PokerStars Game #59939440110:  Hold'em No Limit ($0.10/$0.25) - 2009/07/01 0:39:55 ET
Table 'CM/C/FZf3VHIp50RjmBucQ' 9-max Seat #6 is the button
Seat 1: 1Clf3cPrqoy/YgvWdWK1Xw ($5 in chips) 
Seat 2: 1S/fpm+f42V/6MNZre+ccg ($28.10 in chips) 
Seat 3: dfNim92Z6XK1/h5SFW5vDg ($29.40 in chips) 
Seat 4: oXv2YWrxjhmEfQAgUx964Q ($24.10 in chips) 
Seat 5: TeWJxSETzbXGiYKx0y+dtg ($36.80 in chips) 
Seat 6: 4awUyiDYTgylQKXZ9faBVA ($29.45 in chips) 
Seat 8: cZ99hugmLBj9KhTlc8nCSw ($26.25 in chips) 
Seat 9: Yv4fucyyT28mjx8V5lxKJg ($21.50 in chips) 
cZ99hugmLBj9KhTlc8nCSw: posts small blind $0.10
Yv4fucyyT28mjx8V5lxKJg: posts big blind $0.25
*** HOLE CARDS ***
1Clf3cPrqoy/YgvWdWK1Xw: folds 
1S/fpm+f42V/6MNZre+ccg: folds 
dfNim92Z6XK1/h5SFW5vDg: calls $0.25
oXv2YWrxjhmEfQAgUx964Q: folds 
TeWJxSETzbXGiYKx0y+dtg: folds 
4awUyiDYTgylQKXZ9faBVA: folds 
cZ99hugmLBj9KhTlc8nCSw: folds 
Yv4fucyyT28mjx8V5lxKJg: checks 
*** FLOP *** [Qh Jd 5c]
Yv4fucyyT28mjx8V5lxKJg: checks 
dfNim92Z6XK1/h5SFW5vDg: bets $0.50
Yv4fucyyT28mjx8V5lxKJg: folds 
Uncalled bet ($0.50) returned to dfNim92Z6XK1/h5SFW5vDg
dfNim92Z6XK1/h5SFW5vDg collected $0.60 from pot
dfNim92Z6XK1/h5SFW5vDg: doesn't show hand 
*** SUMMARY ***
Total pot $0.60 | Rake $0 
Board [Qh Jd 5c]
Seat 1: 1Clf3cPrqoy/YgvWdWK1Xw folded before Flop (didn't bet)
Seat 2: 1S/fpm+f42V/6MNZre+ccg folded before Flop (didn't bet)
Seat 3: dfNim92Z6XK1/h5SFW5vDg collected ($0.60)
Seat 4: oXv2YWrxjhmEfQAgUx964Q folded before Flop (didn't bet)
Seat 5: TeWJxSETzbXGiYKx0y+dtg folded before Flop (didn't bet)
Seat 6: 4awUyiDYTgylQKXZ9faBVA (button) folded before Flop (didn't bet)
Seat 8: cZ99hugmLBj9KhTlc8nCSw (small blind) folded before Flop
Seat 9: Yv4fucyyT28mjx8V5lxKJg (big blind) folded on the Flop




PokerStars Game #59939439996:  Hold'em No Limit ($0.10/$0.25) - 2009/07/01 0:39:55 ET
Table 'oxYpQNT8OHNCvpMIFi7UoA' 9-max Seat #4 is the button
Seat 1: H5Se03ZqSX7tbULXur2MAg ($25 in chips) 
Seat 2: Ofo77cVa49gHqAMfHrrMbw ($12.60 in chips) 
Seat 3: DBWHFmM+iV/PrUG8xKBQ7w ($8.20 in chips) 
Seat 4: ghNKXUBl/H+t83JF079ZBA ($25 in chips) 
Seat 5: SXqVW4Q0evTUVZG6BbUNIA ($34.25 in chips) 
Seat 6: +2kMBNpY4nF1qNCRd8SJLA ($25 in chips) 
Seat 8: OlPJsgR4xypSg/w1z7Gyvw ($19.10 in chips) 
Seat 9: KK7jFoJo1TzDCPdsfpPjtw ($40.80 in chips) 
SXqVW4Q0evTUVZG6BbUNIA: posts small blind $0.10
+2kMBNpY4nF1qNCRd8SJLA: posts big blind $0.25
yyG4svzOpC1A+sUP/scg6w: sits out 
DBWHFmM+iV/PrUG8xKBQ7w: posts big blind $0.25
*** HOLE CARDS ***
OlPJsgR4xypSg/w1z7Gyvw: folds 
KK7jFoJo1TzDCPdsfpPjtw: folds 
H5Se03ZqSX7tbULXur2MAg: folds 
Ofo77cVa49gHqAMfHrrMbw: folds 
DBWHFmM+iV/PrUG8xKBQ7w: checks 
ghNKXUBl/H+t83JF079ZBA: folds 
SXqVW4Q0evTUVZG6BbUNIA: folds 
+2kMBNpY4nF1qNCRd8SJLA: checks 
*** FLOP *** [Jd 6h 3c]
+2kMBNpY4nF1qNCRd8SJLA: checks 
DBWHFmM+iV/PrUG8xKBQ7w: bets $0.50
+2kMBNpY4nF1qNCRd8SJLA: folds 
Uncalled bet ($0.50) returned to DBWHFmM+iV/PrUG8xKBQ7w
DBWHFmM+iV/PrUG8xKBQ7w collected $0.60 from pot
DBWHFmM+iV/PrUG8xKBQ7w: doesn't show hand 
*** SUMMARY ***
Total pot $0.60 | Rake $0 
Board [Jd 6h 3c]
Seat 1: H5Se03ZqSX7tbULXur2MAg folded before Flop (didn't bet)
Seat 2: Ofo77cVa49gHqAMfHrrMbw folded before Flop (didn't bet)
Seat 3: DBWHFmM+iV/PrUG8xKBQ7w collected ($0.60)
Seat 4: ghNKXUBl/H+t83JF079ZBA (button) folded before Flop (didn't bet)
Seat 5: SXqVW4Q0evTUVZG6BbUNIA (small blind) folded before Flop
Seat 6: +2kMBNpY4nF1qNCRd8SJLA (big blind) folded on the Flop
Seat 8: OlPJsgR4xypSg/w1z7Gyvw folded before Flop (didn't bet)
Seat 9: KK7jFoJo1TzDCPdsfpPjtw folded before Flop (didn't bet)




PokerStars Game #59939439560:  Hold'em No Limit ($0.10/$0.25) - 2009/07/01 0:39:55 ET
Table 'KYX9dFNuOA9l2PV46IebqQ' 9-max Seat #8 is the button
Seat 1: s7Q6uNouhe7aE8JdFb9E+A ($27.40 in chips) 
Seat 2: r6hsffOo1iKmaPYKwAZmFw ($25 in chips) 
Seat 3: f+H1PHwj9cNu4Y6FfvKwQQ ($18.35 in chips) 
Seat 4: SkLOm0UugROBRt2EfMpOxQ ($35.70 in chips) 
Seat 5: HQMjiff9S04k8kyC4fHVgw ($2.55 in chips) 
Seat 6: DiSvPC2iudwL5j9u6Huyww ($25.35 in chips) 
Seat 7: kmJc9NmBNbE55/AnUDL6/w ($3.85 in chips) 
Seat 8: 4oA316mXLIui1QY63GXBUg ($25 in chips) 
Seat 9: W4TLQcZ2TiM73eIgpIvlGg ($33.05 in chips) 
W4TLQcZ2TiM73eIgpIvlGg: posts small blind $0.10
s7Q6uNouhe7aE8JdFb9E+A: posts big blind $0.25
*** HOLE CARDS ***
r6hsffOo1iKmaPYKwAZmFw: folds 
f+H1PHwj9cNu4Y6FfvKwQQ: calls $0.25
SkLOm0UugROBRt2EfMpOxQ: raises $0.75 to $1
HQMjiff9S04k8kyC4fHVgw: folds 
DiSvPC2iudwL5j9u6Huyww: folds 
kmJc9NmBNbE55/AnUDL6/w: folds 
4oA316mXLIui1QY63GXBUg: folds 
W4TLQcZ2TiM73eIgpIvlGg: folds 
s7Q6uNouhe7aE8JdFb9E+A: folds 
f+H1PHwj9cNu4Y6FfvKwQQ: calls $0.75
*** FLOP *** [Js Kh Jc]
f+H1PHwj9cNu4Y6FfvKwQQ: checks 
SkLOm0UugROBRt2EfMpOxQ: checks 
*** TURN *** [Js Kh Jc] [As]
f+H1PHwj9cNu4Y6FfvKwQQ: checks 
SkLOm0UugROBRt2EfMpOxQ: bets $1.50
f+H1PHwj9cNu4Y6FfvKwQQ: calls $1.50
*** RIVER *** [Js Kh Jc As] [5h]
f+H1PHwj9cNu4Y6FfvKwQQ: checks 
SkLOm0UugROBRt2EfMpOxQ: bets $4
f+H1PHwj9cNu4Y6FfvKwQQ: folds 
Uncalled bet ($4) returned to SkLOm0UugROBRt2EfMpOxQ
SkLOm0UugROBRt2EfMpOxQ collected $5.10 from pot
*** SUMMARY ***
Total pot $5.35 | Rake $0.25 
Board [Js Kh Jc As 5h]
Seat 1: s7Q6uNouhe7aE8JdFb9E+A (big blind) folded before Flop
Seat 2: r6hsffOo1iKmaPYKwAZmFw folded before Flop (didn't bet)
Seat 3: f+H1PHwj9cNu4Y6FfvKwQQ folded on the River
Seat 4: SkLOm0UugROBRt2EfMpOxQ collected ($5.10)
Seat 5: HQMjiff9S04k8kyC4fHVgw folded before Flop (didn't bet)
Seat 6: DiSvPC2iudwL5j9u6Huyww folded before Flop (didn't bet)
Seat 7: kmJc9NmBNbE55/AnUDL6/w folded before Flop (didn't bet)
Seat 8: 4oA316mXLIui1QY63GXBUg (button) folded before Flop (didn't bet)
Seat 9: W4TLQcZ2TiM73eIgpIvlGg (small blind) folded before Flop




PokerStars Game #59939439774:  Hold'em No Limit ($0.10/$0.25) - 2009/07/01 0:39:55 ET
Table '7eunnLa5p3aGsPrUrNnn/A' 9-max Seat #5 is the button
Seat 1: Ml2bY77EHbM51ZWD7dnIWg ($29.75 in chips) 
Seat 2: aJy680tKSaP5er559aSuGA ($12.25 in chips) 
Seat 3: E0iYnEVO2ho7dH3QcCjw7g ($20.80 in chips) 
Seat 4: opOCI2p6kW0tINuVaAqmcQ ($30.70 in chips) 
Seat 5: JLfmdpDbz2ljMNE7ICboMQ ($7.70 in chips) 
Seat 6: jx9kXw1SAZrvXp9Nerz8+Q ($15.95 in chips) 
Seat 7: sD+TKtt36XiiN6jqHiLwDA ($25 in chips) 
Seat 8: 1Clf3cPrqoy/YgvWdWK1Xw ($5 in chips) 
Seat 9: rUpvA02nErFvZ4yFbDR8XA ($21.05 in chips) 
jx9kXw1SAZrvXp9Nerz8+Q: posts small blind $0.10
sD+TKtt36XiiN6jqHiLwDA: posts big blind $0.25
*** HOLE CARDS ***
1Clf3cPrqoy/YgvWdWK1Xw: folds 
rUpvA02nErFvZ4yFbDR8XA: calls $0.25
Ml2bY77EHbM51ZWD7dnIWg: folds 
aJy680tKSaP5er559aSuGA: folds 
E0iYnEVO2ho7dH3QcCjw7g: folds 
opOCI2p6kW0tINuVaAqmcQ: folds 
JLfmdpDbz2ljMNE7ICboMQ: raises $0.25 to $0.50
jx9kXw1SAZrvXp9Nerz8+Q: calls $0.40
sD+TKtt36XiiN6jqHiLwDA: calls $0.25
rUpvA02nErFvZ4yFbDR8XA: calls $0.25
*** FLOP *** [Kh Th 7d]
jx9kXw1SAZrvXp9Nerz8+Q: checks 
sD+TKtt36XiiN6jqHiLwDA: checks 
rUpvA02nErFvZ4yFbDR8XA: checks 
JLfmdpDbz2ljMNE7ICboMQ: bets $1.25
jx9kXw1SAZrvXp9Nerz8+Q: folds 
sD+TKtt36XiiN6jqHiLwDA: folds 
rUpvA02nErFvZ4yFbDR8XA: folds 
Uncalled bet ($1.25) returned to JLfmdpDbz2ljMNE7ICboMQ
JLfmdpDbz2ljMNE7ICboMQ collected $1.90 from pot
*** SUMMARY ***
Total pot $2 | Rake $0.10 
Board [Kh Th 7d]
Seat 1: Ml2bY77EHbM51ZWD7dnIWg folded before Flop (didn't bet)
Seat 2: aJy680tKSaP5er559aSuGA folded before Flop (didn't bet)
Seat 3: E0iYnEVO2ho7dH3QcCjw7g folded before Flop (didn't bet)
Seat 4: opOCI2p6kW0tINuVaAqmcQ folded before Flop (didn't bet)
Seat 5: JLfmdpDbz2ljMNE7ICboMQ (button) collected ($1.90)
Seat 6: jx9kXw1SAZrvXp9Nerz8+Q (small blind) folded on the Flop
Seat 7: sD+TKtt36XiiN6jqHiLwDA (big blind) folded on the Flop
Seat 8: 1Clf3cPrqoy/YgvWdWK1Xw folded before Flop (didn't bet)
Seat 9: rUpvA02nErFvZ4yFbDR8XA folded on the Flop




PokerStars Game #59939440134:  Hold'em No Limit ($0.10/$0.25) - 2009/07/01 0:39:56 ET
Table '0XPo7K54oZIfG0xlNAcDRw' 9-max Seat #5 is the button
Seat 1: opOCI2p6kW0tINuVaAqmcQ ($29.65 in chips) 
Seat 2: Jbrpc6KkvYcsiySJzLmFuA ($15.40 in chips) 
Seat 3: 6qsItdeWZoOL5be2e1RFng ($11.50 in chips) 
Seat 4: vOEICaqlJhPYytg64XnnkQ ($12.60 in chips) 
Seat 5: 8B/dhbQjIWe6ASCdgzktNQ ($40 in chips) 
Seat 6: 9gmYYQesalMrUjaF7nKfrQ ($10.45 in chips) 
Seat 7: tYsOBqdU1+x+yFI7zHO7hQ ($45.85 in chips) 
Seat 8: 1Clf3cPrqoy/YgvWdWK1Xw ($6.25 in chips) 
Seat 9: s7Q6uNouhe7aE8JdFb9E+A ($25.35 in chips) 
9gmYYQesalMrUjaF7nKfrQ: posts small blind $0.10
tYsOBqdU1+x+yFI7zHO7hQ: posts big blind $0.25
*** HOLE CARDS ***
1Clf3cPrqoy/YgvWdWK1Xw: folds 
s7Q6uNouhe7aE8JdFb9E+A: folds 
opOCI2p6kW0tINuVaAqmcQ: folds 
Jbrpc6KkvYcsiySJzLmFuA: folds 
6qsItdeWZoOL5be2e1RFng: calls $0.25
vOEICaqlJhPYytg64XnnkQ: raises $0.25 to $0.50
8B/dhbQjIWe6ASCdgzktNQ: folds 
9gmYYQesalMrUjaF7nKfrQ: calls $0.40
tYsOBqdU1+x+yFI7zHO7hQ: folds 
6qsItdeWZoOL5be2e1RFng: calls $0.25
*** FLOP *** [2d 7s 4s]
9gmYYQesalMrUjaF7nKfrQ: checks 
6qsItdeWZoOL5be2e1RFng: bets $0.75
vOEICaqlJhPYytg64XnnkQ: folds 
9gmYYQesalMrUjaF7nKfrQ: folds 
Uncalled bet ($0.75) returned to 6qsItdeWZoOL5be2e1RFng
6qsItdeWZoOL5be2e1RFng collected $1.70 from pot
*** SUMMARY ***
Total pot $1.75 | Rake $0.05 
Board [2d 7s 4s]
Seat 1: opOCI2p6kW0tINuVaAqmcQ folded before Flop (didn't bet)
Seat 2: Jbrpc6KkvYcsiySJzLmFuA folded before Flop (didn't bet)
Seat 3: 6qsItdeWZoOL5be2e1RFng collected ($1.70)
Seat 4: vOEICaqlJhPYytg64XnnkQ folded on the Flop
Seat 5: 8B/dhbQjIWe6ASCdgzktNQ (button) folded before Flop (didn't bet)
Seat 6: 9gmYYQesalMrUjaF7nKfrQ (small blind) folded on the Flop
Seat 7: tYsOBqdU1+x+yFI7zHO7hQ (big blind) folded before Flop
Seat 8: 1Clf3cPrqoy/YgvWdWK1Xw folded before Flop (didn't bet)
Seat 9: s7Q6uNouhe7aE8JdFb9E+A folded before Flop (didn't bet)




PokerStars Game #59939440632:  Hold'em No Limit ($0.10/$0.25) - 2009/07/01 0:39:56 ET
Table 'rpIHGyt2QpgQc5bvptAvDQ' 9-max Seat #2 is the button
Seat 1: pIK8dHf+MqCSMpnx8j9HEw ($17.15 in chips) 
Seat 2: Xpyqpb+DURDWnyJ3xTEIFQ ($26.10 in chips) 
Seat 3: RNWwL4ZL6E6nNwmoYWS4Ug ($13.25 in chips) 
Seat 4: ottZQkg1UDWk85BtBzGJzg ($13.40 in chips) 
Seat 5: F7uW1LiDD9vUDBtB+5gRDg ($14.15 in chips) 
Seat 6: gehe91e0IyVT0QU/XBkEyg ($39.35 in chips) 
Seat 7: SXqVW4Q0evTUVZG6BbUNIA ($29.60 in chips) 
Seat 8: tYsOBqdU1+x+yFI7zHO7hQ ($25 in chips) 
Seat 9: nm4Dj/f+jJEwKVsUnKh73g ($20.75 in chips) 
RNWwL4ZL6E6nNwmoYWS4Ug: posts small blind $0.10
ottZQkg1UDWk85BtBzGJzg: posts big blind $0.25
*** HOLE CARDS ***
F7uW1LiDD9vUDBtB+5gRDg: folds 
gehe91e0IyVT0QU/XBkEyg: folds 
SXqVW4Q0evTUVZG6BbUNIA: folds 
tYsOBqdU1+x+yFI7zHO7hQ: folds 
nm4Dj/f+jJEwKVsUnKh73g: folds 
pIK8dHf+MqCSMpnx8j9HEw: folds 
Xpyqpb+DURDWnyJ3xTEIFQ: raises $0.75 to $1
RNWwL4ZL6E6nNwmoYWS4Ug: calls $0.90
ottZQkg1UDWk85BtBzGJzg: folds 
*** FLOP *** [5c Ah Ts]
RNWwL4ZL6E6nNwmoYWS4Ug: checks 
Xpyqpb+DURDWnyJ3xTEIFQ: bets $1
RNWwL4ZL6E6nNwmoYWS4Ug: folds 
Uncalled bet ($1) returned to Xpyqpb+DURDWnyJ3xTEIFQ
Xpyqpb+DURDWnyJ3xTEIFQ collected $2.15 from pot
*** SUMMARY ***
Total pot $2.25 | Rake $0.10 
Board [5c Ah Ts]
Seat 1: pIK8dHf+MqCSMpnx8j9HEw folded before Flop (didn't bet)
Seat 2: Xpyqpb+DURDWnyJ3xTEIFQ (button) collected ($2.15)
Seat 3: RNWwL4ZL6E6nNwmoYWS4Ug (small blind) folded on the Flop
Seat 4: ottZQkg1UDWk85BtBzGJzg (big blind) folded before Flop
Seat 5: F7uW1LiDD9vUDBtB+5gRDg folded before Flop (didn't bet)
Seat 6: gehe91e0IyVT0QU/XBkEyg folded before Flop (didn't bet)
Seat 7: SXqVW4Q0evTUVZG6BbUNIA folded before Flop (didn't bet)
Seat 8: tYsOBqdU1+x+yFI7zHO7hQ folded before Flop (didn't bet)
Seat 9: nm4Dj/f+jJEwKVsUnKh73g folded before Flop (didn't bet)




PokerStars Game #59939440292:  Hold'em No Limit ($0.10/$0.25) - 2009/07/01 0:39:56 ET
Table '1zj0+miaIL9cvwnT/50pOA' 9-max Seat #1 is the button
Seat 1: spidnpwmoJ1L6yeNW7D5UA ($25.50 in chips) 
Seat 2: HPEB+AtKw1+C/cxU0o1ciw ($28.55 in chips) 
Seat 3: CYkY0dNBaYaKs8HVCVn3mQ ($5.85 in chips) 
Seat 4: 6esz1u5YivjsX0UoeMBm3w ($22.15 in chips) 
Seat 5: JxpnpCmvRAcrEUy7mq1iAg ($5.70 in chips) 
Seat 6: ydoFOVgzvZv9ZhuWu9rXAw ($5 in chips) 
Seat 7: 6oWOdVz2WG2azNuOj9rMgg ($16.45 in chips) 
Seat 8: HOiu48bZMhEZSoJa8mjiMw ($32.55 in chips) 
Seat 9: OiV1PWZ3IkN29JlmCcnTwQ ($5.25 in chips) 
HPEB+AtKw1+C/cxU0o1ciw: posts small blind $0.10
CYkY0dNBaYaKs8HVCVn3mQ: posts big blind $0.25
*** HOLE CARDS ***
6esz1u5YivjsX0UoeMBm3w: calls $0.25
JxpnpCmvRAcrEUy7mq1iAg: folds 
ydoFOVgzvZv9ZhuWu9rXAw: folds 
6oWOdVz2WG2azNuOj9rMgg: folds 
HOiu48bZMhEZSoJa8mjiMw: folds 
OiV1PWZ3IkN29JlmCcnTwQ: folds 
spidnpwmoJ1L6yeNW7D5UA: folds 
HPEB+AtKw1+C/cxU0o1ciw: folds 
CYkY0dNBaYaKs8HVCVn3mQ: checks 
*** FLOP *** [Qh Ts As]
CYkY0dNBaYaKs8HVCVn3mQ: checks 
6esz1u5YivjsX0UoeMBm3w: bets $0.50
CYkY0dNBaYaKs8HVCVn3mQ: folds 
Uncalled bet ($0.50) returned to 6esz1u5YivjsX0UoeMBm3w
6esz1u5YivjsX0UoeMBm3w collected $0.60 from pot
6esz1u5YivjsX0UoeMBm3w: doesn't show hand 
*** SUMMARY ***
Total pot $0.60 | Rake $0 
Board [Qh Ts As]
Seat 1: spidnpwmoJ1L6yeNW7D5UA (button) folded before Flop (didn't bet)
Seat 2: HPEB+AtKw1+C/cxU0o1ciw (small blind) folded before Flop
Seat 3: CYkY0dNBaYaKs8HVCVn3mQ (big blind) folded on the Flop
Seat 4: 6esz1u5YivjsX0UoeMBm3w collected ($0.60)
Seat 5: JxpnpCmvRAcrEUy7mq1iAg folded before Flop (didn't bet)
Seat 6: ydoFOVgzvZv9ZhuWu9rXAw folded before Flop (didn't bet)
Seat 7: 6oWOdVz2WG2azNuOj9rMgg folded before Flop (didn't bet)
Seat 8: HOiu48bZMhEZSoJa8mjiMw folded before Flop (didn't bet)
Seat 9: OiV1PWZ3IkN29JlmCcnTwQ folded before Flop (didn't bet)




PokerStars Game #59939440538:  Hold'em No Limit ($0.10/$0.25) - 2009/07/01 0:39:56 ET
Table 'mF3KHGMaTpaBZbtBoyfTeg' 6-max Seat #2 is the button
Seat 1: 0HAB2GdCAM7p7V00xueAVQ ($9.80 in chips) 
Seat 2: 4x9jCqgSw4272dnaIqnanw ($4.15 in chips) 
Seat 3: Hzrn9DZJegEZICufTNYkrg ($14.50 in chips) 
Seat 4: FYepjhAvF8ZdVCmqHIy+eQ ($25.90 in chips) 
Seat 5: sEQx9G5Cu8k1HNdQasxvUA ($28.05 in chips) 
Hzrn9DZJegEZICufTNYkrg: posts small blind $0.10
FYepjhAvF8ZdVCmqHIy+eQ: posts big blind $0.25
*** HOLE CARDS ***
sEQx9G5Cu8k1HNdQasxvUA: raises $0.50 to $0.75
0HAB2GdCAM7p7V00xueAVQ: folds 
4x9jCqgSw4272dnaIqnanw: folds 
Hzrn9DZJegEZICufTNYkrg: folds 
FYepjhAvF8ZdVCmqHIy+eQ: folds 
Uncalled bet ($0.50) returned to sEQx9G5Cu8k1HNdQasxvUA
sEQx9G5Cu8k1HNdQasxvUA collected $0.60 from pot
sEQx9G5Cu8k1HNdQasxvUA: doesn't show hand 
*** SUMMARY ***
Total pot $0.60 | Rake $0 
Seat 1: 0HAB2GdCAM7p7V00xueAVQ folded before Flop (didn't bet)
Seat 2: 4x9jCqgSw4272dnaIqnanw (button) folded before Flop (didn't bet)
Seat 3: Hzrn9DZJegEZICufTNYkrg (small blind) folded before Flop
Seat 4: FYepjhAvF8ZdVCmqHIy+eQ (big blind) folded before Flop
Seat 5: sEQx9G5Cu8k1HNdQasxvUA collected ($0.60)




PokerStars Game #59939440446:  Hold'em No Limit ($0.10/$0.25) - 2009/07/01 0:39:56 ET
Table '9iHhO6FyZVM8XpSc23TIgg' 6-max Seat #3 is the button
Seat 1: NhUN/JpAprdJeamFBgJH1w ($25 in chips) 
Seat 2: ErIN0JRL5srYjT6en1f8YQ ($32.05 in chips) 
Seat 3: EXTSABh+qTpWWrIkxl3wXg ($43.65 in chips) 
Seat 4: cfJccEfyn6IkquPN08hFsA ($33.30 in chips) 
Seat 5: WmfI+HZXhME/HMG8E3/H2w ($14 in chips) 
Seat 6: 5z4PIVM9IyDWfUi+/MMdTA ($17.85 in chips) 
cfJccEfyn6IkquPN08hFsA: posts small blind $0.10
WmfI+HZXhME/HMG8E3/H2w: posts big blind $0.25
*** HOLE CARDS ***
5z4PIVM9IyDWfUi+/MMdTA: calls $0.25
NhUN/JpAprdJeamFBgJH1w: folds 
ErIN0JRL5srYjT6en1f8YQ: folds 
EXTSABh+qTpWWrIkxl3wXg: folds 
cfJccEfyn6IkquPN08hFsA: calls $0.15
WmfI+HZXhME/HMG8E3/H2w: checks 
*** FLOP *** [3c 9h Ks]
cfJccEfyn6IkquPN08hFsA: checks 
WmfI+HZXhME/HMG8E3/H2w: checks 
5z4PIVM9IyDWfUi+/MMdTA: checks 
*** TURN *** [3c 9h Ks] [5d]
cfJccEfyn6IkquPN08hFsA: bets $1
WmfI+HZXhME/HMG8E3/H2w: calls $1
5z4PIVM9IyDWfUi+/MMdTA: folds 
*** RIVER *** [3c 9h Ks 5d] [9c]
cfJccEfyn6IkquPN08hFsA: checks 
WmfI+HZXhME/HMG8E3/H2w: checks 
*** SHOW DOWN ***
cfJccEfyn6IkquPN08hFsA: shows [Jh 6s] (a pair of Nines)
WmfI+HZXhME/HMG8E3/H2w: shows [7s 5h] (two pair, Nines and Fives)
WmfI+HZXhME/HMG8E3/H2w collected $2.65 from pot
*** SUMMARY ***
Total pot $2.75 | Rake $0.10 
Board [3c 9h Ks 5d 9c]
Seat 1: NhUN/JpAprdJeamFBgJH1w folded before Flop (didn't bet)
Seat 2: ErIN0JRL5srYjT6en1f8YQ folded before Flop (didn't bet)
Seat 3: EXTSABh+qTpWWrIkxl3wXg (button) folded before Flop (didn't bet)
Seat 4: cfJccEfyn6IkquPN08hFsA (small blind) showed [Jh 6s] and lost with a pair of Nines
Seat 5: WmfI+HZXhME/HMG8E3/H2w (big blind) showed [7s 5h] and won ($2.65) with two pair, Nines and Fives
Seat 6: 5z4PIVM9IyDWfUi+/MMdTA folded on the Turn




PokerStars Game #59939440286:  Hold'em No Limit ($0.10/$0.25) - 2009/07/01 0:39:56 ET
Table 'KKcpZYT1qeSWLmZFp9A4KA' 9-max Seat #3 is the button
Seat 2: vZGoOTJLQLhkPj4I+LNGig ($26.15 in chips) 
Seat 3: j4q3p0lesp63b1gZDwLBZw ($5.25 in chips) 
Seat 5: CbXUS6Z2rXZxL1AKduNtmQ ($34 in chips) 
Seat 6: 4awUyiDYTgylQKXZ9faBVA ($39.70 in chips) 
Seat 7: QEbIGci+itdw+re8RM5fZA ($26.45 in chips) 
Seat 8: CBv6rfZ34K2gts8YbQ4waw ($30.45 in chips) 
CbXUS6Z2rXZxL1AKduNtmQ: posts small blind $0.10
4awUyiDYTgylQKXZ9faBVA: posts big blind $0.25
*** HOLE CARDS ***
QEbIGci+itdw+re8RM5fZA: raises $0.50 to $0.75
CBv6rfZ34K2gts8YbQ4waw: calls $0.75
vZGoOTJLQLhkPj4I+LNGig: folds 
j4q3p0lesp63b1gZDwLBZw: folds 
CbXUS6Z2rXZxL1AKduNtmQ: calls $0.65
4awUyiDYTgylQKXZ9faBVA: folds 
*** FLOP *** [Qh 2s 5s]
Z3a37Ry74FVl+CBZtAONiA joins the table at seat #4 
CbXUS6Z2rXZxL1AKduNtmQ: checks 
QEbIGci+itdw+re8RM5fZA: bets $1.50
CBv6rfZ34K2gts8YbQ4waw: raises $1.50 to $3
CbXUS6Z2rXZxL1AKduNtmQ: folds 
QEbIGci+itdw+re8RM5fZA: folds 
Uncalled bet ($1.50) returned to CBv6rfZ34K2gts8YbQ4waw
CBv6rfZ34K2gts8YbQ4waw collected $5.25 from pot
*** SUMMARY ***
Total pot $5.50 | Rake $0.25 
Board [Qh 2s 5s]
Seat 2: vZGoOTJLQLhkPj4I+LNGig folded before Flop (didn't bet)
Seat 3: j4q3p0lesp63b1gZDwLBZw (button) folded before Flop (didn't bet)
Seat 5: CbXUS6Z2rXZxL1AKduNtmQ (small blind) folded on the Flop
Seat 6: 4awUyiDYTgylQKXZ9faBVA (big blind) folded before Flop
Seat 7: QEbIGci+itdw+re8RM5fZA folded on the Flop
Seat 8: CBv6rfZ34K2gts8YbQ4waw collected ($5.25)




PokerStars Game #59939441070:  Hold'em No Limit ($0.10/$0.25) - 2009/07/01 0:39:57 ET
Table '2AUmC2Rslg+QUbLfdgNdfg' 6-max Seat #6 is the button
Seat 1: lgP2sg9oZJsNSXCt7tbwRg ($16.35 in chips) 
Seat 2: CCxAG7iPVlAv3brCqrGBEg ($12.75 in chips) 
Seat 3: iauW7L/+7qzAuHow7CD75Q ($7.45 in chips) 
Seat 4: B6R6e73iyJNddUtXtvYr3Q ($47.95 in chips) 
Seat 5: 8ClCHtFXGNplITm+63KB+Q ($22.95 in chips) 
Seat 6: BvTq4Tu0zBOsniW3eFCnkQ ($32.80 in chips) 
lgP2sg9oZJsNSXCt7tbwRg: posts small blind $0.10
CCxAG7iPVlAv3brCqrGBEg: posts big blind $0.25
*** HOLE CARDS ***
iauW7L/+7qzAuHow7CD75Q: calls $0.25
B6R6e73iyJNddUtXtvYr3Q: folds 
8ClCHtFXGNplITm+63KB+Q: folds 
BvTq4Tu0zBOsniW3eFCnkQ: raises $1 to $1.25
lgP2sg9oZJsNSXCt7tbwRg: folds 
CCxAG7iPVlAv3brCqrGBEg: folds 
iauW7L/+7qzAuHow7CD75Q: folds 
Uncalled bet ($1) returned to BvTq4Tu0zBOsniW3eFCnkQ
BvTq4Tu0zBOsniW3eFCnkQ collected $0.85 from pot
BvTq4Tu0zBOsniW3eFCnkQ: doesn't show hand 
*** SUMMARY ***
Total pot $0.85 | Rake $0 
Seat 1: lgP2sg9oZJsNSXCt7tbwRg (small blind) folded before Flop
Seat 2: CCxAG7iPVlAv3brCqrGBEg (big blind) folded before Flop
Seat 3: iauW7L/+7qzAuHow7CD75Q folded before Flop
Seat 4: B6R6e73iyJNddUtXtvYr3Q folded before Flop (didn't bet)
Seat 5: 8ClCHtFXGNplITm+63KB+Q folded before Flop (didn't bet)
Seat 6: BvTq4Tu0zBOsniW3eFCnkQ (button) collected ($0.85)




PokerStars Game #59939441288:  Hold'em No Limit ($0.10/$0.25) - 2009/07/01 0:39:57 ET
Table '84TjTrgbsYZladOc4PWf4Q' 6-max Seat #6 is the button
Seat 1: 79ID/ub1Pt/mDpCprVmOoA ($29.75 in chips) 
Seat 2: qGHGf/553gQnDoklMRe3tg ($31.90 in chips) 
Seat 3: BYxjLnV1/LL0aZcTbfAOvw ($38.05 in chips) 
Seat 4: SxIIgwXYLkwd6m3wLyPTCw ($25 in chips) 
Seat 5: SFmT9ZsVopnukjvAzrxTRg ($36.85 in chips) 
Seat 6: 7qRk4YH4/k/08LgJSv7rBQ ($25 in chips) 
79ID/ub1Pt/mDpCprVmOoA: posts small blind $0.10
qGHGf/553gQnDoklMRe3tg: posts big blind $0.25
*** HOLE CARDS ***
BYxjLnV1/LL0aZcTbfAOvw: folds 
SxIIgwXYLkwd6m3wLyPTCw: raises $0.50 to $0.75
SFmT9ZsVopnukjvAzrxTRg: folds 
7qRk4YH4/k/08LgJSv7rBQ: folds 
79ID/ub1Pt/mDpCprVmOoA: folds 
qGHGf/553gQnDoklMRe3tg: folds 
Uncalled bet ($0.50) returned to SxIIgwXYLkwd6m3wLyPTCw
SxIIgwXYLkwd6m3wLyPTCw collected $0.60 from pot
SxIIgwXYLkwd6m3wLyPTCw: doesn't show hand 
*** SUMMARY ***
Total pot $0.60 | Rake $0 
Seat 1: 79ID/ub1Pt/mDpCprVmOoA (small blind) folded before Flop
Seat 2: qGHGf/553gQnDoklMRe3tg (big blind) folded before Flop
Seat 3: BYxjLnV1/LL0aZcTbfAOvw folded before Flop (didn't bet)
Seat 4: SxIIgwXYLkwd6m3wLyPTCw collected ($0.60)
Seat 5: SFmT9ZsVopnukjvAzrxTRg folded before Flop (didn't bet)
Seat 6: 7qRk4YH4/k/08LgJSv7rBQ (button) folded before Flop (didn't bet)




PokerStars Game #59939440930:  Hold'em No Limit ($0.10/$0.25) - 2009/07/01 0:39:57 ET
Table 'AJGgX1ZYM8d68SWMvaLttg' 6-max Seat #5 is the button
Seat 1: sT4sjqzVMH/fZHz0hkbIPw ($32.65 in chips) 
Seat 2: zHHLkD2sRljslKKeQv/ZQw ($33.10 in chips) 
Seat 3: 4x9jCqgSw4272dnaIqnanw ($7.35 in chips) 
Seat 4: Lz/GjRDgmgepqTR7qmS86w ($18.35 in chips) 
Seat 5: SFmT9ZsVopnukjvAzrxTRg ($28.60 in chips) 
Seat 6: UA5OsKS3VPaxa7uC8La/kA ($31 in chips) 
UA5OsKS3VPaxa7uC8La/kA: posts small blind $0.10
sT4sjqzVMH/fZHz0hkbIPw: posts big blind $0.25
*** HOLE CARDS ***
zHHLkD2sRljslKKeQv/ZQw: calls $0.25
4x9jCqgSw4272dnaIqnanw: folds 
Lz/GjRDgmgepqTR7qmS86w: folds 
SFmT9ZsVopnukjvAzrxTRg: folds 
UA5OsKS3VPaxa7uC8La/kA: calls $0.15
sT4sjqzVMH/fZHz0hkbIPw: raises $0.50 to $0.75
zHHLkD2sRljslKKeQv/ZQw: calls $0.50
UA5OsKS3VPaxa7uC8La/kA: calls $0.50
*** FLOP *** [Ts 2c 7h]
UA5OsKS3VPaxa7uC8La/kA: checks 
sT4sjqzVMH/fZHz0hkbIPw: bets $1.75
zHHLkD2sRljslKKeQv/ZQw: folds 
UA5OsKS3VPaxa7uC8La/kA: calls $1.75
*** TURN *** [Ts 2c 7h] [9h]
UA5OsKS3VPaxa7uC8La/kA: checks 
sT4sjqzVMH/fZHz0hkbIPw: bets $4
UA5OsKS3VPaxa7uC8La/kA: folds 
Uncalled bet ($4) returned to sT4sjqzVMH/fZHz0hkbIPw
sT4sjqzVMH/fZHz0hkbIPw collected $5.50 from pot
sT4sjqzVMH/fZHz0hkbIPw: doesn't show hand 
*** SUMMARY ***
Total pot $5.75 | Rake $0.25 
Board [Ts 2c 7h 9h]
Seat 1: sT4sjqzVMH/fZHz0hkbIPw (big blind) collected ($5.50)
Seat 2: zHHLkD2sRljslKKeQv/ZQw folded on the Flop
Seat 3: 4x9jCqgSw4272dnaIqnanw folded before Flop (didn't bet)
Seat 4: Lz/GjRDgmgepqTR7qmS86w folded before Flop (didn't bet)
Seat 5: SFmT9ZsVopnukjvAzrxTRg (button) folded before Flop (didn't bet)
Seat 6: UA5OsKS3VPaxa7uC8La/kA (small blind) folded on the Turn




PokerStars Game #59939440968:  Hold'em No Limit ($0.10/$0.25) - 2009/07/01 0:39:57 ET
Table 'yRuHgMpxv4rPBXeM6HFESw' 6-max Seat #4 is the button
Seat 1: MkNgTuvyxpHXkeIm5JITHQ ($10 in chips) 
Seat 2: iwlxXocltgSdaBmusNXanQ ($15.45 in chips) 
Seat 3: zZ8zH49EwNs0mqgppOaL9g ($50.55 in chips) 
Seat 4: ypXnt+kzrF/5y8QN2rkt1A ($20.10 in chips) 
Seat 5: gaPMxLGp9SOj4Lq6t+/0Ig ($13.75 in chips) 
Seat 6: 4YSTu0Cdzpppe1lUgCZGCQ ($25 in chips) 
gaPMxLGp9SOj4Lq6t+/0Ig: posts small blind $0.10
4YSTu0Cdzpppe1lUgCZGCQ: posts big blind $0.25
MkNgTuvyxpHXkeIm5JITHQ: posts big blind $0.25
*** HOLE CARDS ***
MkNgTuvyxpHXkeIm5JITHQ: checks 
iwlxXocltgSdaBmusNXanQ: folds 
zZ8zH49EwNs0mqgppOaL9g: folds 
ypXnt+kzrF/5y8QN2rkt1A: raises $0.35 to $0.60
gaPMxLGp9SOj4Lq6t+/0Ig: folds 
4YSTu0Cdzpppe1lUgCZGCQ: calls $0.35
MkNgTuvyxpHXkeIm5JITHQ: calls $0.35
*** FLOP *** [5h 2h Jd]
4YSTu0Cdzpppe1lUgCZGCQ: checks 
MkNgTuvyxpHXkeIm5JITHQ: checks 
ypXnt+kzrF/5y8QN2rkt1A: checks 
*** TURN *** [5h 2h Jd] [3s]
4YSTu0Cdzpppe1lUgCZGCQ: bets $1.25
MkNgTuvyxpHXkeIm5JITHQ: folds 
ypXnt+kzrF/5y8QN2rkt1A: folds 
Uncalled bet ($1.25) returned to 4YSTu0Cdzpppe1lUgCZGCQ
4YSTu0Cdzpppe1lUgCZGCQ collected $1.85 from pot
4YSTu0Cdzpppe1lUgCZGCQ: doesn't show hand 
*** SUMMARY ***
Total pot $1.90 | Rake $0.05 
Board [5h 2h Jd 3s]
Seat 1: MkNgTuvyxpHXkeIm5JITHQ folded on the Turn
Seat 2: iwlxXocltgSdaBmusNXanQ folded before Flop (didn't bet)
Seat 3: zZ8zH49EwNs0mqgppOaL9g folded before Flop (didn't bet)
Seat 4: ypXnt+kzrF/5y8QN2rkt1A (button) folded on the Turn
Seat 5: gaPMxLGp9SOj4Lq6t+/0Ig (small blind) folded before Flop
Seat 6: 4YSTu0Cdzpppe1lUgCZGCQ (big blind) collected ($1.85)




PokerStars Game #59939440832:  Hold'em No Limit ($0.10/$0.25) - 2009/07/01 0:39:57 ET
Table 'mk323gviqdkOY5Aek/1EWg' 6-max Seat #1 is the button
Seat 1: e8w9qW2QMnrAqkudVQoHoA ($25.85 in chips) 
Seat 2: GC/9yVD59DUCX7hUI7gcLw ($25 in chips) 
Seat 3: aSrj4lVmn2owyQ1RbbOqxQ ($23.40 in chips) 
Seat 4: o08wk0F4gROLhZS04Iyl3w ($29.10 in chips) 
Seat 5: SFmT9ZsVopnukjvAzrxTRg ($61.55 in chips) 
Seat 6: KkXSr5xFjxLSD3wtAvT+WQ ($18.25 in chips) 
GC/9yVD59DUCX7hUI7gcLw: posts small blind $0.10
aSrj4lVmn2owyQ1RbbOqxQ: posts big blind $0.25
*** HOLE CARDS ***
o08wk0F4gROLhZS04Iyl3w: folds 
SFmT9ZsVopnukjvAzrxTRg: raises $0.75 to $1
KkXSr5xFjxLSD3wtAvT+WQ: folds 
e8w9qW2QMnrAqkudVQoHoA: folds 
GC/9yVD59DUCX7hUI7gcLw: folds 
aSrj4lVmn2owyQ1RbbOqxQ: folds 
Uncalled bet ($0.75) returned to SFmT9ZsVopnukjvAzrxTRg
SFmT9ZsVopnukjvAzrxTRg collected $0.60 from pot
SFmT9ZsVopnukjvAzrxTRg: doesn't show hand 
*** SUMMARY ***
Total pot $0.60 | Rake $0 
Seat 1: e8w9qW2QMnrAqkudVQoHoA (button) folded before Flop (didn't bet)
Seat 2: GC/9yVD59DUCX7hUI7gcLw (small blind) folded before Flop
Seat 3: aSrj4lVmn2owyQ1RbbOqxQ (big blind) folded before Flop
Seat 4: o08wk0F4gROLhZS04Iyl3w folded before Flop (didn't bet)
Seat 5: SFmT9ZsVopnukjvAzrxTRg collected ($0.60)
Seat 6: KkXSr5xFjxLSD3wtAvT+WQ folded before Flop (didn't bet)




PokerStars Game #59939441010:  Hold'em No Limit ($0.10/$0.25) - 2009/07/01 0:39:57 ET
Table 'gHbubGDeVSkmB4vFiqIN3Q' 6-max Seat #6 is the button
Seat 2: 8LzEWRhg4wk8Jh9CqDhH3Q ($3.75 in chips) 
Seat 4: v+QfkGiuj9bgtuNoVnDO8w ($32.50 in chips) 
Seat 6: wvIIdlbCgePONQwXjx9xzQ ($5 in chips) 
8LzEWRhg4wk8Jh9CqDhH3Q: posts small blind $0.10
v+QfkGiuj9bgtuNoVnDO8w: posts big blind $0.25
*** HOLE CARDS ***
wvIIdlbCgePONQwXjx9xzQ: calls $0.25
8LzEWRhg4wk8Jh9CqDhH3Q: calls $0.15
v+QfkGiuj9bgtuNoVnDO8w: checks 
*** FLOP *** [4h Ts 8c]
8LzEWRhg4wk8Jh9CqDhH3Q: checks 
v+QfkGiuj9bgtuNoVnDO8w: checks 
wvIIdlbCgePONQwXjx9xzQ: checks 
*** TURN *** [4h Ts 8c] [8s]
8LzEWRhg4wk8Jh9CqDhH3Q: checks 
v+QfkGiuj9bgtuNoVnDO8w: checks 
wvIIdlbCgePONQwXjx9xzQ: bets $0.50
8LzEWRhg4wk8Jh9CqDhH3Q: folds 
v+QfkGiuj9bgtuNoVnDO8w: folds 
Uncalled bet ($0.50) returned to wvIIdlbCgePONQwXjx9xzQ
wvIIdlbCgePONQwXjx9xzQ collected $0.75 from pot
wvIIdlbCgePONQwXjx9xzQ: doesn't show hand 
*** SUMMARY ***
Total pot $0.75 | Rake $0 
Board [4h Ts 8c 8s]
Seat 2: 8LzEWRhg4wk8Jh9CqDhH3Q (small blind) folded on the Turn
Seat 4: v+QfkGiuj9bgtuNoVnDO8w (big blind) folded on the Turn
Seat 6: wvIIdlbCgePONQwXjx9xzQ (button) collected ($0.75)




PokerStars Game #59939440884:  Hold'em No Limit ($0.10/$0.25) - 2009/07/01 0:39:57 ET
Table '8QBBaev+cI2i/r2H6ml/lg' 9-max Seat #9 is the button
Seat 4: ZoG0obuajzVjwgd7lNHjgg ($3.85 in chips) 
Seat 9: Ml2bY77EHbM51ZWD7dnIWg ($1.70 in chips) 
tYsOBqdU1+x+yFI7zHO7hQ: is sitting out 
Ml2bY77EHbM51ZWD7dnIWg: posts small blind $0.10
ZoG0obuajzVjwgd7lNHjgg: posts big blind $0.25
*** HOLE CARDS ***
Ml2bY77EHbM51ZWD7dnIWg: calls $0.15
tYsOBqdU1+x+yFI7zHO7hQ leaves the table
ZoG0obuajzVjwgd7lNHjgg: raises $0.75 to $1
Ml2bY77EHbM51ZWD7dnIWg: calls $0.75
*** FLOP *** [Qc Qh 4h]
ZoG0obuajzVjwgd7lNHjgg: bets $0.75
Ml2bY77EHbM51ZWD7dnIWg: calls $0.70 and is all-in
Uncalled bet ($0.05) returned to ZoG0obuajzVjwgd7lNHjgg
*** TURN *** [Qc Qh 4h] [Th]
*** RIVER *** [Qc Qh 4h Th] [Qs]
*** SHOW DOWN ***
ZoG0obuajzVjwgd7lNHjgg: shows [As Jc] (three of a kind, Queens)
Ml2bY77EHbM51ZWD7dnIWg: shows [Ah 3h] (a flush, Ace high)
Ml2bY77EHbM51ZWD7dnIWg collected $3.25 from pot
*** SUMMARY ***
Total pot $3.40 | Rake $0.15 
Board [Qc Qh 4h Th Qs]
Seat 4: ZoG0obuajzVjwgd7lNHjgg (big blind) showed [As Jc] and lost with three of a kind, Queens
Seat 9: Ml2bY77EHbM51ZWD7dnIWg (button) (small blind) showed [Ah 3h] and won ($3.25) with a flush, Ace high




PokerStars Game #59939440864:  Hold'em No Limit ($0.10/$0.25) - 2009/07/01 0:39:57 ET
Table '4hfTdIVT/qPsJNfWXLsVIw' 9-max Seat #3 is the button
Seat 1: GbHFBbLqLGz0Pwn6CJeAuw ($24.20 in chips) 
Seat 2: NB5rKy+grn9jKcWXclZ7WA ($33.15 in chips) 
Seat 3: opOCI2p6kW0tINuVaAqmcQ ($26.80 in chips) 
Seat 4: OiV1PWZ3IkN29JlmCcnTwQ ($4.65 in chips) 
Seat 5: wtz6Fi0Zt+cIsTeTHf5zJQ ($5 in chips) 
Seat 6: VWUWpMLMj/Q1jRVpF7Aohw ($8.70 in chips) 
Seat 7: z5GxcHlYz/GSz6W2uFiTtg ($31.90 in chips) 
Seat 8: EfRs3ibIxn+c9JDErwwNCg ($31.65 in chips) 
Seat 9: K5byIbXY6S+c1wAeHitZow ($12.65 in chips) 
OiV1PWZ3IkN29JlmCcnTwQ: posts small blind $0.10
wtz6Fi0Zt+cIsTeTHf5zJQ: posts big blind $0.25
*** HOLE CARDS ***
VWUWpMLMj/Q1jRVpF7Aohw: raises $0.75 to $1
z5GxcHlYz/GSz6W2uFiTtg: folds 
EfRs3ibIxn+c9JDErwwNCg: folds 
K5byIbXY6S+c1wAeHitZow: folds 
GbHFBbLqLGz0Pwn6CJeAuw: folds 
NB5rKy+grn9jKcWXclZ7WA: folds 
opOCI2p6kW0tINuVaAqmcQ: folds 
OiV1PWZ3IkN29JlmCcnTwQ: folds 
wtz6Fi0Zt+cIsTeTHf5zJQ: folds 
Uncalled bet ($0.75) returned to VWUWpMLMj/Q1jRVpF7Aohw
VWUWpMLMj/Q1jRVpF7Aohw collected $0.60 from pot
*** SUMMARY ***
Total pot $0.60 | Rake $0 
Seat 1: GbHFBbLqLGz0Pwn6CJeAuw folded before Flop (didn't bet)
Seat 2: NB5rKy+grn9jKcWXclZ7WA folded before Flop (didn't bet)
Seat 3: opOCI2p6kW0tINuVaAqmcQ (button) folded before Flop (didn't bet)
Seat 4: OiV1PWZ3IkN29JlmCcnTwQ (small blind) folded before Flop
Seat 5: wtz6Fi0Zt+cIsTeTHf5zJQ (big blind) folded before Flop
Seat 6: VWUWpMLMj/Q1jRVpF7Aohw collected ($0.60)
Seat 7: z5GxcHlYz/GSz6W2uFiTtg folded before Flop (didn't bet)
Seat 8: EfRs3ibIxn+c9JDErwwNCg folded before Flop (didn't bet)
Seat 9: K5byIbXY6S+c1wAeHitZow folded before Flop (didn't bet)




PokerStars Game #59939440812:  Hold'em No Limit ($0.10/$0.25) - 2009/07/01 0:39:57 ET
Table 'MQJMxKDF6VYBWIKv7VfCog' 9-max Seat #6 is the button
Seat 1: cZ99hugmLBj9KhTlc8nCSw ($26.15 in chips) 
Seat 2: JxpnpCmvRAcrEUy7mq1iAg ($5.20 in chips) 
Seat 3: EfRs3ibIxn+c9JDErwwNCg ($26.05 in chips) 
Seat 4: JtVGnq5doRa3PublncR+Yw ($24.25 in chips) 
Seat 5: RJ/x9oZtt1RZLaJEQwZOxQ ($25.60 in chips) 
Seat 6: ydoFOVgzvZv9ZhuWu9rXAw ($4.90 in chips) 
Seat 7: dfNim92Z6XK1/h5SFW5vDg ($53.05 in chips) 
Seat 8: Z9AeOQX3yzuSvKAm/xyovg ($9.65 in chips) 
Seat 9: 1S/fpm+f42V/6MNZre+ccg ($36.25 in chips) 
dfNim92Z6XK1/h5SFW5vDg: posts small blind $0.10
Z9AeOQX3yzuSvKAm/xyovg: posts big blind $0.25
*** HOLE CARDS ***
1S/fpm+f42V/6MNZre+ccg: folds 
cZ99hugmLBj9KhTlc8nCSw: folds 
JxpnpCmvRAcrEUy7mq1iAg: folds 
EfRs3ibIxn+c9JDErwwNCg: raises $0.75 to $1
JtVGnq5doRa3PublncR+Yw: folds 
RJ/x9oZtt1RZLaJEQwZOxQ: folds 
ydoFOVgzvZv9ZhuWu9rXAw: folds 
dfNim92Z6XK1/h5SFW5vDg: folds 
Z9AeOQX3yzuSvKAm/xyovg: folds 
Uncalled bet ($0.75) returned to EfRs3ibIxn+c9JDErwwNCg
EfRs3ibIxn+c9JDErwwNCg collected $0.60 from pot
*** SUMMARY ***
Total pot $0.60 | Rake $0 
Seat 1: cZ99hugmLBj9KhTlc8nCSw folded before Flop (didn't bet)
Seat 2: JxpnpCmvRAcrEUy7mq1iAg folded before Flop (didn't bet)
Seat 3: EfRs3ibIxn+c9JDErwwNCg collected ($0.60)
Seat 4: JtVGnq5doRa3PublncR+Yw folded before Flop (didn't bet)
Seat 5: RJ/x9oZtt1RZLaJEQwZOxQ folded before Flop (didn't bet)
Seat 6: ydoFOVgzvZv9ZhuWu9rXAw (button) folded before Flop (didn't bet)
Seat 7: dfNim92Z6XK1/h5SFW5vDg (small blind) folded before Flop
Seat 8: Z9AeOQX3yzuSvKAm/xyovg (big blind) folded before Flop
Seat 9: 1S/fpm+f42V/6MNZre+ccg folded before Flop (didn't bet)




PokerStars Game #59939441066:  Hold'em No Limit ($0.10/$0.25) - 2009/07/01 0:39:57 ET
Table 'i8VqsSY3xDtJ63IHleN8+A' 9-max Seat #9 is the button
Seat 1: D3XCkXRktDfPlSguxwfnRA ($15.40 in chips) 
Seat 2: SXqVW4Q0evTUVZG6BbUNIA ($47 in chips) 
Seat 3: HPEB+AtKw1+C/cxU0o1ciw ($56.20 in chips) 
Seat 4: G2offPrpnppc++nuXqs2JA ($15.15 in chips) 
Seat 5: DIBbjEYGs+TVdVgEB/4+3w ($24.90 in chips) 
Seat 6: Xpyqpb+DURDWnyJ3xTEIFQ ($24.75 in chips) 
Seat 7: j4q3p0lesp63b1gZDwLBZw ($6 in chips) 
Seat 8: 5MgYq10OC5iGoxQFwlJVuw ($12.70 in chips) 
Seat 9: vSkQm2EelzwRGDDQQk0Fqw ($6.25 in chips) 
D3XCkXRktDfPlSguxwfnRA: posts small blind $0.10
SXqVW4Q0evTUVZG6BbUNIA: posts big blind $0.25
*** HOLE CARDS ***
HPEB+AtKw1+C/cxU0o1ciw: folds 
G2offPrpnppc++nuXqs2JA: folds 
DIBbjEYGs+TVdVgEB/4+3w: folds 
Xpyqpb+DURDWnyJ3xTEIFQ: folds 
j4q3p0lesp63b1gZDwLBZw: folds 
5MgYq10OC5iGoxQFwlJVuw: folds 
vSkQm2EelzwRGDDQQk0Fqw: raises $0.50 to $0.75
D3XCkXRktDfPlSguxwfnRA: calls $0.65
SXqVW4Q0evTUVZG6BbUNIA: folds 
*** FLOP *** [6h Tc 8s]
D3XCkXRktDfPlSguxwfnRA: checks 
vSkQm2EelzwRGDDQQk0Fqw: bets $1
D3XCkXRktDfPlSguxwfnRA: folds 
Uncalled bet ($1) returned to vSkQm2EelzwRGDDQQk0Fqw
vSkQm2EelzwRGDDQQk0Fqw collected $1.70 from pot
vSkQm2EelzwRGDDQQk0Fqw: doesn't show hand 
*** SUMMARY ***
Total pot $1.75 | Rake $0.05 
Board [6h Tc 8s]
Seat 1: D3XCkXRktDfPlSguxwfnRA (small blind) folded on the Flop
Seat 2: SXqVW4Q0evTUVZG6BbUNIA (big blind) folded before Flop
Seat 3: HPEB+AtKw1+C/cxU0o1ciw folded before Flop (didn't bet)
Seat 4: G2offPrpnppc++nuXqs2JA folded before Flop (didn't bet)
Seat 5: DIBbjEYGs+TVdVgEB/4+3w folded before Flop (didn't bet)
Seat 6: Xpyqpb+DURDWnyJ3xTEIFQ folded before Flop (didn't bet)
Seat 7: j4q3p0lesp63b1gZDwLBZw folded before Flop (didn't bet)
Seat 8: 5MgYq10OC5iGoxQFwlJVuw folded before Flop (didn't bet)
Seat 9: vSkQm2EelzwRGDDQQk0Fqw (button) collected ($1.70)




PokerStars Game #59939440958:  Hold'em No Limit ($0.10/$0.25) - 2009/07/01 0:39:57 ET
Table 'WjNvuuSgTjm8jh0j9vcCgQ' 9-max Seat #9 is the button
Seat 1: NKymidkL3Kg3ILZPvtLSVg ($9.75 in chips) 
Seat 2: 9gmYYQesalMrUjaF7nKfrQ ($10 in chips) 
Seat 3: 8B/dhbQjIWe6ASCdgzktNQ ($25 in chips) 
Seat 4: 3PjJjazzeHcM4mbFeXmZBg ($20.20 in chips) 
Seat 5: Qi+clOtyDiibLdH2/1Qy8g ($18.10 in chips) 
Seat 7: DdPXdieucQ+n99u1n3A+rQ ($4.65 in chips) 
Seat 8: ghNKXUBl/H+t83JF079ZBA ($25 in chips) 
Seat 9: DiSvPC2iudwL5j9u6Huyww ($30.05 in chips) 
NKymidkL3Kg3ILZPvtLSVg: posts small blind $0.10
9gmYYQesalMrUjaF7nKfrQ: posts big blind $0.25
*** HOLE CARDS ***
8B/dhbQjIWe6ASCdgzktNQ: folds 
3PjJjazzeHcM4mbFeXmZBg: folds 
Qi+clOtyDiibLdH2/1Qy8g: folds 
DdPXdieucQ+n99u1n3A+rQ: folds 
ghNKXUBl/H+t83JF079ZBA: folds 
DiSvPC2iudwL5j9u6Huyww: folds 
NKymidkL3Kg3ILZPvtLSVg: raises $0.50 to $0.75
9gmYYQesalMrUjaF7nKfrQ: folds 
Uncalled bet ($0.50) returned to NKymidkL3Kg3ILZPvtLSVg
NKymidkL3Kg3ILZPvtLSVg collected $0.50 from pot
*** SUMMARY ***
Total pot $0.50 | Rake $0 
Seat 1: NKymidkL3Kg3ILZPvtLSVg (small blind) collected ($0.50)
Seat 2: 9gmYYQesalMrUjaF7nKfrQ (big blind) folded before Flop
Seat 3: 8B/dhbQjIWe6ASCdgzktNQ folded before Flop (didn't bet)
Seat 4: 3PjJjazzeHcM4mbFeXmZBg folded before Flop (didn't bet)
Seat 5: Qi+clOtyDiibLdH2/1Qy8g folded before Flop (didn't bet)
Seat 7: DdPXdieucQ+n99u1n3A+rQ folded before Flop (didn't bet)
Seat 8: ghNKXUBl/H+t83JF079ZBA folded before Flop (didn't bet)
Seat 9: DiSvPC2iudwL5j9u6Huyww (button) folded before Flop (didn't bet)




PokerStars Game #59939441536:  Hold'em No Limit ($0.10/$0.25) - 2009/07/01 0:39:58 ET
Table '9SExUHslNkrPJ4XsrePaVw' 9-max Seat #4 is the button
Seat 1: qpbN+BUWX0f/ckQSmOcmkw ($14.25 in chips) 
Seat 2: ie4EwTMMFYxrCXcenJdzsw ($5 in chips) 
Seat 3: jeKWRUkMaVn8rEUjnJKqpg ($25 in chips) 
Seat 4: dyNjB7p93gTjZ0RXn2HnJA ($12.85 in chips) 
Seat 5: FZrgDbxAanC1xwZxXHJKVA ($13.25 in chips) 
Seat 6: DYB0aP91n+Rg/TIhycbaPQ ($14.20 in chips) 
Seat 8: t2nb95S5EEFOEzNx9Itz0g ($8.30 in chips) 
Seat 9: /THNzAxdv2lBxcf4XTj/0g ($15.75 in chips) 
FZrgDbxAanC1xwZxXHJKVA: posts small blind $0.10
DYB0aP91n+Rg/TIhycbaPQ: posts big blind $0.25
7cv+9Zc9HIQHNvYsMfV3uA: sits out 
*** HOLE CARDS ***
t2nb95S5EEFOEzNx9Itz0g: folds 
/THNzAxdv2lBxcf4XTj/0g: folds 
qpbN+BUWX0f/ckQSmOcmkw: folds 
ie4EwTMMFYxrCXcenJdzsw: folds 
jeKWRUkMaVn8rEUjnJKqpg: folds 
dyNjB7p93gTjZ0RXn2HnJA: raises $0.75 to $1
FZrgDbxAanC1xwZxXHJKVA: folds 
DYB0aP91n+Rg/TIhycbaPQ: calls $0.75
*** FLOP *** [Kh 6h 6s]
DYB0aP91n+Rg/TIhycbaPQ: bets $0.25
dyNjB7p93gTjZ0RXn2HnJA: calls $0.25
*** TURN *** [Kh 6h 6s] [6d]
DYB0aP91n+Rg/TIhycbaPQ: bets $1.50
dyNjB7p93gTjZ0RXn2HnJA: calls $1.50
*** RIVER *** [Kh 6h 6s 6d] [Jh]
DYB0aP91n+Rg/TIhycbaPQ: bets $1.50
dyNjB7p93gTjZ0RXn2HnJA: calls $1.50
*** SHOW DOWN ***
DYB0aP91n+Rg/TIhycbaPQ: shows [9c Qc] (three of a kind, Sixes)
dyNjB7p93gTjZ0RXn2HnJA: shows [8d Ah] (three of a kind, Sixes - Ace kicker)
dyNjB7p93gTjZ0RXn2HnJA collected $8.20 from pot
*** SUMMARY ***
Total pot $8.60 | Rake $0.40 
Board [Kh 6h 6s 6d Jh]
Seat 1: qpbN+BUWX0f/ckQSmOcmkw folded before Flop (didn't bet)
Seat 2: ie4EwTMMFYxrCXcenJdzsw folded before Flop (didn't bet)
Seat 3: jeKWRUkMaVn8rEUjnJKqpg folded before Flop (didn't bet)
Seat 4: dyNjB7p93gTjZ0RXn2HnJA (button) showed [8d Ah] and won ($8.20) with three of a kind, Sixes
Seat 5: FZrgDbxAanC1xwZxXHJKVA (small blind) folded before Flop
Seat 6: DYB0aP91n+Rg/TIhycbaPQ (big blind) showed [9c Qc] and lost with three of a kind, Sixes
Seat 8: t2nb95S5EEFOEzNx9Itz0g folded before Flop (didn't bet)
Seat 9: /THNzAxdv2lBxcf4XTj/0g folded before Flop (didn't bet)




PokerStars Game #59939442024:  Hold'em No Limit ($0.10/$0.25) - 2009/07/01 0:39:58 ET
Table 'yAHDCs33TIgw3ra63xuU2Q' 9-max Seat #8 is the button
Seat 1: 8B/dhbQjIWe6ASCdgzktNQ ($26.15 in chips) 
Seat 2: LBrhQVB4w41YNd7kMYn/og ($19.35 in chips) 
Seat 3: H9KUl8cmpLgEpOVDA00bCg ($4.30 in chips) 
Seat 4: rUdM7gwmNCaxMNSb2CFPhQ ($11 in chips) 
Seat 5: 4awUyiDYTgylQKXZ9faBVA ($25 in chips) 
Seat 7: OiV1PWZ3IkN29JlmCcnTwQ ($4.90 in chips) 
Seat 8: tYsOBqdU1+x+yFI7zHO7hQ ($27.75 in chips) 
Seat 9: k+ydNCnnP3Hgwh0AnDYVrA ($14.50 in chips) 
k+ydNCnnP3Hgwh0AnDYVrA: posts small blind $0.10
8B/dhbQjIWe6ASCdgzktNQ: posts big blind $0.25
*** HOLE CARDS ***
LBrhQVB4w41YNd7kMYn/og: folds 
H9KUl8cmpLgEpOVDA00bCg: folds 
rUdM7gwmNCaxMNSb2CFPhQ: folds 
4awUyiDYTgylQKXZ9faBVA: folds 
OiV1PWZ3IkN29JlmCcnTwQ: folds 
tYsOBqdU1+x+yFI7zHO7hQ: raises $0.50 to $0.75
k+ydNCnnP3Hgwh0AnDYVrA: calls $0.65
8B/dhbQjIWe6ASCdgzktNQ: folds 
*** FLOP *** [Th 2d Kh]
k+ydNCnnP3Hgwh0AnDYVrA: checks 
tYsOBqdU1+x+yFI7zHO7hQ: bets $1.25
k+ydNCnnP3Hgwh0AnDYVrA: folds 
Uncalled bet ($1.25) returned to tYsOBqdU1+x+yFI7zHO7hQ
tYsOBqdU1+x+yFI7zHO7hQ collected $1.70 from pot
tYsOBqdU1+x+yFI7zHO7hQ: doesn't show hand 
*** SUMMARY ***
Total pot $1.75 | Rake $0.05 
Board [Th 2d Kh]
Seat 1: 8B/dhbQjIWe6ASCdgzktNQ (big blind) folded before Flop
Seat 2: LBrhQVB4w41YNd7kMYn/og folded before Flop (didn't bet)
Seat 3: H9KUl8cmpLgEpOVDA00bCg folded before Flop (didn't bet)
Seat 4: rUdM7gwmNCaxMNSb2CFPhQ folded before Flop (didn't bet)
Seat 5: 4awUyiDYTgylQKXZ9faBVA folded before Flop (didn't bet)
Seat 7: OiV1PWZ3IkN29JlmCcnTwQ folded before Flop (didn't bet)
Seat 8: tYsOBqdU1+x+yFI7zHO7hQ (button) collected ($1.70)
Seat 9: k+ydNCnnP3Hgwh0AnDYVrA (small blind) folded on the Flop




PokerStars Game #59939441786:  Hold'em No Limit ($0.10/$0.25) - 2009/07/01 0:39:58 ET
Table 'T/iCKJXGphRN3xcdwfE/JQ' 6-max Seat #6 is the button
Seat 1: zZ8zH49EwNs0mqgppOaL9g ($23.25 in chips) 
Seat 2: FHilMb2i2DbUCc9lplszog ($14.55 in chips) 
Seat 3: R6AGToFJQOYVZAjC2jXEKw ($25.85 in chips) 
Seat 4: yzFNNFIfC89bBPwpFPx2ow ($46.25 in chips) 
Seat 6: jKYGBgexhqKT13Xana4EHg ($11.50 in chips) 
zZ8zH49EwNs0mqgppOaL9g: posts small blind $0.10
FHilMb2i2DbUCc9lplszog: posts big blind $0.25
*** HOLE CARDS ***
R6AGToFJQOYVZAjC2jXEKw: raises $0.50 to $0.75
yzFNNFIfC89bBPwpFPx2ow: folds 
jKYGBgexhqKT13Xana4EHg: folds 
zZ8zH49EwNs0mqgppOaL9g: folds 
FHilMb2i2DbUCc9lplszog: calls $0.50
*** FLOP *** [7s Ah 8d]
FHilMb2i2DbUCc9lplszog: checks 
R6AGToFJQOYVZAjC2jXEKw: bets $0.75
FHilMb2i2DbUCc9lplszog: calls $0.75
*** TURN *** [7s Ah 8d] [4h]
FHilMb2i2DbUCc9lplszog: checks 
R6AGToFJQOYVZAjC2jXEKw: checks 
*** RIVER *** [7s Ah 8d 4h] [7h]
FHilMb2i2DbUCc9lplszog: bets $4.50
R6AGToFJQOYVZAjC2jXEKw: folds 
Uncalled bet ($4.50) returned to FHilMb2i2DbUCc9lplszog
FHilMb2i2DbUCc9lplszog collected $2.95 from pot
*** SUMMARY ***
Total pot $3.10 | Rake $0.15 
Board [7s Ah 8d 4h 7h]
Seat 1: zZ8zH49EwNs0mqgppOaL9g (small blind) folded before Flop
Seat 2: FHilMb2i2DbUCc9lplszog (big blind) collected ($2.95)
Seat 3: R6AGToFJQOYVZAjC2jXEKw folded on the River
Seat 4: yzFNNFIfC89bBPwpFPx2ow folded before Flop (didn't bet)
Seat 6: jKYGBgexhqKT13Xana4EHg (button) folded before Flop (didn't bet)




PokerStars Game #59939441904:  Hold'em No Limit ($0.10/$0.25) - 2009/07/01 0:39:58 ET
Table '2O5CgfSkSwrr4PDrlZ1RLQ' 6-max Seat #3 is the button
Seat 1: kyRaCIljYA6l33lSKQfNsg ($47.60 in chips) 
Seat 2: /gJNBeCkWL4o85/jvlZ4BA ($49.75 in chips) 
Seat 3: yzFNNFIfC89bBPwpFPx2ow ($25 in chips) 
Seat 4: 4x9jCqgSw4272dnaIqnanw ($9 in chips) 
Seat 5: AMrBn4Vx9aAo/vv6WHLk6w ($5.40 in chips) 
4x9jCqgSw4272dnaIqnanw: posts small blind $0.10
AMrBn4Vx9aAo/vv6WHLk6w: posts big blind $0.25
tj9xqoqQaDaFw7u1oyZrtA: sits out 
*** HOLE CARDS ***
kyRaCIljYA6l33lSKQfNsg: folds 
/gJNBeCkWL4o85/jvlZ4BA: folds 
yzFNNFIfC89bBPwpFPx2ow: folds 
4x9jCqgSw4272dnaIqnanw: calls $0.15
AMrBn4Vx9aAo/vv6WHLk6w: checks 
*** FLOP *** [Tc 5s 4d]
4x9jCqgSw4272dnaIqnanw: bets $0.25
AMrBn4Vx9aAo/vv6WHLk6w: calls $0.25
*** TURN *** [Tc 5s 4d] [6s]
4x9jCqgSw4272dnaIqnanw: bets $0.25
AMrBn4Vx9aAo/vv6WHLk6w: calls $0.25
*** RIVER *** [Tc 5s 4d 6s] [Ah]
4x9jCqgSw4272dnaIqnanw: bets $1
AMrBn4Vx9aAo/vv6WHLk6w: raises $1 to $2
4x9jCqgSw4272dnaIqnanw: calls $1
*** SHOW DOWN ***
AMrBn4Vx9aAo/vv6WHLk6w: shows [Ac 7d] (a pair of Aces)
4x9jCqgSw4272dnaIqnanw: shows [5d Ad] (two pair, Aces and Fives)
4x9jCqgSw4272dnaIqnanw collected $5.25 from pot
*** SUMMARY ***
Total pot $5.50 | Rake $0.25 
Board [Tc 5s 4d 6s Ah]
Seat 1: kyRaCIljYA6l33lSKQfNsg folded before Flop (didn't bet)
Seat 2: /gJNBeCkWL4o85/jvlZ4BA folded before Flop (didn't bet)
Seat 3: yzFNNFIfC89bBPwpFPx2ow (button) folded before Flop (didn't bet)
Seat 4: 4x9jCqgSw4272dnaIqnanw (small blind) showed [5d Ad] and won ($5.25) with two pair, Aces and Fives
Seat 5: AMrBn4Vx9aAo/vv6WHLk6w (big blind) showed [Ac 7d] and lost with a pair of Aces




PokerStars Game #59939442038:  Hold'em No Limit ($0.10/$0.25) - 2009/07/01 0:39:58 ET
Table '0XPo7K54oZIfG0xlNAcDRwnQC9LRg01NEuKFHF1nrDEw-max Seat #4 is the button
Seat 1: Nj6/PdBvfG79w0yeIjPmmA ($14.45 in chips) 
Seat 2: cPO/1/dTcZpLkQFm3jH3Rg ($32.05 in chips) 
Seat 4: tLM9aw7T3kBEIhQEh1roOg ($6.25 in chips) 
Seat 5: kG34n23qFQA3nzdOJTQ1dA ($29.10 in chips) 
Seat 6: xQVFeVUDopz+akuEo2wXpQ ($46.60 in chips) 
kG34n23qFQA3nzdOJTQ1dA: posts small blind $0.10
xQVFeVUDopz+akuEo2wXpQ: posts big blind $0.25
*** HOLE CARDS ***
Nj6/PdBvfG79w0yeIjPmmA: calls $0.25
cPO/1/dTcZpLkQFm3jH3Rg: folds 
tLM9aw7T3kBEIhQEh1roOg: raises $0.25 to $0.50
kG34n23qFQA3nzdOJTQ1dA: folds 
xQVFeVUDopz+akuEo2wXpQ: folds 
Nj6/PdBvfG79w0yeIjPmmA: calls $0.25
*** FLOP *** [Ac 4d 6d]
Nj6/PdBvfG79w0yeIjPmmA: checks 
tLM9aw7T3kBEIhQEh1roOg: bets $0.25
Nj6/PdBvfG79w0yeIjPmmA: folds 
Uncalled bet ($0.25) returned to tLM9aw7T3kBEIhQEh1roOg
tLM9aw7T3kBEIhQEh1roOg collected $1.30 from pot
*** SUMMARY ***
Total pot $1.35 | Rake $0.05 
Board [Ac 4d 6d]
Seat 1: Nj6/PdBvfG79w0yeIjPmmA folded on the Flop
Seat 2: cPO/1/dTcZpLkQFm3jH3Rg folded before Flop (didn't bet)
Seat 4: tLM9aw7T3kBEIhQEh1roOg (button) collected ($1.30)
Seat 5: kG34n23qFQA3nzdOJTQ1dA (small blind) folded before Flop
Seat 6: xQVFeVUDopz+akuEo2wXpQ (big blind) folded before Flop




PokerStars Game #59939441900:  Hold'em No Limit ($0.10/$0.25) - 2009/07/01 0:39:58 ET
Table 'sDHjMRwfSiz7+NDdZLUiyA' 9-max Seat #8 is the button
Seat 1: N6fYvIzQLKaydFLKQGtMlQ ($25.90 in chips) 
Seat 2: ljemhp25Zg+nlA9DLCIiUw ($27.50 in chips) 
Seat 4: v5jnQ1gfh9nLla3kMXG7Yg ($16.65 in chips) 
Seat 8: 3hMkm4U5yTRrkGJkxfijaQ ($30.20 in chips) 
Seat 9: Xpyqpb+DURDWnyJ3xTEIFQ ($38 in chips) 
Xpyqpb+DURDWnyJ3xTEIFQ: posts small blind $0.10
N6fYvIzQLKaydFLKQGtMlQ: posts big blind $0.25
IGRfskE1v9H9Bn+fz8AgNQ joins the table at seat #5 
SGA1WpAnQxFdFAYyt362gQ: sits out 
*** HOLE CARDS ***
ljemhp25Zg+nlA9DLCIiUw: folds 
v5jnQ1gfh9nLla3kMXG7Yg: folds 
3hMkm4U5yTRrkGJkxfijaQ: calls $0.25
Xpyqpb+DURDWnyJ3xTEIFQ: raises $0.75 to $1
DlXs37dlX3tb7o/7lYXQSw joins the table at seat #6 
N6fYvIzQLKaydFLKQGtMlQ: folds 
3hMkm4U5yTRrkGJkxfijaQ: folds 
Uncalled bet ($0.75) returned to Xpyqpb+DURDWnyJ3xTEIFQ
Xpyqpb+DURDWnyJ3xTEIFQ collected $0.75 from pot
*** SUMMARY ***
Total pot $0.75 | Rake $0 
Seat 1: N6fYvIzQLKaydFLKQGtMlQ (big blind) folded before Flop
Seat 2: ljemhp25Zg+nlA9DLCIiUw folded before Flop (didn't bet)
Seat 4: v5jnQ1gfh9nLla3kMXG7Yg folded before Flop (didn't bet)
Seat 8: 3hMkm4U5yTRrkGJkxfijaQ (button) folded before Flop
Seat 9: Xpyqpb+DURDWnyJ3xTEIFQ (small blind) collected ($0.75)




PokerStars Game #59939442018:  Hold'em No Limit ($0.10/$0.25) - 2009/07/01 0:39:58 ET
Table 'IdXp6nyeW4FYaEK4qKCnwQ' 9-max Seat #7 is the button
Seat 1: oZXtkl8jsN0rrT7D/pQTHA ($13.75 in chips) 
Seat 2: HPEB+AtKw1+C/cxU0o1ciw ($28.90 in chips) 
Seat 6: 1K6QGyJP9P9xmRac2fH4OQ ($33.10 in chips) 
Seat 7: CYkY0dNBaYaKs8HVCVn3mQ ($8.45 in chips) 
Seat 8: cZ99hugmLBj9KhTlc8nCSw ($25 in chips) 
cZ99hugmLBj9KhTlc8nCSw: posts small blind $0.10
oZXtkl8jsN0rrT7D/pQTHA: posts big blind $0.25
*** HOLE CARDS ***
HPEB+AtKw1+C/cxU0o1ciw: folds 
jiyia7h6fmxBdWBkH9lH5A has returned
1K6QGyJP9P9xmRac2fH4OQ: folds 
CYkY0dNBaYaKs8HVCVn3mQ: folds 
cZ99hugmLBj9KhTlc8nCSw: folds 
Uncalled bet ($0.15) returned to oZXtkl8jsN0rrT7D/pQTHA
oZXtkl8jsN0rrT7D/pQTHA collected $0.20 from pot
oZXtkl8jsN0rrT7D/pQTHA: doesn't show hand 
*** SUMMARY ***
Total pot $0.20 | Rake $0 
Seat 1: oZXtkl8jsN0rrT7D/pQTHA (big blind) collected ($0.20)
Seat 2: HPEB+AtKw1+C/cxU0o1ciw folded before Flop (didn't bet)
Seat 6: 1K6QGyJP9P9xmRac2fH4OQ folded before Flop (didn't bet)
Seat 7: CYkY0dNBaYaKs8HVCVn3mQ (button) folded before Flop (didn't bet)
Seat 8: cZ99hugmLBj9KhTlc8nCSw (small blind) folded before Flop




PokerStars Game #59939442694:  Hold'em No Limit ($0.10/$0.25) - 2009/07/01 0:39:59 ET
Table 'NtCSSONEf1zaJo3042tQug' 6-max Seat #5 is the button
Seat 1: pdS3fOhVgLVaTP0O0GlIvw ($11.55 in chips) 
Seat 2: nbv8IVGAEHbfjk01ulU6ow ($19.20 in chips) 
Seat 3: d0J1xuhsynEY81YHwAvJ5g ($25 in chips) 
Seat 4: dOX4wnYV2sEqvDbF+8KSCw ($25.15 in chips) 
Seat 5: l/t3k8+r77gRew8U2BJs4Q ($3.40 in chips) 
Seat 6: LxehwDpTQ19ph4Qmc78+Pw ($21.50 in chips) 
LxehwDpTQ19ph4Qmc78+Pw: posts small blind $0.10
pdS3fOhVgLVaTP0O0GlIvw: posts big blind $0.25
*** HOLE CARDS ***
nbv8IVGAEHbfjk01ulU6ow: raises $0.50 to $0.75
d0J1xuhsynEY81YHwAvJ5g: folds 
dOX4wnYV2sEqvDbF+8KSCw: folds 
l/t3k8+r77gRew8U2BJs4Q: folds 
LxehwDpTQ19ph4Qmc78+Pw: calls $0.65
pdS3fOhVgLVaTP0O0GlIvw: folds 
*** FLOP *** [4s 5c 5h]
LxehwDpTQ19ph4Qmc78+Pw: checks 
nbv8IVGAEHbfjk01ulU6ow: bets $1.50
LxehwDpTQ19ph4Qmc78+Pw: folds 
Uncalled bet ($1.50) returned to nbv8IVGAEHbfjk01ulU6ow
nbv8IVGAEHbfjk01ulU6ow collected $1.70 from pot
*** SUMMARY ***
Total pot $1.75 | Rake $0.05 
Board [4s 5c 5h]
Seat 1: pdS3fOhVgLVaTP0O0GlIvw (big blind) folded before Flop
Seat 2: nbv8IVGAEHbfjk01ulU6ow collected ($1.70)
Seat 3: d0J1xuhsynEY81YHwAvJ5g folded before Flop (didn't bet)
Seat 4: dOX4wnYV2sEqvDbF+8KSCw folded before Flop (didn't bet)
Seat 5: l/t3k8+r77gRew8U2BJs4Q (button) folded before Flop (didn't bet)
Seat 6: LxehwDpTQ19ph4Qmc78+Pw (small blind) folded on the Flop




PokerStars Game #59939442294:  Hold'em No Limit ($0.10/$0.25) - 2009/07/01 0:39:59 ET
Table 'LLHSnYPAXNI1sFlwPBn1tA' 6-max Seat #6 is the button
Seat 1: tVZW8k4GP+PvZ1DjD/9StA ($11 in chips) 
Seat 2: oseFhpinoe+Zg4j5xyBjyQ ($24.55 in chips) 
Seat 3: JFIAqU8lCZ0vWwEl4bdGsg ($28.15 in chips) 
Seat 4: FPlQHZog0ePFCETQ2KG4hQ ($27.20 in chips) 
Seat 5: jXbd3O6QdeNWctmpAsTgHA ($14.40 in chips) 
Seat 6: PCh4iIHq9rXvWY/FeXc/Jg ($31.25 in chips) 
tVZW8k4GP+PvZ1DjD/9StA: posts small blind $0.10
oseFhpinoe+Zg4j5xyBjyQ: posts big blind $0.25
*** HOLE CARDS ***
JFIAqU8lCZ0vWwEl4bdGsg: calls $0.25
FPlQHZog0ePFCETQ2KG4hQ: folds 
jXbd3O6QdeNWctmpAsTgHA: folds 
PCh4iIHq9rXvWY/FeXc/Jg: calls $0.25
tVZW8k4GP+PvZ1DjD/9StA: calls $0.15
oseFhpinoe+Zg4j5xyBjyQ: checks 
*** FLOP *** [2c 3h As]
tVZW8k4GP+PvZ1DjD/9StA: checks 
oseFhpinoe+Zg4j5xyBjyQ: checks 
JFIAqU8lCZ0vWwEl4bdGsg: checks 
PCh4iIHq9rXvWY/FeXc/Jg: checks 
*** TURN *** [2c 3h As] [9c]
tVZW8k4GP+PvZ1DjD/9StA: checks 
oseFhpinoe+Zg4j5xyBjyQ: checks 
JFIAqU8lCZ0vWwEl4bdGsg: checks 
PCh4iIHq9rXvWY/FeXc/Jg: checks 
*** RIVER *** [2c 3h As 9c] [Jh]
tVZW8k4GP+PvZ1DjD/9StA: checks 
oseFhpinoe+Zg4j5xyBjyQ: checks 
JFIAqU8lCZ0vWwEl4bdGsg: checks 
PCh4iIHq9rXvWY/FeXc/Jg: checks 
*** SHOW DOWN ***
tVZW8k4GP+PvZ1DjD/9StA: shows [5s Ks] (high card Ace)
oseFhpinoe+Zg4j5xyBjyQ: mucks hand 
JFIAqU8lCZ0vWwEl4bdGsg: mucks hand 
PCh4iIHq9rXvWY/FeXc/Jg: shows [Kh 8c] (high card Ace - King+Jack+Nine+Eight kicker)
PCh4iIHq9rXvWY/FeXc/Jg collected $0.95 from pot
*** SUMMARY ***
Total pot $1 | Rake $0.05 
Board [2c 3h As 9c Jh]
Seat 1: tVZW8k4GP+PvZ1DjD/9StA (small blind) showed [5s Ks] and lost with high card Ace
Seat 2: oseFhpinoe+Zg4j5xyBjyQ (big blind) mucked
Seat 3: JFIAqU8lCZ0vWwEl4bdGsg mucked
Seat 4: FPlQHZog0ePFCETQ2KG4hQ folded before Flop (didn't bet)
Seat 5: jXbd3O6QdeNWctmpAsTgHA folded before Flop (didn't bet)
Seat 6: PCh4iIHq9rXvWY/FeXc/Jg (button) showed [Kh 8c] and won ($0.95) with high card Ace




PokerStars Game #59939442292:  Hold'em No Limit ($0.10/$0.25) - 2009/07/01 0:39:59 ET
Table 'QegsWX65l3n/K0A8XB78yg' 6-max Seat #2 is the button
Seat 1: 8ClCHtFXGNplITm+63KB+Q ($29.30 in chips) 
Seat 2: GC/9yVD59DUCX7hUI7gcLw ($31.85 in chips) 
Seat 3: 9jSiy0meE9XJKkdIZwyTEQ ($25 in chips) 
Seat 4: kyRaCIljYA6l33lSKQfNsg ($25 in chips) 
Seat 5: 4YSTu0Cdzpppe1lUgCZGCQ ($56.25 in chips) 
Seat 6: JE/wJXmjw3bpdmjwvh2pcg ($37.50 in chips) 
9jSiy0meE9XJKkdIZwyTEQ: posts small blind $0.10
kyRaCIljYA6l33lSKQfNsg: posts big blind $0.25
*** HOLE CARDS ***
4YSTu0Cdzpppe1lUgCZGCQ: folds 
JE/wJXmjw3bpdmjwvh2pcg: folds 
8ClCHtFXGNplITm+63KB+Q: folds 
GC/9yVD59DUCX7hUI7gcLw: raises $0.75 to $1
9jSiy0meE9XJKkdIZwyTEQ: folds 
kyRaCIljYA6l33lSKQfNsg: folds 
Uncalled bet ($0.75) returned to GC/9yVD59DUCX7hUI7gcLw
GC/9yVD59DUCX7hUI7gcLw collected $0.60 from pot
*** SUMMARY ***
Total pot $0.60 | Rake $0 
Seat 1: 8ClCHtFXGNplITm+63KB+Q folded before Flop (didn't bet)
Seat 2: GC/9yVD59DUCX7hUI7gcLw (button) collected ($0.60)
Seat 3: 9jSiy0meE9XJKkdIZwyTEQ (small blind) folded before Flop
Seat 4: kyRaCIljYA6l33lSKQfNsg (big blind) folded before Flop
Seat 5: 4YSTu0Cdzpppe1lUgCZGCQ folded before Flop (didn't bet)
Seat 6: JE/wJXmjw3bpdmjwvh2pcg folded before Flop (didn't bet)




PokerStars Game #59939442666:  Hold'em No Limit ($0.10/$0.25) - 2009/07/01 0:39:59 ET
Table 'Jz+kWRxWNGk9w24fdQEveA' 9-max Seat #8 is the button
Seat 1: 1K6QGyJP9P9xmRac2fH4OQ ($25.80 in chips) 
Seat 2: ljemhp25Zg+nlA9DLCIiUw ($28.90 in chips) 
Seat 4: HPEB+AtKw1+C/cxU0o1ciw ($24.45 in chips) 
Seat 5: DdPXdieucQ+n99u1n3A+rQ ($5 in chips) 
Seat 6: boms8cM+kQJF0xGLbvuFtg ($10.40 in chips) 
Seat 7: st9jtdNbm1W5GfBwRaCVqQ ($31.35 in chips) 
Seat 8: G7adEXZse2f4gqTWfn/C+Q ($11.30 in chips) 
Seat 9: z7SDvPqXQA6iOv0833Gpig ($12.70 in chips) 
z7SDvPqXQA6iOv0833Gpig: posts small blind $0.10
1K6QGyJP9P9xmRac2fH4OQ: posts big blind $0.25
*** HOLE CARDS ***
ljemhp25Zg+nlA9DLCIiUw: folds 
HPEB+AtKw1+C/cxU0o1ciw: folds 
DdPXdieucQ+n99u1n3A+rQ: folds 
boms8cM+kQJF0xGLbvuFtg: calls $0.25
st9jtdNbm1W5GfBwRaCVqQ: folds 
G7adEXZse2f4gqTWfn/C+Q: folds 
z7SDvPqXQA6iOv0833Gpig: calls $0.15
1K6QGyJP9P9xmRac2fH4OQ: checks 
*** FLOP *** [5c Ad 6h]
z7SDvPqXQA6iOv0833Gpig: checks 
1K6QGyJP9P9xmRac2fH4OQ: checks 
boms8cM+kQJF0xGLbvuFtg: checks 
*** TURN *** [5c Ad 6h] [5h]
z7SDvPqXQA6iOv0833Gpig: checks 
1K6QGyJP9P9xmRac2fH4OQ: checks 
boms8cM+kQJF0xGLbvuFtg: checks 
*** RIVER *** [5c Ad 6h 5h] [Qc]
z7SDvPqXQA6iOv0833Gpig: bets $0.25
1K6QGyJP9P9xmRac2fH4OQ: folds 
boms8cM+kQJF0xGLbvuFtg: folds 
Uncalled bet ($0.25) returned to z7SDvPqXQA6iOv0833Gpig
z7SDvPqXQA6iOv0833Gpig collected $0.75 from pot
*** SUMMARY ***
Total pot $0.75 | Rake $0 
Board [5c Ad 6h 5h Qc]
Seat 1: 1K6QGyJP9P9xmRac2fH4OQ (big blind) folded on the River
Seat 2: ljemhp25Zg+nlA9DLCIiUw folded before Flop (didn't bet)
Seat 4: HPEB+AtKw1+C/cxU0o1ciw folded before Flop (didn't bet)
Seat 5: DdPXdieucQ+n99u1n3A+rQ folded before Flop (didn't bet)
Seat 6: boms8cM+kQJF0xGLbvuFtg folded on the River
Seat 7: st9jtdNbm1W5GfBwRaCVqQ folded before Flop (didn't bet)
Seat 8: G7adEXZse2f4gqTWfn/C+Q (button) folded before Flop (didn't bet)
Seat 9: z7SDvPqXQA6iOv0833Gpig (small blind) collected ($0.75)




PokerStars Game #59939442356:  Hold'em No Limit ($0.10/$0.25) - 2009/07/01 0:39:59 ET
Table '1HT8bEDpLPhOXxmqMtzF8w' 9-max Seat #3 is the button
Seat 1: s7Q6uNouhe7aE8JdFb9E+A ($26.20 in chips) 
Seat 2: r6hsffOo1iKmaPYKwAZmFw ($32.15 in chips) 
Seat 3: UJbH2fMMSFUo/jbJteWjjQ ($4.75 in chips) 
Seat 4: Hlc+zGHlRwk7JHfQklkT2g ($8.05 in chips) 
Seat 5: +iRmxp/CsJ/zuqdUG3CXNw ($6.70 in chips) 
Seat 6: 4oA316mXLIui1QY63GXBUg ($25 in chips) 
Seat 7: DIBbjEYGs+TVdVgEB/4+3w ($30.60 in chips) 
Seat 8: ghNKXUBl/H+t83JF079ZBA ($25 in chips) 
Seat 9: 86vbuhJsyH+nbEg5qpDLyQ ($21.50 in chips) 
Hlc+zGHlRwk7JHfQklkT2g: posts small blind $0.10
+iRmxp/CsJ/zuqdUG3CXNw: posts big blind $0.25
*** HOLE CARDS ***
4oA316mXLIui1QY63GXBUg: folds 
DIBbjEYGs+TVdVgEB/4+3w: calls $0.25
ghNKXUBl/H+t83JF079ZBA: folds 
86vbuhJsyH+nbEg5qpDLyQ: folds 
s7Q6uNouhe7aE8JdFb9E+A: folds 
r6hsffOo1iKmaPYKwAZmFw: raises $1 to $1.25
UJbH2fMMSFUo/jbJteWjjQ: folds 
Hlc+zGHlRwk7JHfQklkT2g: calls $1.15
+iRmxp/CsJ/zuqdUG3CXNw: calls $1
DIBbjEYGs+TVdVgEB/4+3w: folds 
*** FLOP *** [9s 3s Ks]
Hlc+zGHlRwk7JHfQklkT2g: checks 
+iRmxp/CsJ/zuqdUG3CXNw: bets $5.45 and is all-in
r6hsffOo1iKmaPYKwAZmFw: folds 
Hlc+zGHlRwk7JHfQklkT2g: calls $5.45
*** TURN *** [9s 3s Ks] [Kh]
*** RIVER *** [9s 3s Ks Kh] [2d]
*** SHOW DOWN ***
Hlc+zGHlRwk7JHfQklkT2g: shows [9c 9h] (a full house, Nines full of Kings)
+iRmxp/CsJ/zuqdUG3CXNw: mucks hand 
Hlc+zGHlRwk7JHfQklkT2g collected $14.20 from pot
*** SUMMARY ***
Total pot $14.90 | Rake $0.70 
Board [9s 3s Ks Kh 2d]
Seat 1: s7Q6uNouhe7aE8JdFb9E+A folded before Flop (didn't bet)
Seat 2: r6hsffOo1iKmaPYKwAZmFw folded on the Flop
Seat 3: UJbH2fMMSFUo/jbJteWjjQ (button) folded before Flop (didn't bet)
Seat 4: Hlc+zGHlRwk7JHfQklkT2g (small blind) showed [9c 9h] and won ($14.20) with a full house, Nines full of Kings
Seat 5: +iRmxp/CsJ/zuqdUG3CXNw (big blind) mucked
Seat 6: 4oA316mXLIui1QY63GXBUg folded before Flop (didn't bet)
Seat 7: DIBbjEYGs+TVdVgEB/4+3w folded before Flop
Seat 8: ghNKXUBl/H+t83JF079ZBA folded before Flop (didn't bet)
Seat 9: 86vbuhJsyH+nbEg5qpDLyQ folded before Flop (didn't bet)




PokerStars Game #59939443140:  Hold'em No Limit ($0.10/$0.25) - 2009/07/01 0:40:00 ET
Table 'vud0GB/ZlDCvUFhBFIaTlg' 9-max Seat #5 is the button
Seat 5: AwAabNdwDsTMb3aTomdOmg ($6.55 in chips) 
Seat 7: RzaVufWfW9CTnVYR7/Ge+w ($1.70 in chips) 
AwAabNdwDsTMb3aTomdOmg: posts small blind $0.10
RzaVufWfW9CTnVYR7/Ge+w: posts big blind $0.25
*** HOLE CARDS ***
AwAabNdwDsTMb3aTomdOmg: raises $0.25 to $0.50
RzaVufWfW9CTnVYR7/Ge+w: calls $0.25
*** FLOP *** [Tc 2h Qc]
RzaVufWfW9CTnVYR7/Ge+w: checks 
AwAabNdwDsTMb3aTomdOmg: bets $0.75
RzaVufWfW9CTnVYR7/Ge+w: folds 
Uncalled bet ($0.75) returned to AwAabNdwDsTMb3aTomdOmg
AwAabNdwDsTMb3aTomdOmg collected $0.95 from pot
*** SUMMARY ***
Total pot $1 | Rake $0.05 
Board [Tc 2h Qc]
Seat 5: AwAabNdwDsTMb3aTomdOmg (button) (small blind) collected ($0.95)
Seat 7: RzaVufWfW9CTnVYR7/Ge+w (big blind) folded on the Flop




PokerStars Game #59939443410:  Hold'em No Limit ($0.10/$0.25) - 2009/07/01 0:40:00 ET
Table 'fvoGXKLawfAadYn02raohg' 9-max Seat #8 is the button
Seat 1: DIBbjEYGs+TVdVgEB/4+3w ($39.50 in chips) 
Seat 2: Ud3KoJmky17jahFh5jxdNA ($16 in chips) 
Seat 3: aNpwfA31EREwO+ar4XzBCw ($25 in chips) 
Seat 4: uibjYTUZq0zsChpZ84TeGQ ($13.60 in chips) 
Seat 5: 1Uq1Gp+AloSwO4jVgEdX+A ($25.85 in chips) 
Seat 6: SXqVW4Q0evTUVZG6BbUNIA ($31.25 in chips) 
Seat 7: 18G4P1XstjNvItdGUITxgw ($25.45 in chips) 
Seat 8: 4GJMmHGKzu+gVtalqRy7dA ($12.85 in chips) 
Seat 9: JKfTHkCJ+e5tjUU+K32h1A ($14.85 in chips) 
JKfTHkCJ+e5tjUU+K32h1A: posts small blind $0.10
DIBbjEYGs+TVdVgEB/4+3w: posts big blind $0.25
*** HOLE CARDS ***
Ud3KoJmky17jahFh5jxdNA: calls $0.25
aNpwfA31EREwO+ar4XzBCw: folds 
uibjYTUZq0zsChpZ84TeGQ: calls $0.25
1Uq1Gp+AloSwO4jVgEdX+A: folds 
SXqVW4Q0evTUVZG6BbUNIA: folds 
18G4P1XstjNvItdGUITxgw: folds 
4GJMmHGKzu+gVtalqRy7dA: folds 
JKfTHkCJ+e5tjUU+K32h1A: calls $0.15
DIBbjEYGs+TVdVgEB/4+3w: checks 
*** FLOP *** [2c 9d Kh]
JKfTHkCJ+e5tjUU+K32h1A: checks 
DIBbjEYGs+TVdVgEB/4+3w: checks 
Ud3KoJmky17jahFh5jxdNA: checks 
uibjYTUZq0zsChpZ84TeGQ: bets $1
JKfTHkCJ+e5tjUU+K32h1A: folds 
DIBbjEYGs+TVdVgEB/4+3w: folds 
Ud3KoJmky17jahFh5jxdNA: folds 
Uncalled bet ($1) returned to uibjYTUZq0zsChpZ84TeGQ
uibjYTUZq0zsChpZ84TeGQ collected $0.95 from pot
uibjYTUZq0zsChpZ84TeGQ: doesn't show hand 
*** SUMMARY ***
Total pot $1 | Rake $0.05 
Board [2c 9d Kh]
Seat 1: DIBbjEYGs+TVdVgEB/4+3w (big blind) folded on the Flop
Seat 2: Ud3KoJmky17jahFh5jxdNA folded on the Flop
Seat 3: aNpwfA31EREwO+ar4XzBCw folded before Flop (didn't bet)
Seat 4: uibjYTUZq0zsChpZ84TeGQ collected ($0.95)
Seat 5: 1Uq1Gp+AloSwO4jVgEdX+A folded before Flop (didn't bet)
Seat 6: SXqVW4Q0evTUVZG6BbUNIA folded before Flop (didn't bet)
Seat 7: 18G4P1XstjNvItdGUITxgw folded before Flop (didn't bet)
Seat 8: 4GJMmHGKzu+gVtalqRy7dA (button) folded before Flop (didn't bet)
Seat 9: JKfTHkCJ+e5tjUU+K32h1A (small blind) folded on the Flop




PokerStars Game #59939442978:  Hold'em No Limit ($0.10/$0.25) - 2009/07/01 0:40:00 ET
Table 'XX2OuOsa8/8AC+/mR/Az6g' 9-max Seat #7 is the button
Seat 1: 56S3mA6Zs3pGR+0p0vUCtg ($25 in chips) 
Seat 2: MIVCHqCqqlke0Lb0z7glcw ($24.65 in chips) 
Seat 3: PJJTm/ccITEBlwPReiBTwg ($12.65 in chips) 
Seat 4: uLP/lYn7oKq9xCChBXsXxw ($24.75 in chips) 
Seat 5: jXz58rvCgq0VjyVjUBf2mw ($24.05 in chips) 
Seat 6: gT0nY7XiR+2FA+B3F4h8HQ ($25.35 in chips) 
Seat 7: zDrucyjVn5aeekNEc3cJrA ($20.70 in chips) 
Seat 9: 86vbuhJsyH+nbEg5qpDLyQ ($43.55 in chips) 
qwr38jl5txoR36M7G5qi4A will be allowed to play after the button
86vbuhJsyH+nbEg5qpDLyQ: posts small blind $0.10
56S3mA6Zs3pGR+0p0vUCtg: posts big blind $0.25
*** HOLE CARDS ***
MIVCHqCqqlke0Lb0z7glcw: folds 
PJJTm/ccITEBlwPReiBTwg: raises $0.50 to $0.75
uLP/lYn7oKq9xCChBXsXxw: folds 
jXz58rvCgq0VjyVjUBf2mw: folds 
gT0nY7XiR+2FA+B3F4h8HQ: folds 
zDrucyjVn5aeekNEc3cJrA: folds 
86vbuhJsyH+nbEg5qpDLyQ: folds 
56S3mA6Zs3pGR+0p0vUCtg: folds 
Uncalled bet ($0.50) returned to PJJTm/ccITEBlwPReiBTwg
PJJTm/ccITEBlwPReiBTwg collected $0.60 from pot
*** SUMMARY ***
Total pot $0.60 | Rake $0 
Seat 1: 56S3mA6Zs3pGR+0p0vUCtg (big blind) folded before Flop
Seat 2: MIVCHqCqqlke0Lb0z7glcw folded before Flop (didn't bet)
Seat 3: PJJTm/ccITEBlwPReiBTwg collected ($0.60)
Seat 4: uLP/lYn7oKq9xCChBXsXxw folded before Flop (didn't bet)
Seat 5: jXz58rvCgq0VjyVjUBf2mw folded before Flop (didn't bet)
Seat 6: gT0nY7XiR+2FA+B3F4h8HQ folded before Flop (didn't bet)
Seat 7: zDrucyjVn5aeekNEc3cJrA (button) folded before Flop (didn't bet)
Seat 9: 86vbuhJsyH+nbEg5qpDLyQ (small blind) folded before Flop




PokerStars Game #59939443156:  Hold'em No Limit ($0.10/$0.25) - 2009/07/01 0:40:00 ET
Table 'Do4nrTNDYpK3sQjwFxX+Og' 6-max Seat #3 is the button
Seat 1: 7JrQNOR9wRBxq9ijFhWieg ($25.70 in chips) 
Seat 2: tzMoGl9F0PUr5NibYueeSw ($44.15 in chips) 
Seat 3: TSmua8tGK3sTbwi0ynrW9Q ($31.80 in chips) 
Seat 4: df7bIV965hvGEDiUAs5cfQ ($18.30 in chips) 
Seat 5: Ew/TYPQIsbQ2X8nm5iAJBg ($29.75 in chips) 
Seat 6: eHsmIvAb2JREg4O6hNPnXg ($24.45 in chips) 
df7bIV965hvGEDiUAs5cfQ: posts small blind $0.10
Ew/TYPQIsbQ2X8nm5iAJBg: posts big blind $0.25
*** HOLE CARDS ***
eHsmIvAb2JREg4O6hNPnXg: folds 
7JrQNOR9wRBxq9ijFhWieg: folds 
tzMoGl9F0PUr5NibYueeSw: folds 
TSmua8tGK3sTbwi0ynrW9Q: raises $0.50 to $0.75
df7bIV965hvGEDiUAs5cfQ: calls $0.65
Ew/TYPQIsbQ2X8nm5iAJBg: raises $2 to $2.75
TSmua8tGK3sTbwi0ynrW9Q: folds 
df7bIV965hvGEDiUAs5cfQ: folds 
Uncalled bet ($2) returned to Ew/TYPQIsbQ2X8nm5iAJBg
Ew/TYPQIsbQ2X8nm5iAJBg collected $2.25 from pot
Ew/TYPQIsbQ2X8nm5iAJBg: doesn't show hand 
*** SUMMARY ***
Total pot $2.25 | Rake $0 
Seat 1: 7JrQNOR9wRBxq9ijFhWieg folded before Flop (didn't bet)
Seat 2: tzMoGl9F0PUr5NibYueeSw folded before Flop (didn't bet)
Seat 3: TSmua8tGK3sTbwi0ynrW9Q (button) folded before Flop
Seat 4: df7bIV965hvGEDiUAs5cfQ (small blind) folded before Flop
Seat 5: Ew/TYPQIsbQ2X8nm5iAJBg (big blind) collected ($2.25)
Seat 6: eHsmIvAb2JREg4O6hNPnXg folded before Flop (didn't bet)




PokerStars Game #59939443276:  Hold'em No Limit ($0.10/$0.25) - 2009/07/01 0:40:00 ET
Table 'AHkg4ChqzcMauBx6Qvz8Nw' 6-max Seat #5 is the button
Seat 1: b32FRB7ak2jmfrI8EsDhfQ ($5.80 in chips) 
Seat 2: /bjna2FTN7pPjqYGzmDE0Q ($22.05 in chips) 
Seat 3: Zi4SmoY9XJ0iI6ixiSZaWQ ($9 in chips) 
Seat 4: N7O9jUEx2YiQn1+yRYTHmw ($26.35 in chips) 
Seat 5: LtASJ9OlkqGrrUKGQlpGAw ($37.05 in chips) 
Seat 6: SFmT9ZsVopnukjvAzrxTRg ($53.15 in chips) 
SFmT9ZsVopnukjvAzrxTRg: posts small blind $0.10
b32FRB7ak2jmfrI8EsDhfQ: posts big blind $0.25
*** HOLE CARDS ***
/bjna2FTN7pPjqYGzmDE0Q: folds 
Zi4SmoY9XJ0iI6ixiSZaWQ: calls $0.25
N7O9jUEx2YiQn1+yRYTHmw: calls $0.25
LtASJ9OlkqGrrUKGQlpGAw: folds 
SFmT9ZsVopnukjvAzrxTRg: folds 
b32FRB7ak2jmfrI8EsDhfQ: raises $5.55 to $5.80 and is all-in
Zi4SmoY9XJ0iI6ixiSZaWQ: folds 
N7O9jUEx2YiQn1+yRYTHmw: folds 
Uncalled bet ($5.55) returned to b32FRB7ak2jmfrI8EsDhfQ
b32FRB7ak2jmfrI8EsDhfQ collected $0.85 from pot
*** SUMMARY ***
Total pot $0.85 | Rake $0 
Seat 1: b32FRB7ak2jmfrI8EsDhfQ (big blind) collected ($0.85)
Seat 2: /bjna2FTN7pPjqYGzmDE0Q folded before Flop (didn't bet)
Seat 3: Zi4SmoY9XJ0iI6ixiSZaWQ folded before Flop
Seat 4: N7O9jUEx2YiQn1+yRYTHmw folded before Flop
Seat 5: LtASJ9OlkqGrrUKGQlpGAw (button) folded before Flop (didn't bet)
Seat 6: SFmT9ZsVopnukjvAzrxTRg (small blind) folded before Flop




PokerStars Game #59939443414:  Hold'em No Limit ($0.10/$0.25) - 2009/07/01 0:40:00 ET
Table '/XCUCUl3yW6tdTJQEhJKGw' 6-max Seat #2 is the button
Seat 1: p8J112JmNRnCwV2+NAEzCA ($15.30 in chips) 
Seat 2: 8ClCHtFXGNplITm+63KB+Q ($27.95 in chips) 
Seat 3: /gJNBeCkWL4o85/jvlZ4BA ($35.35 in chips) 
Seat 4: SFmT9ZsVopnukjvAzrxTRg ($25.35 in chips) 
Seat 5: 3rlIjSrvbZoI2IILbnetnA ($25 in chips) 
Seat 6: armfxZhGxeZVZBYAQFuIJQ ($36.45 in chips) 
/gJNBeCkWL4o85/jvlZ4BA: posts small blind $0.10
SFmT9ZsVopnukjvAzrxTRg: posts big blind $0.25
*** HOLE CARDS ***
3rlIjSrvbZoI2IILbnetnA: folds 
armfxZhGxeZVZBYAQFuIJQ: folds 
p8J112JmNRnCwV2+NAEzCA: folds 
8ClCHtFXGNplITm+63KB+Q: folds 
/gJNBeCkWL4o85/jvlZ4BA: raises $0.75 to $1
SFmT9ZsVopnukjvAzrxTRg: calls $0.75
*** FLOP *** [4h 3c 7c]
/gJNBeCkWL4o85/jvlZ4BA: checks 
SFmT9ZsVopnukjvAzrxTRg: checks 
*** TURN *** [4h 3c 7c] [Jd]
/gJNBeCkWL4o85/jvlZ4BA: bets $1.25
SFmT9ZsVopnukjvAzrxTRg: folds 
Uncalled bet ($1.25) returned to /gJNBeCkWL4o85/jvlZ4BA
/gJNBeCkWL4o85/jvlZ4BA collected $1.90 from pot
*** SUMMARY ***
Total pot $2 | Rake $0.10 
Board [4h 3c 7c Jd]
Seat 1: p8J112JmNRnCwV2+NAEzCA folded before Flop (didn't bet)
Seat 2: 8ClCHtFXGNplITm+63KB+Q (button) folded before Flop (didn't bet)
Seat 3: /gJNBeCkWL4o85/jvlZ4BA (small blind) collected ($1.90)
Seat 4: SFmT9ZsVopnukjvAzrxTRg (big blind) folded on the Turn
Seat 5: 3rlIjSrvbZoI2IILbnetnA folded before Flop (didn't bet)
Seat 6: armfxZhGxeZVZBYAQFuIJQ folded before Flop (didn't bet)




PokerStars Game #59939443092:  Hold'em No Limit ($0.10/$0.25) - 2009/07/01 0:40:00 ET
Table 'APEHQjIcZHDZUA4iOjju2g' 6-max Seat #1 is the button
Seat 1: eHsmIvAb2JREg4O6hNPnXg ($8 in chips) 
Seat 2: 3zD3qLXT1bEffAoWGnc7wg ($25.10 in chips) 
Seat 3: E7KSkgfIsmIsp0vLnmGFmA ($13.40 in chips) 
Seat 4: EqXTTLKUlDlz7yi6ziyyWA ($35.40 in chips) 
Seat 5: /xN6gc9+8Hew0HxaB6VIVg ($32.10 in chips) 
Seat 6: y7HCJfEmolBCFdi/0j5TRg ($44.70 in chips) 
3zD3qLXT1bEffAoWGnc7wg: posts small blind $0.10
E7KSkgfIsmIsp0vLnmGFmA: posts big blind $0.25
*** HOLE CARDS ***
EqXTTLKUlDlz7yi6ziyyWA: folds 
/xN6gc9+8Hew0HxaB6VIVg: calls $0.25
y7HCJfEmolBCFdi/0j5TRg: folds 
eHsmIvAb2JREg4O6hNPnXg: folds 
3zD3qLXT1bEffAoWGnc7wg: folds 
E7KSkgfIsmIsp0vLnmGFmA: checks 
*** FLOP *** [7c Kh 5d]
E7KSkgfIsmIsp0vLnmGFmA: checks 
/xN6gc9+8Hew0HxaB6VIVg: checks 
*** TURN *** [7c Kh 5d] [6h]
E7KSkgfIsmIsp0vLnmGFmA: bets $0.25
/xN6gc9+8Hew0HxaB6VIVg: calls $0.25
*** RIVER *** [7c Kh 5d 6h] [Th]
E7KSkgfIsmIsp0vLnmGFmA: bets $0.25
/xN6gc9+8Hew0HxaB6VIVg: folds 
Uncalled bet ($0.25) returned to E7KSkgfIsmIsp0vLnmGFmA
E7KSkgfIsmIsp0vLnmGFmA collected $1.05 from pot
E7KSkgfIsmIsp0vLnmGFmA: doesn't show hand 
*** SUMMARY ***
Total pot $1.10 | Rake $0.05 
Board [7c Kh 5d 6h Th]
Seat 1: eHsmIvAb2JREg4O6hNPnXg (button) folded before Flop (didn't bet)
Seat 2: 3zD3qLXT1bEffAoWGnc7wg (small blind) folded before Flop
Seat 3: E7KSkgfIsmIsp0vLnmGFmA (big blind) collected ($1.05)
Seat 4: EqXTTLKUlDlz7yi6ziyyWA folded before Flop (didn't bet)
Seat 5: /xN6gc9+8Hew0HxaB6VIVg folded on the River
Seat 6: y7HCJfEmolBCFdi/0j5TRg folded before Flop (didn't bet)




PokerStars Game #59939442976:  Hold'em No Limit ($0.10/$0.25) - 2009/07/01 0:40:00 ET
Table 'nc6OeGk/wtaWV+6N+kgnZQ' 6-max Seat #6 is the button
Seat 1: 0/FYfBoKhINaqU/H5OSS1A ($4.60 in chips) 
Seat 3: 8f0dtuUGqDbgE6up1lQAlg ($3.75 in chips) 
Seat 6: yJgjVkWgiJ8vdWZjcUod2A ($6.45 in chips) 
0/FYfBoKhINaqU/H5OSS1A: posts small blind $0.10
8f0dtuUGqDbgE6up1lQAlg: posts big blind $0.25
*** HOLE CARDS ***
yJgjVkWgiJ8vdWZjcUod2A: raises $0.50 to $0.75
0/FYfBoKhINaqU/H5OSS1A: folds 
8f0dtuUGqDbgE6up1lQAlg: folds 
Uncalled bet ($0.50) returned to yJgjVkWgiJ8vdWZjcUod2A
yJgjVkWgiJ8vdWZjcUod2A collected $0.60 from pot
yJgjVkWgiJ8vdWZjcUod2A: doesn't show hand 
*** SUMMARY ***
Total pot $0.60 | Rake $0 
Seat 1: 0/FYfBoKhINaqU/H5OSS1A (small blind) folded before Flop
Seat 3: 8f0dtuUGqDbgE6up1lQAlg (big blind) folded before Flop
Seat 6: yJgjVkWgiJ8vdWZjcUod2A (button) collected ($0.60)




PokerStars Game #59939443738:  Hold'em No Limit ($0.10/$0.25) - 2009/07/01 0:40:01 ET
Table 'JJzUs04lHpXg6nboT1/jeg' 6-max Seat #3 is the button
Seat 3: uUXdcVMNa05rfbntdvplfw ($10.95 in chips) 
Seat 4: nwwpaieDRI0UPyVtChVHOg ($36.10 in chips) 
Seat 5: Vr2XE7yYBdg3RZSURDAPEg ($23.50 in chips) 
nwwpaieDRI0UPyVtChVHOg: posts small blind $0.10
Vr2XE7yYBdg3RZSURDAPEg: posts big blind $0.25
mK0/8tWLTEGESD/9ZUEo5A: sits out 
*** HOLE CARDS ***
uUXdcVMNa05rfbntdvplfw: folds 
nwwpaieDRI0UPyVtChVHOg: calls $0.15
Vr2XE7yYBdg3RZSURDAPEg: checks 
*** FLOP *** [7h Tc Kh]
nwwpaieDRI0UPyVtChVHOg: checks 
Vr2XE7yYBdg3RZSURDAPEg: checks 
*** TURN *** [7h Tc Kh] [3s]
nwwpaieDRI0UPyVtChVHOg: checks 
Vr2XE7yYBdg3RZSURDAPEg: checks 
*** RIVER *** [7h Tc Kh 3s] [5h]
nwwpaieDRI0UPyVtChVHOg: checks 
Vr2XE7yYBdg3RZSURDAPEg: bets $1
nwwpaieDRI0UPyVtChVHOg: folds 
Uncalled bet ($1) returned to Vr2XE7yYBdg3RZSURDAPEg
Vr2XE7yYBdg3RZSURDAPEg collected $0.50 from pot
Vr2XE7yYBdg3RZSURDAPEg: doesn't show hand 
*** SUMMARY ***
Total pot $0.50 | Rake $0 
Board [7h Tc Kh 3s 5h]
Seat 3: uUXdcVMNa05rfbntdvplfw (button) folded before Flop (didn't bet)
Seat 4: nwwpaieDRI0UPyVtChVHOg (small blind) folded on the River
Seat 5: Vr2XE7yYBdg3RZSURDAPEg (big blind) collected ($0.50)




PokerStars Game #59939444044:  Hold'em No Limit ($0.10/$0.25) - 2009/07/01 0:40:01 ET
Table 'WEMI3Mtn7dGARDbgNrKibg' 9-max Seat #6 is the button
Seat 2: tYsOBqdU1+x+yFI7zHO7hQ ($45.95 in chips) 
Seat 3: jZaChyamGXWcP+qALPP5Jg ($25 in chips) 
Seat 5: st9jtdNbm1W5GfBwRaCVqQ ($23.90 in chips) 
Seat 6: VBHxUExRAMrbxUq/cVx9Gw ($4.65 in chips) 
Seat 7: DnDcAdn9P0zGovMERigpFA ($58.75 in chips) 
Seat 8: ghNKXUBl/H+t83JF079ZBA ($27.30 in chips) 
Seat 9: NTamLAiMZ86c5yM04t96LA ($56.70 in chips) 
DnDcAdn9P0zGovMERigpFA: posts small blind $0.10
ghNKXUBl/H+t83JF079ZBA: posts big blind $0.25
7cv+9Zc9HIQHNvYsMfV3uA: sits out 
*** HOLE CARDS ***
flealine leaves the table
NTamLAiMZ86c5yM04t96LA: calls $0.25
tYsOBqdU1+x+yFI7zHO7hQ: folds 
jZaChyamGXWcP+qALPP5Jg: calls $0.25
NTamLAiMZ86c5yM04t96LA said, "nh"
st9jtdNbm1W5GfBwRaCVqQ: calls $0.25
VBHxUExRAMrbxUq/cVx9Gw: folds 
DnDcAdn9P0zGovMERigpFA: folds 
yyG4svzOpC1A+sUP/scg6w joins the table at seat #4 
ghNKXUBl/H+t83JF079ZBA: checks 
*** FLOP *** [Qs 8c 3s]
ghNKXUBl/H+t83JF079ZBA: checks 
NTamLAiMZ86c5yM04t96LA: checks 
jZaChyamGXWcP+qALPP5Jg: checks 
st9jtdNbm1W5GfBwRaCVqQ: bets $1
ghNKXUBl/H+t83JF079ZBA: folds 
NTamLAiMZ86c5yM04t96LA: folds 
jZaChyamGXWcP+qALPP5Jg: calls $1
*** TURN *** [Qs 8c 3s] [4h]
jZaChyamGXWcP+qALPP5Jg: checks 
st9jtdNbm1W5GfBwRaCVqQ: bets $2
jZaChyamGXWcP+qALPP5Jg: calls $2
*** RIVER *** [Qs 8c 3s 4h] [6h]
jZaChyamGXWcP+qALPP5Jg: checks 
st9jtdNbm1W5GfBwRaCVqQ: checks 
*** SHOW DOWN ***
jZaChyamGXWcP+qALPP5Jg: shows [Ks 6s] (a pair of Sixes)
st9jtdNbm1W5GfBwRaCVqQ: mucks hand 
jZaChyamGXWcP+qALPP5Jg collected $6.80 from pot
*** SUMMARY ***
Total pot $7.10 | Rake $0.30 
Board [Qs 8c 3s 4h 6h]
Seat 2: tYsOBqdU1+x+yFI7zHO7hQ folded before Flop (didn't bet)
Seat 3: jZaChyamGXWcP+qALPP5Jg showed [Ks 6s] and won ($6.80) with a pair of Sixes
Seat 5: st9jtdNbm1W5GfBwRaCVqQ mucked
Seat 6: VBHxUExRAMrbxUq/cVx9Gw (button) folded before Flop (didn't bet)
Seat 7: DnDcAdn9P0zGovMERigpFA (small blind) folded before Flop
Seat 8: ghNKXUBl/H+t83JF079ZBA (big blind) folded on the Flop
Seat 9: NTamLAiMZ86c5yM04t96LA folded on the Flop




PokerStars Game #59939443894:  Hold'em No Limit ($0.10/$0.25) - 2009/07/01 0:40:01 ET
Table 'qInMnOOn7vKcj4bU7zju7g' 9-max Seat #7 is the button
Seat 1: 3PjJjazzeHcM4mbFeXmZBg ($3.55 in chips) 
Seat 2: f/H6PsHRl4W1JyNsEDvPtg ($14.75 in chips) 
Seat 3: zDrucyjVn5aeekNEc3cJrA ($28.50 in chips) 
Seat 4: ZbKV588BRlpe7vF42jT9yg ($9.80 in chips) 
Seat 5: aNpwfA31EREwO+ar4XzBCw ($34.80 in chips) 
Seat 6: r1pFKMwWp74QwhfPWJOAyw ($4.25 in chips) 
Seat 7: 8B/dhbQjIWe6ASCdgzktNQ ($27.35 in chips) 
Seat 9: K7bAhhMMJ/XcTmGaBZVfFQ ($24 in chips) 
K7bAhhMMJ/XcTmGaBZVfFQ: posts small blind $0.10
3PjJjazzeHcM4mbFeXmZBg: posts big blind $0.25
*** HOLE CARDS ***
f/H6PsHRl4W1JyNsEDvPtg: folds 
zDrucyjVn5aeekNEc3cJrA: folds 
ZbKV588BRlpe7vF42jT9yg: folds 
aNpwfA31EREwO+ar4XzBCw: raises $0.75 to $1
r1pFKMwWp74QwhfPWJOAyw: calls $1
8B/dhbQjIWe6ASCdgzktNQ: folds 
K7bAhhMMJ/XcTmGaBZVfFQ: folds 
3PjJjazzeHcM4mbFeXmZBg: folds 
*** FLOP *** [5c 6c 6s]
aNpwfA31EREwO+ar4XzBCw: bets $1.25
r1pFKMwWp74QwhfPWJOAyw: raises $2 to $3.25 and is all-in
aNpwfA31EREwO+ar4XzBCw: calls $2
*** TURN *** [5c 6c 6s] [4s]
*** RIVER *** [5c 6c 6s 4s] [Th]
*** SHOW DOWN ***
aNpwfA31EREwO+ar4XzBCw: shows [Kc Ks] (two pair, Kings and Sixes)
r1pFKMwWp74QwhfPWJOAyw: shows [7d 7c] (two pair, Sevens and Sixes)
aNpwfA31EREwO+ar4XzBCw collected $8.45 from pot
*** SUMMARY ***
Total pot $8.85 | Rake $0.40 
Board [5c 6c 6s 4s Th]
Seat 1: 3PjJjazzeHcM4mbFeXmZBg (big blind) folded before Flop
Seat 2: f/H6PsHRl4W1JyNsEDvPtg folded before Flop (didn't bet)
Seat 3: zDrucyjVn5aeekNEc3cJrA folded before Flop (didn't bet)
Seat 4: ZbKV588BRlpe7vF42jT9yg folded before Flop (didn't bet)
Seat 5: aNpwfA31EREwO+ar4XzBCw showed [Kc Ks] and won ($8.45) with two pair, Kings and Sixes
Seat 6: r1pFKMwWp74QwhfPWJOAyw showed [7d 7c] and lost with two pair, Sevens and Sixes
Seat 7: 8B/dhbQjIWe6ASCdgzktNQ (button) folded before Flop (didn't bet)
Seat 9: K7bAhhMMJ/XcTmGaBZVfFQ (small blind) folded before Flop




PokerStars Game #59939444052:  Hold'em No Limit ($0.10/$0.25) - 2009/07/01 0:40:01 ET
Table 'dNYnr4D4id1jwnEU66Yowg' 9-max Seat #2 is the button
Seat 2: t2nb95S5EEFOEzNx9Itz0g ($6.10 in chips) 
Seat 5: k+2r6di6GXjNpAdrRkW9bA ($24.75 in chips) 
t2nb95S5EEFOEzNx9Itz0g: posts small blind $0.10
k+2r6di6GXjNpAdrRkW9bA: posts big blind $0.25
*** HOLE CARDS ***
t2nb95S5EEFOEzNx9Itz0g: raises $0.50 to $0.75
k+2r6di6GXjNpAdrRkW9bA: calls $0.50
*** FLOP *** [Qd Ac 7c]
k+2r6di6GXjNpAdrRkW9bA: checks 
t2nb95S5EEFOEzNx9Itz0g: bets $0.75
k+2r6di6GXjNpAdrRkW9bA: raises $0.75 to $1.50
t2nb95S5EEFOEzNx9Itz0g: calls $0.75
*** TURN *** [Qd Ac 7c] [5d]
k+2r6di6GXjNpAdrRkW9bA: bets $4
t2nb95S5EEFOEzNx9Itz0g: calls $3.85 and is all-in
Uncalled bet ($0.15) returned to k+2r6di6GXjNpAdrRkW9bA
*** RIVER *** [Qd Ac 7c 5d] [7d]
*** SHOW DOWN ***
k+2r6di6GXjNpAdrRkW9bA: shows [Ah Ts] (two pair, Aces and Sevens)
t2nb95S5EEFOEzNx9Itz0g: shows [7s 5c] (a full house, Sevens full of Fives)
t2nb95S5EEFOEzNx9Itz0g collected $11.60 from pot
*** SUMMARY ***
Total pot $12.20 | Rake $0.60 
Board [Qd Ac 7c 5d 7d]
Seat 2: t2nb95S5EEFOEzNx9Itz0g (button) (small blind) showed [7s 5c] and won ($11.60) with a full house, Sevens full of Fives
Seat 5: k+2r6di6GXjNpAdrRkW9bA (big blind) showed [Ah Ts] and lost with two pair, Aces and Sevens




PokerStars Game #59939444046:  Hold'em No Limit ($0.10/$0.25) - 2009/07/01 0:40:01 ET
Table 'Of/T60zpXg1GcjrZ7Lm//Q' 9-max Seat #7 is the button
Seat 1: Lro4e37x4FUa5P3yzDjskw ($7.80 in chips) 
Seat 2: hIss79a4pu7GzJZepfgOpg ($25 in chips) 
Seat 3: jeKWRUkMaVn8rEUjnJKqpg ($25 in chips) 
Seat 4: Czut6V7acIqUJrrobjKAZg ($25.05 in chips) 
Seat 5: 18G4P1XstjNvItdGUITxgw ($25 in chips) 
Seat 6: tYsOBqdU1+x+yFI7zHO7hQ ($25.75 in chips) 
Seat 7: s7Q6uNouhe7aE8JdFb9E+A ($34.25 in chips) 
Seat 8: ghNKXUBl/H+t83JF079ZBA ($31.35 in chips) 
Seat 9: TeWJxSETzbXGiYKx0y+dtg ($24.65 in chips) 
ghNKXUBl/H+t83JF079ZBA: posts small blind $0.10
TeWJxSETzbXGiYKx0y+dtg: posts big blind $0.25
*** HOLE CARDS ***
hIss79a4pu7GzJZepfgOpg said, "passive fish"
Lro4e37x4FUa5P3yzDjskw: raises $0.25 to $0.50
ghNKXUBl/H+t83JF079ZBA said, "?"
hIss79a4pu7GzJZepfgOpg: folds 
ghNKXUBl/H+t83JF079ZBA said, "i waiting for you to be aggro in pos"
jeKWRUkMaVn8rEUjnJKqpg: folds 
Czut6V7acIqUJrrobjKAZg: folds 
ghNKXUBl/H+t83JF079ZBA said, "but you puss up"
18G4P1XstjNvItdGUITxgw: folds 
hIss79a4pu7GzJZepfgOpg said, "lol"
tYsOBqdU1+x+yFI7zHO7hQ: folds 
hIss79a4pu7GzJZepfgOpg said, "i know you too well"
hIss79a4pu7GzJZepfgOpg said, "lol meta at 25nl"
s7Q6uNouhe7aE8JdFb9E+A: folds 
ghNKXUBl/H+t83JF079ZBA: folds 
TeWJxSETzbXGiYKx0y+dtg: folds 
Uncalled bet ($0.25) returned to Lro4e37x4FUa5P3yzDjskw
Lro4e37x4FUa5P3yzDjskw collected $0.60 from pot
*** SUMMARY ***
Total pot $0.60 | Rake $0 
Seat 1: Lro4e37x4FUa5P3yzDjskw collected ($0.60)
Seat 2: hIss79a4pu7GzJZepfgOpg folded before Flop (didn't bet)
Seat 3: jeKWRUkMaVn8rEUjnJKqpg folded before Flop (didn't bet)
Seat 4: Czut6V7acIqUJrrobjKAZg folded before Flop (didn't bet)
Seat 5: 18G4P1XstjNvItdGUITxgw folded before Flop (didn't bet)
Seat 6: tYsOBqdU1+x+yFI7zHO7hQ folded before Flop (didn't bet)
Seat 7: s7Q6uNouhe7aE8JdFb9E+A (button) folded before Flop (didn't bet)
Seat 8: ghNKXUBl/H+t83JF079ZBA (small blind) folded before Flop
Seat 9: TeWJxSETzbXGiYKx0y+dtg (big blind) folded before Flop




PokerStars Game #59939444616:  Hold'em No Limit ($0.10/$0.25) - 2009/07/01 0:40:02 ET
Table 'PCxB2W9H6ma8SwsZlImuOw' 9-max Seat #9 is the button
Seat 1: 5s3p6yoJBNW438dsyKTP8g ($31 in chips) 
Seat 2: wjH6l1gQaEfv+C45sAOwIQ ($37.90 in chips) 
Seat 3: opOCI2p6kW0tINuVaAqmcQ ($29.50 in chips) 
Seat 4: ydoFOVgzvZv9ZhuWu9rXAw ($5 in chips) 
Seat 5: h4ggJZYBXV0mEZzYPYKfeA ($23.95 in chips) 
Seat 6: E2c0EwJuNHUUdumOOgYQYA ($7.30 in chips) 
Seat 7: EfRs3ibIxn+c9JDErwwNCg ($25.10 in chips) 
Seat 8: Hdb9b2QXBH2f6YwkTgMKdQ ($3.90 in chips) 
Seat 9: LWN1wPrLH+695JIriXxDuw ($4.50 in chips) 
5s3p6yoJBNW438dsyKTP8g: posts small blind $0.10
wjH6l1gQaEfv+C45sAOwIQ: posts big blind $0.25
*** HOLE CARDS ***
opOCI2p6kW0tINuVaAqmcQ: folds 
ydoFOVgzvZv9ZhuWu9rXAw: folds 
h4ggJZYBXV0mEZzYPYKfeA: folds 
E2c0EwJuNHUUdumOOgYQYA: calls $0.25
EfRs3ibIxn+c9JDErwwNCg: raises $0.75 to $1
Hdb9b2QXBH2f6YwkTgMKdQ: folds 
LWN1wPrLH+695JIriXxDuw: folds 
5s3p6yoJBNW438dsyKTP8g: folds 
wjH6l1gQaEfv+C45sAOwIQ: folds 
LWN1wPrLH+695JIriXxDuw leaves the table
E2c0EwJuNHUUdumOOgYQYA: calls $0.75
*** FLOP *** [8h 5s 5h]
E2c0EwJuNHUUdumOOgYQYA: checks 
EfRs3ibIxn+c9JDErwwNCg: bets $1.25
E2c0EwJuNHUUdumOOgYQYA: folds 
Uncalled bet ($1.25) returned to EfRs3ibIxn+c9JDErwwNCg
EfRs3ibIxn+c9JDErwwNCg collected $2.25 from pot
*** SUMMARY ***
Total pot $2.35 | Rake $0.10 
Board [8h 5s 5h]
Seat 1: 5s3p6yoJBNW438dsyKTP8g (small blind) folded before Flop
Seat 2: wjH6l1gQaEfv+C45sAOwIQ (big blind) folded before Flop
Seat 3: opOCI2p6kW0tINuVaAqmcQ folded before Flop (didn't bet)
Seat 4: ydoFOVgzvZv9ZhuWu9rXAw folded before Flop (didn't bet)
Seat 5: h4ggJZYBXV0mEZzYPYKfeA folded before Flop (didn't bet)
Seat 6: E2c0EwJuNHUUdumOOgYQYA folded on the Flop
Seat 7: EfRs3ibIxn+c9JDErwwNCg collected ($2.25)
Seat 8: Hdb9b2QXBH2f6YwkTgMKdQ folded before Flop (didn't bet)
Seat 9: LWN1wPrLH+695JIriXxDuw (button) folded before Flop (didn't bet)




PokerStars Game #59939444512:  Hold'em No Limit ($0.10/$0.25) - 2009/07/01 0:40:02 ET
Table '2clPgY3+dETPD/8zjXZdFw' 6-max Seat #1 is the button
Seat 1: qllppsCmUqovlriIWCeM/g ($2 in chips) 
Seat 2: NzIFHwilc5zU7QhjDTgTZA ($7.10 in chips) 
Seat 3: 6pF9LtHn+EH0ChbOXzox9g ($5.45 in chips) 
Seat 4: 9KPR3sZ+CxRm7bQ8qxFzMQ ($5 in chips) 
NzIFHwilc5zU7QhjDTgTZA: posts small blind $0.10
6pF9LtHn+EH0ChbOXzox9g: posts big blind $0.25
9KPR3sZ+CxRm7bQ8qxFzMQ: posts big blind $0.25
*** HOLE CARDS ***
9KPR3sZ+CxRm7bQ8qxFzMQ: checks 
qllppsCmUqovlriIWCeM/g: folds 
NzIFHwilc5zU7QhjDTgTZA: calls $0.15
6pF9LtHn+EH0ChbOXzox9g: checks 
*** FLOP *** [3c 2h 6s]
NzIFHwilc5zU7QhjDTgTZA: bets $0.50
6pF9LtHn+EH0ChbOXzox9g: folds 
9KPR3sZ+CxRm7bQ8qxFzMQ: folds 
Uncalled bet ($0.50) returned to NzIFHwilc5zU7QhjDTgTZA
NzIFHwilc5zU7QhjDTgTZA collected $0.75 from pot
*** SUMMARY ***
Total pot $0.75 | Rake $0 
Board [3c 2h 6s]
Seat 1: qllppsCmUqovlriIWCeM/g (button) folded before Flop (didn't bet)
Seat 2: NzIFHwilc5zU7QhjDTgTZA (small blind) collected ($0.75)
Seat 3: 6pF9LtHn+EH0ChbOXzox9g (big blind) folded on the Flop
Seat 4: 9KPR3sZ+CxRm7bQ8qxFzMQ folded on the Flop




PokerStars Game #59939444640:  Hold'em No Limit ($0.10/$0.25) - 2009/07/01 0:40:02 ET
Table 'KU/HrxqxwDz8HKEhYTZ6uw' 6-max Seat #2 is the button
Seat 1: gaPMxLGp9SOj4Lq6t+/0Ig ($27.65 in chips) 
Seat 2: kG34n23qFQA3nzdOJTQ1dA ($24.65 in chips) 
Seat 3: 3seg9SJ1y+HUPN0X0XKF5Q ($11.95 in chips) 
Seat 4: +yxuvzJHyIWsJ515X8zJTQ ($0.90 in chips) 
Seat 5: 4YSTu0Cdzpppe1lUgCZGCQ ($35.45 in chips) 
Seat 6: QIWnfLSqfMcoFfdDe5LZPg ($9.90 in chips) 
3seg9SJ1y+HUPN0X0XKF5Q: posts small blind $0.10
+yxuvzJHyIWsJ515X8zJTQ: posts big blind $0.25
*** HOLE CARDS ***
4YSTu0Cdzpppe1lUgCZGCQ: folds 
QIWnfLSqfMcoFfdDe5LZPg: folds 
gaPMxLGp9SOj4Lq6t+/0Ig: folds 
kG34n23qFQA3nzdOJTQ1dA: folds 
3seg9SJ1y+HUPN0X0XKF5Q: folds 
Uncalled bet ($0.15) returned to +yxuvzJHyIWsJ515X8zJTQ
+yxuvzJHyIWsJ515X8zJTQ collected $0.20 from pot
+yxuvzJHyIWsJ515X8zJTQ: doesn't show hand 
*** SUMMARY ***
Total pot $0.20 | Rake $0 
Seat 1: gaPMxLGp9SOj4Lq6t+/0Ig folded before Flop (didn't bet)
Seat 2: kG34n23qFQA3nzdOJTQ1dA (button) folded before Flop (didn't bet)
Seat 3: 3seg9SJ1y+HUPN0X0XKF5Q (small blind) folded before Flop
Seat 4: +yxuvzJHyIWsJ515X8zJTQ (big blind) collected ($0.20)
Seat 5: 4YSTu0Cdzpppe1lUgCZGCQ folded before Flop (didn't bet)
Seat 6: QIWnfLSqfMcoFfdDe5LZPg folded before Flop (didn't bet)




PokerStars Game #59939444736:  Hold'em No Limit ($0.10/$0.25) - 2009/07/01 0:40:03 ET
Table 'rhQuIjJo0UQ7RRUlF9umHg' 6-max Seat #5 is the button
Seat 1: 5O3Hj9Qg0SqOyKEXoLpjPg ($82.20 in chips) 
Seat 2: Ew/TYPQIsbQ2X8nm5iAJBg ($25 in chips) 
Seat 3: nLE5Yo60EmSlJPyg0GgxXg ($17 in chips) 
Seat 4: buyjetgNT1McXtdaP4zynA ($22.65 in chips) 
Seat 5: 7qRk4YH4/k/08LgJSv7rBQ ($25 in chips) 
Seat 6: r284m4NA4rtNktI86R8/Yw ($11.05 in chips) 
r284m4NA4rtNktI86R8/Yw: posts small blind $0.10
5O3Hj9Qg0SqOyKEXoLpjPg said, "i thought 2"
5O3Hj9Qg0SqOyKEXoLpjPg: posts big blind $0.25
*** HOLE CARDS ***
Ew/TYPQIsbQ2X8nm5iAJBg: folds 
nLE5Yo60EmSlJPyg0GgxXg: calls $0.25
buyjetgNT1McXtdaP4zynA: folds 
7qRk4YH4/k/08LgJSv7rBQ: raises $0.75 to $1
r284m4NA4rtNktI86R8/Yw: folds 
5O3Hj9Qg0SqOyKEXoLpjPg: calls $0.75
nLE5Yo60EmSlJPyg0GgxXg: calls $0.75
*** FLOP *** [7h 7d Qd]
5O3Hj9Qg0SqOyKEXoLpjPg: checks 
nLE5Yo60EmSlJPyg0GgxXg: checks 
7qRk4YH4/k/08LgJSv7rBQ: bets $2
5O3Hj9Qg0SqOyKEXoLpjPg: folds 
nLE5Yo60EmSlJPyg0GgxXg: folds 
Uncalled bet ($2) returned to 7qRk4YH4/k/08LgJSv7rBQ
7qRk4YH4/k/08LgJSv7rBQ collected $2.95 from pot
7qRk4YH4/k/08LgJSv7rBQ: doesn't show hand 
*** SUMMARY ***
Total pot $3.10 | Rake $0.15 
Board [7h 7d Qd]
Seat 1: 5O3Hj9Qg0SqOyKEXoLpjPg (big blind) folded on the Flop
Seat 2: Ew/TYPQIsbQ2X8nm5iAJBg folded before Flop (didn't bet)
Seat 3: nLE5Yo60EmSlJPyg0GgxXg folded on the Flop
Seat 4: buyjetgNT1McXtdaP4zynA folded before Flop (didn't bet)
Seat 5: 7qRk4YH4/k/08LgJSv7rBQ (button) collected ($2.95)
Seat 6: r284m4NA4rtNktI86R8/Yw (small blind) folded before Flop




PokerStars Game #59939444874:  Hold'em No Limit ($0.10/$0.25) - 2009/07/01 0:40:03 ET
Table '9L7XfAwuM7XsXE8LIg2o5Q' 6-max Seat #3 is the button
Seat 1: H6XbZVba2aKDXlG0la0uow ($9.35 in chips) 
Seat 2: oseFhpinoe+Zg4j5xyBjyQ ($19.10 in chips) 
Seat 3: 9StOHp+Y1T0K13JdgS2oQQ ($6.10 in chips) 
Seat 4: xBOVv8xEXtymVpAA5ZajSw ($82.90 in chips) 
Seat 5: Lh8SlCq3OSDKWLUgAI/Lxw ($5.95 in chips) 
Seat 6: k9nHZTHt8hYhYRcW8NTb4g ($29.45 in chips) 
xBOVv8xEXtymVpAA5ZajSw: posts small blind $0.10
Lh8SlCq3OSDKWLUgAI/Lxw: posts big blind $0.25
*** HOLE CARDS ***
k9nHZTHt8hYhYRcW8NTb4g: folds 
H6XbZVba2aKDXlG0la0uow: folds 
oseFhpinoe+Zg4j5xyBjyQ: folds 
9StOHp+Y1T0K13JdgS2oQQ: raises $0.25 to $0.50
xBOVv8xEXtymVpAA5ZajSw: raises $5.75 to $6.25
Lh8SlCq3OSDKWLUgAI/Lxw: calls $5.70 and is all-in
9StOHp+Y1T0K13JdgS2oQQ: folds 
Uncalled bet ($0.30) returned to xBOVv8xEXtymVpAA5ZajSw
*** FLOP *** [3s 9s 7s]
*** TURN *** [3s 9s 7s] [Th]
*** RIVER *** [3s 9s 7s Th] [9c]
*** SHOW DOWN ***
xBOVv8xEXtymVpAA5ZajSw: shows [Js Jh] (two pair, Jacks and Nines)
Lh8SlCq3OSDKWLUgAI/Lxw: shows [Ts Td] (a full house, Tens full of Nines)
Lh8SlCq3OSDKWLUgAI/Lxw collected $11.80 from pot
*** SUMMARY ***
Total pot $12.40 | Rake $0.60 
Board [3s 9s 7s Th 9c]
Seat 1: H6XbZVba2aKDXlG0la0uow folded before Flop (didn't bet)
Seat 2: oseFhpinoe+Zg4j5xyBjyQ folded before Flop (didn't bet)
Seat 3: 9StOHp+Y1T0K13JdgS2oQQ (button) folded before Flop
Seat 4: xBOVv8xEXtymVpAA5ZajSw (small blind) showed [Js Jh] and lost with two pair, Jacks and Nines
Seat 5: Lh8SlCq3OSDKWLUgAI/Lxw (big blind) showed [Ts Td] and won ($11.80) with a full house, Tens full of Nines
Seat 6: k9nHZTHt8hYhYRcW8NTb4g folded before Flop (didn't bet)




PokerStars Game #59939444778:  Hold'em No Limit ($0.10/$0.25) - 2009/07/01 0:40:03 ET
Table '+198VWQSWBhYQOcizzuBkw' 6-max Seat #5 is the button
Seat 2: R6AGToFJQOYVZAjC2jXEKw ($29.05 in chips) 
Seat 3: BYxjLnV1/LL0aZcTbfAOvw ($27.25 in chips) 
Seat 4: TgDsTeCdLQt8kWbL00ByRA ($27.25 in chips) 
Seat 5: LtASJ9OlkqGrrUKGQlpGAw ($30.30 in chips) 
Seat 6: 7qRk4YH4/k/08LgJSv7rBQ ($31.35 in chips) 
7qRk4YH4/k/08LgJSv7rBQ: posts small blind $0.10
R6AGToFJQOYVZAjC2jXEKw: posts big blind $0.25
*** HOLE CARDS ***
BYxjLnV1/LL0aZcTbfAOvw: folds 
TgDsTeCdLQt8kWbL00ByRA: folds 
LtASJ9OlkqGrrUKGQlpGAw: folds 
7qRk4YH4/k/08LgJSv7rBQ: folds 
Uncalled bet ($0.15) returned to R6AGToFJQOYVZAjC2jXEKw
R6AGToFJQOYVZAjC2jXEKw collected $0.20 from pot
R6AGToFJQOYVZAjC2jXEKw: doesn't show hand 
*** SUMMARY ***
Total pot $0.20 | Rake $0 
Seat 2: R6AGToFJQOYVZAjC2jXEKw (big blind) collected ($0.20)
Seat 3: BYxjLnV1/LL0aZcTbfAOvw folded before Flop (didn't bet)
Seat 4: TgDsTeCdLQt8kWbL00ByRA folded before Flop (didn't bet)
Seat 5: LtASJ9OlkqGrrUKGQlpGAw (button) folded before Flop (didn't bet)
Seat 6: 7qRk4YH4/k/08LgJSv7rBQ (small blind) folded before Flop




PokerStars Game #59939444926:  Hold'em No Limit ($0.10/$0.25) - 2009/07/01 0:40:03 ET
Table 'v+LTGPWbrLum+Ggd4ef6lg' 9-max Seat #5 is the button
Seat 4: gGaFLzGESKP3Tj9N/K7QNA ($19.50 in chips) 
Seat 5: eJDZmZbsxdLJcAv2PolkwA ($13.25 in chips) 
Seat 7: YEdelvffSYRP4EDNfFp4dA ($15 in chips) 
Seat 8: +sbyWwIcFp9kP0bDtMegfQ ($28.65 in chips) 
Seat 9: cFmpjvcjNoVAEAIQIxWkYg ($25 in chips) 
YEdelvffSYRP4EDNfFp4dA: posts small blind $0.10
+sbyWwIcFp9kP0bDtMegfQ: posts big blind $0.25
*** HOLE CARDS ***
cFmpjvcjNoVAEAIQIxWkYg: raises $0.50 to $0.75
gGaFLzGESKP3Tj9N/K7QNA: calls $0.75
eJDZmZbsxdLJcAv2PolkwA: calls $0.75
YEdelvffSYRP4EDNfFp4dA: folds 
+sbyWwIcFp9kP0bDtMegfQ: calls $0.50
*** FLOP *** [7s 8s 9d]
+sbyWwIcFp9kP0bDtMegfQ: checks 
cFmpjvcjNoVAEAIQIxWkYg: bets $1.75
gGaFLzGESKP3Tj9N/K7QNA: folds 
eJDZmZbsxdLJcAv2PolkwA: folds 
+sbyWwIcFp9kP0bDtMegfQ: calls $1.75
*** TURN *** [7s 8s 9d] [As]
eJDZmZbsxdLJcAv2PolkwA leaves the table
+sbyWwIcFp9kP0bDtMegfQ: checks 
cFmpjvcjNoVAEAIQIxWkYg: bets $2.50
+sbyWwIcFp9kP0bDtMegfQ: calls $2.50
*** RIVER *** [7s 8s 9d As] [Qs]
+sbyWwIcFp9kP0bDtMegfQ: bets $0.25
cFmpjvcjNoVAEAIQIxWkYg: calls $0.25
*** SHOW DOWN ***
+sbyWwIcFp9kP0bDtMegfQ: shows [Ah Th] (a pair of Aces)
cFmpjvcjNoVAEAIQIxWkYg: mucks hand 
+sbyWwIcFp9kP0bDtMegfQ collected $11.55 from pot
*** SUMMARY ***
Total pot $12.10 | Rake $0.55 
Board [7s 8s 9d As Qs]
Seat 4: gGaFLzGESKP3Tj9N/K7QNA folded on the Flop
Seat 5: eJDZmZbsxdLJcAv2PolkwA (button) folded on the Flop
Seat 7: YEdelvffSYRP4EDNfFp4dA (small blind) folded before Flop
Seat 8: +sbyWwIcFp9kP0bDtMegfQ (big blind) showed [Ah Th] and won ($11.55) with a pair of Aces
Seat 9: cFmpjvcjNoVAEAIQIxWkYg mucked




PokerStars Game #59939444770:  Hold'em No Limit ($0.10/$0.25) - 2009/07/01 0:40:03 ET
Table 'ThBZ355rqvsb8UGb6ajbig' 9-max Seat #3 is the button
Seat 2: 4awUyiDYTgylQKXZ9faBVA ($25 in chips) 
Seat 3: LBrhQVB4w41YNd7kMYn/og ($9.60 in chips) 
Seat 4: GFNwOPqg/Zu4ZuokgGADNQ ($15.75 in chips) 
Seat 5: ljO8CPts14fBjr9/qK0Enw ($28.15 in chips) 
Seat 6: qwr38jl5txoR36M7G5qi4A ($7.50 in chips) 
Seat 7: t2nb95S5EEFOEzNx9Itz0g ($12.95 in chips) 
Seat 8: 6REZ3fl3I5Kaxoupd8cnLg ($14.75 in chips) 
Seat 9: 8B/dhbQjIWe6ASCdgzktNQ ($28.75 in chips) 
GFNwOPqg/Zu4ZuokgGADNQ: posts small blind $0.10
ljO8CPts14fBjr9/qK0Enw: posts big blind $0.25
*** HOLE CARDS ***
qwr38jl5txoR36M7G5qi4A: folds 
t2nb95S5EEFOEzNx9Itz0g: folds 
6REZ3fl3I5Kaxoupd8cnLg: folds 
8B/dhbQjIWe6ASCdgzktNQ: folds 
4awUyiDYTgylQKXZ9faBVA: folds 
LBrhQVB4w41YNd7kMYn/og: calls $0.25
GFNwOPqg/Zu4ZuokgGADNQ: calls $0.15
ljO8CPts14fBjr9/qK0Enw: checks 
*** FLOP *** [3c As Jh]
GFNwOPqg/Zu4ZuokgGADNQ: checks 
ljO8CPts14fBjr9/qK0Enw: checks 
LBrhQVB4w41YNd7kMYn/og: checks 
*** TURN *** [3c As Jh] [8h]
GFNwOPqg/Zu4ZuokgGADNQ: checks 
ljO8CPts14fBjr9/qK0Enw: checks 
LBrhQVB4w41YNd7kMYn/og: bets $0.50
GFNwOPqg/Zu4ZuokgGADNQ: calls $0.50
ljO8CPts14fBjr9/qK0Enw: calls $0.50
*** RIVER *** [3c As Jh 8h] [2h]
GFNwOPqg/Zu4ZuokgGADNQ: checks 
ljO8CPts14fBjr9/qK0Enw: bets $1.75
LBrhQVB4w41YNd7kMYn/og: calls $1.75
GFNwOPqg/Zu4ZuokgGADNQ: folds 
*** SHOW DOWN ***
ljO8CPts14fBjr9/qK0Enw: shows [Td Kh] (high card Ace)
LBrhQVB4w41YNd7kMYn/og: shows [Ac 4d] (a pair of Aces)
LBrhQVB4w41YNd7kMYn/og collected $5.50 from pot
*** SUMMARY ***
Total pot $5.75 | Rake $0.25 
Board [3c As Jh 8h 2h]
Seat 2: 4awUyiDYTgylQKXZ9faBVA folded before Flop (didn't bet)
Seat 3: LBrhQVB4w41YNd7kMYn/og (button) showed [Ac 4d] and won ($5.50) with a pair of Aces
Seat 4: GFNwOPqg/Zu4ZuokgGADNQ (small blind) folded on the River
Seat 5: ljO8CPts14fBjr9/qK0Enw (big blind) showed [Td Kh] and lost with high card Ace
Seat 6: qwr38jl5txoR36M7G5qi4A folded before Flop (didn't bet)
Seat 7: t2nb95S5EEFOEzNx9Itz0g folded before Flop (didn't bet)
Seat 8: 6REZ3fl3I5Kaxoupd8cnLg folded before Flop (didn't bet)
Seat 9: 8B/dhbQjIWe6ASCdgzktNQ folded before Flop (didn't bet)




PokerStars Game #59939444996:  Hold'em No Limit ($0.10/$0.25) - 2009/07/01 0:40:03 ET
Table 'JPFXJXa5xBkjZ/W15BKqeQ' 9-max Seat #7 is the button
Seat 1: hPhp/RE3cJ5YGaQ2xOHXXg ($5 in chips) 
Seat 2: 1/f3/SJ8XpIW1Ek97d1xUw ($5.50 in chips) 
Seat 3: 56S3mA6Zs3pGR+0p0vUCtg ($27.15 in chips) 
Seat 4: VBHxUExRAMrbxUq/cVx9Gw ($5.60 in chips) 
Seat 5: cZ99hugmLBj9KhTlc8nCSw ($25.95 in chips) 
Seat 6: DdPXdieucQ+n99u1n3A+rQ ($4.30 in chips) 
Seat 7: zf2/dINEhk9pCZwJGJLcHw ($14.35 in chips) 
Seat 8: zDrucyjVn5aeekNEc3cJrA ($23.10 in chips) 
Seat 9: uH1RN27w9SKa7TpVR9EFrQ ($15.05 in chips) 
zDrucyjVn5aeekNEc3cJrA: posts small blind $0.10
uH1RN27w9SKa7TpVR9EFrQ: posts big blind $0.25
*** HOLE CARDS ***
hPhp/RE3cJ5YGaQ2xOHXXg: folds 
1/f3/SJ8XpIW1Ek97d1xUw: folds 
56S3mA6Zs3pGR+0p0vUCtg: folds 
VBHxUExRAMrbxUq/cVx9Gw: folds 
cZ99hugmLBj9KhTlc8nCSw: folds 
DdPXdieucQ+n99u1n3A+rQ: folds 
zf2/dINEhk9pCZwJGJLcHw is disconnected 
zf2/dINEhk9pCZwJGJLcHw has timed out while disconnected
zf2/dINEhk9pCZwJGJLcHw: folds 
zf2/dINEhk9pCZwJGJLcHw is sitting out
zDrucyjVn5aeekNEc3cJrA: folds 
Uncalled bet ($0.15) returned to uH1RN27w9SKa7TpVR9EFrQ
uH1RN27w9SKa7TpVR9EFrQ collected $0.20 from pot
uH1RN27w9SKa7TpVR9EFrQ: doesn't show hand 
*** SUMMARY ***
Total pot $0.20 | Rake $0 
Seat 1: hPhp/RE3cJ5YGaQ2xOHXXg folded before Flop (didn't bet)
Seat 2: 1/f3/SJ8XpIW1Ek97d1xUw folded before Flop (didn't bet)
Seat 3: 56S3mA6Zs3pGR+0p0vUCtg folded before Flop (didn't bet)
Seat 4: VBHxUExRAMrbxUq/cVx9Gw folded before Flop (didn't bet)
Seat 5: cZ99hugmLBj9KhTlc8nCSw folded before Flop (didn't bet)
Seat 6: DdPXdieucQ+n99u1n3A+rQ folded before Flop (didn't bet)
Seat 7: zf2/dINEhk9pCZwJGJLcHw (button) folded before Flop (didn't bet)
Seat 8: zDrucyjVn5aeekNEc3cJrA (small blind) folded before Flop
Seat 9: uH1RN27w9SKa7TpVR9EFrQ (big blind) collected ($0.20)




PokerStars Game #59939445046:  Hold'em No Limit ($0.10/$0.25) - 2009/07/01 0:40:03 ET
Table 'jz4TpuH+ag+0iNe2ZcxckQ' 9-max Seat #9 is the button
Seat 1: xw6ysR8BJ8Nvn+ibEf2G9w ($7.60 in chips) 
Seat 2: 18G4P1XstjNvItdGUITxgw ($29.80 in chips) 
Seat 3: Z5NNIVvnhb2IJbLcI79WYQ ($3.50 in chips) 
Seat 4: k+2r6di6GXjNpAdrRkW9bA ($63.20 in chips) 
Seat 5: uJlzv9KL7hgCIqIS2ofoaw ($8.80 in chips) 
Seat 6: ymx/m/7IEqTY+OQPano2gg ($10.70 in chips) 
Seat 7: sJNHTWcSlLHRCZ9+YRLLqA ($25 in chips) 
Seat 8: J3kDdqAF7vHwmQ3VsAbsdA ($77.90 in chips) 
Seat 9: 8B/dhbQjIWe6ASCdgzktNQ ($25 in chips) 
xw6ysR8BJ8Nvn+ibEf2G9w: posts small blind $0.10
18G4P1XstjNvItdGUITxgw: posts big blind $0.25
*** HOLE CARDS ***
Z5NNIVvnhb2IJbLcI79WYQ: folds 
k+2r6di6GXjNpAdrRkW9bA: calls $0.25
uJlzv9KL7hgCIqIS2ofoaw: folds 
ymx/m/7IEqTY+OQPano2gg: folds 
sJNHTWcSlLHRCZ9+YRLLqA: folds 
J3kDdqAF7vHwmQ3VsAbsdA: calls $0.25
8B/dhbQjIWe6ASCdgzktNQ: folds 
xw6ysR8BJ8Nvn+ibEf2G9w: calls $0.15
18G4P1XstjNvItdGUITxgw: checks 
*** FLOP *** [5h Jh 8s]
xw6ysR8BJ8Nvn+ibEf2G9w: checks 
18G4P1XstjNvItdGUITxgw: checks 
k+2r6di6GXjNpAdrRkW9bA: bets $0.50
J3kDdqAF7vHwmQ3VsAbsdA: calls $0.50
xw6ysR8BJ8Nvn+ibEf2G9w: folds 
18G4P1XstjNvItdGUITxgw: folds 
*** TURN *** [5h Jh 8s] [2d]
k+2r6di6GXjNpAdrRkW9bA: bets $0.50
J3kDdqAF7vHwmQ3VsAbsdA: calls $0.50
*** RIVER *** [5h Jh 8s 2d] [3d]
k+2r6di6GXjNpAdrRkW9bA: bets $0.50
J3kDdqAF7vHwmQ3VsAbsdA: calls $0.50
*** SHOW DOWN ***
k+2r6di6GXjNpAdrRkW9bA: shows [Jc Qh] (a pair of Jacks)
J3kDdqAF7vHwmQ3VsAbsdA: mucks hand 
k+2r6di6GXjNpAdrRkW9bA collected $3.85 from pot
*** SUMMARY ***
Total pot $4 | Rake $0.15 
Board [5h Jh 8s 2d 3d]
Seat 1: xw6ysR8BJ8Nvn+ibEf2G9w (small blind) folded on the Flop
Seat 2: 18G4P1XstjNvItdGUITxgw (big blind) folded on the Flop
Seat 3: Z5NNIVvnhb2IJbLcI79WYQ folded before Flop (didn't bet)
Seat 4: k+2r6di6GXjNpAdrRkW9bA showed [Jc Qh] and won ($3.85) with a pair of Jacks
Seat 5: uJlzv9KL7hgCIqIS2ofoaw folded before Flop (didn't bet)
Seat 6: ymx/m/7IEqTY+OQPano2gg folded before Flop (didn't bet)
Seat 7: sJNHTWcSlLHRCZ9+YRLLqA folded before Flop (didn't bet)
Seat 8: J3kDdqAF7vHwmQ3VsAbsdA mucked
Seat 9: 8B/dhbQjIWe6ASCdgzktNQ (button) folded before Flop (didn't bet)




PokerStars Game #59939445890:  Hold'em No Limit ($0.10/$0.25) - 2009/07/01 0:40:04 ET
Table 'jItkp2PNTbH9Cf7gqsAF7g' 9-max Seat #9 is the button
Seat 1: OiV1PWZ3IkN29JlmCcnTwQ ($4.75 in chips) 
Seat 2: qwr38jl5txoR36M7G5qi4A ($7.50 in chips) 
Seat 3: E0iYnEVO2ho7dH3QcCjw7g ($24.70 in chips) 
Seat 4: GQTWTgG7Ydy9q/vohVnKmQ ($29.10 in chips) 
Seat 5: uH1RN27w9SKa7TpVR9EFrQ ($17.80 in chips) 
Seat 6: cZ99hugmLBj9KhTlc8nCSw ($58.60 in chips) 
Seat 7: st9jtdNbm1W5GfBwRaCVqQ ($21.50 in chips) 
Seat 8: t82lXIS9gxYmNHmDgWRFAQ ($11.85 in chips) 
Seat 9: H9KUl8cmpLgEpOVDA00bCg ($6.60 in chips) 
OiV1PWZ3IkN29JlmCcnTwQ: posts small blind $0.10
qwr38jl5txoR36M7G5qi4A: posts big blind $0.25
*** HOLE CARDS ***
E0iYnEVO2ho7dH3QcCjw7g: folds 
GQTWTgG7Ydy9q/vohVnKmQ: calls $0.25
uH1RN27w9SKa7TpVR9EFrQ: calls $0.25
cZ99hugmLBj9KhTlc8nCSw: folds 
st9jtdNbm1W5GfBwRaCVqQ: folds 
t82lXIS9gxYmNHmDgWRFAQ: calls $0.25
H9KUl8cmpLgEpOVDA00bCg: folds 
OiV1PWZ3IkN29JlmCcnTwQ: calls $0.15
qwr38jl5txoR36M7G5qi4A: checks 
*** FLOP *** [Qd 7s 4c]
OiV1PWZ3IkN29JlmCcnTwQ: checks 
qwr38jl5txoR36M7G5qi4A: checks 
GQTWTgG7Ydy9q/vohVnKmQ: bets $0.25
uH1RN27w9SKa7TpVR9EFrQ: folds 
t82lXIS9gxYmNHmDgWRFAQ: calls $0.25
OiV1PWZ3IkN29JlmCcnTwQ: folds 
qwr38jl5txoR36M7G5qi4A: calls $0.25
*** TURN *** [Qd 7s 4c] [Js]
qwr38jl5txoR36M7G5qi4A: bets $0.25
GQTWTgG7Ydy9q/vohVnKmQ: raises $0.25 to $0.50
t82lXIS9gxYmNHmDgWRFAQ: folds 
qwr38jl5txoR36M7G5qi4A: calls $0.25
*** RIVER *** [Qd 7s 4c Js] [4d]
qwr38jl5txoR36M7G5qi4A: bets $0.25
GQTWTgG7Ydy9q/vohVnKmQ: calls $0.25
*** SHOW DOWN ***
qwr38jl5txoR36M7G5qi4A: shows [8d Qh] (two pair, Queens and Fours)
GQTWTgG7Ydy9q/vohVnKmQ: shows [Qs Jc] (two pair, Queens and Jacks)
GQTWTgG7Ydy9q/vohVnKmQ collected $3.35 from pot
*** SUMMARY ***
Total pot $3.50 | Rake $0.15 
Board [Qd 7s 4c Js 4d]
Seat 1: OiV1PWZ3IkN29JlmCcnTwQ (small blind) folded on the Flop
Seat 2: qwr38jl5txoR36M7G5qi4A (big blind) showed [8d Qh] and lost with two pair, Queens and Fours
Seat 3: E0iYnEVO2ho7dH3QcCjw7g folded before Flop (didn't bet)
Seat 4: GQTWTgG7Ydy9q/vohVnKmQ showed [Qs Jc] and won ($3.35) with two pair, Queens and Jacks
Seat 5: uH1RN27w9SKa7TpVR9EFrQ folded on the Flop
Seat 6: cZ99hugmLBj9KhTlc8nCSw folded before Flop (didn't bet)
Seat 7: st9jtdNbm1W5GfBwRaCVqQ folded before Flop (didn't bet)
Seat 8: t82lXIS9gxYmNHmDgWRFAQ folded on the Turn
Seat 9: H9KUl8cmpLgEpOVDA00bCg (button) folded before Flop (didn't bet)




PokerStars Game #59939445700:  Hold'em No Limit ($0.10/$0.25) - 2009/07/01 0:40:04 ET
Table 'YYMg5qzxK1m9eGRo4SbxtQ' 9-max Seat #5 is the button
Seat 1: DiSvPC2iudwL5j9u6Huyww ($25 in chips) 
Seat 2: uH1RN27w9SKa7TpVR9EFrQ ($14.90 in chips) 
Seat 3: N6fYvIzQLKaydFLKQGtMlQ ($24.05 in chips) 
Seat 4: H8sSXb2KLK0U38tU9YITDw ($11.25 in chips) 
Seat 5: BEIBUu2pIflPrCL+Iks4CQ ($19.30 in chips) 
Seat 6: gehe91e0IyVT0QU/XBkEyg ($41.70 in chips) 
Seat 7: hPhp/RE3cJ5YGaQ2xOHXXg ($4.30 in chips) 
Seat 8: 18G4P1XstjNvItdGUITxgw ($26.05 in chips) 
Seat 9: +sbyWwIcFp9kP0bDtMegfQ ($36.90 in chips) 
gehe91e0IyVT0QU/XBkEyg: posts small blind $0.10
hPhp/RE3cJ5YGaQ2xOHXXg: posts big blind $0.25
*** HOLE CARDS ***
18G4P1XstjNvItdGUITxgw: folds 
+sbyWwIcFp9kP0bDtMegfQ: folds 
DiSvPC2iudwL5j9u6Huyww: folds 
uH1RN27w9SKa7TpVR9EFrQ: raises $0.75 to $1
N6fYvIzQLKaydFLKQGtMlQ: folds 
H8sSXb2KLK0U38tU9YITDw: folds 
BEIBUu2pIflPrCL+Iks4CQ: folds 
gehe91e0IyVT0QU/XBkEyg: folds 
hPhp/RE3cJ5YGaQ2xOHXXg: folds 
Uncalled bet ($0.75) returned to uH1RN27w9SKa7TpVR9EFrQ
uH1RN27w9SKa7TpVR9EFrQ collected $0.60 from pot
uH1RN27w9SKa7TpVR9EFrQ: doesn't show hand 
*** SUMMARY ***
Total pot $0.60 | Rake $0 
Seat 1: DiSvPC2iudwL5j9u6Huyww folded before Flop (didn't bet)
Seat 2: uH1RN27w9SKa7TpVR9EFrQ collected ($0.60)
Seat 3: N6fYvIzQLKaydFLKQGtMlQ folded before Flop (didn't bet)
Seat 4: H8sSXb2KLK0U38tU9YITDw folded before Flop (didn't bet)
Seat 5: BEIBUu2pIflPrCL+Iks4CQ (button) folded before Flop (didn't bet)
Seat 6: gehe91e0IyVT0QU/XBkEyg (small blind) folded before Flop
Seat 7: hPhp/RE3cJ5YGaQ2xOHXXg (big blind) folded before Flop
Seat 8: 18G4P1XstjNvItdGUITxgw folded before Flop (didn't bet)
Seat 9: +sbyWwIcFp9kP0bDtMegfQ folded before Flop (didn't bet)




PokerStars Game #59939445908:  Hold'em No Limit ($0.10/$0.25) - 2009/07/01 0:40:04 ET
Table 'mdub7rJf3Z5tCT9s/+1+Wg' 9-max Seat #7 is the button
Seat 1: neWdS67T0XWLJXFjrqXj5g ($16.10 in chips) 
Seat 2: vSkQm2EelzwRGDDQQk0Fqw ($4.65 in chips) 
Seat 3: t2nb95S5EEFOEzNx9Itz0g ($5 in chips) 
Seat 4: fDGyaQz0cs2s4FOYxkbIHA ($4.55 in chips) 
Seat 5: dfNim92Z6XK1/h5SFW5vDg ($25 in chips) 
Seat 6: hAFbY0iBwr4mouozgvjZBg ($47.60 in chips) 
Seat 7: woe+9KKk+L3pZgMTuHcmog ($31.70 in chips) 
Seat 8: cZ99hugmLBj9KhTlc8nCSw ($25 in chips) 
Seat 9: tYsOBqdU1+x+yFI7zHO7hQ ($36.75 in chips) 
cZ99hugmLBj9KhTlc8nCSw: posts small blind $0.10
tYsOBqdU1+x+yFI7zHO7hQ: posts big blind $0.25
*** HOLE CARDS ***
neWdS67T0XWLJXFjrqXj5g: calls $0.25
vSkQm2EelzwRGDDQQk0Fqw: folds 
t2nb95S5EEFOEzNx9Itz0g: folds 
fDGyaQz0cs2s4FOYxkbIHA: raises $0.25 to $0.50
dfNim92Z6XK1/h5SFW5vDg: folds 
hAFbY0iBwr4mouozgvjZBg: folds 
woe+9KKk+L3pZgMTuHcmog: folds 
cZ99hugmLBj9KhTlc8nCSw: folds 
tYsOBqdU1+x+yFI7zHO7hQ: folds 
neWdS67T0XWLJXFjrqXj5g: calls $0.25
*** FLOP *** [2d 2h 3c]
neWdS67T0XWLJXFjrqXj5g: bets $0.75
fDGyaQz0cs2s4FOYxkbIHA: raises $0.75 to $1.50
neWdS67T0XWLJXFjrqXj5g: calls $0.75
*** TURN *** [2d 2h 3c] [8c]
neWdS67T0XWLJXFjrqXj5g: checks 
fDGyaQz0cs2s4FOYxkbIHA: bets $2.55 and is all-in
neWdS67T0XWLJXFjrqXj5g: calls $2.55
*** RIVER *** [2d 2h 3c 8c] [9c]
*** SHOW DOWN ***
neWdS67T0XWLJXFjrqXj5g: shows [3s Qs] (two pair, Threes and Deuces)
fDGyaQz0cs2s4FOYxkbIHA: mucks hand 
neWdS67T0XWLJXFjrqXj5g collected $9 from pot
*** SUMMARY ***
Total pot $9.45 | Rake $0.45 
Board [2d 2h 3c 8c 9c]
Seat 1: neWdS67T0XWLJXFjrqXj5g showed [3s Qs] and won ($9) with two pair, Threes and Deuces
Seat 2: vSkQm2EelzwRGDDQQk0Fqw folded before Flop (didn't bet)
Seat 3: t2nb95S5EEFOEzNx9Itz0g folded before Flop (didn't bet)
Seat 4: fDGyaQz0cs2s4FOYxkbIHA mucked
Seat 5: dfNim92Z6XK1/h5SFW5vDg folded before Flop (didn't bet)
Seat 6: hAFbY0iBwr4mouozgvjZBg folded before Flop (didn't bet)
Seat 7: woe+9KKk+L3pZgMTuHcmog (button) folded before Flop (didn't bet)
Seat 8: cZ99hugmLBj9KhTlc8nCSw (small blind) folded before Flop
Seat 9: tYsOBqdU1+x+yFI7zHO7hQ (big blind) folded before Flop




PokerStars Game #59939445622:  Hold'em No Limit ($0.10/$0.25) - 2009/07/01 0:40:04 ET
Table 'T/iCKJXGphRN3xcdwfE/JQJYkCJJ5Iv+Tu52jx2lpEcgSeat #8 is the button
Seat 1: Yv4fucyyT28mjx8V5lxKJg ($27.25 in chips) 
Seat 2: hBMUlEpyU74r/fwDgIpXjQ ($35.60 in chips) 
Seat 3: Z5ZtGOON8kmSdSCll9Z3XA ($7.25 in chips) 
Seat 5: 6OVSxS1KoddUCYNkZ4hREw ($28.60 in chips) 
Seat 6: OiV1PWZ3IkN29JlmCcnTwQ ($5 in chips) 
Seat 7: N6fYvIzQLKaydFLKQGtMlQ ($24.90 in chips) 
Seat 8: COsrwJSFHQtxlUcrYtDQPQ ($25 in chips) 
Seat 9: H9KUl8cmpLgEpOVDA00bCg ($5.25 in chips) 
H9KUl8cmpLgEpOVDA00bCg: posts small blind $0.10
Yv4fucyyT28mjx8V5lxKJg: posts big blind $0.25
*** HOLE CARDS ***
hBMUlEpyU74r/fwDgIpXjQ: folds 
Z5ZtGOON8kmSdSCll9Z3XA: raises $0.25 to $0.50
6OVSxS1KoddUCYNkZ4hREw: folds 
OiV1PWZ3IkN29JlmCcnTwQ: folds 
N6fYvIzQLKaydFLKQGtMlQ: folds 
COsrwJSFHQtxlUcrYtDQPQ: folds 
H9KUl8cmpLgEpOVDA00bCg: folds 
Yv4fucyyT28mjx8V5lxKJg: raises $1.75 to $2.25
Z5ZtGOON8kmSdSCll9Z3XA: calls $1.75
*** FLOP *** [8s 3d 2c]
Yv4fucyyT28mjx8V5lxKJg: bets $4.25
Z5ZtGOON8kmSdSCll9Z3XA: folds 
Uncalled bet ($4.25) returned to Yv4fucyyT28mjx8V5lxKJg
Yv4fucyyT28mjx8V5lxKJg collected $4.40 from pot
Yv4fucyyT28mjx8V5lxKJg: doesn't show hand 
*** SUMMARY ***
Total pot $4.60 | Rake $0.20 
Board [8s 3d 2c]
Seat 1: Yv4fucyyT28mjx8V5lxKJg (big blind) collected ($4.40)
Seat 2: hBMUlEpyU74r/fwDgIpXjQ folded before Flop (didn't bet)
Seat 3: Z5ZtGOON8kmSdSCll9Z3XA folded on the Flop
Seat 5: 6OVSxS1KoddUCYNkZ4hREw folded before Flop (didn't bet)
Seat 6: OiV1PWZ3IkN29JlmCcnTwQ folded before Flop (didn't bet)
Seat 7: N6fYvIzQLKaydFLKQGtMlQ folded before Flop (didn't bet)
Seat 8: COsrwJSFHQtxlUcrYtDQPQ (button) folded before Flop (didn't bet)
Seat 9: H9KUl8cmpLgEpOVDA00bCg (small blind) folded before Flop




PokerStars Game #59939445946:  Hold'em No Limit ($0.10/$0.25) - 2009/07/01 0:40:04 ET
Table 'sIHZ0lzLr4NGCaBUKhmYhA' 6-max Seat #4 is the button
Seat 1: q6WfTUAD9mowIP63ASq2Dg ($34.55 in chips) 
Seat 2: 1xmHIWgZaOCqEMnW2GkFfw ($10.85 in chips) 
Seat 3: SxIIgwXYLkwd6m3wLyPTCw ($25.15 in chips) 
Seat 4: 4YSTu0Cdzpppe1lUgCZGCQ ($33.55 in chips) 
q6WfTUAD9mowIP63ASq2Dg: posts small blind $0.10
1xmHIWgZaOCqEMnW2GkFfw: posts big blind $0.25
*** HOLE CARDS ***
SxIIgwXYLkwd6m3wLyPTCw: folds 
4YSTu0Cdzpppe1lUgCZGCQ: folds 
q6WfTUAD9mowIP63ASq2Dg: folds 
Uncalled bet ($0.15) returned to 1xmHIWgZaOCqEMnW2GkFfw
q9qPRjJC40e/Q9yuT+glwQ leaves the table
1xmHIWgZaOCqEMnW2GkFfw collected $0.20 from pot
1xmHIWgZaOCqEMnW2GkFfw: doesn't show hand 
*** SUMMARY ***
Total pot $0.20 | Rake $0 
Seat 1: q6WfTUAD9mowIP63ASq2Dg (small blind) folded before Flop
Seat 2: 1xmHIWgZaOCqEMnW2GkFfw (big blind) collected ($0.20)
Seat 3: SxIIgwXYLkwd6m3wLyPTCw folded before Flop (didn't bet)
Seat 4: 4YSTu0Cdzpppe1lUgCZGCQ (button) folded before Flop (didn't bet)




PokerStars Game #59939445696:  Hold'em No Limit ($0.10/$0.25) - 2009/07/01 0:40:04 ET
Table 'ykyWGjhNu7AvZXov27T4ew' 9-max Seat #2 is the button
Seat 2: MG90wfSJZnOejs/KD3vlQQ ($25 in chips) 
Seat 3: r1pFKMwWp74QwhfPWJOAyw ($5.30 in chips) 
Seat 4: hBMUlEpyU74r/fwDgIpXjQ ($25.80 in chips) 
Seat 5: lMysP2jE94oJvWGA6K5puw ($7.25 in chips) 
Seat 6: opOCI2p6kW0tINuVaAqmcQ ($25 in chips) 
Seat 8: tYsOBqdU1+x+yFI7zHO7hQ ($35.85 in chips) 
Seat 9: Yv4fucyyT28mjx8V5lxKJg ($22.15 in chips) 
r1pFKMwWp74QwhfPWJOAyw: posts small blind $0.10
hBMUlEpyU74r/fwDgIpXjQ: posts big blind $0.25
CYkY0dNBaYaKs8HVCVn3mQ: sits out 
*** HOLE CARDS ***
lMysP2jE94oJvWGA6K5puw: folds 
opOCI2p6kW0tINuVaAqmcQ: raises $0.50 to $0.75
tYsOBqdU1+x+yFI7zHO7hQ: folds 
Yv4fucyyT28mjx8V5lxKJg: calls $0.75
MG90wfSJZnOejs/KD3vlQQ: raises $2.35 to $3.10
r1pFKMwWp74QwhfPWJOAyw: folds 
hBMUlEpyU74r/fwDgIpXjQ: folds 
opOCI2p6kW0tINuVaAqmcQ: folds 
Yv4fucyyT28mjx8V5lxKJg: calls $2.35
*** FLOP *** [6d Js Ah]
Yv4fucyyT28mjx8V5lxKJg: checks 
MG90wfSJZnOejs/KD3vlQQ: bets $5.60
Yv4fucyyT28mjx8V5lxKJg: calls $5.60
*** TURN *** [6d Js Ah] [4h]
Yv4fucyyT28mjx8V5lxKJg: checks 
MG90wfSJZnOejs/KD3vlQQ: bets $13.60
Yv4fucyyT28mjx8V5lxKJg: calls $13.45 and is all-in
Uncalled bet ($0.15) returned to MG90wfSJZnOejs/KD3vlQQ
*** RIVER *** [6d Js Ah 4h] [Qc]
*** SHOW DOWN ***
Yv4fucyyT28mjx8V5lxKJg: shows [Jc 9c] (a pair of Jacks)
MG90wfSJZnOejs/KD3vlQQ: shows [Kh As] (a pair of Aces)
MG90wfSJZnOejs/KD3vlQQ collected $43.20 from pot
*** SUMMARY ***
Total pot $45.40 | Rake $2.20 
Board [6d Js Ah 4h Qc]
Seat 2: MG90wfSJZnOejs/KD3vlQQ (button) showed [Kh As] and won ($43.20) with a pair of Aces
Seat 3: r1pFKMwWp74QwhfPWJOAyw (small blind) folded before Flop
Seat 4: hBMUlEpyU74r/fwDgIpXjQ (big blind) folded before Flop
Seat 5: lMysP2jE94oJvWGA6K5puw folded before Flop (didn't bet)
Seat 6: opOCI2p6kW0tINuVaAqmcQ folded before Flop
Seat 8: tYsOBqdU1+x+yFI7zHO7hQ folded before Flop (didn't bet)
Seat 9: Yv4fucyyT28mjx8V5lxKJg showed [Jc 9c] and lost with a pair of Jacks




PokerStars Game #59939445540:  Hold'em No Limit ($0.10/$0.25) - 2009/07/01 0:40:04 ET
Table '/AhP8uWRzEEhOATYIdmn0A' 9-max Seat #5 is the button
Seat 1: +sbyWwIcFp9kP0bDtMegfQ ($23.75 in chips) 
Seat 2: nvWCCH1JBjMjQkSaXl2Mog ($17.30 in chips) 
Seat 3: vSkQm2EelzwRGDDQQk0Fqw ($4.65 in chips) 
Seat 5: BEIBUu2pIflPrCL+Iks4CQ ($13.15 in chips) 
Seat 6: 1K6QGyJP9P9xmRac2fH4OQ ($25 in chips) 
Seat 7: 4oA316mXLIui1QY63GXBUg ($25 in chips) 
Seat 9: DIBbjEYGs+TVdVgEB/4+3w ($29.25 in chips) 
1K6QGyJP9P9xmRac2fH4OQ: posts small blind $0.10
4oA316mXLIui1QY63GXBUg: posts big blind $0.25
CYkY0dNBaYaKs8HVCVn3mQ: sits out 
*** HOLE CARDS ***
DIBbjEYGs+TVdVgEB/4+3w: folds 
+sbyWwIcFp9kP0bDtMegfQ: folds 
nvWCCH1JBjMjQkSaXl2Mog: folds 
vSkQm2EelzwRGDDQQk0Fqw: folds 
BEIBUu2pIflPrCL+Iks4CQ: raises $0.50 to $0.75
1K6QGyJP9P9xmRac2fH4OQ: folds 
4oA316mXLIui1QY63GXBUg: folds 
Uncalled bet ($0.50) returned to BEIBUu2pIflPrCL+Iks4CQ
BEIBUu2pIflPrCL+Iks4CQ collected $0.60 from pot
BEIBUu2pIflPrCL+Iks4CQ: doesn't show hand 
*** SUMMARY ***
Total pot $0.60 | Rake $0 
Seat 1: +sbyWwIcFp9kP0bDtMegfQ folded before Flop (didn't bet)
Seat 2: nvWCCH1JBjMjQkSaXl2Mog folded before Flop (didn't bet)
Seat 3: vSkQm2EelzwRGDDQQk0Fqw folded before Flop (didn't bet)
Seat 5: BEIBUu2pIflPrCL+Iks4CQ (button) collected ($0.60)
Seat 6: 1K6QGyJP9P9xmRac2fH4OQ (small blind) folded before Flop
Seat 7: 4oA316mXLIui1QY63GXBUg (big blind) folded before Flop
Seat 9: DIBbjEYGs+TVdVgEB/4+3w folded before Flop (didn't bet)




PokerStars Game #59939445904:  Hold'em No Limit ($0.10/$0.25) - 2009/07/01 0:40:04 ET
Table 'Pz8SfAzhP5nvWTsJRAxoDg' 6-max Seat #4 is the button
Seat 1: buyjetgNT1McXtdaP4zynA ($44.65 in chips) 
Seat 2: RYLaAIIwK9wxkPswt1yJYw ($23.05 in chips) 
Seat 3: mfrkWA3PTeYPkbO6hi98Aw ($30.50 in chips) 
Seat 4: 9U9Vy/656QCEfKznJWteag ($16.50 in chips) 
Seat 5: FYepjhAvF8ZdVCmqHIy+eQ ($30.05 in chips) 
Seat 6: FStoHe64SQWqAsjya9pDkQ ($25 in chips) 
FYepjhAvF8ZdVCmqHIy+eQ: posts small blind $0.10
FStoHe64SQWqAsjya9pDkQ: posts big blind $0.25
*** HOLE CARDS ***
buyjetgNT1McXtdaP4zynA: calls $0.25
RYLaAIIwK9wxkPswt1yJYw: folds 
mfrkWA3PTeYPkbO6hi98Aw: folds 
9U9Vy/656QCEfKznJWteag: calls $0.25
FYepjhAvF8ZdVCmqHIy+eQ: folds 
FStoHe64SQWqAsjya9pDkQ: checks 
*** FLOP *** [Td 4s Ks]
FStoHe64SQWqAsjya9pDkQ: checks 
buyjetgNT1McXtdaP4zynA: checks 
9U9Vy/656QCEfKznJWteag: bets $0.50
FStoHe64SQWqAsjya9pDkQ: folds 
buyjetgNT1McXtdaP4zynA: calls $0.50
*** TURN *** [Td 4s Ks] [6h]
buyjetgNT1McXtdaP4zynA: checks 
9U9Vy/656QCEfKznJWteag: checks 
*** RIVER *** [Td 4s Ks 6h] [6d]
buyjetgNT1McXtdaP4zynA: bets $1
9U9Vy/656QCEfKznJWteag: raises $1.75 to $2.75
buyjetgNT1McXtdaP4zynA: calls $1.75
*** SHOW DOWN ***
9U9Vy/656QCEfKznJWteag: shows [4d 4c] (a full house, Fours full of Sixes)
buyjetgNT1McXtdaP4zynA: mucks hand 
9U9Vy/656QCEfKznJWteag collected $7 from pot
*** SUMMARY ***
Total pot $7.35 | Rake $0.35 
Board [Td 4s Ks 6h 6d]
Seat 1: buyjetgNT1McXtdaP4zynA mucked
Seat 2: RYLaAIIwK9wxkPswt1yJYw folded before Flop (didn't bet)
Seat 3: mfrkWA3PTeYPkbO6hi98Aw folded before Flop (didn't bet)
Seat 4: 9U9Vy/656QCEfKznJWteag (button) showed [4d 4c] and won ($7) with a full house, Fours full of Sixes
Seat 5: FYepjhAvF8ZdVCmqHIy+eQ (small blind) folded before Flop
Seat 6: FStoHe64SQWqAsjya9pDkQ (big blind) folded on the Flop




PokerStars Game #59939446106:  Hold'em No Limit ($0.10/$0.25) - 2009/07/01 0:40:05 ET
Table 'VQNfcI8vTBCTvRfd3veTLQ' 6-max Seat #6 is the button
Seat 1: ymz+a8dgHSUFPooYplw7Ow ($23.85 in chips) 
Seat 2: KukIGupqqJCXA+Hp2bEFnA ($6.45 in chips) 
Seat 3: LtASJ9OlkqGrrUKGQlpGAw ($23.40 in chips) 
Seat 4: nc79pm0LZRdhncq55evVqA ($28.30 in chips) 
Seat 5: gX2vbKwS/8zZPENAWB7hxQ ($7.65 in chips) 
Seat 6: dlCLwmcvRShnuFDEVkdIEA ($12.35 in chips) 
ymz+a8dgHSUFPooYplw7Ow: posts small blind $0.10
KukIGupqqJCXA+Hp2bEFnA: posts big blind $0.25
*** HOLE CARDS ***
LtASJ9OlkqGrrUKGQlpGAw: folds 
nc79pm0LZRdhncq55evVqA: folds 
gX2vbKwS/8zZPENAWB7hxQ: folds 
dlCLwmcvRShnuFDEVkdIEA: calls $0.25
ymz+a8dgHSUFPooYplw7Ow: calls $0.15
KukIGupqqJCXA+Hp2bEFnA: checks 
*** FLOP *** [7s 3s 3c]
ymz+a8dgHSUFPooYplw7Ow: checks 
KukIGupqqJCXA+Hp2bEFnA: checks 
dlCLwmcvRShnuFDEVkdIEA: checks 
*** TURN *** [7s 3s 3c] [6h]
ymz+a8dgHSUFPooYplw7Ow: checks 
KukIGupqqJCXA+Hp2bEFnA: bets $0.25
dlCLwmcvRShnuFDEVkdIEA: folds 
ymz+a8dgHSUFPooYplw7Ow: folds 
Uncalled bet ($0.25) returned to KukIGupqqJCXA+Hp2bEFnA
KukIGupqqJCXA+Hp2bEFnA collected $0.75 from pot
*** SUMMARY ***
Total pot $0.75 | Rake $0 
Board [7s 3s 3c 6h]
Seat 1: ymz+a8dgHSUFPooYplw7Ow (small blind) folded on the Turn
Seat 2: KukIGupqqJCXA+Hp2bEFnA (big blind) collected ($0.75)
Seat 3: LtASJ9OlkqGrrUKGQlpGAw folded before Flop (didn't bet)
Seat 4: nc79pm0LZRdhncq55evVqA folded before Flop (didn't bet)
Seat 5: gX2vbKwS/8zZPENAWB7hxQ folded before Flop (didn't bet)
Seat 6: dlCLwmcvRShnuFDEVkdIEA (button) folded on the Turn




PokerStars Game #59939446172:  Hold'em No Limit ($0.10/$0.25) - 2009/07/01 0:40:05 ET
Table 'Qr+t8WGovMECkBv+cV1lrg' 6-max Seat #6 is the button
Seat 1: wFKQltIqUcrrkvre6g+fyw ($34 in chips) 
Seat 2: i48129QFpEQQ+UN4aNtmww ($5.30 in chips) 
Seat 3: bjJnMpKgoF+vgHW2f1NCsg ($18.50 in chips) 
Seat 4: 3rlIjSrvbZoI2IILbnetnA ($25.40 in chips) 
Seat 5: iwlxXocltgSdaBmusNXanQ ($14.85 in chips) 
Seat 6: j5NZbEJHsERuXjPHWqc1Nw ($20.15 in chips) 
wFKQltIqUcrrkvre6g+fyw: posts small blind $0.10
i48129QFpEQQ+UN4aNtmww: posts big blind $0.25
*** HOLE CARDS ***
bjJnMpKgoF+vgHW2f1NCsg: folds 
3rlIjSrvbZoI2IILbnetnA: folds 
iwlxXocltgSdaBmusNXanQ: folds 
j5NZbEJHsERuXjPHWqc1Nw: raises $0.75 to $1
wFKQltIqUcrrkvre6g+fyw: folds 
i48129QFpEQQ+UN4aNtmww: calls $0.75
*** FLOP *** [9h Qs 7c]
i48129QFpEQQ+UN4aNtmww: checks 
j5NZbEJHsERuXjPHWqc1Nw: bets $1
i48129QFpEQQ+UN4aNtmww: calls $1
*** TURN *** [9h Qs 7c] [Kc]
i48129QFpEQQ+UN4aNtmww: checks 
j5NZbEJHsERuXjPHWqc1Nw: bets $1.75
i48129QFpEQQ+UN4aNtmww: folds 
Uncalled bet ($1.75) returned to j5NZbEJHsERuXjPHWqc1Nw
j5NZbEJHsERuXjPHWqc1Nw collected $3.90 from pot
*** SUMMARY ***
Total pot $4.10 | Rake $0.20 
Board [9h Qs 7c Kc]
Seat 1: wFKQltIqUcrrkvre6g+fyw (small blind) folded before Flop
Seat 2: i48129QFpEQQ+UN4aNtmww (big blind) folded on the Turn
Seat 3: bjJnMpKgoF+vgHW2f1NCsg folded before Flop (didn't bet)
Seat 4: 3rlIjSrvbZoI2IILbnetnA folded before Flop (didn't bet)
Seat 5: iwlxXocltgSdaBmusNXanQ folded before Flop (didn't bet)
Seat 6: j5NZbEJHsERuXjPHWqc1Nw (button) collected ($3.90)




PokerStars Game #59939446640:  Hold'em No Limit ($0.10/$0.25) - 2009/07/01 0:40:05 ET
Table 'YmPuuzhvRUvgdYcNs5kZKw' 9-max Seat #3 is the button
Seat 1: Qi+clOtyDiibLdH2/1Qy8g ($25.30 in chips) 
Seat 2: Z5ZtGOON8kmSdSCll9Z3XA ($17 in chips) 
Seat 3: uLP/lYn7oKq9xCChBXsXxw ($24.50 in chips) 
Seat 6: z5GxcHlYz/GSz6W2uFiTtg ($21.80 in chips) 
Seat 7: opOCI2p6kW0tINuVaAqmcQ ($25.15 in chips) 
Seat 8: IeNTEKD96WqM7qU1RpSvOQ ($13.55 in chips) 
Seat 9: 5IeCaraAnS03/jUIjZQAig ($6.60 in chips) 
N6fYvIzQLKaydFLKQGtMlQ will be allowed to play after the button
CvL9Ch1HYCVbTsfpNucitg will be allowed to play after the button
z5GxcHlYz/GSz6W2uFiTtg: posts small blind $0.10
opOCI2p6kW0tINuVaAqmcQ: posts big blind $0.25
*** HOLE CARDS ***
IeNTEKD96WqM7qU1RpSvOQ: calls $0.25
5IeCaraAnS03/jUIjZQAig: folds 
Qi+clOtyDiibLdH2/1Qy8g: folds 
Z5ZtGOON8kmSdSCll9Z3XA: folds 
uLP/lYn7oKq9xCChBXsXxw: folds 
z5GxcHlYz/GSz6W2uFiTtg: calls $0.15
opOCI2p6kW0tINuVaAqmcQ: checks 
*** FLOP *** [9c 8h Kd]
z5GxcHlYz/GSz6W2uFiTtg: bets $0.75
opOCI2p6kW0tINuVaAqmcQ: folds 
IeNTEKD96WqM7qU1RpSvOQ: calls $0.75
*** TURN *** [9c 8h Kd] [Qc]
z5GxcHlYz/GSz6W2uFiTtg: bets $1.75
IeNTEKD96WqM7qU1RpSvOQ: calls $1.75
*** RIVER *** [9c 8h Kd Qc] [6s]
z5GxcHlYz/GSz6W2uFiTtg: bets $5.50
IeNTEKD96WqM7qU1RpSvOQ: folds 
Uncalled bet ($5.50) returned to z5GxcHlYz/GSz6W2uFiTtg
z5GxcHlYz/GSz6W2uFiTtg collected $5.50 from pot
*** SUMMARY ***
Total pot $5.75 | Rake $0.25 
Board [9c 8h Kd Qc 6s]
Seat 1: Qi+clOtyDiibLdH2/1Qy8g folded before Flop (didn't bet)
Seat 2: Z5ZtGOON8kmSdSCll9Z3XA folded before Flop (didn't bet)
Seat 3: uLP/lYn7oKq9xCChBXsXxw (button) folded before Flop (didn't bet)
Seat 6: z5GxcHlYz/GSz6W2uFiTtg (small blind) collected ($5.50)
Seat 7: opOCI2p6kW0tINuVaAqmcQ (big blind) folded on the Flop
Seat 8: IeNTEKD96WqM7qU1RpSvOQ folded on the River
Seat 9: 5IeCaraAnS03/jUIjZQAig folded before Flop (didn't bet)




PokerStars Game #59939446300:  Hold'em No Limit ($0.10/$0.25) - 2009/07/01 0:40:05 ET
Table 'x7YStLKc8hpt/pTgSetPKA' 9-max Seat #6 is the button
Seat 2: z5GxcHlYz/GSz6W2uFiTtg ($36.25 in chips) 
Seat 3: S7Ki0P+0AIGPuIfGJjW0gg ($25 in chips) 
Seat 5: gxyie8xe6lDdpfG4quHtbw ($15.15 in chips) 
Seat 6: Yv4fucyyT28mjx8V5lxKJg ($31.80 in chips) 
Seat 7: +8FtfKCFr23+6O39P+U45Q ($29.60 in chips) 
Seat 8: jeKWRUkMaVn8rEUjnJKqpg ($33.65 in chips) 
Seat 9: nm4Dj/f+jJEwKVsUnKh73g ($22.25 in chips) 
+8FtfKCFr23+6O39P+U45Q: posts small blind $0.10
jeKWRUkMaVn8rEUjnJKqpg: posts big blind $0.25
S7Ki0P+0AIGPuIfGJjW0gg: posts big blind $0.25
*** HOLE CARDS ***
nm4Dj/f+jJEwKVsUnKh73g: folds 
z5GxcHlYz/GSz6W2uFiTtg: folds 
S7Ki0P+0AIGPuIfGJjW0gg: raises $0.50 to $0.75
gxyie8xe6lDdpfG4quHtbw: folds 
Yv4fucyyT28mjx8V5lxKJg: folds 
+8FtfKCFr23+6O39P+U45Q: folds 
jeKWRUkMaVn8rEUjnJKqpg: folds 
Uncalled bet ($0.50) returned to S7Ki0P+0AIGPuIfGJjW0gg
S7Ki0P+0AIGPuIfGJjW0gg collected $0.60 from pot
S7Ki0P+0AIGPuIfGJjW0gg: doesn't show hand 
*** SUMMARY ***
Total pot $0.60 | Rake $0 
Seat 2: z5GxcHlYz/GSz6W2uFiTtg folded before Flop (didn't bet)
Seat 3: S7Ki0P+0AIGPuIfGJjW0gg collected ($0.60)
Seat 5: gxyie8xe6lDdpfG4quHtbw folded before Flop (didn't bet)
Seat 6: Yv4fucyyT28mjx8V5lxKJg (button) folded before Flop (didn't bet)
Seat 7: +8FtfKCFr23+6O39P+U45Q (small blind) folded before Flop
Seat 8: jeKWRUkMaVn8rEUjnJKqpg (big blind) folded before Flop
Seat 9: nm4Dj/f+jJEwKVsUnKh73g folded before Flop (didn't bet)




PokerStars Game #59939446038:  Hold'em No Limit ($0.10/$0.25) - 2009/07/01 0:40:05 ET
Table 'nc6OeGk/wtaWV+6N+kgnZQgZetDqJh6q9A3mLO3ThCsASeat #4 is the button
Seat 1: 1YCU970EVCcjs4GQP5Zt0g ($19.40 in chips) 
Seat 3: wKFJ513ucluNNiMlkXcDOQ ($32.10 in chips) 
Seat 4: eHsmIvAb2JREg4O6hNPnXg ($8.65 in chips) 
Seat 5: mfrkWA3PTeYPkbO6hi98Aw ($38.15 in chips) 
Seat 6: R1hR3/XSBdOHwcbSUJRJbg ($32 in chips) 
mfrkWA3PTeYPkbO6hi98Aw: posts small blind $0.10
R1hR3/XSBdOHwcbSUJRJbg: posts big blind $0.25
JFIAqU8lCZ0vWwEl4bdGsg: sits out 
*** HOLE CARDS ***
1YCU970EVCcjs4GQP5Zt0g: folds 
wKFJ513ucluNNiMlkXcDOQ: raises $0.75 to $1
eHsmIvAb2JREg4O6hNPnXg: folds 
mfrkWA3PTeYPkbO6hi98Aw: folds 
R1hR3/XSBdOHwcbSUJRJbg: raises $2.50 to $3.50
wKFJ513ucluNNiMlkXcDOQ: raises $7 to $10.50
R1hR3/XSBdOHwcbSUJRJbg: raises $16 to $26.50
wKFJ513ucluNNiMlkXcDOQ: raises $5.60 to $32.10 and is all-in
R1hR3/XSBdOHwcbSUJRJbg: calls $5.50 and is all-in
Uncalled bet ($0.10) returned to wKFJ513ucluNNiMlkXcDOQ
*** FLOP *** [9h 8h 7h]
*** TURN *** [9h 8h 7h] [2c]
*** RIVER *** [9h 8h 7h 2c] [7d]
*** SHOW DOWN ***
R1hR3/XSBdOHwcbSUJRJbg: shows [Kh Kd] (two pair, Kings and Sevens)
wKFJ513ucluNNiMlkXcDOQ: mucks hand 
R1hR3/XSBdOHwcbSUJRJbg collected $62.10 from pot
*** SUMMARY ***
Total pot $64.10 | Rake $2 
Board [9h 8h 7h 2c 7d]
Seat 1: 1YCU970EVCcjs4GQP5Zt0g folded before Flop (didn't bet)
Seat 3: wKFJ513ucluNNiMlkXcDOQ mucked
Seat 4: eHsmIvAb2JREg4O6hNPnXg (button) folded before Flop (didn't bet)
Seat 5: mfrkWA3PTeYPkbO6hi98Aw (small blind) folded before Flop
Seat 6: R1hR3/XSBdOHwcbSUJRJbg (big blind) showed [Kh Kd] and won ($62.10) with two pair, Kings and Sevens




PokerStars Game #59939446648:  Hold'em No Limit ($0.10/$0.25) - 2009/07/01 0:40:05 ET
Table 'LwnjzXstPtSrqrV/oDpnXQ' 9-max Seat #3 is the button
Seat 1: sChhj/mp8dm+nGvBS5mOIA ($19.10 in chips) 
Seat 2: K7bAhhMMJ/XcTmGaBZVfFQ ($28.35 in chips) 
Seat 3: u+XLsbPQIcRvPRnS1bvZww ($11.35 in chips) 
Seat 4: nmvbguGv4wKulGg49bANbQ ($13.50 in chips) 
Seat 5: Th3FldXKQW6hWVVPahaoOQ ($29.50 in chips) 
Seat 6: ljemhp25Zg+nlA9DLCIiUw ($31.40 in chips) 
Seat 8: h4ggJZYBXV0mEZzYPYKfeA ($32.80 in chips) 
Seat 9: N6fYvIzQLKaydFLKQGtMlQ ($24.40 in chips) 
nmvbguGv4wKulGg49bANbQ: posts small blind $0.10
Th3FldXKQW6hWVVPahaoOQ: posts big blind $0.25
c/Dw/6HyqldTzIRodAIZmg: sits out 
*** HOLE CARDS ***
ljemhp25Zg+nlA9DLCIiUw: folds 
h4ggJZYBXV0mEZzYPYKfeA: folds 
N6fYvIzQLKaydFLKQGtMlQ: folds 
sChhj/mp8dm+nGvBS5mOIA: calls $0.25
K7bAhhMMJ/XcTmGaBZVfFQ: calls $0.25
u+XLsbPQIcRvPRnS1bvZww: folds 
nmvbguGv4wKulGg49bANbQ: calls $0.15
Th3FldXKQW6hWVVPahaoOQ: checks 
*** FLOP *** [5d 5s 7s]
nmvbguGv4wKulGg49bANbQ: checks 
Th3FldXKQW6hWVVPahaoOQ: checks 
sChhj/mp8dm+nGvBS5mOIA: checks 
K7bAhhMMJ/XcTmGaBZVfFQ: bets $0.25
nmvbguGv4wKulGg49bANbQ: folds 
Th3FldXKQW6hWVVPahaoOQ: folds 
sChhj/mp8dm+nGvBS5mOIA: folds 
Uncalled bet ($0.25) returned to K7bAhhMMJ/XcTmGaBZVfFQ
K7bAhhMMJ/XcTmGaBZVfFQ collected $0.95 from pot
*** SUMMARY ***
Total pot $1 | Rake $0.05 
Board [5d 5s 7s]
Seat 1: sChhj/mp8dm+nGvBS5mOIA folded on the Flop
Seat 2: K7bAhhMMJ/XcTmGaBZVfFQ collected ($0.95)
Seat 3: u+XLsbPQIcRvPRnS1bvZww (button) folded before Flop (didn't bet)
Seat 4: nmvbguGv4wKulGg49bANbQ (small blind) folded on the Flop
Seat 5: Th3FldXKQW6hWVVPahaoOQ (big blind) folded on the Flop
Seat 6: ljemhp25Zg+nlA9DLCIiUw folded before Flop (didn't bet)
Seat 8: h4ggJZYBXV0mEZzYPYKfeA folded before Flop (didn't bet)
Seat 9: N6fYvIzQLKaydFLKQGtMlQ folded before Flop (didn't bet)




PokerStars Game #59939446370:  Hold'em No Limit ($0.10/$0.25) - 2009/07/01 0:40:05 ET
Table 'JUMeG5SzDyo9HufhgemQeA' 9-max Seat #7 is the button
Seat 1: N6fYvIzQLKaydFLKQGtMlQ ($24.65 in chips) 
Seat 2: ZeR3hkj1gVv9J4yPCmRrjA ($29.75 in chips) 
Seat 3: IEvLSTIxhlti3EjZDarYnA ($29.45 in chips) 
Seat 4: 6OP8CZnSFyny18DZqWIYog ($2.70 in chips) 
Seat 5: TI/C5Q+DEl4fLR3AofwYdg ($15.35 in chips) 
Seat 6: wFCwdYKUXoQHhz8qeZuuAw ($24.45 in chips) 
Seat 7: aNpwfA31EREwO+ar4XzBCw ($29.30 in chips) 
Seat 8: zDrucyjVn5aeekNEc3cJrA ($36.95 in chips) 
Seat 9: V6p0jQ/RhUsqpHLmXvEX4Q ($12.35 in chips) 
zDrucyjVn5aeekNEc3cJrA: posts small blind $0.10
V6p0jQ/RhUsqpHLmXvEX4Q: posts big blind $0.25
*** HOLE CARDS ***
N6fYvIzQLKaydFLKQGtMlQ: folds 
ZeR3hkj1gVv9J4yPCmRrjA: folds 
IEvLSTIxhlti3EjZDarYnA: calls $0.25
6OP8CZnSFyny18DZqWIYog: folds 
TI/C5Q+DEl4fLR3AofwYdg: raises $0.60 to $0.85
wFCwdYKUXoQHhz8qeZuuAw: folds 
aNpwfA31EREwO+ar4XzBCw: folds 
zDrucyjVn5aeekNEc3cJrA: folds 
V6p0jQ/RhUsqpHLmXvEX4Q: folds 
IEvLSTIxhlti3EjZDarYnA: calls $0.60
*** FLOP *** [Qs 4d Kd]
IEvLSTIxhlti3EjZDarYnA: checks 
TI/C5Q+DEl4fLR3AofwYdg: bets $0.25
IEvLSTIxhlti3EjZDarYnA: calls $0.25
*** TURN *** [Qs 4d Kd] [Ad]
IEvLSTIxhlti3EjZDarYnA: checks 
TI/C5Q+DEl4fLR3AofwYdg: checks 
*** RIVER *** [Qs 4d Kd Ad] [6c]
IEvLSTIxhlti3EjZDarYnA: checks 
TI/C5Q+DEl4fLR3AofwYdg: bets $1.25
IEvLSTIxhlti3EjZDarYnA: folds 
Uncalled bet ($1.25) returned to TI/C5Q+DEl4fLR3AofwYdg
TI/C5Q+DEl4fLR3AofwYdg collected $2.45 from pot
TI/C5Q+DEl4fLR3AofwYdg: doesn't show hand 
*** SUMMARY ***
Total pot $2.55 | Rake $0.10 
Board [Qs 4d Kd Ad 6c]
Seat 1: N6fYvIzQLKaydFLKQGtMlQ folded before Flop (didn't bet)
Seat 2: ZeR3hkj1gVv9J4yPCmRrjA folded before Flop (didn't bet)
Seat 3: IEvLSTIxhlti3EjZDarYnA folded on the River
Seat 4: 6OP8CZnSFyny18DZqWIYog folded before Flop (didn't bet)
Seat 5: TI/C5Q+DEl4fLR3AofwYdg collected ($2.45)
Seat 6: wFCwdYKUXoQHhz8qeZuuAw folded before Flop (didn't bet)
Seat 7: aNpwfA31EREwO+ar4XzBCw (button) folded before Flop (didn't bet)
Seat 8: zDrucyjVn5aeekNEc3cJrA (small blind) folded before Flop
Seat 9: V6p0jQ/RhUsqpHLmXvEX4Q (big blind) folded before Flop




PokerStars Game #59939446682:  Hold'em No Limit ($0.10/$0.25) - 2009/07/01 0:40:05 ET
Table '4ZbiE0ZYjzqmgu6+sO1prg' 9-max Seat #8 is the button
Seat 1: N6fYvIzQLKaydFLKQGtMlQ ($25.90 in chips) 
Seat 2: w31DkWCTQDVIzsHIrFRDxA ($13.65 in chips) 
Seat 3: HPEB+AtKw1+C/cxU0o1ciw ($23.80 in chips) 
Seat 4: Eb2mDXvZ4iY02krYdOYwMA ($26.40 in chips) 
Seat 5: COsrwJSFHQtxlUcrYtDQPQ ($25 in chips) 
Seat 6: rXm4QDVJt67H20lM6n6Z7Q ($7.90 in chips) 
Seat 7: 3RCAkueG3Vc13VpRStCB+w ($21.05 in chips) 
Seat 8: cZ99hugmLBj9KhTlc8nCSw ($25 in chips) 
Seat 9: 1K6QGyJP9P9xmRac2fH4OQ ($99.20 in chips) 
1K6QGyJP9P9xmRac2fH4OQ: posts small blind $0.10
N6fYvIzQLKaydFLKQGtMlQ: posts big blind $0.25
*** HOLE CARDS ***
w31DkWCTQDVIzsHIrFRDxA: raises $0.25 to $0.50
HPEB+AtKw1+C/cxU0o1ciw: folds 
Eb2mDXvZ4iY02krYdOYwMA: calls $0.50
COsrwJSFHQtxlUcrYtDQPQ: folds 
rXm4QDVJt67H20lM6n6Z7Q: folds 
3RCAkueG3Vc13VpRStCB+w: folds 
cZ99hugmLBj9KhTlc8nCSw: folds 
1K6QGyJP9P9xmRac2fH4OQ: folds 
N6fYvIzQLKaydFLKQGtMlQ: folds 
*** FLOP *** [4d Qs 2h]
w31DkWCTQDVIzsHIrFRDxA: checks 
Eb2mDXvZ4iY02krYdOYwMA: bets $0.75
w31DkWCTQDVIzsHIrFRDxA: calls $0.75
*** TURN *** [4d Qs 2h] [Jc]
w31DkWCTQDVIzsHIrFRDxA: checks 
Eb2mDXvZ4iY02krYdOYwMA: bets $1
w31DkWCTQDVIzsHIrFRDxA: calls $1
*** RIVER *** [4d Qs 2h Jc] [7c]
w31DkWCTQDVIzsHIrFRDxA: checks 
Eb2mDXvZ4iY02krYdOYwMA: bets $1.25
w31DkWCTQDVIzsHIrFRDxA: calls $1.25
*** SHOW DOWN ***
Eb2mDXvZ4iY02krYdOYwMA: shows [9h 8h] (high card Queen)
w31DkWCTQDVIzsHIrFRDxA: shows [Tc Ts] (a pair of Tens)
w31DkWCTQDVIzsHIrFRDxA collected $7 from pot
*** SUMMARY ***
Total pot $7.35 | Rake $0.35 
Board [4d Qs 2h Jc 7c]
Seat 1: N6fYvIzQLKaydFLKQGtMlQ (big blind) folded before Flop
Seat 2: w31DkWCTQDVIzsHIrFRDxA showed [Tc Ts] and won ($7) with a pair of Tens
Seat 3: HPEB+AtKw1+C/cxU0o1ciw folded before Flop (didn't bet)
Seat 4: Eb2mDXvZ4iY02krYdOYwMA showed [9h 8h] and lost with high card Queen
Seat 5: COsrwJSFHQtxlUcrYtDQPQ folded before Flop (didn't bet)
Seat 6: rXm4QDVJt67H20lM6n6Z7Q folded before Flop (didn't bet)
Seat 7: 3RCAkueG3Vc13VpRStCB+w folded before Flop (didn't bet)
Seat 8: cZ99hugmLBj9KhTlc8nCSw (button) folded before Flop (didn't bet)
Seat 9: 1K6QGyJP9P9xmRac2fH4OQ (small blind) folded before Flop




PokerStars Game #59939446374:  Hold'em No Limit ($0.10/$0.25) - 2009/07/01 0:40:05 ET
Table 'R5qKG21jwFDYRcOht9qwqQ' 9-max Seat #2 is the button
Seat 1: OgISYvc5hA85YuDnsXCH+Q ($15.50 in chips) 
Seat 2: N6foVRyErHqcNmshkqextQ ($15.40 in chips) 
Seat 3: M2QO2DxB5Wawg2h8HSpnYA ($10 in chips) 
Seat 4: z5GxcHlYz/GSz6W2uFiTtg ($26 in chips) 
Seat 5: 8B/dhbQjIWe6ASCdgzktNQ ($25 in chips) 
Seat 6: sUVgUtgbfVx6JpvApozwhQ ($11.10 in chips) 
Seat 7: HYQiVfBGJsg4smSubKCBmA ($28.50 in chips) 
Seat 8: tYsOBqdU1+x+yFI7zHO7hQ ($25 in chips) 
Seat 9: MG90wfSJZnOejs/KD3vlQQ ($26 in chips) 
M2QO2DxB5Wawg2h8HSpnYA: posts small blind $0.10
z5GxcHlYz/GSz6W2uFiTtg: posts big blind $0.25
*** HOLE CARDS ***
8B/dhbQjIWe6ASCdgzktNQ: folds 
sUVgUtgbfVx6JpvApozwhQ: folds 
HYQiVfBGJsg4smSubKCBmA: folds 
tYsOBqdU1+x+yFI7zHO7hQ: folds 
MG90wfSJZnOejs/KD3vlQQ: folds 
OgISYvc5hA85YuDnsXCH+Q: folds 
N6foVRyErHqcNmshkqextQ: folds 
M2QO2DxB5Wawg2h8HSpnYA: folds 
Uncalled bet ($0.15) returned to z5GxcHlYz/GSz6W2uFiTtg
z5GxcHlYz/GSz6W2uFiTtg collected $0.20 from pot
*** SUMMARY ***
Total pot $0.20 | Rake $0 
Seat 1: OgISYvc5hA85YuDnsXCH+Q folded before Flop (didn't bet)
Seat 2: N6foVRyErHqcNmshkqextQ (button) folded before Flop (didn't bet)
Seat 3: M2QO2DxB5Wawg2h8HSpnYA (small blind) folded before Flop
Seat 4: z5GxcHlYz/GSz6W2uFiTtg (big blind) collected ($0.20)
Seat 5: 8B/dhbQjIWe6ASCdgzktNQ folded before Flop (didn't bet)
Seat 6: sUVgUtgbfVx6JpvApozwhQ folded before Flop (didn't bet)
Seat 7: HYQiVfBGJsg4smSubKCBmA folded before Flop (didn't bet)
Seat 8: tYsOBqdU1+x+yFI7zHO7hQ folded before Flop (didn't bet)
Seat 9: MG90wfSJZnOejs/KD3vlQQ folded before Flop (didn't bet)




PokerStars Game #59939446994:  Hold'em No Limit ($0.10/$0.25) - 2009/07/01 0:40:06 ET
Table 'GoBmKm3klK6VavJE4STfmQ' 9-max Seat #7 is the button
Seat 1: N6fYvIzQLKaydFLKQGtMlQ ($23.55 in chips) 
Seat 2: 1c/7DHPx5CDTmAfk8/bWeA ($15 in chips) 
Seat 3: 4awUyiDYTgylQKXZ9faBVA ($26.40 in chips) 
Seat 4: H5Se03ZqSX7tbULXur2MAg ($24.30 in chips) 
Seat 5: 8B/dhbQjIWe6ASCdgzktNQ ($25.20 in chips) 
Seat 6: S3QwXyGCcujfAwNubHpwbw ($6.40 in chips) 
Seat 7: s9a4d23HFxaL70yUWQ0/tQ ($21.15 in chips) 
Seat 8: cZ99hugmLBj9KhTlc8nCSw ($25.10 in chips) 
Seat 9: 1K6QGyJP9P9xmRac2fH4OQ ($47 in chips) 
cZ99hugmLBj9KhTlc8nCSw: posts small blind $0.10
1K6QGyJP9P9xmRac2fH4OQ: posts big blind $0.25
*** HOLE CARDS ***
N6fYvIzQLKaydFLKQGtMlQ: folds 
1c/7DHPx5CDTmAfk8/bWeA: calls $0.25
4awUyiDYTgylQKXZ9faBVA: folds 
H5Se03ZqSX7tbULXur2MAg: folds 
8B/dhbQjIWe6ASCdgzktNQ: folds 
S3QwXyGCcujfAwNubHpwbw: calls $0.25
s9a4d23HFxaL70yUWQ0/tQ: calls $0.25
cZ99hugmLBj9KhTlc8nCSw: folds 
1K6QGyJP9P9xmRac2fH4OQ: checks 
*** FLOP *** [Kh 6d 6s]
1K6QGyJP9P9xmRac2fH4OQ: bets $0.70
1c/7DHPx5CDTmAfk8/bWeA: folds 
S3QwXyGCcujfAwNubHpwbw: folds 
s9a4d23HFxaL70yUWQ0/tQ: folds 
Uncalled bet ($0.70) returned to 1K6QGyJP9P9xmRac2fH4OQ
1K6QGyJP9P9xmRac2fH4OQ collected $1.05 from pot
1K6QGyJP9P9xmRac2fH4OQ: doesn't show hand 
*** SUMMARY ***
Total pot $1.10 | Rake $0.05 
Board [Kh 6d 6s]
Seat 1: N6fYvIzQLKaydFLKQGtMlQ folded before Flop (didn't bet)
Seat 2: 1c/7DHPx5CDTmAfk8/bWeA folded on the Flop
Seat 3: 4awUyiDYTgylQKXZ9faBVA folded before Flop (didn't bet)
Seat 4: H5Se03ZqSX7tbULXur2MAg folded before Flop (didn't bet)
Seat 5: 8B/dhbQjIWe6ASCdgzktNQ folded before Flop (didn't bet)
Seat 6: S3QwXyGCcujfAwNubHpwbw folded on the Flop
Seat 7: s9a4d23HFxaL70yUWQ0/tQ (button) folded on the Flop
Seat 8: cZ99hugmLBj9KhTlc8nCSw (small blind) folded before Flop
Seat 9: 1K6QGyJP9P9xmRac2fH4OQ (big blind) collected ($1.05)




PokerStars Game #59939446704:  Hold'em No Limit ($0.10/$0.25) - 2009/07/01 0:40:06 ET
Table 'aisAlB9GIV21BwfUW3+Nbg' 9-max Seat #7 is the button
Seat 1: H5Se03ZqSX7tbULXur2MAg ($22.70 in chips) 
Seat 2: 18G4P1XstjNvItdGUITxgw ($25 in chips) 
Seat 3: aaNpjkDAbOD7pVe8Z5CEgQ ($24 in chips) 
Seat 4: Z9AeOQX3yzuSvKAm/xyovg ($10 in chips) 
Seat 5: ghNKXUBl/H+t83JF079ZBA ($25 in chips) 
Seat 6: 9gmYYQesalMrUjaF7nKfrQ ($9.65 in chips) 
Seat 7: sWBBy1WroEskLNyJzhkUag ($14 in chips) 
Seat 8: VWUWpMLMj/Q1jRVpF7Aohw ($14.15 in chips) 
Seat 9: OlPJsgR4xypSg/w1z7Gyvw ($29.15 in chips) 
VWUWpMLMj/Q1jRVpF7Aohw: posts small blind $0.10
OlPJsgR4xypSg/w1z7Gyvw: posts big blind $0.25
*** HOLE CARDS ***
H5Se03ZqSX7tbULXur2MAg: raises $0.50 to $0.75
18G4P1XstjNvItdGUITxgw: folds 
aaNpjkDAbOD7pVe8Z5CEgQ: folds 
Z9AeOQX3yzuSvKAm/xyovg: folds 
ghNKXUBl/H+t83JF079ZBA: folds 
9gmYYQesalMrUjaF7nKfrQ: folds 
sWBBy1WroEskLNyJzhkUag: calls $0.75
VWUWpMLMj/Q1jRVpF7Aohw: folds 
OlPJsgR4xypSg/w1z7Gyvw: calls $0.50
*** FLOP *** [3s Jc Ks]
OlPJsgR4xypSg/w1z7Gyvw: checks 
H5Se03ZqSX7tbULXur2MAg: bets $1.50
sWBBy1WroEskLNyJzhkUag: raises $2.50 to $4
OlPJsgR4xypSg/w1z7Gyvw: folds 
H5Se03ZqSX7tbULXur2MAg: raises $17.95 to $21.95 and is all-in
sWBBy1WroEskLNyJzhkUag: folds 
Uncalled bet ($17.95) returned to H5Se03ZqSX7tbULXur2MAg
H5Se03ZqSX7tbULXur2MAg collected $9.85 from pot
H5Se03ZqSX7tbULXur2MAg: shows [Js As] (a pair of Jacks)
*** SUMMARY ***
Total pot $10.35 | Rake $0.50 
Board [3s Jc Ks]
Seat 1: H5Se03ZqSX7tbULXur2MAg collected ($9.85)
Seat 2: 18G4P1XstjNvItdGUITxgw folded before Flop (didn't bet)
Seat 3: aaNpjkDAbOD7pVe8Z5CEgQ folded before Flop (didn't bet)
Seat 4: Z9AeOQX3yzuSvKAm/xyovg folded before Flop (didn't bet)
Seat 5: ghNKXUBl/H+t83JF079ZBA folded before Flop (didn't bet)
Seat 6: 9gmYYQesalMrUjaF7nKfrQ folded before Flop (didn't bet)
Seat 7: sWBBy1WroEskLNyJzhkUag (button) folded on the Flop
Seat 8: VWUWpMLMj/Q1jRVpF7Aohw (small blind) folded before Flop
Seat 9: OlPJsgR4xypSg/w1z7Gyvw (big blind) folded on the Flop




PokerStars Game #59939447246:  Hold'em No Limit ($0.10/$0.25) - 2009/07/01 0:40:06 ET
Table 'gYBWJG3hEuJg6kphY0yhMg' 9-max Seat #2 is the button
Seat 1: s7Q6uNouhe7aE8JdFb9E+A ($25.25 in chips) 
Seat 2: z2SmIaQ3+5n/eY1BN5HgPg ($17.70 in chips) 
Seat 3: OkWGxhGhDA0lvNLGWmJxug ($11.10 in chips) 
Seat 4: V6p0jQ/RhUsqpHLmXvEX4Q ($12.35 in chips) 
Seat 5: +sbyWwIcFp9kP0bDtMegfQ ($24.55 in chips) 
Seat 6: 9AI+W5n0har4qZZPPHsjKg ($4.65 in chips) 
Seat 7: xqvFhQD+76TQUT0AVOUMAg ($28 in chips) 
Seat 9: DxA2S3LbITR502Wya4qTnw ($2.45 in chips) 
OkWGxhGhDA0lvNLGWmJxug: posts small blind $0.10
V6p0jQ/RhUsqpHLmXvEX4Q: posts big blind $0.25
*** HOLE CARDS ***
+sbyWwIcFp9kP0bDtMegfQ: folds 
9AI+W5n0har4qZZPPHsjKg: folds 
xqvFhQD+76TQUT0AVOUMAg: folds 
DxA2S3LbITR502Wya4qTnw: folds 
s7Q6uNouhe7aE8JdFb9E+A: raises $0.50 to $0.75
z2SmIaQ3+5n/eY1BN5HgPg: raises $1.75 to $2.50
OkWGxhGhDA0lvNLGWmJxug: calls $2.40
j4q3p0lesp63b1gZDwLBZw joins the table at seat #8 
V6p0jQ/RhUsqpHLmXvEX4Q: folds 
s7Q6uNouhe7aE8JdFb9E+A: folds 
*** FLOP *** [8c As 5c]
OkWGxhGhDA0lvNLGWmJxug: bets $1.50
z2SmIaQ3+5n/eY1BN5HgPg: calls $1.50
*** TURN *** [8c As 5c] [9c]
OkWGxhGhDA0lvNLGWmJxug: bets $2.50
z2SmIaQ3+5n/eY1BN5HgPg: raises $4.75 to $7.25
OkWGxhGhDA0lvNLGWmJxug: calls $4.60 and is all-in
Uncalled bet ($0.15) returned to z2SmIaQ3+5n/eY1BN5HgPg
*** RIVER *** [8c As 5c 9c] [Ks]
*** SHOW DOWN ***
OkWGxhGhDA0lvNLGWmJxug: shows [Tc Ts] (a pair of Tens)
z2SmIaQ3+5n/eY1BN5HgPg: shows [Qc Qs] (a pair of Queens)
z2SmIaQ3+5n/eY1BN5HgPg collected $22.10 from pot
*** SUMMARY ***
Total pot $23.20 | Rake $1.10 
Board [8c As 5c 9c Ks]
Seat 1: s7Q6uNouhe7aE8JdFb9E+A folded before Flop
Seat 2: z2SmIaQ3+5n/eY1BN5HgPg (button) showed [Qc Qs] and won ($22.10) with a pair of Queens
Seat 3: OkWGxhGhDA0lvNLGWmJxug (small blind) showed [Tc Ts] and lost with a pair of Tens
Seat 4: V6p0jQ/RhUsqpHLmXvEX4Q (big blind) folded before Flop
Seat 5: +sbyWwIcFp9kP0bDtMegfQ folded before Flop (didn't bet)
Seat 6: 9AI+W5n0har4qZZPPHsjKg folded before Flop (didn't bet)
Seat 7: xqvFhQD+76TQUT0AVOUMAg folded before Flop (didn't bet)
Seat 9: DxA2S3LbITR502Wya4qTnw folded before Flop (didn't bet)




PokerStars Game #59939446964:  Hold'em No Limit ($0.10/$0.25) - 2009/07/01 0:40:06 ET
Table 'R5f24ws6hGXlbvjq9ej+1Q' 9-max Seat #2 is the button
Seat 1: TeWJxSETzbXGiYKx0y+dtg ($26.30 in chips) 
Seat 2: 8lk6dG3H7iS/67/biw/vcQ ($26.55 in chips) 
Seat 4: jM9ExRdqCqq2e6TjpOBoRw ($17.40 in chips) 
Seat 5: YMlMWbkusacDBjx3A8lphw ($6.50 in chips) 
Seat 6: hPhp/RE3cJ5YGaQ2xOHXXg ($9.95 in chips) 
Seat 7: Z5ZtGOON8kmSdSCll9Z3XA ($8.35 in chips) 
Seat 8: qwr38jl5txoR36M7G5qi4A ($7.60 in chips) 
Seat 9: 33y9+GmQ3J84RvZXcraRTw ($27.40 in chips) 
jM9ExRdqCqq2e6TjpOBoRw: posts small blind $0.10
YMlMWbkusacDBjx3A8lphw: posts big blind $0.25
*** HOLE CARDS ***
hPhp/RE3cJ5YGaQ2xOHXXg: folds 
Z5ZtGOON8kmSdSCll9Z3XA: folds 
qwr38jl5txoR36M7G5qi4A: folds 
33y9+GmQ3J84RvZXcraRTw: folds 
TeWJxSETzbXGiYKx0y+dtg: folds 
8lk6dG3H7iS/67/biw/vcQ: folds 
jM9ExRdqCqq2e6TjpOBoRw: calls $0.15
YMlMWbkusacDBjx3A8lphw: checks 
*** FLOP *** [Ad 8c As]
jM9ExRdqCqq2e6TjpOBoRw: checks 
YMlMWbkusacDBjx3A8lphw: checks 
*** TURN *** [Ad 8c As] [6d]
jM9ExRdqCqq2e6TjpOBoRw: bets $0.25
YMlMWbkusacDBjx3A8lphw: folds 
Uncalled bet ($0.25) returned to jM9ExRdqCqq2e6TjpOBoRw
jM9ExRdqCqq2e6TjpOBoRw collected $0.50 from pot
jM9ExRdqCqq2e6TjpOBoRw: doesn't show hand 
*** SUMMARY ***
Total pot $0.50 | Rake $0 
Board [Ad 8c As 6d]
Seat 1: TeWJxSETzbXGiYKx0y+dtg folded before Flop (didn't bet)
Seat 2: 8lk6dG3H7iS/67/biw/vcQ (button) folded before Flop (didn't bet)
Seat 4: jM9ExRdqCqq2e6TjpOBoRw (small blind) collected ($0.50)
Seat 5: YMlMWbkusacDBjx3A8lphw (big blind) folded on the Turn
Seat 6: hPhp/RE3cJ5YGaQ2xOHXXg folded before Flop (didn't bet)
Seat 7: Z5ZtGOON8kmSdSCll9Z3XA folded before Flop (didn't bet)
Seat 8: qwr38jl5txoR36M7G5qi4A folded before Flop (didn't bet)
Seat 9: 33y9+GmQ3J84RvZXcraRTw folded before Flop (didn't bet)




PokerStars Game #59939446702:  Hold'em No Limit ($0.10/$0.25) - 2009/07/01 0:40:06 ET
Table 'fRxOyfaHXkWUDLv4eSxFew' 9-max Seat #6 is the button
Seat 2: TeWJxSETzbXGiYKx0y+dtg ($25 in chips) 
Seat 3: hBMUlEpyU74r/fwDgIpXjQ ($26.05 in chips) 
Seat 4: aCVg6cCxQcqClhB9nq/p1w ($51.50 in chips) 
Seat 6: N/O9ADKpmqB2ASZuqgodlw ($6.80 in chips) 
Seat 7: 7cv+9Zc9HIQHNvYsMfV3uA ($54.15 in chips) 
Seat 8: 1K6QGyJP9P9xmRac2fH4OQ ($25 in chips) 
Seat 9: H5Se03ZqSX7tbULXur2MAg ($23.80 in chips) 
7cv+9Zc9HIQHNvYsMfV3uA: posts small blind $0.10
1K6QGyJP9P9xmRac2fH4OQ: posts big blind $0.25
OlPJsgR4xypSg/w1z7Gyvw: sits out 
*** HOLE CARDS ***
H5Se03ZqSX7tbULXur2MAg: folds 
TeWJxSETzbXGiYKx0y+dtg: folds 
hBMUlEpyU74r/fwDgIpXjQ: folds 
aCVg6cCxQcqClhB9nq/p1w: folds 
N/O9ADKpmqB2ASZuqgodlw: calls $0.25
7cv+9Zc9HIQHNvYsMfV3uA: folds 
1K6QGyJP9P9xmRac2fH4OQ: checks 
*** FLOP *** [Kc Kd Qd]
1K6QGyJP9P9xmRac2fH4OQ: checks 
N/O9ADKpmqB2ASZuqgodlw: bets $1
1K6QGyJP9P9xmRac2fH4OQ: folds 
Uncalled bet ($1) returned to N/O9ADKpmqB2ASZuqgodlw
N/O9ADKpmqB2ASZuqgodlw collected $0.60 from pot
*** SUMMARY ***
Total pot $0.60 | Rake $0 
Board [Kc Kd Qd]
Seat 2: TeWJxSETzbXGiYKx0y+dtg folded before Flop (didn't bet)
Seat 3: hBMUlEpyU74r/fwDgIpXjQ folded before Flop (didn't bet)
Seat 4: aCVg6cCxQcqClhB9nq/p1w folded before Flop (didn't bet)
Seat 6: N/O9ADKpmqB2ASZuqgodlw (button) collected ($0.60)
Seat 7: 7cv+9Zc9HIQHNvYsMfV3uA (small blind) folded before Flop
Seat 8: 1K6QGyJP9P9xmRac2fH4OQ (big blind) folded on the Flop
Seat 9: H5Se03ZqSX7tbULXur2MAg folded before Flop (didn't bet)




PokerStars Game #59939447880:  Hold'em No Limit ($0.10/$0.25) - 2009/07/01 0:40:07 ET
Table 'M7d9IrgQUUFFy/SZ3ksLYg' 6-max Seat #2 is the button
Seat 1: cPO/1/dTcZpLkQFm3jH3Rg ($34.20 in chips) 
Seat 2: JE/wJXmjw3bpdmjwvh2pcg ($25 in chips) 
Seat 3: eHsmIvAb2JREg4O6hNPnXg ($15.80 in chips) 
Seat 4: 7FmwVDcdEtxDpHmP4hOXsQ ($29.90 in chips) 
Seat 6: /gJNBeCkWL4o85/jvlZ4BA ($25.50 in chips) 
eHsmIvAb2JREg4O6hNPnXg: posts small blind $0.10
7FmwVDcdEtxDpHmP4hOXsQ: posts big blind $0.25
*** HOLE CARDS ***
/gJNBeCkWL4o85/jvlZ4BA: folds 
cPO/1/dTcZpLkQFm3jH3Rg: folds 
JE/wJXmjw3bpdmjwvh2pcg: folds 
eHsmIvAb2JREg4O6hNPnXg: folds 
Uncalled bet ($0.15) returned to 7FmwVDcdEtxDpHmP4hOXsQ
7FmwVDcdEtxDpHmP4hOXsQ collected $0.20 from pot
7FmwVDcdEtxDpHmP4hOXsQ: doesn't show hand 
*** SUMMARY ***
Total pot $0.20 | Rake $0 
Seat 1: cPO/1/dTcZpLkQFm3jH3Rg folded before Flop (didn't bet)
Seat 2: JE/wJXmjw3bpdmjwvh2pcg (button) folded before Flop (didn't bet)
Seat 3: eHsmIvAb2JREg4O6hNPnXg (small blind) folded before Flop
Seat 4: 7FmwVDcdEtxDpHmP4hOXsQ (big blind) collected ($0.20)
Seat 6: /gJNBeCkWL4o85/jvlZ4BA folded before Flop (didn't bet)




PokerStars Game #59939447794:  Hold'em No Limit ($0.10/$0.25) - 2009/07/01 0:40:07 ET
Table 'LG9H161ZAHDkOww+ih3Ptg' 6-max Seat #4 is the button
Seat 1: avl8CO/tc0F6eVSiB/KNRA ($24.75 in chips) 
Seat 2: 9jSiy0meE9XJKkdIZwyTEQ ($28.95 in chips) 
Seat 3: sT4sjqzVMH/fZHz0hkbIPw ($37.40 in chips) 
Seat 4: 0C28L4/59aRNtHoBhqTcLg ($34.55 in chips) 
Seat 5: oseFhpinoe+Zg4j5xyBjyQ ($43.65 in chips) 
oseFhpinoe+Zg4j5xyBjyQ: posts small blind $0.10
avl8CO/tc0F6eVSiB/KNRA: posts big blind $0.25
*** HOLE CARDS ***
ludidzeko joins the table at seat #6 
9jSiy0meE9XJKkdIZwyTEQ: folds 
sT4sjqzVMH/fZHz0hkbIPw: raises $0.75 to $1
0C28L4/59aRNtHoBhqTcLg: calls $1
oseFhpinoe+Zg4j5xyBjyQ: folds 
avl8CO/tc0F6eVSiB/KNRA: folds 
*** FLOP *** [5d 2h Qc]
sT4sjqzVMH/fZHz0hkbIPw: bets $1
0C28L4/59aRNtHoBhqTcLg: calls $1
*** TURN *** [5d 2h Qc] [Jd]
sT4sjqzVMH/fZHz0hkbIPw: bets $2
0C28L4/59aRNtHoBhqTcLg: raises $2.50 to $4.50
sT4sjqzVMH/fZHz0hkbIPw: calls $2.50
*** RIVER *** [5d 2h Qc Jd] [8h]
sT4sjqzVMH/fZHz0hkbIPw: checks 
0C28L4/59aRNtHoBhqTcLg: bets $6.95
sT4sjqzVMH/fZHz0hkbIPw: folds 
Uncalled bet ($6.95) returned to 0C28L4/59aRNtHoBhqTcLg
0C28L4/59aRNtHoBhqTcLg collected $12.70 from pot
*** SUMMARY ***
Total pot $13.35 | Rake $0.65 
Board [5d 2h Qc Jd 8h]
Seat 1: avl8CO/tc0F6eVSiB/KNRA (big blind) folded before Flop
Seat 2: 9jSiy0meE9XJKkdIZwyTEQ folded before Flop (didn't bet)
Seat 3: sT4sjqzVMH/fZHz0hkbIPw folded on the River
Seat 4: 0C28L4/59aRNtHoBhqTcLg (button) collected ($12.70)
Seat 5: oseFhpinoe+Zg4j5xyBjyQ (small blind) folded before Flop




PokerStars Game #59939447882:  Hold'em No Limit ($0.10/$0.25) - 2009/07/01 0:40:07 ET
Table 'M8kYidAX3ib7pLKW7edFLw' 6-max Seat #5 is the button
Seat 1: 4YSTu0Cdzpppe1lUgCZGCQ ($39.65 in chips) 
Seat 4: /bjna2FTN7pPjqYGzmDE0Q ($23.85 in chips) 
Seat 5: bDKopKTvPi3W+PEnYUX3tg ($27.85 in chips) 
4YSTu0Cdzpppe1lUgCZGCQ: posts small blind $0.10
/bjna2FTN7pPjqYGzmDE0Q: posts big blind $0.25
*** HOLE CARDS ***
bDKopKTvPi3W+PEnYUX3tg: folds 
4YSTu0Cdzpppe1lUgCZGCQ: folds 
Uncalled bet ($0.15) returned to /bjna2FTN7pPjqYGzmDE0Q
/bjna2FTN7pPjqYGzmDE0Q collected $0.20 from pot
*** SUMMARY ***
Total pot $0.20 | Rake $0 
Seat 1: 4YSTu0Cdzpppe1lUgCZGCQ (small blind) folded before Flop
Seat 4: /bjna2FTN7pPjqYGzmDE0Q (big blind) collected ($0.20)
Seat 5: bDKopKTvPi3W+PEnYUX3tg (button) folded before Flop (didn't bet)




PokerStars Game #59939447608:  Hold'em No Limit ($0.10/$0.25) - 2009/07/01 0:40:07 ET
Table 'B3/JTS7usG3rxMfTbMiZuw' 6-max Seat #3 is the button
Seat 1: wAKC8C/zN0c8V5v13dm9mA ($29.90 in chips) 
Seat 2: 2gqWqkOq59pvtJKe4nS+rw ($23.15 in chips) 
Seat 3: PbMzPZIePKifKQZfKDkbIw ($25 in chips) 
Seat 4: kPCKvyB1yAABEgvF7OaG0g ($25.65 in chips) 
Seat 5: NhUN/JpAprdJeamFBgJH1w ($26.50 in chips) 
Seat 6: AGMIbXefZrMZ8QjfyCknDw ($19.70 in chips) 
kPCKvyB1yAABEgvF7OaG0g: posts small blind $0.10
NhUN/JpAprdJeamFBgJH1w: posts big blind $0.25
*** HOLE CARDS ***
AGMIbXefZrMZ8QjfyCknDw: folds 
wAKC8C/zN0c8V5v13dm9mA: folds 
2gqWqkOq59pvtJKe4nS+rw: calls $0.25
PbMzPZIePKifKQZfKDkbIw: folds 
AGMIbXefZrMZ8QjfyCknDw leaves the table
kPCKvyB1yAABEgvF7OaG0g: calls $0.15
NhUN/JpAprdJeamFBgJH1w: checks 
*** FLOP *** [Kh 7c 7h]
kPCKvyB1yAABEgvF7OaG0g: checks 
NhUN/JpAprdJeamFBgJH1w: bets $0.75
2gqWqkOq59pvtJKe4nS+rw: folds 
kPCKvyB1yAABEgvF7OaG0g: folds 
Uncalled bet ($0.75) returned to NhUN/JpAprdJeamFBgJH1w
NhUN/JpAprdJeamFBgJH1w collected $0.75 from pot
NhUN/JpAprdJeamFBgJH1w: doesn't show hand 
*** SUMMARY ***
Total pot $0.75 | Rake $0 
Board [Kh 7c 7h]
Seat 1: wAKC8C/zN0c8V5v13dm9mA folded before Flop (didn't bet)
Seat 2: 2gqWqkOq59pvtJKe4nS+rw folded on the Flop
Seat 3: PbMzPZIePKifKQZfKDkbIw (button) folded before Flop (didn't bet)
Seat 4: kPCKvyB1yAABEgvF7OaG0g (small blind) folded on the Flop
Seat 5: NhUN/JpAprdJeamFBgJH1w (big blind) collected ($0.75)
Seat 6: AGMIbXefZrMZ8QjfyCknDw folded before Flop (didn't bet)




PokerStars Game #59939447404:  Hold'em No Limit ($0.10/$0.25) - 2009/07/01 0:40:07 ET
Table 'WY+lMaAoIdBZmwk27/RJCA' 6-max Seat #5 is the button
Seat 1: lYjWCpfCxX2kgcHY3v4Yow ($25 in chips) 
Seat 2: cPO/1/dTcZpLkQFm3jH3Rg ($25.05 in chips) 
Seat 3: 79Q62AM0VB++TQYiBlOYsA ($38.05 in chips) 
Seat 4: cGfAi40F+9odP4v0stvfiQ ($25.95 in chips) 
Seat 5: wKFJ513ucluNNiMlkXcDOQ ($29.35 in chips) 
Seat 6: I1TxPvWj8NfG8orglCinNA ($27.60 in chips) 
I1TxPvWj8NfG8orglCinNA: posts small blind $0.10
lYjWCpfCxX2kgcHY3v4Yow: posts big blind $0.25
*** HOLE CARDS ***
cPO/1/dTcZpLkQFm3jH3Rg: folds 
79Q62AM0VB++TQYiBlOYsA: folds 
cGfAi40F+9odP4v0stvfiQ: calls $0.25
wKFJ513ucluNNiMlkXcDOQ: folds 
I1TxPvWj8NfG8orglCinNA: calls $0.15
lYjWCpfCxX2kgcHY3v4Yow: checks 
*** FLOP *** [5s Jc Ts]
I1TxPvWj8NfG8orglCinNA: checks 
lYjWCpfCxX2kgcHY3v4Yow: checks 
cGfAi40F+9odP4v0stvfiQ: checks 
*** TURN *** [5s Jc Ts] [8d]
I1TxPvWj8NfG8orglCinNA: checks 
lYjWCpfCxX2kgcHY3v4Yow: checks 
cGfAi40F+9odP4v0stvfiQ: bets $1
I1TxPvWj8NfG8orglCinNA: folds 
lYjWCpfCxX2kgcHY3v4Yow: folds 
Uncalled bet ($1) returned to cGfAi40F+9odP4v0stvfiQ
cGfAi40F+9odP4v0stvfiQ collected $0.75 from pot
*** SUMMARY ***
Total pot $0.75 | Rake $0 
Board [5s Jc Ts 8d]
Seat 1: lYjWCpfCxX2kgcHY3v4Yow (big blind) folded on the Turn
Seat 2: cPO/1/dTcZpLkQFm3jH3Rg folded before Flop (didn't bet)
Seat 3: 79Q62AM0VB++TQYiBlOYsA folded before Flop (didn't bet)
Seat 4: cGfAi40F+9odP4v0stvfiQ collected ($0.75)
Seat 5: wKFJ513ucluNNiMlkXcDOQ (button) folded before Flop (didn't bet)
Seat 6: I1TxPvWj8NfG8orglCinNA (small blind) folded on the Turn




PokerStars Game #59939447718:  Hold'em No Limit ($0.10/$0.25) - 2009/07/01 0:40:07 ET
Table 'AUM6O+mgQAaLDZKMQ/5/gA' 9-max Seat #4 is the button
Seat 1: Eyuoq9VsHg1Puw0nNzXTjg ($6.60 in chips) 
Seat 2: p0Q0llBV74kraoiHI/UzWA ($24.75 in chips) 
Seat 3: 3m6VfX7io8SA31qh1zCkgQ ($13.35 in chips) 
Seat 4: GIv32m/KBYU5WdIHUImuIg ($4.75 in chips) 
Seat 5: +2kMBNpY4nF1qNCRd8SJLA ($25 in chips) 
Seat 6: cFmpjvcjNoVAEAIQIxWkYg ($25 in chips) 
+2kMBNpY4nF1qNCRd8SJLA: posts small blind $0.10
cFmpjvcjNoVAEAIQIxWkYg: posts big blind $0.25
*** HOLE CARDS ***
jXz58rvCgq0VjyVjUBf2mw joins the table at seat #7 
zDrucyjVn5aeekNEc3cJrA was removed from the table for failing to post
Eyuoq9VsHg1Puw0nNzXTjg: calls $0.25
p0Q0llBV74kraoiHI/UzWA: folds 
zDrucyjVn5aeekNEc3cJrA joins the table at seat #8 
upsista joins the table at seat #9 
3m6VfX7io8SA31qh1zCkgQ: folds 
GIv32m/KBYU5WdIHUImuIg: folds 
+2kMBNpY4nF1qNCRd8SJLA: calls $0.15
cFmpjvcjNoVAEAIQIxWkYg: checks 
*** FLOP *** [8c Qs 5d]
+2kMBNpY4nF1qNCRd8SJLA: bets $0.50
cFmpjvcjNoVAEAIQIxWkYg: calls $0.50
Eyuoq9VsHg1Puw0nNzXTjg: folds 
*** TURN *** [8c Qs 5d] [Ac]
+2kMBNpY4nF1qNCRd8SJLA: checks 
cFmpjvcjNoVAEAIQIxWkYg: checks 
*** RIVER *** [8c Qs 5d Ac] [Qc]
+2kMBNpY4nF1qNCRd8SJLA: bets $1.75
cFmpjvcjNoVAEAIQIxWkYg: folds 
Uncalled bet ($1.75) returned to +2kMBNpY4nF1qNCRd8SJLA
+2kMBNpY4nF1qNCRd8SJLA collected $1.70 from pot
*** SUMMARY ***
Total pot $1.75 | Rake $0.05 
Board [8c Qs 5d Ac Qc]
Seat 1: Eyuoq9VsHg1Puw0nNzXTjg folded on the Flop
Seat 2: p0Q0llBV74kraoiHI/UzWA folded before Flop (didn't bet)
Seat 3: 3m6VfX7io8SA31qh1zCkgQ folded before Flop (didn't bet)
Seat 4: GIv32m/KBYU5WdIHUImuIg (button) folded before Flop (didn't bet)
Seat 5: +2kMBNpY4nF1qNCRd8SJLA (small blind) collected ($1.70)
Seat 6: cFmpjvcjNoVAEAIQIxWkYg (big blind) folded on the River




PokerStars Game #59939447520:  Hold'em No Limit ($0.10/$0.25) - 2009/07/01 0:40:07 ET
Table 'nlpa8xI95gAflovnFxB2yg' 6-max Seat #1 is the button
Seat 1: fZQg9veL7Dd/Z04ZTjC+wQ ($65.70 in chips) 
Seat 3: I1TxPvWj8NfG8orglCinNA ($25 in chips) 
Seat 4: 5xjU9nfIjn1MBxIJKZvS5w ($30.20 in chips) 
Seat 6: FPlQHZog0ePFCETQ2KG4hQ ($26.25 in chips) 
WrLI51S2iMb8GLMB83gGqA will be allowed to play after the button
I1TxPvWj8NfG8orglCinNA: posts small blind $0.10
5xjU9nfIjn1MBxIJKZvS5w: posts big blind $0.25
HotTillt: sits out 
*** HOLE CARDS ***
FPlQHZog0ePFCETQ2KG4hQ: folds 
fZQg9veL7Dd/Z04ZTjC+wQ: raises $0.75 to $1
I1TxPvWj8NfG8orglCinNA: folds 
5xjU9nfIjn1MBxIJKZvS5w: calls $0.75
*** FLOP *** [3c 4s Kc]
5xjU9nfIjn1MBxIJKZvS5w: checks 
HotTillt leaves the table
fZQg9veL7Dd/Z04ZTjC+wQ: checks 
*** TURN *** [3c 4s Kc] [5s]
6DwBRH+xZ12AAZmeAg+aXw joins the table at seat #5 
5xjU9nfIjn1MBxIJKZvS5w: bets $0.75
fZQg9veL7Dd/Z04ZTjC+wQ: folds 
Uncalled bet ($0.75) returned to 5xjU9nfIjn1MBxIJKZvS5w
5xjU9nfIjn1MBxIJKZvS5w collected $2 from pot
5xjU9nfIjn1MBxIJKZvS5w: doesn't show hand 
*** SUMMARY ***
Total pot $2.10 | Rake $0.10 
Board [3c 4s Kc 5s]
Seat 1: fZQg9veL7Dd/Z04ZTjC+wQ (button) folded on the Turn
Seat 3: I1TxPvWj8NfG8orglCinNA (small blind) folded before Flop
Seat 4: 5xjU9nfIjn1MBxIJKZvS5w (big blind) collected ($2)
Seat 6: FPlQHZog0ePFCETQ2KG4hQ folded before Flop (didn't bet)




PokerStars Game #59939448460:  Hold'em No Limit ($0.10/$0.25) - 2009/07/01 0:40:08 ET
Table 'nyTW9cVtYentc5V7xU/0jA' 6-max Seat #3 is the button
Seat 1: YfxPRDAWfqnGBhiIEdlTYg ($12.05 in chips) 
Seat 2: 7FmwVDcdEtxDpHmP4hOXsQ ($25 in chips) 
Seat 3: kG34n23qFQA3nzdOJTQ1dA ($24.55 in chips) 
Seat 4: r6u7MWSXF30/khcTYkrG9Q ($36.90 in chips) 
Seat 5: BedjMfrlRfPgSq7CXpPAmg ($25 in chips) 
Seat 6: dQJByDqHOLbgqX/HobyAJA ($7.75 in chips) 
r6u7MWSXF30/khcTYkrG9Q: posts small blind $0.10
BedjMfrlRfPgSq7CXpPAmg: posts big blind $0.25
*** HOLE CARDS ***
dQJByDqHOLbgqX/HobyAJA: folds 
YfxPRDAWfqnGBhiIEdlTYg: calls $0.25
7FmwVDcdEtxDpHmP4hOXsQ: folds 
kG34n23qFQA3nzdOJTQ1dA: folds 
r6u7MWSXF30/khcTYkrG9Q: folds 
BedjMfrlRfPgSq7CXpPAmg: checks 
*** FLOP *** [Qc 3h 8s]
BedjMfrlRfPgSq7CXpPAmg: checks 
YfxPRDAWfqnGBhiIEdlTYg: bets $0.50
BedjMfrlRfPgSq7CXpPAmg: folds 
Uncalled bet ($0.50) returned to YfxPRDAWfqnGBhiIEdlTYg
YfxPRDAWfqnGBhiIEdlTYg collected $0.60 from pot
*** SUMMARY ***
Total pot $0.60 | Rake $0 
Board [Qc 3h 8s]
Seat 1: YfxPRDAWfqnGBhiIEdlTYg collected ($0.60)
Seat 2: 7FmwVDcdEtxDpHmP4hOXsQ folded before Flop (didn't bet)
Seat 3: kG34n23qFQA3nzdOJTQ1dA (button) folded before Flop (didn't bet)
Seat 4: r6u7MWSXF30/khcTYkrG9Q (small blind) folded before Flop
Seat 5: BedjMfrlRfPgSq7CXpPAmg (big blind) folded on the Flop
Seat 6: dQJByDqHOLbgqX/HobyAJA folded before Flop (didn't bet)




PokerStars Game #59939448358:  Hold'em No Limit ($0.10/$0.25) - 2009/07/01 0:40:08 ET
Table 'ROYvQOMwUrvL3SOiHYcrWg' 9-max Seat #5 is the button
Seat 1: 7q7lZBfgmzjFr0jTNx4b6g ($11.70 in chips) 
Seat 2: hBMUlEpyU74r/fwDgIpXjQ ($48.85 in chips) 
Seat 4: SHegmCn8B0InbWE/zFlvOw ($28.70 in chips) 
Seat 5: jeKWRUkMaVn8rEUjnJKqpg ($25 in chips) 
Seat 7: tYsOBqdU1+x+yFI7zHO7hQ ($26 in chips) 
Seat 8: biJWLZ27fafNeBI2oT1KJw ($15 in chips) 
OiV1PWZ3IkN29JlmCcnTwQ will be allowed to play after the button
tYsOBqdU1+x+yFI7zHO7hQ: posts small blind $0.10
biJWLZ27fafNeBI2oT1KJw: posts big blind $0.25
*** HOLE CARDS ***
7q7lZBfgmzjFr0jTNx4b6g: folds 
hBMUlEpyU74r/fwDgIpXjQ: folds 
SHegmCn8B0InbWE/zFlvOw: calls $0.25
jeKWRUkMaVn8rEUjnJKqpg: folds 
tYsOBqdU1+x+yFI7zHO7hQ: folds 
biJWLZ27fafNeBI2oT1KJw: raises $0.50 to $0.75
SHegmCn8B0InbWE/zFlvOw: calls $0.50
*** FLOP *** [Ac 2c 4d]
biJWLZ27fafNeBI2oT1KJw: bets $0.50
SHegmCn8B0InbWE/zFlvOw: raises $1 to $1.50
biJWLZ27fafNeBI2oT1KJw: calls $1
*** TURN *** [Ac 2c 4d] [7h]
biJWLZ27fafNeBI2oT1KJw: bets $0.75
SHegmCn8B0InbWE/zFlvOw: calls $0.75
*** RIVER *** [Ac 2c 4d 7h] [Ts]
biJWLZ27fafNeBI2oT1KJw: bets $2
SHegmCn8B0InbWE/zFlvOw: folds 
Uncalled bet ($2) returned to biJWLZ27fafNeBI2oT1KJw
biJWLZ27fafNeBI2oT1KJw collected $5.85 from pot
*** SUMMARY ***
Total pot $6.10 | Rake $0.25 
Board [Ac 2c 4d 7h Ts]
Seat 1: 7q7lZBfgmzjFr0jTNx4b6g folded before Flop (didn't bet)
Seat 2: hBMUlEpyU74r/fwDgIpXjQ folded before Flop (didn't bet)
Seat 4: SHegmCn8B0InbWE/zFlvOw folded on the River
Seat 5: jeKWRUkMaVn8rEUjnJKqpg (button) folded before Flop (didn't bet)
Seat 7: tYsOBqdU1+x+yFI7zHO7hQ (small blind) folded before Flop
Seat 8: biJWLZ27fafNeBI2oT1KJw (big blind) collected ($5.85)




PokerStars Game #59939448324:  Hold'em No Limit ($0.10/$0.25) - 2009/07/01 0:40:08 ET
Table 'FuFyQHmlO/QqQp//rDRrPg' 6-max Seat #2 is the button
Seat 1: 4re+a1K56DcbV7DyVX/FMw ($15.45 in chips) 
Seat 2: 0DvgWV5o6c/jYqQCjm4Haw ($25 in chips) 
Seat 3: uoOTv6ecGYEhLPY44ZTW+A ($10.95 in chips) 
Seat 4: Eznneya0vB6S+eXJdVleHA ($8.90 in chips) 
Seat 5: wAKC8C/zN0c8V5v13dm9mA ($26.50 in chips) 
uoOTv6ecGYEhLPY44ZTW+A: posts small blind $0.10
Eznneya0vB6S+eXJdVleHA: posts big blind $0.25
6DwBRH+xZ12AAZmeAg+aXw: sits out 
*** HOLE CARDS ***
wAKC8C/zN0c8V5v13dm9mA: folds 
4re+a1K56DcbV7DyVX/FMw: folds 
0DvgWV5o6c/jYqQCjm4Haw: folds 
uoOTv6ecGYEhLPY44ZTW+A: calls $0.15
Eznneya0vB6S+eXJdVleHA: checks 
*** FLOP *** [4c Jd 9c]
uoOTv6ecGYEhLPY44ZTW+A: checks 
Eznneya0vB6S+eXJdVleHA: checks 
*** TURN *** [4c Jd 9c] [Qs]
uoOTv6ecGYEhLPY44ZTW+A: bets $0.25
Eznneya0vB6S+eXJdVleHA: folds 
Uncalled bet ($0.25) returned to uoOTv6ecGYEhLPY44ZTW+A
uoOTv6ecGYEhLPY44ZTW+A collected $0.50 from pot
uoOTv6ecGYEhLPY44ZTW+A: doesn't show hand 
*** SUMMARY ***
Total pot $0.50 | Rake $0 
Board [4c Jd 9c Qs]
Seat 1: 4re+a1K56DcbV7DyVX/FMw folded before Flop (didn't bet)
Seat 2: 0DvgWV5o6c/jYqQCjm4Haw (button) folded before Flop (didn't bet)
Seat 3: uoOTv6ecGYEhLPY44ZTW+A (small blind) collected ($0.50)
Seat 4: Eznneya0vB6S+eXJdVleHA (big blind) folded on the Turn
Seat 5: wAKC8C/zN0c8V5v13dm9mA folded before Flop (didn't bet)




PokerStars Game #59939448526:  Hold'em No Limit ($0.10/$0.25) - 2009/07/01 0:40:08 ET
Table 'fHv1Mk7ZbLjprZTGWKPiEQ' 6-max Seat #5 is the button
Seat 1: nrBtxp+MnBtUJ1AIhZxHkg ($31.05 in chips) 
Seat 3: HyeBXe7tNOZjTdX/zI0BZQ ($15 in chips) 
Seat 4: TSmua8tGK3sTbwi0ynrW9Q ($46.75 in chips) 
Seat 5: edio/rLJ06xeZOfLhoL3UA ($28.60 in chips) 
Seat 6: AjG0X+rNtc2W08eph8oqpw ($9.05 in chips) 
AjG0X+rNtc2W08eph8oqpw: posts small blind $0.10
nrBtxp+MnBtUJ1AIhZxHkg: posts big blind $0.25
f6TKWwdxmqfPaZe08T+mgg: sits out 
*** HOLE CARDS ***
HyeBXe7tNOZjTdX/zI0BZQ: folds 
TSmua8tGK3sTbwi0ynrW9Q: raises $0.75 to $1
edio/rLJ06xeZOfLhoL3UA: folds 
AjG0X+rNtc2W08eph8oqpw: folds 
nrBtxp+MnBtUJ1AIhZxHkg: calls $0.75
*** FLOP *** [4h Qd 8d]
nrBtxp+MnBtUJ1AIhZxHkg: checks 
TSmua8tGK3sTbwi0ynrW9Q: bets $1.50
nrBtxp+MnBtUJ1AIhZxHkg: calls $1.50
*** TURN *** [4h Qd 8d] [Kd]
nrBtxp+MnBtUJ1AIhZxHkg: checks 
TSmua8tGK3sTbwi0ynrW9Q: bets $3.50
nrBtxp+MnBtUJ1AIhZxHkg: folds 
Uncalled bet ($3.50) returned to TSmua8tGK3sTbwi0ynrW9Q
TSmua8tGK3sTbwi0ynrW9Q collected $4.85 from pot
*** SUMMARY ***
Total pot $5.10 | Rake $0.25 
Board [4h Qd 8d Kd]
Seat 1: nrBtxp+MnBtUJ1AIhZxHkg (big blind) folded on the Turn
Seat 3: HyeBXe7tNOZjTdX/zI0BZQ folded before Flop (didn't bet)
Seat 4: TSmua8tGK3sTbwi0ynrW9Q collected ($4.85)
Seat 5: edio/rLJ06xeZOfLhoL3UA (button) folded before Flop (didn't bet)
Seat 6: AjG0X+rNtc2W08eph8oqpw (small blind) folded before Flop




PokerStars Game #59939448382:  Hold'em No Limit ($0.10/$0.25) - 2009/07/01 0:40:08 ET
Table 'BpNkESDX1ip9c0K1hb5h7A' 6-max Seat #4 is the button
Seat 1: 9jSiy0meE9XJKkdIZwyTEQ ($28.75 in chips) 
Seat 3: cHhVLDikFlByGGN+CM3w/A ($24.50 in chips) 
Seat 4: tbhYGxTClzdFLMcTtjvJhg ($47.95 in chips) 
Seat 5: QvTX2yGq3uKJiKPmns4TKQ ($71.65 in chips) 
Seat 6: iUgsn+WyKFjjVd+tj13R2w ($16.60 in chips) 
QvTX2yGq3uKJiKPmns4TKQ: posts small blind $0.10
iUgsn+WyKFjjVd+tj13R2w: posts big blind $0.25
*** HOLE CARDS ***
9jSiy0meE9XJKkdIZwyTEQ: folds 
cHhVLDikFlByGGN+CM3w/A: raises $0.75 to $1
gqW2aBCmrIw65BvwjTFN6Q joins the table at seat #2 
tbhYGxTClzdFLMcTtjvJhg has timed out
tbhYGxTClzdFLMcTtjvJhg: folds 
tbhYGxTClzdFLMcTtjvJhg is sitting out
QvTX2yGq3uKJiKPmns4TKQ: folds 
iUgsn+WyKFjjVd+tj13R2w: calls $0.75
*** FLOP *** [5s 5c Qh]
iUgsn+WyKFjjVd+tj13R2w: checks 
cHhVLDikFlByGGN+CM3w/A: bets $1.50
iUgsn+WyKFjjVd+tj13R2w: folds 
Uncalled bet ($1.50) returned to cHhVLDikFlByGGN+CM3w/A
cHhVLDikFlByGGN+CM3w/A collected $2 from pot
cHhVLDikFlByGGN+CM3w/A: doesn't show hand 
*** SUMMARY ***
Total pot $2.10 | Rake $0.10 
Board [5s 5c Qh]
Seat 1: 9jSiy0meE9XJKkdIZwyTEQ folded before Flop (didn't bet)
Seat 3: cHhVLDikFlByGGN+CM3w/A collected ($2)
Seat 4: tbhYGxTClzdFLMcTtjvJhg (button) folded before Flop (didn't bet)
Seat 5: QvTX2yGq3uKJiKPmns4TKQ (small blind) folded before Flop
Seat 6: iUgsn+WyKFjjVd+tj13R2w (big blind) folded on the Flop




PokerStars Game #59939448210:  Hold'em No Limit ($0.10/$0.25) - 2009/07/01 0:40:08 ET
Table 'isKy4XK8wJM0x735/D4hWA' 6-max Seat #1 is the button
Seat 1: 7FmwVDcdEtxDpHmP4hOXsQ ($25.20 in chips) 
Seat 2: WrLI51S2iMb8GLMB83gGqA ($25.75 in chips) 
Seat 4: k9vn40MOqqb+xF+7GZ6v2g ($25 in chips) 
Seat 5: zlYHXTtJ5tcx9kwK2h5n9A ($37.40 in chips) 
Seat 6: M6xK/VklCvdyyrmvzATlxQ ($13.75 in chips) 
WrLI51S2iMb8GLMB83gGqA: posts small blind $0.10
k9vn40MOqqb+xF+7GZ6v2g: posts big blind $0.25
*** HOLE CARDS ***
jp34e617tIzV8tKIWmfAbA joins the table at seat #3 
zlYHXTtJ5tcx9kwK2h5n9A: folds 
M6xK/VklCvdyyrmvzATlxQ: raises $0.50 to $0.75
7FmwVDcdEtxDpHmP4hOXsQ: folds 
WrLI51S2iMb8GLMB83gGqA: folds 
k9vn40MOqqb+xF+7GZ6v2g: folds 
Uncalled bet ($0.50) returned to M6xK/VklCvdyyrmvzATlxQ
M6xK/VklCvdyyrmvzATlxQ collected $0.60 from pot
M6xK/VklCvdyyrmvzATlxQ: doesn't show hand 
*** SUMMARY ***
Total pot $0.60 | Rake $0 
Seat 1: 7FmwVDcdEtxDpHmP4hOXsQ (button) folded before Flop (didn't bet)
Seat 2: WrLI51S2iMb8GLMB83gGqA (small blind) folded before Flop
Seat 4: k9vn40MOqqb+xF+7GZ6v2g (big blind) folded before Flop
Seat 5: zlYHXTtJ5tcx9kwK2h5n9A folded before Flop (didn't bet)
Seat 6: M6xK/VklCvdyyrmvzATlxQ collected ($0.60)




PokerStars Game #59939449164:  Hold'em No Limit ($0.10/$0.25) - 2009/07/01 0:40:09 ET
Table 'mF3KHGMaTpaBZbtBoyfTeg' 6-max Seat #3 is the button
Seat 1: 0HAB2GdCAM7p7V00xueAVQ ($9.80 in chips) 
Seat 2: 4x9jCqgSw4272dnaIqnanw ($4.15 in chips) 
Seat 3: Hzrn9DZJegEZICufTNYkrg ($14.40 in chips) 
Seat 4: FYepjhAvF8ZdVCmqHIy+eQ ($25.65 in chips) 
Seat 5: sEQx9G5Cu8k1HNdQasxvUA ($28.40 in chips) 
FYepjhAvF8ZdVCmqHIy+eQ: posts small blind $0.10
sEQx9G5Cu8k1HNdQasxvUA: posts big blind $0.25
*** HOLE CARDS ***
0HAB2GdCAM7p7V00xueAVQ: folds 
4x9jCqgSw4272dnaIqnanw: raises $3.90 to $4.15 and is all-in
Hzrn9DZJegEZICufTNYkrg: folds 
FYepjhAvF8ZdVCmqHIy+eQ: folds 
sEQx9G5Cu8k1HNdQasxvUA: folds 
Uncalled bet ($3.90) returned to 4x9jCqgSw4272dnaIqnanw
4x9jCqgSw4272dnaIqnanw collected $0.60 from pot
*** SUMMARY ***
Total pot $0.60 | Rake $0 
Seat 1: 0HAB2GdCAM7p7V00xueAVQ folded before Flop (didn't bet)
Seat 2: 4x9jCqgSw4272dnaIqnanw collected ($0.60)
Seat 3: Hzrn9DZJegEZICufTNYkrg (button) folded before Flop (didn't bet)
Seat 4: FYepjhAvF8ZdVCmqHIy+eQ (small blind) folded before Flop
Seat 5: sEQx9G5Cu8k1HNdQasxvUA (big blind) folded before Flop




PokerStars Game #59939449044:  Hold'em No Limit ($0.10/$0.25) - 2009/07/01 0:40:09 ET
Table 'gkdjhbH1jaE3hwhPRIKMiQ' 6-max Seat #4 is the button
Seat 1: nc79pm0LZRdhncq55evVqA ($25.35 in chips) 
Seat 2: 1NNFfYMd5Hsphl/FYz9fNA ($33.30 in chips) 
Seat 4: 7uqewvdd5+KjmM7wl58k+w ($14.95 in chips) 
Seat 5: Ew/TYPQIsbQ2X8nm5iAJBg ($26 in chips) 
Seat 6: wqphQtauX5Qn7WRJZS1flA ($26 in chips) 
Ew/TYPQIsbQ2X8nm5iAJBg: posts small blind $0.10
wqphQtauX5Qn7WRJZS1flA: posts big blind $0.25
kG34n23qFQA3nzdOJTQ1dA: sits out 
*** HOLE CARDS ***
nc79pm0LZRdhncq55evVqA: folds 
1NNFfYMd5Hsphl/FYz9fNA: folds 
7uqewvdd5+KjmM7wl58k+w: folds 
Ew/TYPQIsbQ2X8nm5iAJBg: folds 
Uncalled bet ($0.15) returned to wqphQtauX5Qn7WRJZS1flA
wqphQtauX5Qn7WRJZS1flA collected $0.20 from pot
wqphQtauX5Qn7WRJZS1flA: doesn't show hand 
*** SUMMARY ***
Total pot $0.20 | Rake $0 
Seat 1: nc79pm0LZRdhncq55evVqA folded before Flop (didn't bet)
Seat 2: 1NNFfYMd5Hsphl/FYz9fNA folded before Flop (didn't bet)
Seat 4: 7uqewvdd5+KjmM7wl58k+w (button) folded before Flop (didn't bet)
Seat 5: Ew/TYPQIsbQ2X8nm5iAJBg (small blind) folded before Flop
Seat 6: wqphQtauX5Qn7WRJZS1flA (big blind) collected ($0.20)




PokerStars Game #59939449058:  Hold'em No Limit ($0.10/$0.25) - 2009/07/01 0:40:09 ET
Table 'nB7Q7zfNfy6ig6DB+rsgWQ' 6-max Seat #2 is the button
Seat 1: ACU3rO57RhDJfAgHTq2ocA ($4.35 in chips) 
Seat 2: g6kf+5FIgWH33PmH6ZecMQ ($14.15 in chips) 
Seat 3: p3NYOxYhkL7txPRSeXHDeg ($34.85 in chips) 
Seat 4: YZjG5I7FqwMKy06BKVBS7w ($9.55 in chips) 
Seat 5: X0/5h4o4LdHWlM7o/9shzg ($7.30 in chips) 
Seat 6: BYxjLnV1/LL0aZcTbfAOvw ($39.90 in chips) 
p3NYOxYhkL7txPRSeXHDeg: posts small blind $0.10
YZjG5I7FqwMKy06BKVBS7w: posts big blind $0.25
*** HOLE CARDS ***
X0/5h4o4LdHWlM7o/9shzg: folds 
BYxjLnV1/LL0aZcTbfAOvw: folds 
ACU3rO57RhDJfAgHTq2ocA: folds 
g6kf+5FIgWH33PmH6ZecMQ: calls $0.25
p3NYOxYhkL7txPRSeXHDeg: folds 
YZjG5I7FqwMKy06BKVBS7w: checks 
*** FLOP *** [Jh 5s 9h]
YZjG5I7FqwMKy06BKVBS7w: checks 
g6kf+5FIgWH33PmH6ZecMQ: checks 
*** TURN *** [Jh 5s 9h] [9c]
YZjG5I7FqwMKy06BKVBS7w: bets $0.50
g6kf+5FIgWH33PmH6ZecMQ: calls $0.50
*** RIVER *** [Jh 5s 9h 9c] [3d]
YZjG5I7FqwMKy06BKVBS7w: checks 
g6kf+5FIgWH33PmH6ZecMQ: bets $0.75
YZjG5I7FqwMKy06BKVBS7w said, "i think u miss ur flush"
YZjG5I7FqwMKy06BKVBS7w said, "or ur straight"
YZjG5I7FqwMKy06BKVBS7w: calls $0.75
*** SHOW DOWN ***
g6kf+5FIgWH33PmH6ZecMQ: shows [6s Jc] (two pair, Jacks and Nines)
YZjG5I7FqwMKy06BKVBS7w: mucks hand 
YZjG5I7FqwMKy06BKVBS7w said, "umm"
g6kf+5FIgWH33PmH6ZecMQ collected $2.95 from pot
YZjG5I7FqwMKy06BKVBS7w said, "nice hand"
*** SUMMARY ***
Total pot $3.10 | Rake $0.15 
Board [Jh 5s 9h 9c 3d]
Seat 1: ACU3rO57RhDJfAgHTq2ocA folded before Flop (didn't bet)
Seat 2: g6kf+5FIgWH33PmH6ZecMQ (button) showed [6s Jc] and won ($2.95) with two pair, Jacks and Nines
Seat 3: p3NYOxYhkL7txPRSeXHDeg (small blind) folded before Flop
Seat 4: YZjG5I7FqwMKy06BKVBS7w (big blind) mucked
Seat 5: X0/5h4o4LdHWlM7o/9shzg folded before Flop (didn't bet)
Seat 6: BYxjLnV1/LL0aZcTbfAOvw folded before Flop (didn't bet)




PokerStars Game #59939448968:  Hold'em No Limit ($0.10/$0.25) - 2009/07/01 0:40:09 ET
Table 'l8hUTjBTXBorNUR/tyvSLw' 9-max Seat #9 is the button
Seat 2: ZeR3hkj1gVv9J4yPCmRrjA ($50.60 in chips) 
Seat 3: 6TWO15+WfJ5HfI8CbJ4a0w ($8.50 in chips) 
Seat 4: vPtFvcPtn/Afz0sucO1cmQ ($37.60 in chips) 
Seat 5: S7Ki0P+0AIGPuIfGJjW0gg ($13.60 in chips) 
Seat 6: nkD1GtC3+ft+4U3Od0H10A ($14.20 in chips) 
Seat 7: awxYB5n5W4JUl1V4Xsn26g ($4.65 in chips) 
Seat 8: kZJjw0YSgO2CZKraCg0v8g ($12.40 in chips) 
Seat 9: zDrucyjVn5aeekNEc3cJrA ($35.75 in chips) 
ZeR3hkj1gVv9J4yPCmRrjA: posts small blind $0.10
6TWO15+WfJ5HfI8CbJ4a0w: posts big blind $0.25
*** HOLE CARDS ***
vPtFvcPtn/Afz0sucO1cmQ: calls $0.25
S7Ki0P+0AIGPuIfGJjW0gg: folds 
nkD1GtC3+ft+4U3Od0H10A: calls $0.25
awxYB5n5W4JUl1V4Xsn26g: folds 
q9qPRjJC40e/Q9yuT+glwQ leaves the table
kZJjw0YSgO2CZKraCg0v8g: folds 
cZ99hugmLBj9KhTlc8nCSw joins the table at seat #1 
zDrucyjVn5aeekNEc3cJrA: folds 
ZeR3hkj1gVv9J4yPCmRrjA: folds 
6TWO15+WfJ5HfI8CbJ4a0w: raises $0.25 to $0.50
vPtFvcPtn/Afz0sucO1cmQ: calls $0.25
nkD1GtC3+ft+4U3Od0H10A: calls $0.25
*** FLOP *** [7s Jd 6s]
6TWO15+WfJ5HfI8CbJ4a0w: bets $1.25
vPtFvcPtn/Afz0sucO1cmQ: folds 
nkD1GtC3+ft+4U3Od0H10A: folds 
Uncalled bet ($1.25) returned to 6TWO15+WfJ5HfI8CbJ4a0w
6TWO15+WfJ5HfI8CbJ4a0w collected $1.55 from pot
6TWO15+WfJ5HfI8CbJ4a0w: doesn't show hand 
*** SUMMARY ***
Total pot $1.60 | Rake $0.05 
Board [7s Jd 6s]
Seat 2: ZeR3hkj1gVv9J4yPCmRrjA (small blind) folded before Flop
Seat 3: 6TWO15+WfJ5HfI8CbJ4a0w (big blind) collected ($1.55)
Seat 4: vPtFvcPtn/Afz0sucO1cmQ folded on the Flop
Seat 5: S7Ki0P+0AIGPuIfGJjW0gg folded before Flop (didn't bet)
Seat 6: nkD1GtC3+ft+4U3Od0H10A folded on the Flop
Seat 7: awxYB5n5W4JUl1V4Xsn26g folded before Flop (didn't bet)
Seat 8: kZJjw0YSgO2CZKraCg0v8g folded before Flop (didn't bet)
Seat 9: zDrucyjVn5aeekNEc3cJrA (button) folded before Flop (didn't bet)




PokerStars Game #59939448918:  Hold'em No Limit ($0.10/$0.25) - 2009/07/01 0:40:09 ET
Table 'P2yJ+jwfNsBdF12fLKA6DQ' 9-max Seat #5 is the button
Seat 1: zDrucyjVn5aeekNEc3cJrA ($26.25 in chips) 
Seat 2: A1WO60C/QOiRxQuPxxQ/Qw ($22.80 in chips) 
Seat 3: aNpwfA31EREwO+ar4XzBCw ($27.20 in chips) 
Seat 4: dfNim92Z6XK1/h5SFW5vDg ($25 in chips) 
Seat 5: KUcJLaHvrSlvGyIGqDQp9A ($15.95 in chips) 
Seat 6: tIIUJycKjdqE3z/SXWAEwA ($4.15 in chips) 
Seat 7: 1/DuWziR8CXhWB71aPQd9Q ($10 in chips) 
Seat 8: LWN1wPrLH+695JIriXxDuw ($10 in chips) 
Seat 9: Jurq55Mpn9JwRMif6CgVxw ($3.45 in chips) 
tIIUJycKjdqE3z/SXWAEwA: posts small blind $0.10
1/DuWziR8CXhWB71aPQd9Q: posts big blind $0.25
*** HOLE CARDS ***
LWN1wPrLH+695JIriXxDuw: folds 
Jurq55Mpn9JwRMif6CgVxw: calls $0.25
zDrucyjVn5aeekNEc3cJrA: folds 
A1WO60C/QOiRxQuPxxQ/Qw: folds 
aNpwfA31EREwO+ar4XzBCw: folds 
dfNim92Z6XK1/h5SFW5vDg: folds 
KUcJLaHvrSlvGyIGqDQp9A: folds 
A1WO60C/QOiRxQuPxxQ/Qw leaves the table
tIIUJycKjdqE3z/SXWAEwA: raises $0.50 to $0.75
1/DuWziR8CXhWB71aPQd9Q: folds 
V6p0jQ/RhUsqpHLmXvEX4Q joins the table at seat #2 
Jurq55Mpn9JwRMif6CgVxw: calls $0.50
*** FLOP *** [Ks Qs 2c]
tIIUJycKjdqE3z/SXWAEwA: checks 
Jurq55Mpn9JwRMif6CgVxw: checks 
*** TURN *** [Ks Qs 2c] [5s]
tIIUJycKjdqE3z/SXWAEwA: bets $1
Jurq55Mpn9JwRMif6CgVxw: folds 
Uncalled bet ($1) returned to tIIUJycKjdqE3z/SXWAEwA
tIIUJycKjdqE3z/SXWAEwA collected $1.70 from pot
tIIUJycKjdqE3z/SXWAEwA: doesn't show hand 
*** SUMMARY ***
Total pot $1.75 | Rake $0.05 
Board [Ks Qs 2c 5s]
Seat 1: zDrucyjVn5aeekNEc3cJrA folded before Flop (didn't bet)
Seat 2: A1WO60C/QOiRxQuPxxQ/Qw folded before Flop (didn't bet)
Seat 3: aNpwfA31EREwO+ar4XzBCw folded before Flop (didn't bet)
Seat 4: dfNim92Z6XK1/h5SFW5vDg folded before Flop (didn't bet)
Seat 5: KUcJLaHvrSlvGyIGqDQp9A (button) folded before Flop (didn't bet)
Seat 6: tIIUJycKjdqE3z/SXWAEwA (small blind) collected ($1.70)
Seat 7: 1/DuWziR8CXhWB71aPQd9Q (big blind) folded before Flop
Seat 8: LWN1wPrLH+695JIriXxDuw folded before Flop (didn't bet)
Seat 9: Jurq55Mpn9JwRMif6CgVxw folded on the Turn




PokerStars Game #59939449144:  Hold'em No Limit ($0.10/$0.25) - 2009/07/01 0:40:09 ET
Table 'GrYi0DZOHD1EvB+qiLExNw' 9-max Seat #6 is the button
Seat 1: 4awUyiDYTgylQKXZ9faBVA ($48.85 in chips) 
Seat 2: Th3FldXKQW6hWVVPahaoOQ ($26.65 in chips) 
Seat 3: 4oA316mXLIui1QY63GXBUg ($25 in chips) 
Seat 4: 0GQg6tdDMBDzY6FKumSo9w ($25.75 in chips) 
Seat 5: cZ99hugmLBj9KhTlc8nCSw ($48.50 in chips) 
Seat 6: H9KUl8cmpLgEpOVDA00bCg ($4.20 in chips) 
Seat 7: 1Clf3cPrqoy/YgvWdWK1Xw ($5 in chips) 
Seat 8: nalbG/4/1Z1wQjRDWV7b2w ($7 in chips) 
Seat 9: st9jtdNbm1W5GfBwRaCVqQ ($24.75 in chips) 
1Clf3cPrqoy/YgvWdWK1Xw: posts small blind $0.10
nalbG/4/1Z1wQjRDWV7b2w: posts big blind $0.25
*** HOLE CARDS ***
st9jtdNbm1W5GfBwRaCVqQ: folds 
4awUyiDYTgylQKXZ9faBVA: folds 
Th3FldXKQW6hWVVPahaoOQ: folds 
4oA316mXLIui1QY63GXBUg: folds 
0GQg6tdDMBDzY6FKumSo9w: folds 
cZ99hugmLBj9KhTlc8nCSw: folds 
H9KUl8cmpLgEpOVDA00bCg: folds 
1Clf3cPrqoy/YgvWdWK1Xw: folds 
Uncalled bet ($0.15) returned to nalbG/4/1Z1wQjRDWV7b2w
nalbG/4/1Z1wQjRDWV7b2w collected $0.20 from pot
nalbG/4/1Z1wQjRDWV7b2w: doesn't show hand 
*** SUMMARY ***
Total pot $0.20 | Rake $0 
Seat 1: 4awUyiDYTgylQKXZ9faBVA folded before Flop (didn't bet)
Seat 2: Th3FldXKQW6hWVVPahaoOQ folded before Flop (didn't bet)
Seat 3: 4oA316mXLIui1QY63GXBUg folded before Flop (didn't bet)
Seat 4: 0GQg6tdDMBDzY6FKumSo9w folded before Flop (didn't bet)
Seat 5: cZ99hugmLBj9KhTlc8nCSw folded before Flop (didn't bet)
Seat 6: H9KUl8cmpLgEpOVDA00bCg (button) folded before Flop (didn't bet)
Seat 7: 1Clf3cPrqoy/YgvWdWK1Xw (small blind) folded before Flop
Seat 8: nalbG/4/1Z1wQjRDWV7b2w (big blind) collected ($0.20)
Seat 9: st9jtdNbm1W5GfBwRaCVqQ folded before Flop (didn't bet)




PokerStars Game #59939449760:  Hold'em No Limit ($0.10/$0.25) - 2009/07/01 0:40:10 ET
Table 'GxdLtCpYxqT4aAbYqkEEpw' 6-max Seat #5 is the button
Seat 1: heEf/FkFGS9M1NmwH97YIA ($37.20 in chips) 
Seat 2: hADMNbkECXMb2C/C8R2Wlw ($23.15 in chips) 
Seat 3: 9jSiy0meE9XJKkdIZwyTEQ ($33.55 in chips) 
Seat 4: ErIN0JRL5srYjT6en1f8YQ ($28.85 in chips) 
Seat 5: q6WfTUAD9mowIP63ASq2Dg ($40.75 in chips) 
Seat 6: aogAb4Eienxztk8p2v9VVw ($26.50 in chips) 
aogAb4Eienxztk8p2v9VVw: posts small blind $0.10
heEf/FkFGS9M1NmwH97YIA: posts big blind $0.25
*** HOLE CARDS ***
hADMNbkECXMb2C/C8R2Wlw: folds 
9jSiy0meE9XJKkdIZwyTEQ: folds 
ErIN0JRL5srYjT6en1f8YQ: folds 
q6WfTUAD9mowIP63ASq2Dg: folds 
aogAb4Eienxztk8p2v9VVw: raises $0.75 to $1
heEf/FkFGS9M1NmwH97YIA: calls $0.75
*** FLOP *** [Ac 2c Kd]
aogAb4Eienxztk8p2v9VVw: bets $1
heEf/FkFGS9M1NmwH97YIA: calls $1
*** TURN *** [Ac 2c Kd] [3h]
aogAb4Eienxztk8p2v9VVw: checks 
heEf/FkFGS9M1NmwH97YIA: checks 
*** RIVER *** [Ac 2c Kd 3h] [As]
aogAb4Eienxztk8p2v9VVw: checks 
heEf/FkFGS9M1NmwH97YIA: checks 
*** SHOW DOWN ***
aogAb4Eienxztk8p2v9VVw: shows [Jc Qs] (a pair of Aces)
heEf/FkFGS9M1NmwH97YIA: shows [2s Tc] (two pair, Aces and Deuces)
heEf/FkFGS9M1NmwH97YIA collected $3.85 from pot
*** SUMMARY ***
Total pot $4 | Rake $0.15 
Board [Ac 2c Kd 3h As]
Seat 1: heEf/FkFGS9M1NmwH97YIA (big blind) showed [2s Tc] and won ($3.85) with two pair, Aces and Deuces
Seat 2: hADMNbkECXMb2C/C8R2Wlw folded before Flop (didn't bet)
Seat 3: 9jSiy0meE9XJKkdIZwyTEQ folded before Flop (didn't bet)
Seat 4: ErIN0JRL5srYjT6en1f8YQ folded before Flop (didn't bet)
Seat 5: q6WfTUAD9mowIP63ASq2Dg (button) folded before Flop (didn't bet)
Seat 6: aogAb4Eienxztk8p2v9VVw (small blind) showed [Jc Qs] and lost with a pair of Aces




PokerStars Game #59939449590:  Hold'em No Limit ($0.10/$0.25) - 2009/07/01 0:40:10 ET
Table 'l57rayEpPtZotP9nqgSWBg' 6-max Seat #1 is the button
Seat 1: oseFhpinoe+Zg4j5xyBjyQ ($20.40 in chips) 
Seat 2: ErIN0JRL5srYjT6en1f8YQ ($24.75 in chips) 
Seat 3: sEQx9G5Cu8k1HNdQasxvUA ($40.15 in chips) 
Seat 4: NIALbunHAyYqmfMf7mrPhw ($5.35 in chips) 
Seat 5: TSmua8tGK3sTbwi0ynrW9Q ($59.40 in chips) 
ErIN0JRL5srYjT6en1f8YQ: posts small blind $0.10
sEQx9G5Cu8k1HNdQasxvUA: posts big blind $0.25
IGRfskE1v9H9Bn+fz8AgNQ: sits out 
*** HOLE CARDS ***
NIALbunHAyYqmfMf7mrPhw: raises $0.50 to $0.75
TSmua8tGK3sTbwi0ynrW9Q: folds 
oseFhpinoe+Zg4j5xyBjyQ: folds 
ErIN0JRL5srYjT6en1f8YQ: calls $0.65
sEQx9G5Cu8k1HNdQasxvUA: folds 
*** FLOP *** [6d Qc 3d]
ErIN0JRL5srYjT6en1f8YQ: checks 
NIALbunHAyYqmfMf7mrPhw: bets $1
ErIN0JRL5srYjT6en1f8YQ: folds 
Uncalled bet ($1) returned to NIALbunHAyYqmfMf7mrPhw
NIALbunHAyYqmfMf7mrPhw collected $1.70 from pot
*** SUMMARY ***
Total pot $1.75 | Rake $0.05 
Board [6d Qc 3d]
Seat 1: oseFhpinoe+Zg4j5xyBjyQ (button) folded before Flop (didn't bet)
Seat 2: ErIN0JRL5srYjT6en1f8YQ (small blind) folded on the Flop
Seat 3: sEQx9G5Cu8k1HNdQasxvUA (big blind) folded before Flop
Seat 4: NIALbunHAyYqmfMf7mrPhw collected ($1.70)
Seat 5: TSmua8tGK3sTbwi0ynrW9Q folded before Flop (didn't bet)




PokerStars Game #59939449856:  Hold'em No Limit ($0.10/$0.25) - 2009/07/01 0:40:10 ET
Table 'sJ4KpS2GE5Qrsu1/cFjJUw' 9-max Seat #3 is the button
Seat 1: QsLvCwfSWqP+CfjwUnjpXQ ($14.40 in chips) 
Seat 3: eDil7UzSZCjyh1VP6SVXJQ ($7.55 in chips) 
Seat 8: f8ixGbSVIs6Be0mH69ldVQ ($14.60 in chips) 
f8ixGbSVIs6Be0mH69ldVQ: posts small blind $0.10
QsLvCwfSWqP+CfjwUnjpXQ: posts big blind $0.25
*** HOLE CARDS ***
eDil7UzSZCjyh1VP6SVXJQ: folds 
f8ixGbSVIs6Be0mH69ldVQ: calls $0.15
QsLvCwfSWqP+CfjwUnjpXQ: checks 
*** FLOP *** [2d Qc Ks]
f8ixGbSVIs6Be0mH69ldVQ: checks 
QsLvCwfSWqP+CfjwUnjpXQ: checks 
*** TURN *** [2d Qc Ks] [9h]
f8ixGbSVIs6Be0mH69ldVQ: bets $0.25
QsLvCwfSWqP+CfjwUnjpXQ: calls $0.25
*** RIVER *** [2d Qc Ks 9h] [6h]
f8ixGbSVIs6Be0mH69ldVQ: checks 
QsLvCwfSWqP+CfjwUnjpXQ: bets $0.75
f8ixGbSVIs6Be0mH69ldVQ: folds 
Uncalled bet ($0.75) returned to QsLvCwfSWqP+CfjwUnjpXQ
QsLvCwfSWqP+CfjwUnjpXQ collected $0.95 from pot
QsLvCwfSWqP+CfjwUnjpXQ: doesn't show hand 
*** SUMMARY ***
Total pot $1 | Rake $0.05 
Board [2d Qc Ks 9h 6h]
Seat 1: QsLvCwfSWqP+CfjwUnjpXQ (big blind) collected ($0.95)
Seat 3: eDil7UzSZCjyh1VP6SVXJQ (button) folded before Flop (didn't bet)
Seat 8: f8ixGbSVIs6Be0mH69ldVQ (small blind) folded on the River




PokerStars Game #59939450372:  Hold'em No Limit ($0.10/$0.25) - 2009/07/01 0:40:11 ET
Table 'MiquQrQZJJq9ZtgRIp9HFQ' 6-max Seat #2 is the button
Seat 1: hM0MSDtq2ow7J40bSR04ig ($4.90 in chips) 
Seat 2: DMQLAmut/l19xN5STQndFg ($3.50 in chips) 
Seat 4: 0HIrwssk0FQvyKULzUTtlg ($20.45 in chips) 
Seat 5: LXN9U+5F+9if/ead2+w1nw ($44.20 in chips) 
Seat 6: X9oXZTg4PhZVR+ilX2OYbA ($14.40 in chips) 
0HIrwssk0FQvyKULzUTtlg: posts small blind $0.10
LXN9U+5F+9if/ead2+w1nw: posts big blind $0.25
*** HOLE CARDS ***
X9oXZTg4PhZVR+ilX2OYbA: calls $0.25
hM0MSDtq2ow7J40bSR04ig: folds 
DMQLAmut/l19xN5STQndFg: calls $0.25
0HIrwssk0FQvyKULzUTtlg: calls $0.15
q9qPRjJC40e/Q9yuT+glwQ leaves the table
LXN9U+5F+9if/ead2+w1nw: raises $0.75 to $1
X9oXZTg4PhZVR+ilX2OYbA: calls $0.75
DMQLAmut/l19xN5STQndFg: calls $0.75
0HIrwssk0FQvyKULzUTtlg: folds 
*** FLOP *** [3s 2c 5h]
BYxjLnV1/LL0aZcTbfAOvw joins the table at seat #3 
LXN9U+5F+9if/ead2+w1nw: checks 
X9oXZTg4PhZVR+ilX2OYbA: bets $0.25
DMQLAmut/l19xN5STQndFg: calls $0.25
LXN9U+5F+9if/ead2+w1nw: calls $0.25
*** TURN *** [3s 2c 5h] [Tc]
LXN9U+5F+9if/ead2+w1nw: bets $1.50
X9oXZTg4PhZVR+ilX2OYbA: folds 
DMQLAmut/l19xN5STQndFg: folds 
Uncalled bet ($1.50) returned to LXN9U+5F+9if/ead2+w1nw
LXN9U+5F+9if/ead2+w1nw collected $3.85 from pot
*** SUMMARY ***
Total pot $4 | Rake $0.15 
Board [3s 2c 5h Tc]
Seat 1: hM0MSDtq2ow7J40bSR04ig folded before Flop (didn't bet)
Seat 2: DMQLAmut/l19xN5STQndFg (button) folded on the Turn
Seat 4: 0HIrwssk0FQvyKULzUTtlg (small blind) folded before Flop
Seat 5: LXN9U+5F+9if/ead2+w1nw (big blind) collected ($3.85)
Seat 6: X9oXZTg4PhZVR+ilX2OYbA folded on the Turn




PokerStars Game #59939450124:  Hold'em No Limit ($0.10/$0.25) - 2009/07/01 0:40:11 ET
Table 'wRXcD9iXgBbdvKhWmfnBnw' 6-max Seat #4 is the button
Seat 1: LGWRgaQNaDFSlUGk26f0Ig ($19.45 in chips) 
Seat 2: SS/yfeArhULzIcOPe8MdPg ($25 in chips) 
Seat 3: 6zbQpY/G44U1Xvj7DZex0A ($19.70 in chips) 
Seat 4: mfrkWA3PTeYPkbO6hi98Aw ($26.05 in chips) 
Seat 5: EE16Ua5b1HSsYej5zeXOlA ($29.85 in chips) 
EE16Ua5b1HSsYej5zeXOlA: posts small blind $0.10
LGWRgaQNaDFSlUGk26f0Ig: posts big blind $0.25
*** HOLE CARDS ***
SS/yfeArhULzIcOPe8MdPg: folds 
6zbQpY/G44U1Xvj7DZex0A: folds 
rhWCqDS9OBh/IoXY29BGMw joins the table at seat #6 
mfrkWA3PTeYPkbO6hi98Aw: folds 
EE16Ua5b1HSsYej5zeXOlA: folds 
Uncalled bet ($0.15) returned to LGWRgaQNaDFSlUGk26f0Ig
LGWRgaQNaDFSlUGk26f0Ig collected $0.20 from pot
LGWRgaQNaDFSlUGk26f0Ig: doesn't show hand 
*** SUMMARY ***
Total pot $0.20 | Rake $0 
Seat 1: LGWRgaQNaDFSlUGk26f0Ig (big blind) collected ($0.20)
Seat 2: SS/yfeArhULzIcOPe8MdPg folded before Flop (didn't bet)
Seat 3: 6zbQpY/G44U1Xvj7DZex0A folded before Flop (didn't bet)
Seat 4: mfrkWA3PTeYPkbO6hi98Aw (button) folded before Flop (didn't bet)
Seat 5: EE16Ua5b1HSsYej5zeXOlA (small blind) folded before Flop




PokerStars Game #59939450120:  Hold'em No Limit ($0.10/$0.25) - 2009/07/01 0:40:11 ET
Table '7/qMNloI0nSXWiX5Y1watA' 9-max Seat #2 is the button
Seat 1: lF4l0ujUfJ9uYJOg9Ch9/g ($45.10 in chips) 
Seat 2: 8B/dhbQjIWe6ASCdgzktNQ ($25.40 in chips) 
Seat 3: nEg1b6MIksd/4x5eLY735g ($39.85 in chips) 
Seat 4: 18G4P1XstjNvItdGUITxgw ($25.35 in chips) 
Seat 5: dfNim92Z6XK1/h5SFW5vDg ($32.85 in chips) 
Seat 7: z5GxcHlYz/GSz6W2uFiTtg ($11.20 in chips) 
Seat 8: ljemhp25Zg+nlA9DLCIiUw ($24.50 in chips) 
nEg1b6MIksd/4x5eLY735g: posts small blind $0.10
18G4P1XstjNvItdGUITxgw: posts big blind $0.25
aPRz/2GxbXANYpVsQO8pdQ: sits out 
*** HOLE CARDS ***
dfNim92Z6XK1/h5SFW5vDg: folds 
z5GxcHlYz/GSz6W2uFiTtg: raises $0.50 to $0.75
ljemhp25Zg+nlA9DLCIiUw: folds 
lF4l0ujUfJ9uYJOg9Ch9/g: folds 
8B/dhbQjIWe6ASCdgzktNQ: folds 
nEg1b6MIksd/4x5eLY735g: folds 
18G4P1XstjNvItdGUITxgw: folds 
Uncalled bet ($0.50) returned to z5GxcHlYz/GSz6W2uFiTtg
z5GxcHlYz/GSz6W2uFiTtg collected $0.60 from pot
*** SUMMARY ***
Total pot $0.60 | Rake $0 
Seat 1: lF4l0ujUfJ9uYJOg9Ch9/g folded before Flop (didn't bet)
Seat 2: 8B/dhbQjIWe6ASCdgzktNQ (button) folded before Flop (didn't bet)
Seat 3: nEg1b6MIksd/4x5eLY735g (small blind) folded before Flop
Seat 4: 18G4P1XstjNvItdGUITxgw (big blind) folded before Flop
Seat 5: dfNim92Z6XK1/h5SFW5vDg folded before Flop (didn't bet)
Seat 7: z5GxcHlYz/GSz6W2uFiTtg collected ($0.60)
Seat 8: ljemhp25Zg+nlA9DLCIiUw folded before Flop (didn't bet)




PokerStars Game #59939450288:  Hold'em No Limit ($0.10/$0.25) - 2009/07/01 0:40:11 ET
Table '5NipxzzFB2DffzDpddyQoQ' 6-max Seat #1 is the button
Seat 1: TslQs7AQSLbVtr4X8JOOOQ ($12.60 in chips) 
Seat 2: jxrNE4qd8KCOIqHjQcwCrA ($40.55 in chips) 
Seat 3: qGHGf/553gQnDoklMRe3tg ($49.40 in chips) 
Seat 4: Inq44d7PQ+8TbEKfPeuxVQ ($6.35 in chips) 
Seat 5: cS21pIxRHx5Gt42o7hPZzw ($12.30 in chips) 
Seat 6: lYjWCpfCxX2kgcHY3v4Yow ($27.30 in chips) 
jxrNE4qd8KCOIqHjQcwCrA: posts small blind $0.10
qGHGf/553gQnDoklMRe3tg: posts big blind $0.25
*** HOLE CARDS ***
Inq44d7PQ+8TbEKfPeuxVQ: folds 
cS21pIxRHx5Gt42o7hPZzw: folds 
lYjWCpfCxX2kgcHY3v4Yow: raises $0.75 to $1
TslQs7AQSLbVtr4X8JOOOQ: folds 
jxrNE4qd8KCOIqHjQcwCrA: folds 
qGHGf/553gQnDoklMRe3tg: folds 
Uncalled bet ($0.75) returned to lYjWCpfCxX2kgcHY3v4Yow
lYjWCpfCxX2kgcHY3v4Yow collected $0.60 from pot
lYjWCpfCxX2kgcHY3v4Yow: doesn't show hand 
*** SUMMARY ***
Total pot $0.60 | Rake $0 
Seat 1: TslQs7AQSLbVtr4X8JOOOQ (button) folded before Flop (didn't bet)
Seat 2: jxrNE4qd8KCOIqHjQcwCrA (small blind) folded before Flop
Seat 3: qGHGf/553gQnDoklMRe3tg (big blind) folded before Flop
Seat 4: Inq44d7PQ+8TbEKfPeuxVQ folded before Flop (didn't bet)
Seat 5: cS21pIxRHx5Gt42o7hPZzw folded before Flop (didn't bet)
Seat 6: lYjWCpfCxX2kgcHY3v4Yow collected ($0.60)




PokerStars Game #59939450428:  Hold'em No Limit ($0.10/$0.25) - 2009/07/01 0:40:11 ET
Table 'xmJKTGBeWCwutccj3YfupQ' 6-max Seat #2 is the button
Seat 1: sVbkVl4OznxBCfi66UB9vw ($60.80 in chips) 
Seat 2: BedjMfrlRfPgSq7CXpPAmg ($48.45 in chips) 
Seat 3: FStoHe64SQWqAsjya9pDkQ ($25 in chips) 
Seat 4: uWjhTVMpuIroxXcmD3Okug ($41.90 in chips) 
Seat 5: oBUDUfeUyCbZBsjxHZgSiw ($18.05 in chips) 
Seat 6: lYjWCpfCxX2kgcHY3v4Yow ($26 in chips) 
FStoHe64SQWqAsjya9pDkQ: posts small blind $0.10
uWjhTVMpuIroxXcmD3Okug: posts big blind $0.25
*** HOLE CARDS ***
oBUDUfeUyCbZBsjxHZgSiw: folds 
lYjWCpfCxX2kgcHY3v4Yow: folds 
sVbkVl4OznxBCfi66UB9vw said, "darn"
uWjhTVMpuIroxXcmD3Okug said, "yeah i know"
BedjMfrlRfPgSq7CXpPAmg said, "that was deep"
sVbkVl4OznxBCfi66UB9vw: calls $0.25
BedjMfrlRfPgSq7CXpPAmg: raises $1 to $1.25
uWjhTVMpuIroxXcmD3Okug said, "im talking about karma my friend"
FStoHe64SQWqAsjya9pDkQ: folds 
uWjhTVMpuIroxXcmD3Okug: folds 
sVbkVl4OznxBCfi66UB9vw: calls $1
*** FLOP *** [8h 5s 4s]
sVbkVl4OznxBCfi66UB9vw: checks 
BedjMfrlRfPgSq7CXpPAmg: bets $1.75
uWjhTVMpuIroxXcmD3Okug said, "it takes place in everything we do in life"
sVbkVl4OznxBCfi66UB9vw: folds 
Uncalled bet ($1.75) returned to BedjMfrlRfPgSq7CXpPAmg
FStoHe64SQWqAsjya9pDkQ said, "Ah, that's between you are your mind. good luck player"
BedjMfrlRfPgSq7CXpPAmg collected $2.75 from pot
uWjhTVMpuIroxXcmD3Okug said, "and when people interact with each other"
*** SUMMARY ***
Total pot $2.85 | Rake $0.10 
Board [8h 5s 4s]
Seat 1: sVbkVl4OznxBCfi66UB9vw folded on the Flop
Seat 2: BedjMfrlRfPgSq7CXpPAmg (button) collected ($2.75)
Seat 3: FStoHe64SQWqAsjya9pDkQ (small blind) folded before Flop
Seat 4: uWjhTVMpuIroxXcmD3Okug (big blind) folded before Flop
Seat 5: oBUDUfeUyCbZBsjxHZgSiw folded before Flop (didn't bet)
Seat 6: lYjWCpfCxX2kgcHY3v4Yow folded before Flop (didn't bet)




PokerStars Game #59939450118:  Hold'em No Limit ($0.10/$0.25) - 2009/07/01 0:40:11 ET
Table 'QzXakDK7ZHNjgIpoUFGSKQ' 9-max Seat #2 is the button
Seat 1: vZGoOTJLQLhkPj4I+LNGig ($25 in chips) 
Seat 2: HVKi9hnDyvzObpL08/OarQ ($23.80 in chips) 
Seat 3: E4pjUoTJmJNmancGXn1nSw ($19.20 in chips) 
Seat 4: Yv4fucyyT28mjx8V5lxKJg ($24.25 in chips) 
Seat 5: NAP/FpFXsTsBxjDijlVzEg ($26.45 in chips) 
Seat 6: c7sk/W5UhCTyhjXh5MT/eg ($11 in chips) 
Seat 7: zUPSsmVPAK0z0iGmEx7WbA ($9.80 in chips) 
Seat 8: HXf7T9U74NXM5C+iMg8Cbg ($4.50 in chips) 
E4pjUoTJmJNmancGXn1nSw: posts small blind $0.10
Yv4fucyyT28mjx8V5lxKJg: posts big blind $0.25
vnCdP3GsLTKadDukKcJk/Q: sits out 
*** HOLE CARDS ***
NAP/FpFXsTsBxjDijlVzEg: calls $0.25
c7sk/W5UhCTyhjXh5MT/eg: folds 
zUPSsmVPAK0z0iGmEx7WbA: folds 
HXf7T9U74NXM5C+iMg8Cbg: calls $0.25
vZGoOTJLQLhkPj4I+LNGig: folds 
HVKi9hnDyvzObpL08/OarQ: calls $0.25
E4pjUoTJmJNmancGXn1nSw: calls $0.15
Yv4fucyyT28mjx8V5lxKJg: checks 
*** FLOP *** [4s 8d 6h]
E4pjUoTJmJNmancGXn1nSw: checks 
Yv4fucyyT28mjx8V5lxKJg: checks 
NAP/FpFXsTsBxjDijlVzEg: checks 
HXf7T9U74NXM5C+iMg8Cbg: checks 
HVKi9hnDyvzObpL08/OarQ: checks 
*** TURN *** [4s 8d 6h] [Td]
E4pjUoTJmJNmancGXn1nSw: checks 
Yv4fucyyT28mjx8V5lxKJg: checks 
NAP/FpFXsTsBxjDijlVzEg: checks 
HXf7T9U74NXM5C+iMg8Cbg: bets $1
HVKi9hnDyvzObpL08/OarQ: folds 
E4pjUoTJmJNmancGXn1nSw: folds 
Yv4fucyyT28mjx8V5lxKJg: calls $1
NAP/FpFXsTsBxjDijlVzEg: folds 
*** RIVER *** [4s 8d 6h Td] [Kd]
Yv4fucyyT28mjx8V5lxKJg: checks 
HXf7T9U74NXM5C+iMg8Cbg: bets $2
Yv4fucyyT28mjx8V5lxKJg: folds 
Uncalled bet ($2) returned to HXf7T9U74NXM5C+iMg8Cbg
NAP/FpFXsTsBxjDijlVzEg leaves the table
HXf7T9U74NXM5C+iMg8Cbg collected $3.10 from pot
HXf7T9U74NXM5C+iMg8Cbg: doesn't show hand 
*** SUMMARY ***
Total pot $3.25 | Rake $0.15 
Board [4s 8d 6h Td Kd]
Seat 1: vZGoOTJLQLhkPj4I+LNGig folded before Flop (didn't bet)
Seat 2: HVKi9hnDyvzObpL08/OarQ (button) folded on the Turn
Seat 3: E4pjUoTJmJNmancGXn1nSw (small blind) folded on the Turn
Seat 4: Yv4fucyyT28mjx8V5lxKJg (big blind) folded on the River
Seat 5: NAP/FpFXsTsBxjDijlVzEg folded on the Turn
Seat 6: c7sk/W5UhCTyhjXh5MT/eg folded before Flop (didn't bet)
Seat 7: zUPSsmVPAK0z0iGmEx7WbA folded before Flop (didn't bet)
Seat 8: HXf7T9U74NXM5C+iMg8Cbg collected ($3.10)




PokerStars Game #59939450144:  Hold'em No Limit ($0.10/$0.25) - 2009/07/01 0:40:11 ET
Table 'biAgO3TKQBU8XcrVAoU5TA' 6-max Seat #2 is the button
Seat 2: 7qRk4YH4/k/08LgJSv7rBQ ($25.45 in chips) 
Seat 3: 7AHdX4G8gYtDJyNY+wK+6Q ($30.40 in chips) 
Seat 4: 2/AObG8G5tKFCPZ+CdivJQ ($10.55 in chips) 
Seat 6: //i5P+6lSkIyZsqb+ojVQA ($14.50 in chips) 
7AHdX4G8gYtDJyNY+wK+6Q: posts small blind $0.10
2/AObG8G5tKFCPZ+CdivJQ: posts big blind $0.25
*** HOLE CARDS ***
//i5P+6lSkIyZsqb+ojVQA: folds 
7qRk4YH4/k/08LgJSv7rBQ: folds 
7AHdX4G8gYtDJyNY+wK+6Q: calls $0.15
2/AObG8G5tKFCPZ+CdivJQ: raises $0.25 to $0.50
7AHdX4G8gYtDJyNY+wK+6Q: calls $0.25
*** FLOP *** [5d Jh 3d]
7AHdX4G8gYtDJyNY+wK+6Q: checks 
2/AObG8G5tKFCPZ+CdivJQ: bets $1
7AHdX4G8gYtDJyNY+wK+6Q: calls $1
*** TURN *** [5d Jh 3d] [2h]
7AHdX4G8gYtDJyNY+wK+6Q: checks 
2/AObG8G5tKFCPZ+CdivJQ: checks 
*** RIVER *** [5d Jh 3d 2h] [Th]
7AHdX4G8gYtDJyNY+wK+6Q: bets $1.25
2/AObG8G5tKFCPZ+CdivJQ: folds 
Uncalled bet ($1.25) returned to 7AHdX4G8gYtDJyNY+wK+6Q
7AHdX4G8gYtDJyNY+wK+6Q collected $2.90 from pot
7AHdX4G8gYtDJyNY+wK+6Q: doesn't show hand 
*** SUMMARY ***
Total pot $3 | Rake $0.10 
Board [5d Jh 3d 2h Th]
Seat 2: 7qRk4YH4/k/08LgJSv7rBQ (button) folded before Flop (didn't bet)
Seat 3: 7AHdX4G8gYtDJyNY+wK+6Q (small blind) collected ($2.90)
Seat 4: 2/AObG8G5tKFCPZ+CdivJQ (big blind) folded on the River
Seat 6: //i5P+6lSkIyZsqb+ojVQA folded before Flop (didn't bet)




PokerStars Game #59939450130:  Hold'em No Limit ($0.10/$0.25) - 2009/07/01 0:40:11 ET
Table '3lS+sU5k6mwJCS2nFMmQ6Q' 9-max Seat #4 is the button
Seat 1: VWUWpMLMj/Q1jRVpF7Aohw ($13 in chips) 
Seat 2: 4oA316mXLIui1QY63GXBUg ($25.75 in chips) 
Seat 3: 1DXccE2UUK5DIRVGlOKnTA ($9.50 in chips) 
Seat 4: 8B/dhbQjIWe6ASCdgzktNQ ($44.90 in chips) 
Seat 5: LuckyShot



PokerStars Game #59939450856:  Hold'em No Limit ($0.10/$0.25) - 2009/07/01 0:40:12 ET
Table 'D1Yq70l0nNCyMV6DA42p+Q' 9-max Seat #5 is the button
Seat 1: z5GxcHlYz/GSz6W2uFiTtg ($14.60 in chips) 
Seat 2: OB0uLxxDeISeDjs0cxaocA ($31.60 in chips) 
Seat 3: j4q3p0lesp63b1gZDwLBZw ($5 in chips) 
Seat 5: gehe91e0IyVT0QU/XBkEyg ($25.70 in chips) 
Seat 6: MgMavn/DzTzqKgHTZMsVSw ($24.75 in chips) 
Seat 7: 9mw49/JQZ9pj0wFynA329g ($14.70 in chips) 
Seat 8: zDrucyjVn5aeekNEc3cJrA ($22.95 in chips) 
Seat 9: 3PjJjazzeHcM4mbFeXmZBg ($2.90 in chips) 
MgMavn/DzTzqKgHTZMsVSw: posts small blind $0.10
9mw49/JQZ9pj0wFynA329g: posts big blind $0.25
*** HOLE CARDS ***
zDrucyjVn5aeekNEc3cJrA: folds 
3PjJjazzeHcM4mbFeXmZBg: folds 
z5GxcHlYz/GSz6W2uFiTtg: folds 
OB0uLxxDeISeDjs0cxaocA: folds 
j4q3p0lesp63b1gZDwLBZw: folds 
gehe91e0IyVT0QU/XBkEyg: raises $0.75 to $1
MgMavn/DzTzqKgHTZMsVSw: folds 
9mw49/JQZ9pj0wFynA329g: folds 
Uncalled bet ($0.75) returned to gehe91e0IyVT0QU/XBkEyg
gehe91e0IyVT0QU/XBkEyg collected $0.60 from pot
*** SUMMARY ***
Total pot $0.60 | Rake $0 
Seat 1: z5GxcHlYz/GSz6W2uFiTtg folded before Flop (didn't bet)
Seat 2: OB0uLxxDeISeDjs0cxaocA folded before Flop (didn't bet)
Seat 3: j4q3p0lesp63b1gZDwLBZw folded before Flop (didn't bet)
Seat 5: gehe91e0IyVT0QU/XBkEyg (button) collected ($0.60)
Seat 6: MgMavn/DzTzqKgHTZMsVSw (small blind) folded before Flop
Seat 7: 9mw49/JQZ9pj0wFynA329g (big blind) folded before Flop
Seat 8: zDrucyjVn5aeekNEc3cJrA folded before Flop (didn't bet)
Seat 9: 3PjJjazzeHcM4mbFeXmZBg folded before Flop (didn't bet)




PokerStars Game #59939450758:  Hold'em No Limit ($0.10/$0.25) - 2009/07/01 0:40:12 ET
Table '/asc7VQ/OpF/oVJ3erB80w' 9-max Seat #7 is the button
Seat 1: OiV1PWZ3IkN29JlmCcnTwQ ($4.70 in chips) 
Seat 2: Th3FldXKQW6hWVVPahaoOQ ($25.80 in chips) 
Seat 3: ie4EwTMMFYxrCXcenJdzsw ($6.45 in chips) 
Seat 4: H9KUl8cmpLgEpOVDA00bCg ($5.25 in chips) 
Seat 5: 8B/dhbQjIWe6ASCdgzktNQ ($25.25 in chips) 
Seat 6: t2nb95S5EEFOEzNx9Itz0g ($3.10 in chips) 
Seat 7: M2QO2DxB5Wawg2h8HSpnYA ($11.65 in chips) 
Seat 8: T5Hk9oiIr+JDDMnEqwFCrw ($5.80 in chips) 
Seat 9: UkJraTKWQIqFeHOyHQ7afQ ($14.90 in chips) 
T5Hk9oiIr+JDDMnEqwFCrw: posts small blind $0.10
UkJraTKWQIqFeHOyHQ7afQ: posts big blind $0.25
*** HOLE CARDS ***
OiV1PWZ3IkN29JlmCcnTwQ: folds 
Th3FldXKQW6hWVVPahaoOQ: folds 
ie4EwTMMFYxrCXcenJdzsw: folds 
H9KUl8cmpLgEpOVDA00bCg: folds 
8B/dhbQjIWe6ASCdgzktNQ: folds 
t2nb95S5EEFOEzNx9Itz0g: folds 
M2QO2DxB5Wawg2h8HSpnYA: folds 
T5Hk9oiIr+JDDMnEqwFCrw: calls $0.15
UkJraTKWQIqFeHOyHQ7afQ: checks 
*** FLOP *** [5d 2c Qs]
T5Hk9oiIr+JDDMnEqwFCrw: checks 
UkJraTKWQIqFeHOyHQ7afQ: bets $0.25
T5Hk9oiIr+JDDMnEqwFCrw: folds 
Uncalled bet ($0.25) returned to UkJraTKWQIqFeHOyHQ7afQ
UkJraTKWQIqFeHOyHQ7afQ collected $0.50 from pot
*** SUMMARY ***
Total pot $0.50 | Rake $0 
Board [5d 2c Qs]
Seat 1: OiV1PWZ3IkN29JlmCcnTwQ folded before Flop (didn't bet)
Seat 2: Th3FldXKQW6hWVVPahaoOQ folded before Flop (didn't bet)
Seat 3: ie4EwTMMFYxrCXcenJdzsw folded before Flop (didn't bet)
Seat 4: H9KUl8cmpLgEpOVDA00bCg folded before Flop (didn't bet)
Seat 5: 8B/dhbQjIWe6ASCdgzktNQ folded before Flop (didn't bet)
Seat 6: t2nb95S5EEFOEzNx9Itz0g folded before Flop (didn't bet)
Seat 7: M2QO2DxB5Wawg2h8HSpnYA (button) folded before Flop (didn't bet)
Seat 8: T5Hk9oiIr+JDDMnEqwFCrw (small blind) folded on the Flop
Seat 9: UkJraTKWQIqFeHOyHQ7afQ (big blind) collected ($0.50)




PokerStars Game #59939451054:  Hold'em No Limit ($0.10/$0.25) - 2009/07/01 0:40:12 ET
Table 'axb9RsG8Zj1A0LEukTeFrQ' 9-max Seat #1 is the button
Seat 1: qwr38jl5txoR36M7G5qi4A ($9.90 in chips) 
Seat 2: zDrucyjVn5aeekNEc3cJrA ($22.95 in chips) 
Seat 3: cZ99hugmLBj9KhTlc8nCSw ($28 in chips) 
Seat 4: TeWJxSETzbXGiYKx0y+dtg ($25 in chips) 
Seat 5: rLSSHKOHnb6yzVfDoQM/RA ($12.55 in chips) 
Seat 6: FSuhElWc38JXYToR0dwhjg ($15.95 in chips) 
Seat 7: 1K6QGyJP9P9xmRac2fH4OQ ($32.20 in chips) 
Seat 8: CqwJk5Z2+vb2f9j1o7IjKQ ($28.30 in chips) 
Seat 9: qbQE8CifKB4+OEvNF/61Rw ($36 in chips) 
zDrucyjVn5aeekNEc3cJrA: posts small blind $0.10
cZ99hugmLBj9KhTlc8nCSw: posts big blind $0.25
*** HOLE CARDS ***
TeWJxSETzbXGiYKx0y+dtg: folds 
rLSSHKOHnb6yzVfDoQM/RA: calls $0.25
FSuhElWc38JXYToR0dwhjg: folds 
1K6QGyJP9P9xmRac2fH4OQ: folds 
CqwJk5Z2+vb2f9j1o7IjKQ: folds 
qbQE8CifKB4+OEvNF/61Rw: raises $0.50 to $0.75
qwr38jl5txoR36M7G5qi4A: folds 
zDrucyjVn5aeekNEc3cJrA: folds 
cZ99hugmLBj9KhTlc8nCSw: folds 
rLSSHKOHnb6yzVfDoQM/RA: calls $0.50
*** FLOP *** [8h Kc 2c]
rLSSHKOHnb6yzVfDoQM/RA: checks 
qbQE8CifKB4+OEvNF/61Rw: bets $1.25
rLSSHKOHnb6yzVfDoQM/RA: folds 
Uncalled bet ($1.25) returned to qbQE8CifKB4+OEvNF/61Rw
qbQE8CifKB4+OEvNF/61Rw collected $1.80 from pot
qbQE8CifKB4+OEvNF/61Rw: doesn't show hand 
*** SUMMARY ***
Total pot $1.85 | Rake $0.05 
Board [8h Kc 2c]
Seat 1: qwr38jl5txoR36M7G5qi4A (button) folded before Flop (didn't bet)
Seat 2: zDrucyjVn5aeekNEc3cJrA (small blind) folded before Flop
Seat 3: cZ99hugmLBj9KhTlc8nCSw (big blind) folded before Flop
Seat 4: TeWJxSETzbXGiYKx0y+dtg folded before Flop (didn't bet)
Seat 5: rLSSHKOHnb6yzVfDoQM/RA folded on the Flop
Seat 6: FSuhElWc38JXYToR0dwhjg folded before Flop (didn't bet)
Seat 7: 1K6QGyJP9P9xmRac2fH4OQ folded before Flop (didn't bet)
Seat 8: CqwJk5Z2+vb2f9j1o7IjKQ folded before Flop (didn't bet)
Seat 9: qbQE8CifKB4+OEvNF/61Rw collected ($1.80)




PokerStars Game #59939451112:  Hold'em No Limit ($0.10/$0.25) - 2009/07/01 0:40:12 ET
Table 'xro+BVoe2Zuw1TYmz/McJQ' 9-max Seat #9 is the button
Seat 1: xEQxarad8/T4jJdpZy5LGw ($7.45 in chips) 
Seat 2: MXCztnYJ58KLHMztZvKrxA ($11.15 in chips) 
Seat 3: COsrwJSFHQtxlUcrYtDQPQ ($39.45 in chips) 
Seat 4: N2LVj3iImgnOoHVf8g0rIw ($18.85 in chips) 
Seat 5: 87Warq49WFhxNpfNtKRmcQ ($28.25 in chips) 
Seat 6: HPEB+AtKw1+C/cxU0o1ciw ($26.25 in chips) 
Seat 7: QEbIGci+itdw+re8RM5fZA ($25 in chips) 
Seat 8: ljemhp25Zg+nlA9DLCIiUw ($19.80 in chips) 
Seat 9: H5Se03ZqSX7tbULXur2MAg ($24.30 in chips) 
xEQxarad8/T4jJdpZy5LGw: posts small blind $0.10
MXCztnYJ58KLHMztZvKrxA: posts big blind $0.25
*** HOLE CARDS ***
COsrwJSFHQtxlUcrYtDQPQ: raises $0.75 to $1
N2LVj3iImgnOoHVf8g0rIw: folds 
87Warq49WFhxNpfNtKRmcQ: folds 
HPEB+AtKw1+C/cxU0o1ciw: folds 
QEbIGci+itdw+re8RM5fZA: folds 
ljemhp25Zg+nlA9DLCIiUw: folds 
H5Se03ZqSX7tbULXur2MAg: folds 
xEQxarad8/T4jJdpZy5LGw: folds 
MXCztnYJ58KLHMztZvKrxA: calls $0.75
*** FLOP *** [Kc 4s Ad]
MXCztnYJ58KLHMztZvKrxA: checks 
COsrwJSFHQtxlUcrYtDQPQ: bets $1.50
MXCztnYJ58KLHMztZvKrxA: raises $2 to $3.50
COsrwJSFHQtxlUcrYtDQPQ: folds 
Uncalled bet ($2) returned to MXCztnYJ58KLHMztZvKrxA
MXCztnYJ58KLHMztZvKrxA collected $4.85 from pot
*** SUMMARY ***
Total pot $5.10 | Rake $0.25 
Board [Kc 4s Ad]
Seat 1: xEQxarad8/T4jJdpZy5LGw (small blind) folded before Flop
Seat 2: MXCztnYJ58KLHMztZvKrxA (big blind) collected ($4.85)
Seat 3: COsrwJSFHQtxlUcrYtDQPQ folded on the Flop
Seat 4: N2LVj3iImgnOoHVf8g0rIw folded before Flop (didn't bet)
Seat 5: 87Warq49WFhxNpfNtKRmcQ folded before Flop (didn't bet)
Seat 6: HPEB+AtKw1+C/cxU0o1ciw folded before Flop (didn't bet)
Seat 7: QEbIGci+itdw+re8RM5fZA folded before Flop (didn't bet)
Seat 8: ljemhp25Zg+nlA9DLCIiUw folded before Flop (didn't bet)
Seat 9: H5Se03ZqSX7tbULXur2MAg (button) folded before Flop (didn't bet)




PokerStars Game #59939450676:  Hold'em No Limit ($0.10/$0.25) - 2009/07/01 0:40:12 ET
Table 'KU/HrxqxwDz8HKEhYTZ6uw' 6-max Seat #3 is the button
Seat 1: gaPMxLGp9SOj4Lq6t+/0Ig ($27.65 in chips) 
Seat 2: kG34n23qFQA3nzdOJTQ1dA ($24.65 in chips) 
Seat 3: 3seg9SJ1y+HUPN0X0XKF5Q ($11.85 in chips) 
Seat 4: +yxuvzJHyIWsJ515X8zJTQ ($1 in chips) 
Seat 5: 4YSTu0Cdzpppe1lUgCZGCQ ($35.45 in chips) 
Seat 6: QIWnfLSqfMcoFfdDe5LZPg ($9.90 in chips) 
+yxuvzJHyIWsJ515X8zJTQ: posts small blind $0.10
4YSTu0Cdzpppe1lUgCZGCQ: posts big blind $0.25
*** HOLE CARDS ***
QIWnfLSqfMcoFfdDe5LZPg: folds 
gaPMxLGp9SOj4Lq6t+/0Ig: folds 
kG34n23qFQA3nzdOJTQ1dA: folds 
3seg9SJ1y+HUPN0X0XKF5Q: folds 
+yxuvzJHyIWsJ515X8zJTQ: raises $0.75 to $1 and is all-in
4YSTu0Cdzpppe1lUgCZGCQ: calls $0.75
*** FLOP *** [Kd Jd 2c]
*** TURN *** [Kd Jd 2c] [Td]
*** RIVER *** [Kd Jd 2c Td] [5d]
*** SHOW DOWN ***
+yxuvzJHyIWsJ515X8zJTQ: shows [7c Ah] (high card Ace)
4YSTu0Cdzpppe1lUgCZGCQ: shows [3d Ac] (a flush, King high)
4YSTu0Cdzpppe1lUgCZGCQ collected $1.90 from pot
*** SUMMARY ***
Total pot $2 | Rake $0.10 
Board [Kd Jd 2c Td 5d]
Seat 1: gaPMxLGp9SOj4Lq6t+/0Ig folded before Flop (didn't bet)
Seat 2: kG34n23qFQA3nzdOJTQ1dA folded before Flop (didn't bet)
Seat 3: 3seg9SJ1y+HUPN0X0XKF5Q (button) folded before Flop (didn't bet)
Seat 4: +yxuvzJHyIWsJ515X8zJTQ (small blind) showed [7c Ah] and lost with high card Ace
Seat 5: 4YSTu0Cdzpppe1lUgCZGCQ (big blind) showed [3d Ac] and won ($1.90) with a flush, King high
Seat 6: QIWnfLSqfMcoFfdDe5LZPg folded before Flop (didn't bet)




PokerStars Game #59939450960:  Hold'em No Limit ($0.10/$0.25) - 2009/07/01 0:40:12 ET
Table 'DhkrdW2UOy2PfjSW28Kq8w' 6-max Seat #5 is the button
Seat 1: vu2kzHaDtgr6NM7rdq0chA ($25 in chips) 
Seat 2: v+QfkGiuj9bgtuNoVnDO8w ($25 in chips) 
Seat 3: 66a/8+qw1AZLNh63FuclPA ($43.80 in chips) 
Seat 4: I1TxPvWj8NfG8orglCinNA ($27.40 in chips) 
Seat 5: SxIIgwXYLkwd6m3wLyPTCw ($47.50 in chips) 
Seat 6: SS/yfeArhULzIcOPe8MdPg ($25.60 in chips) 
SS/yfeArhULzIcOPe8MdPg: posts small blind $0.10
vu2kzHaDtgr6NM7rdq0chA: posts big blind $0.25
*** HOLE CARDS ***
v+QfkGiuj9bgtuNoVnDO8w: folds 
66a/8+qw1AZLNh63FuclPA: folds 
I1TxPvWj8NfG8orglCinNA: folds 
SxIIgwXYLkwd6m3wLyPTCw: folds 
SS/yfeArhULzIcOPe8MdPg: folds 
Uncalled bet ($0.15) returned to vu2kzHaDtgr6NM7rdq0chA
vu2kzHaDtgr6NM7rdq0chA collected $0.20 from pot
vu2kzHaDtgr6NM7rdq0chA: doesn't show hand 
*** SUMMARY ***
Total pot $0.20 | Rake $0 
Seat 1: vu2kzHaDtgr6NM7rdq0chA (big blind) collected ($0.20)
Seat 2: v+QfkGiuj9bgtuNoVnDO8w folded before Flop (didn't bet)
Seat 3: 66a/8+qw1AZLNh63FuclPA folded before Flop (didn't bet)
Seat 4: I1TxPvWj8NfG8orglCinNA folded before Flop (didn't bet)
Seat 5: SxIIgwXYLkwd6m3wLyPTCw (button) folded before Flop (didn't bet)
Seat 6: SS/yfeArhULzIcOPe8MdPg (small blind) folded before Flop




PokerStars Game #59939450718:  Hold'em No Limit ($0.10/$0.25) - 2009/07/01 0:40:12 ET
Table 'nc6OeGk/wtaWV+6N+kgnZQ' 6-max Seat #1 is the button
Seat 1: 0/FYfBoKhINaqU/H5OSS1A ($4.50 in chips) 
Seat 3: 8f0dtuUGqDbgE6up1lQAlg ($3.50 in chips) 
Seat 6: yJgjVkWgiJ8vdWZjcUod2A ($6.80 in chips) 
8f0dtuUGqDbgE6up1lQAlg: posts small blind $0.10
yJgjVkWgiJ8vdWZjcUod2A: posts big blind $0.25
*** HOLE CARDS ***
0/FYfBoKhINaqU/H5OSS1A: folds 
8f0dtuUGqDbgE6up1lQAlg: folds 
Uncalled bet ($0.15) returned to yJgjVkWgiJ8vdWZjcUod2A
yJgjVkWgiJ8vdWZjcUod2A collected $0.20 from pot
yJgjVkWgiJ8vdWZjcUod2A: doesn't show hand 
*** SUMMARY ***
Total pot $0.20 | Rake $0 
Seat 1: 0/FYfBoKhINaqU/H5OSS1A (button) folded before Flop (didn't bet)
Seat 3: 8f0dtuUGqDbgE6up1lQAlg (small blind) folded before Flop
Seat 6: yJgjVkWgiJ8vdWZjcUod2A (big blind) collected ($0.20)




PokerStars Game #59939450934:  Hold'em No Limit ($0.10/$0.25) - 2009/07/01 0:40:12 ET
Table 'pgrBYaOEx/BuqK5iAtlFzw' 9-max Seat #5 is the button
Seat 1: QsLvCwfSWqP+CfjwUnjpXQ ($15.25 in chips) 
Seat 4: 6meFEBwAfXU5eLC35rA/sw ($5 in chips) 
Seat 5: efYVL4adq0ufQFnZCpL5Tw ($11.15 in chips) 
QsLvCwfSWqP+CfjwUnjpXQ: posts small blind $0.10
6meFEBwAfXU5eLC35rA/sw: posts big blind $0.25
*** HOLE CARDS ***
OqlfFV+MkgflYrm4Q6rLMA joins the table at seat #6 
efYVL4adq0ufQFnZCpL5Tw: calls $0.25
QsLvCwfSWqP+CfjwUnjpXQ: calls $0.15
6meFEBwAfXU5eLC35rA/sw: checks 
*** FLOP *** [5d Jh Th]
QsLvCwfSWqP+CfjwUnjpXQ: checks 
6meFEBwAfXU5eLC35rA/sw: checks 
efYVL4adq0ufQFnZCpL5Tw: bets $0.50
QsLvCwfSWqP+CfjwUnjpXQ: folds 
6meFEBwAfXU5eLC35rA/sw: calls $0.50
*** TURN *** [5d Jh Th] [Tc]
6meFEBwAfXU5eLC35rA/sw: bets $0.25
efYVL4adq0ufQFnZCpL5Tw: calls $0.25
*** RIVER *** [5d Jh Th Tc] [Qd]
6meFEBwAfXU5eLC35rA/sw: bets $0.25
efYVL4adq0ufQFnZCpL5Tw: calls $0.25
*** SHOW DOWN ***
6meFEBwAfXU5eLC35rA/sw: shows [Js 2d] (two pair, Jacks and Tens)
efYVL4adq0ufQFnZCpL5Tw: shows [4s Jc] (two pair, Jacks and Tens)
6meFEBwAfXU5eLC35rA/sw collected $1.35 from pot
efYVL4adq0ufQFnZCpL5Tw collected $1.30 from pot
*** SUMMARY ***
Total pot $2.75 | Rake $0.10 
Board [5d Jh Th Tc Qd]
Seat 1: QsLvCwfSWqP+CfjwUnjpXQ (small blind) folded on the Flop
Seat 4: 6meFEBwAfXU5eLC35rA/sw (big blind) showed [Js 2d] and won ($1.35) with two pair, Jacks and Tens
Seat 5: efYVL4adq0ufQFnZCpL5Tw (button) showed [4s Jc] and won ($1.30) with two pair, Jacks and Tens




PokerStars Game #59939451290:  Hold'em No Limit ($0.10/$0.25) - 2009/07/01 0:40:13 ET
Table 'HzFR0rxmDAPu5GzYR0AlYg' 6-max Seat #3 is the button
Seat 1: v+QfkGiuj9bgtuNoVnDO8w ($25 in chips) 
Seat 2: UA5OsKS3VPaxa7uC8La/kA ($52.95 in chips) 
Seat 3: lfAPI6VglUPipZe8BpDaTA ($24.85 in chips) 
Seat 4: uy9x0X5l7O+IpGjLa77QgQ ($60.15 in chips) 
Seat 5: I1TxPvWj8NfG8orglCinNA ($25 in chips) 
uy9x0X5l7O+IpGjLa77QgQ: posts small blind $0.10
I1TxPvWj8NfG8orglCinNA: posts big blind $0.25
*** HOLE CARDS ***
v+QfkGiuj9bgtuNoVnDO8w: folds 
UA5OsKS3VPaxa7uC8La/kA: folds 
lfAPI6VglUPipZe8BpDaTA: folds 
uy9x0X5l7O+IpGjLa77QgQ: folds 
Uncalled bet ($0.15) returned to I1TxPvWj8NfG8orglCinNA
I1TxPvWj8NfG8orglCinNA collected $0.20 from pot
I1TxPvWj8NfG8orglCinNA: doesn't show hand 
*** SUMMARY ***
Total pot $0.20 | Rake $0 
Seat 1: v+QfkGiuj9bgtuNoVnDO8w folded before Flop (didn't bet)
Seat 2: UA5OsKS3VPaxa7uC8La/kA folded before Flop (didn't bet)
Seat 3: lfAPI6VglUPipZe8BpDaTA (button) folded before Flop (didn't bet)
Seat 4: uy9x0X5l7O+IpGjLa77QgQ (small blind) folded before Flop
Seat 5: I1TxPvWj8NfG8orglCinNA (big blind) collected ($0.20)




PokerStars Game #59939451292:  Hold'em No Limit ($0.10/$0.25) - 2009/07/01 0:40:13 ET
Table 'FgLmv9bi/fJP8ldfbTOpkg' 9-max Seat #6 is the button
Seat 1: opOCI2p6kW0tINuVaAqmcQ ($25.35 in chips) 
Seat 2: mpsfNtnMVDqQHTe92AhIdw ($18.65 in chips) 
Seat 4: WfS0TjI8FyLemNTOo1e9qA ($23.55 in chips) 
Seat 6: oKO7b50N6TzXbPBr/mcrUA ($32.35 in chips) 
Seat 7: eFrBtVXGVoMq1UwCDg8Exg ($24.75 in chips) 
Seat 8: sJNHTWcSlLHRCZ9+YRLLqA ($25 in chips) 
Seat 9: Th3FldXKQW6hWVVPahaoOQ ($25 in chips) 
eFrBtVXGVoMq1UwCDg8Exg: posts small blind $0.10
sJNHTWcSlLHRCZ9+YRLLqA: posts big blind $0.25
*** HOLE CARDS ***
Th3FldXKQW6hWVVPahaoOQ: folds 
Th3FldXKQW6hWVVPahaoOQ leaves the table
opOCI2p6kW0tINuVaAqmcQ: folds 
mpsfNtnMVDqQHTe92AhIdw: folds 
WfS0TjI8FyLemNTOo1e9qA: raises $1 to $1.25
oKO7b50N6TzXbPBr/mcrUA: folds 
eFrBtVXGVoMq1UwCDg8Exg: folds 
sJNHTWcSlLHRCZ9+YRLLqA: folds 
Uncalled bet ($1) returned to WfS0TjI8FyLemNTOo1e9qA
WfS0TjI8FyLemNTOo1e9qA collected $0.60 from pot
*** SUMMARY ***
Total pot $0.60 | Rake $0 
Seat 1: opOCI2p6kW0tINuVaAqmcQ folded before Flop (didn't bet)
Seat 2: mpsfNtnMVDqQHTe92AhIdw folded before Flop (didn't bet)
Seat 4: WfS0TjI8FyLemNTOo1e9qA collected ($0.60)
Seat 6: oKO7b50N6TzXbPBr/mcrUA (button) folded before Flop (didn't bet)
Seat 7: eFrBtVXGVoMq1UwCDg8Exg (small blind) folded before Flop
Seat 8: sJNHTWcSlLHRCZ9+YRLLqA (big blind) folded before Flop
Seat 9: Th3FldXKQW6hWVVPahaoOQ folded before Flop (didn't bet)




PokerStars Game #59939451844:  Hold'em No Limit ($0.10/$0.25) - 2009/07/01 0:40:13 ET
Table 'G+4ZdyRoPjgaJY/jxSlZzQ' 9-max Seat #6 is the button
Seat 1: 0Ui5PFTLvpoTRdxcc8BNSQ ($34.05 in chips) 
Seat 2: 4awUyiDYTgylQKXZ9faBVA ($36.05 in chips) 
Seat 3: opOCI2p6kW0tINuVaAqmcQ ($28.95 in chips) 
Seat 4: yindad6WXRlkjbK12URYkA ($10.80 in chips) 
Seat 5: s7Q6uNouhe7aE8JdFb9E+A ($26.25 in chips) 
Seat 6: gehe91e0IyVT0QU/XBkEyg ($25 in chips) 
Seat 9: AzTBzPGlrIHrrs1Q8oKcGA ($17.30 in chips) 
AzTBzPGlrIHrrs1Q8oKcGA: posts small blind $0.10
0Ui5PFTLvpoTRdxcc8BNSQ: posts big blind $0.25
*** HOLE CARDS ***
4awUyiDYTgylQKXZ9faBVA: folds 
opOCI2p6kW0tINuVaAqmcQ: raises $0.50 to $0.75
yindad6WXRlkjbK12URYkA: folds 
s7Q6uNouhe7aE8JdFb9E+A: folds 
gehe91e0IyVT0QU/XBkEyg: folds 
AzTBzPGlrIHrrs1Q8oKcGA: folds 
0Ui5PFTLvpoTRdxcc8BNSQ: raises $0.50 to $1.25
opOCI2p6kW0tINuVaAqmcQ: calls $0.50
*** FLOP *** [5s 9s Qs]
0Ui5PFTLvpoTRdxcc8BNSQ: bets $3.50
opOCI2p6kW0tINuVaAqmcQ: folds 
Uncalled bet ($3.50) returned to 0Ui5PFTLvpoTRdxcc8BNSQ
0Ui5PFTLvpoTRdxcc8BNSQ collected $2.50 from pot
*** SUMMARY ***
Total pot $2.60 | Rake $0.10 
Board [5s 9s Qs]
Seat 1: 0Ui5PFTLvpoTRdxcc8BNSQ (big blind) collected ($2.50)
Seat 2: 4awUyiDYTgylQKXZ9faBVA folded before Flop (didn't bet)
Seat 3: opOCI2p6kW0tINuVaAqmcQ folded on the Flop
Seat 4: yindad6WXRlkjbK12URYkA folded before Flop (didn't bet)
Seat 5: s7Q6uNouhe7aE8JdFb9E+A folded before Flop (didn't bet)
Seat 6: gehe91e0IyVT0QU/XBkEyg (button) folded before Flop (didn't bet)
Seat 9: AzTBzPGlrIHrrs1Q8oKcGA (small blind) folded before Flop




PokerStars Game #59939451836:  Hold'em No Limit ($0.10/$0.25) - 2009/07/01 0:40:13 ET
Table '6aL2C8IFwHHr6SG6RgXaow' 9-max Seat #8 is the button
Seat 2: +gMmKt3DaQng9M42CmxIZg ($24.55 in chips) 
Seat 5: wre31HfyzQGpIvID1istxw ($14.35 in chips) 
Seat 6: HxDF4QSxC4z39D7teZpprQ ($35.50 in chips) 
Seat 7: rPToQDbLWB+dKnz7fcQSIg ($8.30 in chips) 
Seat 8: rQhYIYXSyH/IivYM1dlV5A ($13.90 in chips) 
Seat 9: yduPKWPzL8YlT5Zv/Nmrwg ($17.15 in chips) 
yduPKWPzL8YlT5Zv/Nmrwg: posts small blind $0.10
+gMmKt3DaQng9M42CmxIZg: posts big blind $0.25
*** HOLE CARDS ***
wre31HfyzQGpIvID1istxw: folds 
HxDF4QSxC4z39D7teZpprQ: folds 
rPToQDbLWB+dKnz7fcQSIg: folds 
rQhYIYXSyH/IivYM1dlV5A: folds 
yduPKWPzL8YlT5Zv/Nmrwg: raises $0.25 to $0.50
+gMmKt3DaQng9M42CmxIZg: folds 
Uncalled bet ($0.25) returned to yduPKWPzL8YlT5Zv/Nmrwg
yduPKWPzL8YlT5Zv/Nmrwg collected $0.50 from pot
yduPKWPzL8YlT5Zv/Nmrwg: doesn't show hand 
*** SUMMARY ***
Total pot $0.50 | Rake $0 
Seat 2: +gMmKt3DaQng9M42CmxIZg (big blind) folded before Flop
Seat 5: wre31HfyzQGpIvID1istxw folded before Flop (didn't bet)
Seat 6: HxDF4QSxC4z39D7teZpprQ folded before Flop (didn't bet)
Seat 7: rPToQDbLWB+dKnz7fcQSIg folded before Flop (didn't bet)
Seat 8: rQhYIYXSyH/IivYM1dlV5A (button) folded before Flop (didn't bet)
Seat 9: yduPKWPzL8YlT5Zv/Nmrwg (small blind) collected ($0.50)




PokerStars Game #59939451626:  Hold'em No Limit ($0.10/$0.25) - 2009/07/01 0:40:13 ET
Table 'WEMI3Mtn7dGARDbgNrKibgoG007Tb0LYbfANo6QWd16wx Seat #7 is the button
Seat 1: GEZ4LFjiwTFoPklBgpSnlw ($18.55 in chips) 
Seat 2: zDrucyjVn5aeekNEc3cJrA ($23 in chips) 
Seat 3: 56S3mA6Zs3pGR+0p0vUCtg ($24.65 in chips) 
Seat 4: oKO7b50N6TzXbPBr/mcrUA ($21.60 in chips) 
Seat 5: MIVCHqCqqlke0Lb0z7glcw ($24.65 in chips) 
Seat 6: lxVahNAs/pc3YeLt9PSgbg ($18.75 in chips) 
Seat 7: sUVgUtgbfVx6JpvApozwhQ ($5 in chips) 
Seat 8: 0b9BiwFeJrba87+xtIuQxg ($7.55 in chips) 
Seat 9: 86vbuhJsyH+nbEg5qpDLyQ ($25.70 in chips) 
0b9BiwFeJrba87+xtIuQxg: posts small blind $0.10
86vbuhJsyH+nbEg5qpDLyQ: posts big blind $0.25
*** HOLE CARDS ***
GEZ4LFjiwTFoPklBgpSnlw: folds 
zDrucyjVn5aeekNEc3cJrA: calls $0.25
56S3mA6Zs3pGR+0p0vUCtg: folds 
oKO7b50N6TzXbPBr/mcrUA: folds 
MIVCHqCqqlke0Lb0z7glcw: folds 
lxVahNAs/pc3YeLt9PSgbg: calls $0.25
sUVgUtgbfVx6JpvApozwhQ: folds 
0b9BiwFeJrba87+xtIuQxg: calls $0.15
86vbuhJsyH+nbEg5qpDLyQ: checks 
*** FLOP *** [4s Ad Ts]
0b9BiwFeJrba87+xtIuQxg: checks 
86vbuhJsyH+nbEg5qpDLyQ: checks 
zDrucyjVn5aeekNEc3cJrA: checks 
lxVahNAs/pc3YeLt9PSgbg: bets $0.50
0b9BiwFeJrba87+xtIuQxg: folds 
86vbuhJsyH+nbEg5qpDLyQ: folds 
zDrucyjVn5aeekNEc3cJrA: calls $0.50
*** TURN *** [4s Ad Ts] [Tc]
zDrucyjVn5aeekNEc3cJrA: checks 
lxVahNAs/pc3YeLt9PSgbg: checks 
*** RIVER *** [4s Ad Ts Tc] [8s]
zDrucyjVn5aeekNEc3cJrA: checks 
lxVahNAs/pc3YeLt9PSgbg: checks 
*** SHOW DOWN ***
zDrucyjVn5aeekNEc3cJrA: shows [Qd Js] (a pair of Tens)
lxVahNAs/pc3YeLt9PSgbg: shows [6h Ah] (two pair, Aces and Tens)
lxVahNAs/pc3YeLt9PSgbg collected $1.95 from pot
*** SUMMARY ***
Total pot $2 | Rake $0.05 
Board [4s Ad Ts Tc 8s]
Seat 1: GEZ4LFjiwTFoPklBgpSnlw folded before Flop (didn't bet)
Seat 2: zDrucyjVn5aeekNEc3cJrA showed [Qd Js] and lost with a pair of Tens
Seat 3: 56S3mA6Zs3pGR+0p0vUCtg folded before Flop (didn't bet)
Seat 4: oKO7b50N6TzXbPBr/mcrUA folded before Flop (didn't bet)
Seat 5: MIVCHqCqqlke0Lb0z7glcw folded before Flop (didn't bet)
Seat 6: lxVahNAs/pc3YeLt9PSgbg showed [6h Ah] and won ($1.95) with two pair, Aces and Tens
Seat 7: sUVgUtgbfVx6JpvApozwhQ (button) folded before Flop (didn't bet)
Seat 8: 0b9BiwFeJrba87+xtIuQxg (small blind) folded on the Flop
Seat 9: 86vbuhJsyH+nbEg5qpDLyQ (big blind) folded on the Flop




PokerStars Game #59939451208:  Hold'em No Limit ($0.10/$0.25) - 2009/07/01 0:40:13 ET
Table '9lYs7ljXi6AgFAxYHlKLJw' 9-max Seat #9 is the button
Seat 2: N6fYvIzQLKaydFLKQGtMlQ ($21.15 in chips) 
Seat 3: DnDcAdn9P0zGovMERigpFA ($27.85 in chips) 
Seat 4: UANt6y/SmDCY/jIxkBixcw ($30 in chips) 
Seat 5: dfNim92Z6XK1/h5SFW5vDg ($55.55 in chips) 
Seat 6: JtVGnq5doRa3PublncR+Yw ($20.45 in chips) 
Seat 7: ghNKXUBl/H+t83JF079ZBA ($30.10 in chips) 
Seat 8: Do7fcCjAx0vINJYUXuFoyA ($20.95 in chips) 
Seat 9: 18G4P1XstjNvItdGUITxgw ($26.30 in chips) 
N6fYvIzQLKaydFLKQGtMlQ: posts small blind $0.10
DnDcAdn9P0zGovMERigpFA: posts big blind $0.25
*** HOLE CARDS ***
UANt6y/SmDCY/jIxkBixcw: folds 
dfNim92Z6XK1/h5SFW5vDg: folds 
JtVGnq5doRa3PublncR+Yw: calls $0.25
ghNKXUBl/H+t83JF079ZBA: folds 
Do7fcCjAx0vINJYUXuFoyA: folds 
Do7fcCjAx0vINJYUXuFoyA leaves the table
18G4P1XstjNvItdGUITxgw: raises $0.50 to $0.75
N6fYvIzQLKaydFLKQGtMlQ: folds 
DnDcAdn9P0zGovMERigpFA: folds 
JtVGnq5doRa3PublncR+Yw: calls $0.50
*** FLOP *** [9s 9h 4s]
JtVGnq5doRa3PublncR+Yw: checks 
18G4P1XstjNvItdGUITxgw: bets $0.75
JtVGnq5doRa3PublncR+Yw: calls $0.75
*** TURN *** [9s 9h 4s] [9d]
JtVGnq5doRa3PublncR+Yw: checks 
18G4P1XstjNvItdGUITxgw: checks 
*** RIVER *** [9s 9h 4s 9d] [As]
JtVGnq5doRa3PublncR+Yw: bets $1.75
18G4P1XstjNvItdGUITxgw: calls $1.75
*** SHOW DOWN ***
JtVGnq5doRa3PublncR+Yw: shows [8d Td] (three of a kind, Nines)
18G4P1XstjNvItdGUITxgw: shows [6d 6s] (a full house, Nines full of Sixes)
18G4P1XstjNvItdGUITxgw collected $6.55 from pot
*** SUMMARY ***
Total pot $6.85 | Rake $0.30 
Board [9s 9h 4s 9d As]
Seat 2: N6fYvIzQLKaydFLKQGtMlQ (small blind) folded before Flop
Seat 3: DnDcAdn9P0zGovMERigpFA (big blind) folded before Flop
Seat 4: UANt6y/SmDCY/jIxkBixcw folded before Flop (didn't bet)
Seat 5: dfNim92Z6XK1/h5SFW5vDg folded before Flop (didn't bet)
Seat 6: JtVGnq5doRa3PublncR+Yw showed [8d Td] and lost with three of a kind, Nines
Seat 7: ghNKXUBl/H+t83JF079ZBA folded before Flop (didn't bet)
Seat 8: Do7fcCjAx0vINJYUXuFoyA folded before Flop (didn't bet)
Seat 9: 18G4P1XstjNvItdGUITxgw (button) showed [6d 6s] and won ($6.55) with a full house, Nines full of Sixes




PokerStars Game #59939451410:  Hold'em No Limit ($0.10/$0.25) - 2009/07/01 0:40:13 ET
Table '0mmHveGuaIfIMQlNE1eqMg' 9-max Seat #1 is the button
Seat 1: 7QzbjWT00wQpau1iqvUmMA ($4.65 in chips) 
Seat 2: rQhYIYXSyH/IivYM1dlV5A ($52.75 in chips) 
Seat 3: ghNKXUBl/H+t83JF079ZBA ($26.40 in chips) 
Seat 4: r0/CtYRRIJAbPQm4qsv8LQ ($35.50 in chips) 
Seat 5: cVVfy+hwCb/YzSIyUWhKEw ($32.75 in chips) 
Seat 6: Xo1w+VqEZh0bV5wYupnNYg ($15.40 in chips) 
Seat 8: jiyia7h6fmxBdWBkH9lH5A ($2.95 in chips) 
Seat 9: W4TLQcZ2TiM73eIgpIvlGg ($34.50 in chips) 
rQhYIYXSyH/IivYM1dlV5A: posts small blind $0.10
ghNKXUBl/H+t83JF079ZBA: posts big blind $0.25
*** HOLE CARDS ***
r0/CtYRRIJAbPQm4qsv8LQ: folds 
cVVfy+hwCb/YzSIyUWhKEw: calls $0.25
Xo1w+VqEZh0bV5wYupnNYg: folds 
jiyia7h6fmxBdWBkH9lH5A: folds 
W4TLQcZ2TiM73eIgpIvlGg: folds 
7QzbjWT00wQpau1iqvUmMA: folds 
rQhYIYXSyH/IivYM1dlV5A: folds 
ghNKXUBl/H+t83JF079ZBA: checks 
*** FLOP *** [Td 4d 4c]
ghNKXUBl/H+t83JF079ZBA: checks 
cVVfy+hwCb/YzSIyUWhKEw: bets $0.75
ghNKXUBl/H+t83JF079ZBA: calls $0.75
*** TURN *** [Td 4d 4c] [9d]
ghNKXUBl/H+t83JF079ZBA: bets $1.75
cVVfy+hwCb/YzSIyUWhKEw: calls $1.75
*** RIVER *** [Td 4d 4c 9d] [5s]
W4TLQcZ2TiM73eIgpIvlGg said, "kinda wish the turn wasn't a J -- scare card"
ghNKXUBl/H+t83JF079ZBA: bets $23.65 and is all-in
cVVfy+hwCb/YzSIyUWhKEw: folds 
Uncalled bet ($23.65) returned to ghNKXUBl/H+t83JF079ZBA
ghNKXUBl/H+t83JF079ZBA collected $5.35 from pot
ghNKXUBl/H+t83JF079ZBA: doesn't show hand 
*** SUMMARY ***
Total pot $5.60 | Rake $0.25 
Board [Td 4d 4c 9d 5s]
Seat 1: 7QzbjWT00wQpau1iqvUmMA (button) folded before Flop (didn't bet)
Seat 2: rQhYIYXSyH/IivYM1dlV5A (small blind) folded before Flop
Seat 3: ghNKXUBl/H+t83JF079ZBA (big blind) collected ($5.35)
Seat 4: r0/CtYRRIJAbPQm4qsv8LQ folded before Flop (didn't bet)
Seat 5: cVVfy+hwCb/YzSIyUWhKEw folded on the River
Seat 6: Xo1w+VqEZh0bV5wYupnNYg folded before Flop (didn't bet)
Seat 8: jiyia7h6fmxBdWBkH9lH5A folded before Flop (didn't bet)
Seat 9: W4TLQcZ2TiM73eIgpIvlGg folded before Flop (didn't bet)




PokerStars Game #59939451322:  Hold'em No Limit ($0.10/$0.25) - 2009/07/01 0:40:13 ET
Table 'luMgmRPIo47e7iXDlheIwA' 6-max Seat #5 is the button
Seat 2: 4YSTu0Cdzpppe1lUgCZGCQ ($35.10 in chips) 
Seat 3: W6Y6au0wf7gRAlqJYgOezw ($14.75 in chips) 
Seat 4: n2OZezRXTtdzQt4SuIy8TQ ($26 in chips) 
Seat 5: kG34n23qFQA3nzdOJTQ1dA ($46.55 in chips) 
4YSTu0Cdzpppe1lUgCZGCQ: posts small blind $0.10
W6Y6au0wf7gRAlqJYgOezw: posts big blind $0.25
*** HOLE CARDS ***
n2OZezRXTtdzQt4SuIy8TQ: folds 
kG34n23qFQA3nzdOJTQ1dA: folds 
4YSTu0Cdzpppe1lUgCZGCQ: folds 
Uncalled bet ($0.15) returned to W6Y6au0wf7gRAlqJYgOezw
W6Y6au0wf7gRAlqJYgOezw collected $0.20 from pot
*** SUMMARY ***
Total pot $0.20 | Rake $0 
Seat 2: 4YSTu0Cdzpppe1lUgCZGCQ (small blind) folded before Flop
Seat 3: W6Y6au0wf7gRAlqJYgOezw (big blind) collected ($0.20)
Seat 4: n2OZezRXTtdzQt4SuIy8TQ folded before Flop (didn't bet)
Seat 5: kG34n23qFQA3nzdOJTQ1dA (button) folded before Flop (didn't bet)




PokerStars Game #59939452504:  Hold'em No Limit ($0.10/$0.25) - 2009/07/01 0:40:14 ET
Table '3KDMdm1sfxFsNKkjc/PnBg' 9-max Seat #6 is the button
Seat 1: GQTWTgG7Ydy9q/vohVnKmQ ($25 in chips) 
Seat 2: rUpvA02nErFvZ4yFbDR8XA ($20.35 in chips) 
Seat 3: GftT+l+xjKzcY0rMiNZfPg ($27.30 in chips) 
Seat 4: 4xnojP+j2Tm8s9Bh7QC5+Q ($12.70 in chips) 
Seat 5: +2kMBNpY4nF1qNCRd8SJLA ($25.35 in chips) 
Seat 6: N1HHRe1nNMukTQB6qMn6Kw ($16.80 in chips) 
Seat 7: gehe91e0IyVT0QU/XBkEyg ($25 in chips) 
Seat 8: st9jtdNbm1W5GfBwRaCVqQ ($27.40 in chips) 
gehe91e0IyVT0QU/XBkEyg: posts small blind $0.10
st9jtdNbm1W5GfBwRaCVqQ: posts big blind $0.25
*** HOLE CARDS ***
GQTWTgG7Ydy9q/vohVnKmQ: folds 
rUpvA02nErFvZ4yFbDR8XA: folds 
GftT+l+xjKzcY0rMiNZfPg: raises $0.50 to $0.75
4xnojP+j2Tm8s9Bh7QC5+Q: folds 
+2kMBNpY4nF1qNCRd8SJLA: folds 
N1HHRe1nNMukTQB6qMn6Kw: folds 
gehe91e0IyVT0QU/XBkEyg: folds 
st9jtdNbm1W5GfBwRaCVqQ: folds 
Uncalled bet ($0.50) returned to GftT+l+xjKzcY0rMiNZfPg
GftT+l+xjKzcY0rMiNZfPg collected $0.60 from pot
GftT+l+xjKzcY0rMiNZfPg: doesn't show hand 
*** SUMMARY ***
Total pot $0.60 | Rake $0 
Seat 1: GQTWTgG7Ydy9q/vohVnKmQ folded before Flop (didn't bet)
Seat 2: rUpvA02nErFvZ4yFbDR8XA folded before Flop (didn't bet)
Seat 3: GftT+l+xjKzcY0rMiNZfPg collected ($0.60)
Seat 4: 4xnojP+j2Tm8s9Bh7QC5+Q folded before Flop (didn't bet)
Seat 5: +2kMBNpY4nF1qNCRd8SJLA folded before Flop (didn't bet)
Seat 6: N1HHRe1nNMukTQB6qMn6Kw (button) folded before Flop (didn't bet)
Seat 7: gehe91e0IyVT0QU/XBkEyg (small blind) folded before Flop
Seat 8: st9jtdNbm1W5GfBwRaCVqQ (big blind) folded before Flop




PokerStars Game #59939451898:  Hold'em No Limit ($0.10/$0.25) - 2009/07/01 0:40:14 ET
Table 'zojWVNukhD2n8RTfHCOwwg' 9-max Seat #6 is the button
Seat 1: DIBbjEYGs+TVdVgEB/4+3w ($41.45 in chips) 
Seat 2: ZeR3hkj1gVv9J4yPCmRrjA ($27.35 in chips) 
Seat 3: 1esmRaxnod+zAkE+7BtzMA ($15.70 in chips) 
Seat 4: Pb7qJqn2QUbp+oYBNQxyyA ($26.45 in chips) 
Seat 6: 2xNcp4M2UG8Li2PMEnWcgA ($10.20 in chips) 
Seat 7: H5Se03ZqSX7tbULXur2MAg ($27.05 in chips) 
Seat 8: j4q3p0lesp63b1gZDwLBZw ($5 in chips) 
Seat 9: 4oA316mXLIui1QY63GXBUg ($25 in chips) 
H5Se03ZqSX7tbULXur2MAg: posts small blind $0.10
j4q3p0lesp63b1gZDwLBZw: posts big blind $0.25
*** HOLE CARDS ***
4oA316mXLIui1QY63GXBUg: folds 
DIBbjEYGs+TVdVgEB/4+3w: folds 
ZeR3hkj1gVv9J4yPCmRrjA: calls $0.25
1esmRaxnod+zAkE+7BtzMA: raises $0.50 to $0.75
Pb7qJqn2QUbp+oYBNQxyyA: folds 
2xNcp4M2UG8Li2PMEnWcgA: folds 
H5Se03ZqSX7tbULXur2MAg: folds 
j4q3p0lesp63b1gZDwLBZw: folds 
ZeR3hkj1gVv9J4yPCmRrjA: calls $0.50
*** FLOP *** [Js Tc 6c]
ZeR3hkj1gVv9J4yPCmRrjA: checks 
1esmRaxnod+zAkE+7BtzMA: bets $1.25
ZeR3hkj1gVv9J4yPCmRrjA: folds 
Uncalled bet ($1.25) returned to 1esmRaxnod+zAkE+7BtzMA
1esmRaxnod+zAkE+7BtzMA collected $1.80 from pot
1esmRaxnod+zAkE+7BtzMA: doesn't show hand 
*** SUMMARY ***
Total pot $1.85 | Rake $0.05 
Board [Js Tc 6c]
Seat 1: DIBbjEYGs+TVdVgEB/4+3w folded before Flop (didn't bet)
Seat 2: ZeR3hkj1gVv9J4yPCmRrjA folded on the Flop
Seat 3: 1esmRaxnod+zAkE+7BtzMA collected ($1.80)
Seat 4: Pb7qJqn2QUbp+oYBNQxyyA folded before Flop (didn't bet)
Seat 6: 2xNcp4M2UG8Li2PMEnWcgA (button) folded before Flop (didn't bet)
Seat 7: H5Se03ZqSX7tbULXur2MAg (small blind) folded before Flop
Seat 8: j4q3p0lesp63b1gZDwLBZw (big blind) folded before Flop
Seat 9: 4oA316mXLIui1QY63GXBUg folded before Flop (didn't bet)




PokerStars Game #59939451996:  Hold'em No Limit ($0.10/$0.25) - 2009/07/01 0:40:14 ET
Table 'Rv0EYnRU8WwZiwx0Zo3X3w' 9-max Seat #1 is the button
Seat 1: opOCI2p6kW0tINuVaAqmcQ ($47.25 in chips) 
Seat 2: Xpyqpb+DURDWnyJ3xTEIFQ ($34.40 in chips) 
Seat 3: STkR8XvpjNv79OOMhrlh2w ($25 in chips) 
Seat 4: IDkfbfxTm9KJ+DMyGVH8rw ($12.05 in chips) 
Seat 5: h4ggJZYBXV0mEZzYPYKfeA ($20.85 in chips) 
Seat 6: 5hAPbqNrvJb8PtLiceXtlg ($4.65 in chips) 
Seat 7: Th3FldXKQW6hWVVPahaoOQ ($38.50 in chips) 
Seat 9: r1pFKMwWp74QwhfPWJOAyw ($6.60 in chips) 
Xpyqpb+DURDWnyJ3xTEIFQ: posts small blind $0.10
STkR8XvpjNv79OOMhrlh2w: posts big blind $0.25
*** HOLE CARDS ***
IDkfbfxTm9KJ+DMyGVH8rw: folds 
h4ggJZYBXV0mEZzYPYKfeA: folds 
5hAPbqNrvJb8PtLiceXtlg: folds 
Th3FldXKQW6hWVVPahaoOQ: folds 
r1pFKMwWp74QwhfPWJOAyw: folds 
opOCI2p6kW0tINuVaAqmcQ: raises $0.50 to $0.75
Xpyqpb+DURDWnyJ3xTEIFQ: raises $1 to $1.75
STkR8XvpjNv79OOMhrlh2w: folds 
10vzP4r6ldwGLbYHKd9www joins the table at seat #8 
opOCI2p6kW0tINuVaAqmcQ: calls $1
*** FLOP *** [9s 8d Ac]
Xpyqpb+DURDWnyJ3xTEIFQ: checks 
opOCI2p6kW0tINuVaAqmcQ: bets $1.50
Xpyqpb+DURDWnyJ3xTEIFQ: calls $1.50
*** TURN *** [9s 8d Ac] [5h]
Xpyqpb+DURDWnyJ3xTEIFQ: checks 
opOCI2p6kW0tINuVaAqmcQ: bets $2.75
Xpyqpb+DURDWnyJ3xTEIFQ: calls $2.75
*** RIVER *** [9s 8d Ac 5h] [Qs]
Xpyqpb+DURDWnyJ3xTEIFQ: checks 
opOCI2p6kW0tINuVaAqmcQ: checks 
*** SHOW DOWN ***
Xpyqpb+DURDWnyJ3xTEIFQ: shows [Kd Ks] (a pair of Kings)
opOCI2p6kW0tINuVaAqmcQ: shows [Kh As] (a pair of Aces)
opOCI2p6kW0tINuVaAqmcQ collected $11.70 from pot
*** SUMMARY ***
Total pot $12.25 | Rake $0.55 
Board [9s 8d Ac 5h Qs]
Seat 1: opOCI2p6kW0tINuVaAqmcQ (button) showed [Kh As] and won ($11.70) with a pair of Aces
Seat 2: Xpyqpb+DURDWnyJ3xTEIFQ (small blind) showed [Kd Ks] and lost with a pair of Kings
Seat 3: STkR8XvpjNv79OOMhrlh2w (big blind) folded before Flop
Seat 4: IDkfbfxTm9KJ+DMyGVH8rw folded before Flop (didn't bet)
Seat 5: h4ggJZYBXV0mEZzYPYKfeA folded before Flop (didn't bet)
Seat 6: 5hAPbqNrvJb8PtLiceXtlg folded before Flop (didn't bet)
Seat 7: Th3FldXKQW6hWVVPahaoOQ folded before Flop (didn't bet)
Seat 9: r1pFKMwWp74QwhfPWJOAyw folded before Flop (didn't bet)




PokerStars Game #59939452074:  Hold'em No Limit ($0.10/$0.25) - 2009/07/01 0:40:14 ET
Table 'RPdw09/gGCIP4xFhDWJgXQ' 9-max Seat #2 is the button
Seat 1: aNpwfA31EREwO+ar4XzBCw ($25 in chips) 
Seat 2: Sd1tfhUq/M96GhXGv1hwFQ ($11 in chips) 
Seat 3: Qi+clOtyDiibLdH2/1Qy8g ($26.10 in chips) 
Seat 4: z5GxcHlYz/GSz6W2uFiTtg ($22.10 in chips) 
Seat 5: z0kymJfmEW9d8WGcY1n6OA ($2.50 in chips) 
Seat 6: monZeAwXUmIA1l84cUd2hw ($19.05 in chips) 
Seat 7: hIss79a4pu7GzJZepfgOpg ($25 in chips) 
Seat 8: MG90wfSJZnOejs/KD3vlQQ ($25 in chips) 
Seat 9: Yv4fucyyT28mjx8V5lxKJg ($48.20 in chips) 
Qi+clOtyDiibLdH2/1Qy8g: posts small blind $0.10
z5GxcHlYz/GSz6W2uFiTtg: posts big blind $0.25
*** HOLE CARDS ***
z0kymJfmEW9d8WGcY1n6OA: calls $0.25
monZeAwXUmIA1l84cUd2hw: calls $0.25
hIss79a4pu7GzJZepfgOpg: folds 
MG90wfSJZnOejs/KD3vlQQ: folds 
Yv4fucyyT28mjx8V5lxKJg: raises $1.75 to $2
aNpwfA31EREwO+ar4XzBCw: folds 
Sd1tfhUq/M96GhXGv1hwFQ: folds 
Qi+clOtyDiibLdH2/1Qy8g: folds 
z5GxcHlYz/GSz6W2uFiTtg: folds 
z0kymJfmEW9d8WGcY1n6OA: folds 
monZeAwXUmIA1l84cUd2hw: calls $1.75
*** FLOP *** [8s 4h Kc]
monZeAwXUmIA1l84cUd2hw: bets $2
Yv4fucyyT28mjx8V5lxKJg: calls $2
*** TURN *** [8s 4h Kc] [Jh]
monZeAwXUmIA1l84cUd2hw: bets $2
Yv4fucyyT28mjx8V5lxKJg: calls $2
*** RIVER *** [8s 4h Kc Jh] [Th]
monZeAwXUmIA1l84cUd2hw: checks 
Yv4fucyyT28mjx8V5lxKJg: bets $42.20 and is all-in
monZeAwXUmIA1l84cUd2hw: folds 
Uncalled bet ($42.20) returned to Yv4fucyyT28mjx8V5lxKJg
Yv4fucyyT28mjx8V5lxKJg collected $12 from pot
Yv4fucyyT28mjx8V5lxKJg: doesn't show hand 
*** SUMMARY ***
Total pot $12.60 | Rake $0.60 
Board [8s 4h Kc Jh Th]
Seat 1: aNpwfA31EREwO+ar4XzBCw folded before Flop (didn't bet)
Seat 2: Sd1tfhUq/M96GhXGv1hwFQ (button) folded before Flop (didn't bet)
Seat 3: Qi+clOtyDiibLdH2/1Qy8g (small blind) folded before Flop
Seat 4: z5GxcHlYz/GSz6W2uFiTtg (big blind) folded before Flop
Seat 5: z0kymJfmEW9d8WGcY1n6OA folded before Flop
Seat 6: monZeAwXUmIA1l84cUd2hw folded on the River
Seat 7: hIss79a4pu7GzJZepfgOpg folded before Flop (didn't bet)
Seat 8: MG90wfSJZnOejs/KD3vlQQ folded before Flop (didn't bet)
Seat 9: Yv4fucyyT28mjx8V5lxKJg collected ($12)




PokerStars Game #59939452370:  Hold'em No Limit ($0.10/$0.25) - 2009/07/01 0:40:14 ET
Table 'O6cwjhrMn9pfzx1Ngn5zkQ' 6-max Seat #1 is the button
Seat 1: k4mJ9nD/YOVTl8/kGW+U6w ($13.70 in chips) 
Seat 2: M6xK/VklCvdyyrmvzATlxQ ($14.10 in chips) 
Seat 3: EE16Ua5b1HSsYej5zeXOlA ($25 in chips) 
Seat 4: wKFJ513ucluNNiMlkXcDOQ ($31.75 in chips) 
Seat 5: niLn0xUVlqh8If80xRjzCA ($23.25 in chips) 
Seat 6: d0J1xuhsynEY81YHwAvJ5g ($27.05 in chips) 
M6xK/VklCvdyyrmvzATlxQ: posts small blind $0.10
EE16Ua5b1HSsYej5zeXOlA: posts big blind $0.25
*** HOLE CARDS ***
wKFJ513ucluNNiMlkXcDOQ: folds 
niLn0xUVlqh8If80xRjzCA: calls $0.25
d0J1xuhsynEY81YHwAvJ5g: folds 
k4mJ9nD/YOVTl8/kGW+U6w: calls $0.25
M6xK/VklCvdyyrmvzATlxQ: folds 
EE16Ua5b1HSsYej5zeXOlA: checks 
*** FLOP *** [Td 4d 7d]
EE16Ua5b1HSsYej5zeXOlA: checks 
niLn0xUVlqh8If80xRjzCA: checks 
k4mJ9nD/YOVTl8/kGW+U6w: bets $0.25
EE16Ua5b1HSsYej5zeXOlA: folds 
niLn0xUVlqh8If80xRjzCA: calls $0.25
*** TURN *** [Td 4d 7d] [Jd]
niLn0xUVlqh8If80xRjzCA: checks 
k4mJ9nD/YOVTl8/kGW+U6w: checks 
*** RIVER *** [Td 4d 7d Jd] [7h]
niLn0xUVlqh8If80xRjzCA: bets $0.25
k4mJ9nD/YOVTl8/kGW+U6w: calls $0.25
*** SHOW DOWN ***
niLn0xUVlqh8If80xRjzCA: shows [Ah 9d] (a flush, Jack high)
k4mJ9nD/YOVTl8/kGW+U6w: mucks hand 
niLn0xUVlqh8If80xRjzCA said, ";)"
niLn0xUVlqh8If80xRjzCA collected $1.80 from pot
k4mJ9nD/YOVTl8/kGW+U6w said, "lucky"
*** SUMMARY ***
Total pot $1.85 | Rake $0.05 
Board [Td 4d 7d Jd 7h]
Seat 1: k4mJ9nD/YOVTl8/kGW+U6w (button) mucked
Seat 2: M6xK/VklCvdyyrmvzATlxQ (small blind) folded before Flop
Seat 3: EE16Ua5b1HSsYej5zeXOlA (big blind) folded on the Flop
Seat 4: wKFJ513ucluNNiMlkXcDOQ folded before Flop (didn't bet)
Seat 5: niLn0xUVlqh8If80xRjzCA showed [Ah 9d] and won ($1.80) with a flush, Jack high
Seat 6: d0J1xuhsynEY81YHwAvJ5g folded before Flop (didn't bet)




PokerStars Game #59939451906:  Hold'em No Limit ($0.10/$0.25) - 2009/07/01 0:40:14 ET
Table 'UVjmXTtsmlX1HxwwZ59akg' 9-max Seat #4 is the button
Seat 1: zDrucyjVn5aeekNEc3cJrA ($27.30 in chips) 
Seat 2: COsrwJSFHQtxlUcrYtDQPQ ($27.60 in chips) 
Seat 3: N6fYvIzQLKaydFLKQGtMlQ ($24.65 in chips) 
Seat 4: aNpwfA31EREwO+ar4XzBCw ($25 in chips) 
Seat 6: DnDcAdn9P0zGovMERigpFA ($33.85 in chips) 
Seat 8: 1MicVRr41LapJvzzk3i8Tw ($11.70 in chips) 
Seat 9: CwVLsIXxfYxktnIIDbafCw ($14.15 in chips) 
DnDcAdn9P0zGovMERigpFA: posts small blind $0.10
1MicVRr41LapJvzzk3i8Tw: posts big blind $0.25
*** HOLE CARDS ***
CwVLsIXxfYxktnIIDbafCw: folds 
zDrucyjVn5aeekNEc3cJrA: calls $0.25
CwVLsIXxfYxktnIIDbafCw leaves the table
COsrwJSFHQtxlUcrYtDQPQ: folds 
1MicVRr41LapJvzzk3i8Tw said, "after you rereaised prefolp you had a higher pair than me"
N6fYvIzQLKaydFLKQGtMlQ: folds 
aNpwfA31EREwO+ar4XzBCw: folds 
DnDcAdn9P0zGovMERigpFA: folds 
1MicVRr41LapJvzzk3i8Tw: checks 
*** FLOP *** [9s Ad 4d]
1MicVRr41LapJvzzk3i8Tw: bets $0.50
zDrucyjVn5aeekNEc3cJrA: raises $0.50 to $1
1MicVRr41LapJvzzk3i8Tw: calls $0.50
*** TURN *** [9s Ad 4d] [Kc]
1MicVRr41LapJvzzk3i8Tw: checks 
zDrucyjVn5aeekNEc3cJrA: checks 
*** RIVER *** [9s Ad 4d Kc] [3s]
1MicVRr41LapJvzzk3i8Tw: checks 
zDrucyjVn5aeekNEc3cJrA: checks 
*** SHOW DOWN ***
1MicVRr41LapJvzzk3i8Tw: shows [9d 7c] (a pair of Nines)
zDrucyjVn5aeekNEc3cJrA: shows [Ah Js] (a pair of Aces)
zDrucyjVn5aeekNEc3cJrA collected $2.50 from pot
*** SUMMARY ***
Total pot $2.60 | Rake $0.10 
Board [9s Ad 4d Kc 3s]
Seat 1: zDrucyjVn5aeekNEc3cJrA showed [Ah Js] and won ($2.50) with a pair of Aces
Seat 2: COsrwJSFHQtxlUcrYtDQPQ folded before Flop (didn't bet)
Seat 3: N6fYvIzQLKaydFLKQGtMlQ folded before Flop (didn't bet)
Seat 4: aNpwfA31EREwO+ar4XzBCw (button) folded before Flop (didn't bet)
Seat 6: DnDcAdn9P0zGovMERigpFA (small blind) folded before Flop
Seat 8: 1MicVRr41LapJvzzk3i8Tw (big blind) showed [9d 7c] and lost with a pair of Nines
Seat 9: CwVLsIXxfYxktnIIDbafCw folded before Flop (didn't bet)




PokerStars Game #59939452212:  Hold'em No Limit ($0.10/$0.25) - 2009/07/01 0:40:14 ET
Table '+198VWQSWBhYQOcizzuBkw' 6-max Seat #6 is the button
Seat 2: R6AGToFJQOYVZAjC2jXEKw ($29.15 in chips) 
Seat 3: BYxjLnV1/LL0aZcTbfAOvw ($27.25 in chips) 
Seat 4: TgDsTeCdLQt8kWbL00ByRA ($27.25 in chips) 
Seat 5: LtASJ9OlkqGrrUKGQlpGAw ($30.30 in chips) 
Seat 6: 7qRk4YH4/k/08LgJSv7rBQ ($31.25 in chips) 
R6AGToFJQOYVZAjC2jXEKw: posts small blind $0.10
BYxjLnV1/LL0aZcTbfAOvw: posts big blind $0.25
*** HOLE CARDS ***
TgDsTeCdLQt8kWbL00ByRA: folds 
LtASJ9OlkqGrrUKGQlpGAw: folds 
7qRk4YH4/k/08LgJSv7rBQ: folds 
R6AGToFJQOYVZAjC2jXEKw: folds 
Uncalled bet ($0.15) returned to BYxjLnV1/LL0aZcTbfAOvw
BYxjLnV1/LL0aZcTbfAOvw collected $0.20 from pot
BYxjLnV1/LL0aZcTbfAOvw: doesn't show hand 
*** SUMMARY ***
Total pot $0.20 | Rake $0 
Seat 2: R6AGToFJQOYVZAjC2jXEKw (small blind) folded before Flop
Seat 3: BYxjLnV1/LL0aZcTbfAOvw (big blind) collected ($0.20)
Seat 4: TgDsTeCdLQt8kWbL00ByRA folded before Flop (didn't bet)
Seat 5: LtASJ9OlkqGrrUKGQlpGAw folded before Flop (didn't bet)
Seat 6: 7qRk4YH4/k/08LgJSv7rBQ (button) folded before Flop (didn't bet)




PokerStars Game #59939452442:  Hold'em No Limit ($0.10/$0.25) - 2009/07/01 0:40:14 ET
Table '5510FxlYzKi+U6MIpo8IPA' 6-max Seat #3 is the button
Seat 1: KM6ogk7SqyRlk3m9b0h+7A ($19.65 in chips) 
Seat 3: v+QfkGiuj9bgtuNoVnDO8w ($29.45 in chips) 
Seat 4: cPO/1/dTcZpLkQFm3jH3Rg ($27.65 in chips) 
Seat 5: 5E1iMY5xyboow7Xm0v7Idw ($11.90 in chips) 
Seat 6: SFmT9ZsVopnukjvAzrxTRg ($29.10 in chips) 
cPO/1/dTcZpLkQFm3jH3Rg: posts small blind $0.10
5E1iMY5xyboow7Xm0v7Idw: posts big blind $0.25
*** HOLE CARDS ***
SFmT9ZsVopnukjvAzrxTRg: folds 
KM6ogk7SqyRlk3m9b0h+7A: folds 
v+QfkGiuj9bgtuNoVnDO8w: folds 
cPO/1/dTcZpLkQFm3jH3Rg: folds 
Uncalled bet ($0.15) returned to 5E1iMY5xyboow7Xm0v7Idw
5E1iMY5xyboow7Xm0v7Idw collected $0.20 from pot
*** SUMMARY ***
Total pot $0.20 | Rake $0 
Seat 1: KM6ogk7SqyRlk3m9b0h+7A folded before Flop (didn't bet)
Seat 3: v+QfkGiuj9bgtuNoVnDO8w (button) folded before Flop (didn't bet)
Seat 4: cPO/1/dTcZpLkQFm3jH3Rg (small blind) folded before Flop
Seat 5: 5E1iMY5xyboow7Xm0v7Idw (big blind) collected ($0.20)
Seat 6: SFmT9ZsVopnukjvAzrxTRg folded before Flop (didn't bet)




PokerStars Game #59939452296:  Hold'em No Limit ($0.10/$0.25) - 2009/07/01 0:40:14 ET
Table 'VuY5ej47Cy8nOI3Wogmhzw' 6-max Seat #4 is the button
Seat 3: 0n9nsjvz4GIG4IyVHT0JVw ($2.75 in chips) 
Seat 4: FC6tJ9EOiutXO8hnpR4VgQ ($4.30 in chips) 
Seat 6: +v0nBUereMsRzYp2Knh/cQ ($12.60 in chips) 
+v0nBUereMsRzYp2Knh/cQ: posts small blind $0.10
0n9nsjvz4GIG4IyVHT0JVw: posts big blind $0.25
*** HOLE CARDS ***
FC6tJ9EOiutXO8hnpR4VgQ: raises $0.50 to $0.75
+v0nBUereMsRzYp2Knh/cQ: folds 
0n9nsjvz4GIG4IyVHT0JVw: folds 
Uncalled bet ($0.50) returned to FC6tJ9EOiutXO8hnpR4VgQ
FC6tJ9EOiutXO8hnpR4VgQ collected $0.60 from pot
FC6tJ9EOiutXO8hnpR4VgQ: doesn't show hand 
*** SUMMARY ***
Total pot $0.60 | Rake $0 
Seat 3: 0n9nsjvz4GIG4IyVHT0JVw (big blind) folded before Flop
Seat 4: FC6tJ9EOiutXO8hnpR4VgQ (button) collected ($0.60)
Seat 6: +v0nBUereMsRzYp2Knh/cQ (small blind) folded before Flop




PokerStars Game #59939452944:  Hold'em No Limit ($0.10/$0.25) - 2009/07/01 0:40:15 ET
Table 'O5NgMYt6EWbLBozZb3kseg' 6-max Seat #1 is the button
Seat 1: T2fEtpqj5ZyZAjEhNtsFAA ($40.80 in chips) 
Seat 2: VWbjqONyDvf8KegytgPLjQ ($61.15 in chips) 
Seat 4: aogAb4Eienxztk8p2v9VVw ($24 in chips) 
Seat 5: vu2kzHaDtgr6NM7rdq0chA ($43.50 in chips) 
Seat 6: k9vn40MOqqb+xF+7GZ6v2g ($22.85 in chips) 
VWbjqONyDvf8KegytgPLjQ: posts small blind $0.10
aogAb4Eienxztk8p2v9VVw: posts big blind $0.25
*** HOLE CARDS ***
vu2kzHaDtgr6NM7rdq0chA: folds 
k9vn40MOqqb+xF+7GZ6v2g: folds 
T2fEtpqj5ZyZAjEhNtsFAA: folds 
VWbjqONyDvf8KegytgPLjQ: calls $0.15
aogAb4Eienxztk8p2v9VVw: checks 
*** FLOP *** [As 7d 5h]
VWbjqONyDvf8KegytgPLjQ: checks 
aogAb4Eienxztk8p2v9VVw: checks 
*** TURN *** [As 7d 5h] [Ts]
VWbjqONyDvf8KegytgPLjQ: checks 
aogAb4Eienxztk8p2v9VVw: checks 
*** RIVER *** [As 7d 5h Ts] [Qd]
VWbjqONyDvf8KegytgPLjQ: checks 
aogAb4Eienxztk8p2v9VVw: checks 
*** SHOW DOWN ***
VWbjqONyDvf8KegytgPLjQ: shows [9d 8d] (high card Ace)
aogAb4Eienxztk8p2v9VVw: mucks hand 
VWbjqONyDvf8KegytgPLjQ collected $0.50 from pot
*** SUMMARY ***
Total pot $0.50 | Rake $0 
Board [As 7d 5h Ts Qd]
Seat 1: T2fEtpqj5ZyZAjEhNtsFAA (button) folded before Flop (didn't bet)
Seat 2: VWbjqONyDvf8KegytgPLjQ (small blind) showed [9d 8d] and won ($0.50) with high card Ace
Seat 4: aogAb4Eienxztk8p2v9VVw (big blind) mucked
Seat 5: vu2kzHaDtgr6NM7rdq0chA folded before Flop (didn't bet)
Seat 6: k9vn40MOqqb+xF+7GZ6v2g folded before Flop (didn't bet)




PokerStars Game #59939453010:  Hold'em No Limit ($0.10/$0.25) - 2009/07/01 0:40:15 ET
Table 'dZNBGqFYSwfOVZvDJ4VjIQ' 6-max Seat #5 is the button
Seat 2: NPueG39V6nKvDRuvBJ4U7g ($14.85 in chips) 
Seat 3: Qd4gQJ1hjQcU9/uDqd6Nlw ($11.70 in chips) 
Seat 4: df01R5ThvHspD8FgKmaDvQ ($25 in chips) 
Seat 5: hZJzYj+7+PvGu6ae1g//sQ ($10.90 in chips) 
Seat 6: VbudEd0ZG+qPwMO9h+hjXw ($18.45 in chips) 
VbudEd0ZG+qPwMO9h+hjXw: posts small blind $0.10
NPueG39V6nKvDRuvBJ4U7g: posts big blind $0.25
df01R5ThvHspD8FgKmaDvQ: posts big blind $0.25
*** HOLE CARDS ***
Qd4gQJ1hjQcU9/uDqd6Nlw: folds 
o08wk0F4gROLhZS04Iyl3w joins the table at seat #1 
df01R5ThvHspD8FgKmaDvQ: checks 
hZJzYj+7+PvGu6ae1g//sQ: calls $0.25
VbudEd0ZG+qPwMO9h+hjXw: calls $0.15
NPueG39V6nKvDRuvBJ4U7g: checks 
*** FLOP *** [8d 4s Qs]
VbudEd0ZG+qPwMO9h+hjXw: checks 
NPueG39V6nKvDRuvBJ4U7g: checks 
df01R5ThvHspD8FgKmaDvQ: checks 
hZJzYj+7+PvGu6ae1g//sQ: checks 
*** TURN *** [8d 4s Qs] [Ts]
VbudEd0ZG+qPwMO9h+hjXw: checks 
NPueG39V6nKvDRuvBJ4U7g: checks 
df01R5ThvHspD8FgKmaDvQ: checks 
hZJzYj+7+PvGu6ae1g//sQ: checks 
*** RIVER *** [8d 4s Qs Ts] [6s]
VbudEd0ZG+qPwMO9h+hjXw: checks 
NPueG39V6nKvDRuvBJ4U7g: checks 
df01R5ThvHspD8FgKmaDvQ: checks 
hZJzYj+7+PvGu6ae1g//sQ: checks 
*** SHOW DOWN ***
VbudEd0ZG+qPwMO9h+hjXw: shows [Th 7s] (a flush, Queen high)
NPueG39V6nKvDRuvBJ4U7g: shows [Js Ac] (a flush, Queen high - Jack higher)
df01R5ThvHspD8FgKmaDvQ: mucks hand 
hZJzYj+7+PvGu6ae1g//sQ: mucks hand 
NPueG39V6nKvDRuvBJ4U7g collected $0.95 from pot
*** SUMMARY ***
Total pot $1 | Rake $0.05 
Board [8d 4s Qs Ts 6s]
Seat 2: NPueG39V6nKvDRuvBJ4U7g (big blind) showed [Js Ac] and won ($0.95) with a flush, Queen high
Seat 3: Qd4gQJ1hjQcU9/uDqd6Nlw folded before Flop (didn't bet)
Seat 4: df01R5ThvHspD8FgKmaDvQ mucked
Seat 5: hZJzYj+7+PvGu6ae1g//sQ (button) mucked
Seat 6: VbudEd0ZG+qPwMO9h+hjXw (small blind) showed [Th 7s] and lost with a flush, Queen high




PokerStars Game #59939452788:  Hold'em No Limit ($0.10/$0.25) - 2009/07/01 0:40:15 ET
Table '+UzantPJ4smVdrh+4GTu1w' 6-max Seat #6 is the button
Seat 1: 3Bm6SLY1pwRvi98HLQUkvg ($1.90 in chips) 
Seat 2: tcbEu7VzyHQ+0lh+skbQhQ ($10.25 in chips) 
Seat 3: SS/yfeArhULzIcOPe8MdPg ($51.15 in chips) 
Seat 5: cj4VBQya7HtVL2zCGd5jLQ ($17.15 in chips) 
Seat 6: BYxjLnV1/LL0aZcTbfAOvw ($48.05 in chips) 
3Bm6SLY1pwRvi98HLQUkvg: posts small blind $0.10
tcbEu7VzyHQ+0lh+skbQhQ: posts big blind $0.25
IGRfskE1v9H9Bn+fz8AgNQ: sits out 
*** HOLE CARDS ***
SS/yfeArhULzIcOPe8MdPg: folds 
cj4VBQya7HtVL2zCGd5jLQ: calls $0.25
BYxjLnV1/LL0aZcTbfAOvw: folds 
3Bm6SLY1pwRvi98HLQUkvg: calls $0.15
tcbEu7VzyHQ+0lh+skbQhQ: checks 
*** FLOP *** [7s Jc As]
3Bm6SLY1pwRvi98HLQUkvg: checks 
tcbEu7VzyHQ+0lh+skbQhQ: checks 
cj4VBQya7HtVL2zCGd5jLQ: checks 
*** TURN *** [7s Jc As] [Kd]
3Bm6SLY1pwRvi98HLQUkvg: checks 
tcbEu7VzyHQ+0lh+skbQhQ: checks 
cj4VBQya7HtVL2zCGd5jLQ: checks 
*** RIVER *** [7s Jc As Kd] [Ts]
3Bm6SLY1pwRvi98HLQUkvg: checks 
tcbEu7VzyHQ+0lh+skbQhQ: checks 
cj4VBQya7HtVL2zCGd5jLQ: checks 
*** SHOW DOWN ***
3Bm6SLY1pwRvi98HLQUkvg: shows [Tc 2s] (a pair of Tens)
tcbEu7VzyHQ+0lh+skbQhQ: mucks hand 
cj4VBQya7HtVL2zCGd5jLQ: mucks hand 
3Bm6SLY1pwRvi98HLQUkvg collected $0.75 from pot
*** SUMMARY ***
Total pot $0.75 | Rake $0 
Board [7s Jc As Kd Ts]
Seat 1: 3Bm6SLY1pwRvi98HLQUkvg (small blind) showed [Tc 2s] and won ($0.75) with a pair of Tens
Seat 2: tcbEu7VzyHQ+0lh+skbQhQ (big blind) mucked
Seat 3: SS/yfeArhULzIcOPe8MdPg folded before Flop (didn't bet)
Seat 5: cj4VBQya7HtVL2zCGd5jLQ mucked
Seat 6: BYxjLnV1/LL0aZcTbfAOvw (button) folded before Flop (didn't bet)




PokerStars Game #59939452594:  Hold'em No Limit ($0.10/$0.25) - 2009/07/01 0:40:15 ET
Table 'GgmUtmhrYPRnhkqEEjD/Kw' 9-max Seat #7 is the button
Seat 2: ghNKXUBl/H+t83JF079ZBA ($25 in chips) 
Seat 3: DZek9vrzBExLUFtbWml/Eg ($11.05 in chips) 
Seat 4: uwmAXQRjyA4iX5kaC15P9A ($5.40 in chips) 
Seat 5: lwrOE80tuooHfIBx/4LUSw ($31.10 in chips) 
Seat 6: 4Ax0vobe1rLVIGZmkFINGA ($17.55 in chips) 
Seat 7: YwDw9cMqkbMznFK77rru4A ($8.55 in chips) 
Seat 8: mKwW7JjB4GQW2YtoYgqIgw ($12.20 in chips) 
mKwW7JjB4GQW2YtoYgqIgw: posts small blind $0.10
ghNKXUBl/H+t83JF079ZBA: posts big blind $0.25
*** HOLE CARDS ***
DZek9vrzBExLUFtbWml/Eg: calls $0.25
uwmAXQRjyA4iX5kaC15P9A: folds 
lwrOE80tuooHfIBx/4LUSw: folds 
4Ax0vobe1rLVIGZmkFINGA: folds 
vnCdP3GsLTKadDukKcJk/Q joins the table at seat #1 
YwDw9cMqkbMznFK77rru4A: folds 
mKwW7JjB4GQW2YtoYgqIgw: calls $0.15
ghNKXUBl/H+t83JF079ZBA: checks 
*** FLOP *** [9c Kd 6s]
mKwW7JjB4GQW2YtoYgqIgw: checks 
ghNKXUBl/H+t83JF079ZBA: checks 
DZek9vrzBExLUFtbWml/Eg: bets $0.75
mKwW7JjB4GQW2YtoYgqIgw: folds 
ghNKXUBl/H+t83JF079ZBA: folds 
Uncalled bet ($0.75) returned to DZek9vrzBExLUFtbWml/Eg
lwrOE80tuooHfIBx/4LUSw leaves the table
DZek9vrzBExLUFtbWml/Eg collected $0.75 from pot
*** SUMMARY ***
Total pot $0.75 | Rake $0 
Board [9c Kd 6s]
Seat 2: ghNKXUBl/H+t83JF079ZBA (big blind) folded on the Flop
Seat 3: DZek9vrzBExLUFtbWml/Eg collected ($0.75)
Seat 4: uwmAXQRjyA4iX5kaC15P9A folded before Flop (didn't bet)
Seat 5: lwrOE80tuooHfIBx/4LUSw folded before Flop (didn't bet)
Seat 6: 4Ax0vobe1rLVIGZmkFINGA folded before Flop (didn't bet)
Seat 7: YwDw9cMqkbMznFK77rru4A (button) folded before Flop (didn't bet)
Seat 8: mKwW7JjB4GQW2YtoYgqIgw (small blind) folded on the Flop




PokerStars Game #59939453092:  Hold'em No Limit ($0.10/$0.25) - 2009/07/01 0:40:15 ET
Table 'FE/j6VqBY4j9Uq+VHURQCQ' 6-max Seat #6 is the button
Seat 1: wKFJ513ucluNNiMlkXcDOQ ($43.85 in chips) 
Seat 2: 3zD3qLXT1bEffAoWGnc7wg ($25 in chips) 
Seat 3: Zijzy/UtPWzWVUo81HHVjQ ($49.75 in chips) 
Seat 4: cPO/1/dTcZpLkQFm3jH3Rg ($25.35 in chips) 
Seat 5: wsP46AGpqDjHZQmlRHKa9g ($25 in chips) 
Seat 6: kARKwAmU6kWJfiSICTYhVw ($14.35 in chips) 
wKFJ513ucluNNiMlkXcDOQ: posts small blind $0.10
3zD3qLXT1bEffAoWGnc7wg: posts big blind $0.25
*** HOLE CARDS ***
Zijzy/UtPWzWVUo81HHVjQ: folds 
cPO/1/dTcZpLkQFm3jH3Rg: folds 
wsP46AGpqDjHZQmlRHKa9g: raises $0.50 to $0.75
kARKwAmU6kWJfiSICTYhVw: folds 
wKFJ513ucluNNiMlkXcDOQ: folds 
3zD3qLXT1bEffAoWGnc7wg: folds 
Uncalled bet ($0.50) returned to wsP46AGpqDjHZQmlRHKa9g
wsP46AGpqDjHZQmlRHKa9g collected $0.60 from pot
*** SUMMARY ***
Total pot $0.60 | Rake $0 
Seat 1: wKFJ513ucluNNiMlkXcDOQ (small blind) folded before Flop
Seat 2: 3zD3qLXT1bEffAoWGnc7wg (big blind) folded before Flop
Seat 3: Zijzy/UtPWzWVUo81HHVjQ folded before Flop (didn't bet)
Seat 4: cPO/1/dTcZpLkQFm3jH3Rg folded before Flop (didn't bet)
Seat 5: wsP46AGpqDjHZQmlRHKa9g collected ($0.60)
Seat 6: kARKwAmU6kWJfiSICTYhVw (button) folded before Flop (didn't bet)




PokerStars Game #59939453008:  Hold'em No Limit ($0.10/$0.25) - 2009/07/01 0:40:15 ET
Table 'rtxA1Y01Nrq5VoyzTAuusQ' 9-max Seat #5 is the button
Seat 1: wfJUJWKI2zkvL7Vp7kqggA ($10 in chips) 
Seat 2: xtpoxBFB+5CWL2iFqk9Zlg ($37.55 in chips) 
Seat 3: K9fS1IUr5GpiJG7VkJ7IbA ($12.30 in chips) 
Seat 4: JxpnpCmvRAcrEUy7mq1iAg ($5 in chips) 
Seat 5: HG/hVrkvCiG0erBa6RyLZA ($13.65 in chips) 
Seat 6: qccGLncfUaN00Few5HsgYg ($23.40 in chips) 
Seat 7: N6fYvIzQLKaydFLKQGtMlQ ($23.05 in chips) 
Seat 8: EUSBQy2KGzT65/CXiIu59Q ($40.40 in chips) 
Seat 9: HPEB+AtKw1+C/cxU0o1ciw ($24.60 in chips) 
qccGLncfUaN00Few5HsgYg: posts small blind $0.10
N6fYvIzQLKaydFLKQGtMlQ: posts big blind $0.25
*** HOLE CARDS ***
EUSBQy2KGzT65/CXiIu59Q: folds 
HPEB+AtKw1+C/cxU0o1ciw: folds 
wfJUJWKI2zkvL7Vp7kqggA: folds 
xtpoxBFB+5CWL2iFqk9Zlg: calls $0.25
K9fS1IUr5GpiJG7VkJ7IbA: folds 
JxpnpCmvRAcrEUy7mq1iAg: folds 
HG/hVrkvCiG0erBa6RyLZA: calls $0.25
qccGLncfUaN00Few5HsgYg: folds 
N6fYvIzQLKaydFLKQGtMlQ: checks 
*** FLOP *** [7h 3d 8s]
N6fYvIzQLKaydFLKQGtMlQ: checks 
xtpoxBFB+5CWL2iFqk9Zlg: bets $1
HG/hVrkvCiG0erBa6RyLZA: folds 
N6fYvIzQLKaydFLKQGtMlQ: folds 
Uncalled bet ($1) returned to xtpoxBFB+5CWL2iFqk9Zlg
xtpoxBFB+5CWL2iFqk9Zlg collected $0.85 from pot
*** SUMMARY ***
Total pot $0.85 | Rake $0 
Board [7h 3d 8s]
Seat 1: wfJUJWKI2zkvL7Vp7kqggA folded before Flop (didn't bet)
Seat 2: xtpoxBFB+5CWL2iFqk9Zlg collected ($0.85)
Seat 3: K9fS1IUr5GpiJG7VkJ7IbA folded before Flop (didn't bet)
Seat 4: JxpnpCmvRAcrEUy7mq1iAg folded before Flop (didn't bet)
Seat 5: HG/hVrkvCiG0erBa6RyLZA (button) folded on the Flop
Seat 6: qccGLncfUaN00Few5HsgYg (small blind) folded before Flop
Seat 7: N6fYvIzQLKaydFLKQGtMlQ (big blind) folded on the Flop
Seat 8: EUSBQy2KGzT65/CXiIu59Q folded before Flop (didn't bet)
Seat 9: HPEB+AtKw1+C/cxU0o1ciw folded before Flop (didn't bet)




PokerStars Game #59939453566:  Hold'em No Limit ($0.10/$0.25) - 2009/07/01 0:40:16 ET
Table '+68ihX5Br1xgGorX6zsCBg' 9-max Seat #4 is the button
Seat 1: qwr38jl5txoR36M7G5qi4A ($8.40 in chips) 
Seat 2: 3PjJjazzeHcM4mbFeXmZBg ($8.60 in chips) 
Seat 3: DIBbjEYGs+TVdVgEB/4+3w ($25.40 in chips) 
Seat 4: STkR8XvpjNv79OOMhrlh2w ($25 in chips) 
Seat 5: AmFFUA8KSwLGIW6CfaP4JQ ($11.90 in chips) 
Seat 6: 8B/dhbQjIWe6ASCdgzktNQ ($25.25 in chips) 
Seat 7: LWN1wPrLH+695JIriXxDuw ($9.05 in chips) 
Seat 8: rUdM7gwmNCaxMNSb2CFPhQ ($12.45 in chips) 
Seat 9: 3wk6bqORFdwo0pZ1g2+Kqw ($22.25 in chips) 
AmFFUA8KSwLGIW6CfaP4JQ: posts small blind $0.10
8B/dhbQjIWe6ASCdgzktNQ: posts big blind $0.25
*** HOLE CARDS ***
LWN1wPrLH+695JIriXxDuw: folds 
rUdM7gwmNCaxMNSb2CFPhQ: folds 
3wk6bqORFdwo0pZ1g2+Kqw: folds 
qwr38jl5txoR36M7G5qi4A: folds 
3PjJjazzeHcM4mbFeXmZBg: folds 
DIBbjEYGs+TVdVgEB/4+3w: folds 
STkR8XvpjNv79OOMhrlh2w: calls $0.25
AmFFUA8KSwLGIW6CfaP4JQ: folds 
8B/dhbQjIWe6ASCdgzktNQ: checks 
*** FLOP *** [As 6d Jd]
8B/dhbQjIWe6ASCdgzktNQ: checks 
STkR8XvpjNv79OOMhrlh2w: checks 
*** TURN *** [As 6d Jd] [6c]
8B/dhbQjIWe6ASCdgzktNQ: checks 
STkR8XvpjNv79OOMhrlh2w: checks 
*** RIVER *** [As 6d Jd 6c] [2c]
8B/dhbQjIWe6ASCdgzktNQ: checks 
STkR8XvpjNv79OOMhrlh2w: checks 
*** SHOW DOWN ***
8B/dhbQjIWe6ASCdgzktNQ: shows [8s Jh] (two pair, Jacks and Sixes)
STkR8XvpjNv79OOMhrlh2w: mucks hand 
8B/dhbQjIWe6ASCdgzktNQ collected $0.60 from pot
*** SUMMARY ***
Total pot $0.60 | Rake $0 
Board [As 6d Jd 6c 2c]
Seat 1: qwr38jl5txoR36M7G5qi4A folded before Flop (didn't bet)
Seat 2: 3PjJjazzeHcM4mbFeXmZBg folded before Flop (didn't bet)
Seat 3: DIBbjEYGs+TVdVgEB/4+3w folded before Flop (didn't bet)
Seat 4: STkR8XvpjNv79OOMhrlh2w (button) mucked
Seat 5: AmFFUA8KSwLGIW6CfaP4JQ (small blind) folded before Flop
Seat 6: 8B/dhbQjIWe6ASCdgzktNQ (big blind) showed [8s Jh] and won ($0.60) with two pair, Jacks and Sixes
Seat 7: LWN1wPrLH+695JIriXxDuw folded before Flop (didn't bet)
Seat 8: rUdM7gwmNCaxMNSb2CFPhQ folded before Flop (didn't bet)
Seat 9: 3wk6bqORFdwo0pZ1g2+Kqw folded before Flop (didn't bet)




PokerStars Game #59939453232:  Hold'em No Limit ($0.10/$0.25) - 2009/07/01 0:40:16 ET
Table '8qKBgCRnebT9/IvA6SmaPw' 9-max Seat #2 is the button
Seat 1: GTcLfsDTPqgfHyhY9FNDMw ($11.20 in chips) 
Seat 2: SXqVW4Q0evTUVZG6BbUNIA ($76.55 in chips) 
Seat 4: rXm4QDVJt67H20lM6n6Z7Q ($6.75 in chips) 
Seat 5: uJlzv9KL7hgCIqIS2ofoaw ($13.65 in chips) 
Seat 6: z5GxcHlYz/GSz6W2uFiTtg ($23.80 in chips) 
Seat 7: UbybWqarUDNRYlbnju2UUQ ($19.50 in chips) 
Seat 8: M2aiKD/Q1d8lySUIbBxeGg ($36.40 in chips) 
Seat 9: MOlR9YEgKTKLerVIDf8U7w ($48.75 in chips) 
V6p0jQ/RhUsqpHLmXvEX4Q will be allowed to play after the button
rXm4QDVJt67H20lM6n6Z7Q: posts small blind $0.10
uJlzv9KL7hgCIqIS2ofoaw: posts big blind $0.25
*** HOLE CARDS ***
z5GxcHlYz/GSz6W2uFiTtg: folds 
UbybWqarUDNRYlbnju2UUQ: folds 
M2aiKD/Q1d8lySUIbBxeGg: folds 
MOlR9YEgKTKLerVIDf8U7w: folds 
GTcLfsDTPqgfHyhY9FNDMw: folds 
SXqVW4Q0evTUVZG6BbUNIA: folds 
rXm4QDVJt67H20lM6n6Z7Q: calls $0.15
uJlzv9KL7hgCIqIS2ofoaw: raises $0.75 to $1
rXm4QDVJt67H20lM6n6Z7Q: folds 
Uncalled bet ($0.75) returned to uJlzv9KL7hgCIqIS2ofoaw
uJlzv9KL7hgCIqIS2ofoaw collected $0.50 from pot
uJlzv9KL7hgCIqIS2ofoaw: doesn't show hand 
*** SUMMARY ***
Total pot $0.50 | Rake $0 
Seat 1: GTcLfsDTPqgfHyhY9FNDMw folded before Flop (didn't bet)
Seat 2: SXqVW4Q0evTUVZG6BbUNIA (button) folded before Flop (didn't bet)
Seat 4: rXm4QDVJt67H20lM6n6Z7Q (small blind) folded before Flop
Seat 5: uJlzv9KL7hgCIqIS2ofoaw (big blind) collected ($0.50)
Seat 6: z5GxcHlYz/GSz6W2uFiTtg folded before Flop (didn't bet)
Seat 7: UbybWqarUDNRYlbnju2UUQ folded before Flop (didn't bet)
Seat 8: M2aiKD/Q1d8lySUIbBxeGg folded before Flop (didn't bet)
Seat 9: MOlR9YEgKTKLerVIDf8U7w folded before Flop (didn't bet)




PokerStars Game #59939453570:  Hold'em No Limit ($0.10/$0.25) - 2009/07/01 0:40:16 ET
Table 'eOXPe2c6mG7DOFKvMsZZfA' 6-max Seat #1 is the button
Seat 1: ShXPHWfjhfmAwLgDdm6bRQ ($7.65 in chips) 
Seat 2: ELW+DKizJhLK7k40PMkD2Q ($32.85 in chips) 
Seat 3: kReyZ6g6Fu3tQ0nyjDf9kA ($16.30 in chips) 
Seat 4: zHHLkD2sRljslKKeQv/ZQw ($42.65 in chips) 
Seat 5: NhUN/JpAprdJeamFBgJH1w ($25 in chips) 
Seat 6: wKFJ513ucluNNiMlkXcDOQ ($40.80 in chips) 
ELW+DKizJhLK7k40PMkD2Q: posts small blind $0.10
kReyZ6g6Fu3tQ0nyjDf9kA: posts big blind $0.25
*** HOLE CARDS ***
zHHLkD2sRljslKKeQv/ZQw: calls $0.25
NhUN/JpAprdJeamFBgJH1w: folds 
wKFJ513ucluNNiMlkXcDOQ: raises $1 to $1.25
ShXPHWfjhfmAwLgDdm6bRQ: folds 
ELW+DKizJhLK7k40PMkD2Q: folds 
kReyZ6g6Fu3tQ0nyjDf9kA: raises $1.50 to $2.75
zHHLkD2sRljslKKeQv/ZQw: folds 
wKFJ513ucluNNiMlkXcDOQ: calls $1.50
*** FLOP *** [8h 4h 7c]
kReyZ6g6Fu3tQ0nyjDf9kA: bets $13.55 and is all-in
wKFJ513ucluNNiMlkXcDOQ: calls $13.55
*** TURN *** [8h 4h 7c] [9d]
*** RIVER *** [8h 4h 7c 9d] [8c]
*** SHOW DOWN ***
kReyZ6g6Fu3tQ0nyjDf9kA: shows [As Ah] (two pair, Aces and Eights)
wKFJ513ucluNNiMlkXcDOQ: mucks hand 
kReyZ6g6Fu3tQ0nyjDf9kA collected $31.35 from pot
*** SUMMARY ***
Total pot $32.95 | Rake $1.60 
Board [8h 4h 7c 9d 8c]
Seat 1: ShXPHWfjhfmAwLgDdm6bRQ (button) folded before Flop (didn't bet)
Seat 2: ELW+DKizJhLK7k40PMkD2Q (small blind) folded before Flop
Seat 3: kReyZ6g6Fu3tQ0nyjDf9kA (big blind) showed [As Ah] and won ($31.35) with two pair, Aces and Eights
Seat 4: zHHLkD2sRljslKKeQv/ZQw folded before Flop
Seat 5: NhUN/JpAprdJeamFBgJH1w folded before Flop (didn't bet)
Seat 6: wKFJ513ucluNNiMlkXcDOQ mucked




PokerStars Game #59939453686:  Hold'em No Limit ($0.10/$0.25) - 2009/07/01 0:40:16 ET
Table 'nteM56rtr9SxLEblf0fvbw' 9-max Seat #5 is the button
Seat 1: H9KUl8cmpLgEpOVDA00bCg ($5 in chips) 
Seat 2: ljemhp25Zg+nlA9DLCIiUw ($25.95 in chips) 
Seat 4: cZ99hugmLBj9KhTlc8nCSw ($25.15 in chips) 
Seat 5: aJy680tKSaP5er559aSuGA ($9.95 in chips) 
Seat 7: dfNim92Z6XK1/h5SFW5vDg ($49.40 in chips) 
Seat 8: RJ/x9oZtt1RZLaJEQwZOxQ ($44.15 in chips) 
Seat 9: t2nb95S5EEFOEzNx9Itz0g ($6.90 in chips) 
dfNim92Z6XK1/h5SFW5vDg: posts small blind $0.10
RJ/x9oZtt1RZLaJEQwZOxQ: posts big blind $0.25
*** HOLE CARDS ***
t2nb95S5EEFOEzNx9Itz0g: folds 
H9KUl8cmpLgEpOVDA00bCg: folds 
ljemhp25Zg+nlA9DLCIiUw: folds 
cZ99hugmLBj9KhTlc8nCSw: raises $0.50 to $0.75
aJy680tKSaP5er559aSuGA: folds 
dfNim92Z6XK1/h5SFW5vDg: folds 
RJ/x9oZtt1RZLaJEQwZOxQ: folds 
Uncalled bet ($0.50) returned to cZ99hugmLBj9KhTlc8nCSw
cZ99hugmLBj9KhTlc8nCSw collected $0.60 from pot
*** SUMMARY ***
Total pot $0.60 | Rake $0 
Seat 1: H9KUl8cmpLgEpOVDA00bCg folded before Flop (didn't bet)
Seat 2: ljemhp25Zg+nlA9DLCIiUw folded before Flop (didn't bet)
Seat 4: cZ99hugmLBj9KhTlc8nCSw collected ($0.60)
Seat 5: aJy680tKSaP5er559aSuGA (button) folded before Flop (didn't bet)
Seat 7: dfNim92Z6XK1/h5SFW5vDg (small blind) folded before Flop
Seat 8: RJ/x9oZtt1RZLaJEQwZOxQ (big blind) folded before Flop
Seat 9: t2nb95S5EEFOEzNx9Itz0g folded before Flop (didn't bet)




PokerStars Game #59939453788:  Hold'em No Limit ($0.10/$0.25) - 2009/07/01 0:40:16 ET
Table 'vFZR6Kf2Th5xBXT9brGW6A' 6-max Seat #1 is the button
Seat 1: xRkU4+naLuz7dEZFbOn9cw ($34.95 in chips) 
Seat 2: REnO5xiZ66YabxDXq2ncvA ($51.45 in chips) 
Seat 4: 79ID/ub1Pt/mDpCprVmOoA ($25 in chips) 
Seat 5: NhUN/JpAprdJeamFBgJH1w ($25.35 in chips) 
Seat 6: d0J1xuhsynEY81YHwAvJ5g ($30.10 in chips) 
REnO5xiZ66YabxDXq2ncvA: posts small blind $0.10
79ID/ub1Pt/mDpCprVmOoA: posts big blind $0.25
*** HOLE CARDS ***
NhUN/JpAprdJeamFBgJH1w: folds 
d0J1xuhsynEY81YHwAvJ5g: folds 
xRkU4+naLuz7dEZFbOn9cw: folds 
REnO5xiZ66YabxDXq2ncvA: calls $0.15
79ID/ub1Pt/mDpCprVmOoA: checks 
*** FLOP *** [4h 7c Kc]
REnO5xiZ66YabxDXq2ncvA: bets $0.50
79ID/ub1Pt/mDpCprVmOoA: folds 
Uncalled bet ($0.50) returned to REnO5xiZ66YabxDXq2ncvA
REnO5xiZ66YabxDXq2ncvA collected $0.50 from pot
*** SUMMARY ***
Total pot $0.50 | Rake $0 
Board [4h 7c Kc]
Seat 1: xRkU4+naLuz7dEZFbOn9cw (button) folded before Flop (didn't bet)
Seat 2: REnO5xiZ66YabxDXq2ncvA (small blind) collected ($0.50)
Seat 4: 79ID/ub1Pt/mDpCprVmOoA (big blind) folded on the Flop
Seat 5: NhUN/JpAprdJeamFBgJH1w folded before Flop (didn't bet)
Seat 6: d0J1xuhsynEY81YHwAvJ5g folded before Flop (didn't bet)




PokerStars Game #59939454442:  Hold'em No Limit ($0.10/$0.25) - 2009/07/01 0:40:17 ET
Table 'KTZXQ4LREPjpS54R3DFTsw' 9-max Seat #1 is the button
Seat 1: dSjkBIV7Bv+ZCIWNBguf7w ($23 in chips) 
Seat 2: hQgb9iRlpctfdl51mltYlw ($29.10 in chips) 
Seat 3: N6fYvIzQLKaydFLKQGtMlQ ($37.45 in chips) 
Seat 5: HPEB+AtKw1+C/cxU0o1ciw ($31.60 in chips) 
Seat 6: 1q23ISSsSMhv2lHXBfj9/A ($23.50 in chips) 
Seat 8: s++YekTPLdOGgNR0tlMkdA ($9.45 in chips) 
Seat 9: E4pjUoTJmJNmancGXn1nSw ($18.25 in chips) 
hQgb9iRlpctfdl51mltYlw: posts small blind $0.10
N6fYvIzQLKaydFLKQGtMlQ: posts big blind $0.25
yyG4svzOpC1A+sUP/scg6w: sits out 
*** HOLE CARDS ***
HPEB+AtKw1+C/cxU0o1ciw: folds 
1q23ISSsSMhv2lHXBfj9/A: folds 
s++YekTPLdOGgNR0tlMkdA: raises $1.25 to $1.50
E4pjUoTJmJNmancGXn1nSw: folds 
dSjkBIV7Bv+ZCIWNBguf7w: calls $1.50
hQgb9iRlpctfdl51mltYlw: calls $1.40
N6fYvIzQLKaydFLKQGtMlQ: calls $1.25
*** FLOP *** [Ad Ts 3h]
hQgb9iRlpctfdl51mltYlw: checks 
N6fYvIzQLKaydFLKQGtMlQ: checks 
s++YekTPLdOGgNR0tlMkdA: checks 
dSjkBIV7Bv+ZCIWNBguf7w: bets $1.25
hQgb9iRlpctfdl51mltYlw: folds 
N6fYvIzQLKaydFLKQGtMlQ: folds 
s++YekTPLdOGgNR0tlMkdA: calls $1.25
*** TURN *** [Ad Ts 3h] [3d]
s++YekTPLdOGgNR0tlMkdA: checks 
dSjkBIV7Bv+ZCIWNBguf7w: bets $1.25
s++YekTPLdOGgNR0tlMkdA: calls $1.25
*** RIVER *** [Ad Ts 3h 3d] [4s]
s++YekTPLdOGgNR0tlMkdA: bets $1.25
dSjkBIV7Bv+ZCIWNBguf7w: calls $1.25
*** SHOW DOWN ***
s++YekTPLdOGgNR0tlMkdA: shows [Qs Qc] (two pair, Queens and Threes)
dSjkBIV7Bv+ZCIWNBguf7w: shows [Ah Kc] (two pair, Aces and Threes)
dSjkBIV7Bv+ZCIWNBguf7w collected $12.85 from pot
K0b5wNInj6hUGRr6yzKFtw has returned
*** SUMMARY ***
Total pot $13.50 | Rake $0.65 
Board [Ad Ts 3h 3d 4s]
Seat 1: dSjkBIV7Bv+ZCIWNBguf7w (button) showed [Ah Kc] and won ($12.85) with two pair, Aces and Threes
Seat 2: hQgb9iRlpctfdl51mltYlw (small blind) folded on the Flop
Seat 3: N6fYvIzQLKaydFLKQGtMlQ (big blind) folded on the Flop
Seat 5: HPEB+AtKw1+C/cxU0o1ciw folded before Flop (didn't bet)
Seat 6: 1q23ISSsSMhv2lHXBfj9/A folded before Flop (didn't bet)
Seat 8: s++YekTPLdOGgNR0tlMkdA showed [Qs Qc] and lost with two pair, Queens and Threes
Seat 9: E4pjUoTJmJNmancGXn1nSw folded before Flop (didn't bet)




PokerStars Game #59939453946:  Hold'em No Limit ($0.10/$0.25) - 2009/07/01 0:40:17 ET
Table 'QegsWX65l3n/K0A8XB78yg' 6-max Seat #3 is the button
Seat 1: 8ClCHtFXGNplITm+63KB+Q ($29.30 in chips) 
Seat 2: GC/9yVD59DUCX7hUI7gcLw ($32.20 in chips) 
Seat 3: 9jSiy0meE9XJKkdIZwyTEQ ($25 in chips) 
Seat 4: kyRaCIljYA6l33lSKQfNsg ($24.75 in chips) 
Seat 5: 4YSTu0Cdzpppe1lUgCZGCQ ($56.25 in chips) 
Seat 6: JE/wJXmjw3bpdmjwvh2pcg ($37.50 in chips) 
kyRaCIljYA6l33lSKQfNsg: posts small blind $0.10
4YSTu0Cdzpppe1lUgCZGCQ: posts big blind $0.25
*** HOLE CARDS ***
JE/wJXmjw3bpdmjwvh2pcg: folds 
8ClCHtFXGNplITm+63KB+Q: folds 
GC/9yVD59DUCX7hUI7gcLw: raises $0.75 to $1
9jSiy0meE9XJKkdIZwyTEQ: folds 
kyRaCIljYA6l33lSKQfNsg: folds 
4YSTu0Cdzpppe1lUgCZGCQ: folds 
Uncalled bet ($0.75) returned to GC/9yVD59DUCX7hUI7gcLw
GC/9yVD59DUCX7hUI7gcLw collected $0.60 from pot
*** SUMMARY ***
Total pot $0.60 | Rake $0 
Seat 1: 8ClCHtFXGNplITm+63KB+Q folded before Flop (didn't bet)
Seat 2: GC/9yVD59DUCX7hUI7gcLw collected ($0.60)
Seat 3: 9jSiy0meE9XJKkdIZwyTEQ (button) folded before Flop (didn't bet)
Seat 4: kyRaCIljYA6l33lSKQfNsg (small blind) folded before Flop
Seat 5: 4YSTu0Cdzpppe1lUgCZGCQ (big blind) folded before Flop
Seat 6: JE/wJXmjw3bpdmjwvh2pcg folded before Flop (didn't bet)




PokerStars Game #59939454182:  Hold'em No Limit ($0.10/$0.25) - 2009/07/01 0:40:17 ET
Table 'hfHe8uKeSJMyWAjSdM7ROQ' 6-max Seat #5 is the button
Seat 1: eHsmIvAb2JREg4O6hNPnXg ($18.75 in chips) 
Seat 2: rnpAao581IcvQglpkpnkoQ ($7.05 in chips) 
Seat 3: og6TUWcndKo5oTDQjnQfjw ($29.70 in chips) 
Seat 4: iAfYkegiTr9eE85LoKmEgA ($7.60 in chips) 
Seat 5: euswrBD1XG0Q5hB1iGJBKQ ($24.45 in chips) 
Seat 6: SFmT9ZsVopnukjvAzrxTRg ($25 in chips) 
SFmT9ZsVopnukjvAzrxTRg: posts small blind $0.10
eHsmIvAb2JREg4O6hNPnXg: posts big blind $0.25
*** HOLE CARDS ***
rnpAao581IcvQglpkpnkoQ: folds 
og6TUWcndKo5oTDQjnQfjw: raises $0.50 to $0.75
iAfYkegiTr9eE85LoKmEgA: folds 
euswrBD1XG0Q5hB1iGJBKQ: folds 
SFmT9ZsVopnukjvAzrxTRg: folds 
eHsmIvAb2JREg4O6hNPnXg: calls $0.50
*** FLOP *** [Jh 2c Jc]
eHsmIvAb2JREg4O6hNPnXg: checks 
og6TUWcndKo5oTDQjnQfjw: bets $0.75
eHsmIvAb2JREg4O6hNPnXg: folds 
Uncalled bet ($0.75) returned to og6TUWcndKo5oTDQjnQfjw
og6TUWcndKo5oTDQjnQfjw collected $1.55 from pot
og6TUWcndKo5oTDQjnQfjw: doesn't show hand 
*** SUMMARY ***
Total pot $1.60 | Rake $0.05 
Board [Jh 2c Jc]
Seat 1: eHsmIvAb2JREg4O6hNPnXg (big blind) folded on the Flop
Seat 2: rnpAao581IcvQglpkpnkoQ folded before Flop (didn't bet)
Seat 3: og6TUWcndKo5oTDQjnQfjw collected ($1.55)
Seat 4: iAfYkegiTr9eE85LoKmEgA folded before Flop (didn't bet)
Seat 5: euswrBD1XG0Q5hB1iGJBKQ (button) folded before Flop (didn't bet)
Seat 6: SFmT9ZsVopnukjvAzrxTRg (small blind) folded before Flop




PokerStars Game #59939454406:  Hold'em No Limit ($0.10/$0.25) - 2009/07/01 0:40:17 ET
Table 'zhqgUUprOJ14VxKxPHcT/Q' 9-max Seat #3 is the button
Seat 3: G2offPrpnppc++nuXqs2JA ($16.90 in chips) 
Seat 4: EfeOSXE8Wc4WWEsgc3WzZg ($8.30 in chips) 
Seat 5: +sbyWwIcFp9kP0bDtMegfQ ($26.75 in chips) 
Seat 6: DIBbjEYGs+TVdVgEB/4+3w ($23.10 in chips) 
Seat 8: amD2PwT1xB7aC2k57sa7Ig ($29.20 in chips) 
Seat 9: 4awUyiDYTgylQKXZ9faBVA ($36.10 in chips) 
EfeOSXE8Wc4WWEsgc3WzZg: posts small blind $0.10
+sbyWwIcFp9kP0bDtMegfQ: posts big blind $0.25
*** HOLE CARDS ***
DIBbjEYGs+TVdVgEB/4+3w: folds 
amD2PwT1xB7aC2k57sa7Ig: folds 
4awUyiDYTgylQKXZ9faBVA: folds 
q9qPRjJC40e/Q9yuT+glwQ leaves the table
G2offPrpnppc++nuXqs2JA: folds 
EfeOSXE8Wc4WWEsgc3WzZg: folds 
Uncalled bet ($0.15) returned to +sbyWwIcFp9kP0bDtMegfQ
+sbyWwIcFp9kP0bDtMegfQ collected $0.20 from pot
+sbyWwIcFp9kP0bDtMegfQ: doesn't show hand 
*** SUMMARY ***
Total pot $0.20 | Rake $0 
Seat 3: G2offPrpnppc++nuXqs2JA (button) folded before Flop (didn't bet)
Seat 4: EfeOSXE8Wc4WWEsgc3WzZg (small blind) folded before Flop
Seat 5: +sbyWwIcFp9kP0bDtMegfQ (big blind) collected ($0.20)
Seat 6: DIBbjEYGs+TVdVgEB/4+3w folded before Flop (didn't bet)
Seat 8: amD2PwT1xB7aC2k57sa7Ig folded before Flop (didn't bet)
Seat 9: 4awUyiDYTgylQKXZ9faBVA folded before Flop (didn't bet)




PokerStars Game #59939453980:  Hold'em No Limit ($0.10/$0.25) - 2009/07/01 0:40:17 ET
Table 'hOE09W281uSob0XeJmUcRg' 6-max Seat #5 is the button
Seat 1: edio/rLJ06xeZOfLhoL3UA ($15.35 in chips) 
Seat 4: TslQs7AQSLbVtr4X8JOOOQ ($19.55 in chips) 
Seat 5: 66a/8+qw1AZLNh63FuclPA ($101 in chips) 
Seat 6: x4ZJ8E/TUrtoB7WiHcv8WA ($10.60 in chips) 
x4ZJ8E/TUrtoB7WiHcv8WA: posts small blind $0.10
edio/rLJ06xeZOfLhoL3UA: posts big blind $0.25
*** HOLE CARDS ***
TslQs7AQSLbVtr4X8JOOOQ: folds 
66a/8+qw1AZLNh63FuclPA: folds 
x4ZJ8E/TUrtoB7WiHcv8WA: raises $0.50 to $0.75
edio/rLJ06xeZOfLhoL3UA: raises $1.50 to $2.25
x4ZJ8E/TUrtoB7WiHcv8WA: calls $1.50
*** FLOP *** [5c 6d Qh]
x4ZJ8E/TUrtoB7WiHcv8WA: checks 
edio/rLJ06xeZOfLhoL3UA: bets $2.75
x4ZJ8E/TUrtoB7WiHcv8WA: folds 
Uncalled bet ($2.75) returned to edio/rLJ06xeZOfLhoL3UA
edio/rLJ06xeZOfLhoL3UA collected $4.30 from pot
edio/rLJ06xeZOfLhoL3UA: doesn't show hand 
*** SUMMARY ***
Total pot $4.50 | Rake $0.20 
Board [5c 6d Qh]
Seat 1: edio/rLJ06xeZOfLhoL3UA (big blind) collected ($4.30)
Seat 4: TslQs7AQSLbVtr4X8JOOOQ folded before Flop (didn't bet)
Seat 5: 66a/8+qw1AZLNh63FuclPA (button) folded before Flop (didn't bet)
Seat 6: x4ZJ8E/TUrtoB7WiHcv8WA (small blind) folded on the Flop




PokerStars Game #59939454292:  Hold'em No Limit ($0.10/$0.25) - 2009/07/01 0:40:17 ET
Table 'NfXsh0UQA+o/kO9acV3WxA' 9-max Seat #6 is the button
Seat 1: H5Se03ZqSX7tbULXur2MAg ($24.30 in chips) 
Seat 2: 5/P8XWKnr8tBG9c+iHgFNA ($24 in chips) 
Seat 3: 1K6QGyJP9P9xmRac2fH4OQ ($37.45 in chips) 
Seat 4: sQ6szDwWrE+LMh1p4dVexA ($17.10 in chips) 
Seat 5: 3RCAkueG3Vc13VpRStCB+w ($36.75 in chips) 
Seat 6: jMfnkiGgGZI43Vhowb6MpA ($12.55 in chips) 
Seat 7: HPEB+AtKw1+C/cxU0o1ciw ($31.70 in chips) 
Seat 8: +sbyWwIcFp9kP0bDtMegfQ ($25 in chips) 
Seat 9: MgMavn/DzTzqKgHTZMsVSw ($25 in chips) 
HPEB+AtKw1+C/cxU0o1ciw: posts small blind $0.10
+sbyWwIcFp9kP0bDtMegfQ: posts big blind $0.25
*** HOLE CARDS ***
MgMavn/DzTzqKgHTZMsVSw: folds 
H5Se03ZqSX7tbULXur2MAg: folds 
5/P8XWKnr8tBG9c+iHgFNA: calls $0.25
1K6QGyJP9P9xmRac2fH4OQ: folds 
sQ6szDwWrE+LMh1p4dVexA: folds 
3RCAkueG3Vc13VpRStCB+w: raises $0.50 to $0.75
jMfnkiGgGZI43Vhowb6MpA: folds 
jMfnkiGgGZI43Vhowb6MpA is sitting out
HPEB+AtKw1+C/cxU0o1ciw: folds 
+sbyWwIcFp9kP0bDtMegfQ: folds 
5/P8XWKnr8tBG9c+iHgFNA: calls $0.50
*** FLOP *** [Jd 7h Ks]
5/P8XWKnr8tBG9c+iHgFNA: checks 
3RCAkueG3Vc13VpRStCB+w: bets $1.25
5/P8XWKnr8tBG9c+iHgFNA: folds 
Uncalled bet ($1.25) returned to 3RCAkueG3Vc13VpRStCB+w
3RCAkueG3Vc13VpRStCB+w collected $1.80 from pot
3RCAkueG3Vc13VpRStCB+w: doesn't show hand 
*** SUMMARY ***
Total pot $1.85 | Rake $0.05 
Board [Jd 7h Ks]
Seat 1: H5Se03ZqSX7tbULXur2MAg folded before Flop (didn't bet)
Seat 2: 5/P8XWKnr8tBG9c+iHgFNA folded on the Flop
Seat 3: 1K6QGyJP9P9xmRac2fH4OQ folded before Flop (didn't bet)
Seat 4: sQ6szDwWrE+LMh1p4dVexA folded before Flop (didn't bet)
Seat 5: 3RCAkueG3Vc13VpRStCB+w collected ($1.80)
Seat 6: jMfnkiGgGZI43Vhowb6MpA (button) folded before Flop (didn't bet)
Seat 7: HPEB+AtKw1+C/cxU0o1ciw (small blind) folded before Flop
Seat 8: +sbyWwIcFp9kP0bDtMegfQ (big blind) folded before Flop
Seat 9: MgMavn/DzTzqKgHTZMsVSw folded before Flop (didn't bet)




PokerStars Game #59939453890:  Hold'em No Limit ($0.10/$0.25) - 2009/07/01 0:40:17 ET
Table 'MQJMxKDF6VYBWIKv7VfCog' 9-max Seat #7 is the button
Seat 1: cZ99hugmLBj9KhTlc8nCSw ($26.15 in chips) 
Seat 2: JxpnpCmvRAcrEUy7mq1iAg ($5.20 in chips) 
Seat 3: EfRs3ibIxn+c9JDErwwNCg ($26.40 in chips) 
Seat 4: JtVGnq5doRa3PublncR+Yw ($24.25 in chips) 
Seat 5: RJ/x9oZtt1RZLaJEQwZOxQ ($25.60 in chips) 
Seat 6: ydoFOVgzvZv9ZhuWu9rXAw ($4.90 in chips) 
Seat 7: dfNim92Z6XK1/h5SFW5vDg ($52.95 in chips) 
Seat 8: Z9AeOQX3yzuSvKAm/xyovg ($9.40 in chips) 
Seat 9: 1S/fpm+f42V/6MNZre+ccg ($36.25 in chips) 
Z9AeOQX3yzuSvKAm/xyovg: posts small blind $0.10
1S/fpm+f42V/6MNZre+ccg: posts big blind $0.25
*** HOLE CARDS ***
cZ99hugmLBj9KhTlc8nCSw: folds 
JxpnpCmvRAcrEUy7mq1iAg: folds 
EfRs3ibIxn+c9JDErwwNCg: folds 
JtVGnq5doRa3PublncR+Yw: folds 
RJ/x9oZtt1RZLaJEQwZOxQ: folds 
ydoFOVgzvZv9ZhuWu9rXAw: folds 
dfNim92Z6XK1/h5SFW5vDg: folds 
Z9AeOQX3yzuSvKAm/xyovg: folds 
Uncalled bet ($0.15) returned to 1S/fpm+f42V/6MNZre+ccg
1S/fpm+f42V/6MNZre+ccg collected $0.20 from pot
1S/fpm+f42V/6MNZre+ccg: doesn't show hand 
*** SUMMARY ***
Total pot $0.20 | Rake $0 
Seat 1: cZ99hugmLBj9KhTlc8nCSw folded before Flop (didn't bet)
Seat 2: JxpnpCmvRAcrEUy7mq1iAg folded before Flop (didn't bet)
Seat 3: EfRs3ibIxn+c9JDErwwNCg folded before Flop (didn't bet)
Seat 4: JtVGnq5doRa3PublncR+Yw folded before Flop (didn't bet)
Seat 5: RJ/x9oZtt1RZLaJEQwZOxQ folded before Flop (didn't bet)
Seat 6: ydoFOVgzvZv9ZhuWu9rXAw folded before Flop (didn't bet)
Seat 7: dfNim92Z6XK1/h5SFW5vDg (button) folded before Flop (didn't bet)
Seat 8: Z9AeOQX3yzuSvKAm/xyovg (small blind) folded before Flop
Seat 9: 1S/fpm+f42V/6MNZre+ccg (big blind) collected ($0.20)




PokerStars Game #59939453982:  Hold'em No Limit ($0.10/$0.25) - 2009/07/01 0:40:17 ET
Table 'dVzscin98UhGisTmV9BDcw' 9-max Seat #5 is the button
Seat 1: sBAwXpkpgyhyWbHIQcIJKA ($19.45 in chips) 
Seat 2: dfNim92Z6XK1/h5SFW5vDg ($29.15 in chips) 
Seat 3: 1Clf3cPrqoy/YgvWdWK1Xw ($5.25 in chips) 
Seat 4: aNpwfA31EREwO+ar4XzBCw ($25.25 in chips) 
Seat 5: ZMRQOoxoJ7Alx96gZhP2EQ ($65.45 in chips) 
Seat 6: hBMUlEpyU74r/fwDgIpXjQ ($25 in chips) 
Seat 7: nEg1b6MIksd/4x5eLY735g ($62.90 in chips) 
Seat 8: /vn2Qu2dvc9AMMq46Ae0jA ($5.70 in chips) 
Seat 9: OYa/ZJBO+suuezfWsUMhZw ($5.80 in chips) 
hBMUlEpyU74r/fwDgIpXjQ: posts small blind $0.10
nEg1b6MIksd/4x5eLY735g: posts big blind $0.25
*** HOLE CARDS ***
/vn2Qu2dvc9AMMq46Ae0jA: folds 
OYa/ZJBO+suuezfWsUMhZw: folds 
sBAwXpkpgyhyWbHIQcIJKA: folds 
dfNim92Z6XK1/h5SFW5vDg: folds 
1Clf3cPrqoy/YgvWdWK1Xw: folds 
aNpwfA31EREwO+ar4XzBCw: folds 
ZMRQOoxoJ7Alx96gZhP2EQ: raises $0.50 to $0.75
hBMUlEpyU74r/fwDgIpXjQ: raises $1.50 to $2.25
nEg1b6MIksd/4x5eLY735g: calls $2
ZMRQOoxoJ7Alx96gZhP2EQ: folds 
*** FLOP *** [7d 6s 3c]
hBMUlEpyU74r/fwDgIpXjQ: bets $3
nEg1b6MIksd/4x5eLY735g: folds 
Uncalled bet ($3) returned to hBMUlEpyU74r/fwDgIpXjQ
hBMUlEpyU74r/fwDgIpXjQ collected $5 from pot
hBMUlEpyU74r/fwDgIpXjQ: doesn't show hand 
*** SUMMARY ***
Total pot $5.25 | Rake $0.25 
Board [7d 6s 3c]
Seat 1: sBAwXpkpgyhyWbHIQcIJKA folded before Flop (didn't bet)
Seat 2: dfNim92Z6XK1/h5SFW5vDg folded before Flop (didn't bet)
Seat 3: 1Clf3cPrqoy/YgvWdWK1Xw folded before Flop (didn't bet)
Seat 4: aNpwfA31EREwO+ar4XzBCw folded before Flop (didn't bet)
Seat 5: ZMRQOoxoJ7Alx96gZhP2EQ (button) folded before Flop
Seat 6: hBMUlEpyU74r/fwDgIpXjQ (small blind) collected ($5)
Seat 7: nEg1b6MIksd/4x5eLY735g (big blind) folded on the Flop
Seat 8: /vn2Qu2dvc9AMMq46Ae0jA folded before Flop (didn't bet)
Seat 9: OYa/ZJBO+suuezfWsUMhZw folded before Flop (didn't bet)




PokerStars Game #59939454936:  Hold'em No Limit ($0.10/$0.25) - 2009/07/01 0:40:18 ET
Table '8QBBaev+cI2i/r2H6ml/lg' 9-max Seat #4 is the button
Seat 4: ZoG0obuajzVjwgd7lNHjgg ($2.15 in chips) 
Seat 9: Ml2bY77EHbM51ZWD7dnIWg ($3.25 in chips) 
ZoG0obuajzVjwgd7lNHjgg: posts small blind $0.10
Ml2bY77EHbM51ZWD7dnIWg: posts big blind $0.25
*** HOLE CARDS ***
ZoG0obuajzVjwgd7lNHjgg: raises $0.50 to $0.75
Ml2bY77EHbM51ZWD7dnIWg: folds 
Uncalled bet ($0.50) returned to ZoG0obuajzVjwgd7lNHjgg
ZoG0obuajzVjwgd7lNHjgg collected $0.50 from pot
*** SUMMARY ***
Total pot $0.50 | Rake $0 
Seat 4: ZoG0obuajzVjwgd7lNHjgg (button) (small blind) collected ($0.50)
Seat 9: Ml2bY77EHbM51ZWD7dnIWg (big blind) folded before Flop




PokerStars Game #59939455156:  Hold'em No Limit ($0.10/$0.25) - 2009/07/01 0:40:18 ET
Table '3eK1r4Q4BSYFvsKkuTLpIA' 9-max Seat #1 is the button
Seat 1: qwr38jl5txoR36M7G5qi4A ($7.75 in chips) 
Seat 2: 7QzbjWT00wQpau1iqvUmMA ($4.75 in chips) 
Seat 3: 56S3mA6Zs3pGR+0p0vUCtg ($33.55 in chips) 
Seat 4: S2iyN4Q7njjhguIuE5g1CQ ($22.95 in chips) 
Seat 5: 1K6QGyJP9P9xmRac2fH4OQ ($31.90 in chips) 
Seat 6: +HvCCmsGSQeatf+GZ9zk8Q ($18.75 in chips) 
Seat 7: GTcLfsDTPqgfHyhY9FNDMw ($8 in chips) 
Seat 8: Cni99AOp8W/F0ZWCuHNcIA ($12.65 in chips) 
Seat 9: +sbyWwIcFp9kP0bDtMegfQ ($37.75 in chips) 
7QzbjWT00wQpau1iqvUmMA: posts small blind $0.10
56S3mA6Zs3pGR+0p0vUCtg: posts big blind $0.25
*** HOLE CARDS ***
S2iyN4Q7njjhguIuE5g1CQ: calls $0.25
1K6QGyJP9P9xmRac2fH4OQ: folds 
+HvCCmsGSQeatf+GZ9zk8Q: folds 
GTcLfsDTPqgfHyhY9FNDMw: folds 
Cni99AOp8W/F0ZWCuHNcIA: folds 
+sbyWwIcFp9kP0bDtMegfQ: folds 
qwr38jl5txoR36M7G5qi4A: folds 
7QzbjWT00wQpau1iqvUmMA: folds 
56S3mA6Zs3pGR+0p0vUCtg: checks 
*** FLOP *** [Ks Qh 9d]
56S3mA6Zs3pGR+0p0vUCtg: checks 
S2iyN4Q7njjhguIuE5g1CQ: bets $0.25
56S3mA6Zs3pGR+0p0vUCtg: calls $0.25
*** TURN *** [Ks Qh 9d] [4h]
56S3mA6Zs3pGR+0p0vUCtg: checks 
S2iyN4Q7njjhguIuE5g1CQ: bets $0.75
56S3mA6Zs3pGR+0p0vUCtg: calls $0.75
*** RIVER *** [Ks Qh 9d 4h] [8c]
56S3mA6Zs3pGR+0p0vUCtg: checks 
S2iyN4Q7njjhguIuE5g1CQ: bets $1.25
56S3mA6Zs3pGR+0p0vUCtg: calls $1.25
*** SHOW DOWN ***
S2iyN4Q7njjhguIuE5g1CQ: shows [Kc 9s] (two pair, Kings and Nines)
56S3mA6Zs3pGR+0p0vUCtg: mucks hand 
S2iyN4Q7njjhguIuE5g1CQ collected $4.85 from pot
*** SUMMARY ***
Total pot $5.10 | Rake $0.25 
Board [Ks Qh 9d 4h 8c]
Seat 1: qwr38jl5txoR36M7G5qi4A (button) folded before Flop (didn't bet)
Seat 2: 7QzbjWT00wQpau1iqvUmMA (small blind) folded before Flop
Seat 3: 56S3mA6Zs3pGR+0p0vUCtg (big blind) mucked
Seat 4: S2iyN4Q7njjhguIuE5g1CQ showed [Kc 9s] and won ($4.85) with two pair, Kings and Nines
Seat 5: 1K6QGyJP9P9xmRac2fH4OQ folded before Flop (didn't bet)
Seat 6: +HvCCmsGSQeatf+GZ9zk8Q folded before Flop (didn't bet)
Seat 7: GTcLfsDTPqgfHyhY9FNDMw folded before Flop (didn't bet)
Seat 8: Cni99AOp8W/F0ZWCuHNcIA folded before Flop (didn't bet)
Seat 9: +sbyWwIcFp9kP0bDtMegfQ folded before Flop (didn't bet)




PokerStars Game #59939454924:  Hold'em No Limit ($0.10/$0.25) - 2009/07/01 0:40:18 ET
Table '6wawJ+MkkvuC3coG6r+Yhg' 6-max Seat #1 is the button
Seat 1: ELW+DKizJhLK7k40PMkD2Q ($24.90 in chips) 
Seat 2: LtASJ9OlkqGrrUKGQlpGAw ($27.65 in chips) 
Seat 3: KYBwVA7jgmSrbIEbEGElVg ($19.75 in chips) 
Seat 4: cS21pIxRHx5Gt42o7hPZzw ($12.75 in chips) 
Seat 5: A8uIskXJTblhVXWuYr+lkw ($15.15 in chips) 
Seat 6: oOGZlBAhqtG/HczLL/KLRQ ($15.75 in chips) 
LtASJ9OlkqGrrUKGQlpGAw: posts small blind $0.10
KYBwVA7jgmSrbIEbEGElVg: posts big blind $0.25
oOGZlBAhqtG/HczLL/KLRQ: posts small & big blinds $0.35
*** HOLE CARDS ***
cS21pIxRHx5Gt42o7hPZzw: folds 
A8uIskXJTblhVXWuYr+lkw: folds 
oOGZlBAhqtG/HczLL/KLRQ: checks 
ELW+DKizJhLK7k40PMkD2Q: folds 
LtASJ9OlkqGrrUKGQlpGAw: calls $0.15
KYBwVA7jgmSrbIEbEGElVg: raises $0.75 to $1
oOGZlBAhqtG/HczLL/KLRQ: folds 
LtASJ9OlkqGrrUKGQlpGAw: folds 
Uncalled bet ($0.75) returned to KYBwVA7jgmSrbIEbEGElVg
KYBwVA7jgmSrbIEbEGElVg collected $0.85 from pot
*** SUMMARY ***
Total pot $0.85 | Rake $0 
Seat 1: ELW+DKizJhLK7k40PMkD2Q (button) folded before Flop (didn't bet)
Seat 2: LtASJ9OlkqGrrUKGQlpGAw (small blind) folded before Flop
Seat 3: KYBwVA7jgmSrbIEbEGElVg (big blind) collected ($0.85)
Seat 4: cS21pIxRHx5Gt42o7hPZzw folded before Flop (didn't bet)
Seat 5: A8uIskXJTblhVXWuYr+lkw folded before Flop (didn't bet)
Seat 6: oOGZlBAhqtG/HczLL/KLRQ folded before Flop




PokerStars Game #59939454640:  Hold'em No Limit ($0.10/$0.25) - 2009/07/01 0:40:18 ET
Table 'Loy/olZ5qoDOSvX4UTujGg' 6-max Seat #3 is the button
Seat 1: yzFNNFIfC89bBPwpFPx2ow ($28.50 in chips) 
Seat 3: 32YL2ZEp8NT4JB2RVM9euQ ($15.65 in chips) 
Seat 4: /gJNBeCkWL4o85/jvlZ4BA ($27.20 in chips) 
Seat 5: 4YSTu0Cdzpppe1lUgCZGCQ ($35.50 in chips) 
Seat 6: 7FmwVDcdEtxDpHmP4hOXsQ ($52.70 in chips) 
/gJNBeCkWL4o85/jvlZ4BA: posts small blind $0.10
4YSTu0Cdzpppe1lUgCZGCQ: posts big blind $0.25
*** HOLE CARDS ***
7FmwVDcdEtxDpHmP4hOXsQ: folds 
yzFNNFIfC89bBPwpFPx2ow: raises $0.75 to $1
32YL2ZEp8NT4JB2RVM9euQ: folds 
/gJNBeCkWL4o85/jvlZ4BA: folds 
4YSTu0Cdzpppe1lUgCZGCQ: folds 
Uncalled bet ($0.75) returned to yzFNNFIfC89bBPwpFPx2ow
yzFNNFIfC89bBPwpFPx2ow collected $0.60 from pot
yzFNNFIfC89bBPwpFPx2ow: doesn't show hand 
*** SUMMARY ***
Total pot $0.60 | Rake $0 
Seat 1: yzFNNFIfC89bBPwpFPx2ow collected ($0.60)
Seat 3: 32YL2ZEp8NT4JB2RVM9euQ (button) folded before Flop (didn't bet)
Seat 4: /gJNBeCkWL4o85/jvlZ4BA (small blind) folded before Flop
Seat 5: 4YSTu0Cdzpppe1lUgCZGCQ (big blind) folded before Flop
Seat 6: 7FmwVDcdEtxDpHmP4hOXsQ folded before Flop (didn't bet)




PokerStars Game #59939455336:  Hold'em No Limit ($0.10/$0.25) - 2009/07/01 0:40:19 ET
Table 'IIO2q2znuuAXmiZ2qFTcmg' 6-max Seat #3 is the button
Seat 1: nwwpaieDRI0UPyVtChVHOg ($17.75 in chips) 
Seat 2: cS21pIxRHx5Gt42o7hPZzw ($15.55 in chips) 
Seat 3: hiTEr3yrERiQp3zHXRioVw ($14.40 in chips) 
Seat 4: 0HIrwssk0FQvyKULzUTtlg ($9.85 in chips) 
Seat 5: f9iRHw0d+kV7pbTYwF2+2g ($17.80 in chips) 
0HIrwssk0FQvyKULzUTtlg: posts small blind $0.10
f9iRHw0d+kV7pbTYwF2+2g: posts big blind $0.25
*** HOLE CARDS ***
nwwpaieDRI0UPyVtChVHOg: calls $0.25
cS21pIxRHx5Gt42o7hPZzw: folds 
hiTEr3yrERiQp3zHXRioVw: folds 
0HIrwssk0FQvyKULzUTtlg: folds 
f9iRHw0d+kV7pbTYwF2+2g: checks 
*** FLOP *** [6h Th Td]
f9iRHw0d+kV7pbTYwF2+2g: checks 
nwwpaieDRI0UPyVtChVHOg: checks 
*** TURN *** [6h Th Td] [Ad]
f9iRHw0d+kV7pbTYwF2+2g: checks 
nwwpaieDRI0UPyVtChVHOg: bets $0.75
f9iRHw0d+kV7pbTYwF2+2g: folds 
Uncalled bet ($0.75) returned to nwwpaieDRI0UPyVtChVHOg
nwwpaieDRI0UPyVtChVHOg collected $0.60 from pot
*** SUMMARY ***
Total pot $0.60 | Rake $0 
Board [6h Th Td Ad]
Seat 1: nwwpaieDRI0UPyVtChVHOg collected ($0.60)
Seat 2: cS21pIxRHx5Gt42o7hPZzw folded before Flop (didn't bet)
Seat 3: hiTEr3yrERiQp3zHXRioVw (button) folded before Flop (didn't bet)
Seat 4: 0HIrwssk0FQvyKULzUTtlg (small blind) folded before Flop
Seat 5: f9iRHw0d+kV7pbTYwF2+2g (big blind) folded on the Turn




PokerStars Game #59939455702:  Hold'em No Limit ($0.10/$0.25) - 2009/07/01 0:40:19 ET
Table 'Zi9/NqNs3XoL1eWhMCyZyg' 9-max Seat #3 is the button
Seat 2: Th3FldXKQW6hWVVPahaoOQ ($31.05 in chips) 
Seat 3: rUpvA02nErFvZ4yFbDR8XA ($21.65 in chips) 
Seat 4: D3XCkXRktDfPlSguxwfnRA ($13.10 in chips) 
Seat 5: OiV1PWZ3IkN29JlmCcnTwQ ($4.65 in chips) 
Seat 6: b3P5tPsBbrP+aAO9+Ts/Nw ($37.85 in chips) 
Seat 7: qul+IMROTuFj45eWi2Tpvg ($48.40 in chips) 
Seat 9: tYsOBqdU1+x+yFI7zHO7hQ ($31.10 in chips) 
D3XCkXRktDfPlSguxwfnRA: posts small blind $0.10
OiV1PWZ3IkN29JlmCcnTwQ: posts big blind $0.25
opOCI2p6kW0tINuVaAqmcQ: sits out 
*** HOLE CARDS ***
b3P5tPsBbrP+aAO9+Ts/Nw: folds 
qul+IMROTuFj45eWi2Tpvg: raises $0.75 to $1
tYsOBqdU1+x+yFI7zHO7hQ: folds 
Th3FldXKQW6hWVVPahaoOQ: folds 
rUpvA02nErFvZ4yFbDR8XA: folds 
D3XCkXRktDfPlSguxwfnRA: folds 
OiV1PWZ3IkN29JlmCcnTwQ: folds 
Uncalled bet ($0.75) returned to qul+IMROTuFj45eWi2Tpvg
qul+IMROTuFj45eWi2Tpvg collected $0.60 from pot
*** SUMMARY ***
Total pot $0.60 | Rake $0 
Seat 2: Th3FldXKQW6hWVVPahaoOQ folded before Flop (didn't bet)
Seat 3: rUpvA02nErFvZ4yFbDR8XA (button) folded before Flop (didn't bet)
Seat 4: D3XCkXRktDfPlSguxwfnRA (small blind) folded before Flop
Seat 5: OiV1PWZ3IkN29JlmCcnTwQ (big blind) folded before Flop
Seat 6: b3P5tPsBbrP+aAO9+Ts/Nw folded before Flop (didn't bet)
Seat 7: qul+IMROTuFj45eWi2Tpvg collected ($0.60)
Seat 9: tYsOBqdU1+x+yFI7zHO7hQ folded before Flop (didn't bet)




PokerStars Game #59939455452:  Hold'em No Limit ($0.10/$0.25) - 2009/07/01 0:40:19 ET
Table 'NgexmgEDEzICBeSO7YCrKQ' 6-max Seat #5 is the button
Seat 1: oseFhpinoe+Zg4j5xyBjyQ ($71.10 in chips) 
Seat 2: 32YL2ZEp8NT4JB2RVM9euQ ($16 in chips) 
Seat 3: JFIAqU8lCZ0vWwEl4bdGsg ($26.90 in chips) 
Seat 4: xx+iYCDJhHJmNzrfeloyEg ($36.85 in chips) 
Seat 5: /MXkdT8TTs8Qp2LVTQNw6w ($47.10 in chips) 
Seat 6: k9nHZTHt8hYhYRcW8NTb4g ($10.60 in chips) 
k9nHZTHt8hYhYRcW8NTb4g: posts small blind $0.10
oseFhpinoe+Zg4j5xyBjyQ: posts big blind $0.25
*** HOLE CARDS ***
32YL2ZEp8NT4JB2RVM9euQ: folds 
JFIAqU8lCZ0vWwEl4bdGsg: folds 
xx+iYCDJhHJmNzrfeloyEg: folds 
/MXkdT8TTs8Qp2LVTQNw6w said, "sorry bout that, i knew i was beat when i called the turn"
/MXkdT8TTs8Qp2LVTQNw6w: raises $0.75 to $1
k9nHZTHt8hYhYRcW8NTb4g: calls $0.90
oseFhpinoe+Zg4j5xyBjyQ: folds 
*** FLOP *** [3c 6h Jh]
k9nHZTHt8hYhYRcW8NTb4g: checks 
/MXkdT8TTs8Qp2LVTQNw6w: checks 
*** TURN *** [3c 6h Jh] [2c]
k9nHZTHt8hYhYRcW8NTb4g: checks 
/MXkdT8TTs8Qp2LVTQNw6w: checks 
*** RIVER *** [3c 6h Jh 2c] [2s]
k9nHZTHt8hYhYRcW8NTb4g: bets $1
/MXkdT8TTs8Qp2LVTQNw6w: calls $1
*** SHOW DOWN ***
k9nHZTHt8hYhYRcW8NTb4g: shows [Kh Qs] (a pair of Deuces)
/MXkdT8TTs8Qp2LVTQNw6w: shows [9c As] (a pair of Deuces - Ace kicker)
/MXkdT8TTs8Qp2LVTQNw6w collected $4.05 from pot
/MXkdT8TTs8Qp2LVTQNw6w said, "what a call"
*** SUMMARY ***
Total pot $4.25 | Rake $0.20 
Board [3c 6h Jh 2c 2s]
Seat 1: oseFhpinoe+Zg4j5xyBjyQ (big blind) folded before Flop
Seat 2: 32YL2ZEp8NT4JB2RVM9euQ folded before Flop (didn't bet)
Seat 3: JFIAqU8lCZ0vWwEl4bdGsg folded before Flop (didn't bet)
Seat 4: xx+iYCDJhHJmNzrfeloyEg folded before Flop (didn't bet)
Seat 5: /MXkdT8TTs8Qp2LVTQNw6w (button) showed [9c As] and won ($4.05) with a pair of Deuces
Seat 6: k9nHZTHt8hYhYRcW8NTb4g (small blind) showed [Kh Qs] and lost with a pair of Deuces




PokerStars Game #59939455288:  Hold'em No Limit ($0.10/$0.25) - 2009/07/01 0:40:19 ET
Table 'vud0GB/ZlDCvUFhBFIaTlg' 9-max Seat #7 is the button
Seat 5: AwAabNdwDsTMb3aTomdOmg ($7 in chips) 
Seat 7: RzaVufWfW9CTnVYR7/Ge+w ($1.20 in chips) 
RzaVufWfW9CTnVYR7/Ge+w: posts small blind $0.10
AwAabNdwDsTMb3aTomdOmg: posts big blind $0.25
*** HOLE CARDS ***
RzaVufWfW9CTnVYR7/Ge+w: raises $0.25 to $0.50
AwAabNdwDsTMb3aTomdOmg: raises $0.75 to $1.25
RzaVufWfW9CTnVYR7/Ge+w: calls $0.70 and is all-in
Uncalled bet ($0.05) returned to AwAabNdwDsTMb3aTomdOmg
*** FLOP *** [Tc 7c 9d]
*** TURN *** [Tc 7c 9d] [Jc]
*** RIVER *** [Tc 7c 9d Jc] [2d]
*** SHOW DOWN ***
AwAabNdwDsTMb3aTomdOmg: shows [As 4c] (high card Ace)
RzaVufWfW9CTnVYR7/Ge+w: shows [Kh Qd] (a straight, Nine to King)
RzaVufWfW9CTnVYR7/Ge+w collected $2.30 from pot
*** SUMMARY ***
Total pot $2.40 | Rake $0.10 
Board [Tc 7c 9d Jc 2d]
Seat 5: AwAabNdwDsTMb3aTomdOmg (big blind) showed [As 4c] and lost with high card Ace
Seat 7: RzaVufWfW9CTnVYR7/Ge+w (button) (small blind) showed [Kh Qd] and won ($2.30) with a straight, Nine to King




PokerStars Game #59939455654:  Hold'em No Limit ($0.10/$0.25) - 2009/07/01 0:40:19 ET
Table 'tANpk8z1C5o0Pq/hpYShHw' 9-max Seat #8 is the button
Seat 1: rQhYIYXSyH/IivYM1dlV5A ($12 in chips) 
Seat 2: og4yH4sZUZdC8jjgW8zPJQ ($7.05 in chips) 
Seat 3: zDrucyjVn5aeekNEc3cJrA ($21.25 in chips) 
Seat 4: dmQRblfPJL8cP867vJRZkg ($7.50 in chips) 
Seat 5: kWxV1qKcmWEussgWafGYNA ($40.60 in chips) 
Seat 6: Vp8EaqUO6YyqsnwsLR8SNQ ($13 in chips) 
Seat 7: sv2dZaqHRlfCDrW63Guhvg ($10.40 in chips) 
Seat 8: sPhk0wImgnCyx4aYrPXnHA ($24.40 in chips) 
Seat 9: gE5rN2TDY1aXcZn/TOPeZw ($13.65 in chips) 
gE5rN2TDY1aXcZn/TOPeZw: posts small blind $0.10
rQhYIYXSyH/IivYM1dlV5A: posts big blind $0.25
*** HOLE CARDS ***
og4yH4sZUZdC8jjgW8zPJQ: calls $0.25
zDrucyjVn5aeekNEc3cJrA: folds 
dmQRblfPJL8cP867vJRZkg: calls $0.25
Vp8EaqUO6YyqsnwsLR8SNQ is connected 
kWxV1qKcmWEussgWafGYNA is connected 
kWxV1qKcmWEussgWafGYNA: folds 
Vp8EaqUO6YyqsnwsLR8SNQ: raises $0.50 to $0.75
sv2dZaqHRlfCDrW63Guhvg: folds 
sPhk0wImgnCyx4aYrPXnHA: folds 
gE5rN2TDY1aXcZn/TOPeZw: folds 
rQhYIYXSyH/IivYM1dlV5A: folds 
og4yH4sZUZdC8jjgW8zPJQ: calls $0.50
dmQRblfPJL8cP867vJRZkg: calls $0.50
*** FLOP *** [3d 8h 9s]
og4yH4sZUZdC8jjgW8zPJQ: checks 
dmQRblfPJL8cP867vJRZkg: checks 
Vp8EaqUO6YyqsnwsLR8SNQ: bets $1
og4yH4sZUZdC8jjgW8zPJQ: calls $1
dmQRblfPJL8cP867vJRZkg: calls $1
*** TURN *** [3d 8h 9s] [8s]
og4yH4sZUZdC8jjgW8zPJQ: checks 
dmQRblfPJL8cP867vJRZkg: checks 
Vp8EaqUO6YyqsnwsLR8SNQ: checks 
*** RIVER *** [3d 8h 9s 8s] [6c]
og4yH4sZUZdC8jjgW8zPJQ: bets $1
dmQRblfPJL8cP867vJRZkg: folds 
Vp8EaqUO6YyqsnwsLR8SNQ: folds 
Uncalled bet ($1) returned to og4yH4sZUZdC8jjgW8zPJQ
og4yH4sZUZdC8jjgW8zPJQ collected $5.35 from pot
*** SUMMARY ***
Total pot $5.60 | Rake $0.25 
Board [3d 8h 9s 8s 6c]
Seat 1: rQhYIYXSyH/IivYM1dlV5A (big blind) folded before Flop
Seat 2: og4yH4sZUZdC8jjgW8zPJQ collected ($5.35)
Seat 3: zDrucyjVn5aeekNEc3cJrA folded before Flop (didn't bet)
Seat 4: dmQRblfPJL8cP867vJRZkg folded on the River
Seat 5: kWxV1qKcmWEussgWafGYNA folded before Flop (didn't bet)
Seat 6: Vp8EaqUO6YyqsnwsLR8SNQ folded on the River
Seat 7: sv2dZaqHRlfCDrW63Guhvg folded before Flop (didn't bet)
Seat 8: sPhk0wImgnCyx4aYrPXnHA (button) folded before Flop (didn't bet)
Seat 9: gE5rN2TDY1aXcZn/TOPeZw (small blind) folded before Flop




PokerStars Game #59939455418:  Hold'em No Limit ($0.10/$0.25) - 2009/07/01 0:40:19 ET
Table 'G26g8jde1eR+mmabeFeSlw' 9-max Seat #9 is the button
Seat 1: eygIcrabyU9hI2mw7NQsgg ($21.75 in chips) 
Seat 2: O2aLEhH7P83nWGvgV84KoA ($14.15 in chips) 
Seat 3: WKL8nUFr7TumC4EjLyqYzw ($5.50 in chips) 
Seat 4: 1Clf3cPrqoy/YgvWdWK1Xw ($5 in chips) 
Seat 5: hJ4uYjNmSZdjrKA8cjZqCA ($19 in chips) 
Seat 6: opOCI2p6kW0tINuVaAqmcQ ($25 in chips) 
Seat 7: nm4Dj/f+jJEwKVsUnKh73g ($26.25 in chips) 
Seat 8: G+6mJ0LVzvA9qwETH4Ostw ($25.40 in chips) 
Seat 9: VWUWpMLMj/Q1jRVpF7Aohw ($12.50 in chips) 
eygIcrabyU9hI2mw7NQsgg: posts small blind $0.10
O2aLEhH7P83nWGvgV84KoA: posts big blind $0.25
*** HOLE CARDS ***
WKL8nUFr7TumC4EjLyqYzw: folds 
1Clf3cPrqoy/YgvWdWK1Xw: folds 
hJ4uYjNmSZdjrKA8cjZqCA: calls $0.25
opOCI2p6kW0tINuVaAqmcQ: folds 
nm4Dj/f+jJEwKVsUnKh73g: folds 
G+6mJ0LVzvA9qwETH4Ostw: folds 
VWUWpMLMj/Q1jRVpF7Aohw: folds 
eygIcrabyU9hI2mw7NQsgg: calls $0.15
O2aLEhH7P83nWGvgV84KoA: checks 
*** FLOP *** [Js Ts 4h]
eygIcrabyU9hI2mw7NQsgg: checks 
O2aLEhH7P83nWGvgV84KoA: bets $0.25
hJ4uYjNmSZdjrKA8cjZqCA: calls $0.25
eygIcrabyU9hI2mw7NQsgg: folds 
*** TURN *** [Js Ts 4h] [Jh]
O2aLEhH7P83nWGvgV84KoA: bets $0.50
hJ4uYjNmSZdjrKA8cjZqCA: calls $0.50
*** RIVER *** [Js Ts 4h Jh] [8s]
O2aLEhH7P83nWGvgV84KoA: checks 
hJ4uYjNmSZdjrKA8cjZqCA: bets $1.75
O2aLEhH7P83nWGvgV84KoA: folds 
Uncalled bet ($1.75) returned to hJ4uYjNmSZdjrKA8cjZqCA
hJ4uYjNmSZdjrKA8cjZqCA collected $2.15 from pot
*** SUMMARY ***
Total pot $2.25 | Rake $0.10 
Board [Js Ts 4h Jh 8s]
Seat 1: eygIcrabyU9hI2mw7NQsgg (small blind) folded on the Flop
Seat 2: O2aLEhH7P83nWGvgV84KoA (big blind) folded on the River
Seat 3: WKL8nUFr7TumC4EjLyqYzw folded before Flop (didn't bet)
Seat 4: 1Clf3cPrqoy/YgvWdWK1Xw folded before Flop (didn't bet)
Seat 5: hJ4uYjNmSZdjrKA8cjZqCA collected ($2.15)
Seat 6: opOCI2p6kW0tINuVaAqmcQ folded before Flop (didn't bet)
Seat 7: nm4Dj/f+jJEwKVsUnKh73g folded before Flop (didn't bet)
Seat 8: G+6mJ0LVzvA9qwETH4Ostw folded before Flop (didn't bet)
Seat 9: VWUWpMLMj/Q1jRVpF7Aohw (button) folded before Flop (didn't bet)




PokerStars Game #59939456362:  Hold'em No Limit ($0.10/$0.25) - 2009/07/01 0:40:20 ET
Table '4hfTdIVT/qPsJNfWXLsVIw' 9-max Seat #4 is the button
Seat 1: GbHFBbLqLGz0Pwn6CJeAuw ($24.20 in chips) 
Seat 2: NB5rKy+grn9jKcWXclZ7WA ($33.15 in chips) 
Seat 3: opOCI2p6kW0tINuVaAqmcQ ($26.80 in chips) 
Seat 4: OiV1PWZ3IkN29JlmCcnTwQ ($4.55 in chips) 
Seat 5: wtz6Fi0Zt+cIsTeTHf5zJQ ($5 in chips) 
Seat 6: VWUWpMLMj/Q1jRVpF7Aohw ($9.05 in chips) 
Seat 7: z5GxcHlYz/GSz6W2uFiTtg ($31.90 in chips) 
Seat 8: EfRs3ibIxn+c9JDErwwNCg ($31.65 in chips) 
Seat 9: K5byIbXY6S+c1wAeHitZow ($12.65 in chips) 
wtz6Fi0Zt+cIsTeTHf5zJQ: posts small blind $0.10
VWUWpMLMj/Q1jRVpF7Aohw: posts big blind $0.25
*** HOLE CARDS ***
z5GxcHlYz/GSz6W2uFiTtg: folds 
EfRs3ibIxn+c9JDErwwNCg: folds 
K5byIbXY6S+c1wAeHitZow: folds 
GbHFBbLqLGz0Pwn6CJeAuw: folds 
NB5rKy+grn9jKcWXclZ7WA: calls $0.25
opOCI2p6kW0tINuVaAqmcQ: folds 
OiV1PWZ3IkN29JlmCcnTwQ: raises $1 to $1.25
wtz6Fi0Zt+cIsTeTHf5zJQ: folds 
VWUWpMLMj/Q1jRVpF7Aohw: folds 
NB5rKy+grn9jKcWXclZ7WA: folds 
Uncalled bet ($1) returned to OiV1PWZ3IkN29JlmCcnTwQ
OiV1PWZ3IkN29JlmCcnTwQ collected $0.85 from pot
OiV1PWZ3IkN29JlmCcnTwQ: doesn't show hand 
*** SUMMARY ***
Total pot $0.85 | Rake $0 
Seat 1: GbHFBbLqLGz0Pwn6CJeAuw folded before Flop (didn't bet)
Seat 2: NB5rKy+grn9jKcWXclZ7WA folded before Flop
Seat 3: opOCI2p6kW0tINuVaAqmcQ folded before Flop (didn't bet)
Seat 4: OiV1PWZ3IkN29JlmCcnTwQ (button) collected ($0.85)
Seat 5: wtz6Fi0Zt+cIsTeTHf5zJQ (small blind) folded before Flop
Seat 6: VWUWpMLMj/Q1jRVpF7Aohw (big blind) folded before Flop
Seat 7: z5GxcHlYz/GSz6W2uFiTtg folded before Flop (didn't bet)
Seat 8: EfRs3ibIxn+c9JDErwwNCg folded before Flop (didn't bet)
Seat 9: K5byIbXY6S+c1wAeHitZow folded before Flop (didn't bet)




PokerStars Game #59939456290:  Hold'em No Limit ($0.10/$0.25) - 2009/07/01 0:40:20 ET
Table 'NtEQAxCeIK2io1CGtW658g' 6-max Seat #2 is the button
Seat 1: lnOV7k25gyN7L5t5YKTgIg ($20.85 in chips) 
Seat 2: nc79pm0LZRdhncq55evVqA ($25.55 in chips) 
Seat 3: m2yWOKfAxqHoy5DDN87Ttw ($24.75 in chips) 
Seat 4: 8296 ($12 in chips) 
Seat 5: FStoHe64SQWqAsjya9pDkQ ($28.20 in chips) 
Seat 6: /gJNBeCkWL4o85/jvlZ4BA ($62 in chips) 
m2yWOKfAxqHoy5DDN87Ttw: posts small blind $0.10
8296: posts big blind $0.25
*** HOLE CARDS ***
FStoHe64SQWqAsjya9pDkQ: folds 
/gJNBeCkWL4o85/jvlZ4BA: raises $0.75 to $1
lnOV7k25gyN7L5t5YKTgIg: folds 
nc79pm0LZRdhncq55evVqA: folds 
m2yWOKfAxqHoy5DDN87Ttw: folds 
8296: folds 
Uncalled bet ($0.75) returned to /gJNBeCkWL4o85/jvlZ4BA
/gJNBeCkWL4o85/jvlZ4BA collected $0.60 from pot
*** SUMMARY ***
Total pot $0.60 | Rake $0 
Seat 1: lnOV7k25gyN7L5t5YKTgIg folded before Flop (didn't bet)
Seat 2: nc79pm0LZRdhncq55evVqA (button) folded before Flop (didn't bet)
Seat 3: m2yWOKfAxqHoy5DDN87Ttw (small blind) folded before Flop
Seat 4: 8296 (big blind) folded before Flop
Seat 5: FStoHe64SQWqAsjya9pDkQ folded before Flop (didn't bet)
Seat 6: /gJNBeCkWL4o85/jvlZ4BA collected ($0.60)




PokerStars Game #59939456084:  Hold'em No Limit ($0.10/$0.25) - 2009/07/01 0:40:20 ET
Table 'o0CDOvKO/bn1WjeymDrXfA' 6-max Seat #2 is the button
Seat 1: 32YL2ZEp8NT4JB2RVM9euQ ($16.60 in chips) 
Seat 2: oc4ZGs0W+3RIg2yPyJw3ig ($30.90 in chips) 
Seat 3: EqXTTLKUlDlz7yi6ziyyWA ($9 in chips) 
Seat 5: u/yN5P9f3KlATg6WLWNkBQ ($29.35 in chips) 
Seat 6: Bada343Si4xKu3fNXY99AA ($20.95 in chips) 
EqXTTLKUlDlz7yi6ziyyWA: posts small blind $0.10
u/yN5P9f3KlATg6WLWNkBQ: posts big blind $0.25
*** HOLE CARDS ***
Bada343Si4xKu3fNXY99AA: folds 
32YL2ZEp8NT4JB2RVM9euQ: folds 
HotTillt joins the table at seat #4 
oc4ZGs0W+3RIg2yPyJw3ig: raises $0.50 to $0.75
EqXTTLKUlDlz7yi6ziyyWA: folds 
u/yN5P9f3KlATg6WLWNkBQ: calls $0.50
*** FLOP *** [2c Qc Jh]
u/yN5P9f3KlATg6WLWNkBQ: checks 
oc4ZGs0W+3RIg2yPyJw3ig: bets $1.25
u/yN5P9f3KlATg6WLWNkBQ: folds 
Uncalled bet ($1.25) returned to oc4ZGs0W+3RIg2yPyJw3ig
oc4ZGs0W+3RIg2yPyJw3ig collected $1.55 from pot
oc4ZGs0W+3RIg2yPyJw3ig: doesn't show hand 
*** SUMMARY ***
Total pot $1.60 | Rake $0.05 
Board [2c Qc Jh]
Seat 1: 32YL2ZEp8NT4JB2RVM9euQ folded before Flop (didn't bet)
Seat 2: oc4ZGs0W+3RIg2yPyJw3ig (button) collected ($1.55)
Seat 3: EqXTTLKUlDlz7yi6ziyyWA (small blind) folded before Flop
Seat 5: u/yN5P9f3KlATg6WLWNkBQ (big blind) folded on the Flop
Seat 6: Bada343Si4xKu3fNXY99AA folded before Flop (didn't bet)




PokerStars Game #59939455938:  Hold'em No Limit ($0.10/$0.25) - 2009/07/01 0:40:20 ET
Table 'M8kYidAX3ib7pLKW7edFLw' 6-max Seat #1 is the button
Seat 1: 4YSTu0Cdzpppe1lUgCZGCQ ($39.55 in chips) 
Seat 4: /bjna2FTN7pPjqYGzmDE0Q ($23.95 in chips) 
Seat 5: bDKopKTvPi3W+PEnYUX3tg ($27.85 in chips) 
/bjna2FTN7pPjqYGzmDE0Q: posts small blind $0.10
bDKopKTvPi3W+PEnYUX3tg: posts big blind $0.25
*** HOLE CARDS ***
4YSTu0Cdzpppe1lUgCZGCQ: folds 
/bjna2FTN7pPjqYGzmDE0Q: calls $0.15
bDKopKTvPi3W+PEnYUX3tg: checks 
*** FLOP *** [5h 3c 7c]
/bjna2FTN7pPjqYGzmDE0Q: checks 
bDKopKTvPi3W+PEnYUX3tg: checks 
*** TURN *** [5h 3c 7c] [6s]
/bjna2FTN7pPjqYGzmDE0Q: checks 
bDKopKTvPi3W+PEnYUX3tg: bets $0.50
/bjna2FTN7pPjqYGzmDE0Q: raises $1 to $1.50
bDKopKTvPi3W+PEnYUX3tg: calls $1
*** RIVER *** [5h 3c 7c 6s] [2d]
/bjna2FTN7pPjqYGzmDE0Q: bets $3.50
bDKopKTvPi3W+PEnYUX3tg said, "u really have 98"
q+Sip/IIcvzqgZt1pJAWTw joins the table at seat #3 
/bjna2FTN7pPjqYGzmDE0Q said, "call already"
bDKopKTvPi3W+PEnYUX3tg said, "best i can do is split but i want to see"
bDKopKTvPi3W+PEnYUX3tg: folds 
Uncalled bet ($3.50) returned to /bjna2FTN7pPjqYGzmDE0Q
/bjna2FTN7pPjqYGzmDE0Q collected $3.35 from pot
/bjna2FTN7pPjqYGzmDE0Q: doesn't show hand 
*** SUMMARY ***
Total pot $3.50 | Rake $0.15 
Board [5h 3c 7c 6s 2d]
Seat 1: 4YSTu0Cdzpppe1lUgCZGCQ (button) folded before Flop (didn't bet)
Seat 4: /bjna2FTN7pPjqYGzmDE0Q (small blind) collected ($3.35)
Seat 5: bDKopKTvPi3W+PEnYUX3tg (big blind) folded on the River




PokerStars Game #59939455878:  Hold'em No Limit ($0.10/$0.25) - 2009/07/01 0:40:20 ET
Table 'nc6OeGk/wtaWV+6N+kgnZQ' 6-max Seat #3 is the button
Seat 1: 0/FYfBoKhINaqU/H5OSS1A ($4.50 in chips) 
Seat 3: 8f0dtuUGqDbgE6up1lQAlg ($3.40 in chips) 
Seat 6: yJgjVkWgiJ8vdWZjcUod2A ($6.90 in chips) 
yJgjVkWgiJ8vdWZjcUod2A: posts small blind $0.10
0/FYfBoKhINaqU/H5OSS1A: posts big blind $0.25
*** HOLE CARDS ***
8f0dtuUGqDbgE6up1lQAlg: calls $0.25
yJgjVkWgiJ8vdWZjcUod2A: folds 
0/FYfBoKhINaqU/H5OSS1A: checks 
*** FLOP *** [Kc Td Qh]
0/FYfBoKhINaqU/H5OSS1A: checks 
8f0dtuUGqDbgE6up1lQAlg: bets $0.25
0/FYfBoKhINaqU/H5OSS1A: calls $0.25
*** TURN *** [Kc Td Qh] [8s]
0/FYfBoKhINaqU/H5OSS1A: checks 
8f0dtuUGqDbgE6up1lQAlg: bets $0.25
0/FYfBoKhINaqU/H5OSS1A: folds 
Uncalled bet ($0.25) returned to 8f0dtuUGqDbgE6up1lQAlg
8f0dtuUGqDbgE6up1lQAlg collected $1.05 from pot
*** SUMMARY ***
Total pot $1.10 | Rake $0.05 
Board [Kc Td Qh 8s]
Seat 1: 0/FYfBoKhINaqU/H5OSS1A (big blind) folded on the Turn
Seat 3: 8f0dtuUGqDbgE6up1lQAlg (button) collected ($1.05)
Seat 6: yJgjVkWgiJ8vdWZjcUod2A (small blind) folded before Flop




PokerStars Game #59939456996:  Hold'em No Limit ($0.10/$0.25) - 2009/07/01 0:40:21 ET
Table 'wPWRBZPJl1HAnysw7qRR0A' 6-max Seat #5 is the button
Seat 1: cPO/1/dTcZpLkQFm3jH3Rg ($49.60 in chips) 
Seat 2: 48oT5xFI+5CHUJlfoGrE4w ($6.55 in chips) 
Seat 4: kbpWbC+dJNBphHl1jtw7bw ($24.20 in chips) 
Seat 5: LtASJ9OlkqGrrUKGQlpGAw ($21.80 in chips) 
Seat 6: VLoE/jniCqHZuUkx8Esf6w ($28.05 in chips) 
VLoE/jniCqHZuUkx8Esf6w: posts small blind $0.10
cPO/1/dTcZpLkQFm3jH3Rg: posts big blind $0.25
*** HOLE CARDS ***
48oT5xFI+5CHUJlfoGrE4w: calls $0.25
kbpWbC+dJNBphHl1jtw7bw: folds 
LtASJ9OlkqGrrUKGQlpGAw: folds 
VLoE/jniCqHZuUkx8Esf6w: calls $0.15
cPO/1/dTcZpLkQFm3jH3Rg: checks 
*** FLOP *** [6s 3s 9s]
VLoE/jniCqHZuUkx8Esf6w: checks 
cPO/1/dTcZpLkQFm3jH3Rg: checks 
48oT5xFI+5CHUJlfoGrE4w: checks 
*** TURN *** [6s 3s 9s] [3d]
VLoE/jniCqHZuUkx8Esf6w: checks 
cPO/1/dTcZpLkQFm3jH3Rg: checks 
48oT5xFI+5CHUJlfoGrE4w: bets $0.75
VLoE/jniCqHZuUkx8Esf6w: calls $0.75
cPO/1/dTcZpLkQFm3jH3Rg: folds 
*** RIVER *** [6s 3s 9s 3d] [Th]
gqW2aBCmrIw65BvwjTFN6Q joins the table at seat #3 
VLoE/jniCqHZuUkx8Esf6w: checks 
48oT5xFI+5CHUJlfoGrE4w: checks 
*** SHOW DOWN ***
VLoE/jniCqHZuUkx8Esf6w: shows [4h 4c] (two pair, Fours and Threes)
48oT5xFI+5CHUJlfoGrE4w: shows [5c 5s] (two pair, Fives and Threes)
48oT5xFI+5CHUJlfoGrE4w collected $2.15 from pot
*** SUMMARY ***
Total pot $2.25 | Rake $0.10 
Board [6s 3s 9s 3d Th]
Seat 1: cPO/1/dTcZpLkQFm3jH3Rg (big blind) folded on the Turn
Seat 2: 48oT5xFI+5CHUJlfoGrE4w showed [5c 5s] and won ($2.15) with two pair, Fives and Threes
Seat 4: kbpWbC+dJNBphHl1jtw7bw folded before Flop (didn't bet)
Seat 5: LtASJ9OlkqGrrUKGQlpGAw (button) folded before Flop (didn't bet)
Seat 6: VLoE/jniCqHZuUkx8Esf6w (small blind) showed [4h 4c] and lost with two pair, Fours and Threes




PokerStars Game #59939456754:  Hold'em No Limit ($0.10/$0.25) - 2009/07/01 0:40:21 ET
Table '9o8Yb3JpUqurD4pNVmOikQ' 6-max Seat #2 is the button
Seat 1: 5tB0F9NjPSUL4FzmzBMs2Q ($25 in chips) 
Seat 2: /gJNBeCkWL4o85/jvlZ4BA ($25 in chips) 
Seat 3: JgRqo1/2phbf7pab7N3BIQ ($7.60 in chips) 
Seat 4: YaAEMJGY5tem39deCUQRNw ($41.30 in chips) 
Seat 5: q9qPRjJC40e/Q9yuT+glwQ ($35.05 in chips) 
Seat 6: k9vn40MOqqb+xF+7GZ6v2g ($35.15 in chips) 
JgRqo1/2phbf7pab7N3BIQ: posts small blind $0.10
YaAEMJGY5tem39deCUQRNw: posts big blind $0.25
*** HOLE CARDS ***
q9qPRjJC40e/Q9yuT+glwQ: folds 
q9qPRjJC40e/Q9yuT+glwQ is sitting out
k9vn40MOqqb+xF+7GZ6v2g: calls $0.25
5tB0F9NjPSUL4FzmzBMs2Q: folds 
q9qPRjJC40e/Q9yuT+glwQ leaves the table
/gJNBeCkWL4o85/jvlZ4BA: folds 
JgRqo1/2phbf7pab7N3BIQ: calls $0.15
YaAEMJGY5tem39deCUQRNw: checks 
*** FLOP *** [9h Ks Kh]
JgRqo1/2phbf7pab7N3BIQ: checks 
YaAEMJGY5tem39deCUQRNw: checks 
k9vn40MOqqb+xF+7GZ6v2g: checks 
*** TURN *** [9h Ks Kh] [3c]
JgRqo1/2phbf7pab7N3BIQ: checks 
YaAEMJGY5tem39deCUQRNw: checks 
k9vn40MOqqb+xF+7GZ6v2g: checks 
*** RIVER *** [9h Ks Kh 3c] [4s]
JgRqo1/2phbf7pab7N3BIQ: checks 
YaAEMJGY5tem39deCUQRNw: checks 
k9vn40MOqqb+xF+7GZ6v2g: checks 
*** SHOW DOWN ***
JgRqo1/2phbf7pab7N3BIQ: shows [Jc 8d] (a pair of Kings)
YaAEMJGY5tem39deCUQRNw: shows [Ac 3h] (two pair, Kings and Threes)
k9vn40MOqqb+xF+7GZ6v2g: mucks hand 
YaAEMJGY5tem39deCUQRNw collected $0.75 from pot
*** SUMMARY ***
Total pot $0.75 | Rake $0 
Board [9h Ks Kh 3c 4s]
Seat 1: 5tB0F9NjPSUL4FzmzBMs2Q folded before Flop (didn't bet)
Seat 2: /gJNBeCkWL4o85/jvlZ4BA (button) folded before Flop (didn't bet)
Seat 3: JgRqo1/2phbf7pab7N3BIQ (small blind) showed [Jc 8d] and lost with a pair of Kings
Seat 4: YaAEMJGY5tem39deCUQRNw (big blind) showed [Ac 3h] and won ($0.75) with two pair, Kings and Threes
Seat 5: q9qPRjJC40e/Q9yuT+glwQ folded before Flop (didn't bet)
Seat 6: k9vn40MOqqb+xF+7GZ6v2g mucked




PokerStars Game #59939456590:  Hold'em No Limit ($0.10/$0.25) - 2009/07/01 0:40:21 ET
Table 'a0kk1yz54EMczhut3KjrxQ' 6-max Seat #5 is the button
Seat 1: V3LJvbHVJHmOj2fd7zIDhA ($29 in chips) 
Seat 2: nc79pm0LZRdhncq55evVqA ($25 in chips) 
Seat 3: FabaCGPqGJLjRL48CMvjiQ ($23.25 in chips) 
Seat 4: FYepjhAvF8ZdVCmqHIy+eQ ($26.70 in chips) 
Seat 5: cPO/1/dTcZpLkQFm3jH3Rg ($25 in chips) 
Seat 6: DTzxFTXVrCqrpjq9B9Vg/g ($16.05 in chips) 
DTzxFTXVrCqrpjq9B9Vg/g: posts small blind $0.10
V3LJvbHVJHmOj2fd7zIDhA: posts big blind $0.25
*** HOLE CARDS ***
nc79pm0LZRdhncq55evVqA: folds 
FabaCGPqGJLjRL48CMvjiQ: folds 
FYepjhAvF8ZdVCmqHIy+eQ: folds 
cPO/1/dTcZpLkQFm3jH3Rg: raises $0.75 to $1
DTzxFTXVrCqrpjq9B9Vg/g: calls $0.90
V3LJvbHVJHmOj2fd7zIDhA: folds 
*** FLOP *** [6s Jc 3c]
DTzxFTXVrCqrpjq9B9Vg/g: checks 
cPO/1/dTcZpLkQFm3jH3Rg: bets $1.40
DTzxFTXVrCqrpjq9B9Vg/g: folds 
Uncalled bet ($1.40) returned to cPO/1/dTcZpLkQFm3jH3Rg
cPO/1/dTcZpLkQFm3jH3Rg collected $2.15 from pot
*** SUMMARY ***
Total pot $2.25 | Rake $0.10 
Board [6s Jc 3c]
Seat 1: V3LJvbHVJHmOj2fd7zIDhA (big blind) folded before Flop
Seat 2: nc79pm0LZRdhncq55evVqA folded before Flop (didn't bet)
Seat 3: FabaCGPqGJLjRL48CMvjiQ folded before Flop (didn't bet)
Seat 4: FYepjhAvF8ZdVCmqHIy+eQ folded before Flop (didn't bet)
Seat 5: cPO/1/dTcZpLkQFm3jH3Rg (button) collected ($2.15)
Seat 6: DTzxFTXVrCqrpjq9B9Vg/g (small blind) folded on the Flop




PokerStars Game #59939456758:  Hold'em No Limit ($0.10/$0.25) - 2009/07/01 0:40:21 ET
Table 'zgAizkhIUPUrfr6LqN3ifw' 9-max Seat #9 is the button
Seat 1: st9jtdNbm1W5GfBwRaCVqQ ($25 in chips) 
Seat 2: s7Q6uNouhe7aE8JdFb9E+A ($26.25 in chips) 
Seat 3: hZuGwtYmFKPmQ+v1wlmdfA ($23.10 in chips) 
Seat 7: 1S/fpm+f42V/6MNZre+ccg ($25 in chips) 
Seat 8: MIVCHqCqqlke0Lb0z7glcw ($24.15 in chips) 
Seat 9: SXqVW4Q0evTUVZG6BbUNIA ($39.30 in chips) 
st9jtdNbm1W5GfBwRaCVqQ: posts small blind $0.10
s7Q6uNouhe7aE8JdFb9E+A: posts big blind $0.25
DdPXdieucQ+n99u1n3A+rQ: sits out 
TeWJxSETzbXGiYKx0y+dtg: sits out 
*** HOLE CARDS ***
hZuGwtYmFKPmQ+v1wlmdfA: folds 
1S/fpm+f42V/6MNZre+ccg: folds 
MIVCHqCqqlke0Lb0z7glcw: folds 
SXqVW4Q0evTUVZG6BbUNIA: folds 
st9jtdNbm1W5GfBwRaCVqQ: folds 
Uncalled bet ($0.15) returned to s7Q6uNouhe7aE8JdFb9E+A
s7Q6uNouhe7aE8JdFb9E+A collected $0.20 from pot
s7Q6uNouhe7aE8JdFb9E+A: doesn't show hand 
*** SUMMARY ***
Total pot $0.20 | Rake $0 
Seat 1: st9jtdNbm1W5GfBwRaCVqQ (small blind) folded before Flop
Seat 2: s7Q6uNouhe7aE8JdFb9E+A (big blind) collected ($0.20)
Seat 3: hZuGwtYmFKPmQ+v1wlmdfA folded before Flop (didn't bet)
Seat 7: 1S/fpm+f42V/6MNZre+ccg folded before Flop (didn't bet)
Seat 8: MIVCHqCqqlke0Lb0z7glcw folded before Flop (didn't bet)
Seat 9: SXqVW4Q0evTUVZG6BbUNIA (button) folded before Flop (didn't bet)




PokerStars Game #59939457198:  Hold'em No Limit ($0.10/$0.25) - 2009/07/01 0:40:22 ET
Table 'aaXqTKUnxrX9DYXtxhWXxA' 6-max Seat #4 is the button
Seat 1: njVkfGYrPiXfq4zLcgfVuA ($12.15 in chips) 
Seat 2: 1Zyw8DT57U6TzxWWRixa6Q ($14.05 in chips) 
Seat 3: cPO/1/dTcZpLkQFm3jH3Rg ($25 in chips) 
Seat 4: 4YSTu0Cdzpppe1lUgCZGCQ ($37.70 in chips) 
Seat 5: kyRaCIljYA6l33lSKQfNsg ($25 in chips) 
Seat 6: buyjetgNT1McXtdaP4zynA ($22.60 in chips) 
kyRaCIljYA6l33lSKQfNsg: posts small blind $0.10
buyjetgNT1McXtdaP4zynA: posts big blind $0.25
*** HOLE CARDS ***
njVkfGYrPiXfq4zLcgfVuA: folds 
1Zyw8DT57U6TzxWWRixa6Q: calls $0.25
cPO/1/dTcZpLkQFm3jH3Rg: folds 
4YSTu0Cdzpppe1lUgCZGCQ: raises $1 to $1.25
kyRaCIljYA6l33lSKQfNsg: folds 
buyjetgNT1McXtdaP4zynA: folds 
1Zyw8DT57U6TzxWWRixa6Q: folds 
Uncalled bet ($1) returned to 4YSTu0Cdzpppe1lUgCZGCQ
4YSTu0Cdzpppe1lUgCZGCQ collected $0.85 from pot
*** SUMMARY ***
Total pot $0.85 | Rake $0 
Seat 1: njVkfGYrPiXfq4zLcgfVuA folded before Flop (didn't bet)
Seat 2: 1Zyw8DT57U6TzxWWRixa6Q folded before Flop
Seat 3: cPO/1/dTcZpLkQFm3jH3Rg folded before Flop (didn't bet)
Seat 4: 4YSTu0Cdzpppe1lUgCZGCQ (button) collected ($0.85)
Seat 5: kyRaCIljYA6l33lSKQfNsg (small blind) folded before Flop
Seat 6: buyjetgNT1McXtdaP4zynA (big blind) folded before Flop




PokerStars Game #59939457718:  Hold'em No Limit ($0.10/$0.25) - 2009/07/01 0:40:22 ET
Table 'BdTkgy6SGkgNXul6irMoOw' 9-max Seat #5 is the button
Seat 1: Jd9JmKichu4pvsKjXEKNvA ($5 in chips) 
Seat 2: ljemhp25Zg+nlA9DLCIiUw ($39.30 in chips) 
Seat 4: eygIcrabyU9hI2mw7NQsgg ($23.55 in chips) 
Seat 5: opOCI2p6kW0tINuVaAqmcQ ($25 in chips) 
Seat 6: XlP4n7rTkDteN8BWl//wvg ($22.75 in chips) 
Seat 9: 5dv9mRGKI/UifM58OINXVQ ($18.90 in chips) 
XlP4n7rTkDteN8BWl//wvg: posts small blind $0.10
5dv9mRGKI/UifM58OINXVQ: posts big blind $0.25
Jd9JmKichu4pvsKjXEKNvA: posts big blind $0.25
*** HOLE CARDS ***
Jd9JmKichu4pvsKjXEKNvA: checks 
ljemhp25Zg+nlA9DLCIiUw: folds 
ljemhp25Zg+nlA9DLCIiUw said, "nice call"
eygIcrabyU9hI2mw7NQsgg: folds 
eygIcrabyU9hI2mw7NQsgg said, "loool"
opOCI2p6kW0tINuVaAqmcQ: folds 
XlP4n7rTkDteN8BWl//wvg: folds 
5dv9mRGKI/UifM58OINXVQ: checks 
*** FLOP *** [Qc Js 4c]
5dv9mRGKI/UifM58OINXVQ: checks 
Jd9JmKichu4pvsKjXEKNvA: checks 
*** TURN *** [Qc Js 4c] [6s]
5dv9mRGKI/UifM58OINXVQ: checks 
Jd9JmKichu4pvsKjXEKNvA: checks 
*** RIVER *** [Qc Js 4c 6s] [Qd]
5dv9mRGKI/UifM58OINXVQ: bets $0.25
Jd9JmKichu4pvsKjXEKNvA: folds 
Uncalled bet ($0.25) returned to 5dv9mRGKI/UifM58OINXVQ
5dv9mRGKI/UifM58OINXVQ collected $0.60 from pot
*** SUMMARY ***
Total pot $0.60 | Rake $0 
Board [Qc Js 4c 6s Qd]
Seat 1: Jd9JmKichu4pvsKjXEKNvA folded on the River
Seat 2: ljemhp25Zg+nlA9DLCIiUw folded before Flop (didn't bet)
Seat 4: eygIcrabyU9hI2mw7NQsgg folded before Flop (didn't bet)
Seat 5: opOCI2p6kW0tINuVaAqmcQ (button) folded before Flop (didn't bet)
Seat 6: XlP4n7rTkDteN8BWl//wvg (small blind) folded before Flop
Seat 9: 5dv9mRGKI/UifM58OINXVQ (big blind) collected ($0.60)




PokerStars Game #59939457354:  Hold'em No Limit ($0.10/$0.25) - 2009/07/01 0:40:22 ET
Table 'hfHe8uKeSJMyWAjSdM7ROQMRfAiS/4JSfnUDlCcZo0wAx Seat #4 is the button
Seat 2: /gJNBeCkWL4o85/jvlZ4BA ($35.35 in chips) 
Seat 3: FYepjhAvF8ZdVCmqHIy+eQ ($46.75 in chips) 
Seat 4: Go8clNIDGP3feVvzBDG4pg ($24.15 in chips) 
Seat 5: qccGLncfUaN00Few5HsgYg ($28.35 in chips) 
Seat 6: VaDPspfGS2lnEkaGNrNqfg ($9.75 in chips) 
qccGLncfUaN00Few5HsgYg: posts small blind $0.10
VaDPspfGS2lnEkaGNrNqfg: posts big blind $0.25
48oT5xFI+5CHUJlfoGrE4w: sits out 
*** HOLE CARDS ***
/gJNBeCkWL4o85/jvlZ4BA: raises $0.75 to $1
FYepjhAvF8ZdVCmqHIy+eQ: folds 
Go8clNIDGP3feVvzBDG4pg: calls $1
qccGLncfUaN00Few5HsgYg: calls $0.90
VaDPspfGS2lnEkaGNrNqfg: folds 
*** FLOP *** [9h Qc 4h]
qccGLncfUaN00Few5HsgYg: checks 
/gJNBeCkWL4o85/jvlZ4BA: bets $1.25
Go8clNIDGP3feVvzBDG4pg: raises $1.25 to $2.50
qccGLncfUaN00Few5HsgYg: folds 
/gJNBeCkWL4o85/jvlZ4BA: calls $1.25
*** TURN *** [9h Qc 4h] [Qs]
/gJNBeCkWL4o85/jvlZ4BA: bets $4
Go8clNIDGP3feVvzBDG4pg: folds 
Uncalled bet ($4) returned to /gJNBeCkWL4o85/jvlZ4BA
/gJNBeCkWL4o85/jvlZ4BA collected $7.85 from pot
*** SUMMARY ***
Total pot $8.25 | Rake $0.40 
Board [9h Qc 4h Qs]
Seat 2: /gJNBeCkWL4o85/jvlZ4BA collected ($7.85)
Seat 3: FYepjhAvF8ZdVCmqHIy+eQ folded before Flop (didn't bet)
Seat 4: Go8clNIDGP3feVvzBDG4pg (button) folded on the Turn
Seat 5: qccGLncfUaN00Few5HsgYg (small blind) folded on the Flop
Seat 6: VaDPspfGS2lnEkaGNrNqfg (big blind) folded before Flop




PokerStars Game #59939457044:  Hold'em No Limit ($0.10/$0.25) - 2009/07/01 0:40:22 ET
Table '6wawJ+MkkvuC3coG6r+YhgZiwAqg4o02gNro+JOAaFNgSeat #2 is the button
Seat 1: j4q3p0lesp63b1gZDwLBZw ($5.60 in chips) 
Seat 2: tYsOBqdU1+x+yFI7zHO7hQ ($31.10 in chips) 
Seat 3: aNpwfA31EREwO+ar4XzBCw ($25 in chips) 
Seat 4: FJflwqC6fqOpM3j0q8Bptw ($17.65 in chips) 
Seat 6: hBMUlEpyU74r/fwDgIpXjQ ($27.95 in chips) 
Seat 8: CYkY0dNBaYaKs8HVCVn3mQ ($5 in chips) 
Seat 9: ljemhp25Zg+nlA9DLCIiUw ($24.65 in chips) 
aNpwfA31EREwO+ar4XzBCw: posts small blind $0.10
FJflwqC6fqOpM3j0q8Bptw: posts big blind $0.25
5hAPbqNrvJb8PtLiceXtlg6HoFYfVGBefsR5Vrz62qIwts out 
opOCI2p6kW0tINuVaAqmcQ: sits out 
*** HOLE CARDS ***
hBMUlEpyU74r/fwDgIpXjQ: folds 
CYkY0dNBaYaKs8HVCVn3mQ: raises $0.50 to $0.75
ljemhp25Zg+nlA9DLCIiUw: folds 
j4q3p0lesp63b1gZDwLBZw: folds 
tYsOBqdU1+x+yFI7zHO7hQ: folds 
aNpwfA31EREwO+ar4XzBCw: folds 
FJflwqC6fqOpM3j0q8Bptw: calls $0.50
*** FLOP *** [Ts 6d Qd]
FJflwqC6fqOpM3j0q8Bptw: checks 
CYkY0dNBaYaKs8HVCVn3mQ: checks 
*** TURN *** [Ts 6d Qd] [4h]
FJflwqC6fqOpM3j0q8Bptw: checks 
CYkY0dNBaYaKs8HVCVn3mQ: bets $2
FJflwqC6fqOpM3j0q8Bptw: calls $2
*** RIVER *** [Ts 6d Qd 4h] [Jd]
FJflwqC6fqOpM3j0q8Bptw: checks 
CYkY0dNBaYaKs8HVCVn3mQ: bets $2.25 and is all-in
FJflwqC6fqOpM3j0q8Bptw: calls $2.25
*** SHOW DOWN ***
CYkY0dNBaYaKs8HVCVn3mQ: shows [6s 6c] (three of a kind, Sixes)
FJflwqC6fqOpM3j0q8Bptw: shows [7d Kd] (a flush, King high)
FJflwqC6fqOpM3j0q8Bptw collected $9.65 from pot
*** SUMMARY ***
Total pot $10.10 | Rake $0.45 
Board [Ts 6d Qd 4h Jd]
Seat 1: j4q3p0lesp63b1gZDwLBZw folded before Flop (didn't bet)
Seat 2: tYsOBqdU1+x+yFI7zHO7hQ (button) folded before Flop (didn't bet)
Seat 3: aNpwfA31EREwO+ar4XzBCw (small blind) folded before Flop
Seat 4: FJflwqC6fqOpM3j0q8Bptw (big blind) showed [7d Kd] and won ($9.65) with a flush, King high
Seat 6: hBMUlEpyU74r/fwDgIpXjQ folded before Flop (didn't bet)
Seat 8: CYkY0dNBaYaKs8HVCVn3mQ showed [6s 6c] and lost with three of a kind, Sixes
Seat 9: ljemhp25Zg+nlA9DLCIiUw folded before Flop (didn't bet)




PokerStars Game #59939457458:  Hold'em No Limit ($0.10/$0.25) - 2009/07/01 0:40:22 ET
Table '+fuYjvJy9okLr23QyZtanA' 9-max Seat #4 is the button
Seat 1: s7Q6uNouhe7aE8JdFb9E+A ($31.35 in chips) 
Seat 4: H/l9NZvuOXwQIPOaVdj0rQ ($8.80 in chips) 
H/l9NZvuOXwQIPOaVdj0rQ: posts small blind $0.10
s7Q6uNouhe7aE8JdFb9E+A: posts big blind $0.25
*** HOLE CARDS ***
H/l9NZvuOXwQIPOaVdj0rQ: calls $0.15
s7Q6uNouhe7aE8JdFb9E+A: checks 
*** FLOP *** [Qh 2c Jc]
s7Q6uNouhe7aE8JdFb9E+A: checks 
H/l9NZvuOXwQIPOaVdj0rQ: bets $0.25
s7Q6uNouhe7aE8JdFb9E+A: folds 
Uncalled bet ($0.25) returned to H/l9NZvuOXwQIPOaVdj0rQ
H/l9NZvuOXwQIPOaVdj0rQ collected $0.50 from pot
H/l9NZvuOXwQIPOaVdj0rQ: doesn't show hand 
*** SUMMARY ***
Total pot $0.50 | Rake $0 
Board [Qh 2c Jc]
Seat 1: s7Q6uNouhe7aE8JdFb9E+A (big blind) folded on the Flop
Seat 4: H/l9NZvuOXwQIPOaVdj0rQ (button) (small blind) collected ($0.50)




PokerStars Game #59939457366:  Hold'em No Limit ($0.10/$0.25) - 2009/07/01 0:40:22 ET
Table '3EebBlzq5yHSY2444L4zlg' 9-max Seat #9 is the button
Seat 1: 8B/dhbQjIWe6ASCdgzktNQ ($37.35 in chips) 
Seat 2: MIVCHqCqqlke0Lb0z7glcw ($25.35 in chips) 
Seat 3: IGbD5vKNhHe60dkdbjg/mw ($25.35 in chips) 
Seat 4: 1S/fpm+f42V/6MNZre+ccg ($25.45 in chips) 
Seat 5: 22Ph+hChb2fjC5+yk/mOew ($14.75 in chips) 
Seat 6: QEbIGci+itdw+re8RM5fZA ($28.15 in chips) 
Seat 7: DiSvPC2iudwL5j9u6Huyww ($28.90 in chips) 
Seat 8: Qi+clOtyDiibLdH2/1Qy8g ($27.85 in chips) 
Seat 9: GTcLfsDTPqgfHyhY9FNDMw ($10.05 in chips) 
8B/dhbQjIWe6ASCdgzktNQ: posts small blind $0.10
MIVCHqCqqlke0Lb0z7glcw: posts big blind $0.25
*** HOLE CARDS ***
IGbD5vKNhHe60dkdbjg/mw: folds 
1S/fpm+f42V/6MNZre+ccg: folds 
22Ph+hChb2fjC5+yk/mOew: folds 
QEbIGci+itdw+re8RM5fZA: folds 
DiSvPC2iudwL5j9u6Huyww: raises $0.75 to $1
Qi+clOtyDiibLdH2/1Qy8g: folds 
GTcLfsDTPqgfHyhY9FNDMw: raises $2.75 to $3.75
8B/dhbQjIWe6ASCdgzktNQ: folds 
MIVCHqCqqlke0Lb0z7glcw: folds 
DiSvPC2iudwL5j9u6Huyww: folds 
Uncalled bet ($2.75) returned to GTcLfsDTPqgfHyhY9FNDMw
GTcLfsDTPqgfHyhY9FNDMw collected $2.35 from pot
GTcLfsDTPqgfHyhY9FNDMw: doesn't show hand 
*** SUMMARY ***
Total pot $2.35 | Rake $0 
Seat 1: 8B/dhbQjIWe6ASCdgzktNQ (small blind) folded before Flop
Seat 2: MIVCHqCqqlke0Lb0z7glcw (big blind) folded before Flop
Seat 3: IGbD5vKNhHe60dkdbjg/mw folded before Flop (didn't bet)
Seat 4: 1S/fpm+f42V/6MNZre+ccg folded before Flop (didn't bet)
Seat 5: 22Ph+hChb2fjC5+yk/mOew folded before Flop (didn't bet)
Seat 6: QEbIGci+itdw+re8RM5fZA folded before Flop (didn't bet)
Seat 7: DiSvPC2iudwL5j9u6Huyww folded before Flop
Seat 8: Qi+clOtyDiibLdH2/1Qy8g folded before Flop (didn't bet)
Seat 9: GTcLfsDTPqgfHyhY9FNDMw (button) collected ($2.35)




PokerStars Game #59939457388:  Hold'em No Limit ($0.10/$0.25) - 2009/07/01 0:40:22 ET
Table 'a6FCGVBMPcT7J7BDN9q1zQ' 9-max Seat #8 is the button
Seat 1: s7Q6uNouhe7aE8JdFb9E+A ($43.35 in chips) 
Seat 2: h4ggJZYBXV0mEZzYPYKfeA ($34.85 in chips) 
Seat 3: hIss79a4pu7GzJZepfgOpg ($25 in chips) 
Seat 5: JJk2ZoH7BSGLAgqFUL5pMg ($2.40 in chips) 
Seat 6: Z9AeOQX3yzuSvKAm/xyovg ($9.65 in chips) 
Seat 7: V0Yo5zRBVM8DYspLKafebg ($24.30 in chips) 
Seat 8: r6hsffOo1iKmaPYKwAZmFw ($51.35 in chips) 
Seat 9: WwcXelmo9g129XJixVb2NA ($14.50 in chips) 
WwcXelmo9g129XJixVb2NA: posts small blind $0.10
s7Q6uNouhe7aE8JdFb9E+A: posts big blind $0.25
ydoFOVgzvZv9ZhuWu9rXAw: sits out 
*** HOLE CARDS ***
h4ggJZYBXV0mEZzYPYKfeA: folds 
hIss79a4pu7GzJZepfgOpg: folds 
JJk2ZoH7BSGLAgqFUL5pMg: folds 
Z9AeOQX3yzuSvKAm/xyovg: folds 
V0Yo5zRBVM8DYspLKafebg: folds 
r6hsffOo1iKmaPYKwAZmFw: folds 
WwcXelmo9g129XJixVb2NA: calls $0.15
s7Q6uNouhe7aE8JdFb9E+A: checks 
*** FLOP *** [2s 2h Ts]
WwcXelmo9g129XJixVb2NA: checks 
s7Q6uNouhe7aE8JdFb9E+A: bets $0.35
WwcXelmo9g129XJixVb2NA: folds 
Uncalled bet ($0.35) returned to s7Q6uNouhe7aE8JdFb9E+A
s7Q6uNouhe7aE8JdFb9E+A collected $0.50 from pot
s7Q6uNouhe7aE8JdFb9E+A: doesn't show hand 
*** SUMMARY ***
Total pot $0.50 | Rake $0 
Board [2s 2h Ts]
Seat 1: s7Q6uNouhe7aE8JdFb9E+A (big blind) collected ($0.50)
Seat 2: h4ggJZYBXV0mEZzYPYKfeA folded before Flop (didn't bet)
Seat 3: hIss79a4pu7GzJZepfgOpg folded before Flop (didn't bet)
Seat 5: JJk2ZoH7BSGLAgqFUL5pMg folded before Flop (didn't bet)
Seat 6: Z9AeOQX3yzuSvKAm/xyovg folded before Flop (didn't bet)
Seat 7: V0Yo5zRBVM8DYspLKafebg folded before Flop (didn't bet)
Seat 8: r6hsffOo1iKmaPYKwAZmFw (button) folded before Flop (didn't bet)
Seat 9: WwcXelmo9g129XJixVb2NA (small blind) folded on the Flop




PokerStars Game #59939457882:  Hold'em No Limit ($0.10/$0.25) - 2009/07/01 0:40:23 ET
Table 'MJ1SB76A4qJrlEa+C5e/8w' 6-max Seat #3 is the button
Seat 2: UA5OsKS3VPaxa7uC8La/kA ($28.90 in chips) 
Seat 3: IrrSNlaIjHnZjG6E7LgmEg ($16 in chips) 
Seat 4: 6boOPJDTFiEyZD2WdW0kCA ($14.25 in chips) 
Seat 5: eHsmIvAb2JREg4O6hNPnXg ($10 in chips) 
Seat 6: JFIAqU8lCZ0vWwEl4bdGsg ($25 in chips) 
6boOPJDTFiEyZD2WdW0kCA: posts small blind $0.10
eHsmIvAb2JREg4O6hNPnXg: posts big blind $0.25
*** HOLE CARDS ***
JFIAqU8lCZ0vWwEl4bdGsg: raises $0.60 to $0.85
UA5OsKS3VPaxa7uC8La/kA: folds 
IrrSNlaIjHnZjG6E7LgmEg: calls $0.85
6boOPJDTFiEyZD2WdW0kCA: folds 
eHsmIvAb2JREg4O6hNPnXg: raises $1.15 to $2
JFIAqU8lCZ0vWwEl4bdGsg: calls $1.15
IrrSNlaIjHnZjG6E7LgmEg: folds 
*** FLOP *** [4s Qh 4c]
eHsmIvAb2JREg4O6hNPnXg: checks 
JFIAqU8lCZ0vWwEl4bdGsg: bets $2.50
eHsmIvAb2JREg4O6hNPnXg: folds 
Uncalled bet ($2.50) returned to JFIAqU8lCZ0vWwEl4bdGsg
JFIAqU8lCZ0vWwEl4bdGsg collected $4.75 from pot
JFIAqU8lCZ0vWwEl4bdGsg: doesn't show hand 
*** SUMMARY ***
Total pot $4.95 | Rake $0.20 
Board [4s Qh 4c]
Seat 2: UA5OsKS3VPaxa7uC8La/kA folded before Flop (didn't bet)
Seat 3: IrrSNlaIjHnZjG6E7LgmEg (button) folded before Flop
Seat 4: 6boOPJDTFiEyZD2WdW0kCA (small blind) folded before Flop
Seat 5: eHsmIvAb2JREg4O6hNPnXg (big blind) folded on the Flop
Seat 6: JFIAqU8lCZ0vWwEl4bdGsg collected ($4.75)




PokerStars Game #59939458018:  Hold'em No Limit ($0.10/$0.25) - 2009/07/01 0:40:23 ET
Table 'Ok3oDLIsTc2+KxPcI0bAOA' 6-max Seat #1 is the button
Seat 1: agQm3ugZ3qSVYNgNu1ddeA ($26.70 in chips) 
Seat 2: oseFhpinoe+Zg4j5xyBjyQ ($30.45 in chips) 
Seat 3: I1TxPvWj8NfG8orglCinNA ($25 in chips) 
Seat 4: WMiAkibyLuLJ32VI20myug ($12.05 in chips) 
Seat 5: nc79pm0LZRdhncq55evVqA ($28.25 in chips) 
Seat 6: JFIAqU8lCZ0vWwEl4bdGsg ($28.65 in chips) 
oseFhpinoe+Zg4j5xyBjyQ: posts small blind $0.10
I1TxPvWj8NfG8orglCinNA: posts big blind $0.25
*** HOLE CARDS ***
WMiAkibyLuLJ32VI20myug: folds 
nc79pm0LZRdhncq55evVqA: folds 
JFIAqU8lCZ0vWwEl4bdGsg: raises $0.60 to $0.85
agQm3ugZ3qSVYNgNu1ddeA: folds 
oseFhpinoe+Zg4j5xyBjyQ: folds 
I1TxPvWj8NfG8orglCinNA: folds 
Uncalled bet ($0.60) returned to JFIAqU8lCZ0vWwEl4bdGsg
JFIAqU8lCZ0vWwEl4bdGsg collected $0.60 from pot
JFIAqU8lCZ0vWwEl4bdGsg: doesn't show hand 
*** SUMMARY ***
Total pot $0.60 | Rake $0 
Seat 1: agQm3ugZ3qSVYNgNu1ddeA (button) folded before Flop (didn't bet)
Seat 2: oseFhpinoe+Zg4j5xyBjyQ (small blind) folded before Flop
Seat 3: I1TxPvWj8NfG8orglCinNA (big blind) folded before Flop
Seat 4: WMiAkibyLuLJ32VI20myug folded before Flop (didn't bet)
Seat 5: nc79pm0LZRdhncq55evVqA folded before Flop (didn't bet)
Seat 6: JFIAqU8lCZ0vWwEl4bdGsg collected ($0.60)




PokerStars Game #59939459018:  Hold'em No Limit ($0.10/$0.25) - 2009/07/01 0:40:24 ET
Table '2AUmC2Rslg+QUbLfdgNdfg' 6-max Seat #1 is the button
Seat 1: lgP2sg9oZJsNSXCt7tbwRg ($16.25 in chips) 
Seat 2: CCxAG7iPVlAv3brCqrGBEg ($12.50 in chips) 
Seat 3: iauW7L/+7qzAuHow7CD75Q ($7.20 in chips) 
Seat 4: B6R6e73iyJNddUtXtvYr3Q ($47.95 in chips) 
Seat 5: 8ClCHtFXGNplITm+63KB+Q ($22.95 in chips) 
Seat 6: BvTq4Tu0zBOsniW3eFCnkQ ($33.40 in chips) 
CCxAG7iPVlAv3brCqrGBEg: posts small blind $0.10
iauW7L/+7qzAuHow7CD75Q: posts big blind $0.25
*** HOLE CARDS ***
B6R6e73iyJNddUtXtvYr3Q: folds 
8ClCHtFXGNplITm+63KB+Q: folds 
BvTq4Tu0zBOsniW3eFCnkQ: folds 
lgP2sg9oZJsNSXCt7tbwRg: folds 
CCxAG7iPVlAv3brCqrGBEg: folds 
Uncalled bet ($0.15) returned to iauW7L/+7qzAuHow7CD75Q
iauW7L/+7qzAuHow7CD75Q collected $0.20 from pot
iauW7L/+7qzAuHow7CD75Q: doesn't show hand 
*** SUMMARY ***
Total pot $0.20 | Rake $0 
Seat 1: lgP2sg9oZJsNSXCt7tbwRg (button) folded before Flop (didn't bet)
Seat 2: CCxAG7iPVlAv3brCqrGBEg (small blind) folded before Flop
Seat 3: iauW7L/+7qzAuHow7CD75Q (big blind) collected ($0.20)
Seat 4: B6R6e73iyJNddUtXtvYr3Q folded before Flop (didn't bet)
Seat 5: 8ClCHtFXGNplITm+63KB+Q folded before Flop (didn't bet)
Seat 6: BvTq4Tu0zBOsniW3eFCnkQ folded before Flop (didn't bet)




PokerStars Game #59939458408:  Hold'em No Limit ($0.10/$0.25) - 2009/07/01 0:40:24 ET
Table 'i93c3z9RLowvuJTKA2F4Jg' 6-max Seat #2 is the button
Seat 1: tbSZq5LHglyHk61mH9eDBw ($35.50 in chips) 
Seat 2: TSmua8tGK3sTbwi0ynrW9Q ($25 in chips) 
Seat 3: tVIFo6yuan1xauX1WIjH2w ($7.85 in chips) 
Seat 4: o86X2Q5GEDU3uP9oj1iFZA ($29.30 in chips) 
Seat 5: lYjWCpfCxX2kgcHY3v4Yow ($31.75 in chips) 
Seat 6: aSrj4lVmn2owyQ1RbbOqxQ ($25 in chips) 
tVIFo6yuan1xauX1WIjH2w: posts small blind $0.10
o86X2Q5GEDU3uP9oj1iFZA: posts big blind $0.25
*** HOLE CARDS ***
lYjWCpfCxX2kgcHY3v4Yow: folds 
aSrj4lVmn2owyQ1RbbOqxQ: folds 
tbSZq5LHglyHk61mH9eDBw: calls $0.25
TSmua8tGK3sTbwi0ynrW9Q: folds 
tVIFo6yuan1xauX1WIjH2w: calls $0.15
o86X2Q5GEDU3uP9oj1iFZA: checks 
*** FLOP *** [Ad 3c 9d]
tVIFo6yuan1xauX1WIjH2w: checks 
o86X2Q5GEDU3uP9oj1iFZA: checks 
tbSZq5LHglyHk61mH9eDBw: checks 
*** TURN *** [Ad 3c 9d] [Qc]
tVIFo6yuan1xauX1WIjH2w: checks 
o86X2Q5GEDU3uP9oj1iFZA: checks 
tbSZq5LHglyHk61mH9eDBw: checks 
*** RIVER *** [Ad 3c 9d Qc] [8c]
tVIFo6yuan1xauX1WIjH2w: bets $0.50
o86X2Q5GEDU3uP9oj1iFZA: folds 
tbSZq5LHglyHk61mH9eDBw: calls $0.50
*** SHOW DOWN ***
tVIFo6yuan1xauX1WIjH2w: shows [4c 9c] (a flush, Queen high)
tbSZq5LHglyHk61mH9eDBw: mucks hand 
tVIFo6yuan1xauX1WIjH2w collected $1.70 from pot
*** SUMMARY ***
Total pot $1.75 | Rake $0.05 
Board [Ad 3c 9d Qc 8c]
Seat 1: tbSZq5LHglyHk61mH9eDBw mucked
Seat 2: TSmua8tGK3sTbwi0ynrW9Q (button) folded before Flop (didn't bet)
Seat 3: tVIFo6yuan1xauX1WIjH2w (small blind) showed [4c 9c] and won ($1.70) with a flush, Queen high
Seat 4: o86X2Q5GEDU3uP9oj1iFZA (big blind) folded on the River
Seat 5: lYjWCpfCxX2kgcHY3v4Yow folded before Flop (didn't bet)
Seat 6: aSrj4lVmn2owyQ1RbbOqxQ folded before Flop (didn't bet)




PokerStars Game #59939458630:  Hold'em No Limit ($0.10/$0.25) - 2009/07/01 0:40:24 ET
Table 'mVdLgAdN9rGe6mMwSrDdGQ' 6-max Seat #3 is the button
Seat 1: 1tFjlBNp9g4Qjfo0vKlSzw ($13.15 in chips) 
Seat 2: fSUx4e1vURbgXyDBEcRbAg ($2.35 in chips) 
Seat 3: kG34n23qFQA3nzdOJTQ1dA ($24.30 in chips) 
Seat 5: oseFhpinoe+Zg4j5xyBjyQ ($56.70 in chips) 
Seat 6: Ew/TYPQIsbQ2X8nm5iAJBg ($24.65 in chips) 
oseFhpinoe+Zg4j5xyBjyQ: posts small blind $0.10
Ew/TYPQIsbQ2X8nm5iAJBg: posts big blind $0.25
*** HOLE CARDS ***
1tFjlBNp9g4Qjfo0vKlSzw: folds 
fSUx4e1vURbgXyDBEcRbAg: folds 
kG34n23qFQA3nzdOJTQ1dA: folds 
oseFhpinoe+Zg4j5xyBjyQ: raises $0.25 to $0.50
Ew/TYPQIsbQ2X8nm5iAJBg: calls $0.25
*** FLOP *** [8c 4h Ad]
oseFhpinoe+Zg4j5xyBjyQ: bets $0.50
Ew/TYPQIsbQ2X8nm5iAJBg: calls $0.50
*** TURN *** [8c 4h Ad] [4d]
ant_gigi_10 has returned
oseFhpinoe+Zg4j5xyBjyQ: checks 
Ew/TYPQIsbQ2X8nm5iAJBg: bets $1.25
ant_gigi_10 leaves the table
oseFhpinoe+Zg4j5xyBjyQ: folds 
Uncalled bet ($1.25) returned to Ew/TYPQIsbQ2X8nm5iAJBg
Ew/TYPQIsbQ2X8nm5iAJBg collected $1.95 from pot
Ew/TYPQIsbQ2X8nm5iAJBg: doesn't show hand 
*** SUMMARY ***
Total pot $2 | Rake $0.05 
Board [8c 4h Ad 4d]
Seat 1: 1tFjlBNp9g4Qjfo0vKlSzw folded before Flop (didn't bet)
Seat 2: fSUx4e1vURbgXyDBEcRbAg folded before Flop (didn't bet)
Seat 3: kG34n23qFQA3nzdOJTQ1dA (button) folded before Flop (didn't bet)
Seat 5: oseFhpinoe+Zg4j5xyBjyQ (small blind) folded on the Turn
Seat 6: Ew/TYPQIsbQ2X8nm5iAJBg (big blind) collected ($1.95)




PokerStars Game #59939458632:  Hold'em No Limit ($0.10/$0.25) - 2009/07/01 0:40:24 ET
Table 'sDHjMRwfSiz7+NDdZLUiyA' 9-max Seat #9 is the button
Seat 1: N6fYvIzQLKaydFLKQGtMlQ ($25.65 in chips) 
Seat 2: ljemhp25Zg+nlA9DLCIiUw ($27.50 in chips) 
Seat 4: v5jnQ1gfh9nLla3kMXG7Yg ($16.65 in chips) 
Seat 8: 3hMkm4U5yTRrkGJkxfijaQ ($29.95 in chips) 
Seat 9: Xpyqpb+DURDWnyJ3xTEIFQ ($38.50 in chips) 
N6fYvIzQLKaydFLKQGtMlQ: posts small blind $0.10
ljemhp25Zg+nlA9DLCIiUw: posts big blind $0.25
SGA1WpAnQxFdFAYyt362gQ: sits out 
IGRfskE1v9H9Bn+fz8AgNQ: sits out 
DlXs37dlX3tb7o/7lYXQSw: sits out 
*** HOLE CARDS ***
v5jnQ1gfh9nLla3kMXG7Yg: folds 
3hMkm4U5yTRrkGJkxfijaQ: calls $0.25
Xpyqpb+DURDWnyJ3xTEIFQ: calls $0.25
N6fYvIzQLKaydFLKQGtMlQ: calls $0.15
ljemhp25Zg+nlA9DLCIiUw: checks 
*** FLOP *** [6h 3s 7c]
N6fYvIzQLKaydFLKQGtMlQ: checks 
ljemhp25Zg+nlA9DLCIiUw: checks 
3hMkm4U5yTRrkGJkxfijaQ: checks 
Xpyqpb+DURDWnyJ3xTEIFQ: bets $0.75
N6fYvIzQLKaydFLKQGtMlQ: folds 
ljemhp25Zg+nlA9DLCIiUw: folds 
3hMkm4U5yTRrkGJkxfijaQ: folds 
Uncalled bet ($0.75) returned to Xpyqpb+DURDWnyJ3xTEIFQ
Xpyqpb+DURDWnyJ3xTEIFQ collected $0.95 from pot
*** SUMMARY ***
Total pot $1 | Rake $0.05 
Board [6h 3s 7c]
Seat 1: N6fYvIzQLKaydFLKQGtMlQ (small blind) folded on the Flop
Seat 2: ljemhp25Zg+nlA9DLCIiUw (big blind) folded on the Flop
Seat 4: v5jnQ1gfh9nLla3kMXG7Yg folded before Flop (didn't bet)
Seat 8: 3hMkm4U5yTRrkGJkxfijaQ folded on the Flop
Seat 9: Xpyqpb+DURDWnyJ3xTEIFQ (button) collected ($0.95)




PokerStars Game #59939459040:  Hold'em No Limit ($0.10/$0.25) - 2009/07/01 0:40:24 ET
Table 'VuY5ej47Cy8nOI3Wogmhzw' 6-max Seat #6 is the button
Seat 3: 0n9nsjvz4GIG4IyVHT0JVw ($2.50 in chips) 
Seat 4: FC6tJ9EOiutXO8hnpR4VgQ ($4.65 in chips) 
Seat 6: +v0nBUereMsRzYp2Knh/cQ ($12.50 in chips) 
0n9nsjvz4GIG4IyVHT0JVw: posts small blind $0.10
FC6tJ9EOiutXO8hnpR4VgQ: posts big blind $0.25
*** HOLE CARDS ***
+v0nBUereMsRzYp2Knh/cQ: folds 
0n9nsjvz4GIG4IyVHT0JVw: calls $0.15
FC6tJ9EOiutXO8hnpR4VgQ: raises $2.50 to $2.75
0n9nsjvz4GIG4IyVHT0JVw: calls $2.25 and is all-in
Uncalled bet ($0.25) returned to FC6tJ9EOiutXO8hnpR4VgQ
*** FLOP *** [5h Td 7s]
*** TURN *** [5h Td 7s] [8s]
aXzmR7FhrqQSWNNmNfbVnw joins the table at seat #1 
*** RIVER *** [5h Td 7s 8s] [3d]
*** SHOW DOWN ***
0n9nsjvz4GIG4IyVHT0JVw: shows [2c Jc] (high card Jack)
FC6tJ9EOiutXO8hnpR4VgQ: shows [Ad 9s] (high card Ace)
FC6tJ9EOiutXO8hnpR4VgQ collected $4.75 from pot
*** SUMMARY ***
Total pot $5 | Rake $0.25 
Board [5h Td 7s 8s 3d]
Seat 3: 0n9nsjvz4GIG4IyVHT0JVw (small blind) showed [2c Jc] and lost with high card Jack
Seat 4: FC6tJ9EOiutXO8hnpR4VgQ (big blind) showed [Ad 9s] and won ($4.75) with high card Ace
Seat 6: +v0nBUereMsRzYp2Knh/cQ (button) folded before Flop (didn't bet)




PokerStars Game #59939458466:  Hold'em No Limit ($0.10/$0.25) - 2009/07/01 0:40:24 ET
Table 'tErGGDyESv/0llKumVeZuQ' 9-max Seat #9 is the button
Seat 1: R3KkgiqTvuhazyCqaD9cZg ($11.85 in chips) 
Seat 2: fnmp9YBEeLxBFinW2Sx+pg ($9.60 in chips) 
Seat 4: j1oAjkBBlFRUy+e+LF1vNQ ($3.70 in chips) 
Seat 5: le+pqvOEeS8Vvxt8ogLv/w ($12 in chips) 
Seat 6: zDrucyjVn5aeekNEc3cJrA ($29.25 in chips) 
Seat 7: s7Q6uNouhe7aE8JdFb9E+A ($25.65 in chips) 
Seat 8: Sv38qYH3jj8a8dddDi1aUA ($14.50 in chips) 
Seat 9: r284m4NA4rtNktI86R8/Yw ($14.55 in chips) 
R3KkgiqTvuhazyCqaD9cZg: posts small blind $0.10
fnmp9YBEeLxBFinW2Sx+pg: posts big blind $0.25
CvL9Ch1HYCVbTsfpNucitg: sits out 
*** HOLE CARDS ***
j1oAjkBBlFRUy+e+LF1vNQ: calls $0.25
le+pqvOEeS8Vvxt8ogLv/w: folds 
zDrucyjVn5aeekNEc3cJrA: folds 
s7Q6uNouhe7aE8JdFb9E+A: folds 
Sv38qYH3jj8a8dddDi1aUA: folds 
r284m4NA4rtNktI86R8/Yw: folds 
R3KkgiqTvuhazyCqaD9cZg: folds 
fnmp9YBEeLxBFinW2Sx+pg: checks 
*** FLOP *** [Kc Jd 6d]
fnmp9YBEeLxBFinW2Sx+pg: checks 
j1oAjkBBlFRUy+e+LF1vNQ: bets $0.50
fnmp9YBEeLxBFinW2Sx+pg: folds 
Uncalled bet ($0.50) returned to j1oAjkBBlFRUy+e+LF1vNQ
j1oAjkBBlFRUy+e+LF1vNQ collected $0.60 from pot
j1oAjkBBlFRUy+e+LF1vNQ: doesn't show hand 
*** SUMMARY ***
Total pot $0.60 | Rake $0 
Board [Kc Jd 6d]
Seat 1: R3KkgiqTvuhazyCqaD9cZg (small blind) folded before Flop
Seat 2: fnmp9YBEeLxBFinW2Sx+pg (big blind) folded on the Flop
Seat 4: j1oAjkBBlFRUy+e+LF1vNQ collected ($0.60)
Seat 5: le+pqvOEeS8Vvxt8ogLv/w folded before Flop (didn't bet)
Seat 6: zDrucyjVn5aeekNEc3cJrA folded before Flop (didn't bet)
Seat 7: s7Q6uNouhe7aE8JdFb9E+A folded before Flop (didn't bet)
Seat 8: Sv38qYH3jj8a8dddDi1aUA folded before Flop (didn't bet)
Seat 9: r284m4NA4rtNktI86R8/Yw (button) folded before Flop (didn't bet)




PokerStars Game #59939459508:  Hold'em No Limit ($0.10/$0.25) - 2009/07/01 0:40:25 ET
Table 'SgI2Cobdjtkh0Fd0/eTTDg' 9-max Seat #6 is the button
Seat 1: JRfCWETUoKaEo7sf/Jy3Kg ($24.65 in chips) 
Seat 2: 8B/dhbQjIWe6ASCdgzktNQ ($42.20 in chips) 
Seat 3: OiV1PWZ3IkN29JlmCcnTwQ ($4.90 in chips) 
Seat 4: 18G4P1XstjNvItdGUITxgw ($25 in chips) 
Seat 5: w/RUHfVzKTf7Bc19nucLpQ ($8.05 in chips) 
Seat 6: f8ewQKsexlXbhtBqiLFb8A ($11 in chips) 
Seat 7: aJy680tKSaP5er559aSuGA ($22.45 in chips) 
Seat 9: cZ99hugmLBj9KhTlc8nCSw ($25.90 in chips) 
aJy680tKSaP5er559aSuGA: posts small blind $0.10
cZ99hugmLBj9KhTlc8nCSw: posts big blind $0.25
*** HOLE CARDS ***
JRfCWETUoKaEo7sf/Jy3Kg: calls $0.25
8B/dhbQjIWe6ASCdgzktNQ: folds 
OiV1PWZ3IkN29JlmCcnTwQ: folds 
18G4P1XstjNvItdGUITxgw: folds 
w/RUHfVzKTf7Bc19nucLpQ: raises $0.50 to $0.75
f8ewQKsexlXbhtBqiLFb8A: folds 
f8ewQKsexlXbhtBqiLFb8A leaves the table
aJy680tKSaP5er559aSuGA: folds 
cZ99hugmLBj9KhTlc8nCSw: folds 
JRfCWETUoKaEo7sf/Jy3Kg: calls $0.50
*** FLOP *** [6c Kc 4h]
JRfCWETUoKaEo7sf/Jy3Kg: checks 
w/RUHfVzKTf7Bc19nucLpQ: bets $0.75
JRfCWETUoKaEo7sf/Jy3Kg: folds 
Uncalled bet ($0.75) returned to w/RUHfVzKTf7Bc19nucLpQ
w/RUHfVzKTf7Bc19nucLpQ collected $1.80 from pot
*** SUMMARY ***
Total pot $1.85 | Rake $0.05 
Board [6c Kc 4h]
Seat 1: JRfCWETUoKaEo7sf/Jy3Kg folded on the Flop
Seat 2: 8B/dhbQjIWe6ASCdgzktNQ folded before Flop (didn't bet)
Seat 3: OiV1PWZ3IkN29JlmCcnTwQ folded before Flop (didn't bet)
Seat 4: 18G4P1XstjNvItdGUITxgw folded before Flop (didn't bet)
Seat 5: w/RUHfVzKTf7Bc19nucLpQ collected ($1.80)
Seat 6: f8ewQKsexlXbhtBqiLFb8A (button) folded before Flop (didn't bet)
Seat 7: aJy680tKSaP5er559aSuGA (small blind) folded before Flop
Seat 9: cZ99hugmLBj9KhTlc8nCSw (big blind) folded before Flop




PokerStars Game #59939459582:  Hold'em No Limit ($0.10/$0.25) - 2009/07/01 0:40:25 ET
Table 'iMiAw/kTZXopgYX4HI7sHg' 9-max Seat #8 is the button
Seat 2: qwr38jl5txoR36M7G5qi4A ($7.50 in chips) 
Seat 3: HPEB+AtKw1+C/cxU0o1ciw ($22.55 in chips) 
Seat 4: S+cUFPGjDERB8nh2Ub77Bg ($12.35 in chips) 
Seat 5: UG5jx0ZzlHKfc+tNQpQoMQ ($1.90 in chips) 
Seat 6: mdk0yKND3u0wCmRU4tNRFg ($28.55 in chips) 
Seat 7: aPRz/2GxbXANYpVsQO8pdQ ($24.50 in chips) 
Seat 8: gU2i78hKxj5RUUH6zCK9bA ($6.40 in chips) 
Seat 9: K36tHfxDQBx3OFpy0baDPA ($19.80 in chips) 
K36tHfxDQBx3OFpy0baDPA: posts small blind $0.10
qwr38jl5txoR36M7G5qi4A: posts big blind $0.25
*** HOLE CARDS ***
HPEB+AtKw1+C/cxU0o1ciw: folds 
S+cUFPGjDERB8nh2Ub77Bg: folds 
UG5jx0ZzlHKfc+tNQpQoMQ: folds 
mdk0yKND3u0wCmRU4tNRFg: calls $0.25
aPRz/2GxbXANYpVsQO8pdQ: calls $0.25
gU2i78hKxj5RUUH6zCK9bA: calls $0.25
K36tHfxDQBx3OFpy0baDPA: calls $0.15
1Clf3cPrqoy/YgvWdWK1Xw joins the table at seat #1 
qwr38jl5txoR36M7G5qi4A: checks 
*** FLOP *** [Ah 6c Jh]
K36tHfxDQBx3OFpy0baDPA: checks 
qwr38jl5txoR36M7G5qi4A: checks 
mdk0yKND3u0wCmRU4tNRFg: checks 
aPRz/2GxbXANYpVsQO8pdQ: checks 
gU2i78hKxj5RUUH6zCK9bA: checks 
*** TURN *** [Ah 6c Jh] [Tc]
K36tHfxDQBx3OFpy0baDPA: bets $0.50
qwr38jl5txoR36M7G5qi4A: folds 
mdk0yKND3u0wCmRU4tNRFg: folds 
aPRz/2GxbXANYpVsQO8pdQ: folds 
gU2i78hKxj5RUUH6zCK9bA: folds 
Uncalled bet ($0.50) returned to K36tHfxDQBx3OFpy0baDPA
K36tHfxDQBx3OFpy0baDPA collected $1.20 from pot
K36tHfxDQBx3OFpy0baDPA: doesn't show hand 
*** SUMMARY ***
Total pot $1.25 | Rake $0.05 
Board [Ah 6c Jh Tc]
Seat 2: qwr38jl5txoR36M7G5qi4A (big blind) folded on the Turn
Seat 3: HPEB+AtKw1+C/cxU0o1ciw folded before Flop (didn't bet)
Seat 4: S+cUFPGjDERB8nh2Ub77Bg folded before Flop (didn't bet)
Seat 5: UG5jx0ZzlHKfc+tNQpQoMQ folded before Flop (didn't bet)
Seat 6: mdk0yKND3u0wCmRU4tNRFg folded on the Turn
Seat 7: aPRz/2GxbXANYpVsQO8pdQ folded on the Turn
Seat 8: gU2i78hKxj5RUUH6zCK9bA (button) folded on the Turn
Seat 9: K36tHfxDQBx3OFpy0baDPA (small blind) collected ($1.20)




PokerStars Game #59939459076:  Hold'em No Limit ($0.10/$0.25) - 2009/07/01 0:40:25 ET
Table 'JJzUs04lHpXg6nboT1/jeg' 6-max Seat #4 is the button
Seat 2: mK0/8tWLTEGESD/9ZUEo5A ($10 in chips) 
Seat 3: uUXdcVMNa05rfbntdvplfw ($10.95 in chips) 
Seat 4: nwwpaieDRI0UPyVtChVHOg ($35.85 in chips) 
Seat 5: Vr2XE7yYBdg3RZSURDAPEg ($23.75 in chips) 
Vr2XE7yYBdg3RZSURDAPEg: posts small blind $0.10
mK0/8tWLTEGESD/9ZUEo5A: posts big blind $0.25
*** HOLE CARDS ***
uUXdcVMNa05rfbntdvplfw: raises $0.25 to $0.50
nwwpaieDRI0UPyVtChVHOg: calls $0.50
Vr2XE7yYBdg3RZSURDAPEg: folds 
mK0/8tWLTEGESD/9ZUEo5A: calls $0.25
*** FLOP *** [8h 9s 9h]
mK0/8tWLTEGESD/9ZUEo5A: bets $0.75
uUXdcVMNa05rfbntdvplfw: calls $0.75
nwwpaieDRI0UPyVtChVHOg: folds 
*** TURN *** [8h 9s 9h] [Jc]
starzjenko joins the table at seat #1 
mK0/8tWLTEGESD/9ZUEo5A: bets $1
uUXdcVMNa05rfbntdvplfw: calls $1
*** RIVER *** [8h 9s 9h Jc] [Th]
mK0/8tWLTEGESD/9ZUEo5A: bets $1.25
uUXdcVMNa05rfbntdvplfw: raises $1.25 to $2.50
mK0/8tWLTEGESD/9ZUEo5A: calls $1.25
*** SHOW DOWN ***
uUXdcVMNa05rfbntdvplfw: shows [5s Qs] (a straight, Eight to Queen)
mK0/8tWLTEGESD/9ZUEo5A: mucks hand 
uUXdcVMNa05rfbntdvplfw collected $9.65 from pot
*** SUMMARY ***
Total pot $10.10 | Rake $0.45 
Board [8h 9s 9h Jc Th]
Seat 2: mK0/8tWLTEGESD/9ZUEo5A (big blind) mucked
Seat 3: uUXdcVMNa05rfbntdvplfw showed [5s Qs] and won ($9.65) with a straight, Eight to Queen
Seat 4: nwwpaieDRI0UPyVtChVHOg (button) folded on the Flop
Seat 5: Vr2XE7yYBdg3RZSURDAPEg (small blind) folded before Flop




PokerStars Game #59939459684:  Hold'em No Limit ($0.10/$0.25) - 2009/07/01 0:40:25 ET
Table '2clPgY3+dETPD/8zjXZdFw' 6-max Seat #2 is the button
Seat 1: qllppsCmUqovlriIWCeM/g ($2 in chips) 
Seat 2: NzIFHwilc5zU7QhjDTgTZA ($7.60 in chips) 
Seat 3: 6pF9LtHn+EH0ChbOXzox9g ($5.20 in chips) 
Seat 4: 9KPR3sZ+CxRm7bQ8qxFzMQ ($4.75 in chips) 
6pF9LtHn+EH0ChbOXzox9g: posts small blind $0.10
9KPR3sZ+CxRm7bQ8qxFzMQ: posts big blind $0.25
*** HOLE CARDS ***
qllppsCmUqovlriIWCeM/g: raises $1.75 to $2 and is all-in
NzIFHwilc5zU7QhjDTgTZA: folds 
6pF9LtHn+EH0ChbOXzox9g: folds 
9KPR3sZ+CxRm7bQ8qxFzMQ: calls $1.75
*** FLOP *** [Td 2h Ts]
*** TURN *** [Td 2h Ts] [Js]
*** RIVER *** [Td 2h Ts Js] [Jh]
*** SHOW DOWN ***
9KPR3sZ+CxRm7bQ8qxFzMQ: shows [Qs Kd] (two pair, Jacks and Tens)
qllppsCmUqovlriIWCeM/g: shows [Qd Qc] (two pair, Queens and Jacks)
qllppsCmUqovlriIWCeM/g collected $3.90 from pot
*** SUMMARY ***
Total pot $4.10 | Rake $0.20 
Board [Td 2h Ts Js Jh]
Seat 1: qllppsCmUqovlriIWCeM/g showed [Qd Qc] and won ($3.90) with two pair, Queens and Jacks
Seat 2: NzIFHwilc5zU7QhjDTgTZA (button) folded before Flop (didn't bet)
Seat 3: 6pF9LtHn+EH0ChbOXzox9g (small blind) folded before Flop
Seat 4: 9KPR3sZ+CxRm7bQ8qxFzMQ (big blind) showed [Qs Kd] and lost with two pair, Jacks and Tens




PokerStars Game #59939459210:  Hold'em No Limit ($0.10/$0.25) - 2009/07/01 0:40:25 ET
Table 'rO1I30HnuCPB0M8qEX1TCQ' 9-max Seat #3 is the button
Seat 1: P32tOtZSz+L5ekobAPq2DA ($3.85 in chips) 
Seat 2: 33y9+GmQ3J84RvZXcraRTw ($21.05 in chips) 
Seat 3: 8Waresd9ixnijISc3GUypg ($12.20 in chips) 
Seat 4: spidnpwmoJ1L6yeNW7D5UA ($24.50 in chips) 
Seat 5: HVKi9hnDyvzObpL08/OarQ ($24.75 in chips) 
Seat 6: 6LFELL8V3NTpb0xg7AOyEg ($18.45 in chips) 
Seat 7: 4oA316mXLIui1QY63GXBUg ($30.75 in chips) 
Seat 8: DIBbjEYGs+TVdVgEB/4+3w ($37 in chips) 
Seat 9: PrviAnKmKklf+We6cR33cw ($30.50 in chips) 
spidnpwmoJ1L6yeNW7D5UA: posts small blind $0.10
HVKi9hnDyvzObpL08/OarQ: posts big blind $0.25
*** HOLE CARDS ***
6LFELL8V3NTpb0xg7AOyEg: folds 
4oA316mXLIui1QY63GXBUg: folds 
6LFELL8V3NTpb0xg7AOyEg leaves the table
DIBbjEYGs+TVdVgEB/4+3w: folds 
PrviAnKmKklf+We6cR33cw: folds 
P32tOtZSz+L5ekobAPq2DA: calls $0.25
33y9+GmQ3J84RvZXcraRTw: folds 
8Waresd9ixnijISc3GUypg: calls $0.25
spidnpwmoJ1L6yeNW7D5UA: calls $0.15
HVKi9hnDyvzObpL08/OarQ: checks 
*** FLOP *** [7s 3c Js]
spidnpwmoJ1L6yeNW7D5UA: checks 
HVKi9hnDyvzObpL08/OarQ: checks 
P32tOtZSz+L5ekobAPq2DA: checks 
8Waresd9ixnijISc3GUypg: bets $0.50
spidnpwmoJ1L6yeNW7D5UA: folds 
HVKi9hnDyvzObpL08/OarQ: folds 
P32tOtZSz+L5ekobAPq2DA: folds 
Uncalled bet ($0.50) returned to 8Waresd9ixnijISc3GUypg
8Waresd9ixnijISc3GUypg collected $0.95 from pot
8Waresd9ixnijISc3GUypg: doesn't show hand 
*** SUMMARY ***
Total pot $1 | Rake $0.05 
Board [7s 3c Js]
Seat 1: P32tOtZSz+L5ekobAPq2DA folded on the Flop
Seat 2: 33y9+GmQ3J84RvZXcraRTw folded before Flop (didn't bet)
Seat 3: 8Waresd9ixnijISc3GUypg (button) collected ($0.95)
Seat 4: spidnpwmoJ1L6yeNW7D5UA (small blind) folded on the Flop
Seat 5: HVKi9hnDyvzObpL08/OarQ (big blind) folded on the Flop
Seat 6: 6LFELL8V3NTpb0xg7AOyEg folded before Flop (didn't bet)
Seat 7: 4oA316mXLIui1QY63GXBUg folded before Flop (didn't bet)
Seat 8: DIBbjEYGs+TVdVgEB/4+3w folded before Flop (didn't bet)
Seat 9: PrviAnKmKklf+We6cR33cw folded before Flop (didn't bet)




PokerStars Game #59939459472:  Hold'em No Limit ($0.10/$0.25) - 2009/07/01 0:40:25 ET
Table 'zW+7jPbOLCvlPu+dUGY5WQ' 6-max Seat #3 is the button
Seat 1: JE/wJXmjw3bpdmjwvh2pcg ($21.65 in chips) 
Seat 3: BedjMfrlRfPgSq7CXpPAmg ($63.75 in chips) 
Seat 4: Qv4VzEkN09uD11sjKv02Ig ($36.20 in chips) 
Seat 5: SFmT9ZsVopnukjvAzrxTRg ($55.50 in chips) 
Seat 6: BiLBinPhgpKAYzLgKJVU5A ($21.60 in chips) 
Qv4VzEkN09uD11sjKv02Ig: posts small blind $0.10
SFmT9ZsVopnukjvAzrxTRg: posts big blind $0.25
DXgVFTcE3WofABsNJ5G/nw: sits out 
*** HOLE CARDS ***
BiLBinPhgpKAYzLgKJVU5A: folds 
JE/wJXmjw3bpdmjwvh2pcg: calls $0.25
BedjMfrlRfPgSq7CXpPAmg: folds 
Qv4VzEkN09uD11sjKv02Ig: folds 
SFmT9ZsVopnukjvAzrxTRg: checks 
*** FLOP *** [Ts As 2s]
SFmT9ZsVopnukjvAzrxTRg: checks 
JE/wJXmjw3bpdmjwvh2pcg: checks 
*** TURN *** [Ts As 2s] [6s]
SFmT9ZsVopnukjvAzrxTRg: bets $0.50
JE/wJXmjw3bpdmjwvh2pcg: folds 
Uncalled bet ($0.50) returned to SFmT9ZsVopnukjvAzrxTRg
SFmT9ZsVopnukjvAzrxTRg collected $0.60 from pot
SFmT9ZsVopnukjvAzrxTRg: doesn't show hand 
*** SUMMARY ***
Total pot $0.60 | Rake $0 
Board [Ts As 2s 6s]
Seat 1: JE/wJXmjw3bpdmjwvh2pcg folded on the Turn
Seat 3: BedjMfrlRfPgSq7CXpPAmg (button) folded before Flop (didn't bet)
Seat 4: Qv4VzEkN09uD11sjKv02Ig (small blind) folded before Flop
Seat 5: SFmT9ZsVopnukjvAzrxTRg (big blind) collected ($0.60)
Seat 6: BiLBinPhgpKAYzLgKJVU5A folded before Flop (didn't bet)




PokerStars Game #59939459430:  Hold'em No Limit ($0.10/$0.25) - 2009/07/01 0:40:25 ET
Table 'nRFAYu63wZNzrz/OBgzFTw' 9-max Seat #6 is the button
Seat 2: hJ4uYjNmSZdjrKA8cjZqCA ($20.20 in chips) 
Seat 3: EfRs3ibIxn+c9JDErwwNCg ($28.95 in chips) 
Seat 4: OiV1PWZ3IkN29JlmCcnTwQ ($5.50 in chips) 
Seat 5: vKdukiQ4ktU4yJ0Xx3MKnA ($28.80 in chips) 
Seat 6: DnDcAdn9P0zGovMERigpFA ($25 in chips) 
Seat 7: COsrwJSFHQtxlUcrYtDQPQ ($26.70 in chips) 
Seat 9: SXqVW4Q0evTUVZG6BbUNIA ($29.50 in chips) 
COsrwJSFHQtxlUcrYtDQPQ: posts small blind $0.10
SXqVW4Q0evTUVZG6BbUNIA: posts big blind $0.25
N6fYvIzQLKaydFLKQGtMlQ: sits out 
*** HOLE CARDS ***
hJ4uYjNmSZdjrKA8cjZqCA: folds 
EfRs3ibIxn+c9JDErwwNCg: folds 
amHgC+Q9cpfD/2w2yUtNbw joins the table at seat #8 
OiV1PWZ3IkN29JlmCcnTwQ: folds 
vKdukiQ4ktU4yJ0Xx3MKnA: folds 
DnDcAdn9P0zGovMERigpFA: folds 
COsrwJSFHQtxlUcrYtDQPQ: folds 
Uncalled bet ($0.15) returned to SXqVW4Q0evTUVZG6BbUNIA
SXqVW4Q0evTUVZG6BbUNIA collected $0.20 from pot
SXqVW4Q0evTUVZG6BbUNIA: doesn't show hand 
*** SUMMARY ***
Total pot $0.20 | Rake $0 
Seat 2: hJ4uYjNmSZdjrKA8cjZqCA folded before Flop (didn't bet)
Seat 3: EfRs3ibIxn+c9JDErwwNCg folded before Flop (didn't bet)
Seat 4: OiV1PWZ3IkN29JlmCcnTwQ folded before Flop (didn't bet)
Seat 5: vKdukiQ4ktU4yJ0Xx3MKnA folded before Flop (didn't bet)
Seat 6: DnDcAdn9P0zGovMERigpFA (button) folded before Flop (didn't bet)
Seat 7: COsrwJSFHQtxlUcrYtDQPQ (small blind) folded before Flop
Seat 9: SXqVW4Q0evTUVZG6BbUNIA (big blind) collected ($0.20)




PokerStars Game #59939459424:  Hold'em No Limit ($0.10/$0.25) - 2009/07/01 0:40:25 ET
Table 'xkqAWQFDrFt4p81M8UsoNw' 9-max Seat #2 is the button
Seat 2: z5GxcHlYz/GSz6W2uFiTtg ($35.45 in chips) 
Seat 3: HEUqKs2EYYGGXJCepUdL0g ($7.35 in chips) 
Seat 4: gY+PO8PaVC7pBPH/9HSv6Q ($4.95 in chips) 
Seat 5: OiV1PWZ3IkN29JlmCcnTwQ ($4.55 in chips) 
Seat 6: Yv4fucyyT28mjx8V5lxKJg ($23.25 in chips) 
Seat 7: MG90wfSJZnOejs/KD3vlQQ ($48.05 in chips) 
Seat 9: Wa7bjLwN7ptOQro84PxQGw ($4.75 in chips) 
HEUqKs2EYYGGXJCepUdL0g: posts small blind $0.10
gY+PO8PaVC7pBPH/9HSv6Q: posts big blind $0.25
*** HOLE CARDS ***
OiV1PWZ3IkN29JlmCcnTwQ: folds 
Yv4fucyyT28mjx8V5lxKJg: folds 
MG90wfSJZnOejs/KD3vlQQ: folds 
Wa7bjLwN7ptOQro84PxQGw: folds 
z5GxcHlYz/GSz6W2uFiTtg: raises $0.50 to $0.75
HEUqKs2EYYGGXJCepUdL0g: folds 
gY+PO8PaVC7pBPH/9HSv6Q: folds 
Uncalled bet ($0.50) returned to z5GxcHlYz/GSz6W2uFiTtg
z5GxcHlYz/GSz6W2uFiTtg collected $0.60 from pot
*** SUMMARY ***
Total pot $0.60 | Rake $0 
Seat 2: z5GxcHlYz/GSz6W2uFiTtg (button) collected ($0.60)
Seat 3: HEUqKs2EYYGGXJCepUdL0g (small blind) folded before Flop
Seat 4: gY+PO8PaVC7pBPH/9HSv6Q (big blind) folded before Flop
Seat 5: OiV1PWZ3IkN29JlmCcnTwQ folded before Flop (didn't bet)
Seat 6: Yv4fucyyT28mjx8V5lxKJg folded before Flop (didn't bet)
Seat 7: MG90wfSJZnOejs/KD3vlQQ folded before Flop (didn't bet)
Seat 9: Wa7bjLwN7ptOQro84PxQGw folded before Flop (didn't bet)




PokerStars Game #59939459134:  Hold'em No Limit ($0.10/$0.25) - 2009/07/01 0:40:25 ET
Table 'gnrUwXkIPE0C8xl6cB4Hyw' 9-max Seat #2 is the button
Seat 2: zVd+j+mjRjWkMTxR5u0Rbw ($6 in chips) 
Seat 3: s7Q6uNouhe7aE8JdFb9E+A ($25 in chips) 
Seat 4: vnCdP3GsLTKadDukKcJk/Q ($25 in chips) 
Seat 5: UU+SYM9uvNEpASN41+yAdA ($29.15 in chips) 
Seat 6: W4TLQcZ2TiM73eIgpIvlGg ($23.60 in chips) 
Seat 7: Z9AeOQX3yzuSvKAm/xyovg ($10 in chips) 
Seat 8: oUgIL46CfA9GCdIuN1TVSw ($24 in chips) 
s7Q6uNouhe7aE8JdFb9E+A: posts small blind $0.10
vnCdP3GsLTKadDukKcJk/Q: posts big blind $0.25
Z9AeOQX3yzuSvKAm/xyovg: posts big blind $0.25
*** HOLE CARDS ***
UU+SYM9uvNEpASN41+yAdA: folds 
W4TLQcZ2TiM73eIgpIvlGg: folds 
Z9AeOQX3yzuSvKAm/xyovg: checks 
oUgIL46CfA9GCdIuN1TVSw: folds 
zVd+j+mjRjWkMTxR5u0Rbw: folds 
s7Q6uNouhe7aE8JdFb9E+A: folds 
vnCdP3GsLTKadDukKcJk/Q: checks 
*** FLOP *** [As Kh Qh]
vnCdP3GsLTKadDukKcJk/Q: checks 
oUgIL46CfA9GCdIuN1TVSw said, "ok thats neither fun nor smart"
Z9AeOQX3yzuSvKAm/xyovg: checks 
*** TURN *** [As Kh Qh] [Ts]
vnCdP3GsLTKadDukKcJk/Q: bets $0.50
Z9AeOQX3yzuSvKAm/xyovg: calls $0.50
*** RIVER *** [As Kh Qh Ts] [7c]
UU+SYM9uvNEpASN41+yAdA said, "lol are you mad? gay boy"
UU+SYM9uvNEpASN41+yAdA said, "lol"
vnCdP3GsLTKadDukKcJk/Q: bets $1.25
oUgIL46CfA9GCdIuN1TVSw said, "my brain isnt feeble it canmake rational decisions"
Z9AeOQX3yzuSvKAm/xyovg: raises $2.50 to $3.75
lwrOE80tuooHfIBx/4LUSw joins the table at seat #1 
vnCdP3GsLTKadDukKcJk/Q: calls $2.50
*** SHOW DOWN ***
Z9AeOQX3yzuSvKAm/xyovg: shows [6h Jc] (a straight, Ten to Ace)
vnCdP3GsLTKadDukKcJk/Q: shows [9c Js] (a straight, Ten to Ace)
vnCdP3GsLTKadDukKcJk/Q collected $4.35 from pot
Z9AeOQX3yzuSvKAm/xyovg collected $4.30 from pot
*** SUMMARY ***
Total pot $9.10 | Rake $0.45 
Board [As Kh Qh Ts 7c]
Seat 2: zVd+j+mjRjWkMTxR5u0Rbw (button) folded before Flop (didn't bet)
Seat 3: s7Q6uNouhe7aE8JdFb9E+A (small blind) folded before Flop
Seat 4: vnCdP3GsLTKadDukKcJk/Q (big blind) showed [9c Js] and won ($4.35) with a straight, Ten to Ace
Seat 5: UU+SYM9uvNEpASN41+yAdA folded before Flop (didn't bet)
Seat 6: W4TLQcZ2TiM73eIgpIvlGg folded before Flop (didn't bet)
Seat 7: Z9AeOQX3yzuSvKAm/xyovg showed [6h Jc] and won ($4.30) with a straight, Ten to Ace
Seat 8: oUgIL46CfA9GCdIuN1TVSw folded before Flop (didn't bet)




PokerStars Game #59939459578:  Hold'em No Limit ($0.10/$0.25) - 2009/07/01 0:40:25 ET
Table 'sm5gqEvXgLbkkE4dryW/5g' 6-max Seat #1 is the button
Seat 1: gaPMxLGp9SOj4Lq6t+/0Ig ($13.35 in chips) 
Seat 2: s13YXIlhF/j3TO0bSnT7bA ($18.90 in chips) 
Seat 3: I1TxPvWj8NfG8orglCinNA ($25.35 in chips) 
Seat 4: BedjMfrlRfPgSq7CXpPAmg ($57.65 in chips) 
Seat 5: M+WmDyCD/ZMu/5t6/iH2kw ($73.75 in chips) 
Seat 6: wKFJ513ucluNNiMlkXcDOQ ($25 in chips) 
s13YXIlhF/j3TO0bSnT7bA: posts small blind $0.10
I1TxPvWj8NfG8orglCinNA: posts big blind $0.25
*** HOLE CARDS ***
BedjMfrlRfPgSq7CXpPAmg: raises $0.75 to $1
M+WmDyCD/ZMu/5t6/iH2kw: folds 
wKFJ513ucluNNiMlkXcDOQ: folds 
gaPMxLGp9SOj4Lq6t+/0Ig: folds 
s13YXIlhF/j3TO0bSnT7bA: folds 
I1TxPvWj8NfG8orglCinNA: folds 
Uncalled bet ($0.75) returned to BedjMfrlRfPgSq7CXpPAmg
BedjMfrlRfPgSq7CXpPAmg collected $0.60 from pot
*** SUMMARY ***
Total pot $0.60 | Rake $0 
Seat 1: gaPMxLGp9SOj4Lq6t+/0Ig (button) folded before Flop (didn't bet)
Seat 2: s13YXIlhF/j3TO0bSnT7bA (small blind) folded before Flop
Seat 3: I1TxPvWj8NfG8orglCinNA (big blind) folded before Flop
Seat 4: BedjMfrlRfPgSq7CXpPAmg collected ($0.60)
Seat 5: M+WmDyCD/ZMu/5t6/iH2kw folded before Flop (didn't bet)
Seat 6: wKFJ513ucluNNiMlkXcDOQ folded before Flop (didn't bet)




PokerStars Game #59939460210:  Hold'em No Limit ($0.10/$0.25) - 2009/07/01 0:40:26 ET
Table 'qryc9C/ELyQ3lubOaELNAQ' 6-max Seat #5 is the button
Seat 1: OZc6kkoTwtITj1ZfreJK1A ($27.15 in chips) 
Seat 2: qvQc9BHp2FhQjrltLiBN+w ($14.65 in chips) 
Seat 3: UXRtG8J9PoBZWTsNtqdoDA ($20 in chips) 
Seat 4: v+QfkGiuj9bgtuNoVnDO8w ($29.35 in chips) 
Seat 5: pV5UZbjsgam+HUQEd6G++w ($7.90 in chips) 
Seat 6: t2RfOOoa56xW0ZHJC0+5JQ ($8.80 in chips) 
t2RfOOoa56xW0ZHJC0+5JQ: posts small blind $0.10
OZc6kkoTwtITj1ZfreJK1A: posts big blind $0.25
*** HOLE CARDS ***
qvQc9BHp2FhQjrltLiBN+w: folds 
UXRtG8J9PoBZWTsNtqdoDA: raises $0.25 to $0.50
v+QfkGiuj9bgtuNoVnDO8w: folds 
pV5UZbjsgam+HUQEd6G++w: folds 
t2RfOOoa56xW0ZHJC0+5JQ: folds 
OZc6kkoTwtITj1ZfreJK1A: calls $0.25
*** FLOP *** [5c Qc 2c]
OZc6kkoTwtITj1ZfreJK1A: checks 
UXRtG8J9PoBZWTsNtqdoDA: checks 
*** TURN *** [5c Qc 2c] [Th]
OZc6kkoTwtITj1ZfreJK1A: bets $0.50
UXRtG8J9PoBZWTsNtqdoDA: raises $1 to $1.50
OZc6kkoTwtITj1ZfreJK1A: folds 
Uncalled bet ($1) returned to UXRtG8J9PoBZWTsNtqdoDA
UXRtG8J9PoBZWTsNtqdoDA collected $2 from pot
*** SUMMARY ***
Total pot $2.10 | Rake $0.10 
Board [5c Qc 2c Th]
Seat 1: OZc6kkoTwtITj1ZfreJK1A (big blind) folded on the Turn
Seat 2: qvQc9BHp2FhQjrltLiBN+w folded before Flop (didn't bet)
Seat 3: UXRtG8J9PoBZWTsNtqdoDA collected ($2)
Seat 4: v+QfkGiuj9bgtuNoVnDO8w folded before Flop (didn't bet)
Seat 5: pV5UZbjsgam+HUQEd6G++w (button) folded before Flop (didn't bet)
Seat 6: t2RfOOoa56xW0ZHJC0+5JQ (small blind) folded before Flop




PokerStars Game #59939459984:  Hold'em No Limit ($0.10/$0.25) - 2009/07/01 0:40:26 ET
Table 'IdXp6nyeW4FYaEK4qKCnwQ' 9-max Seat #8 is the button
Seat 1: oZXtkl8jsN0rrT7D/pQTHA ($13.85 in chips) 
Seat 2: HPEB+AtKw1+C/cxU0o1ciw ($28.90 in chips) 
Seat 3: jiyia7h6fmxBdWBkH9lH5A ($3.70 in chips) 
Seat 6: 1K6QGyJP9P9xmRac2fH4OQ ($33.10 in chips) 
Seat 7: CYkY0dNBaYaKs8HVCVn3mQ ($8.45 in chips) 
Seat 8: cZ99hugmLBj9KhTlc8nCSw ($25 in chips) 
oZXtkl8jsN0rrT7D/pQTHA: posts small blind $0.10
HPEB+AtKw1+C/cxU0o1ciw: posts big blind $0.25
*** HOLE CARDS ***
jiyia7h6fmxBdWBkH9lH5A: folds 
1K6QGyJP9P9xmRac2fH4OQ: folds 
CYkY0dNBaYaKs8HVCVn3mQ: raises $0.75 to $1
cZ99hugmLBj9KhTlc8nCSw: folds 
oZXtkl8jsN0rrT7D/pQTHA: calls $0.90
HPEB+AtKw1+C/cxU0o1ciw: folds 
*** FLOP *** [5d 4h 9s]
oZXtkl8jsN0rrT7D/pQTHA: checks 
CYkY0dNBaYaKs8HVCVn3mQ: bets $2
oZXtkl8jsN0rrT7D/pQTHA: folds 
Uncalled bet ($2) returned to CYkY0dNBaYaKs8HVCVn3mQ
CYkY0dNBaYaKs8HVCVn3mQ collected $2.15 from pot
CYkY0dNBaYaKs8HVCVn3mQ: doesn't show hand 
*** SUMMARY ***
Total pot $2.25 | Rake $0.10 
Board [5d 4h 9s]
Seat 1: oZXtkl8jsN0rrT7D/pQTHA (small blind) folded on the Flop
Seat 2: HPEB+AtKw1+C/cxU0o1ciw (big blind) folded before Flop
Seat 3: jiyia7h6fmxBdWBkH9lH5A folded before Flop (didn't bet)
Seat 6: 1K6QGyJP9P9xmRac2fH4OQ folded before Flop (didn't bet)
Seat 7: CYkY0dNBaYaKs8HVCVn3mQ collected ($2.15)
Seat 8: cZ99hugmLBj9KhTlc8nCSw (button) folded before Flop (didn't bet)




PokerStars Game #59939460142:  Hold'em No Limit ($0.10/$0.25) - 2009/07/01 0:40:26 ET
Table 'yZgGBnUGXVCcEJdcqes8tw' 9-max Seat #8 is the button
Seat 1: SXqVW4Q0evTUVZG6BbUNIA ($24.05 in chips) 
Seat 2: MG90wfSJZnOejs/KD3vlQQ ($25 in chips) 
Seat 3: z5GxcHlYz/GSz6W2uFiTtg ($26.65 in chips) 
Seat 4: opOCI2p6kW0tINuVaAqmcQ ($25.70 in chips) 
Seat 5: IGz29GAFM1DpSdXX+wXg3g ($16.90 in chips) 
Seat 6: H9i0g723A2AKb4nSMXqMPQ ($19.95 in chips) 
Seat 7: eC8Pn1D6Y2pct8o62nQfvQ ($28.05 in chips) 
Seat 8: dmYlc+1cjwZMJ7wV+Z0rRg ($24.55 in chips) 
Seat 9: M/9j4wkHH9i1JM51vgi1VA ($30.60 in chips) 
M/9j4wkHH9i1JM51vgi1VA: posts small blind $0.10
SXqVW4Q0evTUVZG6BbUNIA: posts big blind $0.25
*** HOLE CARDS ***
MG90wfSJZnOejs/KD3vlQQ: folds 
z5GxcHlYz/GSz6W2uFiTtg: folds 
opOCI2p6kW0tINuVaAqmcQ: folds 
IGz29GAFM1DpSdXX+wXg3g: folds 
H9i0g723A2AKb4nSMXqMPQ: calls $0.25
eC8Pn1D6Y2pct8o62nQfvQ: folds 
dmYlc+1cjwZMJ7wV+Z0rRg: folds 
M/9j4wkHH9i1JM51vgi1VA: calls $0.15
SXqVW4Q0evTUVZG6BbUNIA: checks 
*** FLOP *** [2s 7s 7c]
M/9j4wkHH9i1JM51vgi1VA: checks 
SXqVW4Q0evTUVZG6BbUNIA: checks 
H9i0g723A2AKb4nSMXqMPQ: checks 
*** TURN *** [2s 7s 7c] [8d]
M/9j4wkHH9i1JM51vgi1VA: checks 
SXqVW4Q0evTUVZG6BbUNIA: checks 
H9i0g723A2AKb4nSMXqMPQ: checks 
*** RIVER *** [2s 7s 7c 8d] [Ad]
M/9j4wkHH9i1JM51vgi1VA: checks 
SXqVW4Q0evTUVZG6BbUNIA: checks 
H9i0g723A2AKb4nSMXqMPQ: bets $0.25
M/9j4wkHH9i1JM51vgi1VA: calls $0.25
SXqVW4Q0evTUVZG6BbUNIA: folds 
*** SHOW DOWN ***
H9i0g723A2AKb4nSMXqMPQ: shows [Qd Ac] (two pair, Aces and Sevens)
M/9j4wkHH9i1JM51vgi1VA: mucks hand 
H9i0g723A2AKb4nSMXqMPQ collected $1.20 from pot
*** SUMMARY ***
Total pot $1.25 | Rake $0.05 
Board [2s 7s 7c 8d Ad]
Seat 1: SXqVW4Q0evTUVZG6BbUNIA (big blind) folded on the River
Seat 2: MG90wfSJZnOejs/KD3vlQQ folded before Flop (didn't bet)
Seat 3: z5GxcHlYz/GSz6W2uFiTtg folded before Flop (didn't bet)
Seat 4: opOCI2p6kW0tINuVaAqmcQ folded before Flop (didn't bet)
Seat 5: IGz29GAFM1DpSdXX+wXg3g folded before Flop (didn't bet)
Seat 6: H9i0g723A2AKb4nSMXqMPQ showed [Qd Ac] and won ($1.20) with two pair, Aces and Sevens
Seat 7: eC8Pn1D6Y2pct8o62nQfvQ folded before Flop (didn't bet)
Seat 8: dmYlc+1cjwZMJ7wV+Z0rRg (button) folded before Flop (didn't bet)
Seat 9: M/9j4wkHH9i1JM51vgi1VA (small blind) mucked




PokerStars Game #59939459828:  Hold'em No Limit ($0.10/$0.25) - 2009/07/01 0:40:26 ET
Table '4mnXP0EWt9mMZYzTIVDQ0w' 9-max Seat #7 is the button
Seat 1: PTFwg4rGxnfVvj2iP1OI2w ($15.35 in chips) 
Seat 2: j4q3p0lesp63b1gZDwLBZw ($6.50 in chips) 
Seat 4: E0iYnEVO2ho7dH3QcCjw7g ($20.45 in chips) 
Seat 5: sSN8Y0AlsBeidZXPKmwXSw ($12.90 in chips) 
Seat 6: n9toqYXSLowQ/sWq842dEQ ($11.50 in chips) 
Seat 7: s1y+qfkBnhgc67+X3ThjeA ($24.55 in chips) 
Seat 8: H9KUl8cmpLgEpOVDA00bCg ($4.40 in chips) 
Seat 9: wbCayoP+N6xpKgOfIqZsbA ($22.20 in chips) 
H9KUl8cmpLgEpOVDA00bCg: posts small blind $0.10
wbCayoP+N6xpKgOfIqZsbA: posts big blind $0.25
*** HOLE CARDS ***
PTFwg4rGxnfVvj2iP1OI2w: calls $0.25
j4q3p0lesp63b1gZDwLBZw: folds 
E0iYnEVO2ho7dH3QcCjw7g: folds 
sSN8Y0AlsBeidZXPKmwXSw: folds 
n9toqYXSLowQ/sWq842dEQ: calls $0.25
s1y+qfkBnhgc67+X3ThjeA: raises $1 to $1.25
H9KUl8cmpLgEpOVDA00bCg: folds 
wbCayoP+N6xpKgOfIqZsbA: folds 
PTFwg4rGxnfVvj2iP1OI2w: calls $1
n9toqYXSLowQ/sWq842dEQ: calls $1
*** FLOP *** [Jh Ad 6c]
PTFwg4rGxnfVvj2iP1OI2w: checks 
n9toqYXSLowQ/sWq842dEQ has timed out
n9toqYXSLowQ/sWq842dEQ: checks 
s1y+qfkBnhgc67+X3ThjeA: bets $1.75
PTFwg4rGxnfVvj2iP1OI2w: folds 
n9toqYXSLowQ/sWq842dEQ: folds 
Uncalled bet ($1.75) returned to s1y+qfkBnhgc67+X3ThjeA
s1y+qfkBnhgc67+X3ThjeA collected $3.90 from pot
*** SUMMARY ***
Total pot $4.10 | Rake $0.20 
Board [Jh Ad 6c]
Seat 1: PTFwg4rGxnfVvj2iP1OI2w folded on the Flop
Seat 2: j4q3p0lesp63b1gZDwLBZw folded before Flop (didn't bet)
Seat 4: E0iYnEVO2ho7dH3QcCjw7g folded before Flop (didn't bet)
Seat 5: sSN8Y0AlsBeidZXPKmwXSw folded before Flop (didn't bet)
Seat 6: n9toqYXSLowQ/sWq842dEQ folded on the Flop
Seat 7: s1y+qfkBnhgc67+X3ThjeA (button) collected ($3.90)
Seat 8: H9KUl8cmpLgEpOVDA00bCg (small blind) folded before Flop
Seat 9: wbCayoP+N6xpKgOfIqZsbA (big blind) folded before Flop




PokerStars Game #59939459704:  Hold'em No Limit ($0.10/$0.25) - 2009/07/01 0:40:26 ET
Table 'KKk6y4pAXeymxYcd0uZLqg' 9-max Seat #3 is the button
Seat 1: HPEB+AtKw1+C/cxU0o1ciw ($24.55 in chips) 
Seat 3: 4oA316mXLIui1QY63GXBUg ($25 in chips) 
Seat 4: GTcLfsDTPqgfHyhY9FNDMw ($14.90 in chips) 
Seat 5: U0VVxBdRWdhRNdbJ+Qky1A ($46.10 in chips) 
Seat 6: LWN1wPrLH+695JIriXxDuw ($11.60 in chips) 
Seat 7: R3KkgiqTvuhazyCqaD9cZg ($10 in chips) 
Seat 8: +2kMBNpY4nF1qNCRd8SJLA ($26.10 in chips) 
Seat 9: j4q3p0lesp63b1gZDwLBZw ($5 in chips) 
GTcLfsDTPqgfHyhY9FNDMw: posts small blind $0.10
U0VVxBdRWdhRNdbJ+Qky1A: posts big blind $0.25
*** HOLE CARDS ***
LWN1wPrLH+695JIriXxDuw: folds 
R3KkgiqTvuhazyCqaD9cZg: calls $0.25
+2kMBNpY4nF1qNCRd8SJLA: folds 
j4q3p0lesp63b1gZDwLBZw: folds 
HPEB+AtKw1+C/cxU0o1ciw: folds 
4oA316mXLIui1QY63GXBUg: folds 
GTcLfsDTPqgfHyhY9FNDMw: folds 
U0VVxBdRWdhRNdbJ+Qky1A: checks 
*** FLOP *** [Kc Ah 4s]
U0VVxBdRWdhRNdbJ+Qky1A: bets $0.25
R3KkgiqTvuhazyCqaD9cZg: calls $0.25
*** TURN *** [Kc Ah 4s] [4h]
U0VVxBdRWdhRNdbJ+Qky1A: checks 
R3KkgiqTvuhazyCqaD9cZg: bets $0.50
U0VVxBdRWdhRNdbJ+Qky1A: folds 
Uncalled bet ($0.50) returned to R3KkgiqTvuhazyCqaD9cZg
R3KkgiqTvuhazyCqaD9cZg collected $1.05 from pot
R3KkgiqTvuhazyCqaD9cZg: doesn't show hand 
*** SUMMARY ***
Total pot $1.10 | Rake $0.05 
Board [Kc Ah 4s 4h]
Seat 1: HPEB+AtKw1+C/cxU0o1ciw folded before Flop (didn't bet)
Seat 3: 4oA316mXLIui1QY63GXBUg (button) folded before Flop (didn't bet)
Seat 4: GTcLfsDTPqgfHyhY9FNDMw (small blind) folded before Flop
Seat 5: U0VVxBdRWdhRNdbJ+Qky1A (big blind) folded on the Turn
Seat 6: LWN1wPrLH+695JIriXxDuw folded before Flop (didn't bet)
Seat 7: R3KkgiqTvuhazyCqaD9cZg collected ($1.05)
Seat 8: +2kMBNpY4nF1qNCRd8SJLA folded before Flop (didn't bet)
Seat 9: j4q3p0lesp63b1gZDwLBZw folded before Flop (didn't bet)




PokerStars Game #59939460724:  Hold'em No Limit ($0.10/$0.25) - 2009/07/01 0:40:27 ET
Table 'oJpFwZj9+FUGHX90Un8s9Q' 6-max Seat #6 is the button
Seat 2: IMmIhmfU3tqkaJABnD21Rg ($19.35 in chips) 
Seat 3: kyRaCIljYA6l33lSKQfNsg ($26.65 in chips) 
Seat 4: IX/nJvz3Mx/Ez6DgueFA4Q ($7.20 in chips) 
Seat 6: Zijzy/UtPWzWVUo81HHVjQ ($40.10 in chips) 
IMmIhmfU3tqkaJABnD21Rg: posts small blind $0.10
kyRaCIljYA6l33lSKQfNsg: posts big blind $0.25
kG34n23qFQA3nzdOJTQ1dA: sits out 
*** HOLE CARDS ***
IX/nJvz3Mx/Ez6DgueFA4Q: calls $0.25
Zijzy/UtPWzWVUo81HHVjQ: folds 
IMmIhmfU3tqkaJABnD21Rg: calls $0.15
kyRaCIljYA6l33lSKQfNsg: checks 
*** FLOP *** [9d 2h 3d]
IMmIhmfU3tqkaJABnD21Rg: bets $0.25
kyRaCIljYA6l33lSKQfNsg: folds 
IX/nJvz3Mx/Ez6DgueFA4Q: folds 
Uncalled bet ($0.25) returned to IMmIhmfU3tqkaJABnD21Rg
IMmIhmfU3tqkaJABnD21Rg collected $0.75 from pot
IMmIhmfU3tqkaJABnD21Rg: doesn't show hand 
*** SUMMARY ***
Total pot $0.75 | Rake $0 
Board [9d 2h 3d]
Seat 2: IMmIhmfU3tqkaJABnD21Rg (small blind) collected ($0.75)
Seat 3: kyRaCIljYA6l33lSKQfNsg (big blind) folded on the Flop
Seat 4: IX/nJvz3Mx/Ez6DgueFA4Q folded on the Flop
Seat 6: Zijzy/UtPWzWVUo81HHVjQ (button) folded before Flop (didn't bet)




PokerStars Game #59939460692:  Hold'em No Limit ($0.10/$0.25) - 2009/07/01 0:40:27 ET
Table '8PD/MTROSMd6Y8mZeykbpg' 6-max Seat #3 is the button
Seat 1: 32YL2ZEp8NT4JB2RVM9euQ ($19.40 in chips) 
Seat 2: wAKC8C/zN0c8V5v13dm9mA ($25 in chips) 
Seat 3: EV5E02/xfaoDNHy7UQ195Q ($26.15 in chips) 
Seat 4: tTBLQIRkkVpjhASe6+jvXQ ($9.45 in chips) 
Seat 5: z3tQwy28dp5FykDJC/wzQw ($12.20 in chips) 
Seat 6: 096oPBXuIkGUyml0gVo5TA ($12.10 in chips) 
tTBLQIRkkVpjhASe6+jvXQ: posts small blind $0.10
z3tQwy28dp5FykDJC/wzQw: posts big blind $0.25
*** HOLE CARDS ***
096oPBXuIkGUyml0gVo5TA: raises $0.25 to $0.50
32YL2ZEp8NT4JB2RVM9euQ: folds 
wAKC8C/zN0c8V5v13dm9mA: folds 
EV5E02/xfaoDNHy7UQ195Q: folds 
tTBLQIRkkVpjhASe6+jvXQ: calls $0.40
z3tQwy28dp5FykDJC/wzQw: folds 
*** FLOP *** [5h 6d Th]
tTBLQIRkkVpjhASe6+jvXQ: bets $0.75
096oPBXuIkGUyml0gVo5TA: calls $0.75
*** TURN *** [5h 6d Th] [Ks]
tTBLQIRkkVpjhASe6+jvXQ: bets $2
096oPBXuIkGUyml0gVo5TA: calls $2
*** RIVER *** [5h 6d Th Ks] [3s]
tTBLQIRkkVpjhASe6+jvXQ: bets $2
096oPBXuIkGUyml0gVo5TA: calls $2
*** SHOW DOWN ***
tTBLQIRkkVpjhASe6+jvXQ: shows [3h 7s] (a pair of Threes)
096oPBXuIkGUyml0gVo5TA: shows [Kd Ah] (a pair of Kings)
096oPBXuIkGUyml0gVo5TA collected $10.25 from pot
*** SUMMARY ***
Total pot $10.75 | Rake $0.50 
Board [5h 6d Th Ks 3s]
Seat 1: 32YL2ZEp8NT4JB2RVM9euQ folded before Flop (didn't bet)
Seat 2: wAKC8C/zN0c8V5v13dm9mA folded before Flop (didn't bet)
Seat 3: EV5E02/xfaoDNHy7UQ195Q (button) folded before Flop (didn't bet)
Seat 4: tTBLQIRkkVpjhASe6+jvXQ (small blind) showed [3h 7s] and lost with a pair of Threes
Seat 5: z3tQwy28dp5FykDJC/wzQw (big blind) folded before Flop
Seat 6: 096oPBXuIkGUyml0gVo5TA showed [Kd Ah] and won ($10.25) with a pair of Kings




PokerStars Game #59939460642:  Hold'em No Limit ($0.10/$0.25) - 2009/07/01 0:40:27 ET
Table 'x7YStLKc8hpt/pTgSetPKA' 9-max Seat #7 is the button
Seat 2: z5GxcHlYz/GSz6W2uFiTtg ($36.25 in chips) 
Seat 3: S7Ki0P+0AIGPuIfGJjW0gg ($25.35 in chips) 
Seat 5: gxyie8xe6lDdpfG4quHtbw ($15.15 in chips) 
Seat 6: Yv4fucyyT28mjx8V5lxKJg ($31.80 in chips) 
Seat 7: +8FtfKCFr23+6O39P+U45Q ($29.50 in chips) 
Seat 8: jeKWRUkMaVn8rEUjnJKqpg ($33.40 in chips) 
Seat 9: nm4Dj/f+jJEwKVsUnKh73g ($22.25 in chips) 
jeKWRUkMaVn8rEUjnJKqpg: posts small blind $0.10
nm4Dj/f+jJEwKVsUnKh73g: posts big blind $0.25
*** HOLE CARDS ***
z5GxcHlYz/GSz6W2uFiTtg: folds 
S7Ki0P+0AIGPuIfGJjW0gg: calls $0.25
gxyie8xe6lDdpfG4quHtbw: calls $0.25
Yv4fucyyT28mjx8V5lxKJg: folds 
+8FtfKCFr23+6O39P+U45Q: folds 
jeKWRUkMaVn8rEUjnJKqpg: calls $0.15
nm4Dj/f+jJEwKVsUnKh73g: checks 
*** FLOP *** [9h 8c Td]
jeKWRUkMaVn8rEUjnJKqpg: checks 
nm4Dj/f+jJEwKVsUnKh73g: checks 
S7Ki0P+0AIGPuIfGJjW0gg: checks 
tYsOBqdU1+x+yFI7zHO7hQ joins the table at seat #1 
gxyie8xe6lDdpfG4quHtbw: bets $0.75
jeKWRUkMaVn8rEUjnJKqpg: folds 
nm4Dj/f+jJEwKVsUnKh73g: calls $0.75
S7Ki0P+0AIGPuIfGJjW0gg: folds 
*** TURN *** [9h 8c Td] [Jh]
upsista joins the table at seat #4 
nm4Dj/f+jJEwKVsUnKh73g: checks 
gxyie8xe6lDdpfG4quHtbw: bets $1.25
nm4Dj/f+jJEwKVsUnKh73g: raises $1.25 to $2.50
gxyie8xe6lDdpfG4quHtbw: calls $1.25
*** RIVER *** [9h 8c Td Jh] [Tc]
nm4Dj/f+jJEwKVsUnKh73g: bets $2.50
gxyie8xe6lDdpfG4quHtbw: calls $2.50
*** SHOW DOWN ***
nm4Dj/f+jJEwKVsUnKh73g: shows [Qc 6s] (a straight, Eight to Queen)
gxyie8xe6lDdpfG4quHtbw: mucks hand 
nm4Dj/f+jJEwKVsUnKh73g collected $11.90 from pot
*** SUMMARY ***
Total pot $12.50 | Rake $0.60 
Board [9h 8c Td Jh Tc]
Seat 2: z5GxcHlYz/GSz6W2uFiTtg folded before Flop (didn't bet)
Seat 3: S7Ki0P+0AIGPuIfGJjW0gg folded on the Flop
Seat 5: gxyie8xe6lDdpfG4quHtbw mucked
Seat 6: Yv4fucyyT28mjx8V5lxKJg folded before Flop (didn't bet)
Seat 7: +8FtfKCFr23+6O39P+U45Q (button) folded before Flop (didn't bet)
Seat 8: jeKWRUkMaVn8rEUjnJKqpg (small blind) folded on the Flop
Seat 9: nm4Dj/f+jJEwKVsUnKh73g (big blind) showed [Qc 6s] and won ($11.90) with a straight, Eight to Queen




PokerStars Game #59939460872:  Hold'em No Limit ($0.10/$0.25) - 2009/07/01 0:40:27 ET
Table '0XPo7K54oZIfG0xlNAcDRwnQC9LRg01NEuKFHF1nrDEw-max Seat #5 is the button
Seat 1: Nj6/PdBvfG79w0yeIjPmmA ($13.95 in chips) 
Seat 2: cPO/1/dTcZpLkQFm3jH3Rg ($32.05 in chips) 
Seat 4: tLM9aw7T3kBEIhQEh1roOg ($7.05 in chips) 
Seat 5: kG34n23qFQA3nzdOJTQ1dA ($29 in chips) 
Seat 6: xQVFeVUDopz+akuEo2wXpQ ($46.35 in chips) 
xQVFeVUDopz+akuEo2wXpQ: posts small blind $0.10
Nj6/PdBvfG79w0yeIjPmmA: posts big blind $0.25
*** HOLE CARDS ***
cPO/1/dTcZpLkQFm3jH3Rg: folds 
tLM9aw7T3kBEIhQEh1roOg: calls $0.25
kG34n23qFQA3nzdOJTQ1dA: folds 
xQVFeVUDopz+akuEo2wXpQ: folds 
Nj6/PdBvfG79w0yeIjPmmA: checks 
*** FLOP *** [Qs Kh 8d]
Nj6/PdBvfG79w0yeIjPmmA: checks 
tLM9aw7T3kBEIhQEh1roOg: checks 
*** TURN *** [Qs Kh 8d] [Jd]
Nj6/PdBvfG79w0yeIjPmmA: bets $1.75
tLM9aw7T3kBEIhQEh1roOg: folds 
Uncalled bet ($1.75) returned to Nj6/PdBvfG79w0yeIjPmmA
Nj6/PdBvfG79w0yeIjPmmA collected $0.60 from pot
*** SUMMARY ***
Total pot $0.60 | Rake $0 
Board [Qs Kh 8d Jd]
Seat 1: Nj6/PdBvfG79w0yeIjPmmA (big blind) collected ($0.60)
Seat 2: cPO/1/dTcZpLkQFm3jH3Rg folded before Flop (didn't bet)
Seat 4: tLM9aw7T3kBEIhQEh1roOg folded on the Turn
Seat 5: kG34n23qFQA3nzdOJTQ1dA (button) folded before Flop (didn't bet)
Seat 6: xQVFeVUDopz+akuEo2wXpQ (small blind) folded before Flop




PokerStars Game #59939460922:  Hold'em No Limit ($0.10/$0.25) - 2009/07/01 0:40:27 ET
Table 'mF3KHGMaTpaBZbtBoyfTeg' 6-max Seat #4 is the button
Seat 1: 0HAB2GdCAM7p7V00xueAVQ ($9.80 in chips) 
Seat 2: 4x9jCqgSw4272dnaIqnanw ($4.50 in chips) 
Seat 3: Hzrn9DZJegEZICufTNYkrg ($14.40 in chips) 
Seat 4: FYepjhAvF8ZdVCmqHIy+eQ ($25.55 in chips) 
Seat 5: sEQx9G5Cu8k1HNdQasxvUA ($28.15 in chips) 
sEQx9G5Cu8k1HNdQasxvUA: posts small blind $0.10
0HAB2GdCAM7p7V00xueAVQ: posts big blind $0.25
*** HOLE CARDS ***
4x9jCqgSw4272dnaIqnanw: folds 
Hzrn9DZJegEZICufTNYkrg: folds 
FYepjhAvF8ZdVCmqHIy+eQ: folds 
sEQx9G5Cu8k1HNdQasxvUA: calls $0.15
0HAB2GdCAM7p7V00xueAVQ: checks 
*** FLOP *** [7c Td 2d]
sEQx9G5Cu8k1HNdQasxvUA: checks 
0HAB2GdCAM7p7V00xueAVQ: checks 
*** TURN *** [7c Td 2d] [3d]
sEQx9G5Cu8k1HNdQasxvUA: checks 
0HAB2GdCAM7p7V00xueAVQ: checks 
*** RIVER *** [7c Td 2d 3d] [4c]
sEQx9G5Cu8k1HNdQasxvUA: checks 
0HAB2GdCAM7p7V00xueAVQ: bets $0.75
sEQx9G5Cu8k1HNdQasxvUA: folds 
Uncalled bet ($0.75) returned to 0HAB2GdCAM7p7V00xueAVQ
0HAB2GdCAM7p7V00xueAVQ collected $0.50 from pot
0HAB2GdCAM7p7V00xueAVQ: doesn't show hand 
*** SUMMARY ***
Total pot $0.50 | Rake $0 
Board [7c Td 2d 3d 4c]
Seat 1: 0HAB2GdCAM7p7V00xueAVQ (big blind) collected ($0.50)
Seat 2: 4x9jCqgSw4272dnaIqnanw folded before Flop (didn't bet)
Seat 3: Hzrn9DZJegEZICufTNYkrg folded before Flop (didn't bet)
Seat 4: FYepjhAvF8ZdVCmqHIy+eQ (button) folded before Flop (didn't bet)
Seat 5: sEQx9G5Cu8k1HNdQasxvUA (small blind) folded on the River




PokerStars Game #59939460488:  Hold'em No Limit ($0.10/$0.25) - 2009/07/01 0:40:27 ET
Table 'M7d9IrgQUUFFy/SZ3ksLYg' 6-max Seat #3 is the button
Seat 1: cPO/1/dTcZpLkQFm3jH3Rg ($34.20 in chips) 
Seat 2: JE/wJXmjw3bpdmjwvh2pcg ($25 in chips) 
Seat 3: eHsmIvAb2JREg4O6hNPnXg ($15.70 in chips) 
Seat 4: 7FmwVDcdEtxDpHmP4hOXsQ ($30 in chips) 
Seat 6: /gJNBeCkWL4o85/jvlZ4BA ($25.50 in chips) 
7FmwVDcdEtxDpHmP4hOXsQ: posts small blind $0.10
/gJNBeCkWL4o85/jvlZ4BA: posts big blind $0.25
*** HOLE CARDS ***
cPO/1/dTcZpLkQFm3jH3Rg: folds 
JE/wJXmjw3bpdmjwvh2pcg: folds 
eHsmIvAb2JREg4O6hNPnXg: raises $0.50 to $0.75
7FmwVDcdEtxDpHmP4hOXsQ: folds 
/gJNBeCkWL4o85/jvlZ4BA: folds 
Uncalled bet ($0.50) returned to eHsmIvAb2JREg4O6hNPnXg
eHsmIvAb2JREg4O6hNPnXg collected $0.60 from pot
*** SUMMARY ***
Total pot $0.60 | Rake $0 
Seat 1: cPO/1/dTcZpLkQFm3jH3Rg folded before Flop (didn't bet)
Seat 2: JE/wJXmjw3bpdmjwvh2pcg folded before Flop (didn't bet)
Seat 3: eHsmIvAb2JREg4O6hNPnXg (button) collected ($0.60)
Seat 4: 7FmwVDcdEtxDpHmP4hOXsQ (small blind) folded before Flop
Seat 6: /gJNBeCkWL4o85/jvlZ4BA (big blind) folded before Flop




PokerStars Game #59939460376:  Hold'em No Limit ($0.10/$0.25) - 2009/07/01 0:40:27 ET
Table 'gkdjhbH1jaE3hwhPRIKMiQ' 6-max Seat #5 is the button
Seat 1: nc79pm0LZRdhncq55evVqA ($25.35 in chips) 
Seat 2: 1NNFfYMd5Hsphl/FYz9fNA ($33.30 in chips) 
Seat 4: 7uqewvdd5+KjmM7wl58k+w ($14.95 in chips) 
Seat 5: Ew/TYPQIsbQ2X8nm5iAJBg ($25.90 in chips) 
Seat 6: wqphQtauX5Qn7WRJZS1flA ($26.10 in chips) 
wqphQtauX5Qn7WRJZS1flA: posts small blind $0.10
nc79pm0LZRdhncq55evVqA: posts big blind $0.25
kG34n23qFQA3nzdOJTQ1dA: sits out 
*** HOLE CARDS ***
1NNFfYMd5Hsphl/FYz9fNA: folds 
7uqewvdd5+KjmM7wl58k+w: folds 
Ew/TYPQIsbQ2X8nm5iAJBg: folds 
wqphQtauX5Qn7WRJZS1flA: raises $0.50 to $0.75
nc79pm0LZRdhncq55evVqA: folds 
Uncalled bet ($0.50) returned to wqphQtauX5Qn7WRJZS1flA
wqphQtauX5Qn7WRJZS1flA collected $0.50 from pot
wqphQtauX5Qn7WRJZS1flA: doesn't show hand 
*** SUMMARY ***
Total pot $0.50 | Rake $0 
Seat 1: nc79pm0LZRdhncq55evVqA (big blind) folded before Flop
Seat 2: 1NNFfYMd5Hsphl/FYz9fNA folded before Flop (didn't bet)
Seat 4: 7uqewvdd5+KjmM7wl58k+w folded before Flop (didn't bet)
Seat 5: Ew/TYPQIsbQ2X8nm5iAJBg (button) folded before Flop (didn't bet)
Seat 6: wqphQtauX5Qn7WRJZS1flA (small blind) collected ($0.50)




PokerStars Game #59939461628:  Hold'em No Limit ($0.10/$0.25) - 2009/07/01 0:40:28 ET
Table 'Xi38lWH8L2JHRAsKYVX8Qg' 6-max Seat #6 is the button
Seat 1: AqQ7DFpHkgIzTwDu+rClcg ($5.60 in chips) 
Seat 2: YjCHRUY3WJtHMnkcRxvmug ($40.55 in chips) 
Seat 3: hFvl367f+GnfQv2riJlsTA ($11.05 in chips) 
Seat 4: d0J1xuhsynEY81YHwAvJ5g ($25 in chips) 
Seat 6: aogAb4Eienxztk8p2v9VVw ($21 in chips) 
AqQ7DFpHkgIzTwDu+rClcg: posts small blind $0.10
YjCHRUY3WJtHMnkcRxvmug: posts big blind $0.25
79ID/ub1Pt/mDpCprVmOoA: sits out 
*** HOLE CARDS ***
hFvl367f+GnfQv2riJlsTA: folds 
d0J1xuhsynEY81YHwAvJ5g: folds 
aogAb4Eienxztk8p2v9VVw: raises $0.75 to $1
AqQ7DFpHkgIzTwDu+rClcg: folds 
hFvl367f+GnfQv2riJlsTA is sitting out
YjCHRUY3WJtHMnkcRxvmug: calls $0.75
*** FLOP *** [Tc 8h 6d]
YjCHRUY3WJtHMnkcRxvmug: checks 
hFvl367f+GnfQv2riJlsTA leaves the table
aogAb4Eienxztk8p2v9VVw: bets $1.50
YjCHRUY3WJtHMnkcRxvmug: folds 
Uncalled bet ($1.50) returned to aogAb4Eienxztk8p2v9VVw
aogAb4Eienxztk8p2v9VVw collected $2 from pot
aogAb4Eienxztk8p2v9VVw: doesn't show hand 
*** SUMMARY ***
Total pot $2.10 | Rake $0.10 
Board [Tc 8h 6d]
Seat 1: AqQ7DFpHkgIzTwDu+rClcg (small blind) folded before Flop
Seat 2: YjCHRUY3WJtHMnkcRxvmug (big blind) folded on the Flop
Seat 3: hFvl367f+GnfQv2riJlsTA folded before Flop (didn't bet)
Seat 4: d0J1xuhsynEY81YHwAvJ5g folded before Flop (didn't bet)
Seat 6: aogAb4Eienxztk8p2v9VVw (button) collected ($2)




PokerStars Game #59939461156:  Hold'em No Limit ($0.10/$0.25) - 2009/07/01 0:40:28 ET
Table 'WEMI3Mtn7dGARDbgNrKibgQvLFJzpzymuOsaaRYi+8fgx Seat #5 is the button
Seat 2: R6nIVAjK7uhK3Hj0f85A+A ($23.70 in chips) 
Seat 3: W+vSAd2K80ck4uMklFb1OA ($5.95 in chips) 
Seat 5: MG90wfSJZnOejs/KD3vlQQ ($25 in chips) 
Seat 6: /bZlLwyIh+PmlqdCRwfoTg ($14.95 in chips) 
Seat 7: rQhYIYXSyH/IivYM1dlV5A ($16.40 in chips) 
/bZlLwyIh+PmlqdCRwfoTg: posts small blind $0.10
rQhYIYXSyH/IivYM1dlV5A: posts big blind $0.25
*** HOLE CARDS ***
R6nIVAjK7uhK3Hj0f85A+A: raises $0.40 to $0.65
DdyXKuBx0HAOC7dWZmGxWg joins the table at seat #8 
W+vSAd2K80ck4uMklFb1OA: folds 
MG90wfSJZnOejs/KD3vlQQ: calls $0.65
/bZlLwyIh+PmlqdCRwfoTg: folds 
rQhYIYXSyH/IivYM1dlV5A: folds 
*** FLOP *** [8s Qh 2d]
R6nIVAjK7uhK3Hj0f85A+A: checks 
Usqbnp9zov0ml3vx5zES7w joins the table at seat #4 
MG90wfSJZnOejs/KD3vlQQ: bets $1.30
R6nIVAjK7uhK3Hj0f85A+A: folds 
Uncalled bet ($1.30) returned to MG90wfSJZnOejs/KD3vlQQ
MG90wfSJZnOejs/KD3vlQQ collected $1.60 from pot
MG90wfSJZnOejs/KD3vlQQ: doesn't show hand 
*** SUMMARY ***
Total pot $1.65 | Rake $0.05 
Board [8s Qh 2d]
Seat 2: R6nIVAjK7uhK3Hj0f85A+A folded on the Flop
Seat 3: W+vSAd2K80ck4uMklFb1OA folded before Flop (didn't bet)
Seat 5: MG90wfSJZnOejs/KD3vlQQ (button) collected ($1.60)
Seat 6: /bZlLwyIh+PmlqdCRwfoTg (small blind) folded before Flop
Seat 7: rQhYIYXSyH/IivYM1dlV5A (big blind) folded before Flop




PokerStars Game #59939461408:  Hold'em No Limit ($0.10/$0.25) - 2009/07/01 0:40:28 ET
Table 'ZEXL6Wh4qA4Afx8NnoBBAA' 6-max Seat #1 is the button
Seat 1: qo39V8/pMxxofM2aciLSWQ ($95.10 in chips) 
Seat 4: fZQg9veL7Dd/Z04ZTjC+wQ ($32.15 in chips) 
Seat 6: 3rZnxe2K3O+xcVdF94i8lA ($15.80 in chips) 
WrLI51S2iMb8GLMB83gGqA will be allowed to play after the button
fZQg9veL7Dd/Z04ZTjC+wQ: posts small blind $0.10
3rZnxe2K3O+xcVdF94i8lA: posts big blind $0.25
*** HOLE CARDS ***
qo39V8/pMxxofM2aciLSWQ: folds 
fZQg9veL7Dd/Z04ZTjC+wQ: calls $0.15
3rZnxe2K3O+xcVdF94i8lA: checks 
*** FLOP *** [6h As 2s]
fZQg9veL7Dd/Z04ZTjC+wQ: checks 
3rZnxe2K3O+xcVdF94i8lA: bets $0.75
fZQg9veL7Dd/Z04ZTjC+wQ: folds 
Uncalled bet ($0.75) returned to 3rZnxe2K3O+xcVdF94i8lA
3rZnxe2K3O+xcVdF94i8lA collected $0.50 from pot
3rZnxe2K3O+xcVdF94i8lA: doesn't show hand 
*** SUMMARY ***
Total pot $0.50 | Rake $0 
Board [6h As 2s]
Seat 1: qo39V8/pMxxofM2aciLSWQ (button) folded before Flop (didn't bet)
Seat 4: fZQg9veL7Dd/Z04ZTjC+wQ (small blind) folded on the Flop
Seat 6: 3rZnxe2K3O+xcVdF94i8lA (big blind) collected ($0.50)




PokerStars Game #59939461226:  Hold'em No Limit ($0.10/$0.25) - 2009/07/01 0:40:28 ET
Table '5SUMWYuPsGiOD0FY0QbgOw' 6-max Seat #1 is the button
Seat 1: pq78iqNUnoL9mPwPKXxOzg ($14.30 in chips) 
Seat 2: wKFJ513ucluNNiMlkXcDOQ ($25.05 in chips) 
Seat 3: JUE7yMMP0aN5jzhYbdqO6Q ($30.30 in chips) 
Seat 4: hln5cQA1YXs/ERC2LEyoSA ($6 in chips) 
Seat 5: v+QfkGiuj9bgtuNoVnDO8w ($28.70 in chips) 
Seat 6: jA7YMtfNUnAaebB7Lj74EA ($29.85 in chips) 
wKFJ513ucluNNiMlkXcDOQ: posts small blind $0.10
JUE7yMMP0aN5jzhYbdqO6Q: posts big blind $0.25
*** HOLE CARDS ***
hln5cQA1YXs/ERC2LEyoSA: raises $0.75 to $1
v+QfkGiuj9bgtuNoVnDO8w: folds 
jA7YMtfNUnAaebB7Lj74EA: calls $1
pq78iqNUnoL9mPwPKXxOzg: folds 
wKFJ513ucluNNiMlkXcDOQ: folds 
JUE7yMMP0aN5jzhYbdqO6Q: folds 
*** FLOP *** [6c 5c 5h]
hln5cQA1YXs/ERC2LEyoSA: bets $1
jA7YMtfNUnAaebB7Lj74EA: calls $1
*** TURN *** [6c 5c 5h] [Jh]
hln5cQA1YXs/ERC2LEyoSA: checks 
jA7YMtfNUnAaebB7Lj74EA: bets $2
hln5cQA1YXs/ERC2LEyoSA: raises $2 to $4 and is all-in
jA7YMtfNUnAaebB7Lj74EA: calls $2
*** RIVER *** [6c 5c 5h Jh] [Kd]
*** SHOW DOWN ***
hln5cQA1YXs/ERC2LEyoSA: shows [Kh Ac] (two pair, Kings and Fives)
jA7YMtfNUnAaebB7Lj74EA: mucks hand 
hln5cQA1YXs/ERC2LEyoSA collected $11.75 from pot
*** SUMMARY ***
Total pot $12.35 | Rake $0.60 
Board [6c 5c 5h Jh Kd]
Seat 1: pq78iqNUnoL9mPwPKXxOzg (button) folded before Flop (didn't bet)
Seat 2: wKFJ513ucluNNiMlkXcDOQ (small blind) folded before Flop
Seat 3: JUE7yMMP0aN5jzhYbdqO6Q (big blind) folded before Flop
Seat 4: hln5cQA1YXs/ERC2LEyoSA showed [Kh Ac] and won ($11.75) with two pair, Kings and Fives
Seat 5: v+QfkGiuj9bgtuNoVnDO8w folded before Flop (didn't bet)
Seat 6: jA7YMtfNUnAaebB7Lj74EA mucked




PokerStars Game #59939461304:  Hold'em No Limit ($0.10/$0.25) - 2009/07/01 0:40:28 ET
Table 'luMgmRPIo47e7iXDlheIwA' 6-max Seat #2 is the button
Seat 2: 4YSTu0Cdzpppe1lUgCZGCQ ($35 in chips) 
Seat 3: W6Y6au0wf7gRAlqJYgOezw ($14.85 in chips) 
Seat 4: n2OZezRXTtdzQt4SuIy8TQ ($26 in chips) 
Seat 5: kG34n23qFQA3nzdOJTQ1dA ($46.55 in chips) 
W6Y6au0wf7gRAlqJYgOezw: posts small blind $0.10
n2OZezRXTtdzQt4SuIy8TQ: posts big blind $0.25
*** HOLE CARDS ***
kG34n23qFQA3nzdOJTQ1dA: folds 
4YSTu0Cdzpppe1lUgCZGCQ: raises $0.75 to $1
W6Y6au0wf7gRAlqJYgOezw: folds 
n2OZezRXTtdzQt4SuIy8TQ: folds 
Uncalled bet ($0.75) returned to 4YSTu0Cdzpppe1lUgCZGCQ
4YSTu0Cdzpppe1lUgCZGCQ collected $0.60 from pot
*** SUMMARY ***
Total pot $0.60 | Rake $0 
Seat 2: 4YSTu0Cdzpppe1lUgCZGCQ (button) collected ($0.60)
Seat 3: W6Y6au0wf7gRAlqJYgOezw (small blind) folded before Flop
Seat 4: n2OZezRXTtdzQt4SuIy8TQ (big blind) folded before Flop
Seat 5: kG34n23qFQA3nzdOJTQ1dA folded before Flop (didn't bet)




PokerStars Game #59939461052:  Hold'em No Limit ($0.10/$0.25) - 2009/07/01 0:40:28 ET
Table '8QBBaev+cI2i/r2H6ml/lg' 9-max Seat #9 is the button
Seat 4: ZoG0obuajzVjwgd7lNHjgg ($2.40 in chips) 
Seat 9: Ml2bY77EHbM51ZWD7dnIWg ($3 in chips) 
Ml2bY77EHbM51ZWD7dnIWg: posts small blind $0.10
ZoG0obuajzVjwgd7lNHjgg: posts big blind $0.25
*** HOLE CARDS ***
Ml2bY77EHbM51ZWD7dnIWg: calls $0.15
ZoG0obuajzVjwgd7lNHjgg: checks 
*** FLOP *** [Ac 2h 2c]
ZoG0obuajzVjwgd7lNHjgg: checks 
Ml2bY77EHbM51ZWD7dnIWg: checks 
*** TURN *** [Ac 2h 2c] [4s]
ZoG0obuajzVjwgd7lNHjgg: checks 
Ml2bY77EHbM51ZWD7dnIWg: checks 
*** RIVER *** [Ac 2h 2c 4s] [7s]
ZoG0obuajzVjwgd7lNHjgg: bets $0.50
Ml2bY77EHbM51ZWD7dnIWg: raises $0.50 to $1
cxE+szmvEUe7vE+z2ozM2Q joins the table at seat #6 
ZoG0obuajzVjwgd7lNHjgg: folds 
Uncalled bet ($0.50) returned to Ml2bY77EHbM51ZWD7dnIWg
Ml2bY77EHbM51ZWD7dnIWg collected $1.45 from pot
*** SUMMARY ***
Total pot $1.50 | Rake $0.05 
Board [Ac 2h 2c 4s 7s]
Seat 4: ZoG0obuajzVjwgd7lNHjgg (big blind) folded on the River
Seat 9: Ml2bY77EHbM51ZWD7dnIWg (button) (small blind) collected ($1.45)




PokerStars Game #59939461780:  Hold'em No Limit ($0.10/$0.25) - 2009/07/01 0:40:29 ET
Table 'AHkg4ChqzcMauBx6Qvz8Nw' 6-max Seat #6 is the button
Seat 1: b32FRB7ak2jmfrI8EsDhfQ ($6.40 in chips) 
Seat 2: /bjna2FTN7pPjqYGzmDE0Q ($22.05 in chips) 
Seat 3: Zi4SmoY9XJ0iI6ixiSZaWQ ($8.75 in chips) 
Seat 4: N7O9jUEx2YiQn1+yRYTHmw ($26.10 in chips) 
Seat 5: LtASJ9OlkqGrrUKGQlpGAw ($37.05 in chips) 
Seat 6: SFmT9ZsVopnukjvAzrxTRg ($53.05 in chips) 
b32FRB7ak2jmfrI8EsDhfQ: posts small blind $0.10
/bjna2FTN7pPjqYGzmDE0Q: posts big blind $0.25
*** HOLE CARDS ***
Zi4SmoY9XJ0iI6ixiSZaWQ: folds 
N7O9jUEx2YiQn1+yRYTHmw: folds 
LtASJ9OlkqGrrUKGQlpGAw: folds 
SFmT9ZsVopnukjvAzrxTRg: folds 
b32FRB7ak2jmfrI8EsDhfQ: calls $0.15
/bjna2FTN7pPjqYGzmDE0Q: checks 
*** FLOP *** [9d Kd 6s]
b32FRB7ak2jmfrI8EsDhfQ: bets $1
/bjna2FTN7pPjqYGzmDE0Q: folds 
Uncalled bet ($1) returned to b32FRB7ak2jmfrI8EsDhfQ
b32FRB7ak2jmfrI8EsDhfQ collected $0.50 from pot
*** SUMMARY ***
Total pot $0.50 | Rake $0 
Board [9d Kd 6s]
Seat 1: b32FRB7ak2jmfrI8EsDhfQ (small blind) collected ($0.50)
Seat 2: /bjna2FTN7pPjqYGzmDE0Q (big blind) folded on the Flop
Seat 3: Zi4SmoY9XJ0iI6ixiSZaWQ folded before Flop (didn't bet)
Seat 4: N7O9jUEx2YiQn1+yRYTHmw folded before Flop (didn't bet)
Seat 5: LtASJ9OlkqGrrUKGQlpGAw folded before Flop (didn't bet)
Seat 6: SFmT9ZsVopnukjvAzrxTRg (button) folded before Flop (didn't bet)




PokerStars Game #59939461680:  Hold'em No Limit ($0.10/$0.25) - 2009/07/01 0:40:29 ET
Table 'rjcb+nlE+0GuJ6lBhuCkkA' 6-max Seat #4 is the button
Seat 1: 9jSiy0meE9XJKkdIZwyTEQ ($26.05 in chips) 
Seat 2: d9ecz4Yhx6qRKe5k+fUWdw ($18.95 in chips) 
Seat 3: 8ClCHtFXGNplITm+63KB+Q ($25 in chips) 
Seat 4: NzIFHwilc5zU7QhjDTgTZA ($13.05 in chips) 
Seat 5: GC/9yVD59DUCX7hUI7gcLw ($43 in chips) 
Seat 6: 0DvgWV5o6c/jYqQCjm4Haw ($34 in chips) 
GC/9yVD59DUCX7hUI7gcLw: posts small blind $0.10
0DvgWV5o6c/jYqQCjm4Haw: posts big blind $0.25
*** HOLE CARDS ***
9jSiy0meE9XJKkdIZwyTEQ: folds 
d9ecz4Yhx6qRKe5k+fUWdw: calls $0.25
8ClCHtFXGNplITm+63KB+Q: folds 
NzIFHwilc5zU7QhjDTgTZA: folds 
GC/9yVD59DUCX7hUI7gcLw: calls $0.15
0DvgWV5o6c/jYqQCjm4Haw: checks 
*** FLOP *** [Kd Ks 6d]
GC/9yVD59DUCX7hUI7gcLw: bets $0.75
0DvgWV5o6c/jYqQCjm4Haw: folds 
d9ecz4Yhx6qRKe5k+fUWdw: folds 
Uncalled bet ($0.75) returned to GC/9yVD59DUCX7hUI7gcLw
GC/9yVD59DUCX7hUI7gcLw collected $0.75 from pot
*** SUMMARY ***
Total pot $0.75 | Rake $0 
Board [Kd Ks 6d]
Seat 1: 9jSiy0meE9XJKkdIZwyTEQ folded before Flop (didn't bet)
Seat 2: d9ecz4Yhx6qRKe5k+fUWdw folded on the Flop
Seat 3: 8ClCHtFXGNplITm+63KB+Q folded before Flop (didn't bet)
Seat 4: NzIFHwilc5zU7QhjDTgTZA (button) folded before Flop (didn't bet)
Seat 5: GC/9yVD59DUCX7hUI7gcLw (small blind) collected ($0.75)
Seat 6: 0DvgWV5o6c/jYqQCjm4Haw (big blind) folded on the Flop




PokerStars Game #59939462276:  Hold'em No Limit ($0.10/$0.25) - 2009/07/01 0:40:29 ET
Table '6aL2C8IFwHHr6SG6RgXaow' 9-max Seat #9 is the button
Seat 2: +gMmKt3DaQng9M42CmxIZg ($24.30 in chips) 
Seat 5: wre31HfyzQGpIvID1istxw ($14.35 in chips) 
Seat 6: HxDF4QSxC4z39D7teZpprQ ($35.50 in chips) 
Seat 7: rPToQDbLWB+dKnz7fcQSIg ($8.30 in chips) 
Seat 8: rQhYIYXSyH/IivYM1dlV5A ($13.90 in chips) 
Seat 9: yduPKWPzL8YlT5Zv/Nmrwg ($17.40 in chips) 
+gMmKt3DaQng9M42CmxIZg: posts small blind $0.10
wre31HfyzQGpIvID1istxw: posts big blind $0.25
*** HOLE CARDS ***
HxDF4QSxC4z39D7teZpprQ: folds 
rPToQDbLWB+dKnz7fcQSIg: folds 
rQhYIYXSyH/IivYM1dlV5A: raises $0.50 to $0.75
yduPKWPzL8YlT5Zv/Nmrwg: raises $0.50 to $1.25
+gMmKt3DaQng9M42CmxIZg: folds 
wre31HfyzQGpIvID1istxw: folds 
rQhYIYXSyH/IivYM1dlV5A: calls $0.50
*** FLOP *** [Js 3s Jc]
tAxW5XKyzLgVZEyECMLCGw joins the table at seat #4 
rQhYIYXSyH/IivYM1dlV5A: bets $1.25
yduPKWPzL8YlT5Zv/Nmrwg: raises $1.25 to $2.50
rQhYIYXSyH/IivYM1dlV5A: calls $1.25
*** TURN *** [Js 3s Jc] [Qc]
rQhYIYXSyH/IivYM1dlV5A: bets $2.75
yduPKWPzL8YlT5Zv/Nmrwg: folds 
Uncalled bet ($2.75) returned to rQhYIYXSyH/IivYM1dlV5A
rQhYIYXSyH/IivYM1dlV5A collected $7.50 from pot
*** SUMMARY ***
Total pot $7.85 | Rake $0.35 
Board [Js 3s Jc Qc]
Seat 2: +gMmKt3DaQng9M42CmxIZg (small blind) folded before Flop
Seat 5: wre31HfyzQGpIvID1istxw (big blind) folded before Flop
Seat 6: HxDF4QSxC4z39D7teZpprQ folded before Flop (didn't bet)
Seat 7: rPToQDbLWB+dKnz7fcQSIg folded before Flop (didn't bet)
Seat 8: rQhYIYXSyH/IivYM1dlV5A collected ($7.50)
Seat 9: yduPKWPzL8YlT5Zv/Nmrwg (button) folded on the Turn




PokerStars Game #59939462030:  Hold'em No Limit ($0.10/$0.25) - 2009/07/01 0:40:29 ET
Table '5510FxlYzKi+U6MIpo8IPA' 6-max Seat #4 is the button
Seat 1: KM6ogk7SqyRlk3m9b0h+7A ($19.65 in chips) 
Seat 3: v+QfkGiuj9bgtuNoVnDO8w ($29.45 in chips) 
Seat 4: cPO/1/dTcZpLkQFm3jH3Rg ($27.55 in chips) 
Seat 5: 5E1iMY5xyboow7Xm0v7Idw ($12 in chips) 
Seat 6: SFmT9ZsVopnukjvAzrxTRg ($29.10 in chips) 
5E1iMY5xyboow7Xm0v7Idw: posts small blind $0.10
SFmT9ZsVopnukjvAzrxTRg: posts big blind $0.25
*** HOLE CARDS ***
KM6ogk7SqyRlk3m9b0h+7A: raises $0.50 to $0.75
v+QfkGiuj9bgtuNoVnDO8w: folds 
cPO/1/dTcZpLkQFm3jH3Rg: folds 
5E1iMY5xyboow7Xm0v7Idw: calls $0.65
SFmT9ZsVopnukjvAzrxTRg: folds 
*** FLOP *** [5s Jc 2c]
5E1iMY5xyboow7Xm0v7Idw: checks 
KM6ogk7SqyRlk3m9b0h+7A: bets $0.75
5E1iMY5xyboow7Xm0v7Idw: raises $1 to $1.75
KM6ogk7SqyRlk3m9b0h+7A: folds 
Uncalled bet ($1) returned to 5E1iMY5xyboow7Xm0v7Idw
5E1iMY5xyboow7Xm0v7Idw collected $3.10 from pot
*** SUMMARY ***
Total pot $3.25 | Rake $0.15 
Board [5s Jc 2c]
Seat 1: KM6ogk7SqyRlk3m9b0h+7A folded on the Flop
Seat 3: v+QfkGiuj9bgtuNoVnDO8w folded before Flop (didn't bet)
Seat 4: cPO/1/dTcZpLkQFm3jH3Rg (button) folded before Flop (didn't bet)
Seat 5: 5E1iMY5xyboow7Xm0v7Idw (small blind) collected ($3.10)
Seat 6: SFmT9ZsVopnukjvAzrxTRg (big blind) folded before Flop




PokerStars Game #59939462106:  Hold'em No Limit ($0.10/$0.25) - 2009/07/01 0:40:29 ET
Table 'g6ryG70feTw9nNm+XJLuXw' 6-max Seat #4 is the button
Seat 1: v+QfkGiuj9bgtuNoVnDO8w ($27.95 in chips) 
Seat 2: SxIIgwXYLkwd6m3wLyPTCw ($25.25 in chips) 
Seat 3: /6h8PvAHQmfuMUZ8OUF6Xw ($26.05 in chips) 
Seat 4: GC/9yVD59DUCX7hUI7gcLw ($37.90 in chips) 
Seat 5: EE16Ua5b1HSsYej5zeXOlA ($25 in chips) 
EE16Ua5b1HSsYej5zeXOlA: posts small blind $0.10
v+QfkGiuj9bgtuNoVnDO8w: posts big blind $0.25
*** HOLE CARDS ***
SxIIgwXYLkwd6m3wLyPTCw: folds 
/6h8PvAHQmfuMUZ8OUF6Xw: calls $0.25
GC/9yVD59DUCX7hUI7gcLw: folds 
EE16Ua5b1HSsYej5zeXOlA: calls $0.15
v+QfkGiuj9bgtuNoVnDO8w: checks 
*** FLOP *** [8c Ad Td]
EE16Ua5b1HSsYej5zeXOlA: checks 
v+QfkGiuj9bgtuNoVnDO8w: checks 
/6h8PvAHQmfuMUZ8OUF6Xw: checks 
*** TURN *** [8c Ad Td] [Ks]
EE16Ua5b1HSsYej5zeXOlA: checks 
v+QfkGiuj9bgtuNoVnDO8w: checks 
/6h8PvAHQmfuMUZ8OUF6Xw: bets $0.55
EE16Ua5b1HSsYej5zeXOlA: folds 
v+QfkGiuj9bgtuNoVnDO8w: folds 
Uncalled bet ($0.55) returned to /6h8PvAHQmfuMUZ8OUF6Xw
/6h8PvAHQmfuMUZ8OUF6Xw collected $0.75 from pot
/6h8PvAHQmfuMUZ8OUF6Xw: doesn't show hand 
*** SUMMARY ***
Total pot $0.75 | Rake $0 
Board [8c Ad Td Ks]
Seat 1: v+QfkGiuj9bgtuNoVnDO8w (big blind) folded on the Turn
Seat 2: SxIIgwXYLkwd6m3wLyPTCw folded before Flop (didn't bet)
Seat 3: /6h8PvAHQmfuMUZ8OUF6Xw collected ($0.75)
Seat 4: GC/9yVD59DUCX7hUI7gcLw (button) folded before Flop (didn't bet)
Seat 5: EE16Ua5b1HSsYej5zeXOlA (small blind) folded on the Turn




PokerStars Game #59939462244:  Hold'em No Limit ($0.10/$0.25) - 2009/07/01 0:40:29 ET
Table '29D3eoQzK5kOAT0OIDS2uQ' 6-max Seat #1 is the button
Seat 1: kG34n23qFQA3nzdOJTQ1dA ($51.30 in chips) 
Seat 3: z3tQwy28dp5FykDJC/wzQw ($21.30 in chips) 
Seat 4: yzFNNFIfC89bBPwpFPx2ow ($27.10 in chips) 
Seat 5: Q3EMN7b0ie81AFWkDrhCjw ($32.30 in chips) 
Seat 6: bWbV4MVB/vVpiES1Ut4hew ($44.10 in chips) 
tbhYGxTClzdFLMcTtjvJhg is disconnected 
tbhYGxTClzdFLMcTtjvJhg has timed out while disconnected
tbhYGxTClzdFLMcTtjvJhg: is sitting out 
z3tQwy28dp5FykDJC/wzQw: posts small blind $0.10
yzFNNFIfC89bBPwpFPx2ow: posts big blind $0.25
*** HOLE CARDS ***
tbhYGxTClzdFLMcTtjvJhg is connected 
Q3EMN7b0ie81AFWkDrhCjw: raises $0.50 to $0.75
bWbV4MVB/vVpiES1Ut4hew: folds 
kG34n23qFQA3nzdOJTQ1dA: folds 
z3tQwy28dp5FykDJC/wzQw: folds 
yzFNNFIfC89bBPwpFPx2ow: calls $0.50
*** FLOP *** [6d 4d Jh]
yzFNNFIfC89bBPwpFPx2ow: checks 
Q3EMN7b0ie81AFWkDrhCjw: bets $1.75
yzFNNFIfC89bBPwpFPx2ow: folds 
Uncalled bet ($1.75) returned to Q3EMN7b0ie81AFWkDrhCjw
Q3EMN7b0ie81AFWkDrhCjw collected $1.55 from pot
*** SUMMARY ***
Total pot $1.60 | Rake $0.05 
Board [6d 4d Jh]
Seat 1: kG34n23qFQA3nzdOJTQ1dA (button) folded before Flop (didn't bet)
Seat 3: z3tQwy28dp5FykDJC/wzQw (small blind) folded before Flop
Seat 4: yzFNNFIfC89bBPwpFPx2ow (big blind) folded on the Flop
Seat 5: Q3EMN7b0ie81AFWkDrhCjw collected ($1.55)
Seat 6: bWbV4MVB/vVpiES1Ut4hew folded before Flop (didn't bet)




PokerStars Game #59939461942:  Hold'em No Limit ($0.10/$0.25) - 2009/07/01 0:40:29 ET
Table 'ohAuixfiLOYDylNUG5mNUw' 9-max Seat #3 is the button
Seat 1: AtRN1hdV8HbL3X4XogDaLA ($31 in chips) 
Seat 3: HVKi9hnDyvzObpL08/OarQ ($26.25 in chips) 
Seat 4: jeKWRUkMaVn8rEUjnJKqpg ($25 in chips) 
Seat 6: opOCI2p6kW0tINuVaAqmcQ ($25 in chips) 
Seat 7: WdsZPRB5ooUPinQdaX0QrA ($3.55 in chips) 
Seat 8: ppMlNkhYgErlt4fuJO7ADA ($11.95 in chips) 
Seat 9: hIss79a4pu7GzJZepfgOpg ($26.60 in chips) 
jeKWRUkMaVn8rEUjnJKqpg: posts small blind $0.10
Z5ZtGOON8kmSdSCll9Z3XA: is sitting out 
opOCI2p6kW0tINuVaAqmcQ: posts big blind $0.25
*** HOLE CARDS ***
yVwP/Nr5oXkAQp5dmdNUVQ has returned
WdsZPRB5ooUPinQdaX0QrA: calls $0.25
ppMlNkhYgErlt4fuJO7ADA: folds 
hIss79a4pu7GzJZepfgOpg: folds 
AtRN1hdV8HbL3X4XogDaLA: calls $0.25
HVKi9hnDyvzObpL08/OarQ: calls $0.25
jeKWRUkMaVn8rEUjnJKqpg: folds 
Z5ZtGOON8kmSdSCll9Z3XA leaves the table
opOCI2p6kW0tINuVaAqmcQ: checks 
*** FLOP *** [4c 3d 7h]
opOCI2p6kW0tINuVaAqmcQ: bets $0.75
WdsZPRB5ooUPinQdaX0QrA: folds 
AtRN1hdV8HbL3X4XogDaLA: calls $0.75
HVKi9hnDyvzObpL08/OarQ: folds 
*** TURN *** [4c 3d 7h] [Ks]
opOCI2p6kW0tINuVaAqmcQ: checks 
AtRN1hdV8HbL3X4XogDaLA: bets $2
opOCI2p6kW0tINuVaAqmcQ: folds 
Uncalled bet ($2) returned to AtRN1hdV8HbL3X4XogDaLA
AtRN1hdV8HbL3X4XogDaLA collected $2.50 from pot
AtRN1hdV8HbL3X4XogDaLA: doesn't show hand 
*** SUMMARY ***
Total pot $2.60 | Rake $0.10 
Board [4c 3d 7h Ks]
Seat 1: AtRN1hdV8HbL3X4XogDaLA collected ($2.50)
Seat 3: HVKi9hnDyvzObpL08/OarQ (button) folded on the Flop
Seat 4: jeKWRUkMaVn8rEUjnJKqpg (small blind) folded before Flop
Seat 6: opOCI2p6kW0tINuVaAqmcQ (big blind) folded on the Turn
Seat 7: WdsZPRB5ooUPinQdaX0QrA folded on the Flop
Seat 8: ppMlNkhYgErlt4fuJO7ADA folded before Flop (didn't bet)
Seat 9: hIss79a4pu7GzJZepfgOpg folded before Flop (didn't bet)




PokerStars Game #59939462682:  Hold'em No Limit ($0.10/$0.25) - 2009/07/01 0:40:30 ET
Table '+198VWQSWBhYQOcizzuBkw' 6-max Seat #2 is the button
Seat 2: R6AGToFJQOYVZAjC2jXEKw ($29.05 in chips) 
Seat 3: BYxjLnV1/LL0aZcTbfAOvw ($27.35 in chips) 
Seat 4: TgDsTeCdLQt8kWbL00ByRA ($27.25 in chips) 
Seat 5: LtASJ9OlkqGrrUKGQlpGAw ($30.30 in chips) 
Seat 6: 7qRk4YH4/k/08LgJSv7rBQ ($31.25 in chips) 
BYxjLnV1/LL0aZcTbfAOvw: posts small blind $0.10
TgDsTeCdLQt8kWbL00ByRA: posts big blind $0.25
*** HOLE CARDS ***
LtASJ9OlkqGrrUKGQlpGAw: folds 
7qRk4YH4/k/08LgJSv7rBQ: folds 
R6AGToFJQOYVZAjC2jXEKw: folds 
BYxjLnV1/LL0aZcTbfAOvw: folds 
Uncalled bet ($0.15) returned to TgDsTeCdLQt8kWbL00ByRA
TgDsTeCdLQt8kWbL00ByRA collected $0.20 from pot
*** SUMMARY ***
Total pot $0.20 | Rake $0 
Seat 2: R6AGToFJQOYVZAjC2jXEKw (button) folded before Flop (didn't bet)
Seat 3: BYxjLnV1/LL0aZcTbfAOvw (small blind) folded before Flop
Seat 4: TgDsTeCdLQt8kWbL00ByRA (big blind) collected ($0.20)
Seat 5: LtASJ9OlkqGrrUKGQlpGAw folded before Flop (didn't bet)
Seat 6: 7qRk4YH4/k/08LgJSv7rBQ folded before Flop (didn't bet)




PokerStars Game #59939462716:  Hold'em No Limit ($0.10/$0.25) - 2009/07/01 0:40:30 ET
Table 'HzFR0rxmDAPu5GzYR0AlYg' 6-max Seat #4 is the button
Seat 1: v+QfkGiuj9bgtuNoVnDO8w ($25 in chips) 
Seat 2: UA5OsKS3VPaxa7uC8La/kA ($52.95 in chips) 
Seat 3: lfAPI6VglUPipZe8BpDaTA ($24.85 in chips) 
Seat 4: uy9x0X5l7O+IpGjLa77QgQ ($60.05 in chips) 
Seat 5: I1TxPvWj8NfG8orglCinNA ($25.10 in chips) 
I1TxPvWj8NfG8orglCinNA: posts small blind $0.10
v+QfkGiuj9bgtuNoVnDO8w: posts big blind $0.25
*** HOLE CARDS ***
UA5OsKS3VPaxa7uC8La/kA: folds 
lfAPI6VglUPipZe8BpDaTA: folds 
uy9x0X5l7O+IpGjLa77QgQ: folds 
I1TxPvWj8NfG8orglCinNA: folds 
Uncalled bet ($0.15) returned to v+QfkGiuj9bgtuNoVnDO8w
v+QfkGiuj9bgtuNoVnDO8w collected $0.20 from pot
v+QfkGiuj9bgtuNoVnDO8w: doesn't show hand 
*** SUMMARY ***
Total pot $0.20 | Rake $0 
Seat 1: v+QfkGiuj9bgtuNoVnDO8w (big blind) collected ($0.20)
Seat 2: UA5OsKS3VPaxa7uC8La/kA folded before Flop (didn't bet)
Seat 3: lfAPI6VglUPipZe8BpDaTA folded before Flop (didn't bet)
Seat 4: uy9x0X5l7O+IpGjLa77QgQ (button) folded before Flop (didn't bet)
Seat 5: I1TxPvWj8NfG8orglCinNA (small blind) folded before Flop




PokerStars Game #59939462648:  Hold'em No Limit ($0.10/$0.25) - 2009/07/01 0:40:30 ET
Table 'g+mPuNJBCHKE9ents7ZGtg' 6-max Seat #6 is the button
Seat 1: rlqzz6sTpiZGIiNuqy7QUA ($39.30 in chips) 
Seat 2: fZQg9veL7Dd/Z04ZTjC+wQ ($30.35 in chips) 
Seat 3: 9jSiy0meE9XJKkdIZwyTEQ ($25.25 in chips) 
Seat 4: mfrkWA3PTeYPkbO6hi98Aw ($27 in chips) 
Seat 6: MS2T205Bjud7PnNoANu4vQ ($45.85 in chips) 
rlqzz6sTpiZGIiNuqy7QUA: posts small blind $0.10
fZQg9veL7Dd/Z04ZTjC+wQ: posts big blind $0.25
32YL2ZEp8NT4JB2RVM9euQ: sits out 
*** HOLE CARDS ***
9jSiy0meE9XJKkdIZwyTEQ: folds 
mfrkWA3PTeYPkbO6hi98Aw: folds 
MS2T205Bjud7PnNoANu4vQ: raises $0.50 to $0.75
rlqzz6sTpiZGIiNuqy7QUA: folds 
fZQg9veL7Dd/Z04ZTjC+wQ: folds 
Uncalled bet ($0.50) returned to MS2T205Bjud7PnNoANu4vQ
MS2T205Bjud7PnNoANu4vQ collected $0.60 from pot
*** SUMMARY ***
Total pot $0.60 | Rake $0 
Seat 1: rlqzz6sTpiZGIiNuqy7QUA (small blind) folded before Flop
Seat 2: fZQg9veL7Dd/Z04ZTjC+wQ (big blind) folded before Flop
Seat 3: 9jSiy0meE9XJKkdIZwyTEQ folded before Flop (didn't bet)
Seat 4: mfrkWA3PTeYPkbO6hi98Aw folded before Flop (didn't bet)
Seat 6: MS2T205Bjud7PnNoANu4vQ (button) collected ($0.60)




PokerStars Game #59939462484:  Hold'em No Limit ($0.10/$0.25) - 2009/07/01 0:40:30 ET
Table 'KEoOIegxPF91KooL2AelUA' 6-max Seat #4 is the button
Seat 1: wsP46AGpqDjHZQmlRHKa9g ($29.30 in chips) 
Seat 4: Vv37Oa9niKKVcR6Z7ceetw ($23.80 in chips) 
Seat 5: 2NLC44AHHKHEUooUQFYV+Q ($11.60 in chips) 
2NLC44AHHKHEUooUQFYV+Q: posts small blind $0.10
wsP46AGpqDjHZQmlRHKa9g: posts big blind $0.25
*** HOLE CARDS ***
Vv37Oa9niKKVcR6Z7ceetw: folds 
2NLC44AHHKHEUooUQFYV+Q: calls $0.15
wsP46AGpqDjHZQmlRHKa9g: checks 
*** FLOP *** [4h Ac 8s]
2NLC44AHHKHEUooUQFYV+Q: checks 
wsP46AGpqDjHZQmlRHKa9g: bets $0.50
2NLC44AHHKHEUooUQFYV+Q: folds 
Uncalled bet ($0.50) returned to wsP46AGpqDjHZQmlRHKa9g
wsP46AGpqDjHZQmlRHKa9g collected $0.50 from pot
*** SUMMARY ***
Total pot $0.50 | Rake $0 
Board [4h Ac 8s]
Seat 1: wsP46AGpqDjHZQmlRHKa9g (big blind) collected ($0.50)
Seat 4: Vv37Oa9niKKVcR6Z7ceetw (button) folded before Flop (didn't bet)
Seat 5: 2NLC44AHHKHEUooUQFYV+Q (small blind) folded on the Flop




PokerStars Game #59939462410:  Hold'em No Limit ($0.10/$0.25) - 2009/07/01 0:40:30 ET
Table 'NtCSSONEf1zaJo3042tQug' 6-max Seat #6 is the button
Seat 1: pdS3fOhVgLVaTP0O0GlIvw ($11.30 in chips) 
Seat 2: nbv8IVGAEHbfjk01ulU6ow ($20.15 in chips) 
Seat 3: d0J1xuhsynEY81YHwAvJ5g ($25 in chips) 
Seat 4: dOX4wnYV2sEqvDbF+8KSCw ($25.15 in chips) 
Seat 5: l/t3k8+r77gRew8U2BJs4Q ($3.40 in chips) 
Seat 6: LxehwDpTQ19ph4Qmc78+Pw ($20.75 in chips) 
pdS3fOhVgLVaTP0O0GlIvw: posts small blind $0.10
nbv8IVGAEHbfjk01ulU6ow: posts big blind $0.25
*** HOLE CARDS ***
d0J1xuhsynEY81YHwAvJ5g: folds 
dOX4wnYV2sEqvDbF+8KSCw: folds 
l/t3k8+r77gRew8U2BJs4Q: folds 
LxehwDpTQ19ph4Qmc78+Pw: calls $0.25
pdS3fOhVgLVaTP0O0GlIvw: calls $0.15
nbv8IVGAEHbfjk01ulU6ow: checks 
*** FLOP *** [5d Tc 5c]
pdS3fOhVgLVaTP0O0GlIvw: checks 
nbv8IVGAEHbfjk01ulU6ow: checks 
LxehwDpTQ19ph4Qmc78+Pw: bets $0.50
pdS3fOhVgLVaTP0O0GlIvw: folds 
nbv8IVGAEHbfjk01ulU6ow: folds 
Uncalled bet ($0.50) returned to LxehwDpTQ19ph4Qmc78+Pw
LxehwDpTQ19ph4Qmc78+Pw collected $0.75 from pot
LxehwDpTQ19ph4Qmc78+Pw: doesn't show hand 
*** SUMMARY ***
Total pot $0.75 | Rake $0 
Board [5d Tc 5c]
Seat 1: pdS3fOhVgLVaTP0O0GlIvw (small blind) folded on the Flop
Seat 2: nbv8IVGAEHbfjk01ulU6ow (big blind) folded on the Flop
Seat 3: d0J1xuhsynEY81YHwAvJ5g folded before Flop (didn't bet)
Seat 4: dOX4wnYV2sEqvDbF+8KSCw folded before Flop (didn't bet)
Seat 5: l/t3k8+r77gRew8U2BJs4Q folded before Flop (didn't bet)
Seat 6: LxehwDpTQ19ph4Qmc78+Pw (button) collected ($0.75)




PokerStars Game #59939462342:  Hold'em No Limit ($0.10/$0.25) - 2009/07/01 0:40:30 ET
Table 'HbNAGS1OJWQKyfk7UfrYyw' 9-max Seat #3 is the button
Seat 1: YHeeiaUNFin/MUYZJuW1VA ($10.05 in chips) 
Seat 2: Jt0gcXubHx3//kZT9X5jGQ ($28.05 in chips) 
Seat 3: DIBbjEYGs+TVdVgEB/4+3w ($30.20 in chips) 
Seat 5: cu58S48zQeRuppc18okJLA ($12.90 in chips) 
Seat 6: W4TLQcZ2TiM73eIgpIvlGg ($26.70 in chips) 
Seat 9: 8IJfEa/AAO04NtzGHO9CFQ ($15.25 in chips) 
cu58S48zQeRuppc18okJLA: posts small blind $0.10
W4TLQcZ2TiM73eIgpIvlGg: posts big blind $0.25
*** HOLE CARDS ***
8IJfEa/AAO04NtzGHO9CFQ: calls $0.25
YHeeiaUNFin/MUYZJuW1VA: raises $0.75 to $1
Jt0gcXubHx3//kZT9X5jGQ: folds 
DIBbjEYGs+TVdVgEB/4+3w: folds 
cu58S48zQeRuppc18okJLA: folds 
W4TLQcZ2TiM73eIgpIvlGg: folds 
8IJfEa/AAO04NtzGHO9CFQ: folds 
Uncalled bet ($0.75) returned to YHeeiaUNFin/MUYZJuW1VA
Jt0gcXubHx3//kZT9X5jGQ said, "thats why all in"
JJH2Xc95hFewheF67vSv4Q joins the table at seat #7 
YHeeiaUNFin/MUYZJuW1VA collected $0.85 from pot
YHeeiaUNFin/MUYZJuW1VA: doesn't show hand 
*** SUMMARY ***
Total pot $0.85 | Rake $0 
Seat 1: YHeeiaUNFin/MUYZJuW1VA collected ($0.85)
Seat 2: Jt0gcXubHx3//kZT9X5jGQ folded before Flop (didn't bet)
Seat 3: DIBbjEYGs+TVdVgEB/4+3w (button) folded before Flop (didn't bet)
Seat 5: cu58S48zQeRuppc18okJLA (small blind) folded before Flop
Seat 6: W4TLQcZ2TiM73eIgpIvlGg (big blind) folded before Flop
Seat 9: 8IJfEa/AAO04NtzGHO9CFQ folded before Flop




PokerStars Game #59939462428:  Hold'em No Limit ($0.10/$0.25) - 2009/07/01 0:40:30 ET
Table 'TJS4XvvOjO3k7mH74HJw5g' 9-max Seat #2 is the button
Seat 1: SS+d2ix02WTTacMsjCk0OQ ($25.10 in chips) 
Seat 2: ghNKXUBl/H+t83JF079ZBA ($25 in chips) 
Seat 3: 8B/dhbQjIWe6ASCdgzktNQ ($25 in chips) 
Seat 4: Y+IdmmKAoWu2irRi3Jpr4Q ($17.60 in chips) 
Seat 5: NNZypfH1f/VIj3Skf/XIzg ($4.65 in chips) 
Seat 6: cFmpjvcjNoVAEAIQIxWkYg ($25 in chips) 
Seat 7: DiSvPC2iudwL5j9u6Huyww ($25 in chips) 
Seat 8: l9TiQshP7QOsNH6jZrL4Wg ($3.55 in chips) 
Seat 9: +sbyWwIcFp9kP0bDtMegfQ ($32.25 in chips) 
8B/dhbQjIWe6ASCdgzktNQ: posts small blind $0.10
Y+IdmmKAoWu2irRi3Jpr4Q: posts big blind $0.25
*** HOLE CARDS ***
NNZypfH1f/VIj3Skf/XIzg: folds 
cFmpjvcjNoVAEAIQIxWkYg: folds 
DiSvPC2iudwL5j9u6Huyww: folds 
l9TiQshP7QOsNH6jZrL4Wg: folds 
+sbyWwIcFp9kP0bDtMegfQ: folds 
SS+d2ix02WTTacMsjCk0OQ: folds 
ghNKXUBl/H+t83JF079ZBA: folds 
8B/dhbQjIWe6ASCdgzktNQ: folds 
Uncalled bet ($0.15) returned to Y+IdmmKAoWu2irRi3Jpr4Q
Y+IdmmKAoWu2irRi3Jpr4Q collected $0.20 from pot
Y+IdmmKAoWu2irRi3Jpr4Q: doesn't show hand 
*** SUMMARY ***
Total pot $0.20 | Rake $0 
Seat 1: SS+d2ix02WTTacMsjCk0OQ folded before Flop (didn't bet)
Seat 2: ghNKXUBl/H+t83JF079ZBA (button) folded before Flop (didn't bet)
Seat 3: 8B/dhbQjIWe6ASCdgzktNQ (small blind) folded before Flop
Seat 4: Y+IdmmKAoWu2irRi3Jpr4Q (big blind) collected ($0.20)
Seat 5: NNZypfH1f/VIj3Skf/XIzg folded before Flop (didn't bet)
Seat 6: cFmpjvcjNoVAEAIQIxWkYg folded before Flop (didn't bet)
Seat 7: DiSvPC2iudwL5j9u6Huyww folded before Flop (didn't bet)
Seat 8: l9TiQshP7QOsNH6jZrL4Wg folded before Flop (didn't bet)
Seat 9: +sbyWwIcFp9kP0bDtMegfQ folded before Flop (didn't bet)




PokerStars Game #59939462980:  Hold'em No Limit ($0.10/$0.25) - 2009/07/01 0:40:31 ET
Table 'ShgkxBDL5IvR1qjzfRNc0A' 6-max Seat #2 is the button
Seat 1: /gJNBeCkWL4o85/jvlZ4BA ($25 in chips) 
Seat 2: mfrkWA3PTeYPkbO6hi98Aw ($38.85 in chips) 
Seat 3: JXSfL0FgBM1dIFwHP09Hnw ($25.10 in chips) 
Seat 4: kG34n23qFQA3nzdOJTQ1dA ($24.75 in chips) 
Seat 5: ferjiUxLWPNUKxvl8/xD/g ($44.30 in chips) 
Seat 6: 5tB0F9NjPSUL4FzmzBMs2Q ($30.20 in chips) 
JXSfL0FgBM1dIFwHP09Hnw: posts small blind $0.10
kG34n23qFQA3nzdOJTQ1dA: posts big blind $0.25
*** HOLE CARDS ***
ferjiUxLWPNUKxvl8/xD/g: raises $0.75 to $1
5tB0F9NjPSUL4FzmzBMs2Q: folds 
/gJNBeCkWL4o85/jvlZ4BA: calls $1
mfrkWA3PTeYPkbO6hi98Aw: calls $1
JXSfL0FgBM1dIFwHP09Hnw: calls $0.90
kG34n23qFQA3nzdOJTQ1dA: folds 
*** FLOP *** [Ks 9h 7s]
JXSfL0FgBM1dIFwHP09Hnw: checks 
ferjiUxLWPNUKxvl8/xD/g: checks 
/gJNBeCkWL4o85/jvlZ4BA: checks 
mfrkWA3PTeYPkbO6hi98Aw: checks 
*** TURN *** [Ks 9h 7s] [Qh]
JXSfL0FgBM1dIFwHP09Hnw: checks 
ferjiUxLWPNUKxvl8/xD/g: checks 
/gJNBeCkWL4o85/jvlZ4BA: checks 
mfrkWA3PTeYPkbO6hi98Aw: checks 
*** RIVER *** [Ks 9h 7s Qh] [8h]
JXSfL0FgBM1dIFwHP09Hnw: checks 
ferjiUxLWPNUKxvl8/xD/g: bets $3
/gJNBeCkWL4o85/jvlZ4BA: folds 
mfrkWA3PTeYPkbO6hi98Aw: folds 
JXSfL0FgBM1dIFwHP09Hnw: folds 
Uncalled bet ($3) returned to ferjiUxLWPNUKxvl8/xD/g
ferjiUxLWPNUKxvl8/xD/g collected $4.05 from pot
ferjiUxLWPNUKxvl8/xD/g: doesn't show hand 
*** SUMMARY ***
Total pot $4.25 | Rake $0.20 
Board [Ks 9h 7s Qh 8h]
Seat 1: /gJNBeCkWL4o85/jvlZ4BA folded on the River
Seat 2: mfrkWA3PTeYPkbO6hi98Aw (button) folded on the River
Seat 3: JXSfL0FgBM1dIFwHP09Hnw (small blind) folded on the River
Seat 4: kG34n23qFQA3nzdOJTQ1dA (big blind) folded before Flop
Seat 5: ferjiUxLWPNUKxvl8/xD/g collected ($4.05)
Seat 6: 5tB0F9NjPSUL4FzmzBMs2Q folded before Flop (didn't bet)




PokerStars Game #59939463314:  Hold'em No Limit ($0.10/$0.25) - 2009/07/01 0:40:31 ET
Table 'oZuNsbNJuUyQLGKzQ/4JFg' 6-max Seat #5 is the button
Seat 1: /hq3j+3FbArzS8nEzmqRuw ($6.35 in chips) 
Seat 2: UA5OsKS3VPaxa7uC8La/kA ($30.25 in chips) 
Seat 3: 8ClCHtFXGNplITm+63KB+Q ($36.40 in chips) 
Seat 4: pWN7DVB+VCCiq83kllzEtg ($7.25 in chips) 
Seat 5: IH5lT4+CuQFyy32Qf5ydDw ($19.15 in chips) 
Seat 6: 34ttqW62uIRrqINCCmLcsw ($20.90 in chips) 
34ttqW62uIRrqINCCmLcsw: posts small blind $0.10
/hq3j+3FbArzS8nEzmqRuw: posts big blind $0.25
*** HOLE CARDS ***
UA5OsKS3VPaxa7uC8La/kA: folds 
8ClCHtFXGNplITm+63KB+Q: folds 
pWN7DVB+VCCiq83kllzEtg: folds 
IH5lT4+CuQFyy32Qf5ydDw: folds 
34ttqW62uIRrqINCCmLcsw: calls $0.15
/hq3j+3FbArzS8nEzmqRuw: checks 
*** FLOP *** [Kh 5h As]
34ttqW62uIRrqINCCmLcsw: checks 
/hq3j+3FbArzS8nEzmqRuw: checks 
*** TURN *** [Kh 5h As] [8c]
34ttqW62uIRrqINCCmLcsw: checks 
/hq3j+3FbArzS8nEzmqRuw: bets $0.25
34ttqW62uIRrqINCCmLcsw: folds 
Uncalled bet ($0.25) returned to /hq3j+3FbArzS8nEzmqRuw
/hq3j+3FbArzS8nEzmqRuw collected $0.50 from pot
/hq3j+3FbArzS8nEzmqRuw: doesn't show hand 
*** SUMMARY ***
Total pot $0.50 | Rake $0 
Board [Kh 5h As 8c]
Seat 1: /hq3j+3FbArzS8nEzmqRuw (big blind) collected ($0.50)
Seat 2: UA5OsKS3VPaxa7uC8La/kA folded before Flop (didn't bet)
Seat 3: 8ClCHtFXGNplITm+63KB+Q folded before Flop (didn't bet)
Seat 4: pWN7DVB+VCCiq83kllzEtg folded before Flop (didn't bet)
Seat 5: IH5lT4+CuQFyy32Qf5ydDw (button) folded before Flop (didn't bet)
Seat 6: 34ttqW62uIRrqINCCmLcsw (small blind) folded on the Turn




PokerStars Game #59939463346:  Hold'em No Limit ($0.10/$0.25) - 2009/07/01 0:40:31 ET
Table 'fIrOIN3HoXM27ZpRwKa6oA' 6-max Seat #5 is the button
Seat 1: I1TxPvWj8NfG8orglCinNA ($38.85 in chips) 
Seat 2: 5tB0F9NjPSUL4FzmzBMs2Q ($35.80 in chips) 
Seat 3: OElpcjPk5wP6xlAUngsAmg ($4.70 in chips) 
Seat 4: PEUgcMc+CzvN+vLwu5DsLQ ($2.80 in chips) 
Seat 5: 8ClCHtFXGNplITm+63KB+Q ($26.80 in chips) 
Seat 6: v+QfkGiuj9bgtuNoVnDO8w ($29.80 in chips) 
v+QfkGiuj9bgtuNoVnDO8w: posts small blind $0.10
I1TxPvWj8NfG8orglCinNA: posts big blind $0.25
*** HOLE CARDS ***
5tB0F9NjPSUL4FzmzBMs2Q: raises $0.75 to $1
OElpcjPk5wP6xlAUngsAmg: raises $3.70 to $4.70 and is all-in
PEUgcMc+CzvN+vLwu5DsLQ: folds 
8ClCHtFXGNplITm+63KB+Q: folds 
v+QfkGiuj9bgtuNoVnDO8w: folds 
I1TxPvWj8NfG8orglCinNA: folds 
5tB0F9NjPSUL4FzmzBMs2Q: calls $3.70
*** FLOP *** [Ac Qh 7c]
*** TURN *** [Ac Qh 7c] [9h]
*** RIVER *** [Ac Qh 7c 9h] [Jd]
*** SHOW DOWN ***
5tB0F9NjPSUL4FzmzBMs2Q: shows [Qd Qs] (three of a kind, Queens)
OElpcjPk5wP6xlAUngsAmg: mucks hand 
5tB0F9NjPSUL4FzmzBMs2Q collected $9.30 from pot
*** SUMMARY ***
Total pot $9.75 | Rake $0.45 
Board [Ac Qh 7c 9h Jd]
Seat 1: I1TxPvWj8NfG8orglCinNA (big blind) folded before Flop
Seat 2: 5tB0F9NjPSUL4FzmzBMs2Q showed [Qd Qs] and won ($9.30) with three of a kind, Queens
Seat 3: OElpcjPk5wP6xlAUngsAmg mucked
Seat 4: PEUgcMc+CzvN+vLwu5DsLQ folded before Flop (didn't bet)
Seat 5: 8ClCHtFXGNplITm+63KB+Q (button) folded before Flop (didn't bet)
Seat 6: v+QfkGiuj9bgtuNoVnDO8w (small blind) folded before Flop




PokerStars Game #59939463090:  Hold'em No Limit ($0.10/$0.25) - 2009/07/01 0:40:31 ET
Table 'LXz5SsUCyWcm+4JDJh466A' 9-max Seat #9 is the button
Seat 1: MG90wfSJZnOejs/KD3vlQQ ($23.35 in chips) 
Seat 2: H5Se03ZqSX7tbULXur2MAg ($24.50 in chips) 
Seat 5: OiV1PWZ3IkN29JlmCcnTwQ ($5.10 in chips) 
Seat 6: opOCI2p6kW0tINuVaAqmcQ ($25.15 in chips) 
Seat 7: EnNp9cILTCYQ95g+8MNFGw ($29.75 in chips) 
Seat 8: VlJdQJbqyBs3oxP5BIw7jA ($95.45 in chips) 
Seat 9: 2N94FgK4Y2izKFIB+wJOjw ($10.25 in chips) 
MG90wfSJZnOejs/KD3vlQQ: posts small blind $0.10
H5Se03ZqSX7tbULXur2MAg: posts big blind $0.25
Iu9xjReQYvxYiqQm8n6MXQ: sits out 
*** HOLE CARDS ***
OiV1PWZ3IkN29JlmCcnTwQ: folds 
opOCI2p6kW0tINuVaAqmcQ: raises $0.50 to $0.75
EnNp9cILTCYQ95g+8MNFGw: calls $0.75
VlJdQJbqyBs3oxP5BIw7jA: calls $0.75
2N94FgK4Y2izKFIB+wJOjw: folds 
MG90wfSJZnOejs/KD3vlQQ: folds 
H5Se03ZqSX7tbULXur2MAg: folds 
*** FLOP *** [Ad 4s 9h]
opOCI2p6kW0tINuVaAqmcQ: checks 
EnNp9cILTCYQ95g+8MNFGw: checks 
VlJdQJbqyBs3oxP5BIw7jA: checks 
*** TURN *** [Ad 4s 9h] [5s]
opOCI2p6kW0tINuVaAqmcQ: checks 
EnNp9cILTCYQ95g+8MNFGw: bets $1
VlJdQJbqyBs3oxP5BIw7jA: folds 
opOCI2p6kW0tINuVaAqmcQ: folds 
Uncalled bet ($1) returned to EnNp9cILTCYQ95g+8MNFGw
EnNp9cILTCYQ95g+8MNFGw collected $2.50 from pot
EnNp9cILTCYQ95g+8MNFGw: doesn't show hand 
*** SUMMARY ***
Total pot $2.60 | Rake $0.10 
Board [Ad 4s 9h 5s]
Seat 1: MG90wfSJZnOejs/KD3vlQQ (small blind) folded before Flop
Seat 2: H5Se03ZqSX7tbULXur2MAg (big blind) folded before Flop
Seat 5: OiV1PWZ3IkN29JlmCcnTwQ folded before Flop (didn't bet)
Seat 6: opOCI2p6kW0tINuVaAqmcQ folded on the Turn
Seat 7: EnNp9cILTCYQ95g+8MNFGw collected ($2.50)
Seat 8: VlJdQJbqyBs3oxP5BIw7jA folded on the Turn
Seat 9: 2N94FgK4Y2izKFIB+wJOjw (button) folded before Flop (didn't bet)




PokerStars Game #59939464066:  Hold'em No Limit ($0.10/$0.25) - 2009/07/01 0:40:32 ET
Table '7/qMNloI0nSXWiX5Y1watA' 9-max Seat #3 is the button
Seat 1: lF4l0ujUfJ9uYJOg9Ch9/g ($45.10 in chips) 
Seat 2: 8B/dhbQjIWe6ASCdgzktNQ ($25.40 in chips) 
Seat 3: nEg1b6MIksd/4x5eLY735g ($39.75 in chips) 
Seat 4: 18G4P1XstjNvItdGUITxgw ($25.10 in chips) 
Seat 5: dfNim92Z6XK1/h5SFW5vDg ($32.85 in chips) 
Seat 7: z5GxcHlYz/GSz6W2uFiTtg ($11.55 in chips) 
Seat 8: ljemhp25Zg+nlA9DLCIiUw ($24.50 in chips) 
18G4P1XstjNvItdGUITxgw: posts small blind $0.10
dfNim92Z6XK1/h5SFW5vDg: posts big blind $0.25
aPRz/2GxbXANYpVsQO8pdQ: sits out 
*** HOLE CARDS ***
vnCdP3GsLTKadDukKcJk/Q joins the table at seat #6 
aPRz/2GxbXANYpVsQO8pdQ leaves the table
z5GxcHlYz/GSz6W2uFiTtg: folds 
ljemhp25Zg+nlA9DLCIiUw: folds 
lF4l0ujUfJ9uYJOg9Ch9/g: raises $0.50 to $0.75
8B/dhbQjIWe6ASCdgzktNQ: folds 
Telixak joins the table at seat #9 
nEg1b6MIksd/4x5eLY735g: calls $0.75
18G4P1XstjNvItdGUITxgw: folds 
dfNim92Z6XK1/h5SFW5vDg: calls $0.50
*** FLOP *** [3h 9d 5d]
dfNim92Z6XK1/h5SFW5vDg: checks 
lF4l0ujUfJ9uYJOg9Ch9/g: bets $1.25
nEg1b6MIksd/4x5eLY735g: calls $1.25
dfNim92Z6XK1/h5SFW5vDg: folds 
*** TURN *** [3h 9d 5d] [3c]
lF4l0ujUfJ9uYJOg9Ch9/g: checks 
nEg1b6MIksd/4x5eLY735g: checks 
*** RIVER *** [3h 9d 5d 3c] [2d]
lF4l0ujUfJ9uYJOg9Ch9/g: checks 
nEg1b6MIksd/4x5eLY735g: bets $4
lF4l0ujUfJ9uYJOg9Ch9/g: folds 
Uncalled bet ($4) returned to nEg1b6MIksd/4x5eLY735g
nEg1b6MIksd/4x5eLY735g collected $4.65 from pot
*** SUMMARY ***
Total pot $4.85 | Rake $0.20 
Board [3h 9d 5d 3c 2d]
Seat 1: lF4l0ujUfJ9uYJOg9Ch9/g folded on the River
Seat 2: 8B/dhbQjIWe6ASCdgzktNQ folded before Flop (didn't bet)
Seat 3: nEg1b6MIksd/4x5eLY735g (button) collected ($4.65)
Seat 4: 18G4P1XstjNvItdGUITxgw (small blind) folded before Flop
Seat 5: dfNim92Z6XK1/h5SFW5vDg (big blind) folded on the Flop
Seat 7: z5GxcHlYz/GSz6W2uFiTtg folded before Flop (didn't bet)
Seat 8: ljemhp25Zg+nlA9DLCIiUw folded before Flop (didn't bet)




PokerStars Game #59939463654:  Hold'em No Limit ($0.10/$0.25) - 2009/07/01 0:40:32 ET
Table '/JJyyIstHfkT7t/bW+WXgg' 6-max Seat #4 is the button
Seat 1: wsP46AGpqDjHZQmlRHKa9g ($26.15 in chips) 
Seat 2: eRDLpytVTPI4rY3iortMSw ($10.60 in chips) 
Seat 3: oc4ZGs0W+3RIg2yPyJw3ig ($25.85 in chips) 
Seat 4: ELW+DKizJhLK7k40PMkD2Q ($25.80 in chips) 
Seat 5: 2wkoolB4YxxVC2x99F9rcA ($24.75 in chips) 
Seat 6: d338A2rm6NtA1ECEZi4d2g ($16.50 in chips) 
2wkoolB4YxxVC2x99F9rcA: posts small blind $0.10
d338A2rm6NtA1ECEZi4d2g: posts big blind $0.25
*** HOLE CARDS ***
wsP46AGpqDjHZQmlRHKa9g: folds 
eRDLpytVTPI4rY3iortMSw: calls $0.25
oc4ZGs0W+3RIg2yPyJw3ig: folds 
ELW+DKizJhLK7k40PMkD2Q: folds 
2wkoolB4YxxVC2x99F9rcA: raises $0.75 to $1
d338A2rm6NtA1ECEZi4d2g: folds 
eRDLpytVTPI4rY3iortMSw: calls $0.75
*** FLOP *** [8c 7h 7s]
2wkoolB4YxxVC2x99F9rcA: checks 
eRDLpytVTPI4rY3iortMSw: bets $1.75
2wkoolB4YxxVC2x99F9rcA: calls $1.75
*** TURN *** [8c 7h 7s] [Jd]
2wkoolB4YxxVC2x99F9rcA: checks 
eRDLpytVTPI4rY3iortMSw: bets $2.50
2wkoolB4YxxVC2x99F9rcA: calls $2.50
*** RIVER *** [8c 7h 7s Jd] [Kd]
2wkoolB4YxxVC2x99F9rcA: checks 
eRDLpytVTPI4rY3iortMSw: checks 
*** SHOW DOWN ***
2wkoolB4YxxVC2x99F9rcA: shows [8s 8d] (a full house, Eights full of Sevens)
eRDLpytVTPI4rY3iortMSw: mucks hand 
2wkoolB4YxxVC2x99F9rcA collected $10.25 from pot
*** SUMMARY ***
Total pot $10.75 | Rake $0.50 
Board [8c 7h 7s Jd Kd]
Seat 1: wsP46AGpqDjHZQmlRHKa9g folded before Flop (didn't bet)
Seat 2: eRDLpytVTPI4rY3iortMSw mucked
Seat 3: oc4ZGs0W+3RIg2yPyJw3ig folded before Flop (didn't bet)
Seat 4: ELW+DKizJhLK7k40PMkD2Q (button) folded before Flop (didn't bet)
Seat 5: 2wkoolB4YxxVC2x99F9rcA (small blind) showed [8s 8d] and won ($10.25) with a full house, Eights full of Sevens
Seat 6: d338A2rm6NtA1ECEZi4d2g (big blind) folded before Flop




PokerStars Game #59939463986:  Hold'em No Limit ($0.10/$0.25) - 2009/07/01 0:40:32 ET
Table '3Ns9nuTkynfwbBfBXzg6ww' 6-max Seat #4 is the button
Seat 4: kyRaCIljYA6l33lSKQfNsg ($27.50 in chips) 
Seat 5: kBQU/db00TVAMeomlhblPg ($22.20 in chips) 
kyRaCIljYA6l33lSKQfNsg: posts small blind $0.10
kBQU/db00TVAMeomlhblPg: posts big blind $0.25
*** HOLE CARDS ***
kyRaCIljYA6l33lSKQfNsg: folds 
Uncalled bet ($0.15) returned to kBQU/db00TVAMeomlhblPg
kBQU/db00TVAMeomlhblPg collected $0.20 from pot
*** SUMMARY ***
Total pot $0.20 | Rake $0 
Seat 4: kyRaCIljYA6l33lSKQfNsg (button) (small blind) folded before Flop
Seat 5: kBQU/db00TVAMeomlhblPg (big blind) collected ($0.20)




PokerStars Game #59939463684:  Hold'em No Limit ($0.10/$0.25) - 2009/07/01 0:40:32 ET
Table 'SbSV5tlgLp0+/Z+13PW3Hg' 9-max Seat #5 is the button
Seat 1: NAP/FpFXsTsBxjDijlVzEg ($43.40 in chips) 
Seat 2: zDrucyjVn5aeekNEc3cJrA ($20.25 in chips) 
Seat 3: s7Q6uNouhe7aE8JdFb9E+A ($25 in chips) 
Seat 4: NNZypfH1f/VIj3Skf/XIzg ($4.65 in chips) 
Seat 5: z5GxcHlYz/GSz6W2uFiTtg ($19.60 in chips) 
Seat 6: qwr38jl5txoR36M7G5qi4A ($8 in chips) 
Seat 7: j4q3p0lesp63b1gZDwLBZw ($6.70 in chips) 
Seat 8: 7cv+9Zc9HIQHNvYsMfV3uA ($25.50 in chips) 
Seat 9: rXm4QDVJt67H20lM6n6Z7Q ($18.50 in chips) 
qwr38jl5txoR36M7G5qi4A: posts small blind $0.10
j4q3p0lesp63b1gZDwLBZw: posts big blind $0.25
*** HOLE CARDS ***
7cv+9Zc9HIQHNvYsMfV3uA: folds 
rXm4QDVJt67H20lM6n6Z7Q: folds 
NAP/FpFXsTsBxjDijlVzEg: calls $0.25
zDrucyjVn5aeekNEc3cJrA: calls $0.25
s7Q6uNouhe7aE8JdFb9E+A: folds 
NNZypfH1f/VIj3Skf/XIzg: folds 
z5GxcHlYz/GSz6W2uFiTtg: folds 
qwr38jl5txoR36M7G5qi4A: folds 
j4q3p0lesp63b1gZDwLBZw: checks 
*** FLOP *** [Jh Tc Qh]
j4q3p0lesp63b1gZDwLBZw: checks 
NAP/FpFXsTsBxjDijlVzEg: bets $0.50
zDrucyjVn5aeekNEc3cJrA: calls $0.50
j4q3p0lesp63b1gZDwLBZw: folds 
*** TURN *** [Jh Tc Qh] [Jc]
NAP/FpFXsTsBxjDijlVzEg: checks 
zDrucyjVn5aeekNEc3cJrA: checks 
*** RIVER *** [Jh Tc Qh Jc] [6h]
NAP/FpFXsTsBxjDijlVzEg: bets $1
zDrucyjVn5aeekNEc3cJrA: folds 
Uncalled bet ($1) returned to NAP/FpFXsTsBxjDijlVzEg
NAP/FpFXsTsBxjDijlVzEg collected $1.80 from pot
NAP/FpFXsTsBxjDijlVzEg: doesn't show hand 
*** SUMMARY ***
Total pot $1.85 | Rake $0.05 
Board [Jh Tc Qh Jc 6h]
Seat 1: NAP/FpFXsTsBxjDijlVzEg collected ($1.80)
Seat 2: zDrucyjVn5aeekNEc3cJrA folded on the River
Seat 3: s7Q6uNouhe7aE8JdFb9E+A folded before Flop (didn't bet)
Seat 4: NNZypfH1f/VIj3Skf/XIzg folded before Flop (didn't bet)
Seat 5: z5GxcHlYz/GSz6W2uFiTtg (button) folded before Flop (didn't bet)
Seat 6: qwr38jl5txoR36M7G5qi4A (small blind) folded before Flop
Seat 7: j4q3p0lesp63b1gZDwLBZw (big blind) folded on the Flop
Seat 8: 7cv+9Zc9HIQHNvYsMfV3uA folded before Flop (didn't bet)
Seat 9: rXm4QDVJt67H20lM6n6Z7Q folded before Flop (didn't bet)




PokerStars Game #59939464004:  Hold'em No Limit ($0.10/$0.25) - 2009/07/01 0:40:32 ET
Table 'm+FQg/QP0VP1ZA3V62WtOg' 9-max Seat #5 is the button
Seat 1: IK3/w7XV7rd8mVIsuasjYA ($3.15 in chips) 
Seat 2: oKO7b50N6TzXbPBr/mcrUA ($19.20 in chips) 
Seat 3: 4oA316mXLIui1QY63GXBUg ($25 in chips) 
Seat 4: 86vbuhJsyH+nbEg5qpDLyQ ($25 in chips) 
Seat 5: DnDcAdn9P0zGovMERigpFA ($25 in chips) 
Seat 6: 0kGr2KqzSs4y4kVqyDiTag ($14.50 in chips) 
Seat 7: MIVCHqCqqlke0Lb0z7glcw ($25 in chips) 
Seat 8: tZEGwCRajq0AFS6z46uW9w ($22.25 in chips) 
Seat 9: ghNKXUBl/H+t83JF079ZBA ($25 in chips) 
0kGr2KqzSs4y4kVqyDiTag: posts small blind $0.10
MIVCHqCqqlke0Lb0z7glcw: posts big blind $0.25
*** HOLE CARDS ***
tZEGwCRajq0AFS6z46uW9w: calls $0.25
ghNKXUBl/H+t83JF079ZBA: folds 
IK3/w7XV7rd8mVIsuasjYA: folds 
oKO7b50N6TzXbPBr/mcrUA: folds 
4oA316mXLIui1QY63GXBUg: folds 
86vbuhJsyH+nbEg5qpDLyQ: folds 
DnDcAdn9P0zGovMERigpFA: folds 
0kGr2KqzSs4y4kVqyDiTag: calls $0.15
MIVCHqCqqlke0Lb0z7glcw: checks 
*** FLOP *** [Qs 8d Ac]
0kGr2KqzSs4y4kVqyDiTag: checks 
MIVCHqCqqlke0Lb0z7glcw: checks 
tZEGwCRajq0AFS6z46uW9w: checks 
*** TURN *** [Qs 8d Ac] [Tc]
0kGr2KqzSs4y4kVqyDiTag: checks 
MIVCHqCqqlke0Lb0z7glcw: checks 
tZEGwCRajq0AFS6z46uW9w: checks 
*** RIVER *** [Qs 8d Ac Tc] [Ts]
0kGr2KqzSs4y4kVqyDiTag: checks 
MIVCHqCqqlke0Lb0z7glcw: checks 
tZEGwCRajq0AFS6z46uW9w: checks 
*** SHOW DOWN ***
0kGr2KqzSs4y4kVqyDiTag: shows [Js 2c] (a pair of Tens)
MIVCHqCqqlke0Lb0z7glcw: mucks hand 
tZEGwCRajq0AFS6z46uW9w: shows [Kd 6s] (a pair of Tens - Ace+King kicker)
tZEGwCRajq0AFS6z46uW9w collected $0.75 from pot
*** SUMMARY ***
Total pot $0.75 | Rake $0 
Board [Qs 8d Ac Tc Ts]
Seat 1: IK3/w7XV7rd8mVIsuasjYA folded before Flop (didn't bet)
Seat 2: oKO7b50N6TzXbPBr/mcrUA folded before Flop (didn't bet)
Seat 3: 4oA316mXLIui1QY63GXBUg folded before Flop (didn't bet)
Seat 4: 86vbuhJsyH+nbEg5qpDLyQ folded before Flop (didn't bet)
Seat 5: DnDcAdn9P0zGovMERigpFA (button) folded before Flop (didn't bet)
Seat 6: 0kGr2KqzSs4y4kVqyDiTag (small blind) showed [Js 2c] and lost with a pair of Tens
Seat 7: MIVCHqCqqlke0Lb0z7glcw (big blind) mucked
Seat 8: tZEGwCRajq0AFS6z46uW9w showed [Kd 6s] and won ($0.75) with a pair of Tens
Seat 9: ghNKXUBl/H+t83JF079ZBA folded before Flop (didn't bet)




PokerStars Game #59939463686:  Hold'em No Limit ($0.10/$0.25) - 2009/07/01 0:40:32 ET
Table '8Z6T3ssCpo3VV849U4RgBw' 9-max Seat #8 is the button
Seat 1: 8dNQBtNvCvzVgSnmDgi/LA ($12 in chips) 
Seat 2: st9jtdNbm1W5GfBwRaCVqQ ($25.80 in chips) 
Seat 3: DdPXdieucQ+n99u1n3A+rQ ($3.95 in chips) 
Seat 4: swWFmLwqgpSU1P6HAmCGPw ($16.75 in chips) 
Seat 5: zDrucyjVn5aeekNEc3cJrA ($23.55 in chips) 
Seat 6: SXqVW4Q0evTUVZG6BbUNIA ($33.05 in chips) 
Seat 7: VBHxUExRAMrbxUq/cVx9Gw ($5 in chips) 
Seat 8: hPhp/RE3cJ5YGaQ2xOHXXg ($4.90 in chips) 
Seat 9: yfkbMbx4w7MXhQDFPxOq0A ($12.75 in chips) 
yfkbMbx4w7MXhQDFPxOq0A: posts small blind $0.10
8dNQBtNvCvzVgSnmDgi/LA: posts big blind $0.25
*** HOLE CARDS ***
st9jtdNbm1W5GfBwRaCVqQ: folds 
DdPXdieucQ+n99u1n3A+rQ: folds 
swWFmLwqgpSU1P6HAmCGPw: folds 
zDrucyjVn5aeekNEc3cJrA: folds 
SXqVW4Q0evTUVZG6BbUNIA: raises $0.75 to $1
VBHxUExRAMrbxUq/cVx9Gw: folds 
hPhp/RE3cJ5YGaQ2xOHXXg: folds 
yfkbMbx4w7MXhQDFPxOq0A: folds 
8dNQBtNvCvzVgSnmDgi/LA: folds 
Uncalled bet ($0.75) returned to SXqVW4Q0evTUVZG6BbUNIA
SXqVW4Q0evTUVZG6BbUNIA collected $0.60 from pot
SXqVW4Q0evTUVZG6BbUNIA: doesn't show hand 
*** SUMMARY ***
Total pot $0.60 | Rake $0 
Seat 1: 8dNQBtNvCvzVgSnmDgi/LA (big blind) folded before Flop
Seat 2: st9jtdNbm1W5GfBwRaCVqQ folded before Flop (didn't bet)
Seat 3: DdPXdieucQ+n99u1n3A+rQ folded before Flop (didn't bet)
Seat 4: swWFmLwqgpSU1P6HAmCGPw folded before Flop (didn't bet)
Seat 5: zDrucyjVn5aeekNEc3cJrA folded before Flop (didn't bet)
Seat 6: SXqVW4Q0evTUVZG6BbUNIA collected ($0.60)
Seat 7: VBHxUExRAMrbxUq/cVx9Gw folded before Flop (didn't bet)
Seat 8: hPhp/RE3cJ5YGaQ2xOHXXg (button) folded before Flop (didn't bet)
Seat 9: yfkbMbx4w7MXhQDFPxOq0A (small blind) folded before Flop




PokerStars Game #59939463682:  Hold'em No Limit ($0.10/$0.25) - 2009/07/01 0:40:32 ET
Table '1zj0+miaIL9cvwnT/50pOA' 9-max Seat #2 is the button
Seat 1: spidnpwmoJ1L6yeNW7D5UA ($25.50 in chips) 
Seat 2: HPEB+AtKw1+C/cxU0o1ciw ($28.45 in chips) 
Seat 3: CYkY0dNBaYaKs8HVCVn3mQ ($5.60 in chips) 
Seat 4: 6esz1u5YivjsX0UoeMBm3w ($22.50 in chips) 
Seat 5: JxpnpCmvRAcrEUy7mq1iAg ($5.70 in chips) 
Seat 6: ydoFOVgzvZv9ZhuWu9rXAw ($5 in chips) 
Seat 7: 6oWOdVz2WG2azNuOj9rMgg ($16.45 in chips) 
Seat 8: HOiu48bZMhEZSoJa8mjiMw ($32.55 in chips) 
Seat 9: OiV1PWZ3IkN29JlmCcnTwQ ($5.25 in chips) 
CYkY0dNBaYaKs8HVCVn3mQ: posts small blind $0.10
6esz1u5YivjsX0UoeMBm3w: posts big blind $0.25
*** HOLE CARDS ***
JxpnpCmvRAcrEUy7mq1iAg: folds 
ydoFOVgzvZv9ZhuWu9rXAw: folds 
6oWOdVz2WG2azNuOj9rMgg: calls $0.25
HOiu48bZMhEZSoJa8mjiMw: folds 
OiV1PWZ3IkN29JlmCcnTwQ: folds 
spidnpwmoJ1L6yeNW7D5UA: calls $0.25
HPEB+AtKw1+C/cxU0o1ciw: folds 
CYkY0dNBaYaKs8HVCVn3mQ: folds 
6esz1u5YivjsX0UoeMBm3w: checks 
*** FLOP *** [Kc 8h 8d]
6esz1u5YivjsX0UoeMBm3w: checks 
6oWOdVz2WG2azNuOj9rMgg: checks 
spidnpwmoJ1L6yeNW7D5UA: bets $0.50
6esz1u5YivjsX0UoeMBm3w: folds 
6oWOdVz2WG2azNuOj9rMgg: folds 
Uncalled bet ($0.50) returned to spidnpwmoJ1L6yeNW7D5UA
spidnpwmoJ1L6yeNW7D5UA collected $0.85 from pot
*** SUMMARY ***
Total pot $0.85 | Rake $0 
Board [Kc 8h 8d]
Seat 1: spidnpwmoJ1L6yeNW7D5UA collected ($0.85)
Seat 2: HPEB+AtKw1+C/cxU0o1ciw (button) folded before Flop (didn't bet)
Seat 3: CYkY0dNBaYaKs8HVCVn3mQ (small blind) folded before Flop
Seat 4: 6esz1u5YivjsX0UoeMBm3w (big blind) folded on the Flop
Seat 5: JxpnpCmvRAcrEUy7mq1iAg folded before Flop (didn't bet)
Seat 6: ydoFOVgzvZv9ZhuWu9rXAw folded before Flop (didn't bet)
Seat 7: 6oWOdVz2WG2azNuOj9rMgg folded on the Flop
Seat 8: HOiu48bZMhEZSoJa8mjiMw folded before Flop (didn't bet)
Seat 9: OiV1PWZ3IkN29JlmCcnTwQ folded before Flop (didn't bet)




PokerStars Game #59939464644:  Hold'em No Limit ($0.10/$0.25) - 2009/07/01 0:40:33 ET
Table 'R5qKG21jwFDYRcOht9qwqQ' 9-max Seat #3 is the button
Seat 1: OgISYvc5hA85YuDnsXCH+Q ($15.50 in chips) 
Seat 2: N6foVRyErHqcNmshkqextQ ($15.40 in chips) 
Seat 3: M2QO2DxB5Wawg2h8HSpnYA ($10 in chips) 
Seat 4: z5GxcHlYz/GSz6W2uFiTtg ($26.10 in chips) 
Seat 5: 8B/dhbQjIWe6ASCdgzktNQ ($25 in chips) 
Seat 6: sUVgUtgbfVx6JpvApozwhQ ($11.10 in chips) 
Seat 7: HYQiVfBGJsg4smSubKCBmA ($28.50 in chips) 
Seat 8: tYsOBqdU1+x+yFI7zHO7hQ ($25 in chips) 
Seat 9: MG90wfSJZnOejs/KD3vlQQ ($26 in chips) 
z5GxcHlYz/GSz6W2uFiTtg: posts small blind $0.10
8B/dhbQjIWe6ASCdgzktNQ: posts big blind $0.25
*** HOLE CARDS ***
sUVgUtgbfVx6JpvApozwhQ: folds 
HYQiVfBGJsg4smSubKCBmA: folds 
tYsOBqdU1+x+yFI7zHO7hQ: folds 
MG90wfSJZnOejs/KD3vlQQ: folds 
OgISYvc5hA85YuDnsXCH+Q: folds 
N6foVRyErHqcNmshkqextQ: folds 
M2QO2DxB5Wawg2h8HSpnYA: folds 
z5GxcHlYz/GSz6W2uFiTtg: calls $0.15
8B/dhbQjIWe6ASCdgzktNQ: checks 
*** FLOP *** [Jd Ah 6c]
z5GxcHlYz/GSz6W2uFiTtg: checks 
8B/dhbQjIWe6ASCdgzktNQ: checks 
*** TURN *** [Jd Ah 6c] [7d]
z5GxcHlYz/GSz6W2uFiTtg: bets $0.25
8B/dhbQjIWe6ASCdgzktNQ: folds 
Uncalled bet ($0.25) returned to z5GxcHlYz/GSz6W2uFiTtg
z5GxcHlYz/GSz6W2uFiTtg collected $0.50 from pot
*** SUMMARY ***
Total pot $0.50 | Rake $0 
Board [Jd Ah 6c 7d]
Seat 1: OgISYvc5hA85YuDnsXCH+Q folded before Flop (didn't bet)
Seat 2: N6foVRyErHqcNmshkqextQ folded before Flop (didn't bet)
Seat 3: M2QO2DxB5Wawg2h8HSpnYA (button) folded before Flop (didn't bet)
Seat 4: z5GxcHlYz/GSz6W2uFiTtg (small blind) collected ($0.50)
Seat 5: 8B/dhbQjIWe6ASCdgzktNQ (big blind) folded on the Turn
Seat 6: sUVgUtgbfVx6JpvApozwhQ folded before Flop (didn't bet)
Seat 7: HYQiVfBGJsg4smSubKCBmA folded before Flop (didn't bet)
Seat 8: tYsOBqdU1+x+yFI7zHO7hQ folded before Flop (didn't bet)
Seat 9: MG90wfSJZnOejs/KD3vlQQ folded before Flop (didn't bet)




PokerStars Game #59939464312:  Hold'em No Limit ($0.10/$0.25) - 2009/07/01 0:40:33 ET
Table 'I0ZcuiUTeLuGYv26Nah7YA' 9-max Seat #1 is the button
Seat 1: iMiqaPr7dx84UF0wNUeh8A ($19.70 in chips) 
Seat 2: zE0IkNrJoJD964o4eqmCxQ ($2.20 in chips) 
Seat 3: 1S/fpm+f42V/6MNZre+ccg ($27.20 in chips) 
Seat 4: 4awUyiDYTgylQKXZ9faBVA ($30.25 in chips) 
Seat 5: opOCI2p6kW0tINuVaAqmcQ ($45 in chips) 
Seat 6: JRV2PblFtPFz51l0Fwyz8g ($24.75 in chips) 
Seat 7: JxpnpCmvRAcrEUy7mq1iAg ($6.10 in chips) 
Seat 8: ijc1q+bpPQR12wxc0sWc4w ($14.25 in chips) 
Seat 9: 2mQl0jr5DPlr6jqhvCq8Xw ($9.10 in chips) 
zE0IkNrJoJD964o4eqmCxQ: posts small blind $0.10
1S/fpm+f42V/6MNZre+ccg: posts big blind $0.25
*** HOLE CARDS ***
zE0IkNrJoJD964o4eqmCxQ said, "one bet and you would have taken it"
4awUyiDYTgylQKXZ9faBVA: folds 
opOCI2p6kW0tINuVaAqmcQ: raises $0.50 to $0.75
JRV2PblFtPFz51l0Fwyz8g: folds 
JxpnpCmvRAcrEUy7mq1iAg: folds 
ijc1q+bpPQR12wxc0sWc4w: folds 
2mQl0jr5DPlr6jqhvCq8Xw: calls $0.75
iMiqaPr7dx84UF0wNUeh8A: folds 
zE0IkNrJoJD964o4eqmCxQ: folds 
1S/fpm+f42V/6MNZre+ccg: folds 
*** FLOP *** [8s 2c 2h]
opOCI2p6kW0tINuVaAqmcQ: checks 
2mQl0jr5DPlr6jqhvCq8Xw: bets $2
iMiqaPr7dx84UF0wNUeh8A said, "well thanks for your expert advice, but i think i will just stick to my own theory"
opOCI2p6kW0tINuVaAqmcQ: folds 
Uncalled bet ($2) returned to 2mQl0jr5DPlr6jqhvCq8Xw
2mQl0jr5DPlr6jqhvCq8Xw collected $1.80 from pot
*** SUMMARY ***
Total pot $1.85 | Rake $0.05 
Board [8s 2c 2h]
Seat 1: iMiqaPr7dx84UF0wNUeh8A (button) folded before Flop (didn't bet)
Seat 2: zE0IkNrJoJD964o4eqmCxQ (small blind) folded before Flop
Seat 3: 1S/fpm+f42V/6MNZre+ccg (big blind) folded before Flop
Seat 4: 4awUyiDYTgylQKXZ9faBVA folded before Flop (didn't bet)
Seat 5: opOCI2p6kW0tINuVaAqmcQ folded on the Flop
Seat 6: JRV2PblFtPFz51l0Fwyz8g folded before Flop (didn't bet)
Seat 7: JxpnpCmvRAcrEUy7mq1iAg folded before Flop (didn't bet)
Seat 8: ijc1q+bpPQR12wxc0sWc4w folded before Flop (didn't bet)
Seat 9: 2mQl0jr5DPlr6jqhvCq8Xw collected ($1.80)




PokerStars Game #59939464840:  Hold'em No Limit ($0.10/$0.25) - 2009/07/01 0:40:33 ET
Table 'sIHZ0lzLr4NGCaBUKhmYhA' 6-max Seat #1 is the button
Seat 1: q6WfTUAD9mowIP63ASq2Dg ($34.45 in chips) 
Seat 2: 1xmHIWgZaOCqEMnW2GkFfw ($10.95 in chips) 
Seat 3: SxIIgwXYLkwd6m3wLyPTCw ($25.15 in chips) 
Seat 4: 4YSTu0Cdzpppe1lUgCZGCQ ($33.55 in chips) 
1xmHIWgZaOCqEMnW2GkFfw: posts small blind $0.10
SxIIgwXYLkwd6m3wLyPTCw: posts big blind $0.25
*** HOLE CARDS ***
4YSTu0Cdzpppe1lUgCZGCQ: folds 
q6WfTUAD9mowIP63ASq2Dg: folds 
1xmHIWgZaOCqEMnW2GkFfw: calls $0.15
SxIIgwXYLkwd6m3wLyPTCw: checks 
*** FLOP *** [5h Td 7d]
1xmHIWgZaOCqEMnW2GkFfw: bets $1
SxIIgwXYLkwd6m3wLyPTCw: folds 
Uncalled bet ($1) returned to 1xmHIWgZaOCqEMnW2GkFfw
VladBah joins the table at seat #5 
1xmHIWgZaOCqEMnW2GkFfw collected $0.50 from pot
1xmHIWgZaOCqEMnW2GkFfw: doesn't show hand 
*** SUMMARY ***
Total pot $0.50 | Rake $0 
Board [5h Td 7d]
Seat 1: q6WfTUAD9mowIP63ASq2Dg (button) folded before Flop (didn't bet)
Seat 2: 1xmHIWgZaOCqEMnW2GkFfw (small blind) collected ($0.50)
Seat 3: SxIIgwXYLkwd6m3wLyPTCw (big blind) folded on the Flop
Seat 4: 4YSTu0Cdzpppe1lUgCZGCQ folded before Flop (didn't bet)




PokerStars Game #59939464838:  Hold'em No Limit ($0.10/$0.25) - 2009/07/01 0:40:33 ET
Table 'f9j+4UOgRPXbyNbQkZFm4w' 6-max Seat #5 is the button
Seat 1: trN/oHqTTbPw5MNuKrOpLw ($30.85 in chips) 
Seat 2: VHBox3ZuV+/MP3dz2hFEBQ ($5.10 in chips) 
Seat 3: wCBHaebpIJ2ZTqigoRi9DA ($17.75 in chips) 
Seat 4: hiTEr3yrERiQp3zHXRioVw ($21.75 in chips) 
Seat 5: 1lxYIAoJdZwAbzIkzWmSkw ($6.25 in chips) 
Seat 6: C84t1kUtjDF/zm38/Dpcng ($13.25 in chips) 
C84t1kUtjDF/zm38/Dpcng: posts small blind $0.10
trN/oHqTTbPw5MNuKrOpLw: posts big blind $0.25
*** HOLE CARDS ***
VHBox3ZuV+/MP3dz2hFEBQ: raises $0.25 to $0.50
wCBHaebpIJ2ZTqigoRi9DA: raises $0.25 to $0.75
hiTEr3yrERiQp3zHXRioVw: folds 
1lxYIAoJdZwAbzIkzWmSkw: folds 
C84t1kUtjDF/zm38/Dpcng: folds 
trN/oHqTTbPw5MNuKrOpLw: folds 
VHBox3ZuV+/MP3dz2hFEBQ: calls $0.25
*** FLOP *** [8d 4s 7d]
VHBox3ZuV+/MP3dz2hFEBQ: bets $1.25
wCBHaebpIJ2ZTqigoRi9DA: raises $1.25 to $2.50
VHBox3ZuV+/MP3dz2hFEBQ: raises $1.85 to $4.35 and is all-in
wCBHaebpIJ2ZTqigoRi9DA: calls $1.85
*** TURN *** [8d 4s 7d] [Js]
*** RIVER *** [8d 4s 7d Js] [Jd]
*** SHOW DOWN ***
VHBox3ZuV+/MP3dz2hFEBQ: shows [Ah 9d] (a pair of Jacks)
wCBHaebpIJ2ZTqigoRi9DA: shows [Ks Kd] (two pair, Kings and Jacks)
wCBHaebpIJ2ZTqigoRi9DA collected $10.05 from pot
*** SUMMARY ***
Total pot $10.55 | Rake $0.50 
Board [8d 4s 7d Js Jd]
Seat 1: trN/oHqTTbPw5MNuKrOpLw (big blind) folded before Flop
Seat 2: VHBox3ZuV+/MP3dz2hFEBQ showed [Ah 9d] and lost with a pair of Jacks
Seat 3: wCBHaebpIJ2ZTqigoRi9DA showed [Ks Kd] and won ($10.05) with two pair, Kings and Jacks
Seat 4: hiTEr3yrERiQp3zHXRioVw folded before Flop (didn't bet)
Seat 5: 1lxYIAoJdZwAbzIkzWmSkw (button) folded before Flop (didn't bet)
Seat 6: C84t1kUtjDF/zm38/Dpcng (small blind) folded before Flop




PokerStars Game #59939464768:  Hold'em No Limit ($0.10/$0.25) - 2009/07/01 0:40:33 ET
Table '3760QYRYyCWeXf0rLZ5S2g' 9-max Seat #1 is the button
Seat 1: COsrwJSFHQtxlUcrYtDQPQ ($25 in chips) 
Seat 2: zDrucyjVn5aeekNEc3cJrA ($20.95 in chips) 
Seat 3: aLYacoAY3e5d/M5ToF8Ujw ($20.70 in chips) 
Seat 5: MG90wfSJZnOejs/KD3vlQQ ($28.85 in chips) 
Seat 6: DnDcAdn9P0zGovMERigpFA ($47.05 in chips) 
Seat 8: nl78vdCYaG2sN+td5Z33sA ($7 in chips) 
Seat 9: aNpwfA31EREwO+ar4XzBCw ($25 in chips) 
zDrucyjVn5aeekNEc3cJrA: posts small blind $0.10
aLYacoAY3e5d/M5ToF8Ujw: posts big blind $0.25
*** HOLE CARDS ***
MG90wfSJZnOejs/KD3vlQQ: folds 
DnDcAdn9P0zGovMERigpFA: folds 
nl78vdCYaG2sN+td5Z33sA: calls $0.25
aNpwfA31EREwO+ar4XzBCw: folds 
COsrwJSFHQtxlUcrYtDQPQ: folds 
zDrucyjVn5aeekNEc3cJrA: calls $0.15
aLYacoAY3e5d/M5ToF8Ujw: checks 
*** FLOP *** [Jh 8h 7h]
zDrucyjVn5aeekNEc3cJrA: checks 
aLYacoAY3e5d/M5ToF8Ujw: checks 
nl78vdCYaG2sN+td5Z33sA: bets $0.50
zDrucyjVn5aeekNEc3cJrA: folds 
aLYacoAY3e5d/M5ToF8Ujw: folds 
Uncalled bet ($0.50) returned to nl78vdCYaG2sN+td5Z33sA
nl78vdCYaG2sN+td5Z33sA collected $0.75 from pot
*** SUMMARY ***
Total pot $0.75 | Rake $0 
Board [Jh 8h 7h]
Seat 1: COsrwJSFHQtxlUcrYtDQPQ (button) folded before Flop (didn't bet)
Seat 2: zDrucyjVn5aeekNEc3cJrA (small blind) folded on the Flop
Seat 3: aLYacoAY3e5d/M5ToF8Ujw (big blind) folded on the Flop
Seat 5: MG90wfSJZnOejs/KD3vlQQ folded before Flop (didn't bet)
Seat 6: DnDcAdn9P0zGovMERigpFA folded before Flop (didn't bet)
Seat 8: nl78vdCYaG2sN+td5Z33sA collected ($0.75)
Seat 9: aNpwfA31EREwO+ar4XzBCw folded before Flop (didn't bet)




PokerStars Game #59939464342:  Hold'em No Limit ($0.10/$0.25) - 2009/07/01 0:40:33 ET
Table 'T/iCKJXGphRN3xcdwfE/JQ' 6-max Seat #1 is the button
Seat 1: zZ8zH49EwNs0mqgppOaL9g ($25 in chips) 
Seat 2: FHilMb2i2DbUCc9lplszog ($16 in chips) 
Seat 3: R6AGToFJQOYVZAjC2jXEKw ($24.35 in chips) 
Seat 4: yzFNNFIfC89bBPwpFPx2ow ($46.25 in chips) 
Seat 6: jKYGBgexhqKT13Xana4EHg ($11.50 in chips) 
FHilMb2i2DbUCc9lplszog: posts small blind $0.10
R6AGToFJQOYVZAjC2jXEKw: posts big blind $0.25
*** HOLE CARDS ***
yzFNNFIfC89bBPwpFPx2ow: folds 
jKYGBgexhqKT13Xana4EHg: calls $0.25
zZ8zH49EwNs0mqgppOaL9g: folds 
FHilMb2i2DbUCc9lplszog: calls $0.15
R6AGToFJQOYVZAjC2jXEKw: checks 
*** FLOP *** [6h 7s As]
FHilMb2i2DbUCc9lplszog: bets $0.75
R6AGToFJQOYVZAjC2jXEKw: folds 
jKYGBgexhqKT13Xana4EHg: raises $0.75 to $1.50
FHilMb2i2DbUCc9lplszog: calls $0.75
*** TURN *** [6h 7s As] [Ad]
FHilMb2i2DbUCc9lplszog: checks 
jKYGBgexhqKT13Xana4EHg: checks 
*** RIVER *** [6h 7s As Ad] [3s]
FHilMb2i2DbUCc9lplszog: checks 
jKYGBgexhqKT13Xana4EHg: bets $1.50
FHilMb2i2DbUCc9lplszog: calls $1.50
*** SHOW DOWN ***
jKYGBgexhqKT13Xana4EHg: shows [Ac 6c] (a full house, Aces full of Sixes)
FHilMb2i2DbUCc9lplszog: mucks hand 
jKYGBgexhqKT13Xana4EHg collected $6.45 from pot
*** SUMMARY ***
Total pot $6.75 | Rake $0.30 
Board [6h 7s As Ad 3s]
Seat 1: zZ8zH49EwNs0mqgppOaL9g (button) folded before Flop (didn't bet)
Seat 2: FHilMb2i2DbUCc9lplszog (small blind) mucked
Seat 3: R6AGToFJQOYVZAjC2jXEKw (big blind) folded on the Flop
Seat 4: yzFNNFIfC89bBPwpFPx2ow folded before Flop (didn't bet)
Seat 6: jKYGBgexhqKT13Xana4EHg showed [Ac 6c] and won ($6.45) with a full house, Aces full of Sixes




PokerStars Game #59939464938:  Hold'em No Limit ($0.10/$0.25) - 2009/07/01 0:40:34 ET
Table 'gHbubGDeVSkmB4vFiqIN3Q' 6-max Seat #2 is the button
Seat 2: 8LzEWRhg4wk8Jh9CqDhH3Q ($3.50 in chips) 
Seat 4: v+QfkGiuj9bgtuNoVnDO8w ($32.25 in chips) 
Seat 6: wvIIdlbCgePONQwXjx9xzQ ($5.50 in chips) 
v+QfkGiuj9bgtuNoVnDO8w: posts small blind $0.10
wvIIdlbCgePONQwXjx9xzQ: posts big blind $0.25
*** HOLE CARDS ***
8LzEWRhg4wk8Jh9CqDhH3Q: folds 
v+QfkGiuj9bgtuNoVnDO8w: folds 
Uncalled bet ($0.15) returned to wvIIdlbCgePONQwXjx9xzQ
wvIIdlbCgePONQwXjx9xzQ collected $0.20 from pot
wvIIdlbCgePONQwXjx9xzQ: doesn't show hand 
*** SUMMARY ***
Total pot $0.20 | Rake $0 
Seat 2: 8LzEWRhg4wk8Jh9CqDhH3Q (button) folded before Flop (didn't bet)
Seat 4: v+QfkGiuj9bgtuNoVnDO8w (small blind) folded before Flop
Seat 6: wvIIdlbCgePONQwXjx9xzQ (big blind) collected ($0.20)




PokerStars Game #59939465066:  Hold'em No Limit ($0.10/$0.25) - 2009/07/01 0:40:34 ET
Table 'U0hCzoS0KCJL+eoE054K4Q' 9-max Seat #2 is the button
Seat 2: MG90wfSJZnOejs/KD3vlQQ ($25 in chips) 
Seat 3: u/r4MjA69AbvOh1qLp6Eig ($14.75 in chips) 
Seat 4: REZJH+hR80RwfrJtUNUJOw ($29.05 in chips) 
Seat 5: gN5V9qraLHmhKzjLHzt7qA ($15.85 in chips) 
Seat 7: NNZypfH1f/VIj3Skf/XIzg ($5 in chips) 
Seat 8: Xpyqpb+DURDWnyJ3xTEIFQ ($26.80 in chips) 
Seat 9: X9HkgGdfFul8DB9rhTbyFw ($37.35 in chips) 
u/r4MjA69AbvOh1qLp6Eig: posts small blind $0.10
REZJH+hR80RwfrJtUNUJOw: posts big blind $0.25
CYkY0dNBaYaKs8HVCVn3mQ: sits out 
*** HOLE CARDS ***
gN5V9qraLHmhKzjLHzt7qA: calls $0.25
NNZypfH1f/VIj3Skf/XIzg: raises $0.50 to $0.75
Xpyqpb+DURDWnyJ3xTEIFQ: folds 
X9HkgGdfFul8DB9rhTbyFw: folds 
MG90wfSJZnOejs/KD3vlQQ: folds 
u/r4MjA69AbvOh1qLp6Eig: folds 
REZJH+hR80RwfrJtUNUJOw: folds 
gN5V9qraLHmhKzjLHzt7qA: calls $0.50
*** FLOP *** [7h Qh 6h]
gN5V9qraLHmhKzjLHzt7qA: checks 
NNZypfH1f/VIj3Skf/XIzg: bets $0.75
gN5V9qraLHmhKzjLHzt7qA: calls $0.75
*** TURN *** [7h Qh 6h] [Kh]
gN5V9qraLHmhKzjLHzt7qA: checks 
NNZypfH1f/VIj3Skf/XIzg: checks 
*** RIVER *** [7h Qh 6h Kh] [6c]
gN5V9qraLHmhKzjLHzt7qA: bets $1.25
NNZypfH1f/VIj3Skf/XIzg: calls $1.25
*** SHOW DOWN ***
gN5V9qraLHmhKzjLHzt7qA: shows [9d Th] (a flush, King high)
NNZypfH1f/VIj3Skf/XIzg: mucks hand 
gN5V9qraLHmhKzjLHzt7qA collected $5.60 from pot
*** SUMMARY ***
Total pot $5.85 | Rake $0.25 
Board [7h Qh 6h Kh 6c]
Seat 2: MG90wfSJZnOejs/KD3vlQQ (button) folded before Flop (didn't bet)
Seat 3: u/r4MjA69AbvOh1qLp6Eig (small blind) folded before Flop
Seat 4: REZJH+hR80RwfrJtUNUJOw (big blind) folded before Flop
Seat 5: gN5V9qraLHmhKzjLHzt7qA showed [9d Th] and won ($5.60) with a flush, King high
Seat 7: NNZypfH1f/VIj3Skf/XIzg mucked
Seat 8: Xpyqpb+DURDWnyJ3xTEIFQ folded before Flop (didn't bet)
Seat 9: X9HkgGdfFul8DB9rhTbyFw folded before Flop (didn't bet)




PokerStars Game #59939465462:  Hold'em No Limit ($0.10/$0.25) - 2009/07/01 0:40:34 ET
Table 'b64Z+5XI1xkQzNfq4QHr3A' 6-max Seat #1 is the button
Seat 1: qccGLncfUaN00Few5HsgYg ($54.65 in chips) 
Seat 2: SS/yfeArhULzIcOPe8MdPg ($34.50 in chips) 
Seat 3: u/yN5P9f3KlATg6WLWNkBQ ($20.75 in chips) 
Seat 4: SxIIgwXYLkwd6m3wLyPTCw ($25 in chips) 
Seat 5: d0J1xuhsynEY81YHwAvJ5g ($33.25 in chips) 
Seat 6: 8ClCHtFXGNplITm+63KB+Q ($38.35 in chips) 
SS/yfeArhULzIcOPe8MdPg: posts small blind $0.10
u/yN5P9f3KlATg6WLWNkBQ: posts big blind $0.25
*** HOLE CARDS ***
SxIIgwXYLkwd6m3wLyPTCw: raises $0.50 to $0.75
d0J1xuhsynEY81YHwAvJ5g: folds 
8ClCHtFXGNplITm+63KB+Q: folds 
qccGLncfUaN00Few5HsgYg: folds 
SS/yfeArhULzIcOPe8MdPg: folds 
u/yN5P9f3KlATg6WLWNkBQ: folds 
Uncalled bet ($0.50) returned to SxIIgwXYLkwd6m3wLyPTCw
SxIIgwXYLkwd6m3wLyPTCw collected $0.60 from pot
SxIIgwXYLkwd6m3wLyPTCw: doesn't show hand 
*** SUMMARY ***
Total pot $0.60 | Rake $0 
Seat 1: qccGLncfUaN00Few5HsgYg (button) folded before Flop (didn't bet)
Seat 2: SS/yfeArhULzIcOPe8MdPg (small blind) folded before Flop
Seat 3: u/yN5P9f3KlATg6WLWNkBQ (big blind) folded before Flop
Seat 4: SxIIgwXYLkwd6m3wLyPTCw collected ($0.60)
Seat 5: d0J1xuhsynEY81YHwAvJ5g folded before Flop (didn't bet)
Seat 6: 8ClCHtFXGNplITm+63KB+Q folded before Flop (didn't bet)




PokerStars Game #59939464966:  Hold'em No Limit ($0.10/$0.25) - 2009/07/01 0:40:34 ET
Table 'h02LhQ7B/Zk4ETRxxHhGYA' 9-max Seat #4 is the button
Seat 1: sD+TKtt36XiiN6jqHiLwDA ($22.40 in chips) 
Seat 2: RJ/x9oZtt1RZLaJEQwZOxQ ($27.70 in chips) 
Seat 3: kqpa/IbqkUrwPb3hbA7/ww ($10 in chips) 
Seat 4: tYsOBqdU1+x+yFI7zHO7hQ ($38.20 in chips) 
Seat 5: cUxk0Jk4lrUQv9CJl0LPlg ($18.45 in chips) 
Seat 6: kN/irnQSdb8jibbN4f1O+Q ($18.05 in chips) 
Seat 7: rUpvA02nErFvZ4yFbDR8XA ($19.45 in chips) 
Seat 8: 7tW694tRVJnYdoa16Dw4RQ ($25.45 in chips) 
Seat 9: 1c/7DHPx5CDTmAfk8/bWeA ($14.30 in chips) 
cUxk0Jk4lrUQv9CJl0LPlg: posts small blind $0.10
kN/irnQSdb8jibbN4f1O+Q: posts big blind $0.25
kqpa/IbqkUrwPb3hbA7/ww: posts big blind $0.25
*** HOLE CARDS ***
rUpvA02nErFvZ4yFbDR8XA: folds 
7tW694tRVJnYdoa16Dw4RQ: calls $0.25
1c/7DHPx5CDTmAfk8/bWeA: calls $0.25
sD+TKtt36XiiN6jqHiLwDA: folds 
RJ/x9oZtt1RZLaJEQwZOxQ: calls $0.25
kqpa/IbqkUrwPb3hbA7/ww: checks 
tYsOBqdU1+x+yFI7zHO7hQ: folds 
cUxk0Jk4lrUQv9CJl0LPlg: folds 
kN/irnQSdb8jibbN4f1O+Q: checks 
*** FLOP *** [5d Js 2h]
kN/irnQSdb8jibbN4f1O+Q: checks 
7tW694tRVJnYdoa16Dw4RQ: checks 
1c/7DHPx5CDTmAfk8/bWeA: checks 
RJ/x9oZtt1RZLaJEQwZOxQ: checks 
kqpa/IbqkUrwPb3hbA7/ww: checks 
*** TURN *** [5d Js 2h] [3s]
kN/irnQSdb8jibbN4f1O+Q: checks 
7tW694tRVJnYdoa16Dw4RQ: checks 
1c/7DHPx5CDTmAfk8/bWeA: bets $1
RJ/x9oZtt1RZLaJEQwZOxQ: folds 
kqpa/IbqkUrwPb3hbA7/ww: calls $1
kN/irnQSdb8jibbN4f1O+Q: folds 
7tW694tRVJnYdoa16Dw4RQ: folds 
*** RIVER *** [5d Js 2h 3s] [7h]
1c/7DHPx5CDTmAfk8/bWeA: checks 
kqpa/IbqkUrwPb3hbA7/ww: checks 
*** SHOW DOWN ***
1c/7DHPx5CDTmAfk8/bWeA: shows [8d 8h] (a pair of Eights)
kqpa/IbqkUrwPb3hbA7/ww: mucks hand 
kqpa/IbqkUrwPb3hbA7/ww is sitting out
1c/7DHPx5CDTmAfk8/bWeA collected $3.20 from pot
*** SUMMARY ***
Total pot $3.35 | Rake $0.15 
Board [5d Js 2h 3s 7h]
Seat 1: sD+TKtt36XiiN6jqHiLwDA folded before Flop (didn't bet)
Seat 2: RJ/x9oZtt1RZLaJEQwZOxQ folded on the Turn
Seat 3: kqpa/IbqkUrwPb3hbA7/ww mucked
Seat 4: tYsOBqdU1+x+yFI7zHO7hQ (button) folded before Flop (didn't bet)
Seat 5: cUxk0Jk4lrUQv9CJl0LPlg (small blind) folded before Flop
Seat 6: kN/irnQSdb8jibbN4f1O+Q (big blind) folded on the Turn
Seat 7: rUpvA02nErFvZ4yFbDR8XA folded before Flop (didn't bet)
Seat 8: 7tW694tRVJnYdoa16Dw4RQ folded on the Turn
Seat 9: 1c/7DHPx5CDTmAfk8/bWeA showed [8d 8h] and won ($3.20) with a pair of Eights




PokerStars Game #59939465754:  Hold'em No Limit ($0.10/$0.25) - 2009/07/01 0:40:35 ET
Table 'h3+tJ4Vtwq0R+eA8S73eZA' 9-max Seat #5 is the button
Seat 1: H5Se03ZqSX7tbULXur2MAg ($20.90 in chips) 
Seat 2: Th3FldXKQW6hWVVPahaoOQ ($27.40 in chips) 
Seat 3: crgjVDgmUqCw4RyLzbohWQ ($17 in chips) 
Seat 4: M2QO2DxB5Wawg2h8HSpnYA ($11.95 in chips) 
Seat 5: cZ99hugmLBj9KhTlc8nCSw ($31.45 in chips) 
Seat 6: TvIuLx9zUCE+9Li58iImOQ ($7.50 in chips) 
Seat 7: IIGtqtVGyvZR0ZMYMMPjeQ ($27 in chips) 
Seat 8: zWJ/yHAvi0TtCR9RMsJosQ ($24.25 in chips) 
Seat 9: qwr38jl5txoR36M7G5qi4A ($8.05 in chips) 
TvIuLx9zUCE+9Li58iImOQ: posts small blind $0.10
IIGtqtVGyvZR0ZMYMMPjeQ: posts big blind $0.25
*** HOLE CARDS ***
zWJ/yHAvi0TtCR9RMsJosQ: folds 
zWJ/yHAvi0TtCR9RMsJosQ leaves the table
qwr38jl5txoR36M7G5qi4A: folds 
+2kMBNpY4nF1qNCRd8SJLA joins the table at seat #8 
H5Se03ZqSX7tbULXur2MAg: folds 
Th3FldXKQW6hWVVPahaoOQ: folds 
crgjVDgmUqCw4RyLzbohWQ: folds 
M2QO2DxB5Wawg2h8HSpnYA: folds 
cZ99hugmLBj9KhTlc8nCSw: folds 
TvIuLx9zUCE+9Li58iImOQ: calls $0.15
IIGtqtVGyvZR0ZMYMMPjeQ: checks 
*** FLOP *** [Kd 5h 6s]
TvIuLx9zUCE+9Li58iImOQ: checks 
IIGtqtVGyvZR0ZMYMMPjeQ: bets $0.25
TvIuLx9zUCE+9Li58iImOQ: folds 
Uncalled bet ($0.25) returned to IIGtqtVGyvZR0ZMYMMPjeQ
IIGtqtVGyvZR0ZMYMMPjeQ collected $0.50 from pot
IIGtqtVGyvZR0ZMYMMPjeQ: doesn't show hand 
*** SUMMARY ***
Total pot $0.50 | Rake $0 
Board [Kd 5h 6s]
Seat 1: H5Se03ZqSX7tbULXur2MAg folded before Flop (didn't bet)
Seat 2: Th3FldXKQW6hWVVPahaoOQ folded before Flop (didn't bet)
Seat 3: crgjVDgmUqCw4RyLzbohWQ folded before Flop (didn't bet)
Seat 4: M2QO2DxB5Wawg2h8HSpnYA folded before Flop (didn't bet)
Seat 5: cZ99hugmLBj9KhTlc8nCSw (button) folded before Flop (didn't bet)
Seat 6: TvIuLx9zUCE+9Li58iImOQ (small blind) folded on the Flop
Seat 7: IIGtqtVGyvZR0ZMYMMPjeQ (big blind) collected ($0.50)
Seat 8: zWJ/yHAvi0TtCR9RMsJosQ folded before Flop (didn't bet)
Seat 9: qwr38jl5txoR36M7G5qi4A folded before Flop (didn't bet)




PokerStars Game #59939465766:  Hold'em No Limit ($0.10/$0.25) - 2009/07/01 0:40:35 ET
Table 'Qk/910N2Yhg8u5vqTJk50Q' 9-max Seat #7 is the button
Seat 1: zDrucyjVn5aeekNEc3cJrA ($25.25 in chips) 
Seat 2: Th3FldXKQW6hWVVPahaoOQ ($33.20 in chips) 
Seat 3: ghNKXUBl/H+t83JF079ZBA ($25 in chips) 
Seat 4: 33y9+GmQ3J84RvZXcraRTw ($21.20 in chips) 
Seat 5: 4oA316mXLIui1QY63GXBUg ($27.25 in chips) 
Seat 6: Uupj2MGlo48VpA/VyYrfrw ($10 in chips) 
Seat 7: Wem/MTN+sc9vH/UZeT5YLQ ($9.50 in chips) 
Seat 8: H5Se03ZqSX7tbULXur2MAg ($25.60 in chips) 
Seat 9: M2QO2DxB5Wawg2h8HSpnYA ($10 in chips) 
H5Se03ZqSX7tbULXur2MAg: posts small blind $0.10
M2QO2DxB5Wawg2h8HSpnYA: posts big blind $0.25
Uupj2MGlo48VpA/VyYrfrw: posts big blind $0.25
*** HOLE CARDS ***
zDrucyjVn5aeekNEc3cJrA: folds 
Th3FldXKQW6hWVVPahaoOQ: folds 
ghNKXUBl/H+t83JF079ZBA: folds 
33y9+GmQ3J84RvZXcraRTw: folds 
4oA316mXLIui1QY63GXBUg: folds 
Uupj2MGlo48VpA/VyYrfrw: checks 
Wem/MTN+sc9vH/UZeT5YLQ: folds 
H5Se03ZqSX7tbULXur2MAg: folds 
M2QO2DxB5Wawg2h8HSpnYA: checks 
*** FLOP *** [4h Qd Jd]
M2QO2DxB5Wawg2h8HSpnYA: checks 
Uupj2MGlo48VpA/VyYrfrw: checks 
*** TURN *** [4h Qd Jd] [As]
M2QO2DxB5Wawg2h8HSpnYA: checks 
Uupj2MGlo48VpA/VyYrfrw: checks 
*** RIVER *** [4h Qd Jd As] [4c]
M2QO2DxB5Wawg2h8HSpnYA: checks 
Uupj2MGlo48VpA/VyYrfrw: checks 
*** SHOW DOWN ***
M2QO2DxB5Wawg2h8HSpnYA: shows [8h 5c] (a pair of Fours)
Uupj2MGlo48VpA/VyYrfrw: shows [7c 5s] (a pair of Fours)
M2QO2DxB5Wawg2h8HSpnYA collected $0.30 from pot
Uupj2MGlo48VpA/VyYrfrw collected $0.30 from pot
*** SUMMARY ***
Total pot $0.60 | Rake $0 
Board [4h Qd Jd As 4c]
Seat 1: zDrucyjVn5aeekNEc3cJrA folded before Flop (didn't bet)
Seat 2: Th3FldXKQW6hWVVPahaoOQ folded before Flop (didn't bet)
Seat 3: ghNKXUBl/H+t83JF079ZBA folded before Flop (didn't bet)
Seat 4: 33y9+GmQ3J84RvZXcraRTw folded before Flop (didn't bet)
Seat 5: 4oA316mXLIui1QY63GXBUg folded before Flop (didn't bet)
Seat 6: Uupj2MGlo48VpA/VyYrfrw showed [7c 5s] and won ($0.30) with a pair of Fours
Seat 7: Wem/MTN+sc9vH/UZeT5YLQ (button) folded before Flop (didn't bet)
Seat 8: H5Se03ZqSX7tbULXur2MAg (small blind) folded before Flop
Seat 9: M2QO2DxB5Wawg2h8HSpnYA (big blind) showed [8h 5c] and won ($0.30) with a pair of Fours




PokerStars Game #59939465476:  Hold'em No Limit ($0.10/$0.25) - 2009/07/01 0:40:35 ET
Table '2VkNDXXsBj4bSZw/uK5atw' 6-max Seat #1 is the button
Seat 1: 7FmwVDcdEtxDpHmP4hOXsQ ($26.40 in chips) 
Seat 4: yb6rnd48JuBccThV68VHAQ ($74.65 in chips) 
Seat 5: kyRaCIljYA6l33lSKQfNsg ($25 in chips) 
Seat 6: qGHGf/553gQnDoklMRe3tg ($18.40 in chips) 
gqW2aBCmrIw65BvwjTFN6Q will be allowed to play after the button
yb6rnd48JuBccThV68VHAQ: posts small blind $0.10
kyRaCIljYA6l33lSKQfNsg: posts big blind $0.25
*** HOLE CARDS ***
qGHGf/553gQnDoklMRe3tg: folds 
7FmwVDcdEtxDpHmP4hOXsQ: folds 
yb6rnd48JuBccThV68VHAQ: calls $0.15
kyRaCIljYA6l33lSKQfNsg: checks 
*** FLOP *** [2c 9s 3h]
yb6rnd48JuBccThV68VHAQ: bets $0.50
kyRaCIljYA6l33lSKQfNsg: folds 
Uncalled bet ($0.50) returned to yb6rnd48JuBccThV68VHAQ
yb6rnd48JuBccThV68VHAQ collected $0.50 from pot
yb6rnd48JuBccThV68VHAQ: doesn't show hand 
*** SUMMARY ***
Total pot $0.50 | Rake $0 
Board [2c 9s 3h]
Seat 1: 7FmwVDcdEtxDpHmP4hOXsQ (button) folded before Flop (didn't bet)
Seat 4: yb6rnd48JuBccThV68VHAQ (small blind) collected ($0.50)
Seat 5: kyRaCIljYA6l33lSKQfNsg (big blind) folded on the Flop
Seat 6: qGHGf/553gQnDoklMRe3tg folded before Flop (didn't bet)




PokerStars Game #59939465480:  Hold'em No Limit ($0.10/$0.25) - 2009/07/01 0:40:35 ET
Table 'nyTW9cVtYentc5V7xU/0jA' 6-max Seat #4 is the button
Seat 1: YfxPRDAWfqnGBhiIEdlTYg ($12.40 in chips) 
Seat 2: 7FmwVDcdEtxDpHmP4hOXsQ ($25 in chips) 
Seat 3: kG34n23qFQA3nzdOJTQ1dA ($24.55 in chips) 
Seat 4: r6u7MWSXF30/khcTYkrG9Q ($36.80 in chips) 
Seat 5: BedjMfrlRfPgSq7CXpPAmg ($25 in chips) 
Seat 6: dQJByDqHOLbgqX/HobyAJA ($7.75 in chips) 
BedjMfrlRfPgSq7CXpPAmg: posts small blind $0.10
dQJByDqHOLbgqX/HobyAJA: posts big blind $0.25
*** HOLE CARDS ***
YfxPRDAWfqnGBhiIEdlTYg: calls $0.25
7FmwVDcdEtxDpHmP4hOXsQ: folds 
kG34n23qFQA3nzdOJTQ1dA: folds 
r6u7MWSXF30/khcTYkrG9Q: folds 
BedjMfrlRfPgSq7CXpPAmg: folds 
dQJByDqHOLbgqX/HobyAJA: checks 
*** FLOP *** [2c 4h Ac]
dQJByDqHOLbgqX/HobyAJA: checks 
YfxPRDAWfqnGBhiIEdlTYg: checks 
*** TURN *** [2c 4h Ac] [Tc]
dQJByDqHOLbgqX/HobyAJA: bets $0.50
YfxPRDAWfqnGBhiIEdlTYg: folds 
Uncalled bet ($0.50) returned to dQJByDqHOLbgqX/HobyAJA
dQJByDqHOLbgqX/HobyAJA collected $0.60 from pot
*** SUMMARY ***
Total pot $0.60 | Rake $0 
Board [2c 4h Ac Tc]
Seat 1: YfxPRDAWfqnGBhiIEdlTYg folded on the Turn
Seat 2: 7FmwVDcdEtxDpHmP4hOXsQ folded before Flop (didn't bet)
Seat 3: kG34n23qFQA3nzdOJTQ1dA folded before Flop (didn't bet)
Seat 4: r6u7MWSXF30/khcTYkrG9Q (button) folded before Flop (didn't bet)
Seat 5: BedjMfrlRfPgSq7CXpPAmg (small blind) folded before Flop
Seat 6: dQJByDqHOLbgqX/HobyAJA (big blind) collected ($0.60)




PokerStars Game #59939465604:  Hold'em No Limit ($0.10/$0.25) - 2009/07/01 0:40:35 ET
Table 'DhkrdW2UOy2PfjSW28Kq8w' 6-max Seat #6 is the button
Seat 1: vu2kzHaDtgr6NM7rdq0chA ($25.10 in chips) 
Seat 2: v+QfkGiuj9bgtuNoVnDO8w ($25 in chips) 
Seat 3: 66a/8+qw1AZLNh63FuclPA ($43.80 in chips) 
Seat 4: I1TxPvWj8NfG8orglCinNA ($27.40 in chips) 
Seat 5: SxIIgwXYLkwd6m3wLyPTCw ($47.50 in chips) 
Seat 6: SS/yfeArhULzIcOPe8MdPg ($25.50 in chips) 
vu2kzHaDtgr6NM7rdq0chA: posts small blind $0.10
v+QfkGiuj9bgtuNoVnDO8w: posts big blind $0.25
*** HOLE CARDS ***
66a/8+qw1AZLNh63FuclPA: folds 
I1TxPvWj8NfG8orglCinNA: folds 
SxIIgwXYLkwd6m3wLyPTCw: folds 
SS/yfeArhULzIcOPe8MdPg: raises $0.75 to $1
vu2kzHaDtgr6NM7rdq0chA: calls $0.90
v+QfkGiuj9bgtuNoVnDO8w: folds 
*** FLOP *** [Qd 3s 8c]
vu2kzHaDtgr6NM7rdq0chA: checks 
SS/yfeArhULzIcOPe8MdPg: bets $1.50
vu2kzHaDtgr6NM7rdq0chA: folds 
Uncalled bet ($1.50) returned to SS/yfeArhULzIcOPe8MdPg
SS/yfeArhULzIcOPe8MdPg collected $2.15 from pot
SS/yfeArhULzIcOPe8MdPg: doesn't show hand 
*** SUMMARY ***
Total pot $2.25 | Rake $0.10 
Board [Qd 3s 8c]
Seat 1: vu2kzHaDtgr6NM7rdq0chA (small blind) folded on the Flop
Seat 2: v+QfkGiuj9bgtuNoVnDO8w (big blind) folded before Flop
Seat 3: 66a/8+qw1AZLNh63FuclPA folded before Flop (didn't bet)
Seat 4: I1TxPvWj8NfG8orglCinNA folded before Flop (didn't bet)
Seat 5: SxIIgwXYLkwd6m3wLyPTCw folded before Flop (didn't bet)
Seat 6: SS/yfeArhULzIcOPe8MdPg (button) collected ($2.15)




PokerStars Game #59939465586:  Hold'em No Limit ($0.10/$0.25) - 2009/07/01 0:40:35 ET
Table 'sgB7AwZtVgDTf4fi8RwWFQ' 9-max Seat #8 is the button
Seat 1: QEbIGci+itdw+re8RM5fZA ($25 in chips) 
Seat 2: DnDcAdn9P0zGovMERigpFA ($32 in chips) 
Seat 3: OlPJsgR4xypSg/w1z7Gyvw ($20.10 in chips) 
Seat 5: gPFzi0PLRAvfKu2GYwa1VA ($16.55 in chips) 
Seat 6: 1q23ISSsSMhv2lHXBfj9/A ($23.40 in chips) 
Seat 8: Nq5F1B22aaLLZ+D9HbzcGg ($22 in chips) 
Seat 9: MG90wfSJZnOejs/KD3vlQQ ($32.35 in chips) 
MG90wfSJZnOejs/KD3vlQQ: posts small blind $0.10
QEbIGci+itdw+re8RM5fZA: posts big blind $0.25
*** HOLE CARDS ***
DnDcAdn9P0zGovMERigpFA: folds 
OlPJsgR4xypSg/w1z7Gyvw: folds 
gPFzi0PLRAvfKu2GYwa1VA: calls $0.25
1q23ISSsSMhv2lHXBfj9/A: folds 
Nq5F1B22aaLLZ+D9HbzcGg: folds 
MG90wfSJZnOejs/KD3vlQQ: folds 
QEbIGci+itdw+re8RM5fZA: checks 
*** FLOP *** [8s Kh 2h]
QEbIGci+itdw+re8RM5fZA: checks 
gPFzi0PLRAvfKu2GYwa1VA: checks 
*** TURN *** [8s Kh 2h] [Qs]
QEbIGci+itdw+re8RM5fZA: checks 
gPFzi0PLRAvfKu2GYwa1VA: bets $0.25
QEbIGci+itdw+re8RM5fZA: calls $0.25
*** RIVER *** [8s Kh 2h Qs] [6d]
QEbIGci+itdw+re8RM5fZA: checks 
gPFzi0PLRAvfKu2GYwa1VA: checks 
*** SHOW DOWN ***
QEbIGci+itdw+re8RM5fZA: shows [Qc Ts] (a pair of Queens)
gPFzi0PLRAvfKu2GYwa1VA: mucks hand 
QEbIGci+itdw+re8RM5fZA collected $1.05 from pot
*** SUMMARY ***
Total pot $1.10 | Rake $0.05 
Board [8s Kh 2h Qs 6d]
Seat 1: QEbIGci+itdw+re8RM5fZA (big blind) showed [Qc Ts] and won ($1.05) with a pair of Queens
Seat 2: DnDcAdn9P0zGovMERigpFA folded before Flop (didn't bet)
Seat 3: OlPJsgR4xypSg/w1z7Gyvw folded before Flop (didn't bet)
Seat 5: gPFzi0PLRAvfKu2GYwa1VA mucked
Seat 6: 1q23ISSsSMhv2lHXBfj9/A folded before Flop (didn't bet)
Seat 8: Nq5F1B22aaLLZ+D9HbzcGg (button) folded before Flop (didn't bet)
Seat 9: MG90wfSJZnOejs/KD3vlQQ (small blind) folded before Flop




PokerStars Game #59939466274:  Hold'em No Limit ($0.10/$0.25) - 2009/07/01 0:40:36 ET
Table 'nteM56rtr9SxLEblf0fvbw' 9-max Seat #7 is the button
Seat 1: H9KUl8cmpLgEpOVDA00bCg ($5 in chips) 
Seat 2: ljemhp25Zg+nlA9DLCIiUw ($25.95 in chips) 
Seat 4: cZ99hugmLBj9KhTlc8nCSw ($25.50 in chips) 
Seat 5: aJy680tKSaP5er559aSuGA ($9.95 in chips) 
Seat 7: dfNim92Z6XK1/h5SFW5vDg ($49.30 in chips) 
Seat 8: RJ/x9oZtt1RZLaJEQwZOxQ ($43.90 in chips) 
Seat 9: t2nb95S5EEFOEzNx9Itz0g ($6.90 in chips) 
RJ/x9oZtt1RZLaJEQwZOxQ: posts small blind $0.10
LH8Esb23EO9V9GrKx+ymWQ joins the table at seat #6 
t2nb95S5EEFOEzNx9Itz0g: posts big blind $0.25
*** HOLE CARDS ***
H9KUl8cmpLgEpOVDA00bCg: folds 
ljemhp25Zg+nlA9DLCIiUw: folds 
cZ99hugmLBj9KhTlc8nCSw: folds 
aJy680tKSaP5er559aSuGA: raises $0.50 to $0.75
dfNim92Z6XK1/h5SFW5vDg: folds 
RJ/x9oZtt1RZLaJEQwZOxQ: folds 
t2nb95S5EEFOEzNx9Itz0g: folds 
Uncalled bet ($0.50) returned to aJy680tKSaP5er559aSuGA
aJy680tKSaP5er559aSuGA collected $0.60 from pot
*** SUMMARY ***
Total pot $0.60 | Rake $0 
Seat 1: H9KUl8cmpLgEpOVDA00bCg folded before Flop (didn't bet)
Seat 2: ljemhp25Zg+nlA9DLCIiUw folded before Flop (didn't bet)
Seat 4: cZ99hugmLBj9KhTlc8nCSw folded before Flop (didn't bet)
Seat 5: aJy680tKSaP5er559aSuGA collected ($0.60)
Seat 7: dfNim92Z6XK1/h5SFW5vDg (button) folded before Flop (didn't bet)
Seat 8: RJ/x9oZtt1RZLaJEQwZOxQ (small blind) folded before Flop
Seat 9: t2nb95S5EEFOEzNx9Itz0g (big blind) folded before Flop




PokerStars Game #59939466634:  Hold'em No Limit ($0.10/$0.25) - 2009/07/01 0:40:36 ET
Table 'dNYnr4D4id1jwnEU66Yowg' 9-max Seat #2 is the button
Seat 1: 41pZ+Uce9oq+8wmcVBXWIg ($15 in chips) 
Seat 2: t2nb95S5EEFOEzNx9Itz0g ($11.60 in chips) 
Seat 5: k+2r6di6GXjNpAdrRkW9bA ($18.65 in chips) 
k+2r6di6GXjNpAdrRkW9bA: posts small blind $0.10
41pZ+Uce9oq+8wmcVBXWIg: posts big blind $0.25
*** HOLE CARDS ***
t2nb95S5EEFOEzNx9Itz0g: raises $0.50 to $0.75
k+2r6di6GXjNpAdrRkW9bA said, "fish"
k+2r6di6GXjNpAdrRkW9bA: calls $0.65
41pZ+Uce9oq+8wmcVBXWIg: raises $0.50 to $1.25
t2nb95S5EEFOEzNx9Itz0g: calls $0.50
k+2r6di6GXjNpAdrRkW9bA: calls $0.50
*** FLOP *** [5h 7d 3d]
k+2r6di6GXjNpAdrRkW9bA: checks 
41pZ+Uce9oq+8wmcVBXWIg: bets $1.25
t2nb95S5EEFOEzNx9Itz0g: folds 
k+2r6di6GXjNpAdrRkW9bA: folds 
Uncalled bet ($1.25) returned to 41pZ+Uce9oq+8wmcVBXWIg
41pZ+Uce9oq+8wmcVBXWIg collected $3.60 from pot
*** SUMMARY ***
Total pot $3.75 | Rake $0.15 
Board [5h 7d 3d]
Seat 1: 41pZ+Uce9oq+8wmcVBXWIg (big blind) collected ($3.60)
Seat 2: t2nb95S5EEFOEzNx9Itz0g (button) folded on the Flop
Seat 5: k+2r6di6GXjNpAdrRkW9bA (small blind) folded on the Flop




PokerStars Game #59939466044:  Hold'em No Limit ($0.10/$0.25) - 2009/07/01 0:40:36 ET
Table 'APEHQjIcZHDZUA4iOjju2g' 6-max Seat #2 is the button
Seat 1: eHsmIvAb2JREg4O6hNPnXg ($8 in chips) 
Seat 2: 3zD3qLXT1bEffAoWGnc7wg ($25 in chips) 
Seat 3: E7KSkgfIsmIsp0vLnmGFmA ($13.95 in chips) 
Seat 4: EqXTTLKUlDlz7yi6ziyyWA ($35.40 in chips) 
Seat 5: /xN6gc9+8Hew0HxaB6VIVg ($31.60 in chips) 
Seat 6: y7HCJfEmolBCFdi/0j5TRg ($44.70 in chips) 
E7KSkgfIsmIsp0vLnmGFmA: posts small blind $0.10
EqXTTLKUlDlz7yi6ziyyWA: posts big blind $0.25
*** HOLE CARDS ***
/xN6gc9+8Hew0HxaB6VIVg: folds 
y7HCJfEmolBCFdi/0j5TRg: folds 
eHsmIvAb2JREg4O6hNPnXg: folds 
3zD3qLXT1bEffAoWGnc7wg: folds 
E7KSkgfIsmIsp0vLnmGFmA: calls $0.15
EqXTTLKUlDlz7yi6ziyyWA: checks 
*** FLOP *** [Ks 3d Jd]
E7KSkgfIsmIsp0vLnmGFmA: checks 
EqXTTLKUlDlz7yi6ziyyWA: bets $0.75
E7KSkgfIsmIsp0vLnmGFmA: folds 
Uncalled bet ($0.75) returned to EqXTTLKUlDlz7yi6ziyyWA
EqXTTLKUlDlz7yi6ziyyWA collected $0.50 from pot
*** SUMMARY ***
Total pot $0.50 | Rake $0 
Board [Ks 3d Jd]
Seat 1: eHsmIvAb2JREg4O6hNPnXg folded before Flop (didn't bet)
Seat 2: 3zD3qLXT1bEffAoWGnc7wg (button) folded before Flop (didn't bet)
Seat 3: E7KSkgfIsmIsp0vLnmGFmA (small blind) folded on the Flop
Seat 4: EqXTTLKUlDlz7yi6ziyyWA (big blind) collected ($0.50)
Seat 5: /xN6gc9+8Hew0HxaB6VIVg folded before Flop (didn't bet)
Seat 6: y7HCJfEmolBCFdi/0j5TRg folded before Flop (didn't bet)




PokerStars Game #59939466276:  Hold'em No Limit ($0.10/$0.25) - 2009/07/01 0:40:36 ET
Table 'FBhJjLqab11/gKu8nyB/tw' 9-max Seat #4 is the button
Seat 1: +sbyWwIcFp9kP0bDtMegfQ ($21.80 in chips) 
Seat 2: 1pwQJV/Xr0GWPRefx/78VQ ($2.05 in chips) 
Seat 3: uy9x0X5l7O+IpGjLa77QgQ ($26.90 in chips) 
Seat 4: OTC1Bh+DhK778Qnsj6D8+A ($24.50 in chips) 
Seat 5: vZGoOTJLQLhkPj4I+LNGig ($45.50 in chips) 
Seat 6: QrNgXJWFdS+POsPJcil4aA ($19.85 in chips) 
Seat 7: 5Fj9JGGxQT7Djr6AyIiBVA ($24.90 in chips) 
Seat 8: 9lE3Zc4pjmKpQK8rDF1aaQ ($20.20 in chips) 
Seat 9: BEIBUu2pIflPrCL+Iks4CQ ($12.15 in chips) 
vZGoOTJLQLhkPj4I+LNGig: posts small blind $0.10
QrNgXJWFdS+POsPJcil4aA: posts big blind $0.25
*** HOLE CARDS ***
5Fj9JGGxQT7Djr6AyIiBVA: raises $0.50 to $0.75
9lE3Zc4pjmKpQK8rDF1aaQ: folds 
BEIBUu2pIflPrCL+Iks4CQ: folds 
+sbyWwIcFp9kP0bDtMegfQ: folds 
1pwQJV/Xr0GWPRefx/78VQ: folds 
uy9x0X5l7O+IpGjLa77QgQ: folds 
OTC1Bh+DhK778Qnsj6D8+A: folds 
vZGoOTJLQLhkPj4I+LNGig: folds 
QrNgXJWFdS+POsPJcil4aA: folds 
Uncalled bet ($0.50) returned to 5Fj9JGGxQT7Djr6AyIiBVA
5Fj9JGGxQT7Djr6AyIiBVA collected $0.60 from pot
5Fj9JGGxQT7Djr6AyIiBVA: doesn't show hand 
*** SUMMARY ***
Total pot $0.60 | Rake $0 
Seat 1: +sbyWwIcFp9kP0bDtMegfQ folded before Flop (didn't bet)
Seat 2: 1pwQJV/Xr0GWPRefx/78VQ folded before Flop (didn't bet)
Seat 3: uy9x0X5l7O+IpGjLa77QgQ folded before Flop (didn't bet)
Seat 4: OTC1Bh+DhK778Qnsj6D8+A (button) folded before Flop (didn't bet)
Seat 5: vZGoOTJLQLhkPj4I+LNGig (small blind) folded before Flop
Seat 6: QrNgXJWFdS+POsPJcil4aA (big blind) folded before Flop
Seat 7: 5Fj9JGGxQT7Djr6AyIiBVA collected ($0.60)
Seat 8: 9lE3Zc4pjmKpQK8rDF1aaQ folded before Flop (didn't bet)
Seat 9: BEIBUu2pIflPrCL+Iks4CQ folded before Flop (didn't bet)




PokerStars Game #59939467216:  Hold'em No Limit ($0.10/$0.25) - 2009/07/01 0:40:37 ET
Table 'ouLhepGYovxB2x0QxH7cVg' 9-max Seat #9 is the button
Seat 1: ghNKXUBl/H+t83JF079ZBA ($30.45 in chips) 
Seat 2: r1Z5m4PwSI5ANp7qCE1OJw ($14.35 in chips) 
Seat 3: SkLOm0UugROBRt2EfMpOxQ ($24.25 in chips) 
Seat 4: a0Sx6GHY7ln2Ns2C97eXeA ($26.90 in chips) 
Seat 5: 18G4P1XstjNvItdGUITxgw ($25 in chips) 
Seat 6: r6hsffOo1iKmaPYKwAZmFw ($25.30 in chips) 
Seat 7: oHv2mIZJh3H0JR+WOZteZA ($20.65 in chips) 
Seat 8: opOCI2p6kW0tINuVaAqmcQ ($25 in chips) 
Seat 9: fIgGw0jPUR7labvJPaPbeg ($14.05 in chips) 
ghNKXUBl/H+t83JF079ZBA: posts small blind $0.10
r1Z5m4PwSI5ANp7qCE1OJw: posts big blind $0.25
*** HOLE CARDS ***
SkLOm0UugROBRt2EfMpOxQ: folds 
a0Sx6GHY7ln2Ns2C97eXeA: calls $0.25
18G4P1XstjNvItdGUITxgw: folds 
r6hsffOo1iKmaPYKwAZmFw: folds 
oHv2mIZJh3H0JR+WOZteZA: calls $0.25
opOCI2p6kW0tINuVaAqmcQ: folds 
fIgGw0jPUR7labvJPaPbeg: calls $0.25
ghNKXUBl/H+t83JF079ZBA: folds 
r1Z5m4PwSI5ANp7qCE1OJw: checks 
*** FLOP *** [Ks 8h 7d]
r1Z5m4PwSI5ANp7qCE1OJw: checks 
a0Sx6GHY7ln2Ns2C97eXeA: checks 
oHv2mIZJh3H0JR+WOZteZA: bets $0.25
fIgGw0jPUR7labvJPaPbeg: raises $0.50 to $0.75
r1Z5m4PwSI5ANp7qCE1OJw: folds 
a0Sx6GHY7ln2Ns2C97eXeA: calls $0.75
oHv2mIZJh3H0JR+WOZteZA: calls $0.50
*** TURN *** [Ks 8h 7d] [5s]
a0Sx6GHY7ln2Ns2C97eXeA: checks 
oHv2mIZJh3H0JR+WOZteZA: bets $1.25
fIgGw0jPUR7labvJPaPbeg: calls $1.25
a0Sx6GHY7ln2Ns2C97eXeA: calls $1.25
*** RIVER *** [Ks 8h 7d 5s] [6c]
a0Sx6GHY7ln2Ns2C97eXeA: checks 
oHv2mIZJh3H0JR+WOZteZA: bets $1
fIgGw0jPUR7labvJPaPbeg: calls $1
a0Sx6GHY7ln2Ns2C97eXeA: calls $1
*** SHOW DOWN ***
oHv2mIZJh3H0JR+WOZteZA: shows [Qh Kc] (a pair of Kings)
fIgGw0jPUR7labvJPaPbeg: shows [Jh Kd] (a pair of Kings - lower kicker)
a0Sx6GHY7ln2Ns2C97eXeA: shows [Kh Qd] (a pair of Kings)
a0Sx6GHY7ln2Ns2C97eXeA collected $4.85 from pot
oHv2mIZJh3H0JR+WOZteZA collected $4.80 from pot
*** SUMMARY ***
Total pot $10.10 | Rake $0.45 
Board [Ks 8h 7d 5s 6c]
Seat 1: ghNKXUBl/H+t83JF079ZBA (small blind) folded before Flop
Seat 2: r1Z5m4PwSI5ANp7qCE1OJw (big blind) folded on the Flop
Seat 3: SkLOm0UugROBRt2EfMpOxQ folded before Flop (didn't bet)
Seat 4: a0Sx6GHY7ln2Ns2C97eXeA showed [Kh Qd] and won ($4.85) with a pair of Kings
Seat 5: 18G4P1XstjNvItdGUITxgw folded before Flop (didn't bet)
Seat 6: r6hsffOo1iKmaPYKwAZmFw folded before Flop (didn't bet)
Seat 7: oHv2mIZJh3H0JR+WOZteZA showed [Qh Kc] and won ($4.80) with a pair of Kings
Seat 8: opOCI2p6kW0tINuVaAqmcQ folded before Flop (didn't bet)
Seat 9: fIgGw0jPUR7labvJPaPbeg (button) showed [Jh Kd] and lost with a pair of Kings




PokerStars Game #59939467288:  Hold'em No Limit ($0.10/$0.25) - 2009/07/01 0:40:37 ET
Table 'ONP9SkU1SytzTLuNlKzIPw' 9-max Seat #2 is the button
Seat 1: s7Q6uNouhe7aE8JdFb9E+A ($34.70 in chips) 
Seat 2: sJNHTWcSlLHRCZ9+YRLLqA ($25.50 in chips) 
Seat 3: 4BZw8NrbfRfUJKKKd1c2vA ($9.50 in chips) 
Seat 4: rKgOH+UzKBirOiqIwBD9Nw ($6.65 in chips) 
Seat 5: lSeLm4BdnSMLtIli62qjAQ ($4.50 in chips) 
Seat 6: 6X6eofOkuCCdkJdReOpjUQ ($25.10 in chips) 
Seat 7: DiSvPC2iudwL5j9u6Huyww ($26.20 in chips) 
Seat 8: sUVgUtgbfVx6JpvApozwhQ ($5 in chips) 
4BZw8NrbfRfUJKKKd1c2vA: posts small blind $0.10
rKgOH+UzKBirOiqIwBD9Nw: posts big blind $0.25
yyG4svzOpC1A+sUP/scg6w: sits out 
*** HOLE CARDS ***
lSeLm4BdnSMLtIli62qjAQ: folds 
6X6eofOkuCCdkJdReOpjUQ: folds 
DiSvPC2iudwL5j9u6Huyww: folds 
sUVgUtgbfVx6JpvApozwhQ: folds 
s7Q6uNouhe7aE8JdFb9E+A: raises $0.50 to $0.75
sJNHTWcSlLHRCZ9+YRLLqA: folds 
4BZw8NrbfRfUJKKKd1c2vA: folds 
rKgOH+UzKBirOiqIwBD9Nw: calls $0.50
*** FLOP *** [4s 9d 9c]
rKgOH+UzKBirOiqIwBD9Nw: bets $0.25
s7Q6uNouhe7aE8JdFb9E+A: folds 
Uncalled bet ($0.25) returned to rKgOH+UzKBirOiqIwBD9Nw
rKgOH+UzKBirOiqIwBD9Nw collected $1.55 from pot
rKgOH+UzKBirOiqIwBD9Nw: doesn't show hand 
*** SUMMARY ***
Total pot $1.60 | Rake $0.05 
Board [4s 9d 9c]
Seat 1: s7Q6uNouhe7aE8JdFb9E+A folded on the Flop
Seat 2: sJNHTWcSlLHRCZ9+YRLLqA (button) folded before Flop (didn't bet)
Seat 3: 4BZw8NrbfRfUJKKKd1c2vA (small blind) folded before Flop
Seat 4: rKgOH+UzKBirOiqIwBD9Nw (big blind) collected ($1.55)
Seat 5: lSeLm4BdnSMLtIli62qjAQ folded before Flop (didn't bet)
Seat 6: 6X6eofOkuCCdkJdReOpjUQ folded before Flop (didn't bet)
Seat 7: DiSvPC2iudwL5j9u6Huyww folded before Flop (didn't bet)
Seat 8: sUVgUtgbfVx6JpvApozwhQ folded before Flop (didn't bet)




PokerStars Game #59939466878:  Hold'em No Limit ($0.10/$0.25) - 2009/07/01 0:40:37 ET
Table 'z2yOdY2zyGWG1gh9WV9XtQ' 9-max Seat #1 is the button
Seat 1: k/tPF1MnFJtmPS14iqcejw ($29.35 in chips) 
Seat 2: s7Q6uNouhe7aE8JdFb9E+A ($25 in chips) 
Seat 3: 7AzEFY3y7BINbVpICeVrHA ($7.15 in chips) 
Seat 4: BMTbQu92kfh1+tEQba3Flw ($17.55 in chips) 
Seat 5: DYB0aP91n+Rg/TIhycbaPQ ($13.65 in chips) 
Seat 6: vZGoOTJLQLhkPj4I+LNGig ($28.60 in chips) 
Seat 7: zDrucyjVn5aeekNEc3cJrA ($26.45 in chips) 
Seat 8: hIss79a4pu7GzJZepfgOpg ($25 in chips) 
s7Q6uNouhe7aE8JdFb9E+A: posts small blind $0.10
7AzEFY3y7BINbVpICeVrHA: posts big blind $0.25
*** HOLE CARDS ***
BMTbQu92kfh1+tEQba3Flw: calls $0.25
DYB0aP91n+Rg/TIhycbaPQ: calls $0.25
vZGoOTJLQLhkPj4I+LNGig: folds 
zDrucyjVn5aeekNEc3cJrA: folds 
hIss79a4pu7GzJZepfgOpg: folds 
k/tPF1MnFJtmPS14iqcejw: folds 
s7Q6uNouhe7aE8JdFb9E+A: folds 
7AzEFY3y7BINbVpICeVrHA: checks 
*** FLOP *** [9s As Kh]
7AzEFY3y7BINbVpICeVrHA: checks 
BMTbQu92kfh1+tEQba3Flw: checks 
DYB0aP91n+Rg/TIhycbaPQ: checks 
*** TURN *** [9s As Kh] [6s]
7AzEFY3y7BINbVpICeVrHA: bets $1
BMTbQu92kfh1+tEQba3Flw: folds 
DYB0aP91n+Rg/TIhycbaPQ: folds 
Uncalled bet ($1) returned to 7AzEFY3y7BINbVpICeVrHA
7AzEFY3y7BINbVpICeVrHA collected $0.85 from pot
7AzEFY3y7BINbVpICeVrHA: doesn't show hand 
*** SUMMARY ***
Total pot $0.85 | Rake $0 
Board [9s As Kh 6s]
Seat 1: k/tPF1MnFJtmPS14iqcejw (button) folded before Flop (didn't bet)
Seat 2: s7Q6uNouhe7aE8JdFb9E+A (small blind) folded before Flop
Seat 3: 7AzEFY3y7BINbVpICeVrHA (big blind) collected ($0.85)
Seat 4: BMTbQu92kfh1+tEQba3Flw folded on the Turn
Seat 5: DYB0aP91n+Rg/TIhycbaPQ folded on the Turn
Seat 6: vZGoOTJLQLhkPj4I+LNGig folded before Flop (didn't bet)
Seat 7: zDrucyjVn5aeekNEc3cJrA folded before Flop (didn't bet)
Seat 8: hIss79a4pu7GzJZepfgOpg folded before Flop (didn't bet)




PokerStars Game #59939467052:  Hold'em No Limit ($0.10/$0.25) - 2009/07/01 0:40:37 ET
Table 'NtEQAxCeIK2io1CGtW658g' 6-max Seat #3 is the button
Seat 1: lnOV7k25gyN7L5t5YKTgIg ($20.85 in chips) 
Seat 2: nc79pm0LZRdhncq55evVqA ($25.55 in chips) 
Seat 3: m2yWOKfAxqHoy5DDN87Ttw ($24.65 in chips) 
Seat 4: 8296 ($11.75 in chips) 
Seat 5: FStoHe64SQWqAsjya9pDkQ ($28.20 in chips) 
Seat 6: /gJNBeCkWL4o85/jvlZ4BA ($62.35 in chips) 
8296: posts small blind $0.10
FStoHe64SQWqAsjya9pDkQ: posts big blind $0.25
*** HOLE CARDS ***
/gJNBeCkWL4o85/jvlZ4BA: folds 
lnOV7k25gyN7L5t5YKTgIg: folds 
nc79pm0LZRdhncq55evVqA: folds 
m2yWOKfAxqHoy5DDN87Ttw: folds 
8296: folds 
Uncalled bet ($0.15) returned to FStoHe64SQWqAsjya9pDkQ
FStoHe64SQWqAsjya9pDkQ collected $0.20 from pot
FStoHe64SQWqAsjya9pDkQ: doesn't show hand 
*** SUMMARY ***
Total pot $0.20 | Rake $0 
Seat 1: lnOV7k25gyN7L5t5YKTgIg folded before Flop (didn't bet)
Seat 2: nc79pm0LZRdhncq55evVqA folded before Flop (didn't bet)
Seat 3: m2yWOKfAxqHoy5DDN87Ttw (button) folded before Flop (didn't bet)
Seat 4: 8296 (small blind) folded before Flop
Seat 5: FStoHe64SQWqAsjya9pDkQ (big blind) collected ($0.20)
Seat 6: /gJNBeCkWL4o85/jvlZ4BA folded before Flop (didn't bet)




PokerStars Game #59939466782:  Hold'em No Limit ($0.10/$0.25) - 2009/07/01 0:40:37 ET
Table 'isKy4XK8wJM0x735/D4hWA' 6-max Seat #2 is the button
Seat 1: 7FmwVDcdEtxDpHmP4hOXsQ ($25.20 in chips) 
Seat 2: WrLI51S2iMb8GLMB83gGqA ($25.65 in chips) 
Seat 4: k9vn40MOqqb+xF+7GZ6v2g ($24.75 in chips) 
Seat 5: zlYHXTtJ5tcx9kwK2h5n9A ($37.40 in chips) 
Seat 6: M6xK/VklCvdyyrmvzATlxQ ($14.10 in chips) 
jp34e617tIzV8tKIWmfAbA will be allowed to play after the button
k9vn40MOqqb+xF+7GZ6v2g: posts small blind $0.10
zlYHXTtJ5tcx9kwK2h5n9A: posts big blind $0.25
*** HOLE CARDS ***
M6xK/VklCvdyyrmvzATlxQ: folds 
7FmwVDcdEtxDpHmP4hOXsQ: raises $0.50 to $0.75
WrLI51S2iMb8GLMB83gGqA: raises $2.50 to $3.25
k9vn40MOqqb+xF+7GZ6v2g: folds 
zlYHXTtJ5tcx9kwK2h5n9A: folds 
7FmwVDcdEtxDpHmP4hOXsQ: folds 
Uncalled bet ($2.50) returned to WrLI51S2iMb8GLMB83gGqA
WrLI51S2iMb8GLMB83gGqA collected $1.85 from pot
WrLI51S2iMb8GLMB83gGqA: doesn't show hand 
*** SUMMARY ***
Total pot $1.85 | Rake $0 
Seat 1: 7FmwVDcdEtxDpHmP4hOXsQ folded before Flop
Seat 2: WrLI51S2iMb8GLMB83gGqA (button) collected ($1.85)
Seat 4: k9vn40MOqqb+xF+7GZ6v2g (small blind) folded before Flop
Seat 5: zlYHXTtJ5tcx9kwK2h5n9A (big blind) folded before Flop
Seat 6: M6xK/VklCvdyyrmvzATlxQ folded before Flop (didn't bet)




PokerStars Game #59939467258:  Hold'em No Limit ($0.10/$0.25) - 2009/07/01 0:40:37 ET
Table 'Yb2CyZosw7N3yRRVLhKnKg' 9-max Seat #6 is the button
Seat 1: lcT2xQLmuzNRe6+aWd6eww ($32.15 in chips) 
Seat 2: dmYlc+1cjwZMJ7wV+Z0rRg ($25.90 in chips) 
Seat 4: H5Se03ZqSX7tbULXur2MAg ($29 in chips) 
Seat 5: QUCO+kde5iROhmqVTzQ6KQ ($37.25 in chips) 
Seat 6: opOCI2p6kW0tINuVaAqmcQ ($25.55 in chips) 
Seat 7: OiV1PWZ3IkN29JlmCcnTwQ ($5 in chips) 
Seat 8: aJy680tKSaP5er559aSuGA ($22.50 in chips) 
OiV1PWZ3IkN29JlmCcnTwQ: posts small blind $0.10
aJy680tKSaP5er559aSuGA: posts big blind $0.25
*** HOLE CARDS ***
aCVg6cCxQcqClhB9nq/p1w leaves the table
lcT2xQLmuzNRe6+aWd6eww: calls $0.25
dmYlc+1cjwZMJ7wV+Z0rRg: folds 
H5Se03ZqSX7tbULXur2MAg: folds 
QUCO+kde5iROhmqVTzQ6KQ: folds 
opOCI2p6kW0tINuVaAqmcQ: folds 
OiV1PWZ3IkN29JlmCcnTwQ: folds 
aJy680tKSaP5er559aSuGA: checks 
*** FLOP *** [4d 9h Ad]
aJy680tKSaP5er559aSuGA: checks 
lcT2xQLmuzNRe6+aWd6eww: bets $0.75
aJy680tKSaP5er559aSuGA: folds 
Uncalled bet ($0.75) returned to lcT2xQLmuzNRe6+aWd6eww
lcT2xQLmuzNRe6+aWd6eww collected $0.60 from pot
*** SUMMARY ***
Total pot $0.60 | Rake $0 
Board [4d 9h Ad]
Seat 1: lcT2xQLmuzNRe6+aWd6eww collected ($0.60)
Seat 2: dmYlc+1cjwZMJ7wV+Z0rRg folded before Flop (didn't bet)
Seat 4: H5Se03ZqSX7tbULXur2MAg folded before Flop (didn't bet)
Seat 5: QUCO+kde5iROhmqVTzQ6KQ folded before Flop (didn't bet)
Seat 6: opOCI2p6kW0tINuVaAqmcQ (button) folded before Flop (didn't bet)
Seat 7: OiV1PWZ3IkN29JlmCcnTwQ (small blind) folded before Flop
Seat 8: aJy680tKSaP5er559aSuGA (big blind) folded on the Flop




PokerStars Game #59939467598:  Hold'em No Limit ($0.10/$0.25) - 2009/07/01 0:40:38 ET
Table 'C8mMnVmvkagwolEzTvh07A' 9-max Seat #8 is the button
Seat 1: t2nb95S5EEFOEzNx9Itz0g ($5.35 in chips) 
Seat 2: CbXUS6Z2rXZxL1AKduNtmQ ($30.10 in chips) 
Seat 3: Th3FldXKQW6hWVVPahaoOQ ($25.35 in chips) 
Seat 4: dfNim92Z6XK1/h5SFW5vDg ($25 in chips) 
Seat 5: iGMlK+EhUflPB6jKQd95Cg ($25 in chips) 
Seat 8: N6fYvIzQLKaydFLKQGtMlQ ($22.55 in chips) 
Seat 9: 4awUyiDYTgylQKXZ9faBVA ($26.35 in chips) 
4awUyiDYTgylQKXZ9faBVA: posts small blind $0.10
t2nb95S5EEFOEzNx9Itz0g: posts big blind $0.25
V6p0jQ/RhUsqpHLmXvEX4Q has timed out
V6p0jQ/RhUsqpHLmXvEX4Q: is sitting out 
*** HOLE CARDS ***
CbXUS6Z2rXZxL1AKduNtmQ: folds 
Th3FldXKQW6hWVVPahaoOQ: folds 
dfNim92Z6XK1/h5SFW5vDg: folds 
iGMlK+EhUflPB6jKQd95Cg: folds 
N6fYvIzQLKaydFLKQGtMlQ: folds 
4awUyiDYTgylQKXZ9faBVA: raises $0.50 to $0.75
t2nb95S5EEFOEzNx9Itz0g: folds 
Uncalled bet ($0.50) returned to 4awUyiDYTgylQKXZ9faBVA
4awUyiDYTgylQKXZ9faBVA collected $0.50 from pot
4awUyiDYTgylQKXZ9faBVA: doesn't show hand 
*** SUMMARY ***
Total pot $0.50 | Rake $0 
Seat 1: t2nb95S5EEFOEzNx9Itz0g (big blind) folded before Flop
Seat 2: CbXUS6Z2rXZxL1AKduNtmQ folded before Flop (didn't bet)
Seat 3: Th3FldXKQW6hWVVPahaoOQ folded before Flop (didn't bet)
Seat 4: dfNim92Z6XK1/h5SFW5vDg folded before Flop (didn't bet)
Seat 5: iGMlK+EhUflPB6jKQd95Cg folded before Flop (didn't bet)
Seat 8: N6fYvIzQLKaydFLKQGtMlQ (button) folded before Flop (didn't bet)
Seat 9: 4awUyiDYTgylQKXZ9faBVA (small blind) collected ($0.50)




PokerStars Game #59939467838:  Hold'em No Limit ($0.10/$0.25) - 2009/07/01 0:40:38 ET
Table 'R5f24ws6hGXlbvjq9ej+1Q' 9-max Seat #4 is the button
Seat 1: TeWJxSETzbXGiYKx0y+dtg ($26.30 in chips) 
Seat 2: 8lk6dG3H7iS/67/biw/vcQ ($26.55 in chips) 
Seat 4: jM9ExRdqCqq2e6TjpOBoRw ($17.65 in chips) 
Seat 5: YMlMWbkusacDBjx3A8lphw ($6.25 in chips) 
Seat 7: Z5ZtGOON8kmSdSCll9Z3XA ($8.35 in chips) 
Seat 8: qwr38jl5txoR36M7G5qi4A ($7.60 in chips) 
Seat 9: 33y9+GmQ3J84RvZXcraRTw ($27.40 in chips) 
YMlMWbkusacDBjx3A8lphw: posts small blind $0.10
hPhp/RE3cJ5YGaQ2xOHXXg: is sitting out 
Z5ZtGOON8kmSdSCll9Z3XA: posts big blind $0.25
*** HOLE CARDS ***
qwr38jl5txoR36M7G5qi4A: raises $0.50 to $0.75
33y9+GmQ3J84RvZXcraRTw: folds 
hPhp/RE3cJ5YGaQ2xOHXXg leaves the table
TeWJxSETzbXGiYKx0y+dtg: folds 
8lk6dG3H7iS/67/biw/vcQ: folds 
jM9ExRdqCqq2e6TjpOBoRw: calls $0.75
YMlMWbkusacDBjx3A8lphw: folds 
Z5ZtGOON8kmSdSCll9Z3XA: folds 
*** FLOP *** [Qc 6s Qd]
qwr38jl5txoR36M7G5qi4A: bets $0.75
jM9ExRdqCqq2e6TjpOBoRw: folds 
Uncalled bet ($0.75) returned to qwr38jl5txoR36M7G5qi4A
qwr38jl5txoR36M7G5qi4A collected $1.80 from pot
qwr38jl5txoR36M7G5qi4A: doesn't show hand 
*** SUMMARY ***
Total pot $1.85 | Rake $0.05 
Board [Qc 6s Qd]
Seat 1: TeWJxSETzbXGiYKx0y+dtg folded before Flop (didn't bet)
Seat 2: 8lk6dG3H7iS/67/biw/vcQ folded before Flop (didn't bet)
Seat 4: jM9ExRdqCqq2e6TjpOBoRw (button) folded on the Flop
Seat 5: YMlMWbkusacDBjx3A8lphw (small blind) folded before Flop
Seat 7: Z5ZtGOON8kmSdSCll9Z3XA (big blind) folded before Flop
Seat 8: qwr38jl5txoR36M7G5qi4A collected ($1.80)
Seat 9: 33y9+GmQ3J84RvZXcraRTw folded before Flop (didn't bet)




PokerStars Game #59939467806:  Hold'em No Limit ($0.10/$0.25) - 2009/07/01 0:40:38 ET
Table 'FuFyQHmlO/QqQp//rDRrPg' 6-max Seat #3 is the button
Seat 1: 4re+a1K56DcbV7DyVX/FMw ($15.45 in chips) 
Seat 2: 0DvgWV5o6c/jYqQCjm4Haw ($25 in chips) 
Seat 3: uoOTv6ecGYEhLPY44ZTW+A ($11.20 in chips) 
Seat 4: Eznneya0vB6S+eXJdVleHA ($8.65 in chips) 
Seat 5: wAKC8C/zN0c8V5v13dm9mA ($26.50 in chips) 
Eznneya0vB6S+eXJdVleHA: posts small blind $0.10
wAKC8C/zN0c8V5v13dm9mA: posts big blind $0.25
6DwBRH+xZ12AAZmeAg+aXw: sits out 
*** HOLE CARDS ***
4re+a1K56DcbV7DyVX/FMw: calls $0.25
0DvgWV5o6c/jYqQCjm4Haw: raises $0.95 to $1.20
uoOTv6ecGYEhLPY44ZTW+A: folds 
Eznneya0vB6S+eXJdVleHA: folds 
wAKC8C/zN0c8V5v13dm9mA: folds 
4re+a1K56DcbV7DyVX/FMw: folds 
Uncalled bet ($0.95) returned to 0DvgWV5o6c/jYqQCjm4Haw
0DvgWV5o6c/jYqQCjm4Haw collected $0.85 from pot
0DvgWV5o6c/jYqQCjm4Haw: doesn't show hand 
*** SUMMARY ***
Total pot $0.85 | Rake $0 
Seat 1: 4re+a1K56DcbV7DyVX/FMw folded before Flop
Seat 2: 0DvgWV5o6c/jYqQCjm4Haw collected ($0.85)
Seat 3: uoOTv6ecGYEhLPY44ZTW+A (button) folded before Flop (didn't bet)
Seat 4: Eznneya0vB6S+eXJdVleHA (small blind) folded before Flop
Seat 5: wAKC8C/zN0c8V5v13dm9mA (big blind) folded before Flop




PokerStars Game #59939467584:  Hold'em No Limit ($0.10/$0.25) - 2009/07/01 0:40:38 ET
Table 'B3/JTS7usG3rxMfTbMiZuw' 6-max Seat #4 is the button
Seat 1: wAKC8C/zN0c8V5v13dm9mA ($29.90 in chips) 
Seat 2: 2gqWqkOq59pvtJKe4nS+rw ($22.90 in chips) 
Seat 3: PbMzPZIePKifKQZfKDkbIw ($25 in chips) 
Seat 4: kPCKvyB1yAABEgvF7OaG0g ($25.40 in chips) 
Seat 5: NhUN/JpAprdJeamFBgJH1w ($27 in chips) 
NhUN/JpAprdJeamFBgJH1w: posts small blind $0.10
wAKC8C/zN0c8V5v13dm9mA: posts big blind $0.25
*** HOLE CARDS ***
2gqWqkOq59pvtJKe4nS+rw: folds 
PbMzPZIePKifKQZfKDkbIw: folds 
6DwBRH+xZ12AAZmeAg+aXw joins the table at seat #6 
kPCKvyB1yAABEgvF7OaG0g: calls $0.25
NhUN/JpAprdJeamFBgJH1w: folds 
wAKC8C/zN0c8V5v13dm9mA: checks 
*** FLOP *** [3d 3h Ks]
wAKC8C/zN0c8V5v13dm9mA: checks 
kPCKvyB1yAABEgvF7OaG0g: checks 
*** TURN *** [3d 3h Ks] [Ts]
wAKC8C/zN0c8V5v13dm9mA is disconnected 
wAKC8C/zN0c8V5v13dm9mA is connected 
wAKC8C/zN0c8V5v13dm9mA: checks 
kPCKvyB1yAABEgvF7OaG0g: checks 
*** RIVER *** [3d 3h Ks Ts] [5s]
wAKC8C/zN0c8V5v13dm9mA: bets $0.50
kPCKvyB1yAABEgvF7OaG0g: folds 
Uncalled bet ($0.50) returned to wAKC8C/zN0c8V5v13dm9mA
wAKC8C/zN0c8V5v13dm9mA collected $0.60 from pot
*** SUMMARY ***
Total pot $0.60 | Rake $0 
Board [3d 3h Ks Ts 5s]
Seat 1: wAKC8C/zN0c8V5v13dm9mA (big blind) collected ($0.60)
Seat 2: 2gqWqkOq59pvtJKe4nS+rw folded before Flop (didn't bet)
Seat 3: PbMzPZIePKifKQZfKDkbIw folded before Flop (didn't bet)
Seat 4: kPCKvyB1yAABEgvF7OaG0g (button) folded on the River
Seat 5: NhUN/JpAprdJeamFBgJH1w (small blind) folded before Flop




PokerStars Game #59939467840:  Hold'em No Limit ($0.10/$0.25) - 2009/07/01 0:40:38 ET
Table 'zhqgUUprOJ14VxKxPHcT/Q' 9-max Seat #4 is the button
Seat 3: G2offPrpnppc++nuXqs2JA ($16.90 in chips) 
Seat 4: EfeOSXE8Wc4WWEsgc3WzZg ($8.20 in chips) 
Seat 5: +sbyWwIcFp9kP0bDtMegfQ ($26.85 in chips) 
Seat 6: DIBbjEYGs+TVdVgEB/4+3w ($23.10 in chips) 
Seat 8: amD2PwT1xB7aC2k57sa7Ig ($29.20 in chips) 
Seat 9: 4awUyiDYTgylQKXZ9faBVA ($36.10 in chips) 
+sbyWwIcFp9kP0bDtMegfQ: posts small blind $0.10
DIBbjEYGs+TVdVgEB/4+3w: posts big blind $0.25
*** HOLE CARDS ***
amD2PwT1xB7aC2k57sa7Ig: folds 
4awUyiDYTgylQKXZ9faBVA: folds 
G2offPrpnppc++nuXqs2JA: raises $0.50 to $0.75
Ebzw1YytWRd/vXFjA8XReg joins the table at seat #7 
GY095KWhBevJ1Ttvl8WseA joins the table at seat #2 
EfeOSXE8Wc4WWEsgc3WzZg: folds 
+sbyWwIcFp9kP0bDtMegfQ: folds 
DIBbjEYGs+TVdVgEB/4+3w: folds 
Uncalled bet ($0.50) returned to G2offPrpnppc++nuXqs2JA
G2offPrpnppc++nuXqs2JA collected $0.60 from pot
*** SUMMARY ***
Total pot $0.60 | Rake $0 
Seat 3: G2offPrpnppc++nuXqs2JA collected ($0.60)
Seat 4: EfeOSXE8Wc4WWEsgc3WzZg (button) folded before Flop (didn't bet)
Seat 5: +sbyWwIcFp9kP0bDtMegfQ (small blind) folded before Flop
Seat 6: DIBbjEYGs+TVdVgEB/4+3w (big blind) folded before Flop
Seat 8: amD2PwT1xB7aC2k57sa7Ig folded before Flop (didn't bet)
Seat 9: 4awUyiDYTgylQKXZ9faBVA folded before Flop (didn't bet)




PokerStars Game #59939467474:  Hold'em No Limit ($0.10/$0.25) - 2009/07/01 0:40:38 ET
Table '6ae4XiTo6B597KfSSMr8Cg' 9-max Seat #5 is the button
Seat 1: 49YfVBEOwzD3/FVw+dTTBQ ($5.65 in chips) 
Seat 2: 5s3p6yoJBNW438dsyKTP8g ($45.75 in chips) 
Seat 3: yyG4svzOpC1A+sUP/scg6w ($8.05 in chips) 
Seat 4: dfNim92Z6XK1/h5SFW5vDg ($48.75 in chips) 
Seat 5: 1K6QGyJP9P9xmRac2fH4OQ ($25 in chips) 
Seat 6: DlXs37dlX3tb7o/7lYXQSw ($24.75 in chips) 
Seat 7: 18G4P1XstjNvItdGUITxgw ($25.60 in chips) 
Seat 9: E0iYnEVO2ho7dH3QcCjw7g ($34.70 in chips) 
DlXs37dlX3tb7o/7lYXQSw: posts small blind $0.10
18G4P1XstjNvItdGUITxgw: posts big blind $0.25
F7pnn6czNpHvRM55XcA2EA: sits out 
*** HOLE CARDS ***
E0iYnEVO2ho7dH3QcCjw7g: folds 
49YfVBEOwzD3/FVw+dTTBQ: raises $0.50 to $0.75
5s3p6yoJBNW438dsyKTP8g: folds 
yyG4svzOpC1A+sUP/scg6w: folds 
dfNim92Z6XK1/h5SFW5vDg: folds 
1K6QGyJP9P9xmRac2fH4OQ: folds 
DlXs37dlX3tb7o/7lYXQSw: folds 
18G4P1XstjNvItdGUITxgw: folds 
Uncalled bet ($0.50) returned to 49YfVBEOwzD3/FVw+dTTBQ
49YfVBEOwzD3/FVw+dTTBQ collected $0.60 from pot
49YfVBEOwzD3/FVw+dTTBQ: doesn't show hand 
*** SUMMARY ***
Total pot $0.60 | Rake $0 
Seat 1: 49YfVBEOwzD3/FVw+dTTBQ collected ($0.60)
Seat 2: 5s3p6yoJBNW438dsyKTP8g folded before Flop (didn't bet)
Seat 3: yyG4svzOpC1A+sUP/scg6w folded before Flop (didn't bet)
Seat 4: dfNim92Z6XK1/h5SFW5vDg folded before Flop (didn't bet)
Seat 5: 1K6QGyJP9P9xmRac2fH4OQ (button) folded before Flop (didn't bet)
Seat 6: DlXs37dlX3tb7o/7lYXQSw (small blind) folded before Flop
Seat 7: 18G4P1XstjNvItdGUITxgw (big blind) folded before Flop
Seat 9: E0iYnEVO2ho7dH3QcCjw7g folded before Flop (didn't bet)




PokerStars Game #59939467684:  Hold'em No Limit ($0.10/$0.25) - 2009/07/01 0:40:38 ET
Table 'nXVbUw6/HYwA6x21+IZ3XQ' 9-max Seat #8 is the button
Seat 1: zDrucyjVn5aeekNEc3cJrA ($23.40 in chips) 
Seat 2: 1K6QGyJP9P9xmRac2fH4OQ ($29.80 in chips) 
Seat 3: Vhpns1oAZs77VUIptmuKDw ($40.80 in chips) 
Seat 4: GmQux9F6mgOHtI4C9bVTNQ ($5 in chips) 
Seat 5: M/9j4wkHH9i1JM51vgi1VA ($20.80 in chips) 
Seat 6: ljemhp25Zg+nlA9DLCIiUw ($23.60 in chips) 
Seat 7: IupaN0QS3TJoOSYaS7zF9w ($8.20 in chips) 
Seat 8: dfNim92Z6XK1/h5SFW5vDg ($25 in chips) 
Seat 9: rm0e8CshiGK8hjW46YcNqg ($30.15 in chips) 
rm0e8CshiGK8hjW46YcNqg: posts small blind $0.10
zDrucyjVn5aeekNEc3cJrA: posts big blind $0.25
*** HOLE CARDS ***
1K6QGyJP9P9xmRac2fH4OQ: calls $0.25
Vhpns1oAZs77VUIptmuKDw: calls $0.25
GmQux9F6mgOHtI4C9bVTNQ: folds 
M/9j4wkHH9i1JM51vgi1VA: folds 
Vhpns1oAZs77VUIptmuKDw said, "i should start drinking now"
ljemhp25Zg+nlA9DLCIiUw: folds 
IupaN0QS3TJoOSYaS7zF9w said, "But russia never lost a war to China"
IupaN0QS3TJoOSYaS7zF9w: raises $0.50 to $0.75
dfNim92Z6XK1/h5SFW5vDg: folds 
rm0e8CshiGK8hjW46YcNqg said, "So Walleye, have you moved to Canada or what?"
rm0e8CshiGK8hjW46YcNqg: calls $0.65
zDrucyjVn5aeekNEc3cJrA: folds 
rm0e8CshiGK8hjW46YcNqg said, "yes they did"
IupaN0QS3TJoOSYaS7zF9w said, "Wally u going to vegas?"
IupaN0QS3TJoOSYaS7zF9w said, "i dont care"
1K6QGyJP9P9xmRac2fH4OQ: calls $0.50
rm0e8CshiGK8hjW46YcNqg said, "the Boxer Rebellion was about Wladimir Klitshcko"
Vhpns1oAZs77VUIptmuKDw said, "well kinda mayo.  im paying rent on an apartment here"
rm0e8CshiGK8hjW46YcNqg said, "sounds official enough to me"
IupaN0QS3TJoOSYaS7zF9w said, "i know nuttin about china or russian history"
Vhpns1oAZs77VUIptmuKDw: calls $0.50
*** FLOP *** [Ts 5d Qs]
rm0e8CshiGK8hjW46YcNqg: checks 
IupaN0QS3TJoOSYaS7zF9w said, "and i dont care either"
1K6QGyJP9P9xmRac2fH4OQ: bets $2.20
rm0e8CshiGK8hjW46YcNqg said, "well they both have a space program"
Vhpns1oAZs77VUIptmuKDw said, "no vegas for me dang,   i have to go to a wedding here in a couple weeks and don't have a passport yet so i don't dare leave the country"
Vhpns1oAZs77VUIptmuKDw: folds 
Vhpns1oAZs77VUIptmuKDw said, "ya"
rm0e8CshiGK8hjW46YcNqg said, "Hey walleye, congreats on your upcoming wedding."
Vhpns1oAZs77VUIptmuKDw said, "lol, no"
IupaN0QS3TJoOSYaS7zF9w said, "how did u get in with no passport"
IupaN0QS3TJoOSYaS7zF9w: folds 
rm0e8CshiGK8hjW46YcNqg: calls $2.20
*** TURN *** [Ts 5d Qs] [2d]
rm0e8CshiGK8hjW46YcNqg: checks 
Vhpns1oAZs77VUIptmuKDw said, "i got here before the law change"
IupaN0QS3TJoOSYaS7zF9w said, "and Kristy already draging u to Weedings"
Vhpns1oAZs77VUIptmuKDw said, "i will take pics nham"
1K6QGyJP9P9xmRac2fH4OQ: checks 
*** RIVER *** [Ts 5d Qs 2d] [3d]
Vhpns1oAZs77VUIptmuKDw said, "forsure"
rm0e8CshiGK8hjW46YcNqg said, "i didnt get invited to the wedding and i even bought them a present.  :mad:"
rm0e8CshiGK8hjW46YcNqg: bets $1
1K6QGyJP9P9xmRac2fH4OQ: folds 
Uncalled bet ($1) returned to rm0e8CshiGK8hjW46YcNqg
Vhpns1oAZs77VUIptmuKDw said, "a hahahaha"
rm0e8CshiGK8hjW46YcNqg collected $7.30 from pot
rm0e8CshiGK8hjW46YcNqg said, "sick fold"
rm0e8CshiGK8hjW46YcNqg: doesn't show hand 
*** SUMMARY ***
Total pot $7.65 | Rake $0.35 
Board [Ts 5d Qs 2d 3d]
Seat 1: zDrucyjVn5aeekNEc3cJrA (big blind) folded before Flop
Seat 2: 1K6QGyJP9P9xmRac2fH4OQ folded on the River
Seat 3: Vhpns1oAZs77VUIptmuKDw folded on the Flop
Seat 4: GmQux9F6mgOHtI4C9bVTNQ folded before Flop (didn't bet)
Seat 5: M/9j4wkHH9i1JM51vgi1VA folded before Flop (didn't bet)
Seat 6: ljemhp25Zg+nlA9DLCIiUw folded before Flop (didn't bet)
Seat 7: IupaN0QS3TJoOSYaS7zF9w folded on the Flop
Seat 8: dfNim92Z6XK1/h5SFW5vDg (button) folded before Flop (didn't bet)
Seat 9: rm0e8CshiGK8hjW46YcNqg (small blind) collected ($7.30)




PokerStars Game #59939468200:  Hold'em No Limit ($0.10/$0.25) - 2009/07/01 0:40:39 ET
Table 'gkdjhbH1jaE3hwhPRIKMiQ3lL16FBjWXTx3AjK5lMRwwx Seat #2 is the button
Seat 1: fDGyaQz0cs2s4FOYxkbIHA ($7.80 in chips) 
Seat 2: YK2fIgjF+Z0ARwKKcGh1fw ($18.20 in chips) 
Seat 3: QEbIGci+itdw+re8RM5fZA ($26 in chips) 
Seat 5: M/9j4wkHH9i1JM51vgi1VA ($22.85 in chips) 
Seat 6: hBMUlEpyU74r/fwDgIpXjQ ($41.35 in chips) 
Seat 7: JxpnpCmvRAcrEUy7mq1iAg ($5.40 in chips) 
Seat 8: ljemhp25Zg+nlA9DLCIiUw ($23.30 in chips) 
Seat 9: b8t3jWrxzeEt9HtZtc9wUQ ($10.60 in chips) 
QEbIGci+itdw+re8RM5fZA: posts small blind $0.10
pocketcrape: is sitting out 
M/9j4wkHH9i1JM51vgi1VA: posts big blind $0.25
*** HOLE CARDS ***
pocketcrape leaves the table
hBMUlEpyU74r/fwDgIpXjQ: folds 
JxpnpCmvRAcrEUy7mq1iAg: folds 
ljemhp25Zg+nlA9DLCIiUw: folds 
b8t3jWrxzeEt9HtZtc9wUQ: calls $0.25
fDGyaQz0cs2s4FOYxkbIHA: raises $0.75 to $1
YK2fIgjF+Z0ARwKKcGh1fw: folds 
QEbIGci+itdw+re8RM5fZA: folds 
M/9j4wkHH9i1JM51vgi1VA: folds 
b8t3jWrxzeEt9HtZtc9wUQ: folds 
Uncalled bet ($0.75) returned to fDGyaQz0cs2s4FOYxkbIHA
fDGyaQz0cs2s4FOYxkbIHA collected $0.85 from pot
fDGyaQz0cs2s4FOYxkbIHA: doesn't show hand 
*** SUMMARY ***
Total pot $0.85 | Rake $0 
Seat 1: fDGyaQz0cs2s4FOYxkbIHA collected ($0.85)
Seat 2: YK2fIgjF+Z0ARwKKcGh1fw (button) folded before Flop (didn't bet)
Seat 3: QEbIGci+itdw+re8RM5fZA (small blind) folded before Flop
Seat 5: M/9j4wkHH9i1JM51vgi1VA (big blind) folded before Flop
Seat 6: hBMUlEpyU74r/fwDgIpXjQ folded before Flop (didn't bet)
Seat 7: JxpnpCmvRAcrEUy7mq1iAg folded before Flop (didn't bet)
Seat 8: ljemhp25Zg+nlA9DLCIiUw folded before Flop (didn't bet)
Seat 9: b8t3jWrxzeEt9HtZtc9wUQ folded before Flop




PokerStars Game #59939468168:  Hold'em No Limit ($0.10/$0.25) - 2009/07/01 0:40:39 ET
Table 'Do4nrTNDYpK3sQjwFxX+Og' 6-max Seat #4 is the button
Seat 1: 7JrQNOR9wRBxq9ijFhWieg ($25.70 in chips) 
Seat 2: tzMoGl9F0PUr5NibYueeSw ($44.15 in chips) 
Seat 3: TSmua8tGK3sTbwi0ynrW9Q ($31.05 in chips) 
Seat 4: df7bIV965hvGEDiUAs5cfQ ($17.55 in chips) 
Seat 5: Ew/TYPQIsbQ2X8nm5iAJBg ($31.25 in chips) 
Seat 6: eHsmIvAb2JREg4O6hNPnXg ($24.45 in chips) 
Ew/TYPQIsbQ2X8nm5iAJBg: posts small blind $0.10
eHsmIvAb2JREg4O6hNPnXg: posts big blind $0.25
*** HOLE CARDS ***
7JrQNOR9wRBxq9ijFhWieg: raises $0.50 to $0.75
tzMoGl9F0PUr5NibYueeSw: folds 
TSmua8tGK3sTbwi0ynrW9Q: folds 
df7bIV965hvGEDiUAs5cfQ: calls $0.75
Ew/TYPQIsbQ2X8nm5iAJBg: folds 
eHsmIvAb2JREg4O6hNPnXg: folds 
*** FLOP *** [Ac 7d 7c]
7JrQNOR9wRBxq9ijFhWieg: bets $1
df7bIV965hvGEDiUAs5cfQ: calls $1
*** TURN *** [Ac 7d 7c] [5c]
7JrQNOR9wRBxq9ijFhWieg: bets $2
df7bIV965hvGEDiUAs5cfQ: calls $2
*** RIVER *** [Ac 7d 7c 5c] [Td]
7JrQNOR9wRBxq9ijFhWieg: checks 
df7bIV965hvGEDiUAs5cfQ: checks 
*** SHOW DOWN ***
7JrQNOR9wRBxq9ijFhWieg: shows [Jd As] (two pair, Aces and Sevens)
df7bIV965hvGEDiUAs5cfQ: mucks hand 
7JrQNOR9wRBxq9ijFhWieg collected $7.50 from pot
*** SUMMARY ***
Total pot $7.85 | Rake $0.35 
Board [Ac 7d 7c 5c Td]
Seat 1: 7JrQNOR9wRBxq9ijFhWieg showed [Jd As] and won ($7.50) with two pair, Aces and Sevens
Seat 2: tzMoGl9F0PUr5NibYueeSw folded before Flop (didn't bet)
Seat 3: TSmua8tGK3sTbwi0ynrW9Q folded before Flop (didn't bet)
Seat 4: df7bIV965hvGEDiUAs5cfQ (button) mucked
Seat 5: Ew/TYPQIsbQ2X8nm5iAJBg (small blind) folded before Flop
Seat 6: eHsmIvAb2JREg4O6hNPnXg (big blind) folded before Flop




PokerStars Game #59939468276:  Hold'em No Limit ($0.10/$0.25) - 2009/07/01 0:40:39 ET
Table '5NipxzzFB2DffzDpddyQoQ' 6-max Seat #2 is the button
Seat 1: TslQs7AQSLbVtr4X8JOOOQ ($12.60 in chips) 
Seat 2: jxrNE4qd8KCOIqHjQcwCrA ($40.45 in chips) 
Seat 3: qGHGf/553gQnDoklMRe3tg ($49.15 in chips) 
Seat 4: Inq44d7PQ+8TbEKfPeuxVQ ($6.35 in chips) 
Seat 5: cS21pIxRHx5Gt42o7hPZzw ($12.30 in chips) 
Seat 6: lYjWCpfCxX2kgcHY3v4Yow ($27.65 in chips) 
qGHGf/553gQnDoklMRe3tg: posts small blind $0.10
Inq44d7PQ+8TbEKfPeuxVQ: posts big blind $0.25
*** HOLE CARDS ***
cS21pIxRHx5Gt42o7hPZzw: raises $0.75 to $1
lYjWCpfCxX2kgcHY3v4Yow: folds 
TslQs7AQSLbVtr4X8JOOOQ: calls $1
jxrNE4qd8KCOIqHjQcwCrA: folds 
qGHGf/553gQnDoklMRe3tg: folds 
Inq44d7PQ+8TbEKfPeuxVQ: folds 
*** FLOP *** [3c 4d 8d]
cS21pIxRHx5Gt42o7hPZzw: bets $1.50
TslQs7AQSLbVtr4X8JOOOQ: folds 
Uncalled bet ($1.50) returned to cS21pIxRHx5Gt42o7hPZzw
cS21pIxRHx5Gt42o7hPZzw collected $2.25 from pot
*** SUMMARY ***
Total pot $2.35 | Rake $0.10 
Board [3c 4d 8d]
Seat 1: TslQs7AQSLbVtr4X8JOOOQ folded on the Flop
Seat 2: jxrNE4qd8KCOIqHjQcwCrA (button) folded before Flop (didn't bet)
Seat 3: qGHGf/553gQnDoklMRe3tg (small blind) folded before Flop
Seat 4: Inq44d7PQ+8TbEKfPeuxVQ (big blind) folded before Flop
Seat 5: cS21pIxRHx5Gt42o7hPZzw collected ($2.25)
Seat 6: lYjWCpfCxX2kgcHY3v4Yow folded before Flop (didn't bet)




PokerStars Game #59939468116:  Hold'em No Limit ($0.10/$0.25) - 2009/07/01 0:40:39 ET
Table 'VQNfcI8vTBCTvRfd3veTLQ' 6-max Seat #1 is the button
Seat 1: ymz+a8dgHSUFPooYplw7Ow ($23.60 in chips) 
Seat 2: KukIGupqqJCXA+Hp2bEFnA ($6.95 in chips) 
Seat 3: LtASJ9OlkqGrrUKGQlpGAw ($23.40 in chips) 
Seat 4: nc79pm0LZRdhncq55evVqA ($28.30 in chips) 
Seat 5: gX2vbKwS/8zZPENAWB7hxQ ($7.65 in chips) 
Seat 6: dlCLwmcvRShnuFDEVkdIEA ($12.10 in chips) 
KukIGupqqJCXA+Hp2bEFnA: posts small blind $0.10
LtASJ9OlkqGrrUKGQlpGAw: posts big blind $0.25
*** HOLE CARDS ***
nc79pm0LZRdhncq55evVqA: folds 
gX2vbKwS/8zZPENAWB7hxQ: calls $0.25
dlCLwmcvRShnuFDEVkdIEA: calls $0.25
ymz+a8dgHSUFPooYplw7Ow: folds 
KukIGupqqJCXA+Hp2bEFnA: calls $0.15
LtASJ9OlkqGrrUKGQlpGAw: checks 
*** FLOP *** [Kc Ts 9d]
KukIGupqqJCXA+Hp2bEFnA: checks 
LtASJ9OlkqGrrUKGQlpGAw: checks 
gX2vbKwS/8zZPENAWB7hxQ: checks 
dlCLwmcvRShnuFDEVkdIEA: bets $0.25
KukIGupqqJCXA+Hp2bEFnA: folds 
LtASJ9OlkqGrrUKGQlpGAw: folds 
gX2vbKwS/8zZPENAWB7hxQ: calls $0.25
*** TURN *** [Kc Ts 9d] [7s]
gX2vbKwS/8zZPENAWB7hxQ: checks 
dlCLwmcvRShnuFDEVkdIEA: bets $0.25
gX2vbKwS/8zZPENAWB7hxQ: calls $0.25
*** RIVER *** [Kc Ts 9d 7s] [4s]
gX2vbKwS/8zZPENAWB7hxQ: checks 
dlCLwmcvRShnuFDEVkdIEA: bets $0.25
gX2vbKwS/8zZPENAWB7hxQ: calls $0.25
*** SHOW DOWN ***
dlCLwmcvRShnuFDEVkdIEA: shows [Kh 8h] (a pair of Kings)
gX2vbKwS/8zZPENAWB7hxQ: mucks hand 
dlCLwmcvRShnuFDEVkdIEA collected $2.40 from pot
*** SUMMARY ***
Total pot $2.50 | Rake $0.10 
Board [Kc Ts 9d 7s 4s]
Seat 1: ymz+a8dgHSUFPooYplw7Ow (button) folded before Flop (didn't bet)
Seat 2: KukIGupqqJCXA+Hp2bEFnA (small blind) folded on the Flop
Seat 3: LtASJ9OlkqGrrUKGQlpGAw (big blind) folded on the Flop
Seat 4: nc79pm0LZRdhncq55evVqA folded before Flop (didn't bet)
Seat 5: gX2vbKwS/8zZPENAWB7hxQ mucked
Seat 6: dlCLwmcvRShnuFDEVkdIEA showed [Kh 8h] and won ($2.40) with a pair of Kings




PokerStars Game #59939468096:  Hold'em No Limit ($0.10/$0.25) - 2009/07/01 0:40:39 ET
Table 'Loy/olZ5qoDOSvX4UTujGg' 6-max Seat #4 is the button
Seat 1: yzFNNFIfC89bBPwpFPx2ow ($28.85 in chips) 
Seat 3: 32YL2ZEp8NT4JB2RVM9euQ ($15.65 in chips) 
Seat 4: /gJNBeCkWL4o85/jvlZ4BA ($27.10 in chips) 
Seat 5: 4YSTu0Cdzpppe1lUgCZGCQ ($35.25 in chips) 
Seat 6: 7FmwVDcdEtxDpHmP4hOXsQ ($52.70 in chips) 
4YSTu0Cdzpppe1lUgCZGCQ: posts small blind $0.10
7FmwVDcdEtxDpHmP4hOXsQ: posts big blind $0.25
*** HOLE CARDS ***
yzFNNFIfC89bBPwpFPx2ow: folds 
32YL2ZEp8NT4JB2RVM9euQ: raises $0.75 to $1
/gJNBeCkWL4o85/jvlZ4BA: folds 
4YSTu0Cdzpppe1lUgCZGCQ: folds 
7FmwVDcdEtxDpHmP4hOXsQ: folds 
Uncalled bet ($0.75) returned to 32YL2ZEp8NT4JB2RVM9euQ
32YL2ZEp8NT4JB2RVM9euQ collected $0.60 from pot
32YL2ZEp8NT4JB2RVM9euQ: doesn't show hand 
*** SUMMARY ***
Total pot $0.60 | Rake $0 
Seat 1: yzFNNFIfC89bBPwpFPx2ow folded before Flop (didn't bet)
Seat 3: 32YL2ZEp8NT4JB2RVM9euQ collected ($0.60)
Seat 4: /gJNBeCkWL4o85/jvlZ4BA (button) folded before Flop (didn't bet)
Seat 5: 4YSTu0Cdzpppe1lUgCZGCQ (small blind) folded before Flop
Seat 6: 7FmwVDcdEtxDpHmP4hOXsQ (big blind) folded before Flop




PokerStars Game #59939468160:  Hold'em No Limit ($0.10/$0.25) - 2009/07/01 0:40:39 ET
Table 'u5gc8WdJbaPqEonQaM8rHA' 9-max Seat #2 is the button
Seat 1: rXm4QDVJt67H20lM6n6Z7Q ($8.40 in chips) 
Seat 2: YcYxPZXJR8KffyXgr1BkHw ($27.80 in chips) 
Seat 4: QBNV6v6f+1ZHoaKcQDTWog ($29.50 in chips) 
Seat 5: 4y3ZJtAlW/aXjQX7SXyjrQ ($25 in chips) 
Seat 6: iPe2eRZr++z/LEfORn3WBQ ($17.05 in chips) 
QBNV6v6f+1ZHoaKcQDTWog: posts small blind $0.10
4y3ZJtAlW/aXjQX7SXyjrQ: posts big blind $0.25
*** HOLE CARDS ***
iPe2eRZr++z/LEfORn3WBQ: folds 
rXm4QDVJt67H20lM6n6Z7Q: folds 
YcYxPZXJR8KffyXgr1BkHw: folds 
QBNV6v6f+1ZHoaKcQDTWog: folds 
Uncalled bet ($0.15) returned to 4y3ZJtAlW/aXjQX7SXyjrQ
QBNV6v6f+1ZHoaKcQDTWog leaves the table
4y3ZJtAlW/aXjQX7SXyjrQ collected $0.20 from pot
4y3ZJtAlW/aXjQX7SXyjrQ: doesn't show hand 
*** SUMMARY ***
Total pot $0.20 | Rake $0 
Seat 1: rXm4QDVJt67H20lM6n6Z7Q folded before Flop (didn't bet)
Seat 2: YcYxPZXJR8KffyXgr1BkHw (button) folded before Flop (didn't bet)
Seat 4: QBNV6v6f+1ZHoaKcQDTWog (small blind) folded before Flop
Seat 5: 4y3ZJtAlW/aXjQX7SXyjrQ (big blind) collected ($0.20)
Seat 6: iPe2eRZr++z/LEfORn3WBQ folded before Flop (didn't bet)




PokerStars Game #59939468170:  Hold'em No Limit ($0.10/$0.25) - 2009/07/01 0:40:39 ET
Table '3Ns9nuTkynfwbBfBXzg6ww' 6-max Seat #4 is the button
Seat 3: HyXsCmHsOHAlL2pzZ9IYAg ($5 in chips) 
Seat 4: kyRaCIljYA6l33lSKQfNsg ($27.40 in chips) 
Seat 5: kBQU/db00TVAMeomlhblPg ($22.30 in chips) 
kBQU/db00TVAMeomlhblPg: posts small blind $0.10
HyXsCmHsOHAlL2pzZ9IYAg: posts big blind $0.25
*** HOLE CARDS ***
kyRaCIljYA6l33lSKQfNsg: raises $0.50 to $0.75
kBQU/db00TVAMeomlhblPg: calls $0.65
HyXsCmHsOHAlL2pzZ9IYAg: folds 
*** FLOP *** [2d Tc 5s]
kBQU/db00TVAMeomlhblPg: bets $0.75
kyRaCIljYA6l33lSKQfNsg: folds 
Uncalled bet ($0.75) returned to kBQU/db00TVAMeomlhblPg
kBQU/db00TVAMeomlhblPg collected $1.70 from pot
*** SUMMARY ***
Total pot $1.75 | Rake $0.05 
Board [2d Tc 5s]
Seat 3: HyXsCmHsOHAlL2pzZ9IYAg (big blind) folded before Flop
Seat 4: kyRaCIljYA6l33lSKQfNsg (button) folded on the Flop
Seat 5: kBQU/db00TVAMeomlhblPg (small blind) collected ($1.70)




PokerStars Game #59939469224:  Hold'em No Limit ($0.10/$0.25) - 2009/07/01 0:40:40 ET
Table 'nFlmVztKq1HJEWfxmdl15w' 9-max Seat #4 is the button
Seat 1: COsrwJSFHQtxlUcrYtDQPQ ($25 in chips) 
Seat 3: /XMgGtJ7mcWfe5s7McY9kw ($25 in chips) 
Seat 4: +5dSUwD+/k2ktlnutSMivw ($20.40 in chips) 
Seat 5: Tx6zQdk5Ozt9ObEBlU7jeg ($20.35 in chips) 
Seat 6: 4awUyiDYTgylQKXZ9faBVA ($29.60 in chips) 
Seat 7: Mm1VqYDg+pZQ8ufUXZHA1g ($11.90 in chips) 
Seat 9: LSrAei+fS8MYG9ie/GkG0Q ($16 in chips) 
Tx6zQdk5Ozt9ObEBlU7jeg: posts small blind $0.10
4awUyiDYTgylQKXZ9faBVA: posts big blind $0.25
+2kMBNpY4nF1qNCRd8SJLA: sits out 
*** HOLE CARDS ***
Mm1VqYDg+pZQ8ufUXZHA1g: calls $0.25
LSrAei+fS8MYG9ie/GkG0Q: calls $0.25
COsrwJSFHQtxlUcrYtDQPQ: folds 
/XMgGtJ7mcWfe5s7McY9kw: folds 
+5dSUwD+/k2ktlnutSMivw: folds 
Tx6zQdk5Ozt9ObEBlU7jeg: calls $0.15
4awUyiDYTgylQKXZ9faBVA: checks 
*** FLOP *** [9d Js Ks]
XOXO/l78 joins the table at seat #2 
Tx6zQdk5Ozt9ObEBlU7jeg: bets $1
4awUyiDYTgylQKXZ9faBVA: folds 
Mm1VqYDg+pZQ8ufUXZHA1g: folds 
LSrAei+fS8MYG9ie/GkG0Q: folds 
Uncalled bet ($1) returned to Tx6zQdk5Ozt9ObEBlU7jeg
Tx6zQdk5Ozt9ObEBlU7jeg collected $0.95 from pot
Tx6zQdk5Ozt9ObEBlU7jeg: doesn't show hand 
*** SUMMARY ***
Total pot $1 | Rake $0.05 
Board [9d Js Ks]
Seat 1: COsrwJSFHQtxlUcrYtDQPQ folded before Flop (didn't bet)
Seat 3: /XMgGtJ7mcWfe5s7McY9kw folded before Flop (didn't bet)
Seat 4: +5dSUwD+/k2ktlnutSMivw (button) folded before Flop (didn't bet)
Seat 5: Tx6zQdk5Ozt9ObEBlU7jeg (small blind) collected ($0.95)
Seat 6: 4awUyiDYTgylQKXZ9faBVA (big blind) folded on the Flop
Seat 7: Mm1VqYDg+pZQ8ufUXZHA1g folded on the Flop
Seat 9: LSrAei+fS8MYG9ie/GkG0Q folded on the Flop




PokerStars Game #59939468852:  Hold'em No Limit ($0.10/$0.25) - 2009/07/01 0:40:40 ET
Table '9iHhO6FyZVM8XpSc23TIgg' 6-max Seat #4 is the button
Seat 1: NhUN/JpAprdJeamFBgJH1w ($25 in chips) 
Seat 2: ErIN0JRL5srYjT6en1f8YQ ($32.05 in chips) 
Seat 3: EXTSABh+qTpWWrIkxl3wXg ($43.65 in chips) 
Seat 4: cfJccEfyn6IkquPN08hFsA ($32.05 in chips) 
Seat 5: WmfI+HZXhME/HMG8E3/H2w ($15.40 in chips) 
Seat 6: 5z4PIVM9IyDWfUi+/MMdTA ($17.60 in chips) 
WmfI+HZXhME/HMG8E3/H2w: posts small blind $0.10
5z4PIVM9IyDWfUi+/MMdTA: posts big blind $0.25
*** HOLE CARDS ***
NhUN/JpAprdJeamFBgJH1w: folds 
ErIN0JRL5srYjT6en1f8YQ: raises $0.50 to $0.75
EXTSABh+qTpWWrIkxl3wXg: folds 
cfJccEfyn6IkquPN08hFsA: folds 
WmfI+HZXhME/HMG8E3/H2w: folds 
5z4PIVM9IyDWfUi+/MMdTA: calls $0.50
*** FLOP *** [6c Kd Td]
5z4PIVM9IyDWfUi+/MMdTA: checks 
ErIN0JRL5srYjT6en1f8YQ: checks 
*** TURN *** [6c Kd Td] [Qh]
5z4PIVM9IyDWfUi+/MMdTA: checks 
ErIN0JRL5srYjT6en1f8YQ: bets $1.25
5z4PIVM9IyDWfUi+/MMdTA: calls $1.25
*** RIVER *** [6c Kd Td Qh] [3s]
5z4PIVM9IyDWfUi+/MMdTA: checks 
ErIN0JRL5srYjT6en1f8YQ: checks 
*** SHOW DOWN ***
5z4PIVM9IyDWfUi+/MMdTA: shows [8d 9c] (high card King)
ErIN0JRL5srYjT6en1f8YQ: shows [Ad Qd] (a pair of Queens)
ErIN0JRL5srYjT6en1f8YQ collected $3.90 from pot
*** SUMMARY ***
Total pot $4.10 | Rake $0.20 
Board [6c Kd Td Qh 3s]
Seat 1: NhUN/JpAprdJeamFBgJH1w folded before Flop (didn't bet)
Seat 2: ErIN0JRL5srYjT6en1f8YQ showed [Ad Qd] and won ($3.90) with a pair of Queens
Seat 3: EXTSABh+qTpWWrIkxl3wXg folded before Flop (didn't bet)
Seat 4: cfJccEfyn6IkquPN08hFsA (button) folded before Flop (didn't bet)
Seat 5: WmfI+HZXhME/HMG8E3/H2w (small blind) folded before Flop
Seat 6: 5z4PIVM9IyDWfUi+/MMdTA (big blind) showed [8d 9c] and lost with high card King




PokerStars Game #59939468830:  Hold'em No Limit ($0.10/$0.25) - 2009/07/01 0:40:40 ET
Table 'yRuHgMpxv4rPBXeM6HFESw' 6-max Seat #5 is the button
Seat 1: MkNgTuvyxpHXkeIm5JITHQ ($9.40 in chips) 
Seat 2: iwlxXocltgSdaBmusNXanQ ($15.45 in chips) 
Seat 3: zZ8zH49EwNs0mqgppOaL9g ($50.55 in chips) 
Seat 4: ypXnt+kzrF/5y8QN2rkt1A ($19.50 in chips) 
Seat 5: gaPMxLGp9SOj4Lq6t+/0Ig ($13.65 in chips) 
Seat 6: 4YSTu0Cdzpppe1lUgCZGCQ ($26.25 in chips) 
4YSTu0Cdzpppe1lUgCZGCQ: posts small blind $0.10
MkNgTuvyxpHXkeIm5JITHQ: posts big blind $0.25
*** HOLE CARDS ***
iwlxXocltgSdaBmusNXanQ: folds 
zZ8zH49EwNs0mqgppOaL9g: folds 
ypXnt+kzrF/5y8QN2rkt1A: calls $0.25
gaPMxLGp9SOj4Lq6t+/0Ig: folds 
4YSTu0Cdzpppe1lUgCZGCQ: folds 
MkNgTuvyxpHXkeIm5JITHQ: raises $0.50 to $0.75
ypXnt+kzrF/5y8QN2rkt1A: calls $0.50
*** FLOP *** [Ah 8s 8h]
MkNgTuvyxpHXkeIm5JITHQ: bets $0.75
ypXnt+kzrF/5y8QN2rkt1A: calls $0.75
*** TURN *** [Ah 8s 8h] [Qs]
MkNgTuvyxpHXkeIm5JITHQ: checks 
ypXnt+kzrF/5y8QN2rkt1A: bets $1.50
MkNgTuvyxpHXkeIm5JITHQ: folds 
Uncalled bet ($1.50) returned to ypXnt+kzrF/5y8QN2rkt1A
ypXnt+kzrF/5y8QN2rkt1A collected $2.95 from pot
*** SUMMARY ***
Total pot $3.10 | Rake $0.15 
Board [Ah 8s 8h Qs]
Seat 1: MkNgTuvyxpHXkeIm5JITHQ (big blind) folded on the Turn
Seat 2: iwlxXocltgSdaBmusNXanQ folded before Flop (didn't bet)
Seat 3: zZ8zH49EwNs0mqgppOaL9g folded before Flop (didn't bet)
Seat 4: ypXnt+kzrF/5y8QN2rkt1A collected ($2.95)
Seat 5: gaPMxLGp9SOj4Lq6t+/0Ig (button) folded before Flop (didn't bet)
Seat 6: 4YSTu0Cdzpppe1lUgCZGCQ (small blind) folded before Flop




PokerStars Game #59939469222:  Hold'em No Limit ($0.10/$0.25) - 2009/07/01 0:40:40 ET
Table 'GrYi0DZOHD1EvB+qiLExNw' 9-max Seat #7 is the button
Seat 1: 4awUyiDYTgylQKXZ9faBVA ($48.85 in chips) 
Seat 2: Th3FldXKQW6hWVVPahaoOQ ($26.65 in chips) 
Seat 3: 4oA316mXLIui1QY63GXBUg ($25 in chips) 
Seat 4: 0GQg6tdDMBDzY6FKumSo9w ($25.75 in chips) 
Seat 5: cZ99hugmLBj9KhTlc8nCSw ($48.50 in chips) 
Seat 6: H9KUl8cmpLgEpOVDA00bCg ($4.20 in chips) 
Seat 7: 1Clf3cPrqoy/YgvWdWK1Xw ($5 in chips) 
Seat 8: nalbG/4/1Z1wQjRDWV7b2w ($7.10 in chips) 
nalbG/4/1Z1wQjRDWV7b2w: posts small blind $0.10
st9jtdNbm1W5GfBwRaCVqQ: is sitting out 
4awUyiDYTgylQKXZ9faBVA: posts big blind $0.25
*** HOLE CARDS ***
st9jtdNbm1W5GfBwRaCVqQ leaves the table
Th3FldXKQW6hWVVPahaoOQ: folds 
4oA316mXLIui1QY63GXBUg: folds 
0GQg6tdDMBDzY6FKumSo9w: folds 
cZ99hugmLBj9KhTlc8nCSw: folds 
H9KUl8cmpLgEpOVDA00bCg: folds 
1Clf3cPrqoy/YgvWdWK1Xw: folds 
nalbG/4/1Z1wQjRDWV7b2w: folds 
Uncalled bet ($0.15) returned to 4awUyiDYTgylQKXZ9faBVA
4awUyiDYTgylQKXZ9faBVA collected $0.20 from pot
4awUyiDYTgylQKXZ9faBVA: doesn't show hand 
OiV1PWZ3IkN29JlmCcnTwQ joins the table at seat #9 
*** SUMMARY ***
Total pot $0.20 | Rake $0 
Seat 1: 4awUyiDYTgylQKXZ9faBVA (big blind) collected ($0.20)
Seat 2: Th3FldXKQW6hWVVPahaoOQ folded before Flop (didn't bet)
Seat 3: 4oA316mXLIui1QY63GXBUg folded before Flop (didn't bet)
Seat 4: 0GQg6tdDMBDzY6FKumSo9w folded before Flop (didn't bet)
Seat 5: cZ99hugmLBj9KhTlc8nCSw folded before Flop (didn't bet)
Seat 6: H9KUl8cmpLgEpOVDA00bCg folded before Flop (didn't bet)
Seat 7: 1Clf3cPrqoy/YgvWdWK1Xw (button) folded before Flop (didn't bet)
Seat 8: nalbG/4/1Z1wQjRDWV7b2w (small blind) folded before Flop




PokerStars Game #59939469310:  Hold'em No Limit ($0.10/$0.25) - 2009/07/01 0:40:40 ET
Table 'yAHDCs33TIgw3ra63xuU2Q' 9-max Seat #9 is the button
Seat 1: 8B/dhbQjIWe6ASCdgzktNQ ($25.90 in chips) 
Seat 2: LBrhQVB4w41YNd7kMYn/og ($19.35 in chips) 
Seat 3: H9KUl8cmpLgEpOVDA00bCg ($4.30 in chips) 
Seat 4: rUdM7gwmNCaxMNSb2CFPhQ ($11 in chips) 
Seat 5: 4awUyiDYTgylQKXZ9faBVA ($25 in chips) 
Seat 7: OiV1PWZ3IkN29JlmCcnTwQ ($4.90 in chips) 
Seat 8: tYsOBqdU1+x+yFI7zHO7hQ ($28.70 in chips) 
Seat 9: k+ydNCnnP3Hgwh0AnDYVrA ($13.75 in chips) 
8B/dhbQjIWe6ASCdgzktNQ: posts small blind $0.10
LBrhQVB4w41YNd7kMYn/og: posts big blind $0.25
*** HOLE CARDS ***
H9KUl8cmpLgEpOVDA00bCg: folds 
rUdM7gwmNCaxMNSb2CFPhQ: folds 
4awUyiDYTgylQKXZ9faBVA: folds 
OiV1PWZ3IkN29JlmCcnTwQ: folds 
tYsOBqdU1+x+yFI7zHO7hQ: folds 
k+ydNCnnP3Hgwh0AnDYVrA: calls $0.25
8B/dhbQjIWe6ASCdgzktNQ: calls $0.15
LBrhQVB4w41YNd7kMYn/og: checks 
*** FLOP *** [As 5s Jc]
Z5ZtGOON8kmSdSCll9Z3XA joins the table at seat #6 
8B/dhbQjIWe6ASCdgzktNQ: bets $0.75
LBrhQVB4w41YNd7kMYn/og: folds 
k+ydNCnnP3Hgwh0AnDYVrA: folds 
Uncalled bet ($0.75) returned to 8B/dhbQjIWe6ASCdgzktNQ
8B/dhbQjIWe6ASCdgzktNQ collected $0.75 from pot
8B/dhbQjIWe6ASCdgzktNQ: doesn't show hand 
*** SUMMARY ***
Total pot $0.75 | Rake $0 
Board [As 5s Jc]
Seat 1: 8B/dhbQjIWe6ASCdgzktNQ (small blind) collected ($0.75)
Seat 2: LBrhQVB4w41YNd7kMYn/og (big blind) folded on the Flop
Seat 3: H9KUl8cmpLgEpOVDA00bCg folded before Flop (didn't bet)
Seat 4: rUdM7gwmNCaxMNSb2CFPhQ folded before Flop (didn't bet)
Seat 5: 4awUyiDYTgylQKXZ9faBVA folded before Flop (didn't bet)
Seat 7: OiV1PWZ3IkN29JlmCcnTwQ folded before Flop (didn't bet)
Seat 8: tYsOBqdU1+x+yFI7zHO7hQ folded before Flop (didn't bet)
Seat 9: k+ydNCnnP3Hgwh0AnDYVrA (button) folded on the Flop




PokerStars Game #59939469150:  Hold'em No Limit ($0.10/$0.25) - 2009/07/01 0:40:40 ET
Table 'vud0GB/ZlDCvUFhBFIaTlg' 9-max Seat #5 is the button
Seat 5: AwAabNdwDsTMb3aTomdOmg ($5.80 in chips) 
Seat 7: RzaVufWfW9CTnVYR7/Ge+w ($2.30 in chips) 
AwAabNdwDsTMb3aTomdOmg: posts small blind $0.10
RzaVufWfW9CTnVYR7/Ge+w: posts big blind $0.25
*** HOLE CARDS ***
AwAabNdwDsTMb3aTomdOmg: calls $0.15
RzaVufWfW9CTnVYR7/Ge+w: checks 
*** FLOP *** [9d 5s 7c]
RzaVufWfW9CTnVYR7/Ge+w: bets $0.25
AwAabNdwDsTMb3aTomdOmg: calls $0.25
*** TURN *** [9d 5s 7c] [9c]
RzaVufWfW9CTnVYR7/Ge+w: bets $0.25
AwAabNdwDsTMb3aTomdOmg: calls $0.25
*** RIVER *** [9d 5s 7c 9c] [Tc]
RzaVufWfW9CTnVYR7/Ge+w: checks 
AwAabNdwDsTMb3aTomdOmg: checks 
*** SHOW DOWN ***
RzaVufWfW9CTnVYR7/Ge+w: shows [Ac 4h] (a pair of Nines)
AwAabNdwDsTMb3aTomdOmg: mucks hand 
RzaVufWfW9CTnVYR7/Ge+w collected $1.45 from pot
*** SUMMARY ***
Total pot $1.50 | Rake $0.05 
Board [9d 5s 7c 9c Tc]
Seat 5: AwAabNdwDsTMb3aTomdOmg (button) (small blind) mucked
Seat 7: RzaVufWfW9CTnVYR7/Ge+w (big blind) showed [Ac 4h] and won ($1.45) with a pair of Nines




PokerStars Game #59939469176:  Hold'em No Limit ($0.10/$0.25) - 2009/07/01 0:40:40 ET
Table 'djcjiEGabFQO0MNG6jEeJQ' 9-max Seat #1 is the button
Seat 1: K7bAhhMMJ/XcTmGaBZVfFQ ($23.80 in chips) 
Seat 2: 1K6QGyJP9P9xmRac2fH4OQ ($30.75 in chips) 
Seat 3: 1S/fpm+f42V/6MNZre+ccg ($27.35 in chips) 
Seat 4: Z7GF1yA2ZTKm8gR4H8XDhg ($11.30 in chips) 
Seat 5: cZ99hugmLBj9KhTlc8nCSw ($37.15 in chips) 
Seat 6: aNpwfA31EREwO+ar4XzBCw ($59.55 in chips) 
Seat 7: 56S3mA6Zs3pGR+0p0vUCtg ($30.45 in chips) 
Seat 8: +sbyWwIcFp9kP0bDtMegfQ ($45.35 in chips) 
Seat 9: HPEB+AtKw1+C/cxU0o1ciw ($47.65 in chips) 
1K6QGyJP9P9xmRac2fH4OQ: posts small blind $0.10
1S/fpm+f42V/6MNZre+ccg: posts big blind $0.25
*** HOLE CARDS ***
Z7GF1yA2ZTKm8gR4H8XDhg: folds 
cZ99hugmLBj9KhTlc8nCSw: folds 
aNpwfA31EREwO+ar4XzBCw: folds 
56S3mA6Zs3pGR+0p0vUCtg: folds 
Z7GF1yA2ZTKm8gR4H8XDhg leaves the table
+sbyWwIcFp9kP0bDtMegfQ: raises $0.75 to $1
HPEB+AtKw1+C/cxU0o1ciw: folds 
K7bAhhMMJ/XcTmGaBZVfFQ: folds 
1K6QGyJP9P9xmRac2fH4OQ: calls $0.90
1S/fpm+f42V/6MNZre+ccg: folds 
*** FLOP *** [Kd As Ks]
1K6QGyJP9P9xmRac2fH4OQ: bets $1.50
+sbyWwIcFp9kP0bDtMegfQ: calls $1.50
*** TURN *** [Kd As Ks] [6c]
1K6QGyJP9P9xmRac2fH4OQ: bets $3.50
+sbyWwIcFp9kP0bDtMegfQ: raises $4.50 to $8
1K6QGyJP9P9xmRac2fH4OQ: calls $4.50
*** RIVER *** [Kd As Ks 6c] [Tc]
E6WojUZ5V/6opnfMNTSjXQ joins the table at seat #4 
1K6QGyJP9P9xmRac2fH4OQ: checks 
+sbyWwIcFp9kP0bDtMegfQ: bets $25
1K6QGyJP9P9xmRac2fH4OQ: folds 
Uncalled bet ($25) returned to +sbyWwIcFp9kP0bDtMegfQ
+sbyWwIcFp9kP0bDtMegfQ collected $20.20 from pot
+sbyWwIcFp9kP0bDtMegfQ: doesn't show hand 
*** SUMMARY ***
Total pot $21.25 | Rake $1.05 
Board [Kd As Ks 6c Tc]
Seat 1: K7bAhhMMJ/XcTmGaBZVfFQ (button) folded before Flop (didn't bet)
Seat 2: 1K6QGyJP9P9xmRac2fH4OQ (small blind) folded on the River
Seat 3: 1S/fpm+f42V/6MNZre+ccg (big blind) folded before Flop
Seat 4: Z7GF1yA2ZTKm8gR4H8XDhg folded before Flop (didn't bet)
Seat 5: cZ99hugmLBj9KhTlc8nCSw folded before Flop (didn't bet)
Seat 6: aNpwfA31EREwO+ar4XzBCw folded before Flop (didn't bet)
Seat 7: 56S3mA6Zs3pGR+0p0vUCtg folded before Flop (didn't bet)
Seat 8: +sbyWwIcFp9kP0bDtMegfQ collected ($20.20)
Seat 9: HPEB+AtKw1+C/cxU0o1ciw folded before Flop (didn't bet)




PokerStars Game #59939469288:  Hold'em No Limit ($0.10/$0.25) - 2009/07/01 0:40:40 ET
Table 'rpIHGyt2QpgQc5bvptAvDQ' 9-max Seat #3 is the button
Seat 1: pIK8dHf+MqCSMpnx8j9HEw ($17.15 in chips) 
Seat 2: Xpyqpb+DURDWnyJ3xTEIFQ ($27.25 in chips) 
Seat 3: RNWwL4ZL6E6nNwmoYWS4Ug ($12.25 in chips) 
Seat 4: ottZQkg1UDWk85BtBzGJzg ($13.15 in chips) 
Seat 5: F7uW1LiDD9vUDBtB+5gRDg ($14.15 in chips) 
Seat 6: gehe91e0IyVT0QU/XBkEyg ($39.35 in chips) 
Seat 7: SXqVW4Q0evTUVZG6BbUNIA ($29.60 in chips) 
Seat 8: tYsOBqdU1+x+yFI7zHO7hQ ($25 in chips) 
Seat 9: nm4Dj/f+jJEwKVsUnKh73g ($20.75 in chips) 
ottZQkg1UDWk85BtBzGJzg: posts small blind $0.10
F7uW1LiDD9vUDBtB+5gRDg: posts big blind $0.25
*** HOLE CARDS ***
gehe91e0IyVT0QU/XBkEyg: raises $1 to $1.25
SXqVW4Q0evTUVZG6BbUNIA: folds 
tYsOBqdU1+x+yFI7zHO7hQ: folds 
nm4Dj/f+jJEwKVsUnKh73g: folds 
pIK8dHf+MqCSMpnx8j9HEw: folds 
Xpyqpb+DURDWnyJ3xTEIFQ: folds 
RNWwL4ZL6E6nNwmoYWS4Ug: folds 
ottZQkg1UDWk85BtBzGJzg: folds 
F7uW1LiDD9vUDBtB+5gRDg: folds 
Uncalled bet ($1) returned to gehe91e0IyVT0QU/XBkEyg
gehe91e0IyVT0QU/XBkEyg collected $0.60 from pot
*** SUMMARY ***
Total pot $0.60 | Rake $0 
Seat 1: pIK8dHf+MqCSMpnx8j9HEw folded before Flop (didn't bet)
Seat 2: Xpyqpb+DURDWnyJ3xTEIFQ folded before Flop (didn't bet)
Seat 3: RNWwL4ZL6E6nNwmoYWS4Ug (button) folded before Flop (didn't bet)
Seat 4: ottZQkg1UDWk85BtBzGJzg (small blind) folded before Flop
Seat 5: F7uW1LiDD9vUDBtB+5gRDg (big blind) folded before Flop
Seat 6: gehe91e0IyVT0QU/XBkEyg collected ($0.60)
Seat 7: SXqVW4Q0evTUVZG6BbUNIA folded before Flop (didn't bet)
Seat 8: tYsOBqdU1+x+yFI7zHO7hQ folded before Flop (didn't bet)
Seat 9: nm4Dj/f+jJEwKVsUnKh73g folded before Flop (didn't bet)




PokerStars Game #59939468926:  Hold'em No Limit ($0.10/$0.25) - 2009/07/01 0:40:40 ET
Table 'MQJMxKDF6VYBWIKv7VfCog' 9-max Seat #8 is the button
Seat 1: cZ99hugmLBj9KhTlc8nCSw ($26.15 in chips) 
Seat 2: JxpnpCmvRAcrEUy7mq1iAg ($5.20 in chips) 
Seat 3: EfRs3ibIxn+c9JDErwwNCg ($26.40 in chips) 
Seat 4: JtVGnq5doRa3PublncR+Yw ($24.25 in chips) 
Seat 5: RJ/x9oZtt1RZLaJEQwZOxQ ($25.60 in chips) 
Seat 6: ydoFOVgzvZv9ZhuWu9rXAw ($4.90 in chips) 
Seat 7: dfNim92Z6XK1/h5SFW5vDg ($52.95 in chips) 
Seat 8: Z9AeOQX3yzuSvKAm/xyovg ($9.30 in chips) 
Seat 9: 1S/fpm+f42V/6MNZre+ccg ($36.35 in chips) 
1S/fpm+f42V/6MNZre+ccg: posts small blind $0.10
cZ99hugmLBj9KhTlc8nCSw: posts big blind $0.25
*** HOLE CARDS ***
JxpnpCmvRAcrEUy7mq1iAg: folds 
EfRs3ibIxn+c9JDErwwNCg: calls $0.25
JtVGnq5doRa3PublncR+Yw: folds 
RJ/x9oZtt1RZLaJEQwZOxQ: folds 
ydoFOVgzvZv9ZhuWu9rXAw: folds 
dfNim92Z6XK1/h5SFW5vDg: folds 
Z9AeOQX3yzuSvKAm/xyovg: folds 
1S/fpm+f42V/6MNZre+ccg: calls $0.15
cZ99hugmLBj9KhTlc8nCSw: checks 
*** FLOP *** [8c 8s Qs]
1S/fpm+f42V/6MNZre+ccg: checks 
cZ99hugmLBj9KhTlc8nCSw: checks 
EfRs3ibIxn+c9JDErwwNCg: checks 
*** TURN *** [8c 8s Qs] [3d]
1S/fpm+f42V/6MNZre+ccg: checks 
cZ99hugmLBj9KhTlc8nCSw: bets $0.50
EfRs3ibIxn+c9JDErwwNCg: folds 
1S/fpm+f42V/6MNZre+ccg: folds 
Uncalled bet ($0.50) returned to cZ99hugmLBj9KhTlc8nCSw
cZ99hugmLBj9KhTlc8nCSw collected $0.75 from pot
*** SUMMARY ***
Total pot $0.75 | Rake $0 
Board [8c 8s Qs 3d]
Seat 1: cZ99hugmLBj9KhTlc8nCSw (big blind) collected ($0.75)
Seat 2: JxpnpCmvRAcrEUy7mq1iAg folded before Flop (didn't bet)
Seat 3: EfRs3ibIxn+c9JDErwwNCg folded on the Turn
Seat 4: JtVGnq5doRa3PublncR+Yw folded before Flop (didn't bet)
Seat 5: RJ/x9oZtt1RZLaJEQwZOxQ folded before Flop (didn't bet)
Seat 6: ydoFOVgzvZv9ZhuWu9rXAw folded before Flop (didn't bet)
Seat 7: dfNim92Z6XK1/h5SFW5vDg folded before Flop (didn't bet)
Seat 8: Z9AeOQX3yzuSvKAm/xyovg (button) folded before Flop (didn't bet)
Seat 9: 1S/fpm+f42V/6MNZre+ccg (small blind) folded on the Turn




PokerStars Game #59939469944:  Hold'em No Limit ($0.10/$0.25) - 2009/07/01 0:40:41 ET
Table 'HIOfhT0zga/KonFhIl6O3w' 9-max Seat #8 is the button
Seat 1: t2nb95S5EEFOEzNx9Itz0g ($6.20 in chips) 
Seat 2: er86weqXTpTB6/w2dKlYgA ($16.45 in chips) 
Seat 3: RxrlOCIHB/l30KL6EEws0g ($37.15 in chips) 
Seat 4: qwr38jl5txoR36M7G5qi4A ($8.10 in chips) 
Seat 5: K1MDeapSEyKyGPNZGOKfEg ($14.20 in chips) 
Seat 6: cZ99hugmLBj9KhTlc8nCSw ($25.70 in chips) 
Seat 7: H9KUl8cmpLgEpOVDA00bCg ($5.25 in chips) 
Seat 8: 3RCAkueG3Vc13VpRStCB+w ($25.50 in chips) 
Seat 9: dfNim92Z6XK1/h5SFW5vDg ($25.35 in chips) 
dfNim92Z6XK1/h5SFW5vDg: posts small blind $0.10
t2nb95S5EEFOEzNx9Itz0g: posts big blind $0.25
*** HOLE CARDS ***
er86weqXTpTB6/w2dKlYgA: calls $0.25
RxrlOCIHB/l30KL6EEws0g: folds 
qwr38jl5txoR36M7G5qi4A: folds 
K1MDeapSEyKyGPNZGOKfEg: folds 
cZ99hugmLBj9KhTlc8nCSw: raises $0.75 to $1
H9KUl8cmpLgEpOVDA00bCg: folds 
3RCAkueG3Vc13VpRStCB+w: folds 
dfNim92Z6XK1/h5SFW5vDg: folds 
t2nb95S5EEFOEzNx9Itz0g: folds 
er86weqXTpTB6/w2dKlYgA: folds 
Uncalled bet ($0.75) returned to cZ99hugmLBj9KhTlc8nCSw
cZ99hugmLBj9KhTlc8nCSw collected $0.85 from pot
*** SUMMARY ***
Total pot $0.85 | Rake $0 
Seat 1: t2nb95S5EEFOEzNx9Itz0g (big blind) folded before Flop
Seat 2: er86weqXTpTB6/w2dKlYgA folded before Flop
Seat 3: RxrlOCIHB/l30KL6EEws0g folded before Flop (didn't bet)
Seat 4: qwr38jl5txoR36M7G5qi4A folded before Flop (didn't bet)
Seat 5: K1MDeapSEyKyGPNZGOKfEg folded before Flop (didn't bet)
Seat 6: cZ99hugmLBj9KhTlc8nCSw collected ($0.85)
Seat 7: H9KUl8cmpLgEpOVDA00bCg folded before Flop (didn't bet)
Seat 8: 3RCAkueG3Vc13VpRStCB+w (button) folded before Flop (didn't bet)
Seat 9: dfNim92Z6XK1/h5SFW5vDg (small blind) folded before Flop




PokerStars Game #59939469762:  Hold'em No Limit ($0.10/$0.25) - 2009/07/01 0:40:41 ET
Table 'wixGE3Zge1qBdnpWijIl/w' 9-max Seat #3 is the button
Seat 1: EcWpc/mcsCWBGKsSdZaXbA ($24.65 in chips) 
Seat 2: vbD+Kd6m/X3hUBBcGpUKjA ($7.85 in chips) 
Seat 3: DdPXdieucQ+n99u1n3A+rQ ($4.65 in chips) 
Seat 4: 4oA316mXLIui1QY63GXBUg ($25 in chips) 
Seat 5: MIVCHqCqqlke0Lb0z7glcw ($38.25 in chips) 
Seat 6: TlEYI/zXzaKGGsmuvWFd2A ($5.45 in chips) 
Seat 7: qIaaweMCAGmy9HZFT4r/6A ($54.90 in chips) 
Seat 8: hIss79a4pu7GzJZepfgOpg ($25 in chips) 
Seat 9: r6hsffOo1iKmaPYKwAZmFw ($25.75 in chips) 
4oA316mXLIui1QY63GXBUg: posts small blind $0.10
MIVCHqCqqlke0Lb0z7glcw: posts big blind $0.25
*** HOLE CARDS ***
TlEYI/zXzaKGGsmuvWFd2A: raises $0.75 to $1
qIaaweMCAGmy9HZFT4r/6A: folds 
hIss79a4pu7GzJZepfgOpg: folds 
r6hsffOo1iKmaPYKwAZmFw: folds 
EcWpc/mcsCWBGKsSdZaXbA: folds 
vbD+Kd6m/X3hUBBcGpUKjA: folds 
DdPXdieucQ+n99u1n3A+rQ: folds 
4oA316mXLIui1QY63GXBUg: folds 
MIVCHqCqqlke0Lb0z7glcw: folds 
Uncalled bet ($0.75) returned to TlEYI/zXzaKGGsmuvWFd2A
TlEYI/zXzaKGGsmuvWFd2A collected $0.60 from pot
*** SUMMARY ***
Total pot $0.60 | Rake $0 
Seat 1: EcWpc/mcsCWBGKsSdZaXbA folded before Flop (didn't bet)
Seat 2: vbD+Kd6m/X3hUBBcGpUKjA folded before Flop (didn't bet)
Seat 3: DdPXdieucQ+n99u1n3A+rQ (button) folded before Flop (didn't bet)
Seat 4: 4oA316mXLIui1QY63GXBUg (small blind) folded before Flop
Seat 5: MIVCHqCqqlke0Lb0z7glcw (big blind) folded before Flop
Seat 6: TlEYI/zXzaKGGsmuvWFd2A collected ($0.60)
Seat 7: qIaaweMCAGmy9HZFT4r/6A folded before Flop (didn't bet)
Seat 8: hIss79a4pu7GzJZepfgOpg folded before Flop (didn't bet)
Seat 9: r6hsffOo1iKmaPYKwAZmFw folded before Flop (didn't bet)




PokerStars Game #59939469454:  Hold'em No Limit ($0.10/$0.25) - 2009/07/01 0:40:41 ET
Table 'KYX9dFNuOA9l2PV46IebqQ' 9-max Seat #9 is the button
Seat 1: s7Q6uNouhe7aE8JdFb9E+A ($27.15 in chips) 
Seat 2: r6hsffOo1iKmaPYKwAZmFw ($25 in chips) 
Seat 3: f+H1PHwj9cNu4Y6FfvKwQQ ($15.85 in chips) 
Seat 4: SkLOm0UugROBRt2EfMpOxQ ($38.30 in chips) 
Seat 5: HQMjiff9S04k8kyC4fHVgw ($2.55 in chips) 
Seat 6: DiSvPC2iudwL5j9u6Huyww ($25.35 in chips) 
Seat 7: kmJc9NmBNbE55/AnUDL6/w ($3.85 in chips) 
Seat 8: 4oA316mXLIui1QY63GXBUg ($25 in chips) 
Seat 9: W4TLQcZ2TiM73eIgpIvlGg ($32.95 in chips) 
s7Q6uNouhe7aE8JdFb9E+A: posts small blind $0.10
r6hsffOo1iKmaPYKwAZmFw: posts big blind $0.25
*** HOLE CARDS ***
f+H1PHwj9cNu4Y6FfvKwQQ: calls $0.25
SkLOm0UugROBRt2EfMpOxQ: folds 
HQMjiff9S04k8kyC4fHVgw: folds 
DiSvPC2iudwL5j9u6Huyww: folds 
kmJc9NmBNbE55/AnUDL6/w: folds 
4oA316mXLIui1QY63GXBUg: folds 
W4TLQcZ2TiM73eIgpIvlGg: calls $0.25
s7Q6uNouhe7aE8JdFb9E+A: folds 
r6hsffOo1iKmaPYKwAZmFw: checks 
*** FLOP *** [4h 9s 3s]
r6hsffOo1iKmaPYKwAZmFw: bets $0.75
f+H1PHwj9cNu4Y6FfvKwQQ: folds 
W4TLQcZ2TiM73eIgpIvlGg: raises $1.25 to $2
r6hsffOo1iKmaPYKwAZmFw: calls $1.25
*** TURN *** [4h 9s 3s] [7s]
r6hsffOo1iKmaPYKwAZmFw: bets $3.75
W4TLQcZ2TiM73eIgpIvlGg: folds 
Uncalled bet ($3.75) returned to r6hsffOo1iKmaPYKwAZmFw
r6hsffOo1iKmaPYKwAZmFw collected $4.65 from pot
r6hsffOo1iKmaPYKwAZmFw: doesn't show hand 
*** SUMMARY ***
Total pot $4.85 | Rake $0.20 
Board [4h 9s 3s 7s]
Seat 1: s7Q6uNouhe7aE8JdFb9E+A (small blind) folded before Flop
Seat 2: r6hsffOo1iKmaPYKwAZmFw (big blind) collected ($4.65)
Seat 3: f+H1PHwj9cNu4Y6FfvKwQQ folded on the Flop
Seat 4: SkLOm0UugROBRt2EfMpOxQ folded before Flop (didn't bet)
Seat 5: HQMjiff9S04k8kyC4fHVgw folded before Flop (didn't bet)
Seat 6: DiSvPC2iudwL5j9u6Huyww folded before Flop (didn't bet)
Seat 7: kmJc9NmBNbE55/AnUDL6/w folded before Flop (didn't bet)
Seat 8: 4oA316mXLIui1QY63GXBUg folded before Flop (didn't bet)
Seat 9: W4TLQcZ2TiM73eIgpIvlGg (button) folded on the Turn




PokerStars Game #59939469532:  Hold'em No Limit ($0.10/$0.25) - 2009/07/01 0:40:41 ET
Table '0w9m+UkNlGMNoPyQqzWk6A' 9-max Seat #5 is the button
Seat 1: 28AHlgXlrYLdiBUJNBoqWA ($25.05 in chips) 
Seat 2: tYsOBqdU1+x+yFI7zHO7hQ ($46.20 in chips) 
Seat 3: VWwtMkIjXloiX/RKh7RGWQ ($8.25 in chips) 
Seat 5: rPXwQUVloUl+qZm3CCtaJw ($17 in chips) 
Seat 6: sWBBy1WroEskLNyJzhkUag ($16.25 in chips) 
Seat 7: lrTLp1zpuCCs/e0pi2M8jw ($12.65 in chips) 
Seat 8: hPhp/RE3cJ5YGaQ2xOHXXg ($5.75 in chips) 
Seat 9: 56S3mA6Zs3pGR+0p0vUCtg ($24.95 in chips) 
sWBBy1WroEskLNyJzhkUag: posts small blind $0.10
lrTLp1zpuCCs/e0pi2M8jw: posts big blind $0.25
*** HOLE CARDS ***
hPhp/RE3cJ5YGaQ2xOHXXg: folds 
56S3mA6Zs3pGR+0p0vUCtg: raises $1 to $1.25
28AHlgXlrYLdiBUJNBoqWA: folds 
tYsOBqdU1+x+yFI7zHO7hQ: folds 
VWwtMkIjXloiX/RKh7RGWQ: folds 
rPXwQUVloUl+qZm3CCtaJw: folds 
sWBBy1WroEskLNyJzhkUag: folds 
lrTLp1zpuCCs/e0pi2M8jw: calls $1
*** FLOP *** [Jc 3h 2h]
ALASKA OLE said, "gg nice group to plat with :-)"
lrTLp1zpuCCs/e0pi2M8jw: checks 
ALASKA OLE leaves the table
56S3mA6Zs3pGR+0p0vUCtg: bets $1
rPXwQUVloUl+qZm3CCtaJw said, "u2"
lrTLp1zpuCCs/e0pi2M8jw: calls $1
*** TURN *** [Jc 3h 2h] [5s]
lrTLp1zpuCCs/e0pi2M8jw: checks 
rPXwQUVloUl+qZm3CCtaJw said, "wishing you won :)"
56S3mA6Zs3pGR+0p0vUCtg: bets $2
lrTLp1zpuCCs/e0pi2M8jw: calls $2
*** RIVER *** [Jc 3h 2h 5s] [2s]
lrTLp1zpuCCs/e0pi2M8jw: checks 
56S3mA6Zs3pGR+0p0vUCtg: checks 
*** SHOW DOWN ***
lrTLp1zpuCCs/e0pi2M8jw: shows [6s 6h] (two pair, Sixes and Deuces)
56S3mA6Zs3pGR+0p0vUCtg: shows [8c 8h] (two pair, Eights and Deuces)
56S3mA6Zs3pGR+0p0vUCtg collected $8.20 from pot
*** SUMMARY ***
Total pot $8.60 | Rake $0.40 
Board [Jc 3h 2h 5s 2s]
Seat 1: 28AHlgXlrYLdiBUJNBoqWA folded before Flop (didn't bet)
Seat 2: tYsOBqdU1+x+yFI7zHO7hQ folded before Flop (didn't bet)
Seat 3: VWwtMkIjXloiX/RKh7RGWQ folded before Flop (didn't bet)
Seat 5: rPXwQUVloUl+qZm3CCtaJw (button) folded before Flop (didn't bet)
Seat 6: sWBBy1WroEskLNyJzhkUag (small blind) folded before Flop
Seat 7: lrTLp1zpuCCs/e0pi2M8jw (big blind) showed [6s 6h] and lost with two pair, Sixes and Deuces
Seat 8: hPhp/RE3cJ5YGaQ2xOHXXg folded before Flop (didn't bet)
Seat 9: 56S3mA6Zs3pGR+0p0vUCtg showed [8c 8h] and won ($8.20) with two pair, Eights and Deuces




PokerStars Game #59939469766:  Hold'em No Limit ($0.10/$0.25) - 2009/07/01 0:40:41 ET
Table '2AUmC2Rslg+QUbLfdgNdfg' 6-max Seat #2 is the button
Seat 1: lgP2sg9oZJsNSXCt7tbwRg ($16.25 in chips) 
Seat 2: CCxAG7iPVlAv3brCqrGBEg ($12.40 in chips) 
Seat 3: iauW7L/+7qzAuHow7CD75Q ($7.30 in chips) 
Seat 4: B6R6e73iyJNddUtXtvYr3Q ($47.95 in chips) 
Seat 5: 8ClCHtFXGNplITm+63KB+Q ($22.95 in chips) 
Seat 6: BvTq4Tu0zBOsniW3eFCnkQ ($33.40 in chips) 
iauW7L/+7qzAuHow7CD75Q: posts small blind $0.10
B6R6e73iyJNddUtXtvYr3Q: posts big blind $0.25
*** HOLE CARDS ***
8ClCHtFXGNplITm+63KB+Q: raises $0.75 to $1
BvTq4Tu0zBOsniW3eFCnkQ: folds 
lgP2sg9oZJsNSXCt7tbwRg: folds 
CCxAG7iPVlAv3brCqrGBEg: folds 
iauW7L/+7qzAuHow7CD75Q: folds 
B6R6e73iyJNddUtXtvYr3Q: folds 
Uncalled bet ($0.75) returned to 8ClCHtFXGNplITm+63KB+Q
8ClCHtFXGNplITm+63KB+Q collected $0.60 from pot
8ClCHtFXGNplITm+63KB+Q: doesn't show hand 
*** SUMMARY ***
Total pot $0.60 | Rake $0 
Seat 1: lgP2sg9oZJsNSXCt7tbwRg folded before Flop (didn't bet)
Seat 2: CCxAG7iPVlAv3brCqrGBEg (button) folded before Flop (didn't bet)
Seat 3: iauW7L/+7qzAuHow7CD75Q (small blind) folded before Flop
Seat 4: B6R6e73iyJNddUtXtvYr3Q (big blind) folded before Flop
Seat 5: 8ClCHtFXGNplITm+63KB+Q collected ($0.60)
Seat 6: BvTq4Tu0zBOsniW3eFCnkQ folded before Flop (didn't bet)




PokerStars Game #59939469824:  Hold'em No Limit ($0.10/$0.25) - 2009/07/01 0:40:41 ET
Table '63h13e5p7cWe02rClZ1CHw' 6-max Seat #5 is the button
Seat 1: 7VfhiFY533nbUKvyEthASw ($14.40 in chips) 
Seat 2: k9nHZTHt8hYhYRcW8NTb4g ($10.15 in chips) 
Seat 3: 9jSiy0meE9XJKkdIZwyTEQ ($34.25 in chips) 
Seat 4: myagrRAhs0mdgmh5GNqvCw ($4.60 in chips) 
Seat 5: bE34il0XYGjWPD5/vbkMaQ ($24.30 in chips) 
Seat 6: mfrkWA3PTeYPkbO6hi98Aw ($23.10 in chips) 
mfrkWA3PTeYPkbO6hi98Aw: posts small blind $0.10
7VfhiFY533nbUKvyEthASw: posts big blind $0.25
*** HOLE CARDS ***
k9nHZTHt8hYhYRcW8NTb4g: raises $0.50 to $0.75
9jSiy0meE9XJKkdIZwyTEQ: folds 
myagrRAhs0mdgmh5GNqvCw: folds 
bE34il0XYGjWPD5/vbkMaQ: folds 
mfrkWA3PTeYPkbO6hi98Aw: folds 
7VfhiFY533nbUKvyEthASw: raises $1.25 to $2
k9nHZTHt8hYhYRcW8NTb4g: calls $1.25
*** FLOP *** [Jd Qd 5h]
7VfhiFY533nbUKvyEthASw: checks 
k9nHZTHt8hYhYRcW8NTb4g: bets $0.75
7VfhiFY533nbUKvyEthASw: calls $0.75
*** TURN *** [Jd Qd 5h] [9d]
7VfhiFY533nbUKvyEthASw: checks 
k9nHZTHt8hYhYRcW8NTb4g: bets $3.50
7VfhiFY533nbUKvyEthASw: calls $3.50
*** RIVER *** [Jd Qd 5h 9d] [3s]
7VfhiFY533nbUKvyEthASw: checks 
k9nHZTHt8hYhYRcW8NTb4g: bets $3.90 and is all-in
7VfhiFY533nbUKvyEthASw: folds 
Uncalled bet ($3.90) returned to k9nHZTHt8hYhYRcW8NTb4g
k9nHZTHt8hYhYRcW8NTb4g collected $12 from pot
k9nHZTHt8hYhYRcW8NTb4g: doesn't show hand 
*** SUMMARY ***
Total pot $12.60 | Rake $0.60 
Board [Jd Qd 5h 9d 3s]
Seat 1: 7VfhiFY533nbUKvyEthASw (big blind) folded on the River
Seat 2: k9nHZTHt8hYhYRcW8NTb4g collected ($12)
Seat 3: 9jSiy0meE9XJKkdIZwyTEQ folded before Flop (didn't bet)
Seat 4: myagrRAhs0mdgmh5GNqvCw folded before Flop (didn't bet)
Seat 5: bE34il0XYGjWPD5/vbkMaQ (button) folded before Flop (didn't bet)
Seat 6: mfrkWA3PTeYPkbO6hi98Aw (small blind) folded before Flop




PokerStars Game #59939469616:  Hold'em No Limit ($0.10/$0.25) - 2009/07/01 0:40:41 ET
Table 'RUOqTfzbAVGS5x+J9aZMHA' 9-max Seat #1 is the button
Seat 1: KBBTLXGhPdPj+4X0QKMkcg ($13.55 in chips) 
Seat 2: Z5ZtGOON8kmSdSCll9Z3XA ($6.60 in chips) 
Seat 5: opOCI2p6kW0tINuVaAqmcQ ($26.95 in chips) 
Seat 6: ljemhp25Zg+nlA9DLCIiUw ($33.45 in chips) 
Seat 8: 3RCAkueG3Vc13VpRStCB+w ($24.10 in chips) 
Z5ZtGOON8kmSdSCll9Z3XA: posts small blind $0.10
18G4P1XstjNvItdGUITxgw: is sitting out 
opOCI2p6kW0tINuVaAqmcQ: posts big blind $0.25
HxDF4QSxC4z39D7teZpprQ: sits out 
*** HOLE CARDS ***
18G4P1XstjNvItdGUITxgw leaves the table
ljemhp25Zg+nlA9DLCIiUw: calls $0.25
3RCAkueG3Vc13VpRStCB+w: folds 
KBBTLXGhPdPj+4X0QKMkcg: calls $0.25
Z5ZtGOON8kmSdSCll9Z3XA: calls $0.15
opOCI2p6kW0tINuVaAqmcQ: checks 
*** FLOP *** [2c Ah 9d]
Z5ZtGOON8kmSdSCll9Z3XA: checks 
ianfitz2008 joins the table at seat #4 
opOCI2p6kW0tINuVaAqmcQ: checks 
ljemhp25Zg+nlA9DLCIiUw: checks 
KBBTLXGhPdPj+4X0QKMkcg: checks 
*** TURN *** [2c Ah 9d] [7d]
Z5ZtGOON8kmSdSCll9Z3XA: checks 
opOCI2p6kW0tINuVaAqmcQ: checks 
ljemhp25Zg+nlA9DLCIiUw: checks 
KBBTLXGhPdPj+4X0QKMkcg: checks 
*** RIVER *** [2c Ah 9d 7d] [Ad]
mdalglish joins the table at seat #9 
Z5ZtGOON8kmSdSCll9Z3XA: checks 
opOCI2p6kW0tINuVaAqmcQ: checks 
ljemhp25Zg+nlA9DLCIiUw: checks 
KBBTLXGhPdPj+4X0QKMkcg: checks 
*** SHOW DOWN ***
Z5ZtGOON8kmSdSCll9Z3XA: shows [5s Kd] (a pair of Aces)
opOCI2p6kW0tINuVaAqmcQ: shows [9h Qd] (two pair, Aces and Nines)
ljemhp25Zg+nlA9DLCIiUw: mucks hand 
JtVGnq5doRa3PublncR+Yw joins the table at seat #3 
KBBTLXGhPdPj+4X0QKMkcg: mucks hand 
opOCI2p6kW0tINuVaAqmcQ collected $0.95 from pot
*** SUMMARY ***
Total pot $1 | Rake $0.05 
Board [2c Ah 9d 7d Ad]
Seat 1: KBBTLXGhPdPj+4X0QKMkcg (button) mucked
Seat 2: Z5ZtGOON8kmSdSCll9Z3XA (small blind) showed [5s Kd] and lost with a pair of Aces
Seat 5: opOCI2p6kW0tINuVaAqmcQ (big blind) showed [9h Qd] and won ($0.95) with two pair, Aces and Nines
Seat 6: ljemhp25Zg+nlA9DLCIiUw mucked
Seat 8: 3RCAkueG3Vc13VpRStCB+w folded before Flop (didn't bet)




PokerStars Game #59939470026:  Hold'em No Limit ($0.10/$0.25) - 2009/07/01 0:40:42 ET
Table 'vFZR6Kf2Th5xBXT9brGW6A' 6-max Seat #2 is the button
Seat 1: xRkU4+naLuz7dEZFbOn9cw ($34.95 in chips) 
Seat 2: REnO5xiZ66YabxDXq2ncvA ($51.70 in chips) 
Seat 4: 79ID/ub1Pt/mDpCprVmOoA ($25 in chips) 
Seat 5: NhUN/JpAprdJeamFBgJH1w ($25.35 in chips) 
Seat 6: d0J1xuhsynEY81YHwAvJ5g ($30.10 in chips) 
79ID/ub1Pt/mDpCprVmOoA: posts small blind $0.10
NhUN/JpAprdJeamFBgJH1w: posts big blind $0.25
*** HOLE CARDS ***
d0J1xuhsynEY81YHwAvJ5g: folds 
xRkU4+naLuz7dEZFbOn9cw: folds 
REnO5xiZ66YabxDXq2ncvA: folds 
79ID/ub1Pt/mDpCprVmOoA: raises $0.50 to $0.75
NhUN/JpAprdJeamFBgJH1w: calls $0.50
*** FLOP *** [5s Tc Kc]
79ID/ub1Pt/mDpCprVmOoA: bets $1
NhUN/JpAprdJeamFBgJH1w: folds 
Uncalled bet ($1) returned to 79ID/ub1Pt/mDpCprVmOoA
79ID/ub1Pt/mDpCprVmOoA collected $1.45 from pot
79ID/ub1Pt/mDpCprVmOoA: doesn't show hand 
*** SUMMARY ***
Total pot $1.50 | Rake $0.05 
Board [5s Tc Kc]
Seat 1: xRkU4+naLuz7dEZFbOn9cw folded before Flop (didn't bet)
Seat 2: REnO5xiZ66YabxDXq2ncvA (button) folded before Flop (didn't bet)
Seat 4: 79ID/ub1Pt/mDpCprVmOoA (small blind) collected ($1.45)
Seat 5: NhUN/JpAprdJeamFBgJH1w (big blind) folded on the Flop
Seat 6: d0J1xuhsynEY81YHwAvJ5g folded before Flop (didn't bet)




PokerStars Game #59939470516:  Hold'em No Limit ($0.10/$0.25) - 2009/07/01 0:40:42 ET
Table 'xPn6TS/y/OWkX7Qa+MUuKA' 6-max Seat #4 is the button
Seat 1: JFIAqU8lCZ0vWwEl4bdGsg ($27.25 in chips) 
Seat 2: buyjetgNT1McXtdaP4zynA ($20.15 in chips) 
Seat 3: o08wk0F4gROLhZS04Iyl3w ($26.35 in chips) 
Seat 4: SS/yfeArhULzIcOPe8MdPg ($28 in chips) 
Seat 5: I1TxPvWj8NfG8orglCinNA ($39.15 in chips) 
Seat 6: oseFhpinoe+Zg4j5xyBjyQ ($54.55 in chips) 
I1TxPvWj8NfG8orglCinNA: posts small blind $0.10
oseFhpinoe+Zg4j5xyBjyQ: posts big blind $0.25
*** HOLE CARDS ***
JFIAqU8lCZ0vWwEl4bdGsg: calls $0.25
buyjetgNT1McXtdaP4zynA: folds 
o08wk0F4gROLhZS04Iyl3w: folds 
SS/yfeArhULzIcOPe8MdPg: folds 
I1TxPvWj8NfG8orglCinNA: calls $0.15
oseFhpinoe+Zg4j5xyBjyQ: checks 
*** FLOP *** [Ac 6d 6h]
I1TxPvWj8NfG8orglCinNA: checks 
o08wk0F4gROLhZS04Iyl3w is disconnected 
oseFhpinoe+Zg4j5xyBjyQ: checks 
JFIAqU8lCZ0vWwEl4bdGsg: bets $0.75
o08wk0F4gROLhZS04Iyl3w is connected 
I1TxPvWj8NfG8orglCinNA: folds 
oseFhpinoe+Zg4j5xyBjyQ: folds 
Uncalled bet ($0.75) returned to JFIAqU8lCZ0vWwEl4bdGsg
JFIAqU8lCZ0vWwEl4bdGsg collected $0.75 from pot
JFIAqU8lCZ0vWwEl4bdGsg: doesn't show hand 
*** SUMMARY ***
Total pot $0.75 | Rake $0 
Board [Ac 6d 6h]
Seat 1: JFIAqU8lCZ0vWwEl4bdGsg collected ($0.75)
Seat 2: buyjetgNT1McXtdaP4zynA folded before Flop (didn't bet)
Seat 3: o08wk0F4gROLhZS04Iyl3w folded before Flop (didn't bet)
Seat 4: SS/yfeArhULzIcOPe8MdPg (button) folded before Flop (didn't bet)
Seat 5: I1TxPvWj8NfG8orglCinNA (small blind) folded on the Flop
Seat 6: oseFhpinoe+Zg4j5xyBjyQ (big blind) folded on the Flop




PokerStars Game #59939470064:  Hold'em No Limit ($0.10/$0.25) - 2009/07/01 0:40:42 ET
Table '/AhP8uWRzEEhOATYIdmn0A' 9-max Seat #6 is the button
Seat 1: +sbyWwIcFp9kP0bDtMegfQ ($23.75 in chips) 
Seat 2: nvWCCH1JBjMjQkSaXl2Mog ($17.30 in chips) 
Seat 3: vSkQm2EelzwRGDDQQk0Fqw ($4.65 in chips) 
Seat 5: BEIBUu2pIflPrCL+Iks4CQ ($13.50 in chips) 
Seat 6: 1K6QGyJP9P9xmRac2fH4OQ ($25 in chips) 
Seat 7: 4oA316mXLIui1QY63GXBUg ($25 in chips) 
Seat 8: CYkY0dNBaYaKs8HVCVn3mQ ($5 in chips) 
Seat 9: DIBbjEYGs+TVdVgEB/4+3w ($29.25 in chips) 
4oA316mXLIui1QY63GXBUg: posts small blind $0.10
CYkY0dNBaYaKs8HVCVn3mQ: posts big blind $0.25
*** HOLE CARDS ***
DIBbjEYGs+TVdVgEB/4+3w: folds 
+sbyWwIcFp9kP0bDtMegfQ: folds 
nvWCCH1JBjMjQkSaXl2Mog: folds 
vSkQm2EelzwRGDDQQk0Fqw: folds 
BEIBUu2pIflPrCL+Iks4CQ: folds 
1K6QGyJP9P9xmRac2fH4OQ: raises $0.75 to $1
4oA316mXLIui1QY63GXBUg: folds 
CYkY0dNBaYaKs8HVCVn3mQ: folds 
Uncalled bet ($0.75) returned to 1K6QGyJP9P9xmRac2fH4OQ
1K6QGyJP9P9xmRac2fH4OQ collected $0.60 from pot
1K6QGyJP9P9xmRac2fH4OQ: doesn't show hand 
*** SUMMARY ***
Total pot $0.60 | Rake $0 
Seat 1: +sbyWwIcFp9kP0bDtMegfQ folded before Flop (didn't bet)
Seat 2: nvWCCH1JBjMjQkSaXl2Mog folded before Flop (didn't bet)
Seat 3: vSkQm2EelzwRGDDQQk0Fqw folded before Flop (didn't bet)
Seat 5: BEIBUu2pIflPrCL+Iks4CQ folded before Flop (didn't bet)
Seat 6: 1K6QGyJP9P9xmRac2fH4OQ (button) collected ($0.60)
Seat 7: 4oA316mXLIui1QY63GXBUg (small blind) folded before Flop
Seat 8: CYkY0dNBaYaKs8HVCVn3mQ (big blind) folded before Flop
Seat 9: DIBbjEYGs+TVdVgEB/4+3w folded before Flop (didn't bet)




PokerStars Game #59939470822:  Hold'em No Limit ($0.10/$0.25) - 2009/07/01 0:40:43 ET
Table 'T/iCKJXGphRN3xcdwfE/JQJYkCJJ5Iv+Tu52jx2lpEcgSeat #9 is the button
Seat 1: Yv4fucyyT28mjx8V5lxKJg ($29.40 in chips) 
Seat 2: hBMUlEpyU74r/fwDgIpXjQ ($35.60 in chips) 
Seat 3: Z5ZtGOON8kmSdSCll9Z3XA ($8 in chips) 
Seat 5: 6OVSxS1KoddUCYNkZ4hREw ($28.60 in chips) 
Seat 6: OiV1PWZ3IkN29JlmCcnTwQ ($5 in chips) 
Seat 7: N6fYvIzQLKaydFLKQGtMlQ ($24.90 in chips) 
Seat 8: COsrwJSFHQtxlUcrYtDQPQ ($25 in chips) 
Seat 9: H9KUl8cmpLgEpOVDA00bCg ($5.15 in chips) 
Yv4fucyyT28mjx8V5lxKJg: posts small blind $0.10
hBMUlEpyU74r/fwDgIpXjQ: posts big blind $0.25
*** HOLE CARDS ***
Z5ZtGOON8kmSdSCll9Z3XA: calls $0.25
6OVSxS1KoddUCYNkZ4hREw: folds 
OiV1PWZ3IkN29JlmCcnTwQ: folds 
N6fYvIzQLKaydFLKQGtMlQ: folds 
COsrwJSFHQtxlUcrYtDQPQ: folds 
H9KUl8cmpLgEpOVDA00bCg: folds 
Yv4fucyyT28mjx8V5lxKJg: calls $0.15
hBMUlEpyU74r/fwDgIpXjQ: checks 
*** FLOP *** [9c 7d 8c]
Yv4fucyyT28mjx8V5lxKJg: bets $1.75
hBMUlEpyU74r/fwDgIpXjQ: folds 
Z5ZtGOON8kmSdSCll9Z3XA: folds 
Uncalled bet ($1.75) returned to Yv4fucyyT28mjx8V5lxKJg
Yv4fucyyT28mjx8V5lxKJg collected $0.75 from pot
Yv4fucyyT28mjx8V5lxKJg: doesn't show hand 
*** SUMMARY ***
Total pot $0.75 | Rake $0 
Board [9c 7d 8c]
Seat 1: Yv4fucyyT28mjx8V5lxKJg (small blind) collected ($0.75)
Seat 2: hBMUlEpyU74r/fwDgIpXjQ (big blind) folded on the Flop
Seat 3: Z5ZtGOON8kmSdSCll9Z3XA folded on the Flop
Seat 5: 6OVSxS1KoddUCYNkZ4hREw folded before Flop (didn't bet)
Seat 6: OiV1PWZ3IkN29JlmCcnTwQ folded before Flop (didn't bet)
Seat 7: N6fYvIzQLKaydFLKQGtMlQ folded before Flop (didn't bet)
Seat 8: COsrwJSFHQtxlUcrYtDQPQ folded before Flop (didn't bet)
Seat 9: H9KUl8cmpLgEpOVDA00bCg (button) folded before Flop (didn't bet)




PokerStars Game #59939470740:  Hold'em No Limit ($0.10/$0.25) - 2009/07/01 0:40:43 ET
Table 'WjNvuuSgTjm8jh0j9vcCgQ' 9-max Seat #1 is the button
Seat 1: NKymidkL3Kg3ILZPvtLSVg ($10 in chips) 
Seat 2: 9gmYYQesalMrUjaF7nKfrQ ($9.75 in chips) 
Seat 3: 8B/dhbQjIWe6ASCdgzktNQ ($25 in chips) 
Seat 4: 3PjJjazzeHcM4mbFeXmZBg ($20.20 in chips) 
Seat 5: Qi+clOtyDiibLdH2/1Qy8g ($18.10 in chips) 
Seat 7: DdPXdieucQ+n99u1n3A+rQ ($4.65 in chips) 
Seat 8: ghNKXUBl/H+t83JF079ZBA ($25 in chips) 
Seat 9: DiSvPC2iudwL5j9u6Huyww ($30.05 in chips) 
9gmYYQesalMrUjaF7nKfrQ: posts small blind $0.10
8B/dhbQjIWe6ASCdgzktNQ: posts big blind $0.25
*** HOLE CARDS ***
3PjJjazzeHcM4mbFeXmZBg: folds 
3PjJjazzeHcM4mbFeXmZBg leaves the table
Qi+clOtyDiibLdH2/1Qy8g: folds 
DdPXdieucQ+n99u1n3A+rQ: folds 
ghNKXUBl/H+t83JF079ZBA: raises $0.75 to $1
DiSvPC2iudwL5j9u6Huyww: folds 
NKymidkL3Kg3ILZPvtLSVg: folds 
9gmYYQesalMrUjaF7nKfrQ: folds 
8B/dhbQjIWe6ASCdgzktNQ: folds 
Uncalled bet ($0.75) returned to ghNKXUBl/H+t83JF079ZBA
ghNKXUBl/H+t83JF079ZBA collected $0.60 from pot
ghNKXUBl/H+t83JF079ZBA: doesn't show hand 
*** SUMMARY ***
Total pot $0.60 | Rake $0 
Seat 1: NKymidkL3Kg3ILZPvtLSVg (button) folded before Flop (didn't bet)
Seat 2: 9gmYYQesalMrUjaF7nKfrQ (small blind) folded before Flop
Seat 3: 8B/dhbQjIWe6ASCdgzktNQ (big blind) folded before Flop
Seat 4: 3PjJjazzeHcM4mbFeXmZBg folded before Flop (didn't bet)
Seat 5: Qi+clOtyDiibLdH2/1Qy8g folded before Flop (didn't bet)
Seat 7: DdPXdieucQ+n99u1n3A+rQ folded before Flop (didn't bet)
Seat 8: ghNKXUBl/H+t83JF079ZBA collected ($0.60)
Seat 9: DiSvPC2iudwL5j9u6Huyww folded before Flop (didn't bet)




PokerStars Game #59939471084:  Hold'em No Limit ($0.10/$0.25) - 2009/07/01 0:40:43 ET
Table 'XX2OuOsa8/8AC+/mR/Az6g' 9-max Seat #9 is the button
Seat 1: 56S3mA6Zs3pGR+0p0vUCtg ($24.75 in chips) 
Seat 2: MIVCHqCqqlke0Lb0z7glcw ($24.65 in chips) 
Seat 3: PJJTm/ccITEBlwPReiBTwg ($13 in chips) 
Seat 4: uLP/lYn7oKq9xCChBXsXxw ($24.75 in chips) 
Seat 5: jXz58rvCgq0VjyVjUBf2mw ($24.05 in chips) 
Seat 6: gT0nY7XiR+2FA+B3F4h8HQ ($25.35 in chips) 
Seat 7: zDrucyjVn5aeekNEc3cJrA ($20.70 in chips) 
Seat 9: 86vbuhJsyH+nbEg5qpDLyQ ($43.45 in chips) 
56S3mA6Zs3pGR+0p0vUCtg: posts small blind $0.10
MIVCHqCqqlke0Lb0z7glcw: posts big blind $0.25
qwr38jl5txoR36M7G5qi4A: sits out 
*** HOLE CARDS ***
PJJTm/ccITEBlwPReiBTwg: folds 
uLP/lYn7oKq9xCChBXsXxw: folds 
jXz58rvCgq0VjyVjUBf2mw: folds 
gT0nY7XiR+2FA+B3F4h8HQ: folds 
zDrucyjVn5aeekNEc3cJrA: calls $0.25
86vbuhJsyH+nbEg5qpDLyQ: folds 
56S3mA6Zs3pGR+0p0vUCtg: calls $0.15
MIVCHqCqqlke0Lb0z7glcw: checks 
*** FLOP *** [6d 9d Ts]
56S3mA6Zs3pGR+0p0vUCtg: bets $0.50
MIVCHqCqqlke0Lb0z7glcw: calls $0.50
zDrucyjVn5aeekNEc3cJrA: folds 
*** TURN *** [6d 9d Ts] [Js]
56S3mA6Zs3pGR+0p0vUCtg: bets $1
MIVCHqCqqlke0Lb0z7glcw: folds 
Uncalled bet ($1) returned to 56S3mA6Zs3pGR+0p0vUCtg
56S3mA6Zs3pGR+0p0vUCtg collected $1.70 from pot
56S3mA6Zs3pGR+0p0vUCtg: doesn't show hand 
*** SUMMARY ***
Total pot $1.75 | Rake $0.05 
Board [6d 9d Ts Js]
Seat 1: 56S3mA6Zs3pGR+0p0vUCtg (small blind) collected ($1.70)
Seat 2: MIVCHqCqqlke0Lb0z7glcw (big blind) folded on the Turn
Seat 3: PJJTm/ccITEBlwPReiBTwg folded before Flop (didn't bet)
Seat 4: uLP/lYn7oKq9xCChBXsXxw folded before Flop (didn't bet)
Seat 5: jXz58rvCgq0VjyVjUBf2mw folded before Flop (didn't bet)
Seat 6: gT0nY7XiR+2FA+B3F4h8HQ folded before Flop (didn't bet)
Seat 7: zDrucyjVn5aeekNEc3cJrA folded on the Flop
Seat 9: 86vbuhJsyH+nbEg5qpDLyQ (button) folded before Flop (didn't bet)




PokerStars Game #59939470676:  Hold'em No Limit ($0.10/$0.25) - 2009/07/01 0:40:43 ET
Table 'jxoHy9yJy0bbH/Qx73FoPA' 9-max Seat #7 is the button
Seat 1: jN7A9nKK4RYzhFj4MrekhA ($14.85 in chips) 
Seat 3: /DYYmfrw4B9z+N2z81dNtA ($20.70 in chips) 
Seat 4: RJ/x9oZtt1RZLaJEQwZOxQ ($27.40 in chips) 
Seat 5: vO3QVRovWemcGMkm7ijAIA ($4.30 in chips) 
Seat 6: tYsOBqdU1+x+yFI7zHO7hQ ($51.90 in chips) 
Seat 7: HhlCy99+up/IQbbuxF6uXg ($8.45 in chips) 
Seat 8: hBMUlEpyU74r/fwDgIpXjQ ($30.35 in chips) 
Seat 9: IG1d4tXnNA98OKRYYE3l+A ($54.20 in chips) 
hBMUlEpyU74r/fwDgIpXjQ: posts small blind $0.10
IG1d4tXnNA98OKRYYE3l+A: posts big blind $0.25
F7pnn6czNpHvRM55XcA2EA: sits out 
*** HOLE CARDS ***
jN7A9nKK4RYzhFj4MrekhA: folds 
/DYYmfrw4B9z+N2z81dNtA: raises $0.25 to $0.50
RJ/x9oZtt1RZLaJEQwZOxQ: calls $0.50
vO3QVRovWemcGMkm7ijAIA: calls $0.50
tYsOBqdU1+x+yFI7zHO7hQ: folds 
HhlCy99+up/IQbbuxF6uXg: folds 
hBMUlEpyU74r/fwDgIpXjQ: folds 
IG1d4tXnNA98OKRYYE3l+A: calls $0.25
*** FLOP *** [Kc 5d 8h]
IG1d4tXnNA98OKRYYE3l+A: checks 
/DYYmfrw4B9z+N2z81dNtA: checks 
RJ/x9oZtt1RZLaJEQwZOxQ: checks 
vO3QVRovWemcGMkm7ijAIA: checks 
*** TURN *** [Kc 5d 8h] [Kh]
IG1d4tXnNA98OKRYYE3l+A: checks 
/DYYmfrw4B9z+N2z81dNtA: bets $2.50
RJ/x9oZtt1RZLaJEQwZOxQ: folds 
vO3QVRovWemcGMkm7ijAIA: folds 
IG1d4tXnNA98OKRYYE3l+A: folds 
Uncalled bet ($2.50) returned to /DYYmfrw4B9z+N2z81dNtA
/DYYmfrw4B9z+N2z81dNtA collected $2 from pot
*** SUMMARY ***
Total pot $2.10 | Rake $0.10 
Board [Kc 5d 8h Kh]
Seat 1: jN7A9nKK4RYzhFj4MrekhA folded before Flop (didn't bet)
Seat 3: /DYYmfrw4B9z+N2z81dNtA collected ($2)
Seat 4: RJ/x9oZtt1RZLaJEQwZOxQ folded on the Turn
Seat 5: vO3QVRovWemcGMkm7ijAIA folded on the Turn
Seat 6: tYsOBqdU1+x+yFI7zHO7hQ folded before Flop (didn't bet)
Seat 7: HhlCy99+up/IQbbuxF6uXg (button) folded before Flop (didn't bet)
Seat 8: hBMUlEpyU74r/fwDgIpXjQ (small blind) folded before Flop
Seat 9: IG1d4tXnNA98OKRYYE3l+A (big blind) folded on the Turn




PokerStars Game #59939470914:  Hold'em No Limit ($0.10/$0.25) - 2009/07/01 0:40:43 ET
Table '6wawJ+MkkvuC3coG6r+Yhg' 6-max Seat #2 is the button
Seat 1: ELW+DKizJhLK7k40PMkD2Q ($24.90 in chips) 
Seat 2: LtASJ9OlkqGrrUKGQlpGAw ($27.40 in chips) 
Seat 3: KYBwVA7jgmSrbIEbEGElVg ($20.35 in chips) 
Seat 4: cS21pIxRHx5Gt42o7hPZzw ($12.75 in chips) 
Seat 5: A8uIskXJTblhVXWuYr+lkw ($15.15 in chips) 
Seat 6: oOGZlBAhqtG/HczLL/KLRQ ($15.40 in chips) 
KYBwVA7jgmSrbIEbEGElVg: posts small blind $0.10
cS21pIxRHx5Gt42o7hPZzw: posts big blind $0.25
*** HOLE CARDS ***
A8uIskXJTblhVXWuYr+lkw: folds 
oOGZlBAhqtG/HczLL/KLRQ: calls $0.25
ELW+DKizJhLK7k40PMkD2Q: folds 
LtASJ9OlkqGrrUKGQlpGAw: folds 
KYBwVA7jgmSrbIEbEGElVg: calls $0.15
cS21pIxRHx5Gt42o7hPZzw: checks 
*** FLOP *** [Ac 6h 3s]
KYBwVA7jgmSrbIEbEGElVg: checks 
cS21pIxRHx5Gt42o7hPZzw: checks 
oOGZlBAhqtG/HczLL/KLRQ: bets $0.75
KYBwVA7jgmSrbIEbEGElVg: calls $0.75
cS21pIxRHx5Gt42o7hPZzw: folds 
*** TURN *** [Ac 6h 3s] [Qs]
KYBwVA7jgmSrbIEbEGElVg: bets $0.75
oOGZlBAhqtG/HczLL/KLRQ: calls $0.75
*** RIVER *** [Ac 6h 3s Qs] [5s]
KYBwVA7jgmSrbIEbEGElVg: bets $2
oOGZlBAhqtG/HczLL/KLRQ: raises $3 to $5
KYBwVA7jgmSrbIEbEGElVg: folds 
Uncalled bet ($3) returned to oOGZlBAhqtG/HczLL/KLRQ
oOGZlBAhqtG/HczLL/KLRQ collected $7.40 from pot
oOGZlBAhqtG/HczLL/KLRQ: doesn't show hand 
*** SUMMARY ***
Total pot $7.75 | Rake $0.35 
Board [Ac 6h 3s Qs 5s]
Seat 1: ELW+DKizJhLK7k40PMkD2Q folded before Flop (didn't bet)
Seat 2: LtASJ9OlkqGrrUKGQlpGAw (button) folded before Flop (didn't bet)
Seat 3: KYBwVA7jgmSrbIEbEGElVg (small blind) folded on the River
Seat 4: cS21pIxRHx5Gt42o7hPZzw (big blind) folded on the Flop
Seat 5: A8uIskXJTblhVXWuYr+lkw folded before Flop (didn't bet)
Seat 6: oOGZlBAhqtG/HczLL/KLRQ collected ($7.40)




PokerStars Game #59939471076:  Hold'em No Limit ($0.10/$0.25) - 2009/07/01 0:40:43 ET
Table 'ORSZkZqq+7Ja2PdeCFAytA' 9-max Seat #1 is the button
Seat 1: Gpa8cld5y0mdOomHJgHhlA ($8.75 in chips) 
Seat 2: yduPKWPzL8YlT5Zv/Nmrwg ($9.75 in chips) 
Seat 3: nm4Dj/f+jJEwKVsUnKh73g ($24.75 in chips) 
Seat 4: b8t3jWrxzeEt9HtZtc9wUQ ($26.45 in chips) 
Seat 5: tYsOBqdU1+x+yFI7zHO7hQ ($31.30 in chips) 
Seat 8: opOCI2p6kW0tINuVaAqmcQ ($41.40 in chips) 
yduPKWPzL8YlT5Zv/Nmrwg: posts small blind $0.10
nm4Dj/f+jJEwKVsUnKh73g: posts big blind $0.25
*** HOLE CARDS ***
b8t3jWrxzeEt9HtZtc9wUQ: folds 
tYsOBqdU1+x+yFI7zHO7hQ: folds 
opOCI2p6kW0tINuVaAqmcQ: folds 
Gpa8cld5y0mdOomHJgHhlA: raises $0.50 to $0.75
yduPKWPzL8YlT5Zv/Nmrwg: calls $0.65
nm4Dj/f+jJEwKVsUnKh73g: folds 
*** FLOP *** [Ad 5d 9h]
yduPKWPzL8YlT5Zv/Nmrwg: bets $9 and is all-in
b8t3jWrxzeEt9HtZtc9wUQ leaves the table
Gpa8cld5y0mdOomHJgHhlA: folds 
Uncalled bet ($9) returned to yduPKWPzL8YlT5Zv/Nmrwg
yduPKWPzL8YlT5Zv/Nmrwg collected $1.70 from pot
yduPKWPzL8YlT5Zv/Nmrwg: doesn't show hand 
*** SUMMARY ***
Total pot $1.75 | Rake $0.05 
Board [Ad 5d 9h]
Seat 1: Gpa8cld5y0mdOomHJgHhlA (button) folded on the Flop
Seat 2: yduPKWPzL8YlT5Zv/Nmrwg (small blind) collected ($1.70)
Seat 3: nm4Dj/f+jJEwKVsUnKh73g (big blind) folded before Flop
Seat 4: b8t3jWrxzeEt9HtZtc9wUQ folded before Flop (didn't bet)
Seat 5: tYsOBqdU1+x+yFI7zHO7hQ folded before Flop (didn't bet)
Seat 8: opOCI2p6kW0tINuVaAqmcQ folded before Flop (didn't bet)




PokerStars Game #59939470950:  Hold'em No Limit ($0.10/$0.25) - 2009/07/01 0:40:43 ET
Table 'VuY5ej47Cy8nOI3Wogmhzw' 6-max Seat #4 is the button
Seat 1: aXzmR7FhrqQSWNNmNfbVnw ($20 in chips) 
Seat 4: FC6tJ9EOiutXO8hnpR4VgQ ($6.90 in chips) 
Seat 6: +v0nBUereMsRzYp2Knh/cQ ($12.50 in chips) 
+v0nBUereMsRzYp2Knh/cQ: posts small blind $0.10
aXzmR7FhrqQSWNNmNfbVnw: posts big blind $0.25
*** HOLE CARDS ***
FC6tJ9EOiutXO8hnpR4VgQ: folds 
0n9nsjvz4GIG4IyVHT0JVw leaves the table
FC6tJ9EOiutXO8hnpR4VgQ said, "be out"
+v0nBUereMsRzYp2Knh/cQ: folds 
Uncalled bet ($0.15) returned to aXzmR7FhrqQSWNNmNfbVnw
aXzmR7FhrqQSWNNmNfbVnw collected $0.20 from pot
aXzmR7FhrqQSWNNmNfbVnw: doesn't show hand 
*** SUMMARY ***
Total pot $0.20 | Rake $0 
Seat 1: aXzmR7FhrqQSWNNmNfbVnw (big blind) collected ($0.20)
Seat 4: FC6tJ9EOiutXO8hnpR4VgQ (button) folded before Flop (didn't bet)
Seat 6: +v0nBUereMsRzYp2Knh/cQ (small blind) folded before Flop




PokerStars Game #59939470774:  Hold'em No Limit ($0.10/$0.25) - 2009/07/01 0:40:43 ET
Table 'z2yOdY2zyGWG1gh9WV9XtQdYNvO8G5kw5SRxb1Dljhog Seat #5 is the button
Seat 1: Z3dcuTANgdUb/J4unoGPFQ ($16.35 in chips) 
Seat 2: vEBWvFD+KUWgDBKZKvA3SA ($4.50 in chips) 
Seat 3: 1Cs1GyQcoM1omwY7XZ3uRg ($15.10 in chips) 
Seat 5: W7XGvw6ngGVq2hFwXk8Myg ($16.40 in chips) 
Seat 7: DiSvPC2iudwL5j9u6Huyww ($25.25 in chips) 
Seat 8: 5hAPbqNrvJb8PtLiceXtlg6HoFYfVGBefsR5Vrz62qIw4.75 in chips) 
Seat 9: sUVgUtgbfVx6JpvApozwhQ ($5 in chips) 
uH1RN27w9SKa7TpVR9EFrQ will be allowed to play after the button
DiSvPC2iudwL5j9u6Huyww: posts small blind $0.10
5hAPbqNrvJb8PtLiceXtlg6HoFYfVGBefsR5Vrz62qIwsts big blind $0.25
sD+TKtt36XiiN6jqHiLwDA: sits out 
*** HOLE CARDS ***
sUVgUtgbfVx6JpvApozwhQ: folds 
Z3dcuTANgdUb/J4unoGPFQ: calls $0.25
vEBWvFD+KUWgDBKZKvA3SA: calls $0.25
1Cs1GyQcoM1omwY7XZ3uRg: calls $0.25
W7XGvw6ngGVq2hFwXk8Myg: folds 
DiSvPC2iudwL5j9u6Huyww: calls $0.15
5hAPbqNrvJb8PtLiceXtlg6HoFYfVGBefsR5Vrz62qIwecks 
*** FLOP *** [2s 3s 6d]
DiSvPC2iudwL5j9u6Huyww: bets $0.75
5hAPbqNrvJb8PtLiceXtlg6HoFYfVGBefsR5Vrz62qIwlds 
Z3dcuTANgdUb/J4unoGPFQ: calls $0.75
vEBWvFD+KUWgDBKZKvA3SA: folds 
1Cs1GyQcoM1omwY7XZ3uRg: folds 
*** TURN *** [2s 3s 6d] [9h]
DiSvPC2iudwL5j9u6Huyww: bets $1.50
Z3dcuTANgdUb/J4unoGPFQ: raises $1.50 to $3
DiSvPC2iudwL5j9u6Huyww: raises $21.25 to $24.25 and is all-in
Z3dcuTANgdUb/J4unoGPFQ: calls $12.35 and is all-in
Uncalled bet ($8.90) returned to DiSvPC2iudwL5j9u6Huyww
*** RIVER *** [2s 3s 6d 9h] [8d]
*** SHOW DOWN ***
DiSvPC2iudwL5j9u6Huyww: shows [6s 6h] (three of a kind, Sixes)
Z3dcuTANgdUb/J4unoGPFQ: mucks hand 
DiSvPC2iudwL5j9u6Huyww collected $31.80 from pot
*** SUMMARY ***
Total pot $33.45 | Rake $1.65 
Board [2s 3s 6d 9h 8d]
Seat 1: Z3dcuTANgdUb/J4unoGPFQ mucked
Seat 2: vEBWvFD+KUWgDBKZKvA3SA folded on the Flop
Seat 3: 1Cs1GyQcoM1omwY7XZ3uRg folded on the Flop
Seat 5: W7XGvw6ngGVq2hFwXk8Myg (button) folded before Flop (didn't bet)
Seat 7: DiSvPC2iudwL5j9u6Huyww (small blind) showed [6s 6h] and won ($31.80) with three of a kind, Sixes
Seat 8: 5hAPbqNrvJb8PtLiceXtlg6HoFYfVGBefsR5Vrz62qIwg blind) folded on the Flop
Seat 9: sUVgUtgbfVx6JpvApozwhQ folded before Flop (didn't bet)




PokerStars Game #59939471472:  Hold'em No Limit ($0.10/$0.25) - 2009/07/01 0:40:44 ET
Table '2O5CgfSkSwrr4PDrlZ1RLQ' 6-max Seat #4 is the button
Seat 1: kyRaCIljYA6l33lSKQfNsg ($47.60 in chips) 
Seat 2: /gJNBeCkWL4o85/jvlZ4BA ($49.75 in chips) 
Seat 3: yzFNNFIfC89bBPwpFPx2ow ($25 in chips) 
Seat 4: 4x9jCqgSw4272dnaIqnanw ($11.50 in chips) 
Seat 5: AMrBn4Vx9aAo/vv6WHLk6w ($2.65 in chips) 
Seat 6: tj9xqoqQaDaFw7u1oyZrtA ($25 in chips) 
AMrBn4Vx9aAo/vv6WHLk6w: posts small blind $0.10
tj9xqoqQaDaFw7u1oyZrtA: posts big blind $0.25
*** HOLE CARDS ***
kyRaCIljYA6l33lSKQfNsg: folds 
/gJNBeCkWL4o85/jvlZ4BA: folds 
yzFNNFIfC89bBPwpFPx2ow: folds 
4x9jCqgSw4272dnaIqnanw: folds 
AMrBn4Vx9aAo/vv6WHLk6w: folds 
Uncalled bet ($0.15) returned to tj9xqoqQaDaFw7u1oyZrtA
tj9xqoqQaDaFw7u1oyZrtA collected $0.20 from pot
*** SUMMARY ***
Total pot $0.20 | Rake $0 
Seat 1: kyRaCIljYA6l33lSKQfNsg folded before Flop (didn't bet)
Seat 2: /gJNBeCkWL4o85/jvlZ4BA folded before Flop (didn't bet)
Seat 3: yzFNNFIfC89bBPwpFPx2ow folded before Flop (didn't bet)
Seat 4: 4x9jCqgSw4272dnaIqnanw (button) folded before Flop (didn't bet)
Seat 5: AMrBn4Vx9aAo/vv6WHLk6w (small blind) folded before Flop
Seat 6: tj9xqoqQaDaFw7u1oyZrtA (big blind) collected ($0.20)




PokerStars Game #59939471364:  Hold'em No Limit ($0.10/$0.25) - 2009/07/01 0:40:44 ET
Table 'FE/j6VqBY4j9Uq+VHURQCQ' 6-max Seat #1 is the button
Seat 1: wKFJ513ucluNNiMlkXcDOQ ($43.75 in chips) 
Seat 2: 3zD3qLXT1bEffAoWGnc7wg ($25 in chips) 
Seat 3: Zijzy/UtPWzWVUo81HHVjQ ($49.75 in chips) 
Seat 4: cPO/1/dTcZpLkQFm3jH3Rg ($25.35 in chips) 
Seat 5: wsP46AGpqDjHZQmlRHKa9g ($25.35 in chips) 
Seat 6: kARKwAmU6kWJfiSICTYhVw ($14.35 in chips) 
3zD3qLXT1bEffAoWGnc7wg: posts small blind $0.10
Zijzy/UtPWzWVUo81HHVjQ: posts big blind $0.25
*** HOLE CARDS ***
cPO/1/dTcZpLkQFm3jH3Rg: folds 
wsP46AGpqDjHZQmlRHKa9g: folds 
kARKwAmU6kWJfiSICTYhVw: folds 
wKFJ513ucluNNiMlkXcDOQ: folds 
3zD3qLXT1bEffAoWGnc7wg: folds 
Uncalled bet ($0.15) returned to Zijzy/UtPWzWVUo81HHVjQ
Zijzy/UtPWzWVUo81HHVjQ collected $0.20 from pot
Zijzy/UtPWzWVUo81HHVjQ: doesn't show hand 
*** SUMMARY ***
Total pot $0.20 | Rake $0 
Seat 1: wKFJ513ucluNNiMlkXcDOQ (button) folded before Flop (didn't bet)
Seat 2: 3zD3qLXT1bEffAoWGnc7wg (small blind) folded before Flop
Seat 3: Zijzy/UtPWzWVUo81HHVjQ (big blind) collected ($0.20)
Seat 4: cPO/1/dTcZpLkQFm3jH3Rg folded before Flop (didn't bet)
Seat 5: wsP46AGpqDjHZQmlRHKa9g folded before Flop (didn't bet)
Seat 6: kARKwAmU6kWJfiSICTYhVw folded before Flop (didn't bet)




PokerStars Game #59939471476:  Hold'em No Limit ($0.10/$0.25) - 2009/07/01 0:40:44 ET
Table 'QegsWX65l3n/K0A8XB78yg' 6-max Seat #4 is the button
Seat 1: 8ClCHtFXGNplITm+63KB+Q ($29.30 in chips) 
Seat 2: GC/9yVD59DUCX7hUI7gcLw ($32.55 in chips) 
Seat 3: 9jSiy0meE9XJKkdIZwyTEQ ($25 in chips) 
Seat 4: kyRaCIljYA6l33lSKQfNsg ($24.65 in chips) 
Seat 5: 4YSTu0Cdzpppe1lUgCZGCQ ($56 in chips) 
Seat 6: JE/wJXmjw3bpdmjwvh2pcg ($37.50 in chips) 
4YSTu0Cdzpppe1lUgCZGCQ: posts small blind $0.10
JE/wJXmjw3bpdmjwvh2pcg: posts big blind $0.25
*** HOLE CARDS ***
8ClCHtFXGNplITm+63KB+Q: folds 
GC/9yVD59DUCX7hUI7gcLw: raises $0.75 to $1
9jSiy0meE9XJKkdIZwyTEQ: folds 
kyRaCIljYA6l33lSKQfNsg: folds 
4YSTu0Cdzpppe1lUgCZGCQ: folds 
JE/wJXmjw3bpdmjwvh2pcg: folds 
Uncalled bet ($0.75) returned to GC/9yVD59DUCX7hUI7gcLw
GC/9yVD59DUCX7hUI7gcLw collected $0.60 from pot
*** SUMMARY ***
Total pot $0.60 | Rake $0 
Seat 1: 8ClCHtFXGNplITm+63KB+Q folded before Flop (didn't bet)
Seat 2: GC/9yVD59DUCX7hUI7gcLw collected ($0.60)
Seat 3: 9jSiy0meE9XJKkdIZwyTEQ folded before Flop (didn't bet)
Seat 4: kyRaCIljYA6l33lSKQfNsg (button) folded before Flop (didn't bet)
Seat 5: 4YSTu0Cdzpppe1lUgCZGCQ (small blind) folded before Flop
Seat 6: JE/wJXmjw3bpdmjwvh2pcg (big blind) folded before Flop




PokerStars Game #59939471722:  Hold'em No Limit ($0.10/$0.25) - 2009/07/01 0:40:44 ET
Table 'zgAizkhIUPUrfr6LqN3ifw' 9-max Seat #1 is the button
Seat 1: st9jtdNbm1W5GfBwRaCVqQ ($24.90 in chips) 
Seat 2: s7Q6uNouhe7aE8JdFb9E+A ($26.35 in chips) 
Seat 3: hZuGwtYmFKPmQ+v1wlmdfA ($23.10 in chips) 
Seat 7: 1S/fpm+f42V/6MNZre+ccg ($25 in chips) 
Seat 8: MIVCHqCqqlke0Lb0z7glcw ($24.15 in chips) 
Seat 9: SXqVW4Q0evTUVZG6BbUNIA ($39.30 in chips) 
s7Q6uNouhe7aE8JdFb9E+A: posts small blind $0.10
hZuGwtYmFKPmQ+v1wlmdfA: posts big blind $0.25
DdPXdieucQ+n99u1n3A+rQ: sits out 
TeWJxSETzbXGiYKx0y+dtg: sits out 
*** HOLE CARDS ***
1S/fpm+f42V/6MNZre+ccg: folds 
MIVCHqCqqlke0Lb0z7glcw: folds 
SXqVW4Q0evTUVZG6BbUNIA: folds 
st9jtdNbm1W5GfBwRaCVqQ: raises $0.75 to $1
s7Q6uNouhe7aE8JdFb9E+A: folds 
hZuGwtYmFKPmQ+v1wlmdfA: folds 
Uncalled bet ($0.75) returned to st9jtdNbm1W5GfBwRaCVqQ
st9jtdNbm1W5GfBwRaCVqQ collected $0.60 from pot
st9jtdNbm1W5GfBwRaCVqQ: doesn't show hand 
*** SUMMARY ***
Total pot $0.60 | Rake $0 
Seat 1: st9jtdNbm1W5GfBwRaCVqQ (button) collected ($0.60)
Seat 2: s7Q6uNouhe7aE8JdFb9E+A (small blind) folded before Flop
Seat 3: hZuGwtYmFKPmQ+v1wlmdfA (big blind) folded before Flop
Seat 7: 1S/fpm+f42V/6MNZre+ccg folded before Flop (didn't bet)
Seat 8: MIVCHqCqqlke0Lb0z7glcw folded before Flop (didn't bet)
Seat 9: SXqVW4Q0evTUVZG6BbUNIA folded before Flop (didn't bet)




PokerStars Game #59939471480:  Hold'em No Limit ($0.10/$0.25) - 2009/07/01 0:40:44 ET
Table 'FgLmv9bi/fJP8ldfbTOpkg' 9-max Seat #7 is the button
Seat 1: opOCI2p6kW0tINuVaAqmcQ ($25.35 in chips) 
Seat 2: mpsfNtnMVDqQHTe92AhIdw ($18.65 in chips) 
Seat 4: WfS0TjI8FyLemNTOo1e9qA ($23.90 in chips) 
Seat 6: oKO7b50N6TzXbPBr/mcrUA ($32.35 in chips) 
Seat 7: eFrBtVXGVoMq1UwCDg8Exg ($24.65 in chips) 
Seat 8: sJNHTWcSlLHRCZ9+YRLLqA ($25 in chips) 
sJNHTWcSlLHRCZ9+YRLLqA: posts small blind $0.10
opOCI2p6kW0tINuVaAqmcQ: posts big blind $0.25
*** HOLE CARDS ***
mpsfNtnMVDqQHTe92AhIdw: raises $0.50 to $0.75
WfS0TjI8FyLemNTOo1e9qA: calls $0.75
oKO7b50N6TzXbPBr/mcrUA: folds 
eFrBtVXGVoMq1UwCDg8Exg: folds 
sJNHTWcSlLHRCZ9+YRLLqA: folds 
opOCI2p6kW0tINuVaAqmcQ: folds 
*** FLOP *** [5c 3h 4c]
mpsfNtnMVDqQHTe92AhIdw: bets $1.25
WfS0TjI8FyLemNTOo1e9qA: raises $1.25 to $2.50
mpsfNtnMVDqQHTe92AhIdw: calls $1.25
*** TURN *** [5c 3h 4c] [8h]
mpsfNtnMVDqQHTe92AhIdw: checks 
WfS0TjI8FyLemNTOo1e9qA: bets $3.50
mpsfNtnMVDqQHTe92AhIdw: calls $3.50
*** RIVER *** [5c 3h 4c 8h] [3c]
mpsfNtnMVDqQHTe92AhIdw: bets $4.25
WfS0TjI8FyLemNTOo1e9qA: calls $4.25
*** SHOW DOWN ***
mpsfNtnMVDqQHTe92AhIdw: shows [Kc Qc] (a flush, King high)
WfS0TjI8FyLemNTOo1e9qA: mucks hand 
mpsfNtnMVDqQHTe92AhIdw collected $21.30 from pot
*** SUMMARY ***
Total pot $22.35 | Rake $1.05 
Board [5c 3h 4c 8h 3c]
Seat 1: opOCI2p6kW0tINuVaAqmcQ (big blind) folded before Flop
Seat 2: mpsfNtnMVDqQHTe92AhIdw showed [Kc Qc] and won ($21.30) with a flush, King high
Seat 4: WfS0TjI8FyLemNTOo1e9qA mucked
Seat 6: oKO7b50N6TzXbPBr/mcrUA folded before Flop (didn't bet)
Seat 7: eFrBtVXGVoMq1UwCDg8Exg (button) folded before Flop (didn't bet)
Seat 8: sJNHTWcSlLHRCZ9+YRLLqA (small blind) folded before Flop




PokerStars Game #59939471392:  Hold'em No Limit ($0.10/$0.25) - 2009/07/01 0:40:44 ET
Table 'luMgmRPIo47e7iXDlheIwA' 6-max Seat #3 is the button
Seat 2: 4YSTu0Cdzpppe1lUgCZGCQ ($35.35 in chips) 
Seat 3: W6Y6au0wf7gRAlqJYgOezw ($14.75 in chips) 
Seat 4: n2OZezRXTtdzQt4SuIy8TQ ($25.75 in chips) 
Seat 5: kG34n23qFQA3nzdOJTQ1dA ($46.55 in chips) 
n2OZezRXTtdzQt4SuIy8TQ: posts small blind $0.10
kG34n23qFQA3nzdOJTQ1dA: posts big blind $0.25
*** HOLE CARDS ***
4YSTu0Cdzpppe1lUgCZGCQ: folds 
W6Y6au0wf7gRAlqJYgOezw: folds 
n2OZezRXTtdzQt4SuIy8TQ: folds 
Uncalled bet ($0.15) returned to kG34n23qFQA3nzdOJTQ1dA
kG34n23qFQA3nzdOJTQ1dA collected $0.20 from pot
*** SUMMARY ***
Total pot $0.20 | Rake $0 
Seat 2: 4YSTu0Cdzpppe1lUgCZGCQ folded before Flop (didn't bet)
Seat 3: W6Y6au0wf7gRAlqJYgOezw (button) folded before Flop (didn't bet)
Seat 4: n2OZezRXTtdzQt4SuIy8TQ (small blind) folded before Flop
Seat 5: kG34n23qFQA3nzdOJTQ1dA (big blind) collected ($0.20)




PokerStars Game #59939471508:  Hold'em No Limit ($0.10/$0.25) - 2009/07/01 0:40:44 ET
Table 'biAgO3TKQBU8XcrVAoU5TA' 6-max Seat #3 is the button
Seat 2: 7qRk4YH4/k/08LgJSv7rBQ ($25.45 in chips) 
Seat 3: 7AHdX4G8gYtDJyNY+wK+6Q ($31.80 in chips) 
Seat 4: 2/AObG8G5tKFCPZ+CdivJQ ($9.05 in chips) 
Seat 6: //i5P+6lSkIyZsqb+ojVQA ($14.50 in chips) 
2/AObG8G5tKFCPZ+CdivJQ: posts small blind $0.10
//i5P+6lSkIyZsqb+ojVQA: posts big blind $0.25
*** HOLE CARDS ***
7qRk4YH4/k/08LgJSv7rBQ: folds 
7AHdX4G8gYtDJyNY+wK+6Q: calls $0.25
2/AObG8G5tKFCPZ+CdivJQ: folds 
//i5P+6lSkIyZsqb+ojVQA: checks 
*** FLOP *** [3h 9d 3c]
//i5P+6lSkIyZsqb+ojVQA: checks 
7AHdX4G8gYtDJyNY+wK+6Q: checks 
*** TURN *** [3h 9d 3c] [4c]
//i5P+6lSkIyZsqb+ojVQA: checks 
7AHdX4G8gYtDJyNY+wK+6Q: bets $0.25
//i5P+6lSkIyZsqb+ojVQA: folds 
Uncalled bet ($0.25) returned to 7AHdX4G8gYtDJyNY+wK+6Q
7AHdX4G8gYtDJyNY+wK+6Q collected $0.60 from pot
7AHdX4G8gYtDJyNY+wK+6Q: doesn't show hand 
*** SUMMARY ***
Total pot $0.60 | Rake $0 
Board [3h 9d 3c 4c]
Seat 2: 7qRk4YH4/k/08LgJSv7rBQ folded before Flop (didn't bet)
Seat 3: 7AHdX4G8gYtDJyNY+wK+6Q (button) collected ($0.60)
Seat 4: 2/AObG8G5tKFCPZ+CdivJQ (small blind) folded before Flop
Seat 6: //i5P+6lSkIyZsqb+ojVQA (big blind) folded on the Turn




PokerStars Game #59939471470:  Hold'em No Limit ($0.10/$0.25) - 2009/07/01 0:40:44 ET
Table 'Of/T60zpXg1GcjrZ7Lm//Q' 9-max Seat #8 is the button
Seat 1: Lro4e37x4FUa5P3yzDjskw ($8.15 in chips) 
Seat 2: hIss79a4pu7GzJZepfgOpg ($25 in chips) 
Seat 3: jeKWRUkMaVn8rEUjnJKqpg ($25 in chips) 
Seat 4: Czut6V7acIqUJrrobjKAZg ($25.05 in chips) 
Seat 5: 18G4P1XstjNvItdGUITxgw ($25 in chips) 
Seat 6: tYsOBqdU1+x+yFI7zHO7hQ ($25.75 in chips) 
Seat 7: s7Q6uNouhe7aE8JdFb9E+A ($34.25 in chips) 
Seat 8: ghNKXUBl/H+t83JF079ZBA ($31.25 in chips) 
Seat 9: TeWJxSETzbXGiYKx0y+dtg ($24.40 in chips) 
TeWJxSETzbXGiYKx0y+dtg: posts small blind $0.10
Lro4e37x4FUa5P3yzDjskw: posts big blind $0.25
*** HOLE CARDS ***
hIss79a4pu7GzJZepfgOpg: folds 
jeKWRUkMaVn8rEUjnJKqpg: folds 
Czut6V7acIqUJrrobjKAZg: folds 
18G4P1XstjNvItdGUITxgw: folds 
tYsOBqdU1+x+yFI7zHO7hQ: folds 
s7Q6uNouhe7aE8JdFb9E+A: folds 
ghNKXUBl/H+t83JF079ZBA: folds 
TeWJxSETzbXGiYKx0y+dtg: folds 
Uncalled bet ($0.15) returned to Lro4e37x4FUa5P3yzDjskw
Lro4e37x4FUa5P3yzDjskw collected $0.20 from pot
*** SUMMARY ***
Total pot $0.20 | Rake $0 
Seat 1: Lro4e37x4FUa5P3yzDjskw (big blind) collected ($0.20)
Seat 2: hIss79a4pu7GzJZepfgOpg folded before Flop (didn't bet)
Seat 3: jeKWRUkMaVn8rEUjnJKqpg folded before Flop (didn't bet)
Seat 4: Czut6V7acIqUJrrobjKAZg folded before Flop (didn't bet)
Seat 5: 18G4P1XstjNvItdGUITxgw folded before Flop (didn't bet)
Seat 6: tYsOBqdU1+x+yFI7zHO7hQ folded before Flop (didn't bet)
Seat 7: s7Q6uNouhe7aE8JdFb9E+A folded before Flop (didn't bet)
Seat 8: ghNKXUBl/H+t83JF079ZBA (button) folded before Flop (didn't bet)
Seat 9: TeWJxSETzbXGiYKx0y+dtg (small blind) folded before Flop




PokerStars Game #59939471964:  Hold'em No Limit ($0.10/$0.25) - 2009/07/01 0:40:45 ET
Table '+VTTYgQLH1awDHk+IAxqGg' 9-max Seat #3 is the button
Seat 1: s7Q6uNouhe7aE8JdFb9E+A ($25.60 in chips) 
Seat 2: 86vbuhJsyH+nbEg5qpDLyQ ($24.15 in chips) 
Seat 3: rSMoem/92WmnPjtw2tSQkA ($29.55 in chips) 
Seat 4: gE5rN2TDY1aXcZn/TOPeZw ($9.70 in chips) 
Seat 5: sD+TKtt36XiiN6jqHiLwDA ($25 in chips) 
Seat 6: gAlaEiNZy/H/QuIVwzvHAQ ($9.60 in chips) 
Seat 7: W4TLQcZ2TiM73eIgpIvlGg ($26.55 in chips) 
Seat 8: rg+23WZbUM/1tFGv4XhYYA ($4.75 in chips) 
Seat 9: CFZ+ACzShzC3naaIaOjbYQ ($7.65 in chips) 
gE5rN2TDY1aXcZn/TOPeZw: posts small blind $0.10
sD+TKtt36XiiN6jqHiLwDA: posts big blind $0.25
*** HOLE CARDS ***
gAlaEiNZy/H/QuIVwzvHAQ: folds 
W4TLQcZ2TiM73eIgpIvlGg: folds 
rg+23WZbUM/1tFGv4XhYYA: calls $0.25
CFZ+ACzShzC3naaIaOjbYQ: folds 
s7Q6uNouhe7aE8JdFb9E+A: folds 
86vbuhJsyH+nbEg5qpDLyQ: folds 
rSMoem/92WmnPjtw2tSQkA: calls $0.25
gE5rN2TDY1aXcZn/TOPeZw: calls $0.15
sD+TKtt36XiiN6jqHiLwDA: checks 
*** FLOP *** [Kd 8c 2d]
gE5rN2TDY1aXcZn/TOPeZw: checks 
sD+TKtt36XiiN6jqHiLwDA: bets $1
rg+23WZbUM/1tFGv4XhYYA: folds 
rSMoem/92WmnPjtw2tSQkA: folds 
gE5rN2TDY1aXcZn/TOPeZw: folds 
Uncalled bet ($1) returned to sD+TKtt36XiiN6jqHiLwDA
sD+TKtt36XiiN6jqHiLwDA collected $0.95 from pot
sD+TKtt36XiiN6jqHiLwDA: doesn't show hand 
*** SUMMARY ***
Total pot $1 | Rake $0.05 
Board [Kd 8c 2d]
Seat 1: s7Q6uNouhe7aE8JdFb9E+A folded before Flop (didn't bet)
Seat 2: 86vbuhJsyH+nbEg5qpDLyQ folded before Flop (didn't bet)
Seat 3: rSMoem/92WmnPjtw2tSQkA (button) folded on the Flop
Seat 4: gE5rN2TDY1aXcZn/TOPeZw (small blind) folded on the Flop
Seat 5: sD+TKtt36XiiN6jqHiLwDA (big blind) collected ($0.95)
Seat 6: gAlaEiNZy/H/QuIVwzvHAQ folded before Flop (didn't bet)
Seat 7: W4TLQcZ2TiM73eIgpIvlGg folded before Flop (didn't bet)
Seat 8: rg+23WZbUM/1tFGv4XhYYA folded on the Flop
Seat 9: CFZ+ACzShzC3naaIaOjbYQ folded before Flop (didn't bet)




PokerStars Game #59939471972:  Hold'em No Limit ($0.10/$0.25) - 2009/07/01 0:40:45 ET
Table '0XPo7K54oZIfG0xlNAcDRw' 9-max Seat #6 is the button
Seat 1: opOCI2p6kW0tINuVaAqmcQ ($29.65 in chips) 
Seat 2: Jbrpc6KkvYcsiySJzLmFuA ($15.40 in chips) 
Seat 3: 6qsItdeWZoOL5be2e1RFng ($12.70 in chips) 
Seat 4: vOEICaqlJhPYytg64XnnkQ ($12.10 in chips) 
Seat 5: 8B/dhbQjIWe6ASCdgzktNQ ($40 in chips) 
Seat 6: 9gmYYQesalMrUjaF7nKfrQ ($9.95 in chips) 
Seat 7: tYsOBqdU1+x+yFI7zHO7hQ ($45.60 in chips) 
Seat 9: s7Q6uNouhe7aE8JdFb9E+A ($25.35 in chips) 
tYsOBqdU1+x+yFI7zHO7hQ: posts small blind $0.10
1Clf3cPrqoy/YgvWdWK1Xw: is sitting out 
s7Q6uNouhe7aE8JdFb9E+A: posts big blind $0.25
*** HOLE CARDS ***
1Clf3cPrqoy/YgvWdWK1Xw leaves the table
opOCI2p6kW0tINuVaAqmcQ: folds 
Jbrpc6KkvYcsiySJzLmFuA: folds 
6qsItdeWZoOL5be2e1RFng: folds 
vOEICaqlJhPYytg64XnnkQ: folds 
8B/dhbQjIWe6ASCdgzktNQ: folds 
9gmYYQesalMrUjaF7nKfrQ: folds 
tYsOBqdU1+x+yFI7zHO7hQ: folds 
Uncalled bet ($0.15) returned to s7Q6uNouhe7aE8JdFb9E+A
s7Q6uNouhe7aE8JdFb9E+A collected $0.20 from pot
s7Q6uNouhe7aE8JdFb9E+A: doesn't show hand 
*** SUMMARY ***
Total pot $0.20 | Rake $0 
Seat 1: opOCI2p6kW0tINuVaAqmcQ folded before Flop (didn't bet)
Seat 2: Jbrpc6KkvYcsiySJzLmFuA folded before Flop (didn't bet)
Seat 3: 6qsItdeWZoOL5be2e1RFng folded before Flop (didn't bet)
Seat 4: vOEICaqlJhPYytg64XnnkQ folded before Flop (didn't bet)
Seat 5: 8B/dhbQjIWe6ASCdgzktNQ folded before Flop (didn't bet)
Seat 6: 9gmYYQesalMrUjaF7nKfrQ (button) folded before Flop (didn't bet)
Seat 7: tYsOBqdU1+x+yFI7zHO7hQ (small blind) folded before Flop
Seat 9: s7Q6uNouhe7aE8JdFb9E+A (big blind) collected ($0.20)




PokerStars Game #59939472078:  Hold'em No Limit ($0.10/$0.25) - 2009/07/01 0:40:45 ET
Table '5VWnrlxdjwVfMWkVS2WE7A' 6-max Seat #4 is the button
Seat 1: BiLBinPhgpKAYzLgKJVU5A ($21.95 in chips) 
Seat 2: ELW+DKizJhLK7k40PMkD2Q ($24.65 in chips) 
Seat 3: cPO/1/dTcZpLkQFm3jH3Rg ($25 in chips) 
Seat 4: WZv4aSGl7ETtI/Z5BPKi7w ($30.90 in chips) 
Seat 5: JQZew0FjzS19kTjeNtrE+A ($43.40 in chips) 
Seat 6: LtASJ9OlkqGrrUKGQlpGAw ($20.75 in chips) 
JQZew0FjzS19kTjeNtrE+A: posts small blind $0.10
LtASJ9OlkqGrrUKGQlpGAw: posts big blind $0.25
*** HOLE CARDS ***
BiLBinPhgpKAYzLgKJVU5A: folds 
ELW+DKizJhLK7k40PMkD2Q: raises $0.75 to $1
cPO/1/dTcZpLkQFm3jH3Rg: folds 
WZv4aSGl7ETtI/Z5BPKi7w: calls $1
JQZew0FjzS19kTjeNtrE+A: folds 
LtASJ9OlkqGrrUKGQlpGAw: folds 
*** FLOP *** [Ah 9h 5h]
ELW+DKizJhLK7k40PMkD2Q: checks 
WZv4aSGl7ETtI/Z5BPKi7w: bets $2
ELW+DKizJhLK7k40PMkD2Q: raises $4 to $6
WZv4aSGl7ETtI/Z5BPKi7w: folds 
Uncalled bet ($4) returned to ELW+DKizJhLK7k40PMkD2Q
ELW+DKizJhLK7k40PMkD2Q collected $6.05 from pot
*** SUMMARY ***
Total pot $6.35 | Rake $0.30 
Board [Ah 9h 5h]
Seat 1: BiLBinPhgpKAYzLgKJVU5A folded before Flop (didn't bet)
Seat 2: ELW+DKizJhLK7k40PMkD2Q collected ($6.05)
Seat 3: cPO/1/dTcZpLkQFm3jH3Rg folded before Flop (didn't bet)
Seat 4: WZv4aSGl7ETtI/Z5BPKi7w (button) folded on the Flop
Seat 5: JQZew0FjzS19kTjeNtrE+A (small blind) folded before Flop
Seat 6: LtASJ9OlkqGrrUKGQlpGAw (big blind) folded before Flop




PokerStars Game #59939472324:  Hold'em No Limit ($0.10/$0.25) - 2009/07/01 0:40:45 ET
Table 'gHbubGDeVSkmB4vFiqIN3Q' 6-max Seat #4 is the button
Seat 2: 8LzEWRhg4wk8Jh9CqDhH3Q ($3.50 in chips) 
Seat 4: v+QfkGiuj9bgtuNoVnDO8w ($32.15 in chips) 
Seat 6: wvIIdlbCgePONQwXjx9xzQ ($5.60 in chips) 
wvIIdlbCgePONQwXjx9xzQ: posts small blind $0.10
8LzEWRhg4wk8Jh9CqDhH3Q: posts big blind $0.25
*** HOLE CARDS ***
v+QfkGiuj9bgtuNoVnDO8w: folds 
wvIIdlbCgePONQwXjx9xzQ: calls $0.15
8LzEWRhg4wk8Jh9CqDhH3Q: checks 
*** FLOP *** [4s 5s 7h]
wvIIdlbCgePONQwXjx9xzQ: bets $0.25
8LzEWRhg4wk8Jh9CqDhH3Q: calls $0.25
*** TURN *** [4s 5s 7h] [Qh]
wvIIdlbCgePONQwXjx9xzQ: bets $0.25
8LzEWRhg4wk8Jh9CqDhH3Q: raises $0.25 to $0.50
wvIIdlbCgePONQwXjx9xzQ: folds 
Uncalled bet ($0.25) returned to 8LzEWRhg4wk8Jh9CqDhH3Q
8LzEWRhg4wk8Jh9CqDhH3Q collected $1.45 from pot
8LzEWRhg4wk8Jh9CqDhH3Q: doesn't show hand 
*** SUMMARY ***
Total pot $1.50 | Rake $0.05 
Board [4s 5s 7h Qh]
Seat 2: 8LzEWRhg4wk8Jh9CqDhH3Q (big blind) collected ($1.45)
Seat 4: v+QfkGiuj9bgtuNoVnDO8w (button) folded before Flop (didn't bet)
Seat 6: wvIIdlbCgePONQwXjx9xzQ (small blind) folded on the Turn




PokerStars Game #59939472314:  Hold'em No Limit ($0.10/$0.25) - 2009/07/01 0:40:45 ET
Table '+198VWQSWBhYQOcizzuBkw' 6-max Seat #3 is the button
Seat 2: R6AGToFJQOYVZAjC2jXEKw ($29.05 in chips) 
Seat 3: BYxjLnV1/LL0aZcTbfAOvw ($27.25 in chips) 
Seat 4: TgDsTeCdLQt8kWbL00ByRA ($27.35 in chips) 
Seat 5: LtASJ9OlkqGrrUKGQlpGAw ($30.30 in chips) 
Seat 6: 7qRk4YH4/k/08LgJSv7rBQ ($31.25 in chips) 
TgDsTeCdLQt8kWbL00ByRA: posts small blind $0.10
LtASJ9OlkqGrrUKGQlpGAw: posts big blind $0.25
*** HOLE CARDS ***
7qRk4YH4/k/08LgJSv7rBQ: folds 
R6AGToFJQOYVZAjC2jXEKw: calls $0.25
BYxjLnV1/LL0aZcTbfAOvw: raises $1 to $1.25
TgDsTeCdLQt8kWbL00ByRA: folds 
LtASJ9OlkqGrrUKGQlpGAw: folds 
R6AGToFJQOYVZAjC2jXEKw: folds 
Uncalled bet ($1) returned to BYxjLnV1/LL0aZcTbfAOvw
BYxjLnV1/LL0aZcTbfAOvw collected $0.85 from pot
BYxjLnV1/LL0aZcTbfAOvw: doesn't show hand 
*** SUMMARY ***
Total pot $0.85 | Rake $0 
Seat 2: R6AGToFJQOYVZAjC2jXEKw folded before Flop
Seat 3: BYxjLnV1/LL0aZcTbfAOvw (button) collected ($0.85)
Seat 4: TgDsTeCdLQt8kWbL00ByRA (small blind) folded before Flop
Seat 5: LtASJ9OlkqGrrUKGQlpGAw (big blind) folded before Flop
Seat 6: 7qRk4YH4/k/08LgJSv7rBQ folded before Flop (didn't bet)




PokerStars Game #59939472442:  Hold'em No Limit ($0.10/$0.25) - 2009/07/01 0:40:46 ET
Table '8qKBgCRnebT9/IvA6SmaPw' 9-max Seat #4 is the button
Seat 1: GTcLfsDTPqgfHyhY9FNDMw ($11.20 in chips) 
Seat 2: SXqVW4Q0evTUVZG6BbUNIA ($76.55 in chips) 
Seat 4: rXm4QDVJt67H20lM6n6Z7Q ($6.50 in chips) 
Seat 5: uJlzv9KL7hgCIqIS2ofoaw ($13.90 in chips) 
Seat 6: z5GxcHlYz/GSz6W2uFiTtg ($23.80 in chips) 
Seat 7: UbybWqarUDNRYlbnju2UUQ ($19.50 in chips) 
Seat 8: M2aiKD/Q1d8lySUIbBxeGg ($36.40 in chips) 
Seat 9: MOlR9YEgKTKLerVIDf8U7w ($48.75 in chips) 
uJlzv9KL7hgCIqIS2ofoaw: posts small blind $0.10
z5GxcHlYz/GSz6W2uFiTtg: posts big blind $0.25
V6p0jQ/RhUsqpHLmXvEX4Q: sits out 
*** HOLE CARDS ***
UbybWqarUDNRYlbnju2UUQ: folds 
M2aiKD/Q1d8lySUIbBxeGg: calls $0.25
MOlR9YEgKTKLerVIDf8U7w: folds 
GTcLfsDTPqgfHyhY9FNDMw: folds 
SXqVW4Q0evTUVZG6BbUNIA: raises $0.75 to $1
rXm4QDVJt67H20lM6n6Z7Q: folds 
uJlzv9KL7hgCIqIS2ofoaw: calls $0.90
z5GxcHlYz/GSz6W2uFiTtg: folds 
M2aiKD/Q1d8lySUIbBxeGg: calls $0.75
*** FLOP *** [Jh 5d Ad]
uJlzv9KL7hgCIqIS2ofoaw: checks 
M2aiKD/Q1d8lySUIbBxeGg: checks 
SXqVW4Q0evTUVZG6BbUNIA: bets $2
uJlzv9KL7hgCIqIS2ofoaw: folds 
M2aiKD/Q1d8lySUIbBxeGg: folds 
Uncalled bet ($2) returned to SXqVW4Q0evTUVZG6BbUNIA
SXqVW4Q0evTUVZG6BbUNIA collected $3.10 from pot
SXqVW4Q0evTUVZG6BbUNIA: doesn't show hand 
*** SUMMARY ***
Total pot $3.25 | Rake $0.15 
Board [Jh 5d Ad]
Seat 1: GTcLfsDTPqgfHyhY9FNDMw folded before Flop (didn't bet)
Seat 2: SXqVW4Q0evTUVZG6BbUNIA collected ($3.10)
Seat 4: rXm4QDVJt67H20lM6n6Z7Q (button) folded before Flop (didn't bet)
Seat 5: uJlzv9KL7hgCIqIS2ofoaw (small blind) folded on the Flop
Seat 6: z5GxcHlYz/GSz6W2uFiTtg (big blind) folded before Flop
Seat 7: UbybWqarUDNRYlbnju2UUQ folded before Flop (didn't bet)
Seat 8: M2aiKD/Q1d8lySUIbBxeGg folded on the Flop
Seat 9: MOlR9YEgKTKLerVIDf8U7w folded before Flop (didn't bet)




PokerStars Game #59939472674:  Hold'em No Limit ($0.10/$0.25) - 2009/07/01 0:40:46 ET
Table '+giHa6FUL6U5/AZnCJEGvQ' 9-max Seat #5 is the button
Seat 1: kYgmoJdHhyWAdwXflGZuKA ($35.80 in chips) 
Seat 2: YN6/TiJBEQVW8LDMQA1vFQ ($8.85 in chips) 
Seat 3: DIBbjEYGs+TVdVgEB/4+3w ($24.15 in chips) 
Seat 4: ljemhp25Zg+nlA9DLCIiUw ($50.35 in chips) 
Seat 5: zDrucyjVn5aeekNEc3cJrA ($47.15 in chips) 
Seat 6: cZ99hugmLBj9KhTlc8nCSw ($25 in chips) 
Seat 7: TeWJxSETzbXGiYKx0y+dtg ($24.55 in chips) 
Seat 8: t2nb95S5EEFOEzNx9Itz0g ($2.60 in chips) 
Seat 9: qwr38jl5txoR36M7G5qi4A ($7.50 in chips) 
cZ99hugmLBj9KhTlc8nCSw: posts small blind $0.10
TeWJxSETzbXGiYKx0y+dtg: posts big blind $0.25
*** HOLE CARDS ***
t2nb95S5EEFOEzNx9Itz0g: folds 
qwr38jl5txoR36M7G5qi4A: folds 
kYgmoJdHhyWAdwXflGZuKA: folds 
YN6/TiJBEQVW8LDMQA1vFQ: calls $0.25
DIBbjEYGs+TVdVgEB/4+3w: folds 
ljemhp25Zg+nlA9DLCIiUw: calls $0.25
zDrucyjVn5aeekNEc3cJrA: folds 
cZ99hugmLBj9KhTlc8nCSw: folds 
TeWJxSETzbXGiYKx0y+dtg: checks 
*** FLOP *** [Js 2s 9d]
TeWJxSETzbXGiYKx0y+dtg: checks 
YN6/TiJBEQVW8LDMQA1vFQ: bets $0.50
ljemhp25Zg+nlA9DLCIiUw: folds 
TeWJxSETzbXGiYKx0y+dtg: folds 
Uncalled bet ($0.50) returned to YN6/TiJBEQVW8LDMQA1vFQ
YN6/TiJBEQVW8LDMQA1vFQ collected $0.85 from pot
YN6/TiJBEQVW8LDMQA1vFQ: doesn't show hand 
*** SUMMARY ***
Total pot $0.85 | Rake $0 
Board [Js 2s 9d]
Seat 1: kYgmoJdHhyWAdwXflGZuKA folded before Flop (didn't bet)
Seat 2: YN6/TiJBEQVW8LDMQA1vFQ collected ($0.85)
Seat 3: DIBbjEYGs+TVdVgEB/4+3w folded before Flop (didn't bet)
Seat 4: ljemhp25Zg+nlA9DLCIiUw folded on the Flop
Seat 5: zDrucyjVn5aeekNEc3cJrA (button) folded before Flop (didn't bet)
Seat 6: cZ99hugmLBj9KhTlc8nCSw (small blind) folded before Flop
Seat 7: TeWJxSETzbXGiYKx0y+dtg (big blind) folded on the Flop
Seat 8: t2nb95S5EEFOEzNx9Itz0g folded before Flop (didn't bet)
Seat 9: qwr38jl5txoR36M7G5qi4A folded before Flop (didn't bet)




PokerStars Game #59939473228:  Hold'em No Limit ($0.10/$0.25) - 2009/07/01 0:40:47 ET
Table 'HQOv+27sJF7e8+zUsBlT2w' 9-max Seat #5 is the button
Seat 1: CbXUS6Z2rXZxL1AKduNtmQ ($26.25 in chips) 
Seat 2: MG90wfSJZnOejs/KD3vlQQ ($25 in chips) 
Seat 3: 18G4P1XstjNvItdGUITxgw ($29.45 in chips) 
Seat 4: kRW/Cdh6F1t40Vs43OFbYA ($16.25 in chips) 
Seat 5: nD+0ILJGeuYzreVIK9/wcA ($15.95 in chips) 
Seat 6: vZGoOTJLQLhkPj4I+LNGig ($32.35 in chips) 
Seat 7: GmzfAfxcxu1kGbPC+9LkVg ($24.40 in chips) 
Seat 8: RaXCy4DBrUrZSg4MF8FyDg ($12.25 in chips) 
Seat 9: gehe91e0IyVT0QU/XBkEyg ($25 in chips) 
vZGoOTJLQLhkPj4I+LNGig: posts small blind $0.10
GmzfAfxcxu1kGbPC+9LkVg: posts big blind $0.25
*** HOLE CARDS ***
RaXCy4DBrUrZSg4MF8FyDg is disconnected 
RaXCy4DBrUrZSg4MF8FyDg has timed out while disconnected
RaXCy4DBrUrZSg4MF8FyDg: folds 
RaXCy4DBrUrZSg4MF8FyDg is sitting out
gehe91e0IyVT0QU/XBkEyg: folds 
CbXUS6Z2rXZxL1AKduNtmQ: folds 
MG90wfSJZnOejs/KD3vlQQ: folds 
18G4P1XstjNvItdGUITxgw: folds 
kRW/Cdh6F1t40Vs43OFbYA: folds 
nD+0ILJGeuYzreVIK9/wcA: calls $0.25
RaXCy4DBrUrZSg4MF8FyDg is connected 
vZGoOTJLQLhkPj4I+LNGig: folds 
GmzfAfxcxu1kGbPC+9LkVg: checks 
*** FLOP *** [Td Ac 9d]
GmzfAfxcxu1kGbPC+9LkVg: checks 
nD+0ILJGeuYzreVIK9/wcA: bets $0.50
RaXCy4DBrUrZSg4MF8FyDg has returned
GmzfAfxcxu1kGbPC+9LkVg: folds 
Uncalled bet ($0.50) returned to nD+0ILJGeuYzreVIK9/wcA
nD+0ILJGeuYzreVIK9/wcA collected $0.60 from pot
nD+0ILJGeuYzreVIK9/wcA: doesn't show hand 
*** SUMMARY ***
Total pot $0.60 | Rake $0 
Board [Td Ac 9d]
Seat 1: CbXUS6Z2rXZxL1AKduNtmQ folded before Flop (didn't bet)
Seat 2: MG90wfSJZnOejs/KD3vlQQ folded before Flop (didn't bet)
Seat 3: 18G4P1XstjNvItdGUITxgw folded before Flop (didn't bet)
Seat 4: kRW/Cdh6F1t40Vs43OFbYA folded before Flop (didn't bet)
Seat 5: nD+0ILJGeuYzreVIK9/wcA (button) collected ($0.60)
Seat 6: vZGoOTJLQLhkPj4I+LNGig (small blind) folded before Flop
Seat 7: GmzfAfxcxu1kGbPC+9LkVg (big blind) folded on the Flop
Seat 8: RaXCy4DBrUrZSg4MF8FyDg folded before Flop (didn't bet)
Seat 9: gehe91e0IyVT0QU/XBkEyg folded before Flop (didn't bet)




PokerStars Game #59939473116:  Hold'em No Limit ($0.10/$0.25) - 2009/07/01 0:40:47 ET
Table 'KRiZ8S/xwAYkA4EWSX89ow' 9-max Seat #9 is the button
Seat 1: CYkY0dNBaYaKs8HVCVn3mQ ($5.45 in chips) 
Seat 2: vZGoOTJLQLhkPj4I+LNGig ($53.45 in chips) 
Seat 3: /fionJv+b9tkuIj/KKbXYw ($25.95 in chips) 
Seat 4: COsrwJSFHQtxlUcrYtDQPQ ($27.20 in chips) 
Seat 5: t2nb95S5EEFOEzNx9Itz0g ($5.30 in chips) 
Seat 6: DdPXdieucQ+n99u1n3A+rQ ($5.60 in chips) 
Seat 7: cZ99hugmLBj9KhTlc8nCSw ($25 in chips) 
Seat 8: nEg1b6MIksd/4x5eLY735g ($25.60 in chips) 
Seat 9: EcWpc/mcsCWBGKsSdZaXbA ($24.05 in chips) 
CYkY0dNBaYaKs8HVCVn3mQ: posts small blind $0.10
vZGoOTJLQLhkPj4I+LNGig: posts big blind $0.25
*** HOLE CARDS ***
/fionJv+b9tkuIj/KKbXYw: folds 
COsrwJSFHQtxlUcrYtDQPQ: folds 
t2nb95S5EEFOEzNx9Itz0g: folds 
DdPXdieucQ+n99u1n3A+rQ: folds 
cZ99hugmLBj9KhTlc8nCSw: folds 
nEg1b6MIksd/4x5eLY735g: folds 
EcWpc/mcsCWBGKsSdZaXbA: folds 
CYkY0dNBaYaKs8HVCVn3mQ: raises $0.50 to $0.75
vZGoOTJLQLhkPj4I+LNGig: folds 
Uncalled bet ($0.50) returned to CYkY0dNBaYaKs8HVCVn3mQ
CYkY0dNBaYaKs8HVCVn3mQ collected $0.50 from pot
CYkY0dNBaYaKs8HVCVn3mQ: doesn't show hand 
*** SUMMARY ***
Total pot $0.50 | Rake $0 
Seat 1: CYkY0dNBaYaKs8HVCVn3mQ (small blind) collected ($0.50)
Seat 2: vZGoOTJLQLhkPj4I+LNGig (big blind) folded before Flop
Seat 3: /fionJv+b9tkuIj/KKbXYw folded before Flop (didn't bet)
Seat 4: COsrwJSFHQtxlUcrYtDQPQ folded before Flop (didn't bet)
Seat 5: t2nb95S5EEFOEzNx9Itz0g folded before Flop (didn't bet)
Seat 6: DdPXdieucQ+n99u1n3A+rQ folded before Flop (didn't bet)
Seat 7: cZ99hugmLBj9KhTlc8nCSw folded before Flop (didn't bet)
Seat 8: nEg1b6MIksd/4x5eLY735g folded before Flop (didn't bet)
Seat 9: EcWpc/mcsCWBGKsSdZaXbA (button) folded before Flop (didn't bet)




PokerStars Game #59939473332:  Hold'em No Limit ($0.10/$0.25) - 2009/07/01 0:40:47 ET
Table 'BabJGL6tfXQp3leBGbYe8A' 9-max Seat #3 is the button
Seat 2: G5EFgY1bi50mF1iH/+B4yQ ($9.85 in chips) 
Seat 3: Jdj7AsGFrlkCgDXeWK322A ($24.15 in chips) 
Seat 4: Yk91gygnxgAKPGHZ/jPVSw ($8.95 in chips) 
Seat 5: fKqW4kzqpoOv+YKE5kp3FA ($1.90 in chips) 
Seat 6: ELKIDQ6mBSQJr3wiHYHtvw ($7.75 in chips) 
Seat 7: PS2bAPjvHsF4E9tIyk0xBg ($2.20 in chips) 
Seat 8: TJEefy+0K5gBV+8LA5OK7Q ($25 in chips) 
Seat 9: xEQxarad8/T4jJdpZy5LGw ($9.80 in chips) 
Yk91gygnxgAKPGHZ/jPVSw: posts small blind $0.10
fKqW4kzqpoOv+YKE5kp3FA: posts big blind $0.25
qwr38jl5txoR36M7G5qi4A: sits out 
*** HOLE CARDS ***
ELKIDQ6mBSQJr3wiHYHtvw: folds 
PS2bAPjvHsF4E9tIyk0xBg: folds 
TJEefy+0K5gBV+8LA5OK7Q: folds 
xEQxarad8/T4jJdpZy5LGw: folds 
G5EFgY1bi50mF1iH/+B4yQ: folds 
Jdj7AsGFrlkCgDXeWK322A: folds 
Yk91gygnxgAKPGHZ/jPVSw: calls $0.15
fKqW4kzqpoOv+YKE5kp3FA: checks 
*** FLOP *** [2h 8h 3h]
Yk91gygnxgAKPGHZ/jPVSw: bets $0.25
fKqW4kzqpoOv+YKE5kp3FA: calls $0.25
*** TURN *** [2h 8h 3h] [Ah]
Yk91gygnxgAKPGHZ/jPVSw: bets $0.75
fKqW4kzqpoOv+YKE5kp3FA: calls $0.75
*** RIVER *** [2h 8h 3h Ah] [3s]
Yk91gygnxgAKPGHZ/jPVSw: checks 
fKqW4kzqpoOv+YKE5kp3FA: checks 
*** SHOW DOWN ***
Yk91gygnxgAKPGHZ/jPVSw: shows [9s 8d] (two pair, Eights and Threes)
fKqW4kzqpoOv+YKE5kp3FA: shows [4h 5d] (a flush, Ace high)
fKqW4kzqpoOv+YKE5kp3FA collected $2.40 from pot
*** SUMMARY ***
Total pot $2.50 | Rake $0.10 
Board [2h 8h 3h Ah 3s]
Seat 2: G5EFgY1bi50mF1iH/+B4yQ folded before Flop (didn't bet)
Seat 3: Jdj7AsGFrlkCgDXeWK322A (button) folded before Flop (didn't bet)
Seat 4: Yk91gygnxgAKPGHZ/jPVSw (small blind) showed [9s 8d] and lost with two pair, Eights and Threes
Seat 5: fKqW4kzqpoOv+YKE5kp3FA (big blind) showed [4h 5d] and won ($2.40) with a flush, Ace high
Seat 6: ELKIDQ6mBSQJr3wiHYHtvw folded before Flop (didn't bet)
Seat 7: PS2bAPjvHsF4E9tIyk0xBg folded before Flop (didn't bet)
Seat 8: TJEefy+0K5gBV+8LA5OK7Q folded before Flop (didn't bet)
Seat 9: xEQxarad8/T4jJdpZy5LGw folded before Flop (didn't bet)




PokerStars Game #59939473566:  Hold'em No Limit ($0.10/$0.25) - 2009/07/01 0:40:47 ET
Table 'K/f0NNaoGuhSz5DrzgVw7Q' 9-max Seat #6 is the button
Seat 2: 18G4P1XstjNvItdGUITxgw ($25 in chips) 
Seat 3: VBHxUExRAMrbxUq/cVx9Gw ($5.25 in chips) 
Seat 4: 3L1qKVpA6QZjrddTpoh2zQ ($13.50 in chips) 
Seat 5: DnDcAdn9P0zGovMERigpFA ($25.40 in chips) 
Seat 6: 3PVK0IdMlq2fElkVzzr4bg ($18.60 in chips) 
Seat 7: st9jtdNbm1W5GfBwRaCVqQ ($22.55 in chips) 
Seat 8: E0iYnEVO2ho7dH3QcCjw7g ($20 in chips) 
Seat 9: B5Xu8WsfFPfBlsK3fbAtQQ ($11.70 in chips) 
st9jtdNbm1W5GfBwRaCVqQ: posts small blind $0.10
E0iYnEVO2ho7dH3QcCjw7g: posts big blind $0.25
sD+TKtt36XiiN6jqHiLwDA: sits out 
*** HOLE CARDS ***
B5Xu8WsfFPfBlsK3fbAtQQ: calls $0.25
18G4P1XstjNvItdGUITxgw: folds 
VBHxUExRAMrbxUq/cVx9Gw: folds 
3L1qKVpA6QZjrddTpoh2zQ: raises $0.50 to $0.75
DnDcAdn9P0zGovMERigpFA: calls $0.75
3PVK0IdMlq2fElkVzzr4bg: calls $0.75
st9jtdNbm1W5GfBwRaCVqQ: folds 
E0iYnEVO2ho7dH3QcCjw7g: folds 
B5Xu8WsfFPfBlsK3fbAtQQ: calls $0.50
*** FLOP *** [9s Qs Ad]
B5Xu8WsfFPfBlsK3fbAtQQ: checks 
3L1qKVpA6QZjrddTpoh2zQ: checks 
DnDcAdn9P0zGovMERigpFA: bets $2.25
3PVK0IdMlq2fElkVzzr4bg: folds 
B5Xu8WsfFPfBlsK3fbAtQQ: calls $2.25
3L1qKVpA6QZjrddTpoh2zQ: folds 
*** TURN *** [9s Qs Ad] [Qh]
B5Xu8WsfFPfBlsK3fbAtQQ: checks 
DnDcAdn9P0zGovMERigpFA: checks 
*** RIVER *** [9s Qs Ad Qh] [5d]
B5Xu8WsfFPfBlsK3fbAtQQ: checks 
DnDcAdn9P0zGovMERigpFA: bets $3
B5Xu8WsfFPfBlsK3fbAtQQ: folds 
Uncalled bet ($3) returned to DnDcAdn9P0zGovMERigpFA
DnDcAdn9P0zGovMERigpFA collected $7.50 from pot
DnDcAdn9P0zGovMERigpFA: doesn't show hand 
*** SUMMARY ***
Total pot $7.85 | Rake $0.35 
Board [9s Qs Ad Qh 5d]
Seat 2: 18G4P1XstjNvItdGUITxgw folded before Flop (didn't bet)
Seat 3: VBHxUExRAMrbxUq/cVx9Gw folded before Flop (didn't bet)
Seat 4: 3L1qKVpA6QZjrddTpoh2zQ folded on the Flop
Seat 5: DnDcAdn9P0zGovMERigpFA collected ($7.50)
Seat 6: 3PVK0IdMlq2fElkVzzr4bg (button) folded on the Flop
Seat 7: st9jtdNbm1W5GfBwRaCVqQ (small blind) folded before Flop
Seat 8: E0iYnEVO2ho7dH3QcCjw7g (big blind) folded before Flop
Seat 9: B5Xu8WsfFPfBlsK3fbAtQQ folded on the River




PokerStars Game #59939473624:  Hold'em No Limit ($0.10/$0.25) - 2009/07/01 0:40:47 ET
Table '4XGDnEByOol5up4aB2KbJw' 6-max Seat #1 is the button
Seat 1: kyRaCIljYA6l33lSKQfNsg ($26.30 in chips) 
Seat 2: SFmT9ZsVopnukjvAzrxTRg ($33.95 in chips) 
Seat 3: LtASJ9OlkqGrrUKGQlpGAw ($23.60 in chips) 
Seat 4: sjoibHX/s93+8Kwa5aB1dA ($27.60 in chips) 
Seat 5: Dh01+rohD2p9pXLYeBlC5Q ($18 in chips) 
Seat 6: ELW+DKizJhLK7k40PMkD2Q ($28.10 in chips) 
SFmT9ZsVopnukjvAzrxTRg: posts small blind $0.10
LtASJ9OlkqGrrUKGQlpGAw: posts big blind $0.25
*** HOLE CARDS ***
sjoibHX/s93+8Kwa5aB1dA: calls $0.25
Dh01+rohD2p9pXLYeBlC5Q: calls $0.25
ELW+DKizJhLK7k40PMkD2Q: folds 
kyRaCIljYA6l33lSKQfNsg: folds 
SFmT9ZsVopnukjvAzrxTRg: folds 
LtASJ9OlkqGrrUKGQlpGAw: checks 
*** FLOP *** [6d 4d 9d]
LtASJ9OlkqGrrUKGQlpGAw: checks 
sjoibHX/s93+8Kwa5aB1dA: bets $0.50
Dh01+rohD2p9pXLYeBlC5Q: calls $0.50
LtASJ9OlkqGrrUKGQlpGAw: folds 
*** TURN *** [6d 4d 9d] [Ks]
sjoibHX/s93+8Kwa5aB1dA: bets $0.50
Dh01+rohD2p9pXLYeBlC5Q: calls $0.50
*** RIVER *** [6d 4d 9d Ks] [Td]
sjoibHX/s93+8Kwa5aB1dA: checks 
Dh01+rohD2p9pXLYeBlC5Q: bets $1.75
sjoibHX/s93+8Kwa5aB1dA: folds 
Uncalled bet ($1.75) returned to Dh01+rohD2p9pXLYeBlC5Q
Dh01+rohD2p9pXLYeBlC5Q collected $2.75 from pot
*** SUMMARY ***
Total pot $2.85 | Rake $0.10 
Board [6d 4d 9d Ks Td]
Seat 1: kyRaCIljYA6l33lSKQfNsg (button) folded before Flop (didn't bet)
Seat 2: SFmT9ZsVopnukjvAzrxTRg (small blind) folded before Flop
Seat 3: LtASJ9OlkqGrrUKGQlpGAw (big blind) folded on the Flop
Seat 4: sjoibHX/s93+8Kwa5aB1dA folded on the River
Seat 5: Dh01+rohD2p9pXLYeBlC5Q collected ($2.75)
Seat 6: ELW+DKizJhLK7k40PMkD2Q folded before Flop (didn't bet)




PokerStars Game #59939473720:  Hold'em No Limit ($0.10/$0.25) - 2009/07/01 0:40:48 ET
Table 'rhQuIjJo0UQ7RRUlF9umHg' 6-max Seat #6 is the button
Seat 1: 5O3Hj9Qg0SqOyKEXoLpjPg ($81.20 in chips) 
Seat 2: Ew/TYPQIsbQ2X8nm5iAJBg ($25 in chips) 
Seat 3: nLE5Yo60EmSlJPyg0GgxXg ($16 in chips) 
Seat 4: buyjetgNT1McXtdaP4zynA ($22.65 in chips) 
Seat 5: 7qRk4YH4/k/08LgJSv7rBQ ($26.95 in chips) 
Seat 6: r284m4NA4rtNktI86R8/Yw ($10.95 in chips) 
5O3Hj9Qg0SqOyKEXoLpjPg: posts small blind $0.10
Ew/TYPQIsbQ2X8nm5iAJBg: posts big blind $0.25
*** HOLE CARDS ***
nLE5Yo60EmSlJPyg0GgxXg: folds 
buyjetgNT1McXtdaP4zynA: folds 
7qRk4YH4/k/08LgJSv7rBQ: folds 
r284m4NA4rtNktI86R8/Yw: folds 
5O3Hj9Qg0SqOyKEXoLpjPg: calls $0.15
Ew/TYPQIsbQ2X8nm5iAJBg: raises $0.25 to $0.50
5O3Hj9Qg0SqOyKEXoLpjPg: calls $0.25
*** FLOP *** [5s 6s 3h]
5O3Hj9Qg0SqOyKEXoLpjPg: checks 
Ew/TYPQIsbQ2X8nm5iAJBg: checks 
*** TURN *** [5s 6s 3h] [Kd]
5O3Hj9Qg0SqOyKEXoLpjPg: checks 
Ew/TYPQIsbQ2X8nm5iAJBg: bets $0.50
5O3Hj9Qg0SqOyKEXoLpjPg: calls $0.50
*** RIVER *** [5s 6s 3h Kd] [9s]
5O3Hj9Qg0SqOyKEXoLpjPg: checks 
Ew/TYPQIsbQ2X8nm5iAJBg: checks 
*** SHOW DOWN ***
5O3Hj9Qg0SqOyKEXoLpjPg: shows [4c 6c] (a pair of Sixes)
Ew/TYPQIsbQ2X8nm5iAJBg: shows [9c Tc] (a pair of Nines)
Ew/TYPQIsbQ2X8nm5iAJBg collected $1.95 from pot
*** SUMMARY ***
Total pot $2 | Rake $0.05 
Board [5s 6s 3h Kd 9s]
Seat 1: 5O3Hj9Qg0SqOyKEXoLpjPg (small blind) showed [4c 6c] and lost with a pair of Sixes
Seat 2: Ew/TYPQIsbQ2X8nm5iAJBg (big blind) showed [9c Tc] and won ($1.95) with a pair of Nines
Seat 3: nLE5Yo60EmSlJPyg0GgxXg folded before Flop (didn't bet)
Seat 4: buyjetgNT1McXtdaP4zynA folded before Flop (didn't bet)
Seat 5: 7qRk4YH4/k/08LgJSv7rBQ folded before Flop (didn't bet)
Seat 6: r284m4NA4rtNktI86R8/Yw (button) folded before Flop (didn't bet)




PokerStars Game #59939474020:  Hold'em No Limit ($0.10/$0.25) - 2009/07/01 0:40:48 ET
Table 'nlpa8xI95gAflovnFxB2yg' 6-max Seat #3 is the button
Seat 1: fZQg9veL7Dd/Z04ZTjC+wQ ($64.70 in chips) 
Seat 3: I1TxPvWj8NfG8orglCinNA ($25 in chips) 
Seat 4: 5xjU9nfIjn1MBxIJKZvS5w ($31.20 in chips) 
Seat 5: 6DwBRH+xZ12AAZmeAg+aXw ($25 in chips) 
Seat 6: FPlQHZog0ePFCETQ2KG4hQ ($26.25 in chips) 
5xjU9nfIjn1MBxIJKZvS5w: posts small blind $0.10
6DwBRH+xZ12AAZmeAg+aXw: posts big blind $0.25
WrLI51S2iMb8GLMB83gGqA: sits out 
*** HOLE CARDS ***
FPlQHZog0ePFCETQ2KG4hQ: folds 
fZQg9veL7Dd/Z04ZTjC+wQ: raises $0.75 to $1
I1TxPvWj8NfG8orglCinNA: folds 
5xjU9nfIjn1MBxIJKZvS5w: folds 
6DwBRH+xZ12AAZmeAg+aXw: folds 
Uncalled bet ($0.75) returned to fZQg9veL7Dd/Z04ZTjC+wQ
fZQg9veL7Dd/Z04ZTjC+wQ collected $0.60 from pot
fZQg9veL7Dd/Z04ZTjC+wQ: doesn't show hand 
*** SUMMARY ***
Total pot $0.60 | Rake $0 
Seat 1: fZQg9veL7Dd/Z04ZTjC+wQ collected ($0.60)
Seat 3: I1TxPvWj8NfG8orglCinNA (button) folded before Flop (didn't bet)
Seat 4: 5xjU9nfIjn1MBxIJKZvS5w (small blind) folded before Flop
Seat 5: 6DwBRH+xZ12AAZmeAg+aXw (big blind) folded before Flop
Seat 6: FPlQHZog0ePFCETQ2KG4hQ folded before Flop (didn't bet)




PokerStars Game #59939473722:  Hold'em No Limit ($0.10/$0.25) - 2009/07/01 0:40:48 ET
Table 'KEoOIegxPF91KooL2AelUA' 6-max Seat #5 is the button
Seat 1: wsP46AGpqDjHZQmlRHKa9g ($29.55 in chips) 
Seat 4: Vv37Oa9niKKVcR6Z7ceetw ($23.80 in chips) 
Seat 5: 2NLC44AHHKHEUooUQFYV+Q ($11.35 in chips) 
wsP46AGpqDjHZQmlRHKa9g: posts small blind $0.10
Vv37Oa9niKKVcR6Z7ceetw: posts big blind $0.25
*** HOLE CARDS ***
2NLC44AHHKHEUooUQFYV+Q: calls $0.25
wsP46AGpqDjHZQmlRHKa9g: folds 
Vv37Oa9niKKVcR6Z7ceetw: checks 
*** FLOP *** [Ah 8h 5s]
Vv37Oa9niKKVcR6Z7ceetw: checks 
2NLC44AHHKHEUooUQFYV+Q: bets $0.50
Vv37Oa9niKKVcR6Z7ceetw: calls $0.50
*** TURN *** [Ah 8h 5s] [Ks]
Vv37Oa9niKKVcR6Z7ceetw: checks 
2NLC44AHHKHEUooUQFYV+Q: bets $0.75
Vv37Oa9niKKVcR6Z7ceetw: folds 
Uncalled bet ($0.75) returned to 2NLC44AHHKHEUooUQFYV+Q
2NLC44AHHKHEUooUQFYV+Q collected $1.55 from pot
Jq3YrbGb738j4tRTnp4PDA joins the table at seat #6 
*** SUMMARY ***
Total pot $1.60 | Rake $0.05 
Board [Ah 8h 5s Ks]
Seat 1: wsP46AGpqDjHZQmlRHKa9g (small blind) folded before Flop
Seat 4: Vv37Oa9niKKVcR6Z7ceetw (big blind) folded on the Turn
Seat 5: 2NLC44AHHKHEUooUQFYV+Q (button) collected ($1.55)




PokerStars Game #59939474306:  Hold'em No Limit ($0.10/$0.25) - 2009/07/01 0:40:48 ET
Table 'Is9eNmJA1KnBOw0lcVkxUQ' 9-max Seat #6 is the button
Seat 1: 56S3mA6Zs3pGR+0p0vUCtg ($38.70 in chips) 
Seat 2: VllYilcih0t+gMD4GTRlgQ ($40.40 in chips) 
Seat 3: zFrHk6ssFhTu+DiVzVXr+g ($15.85 in chips) 
Seat 4: cZ99hugmLBj9KhTlc8nCSw ($25 in chips) 
Seat 6: HapyJHxV6lc3eqoT7yWL2A ($26.10 in chips) 
Seat 7: aNpwfA31EREwO+ar4XzBCw ($25 in chips) 
Seat 8: 1b3eMBC7sPXgDX9IYcruKg ($5.65 in chips) 
aNpwfA31EREwO+ar4XzBCw: posts small blind $0.10
1b3eMBC7sPXgDX9IYcruKg: posts big blind $0.25
V6p0jQ/RhUsqpHLmXvEX4Q joins the table at seat #5 
7wo6Sr7QG3Zo6BaBDV1BOw: sits out 
*** HOLE CARDS ***
56S3mA6Zs3pGR+0p0vUCtg: folds 
VllYilcih0t+gMD4GTRlgQ: calls $0.25
zFrHk6ssFhTu+DiVzVXr+g: calls $0.25
cZ99hugmLBj9KhTlc8nCSw: folds 
HapyJHxV6lc3eqoT7yWL2A: raises $1 to $1.25
aNpwfA31EREwO+ar4XzBCw: folds 
1b3eMBC7sPXgDX9IYcruKg: folds 
VllYilcih0t+gMD4GTRlgQ: calls $1
zFrHk6ssFhTu+DiVzVXr+g: calls $1
*** FLOP *** [9d 7h 8d]
VllYilcih0t+gMD4GTRlgQ: checks 
zFrHk6ssFhTu+DiVzVXr+g: checks 
HapyJHxV6lc3eqoT7yWL2A: bets $2.50
VllYilcih0t+gMD4GTRlgQ: calls $2.50
zFrHk6ssFhTu+DiVzVXr+g: calls $2.50
*** TURN *** [9d 7h 8d] [2c]
VllYilcih0t+gMD4GTRlgQ: checks 
zFrHk6ssFhTu+DiVzVXr+g: checks 
HapyJHxV6lc3eqoT7yWL2A: bets $6.25
VllYilcih0t+gMD4GTRlgQ: calls $6.25
zFrHk6ssFhTu+DiVzVXr+g: folds 
*** RIVER *** [9d 7h 8d 2c] [3c]
VllYilcih0t+gMD4GTRlgQ: checks 
HapyJHxV6lc3eqoT7yWL2A: bets $12
VllYilcih0t+gMD4GTRlgQ: folds 
Uncalled bet ($12) returned to HapyJHxV6lc3eqoT7yWL2A
HapyJHxV6lc3eqoT7yWL2A collected $22.95 from pot
HapyJHxV6lc3eqoT7yWL2A: doesn't show hand 
*** SUMMARY ***
Total pot $24.10 | Rake $1.15 
Board [9d 7h 8d 2c 3c]
Seat 1: 56S3mA6Zs3pGR+0p0vUCtg folded before Flop (didn't bet)
Seat 2: VllYilcih0t+gMD4GTRlgQ folded on the River
Seat 3: zFrHk6ssFhTu+DiVzVXr+g folded on the Turn
Seat 4: cZ99hugmLBj9KhTlc8nCSw folded before Flop (didn't bet)
Seat 6: HapyJHxV6lc3eqoT7yWL2A (button) collected ($22.95)
Seat 7: aNpwfA31EREwO+ar4XzBCw (small blind) folded before Flop
Seat 8: 1b3eMBC7sPXgDX9IYcruKg (big blind) folded before Flop




PokerStars Game #59939474116:  Hold'em No Limit ($0.10/$0.25) - 2009/07/01 0:40:48 ET
Table 'PCxB2W9H6ma8SwsZlImuOw' 9-max Seat #1 is the button
Seat 1: 5s3p6yoJBNW438dsyKTP8g ($30.90 in chips) 
Seat 2: wjH6l1gQaEfv+C45sAOwIQ ($37.65 in chips) 
Seat 3: opOCI2p6kW0tINuVaAqmcQ ($29.50 in chips) 
Seat 4: ydoFOVgzvZv9ZhuWu9rXAw ($5 in chips) 
Seat 5: h4ggJZYBXV0mEZzYPYKfeA ($23.95 in chips) 
Seat 6: E2c0EwJuNHUUdumOOgYQYA ($6.30 in chips) 
Seat 7: EfRs3ibIxn+c9JDErwwNCg ($26.35 in chips) 
Seat 8: Hdb9b2QXBH2f6YwkTgMKdQ ($3.90 in chips) 
wjH6l1gQaEfv+C45sAOwIQ: posts small blind $0.10
opOCI2p6kW0tINuVaAqmcQ: posts big blind $0.25
*** HOLE CARDS ***
ydoFOVgzvZv9ZhuWu9rXAw: folds 
h4ggJZYBXV0mEZzYPYKfeA: folds 
E2c0EwJuNHUUdumOOgYQYA: calls $0.25
EfRs3ibIxn+c9JDErwwNCg: folds 
Hdb9b2QXBH2f6YwkTgMKdQ: folds 
5s3p6yoJBNW438dsyKTP8g: calls $0.25
wjH6l1gQaEfv+C45sAOwIQ: calls $0.15
opOCI2p6kW0tINuVaAqmcQ: checks 
*** FLOP *** [Ts 6h Ks]
wjH6l1gQaEfv+C45sAOwIQ: bets $0.25
opOCI2p6kW0tINuVaAqmcQ: folds 
E2c0EwJuNHUUdumOOgYQYA: calls $0.25
5s3p6yoJBNW438dsyKTP8g: folds 
*** TURN *** [Ts 6h Ks] [7c]
wjH6l1gQaEfv+C45sAOwIQ: checks 
E2c0EwJuNHUUdumOOgYQYA: checks 
*** RIVER *** [Ts 6h Ks 7c] [9s]
wjH6l1gQaEfv+C45sAOwIQ: bets $0.50
E2c0EwJuNHUUdumOOgYQYA: calls $0.50
*** SHOW DOWN ***
wjH6l1gQaEfv+C45sAOwIQ: shows [Kd 3s] (a pair of Kings)
E2c0EwJuNHUUdumOOgYQYA: mucks hand 
wjH6l1gQaEfv+C45sAOwIQ collected $2.40 from pot
*** SUMMARY ***
Total pot $2.50 | Rake $0.10 
Board [Ts 6h Ks 7c 9s]
Seat 1: 5s3p6yoJBNW438dsyKTP8g (button) folded on the Flop
Seat 2: wjH6l1gQaEfv+C45sAOwIQ (small blind) showed [Kd 3s] and won ($2.40) with a pair of Kings
Seat 3: opOCI2p6kW0tINuVaAqmcQ (big blind) folded on the Flop
Seat 4: ydoFOVgzvZv9ZhuWu9rXAw folded before Flop (didn't bet)
Seat 5: h4ggJZYBXV0mEZzYPYKfeA folded before Flop (didn't bet)
Seat 6: E2c0EwJuNHUUdumOOgYQYA mucked
Seat 7: EfRs3ibIxn+c9JDErwwNCg folded before Flop (didn't bet)
Seat 8: Hdb9b2QXBH2f6YwkTgMKdQ folded before Flop (didn't bet)




PokerStars Game #59939474320:  Hold'em No Limit ($0.10/$0.25) - 2009/07/01 0:40:48 ET
Table 'pgrBYaOEx/BuqK5iAtlFzw' 9-max Seat #1 is the button
Seat 1: QsLvCwfSWqP+CfjwUnjpXQ ($15 in chips) 
Seat 4: 6meFEBwAfXU5eLC35rA/sw ($5.10 in chips) 
Seat 5: efYVL4adq0ufQFnZCpL5Tw ($11.20 in chips) 
Seat 6: OqlfFV+MkgflYrm4Q6rLMA ($6.75 in chips) 
6meFEBwAfXU5eLC35rA/sw: posts small blind $0.10
efYVL4adq0ufQFnZCpL5Tw: posts big blind $0.25
OqlfFV+MkgflYrm4Q6rLMA: posts big blind $0.25
*** HOLE CARDS ***
OqlfFV+MkgflYrm4Q6rLMA: raises $0.50 to $0.75
jXz58rvCgq0VjyVjUBf2mw joins the table at seat #7 
QsLvCwfSWqP+CfjwUnjpXQ: calls $0.75
6meFEBwAfXU5eLC35rA/sw: folds 
efYVL4adq0ufQFnZCpL5Tw: folds 
*** FLOP *** [Th 4d 2c]
OqlfFV+MkgflYrm4Q6rLMA: bets $0.50
QsLvCwfSWqP+CfjwUnjpXQ: calls $0.50
*** TURN *** [Th 4d 2c] [3s]
OqlfFV+MkgflYrm4Q6rLMA: bets $1
QsLvCwfSWqP+CfjwUnjpXQ: raises $1 to $2
OqlfFV+MkgflYrm4Q6rLMA: folds 
Uncalled bet ($1) returned to QsLvCwfSWqP+CfjwUnjpXQ
QsLvCwfSWqP+CfjwUnjpXQ collected $4.65 from pot
QsLvCwfSWqP+CfjwUnjpXQ: doesn't show hand 
*** SUMMARY ***
Total pot $4.85 | Rake $0.20 
Board [Th 4d 2c 3s]
Seat 1: QsLvCwfSWqP+CfjwUnjpXQ (button) collected ($4.65)
Seat 4: 6meFEBwAfXU5eLC35rA/sw (small blind) folded before Flop
Seat 5: efYVL4adq0ufQFnZCpL5Tw (big blind) folded before Flop
Seat 6: OqlfFV+MkgflYrm4Q6rLMA folded on the Turn




PokerStars Game #59939474482:  Hold'em No Limit ($0.10/$0.25) - 2009/07/01 0:40:49 ET
Table 'oJpFwZj9+FUGHX90Un8s9Q' 6-max Seat #2 is the button
Seat 2: IMmIhmfU3tqkaJABnD21Rg ($19.85 in chips) 
Seat 3: kyRaCIljYA6l33lSKQfNsg ($26.40 in chips) 
Seat 4: IX/nJvz3Mx/Ez6DgueFA4Q ($6.95 in chips) 
Seat 6: Zijzy/UtPWzWVUo81HHVjQ ($40.10 in chips) 
kyRaCIljYA6l33lSKQfNsg: posts small blind $0.10
IX/nJvz3Mx/Ez6DgueFA4Q: posts big blind $0.25
kG34n23qFQA3nzdOJTQ1dA: sits out 
*** HOLE CARDS ***
Zijzy/UtPWzWVUo81HHVjQ: raises $0.50 to $0.75
IMmIhmfU3tqkaJABnD21Rg: folds 
kyRaCIljYA6l33lSKQfNsg: folds 
IX/nJvz3Mx/Ez6DgueFA4Q: folds 
Uncalled bet ($0.50) returned to Zijzy/UtPWzWVUo81HHVjQ
Zijzy/UtPWzWVUo81HHVjQ collected $0.60 from pot
Zijzy/UtPWzWVUo81HHVjQ: doesn't show hand 
*** SUMMARY ***
Total pot $0.60 | Rake $0 
Seat 2: IMmIhmfU3tqkaJABnD21Rg (button) folded before Flop (didn't bet)
Seat 3: kyRaCIljYA6l33lSKQfNsg (small blind) folded before Flop
Seat 4: IX/nJvz3Mx/Ez6DgueFA4Q (big blind) folded before Flop
Seat 6: Zijzy/UtPWzWVUo81HHVjQ collected ($0.60)




PokerStars Game #59939474416:  Hold'em No Limit ($0.10/$0.25) - 2009/07/01 0:40:49 ET
Table '+fuYjvJy9okLr23QyZtanA' 9-max Seat #1 is the button
Seat 1: s7Q6uNouhe7aE8JdFb9E+A ($31.10 in chips) 
Seat 4: H/l9NZvuOXwQIPOaVdj0rQ ($9.05 in chips) 
s7Q6uNouhe7aE8JdFb9E+A: posts small blind $0.10
H/l9NZvuOXwQIPOaVdj0rQ: posts big blind $0.25
*** HOLE CARDS ***
s7Q6uNouhe7aE8JdFb9E+A: raises $0.50 to $0.75
H/l9NZvuOXwQIPOaVdj0rQ: raises $0.50 to $1.25
s7Q6uNouhe7aE8JdFb9E+A: calls $0.50
*** FLOP *** [6s 8c Qc]
h48vKHbhkYz+3RYZCQ0tgA joins the table at seat #5 
H/l9NZvuOXwQIPOaVdj0rQ: bets $1
s7Q6uNouhe7aE8JdFb9E+A: folds 
Uncalled bet ($1) returned to H/l9NZvuOXwQIPOaVdj0rQ
H/l9NZvuOXwQIPOaVdj0rQ collected $2.40 from pot
H/l9NZvuOXwQIPOaVdj0rQ: doesn't show hand 
*** SUMMARY ***
Total pot $2.50 | Rake $0.10 
Board [6s 8c Qc]
Seat 1: s7Q6uNouhe7aE8JdFb9E+A (button) (small blind) folded on the Flop
Seat 4: H/l9NZvuOXwQIPOaVdj0rQ (big blind) collected ($2.40)




PokerStars Game #59939474430:  Hold'em No Limit ($0.10/$0.25) - 2009/07/01 0:40:49 ET
Table '50f2Xa1b1jp6cfdTAgXFIg' 9-max Seat #8 is the button
Seat 1: JwUqpgqGHS96sdpExhhEqw ($8.60 in chips) 
Seat 2: OfGfQFPcghysTDljS9GQSQ ($18.85 in chips) 
Seat 3: aZHZRdpOTHSm1zLmzd6+ww ($23.50 in chips) 
Seat 4: ghNKXUBl/H+t83JF079ZBA ($29.60 in chips) 
Seat 5: OlPJsgR4xypSg/w1z7Gyvw ($55.50 in chips) 
Seat 6: Vl8zO7J9ZOnk8Og8eXFezg ($40.40 in chips) 
Seat 7: TeWJxSETzbXGiYKx0y+dtg ($25 in chips) 
Seat 8: jeKWRUkMaVn8rEUjnJKqpg ($25 in chips) 
Seat 9: gehe91e0IyVT0QU/XBkEyg ($25 in chips) 
gehe91e0IyVT0QU/XBkEyg: posts small blind $0.10
JwUqpgqGHS96sdpExhhEqw: posts big blind $0.25
*** HOLE CARDS ***
OfGfQFPcghysTDljS9GQSQ: folds 
aZHZRdpOTHSm1zLmzd6+ww: folds 
ghNKXUBl/H+t83JF079ZBA: folds 
OlPJsgR4xypSg/w1z7Gyvw: folds 
Vl8zO7J9ZOnk8Og8eXFezg said, "someone forgot to take his pill today?"
jeKWRUkMaVn8rEUjnJKqpg said, "so because you are oop you will limp AK's is that so genius?"
aZHZRdpOTHSm1zLmzd6+ww said, "wow you had AQ"
Vl8zO7J9ZOnk8Og8eXFezg: folds 
TeWJxSETzbXGiYKx0y+dtg: raises $0.50 to $0.75
jeKWRUkMaVn8rEUjnJKqpg: folds 
gehe91e0IyVT0QU/XBkEyg: folds 
JwUqpgqGHS96sdpExhhEqw: calls $0.50
*** FLOP *** [4h Kd 2h]
JwUqpgqGHS96sdpExhhEqw: checks 
TeWJxSETzbXGiYKx0y+dtg: checks 
*** TURN *** [4h Kd 2h] [7d]
JwUqpgqGHS96sdpExhhEqw: checks 
jeKWRUkMaVn8rEUjnJKqpg said, "i had aq?"
TeWJxSETzbXGiYKx0y+dtg: checks 
*** RIVER *** [4h Kd 2h 7d] [2s]
JwUqpgqGHS96sdpExhhEqw: checks 
aZHZRdpOTHSm1zLmzd6+ww said, "yes with a player like Vl8zO7J9ZOnk8Og8eXFezg in the game set the trap donk"
TeWJxSETzbXGiYKx0y+dtg: checks 
*** SHOW DOWN ***
JwUqpgqGHS96sdpExhhEqw: shows [Jh Ts] (a pair of Deuces)
TeWJxSETzbXGiYKx0y+dtg: shows [Ad Jd] (a pair of Deuces - Ace kicker)
TeWJxSETzbXGiYKx0y+dtg collected $1.55 from pot
*** SUMMARY ***
Total pot $1.60 | Rake $0.05 
Board [4h Kd 2h 7d 2s]
Seat 1: JwUqpgqGHS96sdpExhhEqw (big blind) showed [Jh Ts] and lost with a pair of Deuces
Seat 2: OfGfQFPcghysTDljS9GQSQ folded before Flop (didn't bet)
Seat 3: aZHZRdpOTHSm1zLmzd6+ww folded before Flop (didn't bet)
Seat 4: ghNKXUBl/H+t83JF079ZBA folded before Flop (didn't bet)
Seat 5: OlPJsgR4xypSg/w1z7Gyvw folded before Flop (didn't bet)
Seat 6: Vl8zO7J9ZOnk8Og8eXFezg folded before Flop (didn't bet)
Seat 7: TeWJxSETzbXGiYKx0y+dtg showed [Ad Jd] and won ($1.55) with a pair of Deuces
Seat 8: jeKWRUkMaVn8rEUjnJKqpg (button) folded before Flop (didn't bet)
Seat 9: gehe91e0IyVT0QU/XBkEyg (small blind) folded before Flop




PokerStars Game #59939474666:  Hold'em No Limit ($0.10/$0.25) - 2009/07/01 0:40:49 ET
Table 'fvoGXKLawfAadYn02raohg' 9-max Seat #9 is the button
Seat 1: DIBbjEYGs+TVdVgEB/4+3w ($39.25 in chips) 
Seat 2: Ud3KoJmky17jahFh5jxdNA ($15.75 in chips) 
Seat 3: aNpwfA31EREwO+ar4XzBCw ($25 in chips) 
Seat 4: uibjYTUZq0zsChpZ84TeGQ ($14.30 in chips) 
Seat 5: 1Uq1Gp+AloSwO4jVgEdX+A ($25.85 in chips) 
Seat 6: SXqVW4Q0evTUVZG6BbUNIA ($31.25 in chips) 
Seat 7: 18G4P1XstjNvItdGUITxgw ($25.45 in chips) 
Seat 8: 4GJMmHGKzu+gVtalqRy7dA ($12.85 in chips) 
Seat 9: JKfTHkCJ+e5tjUU+K32h1A ($14.60 in chips) 
DIBbjEYGs+TVdVgEB/4+3w: posts small blind $0.10
Ud3KoJmky17jahFh5jxdNA: posts big blind $0.25
*** HOLE CARDS ***
aNpwfA31EREwO+ar4XzBCw: folds 
uibjYTUZq0zsChpZ84TeGQ: calls $0.25
1Uq1Gp+AloSwO4jVgEdX+A: folds 
SXqVW4Q0evTUVZG6BbUNIA: folds 
18G4P1XstjNvItdGUITxgw: folds 
4GJMmHGKzu+gVtalqRy7dA: folds 
JKfTHkCJ+e5tjUU+K32h1A: folds 
DIBbjEYGs+TVdVgEB/4+3w: calls $0.15
Ud3KoJmky17jahFh5jxdNA: checks 
*** FLOP *** [Qc 2h 6c]
DIBbjEYGs+TVdVgEB/4+3w: checks 
Ud3KoJmky17jahFh5jxdNA: checks 
uibjYTUZq0zsChpZ84TeGQ: checks 
*** TURN *** [Qc 2h 6c] [Ts]
DIBbjEYGs+TVdVgEB/4+3w: checks 
Ud3KoJmky17jahFh5jxdNA: checks 
uibjYTUZq0zsChpZ84TeGQ: checks 
*** RIVER *** [Qc 2h 6c Ts] [4c]
DIBbjEYGs+TVdVgEB/4+3w: checks 
Ud3KoJmky17jahFh5jxdNA: checks 
uibjYTUZq0zsChpZ84TeGQ: checks 
*** SHOW DOWN ***
DIBbjEYGs+TVdVgEB/4+3w: shows [9s 6s] (a pair of Sixes)
Ud3KoJmky17jahFh5jxdNA: mucks hand 
uibjYTUZq0zsChpZ84TeGQ: shows [Th Jd] (a pair of Tens)
uibjYTUZq0zsChpZ84TeGQ collected $0.75 from pot
*** SUMMARY ***
Total pot $0.75 | Rake $0 
Board [Qc 2h 6c Ts 4c]
Seat 1: DIBbjEYGs+TVdVgEB/4+3w (small blind) showed [9s 6s] and lost with a pair of Sixes
Seat 2: Ud3KoJmky17jahFh5jxdNA (big blind) mucked
Seat 3: aNpwfA31EREwO+ar4XzBCw folded before Flop (didn't bet)
Seat 4: uibjYTUZq0zsChpZ84TeGQ showed [Th Jd] and won ($0.75) with a pair of Tens
Seat 5: 1Uq1Gp+AloSwO4jVgEdX+A folded before Flop (didn't bet)
Seat 6: SXqVW4Q0evTUVZG6BbUNIA folded before Flop (didn't bet)
Seat 7: 18G4P1XstjNvItdGUITxgw folded before Flop (didn't bet)
Seat 8: 4GJMmHGKzu+gVtalqRy7dA folded before Flop (didn't bet)
Seat 9: JKfTHkCJ+e5tjUU+K32h1A (button) folded before Flop (didn't bet)




PokerStars Game #59939474478:  Hold'em No Limit ($0.10/$0.25) - 2009/07/01 0:40:49 ET
Table '7eunnLa5p3aGsPrUrNnn/A' 9-max Seat #6 is the button
Seat 1: Ml2bY77EHbM51ZWD7dnIWg ($29.75 in chips) 
Seat 2: aJy680tKSaP5er559aSuGA ($12.25 in chips) 
Seat 3: E0iYnEVO2ho7dH3QcCjw7g ($20.80 in chips) 
Seat 4: opOCI2p6kW0tINuVaAqmcQ ($30.70 in chips) 
Seat 5: JLfmdpDbz2ljMNE7ICboMQ ($9.10 in chips) 
Seat 6: jx9kXw1SAZrvXp9Nerz8+Q ($15.45 in chips) 
Seat 7: sD+TKtt36XiiN6jqHiLwDA ($24.50 in chips) 
Seat 8: 1Clf3cPrqoy/YgvWdWK1Xw ($5 in chips) 
Seat 9: rUpvA02nErFvZ4yFbDR8XA ($20.55 in chips) 
sD+TKtt36XiiN6jqHiLwDA: posts small blind $0.10
1Clf3cPrqoy/YgvWdWK1Xw: posts big blind $0.25
*** HOLE CARDS ***
rUpvA02nErFvZ4yFbDR8XA: folds 
Ml2bY77EHbM51ZWD7dnIWg: calls $0.25
aJy680tKSaP5er559aSuGA: folds 
E0iYnEVO2ho7dH3QcCjw7g: folds 
opOCI2p6kW0tINuVaAqmcQ: folds 
JLfmdpDbz2ljMNE7ICboMQ: calls $0.25
jx9kXw1SAZrvXp9Nerz8+Q: raises $0.50 to $0.75
sD+TKtt36XiiN6jqHiLwDA: folds 
1Clf3cPrqoy/YgvWdWK1Xw: folds 
Ml2bY77EHbM51ZWD7dnIWg: calls $0.50
JLfmdpDbz2ljMNE7ICboMQ: calls $0.50
*** FLOP *** [8s Ac As]
Ml2bY77EHbM51ZWD7dnIWg: checks 
JLfmdpDbz2ljMNE7ICboMQ: bets $1.75
jx9kXw1SAZrvXp9Nerz8+Q: folds 
Ml2bY77EHbM51ZWD7dnIWg: calls $1.75
*** TURN *** [8s Ac As] [7d]
Ml2bY77EHbM51ZWD7dnIWg: checks 
JLfmdpDbz2ljMNE7ICboMQ: checks 
*** RIVER *** [8s Ac As 7d] [Qh]
Ml2bY77EHbM51ZWD7dnIWg: bets $1
JLfmdpDbz2ljMNE7ICboMQ: calls $1
*** SHOW DOWN ***
Ml2bY77EHbM51ZWD7dnIWg: shows [Jd Ah] (three of a kind, Aces)
JLfmdpDbz2ljMNE7ICboMQ: mucks hand 
Ml2bY77EHbM51ZWD7dnIWg collected $7.75 from pot
*** SUMMARY ***
Total pot $8.10 | Rake $0.35 
Board [8s Ac As 7d Qh]
Seat 1: Ml2bY77EHbM51ZWD7dnIWg showed [Jd Ah] and won ($7.75) with three of a kind, Aces
Seat 2: aJy680tKSaP5er559aSuGA folded before Flop (didn't bet)
Seat 3: E0iYnEVO2ho7dH3QcCjw7g folded before Flop (didn't bet)
Seat 4: opOCI2p6kW0tINuVaAqmcQ folded before Flop (didn't bet)
Seat 5: JLfmdpDbz2ljMNE7ICboMQ mucked
Seat 6: jx9kXw1SAZrvXp9Nerz8+Q (button) folded on the Flop
Seat 7: sD+TKtt36XiiN6jqHiLwDA (small blind) folded before Flop
Seat 8: 1Clf3cPrqoy/YgvWdWK1Xw (big blind) folded before Flop
Seat 9: rUpvA02nErFvZ4yFbDR8XA folded before Flop (didn't bet)




PokerStars Game #59939474668:  Hold'em No Limit ($0.10/$0.25) - 2009/07/01 0:40:49 ET
Table 'pPgW4R3kdH26lLi1MnE92w' 9-max Seat #9 is the button
Seat 1: dPWIrImjP1yFagoUVDKR0Q ($11.50 in chips) 
Seat 2: cZ99hugmLBj9KhTlc8nCSw ($28.60 in chips) 
Seat 3: og+56SuM1LUF/5l/Qtaw4Q ($8.80 in chips) 
Seat 4: hBMUlEpyU74r/fwDgIpXjQ ($31.15 in chips) 
Seat 5: HPEB+AtKw1+C/cxU0o1ciw ($34.35 in chips) 
Seat 8: aCVg6cCxQcqClhB9nq/p1w ($19.25 in chips) 
Seat 9: tcbEu7VzyHQ+0lh+skbQhQ ($18.15 in chips) 
dPWIrImjP1yFagoUVDKR0Q: posts small blind $0.10
cZ99hugmLBj9KhTlc8nCSw: posts big blind $0.25
VllYilcih0t+gMD4GTRlgQ: sits out 
sD+TKtt36XiiN6jqHiLwDA: sits out 
*** HOLE CARDS ***
og+56SuM1LUF/5l/Qtaw4Q: folds 
hBMUlEpyU74r/fwDgIpXjQ: folds 
HPEB+AtKw1+C/cxU0o1ciw: folds 
aCVg6cCxQcqClhB9nq/p1w: folds 
tcbEu7VzyHQ+0lh+skbQhQ: calls $0.25
dPWIrImjP1yFagoUVDKR0Q: folds 
cZ99hugmLBj9KhTlc8nCSw: checks 
*** FLOP *** [6d Th 9d]
cZ99hugmLBj9KhTlc8nCSw: checks 
tcbEu7VzyHQ+0lh+skbQhQ: bets $0.75
cZ99hugmLBj9KhTlc8nCSw: folds 
Uncalled bet ($0.75) returned to tcbEu7VzyHQ+0lh+skbQhQ
tcbEu7VzyHQ+0lh+skbQhQ collected $0.60 from pot
*** SUMMARY ***
Total pot $0.60 | Rake $0 
Board [6d Th 9d]
Seat 1: dPWIrImjP1yFagoUVDKR0Q (small blind) folded before Flop
Seat 2: cZ99hugmLBj9KhTlc8nCSw (big blind) folded on the Flop
Seat 3: og+56SuM1LUF/5l/Qtaw4Q folded before Flop (didn't bet)
Seat 4: hBMUlEpyU74r/fwDgIpXjQ folded before Flop (didn't bet)
Seat 5: HPEB+AtKw1+C/cxU0o1ciw folded before Flop (didn't bet)
Seat 8: aCVg6cCxQcqClhB9nq/p1w folded before Flop (didn't bet)
Seat 9: tcbEu7VzyHQ+0lh+skbQhQ (button) collected ($0.60)




PokerStars Game #59939475328:  Hold'em No Limit ($0.10/$0.25) - 2009/07/01 0:40:50 ET
Table 'xkqAWQFDrFt4p81M8UsoNw' 9-max Seat #3 is the button
Seat 2: z5GxcHlYz/GSz6W2uFiTtg ($35.80 in chips) 
Seat 3: HEUqKs2EYYGGXJCepUdL0g ($7.25 in chips) 
Seat 4: gY+PO8PaVC7pBPH/9HSv6Q ($4.70 in chips) 
Seat 5: OiV1PWZ3IkN29JlmCcnTwQ ($4.55 in chips) 
Seat 6: Yv4fucyyT28mjx8V5lxKJg ($23.25 in chips) 
Seat 7: MG90wfSJZnOejs/KD3vlQQ ($48.05 in chips) 
Seat 9: Wa7bjLwN7ptOQro84PxQGw ($4.75 in chips) 
gY+PO8PaVC7pBPH/9HSv6Q: posts small blind $0.10
OiV1PWZ3IkN29JlmCcnTwQ: posts big blind $0.25
*** HOLE CARDS ***
Yv4fucyyT28mjx8V5lxKJg: folds 
MG90wfSJZnOejs/KD3vlQQ: raises $0.50 to $0.75
Wa7bjLwN7ptOQro84PxQGw: folds 
z5GxcHlYz/GSz6W2uFiTtg: folds 
HEUqKs2EYYGGXJCepUdL0g: folds 
gY+PO8PaVC7pBPH/9HSv6Q: folds 
OiV1PWZ3IkN29JlmCcnTwQ: folds 
Uncalled bet ($0.50) returned to MG90wfSJZnOejs/KD3vlQQ
MG90wfSJZnOejs/KD3vlQQ collected $0.60 from pot
MG90wfSJZnOejs/KD3vlQQ: doesn't show hand 
*** SUMMARY ***
Total pot $0.60 | Rake $0 
Seat 2: z5GxcHlYz/GSz6W2uFiTtg folded before Flop (didn't bet)
Seat 3: HEUqKs2EYYGGXJCepUdL0g (button) folded before Flop (didn't bet)
Seat 4: gY+PO8PaVC7pBPH/9HSv6Q (small blind) folded before Flop
Seat 5: OiV1PWZ3IkN29JlmCcnTwQ (big blind) folded before Flop
Seat 6: Yv4fucyyT28mjx8V5lxKJg folded before Flop (didn't bet)
Seat 7: MG90wfSJZnOejs/KD3vlQQ collected ($0.60)
Seat 9: Wa7bjLwN7ptOQro84PxQGw folded before Flop (didn't bet)




PokerStars Game #59939475518:  Hold'em No Limit ($0.10/$0.25) - 2009/07/01 0:40:50 ET
Table 'pAhiNHs/spaABQia+7gWNQ' 9-max Seat #6 is the button
Seat 1: /VQLorsEOrMfI+KamzNQEA ($4.70 in chips) 
Seat 3: xEQxarad8/T4jJdpZy5LGw ($8.90 in chips) 
Seat 5: /vn2Qu2dvc9AMMq46Ae0jA ($10.15 in chips) 
Seat 6: FinSxgTdEPV/yPQRl5uhmA ($49.45 in chips) 
Seat 7: 04UcDjK4SUEJctLqNtWFoQ ($9.50 in chips) 
Seat 8: vSkQm2EelzwRGDDQQk0Fqw ($14.05 in chips) 
Seat 9: /67o0BjW8sY1ZxYt7/6StQ ($13.40 in chips) 
04UcDjK4SUEJctLqNtWFoQ: posts small blind $0.10
vSkQm2EelzwRGDDQQk0Fqw: posts big blind $0.25
vnCdP3GsLTKadDukKcJk/Q: sits out 
F7pnn6czNpHvRM55XcA2EA: sits out 
*** HOLE CARDS ***
/67o0BjW8sY1ZxYt7/6StQ: folds 
/VQLorsEOrMfI+KamzNQEA: folds 
xEQxarad8/T4jJdpZy5LGw: raises $0.50 to $0.75
/67o0BjW8sY1ZxYt7/6StQ leaves the table
/vn2Qu2dvc9AMMq46Ae0jA: folds 
FinSxgTdEPV/yPQRl5uhmA: calls $0.75
04UcDjK4SUEJctLqNtWFoQ: folds 
vSkQm2EelzwRGDDQQk0Fqw: folds 
*** FLOP *** [Qh Td Qs]
xEQxarad8/T4jJdpZy5LGw: bets $0.75
FinSxgTdEPV/yPQRl5uhmA: folds 
Uncalled bet ($0.75) returned to xEQxarad8/T4jJdpZy5LGw
xEQxarad8/T4jJdpZy5LGw collected $1.80 from pot
*** SUMMARY ***
Total pot $1.85 | Rake $0.05 
Board [Qh Td Qs]
Seat 1: /VQLorsEOrMfI+KamzNQEA folded before Flop (didn't bet)
Seat 3: xEQxarad8/T4jJdpZy5LGw collected ($1.80)
Seat 5: /vn2Qu2dvc9AMMq46Ae0jA folded before Flop (didn't bet)
Seat 6: FinSxgTdEPV/yPQRl5uhmA (button) folded on the Flop
Seat 7: 04UcDjK4SUEJctLqNtWFoQ (small blind) folded before Flop
Seat 8: vSkQm2EelzwRGDDQQk0Fqw (big blind) folded before Flop
Seat 9: /67o0BjW8sY1ZxYt7/6StQ folded before Flop (didn't bet)




PokerStars Game #59939475144:  Hold'em No Limit ($0.10/$0.25) - 2009/07/01 0:40:50 ET
Table 'wRXcD9iXgBbdvKhWmfnBnw' 6-max Seat #5 is the button
Seat 1: LGWRgaQNaDFSlUGk26f0Ig ($19.55 in chips) 
Seat 2: SS/yfeArhULzIcOPe8MdPg ($25 in chips) 
Seat 3: 6zbQpY/G44U1Xvj7DZex0A ($19.70 in chips) 
Seat 4: mfrkWA3PTeYPkbO6hi98Aw ($26.05 in chips) 
Seat 5: EE16Ua5b1HSsYej5zeXOlA ($29.75 in chips) 
rhWCqDS9OBh/IoXY29BGMw will be allowed to play after the button
LGWRgaQNaDFSlUGk26f0Ig: posts small blind $0.10
SS/yfeArhULzIcOPe8MdPg: posts big blind $0.25
*** HOLE CARDS ***
6zbQpY/G44U1Xvj7DZex0A: raises $0.25 to $0.50
mfrkWA3PTeYPkbO6hi98Aw: folds 
EE16Ua5b1HSsYej5zeXOlA: folds 
LGWRgaQNaDFSlUGk26f0Ig: folds 
SS/yfeArhULzIcOPe8MdPg: folds 
Uncalled bet ($0.25) returned to 6zbQpY/G44U1Xvj7DZex0A
6zbQpY/G44U1Xvj7DZex0A collected $0.60 from pot
*** SUMMARY ***
Total pot $0.60 | Rake $0 
Seat 1: LGWRgaQNaDFSlUGk26f0Ig (small blind) folded before Flop
Seat 2: SS/yfeArhULzIcOPe8MdPg (big blind) folded before Flop
Seat 3: 6zbQpY/G44U1Xvj7DZex0A collected ($0.60)
Seat 4: mfrkWA3PTeYPkbO6hi98Aw folded before Flop (didn't bet)
Seat 5: EE16Ua5b1HSsYej5zeXOlA (button) folded before Flop (didn't bet)




PokerStars Game #59939475352:  Hold'em No Limit ($0.10/$0.25) - 2009/07/01 0:40:50 ET
Table 'L5GvbdQO5aCZJSE6pyQ8OA' 6-max Seat #3 is the button
Seat 1: FOcO5GvOP3rgvLGPLVkg5g ($30.35 in chips) 
Seat 2: LxehwDpTQ19ph4Qmc78+Pw ($20.40 in chips) 
Seat 3: wKFJ513ucluNNiMlkXcDOQ ($28.70 in chips) 
Seat 4: ErIN0JRL5srYjT6en1f8YQ ($21.20 in chips) 
Seat 5: pGthjNbaUqdSv6V/A1ekXw ($8.30 in chips) 
Seat 6: v+QfkGiuj9bgtuNoVnDO8w ($35.25 in chips) 
ErIN0JRL5srYjT6en1f8YQ: posts small blind $0.10
pGthjNbaUqdSv6V/A1ekXw: posts big blind $0.25
*** HOLE CARDS ***
v+QfkGiuj9bgtuNoVnDO8w: folds 
FOcO5GvOP3rgvLGPLVkg5g: folds 
LxehwDpTQ19ph4Qmc78+Pw: calls $0.25
wKFJ513ucluNNiMlkXcDOQ: folds 
ErIN0JRL5srYjT6en1f8YQ: folds 
pGthjNbaUqdSv6V/A1ekXw: checks 
*** FLOP *** [Ah Qd Ks]
pGthjNbaUqdSv6V/A1ekXw: bets $0.25
LxehwDpTQ19ph4Qmc78+Pw: calls $0.25
*** TURN *** [Ah Qd Ks] [9s]
pGthjNbaUqdSv6V/A1ekXw: bets $0.50
LxehwDpTQ19ph4Qmc78+Pw: raises $0.50 to $1
pGthjNbaUqdSv6V/A1ekXw: calls $0.50
*** RIVER *** [Ah Qd Ks 9s] [9d]
pGthjNbaUqdSv6V/A1ekXw: bets $1
LxehwDpTQ19ph4Qmc78+Pw: raises $1 to $2
pGthjNbaUqdSv6V/A1ekXw: raises $1 to $3
LxehwDpTQ19ph4Qmc78+Pw: calls $1
*** SHOW DOWN ***
pGthjNbaUqdSv6V/A1ekXw: shows [Ac 9h] (a full house, Nines full of Aces)
LxehwDpTQ19ph4Qmc78+Pw: mucks hand 
pGthjNbaUqdSv6V/A1ekXw collected $8.70 from pot
*** SUMMARY ***
Total pot $9.10 | Rake $0.40 
Board [Ah Qd Ks 9s 9d]
Seat 1: FOcO5GvOP3rgvLGPLVkg5g folded before Flop (didn't bet)
Seat 2: LxehwDpTQ19ph4Qmc78+Pw mucked
Seat 3: wKFJ513ucluNNiMlkXcDOQ (button) folded before Flop (didn't bet)
Seat 4: ErIN0JRL5srYjT6en1f8YQ (small blind) folded before Flop
Seat 5: pGthjNbaUqdSv6V/A1ekXw (big blind) showed [Ac 9h] and won ($8.70) with a full house, Nines full of Aces
Seat 6: v+QfkGiuj9bgtuNoVnDO8w folded before Flop (didn't bet)




PokerStars Game #59939475520:  Hold'em No Limit ($0.10/$0.25) - 2009/07/01 0:40:50 ET
Table 'IRgQPZVA4+IaZZIQshgwyg' 6-max Seat #1 is the button
Seat 1: d0J1xuhsynEY81YHwAvJ5g ($25 in chips) 
Seat 2: 9jSiy0meE9XJKkdIZwyTEQ ($35.20 in chips) 
Seat 3: 8EEqTTh7T1q48sYDqbI2Xg ($27.75 in chips) 
Seat 4: PXXRy0uk7WED5BEf+ReJDQ ($14.15 in chips) 
Seat 5: PbMzPZIePKifKQZfKDkbIw ($27.35 in chips) 
Seat 6: qo39V8/pMxxofM2aciLSWQ ($37.85 in chips) 
9jSiy0meE9XJKkdIZwyTEQ: posts small blind $0.10
8EEqTTh7T1q48sYDqbI2Xg: posts big blind $0.25
*** HOLE CARDS ***
PXXRy0uk7WED5BEf+ReJDQ: raises $0.75 to $1
PbMzPZIePKifKQZfKDkbIw: folds 
qo39V8/pMxxofM2aciLSWQ: folds 
d0J1xuhsynEY81YHwAvJ5g: folds 
9jSiy0meE9XJKkdIZwyTEQ: folds 
8EEqTTh7T1q48sYDqbI2Xg: calls $0.75
*** FLOP *** [4c 4s Kd]
8EEqTTh7T1q48sYDqbI2Xg: checks 
PXXRy0uk7WED5BEf+ReJDQ: bets $1
8EEqTTh7T1q48sYDqbI2Xg: folds 
Uncalled bet ($1) returned to PXXRy0uk7WED5BEf+ReJDQ
PXXRy0uk7WED5BEf+ReJDQ collected $2 from pot
PXXRy0uk7WED5BEf+ReJDQ: doesn't show hand 
*** SUMMARY ***
Total pot $2.10 | Rake $0.10 
Board [4c 4s Kd]
Seat 1: d0J1xuhsynEY81YHwAvJ5g (button) folded before Flop (didn't bet)
Seat 2: 9jSiy0meE9XJKkdIZwyTEQ (small blind) folded before Flop
Seat 3: 8EEqTTh7T1q48sYDqbI2Xg (big blind) folded on the Flop
Seat 4: PXXRy0uk7WED5BEf+ReJDQ collected ($2)
Seat 5: PbMzPZIePKifKQZfKDkbIw folded before Flop (didn't bet)
Seat 6: qo39V8/pMxxofM2aciLSWQ folded before Flop (didn't bet)




PokerStars Game #59939475360:  Hold'em No Limit ($0.10/$0.25) - 2009/07/01 0:40:50 ET
Table 'NtEQAxCeIK2io1CGtW658g' 6-max Seat #4 is the button
Seat 1: lnOV7k25gyN7L5t5YKTgIg ($20.85 in chips) 
Seat 2: nc79pm0LZRdhncq55evVqA ($25.55 in chips) 
Seat 3: m2yWOKfAxqHoy5DDN87Ttw ($24.65 in chips) 
Seat 4: 8296 ($11.65 in chips) 
Seat 5: FStoHe64SQWqAsjya9pDkQ ($28.30 in chips) 
Seat 6: /gJNBeCkWL4o85/jvlZ4BA ($62.35 in chips) 
FStoHe64SQWqAsjya9pDkQ: posts small blind $0.10
/gJNBeCkWL4o85/jvlZ4BA: posts big blind $0.25
*** HOLE CARDS ***
lnOV7k25gyN7L5t5YKTgIg: folds 
nc79pm0LZRdhncq55evVqA: folds 
m2yWOKfAxqHoy5DDN87Ttw: folds 
8296: folds 
FStoHe64SQWqAsjya9pDkQ: folds 
Uncalled bet ($0.15) returned to /gJNBeCkWL4o85/jvlZ4BA
/gJNBeCkWL4o85/jvlZ4BA collected $0.20 from pot
*** SUMMARY ***
Total pot $0.20 | Rake $0 
Seat 1: lnOV7k25gyN7L5t5YKTgIg folded before Flop (didn't bet)
Seat 2: nc79pm0LZRdhncq55evVqA folded before Flop (didn't bet)
Seat 3: m2yWOKfAxqHoy5DDN87Ttw folded before Flop (didn't bet)
Seat 4: 8296 (button) folded before Flop (didn't bet)
Seat 5: FStoHe64SQWqAsjya9pDkQ (small blind) folded before Flop
Seat 6: /gJNBeCkWL4o85/jvlZ4BA (big blind) collected ($0.20)




PokerStars Game #59939475472:  Hold'em No Limit ($0.10/$0.25) - 2009/07/01 0:40:50 ET
Table 'nRFAYu63wZNzrz/OBgzFTw' 9-max Seat #7 is the button
Seat 1: N6fYvIzQLKaydFLKQGtMlQ ($25 in chips) 
Seat 2: hJ4uYjNmSZdjrKA8cjZqCA ($20.20 in chips) 
Seat 3: EfRs3ibIxn+c9JDErwwNCg ($28.95 in chips) 
Seat 4: OiV1PWZ3IkN29JlmCcnTwQ ($5.50 in chips) 
Seat 5: vKdukiQ4ktU4yJ0Xx3MKnA ($28.80 in chips) 
Seat 6: DnDcAdn9P0zGovMERigpFA ($25 in chips) 
Seat 7: COsrwJSFHQtxlUcrYtDQPQ ($26.60 in chips) 
Seat 9: SXqVW4Q0evTUVZG6BbUNIA ($29.60 in chips) 
amHgC+Q9cpfD/2w2yUtNbw will be allowed to play after the button
SXqVW4Q0evTUVZG6BbUNIA: posts small blind $0.10
N6fYvIzQLKaydFLKQGtMlQ: posts big blind $0.25
*** HOLE CARDS ***
hJ4uYjNmSZdjrKA8cjZqCA: calls $0.25
EfRs3ibIxn+c9JDErwwNCg: folds 
OiV1PWZ3IkN29JlmCcnTwQ: folds 
vKdukiQ4ktU4yJ0Xx3MKnA: folds 
DnDcAdn9P0zGovMERigpFA: folds 
COsrwJSFHQtxlUcrYtDQPQ: folds 
SXqVW4Q0evTUVZG6BbUNIA: folds 
N6fYvIzQLKaydFLKQGtMlQ: checks 
*** FLOP *** [Ah 8c Ac]
N6fYvIzQLKaydFLKQGtMlQ: checks 
hJ4uYjNmSZdjrKA8cjZqCA: checks 
*** TURN *** [Ah 8c Ac] [5d]
N6fYvIzQLKaydFLKQGtMlQ: checks 
hJ4uYjNmSZdjrKA8cjZqCA: checks 
*** RIVER *** [Ah 8c Ac 5d] [8s]
N6fYvIzQLKaydFLKQGtMlQ: checks 
hJ4uYjNmSZdjrKA8cjZqCA: checks 
*** SHOW DOWN ***
N6fYvIzQLKaydFLKQGtMlQ: shows [2d Jh] (two pair, Aces and Eights)
hJ4uYjNmSZdjrKA8cjZqCA: shows [Th Qh] (two pair, Aces and Eights - Queen kicker)
hJ4uYjNmSZdjrKA8cjZqCA collected $0.60 from pot
*** SUMMARY ***
Total pot $0.60 | Rake $0 
Board [Ah 8c Ac 5d 8s]
Seat 1: N6fYvIzQLKaydFLKQGtMlQ (big blind) showed [2d Jh] and lost with two pair, Aces and Eights
Seat 2: hJ4uYjNmSZdjrKA8cjZqCA showed [Th Qh] and won ($0.60) with two pair, Aces and Eights
Seat 3: EfRs3ibIxn+c9JDErwwNCg folded before Flop (didn't bet)
Seat 4: OiV1PWZ3IkN29JlmCcnTwQ folded before Flop (didn't bet)
Seat 5: vKdukiQ4ktU4yJ0Xx3MKnA folded before Flop (didn't bet)
Seat 6: DnDcAdn9P0zGovMERigpFA folded before Flop (didn't bet)
Seat 7: COsrwJSFHQtxlUcrYtDQPQ (button) folded before Flop (didn't bet)
Seat 9: SXqVW4Q0evTUVZG6BbUNIA (small blind) folded before Flop




PokerStars Game #59939475138:  Hold'em No Limit ($0.10/$0.25) - 2009/07/01 0:40:50 ET
Table 'aT31tt16YvQM/Ue69HPLpA' 9-max Seat #6 is the button
Seat 1: uYY6p3irj4hBN7IeHiNGSw ($24.75 in chips) 
Seat 3: tYsOBqdU1+x+yFI7zHO7hQ ($26.65 in chips) 
Seat 4: s7Q6uNouhe7aE8JdFb9E+A ($25 in chips) 
Seat 5: cvtKnIIaTx2+P/KlOK+tfQ ($9.05 in chips) 
Seat 6: 7cv+9Zc9HIQHNvYsMfV3uA ($42.75 in chips) 
Seat 7: s8SPJjToEJz2mPsHsMqL0A ($6.10 in chips) 
Seat 8: lrTLp1zpuCCs/e0pi2M8jw ($44.85 in chips) 
Seat 9: SXqVW4Q0evTUVZG6BbUNIA ($30.75 in chips) 
s8SPJjToEJz2mPsHsMqL0A: posts small blind $0.10
lrTLp1zpuCCs/e0pi2M8jw: posts big blind $0.25
CYkY0dNBaYaKs8HVCVn3mQ: sits out 
*** HOLE CARDS ***
SXqVW4Q0evTUVZG6BbUNIA: raises $0.50 to $0.75
uYY6p3irj4hBN7IeHiNGSw: folds 
tYsOBqdU1+x+yFI7zHO7hQ: folds 
s7Q6uNouhe7aE8JdFb9E+A: folds 
cvtKnIIaTx2+P/KlOK+tfQ: calls $0.75
7cv+9Zc9HIQHNvYsMfV3uA: folds 
s8SPJjToEJz2mPsHsMqL0A: calls $0.65
lrTLp1zpuCCs/e0pi2M8jw: calls $0.50
*** FLOP *** [3c Ad Js]
s8SPJjToEJz2mPsHsMqL0A: checks 
lrTLp1zpuCCs/e0pi2M8jw: checks 
SXqVW4Q0evTUVZG6BbUNIA: checks 
cvtKnIIaTx2+P/KlOK+tfQ: bets $1.25
s8SPJjToEJz2mPsHsMqL0A: folds 
lrTLp1zpuCCs/e0pi2M8jw: folds 
SXqVW4Q0evTUVZG6BbUNIA: folds 
Uncalled bet ($1.25) returned to cvtKnIIaTx2+P/KlOK+tfQ
cvtKnIIaTx2+P/KlOK+tfQ collected $2.85 from pot
*** SUMMARY ***
Total pot $3 | Rake $0.15 
Board [3c Ad Js]
Seat 1: uYY6p3irj4hBN7IeHiNGSw folded before Flop (didn't bet)
Seat 3: tYsOBqdU1+x+yFI7zHO7hQ folded before Flop (didn't bet)
Seat 4: s7Q6uNouhe7aE8JdFb9E+A folded before Flop (didn't bet)
Seat 5: cvtKnIIaTx2+P/KlOK+tfQ collected ($2.85)
Seat 6: 7cv+9Zc9HIQHNvYsMfV3uA (button) folded before Flop (didn't bet)
Seat 7: s8SPJjToEJz2mPsHsMqL0A (small blind) folded on the Flop
Seat 8: lrTLp1zpuCCs/e0pi2M8jw (big blind) folded on the Flop
Seat 9: SXqVW4Q0evTUVZG6BbUNIA folded on the Flop




PokerStars Game #59939475072:  Hold'em No Limit ($0.10/$0.25) - 2009/07/01 0:40:50 ET
Table '2clPgY3+dETPD/8zjXZdFw' 6-max Seat #3 is the button
Seat 1: qllppsCmUqovlriIWCeM/g ($3.90 in chips) 
Seat 2: NzIFHwilc5zU7QhjDTgTZA ($7.60 in chips) 
Seat 3: 6pF9LtHn+EH0ChbOXzox9g ($5.10 in chips) 
Seat 4: 9KPR3sZ+CxRm7bQ8qxFzMQ ($2.75 in chips) 
9KPR3sZ+CxRm7bQ8qxFzMQ: posts small blind $0.10
qllppsCmUqovlriIWCeM/g: posts big blind $0.25
*** HOLE CARDS ***
NzIFHwilc5zU7QhjDTgTZA: folds 
6pF9LtHn+EH0ChbOXzox9g: calls $0.25
9KPR3sZ+CxRm7bQ8qxFzMQ: raises $0.75 to $1
qllppsCmUqovlriIWCeM/g: folds 
6pF9LtHn+EH0ChbOXzox9g: raises $2.25 to $3.25
9KPR3sZ+CxRm7bQ8qxFzMQ: calls $1.75 and is all-in
Uncalled bet ($0.50) returned to 6pF9LtHn+EH0ChbOXzox9g
*** FLOP *** [8s 2h Jc]
*** TURN *** [8s 2h Jc] [5c]
*** RIVER *** [8s 2h Jc 5c] [6h]
*** SHOW DOWN ***
9KPR3sZ+CxRm7bQ8qxFzMQ: shows [Qs Qd] (a pair of Queens)
6pF9LtHn+EH0ChbOXzox9g: mucks hand 
9KPR3sZ+CxRm7bQ8qxFzMQ collected $5.50 from pot
*** SUMMARY ***
Total pot $5.75 | Rake $0.25 
Board [8s 2h Jc 5c 6h]
Seat 1: qllppsCmUqovlriIWCeM/g (big blind) folded before Flop
Seat 2: NzIFHwilc5zU7QhjDTgTZA folded before Flop (didn't bet)
Seat 3: 6pF9LtHn+EH0ChbOXzox9g (button) mucked
Seat 4: 9KPR3sZ+CxRm7bQ8qxFzMQ (small blind) showed [Qs Qd] and won ($5.50) with a pair of Queens




PokerStars Game #59939475148:  Hold'em No Limit ($0.10/$0.25) - 2009/07/01 0:40:50 ET
Table 'v+LTGPWbrLum+Ggd4ef6lg' 9-max Seat #7 is the button
Seat 4: gGaFLzGESKP3Tj9N/K7QNA ($18.75 in chips) 
Seat 7: YEdelvffSYRP4EDNfFp4dA ($14.90 in chips) 
Seat 8: +sbyWwIcFp9kP0bDtMegfQ ($34.95 in chips) 
Seat 9: cFmpjvcjNoVAEAIQIxWkYg ($25 in chips) 
+sbyWwIcFp9kP0bDtMegfQ: posts small blind $0.10
cFmpjvcjNoVAEAIQIxWkYg: posts big blind $0.25
*** HOLE CARDS ***
gGaFLzGESKP3Tj9N/K7QNA: calls $0.25
YEdelvffSYRP4EDNfFp4dA: raises $0.25 to $0.50
+sbyWwIcFp9kP0bDtMegfQ: folds 
cFmpjvcjNoVAEAIQIxWkYg: folds 
gGaFLzGESKP3Tj9N/K7QNA: calls $0.25
*** FLOP *** [Jh Td 2h]
gGaFLzGESKP3Tj9N/K7QNA: folds 
YEdelvffSYRP4EDNfFp4dA collected $1.30 from pot
YEdelvffSYRP4EDNfFp4dA: doesn't show hand 
*** SUMMARY ***
Total pot $1.35 | Rake $0.05 
Board [Jh Td 2h]
Seat 4: gGaFLzGESKP3Tj9N/K7QNA folded on the Flop
Seat 7: YEdelvffSYRP4EDNfFp4dA (button) collected ($1.30)
Seat 8: +sbyWwIcFp9kP0bDtMegfQ (small blind) folded before Flop
Seat 9: cFmpjvcjNoVAEAIQIxWkYg (big blind) folded before Flop




PokerStars Game #59939475898:  Hold'em No Limit ($0.10/$0.25) - 2009/07/01 0:40:51 ET
Table 'CM/C/FZf3VHIp50RjmBucQ' 9-max Seat #8 is the button
Seat 1: 1Clf3cPrqoy/YgvWdWK1Xw ($5 in chips) 
Seat 2: 1S/fpm+f42V/6MNZre+ccg ($28.10 in chips) 
Seat 3: dfNim92Z6XK1/h5SFW5vDg ($29.75 in chips) 
Seat 4: oXv2YWrxjhmEfQAgUx964Q ($24.10 in chips) 
Seat 5: TeWJxSETzbXGiYKx0y+dtg ($36.80 in chips) 
Seat 6: 4awUyiDYTgylQKXZ9faBVA ($29.45 in chips) 
Seat 8: cZ99hugmLBj9KhTlc8nCSw ($26.15 in chips) 
Seat 9: Yv4fucyyT28mjx8V5lxKJg ($21.25 in chips) 
Yv4fucyyT28mjx8V5lxKJg: posts small blind $0.10
1Clf3cPrqoy/YgvWdWK1Xw: posts big blind $0.25
*** HOLE CARDS ***
1S/fpm+f42V/6MNZre+ccg: folds 
dfNim92Z6XK1/h5SFW5vDg: folds 
oXv2YWrxjhmEfQAgUx964Q: calls $0.25
TeWJxSETzbXGiYKx0y+dtg: folds 
4awUyiDYTgylQKXZ9faBVA: folds 
cZ99hugmLBj9KhTlc8nCSw: folds 
Yv4fucyyT28mjx8V5lxKJg: folds 
1Clf3cPrqoy/YgvWdWK1Xw: checks 
*** FLOP *** [Th 4d Qd]
1Clf3cPrqoy/YgvWdWK1Xw: checks 
j4q3p0lesp63b1gZDwLBZw joins the table at seat #7 
oXv2YWrxjhmEfQAgUx964Q: bets $1.25
1Clf3cPrqoy/YgvWdWK1Xw: folds 
Uncalled bet ($1.25) returned to oXv2YWrxjhmEfQAgUx964Q
oXv2YWrxjhmEfQAgUx964Q collected $0.60 from pot
oXv2YWrxjhmEfQAgUx964Q: doesn't show hand 
*** SUMMARY ***
Total pot $0.60 | Rake $0 
Board [Th 4d Qd]
Seat 1: 1Clf3cPrqoy/YgvWdWK1Xw (big blind) folded on the Flop
Seat 2: 1S/fpm+f42V/6MNZre+ccg folded before Flop (didn't bet)
Seat 3: dfNim92Z6XK1/h5SFW5vDg folded before Flop (didn't bet)
Seat 4: oXv2YWrxjhmEfQAgUx964Q collected ($0.60)
Seat 5: TeWJxSETzbXGiYKx0y+dtg folded before Flop (didn't bet)
Seat 6: 4awUyiDYTgylQKXZ9faBVA folded before Flop (didn't bet)
Seat 8: cZ99hugmLBj9KhTlc8nCSw (button) folded before Flop (didn't bet)
Seat 9: Yv4fucyyT28mjx8V5lxKJg (small blind) folded before Flop




PokerStars Game #59939476130:  Hold'em No Limit ($0.10/$0.25) - 2009/07/01 0:40:51 ET
Table '9HJEqVOjSU5ECoVB4C4sgQ' 6-max Seat #2 is the button
Seat 1: EyMmRrAOlNpDOWLqSYRZdw ($27.45 in chips) 
Seat 2: sEQx9G5Cu8k1HNdQasxvUA ($39.30 in chips) 
Seat 3: KM6ogk7SqyRlk3m9b0h+7A ($13.85 in chips) 
Seat 4: mfrkWA3PTeYPkbO6hi98Aw ($31.15 in chips) 
Seat 5: ymz+a8dgHSUFPooYplw7Ow ($24.75 in chips) 
Seat 6: aOMbOQ6Ji1Gie6dYOurd5A ($14.10 in chips) 
KM6ogk7SqyRlk3m9b0h+7A: posts small blind $0.10
mfrkWA3PTeYPkbO6hi98Aw: posts big blind $0.25
*** HOLE CARDS ***
ymz+a8dgHSUFPooYplw7Ow: folds 
aOMbOQ6Ji1Gie6dYOurd5A: folds 
EyMmRrAOlNpDOWLqSYRZdw: raises $0.50 to $0.75
sEQx9G5Cu8k1HNdQasxvUA: raises $2 to $2.75
KM6ogk7SqyRlk3m9b0h+7A: folds 
mfrkWA3PTeYPkbO6hi98Aw: folds 
EyMmRrAOlNpDOWLqSYRZdw: calls $2
*** FLOP *** [Td 4d 8s]
EyMmRrAOlNpDOWLqSYRZdw: checks 
sEQx9G5Cu8k1HNdQasxvUA: bets $2.50
EyMmRrAOlNpDOWLqSYRZdw: folds 
Uncalled bet ($2.50) returned to sEQx9G5Cu8k1HNdQasxvUA
sEQx9G5Cu8k1HNdQasxvUA collected $5.60 from pot
sEQx9G5Cu8k1HNdQasxvUA: doesn't show hand 
*** SUMMARY ***
Total pot $5.85 | Rake $0.25 
Board [Td 4d 8s]
Seat 1: EyMmRrAOlNpDOWLqSYRZdw folded on the Flop
Seat 2: sEQx9G5Cu8k1HNdQasxvUA (button) collected ($5.60)
Seat 3: KM6ogk7SqyRlk3m9b0h+7A (small blind) folded before Flop
Seat 4: mfrkWA3PTeYPkbO6hi98Aw (big blind) folded before Flop
Seat 5: ymz+a8dgHSUFPooYplw7Ow folded before Flop (didn't bet)
Seat 6: aOMbOQ6Ji1Gie6dYOurd5A folded before Flop (didn't bet)




PokerStars Game #59939475896:  Hold'em No Limit ($0.10/$0.25) - 2009/07/01 0:40:51 ET
Table 'O5NgMYt6EWbLBozZb3kseg' 6-max Seat #2 is the button
Seat 1: T2fEtpqj5ZyZAjEhNtsFAA ($40.80 in chips) 
Seat 2: VWbjqONyDvf8KegytgPLjQ ($61.40 in chips) 
Seat 4: aogAb4Eienxztk8p2v9VVw ($23.75 in chips) 
Seat 5: vu2kzHaDtgr6NM7rdq0chA ($43.50 in chips) 
Seat 6: k9vn40MOqqb+xF+7GZ6v2g ($22.85 in chips) 
aogAb4Eienxztk8p2v9VVw: posts small blind $0.10
vu2kzHaDtgr6NM7rdq0chA: posts big blind $0.25
*** HOLE CARDS ***
k9vn40MOqqb+xF+7GZ6v2g: calls $0.25
T2fEtpqj5ZyZAjEhNtsFAA: calls $0.25
VWbjqONyDvf8KegytgPLjQ: calls $0.25
dg3SMYXD7586yGx+LuFM0g has returned
aogAb4Eienxztk8p2v9VVw: calls $0.15
vu2kzHaDtgr6NM7rdq0chA: raises $1.75 to $2
k9vn40MOqqb+xF+7GZ6v2g: folds 
T2fEtpqj5ZyZAjEhNtsFAA: calls $1.75
VWbjqONyDvf8KegytgPLjQ: calls $1.75
aogAb4Eienxztk8p2v9VVw: folds 
*** FLOP *** [2d 4d 2h]
vu2kzHaDtgr6NM7rdq0chA: bets $5
T2fEtpqj5ZyZAjEhNtsFAA: folds 
VWbjqONyDvf8KegytgPLjQ: folds 
Uncalled bet ($5) returned to vu2kzHaDtgr6NM7rdq0chA
vu2kzHaDtgr6NM7rdq0chA collected $6.20 from pot
vu2kzHaDtgr6NM7rdq0chA: doesn't show hand 
*** SUMMARY ***
Total pot $6.50 | Rake $0.30 
Board [2d 4d 2h]
Seat 1: T2fEtpqj5ZyZAjEhNtsFAA folded on the Flop
Seat 2: VWbjqONyDvf8KegytgPLjQ (button) folded on the Flop
Seat 4: aogAb4Eienxztk8p2v9VVw (small blind) folded before Flop
Seat 5: vu2kzHaDtgr6NM7rdq0chA (big blind) collected ($6.20)
Seat 6: k9vn40MOqqb+xF+7GZ6v2g folded before Flop




PokerStars Game #59939476146:  Hold'em No Limit ($0.10/$0.25) - 2009/07/01 0:40:51 ET
Table 'sgdCtiuCu2BDZhyDi6RzTA' 6-max Seat #6 is the button
Seat 1: 3zD3qLXT1bEffAoWGnc7wg ($25 in chips) 
Seat 3: yzFNNFIfC89bBPwpFPx2ow ($15.35 in chips) 
Seat 4: rVKEgilmMX+EkKzDVvhmxA ($8.15 in chips) 
Seat 5: kD/Cb2UM93FAVgDMhEEb5g ($10 in chips) 
Seat 6: KODslGU8ikCYS0/29dUkhg ($9.60 in chips) 
3zD3qLXT1bEffAoWGnc7wg: posts small blind $0.10
yzFNNFIfC89bBPwpFPx2ow: posts big blind $0.25
*** HOLE CARDS ***
rVKEgilmMX+EkKzDVvhmxA: folds 
kD/Cb2UM93FAVgDMhEEb5g: folds 
KODslGU8ikCYS0/29dUkhg: folds 
3zD3qLXT1bEffAoWGnc7wg: folds 
Uncalled bet ($0.15) returned to yzFNNFIfC89bBPwpFPx2ow
yzFNNFIfC89bBPwpFPx2ow collected $0.20 from pot
yzFNNFIfC89bBPwpFPx2ow: doesn't show hand 
*** SUMMARY ***
Total pot $0.20 | Rake $0 
Seat 1: 3zD3qLXT1bEffAoWGnc7wg (small blind) folded before Flop
Seat 3: yzFNNFIfC89bBPwpFPx2ow (big blind) collected ($0.20)
Seat 4: rVKEgilmMX+EkKzDVvhmxA folded before Flop (didn't bet)
Seat 5: kD/Cb2UM93FAVgDMhEEb5g folded before Flop (didn't bet)
Seat 6: KODslGU8ikCYS0/29dUkhg (button) folded before Flop (didn't bet)




PokerStars Game #59939475660:  Hold'em No Limit ($0.10/$0.25) - 2009/07/01 0:40:51 ET
Table 'nc6OeGk/wtaWV+6N+kgnZQ' 6-max Seat #6 is the button
Seat 1: 0/FYfBoKhINaqU/H5OSS1A ($4 in chips) 
Seat 3: 8f0dtuUGqDbgE6up1lQAlg ($3.95 in chips) 
Seat 6: yJgjVkWgiJ8vdWZjcUod2A ($6.80 in chips) 
0/FYfBoKhINaqU/H5OSS1A: posts small blind $0.10
8f0dtuUGqDbgE6up1lQAlg: posts big blind $0.25
*** HOLE CARDS ***
yJgjVkWgiJ8vdWZjcUod2A: raises $0.50 to $0.75
0/FYfBoKhINaqU/H5OSS1A: calls $0.65
8f0dtuUGqDbgE6up1lQAlg: folds 
*** FLOP *** [Ac 6c Ts]
0/FYfBoKhINaqU/H5OSS1A: checks 
yJgjVkWgiJ8vdWZjcUod2A: bets $0.75
0/FYfBoKhINaqU/H5OSS1A: calls $0.75
*** TURN *** [Ac 6c Ts] [Td]
0/FYfBoKhINaqU/H5OSS1A: checks 
yJgjVkWgiJ8vdWZjcUod2A: bets $2.50
0/FYfBoKhINaqU/H5OSS1A: folds 
Uncalled bet ($2.50) returned to yJgjVkWgiJ8vdWZjcUod2A
yJgjVkWgiJ8vdWZjcUod2A collected $3.10 from pot
yJgjVkWgiJ8vdWZjcUod2A: doesn't show hand 
*** SUMMARY ***
Total pot $3.25 | Rake $0.15 
Board [Ac 6c Ts Td]
Seat 1: 0/FYfBoKhINaqU/H5OSS1A (small blind) folded on the Turn
Seat 3: 8f0dtuUGqDbgE6up1lQAlg (big blind) folded before Flop
Seat 6: yJgjVkWgiJ8vdWZjcUod2A (button) collected ($3.10)




PokerStars Game #59939476650:  Hold'em No Limit ($0.10/$0.25) - 2009/07/01 0:40:52 ET
Table 'VuY5ej47Cy8nOI3Wogmhzw' 6-max Seat #6 is the button
Seat 1: aXzmR7FhrqQSWNNmNfbVnw ($20.10 in chips) 
Seat 4: FC6tJ9EOiutXO8hnpR4VgQ ($6.90 in chips) 
Seat 6: +v0nBUereMsRzYp2Knh/cQ ($12.40 in chips) 
aXzmR7FhrqQSWNNmNfbVnw: posts small blind $0.10
FC6tJ9EOiutXO8hnpR4VgQ: posts big blind $0.25
*** HOLE CARDS ***
+v0nBUereMsRzYp2Knh/cQ: calls $0.25
aXzmR7FhrqQSWNNmNfbVnw: calls $0.15
FC6tJ9EOiutXO8hnpR4VgQ: checks 
*** FLOP *** [8c Qs 9c]
aXzmR7FhrqQSWNNmNfbVnw: checks 
FC6tJ9EOiutXO8hnpR4VgQ: checks 
+v0nBUereMsRzYp2Knh/cQ: checks 
*** TURN *** [8c Qs 9c] [3c]
aXzmR7FhrqQSWNNmNfbVnw: checks 
FC6tJ9EOiutXO8hnpR4VgQ: checks 
+v0nBUereMsRzYp2Knh/cQ: checks 
*** RIVER *** [8c Qs 9c 3c] [4c]
aXzmR7FhrqQSWNNmNfbVnw: checks 
FC6tJ9EOiutXO8hnpR4VgQ: checks 
+v0nBUereMsRzYp2Knh/cQ: checks 
*** SHOW DOWN ***
aXzmR7FhrqQSWNNmNfbVnw: shows [As 5s] (high card Ace)
FC6tJ9EOiutXO8hnpR4VgQ: mucks hand 
+v0nBUereMsRzYp2Knh/cQ: shows [4h Kd] (a pair of Fours)
+v0nBUereMsRzYp2Knh/cQ collected $0.75 from pot
*** SUMMARY ***
Total pot $0.75 | Rake $0 
Board [8c Qs 9c 3c 4c]
Seat 1: aXzmR7FhrqQSWNNmNfbVnw (small blind) showed [As 5s] and lost with high card Ace
Seat 4: FC6tJ9EOiutXO8hnpR4VgQ (big blind) mucked
Seat 6: +v0nBUereMsRzYp2Knh/cQ (button) showed [4h Kd] and won ($0.75) with a pair of Fours




PokerStars Game #59939476870:  Hold'em No Limit ($0.10/$0.25) - 2009/07/01 0:40:52 ET
Table 'OvOqQoL/QnXuXuQjXo2hIQ' 9-max Seat #4 is the button
Seat 1: Xbfvrzh7Jjg4vOZkdMSfbA ($17.50 in chips) 
Seat 3: uJlzv9KL7hgCIqIS2ofoaw ($16.65 in chips) 
Seat 4: e8solDZU6VFefGEm0DJbUg ($6.60 in chips) 
Seat 5: sJNHTWcSlLHRCZ9+YRLLqA ($28.70 in chips) 
Seat 6: MIVCHqCqqlke0Lb0z7glcw ($46.40 in chips) 
Seat 7: aNpwfA31EREwO+ar4XzBCw ($26.80 in chips) 
Seat 9: VWUWpMLMj/Q1jRVpF7Aohw ($14.60 in chips) 
sJNHTWcSlLHRCZ9+YRLLqA: posts small blind $0.10
MIVCHqCqqlke0Lb0z7glcw: posts big blind $0.25
*** HOLE CARDS ***
aNpwfA31EREwO+ar4XzBCw: folds 
VWUWpMLMj/Q1jRVpF7Aohw: folds 
Xbfvrzh7Jjg4vOZkdMSfbA: folds 
uJlzv9KL7hgCIqIS2ofoaw: folds 
e8solDZU6VFefGEm0DJbUg: folds 
e8solDZU6VFefGEm0DJbUg leaves the table
sJNHTWcSlLHRCZ9+YRLLqA: raises $0.50 to $0.75
MIVCHqCqqlke0Lb0z7glcw: folds 
Uncalled bet ($0.50) returned to sJNHTWcSlLHRCZ9+YRLLqA
sJNHTWcSlLHRCZ9+YRLLqA collected $0.50 from pot
sJNHTWcSlLHRCZ9+YRLLqA: doesn't show hand 
*** SUMMARY ***
Total pot $0.50 | Rake $0 
Seat 1: Xbfvrzh7Jjg4vOZkdMSfbA folded before Flop (didn't bet)
Seat 3: uJlzv9KL7hgCIqIS2ofoaw folded before Flop (didn't bet)
Seat 4: e8solDZU6VFefGEm0DJbUg (button) folded before Flop (didn't bet)
Seat 5: sJNHTWcSlLHRCZ9+YRLLqA (small blind) collected ($0.50)
Seat 6: MIVCHqCqqlke0Lb0z7glcw (big blind) folded before Flop
Seat 7: aNpwfA31EREwO+ar4XzBCw folded before Flop (didn't bet)
Seat 9: VWUWpMLMj/Q1jRVpF7Aohw folded before Flop (didn't bet)




PokerStars Game #59939476498:  Hold'em No Limit ($0.10/$0.25) - 2009/07/01 0:40:52 ET
Table 'sm5gqEvXgLbkkE4dryW/5g' 6-max Seat #2 is the button
Seat 1: gaPMxLGp9SOj4Lq6t+/0Ig ($13.35 in chips) 
Seat 2: s13YXIlhF/j3TO0bSnT7bA ($18.80 in chips) 
Seat 3: I1TxPvWj8NfG8orglCinNA ($25.10 in chips) 
Seat 4: BedjMfrlRfPgSq7CXpPAmg ($58 in chips) 
Seat 5: M+WmDyCD/ZMu/5t6/iH2kw ($73.75 in chips) 
Seat 6: wKFJ513ucluNNiMlkXcDOQ ($25 in chips) 
I1TxPvWj8NfG8orglCinNA: posts small blind $0.10
BedjMfrlRfPgSq7CXpPAmg: posts big blind $0.25
*** HOLE CARDS ***
M+WmDyCD/ZMu/5t6/iH2kw: folds 
wKFJ513ucluNNiMlkXcDOQ: folds 
gaPMxLGp9SOj4Lq6t+/0Ig: folds 
s13YXIlhF/j3TO0bSnT7bA: folds 
I1TxPvWj8NfG8orglCinNA: raises $0.75 to $1
BedjMfrlRfPgSq7CXpPAmg: folds 
Uncalled bet ($0.75) returned to I1TxPvWj8NfG8orglCinNA
I1TxPvWj8NfG8orglCinNA collected $0.50 from pot
I1TxPvWj8NfG8orglCinNA: doesn't show hand 
*** SUMMARY ***
Total pot $0.50 | Rake $0 
Seat 1: gaPMxLGp9SOj4Lq6t+/0Ig folded before Flop (didn't bet)
Seat 2: s13YXIlhF/j3TO0bSnT7bA (button) folded before Flop (didn't bet)
Seat 3: I1TxPvWj8NfG8orglCinNA (small blind) collected ($0.50)
Seat 4: BedjMfrlRfPgSq7CXpPAmg (big blind) folded before Flop
Seat 5: M+WmDyCD/ZMu/5t6/iH2kw folded before Flop (didn't bet)
Seat 6: wKFJ513ucluNNiMlkXcDOQ folded before Flop (didn't bet)




PokerStars Game #59939476692:  Hold'em No Limit ($0.10/$0.25) - 2009/07/01 0:40:52 ET
Table 'S6s+TmTlAjLHclBRvN5/fw' 9-max Seat #1 is the button
Seat 1: /XMgGtJ7mcWfe5s7McY9kw ($24.60 in chips) 
Seat 2: GGVjFwYkbwsuyKljxyML4g ($11.75 in chips) 
Seat 3: imHPFFqvfHGzsBBWeGuy4w ($20.95 in chips) 
Seat 4: M/9j4wkHH9i1JM51vgi1VA ($38.95 in chips) 
Seat 5: z5GxcHlYz/GSz6W2uFiTtg ($25.05 in chips) 
Seat 6: aNpwfA31EREwO+ar4XzBCw ($25.20 in chips) 
Seat 7: vSkQm2EelzwRGDDQQk0Fqw ($5.65 in chips) 
Seat 9: BODayQmPi2rEfae9e6hIlw ($28.80 in chips) 
GGVjFwYkbwsuyKljxyML4g: posts small blind $0.10
imHPFFqvfHGzsBBWeGuy4w: posts big blind $0.25
*** HOLE CARDS ***
M/9j4wkHH9i1JM51vgi1VA: folds 
z5GxcHlYz/GSz6W2uFiTtg: folds 
aNpwfA31EREwO+ar4XzBCw: folds 
vSkQm2EelzwRGDDQQk0Fqw: folds 
BODayQmPi2rEfae9e6hIlw: folds 
/XMgGtJ7mcWfe5s7McY9kw: folds 
GGVjFwYkbwsuyKljxyML4g: folds 
Uncalled bet ($0.15) returned to imHPFFqvfHGzsBBWeGuy4w
imHPFFqvfHGzsBBWeGuy4w collected $0.20 from pot
imHPFFqvfHGzsBBWeGuy4w: doesn't show hand 
*** SUMMARY ***
Total pot $0.20 | Rake $0 
Seat 1: /XMgGtJ7mcWfe5s7McY9kw (button) folded before Flop (didn't bet)
Seat 2: GGVjFwYkbwsuyKljxyML4g (small blind) folded before Flop
Seat 3: imHPFFqvfHGzsBBWeGuy4w (big blind) collected ($0.20)
Seat 4: M/9j4wkHH9i1JM51vgi1VA folded before Flop (didn't bet)
Seat 5: z5GxcHlYz/GSz6W2uFiTtg folded before Flop (didn't bet)
Seat 6: aNpwfA31EREwO+ar4XzBCw folded before Flop (didn't bet)
Seat 7: vSkQm2EelzwRGDDQQk0Fqw folded before Flop (didn't bet)
Seat 9: BODayQmPi2rEfae9e6hIlw folded before Flop (didn't bet)




PokerStars Game #59939476912:  Hold'em No Limit ($0.10/$0.25) - 2009/07/01 0:40:52 ET
Table 'a6FCGVBMPcT7J7BDN9q1zQ' 9-max Seat #9 is the button
Seat 1: s7Q6uNouhe7aE8JdFb9E+A ($43.60 in chips) 
Seat 2: h4ggJZYBXV0mEZzYPYKfeA ($34.85 in chips) 
Seat 3: hIss79a4pu7GzJZepfgOpg ($25 in chips) 
Seat 5: JJk2ZoH7BSGLAgqFUL5pMg ($2.40 in chips) 
Seat 6: Z9AeOQX3yzuSvKAm/xyovg ($9.65 in chips) 
Seat 7: V0Yo5zRBVM8DYspLKafebg ($24.30 in chips) 
Seat 8: r6hsffOo1iKmaPYKwAZmFw ($51.35 in chips) 
Seat 9: WwcXelmo9g129XJixVb2NA ($14.25 in chips) 
s7Q6uNouhe7aE8JdFb9E+A: posts small blind $0.10
h4ggJZYBXV0mEZzYPYKfeA: posts big blind $0.25
ydoFOVgzvZv9ZhuWu9rXAw: sits out 
*** HOLE CARDS ***
hIss79a4pu7GzJZepfgOpg: folds 
JJk2ZoH7BSGLAgqFUL5pMg: folds 
Z9AeOQX3yzuSvKAm/xyovg: folds 
V0Yo5zRBVM8DYspLKafebg: calls $0.25
r6hsffOo1iKmaPYKwAZmFw: raises $1 to $1.25
WwcXelmo9g129XJixVb2NA: raises $1.50 to $2.75
s7Q6uNouhe7aE8JdFb9E+A has timed out
s7Q6uNouhe7aE8JdFb9E+A: folds 
s7Q6uNouhe7aE8JdFb9E+A is sitting out
h4ggJZYBXV0mEZzYPYKfeA: folds 
s7Q6uNouhe7aE8JdFb9E+A has returned
V0Yo5zRBVM8DYspLKafebg: folds 
r6hsffOo1iKmaPYKwAZmFw: folds 
Uncalled bet ($1.50) returned to WwcXelmo9g129XJixVb2NA
WwcXelmo9g129XJixVb2NA collected $3.10 from pot
WwcXelmo9g129XJixVb2NA: doesn't show hand 
*** SUMMARY ***
Total pot $3.10 | Rake $0 
Seat 1: s7Q6uNouhe7aE8JdFb9E+A (small blind) folded before Flop
Seat 2: h4ggJZYBXV0mEZzYPYKfeA (big blind) folded before Flop
Seat 3: hIss79a4pu7GzJZepfgOpg folded before Flop (didn't bet)
Seat 5: JJk2ZoH7BSGLAgqFUL5pMg folded before Flop (didn't bet)
Seat 6: Z9AeOQX3yzuSvKAm/xyovg folded before Flop (didn't bet)
Seat 7: V0Yo5zRBVM8DYspLKafebg folded before Flop
Seat 8: r6hsffOo1iKmaPYKwAZmFw folded before Flop
Seat 9: WwcXelmo9g129XJixVb2NA (button) collected ($3.10)




PokerStars Game #59939476390:  Hold'em No Limit ($0.10/$0.25) - 2009/07/01 0:40:52 ET
Table 'sSe6q4YTb/iS19t2eCFdsA' 9-max Seat #5 is the button
Seat 1: 5z3YkZTfH2GjoLK+6X7z2w ($11.55 in chips) 
Seat 2: rUpvA02nErFvZ4yFbDR8XA ($28.10 in chips) 
Seat 3: hBMUlEpyU74r/fwDgIpXjQ ($26.20 in chips) 
Seat 4: SXqVW4Q0evTUVZG6BbUNIA ($15.85 in chips) 
Seat 5: qS+jfnNoG75bT+uQ8CKhQA ($10.65 in chips) 
Seat 6: tYsOBqdU1+x+yFI7zHO7hQ ($26.15 in chips) 
Seat 7: t70KGeRtR3naHSqKDixsUg ($13.80 in chips) 
Seat 8: jeKWRUkMaVn8rEUjnJKqpg ($27.40 in chips) 
Seat 9: 4oA316mXLIui1QY63GXBUg ($25.60 in chips) 
tYsOBqdU1+x+yFI7zHO7hQ: posts small blind $0.10
t70KGeRtR3naHSqKDixsUg: posts big blind $0.25
*** HOLE CARDS ***
jeKWRUkMaVn8rEUjnJKqpg: folds 
4oA316mXLIui1QY63GXBUg: folds 
5z3YkZTfH2GjoLK+6X7z2w: folds 
rUpvA02nErFvZ4yFbDR8XA: folds 
hBMUlEpyU74r/fwDgIpXjQ: folds 
SXqVW4Q0evTUVZG6BbUNIA: folds 
qS+jfnNoG75bT+uQ8CKhQA: folds 
tYsOBqdU1+x+yFI7zHO7hQ: folds 
Uncalled bet ($0.15) returned to t70KGeRtR3naHSqKDixsUg
t70KGeRtR3naHSqKDixsUg collected $0.20 from pot
*** SUMMARY ***
Total pot $0.20 | Rake $0 
Seat 1: 5z3YkZTfH2GjoLK+6X7z2w folded before Flop (didn't bet)
Seat 2: rUpvA02nErFvZ4yFbDR8XA folded before Flop (didn't bet)
Seat 3: hBMUlEpyU74r/fwDgIpXjQ folded before Flop (didn't bet)
Seat 4: SXqVW4Q0evTUVZG6BbUNIA folded before Flop (didn't bet)
Seat 5: qS+jfnNoG75bT+uQ8CKhQA (button) folded before Flop (didn't bet)
Seat 6: tYsOBqdU1+x+yFI7zHO7hQ (small blind) folded before Flop
Seat 7: t70KGeRtR3naHSqKDixsUg (big blind) collected ($0.20)
Seat 8: jeKWRUkMaVn8rEUjnJKqpg folded before Flop (didn't bet)
Seat 9: 4oA316mXLIui1QY63GXBUg folded before Flop (didn't bet)




PokerStars Game #59939477492:  Hold'em No Limit ($0.10/$0.25) - 2009/07/01 0:40:53 ET
Table 'i8VqsSY3xDtJ63IHleN8+A' 9-max Seat #1 is the button
Seat 1: D3XCkXRktDfPlSguxwfnRA ($14.65 in chips) 
Seat 2: SXqVW4Q0evTUVZG6BbUNIA ($46.75 in chips) 
Seat 3: HPEB+AtKw1+C/cxU0o1ciw ($56.20 in chips) 
Seat 4: G2offPrpnppc++nuXqs2JA ($15.15 in chips) 
Seat 5: DIBbjEYGs+TVdVgEB/4+3w ($24.90 in chips) 
Seat 6: Xpyqpb+DURDWnyJ3xTEIFQ ($24.75 in chips) 
Seat 7: j4q3p0lesp63b1gZDwLBZw ($6 in chips) 
Seat 8: 5MgYq10OC5iGoxQFwlJVuw ($12.70 in chips) 
Seat 9: vSkQm2EelzwRGDDQQk0Fqw ($7.20 in chips) 
SXqVW4Q0evTUVZG6BbUNIA: posts small blind $0.10
HPEB+AtKw1+C/cxU0o1ciw: posts big blind $0.25
*** HOLE CARDS ***
G2offPrpnppc++nuXqs2JA: folds 
DIBbjEYGs+TVdVgEB/4+3w: folds 
Xpyqpb+DURDWnyJ3xTEIFQ: folds 
j4q3p0lesp63b1gZDwLBZw: folds 
5MgYq10OC5iGoxQFwlJVuw: folds 
vSkQm2EelzwRGDDQQk0Fqw: folds 
D3XCkXRktDfPlSguxwfnRA: calls $0.25
SXqVW4Q0evTUVZG6BbUNIA: calls $0.15
HPEB+AtKw1+C/cxU0o1ciw: checks 
*** FLOP *** [Qs 6c Kh]
SXqVW4Q0evTUVZG6BbUNIA: checks 
HPEB+AtKw1+C/cxU0o1ciw: checks 
D3XCkXRktDfPlSguxwfnRA: bets $0.75
SXqVW4Q0evTUVZG6BbUNIA: folds 
HPEB+AtKw1+C/cxU0o1ciw: folds 
Uncalled bet ($0.75) returned to D3XCkXRktDfPlSguxwfnRA
D3XCkXRktDfPlSguxwfnRA collected $0.75 from pot
*** SUMMARY ***
Total pot $0.75 | Rake $0 
Board [Qs 6c Kh]
Seat 1: D3XCkXRktDfPlSguxwfnRA (button) collected ($0.75)
Seat 2: SXqVW4Q0evTUVZG6BbUNIA (small blind) folded on the Flop
Seat 3: HPEB+AtKw1+C/cxU0o1ciw (big blind) folded on the Flop
Seat 4: G2offPrpnppc++nuXqs2JA folded before Flop (didn't bet)
Seat 5: DIBbjEYGs+TVdVgEB/4+3w folded before Flop (didn't bet)
Seat 6: Xpyqpb+DURDWnyJ3xTEIFQ folded before Flop (didn't bet)
Seat 7: j4q3p0lesp63b1gZDwLBZw folded before Flop (didn't bet)
Seat 8: 5MgYq10OC5iGoxQFwlJVuw folded before Flop (didn't bet)
Seat 9: vSkQm2EelzwRGDDQQk0Fqw folded before Flop (didn't bet)




PokerStars Game #59939477122:  Hold'em No Limit ($0.10/$0.25) - 2009/07/01 0:40:53 ET
Table 'IIO2q2znuuAXmiZ2qFTcmgiHlyuN1lFZ6WTlMBiiMYXAx Seat #2 is the button
Seat 2: R6nIVAjK7uhK3Hj0f85A+A ($29.10 in chips) 
Seat 3: QGjA4xtpxSpgzm+HC+ps4w ($22 in chips) 
Seat 4: z5GxcHlYz/GSz6W2uFiTtg ($24 in chips) 
Seat 5: 6LFELL8V3NTpb0xg7AOyEg ($12.70 in chips) 
Seat 6: M2QO2DxB5Wawg2h8HSpnYA ($13.95 in chips) 
Seat 7: gehe91e0IyVT0QU/XBkEyg ($33.50 in chips) 
Seat 8: TeWJxSETzbXGiYKx0y+dtg ($24.55 in chips) 
Seat 9: PqvgxdSg9z5VmrWpbYuz+g ($23.20 in chips) 
QGjA4xtpxSpgzm+HC+ps4w: posts small blind $0.10
z5GxcHlYz/GSz6W2uFiTtg: posts big blind $0.25
*** HOLE CARDS ***
6LFELL8V3NTpb0xg7AOyEg: folds 
M2QO2DxB5Wawg2h8HSpnYA: folds 
6LFELL8V3NTpb0xg7AOyEg leaves the table
gehe91e0IyVT0QU/XBkEyg: folds 
TeWJxSETzbXGiYKx0y+dtg: folds 
PqvgxdSg9z5VmrWpbYuz+g: folds 
PqvgxdSg9z5VmrWpbYuz+g said, "****face"
R6nIVAjK7uhK3Hj0f85A+A: folds 
QGjA4xtpxSpgzm+HC+ps4w: calls $0.15
z5GxcHlYz/GSz6W2uFiTtg: checks 
*** FLOP *** [2h Jc 9d]
PqvgxdSg9z5VmrWpbYuz+g leaves the table
QGjA4xtpxSpgzm+HC+ps4w: checks 
z5GxcHlYz/GSz6W2uFiTtg: checks 
*** TURN *** [2h Jc 9d] [4h]
QGjA4xtpxSpgzm+HC+ps4w: checks 
z5GxcHlYz/GSz6W2uFiTtg: checks 
*** RIVER *** [2h Jc 9d 4h] [2c]
QGjA4xtpxSpgzm+HC+ps4w: checks 
z5GxcHlYz/GSz6W2uFiTtg: checks 
*** SHOW DOWN ***
QGjA4xtpxSpgzm+HC+ps4w: shows [5s Qd] (a pair of Deuces)
z5GxcHlYz/GSz6W2uFiTtg: shows [6c 4d] (two pair, Fours and Deuces)
z5GxcHlYz/GSz6W2uFiTtg collected $0.50 from pot
*** SUMMARY ***
Total pot $0.50 | Rake $0 
Board [2h Jc 9d 4h 2c]
Seat 2: R6nIVAjK7uhK3Hj0f85A+A (button) folded before Flop (didn't bet)
Seat 3: QGjA4xtpxSpgzm+HC+ps4w (small blind) showed [5s Qd] and lost with a pair of Deuces
Seat 4: z5GxcHlYz/GSz6W2uFiTtg (big blind) showed [6c 4d] and won ($0.50) with two pair, Fours and Deuces
Seat 5: 6LFELL8V3NTpb0xg7AOyEg folded before Flop (didn't bet)
Seat 6: M2QO2DxB5Wawg2h8HSpnYA folded before Flop (didn't bet)
Seat 7: gehe91e0IyVT0QU/XBkEyg folded before Flop (didn't bet)
Seat 8: TeWJxSETzbXGiYKx0y+dtg folded before Flop (didn't bet)
Seat 9: PqvgxdSg9z5VmrWpbYuz+g folded before Flop (didn't bet)




PokerStars Game #59939477384:  Hold'em No Limit ($0.10/$0.25) - 2009/07/01 0:40:53 ET
Table 'KAnP7XvDtlku47YfJwdOVw' 9-max Seat #9 is the button
Seat 1: sJNHTWcSlLHRCZ9+YRLLqA ($33.30 in chips) 
Seat 2: CYkY0dNBaYaKs8HVCVn3mQ ($5 in chips) 
Seat 3: 7qgCOBwxmRRmkppeMkqy0Q ($7.40 in chips) 
Seat 5: MG90wfSJZnOejs/KD3vlQQ ($31.20 in chips) 
Seat 6: z5GxcHlYz/GSz6W2uFiTtg ($26.20 in chips) 
Seat 7: Lro4e37x4FUa5P3yzDjskw ($9.90 in chips) 
Seat 8: 3fPCxL5JUJVUL3eETYhxQQ ($8.90 in chips) 
Seat 9: qwr38jl5txoR36M7G5qi4A ($9.30 in chips) 
sJNHTWcSlLHRCZ9+YRLLqA: posts small blind $0.10
CYkY0dNBaYaKs8HVCVn3mQ: posts big blind $0.25
IrishMike123: sits out 
*** HOLE CARDS ***
7qgCOBwxmRRmkppeMkqy0Q: folds 
MG90wfSJZnOejs/KD3vlQQ: folds 
z5GxcHlYz/GSz6W2uFiTtg: calls $0.25
Lro4e37x4FUa5P3yzDjskw: folds 
3fPCxL5JUJVUL3eETYhxQQ: folds 
qwr38jl5txoR36M7G5qi4A: raises $1 to $1.25
sJNHTWcSlLHRCZ9+YRLLqA: raises $3.05 to $4.30
CYkY0dNBaYaKs8HVCVn3mQ: folds 
z5GxcHlYz/GSz6W2uFiTtg: folds 
qwr38jl5txoR36M7G5qi4A: calls $3.05
*** FLOP *** [5s 3d 6s]
sJNHTWcSlLHRCZ9+YRLLqA: bets $8.60
qwr38jl5txoR36M7G5qi4A: calls $5 and is all-in
Uncalled bet ($3.60) returned to sJNHTWcSlLHRCZ9+YRLLqA
*** TURN *** [5s 3d 6s] [6c]
*** RIVER *** [5s 3d 6s 6c] [4d]
*** SHOW DOWN ***
sJNHTWcSlLHRCZ9+YRLLqA: shows [Ks Ac] (a pair of Sixes)
qwr38jl5txoR36M7G5qi4A: shows [Qd Qh] (two pair, Queens and Sixes)
qwr38jl5txoR36M7G5qi4A collected $18.20 from pot
*** SUMMARY ***
Total pot $19.10 | Rake $0.90 
Board [5s 3d 6s 6c 4d]
Seat 1: sJNHTWcSlLHRCZ9+YRLLqA (small blind) showed [Ks Ac] and lost with a pair of Sixes
Seat 2: CYkY0dNBaYaKs8HVCVn3mQ (big blind) folded before Flop
Seat 3: 7qgCOBwxmRRmkppeMkqy0Q folded before Flop (didn't bet)
Seat 5: MG90wfSJZnOejs/KD3vlQQ folded before Flop (didn't bet)
Seat 6: z5GxcHlYz/GSz6W2uFiTtg folded before Flop
Seat 7: Lro4e37x4FUa5P3yzDjskw folded before Flop (didn't bet)
Seat 8: 3fPCxL5JUJVUL3eETYhxQQ folded before Flop (didn't bet)
Seat 9: qwr38jl5txoR36M7G5qi4A (button) showed [Qd Qh] and won ($18.20) with two pair, Queens and Sixes




PokerStars Game #59939477244:  Hold'em No Limit ($0.10/$0.25) - 2009/07/01 0:40:53 ET
Table 'srBTB98reCdD1TffxE6o7g' 6-max Seat #1 is the button
Seat 1: FEzezmgaiyVRh9sHKhd+9Q ($43.90 in chips) 
Seat 2: YaAEMJGY5tem39deCUQRNw ($57.35 in chips) 
Seat 3: 4YSTu0Cdzpppe1lUgCZGCQ ($31.60 in chips) 
Seat 5: n2OZezRXTtdzQt4SuIy8TQ ($35.80 in chips) 
YaAEMJGY5tem39deCUQRNw: posts small blind $0.10
gaPMxLGp9SOj4Lq6t+/0Ig has returned
4YSTu0Cdzpppe1lUgCZGCQ: posts big blind $0.25
6DwBRH+xZ12AAZmeAg+aXw: sits out 
*** HOLE CARDS ***
n2OZezRXTtdzQt4SuIy8TQ: folds 
FEzezmgaiyVRh9sHKhd+9Q: folds 
YaAEMJGY5tem39deCUQRNw: calls $0.15
4YSTu0Cdzpppe1lUgCZGCQ: checks 
*** FLOP *** [Ts Kh Ks]
YaAEMJGY5tem39deCUQRNw: checks 
4YSTu0Cdzpppe1lUgCZGCQ: checks 
*** TURN *** [Ts Kh Ks] [Js]
YaAEMJGY5tem39deCUQRNw: checks 
4YSTu0Cdzpppe1lUgCZGCQ: checks 
*** RIVER *** [Ts Kh Ks Js] [Qc]
YaAEMJGY5tem39deCUQRNw: bets $0.25
4YSTu0Cdzpppe1lUgCZGCQ: folds 
Uncalled bet ($0.25) returned to YaAEMJGY5tem39deCUQRNw
YaAEMJGY5tem39deCUQRNw collected $0.50 from pot
YaAEMJGY5tem39deCUQRNw: doesn't show hand 
*** SUMMARY ***
Total pot $0.50 | Rake $0 
Board [Ts Kh Ks Js Qc]
Seat 1: FEzezmgaiyVRh9sHKhd+9Q (button) folded before Flop (didn't bet)
Seat 2: YaAEMJGY5tem39deCUQRNw (small blind) collected ($0.50)
Seat 3: 4YSTu0Cdzpppe1lUgCZGCQ (big blind) folded on the River
Seat 5: n2OZezRXTtdzQt4SuIy8TQ folded before Flop (didn't bet)




PokerStars Game #59939477160:  Hold'em No Limit ($0.10/$0.25) - 2009/07/01 0:40:53 ET
Table '/XCUCUl3yW6tdTJQEhJKGw' 6-max Seat #3 is the button
Seat 1: p8J112JmNRnCwV2+NAEzCA ($15.30 in chips) 
Seat 2: 8ClCHtFXGNplITm+63KB+Q ($27.95 in chips) 
Seat 3: /gJNBeCkWL4o85/jvlZ4BA ($36.25 in chips) 
Seat 4: SFmT9ZsVopnukjvAzrxTRg ($25 in chips) 
Seat 5: 3rlIjSrvbZoI2IILbnetnA ($25 in chips) 
Seat 6: armfxZhGxeZVZBYAQFuIJQ ($36.45 in chips) 
SFmT9ZsVopnukjvAzrxTRg: posts small blind $0.10
3rlIjSrvbZoI2IILbnetnA: posts big blind $0.25
*** HOLE CARDS ***
armfxZhGxeZVZBYAQFuIJQ: folds 
p8J112JmNRnCwV2+NAEzCA: folds 
8ClCHtFXGNplITm+63KB+Q: folds 
/gJNBeCkWL4o85/jvlZ4BA: raises $0.75 to $1
SFmT9ZsVopnukjvAzrxTRg: folds 
3rlIjSrvbZoI2IILbnetnA: folds 
Uncalled bet ($0.75) returned to /gJNBeCkWL4o85/jvlZ4BA
/gJNBeCkWL4o85/jvlZ4BA collected $0.60 from pot
*** SUMMARY ***
Total pot $0.60 | Rake $0 
Seat 1: p8J112JmNRnCwV2+NAEzCA folded before Flop (didn't bet)
Seat 2: 8ClCHtFXGNplITm+63KB+Q folded before Flop (didn't bet)
Seat 3: /gJNBeCkWL4o85/jvlZ4BA (button) collected ($0.60)
Seat 4: SFmT9ZsVopnukjvAzrxTRg (small blind) folded before Flop
Seat 5: 3rlIjSrvbZoI2IILbnetnA (big blind) folded before Flop
Seat 6: armfxZhGxeZVZBYAQFuIJQ folded before Flop (didn't bet)




PokerStars Game #59939477694:  Hold'em No Limit ($0.10/$0.25) - 2009/07/01 0:40:54 ET
Table 'sIHZ0lzLr4NGCaBUKhmYhAJj2eLzVCUVAGBmM+Og79iQax Seat #9 is the button
Seat 1: /XMgGtJ7mcWfe5s7McY9kw ($41.50 in chips) 
Seat 2: oMxwMC7+uAsJudeUN6aP0A ($19.10 in chips) 
Seat 3: HPEB+AtKw1+C/cxU0o1ciw ($24.05 in chips) 
Seat 4: aNpwfA31EREwO+ar4XzBCw ($47.05 in chips) 
Seat 5: UOx+/JnFB2Or6ZU9oasIlQ ($16.40 in chips) 
Seat 6: ZeR3hkj1gVv9J4yPCmRrjA ($32 in chips) 
Seat 9: wU1LtrccnZo6PYKhlJ6ElQ ($36.35 in chips) 
/XMgGtJ7mcWfe5s7McY9kw: posts small blind $0.10
oMxwMC7+uAsJudeUN6aP0A: posts big blind $0.25
18G4P1XstjNvItdGUITxgw: sits out 
*** HOLE CARDS ***
HPEB+AtKw1+C/cxU0o1ciw: folds 
aNpwfA31EREwO+ar4XzBCw: folds 
UOx+/JnFB2Or6ZU9oasIlQ: folds 
ZeR3hkj1gVv9J4yPCmRrjA: folds 
wU1LtrccnZo6PYKhlJ6ElQ: folds 
/XMgGtJ7mcWfe5s7McY9kw: folds 
Uncalled bet ($0.15) returned to oMxwMC7+uAsJudeUN6aP0A
oMxwMC7+uAsJudeUN6aP0A collected $0.20 from pot
oMxwMC7+uAsJudeUN6aP0A: doesn't show hand 
*** SUMMARY ***
Total pot $0.20 | Rake $0 
Seat 1: /XMgGtJ7mcWfe5s7McY9kw (small blind) folded before Flop
Seat 2: oMxwMC7+uAsJudeUN6aP0A (big blind) collected ($0.20)
Seat 3: HPEB+AtKw1+C/cxU0o1ciw folded before Flop (didn't bet)
Seat 4: aNpwfA31EREwO+ar4XzBCw folded before Flop (didn't bet)
Seat 5: UOx+/JnFB2Or6ZU9oasIlQ folded before Flop (didn't bet)
Seat 6: ZeR3hkj1gVv9J4yPCmRrjA folded before Flop (didn't bet)
Seat 9: wU1LtrccnZo6PYKhlJ6ElQ (button) folded before Flop (didn't bet)




PokerStars Game #59939477588:  Hold'em No Limit ($0.10/$0.25) - 2009/07/01 0:40:54 ET
Table 'Zi9/NqNs3XoL1eWhMCyZyg' 9-max Seat #4 is the button
Seat 2: Th3FldXKQW6hWVVPahaoOQ ($31.05 in chips) 
Seat 3: rUpvA02nErFvZ4yFbDR8XA ($21.65 in chips) 
Seat 4: D3XCkXRktDfPlSguxwfnRA ($13 in chips) 
Seat 5: OiV1PWZ3IkN29JlmCcnTwQ ($5 in chips) 
Seat 6: b3P5tPsBbrP+aAO9+Ts/Nw ($37.85 in chips) 
Seat 7: qul+IMROTuFj45eWi2Tpvg ($48.75 in chips) 
Seat 9: tYsOBqdU1+x+yFI7zHO7hQ ($31.10 in chips) 
OiV1PWZ3IkN29JlmCcnTwQ: posts small blind $0.10
b3P5tPsBbrP+aAO9+Ts/Nw: posts big blind $0.25
opOCI2p6kW0tINuVaAqmcQ: sits out 
*** HOLE CARDS ***
qul+IMROTuFj45eWi2Tpvg: raises $0.75 to $1
tYsOBqdU1+x+yFI7zHO7hQ: folds 
Th3FldXKQW6hWVVPahaoOQ: folds 
rUpvA02nErFvZ4yFbDR8XA: folds 
D3XCkXRktDfPlSguxwfnRA: folds 
OiV1PWZ3IkN29JlmCcnTwQ: folds 
b3P5tPsBbrP+aAO9+Ts/Nw: folds 
Uncalled bet ($0.75) returned to qul+IMROTuFj45eWi2Tpvg
qul+IMROTuFj45eWi2Tpvg collected $0.60 from pot
*** SUMMARY ***
Total pot $0.60 | Rake $0 
Seat 2: Th3FldXKQW6hWVVPahaoOQ folded before Flop (didn't bet)
Seat 3: rUpvA02nErFvZ4yFbDR8XA folded before Flop (didn't bet)
Seat 4: D3XCkXRktDfPlSguxwfnRA (button) folded before Flop (didn't bet)
Seat 5: OiV1PWZ3IkN29JlmCcnTwQ (small blind) folded before Flop
Seat 6: b3P5tPsBbrP+aAO9+Ts/Nw (big blind) folded before Flop
Seat 7: qul+IMROTuFj45eWi2Tpvg collected ($0.60)
Seat 9: tYsOBqdU1+x+yFI7zHO7hQ folded before Flop (didn't bet)




PokerStars Game #59939477870:  Hold'em No Limit ($0.10/$0.25) - 2009/07/01 0:40:54 ET
Table 'IIO2q2znuuAXmiZ2qFTcmg' 6-max Seat #4 is the button
Seat 1: nwwpaieDRI0UPyVtChVHOg ($18.10 in chips) 
Seat 2: cS21pIxRHx5Gt42o7hPZzw ($15.55 in chips) 
Seat 3: hiTEr3yrERiQp3zHXRioVw ($14.40 in chips) 
Seat 4: 0HIrwssk0FQvyKULzUTtlg ($9.75 in chips) 
Seat 5: f9iRHw0d+kV7pbTYwF2+2g ($17.55 in chips) 
f9iRHw0d+kV7pbTYwF2+2g: posts small blind $0.10
nwwpaieDRI0UPyVtChVHOg: posts big blind $0.25
*** HOLE CARDS ***
cS21pIxRHx5Gt42o7hPZzw: raises $0.75 to $1
hiTEr3yrERiQp3zHXRioVw: folds 
0HIrwssk0FQvyKULzUTtlg: folds 
f9iRHw0d+kV7pbTYwF2+2g: folds 
nwwpaieDRI0UPyVtChVHOg: folds 
Uncalled bet ($0.75) returned to cS21pIxRHx5Gt42o7hPZzw
cS21pIxRHx5Gt42o7hPZzw collected $0.60 from pot
*** SUMMARY ***
Total pot $0.60 | Rake $0 
Seat 1: nwwpaieDRI0UPyVtChVHOg (big blind) folded before Flop
Seat 2: cS21pIxRHx5Gt42o7hPZzw collected ($0.60)
Seat 3: hiTEr3yrERiQp3zHXRioVw folded before Flop (didn't bet)
Seat 4: 0HIrwssk0FQvyKULzUTtlg (button) folded before Flop (didn't bet)
Seat 5: f9iRHw0d+kV7pbTYwF2+2g (small blind) folded before Flop




PokerStars Game #59939477972:  Hold'em No Limit ($0.10/$0.25) - 2009/07/01 0:40:54 ET
Table 'KU/HrxqxwDz8HKEhYTZ6uw' 6-max Seat #5 is the button
Seat 1: gaPMxLGp9SOj4Lq6t+/0Ig ($27.65 in chips) 
Seat 2: kG34n23qFQA3nzdOJTQ1dA ($24.65 in chips) 
Seat 3: 3seg9SJ1y+HUPN0X0XKF5Q ($11.85 in chips) 
Seat 5: 4YSTu0Cdzpppe1lUgCZGCQ ($36.35 in chips) 
Seat 6: QIWnfLSqfMcoFfdDe5LZPg ($9.90 in chips) 
QIWnfLSqfMcoFfdDe5LZPg: posts small blind $0.10
gaPMxLGp9SOj4Lq6t+/0Ig: posts big blind $0.25
*** HOLE CARDS ***
kG34n23qFQA3nzdOJTQ1dA: folds 
3seg9SJ1y+HUPN0X0XKF5Q: folds 
+yxuvzJHyIWsJ515X8zJTQ leaves the table
4YSTu0Cdzpppe1lUgCZGCQ has timed out while being disconnected
4YSTu0Cdzpppe1lUgCZGCQ: folds 
4YSTu0Cdzpppe1lUgCZGCQ is sitting out
QIWnfLSqfMcoFfdDe5LZPg: folds 
Uncalled bet ($0.15) returned to gaPMxLGp9SOj4Lq6t+/0Ig
4YSTu0Cdzpppe1lUgCZGCQ has returned
gaPMxLGp9SOj4Lq6t+/0Ig collected $0.20 from pot
gaPMxLGp9SOj4Lq6t+/0Ig: doesn't show hand 
*** SUMMARY ***
Total pot $0.20 | Rake $0 
Seat 1: gaPMxLGp9SOj4Lq6t+/0Ig (big blind) collected ($0.20)
Seat 2: kG34n23qFQA3nzdOJTQ1dA folded before Flop (didn't bet)
Seat 3: 3seg9SJ1y+HUPN0X0XKF5Q folded before Flop (didn't bet)
Seat 5: 4YSTu0Cdzpppe1lUgCZGCQ (button) folded before Flop (didn't bet)
Seat 6: QIWnfLSqfMcoFfdDe5LZPg (small blind) folded before Flop




PokerStars Game #59939477950:  Hold'em No Limit ($0.10/$0.25) - 2009/07/01 0:40:54 ET
Table 'D1Yq70l0nNCyMV6DA42p+Q' 9-max Seat #6 is the button
Seat 1: z5GxcHlYz/GSz6W2uFiTtg ($14.60 in chips) 
Seat 2: OB0uLxxDeISeDjs0cxaocA ($31.60 in chips) 
Seat 3: j4q3p0lesp63b1gZDwLBZw ($5 in chips) 
Seat 5: gehe91e0IyVT0QU/XBkEyg ($26.05 in chips) 
Seat 6: MgMavn/DzTzqKgHTZMsVSw ($24.65 in chips) 
Seat 7: 9mw49/JQZ9pj0wFynA329g ($14.45 in chips) 
Seat 8: zDrucyjVn5aeekNEc3cJrA ($22.95 in chips) 
Seat 9: 3PjJjazzeHcM4mbFeXmZBg ($2.90 in chips) 
9mw49/JQZ9pj0wFynA329g: posts small blind $0.10
zDrucyjVn5aeekNEc3cJrA: posts big blind $0.25
*** HOLE CARDS ***
3PjJjazzeHcM4mbFeXmZBg: raises $0.25 to $0.50
z5GxcHlYz/GSz6W2uFiTtg: folds 
OB0uLxxDeISeDjs0cxaocA: folds 
j4q3p0lesp63b1gZDwLBZw: folds 
gehe91e0IyVT0QU/XBkEyg: folds 
MgMavn/DzTzqKgHTZMsVSw: calls $0.50
9mw49/JQZ9pj0wFynA329g: folds 
zDrucyjVn5aeekNEc3cJrA: folds 
*** FLOP *** [Th 9s As]
3PjJjazzeHcM4mbFeXmZBg: checks 
MgMavn/DzTzqKgHTZMsVSw: checks 
*** TURN *** [Th 9s As] [8c]
3PjJjazzeHcM4mbFeXmZBg: bets $0.50
MgMavn/DzTzqKgHTZMsVSw: folds 
Uncalled bet ($0.50) returned to 3PjJjazzeHcM4mbFeXmZBg
3PjJjazzeHcM4mbFeXmZBg collected $1.30 from pot
*** SUMMARY ***
Total pot $1.35 | Rake $0.05 
Board [Th 9s As 8c]
Seat 1: z5GxcHlYz/GSz6W2uFiTtg folded before Flop (didn't bet)
Seat 2: OB0uLxxDeISeDjs0cxaocA folded before Flop (didn't bet)
Seat 3: j4q3p0lesp63b1gZDwLBZw folded before Flop (didn't bet)
Seat 5: gehe91e0IyVT0QU/XBkEyg folded before Flop (didn't bet)
Seat 6: MgMavn/DzTzqKgHTZMsVSw (button) folded on the Turn
Seat 7: 9mw49/JQZ9pj0wFynA329g (small blind) folded before Flop
Seat 8: zDrucyjVn5aeekNEc3cJrA (big blind) folded before Flop
Seat 9: 3PjJjazzeHcM4mbFeXmZBg collected ($1.30)




PokerStars Game #59939478104:  Hold'em No Limit ($0.10/$0.25) - 2009/07/01 0:40:54 ET
Table 'bIGKmJgZehWJ+FAo8b85iw' 9-max Seat #9 is the button
Seat 1: yyG4svzOpC1A+sUP/scg6w ($7.25 in chips) 
Seat 2: Ut3g/kEEdCCbe/gbWrHnDg ($20.25 in chips) 
Seat 3: TeWJxSETzbXGiYKx0y+dtg ($36.40 in chips) 
Seat 4: EJRVVUAJEYLdm1qbO8TzuQ ($10.55 in chips) 
Seat 5: 7wo6Sr7QG3Zo6BaBDV1BOw ($7.15 in chips) 
Seat 6: H5Se03ZqSX7tbULXur2MAg ($21.95 in chips) 
Seat 7: DdPXdieucQ+n99u1n3A+rQ ($11.45 in chips) 
Seat 8: +2kMBNpY4nF1qNCRd8SJLA ($25 in chips) 
Seat 9: aNpwfA31EREwO+ar4XzBCw ($25 in chips) 
yyG4svzOpC1A+sUP/scg6w: posts small blind $0.10
Ut3g/kEEdCCbe/gbWrHnDg: posts big blind $0.25
*** HOLE CARDS ***
TeWJxSETzbXGiYKx0y+dtg: folds 
EJRVVUAJEYLdm1qbO8TzuQ: folds 
7wo6Sr7QG3Zo6BaBDV1BOw: folds 
H5Se03ZqSX7tbULXur2MAg: folds 
DdPXdieucQ+n99u1n3A+rQ: folds 
+2kMBNpY4nF1qNCRd8SJLA: folds 
aNpwfA31EREwO+ar4XzBCw: folds 
yyG4svzOpC1A+sUP/scg6w: calls $0.15
Ut3g/kEEdCCbe/gbWrHnDg: checks 
*** FLOP *** [4d Tc Kd]
yyG4svzOpC1A+sUP/scg6w: checks 
Ut3g/kEEdCCbe/gbWrHnDg: bets $0.50
yyG4svzOpC1A+sUP/scg6w: calls $0.50
*** TURN *** [4d Tc Kd] [Qh]
yyG4svzOpC1A+sUP/scg6w: checks 
Ut3g/kEEdCCbe/gbWrHnDg: bets $1
yyG4svzOpC1A+sUP/scg6w: calls $1
*** RIVER *** [4d Tc Kd Qh] [Jc]
yyG4svzOpC1A+sUP/scg6w: bets $1.75
Ut3g/kEEdCCbe/gbWrHnDg: folds 
Uncalled bet ($1.75) returned to yyG4svzOpC1A+sUP/scg6w
yyG4svzOpC1A+sUP/scg6w collected $3.35 from pot
*** SUMMARY ***
Total pot $3.50 | Rake $0.15 
Board [4d Tc Kd Qh Jc]
Seat 1: yyG4svzOpC1A+sUP/scg6w (small blind) collected ($3.35)
Seat 2: Ut3g/kEEdCCbe/gbWrHnDg (big blind) folded on the River
Seat 3: TeWJxSETzbXGiYKx0y+dtg folded before Flop (didn't bet)
Seat 4: EJRVVUAJEYLdm1qbO8TzuQ folded before Flop (didn't bet)
Seat 5: 7wo6Sr7QG3Zo6BaBDV1BOw folded before Flop (didn't bet)
Seat 6: H5Se03ZqSX7tbULXur2MAg folded before Flop (didn't bet)
Seat 7: DdPXdieucQ+n99u1n3A+rQ folded before Flop (didn't bet)
Seat 8: +2kMBNpY4nF1qNCRd8SJLA folded before Flop (didn't bet)
Seat 9: aNpwfA31EREwO+ar4XzBCw (button) folded before Flop (didn't bet)




PokerStars Game #59939478872:  Hold'em No Limit ($0.10/$0.25) - 2009/07/01 0:40:55 ET
Table '52Meibn9NOL4XtVi1p2Upw' 9-max Seat #3 is the button
Seat 1: LSrAei+fS8MYG9ie/GkG0Q ($12.70 in chips) 
Seat 2: BEIBUu2pIflPrCL+Iks4CQ ($12.25 in chips) 
Seat 3: MzBvksetB8XYtCt0FExJMg ($14.90 in chips) 
Seat 4: rCaXm4/EwAgWqCiClpbsqQ ($8.75 in chips) 
Seat 5: 4oA316mXLIui1QY63GXBUg ($27.10 in chips) 
Seat 6: 1wKfgJ8xXIiuc8C6qjkxhg ($6.05 in chips) 
Seat 7: R3KkgiqTvuhazyCqaD9cZg ($10 in chips) 
Seat 8: eKma8Z98pP7H8m4CEt075w ($23.45 in chips) 
Seat 9: 8B/dhbQjIWe6ASCdgzktNQ ($30.10 in chips) 
rCaXm4/EwAgWqCiClpbsqQ: posts small blind $0.10
4oA316mXLIui1QY63GXBUg: posts big blind $0.25
*** HOLE CARDS ***
1wKfgJ8xXIiuc8C6qjkxhg: folds 
R3KkgiqTvuhazyCqaD9cZg: folds 
eKma8Z98pP7H8m4CEt075w: folds 
8B/dhbQjIWe6ASCdgzktNQ: folds 
LSrAei+fS8MYG9ie/GkG0Q: calls $0.25
BEIBUu2pIflPrCL+Iks4CQ: folds 
MzBvksetB8XYtCt0FExJMg: folds 
rCaXm4/EwAgWqCiClpbsqQ: folds 
4oA316mXLIui1QY63GXBUg: checks 
*** FLOP *** [5d 9h Qc]
4oA316mXLIui1QY63GXBUg: checks 
LSrAei+fS8MYG9ie/GkG0Q: checks 
*** TURN *** [5d 9h Qc] [Qs]
4oA316mXLIui1QY63GXBUg: checks 
LSrAei+fS8MYG9ie/GkG0Q: checks 
*** RIVER *** [5d 9h Qc Qs] [5c]
4oA316mXLIui1QY63GXBUg: checks 
LSrAei+fS8MYG9ie/GkG0Q: checks 
*** SHOW DOWN ***
4oA316mXLIui1QY63GXBUg: shows [4c Kc] (two pair, Queens and Fives)
LSrAei+fS8MYG9ie/GkG0Q: shows [As 6c] (two pair, Queens and Fives - Ace kicker)
LSrAei+fS8MYG9ie/GkG0Q collected $0.60 from pot
*** SUMMARY ***
Total pot $0.60 | Rake $0 
Board [5d 9h Qc Qs 5c]
Seat 1: LSrAei+fS8MYG9ie/GkG0Q showed [As 6c] and won ($0.60) with two pair, Queens and Fives
Seat 2: BEIBUu2pIflPrCL+Iks4CQ folded before Flop (didn't bet)
Seat 3: MzBvksetB8XYtCt0FExJMg (button) folded before Flop (didn't bet)
Seat 4: rCaXm4/EwAgWqCiClpbsqQ (small blind) folded before Flop
Seat 5: 4oA316mXLIui1QY63GXBUg (big blind) showed [4c Kc] and lost with two pair, Queens and Fives
Seat 6: 1wKfgJ8xXIiuc8C6qjkxhg folded before Flop (didn't bet)
Seat 7: R3KkgiqTvuhazyCqaD9cZg folded before Flop (didn't bet)
Seat 8: eKma8Z98pP7H8m4CEt075w folded before Flop (didn't bet)
Seat 9: 8B/dhbQjIWe6ASCdgzktNQ folded before Flop (didn't bet)




PokerStars Game #599394787608296old'em No Limit ($0.10/$0.25) - 2009/07/01 0:40:55 ET
Table 'hg+KpirwreMnBAFQr/SEUA' 9-max Seat #8 is the button
Seat 1: H5Se03ZqSX7tbULXur2MAg ($24.20 in chips) 
Seat 2: OlPJsgR4xypSg/w1z7Gyvw ($18.40 in chips) 
Seat 3: N6fYvIzQLKaydFLKQGtMlQ ($24.65 in chips) 
Seat 4: GGSFATxBXI5pXwoMMI70zg ($5.45 in chips) 
Seat 5: +2kMBNpY4nF1qNCRd8SJLA ($25 in chips) 
Seat 6: dAohy+E9dUFBp6GlYFiOtQ ($24.95 in chips) 
Seat 7: EcWpc/mcsCWBGKsSdZaXbA ($23.45 in chips) 
Seat 8: HPEB+AtKw1+C/cxU0o1ciw ($25 in chips) 
H5Se03ZqSX7tbULXur2MAg: posts small blind $0.10
OlPJsgR4xypSg/w1z7Gyvw: posts big blind $0.25
*** HOLE CARDS ***
N6fYvIzQLKaydFLKQGtMlQ: folds 
GGSFATxBXI5pXwoMMI70zg: folds 
+2kMBNpY4nF1qNCRd8SJLA: folds 
dAohy+E9dUFBp6GlYFiOtQ: folds 
EcWpc/mcsCWBGKsSdZaXbA: raises $0.50 to $0.75
HPEB+AtKw1+C/cxU0o1ciw: folds 
H5Se03ZqSX7tbULXur2MAg: folds 
OlPJsgR4xypSg/w1z7Gyvw: folds 
Uncalled bet ($0.50) returned to EcWpc/mcsCWBGKsSdZaXbA
EcWpc/mcsCWBGKsSdZaXbA collected $0.60 from pot
EcWpc/mcsCWBGKsSdZaXbA: doesn't show hand 
*** SUMMARY ***
Total pot $0.60 | Rake $0 
Seat 1: H5Se03ZqSX7tbULXur2MAg (small blind) folded before Flop
Seat 2: OlPJsgR4xypSg/w1z7Gyvw (big blind) folded before Flop
Seat 3: N6fYvIzQLKaydFLKQGtMlQ folded before Flop (didn't bet)
Seat 4: GGSFATxBXI5pXwoMMI70zg folded before Flop (didn't bet)
Seat 5: +2kMBNpY4nF1qNCRd8SJLA folded before Flop (didn't bet)
Seat 6: dAohy+E9dUFBp6GlYFiOtQ folded before Flop (didn't bet)
Seat 7: EcWpc/mcsCWBGKsSdZaXbA collected ($0.60)
Seat 8: HPEB+AtKw1+C/cxU0o1ciw (button) folded before Flop (didn't bet)




PokerStars Game #59939478698:  Hold'em No Limit ($0.10/$0.25) - 2009/07/01 0:40:55 ET
Table 'BpNkESDX1ip9c0K1hb5h7A' 6-max Seat #5 is the button
Seat 1: 9jSiy0meE9XJKkdIZwyTEQ ($28.75 in chips) 
Seat 3: cHhVLDikFlByGGN+CM3w/A ($25.50 in chips) 
Seat 5: QvTX2yGq3uKJiKPmns4TKQ ($71.55 in chips) 
Seat 6: iUgsn+WyKFjjVd+tj13R2w ($15.60 in chips) 
iUgsn+WyKFjjVd+tj13R2w: posts small blind $0.10
9jSiy0meE9XJKkdIZwyTEQ: posts big blind $0.25
gqW2aBCmrIw65BvwjTFN6Q: sits out 
*** HOLE CARDS ***
tbhYGxTClzdFLMcTtjvJhg is disconnected 
cHhVLDikFlByGGN+CM3w/A: folds 
QvTX2yGq3uKJiKPmns4TKQ: folds 
iUgsn+WyKFjjVd+tj13R2w: calls $0.15
tbhYGxTClzdFLMcTtjvJhg is connected 
9jSiy0meE9XJKkdIZwyTEQ: checks 
*** FLOP *** [6d As Qd]
iUgsn+WyKFjjVd+tj13R2w: checks 
9jSiy0meE9XJKkdIZwyTEQ: checks 
*** TURN *** [6d As Qd] [Kd]
iUgsn+WyKFjjVd+tj13R2w: checks 
9jSiy0meE9XJKkdIZwyTEQ: checks 
*** RIVER *** [6d As Qd Kd] [Ah]
tbhYGxTClzdFLMcTtjvJhg said, "this is so cruel"
iUgsn+WyKFjjVd+tj13R2w: folds 
9jSiy0meE9XJKkdIZwyTEQ collected $0.50 from pot
9jSiy0meE9XJKkdIZwyTEQ: doesn't show hand 
*** SUMMARY ***
Total pot $0.50 | Rake $0 
Board [6d As Qd Kd Ah]
Seat 1: 9jSiy0meE9XJKkdIZwyTEQ (big blind) collected ($0.50)
Seat 3: cHhVLDikFlByGGN+CM3w/A folded before Flop (didn't bet)
Seat 5: QvTX2yGq3uKJiKPmns4TKQ (button) folded before Flop (didn't bet)
Seat 6: iUgsn+WyKFjjVd+tj13R2w (small blind) folded on the River




PokerStars Game #59939478664:  Hold'em No Limit ($0.10/$0.25) - 2009/07/01 0:40:55 ET
Table 'zW+7jPbOLCvlPu+dUGY5WQ' 6-max Seat #4 is the button
Seat 1: JE/wJXmjw3bpdmjwvh2pcg ($21.40 in chips) 
Seat 3: BedjMfrlRfPgSq7CXpPAmg ($63.75 in chips) 
Seat 4: Qv4VzEkN09uD11sjKv02Ig ($36.10 in chips) 
Seat 5: SFmT9ZsVopnukjvAzrxTRg ($55.85 in chips) 
Seat 6: BiLBinPhgpKAYzLgKJVU5A ($21.60 in chips) 
SFmT9ZsVopnukjvAzrxTRg: posts small blind $0.10
BiLBinPhgpKAYzLgKJVU5A: posts big blind $0.25
DXgVFTcE3WofABsNJ5G/nw: sits out 
*** HOLE CARDS ***
JE/wJXmjw3bpdmjwvh2pcg: folds 
BedjMfrlRfPgSq7CXpPAmg: folds 
Qv4VzEkN09uD11sjKv02Ig: folds 
SFmT9ZsVopnukjvAzrxTRg: folds 
Uncalled bet ($0.15) returned to BiLBinPhgpKAYzLgKJVU5A
BiLBinPhgpKAYzLgKJVU5A collected $0.20 from pot
*** SUMMARY ***
Total pot $0.20 | Rake $0 
Seat 1: JE/wJXmjw3bpdmjwvh2pcg folded before Flop (didn't bet)
Seat 3: BedjMfrlRfPgSq7CXpPAmg folded before Flop (didn't bet)
Seat 4: Qv4VzEkN09uD11sjKv02Ig (button) folded before Flop (didn't bet)
Seat 5: SFmT9ZsVopnukjvAzrxTRg (small blind) folded before Flop
Seat 6: BiLBinPhgpKAYzLgKJVU5A (big blind) collected ($0.20)




PokerStars Game #59939478798:  Hold'em No Limit ($0.10/$0.25) - 2009/07/01 0:40:55 ET
Table 'gkdjhbH1jaE3hwhPRIKMiQ' 6-max Seat #6 is the button
Seat 1: nc79pm0LZRdhncq55evVqA ($25.10 in chips) 
Seat 2: 1NNFfYMd5Hsphl/FYz9fNA ($33.30 in chips) 
Seat 4: 7uqewvdd5+KjmM7wl58k+w ($14.95 in chips) 
Seat 5: Ew/TYPQIsbQ2X8nm5iAJBg ($25.90 in chips) 
Seat 6: wqphQtauX5Qn7WRJZS1flA ($26.35 in chips) 
nc79pm0LZRdhncq55evVqA: posts small blind $0.10
1NNFfYMd5Hsphl/FYz9fNA: posts big blind $0.25
kG34n23qFQA3nzdOJTQ1dA: sits out 
*** HOLE CARDS ***
7uqewvdd5+KjmM7wl58k+w: folds 
Ew/TYPQIsbQ2X8nm5iAJBg: folds 
wqphQtauX5Qn7WRJZS1flA: folds 
nc79pm0LZRdhncq55evVqA: folds 
Uncalled bet ($0.15) returned to 1NNFfYMd5Hsphl/FYz9fNA
1NNFfYMd5Hsphl/FYz9fNA collected $0.20 from pot
*** SUMMARY ***
Total pot $0.20 | Rake $0 
Seat 1: nc79pm0LZRdhncq55evVqA (small blind) folded before Flop
Seat 2: 1NNFfYMd5Hsphl/FYz9fNA (big blind) collected ($0.20)
Seat 4: 7uqewvdd5+KjmM7wl58k+w folded before Flop (didn't bet)
Seat 5: Ew/TYPQIsbQ2X8nm5iAJBg folded before Flop (didn't bet)
Seat 6: wqphQtauX5Qn7WRJZS1flA (button) folded before Flop (didn't bet)




PokerStars Game #599394787668296old'em No Limit ($0.10/$0.25) - 2009/07/01 0:40:55 ET
Table '+UzantPJ4smVdrh+4GTu1w' 6-max Seat #1 is the button
Seat 1: 3Bm6SLY1pwRvi98HLQUkvg ($2.40 in chips) 
Seat 2: tcbEu7VzyHQ+0lh+skbQhQ ($10 in chips) 
Seat 3: SS/yfeArhULzIcOPe8MdPg ($51.15 in chips) 
Seat 5: cj4VBQya7HtVL2zCGd5jLQ ($16.90 in chips) 
Seat 6: BYxjLnV1/LL0aZcTbfAOvw ($48.05 in chips) 
tcbEu7VzyHQ+0lh+skbQhQ: posts small blind $0.10
SS/yfeArhULzIcOPe8MdPg: posts big blind $0.25
IGRfskE1v9H9Bn+fz8AgNQ: sits out 
*** HOLE CARDS ***
cj4VBQya7HtVL2zCGd5jLQ: folds 
BYxjLnV1/LL0aZcTbfAOvw: folds 
3Bm6SLY1pwRvi98HLQUkvg: folds 
tcbEu7VzyHQ+0lh+skbQhQ: folds 
Uncalled bet ($0.15) returned to SS/yfeArhULzIcOPe8MdPg
SS/yfeArhULzIcOPe8MdPg collected $0.20 from pot
*** SUMMARY ***
Total pot $0.20 | Rake $0 
Seat 1: 3Bm6SLY1pwRvi98HLQUkvg (button) folded before Flop (didn't bet)
Seat 2: tcbEu7VzyHQ+0lh+skbQhQ (small blind) folded before Flop
Seat 3: SS/yfeArhULzIcOPe8MdPg (big blind) collected ($0.20)
Seat 5: cj4VBQya7HtVL2zCGd5jLQ folded before Flop (didn't bet)
Seat 6: BYxjLnV1/LL0aZcTbfAOvw folded before Flop (didn't bet)




PokerStars Game #59939478442:  Hold'em No Limit ($0.10/$0.25) - 2009/07/01 0:40:55 ET
Table 'FE/j6VqBY4j9Uq+VHURQCQ' 6-max Seat #2 is the button
Seat 1: wKFJ513ucluNNiMlkXcDOQ ($43.75 in chips) 
Seat 2: 3zD3qLXT1bEffAoWGnc7wg ($25 in chips) 
Seat 3: Zijzy/UtPWzWVUo81HHVjQ ($49.85 in chips) 
Seat 4: cPO/1/dTcZpLkQFm3jH3Rg ($25.35 in chips) 
Seat 5: wsP46AGpqDjHZQmlRHKa9g ($25.35 in chips) 
Seat 6: kARKwAmU6kWJfiSICTYhVw ($14.35 in chips) 
Zijzy/UtPWzWVUo81HHVjQ: posts small blind $0.10
cPO/1/dTcZpLkQFm3jH3Rg: posts big blind $0.25
*** HOLE CARDS ***
wsP46AGpqDjHZQmlRHKa9g: folds 
kARKwAmU6kWJfiSICTYhVw: calls $0.25
wKFJ513ucluNNiMlkXcDOQ: folds 
3zD3qLXT1bEffAoWGnc7wg: folds 
Zijzy/UtPWzWVUo81HHVjQ: raises $0.50 to $0.75
cPO/1/dTcZpLkQFm3jH3Rg: folds 
kARKwAmU6kWJfiSICTYhVw: calls $0.50
*** FLOP *** [Kd 5s 5h]
Zijzy/UtPWzWVUo81HHVjQ: bets $0.80
kARKwAmU6kWJfiSICTYhVw: calls $0.80
*** TURN *** [Kd 5s 5h] [Td]
Zijzy/UtPWzWVUo81HHVjQ: checks 
kARKwAmU6kWJfiSICTYhVw: checks 
*** RIVER *** [Kd 5s 5h Td] [Th]
Zijzy/UtPWzWVUo81HHVjQ: checks 
kARKwAmU6kWJfiSICTYhVw: checks 
*** SHOW DOWN ***
Zijzy/UtPWzWVUo81HHVjQ: shows [Qs Kc] (two pair, Kings and Tens)
kARKwAmU6kWJfiSICTYhVw: mucks hand 
Zijzy/UtPWzWVUo81HHVjQ collected $3.20 from pot
*** SUMMARY ***
Total pot $3.35 | Rake $0.15 
Board [Kd 5s 5h Td Th]
Seat 1: wKFJ513ucluNNiMlkXcDOQ folded before Flop (didn't bet)
Seat 2: 3zD3qLXT1bEffAoWGnc7wg (button) folded before Flop (didn't bet)
Seat 3: Zijzy/UtPWzWVUo81HHVjQ (small blind) showed [Qs Kc] and won ($3.20) with two pair, Kings and Tens
Seat 4: cPO/1/dTcZpLkQFm3jH3Rg (big blind) folded before Flop
Seat 5: wsP46AGpqDjHZQmlRHKa9g folded before Flop (didn't bet)
Seat 6: kARKwAmU6kWJfiSICTYhVw mucked




PokerStars Game #59939478586:  Hold'em No Limit ($0.10/$0.25) - 2009/07/01 0:40:55 ET
Table 'SHi8+hK6i7E2dJ/3Agbyig' 6-max Seat #5 is the button
Seat 1: gPEN9Zp33YTm/mu9/SYP1w ($24.30 in chips) 
Seat 2: Zijzy/UtPWzWVUo81HHVjQ ($43.15 in chips) 
Seat 3: 2p/OXJK5bWQbcvYltdbSfg ($31.55 in chips) 
Seat 4: +KSG/hZ6NXRHDk1WHcV2+Q ($15.15 in chips) 
Seat 5: T5wrp/d5jarm+SxNy8OQAg ($15.75 in chips) 
Seat 6: NVWCcUck2mqZMp/UrHDLKQ ($11.50 in chips) 
NVWCcUck2mqZMp/UrHDLKQ: posts small blind $0.10
gPEN9Zp33YTm/mu9/SYP1w: posts big blind $0.25
*** HOLE CARDS ***
Zijzy/UtPWzWVUo81HHVjQ: folds 
2p/OXJK5bWQbcvYltdbSfg: calls $0.25
+KSG/hZ6NXRHDk1WHcV2+Q: calls $0.25
T5wrp/d5jarm+SxNy8OQAg: raises $1 to $1.25
NVWCcUck2mqZMp/UrHDLKQ: folds 
gPEN9Zp33YTm/mu9/SYP1w: folds 
2p/OXJK5bWQbcvYltdbSfg: calls $1
+KSG/hZ6NXRHDk1WHcV2+Q: folds 
*** FLOP *** [7s Kc Jd]
2p/OXJK5bWQbcvYltdbSfg: checks 
T5wrp/d5jarm+SxNy8OQAg: bets $2
2p/OXJK5bWQbcvYltdbSfg: folds 
Uncalled bet ($2) returned to T5wrp/d5jarm+SxNy8OQAg
T5wrp/d5jarm+SxNy8OQAg collected $2.95 from pot
*** SUMMARY ***
Total pot $3.10 | Rake $0.15 
Board [7s Kc Jd]
Seat 1: gPEN9Zp33YTm/mu9/SYP1w (big blind) folded before Flop
Seat 2: Zijzy/UtPWzWVUo81HHVjQ folded before Flop (didn't bet)
Seat 3: 2p/OXJK5bWQbcvYltdbSfg folded on the Flop
Seat 4: +KSG/hZ6NXRHDk1WHcV2+Q folded before Flop
Seat 5: T5wrp/d5jarm+SxNy8OQAg (button) collected ($2.95)
Seat 6: NVWCcUck2mqZMp/UrHDLKQ (small blind) folded before Flop




PokerStars Game #59939478908:  Hold'em No Limit ($0.10/$0.25) - 2009/07/01 0:40:56 ET
Table 'GxdLtCpYxqT4aAbYqkEEpw' 6-max Seat #6 is the button
Seat 1: heEf/FkFGS9M1NmwH97YIA ($39.05 in chips) 
Seat 2: hADMNbkECXMb2C/C8R2Wlw ($23.15 in chips) 
Seat 3: 9jSiy0meE9XJKkdIZwyTEQ ($33.55 in chips) 
Seat 4: ErIN0JRL5srYjT6en1f8YQ ($28.85 in chips) 
Seat 5: q6WfTUAD9mowIP63ASq2Dg ($40.75 in chips) 
Seat 6: aogAb4Eienxztk8p2v9VVw ($24.50 in chips) 
heEf/FkFGS9M1NmwH97YIA: posts small blind $0.10
hADMNbkECXMb2C/C8R2Wlw: posts big blind $0.25
*** HOLE CARDS ***
9jSiy0meE9XJKkdIZwyTEQ: raises $0.60 to $0.85
ErIN0JRL5srYjT6en1f8YQ: folds 
q6WfTUAD9mowIP63ASq2Dg: folds 
aogAb4Eienxztk8p2v9VVw: folds 
heEf/FkFGS9M1NmwH97YIA: calls $0.75
hADMNbkECXMb2C/C8R2Wlw: folds 
*** FLOP *** [Kd 8d Kc]
heEf/FkFGS9M1NmwH97YIA: checks 
9jSiy0meE9XJKkdIZwyTEQ: bets $1.40
heEf/FkFGS9M1NmwH97YIA: raises $1.40 to $2.80
9jSiy0meE9XJKkdIZwyTEQ: folds 
Uncalled bet ($1.40) returned to heEf/FkFGS9M1NmwH97YIA
heEf/FkFGS9M1NmwH97YIA collected $4.55 from pot
heEf/FkFGS9M1NmwH97YIA: doesn't show hand 
*** SUMMARY ***
Total pot $4.75 | Rake $0.20 
Board [Kd 8d Kc]
Seat 1: heEf/FkFGS9M1NmwH97YIA (small blind) collected ($4.55)
Seat 2: hADMNbkECXMb2C/C8R2Wlw (big blind) folded before Flop
Seat 3: 9jSiy0meE9XJKkdIZwyTEQ folded on the Flop
Seat 4: ErIN0JRL5srYjT6en1f8YQ folded before Flop (didn't bet)
Seat 5: q6WfTUAD9mowIP63ASq2Dg folded before Flop (didn't bet)
Seat 6: aogAb4Eienxztk8p2v9VVw (button) folded before Flop (didn't bet)




PokerStars Game #59939479240:  Hold'em No Limit ($0.10/$0.25) - 2009/07/01 0:40:56 ET
Table '2O5CgfSkSwrr4PDrlZ1RLQ' 6-max Seat #5 is the button
Seat 1: kyRaCIljYA6l33lSKQfNsg ($47.60 in chips) 
Seat 2: /gJNBeCkWL4o85/jvlZ4BA ($49.75 in chips) 
Seat 3: yzFNNFIfC89bBPwpFPx2ow ($25 in chips) 
Seat 4: 4x9jCqgSw4272dnaIqnanw ($11.50 in chips) 
Seat 5: AMrBn4Vx9aAo/vv6WHLk6w ($2.55 in chips) 
Seat 6: tj9xqoqQaDaFw7u1oyZrtA ($25.10 in chips) 
tj9xqoqQaDaFw7u1oyZrtA: posts small blind $0.10
kyRaCIljYA6l33lSKQfNsg: posts big blind $0.25
*** HOLE CARDS ***
/gJNBeCkWL4o85/jvlZ4BA: folds 
yzFNNFIfC89bBPwpFPx2ow: folds 
4x9jCqgSw4272dnaIqnanw: raises $11.25 to $11.50 and is all-in
AMrBn4Vx9aAo/vv6WHLk6w: folds 
tj9xqoqQaDaFw7u1oyZrtA: folds 
kyRaCIljYA6l33lSKQfNsg: folds 
Uncalled bet ($11.25) returned to 4x9jCqgSw4272dnaIqnanw
4x9jCqgSw4272dnaIqnanw collected $0.60 from pot
*** SUMMARY ***
Total pot $0.60 | Rake $0 
Seat 1: kyRaCIljYA6l33lSKQfNsg (big blind) folded before Flop
Seat 2: /gJNBeCkWL4o85/jvlZ4BA folded before Flop (didn't bet)
Seat 3: yzFNNFIfC89bBPwpFPx2ow folded before Flop (didn't bet)
Seat 4: 4x9jCqgSw4272dnaIqnanw collected ($0.60)
Seat 5: AMrBn4Vx9aAo/vv6WHLk6w (button) folded before Flop (didn't bet)
Seat 6: tj9xqoqQaDaFw7u1oyZrtA (small blind) folded before Flop




PokerStars Game #59939479308:  Hold'em No Limit ($0.10/$0.25) - 2009/07/01 0:40:56 ET
Table 'aaXqTKUnxrX9DYXtxhWXxA' 6-max Seat #5 is the button
Seat 1: njVkfGYrPiXfq4zLcgfVuA ($12.15 in chips) 
Seat 2: 1Zyw8DT57U6TzxWWRixa6Q ($13.80 in chips) 
Seat 3: cPO/1/dTcZpLkQFm3jH3Rg ($25 in chips) 
Seat 4: 4YSTu0Cdzpppe1lUgCZGCQ ($38.30 in chips) 
Seat 5: kyRaCIljYA6l33lSKQfNsg ($24.90 in chips) 
Seat 6: buyjetgNT1McXtdaP4zynA ($22.35 in chips) 
buyjetgNT1McXtdaP4zynA: posts small blind $0.10
njVkfGYrPiXfq4zLcgfVuA: posts big blind $0.25
*** HOLE CARDS ***
1Zyw8DT57U6TzxWWRixa6Q: folds 
cPO/1/dTcZpLkQFm3jH3Rg: folds 
4YSTu0Cdzpppe1lUgCZGCQ has timed out
4YSTu0Cdzpppe1lUgCZGCQ: folds 
4YSTu0Cdzpppe1lUgCZGCQ is sitting out
kyRaCIljYA6l33lSKQfNsg: folds 
buyjetgNT1McXtdaP4zynA: calls $0.15
njVkfGYrPiXfq4zLcgfVuA: checks 
*** FLOP *** [8c 2s 6h]
njVkfGYrPiXfq4zLcgfVuA said, "you forgot to show lafast"
buyjetgNT1McXtdaP4zynA: checks 
njVkfGYrPiXfq4zLcgfVuA: checks 
*** TURN *** [8c 2s 6h] [Qd]
buyjetgNT1McXtdaP4zynA: checks 
njVkfGYrPiXfq4zLcgfVuA: bets $0.50
buyjetgNT1McXtdaP4zynA: folds 
Uncalled bet ($0.50) returned to njVkfGYrPiXfq4zLcgfVuA
njVkfGYrPiXfq4zLcgfVuA collected $0.50 from pot
njVkfGYrPiXfq4zLcgfVuA: doesn't show hand 
*** SUMMARY ***
Total pot $0.50 | Rake $0 
Board [8c 2s 6h Qd]
Seat 1: njVkfGYrPiXfq4zLcgfVuA (big blind) collected ($0.50)
Seat 2: 1Zyw8DT57U6TzxWWRixa6Q folded before Flop (didn't bet)
Seat 3: cPO/1/dTcZpLkQFm3jH3Rg folded before Flop (didn't bet)
Seat 4: 4YSTu0Cdzpppe1lUgCZGCQ folded before Flop (didn't bet)
Seat 5: kyRaCIljYA6l33lSKQfNsg (button) folded before Flop (didn't bet)
Seat 6: buyjetgNT1McXtdaP4zynA (small blind) folded on the Turn




PokerStars Game #59939479396:  Hold'em No Limit ($0.10/$0.25) - 2009/07/01 0:40:56 ET
Table 'APEHQjIcZHDZUA4iOjju2g' 6-max Seat #3 is the button
Seat 1: eHsmIvAb2JREg4O6hNPnXg ($8 in chips) 
Seat 2: 3zD3qLXT1bEffAoWGnc7wg ($25 in chips) 
Seat 3: E7KSkgfIsmIsp0vLnmGFmA ($13.70 in chips) 
Seat 4: EqXTTLKUlDlz7yi6ziyyWA ($35.65 in chips) 
Seat 5: /xN6gc9+8Hew0HxaB6VIVg ($31.60 in chips) 
Seat 6: y7HCJfEmolBCFdi/0j5TRg ($44.70 in chips) 
EqXTTLKUlDlz7yi6ziyyWA: posts small blind $0.10
/xN6gc9+8Hew0HxaB6VIVg: posts big blind $0.25
*** HOLE CARDS ***
y7HCJfEmolBCFdi/0j5TRg: folds 
eHsmIvAb2JREg4O6hNPnXg: folds 
3zD3qLXT1bEffAoWGnc7wg: folds 
E7KSkgfIsmIsp0vLnmGFmA: folds 
EqXTTLKUlDlz7yi6ziyyWA: calls $0.15
/xN6gc9+8Hew0HxaB6VIVg: raises $0.75 to $1
EqXTTLKUlDlz7yi6ziyyWA: calls $0.75
*** FLOP *** [2h 7c 9d]
EqXTTLKUlDlz7yi6ziyyWA: checks 
/xN6gc9+8Hew0HxaB6VIVg: bets $1
EqXTTLKUlDlz7yi6ziyyWA: raises $4.50 to $5.50
/xN6gc9+8Hew0HxaB6VIVg: folds 
Uncalled bet ($4.50) returned to EqXTTLKUlDlz7yi6ziyyWA
EqXTTLKUlDlz7yi6ziyyWA collected $3.85 from pot
*** SUMMARY ***
Total pot $4 | Rake $0.15 
Board [2h 7c 9d]
Seat 1: eHsmIvAb2JREg4O6hNPnXg folded before Flop (didn't bet)
Seat 2: 3zD3qLXT1bEffAoWGnc7wg folded before Flop (didn't bet)
Seat 3: E7KSkgfIsmIsp0vLnmGFmA (button) folded before Flop (didn't bet)
Seat 4: EqXTTLKUlDlz7yi6ziyyWA (small blind) collected ($3.85)
Seat 5: /xN6gc9+8Hew0HxaB6VIVg (big blind) folded on the Flop
Seat 6: y7HCJfEmolBCFdi/0j5TRg folded before Flop (didn't bet)




PokerStars Game #59939479836:  Hold'em No Limit ($0.10/$0.25) - 2009/07/01 0:40:57 ET
Table 'IUwZ/e0bDHZPgsIWx0RnNg' 6-max Seat #3 is the button
Seat 1: 8JTm/CXBn3+kuQgcUOgPkw ($24.75 in chips) 
Seat 2: mvFHK3pE7tCxJEqLjKC70Q ($24.30 in chips) 
Seat 3: dOX4wnYV2sEqvDbF+8KSCw ($30.15 in chips) 
Seat 4: IyZ9SVxKy7TJvRGFneWTMg ($29.60 in chips) 
Seat 5: wsP46AGpqDjHZQmlRHKa9g ($25.85 in chips) 
Seat 6: NhUN/JpAprdJeamFBgJH1w ($25 in chips) 
IyZ9SVxKy7TJvRGFneWTMg: posts small blind $0.10
wsP46AGpqDjHZQmlRHKa9g: posts big blind $0.25
*** HOLE CARDS ***
NhUN/JpAprdJeamFBgJH1w: folds 
8JTm/CXBn3+kuQgcUOgPkw: folds 
mvFHK3pE7tCxJEqLjKC70Q: folds 
dOX4wnYV2sEqvDbF+8KSCw: raises $0.75 to $1
IyZ9SVxKy7TJvRGFneWTMg: folds 
wsP46AGpqDjHZQmlRHKa9g: folds 
Uncalled bet ($0.75) returned to dOX4wnYV2sEqvDbF+8KSCw
dOX4wnYV2sEqvDbF+8KSCw collected $0.60 from pot
dOX4wnYV2sEqvDbF+8KSCw: doesn't show hand 
*** SUMMARY ***
Total pot $0.60 | Rake $0 
Seat 1: 8JTm/CXBn3+kuQgcUOgPkw folded before Flop (didn't bet)
Seat 2: mvFHK3pE7tCxJEqLjKC70Q folded before Flop (didn't bet)
Seat 3: dOX4wnYV2sEqvDbF+8KSCw (button) collected ($0.60)
Seat 4: IyZ9SVxKy7TJvRGFneWTMg (small blind) folded before Flop
Seat 5: wsP46AGpqDjHZQmlRHKa9g (big blind) folded before Flop
Seat 6: NhUN/JpAprdJeamFBgJH1w folded before Flop (didn't bet)




PokerStars Game #59939479658:  Hold'em No Limit ($0.10/$0.25) - 2009/07/01 0:40:57 ET
Table 'vZfV/Uj0q8joA1du9sRJSg' 6-max Seat #1 is the button
Seat 1: OAmGQMdOxnvuBNHdADx0ew ($6 in chips) 
Seat 2: wMiE3yTbDJGOLOF9th7KPA ($11.70 in chips) 
Seat 3: QJ/0wT0pYdWbDuqo9eNJgQ ($8.30 in chips) 
Seat 4: v+QfkGiuj9bgtuNoVnDO8w ($25 in chips) 
Seat 5: FStoHe64SQWqAsjya9pDkQ ($25.25 in chips) 
Seat 6: 8ClCHtFXGNplITm+63KB+Q ($26.20 in chips) 
wMiE3yTbDJGOLOF9th7KPA: posts small blind $0.10
QJ/0wT0pYdWbDuqo9eNJgQ: posts big blind $0.25
*** HOLE CARDS ***
v+QfkGiuj9bgtuNoVnDO8w: folds 
FStoHe64SQWqAsjya9pDkQ: folds 
8ClCHtFXGNplITm+63KB+Q: folds 
OAmGQMdOxnvuBNHdADx0ew: calls $0.25
wMiE3yTbDJGOLOF9th7KPA: raises $0.50 to $0.75
QJ/0wT0pYdWbDuqo9eNJgQ: calls $0.50
OAmGQMdOxnvuBNHdADx0ew: calls $0.50
*** FLOP *** [9s 6h Qd]
wMiE3yTbDJGOLOF9th7KPA: bets $0.50
QJ/0wT0pYdWbDuqo9eNJgQ: calls $0.50
OAmGQMdOxnvuBNHdADx0ew: folds 
*** TURN *** [9s 6h Qd] [9d]
wMiE3yTbDJGOLOF9th7KPA: bets $0.50
QJ/0wT0pYdWbDuqo9eNJgQ: calls $0.50
*** RIVER *** [9s 6h Qd 9d] [Qc]
wMiE3yTbDJGOLOF9th7KPA: bets $1.25
QJ/0wT0pYdWbDuqo9eNJgQ: folds 
Uncalled bet ($1.25) returned to wMiE3yTbDJGOLOF9th7KPA
wMiE3yTbDJGOLOF9th7KPA collected $4.05 from pot
*** SUMMARY ***
Total pot $4.25 | Rake $0.20 
Board [9s 6h Qd 9d Qc]
Seat 1: OAmGQMdOxnvuBNHdADx0ew (button) folded on the Flop
Seat 2: wMiE3yTbDJGOLOF9th7KPA (small blind) collected ($4.05)
Seat 3: QJ/0wT0pYdWbDuqo9eNJgQ (big blind) folded on the River
Seat 4: v+QfkGiuj9bgtuNoVnDO8w folded before Flop (didn't bet)
Seat 5: FStoHe64SQWqAsjya9pDkQ folded before Flop (didn't bet)
Seat 6: 8ClCHtFXGNplITm+63KB+Q folded before Flop (didn't bet)




PokerStars Game #59939480098:  Hold'em No Limit ($0.10/$0.25) - 2009/07/01 0:40:57 ET
Table 'dZNBGqFYSwfOVZvDJ4VjIQ' 6-max Seat #6 is the button
Seat 2: NPueG39V6nKvDRuvBJ4U7g ($15.55 in chips) 
Seat 3: Qd4gQJ1hjQcU9/uDqd6Nlw ($11.70 in chips) 
Seat 4: df01R5ThvHspD8FgKmaDvQ ($24.75 in chips) 
Seat 5: hZJzYj+7+PvGu6ae1g//sQ ($10.65 in chips) 
Seat 6: VbudEd0ZG+qPwMO9h+hjXw ($18.20 in chips) 
o08wk0F4gROLhZS04Iyl3w will be allowed to play after the button
NPueG39V6nKvDRuvBJ4U7g: posts small blind $0.10
Qd4gQJ1hjQcU9/uDqd6Nlw: posts big blind $0.25
*** HOLE CARDS ***
df01R5ThvHspD8FgKmaDvQ: folds 
hZJzYj+7+PvGu6ae1g//sQ: calls $0.25
VbudEd0ZG+qPwMO9h+hjXw: raises $0.75 to $1
NPueG39V6nKvDRuvBJ4U7g: folds 
Qd4gQJ1hjQcU9/uDqd6Nlw: folds 
hZJzYj+7+PvGu6ae1g//sQ: calls $0.75
*** FLOP *** [Qh Kd 7s]
hZJzYj+7+PvGu6ae1g//sQ: checks 
VbudEd0ZG+qPwMO9h+hjXw: bets $2.50
hZJzYj+7+PvGu6ae1g//sQ: folds 
Uncalled bet ($2.50) returned to VbudEd0ZG+qPwMO9h+hjXw
VbudEd0ZG+qPwMO9h+hjXw collected $2.25 from pot
*** SUMMARY ***
Total pot $2.35 | Rake $0.10 
Board [Qh Kd 7s]
Seat 2: NPueG39V6nKvDRuvBJ4U7g (small blind) folded before Flop
Seat 3: Qd4gQJ1hjQcU9/uDqd6Nlw (big blind) folded before Flop
Seat 4: df01R5ThvHspD8FgKmaDvQ folded before Flop (didn't bet)
Seat 5: hZJzYj+7+PvGu6ae1g//sQ folded on the Flop
Seat 6: VbudEd0ZG+qPwMO9h+hjXw (button) collected ($2.25)




PokerStars Game #59939479686:  Hold'em No Limit ($0.10/$0.25) - 2009/07/01 0:40:57 ET
Table 'YYMg5qzxK1m9eGRo4SbxtQ' 9-max Seat #6 is the button
Seat 1: DiSvPC2iudwL5j9u6Huyww ($25 in chips) 
Seat 2: uH1RN27w9SKa7TpVR9EFrQ ($15.25 in chips) 
Seat 3: N6fYvIzQLKaydFLKQGtMlQ ($24.05 in chips) 
Seat 4: H8sSXb2KLK0U38tU9YITDw ($11.25 in chips) 
Seat 5: BEIBUu2pIflPrCL+Iks4CQ ($19.30 in chips) 
Seat 6: gehe91e0IyVT0QU/XBkEyg ($41.60 in chips) 
Seat 7: hPhp/RE3cJ5YGaQ2xOHXXg ($4.05 in chips) 
Seat 8: 18G4P1XstjNvItdGUITxgw ($26.05 in chips) 
Seat 9: +sbyWwIcFp9kP0bDtMegfQ ($36.90 in chips) 
hPhp/RE3cJ5YGaQ2xOHXXg: posts small blind $0.10
18G4P1XstjNvItdGUITxgw: posts big blind $0.25
*** HOLE CARDS ***
+sbyWwIcFp9kP0bDtMegfQ: folds 
DiSvPC2iudwL5j9u6Huyww: folds 
uH1RN27w9SKa7TpVR9EFrQ: folds 
N6fYvIzQLKaydFLKQGtMlQ: folds 
H8sSXb2KLK0U38tU9YITDw: folds 
BEIBUu2pIflPrCL+Iks4CQ: folds 
gehe91e0IyVT0QU/XBkEyg: folds 
hPhp/RE3cJ5YGaQ2xOHXXg: folds 
Uncalled bet ($0.15) returned to 18G4P1XstjNvItdGUITxgw
18G4P1XstjNvItdGUITxgw collected $0.20 from pot
18G4P1XstjNvItdGUITxgw: doesn't show hand 
*** SUMMARY ***
Total pot $0.20 | Rake $0 
Seat 1: DiSvPC2iudwL5j9u6Huyww folded before Flop (didn't bet)
Seat 2: uH1RN27w9SKa7TpVR9EFrQ folded before Flop (didn't bet)
Seat 3: N6fYvIzQLKaydFLKQGtMlQ folded before Flop (didn't bet)
Seat 4: H8sSXb2KLK0U38tU9YITDw folded before Flop (didn't bet)
Seat 5: BEIBUu2pIflPrCL+Iks4CQ folded before Flop (didn't bet)
Seat 6: gehe91e0IyVT0QU/XBkEyg (button) folded before Flop (didn't bet)
Seat 7: hPhp/RE3cJ5YGaQ2xOHXXg (small blind) folded before Flop
Seat 8: 18G4P1XstjNvItdGUITxgw (big blind) collected ($0.20)
Seat 9: +sbyWwIcFp9kP0bDtMegfQ folded before Flop (didn't bet)




PokerStars Game #59939480134:  Hold'em No Limit ($0.10/$0.25) - 2009/07/01 0:40:57 ET
Table 'YlRA05h9BJ1EhOUSNUjJdg' 9-max Seat #8 is the button
Seat 1: 5gHh6iDvZdEvYi59Pko1iA ($4.75 in chips) 
Seat 2: Y2GFAe+PT7xnUUtgqCNDFw ($19.80 in chips) 
Seat 3: C91Mv1usdi9Vq9ljlQVsug ($54.30 in chips) 
Seat 4: HPEB+AtKw1+C/cxU0o1ciw ($30.70 in chips) 
Seat 5: oKO7b50N6TzXbPBr/mcrUA ($24.05 in chips) 
Seat 6: GMMsoUkaAAY5/vm1Kmh9pA ($13.70 in chips) 
Seat 7: oVDuzcEt1umAPOB/u6ZH9g ($25.35 in chips) 
Seat 8: j4q3p0lesp63b1gZDwLBZw ($5 in chips) 
Seat 9: hBMUlEpyU74r/fwDgIpXjQ ($25 in chips) 
hBMUlEpyU74r/fwDgIpXjQ: posts small blind $0.10
5gHh6iDvZdEvYi59Pko1iA: posts big blind $0.25
*** HOLE CARDS ***
Y2GFAe+PT7xnUUtgqCNDFw: calls $0.25
C91Mv1usdi9Vq9ljlQVsug: calls $0.25
HPEB+AtKw1+C/cxU0o1ciw: folds 
oKO7b50N6TzXbPBr/mcrUA: folds 
GMMsoUkaAAY5/vm1Kmh9pA: folds 
oVDuzcEt1umAPOB/u6ZH9g: calls $0.25
j4q3p0lesp63b1gZDwLBZw: folds 
hBMUlEpyU74r/fwDgIpXjQ: calls $0.15
5gHh6iDvZdEvYi59Pko1iA: checks 
*** FLOP *** [9s 8c 9c]
hBMUlEpyU74r/fwDgIpXjQ: bets $0.75
5gHh6iDvZdEvYi59Pko1iA: raises $0.75 to $1.50
Y2GFAe+PT7xnUUtgqCNDFw: folds 
C91Mv1usdi9Vq9ljlQVsug: folds 
oVDuzcEt1umAPOB/u6ZH9g: folds 
hBMUlEpyU74r/fwDgIpXjQ: calls $0.75
*** TURN *** [9s 8c 9c] [2s]
hBMUlEpyU74r/fwDgIpXjQ: checks 
5gHh6iDvZdEvYi59Pko1iA: checks 
*** RIVER *** [9s 8c 9c 2s] [5s]
hBMUlEpyU74r/fwDgIpXjQ: checks 
5gHh6iDvZdEvYi59Pko1iA: checks 
*** SHOW DOWN ***
hBMUlEpyU74r/fwDgIpXjQ: shows [9d 6d] (three of a kind, Nines)
5gHh6iDvZdEvYi59Pko1iA: mucks hand 
hBMUlEpyU74r/fwDgIpXjQ collected $4.05 from pot
*** SUMMARY ***
Total pot $4.25 | Rake $0.20 
Board [9s 8c 9c 2s 5s]
Seat 1: 5gHh6iDvZdEvYi59Pko1iA (big blind) mucked
Seat 2: Y2GFAe+PT7xnUUtgqCNDFw folded on the Flop
Seat 3: C91Mv1usdi9Vq9ljlQVsug folded on the Flop
Seat 4: HPEB+AtKw1+C/cxU0o1ciw folded before Flop (didn't bet)
Seat 5: oKO7b50N6TzXbPBr/mcrUA folded before Flop (didn't bet)
Seat 6: GMMsoUkaAAY5/vm1Kmh9pA folded before Flop (didn't bet)
Seat 7: oVDuzcEt1umAPOB/u6ZH9g folded on the Flop
Seat 8: j4q3p0lesp63b1gZDwLBZw (button) folded before Flop (didn't bet)
Seat 9: hBMUlEpyU74r/fwDgIpXjQ (small blind) showed [9d 6d] and won ($4.05) with three of a kind, Nines




PokerStars Game #59939479806:  Hold'em No Limit ($0.10/$0.25) - 2009/07/01 0:40:57 ET
Table 'IrJPyZ3JW2iIa+krdoSbJQ' 9-max Seat #3 is the button
Seat 1: 4+E2msto8r80F3SH2gctVA ($25.10 in chips) 
Seat 2: DdPXdieucQ+n99u1n3A+rQ ($9.30 in chips) 
Seat 3: vZGoOTJLQLhkPj4I+LNGig ($25 in chips) 
Seat 4: DnDcAdn9P0zGovMERigpFA ($25 in chips) 
Seat 5: sUVgUtgbfVx6JpvApozwhQ ($5.40 in chips) 
Seat 6: +sbyWwIcFp9kP0bDtMegfQ ($24.30 in chips) 
Seat 7: uH1RN27w9SKa7TpVR9EFrQ ($23.20 in chips) 
Seat 8: VBHxUExRAMrbxUq/cVx9Gw ($5 in chips) 
Seat 9: SXqVW4Q0evTUVZG6BbUNIA ($29.30 in chips) 
DnDcAdn9P0zGovMERigpFA: posts small blind $0.10
sUVgUtgbfVx6JpvApozwhQ: posts big blind $0.25
*** HOLE CARDS ***
+sbyWwIcFp9kP0bDtMegfQ: folds 
uH1RN27w9SKa7TpVR9EFrQ: calls $0.25
VBHxUExRAMrbxUq/cVx9Gw: folds 
SXqVW4Q0evTUVZG6BbUNIA: folds 
4+E2msto8r80F3SH2gctVA: folds 
DdPXdieucQ+n99u1n3A+rQ: folds 
vZGoOTJLQLhkPj4I+LNGig: folds 
DnDcAdn9P0zGovMERigpFA: folds 
sUVgUtgbfVx6JpvApozwhQ: checks 
*** FLOP *** [Ks 4s 8s]
sUVgUtgbfVx6JpvApozwhQ: checks 
uH1RN27w9SKa7TpVR9EFrQ: checks 
*** TURN *** [Ks 4s 8s] [Ad]
sUVgUtgbfVx6JpvApozwhQ: checks 
uH1RN27w9SKa7TpVR9EFrQ: bets $0.50
sUVgUtgbfVx6JpvApozwhQ: raises $1 to $1.50
uH1RN27w9SKa7TpVR9EFrQ: folds 
Uncalled bet ($1) returned to sUVgUtgbfVx6JpvApozwhQ
sUVgUtgbfVx6JpvApozwhQ collected $1.55 from pot
sUVgUtgbfVx6JpvApozwhQ: doesn't show hand 
*** SUMMARY ***
Total pot $1.60 | Rake $0.05 
Board [Ks 4s 8s Ad]
Seat 1: 4+E2msto8r80F3SH2gctVA folded before Flop (didn't bet)
Seat 2: DdPXdieucQ+n99u1n3A+rQ folded before Flop (didn't bet)
Seat 3: vZGoOTJLQLhkPj4I+LNGig (button) folded before Flop (didn't bet)
Seat 4: DnDcAdn9P0zGovMERigpFA (small blind) folded before Flop
Seat 5: sUVgUtgbfVx6JpvApozwhQ (big blind) collected ($1.55)
Seat 6: +sbyWwIcFp9kP0bDtMegfQ folded before Flop (didn't bet)
Seat 7: uH1RN27w9SKa7TpVR9EFrQ folded on the Turn
Seat 8: VBHxUExRAMrbxUq/cVx9Gw folded before Flop (didn't bet)
Seat 9: SXqVW4Q0evTUVZG6BbUNIA folded before Flop (didn't bet)




PokerStars Game #59939480662:  Hold'em No Limit ($0.10/$0.25) - 2009/07/01 0:40:58 ET
Table 'ThBZ355rqvsb8UGb6ajbig' 9-max Seat #4 is the button
Seat 2: 4awUyiDYTgylQKXZ9faBVA ($25 in chips) 
Seat 3: LBrhQVB4w41YNd7kMYn/og ($12.60 in chips) 
Seat 4: GFNwOPqg/Zu4ZuokgGADNQ ($15 in chips) 
Seat 5: ljO8CPts14fBjr9/qK0Enw ($25.65 in chips) 
Seat 6: qwr38jl5txoR36M7G5qi4A ($7.50 in chips) 
Seat 7: t2nb95S5EEFOEzNx9Itz0g ($12.95 in chips) 
Seat 8: 6REZ3fl3I5Kaxoupd8cnLg ($14.75 in chips) 
Seat 9: 8B/dhbQjIWe6ASCdgzktNQ ($28.75 in chips) 
ljO8CPts14fBjr9/qK0Enw: posts small blind $0.10
qwr38jl5txoR36M7G5qi4A: posts big blind $0.25
*** HOLE CARDS ***
t2nb95S5EEFOEzNx9Itz0g: folds 
6REZ3fl3I5Kaxoupd8cnLg: raises $0.50 to $0.75
8B/dhbQjIWe6ASCdgzktNQ: folds 
4awUyiDYTgylQKXZ9faBVA: folds 
LBrhQVB4w41YNd7kMYn/og: calls $0.75
GFNwOPqg/Zu4ZuokgGADNQ: folds 
ljO8CPts14fBjr9/qK0Enw: raises $24.90 to $25.65 and is all-in
qwr38jl5txoR36M7G5qi4A: folds 
6REZ3fl3I5Kaxoupd8cnLg: calls $14 and is all-in
LBrhQVB4w41YNd7kMYn/og: folds 
Uncalled bet ($10.90) returned to ljO8CPts14fBjr9/qK0Enw
*** FLOP *** [3d 7h 4h]
*** TURN *** [3d 7h 4h] [Js]
*** RIVER *** [3d 7h 4h Js] [6h]
*** SHOW DOWN ***
ljO8CPts14fBjr9/qK0Enw: shows [2s Ks] (high card King)
6REZ3fl3I5Kaxoupd8cnLg: shows [Ad Kh] (high card Ace)
6REZ3fl3I5Kaxoupd8cnLg collected $29 from pot
*** SUMMARY ***
Total pot $30.50 | Rake $1.50 
Board [3d 7h 4h Js 6h]
Seat 2: 4awUyiDYTgylQKXZ9faBVA folded before Flop (didn't bet)
Seat 3: LBrhQVB4w41YNd7kMYn/og folded before Flop
Seat 4: GFNwOPqg/Zu4ZuokgGADNQ (button) folded before Flop (didn't bet)
Seat 5: ljO8CPts14fBjr9/qK0Enw (small blind) showed [2s Ks] and lost with high card King
Seat 6: qwr38jl5txoR36M7G5qi4A (big blind) folded before Flop
Seat 7: t2nb95S5EEFOEzNx9Itz0g folded before Flop (didn't bet)
Seat 8: 6REZ3fl3I5Kaxoupd8cnLg showed [Ad Kh] and won ($29) with high card Ace
Seat 9: 8B/dhbQjIWe6ASCdgzktNQ folded before Flop (didn't bet)




PokerStars Game #59939480546:  Hold'em No Limit ($0.10/$0.25) - 2009/07/01 0:40:58 ET
Table 'zKwHJD0cmKNUure9qQTfFg' 6-max Seat #6 is the button
Seat 1: zsU1ijOyYEi+40wBKPEbmw ($6.30 in chips) 
Seat 2: XwQK8xvCADxp0bUmji+Zyg ($32.25 in chips) 
Seat 4: v+QfkGiuj9bgtuNoVnDO8w ($25 in chips) 
Seat 5: I1TxPvWj8NfG8orglCinNA ($25.20 in chips) 
Seat 6: BvTq4Tu0zBOsniW3eFCnkQ ($42.50 in chips) 
zsU1ijOyYEi+40wBKPEbmw: posts small blind $0.10
XwQK8xvCADxp0bUmji+Zyg: posts big blind $0.25
wUwfsTnmpHcWa17qFlQr1Q: sits out 
*** HOLE CARDS ***
v+QfkGiuj9bgtuNoVnDO8w: folds 
I1TxPvWj8NfG8orglCinNA: raises $0.75 to $1
BvTq4Tu0zBOsniW3eFCnkQ: folds 
zsU1ijOyYEi+40wBKPEbmw: folds 
XwQK8xvCADxp0bUmji+Zyg: folds 
Uncalled bet ($0.75) returned to I1TxPvWj8NfG8orglCinNA
I1TxPvWj8NfG8orglCinNA collected $0.60 from pot
I1TxPvWj8NfG8orglCinNA: doesn't show hand 
*** SUMMARY ***
Total pot $0.60 | Rake $0 
Seat 1: zsU1ijOyYEi+40wBKPEbmw (small blind) folded before Flop
Seat 2: XwQK8xvCADxp0bUmji+Zyg (big blind) folded before Flop
Seat 4: v+QfkGiuj9bgtuNoVnDO8w folded before Flop (didn't bet)
Seat 5: I1TxPvWj8NfG8orglCinNA collected ($0.60)
Seat 6: BvTq4Tu0zBOsniW3eFCnkQ (button) folded before Flop (didn't bet)




PokerStars Game #59939480500:  Hold'em No Limit ($0.10/$0.25) - 2009/07/01 0:40:58 ET
Table 'M7d9IrgQUUFFy/SZ3ksLYg' 6-max Seat #4 is the button
Seat 1: cPO/1/dTcZpLkQFm3jH3Rg ($34.20 in chips) 
Seat 2: JE/wJXmjw3bpdmjwvh2pcg ($25 in chips) 
Seat 3: eHsmIvAb2JREg4O6hNPnXg ($16.05 in chips) 
Seat 4: 7FmwVDcdEtxDpHmP4hOXsQ ($29.90 in chips) 
Seat 6: /gJNBeCkWL4o85/jvlZ4BA ($25.25 in chips) 
/gJNBeCkWL4o85/jvlZ4BA: posts small blind $0.10
cPO/1/dTcZpLkQFm3jH3Rg: posts big blind $0.25
*** HOLE CARDS ***
JE/wJXmjw3bpdmjwvh2pcg: folds 
eHsmIvAb2JREg4O6hNPnXg: folds 
7FmwVDcdEtxDpHmP4hOXsQ: folds 
/gJNBeCkWL4o85/jvlZ4BA: folds 
Uncalled bet ($0.15) returned to cPO/1/dTcZpLkQFm3jH3Rg
cPO/1/dTcZpLkQFm3jH3Rg collected $0.20 from pot
*** SUMMARY ***
Total pot $0.20 | Rake $0 
Seat 1: cPO/1/dTcZpLkQFm3jH3Rg (big blind) collected ($0.20)
Seat 2: JE/wJXmjw3bpdmjwvh2pcg folded before Flop (didn't bet)
Seat 3: eHsmIvAb2JREg4O6hNPnXg folded before Flop (didn't bet)
Seat 4: 7FmwVDcdEtxDpHmP4hOXsQ (button) folded before Flop (didn't bet)
Seat 6: /gJNBeCkWL4o85/jvlZ4BA (small blind) folded before Flop




PokerStars Game #59939480660:  Hold'em No Limit ($0.10/$0.25) - 2009/07/01 0:40:58 ET
Table 'HzFR0rxmDAPu5GzYR0AlYg' 6-max Seat #5 is the button
Seat 1: v+QfkGiuj9bgtuNoVnDO8w ($25.10 in chips) 
Seat 2: UA5OsKS3VPaxa7uC8La/kA ($52.95 in chips) 
Seat 3: lfAPI6VglUPipZe8BpDaTA ($24.85 in chips) 
Seat 4: uy9x0X5l7O+IpGjLa77QgQ ($60.05 in chips) 
Seat 5: I1TxPvWj8NfG8orglCinNA ($25 in chips) 
v+QfkGiuj9bgtuNoVnDO8w: posts small blind $0.10
UA5OsKS3VPaxa7uC8La/kA: posts big blind $0.25
*** HOLE CARDS ***
lfAPI6VglUPipZe8BpDaTA: folds 
uy9x0X5l7O+IpGjLa77QgQ: folds 
I1TxPvWj8NfG8orglCinNA: folds 
v+QfkGiuj9bgtuNoVnDO8w: folds 
Uncalled bet ($0.15) returned to UA5OsKS3VPaxa7uC8La/kA
UA5OsKS3VPaxa7uC8La/kA collected $0.20 from pot
*** SUMMARY ***
Total pot $0.20 | Rake $0 
Seat 1: v+QfkGiuj9bgtuNoVnDO8w (small blind) folded before Flop
Seat 2: UA5OsKS3VPaxa7uC8La/kA (big blind) collected ($0.20)
Seat 3: lfAPI6VglUPipZe8BpDaTA folded before Flop (didn't bet)
Seat 4: uy9x0X5l7O+IpGjLa77QgQ folded before Flop (didn't bet)
Seat 5: I1TxPvWj8NfG8orglCinNA (button) folded before Flop (didn't bet)




PokerStars Game #59939480658:  Hold'em No Limit ($0.10/$0.25) - 2009/07/01 0:40:58 ET
Table 'KKcpZYT1qeSWLmZFp9A4KA' 9-max Seat #5 is the button
Seat 2: vZGoOTJLQLhkPj4I+LNGig ($26.15 in chips) 
Seat 3: j4q3p0lesp63b1gZDwLBZw ($5.25 in chips) 
Seat 4: Z3a37Ry74FVl+CBZtAONiA ($12 in chips) 
Seat 5: CbXUS6Z2rXZxL1AKduNtmQ ($33.25 in chips) 
Seat 6: 4awUyiDYTgylQKXZ9faBVA ($39.45 in chips) 
Seat 7: QEbIGci+itdw+re8RM5fZA ($25 in chips) 
Seat 8: CBv6rfZ34K2gts8YbQ4waw ($33.45 in chips) 
4awUyiDYTgylQKXZ9faBVA: posts small blind $0.10
QEbIGci+itdw+re8RM5fZA: posts big blind $0.25
Z3a37Ry74FVl+CBZtAONiA: posts big blind $0.25
*** HOLE CARDS ***
CBv6rfZ34K2gts8YbQ4waw: folds 
vZGoOTJLQLhkPj4I+LNGig: raises $1 to $1.25
j4q3p0lesp63b1gZDwLBZw: folds 
CBv6rfZ34K2gts8YbQ4waw leaves the table
Z3a37Ry74FVl+CBZtAONiA: folds 
CbXUS6Z2rXZxL1AKduNtmQ: folds 
4awUyiDYTgylQKXZ9faBVA: folds 
QEbIGci+itdw+re8RM5fZA: folds 
Uncalled bet ($1) returned to vZGoOTJLQLhkPj4I+LNGig
vZGoOTJLQLhkPj4I+LNGig collected $0.85 from pot
vZGoOTJLQLhkPj4I+LNGig: doesn't show hand 
*** SUMMARY ***
Total pot $0.85 | Rake $0 
Seat 2: vZGoOTJLQLhkPj4I+LNGig collected ($0.85)
Seat 3: j4q3p0lesp63b1gZDwLBZw folded before Flop (didn't bet)
Seat 4: Z3a37Ry74FVl+CBZtAONiA folded before Flop
Seat 5: CbXUS6Z2rXZxL1AKduNtmQ (button) folded before Flop (didn't bet)
Seat 6: 4awUyiDYTgylQKXZ9faBVA (small blind) folded before Flop
Seat 7: QEbIGci+itdw+re8RM5fZA (big blind) folded before Flop
Seat 8: CBv6rfZ34K2gts8YbQ4waw folded before Flop (didn't bet)




PokerStars Game #59939480840:  Hold'em No Limit ($0.10/$0.25) - 2009/07/01 0:40:58 ET
Table 'oZuNsbNJuUyQLGKzQ/4JFg' 6-max Seat #6 is the button
Seat 1: /hq3j+3FbArzS8nEzmqRuw ($6.60 in chips) 
Seat 2: UA5OsKS3VPaxa7uC8La/kA ($30.25 in chips) 
Seat 3: 8ClCHtFXGNplITm+63KB+Q ($36.40 in chips) 
Seat 4: pWN7DVB+VCCiq83kllzEtg ($17.25 in chips) 
Seat 5: IH5lT4+CuQFyy32Qf5ydDw ($19.15 in chips) 
Seat 6: 34ttqW62uIRrqINCCmLcsw ($20.65 in chips) 
/hq3j+3FbArzS8nEzmqRuw: posts small blind $0.10
UA5OsKS3VPaxa7uC8La/kA: posts big blind $0.25
*** HOLE CARDS ***
8ClCHtFXGNplITm+63KB+Q: folds 
pWN7DVB+VCCiq83kllzEtg: folds 
IH5lT4+CuQFyy32Qf5ydDw: calls $0.25
34ttqW62uIRrqINCCmLcsw: folds 
/hq3j+3FbArzS8nEzmqRuw: calls $0.15
UA5OsKS3VPaxa7uC8La/kA has timed out
UA5OsKS3VPaxa7uC8La/kA: checks 
*** FLOP *** [2d Td Js]
/hq3j+3FbArzS8nEzmqRuw: bets $1
UA5OsKS3VPaxa7uC8La/kA has timed out
UA5OsKS3VPaxa7uC8La/kA: folds 
UA5OsKS3VPaxa7uC8La/kA is sitting out
IH5lT4+CuQFyy32Qf5ydDw: calls $1
*** TURN *** [2d Td Js] [Kd]
/hq3j+3FbArzS8nEzmqRuw: bets $0.25
IH5lT4+CuQFyy32Qf5ydDw: calls $0.25
*** RIVER *** [2d Td Js Kd] [Qs]
/hq3j+3FbArzS8nEzmqRuw: bets $0.25
IH5lT4+CuQFyy32Qf5ydDw: raises $1.75 to $2
/hq3j+3FbArzS8nEzmqRuw: folds 
Uncalled bet ($1.75) returned to IH5lT4+CuQFyy32Qf5ydDw
IH5lT4+CuQFyy32Qf5ydDw collected $3.60 from pot
IH5lT4+CuQFyy32Qf5ydDw: shows [Jc Ac] (a straight, Ten to Ace)
*** SUMMARY ***
Total pot $3.75 | Rake $0.15 
Board [2d Td Js Kd Qs]
Seat 1: /hq3j+3FbArzS8nEzmqRuw (small blind) folded on the River
Seat 2: UA5OsKS3VPaxa7uC8La/kA (big blind) folded on the Flop
Seat 3: 8ClCHtFXGNplITm+63KB+Q folded before Flop (didn't bet)
Seat 4: pWN7DVB+VCCiq83kllzEtg folded before Flop (didn't bet)
Seat 5: IH5lT4+CuQFyy32Qf5ydDw collected ($3.60)
Seat 6: 34ttqW62uIRrqINCCmLcsw (button) folded before Flop (didn't bet)




PokerStars Game #59939480262:  Hold'em No Limit ($0.10/$0.25) - 2009/07/01 0:40:58 ET
Table 'AHkg4ChqzcMauBx6Qvz8Nw' 6-max Seat #1 is the button
Seat 1: b32FRB7ak2jmfrI8EsDhfQ ($6.65 in chips) 
Seat 2: /bjna2FTN7pPjqYGzmDE0Q ($21.80 in chips) 
Seat 3: Zi4SmoY9XJ0iI6ixiSZaWQ ($8.75 in chips) 
Seat 4: N7O9jUEx2YiQn1+yRYTHmw ($26.10 in chips) 
Seat 5: LtASJ9OlkqGrrUKGQlpGAw ($37.05 in chips) 
Seat 6: SFmT9ZsVopnukjvAzrxTRg ($53.05 in chips) 
/bjna2FTN7pPjqYGzmDE0Q: posts small blind $0.10
Zi4SmoY9XJ0iI6ixiSZaWQ: posts big blind $0.25
*** HOLE CARDS ***
N7O9jUEx2YiQn1+yRYTHmw: calls $0.25
LtASJ9OlkqGrrUKGQlpGAw: folds 
SFmT9ZsVopnukjvAzrxTRg: folds 
b32FRB7ak2jmfrI8EsDhfQ: calls $0.25
/bjna2FTN7pPjqYGzmDE0Q: folds 
Zi4SmoY9XJ0iI6ixiSZaWQ: checks 
*** FLOP *** [8c Th 9h]
Zi4SmoY9XJ0iI6ixiSZaWQ: checks 
N7O9jUEx2YiQn1+yRYTHmw: bets $0.50
b32FRB7ak2jmfrI8EsDhfQ: raises $5.90 to $6.40 and is all-in
Zi4SmoY9XJ0iI6ixiSZaWQ: folds 
N7O9jUEx2YiQn1+yRYTHmw: calls $5.90
*** TURN *** [8c Th 9h] [4h]
*** RIVER *** [8c Th 9h 4h] [8d]
*** SHOW DOWN ***
N7O9jUEx2YiQn1+yRYTHmw: shows [9d Ts] (two pair, Tens and Nines)
b32FRB7ak2jmfrI8EsDhfQ: shows [8h 9c] (a full house, Eights full of Nines)
b32FRB7ak2jmfrI8EsDhfQ collected $13 from pot
*** SUMMARY ***
Total pot $13.65 | Rake $0.65 
Board [8c Th 9h 4h 8d]
Seat 1: b32FRB7ak2jmfrI8EsDhfQ (button) showed [8h 9c] and won ($13) with a full house, Eights full of Nines
Seat 2: /bjna2FTN7pPjqYGzmDE0Q (small blind) folded before Flop
Seat 3: Zi4SmoY9XJ0iI6ixiSZaWQ (big blind) folded on the Flop
Seat 4: N7O9jUEx2YiQn1+yRYTHmw showed [9d Ts] and lost with two pair, Tens and Nines
Seat 5: LtASJ9OlkqGrrUKGQlpGAw folded before Flop (didn't bet)
Seat 6: SFmT9ZsVopnukjvAzrxTRg folded before Flop (didn't bet)




PokerStars Game #59939480256:  Hold'em No Limit ($0.10/$0.25) - 2009/07/01 0:40:58 ET
Table 'ER5H84HUgJx7HyDLnELLeA' 6-max Seat #4 is the button
Seat 1: pjM/xh4+RG8zrxCobDgYDg ($15.85 in chips) 
Seat 2: nc79pm0LZRdhncq55evVqA ($48.50 in chips) 
Seat 3: 2j+7KACUO5iqZ/NSvIH3vg ($6.05 in chips) 
Seat 4: tkRWn3WaJIfGmCXT2hPvJA ($18.90 in chips) 
Seat 5: mfrkWA3PTeYPkbO6hi98Aw ($23.15 in chips) 
Seat 6: 3zD3qLXT1bEffAoWGnc7wg ($25 in chips) 
mfrkWA3PTeYPkbO6hi98Aw: posts small blind $0.10
3zD3qLXT1bEffAoWGnc7wg: posts big blind $0.25
*** HOLE CARDS ***
pjM/xh4+RG8zrxCobDgYDg: folds 
nc79pm0LZRdhncq55evVqA: folds 
2j+7KACUO5iqZ/NSvIH3vg: calls $0.25
tkRWn3WaJIfGmCXT2hPvJA: folds 
mfrkWA3PTeYPkbO6hi98Aw: folds 
3zD3qLXT1bEffAoWGnc7wg: raises $1 to $1.25
2j+7KACUO5iqZ/NSvIH3vg: calls $1
*** FLOP *** [Jd Ks 7d]
3zD3qLXT1bEffAoWGnc7wg: bets $1.75
2j+7KACUO5iqZ/NSvIH3vg: calls $1.75
*** TURN *** [Jd Ks 7d] [6c]
3zD3qLXT1bEffAoWGnc7wg: bets $4.25
2j+7KACUO5iqZ/NSvIH3vg: calls $3.05 and is all-in
Uncalled bet ($1.20) returned to 3zD3qLXT1bEffAoWGnc7wg
*** RIVER *** [Jd Ks 7d 6c] [Ts]
*** SHOW DOWN ***
3zD3qLXT1bEffAoWGnc7wg: shows [As Ah] (a pair of Aces)
2j+7KACUO5iqZ/NSvIH3vg: mucks hand 
3zD3qLXT1bEffAoWGnc7wg collected $11.65 from pot
*** SUMMARY ***
Total pot $12.20 | Rake $0.55 
Board [Jd Ks 7d 6c Ts]
Seat 1: pjM/xh4+RG8zrxCobDgYDg folded before Flop (didn't bet)
Seat 2: nc79pm0LZRdhncq55evVqA folded before Flop (didn't bet)
Seat 3: 2j+7KACUO5iqZ/NSvIH3vg mucked
Seat 4: tkRWn3WaJIfGmCXT2hPvJA (button) folded before Flop (didn't bet)
Seat 5: mfrkWA3PTeYPkbO6hi98Aw (small blind) folded before Flop
Seat 6: 3zD3qLXT1bEffAoWGnc7wg (big blind) showed [As Ah] and won ($11.65) with a pair of Aces




PokerStars Game #59939480174:  Hold'em No Limit ($0.10/$0.25) - 2009/07/01 0:40:58 ET
Table 'a0kk1yz54EMczhut3KjrxQ' 6-max Seat #6 is the button
Seat 1: V3LJvbHVJHmOj2fd7zIDhA ($28.75 in chips) 
Seat 2: nc79pm0LZRdhncq55evVqA ($25 in chips) 
Seat 3: FabaCGPqGJLjRL48CMvjiQ ($23.25 in chips) 
Seat 4: FYepjhAvF8ZdVCmqHIy+eQ ($26.70 in chips) 
Seat 5: cPO/1/dTcZpLkQFm3jH3Rg ($26.15 in chips) 
Seat 6: DTzxFTXVrCqrpjq9B9Vg/g ($15.05 in chips) 
V3LJvbHVJHmOj2fd7zIDhA: posts small blind $0.10
nc79pm0LZRdhncq55evVqA: posts big blind $0.25
*** HOLE CARDS ***
FabaCGPqGJLjRL48CMvjiQ: folds 
FYepjhAvF8ZdVCmqHIy+eQ: raises $0.75 to $1
cPO/1/dTcZpLkQFm3jH3Rg: folds 
DTzxFTXVrCqrpjq9B9Vg/g: folds 
V3LJvbHVJHmOj2fd7zIDhA: folds 
nc79pm0LZRdhncq55evVqA: calls $0.75
*** FLOP *** [2c 2s Ts]
nc79pm0LZRdhncq55evVqA: checks 
FYepjhAvF8ZdVCmqHIy+eQ: bets $1.65
nc79pm0LZRdhncq55evVqA: folds 
Uncalled bet ($1.65) returned to FYepjhAvF8ZdVCmqHIy+eQ
FYepjhAvF8ZdVCmqHIy+eQ collected $2 from pot
FYepjhAvF8ZdVCmqHIy+eQ: doesn't show hand 
*** SUMMARY ***
Total pot $2.10 | Rake $0.10 
Board [2c 2s Ts]
Seat 1: V3LJvbHVJHmOj2fd7zIDhA (small blind) folded before Flop
Seat 2: nc79pm0LZRdhncq55evVqA (big blind) folded on the Flop
Seat 3: FabaCGPqGJLjRL48CMvjiQ folded before Flop (didn't bet)
Seat 4: FYepjhAvF8ZdVCmqHIy+eQ collected ($2)
Seat 5: cPO/1/dTcZpLkQFm3jH3Rg folded before Flop (didn't bet)
Seat 6: DTzxFTXVrCqrpjq9B9Vg/g (button) folded before Flop (didn't bet)




PokerStars Game #59939481248:  Hold'em No Limit ($0.10/$0.25) - 2009/07/01 0:40:59 ET
Table 'b64Z+5XI1xkQzNfq4QHr3A' 6-max Seat #2 is the button
Seat 1: qccGLncfUaN00Few5HsgYg ($54.65 in chips) 
Seat 2: SS/yfeArhULzIcOPe8MdPg ($34.40 in chips) 
Seat 3: u/yN5P9f3KlATg6WLWNkBQ ($24.75 in chips) 
Seat 4: SxIIgwXYLkwd6m3wLyPTCw ($25.35 in chips) 
Seat 5: d0J1xuhsynEY81YHwAvJ5g ($33.25 in chips) 
Seat 6: 8ClCHtFXGNplITm+63KB+Q ($38.35 in chips) 
u/yN5P9f3KlATg6WLWNkBQ: posts small blind $0.10
SxIIgwXYLkwd6m3wLyPTCw: posts big blind $0.25
*** HOLE CARDS ***
d0J1xuhsynEY81YHwAvJ5g: folds 
8ClCHtFXGNplITm+63KB+Q: folds 
qccGLncfUaN00Few5HsgYg: calls $0.25
SS/yfeArhULzIcOPe8MdPg: folds 
u/yN5P9f3KlATg6WLWNkBQ: calls $0.15
SxIIgwXYLkwd6m3wLyPTCw: checks 
*** FLOP *** [6c Js 9d]
u/yN5P9f3KlATg6WLWNkBQ: checks 
SxIIgwXYLkwd6m3wLyPTCw: bets $0.50
qccGLncfUaN00Few5HsgYg: calls $0.50
u/yN5P9f3KlATg6WLWNkBQ: folds 
*** TURN *** [6c Js 9d] [9c]
SxIIgwXYLkwd6m3wLyPTCw: bets $1
qccGLncfUaN00Few5HsgYg: calls $1
*** RIVER *** [6c Js 9d 9c] [3c]
SxIIgwXYLkwd6m3wLyPTCw: checks 
qccGLncfUaN00Few5HsgYg: checks 
*** SHOW DOWN ***
SxIIgwXYLkwd6m3wLyPTCw: shows [8s Tc] (a pair of Nines)
qccGLncfUaN00Few5HsgYg: shows [Td Qd] (a pair of Nines - Queen kicker)
qccGLncfUaN00Few5HsgYg collected $3.60 from pot
*** SUMMARY ***
Total pot $3.75 | Rake $0.15 
Board [6c Js 9d 9c 3c]
Seat 1: qccGLncfUaN00Few5HsgYg showed [Td Qd] and won ($3.60) with a pair of Nines
Seat 2: SS/yfeArhULzIcOPe8MdPg (button) folded before Flop (didn't bet)
Seat 3: u/yN5P9f3KlATg6WLWNkBQ (small blind) folded on the Flop
Seat 4: SxIIgwXYLkwd6m3wLyPTCw (big blind) showed [8s Tc] and lost with a pair of Nines
Seat 5: d0J1xuhsynEY81YHwAvJ5g folded before Flop (didn't bet)
Seat 6: 8ClCHtFXGNplITm+63KB+Q folded before Flop (didn't bet)




PokerStars Game #59939481318:  Hold'em No Limit ($0.10/$0.25) - 2009/07/01 0:40:59 ET
Table 'AchTjdLS1zBUbH3ZIx6f0w' 6-max Seat #2 is the button
Seat 1: IzVI+wIP7IS+d0sugIrOPQ ($25.55 in chips) 
Seat 2: kG34n23qFQA3nzdOJTQ1dA ($40.20 in chips) 
Seat 3: ehifenV36yVvJMnV63D3cg ($1.85 in chips) 
Seat 4: q6WfTUAD9mowIP63ASq2Dg ($26.70 in chips) 
Seat 5: oBUDUfeUyCbZBsjxHZgSiw ($37.70 in chips) 
Seat 6: 5tB0F9NjPSUL4FzmzBMs2Q ($25 in chips) 
ehifenV36yVvJMnV63D3cg: posts small blind $0.10
q6WfTUAD9mowIP63ASq2Dg: posts big blind $0.25
*** HOLE CARDS ***
oBUDUfeUyCbZBsjxHZgSiw: folds 
5tB0F9NjPSUL4FzmzBMs2Q: folds 
IzVI+wIP7IS+d0sugIrOPQ: calls $0.25
kG34n23qFQA3nzdOJTQ1dA: folds 
ehifenV36yVvJMnV63D3cg: calls $0.15
q6WfTUAD9mowIP63ASq2Dg: checks 
*** FLOP *** [4c 4h 9h]
ehifenV36yVvJMnV63D3cg: bets $0.75
q6WfTUAD9mowIP63ASq2Dg: folds 
IzVI+wIP7IS+d0sugIrOPQ: folds 
Uncalled bet ($0.75) returned to ehifenV36yVvJMnV63D3cg
ehifenV36yVvJMnV63D3cg collected $0.75 from pot
ehifenV36yVvJMnV63D3cg: doesn't show hand 
*** SUMMARY ***
Total pot $0.75 | Rake $0 
Board [4c 4h 9h]
Seat 1: IzVI+wIP7IS+d0sugIrOPQ folded on the Flop
Seat 2: kG34n23qFQA3nzdOJTQ1dA (button) folded before Flop (didn't bet)
Seat 3: ehifenV36yVvJMnV63D3cg (small blind) collected ($0.75)
Seat 4: q6WfTUAD9mowIP63ASq2Dg (big blind) folded on the Flop
Seat 5: oBUDUfeUyCbZBsjxHZgSiw folded before Flop (didn't bet)
Seat 6: 5tB0F9NjPSUL4FzmzBMs2Q folded before Flop (didn't bet)




PokerStars Game #59939481108:  Hold'em No Limit ($0.10/$0.25) - 2009/07/01 0:40:59 ET
Table 'fRxOyfaHXkWUDLv4eSxFew' 9-max Seat #7 is the button
Seat 2: TeWJxSETzbXGiYKx0y+dtg ($25 in chips) 
Seat 3: hBMUlEpyU74r/fwDgIpXjQ ($26.05 in chips) 
Seat 4: aCVg6cCxQcqClhB9nq/p1w ($51.50 in chips) 
Seat 6: N/O9ADKpmqB2ASZuqgodlw ($7.15 in chips) 
Seat 7: 7cv+9Zc9HIQHNvYsMfV3uA ($54.05 in chips) 
Seat 8: 1K6QGyJP9P9xmRac2fH4OQ ($25 in chips) 
Seat 9: H5Se03ZqSX7tbULXur2MAg ($23.80 in chips) 
1K6QGyJP9P9xmRac2fH4OQ: posts small blind $0.10
H5Se03ZqSX7tbULXur2MAg: posts big blind $0.25
OlPJsgR4xypSg/w1z7Gyvw: sits out 
*** HOLE CARDS ***
TeWJxSETzbXGiYKx0y+dtg: folds 
hBMUlEpyU74r/fwDgIpXjQ: folds 
aCVg6cCxQcqClhB9nq/p1w: folds 
N/O9ADKpmqB2ASZuqgodlw: raises $0.75 to $1
7cv+9Zc9HIQHNvYsMfV3uA: folds 
1K6QGyJP9P9xmRac2fH4OQ: folds 
H5Se03ZqSX7tbULXur2MAg: folds 
Uncalled bet ($0.75) returned to N/O9ADKpmqB2ASZuqgodlw
N/O9ADKpmqB2ASZuqgodlw collected $0.60 from pot
*** SUMMARY ***
Total pot $0.60 | Rake $0 
Seat 2: TeWJxSETzbXGiYKx0y+dtg folded before Flop (didn't bet)
Seat 3: hBMUlEpyU74r/fwDgIpXjQ folded before Flop (didn't bet)
Seat 4: aCVg6cCxQcqClhB9nq/p1w folded before Flop (didn't bet)
Seat 6: N/O9ADKpmqB2ASZuqgodlw collected ($0.60)
Seat 7: 7cv+9Zc9HIQHNvYsMfV3uA (button) folded before Flop (didn't bet)
Seat 8: 1K6QGyJP9P9xmRac2fH4OQ (small blind) folded before Flop
Seat 9: H5Se03ZqSX7tbULXur2MAg (big blind) folded before Flop




PokerStars Game #59939480974:  Hold'em No Limit ($0.10/$0.25) - 2009/07/01 0:40:59 ET
Table '3Ns9nuTkynfwbBfBXzg6ww' 6-max Seat #5 is the button
Seat 3: HyXsCmHsOHAlL2pzZ9IYAg ($4.75 in chips) 
Seat 4: kyRaCIljYA6l33lSKQfNsg ($26.65 in chips) 
Seat 5: kBQU/db00TVAMeomlhblPg ($23.25 in chips) 
HyXsCmHsOHAlL2pzZ9IYAg: posts small blind $0.10
kyRaCIljYA6l33lSKQfNsg: posts big blind $0.25
*** HOLE CARDS ***
kBQU/db00TVAMeomlhblPg: raises $0.50 to $0.75
HyXsCmHsOHAlL2pzZ9IYAg: calls $0.65
kyRaCIljYA6l33lSKQfNsg: folds 
*** FLOP *** [5h 4h Th]
kyRaCIljYA6l33lSKQfNsg leaves the table
HyXsCmHsOHAlL2pzZ9IYAg: bets $1
kBQU/db00TVAMeomlhblPg: folds 
Uncalled bet ($1) returned to HyXsCmHsOHAlL2pzZ9IYAg
HyXsCmHsOHAlL2pzZ9IYAg collected $1.70 from pot
*** SUMMARY ***
Total pot $1.75 | Rake $0.05 
Board [5h 4h Th]
Seat 3: HyXsCmHsOHAlL2pzZ9IYAg (small blind) collected ($1.70)
Seat 4: kyRaCIljYA6l33lSKQfNsg (big blind) folded before Flop
Seat 5: kBQU/db00TVAMeomlhblPg (button) folded on the Flop




PokerStars Game #59939481106:  Hold'em No Limit ($0.10/$0.25) - 2009/07/01 0:40:59 ET
Table 'sJ4KpS2GE5Qrsu1/cFjJUw' 9-max Seat #8 is the button
Seat 1: QsLvCwfSWqP+CfjwUnjpXQ ($14.85 in chips) 
Seat 3: eDil7UzSZCjyh1VP6SVXJQ ($7.55 in chips) 
Seat 8: f8ixGbSVIs6Be0mH69ldVQ ($14.10 in chips) 
QsLvCwfSWqP+CfjwUnjpXQ: posts small blind $0.10
eDil7UzSZCjyh1VP6SVXJQ: posts big blind $0.25
*** HOLE CARDS ***
f8ixGbSVIs6Be0mH69ldVQ: folds 
QsLvCwfSWqP+CfjwUnjpXQ: calls $0.15
eDil7UzSZCjyh1VP6SVXJQ: checks 
*** FLOP *** [Qh 7h 4h]
QsLvCwfSWqP+CfjwUnjpXQ: checks 
eDil7UzSZCjyh1VP6SVXJQ: checks 
*** TURN *** [Qh 7h 4h] [Kc]
QsLvCwfSWqP+CfjwUnjpXQ: checks 
eDil7UzSZCjyh1VP6SVXJQ: checks 
*** RIVER *** [Qh 7h 4h Kc] [2s]
QsLvCwfSWqP+CfjwUnjpXQ: checks 
eDil7UzSZCjyh1VP6SVXJQ: checks 
*** SHOW DOWN ***
QsLvCwfSWqP+CfjwUnjpXQ: shows [Ac Th] (high card Ace)
eDil7UzSZCjyh1VP6SVXJQ: shows [As Tc] (high card Ace)
QsLvCwfSWqP+CfjwUnjpXQ collected $0.25 from pot
eDil7UzSZCjyh1VP6SVXJQ collected $0.25 from pot
*** SUMMARY ***
Total pot $0.50 | Rake $0 
Board [Qh 7h 4h Kc 2s]
Seat 1: QsLvCwfSWqP+CfjwUnjpXQ (small blind) showed [Ac Th] and won ($0.25) with high card Ace
Seat 3: eDil7UzSZCjyh1VP6SVXJQ (big blind) showed [As Tc] and won ($0.25) with high card Ace
Seat 8: f8ixGbSVIs6Be0mH69ldVQ (button) folded before Flop (didn't bet)




PokerStars Game #59939481458:  Hold'em No Limit ($0.10/$0.25) - 2009/07/01 0:40:59 ET
Table '8QBBaev+cI2i/r2H6ml/lg' 9-max Seat #9 is the button
Seat 4: ZoG0obuajzVjwgd7lNHjgg ($1.65 in chips) 
Seat 6: cxE+szmvEUe7vE+z2ozM2Q ($10 in chips) 
Seat 9: Ml2bY77EHbM51ZWD7dnIWg ($3.70 in chips) 
ZoG0obuajzVjwgd7lNHjgg: posts small blind $0.10
cxE+szmvEUe7vE+z2ozM2Q: posts big blind $0.25
*** HOLE CARDS ***
Ml2bY77EHbM51ZWD7dnIWg: folds 
ZoG0obuajzVjwgd7lNHjgg: raises $1.40 to $1.65 and is all-in
cxE+szmvEUe7vE+z2ozM2Q: folds 
Uncalled bet ($1.40) returned to ZoG0obuajzVjwgd7lNHjgg
ZoG0obuajzVjwgd7lNHjgg collected $0.50 from pot
*** SUMMARY ***
Total pot $0.50 | Rake $0 
Seat 4: ZoG0obuajzVjwgd7lNHjgg (small blind) collected ($0.50)
Seat 6: cxE+szmvEUe7vE+z2ozM2Q (big blind) folded before Flop
Seat 9: Ml2bY77EHbM51ZWD7dnIWg (button) folded before Flop (didn't bet)




PokerStars Game #59939481912:  Hold'em No Limit ($0.10/$0.25) - 2009/07/01 0:41:00 ET
Table 'g+mPuNJBCHKE9ents7ZGtg' 6-max Seat #1 is the button
Seat 1: rlqzz6sTpiZGIiNuqy7QUA ($39.20 in chips) 
Seat 2: fZQg9veL7Dd/Z04ZTjC+wQ ($30.10 in chips) 
Seat 3: 9jSiy0meE9XJKkdIZwyTEQ ($25.25 in chips) 
Seat 4: mfrkWA3PTeYPkbO6hi98Aw ($27 in chips) 
Seat 6: MS2T205Bjud7PnNoANu4vQ ($46.20 in chips) 
fZQg9veL7Dd/Z04ZTjC+wQ: posts small blind $0.10
9jSiy0meE9XJKkdIZwyTEQ: posts big blind $0.25
32YL2ZEp8NT4JB2RVM9euQ: sits out 
*** HOLE CARDS ***
mfrkWA3PTeYPkbO6hi98Aw: folds 
MS2T205Bjud7PnNoANu4vQ: folds 
rlqzz6sTpiZGIiNuqy7QUA: raises $0.75 to $1
fZQg9veL7Dd/Z04ZTjC+wQ: folds 
9jSiy0meE9XJKkdIZwyTEQ: folds 
Uncalled bet ($0.75) returned to rlqzz6sTpiZGIiNuqy7QUA
rlqzz6sTpiZGIiNuqy7QUA collected $0.60 from pot
*** SUMMARY ***
Total pot $0.60 | Rake $0 
Seat 1: rlqzz6sTpiZGIiNuqy7QUA (button) collected ($0.60)
Seat 2: fZQg9veL7Dd/Z04ZTjC+wQ (small blind) folded before Flop
Seat 3: 9jSiy0meE9XJKkdIZwyTEQ (big blind) folded before Flop
Seat 4: mfrkWA3PTeYPkbO6hi98Aw folded before Flop (didn't bet)
Seat 6: MS2T205Bjud7PnNoANu4vQ folded before Flop (didn't bet)




PokerStars Game #59939481558:  Hold'em No Limit ($0.10/$0.25) - 2009/07/01 0:41:00 ET
Table '8UiaYOdeBwzanG6w1SMeFg' 9-max Seat #8 is the button
Seat 2: 18G4P1XstjNvItdGUITxgw ($25 in chips) 
Seat 3: A7xJNkBMCQG6Zuocn2v8YQ ($14.60 in chips) 
Seat 4: H5Se03ZqSX7tbULXur2MAg ($29.85 in chips) 
Seat 5: UmzixCpC0bAc1lDEjgB3NQ ($19.05 in chips) 
Seat 6: N6fYvIzQLKaydFLKQGtMlQ ($23.30 in chips) 
Seat 7: E0iYnEVO2ho7dH3QcCjw7g ($21.25 in chips) 
Seat 8: hBMUlEpyU74r/fwDgIpXjQ ($53.40 in chips) 
eyesirish will be allowed to play after the button
18G4P1XstjNvItdGUITxgw: posts small blind $0.10
A7xJNkBMCQG6Zuocn2v8YQ: posts big blind $0.25
*** HOLE CARDS ***
H5Se03ZqSX7tbULXur2MAg: folds 
UmzixCpC0bAc1lDEjgB3NQ: folds 
N6fYvIzQLKaydFLKQGtMlQ: folds 
E0iYnEVO2ho7dH3QcCjw7g: folds 
hBMUlEpyU74r/fwDgIpXjQ: folds 
eyesirish leaves the table
18G4P1XstjNvItdGUITxgw: raises $0.50 to $0.75
A7xJNkBMCQG6Zuocn2v8YQ: calls $0.50
*** FLOP *** [9h 9d Jh]
18G4P1XstjNvItdGUITxgw: checks 
A7xJNkBMCQG6Zuocn2v8YQ: checks 
*** TURN *** [9h 9d Jh] [Jd]
18G4P1XstjNvItdGUITxgw: bets $0.50
A7xJNkBMCQG6Zuocn2v8YQ: calls $0.50
*** RIVER *** [9h 9d Jh Jd] [7c]
18G4P1XstjNvItdGUITxgw: bets $0.75
A7xJNkBMCQG6Zuocn2v8YQ: calls $0.75
*** SHOW DOWN ***
18G4P1XstjNvItdGUITxgw: shows [Qh Kc] (two pair, Jacks and Nines)
A7xJNkBMCQG6Zuocn2v8YQ: shows [Ah 5d] (two pair, Jacks and Nines - Ace kicker)
A7xJNkBMCQG6Zuocn2v8YQ collected $3.85 from pot
K4All-In joins the table at seat #9 
*** SUMMARY ***
Total pot $4 | Rake $0.15 
Board [9h 9d Jh Jd 7c]
Seat 2: 18G4P1XstjNvItdGUITxgw (small blind) showed [Qh Kc] and lost with two pair, Jacks and Nines
Seat 3: A7xJNkBMCQG6Zuocn2v8YQ (big blind) showed [Ah 5d] and won ($3.85) with two pair, Jacks and Nines
Seat 4: H5Se03ZqSX7tbULXur2MAg folded before Flop (didn't bet)
Seat 5: UmzixCpC0bAc1lDEjgB3NQ folded before Flop (didn't bet)
Seat 6: N6fYvIzQLKaydFLKQGtMlQ folded before Flop (didn't bet)
Seat 7: E0iYnEVO2ho7dH3QcCjw7g folded before Flop (didn't bet)
Seat 8: hBMUlEpyU74r/fwDgIpXjQ (button) folded before Flop (didn't bet)




PokerStars Game #59939482162:  Hold'em No Limit ($0.10/$0.25) - 2009/07/01 0:41:00 ET
Table 'BmUMTVcNATeov2rAGYU0Qg' 9-max Seat #7 is the button
Seat 1: v5jnQ1gfh9nLla3kMXG7Yg ($4.75 in chips) 
Seat 2: jJnMGXoBXye+afMd0k0rUw ($11.80 in chips) 
Seat 4: aNpwfA31EREwO+ar4XzBCw ($35.85 in chips) 
Seat 5: EBPuArucumZnjWoW71jHBg ($48.25 in chips) 
Seat 6: JxpnpCmvRAcrEUy7mq1iAg ($5.90 in chips) 
Seat 7: zWJ/yHAvi0TtCR9RMsJosQ ($55.60 in chips) 
Seat 8: f/H6PsHRl4W1JyNsEDvPtg ($14.25 in chips) 
f/H6PsHRl4W1JyNsEDvPtg: posts small blind $0.10
pocketcrape: is sitting out 
v5jnQ1gfh9nLla3kMXG7Yg: posts big blind $0.25
*** HOLE CARDS ***
pocketcrape leaves the table
jJnMGXoBXye+afMd0k0rUw: folds 
aNpwfA31EREwO+ar4XzBCw: folds 
EBPuArucumZnjWoW71jHBg: calls $0.25
JxpnpCmvRAcrEUy7mq1iAg: folds 
hJ4uYjNmSZdjrKA8cjZqCA has returned
zWJ/yHAvi0TtCR9RMsJosQ: raises $0.75 to $1
f/H6PsHRl4W1JyNsEDvPtg: calls $0.90
v5jnQ1gfh9nLla3kMXG7Yg: folds 
EBPuArucumZnjWoW71jHBg: calls $0.75
*** FLOP *** [Kd 6s 6c]
f/H6PsHRl4W1JyNsEDvPtg: bets $2
EBPuArucumZnjWoW71jHBg: folds 
zWJ/yHAvi0TtCR9RMsJosQ: calls $2
*** TURN *** [Kd 6s 6c] [Js]
f/H6PsHRl4W1JyNsEDvPtg: checks 
zWJ/yHAvi0TtCR9RMsJosQ: bets $3
f/H6PsHRl4W1JyNsEDvPtg: folds 
Uncalled bet ($3) returned to zWJ/yHAvi0TtCR9RMsJosQ
zWJ/yHAvi0TtCR9RMsJosQ collected $6.90 from pot
*** SUMMARY ***
Total pot $7.25 | Rake $0.35 
Board [Kd 6s 6c Js]
Seat 1: v5jnQ1gfh9nLla3kMXG7Yg (big blind) folded before Flop
Seat 2: jJnMGXoBXye+afMd0k0rUw folded before Flop (didn't bet)
Seat 4: aNpwfA31EREwO+ar4XzBCw folded before Flop (didn't bet)
Seat 5: EBPuArucumZnjWoW71jHBg folded on the Flop
Seat 6: JxpnpCmvRAcrEUy7mq1iAg folded before Flop (didn't bet)
Seat 7: zWJ/yHAvi0TtCR9RMsJosQ (button) collected ($6.90)
Seat 8: f/H6PsHRl4W1JyNsEDvPtg (small blind) folded on the Turn




PokerStars Game #59939481668:  Hold'em No Limit ($0.10/$0.25) - 2009/07/01 0:41:00 ET
Table '2AUmC2Rslg+QUbLfdgNdfg' 6-max Seat #3 is the button
Seat 1: lgP2sg9oZJsNSXCt7tbwRg ($16.25 in chips) 
Seat 2: CCxAG7iPVlAv3brCqrGBEg ($12.40 in chips) 
Seat 3: iauW7L/+7qzAuHow7CD75Q ($7.20 in chips) 
Seat 4: B6R6e73iyJNddUtXtvYr3Q ($47.70 in chips) 
Seat 5: 8ClCHtFXGNplITm+63KB+Q ($23.30 in chips) 
Seat 6: BvTq4Tu0zBOsniW3eFCnkQ ($33.40 in chips) 
B6R6e73iyJNddUtXtvYr3Q: posts small blind $0.10
8ClCHtFXGNplITm+63KB+Q: posts big blind $0.25
*** HOLE CARDS ***
BvTq4Tu0zBOsniW3eFCnkQ: folds 
lgP2sg9oZJsNSXCt7tbwRg: folds 
CCxAG7iPVlAv3brCqrGBEg: folds 
iauW7L/+7qzAuHow7CD75Q: folds 
B6R6e73iyJNddUtXtvYr3Q: calls $0.15
8ClCHtFXGNplITm+63KB+Q: checks 
*** FLOP *** [7h 9c 2h]
B6R6e73iyJNddUtXtvYr3Q: checks 
8ClCHtFXGNplITm+63KB+Q: checks 
*** TURN *** [7h 9c 2h] [8d]
B6R6e73iyJNddUtXtvYr3Q: bets $0.50
8ClCHtFXGNplITm+63KB+Q: folds 
Uncalled bet ($0.50) returned to B6R6e73iyJNddUtXtvYr3Q
B6R6e73iyJNddUtXtvYr3Q collected $0.50 from pot
B6R6e73iyJNddUtXtvYr3Q: doesn't show hand 
*** SUMMARY ***
Total pot $0.50 | Rake $0 
Board [7h 9c 2h 8d]
Seat 1: lgP2sg9oZJsNSXCt7tbwRg folded before Flop (didn't bet)
Seat 2: CCxAG7iPVlAv3brCqrGBEg folded before Flop (didn't bet)
Seat 3: iauW7L/+7qzAuHow7CD75Q (button) folded before Flop (didn't bet)
Seat 4: B6R6e73iyJNddUtXtvYr3Q (small blind) collected ($0.50)
Seat 5: 8ClCHtFXGNplITm+63KB+Q (big blind) folded on the Turn
Seat 6: BvTq4Tu0zBOsniW3eFCnkQ folded before Flop (didn't bet)




PokerStars Game #59939481694:  Hold'em No Limit ($0.10/$0.25) - 2009/07/01 0:41:00 ET
Table 'fHv1Mk7ZbLjprZTGWKPiEQ' 6-max Seat #6 is the button
Seat 1: nrBtxp+MnBtUJ1AIhZxHkg ($28.55 in chips) 
Seat 2: f6TKWwdxmqfPaZe08T+mgg ($5 in chips) 
Seat 3: HyeBXe7tNOZjTdX/zI0BZQ ($15 in chips) 
Seat 4: TSmua8tGK3sTbwi0ynrW9Q ($49.10 in chips) 
Seat 5: edio/rLJ06xeZOfLhoL3UA ($28.60 in chips) 
Seat 6: AjG0X+rNtc2W08eph8oqpw ($8.95 in chips) 
nrBtxp+MnBtUJ1AIhZxHkg: posts small blind $0.10
f6TKWwdxmqfPaZe08T+mgg: posts big blind $0.25
*** HOLE CARDS ***
HyeBXe7tNOZjTdX/zI0BZQ: folds 
TSmua8tGK3sTbwi0ynrW9Q: folds 
edio/rLJ06xeZOfLhoL3UA: raises $1 to $1.25
AjG0X+rNtc2W08eph8oqpw: folds 
nrBtxp+MnBtUJ1AIhZxHkg: calls $1.15
f6TKWwdxmqfPaZe08T+mgg: folds 
*** FLOP *** [Th 8c 5d]
nrBtxp+MnBtUJ1AIhZxHkg: checks 
edio/rLJ06xeZOfLhoL3UA: bets $1.25
nrBtxp+MnBtUJ1AIhZxHkg: calls $1.25
*** TURN *** [Th 8c 5d] [4c]
nrBtxp+MnBtUJ1AIhZxHkg: checks 
edio/rLJ06xeZOfLhoL3UA: bets $3.25
nrBtxp+MnBtUJ1AIhZxHkg: calls $3.25
*** RIVER *** [Th 8c 5d 4c] [6c]
nrBtxp+MnBtUJ1AIhZxHkg: checks 
edio/rLJ06xeZOfLhoL3UA: bets $8
nrBtxp+MnBtUJ1AIhZxHkg: calls $8
*** SHOW DOWN ***
edio/rLJ06xeZOfLhoL3UA: shows [6s 7d] (a straight, Four to Eight)
nrBtxp+MnBtUJ1AIhZxHkg: shows [7h 8d] (a straight, Four to Eight)
nrBtxp+MnBtUJ1AIhZxHkg collected $13.20 from pot
edio/rLJ06xeZOfLhoL3UA collected $13.20 from pot
*** SUMMARY ***
Total pot $27.75 | Rake $1.35 
Board [Th 8c 5d 4c 6c]
Seat 1: nrBtxp+MnBtUJ1AIhZxHkg (small blind) showed [7h 8d] and won ($13.20) with a straight, Four to Eight
Seat 2: f6TKWwdxmqfPaZe08T+mgg (big blind) folded before Flop
Seat 3: HyeBXe7tNOZjTdX/zI0BZQ folded before Flop (didn't bet)
Seat 4: TSmua8tGK3sTbwi0ynrW9Q folded before Flop (didn't bet)
Seat 5: edio/rLJ06xeZOfLhoL3UA showed [6s 7d] and won ($13.20) with a straight, Four to Eight
Seat 6: AjG0X+rNtc2W08eph8oqpw (button) folded before Flop (didn't bet)




PokerStars Game #59939482188:  Hold'em No Limit ($0.10/$0.25) - 2009/07/01 0:41:00 ET
Table 'edvgY2YQ1I34euq4EVqGnA' 6-max Seat #2 is the button
Seat 1: mvFHK3pE7tCxJEqLjKC70Q ($26.90 in chips) 
Seat 2: 0vuFCuW1P8y6cFZZvuXNPg ($11.85 in chips) 
Seat 3: HjESR5/RHWT5gaSbIVQQ0Q ($17.85 in chips) 
Seat 4: JFIAqU8lCZ0vWwEl4bdGsg ($29.60 in chips) 
Seat 5: EE16Ua5b1HSsYej5zeXOlA ($25.60 in chips) 
Seat 6: kG34n23qFQA3nzdOJTQ1dA ($68.60 in chips) 
HjESR5/RHWT5gaSbIVQQ0Q: posts small blind $0.10
JFIAqU8lCZ0vWwEl4bdGsg: posts big blind $0.25
*** HOLE CARDS ***
EE16Ua5b1HSsYej5zeXOlA: folds 
kG34n23qFQA3nzdOJTQ1dA: folds 
mvFHK3pE7tCxJEqLjKC70Q: folds 
0vuFCuW1P8y6cFZZvuXNPg: raises $0.50 to $0.75
HjESR5/RHWT5gaSbIVQQ0Q: folds 
JFIAqU8lCZ0vWwEl4bdGsg: folds 
Uncalled bet ($0.50) returned to 0vuFCuW1P8y6cFZZvuXNPg
0vuFCuW1P8y6cFZZvuXNPg collected $0.60 from pot
*** SUMMARY ***
Total pot $0.60 | Rake $0 
Seat 1: mvFHK3pE7tCxJEqLjKC70Q folded before Flop (didn't bet)
Seat 2: 0vuFCuW1P8y6cFZZvuXNPg (button) collected ($0.60)
Seat 3: HjESR5/RHWT5gaSbIVQQ0Q (small blind) folded before Flop
Seat 4: JFIAqU8lCZ0vWwEl4bdGsg (big blind) folded before Flop
Seat 5: EE16Ua5b1HSsYej5zeXOlA folded before Flop (didn't bet)
Seat 6: kG34n23qFQA3nzdOJTQ1dA folded before Flop (didn't bet)




PokerStars Game #59939482058:  Hold'em No Limit ($0.10/$0.25) - 2009/07/01 0:41:00 ET
Table '/asc7VQ/OpF/oVJ3erB80w' 9-max Seat #8 is the button
Seat 1: OiV1PWZ3IkN29JlmCcnTwQ ($4.70 in chips) 
Seat 2: Th3FldXKQW6hWVVPahaoOQ ($25.80 in chips) 
Seat 3: ie4EwTMMFYxrCXcenJdzsw ($6.45 in chips) 
Seat 4: H9KUl8cmpLgEpOVDA00bCg ($5.25 in chips) 
Seat 5: 8B/dhbQjIWe6ASCdgzktNQ ($25.25 in chips) 
Seat 6: t2nb95S5EEFOEzNx9Itz0g ($3.10 in chips) 
Seat 7: M2QO2DxB5Wawg2h8HSpnYA ($11.65 in chips) 
Seat 8: T5Hk9oiIr+JDDMnEqwFCrw ($5.55 in chips) 
Seat 9: UkJraTKWQIqFeHOyHQ7afQ ($15.15 in chips) 
UkJraTKWQIqFeHOyHQ7afQ: posts small blind $0.10
OiV1PWZ3IkN29JlmCcnTwQ: posts big blind $0.25
*** HOLE CARDS ***
Th3FldXKQW6hWVVPahaoOQ: folds 
ie4EwTMMFYxrCXcenJdzsw: folds 
H9KUl8cmpLgEpOVDA00bCg: folds 
8B/dhbQjIWe6ASCdgzktNQ: folds 
t2nb95S5EEFOEzNx9Itz0g: folds 
M2QO2DxB5Wawg2h8HSpnYA: raises $0.50 to $0.75
T5Hk9oiIr+JDDMnEqwFCrw: folds 
UkJraTKWQIqFeHOyHQ7afQ: folds 
OiV1PWZ3IkN29JlmCcnTwQ: folds 
Uncalled bet ($0.50) returned to M2QO2DxB5Wawg2h8HSpnYA
M2QO2DxB5Wawg2h8HSpnYA collected $0.60 from pot
M2QO2DxB5Wawg2h8HSpnYA: doesn't show hand 
*** SUMMARY ***
Total pot $0.60 | Rake $0 
Seat 1: OiV1PWZ3IkN29JlmCcnTwQ (big blind) folded before Flop
Seat 2: Th3FldXKQW6hWVVPahaoOQ folded before Flop (didn't bet)
Seat 3: ie4EwTMMFYxrCXcenJdzsw folded before Flop (didn't bet)
Seat 4: H9KUl8cmpLgEpOVDA00bCg folded before Flop (didn't bet)
Seat 5: 8B/dhbQjIWe6ASCdgzktNQ folded before Flop (didn't bet)
Seat 6: t2nb95S5EEFOEzNx9Itz0g folded before Flop (didn't bet)
Seat 7: M2QO2DxB5Wawg2h8HSpnYA collected ($0.60)
Seat 8: T5Hk9oiIr+JDDMnEqwFCrw (button) folded before Flop (didn't bet)
Seat 9: UkJraTKWQIqFeHOyHQ7afQ (small blind) folded before Flop




PokerStars Game #59939482606:  Hold'em No Limit ($0.10/$0.25) - 2009/07/01 0:41:01 ET
Table 'wixGE3Zge1qBdnpWijIl/w' 9-max Seat #4 is the button
Seat 1: EcWpc/mcsCWBGKsSdZaXbA ($24.65 in chips) 
Seat 2: vbD+Kd6m/X3hUBBcGpUKjA ($7.85 in chips) 
Seat 3: DdPXdieucQ+n99u1n3A+rQ ($4.65 in chips) 
Seat 4: 4oA316mXLIui1QY63GXBUg ($25 in chips) 
Seat 5: MIVCHqCqqlke0Lb0z7glcw ($38 in chips) 
Seat 6: TlEYI/zXzaKGGsmuvWFd2A ($5.80 in chips) 
Seat 7: qIaaweMCAGmy9HZFT4r/6A ($54.90 in chips) 
Seat 8: hIss79a4pu7GzJZepfgOpg ($25 in chips) 
Seat 9: r6hsffOo1iKmaPYKwAZmFw ($25.75 in chips) 
MIVCHqCqqlke0Lb0z7glcw: posts small blind $0.10
TlEYI/zXzaKGGsmuvWFd2A: posts big blind $0.25
*** HOLE CARDS ***
qIaaweMCAGmy9HZFT4r/6A: folds 
hIss79a4pu7GzJZepfgOpg: folds 
r6hsffOo1iKmaPYKwAZmFw: folds 
EcWpc/mcsCWBGKsSdZaXbA: folds 
vbD+Kd6m/X3hUBBcGpUKjA: folds 
DdPXdieucQ+n99u1n3A+rQ: folds 
4oA316mXLIui1QY63GXBUg: folds 
MIVCHqCqqlke0Lb0z7glcw: folds 
Uncalled bet ($0.15) returned to TlEYI/zXzaKGGsmuvWFd2A
TlEYI/zXzaKGGsmuvWFd2A collected $0.20 from pot
*** SUMMARY ***
Total pot $0.20 | Rake $0 
Seat 1: EcWpc/mcsCWBGKsSdZaXbA folded before Flop (didn't bet)
Seat 2: vbD+Kd6m/X3hUBBcGpUKjA folded before Flop (didn't bet)
Seat 3: DdPXdieucQ+n99u1n3A+rQ folded before Flop (didn't bet)
Seat 4: 4oA316mXLIui1QY63GXBUg (button) folded before Flop (didn't bet)
Seat 5: MIVCHqCqqlke0Lb0z7glcw (small blind) folded before Flop
Seat 6: TlEYI/zXzaKGGsmuvWFd2A (big blind) collected ($0.20)
Seat 7: qIaaweMCAGmy9HZFT4r/6A folded before Flop (didn't bet)
Seat 8: hIss79a4pu7GzJZepfgOpg folded before Flop (didn't bet)
Seat 9: r6hsffOo1iKmaPYKwAZmFw folded before Flop (didn't bet)




PokerStars Game #59939482420:  Hold'em No Limit ($0.10/$0.25) - 2009/07/01 0:41:01 ET
Table 'zojWVNukhD2n8RTfHCOwwg' 9-max Seat #7 is the button
Seat 1: DIBbjEYGs+TVdVgEB/4+3w ($41.45 in chips) 
Seat 2: ZeR3hkj1gVv9J4yPCmRrjA ($26.60 in chips) 
Seat 3: 1esmRaxnod+zAkE+7BtzMA ($16.75 in chips) 
Seat 4: Pb7qJqn2QUbp+oYBNQxyyA ($26.45 in chips) 
Seat 6: 2xNcp4M2UG8Li2PMEnWcgA ($10.20 in chips) 
Seat 7: H5Se03ZqSX7tbULXur2MAg ($26.95 in chips) 
Seat 8: j4q3p0lesp63b1gZDwLBZw ($5 in chips) 
Seat 9: 4oA316mXLIui1QY63GXBUg ($25 in chips) 
j4q3p0lesp63b1gZDwLBZw: posts small blind $0.10
4oA316mXLIui1QY63GXBUg: posts big blind $0.25
*** HOLE CARDS ***
DIBbjEYGs+TVdVgEB/4+3w: folds 
ZeR3hkj1gVv9J4yPCmRrjA: folds 
1esmRaxnod+zAkE+7BtzMA: calls $0.25
Pb7qJqn2QUbp+oYBNQxyyA: folds 
2xNcp4M2UG8Li2PMEnWcgA: folds 
H5Se03ZqSX7tbULXur2MAg: folds 
j4q3p0lesp63b1gZDwLBZw: folds 
4oA316mXLIui1QY63GXBUg: checks 
*** FLOP *** [4d 7c 5c]
4oA316mXLIui1QY63GXBUg: checks 
1esmRaxnod+zAkE+7BtzMA: checks 
*** TURN *** [4d 7c 5c] [Ad]
4oA316mXLIui1QY63GXBUg: bets $0.50
1esmRaxnod+zAkE+7BtzMA: folds 
Uncalled bet ($0.50) returned to 4oA316mXLIui1QY63GXBUg
4oA316mXLIui1QY63GXBUg collected $0.60 from pot
4oA316mXLIui1QY63GXBUg: doesn't show hand 
*** SUMMARY ***
Total pot $0.60 | Rake $0 
Board [4d 7c 5c Ad]
Seat 1: DIBbjEYGs+TVdVgEB/4+3w folded before Flop (didn't bet)
Seat 2: ZeR3hkj1gVv9J4yPCmRrjA folded before Flop (didn't bet)
Seat 3: 1esmRaxnod+zAkE+7BtzMA folded on the Turn
Seat 4: Pb7qJqn2QUbp+oYBNQxyyA folded before Flop (didn't bet)
Seat 6: 2xNcp4M2UG8Li2PMEnWcgA folded before Flop (didn't bet)
Seat 7: H5Se03ZqSX7tbULXur2MAg (button) folded before Flop (didn't bet)
Seat 8: j4q3p0lesp63b1gZDwLBZw (small blind) folded before Flop
Seat 9: 4oA316mXLIui1QY63GXBUg (big blind) collected ($0.60)




PokerStars Game #59939483280:  Hold'em No Limit ($0.10/$0.25) - 2009/07/01 0:41:02 ET
Table 'Xi38lWH8L2JHRAsKYVX8Qg' 6-max Seat #1 is the button
Seat 1: AqQ7DFpHkgIzTwDu+rClcg ($5.50 in chips) 
Seat 2: YjCHRUY3WJtHMnkcRxvmug ($39.55 in chips) 
Seat 4: d0J1xuhsynEY81YHwAvJ5g ($25 in chips) 
Seat 6: aogAb4Eienxztk8p2v9VVw ($22 in chips) 
YjCHRUY3WJtHMnkcRxvmug: posts small blind $0.10
d0J1xuhsynEY81YHwAvJ5g: posts big blind $0.25
79ID/ub1Pt/mDpCprVmOoA: sits out 
*** HOLE CARDS ***
6DwBRH+xZ12AAZmeAg+aXw joins the table at seat #3 
aogAb4Eienxztk8p2v9VVw: raises $0.75 to $1
AqQ7DFpHkgIzTwDu+rClcg: folds 
YjCHRUY3WJtHMnkcRxvmug: folds 
d0J1xuhsynEY81YHwAvJ5g: folds 
Uncalled bet ($0.75) returned to aogAb4Eienxztk8p2v9VVw
YjCHRUY3WJtHMnkcRxvmug leaves the table
aogAb4Eienxztk8p2v9VVw collected $0.60 from pot
aogAb4Eienxztk8p2v9VVw: doesn't show hand 
*** SUMMARY ***
Total pot $0.60 | Rake $0 
Seat 1: AqQ7DFpHkgIzTwDu+rClcg (button) folded before Flop (didn't bet)
Seat 2: YjCHRUY3WJtHMnkcRxvmug (small blind) folded before Flop
Seat 4: d0J1xuhsynEY81YHwAvJ5g (big blind) folded before Flop
Seat 6: aogAb4Eienxztk8p2v9VVw collected ($0.60)




PokerStars Game #59939483390:  Hold'em No Limit ($0.10/$0.25) - 2009/07/01 0:41:02 ET
Table 'P1IJQ2p3ACFySC35W1qwQw' 9-max Seat #3 is the button
Seat 2: E0iYnEVO2ho7dH3QcCjw7g ($20 in chips) 
Seat 3: Ml2bY77EHbM51ZWD7dnIWg ($16.80 in chips) 
Seat 4: LuckyShot



PokerStars Game #59939483104:  Hold'em No Limit ($0.10/$0.25) - 2009/07/01 0:41:02 ET
Table 'Ok3oDLIsTc2+KxPcI0bAOA' 6-max Seat #2 is the button
Seat 1: agQm3ugZ3qSVYNgNu1ddeA ($26.70 in chips) 
Seat 2: oseFhpinoe+Zg4j5xyBjyQ ($30.35 in chips) 
Seat 3: I1TxPvWj8NfG8orglCinNA ($25 in chips) 
Seat 4: WMiAkibyLuLJ32VI20myug ($12.05 in chips) 
Seat 5: nc79pm0LZRdhncq55evVqA ($28.25 in chips) 
Seat 6: JFIAqU8lCZ0vWwEl4bdGsg ($29 in chips) 
I1TxPvWj8NfG8orglCinNA: posts small blind $0.10
WMiAkibyLuLJ32VI20myug: posts big blind $0.25
*** HOLE CARDS ***
nc79pm0LZRdhncq55evVqA: folds 
JFIAqU8lCZ0vWwEl4bdGsg: folds 
agQm3ugZ3qSVYNgNu1ddeA: raises $0.50 to $0.75
oseFhpinoe+Zg4j5xyBjyQ: folds 
I1TxPvWj8NfG8orglCinNA: folds 
WMiAkibyLuLJ32VI20myug: folds 
Uncalled bet ($0.50) returned to agQm3ugZ3qSVYNgNu1ddeA
agQm3ugZ3qSVYNgNu1ddeA collected $0.60 from pot
agQm3ugZ3qSVYNgNu1ddeA: doesn't show hand 
*** SUMMARY ***
Total pot $0.60 | Rake $0 
Seat 1: agQm3ugZ3qSVYNgNu1ddeA collected ($0.60)
Seat 2: oseFhpinoe+Zg4j5xyBjyQ (button) folded before Flop (didn't bet)
Seat 3: I1TxPvWj8NfG8orglCinNA (small blind) folded before Flop
Seat 4: WMiAkibyLuLJ32VI20myug (big blind) folded before Flop
Seat 5: nc79pm0LZRdhncq55evVqA folded before Flop (didn't bet)
Seat 6: JFIAqU8lCZ0vWwEl4bdGsg folded before Flop (didn't bet)




PokerStars Game #59939483438:  Hold'em No Limit ($0.10/$0.25) - 2009/07/01 0:41:02 ET
Table 'NtEQAxCeIK2io1CGtW658g' 6-max Seat #5 is the button
Seat 1: lnOV7k25gyN7L5t5YKTgIg ($20.85 in chips) 
Seat 2: nc79pm0LZRdhncq55evVqA ($25.55 in chips) 
Seat 3: m2yWOKfAxqHoy5DDN87Ttw ($24.65 in chips) 
Seat 4: 8296 ($11.65 in chips) 
Seat 5: FStoHe64SQWqAsjya9pDkQ ($28.20 in chips) 
Seat 6: /gJNBeCkWL4o85/jvlZ4BA ($62.45 in chips) 
/gJNBeCkWL4o85/jvlZ4BA: posts small blind $0.10
lnOV7k25gyN7L5t5YKTgIg: posts big blind $0.25
*** HOLE CARDS ***
nc79pm0LZRdhncq55evVqA: folds 
m2yWOKfAxqHoy5DDN87Ttw: folds 
8296: folds 
FStoHe64SQWqAsjya9pDkQ: folds 
/gJNBeCkWL4o85/jvlZ4BA: folds 
Uncalled bet ($0.15) returned to lnOV7k25gyN7L5t5YKTgIg
lnOV7k25gyN7L5t5YKTgIg collected $0.20 from pot
lnOV7k25gyN7L5t5YKTgIg: doesn't show hand 
*** SUMMARY ***
Total pot $0.20 | Rake $0 
Seat 1: lnOV7k25gyN7L5t5YKTgIg (big blind) collected ($0.20)
Seat 2: nc79pm0LZRdhncq55evVqA folded before Flop (didn't bet)
Seat 3: m2yWOKfAxqHoy5DDN87Ttw folded before Flop (didn't bet)
Seat 4: 8296 folded before Flop (didn't bet)
Seat 5: FStoHe64SQWqAsjya9pDkQ (button) folded before Flop (didn't bet)
Seat 6: /gJNBeCkWL4o85/jvlZ4BA (small blind) folded before Flop




PokerStars Game #59939482808:  Hold'em No Limit ($0.10/$0.25) - 2009/07/01 0:41:02 ET
Table 'uFgIyfWPagvEVGEb86da7A' 9-max Seat #8 is the button
Seat 1: 5MgYq10OC5iGoxQFwlJVuw ($15 in chips) 
Seat 2: o3zvoO+PsqGti+1NZGNRrQ ($6.35 in chips) 
Seat 3: q4GZp0xt5Unxtq8PS32SAQ ($35.70 in chips) 
Seat 5: Qi+clOtyDiibLdH2/1Qy8g ($17.30 in chips) 
Seat 6: zDrucyjVn5aeekNEc3cJrA ($22.70 in chips) 
Seat 8: MzxZJee3eU6Q0wg0XTfZew ($11.35 in chips) 
Seat 9: DnDcAdn9P0zGovMERigpFA ($25 in chips) 
DnDcAdn9P0zGovMERigpFA: posts small blind $0.10
5MgYq10OC5iGoxQFwlJVuw: posts big blind $0.25
IGRfskE1v9H9Bn+fz8AgNQ: sits out 
*** HOLE CARDS ***
o3zvoO+PsqGti+1NZGNRrQ: folds 
q4GZp0xt5Unxtq8PS32SAQ: folds 
Qi+clOtyDiibLdH2/1Qy8g: folds 
zDrucyjVn5aeekNEc3cJrA: folds 
MzxZJee3eU6Q0wg0XTfZew: folds 
DnDcAdn9P0zGovMERigpFA: folds 
Uncalled bet ($0.15) returned to 5MgYq10OC5iGoxQFwlJVuw
5MgYq10OC5iGoxQFwlJVuw collected $0.20 from pot
*** SUMMARY ***
Total pot $0.20 | Rake $0 
Seat 1: 5MgYq10OC5iGoxQFwlJVuw (big blind) collected ($0.20)
Seat 2: o3zvoO+PsqGti+1NZGNRrQ folded before Flop (didn't bet)
Seat 3: q4GZp0xt5Unxtq8PS32SAQ folded before Flop (didn't bet)
Seat 5: Qi+clOtyDiibLdH2/1Qy8g folded before Flop (didn't bet)
Seat 6: zDrucyjVn5aeekNEc3cJrA folded before Flop (didn't bet)
Seat 8: MzxZJee3eU6Q0wg0XTfZew (button) folded before Flop (didn't bet)
Seat 9: DnDcAdn9P0zGovMERigpFA (small blind) folded before Flop




PokerStars Game #59939483226:  Hold'em No Limit ($0.10/$0.25) - 2009/07/01 0:41:02 ET
Table 'oJpFwZj9+FUGHX90Un8s9Q' 6-max Seat #3 is the button
Seat 2: IMmIhmfU3tqkaJABnD21Rg ($19.85 in chips) 
Seat 3: kyRaCIljYA6l33lSKQfNsg ($26.30 in chips) 
Seat 4: IX/nJvz3Mx/Ez6DgueFA4Q ($6.70 in chips) 
Seat 5: kG34n23qFQA3nzdOJTQ1dA ($25 in chips) 
Seat 6: Zijzy/UtPWzWVUo81HHVjQ ($40.45 in chips) 
IX/nJvz3Mx/Ez6DgueFA4Q: posts small blind $0.10
kG34n23qFQA3nzdOJTQ1dA: posts big blind $0.25
*** HOLE CARDS ***
Zijzy/UtPWzWVUo81HHVjQ: raises $0.50 to $0.75
IMmIhmfU3tqkaJABnD21Rg: folds 
kyRaCIljYA6l33lSKQfNsg: folds 
pablounzueta leaves the table
IX/nJvz3Mx/Ez6DgueFA4Q: folds 
kG34n23qFQA3nzdOJTQ1dA: folds 
Uncalled bet ($0.50) returned to Zijzy/UtPWzWVUo81HHVjQ
Zijzy/UtPWzWVUo81HHVjQ collected $0.60 from pot
Zijzy/UtPWzWVUo81HHVjQ: doesn't show hand 
*** SUMMARY ***
Total pot $0.60 | Rake $0 
Seat 2: IMmIhmfU3tqkaJABnD21Rg folded before Flop (didn't bet)
Seat 3: kyRaCIljYA6l33lSKQfNsg (button) folded before Flop (didn't bet)
Seat 4: IX/nJvz3Mx/Ez6DgueFA4Q (small blind) folded before Flop
Seat 5: kG34n23qFQA3nzdOJTQ1dA (big blind) folded before Flop
Seat 6: Zijzy/UtPWzWVUo81HHVjQ collected ($0.60)




PokerStars Game #59939484060:  Hold'em No Limit ($0.10/$0.25) - 2009/07/01 0:41:03 ET
Table 'zW+7jPbOLCvlPu+dUGY5WQ' 6-max Seat #5 is the button
Seat 1: JE/wJXmjw3bpdmjwvh2pcg ($21.40 in chips) 
Seat 3: BedjMfrlRfPgSq7CXpPAmg ($63.75 in chips) 
Seat 4: Qv4VzEkN09uD11sjKv02Ig ($36.10 in chips) 
Seat 5: SFmT9ZsVopnukjvAzrxTRg ($55.75 in chips) 
Seat 6: BiLBinPhgpKAYzLgKJVU5A ($21.70 in chips) 
BiLBinPhgpKAYzLgKJVU5A: posts small blind $0.10
JE/wJXmjw3bpdmjwvh2pcg: posts big blind $0.25
DXgVFTcE3WofABsNJ5G/nw: sits out 
*** HOLE CARDS ***
BedjMfrlRfPgSq7CXpPAmg: raises $0.75 to $1
Qv4VzEkN09uD11sjKv02Ig: folds 
SFmT9ZsVopnukjvAzrxTRg: folds 
BiLBinPhgpKAYzLgKJVU5A: folds 
JE/wJXmjw3bpdmjwvh2pcg: folds 
Uncalled bet ($0.75) returned to BedjMfrlRfPgSq7CXpPAmg
BedjMfrlRfPgSq7CXpPAmg collected $0.60 from pot
*** SUMMARY ***
Total pot $0.60 | Rake $0 
Seat 1: JE/wJXmjw3bpdmjwvh2pcg (big blind) folded before Flop
Seat 3: BedjMfrlRfPgSq7CXpPAmg collected ($0.60)
Seat 4: Qv4VzEkN09uD11sjKv02Ig folded before Flop (didn't bet)
Seat 5: SFmT9ZsVopnukjvAzrxTRg (button) folded before Flop (didn't bet)
Seat 6: BiLBinPhgpKAYzLgKJVU5A (small blind) folded before Flop




PokerStars Game #59939483598:  Hold'em No Limit ($0.10/$0.25) - 2009/07/01 0:41:03 ET
Table 'o0CDOvKO/bn1WjeymDrXfA' 6-max Seat #3 is the button
Seat 1: 32YL2ZEp8NT4JB2RVM9euQ ($16.60 in chips) 
Seat 2: oc4ZGs0W+3RIg2yPyJw3ig ($31.70 in chips) 
Seat 3: EqXTTLKUlDlz7yi6ziyyWA ($8.90 in chips) 
Seat 5: u/yN5P9f3KlATg6WLWNkBQ ($28.60 in chips) 
Seat 6: Bada343Si4xKu3fNXY99AA ($20.95 in chips) 
HotTillt will be allowed to play after the button
u/yN5P9f3KlATg6WLWNkBQ: posts small blind $0.10
Bada343Si4xKu3fNXY99AA: posts big blind $0.25
*** HOLE CARDS ***
32YL2ZEp8NT4JB2RVM9euQ: folds 
oc4ZGs0W+3RIg2yPyJw3ig: calls $0.25
EqXTTLKUlDlz7yi6ziyyWA: calls $0.25
u/yN5P9f3KlATg6WLWNkBQ: folds 
Bada343Si4xKu3fNXY99AA: checks 
*** FLOP *** [Qd Kd Qh]
Bada343Si4xKu3fNXY99AA: checks 
oc4ZGs0W+3RIg2yPyJw3ig: checks 
EqXTTLKUlDlz7yi6ziyyWA: bets $0.75
Bada343Si4xKu3fNXY99AA: folds 
oc4ZGs0W+3RIg2yPyJw3ig: folds 
Uncalled bet ($0.75) returned to EqXTTLKUlDlz7yi6ziyyWA
EqXTTLKUlDlz7yi6ziyyWA collected $0.85 from pot
EqXTTLKUlDlz7yi6ziyyWA: doesn't show hand 
*** SUMMARY ***
Total pot $0.85 | Rake $0 
Board [Qd Kd Qh]
Seat 1: 32YL2ZEp8NT4JB2RVM9euQ folded before Flop (didn't bet)
Seat 2: oc4ZGs0W+3RIg2yPyJw3ig folded on the Flop
Seat 3: EqXTTLKUlDlz7yi6ziyyWA (button) collected ($0.85)
Seat 5: u/yN5P9f3KlATg6WLWNkBQ (small blind) folded before Flop
Seat 6: Bada343Si4xKu3fNXY99AA (big blind) folded on the Flop




PokerStars Game #59939483498:  Hold'em No Limit ($0.10/$0.25) - 2009/07/01 0:41:03 ET
Table 'sgdCtiuCu2BDZhyDi6RzTA' 6-max Seat #1 is the button
Seat 1: 3zD3qLXT1bEffAoWGnc7wg ($25 in chips) 
Seat 3: yzFNNFIfC89bBPwpFPx2ow ($15.45 in chips) 
Seat 4: rVKEgilmMX+EkKzDVvhmxA ($8.15 in chips) 
Seat 5: kD/Cb2UM93FAVgDMhEEb5g ($10 in chips) 
Seat 6: KODslGU8ikCYS0/29dUkhg ($9.60 in chips) 
yzFNNFIfC89bBPwpFPx2ow: posts small blind $0.10
rVKEgilmMX+EkKzDVvhmxA: posts big blind $0.25
*** HOLE CARDS ***
kD/Cb2UM93FAVgDMhEEb5g: raises $0.50 to $0.75
KODslGU8ikCYS0/29dUkhg: folds 
3zD3qLXT1bEffAoWGnc7wg: calls $0.75
yzFNNFIfC89bBPwpFPx2ow: calls $0.65
rVKEgilmMX+EkKzDVvhmxA: folds 
*** FLOP *** [Qc 2d 7h]
yzFNNFIfC89bBPwpFPx2ow: checks 
kD/Cb2UM93FAVgDMhEEb5g: checks 
3zD3qLXT1bEffAoWGnc7wg: checks 
*** TURN *** [Qc 2d 7h] [6s]
yzFNNFIfC89bBPwpFPx2ow: bets $1.25
kD/Cb2UM93FAVgDMhEEb5g: folds 
3zD3qLXT1bEffAoWGnc7wg: folds 
Uncalled bet ($1.25) returned to yzFNNFIfC89bBPwpFPx2ow
yzFNNFIfC89bBPwpFPx2ow collected $2.40 from pot
yzFNNFIfC89bBPwpFPx2ow: doesn't show hand 
*** SUMMARY ***
Total pot $2.50 | Rake $0.10 
Board [Qc 2d 7h 6s]
Seat 1: 3zD3qLXT1bEffAoWGnc7wg (button) folded on the Turn
Seat 3: yzFNNFIfC89bBPwpFPx2ow (small blind) collected ($2.40)
Seat 4: rVKEgilmMX+EkKzDVvhmxA (big blind) folded before Flop
Seat 5: kD/Cb2UM93FAVgDMhEEb5g folded on the Turn
Seat 6: KODslGU8ikCYS0/29dUkhg folded before Flop (didn't bet)




PokerStars Game #59939483688:  Hold'em No Limit ($0.10/$0.25) - 2009/07/01 0:41:03 ET
Table 'nB7Q7zfNfy6ig6DB+rsgWQ' 6-max Seat #3 is the button
Seat 1: ACU3rO57RhDJfAgHTq2ocA ($4.35 in chips) 
Seat 2: g6kf+5FIgWH33PmH6ZecMQ ($15.60 in chips) 
Seat 3: p3NYOxYhkL7txPRSeXHDeg ($34.75 in chips) 
Seat 4: YZjG5I7FqwMKy06BKVBS7w ($8.05 in chips) 
Seat 5: X0/5h4o4LdHWlM7o/9shzg ($7.30 in chips) 
Seat 6: BYxjLnV1/LL0aZcTbfAOvw ($39.90 in chips) 
YZjG5I7FqwMKy06BKVBS7w: posts small blind $0.10
X0/5h4o4LdHWlM7o/9shzg: posts big blind $0.25
*** HOLE CARDS ***
BYxjLnV1/LL0aZcTbfAOvw: folds 
g6kf+5FIgWH33PmH6ZecMQ said, "tks"
ACU3rO57RhDJfAgHTq2ocA: calls $0.25
g6kf+5FIgWH33PmH6ZecMQ: folds 
p3NYOxYhkL7txPRSeXHDeg: folds 
YZjG5I7FqwMKy06BKVBS7w: folds 
X0/5h4o4LdHWlM7o/9shzg: checks 
*** FLOP *** [Ah 4h 6c]
X0/5h4o4LdHWlM7o/9shzg: checks 
ACU3rO57RhDJfAgHTq2ocA: bets $0.25
X0/5h4o4LdHWlM7o/9shzg: folds 
Uncalled bet ($0.25) returned to ACU3rO57RhDJfAgHTq2ocA
ACU3rO57RhDJfAgHTq2ocA collected $0.60 from pot
ACU3rO57RhDJfAgHTq2ocA: doesn't show hand 
*** SUMMARY ***
Total pot $0.60 | Rake $0 
Board [Ah 4h 6c]
Seat 1: ACU3rO57RhDJfAgHTq2ocA collected ($0.60)
Seat 2: g6kf+5FIgWH33PmH6ZecMQ folded before Flop (didn't bet)
Seat 3: p3NYOxYhkL7txPRSeXHDeg (button) folded before Flop (didn't bet)
Seat 4: YZjG5I7FqwMKy06BKVBS7w (small blind) folded before Flop
Seat 5: X0/5h4o4LdHWlM7o/9shzg (big blind) folded on the Flop
Seat 6: BYxjLnV1/LL0aZcTbfAOvw folded before Flop (didn't bet)




PokerStars Game #59939484098:  Hold'em No Limit ($0.10/$0.25) - 2009/07/01 0:41:03 ET
Table 'tq5CvS0RUqGkuBK0XTzqqg' 6-max Seat #1 is the button
Seat 1: 39EF5EcifdyPS7v+EnfxLg ($22.65 in chips) 
Seat 2: mfrkWA3PTeYPkbO6hi98Aw ($68.70 in chips) 
Seat 3: PbMzPZIePKifKQZfKDkbIw ($25 in chips) 
Seat 4: W7FS+h5B+OhmwF+cTt3ZPQ ($14.45 in chips) 
Seat 5: qGHGf/553gQnDoklMRe3tg ($19.90 in chips) 
Seat 6: hOfhw8jxWiq14wXGL4Bh/Q ($14.65 in chips) 
mfrkWA3PTeYPkbO6hi98Aw: posts small blind $0.10
PbMzPZIePKifKQZfKDkbIw: posts big blind $0.25
*** HOLE CARDS ***
W7FS+h5B+OhmwF+cTt3ZPQ: calls $0.25
qGHGf/553gQnDoklMRe3tg: folds 
hOfhw8jxWiq14wXGL4Bh/Q: folds 
39EF5EcifdyPS7v+EnfxLg: calls $0.25
mfrkWA3PTeYPkbO6hi98Aw: folds 
PbMzPZIePKifKQZfKDkbIw: checks 
*** FLOP *** [4s 4d Qd]
PbMzPZIePKifKQZfKDkbIw: checks 
W7FS+h5B+OhmwF+cTt3ZPQ: checks 
39EF5EcifdyPS7v+EnfxLg: checks 
*** TURN *** [4s 4d Qd] [8s]
PbMzPZIePKifKQZfKDkbIw: checks 
W7FS+h5B+OhmwF+cTt3ZPQ: checks 
39EF5EcifdyPS7v+EnfxLg: checks 
*** RIVER *** [4s 4d Qd 8s] [Qh]
PbMzPZIePKifKQZfKDkbIw: checks 
W7FS+h5B+OhmwF+cTt3ZPQ: checks 
39EF5EcifdyPS7v+EnfxLg: checks 
*** SHOW DOWN ***
PbMzPZIePKifKQZfKDkbIw: shows [Jc Td] (two pair, Queens and Fours)
W7FS+h5B+OhmwF+cTt3ZPQ: shows [3c Kd] (two pair, Queens and Fours - King kicker)
39EF5EcifdyPS7v+EnfxLg: shows [Kh 3s] (two pair, Queens and Fours)
W7FS+h5B+OhmwF+cTt3ZPQ collected $0.45 from pot
39EF5EcifdyPS7v+EnfxLg collected $0.40 from pot
*** SUMMARY ***
Total pot $0.85 | Rake $0 
Board [4s 4d Qd 8s Qh]
Seat 1: 39EF5EcifdyPS7v+EnfxLg (button) showed [Kh 3s] and won ($0.40) with two pair, Queens and Fours
Seat 2: mfrkWA3PTeYPkbO6hi98Aw (small blind) folded before Flop
Seat 3: PbMzPZIePKifKQZfKDkbIw (big blind) showed [Jc Td] and lost with two pair, Queens and Fours
Seat 4: W7FS+h5B+OhmwF+cTt3ZPQ showed [3c Kd] and won ($0.45) with two pair, Queens and Fours
Seat 5: qGHGf/553gQnDoklMRe3tg folded before Flop (didn't bet)
Seat 6: hOfhw8jxWiq14wXGL4Bh/Q folded before Flop (didn't bet)




PokerStars Game #59939484038:  Hold'em No Limit ($0.10/$0.25) - 2009/07/01 0:41:03 ET
Table 'P2yJ+jwfNsBdF12fLKA6DQ' 9-max Seat #6 is the button
Seat 1: zDrucyjVn5aeekNEc3cJrA ($26.25 in chips) 
Seat 3: aNpwfA31EREwO+ar4XzBCw ($27.20 in chips) 
Seat 4: dfNim92Z6XK1/h5SFW5vDg ($25 in chips) 
Seat 5: KUcJLaHvrSlvGyIGqDQp9A ($15.95 in chips) 
Seat 6: tIIUJycKjdqE3z/SXWAEwA ($5.10 in chips) 
Seat 7: 1/DuWziR8CXhWB71aPQd9Q ($9.75 in chips) 
Seat 8: LWN1wPrLH+695JIriXxDuw ($10 in chips) 
Seat 9: Jurq55Mpn9JwRMif6CgVxw ($2.70 in chips) 
1/DuWziR8CXhWB71aPQd9Q: posts small blind $0.10
LWN1wPrLH+695JIriXxDuw: posts big blind $0.25
V6p0jQ/RhUsqpHLmXvEX4Q: sits out 
*** HOLE CARDS ***
Jurq55Mpn9JwRMif6CgVxw: calls $0.25
zDrucyjVn5aeekNEc3cJrA: folds 
aNpwfA31EREwO+ar4XzBCw: folds 
dfNim92Z6XK1/h5SFW5vDg: folds 
KUcJLaHvrSlvGyIGqDQp9A: calls $0.25
tIIUJycKjdqE3z/SXWAEwA: raises $1 to $1.25
1/DuWziR8CXhWB71aPQd9Q: folds 
LWN1wPrLH+695JIriXxDuw: folds 
Jurq55Mpn9JwRMif6CgVxw: calls $1
KUcJLaHvrSlvGyIGqDQp9A: folds 
*** FLOP *** [2d 3s 6c]
Jurq55Mpn9JwRMif6CgVxw: checks 
tIIUJycKjdqE3z/SXWAEwA: bets $1.75
Jurq55Mpn9JwRMif6CgVxw: calls $1.45 and is all-in
Uncalled bet ($0.30) returned to tIIUJycKjdqE3z/SXWAEwA
*** TURN *** [2d 3s 6c] [Qs]
*** RIVER *** [2d 3s 6c Qs] [4c]
*** SHOW DOWN ***
Jurq55Mpn9JwRMif6CgVxw: shows [8d Qc] (a pair of Queens)
tIIUJycKjdqE3z/SXWAEwA: mucks hand 
Jurq55Mpn9JwRMif6CgVxw collected $5.75 from pot
*** SUMMARY ***
Total pot $6 | Rake $0.25 
Board [2d 3s 6c Qs 4c]
Seat 1: zDrucyjVn5aeekNEc3cJrA folded before Flop (didn't bet)
Seat 3: aNpwfA31EREwO+ar4XzBCw folded before Flop (didn't bet)
Seat 4: dfNim92Z6XK1/h5SFW5vDg folded before Flop (didn't bet)
Seat 5: KUcJLaHvrSlvGyIGqDQp9A folded before Flop
Seat 6: tIIUJycKjdqE3z/SXWAEwA (button) mucked
Seat 7: 1/DuWziR8CXhWB71aPQd9Q (small blind) folded before Flop
Seat 8: LWN1wPrLH+695JIriXxDuw (big blind) folded before Flop
Seat 9: Jurq55Mpn9JwRMif6CgVxw showed [8d Qc] and won ($5.75) with a pair of Queens




PokerStars Game #59939483874:  Hold'em No Limit ($0.10/$0.25) - 2009/07/01 0:41:03 ET
Table 'GrYi0DZOHD1EvB+qiLExNw' 9-max Seat #8 is the button
Seat 1: 4awUyiDYTgylQKXZ9faBVA ($48.95 in chips) 
Seat 2: Th3FldXKQW6hWVVPahaoOQ ($26.65 in chips) 
Seat 3: 4oA316mXLIui1QY63GXBUg ($25 in chips) 
Seat 4: 0GQg6tdDMBDzY6FKumSo9w ($25.75 in chips) 
Seat 5: cZ99hugmLBj9KhTlc8nCSw ($48.50 in chips) 
Seat 6: H9KUl8cmpLgEpOVDA00bCg ($4.20 in chips) 
Seat 7: 1Clf3cPrqoy/YgvWdWK1Xw ($5 in chips) 
Seat 8: nalbG/4/1Z1wQjRDWV7b2w ($7 in chips) 
OiV1PWZ3IkN29JlmCcnTwQ will be allowed to play after the button
4awUyiDYTgylQKXZ9faBVA: posts small blind $0.10
Th3FldXKQW6hWVVPahaoOQ: posts big blind $0.25
*** HOLE CARDS ***
4oA316mXLIui1QY63GXBUg: folds 
0GQg6tdDMBDzY6FKumSo9w: folds 
cZ99hugmLBj9KhTlc8nCSw: folds 
H9KUl8cmpLgEpOVDA00bCg: folds 
1Clf3cPrqoy/YgvWdWK1Xw: folds 
nalbG/4/1Z1wQjRDWV7b2w: folds 
4awUyiDYTgylQKXZ9faBVA: raises $0.50 to $0.75
Th3FldXKQW6hWVVPahaoOQ: folds 
Uncalled bet ($0.50) returned to 4awUyiDYTgylQKXZ9faBVA
4awUyiDYTgylQKXZ9faBVA collected $0.50 from pot
4awUyiDYTgylQKXZ9faBVA: doesn't show hand 
*** SUMMARY ***
Total pot $0.50 | Rake $0 
Seat 1: 4awUyiDYTgylQKXZ9faBVA (small blind) collected ($0.50)
Seat 2: Th3FldXKQW6hWVVPahaoOQ (big blind) folded before Flop
Seat 3: 4oA316mXLIui1QY63GXBUg folded before Flop (didn't bet)
Seat 4: 0GQg6tdDMBDzY6FKumSo9w folded before Flop (didn't bet)
Seat 5: cZ99hugmLBj9KhTlc8nCSw folded before Flop (didn't bet)
Seat 6: H9KUl8cmpLgEpOVDA00bCg folded before Flop (didn't bet)
Seat 7: 1Clf3cPrqoy/YgvWdWK1Xw folded before Flop (didn't bet)
Seat 8: nalbG/4/1Z1wQjRDWV7b2w (button) folded before Flop (didn't bet)




PokerStars Game #59939484180:  Hold'em No Limit ($0.10/$0.25) - 2009/07/01 0:41:04 ET
Table 'sIHZ0lzLr4NGCaBUKhmYhAr562aMIMs5kgo28FEU6lkAax Seat #5 is the button
Seat 1: vZGoOTJLQLhkPj4I+LNGig ($25 in chips) 
Seat 2: N8muFAHrFHW6elSMGuyVLQ ($14.75 in chips) 
Seat 3: vX2B+8jhZFyBctQ3P4IKEw ($10.05 in chips) 
Seat 4: XBq1lBzax7LjRqdJP2TqWg ($13.10 in chips) 
Seat 5: zDrucyjVn5aeekNEc3cJrA ($37.30 in chips) 
Seat 6: rCaXm4/EwAgWqCiClpbsqQ ($10.50 in chips) 
Seat 7: R6nIVAjK7uhK3Hj0f85A+A ($18.70 in chips) 
Seat 9: W4TLQcZ2TiM73eIgpIvlGg ($26.10 in chips) 
rCaXm4/EwAgWqCiClpbsqQ: posts small blind $0.10
R6nIVAjK7uhK3Hj0f85A+A: posts big blind $0.25
B6xHiX1SJkS0CUNCKDVwuQ: sits out 
*** HOLE CARDS ***
W4TLQcZ2TiM73eIgpIvlGg: folds 
vZGoOTJLQLhkPj4I+LNGig: folds 
N8muFAHrFHW6elSMGuyVLQ: folds 
vX2B+8jhZFyBctQ3P4IKEw: raises $0.75 to $1
XBq1lBzax7LjRqdJP2TqWg: folds 
zDrucyjVn5aeekNEc3cJrA: folds 
rCaXm4/EwAgWqCiClpbsqQ: folds 
R6nIVAjK7uhK3Hj0f85A+A: folds 
Uncalled bet ($0.75) returned to vX2B+8jhZFyBctQ3P4IKEw
vX2B+8jhZFyBctQ3P4IKEw collected $0.60 from pot
vX2B+8jhZFyBctQ3P4IKEw: doesn't show hand 
*** SUMMARY ***
Total pot $0.60 | Rake $0 
Seat 1: vZGoOTJLQLhkPj4I+LNGig folded before Flop (didn't bet)
Seat 2: N8muFAHrFHW6elSMGuyVLQ folded before Flop (didn't bet)
Seat 3: vX2B+8jhZFyBctQ3P4IKEw collected ($0.60)
Seat 4: XBq1lBzax7LjRqdJP2TqWg folded before Flop (didn't bet)
Seat 5: zDrucyjVn5aeekNEc3cJrA (button) folded before Flop (didn't bet)
Seat 6: rCaXm4/EwAgWqCiClpbsqQ (small blind) folded before Flop
Seat 7: R6nIVAjK7uhK3Hj0f85A+A (big blind) folded before Flop
Seat 9: W4TLQcZ2TiM73eIgpIvlGg folded before Flop (didn't bet)




PokerStars Game #59939484296:  Hold'em No Limit ($0.10/$0.25) - 2009/07/01 0:41:04 ET
Table 'JJzUs04lHpXg6nboT1/jeg' 6-max Seat #5 is the button
Seat 2: mK0/8tWLTEGESD/9ZUEo5A ($5.25 in chips) 
Seat 3: uUXdcVMNa05rfbntdvplfw ($15.85 in chips) 
Seat 4: nwwpaieDRI0UPyVtChVHOg ($35.35 in chips) 
Seat 5: Vr2XE7yYBdg3RZSURDAPEg ($23.65 in chips) 
starzjenko will be allowed to play after the button
mK0/8tWLTEGESD/9ZUEo5A: posts small blind $0.10
uUXdcVMNa05rfbntdvplfw: posts big blind $0.25
*** HOLE CARDS ***
sbFQMajC1QuRxa8Jly3usQ joins the table at seat #6 
nwwpaieDRI0UPyVtChVHOg: calls $0.25
Vr2XE7yYBdg3RZSURDAPEg: raises $0.25 to $0.50
mK0/8tWLTEGESD/9ZUEo5A: calls $0.40
uUXdcVMNa05rfbntdvplfw: calls $0.25
nwwpaieDRI0UPyVtChVHOg: calls $0.25
*** FLOP *** [Tc Js 2s]
mK0/8tWLTEGESD/9ZUEo5A: checks 
uUXdcVMNa05rfbntdvplfw: bets $0.25
nwwpaieDRI0UPyVtChVHOg: raises $0.25 to $0.50
Vr2XE7yYBdg3RZSURDAPEg: calls $0.50
mK0/8tWLTEGESD/9ZUEo5A: calls $0.50
uUXdcVMNa05rfbntdvplfw: raises $0.25 to $0.75
nwwpaieDRI0UPyVtChVHOg: calls $0.25
Vr2XE7yYBdg3RZSURDAPEg: calls $0.25
mK0/8tWLTEGESD/9ZUEo5A: folds 
*** TURN *** [Tc Js 2s] [8d]
uUXdcVMNa05rfbntdvplfw: bets $0.50
nwwpaieDRI0UPyVtChVHOg: calls $0.50
Vr2XE7yYBdg3RZSURDAPEg: calls $0.50
*** RIVER *** [Tc Js 2s 8d] [4s]
uUXdcVMNa05rfbntdvplfw: bets $2
nwwpaieDRI0UPyVtChVHOg: folds 
Vr2XE7yYBdg3RZSURDAPEg: folds 
Uncalled bet ($2) returned to uUXdcVMNa05rfbntdvplfw
uUXdcVMNa05rfbntdvplfw collected $5.95 from pot
uUXdcVMNa05rfbntdvplfw: doesn't show hand 
*** SUMMARY ***
Total pot $6.25 | Rake $0.30 
Board [Tc Js 2s 8d 4s]
Seat 2: mK0/8tWLTEGESD/9ZUEo5A (small blind) folded on the Flop
Seat 3: uUXdcVMNa05rfbntdvplfw (big blind) collected ($5.95)
Seat 4: nwwpaieDRI0UPyVtChVHOg folded on the River
Seat 5: Vr2XE7yYBdg3RZSURDAPEg (button) folded on the River




PokerStars Game #59939484648:  Hold'em No Limit ($0.10/$0.25) - 2009/07/01 0:41:04 ET
Table '2VkNDXXsBj4bSZw/uK5atw' 6-max Seat #4 is the button
Seat 1: 7FmwVDcdEtxDpHmP4hOXsQ ($26.40 in chips) 
Seat 4: yb6rnd48JuBccThV68VHAQ ($74.90 in chips) 
Seat 5: kyRaCIljYA6l33lSKQfNsg ($24.75 in chips) 
Seat 6: qGHGf/553gQnDoklMRe3tg ($18.40 in chips) 
kyRaCIljYA6l33lSKQfNsg: posts small blind $0.10
qGHGf/553gQnDoklMRe3tg: posts big blind $0.25
gqW2aBCmrIw65BvwjTFN6Q: sits out 
*** HOLE CARDS ***
7FmwVDcdEtxDpHmP4hOXsQ: folds 
yb6rnd48JuBccThV68VHAQ: calls $0.25
kyRaCIljYA6l33lSKQfNsg: folds 
qGHGf/553gQnDoklMRe3tg: checks 
*** FLOP *** [9d 2c Ts]
qGHGf/553gQnDoklMRe3tg: checks 
yb6rnd48JuBccThV68VHAQ: checks 
*** TURN *** [9d 2c Ts] [Ac]
qGHGf/553gQnDoklMRe3tg: checks 
yb6rnd48JuBccThV68VHAQ: checks 
*** RIVER *** [9d 2c Ts Ac] [8d]
qGHGf/553gQnDoklMRe3tg: checks 
yb6rnd48JuBccThV68VHAQ: checks 
*** SHOW DOWN ***
qGHGf/553gQnDoklMRe3tg: shows [3h Ad] (a pair of Aces)
yb6rnd48JuBccThV68VHAQ: mucks hand 
qGHGf/553gQnDoklMRe3tg collected $0.60 from pot
*** SUMMARY ***
Total pot $0.60 | Rake $0 
Board [9d 2c Ts Ac 8d]
Seat 1: 7FmwVDcdEtxDpHmP4hOXsQ folded before Flop (didn't bet)
Seat 4: yb6rnd48JuBccThV68VHAQ (button) mucked
Seat 5: kyRaCIljYA6l33lSKQfNsg (small blind) folded before Flop
Seat 6: qGHGf/553gQnDoklMRe3tg (big blind) showed [3h Ad] and won ($0.60) with a pair of Aces




PokerStars Game #59939484234:  Hold'em No Limit ($0.10/$0.25) - 2009/07/01 0:41:04 ET
Table '4hfTdIVT/qPsJNfWXLsVIw' 9-max Seat #5 is the button
Seat 1: GbHFBbLqLGz0Pwn6CJeAuw ($24.20 in chips) 
Seat 2: NB5rKy+grn9jKcWXclZ7WA ($32.90 in chips) 
Seat 3: opOCI2p6kW0tINuVaAqmcQ ($26.80 in chips) 
Seat 4: OiV1PWZ3IkN29JlmCcnTwQ ($5.15 in chips) 
Seat 5: wtz6Fi0Zt+cIsTeTHf5zJQ ($5 in chips) 
Seat 6: VWUWpMLMj/Q1jRVpF7Aohw ($8.80 in chips) 
Seat 7: z5GxcHlYz/GSz6W2uFiTtg ($31.90 in chips) 
Seat 8: EfRs3ibIxn+c9JDErwwNCg ($31.65 in chips) 
Seat 9: K5byIbXY6S+c1wAeHitZow ($12.65 in chips) 
VWUWpMLMj/Q1jRVpF7Aohw: posts small blind $0.10
z5GxcHlYz/GSz6W2uFiTtg: posts big blind $0.25
*** HOLE CARDS ***
EfRs3ibIxn+c9JDErwwNCg: folds 
K5byIbXY6S+c1wAeHitZow: folds 
GbHFBbLqLGz0Pwn6CJeAuw: folds 
NB5rKy+grn9jKcWXclZ7WA: folds 
opOCI2p6kW0tINuVaAqmcQ: folds 
OiV1PWZ3IkN29JlmCcnTwQ: folds 
wtz6Fi0Zt+cIsTeTHf5zJQ: folds 
VWUWpMLMj/Q1jRVpF7Aohw: folds 
Uncalled bet ($0.15) returned to z5GxcHlYz/GSz6W2uFiTtg
z5GxcHlYz/GSz6W2uFiTtg collected $0.20 from pot
*** SUMMARY ***
Total pot $0.20 | Rake $0 
Seat 1: GbHFBbLqLGz0Pwn6CJeAuw folded before Flop (didn't bet)
Seat 2: NB5rKy+grn9jKcWXclZ7WA folded before Flop (didn't bet)
Seat 3: opOCI2p6kW0tINuVaAqmcQ folded before Flop (didn't bet)
Seat 4: OiV1PWZ3IkN29JlmCcnTwQ folded before Flop (didn't bet)
Seat 5: wtz6Fi0Zt+cIsTeTHf5zJQ (button) folded before Flop (didn't bet)
Seat 6: VWUWpMLMj/Q1jRVpF7Aohw (small blind) folded before Flop
Seat 7: z5GxcHlYz/GSz6W2uFiTtg (big blind) collected ($0.20)
Seat 8: EfRs3ibIxn+c9JDErwwNCg folded before Flop (didn't bet)
Seat 9: K5byIbXY6S+c1wAeHitZow folded before Flop (didn't bet)




PokerStars Game #59939484434:  Hold'em No Limit ($0.10/$0.25) - 2009/07/01 0:41:04 ET
Table '9SExUHslNkrPJ4XsrePaVw' 9-max Seat #5 is the button
Seat 1: qpbN+BUWX0f/ckQSmOcmkw ($14.25 in chips) 
Seat 2: ie4EwTMMFYxrCXcenJdzsw ($5 in chips) 
Seat 3: jeKWRUkMaVn8rEUjnJKqpg ($25 in chips) 
Seat 4: dyNjB7p93gTjZ0RXn2HnJA ($16.80 in chips) 
Seat 5: FZrgDbxAanC1xwZxXHJKVA ($13.15 in chips) 
Seat 6: DYB0aP91n+Rg/TIhycbaPQ ($9.95 in chips) 
Seat 7: 7cv+9Zc9HIQHNvYsMfV3uA ($25 in chips) 
Seat 8: t2nb95S5EEFOEzNx9Itz0g ($8.30 in chips) 
Seat 9: /THNzAxdv2lBxcf4XTj/0g ($15.75 in chips) 
DYB0aP91n+Rg/TIhycbaPQ: posts small blind $0.10
7cv+9Zc9HIQHNvYsMfV3uA: posts big blind $0.25
*** HOLE CARDS ***
t2nb95S5EEFOEzNx9Itz0g: folds 
/THNzAxdv2lBxcf4XTj/0g: folds 
qpbN+BUWX0f/ckQSmOcmkw: folds 
ie4EwTMMFYxrCXcenJdzsw: calls $0.25
jeKWRUkMaVn8rEUjnJKqpg: calls $0.25
dyNjB7p93gTjZ0RXn2HnJA: calls $0.25
FZrgDbxAanC1xwZxXHJKVA: calls $0.25
DYB0aP91n+Rg/TIhycbaPQ: calls $0.15
7cv+9Zc9HIQHNvYsMfV3uA: checks 
*** FLOP *** [As 3s Qc]
DYB0aP91n+Rg/TIhycbaPQ: checks 
7cv+9Zc9HIQHNvYsMfV3uA: checks 
ie4EwTMMFYxrCXcenJdzsw: bets $0.50
jeKWRUkMaVn8rEUjnJKqpg: raises $1 to $1.50
dyNjB7p93gTjZ0RXn2HnJA: calls $1.50
FZrgDbxAanC1xwZxXHJKVA: folds 
FZrgDbxAanC1xwZxXHJKVA leaves the table
DYB0aP91n+Rg/TIhycbaPQ: folds 
7cv+9Zc9HIQHNvYsMfV3uA: folds 
ie4EwTMMFYxrCXcenJdzsw: raises $3.25 to $4.75 and is all-in
jeKWRUkMaVn8rEUjnJKqpg: calls $3.25
ydoFOVgzvZv9ZhuWu9rXAw joins the table at seat #5 
dyNjB7p93gTjZ0RXn2HnJA: folds 
*** TURN *** [As 3s Qc] [Td]
*** RIVER *** [As 3s Qc Td] [Kd]
*** SHOW DOWN ***
ie4EwTMMFYxrCXcenJdzsw: shows [7s Ts] (a pair of Tens)
jeKWRUkMaVn8rEUjnJKqpg: shows [Ac 3c] (two pair, Aces and Threes)
jeKWRUkMaVn8rEUjnJKqpg collected $11.90 from pot
*** SUMMARY ***
Total pot $12.50 | Rake $0.60 
Board [As 3s Qc Td Kd]
Seat 1: qpbN+BUWX0f/ckQSmOcmkw folded before Flop (didn't bet)
Seat 2: ie4EwTMMFYxrCXcenJdzsw showed [7s Ts] and lost with a pair of Tens
Seat 3: jeKWRUkMaVn8rEUjnJKqpg showed [Ac 3c] and won ($11.90) with two pair, Aces and Threes
Seat 4: dyNjB7p93gTjZ0RXn2HnJA folded on the Flop
Seat 5: FZrgDbxAanC1xwZxXHJKVA (button) folded on the Flop
Seat 6: DYB0aP91n+Rg/TIhycbaPQ (small blind) folded on the Flop
Seat 7: 7cv+9Zc9HIQHNvYsMfV3uA (big blind) folded on the Flop
Seat 8: t2nb95S5EEFOEzNx9Itz0g folded before Flop (didn't bet)
Seat 9: /THNzAxdv2lBxcf4XTj/0g folded before Flop (didn't bet)




PokerStars Game #59939484510:  Hold'em No Limit ($0.10/$0.25) - 2009/07/01 0:41:04 ET
Table '8PD/MTROSMd6Y8mZeykbpg' 6-max Seat #4 is the button
Seat 1: 32YL2ZEp8NT4JB2RVM9euQ ($19.40 in chips) 
Seat 2: wAKC8C/zN0c8V5v13dm9mA ($25 in chips) 
Seat 3: EV5E02/xfaoDNHy7UQ195Q ($26.15 in chips) 
Seat 4: tTBLQIRkkVpjhASe6+jvXQ ($4.20 in chips) 
Seat 5: z3tQwy28dp5FykDJC/wzQw ($11.95 in chips) 
Seat 6: 096oPBXuIkGUyml0gVo5TA ($17.10 in chips) 
z3tQwy28dp5FykDJC/wzQw: posts small blind $0.10
096oPBXuIkGUyml0gVo5TA: posts big blind $0.25
*** HOLE CARDS ***
32YL2ZEp8NT4JB2RVM9euQ: folds 
wAKC8C/zN0c8V5v13dm9mA: folds 
EV5E02/xfaoDNHy7UQ195Q: folds 
tTBLQIRkkVpjhASe6+jvXQ: calls $0.25
z3tQwy28dp5FykDJC/wzQw: folds 
096oPBXuIkGUyml0gVo5TA: checks 
*** FLOP *** [5d 3s 4c]
096oPBXuIkGUyml0gVo5TA: checks 
tTBLQIRkkVpjhASe6+jvXQ: checks 
*** TURN *** [5d 3s 4c] [Kd]
096oPBXuIkGUyml0gVo5TA: bets $0.50
tTBLQIRkkVpjhASe6+jvXQ: calls $0.50
*** RIVER *** [5d 3s 4c Kd] [Tc]
096oPBXuIkGUyml0gVo5TA: bets $0.50
tTBLQIRkkVpjhASe6+jvXQ: calls $0.50
*** SHOW DOWN ***
096oPBXuIkGUyml0gVo5TA: shows [7c Kc] (a pair of Kings)
tTBLQIRkkVpjhASe6+jvXQ: mucks hand 
wAKC8C/zN0c8V5v13dm9mA is disconnected 
096oPBXuIkGUyml0gVo5TA collected $2.50 from pot
wAKC8C/zN0c8V5v13dm9mA is connected 
*** SUMMARY ***
Total pot $2.60 | Rake $0.10 
Board [5d 3s 4c Kd Tc]
Seat 1: 32YL2ZEp8NT4JB2RVM9euQ folded before Flop (didn't bet)
Seat 2: wAKC8C/zN0c8V5v13dm9mA folded before Flop (didn't bet)
Seat 3: EV5E02/xfaoDNHy7UQ195Q folded before Flop (didn't bet)
Seat 4: tTBLQIRkkVpjhASe6+jvXQ (button) mucked
Seat 5: z3tQwy28dp5FykDJC/wzQw (small blind) folded before Flop
Seat 6: 096oPBXuIkGUyml0gVo5TA (big blind) showed [7c Kc] and won ($2.50) with a pair of Kings




PokerStars Game #59939484470:  Hold'em No Limit ($0.10/$0.25) - 2009/07/01 0:41:04 ET
Table 'rjcb+nlE+0GuJ6lBhuCkkA' 6-max Seat #5 is the button
Seat 1: 9jSiy0meE9XJKkdIZwyTEQ ($26.05 in chips) 
Seat 2: d9ecz4Yhx6qRKe5k+fUWdw ($18.70 in chips) 
Seat 3: 8ClCHtFXGNplITm+63KB+Q ($25 in chips) 
Seat 4: NzIFHwilc5zU7QhjDTgTZA ($13.05 in chips) 
Seat 5: GC/9yVD59DUCX7hUI7gcLw ($43.50 in chips) 
Seat 6: 0DvgWV5o6c/jYqQCjm4Haw ($33.75 in chips) 
0DvgWV5o6c/jYqQCjm4Haw: posts small blind $0.10
9jSiy0meE9XJKkdIZwyTEQ: posts big blind $0.25
*** HOLE CARDS ***
d9ecz4Yhx6qRKe5k+fUWdw: folds 
8ClCHtFXGNplITm+63KB+Q: folds 
NzIFHwilc5zU7QhjDTgTZA: folds 
GC/9yVD59DUCX7hUI7gcLw: folds 
0DvgWV5o6c/jYqQCjm4Haw: folds 
Uncalled bet ($0.15) returned to 9jSiy0meE9XJKkdIZwyTEQ
9jSiy0meE9XJKkdIZwyTEQ collected $0.20 from pot
9jSiy0meE9XJKkdIZwyTEQ: doesn't show hand 
*** SUMMARY ***
Total pot $0.20 | Rake $0 
Seat 1: 9jSiy0meE9XJKkdIZwyTEQ (big blind) collected ($0.20)
Seat 2: d9ecz4Yhx6qRKe5k+fUWdw folded before Flop (didn't bet)
Seat 3: 8ClCHtFXGNplITm+63KB+Q folded before Flop (didn't bet)
Seat 4: NzIFHwilc5zU7QhjDTgTZA folded before Flop (didn't bet)
Seat 5: GC/9yVD59DUCX7hUI7gcLw (button) folded before Flop (didn't bet)
Seat 6: 0DvgWV5o6c/jYqQCjm4Haw (small blind) folded before Flop




PokerStars Game #59939484466:  Hold'em No Limit ($0.10/$0.25) - 2009/07/01 0:41:04 ET
Table 'WY+lMaAoIdBZmwk27/RJCA' 6-max Seat #6 is the button
Seat 1: lYjWCpfCxX2kgcHY3v4Yow ($25 in chips) 
Seat 2: cPO/1/dTcZpLkQFm3jH3Rg ($25.05 in chips) 
Seat 3: 79Q62AM0VB++TQYiBlOYsA ($38.05 in chips) 
Seat 4: cGfAi40F+9odP4v0stvfiQ ($26.45 in chips) 
Seat 5: wKFJ513ucluNNiMlkXcDOQ ($29.35 in chips) 
Seat 6: I1TxPvWj8NfG8orglCinNA ($27.35 in chips) 
lYjWCpfCxX2kgcHY3v4Yow: posts small blind $0.10
cPO/1/dTcZpLkQFm3jH3Rg: posts big blind $0.25
*** HOLE CARDS ***
79Q62AM0VB++TQYiBlOYsA: calls $0.25
cGfAi40F+9odP4v0stvfiQ: calls $0.25
wKFJ513ucluNNiMlkXcDOQ: raises $1.25 to $1.50
I1TxPvWj8NfG8orglCinNA: folds 
lYjWCpfCxX2kgcHY3v4Yow: folds 
cPO/1/dTcZpLkQFm3jH3Rg: folds 
79Q62AM0VB++TQYiBlOYsA: folds 
cGfAi40F+9odP4v0stvfiQ: folds 
Uncalled bet ($1.25) returned to wKFJ513ucluNNiMlkXcDOQ
wKFJ513ucluNNiMlkXcDOQ collected $1.10 from pot
wKFJ513ucluNNiMlkXcDOQ: doesn't show hand 
*** SUMMARY ***
Total pot $1.10 | Rake $0 
Seat 1: lYjWCpfCxX2kgcHY3v4Yow (small blind) folded before Flop
Seat 2: cPO/1/dTcZpLkQFm3jH3Rg (big blind) folded before Flop
Seat 3: 79Q62AM0VB++TQYiBlOYsA folded before Flop
Seat 4: cGfAi40F+9odP4v0stvfiQ folded before Flop
Seat 5: wKFJ513ucluNNiMlkXcDOQ collected ($1.10)
Seat 6: I1TxPvWj8NfG8orglCinNA (button) folded before Flop (didn't bet)




PokerStars Game #59939484410:  Hold'em No Limit ($0.10/$0.25) - 2009/07/01 0:41:04 ET
Table 'IIO2q2znuuAXmiZ2qFTcmg' 6-max Seat #5 is the button
Seat 1: nwwpaieDRI0UPyVtChVHOg ($17.85 in chips) 
Seat 2: cS21pIxRHx5Gt42o7hPZzw ($15.90 in chips) 
Seat 3: hiTEr3yrERiQp3zHXRioVw ($14.40 in chips) 
Seat 4: 0HIrwssk0FQvyKULzUTtlg ($9.75 in chips) 
Seat 5: f9iRHw0d+kV7pbTYwF2+2g ($17.45 in chips) 
nwwpaieDRI0UPyVtChVHOg: posts small blind $0.10
cS21pIxRHx5Gt42o7hPZzw: posts big blind $0.25
*** HOLE CARDS ***
hiTEr3yrERiQp3zHXRioVw: calls $0.25
0HIrwssk0FQvyKULzUTtlg: folds 
f9iRHw0d+kV7pbTYwF2+2g: calls $0.25
nwwpaieDRI0UPyVtChVHOg: folds 
cS21pIxRHx5Gt42o7hPZzw: checks 
*** FLOP *** [4s 4h Kc]
cS21pIxRHx5Gt42o7hPZzw: checks 
hiTEr3yrERiQp3zHXRioVw: checks 
f9iRHw0d+kV7pbTYwF2+2g: bets $0.25
cS21pIxRHx5Gt42o7hPZzw: calls $0.25
hiTEr3yrERiQp3zHXRioVw: calls $0.25
*** TURN *** [4s 4h Kc] [6h]
cS21pIxRHx5Gt42o7hPZzw: checks 
hiTEr3yrERiQp3zHXRioVw: checks 
f9iRHw0d+kV7pbTYwF2+2g: checks 
*** RIVER *** [4s 4h Kc 6h] [Jh]
cS21pIxRHx5Gt42o7hPZzw: checks 
hiTEr3yrERiQp3zHXRioVw: checks 
f9iRHw0d+kV7pbTYwF2+2g: checks 
*** SHOW DOWN ***
cS21pIxRHx5Gt42o7hPZzw: shows [9d Ks] (two pair, Kings and Fours)
hiTEr3yrERiQp3zHXRioVw: mucks hand 
f9iRHw0d+kV7pbTYwF2+2g: mucks hand 
cS21pIxRHx5Gt42o7hPZzw collected $1.55 from pot
*** SUMMARY ***
Total pot $1.60 | Rake $0.05 
Board [4s 4h Kc 6h Jh]
Seat 1: nwwpaieDRI0UPyVtChVHOg (small blind) folded before Flop
Seat 2: cS21pIxRHx5Gt42o7hPZzw (big blind) showed [9d Ks] and won ($1.55) with two pair, Kings and Fours
Seat 3: hiTEr3yrERiQp3zHXRioVw mucked
Seat 4: 0HIrwssk0FQvyKULzUTtlg folded before Flop (didn't bet)
Seat 5: f9iRHw0d+kV7pbTYwF2+2g (button) mucked




PokerStars Game #59939484984:  Hold'em No Limit ($0.10/$0.25) - 2009/07/01 0:41:05 ET
Table 'mF3KHGMaTpaBZbtBoyfTeg' 6-max Seat #5 is the button
Seat 1: 0HAB2GdCAM7p7V00xueAVQ ($10.05 in chips) 
Seat 2: 4x9jCqgSw4272dnaIqnanw ($4.50 in chips) 
Seat 3: Hzrn9DZJegEZICufTNYkrg ($14.40 in chips) 
Seat 4: FYepjhAvF8ZdVCmqHIy+eQ ($25.55 in chips) 
Seat 5: sEQx9G5Cu8k1HNdQasxvUA ($27.90 in chips) 
0HAB2GdCAM7p7V00xueAVQ: posts small blind $0.10
4x9jCqgSw4272dnaIqnanw: posts big blind $0.25
*** HOLE CARDS ***
Hzrn9DZJegEZICufTNYkrg: calls $0.25
FYepjhAvF8ZdVCmqHIy+eQ: folds 
sEQx9G5Cu8k1HNdQasxvUA: folds 
0HAB2GdCAM7p7V00xueAVQ: folds 
4x9jCqgSw4272dnaIqnanw: checks 
*** FLOP *** [Ad Js 5c]
4x9jCqgSw4272dnaIqnanw: checks 
Hzrn9DZJegEZICufTNYkrg: checks 
*** TURN *** [Ad Js 5c] [6h]
4x9jCqgSw4272dnaIqnanw: checks 
Hzrn9DZJegEZICufTNYkrg: checks 
*** RIVER *** [Ad Js 5c 6h] [5s]
4x9jCqgSw4272dnaIqnanw: checks 
Hzrn9DZJegEZICufTNYkrg: bets $0.50
4x9jCqgSw4272dnaIqnanw: folds 
Uncalled bet ($0.50) returned to Hzrn9DZJegEZICufTNYkrg
Hzrn9DZJegEZICufTNYkrg collected $0.60 from pot
Hzrn9DZJegEZICufTNYkrg: doesn't show hand 
*** SUMMARY ***
Total pot $0.60 | Rake $0 
Board [Ad Js 5c 6h 5s]
Seat 1: 0HAB2GdCAM7p7V00xueAVQ (small blind) folded before Flop
Seat 2: 4x9jCqgSw4272dnaIqnanw (big blind) folded on the River
Seat 3: Hzrn9DZJegEZICufTNYkrg collected ($0.60)
Seat 4: FYepjhAvF8ZdVCmqHIy+eQ folded before Flop (didn't bet)
Seat 5: sEQx9G5Cu8k1HNdQasxvUA (button) folded before Flop (didn't bet)




PokerStars Game #59939485002:  Hold'em No Limit ($0.10/$0.25) - 2009/07/01 0:41:05 ET
Table 'isKy4XK8wJM0x735/D4hWA' 6-max Seat #4 is the button
Seat 1: 7FmwVDcdEtxDpHmP4hOXsQ ($25 in chips) 
Seat 2: WrLI51S2iMb8GLMB83gGqA ($26.75 in chips) 
Seat 4: k9vn40MOqqb+xF+7GZ6v2g ($24.65 in chips) 
Seat 5: zlYHXTtJ5tcx9kwK2h5n9A ($37.15 in chips) 
Seat 6: M6xK/VklCvdyyrmvzATlxQ ($14.10 in chips) 
zlYHXTtJ5tcx9kwK2h5n9A: posts small blind $0.10
M6xK/VklCvdyyrmvzATlxQ: posts big blind $0.25
jp34e617tIzV8tKIWmfAbA: sits out 
*** HOLE CARDS ***
7FmwVDcdEtxDpHmP4hOXsQ: folds 
WrLI51S2iMb8GLMB83gGqA: raises $0.75 to $1
k9vn40MOqqb+xF+7GZ6v2g: folds 
zlYHXTtJ5tcx9kwK2h5n9A: folds 
M6xK/VklCvdyyrmvzATlxQ: folds 
Uncalled bet ($0.75) returned to WrLI51S2iMb8GLMB83gGqA
WrLI51S2iMb8GLMB83gGqA collected $0.60 from pot
WrLI51S2iMb8GLMB83gGqA: doesn't show hand 
*** SUMMARY ***
Total pot $0.60 | Rake $0 
Seat 1: 7FmwVDcdEtxDpHmP4hOXsQ folded before Flop (didn't bet)
Seat 2: WrLI51S2iMb8GLMB83gGqA collected ($0.60)
Seat 4: k9vn40MOqqb+xF+7GZ6v2g (button) folded before Flop (didn't bet)
Seat 5: zlYHXTtJ5tcx9kwK2h5n9A (small blind) folded before Flop
Seat 6: M6xK/VklCvdyyrmvzATlxQ (big blind) folded before Flop




PokerStars Game #59939484846:  Hold'em No Limit ($0.10/$0.25) - 2009/07/01 0:41:05 ET
Table 'nyTW9cVtYentc5V7xU/0jA' 6-max Seat #5 is the button
Seat 1: YfxPRDAWfqnGBhiIEdlTYg ($12.15 in chips) 
Seat 2: 7FmwVDcdEtxDpHmP4hOXsQ ($25 in chips) 
Seat 3: kG34n23qFQA3nzdOJTQ1dA ($24.55 in chips) 
Seat 4: r6u7MWSXF30/khcTYkrG9Q ($36.80 in chips) 
Seat 5: BedjMfrlRfPgSq7CXpPAmg ($25 in chips) 
Seat 6: dQJByDqHOLbgqX/HobyAJA ($8.10 in chips) 
dQJByDqHOLbgqX/HobyAJA: posts small blind $0.10
YfxPRDAWfqnGBhiIEdlTYg: posts big blind $0.25
*** HOLE CARDS ***
7FmwVDcdEtxDpHmP4hOXsQ: folds 
kG34n23qFQA3nzdOJTQ1dA: folds 
r6u7MWSXF30/khcTYkrG9Q: raises $0.50 to $0.75
BedjMfrlRfPgSq7CXpPAmg: calls $0.75
dQJByDqHOLbgqX/HobyAJA: calls $0.65
YfxPRDAWfqnGBhiIEdlTYg: calls $0.50
*** FLOP *** [Kc 9d 4s]
dQJByDqHOLbgqX/HobyAJA: checks 
YfxPRDAWfqnGBhiIEdlTYg: checks 
r6u7MWSXF30/khcTYkrG9Q: checks 
BedjMfrlRfPgSq7CXpPAmg: bets $1.85
dQJByDqHOLbgqX/HobyAJA: folds 
YfxPRDAWfqnGBhiIEdlTYg: folds 
r6u7MWSXF30/khcTYkrG9Q: calls $1.85
*** TURN *** [Kc 9d 4s] [4c]
r6u7MWSXF30/khcTYkrG9Q: checks 
BedjMfrlRfPgSq7CXpPAmg: checks 
*** RIVER *** [Kc 9d 4s 4c] [6s]
r6u7MWSXF30/khcTYkrG9Q: checks 
BedjMfrlRfPgSq7CXpPAmg: checks 
*** SHOW DOWN ***
r6u7MWSXF30/khcTYkrG9Q: shows [Td Th] (two pair, Tens and Fours)
BedjMfrlRfPgSq7CXpPAmg: shows [Jd Js] (two pair, Jacks and Fours)
BedjMfrlRfPgSq7CXpPAmg collected $6.40 from pot
*** SUMMARY ***
Total pot $6.70 | Rake $0.30 
Board [Kc 9d 4s 4c 6s]
Seat 1: YfxPRDAWfqnGBhiIEdlTYg (big blind) folded on the Flop
Seat 2: 7FmwVDcdEtxDpHmP4hOXsQ folded before Flop (didn't bet)
Seat 3: kG34n23qFQA3nzdOJTQ1dA folded before Flop (didn't bet)
Seat 4: r6u7MWSXF30/khcTYkrG9Q showed [Td Th] and lost with two pair, Tens and Fours
Seat 5: BedjMfrlRfPgSq7CXpPAmg (button) showed [Jd Js] and won ($6.40) with two pair, Jacks and Fours
Seat 6: dQJByDqHOLbgqX/HobyAJA (small blind) folded on the Flop




PokerStars Game #59939485358:  Hold'em No Limit ($0.10/$0.25) - 2009/07/01 0:41:05 ET
Table '9L7XfAwuM7XsXE8LIg2o5Q' 6-max Seat #4 is the button
Seat 1: H6XbZVba2aKDXlG0la0uow ($9.35 in chips) 
Seat 2: oseFhpinoe+Zg4j5xyBjyQ ($19.10 in chips) 
Seat 3: 9StOHp+Y1T0K13JdgS2oQQ ($5.60 in chips) 
Seat 4: xBOVv8xEXtymVpAA5ZajSw ($76.95 in chips) 
Seat 5: Lh8SlCq3OSDKWLUgAI/Lxw ($11.80 in chips) 
Seat 6: k9nHZTHt8hYhYRcW8NTb4g ($29.45 in chips) 
Lh8SlCq3OSDKWLUgAI/Lxw: posts small blind $0.10
k9nHZTHt8hYhYRcW8NTb4g: posts big blind $0.25
*** HOLE CARDS ***
H6XbZVba2aKDXlG0la0uow: folds 
oseFhpinoe+Zg4j5xyBjyQ: folds 
9StOHp+Y1T0K13JdgS2oQQ: raises $0.25 to $0.50
xBOVv8xEXtymVpAA5ZajSw: raises $5 to $5.50
Lh8SlCq3OSDKWLUgAI/Lxw: folds 
k9nHZTHt8hYhYRcW8NTb4g: folds 
9StOHp+Y1T0K13JdgS2oQQ: folds 
Uncalled bet ($5) returned to xBOVv8xEXtymVpAA5ZajSw
Lh8SlCq3OSDKWLUgAI/Lxw leaves the table
xBOVv8xEXtymVpAA5ZajSw collected $1.35 from pot
*** SUMMARY ***
Total pot $1.35 | Rake $0 
Seat 1: H6XbZVba2aKDXlG0la0uow folded before Flop (didn't bet)
Seat 2: oseFhpinoe+Zg4j5xyBjyQ folded before Flop (didn't bet)
Seat 3: 9StOHp+Y1T0K13JdgS2oQQ folded before Flop
Seat 4: xBOVv8xEXtymVpAA5ZajSw (button) collected ($1.35)
Seat 5: Lh8SlCq3OSDKWLUgAI/Lxw (small blind) folded before Flop
Seat 6: k9nHZTHt8hYhYRcW8NTb4g (big blind) folded before Flop




PokerStars Game #59939485280:  Hold'em No Limit ($0.10/$0.25) - 2009/07/01 0:41:05 ET
Table 'GoBmKm3klK6VavJE4STfmQ' 9-max Seat #8 is the button
Seat 1: N6fYvIzQLKaydFLKQGtMlQ ($23.55 in chips) 
Seat 2: 1c/7DHPx5CDTmAfk8/bWeA ($14.75 in chips) 
Seat 3: 4awUyiDYTgylQKXZ9faBVA ($26.40 in chips) 
Seat 4: H5Se03ZqSX7tbULXur2MAg ($24.30 in chips) 
Seat 5: 8B/dhbQjIWe6ASCdgzktNQ ($25.20 in chips) 
Seat 6: S3QwXyGCcujfAwNubHpwbw ($6.15 in chips) 
Seat 7: s9a4d23HFxaL70yUWQ0/tQ ($20.90 in chips) 
Seat 8: cZ99hugmLBj9KhTlc8nCSw ($25 in chips) 
Seat 9: 1K6QGyJP9P9xmRac2fH4OQ ($47.80 in chips) 
1K6QGyJP9P9xmRac2fH4OQ: posts small blind $0.10
N6fYvIzQLKaydFLKQGtMlQ: posts big blind $0.25
*** HOLE CARDS ***
1c/7DHPx5CDTmAfk8/bWeA: calls $0.25
4awUyiDYTgylQKXZ9faBVA: folds 
H5Se03ZqSX7tbULXur2MAg: folds 
8B/dhbQjIWe6ASCdgzktNQ: folds 
S3QwXyGCcujfAwNubHpwbw: calls $0.25
s9a4d23HFxaL70yUWQ0/tQ: folds 
cZ99hugmLBj9KhTlc8nCSw: folds 
1K6QGyJP9P9xmRac2fH4OQ: folds 
N6fYvIzQLKaydFLKQGtMlQ: checks 
*** FLOP *** [2d 4d Jd]
N6fYvIzQLKaydFLKQGtMlQ: checks 
1c/7DHPx5CDTmAfk8/bWeA: bets $0.25
S3QwXyGCcujfAwNubHpwbw: folds 
N6fYvIzQLKaydFLKQGtMlQ: folds 
Uncalled bet ($0.25) returned to 1c/7DHPx5CDTmAfk8/bWeA
1c/7DHPx5CDTmAfk8/bWeA collected $0.85 from pot
*** SUMMARY ***
Total pot $0.85 | Rake $0 
Board [2d 4d Jd]
Seat 1: N6fYvIzQLKaydFLKQGtMlQ (big blind) folded on the Flop
Seat 2: 1c/7DHPx5CDTmAfk8/bWeA collected ($0.85)
Seat 3: 4awUyiDYTgylQKXZ9faBVA folded before Flop (didn't bet)
Seat 4: H5Se03ZqSX7tbULXur2MAg folded before Flop (didn't bet)
Seat 5: 8B/dhbQjIWe6ASCdgzktNQ folded before Flop (didn't bet)
Seat 6: S3QwXyGCcujfAwNubHpwbw folded on the Flop
Seat 7: s9a4d23HFxaL70yUWQ0/tQ folded before Flop (didn't bet)
Seat 8: cZ99hugmLBj9KhTlc8nCSw (button) folded before Flop (didn't bet)
Seat 9: 1K6QGyJP9P9xmRac2fH4OQ (small blind) folded before Flop




PokerStars Game #59939485326:  Hold'em No Limit ($0.10/$0.25) - 2009/07/01 0:41:05 ET
Table 'oxYpQNT8OHNCvpMIFi7UoA' 9-max Seat #5 is the button
Seat 1: H5Se03ZqSX7tbULXur2MAg ($25 in chips) 
Seat 2: Ofo77cVa49gHqAMfHrrMbw ($12.60 in chips) 
Seat 3: DBWHFmM+iV/PrUG8xKBQ7w ($8.55 in chips) 
Seat 4: ghNKXUBl/H+t83JF079ZBA ($25 in chips) 
Seat 5: SXqVW4Q0evTUVZG6BbUNIA ($34.15 in chips) 
Seat 6: +2kMBNpY4nF1qNCRd8SJLA ($25 in chips) 
Seat 7: yyG4svzOpC1A+sUP/scg6w ($7.50 in chips) 
Seat 8: OlPJsgR4xypSg/w1z7Gyvw ($19.10 in chips) 
Seat 9: KK7jFoJo1TzDCPdsfpPjtw ($40.80 in chips) 
+2kMBNpY4nF1qNCRd8SJLA: posts small blind $0.10
yyG4svzOpC1A+sUP/scg6w: posts big blind $0.25
*** HOLE CARDS ***
OlPJsgR4xypSg/w1z7Gyvw: calls $0.25
KK7jFoJo1TzDCPdsfpPjtw: calls $0.25
H5Se03ZqSX7tbULXur2MAg: folds 
Ofo77cVa49gHqAMfHrrMbw: folds 
DBWHFmM+iV/PrUG8xKBQ7w: folds 
ghNKXUBl/H+t83JF079ZBA: folds 
SXqVW4Q0evTUVZG6BbUNIA: folds 
+2kMBNpY4nF1qNCRd8SJLA: calls $0.15
yyG4svzOpC1A+sUP/scg6w: checks 
*** FLOP *** [Jh Jc 8s]
+2kMBNpY4nF1qNCRd8SJLA: checks 
yyG4svzOpC1A+sUP/scg6w: checks 
OlPJsgR4xypSg/w1z7Gyvw: checks 
KK7jFoJo1TzDCPdsfpPjtw: bets $0.50
+2kMBNpY4nF1qNCRd8SJLA: calls $0.50
yyG4svzOpC1A+sUP/scg6w: folds 
OlPJsgR4xypSg/w1z7Gyvw: folds 
*** TURN *** [Jh Jc 8s] [8h]
+2kMBNpY4nF1qNCRd8SJLA: checks 
KK7jFoJo1TzDCPdsfpPjtw: bets $1
+2kMBNpY4nF1qNCRd8SJLA: folds 
Uncalled bet ($1) returned to KK7jFoJo1TzDCPdsfpPjtw
KK7jFoJo1TzDCPdsfpPjtw collected $1.95 from pot
KK7jFoJo1TzDCPdsfpPjtw: doesn't show hand 
*** SUMMARY ***
Total pot $2 | Rake $0.05 
Board [Jh Jc 8s 8h]
Seat 1: H5Se03ZqSX7tbULXur2MAg folded before Flop (didn't bet)
Seat 2: Ofo77cVa49gHqAMfHrrMbw folded before Flop (didn't bet)
Seat 3: DBWHFmM+iV/PrUG8xKBQ7w folded before Flop (didn't bet)
Seat 4: ghNKXUBl/H+t83JF079ZBA folded before Flop (didn't bet)
Seat 5: SXqVW4Q0evTUVZG6BbUNIA (button) folded before Flop (didn't bet)
Seat 6: +2kMBNpY4nF1qNCRd8SJLA (small blind) folded on the Turn
Seat 7: yyG4svzOpC1A+sUP/scg6w (big blind) folded on the Flop
Seat 8: OlPJsgR4xypSg/w1z7Gyvw folded on the Flop
Seat 9: KK7jFoJo1TzDCPdsfpPjtw collected ($1.95)




PokerStars Game #59939484802:  Hold'em No Limit ($0.10/$0.25) - 2009/07/01 0:41:05 ET
Table '3EebBlzq5yHSY2444L4zlg' 9-max Seat #1 is the button
Seat 1: 8B/dhbQjIWe6ASCdgzktNQ ($37.25 in chips) 
Seat 2: MIVCHqCqqlke0Lb0z7glcw ($25.10 in chips) 
Seat 3: IGbD5vKNhHe60dkdbjg/mw ($25.35 in chips) 
Seat 4: 1S/fpm+f42V/6MNZre+ccg ($25.45 in chips) 
Seat 5: 22Ph+hChb2fjC5+yk/mOew ($14.75 in chips) 
Seat 6: QEbIGci+itdw+re8RM5fZA ($28.15 in chips) 
Seat 7: DiSvPC2iudwL5j9u6Huyww ($27.90 in chips) 
Seat 8: Qi+clOtyDiibLdH2/1Qy8g ($27.85 in chips) 
Seat 9: GTcLfsDTPqgfHyhY9FNDMw ($11.40 in chips) 
MIVCHqCqqlke0Lb0z7glcw: posts small blind $0.10
IGbD5vKNhHe60dkdbjg/mw: posts big blind $0.25
*** HOLE CARDS ***
1S/fpm+f42V/6MNZre+ccg: folds 
22Ph+hChb2fjC5+yk/mOew: folds 
QEbIGci+itdw+re8RM5fZA: folds 
DiSvPC2iudwL5j9u6Huyww: folds 
Qi+clOtyDiibLdH2/1Qy8g: folds 
GTcLfsDTPqgfHyhY9FNDMw: folds 
8B/dhbQjIWe6ASCdgzktNQ: raises $0.50 to $0.75
MIVCHqCqqlke0Lb0z7glcw: calls $0.65
IGbD5vKNhHe60dkdbjg/mw: calls $0.50
*** FLOP *** [Tc 5s 7h]
MIVCHqCqqlke0Lb0z7glcw: checks 
IGbD5vKNhHe60dkdbjg/mw: bets $1
8B/dhbQjIWe6ASCdgzktNQ: calls $1
MIVCHqCqqlke0Lb0z7glcw: folds 
*** TURN *** [Tc 5s 7h] [As]
IGbD5vKNhHe60dkdbjg/mw: bets $1
8B/dhbQjIWe6ASCdgzktNQ: raises $2.25 to $3.25
IGbD5vKNhHe60dkdbjg/mw: raises $20.35 to $23.60 and is all-in
8B/dhbQjIWe6ASCdgzktNQ said, "2 pair?"
8B/dhbQjIWe6ASCdgzktNQ: folds 
Uncalled bet ($20.35) returned to IGbD5vKNhHe60dkdbjg/mw
IGbD5vKNhHe60dkdbjg/mw collected $10.25 from pot
*** SUMMARY ***
Total pot $10.75 | Rake $0.50 
Board [Tc 5s 7h As]
Seat 1: 8B/dhbQjIWe6ASCdgzktNQ (button) folded on the Turn
Seat 2: MIVCHqCqqlke0Lb0z7glcw (small blind) folded on the Flop
Seat 3: IGbD5vKNhHe60dkdbjg/mw (big blind) collected ($10.25)
Seat 4: 1S/fpm+f42V/6MNZre+ccg folded before Flop (didn't bet)
Seat 5: 22Ph+hChb2fjC5+yk/mOew folded before Flop (didn't bet)
Seat 6: QEbIGci+itdw+re8RM5fZA folded before Flop (didn't bet)
Seat 7: DiSvPC2iudwL5j9u6Huyww folded before Flop (didn't bet)
Seat 8: Qi+clOtyDiibLdH2/1Qy8g folded before Flop (didn't bet)
Seat 9: GTcLfsDTPqgfHyhY9FNDMw folded before Flop (didn't bet)




PokerStars Game #59939485134:  Hold'em No Limit ($0.10/$0.25) - 2009/07/01 0:41:05 ET
Table 'Utmw+yX+E/wdhNDIim90lQ' 9-max Seat #4 is the button
Seat 1: lwlnPm68QGGI/+pnAd4GAw ($60.10 in chips) 
Seat 2: iGMlK+EhUflPB6jKQd95Cg ($25.20 in chips) 
Seat 3: dfNim92Z6XK1/h5SFW5vDg ($25 in chips) 
Seat 4: ifYGvZDHQQ0aam4awTtHwA ($4.70 in chips) 
Seat 5: H9KUl8cmpLgEpOVDA00bCg ($4.05 in chips) 
Seat 6: OlPJsgR4xypSg/w1z7Gyvw ($20 in chips) 
Seat 7: CImUHesK+ZER4v/VCA9IUg ($64.80 in chips) 
Seat 8: DdPXdieucQ+n99u1n3A+rQ ($4.90 in chips) 
Seat 9: Th3FldXKQW6hWVVPahaoOQ ($27.50 in chips) 
H9KUl8cmpLgEpOVDA00bCg: posts small blind $0.10
OlPJsgR4xypSg/w1z7Gyvw: posts big blind $0.25
*** HOLE CARDS ***
CImUHesK+ZER4v/VCA9IUg: calls $0.25
DdPXdieucQ+n99u1n3A+rQ: folds 
Th3FldXKQW6hWVVPahaoOQ: folds 
lwlnPm68QGGI/+pnAd4GAw: folds 
iGMlK+EhUflPB6jKQd95Cg: folds 
dfNim92Z6XK1/h5SFW5vDg: calls $0.25
ifYGvZDHQQ0aam4awTtHwA: raises $0.75 to $1
H9KUl8cmpLgEpOVDA00bCg: folds 
OlPJsgR4xypSg/w1z7Gyvw: folds 
CImUHesK+ZER4v/VCA9IUg: folds 
dfNim92Z6XK1/h5SFW5vDg: folds 
Uncalled bet ($0.75) returned to ifYGvZDHQQ0aam4awTtHwA
ifYGvZDHQQ0aam4awTtHwA collected $1.10 from pot
*** SUMMARY ***
Total pot $1.10 | Rake $0 
Seat 1: lwlnPm68QGGI/+pnAd4GAw folded before Flop (didn't bet)
Seat 2: iGMlK+EhUflPB6jKQd95Cg folded before Flop (didn't bet)
Seat 3: dfNim92Z6XK1/h5SFW5vDg folded before Flop
Seat 4: ifYGvZDHQQ0aam4awTtHwA (button) collected ($1.10)
Seat 5: H9KUl8cmpLgEpOVDA00bCg (small blind) folded before Flop
Seat 6: OlPJsgR4xypSg/w1z7Gyvw (big blind) folded before Flop
Seat 7: CImUHesK+ZER4v/VCA9IUg folded before Flop
Seat 8: DdPXdieucQ+n99u1n3A+rQ folded before Flop (didn't bet)
Seat 9: Th3FldXKQW6hWVVPahaoOQ folded before Flop (didn't bet)




PokerStars Game #59939485142:  Hold'em No Limit ($0.10/$0.25) - 2009/07/01 0:41:05 ET
Table 'dVzscin98UhGisTmV9BDcw' 9-max Seat #6 is the button
Seat 1: sBAwXpkpgyhyWbHIQcIJKA ($19.45 in chips) 
Seat 2: dfNim92Z6XK1/h5SFW5vDg ($29.15 in chips) 
Seat 3: 1Clf3cPrqoy/YgvWdWK1Xw ($5.25 in chips) 
Seat 4: aNpwfA31EREwO+ar4XzBCw ($25.25 in chips) 
Seat 5: ZMRQOoxoJ7Alx96gZhP2EQ ($64.70 in chips) 
Seat 6: hBMUlEpyU74r/fwDgIpXjQ ($27.75 in chips) 
Seat 7: nEg1b6MIksd/4x5eLY735g ($60.65 in chips) 
Seat 8: /vn2Qu2dvc9AMMq46Ae0jA ($5.70 in chips) 
Seat 9: OYa/ZJBO+suuezfWsUMhZw ($5.80 in chips) 
nEg1b6MIksd/4x5eLY735g: posts small blind $0.10
/vn2Qu2dvc9AMMq46Ae0jA: posts big blind $0.25
*** HOLE CARDS ***
OYa/ZJBO+suuezfWsUMhZw: folds 
sBAwXpkpgyhyWbHIQcIJKA: folds 
dfNim92Z6XK1/h5SFW5vDg: folds 
1Clf3cPrqoy/YgvWdWK1Xw: folds 
aNpwfA31EREwO+ar4XzBCw: folds 
ZMRQOoxoJ7Alx96gZhP2EQ: calls $0.25
hBMUlEpyU74r/fwDgIpXjQ: raises $0.75 to $1
nEg1b6MIksd/4x5eLY735g: folds 
/vn2Qu2dvc9AMMq46Ae0jA: folds 
ZMRQOoxoJ7Alx96gZhP2EQ: folds 
Uncalled bet ($0.75) returned to hBMUlEpyU74r/fwDgIpXjQ
hBMUlEpyU74r/fwDgIpXjQ collected $0.85 from pot
hBMUlEpyU74r/fwDgIpXjQ: doesn't show hand 
*** SUMMARY ***
Total pot $0.85 | Rake $0 
Seat 1: sBAwXpkpgyhyWbHIQcIJKA folded before Flop (didn't bet)
Seat 2: dfNim92Z6XK1/h5SFW5vDg folded before Flop (didn't bet)
Seat 3: 1Clf3cPrqoy/YgvWdWK1Xw folded before Flop (didn't bet)
Seat 4: aNpwfA31EREwO+ar4XzBCw folded before Flop (didn't bet)
Seat 5: ZMRQOoxoJ7Alx96gZhP2EQ folded before Flop
Seat 6: hBMUlEpyU74r/fwDgIpXjQ (button) collected ($0.85)
Seat 7: nEg1b6MIksd/4x5eLY735g (small blind) folded before Flop
Seat 8: /vn2Qu2dvc9AMMq46Ae0jA (big blind) folded before Flop
Seat 9: OYa/ZJBO+suuezfWsUMhZw folded before Flop (didn't bet)




PokerStars Game #59939484856:  Hold'em No Limit ($0.10/$0.25) - 2009/07/01 0:41:05 ET
Table 'RuT55t7dqtns1CdLsutksg' 9-max Seat #5 is the button
Seat 1: N6WEabmk+J6IGeE7kub1QQ ($41.10 in chips) 
Seat 2: CYkY0dNBaYaKs8HVCVn3mQ ($5.90 in chips) 
Seat 3: xOx0qYgTfvbPkTa+GuX0WA ($16.25 in chips) 
Seat 4: MG90wfSJZnOejs/KD3vlQQ ($25.75 in chips) 
Seat 5: 0D3Q+hLxjPei/5wgaaYhZA ($4.05 in chips) 
Seat 6: CqwJk5Z2+vb2f9j1o7IjKQ ($12.35 in chips) 
Seat 8: yyG4svzOpC1A+sUP/scg6w ($7.50 in chips) 
Seat 9: oAO88RFrn7cbQFHZt8VrkA ($35.15 in chips) 
CqwJk5Z2+vb2f9j1o7IjKQ: posts small blind $0.10
Urgefan10: is sitting out 
Urgefan10 leaves the table
yyG4svzOpC1A+sUP/scg6w: posts big blind $0.25
*** HOLE CARDS ***
oAO88RFrn7cbQFHZt8VrkA: folds 
oAO88RFrn7cbQFHZt8VrkA is sitting out
N6WEabmk+J6IGeE7kub1QQ: folds 
CYkY0dNBaYaKs8HVCVn3mQ: folds 
xOx0qYgTfvbPkTa+GuX0WA: folds 
MG90wfSJZnOejs/KD3vlQQ: raises $0.50 to $0.75
0D3Q+hLxjPei/5wgaaYhZA: folds 
CqwJk5Z2+vb2f9j1o7IjKQ: calls $0.65
yyG4svzOpC1A+sUP/scg6w: folds 
*** FLOP *** [3s Kh 5d]
oAO88RFrn7cbQFHZt8VrkA leaves the table
CqwJk5Z2+vb2f9j1o7IjKQ: checks 
MG90wfSJZnOejs/KD3vlQQ: bets $1.40
CqwJk5Z2+vb2f9j1o7IjKQ: folds 
Uncalled bet ($1.40) returned to MG90wfSJZnOejs/KD3vlQQ
MG90wfSJZnOejs/KD3vlQQ collected $1.70 from pot
MG90wfSJZnOejs/KD3vlQQ: doesn't show hand 
*** SUMMARY ***
Total pot $1.75 | Rake $0.05 
Board [3s Kh 5d]
Seat 1: N6WEabmk+J6IGeE7kub1QQ folded before Flop (didn't bet)
Seat 2: CYkY0dNBaYaKs8HVCVn3mQ folded before Flop (didn't bet)
Seat 3: xOx0qYgTfvbPkTa+GuX0WA folded before Flop (didn't bet)
Seat 4: MG90wfSJZnOejs/KD3vlQQ collected ($1.70)
Seat 5: 0D3Q+hLxjPei/5wgaaYhZA (button) folded before Flop (didn't bet)
Seat 6: CqwJk5Z2+vb2f9j1o7IjKQ (small blind) folded on the Flop
Seat 8: yyG4svzOpC1A+sUP/scg6w (big blind) folded before Flop
Seat 9: oAO88RFrn7cbQFHZt8VrkA folded before Flop (didn't bet)




PokerStars Game #59939485092:  Hold'em No Limit ($0.10/$0.25) - 2009/07/01 0:41:05 ET
Table 'u5gc8WdJbaPqEonQaM8rHA' 9-max Seat #5 is the button
Seat 1: rXm4QDVJt67H20lM6n6Z7Q ($8.40 in chips) 
Seat 2: YcYxPZXJR8KffyXgr1BkHw ($27.80 in chips) 
Seat 5: 4y3ZJtAlW/aXjQX7SXyjrQ ($25.10 in chips) 
Seat 6: iPe2eRZr++z/LEfORn3WBQ ($17.05 in chips) 
iPe2eRZr++z/LEfORn3WBQ: posts small blind $0.10
rXm4QDVJt67H20lM6n6Z7Q: posts big blind $0.25
*** HOLE CARDS ***
YcYxPZXJR8KffyXgr1BkHw: raises $0.50 to $0.75
4y3ZJtAlW/aXjQX7SXyjrQ: folds 
iPe2eRZr++z/LEfORn3WBQ: folds 
rXm4QDVJt67H20lM6n6Z7Q: folds 
Uncalled bet ($0.50) returned to YcYxPZXJR8KffyXgr1BkHw
9j9dK6T4bnFE4nxAg16ycg joins the table at seat #8 
YcYxPZXJR8KffyXgr1BkHw collected $0.60 from pot
YcYxPZXJR8KffyXgr1BkHw: doesn't show hand 
*** SUMMARY ***
Total pot $0.60 | Rake $0 
Seat 1: rXm4QDVJt67H20lM6n6Z7Q (big blind) folded before Flop
Seat 2: YcYxPZXJR8KffyXgr1BkHw collected ($0.60)
Seat 5: 4y3ZJtAlW/aXjQX7SXyjrQ (button) folded before Flop (didn't bet)
Seat 6: iPe2eRZr++z/LEfORn3WBQ (small blind) folded before Flop




PokerStars Game #59939485896:  Hold'em No Limit ($0.10/$0.25) - 2009/07/01 0:41:06 ET
Table '0mmHveGuaIfIMQlNE1eqMg' 9-max Seat #2 is the button
Seat 1: 7QzbjWT00wQpau1iqvUmMA ($4.65 in chips) 
Seat 2: rQhYIYXSyH/IivYM1dlV5A ($52.65 in chips) 
Seat 3: ghNKXUBl/H+t83JF079ZBA ($29 in chips) 
Seat 4: r0/CtYRRIJAbPQm4qsv8LQ ($35.50 in chips) 
Seat 5: cVVfy+hwCb/YzSIyUWhKEw ($30 in chips) 
Seat 6: Xo1w+VqEZh0bV5wYupnNYg ($15.40 in chips) 
Seat 8: jiyia7h6fmxBdWBkH9lH5A ($2.95 in chips) 
Seat 9: W4TLQcZ2TiM73eIgpIvlGg ($34.50 in chips) 
ghNKXUBl/H+t83JF079ZBA: posts small blind $0.10
r0/CtYRRIJAbPQm4qsv8LQ: posts big blind $0.25
*** HOLE CARDS ***
cVVfy+hwCb/YzSIyUWhKEw: calls $0.25
Xo1w+VqEZh0bV5wYupnNYg: folds 
jiyia7h6fmxBdWBkH9lH5A: folds 
W4TLQcZ2TiM73eIgpIvlGg said, "just hit quads again on another table!"
W4TLQcZ2TiM73eIgpIvlGg said, "lol"
W4TLQcZ2TiM73eIgpIvlGg: calls $0.25
7QzbjWT00wQpau1iqvUmMA: folds 
rQhYIYXSyH/IivYM1dlV5A: folds 
ghNKXUBl/H+t83JF079ZBA: calls $0.15
r0/CtYRRIJAbPQm4qsv8LQ: checks 
*** FLOP *** [3s 6d 2d]
ghNKXUBl/H+t83JF079ZBA: bets $0.75
r0/CtYRRIJAbPQm4qsv8LQ: folds 
cVVfy+hwCb/YzSIyUWhKEw: raises $0.75 to $1.50
r0/CtYRRIJAbPQm4qsv8LQ said, "wow"
W4TLQcZ2TiM73eIgpIvlGg: folds 
ghNKXUBl/H+t83JF079ZBA: calls $0.75
*** TURN *** [3s 6d 2d] [Js]
ghNKXUBl/H+t83JF079ZBA: checks 
cVVfy+hwCb/YzSIyUWhKEw: bets $1.50
ghNKXUBl/H+t83JF079ZBA: calls $1.50
*** RIVER *** [3s 6d 2d Js] [Jc]
ghNKXUBl/H+t83JF079ZBA: checks 
cVVfy+hwCb/YzSIyUWhKEw: bets $6.75
ghNKXUBl/H+t83JF079ZBA: folds 
Uncalled bet ($6.75) returned to cVVfy+hwCb/YzSIyUWhKEw
cVVfy+hwCb/YzSIyUWhKEw collected $6.70 from pot
*** SUMMARY ***
Total pot $7 | Rake $0.30 
Board [3s 6d 2d Js Jc]
Seat 1: 7QzbjWT00wQpau1iqvUmMA folded before Flop (didn't bet)
Seat 2: rQhYIYXSyH/IivYM1dlV5A (button) folded before Flop (didn't bet)
Seat 3: ghNKXUBl/H+t83JF079ZBA (small blind) folded on the River
Seat 4: r0/CtYRRIJAbPQm4qsv8LQ (big blind) folded on the Flop
Seat 5: cVVfy+hwCb/YzSIyUWhKEw collected ($6.70)
Seat 6: Xo1w+VqEZh0bV5wYupnNYg folded before Flop (didn't bet)
Seat 8: jiyia7h6fmxBdWBkH9lH5A folded before Flop (didn't bet)
Seat 9: W4TLQcZ2TiM73eIgpIvlGg folded on the Flop




PokerStars Game #59939485806:  Hold'em No Limit ($0.10/$0.25) - 2009/07/01 0:41:06 ET
Table 'qryc9C/ELyQ3lubOaELNAQ' 6-max Seat #6 is the button
Seat 1: OZc6kkoTwtITj1ZfreJK1A ($26.15 in chips) 
Seat 2: qvQc9BHp2FhQjrltLiBN+w ($14.65 in chips) 
Seat 3: UXRtG8J9PoBZWTsNtqdoDA ($21 in chips) 
Seat 4: v+QfkGiuj9bgtuNoVnDO8w ($29.35 in chips) 
Seat 5: pV5UZbjsgam+HUQEd6G++w ($7.90 in chips) 
Seat 6: t2RfOOoa56xW0ZHJC0+5JQ ($8.70 in chips) 
OZc6kkoTwtITj1ZfreJK1A: posts small blind $0.10
qvQc9BHp2FhQjrltLiBN+w: posts big blind $0.25
*** HOLE CARDS ***
UXRtG8J9PoBZWTsNtqdoDA: folds 
v+QfkGiuj9bgtuNoVnDO8w: folds 
pV5UZbjsgam+HUQEd6G++w: folds 
t2RfOOoa56xW0ZHJC0+5JQ: folds 
OZc6kkoTwtITj1ZfreJK1A: raises $0.25 to $0.50
qvQc9BHp2FhQjrltLiBN+w: calls $0.25
*** FLOP *** [2d Qs 8h]
OZc6kkoTwtITj1ZfreJK1A: checks 
qvQc9BHp2FhQjrltLiBN+w: bets $0.50
OZc6kkoTwtITj1ZfreJK1A: calls $0.50
*** TURN *** [2d Qs 8h] [9s]
OZc6kkoTwtITj1ZfreJK1A: bets $2.25
qvQc9BHp2FhQjrltLiBN+w: calls $2.25
*** RIVER *** [2d Qs 8h 9s] [Ad]
OZc6kkoTwtITj1ZfreJK1A: checks 
qvQc9BHp2FhQjrltLiBN+w: checks 
*** SHOW DOWN ***
OZc6kkoTwtITj1ZfreJK1A: shows [Qh Js] (a pair of Queens)
qvQc9BHp2FhQjrltLiBN+w: mucks hand 
OZc6kkoTwtITj1ZfreJK1A collected $6.20 from pot
*** SUMMARY ***
Total pot $6.50 | Rake $0.30 
Board [2d Qs 8h 9s Ad]
Seat 1: OZc6kkoTwtITj1ZfreJK1A (small blind) showed [Qh Js] and won ($6.20) with a pair of Queens
Seat 2: qvQc9BHp2FhQjrltLiBN+w (big blind) mucked
Seat 3: UXRtG8J9PoBZWTsNtqdoDA folded before Flop (didn't bet)
Seat 4: v+QfkGiuj9bgtuNoVnDO8w folded before Flop (didn't bet)
Seat 5: pV5UZbjsgam+HUQEd6G++w folded before Flop (didn't bet)
Seat 6: t2RfOOoa56xW0ZHJC0+5JQ (button) folded before Flop (didn't bet)




PokerStars Game #59939485582:  Hold'em No Limit ($0.10/$0.25) - 2009/07/01 0:41:06 ET
Table '0XPo7K54oZIfG0xlNAcDRwnQC9LRg01NEuKFHF1nrDEw-max Seat #6 is the button
Seat 1: Nj6/PdBvfG79w0yeIjPmmA ($14.30 in chips) 
Seat 2: cPO/1/dTcZpLkQFm3jH3Rg ($32.05 in chips) 
Seat 4: tLM9aw7T3kBEIhQEh1roOg ($6.80 in chips) 
Seat 5: kG34n23qFQA3nzdOJTQ1dA ($29 in chips) 
Seat 6: xQVFeVUDopz+akuEo2wXpQ ($46.25 in chips) 
Nj6/PdBvfG79w0yeIjPmmA: posts small blind $0.10
cPO/1/dTcZpLkQFm3jH3Rg: posts big blind $0.25
*** HOLE CARDS ***
tLM9aw7T3kBEIhQEh1roOg: folds 
kG34n23qFQA3nzdOJTQ1dA: folds 
xQVFeVUDopz+akuEo2wXpQ: folds 
Nj6/PdBvfG79w0yeIjPmmA: calls $0.15
cPO/1/dTcZpLkQFm3jH3Rg: checks 
*** FLOP *** [Kh Ah 6s]
Nj6/PdBvfG79w0yeIjPmmA: checks 
cPO/1/dTcZpLkQFm3jH3Rg: bets $0.50
Nj6/PdBvfG79w0yeIjPmmA: folds 
Uncalled bet ($0.50) returned to cPO/1/dTcZpLkQFm3jH3Rg
cPO/1/dTcZpLkQFm3jH3Rg collected $0.50 from pot
*** SUMMARY ***
Total pot $0.50 | Rake $0 
Board [Kh Ah 6s]
Seat 1: Nj6/PdBvfG79w0yeIjPmmA (small blind) folded on the Flop
Seat 2: cPO/1/dTcZpLkQFm3jH3Rg (big blind) collected ($0.50)
Seat 4: tLM9aw7T3kBEIhQEh1roOg folded before Flop (didn't bet)
Seat 5: kG34n23qFQA3nzdOJTQ1dA folded before Flop (didn't bet)
Seat 6: xQVFeVUDopz+akuEo2wXpQ (button) folded before Flop (didn't bet)




PokerStars Game #59939485436:  Hold'em No Limit ($0.10/$0.25) - 2009/07/01 0:41:06 ET
Table 'HbNAGS1OJWQKyfk7UfrYyw' 9-max Seat #5 is the button
Seat 1: YHeeiaUNFin/MUYZJuW1VA ($10.65 in chips) 
Seat 2: Jt0gcXubHx3//kZT9X5jGQ ($28.05 in chips) 
Seat 3: DIBbjEYGs+TVdVgEB/4+3w ($30.20 in chips) 
Seat 5: cu58S48zQeRuppc18okJLA ($12.80 in chips) 
Seat 6: W4TLQcZ2TiM73eIgpIvlGg ($26.45 in chips) 
Seat 7: JJH2Xc95hFewheF67vSv4Q ($15 in chips) 
Seat 9: 8IJfEa/AAO04NtzGHO9CFQ ($15 in chips) 
W4TLQcZ2TiM73eIgpIvlGg: posts small blind $0.10
JJH2Xc95hFewheF67vSv4Q: posts big blind $0.25
*** HOLE CARDS ***
8IJfEa/AAO04NtzGHO9CFQ: folds 
YHeeiaUNFin/MUYZJuW1VA: folds 
Jt0gcXubHx3//kZT9X5jGQ: folds 
8IJfEa/AAO04NtzGHO9CFQ leaves the table
fsTS8sDyZ7BxKQFEMv9xCg joins the table at seat #8 
DIBbjEYGs+TVdVgEB/4+3w: folds 
cu58S48zQeRuppc18okJLA: raises $0.50 to $0.75
W4TLQcZ2TiM73eIgpIvlGg: folds 
JJH2Xc95hFewheF67vSv4Q: calls $0.50
*** FLOP *** [Jc 8d Th]
JJH2Xc95hFewheF67vSv4Q: checks 
cu58S48zQeRuppc18okJLA: checks 
*** TURN *** [Jc 8d Th] [5c]
JJH2Xc95hFewheF67vSv4Q: bets $0.75
cu58S48zQeRuppc18okJLA: calls $0.75
*** RIVER *** [Jc 8d Th 5c] [Qd]
JJH2Xc95hFewheF67vSv4Q: checks 
cu58S48zQeRuppc18okJLA: bets $2
JJH2Xc95hFewheF67vSv4Q: calls $2
*** SHOW DOWN ***
cu58S48zQeRuppc18okJLA: shows [Kc 9c] (a straight, Nine to King)
JJH2Xc95hFewheF67vSv4Q: mucks hand 
cu58S48zQeRuppc18okJLA collected $6.80 from pot
*** SUMMARY ***
Total pot $7.10 | Rake $0.30 
Board [Jc 8d Th 5c Qd]
Seat 1: YHeeiaUNFin/MUYZJuW1VA folded before Flop (didn't bet)
Seat 2: Jt0gcXubHx3//kZT9X5jGQ folded before Flop (didn't bet)
Seat 3: DIBbjEYGs+TVdVgEB/4+3w folded before Flop (didn't bet)
Seat 5: cu58S48zQeRuppc18okJLA (button) showed [Kc 9c] and won ($6.80) with a straight, Nine to King
Seat 6: W4TLQcZ2TiM73eIgpIvlGg (small blind) folded before Flop
Seat 7: JJH2Xc95hFewheF67vSv4Q (big blind) mucked
Seat 9: 8IJfEa/AAO04NtzGHO9CFQ folded before Flop (didn't bet)




PokerStars Game #59939485616:  Hold'em No Limit ($0.10/$0.25) - 2009/07/01 0:41:06 ET
Table 'G+4ZdyRoPjgaJY/jxSlZzQ' 9-max Seat #9 is the button
Seat 1: 0Ui5PFTLvpoTRdxcc8BNSQ ($35.30 in chips) 
Seat 2: 4awUyiDYTgylQKXZ9faBVA ($36.05 in chips) 
Seat 3: opOCI2p6kW0tINuVaAqmcQ ($27.70 in chips) 
Seat 4: yindad6WXRlkjbK12URYkA ($10.80 in chips) 
Seat 5: s7Q6uNouhe7aE8JdFb9E+A ($26.25 in chips) 
Seat 6: gehe91e0IyVT0QU/XBkEyg ($25 in chips) 
Seat 9: AzTBzPGlrIHrrs1Q8oKcGA ($17.20 in chips) 
0Ui5PFTLvpoTRdxcc8BNSQ: posts small blind $0.10
4awUyiDYTgylQKXZ9faBVA: posts big blind $0.25
*** HOLE CARDS ***
Archi91 joins the table at seat #8 
opOCI2p6kW0tINuVaAqmcQ: folds 
yindad6WXRlkjbK12URYkA: calls $0.25
s7Q6uNouhe7aE8JdFb9E+A: folds 
gehe91e0IyVT0QU/XBkEyg: raises $1 to $1.25
AzTBzPGlrIHrrs1Q8oKcGA: folds 
0Ui5PFTLvpoTRdxcc8BNSQ: calls $1.15
4awUyiDYTgylQKXZ9faBVA: calls $1
yindad6WXRlkjbK12URYkA: folds 
*** FLOP *** [Qc Th Jd]
0Ui5PFTLvpoTRdxcc8BNSQ: checks 
4awUyiDYTgylQKXZ9faBVA: checks 
gehe91e0IyVT0QU/XBkEyg: checks 
*** TURN *** [Qc Th Jd] [Kh]
0Ui5PFTLvpoTRdxcc8BNSQ: checks 
4awUyiDYTgylQKXZ9faBVA: checks 
gehe91e0IyVT0QU/XBkEyg: bets $4
0Ui5PFTLvpoTRdxcc8BNSQ: folds 
4awUyiDYTgylQKXZ9faBVA: folds 
Uncalled bet ($4) returned to gehe91e0IyVT0QU/XBkEyg
gehe91e0IyVT0QU/XBkEyg collected $3.80 from pot
*** SUMMARY ***
Total pot $4 | Rake $0.20 
Board [Qc Th Jd Kh]
Seat 1: 0Ui5PFTLvpoTRdxcc8BNSQ (small blind) folded on the Turn
Seat 2: 4awUyiDYTgylQKXZ9faBVA (big blind) folded on the Turn
Seat 3: opOCI2p6kW0tINuVaAqmcQ folded before Flop (didn't bet)
Seat 4: yindad6WXRlkjbK12URYkA folded before Flop
Seat 5: s7Q6uNouhe7aE8JdFb9E+A folded before Flop (didn't bet)
Seat 6: gehe91e0IyVT0QU/XBkEyg collected ($3.80)
Seat 9: AzTBzPGlrIHrrs1Q8oKcGA (button) folded before Flop (didn't bet)




PokerStars Game #59939486188:  Hold'em No Limit ($0.10/$0.25) - 2009/07/01 0:41:07 ET
Table '5510FxlYzKi+U6MIpo8IPA' 6-max Seat #5 is the button
Seat 1: KM6ogk7SqyRlk3m9b0h+7A ($18.15 in chips) 
Seat 3: v+QfkGiuj9bgtuNoVnDO8w ($29.45 in chips) 
Seat 4: cPO/1/dTcZpLkQFm3jH3Rg ($27.55 in chips) 
Seat 5: 5E1iMY5xyboow7Xm0v7Idw ($13.60 in chips) 
Seat 6: SFmT9ZsVopnukjvAzrxTRg ($28.85 in chips) 
SFmT9ZsVopnukjvAzrxTRg: posts small blind $0.10
KM6ogk7SqyRlk3m9b0h+7A: posts big blind $0.25
*** HOLE CARDS ***
v+QfkGiuj9bgtuNoVnDO8w: folds 
cPO/1/dTcZpLkQFm3jH3Rg: folds 
gqW2aBCmrIw65BvwjTFN6Q joins the table at seat #2 
5E1iMY5xyboow7Xm0v7Idw: folds 
SFmT9ZsVopnukjvAzrxTRg: folds 
Uncalled bet ($0.15) returned to KM6ogk7SqyRlk3m9b0h+7A
KM6ogk7SqyRlk3m9b0h+7A collected $0.20 from pot
*** SUMMARY ***
Total pot $0.20 | Rake $0 
Seat 1: KM6ogk7SqyRlk3m9b0h+7A (big blind) collected ($0.20)
Seat 3: v+QfkGiuj9bgtuNoVnDO8w folded before Flop (didn't bet)
Seat 4: cPO/1/dTcZpLkQFm3jH3Rg folded before Flop (didn't bet)
Seat 5: 5E1iMY5xyboow7Xm0v7Idw (button) folded before Flop (didn't bet)
Seat 6: SFmT9ZsVopnukjvAzrxTRg (small blind) folded before Flop




PokerStars Game #59939486104:  Hold'em No Limit ($0.10/$0.25) - 2009/07/01 0:41:07 ET
Table 'IdXp6nyeW4FYaEK4qKCnwQ' 9-max Seat #1 is the button
Seat 1: oZXtkl8jsN0rrT7D/pQTHA ($12.85 in chips) 
Seat 2: HPEB+AtKw1+C/cxU0o1ciw ($28.65 in chips) 
Seat 3: jiyia7h6fmxBdWBkH9lH5A ($3.70 in chips) 
Seat 6: 1K6QGyJP9P9xmRac2fH4OQ ($33.10 in chips) 
Seat 7: CYkY0dNBaYaKs8HVCVn3mQ ($9.60 in chips) 
Seat 8: cZ99hugmLBj9KhTlc8nCSw ($25 in chips) 
HPEB+AtKw1+C/cxU0o1ciw: posts small blind $0.10
jiyia7h6fmxBdWBkH9lH5A: posts big blind $0.25
*** HOLE CARDS ***
1K6QGyJP9P9xmRac2fH4OQ: raises $0.75 to $1
CYkY0dNBaYaKs8HVCVn3mQ: folds 
cZ99hugmLBj9KhTlc8nCSw: folds 
oZXtkl8jsN0rrT7D/pQTHA: folds 
oZXtkl8jsN0rrT7D/pQTHA leaves the table
HPEB+AtKw1+C/cxU0o1ciw: folds 
jiyia7h6fmxBdWBkH9lH5A: folds 
Uncalled bet ($0.75) returned to 1K6QGyJP9P9xmRac2fH4OQ
1K6QGyJP9P9xmRac2fH4OQ collected $0.60 from pot
1K6QGyJP9P9xmRac2fH4OQ: doesn't show hand 
U41wNf6XauAiBOQaKu2ZIA joins the table at seat #5 
*** SUMMARY ***
Total pot $0.60 | Rake $0 
Seat 1: oZXtkl8jsN0rrT7D/pQTHA (button) folded before Flop (didn't bet)
Seat 2: HPEB+AtKw1+C/cxU0o1ciw (small blind) folded before Flop
Seat 3: jiyia7h6fmxBdWBkH9lH5A (big blind) folded before Flop
Seat 6: 1K6QGyJP9P9xmRac2fH4OQ collected ($0.60)
Seat 7: CYkY0dNBaYaKs8HVCVn3mQ folded before Flop (didn't bet)
Seat 8: cZ99hugmLBj9KhTlc8nCSw folded before Flop (didn't bet)




PokerStars Game #59939486564:  Hold'em No Limit ($0.10/$0.25) - 2009/07/01 0:41:07 ET
Table 'IfRHUn9gQQA9I/Z4tn+BoA' 9-max Seat #5 is the button
Seat 1: vSkQm2EelzwRGDDQQk0Fqw ($4.65 in chips) 
Seat 2: zgWbKMp0/btzsnVbQWKXww ($16.30 in chips) 
Seat 3: iAQDnrJCZVD1LzAGxTYegw ($25.25 in chips) 
Seat 4: QEbIGci+itdw+re8RM5fZA ($25 in chips) 
Seat 5: 10584482 ($17.25 in chips) 
Seat 6: UOjoGGQ58/uDS7V0xkjOrQ ($6.80 in chips) 
Seat 7: TeWJxSETzbXGiYKx0y+dtg ($25.85 in chips) 
Seat 8: cZ99hugmLBj9KhTlc8nCSw ($25 in chips) 
UOjoGGQ58/uDS7V0xkjOrQ: posts small blind $0.10
TeWJxSETzbXGiYKx0y+dtg: posts big blind $0.25
7cv+9Zc9HIQHNvYsMfV3uA: sits out 
*** HOLE CARDS ***
cZ99hugmLBj9KhTlc8nCSw: folds 
vSkQm2EelzwRGDDQQk0Fqw: folds 
zgWbKMp0/btzsnVbQWKXww: calls $0.25
iAQDnrJCZVD1LzAGxTYegw: folds 
QEbIGci+itdw+re8RM5fZA: folds 
10584482: folds 
UOjoGGQ58/uDS7V0xkjOrQ: calls $0.15
TeWJxSETzbXGiYKx0y+dtg: raises $1 to $1.25
zgWbKMp0/btzsnVbQWKXww: calls $1
UOjoGGQ58/uDS7V0xkjOrQ: folds 
*** FLOP *** [8d Ac Ah]
TeWJxSETzbXGiYKx0y+dtg: checks 
zgWbKMp0/btzsnVbQWKXww: bets $1
TeWJxSETzbXGiYKx0y+dtg: raises $1.50 to $2.50
zgWbKMp0/btzsnVbQWKXww: raises $1.50 to $4
TeWJxSETzbXGiYKx0y+dtg: calls $1.50
*** TURN *** [8d Ac Ah] [Ad]
TeWJxSETzbXGiYKx0y+dtg: checks 
zgWbKMp0/btzsnVbQWKXww: checks 
*** RIVER *** [8d Ac Ah Ad] [6h]
TeWJxSETzbXGiYKx0y+dtg: bets $5.50
zgWbKMp0/btzsnVbQWKXww: calls $5.50
*** SHOW DOWN ***
TeWJxSETzbXGiYKx0y+dtg: shows [Jh Jc] (a full house, Aces full of Jacks)
zgWbKMp0/btzsnVbQWKXww: mucks hand 
TeWJxSETzbXGiYKx0y+dtg collected $20.70 from pot
*** SUMMARY ***
Total pot $21.75 | Rake $1.05 
Board [8d Ac Ah Ad 6h]
Seat 1: vSkQm2EelzwRGDDQQk0Fqw folded before Flop (didn't bet)
Seat 2: zgWbKMp0/btzsnVbQWKXww mucked
Seat 3: iAQDnrJCZVD1LzAGxTYegw folded before Flop (didn't bet)
Seat 4: QEbIGci+itdw+re8RM5fZA folded before Flop (didn't bet)
Seat 5: 10584482 (button) folded before Flop (didn't bet)
Seat 6: UOjoGGQ58/uDS7V0xkjOrQ (small blind) folded before Flop
Seat 7: TeWJxSETzbXGiYKx0y+dtg (big blind) showed [Jh Jc] and won ($20.70) with a full house, Aces full of Jacks
Seat 8: cZ99hugmLBj9KhTlc8nCSw folded before Flop (didn't bet)




PokerStars Game #59939486198:  Hold'em No Limit ($0.10/$0.25) - 2009/07/01 0:41:07 ET
Table 'biAgO3TKQBU8XcrVAoU5TA' 6-max Seat #4 is the button
Seat 2: 7qRk4YH4/k/08LgJSv7rBQ ($25.45 in chips) 
Seat 3: 7AHdX4G8gYtDJyNY+wK+6Q ($32.15 in chips) 
Seat 4: 2/AObG8G5tKFCPZ+CdivJQ ($8.95 in chips) 
Seat 6: //i5P+6lSkIyZsqb+ojVQA ($14.25 in chips) 
//i5P+6lSkIyZsqb+ojVQA: posts small blind $0.10
7qRk4YH4/k/08LgJSv7rBQ: posts big blind $0.25
*** HOLE CARDS ***
7AHdX4G8gYtDJyNY+wK+6Q: folds 
2/AObG8G5tKFCPZ+CdivJQ: folds 
//i5P+6lSkIyZsqb+ojVQA: raises $0.25 to $0.50
7qRk4YH4/k/08LgJSv7rBQ: calls $0.25
*** FLOP *** [Js 4s 4c]
//i5P+6lSkIyZsqb+ojVQA: checks 
7qRk4YH4/k/08LgJSv7rBQ: checks 
*** TURN *** [Js 4s 4c] [Kh]
//i5P+6lSkIyZsqb+ojVQA: bets $0.50
7qRk4YH4/k/08LgJSv7rBQ: folds 
Uncalled bet ($0.50) returned to //i5P+6lSkIyZsqb+ojVQA
//i5P+6lSkIyZsqb+ojVQA collected $0.95 from pot
//i5P+6lSkIyZsqb+ojVQA: doesn't show hand 
*** SUMMARY ***
Total pot $1 | Rake $0.05 
Board [Js 4s 4c Kh]
Seat 2: 7qRk4YH4/k/08LgJSv7rBQ (big blind) folded on the Turn
Seat 3: 7AHdX4G8gYtDJyNY+wK+6Q folded before Flop (didn't bet)
Seat 4: 2/AObG8G5tKFCPZ+CdivJQ (button) folded before Flop (didn't bet)
Seat 6: //i5P+6lSkIyZsqb+ojVQA (small blind) collected ($0.95)




PokerStars Game #59939486502:  Hold'em No Limit ($0.10/$0.25) - 2009/07/01 0:41:07 ET
Table 'mdub7rJf3Z5tCT9s/+1+Wg' 9-max Seat #8 is the button
Seat 1: neWdS67T0XWLJXFjrqXj5g ($20.55 in chips) 
Seat 2: vSkQm2EelzwRGDDQQk0Fqw ($4.65 in chips) 
Seat 3: t2nb95S5EEFOEzNx9Itz0g ($5 in chips) 
Seat 4: fDGyaQz0cs2s4FOYxkbIHA ($5 in chips) 
Seat 5: dfNim92Z6XK1/h5SFW5vDg ($25 in chips) 
Seat 6: hAFbY0iBwr4mouozgvjZBg ($47.60 in chips) 
Seat 7: woe+9KKk+L3pZgMTuHcmog ($31.70 in chips) 
Seat 8: cZ99hugmLBj9KhTlc8nCSw ($25 in chips) 
Seat 9: tYsOBqdU1+x+yFI7zHO7hQ ($36.50 in chips) 
tYsOBqdU1+x+yFI7zHO7hQ: posts small blind $0.10
neWdS67T0XWLJXFjrqXj5g: posts big blind $0.25
*** HOLE CARDS ***
vSkQm2EelzwRGDDQQk0Fqw: folds 
t2nb95S5EEFOEzNx9Itz0g: folds 
fDGyaQz0cs2s4FOYxkbIHA: folds 
dfNim92Z6XK1/h5SFW5vDg: folds 
hAFbY0iBwr4mouozgvjZBg: raises $0.50 to $0.75
woe+9KKk+L3pZgMTuHcmog: folds 
cZ99hugmLBj9KhTlc8nCSw: folds 
tYsOBqdU1+x+yFI7zHO7hQ: folds 
neWdS67T0XWLJXFjrqXj5g: calls $0.50
*** FLOP *** [4c Ks 9h]
neWdS67T0XWLJXFjrqXj5g: checks 
hAFbY0iBwr4mouozgvjZBg: checks 
*** TURN *** [4c Ks 9h] [Kd]
neWdS67T0XWLJXFjrqXj5g: checks 
hAFbY0iBwr4mouozgvjZBg: checks 
*** RIVER *** [4c Ks 9h Kd] [3c]
neWdS67T0XWLJXFjrqXj5g: bets $0.75
hAFbY0iBwr4mouozgvjZBg: calls $0.75
*** SHOW DOWN ***
neWdS67T0XWLJXFjrqXj5g: shows [7d Tc] (a pair of Kings)
hAFbY0iBwr4mouozgvjZBg: shows [Ts Ac] (a pair of Kings - Ace kicker)
hAFbY0iBwr4mouozgvjZBg collected $2.95 from pot
*** SUMMARY ***
Total pot $3.10 | Rake $0.15 
Board [4c Ks 9h Kd 3c]
Seat 1: neWdS67T0XWLJXFjrqXj5g (big blind) showed [7d Tc] and lost with a pair of Kings
Seat 2: vSkQm2EelzwRGDDQQk0Fqw folded before Flop (didn't bet)
Seat 3: t2nb95S5EEFOEzNx9Itz0g folded before Flop (didn't bet)
Seat 4: fDGyaQz0cs2s4FOYxkbIHA folded before Flop (didn't bet)
Seat 5: dfNim92Z6XK1/h5SFW5vDg folded before Flop (didn't bet)
Seat 6: hAFbY0iBwr4mouozgvjZBg showed [Ts Ac] and won ($2.95) with a pair of Kings
Seat 7: woe+9KKk+L3pZgMTuHcmog folded before Flop (didn't bet)
Seat 8: cZ99hugmLBj9KhTlc8nCSw (button) folded before Flop (didn't bet)
Seat 9: tYsOBqdU1+x+yFI7zHO7hQ (small blind) folded before Flop




PokerStars Game #59939486808:  Hold'em No Limit ($0.10/$0.25) - 2009/07/01 0:41:08 ET
Table 'by7aHYEDnDd144EXOXa/jA' 9-max Seat #4 is the button
Seat 1: zU1DfKpyUFgAuyEO9JqLHg ($8.85 in chips) 
Seat 2: vSkQm2EelzwRGDDQQk0Fqw ($4.90 in chips) 
Seat 3: 1Clf3cPrqoy/YgvWdWK1Xw ($5.55 in chips) 
Seat 4: vZGoOTJLQLhkPj4I+LNGig ($47.05 in chips) 
Seat 5: yyG4svzOpC1A+sUP/scg6w ($6.75 in chips) 
Seat 6: DIBbjEYGs+TVdVgEB/4+3w ($23.25 in chips) 
Seat 7: tWA6Uowb3ysfJYO6d8AUqw ($11.20 in chips) 
Seat 8: s7Q6uNouhe7aE8JdFb9E+A ($25.60 in chips) 
yyG4svzOpC1A+sUP/scg6w: posts small blind $0.10
DIBbjEYGs+TVdVgEB/4+3w: posts big blind $0.25
*** HOLE CARDS ***
tWA6Uowb3ysfJYO6d8AUqw: folds 
s7Q6uNouhe7aE8JdFb9E+A: folds 
zU1DfKpyUFgAuyEO9JqLHg: folds 
tWA6Uowb3ysfJYO6d8AUqw leaves the table
vSkQm2EelzwRGDDQQk0Fqw: folds 
1Clf3cPrqoy/YgvWdWK1Xw: folds 
vZGoOTJLQLhkPj4I+LNGig: raises $0.75 to $1
yyG4svzOpC1A+sUP/scg6w: folds 
DIBbjEYGs+TVdVgEB/4+3w: folds 
Uncalled bet ($0.75) returned to vZGoOTJLQLhkPj4I+LNGig
vZGoOTJLQLhkPj4I+LNGig collected $0.60 from pot
vZGoOTJLQLhkPj4I+LNGig: doesn't show hand 
*** SUMMARY ***
Total pot $0.60 | Rake $0 
Seat 1: zU1DfKpyUFgAuyEO9JqLHg folded before Flop (didn't bet)
Seat 2: vSkQm2EelzwRGDDQQk0Fqw folded before Flop (didn't bet)
Seat 3: 1Clf3cPrqoy/YgvWdWK1Xw folded before Flop (didn't bet)
Seat 4: vZGoOTJLQLhkPj4I+LNGig (button) collected ($0.60)
Seat 5: yyG4svzOpC1A+sUP/scg6w (small blind) folded before Flop
Seat 6: DIBbjEYGs+TVdVgEB/4+3w (big blind) folded before Flop
Seat 7: tWA6Uowb3ysfJYO6d8AUqw folded before Flop (didn't bet)
Seat 8: s7Q6uNouhe7aE8JdFb9E+A folded before Flop (didn't bet)




PokerStars Game #59939487048:  Hold'em No Limit ($0.10/$0.25) - 2009/07/01 0:41:08 ET
Table 'eOXPe2c6mG7DOFKvMsZZfA' 6-max Seat #2 is the button
Seat 1: ShXPHWfjhfmAwLgDdm6bRQ ($7.65 in chips) 
Seat 2: ELW+DKizJhLK7k40PMkD2Q ($32.75 in chips) 
Seat 3: kReyZ6g6Fu3tQ0nyjDf9kA ($31.35 in chips) 
Seat 4: zHHLkD2sRljslKKeQv/ZQw ($42.40 in chips) 
Seat 5: NhUN/JpAprdJeamFBgJH1w ($25 in chips) 
Seat 6: wKFJ513ucluNNiMlkXcDOQ ($25 in chips) 
kReyZ6g6Fu3tQ0nyjDf9kA: posts small blind $0.10
zHHLkD2sRljslKKeQv/ZQw: posts big blind $0.25
*** HOLE CARDS ***
NhUN/JpAprdJeamFBgJH1w: folds 
wKFJ513ucluNNiMlkXcDOQ: raises $0.75 to $1
ShXPHWfjhfmAwLgDdm6bRQ: folds 
ELW+DKizJhLK7k40PMkD2Q: folds 
kReyZ6g6Fu3tQ0nyjDf9kA: folds 
zHHLkD2sRljslKKeQv/ZQw: folds 
Uncalled bet ($0.75) returned to wKFJ513ucluNNiMlkXcDOQ
wKFJ513ucluNNiMlkXcDOQ collected $0.60 from pot
wKFJ513ucluNNiMlkXcDOQ: doesn't show hand 
*** SUMMARY ***
Total pot $0.60 | Rake $0 
Seat 1: ShXPHWfjhfmAwLgDdm6bRQ folded before Flop (didn't bet)
Seat 2: ELW+DKizJhLK7k40PMkD2Q (button) folded before Flop (didn't bet)
Seat 3: kReyZ6g6Fu3tQ0nyjDf9kA (small blind) folded before Flop
Seat 4: zHHLkD2sRljslKKeQv/ZQw (big blind) folded before Flop
Seat 5: NhUN/JpAprdJeamFBgJH1w folded before Flop (didn't bet)
Seat 6: wKFJ513ucluNNiMlkXcDOQ collected ($0.60)




PokerStars Game #59939487166:  Hold'em No Limit ($0.10/$0.25) - 2009/07/01 0:41:08 ET
Table '+UzantPJ4smVdrh+4GTu1w' 6-max Seat #2 is the button
Seat 1: 3Bm6SLY1pwRvi98HLQUkvg ($2.40 in chips) 
Seat 2: tcbEu7VzyHQ+0lh+skbQhQ ($9.90 in chips) 
Seat 3: SS/yfeArhULzIcOPe8MdPg ($51.25 in chips) 
Seat 4: IGRfskE1v9H9Bn+fz8AgNQ ($25 in chips) 
Seat 5: cj4VBQya7HtVL2zCGd5jLQ ($16.90 in chips) 
Seat 6: BYxjLnV1/LL0aZcTbfAOvw ($48.05 in chips) 
SS/yfeArhULzIcOPe8MdPg: posts small blind $0.10
IGRfskE1v9H9Bn+fz8AgNQ: posts big blind $0.25
*** HOLE CARDS ***
cj4VBQya7HtVL2zCGd5jLQ: folds 
BYxjLnV1/LL0aZcTbfAOvw: folds 
3Bm6SLY1pwRvi98HLQUkvg: calls $0.25
tcbEu7VzyHQ+0lh+skbQhQ: calls $0.25
SS/yfeArhULzIcOPe8MdPg: calls $0.15
IGRfskE1v9H9Bn+fz8AgNQ: checks 
*** FLOP *** [8d 9h Td]
SS/yfeArhULzIcOPe8MdPg: checks 
IGRfskE1v9H9Bn+fz8AgNQ: bets $0.75
3Bm6SLY1pwRvi98HLQUkvg: calls $0.75
tcbEu7VzyHQ+0lh+skbQhQ: raises $0.75 to $1.50
SS/yfeArhULzIcOPe8MdPg: folds 
IGRfskE1v9H9Bn+fz8AgNQ: folds 
3Bm6SLY1pwRvi98HLQUkvg: raises $0.65 to $2.15 and is all-in
tcbEu7VzyHQ+0lh+skbQhQ: calls $0.65
*** TURN *** [8d 9h Td] [Qc]
*** RIVER *** [8d 9h Td Qc] [Qh]
*** SHOW DOWN ***
3Bm6SLY1pwRvi98HLQUkvg: shows [2d 5d] (a pair of Queens)
tcbEu7VzyHQ+0lh+skbQhQ: shows [Js 6s] (a straight, Eight to Queen)
tcbEu7VzyHQ+0lh+skbQhQ collected $5.75 from pot
*** SUMMARY ***
Total pot $6.05 | Rake $0.30 
Board [8d 9h Td Qc Qh]
Seat 1: 3Bm6SLY1pwRvi98HLQUkvg showed [2d 5d] and lost with a pair of Queens
Seat 2: tcbEu7VzyHQ+0lh+skbQhQ (button) showed [Js 6s] and won ($5.75) with a straight, Eight to Queen
Seat 3: SS/yfeArhULzIcOPe8MdPg (small blind) folded on the Flop
Seat 4: IGRfskE1v9H9Bn+fz8AgNQ (big blind) folded on the Flop
Seat 5: cj4VBQya7HtVL2zCGd5jLQ folded before Flop (didn't bet)
Seat 6: BYxjLnV1/LL0aZcTbfAOvw folded before Flop (didn't bet)




PokerStars Game #59939486810:  Hold'em No Limit ($0.10/$0.25) - 2009/07/01 0:41:08 ET
Table '84TjTrgbsYZladOc4PWf4Q' 6-max Seat #2 is the button
Seat 1: 79ID/ub1Pt/mDpCprVmOoA ($29.65 in chips) 
Seat 2: qGHGf/553gQnDoklMRe3tg ($31.90 in chips) 
Seat 4: SxIIgwXYLkwd6m3wLyPTCw ($25.10 in chips) 
Seat 5: SFmT9ZsVopnukjvAzrxTRg ($36.85 in chips) 
Seat 6: 7qRk4YH4/k/08LgJSv7rBQ ($25 in chips) 
SxIIgwXYLkwd6m3wLyPTCw: posts small blind $0.10
SFmT9ZsVopnukjvAzrxTRg: posts big blind $0.25
*** HOLE CARDS ***
7qRk4YH4/k/08LgJSv7rBQ: folds 
79ID/ub1Pt/mDpCprVmOoA: folds 
qGHGf/553gQnDoklMRe3tg: folds 
SxIIgwXYLkwd6m3wLyPTCw: folds 
Uncalled bet ($0.15) returned to SFmT9ZsVopnukjvAzrxTRg
SFmT9ZsVopnukjvAzrxTRg collected $0.20 from pot
SFmT9ZsVopnukjvAzrxTRg: doesn't show hand 
*** SUMMARY ***
Total pot $0.20 | Rake $0 
Seat 1: 79ID/ub1Pt/mDpCprVmOoA folded before Flop (didn't bet)
Seat 2: qGHGf/553gQnDoklMRe3tg (button) folded before Flop (didn't bet)
Seat 4: SxIIgwXYLkwd6m3wLyPTCw (small blind) folded before Flop
Seat 5: SFmT9ZsVopnukjvAzrxTRg (big blind) collected ($0.20)
Seat 6: 7qRk4YH4/k/08LgJSv7rBQ folded before Flop (didn't bet)




PokerStars Game #59939486988:  Hold'em No Limit ($0.10/$0.25) - 2009/07/01 0:41:08 ET
Table 'ZEXL6Wh4qA4Afx8NnoBBAA' 6-max Seat #4 is the button
Seat 1: qo39V8/pMxxofM2aciLSWQ ($95.10 in chips) 
Seat 4: fZQg9veL7Dd/Z04ZTjC+wQ ($31.90 in chips) 
Seat 6: 3rZnxe2K3O+xcVdF94i8lA ($16.05 in chips) 
3rZnxe2K3O+xcVdF94i8lA: posts small blind $0.10
qo39V8/pMxxofM2aciLSWQ: posts big blind $0.25
WrLI51S2iMb8GLMB83gGqA: sits out 
*** HOLE CARDS ***
fZQg9veL7Dd/Z04ZTjC+wQ: folds 
3rZnxe2K3O+xcVdF94i8lA: calls $0.15
qo39V8/pMxxofM2aciLSWQ: checks 
*** FLOP *** [8d As 7d]
3rZnxe2K3O+xcVdF94i8lA: checks 
qo39V8/pMxxofM2aciLSWQ: bets $0.50
3rZnxe2K3O+xcVdF94i8lA: folds 
Uncalled bet ($0.50) returned to qo39V8/pMxxofM2aciLSWQ
qo39V8/pMxxofM2aciLSWQ collected $0.50 from pot
*** SUMMARY ***
Total pot $0.50 | Rake $0 
Board [8d As 7d]
Seat 1: qo39V8/pMxxofM2aciLSWQ (big blind) collected ($0.50)
Seat 4: fZQg9veL7Dd/Z04ZTjC+wQ (button) folded before Flop (didn't bet)
Seat 6: 3rZnxe2K3O+xcVdF94i8lA (small blind) folded on the Flop




PokerStars Game #59939487088:  Hold'em No Limit ($0.10/$0.25) - 2009/07/01 0:41:08 ET
Table 'KEoOIegxPF91KooL2AelUA' 6-max Seat #1 is the button
Seat 1: wsP46AGpqDjHZQmlRHKa9g ($29.45 in chips) 
Seat 4: Vv37Oa9niKKVcR6Z7ceetw ($23.05 in chips) 
Seat 5: 2NLC44AHHKHEUooUQFYV+Q ($12.15 in chips) 
Vv37Oa9niKKVcR6Z7ceetw: posts small blind $0.10
2NLC44AHHKHEUooUQFYV+Q: posts big blind $0.25
Jq3YrbGb738j4tRTnp4PDA: sits out 
*** HOLE CARDS ***
wsP46AGpqDjHZQmlRHKa9g: raises $0.50 to $0.75
Vv37Oa9niKKVcR6Z7ceetw: folds 
2NLC44AHHKHEUooUQFYV+Q: folds 
Uncalled bet ($0.50) returned to wsP46AGpqDjHZQmlRHKa9g
wsP46AGpqDjHZQmlRHKa9g collected $0.60 from pot
*** SUMMARY ***
Total pot $0.60 | Rake $0 
Seat 1: wsP46AGpqDjHZQmlRHKa9g (button) collected ($0.60)
Seat 4: Vv37Oa9niKKVcR6Z7ceetw (small blind) folded before Flop
Seat 5: 2NLC44AHHKHEUooUQFYV+Q (big blind) folded before Flop




PokerStars Game #59939487504:  Hold'em No Limit ($0.10/$0.25) - 2009/07/01 0:41:09 ET
Table 'Loy/olZ5qoDOSvX4UTujGg' 6-max Seat #5 is the button
Seat 1: yzFNNFIfC89bBPwpFPx2ow ($28.85 in chips) 
Seat 3: 32YL2ZEp8NT4JB2RVM9euQ ($16 in chips) 
Seat 4: /gJNBeCkWL4o85/jvlZ4BA ($27.10 in chips) 
Seat 5: 4YSTu0Cdzpppe1lUgCZGCQ ($35.15 in chips) 
Seat 6: 7FmwVDcdEtxDpHmP4hOXsQ ($52.45 in chips) 
7FmwVDcdEtxDpHmP4hOXsQ: posts small blind $0.10
yzFNNFIfC89bBPwpFPx2ow: posts big blind $0.25
*** HOLE CARDS ***
32YL2ZEp8NT4JB2RVM9euQ: folds 
/gJNBeCkWL4o85/jvlZ4BA: folds 
4YSTu0Cdzpppe1lUgCZGCQ has timed out while being disconnected
4YSTu0Cdzpppe1lUgCZGCQ: folds 
4YSTu0Cdzpppe1lUgCZGCQ is sitting out
7FmwVDcdEtxDpHmP4hOXsQ: folds 
Uncalled bet ($0.15) returned to yzFNNFIfC89bBPwpFPx2ow
yzFNNFIfC89bBPwpFPx2ow collected $0.20 from pot
yzFNNFIfC89bBPwpFPx2ow: doesn't show hand 
*** SUMMARY ***
Total pot $0.20 | Rake $0 
Seat 1: yzFNNFIfC89bBPwpFPx2ow (big blind) collected ($0.20)
Seat 3: 32YL2ZEp8NT4JB2RVM9euQ folded before Flop (didn't bet)
Seat 4: /gJNBeCkWL4o85/jvlZ4BA folded before Flop (didn't bet)
Seat 5: 4YSTu0Cdzpppe1lUgCZGCQ (button) folded before Flop (didn't bet)
Seat 6: 7FmwVDcdEtxDpHmP4hOXsQ (small blind) folded before Flop




PokerStars Game #59939487330:  Hold'em No Limit ($0.10/$0.25) - 2009/07/01 0:41:09 ET
Table 'Mef6A0EMopL6WaFO5/KO9g' 6-max Seat #1 is the button
Seat 1: ELW+DKizJhLK7k40PMkD2Q ($25.75 in chips) 
Seat 2: 8ClCHtFXGNplITm+63KB+Q ($33.25 in chips) 
Seat 3: Wq26opBLDGJe91GRJn2epg ($19.80 in chips) 
Seat 4: pisIQ6Ztya1lC0kTtGSTHw ($58.05 in chips) 
Seat 5: WrLI51S2iMb8GLMB83gGqA ($29.20 in chips) 
8ClCHtFXGNplITm+63KB+Q: posts small blind $0.10
Wq26opBLDGJe91GRJn2epg: posts big blind $0.25
jp34e617tIzV8tKIWmfAbA: sits out 
*** HOLE CARDS ***
pisIQ6Ztya1lC0kTtGSTHw: calls $0.25
WrLI51S2iMb8GLMB83gGqA: raises $0.75 to $1
ELW+DKizJhLK7k40PMkD2Q: folds 
8ClCHtFXGNplITm+63KB+Q: calls $0.90
Wq26opBLDGJe91GRJn2epg: folds 
pisIQ6Ztya1lC0kTtGSTHw: calls $0.75
*** FLOP *** [Qd Tc Qs]
8ClCHtFXGNplITm+63KB+Q: checks 
pisIQ6Ztya1lC0kTtGSTHw: checks 
WrLI51S2iMb8GLMB83gGqA: checks 
*** TURN *** [Qd Tc Qs] [Jc]
8ClCHtFXGNplITm+63KB+Q: checks 
pisIQ6Ztya1lC0kTtGSTHw: bets $0.50
WrLI51S2iMb8GLMB83gGqA: calls $0.50
8ClCHtFXGNplITm+63KB+Q: folds 
*** RIVER *** [Qd Tc Qs Jc] [9c]
pisIQ6Ztya1lC0kTtGSTHw: bets $1
WrLI51S2iMb8GLMB83gGqA: raises $4 to $5
pisIQ6Ztya1lC0kTtGSTHw: calls $4
*** SHOW DOWN ***
WrLI51S2iMb8GLMB83gGqA: shows [Ac 6c] (a flush, Ace high)
pisIQ6Ztya1lC0kTtGSTHw: mucks hand 
pisIQ6Ztya1lC0kTtGSTHw is sitting out
WrLI51S2iMb8GLMB83gGqA collected $13.55 from pot
pisIQ6Ztya1lC0kTtGSTHw leaves the table
*** SUMMARY ***
Total pot $14.25 | Rake $0.70 
Board [Qd Tc Qs Jc 9c]
Seat 1: ELW+DKizJhLK7k40PMkD2Q (button) folded before Flop (didn't bet)
Seat 2: 8ClCHtFXGNplITm+63KB+Q (small blind) folded on the Turn
Seat 3: Wq26opBLDGJe91GRJn2epg (big blind) folded before Flop
Seat 4: pisIQ6Ztya1lC0kTtGSTHw mucked
Seat 5: WrLI51S2iMb8GLMB83gGqA showed [Ac 6c] and won ($13.55) with a flush, Ace high




PokerStars Game #59939487280:  Hold'em No Limit ($0.10/$0.25) - 2009/07/01 0:41:09 ET
Table 'gkdjhbH1jaE3hwhPRIKMiQ' 6-max Seat #1 is the button
Seat 1: nc79pm0LZRdhncq55evVqA ($25 in chips) 
Seat 2: 1NNFfYMd5Hsphl/FYz9fNA ($33.40 in chips) 
Seat 3: kG34n23qFQA3nzdOJTQ1dA ($25 in chips) 
Seat 4: 7uqewvdd5+KjmM7wl58k+w ($14.95 in chips) 
Seat 5: Ew/TYPQIsbQ2X8nm5iAJBg ($25.90 in chips) 
Seat 6: wqphQtauX5Qn7WRJZS1flA ($26.35 in chips) 
1NNFfYMd5Hsphl/FYz9fNA: posts small blind $0.10
kG34n23qFQA3nzdOJTQ1dA: posts big blind $0.25
*** HOLE CARDS ***
7uqewvdd5+KjmM7wl58k+w: folds 
Ew/TYPQIsbQ2X8nm5iAJBg: raises $0.75 to $1
wqphQtauX5Qn7WRJZS1flA: raises $2 to $3
7uqewvdd5+KjmM7wl58k+w is sitting out
nc79pm0LZRdhncq55evVqA: folds 
1NNFfYMd5Hsphl/FYz9fNA: folds 
kG34n23qFQA3nzdOJTQ1dA: folds 
Ew/TYPQIsbQ2X8nm5iAJBg: folds 
Uncalled bet ($2) returned to wqphQtauX5Qn7WRJZS1flA
wqphQtauX5Qn7WRJZS1flA collected $2.35 from pot
wqphQtauX5Qn7WRJZS1flA: doesn't show hand 
*** SUMMARY ***
Total pot $2.35 | Rake $0 
Seat 1: nc79pm0LZRdhncq55evVqA (button) folded before Flop (didn't bet)
Seat 2: 1NNFfYMd5Hsphl/FYz9fNA (small blind) folded before Flop
Seat 3: kG34n23qFQA3nzdOJTQ1dA (big blind) folded before Flop
Seat 4: 7uqewvdd5+KjmM7wl58k+w folded before Flop (didn't bet)
Seat 5: Ew/TYPQIsbQ2X8nm5iAJBg folded before Flop
Seat 6: wqphQtauX5Qn7WRJZS1flA collected ($2.35)




PokerStars Game #59939487382:  Hold'em No Limit ($0.10/$0.25) - 2009/07/01 0:41:09 ET
Table 'Pz8SfAzhP5nvWTsJRAxoDg' 6-max Seat #5 is the button
Seat 1: buyjetgNT1McXtdaP4zynA ($41.15 in chips) 
Seat 2: RYLaAIIwK9wxkPswt1yJYw ($23.05 in chips) 
Seat 3: mfrkWA3PTeYPkbO6hi98Aw ($30.50 in chips) 
Seat 4: 9U9Vy/656QCEfKznJWteag ($20 in chips) 
Seat 5: FYepjhAvF8ZdVCmqHIy+eQ ($29.95 in chips) 
Seat 6: FStoHe64SQWqAsjya9pDkQ ($25 in chips) 
FStoHe64SQWqAsjya9pDkQ: posts small blind $0.10
buyjetgNT1McXtdaP4zynA: posts big blind $0.25
*** HOLE CARDS ***
RYLaAIIwK9wxkPswt1yJYw: folds 
mfrkWA3PTeYPkbO6hi98Aw: raises $0.75 to $1
9U9Vy/656QCEfKznJWteag: raises $1 to $2
FYepjhAvF8ZdVCmqHIy+eQ: folds 
FStoHe64SQWqAsjya9pDkQ: folds 
buyjetgNT1McXtdaP4zynA: folds 
mfrkWA3PTeYPkbO6hi98Aw: calls $1
*** FLOP *** [6c 4d 6s]
mfrkWA3PTeYPkbO6hi98Aw: checks 
9U9Vy/656QCEfKznJWteag: bets $2.50
mfrkWA3PTeYPkbO6hi98Aw: raises $5 to $7.50
9U9Vy/656QCEfKznJWteag: folds 
Uncalled bet ($5) returned to mfrkWA3PTeYPkbO6hi98Aw
mfrkWA3PTeYPkbO6hi98Aw collected $8.90 from pot
mfrkWA3PTeYPkbO6hi98Aw: doesn't show hand 
*** SUMMARY ***
Total pot $9.35 | Rake $0.45 
Board [6c 4d 6s]
Seat 1: buyjetgNT1McXtdaP4zynA (big blind) folded before Flop
Seat 2: RYLaAIIwK9wxkPswt1yJYw folded before Flop (didn't bet)
Seat 3: mfrkWA3PTeYPkbO6hi98Aw collected ($8.90)
Seat 4: 9U9Vy/656QCEfKznJWteag folded on the Flop
Seat 5: FYepjhAvF8ZdVCmqHIy+eQ (button) folded before Flop (didn't bet)
Seat 6: FStoHe64SQWqAsjya9pDkQ (small blind) folded before Flop




PokerStars Game #59939487688:  Hold'em No Limit ($0.10/$0.25) - 2009/07/01 0:41:09 ET
Table 'xmJKTGBeWCwutccj3YfupQ' 6-max Seat #3 is the button
Seat 1: sVbkVl4OznxBCfi66UB9vw ($59.55 in chips) 
Seat 2: BedjMfrlRfPgSq7CXpPAmg ($49.95 in chips) 
Seat 3: FStoHe64SQWqAsjya9pDkQ ($25 in chips) 
Seat 4: uWjhTVMpuIroxXcmD3Okug ($41.65 in chips) 
Seat 5: oBUDUfeUyCbZBsjxHZgSiw ($18.05 in chips) 
Seat 6: lYjWCpfCxX2kgcHY3v4Yow ($26 in chips) 
uWjhTVMpuIroxXcmD3Okug: posts small blind $0.10
oBUDUfeUyCbZBsjxHZgSiw: posts big blind $0.25
*** HOLE CARDS ***
lYjWCpfCxX2kgcHY3v4Yow: folds 
sVbkVl4OznxBCfi66UB9vw: folds 
BedjMfrlRfPgSq7CXpPAmg: folds 
FStoHe64SQWqAsjya9pDkQ said, "I understand"
FStoHe64SQWqAsjya9pDkQ: folds 
uWjhTVMpuIroxXcmD3Okug: calls $0.15
oBUDUfeUyCbZBsjxHZgSiw: checks 
*** FLOP *** [Kc Td 3h]
uWjhTVMpuIroxXcmD3Okug: bets $0.25
oBUDUfeUyCbZBsjxHZgSiw: folds 
Uncalled bet ($0.25) returned to uWjhTVMpuIroxXcmD3Okug
uWjhTVMpuIroxXcmD3Okug collected $0.50 from pot
uWjhTVMpuIroxXcmD3Okug: doesn't show hand 
*** SUMMARY ***
Total pot $0.50 | Rake $0 
Board [Kc Td 3h]
Seat 1: sVbkVl4OznxBCfi66UB9vw folded before Flop (didn't bet)
Seat 2: BedjMfrlRfPgSq7CXpPAmg folded before Flop (didn't bet)
Seat 3: FStoHe64SQWqAsjya9pDkQ (button) folded before Flop (didn't bet)
Seat 4: uWjhTVMpuIroxXcmD3Okug (small blind) collected ($0.50)
Seat 5: oBUDUfeUyCbZBsjxHZgSiw (big blind) folded on the Flop
Seat 6: lYjWCpfCxX2kgcHY3v4Yow folded before Flop (didn't bet)




PokerStars Game #59939487514:  Hold'em No Limit ($0.10/$0.25) - 2009/07/01 0:41:09 ET
Table '0XPo7K54oZIfG0xlNAcDRw' 9-max Seat #7 is the button
Seat 1: opOCI2p6kW0tINuVaAqmcQ ($29.65 in chips) 
Seat 2: Jbrpc6KkvYcsiySJzLmFuA ($15.40 in chips) 
Seat 3: 6qsItdeWZoOL5be2e1RFng ($12.70 in chips) 
Seat 4: vOEICaqlJhPYytg64XnnkQ ($12.10 in chips) 
Seat 5: 8B/dhbQjIWe6ASCdgzktNQ ($40 in chips) 
Seat 6: 9gmYYQesalMrUjaF7nKfrQ ($9.95 in chips) 
Seat 7: tYsOBqdU1+x+yFI7zHO7hQ ($45.50 in chips) 
Seat 9: s7Q6uNouhe7aE8JdFb9E+A ($25.45 in chips) 
s7Q6uNouhe7aE8JdFb9E+A: posts small blind $0.10
opOCI2p6kW0tINuVaAqmcQ: posts big blind $0.25
*** HOLE CARDS ***
Jbrpc6KkvYcsiySJzLmFuA: folds 
6qsItdeWZoOL5be2e1RFng: calls $0.25
vOEICaqlJhPYytg64XnnkQ: raises $0.25 to $0.50
8B/dhbQjIWe6ASCdgzktNQ: folds 
9gmYYQesalMrUjaF7nKfrQ: folds 
tYsOBqdU1+x+yFI7zHO7hQ: folds 
OiV1PWZ3IkN29JlmCcnTwQ joins the table at seat #8 
s7Q6uNouhe7aE8JdFb9E+A: calls $0.40
opOCI2p6kW0tINuVaAqmcQ: folds 
6qsItdeWZoOL5be2e1RFng: calls $0.25
*** FLOP *** [8d Ks 4d]
s7Q6uNouhe7aE8JdFb9E+A: checks 
6qsItdeWZoOL5be2e1RFng: bets $0.50
vOEICaqlJhPYytg64XnnkQ: calls $0.50
s7Q6uNouhe7aE8JdFb9E+A: calls $0.50
*** TURN *** [8d Ks 4d] [2s]
s7Q6uNouhe7aE8JdFb9E+A: checks 
6qsItdeWZoOL5be2e1RFng: bets $1
vOEICaqlJhPYytg64XnnkQ: folds 
s7Q6uNouhe7aE8JdFb9E+A: calls $1
*** RIVER *** [8d Ks 4d 2s] [5d]
s7Q6uNouhe7aE8JdFb9E+A: checks 
6qsItdeWZoOL5be2e1RFng: checks 
*** SHOW DOWN ***
s7Q6uNouhe7aE8JdFb9E+A: shows [Tc Th] (a pair of Tens)
6qsItdeWZoOL5be2e1RFng: shows [7c Kh] (a pair of Kings)
6qsItdeWZoOL5be2e1RFng collected $5 from pot
*** SUMMARY ***
Total pot $5.25 | Rake $0.25 
Board [8d Ks 4d 2s 5d]
Seat 1: opOCI2p6kW0tINuVaAqmcQ (big blind) folded before Flop
Seat 2: Jbrpc6KkvYcsiySJzLmFuA folded before Flop (didn't bet)
Seat 3: 6qsItdeWZoOL5be2e1RFng showed [7c Kh] and won ($5) with a pair of Kings
Seat 4: vOEICaqlJhPYytg64XnnkQ folded on the Turn
Seat 5: 8B/dhbQjIWe6ASCdgzktNQ folded before Flop (didn't bet)
Seat 6: 9gmYYQesalMrUjaF7nKfrQ folded before Flop (didn't bet)
Seat 7: tYsOBqdU1+x+yFI7zHO7hQ (button) folded before Flop (didn't bet)
Seat 9: s7Q6uNouhe7aE8JdFb9E+A (small blind) showed [Tc Th] and lost with a pair of Tens




PokerStars Game #59939487244:  Hold'em No Limit ($0.10/$0.25) - 2009/07/01 0:41:09 ET
Table '1zj0+miaIL9cvwnT/50pOA' 9-max Seat #3 is the button
Seat 1: spidnpwmoJ1L6yeNW7D5UA ($26.10 in chips) 
Seat 2: HPEB+AtKw1+C/cxU0o1ciw ($28.45 in chips) 
Seat 3: CYkY0dNBaYaKs8HVCVn3mQ ($5.50 in chips) 
Seat 4: 6esz1u5YivjsX0UoeMBm3w ($22.25 in chips) 
Seat 6: ydoFOVgzvZv9ZhuWu9rXAw ($5 in chips) 
Seat 7: 6oWOdVz2WG2azNuOj9rMgg ($16.20 in chips) 
Seat 8: HOiu48bZMhEZSoJa8mjiMw ($32.55 in chips) 
Seat 9: OiV1PWZ3IkN29JlmCcnTwQ ($5.25 in chips) 
6esz1u5YivjsX0UoeMBm3w: posts small blind $0.10
JxpnpCmvRAcrEUy7mq1iAg: is sitting out 
ydoFOVgzvZv9ZhuWu9rXAw: posts big blind $0.25
*** HOLE CARDS ***
6oWOdVz2WG2azNuOj9rMgg: folds 
HOiu48bZMhEZSoJa8mjiMw: folds 
OiV1PWZ3IkN29JlmCcnTwQ: folds 
spidnpwmoJ1L6yeNW7D5UA: folds 
HPEB+AtKw1+C/cxU0o1ciw: folds 
CYkY0dNBaYaKs8HVCVn3mQ: folds 
6esz1u5YivjsX0UoeMBm3w: calls $0.15
ydoFOVgzvZv9ZhuWu9rXAw: checks 
*** FLOP *** [5h Qs 2c]
6esz1u5YivjsX0UoeMBm3w: checks 
ydoFOVgzvZv9ZhuWu9rXAw: checks 
*** TURN *** [5h Qs 2c] [3s]
6esz1u5YivjsX0UoeMBm3w: bets $0.50
ydoFOVgzvZv9ZhuWu9rXAw: folds 
Uncalled bet ($0.50) returned to 6esz1u5YivjsX0UoeMBm3w
6esz1u5YivjsX0UoeMBm3w collected $0.50 from pot
6esz1u5YivjsX0UoeMBm3w: doesn't show hand 
*** SUMMARY ***
Total pot $0.50 | Rake $0 
Board [5h Qs 2c 3s]
Seat 1: spidnpwmoJ1L6yeNW7D5UA folded before Flop (didn't bet)
Seat 2: HPEB+AtKw1+C/cxU0o1ciw folded before Flop (didn't bet)
Seat 3: CYkY0dNBaYaKs8HVCVn3mQ (button) folded before Flop (didn't bet)
Seat 4: 6esz1u5YivjsX0UoeMBm3w (small blind) collected ($0.50)
Seat 6: ydoFOVgzvZv9ZhuWu9rXAw (big blind) folded on the Turn
Seat 7: 6oWOdVz2WG2azNuOj9rMgg folded before Flop (didn't bet)
Seat 8: HOiu48bZMhEZSoJa8mjiMw folded before Flop (didn't bet)
Seat 9: OiV1PWZ3IkN29JlmCcnTwQ folded before Flop (didn't bet)




PokerStars Game #59939487356:  Hold'em No Limit ($0.10/$0.25) - 2009/07/01 0:41:09 ET
Table 'rtxA1Y01Nrq5VoyzTAuusQ' 9-max Seat #6 is the button
Seat 1: wfJUJWKI2zkvL7Vp7kqggA ($10 in chips) 
Seat 2: xtpoxBFB+5CWL2iFqk9Zlg ($38.15 in chips) 
Seat 3: K9fS1IUr5GpiJG7VkJ7IbA ($12.30 in chips) 
Seat 4: JxpnpCmvRAcrEUy7mq1iAg ($5 in chips) 
Seat 5: HG/hVrkvCiG0erBa6RyLZA ($13.40 in chips) 
Seat 6: qccGLncfUaN00Few5HsgYg ($23.30 in chips) 
Seat 7: N6fYvIzQLKaydFLKQGtMlQ ($22.80 in chips) 
Seat 8: EUSBQy2KGzT65/CXiIu59Q ($40.40 in chips) 
Seat 9: HPEB+AtKw1+C/cxU0o1ciw ($24.60 in chips) 
N6fYvIzQLKaydFLKQGtMlQ: posts small blind $0.10
EUSBQy2KGzT65/CXiIu59Q: posts big blind $0.25
*** HOLE CARDS ***
HPEB+AtKw1+C/cxU0o1ciw: folds 
wfJUJWKI2zkvL7Vp7kqggA: calls $0.25
xtpoxBFB+5CWL2iFqk9Zlg: calls $0.25
K9fS1IUr5GpiJG7VkJ7IbA: calls $0.25
JxpnpCmvRAcrEUy7mq1iAg: folds 
HG/hVrkvCiG0erBa6RyLZA: calls $0.25
qccGLncfUaN00Few5HsgYg: folds 
N6fYvIzQLKaydFLKQGtMlQ: calls $0.15
EUSBQy2KGzT65/CXiIu59Q: checks 
*** FLOP *** [3s 9h Qh]
N6fYvIzQLKaydFLKQGtMlQ: checks 
EUSBQy2KGzT65/CXiIu59Q: bets $1.25
wfJUJWKI2zkvL7Vp7kqggA: calls $1.25
xtpoxBFB+5CWL2iFqk9Zlg: calls $1.25
K9fS1IUr5GpiJG7VkJ7IbA: calls $1.25
HG/hVrkvCiG0erBa6RyLZA: folds 
N6fYvIzQLKaydFLKQGtMlQ: calls $1.25
*** TURN *** [3s 9h Qh] [Js]
N6fYvIzQLKaydFLKQGtMlQ: checks 
EUSBQy2KGzT65/CXiIu59Q: bets $2.75
wfJUJWKI2zkvL7Vp7kqggA: calls $2.75
xtpoxBFB+5CWL2iFqk9Zlg: folds 
K9fS1IUr5GpiJG7VkJ7IbA: raises $8.05 to $10.80 and is all-in
N6fYvIzQLKaydFLKQGtMlQ: folds 
EUSBQy2KGzT65/CXiIu59Q: calls $8.05
wfJUJWKI2zkvL7Vp7kqggA: calls $5.75 and is all-in
*** RIVER *** [3s 9h Qh Js] [As]
*** SHOW DOWN ***
EUSBQy2KGzT65/CXiIu59Q: shows [3h Th] (a pair of Threes)
K9fS1IUr5GpiJG7VkJ7IbA: shows [9c Qd] (two pair, Queens and Nines)
K9fS1IUr5GpiJG7VkJ7IbA collected $4.35 from side pot
wfJUJWKI2zkvL7Vp7kqggA: mucks hand 
K9fS1IUr5GpiJG7VkJ7IbA collected $31.65 from main pot
*** SUMMARY ***
Total pot $37.85 Main pot $31.65. Side pot $4.35. | Rake $1.85 
Board [3s 9h Qh Js As]
Seat 1: wfJUJWKI2zkvL7Vp7kqggA mucked
Seat 2: xtpoxBFB+5CWL2iFqk9Zlg folded on the Turn
Seat 3: K9fS1IUr5GpiJG7VkJ7IbA showed [9c Qd] and won ($36) with two pair, Queens and Nines
Seat 4: JxpnpCmvRAcrEUy7mq1iAg folded before Flop (didn't bet)
Seat 5: HG/hVrkvCiG0erBa6RyLZA folded on the Flop
Seat 6: qccGLncfUaN00Few5HsgYg (button) folded before Flop (didn't bet)
Seat 7: N6fYvIzQLKaydFLKQGtMlQ (small blind) folded on the Turn
Seat 8: EUSBQy2KGzT65/CXiIu59Q (big blind) showed [3h Th] and lost with a pair of Threes
Seat 9: HPEB+AtKw1+C/cxU0o1ciw folded before Flop (didn't bet)




PokerStars Game #59939487652:  Hold'em No Limit ($0.10/$0.25) - 2009/07/01 0:41:09 ET
Table 'n8mNkPYbe1AIQEkioNesZA' 9-max Seat #5 is the button
Seat 1: /VQLorsEOrMfI+KamzNQEA ($2.40 in chips) 
Seat 2: QEbIGci+itdw+re8RM5fZA ($35 in chips) 
Seat 3: zDrucyjVn5aeekNEc3cJrA ($19.70 in chips) 
Seat 4: ZeR3hkj1gVv9J4yPCmRrjA ($27.85 in chips) 
Seat 5: j5kXXioAn7mKbcDKt4UzMw ($13.90 in chips) 
Seat 6: HPEB+AtKw1+C/cxU0o1ciw ($41.40 in chips) 
Seat 7: BrlfhE2AlcawLAz+eF5BDg ($4.85 in chips) 
Seat 8: N6fYvIzQLKaydFLKQGtMlQ ($27.40 in chips) 
Seat 9: gehe91e0IyVT0QU/XBkEyg ($28.50 in chips) 
HPEB+AtKw1+C/cxU0o1ciw: posts small blind $0.10
BrlfhE2AlcawLAz+eF5BDg: posts big blind $0.25
*** HOLE CARDS ***
N6fYvIzQLKaydFLKQGtMlQ: folds 
gehe91e0IyVT0QU/XBkEyg: folds 
/VQLorsEOrMfI+KamzNQEA: folds 
QEbIGci+itdw+re8RM5fZA: folds 
zDrucyjVn5aeekNEc3cJrA: folds 
ZeR3hkj1gVv9J4yPCmRrjA: calls $0.25
j5kXXioAn7mKbcDKt4UzMw: folds 
HPEB+AtKw1+C/cxU0o1ciw: calls $0.15
BrlfhE2AlcawLAz+eF5BDg: checks 
*** FLOP *** [9d 8h 4d]
HPEB+AtKw1+C/cxU0o1ciw: checks 
BrlfhE2AlcawLAz+eF5BDg: bets $0.75
ZeR3hkj1gVv9J4yPCmRrjA: folds 
HPEB+AtKw1+C/cxU0o1ciw: folds 
Uncalled bet ($0.75) returned to BrlfhE2AlcawLAz+eF5BDg
BrlfhE2AlcawLAz+eF5BDg collected $0.75 from pot
BrlfhE2AlcawLAz+eF5BDg: doesn't show hand 
*** SUMMARY ***
Total pot $0.75 | Rake $0 
Board [9d 8h 4d]
Seat 1: /VQLorsEOrMfI+KamzNQEA folded before Flop (didn't bet)
Seat 2: QEbIGci+itdw+re8RM5fZA folded before Flop (didn't bet)
Seat 3: zDrucyjVn5aeekNEc3cJrA folded before Flop (didn't bet)
Seat 4: ZeR3hkj1gVv9J4yPCmRrjA folded on the Flop
Seat 5: j5kXXioAn7mKbcDKt4UzMw (button) folded before Flop (didn't bet)
Seat 6: HPEB+AtKw1+C/cxU0o1ciw (small blind) folded on the Flop
Seat 7: BrlfhE2AlcawLAz+eF5BDg (big blind) collected ($0.75)
Seat 8: N6fYvIzQLKaydFLKQGtMlQ folded before Flop (didn't bet)
Seat 9: gehe91e0IyVT0QU/XBkEyg folded before Flop (didn't bet)




PokerStars Game #59939487976:  Hold'em No Limit ($0.10/$0.25) - 2009/07/01 0:41:10 ET
Table 'dNYnr4D4id1jwnEU66Yowg' 9-max Seat #1 is the button
Seat 1: 41pZ+Uce9oq+8wmcVBXWIg ($17.35 in chips) 
Seat 5: k+2r6di6GXjNpAdrRkW9bA ($17.40 in chips) 
41pZ+Uce9oq+8wmcVBXWIg: posts small blind $0.10
t2nb95S5EEFOEzNx9Itz0g: is sitting out 
k+2r6di6GXjNpAdrRkW9bA: posts big blind $0.25
*** HOLE CARDS ***
41pZ+Uce9oq+8wmcVBXWIg: calls $0.15
d9fERE+24v0MqnylCrXchQ joins the table at seat #4 
t2nb95S5EEFOEzNx9Itz0g leaves the table
k+2r6di6GXjNpAdrRkW9bA: checks 
*** FLOP *** [3d Qs 9h]
k+2r6di6GXjNpAdrRkW9bA: bets $0.75
41pZ+Uce9oq+8wmcVBXWIg: calls $0.75
*** TURN *** [3d Qs 9h] [4c]
k+2r6di6GXjNpAdrRkW9bA: bets $0.50
41pZ+Uce9oq+8wmcVBXWIg: calls $0.50
*** RIVER *** [3d Qs 9h 4c] [Jc]
k+2r6di6GXjNpAdrRkW9bA: bets $1
41pZ+Uce9oq+8wmcVBXWIg: folds 
Uncalled bet ($1) returned to k+2r6di6GXjNpAdrRkW9bA
k+2r6di6GXjNpAdrRkW9bA collected $2.90 from pot
k+2r6di6GXjNpAdrRkW9bA: doesn't show hand 
*** SUMMARY ***
Total pot $3 | Rake $0.10 
Board [3d Qs 9h 4c Jc]
Seat 1: 41pZ+Uce9oq+8wmcVBXWIg (button) (small blind) folded on the River
Seat 5: k+2r6di6GXjNpAdrRkW9bA (big blind) collected ($2.90)




PokerStars Game #59939487982:  Hold'em No Limit ($0.10/$0.25) - 2009/07/01 0:41:10 ET
Table 'LwnjzXstPtSrqrV/oDpnXQ' 9-max Seat #4 is the button
Seat 1: sChhj/mp8dm+nGvBS5mOIA ($18.85 in chips) 
Seat 2: K7bAhhMMJ/XcTmGaBZVfFQ ($29.05 in chips) 
Seat 3: u+XLsbPQIcRvPRnS1bvZww ($11.35 in chips) 
Seat 4: nmvbguGv4wKulGg49bANbQ ($13.25 in chips) 
Seat 5: Th3FldXKQW6hWVVPahaoOQ ($29.25 in chips) 
Seat 6: ljemhp25Zg+nlA9DLCIiUw ($31.40 in chips) 
Seat 8: h4ggJZYBXV0mEZzYPYKfeA ($32.80 in chips) 
Seat 9: N6fYvIzQLKaydFLKQGtMlQ ($24.40 in chips) 
Th3FldXKQW6hWVVPahaoOQ: posts small blind $0.10
ljemhp25Zg+nlA9DLCIiUw: posts big blind $0.25
c/Dw/6HyqldTzIRodAIZmg: sits out 
*** HOLE CARDS ***
h4ggJZYBXV0mEZzYPYKfeA: folds 
N6fYvIzQLKaydFLKQGtMlQ: folds 
sChhj/mp8dm+nGvBS5mOIA: folds 
K7bAhhMMJ/XcTmGaBZVfFQ: raises $0.50 to $0.75
u+XLsbPQIcRvPRnS1bvZww: calls $0.75
nmvbguGv4wKulGg49bANbQ: folds 
Th3FldXKQW6hWVVPahaoOQ: folds 
ljemhp25Zg+nlA9DLCIiUw: folds 
*** FLOP *** [6c 3d 9c]
K7bAhhMMJ/XcTmGaBZVfFQ: checks 
u+XLsbPQIcRvPRnS1bvZww: bets $0.50
K7bAhhMMJ/XcTmGaBZVfFQ: folds 
Uncalled bet ($0.50) returned to u+XLsbPQIcRvPRnS1bvZww
u+XLsbPQIcRvPRnS1bvZww collected $1.80 from pot
u+XLsbPQIcRvPRnS1bvZww: doesn't show hand 
*** SUMMARY ***
Total pot $1.85 | Rake $0.05 
Board [6c 3d 9c]
Seat 1: sChhj/mp8dm+nGvBS5mOIA folded before Flop (didn't bet)
Seat 2: K7bAhhMMJ/XcTmGaBZVfFQ folded on the Flop
Seat 3: u+XLsbPQIcRvPRnS1bvZww collected ($1.80)
Seat 4: nmvbguGv4wKulGg49bANbQ (button) folded before Flop (didn't bet)
Seat 5: Th3FldXKQW6hWVVPahaoOQ (small blind) folded before Flop
Seat 6: ljemhp25Zg+nlA9DLCIiUw (big blind) folded before Flop
Seat 8: h4ggJZYBXV0mEZzYPYKfeA folded before Flop (didn't bet)
Seat 9: N6fYvIzQLKaydFLKQGtMlQ folded before Flop (didn't bet)




PokerStars Game #59939487848:  Hold'em No Limit ($0.10/$0.25) - 2009/07/01 0:41:10 ET
Table 'gkdjhbH1jaE3hwhPRIKMiQ3lL16FBjWXTx3AjK5lMRwwx Seat #3 is the button
Seat 1: fDGyaQz0cs2s4FOYxkbIHA ($8.40 in chips) 
Seat 2: YK2fIgjF+Z0ARwKKcGh1fw ($18.20 in chips) 
Seat 3: QEbIGci+itdw+re8RM5fZA ($25.90 in chips) 
Seat 5: M/9j4wkHH9i1JM51vgi1VA ($22.60 in chips) 
Seat 6: hBMUlEpyU74r/fwDgIpXjQ ($41.35 in chips) 
Seat 7: JxpnpCmvRAcrEUy7mq1iAg ($5.40 in chips) 
Seat 8: ljemhp25Zg+nlA9DLCIiUw ($23.30 in chips) 
Seat 9: b8t3jWrxzeEt9HtZtc9wUQ ($10.35 in chips) 
M/9j4wkHH9i1JM51vgi1VA: posts small blind $0.10
hBMUlEpyU74r/fwDgIpXjQ: posts big blind $0.25
*** HOLE CARDS ***
JxpnpCmvRAcrEUy7mq1iAg: folds 
ljemhp25Zg+nlA9DLCIiUw: folds 
b8t3jWrxzeEt9HtZtc9wUQ: folds 
fDGyaQz0cs2s4FOYxkbIHA: folds 
YK2fIgjF+Z0ARwKKcGh1fw: calls $0.25
QEbIGci+itdw+re8RM5fZA: folds 
M/9j4wkHH9i1JM51vgi1VA: folds 
hBMUlEpyU74r/fwDgIpXjQ: checks 
*** FLOP *** [3c 8c 9c]
hBMUlEpyU74r/fwDgIpXjQ: bets $0.50
YK2fIgjF+Z0ARwKKcGh1fw: folds 
Uncalled bet ($0.50) returned to hBMUlEpyU74r/fwDgIpXjQ
hBMUlEpyU74r/fwDgIpXjQ collected $0.60 from pot
hBMUlEpyU74r/fwDgIpXjQ: doesn't show hand 
*** SUMMARY ***
Total pot $0.60 | Rake $0 
Board [3c 8c 9c]
Seat 1: fDGyaQz0cs2s4FOYxkbIHA folded before Flop (didn't bet)
Seat 2: YK2fIgjF+Z0ARwKKcGh1fw folded on the Flop
Seat 3: QEbIGci+itdw+re8RM5fZA (button) folded before Flop (didn't bet)
Seat 5: M/9j4wkHH9i1JM51vgi1VA (small blind) folded before Flop
Seat 6: hBMUlEpyU74r/fwDgIpXjQ (big blind) collected ($0.60)
Seat 7: JxpnpCmvRAcrEUy7mq1iAg folded before Flop (didn't bet)
Seat 8: ljemhp25Zg+nlA9DLCIiUw folded before Flop (didn't bet)
Seat 9: b8t3jWrxzeEt9HtZtc9wUQ folded before Flop (didn't bet)




PokerStars Game #59939488314:  Hold'em No Limit ($0.10/$0.25) - 2009/07/01 0:41:10 ET
Table '+198VWQSWBhYQOcizzuBkw' 6-max Seat #4 is the button
Seat 2: R6AGToFJQOYVZAjC2jXEKw ($28.80 in chips) 
Seat 3: BYxjLnV1/LL0aZcTbfAOvw ($27.85 in chips) 
Seat 4: TgDsTeCdLQt8kWbL00ByRA ($27.25 in chips) 
Seat 5: LtASJ9OlkqGrrUKGQlpGAw ($30.05 in chips) 
Seat 6: 7qRk4YH4/k/08LgJSv7rBQ ($31.25 in chips) 
LtASJ9OlkqGrrUKGQlpGAw: posts small blind $0.10
7qRk4YH4/k/08LgJSv7rBQ: posts big blind $0.25
*** HOLE CARDS ***
R6AGToFJQOYVZAjC2jXEKw: folds 
BYxjLnV1/LL0aZcTbfAOvw: folds 
TgDsTeCdLQt8kWbL00ByRA: folds 
LtASJ9OlkqGrrUKGQlpGAw: folds 
Uncalled bet ($0.15) returned to 7qRk4YH4/k/08LgJSv7rBQ
7qRk4YH4/k/08LgJSv7rBQ collected $0.20 from pot
7qRk4YH4/k/08LgJSv7rBQ: doesn't show hand 
*** SUMMARY ***
Total pot $0.20 | Rake $0 
Seat 2: R6AGToFJQOYVZAjC2jXEKw folded before Flop (didn't bet)
Seat 3: BYxjLnV1/LL0aZcTbfAOvw folded before Flop (didn't bet)
Seat 4: TgDsTeCdLQt8kWbL00ByRA (button) folded before Flop (didn't bet)
Seat 5: LtASJ9OlkqGrrUKGQlpGAw (small blind) folded before Flop
Seat 6: 7qRk4YH4/k/08LgJSv7rBQ (big blind) collected ($0.20)




PokerStars Game #59939488194:  Hold'em No Limit ($0.10/$0.25) - 2009/07/01 0:41:10 ET
Table 'l57rayEpPtZotP9nqgSWBg' 6-max Seat #2 is the button
Seat 1: oseFhpinoe+Zg4j5xyBjyQ ($20.40 in chips) 
Seat 2: ErIN0JRL5srYjT6en1f8YQ ($24 in chips) 
Seat 3: sEQx9G5Cu8k1HNdQasxvUA ($39.90 in chips) 
Seat 4: NIALbunHAyYqmfMf7mrPhw ($6.30 in chips) 
Seat 5: TSmua8tGK3sTbwi0ynrW9Q ($59.40 in chips) 
sEQx9G5Cu8k1HNdQasxvUA: posts small blind $0.10
NIALbunHAyYqmfMf7mrPhw: posts big blind $0.25
IGRfskE1v9H9Bn+fz8AgNQ: sits out 
*** HOLE CARDS ***
TSmua8tGK3sTbwi0ynrW9Q: folds 
oseFhpinoe+Zg4j5xyBjyQ: folds 
ErIN0JRL5srYjT6en1f8YQ: raises $0.50 to $0.75
sEQx9G5Cu8k1HNdQasxvUA: folds 
NIALbunHAyYqmfMf7mrPhw: calls $0.50
*** FLOP *** [Ah 8s 7h]
NIALbunHAyYqmfMf7mrPhw: checks 
ErIN0JRL5srYjT6en1f8YQ: bets $1.25
NIALbunHAyYqmfMf7mrPhw: folds 
Uncalled bet ($1.25) returned to ErIN0JRL5srYjT6en1f8YQ
ErIN0JRL5srYjT6en1f8YQ collected $1.55 from pot
ErIN0JRL5srYjT6en1f8YQ: doesn't show hand 
*** SUMMARY ***
Total pot $1.60 | Rake $0.05 
Board [Ah 8s 7h]
Seat 1: oseFhpinoe+Zg4j5xyBjyQ folded before Flop (didn't bet)
Seat 2: ErIN0JRL5srYjT6en1f8YQ (button) collected ($1.55)
Seat 3: sEQx9G5Cu8k1HNdQasxvUA (small blind) folded before Flop
Seat 4: NIALbunHAyYqmfMf7mrPhw (big blind) folded on the Flop
Seat 5: TSmua8tGK3sTbwi0ynrW9Q folded before Flop (didn't bet)




PokerStars Game #59939488196:  Hold'em No Limit ($0.10/$0.25) - 2009/07/01 0:41:10 ET
Table 'MJ1SB76A4qJrlEa+C5e/8w' 6-max Seat #4 is the button
Seat 2: UA5OsKS3VPaxa7uC8La/kA ($28.90 in chips) 
Seat 3: IrrSNlaIjHnZjG6E7LgmEg ($15.15 in chips) 
Seat 4: 6boOPJDTFiEyZD2WdW0kCA ($14.15 in chips) 
Seat 5: eHsmIvAb2JREg4O6hNPnXg ($8 in chips) 
Seat 6: JFIAqU8lCZ0vWwEl4bdGsg ($27.75 in chips) 
eHsmIvAb2JREg4O6hNPnXg: posts small blind $0.10
JFIAqU8lCZ0vWwEl4bdGsg: posts big blind $0.25
*** HOLE CARDS ***
UA5OsKS3VPaxa7uC8La/kA: raises $0.75 to $1
IrrSNlaIjHnZjG6E7LgmEg: folds 
6boOPJDTFiEyZD2WdW0kCA: folds 
eHsmIvAb2JREg4O6hNPnXg: folds 
JFIAqU8lCZ0vWwEl4bdGsg: folds 
Uncalled bet ($0.75) returned to UA5OsKS3VPaxa7uC8La/kA
UA5OsKS3VPaxa7uC8La/kA collected $0.60 from pot
*** SUMMARY ***
Total pot $0.60 | Rake $0 
Seat 2: UA5OsKS3VPaxa7uC8La/kA collected ($0.60)
Seat 3: IrrSNlaIjHnZjG6E7LgmEg folded before Flop (didn't bet)
Seat 4: 6boOPJDTFiEyZD2WdW0kCA (button) folded before Flop (didn't bet)
Seat 5: eHsmIvAb2JREg4O6hNPnXg (small blind) folded before Flop
Seat 6: JFIAqU8lCZ0vWwEl4bdGsg (big blind) folded before Flop




PokerStars Game #59939488012:  Hold'em No Limit ($0.10/$0.25) - 2009/07/01 0:41:10 ET
Table 'luMgmRPIo47e7iXDlheIwA' 6-max Seat #4 is the button
Seat 3: W6Y6au0wf7gRAlqJYgOezw ($14.75 in chips) 
Seat 4: n2OZezRXTtdzQt4SuIy8TQ ($25.65 in chips) 
Seat 5: kG34n23qFQA3nzdOJTQ1dA ($46.65 in chips) 
kG34n23qFQA3nzdOJTQ1dA: posts small blind $0.10
4YSTu0Cdzpppe1lUgCZGCQ has timed out
4YSTu0Cdzpppe1lUgCZGCQ: is sitting out 
W6Y6au0wf7gRAlqJYgOezw: posts big blind $0.25
*** HOLE CARDS ***
n2OZezRXTtdzQt4SuIy8TQ: folds 
kG34n23qFQA3nzdOJTQ1dA: folds 
Uncalled bet ($0.15) returned to W6Y6au0wf7gRAlqJYgOezw
kG34n23qFQA3nzdOJTQ1dA is sitting out
W6Y6au0wf7gRAlqJYgOezw collected $0.20 from pot
*** SUMMARY ***
Total pot $0.20 | Rake $0 
Seat 3: W6Y6au0wf7gRAlqJYgOezw (big blind) collected ($0.20)
Seat 4: n2OZezRXTtdzQt4SuIy8TQ (button) folded before Flop (didn't bet)
Seat 5: kG34n23qFQA3nzdOJTQ1dA (small blind) folded before Flop




PokerStars Game #59939487946:  Hold'em No Limit ($0.10/$0.25) - 2009/07/01 0:41:10 ET
Table 'xkqAWQFDrFt4p81M8UsoNw' 9-max Seat #4 is the button
Seat 2: z5GxcHlYz/GSz6W2uFiTtg ($35.80 in chips) 
Seat 3: HEUqKs2EYYGGXJCepUdL0g ($7.25 in chips) 
Seat 4: gY+PO8PaVC7pBPH/9HSv6Q ($4.60 in chips) 
Seat 5: OiV1PWZ3IkN29JlmCcnTwQ ($5 in chips) 
Seat 6: Yv4fucyyT28mjx8V5lxKJg ($23.25 in chips) 
Seat 7: MG90wfSJZnOejs/KD3vlQQ ($48.40 in chips) 
Seat 9: Wa7bjLwN7ptOQro84PxQGw ($4.75 in chips) 
OiV1PWZ3IkN29JlmCcnTwQ: posts small blind $0.10
Yv4fucyyT28mjx8V5lxKJg: posts big blind $0.25
*** HOLE CARDS ***
MG90wfSJZnOejs/KD3vlQQ: folds 
Wa7bjLwN7ptOQro84PxQGw: folds 
N6fYvIzQLKaydFLKQGtMlQ joins the table at seat #1 
z5GxcHlYz/GSz6W2uFiTtg: raises $1 to $1.25
HEUqKs2EYYGGXJCepUdL0g: folds 
gY+PO8PaVC7pBPH/9HSv6Q: folds 
OiV1PWZ3IkN29JlmCcnTwQ: folds 
Yv4fucyyT28mjx8V5lxKJg: calls $1
*** FLOP *** [Kd Js Qh]
Yv4fucyyT28mjx8V5lxKJg: checks 
z5GxcHlYz/GSz6W2uFiTtg: bets $2.50
Yv4fucyyT28mjx8V5lxKJg: folds 
Uncalled bet ($2.50) returned to z5GxcHlYz/GSz6W2uFiTtg
z5GxcHlYz/GSz6W2uFiTtg collected $2.50 from pot
*** SUMMARY ***
Total pot $2.60 | Rake $0.10 
Board [Kd Js Qh]
Seat 2: z5GxcHlYz/GSz6W2uFiTtg collected ($2.50)
Seat 3: HEUqKs2EYYGGXJCepUdL0g folded before Flop (didn't bet)
Seat 4: gY+PO8PaVC7pBPH/9HSv6Q (button) folded before Flop (didn't bet)
Seat 5: OiV1PWZ3IkN29JlmCcnTwQ (small blind) folded before Flop
Seat 6: Yv4fucyyT28mjx8V5lxKJg (big blind) folded on the Flop
Seat 7: MG90wfSJZnOejs/KD3vlQQ folded before Flop (didn't bet)
Seat 9: Wa7bjLwN7ptOQro84PxQGw folded before Flop (didn't bet)




PokerStars Game #59939488794:  Hold'em No Limit ($0.10/$0.25) - 2009/07/01 0:41:11 ET
Table '9iHhO6FyZVM8XpSc23TIgg' 6-max Seat #5 is the button
Seat 1: NhUN/JpAprdJeamFBgJH1w ($25 in chips) 
Seat 2: ErIN0JRL5srYjT6en1f8YQ ($33.95 in chips) 
Seat 3: EXTSABh+qTpWWrIkxl3wXg ($43.65 in chips) 
Seat 4: cfJccEfyn6IkquPN08hFsA ($32.05 in chips) 
Seat 5: WmfI+HZXhME/HMG8E3/H2w ($15.30 in chips) 
Seat 6: 5z4PIVM9IyDWfUi+/MMdTA ($15.60 in chips) 
5z4PIVM9IyDWfUi+/MMdTA: posts small blind $0.10
NhUN/JpAprdJeamFBgJH1w: posts big blind $0.25
*** HOLE CARDS ***
ErIN0JRL5srYjT6en1f8YQ: raises $0.75 to $1
EXTSABh+qTpWWrIkxl3wXg: folds 
cfJccEfyn6IkquPN08hFsA: folds 
WmfI+HZXhME/HMG8E3/H2w: calls $1
5z4PIVM9IyDWfUi+/MMdTA: calls $0.90
NhUN/JpAprdJeamFBgJH1w: folds 
*** FLOP *** [6s Th Jh]
5z4PIVM9IyDWfUi+/MMdTA: checks 
ErIN0JRL5srYjT6en1f8YQ: checks 
WmfI+HZXhME/HMG8E3/H2w: bets $1.50
5z4PIVM9IyDWfUi+/MMdTA: calls $1.50
ErIN0JRL5srYjT6en1f8YQ: calls $1.50
*** TURN *** [6s Th Jh] [4s]
5z4PIVM9IyDWfUi+/MMdTA: checks 
ErIN0JRL5srYjT6en1f8YQ: checks 
WmfI+HZXhME/HMG8E3/H2w: bets $12.80 and is all-in
5z4PIVM9IyDWfUi+/MMdTA: calls $12.80
ErIN0JRL5srYjT6en1f8YQ: folds 
*** RIVER *** [6s Th Jh 4s] [9c]
*** SHOW DOWN ***
5z4PIVM9IyDWfUi+/MMdTA: shows [7h 6d] (a pair of Sixes)
WmfI+HZXhME/HMG8E3/H2w: shows [Ts Qh] (a pair of Tens)
WmfI+HZXhME/HMG8E3/H2w collected $31.70 from pot
*** SUMMARY ***
Total pot $33.35 | Rake $1.65 
Board [6s Th Jh 4s 9c]
Seat 1: NhUN/JpAprdJeamFBgJH1w (big blind) folded before Flop
Seat 2: ErIN0JRL5srYjT6en1f8YQ folded on the Turn
Seat 3: EXTSABh+qTpWWrIkxl3wXg folded before Flop (didn't bet)
Seat 4: cfJccEfyn6IkquPN08hFsA folded before Flop (didn't bet)
Seat 5: WmfI+HZXhME/HMG8E3/H2w (button) showed [Ts Qh] and won ($31.70) with a pair of Tens
Seat 6: 5z4PIVM9IyDWfUi+/MMdTA (small blind) showed [7h 6d] and lost with a pair of Sixes




PokerStars Game #59939489214:  Hold'em No Limit ($0.10/$0.25) - 2009/07/01 0:41:12 ET
Table 'ggwTHpIC5qhhHJSYjK1XCw' 6-max Seat #3 is the button
Seat 1: BYxjLnV1/LL0aZcTbfAOvw ($29 in chips) 
Seat 2: mBAp/L4XPhNEkNUlUTV4Iw ($16.05 in chips) 
Seat 3: SxIIgwXYLkwd6m3wLyPTCw ($25 in chips) 
Seat 4: JFIAqU8lCZ0vWwEl4bdGsg ($25.50 in chips) 
Seat 5: 6zbQpY/G44U1Xvj7DZex0A ($20.95 in chips) 
Seat 6: QOk5VUJeDqXaA3RlMSluGA ($11.20 in chips) 
JFIAqU8lCZ0vWwEl4bdGsg: posts small blind $0.10
6zbQpY/G44U1Xvj7DZex0A: posts big blind $0.25
*** HOLE CARDS ***
QOk5VUJeDqXaA3RlMSluGA: folds 
BYxjLnV1/LL0aZcTbfAOvw: folds 
mBAp/L4XPhNEkNUlUTV4Iw: folds 
SxIIgwXYLkwd6m3wLyPTCw: raises $0.50 to $0.75
JFIAqU8lCZ0vWwEl4bdGsg: folds 
6zbQpY/G44U1Xvj7DZex0A: raises $4 to $4.75
SxIIgwXYLkwd6m3wLyPTCw: folds 
Uncalled bet ($4) returned to 6zbQpY/G44U1Xvj7DZex0A
6zbQpY/G44U1Xvj7DZex0A collected $1.60 from pot
*** SUMMARY ***
Total pot $1.60 | Rake $0 
Seat 1: BYxjLnV1/LL0aZcTbfAOvw folded before Flop (didn't bet)
Seat 2: mBAp/L4XPhNEkNUlUTV4Iw folded before Flop (didn't bet)
Seat 3: SxIIgwXYLkwd6m3wLyPTCw (button) folded before Flop
Seat 4: JFIAqU8lCZ0vWwEl4bdGsg (small blind) folded before Flop
Seat 5: 6zbQpY/G44U1Xvj7DZex0A (big blind) collected ($1.60)
Seat 6: QOk5VUJeDqXaA3RlMSluGA folded before Flop (didn't bet)




PokerStars Game #59939489702:  Hold'em No Limit ($0.10/$0.25) - 2009/07/01 0:41:12 ET
Table 'hfHe8uKeSJMyWAjSdM7ROQ' 6-max Seat #6 is the button
Seat 1: eHsmIvAb2JREg4O6hNPnXg ($18 in chips) 
Seat 2: rnpAao581IcvQglpkpnkoQ ($7.05 in chips) 
Seat 3: og6TUWcndKo5oTDQjnQfjw ($30.50 in chips) 
Seat 4: iAfYkegiTr9eE85LoKmEgA ($7.60 in chips) 
Seat 5: euswrBD1XG0Q5hB1iGJBKQ ($24.45 in chips) 
Seat 6: SFmT9ZsVopnukjvAzrxTRg ($25 in chips) 
eHsmIvAb2JREg4O6hNPnXg: posts small blind $0.10
rnpAao581IcvQglpkpnkoQ: posts big blind $0.25
*** HOLE CARDS ***
og6TUWcndKo5oTDQjnQfjw: raises $0.50 to $0.75
iAfYkegiTr9eE85LoKmEgA: calls $0.75
euswrBD1XG0Q5hB1iGJBKQ: folds 
SFmT9ZsVopnukjvAzrxTRg: folds 
eHsmIvAb2JREg4O6hNPnXg: folds 
rnpAao581IcvQglpkpnkoQ: folds 
*** FLOP *** [2h 8d Qh]
og6TUWcndKo5oTDQjnQfjw: bets $1
iAfYkegiTr9eE85LoKmEgA: folds 
Uncalled bet ($1) returned to og6TUWcndKo5oTDQjnQfjw
og6TUWcndKo5oTDQjnQfjw collected $1.80 from pot
og6TUWcndKo5oTDQjnQfjw: doesn't show hand 
*** SUMMARY ***
Total pot $1.85 | Rake $0.05 
Board [2h 8d Qh]
Seat 1: eHsmIvAb2JREg4O6hNPnXg (small blind) folded before Flop
Seat 2: rnpAao581IcvQglpkpnkoQ (big blind) folded before Flop
Seat 3: og6TUWcndKo5oTDQjnQfjw collected ($1.80)
Seat 4: iAfYkegiTr9eE85LoKmEgA folded on the Flop
Seat 5: euswrBD1XG0Q5hB1iGJBKQ folded before Flop (didn't bet)
Seat 6: SFmT9ZsVopnukjvAzrxTRg (button) folded before Flop (didn't bet)




PokerStars Game #59939489380:  Hold'em No Limit ($0.10/$0.25) - 2009/07/01 0:41:12 ET
Table 'wRXcD9iXgBbdvKhWmfnBnw' 6-max Seat #1 is the button
Seat 1: LGWRgaQNaDFSlUGk26f0Ig ($19.45 in chips) 
Seat 2: SS/yfeArhULzIcOPe8MdPg ($25 in chips) 
Seat 3: 6zbQpY/G44U1Xvj7DZex0A ($20.05 in chips) 
Seat 4: mfrkWA3PTeYPkbO6hi98Aw ($26.05 in chips) 
Seat 5: EE16Ua5b1HSsYej5zeXOlA ($29.75 in chips) 
Seat 6: rhWCqDS9OBh/IoXY29BGMw ($19.55 in chips) 
SS/yfeArhULzIcOPe8MdPg: posts small blind $0.10
6zbQpY/G44U1Xvj7DZex0A: posts big blind $0.25
rhWCqDS9OBh/IoXY29BGMw: posts big blind $0.25
*** HOLE CARDS ***
mfrkWA3PTeYPkbO6hi98Aw: folds 
EE16Ua5b1HSsYej5zeXOlA: folds 
rhWCqDS9OBh/IoXY29BGMw: checks 
LGWRgaQNaDFSlUGk26f0Ig: raises $0.25 to $0.50
SS/yfeArhULzIcOPe8MdPg: folds 
6zbQpY/G44U1Xvj7DZex0A: calls $0.25
rhWCqDS9OBh/IoXY29BGMw: folds 
*** FLOP *** [2d 4h 2c]
6zbQpY/G44U1Xvj7DZex0A: checks 
LGWRgaQNaDFSlUGk26f0Ig: bets $0.75
6zbQpY/G44U1Xvj7DZex0A: calls $0.75
*** TURN *** [2d 4h 2c] [Qd]
6zbQpY/G44U1Xvj7DZex0A: bets $2
LGWRgaQNaDFSlUGk26f0Ig: calls $2
*** RIVER *** [2d 4h 2c Qd] [5c]
6zbQpY/G44U1Xvj7DZex0A: bets $2
LGWRgaQNaDFSlUGk26f0Ig: calls $2
*** SHOW DOWN ***
6zbQpY/G44U1Xvj7DZex0A: shows [Jh Qs] (two pair, Queens and Deuces)
LGWRgaQNaDFSlUGk26f0Ig: shows [As Ac] (two pair, Aces and Deuces)
LGWRgaQNaDFSlUGk26f0Ig collected $10.35 from pot
*** SUMMARY ***
Total pot $10.85 | Rake $0.50 
Board [2d 4h 2c Qd 5c]
Seat 1: LGWRgaQNaDFSlUGk26f0Ig (button) showed [As Ac] and won ($10.35) with two pair, Aces and Deuces
Seat 2: SS/yfeArhULzIcOPe8MdPg (small blind) folded before Flop
Seat 3: 6zbQpY/G44U1Xvj7DZex0A (big blind) showed [Jh Qs] and lost with two pair, Queens and Deuces
Seat 4: mfrkWA3PTeYPkbO6hi98Aw folded before Flop (didn't bet)
Seat 5: EE16Ua5b1HSsYej5zeXOlA folded before Flop (didn't bet)
Seat 6: rhWCqDS9OBh/IoXY29BGMw folded before Flop




PokerStars Game #59939488976:  Hold'em No Limit ($0.10/$0.25) - 2009/07/01 0:41:12 ET
Table '8QBBaev+cI2i/r2H6ml/lg' 9-max Seat #4 is the button
Seat 4: ZoG0obuajzVjwgd7lNHjgg ($1.90 in chips) 
Seat 6: cxE+szmvEUe7vE+z2ozM2Q ($9.75 in chips) 
Seat 9: Ml2bY77EHbM51ZWD7dnIWg ($3.70 in chips) 
cxE+szmvEUe7vE+z2ozM2Q: posts small blind $0.10
Ml2bY77EHbM51ZWD7dnIWg: posts big blind $0.25
*** HOLE CARDS ***
ZoG0obuajzVjwgd7lNHjgg: folds 
cxE+szmvEUe7vE+z2ozM2Q: raises $9.50 to $9.75 and is all-in
Ml2bY77EHbM51ZWD7dnIWg: folds 
Uncalled bet ($9.50) returned to cxE+szmvEUe7vE+z2ozM2Q
cxE+szmvEUe7vE+z2ozM2Q collected $0.50 from pot
cxE+szmvEUe7vE+z2ozM2Q: doesn't show hand 
*** SUMMARY ***
Total pot $0.50 | Rake $0 
Seat 4: ZoG0obuajzVjwgd7lNHjgg (button) folded before Flop (didn't bet)
Seat 6: cxE+szmvEUe7vE+z2ozM2Q (small blind) collected ($0.50)
Seat 9: Ml2bY77EHbM51ZWD7dnIWg (big blind) folded before Flop




PokerStars Game #59939489528:  Hold'em No Limit ($0.10/$0.25) - 2009/07/01 0:41:12 ET
Table 'T/iCKJXGphRN3xcdwfE/JQ' 6-max Seat #2 is the button
Seat 1: zZ8zH49EwNs0mqgppOaL9g ($25 in chips) 
Seat 2: FHilMb2i2DbUCc9lplszog ($12.75 in chips) 
Seat 3: R6AGToFJQOYVZAjC2jXEKw ($24.10 in chips) 
Seat 4: yzFNNFIfC89bBPwpFPx2ow ($46.25 in chips) 
Seat 6: jKYGBgexhqKT13Xana4EHg ($14.70 in chips) 
R6AGToFJQOYVZAjC2jXEKw: posts small blind $0.10
yzFNNFIfC89bBPwpFPx2ow: posts big blind $0.25
*** HOLE CARDS ***
DzdrMZ6l84e65/zfW+2bcA has returned
jKYGBgexhqKT13Xana4EHg: calls $0.25
zZ8zH49EwNs0mqgppOaL9g is disconnected 
zZ8zH49EwNs0mqgppOaL9g has timed out while disconnected
zZ8zH49EwNs0mqgppOaL9g: folds 
zZ8zH49EwNs0mqgppOaL9g is sitting out
FHilMb2i2DbUCc9lplszog: calls $0.25
R6AGToFJQOYVZAjC2jXEKw: calls $0.15
yzFNNFIfC89bBPwpFPx2ow: raises $1.25 to $1.50
jKYGBgexhqKT13Xana4EHg: folds 
FHilMb2i2DbUCc9lplszog: calls $1.25
R6AGToFJQOYVZAjC2jXEKw: folds 
*** FLOP *** [As 6s 5c]
yzFNNFIfC89bBPwpFPx2ow: bets $1.50
FHilMb2i2DbUCc9lplszog: calls $1.50
*** TURN *** [As 6s 5c] [Qs]
yzFNNFIfC89bBPwpFPx2ow: bets $3.25
FHilMb2i2DbUCc9lplszog: calls $3.25
*** RIVER *** [As 6s 5c Qs] [3c]
zZ8zH49EwNs0mqgppOaL9g is connected 
yzFNNFIfC89bBPwpFPx2ow: bets $7
FHilMb2i2DbUCc9lplszog: calls $6.50 and is all-in
Uncalled bet ($0.50) returned to yzFNNFIfC89bBPwpFPx2ow
zZ8zH49EwNs0mqgppOaL9g has returned
*** SHOW DOWN ***
yzFNNFIfC89bBPwpFPx2ow: shows [Qc Qh] (three of a kind, Queens)
FHilMb2i2DbUCc9lplszog: mucks hand 
yzFNNFIfC89bBPwpFPx2ow collected $24.75 from pot
*** SUMMARY ***
Total pot $26 | Rake $1.25 
Board [As 6s 5c Qs 3c]
Seat 1: zZ8zH49EwNs0mqgppOaL9g folded before Flop (didn't bet)
Seat 2: FHilMb2i2DbUCc9lplszog (button) mucked
Seat 3: R6AGToFJQOYVZAjC2jXEKw (small blind) folded before Flop
Seat 4: yzFNNFIfC89bBPwpFPx2ow (big blind) showed [Qc Qh] and won ($24.75) with three of a kind, Queens
Seat 6: jKYGBgexhqKT13Xana4EHg folded before Flop




PokerStars Game #59939489546:  Hold'em No Limit ($0.10/$0.25) - 2009/07/01 0:41:12 ET
Table 'hOE09W281uSob0XeJmUcRg' 6-max Seat #6 is the button
Seat 1: edio/rLJ06xeZOfLhoL3UA ($17.40 in chips) 
Seat 4: TslQs7AQSLbVtr4X8JOOOQ ($19.55 in chips) 
Seat 5: 66a/8+qw1AZLNh63FuclPA ($101 in chips) 
Seat 6: x4ZJ8E/TUrtoB7WiHcv8WA ($8.35 in chips) 
edio/rLJ06xeZOfLhoL3UA: posts small blind $0.10
TslQs7AQSLbVtr4X8JOOOQ: posts big blind $0.25
*** HOLE CARDS ***
66a/8+qw1AZLNh63FuclPA: raises $0.50 to $0.75
x4ZJ8E/TUrtoB7WiHcv8WA: folds 
edio/rLJ06xeZOfLhoL3UA: folds 
TslQs7AQSLbVtr4X8JOOOQ: folds 
Uncalled bet ($0.50) returned to 66a/8+qw1AZLNh63FuclPA
66a/8+qw1AZLNh63FuclPA collected $0.60 from pot
66a/8+qw1AZLNh63FuclPA: doesn't show hand 
*** SUMMARY ***
Total pot $0.60 | Rake $0 
Seat 1: edio/rLJ06xeZOfLhoL3UA (small blind) folded before Flop
Seat 4: TslQs7AQSLbVtr4X8JOOOQ (big blind) folded before Flop
Seat 5: 66a/8+qw1AZLNh63FuclPA collected ($0.60)
Seat 6: x4ZJ8E/TUrtoB7WiHcv8WA (button) folded before Flop (didn't bet)




PokerStars Game #59939490242:  Hold'em No Limit ($0.10/$0.25) - 2009/07/01 0:41:13 ET
Table 'NfXsh0UQA+o/kO9acV3WxA' 9-max Seat #7 is the button
Seat 1: H5Se03ZqSX7tbULXur2MAg ($24.30 in chips) 
Seat 2: 5/P8XWKnr8tBG9c+iHgFNA ($23.25 in chips) 
Seat 3: 1K6QGyJP9P9xmRac2fH4OQ ($37.45 in chips) 
Seat 4: sQ6szDwWrE+LMh1p4dVexA ($17.10 in chips) 
Seat 5: 3RCAkueG3Vc13VpRStCB+w ($37.80 in chips) 
Seat 7: HPEB+AtKw1+C/cxU0o1ciw ($31.60 in chips) 
Seat 8: +sbyWwIcFp9kP0bDtMegfQ ($24.75 in chips) 
Seat 9: MgMavn/DzTzqKgHTZMsVSw ($25 in chips) 
+sbyWwIcFp9kP0bDtMegfQ: posts small blind $0.10
MgMavn/DzTzqKgHTZMsVSw: posts big blind $0.25
*** HOLE CARDS ***
H5Se03ZqSX7tbULXur2MAg: folds 
5/P8XWKnr8tBG9c+iHgFNA: folds 
5/P8XWKnr8tBG9c+iHgFNA leaves the table
1K6QGyJP9P9xmRac2fH4OQ: raises $0.75 to $1
sQ6szDwWrE+LMh1p4dVexA: folds 
3RCAkueG3Vc13VpRStCB+w: folds 
HPEB+AtKw1+C/cxU0o1ciw: folds 
+sbyWwIcFp9kP0bDtMegfQ: folds 
MgMavn/DzTzqKgHTZMsVSw: folds 
Uncalled bet ($0.75) returned to 1K6QGyJP9P9xmRac2fH4OQ
1K6QGyJP9P9xmRac2fH4OQ collected $0.60 from pot
1K6QGyJP9P9xmRac2fH4OQ: doesn't show hand 
*** SUMMARY ***
Total pot $0.60 | Rake $0 
Seat 1: H5Se03ZqSX7tbULXur2MAg folded before Flop (didn't bet)
Seat 2: 5/P8XWKnr8tBG9c+iHgFNA folded before Flop (didn't bet)
Seat 3: 1K6QGyJP9P9xmRac2fH4OQ collected ($0.60)
Seat 4: sQ6szDwWrE+LMh1p4dVexA folded before Flop (didn't bet)
Seat 5: 3RCAkueG3Vc13VpRStCB+w folded before Flop (didn't bet)
Seat 7: HPEB+AtKw1+C/cxU0o1ciw (button) folded before Flop (didn't bet)
Seat 8: +sbyWwIcFp9kP0bDtMegfQ (small blind) folded before Flop
Seat 9: MgMavn/DzTzqKgHTZMsVSw (big blind) folded before Flop




PokerStars Game #59939489788:  Hold'em No Limit ($0.10/$0.25) - 2009/07/01 0:41:13 ET
Table 'KKk6y4pAXeymxYcd0uZLqg' 9-max Seat #4 is the button
Seat 1: HPEB+AtKw1+C/cxU0o1ciw ($24.55 in chips) 
Seat 3: 4oA316mXLIui1QY63GXBUg ($25 in chips) 
Seat 4: GTcLfsDTPqgfHyhY9FNDMw ($14.80 in chips) 
Seat 5: U0VVxBdRWdhRNdbJ+Qky1A ($45.60 in chips) 
Seat 6: LWN1wPrLH+695JIriXxDuw ($11.60 in chips) 
Seat 7: R3KkgiqTvuhazyCqaD9cZg ($10.55 in chips) 
Seat 8: +2kMBNpY4nF1qNCRd8SJLA ($26.10 in chips) 
Seat 9: j4q3p0lesp63b1gZDwLBZw ($5 in chips) 
U0VVxBdRWdhRNdbJ+Qky1A: posts small blind $0.10
LWN1wPrLH+695JIriXxDuw: posts big blind $0.25
*** HOLE CARDS ***
R3KkgiqTvuhazyCqaD9cZg: calls $0.25
+2kMBNpY4nF1qNCRd8SJLA: folds 
j4q3p0lesp63b1gZDwLBZw: folds 
HPEB+AtKw1+C/cxU0o1ciw: folds 
4oA316mXLIui1QY63GXBUg: folds 
GTcLfsDTPqgfHyhY9FNDMw: calls $0.25
U0VVxBdRWdhRNdbJ+Qky1A: calls $0.15
LWN1wPrLH+695JIriXxDuw: checks 
*** FLOP *** [4c Jd 6h]
U0VVxBdRWdhRNdbJ+Qky1A: checks 
LWN1wPrLH+695JIriXxDuw: checks 
R3KkgiqTvuhazyCqaD9cZg: checks 
GTcLfsDTPqgfHyhY9FNDMw: bets $0.75
U0VVxBdRWdhRNdbJ+Qky1A: folds 
LWN1wPrLH+695JIriXxDuw: folds 
R3KkgiqTvuhazyCqaD9cZg: folds 
Uncalled bet ($0.75) returned to GTcLfsDTPqgfHyhY9FNDMw
GTcLfsDTPqgfHyhY9FNDMw collected $0.95 from pot
GTcLfsDTPqgfHyhY9FNDMw: doesn't show hand 
*** SUMMARY ***
Total pot $1 | Rake $0.05 
Board [4c Jd 6h]
Seat 1: HPEB+AtKw1+C/cxU0o1ciw folded before Flop (didn't bet)
Seat 3: 4oA316mXLIui1QY63GXBUg folded before Flop (didn't bet)
Seat 4: GTcLfsDTPqgfHyhY9FNDMw (button) collected ($0.95)
Seat 5: U0VVxBdRWdhRNdbJ+Qky1A (small blind) folded on the Flop
Seat 6: LWN1wPrLH+695JIriXxDuw (big blind) folded on the Flop
Seat 7: R3KkgiqTvuhazyCqaD9cZg folded on the Flop
Seat 8: +2kMBNpY4nF1qNCRd8SJLA folded before Flop (didn't bet)
Seat 9: j4q3p0lesp63b1gZDwLBZw folded before Flop (didn't bet)




PokerStars Game #59939489972:  Hold'em No Limit ($0.10/$0.25) - 2009/07/01 0:41:13 ET
Table 'rO1I30HnuCPB0M8qEX1TCQ' 9-max Seat #4 is the button
Seat 1: P32tOtZSz+L5ekobAPq2DA ($3.60 in chips) 
Seat 2: 33y9+GmQ3J84RvZXcraRTw ($21.05 in chips) 
Seat 3: 8Waresd9ixnijISc3GUypg ($12.90 in chips) 
Seat 4: spidnpwmoJ1L6yeNW7D5UA ($24.25 in chips) 
Seat 5: HVKi9hnDyvzObpL08/OarQ ($24.50 in chips) 
Seat 7: 4oA316mXLIui1QY63GXBUg ($30.75 in chips) 
Seat 8: DIBbjEYGs+TVdVgEB/4+3w ($37 in chips) 
Seat 9: PrviAnKmKklf+We6cR33cw ($30.50 in chips) 
HVKi9hnDyvzObpL08/OarQ: posts small blind $0.10
4oA316mXLIui1QY63GXBUg: posts big blind $0.25
*** HOLE CARDS ***
DIBbjEYGs+TVdVgEB/4+3w: folds 
PrviAnKmKklf+We6cR33cw: folds 
P32tOtZSz+L5ekobAPq2DA: folds 
33y9+GmQ3J84RvZXcraRTw: folds 
8Waresd9ixnijISc3GUypg: folds 
spidnpwmoJ1L6yeNW7D5UA: raises $0.50 to $0.75
HVKi9hnDyvzObpL08/OarQ: folds 
4oA316mXLIui1QY63GXBUg: folds 
Uncalled bet ($0.50) returned to spidnpwmoJ1L6yeNW7D5UA
spidnpwmoJ1L6yeNW7D5UA collected $0.60 from pot
spidnpwmoJ1L6yeNW7D5UA: doesn't show hand 
*** SUMMARY ***
Total pot $0.60 | Rake $0 
Seat 1: P32tOtZSz+L5ekobAPq2DA folded before Flop (didn't bet)
Seat 2: 33y9+GmQ3J84RvZXcraRTw folded before Flop (didn't bet)
Seat 3: 8Waresd9ixnijISc3GUypg folded before Flop (didn't bet)
Seat 4: spidnpwmoJ1L6yeNW7D5UA (button) collected ($0.60)
Seat 5: HVKi9hnDyvzObpL08/OarQ (small blind) folded before Flop
Seat 7: 4oA316mXLIui1QY63GXBUg (big blind) folded before Flop
Seat 8: DIBbjEYGs+TVdVgEB/4+3w folded before Flop (didn't bet)
Seat 9: PrviAnKmKklf+We6cR33cw folded before Flop (didn't bet)




PokerStars Game #59939490342:  Hold'em No Limit ($0.10/$0.25) - 2009/07/01 0:41:13 ET
Table 'tErGGDyESv/0llKumVeZuQ' 9-max Seat #1 is the button
Seat 1: R3KkgiqTvuhazyCqaD9cZg ($11.75 in chips) 
Seat 2: fnmp9YBEeLxBFinW2Sx+pg ($9.35 in chips) 
Seat 3: CvL9Ch1HYCVbTsfpNucitg ($5 in chips) 
Seat 4: j1oAjkBBlFRUy+e+LF1vNQ ($4.05 in chips) 
Seat 5: le+pqvOEeS8Vvxt8ogLv/w ($12 in chips) 
Seat 6: zDrucyjVn5aeekNEc3cJrA ($29.25 in chips) 
Seat 7: s7Q6uNouhe7aE8JdFb9E+A ($25.65 in chips) 
Seat 8: Sv38qYH3jj8a8dddDi1aUA ($14.50 in chips) 
Seat 9: r284m4NA4rtNktI86R8/Yw ($14.55 in chips) 
fnmp9YBEeLxBFinW2Sx+pg: posts small blind $0.10
CvL9Ch1HYCVbTsfpNucitg: posts big blind $0.25
*** HOLE CARDS ***
j1oAjkBBlFRUy+e+LF1vNQ: calls $0.25
le+pqvOEeS8Vvxt8ogLv/w: folds 
zDrucyjVn5aeekNEc3cJrA: folds 
s7Q6uNouhe7aE8JdFb9E+A: folds 
Sv38qYH3jj8a8dddDi1aUA: folds 
r284m4NA4rtNktI86R8/Yw: folds 
R3KkgiqTvuhazyCqaD9cZg: folds 
fnmp9YBEeLxBFinW2Sx+pg: calls $0.15
CvL9Ch1HYCVbTsfpNucitg: checks 
*** FLOP *** [2d 7s Ad]
fnmp9YBEeLxBFinW2Sx+pg: checks 
CvL9Ch1HYCVbTsfpNucitg: checks 
j1oAjkBBlFRUy+e+LF1vNQ: bets $0.25
fnmp9YBEeLxBFinW2Sx+pg: calls $0.25
CvL9Ch1HYCVbTsfpNucitg: folds 
*** TURN *** [2d 7s Ad] [Jh]
fnmp9YBEeLxBFinW2Sx+pg: checks 
j1oAjkBBlFRUy+e+LF1vNQ: bets $0.75
fnmp9YBEeLxBFinW2Sx+pg: calls $0.75
*** RIVER *** [2d 7s Ad Jh] [8c]
fnmp9YBEeLxBFinW2Sx+pg: folds 
fnmp9YBEeLxBFinW2Sx+pg leaves the table
j1oAjkBBlFRUy+e+LF1vNQ collected $2.65 from pot
j1oAjkBBlFRUy+e+LF1vNQ: doesn't show hand 
*** SUMMARY ***
Total pot $2.75 | Rake $0.10 
Board [2d 7s Ad Jh 8c]
Seat 1: R3KkgiqTvuhazyCqaD9cZg (button) folded before Flop (didn't bet)
Seat 2: fnmp9YBEeLxBFinW2Sx+pg (small blind) folded on the River
Seat 3: CvL9Ch1HYCVbTsfpNucitg (big blind) folded on the Flop
Seat 4: j1oAjkBBlFRUy+e+LF1vNQ collected ($2.65)
Seat 5: le+pqvOEeS8Vvxt8ogLv/w folded before Flop (didn't bet)
Seat 6: zDrucyjVn5aeekNEc3cJrA folded before Flop (didn't bet)
Seat 7: s7Q6uNouhe7aE8JdFb9E+A folded before Flop (didn't bet)
Seat 8: Sv38qYH3jj8a8dddDi1aUA folded before Flop (didn't bet)
Seat 9: r284m4NA4rtNktI86R8/Yw folded before Flop (didn't bet)




PokerStars Game #59939490356:  Hold'em No Limit ($0.10/$0.25) - 2009/07/01 0:41:13 ET
Table 'sSe6q4YTb/iS19t2eCFdsA' 9-max Seat #6 is the button
Seat 1: 5z3YkZTfH2GjoLK+6X7z2w ($11.55 in chips) 
Seat 2: rUpvA02nErFvZ4yFbDR8XA ($28.10 in chips) 
Seat 3: hBMUlEpyU74r/fwDgIpXjQ ($26.20 in chips) 
Seat 4: SXqVW4Q0evTUVZG6BbUNIA ($15.85 in chips) 
Seat 5: qS+jfnNoG75bT+uQ8CKhQA ($10.65 in chips) 
Seat 6: tYsOBqdU1+x+yFI7zHO7hQ ($26.05 in chips) 
Seat 7: t70KGeRtR3naHSqKDixsUg ($13.90 in chips) 
Seat 8: jeKWRUkMaVn8rEUjnJKqpg ($27.40 in chips) 
Seat 9: 4oA316mXLIui1QY63GXBUg ($25.60 in chips) 
t70KGeRtR3naHSqKDixsUg: posts small blind $0.10
jeKWRUkMaVn8rEUjnJKqpg: posts big blind $0.25
*** HOLE CARDS ***
4oA316mXLIui1QY63GXBUg: folds 
5z3YkZTfH2GjoLK+6X7z2w has timed out
5z3YkZTfH2GjoLK+6X7z2w: folds 
5z3YkZTfH2GjoLK+6X7z2w is sitting out
rUpvA02nErFvZ4yFbDR8XA: folds 
hBMUlEpyU74r/fwDgIpXjQ: folds 
SXqVW4Q0evTUVZG6BbUNIA: raises $0.75 to $1
qS+jfnNoG75bT+uQ8CKhQA: folds 
tYsOBqdU1+x+yFI7zHO7hQ: folds 
t70KGeRtR3naHSqKDixsUg: folds 
jeKWRUkMaVn8rEUjnJKqpg: folds 
Uncalled bet ($0.75) returned to SXqVW4Q0evTUVZG6BbUNIA
SXqVW4Q0evTUVZG6BbUNIA collected $0.60 from pot
*** SUMMARY ***
Total pot $0.60 | Rake $0 
Seat 1: 5z3YkZTfH2GjoLK+6X7z2w folded before Flop (didn't bet)
Seat 2: rUpvA02nErFvZ4yFbDR8XA folded before Flop (didn't bet)
Seat 3: hBMUlEpyU74r/fwDgIpXjQ folded before Flop (didn't bet)
Seat 4: SXqVW4Q0evTUVZG6BbUNIA collected ($0.60)
Seat 5: qS+jfnNoG75bT+uQ8CKhQA folded before Flop (didn't bet)
Seat 6: tYsOBqdU1+x+yFI7zHO7hQ (button) folded before Flop (didn't bet)
Seat 7: t70KGeRtR3naHSqKDixsUg (small blind) folded before Flop
Seat 8: jeKWRUkMaVn8rEUjnJKqpg (big blind) folded before Flop
Seat 9: 4oA316mXLIui1QY63GXBUg folded before Flop (didn't bet)




PokerStars Game #59939490222:  Hold'em No Limit ($0.10/$0.25) - 2009/07/01 0:41:13 ET
Table 'fIrOIN3HoXM27ZpRwKa6oA' 6-max Seat #6 is the button
Seat 1: I1TxPvWj8NfG8orglCinNA ($38.60 in chips) 
Seat 2: 5tB0F9NjPSUL4FzmzBMs2Q ($40.40 in chips) 
Seat 4: PEUgcMc+CzvN+vLwu5DsLQ ($2.80 in chips) 
Seat 5: 8ClCHtFXGNplITm+63KB+Q ($26.80 in chips) 
Seat 6: v+QfkGiuj9bgtuNoVnDO8w ($29.70 in chips) 
I1TxPvWj8NfG8orglCinNA: posts small blind $0.10
5tB0F9NjPSUL4FzmzBMs2Q: posts big blind $0.25
*** HOLE CARDS ***
PEUgcMc+CzvN+vLwu5DsLQ: calls $0.25
8ClCHtFXGNplITm+63KB+Q: folds 
OElpcjPk5wP6xlAUngsAmg leaves the table
v+QfkGiuj9bgtuNoVnDO8w: folds 
I1TxPvWj8NfG8orglCinNA: folds 
5tB0F9NjPSUL4FzmzBMs2Q: raises $1 to $1.25
PEUgcMc+CzvN+vLwu5DsLQ: calls $1
*** FLOP *** [Jd Ad 8h]
5tB0F9NjPSUL4FzmzBMs2Q: checks 
PEUgcMc+CzvN+vLwu5DsLQ: bets $1.55 and is all-in
5tB0F9NjPSUL4FzmzBMs2Q: calls $1.55
*** TURN *** [Jd Ad 8h] [6d]
*** RIVER *** [Jd Ad 8h 6d] [7s]
*** SHOW DOWN ***
5tB0F9NjPSUL4FzmzBMs2Q: shows [Kc Td] (high card Ace)
PEUgcMc+CzvN+vLwu5DsLQ: shows [8c 6c] (two pair, Eights and Sixes)
PEUgcMc+CzvN+vLwu5DsLQ collected $5.45 from pot
*** SUMMARY ***
Total pot $5.70 | Rake $0.25 
Board [Jd Ad 8h 6d 7s]
Seat 1: I1TxPvWj8NfG8orglCinNA (small blind) folded before Flop
Seat 2: 5tB0F9NjPSUL4FzmzBMs2Q (big blind) showed [Kc Td] and lost with high card Ace
Seat 4: PEUgcMc+CzvN+vLwu5DsLQ showed [8c 6c] and won ($5.45) with two pair, Eights and Sixes
Seat 5: 8ClCHtFXGNplITm+63KB+Q folded before Flop (didn't bet)
Seat 6: v+QfkGiuj9bgtuNoVnDO8w (button) folded before Flop (didn't bet)




PokerStars Game #59939489826:  Hold'em No Limit ($0.10/$0.25) - 2009/07/01 0:41:13 ET
Table 'sCop8wmj9zlSS2KJqk1QKQ' 9-max Seat #7 is the button
Seat 1: SXqVW4Q0evTUVZG6BbUNIA ($21.90 in chips) 
Seat 2: W4TLQcZ2TiM73eIgpIvlGg ($22.80 in chips) 
Seat 3: 6TWO15+WfJ5HfI8CbJ4a0w ($4.30 in chips) 
Seat 4: KNrY0Y/j01dK9gZK7dx7QA ($14.40 in chips) 
Seat 6: hZuGwtYmFKPmQ+v1wlmdfA ($40.10 in chips) 
Seat 7: 4dd+rKHhaMiTl5LEkADvQQ ($4.90 in chips) 
Seat 9: tOdE7+08fkUzsTpCnhoPDA ($22.20 in chips) 
tOdE7+08fkUzsTpCnhoPDA: posts small blind $0.10
SXqVW4Q0evTUVZG6BbUNIA: posts big blind $0.25
sD+TKtt36XiiN6jqHiLwDA: sits out 
*** HOLE CARDS ***
NNZypfH1f/VIj3Skf/XIzg leaves the table
W4TLQcZ2TiM73eIgpIvlGg: raises $0.75 to $1
6TWO15+WfJ5HfI8CbJ4a0w: folds 
KNrY0Y/j01dK9gZK7dx7QA: folds 
hZuGwtYmFKPmQ+v1wlmdfA: folds 
4dd+rKHhaMiTl5LEkADvQQ: folds 
tOdE7+08fkUzsTpCnhoPDA: folds 
SXqVW4Q0evTUVZG6BbUNIA: folds 
Uncalled bet ($0.75) returned to W4TLQcZ2TiM73eIgpIvlGg
W4TLQcZ2TiM73eIgpIvlGg collected $0.60 from pot
*** SUMMARY ***
Total pot $0.60 | Rake $0 
Seat 1: SXqVW4Q0evTUVZG6BbUNIA (big blind) folded before Flop
Seat 2: W4TLQcZ2TiM73eIgpIvlGg collected ($0.60)
Seat 3: 6TWO15+WfJ5HfI8CbJ4a0w folded before Flop (didn't bet)
Seat 4: KNrY0Y/j01dK9gZK7dx7QA folded before Flop (didn't bet)
Seat 6: hZuGwtYmFKPmQ+v1wlmdfA folded before Flop (didn't bet)
Seat 7: 4dd+rKHhaMiTl5LEkADvQQ (button) folded before Flop (didn't bet)
Seat 9: tOdE7+08fkUzsTpCnhoPDA (small blind) folded before Flop




PokerStars Game #59939489786:  Hold'em No Limit ($0.10/$0.25) - 2009/07/01 0:41:13 ET
Table 'AJGgX1ZYM8d68SWMvaLttg' 6-max Seat #6 is the button
Seat 1: sT4sjqzVMH/fZHz0hkbIPw ($35.65 in chips) 
Seat 2: zHHLkD2sRljslKKeQv/ZQw ($32.35 in chips) 
Seat 3: 4x9jCqgSw4272dnaIqnanw ($7.35 in chips) 
Seat 4: Lz/GjRDgmgepqTR7qmS86w ($18.35 in chips) 
Seat 5: SFmT9ZsVopnukjvAzrxTRg ($28.60 in chips) 
Seat 6: UA5OsKS3VPaxa7uC8La/kA ($28.50 in chips) 
sT4sjqzVMH/fZHz0hkbIPw: posts small blind $0.10
zHHLkD2sRljslKKeQv/ZQw: posts big blind $0.25
*** HOLE CARDS ***
4x9jCqgSw4272dnaIqnanw: folds 
Lz/GjRDgmgepqTR7qmS86w: folds 
SFmT9ZsVopnukjvAzrxTRg: folds 
UA5OsKS3VPaxa7uC8La/kA: raises $0.50 to $0.75
sT4sjqzVMH/fZHz0hkbIPw: calls $0.65
zHHLkD2sRljslKKeQv/ZQw: calls $0.50
*** FLOP *** [Jc 9c 8s]
sT4sjqzVMH/fZHz0hkbIPw: bets $1
zHHLkD2sRljslKKeQv/ZQw: calls $1
UA5OsKS3VPaxa7uC8La/kA: folds 
*** TURN *** [Jc 9c 8s] [Kc]
sT4sjqzVMH/fZHz0hkbIPw: bets $2
zHHLkD2sRljslKKeQv/ZQw: folds 
Uncalled bet ($2) returned to sT4sjqzVMH/fZHz0hkbIPw
sT4sjqzVMH/fZHz0hkbIPw collected $4.05 from pot
sT4sjqzVMH/fZHz0hkbIPw: doesn't show hand 
*** SUMMARY ***
Total pot $4.25 | Rake $0.20 
Board [Jc 9c 8s Kc]
Seat 1: sT4sjqzVMH/fZHz0hkbIPw (small blind) collected ($4.05)
Seat 2: zHHLkD2sRljslKKeQv/ZQw (big blind) folded on the Turn
Seat 3: 4x9jCqgSw4272dnaIqnanw folded before Flop (didn't bet)
Seat 4: Lz/GjRDgmgepqTR7qmS86w folded before Flop (didn't bet)
Seat 5: SFmT9ZsVopnukjvAzrxTRg folded before Flop (didn't bet)
Seat 6: UA5OsKS3VPaxa7uC8La/kA (button) folded on the Flop




PokerStars Game #59939489918:  Hold'em No Limit ($0.10/$0.25) - 2009/07/01 0:41:13 ET
Table 'O6cwjhrMn9pfzx1Ngn5zkQ' 6-max Seat #2 is the button
Seat 1: k4mJ9nD/YOVTl8/kGW+U6w ($12.95 in chips) 
Seat 2: M6xK/VklCvdyyrmvzATlxQ ($14 in chips) 
Seat 3: EE16Ua5b1HSsYej5zeXOlA ($25 in chips) 
Seat 4: wKFJ513ucluNNiMlkXcDOQ ($31.75 in chips) 
Seat 5: niLn0xUVlqh8If80xRjzCA ($24.30 in chips) 
Seat 6: d0J1xuhsynEY81YHwAvJ5g ($27.05 in chips) 
EE16Ua5b1HSsYej5zeXOlA: posts small blind $0.10
wKFJ513ucluNNiMlkXcDOQ: posts big blind $0.25
*** HOLE CARDS ***
niLn0xUVlqh8If80xRjzCA said, "its called skill young man"
niLn0xUVlqh8If80xRjzCA: calls $0.25
d0J1xuhsynEY81YHwAvJ5g: folds 
k4mJ9nD/YOVTl8/kGW+U6w: folds 
M6xK/VklCvdyyrmvzATlxQ: folds 
EE16Ua5b1HSsYej5zeXOlA: folds 
wKFJ513ucluNNiMlkXcDOQ: checks 
*** FLOP *** [8s 2c 3d]
wKFJ513ucluNNiMlkXcDOQ: bets $0.50
niLn0xUVlqh8If80xRjzCA said, "when you play at this level u have to bring ur big guns'"
niLn0xUVlqh8If80xRjzCA: calls $0.50
*** TURN *** [8s 2c 3d] [As]
wKFJ513ucluNNiMlkXcDOQ: bets $1
niLn0xUVlqh8If80xRjzCA: folds 
Uncalled bet ($1) returned to wKFJ513ucluNNiMlkXcDOQ
wKFJ513ucluNNiMlkXcDOQ collected $1.55 from pot
wKFJ513ucluNNiMlkXcDOQ: doesn't show hand 
*** SUMMARY ***
Total pot $1.60 | Rake $0.05 
Board [8s 2c 3d As]
Seat 1: k4mJ9nD/YOVTl8/kGW+U6w folded before Flop (didn't bet)
Seat 2: M6xK/VklCvdyyrmvzATlxQ (button) folded before Flop (didn't bet)
Seat 3: EE16Ua5b1HSsYej5zeXOlA (small blind) folded before Flop
Seat 4: wKFJ513ucluNNiMlkXcDOQ (big blind) collected ($1.55)
Seat 5: niLn0xUVlqh8If80xRjzCA folded on the Turn
Seat 6: d0J1xuhsynEY81YHwAvJ5g folded before Flop (didn't bet)




PokerStars Game #59939490756:  Hold'em No Limit ($0.10/$0.25) - 2009/07/01 0:41:14 ET
Table '1LkLBsok91+aSWIELy/cyw' 6-max Seat #6 is the button
Seat 1: /gJNBeCkWL4o85/jvlZ4BA ($25.25 in chips) 
Seat 2: oseFhpinoe+Zg4j5xyBjyQ ($25.95 in chips) 
Seat 3: wUwfsTnmpHcWa17qFlQr1Q ($5.70 in chips) 
Seat 4: vEZ/HxVuyR6kaq0BtZoUgQ ($13.85 in chips) 
Seat 5: trN/oHqTTbPw5MNuKrOpLw ($29.05 in chips) 
Seat 6: MuW7Zf0FjOGlCuY3aIrlsA ($24.75 in chips) 
/gJNBeCkWL4o85/jvlZ4BA: posts small blind $0.10
oseFhpinoe+Zg4j5xyBjyQ: posts big blind $0.25
*** HOLE CARDS ***
wUwfsTnmpHcWa17qFlQr1Q: raises $0.50 to $0.75
vEZ/HxVuyR6kaq0BtZoUgQ: folds 
trN/oHqTTbPw5MNuKrOpLw: folds 
MuW7Zf0FjOGlCuY3aIrlsA: folds 
/gJNBeCkWL4o85/jvlZ4BA: folds 
oseFhpinoe+Zg4j5xyBjyQ: folds 
Uncalled bet ($0.50) returned to wUwfsTnmpHcWa17qFlQr1Q
wUwfsTnmpHcWa17qFlQr1Q collected $0.60 from pot
wUwfsTnmpHcWa17qFlQr1Q is sitting out
*** SUMMARY ***
Total pot $0.60 | Rake $0 
Seat 1: /gJNBeCkWL4o85/jvlZ4BA (small blind) folded before Flop
Seat 2: oseFhpinoe+Zg4j5xyBjyQ (big blind) folded before Flop
Seat 3: wUwfsTnmpHcWa17qFlQr1Q collected ($0.60)
Seat 4: vEZ/HxVuyR6kaq0BtZoUgQ folded before Flop (didn't bet)
Seat 5: trN/oHqTTbPw5MNuKrOpLw folded before Flop (didn't bet)
Seat 6: MuW7Zf0FjOGlCuY3aIrlsA (button) folded before Flop (didn't bet)




PokerStars Game #59939491072:  Hold'em No Limit ($0.10/$0.25) - 2009/07/01 0:41:14 ET
Table 'GgmUtmhrYPRnhkqEEjD/Kw' 9-max Seat #8 is the button
Seat 2: ghNKXUBl/H+t83JF079ZBA ($25 in chips) 
Seat 3: DZek9vrzBExLUFtbWml/Eg ($11.55 in chips) 
Seat 4: uwmAXQRjyA4iX5kaC15P9A ($5.40 in chips) 
Seat 6: 4Ax0vobe1rLVIGZmkFINGA ($17.55 in chips) 
Seat 7: YwDw9cMqkbMznFK77rru4A ($8.55 in chips) 
Seat 8: mKwW7JjB4GQW2YtoYgqIgw ($11.95 in chips) 
vnCdP3GsLTKadDukKcJk/Q will be allowed to play after the button
ghNKXUBl/H+t83JF079ZBA: posts small blind $0.10
DZek9vrzBExLUFtbWml/Eg: posts big blind $0.25
*** HOLE CARDS ***
uwmAXQRjyA4iX5kaC15P9A: folds 
4Ax0vobe1rLVIGZmkFINGA: folds 
YwDw9cMqkbMznFK77rru4A: folds 
mKwW7JjB4GQW2YtoYgqIgw: raises $0.75 to $1
ghNKXUBl/H+t83JF079ZBA: folds 
DZek9vrzBExLUFtbWml/Eg: folds 
Uncalled bet ($0.75) returned to mKwW7JjB4GQW2YtoYgqIgw
mKwW7JjB4GQW2YtoYgqIgw collected $0.60 from pot
*** SUMMARY ***
Total pot $0.60 | Rake $0 
Seat 2: ghNKXUBl/H+t83JF079ZBA (small blind) folded before Flop
Seat 3: DZek9vrzBExLUFtbWml/Eg (big blind) folded before Flop
Seat 4: uwmAXQRjyA4iX5kaC15P9A folded before Flop (didn't bet)
Seat 6: 4Ax0vobe1rLVIGZmkFINGA folded before Flop (didn't bet)
Seat 7: YwDw9cMqkbMznFK77rru4A folded before Flop (didn't bet)
Seat 8: mKwW7JjB4GQW2YtoYgqIgw (button) collected ($0.60)




PokerStars Game #59939490434:  Hold'em No Limit ($0.10/$0.25) - 2009/07/01 0:41:14 ET
Table 'qInMnOOn7vKcj4bU7zju7g' 9-max Seat #9 is the button
Seat 1: 3PjJjazzeHcM4mbFeXmZBg ($3.30 in chips) 
Seat 2: f/H6PsHRl4W1JyNsEDvPtg ($14.75 in chips) 
Seat 3: zDrucyjVn5aeekNEc3cJrA ($28.50 in chips) 
Seat 4: ZbKV588BRlpe7vF42jT9yg ($9.80 in chips) 
Seat 5: aNpwfA31EREwO+ar4XzBCw ($39 in chips) 
Seat 7: 8B/dhbQjIWe6ASCdgzktNQ ($27.35 in chips) 
Seat 9: K7bAhhMMJ/XcTmGaBZVfFQ ($23.90 in chips) 
3PjJjazzeHcM4mbFeXmZBg: posts small blind $0.10
f/H6PsHRl4W1JyNsEDvPtg: posts big blind $0.25
*** HOLE CARDS ***
r1pFKMwWp74QwhfPWJOAyw has returned
zDrucyjVn5aeekNEc3cJrA: folds 
ZbKV588BRlpe7vF42jT9yg: folds 
aNpwfA31EREwO+ar4XzBCw: folds 
8B/dhbQjIWe6ASCdgzktNQ: raises $0.50 to $0.75
K7bAhhMMJ/XcTmGaBZVfFQ: folds 
3PjJjazzeHcM4mbFeXmZBg: raises $2.55 to $3.30 and is all-in
f/H6PsHRl4W1JyNsEDvPtg: folds 
8B/dhbQjIWe6ASCdgzktNQ: folds 
Uncalled bet ($2.55) returned to 3PjJjazzeHcM4mbFeXmZBg
3PjJjazzeHcM4mbFeXmZBg collected $1.75 from pot
*** SUMMARY ***
Total pot $1.75 | Rake $0 
Seat 1: 3PjJjazzeHcM4mbFeXmZBg (small blind) collected ($1.75)
Seat 2: f/H6PsHRl4W1JyNsEDvPtg (big blind) folded before Flop
Seat 3: zDrucyjVn5aeekNEc3cJrA folded before Flop (didn't bet)
Seat 4: ZbKV588BRlpe7vF42jT9yg folded before Flop (didn't bet)
Seat 5: aNpwfA31EREwO+ar4XzBCw folded before Flop (didn't bet)
Seat 7: 8B/dhbQjIWe6ASCdgzktNQ folded before Flop
Seat 9: K7bAhhMMJ/XcTmGaBZVfFQ (button) folded before Flop (didn't bet)




PokerStars Game #59939490810:  Hold'em No Limit ($0.10/$0.25) - 2009/07/01 0:41:14 ET
Table '3760QYRYyCWeXf0rLZ5S2g' 9-max Seat #2 is the button
Seat 1: COsrwJSFHQtxlUcrYtDQPQ ($25 in chips) 
Seat 2: zDrucyjVn5aeekNEc3cJrA ($20.70 in chips) 
Seat 3: aLYacoAY3e5d/M5ToF8Ujw ($20.45 in chips) 
Seat 5: MG90wfSJZnOejs/KD3vlQQ ($28.85 in chips) 
Seat 6: DnDcAdn9P0zGovMERigpFA ($47.05 in chips) 
Seat 8: nl78vdCYaG2sN+td5Z33sA ($7.50 in chips) 
Seat 9: aNpwfA31EREwO+ar4XzBCw ($25 in chips) 
aLYacoAY3e5d/M5ToF8Ujw: posts small blind $0.10
MG90wfSJZnOejs/KD3vlQQ: posts big blind $0.25
*** HOLE CARDS ***
DnDcAdn9P0zGovMERigpFA: folds 
nl78vdCYaG2sN+td5Z33sA: folds 
aNpwfA31EREwO+ar4XzBCw: folds 
nl78vdCYaG2sN+td5Z33sA leaves the table
COsrwJSFHQtxlUcrYtDQPQ: folds 
zDrucyjVn5aeekNEc3cJrA: calls $0.25
aLYacoAY3e5d/M5ToF8Ujw: folds 
MG90wfSJZnOejs/KD3vlQQ: checks 
*** FLOP *** [Jd 5h 6h]
MG90wfSJZnOejs/KD3vlQQ: checks 
zDrucyjVn5aeekNEc3cJrA: checks 
*** TURN *** [Jd 5h 6h] [Ks]
K0b5wNInj6hUGRr6yzKFtw has returned
MG90wfSJZnOejs/KD3vlQQ: checks 
zDrucyjVn5aeekNEc3cJrA: bets $0.75
MG90wfSJZnOejs/KD3vlQQ: folds 
Uncalled bet ($0.75) returned to zDrucyjVn5aeekNEc3cJrA
zDrucyjVn5aeekNEc3cJrA collected $0.60 from pot
*** SUMMARY ***
Total pot $0.60 | Rake $0 
Board [Jd 5h 6h Ks]
Seat 1: COsrwJSFHQtxlUcrYtDQPQ folded before Flop (didn't bet)
Seat 2: zDrucyjVn5aeekNEc3cJrA (button) collected ($0.60)
Seat 3: aLYacoAY3e5d/M5ToF8Ujw (small blind) folded before Flop
Seat 5: MG90wfSJZnOejs/KD3vlQQ (big blind) folded on the Turn
Seat 6: DnDcAdn9P0zGovMERigpFA folded before Flop (didn't bet)
Seat 8: nl78vdCYaG2sN+td5Z33sA folded before Flop (didn't bet)
Seat 9: aNpwfA31EREwO+ar4XzBCw folded before Flop (didn't bet)




PokerStars Game #59939490876:  Hold'em No Limit ($0.10/$0.25) - 2009/07/01 0:41:14 ET
Table 'SgI2Cobdjtkh0Fd0/eTTDg' 9-max Seat #7 is the button
Seat 1: JRfCWETUoKaEo7sf/Jy3Kg ($23.90 in chips) 
Seat 2: 8B/dhbQjIWe6ASCdgzktNQ ($42.20 in chips) 
Seat 3: OiV1PWZ3IkN29JlmCcnTwQ ($4.90 in chips) 
Seat 4: 18G4P1XstjNvItdGUITxgw ($25 in chips) 
Seat 5: w/RUHfVzKTf7Bc19nucLpQ ($9.10 in chips) 
Seat 7: aJy680tKSaP5er559aSuGA ($22.35 in chips) 
Seat 9: cZ99hugmLBj9KhTlc8nCSw ($25.65 in chips) 
cZ99hugmLBj9KhTlc8nCSw: posts small blind $0.10
JRfCWETUoKaEo7sf/Jy3Kg: posts big blind $0.25
*** HOLE CARDS ***
8B/dhbQjIWe6ASCdgzktNQ: folds 
OiV1PWZ3IkN29JlmCcnTwQ: folds 
18G4P1XstjNvItdGUITxgw: folds 
w/RUHfVzKTf7Bc19nucLpQ: folds 
aJy680tKSaP5er559aSuGA: folds 
cZ99hugmLBj9KhTlc8nCSw: folds 
Uncalled bet ($0.15) returned to JRfCWETUoKaEo7sf/Jy3Kg
JRfCWETUoKaEo7sf/Jy3Kg collected $0.20 from pot
JRfCWETUoKaEo7sf/Jy3Kg: doesn't show hand 
*** SUMMARY ***
Total pot $0.20 | Rake $0 
Seat 1: JRfCWETUoKaEo7sf/Jy3Kg (big blind) collected ($0.20)
Seat 2: 8B/dhbQjIWe6ASCdgzktNQ folded before Flop (didn't bet)
Seat 3: OiV1PWZ3IkN29JlmCcnTwQ folded before Flop (didn't bet)
Seat 4: 18G4P1XstjNvItdGUITxgw folded before Flop (didn't bet)
Seat 5: w/RUHfVzKTf7Bc19nucLpQ folded before Flop (didn't bet)
Seat 7: aJy680tKSaP5er559aSuGA (button) folded before Flop (didn't bet)
Seat 9: cZ99hugmLBj9KhTlc8nCSw (small blind) folded before Flop




PokerStars Game #59939490646:  Hold'em No Limit ($0.10/$0.25) - 2009/07/01 0:41:14 ET
Table '0M5QEJGOThqZwQ/sjbjXYw' 6-max Seat #5 is the button
Seat 1: RVBrV53KVTJ2T2VL8ucnfw ($23.55 in chips) 
Seat 2: /gJNBeCkWL4o85/jvlZ4BA ($48.10 in chips) 
Seat 4: fZQg9veL7Dd/Z04ZTjC+wQ ($32.10 in chips) 
Seat 5: ErIN0JRL5srYjT6en1f8YQ ($27.10 in chips) 
Seat 6: mYz11CHiw5KsDCRD5T7/jg ($60.40 in chips) 
mYz11CHiw5KsDCRD5T7/jg: posts small blind $0.10
RVBrV53KVTJ2T2VL8ucnfw: posts big blind $0.25
*** HOLE CARDS ***
/gJNBeCkWL4o85/jvlZ4BA: raises $0.75 to $1
fZQg9veL7Dd/Z04ZTjC+wQ: folds 
ErIN0JRL5srYjT6en1f8YQ: folds 
mYz11CHiw5KsDCRD5T7/jg: calls $0.90
RVBrV53KVTJ2T2VL8ucnfw: calls $0.75
*** FLOP *** [6d Kh Qs]
mYz11CHiw5KsDCRD5T7/jg: checks 
RVBrV53KVTJ2T2VL8ucnfw: checks 
/gJNBeCkWL4o85/jvlZ4BA: checks 
*** TURN *** [6d Kh Qs] [8d]
mYz11CHiw5KsDCRD5T7/jg: bets $0.50
RVBrV53KVTJ2T2VL8ucnfw: calls $0.50
/gJNBeCkWL4o85/jvlZ4BA: folds 
*** RIVER *** [6d Kh Qs 8d] [6c]
mYz11CHiw5KsDCRD5T7/jg: bets $0.75
RVBrV53KVTJ2T2VL8ucnfw: raises $0.75 to $1.50
mYz11CHiw5KsDCRD5T7/jg: calls $0.75
*** SHOW DOWN ***
RVBrV53KVTJ2T2VL8ucnfw: shows [Qc Td] (two pair, Queens and Sixes)
mYz11CHiw5KsDCRD5T7/jg: shows [Qh Ts] (two pair, Queens and Sixes)
mYz11CHiw5KsDCRD5T7/jg collected $3.35 from pot
RVBrV53KVTJ2T2VL8ucnfw collected $3.35 from pot
*** SUMMARY ***
Total pot $7 | Rake $0.30 
Board [6d Kh Qs 8d 6c]
Seat 1: RVBrV53KVTJ2T2VL8ucnfw (big blind) showed [Qc Td] and won ($3.35) with two pair, Queens and Sixes
Seat 2: /gJNBeCkWL4o85/jvlZ4BA folded on the Turn
Seat 4: fZQg9veL7Dd/Z04ZTjC+wQ folded before Flop (didn't bet)
Seat 5: ErIN0JRL5srYjT6en1f8YQ (button) folded before Flop (didn't bet)
Seat 6: mYz11CHiw5KsDCRD5T7/jg (small blind) showed [Qh Ts] and won ($3.35) with two pair, Queens and Sixes




PokerStars Game #59939490482:  Hold'em No Limit ($0.10/$0.25) - 2009/07/01 0:41:14 ET
Table 'rpIHGyt2QpgQc5bvptAvDQ' 9-max Seat #4 is the button
Seat 1: pIK8dHf+MqCSMpnx8j9HEw ($17.15 in chips) 
Seat 2: Xpyqpb+DURDWnyJ3xTEIFQ ($27.25 in chips) 
Seat 3: RNWwL4ZL6E6nNwmoYWS4Ug ($12.25 in chips) 
Seat 4: ottZQkg1UDWk85BtBzGJzg ($13.05 in chips) 
Seat 5: F7uW1LiDD9vUDBtB+5gRDg ($13.90 in chips) 
Seat 6: gehe91e0IyVT0QU/XBkEyg ($39.70 in chips) 
Seat 7: SXqVW4Q0evTUVZG6BbUNIA ($29.60 in chips) 
Seat 8: tYsOBqdU1+x+yFI7zHO7hQ ($25 in chips) 
Seat 9: nm4Dj/f+jJEwKVsUnKh73g ($20.75 in chips) 
F7uW1LiDD9vUDBtB+5gRDg: posts small blind $0.10
gehe91e0IyVT0QU/XBkEyg: posts big blind $0.25
*** HOLE CARDS ***
SXqVW4Q0evTUVZG6BbUNIA: folds 
tYsOBqdU1+x+yFI7zHO7hQ: folds 
nm4Dj/f+jJEwKVsUnKh73g: folds 
pIK8dHf+MqCSMpnx8j9HEw: folds 
Xpyqpb+DURDWnyJ3xTEIFQ: folds 
RNWwL4ZL6E6nNwmoYWS4Ug: folds 
ottZQkg1UDWk85BtBzGJzg: raises $0.25 to $0.50
F7uW1LiDD9vUDBtB+5gRDg: calls $0.40
gehe91e0IyVT0QU/XBkEyg: folds 
*** FLOP *** [7c 4d 5s]
F7uW1LiDD9vUDBtB+5gRDg: bets $0.50
ottZQkg1UDWk85BtBzGJzg: calls $0.50
*** TURN *** [7c 4d 5s] [Kc]
F7uW1LiDD9vUDBtB+5gRDg: bets $1
ottZQkg1UDWk85BtBzGJzg: raises $2 to $3
F7uW1LiDD9vUDBtB+5gRDg: calls $2
*** RIVER *** [7c 4d 5s Kc] [3h]
F7uW1LiDD9vUDBtB+5gRDg: checks 
ottZQkg1UDWk85BtBzGJzg: bets $5
F7uW1LiDD9vUDBtB+5gRDg: calls $5
*** SHOW DOWN ***
ottZQkg1UDWk85BtBzGJzg: shows [Ts As] (high card Ace)
F7uW1LiDD9vUDBtB+5gRDg: shows [7d Ah] (a pair of Sevens)
F7uW1LiDD9vUDBtB+5gRDg collected $17.40 from pot
*** SUMMARY ***
Total pot $18.25 | Rake $0.85 
Board [7c 4d 5s Kc 3h]
Seat 1: pIK8dHf+MqCSMpnx8j9HEw folded before Flop (didn't bet)
Seat 2: Xpyqpb+DURDWnyJ3xTEIFQ folded before Flop (didn't bet)
Seat 3: RNWwL4ZL6E6nNwmoYWS4Ug folded before Flop (didn't bet)
Seat 4: ottZQkg1UDWk85BtBzGJzg (button) showed [Ts As] and lost with high card Ace
Seat 5: F7uW1LiDD9vUDBtB+5gRDg (small blind) showed [7d Ah] and won ($17.40) with a pair of Sevens
Seat 6: gehe91e0IyVT0QU/XBkEyg (big blind) folded before Flop
Seat 7: SXqVW4Q0evTUVZG6BbUNIA folded before Flop (didn't bet)
Seat 8: tYsOBqdU1+x+yFI7zHO7hQ folded before Flop (didn't bet)
Seat 9: nm4Dj/f+jJEwKVsUnKh73g folded before Flop (didn't bet)




PokerStars Game #59939490712:  Hold'em No Limit ($0.10/$0.25) - 2009/07/01 0:41:14 ET
Table 'axb9RsG8Zj1A0LEukTeFrQ' 9-max Seat #2 is the button
Seat 1: qwr38jl5txoR36M7G5qi4A ($9.90 in chips) 
Seat 2: zDrucyjVn5aeekNEc3cJrA ($22.85 in chips) 
Seat 3: cZ99hugmLBj9KhTlc8nCSw ($27.75 in chips) 
Seat 4: TeWJxSETzbXGiYKx0y+dtg ($25 in chips) 
Seat 5: rLSSHKOHnb6yzVfDoQM/RA ($11.80 in chips) 
Seat 6: FSuhElWc38JXYToR0dwhjg ($15.95 in chips) 
Seat 7: 1K6QGyJP9P9xmRac2fH4OQ ($32.20 in chips) 
Seat 8: CqwJk5Z2+vb2f9j1o7IjKQ ($28.30 in chips) 
Seat 9: qbQE8CifKB4+OEvNF/61Rw ($37.05 in chips) 
cZ99hugmLBj9KhTlc8nCSw: posts small blind $0.10
TeWJxSETzbXGiYKx0y+dtg: posts big blind $0.25
*** HOLE CARDS ***
rLSSHKOHnb6yzVfDoQM/RA: folds 
FSuhElWc38JXYToR0dwhjg: folds 
1K6QGyJP9P9xmRac2fH4OQ: folds 
CqwJk5Z2+vb2f9j1o7IjKQ: folds 
qbQE8CifKB4+OEvNF/61Rw: calls $0.25
qwr38jl5txoR36M7G5qi4A: folds 
zDrucyjVn5aeekNEc3cJrA: calls $0.25
cZ99hugmLBj9KhTlc8nCSw: folds 
TeWJxSETzbXGiYKx0y+dtg: checks 
*** FLOP *** [4h 9c 4s]
TeWJxSETzbXGiYKx0y+dtg: checks 
qbQE8CifKB4+OEvNF/61Rw: checks 
zDrucyjVn5aeekNEc3cJrA: checks 
*** TURN *** [4h 9c 4s] [5d]
TeWJxSETzbXGiYKx0y+dtg: checks 
qbQE8CifKB4+OEvNF/61Rw: checks 
zDrucyjVn5aeekNEc3cJrA: checks 
*** RIVER *** [4h 9c 4s 5d] [3s]
TeWJxSETzbXGiYKx0y+dtg: checks 
qbQE8CifKB4+OEvNF/61Rw: bets $0.25
zDrucyjVn5aeekNEc3cJrA: folds 
TeWJxSETzbXGiYKx0y+dtg: folds 
Uncalled bet ($0.25) returned to qbQE8CifKB4+OEvNF/61Rw
qbQE8CifKB4+OEvNF/61Rw collected $0.85 from pot
qbQE8CifKB4+OEvNF/61Rw: doesn't show hand 
*** SUMMARY ***
Total pot $0.85 | Rake $0 
Board [4h 9c 4s 5d 3s]
Seat 1: qwr38jl5txoR36M7G5qi4A folded before Flop (didn't bet)
Seat 2: zDrucyjVn5aeekNEc3cJrA (button) folded on the River
Seat 3: cZ99hugmLBj9KhTlc8nCSw (small blind) folded before Flop
Seat 4: TeWJxSETzbXGiYKx0y+dtg (big blind) folded on the River
Seat 5: rLSSHKOHnb6yzVfDoQM/RA folded before Flop (didn't bet)
Seat 6: FSuhElWc38JXYToR0dwhjg folded before Flop (didn't bet)
Seat 7: 1K6QGyJP9P9xmRac2fH4OQ folded before Flop (didn't bet)
Seat 8: CqwJk5Z2+vb2f9j1o7IjKQ folded before Flop (didn't bet)
Seat 9: qbQE8CifKB4+OEvNF/61Rw collected ($0.85)




PokerStars Game #59939490382:  Hold'em No Limit ($0.10/$0.25) - 2009/07/01 0:41:14 ET
Table 'l8hUTjBTXBorNUR/tyvSLw' 9-max Seat #2 is the button
Seat 2: ZeR3hkj1gVv9J4yPCmRrjA ($50.50 in chips) 
Seat 3: 6TWO15+WfJ5HfI8CbJ4a0w ($9.55 in chips) 
Seat 4: vPtFvcPtn/Afz0sucO1cmQ ($37.10 in chips) 
Seat 5: S7Ki0P+0AIGPuIfGJjW0gg ($13.60 in chips) 
Seat 6: nkD1GtC3+ft+4U3Od0H10A ($13.70 in chips) 
Seat 7: awxYB5n5W4JUl1V4Xsn26g ($4.65 in chips) 
Seat 8: kZJjw0YSgO2CZKraCg0v8g ($12.40 in chips) 
Seat 9: zDrucyjVn5aeekNEc3cJrA ($35.75 in chips) 
6TWO15+WfJ5HfI8CbJ4a0w: posts small blind $0.10
vPtFvcPtn/Afz0sucO1cmQ: posts big blind $0.25
cZ99hugmLBj9KhTlc8nCSw: sits out 
*** HOLE CARDS ***
S7Ki0P+0AIGPuIfGJjW0gg: folds 
nkD1GtC3+ft+4U3Od0H10A: folds 
awxYB5n5W4JUl1V4Xsn26g: folds 
kZJjw0YSgO2CZKraCg0v8g: folds 
zDrucyjVn5aeekNEc3cJrA: folds 
ZeR3hkj1gVv9J4yPCmRrjA: folds 
6TWO15+WfJ5HfI8CbJ4a0w: calls $0.15
vPtFvcPtn/Afz0sucO1cmQ: checks 
*** FLOP *** [Th 6d Jh]
6TWO15+WfJ5HfI8CbJ4a0w: bets $0.25
vPtFvcPtn/Afz0sucO1cmQ: calls $0.25
*** TURN *** [Th 6d Jh] [6h]
6TWO15+WfJ5HfI8CbJ4a0w: checks 
vPtFvcPtn/Afz0sucO1cmQ: bets $0.50
6TWO15+WfJ5HfI8CbJ4a0w: folds 
Uncalled bet ($0.50) returned to vPtFvcPtn/Afz0sucO1cmQ
vPtFvcPtn/Afz0sucO1cmQ collected $0.95 from pot
vPtFvcPtn/Afz0sucO1cmQ: doesn't show hand 
*** SUMMARY ***
Total pot $1 | Rake $0.05 
Board [Th 6d Jh 6h]
Seat 2: ZeR3hkj1gVv9J4yPCmRrjA (button) folded before Flop (didn't bet)
Seat 3: 6TWO15+WfJ5HfI8CbJ4a0w (small blind) folded on the Turn
Seat 4: vPtFvcPtn/Afz0sucO1cmQ (big blind) collected ($0.95)
Seat 5: S7Ki0P+0AIGPuIfGJjW0gg folded before Flop (didn't bet)
Seat 6: nkD1GtC3+ft+4U3Od0H10A folded before Flop (didn't bet)
Seat 7: awxYB5n5W4JUl1V4Xsn26g folded before Flop (didn't bet)
Seat 8: kZJjw0YSgO2CZKraCg0v8g folded before Flop (didn't bet)
Seat 9: zDrucyjVn5aeekNEc3cJrA folded before Flop (didn't bet)




PokerStars Game #59939490814:  Hold'em No Limit ($0.10/$0.25) - 2009/07/01 0:41:14 ET
Table 'nteM56rtr9SxLEblf0fvbw' 9-max Seat #8 is the button
Seat 1: H9KUl8cmpLgEpOVDA00bCg ($5 in chips) 
Seat 2: ljemhp25Zg+nlA9DLCIiUw ($25.95 in chips) 
Seat 4: cZ99hugmLBj9KhTlc8nCSw ($25.50 in chips) 
Seat 5: aJy680tKSaP5er559aSuGA ($10.30 in chips) 
Seat 6: LH8Esb23EO9V9GrKx+ymWQ ($5 in chips) 
Seat 7: dfNim92Z6XK1/h5SFW5vDg ($49.30 in chips) 
Seat 8: RJ/x9oZtt1RZLaJEQwZOxQ ($43.80 in chips) 
Seat 9: t2nb95S5EEFOEzNx9Itz0g ($6.65 in chips) 
t2nb95S5EEFOEzNx9Itz0g: posts small blind $0.10
H9KUl8cmpLgEpOVDA00bCg: posts big blind $0.25
LH8Esb23EO9V9GrKx+ymWQ: posts big blind $0.25
*** HOLE CARDS ***
ljemhp25Zg+nlA9DLCIiUw: folds 
cZ99hugmLBj9KhTlc8nCSw: folds 
aJy680tKSaP5er559aSuGA: folds 
LH8Esb23EO9V9GrKx+ymWQ: checks 
dfNim92Z6XK1/h5SFW5vDg: folds 
RJ/x9oZtt1RZLaJEQwZOxQ: raises $0.75 to $1
t2nb95S5EEFOEzNx9Itz0g: folds 
H9KUl8cmpLgEpOVDA00bCg: folds 
LH8Esb23EO9V9GrKx+ymWQ: folds 
Uncalled bet ($0.75) returned to RJ/x9oZtt1RZLaJEQwZOxQ
RJ/x9oZtt1RZLaJEQwZOxQ collected $0.85 from pot
RJ/x9oZtt1RZLaJEQwZOxQ: doesn't show hand 
*** SUMMARY ***
Total pot $0.85 | Rake $0 
Seat 1: H9KUl8cmpLgEpOVDA00bCg (big blind) folded before Flop
Seat 2: ljemhp25Zg+nlA9DLCIiUw folded before Flop (didn't bet)
Seat 4: cZ99hugmLBj9KhTlc8nCSw folded before Flop (didn't bet)
Seat 5: aJy680tKSaP5er559aSuGA folded before Flop (didn't bet)
Seat 6: LH8Esb23EO9V9GrKx+ymWQ folded before Flop
Seat 7: dfNim92Z6XK1/h5SFW5vDg folded before Flop (didn't bet)
Seat 8: RJ/x9oZtt1RZLaJEQwZOxQ (button) collected ($0.85)
Seat 9: t2nb95S5EEFOEzNx9Itz0g (small blind) folded before Flop




PokerStars Game #59939491510:  Hold'em No Limit ($0.10/$0.25) - 2009/07/01 0:41:15 ET
Table '/AhP8uWRzEEhOATYIdmn0A' 9-max Seat #7 is the button
Seat 1: +sbyWwIcFp9kP0bDtMegfQ ($23.75 in chips) 
Seat 2: nvWCCH1JBjMjQkSaXl2Mog ($17.30 in chips) 
Seat 3: vSkQm2EelzwRGDDQQk0Fqw ($4.65 in chips) 
Seat 5: BEIBUu2pIflPrCL+Iks4CQ ($13.50 in chips) 
Seat 6: 1K6QGyJP9P9xmRac2fH4OQ ($25.35 in chips) 
Seat 7: 4oA316mXLIui1QY63GXBUg ($25 in chips) 
Seat 8: CYkY0dNBaYaKs8HVCVn3mQ ($4.75 in chips) 
Seat 9: DIBbjEYGs+TVdVgEB/4+3w ($29.25 in chips) 
CYkY0dNBaYaKs8HVCVn3mQ: posts small blind $0.10
DIBbjEYGs+TVdVgEB/4+3w: posts big blind $0.25
*** HOLE CARDS ***
+sbyWwIcFp9kP0bDtMegfQ: folds 
nvWCCH1JBjMjQkSaXl2Mog: folds 
vSkQm2EelzwRGDDQQk0Fqw: folds 
BEIBUu2pIflPrCL+Iks4CQ: folds 
1K6QGyJP9P9xmRac2fH4OQ: folds 
4oA316mXLIui1QY63GXBUg: folds 
CYkY0dNBaYaKs8HVCVn3mQ: folds 
Uncalled bet ($0.15) returned to DIBbjEYGs+TVdVgEB/4+3w
DIBbjEYGs+TVdVgEB/4+3w collected $0.20 from pot
*** SUMMARY ***
Total pot $0.20 | Rake $0 
Seat 1: +sbyWwIcFp9kP0bDtMegfQ folded before Flop (didn't bet)
Seat 2: nvWCCH1JBjMjQkSaXl2Mog folded before Flop (didn't bet)
Seat 3: vSkQm2EelzwRGDDQQk0Fqw folded before Flop (didn't bet)
Seat 5: BEIBUu2pIflPrCL+Iks4CQ folded before Flop (didn't bet)
Seat 6: 1K6QGyJP9P9xmRac2fH4OQ folded before Flop (didn't bet)
Seat 7: 4oA316mXLIui1QY63GXBUg (button) folded before Flop (didn't bet)
Seat 8: CYkY0dNBaYaKs8HVCVn3mQ (small blind) folded before Flop
Seat 9: DIBbjEYGs+TVdVgEB/4+3w (big blind) collected ($0.20)




PokerStars Game #59939491342:  Hold'em No Limit ($0.10/$0.25) - 2009/07/01 0:41:15 ET
Table '5NipxzzFB2DffzDpddyQoQ' 6-max Seat #3 is the button
Seat 1: TslQs7AQSLbVtr4X8JOOOQ ($11.60 in chips) 
Seat 2: jxrNE4qd8KCOIqHjQcwCrA ($40.45 in chips) 
Seat 3: qGHGf/553gQnDoklMRe3tg ($49.05 in chips) 
Seat 4: Inq44d7PQ+8TbEKfPeuxVQ ($6.10 in chips) 
Seat 5: cS21pIxRHx5Gt42o7hPZzw ($13.55 in chips) 
Seat 6: lYjWCpfCxX2kgcHY3v4Yow ($27.65 in chips) 
Inq44d7PQ+8TbEKfPeuxVQ: posts small blind $0.10
cS21pIxRHx5Gt42o7hPZzw: posts big blind $0.25
*** HOLE CARDS ***
lYjWCpfCxX2kgcHY3v4Yow: folds 
TslQs7AQSLbVtr4X8JOOOQ: folds 
jxrNE4qd8KCOIqHjQcwCrA: raises $0.75 to $1
qGHGf/553gQnDoklMRe3tg: folds 
Inq44d7PQ+8TbEKfPeuxVQ: calls $0.90
cS21pIxRHx5Gt42o7hPZzw: folds 
*** FLOP *** [9h 5c 7s]
Inq44d7PQ+8TbEKfPeuxVQ: checks 
jxrNE4qd8KCOIqHjQcwCrA: bets $1
Inq44d7PQ+8TbEKfPeuxVQ: calls $1
*** TURN *** [9h 5c 7s] [Jc]
Inq44d7PQ+8TbEKfPeuxVQ: checks 
jxrNE4qd8KCOIqHjQcwCrA: bets $2.25
Inq44d7PQ+8TbEKfPeuxVQ: folds 
Uncalled bet ($2.25) returned to jxrNE4qd8KCOIqHjQcwCrA
jxrNE4qd8KCOIqHjQcwCrA collected $4.05 from pot
jxrNE4qd8KCOIqHjQcwCrA: doesn't show hand 
*** SUMMARY ***
Total pot $4.25 | Rake $0.20 
Board [9h 5c 7s Jc]
Seat 1: TslQs7AQSLbVtr4X8JOOOQ folded before Flop (didn't bet)
Seat 2: jxrNE4qd8KCOIqHjQcwCrA collected ($4.05)
Seat 3: qGHGf/553gQnDoklMRe3tg (button) folded before Flop (didn't bet)
Seat 4: Inq44d7PQ+8TbEKfPeuxVQ (small blind) folded on the Turn
Seat 5: cS21pIxRHx5Gt42o7hPZzw (big blind) folded before Flop
Seat 6: lYjWCpfCxX2kgcHY3v4Yow folded before Flop (didn't bet)




PokerStars Game #59939492052:  Hold'em No Limit ($0.10/$0.25) - 2009/07/01 0:41:16 ET
Table 'rjcb+nlE+0GuJ6lBhuCkkA' 6-max Seat #6 is the button
Seat 1: 9jSiy0meE9XJKkdIZwyTEQ ($26.15 in chips) 
Seat 2: d9ecz4Yhx6qRKe5k+fUWdw ($18.70 in chips) 
Seat 3: 8ClCHtFXGNplITm+63KB+Q ($25 in chips) 
Seat 4: NzIFHwilc5zU7QhjDTgTZA ($13.05 in chips) 
Seat 5: GC/9yVD59DUCX7hUI7gcLw ($43.50 in chips) 
Seat 6: 0DvgWV5o6c/jYqQCjm4Haw ($33.65 in chips) 
9jSiy0meE9XJKkdIZwyTEQ: posts small blind $0.10
d9ecz4Yhx6qRKe5k+fUWdw: posts big blind $0.25
*** HOLE CARDS ***
8ClCHtFXGNplITm+63KB+Q: folds 
NzIFHwilc5zU7QhjDTgTZA: calls $0.25
GC/9yVD59DUCX7hUI7gcLw: raises $1 to $1.25
0DvgWV5o6c/jYqQCjm4Haw: folds 
9jSiy0meE9XJKkdIZwyTEQ: folds 
d9ecz4Yhx6qRKe5k+fUWdw: folds 
NzIFHwilc5zU7QhjDTgTZA: folds 
Uncalled bet ($1) returned to GC/9yVD59DUCX7hUI7gcLw
GC/9yVD59DUCX7hUI7gcLw collected $0.85 from pot
*** SUMMARY ***
Total pot $0.85 | Rake $0 
Seat 1: 9jSiy0meE9XJKkdIZwyTEQ (small blind) folded before Flop
Seat 2: d9ecz4Yhx6qRKe5k+fUWdw (big blind) folded before Flop
Seat 3: 8ClCHtFXGNplITm+63KB+Q folded before Flop (didn't bet)
Seat 4: NzIFHwilc5zU7QhjDTgTZA folded before Flop
Seat 5: GC/9yVD59DUCX7hUI7gcLw collected ($0.85)
Seat 6: 0DvgWV5o6c/jYqQCjm4Haw (button) folded before Flop (didn't bet)




PokerStars Game #59939492360:  Hold'em No Limit ($0.10/$0.25) - 2009/07/01 0:41:16 ET
Table 'yRuHgMpxv4rPBXeM6HFESw' 6-max Seat #6 is the button
Seat 1: MkNgTuvyxpHXkeIm5JITHQ ($7.90 in chips) 
Seat 2: iwlxXocltgSdaBmusNXanQ ($15.45 in chips) 
Seat 3: zZ8zH49EwNs0mqgppOaL9g ($50.55 in chips) 
Seat 4: ypXnt+kzrF/5y8QN2rkt1A ($20.95 in chips) 
Seat 5: gaPMxLGp9SOj4Lq6t+/0Ig ($13.65 in chips) 
Seat 6: 4YSTu0Cdzpppe1lUgCZGCQ ($26.15 in chips) 
MkNgTuvyxpHXkeIm5JITHQ: posts small blind $0.10
iwlxXocltgSdaBmusNXanQ: posts big blind $0.25
*** HOLE CARDS ***
zZ8zH49EwNs0mqgppOaL9g is disconnected 
zZ8zH49EwNs0mqgppOaL9g has timed out while disconnected
zZ8zH49EwNs0mqgppOaL9g: folds 
zZ8zH49EwNs0mqgppOaL9g is sitting out
ypXnt+kzrF/5y8QN2rkt1A: folds 
gaPMxLGp9SOj4Lq6t+/0Ig: folds 
4YSTu0Cdzpppe1lUgCZGCQ: folds 
MkNgTuvyxpHXkeIm5JITHQ: folds 
Uncalled bet ($0.15) returned to iwlxXocltgSdaBmusNXanQ
iwlxXocltgSdaBmusNXanQ collected $0.20 from pot
*** SUMMARY ***
Total pot $0.20 | Rake $0 
Seat 1: MkNgTuvyxpHXkeIm5JITHQ (small blind) folded before Flop
Seat 2: iwlxXocltgSdaBmusNXanQ (big blind) collected ($0.20)
Seat 3: zZ8zH49EwNs0mqgppOaL9g folded before Flop (didn't bet)
Seat 4: ypXnt+kzrF/5y8QN2rkt1A folded before Flop (didn't bet)
Seat 5: gaPMxLGp9SOj4Lq6t+/0Ig folded before Flop (didn't bet)
Seat 6: 4YSTu0Cdzpppe1lUgCZGCQ (button) folded before Flop (didn't bet)




PokerStars Game #59939492070:  Hold'em No Limit ($0.10/$0.25) - 2009/07/01 0:41:16 ET
Table 'wPWRBZPJl1HAnysw7qRR0A' 6-max Seat #6 is the button
Seat 1: cPO/1/dTcZpLkQFm3jH3Rg ($49.35 in chips) 
Seat 2: 48oT5xFI+5CHUJlfoGrE4w ($7.70 in chips) 
Seat 4: kbpWbC+dJNBphHl1jtw7bw ($24.20 in chips) 
Seat 5: LtASJ9OlkqGrrUKGQlpGAw ($21.80 in chips) 
Seat 6: VLoE/jniCqHZuUkx8Esf6w ($27.05 in chips) 
cPO/1/dTcZpLkQFm3jH3Rg: posts small blind $0.10
48oT5xFI+5CHUJlfoGrE4w: posts big blind $0.25
gqW2aBCmrIw65BvwjTFN6Q: sits out 
*** HOLE CARDS ***
kbpWbC+dJNBphHl1jtw7bw: folds 
LtASJ9OlkqGrrUKGQlpGAw: folds 
VLoE/jniCqHZuUkx8Esf6w: folds 
cPO/1/dTcZpLkQFm3jH3Rg: folds 
Uncalled bet ($0.15) returned to 48oT5xFI+5CHUJlfoGrE4w
48oT5xFI+5CHUJlfoGrE4w collected $0.20 from pot
48oT5xFI+5CHUJlfoGrE4w: doesn't show hand 
*** SUMMARY ***
Total pot $0.20 | Rake $0 
Seat 1: cPO/1/dTcZpLkQFm3jH3Rg (small blind) folded before Flop
Seat 2: 48oT5xFI+5CHUJlfoGrE4w (big blind) collected ($0.20)
Seat 4: kbpWbC+dJNBphHl1jtw7bw folded before Flop (didn't bet)
Seat 5: LtASJ9OlkqGrrUKGQlpGAw folded before Flop (didn't bet)
Seat 6: VLoE/jniCqHZuUkx8Esf6w (button) folded before Flop (didn't bet)




PokerStars Game #59939491984:  Hold'em No Limit ($0.10/$0.25) - 2009/07/01 0:41:16 ET
Table '9o8Yb3JpUqurD4pNVmOikQ' 6-max Seat #3 is the button
Seat 1: 5tB0F9NjPSUL4FzmzBMs2Q ($25 in chips) 
Seat 2: /gJNBeCkWL4o85/jvlZ4BA ($25 in chips) 
Seat 3: JgRqo1/2phbf7pab7N3BIQ ($7.35 in chips) 
Seat 4: YaAEMJGY5tem39deCUQRNw ($41.80 in chips) 
Seat 6: k9vn40MOqqb+xF+7GZ6v2g ($34.90 in chips) 
YaAEMJGY5tem39deCUQRNw: posts small blind $0.10
k9vn40MOqqb+xF+7GZ6v2g: posts big blind $0.25
*** HOLE CARDS ***
5tB0F9NjPSUL4FzmzBMs2Q: raises $0.75 to $1
/gJNBeCkWL4o85/jvlZ4BA: folds 
JgRqo1/2phbf7pab7N3BIQ: folds 
YaAEMJGY5tem39deCUQRNw: folds 
k9vn40MOqqb+xF+7GZ6v2g: folds 
Uncalled bet ($0.75) returned to 5tB0F9NjPSUL4FzmzBMs2Q
5tB0F9NjPSUL4FzmzBMs2Q collected $0.60 from pot
*** SUMMARY ***
Total pot $0.60 | Rake $0 
Seat 1: 5tB0F9NjPSUL4FzmzBMs2Q collected ($0.60)
Seat 2: /gJNBeCkWL4o85/jvlZ4BA folded before Flop (didn't bet)
Seat 3: JgRqo1/2phbf7pab7N3BIQ (button) folded before Flop (didn't bet)
Seat 4: YaAEMJGY5tem39deCUQRNw (small blind) folded before Flop
Seat 6: k9vn40MOqqb+xF+7GZ6v2g (big blind) folded before Flop




PokerStars Game #59939492348:  Hold'em No Limit ($0.10/$0.25) - 2009/07/01 0:41:16 ET
Table 'S6s+TmTlAjLHclBRvN5/fw' 9-max Seat #2 is the button
Seat 1: /XMgGtJ7mcWfe5s7McY9kw ($24.60 in chips) 
Seat 2: GGVjFwYkbwsuyKljxyML4g ($11.65 in chips) 
Seat 3: imHPFFqvfHGzsBBWeGuy4w ($21.05 in chips) 
Seat 4: M/9j4wkHH9i1JM51vgi1VA ($38.95 in chips) 
Seat 5: z5GxcHlYz/GSz6W2uFiTtg ($25.05 in chips) 
Seat 6: aNpwfA31EREwO+ar4XzBCw ($25.20 in chips) 
Seat 7: vSkQm2EelzwRGDDQQk0Fqw ($5.65 in chips) 
Seat 9: BODayQmPi2rEfae9e6hIlw ($28.80 in chips) 
imHPFFqvfHGzsBBWeGuy4w: posts small blind $0.10
42xLFHn85WRGGaaUZTNvwA joins the table at seat #8 
M/9j4wkHH9i1JM51vgi1VA: posts big blind $0.25
*** HOLE CARDS ***
z5GxcHlYz/GSz6W2uFiTtg: folds 
aNpwfA31EREwO+ar4XzBCw: folds 
vSkQm2EelzwRGDDQQk0Fqw: raises $0.75 to $1
BODayQmPi2rEfae9e6hIlw: folds 
/XMgGtJ7mcWfe5s7McY9kw: folds 
GGVjFwYkbwsuyKljxyML4g: folds 
imHPFFqvfHGzsBBWeGuy4w: folds 
M/9j4wkHH9i1JM51vgi1VA: folds 
Uncalled bet ($0.75) returned to vSkQm2EelzwRGDDQQk0Fqw
vSkQm2EelzwRGDDQQk0Fqw collected $0.60 from pot
vSkQm2EelzwRGDDQQk0Fqw: doesn't show hand 
*** SUMMARY ***
Total pot $0.60 | Rake $0 
Seat 1: /XMgGtJ7mcWfe5s7McY9kw folded before Flop (didn't bet)
Seat 2: GGVjFwYkbwsuyKljxyML4g (button) folded before Flop (didn't bet)
Seat 3: imHPFFqvfHGzsBBWeGuy4w (small blind) folded before Flop
Seat 4: M/9j4wkHH9i1JM51vgi1VA (big blind) folded before Flop
Seat 5: z5GxcHlYz/GSz6W2uFiTtg folded before Flop (didn't bet)
Seat 6: aNpwfA31EREwO+ar4XzBCw folded before Flop (didn't bet)
Seat 7: vSkQm2EelzwRGDDQQk0Fqw collected ($0.60)
Seat 9: BODayQmPi2rEfae9e6hIlw folded before Flop (didn't bet)




PokerStars Game #59939491876:  Hold'em No Limit ($0.10/$0.25) - 2009/07/01 0:41:16 ET
Table 'zhqgUUprOJ14VxKxPHcT/Q' 9-max Seat #5 is the button
Seat 2: GY095KWhBevJ1Ttvl8WseA ($6.65 in chips) 
Seat 3: G2offPrpnppc++nuXqs2JA ($17.25 in chips) 
Seat 4: EfeOSXE8Wc4WWEsgc3WzZg ($8.20 in chips) 
Seat 5: +sbyWwIcFp9kP0bDtMegfQ ($26.75 in chips) 
Seat 6: DIBbjEYGs+TVdVgEB/4+3w ($22.85 in chips) 
Seat 7: Ebzw1YytWRd/vXFjA8XReg ($25 in chips) 
Seat 8: amD2PwT1xB7aC2k57sa7Ig ($29.20 in chips) 
Seat 9: 4awUyiDYTgylQKXZ9faBVA ($36.10 in chips) 
DIBbjEYGs+TVdVgEB/4+3w: posts small blind $0.10
Ebzw1YytWRd/vXFjA8XReg: posts big blind $0.25
GY095KWhBevJ1Ttvl8WseA: posts big blind $0.25
*** HOLE CARDS ***
amD2PwT1xB7aC2k57sa7Ig: folds 
4awUyiDYTgylQKXZ9faBVA: folds 
GY095KWhBevJ1Ttvl8WseA: checks 
G2offPrpnppc++nuXqs2JA: folds 
EfeOSXE8Wc4WWEsgc3WzZg: folds 
+sbyWwIcFp9kP0bDtMegfQ: folds 
DIBbjEYGs+TVdVgEB/4+3w: calls $0.15
Ebzw1YytWRd/vXFjA8XReg: checks 
*** FLOP *** [6s 7s 8h]
DIBbjEYGs+TVdVgEB/4+3w: checks 
Ebzw1YytWRd/vXFjA8XReg: checks 
GY095KWhBevJ1Ttvl8WseA: bets $1
DIBbjEYGs+TVdVgEB/4+3w: folds 
Ebzw1YytWRd/vXFjA8XReg: folds 
Uncalled bet ($1) returned to GY095KWhBevJ1Ttvl8WseA
GY095KWhBevJ1Ttvl8WseA collected $0.75 from pot
GY095KWhBevJ1Ttvl8WseA: doesn't show hand 
*** SUMMARY ***
Total pot $0.75 | Rake $0 
Board [6s 7s 8h]
Seat 2: GY095KWhBevJ1Ttvl8WseA collected ($0.75)
Seat 3: G2offPrpnppc++nuXqs2JA folded before Flop (didn't bet)
Seat 4: EfeOSXE8Wc4WWEsgc3WzZg folded before Flop (didn't bet)
Seat 5: +sbyWwIcFp9kP0bDtMegfQ (button) folded before Flop (didn't bet)
Seat 6: DIBbjEYGs+TVdVgEB/4+3w (small blind) folded on the Flop
Seat 7: Ebzw1YytWRd/vXFjA8XReg (big blind) folded on the Flop
Seat 8: amD2PwT1xB7aC2k57sa7Ig folded before Flop (didn't bet)
Seat 9: 4awUyiDYTgylQKXZ9faBVA folded before Flop (didn't bet)




PokerStars Game #59939492300:  Hold'em No Limit ($0.10/$0.25) - 2009/07/01 0:41:16 ET
Table 'vud0GB/ZlDCvUFhBFIaTlg' 9-max Seat #7 is the button
Seat 5: AwAabNdwDsTMb3aTomdOmg ($5.05 in chips) 
Seat 7: RzaVufWfW9CTnVYR7/Ge+w ($3 in chips) 
RzaVufWfW9CTnVYR7/Ge+w: posts small blind $0.10
AwAabNdwDsTMb3aTomdOmg: posts big blind $0.25
*** HOLE CARDS ***
RzaVufWfW9CTnVYR7/Ge+w: raises $0.25 to $0.50
AwAabNdwDsTMb3aTomdOmg: folds 
Uncalled bet ($0.25) returned to RzaVufWfW9CTnVYR7/Ge+w
RzaVufWfW9CTnVYR7/Ge+w collected $0.50 from pot
RzaVufWfW9CTnVYR7/Ge+w: shows [Ad Ks] (high card Ace)
*** SUMMARY ***
Total pot $0.50 | Rake $0 
Seat 5: AwAabNdwDsTMb3aTomdOmg (big blind) folded before Flop
Seat 7: RzaVufWfW9CTnVYR7/Ge+w (button) (small blind) collected ($0.50)




PokerStars Game #59939492332:  Hold'em No Limit ($0.10/$0.25) - 2009/07/01 0:41:16 ET
Table '4ZbiE0ZYjzqmgu6+sO1prg' 9-max Seat #9 is the button
Seat 1: N6fYvIzQLKaydFLKQGtMlQ ($25.65 in chips) 
Seat 2: w31DkWCTQDVIzsHIrFRDxA ($17.15 in chips) 
Seat 3: HPEB+AtKw1+C/cxU0o1ciw ($23.80 in chips) 
Seat 4: Eb2mDXvZ4iY02krYdOYwMA ($22.90 in chips) 
Seat 5: COsrwJSFHQtxlUcrYtDQPQ ($25 in chips) 
Seat 6: rXm4QDVJt67H20lM6n6Z7Q ($7.90 in chips) 
Seat 7: 3RCAkueG3Vc13VpRStCB+w ($21.05 in chips) 
Seat 8: cZ99hugmLBj9KhTlc8nCSw ($25 in chips) 
Seat 9: 1K6QGyJP9P9xmRac2fH4OQ ($99.10 in chips) 
N6fYvIzQLKaydFLKQGtMlQ: posts small blind $0.10
w31DkWCTQDVIzsHIrFRDxA: posts big blind $0.25
*** HOLE CARDS ***
HPEB+AtKw1+C/cxU0o1ciw: calls $0.25
Eb2mDXvZ4iY02krYdOYwMA: folds 
COsrwJSFHQtxlUcrYtDQPQ: folds 
rXm4QDVJt67H20lM6n6Z7Q: folds 
3RCAkueG3Vc13VpRStCB+w: folds 
cZ99hugmLBj9KhTlc8nCSw: folds 
1K6QGyJP9P9xmRac2fH4OQ: raises $0.75 to $1
N6fYvIzQLKaydFLKQGtMlQ: folds 
w31DkWCTQDVIzsHIrFRDxA: folds 
HPEB+AtKw1+C/cxU0o1ciw: raises $1.50 to $2.50
1K6QGyJP9P9xmRac2fH4OQ: folds 
Uncalled bet ($1.50) returned to HPEB+AtKw1+C/cxU0o1ciw
HPEB+AtKw1+C/cxU0o1ciw collected $2.35 from pot
HPEB+AtKw1+C/cxU0o1ciw: doesn't show hand 
*** SUMMARY ***
Total pot $2.35 | Rake $0 
Seat 1: N6fYvIzQLKaydFLKQGtMlQ (small blind) folded before Flop
Seat 2: w31DkWCTQDVIzsHIrFRDxA (big blind) folded before Flop
Seat 3: HPEB+AtKw1+C/cxU0o1ciw collected ($2.35)
Seat 4: Eb2mDXvZ4iY02krYdOYwMA folded before Flop (didn't bet)
Seat 5: COsrwJSFHQtxlUcrYtDQPQ folded before Flop (didn't bet)
Seat 6: rXm4QDVJt67H20lM6n6Z7Q folded before Flop (didn't bet)
Seat 7: 3RCAkueG3Vc13VpRStCB+w folded before Flop (didn't bet)
Seat 8: cZ99hugmLBj9KhTlc8nCSw folded before Flop (didn't bet)
Seat 9: 1K6QGyJP9P9xmRac2fH4OQ (button) folded before Flop




PokerStars Game #59939492936:  Hold'em No Limit ($0.10/$0.25) - 2009/07/01 0:41:17 ET
Table 'ONP9SkU1SytzTLuNlKzIPw' 9-max Seat #3 is the button
Seat 1: s7Q6uNouhe7aE8JdFb9E+A ($33.95 in chips) 
Seat 2: sJNHTWcSlLHRCZ9+YRLLqA ($25.50 in chips) 
Seat 3: 4BZw8NrbfRfUJKKKd1c2vA ($9.40 in chips) 
Seat 4: rKgOH+UzKBirOiqIwBD9Nw ($7.45 in chips) 
Seat 5: lSeLm4BdnSMLtIli62qjAQ ($4.50 in chips) 
Seat 6: 6X6eofOkuCCdkJdReOpjUQ ($25.10 in chips) 
Seat 7: DiSvPC2iudwL5j9u6Huyww ($26.20 in chips) 
Seat 8: sUVgUtgbfVx6JpvApozwhQ ($5 in chips) 
rKgOH+UzKBirOiqIwBD9Nw: posts small blind $0.10
lSeLm4BdnSMLtIli62qjAQ: posts big blind $0.25
yyG4svzOpC1A+sUP/scg6w: sits out 
*** HOLE CARDS ***
6X6eofOkuCCdkJdReOpjUQ: folds 
DiSvPC2iudwL5j9u6Huyww: folds 
sUVgUtgbfVx6JpvApozwhQ: folds 
s7Q6uNouhe7aE8JdFb9E+A: folds 
sJNHTWcSlLHRCZ9+YRLLqA: folds 
4BZw8NrbfRfUJKKKd1c2vA: folds 
rKgOH+UzKBirOiqIwBD9Nw: raises $0.25 to $0.50
lSeLm4BdnSMLtIli62qjAQ: calls $0.25
*** FLOP *** [2c 7h Ac]
rKgOH+UzKBirOiqIwBD9Nw: bets $0.25
lSeLm4BdnSMLtIli62qjAQ: folds 
Uncalled bet ($0.25) returned to rKgOH+UzKBirOiqIwBD9Nw
rKgOH+UzKBirOiqIwBD9Nw collected $0.95 from pot
rKgOH+UzKBirOiqIwBD9Nw: doesn't show hand 
*** SUMMARY ***
Total pot $1 | Rake $0.05 
Board [2c 7h Ac]
Seat 1: s7Q6uNouhe7aE8JdFb9E+A folded before Flop (didn't bet)
Seat 2: sJNHTWcSlLHRCZ9+YRLLqA folded before Flop (didn't bet)
Seat 3: 4BZw8NrbfRfUJKKKd1c2vA (button) folded before Flop (didn't bet)
Seat 4: rKgOH+UzKBirOiqIwBD9Nw (small blind) collected ($0.95)
Seat 5: lSeLm4BdnSMLtIli62qjAQ (big blind) folded on the Flop
Seat 6: 6X6eofOkuCCdkJdReOpjUQ folded before Flop (didn't bet)
Seat 7: DiSvPC2iudwL5j9u6Huyww folded before Flop (didn't bet)
Seat 8: sUVgUtgbfVx6JpvApozwhQ folded before Flop (didn't bet)




PokerStars Game #59939492682:  Hold'em No Limit ($0.10/$0.25) - 2009/07/01 0:41:17 ET
Table 'yAHDCs33TIgw3ra63xuU2Q' 9-max Seat #1 is the button
Seat 1: 8B/dhbQjIWe6ASCdgzktNQ ($26.40 in chips) 
Seat 2: LBrhQVB4w41YNd7kMYn/og ($19.10 in chips) 
Seat 3: H9KUl8cmpLgEpOVDA00bCg ($4.30 in chips) 
Seat 4: rUdM7gwmNCaxMNSb2CFPhQ ($11 in chips) 
Seat 5: 4awUyiDYTgylQKXZ9faBVA ($25 in chips) 
Seat 7: OiV1PWZ3IkN29JlmCcnTwQ ($4.90 in chips) 
Seat 8: tYsOBqdU1+x+yFI7zHO7hQ ($28.70 in chips) 
Seat 9: k+ydNCnnP3Hgwh0AnDYVrA ($13.50 in chips) 
LBrhQVB4w41YNd7kMYn/og: posts small blind $0.10
H9KUl8cmpLgEpOVDA00bCg: posts big blind $0.25
Z5ZtGOON8kmSdSCll9Z3XA: sits out 
*** HOLE CARDS ***
rUdM7gwmNCaxMNSb2CFPhQ: folds 
4awUyiDYTgylQKXZ9faBVA: folds 
OiV1PWZ3IkN29JlmCcnTwQ: folds 
tYsOBqdU1+x+yFI7zHO7hQ: folds 
k+ydNCnnP3Hgwh0AnDYVrA: folds 
8B/dhbQjIWe6ASCdgzktNQ: folds 
LBrhQVB4w41YNd7kMYn/og: calls $0.15
H9KUl8cmpLgEpOVDA00bCg: checks 
*** FLOP *** [Ts Js 9s]
LBrhQVB4w41YNd7kMYn/og: checks 
H9KUl8cmpLgEpOVDA00bCg: checks 
*** TURN *** [Ts Js 9s] [5h]
LBrhQVB4w41YNd7kMYn/og: bets $0.50
H9KUl8cmpLgEpOVDA00bCg: calls $0.50
*** RIVER *** [Ts Js 9s 5h] [As]
LBrhQVB4w41YNd7kMYn/og: checks 
H9KUl8cmpLgEpOVDA00bCg: checks 
*** SHOW DOWN ***
LBrhQVB4w41YNd7kMYn/og: shows [7c 6s] (a flush, Ace high)
H9KUl8cmpLgEpOVDA00bCg: mucks hand 
LBrhQVB4w41YNd7kMYn/og collected $1.45 from pot
*** SUMMARY ***
Total pot $1.50 | Rake $0.05 
Board [Ts Js 9s 5h As]
Seat 1: 8B/dhbQjIWe6ASCdgzktNQ (button) folded before Flop (didn't bet)
Seat 2: LBrhQVB4w41YNd7kMYn/og (small blind) showed [7c 6s] and won ($1.45) with a flush, Ace high
Seat 3: H9KUl8cmpLgEpOVDA00bCg (big blind) mucked
Seat 4: rUdM7gwmNCaxMNSb2CFPhQ folded before Flop (didn't bet)
Seat 5: 4awUyiDYTgylQKXZ9faBVA folded before Flop (didn't bet)
Seat 7: OiV1PWZ3IkN29JlmCcnTwQ folded before Flop (didn't bet)
Seat 8: tYsOBqdU1+x+yFI7zHO7hQ folded before Flop (didn't bet)
Seat 9: k+ydNCnnP3Hgwh0AnDYVrA folded before Flop (didn't bet)




PokerStars Game #59939492960:  Hold'em No Limit ($0.10/$0.25) - 2009/07/01 0:41:17 ET
Table 'Ez9TB43XM4QgMDQkIW9DYw' 9-max Seat #4 is the button
Seat 1: YqWNLUj3exwMphJEDBi8Ug ($29.25 in chips) 
Seat 2: gtLY9BJ1dcPGyJ0NDNjaBg ($10.40 in chips) 
Seat 3: LorpmCSxb4uozpKwk8Awsg ($27.15 in chips) 
Seat 4: il+NK449FnwuQ8vyJ0Xn/g ($9 in chips) 
Seat 5: vZGoOTJLQLhkPj4I+LNGig ($25.35 in chips) 
Seat 6: 76o85YBHJ9veRYp2LPuluQ ($31 in chips) 
Seat 7: 18G4P1XstjNvItdGUITxgw ($25 in chips) 
Seat 9: QEbIGci+itdw+re8RM5fZA ($25 in chips) 
vZGoOTJLQLhkPj4I+LNGig: posts small blind $0.10
76o85YBHJ9veRYp2LPuluQ: posts big blind $0.25
+2kMBNpY4nF1qNCRd8SJLA: sits out 
*** HOLE CARDS ***
18G4P1XstjNvItdGUITxgw: folds 
QEbIGci+itdw+re8RM5fZA: folds 
YqWNLUj3exwMphJEDBi8Ug: raises $0.50 to $0.75
gtLY9BJ1dcPGyJ0NDNjaBg: folds 
LorpmCSxb4uozpKwk8Awsg: folds 
il+NK449FnwuQ8vyJ0Xn/g: folds 
vZGoOTJLQLhkPj4I+LNGig: folds 
76o85YBHJ9veRYp2LPuluQ: folds 
Uncalled bet ($0.50) returned to YqWNLUj3exwMphJEDBi8Ug
YqWNLUj3exwMphJEDBi8Ug collected $0.60 from pot
YqWNLUj3exwMphJEDBi8Ug: doesn't show hand 
*** SUMMARY ***
Total pot $0.60 | Rake $0 
Seat 1: YqWNLUj3exwMphJEDBi8Ug collected ($0.60)
Seat 2: gtLY9BJ1dcPGyJ0NDNjaBg folded before Flop (didn't bet)
Seat 3: LorpmCSxb4uozpKwk8Awsg folded before Flop (didn't bet)
Seat 4: il+NK449FnwuQ8vyJ0Xn/g (button) folded before Flop (didn't bet)
Seat 5: vZGoOTJLQLhkPj4I+LNGig (small blind) folded before Flop
Seat 6: 76o85YBHJ9veRYp2LPuluQ (big blind) folded before Flop
Seat 7: 18G4P1XstjNvItdGUITxgw folded before Flop (didn't bet)
Seat 9: QEbIGci+itdw+re8RM5fZA folded before Flop (didn't bet)




PokerStars Game #59939493024:  Hold'em No Limit ($0.10/$0.25) - 2009/07/01 0:41:17 ET
Table '9lYs7ljXi6AgFAxYHlKLJw' 9-max Seat #2 is the button
Seat 2: N6fYvIzQLKaydFLKQGtMlQ ($21.05 in chips) 
Seat 3: DnDcAdn9P0zGovMERigpFA ($27.60 in chips) 
Seat 4: UANt6y/SmDCY/jIxkBixcw ($30 in chips) 
Seat 5: dfNim92Z6XK1/h5SFW5vDg ($55.55 in chips) 
Seat 6: JtVGnq5doRa3PublncR+Yw ($17.20 in chips) 
Seat 7: ghNKXUBl/H+t83JF079ZBA ($30.10 in chips) 
Seat 9: 18G4P1XstjNvItdGUITxgw ($29.60 in chips) 
DnDcAdn9P0zGovMERigpFA: posts small blind $0.10
UANt6y/SmDCY/jIxkBixcw: posts big blind $0.25
*** HOLE CARDS ***
dfNim92Z6XK1/h5SFW5vDg: folds 
JtVGnq5doRa3PublncR+Yw: folds 
ghNKXUBl/H+t83JF079ZBA: folds 
18G4P1XstjNvItdGUITxgw: folds 
N6fYvIzQLKaydFLKQGtMlQ: raises $0.75 to $1
DnDcAdn9P0zGovMERigpFA: folds 
JtVGnq5doRa3PublncR+Yw leaves the table
UANt6y/SmDCY/jIxkBixcw: folds 
Uncalled bet ($0.75) returned to N6fYvIzQLKaydFLKQGtMlQ
N6fYvIzQLKaydFLKQGtMlQ collected $0.60 from pot
*** SUMMARY ***
Total pot $0.60 | Rake $0 
Seat 2: N6fYvIzQLKaydFLKQGtMlQ (button) collected ($0.60)
Seat 3: DnDcAdn9P0zGovMERigpFA (small blind) folded before Flop
Seat 4: UANt6y/SmDCY/jIxkBixcw (big blind) folded before Flop
Seat 5: dfNim92Z6XK1/h5SFW5vDg folded before Flop (didn't bet)
Seat 6: JtVGnq5doRa3PublncR+Yw folded before Flop (didn't bet)
Seat 7: ghNKXUBl/H+t83JF079ZBA folded before Flop (didn't bet)
Seat 9: 18G4P1XstjNvItdGUITxgw folded before Flop (didn't bet)




PokerStars Game #59939492950:  Hold'em No Limit ($0.10/$0.25) - 2009/07/01 0:41:17 ET
Table 'WEMI3Mtn7dGARDbgNrKibgQvLFJzpzymuOsaaRYi+8fgx Seat #6 is the button
Seat 2: R6nIVAjK7uhK3Hj0f85A+A ($23.05 in chips) 
Seat 3: W+vSAd2K80ck4uMklFb1OA ($5.95 in chips) 
Seat 4: Usqbnp9zov0ml3vx5zES7w ($10 in chips) 
Seat 5: MG90wfSJZnOejs/KD3vlQQ ($25.95 in chips) 
Seat 6: /bZlLwyIh+PmlqdCRwfoTg ($14.85 in chips) 
Seat 7: rQhYIYXSyH/IivYM1dlV5A ($16.15 in chips) 
Seat 8: DdyXKuBx0HAOC7dWZmGxWg ($21.45 in chips) 
rQhYIYXSyH/IivYM1dlV5A: posts small blind $0.10
DdyXKuBx0HAOC7dWZmGxWg: posts big blind $0.25
Usqbnp9zov0ml3vx5zES7w: posts big blind $0.25
*** HOLE CARDS ***
R6nIVAjK7uhK3Hj0f85A+A: folds 
W+vSAd2K80ck4uMklFb1OA: folds 
W+vSAd2K80ck4uMklFb1OA is sitting out
Usqbnp9zov0ml3vx5zES7w: checks 
MG90wfSJZnOejs/KD3vlQQ: folds 
/bZlLwyIh+PmlqdCRwfoTg: folds 
rQhYIYXSyH/IivYM1dlV5A: calls $0.15
DdyXKuBx0HAOC7dWZmGxWg: raises $0.25 to $0.50
Usqbnp9zov0ml3vx5zES7w: folds 
rQhYIYXSyH/IivYM1dlV5A: calls $0.25
*** FLOP *** [5c 9d Qh]
rQhYIYXSyH/IivYM1dlV5A: bets $0.50
DdyXKuBx0HAOC7dWZmGxWg: calls $0.50
*** TURN *** [5c 9d Qh] [2h]
rQhYIYXSyH/IivYM1dlV5A: bets $0.50
DdyXKuBx0HAOC7dWZmGxWg: folds 
Uncalled bet ($0.50) returned to rQhYIYXSyH/IivYM1dlV5A
rQhYIYXSyH/IivYM1dlV5A collected $2.15 from pot
*** SUMMARY ***
Total pot $2.25 | Rake $0.10 
Board [5c 9d Qh 2h]
Seat 2: R6nIVAjK7uhK3Hj0f85A+A folded before Flop (didn't bet)
Seat 3: W+vSAd2K80ck4uMklFb1OA folded before Flop (didn't bet)
Seat 4: Usqbnp9zov0ml3vx5zES7w folded before Flop
Seat 5: MG90wfSJZnOejs/KD3vlQQ folded before Flop (didn't bet)
Seat 6: /bZlLwyIh+PmlqdCRwfoTg (button) folded before Flop (didn't bet)
Seat 7: rQhYIYXSyH/IivYM1dlV5A (small blind) collected ($2.15)
Seat 8: DdyXKuBx0HAOC7dWZmGxWg (big blind) folded on the Turn




PokerStars Game #59939492594:  Hold'em No Limit ($0.10/$0.25) - 2009/07/01 0:41:17 ET
Table 'NtCSSONEf1zaJo3042tQug' 6-max Seat #1 is the button
Seat 1: pdS3fOhVgLVaTP0O0GlIvw ($11.05 in chips) 
Seat 2: nbv8IVGAEHbfjk01ulU6ow ($19.90 in chips) 
Seat 3: d0J1xuhsynEY81YHwAvJ5g ($25 in chips) 
Seat 4: dOX4wnYV2sEqvDbF+8KSCw ($25.15 in chips) 
Seat 5: l/t3k8+r77gRew8U2BJs4Q ($3.40 in chips) 
Seat 6: LxehwDpTQ19ph4Qmc78+Pw ($21.25 in chips) 
nbv8IVGAEHbfjk01ulU6ow: posts small blind $0.10
d0J1xuhsynEY81YHwAvJ5g: posts big blind $0.25
*** HOLE CARDS ***
dOX4wnYV2sEqvDbF+8KSCw: raises $0.75 to $1
l/t3k8+r77gRew8U2BJs4Q: folds 
LxehwDpTQ19ph4Qmc78+Pw: folds 
pdS3fOhVgLVaTP0O0GlIvw: folds 
nbv8IVGAEHbfjk01ulU6ow: folds 
d0J1xuhsynEY81YHwAvJ5g: folds 
Uncalled bet ($0.75) returned to dOX4wnYV2sEqvDbF+8KSCw
dOX4wnYV2sEqvDbF+8KSCw collected $0.60 from pot
dOX4wnYV2sEqvDbF+8KSCw: doesn't show hand 
*** SUMMARY ***
Total pot $0.60 | Rake $0 
Seat 1: pdS3fOhVgLVaTP0O0GlIvw (button) folded before Flop (didn't bet)
Seat 2: nbv8IVGAEHbfjk01ulU6ow (small blind) folded before Flop
Seat 3: d0J1xuhsynEY81YHwAvJ5g (big blind) folded before Flop
Seat 4: dOX4wnYV2sEqvDbF+8KSCw collected ($0.60)
Seat 5: l/t3k8+r77gRew8U2BJs4Q folded before Flop (didn't bet)
Seat 6: LxehwDpTQ19ph4Qmc78+Pw folded before Flop (didn't bet)




PokerStars Game #59939492914:  Hold'em No Limit ($0.10/$0.25) - 2009/07/01 0:41:17 ET
Table '/XCUCUl3yW6tdTJQEhJKGw' 6-max Seat #4 is the button
Seat 1: p8J112JmNRnCwV2+NAEzCA ($15.30 in chips) 
Seat 2: 8ClCHtFXGNplITm+63KB+Q ($27.95 in chips) 
Seat 3: /gJNBeCkWL4o85/jvlZ4BA ($36.60 in chips) 
Seat 4: SFmT9ZsVopnukjvAzrxTRg ($25 in chips) 
Seat 5: 3rlIjSrvbZoI2IILbnetnA ($25 in chips) 
Seat 6: armfxZhGxeZVZBYAQFuIJQ ($36.45 in chips) 
3rlIjSrvbZoI2IILbnetnA: posts small blind $0.10
armfxZhGxeZVZBYAQFuIJQ: posts big blind $0.25
*** HOLE CARDS ***
p8J112JmNRnCwV2+NAEzCA: raises $0.25 to $0.50
8ClCHtFXGNplITm+63KB+Q: folds 
/gJNBeCkWL4o85/jvlZ4BA: folds 
SFmT9ZsVopnukjvAzrxTRg: folds 
3rlIjSrvbZoI2IILbnetnA: folds 
armfxZhGxeZVZBYAQFuIJQ: folds 
Uncalled bet ($0.25) returned to p8J112JmNRnCwV2+NAEzCA
p8J112JmNRnCwV2+NAEzCA collected $0.60 from pot
p8J112JmNRnCwV2+NAEzCA: doesn't show hand 
*** SUMMARY ***
Total pot $0.60 | Rake $0 
Seat 1: p8J112JmNRnCwV2+NAEzCA collected ($0.60)
Seat 2: 8ClCHtFXGNplITm+63KB+Q folded before Flop (didn't bet)
Seat 3: /gJNBeCkWL4o85/jvlZ4BA folded before Flop (didn't bet)
Seat 4: SFmT9ZsVopnukjvAzrxTRg (button) folded before Flop (didn't bet)
Seat 5: 3rlIjSrvbZoI2IILbnetnA (small blind) folded before Flop
Seat 6: armfxZhGxeZVZBYAQFuIJQ (big blind) folded before Flop




PokerStars Game #59939492786:  Hold'em No Limit ($0.10/$0.25) - 2009/07/01 0:41:17 ET
Table 'BdTkgy6SGkgNXul6irMoOw' 9-max Seat #6 is the button
Seat 1: Jd9JmKichu4pvsKjXEKNvA ($4.75 in chips) 
Seat 2: ljemhp25Zg+nlA9DLCIiUw ($39.30 in chips) 
Seat 4: eygIcrabyU9hI2mw7NQsgg ($23.55 in chips) 
Seat 5: opOCI2p6kW0tINuVaAqmcQ ($25 in chips) 
Seat 6: XlP4n7rTkDteN8BWl//wvg ($22.65 in chips) 
Seat 9: 5dv9mRGKI/UifM58OINXVQ ($19.25 in chips) 
5dv9mRGKI/UifM58OINXVQ: posts small blind $0.10
Jd9JmKichu4pvsKjXEKNvA: posts big blind $0.25
*** HOLE CARDS ***
ljemhp25Zg+nlA9DLCIiUw: folds 
eygIcrabyU9hI2mw7NQsgg: folds 
opOCI2p6kW0tINuVaAqmcQ: folds 
XlP4n7rTkDteN8BWl//wvg: raises $0.75 to $1
5dv9mRGKI/UifM58OINXVQ: folds 
RQ9/w/vIRUIpv009qodF2Q joins the table at seat #3 
Jd9JmKichu4pvsKjXEKNvA: folds 
Uncalled bet ($0.75) returned to XlP4n7rTkDteN8BWl//wvg
XlP4n7rTkDteN8BWl//wvg collected $0.60 from pot
*** SUMMARY ***
Total pot $0.60 | Rake $0 
Seat 1: Jd9JmKichu4pvsKjXEKNvA (big blind) folded before Flop
Seat 2: ljemhp25Zg+nlA9DLCIiUw folded before Flop (didn't bet)
Seat 4: eygIcrabyU9hI2mw7NQsgg folded before Flop (didn't bet)
Seat 5: opOCI2p6kW0tINuVaAqmcQ folded before Flop (didn't bet)
Seat 6: XlP4n7rTkDteN8BWl//wvg (button) collected ($0.60)
Seat 9: 5dv9mRGKI/UifM58OINXVQ (small blind) folded before Flop




PokerStars Game #59939493116:  Hold'em No Limit ($0.10/$0.25) - 2009/07/01 0:41:18 ET
Table 'hfHe8uKeSJMyWAjSdM7ROQMRfAiS/4JSfnUDlCcZo0wAx Seat #5 is the button
Seat 1: 48oT5xFI+5CHUJlfoGrE4w ($10 in chips) 
Seat 2: /gJNBeCkWL4o85/jvlZ4BA ($39.70 in chips) 
Seat 3: FYepjhAvF8ZdVCmqHIy+eQ ($46.75 in chips) 
Seat 4: Go8clNIDGP3feVvzBDG4pg ($20.65 in chips) 
Seat 5: qccGLncfUaN00Few5HsgYg ($27.35 in chips) 
Seat 6: VaDPspfGS2lnEkaGNrNqfg ($9.50 in chips) 
VaDPspfGS2lnEkaGNrNqfg: posts small blind $0.10
48oT5xFI+5CHUJlfoGrE4w: posts big blind $0.25
*** HOLE CARDS ***
/gJNBeCkWL4o85/jvlZ4BA: folds 
FYepjhAvF8ZdVCmqHIy+eQ: raises $0.75 to $1
Go8clNIDGP3feVvzBDG4pg: calls $1
qccGLncfUaN00Few5HsgYg: calls $1
VaDPspfGS2lnEkaGNrNqfg: calls $0.90
48oT5xFI+5CHUJlfoGrE4w: calls $0.75
*** FLOP *** [3s 8c 9c]
VaDPspfGS2lnEkaGNrNqfg: checks 
48oT5xFI+5CHUJlfoGrE4w: checks 
FYepjhAvF8ZdVCmqHIy+eQ: checks 
Go8clNIDGP3feVvzBDG4pg: checks 
qccGLncfUaN00Few5HsgYg: checks 
*** TURN *** [3s 8c 9c] [5h]
VaDPspfGS2lnEkaGNrNqfg: checks 
48oT5xFI+5CHUJlfoGrE4w: checks 
FYepjhAvF8ZdVCmqHIy+eQ: checks 
Go8clNIDGP3feVvzBDG4pg: checks 
qccGLncfUaN00Few5HsgYg: checks 
*** RIVER *** [3s 8c 9c 5h] [8h]
VaDPspfGS2lnEkaGNrNqfg: checks 
48oT5xFI+5CHUJlfoGrE4w: checks 
FYepjhAvF8ZdVCmqHIy+eQ: checks 
Go8clNIDGP3feVvzBDG4pg: checks 
qccGLncfUaN00Few5HsgYg: checks 
*** SHOW DOWN ***
VaDPspfGS2lnEkaGNrNqfg: shows [7d Ac] (a pair of Eights)
48oT5xFI+5CHUJlfoGrE4w: shows [6s 6h] (two pair, Eights and Sixes)
FYepjhAvF8ZdVCmqHIy+eQ: mucks hand 
Go8clNIDGP3feVvzBDG4pg: mucks hand 
qccGLncfUaN00Few5HsgYg: shows [6d 6c] (two pair, Eights and Sixes)
48oT5xFI+5CHUJlfoGrE4w collected $2.40 from pot
qccGLncfUaN00Few5HsgYg collected $2.35 from pot
*** SUMMARY ***
Total pot $5 | Rake $0.25 
Board [3s 8c 9c 5h 8h]
Seat 1: 48oT5xFI+5CHUJlfoGrE4w (big blind) showed [6s 6h] and won ($2.40) with two pair, Eights and Sixes
Seat 2: /gJNBeCkWL4o85/jvlZ4BA folded before Flop (didn't bet)
Seat 3: FYepjhAvF8ZdVCmqHIy+eQ mucked
Seat 4: Go8clNIDGP3feVvzBDG4pg mucked
Seat 5: qccGLncfUaN00Few5HsgYg (button) showed [6d 6c] and won ($2.35) with two pair, Eights and Sixes
Seat 6: VaDPspfGS2lnEkaGNrNqfg (small blind) showed [7d Ac] and lost with a pair of Eights




PokerStars Game #59939493198:  Hold'em No Limit ($0.10/$0.25) - 2009/07/01 0:41:18 ET
Table 'NtEQAxCeIK2io1CGtW658g' 6-max Seat #6 is the button
Seat 1: lnOV7k25gyN7L5t5YKTgIg ($20.95 in chips) 
Seat 2: nc79pm0LZRdhncq55evVqA ($25.55 in chips) 
Seat 3: m2yWOKfAxqHoy5DDN87Ttw ($24.65 in chips) 
Seat 4: 8296 ($11.65 in chips) 
Seat 5: FStoHe64SQWqAsjya9pDkQ ($28.20 in chips) 
Seat 6: /gJNBeCkWL4o85/jvlZ4BA ($62.35 in chips) 
lnOV7k25gyN7L5t5YKTgIg: posts small blind $0.10
nc79pm0LZRdhncq55evVqA: posts big blind $0.25
*** HOLE CARDS ***
m2yWOKfAxqHoy5DDN87Ttw: folds 
8296: folds 
FStoHe64SQWqAsjya9pDkQ: raises $0.50 to $0.75
/gJNBeCkWL4o85/jvlZ4BA: folds 
lnOV7k25gyN7L5t5YKTgIg: calls $0.65
nc79pm0LZRdhncq55evVqA: folds 
*** FLOP *** [7h Qd 3d]
lnOV7k25gyN7L5t5YKTgIg: checks 
FStoHe64SQWqAsjya9pDkQ: bets $1.25
lnOV7k25gyN7L5t5YKTgIg: calls $1.25
*** TURN *** [7h Qd 3d] [7d]
lnOV7k25gyN7L5t5YKTgIg: checks 
FStoHe64SQWqAsjya9pDkQ: checks 
*** RIVER *** [7h Qd 3d 7d] [Jc]
lnOV7k25gyN7L5t5YKTgIg: bets $3
FStoHe64SQWqAsjya9pDkQ: folds 
Uncalled bet ($3) returned to lnOV7k25gyN7L5t5YKTgIg
lnOV7k25gyN7L5t5YKTgIg collected $4.05 from pot
lnOV7k25gyN7L5t5YKTgIg: shows [3s 3h] (a full house, Threes full of Sevens)
*** SUMMARY ***
Total pot $4.25 | Rake $0.20 
Board [7h Qd 3d 7d Jc]
Seat 1: lnOV7k25gyN7L5t5YKTgIg (small blind) collected ($4.05)
Seat 2: nc79pm0LZRdhncq55evVqA (big blind) folded before Flop
Seat 3: m2yWOKfAxqHoy5DDN87Ttw folded before Flop (didn't bet)
Seat 4: 8296 folded before Flop (didn't bet)
Seat 5: FStoHe64SQWqAsjya9pDkQ folded on the River
Seat 6: /gJNBeCkWL4o85/jvlZ4BA (button) folded before Flop (didn't bet)




PokerStars Game #59939493102:  Hold'em No Limit ($0.10/$0.25) - 2009/07/01 0:41:18 ET
Table 'R5f24ws6hGXlbvjq9ej+1Q' 9-max Seat #5 is the button
Seat 1: TeWJxSETzbXGiYKx0y+dtg ($26.30 in chips) 
Seat 2: 8lk6dG3H7iS/67/biw/vcQ ($26.55 in chips) 
Seat 4: jM9ExRdqCqq2e6TjpOBoRw ($16.90 in chips) 
Seat 5: YMlMWbkusacDBjx3A8lphw ($6.15 in chips) 
Seat 7: Z5ZtGOON8kmSdSCll9Z3XA ($8.10 in chips) 
Seat 8: qwr38jl5txoR36M7G5qi4A ($8.65 in chips) 
Seat 9: 33y9+GmQ3J84RvZXcraRTw ($27.40 in chips) 
Z5ZtGOON8kmSdSCll9Z3XA: posts small blind $0.10
qwr38jl5txoR36M7G5qi4A: posts big blind $0.25
*** HOLE CARDS ***
33y9+GmQ3J84RvZXcraRTw: folds 
TeWJxSETzbXGiYKx0y+dtg: folds 
8lk6dG3H7iS/67/biw/vcQ: folds 
jM9ExRdqCqq2e6TjpOBoRw: calls $0.25
YMlMWbkusacDBjx3A8lphw: calls $0.25
Z5ZtGOON8kmSdSCll9Z3XA: folds 
qwr38jl5txoR36M7G5qi4A: checks 
*** FLOP *** [4d 4s Js]
qwr38jl5txoR36M7G5qi4A: bets $0.75
jM9ExRdqCqq2e6TjpOBoRw: folds 
YMlMWbkusacDBjx3A8lphw: folds 
Uncalled bet ($0.75) returned to qwr38jl5txoR36M7G5qi4A
qwr38jl5txoR36M7G5qi4A collected $0.85 from pot
qwr38jl5txoR36M7G5qi4A: doesn't show hand 
*** SUMMARY ***
Total pot $0.85 | Rake $0 
Board [4d 4s Js]
Seat 1: TeWJxSETzbXGiYKx0y+dtg folded before Flop (didn't bet)
Seat 2: 8lk6dG3H7iS/67/biw/vcQ folded before Flop (didn't bet)
Seat 4: jM9ExRdqCqq2e6TjpOBoRw folded on the Flop
Seat 5: YMlMWbkusacDBjx3A8lphw (button) folded on the Flop
Seat 7: Z5ZtGOON8kmSdSCll9Z3XA (small blind) folded before Flop
Seat 8: qwr38jl5txoR36M7G5qi4A (big blind) collected ($0.85)
Seat 9: 33y9+GmQ3J84RvZXcraRTw folded before Flop (didn't bet)




PokerStars Game #59939493440:  Hold'em No Limit ($0.10/$0.25) - 2009/07/01 0:41:18 ET
Table 'JPFXJXa5xBkjZ/W15BKqeQ' 9-max Seat #8 is the button
Seat 1: hPhp/RE3cJ5YGaQ2xOHXXg ($5 in chips) 
Seat 2: 1/f3/SJ8XpIW1Ek97d1xUw ($5.50 in chips) 
Seat 3: 56S3mA6Zs3pGR+0p0vUCtg ($27.15 in chips) 
Seat 4: VBHxUExRAMrbxUq/cVx9Gw ($5.60 in chips) 
Seat 5: cZ99hugmLBj9KhTlc8nCSw ($25.95 in chips) 
Seat 6: DdPXdieucQ+n99u1n3A+rQ ($4.30 in chips) 
Seat 8: zDrucyjVn5aeekNEc3cJrA ($23 in chips) 
Seat 9: uH1RN27w9SKa7TpVR9EFrQ ($15.15 in chips) 
uH1RN27w9SKa7TpVR9EFrQ: posts small blind $0.10
hPhp/RE3cJ5YGaQ2xOHXXg: posts big blind $0.25
*** HOLE CARDS ***
1/f3/SJ8XpIW1Ek97d1xUw: calls $0.25
56S3mA6Zs3pGR+0p0vUCtg: folds 
VBHxUExRAMrbxUq/cVx9Gw: folds 
cZ99hugmLBj9KhTlc8nCSw: folds 
DdPXdieucQ+n99u1n3A+rQ: folds 
zDrucyjVn5aeekNEc3cJrA: folds 
uH1RN27w9SKa7TpVR9EFrQ: calls $0.15
hPhp/RE3cJ5YGaQ2xOHXXg: checks 
*** FLOP *** [9h As 4h]
uH1RN27w9SKa7TpVR9EFrQ: checks 
hPhp/RE3cJ5YGaQ2xOHXXg: checks 
1/f3/SJ8XpIW1Ek97d1xUw: bets $0.25
uH1RN27w9SKa7TpVR9EFrQ: calls $0.25
hPhp/RE3cJ5YGaQ2xOHXXg: folds 
*** TURN *** [9h As 4h] [Th]
uH1RN27w9SKa7TpVR9EFrQ: checks 
1/f3/SJ8XpIW1Ek97d1xUw: bets $0.25
uH1RN27w9SKa7TpVR9EFrQ: raises $1.25 to $1.50
1/f3/SJ8XpIW1Ek97d1xUw: calls $1.25
*** RIVER *** [9h As 4h Th] [Qh]
uH1RN27w9SKa7TpVR9EFrQ: bets $13.15 and is all-in
1/f3/SJ8XpIW1Ek97d1xUw: calls $3.50 and is all-in
Uncalled bet ($9.65) returned to uH1RN27w9SKa7TpVR9EFrQ
*** SHOW DOWN ***
uH1RN27w9SKa7TpVR9EFrQ: shows [6h 8h] (a flush, Queen high)
1/f3/SJ8XpIW1Ek97d1xUw: shows [Ad Jh] (a flush, Queen high - Jack higher)
1/f3/SJ8XpIW1Ek97d1xUw collected $10.70 from pot
*** SUMMARY ***
Total pot $11.25 | Rake $0.55 
Board [9h As 4h Th Qh]
Seat 1: hPhp/RE3cJ5YGaQ2xOHXXg (big blind) folded on the Flop
Seat 2: 1/f3/SJ8XpIW1Ek97d1xUw showed [Ad Jh] and won ($10.70) with a flush, Queen high
Seat 3: 56S3mA6Zs3pGR+0p0vUCtg folded before Flop (didn't bet)
Seat 4: VBHxUExRAMrbxUq/cVx9Gw folded before Flop (didn't bet)
Seat 5: cZ99hugmLBj9KhTlc8nCSw folded before Flop (didn't bet)
Seat 6: DdPXdieucQ+n99u1n3A+rQ folded before Flop (didn't bet)
Seat 8: zDrucyjVn5aeekNEc3cJrA (button) folded before Flop (didn't bet)
Seat 9: uH1RN27w9SKa7TpVR9EFrQ (small blind) showed [6h 8h] and lost with a flush, Queen high




PokerStars Game #59939493506:  Hold'em No Limit ($0.10/$0.25) - 2009/07/01 0:41:18 ET
Table 'KEoOIegxPF91KooL2AelUA' 6-max Seat #4 is the button
Seat 1: wsP46AGpqDjHZQmlRHKa9g ($29.80 in chips) 
Seat 4: Vv37Oa9niKKVcR6Z7ceetw ($22.95 in chips) 
Seat 5: 2NLC44AHHKHEUooUQFYV+Q ($11.90 in chips) 
Seat 6: Jq3YrbGb738j4tRTnp4PDA ($15 in chips) 
2NLC44AHHKHEUooUQFYV+Q: posts small blind $0.10
Jq3YrbGb738j4tRTnp4PDA: posts big blind $0.25
*** HOLE CARDS ***
wsP46AGpqDjHZQmlRHKa9g: raises $0.50 to $0.75
Vv37Oa9niKKVcR6Z7ceetw: folds 
2NLC44AHHKHEUooUQFYV+Q: calls $0.65
Jq3YrbGb738j4tRTnp4PDA: folds 
*** FLOP *** [Jh 2c 3c]
2NLC44AHHKHEUooUQFYV+Q: checks 
wsP46AGpqDjHZQmlRHKa9g: bets $1
2NLC44AHHKHEUooUQFYV+Q: calls $1
*** TURN *** [Jh 2c 3c] [5s]
2NLC44AHHKHEUooUQFYV+Q: checks 
wsP46AGpqDjHZQmlRHKa9g: checks 
*** RIVER *** [Jh 2c 3c 5s] [Kc]
2NLC44AHHKHEUooUQFYV+Q: bets $1.25
wsP46AGpqDjHZQmlRHKa9g: folds 
Uncalled bet ($1.25) returned to 2NLC44AHHKHEUooUQFYV+Q
2NLC44AHHKHEUooUQFYV+Q collected $3.60 from pot
2NLC44AHHKHEUooUQFYV+Q: doesn't show hand 
*** SUMMARY ***
Total pot $3.75 | Rake $0.15 
Board [Jh 2c 3c 5s Kc]
Seat 1: wsP46AGpqDjHZQmlRHKa9g folded on the River
Seat 4: Vv37Oa9niKKVcR6Z7ceetw (button) folded before Flop (didn't bet)
Seat 5: 2NLC44AHHKHEUooUQFYV+Q (small blind) collected ($3.60)
Seat 6: Jq3YrbGb738j4tRTnp4PDA (big blind) folded before Flop




PokerStars Game #59939493540:  Hold'em No Limit ($0.10/$0.25) - 2009/07/01 0:41:18 ET
Table 'FBhJjLqab11/gKu8nyB/tw' 9-max Seat #5 is the button
Seat 1: +sbyWwIcFp9kP0bDtMegfQ ($21.80 in chips) 
Seat 2: 1pwQJV/Xr0GWPRefx/78VQ ($2.05 in chips) 
Seat 3: uy9x0X5l7O+IpGjLa77QgQ ($26.90 in chips) 
Seat 4: OTC1Bh+DhK778Qnsj6D8+A ($24.50 in chips) 
Seat 5: vZGoOTJLQLhkPj4I+LNGig ($45.40 in chips) 
Seat 6: QrNgXJWFdS+POsPJcil4aA ($19.60 in chips) 
Seat 7: 5Fj9JGGxQT7Djr6AyIiBVA ($25.25 in chips) 
Seat 8: 9lE3Zc4pjmKpQK8rDF1aaQ ($20.20 in chips) 
Seat 9: BEIBUu2pIflPrCL+Iks4CQ ($12.15 in chips) 
QrNgXJWFdS+POsPJcil4aA: posts small blind $0.10
5Fj9JGGxQT7Djr6AyIiBVA: posts big blind $0.25
*** HOLE CARDS ***
9lE3Zc4pjmKpQK8rDF1aaQ: raises $0.50 to $0.75
BEIBUu2pIflPrCL+Iks4CQ: folds 
+sbyWwIcFp9kP0bDtMegfQ: folds 
1pwQJV/Xr0GWPRefx/78VQ: folds 
uy9x0X5l7O+IpGjLa77QgQ: folds 
OTC1Bh+DhK778Qnsj6D8+A: folds 
vZGoOTJLQLhkPj4I+LNGig: folds 
QrNgXJWFdS+POsPJcil4aA: folds 
5Fj9JGGxQT7Djr6AyIiBVA: folds 
Uncalled bet ($0.50) returned to 9lE3Zc4pjmKpQK8rDF1aaQ
9lE3Zc4pjmKpQK8rDF1aaQ collected $0.60 from pot
9lE3Zc4pjmKpQK8rDF1aaQ: doesn't show hand 
*** SUMMARY ***
Total pot $0.60 | Rake $0 
Seat 1: +sbyWwIcFp9kP0bDtMegfQ folded before Flop (didn't bet)
Seat 2: 1pwQJV/Xr0GWPRefx/78VQ folded before Flop (didn't bet)
Seat 3: uy9x0X5l7O+IpGjLa77QgQ folded before Flop (didn't bet)
Seat 4: OTC1Bh+DhK778Qnsj6D8+A folded before Flop (didn't bet)
Seat 5: vZGoOTJLQLhkPj4I+LNGig (button) folded before Flop (didn't bet)
Seat 6: QrNgXJWFdS+POsPJcil4aA (small blind) folded before Flop
Seat 7: 5Fj9JGGxQT7Djr6AyIiBVA (big blind) folded before Flop
Seat 8: 9lE3Zc4pjmKpQK8rDF1aaQ collected ($0.60)
Seat 9: BEIBUu2pIflPrCL+Iks4CQ folded before Flop (didn't bet)




PokerStars Game #59939493956:  Hold'em No Limit ($0.10/$0.25) - 2009/07/01 0:41:19 ET
Table 'HIOfhT0zga/KonFhIl6O3w' 9-max Seat #9 is the button
Seat 1: t2nb95S5EEFOEzNx9Itz0g ($5.95 in chips) 
Seat 2: er86weqXTpTB6/w2dKlYgA ($16.20 in chips) 
Seat 3: RxrlOCIHB/l30KL6EEws0g ($37.15 in chips) 
Seat 4: qwr38jl5txoR36M7G5qi4A ($8.10 in chips) 
Seat 5: K1MDeapSEyKyGPNZGOKfEg ($14.20 in chips) 
Seat 6: cZ99hugmLBj9KhTlc8nCSw ($26.30 in chips) 
Seat 7: H9KUl8cmpLgEpOVDA00bCg ($5.25 in chips) 
Seat 8: 3RCAkueG3Vc13VpRStCB+w ($25.50 in chips) 
Seat 9: dfNim92Z6XK1/h5SFW5vDg ($25.25 in chips) 
t2nb95S5EEFOEzNx9Itz0g: posts small blind $0.10
er86weqXTpTB6/w2dKlYgA: posts big blind $0.25
*** HOLE CARDS ***
RxrlOCIHB/l30KL6EEws0g: folds 
qwr38jl5txoR36M7G5qi4A: folds 
K1MDeapSEyKyGPNZGOKfEg: calls $0.25
cZ99hugmLBj9KhTlc8nCSw: folds 
H9KUl8cmpLgEpOVDA00bCg: folds 
3RCAkueG3Vc13VpRStCB+w: folds 
dfNim92Z6XK1/h5SFW5vDg: folds 
t2nb95S5EEFOEzNx9Itz0g: folds 
er86weqXTpTB6/w2dKlYgA: checks 
*** FLOP *** [8c 9c 3s]
er86weqXTpTB6/w2dKlYgA: checks 
K1MDeapSEyKyGPNZGOKfEg: checks 
*** TURN *** [8c 9c 3s] [Qs]
er86weqXTpTB6/w2dKlYgA: checks 
K1MDeapSEyKyGPNZGOKfEg: checks 
*** RIVER *** [8c 9c 3s Qs] [Ts]
er86weqXTpTB6/w2dKlYgA: checks 
K1MDeapSEyKyGPNZGOKfEg: checks 
*** SHOW DOWN ***
er86weqXTpTB6/w2dKlYgA: shows [As Jc] (a straight, Eight to Queen)
K1MDeapSEyKyGPNZGOKfEg: mucks hand 
er86weqXTpTB6/w2dKlYgA collected $0.60 from pot
*** SUMMARY ***
Total pot $0.60 | Rake $0 
Board [8c 9c 3s Qs Ts]
Seat 1: t2nb95S5EEFOEzNx9Itz0g (small blind) folded before Flop
Seat 2: er86weqXTpTB6/w2dKlYgA (big blind) showed [As Jc] and won ($0.60) with a straight, Eight to Queen
Seat 3: RxrlOCIHB/l30KL6EEws0g folded before Flop (didn't bet)
Seat 4: qwr38jl5txoR36M7G5qi4A folded before Flop (didn't bet)
Seat 5: K1MDeapSEyKyGPNZGOKfEg mucked
Seat 6: cZ99hugmLBj9KhTlc8nCSw folded before Flop (didn't bet)
Seat 7: H9KUl8cmpLgEpOVDA00bCg folded before Flop (didn't bet)
Seat 8: 3RCAkueG3Vc13VpRStCB+w folded before Flop (didn't bet)
Seat 9: dfNim92Z6XK1/h5SFW5vDg (button) folded before Flop (didn't bet)




PokerStars Game #59939493806:  Hold'em No Limit ($0.10/$0.25) - 2009/07/01 0:41:19 ET
Table 'T/iCKJXGphRN3xcdwfE/JQJYkCJJ5Iv+Tu52jx2lpEcgSeat #1 is the button
Seat 1: Yv4fucyyT28mjx8V5lxKJg ($29.90 in chips) 
Seat 2: hBMUlEpyU74r/fwDgIpXjQ ($35.35 in chips) 
Seat 3: Z5ZtGOON8kmSdSCll9Z3XA ($7.75 in chips) 
Seat 5: 6OVSxS1KoddUCYNkZ4hREw ($28.60 in chips) 
Seat 6: OiV1PWZ3IkN29JlmCcnTwQ ($5 in chips) 
Seat 7: N6fYvIzQLKaydFLKQGtMlQ ($24.90 in chips) 
Seat 8: COsrwJSFHQtxlUcrYtDQPQ ($25 in chips) 
Seat 9: H9KUl8cmpLgEpOVDA00bCg ($5.15 in chips) 
hBMUlEpyU74r/fwDgIpXjQ: posts small blind $0.10
Z5ZtGOON8kmSdSCll9Z3XA: posts big blind $0.25
*** HOLE CARDS ***
6OVSxS1KoddUCYNkZ4hREw: folds 
OiV1PWZ3IkN29JlmCcnTwQ: folds 
N6fYvIzQLKaydFLKQGtMlQ: folds 
COsrwJSFHQtxlUcrYtDQPQ: folds 
H9KUl8cmpLgEpOVDA00bCg: folds 
Yv4fucyyT28mjx8V5lxKJg: raises $1 to $1.25
hBMUlEpyU74r/fwDgIpXjQ: folds 
Z5ZtGOON8kmSdSCll9Z3XA: folds 
Uncalled bet ($1) returned to Yv4fucyyT28mjx8V5lxKJg
Yv4fucyyT28mjx8V5lxKJg collected $0.60 from pot
Yv4fucyyT28mjx8V5lxKJg: doesn't show hand 
*** SUMMARY ***
Total pot $0.60 | Rake $0 
Seat 1: Yv4fucyyT28mjx8V5lxKJg (button) collected ($0.60)
Seat 2: hBMUlEpyU74r/fwDgIpXjQ (small blind) folded before Flop
Seat 3: Z5ZtGOON8kmSdSCll9Z3XA (big blind) folded before Flop
Seat 5: 6OVSxS1KoddUCYNkZ4hREw folded before Flop (didn't bet)
Seat 6: OiV1PWZ3IkN29JlmCcnTwQ folded before Flop (didn't bet)
Seat 7: N6fYvIzQLKaydFLKQGtMlQ folded before Flop (didn't bet)
Seat 8: COsrwJSFHQtxlUcrYtDQPQ folded before Flop (didn't bet)
Seat 9: H9KUl8cmpLgEpOVDA00bCg folded before Flop (didn't bet)




PokerStars Game #59939493784:  Hold'em No Limit ($0.10/$0.25) - 2009/07/01 0:41:19 ET
Table '8Z6T3ssCpo3VV849U4RgBw' 9-max Seat #9 is the button
Seat 1: 8dNQBtNvCvzVgSnmDgi/LA ($11.75 in chips) 
Seat 3: DdPXdieucQ+n99u1n3A+rQ ($3.95 in chips) 
Seat 4: swWFmLwqgpSU1P6HAmCGPw ($16.75 in chips) 
Seat 5: zDrucyjVn5aeekNEc3cJrA ($23.55 in chips) 
Seat 6: SXqVW4Q0evTUVZG6BbUNIA ($33.40 in chips) 
Seat 7: VBHxUExRAMrbxUq/cVx9Gw ($5 in chips) 
Seat 8: hPhp/RE3cJ5YGaQ2xOHXXg ($4.90 in chips) 
Seat 9: yfkbMbx4w7MXhQDFPxOq0A ($12.65 in chips) 
8dNQBtNvCvzVgSnmDgi/LA: posts small blind $0.10
st9jtdNbm1W5GfBwRaCVqQ: is sitting out 
DdPXdieucQ+n99u1n3A+rQ: posts big blind $0.25
*** HOLE CARDS ***
swWFmLwqgpSU1P6HAmCGPw: folds 
st9jtdNbm1W5GfBwRaCVqQ leaves the table
zDrucyjVn5aeekNEc3cJrA: folds 
SXqVW4Q0evTUVZG6BbUNIA: folds 
VBHxUExRAMrbxUq/cVx9Gw: folds 
hPhp/RE3cJ5YGaQ2xOHXXg: raises $0.75 to $1
yfkbMbx4w7MXhQDFPxOq0A: calls $1
8dNQBtNvCvzVgSnmDgi/LA: folds 
DdPXdieucQ+n99u1n3A+rQ: raises $2.95 to $3.95 and is all-in
hPhp/RE3cJ5YGaQ2xOHXXg: folds 
yfkbMbx4w7MXhQDFPxOq0A: calls $2.95
*** FLOP *** [4d Jc 9d]
*** TURN *** [4d Jc 9d] [8d]
*** RIVER *** [4d Jc 9d 8d] [2d]
*** SHOW DOWN ***
DdPXdieucQ+n99u1n3A+rQ: shows [5s 5h] (a pair of Fives)
yfkbMbx4w7MXhQDFPxOq0A: shows [8s 7s] (a pair of Eights)
yfkbMbx4w7MXhQDFPxOq0A collected $8.55 from pot
*** SUMMARY ***
Total pot $9 | Rake $0.45 
Board [4d Jc 9d 8d 2d]
Seat 1: 8dNQBtNvCvzVgSnmDgi/LA (small blind) folded before Flop
Seat 3: DdPXdieucQ+n99u1n3A+rQ (big blind) showed [5s 5h] and lost with a pair of Fives
Seat 4: swWFmLwqgpSU1P6HAmCGPw folded before Flop (didn't bet)
Seat 5: zDrucyjVn5aeekNEc3cJrA folded before Flop (didn't bet)
Seat 6: SXqVW4Q0evTUVZG6BbUNIA folded before Flop (didn't bet)
Seat 7: VBHxUExRAMrbxUq/cVx9Gw folded before Flop (didn't bet)
Seat 8: hPhp/RE3cJ5YGaQ2xOHXXg folded before Flop
Seat 9: yfkbMbx4w7MXhQDFPxOq0A (button) showed [8s 7s] and won ($8.55) with a pair of Eights




PokerStars Game #59939493976:  Hold'em No Limit ($0.10/$0.25) - 2009/07/01 0:41:19 ET
Table 'Zi9/NqNs3XoL1eWhMCyZyg' 9-max Seat #5 is the button
Seat 2: Th3FldXKQW6hWVVPahaoOQ ($31.05 in chips) 
Seat 3: rUpvA02nErFvZ4yFbDR8XA ($21.65 in chips) 
Seat 4: D3XCkXRktDfPlSguxwfnRA ($13 in chips) 
Seat 5: OiV1PWZ3IkN29JlmCcnTwQ ($4.90 in chips) 
Seat 6: b3P5tPsBbrP+aAO9+Ts/Nw ($37.60 in chips) 
Seat 7: qul+IMROTuFj45eWi2Tpvg ($49.10 in chips) 
Seat 9: tYsOBqdU1+x+yFI7zHO7hQ ($31.10 in chips) 
b3P5tPsBbrP+aAO9+Ts/Nw: posts small blind $0.10
qul+IMROTuFj45eWi2Tpvg: posts big blind $0.25
opOCI2p6kW0tINuVaAqmcQ: sits out 
*** HOLE CARDS ***
tYsOBqdU1+x+yFI7zHO7hQ: folds 
Th3FldXKQW6hWVVPahaoOQ: folds 
rUpvA02nErFvZ4yFbDR8XA: folds 
D3XCkXRktDfPlSguxwfnRA: folds 
OiV1PWZ3IkN29JlmCcnTwQ: folds 
b3P5tPsBbrP+aAO9+Ts/Nw: raises $0.25 to $0.50
qul+IMROTuFj45eWi2Tpvg: calls $0.25
*** FLOP *** [9h 9s Qd]
b3P5tPsBbrP+aAO9+Ts/Nw: checks 
qul+IMROTuFj45eWi2Tpvg: checks 
*** TURN *** [9h 9s Qd] [Td]
b3P5tPsBbrP+aAO9+Ts/Nw: checks 
qul+IMROTuFj45eWi2Tpvg: bets $0.50
b3P5tPsBbrP+aAO9+Ts/Nw: folds 
Uncalled bet ($0.50) returned to qul+IMROTuFj45eWi2Tpvg
qul+IMROTuFj45eWi2Tpvg collected $0.95 from pot
*** SUMMARY ***
Total pot $1 | Rake $0.05 
Board [9h 9s Qd Td]
Seat 2: Th3FldXKQW6hWVVPahaoOQ folded before Flop (didn't bet)
Seat 3: rUpvA02nErFvZ4yFbDR8XA folded before Flop (didn't bet)
Seat 4: D3XCkXRktDfPlSguxwfnRA folded before Flop (didn't bet)
Seat 5: OiV1PWZ3IkN29JlmCcnTwQ (button) folded before Flop (didn't bet)
Seat 6: b3P5tPsBbrP+aAO9+Ts/Nw (small blind) folded on the Turn
Seat 7: qul+IMROTuFj45eWi2Tpvg (big blind) collected ($0.95)
Seat 9: tYsOBqdU1+x+yFI7zHO7hQ folded before Flop (didn't bet)




PokerStars Game #59939494116:  Hold'em No Limit ($0.10/$0.25) - 2009/07/01 0:41:19 ET
Table 'M7d9IrgQUUFFy/SZ3ksLYg' 6-max Seat #6 is the button
Seat 1: cPO/1/dTcZpLkQFm3jH3Rg ($34.30 in chips) 
Seat 2: JE/wJXmjw3bpdmjwvh2pcg ($25 in chips) 
Seat 3: eHsmIvAb2JREg4O6hNPnXg ($16.05 in chips) 
Seat 4: 7FmwVDcdEtxDpHmP4hOXsQ ($29.90 in chips) 
Seat 6: /gJNBeCkWL4o85/jvlZ4BA ($25.15 in chips) 
cPO/1/dTcZpLkQFm3jH3Rg: posts small blind $0.10
JE/wJXmjw3bpdmjwvh2pcg: posts big blind $0.25
*** HOLE CARDS ***
eHsmIvAb2JREg4O6hNPnXg: folds 
7FmwVDcdEtxDpHmP4hOXsQ: folds 
/gJNBeCkWL4o85/jvlZ4BA: folds 
cPO/1/dTcZpLkQFm3jH3Rg: raises $0.50 to $0.75
JE/wJXmjw3bpdmjwvh2pcg: raises $1.25 to $2
cPO/1/dTcZpLkQFm3jH3Rg: calls $1.25
*** FLOP *** [5h 3c 6c]
cPO/1/dTcZpLkQFm3jH3Rg: checks 
JE/wJXmjw3bpdmjwvh2pcg: bets $3
cPO/1/dTcZpLkQFm3jH3Rg: folds 
Uncalled bet ($3) returned to JE/wJXmjw3bpdmjwvh2pcg
JE/wJXmjw3bpdmjwvh2pcg collected $3.80 from pot
JE/wJXmjw3bpdmjwvh2pcg: doesn't show hand 
*** SUMMARY ***
Total pot $4 | Rake $0.20 
Board [5h 3c 6c]
Seat 1: cPO/1/dTcZpLkQFm3jH3Rg (small blind) folded on the Flop
Seat 2: JE/wJXmjw3bpdmjwvh2pcg (big blind) collected ($3.80)
Seat 3: eHsmIvAb2JREg4O6hNPnXg folded before Flop (didn't bet)
Seat 4: 7FmwVDcdEtxDpHmP4hOXsQ folded before Flop (didn't bet)
Seat 6: /gJNBeCkWL4o85/jvlZ4BA (button) folded before Flop (didn't bet)




PokerStars Game #59939494118:  Hold'em No Limit ($0.10/$0.25) - 2009/07/01 0:41:19 ET
Table 'nlpa8xI95gAflovnFxB2yg' 6-max Seat #4 is the button
Seat 1: fZQg9veL7Dd/Z04ZTjC+wQ ($65.05 in chips) 
Seat 3: I1TxPvWj8NfG8orglCinNA ($25 in chips) 
Seat 4: 5xjU9nfIjn1MBxIJKZvS5w ($31.10 in chips) 
Seat 5: 6DwBRH+xZ12AAZmeAg+aXw ($25 in chips) 
Seat 6: FPlQHZog0ePFCETQ2KG4hQ ($26.25 in chips) 
6DwBRH+xZ12AAZmeAg+aXw: posts small blind $0.10
FPlQHZog0ePFCETQ2KG4hQ: posts big blind $0.25
WrLI51S2iMb8GLMB83gGqA: sits out 
*** HOLE CARDS ***
fZQg9veL7Dd/Z04ZTjC+wQ: raises $0.75 to $1
I1TxPvWj8NfG8orglCinNA: folds 
5xjU9nfIjn1MBxIJKZvS5w: calls $1
6DwBRH+xZ12AAZmeAg+aXw: folds 
FPlQHZog0ePFCETQ2KG4hQ: folds 
*** FLOP *** [7c 6c Qd]
fZQg9veL7Dd/Z04ZTjC+wQ: checks 
5xjU9nfIjn1MBxIJKZvS5w: checks 
*** TURN *** [7c 6c Qd] [9d]
fZQg9veL7Dd/Z04ZTjC+wQ: checks 
5xjU9nfIjn1MBxIJKZvS5w: checks 
*** RIVER *** [7c 6c Qd 9d] [2d]
fZQg9veL7Dd/Z04ZTjC+wQ: checks 
5xjU9nfIjn1MBxIJKZvS5w: checks 
*** SHOW DOWN ***
fZQg9veL7Dd/Z04ZTjC+wQ: shows [As Ts] (high card Ace)
5xjU9nfIjn1MBxIJKZvS5w: shows [7h 5h] (a pair of Sevens)
5xjU9nfIjn1MBxIJKZvS5w collected $2.25 from pot
*** SUMMARY ***
Total pot $2.35 | Rake $0.10 
Board [7c 6c Qd 9d 2d]
Seat 1: fZQg9veL7Dd/Z04ZTjC+wQ showed [As Ts] and lost with high card Ace
Seat 3: I1TxPvWj8NfG8orglCinNA folded before Flop (didn't bet)
Seat 4: 5xjU9nfIjn1MBxIJKZvS5w (button) showed [7h 5h] and won ($2.25) with a pair of Sevens
Seat 5: 6DwBRH+xZ12AAZmeAg+aXw (small blind) folded before Flop
Seat 6: FPlQHZog0ePFCETQ2KG4hQ (big blind) folded before Flop




PokerStars Game #59939494154:  Hold'em No Limit ($0.10/$0.25) - 2009/07/01 0:41:19 ET
Table 'g+mPuNJBCHKE9ents7ZGtg' 6-max Seat #2 is the button
Seat 1: rlqzz6sTpiZGIiNuqy7QUA ($39.55 in chips) 
Seat 2: fZQg9veL7Dd/Z04ZTjC+wQ ($30 in chips) 
Seat 3: 9jSiy0meE9XJKkdIZwyTEQ ($25 in chips) 
Seat 4: mfrkWA3PTeYPkbO6hi98Aw ($27 in chips) 
Seat 6: MS2T205Bjud7PnNoANu4vQ ($46.20 in chips) 
9jSiy0meE9XJKkdIZwyTEQ: posts small blind $0.10
mfrkWA3PTeYPkbO6hi98Aw: posts big blind $0.25
32YL2ZEp8NT4JB2RVM9euQ: sits out 
*** HOLE CARDS ***
MS2T205Bjud7PnNoANu4vQ: folds 
rlqzz6sTpiZGIiNuqy7QUA: raises $0.50 to $0.75
fZQg9veL7Dd/Z04ZTjC+wQ: folds 
9jSiy0meE9XJKkdIZwyTEQ: folds 
mfrkWA3PTeYPkbO6hi98Aw: folds 
Uncalled bet ($0.50) returned to rlqzz6sTpiZGIiNuqy7QUA
rlqzz6sTpiZGIiNuqy7QUA collected $0.60 from pot
*** SUMMARY ***
Total pot $0.60 | Rake $0 
Seat 1: rlqzz6sTpiZGIiNuqy7QUA collected ($0.60)
Seat 2: fZQg9veL7Dd/Z04ZTjC+wQ (button) folded before Flop (didn't bet)
Seat 3: 9jSiy0meE9XJKkdIZwyTEQ (small blind) folded before Flop
Seat 4: mfrkWA3PTeYPkbO6hi98Aw (big blind) folded before Flop
Seat 6: MS2T205Bjud7PnNoANu4vQ folded before Flop (didn't bet)




PokerStars Game #59939494036:  Hold'em No Limit ($0.10/$0.25) - 2009/07/01 0:41:19 ET
Table 'Xi38lWH8L2JHRAsKYVX8Qg' 6-max Seat #4 is the button
Seat 1: AqQ7DFpHkgIzTwDu+rClcg ($5.50 in chips) 
Seat 4: d0J1xuhsynEY81YHwAvJ5g ($25 in chips) 
Seat 6: aogAb4Eienxztk8p2v9VVw ($22.35 in chips) 
79ID/ub1Pt/mDpCprVmOoA will be allowed to play after the button
aogAb4Eienxztk8p2v9VVw: posts small blind $0.10
AqQ7DFpHkgIzTwDu+rClcg: posts big blind $0.25
6DwBRH+xZ12AAZmeAg+aXw: sits out 
*** HOLE CARDS ***
d0J1xuhsynEY81YHwAvJ5g: raises $0.75 to $1
aogAb4Eienxztk8p2v9VVw: folds 
AqQ7DFpHkgIzTwDu+rClcg: folds 
Uncalled bet ($0.75) returned to d0J1xuhsynEY81YHwAvJ5g
d0J1xuhsynEY81YHwAvJ5g collected $0.60 from pot
d0J1xuhsynEY81YHwAvJ5g: doesn't show hand 
*** SUMMARY ***
Total pot $0.60 | Rake $0 
Seat 1: AqQ7DFpHkgIzTwDu+rClcg (big blind) folded before Flop
Seat 4: d0J1xuhsynEY81YHwAvJ5g (button) collected ($0.60)
Seat 6: aogAb4Eienxztk8p2v9VVw (small blind) folded before Flop




PokerStars Game #59939494210:  Hold'em No Limit ($0.10/$0.25) - 2009/07/01 0:41:19 ET
Table 'sJ4KpS2GE5Qrsu1/cFjJUw' 9-max Seat #1 is the button
Seat 1: QsLvCwfSWqP+CfjwUnjpXQ ($14.85 in chips) 
Seat 3: eDil7UzSZCjyh1VP6SVXJQ ($7.55 in chips) 
Seat 8: f8ixGbSVIs6Be0mH69ldVQ ($14.10 in chips) 
eDil7UzSZCjyh1VP6SVXJQ: posts small blind $0.10
f8ixGbSVIs6Be0mH69ldVQ: posts big blind $0.25
*** HOLE CARDS ***
QsLvCwfSWqP+CfjwUnjpXQ: folds 
eDil7UzSZCjyh1VP6SVXJQ: calls $0.15
f8ixGbSVIs6Be0mH69ldVQ: raises $0.25 to $0.50
eDil7UzSZCjyh1VP6SVXJQ: folds 
Uncalled bet ($0.25) returned to f8ixGbSVIs6Be0mH69ldVQ
f8ixGbSVIs6Be0mH69ldVQ collected $0.50 from pot
f8ixGbSVIs6Be0mH69ldVQ: doesn't show hand 
*** SUMMARY ***
Total pot $0.50 | Rake $0 
Seat 1: QsLvCwfSWqP+CfjwUnjpXQ (button) folded before Flop (didn't bet)
Seat 3: eDil7UzSZCjyh1VP6SVXJQ (small blind) folded before Flop
Seat 8: f8ixGbSVIs6Be0mH69ldVQ (big blind) collected ($0.50)




PokerStars Game #59939493858:  Hold'em No Limit ($0.10/$0.25) - 2009/07/01 0:41:19 ET
Table 'zW+7jPbOLCvlPu+dUGY5WQ' 6-max Seat #6 is the button
Seat 1: JE/wJXmjw3bpdmjwvh2pcg ($21.15 in chips) 
Seat 2: DXgVFTcE3WofABsNJ5G/nw ($15 in chips) 
Seat 3: BedjMfrlRfPgSq7CXpPAmg ($64.10 in chips) 
Seat 4: Qv4VzEkN09uD11sjKv02Ig ($36.10 in chips) 
Seat 5: SFmT9ZsVopnukjvAzrxTRg ($55.75 in chips) 
Seat 6: BiLBinPhgpKAYzLgKJVU5A ($21.60 in chips) 
JE/wJXmjw3bpdmjwvh2pcg: posts small blind $0.10
DXgVFTcE3WofABsNJ5G/nw: posts big blind $0.25
*** HOLE CARDS ***
BedjMfrlRfPgSq7CXpPAmg: folds 
Qv4VzEkN09uD11sjKv02Ig: raises $0.50 to $0.75
SFmT9ZsVopnukjvAzrxTRg: folds 
BiLBinPhgpKAYzLgKJVU5A: folds 
JE/wJXmjw3bpdmjwvh2pcg: folds 
DXgVFTcE3WofABsNJ5G/nw: folds 
Uncalled bet ($0.50) returned to Qv4VzEkN09uD11sjKv02Ig
Qv4VzEkN09uD11sjKv02Ig collected $0.60 from pot
*** SUMMARY ***
Total pot $0.60 | Rake $0 
Seat 1: JE/wJXmjw3bpdmjwvh2pcg (small blind) folded before Flop
Seat 2: DXgVFTcE3WofABsNJ5G/nw (big blind) folded before Flop
Seat 3: BedjMfrlRfPgSq7CXpPAmg folded before Flop (didn't bet)
Seat 4: Qv4VzEkN09uD11sjKv02Ig collected ($0.60)
Seat 5: SFmT9ZsVopnukjvAzrxTRg folded before Flop (didn't bet)
Seat 6: BiLBinPhgpKAYzLgKJVU5A (button) folded before Flop (didn't bet)




PokerStars Game #59939494410:  Hold'em No Limit ($0.10/$0.25) - 2009/07/01 0:41:20 ET
Table '2O5CgfSkSwrr4PDrlZ1RLQ' 6-max Seat #6 is the button
Seat 1: kyRaCIljYA6l33lSKQfNsg ($47.35 in chips) 
Seat 2: /gJNBeCkWL4o85/jvlZ4BA ($49.75 in chips) 
Seat 3: yzFNNFIfC89bBPwpFPx2ow ($25 in chips) 
Seat 4: 4x9jCqgSw4272dnaIqnanw ($11.85 in chips) 
Seat 5: AMrBn4Vx9aAo/vv6WHLk6w ($2.55 in chips) 
Seat 6: tj9xqoqQaDaFw7u1oyZrtA ($25 in chips) 
kyRaCIljYA6l33lSKQfNsg: posts small blind $0.10
/gJNBeCkWL4o85/jvlZ4BA: posts big blind $0.25
*** HOLE CARDS ***
yzFNNFIfC89bBPwpFPx2ow: folds 
4x9jCqgSw4272dnaIqnanw: folds 
AMrBn4Vx9aAo/vv6WHLk6w: folds 
tj9xqoqQaDaFw7u1oyZrtA: calls $0.25
kyRaCIljYA6l33lSKQfNsg: calls $0.15
/gJNBeCkWL4o85/jvlZ4BA: checks 
*** FLOP *** [Kh 6s Js]
kyRaCIljYA6l33lSKQfNsg: checks 
/gJNBeCkWL4o85/jvlZ4BA: checks 
tj9xqoqQaDaFw7u1oyZrtA is disconnected 
tj9xqoqQaDaFw7u1oyZrtA has timed out while disconnected
tj9xqoqQaDaFw7u1oyZrtA: checks 
*** TURN *** [Kh 6s Js] [Qd]
kyRaCIljYA6l33lSKQfNsg: checks 
/gJNBeCkWL4o85/jvlZ4BA: bets $1
tj9xqoqQaDaFw7u1oyZrtA is connected 
tj9xqoqQaDaFw7u1oyZrtA: folds 
kyRaCIljYA6l33lSKQfNsg: folds 
Uncalled bet ($1) returned to /gJNBeCkWL4o85/jvlZ4BA
/gJNBeCkWL4o85/jvlZ4BA collected $0.75 from pot
*** SUMMARY ***
Total pot $0.75 | Rake $0 
Board [Kh 6s Js Qd]
Seat 1: kyRaCIljYA6l33lSKQfNsg (small blind) folded on the Turn
Seat 2: /gJNBeCkWL4o85/jvlZ4BA (big blind) collected ($0.75)
Seat 3: yzFNNFIfC89bBPwpFPx2ow folded before Flop (didn't bet)
Seat 4: 4x9jCqgSw4272dnaIqnanw folded before Flop (didn't bet)
Seat 5: AMrBn4Vx9aAo/vv6WHLk6w folded before Flop (didn't bet)
Seat 6: tj9xqoqQaDaFw7u1oyZrtA (button) folded on the Turn




PokerStars Game #59939494458:  Hold'em No Limit ($0.10/$0.25) - 2009/07/01 0:41:20 ET
Table '6aL2C8IFwHHr6SG6RgXaow' 9-max Seat #2 is the button
Seat 2: +gMmKt3DaQng9M42CmxIZg ($24.20 in chips) 
Seat 5: wre31HfyzQGpIvID1istxw ($14.10 in chips) 
Seat 6: HxDF4QSxC4z39D7teZpprQ ($35.50 in chips) 
Seat 7: rPToQDbLWB+dKnz7fcQSIg ($8.30 in chips) 
Seat 8: rQhYIYXSyH/IivYM1dlV5A ($17.65 in chips) 
Seat 9: yduPKWPzL8YlT5Zv/Nmrwg ($13.65 in chips) 
tAxW5XKyzLgVZEyECMLCGw will be allowed to play after the button
wre31HfyzQGpIvID1istxw: posts small blind $0.10
HxDF4QSxC4z39D7teZpprQ: posts big blind $0.25
*** HOLE CARDS ***
rPToQDbLWB+dKnz7fcQSIg: folds 
rQhYIYXSyH/IivYM1dlV5A: raises $0.50 to $0.75
yduPKWPzL8YlT5Zv/Nmrwg: folds 
+gMmKt3DaQng9M42CmxIZg: folds 
wre31HfyzQGpIvID1istxw: calls $0.65
HxDF4QSxC4z39D7teZpprQ: calls $0.50
*** FLOP *** [6d 2h As]
wre31HfyzQGpIvID1istxw: checks 
HxDF4QSxC4z39D7teZpprQ: checks 
rQhYIYXSyH/IivYM1dlV5A: bets $1
wre31HfyzQGpIvID1istxw: folds 
HxDF4QSxC4z39D7teZpprQ: calls $1
*** TURN *** [6d 2h As] [6c]
HxDF4QSxC4z39D7teZpprQ: checks 
rQhYIYXSyH/IivYM1dlV5A: checks 
*** RIVER *** [6d 2h As 6c] [Qh]
HxDF4QSxC4z39D7teZpprQ: checks 
rQhYIYXSyH/IivYM1dlV5A: checks 
*** SHOW DOWN ***
HxDF4QSxC4z39D7teZpprQ: shows [3s 5c] (a pair of Sixes)
rQhYIYXSyH/IivYM1dlV5A: shows [8d 8c] (two pair, Eights and Sixes)
rQhYIYXSyH/IivYM1dlV5A collected $4.05 from pot
*** SUMMARY ***
Total pot $4.25 | Rake $0.20 
Board [6d 2h As 6c Qh]
Seat 2: +gMmKt3DaQng9M42CmxIZg (button) folded before Flop (didn't bet)
Seat 5: wre31HfyzQGpIvID1istxw (small blind) folded on the Flop
Seat 6: HxDF4QSxC4z39D7teZpprQ (big blind) showed [3s 5c] and lost with a pair of Sixes
Seat 7: rPToQDbLWB+dKnz7fcQSIg folded before Flop (didn't bet)
Seat 8: rQhYIYXSyH/IivYM1dlV5A showed [8d 8c] and won ($4.05) with two pair, Eights and Sixes
Seat 9: yduPKWPzL8YlT5Zv/Nmrwg folded before Flop (didn't bet)




PokerStars Game #59939494296:  Hold'em No Limit ($0.10/$0.25) - 2009/07/01 0:41:20 ET
Table 'gHbubGDeVSkmB4vFiqIN3Q' 6-max Seat #6 is the button
Seat 2: 8LzEWRhg4wk8Jh9CqDhH3Q ($4.20 in chips) 
Seat 4: v+QfkGiuj9bgtuNoVnDO8w ($32.15 in chips) 
Seat 6: wvIIdlbCgePONQwXjx9xzQ ($4.85 in chips) 
8LzEWRhg4wk8Jh9CqDhH3Q: posts small blind $0.10
v+QfkGiuj9bgtuNoVnDO8w: posts big blind $0.25
*** HOLE CARDS ***
wvIIdlbCgePONQwXjx9xzQ: folds 
wvIIdlbCgePONQwXjx9xzQ leaves the table
8LzEWRhg4wk8Jh9CqDhH3Q: calls $0.15
v+QfkGiuj9bgtuNoVnDO8w: folds 
v+QfkGiuj9bgtuNoVnDO8w leaves the table
8LzEWRhg4wk8Jh9CqDhH3Q collected $0.50 from pot
8LzEWRhg4wk8Jh9CqDhH3Q: doesn't show hand 
*** SUMMARY ***
Total pot $0.50 | Rake $0 
Seat 2: 8LzEWRhg4wk8Jh9CqDhH3Q (small blind) collected ($0.50)
Seat 4: v+QfkGiuj9bgtuNoVnDO8w (big blind) folded before Flop
Seat 6: wvIIdlbCgePONQwXjx9xzQ (button) folded before Flop (didn't bet)




PokerStars Game #59939494440:  Hold'em No Limit ($0.10/$0.25) - 2009/07/01 0:41:20 ET
Table 'g6ryG70feTw9nNm+XJLuXw' 6-max Seat #5 is the button
Seat 1: v+QfkGiuj9bgtuNoVnDO8w ($27.70 in chips) 
Seat 2: SxIIgwXYLkwd6m3wLyPTCw ($25.25 in chips) 
Seat 3: /6h8PvAHQmfuMUZ8OUF6Xw ($26.55 in chips) 
Seat 4: GC/9yVD59DUCX7hUI7gcLw ($37.90 in chips) 
Seat 5: EE16Ua5b1HSsYej5zeXOlA ($25 in chips) 
v+QfkGiuj9bgtuNoVnDO8w: posts small blind $0.10
SxIIgwXYLkwd6m3wLyPTCw: posts big blind $0.25
*** HOLE CARDS ***
/6h8PvAHQmfuMUZ8OUF6Xw: folds 
GC/9yVD59DUCX7hUI7gcLw: folds 
EE16Ua5b1HSsYej5zeXOlA: raises $0.50 to $0.75
v+QfkGiuj9bgtuNoVnDO8w: folds 
SxIIgwXYLkwd6m3wLyPTCw: folds 
Uncalled bet ($0.50) returned to EE16Ua5b1HSsYej5zeXOlA
EE16Ua5b1HSsYej5zeXOlA collected $0.60 from pot
EE16Ua5b1HSsYej5zeXOlA: doesn't show hand 
*** SUMMARY ***
Total pot $0.60 | Rake $0 
Seat 1: v+QfkGiuj9bgtuNoVnDO8w (small blind) folded before Flop
Seat 2: SxIIgwXYLkwd6m3wLyPTCw (big blind) folded before Flop
Seat 3: /6h8PvAHQmfuMUZ8OUF6Xw folded before Flop (didn't bet)
Seat 4: GC/9yVD59DUCX7hUI7gcLw folded before Flop (didn't bet)
Seat 5: EE16Ua5b1HSsYej5zeXOlA (button) collected ($0.60)




PokerStars Game #59939494540:  Hold'em No Limit ($0.10/$0.25) - 2009/07/01 0:41:20 ET
Table 'AUM6O+mgQAaLDZKMQ/5/gA' 9-max Seat #5 is the button
Seat 1: Eyuoq9VsHg1Puw0nNzXTjg ($6.35 in chips) 
Seat 2: p0Q0llBV74kraoiHI/UzWA ($24.75 in chips) 
Seat 3: 3m6VfX7io8SA31qh1zCkgQ ($13.35 in chips) 
Seat 4: GIv32m/KBYU5WdIHUImuIg ($4.75 in chips) 
Seat 5: +2kMBNpY4nF1qNCRd8SJLA ($25.95 in chips) 
Seat 6: cFmpjvcjNoVAEAIQIxWkYg ($25 in chips) 
Seat 7: jXz58rvCgq0VjyVjUBf2mw ($25 in chips) 
cFmpjvcjNoVAEAIQIxWkYg: posts small blind $0.10
jXz58rvCgq0VjyVjUBf2mw: posts big blind $0.25
zDrucyjVn5aeekNEc3cJrA: sits out 
upsista: sits out 
*** HOLE CARDS ***
Eyuoq9VsHg1Puw0nNzXTjg: folds 
p0Q0llBV74kraoiHI/UzWA: folds 
3m6VfX7io8SA31qh1zCkgQ: folds 
GIv32m/KBYU5WdIHUImuIg: folds 
+2kMBNpY4nF1qNCRd8SJLA: raises $0.75 to $1
cFmpjvcjNoVAEAIQIxWkYg: folds 
jXz58rvCgq0VjyVjUBf2mw: calls $0.75
*** FLOP *** [4d Td 8c]
jXz58rvCgq0VjyVjUBf2mw: checks 
+2kMBNpY4nF1qNCRd8SJLA: checks 
*** TURN *** [4d Td 8c] [4s]
jXz58rvCgq0VjyVjUBf2mw: checks 
+2kMBNpY4nF1qNCRd8SJLA: checks 
*** RIVER *** [4d Td 8c 4s] [9s]
jXz58rvCgq0VjyVjUBf2mw: checks 
+2kMBNpY4nF1qNCRd8SJLA: checks 
*** SHOW DOWN ***
jXz58rvCgq0VjyVjUBf2mw: shows [Kd As] (a pair of Fours)
+2kMBNpY4nF1qNCRd8SJLA: mucks hand 
jXz58rvCgq0VjyVjUBf2mw collected $2 from pot
*** SUMMARY ***
Total pot $2.10 | Rake $0.10 
Board [4d Td 8c 4s 9s]
Seat 1: Eyuoq9VsHg1Puw0nNzXTjg folded before Flop (didn't bet)
Seat 2: p0Q0llBV74kraoiHI/UzWA folded before Flop (didn't bet)
Seat 3: 3m6VfX7io8SA31qh1zCkgQ folded before Flop (didn't bet)
Seat 4: GIv32m/KBYU5WdIHUImuIg folded before Flop (didn't bet)
Seat 5: +2kMBNpY4nF1qNCRd8SJLA (button) mucked
Seat 6: cFmpjvcjNoVAEAIQIxWkYg (small blind) folded before Flop
Seat 7: jXz58rvCgq0VjyVjUBf2mw (big blind) showed [Kd As] and won ($2) with a pair of Fours




PokerStars Game #59939494566:  Hold'em No Limit ($0.10/$0.25) - 2009/07/01 0:41:20 ET
Table 'sgB7AwZtVgDTf4fi8RwWFQ' 9-max Seat #9 is the button
Seat 1: QEbIGci+itdw+re8RM5fZA ($25.55 in chips) 
Seat 2: DnDcAdn9P0zGovMERigpFA ($32 in chips) 
Seat 3: OlPJsgR4xypSg/w1z7Gyvw ($20.10 in chips) 
Seat 5: gPFzi0PLRAvfKu2GYwa1VA ($16.05 in chips) 
Seat 6: 1q23ISSsSMhv2lHXBfj9/A ($23.40 in chips) 
Seat 8: Nq5F1B22aaLLZ+D9HbzcGg ($22 in chips) 
Seat 9: MG90wfSJZnOejs/KD3vlQQ ($32.25 in chips) 
QEbIGci+itdw+re8RM5fZA: posts small blind $0.10
DnDcAdn9P0zGovMERigpFA: posts big blind $0.25
*** HOLE CARDS ***
OlPJsgR4xypSg/w1z7Gyvw: folds 
OlPJsgR4xypSg/w1z7Gyvw leaves the table
eenho joins the table at seat #4 
gPFzi0PLRAvfKu2GYwa1VA: folds 
1q23ISSsSMhv2lHXBfj9/A: folds 
Nq5F1B22aaLLZ+D9HbzcGg: folds 
MG90wfSJZnOejs/KD3vlQQ: raises $0.50 to $0.75
QEbIGci+itdw+re8RM5fZA: folds 
DnDcAdn9P0zGovMERigpFA: calls $0.50
*** FLOP *** [Jd 3d Th]
DnDcAdn9P0zGovMERigpFA: checks 
MG90wfSJZnOejs/KD3vlQQ: bets $1.20
DnDcAdn9P0zGovMERigpFA: folds 
Uncalled bet ($1.20) returned to MG90wfSJZnOejs/KD3vlQQ
MG90wfSJZnOejs/KD3vlQQ collected $1.55 from pot
MG90wfSJZnOejs/KD3vlQQ: doesn't show hand 
*** SUMMARY ***
Total pot $1.60 | Rake $0.05 
Board [Jd 3d Th]
Seat 1: QEbIGci+itdw+re8RM5fZA (small blind) folded before Flop
Seat 2: DnDcAdn9P0zGovMERigpFA (big blind) folded on the Flop
Seat 3: OlPJsgR4xypSg/w1z7Gyvw folded before Flop (didn't bet)
Seat 5: gPFzi0PLRAvfKu2GYwa1VA folded before Flop (didn't bet)
Seat 6: 1q23ISSsSMhv2lHXBfj9/A folded before Flop (didn't bet)
Seat 8: Nq5F1B22aaLLZ+D9HbzcGg folded before Flop (didn't bet)
Seat 9: MG90wfSJZnOejs/KD3vlQQ (button) collected ($1.55)




PokerStars Game #59939494520:  Hold'em No Limit ($0.10/$0.25) - 2009/07/01 0:41:20 ET
Table 'Jz+kWRxWNGk9w24fdQEveA' 9-max Seat #9 is the button
Seat 1: 1K6QGyJP9P9xmRac2fH4OQ ($25.55 in chips) 
Seat 2: ljemhp25Zg+nlA9DLCIiUw ($28.90 in chips) 
Seat 4: HPEB+AtKw1+C/cxU0o1ciw ($24.45 in chips) 
Seat 5: DdPXdieucQ+n99u1n3A+rQ ($5 in chips) 
Seat 6: boms8cM+kQJF0xGLbvuFtg ($10.15 in chips) 
Seat 7: st9jtdNbm1W5GfBwRaCVqQ ($31.35 in chips) 
Seat 8: G7adEXZse2f4gqTWfn/C+Q ($11.30 in chips) 
Seat 9: z7SDvPqXQA6iOv0833Gpig ($13.20 in chips) 
1K6QGyJP9P9xmRac2fH4OQ: posts small blind $0.10
ljemhp25Zg+nlA9DLCIiUw: posts big blind $0.25
*** HOLE CARDS ***
HPEB+AtKw1+C/cxU0o1ciw: folds 
DdPXdieucQ+n99u1n3A+rQ: folds 
boms8cM+kQJF0xGLbvuFtg: calls $0.25
st9jtdNbm1W5GfBwRaCVqQ: calls $0.25
G7adEXZse2f4gqTWfn/C+Q: folds 
z7SDvPqXQA6iOv0833Gpig: calls $0.25
uwmAXQRjyA4iX5kaC15P9A joins the table at seat #3 
1K6QGyJP9P9xmRac2fH4OQ: calls $0.15
ljemhp25Zg+nlA9DLCIiUw: checks 
*** FLOP *** [As Ac Kh]
1K6QGyJP9P9xmRac2fH4OQ: bets $0.80
ljemhp25Zg+nlA9DLCIiUw: folds 
boms8cM+kQJF0xGLbvuFtg: folds 
st9jtdNbm1W5GfBwRaCVqQ: folds 
z7SDvPqXQA6iOv0833Gpig: calls $0.80
*** TURN *** [As Ac Kh] [7h]
1K6QGyJP9P9xmRac2fH4OQ: checks 
z7SDvPqXQA6iOv0833Gpig: bets $1.25
1K6QGyJP9P9xmRac2fH4OQ: folds 
Uncalled bet ($1.25) returned to z7SDvPqXQA6iOv0833Gpig
z7SDvPqXQA6iOv0833Gpig collected $2.75 from pot
z7SDvPqXQA6iOv0833Gpig: doesn't show hand 
*** SUMMARY ***
Total pot $2.85 | Rake $0.10 
Board [As Ac Kh 7h]
Seat 1: 1K6QGyJP9P9xmRac2fH4OQ (small blind) folded on the Turn
Seat 2: ljemhp25Zg+nlA9DLCIiUw (big blind) folded on the Flop
Seat 4: HPEB+AtKw1+C/cxU0o1ciw folded before Flop (didn't bet)
Seat 5: DdPXdieucQ+n99u1n3A+rQ folded before Flop (didn't bet)
Seat 6: boms8cM+kQJF0xGLbvuFtg folded on the Flop
Seat 7: st9jtdNbm1W5GfBwRaCVqQ folded on the Flop
Seat 8: G7adEXZse2f4gqTWfn/C+Q folded before Flop (didn't bet)
Seat 9: z7SDvPqXQA6iOv0833Gpig (button) collected ($2.75)




PokerStars Game #59939494220:  Hold'em No Limit ($0.10/$0.25) - 2009/07/01 0:41:20 ET
Table 'jItkp2PNTbH9Cf7gqsAF7g' 9-max Seat #1 is the button
Seat 1: OiV1PWZ3IkN29JlmCcnTwQ ($4.50 in chips) 
Seat 2: qwr38jl5txoR36M7G5qi4A ($7.50 in chips) 
Seat 3: E0iYnEVO2ho7dH3QcCjw7g ($24.70 in chips) 
Seat 4: GQTWTgG7Ydy9q/vohVnKmQ ($31.20 in chips) 
Seat 5: uH1RN27w9SKa7TpVR9EFrQ ($17.55 in chips) 
Seat 6: cZ99hugmLBj9KhTlc8nCSw ($58.60 in chips) 
Seat 7: st9jtdNbm1W5GfBwRaCVqQ ($21.50 in chips) 
Seat 8: t82lXIS9gxYmNHmDgWRFAQ ($11.35 in chips) 
Seat 9: H9KUl8cmpLgEpOVDA00bCg ($6.60 in chips) 
qwr38jl5txoR36M7G5qi4A: posts small blind $0.10
E0iYnEVO2ho7dH3QcCjw7g: posts big blind $0.25
*** HOLE CARDS ***
GQTWTgG7Ydy9q/vohVnKmQ: folds 
uH1RN27w9SKa7TpVR9EFrQ: folds 
cZ99hugmLBj9KhTlc8nCSw: folds 
st9jtdNbm1W5GfBwRaCVqQ: raises $0.50 to $0.75
t82lXIS9gxYmNHmDgWRFAQ: folds 
H9KUl8cmpLgEpOVDA00bCg: folds 
OiV1PWZ3IkN29JlmCcnTwQ: folds 
qwr38jl5txoR36M7G5qi4A: folds 
E0iYnEVO2ho7dH3QcCjw7g: folds 
Uncalled bet ($0.50) returned to st9jtdNbm1W5GfBwRaCVqQ
st9jtdNbm1W5GfBwRaCVqQ collected $0.60 from pot
st9jtdNbm1W5GfBwRaCVqQ: doesn't show hand 
*** SUMMARY ***
Total pot $0.60 | Rake $0 
Seat 1: OiV1PWZ3IkN29JlmCcnTwQ (button) folded before Flop (didn't bet)
Seat 2: qwr38jl5txoR36M7G5qi4A (small blind) folded before Flop
Seat 3: E0iYnEVO2ho7dH3QcCjw7g (big blind) folded before Flop
Seat 4: GQTWTgG7Ydy9q/vohVnKmQ folded before Flop (didn't bet)
Seat 5: uH1RN27w9SKa7TpVR9EFrQ folded before Flop (didn't bet)
Seat 6: cZ99hugmLBj9KhTlc8nCSw folded before Flop (didn't bet)
Seat 7: st9jtdNbm1W5GfBwRaCVqQ collected ($0.60)
Seat 8: t82lXIS9gxYmNHmDgWRFAQ folded before Flop (didn't bet)
Seat 9: H9KUl8cmpLgEpOVDA00bCg folded before Flop (didn't bet)




PokerStars Game #59939494244:  Hold'em No Limit ($0.10/$0.25) - 2009/07/01 0:41:20 ET
Table 'xro+BVoe2Zuw1TYmz/McJQ' 9-max Seat #1 is the button
Seat 1: xEQxarad8/T4jJdpZy5LGw ($7.35 in chips) 
Seat 2: MXCztnYJ58KLHMztZvKrxA ($13.50 in chips) 
Seat 3: COsrwJSFHQtxlUcrYtDQPQ ($36.95 in chips) 
Seat 4: N2LVj3iImgnOoHVf8g0rIw ($18.85 in chips) 
Seat 5: 87Warq49WFhxNpfNtKRmcQ ($28.25 in chips) 
Seat 6: HPEB+AtKw1+C/cxU0o1ciw ($26.25 in chips) 
Seat 7: QEbIGci+itdw+re8RM5fZA ($25 in chips) 
Seat 8: ljemhp25Zg+nlA9DLCIiUw ($19.80 in chips) 
Seat 9: H5Se03ZqSX7tbULXur2MAg ($24.30 in chips) 
MXCztnYJ58KLHMztZvKrxA: posts small blind $0.10
COsrwJSFHQtxlUcrYtDQPQ: posts big blind $0.25
*** HOLE CARDS ***
N2LVj3iImgnOoHVf8g0rIw: folds 
87Warq49WFhxNpfNtKRmcQ: folds 
HPEB+AtKw1+C/cxU0o1ciw: folds 
QEbIGci+itdw+re8RM5fZA: folds 
ljemhp25Zg+nlA9DLCIiUw: folds 
H5Se03ZqSX7tbULXur2MAg: folds 
xEQxarad8/T4jJdpZy5LGw: calls $0.25
MXCztnYJ58KLHMztZvKrxA: calls $0.15
COsrwJSFHQtxlUcrYtDQPQ: checks 
*** FLOP *** [9c Ah 5h]
MXCztnYJ58KLHMztZvKrxA: checks 
COsrwJSFHQtxlUcrYtDQPQ: checks 
xEQxarad8/T4jJdpZy5LGw: bets $0.50
MXCztnYJ58KLHMztZvKrxA: folds 
COsrwJSFHQtxlUcrYtDQPQ: folds 
Uncalled bet ($0.50) returned to xEQxarad8/T4jJdpZy5LGw
xEQxarad8/T4jJdpZy5LGw collected $0.75 from pot
*** SUMMARY ***
Total pot $0.75 | Rake $0 
Board [9c Ah 5h]
Seat 1: xEQxarad8/T4jJdpZy5LGw (button) collected ($0.75)
Seat 2: MXCztnYJ58KLHMztZvKrxA (small blind) folded on the Flop
Seat 3: COsrwJSFHQtxlUcrYtDQPQ (big blind) folded on the Flop
Seat 4: N2LVj3iImgnOoHVf8g0rIw folded before Flop (didn't bet)
Seat 5: 87Warq49WFhxNpfNtKRmcQ folded before Flop (didn't bet)
Seat 6: HPEB+AtKw1+C/cxU0o1ciw folded before Flop (didn't bet)
Seat 7: QEbIGci+itdw+re8RM5fZA folded before Flop (didn't bet)
Seat 8: ljemhp25Zg+nlA9DLCIiUw folded before Flop (didn't bet)
Seat 9: H5Se03ZqSX7tbULXur2MAg folded before Flop (didn't bet)




PokerStars Game #59939495434:  Hold'em No Limit ($0.10/$0.25) - 2009/07/01 0:41:21 ET
Table '6ae4XiTo6B597KfSSMr8Cg' 9-max Seat #6 is the button
Seat 1: 49YfVBEOwzD3/FVw+dTTBQ ($6 in chips) 
Seat 2: 5s3p6yoJBNW438dsyKTP8g ($45.75 in chips) 
Seat 3: yyG4svzOpC1A+sUP/scg6w ($8.05 in chips) 
Seat 4: dfNim92Z6XK1/h5SFW5vDg ($48.75 in chips) 
Seat 5: 1K6QGyJP9P9xmRac2fH4OQ ($25 in chips) 
Seat 6: DlXs37dlX3tb7o/7lYXQSw ($24.65 in chips) 
Seat 7: 18G4P1XstjNvItdGUITxgw ($25.35 in chips) 
Seat 8: F7pnn6czNpHvRM55XcA2EA ($25 in chips) 
Seat 9: E0iYnEVO2ho7dH3QcCjw7g ($34.70 in chips) 
18G4P1XstjNvItdGUITxgw: posts small blind $0.10
F7pnn6czNpHvRM55XcA2EA: posts big blind $0.25
*** HOLE CARDS ***
E0iYnEVO2ho7dH3QcCjw7g: folds 
49YfVBEOwzD3/FVw+dTTBQ: folds 
5s3p6yoJBNW438dsyKTP8g: folds 
yyG4svzOpC1A+sUP/scg6w: calls $0.25
dfNim92Z6XK1/h5SFW5vDg: folds 
1K6QGyJP9P9xmRac2fH4OQ: folds 
DlXs37dlX3tb7o/7lYXQSw: calls $0.25
18G4P1XstjNvItdGUITxgw: calls $0.15
F7pnn6czNpHvRM55XcA2EA: checks 
*** FLOP *** [2c As Jc]
18G4P1XstjNvItdGUITxgw: checks 
F7pnn6czNpHvRM55XcA2EA: checks 
yyG4svzOpC1A+sUP/scg6w: bets $0.75
DlXs37dlX3tb7o/7lYXQSw: calls $0.75
18G4P1XstjNvItdGUITxgw: folds 
F7pnn6czNpHvRM55XcA2EA: folds 
*** TURN *** [2c As Jc] [9h]
yyG4svzOpC1A+sUP/scg6w: bets $1.50
DlXs37dlX3tb7o/7lYXQSw: folds 
Uncalled bet ($1.50) returned to yyG4svzOpC1A+sUP/scg6w
yyG4svzOpC1A+sUP/scg6w collected $2.40 from pot
*** SUMMARY ***
Total pot $2.50 | Rake $0.10 
Board [2c As Jc 9h]
Seat 1: 49YfVBEOwzD3/FVw+dTTBQ folded before Flop (didn't bet)
Seat 2: 5s3p6yoJBNW438dsyKTP8g folded before Flop (didn't bet)
Seat 3: yyG4svzOpC1A+sUP/scg6w collected ($2.40)
Seat 4: dfNim92Z6XK1/h5SFW5vDg folded before Flop (didn't bet)
Seat 5: 1K6QGyJP9P9xmRac2fH4OQ folded before Flop (didn't bet)
Seat 6: DlXs37dlX3tb7o/7lYXQSw (button) folded on the Turn
Seat 7: 18G4P1XstjNvItdGUITxgw (small blind) folded on the Flop
Seat 8: F7pnn6czNpHvRM55XcA2EA (big blind) folded on the Flop
Seat 9: E0iYnEVO2ho7dH3QcCjw7g folded before Flop (didn't bet)




PokerStars Game #59939495190:  Hold'em No Limit ($0.10/$0.25) - 2009/07/01 0:41:21 ET
Table 'TJS4XvvOjO3k7mH74HJw5g' 9-max Seat #3 is the button
Seat 1: SS+d2ix02WTTacMsjCk0OQ ($25.10 in chips) 
Seat 2: ghNKXUBl/H+t83JF079ZBA ($25 in chips) 
Seat 3: 8B/dhbQjIWe6ASCdgzktNQ ($25 in chips) 
Seat 4: Y+IdmmKAoWu2irRi3Jpr4Q ($17.70 in chips) 
Seat 5: NNZypfH1f/VIj3Skf/XIzg ($4.65 in chips) 
Seat 6: cFmpjvcjNoVAEAIQIxWkYg ($25 in chips) 
Seat 7: DiSvPC2iudwL5j9u6Huyww ($25 in chips) 
Seat 8: l9TiQshP7QOsNH6jZrL4Wg ($3.55 in chips) 
Seat 9: +sbyWwIcFp9kP0bDtMegfQ ($32.25 in chips) 
Y+IdmmKAoWu2irRi3Jpr4Q: posts small blind $0.10
NNZypfH1f/VIj3Skf/XIzg: posts big blind $0.25
*** HOLE CARDS ***
cFmpjvcjNoVAEAIQIxWkYg: folds 
DiSvPC2iudwL5j9u6Huyww: folds 
l9TiQshP7QOsNH6jZrL4Wg: folds 
+sbyWwIcFp9kP0bDtMegfQ: folds 
SS+d2ix02WTTacMsjCk0OQ: calls $0.25
ghNKXUBl/H+t83JF079ZBA: folds 
8B/dhbQjIWe6ASCdgzktNQ: folds 
cFmpjvcjNoVAEAIQIxWkYg is sitting out
Y+IdmmKAoWu2irRi3Jpr4Q: calls $0.15
NNZypfH1f/VIj3Skf/XIzg: checks 
*** FLOP *** [4h 4d 8c]
Y+IdmmKAoWu2irRi3Jpr4Q: bets $0.50
NNZypfH1f/VIj3Skf/XIzg: folds 
SS+d2ix02WTTacMsjCk0OQ: calls $0.50
*** TURN *** [4h 4d 8c] [2s]
Y+IdmmKAoWu2irRi3Jpr4Q: bets $1.50
SS+d2ix02WTTacMsjCk0OQ: calls $1.50
*** RIVER *** [4h 4d 8c 2s] [6c]
Y+IdmmKAoWu2irRi3Jpr4Q: bets $2
SS+d2ix02WTTacMsjCk0OQ: raises $3.25 to $5.25
Y+IdmmKAoWu2irRi3Jpr4Q: calls $3.25
*** SHOW DOWN ***
SS+d2ix02WTTacMsjCk0OQ: shows [8s 8h] (a full house, Eights full of Fours)
Y+IdmmKAoWu2irRi3Jpr4Q: mucks hand 
SS+d2ix02WTTacMsjCk0OQ collected $14.50 from pot
*** SUMMARY ***
Total pot $15.25 | Rake $0.75 
Board [4h 4d 8c 2s 6c]
Seat 1: SS+d2ix02WTTacMsjCk0OQ showed [8s 8h] and won ($14.50) with a full house, Eights full of Fours
Seat 2: ghNKXUBl/H+t83JF079ZBA folded before Flop (didn't bet)
Seat 3: 8B/dhbQjIWe6ASCdgzktNQ (button) folded before Flop (didn't bet)
Seat 4: Y+IdmmKAoWu2irRi3Jpr4Q (small blind) mucked
Seat 5: NNZypfH1f/VIj3Skf/XIzg (big blind) folded on the Flop
Seat 6: cFmpjvcjNoVAEAIQIxWkYg folded before Flop (didn't bet)
Seat 7: DiSvPC2iudwL5j9u6Huyww folded before Flop (didn't bet)
Seat 8: l9TiQshP7QOsNH6jZrL4Wg folded before Flop (didn't bet)
Seat 9: +sbyWwIcFp9kP0bDtMegfQ folded before Flop (didn't bet)




PokerStars Game #59939495280:  Hold'em No Limit ($0.10/$0.25) - 2009/07/01 0:41:21 ET
Table 'FuFyQHmlO/QqQp//rDRrPg' 6-max Seat #4 is the button
Seat 1: 4re+a1K56DcbV7DyVX/FMw ($15.20 in chips) 
Seat 2: 0DvgWV5o6c/jYqQCjm4Haw ($25.60 in chips) 
Seat 3: uoOTv6ecGYEhLPY44ZTW+A ($11.20 in chips) 
Seat 4: Eznneya0vB6S+eXJdVleHA ($8.55 in chips) 
Eznneya0vB6S+eXJdVleHA said, "hurry upp"
wAKC8C/zN0c8V5v13dm9mA has timed out while being disconnected
wAKC8C/zN0c8V5v13dm9mA: is sitting out 
6DwBRH+xZ12AAZmeAg+aXw will be allowed to play after the button
4re+a1K56DcbV7DyVX/FMw: posts small blind $0.10
0DvgWV5o6c/jYqQCjm4Haw: posts big blind $0.25
*** HOLE CARDS ***
wAKC8C/zN0c8V5v13dm9mA is disconnected 
uoOTv6ecGYEhLPY44ZTW+A: calls $0.25
Eznneya0vB6S+eXJdVleHA: raises $0.25 to $0.50
wAKC8C/zN0c8V5v13dm9mA is connected 
wAKC8C/zN0c8V5v13dm9mA has returned
4re+a1K56DcbV7DyVX/FMw: calls $0.40
0DvgWV5o6c/jYqQCjm4Haw: calls $0.25
uoOTv6ecGYEhLPY44ZTW+A: calls $0.25
*** FLOP *** [5d 5s Ac]
4re+a1K56DcbV7DyVX/FMw: checks 
0DvgWV5o6c/jYqQCjm4Haw: checks 
uoOTv6ecGYEhLPY44ZTW+A: checks 
Eznneya0vB6S+eXJdVleHA: bets $0.50
4re+a1K56DcbV7DyVX/FMw: folds 
4re+a1K56DcbV7DyVX/FMw leaves the table
0DvgWV5o6c/jYqQCjm4Haw: raises $2.15 to $2.65
uoOTv6ecGYEhLPY44ZTW+A: folds 
jp34e617tIzV8tKIWmfAbA joins the table at seat #1 
Eznneya0vB6S+eXJdVleHA: calls $2.15
*** TURN *** [5d 5s Ac] [2c]
0DvgWV5o6c/jYqQCjm4Haw: checks 
Eznneya0vB6S+eXJdVleHA: checks 
*** RIVER *** [5d 5s Ac 2c] [8d]
0DvgWV5o6c/jYqQCjm4Haw: bets $5.20
Eznneya0vB6S+eXJdVleHA: folds 
Uncalled bet ($5.20) returned to 0DvgWV5o6c/jYqQCjm4Haw
0DvgWV5o6c/jYqQCjm4Haw collected $6.95 from pot
0DvgWV5o6c/jYqQCjm4Haw: doesn't show hand 
*** SUMMARY ***
Total pot $7.30 | Rake $0.35 
Board [5d 5s Ac 2c 8d]
Seat 1: 4re+a1K56DcbV7DyVX/FMw (small blind) folded on the Flop
Seat 2: 0DvgWV5o6c/jYqQCjm4Haw (big blind) collected ($6.95)
Seat 3: uoOTv6ecGYEhLPY44ZTW+A folded on the Flop
Seat 4: Eznneya0vB6S+eXJdVleHA (button) folded on the River




PokerStars Game #59939494846:  Hold'em No Limit ($0.10/$0.25) - 2009/07/01 0:41:21 ET
Table 'zJTgUqdWn7ojWWqV4pItEQ' 9-max Seat #1 is the button
Seat 1: CbXUS6Z2rXZxL1AKduNtmQ ($30.35 in chips) 
Seat 2: 7wo6Sr7QG3Zo6BaBDV1BOw ($6.25 in chips) 
Seat 3: 2N94FgK4Y2izKFIB+wJOjw ($20.50 in chips) 
Seat 4: ZeR3hkj1gVv9J4yPCmRrjA ($33.50 in chips) 
Seat 6: cQQdn+v2h6ICJU1fq6mEyA ($22.15 in chips) 
Seat 7: 4oA316mXLIui1QY63GXBUg ($25 in chips) 
Seat 9: DnDcAdn9P0zGovMERigpFA ($25.25 in chips) 
7wo6Sr7QG3Zo6BaBDV1BOw: posts small blind $0.10
2N94FgK4Y2izKFIB+wJOjw: posts big blind $0.25
murdog71: sits out 
*** HOLE CARDS ***
ZeR3hkj1gVv9J4yPCmRrjA: folds 
cQQdn+v2h6ICJU1fq6mEyA: calls $0.25
4oA316mXLIui1QY63GXBUg: folds 
DnDcAdn9P0zGovMERigpFA: folds 
CbXUS6Z2rXZxL1AKduNtmQ: folds 
7wo6Sr7QG3Zo6BaBDV1BOw: raises $0.75 to $1
2N94FgK4Y2izKFIB+wJOjw: folds 
cQQdn+v2h6ICJU1fq6mEyA: calls $0.75
*** FLOP *** [Kd 7s 8s]
7wo6Sr7QG3Zo6BaBDV1BOw: bets $1.25
cQQdn+v2h6ICJU1fq6mEyA: raises $4.50 to $5.75
7wo6Sr7QG3Zo6BaBDV1BOw: folds 
Uncalled bet ($4.50) returned to cQQdn+v2h6ICJU1fq6mEyA
cQQdn+v2h6ICJU1fq6mEyA collected $4.55 from pot
cQQdn+v2h6ICJU1fq6mEyA: doesn't show hand 
huynhpham joins the table at seat #8 
*** SUMMARY ***
Total pot $4.75 | Rake $0.20 
Board [Kd 7s 8s]
Seat 1: CbXUS6Z2rXZxL1AKduNtmQ (button) folded before Flop (didn't bet)
Seat 2: 7wo6Sr7QG3Zo6BaBDV1BOw (small blind) folded on the Flop
Seat 3: 2N94FgK4Y2izKFIB+wJOjw (big blind) folded before Flop
Seat 4: ZeR3hkj1gVv9J4yPCmRrjA folded before Flop (didn't bet)
Seat 6: cQQdn+v2h6ICJU1fq6mEyA collected ($4.55)
Seat 7: 4oA316mXLIui1QY63GXBUg folded before Flop (didn't bet)
Seat 9: DnDcAdn9P0zGovMERigpFA folded before Flop (didn't bet)




PokerStars Game #59939494872:  Hold'em No Limit ($0.10/$0.25) - 2009/07/01 0:41:21 ET
Table 'zKwHJD0cmKNUure9qQTfFg' 6-max Seat #1 is the button
Seat 1: zsU1ijOyYEi+40wBKPEbmw ($6.20 in chips) 
Seat 2: XwQK8xvCADxp0bUmji+Zyg ($32 in chips) 
Seat 3: wUwfsTnmpHcWa17qFlQr1Q ($5 in chips) 
Seat 4: v+QfkGiuj9bgtuNoVnDO8w ($25 in chips) 
Seat 5: I1TxPvWj8NfG8orglCinNA ($25.55 in chips) 
Seat 6: BvTq4Tu0zBOsniW3eFCnkQ ($42.50 in chips) 
XwQK8xvCADxp0bUmji+Zyg: posts small blind $0.10
wUwfsTnmpHcWa17qFlQr1Q: posts big blind $0.25
*** HOLE CARDS ***
v+QfkGiuj9bgtuNoVnDO8w: folds 
I1TxPvWj8NfG8orglCinNA: raises $0.75 to $1
BvTq4Tu0zBOsniW3eFCnkQ: folds 
zsU1ijOyYEi+40wBKPEbmw: folds 
XwQK8xvCADxp0bUmji+Zyg: folds 
wUwfsTnmpHcWa17qFlQr1Q: calls $0.75
*** FLOP *** [Kc Jd 4s]
wUwfsTnmpHcWa17qFlQr1Q: checks 
I1TxPvWj8NfG8orglCinNA: bets $1
wUwfsTnmpHcWa17qFlQr1Q: raises $3 to $4 and is all-in
I1TxPvWj8NfG8orglCinNA: calls $3
*** TURN *** [Kc Jd 4s] [Js]
*** RIVER *** [Kc Jd 4s Js] [6h]
*** SHOW DOWN ***
wUwfsTnmpHcWa17qFlQr1Q: shows [3d Kd] (two pair, Kings and Jacks)
I1TxPvWj8NfG8orglCinNA: shows [Jc Jh] (four of a kind, Jacks)
I1TxPvWj8NfG8orglCinNA collected $9.60 from pot
*** SUMMARY ***
Total pot $10.10 | Rake $0.50 
Board [Kc Jd 4s Js 6h]
Seat 1: zsU1ijOyYEi+40wBKPEbmw (button) folded before Flop (didn't bet)
Seat 2: XwQK8xvCADxp0bUmji+Zyg (small blind) folded before Flop
Seat 3: wUwfsTnmpHcWa17qFlQr1Q (big blind) showed [3d Kd] and lost with two pair, Kings and Jacks
Seat 4: v+QfkGiuj9bgtuNoVnDO8w folded before Flop (didn't bet)
Seat 5: I1TxPvWj8NfG8orglCinNA showed [Jc Jh] and won ($9.60) with four of a kind, Jacks
Seat 6: BvTq4Tu0zBOsniW3eFCnkQ folded before Flop (didn't bet)




PokerStars Game #59939494864:  Hold'em No Limit ($0.10/$0.25) - 2009/07/01 0:41:21 ET
Table 'VQNfcI8vTBCTvRfd3veTLQ' 6-max Seat #2 is the button
Seat 1: ymz+a8dgHSUFPooYplw7Ow ($23.60 in chips) 
Seat 2: KukIGupqqJCXA+Hp2bEFnA ($6.70 in chips) 
Seat 3: LtASJ9OlkqGrrUKGQlpGAw ($23.15 in chips) 
Seat 4: nc79pm0LZRdhncq55evVqA ($28.30 in chips) 
Seat 5: gX2vbKwS/8zZPENAWB7hxQ ($6.65 in chips) 
Seat 6: dlCLwmcvRShnuFDEVkdIEA ($13.50 in chips) 
LtASJ9OlkqGrrUKGQlpGAw: posts small blind $0.10
nc79pm0LZRdhncq55evVqA: posts big blind $0.25
*** HOLE CARDS ***
gX2vbKwS/8zZPENAWB7hxQ: folds 
dlCLwmcvRShnuFDEVkdIEA: folds 
ymz+a8dgHSUFPooYplw7Ow: raises $0.75 to $1
KukIGupqqJCXA+Hp2bEFnA: folds 
LtASJ9OlkqGrrUKGQlpGAw: folds 
nc79pm0LZRdhncq55evVqA: folds 
Uncalled bet ($0.75) returned to ymz+a8dgHSUFPooYplw7Ow
ymz+a8dgHSUFPooYplw7Ow collected $0.60 from pot
ymz+a8dgHSUFPooYplw7Ow: doesn't show hand 
*** SUMMARY ***
Total pot $0.60 | Rake $0 
Seat 1: ymz+a8dgHSUFPooYplw7Ow collected ($0.60)
Seat 2: KukIGupqqJCXA+Hp2bEFnA (button) folded before Flop (didn't bet)
Seat 3: LtASJ9OlkqGrrUKGQlpGAw (small blind) folded before Flop
Seat 4: nc79pm0LZRdhncq55evVqA (big blind) folded before Flop
Seat 5: gX2vbKwS/8zZPENAWB7hxQ folded before Flop (didn't bet)
Seat 6: dlCLwmcvRShnuFDEVkdIEA folded before Flop (didn't bet)




PokerStars Game #59939495452:  Hold'em No Limit ($0.10/$0.25) - 2009/07/01 0:41:21 ET
Table 'ykyWGjhNu7AvZXov27T4ew' 9-max Seat #3 is the button
Seat 2: MG90wfSJZnOejs/KD3vlQQ ($46.05 in chips) 
Seat 3: r1pFKMwWp74QwhfPWJOAyw ($5.20 in chips) 
Seat 4: hBMUlEpyU74r/fwDgIpXjQ ($25.55 in chips) 
Seat 5: lMysP2jE94oJvWGA6K5puw ($7.25 in chips) 
Seat 6: opOCI2p6kW0tINuVaAqmcQ ($25 in chips) 
Seat 8: tYsOBqdU1+x+yFI7zHO7hQ ($35.85 in chips) 
hBMUlEpyU74r/fwDgIpXjQ: posts small blind $0.10
lMysP2jE94oJvWGA6K5puw: posts big blind $0.25
CYkY0dNBaYaKs8HVCVn3mQ: sits out 
*** HOLE CARDS ***
Yv4fucyyT28mjx8V5lxKJg leaves the table
opOCI2p6kW0tINuVaAqmcQ: folds 
tYsOBqdU1+x+yFI7zHO7hQ: folds 
MG90wfSJZnOejs/KD3vlQQ: raises $0.50 to $0.75
r1pFKMwWp74QwhfPWJOAyw: calls $0.75
hBMUlEpyU74r/fwDgIpXjQ: folds 
lMysP2jE94oJvWGA6K5puw: folds 
*** FLOP *** [Ts 5h 4h]
MG90wfSJZnOejs/KD3vlQQ: bets $1.40
r1pFKMwWp74QwhfPWJOAyw: folds 
Uncalled bet ($1.40) returned to MG90wfSJZnOejs/KD3vlQQ
MG90wfSJZnOejs/KD3vlQQ collected $1.80 from pot
*** SUMMARY ***
Total pot $1.85 | Rake $0.05 
Board [Ts 5h 4h]
Seat 2: MG90wfSJZnOejs/KD3vlQQ collected ($1.80)
Seat 3: r1pFKMwWp74QwhfPWJOAyw (button) folded on the Flop
Seat 4: hBMUlEpyU74r/fwDgIpXjQ (small blind) folded before Flop
Seat 5: lMysP2jE94oJvWGA6K5puw (big blind) folded before Flop
Seat 6: opOCI2p6kW0tINuVaAqmcQ folded before Flop (didn't bet)
Seat 8: tYsOBqdU1+x+yFI7zHO7hQ folded before Flop (didn't bet)




PokerStars Game #59939496004:  Hold'em No Limit ($0.10/$0.25) - 2009/07/01 0:41:22 ET
Table 'sIHZ0lzLr4NGCaBUKhmYhAJj2eLzVCUVAGBmM+Og79iQax Seat #1 is the button
Seat 1: /XMgGtJ7mcWfe5s7McY9kw ($41.40 in chips) 
Seat 2: oMxwMC7+uAsJudeUN6aP0A ($19.20 in chips) 
Seat 3: HPEB+AtKw1+C/cxU0o1ciw ($24.05 in chips) 
Seat 4: aNpwfA31EREwO+ar4XzBCw ($47.05 in chips) 
Seat 5: UOx+/JnFB2Or6ZU9oasIlQ ($16.40 in chips) 
Seat 6: ZeR3hkj1gVv9J4yPCmRrjA ($32 in chips) 
Seat 9: wU1LtrccnZo6PYKhlJ6ElQ ($36.35 in chips) 
oMxwMC7+uAsJudeUN6aP0A: posts small blind $0.10
HPEB+AtKw1+C/cxU0o1ciw: posts big blind $0.25
18G4P1XstjNvItdGUITxgw: sits out 
*** HOLE CARDS ***
aNpwfA31EREwO+ar4XzBCw: folds 
UOx+/JnFB2Or6ZU9oasIlQ: calls $0.25
ZeR3hkj1gVv9J4yPCmRrjA: folds 
wU1LtrccnZo6PYKhlJ6ElQ: folds 
/XMgGtJ7mcWfe5s7McY9kw: folds 
oMxwMC7+uAsJudeUN6aP0A: folds 
HPEB+AtKw1+C/cxU0o1ciw: checks 
*** FLOP *** [Qh Jh 3d]
HPEB+AtKw1+C/cxU0o1ciw: checks 
UOx+/JnFB2Or6ZU9oasIlQ: bets $0.50
HPEB+AtKw1+C/cxU0o1ciw: folds 
Uncalled bet ($0.50) returned to UOx+/JnFB2Or6ZU9oasIlQ
UOx+/JnFB2Or6ZU9oasIlQ collected $0.60 from pot
*** SUMMARY ***
Total pot $0.60 | Rake $0 
Board [Qh Jh 3d]
Seat 1: /XMgGtJ7mcWfe5s7McY9kw (button) folded before Flop (didn't bet)
Seat 2: oMxwMC7+uAsJudeUN6aP0A (small blind) folded before Flop
Seat 3: HPEB+AtKw1+C/cxU0o1ciw (big blind) folded on the Flop
Seat 4: aNpwfA31EREwO+ar4XzBCw folded before Flop (didn't bet)
Seat 5: UOx+/JnFB2Or6ZU9oasIlQ collected ($0.60)
Seat 6: ZeR3hkj1gVv9J4yPCmRrjA folded before Flop (didn't bet)
Seat 9: wU1LtrccnZo6PYKhlJ6ElQ folded before Flop (didn't bet)




PokerStars Game #59939495680:  Hold'em No Limit ($0.10/$0.25) - 2009/07/01 0:41:22 ET
Table 'vFZR6Kf2Th5xBXT9brGW6A' 6-max Seat #4 is the button
Seat 1: xRkU4+naLuz7dEZFbOn9cw ($34.95 in chips) 
Seat 2: REnO5xiZ66YabxDXq2ncvA ($51.70 in chips) 
Seat 4: 79ID/ub1Pt/mDpCprVmOoA ($25.70 in chips) 
Seat 5: NhUN/JpAprdJeamFBgJH1w ($25 in chips) 
Seat 6: d0J1xuhsynEY81YHwAvJ5g ($30.10 in chips) 
NhUN/JpAprdJeamFBgJH1w: posts small blind $0.10
d0J1xuhsynEY81YHwAvJ5g: posts big blind $0.25
*** HOLE CARDS ***
xRkU4+naLuz7dEZFbOn9cw: folds 
REnO5xiZ66YabxDXq2ncvA: raises $1 to $1.25
79ID/ub1Pt/mDpCprVmOoA: folds 
NhUN/JpAprdJeamFBgJH1w: folds 
d0J1xuhsynEY81YHwAvJ5g: folds 
Uncalled bet ($1) returned to REnO5xiZ66YabxDXq2ncvA
REnO5xiZ66YabxDXq2ncvA collected $0.60 from pot
*** SUMMARY ***
Total pot $0.60 | Rake $0 
Seat 1: xRkU4+naLuz7dEZFbOn9cw folded before Flop (didn't bet)
Seat 2: REnO5xiZ66YabxDXq2ncvA collected ($0.60)
Seat 4: 79ID/ub1Pt/mDpCprVmOoA (button) folded before Flop (didn't bet)
Seat 5: NhUN/JpAprdJeamFBgJH1w (small blind) folded before Flop
Seat 6: d0J1xuhsynEY81YHwAvJ5g (big blind) folded before Flop




PokerStars Game #59939496014:  Hold'em No Limit ($0.10/$0.25) - 2009/07/01 0:41:22 ET
Table 'Y9EhDWuqWWQFM9SelXAj5g' 9-max Seat #5 is the button
Seat 1: zDrucyjVn5aeekNEc3cJrA ($19.45 in chips) 
Seat 2: nEg1b6MIksd/4x5eLY735g ($40.10 in chips) 
Seat 3: CbXUS6Z2rXZxL1AKduNtmQ ($25 in chips) 
Seat 4: 5MgYq10OC5iGoxQFwlJVuw ($15.05 in chips) 
Seat 5: LY5GvFqMlE3xxbG85bDqlw ($7.10 in chips) 
Seat 6: STkR8XvpjNv79OOMhrlh2w ($26.60 in chips) 
Seat 7: aNpwfA31EREwO+ar4XzBCw ($30.60 in chips) 
Seat 8: XDxyajtqmdag0QPvwcOG7Q ($9.85 in chips) 
Seat 9: K7bAhhMMJ/XcTmGaBZVfFQ ($25.40 in chips) 
STkR8XvpjNv79OOMhrlh2w: posts small blind $0.10
aNpwfA31EREwO+ar4XzBCw: posts big blind $0.25
*** HOLE CARDS ***
XDxyajtqmdag0QPvwcOG7Q: folds 
K7bAhhMMJ/XcTmGaBZVfFQ: folds 
zDrucyjVn5aeekNEc3cJrA: folds 
nEg1b6MIksd/4x5eLY735g: folds 
CbXUS6Z2rXZxL1AKduNtmQ: raises $0.50 to $0.75
5MgYq10OC5iGoxQFwlJVuw: calls $0.75
LY5GvFqMlE3xxbG85bDqlw: calls $0.75
STkR8XvpjNv79OOMhrlh2w: calls $0.65
aNpwfA31EREwO+ar4XzBCw: folds 
*** FLOP *** [6c Ks Jd]
STkR8XvpjNv79OOMhrlh2w: checks 
CbXUS6Z2rXZxL1AKduNtmQ: checks 
5MgYq10OC5iGoxQFwlJVuw: checks 
LY5GvFqMlE3xxbG85bDqlw: checks 
*** TURN *** [6c Ks Jd] [6s]
STkR8XvpjNv79OOMhrlh2w: bets $1
CbXUS6Z2rXZxL1AKduNtmQ: folds 
5MgYq10OC5iGoxQFwlJVuw: folds 
LY5GvFqMlE3xxbG85bDqlw: folds 
Uncalled bet ($1) returned to STkR8XvpjNv79OOMhrlh2w
STkR8XvpjNv79OOMhrlh2w collected $3.10 from pot
*** SUMMARY ***
Total pot $3.25 | Rake $0.15 
Board [6c Ks Jd 6s]
Seat 1: zDrucyjVn5aeekNEc3cJrA folded before Flop (didn't bet)
Seat 2: nEg1b6MIksd/4x5eLY735g folded before Flop (didn't bet)
Seat 3: CbXUS6Z2rXZxL1AKduNtmQ folded on the Turn
Seat 4: 5MgYq10OC5iGoxQFwlJVuw folded on the Turn
Seat 5: LY5GvFqMlE3xxbG85bDqlw (button) folded on the Turn
Seat 6: STkR8XvpjNv79OOMhrlh2w (small blind) collected ($3.10)
Seat 7: aNpwfA31EREwO+ar4XzBCw (big blind) folded before Flop
Seat 8: XDxyajtqmdag0QPvwcOG7Q folded before Flop (didn't bet)
Seat 9: K7bAhhMMJ/XcTmGaBZVfFQ folded before Flop (didn't bet)




PokerStars Game #59939495812:  Hold'em No Limit ($0.10/$0.25) - 2009/07/01 0:41:22 ET
Table 'KRiZ8S/xwAYkA4EWSX89ow' 9-max Seat #1 is the button
Seat 1: CYkY0dNBaYaKs8HVCVn3mQ ($5.70 in chips) 
Seat 2: vZGoOTJLQLhkPj4I+LNGig ($53.20 in chips) 
Seat 3: /fionJv+b9tkuIj/KKbXYw ($25.95 in chips) 
Seat 4: COsrwJSFHQtxlUcrYtDQPQ ($27.20 in chips) 
Seat 5: t2nb95S5EEFOEzNx9Itz0g ($5.30 in chips) 
Seat 6: DdPXdieucQ+n99u1n3A+rQ ($5.60 in chips) 
Seat 7: cZ99hugmLBj9KhTlc8nCSw ($25 in chips) 
Seat 8: nEg1b6MIksd/4x5eLY735g ($25.60 in chips) 
Seat 9: EcWpc/mcsCWBGKsSdZaXbA ($24.05 in chips) 
vZGoOTJLQLhkPj4I+LNGig: posts small blind $0.10
/fionJv+b9tkuIj/KKbXYw: posts big blind $0.25
*** HOLE CARDS ***
COsrwJSFHQtxlUcrYtDQPQ: folds 
t2nb95S5EEFOEzNx9Itz0g: folds 
DdPXdieucQ+n99u1n3A+rQ: folds 
cZ99hugmLBj9KhTlc8nCSw: folds 
nEg1b6MIksd/4x5eLY735g: folds 
EcWpc/mcsCWBGKsSdZaXbA: folds 
CYkY0dNBaYaKs8HVCVn3mQ: folds 
vZGoOTJLQLhkPj4I+LNGig: folds 
Uncalled bet ($0.15) returned to /fionJv+b9tkuIj/KKbXYw
/fionJv+b9tkuIj/KKbXYw collected $0.20 from pot
/fionJv+b9tkuIj/KKbXYw: doesn't show hand 
*** SUMMARY ***
Total pot $0.20 | Rake $0 
Seat 1: CYkY0dNBaYaKs8HVCVn3mQ (button) folded before Flop (didn't bet)
Seat 2: vZGoOTJLQLhkPj4I+LNGig (small blind) folded before Flop
Seat 3: /fionJv+b9tkuIj/KKbXYw (big blind) collected ($0.20)
Seat 4: COsrwJSFHQtxlUcrYtDQPQ folded before Flop (didn't bet)
Seat 5: t2nb95S5EEFOEzNx9Itz0g folded before Flop (didn't bet)
Seat 6: DdPXdieucQ+n99u1n3A+rQ folded before Flop (didn't bet)
Seat 7: cZ99hugmLBj9KhTlc8nCSw folded before Flop (didn't bet)
Seat 8: nEg1b6MIksd/4x5eLY735g folded before Flop (didn't bet)
Seat 9: EcWpc/mcsCWBGKsSdZaXbA folded before Flop (didn't bet)




PokerStars Game #59939496226:  Hold'em No Limit ($0.10/$0.25) - 2009/07/01 0:41:23 ET
Table '3Ns9nuTkynfwbBfBXzg6ww' 6-max Seat #3 is the button
Seat 3: HyXsCmHsOHAlL2pzZ9IYAg ($5.70 in chips) 
Seat 5: kBQU/db00TVAMeomlhblPg ($22.50 in chips) 
HyXsCmHsOHAlL2pzZ9IYAg: posts small blind $0.10
kBQU/db00TVAMeomlhblPg: posts big blind $0.25
*** HOLE CARDS ***
HyXsCmHsOHAlL2pzZ9IYAg: raises $0.25 to $0.50
kBQU/db00TVAMeomlhblPg: raises $0.25 to $0.75
HyXsCmHsOHAlL2pzZ9IYAg: calls $0.25
*** FLOP *** [9s Jd As]
ZZm/rg8aThjE+A2LiItuzA joins the table at seat #6 
kBQU/db00TVAMeomlhblPg: bets $1
HyXsCmHsOHAlL2pzZ9IYAg: calls $1
*** TURN *** [9s Jd As] [8s]
kBQU/db00TVAMeomlhblPg: checks 
HyXsCmHsOHAlL2pzZ9IYAg: bets $1
kBQU/db00TVAMeomlhblPg: calls $1
*** RIVER *** [9s Jd As 8s] [5h]
kBQU/db00TVAMeomlhblPg: checks 
HyXsCmHsOHAlL2pzZ9IYAg: checks 
*** SHOW DOWN ***
kBQU/db00TVAMeomlhblPg: shows [Qh Kc] (high card Ace)
HyXsCmHsOHAlL2pzZ9IYAg: shows [Td Qd] (a straight, Eight to Queen)
HyXsCmHsOHAlL2pzZ9IYAg collected $5.25 from pot
*** SUMMARY ***
Total pot $5.50 | Rake $0.25 
Board [9s Jd As 8s 5h]
Seat 3: HyXsCmHsOHAlL2pzZ9IYAg (button) (small blind) showed [Td Qd] and won ($5.25) with a straight, Eight to Queen
Seat 5: kBQU/db00TVAMeomlhblPg (big blind) showed [Qh Kc] and lost with high card Ace




PokerStars Game #59939496620:  Hold'em No Limit ($0.10/$0.25) - 2009/07/01 0:41:23 ET
Table 'vud0GB/ZlDCvUFhBFIaTlg' 9-max Seat #5 is the button
Seat 5: AwAabNdwDsTMb3aTomdOmg ($4.80 in chips) 
Seat 7: RzaVufWfW9CTnVYR7/Ge+w ($3.25 in chips) 
AwAabNdwDsTMb3aTomdOmg: posts small blind $0.10
RzaVufWfW9CTnVYR7/Ge+w: posts big blind $0.25
*** HOLE CARDS ***
AwAabNdwDsTMb3aTomdOmg: calls $0.15
RzaVufWfW9CTnVYR7/Ge+w: checks 
*** FLOP *** [6s 7s Ks]
RzaVufWfW9CTnVYR7/Ge+w: bets $0.25
AwAabNdwDsTMb3aTomdOmg: raises $0.25 to $0.50
RzaVufWfW9CTnVYR7/Ge+w: calls $0.25
*** TURN *** [6s 7s Ks] [6c]
RzaVufWfW9CTnVYR7/Ge+w: checks 
AwAabNdwDsTMb3aTomdOmg: bets $0.75
RzaVufWfW9CTnVYR7/Ge+w: calls $0.75
*** RIVER *** [6s 7s Ks 6c] [7c]
RzaVufWfW9CTnVYR7/Ge+w: checks 
AwAabNdwDsTMb3aTomdOmg: bets $1.75
RzaVufWfW9CTnVYR7/Ge+w: folds 
Uncalled bet ($1.75) returned to AwAabNdwDsTMb3aTomdOmg
AwAabNdwDsTMb3aTomdOmg collected $2.90 from pot
*** SUMMARY ***
Total pot $3 | Rake $0.10 
Board [6s 7s Ks 6c 7c]
Seat 5: AwAabNdwDsTMb3aTomdOmg (button) (small blind) collected ($2.90)
Seat 7: RzaVufWfW9CTnVYR7/Ge+w (big blind) folded on the River




PokerStars Game #59939496234:  Hold'em No Limit ($0.10/$0.25) - 2009/07/01 0:41:23 ET
Table 'MiquQrQZJJq9ZtgRIp9HFQ' 6-max Seat #4 is the button
Seat 1: hM0MSDtq2ow7J40bSR04ig ($4.90 in chips) 
Seat 2: DMQLAmut/l19xN5STQndFg ($2.25 in chips) 
Seat 4: 0HIrwssk0FQvyKULzUTtlg ($20.20 in chips) 
Seat 5: LXN9U+5F+9if/ead2+w1nw ($46.80 in chips) 
Seat 6: X9oXZTg4PhZVR+ilX2OYbA ($13.15 in chips) 
LXN9U+5F+9if/ead2+w1nw: posts small blind $0.10
X9oXZTg4PhZVR+ilX2OYbA: posts big blind $0.25
BYxjLnV1/LL0aZcTbfAOvw: sits out 
*** HOLE CARDS ***
hM0MSDtq2ow7J40bSR04ig: folds 
DMQLAmut/l19xN5STQndFg: raises $2 to $2.25 and is all-in
0HIrwssk0FQvyKULzUTtlg: folds 
LXN9U+5F+9if/ead2+w1nw: folds 
X9oXZTg4PhZVR+ilX2OYbA: folds 
Uncalled bet ($2) returned to DMQLAmut/l19xN5STQndFg
DMQLAmut/l19xN5STQndFg collected $0.60 from pot
DMQLAmut/l19xN5STQndFg: doesn't show hand 
*** SUMMARY ***
Total pot $0.60 | Rake $0 
Seat 1: hM0MSDtq2ow7J40bSR04ig folded before Flop (didn't bet)
Seat 2: DMQLAmut/l19xN5STQndFg collected ($0.60)
Seat 4: 0HIrwssk0FQvyKULzUTtlg (button) folded before Flop (didn't bet)
Seat 5: LXN9U+5F+9if/ead2+w1nw (small blind) folded before Flop
Seat 6: X9oXZTg4PhZVR+ilX2OYbA (big blind) folded before Flop




PokerStars Game #59939496212:  Hold'em No Limit ($0.10/$0.25) - 2009/07/01 0:41:23 ET
Table 'SHi8+hK6i7E2dJ/3Agbyig' 6-max Seat #6 is the button
Seat 1: gPEN9Zp33YTm/mu9/SYP1w ($24.05 in chips) 
Seat 2: Zijzy/UtPWzWVUo81HHVjQ ($43.15 in chips) 
Seat 3: 2p/OXJK5bWQbcvYltdbSfg ($30.30 in chips) 
Seat 4: +KSG/hZ6NXRHDk1WHcV2+Q ($14.90 in chips) 
Seat 5: T5wrp/d5jarm+SxNy8OQAg ($17.45 in chips) 
Seat 6: NVWCcUck2mqZMp/UrHDLKQ ($11.40 in chips) 
gPEN9Zp33YTm/mu9/SYP1w: posts small blind $0.10
Zijzy/UtPWzWVUo81HHVjQ: posts big blind $0.25
*** HOLE CARDS ***
2p/OXJK5bWQbcvYltdbSfg: calls $0.25
+KSG/hZ6NXRHDk1WHcV2+Q: folds 
T5wrp/d5jarm+SxNy8OQAg: folds 
NVWCcUck2mqZMp/UrHDLKQ: calls $0.25
gPEN9Zp33YTm/mu9/SYP1w: calls $0.15
Zijzy/UtPWzWVUo81HHVjQ: raises $0.75 to $1
2p/OXJK5bWQbcvYltdbSfg: folds 
NVWCcUck2mqZMp/UrHDLKQ: folds 
gPEN9Zp33YTm/mu9/SYP1w: calls $0.75
*** FLOP *** [Ad 5s 8c]
gPEN9Zp33YTm/mu9/SYP1w: checks 
Zijzy/UtPWzWVUo81HHVjQ: bets $1.25
gPEN9Zp33YTm/mu9/SYP1w: calls $1.25
*** TURN *** [Ad 5s 8c] [2c]
gPEN9Zp33YTm/mu9/SYP1w: checks 
Zijzy/UtPWzWVUo81HHVjQ: checks 
*** RIVER *** [Ad 5s 8c 2c] [2d]
gPEN9Zp33YTm/mu9/SYP1w: bets $4
Zijzy/UtPWzWVUo81HHVjQ: folds 
Uncalled bet ($4) returned to gPEN9Zp33YTm/mu9/SYP1w
gPEN9Zp33YTm/mu9/SYP1w collected $4.80 from pot
*** SUMMARY ***
Total pot $5 | Rake $0.20 
Board [Ad 5s 8c 2c 2d]
Seat 1: gPEN9Zp33YTm/mu9/SYP1w (small blind) collected ($4.80)
Seat 2: Zijzy/UtPWzWVUo81HHVjQ (big blind) folded on the River
Seat 3: 2p/OXJK5bWQbcvYltdbSfg folded before Flop
Seat 4: +KSG/hZ6NXRHDk1WHcV2+Q folded before Flop (didn't bet)
Seat 5: T5wrp/d5jarm+SxNy8OQAg folded before Flop (didn't bet)
Seat 6: NVWCcUck2mqZMp/UrHDLKQ (button) folded before Flop




PokerStars Game #59939496834:  Hold'em No Limit ($0.10/$0.25) - 2009/07/01 0:41:24 ET
Table 'IUwZ/e0bDHZPgsIWx0RnNg' 6-max Seat #4 is the button
Seat 1: 8JTm/CXBn3+kuQgcUOgPkw ($24.75 in chips) 
Seat 2: mvFHK3pE7tCxJEqLjKC70Q ($25 in chips) 
Seat 3: dOX4wnYV2sEqvDbF+8KSCw ($30.50 in chips) 
Seat 4: IyZ9SVxKy7TJvRGFneWTMg ($29.50 in chips) 
Seat 5: wsP46AGpqDjHZQmlRHKa9g ($25.60 in chips) 
Seat 6: NhUN/JpAprdJeamFBgJH1w ($25 in chips) 
wsP46AGpqDjHZQmlRHKa9g: posts small blind $0.10
NhUN/JpAprdJeamFBgJH1w: posts big blind $0.25
*** HOLE CARDS ***
8JTm/CXBn3+kuQgcUOgPkw: folds 
mvFHK3pE7tCxJEqLjKC70Q: raises $0.50 to $0.75
dOX4wnYV2sEqvDbF+8KSCw: folds 
IyZ9SVxKy7TJvRGFneWTMg: folds 
wsP46AGpqDjHZQmlRHKa9g: folds 
NhUN/JpAprdJeamFBgJH1w: folds 
Uncalled bet ($0.50) returned to mvFHK3pE7tCxJEqLjKC70Q
mvFHK3pE7tCxJEqLjKC70Q collected $0.60 from pot
mvFHK3pE7tCxJEqLjKC70Q: doesn't show hand 
*** SUMMARY ***
Total pot $0.60 | Rake $0 
Seat 1: 8JTm/CXBn3+kuQgcUOgPkw folded before Flop (didn't bet)
Seat 2: mvFHK3pE7tCxJEqLjKC70Q collected ($0.60)
Seat 3: dOX4wnYV2sEqvDbF+8KSCw folded before Flop (didn't bet)
Seat 4: IyZ9SVxKy7TJvRGFneWTMg (button) folded before Flop (didn't bet)
Seat 5: wsP46AGpqDjHZQmlRHKa9g (small blind) folded before Flop
Seat 6: NhUN/JpAprdJeamFBgJH1w (big blind) folded before Flop




PokerStars Game #59939496948:  Hold'em No Limit ($0.10/$0.25) - 2009/07/01 0:41:24 ET
Table '9HJEqVOjSU5ECoVB4C4sgQ' 6-max Seat #3 is the button
Seat 1: EyMmRrAOlNpDOWLqSYRZdw ($24.70 in chips) 
Seat 2: sEQx9G5Cu8k1HNdQasxvUA ($42.15 in chips) 
Seat 3: KM6ogk7SqyRlk3m9b0h+7A ($13.75 in chips) 
Seat 4: mfrkWA3PTeYPkbO6hi98Aw ($30.90 in chips) 
Seat 5: ymz+a8dgHSUFPooYplw7Ow ($24.75 in chips) 
Seat 6: aOMbOQ6Ji1Gie6dYOurd5A ($14.10 in chips) 
mfrkWA3PTeYPkbO6hi98Aw: posts small blind $0.10
ymz+a8dgHSUFPooYplw7Ow: posts big blind $0.25
*** HOLE CARDS ***
aOMbOQ6Ji1Gie6dYOurd5A: calls $0.25
EyMmRrAOlNpDOWLqSYRZdw: raises $0.75 to $1
sEQx9G5Cu8k1HNdQasxvUA: folds 
KM6ogk7SqyRlk3m9b0h+7A: calls $1
mfrkWA3PTeYPkbO6hi98Aw: folds 
ymz+a8dgHSUFPooYplw7Ow: folds 
aOMbOQ6Ji1Gie6dYOurd5A: calls $0.75
*** FLOP *** [Ad Kd 4c]
aOMbOQ6Ji1Gie6dYOurd5A: bets $0.25
EyMmRrAOlNpDOWLqSYRZdw: calls $0.25
KM6ogk7SqyRlk3m9b0h+7A: calls $0.25
*** TURN *** [Ad Kd 4c] [Qh]
aOMbOQ6Ji1Gie6dYOurd5A: checks 
EyMmRrAOlNpDOWLqSYRZdw: bets $1.50
KM6ogk7SqyRlk3m9b0h+7A: calls $1.50
aOMbOQ6Ji1Gie6dYOurd5A: calls $1.50
*** RIVER *** [Ad Kd 4c Qh] [8s]
aOMbOQ6Ji1Gie6dYOurd5A: checks 
EyMmRrAOlNpDOWLqSYRZdw: bets $4
KM6ogk7SqyRlk3m9b0h+7A: folds 
aOMbOQ6Ji1Gie6dYOurd5A: folds 
Uncalled bet ($4) returned to EyMmRrAOlNpDOWLqSYRZdw
EyMmRrAOlNpDOWLqSYRZdw collected $8.20 from pot
EyMmRrAOlNpDOWLqSYRZdw: doesn't show hand 
*** SUMMARY ***
Total pot $8.60 | Rake $0.40 
Board [Ad Kd 4c Qh 8s]
Seat 1: EyMmRrAOlNpDOWLqSYRZdw collected ($8.20)
Seat 2: sEQx9G5Cu8k1HNdQasxvUA folded before Flop (didn't bet)
Seat 3: KM6ogk7SqyRlk3m9b0h+7A (button) folded on the River
Seat 4: mfrkWA3PTeYPkbO6hi98Aw (small blind) folded before Flop
Seat 5: ymz+a8dgHSUFPooYplw7Ow (big blind) folded before Flop
Seat 6: aOMbOQ6Ji1Gie6dYOurd5A folded on the River




PokerStars Game #59939496944:  Hold'em No Limit ($0.10/$0.25) - 2009/07/01 0:41:24 ET
Table '+198VWQSWBhYQOcizzuBkw' 6-max Seat #5 is the button
Seat 2: R6AGToFJQOYVZAjC2jXEKw ($28.80 in chips) 
Seat 3: BYxjLnV1/LL0aZcTbfAOvw ($27.85 in chips) 
Seat 4: TgDsTeCdLQt8kWbL00ByRA ($27.25 in chips) 
Seat 5: LtASJ9OlkqGrrUKGQlpGAw ($29.95 in chips) 
Seat 6: 7qRk4YH4/k/08LgJSv7rBQ ($31.35 in chips) 
7qRk4YH4/k/08LgJSv7rBQ: posts small blind $0.10
R6AGToFJQOYVZAjC2jXEKw: posts big blind $0.25
*** HOLE CARDS ***
BYxjLnV1/LL0aZcTbfAOvw: folds 
TgDsTeCdLQt8kWbL00ByRA: folds 
LtASJ9OlkqGrrUKGQlpGAw: folds 
7qRk4YH4/k/08LgJSv7rBQ: folds 
Uncalled bet ($0.15) returned to R6AGToFJQOYVZAjC2jXEKw
R6AGToFJQOYVZAjC2jXEKw collected $0.20 from pot
R6AGToFJQOYVZAjC2jXEKw: doesn't show hand 
*** SUMMARY ***
Total pot $0.20 | Rake $0 
Seat 2: R6AGToFJQOYVZAjC2jXEKw (big blind) collected ($0.20)
Seat 3: BYxjLnV1/LL0aZcTbfAOvw folded before Flop (didn't bet)
Seat 4: TgDsTeCdLQt8kWbL00ByRA folded before Flop (didn't bet)
Seat 5: LtASJ9OlkqGrrUKGQlpGAw (button) folded before Flop (didn't bet)
Seat 6: 7qRk4YH4/k/08LgJSv7rBQ (small blind) folded before Flop




PokerStars Game #59939496946:  Hold'em No Limit ($0.10/$0.25) - 2009/07/01 0:41:24 ET
Table 'f9j+4UOgRPXbyNbQkZFm4w' 6-max Seat #6 is the button
Seat 1: trN/oHqTTbPw5MNuKrOpLw ($30.60 in chips) 
Seat 3: wCBHaebpIJ2ZTqigoRi9DA ($22.70 in chips) 
Seat 4: hiTEr3yrERiQp3zHXRioVw ($21.75 in chips) 
Seat 5: 1lxYIAoJdZwAbzIkzWmSkw ($6.25 in chips) 
Seat 6: C84t1kUtjDF/zm38/Dpcng ($13.15 in chips) 
trN/oHqTTbPw5MNuKrOpLw: posts small blind $0.10
VHBox3ZuV+/MP3dz2hFEBQ has returned
wCBHaebpIJ2ZTqigoRi9DA: posts big blind $0.25
*** HOLE CARDS ***
hiTEr3yrERiQp3zHXRioVw: folds 
1lxYIAoJdZwAbzIkzWmSkw: calls $0.25
C84t1kUtjDF/zm38/Dpcng: folds 
trN/oHqTTbPw5MNuKrOpLw: folds 
wCBHaebpIJ2ZTqigoRi9DA: checks 
*** FLOP *** [7s 2s Ac]
wCBHaebpIJ2ZTqigoRi9DA: checks 
1lxYIAoJdZwAbzIkzWmSkw: bets $0.50
wCBHaebpIJ2ZTqigoRi9DA: folds 
Uncalled bet ($0.50) returned to 1lxYIAoJdZwAbzIkzWmSkw
1lxYIAoJdZwAbzIkzWmSkw collected $0.60 from pot
*** SUMMARY ***
Total pot $0.60 | Rake $0 
Board [7s 2s Ac]
Seat 1: trN/oHqTTbPw5MNuKrOpLw (small blind) folded before Flop
Seat 3: wCBHaebpIJ2ZTqigoRi9DA (big blind) folded on the Flop
Seat 4: hiTEr3yrERiQp3zHXRioVw folded before Flop (didn't bet)
Seat 5: 1lxYIAoJdZwAbzIkzWmSkw collected ($0.60)
Seat 6: C84t1kUtjDF/zm38/Dpcng (button) folded before Flop (didn't bet)




PokerStars Game #59939497244:  Hold'em No Limit ($0.10/$0.25) - 2009/07/01 0:41:24 ET
Table '8QBBaev+cI2i/r2H6ml/lg' 9-max Seat #6 is the button
Seat 4: ZoG0obuajzVjwgd7lNHjgg ($1.90 in chips) 
Seat 6: cxE+szmvEUe7vE+z2ozM2Q ($10 in chips) 
Seat 9: Ml2bY77EHbM51ZWD7dnIWg ($3.45 in chips) 
Ml2bY77EHbM51ZWD7dnIWg: posts small blind $0.10
ZoG0obuajzVjwgd7lNHjgg: posts big blind $0.25
*** HOLE CARDS ***
cxE+szmvEUe7vE+z2ozM2Q: calls $0.25
Ml2bY77EHbM51ZWD7dnIWg: calls $0.15
ZoG0obuajzVjwgd7lNHjgg: checks 
*** FLOP *** [7d 5s 5h]
Ml2bY77EHbM51ZWD7dnIWg: checks 
ZoG0obuajzVjwgd7lNHjgg: checks 
cxE+szmvEUe7vE+z2ozM2Q: bets $0.50
Ml2bY77EHbM51ZWD7dnIWg: folds 
ZoG0obuajzVjwgd7lNHjgg: folds 
Uncalled bet ($0.50) returned to cxE+szmvEUe7vE+z2ozM2Q
cxE+szmvEUe7vE+z2ozM2Q collected $0.75 from pot
cxE+szmvEUe7vE+z2ozM2Q: doesn't show hand 
*** SUMMARY ***
Total pot $0.75 | Rake $0 
Board [7d 5s 5h]
Seat 4: ZoG0obuajzVjwgd7lNHjgg (big blind) folded on the Flop
Seat 6: cxE+szmvEUe7vE+z2ozM2Q (button) collected ($0.75)
Seat 9: Ml2bY77EHbM51ZWD7dnIWg (small blind) folded on the Flop




PokerStars Game #59939497884:  Hold'em No Limit ($0.10/$0.25) - 2009/07/01 0:41:25 ET
Table 'gnrUwXkIPE0C8xl6cB4Hyw' 9-max Seat #3 is the button
Seat 2: zVd+j+mjRjWkMTxR5u0Rbw ($6 in chips) 
Seat 3: s7Q6uNouhe7aE8JdFb9E+A ($25 in chips) 
Seat 4: vnCdP3GsLTKadDukKcJk/Q ($25 in chips) 
Seat 5: UU+SYM9uvNEpASN41+yAdA ($29.15 in chips) 
Seat 6: W4TLQcZ2TiM73eIgpIvlGg ($23.60 in chips) 
Seat 7: Z9AeOQX3yzuSvKAm/xyovg ($9.80 in chips) 
Seat 8: oUgIL46CfA9GCdIuN1TVSw ($24 in chips) 
vnCdP3GsLTKadDukKcJk/Q: posts small blind $0.10
UU+SYM9uvNEpASN41+yAdA: posts big blind $0.25
lwrOE80tuooHfIBx/4LUSw: sits out 
*** HOLE CARDS ***
W4TLQcZ2TiM73eIgpIvlGg: folds 
Z9AeOQX3yzuSvKAm/xyovg: folds 
oUgIL46CfA9GCdIuN1TVSw: calls $0.25
zVd+j+mjRjWkMTxR5u0Rbw: folds 
UU+SYM9uvNEpASN41+yAdA said, "lmao... gay boy please shut up... youre ridiculous"
s7Q6uNouhe7aE8JdFb9E+A: folds 
vnCdP3GsLTKadDukKcJk/Q: folds 
UU+SYM9uvNEpASN41+yAdA: checks 
*** FLOP *** [3c 5h Kc]
UU+SYM9uvNEpASN41+yAdA: checks 
oUgIL46CfA9GCdIuN1TVSw: checks 
*** TURN *** [3c 5h Kc] [Kd]
UU+SYM9uvNEpASN41+yAdA said, "come on all in gay boy"
UU+SYM9uvNEpASN41+yAdA: checks 
oUgIL46CfA9GCdIuN1TVSw: checks 
*** RIVER *** [3c 5h Kc Kd] [Kh]
UU+SYM9uvNEpASN41+yAdA: bets $0.25
UU+SYM9uvNEpASN41+yAdA said, "come on gay boy"
oUgIL46CfA9GCdIuN1TVSw said, "im having fun tho i enjoy kids like u who think their cool saying same thing"
oUgIL46CfA9GCdIuN1TVSw: folds 
Uncalled bet ($0.25) returned to UU+SYM9uvNEpASN41+yAdA
UU+SYM9uvNEpASN41+yAdA collected $0.60 from pot
*** SUMMARY ***
Total pot $0.60 | Rake $0 
Board [3c 5h Kc Kd Kh]
Seat 2: zVd+j+mjRjWkMTxR5u0Rbw folded before Flop (didn't bet)
Seat 3: s7Q6uNouhe7aE8JdFb9E+A (button) folded before Flop (didn't bet)
Seat 4: vnCdP3GsLTKadDukKcJk/Q (small blind) folded before Flop
Seat 5: UU+SYM9uvNEpASN41+yAdA (big blind) collected ($0.60)
Seat 6: W4TLQcZ2TiM73eIgpIvlGg folded before Flop (didn't bet)
Seat 7: Z9AeOQX3yzuSvKAm/xyovg folded before Flop (didn't bet)
Seat 8: oUgIL46CfA9GCdIuN1TVSw folded on the River




PokerStars Game #59939497496:  Hold'em No Limit ($0.10/$0.25) - 2009/07/01 0:41:25 ET
Table 'DhkrdW2UOy2PfjSW28Kq8w' 6-max Seat #1 is the button
Seat 1: vu2kzHaDtgr6NM7rdq0chA ($25 in chips) 
Seat 2: v+QfkGiuj9bgtuNoVnDO8w ($25 in chips) 
Seat 3: 66a/8+qw1AZLNh63FuclPA ($43.80 in chips) 
Seat 4: I1TxPvWj8NfG8orglCinNA ($27.40 in chips) 
Seat 5: SxIIgwXYLkwd6m3wLyPTCw ($47.50 in chips) 
Seat 6: SS/yfeArhULzIcOPe8MdPg ($26.65 in chips) 
v+QfkGiuj9bgtuNoVnDO8w: posts small blind $0.10
66a/8+qw1AZLNh63FuclPA: posts big blind $0.25
*** HOLE CARDS ***
I1TxPvWj8NfG8orglCinNA: folds 
SxIIgwXYLkwd6m3wLyPTCw: folds 
SS/yfeArhULzIcOPe8MdPg: folds 
vu2kzHaDtgr6NM7rdq0chA: folds 
v+QfkGiuj9bgtuNoVnDO8w: folds 
Uncalled bet ($0.15) returned to 66a/8+qw1AZLNh63FuclPA
66a/8+qw1AZLNh63FuclPA collected $0.20 from pot
66a/8+qw1AZLNh63FuclPA: doesn't show hand 
*** SUMMARY ***
Total pot $0.20 | Rake $0 
Seat 1: vu2kzHaDtgr6NM7rdq0chA (button) folded before Flop (didn't bet)
Seat 2: v+QfkGiuj9bgtuNoVnDO8w (small blind) folded before Flop
Seat 3: 66a/8+qw1AZLNh63FuclPA (big blind) collected ($0.20)
Seat 4: I1TxPvWj8NfG8orglCinNA folded before Flop (didn't bet)
Seat 5: SxIIgwXYLkwd6m3wLyPTCw folded before Flop (didn't bet)
Seat 6: SS/yfeArhULzIcOPe8MdPg folded before Flop (didn't bet)




PokerStars Game #59939497792:  Hold'em No Limit ($0.10/$0.25) - 2009/07/01 0:41:25 ET
Table 'Of/T60zpXg1GcjrZ7Lm//Q' 9-max Seat #9 is the button
Seat 1: Lro4e37x4FUa5P3yzDjskw ($8.25 in chips) 
Seat 2: hIss79a4pu7GzJZepfgOpg ($25 in chips) 
Seat 3: jeKWRUkMaVn8rEUjnJKqpg ($25 in chips) 
Seat 4: Czut6V7acIqUJrrobjKAZg ($25.05 in chips) 
Seat 5: 18G4P1XstjNvItdGUITxgw ($25 in chips) 
Seat 6: tYsOBqdU1+x+yFI7zHO7hQ ($25.75 in chips) 
Seat 7: s7Q6uNouhe7aE8JdFb9E+A ($34.25 in chips) 
Seat 8: ghNKXUBl/H+t83JF079ZBA ($31.25 in chips) 
Seat 9: TeWJxSETzbXGiYKx0y+dtg ($24.30 in chips) 
Lro4e37x4FUa5P3yzDjskw: posts small blind $0.10
hIss79a4pu7GzJZepfgOpg: posts big blind $0.25
*** HOLE CARDS ***
jeKWRUkMaVn8rEUjnJKqpg: calls $0.25
Czut6V7acIqUJrrobjKAZg: folds 
18G4P1XstjNvItdGUITxgw: folds 
tYsOBqdU1+x+yFI7zHO7hQ: folds 
s7Q6uNouhe7aE8JdFb9E+A has timed out
s7Q6uNouhe7aE8JdFb9E+A: folds 
s7Q6uNouhe7aE8JdFb9E+A is sitting out
s7Q6uNouhe7aE8JdFb9E+A has returned
ghNKXUBl/H+t83JF079ZBA: folds 
TeWJxSETzbXGiYKx0y+dtg: folds 
Lro4e37x4FUa5P3yzDjskw: calls $0.15
hIss79a4pu7GzJZepfgOpg: checks 
*** FLOP *** [5c 7s Jc]
Lro4e37x4FUa5P3yzDjskw: checks 
hIss79a4pu7GzJZepfgOpg: checks 
jeKWRUkMaVn8rEUjnJKqpg: checks 
*** TURN *** [5c 7s Jc] [2d]
Lro4e37x4FUa5P3yzDjskw: bets $0.50
hIss79a4pu7GzJZepfgOpg: folds 
jeKWRUkMaVn8rEUjnJKqpg: raises $1 to $1.50
Lro4e37x4FUa5P3yzDjskw: folds 
Uncalled bet ($1) returned to jeKWRUkMaVn8rEUjnJKqpg
jeKWRUkMaVn8rEUjnJKqpg collected $1.70 from pot
jeKWRUkMaVn8rEUjnJKqpg: doesn't show hand 
*** SUMMARY ***
Total pot $1.75 | Rake $0.05 
Board [5c 7s Jc 2d]
Seat 1: Lro4e37x4FUa5P3yzDjskw (small blind) folded on the Turn
Seat 2: hIss79a4pu7GzJZepfgOpg (big blind) folded on the Turn
Seat 3: jeKWRUkMaVn8rEUjnJKqpg collected ($1.70)
Seat 4: Czut6V7acIqUJrrobjKAZg folded before Flop (didn't bet)
Seat 5: 18G4P1XstjNvItdGUITxgw folded before Flop (didn't bet)
Seat 6: tYsOBqdU1+x+yFI7zHO7hQ folded before Flop (didn't bet)
Seat 7: s7Q6uNouhe7aE8JdFb9E+A folded before Flop (didn't bet)
Seat 8: ghNKXUBl/H+t83JF079ZBA folded before Flop (didn't bet)
Seat 9: TeWJxSETzbXGiYKx0y+dtg (button) folded before Flop (didn't bet)




PokerStars Game #59939498618:  Hold'em No Limit ($0.10/$0.25) - 2009/07/01 0:41:26 ET
Table 'NgexmgEDEzICBeSO7YCrKQ' 6-max Seat #6 is the button
Seat 1: oseFhpinoe+Zg4j5xyBjyQ ($70.85 in chips) 
Seat 2: 32YL2ZEp8NT4JB2RVM9euQ ($16 in chips) 
Seat 3: JFIAqU8lCZ0vWwEl4bdGsg ($26.90 in chips) 
Seat 4: xx+iYCDJhHJmNzrfeloyEg ($36.85 in chips) 
Seat 5: /MXkdT8TTs8Qp2LVTQNw6w ($49.15 in chips) 
Seat 6: k9nHZTHt8hYhYRcW8NTb4g ($8.60 in chips) 
oseFhpinoe+Zg4j5xyBjyQ: posts small blind $0.10
32YL2ZEp8NT4JB2RVM9euQ: posts big blind $0.25
*** HOLE CARDS ***
JFIAqU8lCZ0vWwEl4bdGsg: folds 
xx+iYCDJhHJmNzrfeloyEg: folds 
/MXkdT8TTs8Qp2LVTQNw6w: folds 
k9nHZTHt8hYhYRcW8NTb4g: raises $0.50 to $0.75
oseFhpinoe+Zg4j5xyBjyQ: folds 
32YL2ZEp8NT4JB2RVM9euQ: folds 
Uncalled bet ($0.50) returned to k9nHZTHt8hYhYRcW8NTb4g
k9nHZTHt8hYhYRcW8NTb4g collected $0.60 from pot
k9nHZTHt8hYhYRcW8NTb4g: doesn't show hand 
*** SUMMARY ***
Total pot $0.60 | Rake $0 
Seat 1: oseFhpinoe+Zg4j5xyBjyQ (small blind) folded before Flop
Seat 2: 32YL2ZEp8NT4JB2RVM9euQ (big blind) folded before Flop
Seat 3: JFIAqU8lCZ0vWwEl4bdGsg folded before Flop (didn't bet)
Seat 4: xx+iYCDJhHJmNzrfeloyEg folded before Flop (didn't bet)
Seat 5: /MXkdT8TTs8Qp2LVTQNw6w folded before Flop (didn't bet)
Seat 6: k9nHZTHt8hYhYRcW8NTb4g (button) collected ($0.60)




PokerStars Game #59939498126:  Hold'em No Limit ($0.10/$0.25) - 2009/07/01 0:41:26 ET
Table 'i93c3z9RLowvuJTKA2F4Jg' 6-max Seat #3 is the button
Seat 1: tbSZq5LHglyHk61mH9eDBw ($34.75 in chips) 
Seat 2: TSmua8tGK3sTbwi0ynrW9Q ($25 in chips) 
Seat 3: tVIFo6yuan1xauX1WIjH2w ($8.80 in chips) 
Seat 4: o86X2Q5GEDU3uP9oj1iFZA ($29.05 in chips) 
Seat 5: lYjWCpfCxX2kgcHY3v4Yow ($31.75 in chips) 
Seat 6: aSrj4lVmn2owyQ1RbbOqxQ ($25 in chips) 
o86X2Q5GEDU3uP9oj1iFZA: posts small blind $0.10
lYjWCpfCxX2kgcHY3v4Yow: posts big blind $0.25
*** HOLE CARDS ***
aSrj4lVmn2owyQ1RbbOqxQ: calls $0.25
tbSZq5LHglyHk61mH9eDBw: raises $0.75 to $1
TSmua8tGK3sTbwi0ynrW9Q: folds 
tVIFo6yuan1xauX1WIjH2w: folds 
o86X2Q5GEDU3uP9oj1iFZA: folds 
lYjWCpfCxX2kgcHY3v4Yow: folds 
aSrj4lVmn2owyQ1RbbOqxQ: calls $0.75
*** FLOP *** [Js 3h Kh]
aSrj4lVmn2owyQ1RbbOqxQ: checks 
tbSZq5LHglyHk61mH9eDBw: bets $1.25
aSrj4lVmn2owyQ1RbbOqxQ: folds 
Uncalled bet ($1.25) returned to tbSZq5LHglyHk61mH9eDBw
tbSZq5LHglyHk61mH9eDBw collected $2.25 from pot
*** SUMMARY ***
Total pot $2.35 | Rake $0.10 
Board [Js 3h Kh]
Seat 1: tbSZq5LHglyHk61mH9eDBw collected ($2.25)
Seat 2: TSmua8tGK3sTbwi0ynrW9Q folded before Flop (didn't bet)
Seat 3: tVIFo6yuan1xauX1WIjH2w (button) folded before Flop (didn't bet)
Seat 4: o86X2Q5GEDU3uP9oj1iFZA (small blind) folded before Flop
Seat 5: lYjWCpfCxX2kgcHY3v4Yow (big blind) folded before Flop
Seat 6: aSrj4lVmn2owyQ1RbbOqxQ folded on the Flop




PokerStars Game #59939498356:  Hold'em No Limit ($0.10/$0.25) - 2009/07/01 0:41:26 ET
Table 'OvOqQoL/QnXuXuQjXo2hIQ' 9-max Seat #5 is the button
Seat 1: Xbfvrzh7Jjg4vOZkdMSfbA ($17.50 in chips) 
Seat 3: uJlzv9KL7hgCIqIS2ofoaw ($16.65 in chips) 
Seat 5: sJNHTWcSlLHRCZ9+YRLLqA ($28.95 in chips) 
Seat 6: MIVCHqCqqlke0Lb0z7glcw ($46.15 in chips) 
Seat 7: aNpwfA31EREwO+ar4XzBCw ($26.80 in chips) 
Seat 9: VWUWpMLMj/Q1jRVpF7Aohw ($14.60 in chips) 
MIVCHqCqqlke0Lb0z7glcw: posts small blind $0.10
aNpwfA31EREwO+ar4XzBCw: posts big blind $0.25
*** HOLE CARDS ***
VWUWpMLMj/Q1jRVpF7Aohw: folds 
Xbfvrzh7Jjg4vOZkdMSfbA: folds 
uJlzv9KL7hgCIqIS2ofoaw: folds 
sJNHTWcSlLHRCZ9+YRLLqA: raises $0.75 to $1
MIVCHqCqqlke0Lb0z7glcw: folds 
aNpwfA31EREwO+ar4XzBCw: raises $2.50 to $3.50
Xbfvrzh7Jjg4vOZkdMSfbA is sitting out
sJNHTWcSlLHRCZ9+YRLLqA: folds 
Uncalled bet ($2.50) returned to aNpwfA31EREwO+ar4XzBCw
aNpwfA31EREwO+ar4XzBCw collected $2.10 from pot
aNpwfA31EREwO+ar4XzBCw: doesn't show hand 
*** SUMMARY ***
Total pot $2.10 | Rake $0 
Seat 1: Xbfvrzh7Jjg4vOZkdMSfbA folded before Flop (didn't bet)
Seat 3: uJlzv9KL7hgCIqIS2ofoaw folded before Flop (didn't bet)
Seat 5: sJNHTWcSlLHRCZ9+YRLLqA (button) folded before Flop
Seat 6: MIVCHqCqqlke0Lb0z7glcw (small blind) folded before Flop
Seat 7: aNpwfA31EREwO+ar4XzBCw (big blind) collected ($2.10)
Seat 9: VWUWpMLMj/Q1jRVpF7Aohw folded before Flop (didn't bet)




PokerStars Game #59939498266:  Hold'em No Limit ($0.10/$0.25) - 2009/07/01 0:41:26 ET
Table 'ROYvQOMwUrvL3SOiHYcrWg' 9-max Seat #7 is the button
Seat 1: 7q7lZBfgmzjFr0jTNx4b6g ($11.70 in chips) 
Seat 2: hBMUlEpyU74r/fwDgIpXjQ ($48.85 in chips) 
Seat 4: SHegmCn8B0InbWE/zFlvOw ($25.70 in chips) 
Seat 5: jeKWRUkMaVn8rEUjnJKqpg ($25 in chips) 
Seat 7: tYsOBqdU1+x+yFI7zHO7hQ ($25.90 in chips) 
Seat 8: biJWLZ27fafNeBI2oT1KJw ($17.85 in chips) 
biJWLZ27fafNeBI2oT1KJw: posts small blind $0.10
7q7lZBfgmzjFr0jTNx4b6g: posts big blind $0.25
OiV1PWZ3IkN29JlmCcnTwQ: sits out 
*** HOLE CARDS ***
hBMUlEpyU74r/fwDgIpXjQ: folds 
SHegmCn8B0InbWE/zFlvOw: folds 
jeKWRUkMaVn8rEUjnJKqpg: folds 
tYsOBqdU1+x+yFI7zHO7hQ: raises $0.50 to $0.75
biJWLZ27fafNeBI2oT1KJw: folds 
7q7lZBfgmzjFr0jTNx4b6g: calls $0.50
*** FLOP *** [2d Td 2s]
7q7lZBfgmzjFr0jTNx4b6g: checks 
tYsOBqdU1+x+yFI7zHO7hQ: bets $1.25
caspertheska has returned
7q7lZBfgmzjFr0jTNx4b6g: folds 
Uncalled bet ($1.25) returned to tYsOBqdU1+x+yFI7zHO7hQ
tYsOBqdU1+x+yFI7zHO7hQ collected $1.55 from pot
tYsOBqdU1+x+yFI7zHO7hQ: doesn't show hand 
*** SUMMARY ***
Total pot $1.60 | Rake $0.05 
Board [2d Td 2s]
Seat 1: 7q7lZBfgmzjFr0jTNx4b6g (big blind) folded on the Flop
Seat 2: hBMUlEpyU74r/fwDgIpXjQ folded before Flop (didn't bet)
Seat 4: SHegmCn8B0InbWE/zFlvOw folded before Flop (didn't bet)
Seat 5: jeKWRUkMaVn8rEUjnJKqpg folded before Flop (didn't bet)
Seat 7: tYsOBqdU1+x+yFI7zHO7hQ (button) collected ($1.55)
Seat 8: biJWLZ27fafNeBI2oT1KJw (small blind) folded before Flop




PokerStars Game #59939498546:  Hold'em No Limit ($0.10/$0.25) - 2009/07/01 0:41:26 ET
Table 'Yb2CyZosw7N3yRRVLhKnKg' 9-max Seat #7 is the button
Seat 1: lcT2xQLmuzNRe6+aWd6eww ($32.50 in chips) 
Seat 2: dmYlc+1cjwZMJ7wV+Z0rRg ($25.90 in chips) 
Seat 4: H5Se03ZqSX7tbULXur2MAg ($29 in chips) 
Seat 5: QUCO+kde5iROhmqVTzQ6KQ ($37.25 in chips) 
Seat 6: opOCI2p6kW0tINuVaAqmcQ ($25.55 in chips) 
Seat 7: OiV1PWZ3IkN29JlmCcnTwQ ($4.90 in chips) 
Seat 8: aJy680tKSaP5er559aSuGA ($22.25 in chips) 
aJy680tKSaP5er559aSuGA: posts small blind $0.10
lcT2xQLmuzNRe6+aWd6eww: posts big blind $0.25
*** HOLE CARDS ***
dmYlc+1cjwZMJ7wV+Z0rRg: folds 
H5Se03ZqSX7tbULXur2MAg: folds 
QUCO+kde5iROhmqVTzQ6KQ: calls $0.25
opOCI2p6kW0tINuVaAqmcQ: raises $0.50 to $0.75
OiV1PWZ3IkN29JlmCcnTwQ: folds 
aJy680tKSaP5er559aSuGA: folds 
lcT2xQLmuzNRe6+aWd6eww: folds 
QUCO+kde5iROhmqVTzQ6KQ: calls $0.50
*** FLOP *** [Qc 5c 8h]
QUCO+kde5iROhmqVTzQ6KQ: checks 
opOCI2p6kW0tINuVaAqmcQ: checks 
*** TURN *** [Qc 5c 8h] [Qd]
QUCO+kde5iROhmqVTzQ6KQ: checks 
opOCI2p6kW0tINuVaAqmcQ: bets $0.75
ELau00 joins the table at seat #3 
QUCO+kde5iROhmqVTzQ6KQ: calls $0.75
*** RIVER *** [Qc 5c 8h Qd] [Qh]
QUCO+kde5iROhmqVTzQ6KQ: checks 
opOCI2p6kW0tINuVaAqmcQ: bets $1.50
QUCO+kde5iROhmqVTzQ6KQ: calls $1.50
*** SHOW DOWN ***
opOCI2p6kW0tINuVaAqmcQ: shows [Jd Js] (a full house, Queens full of Jacks)
QUCO+kde5iROhmqVTzQ6KQ: mucks hand 
opOCI2p6kW0tINuVaAqmcQ collected $6.05 from pot
*** SUMMARY ***
Total pot $6.35 | Rake $0.30 
Board [Qc 5c 8h Qd Qh]
Seat 1: lcT2xQLmuzNRe6+aWd6eww (big blind) folded before Flop
Seat 2: dmYlc+1cjwZMJ7wV+Z0rRg folded before Flop (didn't bet)
Seat 4: H5Se03ZqSX7tbULXur2MAg folded before Flop (didn't bet)
Seat 5: QUCO+kde5iROhmqVTzQ6KQ mucked
Seat 6: opOCI2p6kW0tINuVaAqmcQ showed [Jd Js] and won ($6.05) with a full house, Queens full of Jacks
Seat 7: OiV1PWZ3IkN29JlmCcnTwQ (button) folded before Flop (didn't bet)
Seat 8: aJy680tKSaP5er559aSuGA (small blind) folded before Flop




PokerStars Game #59939499184:  Hold'em No Limit ($0.10/$0.25) - 2009/07/01 0:41:27 ET
Table 'WjNvuuSgTjm8jh0j9vcCgQ' 9-max Seat #2 is the button
Seat 1: NKymidkL3Kg3ILZPvtLSVg ($10 in chips) 
Seat 2: 9gmYYQesalMrUjaF7nKfrQ ($9.65 in chips) 
Seat 3: 8B/dhbQjIWe6ASCdgzktNQ ($25 in chips) 
Seat 5: Qi+clOtyDiibLdH2/1Qy8g ($18.10 in chips) 
Seat 7: DdPXdieucQ+n99u1n3A+rQ ($4.65 in chips) 
Seat 8: ghNKXUBl/H+t83JF079ZBA ($25.35 in chips) 
Seat 9: DiSvPC2iudwL5j9u6Huyww ($30.05 in chips) 
8B/dhbQjIWe6ASCdgzktNQ: posts small blind $0.10
Qi+clOtyDiibLdH2/1Qy8g: posts big blind $0.25
*** HOLE CARDS ***
DdPXdieucQ+n99u1n3A+rQ: folds 
ghNKXUBl/H+t83JF079ZBA: folds 
DiSvPC2iudwL5j9u6Huyww: folds 
NKymidkL3Kg3ILZPvtLSVg: folds 
9gmYYQesalMrUjaF7nKfrQ: folds 
8B/dhbQjIWe6ASCdgzktNQ: folds 
Uncalled bet ($0.15) returned to Qi+clOtyDiibLdH2/1Qy8g
Qi+clOtyDiibLdH2/1Qy8g collected $0.20 from pot
Qi+clOtyDiibLdH2/1Qy8g: doesn't show hand 
*** SUMMARY ***
Total pot $0.20 | Rake $0 
Seat 1: NKymidkL3Kg3ILZPvtLSVg folded before Flop (didn't bet)
Seat 2: 9gmYYQesalMrUjaF7nKfrQ (button) folded before Flop (didn't bet)
Seat 3: 8B/dhbQjIWe6ASCdgzktNQ (small blind) folded before Flop
Seat 5: Qi+clOtyDiibLdH2/1Qy8g (big blind) collected ($0.20)
Seat 7: DdPXdieucQ+n99u1n3A+rQ folded before Flop (didn't bet)
Seat 8: ghNKXUBl/H+t83JF079ZBA folded before Flop (didn't bet)
Seat 9: DiSvPC2iudwL5j9u6Huyww folded before Flop (didn't bet)




PokerStars Game #59939499102:  Hold'em No Limit ($0.10/$0.25) - 2009/07/01 0:41:27 ET
Table '5SUMWYuPsGiOD0FY0QbgOw' 6-max Seat #2 is the button
Seat 1: pq78iqNUnoL9mPwPKXxOzg ($14.30 in chips) 
Seat 2: wKFJ513ucluNNiMlkXcDOQ ($25 in chips) 
Seat 3: JUE7yMMP0aN5jzhYbdqO6Q ($30.05 in chips) 
Seat 4: hln5cQA1YXs/ERC2LEyoSA ($11.75 in chips) 
Seat 5: v+QfkGiuj9bgtuNoVnDO8w ($28.70 in chips) 
Seat 6: jA7YMtfNUnAaebB7Lj74EA ($23.85 in chips) 
JUE7yMMP0aN5jzhYbdqO6Q: posts small blind $0.10
hln5cQA1YXs/ERC2LEyoSA: posts big blind $0.25
*** HOLE CARDS ***
v+QfkGiuj9bgtuNoVnDO8w: folds 
jA7YMtfNUnAaebB7Lj74EA: raises $0.50 to $0.75
pq78iqNUnoL9mPwPKXxOzg: folds 
wKFJ513ucluNNiMlkXcDOQ: folds 
JUE7yMMP0aN5jzhYbdqO6Q: folds 
hln5cQA1YXs/ERC2LEyoSA: folds 
Uncalled bet ($0.50) returned to jA7YMtfNUnAaebB7Lj74EA
jA7YMtfNUnAaebB7Lj74EA collected $0.60 from pot
*** SUMMARY ***
Total pot $0.60 | Rake $0 
Seat 1: pq78iqNUnoL9mPwPKXxOzg folded before Flop (didn't bet)
Seat 2: wKFJ513ucluNNiMlkXcDOQ (button) folded before Flop (didn't bet)
Seat 3: JUE7yMMP0aN5jzhYbdqO6Q (small blind) folded before Flop
Seat 4: hln5cQA1YXs/ERC2LEyoSA (big blind) folded before Flop
Seat 5: v+QfkGiuj9bgtuNoVnDO8w folded before Flop (didn't bet)
Seat 6: jA7YMtfNUnAaebB7Lj74EA collected ($0.60)




PokerStars Game #59939499206:  Hold'em No Limit ($0.10/$0.25) - 2009/07/01 0:41:27 ET
Table 'IRgQPZVA4+IaZZIQshgwyg' 6-max Seat #2 is the button
Seat 1: d0J1xuhsynEY81YHwAvJ5g ($25 in chips) 
Seat 2: 9jSiy0meE9XJKkdIZwyTEQ ($35.10 in chips) 
Seat 3: 8EEqTTh7T1q48sYDqbI2Xg ($26.75 in chips) 
Seat 4: PXXRy0uk7WED5BEf+ReJDQ ($15.15 in chips) 
Seat 5: PbMzPZIePKifKQZfKDkbIw ($27.35 in chips) 
Seat 6: qo39V8/pMxxofM2aciLSWQ ($37.85 in chips) 
8EEqTTh7T1q48sYDqbI2Xg: posts small blind $0.10
PXXRy0uk7WED5BEf+ReJDQ: posts big blind $0.25
*** HOLE CARDS ***
PbMzPZIePKifKQZfKDkbIw: folds 
qo39V8/pMxxofM2aciLSWQ: folds 
d0J1xuhsynEY81YHwAvJ5g: folds 
9jSiy0meE9XJKkdIZwyTEQ: raises $0.60 to $0.85
8EEqTTh7T1q48sYDqbI2Xg: folds 
PXXRy0uk7WED5BEf+ReJDQ: folds 
Uncalled bet ($0.60) returned to 9jSiy0meE9XJKkdIZwyTEQ
9jSiy0meE9XJKkdIZwyTEQ collected $0.60 from pot
9jSiy0meE9XJKkdIZwyTEQ: doesn't show hand 
*** SUMMARY ***
Total pot $0.60 | Rake $0 
Seat 1: d0J1xuhsynEY81YHwAvJ5g folded before Flop (didn't bet)
Seat 2: 9jSiy0meE9XJKkdIZwyTEQ (button) collected ($0.60)
Seat 3: 8EEqTTh7T1q48sYDqbI2Xg (small blind) folded before Flop
Seat 4: PXXRy0uk7WED5BEf+ReJDQ (big blind) folded before Flop
Seat 5: PbMzPZIePKifKQZfKDkbIw folded before Flop (didn't bet)
Seat 6: qo39V8/pMxxofM2aciLSWQ folded before Flop (didn't bet)




PokerStars Game #59939498944:  Hold'em No Limit ($0.10/$0.25) - 2009/07/01 0:41:27 ET
Table 'yZgGBnUGXVCcEJdcqes8tw' 9-max Seat #9 is the button
Seat 1: SXqVW4Q0evTUVZG6BbUNIA ($23.80 in chips) 
Seat 2: MG90wfSJZnOejs/KD3vlQQ ($25 in chips) 
Seat 3: z5GxcHlYz/GSz6W2uFiTtg ($26.65 in chips) 
Seat 4: opOCI2p6kW0tINuVaAqmcQ ($25.70 in chips) 
Seat 5: IGz29GAFM1DpSdXX+wXg3g ($16.90 in chips) 
Seat 6: H9i0g723A2AKb4nSMXqMPQ ($20.65 in chips) 
Seat 7: eC8Pn1D6Y2pct8o62nQfvQ ($28.05 in chips) 
Seat 8: dmYlc+1cjwZMJ7wV+Z0rRg ($24.55 in chips) 
Seat 9: M/9j4wkHH9i1JM51vgi1VA ($30.10 in chips) 
SXqVW4Q0evTUVZG6BbUNIA: posts small blind $0.10
MG90wfSJZnOejs/KD3vlQQ: posts big blind $0.25
*** HOLE CARDS ***
z5GxcHlYz/GSz6W2uFiTtg: calls $0.25
opOCI2p6kW0tINuVaAqmcQ: folds 
IGz29GAFM1DpSdXX+wXg3g: folds 
H9i0g723A2AKb4nSMXqMPQ: folds 
eC8Pn1D6Y2pct8o62nQfvQ: folds 
dmYlc+1cjwZMJ7wV+Z0rRg: calls $0.25
M/9j4wkHH9i1JM51vgi1VA: folds 
SXqVW4Q0evTUVZG6BbUNIA: folds 
MG90wfSJZnOejs/KD3vlQQ: checks 
*** FLOP *** [5d 6s Kc]
MG90wfSJZnOejs/KD3vlQQ: checks 
z5GxcHlYz/GSz6W2uFiTtg: checks 
dmYlc+1cjwZMJ7wV+Z0rRg: bets $0.25
MG90wfSJZnOejs/KD3vlQQ: folds 
z5GxcHlYz/GSz6W2uFiTtg: folds 
Uncalled bet ($0.25) returned to dmYlc+1cjwZMJ7wV+Z0rRg
dmYlc+1cjwZMJ7wV+Z0rRg collected $0.85 from pot
dmYlc+1cjwZMJ7wV+Z0rRg: doesn't show hand 
*** SUMMARY ***
Total pot $0.85 | Rake $0 
Board [5d 6s Kc]
Seat 1: SXqVW4Q0evTUVZG6BbUNIA (small blind) folded before Flop
Seat 2: MG90wfSJZnOejs/KD3vlQQ (big blind) folded on the Flop
Seat 3: z5GxcHlYz/GSz6W2uFiTtg folded on the Flop
Seat 4: opOCI2p6kW0tINuVaAqmcQ folded before Flop (didn't bet)
Seat 5: IGz29GAFM1DpSdXX+wXg3g folded before Flop (didn't bet)
Seat 6: H9i0g723A2AKb4nSMXqMPQ folded before Flop (didn't bet)
Seat 7: eC8Pn1D6Y2pct8o62nQfvQ folded before Flop (didn't bet)
Seat 8: dmYlc+1cjwZMJ7wV+Z0rRg collected ($0.85)
Seat 9: M/9j4wkHH9i1JM51vgi1VA (button) folded before Flop (didn't bet)




PokerStars Game #59939498888:  Hold'em No Limit ($0.10/$0.25) - 2009/07/01 0:41:27 ET
Table '52Meibn9NOL4XtVi1p2UpwpyZQRcpxhWj2y2cT/ydvwwx Seat #8 is the button
Seat 1: TeWJxSETzbXGiYKx0y+dtg ($26.95 in chips) 
Seat 2: Th3FldXKQW6hWVVPahaoOQ ($49.05 in chips) 
Seat 3: DgRMoUciGePff+edyvpt6g ($35.20 in chips) 
Seat 5: 4oA316mXLIui1QY63GXBUg ($25 in chips) 
Seat 6: 4awUyiDYTgylQKXZ9faBVA ($26.85 in chips) 
Seat 7: Xpyqpb+DURDWnyJ3xTEIFQ ($29.80 in chips) 
Seat 8: 18G4P1XstjNvItdGUITxgw ($25 in chips) 
Seat 9: 1K6QGyJP9P9xmRac2fH4OQ ($25.10 in chips) 
1K6QGyJP9P9xmRac2fH4OQ: posts small blind $0.10
TeWJxSETzbXGiYKx0y+dtg: posts big blind $0.25
*** HOLE CARDS ***
Th3FldXKQW6hWVVPahaoOQ: folds 
Archi91 joins the table at seat #4 
DgRMoUciGePff+edyvpt6g: folds 
4oA316mXLIui1QY63GXBUg: folds 
4awUyiDYTgylQKXZ9faBVA: folds 
Xpyqpb+DURDWnyJ3xTEIFQ: folds 
18G4P1XstjNvItdGUITxgw: folds 
1K6QGyJP9P9xmRac2fH4OQ: raises $0.75 to $1
TeWJxSETzbXGiYKx0y+dtg: folds 
Uncalled bet ($0.75) returned to 1K6QGyJP9P9xmRac2fH4OQ
1K6QGyJP9P9xmRac2fH4OQ collected $0.50 from pot
1K6QGyJP9P9xmRac2fH4OQ: doesn't show hand 
*** SUMMARY ***
Total pot $0.50 | Rake $0 
Seat 1: TeWJxSETzbXGiYKx0y+dtg (big blind) folded before Flop
Seat 2: Th3FldXKQW6hWVVPahaoOQ folded before Flop (didn't bet)
Seat 3: DgRMoUciGePff+edyvpt6g folded before Flop (didn't bet)
Seat 5: 4oA316mXLIui1QY63GXBUg folded before Flop (didn't bet)
Seat 6: 4awUyiDYTgylQKXZ9faBVA folded before Flop (didn't bet)
Seat 7: Xpyqpb+DURDWnyJ3xTEIFQ folded before Flop (didn't bet)
Seat 8: 18G4P1XstjNvItdGUITxgw (button) folded before Flop (didn't bet)
Seat 9: 1K6QGyJP9P9xmRac2fH4OQ (small blind) collected ($0.50)




PokerStars Game #59939498720:  Hold'em No Limit ($0.10/$0.25) - 2009/07/01 0:41:27 ET
Table '4hfTdIVT/qPsJNfWXLsVIw' 9-max Seat #6 is the button
Seat 1: GbHFBbLqLGz0Pwn6CJeAuw ($24.20 in chips) 
Seat 2: NB5rKy+grn9jKcWXclZ7WA ($32.90 in chips) 
Seat 3: opOCI2p6kW0tINuVaAqmcQ ($26.80 in chips) 
Seat 4: OiV1PWZ3IkN29JlmCcnTwQ ($5.15 in chips) 
Seat 5: wtz6Fi0Zt+cIsTeTHf5zJQ ($5 in chips) 
Seat 6: VWUWpMLMj/Q1jRVpF7Aohw ($8.70 in chips) 
Seat 7: z5GxcHlYz/GSz6W2uFiTtg ($32 in chips) 
Seat 9: K5byIbXY6S+c1wAeHitZow ($12.65 in chips) 
z5GxcHlYz/GSz6W2uFiTtg: posts small blind $0.10
EfRs3ibIxn+c9JDErwwNCg: is sitting out 
K5byIbXY6S+c1wAeHitZow: posts big blind $0.25
*** HOLE CARDS ***
GbHFBbLqLGz0Pwn6CJeAuw: calls $0.25
NB5rKy+grn9jKcWXclZ7WA: folds 
EfRs3ibIxn+c9JDErwwNCg leaves the table
opOCI2p6kW0tINuVaAqmcQ: folds 
OiV1PWZ3IkN29JlmCcnTwQ: folds 
wtz6Fi0Zt+cIsTeTHf5zJQ: folds 
VWUWpMLMj/Q1jRVpF7Aohw: calls $0.25
z5GxcHlYz/GSz6W2uFiTtg: calls $0.15
K5byIbXY6S+c1wAeHitZow: checks 
*** FLOP *** [5c 8c 3s]
z5GxcHlYz/GSz6W2uFiTtg: checks 
K5byIbXY6S+c1wAeHitZow: checks 
GbHFBbLqLGz0Pwn6CJeAuw: checks 
VWUWpMLMj/Q1jRVpF7Aohw: bets $0.75
z5GxcHlYz/GSz6W2uFiTtg: folds 
K5byIbXY6S+c1wAeHitZow: folds 
GbHFBbLqLGz0Pwn6CJeAuw: folds 
Uncalled bet ($0.75) returned to VWUWpMLMj/Q1jRVpF7Aohw
VWUWpMLMj/Q1jRVpF7Aohw collected $0.95 from pot
VWUWpMLMj/Q1jRVpF7Aohw: doesn't show hand 
*** SUMMARY ***
Total pot $1 | Rake $0.05 
Board [5c 8c 3s]
Seat 1: GbHFBbLqLGz0Pwn6CJeAuw folded on the Flop
Seat 2: NB5rKy+grn9jKcWXclZ7WA folded before Flop (didn't bet)
Seat 3: opOCI2p6kW0tINuVaAqmcQ folded before Flop (didn't bet)
Seat 4: OiV1PWZ3IkN29JlmCcnTwQ folded before Flop (didn't bet)
Seat 5: wtz6Fi0Zt+cIsTeTHf5zJQ folded before Flop (didn't bet)
Seat 6: VWUWpMLMj/Q1jRVpF7Aohw (button) collected ($0.95)
Seat 7: z5GxcHlYz/GSz6W2uFiTtg (small blind) folded on the Flop
Seat 9: K5byIbXY6S+c1wAeHitZow (big blind) folded on the Flop




PokerStars Game #59939498668:  Hold'em No Limit ($0.10/$0.25) - 2009/07/01 0:41:27 ET
Table '2clPgY3+dETPD/8zjXZdFw' 6-max Seat #4 is the button
Seat 1: qllppsCmUqovlriIWCeM/g ($3.65 in chips) 
Seat 2: NzIFHwilc5zU7QhjDTgTZA ($7.60 in chips) 
Seat 3: 6pF9LtHn+EH0ChbOXzox9g ($2.35 in chips) 
Seat 4: 9KPR3sZ+CxRm7bQ8qxFzMQ ($5.50 in chips) 
qllppsCmUqovlriIWCeM/g: posts small blind $0.10
NzIFHwilc5zU7QhjDTgTZA: posts big blind $0.25
*** HOLE CARDS ***
6pF9LtHn+EH0ChbOXzox9g: raises $2.10 to $2.35 and is all-in
9KPR3sZ+CxRm7bQ8qxFzMQ: folds 
qllppsCmUqovlriIWCeM/g: folds 
NzIFHwilc5zU7QhjDTgTZA: folds 
Uncalled bet ($2.10) returned to 6pF9LtHn+EH0ChbOXzox9g
6pF9LtHn+EH0ChbOXzox9g collected $0.60 from pot
6pF9LtHn+EH0ChbOXzox9g: doesn't show hand 
*** SUMMARY ***
Total pot $0.60 | Rake $0 
Seat 1: qllppsCmUqovlriIWCeM/g (small blind) folded before Flop
Seat 2: NzIFHwilc5zU7QhjDTgTZA (big blind) folded before Flop
Seat 3: 6pF9LtHn+EH0ChbOXzox9g collected ($0.60)
Seat 4: 9KPR3sZ+CxRm7bQ8qxFzMQ (button) folded before Flop (didn't bet)




PokerStars Game #59939499346:  Hold'em No Limit ($0.10/$0.25) - 2009/07/01 0:41:28 ET
Table 'GrYi0DZOHD1EvB+qiLExNw' 9-max Seat #1 is the button
Seat 1: 4awUyiDYTgylQKXZ9faBVA ($49.20 in chips) 
Seat 2: Th3FldXKQW6hWVVPahaoOQ ($26.40 in chips) 
Seat 3: 4oA316mXLIui1QY63GXBUg ($25 in chips) 
Seat 4: 0GQg6tdDMBDzY6FKumSo9w ($25.75 in chips) 
Seat 5: cZ99hugmLBj9KhTlc8nCSw ($48.50 in chips) 
Seat 6: H9KUl8cmpLgEpOVDA00bCg ($4.20 in chips) 
Seat 7: 1Clf3cPrqoy/YgvWdWK1Xw ($5 in chips) 
Seat 8: nalbG/4/1Z1wQjRDWV7b2w ($7 in chips) 
Th3FldXKQW6hWVVPahaoOQ: posts small blind $0.10
4oA316mXLIui1QY63GXBUg: posts big blind $0.25
OiV1PWZ3IkN29JlmCcnTwQ: sits out 
*** HOLE CARDS ***
0GQg6tdDMBDzY6FKumSo9w: folds 
cZ99hugmLBj9KhTlc8nCSw: folds 
H9KUl8cmpLgEpOVDA00bCg: folds 
1Clf3cPrqoy/YgvWdWK1Xw: folds 
nalbG/4/1Z1wQjRDWV7b2w: raises $0.75 to $1
4awUyiDYTgylQKXZ9faBVA: folds 
Th3FldXKQW6hWVVPahaoOQ: folds 
4oA316mXLIui1QY63GXBUg: folds 
Uncalled bet ($0.75) returned to nalbG/4/1Z1wQjRDWV7b2w
nalbG/4/1Z1wQjRDWV7b2w collected $0.60 from pot
nalbG/4/1Z1wQjRDWV7b2w: doesn't show hand 
*** SUMMARY ***
Total pot $0.60 | Rake $0 
Seat 1: 4awUyiDYTgylQKXZ9faBVA (button) folded before Flop (didn't bet)
Seat 2: Th3FldXKQW6hWVVPahaoOQ (small blind) folded before Flop
Seat 3: 4oA316mXLIui1QY63GXBUg (big blind) folded before Flop
Seat 4: 0GQg6tdDMBDzY6FKumSo9w folded before Flop (didn't bet)
Seat 5: cZ99hugmLBj9KhTlc8nCSw folded before Flop (didn't bet)
Seat 6: H9KUl8cmpLgEpOVDA00bCg folded before Flop (didn't bet)
Seat 7: 1Clf3cPrqoy/YgvWdWK1Xw folded before Flop (didn't bet)
Seat 8: nalbG/4/1Z1wQjRDWV7b2w collected ($0.60)




PokerStars Game #59939499676:  Hold'em No Limit ($0.10/$0.25) - 2009/07/01 0:41:28 ET
Table '+68ihX5Br1xgGorX6zsCBg' 9-max Seat #5 is the button
Seat 1: qwr38jl5txoR36M7G5qi4A ($8.40 in chips) 
Seat 2: 3PjJjazzeHcM4mbFeXmZBg ($8.60 in chips) 
Seat 3: DIBbjEYGs+TVdVgEB/4+3w ($25.40 in chips) 
Seat 4: STkR8XvpjNv79OOMhrlh2w ($25 in chips) 
Seat 5: AmFFUA8KSwLGIW6CfaP4JQ ($11.80 in chips) 
Seat 6: 8B/dhbQjIWe6ASCdgzktNQ ($25.60 in chips) 
Seat 7: LWN1wPrLH+695JIriXxDuw ($9.05 in chips) 
Seat 8: rUdM7gwmNCaxMNSb2CFPhQ ($12.45 in chips) 
Seat 9: 3wk6bqORFdwo0pZ1g2+Kqw ($22.25 in chips) 
8B/dhbQjIWe6ASCdgzktNQ: posts small blind $0.10
LWN1wPrLH+695JIriXxDuw: posts big blind $0.25
*** HOLE CARDS ***
rUdM7gwmNCaxMNSb2CFPhQ: folds 
3wk6bqORFdwo0pZ1g2+Kqw: folds 
qwr38jl5txoR36M7G5qi4A: folds 
3PjJjazzeHcM4mbFeXmZBg: folds 
DIBbjEYGs+TVdVgEB/4+3w: folds 
STkR8XvpjNv79OOMhrlh2w: folds 
AmFFUA8KSwLGIW6CfaP4JQ: folds 
8B/dhbQjIWe6ASCdgzktNQ: raises $0.50 to $0.75
LWN1wPrLH+695JIriXxDuw: folds 
Uncalled bet ($0.50) returned to 8B/dhbQjIWe6ASCdgzktNQ
8B/dhbQjIWe6ASCdgzktNQ collected $0.50 from pot
8B/dhbQjIWe6ASCdgzktNQ: doesn't show hand 
*** SUMMARY ***
Total pot $0.50 | Rake $0 
Seat 1: qwr38jl5txoR36M7G5qi4A folded before Flop (didn't bet)
Seat 2: 3PjJjazzeHcM4mbFeXmZBg folded before Flop (didn't bet)
Seat 3: DIBbjEYGs+TVdVgEB/4+3w folded before Flop (didn't bet)
Seat 4: STkR8XvpjNv79OOMhrlh2w folded before Flop (didn't bet)
Seat 5: AmFFUA8KSwLGIW6CfaP4JQ (button) folded before Flop (didn't bet)
Seat 6: 8B/dhbQjIWe6ASCdgzktNQ (small blind) collected ($0.50)
Seat 7: LWN1wPrLH+695JIriXxDuw (big blind) folded before Flop
Seat 8: rUdM7gwmNCaxMNSb2CFPhQ folded before Flop (didn't bet)
Seat 9: 3wk6bqORFdwo0pZ1g2+Kqw folded before Flop (didn't bet)




PokerStars Game #59939499654:  Hold'em No Limit ($0.10/$0.25) - 2009/07/01 0:41:28 ET
Table 'rhQuIjJo0UQ7RRUlF9umHg' 6-max Seat #1 is the button
Seat 1: 5O3Hj9Qg0SqOyKEXoLpjPg ($80.20 in chips) 
Seat 2: Ew/TYPQIsbQ2X8nm5iAJBg ($25.95 in chips) 
Seat 3: nLE5Yo60EmSlJPyg0GgxXg ($16 in chips) 
Seat 4: buyjetgNT1McXtdaP4zynA ($22.65 in chips) 
Seat 5: 7qRk4YH4/k/08LgJSv7rBQ ($26.95 in chips) 
Seat 6: r284m4NA4rtNktI86R8/Yw ($10.95 in chips) 
Ew/TYPQIsbQ2X8nm5iAJBg: posts small blind $0.10
nLE5Yo60EmSlJPyg0GgxXg: posts big blind $0.25
*** HOLE CARDS ***
buyjetgNT1McXtdaP4zynA: calls $0.25
7qRk4YH4/k/08LgJSv7rBQ: raises $0.75 to $1
r284m4NA4rtNktI86R8/Yw: folds 
5O3Hj9Qg0SqOyKEXoLpjPg: calls $1
Ew/TYPQIsbQ2X8nm5iAJBg: calls $0.90
nLE5Yo60EmSlJPyg0GgxXg: calls $0.75
buyjetgNT1McXtdaP4zynA: calls $0.75
*** FLOP *** [2c Js Qs]
Ew/TYPQIsbQ2X8nm5iAJBg: checks 
nLE5Yo60EmSlJPyg0GgxXg: checks 
buyjetgNT1McXtdaP4zynA: checks 
7qRk4YH4/k/08LgJSv7rBQ: checks 
5O3Hj9Qg0SqOyKEXoLpjPg: bets $5
Ew/TYPQIsbQ2X8nm5iAJBg: raises $8.75 to $13.75
nLE5Yo60EmSlJPyg0GgxXg: folds 
buyjetgNT1McXtdaP4zynA: folds 
7qRk4YH4/k/08LgJSv7rBQ: folds 
5O3Hj9Qg0SqOyKEXoLpjPg: calls $8.75
*** TURN *** [2c Js Qs] [6c]
Ew/TYPQIsbQ2X8nm5iAJBg: bets $11.20 and is all-in
5O3Hj9Qg0SqOyKEXoLpjPg: calls $11.20
*** RIVER *** [2c Js Qs 6c] [Kd]
*** SHOW DOWN ***
Ew/TYPQIsbQ2X8nm5iAJBg: shows [2s 6s] (two pair, Sixes and Deuces)
5O3Hj9Qg0SqOyKEXoLpjPg: mucks hand 
Ew/TYPQIsbQ2X8nm5iAJBg collected $52.25 from pot
*** SUMMARY ***
Total pot $54.90 | Rake $2.65 
Board [2c Js Qs 6c Kd]
Seat 1: 5O3Hj9Qg0SqOyKEXoLpjPg (button) mucked
Seat 2: Ew/TYPQIsbQ2X8nm5iAJBg (small blind) showed [2s 6s] and won ($52.25) with two pair, Sixes and Deuces
Seat 3: nLE5Yo60EmSlJPyg0GgxXg (big blind) folded on the Flop
Seat 4: buyjetgNT1McXtdaP4zynA folded on the Flop
Seat 5: 7qRk4YH4/k/08LgJSv7rBQ folded on the Flop
Seat 6: r284m4NA4rtNktI86R8/Yw folded before Flop (didn't bet)




PokerStars Game #59939500092:  Hold'em No Limit ($0.10/$0.25) - 2009/07/01 0:41:29 ET
Table 'eOXPe2c6mG7DOFKvMsZZfA' 6-max Seat #3 is the button
Seat 1: ShXPHWfjhfmAwLgDdm6bRQ ($7.65 in chips) 
Seat 2: ELW+DKizJhLK7k40PMkD2Q ($32.75 in chips) 
Seat 3: kReyZ6g6Fu3tQ0nyjDf9kA ($31.25 in chips) 
Seat 4: zHHLkD2sRljslKKeQv/ZQw ($42.15 in chips) 
Seat 5: NhUN/JpAprdJeamFBgJH1w ($25 in chips) 
Seat 6: wKFJ513ucluNNiMlkXcDOQ ($25.35 in chips) 
zHHLkD2sRljslKKeQv/ZQw: posts small blind $0.10
NhUN/JpAprdJeamFBgJH1w: posts big blind $0.25
*** HOLE CARDS ***
wKFJ513ucluNNiMlkXcDOQ: raises $0.75 to $1
ShXPHWfjhfmAwLgDdm6bRQ: folds 
ELW+DKizJhLK7k40PMkD2Q: folds 
kReyZ6g6Fu3tQ0nyjDf9kA: folds 
zHHLkD2sRljslKKeQv/ZQw: folds 
NhUN/JpAprdJeamFBgJH1w: folds 
Uncalled bet ($0.75) returned to wKFJ513ucluNNiMlkXcDOQ
wKFJ513ucluNNiMlkXcDOQ collected $0.60 from pot
wKFJ513ucluNNiMlkXcDOQ: doesn't show hand 
*** SUMMARY ***
Total pot $0.60 | Rake $0 
Seat 1: ShXPHWfjhfmAwLgDdm6bRQ folded before Flop (didn't bet)
Seat 2: ELW+DKizJhLK7k40PMkD2Q folded before Flop (didn't bet)
Seat 3: kReyZ6g6Fu3tQ0nyjDf9kA (button) folded before Flop (didn't bet)
Seat 4: zHHLkD2sRljslKKeQv/ZQw (small blind) folded before Flop
Seat 5: NhUN/JpAprdJeamFBgJH1w (big blind) folded before Flop
Seat 6: wKFJ513ucluNNiMlkXcDOQ collected ($0.60)




PokerStars Game #59939499866:  Hold'em No Limit ($0.10/$0.25) - 2009/07/01 0:41:29 ET
Table '5510FxlYzKi+U6MIpo8IPA' 6-max Seat #6 is the button
Seat 1: KM6ogk7SqyRlk3m9b0h+7A ($18.25 in chips) 
Seat 2: gqW2aBCmrIw65BvwjTFN6Q ($25 in chips) 
Seat 3: v+QfkGiuj9bgtuNoVnDO8w ($29.45 in chips) 
Seat 4: cPO/1/dTcZpLkQFm3jH3Rg ($27.55 in chips) 
Seat 5: 5E1iMY5xyboow7Xm0v7Idw ($13.60 in chips) 
Seat 6: SFmT9ZsVopnukjvAzrxTRg ($28.75 in chips) 
KM6ogk7SqyRlk3m9b0h+7A: posts small blind $0.10
gqW2aBCmrIw65BvwjTFN6Q: posts big blind $0.25
*** HOLE CARDS ***
v+QfkGiuj9bgtuNoVnDO8w: folds 
cPO/1/dTcZpLkQFm3jH3Rg: folds 
5E1iMY5xyboow7Xm0v7Idw: folds 
SFmT9ZsVopnukjvAzrxTRg: folds 
KM6ogk7SqyRlk3m9b0h+7A: raises $0.50 to $0.75
gqW2aBCmrIw65BvwjTFN6Q: calls $0.50
*** FLOP *** [3h Kc 4s]
KM6ogk7SqyRlk3m9b0h+7A: checks 
gqW2aBCmrIw65BvwjTFN6Q: bets $1
KM6ogk7SqyRlk3m9b0h+7A: calls $1
*** TURN *** [3h Kc 4s] [5c]
KM6ogk7SqyRlk3m9b0h+7A: checks 
gqW2aBCmrIw65BvwjTFN6Q: checks 
*** RIVER *** [3h Kc 4s 5c] [Jc]
KM6ogk7SqyRlk3m9b0h+7A: bets $1
gqW2aBCmrIw65BvwjTFN6Q: folds 
Uncalled bet ($1) returned to KM6ogk7SqyRlk3m9b0h+7A
KM6ogk7SqyRlk3m9b0h+7A collected $3.35 from pot
*** SUMMARY ***
Total pot $3.50 | Rake $0.15 
Board [3h Kc 4s 5c Jc]
Seat 1: KM6ogk7SqyRlk3m9b0h+7A (small blind) collected ($3.35)
Seat 2: gqW2aBCmrIw65BvwjTFN6Q (big blind) folded on the River
Seat 3: v+QfkGiuj9bgtuNoVnDO8w folded before Flop (didn't bet)
Seat 4: cPO/1/dTcZpLkQFm3jH3Rg folded before Flop (didn't bet)
Seat 5: 5E1iMY5xyboow7Xm0v7Idw folded before Flop (didn't bet)
Seat 6: SFmT9ZsVopnukjvAzrxTRg (button) folded before Flop (didn't bet)




PokerStars Game #59939499992:  Hold'em No Limit ($0.10/$0.25) - 2009/07/01 0:41:29 ET
Table 'IdXp6nyeW4FYaEK4qKCnwQ' 9-max Seat #2 is the button
Seat 2: HPEB+AtKw1+C/cxU0o1ciw ($28.55 in chips) 
Seat 3: jiyia7h6fmxBdWBkH9lH5A ($3.45 in chips) 
Seat 5: U41wNf6XauAiBOQaKu2ZIA ($10 in chips) 
Seat 6: 1K6QGyJP9P9xmRac2fH4OQ ($33.45 in chips) 
Seat 7: CYkY0dNBaYaKs8HVCVn3mQ ($9.60 in chips) 
Seat 8: cZ99hugmLBj9KhTlc8nCSw ($25 in chips) 
jiyia7h6fmxBdWBkH9lH5A: posts small blind $0.10
U41wNf6XauAiBOQaKu2ZIA: posts big blind $0.25
*** HOLE CARDS ***
JJH2Xc95hFewheF67vSv4Q joins the table at seat #9 
1K6QGyJP9P9xmRac2fH4OQ: folds 
CYkY0dNBaYaKs8HVCVn3mQ: folds 
cZ99hugmLBj9KhTlc8nCSw: folds 
HPEB+AtKw1+C/cxU0o1ciw: folds 
jiyia7h6fmxBdWBkH9lH5A: calls $0.15
U41wNf6XauAiBOQaKu2ZIA: raises $0.25 to $0.50
jiyia7h6fmxBdWBkH9lH5A: calls $0.25
*** FLOP *** [Td Kd Ks]
jiyia7h6fmxBdWBkH9lH5A: bets $0.50
U41wNf6XauAiBOQaKu2ZIA: calls $0.50
*** TURN *** [Td Kd Ks] [Jc]
jiyia7h6fmxBdWBkH9lH5A: bets $0.50
U41wNf6XauAiBOQaKu2ZIA: raises $0.75 to $1.25
jiyia7h6fmxBdWBkH9lH5A: calls $0.75
*** RIVER *** [Td Kd Ks Jc] [3h]
jiyia7h6fmxBdWBkH9lH5A: bets $0.50
U41wNf6XauAiBOQaKu2ZIA: raises $1.50 to $2
jiyia7h6fmxBdWBkH9lH5A: calls $0.70 and is all-in
Uncalled bet ($0.80) returned to U41wNf6XauAiBOQaKu2ZIA
*** SHOW DOWN ***
U41wNf6XauAiBOQaKu2ZIA: shows [Ad Ac] (two pair, Aces and Kings)
jiyia7h6fmxBdWBkH9lH5A: mucks hand 
U41wNf6XauAiBOQaKu2ZIA collected $6.60 from pot
*** SUMMARY ***
Total pot $6.90 | Rake $0.30 
Board [Td Kd Ks Jc 3h]
Seat 2: HPEB+AtKw1+C/cxU0o1ciw (button) folded before Flop (didn't bet)
Seat 3: jiyia7h6fmxBdWBkH9lH5A (small blind) mucked
Seat 5: U41wNf6XauAiBOQaKu2ZIA (big blind) showed [Ad Ac] and won ($6.60) with two pair, Aces and Kings
Seat 6: 1K6QGyJP9P9xmRac2fH4OQ folded before Flop (didn't bet)
Seat 7: CYkY0dNBaYaKs8HVCVn3mQ folded before Flop (didn't bet)
Seat 8: cZ99hugmLBj9KhTlc8nCSw folded before Flop (didn't bet)




PokerStars Game #59939500044:  Hold'em No Limit ($0.10/$0.25) - 2009/07/01 0:41:29 ET
Table 'YmPuuzhvRUvgdYcNs5kZKw' 9-max Seat #6 is the button
Seat 1: Qi+clOtyDiibLdH2/1Qy8g ($25.30 in chips) 
Seat 2: Z5ZtGOON8kmSdSCll9Z3XA ($17 in chips) 
Seat 3: uLP/lYn7oKq9xCChBXsXxw ($24.50 in chips) 
Seat 6: z5GxcHlYz/GSz6W2uFiTtg ($24.55 in chips) 
Seat 7: opOCI2p6kW0tINuVaAqmcQ ($25 in chips) 
Seat 8: IeNTEKD96WqM7qU1RpSvOQ ($10.80 in chips) 
Seat 9: 5IeCaraAnS03/jUIjZQAig ($6.60 in chips) 
opOCI2p6kW0tINuVaAqmcQ: posts small blind $0.10
IeNTEKD96WqM7qU1RpSvOQ: posts big blind $0.25
N6fYvIzQLKaydFLKQGtMlQ: sits out 
CvL9Ch1HYCVbTsfpNucitg: sits out 
*** HOLE CARDS ***
5IeCaraAnS03/jUIjZQAig: folds 
Qi+clOtyDiibLdH2/1Qy8g: folds 
Z5ZtGOON8kmSdSCll9Z3XA: folds 
uLP/lYn7oKq9xCChBXsXxw: folds 
z5GxcHlYz/GSz6W2uFiTtg: calls $0.25
opOCI2p6kW0tINuVaAqmcQ: folds 
IeNTEKD96WqM7qU1RpSvOQ: checks 
*** FLOP *** [2c 3d 4d]
IeNTEKD96WqM7qU1RpSvOQ: bets $0.25
z5GxcHlYz/GSz6W2uFiTtg: folds 
Uncalled bet ($0.25) returned to IeNTEKD96WqM7qU1RpSvOQ
IeNTEKD96WqM7qU1RpSvOQ collected $0.60 from pot
*** SUMMARY ***
Total pot $0.60 | Rake $0 
Board [2c 3d 4d]
Seat 1: Qi+clOtyDiibLdH2/1Qy8g folded before Flop (didn't bet)
Seat 2: Z5ZtGOON8kmSdSCll9Z3XA folded before Flop (didn't bet)
Seat 3: uLP/lYn7oKq9xCChBXsXxw folded before Flop (didn't bet)
Seat 6: z5GxcHlYz/GSz6W2uFiTtg (button) folded on the Flop
Seat 7: opOCI2p6kW0tINuVaAqmcQ (small blind) folded before Flop
Seat 8: IeNTEKD96WqM7qU1RpSvOQ (big blind) collected ($0.60)
Seat 9: 5IeCaraAnS03/jUIjZQAig folded before Flop (didn't bet)




PokerStars Game #59939500372:  Hold'em No Limit ($0.10/$0.25) - 2009/07/01 0:41:29 ET
Table 'nFlmVztKq1HJEWfxmdl15w' 9-max Seat #5 is the button
Seat 1: COsrwJSFHQtxlUcrYtDQPQ ($25 in chips) 
Seat 3: /XMgGtJ7mcWfe5s7McY9kw ($25 in chips) 
Seat 4: +5dSUwD+/k2ktlnutSMivw ($20.40 in chips) 
Seat 5: Tx6zQdk5Ozt9ObEBlU7jeg ($21.05 in chips) 
Seat 6: 4awUyiDYTgylQKXZ9faBVA ($29.35 in chips) 
Seat 7: Mm1VqYDg+pZQ8ufUXZHA1g ($11.65 in chips) 
Seat 9: LSrAei+fS8MYG9ie/GkG0Q ($15.75 in chips) 
4awUyiDYTgylQKXZ9faBVA: posts small blind $0.10
Mm1VqYDg+pZQ8ufUXZHA1g: posts big blind $0.25
+2kMBNpY4nF1qNCRd8SJLA: sits out 
XOXO/l78: sits out 
*** HOLE CARDS ***
LSrAei+fS8MYG9ie/GkG0Q: folds 
COsrwJSFHQtxlUcrYtDQPQ: folds 
/XMgGtJ7mcWfe5s7McY9kw: raises $0.50 to $0.75
+5dSUwD+/k2ktlnutSMivw: folds 
Tx6zQdk5Ozt9ObEBlU7jeg: calls $0.75
4awUyiDYTgylQKXZ9faBVA: folds 
Mm1VqYDg+pZQ8ufUXZHA1g: folds 
*** FLOP *** [Qs 8d 7c]
/XMgGtJ7mcWfe5s7McY9kw: checks 
Tx6zQdk5Ozt9ObEBlU7jeg: checks 
*** TURN *** [Qs 8d 7c] [Ts]
/XMgGtJ7mcWfe5s7McY9kw: checks 
Tx6zQdk5Ozt9ObEBlU7jeg: bets $0.25
/XMgGtJ7mcWfe5s7McY9kw: calls $0.25
*** RIVER *** [Qs 8d 7c Ts] [Kh]
/XMgGtJ7mcWfe5s7McY9kw: bets $1
Tx6zQdk5Ozt9ObEBlU7jeg: raises $1 to $2
/XMgGtJ7mcWfe5s7McY9kw: calls $1
*** SHOW DOWN ***
Tx6zQdk5Ozt9ObEBlU7jeg: shows [7s 7d] (three of a kind, Sevens)
/XMgGtJ7mcWfe5s7McY9kw: mucks hand 
Tx6zQdk5Ozt9ObEBlU7jeg collected $6.05 from pot
*** SUMMARY ***
Total pot $6.35 | Rake $0.30 
Board [Qs 8d 7c Ts Kh]
Seat 1: COsrwJSFHQtxlUcrYtDQPQ folded before Flop (didn't bet)
Seat 3: /XMgGtJ7mcWfe5s7McY9kw mucked
Seat 4: +5dSUwD+/k2ktlnutSMivw folded before Flop (didn't bet)
Seat 5: Tx6zQdk5Ozt9ObEBlU7jeg (button) showed [7s 7d] and won ($6.05) with three of a kind, Sevens
Seat 6: 4awUyiDYTgylQKXZ9faBVA (small blind) folded before Flop
Seat 7: Mm1VqYDg+pZQ8ufUXZHA1g (big blind) folded before Flop
Seat 9: LSrAei+fS8MYG9ie/GkG0Q folded before Flop (didn't bet)




PokerStars Game #59939500088:  Hold'em No Limit ($0.10/$0.25) - 2009/07/01 0:41:29 ET
Table 'HzFR0rxmDAPu5GzYR0AlYg' 6-max Seat #1 is the button
Seat 1: v+QfkGiuj9bgtuNoVnDO8w ($25 in chips) 
Seat 2: UA5OsKS3VPaxa7uC8La/kA ($53.05 in chips) 
Seat 3: lfAPI6VglUPipZe8BpDaTA ($24.85 in chips) 
Seat 4: uy9x0X5l7O+IpGjLa77QgQ ($60.05 in chips) 
Seat 5: I1TxPvWj8NfG8orglCinNA ($25 in chips) 
UA5OsKS3VPaxa7uC8La/kA: posts small blind $0.10
lfAPI6VglUPipZe8BpDaTA: posts big blind $0.25
*** HOLE CARDS ***
uy9x0X5l7O+IpGjLa77QgQ: folds 
I1TxPvWj8NfG8orglCinNA: folds 
v+QfkGiuj9bgtuNoVnDO8w: folds 
UA5OsKS3VPaxa7uC8La/kA: folds 
Uncalled bet ($0.15) returned to lfAPI6VglUPipZe8BpDaTA
lfAPI6VglUPipZe8BpDaTA collected $0.20 from pot
lfAPI6VglUPipZe8BpDaTA: doesn't show hand 
*** SUMMARY ***
Total pot $0.20 | Rake $0 
Seat 1: v+QfkGiuj9bgtuNoVnDO8w (button) folded before Flop (didn't bet)
Seat 2: UA5OsKS3VPaxa7uC8La/kA (small blind) folded before Flop
Seat 3: lfAPI6VglUPipZe8BpDaTA (big blind) collected ($0.20)
Seat 4: uy9x0X5l7O+IpGjLa77QgQ folded before Flop (didn't bet)
Seat 5: I1TxPvWj8NfG8orglCinNA folded before Flop (didn't bet)




PokerStars Game #59939500010:  Hold'em No Limit ($0.10/$0.25) - 2009/07/01 0:41:29 ET
Table 'hOE09W281uSob0XeJmUcRg' 6-max Seat #1 is the button
Seat 1: edio/rLJ06xeZOfLhoL3UA ($17.30 in chips) 
Seat 4: TslQs7AQSLbVtr4X8JOOOQ ($19.30 in chips) 
Seat 5: 66a/8+qw1AZLNh63FuclPA ($101.35 in chips) 
Seat 6: x4ZJ8E/TUrtoB7WiHcv8WA ($8.35 in chips) 
TslQs7AQSLbVtr4X8JOOOQ: posts small blind $0.10
66a/8+qw1AZLNh63FuclPA: posts big blind $0.25
*** HOLE CARDS ***
x4ZJ8E/TUrtoB7WiHcv8WA: folds 
edio/rLJ06xeZOfLhoL3UA: raises $1 to $1.25
TslQs7AQSLbVtr4X8JOOOQ: folds 
66a/8+qw1AZLNh63FuclPA: calls $1
*** FLOP *** [Ah 2h 9s]
66a/8+qw1AZLNh63FuclPA: checks 
edio/rLJ06xeZOfLhoL3UA: bets $1.25
66a/8+qw1AZLNh63FuclPA: raises $2.25 to $3.50
edio/rLJ06xeZOfLhoL3UA: calls $2.25
*** TURN *** [Ah 2h 9s] [3s]
PNRA_Broker joins the table at seat #3 
66a/8+qw1AZLNh63FuclPA: checks 
edio/rLJ06xeZOfLhoL3UA: checks 
*** RIVER *** [Ah 2h 9s 3s] [5h]
VladBah joins the table at seat #2 
66a/8+qw1AZLNh63FuclPA: bets $5
edio/rLJ06xeZOfLhoL3UA: raises $7.55 to $12.55 and is all-in
66a/8+qw1AZLNh63FuclPA: calls $7.55
*** SHOW DOWN ***
edio/rLJ06xeZOfLhoL3UA: shows [8h Qh] (a flush, Ace high)
66a/8+qw1AZLNh63FuclPA: mucks hand 
edio/rLJ06xeZOfLhoL3UA collected $33 from pot
*** SUMMARY ***
Total pot $34.70 | Rake $1.70 
Board [Ah 2h 9s 3s 5h]
Seat 1: edio/rLJ06xeZOfLhoL3UA (button) showed [8h Qh] and won ($33) with a flush, Ace high
Seat 4: TslQs7AQSLbVtr4X8JOOOQ (small blind) folded before Flop
Seat 5: 66a/8+qw1AZLNh63FuclPA (big blind) mucked
Seat 6: x4ZJ8E/TUrtoB7WiHcv8WA folded before Flop (didn't bet)




PokerStars Game #59939500840:  Hold'em No Limit ($0.10/$0.25) - 2009/07/01 0:41:30 ET
Table 'biAgO3TKQBU8XcrVAoU5TA' 6-max Seat #6 is the button
Seat 2: 7qRk4YH4/k/08LgJSv7rBQ ($24.95 in chips) 
Seat 3: 7AHdX4G8gYtDJyNY+wK+6Q ($32.15 in chips) 
Seat 4: 2/AObG8G5tKFCPZ+CdivJQ ($8.95 in chips) 
Seat 6: //i5P+6lSkIyZsqb+ojVQA ($14.70 in chips) 
7qRk4YH4/k/08LgJSv7rBQ: posts small blind $0.10
7AHdX4G8gYtDJyNY+wK+6Q: posts big blind $0.25
*** HOLE CARDS ***
2/AObG8G5tKFCPZ+CdivJQ: folds 
//i5P+6lSkIyZsqb+ojVQA: raises $0.25 to $0.50
7qRk4YH4/k/08LgJSv7rBQ: folds 
7AHdX4G8gYtDJyNY+wK+6Q: calls $0.25
*** FLOP *** [Th Tc Ks]
7AHdX4G8gYtDJyNY+wK+6Q: checks 
//i5P+6lSkIyZsqb+ojVQA: checks 
*** TURN *** [Th Tc Ks] [Kd]
7AHdX4G8gYtDJyNY+wK+6Q: checks 
i48129QFpEQQ+UN4aNtmww joins the table at seat #1 
//i5P+6lSkIyZsqb+ojVQA: bets $0.50
7AHdX4G8gYtDJyNY+wK+6Q: calls $0.50
*** RIVER *** [Th Tc Ks Kd] [Td]
7AHdX4G8gYtDJyNY+wK+6Q: checks 
6DwBRH+xZ12AAZmeAg+aXw joins the table at seat #5 
//i5P+6lSkIyZsqb+ojVQA: bets $1
7AHdX4G8gYtDJyNY+wK+6Q: calls $1
*** SHOW DOWN ***
//i5P+6lSkIyZsqb+ojVQA: shows [8h Ah] (a full house, Tens full of Kings)
7AHdX4G8gYtDJyNY+wK+6Q: shows [9s 9h] (a full house, Tens full of Kings)
7AHdX4G8gYtDJyNY+wK+6Q collected $1.95 from pot
//i5P+6lSkIyZsqb+ojVQA collected $1.95 from pot
*** SUMMARY ***
Total pot $4.10 | Rake $0.20 
Board [Th Tc Ks Kd Td]
Seat 2: 7qRk4YH4/k/08LgJSv7rBQ (small blind) folded before Flop
Seat 3: 7AHdX4G8gYtDJyNY+wK+6Q (big blind) showed [9s 9h] and won ($1.95) with a full house, Tens full of Kings
Seat 4: 2/AObG8G5tKFCPZ+CdivJQ folded before Flop (didn't bet)
Seat 6: //i5P+6lSkIyZsqb+ojVQA (button) showed [8h Ah] and won ($1.95) with a full house, Tens full of Kings




PokerStars Game #59939500932:  Hold'em No Limit ($0.10/$0.25) - 2009/07/01 0:41:30 ET
Table 'Qk/910N2Yhg8u5vqTJk50Q' 9-max Seat #8 is the button
Seat 1: zDrucyjVn5aeekNEc3cJrA ($25.25 in chips) 
Seat 2: Th3FldXKQW6hWVVPahaoOQ ($33.20 in chips) 
Seat 3: ghNKXUBl/H+t83JF079ZBA ($25 in chips) 
Seat 4: 33y9+GmQ3J84RvZXcraRTw ($21.20 in chips) 
Seat 5: 4oA316mXLIui1QY63GXBUg ($27.25 in chips) 
Seat 6: Uupj2MGlo48VpA/VyYrfrw ($10.05 in chips) 
Seat 7: Wem/MTN+sc9vH/UZeT5YLQ ($9.50 in chips) 
Seat 8: H5Se03ZqSX7tbULXur2MAg ($25.50 in chips) 
Seat 9: M2QO2DxB5Wawg2h8HSpnYA ($10.05 in chips) 
M2QO2DxB5Wawg2h8HSpnYA: posts small blind $0.10
zDrucyjVn5aeekNEc3cJrA: posts big blind $0.25
*** HOLE CARDS ***
Th3FldXKQW6hWVVPahaoOQ: raises $0.75 to $1
ghNKXUBl/H+t83JF079ZBA: folds 
33y9+GmQ3J84RvZXcraRTw: folds 
4oA316mXLIui1QY63GXBUg: folds 
Uupj2MGlo48VpA/VyYrfrw: folds 
Wem/MTN+sc9vH/UZeT5YLQ: calls $1
H5Se03ZqSX7tbULXur2MAg: folds 
M2QO2DxB5Wawg2h8HSpnYA: folds 
zDrucyjVn5aeekNEc3cJrA: folds 
*** FLOP *** [8h 6d 7c]
Th3FldXKQW6hWVVPahaoOQ: bets $1.50
Wem/MTN+sc9vH/UZeT5YLQ: calls $1.50
*** TURN *** [8h 6d 7c] [5c]
Th3FldXKQW6hWVVPahaoOQ: bets $2.50
Wem/MTN+sc9vH/UZeT5YLQ: calls $2.50
*** RIVER *** [8h 6d 7c 5c] [Jd]
Th3FldXKQW6hWVVPahaoOQ: bets $5.75
Wem/MTN+sc9vH/UZeT5YLQ: folds 
Uncalled bet ($5.75) returned to Th3FldXKQW6hWVVPahaoOQ
Th3FldXKQW6hWVVPahaoOQ collected $9.85 from pot
Th3FldXKQW6hWVVPahaoOQ: doesn't show hand 
*** SUMMARY ***
Total pot $10.35 | Rake $0.50 
Board [8h 6d 7c 5c Jd]
Seat 1: zDrucyjVn5aeekNEc3cJrA (big blind) folded before Flop
Seat 2: Th3FldXKQW6hWVVPahaoOQ collected ($9.85)
Seat 3: ghNKXUBl/H+t83JF079ZBA folded before Flop (didn't bet)
Seat 4: 33y9+GmQ3J84RvZXcraRTw folded before Flop (didn't bet)
Seat 5: 4oA316mXLIui1QY63GXBUg folded before Flop (didn't bet)
Seat 6: Uupj2MGlo48VpA/VyYrfrw folded before Flop (didn't bet)
Seat 7: Wem/MTN+sc9vH/UZeT5YLQ folded on the River
Seat 8: H5Se03ZqSX7tbULXur2MAg (button) folded before Flop (didn't bet)
Seat 9: M2QO2DxB5Wawg2h8HSpnYA (small blind) folded before Flop




PokerStars Game #59939501040:  Hold'em No Limit ($0.10/$0.25) - 2009/07/01 0:41:30 ET
Table 'oJpFwZj9+FUGHX90Un8s9Q' 6-max Seat #4 is the button
Seat 2: IMmIhmfU3tqkaJABnD21Rg ($19.85 in chips) 
Seat 3: kyRaCIljYA6l33lSKQfNsg ($26.30 in chips) 
Seat 4: IX/nJvz3Mx/Ez6DgueFA4Q ($6.60 in chips) 
Seat 5: kG34n23qFQA3nzdOJTQ1dA ($24.75 in chips) 
Seat 6: Zijzy/UtPWzWVUo81HHVjQ ($40.80 in chips) 
kG34n23qFQA3nzdOJTQ1dA: posts small blind $0.10
Zijzy/UtPWzWVUo81HHVjQ: posts big blind $0.25
*** HOLE CARDS ***
IMmIhmfU3tqkaJABnD21Rg: raises $0.25 to $0.50
kyRaCIljYA6l33lSKQfNsg: folds 
IX/nJvz3Mx/Ez6DgueFA4Q: folds 
kG34n23qFQA3nzdOJTQ1dA: folds 
6DwBRH+xZ12AAZmeAg+aXw joins the table at seat #1 
Zijzy/UtPWzWVUo81HHVjQ: folds 
Uncalled bet ($0.25) returned to IMmIhmfU3tqkaJABnD21Rg
IMmIhmfU3tqkaJABnD21Rg collected $0.60 from pot
IMmIhmfU3tqkaJABnD21Rg: doesn't show hand 
*** SUMMARY ***
Total pot $0.60 | Rake $0 
Seat 2: IMmIhmfU3tqkaJABnD21Rg collected ($0.60)
Seat 3: kyRaCIljYA6l33lSKQfNsg folded before Flop (didn't bet)
Seat 4: IX/nJvz3Mx/Ez6DgueFA4Q (button) folded before Flop (didn't bet)
Seat 5: kG34n23qFQA3nzdOJTQ1dA (small blind) folded before Flop
Seat 6: Zijzy/UtPWzWVUo81HHVjQ (big blind) folded before Flop




PokerStars Game #59939500546:  Hold'em No Limit ($0.10/$0.25) - 2009/07/01 0:41:30 ET
Table 'zgAizkhIUPUrfr6LqN3ifw' 9-max Seat #2 is the button
Seat 1: st9jtdNbm1W5GfBwRaCVqQ ($25.25 in chips) 
Seat 2: s7Q6uNouhe7aE8JdFb9E+A ($26.25 in chips) 
Seat 3: hZuGwtYmFKPmQ+v1wlmdfA ($22.85 in chips) 
Seat 5: DdPXdieucQ+n99u1n3A+rQ ($5 in chips) 
Seat 7: 1S/fpm+f42V/6MNZre+ccg ($25 in chips) 
Seat 8: MIVCHqCqqlke0Lb0z7glcw ($24.15 in chips) 
Seat 9: SXqVW4Q0evTUVZG6BbUNIA ($39.30 in chips) 
hZuGwtYmFKPmQ+v1wlmdfA: posts small blind $0.10
DdPXdieucQ+n99u1n3A+rQ: posts big blind $0.25
TeWJxSETzbXGiYKx0y+dtg: sits out 
*** HOLE CARDS ***
1S/fpm+f42V/6MNZre+ccg: folds 
MIVCHqCqqlke0Lb0z7glcw: folds 
SXqVW4Q0evTUVZG6BbUNIA: folds 
st9jtdNbm1W5GfBwRaCVqQ: folds 
s7Q6uNouhe7aE8JdFb9E+A: folds 
hZuGwtYmFKPmQ+v1wlmdfA: calls $0.15
DdPXdieucQ+n99u1n3A+rQ: raises $0.75 to $1
hZuGwtYmFKPmQ+v1wlmdfA: folds 
Uncalled bet ($0.75) returned to DdPXdieucQ+n99u1n3A+rQ
DdPXdieucQ+n99u1n3A+rQ collected $0.50 from pot
DdPXdieucQ+n99u1n3A+rQ: doesn't show hand 
*** SUMMARY ***
Total pot $0.50 | Rake $0 
Seat 1: st9jtdNbm1W5GfBwRaCVqQ folded before Flop (didn't bet)
Seat 2: s7Q6uNouhe7aE8JdFb9E+A (button) folded before Flop (didn't bet)
Seat 3: hZuGwtYmFKPmQ+v1wlmdfA (small blind) folded before Flop
Seat 5: DdPXdieucQ+n99u1n3A+rQ (big blind) collected ($0.50)
Seat 7: 1S/fpm+f42V/6MNZre+ccg folded before Flop (didn't bet)
Seat 8: MIVCHqCqqlke0Lb0z7glcw folded before Flop (didn't bet)
Seat 9: SXqVW4Q0evTUVZG6BbUNIA folded before Flop (didn't bet)




PokerStars Game #59939500514:  Hold'em No Limit ($0.10/$0.25) - 2009/07/01 0:41:30 ET
Table 'SgI2Cobdjtkh0Fd0/eTTDg' 9-max Seat #9 is the button
Seat 1: JRfCWETUoKaEo7sf/Jy3Kg ($24 in chips) 
Seat 2: 8B/dhbQjIWe6ASCdgzktNQ ($42.20 in chips) 
Seat 3: OiV1PWZ3IkN29JlmCcnTwQ ($4.90 in chips) 
Seat 4: 18G4P1XstjNvItdGUITxgw ($25 in chips) 
Seat 5: w/RUHfVzKTf7Bc19nucLpQ ($9.10 in chips) 
Seat 7: aJy680tKSaP5er559aSuGA ($22.35 in chips) 
Seat 9: cZ99hugmLBj9KhTlc8nCSw ($25.55 in chips) 
JRfCWETUoKaEo7sf/Jy3Kg: posts small blind $0.10
8B/dhbQjIWe6ASCdgzktNQ: posts big blind $0.25
*** HOLE CARDS ***
OiV1PWZ3IkN29JlmCcnTwQ: folds 
18G4P1XstjNvItdGUITxgw: folds 
w/RUHfVzKTf7Bc19nucLpQ: raises $0.50 to $0.75
aJy680tKSaP5er559aSuGA: folds 
cZ99hugmLBj9KhTlc8nCSw: folds 
JRfCWETUoKaEo7sf/Jy3Kg: folds 
8B/dhbQjIWe6ASCdgzktNQ: folds 
Uncalled bet ($0.50) returned to w/RUHfVzKTf7Bc19nucLpQ
w/RUHfVzKTf7Bc19nucLpQ collected $0.60 from pot
*** SUMMARY ***
Total pot $0.60 | Rake $0 
Seat 1: JRfCWETUoKaEo7sf/Jy3Kg (small blind) folded before Flop
Seat 2: 8B/dhbQjIWe6ASCdgzktNQ (big blind) folded before Flop
Seat 3: OiV1PWZ3IkN29JlmCcnTwQ folded before Flop (didn't bet)
Seat 4: 18G4P1XstjNvItdGUITxgw folded before Flop (didn't bet)
Seat 5: w/RUHfVzKTf7Bc19nucLpQ collected ($0.60)
Seat 7: aJy680tKSaP5er559aSuGA folded before Flop (didn't bet)
Seat 9: cZ99hugmLBj9KhTlc8nCSw (button) folded before Flop (didn't bet)




PokerStars Game #59939500844:  Hold'em No Limit ($0.10/$0.25) - 2009/07/01 0:41:30 ET
Table 'MQJMxKDF6VYBWIKv7VfCog' 9-max Seat #9 is the button
Seat 1: cZ99hugmLBj9KhTlc8nCSw ($26.65 in chips) 
Seat 4: JtVGnq5doRa3PublncR+Yw ($24.25 in chips) 
Seat 5: RJ/x9oZtt1RZLaJEQwZOxQ ($25.60 in chips) 
Seat 6: ydoFOVgzvZv9ZhuWu9rXAw ($4.90 in chips) 
Seat 7: dfNim92Z6XK1/h5SFW5vDg ($52.95 in chips) 
Seat 8: Z9AeOQX3yzuSvKAm/xyovg ($9.30 in chips) 
Seat 9: 1S/fpm+f42V/6MNZre+ccg ($36.10 in chips) 
cZ99hugmLBj9KhTlc8nCSw: posts small blind $0.10
JxpnpCmvRAcrEUy7mq1iAg: is sitting out 
EfRs3ibIxn+c9JDErwwNCg: is sitting out 
JtVGnq5doRa3PublncR+Yw: posts big blind $0.25
*** HOLE CARDS ***
RJ/x9oZtt1RZLaJEQwZOxQ: folds 
EfRs3ibIxn+c9JDErwwNCg leaves the table
ydoFOVgzvZv9ZhuWu9rXAw: folds 
dfNim92Z6XK1/h5SFW5vDg: folds 
Z9AeOQX3yzuSvKAm/xyovg: folds 
1S/fpm+f42V/6MNZre+ccg: folds 
cZ99hugmLBj9KhTlc8nCSw: folds 
Uncalled bet ($0.15) returned to JtVGnq5doRa3PublncR+Yw
JtVGnq5doRa3PublncR+Yw collected $0.20 from pot
*** SUMMARY ***
Total pot $0.20 | Rake $0 
Seat 1: cZ99hugmLBj9KhTlc8nCSw (small blind) folded before Flop
Seat 4: JtVGnq5doRa3PublncR+Yw (big blind) collected ($0.20)
Seat 5: RJ/x9oZtt1RZLaJEQwZOxQ folded before Flop (didn't bet)
Seat 6: ydoFOVgzvZv9ZhuWu9rXAw folded before Flop (didn't bet)
Seat 7: dfNim92Z6XK1/h5SFW5vDg folded before Flop (didn't bet)
Seat 8: Z9AeOQX3yzuSvKAm/xyovg folded before Flop (didn't bet)
Seat 9: 1S/fpm+f42V/6MNZre+ccg (button) folded before Flop (didn't bet)




PokerStars Game #59939500516:  Hold'em No Limit ($0.10/$0.25) - 2009/07/01 0:41:30 ET
Table 'edvgY2YQ1I34euq4EVqGnA' 6-max Seat #3 is the button
Seat 1: mvFHK3pE7tCxJEqLjKC70Q ($26.90 in chips) 
Seat 2: 0vuFCuW1P8y6cFZZvuXNPg ($12.20 in chips) 
Seat 3: HjESR5/RHWT5gaSbIVQQ0Q ($17.75 in chips) 
Seat 4: JFIAqU8lCZ0vWwEl4bdGsg ($29.35 in chips) 
Seat 5: EE16Ua5b1HSsYej5zeXOlA ($25.60 in chips) 
Seat 6: kG34n23qFQA3nzdOJTQ1dA ($68.60 in chips) 
JFIAqU8lCZ0vWwEl4bdGsg: posts small blind $0.10
EE16Ua5b1HSsYej5zeXOlA: posts big blind $0.25
*** HOLE CARDS ***
kG34n23qFQA3nzdOJTQ1dA: folds 
mvFHK3pE7tCxJEqLjKC70Q: folds 
0vuFCuW1P8y6cFZZvuXNPg is disconnected 
0vuFCuW1P8y6cFZZvuXNPg is connected 
0vuFCuW1P8y6cFZZvuXNPg: folds 
HjESR5/RHWT5gaSbIVQQ0Q: folds 
JFIAqU8lCZ0vWwEl4bdGsg: raises $0.60 to $0.85
EE16Ua5b1HSsYej5zeXOlA: folds 
Uncalled bet ($0.60) returned to JFIAqU8lCZ0vWwEl4bdGsg
JFIAqU8lCZ0vWwEl4bdGsg collected $0.50 from pot
JFIAqU8lCZ0vWwEl4bdGsg: doesn't show hand 
*** SUMMARY ***
Total pot $0.50 | Rake $0 
Seat 1: mvFHK3pE7tCxJEqLjKC70Q folded before Flop (didn't bet)
Seat 2: 0vuFCuW1P8y6cFZZvuXNPg folded before Flop (didn't bet)
Seat 3: HjESR5/RHWT5gaSbIVQQ0Q (button) folded before Flop (didn't bet)
Seat 4: JFIAqU8lCZ0vWwEl4bdGsg (small blind) collected ($0.50)
Seat 5: EE16Ua5b1HSsYej5zeXOlA (big blind) folded before Flop
Seat 6: kG34n23qFQA3nzdOJTQ1dA folded before Flop (didn't bet)




PokerStars Game #59939501170:  Hold'em No Limit ($0.10/$0.25) - 2009/07/01 0:41:31 ET
Table '5VWnrlxdjwVfMWkVS2WE7A' 6-max Seat #5 is the button
Seat 1: BiLBinPhgpKAYzLgKJVU5A ($21.95 in chips) 
Seat 2: ELW+DKizJhLK7k40PMkD2Q ($27.70 in chips) 
Seat 3: cPO/1/dTcZpLkQFm3jH3Rg ($25 in chips) 
Seat 4: WZv4aSGl7ETtI/Z5BPKi7w ($27.90 in chips) 
Seat 5: JQZew0FjzS19kTjeNtrE+A ($43.30 in chips) 
Seat 6: LtASJ9OlkqGrrUKGQlpGAw ($20.50 in chips) 
LtASJ9OlkqGrrUKGQlpGAw: posts small blind $0.10
BiLBinPhgpKAYzLgKJVU5A: posts big blind $0.25
*** HOLE CARDS ***
ELW+DKizJhLK7k40PMkD2Q: folds 
cPO/1/dTcZpLkQFm3jH3Rg: folds 
WZv4aSGl7ETtI/Z5BPKi7w: calls $0.25
JQZew0FjzS19kTjeNtrE+A: calls $0.25
LtASJ9OlkqGrrUKGQlpGAw: folds 
BiLBinPhgpKAYzLgKJVU5A: checks 
*** FLOP *** [Qc Jc 9s]
BiLBinPhgpKAYzLgKJVU5A: checks 
WZv4aSGl7ETtI/Z5BPKi7w: checks 
JQZew0FjzS19kTjeNtrE+A: bets $0.75
BiLBinPhgpKAYzLgKJVU5A: folds 
WZv4aSGl7ETtI/Z5BPKi7w: calls $0.75
*** TURN *** [Qc Jc 9s] [Td]
WZv4aSGl7ETtI/Z5BPKi7w: checks 
JQZew0FjzS19kTjeNtrE+A: checks 
*** RIVER *** [Qc Jc 9s Td] [2h]
WZv4aSGl7ETtI/Z5BPKi7w: bets $1
JQZew0FjzS19kTjeNtrE+A: folds 
Uncalled bet ($1) returned to WZv4aSGl7ETtI/Z5BPKi7w
WZv4aSGl7ETtI/Z5BPKi7w collected $2.25 from pot
WZv4aSGl7ETtI/Z5BPKi7w: doesn't show hand 
*** SUMMARY ***
Total pot $2.35 | Rake $0.10 
Board [Qc Jc 9s Td 2h]
Seat 1: BiLBinPhgpKAYzLgKJVU5A (big blind) folded on the Flop
Seat 2: ELW+DKizJhLK7k40PMkD2Q folded before Flop (didn't bet)
Seat 3: cPO/1/dTcZpLkQFm3jH3Rg folded before Flop (didn't bet)
Seat 4: WZv4aSGl7ETtI/Z5BPKi7w collected ($2.25)
Seat 5: JQZew0FjzS19kTjeNtrE+A (button) folded on the River
Seat 6: LtASJ9OlkqGrrUKGQlpGAw (small blind) folded before Flop




PokerStars Game #59939501244:  Hold'em No Limit ($0.10/$0.25) - 2009/07/01 0:41:31 ET
Table 'gkdjhbH1jaE3hwhPRIKMiQ' 6-max Seat #2 is the button
Seat 1: nc79pm0LZRdhncq55evVqA ($25 in chips) 
Seat 2: 1NNFfYMd5Hsphl/FYz9fNA ($33.30 in chips) 
Seat 3: kG34n23qFQA3nzdOJTQ1dA ($24.75 in chips) 
Seat 5: Ew/TYPQIsbQ2X8nm5iAJBg ($24.90 in chips) 
Seat 6: wqphQtauX5Qn7WRJZS1flA ($27.70 in chips) 
kG34n23qFQA3nzdOJTQ1dA: posts small blind $0.10
Ew/TYPQIsbQ2X8nm5iAJBg: posts big blind $0.25
*** HOLE CARDS ***
wqphQtauX5Qn7WRJZS1flA: folds 
nc79pm0LZRdhncq55evVqA: folds 
1NNFfYMd5Hsphl/FYz9fNA: raises $0.50 to $0.75
kG34n23qFQA3nzdOJTQ1dA: folds 
Ew/TYPQIsbQ2X8nm5iAJBg: folds 
Uncalled bet ($0.50) returned to 1NNFfYMd5Hsphl/FYz9fNA
1NNFfYMd5Hsphl/FYz9fNA collected $0.60 from pot
1NNFfYMd5Hsphl/FYz9fNA: doesn't show hand 
*** SUMMARY ***
Total pot $0.60 | Rake $0 
Seat 1: nc79pm0LZRdhncq55evVqA folded before Flop (didn't bet)
Seat 2: 1NNFfYMd5Hsphl/FYz9fNA (button) collected ($0.60)
Seat 3: kG34n23qFQA3nzdOJTQ1dA (small blind) folded before Flop
Seat 5: Ew/TYPQIsbQ2X8nm5iAJBg (big blind) folded before Flop
Seat 6: wqphQtauX5Qn7WRJZS1flA folded before Flop (didn't bet)




PokerStars Game #59939501438:  Hold'em No Limit ($0.10/$0.25) - 2009/07/01 0:41:31 ET
Table 'VuY5ej47Cy8nOI3Wogmhzw' 6-max Seat #1 is the button
Seat 1: aXzmR7FhrqQSWNNmNfbVnw ($19.85 in chips) 
Seat 4: FC6tJ9EOiutXO8hnpR4VgQ ($6.65 in chips) 
Seat 6: +v0nBUereMsRzYp2Knh/cQ ($12.90 in chips) 
FC6tJ9EOiutXO8hnpR4VgQ: posts small blind $0.10
+v0nBUereMsRzYp2Knh/cQ: posts big blind $0.25
*** HOLE CARDS ***
aXzmR7FhrqQSWNNmNfbVnw: calls $0.25
FC6tJ9EOiutXO8hnpR4VgQ: raises $0.75 to $1
+v0nBUereMsRzYp2Knh/cQ: calls $0.75
aXzmR7FhrqQSWNNmNfbVnw: folds 
*** FLOP *** [5s Td Th]
FC6tJ9EOiutXO8hnpR4VgQ: checks 
+v0nBUereMsRzYp2Knh/cQ: checks 
*** TURN *** [5s Td Th] [9c]
FC6tJ9EOiutXO8hnpR4VgQ: bets $0.50
+v0nBUereMsRzYp2Knh/cQ: calls $0.50
*** RIVER *** [5s Td Th 9c] [3s]
FC6tJ9EOiutXO8hnpR4VgQ: bets $1.25
+v0nBUereMsRzYp2Knh/cQ: calls $1.25
*** SHOW DOWN ***
FC6tJ9EOiutXO8hnpR4VgQ: shows [As 2s] (a pair of Tens)
+v0nBUereMsRzYp2Knh/cQ: shows [7c 7d] (two pair, Tens and Sevens)
+v0nBUereMsRzYp2Knh/cQ collected $5.50 from pot
*** SUMMARY ***
Total pot $5.75 | Rake $0.25 
Board [5s Td Th 9c 3s]
Seat 1: aXzmR7FhrqQSWNNmNfbVnw (button) folded before Flop
Seat 4: FC6tJ9EOiutXO8hnpR4VgQ (small blind) showed [As 2s] and lost with a pair of Tens
Seat 6: +v0nBUereMsRzYp2Knh/cQ (big blind) showed [7c 7d] and won ($5.50) with two pair, Tens and Sevens




PokerStars Game #59939501708:  Hold'em No Limit ($0.10/$0.25) - 2009/07/01 0:41:31 ET
Table 'wixGE3Zge1qBdnpWijIl/w' 9-max Seat #5 is the button
Seat 1: EcWpc/mcsCWBGKsSdZaXbA ($24.65 in chips) 
Seat 2: vbD+Kd6m/X3hUBBcGpUKjA ($7.85 in chips) 
Seat 3: DdPXdieucQ+n99u1n3A+rQ ($4.65 in chips) 
Seat 4: 4oA316mXLIui1QY63GXBUg ($25 in chips) 
Seat 5: MIVCHqCqqlke0Lb0z7glcw ($37.90 in chips) 
Seat 6: TlEYI/zXzaKGGsmuvWFd2A ($5.90 in chips) 
Seat 7: qIaaweMCAGmy9HZFT4r/6A ($54.90 in chips) 
Seat 8: hIss79a4pu7GzJZepfgOpg ($25 in chips) 
Seat 9: r6hsffOo1iKmaPYKwAZmFw ($25.75 in chips) 
TlEYI/zXzaKGGsmuvWFd2A: posts small blind $0.10
qIaaweMCAGmy9HZFT4r/6A: posts big blind $0.25
*** HOLE CARDS ***
hIss79a4pu7GzJZepfgOpg: folds 
r6hsffOo1iKmaPYKwAZmFw: folds 
EcWpc/mcsCWBGKsSdZaXbA: folds 
vbD+Kd6m/X3hUBBcGpUKjA: folds 
DdPXdieucQ+n99u1n3A+rQ: folds 
4oA316mXLIui1QY63GXBUg: folds 
MIVCHqCqqlke0Lb0z7glcw: raises $0.50 to $0.75
TlEYI/zXzaKGGsmuvWFd2A: raises $5.15 to $5.90 and is all-in
qIaaweMCAGmy9HZFT4r/6A: folds 
MIVCHqCqqlke0Lb0z7glcw: calls $5.15
*** FLOP *** [4c Td 9h]
*** TURN *** [4c Td 9h] [2s]
*** RIVER *** [4c Td 9h 2s] [Js]
*** SHOW DOWN ***
TlEYI/zXzaKGGsmuvWFd2A: shows [Ks Qh] (a straight, Nine to King)
MIVCHqCqqlke0Lb0z7glcw: mucks hand 
TlEYI/zXzaKGGsmuvWFd2A collected $11.45 from pot
*** SUMMARY ***
Total pot $12.05 | Rake $0.60 
Board [4c Td 9h 2s Js]
Seat 1: EcWpc/mcsCWBGKsSdZaXbA folded before Flop (didn't bet)
Seat 2: vbD+Kd6m/X3hUBBcGpUKjA folded before Flop (didn't bet)
Seat 3: DdPXdieucQ+n99u1n3A+rQ folded before Flop (didn't bet)
Seat 4: 4oA316mXLIui1QY63GXBUg folded before Flop (didn't bet)
Seat 5: MIVCHqCqqlke0Lb0z7glcw (button) mucked
Seat 6: TlEYI/zXzaKGGsmuvWFd2A (small blind) showed [Ks Qh] and won ($11.45) with a straight, Nine to King
Seat 7: qIaaweMCAGmy9HZFT4r/6A (big blind) folded before Flop
Seat 8: hIss79a4pu7GzJZepfgOpg folded before Flop (didn't bet)
Seat 9: r6hsffOo1iKmaPYKwAZmFw folded before Flop (didn't bet)




PokerStars Game #59939501352:  Hold'em No Limit ($0.10/$0.25) - 2009/07/01 0:41:31 ET
Table 'pgrBYaOEx/BuqK5iAtlFzw' 9-max Seat #4 is the button
Seat 1: QsLvCwfSWqP+CfjwUnjpXQ ($17.40 in chips) 
Seat 4: 6meFEBwAfXU5eLC35rA/sw ($5 in chips) 
Seat 5: efYVL4adq0ufQFnZCpL5Tw ($10.95 in chips) 
Seat 6: OqlfFV+MkgflYrm4Q6rLMA ($4.50 in chips) 
efYVL4adq0ufQFnZCpL5Tw: posts small blind $0.10
OqlfFV+MkgflYrm4Q6rLMA: posts big blind $0.25
jXz58rvCgq0VjyVjUBf2mw: sits out 
*** HOLE CARDS ***
QsLvCwfSWqP+CfjwUnjpXQ: calls $0.25
6meFEBwAfXU5eLC35rA/sw: calls $0.25
efYVL4adq0ufQFnZCpL5Tw: calls $0.15
OqlfFV+MkgflYrm4Q6rLMA: checks 
*** FLOP *** [4d Qc 3s]
efYVL4adq0ufQFnZCpL5Tw: checks 
OqlfFV+MkgflYrm4Q6rLMA: checks 
QsLvCwfSWqP+CfjwUnjpXQ: checks 
6meFEBwAfXU5eLC35rA/sw: checks 
*** TURN *** [4d Qc 3s] [8s]
efYVL4adq0ufQFnZCpL5Tw: checks 
OqlfFV+MkgflYrm4Q6rLMA: checks 
QsLvCwfSWqP+CfjwUnjpXQ: checks 
cFmpjvcjNoVAEAIQIxWkYg joins the table at seat #8 
6meFEBwAfXU5eLC35rA/sw: checks 
*** RIVER *** [4d Qc 3s 8s] [6s]
efYVL4adq0ufQFnZCpL5Tw: checks 
OqlfFV+MkgflYrm4Q6rLMA: bets $0.25
SIMMYD1 joins the table at seat #3 
QsLvCwfSWqP+CfjwUnjpXQ: folds 
6meFEBwAfXU5eLC35rA/sw: calls $0.25
efYVL4adq0ufQFnZCpL5Tw: folds 
*** SHOW DOWN ***
OqlfFV+MkgflYrm4Q6rLMA: shows [6c 2c] (a pair of Sixes)
6meFEBwAfXU5eLC35rA/sw: shows [Th 8c] (a pair of Eights)
6meFEBwAfXU5eLC35rA/sw collected $1.45 from pot
*** SUMMARY ***
Total pot $1.50 | Rake $0.05 
Board [4d Qc 3s 8s 6s]
Seat 1: QsLvCwfSWqP+CfjwUnjpXQ folded on the River
Seat 4: 6meFEBwAfXU5eLC35rA/sw (button) showed [Th 8c] and won ($1.45) with a pair of Eights
Seat 5: efYVL4adq0ufQFnZCpL5Tw (small blind) folded on the River
Seat 6: OqlfFV+MkgflYrm4Q6rLMA (big blind) showed [6c 2c] and lost with a pair of Sixes




PokerStars Game #59939502388:  Hold'em No Limit ($0.10/$0.25) - 2009/07/01 0:41:32 ET
Table '/VaaaFnlEJoYVomG9uxHkA' 9-max Seat #7 is the button
Seat 2: DIkeSkosO/tsUp9d2JVyTA ($9.10 in chips) 
Seat 3: 32P5dKDi4pEUiDHMQTV1uw ($23.25 in chips) 
Seat 4: j4q3p0lesp63b1gZDwLBZw ($5 in chips) 
Seat 5: LWN1wPrLH+695JIriXxDuw ($24.20 in chips) 
Seat 6: 5MgYq10OC5iGoxQFwlJVuw ($14.45 in chips) 
Seat 7: PjjWswkn2akmg6ArntxvuA ($33.95 in chips) 
Seat 8: n9toqYXSLowQ/sWq842dEQ ($3.50 in chips) 
Seat 9: r1pFKMwWp74QwhfPWJOAyw ($5.80 in chips) 
n9toqYXSLowQ/sWq842dEQ: posts small blind $0.10
r1pFKMwWp74QwhfPWJOAyw: posts big blind $0.25
*** HOLE CARDS ***
DIkeSkosO/tsUp9d2JVyTA: calls $0.25
32P5dKDi4pEUiDHMQTV1uw: folds 
j4q3p0lesp63b1gZDwLBZw: folds 
LWN1wPrLH+695JIriXxDuw: folds 
5MgYq10OC5iGoxQFwlJVuw: folds 
PjjWswkn2akmg6ArntxvuA: raises $0.25 to $0.50
n9toqYXSLowQ/sWq842dEQ: folds 
r1pFKMwWp74QwhfPWJOAyw: calls $0.25
DIkeSkosO/tsUp9d2JVyTA: calls $0.25
*** FLOP *** [Ks Jh Kh]
r1pFKMwWp74QwhfPWJOAyw: checks 
DIkeSkosO/tsUp9d2JVyTA: bets $0.50
inanimateone has returned
PjjWswkn2akmg6ArntxvuA: raises $0.50 to $1
r1pFKMwWp74QwhfPWJOAyw: folds 
DIkeSkosO/tsUp9d2JVyTA: calls $0.50
*** TURN *** [Ks Jh Kh] [2c]
DIkeSkosO/tsUp9d2JVyTA: checks 
PjjWswkn2akmg6ArntxvuA: bets $1.50
DIkeSkosO/tsUp9d2JVyTA: calls $1.50
*** RIVER *** [Ks Jh Kh 2c] [8c]
DIkeSkosO/tsUp9d2JVyTA: checks 
PjjWswkn2akmg6ArntxvuA: bets $5.25
DIkeSkosO/tsUp9d2JVyTA: folds 
Uncalled bet ($5.25) returned to PjjWswkn2akmg6ArntxvuA
PjjWswkn2akmg6ArntxvuA collected $6.30 from pot
PjjWswkn2akmg6ArntxvuA: doesn't show hand 
*** SUMMARY ***
Total pot $6.60 | Rake $0.30 
Board [Ks Jh Kh 2c 8c]
Seat 2: DIkeSkosO/tsUp9d2JVyTA folded on the River
Seat 3: 32P5dKDi4pEUiDHMQTV1uw folded before Flop (didn't bet)
Seat 4: j4q3p0lesp63b1gZDwLBZw folded before Flop (didn't bet)
Seat 5: LWN1wPrLH+695JIriXxDuw folded before Flop (didn't bet)
Seat 6: 5MgYq10OC5iGoxQFwlJVuw folded before Flop (didn't bet)
Seat 7: PjjWswkn2akmg6ArntxvuA (button) collected ($6.30)
Seat 8: n9toqYXSLowQ/sWq842dEQ (small blind) folded before Flop
Seat 9: r1pFKMwWp74QwhfPWJOAyw (big blind) folded on the Flop




PokerStars Game #59939501934:  Hold'em No Limit ($0.10/$0.25) - 2009/07/01 0:41:32 ET
Table '1HT8bEDpLPhOXxmqMtzF8w' 9-max Seat #4 is the button
Seat 1: s7Q6uNouhe7aE8JdFb9E+A ($26.20 in chips) 
Seat 2: r6hsffOo1iKmaPYKwAZmFw ($30.90 in chips) 
Seat 3: UJbH2fMMSFUo/jbJteWjjQ ($4.75 in chips) 
Seat 4: Hlc+zGHlRwk7JHfQklkT2g ($15.55 in chips) 
Seat 6: 4oA316mXLIui1QY63GXBUg ($25 in chips) 
Seat 7: DIBbjEYGs+TVdVgEB/4+3w ($30.35 in chips) 
Seat 8: ghNKXUBl/H+t83JF079ZBA ($25 in chips) 
Seat 9: 86vbuhJsyH+nbEg5qpDLyQ ($21.50 in chips) 
4oA316mXLIui1QY63GXBUg: posts small blind $0.10
DIBbjEYGs+TVdVgEB/4+3w: posts big blind $0.25
*** HOLE CARDS ***
ghNKXUBl/H+t83JF079ZBA: folds 
86vbuhJsyH+nbEg5qpDLyQ: folds 
+iRmxp/CsJ/zuqdUG3CXNw has returned
s7Q6uNouhe7aE8JdFb9E+A: folds 
r6hsffOo1iKmaPYKwAZmFw: raises $0.75 to $1
UJbH2fMMSFUo/jbJteWjjQ: folds 
Hlc+zGHlRwk7JHfQklkT2g: folds 
4oA316mXLIui1QY63GXBUg: folds 
DIBbjEYGs+TVdVgEB/4+3w: folds 
Uncalled bet ($0.75) returned to r6hsffOo1iKmaPYKwAZmFw
r6hsffOo1iKmaPYKwAZmFw collected $0.60 from pot
r6hsffOo1iKmaPYKwAZmFw: doesn't show hand 
*** SUMMARY ***
Total pot $0.60 | Rake $0 
Seat 1: s7Q6uNouhe7aE8JdFb9E+A folded before Flop (didn't bet)
Seat 2: r6hsffOo1iKmaPYKwAZmFw collected ($0.60)
Seat 3: UJbH2fMMSFUo/jbJteWjjQ folded before Flop (didn't bet)
Seat 4: Hlc+zGHlRwk7JHfQklkT2g (button) folded before Flop (didn't bet)
Seat 6: 4oA316mXLIui1QY63GXBUg (small blind) folded before Flop
Seat 7: DIBbjEYGs+TVdVgEB/4+3w (big blind) folded before Flop
Seat 8: ghNKXUBl/H+t83JF079ZBA folded before Flop (didn't bet)
Seat 9: 86vbuhJsyH+nbEg5qpDLyQ folded before Flop (didn't bet)




PokerStars Game #59939502118:  Hold'em No Limit ($0.10/$0.25) - 2009/07/01 0:41:32 ET
Table 'aisAlB9GIV21BwfUW3+Nbg' 9-max Seat #8 is the button
Seat 1: H5Se03ZqSX7tbULXur2MAg ($27.80 in chips) 
Seat 2: 18G4P1XstjNvItdGUITxgw ($25 in chips) 
Seat 3: aaNpjkDAbOD7pVe8Z5CEgQ ($24 in chips) 
Seat 4: Z9AeOQX3yzuSvKAm/xyovg ($10 in chips) 
Seat 5: ghNKXUBl/H+t83JF079ZBA ($25 in chips) 
Seat 6: 9gmYYQesalMrUjaF7nKfrQ ($9.65 in chips) 
Seat 7: sWBBy1WroEskLNyJzhkUag ($9.25 in chips) 
Seat 8: VWUWpMLMj/Q1jRVpF7Aohw ($14.05 in chips) 
Seat 9: OlPJsgR4xypSg/w1z7Gyvw ($28.40 in chips) 
OlPJsgR4xypSg/w1z7Gyvw: posts small blind $0.10
H5Se03ZqSX7tbULXur2MAg: posts big blind $0.25
*** HOLE CARDS ***
18G4P1XstjNvItdGUITxgw: folds 
aaNpjkDAbOD7pVe8Z5CEgQ: calls $0.25
Z9AeOQX3yzuSvKAm/xyovg: raises $0.75 to $1
ghNKXUBl/H+t83JF079ZBA: folds 
9gmYYQesalMrUjaF7nKfrQ: folds 
sWBBy1WroEskLNyJzhkUag: folds 
VWUWpMLMj/Q1jRVpF7Aohw: folds 
OlPJsgR4xypSg/w1z7Gyvw: folds 
H5Se03ZqSX7tbULXur2MAg: folds 
aaNpjkDAbOD7pVe8Z5CEgQ: calls $0.75
*** FLOP *** [9h 6c 7c]
aaNpjkDAbOD7pVe8Z5CEgQ: checks 
Z9AeOQX3yzuSvKAm/xyovg: bets $2.25
aaNpjkDAbOD7pVe8Z5CEgQ: folds 
Uncalled bet ($2.25) returned to Z9AeOQX3yzuSvKAm/xyovg
Z9AeOQX3yzuSvKAm/xyovg collected $2.25 from pot
*** SUMMARY ***
Total pot $2.35 | Rake $0.10 
Board [9h 6c 7c]
Seat 1: H5Se03ZqSX7tbULXur2MAg (big blind) folded before Flop
Seat 2: 18G4P1XstjNvItdGUITxgw folded before Flop (didn't bet)
Seat 3: aaNpjkDAbOD7pVe8Z5CEgQ folded on the Flop
Seat 4: Z9AeOQX3yzuSvKAm/xyovg collected ($2.25)
Seat 5: ghNKXUBl/H+t83JF079ZBA folded before Flop (didn't bet)
Seat 6: 9gmYYQesalMrUjaF7nKfrQ folded before Flop (didn't bet)
Seat 7: sWBBy1WroEskLNyJzhkUag folded before Flop (didn't bet)
Seat 8: VWUWpMLMj/Q1jRVpF7Aohw (button) folded before Flop (didn't bet)
Seat 9: OlPJsgR4xypSg/w1z7Gyvw (small blind) folded before Flop




PokerStars Game #59939501912:  Hold'em No Limit ($0.10/$0.25) - 2009/07/01 0:41:32 ET
Table 'I0ZcuiUTeLuGYv26Nah7YA' 9-max Seat #2 is the button
Seat 1: iMiqaPr7dx84UF0wNUeh8A ($19.70 in chips) 
Seat 2: zE0IkNrJoJD964o4eqmCxQ ($2.10 in chips) 
Seat 3: 1S/fpm+f42V/6MNZre+ccg ($26.95 in chips) 
Seat 4: 4awUyiDYTgylQKXZ9faBVA ($30.25 in chips) 
Seat 5: opOCI2p6kW0tINuVaAqmcQ ($44.25 in chips) 
Seat 6: JRV2PblFtPFz51l0Fwyz8g ($24.75 in chips) 
Seat 7: JxpnpCmvRAcrEUy7mq1iAg ($6.10 in chips) 
Seat 8: ijc1q+bpPQR12wxc0sWc4w ($14.25 in chips) 
Seat 9: 2mQl0jr5DPlr6jqhvCq8Xw ($10.15 in chips) 
1S/fpm+f42V/6MNZre+ccg: posts small blind $0.10
4awUyiDYTgylQKXZ9faBVA: posts big blind $0.25
*** HOLE CARDS ***
opOCI2p6kW0tINuVaAqmcQ: folds 
JRV2PblFtPFz51l0Fwyz8g: folds 
JxpnpCmvRAcrEUy7mq1iAg: folds 
ijc1q+bpPQR12wxc0sWc4w: folds 
2mQl0jr5DPlr6jqhvCq8Xw: folds 
iMiqaPr7dx84UF0wNUeh8A: folds 
zE0IkNrJoJD964o4eqmCxQ said, "sure...whatever"
zE0IkNrJoJD964o4eqmCxQ: raises $1.85 to $2.10 and is all-in
1S/fpm+f42V/6MNZre+ccg: folds 
4awUyiDYTgylQKXZ9faBVA: calls $1.85
*** FLOP *** [4s 2s 5d]
*** TURN *** [4s 2s 5d] [Td]
*** RIVER *** [4s 2s 5d Td] [Qh]
*** SHOW DOWN ***
4awUyiDYTgylQKXZ9faBVA: shows [Ac 9c] (high card Ace)
zE0IkNrJoJD964o4eqmCxQ: shows [3s Ad] (a straight, Ace to Five)
zE0IkNrJoJD964o4eqmCxQ collected $4.10 from pot
*** SUMMARY ***
Total pot $4.30 | Rake $0.20 
Board [4s 2s 5d Td Qh]
Seat 1: iMiqaPr7dx84UF0wNUeh8A folded before Flop (didn't bet)
Seat 2: zE0IkNrJoJD964o4eqmCxQ (button) showed [3s Ad] and won ($4.10) with a straight, Ace to Five
Seat 3: 1S/fpm+f42V/6MNZre+ccg (small blind) folded before Flop
Seat 4: 4awUyiDYTgylQKXZ9faBVA (big blind) showed [Ac 9c] and lost with high card Ace
Seat 5: opOCI2p6kW0tINuVaAqmcQ folded before Flop (didn't bet)
Seat 6: JRV2PblFtPFz51l0Fwyz8g folded before Flop (didn't bet)
Seat 7: JxpnpCmvRAcrEUy7mq1iAg folded before Flop (didn't bet)
Seat 8: ijc1q+bpPQR12wxc0sWc4w folded before Flop (didn't bet)
Seat 9: 2mQl0jr5DPlr6jqhvCq8Xw folded before Flop (didn't bet)




PokerStars Game #59939501870:  Hold'em No Limit ($0.10/$0.25) - 2009/07/01 0:41:32 ET
Table '8kaMIn+aON/ferW89Go6Pw' 9-max Seat #7 is the button
Seat 1: st9jtdNbm1W5GfBwRaCVqQ ($29.90 in chips) 
Seat 2: jeKWRUkMaVn8rEUjnJKqpg ($25 in chips) 
Seat 3: 7cv+9Zc9HIQHNvYsMfV3uA ($27.95 in chips) 
Seat 4: KRWTiGM4xH+MkvPtJz4+SA ($44.70 in chips) 
Seat 5: hIss79a4pu7GzJZepfgOpg ($31.35 in chips) 
Seat 6: 1S/fpm+f42V/6MNZre+ccg ($25 in chips) 
Seat 7: HVKi9hnDyvzObpL08/OarQ ($21.90 in chips) 
Seat 8: f7p49X29YgYZCOxWxJo6Lw ($6.80 in chips) 
Seat 9: DiSvPC2iudwL5j9u6Huyww ($25.35 in chips) 
f7p49X29YgYZCOxWxJo6Lw: posts small blind $0.10
DiSvPC2iudwL5j9u6Huyww: posts big blind $0.25
*** HOLE CARDS ***
st9jtdNbm1W5GfBwRaCVqQ: folds 
jeKWRUkMaVn8rEUjnJKqpg: calls $0.25
7cv+9Zc9HIQHNvYsMfV3uA: folds 
KRWTiGM4xH+MkvPtJz4+SA: folds 
hIss79a4pu7GzJZepfgOpg: folds 
1S/fpm+f42V/6MNZre+ccg: folds 
HVKi9hnDyvzObpL08/OarQ: folds 
f7p49X29YgYZCOxWxJo6Lw: calls $0.15
DiSvPC2iudwL5j9u6Huyww: checks 
*** FLOP *** [9c 2c 8c]
f7p49X29YgYZCOxWxJo6Lw: checks 
DiSvPC2iudwL5j9u6Huyww: checks 
jeKWRUkMaVn8rEUjnJKqpg: checks 
*** TURN *** [9c 2c 8c] [4h]
f7p49X29YgYZCOxWxJo6Lw: checks 
DiSvPC2iudwL5j9u6Huyww: checks 
jeKWRUkMaVn8rEUjnJKqpg: checks 
*** RIVER *** [9c 2c 8c 4h] [6s]
f7p49X29YgYZCOxWxJo6Lw: checks 
DiSvPC2iudwL5j9u6Huyww: checks 
jeKWRUkMaVn8rEUjnJKqpg: checks 
*** SHOW DOWN ***
f7p49X29YgYZCOxWxJo6Lw: shows [7c 4s] (a pair of Fours)
DiSvPC2iudwL5j9u6Huyww: mucks hand 
jeKWRUkMaVn8rEUjnJKqpg: shows [Kd 6d] (a pair of Sixes)
jeKWRUkMaVn8rEUjnJKqpg collected $0.75 from pot
*** SUMMARY ***
Total pot $0.75 | Rake $0 
Board [9c 2c 8c 4h 6s]
Seat 1: st9jtdNbm1W5GfBwRaCVqQ folded before Flop (didn't bet)
Seat 2: jeKWRUkMaVn8rEUjnJKqpg showed [Kd 6d] and won ($0.75) with a pair of Sixes
Seat 3: 7cv+9Zc9HIQHNvYsMfV3uA folded before Flop (didn't bet)
Seat 4: KRWTiGM4xH+MkvPtJz4+SA folded before Flop (didn't bet)
Seat 5: hIss79a4pu7GzJZepfgOpg folded before Flop (didn't bet)
Seat 6: 1S/fpm+f42V/6MNZre+ccg folded before Flop (didn't bet)
Seat 7: HVKi9hnDyvzObpL08/OarQ (button) folded before Flop (didn't bet)
Seat 8: f7p49X29YgYZCOxWxJo6Lw (small blind) showed [7c 4s] and lost with a pair of Fours
Seat 9: DiSvPC2iudwL5j9u6Huyww (big blind) mucked




PokerStars Game #59939502112:  Hold'em No Limit ($0.10/$0.25) - 2009/07/01 0:41:32 ET
Table 'nc6OeGk/wtaWV+6N+kgnZQ' 6-max Seat #1 is the button
Seat 1: 0/FYfBoKhINaqU/H5OSS1A ($2.50 in chips) 
Seat 3: 8f0dtuUGqDbgE6up1lQAlg ($3.70 in chips) 
Seat 6: yJgjVkWgiJ8vdWZjcUod2A ($8.40 in chips) 
8f0dtuUGqDbgE6up1lQAlg: posts small blind $0.10
yJgjVkWgiJ8vdWZjcUod2A: posts big blind $0.25
*** HOLE CARDS ***
0/FYfBoKhINaqU/H5OSS1A: calls $0.25
8f0dtuUGqDbgE6up1lQAlg: calls $0.15
yJgjVkWgiJ8vdWZjcUod2A: checks 
*** FLOP *** [Tc 2c Qd]
8f0dtuUGqDbgE6up1lQAlg: checks 
yJgjVkWgiJ8vdWZjcUod2A: checks 
0/FYfBoKhINaqU/H5OSS1A: checks 
*** TURN *** [Tc 2c Qd] [Ad]
8f0dtuUGqDbgE6up1lQAlg: checks 
yJgjVkWgiJ8vdWZjcUod2A: checks 
0/FYfBoKhINaqU/H5OSS1A: checks 
*** RIVER *** [Tc 2c Qd Ad] [Qc]
8f0dtuUGqDbgE6up1lQAlg: checks 
yJgjVkWgiJ8vdWZjcUod2A: bets $0.50
0/FYfBoKhINaqU/H5OSS1A: folds 
8f0dtuUGqDbgE6up1lQAlg: folds 
Uncalled bet ($0.50) returned to yJgjVkWgiJ8vdWZjcUod2A
yJgjVkWgiJ8vdWZjcUod2A collected $0.75 from pot
*** SUMMARY ***
Total pot $0.75 | Rake $0 
Board [Tc 2c Qd Ad Qc]
Seat 1: 0/FYfBoKhINaqU/H5OSS1A (button) folded on the River
Seat 3: 8f0dtuUGqDbgE6up1lQAlg (small blind) folded on the River
Seat 6: yJgjVkWgiJ8vdWZjcUod2A (big blind) collected ($0.75)




PokerStars Game #59939502372:  Hold'em No Limit ($0.10/$0.25) - 2009/07/01 0:41:32 ET
Table 'MJ1SB76A4qJrlEa+C5e/8w' 6-max Seat #5 is the button
Seat 2: UA5OsKS3VPaxa7uC8La/kA ($29.25 in chips) 
Seat 3: IrrSNlaIjHnZjG6E7LgmEg ($15.15 in chips) 
Seat 4: 6boOPJDTFiEyZD2WdW0kCA ($14.15 in chips) 
Seat 5: eHsmIvAb2JREg4O6hNPnXg ($7.90 in chips) 
Seat 6: JFIAqU8lCZ0vWwEl4bdGsg ($27.50 in chips) 
JFIAqU8lCZ0vWwEl4bdGsg: posts small blind $0.10
UA5OsKS3VPaxa7uC8La/kA: posts big blind $0.25
*** HOLE CARDS ***
IrrSNlaIjHnZjG6E7LgmEg: calls $0.25
6boOPJDTFiEyZD2WdW0kCA: raises $0.75 to $1
eHsmIvAb2JREg4O6hNPnXg: folds 
JFIAqU8lCZ0vWwEl4bdGsg: folds 
UA5OsKS3VPaxa7uC8La/kA: folds 
IrrSNlaIjHnZjG6E7LgmEg: calls $0.75
*** FLOP *** [6c Ac 9h]
IrrSNlaIjHnZjG6E7LgmEg: checks 
6boOPJDTFiEyZD2WdW0kCA: bets $1.50
IrrSNlaIjHnZjG6E7LgmEg: folds 
Uncalled bet ($1.50) returned to 6boOPJDTFiEyZD2WdW0kCA
6boOPJDTFiEyZD2WdW0kCA collected $2.25 from pot
6boOPJDTFiEyZD2WdW0kCA: doesn't show hand 
*** SUMMARY ***
Total pot $2.35 | Rake $0.10 
Board [6c Ac 9h]
Seat 2: UA5OsKS3VPaxa7uC8La/kA (big blind) folded before Flop
Seat 3: IrrSNlaIjHnZjG6E7LgmEg folded on the Flop
Seat 4: 6boOPJDTFiEyZD2WdW0kCA collected ($2.25)
Seat 5: eHsmIvAb2JREg4O6hNPnXg (button) folded before Flop (didn't bet)
Seat 6: JFIAqU8lCZ0vWwEl4bdGsg (small blind) folded before Flop




PokerStars Game #59939501834:  Hold'em No Limit ($0.10/$0.25) - 2009/07/01 0:41:32 ET
Table '6wawJ+MkkvuC3coG6r+YhgZiwAqg4o02gNro+JOAaFNgSeat #3 is the button
Seat 1: j4q3p0lesp63b1gZDwLBZw ($5.60 in chips) 
Seat 2: tYsOBqdU1+x+yFI7zHO7hQ ($31.10 in chips) 
Seat 3: aNpwfA31EREwO+ar4XzBCw ($25 in chips) 
Seat 4: FJflwqC6fqOpM3j0q8Bptw ($22.30 in chips) 
Seat 5: 5hAPbqNrvJb8PtLiceXtlg6HoFYfVGBefsR5Vrz62qIw5 in chips) 
Seat 6: hBMUlEpyU74r/fwDgIpXjQ ($27.95 in chips) 
Seat 9: ljemhp25Zg+nlA9DLCIiUw ($24.65 in chips) 
FJflwqC6fqOpM3j0q8Bptw: posts small blind $0.10
5hAPbqNrvJb8PtLiceXtlg6HoFYfVGBefsR5Vrz62qIwsts big blind $0.25
opOCI2p6kW0tINuVaAqmcQ: sits out 
*** HOLE CARDS ***
CYkY0dNBaYaKs8HVCVn3mQ has returned
hBMUlEpyU74r/fwDgIpXjQ: folds 
ljemhp25Zg+nlA9DLCIiUw: folds 
j4q3p0lesp63b1gZDwLBZw: folds 
tYsOBqdU1+x+yFI7zHO7hQ: folds 
aNpwfA31EREwO+ar4XzBCw: folds 
FJflwqC6fqOpM3j0q8Bptw: folds 
Uncalled bet ($0.15) returned to 5hAPbqNrvJb8PtLiceXtlg6HoFYfVGBefsR5Vrz62qIw5hAPbqNrvJb8PtLiceXtlg3011 collected $0.20 from pot
*** SUMMARY ***
Total pot $0.20 | Rake $0 
Seat 1: j4q3p0lesp63b1gZDwLBZw folded before Flop (didn't bet)
Seat 2: tYsOBqdU1+x+yFI7zHO7hQ folded before Flop (didn't bet)
Seat 3: aNpwfA31EREwO+ar4XzBCw (button) folded before Flop (didn't bet)
Seat 4: FJflwqC6fqOpM3j0q8Bptw (small blind) folded before Flop
Seat 5: 5hAPbqNrvJb8PtLiceXtlg6HoFYfVGBefsR5Vrz62qIwg blind) collected ($0.20)
Seat 6: hBMUlEpyU74r/fwDgIpXjQ folded before Flop (didn't bet)
Seat 9: ljemhp25Zg+nlA9DLCIiUw folded before Flop (didn't bet)




PokerStars Game #59939502052:  Hold'em No Limit ($0.10/$0.25) - 2009/07/01 0:41:32 ET
Table 'wPWRBZPJl1HAnysw7qRR0A' 6-max Seat #1 is the button
Seat 1: cPO/1/dTcZpLkQFm3jH3Rg ($49.25 in chips) 
Seat 2: 48oT5xFI+5CHUJlfoGrE4w ($7.80 in chips) 
Seat 3: gqW2aBCmrIw65BvwjTFN6Q ($25 in chips) 
Seat 4: kbpWbC+dJNBphHl1jtw7bw ($24.20 in chips) 
Seat 5: LtASJ9OlkqGrrUKGQlpGAw ($21.80 in chips) 
Seat 6: VLoE/jniCqHZuUkx8Esf6w ($27.05 in chips) 
48oT5xFI+5CHUJlfoGrE4w: posts small blind $0.10
gqW2aBCmrIw65BvwjTFN6Q: posts big blind $0.25
*** HOLE CARDS ***
kbpWbC+dJNBphHl1jtw7bw: calls $0.25
LtASJ9OlkqGrrUKGQlpGAw: calls $0.25
VLoE/jniCqHZuUkx8Esf6w: calls $0.25
cPO/1/dTcZpLkQFm3jH3Rg: folds 
48oT5xFI+5CHUJlfoGrE4w: folds 
gqW2aBCmrIw65BvwjTFN6Q: checks 
*** FLOP *** [Th 4h 3s]
gqW2aBCmrIw65BvwjTFN6Q: checks 
kbpWbC+dJNBphHl1jtw7bw: bets $0.75
LtASJ9OlkqGrrUKGQlpGAw: folds 
VLoE/jniCqHZuUkx8Esf6w: folds 
gqW2aBCmrIw65BvwjTFN6Q: folds 
Uncalled bet ($0.75) returned to kbpWbC+dJNBphHl1jtw7bw
kbpWbC+dJNBphHl1jtw7bw collected $1.05 from pot
kbpWbC+dJNBphHl1jtw7bw: doesn't show hand 
*** SUMMARY ***
Total pot $1.10 | Rake $0.05 
Board [Th 4h 3s]
Seat 1: cPO/1/dTcZpLkQFm3jH3Rg (button) folded before Flop (didn't bet)
Seat 2: 48oT5xFI+5CHUJlfoGrE4w (small blind) folded before Flop
Seat 3: gqW2aBCmrIw65BvwjTFN6Q (big blind) folded on the Flop
Seat 4: kbpWbC+dJNBphHl1jtw7bw collected ($1.05)
Seat 5: LtASJ9OlkqGrrUKGQlpGAw folded on the Flop
Seat 6: VLoE/jniCqHZuUkx8Esf6w folded on the Flop




PokerStars Game #59939502468:  Hold'em No Limit ($0.10/$0.25) - 2009/07/01 0:41:33 ET
Table '6wawJ+MkkvuC3coG6r+Yhg' 6-max Seat #3 is the button
Seat 1: ELW+DKizJhLK7k40PMkD2Q ($24.90 in chips) 
Seat 2: LtASJ9OlkqGrrUKGQlpGAw ($27.40 in chips) 
Seat 3: KYBwVA7jgmSrbIEbEGElVg ($16.60 in chips) 
Seat 4: cS21pIxRHx5Gt42o7hPZzw ($12.50 in chips) 
Seat 5: A8uIskXJTblhVXWuYr+lkw ($15.15 in chips) 
Seat 6: oOGZlBAhqtG/HczLL/KLRQ ($19.05 in chips) 
cS21pIxRHx5Gt42o7hPZzw: posts small blind $0.10
A8uIskXJTblhVXWuYr+lkw: posts big blind $0.25
*** HOLE CARDS ***
oOGZlBAhqtG/HczLL/KLRQ: folds 
ELW+DKizJhLK7k40PMkD2Q: folds 
LtASJ9OlkqGrrUKGQlpGAw: folds 
KYBwVA7jgmSrbIEbEGElVg: folds 
cS21pIxRHx5Gt42o7hPZzw: calls $0.15
A8uIskXJTblhVXWuYr+lkw: raises $0.25 to $0.50
cS21pIxRHx5Gt42o7hPZzw: calls $0.25
*** FLOP *** [4c 5h 2c]
cS21pIxRHx5Gt42o7hPZzw: checks 
A8uIskXJTblhVXWuYr+lkw: bets $0.25
cS21pIxRHx5Gt42o7hPZzw: folds 
Uncalled bet ($0.25) returned to A8uIskXJTblhVXWuYr+lkw
A8uIskXJTblhVXWuYr+lkw collected $0.95 from pot
*** SUMMARY ***
Total pot $1 | Rake $0.05 
Board [4c 5h 2c]
Seat 1: ELW+DKizJhLK7k40PMkD2Q folded before Flop (didn't bet)
Seat 2: LtASJ9OlkqGrrUKGQlpGAw folded before Flop (didn't bet)
Seat 3: KYBwVA7jgmSrbIEbEGElVg (button) folded before Flop (didn't bet)
Seat 4: cS21pIxRHx5Gt42o7hPZzw (small blind) folded on the Flop
Seat 5: A8uIskXJTblhVXWuYr+lkw (big blind) collected ($0.95)
Seat 6: oOGZlBAhqtG/HczLL/KLRQ folded before Flop (didn't bet)




PokerStars Game #59939502424:  Hold'em No Limit ($0.10/$0.25) - 2009/07/01 0:41:33 ET
Table 'a0kk1yz54EMczhut3KjrxQ' 6-max Seat #1 is the button
Seat 1: V3LJvbHVJHmOj2fd7zIDhA ($28.65 in chips) 
Seat 2: nc79pm0LZRdhncq55evVqA ($25 in chips) 
Seat 3: FabaCGPqGJLjRL48CMvjiQ ($23.25 in chips) 
Seat 4: FYepjhAvF8ZdVCmqHIy+eQ ($27.70 in chips) 
Seat 5: cPO/1/dTcZpLkQFm3jH3Rg ($26.15 in chips) 
Seat 6: DTzxFTXVrCqrpjq9B9Vg/g ($15.05 in chips) 
nc79pm0LZRdhncq55evVqA: posts small blind $0.10
FabaCGPqGJLjRL48CMvjiQ: posts big blind $0.25
*** HOLE CARDS ***
FYepjhAvF8ZdVCmqHIy+eQ: folds 
cPO/1/dTcZpLkQFm3jH3Rg: folds 
DTzxFTXVrCqrpjq9B9Vg/g: calls $0.25
V3LJvbHVJHmOj2fd7zIDhA: folds 
nc79pm0LZRdhncq55evVqA: folds 
FabaCGPqGJLjRL48CMvjiQ: checks 
*** FLOP *** [Qd 4c Js]
FabaCGPqGJLjRL48CMvjiQ: bets $0.25
DTzxFTXVrCqrpjq9B9Vg/g: raises $0.25 to $0.50
FabaCGPqGJLjRL48CMvjiQ: folds 
Uncalled bet ($0.25) returned to DTzxFTXVrCqrpjq9B9Vg/g
DTzxFTXVrCqrpjq9B9Vg/g collected $1.05 from pot
*** SUMMARY ***
Total pot $1.10 | Rake $0.05 
Board [Qd 4c Js]
Seat 1: V3LJvbHVJHmOj2fd7zIDhA (button) folded before Flop (didn't bet)
Seat 2: nc79pm0LZRdhncq55evVqA (small blind) folded before Flop
Seat 3: FabaCGPqGJLjRL48CMvjiQ (big blind) folded on the Flop
Seat 4: FYepjhAvF8ZdVCmqHIy+eQ folded before Flop (didn't bet)
Seat 5: cPO/1/dTcZpLkQFm3jH3Rg folded before Flop (didn't bet)
Seat 6: DTzxFTXVrCqrpjq9B9Vg/g collected ($1.05)




PokerStars Game #59939502952:  Hold'em No Limit ($0.10/$0.25) - 2009/07/01 0:41:33 ET
Table 'IIO2q2znuuAXmiZ2qFTcmgiHlyuN1lFZ6WTlMBiiMYXAx Seat #3 is the button
Seat 2: R6nIVAjK7uhK3Hj0f85A+A ($29.10 in chips) 
Seat 3: QGjA4xtpxSpgzm+HC+ps4w ($21.75 in chips) 
Seat 4: z5GxcHlYz/GSz6W2uFiTtg ($24.25 in chips) 
Seat 6: M2QO2DxB5Wawg2h8HSpnYA ($13.95 in chips) 
Seat 7: gehe91e0IyVT0QU/XBkEyg ($33.50 in chips) 
Seat 8: TeWJxSETzbXGiYKx0y+dtg ($24.55 in chips) 
z5GxcHlYz/GSz6W2uFiTtg: posts small blind $0.10
M2QO2DxB5Wawg2h8HSpnYA: posts big blind $0.25
*** HOLE CARDS ***
gehe91e0IyVT0QU/XBkEyg: folds 
TeWJxSETzbXGiYKx0y+dtg: folds 
R6nIVAjK7uhK3Hj0f85A+A: raises $0.40 to $0.65
QGjA4xtpxSpgzm+HC+ps4w: folds 
z5GxcHlYz/GSz6W2uFiTtg: folds 
M2QO2DxB5Wawg2h8HSpnYA: folds 
Uncalled bet ($0.40) returned to R6nIVAjK7uhK3Hj0f85A+A
R6nIVAjK7uhK3Hj0f85A+A collected $0.60 from pot
R6nIVAjK7uhK3Hj0f85A+A: doesn't show hand 
*** SUMMARY ***
Total pot $0.60 | Rake $0 
Seat 2: R6nIVAjK7uhK3Hj0f85A+A collected ($0.60)
Seat 3: QGjA4xtpxSpgzm+HC+ps4w (button) folded before Flop (didn't bet)
Seat 4: z5GxcHlYz/GSz6W2uFiTtg (small blind) folded before Flop
Seat 6: M2QO2DxB5Wawg2h8HSpnYA (big blind) folded before Flop
Seat 7: gehe91e0IyVT0QU/XBkEyg folded before Flop (didn't bet)
Seat 8: TeWJxSETzbXGiYKx0y+dtg folded before Flop (didn't bet)




PokerStars Game #59939502478:  Hold'em No Limit ($0.10/$0.25) - 2009/07/01 0:41:33 ET
Table 'KU/HrxqxwDz8HKEhYTZ6uw' 6-max Seat #6 is the button
Seat 1: gaPMxLGp9SOj4Lq6t+/0Ig ($27.75 in chips) 
Seat 2: kG34n23qFQA3nzdOJTQ1dA ($24.65 in chips) 
Seat 3: 3seg9SJ1y+HUPN0X0XKF5Q ($11.85 in chips) 
Seat 5: 4YSTu0Cdzpppe1lUgCZGCQ ($36.35 in chips) 
Seat 6: QIWnfLSqfMcoFfdDe5LZPg ($9.80 in chips) 
gaPMxLGp9SOj4Lq6t+/0Ig: posts small blind $0.10
kG34n23qFQA3nzdOJTQ1dA: posts big blind $0.25
*** HOLE CARDS ***
3seg9SJ1y+HUPN0X0XKF5Q: folds 
4YSTu0Cdzpppe1lUgCZGCQ has timed out
4YSTu0Cdzpppe1lUgCZGCQ: folds 
4YSTu0Cdzpppe1lUgCZGCQ is sitting out
QIWnfLSqfMcoFfdDe5LZPg: folds 
4YSTu0Cdzpppe1lUgCZGCQ has returned
gaPMxLGp9SOj4Lq6t+/0Ig: raises $0.50 to $0.75
kG34n23qFQA3nzdOJTQ1dA: folds 
Uncalled bet ($0.50) returned to gaPMxLGp9SOj4Lq6t+/0Ig
gaPMxLGp9SOj4Lq6t+/0Ig collected $0.50 from pot
gaPMxLGp9SOj4Lq6t+/0Ig: doesn't show hand 
*** SUMMARY ***
Total pot $0.50 | Rake $0 
Seat 1: gaPMxLGp9SOj4Lq6t+/0Ig (small blind) collected ($0.50)
Seat 2: kG34n23qFQA3nzdOJTQ1dA (big blind) folded before Flop
Seat 3: 3seg9SJ1y+HUPN0X0XKF5Q folded before Flop (didn't bet)
Seat 5: 4YSTu0Cdzpppe1lUgCZGCQ folded before Flop (didn't bet)
Seat 6: QIWnfLSqfMcoFfdDe5LZPg (button) folded before Flop (didn't bet)




PokerStars Game #59939502490:  Hold'em No Limit ($0.10/$0.25) - 2009/07/01 0:41:33 ET
Table 'fIMYcWwN4/aXFJvH5Z8Ymg' 6-max Seat #3 is the button
Seat 1: 64ZeDpsBsP594VsWmafRTQ ($12.20 in chips) 
Seat 2: vu2kzHaDtgr6NM7rdq0chA ($25.45 in chips) 
Seat 3: bWbV4MVB/vVpiES1Ut4hew ($50.75 in chips) 
Seat 4: 32YL2ZEp8NT4JB2RVM9euQ ($40.15 in chips) 
Seat 5: 9jSiy0meE9XJKkdIZwyTEQ ($29.75 in chips) 
32YL2ZEp8NT4JB2RVM9euQ: posts small blind $0.10
9jSiy0meE9XJKkdIZwyTEQ: posts big blind $0.25
jp34e617tIzV8tKIWmfAbA: sits out 
*** HOLE CARDS ***
64ZeDpsBsP594VsWmafRTQ: folds 
vu2kzHaDtgr6NM7rdq0chA: folds 
bWbV4MVB/vVpiES1Ut4hew: folds 
32YL2ZEp8NT4JB2RVM9euQ: raises $0.75 to $1
9jSiy0meE9XJKkdIZwyTEQ: folds 
Uncalled bet ($0.75) returned to 32YL2ZEp8NT4JB2RVM9euQ
32YL2ZEp8NT4JB2RVM9euQ collected $0.50 from pot
32YL2ZEp8NT4JB2RVM9euQ: doesn't show hand 
*** SUMMARY ***
Total pot $0.50 | Rake $0 
Seat 1: 64ZeDpsBsP594VsWmafRTQ folded before Flop (didn't bet)
Seat 2: vu2kzHaDtgr6NM7rdq0chA folded before Flop (didn't bet)
Seat 3: bWbV4MVB/vVpiES1Ut4hew (button) folded before Flop (didn't bet)
Seat 4: 32YL2ZEp8NT4JB2RVM9euQ (small blind) collected ($0.50)
Seat 5: 9jSiy0meE9XJKkdIZwyTEQ (big blind) folded before Flop




PokerStars Game #59939502590:  Hold'em No Limit ($0.10/$0.25) - 2009/07/01 0:41:33 ET
Table 'sJ4KpS2GE5Qrsu1/cFjJUw' 9-max Seat #3 is the button
Seat 1: QsLvCwfSWqP+CfjwUnjpXQ ($14.85 in chips) 
Seat 3: eDil7UzSZCjyh1VP6SVXJQ ($7.30 in chips) 
Seat 8: f8ixGbSVIs6Be0mH69ldVQ ($14.35 in chips) 
f8ixGbSVIs6Be0mH69ldVQ: posts small blind $0.10
QsLvCwfSWqP+CfjwUnjpXQ: posts big blind $0.25
*** HOLE CARDS ***
eDil7UzSZCjyh1VP6SVXJQ: folds 
f8ixGbSVIs6Be0mH69ldVQ: calls $0.15
QsLvCwfSWqP+CfjwUnjpXQ: checks 
*** FLOP *** [7d 9d 9h]
f8ixGbSVIs6Be0mH69ldVQ: checks 
QsLvCwfSWqP+CfjwUnjpXQ: checks 
*** TURN *** [7d 9d 9h] [8s]
f8ixGbSVIs6Be0mH69ldVQ: bets $0.25
QsLvCwfSWqP+CfjwUnjpXQ: calls $0.25
*** RIVER *** [7d 9d 9h 8s] [Ts]
f8ixGbSVIs6Be0mH69ldVQ: checks 
QsLvCwfSWqP+CfjwUnjpXQ: bets $1
f8ixGbSVIs6Be0mH69ldVQ: calls $1
*** SHOW DOWN ***
QsLvCwfSWqP+CfjwUnjpXQ: shows [Kd Js] (a straight, Seven to Jack)
f8ixGbSVIs6Be0mH69ldVQ: mucks hand 
QsLvCwfSWqP+CfjwUnjpXQ collected $2.90 from pot
*** SUMMARY ***
Total pot $3 | Rake $0.10 
Board [7d 9d 9h 8s Ts]
Seat 1: QsLvCwfSWqP+CfjwUnjpXQ (big blind) showed [Kd Js] and won ($2.90) with a straight, Seven to Jack
Seat 3: eDil7UzSZCjyh1VP6SVXJQ (button) folded before Flop (didn't bet)
Seat 8: f8ixGbSVIs6Be0mH69ldVQ (small blind) mucked




PokerStars Game #59939502530:  Hold'em No Limit ($0.10/$0.25) - 2009/07/01 0:41:33 ET
Table 'ktio12Pyq06LsrFhIorSqA' 9-max Seat #5 is the button
Seat 2: sX4bSd399rlGD2VqB7dh2Q ($8.20 in chips) 
Seat 3: 21oaELqROjaQrGRMDGa8pQ ($14 in chips) 
Seat 4: E0iYnEVO2ho7dH3QcCjw7g ($20 in chips) 
Seat 5: u5FxT1XSXMItxD9DAQOsoQ ($38.05 in chips) 
Seat 6: jQL6XIewylQ8MmZhhq2YFg ($31.75 in chips) 
Seat 7: XGCfQsxa6PfAg3kJtzUmww ($24.15 in chips) 
Seat 8: Z5y2J55JmfLYR6/DPAGHwQ ($17.40 in chips) 
Seat 9: 2Gn4w2tIKlLbK/3nwIeRYA ($15.80 in chips) 
jQL6XIewylQ8MmZhhq2YFg: posts small blind $0.10
XGCfQsxa6PfAg3kJtzUmww: posts big blind $0.25
DerBendero: sits out 
E0iYnEVO2ho7dH3QcCjw7g: posts big blind $0.25
*** HOLE CARDS ***
Z5y2J55JmfLYR6/DPAGHwQ: folds 
2Gn4w2tIKlLbK/3nwIeRYA: calls $0.25
sX4bSd399rlGD2VqB7dh2Q: folds 
21oaELqROjaQrGRMDGa8pQ: folds 
E0iYnEVO2ho7dH3QcCjw7g: checks 
u5FxT1XSXMItxD9DAQOsoQ has timed out
u5FxT1XSXMItxD9DAQOsoQ: folds 
u5FxT1XSXMItxD9DAQOsoQ is sitting out
jQL6XIewylQ8MmZhhq2YFg: calls $0.15
XGCfQsxa6PfAg3kJtzUmww: checks 
*** FLOP *** [Ks 9d Ac]
jQL6XIewylQ8MmZhhq2YFg: checks 
XGCfQsxa6PfAg3kJtzUmww: checks 
2Gn4w2tIKlLbK/3nwIeRYA: bets $0.25
E0iYnEVO2ho7dH3QcCjw7g: folds 
jQL6XIewylQ8MmZhhq2YFg said, "n"
jQL6XIewylQ8MmZhhq2YFg has timed out
jQL6XIewylQ8MmZhhq2YFg: folds 
jQL6XIewylQ8MmZhhq2YFg is sitting out
jQL6XIewylQ8MmZhhq2YFg has returned
XGCfQsxa6PfAg3kJtzUmww: folds 
Uncalled bet ($0.25) returned to 2Gn4w2tIKlLbK/3nwIeRYA
2Gn4w2tIKlLbK/3nwIeRYA collected $0.95 from pot
*** SUMMARY ***
Total pot $1 | Rake $0.05 
Board [Ks 9d Ac]
Seat 2: sX4bSd399rlGD2VqB7dh2Q folded before Flop (didn't bet)
Seat 3: 21oaELqROjaQrGRMDGa8pQ folded before Flop (didn't bet)
Seat 4: E0iYnEVO2ho7dH3QcCjw7g folded on the Flop
Seat 5: u5FxT1XSXMItxD9DAQOsoQ (button) folded before Flop (didn't bet)
Seat 6: jQL6XIewylQ8MmZhhq2YFg (small blind) folded on the Flop
Seat 7: XGCfQsxa6PfAg3kJtzUmww (big blind) folded on the Flop
Seat 8: Z5y2J55JmfLYR6/DPAGHwQ folded before Flop (didn't bet)
Seat 9: 2Gn4w2tIKlLbK/3nwIeRYA collected ($0.95)




PokerStars Game #59939502850:  Hold'em No Limit ($0.10/$0.25) - 2009/07/01 0:41:33 ET
Table 'ohAuixfiLOYDylNUG5mNUw' 9-max Seat #4 is the button
Seat 1: AtRN1hdV8HbL3X4XogDaLA ($32.50 in chips) 
Seat 2: yVwP/Nr5oXkAQp5dmdNUVQ ($24.10 in chips) 
Seat 3: HVKi9hnDyvzObpL08/OarQ ($26 in chips) 
Seat 4: jeKWRUkMaVn8rEUjnJKqpg ($25 in chips) 
Seat 6: opOCI2p6kW0tINuVaAqmcQ ($25 in chips) 
Seat 7: WdsZPRB5ooUPinQdaX0QrA ($3.30 in chips) 
Seat 8: ppMlNkhYgErlt4fuJO7ADA ($11.95 in chips) 
Seat 9: hIss79a4pu7GzJZepfgOpg ($26.60 in chips) 
opOCI2p6kW0tINuVaAqmcQ: posts small blind $0.10
WdsZPRB5ooUPinQdaX0QrA: posts big blind $0.25
yVwP/Nr5oXkAQp5dmdNUVQ: posts small & big blinds $0.35
*** HOLE CARDS ***
ppMlNkhYgErlt4fuJO7ADA: calls $0.25
hIss79a4pu7GzJZepfgOpg: folds 
AtRN1hdV8HbL3X4XogDaLA: calls $0.25
yVwP/Nr5oXkAQp5dmdNUVQ: checks 
HVKi9hnDyvzObpL08/OarQ: calls $0.25
jeKWRUkMaVn8rEUjnJKqpg: folds 
opOCI2p6kW0tINuVaAqmcQ: folds 
WdsZPRB5ooUPinQdaX0QrA: checks 
*** FLOP *** [8s Kc 4c]
WdsZPRB5ooUPinQdaX0QrA: checks 
strongbadia5 joins the table at seat #5 
ppMlNkhYgErlt4fuJO7ADA: bets $0.75
AtRN1hdV8HbL3X4XogDaLA: folds 
yVwP/Nr5oXkAQp5dmdNUVQ: folds 
HVKi9hnDyvzObpL08/OarQ: folds 
WdsZPRB5ooUPinQdaX0QrA: folds 
Uncalled bet ($0.75) returned to ppMlNkhYgErlt4fuJO7ADA
ppMlNkhYgErlt4fuJO7ADA collected $1.40 from pot
ppMlNkhYgErlt4fuJO7ADA: doesn't show hand 
*** SUMMARY ***
Total pot $1.45 | Rake $0.05 
Board [8s Kc 4c]
Seat 1: AtRN1hdV8HbL3X4XogDaLA folded on the Flop
Seat 2: yVwP/Nr5oXkAQp5dmdNUVQ folded on the Flop
Seat 3: HVKi9hnDyvzObpL08/OarQ folded on the Flop
Seat 4: jeKWRUkMaVn8rEUjnJKqpg (button) folded before Flop (didn't bet)
Seat 6: opOCI2p6kW0tINuVaAqmcQ (small blind) folded before Flop
Seat 7: WdsZPRB5ooUPinQdaX0QrA (big blind) folded on the Flop
Seat 8: ppMlNkhYgErlt4fuJO7ADA collected ($1.40)
Seat 9: hIss79a4pu7GzJZepfgOpg folded before Flop (didn't bet)




PokerStars Game #59939502466:  Hold'em No Limit ($0.10/$0.25) - 2009/07/01 0:41:33 ET
Table 'Xi38lWH8L2JHRAsKYVX8Qg' 6-max Seat #6 is the button
Seat 1: AqQ7DFpHkgIzTwDu+rClcg ($5.25 in chips) 
Seat 3: 6DwBRH+xZ12AAZmeAg+aXw ($25 in chips) 
Seat 4: d0J1xuhsynEY81YHwAvJ5g ($25.35 in chips) 
Seat 6: aogAb4Eienxztk8p2v9VVw ($22.25 in chips) 
AqQ7DFpHkgIzTwDu+rClcg: posts small blind $0.10
6DwBRH+xZ12AAZmeAg+aXw: posts big blind $0.25
79ID/ub1Pt/mDpCprVmOoA: sits out 
*** HOLE CARDS ***
d0J1xuhsynEY81YHwAvJ5g: folds 
d0J1xuhsynEY81YHwAvJ5g leaves the table
aogAb4Eienxztk8p2v9VVw: raises $0.50 to $0.75
AqQ7DFpHkgIzTwDu+rClcg: raises $1.25 to $2
7iL6KfkJTFbyWmnLYk4+AA joins the table at seat #2 
6DwBRH+xZ12AAZmeAg+aXw: folds 
aogAb4Eienxztk8p2v9VVw: folds 
Uncalled bet ($1.25) returned to AqQ7DFpHkgIzTwDu+rClcg
AqQ7DFpHkgIzTwDu+rClcg collected $1.75 from pot
*** SUMMARY ***
Total pot $1.75 | Rake $0 
Seat 1: AqQ7DFpHkgIzTwDu+rClcg (small blind) collected ($1.75)
Seat 3: 6DwBRH+xZ12AAZmeAg+aXw (big blind) folded before Flop
Seat 4: d0J1xuhsynEY81YHwAvJ5g folded before Flop (didn't bet)
Seat 6: aogAb4Eienxztk8p2v9VVw (button) folded before Flop




PokerStars Game #59939503146:  Hold'em No Limit ($0.10/$0.25) - 2009/07/01 0:41:34 ET
Table 'BabJGL6tfXQp3leBGbYe8A' 9-max Seat #4 is the button
Seat 2: G5EFgY1bi50mF1iH/+B4yQ ($9.85 in chips) 
Seat 3: Jdj7AsGFrlkCgDXeWK322A ($24.15 in chips) 
Seat 4: Yk91gygnxgAKPGHZ/jPVSw ($7.70 in chips) 
Seat 5: fKqW4kzqpoOv+YKE5kp3FA ($3.05 in chips) 
Seat 6: ELKIDQ6mBSQJr3wiHYHtvw ($7.75 in chips) 
Seat 7: PS2bAPjvHsF4E9tIyk0xBg ($2.20 in chips) 
Seat 8: TJEefy+0K5gBV+8LA5OK7Q ($25 in chips) 
Seat 9: xEQxarad8/T4jJdpZy5LGw ($9.80 in chips) 
fKqW4kzqpoOv+YKE5kp3FA: posts small blind $0.10
ELKIDQ6mBSQJr3wiHYHtvw: posts big blind $0.25
qwr38jl5txoR36M7G5qi4A: sits out 
*** HOLE CARDS ***
PS2bAPjvHsF4E9tIyk0xBg: calls $0.25
TJEefy+0K5gBV+8LA5OK7Q: folds 
xEQxarad8/T4jJdpZy5LGw: folds 
G5EFgY1bi50mF1iH/+B4yQ: folds 
Jdj7AsGFrlkCgDXeWK322A: calls $0.25
Yk91gygnxgAKPGHZ/jPVSw: calls $0.25
fKqW4kzqpoOv+YKE5kp3FA: calls $0.15
ELKIDQ6mBSQJr3wiHYHtvw: checks 
*** FLOP *** [8s Tc Qc]
fKqW4kzqpoOv+YKE5kp3FA: checks 
ELKIDQ6mBSQJr3wiHYHtvw: checks 
PS2bAPjvHsF4E9tIyk0xBg: bets $1.95 and is all-in
Jdj7AsGFrlkCgDXeWK322A: calls $1.95
Yk91gygnxgAKPGHZ/jPVSw: folds 
fKqW4kzqpoOv+YKE5kp3FA: folds 
ELKIDQ6mBSQJr3wiHYHtvw: folds 
*** TURN *** [8s Tc Qc] [8h]
*** RIVER *** [8s Tc Qc 8h] [Jh]
*** SHOW DOWN ***
PS2bAPjvHsF4E9tIyk0xBg: shows [Qs 7s] (two pair, Queens and Eights)
Jdj7AsGFrlkCgDXeWK322A: shows [6c 9s] (a straight, Eight to Queen)
Jdj7AsGFrlkCgDXeWK322A collected $4.90 from pot
*** SUMMARY ***
Total pot $5.15 | Rake $0.25 
Board [8s Tc Qc 8h Jh]
Seat 2: G5EFgY1bi50mF1iH/+B4yQ folded before Flop (didn't bet)
Seat 3: Jdj7AsGFrlkCgDXeWK322A showed [6c 9s] and won ($4.90) with a straight, Eight to Queen
Seat 4: Yk91gygnxgAKPGHZ/jPVSw (button) folded on the Flop
Seat 5: fKqW4kzqpoOv+YKE5kp3FA (small blind) folded on the Flop
Seat 6: ELKIDQ6mBSQJr3wiHYHtvw (big blind) folded on the Flop
Seat 7: PS2bAPjvHsF4E9tIyk0xBg showed [Qs 7s] and lost with two pair, Queens and Eights
Seat 8: TJEefy+0K5gBV+8LA5OK7Q folded before Flop (didn't bet)
Seat 9: xEQxarad8/T4jJdpZy5LGw folded before Flop (didn't bet)




PokerStars Game #59939503198:  Hold'em No Limit ($0.10/$0.25) - 2009/07/01 0:41:34 ET
Table '2VkNDXXsBj4bSZw/uK5atw' 6-max Seat #5 is the button
Seat 1: 7FmwVDcdEtxDpHmP4hOXsQ ($26.40 in chips) 
Seat 4: yb6rnd48JuBccThV68VHAQ ($74.65 in chips) 
Seat 5: kyRaCIljYA6l33lSKQfNsg ($24.65 in chips) 
Seat 6: qGHGf/553gQnDoklMRe3tg ($25 in chips) 
qGHGf/553gQnDoklMRe3tg: posts small blind $0.10
7FmwVDcdEtxDpHmP4hOXsQ: posts big blind $0.25
gqW2aBCmrIw65BvwjTFN6Q: sits out 
*** HOLE CARDS ***
yb6rnd48JuBccThV68VHAQ: folds 
kyRaCIljYA6l33lSKQfNsg: folds 
qGHGf/553gQnDoklMRe3tg: folds 
Uncalled bet ($0.15) returned to 7FmwVDcdEtxDpHmP4hOXsQ
7FmwVDcdEtxDpHmP4hOXsQ collected $0.20 from pot
7FmwVDcdEtxDpHmP4hOXsQ: doesn't show hand 
*** SUMMARY ***
Total pot $0.20 | Rake $0 
Seat 1: 7FmwVDcdEtxDpHmP4hOXsQ (big blind) collected ($0.20)
Seat 4: yb6rnd48JuBccThV68VHAQ folded before Flop (didn't bet)
Seat 5: kyRaCIljYA6l33lSKQfNsg (button) folded before Flop (didn't bet)
Seat 6: qGHGf/553gQnDoklMRe3tg (small blind) folded before Flop




PokerStars Game #59939503582:  Hold'em No Limit ($0.10/$0.25) - 2009/07/01 0:41:34 ET
Table 'u5gc8WdJbaPqEonQaM8rHA' 9-max Seat #6 is the button
Seat 1: rXm4QDVJt67H20lM6n6Z7Q ($8.15 in chips) 
Seat 2: YcYxPZXJR8KffyXgr1BkHw ($28.15 in chips) 
Seat 5: 4y3ZJtAlW/aXjQX7SXyjrQ ($25.10 in chips) 
Seat 6: iPe2eRZr++z/LEfORn3WBQ ($16.95 in chips) 
9j9dK6T4bnFE4nxAg16ycg will be allowed to play after the button
rXm4QDVJt67H20lM6n6Z7Q: posts small blind $0.10
YcYxPZXJR8KffyXgr1BkHw: posts big blind $0.25
*** HOLE CARDS ***
4y3ZJtAlW/aXjQX7SXyjrQ: folds 
iPe2eRZr++z/LEfORn3WBQ: calls $0.25
rXm4QDVJt67H20lM6n6Z7Q: folds 
YcYxPZXJR8KffyXgr1BkHw: checks 
*** FLOP *** [5d 5h 8s]
YcYxPZXJR8KffyXgr1BkHw: checks 
iPe2eRZr++z/LEfORn3WBQ: checks 
*** TURN *** [5d 5h 8s] [3d]
YcYxPZXJR8KffyXgr1BkHw: bets $0.50
iPe2eRZr++z/LEfORn3WBQ: folds 
Uncalled bet ($0.50) returned to YcYxPZXJR8KffyXgr1BkHw
YcYxPZXJR8KffyXgr1BkHw collected $0.60 from pot
YcYxPZXJR8KffyXgr1BkHw: doesn't show hand 
*** SUMMARY ***
Total pot $0.60 | Rake $0 
Board [5d 5h 8s 3d]
Seat 1: rXm4QDVJt67H20lM6n6Z7Q (small blind) folded before Flop
Seat 2: YcYxPZXJR8KffyXgr1BkHw (big blind) collected ($0.60)
Seat 5: 4y3ZJtAlW/aXjQX7SXyjrQ folded before Flop (didn't bet)
Seat 6: iPe2eRZr++z/LEfORn3WBQ (button) folded on the Turn




PokerStars Game #59939503276:  Hold'em No Limit ($0.10/$0.25) - 2009/07/01 0:41:34 ET
Table '/asc7VQ/OpF/oVJ3erB80w' 9-max Seat #9 is the button
Seat 1: OiV1PWZ3IkN29JlmCcnTwQ ($5 in chips) 
Seat 2: Th3FldXKQW6hWVVPahaoOQ ($25.80 in chips) 
Seat 3: ie4EwTMMFYxrCXcenJdzsw ($6.45 in chips) 
Seat 4: H9KUl8cmpLgEpOVDA00bCg ($5.25 in chips) 
Seat 5: 8B/dhbQjIWe6ASCdgzktNQ ($25.25 in chips) 
Seat 6: t2nb95S5EEFOEzNx9Itz0g ($3.10 in chips) 
Seat 7: M2QO2DxB5Wawg2h8HSpnYA ($12 in chips) 
Seat 8: T5Hk9oiIr+JDDMnEqwFCrw ($5.55 in chips) 
Seat 9: UkJraTKWQIqFeHOyHQ7afQ ($15.05 in chips) 
OiV1PWZ3IkN29JlmCcnTwQ: posts small blind $0.10
Th3FldXKQW6hWVVPahaoOQ: posts big blind $0.25
*** HOLE CARDS ***
ie4EwTMMFYxrCXcenJdzsw: calls $0.25
H9KUl8cmpLgEpOVDA00bCg: folds 
8B/dhbQjIWe6ASCdgzktNQ: folds 
t2nb95S5EEFOEzNx9Itz0g: folds 
M2QO2DxB5Wawg2h8HSpnYA: folds 
T5Hk9oiIr+JDDMnEqwFCrw: folds 
UkJraTKWQIqFeHOyHQ7afQ: folds 
OiV1PWZ3IkN29JlmCcnTwQ: folds 
Th3FldXKQW6hWVVPahaoOQ: checks 
*** FLOP *** [6c 5c As]
Th3FldXKQW6hWVVPahaoOQ: checks 
ie4EwTMMFYxrCXcenJdzsw: bets $0.25
Th3FldXKQW6hWVVPahaoOQ: folds 
Uncalled bet ($0.25) returned to ie4EwTMMFYxrCXcenJdzsw
ie4EwTMMFYxrCXcenJdzsw collected $0.60 from pot
*** SUMMARY ***
Total pot $0.60 | Rake $0 
Board [6c 5c As]
Seat 1: OiV1PWZ3IkN29JlmCcnTwQ (small blind) folded before Flop
Seat 2: Th3FldXKQW6hWVVPahaoOQ (big blind) folded on the Flop
Seat 3: ie4EwTMMFYxrCXcenJdzsw collected ($0.60)
Seat 4: H9KUl8cmpLgEpOVDA00bCg folded before Flop (didn't bet)
Seat 5: 8B/dhbQjIWe6ASCdgzktNQ folded before Flop (didn't bet)
Seat 6: t2nb95S5EEFOEzNx9Itz0g folded before Flop (didn't bet)
Seat 7: M2QO2DxB5Wawg2h8HSpnYA folded before Flop (didn't bet)
Seat 8: T5Hk9oiIr+JDDMnEqwFCrw folded before Flop (didn't bet)
Seat 9: UkJraTKWQIqFeHOyHQ7afQ (button) folded before Flop (didn't bet)




PokerStars Game #59939503348:  Hold'em No Limit ($0.10/$0.25) - 2009/07/01 0:41:34 ET
Table 'dVzscin98UhGisTmV9BDcw' 9-max Seat #7 is the button
Seat 1: sBAwXpkpgyhyWbHIQcIJKA ($19.45 in chips) 
Seat 2: dfNim92Z6XK1/h5SFW5vDg ($29.15 in chips) 
Seat 3: 1Clf3cPrqoy/YgvWdWK1Xw ($5.25 in chips) 
Seat 4: aNpwfA31EREwO+ar4XzBCw ($25.25 in chips) 
Seat 5: ZMRQOoxoJ7Alx96gZhP2EQ ($64.45 in chips) 
Seat 6: hBMUlEpyU74r/fwDgIpXjQ ($28.35 in chips) 
Seat 7: nEg1b6MIksd/4x5eLY735g ($60.55 in chips) 
Seat 8: /vn2Qu2dvc9AMMq46Ae0jA ($5.45 in chips) 
Seat 9: OYa/ZJBO+suuezfWsUMhZw ($5.80 in chips) 
/vn2Qu2dvc9AMMq46Ae0jA: posts small blind $0.10
OYa/ZJBO+suuezfWsUMhZw: posts big blind $0.25
*** HOLE CARDS ***
sBAwXpkpgyhyWbHIQcIJKA: raises $0.25 to $0.50
dfNim92Z6XK1/h5SFW5vDg: folds 
1Clf3cPrqoy/YgvWdWK1Xw: folds 
aNpwfA31EREwO+ar4XzBCw: folds 
ZMRQOoxoJ7Alx96gZhP2EQ: calls $0.50
hBMUlEpyU74r/fwDgIpXjQ: folds 
nEg1b6MIksd/4x5eLY735g: folds 
/vn2Qu2dvc9AMMq46Ae0jA: calls $0.40
OYa/ZJBO+suuezfWsUMhZw: folds 
*** FLOP *** [Th 7c 6c]
/vn2Qu2dvc9AMMq46Ae0jA: checks 
sBAwXpkpgyhyWbHIQcIJKA: checks 
ZMRQOoxoJ7Alx96gZhP2EQ: checks 
*** TURN *** [Th 7c 6c] [6d]
/vn2Qu2dvc9AMMq46Ae0jA: checks 
sBAwXpkpgyhyWbHIQcIJKA: bets $1
ZMRQOoxoJ7Alx96gZhP2EQ: folds 
/vn2Qu2dvc9AMMq46Ae0jA: folds 
Uncalled bet ($1) returned to sBAwXpkpgyhyWbHIQcIJKA
sBAwXpkpgyhyWbHIQcIJKA collected $1.70 from pot
sBAwXpkpgyhyWbHIQcIJKA: doesn't show hand 
*** SUMMARY ***
Total pot $1.75 | Rake $0.05 
Board [Th 7c 6c 6d]
Seat 1: sBAwXpkpgyhyWbHIQcIJKA collected ($1.70)
Seat 2: dfNim92Z6XK1/h5SFW5vDg folded before Flop (didn't bet)
Seat 3: 1Clf3cPrqoy/YgvWdWK1Xw folded before Flop (didn't bet)
Seat 4: aNpwfA31EREwO+ar4XzBCw folded before Flop (didn't bet)
Seat 5: ZMRQOoxoJ7Alx96gZhP2EQ folded on the Turn
Seat 6: hBMUlEpyU74r/fwDgIpXjQ folded before Flop (didn't bet)
Seat 7: nEg1b6MIksd/4x5eLY735g (button) folded before Flop (didn't bet)
Seat 8: /vn2Qu2dvc9AMMq46Ae0jA (small blind) folded on the Turn
Seat 9: OYa/ZJBO+suuezfWsUMhZw (big blind) folded before Flop




PokerStars Game #59939503162:  Hold'em No Limit ($0.10/$0.25) - 2009/07/01 0:41:34 ET
Table 'dZNBGqFYSwfOVZvDJ4VjIQ' 6-max Seat #2 is the button
Seat 2: NPueG39V6nKvDRuvBJ4U7g ($15.45 in chips) 
Seat 3: Qd4gQJ1hjQcU9/uDqd6Nlw ($11.45 in chips) 
Seat 4: df01R5ThvHspD8FgKmaDvQ ($24.75 in chips) 
Seat 5: hZJzYj+7+PvGu6ae1g//sQ ($9.65 in chips) 
Seat 6: VbudEd0ZG+qPwMO9h+hjXw ($19.45 in chips) 
Qd4gQJ1hjQcU9/uDqd6Nlw: posts small blind $0.10
df01R5ThvHspD8FgKmaDvQ: posts big blind $0.25
o08wk0F4gROLhZS04Iyl3w is disconnected 
o08wk0F4gROLhZS04Iyl3w has timed out while disconnected
o08wk0F4gROLhZS04Iyl3w: is sitting out 
*** HOLE CARDS ***
o08wk0F4gROLhZS04Iyl3w is connected 
hZJzYj+7+PvGu6ae1g//sQ: calls $0.25
VbudEd0ZG+qPwMO9h+hjXw: folds 
NPueG39V6nKvDRuvBJ4U7g: calls $0.25
Qd4gQJ1hjQcU9/uDqd6Nlw: raises $0.50 to $0.75
df01R5ThvHspD8FgKmaDvQ: folds 
hZJzYj+7+PvGu6ae1g//sQ: calls $0.50
NPueG39V6nKvDRuvBJ4U7g: calls $0.50
*** FLOP *** [9h 6h 2d]
Qd4gQJ1hjQcU9/uDqd6Nlw: bets $0.50
o08wk0F4gROLhZS04Iyl3w has returned
hZJzYj+7+PvGu6ae1g//sQ: calls $0.50
NPueG39V6nKvDRuvBJ4U7g: folds 
*** TURN *** [9h 6h 2d] [Qh]
Qd4gQJ1hjQcU9/uDqd6Nlw: bets $1.25
hZJzYj+7+PvGu6ae1g//sQ: folds 
Uncalled bet ($1.25) returned to Qd4gQJ1hjQcU9/uDqd6Nlw
Qd4gQJ1hjQcU9/uDqd6Nlw collected $3.35 from pot
Qd4gQJ1hjQcU9/uDqd6Nlw: doesn't show hand 
*** SUMMARY ***
Total pot $3.50 | Rake $0.15 
Board [9h 6h 2d Qh]
Seat 2: NPueG39V6nKvDRuvBJ4U7g (button) folded on the Flop
Seat 3: Qd4gQJ1hjQcU9/uDqd6Nlw (small blind) collected ($3.35)
Seat 4: df01R5ThvHspD8FgKmaDvQ (big blind) folded before Flop
Seat 5: hZJzYj+7+PvGu6ae1g//sQ folded on the Turn
Seat 6: VbudEd0ZG+qPwMO9h+hjXw folded before Flop (didn't bet)




PokerStars Game #59939503398:  Hold'em No Limit ($0.10/$0.25) - 2009/07/01 0:41:34 ET
Table 'nc6OeGk/wtaWV+6N+kgnZQgZetDqJh6q9A3mLO3ThCsASeat #5 is the button
Seat 1: 1YCU970EVCcjs4GQP5Zt0g ($19.40 in chips) 
Seat 3: wKFJ513ucluNNiMlkXcDOQ ($25 in chips) 
Seat 4: eHsmIvAb2JREg4O6hNPnXg ($8.65 in chips) 
Seat 5: mfrkWA3PTeYPkbO6hi98Aw ($38.05 in chips) 
Seat 6: R1hR3/XSBdOHwcbSUJRJbg ($62.10 in chips) 
R1hR3/XSBdOHwcbSUJRJbg: posts small blind $0.10
1YCU970EVCcjs4GQP5Zt0g: posts big blind $0.25
JFIAqU8lCZ0vWwEl4bdGsg: sits out 
*** HOLE CARDS ***
wKFJ513ucluNNiMlkXcDOQ: folds 
eHsmIvAb2JREg4O6hNPnXg: folds 
mfrkWA3PTeYPkbO6hi98Aw: raises $0.75 to $1
R1hR3/XSBdOHwcbSUJRJbg: folds 
1YCU970EVCcjs4GQP5Zt0g: folds 
Uncalled bet ($0.75) returned to mfrkWA3PTeYPkbO6hi98Aw
mfrkWA3PTeYPkbO6hi98Aw collected $0.60 from pot
mfrkWA3PTeYPkbO6hi98Aw: doesn't show hand 
*** SUMMARY ***
Total pot $0.60 | Rake $0 
Seat 1: 1YCU970EVCcjs4GQP5Zt0g (big blind) folded before Flop
Seat 3: wKFJ513ucluNNiMlkXcDOQ folded before Flop (didn't bet)
Seat 4: eHsmIvAb2JREg4O6hNPnXg folded before Flop (didn't bet)
Seat 5: mfrkWA3PTeYPkbO6hi98Aw (button) collected ($0.60)
Seat 6: R1hR3/XSBdOHwcbSUJRJbg (small blind) folded before Flop




PokerStars Game #59939503386:  Hold'em No Limit ($0.10/$0.25) - 2009/07/01 0:41:34 ET
Table 'isKy4XK8wJM0x735/D4hWA' 6-max Seat #5 is the button
Seat 1: 7FmwVDcdEtxDpHmP4hOXsQ ($25 in chips) 
Seat 2: WrLI51S2iMb8GLMB83gGqA ($27.10 in chips) 
Seat 4: k9vn40MOqqb+xF+7GZ6v2g ($24.65 in chips) 
Seat 5: zlYHXTtJ5tcx9kwK2h5n9A ($37.05 in chips) 
Seat 6: M6xK/VklCvdyyrmvzATlxQ ($13.85 in chips) 
M6xK/VklCvdyyrmvzATlxQ: posts small blind $0.10
7FmwVDcdEtxDpHmP4hOXsQ: posts big blind $0.25
jp34e617tIzV8tKIWmfAbA: sits out 
*** HOLE CARDS ***
WrLI51S2iMb8GLMB83gGqA: raises $0.75 to $1
k9vn40MOqqb+xF+7GZ6v2g: folds 
zlYHXTtJ5tcx9kwK2h5n9A: folds 
M6xK/VklCvdyyrmvzATlxQ: folds 
7FmwVDcdEtxDpHmP4hOXsQ: folds 
Uncalled bet ($0.75) returned to WrLI51S2iMb8GLMB83gGqA
WrLI51S2iMb8GLMB83gGqA collected $0.60 from pot
WrLI51S2iMb8GLMB83gGqA: doesn't show hand 
*** SUMMARY ***
Total pot $0.60 | Rake $0 
Seat 1: 7FmwVDcdEtxDpHmP4hOXsQ (big blind) folded before Flop
Seat 2: WrLI51S2iMb8GLMB83gGqA collected ($0.60)
Seat 4: k9vn40MOqqb+xF+7GZ6v2g folded before Flop (didn't bet)
Seat 5: zlYHXTtJ5tcx9kwK2h5n9A (button) folded before Flop (didn't bet)
Seat 6: M6xK/VklCvdyyrmvzATlxQ (small blind) folded before Flop




PokerStars Game #59939503282:  Hold'em No Limit ($0.10/$0.25) - 2009/07/01 0:41:34 ET
Table 'sm5gqEvXgLbkkE4dryW/5g' 6-max Seat #3 is the button
Seat 1: gaPMxLGp9SOj4Lq6t+/0Ig ($13.35 in chips) 
Seat 2: s13YXIlhF/j3TO0bSnT7bA ($18.80 in chips) 
Seat 3: I1TxPvWj8NfG8orglCinNA ($25.35 in chips) 
Seat 4: BedjMfrlRfPgSq7CXpPAmg ($57.75 in chips) 
Seat 5: M+WmDyCD/ZMu/5t6/iH2kw ($73.75 in chips) 
Seat 6: wKFJ513ucluNNiMlkXcDOQ ($25 in chips) 
BedjMfrlRfPgSq7CXpPAmg: posts small blind $0.10
M+WmDyCD/ZMu/5t6/iH2kw: posts big blind $0.25
*** HOLE CARDS ***
wKFJ513ucluNNiMlkXcDOQ: folds 
gaPMxLGp9SOj4Lq6t+/0Ig: folds 
s13YXIlhF/j3TO0bSnT7bA: folds 
I1TxPvWj8NfG8orglCinNA: raises $0.75 to $1
BedjMfrlRfPgSq7CXpPAmg: folds 
M+WmDyCD/ZMu/5t6/iH2kw: calls $0.75
*** FLOP *** [2d Jc Jh]
M+WmDyCD/ZMu/5t6/iH2kw: checks 
I1TxPvWj8NfG8orglCinNA has timed out
I1TxPvWj8NfG8orglCinNA: checks 
*** TURN *** [2d Jc Jh] [5s]
M+WmDyCD/ZMu/5t6/iH2kw: bets $1.25
I1TxPvWj8NfG8orglCinNA: calls $1.25
*** RIVER *** [2d Jc Jh 5s] [4c]
M+WmDyCD/ZMu/5t6/iH2kw: checks 
I1TxPvWj8NfG8orglCinNA: checks 
*** SHOW DOWN ***
M+WmDyCD/ZMu/5t6/iH2kw: shows [Ks 8c] (a pair of Jacks)
I1TxPvWj8NfG8orglCinNA: shows [Ad 5d] (two pair, Jacks and Fives)
I1TxPvWj8NfG8orglCinNA collected $4.40 from pot
*** SUMMARY ***
Total pot $4.60 | Rake $0.20 
Board [2d Jc Jh 5s 4c]
Seat 1: gaPMxLGp9SOj4Lq6t+/0Ig folded before Flop (didn't bet)
Seat 2: s13YXIlhF/j3TO0bSnT7bA folded before Flop (didn't bet)
Seat 3: I1TxPvWj8NfG8orglCinNA (button) showed [Ad 5d] and won ($4.40) with two pair, Jacks and Fives
Seat 4: BedjMfrlRfPgSq7CXpPAmg (small blind) folded before Flop
Seat 5: M+WmDyCD/ZMu/5t6/iH2kw (big blind) showed [Ks 8c] and lost with a pair of Jacks
Seat 6: wKFJ513ucluNNiMlkXcDOQ folded before Flop (didn't bet)




PokerStars Game #59939503292:  Hold'em No Limit ($0.10/$0.25) - 2009/07/01 0:41:34 ET
Table 'sDHjMRwfSiz7+NDdZLUiyA' 9-max Seat #1 is the button
Seat 1: N6fYvIzQLKaydFLKQGtMlQ ($25.40 in chips) 
Seat 2: ljemhp25Zg+nlA9DLCIiUw ($27.25 in chips) 
Seat 3: SGA1WpAnQxFdFAYyt362gQ ($15 in chips) 
Seat 4: v5jnQ1gfh9nLla3kMXG7Yg ($16.65 in chips) 
Seat 8: 3hMkm4U5yTRrkGJkxfijaQ ($29.70 in chips) 
Seat 9: Xpyqpb+DURDWnyJ3xTEIFQ ($39.20 in chips) 
ljemhp25Zg+nlA9DLCIiUw: posts small blind $0.10
SGA1WpAnQxFdFAYyt362gQ: posts big blind $0.25
IGRfskE1v9H9Bn+fz8AgNQ: sits out 
DlXs37dlX3tb7o/7lYXQSw: sits out 
*** HOLE CARDS ***
v5jnQ1gfh9nLla3kMXG7Yg: folds 
3hMkm4U5yTRrkGJkxfijaQ: calls $0.25
Xpyqpb+DURDWnyJ3xTEIFQ: raises $0.75 to $1
N6fYvIzQLKaydFLKQGtMlQ: calls $1
ljemhp25Zg+nlA9DLCIiUw: folds 
SGA1WpAnQxFdFAYyt362gQ: folds 
3hMkm4U5yTRrkGJkxfijaQ: calls $0.75
*** FLOP *** [3d 7s 8d]
K0b5wNInj6hUGRr6yzKFtw has returned
3hMkm4U5yTRrkGJkxfijaQ: checks 
Xpyqpb+DURDWnyJ3xTEIFQ: checks 
N6fYvIzQLKaydFLKQGtMlQ: checks 
*** TURN *** [3d 7s 8d] [4s]
3hMkm4U5yTRrkGJkxfijaQ: checks 
Xpyqpb+DURDWnyJ3xTEIFQ: bets $2
N6fYvIzQLKaydFLKQGtMlQ: folds 
3hMkm4U5yTRrkGJkxfijaQ: folds 
Uncalled bet ($2) returned to Xpyqpb+DURDWnyJ3xTEIFQ
Xpyqpb+DURDWnyJ3xTEIFQ collected $3.20 from pot
Xpyqpb+DURDWnyJ3xTEIFQ: doesn't show hand 
*** SUMMARY ***
Total pot $3.35 | Rake $0.15 
Board [3d 7s 8d 4s]
Seat 1: N6fYvIzQLKaydFLKQGtMlQ (button) folded on the Turn
Seat 2: ljemhp25Zg+nlA9DLCIiUw (small blind) folded before Flop
Seat 3: SGA1WpAnQxFdFAYyt362gQ (big blind) folded before Flop
Seat 4: v5jnQ1gfh9nLla3kMXG7Yg folded before Flop (didn't bet)
Seat 8: 3hMkm4U5yTRrkGJkxfijaQ folded on the Turn
Seat 9: Xpyqpb+DURDWnyJ3xTEIFQ collected ($3.20)




PokerStars Game #59939503886:  Hold'em No Limit ($0.10/$0.25) - 2009/07/01 0:41:35 ET
Table 'mF3KHGMaTpaBZbtBoyfTeg' 6-max Seat #1 is the button
Seat 1: 0HAB2GdCAM7p7V00xueAVQ ($9.95 in chips) 
Seat 2: 4x9jCqgSw4272dnaIqnanw ($4.25 in chips) 
Seat 3: Hzrn9DZJegEZICufTNYkrg ($14.75 in chips) 
Seat 4: FYepjhAvF8ZdVCmqHIy+eQ ($25.55 in chips) 
Seat 5: sEQx9G5Cu8k1HNdQasxvUA ($27.90 in chips) 
4x9jCqgSw4272dnaIqnanw: posts small blind $0.10
Hzrn9DZJegEZICufTNYkrg: posts big blind $0.25
*** HOLE CARDS ***
FYepjhAvF8ZdVCmqHIy+eQ: folds 
sEQx9G5Cu8k1HNdQasxvUA: folds 
0HAB2GdCAM7p7V00xueAVQ: folds 
4x9jCqgSw4272dnaIqnanw: raises $4 to $4.25 and is all-in
Hzrn9DZJegEZICufTNYkrg: folds 
Uncalled bet ($4) returned to 4x9jCqgSw4272dnaIqnanw
4x9jCqgSw4272dnaIqnanw collected $0.50 from pot
*** SUMMARY ***
Total pot $0.50 | Rake $0 
Seat 1: 0HAB2GdCAM7p7V00xueAVQ (button) folded before Flop (didn't bet)
Seat 2: 4x9jCqgSw4272dnaIqnanw (small blind) collected ($0.50)
Seat 3: Hzrn9DZJegEZICufTNYkrg (big blind) folded before Flop
Seat 4: FYepjhAvF8ZdVCmqHIy+eQ folded before Flop (didn't bet)
Seat 5: sEQx9G5Cu8k1HNdQasxvUA folded before Flop (didn't bet)




PokerStars Game #59939504248:  Hold'em No Limit ($0.10/$0.25) - 2009/07/01 0:41:35 ET
Table '29D3eoQzK5kOAT0OIDS2uQ' 6-max Seat #3 is the button
Seat 1: kG34n23qFQA3nzdOJTQ1dA ($51.30 in chips) 
Seat 3: z3tQwy28dp5FykDJC/wzQw ($21.20 in chips) 
Seat 4: yzFNNFIfC89bBPwpFPx2ow ($26.35 in chips) 
Seat 5: Q3EMN7b0ie81AFWkDrhCjw ($33.10 in chips) 
Seat 6: bWbV4MVB/vVpiES1Ut4hew ($44.10 in chips) 
yzFNNFIfC89bBPwpFPx2ow: posts small blind $0.10
Q3EMN7b0ie81AFWkDrhCjw: posts big blind $0.25
*** HOLE CARDS ***
bWbV4MVB/vVpiES1Ut4hew: folds 
kG34n23qFQA3nzdOJTQ1dA: calls $0.25
z3tQwy28dp5FykDJC/wzQw: folds 
yzFNNFIfC89bBPwpFPx2ow: folds 
Q3EMN7b0ie81AFWkDrhCjw: checks 
*** FLOP *** [9c 3d 9s]
Q3EMN7b0ie81AFWkDrhCjw: bets $0.50
kG34n23qFQA3nzdOJTQ1dA: calls $0.50
*** TURN *** [9c 3d 9s] [As]
Q3EMN7b0ie81AFWkDrhCjw: bets $0.50
kG34n23qFQA3nzdOJTQ1dA: calls $0.50
*** RIVER *** [9c 3d 9s As] [Jc]
Q3EMN7b0ie81AFWkDrhCjw: bets $0.50
kG34n23qFQA3nzdOJTQ1dA: folds 
Uncalled bet ($0.50) returned to Q3EMN7b0ie81AFWkDrhCjw
Q3EMN7b0ie81AFWkDrhCjw collected $2.50 from pot
*** SUMMARY ***
Total pot $2.60 | Rake $0.10 
Board [9c 3d 9s As Jc]
Seat 1: kG34n23qFQA3nzdOJTQ1dA folded on the River
Seat 3: z3tQwy28dp5FykDJC/wzQw (button) folded before Flop (didn't bet)
Seat 4: yzFNNFIfC89bBPwpFPx2ow (small blind) folded before Flop
Seat 5: Q3EMN7b0ie81AFWkDrhCjw (big blind) collected ($2.50)
Seat 6: bWbV4MVB/vVpiES1Ut4hew folded before Flop (didn't bet)




PokerStars Game #59939503972:  Hold'em No Limit ($0.10/$0.25) - 2009/07/01 0:41:35 ET
Table 'WEMI3Mtn7dGARDbgNrKibg' 9-max Seat #7 is the button
Seat 2: tYsOBqdU1+x+yFI7zHO7hQ ($45.95 in chips) 
Seat 3: jZaChyamGXWcP+qALPP5Jg ($28.55 in chips) 
Seat 5: st9jtdNbm1W5GfBwRaCVqQ ($20.65 in chips) 
Seat 6: VBHxUExRAMrbxUq/cVx9Gw ($5 in chips) 
Seat 7: DnDcAdn9P0zGovMERigpFA ($58.65 in chips) 
Seat 8: ghNKXUBl/H+t83JF079ZBA ($27.05 in chips) 
Seat 9: NTamLAiMZ86c5yM04t96LA ($56.45 in chips) 
ghNKXUBl/H+t83JF079ZBA: posts small blind $0.10
NTamLAiMZ86c5yM04t96LA: posts big blind $0.25
7cv+9Zc9HIQHNvYsMfV3uA: sits out 
yyG4svzOpC1A+sUP/scg6w: sits out 
*** HOLE CARDS ***
tYsOBqdU1+x+yFI7zHO7hQ: raises $0.75 to $1
jZaChyamGXWcP+qALPP5Jg: calls $1
st9jtdNbm1W5GfBwRaCVqQ: folds 
VBHxUExRAMrbxUq/cVx9Gw: folds 
DnDcAdn9P0zGovMERigpFA: folds 
ghNKXUBl/H+t83JF079ZBA: folds 
NTamLAiMZ86c5yM04t96LA: folds 
*** FLOP *** [9c Ad Kc]
NTamLAiMZ86c5yM04t96LA is sitting out
tYsOBqdU1+x+yFI7zHO7hQ: checks 
jZaChyamGXWcP+qALPP5Jg: checks 
*** TURN *** [9c Ad Kc] [Jc]
tYsOBqdU1+x+yFI7zHO7hQ: checks 
NTamLAiMZ86c5yM04t96LA has returned
jZaChyamGXWcP+qALPP5Jg: bets $1.25
tYsOBqdU1+x+yFI7zHO7hQ: folds 
Uncalled bet ($1.25) returned to jZaChyamGXWcP+qALPP5Jg
jZaChyamGXWcP+qALPP5Jg collected $2.25 from pot
jZaChyamGXWcP+qALPP5Jg: doesn't show hand 
*** SUMMARY ***
Total pot $2.35 | Rake $0.10 
Board [9c Ad Kc Jc]
Seat 2: tYsOBqdU1+x+yFI7zHO7hQ folded on the Turn
Seat 3: jZaChyamGXWcP+qALPP5Jg collected ($2.25)
Seat 5: st9jtdNbm1W5GfBwRaCVqQ folded before Flop (didn't bet)
Seat 6: VBHxUExRAMrbxUq/cVx9Gw folded before Flop (didn't bet)
Seat 7: DnDcAdn9P0zGovMERigpFA (button) folded before Flop (didn't bet)
Seat 8: ghNKXUBl/H+t83JF079ZBA (small blind) folded before Flop
Seat 9: NTamLAiMZ86c5yM04t96LA (big blind) folded before Flop




PokerStars Game #59939503812:  Hold'em No Limit ($0.10/$0.25) - 2009/07/01 0:41:35 ET
Table 'ORSZkZqq+7Ja2PdeCFAytA' 9-max Seat #2 is the button
Seat 1: Gpa8cld5y0mdOomHJgHhlA ($8 in chips) 
Seat 2: yduPKWPzL8YlT5Zv/Nmrwg ($10.70 in chips) 
Seat 3: nm4Dj/f+jJEwKVsUnKh73g ($24.50 in chips) 
Seat 8: opOCI2p6kW0tINuVaAqmcQ ($41.40 in chips) 
nm4Dj/f+jJEwKVsUnKh73g: posts small blind $0.10
tYsOBqdU1+x+yFI7zHO7hQ: is sitting out 
opOCI2p6kW0tINuVaAqmcQ: posts big blind $0.25
*** HOLE CARDS ***
Gpa8cld5y0mdOomHJgHhlA: calls $0.25
tYsOBqdU1+x+yFI7zHO7hQ leaves the table
yduPKWPzL8YlT5Zv/Nmrwg: raises $10.45 to $10.70 and is all-in
nm4Dj/f+jJEwKVsUnKh73g: folds 
opOCI2p6kW0tINuVaAqmcQ: folds 
Gpa8cld5y0mdOomHJgHhlA: folds 
Uncalled bet ($10.45) returned to yduPKWPzL8YlT5Zv/Nmrwg
opOCI2p6kW0tINuVaAqmcQ leaves the table
yduPKWPzL8YlT5Zv/Nmrwg collected $0.85 from pot
yduPKWPzL8YlT5Zv/Nmrwg: doesn't show hand 
*** SUMMARY ***
Total pot $0.85 | Rake $0 
Seat 1: Gpa8cld5y0mdOomHJgHhlA folded before Flop
Seat 2: yduPKWPzL8YlT5Zv/Nmrwg (button) collected ($0.85)
Seat 3: nm4Dj/f+jJEwKVsUnKh73g (small blind) folded before Flop
Seat 8: opOCI2p6kW0tINuVaAqmcQ (big blind) folded before Flop




PokerStars Game #59939504868:  Hold'em No Limit ($0.10/$0.25) - 2009/07/01 0:41:36 ET
Table 'CM/C/FZf3VHIp50RjmBucQ' 9-max Seat #9 is the button
Seat 1: 1Clf3cPrqoy/YgvWdWK1Xw ($5 in chips) 
Seat 2: 1S/fpm+f42V/6MNZre+ccg ($28.10 in chips) 
Seat 3: dfNim92Z6XK1/h5SFW5vDg ($29.75 in chips) 
Seat 4: oXv2YWrxjhmEfQAgUx964Q ($24.45 in chips) 
Seat 5: TeWJxSETzbXGiYKx0y+dtg ($36.80 in chips) 
Seat 6: 4awUyiDYTgylQKXZ9faBVA ($29.45 in chips) 
Seat 8: cZ99hugmLBj9KhTlc8nCSw ($26.15 in chips) 
Seat 9: Yv4fucyyT28mjx8V5lxKJg ($21.15 in chips) 
1Clf3cPrqoy/YgvWdWK1Xw: posts small blind $0.10
1S/fpm+f42V/6MNZre+ccg: posts big blind $0.25
j4q3p0lesp63b1gZDwLBZw: sits out 
*** HOLE CARDS ***
dfNim92Z6XK1/h5SFW5vDg: folds 
oXv2YWrxjhmEfQAgUx964Q: calls $0.25
TeWJxSETzbXGiYKx0y+dtg: folds 
4awUyiDYTgylQKXZ9faBVA: folds 
cZ99hugmLBj9KhTlc8nCSw: folds 
Yv4fucyyT28mjx8V5lxKJg: folds 
1Clf3cPrqoy/YgvWdWK1Xw: folds 
1S/fpm+f42V/6MNZre+ccg: checks 
*** FLOP *** [Kc 5s 4d]
1S/fpm+f42V/6MNZre+ccg: checks 
oXv2YWrxjhmEfQAgUx964Q: bets $1.25
1S/fpm+f42V/6MNZre+ccg: folds 
Uncalled bet ($1.25) returned to oXv2YWrxjhmEfQAgUx964Q
oXv2YWrxjhmEfQAgUx964Q collected $0.60 from pot
oXv2YWrxjhmEfQAgUx964Q: doesn't show hand 
*** SUMMARY ***
Total pot $0.60 | Rake $0 
Board [Kc 5s 4d]
Seat 1: 1Clf3cPrqoy/YgvWdWK1Xw (small blind) folded before Flop
Seat 2: 1S/fpm+f42V/6MNZre+ccg (big blind) folded on the Flop
Seat 3: dfNim92Z6XK1/h5SFW5vDg folded before Flop (didn't bet)
Seat 4: oXv2YWrxjhmEfQAgUx964Q collected ($0.60)
Seat 5: TeWJxSETzbXGiYKx0y+dtg folded before Flop (didn't bet)
Seat 6: 4awUyiDYTgylQKXZ9faBVA folded before Flop (didn't bet)
Seat 8: cZ99hugmLBj9KhTlc8nCSw folded before Flop (didn't bet)
Seat 9: Yv4fucyyT28mjx8V5lxKJg (button) folded before Flop (didn't bet)




PokerStars Game #59939504850:  Hold'em No Limit ($0.10/$0.25) - 2009/07/01 0:41:36 ET
Table 'CBnRhp0d6E2+/NtM7Vbruw' 9-max Seat #8 is the button
Seat 1: WQe4GbiYBiPsb5WKFKkijQ ($4.50 in chips) 
Seat 2: DIBbjEYGs+TVdVgEB/4+3w ($36.15 in chips) 
Seat 4: FR1anYnrxOdUfdNDELZ4SQ ($19.35 in chips) 
Seat 5: R6nIVAjK7uhK3Hj0f85A+A ($26.90 in chips) 
Seat 6: PqvgxdSg9z5VmrWpbYuz+g ($23.20 in chips) 
Seat 7: 40uIA6odSc6GeRu392xZTA ($29.60 in chips) 
Seat 8: MG90wfSJZnOejs/KD3vlQQ ($35.70 in chips) 
Seat 9: BHKu5wmAIC0UlfmA78se7A ($4.75 in chips) 
BHKu5wmAIC0UlfmA78se7A: posts small blind $0.10
WQe4GbiYBiPsb5WKFKkijQ: posts big blind $0.25
aNpwfA31EREwO+ar4XzBCw: sits out 
PqvgxdSg9z5VmrWpbYuz+g: posts big blind $0.25
*** HOLE CARDS ***
DIBbjEYGs+TVdVgEB/4+3w: calls $0.25
FR1anYnrxOdUfdNDELZ4SQ: folds 
R6nIVAjK7uhK3Hj0f85A+A: folds 
PqvgxdSg9z5VmrWpbYuz+g: checks 
40uIA6odSc6GeRu392xZTA: folds 
MG90wfSJZnOejs/KD3vlQQ: folds 
BHKu5wmAIC0UlfmA78se7A: calls $0.15
WQe4GbiYBiPsb5WKFKkijQ: checks 
*** FLOP *** [8c Jc 7s]
BHKu5wmAIC0UlfmA78se7A: checks 
WQe4GbiYBiPsb5WKFKkijQ: bets $0.50
DIBbjEYGs+TVdVgEB/4+3w: folds 
PqvgxdSg9z5VmrWpbYuz+g: folds 
BHKu5wmAIC0UlfmA78se7A: folds 
Uncalled bet ($0.50) returned to WQe4GbiYBiPsb5WKFKkijQ
WQe4GbiYBiPsb5WKFKkijQ collected $0.95 from pot
*** SUMMARY ***
Total pot $1 | Rake $0.05 
Board [8c Jc 7s]
Seat 1: WQe4GbiYBiPsb5WKFKkijQ (big blind) collected ($0.95)
Seat 2: DIBbjEYGs+TVdVgEB/4+3w folded on the Flop
Seat 4: FR1anYnrxOdUfdNDELZ4SQ folded before Flop (didn't bet)
Seat 5: R6nIVAjK7uhK3Hj0f85A+A folded before Flop (didn't bet)
Seat 6: PqvgxdSg9z5VmrWpbYuz+g folded on the Flop
Seat 7: 40uIA6odSc6GeRu392xZTA folded before Flop (didn't bet)
Seat 8: MG90wfSJZnOejs/KD3vlQQ (button) folded before Flop (didn't bet)
Seat 9: BHKu5wmAIC0UlfmA78se7A (small blind) folded on the Flop




PokerStars Game #59939504476:  Hold'em No Limit ($0.10/$0.25) - 2009/07/01 0:41:36 ET
Table 'luMgmRPIo47e7iXDlheIwA' 6-max Seat #3 is the button
Seat 3: W6Y6au0wf7gRAlqJYgOezw ($14.85 in chips) 
Seat 4: n2OZezRXTtdzQt4SuIy8TQ ($25.65 in chips) 
W6Y6au0wf7gRAlqJYgOezw: posts small blind $0.10
n2OZezRXTtdzQt4SuIy8TQ: posts big blind $0.25
*** HOLE CARDS ***
kG34n23qFQA3nzdOJTQ1dA leaves the table
W6Y6au0wf7gRAlqJYgOezw: calls $0.15
n2OZezRXTtdzQt4SuIy8TQ: checks 
*** FLOP *** [8h Ts Jh]
z/jAqpWD9ifpbtEpwGyInw joins the table at seat #1 
n2OZezRXTtdzQt4SuIy8TQ: checks 
W6Y6au0wf7gRAlqJYgOezw: checks 
*** TURN *** [8h Ts Jh] [Jc]
n2OZezRXTtdzQt4SuIy8TQ: checks 
W6Y6au0wf7gRAlqJYgOezw: checks 
*** RIVER *** [8h Ts Jh Jc] [2s]
n2OZezRXTtdzQt4SuIy8TQ: checks 
W6Y6au0wf7gRAlqJYgOezw: checks 
*** SHOW DOWN ***
n2OZezRXTtdzQt4SuIy8TQ: shows [3d Td] (two pair, Jacks and Tens)
W6Y6au0wf7gRAlqJYgOezw: mucks hand 
n2OZezRXTtdzQt4SuIy8TQ collected $0.50 from pot
*** SUMMARY ***
Total pot $0.50 | Rake $0 
Board [8h Ts Jh Jc 2s]
Seat 3: W6Y6au0wf7gRAlqJYgOezw (button) (small blind) mucked
Seat 4: n2OZezRXTtdzQt4SuIy8TQ (big blind) showed [3d Td] and won ($0.50) with two pair, Jacks and Tens




PokerStars Game #59939504534:  Hold'em No Limit ($0.10/$0.25) - 2009/07/01 0:41:36 ET
Table 'ER5H84HUgJx7HyDLnELLeA' 6-max Seat #5 is the button
Seat 1: pjM/xh4+RG8zrxCobDgYDg ($15.85 in chips) 
Seat 2: nc79pm0LZRdhncq55evVqA ($48.50 in chips) 
Seat 4: tkRWn3WaJIfGmCXT2hPvJA ($18.90 in chips) 
Seat 5: mfrkWA3PTeYPkbO6hi98Aw ($23.05 in chips) 
Seat 6: 3zD3qLXT1bEffAoWGnc7wg ($30.60 in chips) 
3zD3qLXT1bEffAoWGnc7wg: posts small blind $0.10
pjM/xh4+RG8zrxCobDgYDg: posts big blind $0.25
*** HOLE CARDS ***
nc79pm0LZRdhncq55evVqA: folds 
tkRWn3WaJIfGmCXT2hPvJA: calls $0.25
2j+7KACUO5iqZ/NSvIH3vg leaves the table
mfrkWA3PTeYPkbO6hi98Aw: folds 
3zD3qLXT1bEffAoWGnc7wg: folds 
pjM/xh4+RG8zrxCobDgYDg: checks 
*** FLOP *** [2h 5h 9d]
BYxjLnV1/LL0aZcTbfAOvw joins the table at seat #3 
pjM/xh4+RG8zrxCobDgYDg: checks 
tkRWn3WaJIfGmCXT2hPvJA: bets $0.25
pjM/xh4+RG8zrxCobDgYDg: calls $0.25
*** TURN *** [2h 5h 9d] [3d]
pjM/xh4+RG8zrxCobDgYDg: bets $0.50
tkRWn3WaJIfGmCXT2hPvJA: calls $0.50
*** RIVER *** [2h 5h 9d 3d] [6h]
pjM/xh4+RG8zrxCobDgYDg: checks 
tkRWn3WaJIfGmCXT2hPvJA: bets $1.75
pjM/xh4+RG8zrxCobDgYDg: folds 
Uncalled bet ($1.75) returned to tkRWn3WaJIfGmCXT2hPvJA
tkRWn3WaJIfGmCXT2hPvJA collected $2 from pot
*** SUMMARY ***
Total pot $2.10 | Rake $0.10 
Board [2h 5h 9d 3d 6h]
Seat 1: pjM/xh4+RG8zrxCobDgYDg (big blind) folded on the River
Seat 2: nc79pm0LZRdhncq55evVqA folded before Flop (didn't bet)
Seat 4: tkRWn3WaJIfGmCXT2hPvJA collected ($2)
Seat 5: mfrkWA3PTeYPkbO6hi98Aw (button) folded before Flop (didn't bet)
Seat 6: 3zD3qLXT1bEffAoWGnc7wg (small blind) folded before Flop




PokerStars Game #59939504914:  Hold'em No Limit ($0.10/$0.25) - 2009/07/01 0:41:36 ET
Table '2AUmC2Rslg+QUbLfdgNdfg' 6-max Seat #4 is the button
Seat 1: lgP2sg9oZJsNSXCt7tbwRg ($16.25 in chips) 
Seat 2: CCxAG7iPVlAv3brCqrGBEg ($12.40 in chips) 
Seat 3: iauW7L/+7qzAuHow7CD75Q ($7.20 in chips) 
Seat 4: B6R6e73iyJNddUtXtvYr3Q ($47.95 in chips) 
Seat 5: 8ClCHtFXGNplITm+63KB+Q ($23.05 in chips) 
Seat 6: BvTq4Tu0zBOsniW3eFCnkQ ($33.40 in chips) 
8ClCHtFXGNplITm+63KB+Q: posts small blind $0.10
BvTq4Tu0zBOsniW3eFCnkQ: posts big blind $0.25
*** HOLE CARDS ***
lgP2sg9oZJsNSXCt7tbwRg: folds 
lgP2sg9oZJsNSXCt7tbwRg is sitting out
CCxAG7iPVlAv3brCqrGBEg: raises $0.50 to $0.75
iauW7L/+7qzAuHow7CD75Q: calls $0.75
B6R6e73iyJNddUtXtvYr3Q: folds 
8ClCHtFXGNplITm+63KB+Q: folds 
BvTq4Tu0zBOsniW3eFCnkQ: calls $0.50
*** FLOP *** [Ks Jc Ac]
BvTq4Tu0zBOsniW3eFCnkQ: checks 
CCxAG7iPVlAv3brCqrGBEg: bets $1.50
iauW7L/+7qzAuHow7CD75Q: folds 
BvTq4Tu0zBOsniW3eFCnkQ: folds 
Uncalled bet ($1.50) returned to CCxAG7iPVlAv3brCqrGBEg
CCxAG7iPVlAv3brCqrGBEg collected $2.25 from pot
*** SUMMARY ***
Total pot $2.35 | Rake $0.10 
Board [Ks Jc Ac]
Seat 1: lgP2sg9oZJsNSXCt7tbwRg folded before Flop (didn't bet)
Seat 2: CCxAG7iPVlAv3brCqrGBEg collected ($2.25)
Seat 3: iauW7L/+7qzAuHow7CD75Q folded on the Flop
Seat 4: B6R6e73iyJNddUtXtvYr3Q (button) folded before Flop (didn't bet)
Seat 5: 8ClCHtFXGNplITm+63KB+Q (small blind) folded before Flop
Seat 6: BvTq4Tu0zBOsniW3eFCnkQ (big blind) folded on the Flop




PokerStars Game #59939504820:  Hold'em No Limit ($0.10/$0.25) - 2009/07/01 0:41:36 ET
Table 'WY+lMaAoIdBZmwk27/RJCA' 6-max Seat #1 is the button
Seat 1: lYjWCpfCxX2kgcHY3v4Yow ($25 in chips) 
Seat 2: cPO/1/dTcZpLkQFm3jH3Rg ($25 in chips) 
Seat 3: 79Q62AM0VB++TQYiBlOYsA ($37.80 in chips) 
Seat 4: cGfAi40F+9odP4v0stvfiQ ($26.20 in chips) 
Seat 5: wKFJ513ucluNNiMlkXcDOQ ($30.20 in chips) 
Seat 6: I1TxPvWj8NfG8orglCinNA ($27.35 in chips) 
cPO/1/dTcZpLkQFm3jH3Rg: posts small blind $0.10
79Q62AM0VB++TQYiBlOYsA: posts big blind $0.25
*** HOLE CARDS ***
cGfAi40F+9odP4v0stvfiQ: calls $0.25
wKFJ513ucluNNiMlkXcDOQ: raises $1 to $1.25
I1TxPvWj8NfG8orglCinNA: folds 
lYjWCpfCxX2kgcHY3v4Yow: folds 
cPO/1/dTcZpLkQFm3jH3Rg: folds 
79Q62AM0VB++TQYiBlOYsA: folds 
cGfAi40F+9odP4v0stvfiQ: calls $1
*** FLOP *** [Qd Ks 3d]
cGfAi40F+9odP4v0stvfiQ: checks 
wKFJ513ucluNNiMlkXcDOQ: bets $2.25
cGfAi40F+9odP4v0stvfiQ: calls $2.25
*** TURN *** [Qd Ks 3d] [3s]
cGfAi40F+9odP4v0stvfiQ: checks 
wKFJ513ucluNNiMlkXcDOQ: checks 
*** RIVER *** [Qd Ks 3d 3s] [6h]
cGfAi40F+9odP4v0stvfiQ: bets $2
wKFJ513ucluNNiMlkXcDOQ: calls $2
*** SHOW DOWN ***
cGfAi40F+9odP4v0stvfiQ: shows [Ad Qs] (two pair, Queens and Threes)
wKFJ513ucluNNiMlkXcDOQ: mucks hand 
cGfAi40F+9odP4v0stvfiQ collected $10.80 from pot
*** SUMMARY ***
Total pot $11.35 | Rake $0.55 
Board [Qd Ks 3d 3s 6h]
Seat 1: lYjWCpfCxX2kgcHY3v4Yow (button) folded before Flop (didn't bet)
Seat 2: cPO/1/dTcZpLkQFm3jH3Rg (small blind) folded before Flop
Seat 3: 79Q62AM0VB++TQYiBlOYsA (big blind) folded before Flop
Seat 4: cGfAi40F+9odP4v0stvfiQ showed [Ad Qs] and won ($10.80) with two pair, Queens and Threes
Seat 5: wKFJ513ucluNNiMlkXcDOQ mucked
Seat 6: I1TxPvWj8NfG8orglCinNA folded before Flop (didn't bet)




PokerStars Game #59939504754:  Hold'em No Limit ($0.10/$0.25) - 2009/07/01 0:41:36 ET
Table 'KKcpZYT1qeSWLmZFp9A4KA' 9-max Seat #6 is the button
Seat 2: vZGoOTJLQLhkPj4I+LNGig ($26.75 in chips) 
Seat 3: j4q3p0lesp63b1gZDwLBZw ($5.25 in chips) 
Seat 4: Z3a37Ry74FVl+CBZtAONiA ($11.75 in chips) 
Seat 5: CbXUS6Z2rXZxL1AKduNtmQ ($33.25 in chips) 
Seat 6: 4awUyiDYTgylQKXZ9faBVA ($39.35 in chips) 
Seat 7: QEbIGci+itdw+re8RM5fZA ($25 in chips) 
QEbIGci+itdw+re8RM5fZA: posts small blind $0.10
vZGoOTJLQLhkPj4I+LNGig: posts big blind $0.25
*** HOLE CARDS ***
j4q3p0lesp63b1gZDwLBZw: folds 
Z3a37Ry74FVl+CBZtAONiA: raises $0.25 to $0.50
CbXUS6Z2rXZxL1AKduNtmQ: folds 
4awUyiDYTgylQKXZ9faBVA: folds 
CbXUS6Z2rXZxL1AKduNtmQ leaves the table
QEbIGci+itdw+re8RM5fZA: folds 
vZGoOTJLQLhkPj4I+LNGig: folds 
Uncalled bet ($0.25) returned to Z3a37Ry74FVl+CBZtAONiA
vZGoOTJLQLhkPj4I+LNGig leaves the table
Z3a37Ry74FVl+CBZtAONiA collected $0.60 from pot
Z3a37Ry74FVl+CBZtAONiA: doesn't show hand 
*** SUMMARY ***
Total pot $0.60 | Rake $0 
Seat 2: vZGoOTJLQLhkPj4I+LNGig (big blind) folded before Flop
Seat 3: j4q3p0lesp63b1gZDwLBZw folded before Flop (didn't bet)
Seat 4: Z3a37Ry74FVl+CBZtAONiA collected ($0.60)
Seat 5: CbXUS6Z2rXZxL1AKduNtmQ folded before Flop (didn't bet)
Seat 6: 4awUyiDYTgylQKXZ9faBVA (button) folded before Flop (didn't bet)
Seat 7: QEbIGci+itdw+re8RM5fZA (small blind) folded before Flop




PokerStars Game #59939505242:  Hold'em No Limit ($0.10/$0.25) - 2009/07/01 0:41:37 ET
Table 'Ok3oDLIsTc2+KxPcI0bAOA' 6-max Seat #3 is the button
Seat 1: agQm3ugZ3qSVYNgNu1ddeA ($27.05 in chips) 
Seat 2: oseFhpinoe+Zg4j5xyBjyQ ($30.35 in chips) 
Seat 3: I1TxPvWj8NfG8orglCinNA ($25 in chips) 
Seat 4: WMiAkibyLuLJ32VI20myug ($11.80 in chips) 
Seat 5: nc79pm0LZRdhncq55evVqA ($28.25 in chips) 
Seat 6: JFIAqU8lCZ0vWwEl4bdGsg ($29 in chips) 
WMiAkibyLuLJ32VI20myug: posts small blind $0.10
nc79pm0LZRdhncq55evVqA: posts big blind $0.25
*** HOLE CARDS ***
JFIAqU8lCZ0vWwEl4bdGsg: raises $0.60 to $0.85
agQm3ugZ3qSVYNgNu1ddeA: folds 
oseFhpinoe+Zg4j5xyBjyQ: folds 
I1TxPvWj8NfG8orglCinNA: folds 
WMiAkibyLuLJ32VI20myug: folds 
nc79pm0LZRdhncq55evVqA: folds 
Uncalled bet ($0.60) returned to JFIAqU8lCZ0vWwEl4bdGsg
JFIAqU8lCZ0vWwEl4bdGsg collected $0.60 from pot
JFIAqU8lCZ0vWwEl4bdGsg: doesn't show hand 
*** SUMMARY ***
Total pot $0.60 | Rake $0 
Seat 1: agQm3ugZ3qSVYNgNu1ddeA folded before Flop (didn't bet)
Seat 2: oseFhpinoe+Zg4j5xyBjyQ folded before Flop (didn't bet)
Seat 3: I1TxPvWj8NfG8orglCinNA (button) folded before Flop (didn't bet)
Seat 4: WMiAkibyLuLJ32VI20myug (small blind) folded before Flop
Seat 5: nc79pm0LZRdhncq55evVqA (big blind) folded before Flop
Seat 6: JFIAqU8lCZ0vWwEl4bdGsg collected ($0.60)




PokerStars Game #59939505208:  Hold'em No Limit ($0.10/$0.25) - 2009/07/01 0:41:37 ET
Table 'xmJKTGBeWCwutccj3YfupQ' 6-max Seat #4 is the button
Seat 1: sVbkVl4OznxBCfi66UB9vw ($59.55 in chips) 
Seat 2: BedjMfrlRfPgSq7CXpPAmg ($49.95 in chips) 
Seat 3: FStoHe64SQWqAsjya9pDkQ ($25 in chips) 
Seat 4: uWjhTVMpuIroxXcmD3Okug ($41.90 in chips) 
Seat 5: oBUDUfeUyCbZBsjxHZgSiw ($17.80 in chips) 
Seat 6: lYjWCpfCxX2kgcHY3v4Yow ($26 in chips) 
oBUDUfeUyCbZBsjxHZgSiw: posts small blind $0.10
lYjWCpfCxX2kgcHY3v4Yow: posts big blind $0.25
*** HOLE CARDS ***
uWjhTVMpuIroxXcmD3Okug said, "its cool ill live"
sVbkVl4OznxBCfi66UB9vw: folds 
BedjMfrlRfPgSq7CXpPAmg: folds 
FStoHe64SQWqAsjya9pDkQ: folds 
uWjhTVMpuIroxXcmD3Okug: folds 
oBUDUfeUyCbZBsjxHZgSiw: folds 
Uncalled bet ($0.15) returned to lYjWCpfCxX2kgcHY3v4Yow
lYjWCpfCxX2kgcHY3v4Yow collected $0.20 from pot
lYjWCpfCxX2kgcHY3v4Yow: doesn't show hand 
*** SUMMARY ***
Total pot $0.20 | Rake $0 
Seat 1: sVbkVl4OznxBCfi66UB9vw folded before Flop (didn't bet)
Seat 2: BedjMfrlRfPgSq7CXpPAmg folded before Flop (didn't bet)
Seat 3: FStoHe64SQWqAsjya9pDkQ folded before Flop (didn't bet)
Seat 4: uWjhTVMpuIroxXcmD3Okug (button) folded before Flop (didn't bet)
Seat 5: oBUDUfeUyCbZBsjxHZgSiw (small blind) folded before Flop
Seat 6: lYjWCpfCxX2kgcHY3v4Yow (big blind) collected ($0.20)




PokerStars Game #59939505132:  Hold'em No Limit ($0.10/$0.25) - 2009/07/01 0:41:37 ET
Table 'pAhiNHs/spaABQia+7gWNQ' 9-max Seat #7 is the button
Seat 1: /VQLorsEOrMfI+KamzNQEA ($4.70 in chips) 
Seat 3: xEQxarad8/T4jJdpZy5LGw ($9.95 in chips) 
Seat 5: /vn2Qu2dvc9AMMq46Ae0jA ($10.15 in chips) 
Seat 6: FinSxgTdEPV/yPQRl5uhmA ($48.70 in chips) 
Seat 7: 04UcDjK4SUEJctLqNtWFoQ ($9.40 in chips) 
Seat 8: vSkQm2EelzwRGDDQQk0Fqw ($13.80 in chips) 
vSkQm2EelzwRGDDQQk0Fqw: posts small blind $0.10
/VQLorsEOrMfI+KamzNQEA: posts big blind $0.25
vnCdP3GsLTKadDukKcJk/Q: sits out 
F7pnn6czNpHvRM55XcA2EA: sits out 
*** HOLE CARDS ***
xEQxarad8/T4jJdpZy5LGw: folds 
/vn2Qu2dvc9AMMq46Ae0jA: folds 
FinSxgTdEPV/yPQRl5uhmA: calls $0.25
04UcDjK4SUEJctLqNtWFoQ: folds 
vSkQm2EelzwRGDDQQk0Fqw: calls $0.15
/VQLorsEOrMfI+KamzNQEA: checks 
*** FLOP *** [Qh 9s 6h]
vSkQm2EelzwRGDDQQk0Fqw: bets $0.75
/VQLorsEOrMfI+KamzNQEA: folds 
FinSxgTdEPV/yPQRl5uhmA: folds 
Uncalled bet ($0.75) returned to vSkQm2EelzwRGDDQQk0Fqw
vSkQm2EelzwRGDDQQk0Fqw collected $0.75 from pot
vSkQm2EelzwRGDDQQk0Fqw: doesn't show hand 
*** SUMMARY ***
Total pot $0.75 | Rake $0 
Board [Qh 9s 6h]
Seat 1: /VQLorsEOrMfI+KamzNQEA (big blind) folded on the Flop
Seat 3: xEQxarad8/T4jJdpZy5LGw folded before Flop (didn't bet)
Seat 5: /vn2Qu2dvc9AMMq46Ae0jA folded before Flop (didn't bet)
Seat 6: FinSxgTdEPV/yPQRl5uhmA folded on the Flop
Seat 7: 04UcDjK4SUEJctLqNtWFoQ (button) folded before Flop (didn't bet)
Seat 8: vSkQm2EelzwRGDDQQk0Fqw (small blind) collected ($0.75)




PokerStars Game #59939505210:  Hold'em No Limit ($0.10/$0.25) - 2009/07/01 0:41:37 ET
Table 'IIO2q2znuuAXmiZ2qFTcmg' 6-max Seat #1 is the button
Seat 1: nwwpaieDRI0UPyVtChVHOg ($17.75 in chips) 
Seat 2: cS21pIxRHx5Gt42o7hPZzw ($16.95 in chips) 
Seat 3: hiTEr3yrERiQp3zHXRioVw ($13.90 in chips) 
Seat 4: 0HIrwssk0FQvyKULzUTtlg ($9.75 in chips) 
Seat 5: f9iRHw0d+kV7pbTYwF2+2g ($16.95 in chips) 
cS21pIxRHx5Gt42o7hPZzw: posts small blind $0.10
hiTEr3yrERiQp3zHXRioVw: posts big blind $0.25
*** HOLE CARDS ***
0HIrwssk0FQvyKULzUTtlg: folds 
f9iRHw0d+kV7pbTYwF2+2g: calls $0.25
nwwpaieDRI0UPyVtChVHOg: calls $0.25
cS21pIxRHx5Gt42o7hPZzw: folds 
hiTEr3yrERiQp3zHXRioVw: checks 
*** FLOP *** [2s Ad Js]
hiTEr3yrERiQp3zHXRioVw: checks 
f9iRHw0d+kV7pbTYwF2+2g: checks 
nwwpaieDRI0UPyVtChVHOg: checks 
*** TURN *** [2s Ad Js] [7s]
hiTEr3yrERiQp3zHXRioVw: checks 
f9iRHw0d+kV7pbTYwF2+2g: checks 
nwwpaieDRI0UPyVtChVHOg: bets $0.50
hiTEr3yrERiQp3zHXRioVw: folds 
f9iRHw0d+kV7pbTYwF2+2g: folds 
Uncalled bet ($0.50) returned to nwwpaieDRI0UPyVtChVHOg
nwwpaieDRI0UPyVtChVHOg collected $0.85 from pot
*** SUMMARY ***
Total pot $0.85 | Rake $0 
Board [2s Ad Js 7s]
Seat 1: nwwpaieDRI0UPyVtChVHOg (button) collected ($0.85)
Seat 2: cS21pIxRHx5Gt42o7hPZzw (small blind) folded before Flop
Seat 3: hiTEr3yrERiQp3zHXRioVw (big blind) folded on the Turn
Seat 4: 0HIrwssk0FQvyKULzUTtlg folded before Flop (didn't bet)
Seat 5: f9iRHw0d+kV7pbTYwF2+2g folded on the Turn




PokerStars Game #59939505446:  Hold'em No Limit ($0.10/$0.25) - 2009/07/01 0:41:37 ET
Table 'Rv0EYnRU8WwZiwx0Zo3X3w' 9-max Seat #2 is the button
Seat 1: opOCI2p6kW0tINuVaAqmcQ ($52.95 in chips) 
Seat 2: Xpyqpb+DURDWnyJ3xTEIFQ ($28.40 in chips) 
Seat 3: STkR8XvpjNv79OOMhrlh2w ($25 in chips) 
Seat 4: IDkfbfxTm9KJ+DMyGVH8rw ($12.05 in chips) 
Seat 5: h4ggJZYBXV0mEZzYPYKfeA ($20.85 in chips) 
Seat 6: 5hAPbqNrvJb8PtLiceXtlg ($15 in chips) 
Seat 7: Th3FldXKQW6hWVVPahaoOQ ($38.50 in chips) 
Seat 8: 10vzP4r6ldwGLbYHKd9www ($15 in chips) 
Seat 9: r1pFKMwWp74QwhfPWJOAyw ($6.60 in chips) 
STkR8XvpjNv79OOMhrlh2w: posts small blind $0.10
IDkfbfxTm9KJ+DMyGVH8rw: posts big blind $0.25
10vzP4r6ldwGLbYHKd9www: posts big blind $0.25
*** HOLE CARDS ***
h4ggJZYBXV0mEZzYPYKfeA: calls $0.25
5hAPbqNrvJb8PtLiceXtlg: folds 
Th3FldXKQW6hWVVPahaoOQ: folds 
10vzP4r6ldwGLbYHKd9www: checks 
r1pFKMwWp74QwhfPWJOAyw: folds 
opOCI2p6kW0tINuVaAqmcQ: folds 
Xpyqpb+DURDWnyJ3xTEIFQ: folds 
STkR8XvpjNv79OOMhrlh2w: calls $0.15
IDkfbfxTm9KJ+DMyGVH8rw: checks 
*** FLOP *** [2h Kh Td]
STkR8XvpjNv79OOMhrlh2w: checks 
IDkfbfxTm9KJ+DMyGVH8rw: checks 
h4ggJZYBXV0mEZzYPYKfeA: bets $0.75
10vzP4r6ldwGLbYHKd9www: folds 
STkR8XvpjNv79OOMhrlh2w: folds 
IDkfbfxTm9KJ+DMyGVH8rw: folds 
Uncalled bet ($0.75) returned to h4ggJZYBXV0mEZzYPYKfeA
h4ggJZYBXV0mEZzYPYKfeA collected $0.95 from pot
h4ggJZYBXV0mEZzYPYKfeA: doesn't show hand 
*** SUMMARY ***
Total pot $1 | Rake $0.05 
Board [2h Kh Td]
Seat 1: opOCI2p6kW0tINuVaAqmcQ folded before Flop (didn't bet)
Seat 2: Xpyqpb+DURDWnyJ3xTEIFQ (button) folded before Flop (didn't bet)
Seat 3: STkR8XvpjNv79OOMhrlh2w (small blind) folded on the Flop
Seat 4: IDkfbfxTm9KJ+DMyGVH8rw (big blind) folded on the Flop
Seat 5: h4ggJZYBXV0mEZzYPYKfeA collected ($0.95)
Seat 6: 5hAPbqNrvJb8PtLiceXtlg folded before Flop (didn't bet)
Seat 7: Th3FldXKQW6hWVVPahaoOQ folded before Flop (didn't bet)
Seat 8: 10vzP4r6ldwGLbYHKd9www folded on the Flop
Seat 9: r1pFKMwWp74QwhfPWJOAyw folded before Flop (didn't bet)




PokerStars Game #59939505432:  Hold'em No Limit ($0.10/$0.25) - 2009/07/01 0:41:37 ET
Table '4mnXP0EWt9mMZYzTIVDQ0w' 9-max Seat #8 is the button
Seat 1: PTFwg4rGxnfVvj2iP1OI2w ($14.10 in chips) 
Seat 2: j4q3p0lesp63b1gZDwLBZw ($6.50 in chips) 
Seat 4: E0iYnEVO2ho7dH3QcCjw7g ($20.45 in chips) 
Seat 5: sSN8Y0AlsBeidZXPKmwXSw ($12.90 in chips) 
Seat 6: n9toqYXSLowQ/sWq842dEQ ($10.25 in chips) 
Seat 7: s1y+qfkBnhgc67+X3ThjeA ($27.20 in chips) 
Seat 8: H9KUl8cmpLgEpOVDA00bCg ($4.30 in chips) 
Seat 9: wbCayoP+N6xpKgOfIqZsbA ($21.95 in chips) 
wbCayoP+N6xpKgOfIqZsbA: posts small blind $0.10
PTFwg4rGxnfVvj2iP1OI2w: posts big blind $0.25
*** HOLE CARDS ***
j4q3p0lesp63b1gZDwLBZw: folds 
E0iYnEVO2ho7dH3QcCjw7g: folds 
sSN8Y0AlsBeidZXPKmwXSw: raises $0.75 to $1
n9toqYXSLowQ/sWq842dEQ has timed out
n9toqYXSLowQ/sWq842dEQ: folds 
n9toqYXSLowQ/sWq842dEQ is sitting out
s1y+qfkBnhgc67+X3ThjeA: folds 
H9KUl8cmpLgEpOVDA00bCg: folds 
wbCayoP+N6xpKgOfIqZsbA: folds 
PTFwg4rGxnfVvj2iP1OI2w: folds 
Uncalled bet ($0.75) returned to sSN8Y0AlsBeidZXPKmwXSw
sSN8Y0AlsBeidZXPKmwXSw collected $0.60 from pot
*** SUMMARY ***
Total pot $0.60 | Rake $0 
Seat 1: PTFwg4rGxnfVvj2iP1OI2w (big blind) folded before Flop
Seat 2: j4q3p0lesp63b1gZDwLBZw folded before Flop (didn't bet)
Seat 4: E0iYnEVO2ho7dH3QcCjw7g folded before Flop (didn't bet)
Seat 5: sSN8Y0AlsBeidZXPKmwXSw collected ($0.60)
Seat 6: n9toqYXSLowQ/sWq842dEQ folded before Flop (didn't bet)
Seat 7: s1y+qfkBnhgc67+X3ThjeA folded before Flop (didn't bet)
Seat 8: H9KUl8cmpLgEpOVDA00bCg (button) folded before Flop (didn't bet)
Seat 9: wbCayoP+N6xpKgOfIqZsbA (small blind) folded before Flop




PokerStars Game #59939505366:  Hold'em No Limit ($0.10/$0.25) - 2009/07/01 0:41:37 ET
Table 'fRxOyfaHXkWUDLv4eSxFew' 9-max Seat #8 is the button
Seat 1: OlPJsgR4xypSg/w1z7Gyvw ($20 in chips) 
Seat 2: TeWJxSETzbXGiYKx0y+dtg ($25 in chips) 
Seat 3: hBMUlEpyU74r/fwDgIpXjQ ($26.05 in chips) 
Seat 4: aCVg6cCxQcqClhB9nq/p1w ($51.50 in chips) 
Seat 6: N/O9ADKpmqB2ASZuqgodlw ($7.50 in chips) 
Seat 7: 7cv+9Zc9HIQHNvYsMfV3uA ($54.05 in chips) 
Seat 8: 1K6QGyJP9P9xmRac2fH4OQ ($25 in chips) 
Seat 9: H5Se03ZqSX7tbULXur2MAg ($23.55 in chips) 
H5Se03ZqSX7tbULXur2MAg: posts small blind $0.10
OlPJsgR4xypSg/w1z7Gyvw: posts big blind $0.25
*** HOLE CARDS ***
TeWJxSETzbXGiYKx0y+dtg: folds 
hBMUlEpyU74r/fwDgIpXjQ: folds 
aCVg6cCxQcqClhB9nq/p1w: folds 
N/O9ADKpmqB2ASZuqgodlw: raises $1 to $1.25
7cv+9Zc9HIQHNvYsMfV3uA: folds 
aCVg6cCxQcqClhB9nq/p1w leaves the table
1K6QGyJP9P9xmRac2fH4OQ: folds 
H5Se03ZqSX7tbULXur2MAg: folds 
OlPJsgR4xypSg/w1z7Gyvw: folds 
Uncalled bet ($1) returned to N/O9ADKpmqB2ASZuqgodlw
N/O9ADKpmqB2ASZuqgodlw collected $0.60 from pot
*** SUMMARY ***
Total pot $0.60 | Rake $0 
Seat 1: OlPJsgR4xypSg/w1z7Gyvw (big blind) folded before Flop
Seat 2: TeWJxSETzbXGiYKx0y+dtg folded before Flop (didn't bet)
Seat 3: hBMUlEpyU74r/fwDgIpXjQ folded before Flop (didn't bet)
Seat 4: aCVg6cCxQcqClhB9nq/p1w folded before Flop (didn't bet)
Seat 6: N/O9ADKpmqB2ASZuqgodlw collected ($0.60)
Seat 7: 7cv+9Zc9HIQHNvYsMfV3uA folded before Flop (didn't bet)
Seat 8: 1K6QGyJP9P9xmRac2fH4OQ (button) folded before Flop (didn't bet)
Seat 9: H5Se03ZqSX7tbULXur2MAg (small blind) folded before Flop




PokerStars Game #59939505920:  Hold'em No Limit ($0.10/$0.25) - 2009/07/01 0:41:38 ET
Table 'aT31tt16YvQM/Ue69HPLpA' 9-max Seat #7 is the button
Seat 1: uYY6p3irj4hBN7IeHiNGSw ($24.75 in chips) 
Seat 3: tYsOBqdU1+x+yFI7zHO7hQ ($26.65 in chips) 
Seat 4: s7Q6uNouhe7aE8JdFb9E+A ($25 in chips) 
Seat 5: cvtKnIIaTx2+P/KlOK+tfQ ($11.15 in chips) 
Seat 6: 7cv+9Zc9HIQHNvYsMfV3uA ($42.75 in chips) 
Seat 7: s8SPJjToEJz2mPsHsMqL0A ($5.35 in chips) 
Seat 8: lrTLp1zpuCCs/e0pi2M8jw ($44.10 in chips) 
Seat 9: SXqVW4Q0evTUVZG6BbUNIA ($30 in chips) 
lrTLp1zpuCCs/e0pi2M8jw: posts small blind $0.10
SXqVW4Q0evTUVZG6BbUNIA: posts big blind $0.25
CYkY0dNBaYaKs8HVCVn3mQ: sits out 
*** HOLE CARDS ***
uYY6p3irj4hBN7IeHiNGSw: calls $0.25
tYsOBqdU1+x+yFI7zHO7hQ: folds 
s7Q6uNouhe7aE8JdFb9E+A: folds 
cvtKnIIaTx2+P/KlOK+tfQ: folds 
7cv+9Zc9HIQHNvYsMfV3uA: folds 
s8SPJjToEJz2mPsHsMqL0A: calls $0.25
lrTLp1zpuCCs/e0pi2M8jw: calls $0.15
SXqVW4Q0evTUVZG6BbUNIA: checks 
*** FLOP *** [4s 6c 8h]
lrTLp1zpuCCs/e0pi2M8jw: checks 
SXqVW4Q0evTUVZG6BbUNIA: checks 
uYY6p3irj4hBN7IeHiNGSw: checks 
s8SPJjToEJz2mPsHsMqL0A: checks 
*** TURN *** [4s 6c 8h] [Ac]
lrTLp1zpuCCs/e0pi2M8jw: checks 
SXqVW4Q0evTUVZG6BbUNIA: checks 
uYY6p3irj4hBN7IeHiNGSw: bets $0.50
s8SPJjToEJz2mPsHsMqL0A: calls $0.50
lrTLp1zpuCCs/e0pi2M8jw: folds 
SXqVW4Q0evTUVZG6BbUNIA: folds 
*** RIVER *** [4s 6c 8h Ac] [Qh]
uYY6p3irj4hBN7IeHiNGSw: checks 
s8SPJjToEJz2mPsHsMqL0A: checks 
*** SHOW DOWN ***
uYY6p3irj4hBN7IeHiNGSw: shows [7h 9h] (high card Ace)
s8SPJjToEJz2mPsHsMqL0A: shows [5d Qs] (a pair of Queens)
s8SPJjToEJz2mPsHsMqL0A collected $1.95 from pot
*** SUMMARY ***
Total pot $2 | Rake $0.05 
Board [4s 6c 8h Ac Qh]
Seat 1: uYY6p3irj4hBN7IeHiNGSw showed [7h 9h] and lost with high card Ace
Seat 3: tYsOBqdU1+x+yFI7zHO7hQ folded before Flop (didn't bet)
Seat 4: s7Q6uNouhe7aE8JdFb9E+A folded before Flop (didn't bet)
Seat 5: cvtKnIIaTx2+P/KlOK+tfQ folded before Flop (didn't bet)
Seat 6: 7cv+9Zc9HIQHNvYsMfV3uA folded before Flop (didn't bet)
Seat 7: s8SPJjToEJz2mPsHsMqL0A (button) showed [5d Qs] and won ($1.95) with a pair of Queens
Seat 8: lrTLp1zpuCCs/e0pi2M8jw (small blind) folded on the Turn
Seat 9: SXqVW4Q0evTUVZG6BbUNIA (big blind) folded on the Turn




PokerStars Game #59939506256:  Hold'em No Limit ($0.10/$0.25) - 2009/07/01 0:41:38 ET
Table 'h3+tJ4Vtwq0R+eA8S73eZA' 9-max Seat #6 is the button
Seat 1: H5Se03ZqSX7tbULXur2MAg ($20.90 in chips) 
Seat 2: Th3FldXKQW6hWVVPahaoOQ ($27.40 in chips) 
Seat 3: crgjVDgmUqCw4RyLzbohWQ ($17 in chips) 
Seat 4: M2QO2DxB5Wawg2h8HSpnYA ($11.95 in chips) 
Seat 5: cZ99hugmLBj9KhTlc8nCSw ($31.45 in chips) 
Seat 6: TvIuLx9zUCE+9Li58iImOQ ($7.25 in chips) 
Seat 7: IIGtqtVGyvZR0ZMYMMPjeQ ($27.25 in chips) 
Seat 8: +2kMBNpY4nF1qNCRd8SJLA ($25 in chips) 
Seat 9: qwr38jl5txoR36M7G5qi4A ($8.05 in chips) 
IIGtqtVGyvZR0ZMYMMPjeQ: posts small blind $0.10
+2kMBNpY4nF1qNCRd8SJLA: posts big blind $0.25
*** HOLE CARDS ***
qwr38jl5txoR36M7G5qi4A: folds 
H5Se03ZqSX7tbULXur2MAg: folds 
Th3FldXKQW6hWVVPahaoOQ: folds 
crgjVDgmUqCw4RyLzbohWQ: folds 
M2QO2DxB5Wawg2h8HSpnYA: folds 
cZ99hugmLBj9KhTlc8nCSw: folds 
TvIuLx9zUCE+9Li58iImOQ: folds 
IIGtqtVGyvZR0ZMYMMPjeQ: calls $0.15
+2kMBNpY4nF1qNCRd8SJLA: raises $1 to $1.25
IIGtqtVGyvZR0ZMYMMPjeQ: folds 
Uncalled bet ($1) returned to +2kMBNpY4nF1qNCRd8SJLA
+2kMBNpY4nF1qNCRd8SJLA collected $0.50 from pot
*** SUMMARY ***
Total pot $0.50 | Rake $0 
Seat 1: H5Se03ZqSX7tbULXur2MAg folded before Flop (didn't bet)
Seat 2: Th3FldXKQW6hWVVPahaoOQ folded before Flop (didn't bet)
Seat 3: crgjVDgmUqCw4RyLzbohWQ folded before Flop (didn't bet)
Seat 4: M2QO2DxB5Wawg2h8HSpnYA folded before Flop (didn't bet)
Seat 5: cZ99hugmLBj9KhTlc8nCSw folded before Flop (didn't bet)
Seat 6: TvIuLx9zUCE+9Li58iImOQ (button) folded before Flop (didn't bet)
Seat 7: IIGtqtVGyvZR0ZMYMMPjeQ (small blind) folded before Flop
Seat 8: +2kMBNpY4nF1qNCRd8SJLA (big blind) collected ($0.50)
Seat 9: qwr38jl5txoR36M7G5qi4A folded before Flop (didn't bet)




PokerStars Game #59939506310:  Hold'em No Limit ($0.10/$0.25) - 2009/07/01 0:41:38 ET
Table '3eK1r4Q4BSYFvsKkuTLpIA' 9-max Seat #2 is the button
Seat 1: qwr38jl5txoR36M7G5qi4A ($7.75 in chips) 
Seat 2: 7QzbjWT00wQpau1iqvUmMA ($4.65 in chips) 
Seat 3: 56S3mA6Zs3pGR+0p0vUCtg ($31.05 in chips) 
Seat 4: S2iyN4Q7njjhguIuE5g1CQ ($25.30 in chips) 
Seat 5: 1K6QGyJP9P9xmRac2fH4OQ ($31.90 in chips) 
Seat 6: +HvCCmsGSQeatf+GZ9zk8Q ($18.75 in chips) 
Seat 7: GTcLfsDTPqgfHyhY9FNDMw ($8 in chips) 
Seat 8: Cni99AOp8W/F0ZWCuHNcIA ($12.65 in chips) 
Seat 9: +sbyWwIcFp9kP0bDtMegfQ ($37.75 in chips) 
56S3mA6Zs3pGR+0p0vUCtg: posts small blind $0.10
S2iyN4Q7njjhguIuE5g1CQ: posts big blind $0.25
*** HOLE CARDS ***
1K6QGyJP9P9xmRac2fH4OQ: folds 
+HvCCmsGSQeatf+GZ9zk8Q: raises $1 to $1.25
GTcLfsDTPqgfHyhY9FNDMw: folds 
Cni99AOp8W/F0ZWCuHNcIA: calls $1.25
+sbyWwIcFp9kP0bDtMegfQ: folds 
qwr38jl5txoR36M7G5qi4A: folds 
7QzbjWT00wQpau1iqvUmMA: folds 
56S3mA6Zs3pGR+0p0vUCtg: folds 
S2iyN4Q7njjhguIuE5g1CQ: folds 
*** FLOP *** [Kd 3d 4s]
S2iyN4Q7njjhguIuE5g1CQ is sitting out
+HvCCmsGSQeatf+GZ9zk8Q: bets $2
Cni99AOp8W/F0ZWCuHNcIA: folds 
Uncalled bet ($2) returned to +HvCCmsGSQeatf+GZ9zk8Q
+HvCCmsGSQeatf+GZ9zk8Q collected $2.75 from pot
+HvCCmsGSQeatf+GZ9zk8Q: doesn't show hand 
*** SUMMARY ***
Total pot $2.85 | Rake $0.10 
Board [Kd 3d 4s]
Seat 1: qwr38jl5txoR36M7G5qi4A folded before Flop (didn't bet)
Seat 2: 7QzbjWT00wQpau1iqvUmMA (button) folded before Flop (didn't bet)
Seat 3: 56S3mA6Zs3pGR+0p0vUCtg (small blind) folded before Flop
Seat 4: S2iyN4Q7njjhguIuE5g1CQ (big blind) folded before Flop
Seat 5: 1K6QGyJP9P9xmRac2fH4OQ folded before Flop (didn't bet)
Seat 6: +HvCCmsGSQeatf+GZ9zk8Q collected ($2.75)
Seat 7: GTcLfsDTPqgfHyhY9FNDMw folded before Flop (didn't bet)
Seat 8: Cni99AOp8W/F0ZWCuHNcIA folded on the Flop
Seat 9: +sbyWwIcFp9kP0bDtMegfQ folded before Flop (didn't bet)




PokerStars Game #59939506076:  Hold'em No Limit ($0.10/$0.25) - 2009/07/01 0:41:38 ET
Table 'i8VqsSY3xDtJ63IHleN8+A' 9-max Seat #2 is the button
Seat 1: D3XCkXRktDfPlSguxwfnRA ($15.15 in chips) 
Seat 2: SXqVW4Q0evTUVZG6BbUNIA ($46.50 in chips) 
Seat 3: HPEB+AtKw1+C/cxU0o1ciw ($55.95 in chips) 
Seat 4: G2offPrpnppc++nuXqs2JA ($15.15 in chips) 
Seat 5: DIBbjEYGs+TVdVgEB/4+3w ($24.90 in chips) 
Seat 6: Xpyqpb+DURDWnyJ3xTEIFQ ($24.75 in chips) 
Seat 7: j4q3p0lesp63b1gZDwLBZw ($6 in chips) 
Seat 8: 5MgYq10OC5iGoxQFwlJVuw ($12.70 in chips) 
Seat 9: vSkQm2EelzwRGDDQQk0Fqw ($7.20 in chips) 
HPEB+AtKw1+C/cxU0o1ciw: posts small blind $0.10
G2offPrpnppc++nuXqs2JA: posts big blind $0.25
*** HOLE CARDS ***
DIBbjEYGs+TVdVgEB/4+3w: folds 
Xpyqpb+DURDWnyJ3xTEIFQ: folds 
j4q3p0lesp63b1gZDwLBZw: raises $0.75 to $1
5MgYq10OC5iGoxQFwlJVuw: calls $1
vSkQm2EelzwRGDDQQk0Fqw: folds 
D3XCkXRktDfPlSguxwfnRA: folds 
SXqVW4Q0evTUVZG6BbUNIA: folds 
HPEB+AtKw1+C/cxU0o1ciw: folds 
G2offPrpnppc++nuXqs2JA: folds 
*** FLOP *** [Qc 5c Kc]
j4q3p0lesp63b1gZDwLBZw: bets $1.75
5MgYq10OC5iGoxQFwlJVuw: calls $1.75
*** TURN *** [Qc 5c Kc] [Td]
j4q3p0lesp63b1gZDwLBZw: bets $3.25 and is all-in
5MgYq10OC5iGoxQFwlJVuw: calls $3.25
*** RIVER *** [Qc 5c Kc Td] [7h]
*** SHOW DOWN ***
j4q3p0lesp63b1gZDwLBZw: shows [Ad Kd] (a pair of Kings)
5MgYq10OC5iGoxQFwlJVuw: shows [Ac Tc] (a flush, Ace high)
5MgYq10OC5iGoxQFwlJVuw collected $11.75 from pot
*** SUMMARY ***
Total pot $12.35 | Rake $0.60 
Board [Qc 5c Kc Td 7h]
Seat 1: D3XCkXRktDfPlSguxwfnRA folded before Flop (didn't bet)
Seat 2: SXqVW4Q0evTUVZG6BbUNIA (button) folded before Flop (didn't bet)
Seat 3: HPEB+AtKw1+C/cxU0o1ciw (small blind) folded before Flop
Seat 4: G2offPrpnppc++nuXqs2JA (big blind) folded before Flop
Seat 5: DIBbjEYGs+TVdVgEB/4+3w folded before Flop (didn't bet)
Seat 6: Xpyqpb+DURDWnyJ3xTEIFQ folded before Flop (didn't bet)
Seat 7: j4q3p0lesp63b1gZDwLBZw showed [Ad Kd] and lost with a pair of Kings
Seat 8: 5MgYq10OC5iGoxQFwlJVuw showed [Ac Tc] and won ($11.75) with a flush, Ace high
Seat 9: vSkQm2EelzwRGDDQQk0Fqw folded before Flop (didn't bet)




PokerStars Game #59939506182:  Hold'em No Limit ($0.10/$0.25) - 2009/07/01 0:41:38 ET
Table '84TjTrgbsYZladOc4PWf4Q' 6-max Seat #4 is the button
Seat 1: 79ID/ub1Pt/mDpCprVmOoA ($29.65 in chips) 
Seat 2: qGHGf/553gQnDoklMRe3tg ($31.90 in chips) 
Seat 4: SxIIgwXYLkwd6m3wLyPTCw ($25 in chips) 
Seat 5: SFmT9ZsVopnukjvAzrxTRg ($36.95 in chips) 
Seat 6: 7qRk4YH4/k/08LgJSv7rBQ ($25 in chips) 
SFmT9ZsVopnukjvAzrxTRg: posts small blind $0.10
7qRk4YH4/k/08LgJSv7rBQ: posts big blind $0.25
*** HOLE CARDS ***
79ID/ub1Pt/mDpCprVmOoA: raises $0.50 to $0.75
qGHGf/553gQnDoklMRe3tg: folds 
SxIIgwXYLkwd6m3wLyPTCw: folds 
SFmT9ZsVopnukjvAzrxTRg: folds 
7qRk4YH4/k/08LgJSv7rBQ: folds 
Uncalled bet ($0.50) returned to 79ID/ub1Pt/mDpCprVmOoA
79ID/ub1Pt/mDpCprVmOoA collected $0.60 from pot
79ID/ub1Pt/mDpCprVmOoA: doesn't show hand 
*** SUMMARY ***
Total pot $0.60 | Rake $0 
Seat 1: 79ID/ub1Pt/mDpCprVmOoA collected ($0.60)
Seat 2: qGHGf/553gQnDoklMRe3tg folded before Flop (didn't bet)
Seat 4: SxIIgwXYLkwd6m3wLyPTCw (button) folded before Flop (didn't bet)
Seat 5: SFmT9ZsVopnukjvAzrxTRg (small blind) folded before Flop
Seat 6: 7qRk4YH4/k/08LgJSv7rBQ (big blind) folded before Flop




PokerStars Game #59939506188:  Hold'em No Limit ($0.10/$0.25) - 2009/07/01 0:41:38 ET
Table 'o0CDOvKO/bn1WjeymDrXfA' 6-max Seat #5 is the button
Seat 1: 32YL2ZEp8NT4JB2RVM9euQ ($16.60 in chips) 
Seat 2: oc4ZGs0W+3RIg2yPyJw3ig ($31.45 in chips) 
Seat 3: EqXTTLKUlDlz7yi6ziyyWA ($9.50 in chips) 
Seat 5: u/yN5P9f3KlATg6WLWNkBQ ($28.50 in chips) 
Seat 6: Bada343Si4xKu3fNXY99AA ($20.70 in chips) 
Bada343Si4xKu3fNXY99AA: posts small blind $0.10
32YL2ZEp8NT4JB2RVM9euQ: posts big blind $0.25
HotTillt: sits out 
*** HOLE CARDS ***
oc4ZGs0W+3RIg2yPyJw3ig: raises $0.75 to $1
EqXTTLKUlDlz7yi6ziyyWA: raises $2.50 to $3.50
u/yN5P9f3KlATg6WLWNkBQ: folds 
Bada343Si4xKu3fNXY99AA: folds 
32YL2ZEp8NT4JB2RVM9euQ: folds 
oc4ZGs0W+3RIg2yPyJw3ig: folds 
Uncalled bet ($2.50) returned to EqXTTLKUlDlz7yi6ziyyWA
EqXTTLKUlDlz7yi6ziyyWA collected $2.35 from pot
EqXTTLKUlDlz7yi6ziyyWA: doesn't show hand 
*** SUMMARY ***
Total pot $2.35 | Rake $0 
Seat 1: 32YL2ZEp8NT4JB2RVM9euQ (big blind) folded before Flop
Seat 2: oc4ZGs0W+3RIg2yPyJw3ig folded before Flop
Seat 3: EqXTTLKUlDlz7yi6ziyyWA collected ($2.35)
Seat 5: u/yN5P9f3KlATg6WLWNkBQ (button) folded before Flop (didn't bet)
Seat 6: Bada343Si4xKu3fNXY99AA (small blind) folded before Flop




PokerStars Game #59939505746:  Hold'em No Limit ($0.10/$0.25) - 2009/07/01 0:41:38 ET
Table 'AHkg4ChqzcMauBx6Qvz8Nw' 6-max Seat #2 is the button
Seat 1: b32FRB7ak2jmfrI8EsDhfQ ($13 in chips) 
Seat 2: /bjna2FTN7pPjqYGzmDE0Q ($21.70 in chips) 
Seat 3: Zi4SmoY9XJ0iI6ixiSZaWQ ($8.50 in chips) 
Seat 4: N7O9jUEx2YiQn1+yRYTHmw ($19.45 in chips) 
Seat 5: LtASJ9OlkqGrrUKGQlpGAw ($37.05 in chips) 
Seat 6: SFmT9ZsVopnukjvAzrxTRg ($53.05 in chips) 
Zi4SmoY9XJ0iI6ixiSZaWQ: posts small blind $0.10
N7O9jUEx2YiQn1+yRYTHmw: posts big blind $0.25
*** HOLE CARDS ***
LtASJ9OlkqGrrUKGQlpGAw: folds 
SFmT9ZsVopnukjvAzrxTRg: folds 
b32FRB7ak2jmfrI8EsDhfQ: raises $12.75 to $13 and is all-in
/bjna2FTN7pPjqYGzmDE0Q: folds 
Zi4SmoY9XJ0iI6ixiSZaWQ: calls $8.40 and is all-in
N7O9jUEx2YiQn1+yRYTHmw: folds 
Uncalled bet ($4.50) returned to b32FRB7ak2jmfrI8EsDhfQ
*** FLOP *** [Ad 3c Jc]
*** TURN *** [Ad 3c Jc] [6c]
*** RIVER *** [Ad 3c Jc 6c] [5s]
*** SHOW DOWN ***
Zi4SmoY9XJ0iI6ixiSZaWQ: shows [7d Ah] (a pair of Aces)
b32FRB7ak2jmfrI8EsDhfQ: mucks hand 
Zi4SmoY9XJ0iI6ixiSZaWQ collected $16.40 from pot
*** SUMMARY ***
Total pot $17.25 | Rake $0.85 
Board [Ad 3c Jc 6c 5s]
Seat 1: b32FRB7ak2jmfrI8EsDhfQ mucked
Seat 2: /bjna2FTN7pPjqYGzmDE0Q (button) folded before Flop (didn't bet)
Seat 3: Zi4SmoY9XJ0iI6ixiSZaWQ (small blind) showed [7d Ah] and won ($16.40) with a pair of Aces
Seat 4: N7O9jUEx2YiQn1+yRYTHmw (big blind) folded before Flop
Seat 5: LtASJ9OlkqGrrUKGQlpGAw folded before Flop (didn't bet)
Seat 6: SFmT9ZsVopnukjvAzrxTRg folded before Flop (didn't bet)




PokerStars Game #59939505950:  Hold'em No Limit ($0.10/$0.25) - 2009/07/01 0:41:38 ET
Table 'AchTjdLS1zBUbH3ZIx6f0w' 6-max Seat #3 is the button
Seat 1: IzVI+wIP7IS+d0sugIrOPQ ($25.30 in chips) 
Seat 2: kG34n23qFQA3nzdOJTQ1dA ($40.20 in chips) 
Seat 3: ehifenV36yVvJMnV63D3cg ($2.35 in chips) 
Seat 4: q6WfTUAD9mowIP63ASq2Dg ($26.45 in chips) 
Seat 5: oBUDUfeUyCbZBsjxHZgSiw ($37.70 in chips) 
Seat 6: 5tB0F9NjPSUL4FzmzBMs2Q ($25 in chips) 
q6WfTUAD9mowIP63ASq2Dg: posts small blind $0.10
oBUDUfeUyCbZBsjxHZgSiw: posts big blind $0.25
*** HOLE CARDS ***
5tB0F9NjPSUL4FzmzBMs2Q: folds 
IzVI+wIP7IS+d0sugIrOPQ: calls $0.25
kG34n23qFQA3nzdOJTQ1dA: calls $0.25
ehifenV36yVvJMnV63D3cg: folds 
q6WfTUAD9mowIP63ASq2Dg: calls $0.15
oBUDUfeUyCbZBsjxHZgSiw: checks 
*** FLOP *** [9d 2h Qc]
q6WfTUAD9mowIP63ASq2Dg: bets $0.80
oBUDUfeUyCbZBsjxHZgSiw: folds 
IzVI+wIP7IS+d0sugIrOPQ: folds 
kG34n23qFQA3nzdOJTQ1dA: folds 
Uncalled bet ($0.80) returned to q6WfTUAD9mowIP63ASq2Dg
q6WfTUAD9mowIP63ASq2Dg collected $0.95 from pot
*** SUMMARY ***
Total pot $1 | Rake $0.05 
Board [9d 2h Qc]
Seat 1: IzVI+wIP7IS+d0sugIrOPQ folded on the Flop
Seat 2: kG34n23qFQA3nzdOJTQ1dA folded on the Flop
Seat 3: ehifenV36yVvJMnV63D3cg (button) folded before Flop (didn't bet)
Seat 4: q6WfTUAD9mowIP63ASq2Dg (small blind) collected ($0.95)
Seat 5: oBUDUfeUyCbZBsjxHZgSiw (big blind) folded on the Flop
Seat 6: 5tB0F9NjPSUL4FzmzBMs2Q folded before Flop (didn't bet)




PokerStars Game #59939506480:  Hold'em No Limit ($0.10/$0.25) - 2009/07/01 0:41:39 ET
Table 'nB7Q7zfNfy6ig6DB+rsgWQ' 6-max Seat #4 is the button
Seat 1: ACU3rO57RhDJfAgHTq2ocA ($4.70 in chips) 
Seat 2: g6kf+5FIgWH33PmH6ZecMQ ($15.60 in chips) 
Seat 3: p3NYOxYhkL7txPRSeXHDeg ($34.75 in chips) 
Seat 4: YZjG5I7FqwMKy06BKVBS7w ($7.95 in chips) 
Seat 5: X0/5h4o4LdHWlM7o/9shzg ($7.05 in chips) 
Seat 6: BYxjLnV1/LL0aZcTbfAOvw ($39.90 in chips) 
X0/5h4o4LdHWlM7o/9shzg: posts small blind $0.10
BYxjLnV1/LL0aZcTbfAOvw: posts big blind $0.25
*** HOLE CARDS ***
ACU3rO57RhDJfAgHTq2ocA: calls $0.25
g6kf+5FIgWH33PmH6ZecMQ: folds 
p3NYOxYhkL7txPRSeXHDeg: folds 
YZjG5I7FqwMKy06BKVBS7w: folds 
X0/5h4o4LdHWlM7o/9shzg: calls $0.15
BYxjLnV1/LL0aZcTbfAOvw: raises $1.25 to $1.50
ACU3rO57RhDJfAgHTq2ocA: folds 
X0/5h4o4LdHWlM7o/9shzg: folds 
Uncalled bet ($1.25) returned to BYxjLnV1/LL0aZcTbfAOvw
BYxjLnV1/LL0aZcTbfAOvw collected $0.75 from pot
BYxjLnV1/LL0aZcTbfAOvw: doesn't show hand 
*** SUMMARY ***
Total pot $0.75 | Rake $0 
Seat 1: ACU3rO57RhDJfAgHTq2ocA folded before Flop
Seat 2: g6kf+5FIgWH33PmH6ZecMQ folded before Flop (didn't bet)
Seat 3: p3NYOxYhkL7txPRSeXHDeg folded before Flop (didn't bet)
Seat 4: YZjG5I7FqwMKy06BKVBS7w (button) folded before Flop (didn't bet)
Seat 5: X0/5h4o4LdHWlM7o/9shzg (small blind) folded before Flop
Seat 6: BYxjLnV1/LL0aZcTbfAOvw (big blind) collected ($0.75)




PokerStars Game #59939506996:  Hold'em No Limit ($0.10/$0.25) - 2009/07/01 0:41:39 ET
Table '4XGDnEByOol5up4aB2KbJw' 6-max Seat #2 is the button
Seat 1: kyRaCIljYA6l33lSKQfNsg ($26.30 in chips) 
Seat 2: SFmT9ZsVopnukjvAzrxTRg ($33.85 in chips) 
Seat 3: LtASJ9OlkqGrrUKGQlpGAw ($23.35 in chips) 
Seat 4: sjoibHX/s93+8Kwa5aB1dA ($26.35 in chips) 
Seat 5: Dh01+rohD2p9pXLYeBlC5Q ($19.50 in chips) 
Seat 6: ELW+DKizJhLK7k40PMkD2Q ($28.10 in chips) 
LtASJ9OlkqGrrUKGQlpGAw: posts small blind $0.10
sjoibHX/s93+8Kwa5aB1dA: posts big blind $0.25
*** HOLE CARDS ***
Dh01+rohD2p9pXLYeBlC5Q: calls $0.25
ELW+DKizJhLK7k40PMkD2Q: folds 
kyRaCIljYA6l33lSKQfNsg: folds 
SFmT9ZsVopnukjvAzrxTRg: folds 
LtASJ9OlkqGrrUKGQlpGAw: folds 
sjoibHX/s93+8Kwa5aB1dA: checks 
*** FLOP *** [5c 3h Tc]
sjoibHX/s93+8Kwa5aB1dA: bets $0.50
Dh01+rohD2p9pXLYeBlC5Q: calls $0.50
*** TURN *** [5c 3h Tc] [8h]
sjoibHX/s93+8Kwa5aB1dA: bets $0.50
Dh01+rohD2p9pXLYeBlC5Q: calls $0.50
*** RIVER *** [5c 3h Tc 8h] [6s]
sjoibHX/s93+8Kwa5aB1dA: bets $1
Dh01+rohD2p9pXLYeBlC5Q: folds 
Uncalled bet ($1) returned to sjoibHX/s93+8Kwa5aB1dA
sjoibHX/s93+8Kwa5aB1dA collected $2.50 from pot
sjoibHX/s93+8Kwa5aB1dA: doesn't show hand 
*** SUMMARY ***
Total pot $2.60 | Rake $0.10 
Board [5c 3h Tc 8h 6s]
Seat 1: kyRaCIljYA6l33lSKQfNsg folded before Flop (didn't bet)
Seat 2: SFmT9ZsVopnukjvAzrxTRg (button) folded before Flop (didn't bet)
Seat 3: LtASJ9OlkqGrrUKGQlpGAw (small blind) folded before Flop
Seat 4: sjoibHX/s93+8Kwa5aB1dA (big blind) collected ($2.50)
Seat 5: Dh01+rohD2p9pXLYeBlC5Q folded on the River
Seat 6: ELW+DKizJhLK7k40PMkD2Q folded before Flop (didn't bet)




PokerStars Game #59939506714:  Hold'em No Limit ($0.10/$0.25) - 2009/07/01 0:41:39 ET
Table 'zW+7jPbOLCvlPu+dUGY5WQ' 6-max Seat #1 is the button
Seat 1: JE/wJXmjw3bpdmjwvh2pcg ($21.05 in chips) 
Seat 2: DXgVFTcE3WofABsNJ5G/nw ($14.75 in chips) 
Seat 3: BedjMfrlRfPgSq7CXpPAmg ($64.10 in chips) 
Seat 4: Qv4VzEkN09uD11sjKv02Ig ($36.45 in chips) 
Seat 5: SFmT9ZsVopnukjvAzrxTRg ($55.75 in chips) 
Seat 6: BiLBinPhgpKAYzLgKJVU5A ($21.60 in chips) 
DXgVFTcE3WofABsNJ5G/nw: posts small blind $0.10
BedjMfrlRfPgSq7CXpPAmg: posts big blind $0.25
*** HOLE CARDS ***
Qv4VzEkN09uD11sjKv02Ig: raises $0.50 to $0.75
SFmT9ZsVopnukjvAzrxTRg: calls $0.75
BiLBinPhgpKAYzLgKJVU5A: folds 
JE/wJXmjw3bpdmjwvh2pcg: folds 
DXgVFTcE3WofABsNJ5G/nw: folds 
BedjMfrlRfPgSq7CXpPAmg: folds 
*** FLOP *** [9d 7c 8h]
Qv4VzEkN09uD11sjKv02Ig: checks 
SFmT9ZsVopnukjvAzrxTRg: bets $1.50
Qv4VzEkN09uD11sjKv02Ig: folds 
Uncalled bet ($1.50) returned to SFmT9ZsVopnukjvAzrxTRg
SFmT9ZsVopnukjvAzrxTRg collected $1.80 from pot
SFmT9ZsVopnukjvAzrxTRg: doesn't show hand 
*** SUMMARY ***
Total pot $1.85 | Rake $0.05 
Board [9d 7c 8h]
Seat 1: JE/wJXmjw3bpdmjwvh2pcg (button) folded before Flop (didn't bet)
Seat 2: DXgVFTcE3WofABsNJ5G/nw (small blind) folded before Flop
Seat 3: BedjMfrlRfPgSq7CXpPAmg (big blind) folded before Flop
Seat 4: Qv4VzEkN09uD11sjKv02Ig folded on the Flop
Seat 5: SFmT9ZsVopnukjvAzrxTRg collected ($1.80)
Seat 6: BiLBinPhgpKAYzLgKJVU5A folded before Flop (didn't bet)




PokerStars Game #59939506856:  Hold'em No Limit ($0.10/$0.25) - 2009/07/01 0:41:39 ET
Table 'pPgW4R3kdH26lLi1MnE92w' 9-max Seat #1 is the button
Seat 1: dPWIrImjP1yFagoUVDKR0Q ($11.40 in chips) 
Seat 2: cZ99hugmLBj9KhTlc8nCSw ($28.35 in chips) 
Seat 3: og+56SuM1LUF/5l/Qtaw4Q ($8.80 in chips) 
Seat 4: hBMUlEpyU74r/fwDgIpXjQ ($31.15 in chips) 
Seat 5: HPEB+AtKw1+C/cxU0o1ciw ($34.35 in chips) 
Seat 8: aCVg6cCxQcqClhB9nq/p1w ($19.25 in chips) 
Seat 9: tcbEu7VzyHQ+0lh+skbQhQ ($18.50 in chips) 
cZ99hugmLBj9KhTlc8nCSw: posts small blind $0.10
og+56SuM1LUF/5l/Qtaw4Q: posts big blind $0.25
VllYilcih0t+gMD4GTRlgQ: sits out 
sD+TKtt36XiiN6jqHiLwDA: sits out 
*** HOLE CARDS ***
hBMUlEpyU74r/fwDgIpXjQ: folds 
HPEB+AtKw1+C/cxU0o1ciw: folds 
aCVg6cCxQcqClhB9nq/p1w: folds 
tcbEu7VzyHQ+0lh+skbQhQ: calls $0.25
dPWIrImjP1yFagoUVDKR0Q: calls $0.25
cZ99hugmLBj9KhTlc8nCSw: folds 
og+56SuM1LUF/5l/Qtaw4Q: raises $0.50 to $0.75
tcbEu7VzyHQ+0lh+skbQhQ: folds 
dPWIrImjP1yFagoUVDKR0Q: calls $0.50
*** FLOP *** [Qc Js 9s]
og+56SuM1LUF/5l/Qtaw4Q: bets $0.75
dPWIrImjP1yFagoUVDKR0Q: calls $0.75
*** TURN *** [Qc Js 9s] [Ks]
og+56SuM1LUF/5l/Qtaw4Q: bets $0.75
dPWIrImjP1yFagoUVDKR0Q: calls $0.75
*** RIVER *** [Qc Js 9s Ks] [7s]
og+56SuM1LUF/5l/Qtaw4Q: bets $2.75
dPWIrImjP1yFagoUVDKR0Q: folds 
Uncalled bet ($2.75) returned to og+56SuM1LUF/5l/Qtaw4Q
og+56SuM1LUF/5l/Qtaw4Q collected $4.65 from pot
*** SUMMARY ***
Total pot $4.85 | Rake $0.20 
Board [Qc Js 9s Ks 7s]
Seat 1: dPWIrImjP1yFagoUVDKR0Q (button) folded on the River
Seat 2: cZ99hugmLBj9KhTlc8nCSw (small blind) folded before Flop
Seat 3: og+56SuM1LUF/5l/Qtaw4Q (big blind) collected ($4.65)
Seat 4: hBMUlEpyU74r/fwDgIpXjQ folded before Flop (didn't bet)
Seat 5: HPEB+AtKw1+C/cxU0o1ciw folded before Flop (didn't bet)
Seat 8: aCVg6cCxQcqClhB9nq/p1w folded before Flop (didn't bet)
Seat 9: tcbEu7VzyHQ+0lh+skbQhQ folded before Flop




PokerStars Game #59939506910:  Hold'em No Limit ($0.10/$0.25) - 2009/07/01 0:41:39 ET
Table 'dNYnr4D4id1jwnEU66Yowg' 9-max Seat #5 is the button
Seat 1: 41pZ+Uce9oq+8wmcVBXWIg ($15.85 in chips) 
Seat 5: k+2r6di6GXjNpAdrRkW9bA ($18.80 in chips) 
k+2r6di6GXjNpAdrRkW9bA: posts small blind $0.10
41pZ+Uce9oq+8wmcVBXWIg: posts big blind $0.25
*** HOLE CARDS ***
k+2r6di6GXjNpAdrRkW9bA: calls $0.15
41pZ+Uce9oq+8wmcVBXWIg: checks 
*** FLOP *** [7c 5s Qd]
41pZ+Uce9oq+8wmcVBXWIg: checks 
k+2r6di6GXjNpAdrRkW9bA: checks 
*** TURN *** [7c 5s Qd] [6d]
41pZ+Uce9oq+8wmcVBXWIg: bets $0.25
k+2r6di6GXjNpAdrRkW9bA: calls $0.25
*** RIVER *** [7c 5s Qd 6d] [9c]
41pZ+Uce9oq+8wmcVBXWIg: checks 
k+2r6di6GXjNpAdrRkW9bA: checks 
*** SHOW DOWN ***
41pZ+Uce9oq+8wmcVBXWIg: shows [2c 8h] (a straight, Five to Nine)
k+2r6di6GXjNpAdrRkW9bA: mucks hand 
Lu6miJBtf3FVzUdzCWEtqQ joins the table at seat #6 
41pZ+Uce9oq+8wmcVBXWIg collected $0.95 from pot
*** SUMMARY ***
Total pot $1 | Rake $0.05 
Board [7c 5s Qd 6d 9c]
Seat 1: 41pZ+Uce9oq+8wmcVBXWIg (big blind) showed [2c 8h] and won ($0.95) with a straight, Five to Nine
Seat 5: k+2r6di6GXjNpAdrRkW9bA (button) (small blind) mucked




PokerStars Game #59939506750:  Hold'em No Limit ($0.10/$0.25) - 2009/07/01 0:41:39 ET
Table 'jz4TpuH+ag+0iNe2ZcxckQ' 9-max Seat #1 is the button
Seat 1: xw6ysR8BJ8Nvn+ibEf2G9w ($7.35 in chips) 
Seat 2: 18G4P1XstjNvItdGUITxgw ($29.55 in chips) 
Seat 3: Z5NNIVvnhb2IJbLcI79WYQ ($3.50 in chips) 
Seat 4: k+2r6di6GXjNpAdrRkW9bA ($65.30 in chips) 
Seat 5: uJlzv9KL7hgCIqIS2ofoaw ($8.80 in chips) 
Seat 6: ymx/m/7IEqTY+OQPano2gg ($10.70 in chips) 
Seat 7: sJNHTWcSlLHRCZ9+YRLLqA ($25 in chips) 
Seat 8: J3kDdqAF7vHwmQ3VsAbsdA ($76.15 in chips) 
Seat 9: 8B/dhbQjIWe6ASCdgzktNQ ($25 in chips) 
18G4P1XstjNvItdGUITxgw: posts small blind $0.10
Z5NNIVvnhb2IJbLcI79WYQ: posts big blind $0.25
*** HOLE CARDS ***
k+2r6di6GXjNpAdrRkW9bA: calls $0.25
uJlzv9KL7hgCIqIS2ofoaw: folds 
ymx/m/7IEqTY+OQPano2gg: folds 
sJNHTWcSlLHRCZ9+YRLLqA: folds 
J3kDdqAF7vHwmQ3VsAbsdA: folds 
J3kDdqAF7vHwmQ3VsAbsdA leaves the table
8B/dhbQjIWe6ASCdgzktNQ: folds 
xw6ysR8BJ8Nvn+ibEf2G9w: calls $0.25
DlXs37dlX3tb7o/7lYXQSw joins the table at seat #8 
18G4P1XstjNvItdGUITxgw: calls $0.15
Z5NNIVvnhb2IJbLcI79WYQ: checks 
*** FLOP *** [4d 9h Kh]
18G4P1XstjNvItdGUITxgw: bets $0.75
Z5NNIVvnhb2IJbLcI79WYQ: folds 
k+2r6di6GXjNpAdrRkW9bA: folds 
xw6ysR8BJ8Nvn+ibEf2G9w: folds 
Uncalled bet ($0.75) returned to 18G4P1XstjNvItdGUITxgw
18G4P1XstjNvItdGUITxgw collected $0.95 from pot
18G4P1XstjNvItdGUITxgw: doesn't show hand 
*** SUMMARY ***
Total pot $1 | Rake $0.05 
Board [4d 9h Kh]
Seat 1: xw6ysR8BJ8Nvn+ibEf2G9w (button) folded on the Flop
Seat 2: 18G4P1XstjNvItdGUITxgw (small blind) collected ($0.95)
Seat 3: Z5NNIVvnhb2IJbLcI79WYQ (big blind) folded on the Flop
Seat 4: k+2r6di6GXjNpAdrRkW9bA folded on the Flop
Seat 5: uJlzv9KL7hgCIqIS2ofoaw folded before Flop (didn't bet)
Seat 6: ymx/m/7IEqTY+OQPano2gg folded before Flop (didn't bet)
Seat 7: sJNHTWcSlLHRCZ9+YRLLqA folded before Flop (didn't bet)
Seat 8: J3kDdqAF7vHwmQ3VsAbsdA folded before Flop (didn't bet)
Seat 9: 8B/dhbQjIWe6ASCdgzktNQ folded before Flop (didn't bet)




PokerStars Game #59939506950:  Hold'em No Limit ($0.10/$0.25) - 2009/07/01 0:41:39 ET
Table '2clPgY3+dETPD/8zjXZdFw' 6-max Seat #1 is the button
Seat 1: qllppsCmUqovlriIWCeM/g ($3.55 in chips) 
Seat 2: NzIFHwilc5zU7QhjDTgTZA ($7.35 in chips) 
Seat 3: 6pF9LtHn+EH0ChbOXzox9g ($2.70 in chips) 
Seat 4: 9KPR3sZ+CxRm7bQ8qxFzMQ ($5.50 in chips) 
NzIFHwilc5zU7QhjDTgTZA: posts small blind $0.10
6pF9LtHn+EH0ChbOXzox9g: posts big blind $0.25
*** HOLE CARDS ***
9KPR3sZ+CxRm7bQ8qxFzMQ: calls $0.25
qllppsCmUqovlriIWCeM/g: folds 
NzIFHwilc5zU7QhjDTgTZA: calls $0.15
6pF9LtHn+EH0ChbOXzox9g: raises $2.45 to $2.70 and is all-in
9KPR3sZ+CxRm7bQ8qxFzMQ: folds 
NzIFHwilc5zU7QhjDTgTZA: folds 
Uncalled bet ($2.45) returned to 6pF9LtHn+EH0ChbOXzox9g
6pF9LtHn+EH0ChbOXzox9g collected $0.75 from pot
6pF9LtHn+EH0ChbOXzox9g: doesn't show hand 
*** SUMMARY ***
Total pot $0.75 | Rake $0 
Seat 1: qllppsCmUqovlriIWCeM/g (button) folded before Flop (didn't bet)
Seat 2: NzIFHwilc5zU7QhjDTgTZA (small blind) folded before Flop
Seat 3: 6pF9LtHn+EH0ChbOXzox9g (big blind) collected ($0.75)
Seat 4: 9KPR3sZ+CxRm7bQ8qxFzMQ folded before Flop




PokerStars Game #59939507224:  Hold'em No Limit ($0.10/$0.25) - 2009/07/01 0:41:40 ET
Table 'YYMg5qzxK1m9eGRo4SbxtQ' 9-max Seat #7 is the button
Seat 1: DiSvPC2iudwL5j9u6Huyww ($25 in chips) 
Seat 2: uH1RN27w9SKa7TpVR9EFrQ ($15.25 in chips) 
Seat 3: N6fYvIzQLKaydFLKQGtMlQ ($24.05 in chips) 
Seat 4: H8sSXb2KLK0U38tU9YITDw ($11.25 in chips) 
Seat 5: BEIBUu2pIflPrCL+Iks4CQ ($19.30 in chips) 
Seat 6: gehe91e0IyVT0QU/XBkEyg ($41.60 in chips) 
Seat 7: hPhp/RE3cJ5YGaQ2xOHXXg ($3.95 in chips) 
Seat 8: 18G4P1XstjNvItdGUITxgw ($26.15 in chips) 
Seat 9: +sbyWwIcFp9kP0bDtMegfQ ($36.90 in chips) 
18G4P1XstjNvItdGUITxgw: posts small blind $0.10
+sbyWwIcFp9kP0bDtMegfQ: posts big blind $0.25
*** HOLE CARDS ***
DiSvPC2iudwL5j9u6Huyww: folds 
uH1RN27w9SKa7TpVR9EFrQ: folds 
N6fYvIzQLKaydFLKQGtMlQ: folds 
H8sSXb2KLK0U38tU9YITDw: folds 
BEIBUu2pIflPrCL+Iks4CQ: folds 
gehe91e0IyVT0QU/XBkEyg: folds 
hPhp/RE3cJ5YGaQ2xOHXXg: folds 
18G4P1XstjNvItdGUITxgw: raises $0.50 to $0.75
+sbyWwIcFp9kP0bDtMegfQ: folds 
Uncalled bet ($0.50) returned to 18G4P1XstjNvItdGUITxgw
18G4P1XstjNvItdGUITxgw collected $0.50 from pot
18G4P1XstjNvItdGUITxgw: doesn't show hand 
*** SUMMARY ***
Total pot $0.50 | Rake $0 
Seat 1: DiSvPC2iudwL5j9u6Huyww folded before Flop (didn't bet)
Seat 2: uH1RN27w9SKa7TpVR9EFrQ folded before Flop (didn't bet)
Seat 3: N6fYvIzQLKaydFLKQGtMlQ folded before Flop (didn't bet)
Seat 4: H8sSXb2KLK0U38tU9YITDw folded before Flop (didn't bet)
Seat 5: BEIBUu2pIflPrCL+Iks4CQ folded before Flop (didn't bet)
Seat 6: gehe91e0IyVT0QU/XBkEyg folded before Flop (didn't bet)
Seat 7: hPhp/RE3cJ5YGaQ2xOHXXg (button) folded before Flop (didn't bet)
Seat 8: 18G4P1XstjNvItdGUITxgw (small blind) collected ($0.50)
Seat 9: +sbyWwIcFp9kP0bDtMegfQ (big blind) folded before Flop




PokerStars Game #59939507272:  Hold'em No Limit ($0.10/$0.25) - 2009/07/01 0:41:40 ET
Table 'NtCSSONEf1zaJo3042tQug' 6-max Seat #2 is the button
Seat 1: pdS3fOhVgLVaTP0O0GlIvw ($11.05 in chips) 
Seat 2: nbv8IVGAEHbfjk01ulU6ow ($19.80 in chips) 
Seat 3: d0J1xuhsynEY81YHwAvJ5g ($25 in chips) 
Seat 4: dOX4wnYV2sEqvDbF+8KSCw ($25.50 in chips) 
Seat 5: l/t3k8+r77gRew8U2BJs4Q ($3.40 in chips) 
Seat 6: LxehwDpTQ19ph4Qmc78+Pw ($21.25 in chips) 
d0J1xuhsynEY81YHwAvJ5g: posts small blind $0.10
dOX4wnYV2sEqvDbF+8KSCw: posts big blind $0.25
*** HOLE CARDS ***
l/t3k8+r77gRew8U2BJs4Q: calls $0.25
LxehwDpTQ19ph4Qmc78+Pw: calls $0.25
pdS3fOhVgLVaTP0O0GlIvw: calls $0.25
nbv8IVGAEHbfjk01ulU6ow: raises $0.50 to $0.75
d0J1xuhsynEY81YHwAvJ5g: calls $0.65
dOX4wnYV2sEqvDbF+8KSCw: folds 
l/t3k8+r77gRew8U2BJs4Q: folds 
LxehwDpTQ19ph4Qmc78+Pw: calls $0.50
pdS3fOhVgLVaTP0O0GlIvw: calls $0.50
*** FLOP *** [9s Qd Kh]
d0J1xuhsynEY81YHwAvJ5g: checks 
LxehwDpTQ19ph4Qmc78+Pw: bets $3
pdS3fOhVgLVaTP0O0GlIvw: folds 
nbv8IVGAEHbfjk01ulU6ow: raises $16.05 to $19.05 and is all-in
d0J1xuhsynEY81YHwAvJ5g: folds 
LxehwDpTQ19ph4Qmc78+Pw: folds 
Uncalled bet ($16.05) returned to nbv8IVGAEHbfjk01ulU6ow
nbv8IVGAEHbfjk01ulU6ow collected $9.05 from pot
*** SUMMARY ***
Total pot $9.50 | Rake $0.45 
Board [9s Qd Kh]
Seat 1: pdS3fOhVgLVaTP0O0GlIvw folded on the Flop
Seat 2: nbv8IVGAEHbfjk01ulU6ow (button) collected ($9.05)
Seat 3: d0J1xuhsynEY81YHwAvJ5g (small blind) folded on the Flop
Seat 4: dOX4wnYV2sEqvDbF+8KSCw (big blind) folded before Flop
Seat 5: l/t3k8+r77gRew8U2BJs4Q folded before Flop
Seat 6: LxehwDpTQ19ph4Qmc78+Pw folded on the Flop




PokerStars Game #59939508044:  Hold'em No Limit ($0.10/$0.25) - 2009/07/01 0:41:41 ET
Table '9lYs7ljXi6AgFAxYHlKLJw' 9-max Seat #3 is the button
Seat 2: N6fYvIzQLKaydFLKQGtMlQ ($21.40 in chips) 
Seat 3: DnDcAdn9P0zGovMERigpFA ($27.50 in chips) 
Seat 4: UANt6y/SmDCY/jIxkBixcw ($29.75 in chips) 
Seat 5: dfNim92Z6XK1/h5SFW5vDg ($55.55 in chips) 
Seat 7: ghNKXUBl/H+t83JF079ZBA ($30.10 in chips) 
Seat 9: 18G4P1XstjNvItdGUITxgw ($29.60 in chips) 
UANt6y/SmDCY/jIxkBixcw: posts small blind $0.10
dfNim92Z6XK1/h5SFW5vDg: posts big blind $0.25
*** HOLE CARDS ***
ghNKXUBl/H+t83JF079ZBA: folds 
18G4P1XstjNvItdGUITxgw: folds 
N6fYvIzQLKaydFLKQGtMlQ: folds 
DnDcAdn9P0zGovMERigpFA: folds 
UANt6y/SmDCY/jIxkBixcw: raises $0.50 to $0.75
dfNim92Z6XK1/h5SFW5vDg: folds 
Uncalled bet ($0.50) returned to UANt6y/SmDCY/jIxkBixcw
UANt6y/SmDCY/jIxkBixcw collected $0.50 from pot
UANt6y/SmDCY/jIxkBixcw: doesn't show hand 
*** SUMMARY ***
Total pot $0.50 | Rake $0 
Seat 2: N6fYvIzQLKaydFLKQGtMlQ folded before Flop (didn't bet)
Seat 3: DnDcAdn9P0zGovMERigpFA (button) folded before Flop (didn't bet)
Seat 4: UANt6y/SmDCY/jIxkBixcw (small blind) collected ($0.50)
Seat 5: dfNim92Z6XK1/h5SFW5vDg (big blind) folded before Flop
Seat 7: ghNKXUBl/H+t83JF079ZBA folded before Flop (didn't bet)
Seat 9: 18G4P1XstjNvItdGUITxgw folded before Flop (didn't bet)




PokerStars Game #59939508176:  Hold'em No Limit ($0.10/$0.25) - 2009/07/01 0:41:41 ET
Table 'BdTkgy6SGkgNXul6irMoOw' 9-max Seat #9 is the button
Seat 1: Jd9JmKichu4pvsKjXEKNvA ($4.50 in chips) 
Seat 2: ljemhp25Zg+nlA9DLCIiUw ($39.30 in chips) 
Seat 3: RQ9/w/vIRUIpv009qodF2Q ($10 in chips) 
Seat 4: eygIcrabyU9hI2mw7NQsgg ($23.55 in chips) 
Seat 5: opOCI2p6kW0tINuVaAqmcQ ($25 in chips) 
Seat 6: XlP4n7rTkDteN8BWl//wvg ($23 in chips) 
Seat 9: 5dv9mRGKI/UifM58OINXVQ ($19.15 in chips) 
Jd9JmKichu4pvsKjXEKNvA: posts small blind $0.10
ljemhp25Zg+nlA9DLCIiUw: posts big blind $0.25
RQ9/w/vIRUIpv009qodF2Q: posts big blind $0.25
*** HOLE CARDS ***
RQ9/w/vIRUIpv009qodF2Q: checks 
b8t3jWrxzeEt9HtZtc9wUQ joins the table at seat #7 
eygIcrabyU9hI2mw7NQsgg: folds 
opOCI2p6kW0tINuVaAqmcQ: folds 
XlP4n7rTkDteN8BWl//wvg: raises $0.75 to $1
5dv9mRGKI/UifM58OINXVQ: calls $1
Jd9JmKichu4pvsKjXEKNvA: folds 
8Y1YOndOSMx6Ei47RaGbrw joins the table at seat #8 
ljemhp25Zg+nlA9DLCIiUw: folds 
RQ9/w/vIRUIpv009qodF2Q: calls $0.75
*** FLOP *** [3h 4h Ks]
RQ9/w/vIRUIpv009qodF2Q: checks 
XlP4n7rTkDteN8BWl//wvg: bets $2
5dv9mRGKI/UifM58OINXVQ: calls $2
RQ9/w/vIRUIpv009qodF2Q: folds 
*** TURN *** [3h 4h Ks] [3d]
XlP4n7rTkDteN8BWl//wvg: checks 
5dv9mRGKI/UifM58OINXVQ: bets $3
XlP4n7rTkDteN8BWl//wvg: folds 
Uncalled bet ($3) returned to 5dv9mRGKI/UifM58OINXVQ
5dv9mRGKI/UifM58OINXVQ collected $7 from pot
5dv9mRGKI/UifM58OINXVQ: doesn't show hand 
*** SUMMARY ***
Total pot $7.35 | Rake $0.35 
Board [3h 4h Ks 3d]
Seat 1: Jd9JmKichu4pvsKjXEKNvA (small blind) folded before Flop
Seat 2: ljemhp25Zg+nlA9DLCIiUw (big blind) folded before Flop
Seat 3: RQ9/w/vIRUIpv009qodF2Q folded on the Flop
Seat 4: eygIcrabyU9hI2mw7NQsgg folded before Flop (didn't bet)
Seat 5: opOCI2p6kW0tINuVaAqmcQ folded before Flop (didn't bet)
Seat 6: XlP4n7rTkDteN8BWl//wvg folded on the Turn
Seat 9: 5dv9mRGKI/UifM58OINXVQ (button) collected ($7)




PokerStars Game #59939507924:  Hold'em No Limit ($0.10/$0.25) - 2009/07/01 0:41:41 ET
Table '52Meibn9NOL4XtVi1p2Upw' 9-max Seat #4 is the button
Seat 1: LSrAei+fS8MYG9ie/GkG0Q ($13.05 in chips) 
Seat 2: BEIBUu2pIflPrCL+Iks4CQ ($12.25 in chips) 
Seat 3: MzBvksetB8XYtCt0FExJMg ($14.90 in chips) 
Seat 4: rCaXm4/EwAgWqCiClpbsqQ ($8.65 in chips) 
Seat 5: 4oA316mXLIui1QY63GXBUg ($26.85 in chips) 
Seat 6: 1wKfgJ8xXIiuc8C6qjkxhg ($6.05 in chips) 
Seat 7: R3KkgiqTvuhazyCqaD9cZg ($10 in chips) 
Seat 8: eKma8Z98pP7H8m4CEt075w ($23.45 in chips) 
Seat 9: 8B/dhbQjIWe6ASCdgzktNQ ($30.10 in chips) 
4oA316mXLIui1QY63GXBUg: posts small blind $0.10
1wKfgJ8xXIiuc8C6qjkxhg: posts big blind $0.25
*** HOLE CARDS ***
R3KkgiqTvuhazyCqaD9cZg: folds 
eKma8Z98pP7H8m4CEt075w: folds 
8B/dhbQjIWe6ASCdgzktNQ: folds 
LSrAei+fS8MYG9ie/GkG0Q: folds 
BEIBUu2pIflPrCL+Iks4CQ: folds 
MzBvksetB8XYtCt0FExJMg: raises $0.50 to $0.75
rCaXm4/EwAgWqCiClpbsqQ: folds 
4oA316mXLIui1QY63GXBUg: folds 
1wKfgJ8xXIiuc8C6qjkxhg: folds 
Uncalled bet ($0.50) returned to MzBvksetB8XYtCt0FExJMg
MzBvksetB8XYtCt0FExJMg collected $0.60 from pot
MzBvksetB8XYtCt0FExJMg: doesn't show hand 
*** SUMMARY ***
Total pot $0.60 | Rake $0 
Seat 1: LSrAei+fS8MYG9ie/GkG0Q folded before Flop (didn't bet)
Seat 2: BEIBUu2pIflPrCL+Iks4CQ folded before Flop (didn't bet)
Seat 3: MzBvksetB8XYtCt0FExJMg collected ($0.60)
Seat 4: rCaXm4/EwAgWqCiClpbsqQ (button) folded before Flop (didn't bet)
Seat 5: 4oA316mXLIui1QY63GXBUg (small blind) folded before Flop
Seat 6: 1wKfgJ8xXIiuc8C6qjkxhg (big blind) folded before Flop
Seat 7: R3KkgiqTvuhazyCqaD9cZg folded before Flop (didn't bet)
Seat 8: eKma8Z98pP7H8m4CEt075w folded before Flop (didn't bet)
Seat 9: 8B/dhbQjIWe6ASCdgzktNQ folded before Flop (didn't bet)




PokerStars Game #59939508082:  Hold'em No Limit ($0.10/$0.25) - 2009/07/01 0:41:41 ET
Table 'zojWVNukhD2n8RTfHCOwwg' 9-max Seat #8 is the button
Seat 1: DIBbjEYGs+TVdVgEB/4+3w ($41.45 in chips) 
Seat 2: ZeR3hkj1gVv9J4yPCmRrjA ($26.60 in chips) 
Seat 3: 1esmRaxnod+zAkE+7BtzMA ($16.50 in chips) 
Seat 4: Pb7qJqn2QUbp+oYBNQxyyA ($26.45 in chips) 
Seat 6: 2xNcp4M2UG8Li2PMEnWcgA ($10.20 in chips) 
Seat 7: H5Se03ZqSX7tbULXur2MAg ($26.95 in chips) 
Seat 8: j4q3p0lesp63b1gZDwLBZw ($5 in chips) 
Seat 9: 4oA316mXLIui1QY63GXBUg ($25.35 in chips) 
4oA316mXLIui1QY63GXBUg: posts small blind $0.10
DIBbjEYGs+TVdVgEB/4+3w: posts big blind $0.25
*** HOLE CARDS ***
ZeR3hkj1gVv9J4yPCmRrjA: folds 
1esmRaxnod+zAkE+7BtzMA: raises $0.50 to $0.75
Pb7qJqn2QUbp+oYBNQxyyA: folds 
2xNcp4M2UG8Li2PMEnWcgA: folds 
H5Se03ZqSX7tbULXur2MAg: folds 
j4q3p0lesp63b1gZDwLBZw: folds 
4oA316mXLIui1QY63GXBUg: folds 
DIBbjEYGs+TVdVgEB/4+3w: folds 
Uncalled bet ($0.50) returned to 1esmRaxnod+zAkE+7BtzMA
1esmRaxnod+zAkE+7BtzMA collected $0.60 from pot
1esmRaxnod+zAkE+7BtzMA: doesn't show hand 
*** SUMMARY ***
Total pot $0.60 | Rake $0 
Seat 1: DIBbjEYGs+TVdVgEB/4+3w (big blind) folded before Flop
Seat 2: ZeR3hkj1gVv9J4yPCmRrjA folded before Flop (didn't bet)
Seat 3: 1esmRaxnod+zAkE+7BtzMA collected ($0.60)
Seat 4: Pb7qJqn2QUbp+oYBNQxyyA folded before Flop (didn't bet)
Seat 6: 2xNcp4M2UG8Li2PMEnWcgA folded before Flop (didn't bet)
Seat 7: H5Se03ZqSX7tbULXur2MAg folded before Flop (didn't bet)
Seat 8: j4q3p0lesp63b1gZDwLBZw (button) folded before Flop (didn't bet)
Seat 9: 4oA316mXLIui1QY63GXBUg (small blind) folded before Flop




PokerStars Game #59939508526:  Hold'em No Limit ($0.10/$0.25) - 2009/07/01 0:41:42 ET
Table '7/qMNloI0nSXWiX5Y1watA' 9-max Seat #4 is the button
Seat 1: lF4l0ujUfJ9uYJOg9Ch9/g ($43.10 in chips) 
Seat 2: 8B/dhbQjIWe6ASCdgzktNQ ($25.40 in chips) 
Seat 3: nEg1b6MIksd/4x5eLY735g ($42.40 in chips) 
Seat 4: 18G4P1XstjNvItdGUITxgw ($25 in chips) 
Seat 5: dfNim92Z6XK1/h5SFW5vDg ($32.10 in chips) 
Seat 6: vnCdP3GsLTKadDukKcJk/Q ($25 in chips) 
Seat 7: z5GxcHlYz/GSz6W2uFiTtg ($11.55 in chips) 
Seat 8: ljemhp25Zg+nlA9DLCIiUw ($24.50 in chips) 
dfNim92Z6XK1/h5SFW5vDg: posts small blind $0.10
vnCdP3GsLTKadDukKcJk/Q: posts big blind $0.25
Telixak: sits out 
*** HOLE CARDS ***
z5GxcHlYz/GSz6W2uFiTtg: folds 
ljemhp25Zg+nlA9DLCIiUw: calls $0.25
lF4l0ujUfJ9uYJOg9Ch9/g: folds 
8B/dhbQjIWe6ASCdgzktNQ: folds 
nEg1b6MIksd/4x5eLY735g: raises $0.55 to $0.80
18G4P1XstjNvItdGUITxgw: folds 
dfNim92Z6XK1/h5SFW5vDg: folds 
vnCdP3GsLTKadDukKcJk/Q: folds 
ljemhp25Zg+nlA9DLCIiUw: calls $0.55
*** FLOP *** [3h 7h Td]
ljemhp25Zg+nlA9DLCIiUw: checks 
nEg1b6MIksd/4x5eLY735g: bets $1.20
ljemhp25Zg+nlA9DLCIiUw: folds 
Uncalled bet ($1.20) returned to nEg1b6MIksd/4x5eLY735g
nEg1b6MIksd/4x5eLY735g collected $1.90 from pot
*** SUMMARY ***
Total pot $1.95 | Rake $0.05 
Board [3h 7h Td]
Seat 1: lF4l0ujUfJ9uYJOg9Ch9/g folded before Flop (didn't bet)
Seat 2: 8B/dhbQjIWe6ASCdgzktNQ folded before Flop (didn't bet)
Seat 3: nEg1b6MIksd/4x5eLY735g collected ($1.90)
Seat 4: 18G4P1XstjNvItdGUITxgw (button) folded before Flop (didn't bet)
Seat 5: dfNim92Z6XK1/h5SFW5vDg (small blind) folded before Flop
Seat 6: vnCdP3GsLTKadDukKcJk/Q (big blind) folded before Flop
Seat 7: z5GxcHlYz/GSz6W2uFiTtg folded before Flop (didn't bet)
Seat 8: ljemhp25Zg+nlA9DLCIiUw folded on the Flop




PokerStars Game #59939508440:  Hold'em No Limit ($0.10/$0.25) - 2009/07/01 0:41:42 ET
Table 'uFgIyfWPagvEVGEb86da7A' 9-max Seat #9 is the button
Seat 1: 5MgYq10OC5iGoxQFwlJVuw ($15.10 in chips) 
Seat 2: o3zvoO+PsqGti+1NZGNRrQ ($6.35 in chips) 
Seat 3: q4GZp0xt5Unxtq8PS32SAQ ($35.70 in chips) 
Seat 5: Qi+clOtyDiibLdH2/1Qy8g ($17.30 in chips) 
Seat 6: zDrucyjVn5aeekNEc3cJrA ($22.70 in chips) 
Seat 8: MzxZJee3eU6Q0wg0XTfZew ($11.35 in chips) 
Seat 9: DnDcAdn9P0zGovMERigpFA ($25 in chips) 
5MgYq10OC5iGoxQFwlJVuw: posts small blind $0.10
o3zvoO+PsqGti+1NZGNRrQ is connected 
o3zvoO+PsqGti+1NZGNRrQ: posts big blind $0.25
IGRfskE1v9H9Bn+fz8AgNQ: sits out 
*** HOLE CARDS ***
q4GZp0xt5Unxtq8PS32SAQ: folds 
Qi+clOtyDiibLdH2/1Qy8g: folds 
zDrucyjVn5aeekNEc3cJrA: folds 
MzxZJee3eU6Q0wg0XTfZew: raises $0.25 to $0.50
DnDcAdn9P0zGovMERigpFA: folds 
5MgYq10OC5iGoxQFwlJVuw: folds 
o3zvoO+PsqGti+1NZGNRrQ: folds 
Uncalled bet ($0.25) returned to MzxZJee3eU6Q0wg0XTfZew
MzxZJee3eU6Q0wg0XTfZew collected $0.60 from pot
*** SUMMARY ***
Total pot $0.60 | Rake $0 
Seat 1: 5MgYq10OC5iGoxQFwlJVuw (small blind) folded before Flop
Seat 2: o3zvoO+PsqGti+1NZGNRrQ (big blind) folded before Flop
Seat 3: q4GZp0xt5Unxtq8PS32SAQ folded before Flop (didn't bet)
Seat 5: Qi+clOtyDiibLdH2/1Qy8g folded before Flop (didn't bet)
Seat 6: zDrucyjVn5aeekNEc3cJrA folded before Flop (didn't bet)
Seat 8: MzxZJee3eU6Q0wg0XTfZew collected ($0.60)
Seat 9: DnDcAdn9P0zGovMERigpFA (button) folded before Flop (didn't bet)




PokerStars Game #59939508998:  Hold'em No Limit ($0.10/$0.25) - 2009/07/01 0:41:42 ET
Table '0XPo7K54oZIfG0xlNAcDRwnQC9LRg01NEuKFHF1nrDEw-max Seat #1 is the button
Seat 1: Nj6/PdBvfG79w0yeIjPmmA ($14.05 in chips) 
Seat 2: cPO/1/dTcZpLkQFm3jH3Rg ($32.30 in chips) 
Seat 4: tLM9aw7T3kBEIhQEh1roOg ($6.80 in chips) 
Seat 5: kG34n23qFQA3nzdOJTQ1dA ($29 in chips) 
Seat 6: xQVFeVUDopz+akuEo2wXpQ ($46.25 in chips) 
cPO/1/dTcZpLkQFm3jH3Rg: posts small blind $0.10
tLM9aw7T3kBEIhQEh1roOg: posts big blind $0.25
*** HOLE CARDS ***
kG34n23qFQA3nzdOJTQ1dA: calls $0.25
xQVFeVUDopz+akuEo2wXpQ: calls $0.25
Nj6/PdBvfG79w0yeIjPmmA: calls $0.25
cPO/1/dTcZpLkQFm3jH3Rg: folds 
tLM9aw7T3kBEIhQEh1roOg: raises $0.25 to $0.50
kG34n23qFQA3nzdOJTQ1dA: calls $0.25
xQVFeVUDopz+akuEo2wXpQ: calls $0.25
Nj6/PdBvfG79w0yeIjPmmA: calls $0.25
*** FLOP *** [4d 4c 3d]
tLM9aw7T3kBEIhQEh1roOg: bets $0.25
kG34n23qFQA3nzdOJTQ1dA: folds 
xQVFeVUDopz+akuEo2wXpQ: folds 
Nj6/PdBvfG79w0yeIjPmmA: calls $0.25
*** TURN *** [4d 4c 3d] [3c]
xQVFeVUDopz+akuEo2wXpQ said, "pocket AA"
tLM9aw7T3kBEIhQEh1roOg: bets $0.50
Nj6/PdBvfG79w0yeIjPmmA: calls $0.50
*** RIVER *** [4d 4c 3d 3c] [2h]
tLM9aw7T3kBEIhQEh1roOg: bets $0.50
Nj6/PdBvfG79w0yeIjPmmA: calls $0.50
*** SHOW DOWN ***
tLM9aw7T3kBEIhQEh1roOg: shows [Ad Jd] (two pair, Fours and Threes)
Nj6/PdBvfG79w0yeIjPmmA: mucks hand 
tLM9aw7T3kBEIhQEh1roOg collected $4.40 from pot
*** SUMMARY ***
Total pot $4.60 | Rake $0.20 
Board [4d 4c 3d 3c 2h]
Seat 1: Nj6/PdBvfG79w0yeIjPmmA (button) mucked
Seat 2: cPO/1/dTcZpLkQFm3jH3Rg (small blind) folded before Flop
Seat 4: tLM9aw7T3kBEIhQEh1roOg (big blind) showed [Ad Jd] and won ($4.40) with two pair, Fours and Threes
Seat 5: kG34n23qFQA3nzdOJTQ1dA folded on the Flop
Seat 6: xQVFeVUDopz+akuEo2wXpQ folded on the Flop




PokerStars Game #59939508958:  Hold'em No Limit ($0.10/$0.25) - 2009/07/01 0:41:42 ET
Table 'Qr+t8WGovMECkBv+cV1lrg' 6-max Seat #3 is the button
Seat 1: wFKQltIqUcrrkvre6g+fyw ($33.90 in chips) 
Seat 3: bjJnMpKgoF+vgHW2f1NCsg ($19.10 in chips) 
Seat 4: 3rlIjSrvbZoI2IILbnetnA ($25.15 in chips) 
Seat 5: iwlxXocltgSdaBmusNXanQ ($14.60 in chips) 
Seat 6: j5NZbEJHsERuXjPHWqc1Nw ($22.05 in chips) 
3rlIjSrvbZoI2IILbnetnA: posts small blind $0.10
iwlxXocltgSdaBmusNXanQ: posts big blind $0.25
*** HOLE CARDS ***
j5NZbEJHsERuXjPHWqc1Nw: folds 
wFKQltIqUcrrkvre6g+fyw: folds 
bjJnMpKgoF+vgHW2f1NCsg: folds 
9h7TNZ1TDGRUJXA6rI+ZTw joins the table at seat #2 
3rlIjSrvbZoI2IILbnetnA: calls $0.15
iwlxXocltgSdaBmusNXanQ: checks 
*** FLOP *** [6c 3d 7d]
3rlIjSrvbZoI2IILbnetnA: checks 
iwlxXocltgSdaBmusNXanQ: bets $0.25
3rlIjSrvbZoI2IILbnetnA: calls $0.25
*** TURN *** [6c 3d 7d] [Th]
3rlIjSrvbZoI2IILbnetnA: checks 
iwlxXocltgSdaBmusNXanQ: bets $0.25
3rlIjSrvbZoI2IILbnetnA: calls $0.25
*** RIVER *** [6c 3d 7d Th] [Qs]
3rlIjSrvbZoI2IILbnetnA: bets $1
iwlxXocltgSdaBmusNXanQ: folds 
Uncalled bet ($1) returned to 3rlIjSrvbZoI2IILbnetnA
3rlIjSrvbZoI2IILbnetnA collected $1.45 from pot
*** SUMMARY ***
Total pot $1.50 | Rake $0.05 
Board [6c 3d 7d Th Qs]
Seat 1: wFKQltIqUcrrkvre6g+fyw folded before Flop (didn't bet)
Seat 3: bjJnMpKgoF+vgHW2f1NCsg (button) folded before Flop (didn't bet)
Seat 4: 3rlIjSrvbZoI2IILbnetnA (small blind) collected ($1.45)
Seat 5: iwlxXocltgSdaBmusNXanQ (big blind) folded on the River
Seat 6: j5NZbEJHsERuXjPHWqc1Nw folded before Flop (didn't bet)




PokerStars Game #59939508714:  Hold'em No Limit ($0.10/$0.25) - 2009/07/01 0:41:42 ET
Table '9o8Yb3JpUqurD4pNVmOikQ' 6-max Seat #4 is the button
Seat 1: 5tB0F9NjPSUL4FzmzBMs2Q ($25.35 in chips) 
Seat 2: /gJNBeCkWL4o85/jvlZ4BA ($25 in chips) 
Seat 3: JgRqo1/2phbf7pab7N3BIQ ($7.35 in chips) 
Seat 4: YaAEMJGY5tem39deCUQRNw ($41.70 in chips) 
Seat 6: k9vn40MOqqb+xF+7GZ6v2g ($34.65 in chips) 
k9vn40MOqqb+xF+7GZ6v2g: posts small blind $0.10
5tB0F9NjPSUL4FzmzBMs2Q: posts big blind $0.25
*** HOLE CARDS ***
/gJNBeCkWL4o85/jvlZ4BA: folds 
JgRqo1/2phbf7pab7N3BIQ: calls $0.25
YaAEMJGY5tem39deCUQRNw: raises $0.75 to $1
k9vn40MOqqb+xF+7GZ6v2g: folds 
5tB0F9NjPSUL4FzmzBMs2Q: folds 
JgRqo1/2phbf7pab7N3BIQ: calls $0.75
*** FLOP *** [Jc 4d 5d]
JgRqo1/2phbf7pab7N3BIQ: checks 
YaAEMJGY5tem39deCUQRNw: bets $1.50
JgRqo1/2phbf7pab7N3BIQ: calls $1.50
*** TURN *** [Jc 4d 5d] [5h]
JgRqo1/2phbf7pab7N3BIQ: checks 
YaAEMJGY5tem39deCUQRNw: checks 
*** RIVER *** [Jc 4d 5d 5h] [6s]
JgRqo1/2phbf7pab7N3BIQ: checks 
YaAEMJGY5tem39deCUQRNw: bets $3.50
JgRqo1/2phbf7pab7N3BIQ: calls $3.50
*** SHOW DOWN ***
YaAEMJGY5tem39deCUQRNw: shows [8c Tc] (a pair of Fives)
JgRqo1/2phbf7pab7N3BIQ: shows [9s 9h] (two pair, Nines and Fives)
YaAEMJGY5tem39deCUQRNw leaves the table
JgRqo1/2phbf7pab7N3BIQ collected $11.75 from pot
*** SUMMARY ***
Total pot $12.35 | Rake $0.60 
Board [Jc 4d 5d 5h 6s]
Seat 1: 5tB0F9NjPSUL4FzmzBMs2Q (big blind) folded before Flop
Seat 2: /gJNBeCkWL4o85/jvlZ4BA folded before Flop (didn't bet)
Seat 3: JgRqo1/2phbf7pab7N3BIQ showed [9s 9h] and won ($11.75) with two pair, Nines and Fives
Seat 4: YaAEMJGY5tem39deCUQRNw (button) showed [8c Tc] and lost with a pair of Fives
Seat 6: k9vn40MOqqb+xF+7GZ6v2g (small blind) folded before Flop




PokerStars Game #59939509210:  Hold'em No Limit ($0.10/$0.25) - 2009/07/01 0:41:43 ET
Table 'mVdLgAdN9rGe6mMwSrDdGQ' 6-max Seat #5 is the button
Seat 1: 1tFjlBNp9g4Qjfo0vKlSzw ($13.15 in chips) 
Seat 2: fSUx4e1vURbgXyDBEcRbAg ($2.35 in chips) 
Seat 3: kG34n23qFQA3nzdOJTQ1dA ($24.30 in chips) 
Seat 5: oseFhpinoe+Zg4j5xyBjyQ ($55.70 in chips) 
Seat 6: Ew/TYPQIsbQ2X8nm5iAJBg ($25.60 in chips) 
Ew/TYPQIsbQ2X8nm5iAJBg: posts small blind $0.10
1tFjlBNp9g4Qjfo0vKlSzw: posts big blind $0.25
*** HOLE CARDS ***
fSUx4e1vURbgXyDBEcRbAg: raises $0.50 to $0.75
kG34n23qFQA3nzdOJTQ1dA: folds 
oseFhpinoe+Zg4j5xyBjyQ: folds 
Ew/TYPQIsbQ2X8nm5iAJBg: folds 
VladBah joins the table at seat #4 
1tFjlBNp9g4Qjfo0vKlSzw: calls $0.50
*** FLOP *** [Js 4s Ac]
1tFjlBNp9g4Qjfo0vKlSzw: checks 
fSUx4e1vURbgXyDBEcRbAg: bets $1
1tFjlBNp9g4Qjfo0vKlSzw: calls $1
*** TURN *** [Js 4s Ac] [Kc]
1tFjlBNp9g4Qjfo0vKlSzw: bets $1.25
fSUx4e1vURbgXyDBEcRbAg: calls $0.60 and is all-in
Uncalled bet ($0.65) returned to 1tFjlBNp9g4Qjfo0vKlSzw
*** RIVER *** [Js 4s Ac Kc] [Qd]
*** SHOW DOWN ***
1tFjlBNp9g4Qjfo0vKlSzw: shows [2c Ah] (a pair of Aces)
fSUx4e1vURbgXyDBEcRbAg: shows [Kh As] (two pair, Aces and Kings)
fSUx4e1vURbgXyDBEcRbAg collected $4.60 from pot
*** SUMMARY ***
Total pot $4.80 | Rake $0.20 
Board [Js 4s Ac Kc Qd]
Seat 1: 1tFjlBNp9g4Qjfo0vKlSzw (big blind) showed [2c Ah] and lost with a pair of Aces
Seat 2: fSUx4e1vURbgXyDBEcRbAg showed [Kh As] and won ($4.60) with two pair, Aces and Kings
Seat 3: kG34n23qFQA3nzdOJTQ1dA folded before Flop (didn't bet)
Seat 5: oseFhpinoe+Zg4j5xyBjyQ (button) folded before Flop (didn't bet)
Seat 6: Ew/TYPQIsbQ2X8nm5iAJBg (small blind) folded before Flop




PokerStars Game #59939509200:  Hold'em No Limit ($0.10/$0.25) - 2009/07/01 0:41:43 ET
Table 'g6ryG70feTw9nNm+XJLuXw' 6-max Seat #1 is the button
Seat 1: v+QfkGiuj9bgtuNoVnDO8w ($27.60 in chips) 
Seat 2: SxIIgwXYLkwd6m3wLyPTCw ($25 in chips) 
Seat 3: /6h8PvAHQmfuMUZ8OUF6Xw ($26.55 in chips) 
Seat 4: GC/9yVD59DUCX7hUI7gcLw ($37.90 in chips) 
Seat 5: EE16Ua5b1HSsYej5zeXOlA ($25.35 in chips) 
SxIIgwXYLkwd6m3wLyPTCw: posts small blind $0.10
/6h8PvAHQmfuMUZ8OUF6Xw: posts big blind $0.25
*** HOLE CARDS ***
GC/9yVD59DUCX7hUI7gcLw: folds 
EE16Ua5b1HSsYej5zeXOlA: folds 
v+QfkGiuj9bgtuNoVnDO8w: folds 
SxIIgwXYLkwd6m3wLyPTCw: folds 
Uncalled bet ($0.15) returned to /6h8PvAHQmfuMUZ8OUF6Xw
/6h8PvAHQmfuMUZ8OUF6Xw collected $0.20 from pot
/6h8PvAHQmfuMUZ8OUF6Xw: doesn't show hand 
*** SUMMARY ***
Total pot $0.20 | Rake $0 
Seat 1: v+QfkGiuj9bgtuNoVnDO8w (button) folded before Flop (didn't bet)
Seat 2: SxIIgwXYLkwd6m3wLyPTCw (small blind) folded before Flop
Seat 3: /6h8PvAHQmfuMUZ8OUF6Xw (big blind) collected ($0.20)
Seat 4: GC/9yVD59DUCX7hUI7gcLw folded before Flop (didn't bet)
Seat 5: EE16Ua5b1HSsYej5zeXOlA folded before Flop (didn't bet)




PokerStars Game #59939509494:  Hold'em No Limit ($0.10/$0.25) - 2009/07/01 0:41:43 ET
Table 'QegsWX65l3n/K0A8XB78yg' 6-max Seat #5 is the button
Seat 1: 8ClCHtFXGNplITm+63KB+Q ($29.30 in chips) 
Seat 2: GC/9yVD59DUCX7hUI7gcLw ($32.90 in chips) 
Seat 3: 9jSiy0meE9XJKkdIZwyTEQ ($25 in chips) 
Seat 4: kyRaCIljYA6l33lSKQfNsg ($24.65 in chips) 
Seat 5: 4YSTu0Cdzpppe1lUgCZGCQ ($55.90 in chips) 
Seat 6: JE/wJXmjw3bpdmjwvh2pcg ($37.25 in chips) 
JE/wJXmjw3bpdmjwvh2pcg: posts small blind $0.10
8ClCHtFXGNplITm+63KB+Q: posts big blind $0.25
*** HOLE CARDS ***
GC/9yVD59DUCX7hUI7gcLw: folds 
9jSiy0meE9XJKkdIZwyTEQ: folds 
kyRaCIljYA6l33lSKQfNsg: folds 
4YSTu0Cdzpppe1lUgCZGCQ: raises $0.75 to $1
JE/wJXmjw3bpdmjwvh2pcg: folds 
8ClCHtFXGNplITm+63KB+Q: folds 
Uncalled bet ($0.75) returned to 4YSTu0Cdzpppe1lUgCZGCQ
4YSTu0Cdzpppe1lUgCZGCQ collected $0.60 from pot
4YSTu0Cdzpppe1lUgCZGCQ: doesn't show hand 
*** SUMMARY ***
Total pot $0.60 | Rake $0 
Seat 1: 8ClCHtFXGNplITm+63KB+Q (big blind) folded before Flop
Seat 2: GC/9yVD59DUCX7hUI7gcLw folded before Flop (didn't bet)
Seat 3: 9jSiy0meE9XJKkdIZwyTEQ folded before Flop (didn't bet)
Seat 4: kyRaCIljYA6l33lSKQfNsg folded before Flop (didn't bet)
Seat 5: 4YSTu0Cdzpppe1lUgCZGCQ (button) collected ($0.60)
Seat 6: JE/wJXmjw3bpdmjwvh2pcg (small blind) folded before Flop




PokerStars Game #59939509442:  Hold'em No Limit ($0.10/$0.25) - 2009/07/01 0:41:43 ET
Table 'VQNfcI8vTBCTvRfd3veTLQ' 6-max Seat #3 is the button
Seat 1: ymz+a8dgHSUFPooYplw7Ow ($23.95 in chips) 
Seat 2: KukIGupqqJCXA+Hp2bEFnA ($6.70 in chips) 
Seat 3: LtASJ9OlkqGrrUKGQlpGAw ($23.05 in chips) 
Seat 4: nc79pm0LZRdhncq55evVqA ($28.05 in chips) 
Seat 5: gX2vbKwS/8zZPENAWB7hxQ ($6.65 in chips) 
Seat 6: dlCLwmcvRShnuFDEVkdIEA ($13.50 in chips) 
nc79pm0LZRdhncq55evVqA: posts small blind $0.10
gX2vbKwS/8zZPENAWB7hxQ: posts big blind $0.25
*** HOLE CARDS ***
dlCLwmcvRShnuFDEVkdIEA: calls $0.25
ymz+a8dgHSUFPooYplw7Ow: folds 
KukIGupqqJCXA+Hp2bEFnA: calls $0.25
LtASJ9OlkqGrrUKGQlpGAw: folds 
nc79pm0LZRdhncq55evVqA: calls $0.15
gX2vbKwS/8zZPENAWB7hxQ: checks 
*** FLOP *** [2s 5d 6c]
nc79pm0LZRdhncq55evVqA: checks 
gX2vbKwS/8zZPENAWB7hxQ: checks 
dlCLwmcvRShnuFDEVkdIEA: checks 
KukIGupqqJCXA+Hp2bEFnA: checks 
*** TURN *** [2s 5d 6c] [9s]
nc79pm0LZRdhncq55evVqA: bets $0.50
gX2vbKwS/8zZPENAWB7hxQ: raises $0.75 to $1.25
dlCLwmcvRShnuFDEVkdIEA: folds 
KukIGupqqJCXA+Hp2bEFnA: folds 
nc79pm0LZRdhncq55evVqA: calls $0.75
*** RIVER *** [2s 5d 6c 9s] [2c]
nc79pm0LZRdhncq55evVqA: checks 
gX2vbKwS/8zZPENAWB7hxQ: bets $1.50
nc79pm0LZRdhncq55evVqA: calls $1.50
*** SHOW DOWN ***
gX2vbKwS/8zZPENAWB7hxQ: shows [3c 4h] (a straight, Deuce to Six)
nc79pm0LZRdhncq55evVqA: mucks hand 
gX2vbKwS/8zZPENAWB7hxQ collected $6.20 from pot
*** SUMMARY ***
Total pot $6.50 | Rake $0.30 
Board [2s 5d 6c 9s 2c]
Seat 1: ymz+a8dgHSUFPooYplw7Ow folded before Flop (didn't bet)
Seat 2: KukIGupqqJCXA+Hp2bEFnA folded on the Turn
Seat 3: LtASJ9OlkqGrrUKGQlpGAw (button) folded before Flop (didn't bet)
Seat 4: nc79pm0LZRdhncq55evVqA (small blind) mucked
Seat 5: gX2vbKwS/8zZPENAWB7hxQ (big blind) showed [3c 4h] and won ($6.20) with a straight, Deuce to Six
Seat 6: dlCLwmcvRShnuFDEVkdIEA folded on the Turn




PokerStars Game #59939510172:  Hold'em No Limit ($0.10/$0.25) - 2009/07/01 0:41:44 ET
Table 'qryc9C/ELyQ3lubOaELNAQ' 6-max Seat #1 is the button
Seat 1: OZc6kkoTwtITj1ZfreJK1A ($29.10 in chips) 
Seat 2: qvQc9BHp2FhQjrltLiBN+w ($11.40 in chips) 
Seat 3: UXRtG8J9PoBZWTsNtqdoDA ($21 in chips) 
Seat 4: v+QfkGiuj9bgtuNoVnDO8w ($29.35 in chips) 
Seat 5: pV5UZbjsgam+HUQEd6G++w ($7.90 in chips) 
Seat 6: t2RfOOoa56xW0ZHJC0+5JQ ($8.70 in chips) 
qvQc9BHp2FhQjrltLiBN+w: posts small blind $0.10
UXRtG8J9PoBZWTsNtqdoDA: posts big blind $0.25
*** HOLE CARDS ***
v+QfkGiuj9bgtuNoVnDO8w: folds 
pV5UZbjsgam+HUQEd6G++w: folds 
t2RfOOoa56xW0ZHJC0+5JQ: calls $0.25
OZc6kkoTwtITj1ZfreJK1A: calls $0.25
qvQc9BHp2FhQjrltLiBN+w: calls $0.15
UXRtG8J9PoBZWTsNtqdoDA: checks 
*** FLOP *** [2c Jc Ks]
qvQc9BHp2FhQjrltLiBN+w: bets $0.50
UXRtG8J9PoBZWTsNtqdoDA: folds 
t2RfOOoa56xW0ZHJC0+5JQ: folds 
OZc6kkoTwtITj1ZfreJK1A: folds 
Uncalled bet ($0.50) returned to qvQc9BHp2FhQjrltLiBN+w
qvQc9BHp2FhQjrltLiBN+w collected $0.95 from pot
*** SUMMARY ***
Total pot $1 | Rake $0.05 
Board [2c Jc Ks]
Seat 1: OZc6kkoTwtITj1ZfreJK1A (button) folded on the Flop
Seat 2: qvQc9BHp2FhQjrltLiBN+w (small blind) collected ($0.95)
Seat 3: UXRtG8J9PoBZWTsNtqdoDA (big blind) folded on the Flop
Seat 4: v+QfkGiuj9bgtuNoVnDO8w folded before Flop (didn't bet)
Seat 5: pV5UZbjsgam+HUQEd6G++w folded before Flop (didn't bet)
Seat 6: t2RfOOoa56xW0ZHJC0+5JQ folded on the Flop




PokerStars Game #59939509678:  Hold'em No Limit ($0.10/$0.25) - 2009/07/01 0:41:44 ET
Table 'gkdjhbH1jaE3hwhPRIKMiQ3lL16FBjWXTx3AjK5lMRwwx Seat #5 is the button
Seat 1: fDGyaQz0cs2s4FOYxkbIHA ($8.40 in chips) 
Seat 2: YK2fIgjF+Z0ARwKKcGh1fw ($17.95 in chips) 
Seat 3: QEbIGci+itdw+re8RM5fZA ($25.90 in chips) 
Seat 5: M/9j4wkHH9i1JM51vgi1VA ($22.50 in chips) 
Seat 6: hBMUlEpyU74r/fwDgIpXjQ ($41.70 in chips) 
Seat 8: ljemhp25Zg+nlA9DLCIiUw ($23.30 in chips) 
Seat 9: b8t3jWrxzeEt9HtZtc9wUQ ($10.35 in chips) 
hBMUlEpyU74r/fwDgIpXjQ: posts small blind $0.10
JxpnpCmvRAcrEUy7mq1iAg: is sitting out 
ljemhp25Zg+nlA9DLCIiUw: posts big blind $0.25
*** HOLE CARDS ***
b8t3jWrxzeEt9HtZtc9wUQ: folds 
fDGyaQz0cs2s4FOYxkbIHA: folds 
YK2fIgjF+Z0ARwKKcGh1fw: folds 
JxpnpCmvRAcrEUy7mq1iAg leaves the table
QEbIGci+itdw+re8RM5fZA: folds 
M/9j4wkHH9i1JM51vgi1VA: folds 
hBMUlEpyU74r/fwDgIpXjQ: folds 
Uncalled bet ($0.15) returned to ljemhp25Zg+nlA9DLCIiUw
ljemhp25Zg+nlA9DLCIiUw collected $0.20 from pot
ljemhp25Zg+nlA9DLCIiUw: doesn't show hand 
*** SUMMARY ***
Total pot $0.20 | Rake $0 
Seat 1: fDGyaQz0cs2s4FOYxkbIHA folded before Flop (didn't bet)
Seat 2: YK2fIgjF+Z0ARwKKcGh1fw folded before Flop (didn't bet)
Seat 3: QEbIGci+itdw+re8RM5fZA folded before Flop (didn't bet)
Seat 5: M/9j4wkHH9i1JM51vgi1VA (button) folded before Flop (didn't bet)
Seat 6: hBMUlEpyU74r/fwDgIpXjQ (small blind) folded before Flop
Seat 8: ljemhp25Zg+nlA9DLCIiUw (big blind) collected ($0.20)
Seat 9: b8t3jWrxzeEt9HtZtc9wUQ folded before Flop (didn't bet)




PokerStars Game #59939509806:  Hold'em No Limit ($0.10/$0.25) - 2009/07/01 0:41:44 ET
Table 'hg+KpirwreMnBAFQr/SEUA' 9-max Seat #1 is the button
Seat 1: H5Se03ZqSX7tbULXur2MAg ($24.10 in chips) 
Seat 2: OlPJsgR4xypSg/w1z7Gyvw ($18.15 in chips) 
Seat 3: N6fYvIzQLKaydFLKQGtMlQ ($24.65 in chips) 
Seat 4: GGSFATxBXI5pXwoMMI70zg ($5.45 in chips) 
Seat 5: +2kMBNpY4nF1qNCRd8SJLA ($25 in chips) 
Seat 6: dAohy+E9dUFBp6GlYFiOtQ ($24.95 in chips) 
Seat 7: EcWpc/mcsCWBGKsSdZaXbA ($23.80 in chips) 
Seat 8: HPEB+AtKw1+C/cxU0o1ciw ($25 in chips) 
OlPJsgR4xypSg/w1z7Gyvw: posts small blind $0.10
N6fYvIzQLKaydFLKQGtMlQ: posts big blind $0.25
*** HOLE CARDS ***
GGSFATxBXI5pXwoMMI70zg: folds 
+2kMBNpY4nF1qNCRd8SJLA: folds 
dAohy+E9dUFBp6GlYFiOtQ: calls $0.25
EcWpc/mcsCWBGKsSdZaXbA: folds 
HPEB+AtKw1+C/cxU0o1ciw: folds 
H5Se03ZqSX7tbULXur2MAg: folds 
OlPJsgR4xypSg/w1z7Gyvw: folds 
N6fYvIzQLKaydFLKQGtMlQ: checks 
*** FLOP *** [2h 9c 3h]
N6fYvIzQLKaydFLKQGtMlQ: checks 
dAohy+E9dUFBp6GlYFiOtQ: checks 
*** TURN *** [2h 9c 3h] [Qh]
N6fYvIzQLKaydFLKQGtMlQ: checks 
dAohy+E9dUFBp6GlYFiOtQ: checks 
*** RIVER *** [2h 9c 3h Qh] [4d]
N6fYvIzQLKaydFLKQGtMlQ: checks 
dAohy+E9dUFBp6GlYFiOtQ: checks 
*** SHOW DOWN ***
N6fYvIzQLKaydFLKQGtMlQ: shows [Ks 5d] (high card King)
dAohy+E9dUFBp6GlYFiOtQ: mucks hand 
N6fYvIzQLKaydFLKQGtMlQ collected $0.60 from pot
*** SUMMARY ***
Total pot $0.60 | Rake $0 
Board [2h 9c 3h Qh 4d]
Seat 1: H5Se03ZqSX7tbULXur2MAg (button) folded before Flop (didn't bet)
Seat 2: OlPJsgR4xypSg/w1z7Gyvw (small blind) folded before Flop
Seat 3: N6fYvIzQLKaydFLKQGtMlQ (big blind) showed [Ks 5d] and won ($0.60) with high card King
Seat 4: GGSFATxBXI5pXwoMMI70zg folded before Flop (didn't bet)
Seat 5: +2kMBNpY4nF1qNCRd8SJLA folded before Flop (didn't bet)
Seat 6: dAohy+E9dUFBp6GlYFiOtQ mucked
Seat 7: EcWpc/mcsCWBGKsSdZaXbA folded before Flop (didn't bet)
Seat 8: HPEB+AtKw1+C/cxU0o1ciw folded before Flop (didn't bet)




PokerStars Game #59939510276:  Hold'em No Limit ($0.10/$0.25) - 2009/07/01 0:41:44 ET
Table 'ThBZ355rqvsb8UGb6ajbig' 9-max Seat #5 is the button
Seat 2: 4awUyiDYTgylQKXZ9faBVA ($25 in chips) 
Seat 3: LBrhQVB4w41YNd7kMYn/og ($11.85 in chips) 
Seat 4: GFNwOPqg/Zu4ZuokgGADNQ ($15 in chips) 
Seat 5: ljO8CPts14fBjr9/qK0Enw ($10.90 in chips) 
Seat 6: qwr38jl5txoR36M7G5qi4A ($7.50 in chips) 
Seat 7: t2nb95S5EEFOEzNx9Itz0g ($12.95 in chips) 
Seat 8: 6REZ3fl3I5Kaxoupd8cnLg ($29 in chips) 
Seat 9: 8B/dhbQjIWe6ASCdgzktNQ ($28.75 in chips) 
qwr38jl5txoR36M7G5qi4A: posts small blind $0.10
t2nb95S5EEFOEzNx9Itz0g: posts big blind $0.25
*** HOLE CARDS ***
6REZ3fl3I5Kaxoupd8cnLg: calls $0.25
8B/dhbQjIWe6ASCdgzktNQ: folds 
4awUyiDYTgylQKXZ9faBVA: raises $1 to $1.25
LBrhQVB4w41YNd7kMYn/og: folds 
GFNwOPqg/Zu4ZuokgGADNQ: folds 
ljO8CPts14fBjr9/qK0Enw: folds 
qwr38jl5txoR36M7G5qi4A: folds 
t2nb95S5EEFOEzNx9Itz0g: folds 
6REZ3fl3I5Kaxoupd8cnLg: calls $1
*** FLOP *** [8d 5c 3c]
6REZ3fl3I5Kaxoupd8cnLg: checks 
4awUyiDYTgylQKXZ9faBVA: bets $1.50
6REZ3fl3I5Kaxoupd8cnLg: folds 
Uncalled bet ($1.50) returned to 4awUyiDYTgylQKXZ9faBVA
4awUyiDYTgylQKXZ9faBVA collected $2.75 from pot
4awUyiDYTgylQKXZ9faBVA: doesn't show hand 
*** SUMMARY ***
Total pot $2.85 | Rake $0.10 
Board [8d 5c 3c]
Seat 2: 4awUyiDYTgylQKXZ9faBVA collected ($2.75)
Seat 3: LBrhQVB4w41YNd7kMYn/og folded before Flop (didn't bet)
Seat 4: GFNwOPqg/Zu4ZuokgGADNQ folded before Flop (didn't bet)
Seat 5: ljO8CPts14fBjr9/qK0Enw (button) folded before Flop (didn't bet)
Seat 6: qwr38jl5txoR36M7G5qi4A (small blind) folded before Flop
Seat 7: t2nb95S5EEFOEzNx9Itz0g (big blind) folded before Flop
Seat 8: 6REZ3fl3I5Kaxoupd8cnLg folded on the Flop
Seat 9: 8B/dhbQjIWe6ASCdgzktNQ folded before Flop (didn't bet)




PokerStars Game #59939509796:  Hold'em No Limit ($0.10/$0.25) - 2009/07/01 0:41:44 ET
Table 'Loy/olZ5qoDOSvX4UTujGg' 6-max Seat #6 is the button
Seat 1: yzFNNFIfC89bBPwpFPx2ow ($28.95 in chips) 
Seat 3: 32YL2ZEp8NT4JB2RVM9euQ ($16 in chips) 
Seat 4: /gJNBeCkWL4o85/jvlZ4BA ($27.10 in chips) 
Seat 6: 7FmwVDcdEtxDpHmP4hOXsQ ($52.35 in chips) 
yzFNNFIfC89bBPwpFPx2ow: posts small blind $0.10
32YL2ZEp8NT4JB2RVM9euQ: posts big blind $0.25
*** HOLE CARDS ***
/gJNBeCkWL4o85/jvlZ4BA: folds 
4YSTu0Cdzpppe1lUgCZGCQ has returned
7FmwVDcdEtxDpHmP4hOXsQ: raises $0.50 to $0.75
yzFNNFIfC89bBPwpFPx2ow: folds 
32YL2ZEp8NT4JB2RVM9euQ: folds 
Uncalled bet ($0.50) returned to 7FmwVDcdEtxDpHmP4hOXsQ
7FmwVDcdEtxDpHmP4hOXsQ collected $0.60 from pot
7FmwVDcdEtxDpHmP4hOXsQ: doesn't show hand 
*** SUMMARY ***
Total pot $0.60 | Rake $0 
Seat 1: yzFNNFIfC89bBPwpFPx2ow (small blind) folded before Flop
Seat 3: 32YL2ZEp8NT4JB2RVM9euQ (big blind) folded before Flop
Seat 4: /gJNBeCkWL4o85/jvlZ4BA folded before Flop (didn't bet)
Seat 6: 7FmwVDcdEtxDpHmP4hOXsQ (button) collected ($0.60)




PokerStars Game #59939510674:  Hold'em No Limit ($0.10/$0.25) - 2009/07/01 0:41:45 ET
Table '+198VWQSWBhYQOcizzuBkw' 6-max Seat #6 is the button
Seat 2: R6AGToFJQOYVZAjC2jXEKw ($28.90 in chips) 
Seat 3: BYxjLnV1/LL0aZcTbfAOvw ($27.85 in chips) 
Seat 4: TgDsTeCdLQt8kWbL00ByRA ($27.25 in chips) 
Seat 5: LtASJ9OlkqGrrUKGQlpGAw ($29.95 in chips) 
Seat 6: 7qRk4YH4/k/08LgJSv7rBQ ($31.25 in chips) 
R6AGToFJQOYVZAjC2jXEKw: posts small blind $0.10
BYxjLnV1/LL0aZcTbfAOvw: posts big blind $0.25
*** HOLE CARDS ***
TgDsTeCdLQt8kWbL00ByRA: folds 
LtASJ9OlkqGrrUKGQlpGAw: raises $0.50 to $0.75
7qRk4YH4/k/08LgJSv7rBQ: folds 
R6AGToFJQOYVZAjC2jXEKw: folds 
BYxjLnV1/LL0aZcTbfAOvw: folds 
Uncalled bet ($0.50) returned to LtASJ9OlkqGrrUKGQlpGAw
LtASJ9OlkqGrrUKGQlpGAw collected $0.60 from pot
LtASJ9OlkqGrrUKGQlpGAw: doesn't show hand 
*** SUMMARY ***
Total pot $0.60 | Rake $0 
Seat 2: R6AGToFJQOYVZAjC2jXEKw (small blind) folded before Flop
Seat 3: BYxjLnV1/LL0aZcTbfAOvw (big blind) folded before Flop
Seat 4: TgDsTeCdLQt8kWbL00ByRA folded before Flop (didn't bet)
Seat 5: LtASJ9OlkqGrrUKGQlpGAw collected ($0.60)
Seat 6: 7qRk4YH4/k/08LgJSv7rBQ (button) folded before Flop (didn't bet)




PokerStars Game #59939510644:  Hold'em No Limit ($0.10/$0.25) - 2009/07/01 0:41:45 ET
Table 'vFZR6Kf2Th5xBXT9brGW6A' 6-max Seat #5 is the button
Seat 1: xRkU4+naLuz7dEZFbOn9cw ($34.95 in chips) 
Seat 2: REnO5xiZ66YabxDXq2ncvA ($52.05 in chips) 
Seat 4: 79ID/ub1Pt/mDpCprVmOoA ($25.70 in chips) 
Seat 5: NhUN/JpAprdJeamFBgJH1w ($25 in chips) 
Seat 6: d0J1xuhsynEY81YHwAvJ5g ($29.85 in chips) 
d0J1xuhsynEY81YHwAvJ5g: posts small blind $0.10
xRkU4+naLuz7dEZFbOn9cw: posts big blind $0.25
*** HOLE CARDS ***
REnO5xiZ66YabxDXq2ncvA: folds 
79ID/ub1Pt/mDpCprVmOoA: raises $0.50 to $0.75
NhUN/JpAprdJeamFBgJH1w: folds 
d0J1xuhsynEY81YHwAvJ5g: folds 
xRkU4+naLuz7dEZFbOn9cw: calls $0.50
*** FLOP *** [Jh Ah Qh]
xRkU4+naLuz7dEZFbOn9cw: checks 
79ID/ub1Pt/mDpCprVmOoA: checks 
*** TURN *** [Jh Ah Qh] [5d]
xRkU4+naLuz7dEZFbOn9cw: checks 
79ID/ub1Pt/mDpCprVmOoA: checks 
*** RIVER *** [Jh Ah Qh 5d] [8s]
xRkU4+naLuz7dEZFbOn9cw: checks 
79ID/ub1Pt/mDpCprVmOoA: checks 
*** SHOW DOWN ***
xRkU4+naLuz7dEZFbOn9cw: shows [3h 5s] (a pair of Fives)
79ID/ub1Pt/mDpCprVmOoA: shows [6c 6h] (a pair of Sixes)
79ID/ub1Pt/mDpCprVmOoA collected $1.55 from pot
*** SUMMARY ***
Total pot $1.60 | Rake $0.05 
Board [Jh Ah Qh 5d 8s]
Seat 1: xRkU4+naLuz7dEZFbOn9cw (big blind) showed [3h 5s] and lost with a pair of Fives
Seat 2: REnO5xiZ66YabxDXq2ncvA folded before Flop (didn't bet)
Seat 4: 79ID/ub1Pt/mDpCprVmOoA showed [6c 6h] and won ($1.55) with a pair of Sixes
Seat 5: NhUN/JpAprdJeamFBgJH1w (button) folded before Flop (didn't bet)
Seat 6: d0J1xuhsynEY81YHwAvJ5g (small blind) folded before Flop




PokerStars Game #59939510604:  Hold'em No Limit ($0.10/$0.25) - 2009/07/01 0:41:45 ET
Table 'gkdjhbH1jaE3hwhPRIKMiQ' 6-max Seat #3 is the button
Seat 1: nc79pm0LZRdhncq55evVqA ($25 in chips) 
Seat 2: 1NNFfYMd5Hsphl/FYz9fNA ($33.65 in chips) 
Seat 3: kG34n23qFQA3nzdOJTQ1dA ($24.65 in chips) 
Seat 5: Ew/TYPQIsbQ2X8nm5iAJBg ($24.65 in chips) 
Seat 6: wqphQtauX5Qn7WRJZS1flA ($27.70 in chips) 
Ew/TYPQIsbQ2X8nm5iAJBg: posts small blind $0.10
wqphQtauX5Qn7WRJZS1flA: posts big blind $0.25
*** HOLE CARDS ***
nc79pm0LZRdhncq55evVqA: folds 
1NNFfYMd5Hsphl/FYz9fNA: folds 
kG34n23qFQA3nzdOJTQ1dA: folds 
Ew/TYPQIsbQ2X8nm5iAJBg: folds 
Uncalled bet ($0.15) returned to wqphQtauX5Qn7WRJZS1flA
wqphQtauX5Qn7WRJZS1flA collected $0.20 from pot
wqphQtauX5Qn7WRJZS1flA: doesn't show hand 
*** SUMMARY ***
Total pot $0.20 | Rake $0 
Seat 1: nc79pm0LZRdhncq55evVqA folded before Flop (didn't bet)
Seat 2: 1NNFfYMd5Hsphl/FYz9fNA folded before Flop (didn't bet)
Seat 3: kG34n23qFQA3nzdOJTQ1dA (button) folded before Flop (didn't bet)
Seat 5: Ew/TYPQIsbQ2X8nm5iAJBg (small blind) folded before Flop
Seat 6: wqphQtauX5Qn7WRJZS1flA (big blind) collected ($0.20)




PokerStars Game #59939510878:  Hold'em No Limit ($0.10/$0.25) - 2009/07/01 0:41:45 ET
Table 'MiquQrQZJJq9ZtgRIp9HFQ' 6-max Seat #5 is the button
Seat 1: hM0MSDtq2ow7J40bSR04ig ($4.90 in chips) 
Seat 2: DMQLAmut/l19xN5STQndFg ($2.60 in chips) 
Seat 4: 0HIrwssk0FQvyKULzUTtlg ($20.20 in chips) 
Seat 5: LXN9U+5F+9if/ead2+w1nw ($46.70 in chips) 
Seat 6: X9oXZTg4PhZVR+ilX2OYbA ($12.90 in chips) 
X9oXZTg4PhZVR+ilX2OYbA: posts small blind $0.10
hM0MSDtq2ow7J40bSR04ig: posts big blind $0.25
BYxjLnV1/LL0aZcTbfAOvw: sits out 
*** HOLE CARDS ***
DMQLAmut/l19xN5STQndFg: folds 
0HIrwssk0FQvyKULzUTtlg: raises $0.50 to $0.75
LXN9U+5F+9if/ead2+w1nw: folds 
X9oXZTg4PhZVR+ilX2OYbA: calls $0.65
hM0MSDtq2ow7J40bSR04ig: folds 
*** FLOP *** [5h Ac 3c]
X9oXZTg4PhZVR+ilX2OYbA: checks 
0HIrwssk0FQvyKULzUTtlg: bets $1
X9oXZTg4PhZVR+ilX2OYbA: folds 
Uncalled bet ($1) returned to 0HIrwssk0FQvyKULzUTtlg
0HIrwssk0FQvyKULzUTtlg collected $1.70 from pot
*** SUMMARY ***
Total pot $1.75 | Rake $0.05 
Board [5h Ac 3c]
Seat 1: hM0MSDtq2ow7J40bSR04ig (big blind) folded before Flop
Seat 2: DMQLAmut/l19xN5STQndFg folded before Flop (didn't bet)
Seat 4: 0HIrwssk0FQvyKULzUTtlg collected ($1.70)
Seat 5: LXN9U+5F+9if/ead2+w1nw (button) folded before Flop (didn't bet)
Seat 6: X9oXZTg4PhZVR+ilX2OYbA (small blind) folded on the Flop




PokerStars Game #59939510408:  Hold'em No Limit ($0.10/$0.25) - 2009/07/01 0:41:45 ET
Table 'UVjmXTtsmlX1HxwwZ59akg' 9-max Seat #6 is the button
Seat 1: zDrucyjVn5aeekNEc3cJrA ($28.55 in chips) 
Seat 2: COsrwJSFHQtxlUcrYtDQPQ ($27.60 in chips) 
Seat 3: N6fYvIzQLKaydFLKQGtMlQ ($24.65 in chips) 
Seat 4: aNpwfA31EREwO+ar4XzBCw ($25 in chips) 
Seat 6: DnDcAdn9P0zGovMERigpFA ($33.75 in chips) 
1MicVRr41LapJvzzk3i8Tw: is sitting out 
zDrucyjVn5aeekNEc3cJrA: posts small blind $0.10
COsrwJSFHQtxlUcrYtDQPQ: posts big blind $0.25
*** HOLE CARDS ***
N6fYvIzQLKaydFLKQGtMlQ: folds 
aNpwfA31EREwO+ar4XzBCw: folds 
DnDcAdn9P0zGovMERigpFA: folds 
zDrucyjVn5aeekNEc3cJrA: calls $0.15
COsrwJSFHQtxlUcrYtDQPQ: checks 
*** FLOP *** [6c Ac Jd]
zDrucyjVn5aeekNEc3cJrA: checks 
COsrwJSFHQtxlUcrYtDQPQ: checks 
*** TURN *** [6c Ac Jd] [7d]
zDrucyjVn5aeekNEc3cJrA: checks 
COsrwJSFHQtxlUcrYtDQPQ: checks 
*** RIVER *** [6c Ac Jd 7d] [5d]
zDrucyjVn5aeekNEc3cJrA: checks 
COsrwJSFHQtxlUcrYtDQPQ: checks 
*** SHOW DOWN ***
zDrucyjVn5aeekNEc3cJrA: shows [8d Jc] (a pair of Jacks)
COsrwJSFHQtxlUcrYtDQPQ: mucks hand 
zDrucyjVn5aeekNEc3cJrA collected $0.50 from pot
*** SUMMARY ***
Total pot $0.50 | Rake $0 
Board [6c Ac Jd 7d 5d]
Seat 1: zDrucyjVn5aeekNEc3cJrA (small blind) showed [8d Jc] and won ($0.50) with a pair of Jacks
Seat 2: COsrwJSFHQtxlUcrYtDQPQ (big blind) mucked
Seat 3: N6fYvIzQLKaydFLKQGtMlQ folded before Flop (didn't bet)
Seat 4: aNpwfA31EREwO+ar4XzBCw folded before Flop (didn't bet)
Seat 6: DnDcAdn9P0zGovMERigpFA (button) folded before Flop (didn't bet)




PokerStars Game #59939510464:  Hold'em No Limit ($0.10/$0.25) - 2009/07/01 0:41:45 ET
Table '/JJyyIstHfkT7t/bW+WXgg' 6-max Seat #5 is the button
Seat 1: wsP46AGpqDjHZQmlRHKa9g ($26.15 in chips) 
Seat 2: eRDLpytVTPI4rY3iortMSw ($5.35 in chips) 
Seat 3: oc4ZGs0W+3RIg2yPyJw3ig ($25.85 in chips) 
Seat 4: ELW+DKizJhLK7k40PMkD2Q ($25.80 in chips) 
Seat 5: 2wkoolB4YxxVC2x99F9rcA ($29.75 in chips) 
Seat 6: d338A2rm6NtA1ECEZi4d2g ($16.25 in chips) 
d338A2rm6NtA1ECEZi4d2g: posts small blind $0.10
wsP46AGpqDjHZQmlRHKa9g: posts big blind $0.25
*** HOLE CARDS ***
eRDLpytVTPI4rY3iortMSw: folds 
oc4ZGs0W+3RIg2yPyJw3ig: folds 
ELW+DKizJhLK7k40PMkD2Q: folds 
2wkoolB4YxxVC2x99F9rcA: folds 
d338A2rm6NtA1ECEZi4d2g: raises $0.75 to $1
wsP46AGpqDjHZQmlRHKa9g: calls $0.75
*** FLOP *** [6h 2s 7c]
d338A2rm6NtA1ECEZi4d2g: bets $1.50
wsP46AGpqDjHZQmlRHKa9g: folds 
Uncalled bet ($1.50) returned to d338A2rm6NtA1ECEZi4d2g
d338A2rm6NtA1ECEZi4d2g collected $1.90 from pot
*** SUMMARY ***
Total pot $2 | Rake $0.10 
Board [6h 2s 7c]
Seat 1: wsP46AGpqDjHZQmlRHKa9g (big blind) folded on the Flop
Seat 2: eRDLpytVTPI4rY3iortMSw folded before Flop (didn't bet)
Seat 3: oc4ZGs0W+3RIg2yPyJw3ig folded before Flop (didn't bet)
Seat 4: ELW+DKizJhLK7k40PMkD2Q folded before Flop (didn't bet)
Seat 5: 2wkoolB4YxxVC2x99F9rcA (button) folded before Flop (didn't bet)
Seat 6: d338A2rm6NtA1ECEZi4d2g (small blind) collected ($1.90)




PokerStars Game #59939511438:  Hold'em No Limit ($0.10/$0.25) - 2009/07/01 0:41:46 ET
Table 'Do4nrTNDYpK3sQjwFxX+Og' 6-max Seat #5 is the button
Seat 1: 7JrQNOR9wRBxq9ijFhWieg ($29.45 in chips) 
Seat 2: tzMoGl9F0PUr5NibYueeSw ($44.15 in chips) 
Seat 3: TSmua8tGK3sTbwi0ynrW9Q ($31.05 in chips) 
Seat 4: df7bIV965hvGEDiUAs5cfQ ($13.80 in chips) 
Seat 5: Ew/TYPQIsbQ2X8nm5iAJBg ($31.15 in chips) 
Seat 6: eHsmIvAb2JREg4O6hNPnXg ($24.20 in chips) 
eHsmIvAb2JREg4O6hNPnXg: posts small blind $0.10
7JrQNOR9wRBxq9ijFhWieg: posts big blind $0.25
*** HOLE CARDS ***
tzMoGl9F0PUr5NibYueeSw: folds 
TSmua8tGK3sTbwi0ynrW9Q: folds 
df7bIV965hvGEDiUAs5cfQ: raises $0.50 to $0.75
Ew/TYPQIsbQ2X8nm5iAJBg: folds 
eHsmIvAb2JREg4O6hNPnXg: calls $0.65
7JrQNOR9wRBxq9ijFhWieg: folds 
*** FLOP *** [Th 8h 4s]
eHsmIvAb2JREg4O6hNPnXg: bets $0.50
df7bIV965hvGEDiUAs5cfQ: calls $0.50
*** TURN *** [Th 8h 4s] [Ks]
eHsmIvAb2JREg4O6hNPnXg: bets $0.50
df7bIV965hvGEDiUAs5cfQ: raises $1.50 to $2
eHsmIvAb2JREg4O6hNPnXg: folds 
Uncalled bet ($1.50) returned to df7bIV965hvGEDiUAs5cfQ
df7bIV965hvGEDiUAs5cfQ collected $3.60 from pot
*** SUMMARY ***
Total pot $3.75 | Rake $0.15 
Board [Th 8h 4s Ks]
Seat 1: 7JrQNOR9wRBxq9ijFhWieg (big blind) folded before Flop
Seat 2: tzMoGl9F0PUr5NibYueeSw folded before Flop (didn't bet)
Seat 3: TSmua8tGK3sTbwi0ynrW9Q folded before Flop (didn't bet)
Seat 4: df7bIV965hvGEDiUAs5cfQ collected ($3.60)
Seat 5: Ew/TYPQIsbQ2X8nm5iAJBg (button) folded before Flop (didn't bet)
Seat 6: eHsmIvAb2JREg4O6hNPnXg (small blind) folded on the Turn




PokerStars Game #59939511122:  Hold'em No Limit ($0.10/$0.25) - 2009/07/01 0:41:46 ET
Table '/XCUCUl3yW6tdTJQEhJKGw' 6-max Seat #5 is the button
Seat 1: p8J112JmNRnCwV2+NAEzCA ($15.65 in chips) 
Seat 2: 8ClCHtFXGNplITm+63KB+Q ($27.95 in chips) 
Seat 3: /gJNBeCkWL4o85/jvlZ4BA ($36.60 in chips) 
Seat 4: SFmT9ZsVopnukjvAzrxTRg ($25 in chips) 
Seat 5: 3rlIjSrvbZoI2IILbnetnA ($25 in chips) 
Seat 6: armfxZhGxeZVZBYAQFuIJQ ($36.20 in chips) 
armfxZhGxeZVZBYAQFuIJQ: posts small blind $0.10
p8J112JmNRnCwV2+NAEzCA: posts big blind $0.25
*** HOLE CARDS ***
8ClCHtFXGNplITm+63KB+Q: folds 
/gJNBeCkWL4o85/jvlZ4BA: folds 
SFmT9ZsVopnukjvAzrxTRg: folds 
3rlIjSrvbZoI2IILbnetnA: calls $0.25
armfxZhGxeZVZBYAQFuIJQ: calls $0.15
p8J112JmNRnCwV2+NAEzCA: checks 
*** FLOP *** [8c 3h 4c]
armfxZhGxeZVZBYAQFuIJQ: bets $0.50
p8J112JmNRnCwV2+NAEzCA: calls $0.50
3rlIjSrvbZoI2IILbnetnA: folds 
*** TURN *** [8c 3h 4c] [Th]
armfxZhGxeZVZBYAQFuIJQ: bets $1.25
p8J112JmNRnCwV2+NAEzCA: raises $1.60 to $2.85
armfxZhGxeZVZBYAQFuIJQ: calls $1.60
*** RIVER *** [8c 3h 4c Th] [5c]
armfxZhGxeZVZBYAQFuIJQ: checks 
p8J112JmNRnCwV2+NAEzCA: checks 
*** SHOW DOWN ***
armfxZhGxeZVZBYAQFuIJQ: shows [8h 6h] (a pair of Eights)
p8J112JmNRnCwV2+NAEzCA: shows [Ts 3s] (two pair, Tens and Threes)
p8J112JmNRnCwV2+NAEzCA collected $7.10 from pot
*** SUMMARY ***
Total pot $7.45 | Rake $0.35 
Board [8c 3h 4c Th 5c]
Seat 1: p8J112JmNRnCwV2+NAEzCA (big blind) showed [Ts 3s] and won ($7.10) with two pair, Tens and Threes
Seat 2: 8ClCHtFXGNplITm+63KB+Q folded before Flop (didn't bet)
Seat 3: /gJNBeCkWL4o85/jvlZ4BA folded before Flop (didn't bet)
Seat 4: SFmT9ZsVopnukjvAzrxTRg folded before Flop (didn't bet)
Seat 5: 3rlIjSrvbZoI2IILbnetnA (button) folded on the Flop
Seat 6: armfxZhGxeZVZBYAQFuIJQ (small blind) showed [8h 6h] and lost with a pair of Eights




PokerStars Game #59939511376:  Hold'em No Limit ($0.10/$0.25) - 2009/07/01 0:41:46 ET
Table 'GgmUtmhrYPRnhkqEEjD/Kw' 9-max Seat #2 is the button
Seat 2: ghNKXUBl/H+t83JF079ZBA ($25 in chips) 
Seat 3: DZek9vrzBExLUFtbWml/Eg ($11.30 in chips) 
Seat 4: uwmAXQRjyA4iX5kaC15P9A ($5.40 in chips) 
Seat 6: 4Ax0vobe1rLVIGZmkFINGA ($17.55 in chips) 
Seat 7: YwDw9cMqkbMznFK77rru4A ($8.55 in chips) 
Seat 8: mKwW7JjB4GQW2YtoYgqIgw ($12.30 in chips) 
DZek9vrzBExLUFtbWml/Eg: posts small blind $0.10
uwmAXQRjyA4iX5kaC15P9A: posts big blind $0.25
vnCdP3GsLTKadDukKcJk/Q: sits out 
*** HOLE CARDS ***
4Ax0vobe1rLVIGZmkFINGA: calls $0.25
YwDw9cMqkbMznFK77rru4A: folds 
mKwW7JjB4GQW2YtoYgqIgw: raises $1 to $1.25
ghNKXUBl/H+t83JF079ZBA: folds 
DZek9vrzBExLUFtbWml/Eg: folds 
uwmAXQRjyA4iX5kaC15P9A: folds 
4Ax0vobe1rLVIGZmkFINGA: folds 
Uncalled bet ($1) returned to mKwW7JjB4GQW2YtoYgqIgw
mKwW7JjB4GQW2YtoYgqIgw collected $0.85 from pot
*** SUMMARY ***
Total pot $0.85 | Rake $0 
Seat 2: ghNKXUBl/H+t83JF079ZBA (button) folded before Flop (didn't bet)
Seat 3: DZek9vrzBExLUFtbWml/Eg (small blind) folded before Flop
Seat 4: uwmAXQRjyA4iX5kaC15P9A (big blind) folded before Flop
Seat 6: 4Ax0vobe1rLVIGZmkFINGA folded before Flop
Seat 7: YwDw9cMqkbMznFK77rru4A folded before Flop (didn't bet)
Seat 8: mKwW7JjB4GQW2YtoYgqIgw collected ($0.85)




PokerStars Game #59939511072:  Hold'em No Limit ($0.10/$0.25) - 2009/07/01 0:41:46 ET
Table '2VkNDXXsBj4bSZw/uK5atw' 6-max Seat #6 is the button
Seat 1: 7FmwVDcdEtxDpHmP4hOXsQ ($26.50 in chips) 
Seat 2: gqW2aBCmrIw65BvwjTFN6Q ($25 in chips) 
Seat 4: yb6rnd48JuBccThV68VHAQ ($74.65 in chips) 
Seat 5: kyRaCIljYA6l33lSKQfNsg ($24.65 in chips) 
Seat 6: qGHGf/553gQnDoklMRe3tg ($24.90 in chips) 
7FmwVDcdEtxDpHmP4hOXsQ: posts small blind $0.10
gqW2aBCmrIw65BvwjTFN6Q: posts big blind $0.25
*** HOLE CARDS ***
yb6rnd48JuBccThV68VHAQ: folds 
8D0jr3B4e++Q/cTSnpHdzg joins the table at seat #3 
kyRaCIljYA6l33lSKQfNsg: folds 
qGHGf/553gQnDoklMRe3tg: folds 
7FmwVDcdEtxDpHmP4hOXsQ: folds 
Uncalled bet ($0.15) returned to gqW2aBCmrIw65BvwjTFN6Q
gqW2aBCmrIw65BvwjTFN6Q collected $0.20 from pot
gqW2aBCmrIw65BvwjTFN6Q: doesn't show hand 
*** SUMMARY ***
Total pot $0.20 | Rake $0 
Seat 1: 7FmwVDcdEtxDpHmP4hOXsQ (small blind) folded before Flop
Seat 2: gqW2aBCmrIw65BvwjTFN6Q (big blind) collected ($0.20)
Seat 4: yb6rnd48JuBccThV68VHAQ folded before Flop (didn't bet)
Seat 5: kyRaCIljYA6l33lSKQfNsg folded before Flop (didn't bet)
Seat 6: qGHGf/553gQnDoklMRe3tg (button) folded before Flop (didn't bet)




PokerStars Game #59939510902:  Hold'em No Limit ($0.10/$0.25) - 2009/07/01 0:41:46 ET
Table '1LkLBsok91+aSWIELy/cyw' 6-max Seat #1 is the button
Seat 1: /gJNBeCkWL4o85/jvlZ4BA ($25.15 in chips) 
Seat 2: oseFhpinoe+Zg4j5xyBjyQ ($25.70 in chips) 
Seat 4: vEZ/HxVuyR6kaq0BtZoUgQ ($13.85 in chips) 
Seat 5: trN/oHqTTbPw5MNuKrOpLw ($29.05 in chips) 
Seat 6: MuW7Zf0FjOGlCuY3aIrlsA ($24.75 in chips) 
oseFhpinoe+Zg4j5xyBjyQ: posts small blind $0.10
vEZ/HxVuyR6kaq0BtZoUgQ: posts big blind $0.25
*** HOLE CARDS ***
wUwfsTnmpHcWa17qFlQr1Q leaves the table
trN/oHqTTbPw5MNuKrOpLw: folds 
MuW7Zf0FjOGlCuY3aIrlsA: raises $0.75 to $1
/gJNBeCkWL4o85/jvlZ4BA: folds 
+yxuvzJHyIWsJ515X8zJTQ joins the table at seat #3 
oseFhpinoe+Zg4j5xyBjyQ: folds 
vEZ/HxVuyR6kaq0BtZoUgQ: folds 
Uncalled bet ($0.75) returned to MuW7Zf0FjOGlCuY3aIrlsA
MuW7Zf0FjOGlCuY3aIrlsA collected $0.60 from pot
MuW7Zf0FjOGlCuY3aIrlsA: doesn't show hand 
*** SUMMARY ***
Total pot $0.60 | Rake $0 
Seat 1: /gJNBeCkWL4o85/jvlZ4BA (button) folded before Flop (didn't bet)
Seat 2: oseFhpinoe+Zg4j5xyBjyQ (small blind) folded before Flop
Seat 4: vEZ/HxVuyR6kaq0BtZoUgQ (big blind) folded before Flop
Seat 5: trN/oHqTTbPw5MNuKrOpLw folded before Flop (didn't bet)
Seat 6: MuW7Zf0FjOGlCuY3aIrlsA collected ($0.60)




PokerStars Game #59939511112:  Hold'em No Limit ($0.10/$0.25) - 2009/07/01 0:41:46 ET
Table 'D1Yq70l0nNCyMV6DA42p+Q' 9-max Seat #7 is the button
Seat 1: z5GxcHlYz/GSz6W2uFiTtg ($14.60 in chips) 
Seat 2: OB0uLxxDeISeDjs0cxaocA ($31.60 in chips) 
Seat 3: j4q3p0lesp63b1gZDwLBZw ($5 in chips) 
Seat 5: gehe91e0IyVT0QU/XBkEyg ($26.05 in chips) 
Seat 6: MgMavn/DzTzqKgHTZMsVSw ($24.15 in chips) 
Seat 7: 9mw49/JQZ9pj0wFynA329g ($14.35 in chips) 
Seat 8: zDrucyjVn5aeekNEc3cJrA ($22.70 in chips) 
zDrucyjVn5aeekNEc3cJrA: posts small blind $0.10
3PjJjazzeHcM4mbFeXmZBg: is sitting out 
3PjJjazzeHcM4mbFeXmZBg leaves the table
z5GxcHlYz/GSz6W2uFiTtg: posts big blind $0.25
*** HOLE CARDS ***
OB0uLxxDeISeDjs0cxaocA: folds 
j4q3p0lesp63b1gZDwLBZw: folds 
gehe91e0IyVT0QU/XBkEyg: folds 
MgMavn/DzTzqKgHTZMsVSw: raises $0.75 to $1
9mw49/JQZ9pj0wFynA329g: folds 
zDrucyjVn5aeekNEc3cJrA: folds 
z5GxcHlYz/GSz6W2uFiTtg: folds 
Uncalled bet ($0.75) returned to MgMavn/DzTzqKgHTZMsVSw
MgMavn/DzTzqKgHTZMsVSw collected $0.60 from pot
MgMavn/DzTzqKgHTZMsVSw: doesn't show hand 
*** SUMMARY ***
Total pot $0.60 | Rake $0 
Seat 1: z5GxcHlYz/GSz6W2uFiTtg (big blind) folded before Flop
Seat 2: OB0uLxxDeISeDjs0cxaocA folded before Flop (didn't bet)
Seat 3: j4q3p0lesp63b1gZDwLBZw folded before Flop (didn't bet)
Seat 5: gehe91e0IyVT0QU/XBkEyg folded before Flop (didn't bet)
Seat 6: MgMavn/DzTzqKgHTZMsVSw collected ($0.60)
Seat 7: 9mw49/JQZ9pj0wFynA329g (button) folded before Flop (didn't bet)
Seat 8: zDrucyjVn5aeekNEc3cJrA (small blind) folded before Flop




PokerStars Game #59939511026:  Hold'em No Limit ($0.10/$0.25) - 2009/07/01 0:41:46 ET
Table 'x7YStLKc8hpt/pTgSetPKA' 9-max Seat #8 is the button
Seat 1: tYsOBqdU1+x+yFI7zHO7hQ ($25 in chips) 
Seat 2: z5GxcHlYz/GSz6W2uFiTtg ($36.25 in chips) 
Seat 3: S7Ki0P+0AIGPuIfGJjW0gg ($25.10 in chips) 
Seat 5: gxyie8xe6lDdpfG4quHtbw ($9.15 in chips) 
Seat 6: Yv4fucyyT28mjx8V5lxKJg ($31.80 in chips) 
Seat 7: +8FtfKCFr23+6O39P+U45Q ($29.50 in chips) 
Seat 8: jeKWRUkMaVn8rEUjnJKqpg ($33.15 in chips) 
Seat 9: nm4Dj/f+jJEwKVsUnKh73g ($28.15 in chips) 
nm4Dj/f+jJEwKVsUnKh73g: posts small blind $0.10
tYsOBqdU1+x+yFI7zHO7hQ: posts big blind $0.25
upsista: sits out 
*** HOLE CARDS ***
z5GxcHlYz/GSz6W2uFiTtg: folds 
S7Ki0P+0AIGPuIfGJjW0gg: raises $0.25 to $0.50
gxyie8xe6lDdpfG4quHtbw: folds 
Yv4fucyyT28mjx8V5lxKJg: folds 
+8FtfKCFr23+6O39P+U45Q: folds 
jeKWRUkMaVn8rEUjnJKqpg: folds 
nm4Dj/f+jJEwKVsUnKh73g: folds 
tYsOBqdU1+x+yFI7zHO7hQ: folds 
Uncalled bet ($0.25) returned to S7Ki0P+0AIGPuIfGJjW0gg
S7Ki0P+0AIGPuIfGJjW0gg collected $0.60 from pot
S7Ki0P+0AIGPuIfGJjW0gg: doesn't show hand 
*** SUMMARY ***
Total pot $0.60 | Rake $0 
Seat 1: tYsOBqdU1+x+yFI7zHO7hQ (big blind) folded before Flop
Seat 2: z5GxcHlYz/GSz6W2uFiTtg folded before Flop (didn't bet)
Seat 3: S7Ki0P+0AIGPuIfGJjW0gg collected ($0.60)
Seat 5: gxyie8xe6lDdpfG4quHtbw folded before Flop (didn't bet)
Seat 6: Yv4fucyyT28mjx8V5lxKJg folded before Flop (didn't bet)
Seat 7: +8FtfKCFr23+6O39P+U45Q folded before Flop (didn't bet)
Seat 8: jeKWRUkMaVn8rEUjnJKqpg (button) folded before Flop (didn't bet)
Seat 9: nm4Dj/f+jJEwKVsUnKh73g (small blind) folded before Flop




PokerStars Game #59939511166:  Hold'em No Limit ($0.10/$0.25) - 2009/07/01 0:41:46 ET
Table 'nteM56rtr9SxLEblf0fvbw' 9-max Seat #9 is the button
Seat 1: H9KUl8cmpLgEpOVDA00bCg ($4.75 in chips) 
Seat 2: ljemhp25Zg+nlA9DLCIiUw ($25.95 in chips) 
Seat 4: cZ99hugmLBj9KhTlc8nCSw ($25.50 in chips) 
Seat 5: aJy680tKSaP5er559aSuGA ($10.30 in chips) 
Seat 6: LH8Esb23EO9V9GrKx+ymWQ ($4.75 in chips) 
Seat 7: dfNim92Z6XK1/h5SFW5vDg ($49.30 in chips) 
Seat 8: RJ/x9oZtt1RZLaJEQwZOxQ ($44.40 in chips) 
Seat 9: t2nb95S5EEFOEzNx9Itz0g ($6.55 in chips) 
H9KUl8cmpLgEpOVDA00bCg: posts small blind $0.10
ljemhp25Zg+nlA9DLCIiUw: posts big blind $0.25
*** HOLE CARDS ***
cZ99hugmLBj9KhTlc8nCSw: folds 
aJy680tKSaP5er559aSuGA: folds 
LH8Esb23EO9V9GrKx+ymWQ: folds 
dfNim92Z6XK1/h5SFW5vDg: folds 
RJ/x9oZtt1RZLaJEQwZOxQ: folds 
t2nb95S5EEFOEzNx9Itz0g: folds 
H9KUl8cmpLgEpOVDA00bCg: raises $0.75 to $1
ljemhp25Zg+nlA9DLCIiUw: folds 
Uncalled bet ($0.75) returned to H9KUl8cmpLgEpOVDA00bCg
H9KUl8cmpLgEpOVDA00bCg collected $0.50 from pot
*** SUMMARY ***
Total pot $0.50 | Rake $0 
Seat 1: H9KUl8cmpLgEpOVDA00bCg (small blind) collected ($0.50)
Seat 2: ljemhp25Zg+nlA9DLCIiUw (big blind) folded before Flop
Seat 4: cZ99hugmLBj9KhTlc8nCSw folded before Flop (didn't bet)
Seat 5: aJy680tKSaP5er559aSuGA folded before Flop (didn't bet)
Seat 6: LH8Esb23EO9V9GrKx+ymWQ folded before Flop (didn't bet)
Seat 7: dfNim92Z6XK1/h5SFW5vDg folded before Flop (didn't bet)
Seat 8: RJ/x9oZtt1RZLaJEQwZOxQ folded before Flop (didn't bet)
Seat 9: t2nb95S5EEFOEzNx9Itz0g (button) folded before Flop (didn't bet)




PokerStars Game #59939511278:  Hold'em No Limit ($0.10/$0.25) - 2009/07/01 0:41:46 ET
Table 'v+LTGPWbrLum+Ggd4ef6lg' 9-max Seat #8 is the button
Seat 4: gGaFLzGESKP3Tj9N/K7QNA ($18.25 in chips) 
Seat 7: YEdelvffSYRP4EDNfFp4dA ($15.70 in chips) 
Seat 8: +sbyWwIcFp9kP0bDtMegfQ ($34.85 in chips) 
Seat 9: cFmpjvcjNoVAEAIQIxWkYg ($25 in chips) 
cFmpjvcjNoVAEAIQIxWkYg: posts small blind $0.10
gGaFLzGESKP3Tj9N/K7QNA: posts big blind $0.25
*** HOLE CARDS ***
YEdelvffSYRP4EDNfFp4dA: calls $0.25
+sbyWwIcFp9kP0bDtMegfQ: folds 
cFmpjvcjNoVAEAIQIxWkYg: folds 
gGaFLzGESKP3Tj9N/K7QNA: checks 
*** FLOP *** [Kc Ah Tc]
gGaFLzGESKP3Tj9N/K7QNA: checks 
YEdelvffSYRP4EDNfFp4dA: checks 
*** TURN *** [Kc Ah Tc] [9c]
gGaFLzGESKP3Tj9N/K7QNA: bets $0.25
YEdelvffSYRP4EDNfFp4dA: calls $0.25
*** RIVER *** [Kc Ah Tc 9c] [4d]
gGaFLzGESKP3Tj9N/K7QNA: bets $0.25
YEdelvffSYRP4EDNfFp4dA: folds 
Uncalled bet ($0.25) returned to gGaFLzGESKP3Tj9N/K7QNA
gGaFLzGESKP3Tj9N/K7QNA collected $1.05 from pot
gGaFLzGESKP3Tj9N/K7QNA leaves the table
*** SUMMARY ***
Total pot $1.10 | Rake $0.05 
Board [Kc Ah Tc 9c 4d]
Seat 4: gGaFLzGESKP3Tj9N/K7QNA (big blind) collected ($1.05)
Seat 7: YEdelvffSYRP4EDNfFp4dA folded on the River
Seat 8: +sbyWwIcFp9kP0bDtMegfQ (button) folded before Flop (didn't bet)
Seat 9: cFmpjvcjNoVAEAIQIxWkYg (small blind) folded before Flop




PokerStars Game #59939511646:  Hold'em No Limit ($0.10/$0.25) - 2009/07/01 0:41:47 ET
Table 'KAnP7XvDtlku47YfJwdOVw' 9-max Seat #1 is the button
Seat 1: sJNHTWcSlLHRCZ9+YRLLqA ($25 in chips) 
Seat 2: CYkY0dNBaYaKs8HVCVn3mQ ($4.75 in chips) 
Seat 3: 7qgCOBwxmRRmkppeMkqy0Q ($7.40 in chips) 
Seat 5: MG90wfSJZnOejs/KD3vlQQ ($31.20 in chips) 
Seat 6: z5GxcHlYz/GSz6W2uFiTtg ($25.95 in chips) 
Seat 7: Lro4e37x4FUa5P3yzDjskw ($9.90 in chips) 
Seat 8: 3fPCxL5JUJVUL3eETYhxQQ ($8.90 in chips) 
Seat 9: qwr38jl5txoR36M7G5qi4A ($18.20 in chips) 
CYkY0dNBaYaKs8HVCVn3mQ: posts small blind $0.10
7qgCOBwxmRRmkppeMkqy0Q: posts big blind $0.25
IrishMike123: sits out 
*** HOLE CARDS ***
MG90wfSJZnOejs/KD3vlQQ: folds 
z5GxcHlYz/GSz6W2uFiTtg: calls $0.25
Lro4e37x4FUa5P3yzDjskw: folds 
3fPCxL5JUJVUL3eETYhxQQ: calls $0.25
qwr38jl5txoR36M7G5qi4A: folds 
sJNHTWcSlLHRCZ9+YRLLqA: folds 
CYkY0dNBaYaKs8HVCVn3mQ: folds 
7qgCOBwxmRRmkppeMkqy0Q: raises $0.25 to $0.50
z5GxcHlYz/GSz6W2uFiTtg: calls $0.25
3fPCxL5JUJVUL3eETYhxQQ: raises $8.40 to $8.90 and is all-in
7qgCOBwxmRRmkppeMkqy0Q: folds 
z5GxcHlYz/GSz6W2uFiTtg: folds 
Uncalled bet ($8.40) returned to 3fPCxL5JUJVUL3eETYhxQQ
3fPCxL5JUJVUL3eETYhxQQ collected $1.60 from pot
*** SUMMARY ***
Total pot $1.60 | Rake $0 
Seat 1: sJNHTWcSlLHRCZ9+YRLLqA (button) folded before Flop (didn't bet)
Seat 2: CYkY0dNBaYaKs8HVCVn3mQ (small blind) folded before Flop
Seat 3: 7qgCOBwxmRRmkppeMkqy0Q (big blind) folded before Flop
Seat 5: MG90wfSJZnOejs/KD3vlQQ folded before Flop (didn't bet)
Seat 6: z5GxcHlYz/GSz6W2uFiTtg folded before Flop
Seat 7: Lro4e37x4FUa5P3yzDjskw folded before Flop (didn't bet)
Seat 8: 3fPCxL5JUJVUL3eETYhxQQ collected ($1.60)
Seat 9: qwr38jl5txoR36M7G5qi4A folded before Flop (didn't bet)




PokerStars Game #59939511878:  Hold'em No Limit ($0.10/$0.25) - 2009/07/01 0:41:47 ET
Table 'SkaFM7xfUr/Nd+JFPb7f2w' 9-max Seat #5 is the button
Seat 2: QEbIGci+itdw+re8RM5fZA ($28.30 in chips) 
Seat 3: 4oA316mXLIui1QY63GXBUg ($25 in chips) 
Seat 4: DIBbjEYGs+TVdVgEB/4+3w ($39.20 in chips) 
Seat 5: GftT+l+xjKzcY0rMiNZfPg ($11.30 in chips) 
Seat 6: PskTLlFIRHSp61inskRzVg ($7.35 in chips) 
Seat 7: 7wo6Sr7QG3Zo6BaBDV1BOw ($5 in chips) 
Seat 8: Lro4e37x4FUa5P3yzDjskw ($9.85 in chips) 
Seat 9: STkR8XvpjNv79OOMhrlh2w ($59.45 in chips) 
PskTLlFIRHSp61inskRzVg: posts small blind $0.10
7wo6Sr7QG3Zo6BaBDV1BOw: posts big blind $0.25
CvL9Ch1HYCVbTsfpNucitg: sits out 
*** HOLE CARDS ***
Lro4e37x4FUa5P3yzDjskw: folds 
STkR8XvpjNv79OOMhrlh2w: folds 
QEbIGci+itdw+re8RM5fZA: folds 
4oA316mXLIui1QY63GXBUg: folds 
DIBbjEYGs+TVdVgEB/4+3w: folds 
GftT+l+xjKzcY0rMiNZfPg: calls $0.25
PskTLlFIRHSp61inskRzVg: calls $0.15
7wo6Sr7QG3Zo6BaBDV1BOw: checks 
*** FLOP *** [3c Jd Ah]
PskTLlFIRHSp61inskRzVg: bets $1.25
7wo6Sr7QG3Zo6BaBDV1BOw: folds 
GftT+l+xjKzcY0rMiNZfPg: folds 
Uncalled bet ($1.25) returned to PskTLlFIRHSp61inskRzVg
PskTLlFIRHSp61inskRzVg collected $0.75 from pot
PskTLlFIRHSp61inskRzVg: doesn't show hand 
*** SUMMARY ***
Total pot $0.75 | Rake $0 
Board [3c Jd Ah]
Seat 2: QEbIGci+itdw+re8RM5fZA folded before Flop (didn't bet)
Seat 3: 4oA316mXLIui1QY63GXBUg folded before Flop (didn't bet)
Seat 4: DIBbjEYGs+TVdVgEB/4+3w folded before Flop (didn't bet)
Seat 5: GftT+l+xjKzcY0rMiNZfPg (button) folded on the Flop
Seat 6: PskTLlFIRHSp61inskRzVg (small blind) collected ($0.75)
Seat 7: 7wo6Sr7QG3Zo6BaBDV1BOw (big blind) folded on the Flop
Seat 8: Lro4e37x4FUa5P3yzDjskw folded before Flop (didn't bet)
Seat 9: STkR8XvpjNv79OOMhrlh2w folded before Flop (didn't bet)




PokerStars Game #59939512010:  Hold'em No Limit ($0.10/$0.25) - 2009/07/01 0:41:47 ET
Table '3lS+sU5k6mwJCS2nFMmQ6Q' 9-max Seat #5 is the button
Seat 1: VWUWpMLMj/Q1jRVpF7Aohw ($13 in chips) 
Seat 2: 4oA316mXLIui1QY63GXBUg ($25.75 in chips) 
Seat 3: 1DXccE2UUK5DIRVGlOKnTA ($9.50 in chips) 
Seat 4: 8B/dhbQjIWe6ASCdgzktNQ ($44.90 in chips) 
Seat 5: LuckyShot



PokerStars Game #59939511724:  Hold'em No Limit ($0.10/$0.25) - 2009/07/01 0:41:47 ET
Table 'by7aHYEDnDd144EXOXa/jA' 9-max Seat #5 is the button
Seat 1: zU1DfKpyUFgAuyEO9JqLHg ($8.85 in chips) 
Seat 2: vSkQm2EelzwRGDDQQk0Fqw ($4.90 in chips) 
Seat 3: 1Clf3cPrqoy/YgvWdWK1Xw ($5.55 in chips) 
Seat 4: vZGoOTJLQLhkPj4I+LNGig ($47.40 in chips) 
Seat 5: yyG4svzOpC1A+sUP/scg6w ($6.65 in chips) 
Seat 6: DIBbjEYGs+TVdVgEB/4+3w ($23 in chips) 
Seat 8: s7Q6uNouhe7aE8JdFb9E+A ($25.60 in chips) 
DIBbjEYGs+TVdVgEB/4+3w: posts small blind $0.10
s7Q6uNouhe7aE8JdFb9E+A: posts big blind $0.25
*** HOLE CARDS ***
zU1DfKpyUFgAuyEO9JqLHg: folds 
vSkQm2EelzwRGDDQQk0Fqw: folds 
1Clf3cPrqoy/YgvWdWK1Xw: folds 
V6p0jQ/RhUsqpHLmXvEX4Q joins the table at seat #7 
vZGoOTJLQLhkPj4I+LNGig: folds 
yyG4svzOpC1A+sUP/scg6w: calls $0.25
K0b5wNInj6hUGRr6yzKFtw has returned
DIBbjEYGs+TVdVgEB/4+3w: calls $0.15
s7Q6uNouhe7aE8JdFb9E+A: checks 
*** FLOP *** [8d 7d 5s]
DIBbjEYGs+TVdVgEB/4+3w: checks 
s7Q6uNouhe7aE8JdFb9E+A: checks 
yyG4svzOpC1A+sUP/scg6w: checks 
*** TURN *** [8d 7d 5s] [Qs]
DIBbjEYGs+TVdVgEB/4+3w: checks 
s7Q6uNouhe7aE8JdFb9E+A: checks 
yyG4svzOpC1A+sUP/scg6w: bets $0.75
DIBbjEYGs+TVdVgEB/4+3w: folds 
s7Q6uNouhe7aE8JdFb9E+A: folds 
Uncalled bet ($0.75) returned to yyG4svzOpC1A+sUP/scg6w
yyG4svzOpC1A+sUP/scg6w collected $0.75 from pot
yyG4svzOpC1A+sUP/scg6w: doesn't show hand 
*** SUMMARY ***
Total pot $0.75 | Rake $0 
Board [8d 7d 5s Qs]
Seat 1: zU1DfKpyUFgAuyEO9JqLHg folded before Flop (didn't bet)
Seat 2: vSkQm2EelzwRGDDQQk0Fqw folded before Flop (didn't bet)
Seat 3: 1Clf3cPrqoy/YgvWdWK1Xw folded before Flop (didn't bet)
Seat 4: vZGoOTJLQLhkPj4I+LNGig folded before Flop (didn't bet)
Seat 5: yyG4svzOpC1A+sUP/scg6w (button) collected ($0.75)
Seat 6: DIBbjEYGs+TVdVgEB/4+3w (small blind) folded on the Turn
Seat 8: s7Q6uNouhe7aE8JdFb9E+A (big blind) folded on the Turn




PokerStars Game #59939511948:  Hold'em No Limit ($0.10/$0.25) - 2009/07/01 0:41:47 ET
Table 'tq5CvS0RUqGkuBK0XTzqqg' 6-max Seat #2 is the button
Seat 1: 39EF5EcifdyPS7v+EnfxLg ($22.80 in chips) 
Seat 2: mfrkWA3PTeYPkbO6hi98Aw ($68.60 in chips) 
Seat 3: PbMzPZIePKifKQZfKDkbIw ($25 in chips) 
Seat 4: W7FS+h5B+OhmwF+cTt3ZPQ ($14.65 in chips) 
Seat 5: qGHGf/553gQnDoklMRe3tg ($25 in chips) 
Seat 6: hOfhw8jxWiq14wXGL4Bh/Q ($14.65 in chips) 
PbMzPZIePKifKQZfKDkbIw: posts small blind $0.10
W7FS+h5B+OhmwF+cTt3ZPQ: posts big blind $0.25
*** HOLE CARDS ***
qGHGf/553gQnDoklMRe3tg: folds 
hOfhw8jxWiq14wXGL4Bh/Q: folds 
39EF5EcifdyPS7v+EnfxLg: calls $0.25
mfrkWA3PTeYPkbO6hi98Aw: folds 
PbMzPZIePKifKQZfKDkbIw: raises $0.75 to $1
W7FS+h5B+OhmwF+cTt3ZPQ: folds 
39EF5EcifdyPS7v+EnfxLg: folds 
Uncalled bet ($0.75) returned to PbMzPZIePKifKQZfKDkbIw
PbMzPZIePKifKQZfKDkbIw collected $0.75 from pot
*** SUMMARY ***
Total pot $0.75 | Rake $0 
Seat 1: 39EF5EcifdyPS7v+EnfxLg folded before Flop
Seat 2: mfrkWA3PTeYPkbO6hi98Aw (button) folded before Flop (didn't bet)
Seat 3: PbMzPZIePKifKQZfKDkbIw (small blind) collected ($0.75)
Seat 4: W7FS+h5B+OhmwF+cTt3ZPQ (big blind) folded before Flop
Seat 5: qGHGf/553gQnDoklMRe3tg folded before Flop (didn't bet)
Seat 6: hOfhw8jxWiq14wXGL4Bh/Q folded before Flop (didn't bet)




PokerStars Game #59939512778:  Hold'em No Limit ($0.10/$0.25) - 2009/07/01 0:41:48 ET
Table 'IUwZ/e0bDHZPgsIWx0RnNg' 6-max Seat #5 is the button
Seat 1: 8JTm/CXBn3+kuQgcUOgPkw ($24.75 in chips) 
Seat 2: mvFHK3pE7tCxJEqLjKC70Q ($25.35 in chips) 
Seat 3: dOX4wnYV2sEqvDbF+8KSCw ($30.50 in chips) 
Seat 4: IyZ9SVxKy7TJvRGFneWTMg ($29.50 in chips) 
Seat 5: wsP46AGpqDjHZQmlRHKa9g ($25.50 in chips) 
Seat 6: NhUN/JpAprdJeamFBgJH1w ($25 in chips) 
NhUN/JpAprdJeamFBgJH1w: posts small blind $0.10
8JTm/CXBn3+kuQgcUOgPkw: posts big blind $0.25
*** HOLE CARDS ***
mvFHK3pE7tCxJEqLjKC70Q: folds 
dOX4wnYV2sEqvDbF+8KSCw: folds 
IyZ9SVxKy7TJvRGFneWTMg: calls $0.25
wsP46AGpqDjHZQmlRHKa9g: folds 
NhUN/JpAprdJeamFBgJH1w: calls $0.15
8JTm/CXBn3+kuQgcUOgPkw: checks 
*** FLOP *** [Jd 8h 4d]
NhUN/JpAprdJeamFBgJH1w: checks 
8JTm/CXBn3+kuQgcUOgPkw: checks 
IyZ9SVxKy7TJvRGFneWTMg: checks 
*** TURN *** [Jd 8h 4d] [8c]
NhUN/JpAprdJeamFBgJH1w: checks 
8JTm/CXBn3+kuQgcUOgPkw: checks 
IyZ9SVxKy7TJvRGFneWTMg: bets $1
NhUN/JpAprdJeamFBgJH1w: folds 
8JTm/CXBn3+kuQgcUOgPkw: folds 
Uncalled bet ($1) returned to IyZ9SVxKy7TJvRGFneWTMg
IyZ9SVxKy7TJvRGFneWTMg collected $0.75 from pot
IyZ9SVxKy7TJvRGFneWTMg: doesn't show hand 
*** SUMMARY ***
Total pot $0.75 | Rake $0 
Board [Jd 8h 4d 8c]
Seat 1: 8JTm/CXBn3+kuQgcUOgPkw (big blind) folded on the Turn
Seat 2: mvFHK3pE7tCxJEqLjKC70Q folded before Flop (didn't bet)
Seat 3: dOX4wnYV2sEqvDbF+8KSCw folded before Flop (didn't bet)
Seat 4: IyZ9SVxKy7TJvRGFneWTMg collected ($0.75)
Seat 5: wsP46AGpqDjHZQmlRHKa9g (button) folded before Flop (didn't bet)
Seat 6: NhUN/JpAprdJeamFBgJH1w (small blind) folded on the Turn




PokerStars Game #59939512630:  Hold'em No Limit ($0.10/$0.25) - 2009/07/01 0:41:48 ET
Table '+fuYjvJy9okLr23QyZtanA' 9-max Seat #1 is the button
Seat 1: s7Q6uNouhe7aE8JdFb9E+A ($29.85 in chips) 
Seat 4: H/l9NZvuOXwQIPOaVdj0rQ ($10.20 in chips) 
Seat 5: h48vKHbhkYz+3RYZCQ0tgA ($15 in chips) 
H/l9NZvuOXwQIPOaVdj0rQ: posts small blind $0.10
h48vKHbhkYz+3RYZCQ0tgA: posts big blind $0.25
*** HOLE CARDS ***
s7Q6uNouhe7aE8JdFb9E+A: folds 
H/l9NZvuOXwQIPOaVdj0rQ: calls $0.15
h48vKHbhkYz+3RYZCQ0tgA: checks 
*** FLOP *** [Ah 7d Kh]
H/l9NZvuOXwQIPOaVdj0rQ: checks 
h48vKHbhkYz+3RYZCQ0tgA: bets $0.25
H/l9NZvuOXwQIPOaVdj0rQ: folds 
Uncalled bet ($0.25) returned to h48vKHbhkYz+3RYZCQ0tgA
h48vKHbhkYz+3RYZCQ0tgA collected $0.50 from pot
*** SUMMARY ***
Total pot $0.50 | Rake $0 
Board [Ah 7d Kh]
Seat 1: s7Q6uNouhe7aE8JdFb9E+A (button) folded before Flop (didn't bet)
Seat 4: H/l9NZvuOXwQIPOaVdj0rQ (small blind) folded on the Flop
Seat 5: h48vKHbhkYz+3RYZCQ0tgA (big blind) collected ($0.50)




PokerStars Game #59939512224:  Hold'em No Limit ($0.10/$0.25) - 2009/07/01 0:41:48 ET
Table 'jItkp2PNTbH9Cf7gqsAF7g' 9-max Seat #2 is the button
Seat 1: OiV1PWZ3IkN29JlmCcnTwQ ($4.50 in chips) 
Seat 2: qwr38jl5txoR36M7G5qi4A ($7.50 in chips) 
Seat 3: E0iYnEVO2ho7dH3QcCjw7g ($24.45 in chips) 
Seat 4: GQTWTgG7Ydy9q/vohVnKmQ ($31.20 in chips) 
Seat 5: uH1RN27w9SKa7TpVR9EFrQ ($17.55 in chips) 
Seat 6: cZ99hugmLBj9KhTlc8nCSw ($58.60 in chips) 
Seat 7: st9jtdNbm1W5GfBwRaCVqQ ($21.85 in chips) 
Seat 8: t82lXIS9gxYmNHmDgWRFAQ ($11.35 in chips) 
Seat 9: H9KUl8cmpLgEpOVDA00bCg ($6.60 in chips) 
E0iYnEVO2ho7dH3QcCjw7g: posts small blind $0.10
GQTWTgG7Ydy9q/vohVnKmQ: posts big blind $0.25
*** HOLE CARDS ***
uH1RN27w9SKa7TpVR9EFrQ: folds 
cZ99hugmLBj9KhTlc8nCSw: folds 
st9jtdNbm1W5GfBwRaCVqQ: folds 
t82lXIS9gxYmNHmDgWRFAQ: folds 
H9KUl8cmpLgEpOVDA00bCg: folds 
OiV1PWZ3IkN29JlmCcnTwQ: raises $0.75 to $1
qwr38jl5txoR36M7G5qi4A: calls $1
E0iYnEVO2ho7dH3QcCjw7g: folds 
GQTWTgG7Ydy9q/vohVnKmQ: folds 
*** FLOP *** [4s 6s Qs]
OiV1PWZ3IkN29JlmCcnTwQ: bets $1.50
qwr38jl5txoR36M7G5qi4A: folds 
Uncalled bet ($1.50) returned to OiV1PWZ3IkN29JlmCcnTwQ
OiV1PWZ3IkN29JlmCcnTwQ collected $2.25 from pot
OiV1PWZ3IkN29JlmCcnTwQ: doesn't show hand 
*** SUMMARY ***
Total pot $2.35 | Rake $0.10 
Board [4s 6s Qs]
Seat 1: OiV1PWZ3IkN29JlmCcnTwQ collected ($2.25)
Seat 2: qwr38jl5txoR36M7G5qi4A (button) folded on the Flop
Seat 3: E0iYnEVO2ho7dH3QcCjw7g (small blind) folded before Flop
Seat 4: GQTWTgG7Ydy9q/vohVnKmQ (big blind) folded before Flop
Seat 5: uH1RN27w9SKa7TpVR9EFrQ folded before Flop (didn't bet)
Seat 6: cZ99hugmLBj9KhTlc8nCSw folded before Flop (didn't bet)
Seat 7: st9jtdNbm1W5GfBwRaCVqQ folded before Flop (didn't bet)
Seat 8: t82lXIS9gxYmNHmDgWRFAQ folded before Flop (didn't bet)
Seat 9: H9KUl8cmpLgEpOVDA00bCg folded before Flop (didn't bet)




PokerStars Game #59939512484:  Hold'em No Limit ($0.10/$0.25) - 2009/07/01 0:41:48 ET
Table 'S6s+TmTlAjLHclBRvN5/fw' 9-max Seat #3 is the button
Seat 1: /XMgGtJ7mcWfe5s7McY9kw ($24.60 in chips) 
Seat 2: GGVjFwYkbwsuyKljxyML4g ($11.65 in chips) 
Seat 3: imHPFFqvfHGzsBBWeGuy4w ($20.95 in chips) 
Seat 4: M/9j4wkHH9i1JM51vgi1VA ($38.70 in chips) 
Seat 5: z5GxcHlYz/GSz6W2uFiTtg ($25.05 in chips) 
Seat 6: aNpwfA31EREwO+ar4XzBCw ($25.20 in chips) 
Seat 7: vSkQm2EelzwRGDDQQk0Fqw ($6 in chips) 
Seat 8: 42xLFHn85WRGGaaUZTNvwA ($10 in chips) 
Seat 9: BODayQmPi2rEfae9e6hIlw ($28.80 in chips) 
M/9j4wkHH9i1JM51vgi1VA: posts small blind $0.10
z5GxcHlYz/GSz6W2uFiTtg: posts big blind $0.25
42xLFHn85WRGGaaUZTNvwA: posts big blind $0.25
*** HOLE CARDS ***
aNpwfA31EREwO+ar4XzBCw: folds 
vSkQm2EelzwRGDDQQk0Fqw: folds 
42xLFHn85WRGGaaUZTNvwA: checks 
BODayQmPi2rEfae9e6hIlw: raises $0.75 to $1
/XMgGtJ7mcWfe5s7McY9kw: folds 
GGVjFwYkbwsuyKljxyML4g: calls $1
imHPFFqvfHGzsBBWeGuy4w: folds 
M/9j4wkHH9i1JM51vgi1VA: folds 
z5GxcHlYz/GSz6W2uFiTtg: folds 
42xLFHn85WRGGaaUZTNvwA: folds 
*** FLOP *** [7d 8d 9c]
BODayQmPi2rEfae9e6hIlw: bets $2.50
GGVjFwYkbwsuyKljxyML4g: raises $8.15 to $10.65 and is all-in
BODayQmPi2rEfae9e6hIlw: calls $8.15
*** TURN *** [7d 8d 9c] [3h]
*** RIVER *** [7d 8d 9c 3h] [Qd]
*** SHOW DOWN ***
BODayQmPi2rEfae9e6hIlw: shows [9d 9s] (three of a kind, Nines)
GGVjFwYkbwsuyKljxyML4g: shows [Ad 2d] (a flush, Ace high)
GGVjFwYkbwsuyKljxyML4g collected $22.75 from pot
*** SUMMARY ***
Total pot $23.90 | Rake $1.15 
Board [7d 8d 9c 3h Qd]
Seat 1: /XMgGtJ7mcWfe5s7McY9kw folded before Flop (didn't bet)
Seat 2: GGVjFwYkbwsuyKljxyML4g showed [Ad 2d] and won ($22.75) with a flush, Ace high
Seat 3: imHPFFqvfHGzsBBWeGuy4w (button) folded before Flop (didn't bet)
Seat 4: M/9j4wkHH9i1JM51vgi1VA (small blind) folded before Flop
Seat 5: z5GxcHlYz/GSz6W2uFiTtg (big blind) folded before Flop
Seat 6: aNpwfA31EREwO+ar4XzBCw folded before Flop (didn't bet)
Seat 7: vSkQm2EelzwRGDDQQk0Fqw folded before Flop (didn't bet)
Seat 8: 42xLFHn85WRGGaaUZTNvwA folded before Flop
Seat 9: BODayQmPi2rEfae9e6hIlw showed [9d 9s] and lost with three of a kind, Nines




PokerStars Game #59939512722:  Hold'em No Limit ($0.10/$0.25) - 2009/07/01 0:41:48 ET
Table '7eunnLa5p3aGsPrUrNnn/A' 9-max Seat #7 is the button
Seat 1: Ml2bY77EHbM51ZWD7dnIWg ($34 in chips) 
Seat 2: aJy680tKSaP5er559aSuGA ($12.25 in chips) 
Seat 3: E0iYnEVO2ho7dH3QcCjw7g ($20.80 in chips) 
Seat 4: opOCI2p6kW0tINuVaAqmcQ ($30.70 in chips) 
Seat 5: JLfmdpDbz2ljMNE7ICboMQ ($5.60 in chips) 
Seat 6: jx9kXw1SAZrvXp9Nerz8+Q ($14.70 in chips) 
Seat 7: sD+TKtt36XiiN6jqHiLwDA ($24.40 in chips) 
Seat 8: 1Clf3cPrqoy/YgvWdWK1Xw ($5 in chips) 
Seat 9: rUpvA02nErFvZ4yFbDR8XA ($20.55 in chips) 
1Clf3cPrqoy/YgvWdWK1Xw: posts small blind $0.10
rUpvA02nErFvZ4yFbDR8XA: posts big blind $0.25
*** HOLE CARDS ***
Ml2bY77EHbM51ZWD7dnIWg: calls $0.25
aJy680tKSaP5er559aSuGA: folds 
E0iYnEVO2ho7dH3QcCjw7g: folds 
opOCI2p6kW0tINuVaAqmcQ: raises $0.50 to $0.75
JLfmdpDbz2ljMNE7ICboMQ: calls $0.75
jx9kXw1SAZrvXp9Nerz8+Q: folds 
sD+TKtt36XiiN6jqHiLwDA: folds 
1Clf3cPrqoy/YgvWdWK1Xw: folds 
rUpvA02nErFvZ4yFbDR8XA: folds 
Ml2bY77EHbM51ZWD7dnIWg: calls $0.50
*** FLOP *** [6s Jd 8d]
Ml2bY77EHbM51ZWD7dnIWg: checks 
opOCI2p6kW0tINuVaAqmcQ: checks 
JLfmdpDbz2ljMNE7ICboMQ: checks 
*** TURN *** [6s Jd 8d] [7h]
Ml2bY77EHbM51ZWD7dnIWg: checks 
opOCI2p6kW0tINuVaAqmcQ: checks 
JLfmdpDbz2ljMNE7ICboMQ: checks 
*** RIVER *** [6s Jd 8d 7h] [5h]
Ml2bY77EHbM51ZWD7dnIWg: bets $0.50
opOCI2p6kW0tINuVaAqmcQ: folds 
JLfmdpDbz2ljMNE7ICboMQ: calls $0.50
*** SHOW DOWN ***
Ml2bY77EHbM51ZWD7dnIWg: shows [3c 4c] (a straight, Four to Eight)
JLfmdpDbz2ljMNE7ICboMQ: shows [4h Ad] (a straight, Four to Eight)
Ml2bY77EHbM51ZWD7dnIWg collected $1.75 from pot
JLfmdpDbz2ljMNE7ICboMQ collected $1.70 from pot
*** SUMMARY ***
Total pot $3.60 | Rake $0.15 
Board [6s Jd 8d 7h 5h]
Seat 1: Ml2bY77EHbM51ZWD7dnIWg showed [3c 4c] and won ($1.75) with a straight, Four to Eight
Seat 2: aJy680tKSaP5er559aSuGA folded before Flop (didn't bet)
Seat 3: E0iYnEVO2ho7dH3QcCjw7g folded before Flop (didn't bet)
Seat 4: opOCI2p6kW0tINuVaAqmcQ folded on the River
Seat 5: JLfmdpDbz2ljMNE7ICboMQ showed [4h Ad] and won ($1.70) with a straight, Four to Eight
Seat 6: jx9kXw1SAZrvXp9Nerz8+Q folded before Flop (didn't bet)
Seat 7: sD+TKtt36XiiN6jqHiLwDA (button) folded before Flop (didn't bet)
Seat 8: 1Clf3cPrqoy/YgvWdWK1Xw (small blind) folded before Flop
Seat 9: rUpvA02nErFvZ4yFbDR8XA (big blind) folded before Flop




PokerStars Game #59939513146:  Hold'em No Limit ($0.10/$0.25) - 2009/07/01 0:41:49 ET
Table 'LG9H161ZAHDkOww+ih3Ptg' 6-max Seat #5 is the button
Seat 1: avl8CO/tc0F6eVSiB/KNRA ($24.50 in chips) 
Seat 2: 9jSiy0meE9XJKkdIZwyTEQ ($28.95 in chips) 
Seat 3: sT4sjqzVMH/fZHz0hkbIPw ($30.90 in chips) 
Seat 4: 0C28L4/59aRNtHoBhqTcLg ($40.75 in chips) 
Seat 5: oseFhpinoe+Zg4j5xyBjyQ ($43.55 in chips) 
ludidzeko will be allowed to play after the button
avl8CO/tc0F6eVSiB/KNRA: posts small blind $0.10
9jSiy0meE9XJKkdIZwyTEQ: posts big blind $0.25
*** HOLE CARDS ***
sT4sjqzVMH/fZHz0hkbIPw: folds 
0C28L4/59aRNtHoBhqTcLg: folds 
oseFhpinoe+Zg4j5xyBjyQ: folds 
avl8CO/tc0F6eVSiB/KNRA: calls $0.15
9jSiy0meE9XJKkdIZwyTEQ: checks 
*** FLOP *** [Kc 6c 5c]
avl8CO/tc0F6eVSiB/KNRA: checks 
9jSiy0meE9XJKkdIZwyTEQ: checks 
*** TURN *** [Kc 6c 5c] [6d]
avl8CO/tc0F6eVSiB/KNRA: bets $0.50
9jSiy0meE9XJKkdIZwyTEQ: folds 
Uncalled bet ($0.50) returned to avl8CO/tc0F6eVSiB/KNRA
avl8CO/tc0F6eVSiB/KNRA collected $0.50 from pot
avl8CO/tc0F6eVSiB/KNRA: doesn't show hand 
*** SUMMARY ***
Total pot $0.50 | Rake $0 
Board [Kc 6c 5c 6d]
Seat 1: avl8CO/tc0F6eVSiB/KNRA (small blind) collected ($0.50)
Seat 2: 9jSiy0meE9XJKkdIZwyTEQ (big blind) folded on the Turn
Seat 3: sT4sjqzVMH/fZHz0hkbIPw folded before Flop (didn't bet)
Seat 4: 0C28L4/59aRNtHoBhqTcLg folded before Flop (didn't bet)
Seat 5: oseFhpinoe+Zg4j5xyBjyQ (button) folded before Flop (didn't bet)




PokerStars Game #59939513730:  Hold'em No Limit ($0.10/$0.25) - 2009/07/01 0:41:50 ET
Table 'sgdCtiuCu2BDZhyDi6RzTA' 6-max Seat #3 is the button
Seat 1: 3zD3qLXT1bEffAoWGnc7wg ($25 in chips) 
Seat 3: yzFNNFIfC89bBPwpFPx2ow ($17.10 in chips) 
Seat 4: rVKEgilmMX+EkKzDVvhmxA ($7.90 in chips) 
Seat 5: kD/Cb2UM93FAVgDMhEEb5g ($9.25 in chips) 
Seat 6: KODslGU8ikCYS0/29dUkhg ($9.60 in chips) 
rVKEgilmMX+EkKzDVvhmxA: posts small blind $0.10
kD/Cb2UM93FAVgDMhEEb5g: posts big blind $0.25
*** HOLE CARDS ***
KODslGU8ikCYS0/29dUkhg: calls $0.25
3zD3qLXT1bEffAoWGnc7wg: folds 
yzFNNFIfC89bBPwpFPx2ow: folds 
rVKEgilmMX+EkKzDVvhmxA: calls $0.15
kD/Cb2UM93FAVgDMhEEb5g: checks 
*** FLOP *** [9c Qc Td]
rVKEgilmMX+EkKzDVvhmxA: checks 
kD/Cb2UM93FAVgDMhEEb5g: checks 
KODslGU8ikCYS0/29dUkhg: checks 
*** TURN *** [9c Qc Td] [Qd]
rVKEgilmMX+EkKzDVvhmxA: checks 
kD/Cb2UM93FAVgDMhEEb5g: checks 
KODslGU8ikCYS0/29dUkhg: bets $1.50
rVKEgilmMX+EkKzDVvhmxA: folds 
kD/Cb2UM93FAVgDMhEEb5g: folds 
Uncalled bet ($1.50) returned to KODslGU8ikCYS0/29dUkhg
KODslGU8ikCYS0/29dUkhg collected $0.75 from pot
KODslGU8ikCYS0/29dUkhg: doesn't show hand 
*** SUMMARY ***
Total pot $0.75 | Rake $0 
Board [9c Qc Td Qd]
Seat 1: 3zD3qLXT1bEffAoWGnc7wg folded before Flop (didn't bet)
Seat 3: yzFNNFIfC89bBPwpFPx2ow (button) folded before Flop (didn't bet)
Seat 4: rVKEgilmMX+EkKzDVvhmxA (small blind) folded on the Turn
Seat 5: kD/Cb2UM93FAVgDMhEEb5g (big blind) folded on the Turn
Seat 6: KODslGU8ikCYS0/29dUkhg collected ($0.75)




PokerStars Game #59939513742:  Hold'em No Limit ($0.10/$0.25) - 2009/07/01 0:41:50 ET
Table 'g+mPuNJBCHKE9ents7ZGtg' 6-max Seat #3 is the button
Seat 1: rlqzz6sTpiZGIiNuqy7QUA ($39.90 in chips) 
Seat 2: fZQg9veL7Dd/Z04ZTjC+wQ ($30 in chips) 
Seat 3: 9jSiy0meE9XJKkdIZwyTEQ ($25 in chips) 
Seat 4: mfrkWA3PTeYPkbO6hi98Aw ($26.75 in chips) 
Seat 5: 32YL2ZEp8NT4JB2RVM9euQ ($16 in chips) 
Seat 6: MS2T205Bjud7PnNoANu4vQ ($46.20 in chips) 
mfrkWA3PTeYPkbO6hi98Aw: posts small blind $0.10
32YL2ZEp8NT4JB2RVM9euQ: posts big blind $0.25
*** HOLE CARDS ***
MS2T205Bjud7PnNoANu4vQ: calls $0.25
rlqzz6sTpiZGIiNuqy7QUA: calls $0.25
fZQg9veL7Dd/Z04ZTjC+wQ: calls $0.25
9jSiy0meE9XJKkdIZwyTEQ: raises $1.50 to $1.75
mfrkWA3PTeYPkbO6hi98Aw: folds 
32YL2ZEp8NT4JB2RVM9euQ: folds 
MS2T205Bjud7PnNoANu4vQ: folds 
rlqzz6sTpiZGIiNuqy7QUA: calls $1.50
fZQg9veL7Dd/Z04ZTjC+wQ: folds 
*** FLOP *** [8h Kc Kh]
rlqzz6sTpiZGIiNuqy7QUA: bets $2.50
9jSiy0meE9XJKkdIZwyTEQ: calls $2.50
*** TURN *** [8h Kc Kh] [Qd]
rlqzz6sTpiZGIiNuqy7QUA: checks 
9jSiy0meE9XJKkdIZwyTEQ: checks 
*** RIVER *** [8h Kc Kh Qd] [2s]
rlqzz6sTpiZGIiNuqy7QUA: bets $4.75
9jSiy0meE9XJKkdIZwyTEQ: calls $4.75
*** SHOW DOWN ***
rlqzz6sTpiZGIiNuqy7QUA: shows [Ac 4d] (a pair of Kings)
9jSiy0meE9XJKkdIZwyTEQ: shows [Ks Tc] (three of a kind, Kings)
9jSiy0meE9XJKkdIZwyTEQ collected $17.95 from pot
*** SUMMARY ***
Total pot $18.85 | Rake $0.90 
Board [8h Kc Kh Qd 2s]
Seat 1: rlqzz6sTpiZGIiNuqy7QUA showed [Ac 4d] and lost with a pair of Kings
Seat 2: fZQg9veL7Dd/Z04ZTjC+wQ folded before Flop
Seat 3: 9jSiy0meE9XJKkdIZwyTEQ (button) showed [Ks Tc] and won ($17.95) with three of a kind, Kings
Seat 4: mfrkWA3PTeYPkbO6hi98Aw (small blind) folded before Flop
Seat 5: 32YL2ZEp8NT4JB2RVM9euQ (big blind) folded before Flop
Seat 6: MS2T205Bjud7PnNoANu4vQ folded before Flop




PokerStars Game #59939513862:  Hold'em No Limit ($0.10/$0.25) - 2009/07/01 0:41:50 ET
Table 'KYX9dFNuOA9l2PV46IebqQ' 9-max Seat #1 is the button
Seat 1: s7Q6uNouhe7aE8JdFb9E+A ($27.05 in chips) 
Seat 2: r6hsffOo1iKmaPYKwAZmFw ($27.40 in chips) 
Seat 3: f+H1PHwj9cNu4Y6FfvKwQQ ($15.60 in chips) 
Seat 4: SkLOm0UugROBRt2EfMpOxQ ($38.30 in chips) 
Seat 5: HQMjiff9S04k8kyC4fHVgw ($2.55 in chips) 
Seat 6: DiSvPC2iudwL5j9u6Huyww ($25.35 in chips) 
Seat 7: kmJc9NmBNbE55/AnUDL6/w ($3.85 in chips) 
Seat 8: 4oA316mXLIui1QY63GXBUg ($25 in chips) 
Seat 9: W4TLQcZ2TiM73eIgpIvlGg ($30.70 in chips) 
r6hsffOo1iKmaPYKwAZmFw: posts small blind $0.10
f+H1PHwj9cNu4Y6FfvKwQQ: posts big blind $0.25
*** HOLE CARDS ***
SkLOm0UugROBRt2EfMpOxQ: folds 
HQMjiff9S04k8kyC4fHVgw: calls $0.25
DiSvPC2iudwL5j9u6Huyww: folds 
kmJc9NmBNbE55/AnUDL6/w: calls $0.25
4oA316mXLIui1QY63GXBUg: folds 
W4TLQcZ2TiM73eIgpIvlGg: calls $0.25
s7Q6uNouhe7aE8JdFb9E+A: folds 
r6hsffOo1iKmaPYKwAZmFw: calls $0.15
f+H1PHwj9cNu4Y6FfvKwQQ: checks 
*** FLOP *** [Jc 8h 9h]
r6hsffOo1iKmaPYKwAZmFw: checks 
f+H1PHwj9cNu4Y6FfvKwQQ: checks 
HQMjiff9S04k8kyC4fHVgw: checks 
kmJc9NmBNbE55/AnUDL6/w: bets $0.75
W4TLQcZ2TiM73eIgpIvlGg: raises $1.50 to $2.25
r6hsffOo1iKmaPYKwAZmFw: folds 
f+H1PHwj9cNu4Y6FfvKwQQ: folds 
HQMjiff9S04k8kyC4fHVgw: folds 
kmJc9NmBNbE55/AnUDL6/w: calls $1.50
*** TURN *** [Jc 8h 9h] [Kd]
kmJc9NmBNbE55/AnUDL6/w: checks 
W4TLQcZ2TiM73eIgpIvlGg: bets $1.50
kmJc9NmBNbE55/AnUDL6/w: calls $1.35 and is all-in
Uncalled bet ($0.15) returned to W4TLQcZ2TiM73eIgpIvlGg
*** RIVER *** [Jc 8h 9h Kd] [8s]
*** SHOW DOWN ***
kmJc9NmBNbE55/AnUDL6/w: shows [Ac Qs] (a pair of Eights)
W4TLQcZ2TiM73eIgpIvlGg: shows [As Jd] (two pair, Jacks and Eights)
W4TLQcZ2TiM73eIgpIvlGg collected $8.05 from pot
*** SUMMARY ***
Total pot $8.45 | Rake $0.40 
Board [Jc 8h 9h Kd 8s]
Seat 1: s7Q6uNouhe7aE8JdFb9E+A (button) folded before Flop (didn't bet)
Seat 2: r6hsffOo1iKmaPYKwAZmFw (small blind) folded on the Flop
Seat 3: f+H1PHwj9cNu4Y6FfvKwQQ (big blind) folded on the Flop
Seat 4: SkLOm0UugROBRt2EfMpOxQ folded before Flop (didn't bet)
Seat 5: HQMjiff9S04k8kyC4fHVgw folded on the Flop
Seat 6: DiSvPC2iudwL5j9u6Huyww folded before Flop (didn't bet)
Seat 7: kmJc9NmBNbE55/AnUDL6/w showed [Ac Qs] and lost with a pair of Eights
Seat 8: 4oA316mXLIui1QY63GXBUg folded before Flop (didn't bet)
Seat 9: W4TLQcZ2TiM73eIgpIvlGg showed [As Jd] and won ($8.05) with two pair, Jacks and Eights




PokerStars Game #59939513800:  Hold'em No Limit ($0.10/$0.25) - 2009/07/01 0:41:50 ET
Table 'G26g8jde1eR+mmabeFeSlw' 9-max Seat #1 is the button
Seat 1: eygIcrabyU9hI2mw7NQsgg ($21.50 in chips) 
Seat 2: O2aLEhH7P83nWGvgV84KoA ($13.15 in chips) 
Seat 3: WKL8nUFr7TumC4EjLyqYzw ($5.50 in chips) 
Seat 4: 1Clf3cPrqoy/YgvWdWK1Xw ($5 in chips) 
Seat 5: hJ4uYjNmSZdjrKA8cjZqCA ($20.15 in chips) 
Seat 6: opOCI2p6kW0tINuVaAqmcQ ($25 in chips) 
Seat 7: nm4Dj/f+jJEwKVsUnKh73g ($26.25 in chips) 
Seat 8: G+6mJ0LVzvA9qwETH4Ostw ($25.40 in chips) 
Seat 9: VWUWpMLMj/Q1jRVpF7Aohw ($12.50 in chips) 
O2aLEhH7P83nWGvgV84KoA: posts small blind $0.10
WKL8nUFr7TumC4EjLyqYzw: posts big blind $0.25
*** HOLE CARDS ***
1Clf3cPrqoy/YgvWdWK1Xw: raises $0.50 to $0.75
hJ4uYjNmSZdjrKA8cjZqCA: folds 
opOCI2p6kW0tINuVaAqmcQ: folds 
nm4Dj/f+jJEwKVsUnKh73g has timed out
nm4Dj/f+jJEwKVsUnKh73g: folds 
nm4Dj/f+jJEwKVsUnKh73g is sitting out
G+6mJ0LVzvA9qwETH4Ostw: folds 
nm4Dj/f+jJEwKVsUnKh73g has returned
VWUWpMLMj/Q1jRVpF7Aohw: folds 
eygIcrabyU9hI2mw7NQsgg: folds 
O2aLEhH7P83nWGvgV84KoA: calls $0.65
WKL8nUFr7TumC4EjLyqYzw: calls $0.50
*** FLOP *** [Jc 3d 4d]
O2aLEhH7P83nWGvgV84KoA: checks 
WKL8nUFr7TumC4EjLyqYzw: checks 
1Clf3cPrqoy/YgvWdWK1Xw: bets $1.60
O2aLEhH7P83nWGvgV84KoA: folds 
WKL8nUFr7TumC4EjLyqYzw: raises $3.15 to $4.75 and is all-in
1Clf3cPrqoy/YgvWdWK1Xw: calls $2.65 and is all-in
Uncalled bet ($0.50) returned to WKL8nUFr7TumC4EjLyqYzw
*** TURN *** [Jc 3d 4d] [Th]
*** RIVER *** [Jc 3d 4d Th] [Tc]
*** SHOW DOWN ***
WKL8nUFr7TumC4EjLyqYzw: shows [8d 9d] (a pair of Tens)
1Clf3cPrqoy/YgvWdWK1Xw: shows [Kh Kc] (two pair, Kings and Tens)
1Clf3cPrqoy/YgvWdWK1Xw collected $10.25 from pot
*** SUMMARY ***
Total pot $10.75 | Rake $0.50 
Board [Jc 3d 4d Th Tc]
Seat 1: eygIcrabyU9hI2mw7NQsgg (button) folded before Flop (didn't bet)
Seat 2: O2aLEhH7P83nWGvgV84KoA (small blind) folded on the Flop
Seat 3: WKL8nUFr7TumC4EjLyqYzw (big blind) showed [8d 9d] and lost with a pair of Tens
Seat 4: 1Clf3cPrqoy/YgvWdWK1Xw showed [Kh Kc] and won ($10.25) with two pair, Kings and Tens
Seat 5: hJ4uYjNmSZdjrKA8cjZqCA folded before Flop (didn't bet)
Seat 6: opOCI2p6kW0tINuVaAqmcQ folded before Flop (didn't bet)
Seat 7: nm4Dj/f+jJEwKVsUnKh73g folded before Flop (didn't bet)
Seat 8: G+6mJ0LVzvA9qwETH4Ostw folded before Flop (didn't bet)
Seat 9: VWUWpMLMj/Q1jRVpF7Aohw folded before Flop (didn't bet)




PokerStars Game #59939513816:  Hold'em No Limit ($0.10/$0.25) - 2009/07/01 0:41:50 ET
Table 'KEoOIegxPF91KooL2AelUA' 6-max Seat #5 is the button
Seat 1: wsP46AGpqDjHZQmlRHKa9g ($28.05 in chips) 
Seat 4: Vv37Oa9niKKVcR6Z7ceetw ($22.95 in chips) 
Seat 5: 2NLC44AHHKHEUooUQFYV+Q ($13.75 in chips) 
Seat 6: Jq3YrbGb738j4tRTnp4PDA ($14.75 in chips) 
Jq3YrbGb738j4tRTnp4PDA: posts small blind $0.10
wsP46AGpqDjHZQmlRHKa9g: posts big blind $0.25
*** HOLE CARDS ***
Vv37Oa9niKKVcR6Z7ceetw: raises $0.50 to $0.75
2NLC44AHHKHEUooUQFYV+Q: folds 
Jq3YrbGb738j4tRTnp4PDA: folds 
wsP46AGpqDjHZQmlRHKa9g: raises $2.25 to $3
Vv37Oa9niKKVcR6Z7ceetw: folds 
Uncalled bet ($2.25) returned to wsP46AGpqDjHZQmlRHKa9g
wsP46AGpqDjHZQmlRHKa9g collected $1.60 from pot
*** SUMMARY ***
Total pot $1.60 | Rake $0 
Seat 1: wsP46AGpqDjHZQmlRHKa9g (big blind) collected ($1.60)
Seat 4: Vv37Oa9niKKVcR6Z7ceetw folded before Flop
Seat 5: 2NLC44AHHKHEUooUQFYV+Q (button) folded before Flop (didn't bet)
Seat 6: Jq3YrbGb738j4tRTnp4PDA (small blind) folded before Flop




PokerStars Game #59939514192:  Hold'em No Limit ($0.10/$0.25) - 2009/07/01 0:41:51 ET
Table '6wawJ+MkkvuC3coG6r+YhgZiwAqg4o02gNro+JOAaFNgSeat #4 is the button
Seat 1: j4q3p0lesp63b1gZDwLBZw ($5.60 in chips) 
Seat 2: tYsOBqdU1+x+yFI7zHO7hQ ($31.10 in chips) 
Seat 3: aNpwfA31EREwO+ar4XzBCw ($25 in chips) 
Seat 4: FJflwqC6fqOpM3j0q8Bptw ($22.20 in chips) 
Seat 5: 5hAPbqNrvJb8PtLiceXtlg6HoFYfVGBefsR5Vrz62qIw5.10 in chips) 
Seat 6: hBMUlEpyU74r/fwDgIpXjQ ($27.95 in chips) 
Seat 8: CYkY0dNBaYaKs8HVCVn3mQ ($5 in chips) 
Seat 9: ljemhp25Zg+nlA9DLCIiUw ($24.65 in chips) 
5hAPbqNrvJb8PtLiceXtlg6HoFYfVGBefsR5Vrz62qIwsts small blind $0.10
hBMUlEpyU74r/fwDgIpXjQ: posts big blind $0.25
opOCI2p6kW0tINuVaAqmcQ: sits out 
*** HOLE CARDS ***
CYkY0dNBaYaKs8HVCVn3mQ: raises $0.75 to $1
ljemhp25Zg+nlA9DLCIiUw: folds 
j4q3p0lesp63b1gZDwLBZw: folds 
tYsOBqdU1+x+yFI7zHO7hQ: folds 
aNpwfA31EREwO+ar4XzBCw: folds 
FJflwqC6fqOpM3j0q8Bptw: folds 
5hAPbqNrvJb8PtLiceXtlg6HoFYfVGBefsR5Vrz62qIwlds 
hBMUlEpyU74r/fwDgIpXjQ: folds 
Uncalled bet ($0.75) returned to CYkY0dNBaYaKs8HVCVn3mQ
CYkY0dNBaYaKs8HVCVn3mQ collected $0.60 from pot
CYkY0dNBaYaKs8HVCVn3mQ: doesn't show hand 
*** SUMMARY ***
Total pot $0.60 | Rake $0 
Seat 1: j4q3p0lesp63b1gZDwLBZw folded before Flop (didn't bet)
Seat 2: tYsOBqdU1+x+yFI7zHO7hQ folded before Flop (didn't bet)
Seat 3: aNpwfA31EREwO+ar4XzBCw folded before Flop (didn't bet)
Seat 4: FJflwqC6fqOpM3j0q8Bptw (button) folded before Flop (didn't bet)
Seat 5: 5hAPbqNrvJb8PtLiceXtlg6HoFYfVGBefsR5Vrz62qIwall blind) folded before Flop
Seat 6: hBMUlEpyU74r/fwDgIpXjQ (big blind) folded before Flop
Seat 8: CYkY0dNBaYaKs8HVCVn3mQ collected ($0.60)
Seat 9: ljemhp25Zg+nlA9DLCIiUw folded before Flop (didn't bet)




PokerStars Game #59939514418:  Hold'em No Limit ($0.10/$0.25) - 2009/07/01 0:41:51 ET
Table 'GrYi0DZOHD1EvB+qiLExNw' 9-max Seat #2 is the button
Seat 1: 4awUyiDYTgylQKXZ9faBVA ($49.20 in chips) 
Seat 2: Th3FldXKQW6hWVVPahaoOQ ($26.30 in chips) 
Seat 3: 4oA316mXLIui1QY63GXBUg ($25 in chips) 
Seat 4: 0GQg6tdDMBDzY6FKumSo9w ($25.75 in chips) 
Seat 5: cZ99hugmLBj9KhTlc8nCSw ($48.50 in chips) 
Seat 6: H9KUl8cmpLgEpOVDA00bCg ($4.20 in chips) 
Seat 7: 1Clf3cPrqoy/YgvWdWK1Xw ($5 in chips) 
Seat 8: nalbG/4/1Z1wQjRDWV7b2w ($7.35 in chips) 
4oA316mXLIui1QY63GXBUg: posts small blind $0.10
0GQg6tdDMBDzY6FKumSo9w: posts big blind $0.25
OiV1PWZ3IkN29JlmCcnTwQ: sits out 
*** HOLE CARDS ***
cZ99hugmLBj9KhTlc8nCSw: folds 
H9KUl8cmpLgEpOVDA00bCg: folds 
1Clf3cPrqoy/YgvWdWK1Xw: folds 
nalbG/4/1Z1wQjRDWV7b2w: folds 
4awUyiDYTgylQKXZ9faBVA: raises $0.75 to $1
Th3FldXKQW6hWVVPahaoOQ: folds 
4oA316mXLIui1QY63GXBUg: folds 
0GQg6tdDMBDzY6FKumSo9w: calls $0.75
*** FLOP *** [5h 6c Qh]
0GQg6tdDMBDzY6FKumSo9w: checks 
4awUyiDYTgylQKXZ9faBVA: bets $1.25
0GQg6tdDMBDzY6FKumSo9w: raises $1.75 to $3
4awUyiDYTgylQKXZ9faBVA: raises $6 to $9
0GQg6tdDMBDzY6FKumSo9w: calls $6
*** TURN *** [5h 6c Qh] [9c]
0GQg6tdDMBDzY6FKumSo9w: bets $15.75 and is all-in
4awUyiDYTgylQKXZ9faBVA: calls $15.75
*** RIVER *** [5h 6c Qh 9c] [Jd]
*** SHOW DOWN ***
0GQg6tdDMBDzY6FKumSo9w: shows [6d 6h] (three of a kind, Sixes)
4awUyiDYTgylQKXZ9faBVA: mucks hand 
0GQg6tdDMBDzY6FKumSo9w collected $49.10 from pot
*** SUMMARY ***
Total pot $51.60 | Rake $2.50 
Board [5h 6c Qh 9c Jd]
Seat 1: 4awUyiDYTgylQKXZ9faBVA mucked
Seat 2: Th3FldXKQW6hWVVPahaoOQ (button) folded before Flop (didn't bet)
Seat 3: 4oA316mXLIui1QY63GXBUg (small blind) folded before Flop
Seat 4: 0GQg6tdDMBDzY6FKumSo9w (big blind) showed [6d 6h] and won ($49.10) with three of a kind, Sixes
Seat 5: cZ99hugmLBj9KhTlc8nCSw folded before Flop (didn't bet)
Seat 6: H9KUl8cmpLgEpOVDA00bCg folded before Flop (didn't bet)
Seat 7: 1Clf3cPrqoy/YgvWdWK1Xw folded before Flop (didn't bet)
Seat 8: nalbG/4/1Z1wQjRDWV7b2w folded before Flop (didn't bet)




PokerStars Game #59939514362:  Hold'em No Limit ($0.10/$0.25) - 2009/07/01 0:41:51 ET
Table '1zj0+miaIL9cvwnT/50pOA' 9-max Seat #4 is the button
Seat 1: spidnpwmoJ1L6yeNW7D5UA ($26.10 in chips) 
Seat 2: HPEB+AtKw1+C/cxU0o1ciw ($28.45 in chips) 
Seat 3: CYkY0dNBaYaKs8HVCVn3mQ ($5.50 in chips) 
Seat 4: 6esz1u5YivjsX0UoeMBm3w ($22.50 in chips) 
Seat 6: ydoFOVgzvZv9ZhuWu9rXAw ($4.75 in chips) 
Seat 7: 6oWOdVz2WG2azNuOj9rMgg ($16.20 in chips) 
Seat 8: HOiu48bZMhEZSoJa8mjiMw ($32.55 in chips) 
Seat 9: OiV1PWZ3IkN29JlmCcnTwQ ($5.25 in chips) 
ydoFOVgzvZv9ZhuWu9rXAw: posts small blind $0.10
6oWOdVz2WG2azNuOj9rMgg: posts big blind $0.25
*** HOLE CARDS ***
HOiu48bZMhEZSoJa8mjiMw: folds 
JxpnpCmvRAcrEUy7mq1iAg leaves the table
OiV1PWZ3IkN29JlmCcnTwQ: raises $0.75 to $1
spidnpwmoJ1L6yeNW7D5UA: folds 
HPEB+AtKw1+C/cxU0o1ciw: folds 
CYkY0dNBaYaKs8HVCVn3mQ: folds 
6esz1u5YivjsX0UoeMBm3w: folds 
ydoFOVgzvZv9ZhuWu9rXAw: folds 
6oWOdVz2WG2azNuOj9rMgg: folds 
Uncalled bet ($0.75) returned to OiV1PWZ3IkN29JlmCcnTwQ
OiV1PWZ3IkN29JlmCcnTwQ collected $0.60 from pot
OiV1PWZ3IkN29JlmCcnTwQ: doesn't show hand 
*** SUMMARY ***
Total pot $0.60 | Rake $0 
Seat 1: spidnpwmoJ1L6yeNW7D5UA folded before Flop (didn't bet)
Seat 2: HPEB+AtKw1+C/cxU0o1ciw folded before Flop (didn't bet)
Seat 3: CYkY0dNBaYaKs8HVCVn3mQ folded before Flop (didn't bet)
Seat 4: 6esz1u5YivjsX0UoeMBm3w (button) folded before Flop (didn't bet)
Seat 6: ydoFOVgzvZv9ZhuWu9rXAw (small blind) folded before Flop
Seat 7: 6oWOdVz2WG2azNuOj9rMgg (big blind) folded before Flop
Seat 8: HOiu48bZMhEZSoJa8mjiMw folded before Flop (didn't bet)
Seat 9: OiV1PWZ3IkN29JlmCcnTwQ collected ($0.60)




PokerStars Game #59939514656:  Hold'em No Limit ($0.10/$0.25) - 2009/07/01 0:41:51 ET
Table 'Ez9TB43XM4QgMDQkIW9DYw' 9-max Seat #5 is the button
Seat 1: YqWNLUj3exwMphJEDBi8Ug ($29.60 in chips) 
Seat 2: gtLY9BJ1dcPGyJ0NDNjaBg ($10.40 in chips) 
Seat 3: LorpmCSxb4uozpKwk8Awsg ($27.15 in chips) 
Seat 4: il+NK449FnwuQ8vyJ0Xn/g ($9 in chips) 
Seat 5: vZGoOTJLQLhkPj4I+LNGig ($25.25 in chips) 
Seat 6: 76o85YBHJ9veRYp2LPuluQ ($30.75 in chips) 
Seat 7: 18G4P1XstjNvItdGUITxgw ($25 in chips) 
Seat 9: QEbIGci+itdw+re8RM5fZA ($25 in chips) 
76o85YBHJ9veRYp2LPuluQ: posts small blind $0.10
18G4P1XstjNvItdGUITxgw: posts big blind $0.25
+2kMBNpY4nF1qNCRd8SJLA: sits out 
*** HOLE CARDS ***
QEbIGci+itdw+re8RM5fZA: folds 
YqWNLUj3exwMphJEDBi8Ug: folds 
gtLY9BJ1dcPGyJ0NDNjaBg: folds 
LorpmCSxb4uozpKwk8Awsg: folds 
il+NK449FnwuQ8vyJ0Xn/g: folds 
vZGoOTJLQLhkPj4I+LNGig: folds 
76o85YBHJ9veRYp2LPuluQ: calls $0.15
18G4P1XstjNvItdGUITxgw: checks 
*** FLOP *** [Qc Qh 6h]
76o85YBHJ9veRYp2LPuluQ: bets $0.25
18G4P1XstjNvItdGUITxgw: folds 
Uncalled bet ($0.25) returned to 76o85YBHJ9veRYp2LPuluQ
76o85YBHJ9veRYp2LPuluQ collected $0.50 from pot
76o85YBHJ9veRYp2LPuluQ: doesn't show hand 
*** SUMMARY ***
Total pot $0.50 | Rake $0 
Board [Qc Qh 6h]
Seat 1: YqWNLUj3exwMphJEDBi8Ug folded before Flop (didn't bet)
Seat 2: gtLY9BJ1dcPGyJ0NDNjaBg folded before Flop (didn't bet)
Seat 3: LorpmCSxb4uozpKwk8Awsg folded before Flop (didn't bet)
Seat 4: il+NK449FnwuQ8vyJ0Xn/g folded before Flop (didn't bet)
Seat 5: vZGoOTJLQLhkPj4I+LNGig (button) folded before Flop (didn't bet)
Seat 6: 76o85YBHJ9veRYp2LPuluQ (small blind) collected ($0.50)
Seat 7: 18G4P1XstjNvItdGUITxgw (big blind) folded on the Flop
Seat 9: QEbIGci+itdw+re8RM5fZA folded before Flop (didn't bet)




PokerStars Game #59939514282:  Hold'em No Limit ($0.10/$0.25) - 2009/07/01 0:41:51 ET
Table 'PCxB2W9H6ma8SwsZlImuOw' 9-max Seat #2 is the button
Seat 1: 5s3p6yoJBNW438dsyKTP8g ($30.65 in chips) 
Seat 2: wjH6l1gQaEfv+C45sAOwIQ ($39.05 in chips) 
Seat 3: opOCI2p6kW0tINuVaAqmcQ ($29.25 in chips) 
Seat 4: ydoFOVgzvZv9ZhuWu9rXAw ($5 in chips) 
Seat 5: h4ggJZYBXV0mEZzYPYKfeA ($23.95 in chips) 
Seat 6: E2c0EwJuNHUUdumOOgYQYA ($5.30 in chips) 
Seat 7: EfRs3ibIxn+c9JDErwwNCg ($26.35 in chips) 
Seat 8: Hdb9b2QXBH2f6YwkTgMKdQ ($3.90 in chips) 
opOCI2p6kW0tINuVaAqmcQ: posts small blind $0.10
ydoFOVgzvZv9ZhuWu9rXAw: posts big blind $0.25
*** HOLE CARDS ***
h4ggJZYBXV0mEZzYPYKfeA: folds 
E2c0EwJuNHUUdumOOgYQYA: calls $0.25
EfRs3ibIxn+c9JDErwwNCg: folds 
Hdb9b2QXBH2f6YwkTgMKdQ: calls $0.25
5s3p6yoJBNW438dsyKTP8g: folds 
wjH6l1gQaEfv+C45sAOwIQ: calls $0.25
opOCI2p6kW0tINuVaAqmcQ: raises $0.50 to $0.75
ydoFOVgzvZv9ZhuWu9rXAw: folds 
E2c0EwJuNHUUdumOOgYQYA: calls $0.50
Hdb9b2QXBH2f6YwkTgMKdQ: calls $0.50
wjH6l1gQaEfv+C45sAOwIQ: calls $0.50
*** FLOP *** [7s 2d 2c]
opOCI2p6kW0tINuVaAqmcQ: bets $2
E2c0EwJuNHUUdumOOgYQYA: folds 
Hdb9b2QXBH2f6YwkTgMKdQ: calls $2
wjH6l1gQaEfv+C45sAOwIQ: folds 
*** TURN *** [7s 2d 2c] [Tc]
opOCI2p6kW0tINuVaAqmcQ: bets $1.50
Hdb9b2QXBH2f6YwkTgMKdQ: calls $1.15 and is all-in
Uncalled bet ($0.35) returned to opOCI2p6kW0tINuVaAqmcQ
1q23ISSsSMhv2lHXBfj9/A joins the table at seat #9 
*** RIVER *** [7s 2d 2c Tc] [2s]
*** SHOW DOWN ***
opOCI2p6kW0tINuVaAqmcQ: shows [Ad As] (a full house, Deuces full of Aces)
Hdb9b2QXBH2f6YwkTgMKdQ: mucks hand 
opOCI2p6kW0tINuVaAqmcQ collected $9.10 from pot
*** SUMMARY ***
Total pot $9.55 | Rake $0.45 
Board [7s 2d 2c Tc 2s]
Seat 1: 5s3p6yoJBNW438dsyKTP8g folded before Flop (didn't bet)
Seat 2: wjH6l1gQaEfv+C45sAOwIQ (button) folded on the Flop
Seat 3: opOCI2p6kW0tINuVaAqmcQ (small blind) showed [Ad As] and won ($9.10) with a full house, Deuces full of Aces
Seat 4: ydoFOVgzvZv9ZhuWu9rXAw (big blind) folded before Flop
Seat 5: h4ggJZYBXV0mEZzYPYKfeA folded before Flop (didn't bet)
Seat 6: E2c0EwJuNHUUdumOOgYQYA folded on the Flop
Seat 7: EfRs3ibIxn+c9JDErwwNCg folded before Flop (didn't bet)
Seat 8: Hdb9b2QXBH2f6YwkTgMKdQ mucked




PokerStars Game #59939514650:  Hold'em No Limit ($0.10/$0.25) - 2009/07/01 0:41:51 ET
Table 'a6FCGVBMPcT7J7BDN9q1zQ' 9-max Seat #1 is the button
Seat 1: s7Q6uNouhe7aE8JdFb9E+A ($43.50 in chips) 
Seat 2: h4ggJZYBXV0mEZzYPYKfeA ($34.60 in chips) 
Seat 3: hIss79a4pu7GzJZepfgOpg ($25 in chips) 
Seat 5: JJk2ZoH7BSGLAgqFUL5pMg ($2.40 in chips) 
Seat 6: Z9AeOQX3yzuSvKAm/xyovg ($9.65 in chips) 
Seat 7: V0Yo5zRBVM8DYspLKafebg ($24.05 in chips) 
Seat 8: r6hsffOo1iKmaPYKwAZmFw ($50.10 in chips) 
Seat 9: WwcXelmo9g129XJixVb2NA ($16.10 in chips) 
h4ggJZYBXV0mEZzYPYKfeA: posts small blind $0.10
hIss79a4pu7GzJZepfgOpg: posts big blind $0.25
ydoFOVgzvZv9ZhuWu9rXAw: sits out 
*** HOLE CARDS ***
JJk2ZoH7BSGLAgqFUL5pMg: folds 
Z9AeOQX3yzuSvKAm/xyovg: folds 
V0Yo5zRBVM8DYspLKafebg: calls $0.25
r6hsffOo1iKmaPYKwAZmFw: folds 
WwcXelmo9g129XJixVb2NA: calls $0.25
s7Q6uNouhe7aE8JdFb9E+A: folds 
h4ggJZYBXV0mEZzYPYKfeA: folds 
hIss79a4pu7GzJZepfgOpg: checks 
*** FLOP *** [Th 9h 7h]
hIss79a4pu7GzJZepfgOpg: checks 
V0Yo5zRBVM8DYspLKafebg: bets $1
WwcXelmo9g129XJixVb2NA: folds 
hIss79a4pu7GzJZepfgOpg: folds 
Uncalled bet ($1) returned to V0Yo5zRBVM8DYspLKafebg
V0Yo5zRBVM8DYspLKafebg collected $0.85 from pot
*** SUMMARY ***
Total pot $0.85 | Rake $0 
Board [Th 9h 7h]
Seat 1: s7Q6uNouhe7aE8JdFb9E+A (button) folded before Flop (didn't bet)
Seat 2: h4ggJZYBXV0mEZzYPYKfeA (small blind) folded before Flop
Seat 3: hIss79a4pu7GzJZepfgOpg (big blind) folded on the Flop
Seat 5: JJk2ZoH7BSGLAgqFUL5pMg folded before Flop (didn't bet)
Seat 6: Z9AeOQX3yzuSvKAm/xyovg folded before Flop (didn't bet)
Seat 7: V0Yo5zRBVM8DYspLKafebg collected ($0.85)
Seat 8: r6hsffOo1iKmaPYKwAZmFw folded before Flop (didn't bet)
Seat 9: WwcXelmo9g129XJixVb2NA folded on the Flop




PokerStars Game #59939514092:  Hold'em No Limit ($0.10/$0.25) - 2009/07/01 0:41:51 ET
Table 'Xi38lWH8L2JHRAsKYVX8Qg' 6-max Seat #1 is the button
Seat 1: AqQ7DFpHkgIzTwDu+rClcg ($6.25 in chips) 
Seat 3: 6DwBRH+xZ12AAZmeAg+aXw ($25 in chips) 
Seat 5: 79ID/ub1Pt/mDpCprVmOoA ($25 in chips) 
Seat 6: aogAb4Eienxztk8p2v9VVw ($21.50 in chips) 
7iL6KfkJTFbyWmnLYk4+AA will be allowed to play after the button
6DwBRH+xZ12AAZmeAg+aXw: posts small blind $0.10
79ID/ub1Pt/mDpCprVmOoA: posts big blind $0.25
*** HOLE CARDS ***
aogAb4Eienxztk8p2v9VVw: folds 
AqQ7DFpHkgIzTwDu+rClcg: folds 
6DwBRH+xZ12AAZmeAg+aXw: folds 
Uncalled bet ($0.15) returned to 79ID/ub1Pt/mDpCprVmOoA
79ID/ub1Pt/mDpCprVmOoA collected $0.20 from pot
79ID/ub1Pt/mDpCprVmOoA: doesn't show hand 
*** SUMMARY ***
Total pot $0.20 | Rake $0 
Seat 1: AqQ7DFpHkgIzTwDu+rClcg (button) folded before Flop (didn't bet)
Seat 3: 6DwBRH+xZ12AAZmeAg+aXw (small blind) folded before Flop
Seat 5: 79ID/ub1Pt/mDpCprVmOoA (big blind) collected ($0.20)
Seat 6: aogAb4Eienxztk8p2v9VVw folded before Flop (didn't bet)




PokerStars Game #59939514120:  Hold'em No Limit ($0.10/$0.25) - 2009/07/01 0:41:51 ET
Table 'mF3KHGMaTpaBZbtBoyfTeg' 6-max Seat #2 is the button
Seat 1: 0HAB2GdCAM7p7V00xueAVQ ($9.95 in chips) 
Seat 2: 4x9jCqgSw4272dnaIqnanw ($4.50 in chips) 
Seat 3: Hzrn9DZJegEZICufTNYkrg ($14.50 in chips) 
Seat 4: FYepjhAvF8ZdVCmqHIy+eQ ($25.55 in chips) 
Seat 5: sEQx9G5Cu8k1HNdQasxvUA ($27.90 in chips) 
Hzrn9DZJegEZICufTNYkrg: posts small blind $0.10
FYepjhAvF8ZdVCmqHIy+eQ: posts big blind $0.25
*** HOLE CARDS ***
sEQx9G5Cu8k1HNdQasxvUA: folds 
0HAB2GdCAM7p7V00xueAVQ: raises $0.50 to $0.75
4x9jCqgSw4272dnaIqnanw: folds 
Hzrn9DZJegEZICufTNYkrg: folds 
FYepjhAvF8ZdVCmqHIy+eQ: folds 
Uncalled bet ($0.50) returned to 0HAB2GdCAM7p7V00xueAVQ
0HAB2GdCAM7p7V00xueAVQ collected $0.60 from pot
0HAB2GdCAM7p7V00xueAVQ: doesn't show hand 
*** SUMMARY ***
Total pot $0.60 | Rake $0 
Seat 1: 0HAB2GdCAM7p7V00xueAVQ collected ($0.60)
Seat 2: 4x9jCqgSw4272dnaIqnanw (button) folded before Flop (didn't bet)
Seat 3: Hzrn9DZJegEZICufTNYkrg (small blind) folded before Flop
Seat 4: FYepjhAvF8ZdVCmqHIy+eQ (big blind) folded before Flop
Seat 5: sEQx9G5Cu8k1HNdQasxvUA folded before Flop (didn't bet)




PokerStars Game #59939514722:  Hold'em No Limit ($0.10/$0.25) - 2009/07/01 0:41:51 ET
Table 'yRuHgMpxv4rPBXeM6HFESw' 6-max Seat #1 is the button
Seat 1: MkNgTuvyxpHXkeIm5JITHQ ($7.80 in chips) 
Seat 2: iwlxXocltgSdaBmusNXanQ ($15.55 in chips) 
Seat 4: ypXnt+kzrF/5y8QN2rkt1A ($20.95 in chips) 
Seat 5: gaPMxLGp9SOj4Lq6t+/0Ig ($13.65 in chips) 
Seat 6: 4YSTu0Cdzpppe1lUgCZGCQ ($26.15 in chips) 
iwlxXocltgSdaBmusNXanQ: posts small blind $0.10
ypXnt+kzrF/5y8QN2rkt1A: posts big blind $0.25
*** HOLE CARDS ***
gaPMxLGp9SOj4Lq6t+/0Ig: folds 
4YSTu0Cdzpppe1lUgCZGCQ: folds 
ypXnt+kzrF/5y8QN2rkt1A said, "DSrdy"
MkNgTuvyxpHXkeIm5JITHQ: raises $0.50 to $0.75
iwlxXocltgSdaBmusNXanQ: folds 
ypXnt+kzrF/5y8QN2rkt1A: calls $0.50
*** FLOP *** [8s 3c 7d]
zZ8zH49EwNs0mqgppOaL9g is connected 
ypXnt+kzrF/5y8QN2rkt1A: checks 
zZ8zH49EwNs0mqgppOaL9g has returned
MkNgTuvyxpHXkeIm5JITHQ: bets $0.75
ypXnt+kzrF/5y8QN2rkt1A: folds 
Uncalled bet ($0.75) returned to MkNgTuvyxpHXkeIm5JITHQ
MkNgTuvyxpHXkeIm5JITHQ collected $1.55 from pot
MkNgTuvyxpHXkeIm5JITHQ: doesn't show hand 
*** SUMMARY ***
Total pot $1.60 | Rake $0.05 
Board [8s 3c 7d]
Seat 1: MkNgTuvyxpHXkeIm5JITHQ (button) collected ($1.55)
Seat 2: iwlxXocltgSdaBmusNXanQ (small blind) folded before Flop
Seat 4: ypXnt+kzrF/5y8QN2rkt1A (big blind) folded on the Flop
Seat 5: gaPMxLGp9SOj4Lq6t+/0Ig folded before Flop (didn't bet)
Seat 6: 4YSTu0Cdzpppe1lUgCZGCQ folded before Flop (didn't bet)




PokerStars Game #59939514370:  Hold'em No Limit ($0.10/$0.25) - 2009/07/01 0:41:51 ET
Table 'RUOqTfzbAVGS5x+J9aZMHA' 9-max Seat #2 is the button
Seat 1: KBBTLXGhPdPj+4X0QKMkcg ($13.30 in chips) 
Seat 2: Z5ZtGOON8kmSdSCll9Z3XA ($6.35 in chips) 
Seat 5: opOCI2p6kW0tINuVaAqmcQ ($27.65 in chips) 
Seat 6: ljemhp25Zg+nlA9DLCIiUw ($33.20 in chips) 
Seat 8: 3RCAkueG3Vc13VpRStCB+w ($24.10 in chips) 
JtVGnq5doRa3PublncR+Yw will be allowed to play after the button
ianfitz2008 will be allowed to play after the button
opOCI2p6kW0tINuVaAqmcQ: posts small blind $0.10
ljemhp25Zg+nlA9DLCIiUw: posts big blind $0.25
HxDF4QSxC4z39D7teZpprQ: sits out 
mdalglish: sits out 
*** HOLE CARDS ***
3RCAkueG3Vc13VpRStCB+w: folds 
KBBTLXGhPdPj+4X0QKMkcg: calls $0.25
Z5ZtGOON8kmSdSCll9Z3XA: calls $0.25
opOCI2p6kW0tINuVaAqmcQ: calls $0.15
ljemhp25Zg+nlA9DLCIiUw: checks 
*** FLOP *** [Ks 3s Kh]
opOCI2p6kW0tINuVaAqmcQ: checks 
ljemhp25Zg+nlA9DLCIiUw: checks 
KBBTLXGhPdPj+4X0QKMkcg: checks 
Z5ZtGOON8kmSdSCll9Z3XA: bets $0.50
opOCI2p6kW0tINuVaAqmcQ: calls $0.50
ljemhp25Zg+nlA9DLCIiUw: folds 
KBBTLXGhPdPj+4X0QKMkcg: folds 
*** TURN *** [Ks 3s Kh] [6d]
opOCI2p6kW0tINuVaAqmcQ: checks 
Z5ZtGOON8kmSdSCll9Z3XA: checks 
*** RIVER *** [Ks 3s Kh 6d] [4s]
opOCI2p6kW0tINuVaAqmcQ: bets $0.75
Z5ZtGOON8kmSdSCll9Z3XA: raises $1.25 to $2
opOCI2p6kW0tINuVaAqmcQ: calls $1.25
*** SHOW DOWN ***
Z5ZtGOON8kmSdSCll9Z3XA: shows [8s 7s] (a flush, King high)
opOCI2p6kW0tINuVaAqmcQ: mucks hand 
Z5ZtGOON8kmSdSCll9Z3XA collected $5.75 from pot
*** SUMMARY ***
Total pot $6 | Rake $0.25 
Board [Ks 3s Kh 6d 4s]
Seat 1: KBBTLXGhPdPj+4X0QKMkcg folded on the Flop
Seat 2: Z5ZtGOON8kmSdSCll9Z3XA (button) showed [8s 7s] and won ($5.75) with a flush, King high
Seat 5: opOCI2p6kW0tINuVaAqmcQ (small blind) mucked
Seat 6: ljemhp25Zg+nlA9DLCIiUw (big blind) folded on the Flop
Seat 8: 3RCAkueG3Vc13VpRStCB+w folded before Flop (didn't bet)




PokerStars Game #59939515048:  Hold'em No Limit ($0.10/$0.25) - 2009/07/01 0:41:52 ET
Table 'xkqAWQFDrFt4p81M8UsoNw' 9-max Seat #5 is the button
Seat 2: z5GxcHlYz/GSz6W2uFiTtg ($37.05 in chips) 
Seat 3: HEUqKs2EYYGGXJCepUdL0g ($7.25 in chips) 
Seat 4: gY+PO8PaVC7pBPH/9HSv6Q ($4.60 in chips) 
Seat 5: OiV1PWZ3IkN29JlmCcnTwQ ($4.90 in chips) 
Seat 6: Yv4fucyyT28mjx8V5lxKJg ($22 in chips) 
Seat 7: MG90wfSJZnOejs/KD3vlQQ ($48.40 in chips) 
Seat 9: Wa7bjLwN7ptOQro84PxQGw ($4.75 in chips) 
Yv4fucyyT28mjx8V5lxKJg: posts small blind $0.10
MG90wfSJZnOejs/KD3vlQQ: posts big blind $0.25
N6fYvIzQLKaydFLKQGtMlQ: sits out 
*** HOLE CARDS ***
Wa7bjLwN7ptOQro84PxQGw: folds 
z5GxcHlYz/GSz6W2uFiTtg: calls $0.25
HEUqKs2EYYGGXJCepUdL0g: folds 
gY+PO8PaVC7pBPH/9HSv6Q: folds 
OiV1PWZ3IkN29JlmCcnTwQ: folds 
Yv4fucyyT28mjx8V5lxKJg: folds 
MG90wfSJZnOejs/KD3vlQQ: checks 
*** FLOP *** [Jc 8h 9s]
MG90wfSJZnOejs/KD3vlQQ: checks 
z5GxcHlYz/GSz6W2uFiTtg: checks 
*** TURN *** [Jc 8h 9s] [As]
MG90wfSJZnOejs/KD3vlQQ: checks 
z5GxcHlYz/GSz6W2uFiTtg: bets $0.25
MG90wfSJZnOejs/KD3vlQQ: folds 
Uncalled bet ($0.25) returned to z5GxcHlYz/GSz6W2uFiTtg
z5GxcHlYz/GSz6W2uFiTtg collected $0.60 from pot
*** SUMMARY ***
Total pot $0.60 | Rake $0 
Board [Jc 8h 9s As]
Seat 2: z5GxcHlYz/GSz6W2uFiTtg collected ($0.60)
Seat 3: HEUqKs2EYYGGXJCepUdL0g folded before Flop (didn't bet)
Seat 4: gY+PO8PaVC7pBPH/9HSv6Q folded before Flop (didn't bet)
Seat 5: OiV1PWZ3IkN29JlmCcnTwQ (button) folded before Flop (didn't bet)
Seat 6: Yv4fucyyT28mjx8V5lxKJg (small blind) folded before Flop
Seat 7: MG90wfSJZnOejs/KD3vlQQ (big blind) folded on the Turn
Seat 9: Wa7bjLwN7ptOQro84PxQGw folded before Flop (didn't bet)




PokerStars Game #59939514918:  Hold'em No Limit ($0.10/$0.25) - 2009/07/01 0:41:52 ET
Table 'sIHZ0lzLr4NGCaBUKhmYhAJj2eLzVCUVAGBmM+Og79iQax Seat #2 is the button
Seat 1: /XMgGtJ7mcWfe5s7McY9kw ($41.40 in chips) 
Seat 2: oMxwMC7+uAsJudeUN6aP0A ($19.10 in chips) 
Seat 3: HPEB+AtKw1+C/cxU0o1ciw ($23.80 in chips) 
Seat 4: aNpwfA31EREwO+ar4XzBCw ($47.05 in chips) 
Seat 5: UOx+/JnFB2Or6ZU9oasIlQ ($16.75 in chips) 
Seat 6: ZeR3hkj1gVv9J4yPCmRrjA ($32 in chips) 
Seat 9: wU1LtrccnZo6PYKhlJ6ElQ ($36.35 in chips) 
HPEB+AtKw1+C/cxU0o1ciw: posts small blind $0.10
aNpwfA31EREwO+ar4XzBCw: posts big blind $0.25
18G4P1XstjNvItdGUITxgw: sits out 
*** HOLE CARDS ***
UOx+/JnFB2Or6ZU9oasIlQ: folds 
ZeR3hkj1gVv9J4yPCmRrjA: folds 
wU1LtrccnZo6PYKhlJ6ElQ: folds 
/XMgGtJ7mcWfe5s7McY9kw: folds 
oMxwMC7+uAsJudeUN6aP0A: calls $0.25
HPEB+AtKw1+C/cxU0o1ciw: folds 
aNpwfA31EREwO+ar4XzBCw: checks 
*** FLOP *** [Qc 4c 5h]
aNpwfA31EREwO+ar4XzBCw: checks 
oMxwMC7+uAsJudeUN6aP0A: checks 
*** TURN *** [Qc 4c 5h] [As]
aNpwfA31EREwO+ar4XzBCw: checks 
K0b5wNInj6hUGRr6yzKFtw has returned
oMxwMC7+uAsJudeUN6aP0A: checks 
*** RIVER *** [Qc 4c 5h As] [8c]
aNpwfA31EREwO+ar4XzBCw: checks 
oMxwMC7+uAsJudeUN6aP0A: bets $0.25
aNpwfA31EREwO+ar4XzBCw: folds 
Uncalled bet ($0.25) returned to oMxwMC7+uAsJudeUN6aP0A
oMxwMC7+uAsJudeUN6aP0A collected $0.60 from pot
oMxwMC7+uAsJudeUN6aP0A: doesn't show hand 
*** SUMMARY ***
Total pot $0.60 | Rake $0 
Board [Qc 4c 5h As 8c]
Seat 1: /XMgGtJ7mcWfe5s7McY9kw folded before Flop (didn't bet)
Seat 2: oMxwMC7+uAsJudeUN6aP0A (button) collected ($0.60)
Seat 3: HPEB+AtKw1+C/cxU0o1ciw (small blind) folded before Flop
Seat 4: aNpwfA31EREwO+ar4XzBCw (big blind) folded on the River
Seat 5: UOx+/JnFB2Or6ZU9oasIlQ folded before Flop (didn't bet)
Seat 6: ZeR3hkj1gVv9J4yPCmRrjA folded before Flop (didn't bet)
Seat 9: wU1LtrccnZo6PYKhlJ6ElQ folded before Flop (didn't bet)




PokerStars Game #59939514788:  Hold'em No Limit ($0.10/$0.25) - 2009/07/01 0:41:52 ET
Table 'R5f24ws6hGXlbvjq9ej+1Q' 9-max Seat #7 is the button
Seat 1: TeWJxSETzbXGiYKx0y+dtg ($26.30 in chips) 
Seat 2: 8lk6dG3H7iS/67/biw/vcQ ($26.55 in chips) 
Seat 4: jM9ExRdqCqq2e6TjpOBoRw ($16.65 in chips) 
Seat 5: YMlMWbkusacDBjx3A8lphw ($5.90 in chips) 
Seat 7: Z5ZtGOON8kmSdSCll9Z3XA ($8 in chips) 
Seat 8: qwr38jl5txoR36M7G5qi4A ($9.25 in chips) 
Seat 9: 33y9+GmQ3J84RvZXcraRTw ($27.40 in chips) 
qwr38jl5txoR36M7G5qi4A: posts small blind $0.10
33y9+GmQ3J84RvZXcraRTw: posts big blind $0.25
*** HOLE CARDS ***
TeWJxSETzbXGiYKx0y+dtg: folds 
8lk6dG3H7iS/67/biw/vcQ: calls $0.25
jM9ExRdqCqq2e6TjpOBoRw: folds 
jM9ExRdqCqq2e6TjpOBoRw leaves the table
YMlMWbkusacDBjx3A8lphw: folds 
Z5ZtGOON8kmSdSCll9Z3XA: folds 
qwr38jl5txoR36M7G5qi4A: folds 
33y9+GmQ3J84RvZXcraRTw: checks 
*** FLOP *** [6d 2h 4s]
33y9+GmQ3J84RvZXcraRTw: checks 
8lk6dG3H7iS/67/biw/vcQ: checks 
*** TURN *** [6d 2h 4s] [As]
33y9+GmQ3J84RvZXcraRTw: checks 
8lk6dG3H7iS/67/biw/vcQ: checks 
*** RIVER *** [6d 2h 4s As] [3d]
33y9+GmQ3J84RvZXcraRTw: bets $1
8lk6dG3H7iS/67/biw/vcQ: folds 
Uncalled bet ($1) returned to 33y9+GmQ3J84RvZXcraRTw
33y9+GmQ3J84RvZXcraRTw collected $0.60 from pot
33y9+GmQ3J84RvZXcraRTw: doesn't show hand 
*** SUMMARY ***
Total pot $0.60 | Rake $0 
Board [6d 2h 4s As 3d]
Seat 1: TeWJxSETzbXGiYKx0y+dtg folded before Flop (didn't bet)
Seat 2: 8lk6dG3H7iS/67/biw/vcQ folded on the River
Seat 4: jM9ExRdqCqq2e6TjpOBoRw folded before Flop (didn't bet)
Seat 5: YMlMWbkusacDBjx3A8lphw folded before Flop (didn't bet)
Seat 7: Z5ZtGOON8kmSdSCll9Z3XA (button) folded before Flop (didn't bet)
Seat 8: qwr38jl5txoR36M7G5qi4A (small blind) folded before Flop
Seat 9: 33y9+GmQ3J84RvZXcraRTw (big blind) collected ($0.60)




PokerStars Game #59939515104:  Hold'em No Limit ($0.10/$0.25) - 2009/07/01 0:41:52 ET
Table 'MQJMxKDF6VYBWIKv7VfCog' 9-max Seat #1 is the button
Seat 1: cZ99hugmLBj9KhTlc8nCSw ($26.55 in chips) 
Seat 4: JtVGnq5doRa3PublncR+Yw ($24.35 in chips) 
Seat 5: RJ/x9oZtt1RZLaJEQwZOxQ ($25.60 in chips) 
Seat 6: ydoFOVgzvZv9ZhuWu9rXAw ($4.90 in chips) 
Seat 7: dfNim92Z6XK1/h5SFW5vDg ($52.95 in chips) 
Seat 8: Z9AeOQX3yzuSvKAm/xyovg ($9.30 in chips) 
Seat 9: 1S/fpm+f42V/6MNZre+ccg ($36.10 in chips) 
JtVGnq5doRa3PublncR+Yw: posts small blind $0.10
RJ/x9oZtt1RZLaJEQwZOxQ: posts big blind $0.25
*** HOLE CARDS ***
ydoFOVgzvZv9ZhuWu9rXAw: folds 
dfNim92Z6XK1/h5SFW5vDg: folds 
JxpnpCmvRAcrEUy7mq1iAg leaves the table
Z9AeOQX3yzuSvKAm/xyovg: folds 
1S/fpm+f42V/6MNZre+ccg: folds 
cZ99hugmLBj9KhTlc8nCSw: folds 
ydoFOVgzvZv9ZhuWu9rXAw leaves the table
JtVGnq5doRa3PublncR+Yw: folds 
Uncalled bet ($0.15) returned to RJ/x9oZtt1RZLaJEQwZOxQ
RJ/x9oZtt1RZLaJEQwZOxQ collected $0.20 from pot
RJ/x9oZtt1RZLaJEQwZOxQ: doesn't show hand 
*** SUMMARY ***
Total pot $0.20 | Rake $0 
Seat 1: cZ99hugmLBj9KhTlc8nCSw (button) folded before Flop (didn't bet)
Seat 4: JtVGnq5doRa3PublncR+Yw (small blind) folded before Flop
Seat 5: RJ/x9oZtt1RZLaJEQwZOxQ (big blind) collected ($0.20)
Seat 6: ydoFOVgzvZv9ZhuWu9rXAw folded before Flop (didn't bet)
Seat 7: dfNim92Z6XK1/h5SFW5vDg folded before Flop (didn't bet)
Seat 8: Z9AeOQX3yzuSvKAm/xyovg folded before Flop (didn't bet)
Seat 9: 1S/fpm+f42V/6MNZre+ccg folded before Flop (didn't bet)




PokerStars Game #59939514824:  Hold'em No Limit ($0.10/$0.25) - 2009/07/01 0:41:52 ET
Table 'eOXPe2c6mG7DOFKvMsZZfA' 6-max Seat #4 is the button
Seat 1: ShXPHWfjhfmAwLgDdm6bRQ ($7.65 in chips) 
Seat 2: ELW+DKizJhLK7k40PMkD2Q ($32.75 in chips) 
Seat 3: kReyZ6g6Fu3tQ0nyjDf9kA ($31.25 in chips) 
Seat 4: zHHLkD2sRljslKKeQv/ZQw ($42.05 in chips) 
Seat 5: NhUN/JpAprdJeamFBgJH1w ($25 in chips) 
Seat 6: wKFJ513ucluNNiMlkXcDOQ ($25.70 in chips) 
NhUN/JpAprdJeamFBgJH1w: posts small blind $0.10
wKFJ513ucluNNiMlkXcDOQ: posts big blind $0.25
*** HOLE CARDS ***
ShXPHWfjhfmAwLgDdm6bRQ: folds 
ELW+DKizJhLK7k40PMkD2Q: raises $0.75 to $1
kReyZ6g6Fu3tQ0nyjDf9kA: calls $1
zHHLkD2sRljslKKeQv/ZQw: folds 
NhUN/JpAprdJeamFBgJH1w: folds 
wKFJ513ucluNNiMlkXcDOQ: folds 
*** FLOP *** [Ad Qh 5h]
ELW+DKizJhLK7k40PMkD2Q: bets $1.50
kReyZ6g6Fu3tQ0nyjDf9kA: folds 
Uncalled bet ($1.50) returned to ELW+DKizJhLK7k40PMkD2Q
ELW+DKizJhLK7k40PMkD2Q collected $2.25 from pot
*** SUMMARY ***
Total pot $2.35 | Rake $0.10 
Board [Ad Qh 5h]
Seat 1: ShXPHWfjhfmAwLgDdm6bRQ folded before Flop (didn't bet)
Seat 2: ELW+DKizJhLK7k40PMkD2Q collected ($2.25)
Seat 3: kReyZ6g6Fu3tQ0nyjDf9kA folded on the Flop
Seat 4: zHHLkD2sRljslKKeQv/ZQw (button) folded before Flop (didn't bet)
Seat 5: NhUN/JpAprdJeamFBgJH1w (small blind) folded before Flop
Seat 6: wKFJ513ucluNNiMlkXcDOQ (big blind) folded before Flop




PokerStars Game #59939515272:  Hold'em No Limit ($0.10/$0.25) - 2009/07/01 0:41:52 ET
Table 'DhkrdW2UOy2PfjSW28Kq8w' 6-max Seat #2 is the button
Seat 1: vu2kzHaDtgr6NM7rdq0chA ($25 in chips) 
Seat 2: v+QfkGiuj9bgtuNoVnDO8w ($25 in chips) 
Seat 3: 66a/8+qw1AZLNh63FuclPA ($43.90 in chips) 
Seat 4: I1TxPvWj8NfG8orglCinNA ($27.40 in chips) 
Seat 5: SxIIgwXYLkwd6m3wLyPTCw ($47.50 in chips) 
Seat 6: SS/yfeArhULzIcOPe8MdPg ($26.65 in chips) 
66a/8+qw1AZLNh63FuclPA: posts small blind $0.10
I1TxPvWj8NfG8orglCinNA: posts big blind $0.25
*** HOLE CARDS ***
SxIIgwXYLkwd6m3wLyPTCw: folds 
SS/yfeArhULzIcOPe8MdPg: folds 
vu2kzHaDtgr6NM7rdq0chA: folds 
v+QfkGiuj9bgtuNoVnDO8w: raises $0.75 to $1
66a/8+qw1AZLNh63FuclPA: folds 
I1TxPvWj8NfG8orglCinNA: raises $3 to $4
v+QfkGiuj9bgtuNoVnDO8w: raises $7 to $11
I1TxPvWj8NfG8orglCinNA: folds 
Uncalled bet ($7) returned to v+QfkGiuj9bgtuNoVnDO8w
v+QfkGiuj9bgtuNoVnDO8w collected $8.10 from pot
v+QfkGiuj9bgtuNoVnDO8w: doesn't show hand 
*** SUMMARY ***
Total pot $8.10 | Rake $0 
Seat 1: vu2kzHaDtgr6NM7rdq0chA folded before Flop (didn't bet)
Seat 2: v+QfkGiuj9bgtuNoVnDO8w (button) collected ($8.10)
Seat 3: 66a/8+qw1AZLNh63FuclPA (small blind) folded before Flop
Seat 4: I1TxPvWj8NfG8orglCinNA (big blind) folded before Flop
Seat 5: SxIIgwXYLkwd6m3wLyPTCw folded before Flop (didn't bet)
Seat 6: SS/yfeArhULzIcOPe8MdPg folded before Flop (didn't bet)




PokerStars Game #59939514782:  Hold'em No Limit ($0.10/$0.25) - 2009/07/01 0:41:52 ET
Table 'oJpFwZj9+FUGHX90Un8s9Q' 6-max Seat #5 is the button
Seat 1: 6DwBRH+xZ12AAZmeAg+aXw ($25 in chips) 
Seat 2: IMmIhmfU3tqkaJABnD21Rg ($20.20 in chips) 
Seat 3: kyRaCIljYA6l33lSKQfNsg ($26.30 in chips) 
Seat 4: IX/nJvz3Mx/Ez6DgueFA4Q ($6.60 in chips) 
Seat 5: kG34n23qFQA3nzdOJTQ1dA ($24.65 in chips) 
Seat 6: Zijzy/UtPWzWVUo81HHVjQ ($40.55 in chips) 
Zijzy/UtPWzWVUo81HHVjQ: posts small blind $0.10
6DwBRH+xZ12AAZmeAg+aXw: posts big blind $0.25
*** HOLE CARDS ***
IMmIhmfU3tqkaJABnD21Rg: calls $0.25
kyRaCIljYA6l33lSKQfNsg: folds 
IX/nJvz3Mx/Ez6DgueFA4Q: calls $0.25
kG34n23qFQA3nzdOJTQ1dA: folds 
Zijzy/UtPWzWVUo81HHVjQ: folds 
6DwBRH+xZ12AAZmeAg+aXw: checks 
*** FLOP *** [3s Kh 5d]
6DwBRH+xZ12AAZmeAg+aXw: checks 
IMmIhmfU3tqkaJABnD21Rg: bets $0.25
IX/nJvz3Mx/Ez6DgueFA4Q: raises $0.75 to $1
6DwBRH+xZ12AAZmeAg+aXw: folds 
IMmIhmfU3tqkaJABnD21Rg: calls $0.75
*** TURN *** [3s Kh 5d] [Qc]
IMmIhmfU3tqkaJABnD21Rg: checks 
IX/nJvz3Mx/Ez6DgueFA4Q: bets $1
IMmIhmfU3tqkaJABnD21Rg: folds 
Uncalled bet ($1) returned to IX/nJvz3Mx/Ez6DgueFA4Q
IX/nJvz3Mx/Ez6DgueFA4Q collected $2.75 from pot
IX/nJvz3Mx/Ez6DgueFA4Q: shows [Ks 7s] (a pair of Kings)
*** SUMMARY ***
Total pot $2.85 | Rake $0.10 
Board [3s Kh 5d Qc]
Seat 1: 6DwBRH+xZ12AAZmeAg+aXw (big blind) folded on the Flop
Seat 2: IMmIhmfU3tqkaJABnD21Rg folded on the Turn
Seat 3: kyRaCIljYA6l33lSKQfNsg folded before Flop (didn't bet)
Seat 4: IX/nJvz3Mx/Ez6DgueFA4Q collected ($2.75)
Seat 5: kG34n23qFQA3nzdOJTQ1dA (button) folded before Flop (didn't bet)
Seat 6: Zijzy/UtPWzWVUo81HHVjQ (small blind) folded before Flop




PokerStars Game #59939514928:  Hold'em No Limit ($0.10/$0.25) - 2009/07/01 0:41:52 ET
Table 'xmJKTGBeWCwutccj3YfupQ' 6-max Seat #5 is the button
Seat 1: sVbkVl4OznxBCfi66UB9vw ($59.55 in chips) 
Seat 2: BedjMfrlRfPgSq7CXpPAmg ($49.95 in chips) 
Seat 3: FStoHe64SQWqAsjya9pDkQ ($25 in chips) 
Seat 4: uWjhTVMpuIroxXcmD3Okug ($41.90 in chips) 
Seat 5: oBUDUfeUyCbZBsjxHZgSiw ($17.70 in chips) 
Seat 6: lYjWCpfCxX2kgcHY3v4Yow ($26.10 in chips) 
lYjWCpfCxX2kgcHY3v4Yow: posts small blind $0.10
sVbkVl4OznxBCfi66UB9vw: posts big blind $0.25
*** HOLE CARDS ***
BedjMfrlRfPgSq7CXpPAmg: folds 
FStoHe64SQWqAsjya9pDkQ: raises $0.50 to $0.75
uWjhTVMpuIroxXcmD3Okug: calls $0.75
oBUDUfeUyCbZBsjxHZgSiw: calls $0.75
lYjWCpfCxX2kgcHY3v4Yow: folds 
sVbkVl4OznxBCfi66UB9vw: folds 
*** FLOP *** [2c Kd 5s]
FStoHe64SQWqAsjya9pDkQ: checks 
uWjhTVMpuIroxXcmD3Okug: checks 
oBUDUfeUyCbZBsjxHZgSiw: checks 
*** TURN *** [2c Kd 5s] [5h]
FStoHe64SQWqAsjya9pDkQ: checks 
uWjhTVMpuIroxXcmD3Okug: bets $0.75
oBUDUfeUyCbZBsjxHZgSiw: calls $0.75
FStoHe64SQWqAsjya9pDkQ: folds 
*** RIVER *** [2c Kd 5s 5h] [As]
uWjhTVMpuIroxXcmD3Okug: checks 
oBUDUfeUyCbZBsjxHZgSiw: checks 
*** SHOW DOWN ***
uWjhTVMpuIroxXcmD3Okug: shows [8c 8s] (two pair, Eights and Fives)
oBUDUfeUyCbZBsjxHZgSiw: mucks hand 
uWjhTVMpuIroxXcmD3Okug collected $3.90 from pot
*** SUMMARY ***
Total pot $4.10 | Rake $0.20 
Board [2c Kd 5s 5h As]
Seat 1: sVbkVl4OznxBCfi66UB9vw (big blind) folded before Flop
Seat 2: BedjMfrlRfPgSq7CXpPAmg folded before Flop (didn't bet)
Seat 3: FStoHe64SQWqAsjya9pDkQ folded on the Turn
Seat 4: uWjhTVMpuIroxXcmD3Okug showed [8c 8s] and won ($3.90) with two pair, Eights and Fives
Seat 5: oBUDUfeUyCbZBsjxHZgSiw (button) mucked
Seat 6: lYjWCpfCxX2kgcHY3v4Yow (small blind) folded before Flop




PokerStars Game #59939515290:  Hold'em No Limit ($0.10/$0.25) - 2009/07/01 0:41:52 ET
Table 'ROYvQOMwUrvL3SOiHYcrWg' 9-max Seat #8 is the button
Seat 1: 7q7lZBfgmzjFr0jTNx4b6g ($10.95 in chips) 
Seat 2: hBMUlEpyU74r/fwDgIpXjQ ($48.85 in chips) 
Seat 4: SHegmCn8B0InbWE/zFlvOw ($25.70 in chips) 
Seat 5: jeKWRUkMaVn8rEUjnJKqpg ($25 in chips) 
Seat 7: tYsOBqdU1+x+yFI7zHO7hQ ($26.70 in chips) 
Seat 8: biJWLZ27fafNeBI2oT1KJw ($17.75 in chips) 
caspertheska will be allowed to play after the button
7q7lZBfgmzjFr0jTNx4b6g: posts small blind $0.10
hBMUlEpyU74r/fwDgIpXjQ: posts big blind $0.25
OiV1PWZ3IkN29JlmCcnTwQ: sits out 
*** HOLE CARDS ***
caspertheska leaves the table
SHegmCn8B0InbWE/zFlvOw: calls $0.25
jeKWRUkMaVn8rEUjnJKqpg: folds 
tYsOBqdU1+x+yFI7zHO7hQ: folds 
biJWLZ27fafNeBI2oT1KJw: raises $0.50 to $0.75
7q7lZBfgmzjFr0jTNx4b6g: calls $0.65
hBMUlEpyU74r/fwDgIpXjQ: folds 
SHegmCn8B0InbWE/zFlvOw: calls $0.50
*** FLOP *** [9h Ac Td]
7q7lZBfgmzjFr0jTNx4b6g: checks 
SHegmCn8B0InbWE/zFlvOw: checks 
biJWLZ27fafNeBI2oT1KJw: bets $2
7q7lZBfgmzjFr0jTNx4b6g: folds 
SHegmCn8B0InbWE/zFlvOw: calls $2
*** TURN *** [9h Ac Td] [Ah]
yduPKWPzL8YlT5Zv/Nmrwg joins the table at seat #9 
SHegmCn8B0InbWE/zFlvOw: bets $4
biJWLZ27fafNeBI2oT1KJw: raises $11 to $15 and is all-in
SHegmCn8B0InbWE/zFlvOw: calls $11
*** RIVER *** [9h Ac Td Ah] [2s]
*** SHOW DOWN ***
SHegmCn8B0InbWE/zFlvOw: shows [As 8c] (three of a kind, Aces)
biJWLZ27fafNeBI2oT1KJw: shows [5d Ad] (three of a kind, Aces)
SHegmCn8B0InbWE/zFlvOw collected $17.35 from pot
biJWLZ27fafNeBI2oT1KJw collected $17.35 from pot
*** SUMMARY ***
Total pot $36.50 | Rake $1.80 
Board [9h Ac Td Ah 2s]
Seat 1: 7q7lZBfgmzjFr0jTNx4b6g (small blind) folded on the Flop
Seat 2: hBMUlEpyU74r/fwDgIpXjQ (big blind) folded before Flop
Seat 4: SHegmCn8B0InbWE/zFlvOw showed [As 8c] and won ($17.35) with three of a kind, Aces
Seat 5: jeKWRUkMaVn8rEUjnJKqpg folded before Flop (didn't bet)
Seat 7: tYsOBqdU1+x+yFI7zHO7hQ folded before Flop (didn't bet)
Seat 8: biJWLZ27fafNeBI2oT1KJw (button) showed [5d Ad] and won ($17.35) with three of a kind, Aces




PokerStars Game #59939515344:  Hold'em No Limit ($0.10/$0.25) - 2009/07/01 0:41:52 ET
Table 'T/iCKJXGphRN3xcdwfE/JQJYkCJJ5Iv+Tu52jx2lpEcgSeat #2 is the button
Seat 1: Yv4fucyyT28mjx8V5lxKJg ($30.25 in chips) 
Seat 2: hBMUlEpyU74r/fwDgIpXjQ ($35.25 in chips) 
Seat 3: Z5ZtGOON8kmSdSCll9Z3XA ($7.50 in chips) 
Seat 5: 6OVSxS1KoddUCYNkZ4hREw ($28.60 in chips) 
Seat 6: OiV1PWZ3IkN29JlmCcnTwQ ($5 in chips) 
Seat 7: N6fYvIzQLKaydFLKQGtMlQ ($24.90 in chips) 
Seat 8: COsrwJSFHQtxlUcrYtDQPQ ($25 in chips) 
Seat 9: H9KUl8cmpLgEpOVDA00bCg ($5.15 in chips) 
Z5ZtGOON8kmSdSCll9Z3XA: posts small blind $0.10
6OVSxS1KoddUCYNkZ4hREw: posts big blind $0.25
*** HOLE CARDS ***
OiV1PWZ3IkN29JlmCcnTwQ: folds 
N6fYvIzQLKaydFLKQGtMlQ: folds 
COsrwJSFHQtxlUcrYtDQPQ: folds 
H9KUl8cmpLgEpOVDA00bCg: folds 
Yv4fucyyT28mjx8V5lxKJg: folds 
hBMUlEpyU74r/fwDgIpXjQ: folds 
Z5ZtGOON8kmSdSCll9Z3XA: raises $0.25 to $0.50
6OVSxS1KoddUCYNkZ4hREw: folds 
Uncalled bet ($0.25) returned to Z5ZtGOON8kmSdSCll9Z3XA
Z5ZtGOON8kmSdSCll9Z3XA collected $0.50 from pot
*** SUMMARY ***
Total pot $0.50 | Rake $0 
Seat 1: Yv4fucyyT28mjx8V5lxKJg folded before Flop (didn't bet)
Seat 2: hBMUlEpyU74r/fwDgIpXjQ (button) folded before Flop (didn't bet)
Seat 3: Z5ZtGOON8kmSdSCll9Z3XA (small blind) collected ($0.50)
Seat 5: 6OVSxS1KoddUCYNkZ4hREw (big blind) folded before Flop
Seat 6: OiV1PWZ3IkN29JlmCcnTwQ folded before Flop (didn't bet)
Seat 7: N6fYvIzQLKaydFLKQGtMlQ folded before Flop (didn't bet)
Seat 8: COsrwJSFHQtxlUcrYtDQPQ folded before Flop (didn't bet)
Seat 9: H9KUl8cmpLgEpOVDA00bCg folded before Flop (didn't bet)




PokerStars Game #59939515050:  Hold'em No Limit ($0.10/$0.25) - 2009/07/01 0:41:52 ET
Table 'XX2OuOsa8/8AC+/mR/Az6g' 9-max Seat #1 is the button
Seat 1: 56S3mA6Zs3pGR+0p0vUCtg ($25.70 in chips) 
Seat 2: MIVCHqCqqlke0Lb0z7glcw ($23.90 in chips) 
Seat 3: PJJTm/ccITEBlwPReiBTwg ($13 in chips) 
Seat 4: uLP/lYn7oKq9xCChBXsXxw ($24.75 in chips) 
Seat 5: jXz58rvCgq0VjyVjUBf2mw ($24.05 in chips) 
Seat 6: gT0nY7XiR+2FA+B3F4h8HQ ($25.35 in chips) 
Seat 7: zDrucyjVn5aeekNEc3cJrA ($20.45 in chips) 
Seat 9: 86vbuhJsyH+nbEg5qpDLyQ ($43.45 in chips) 
MIVCHqCqqlke0Lb0z7glcw: posts small blind $0.10
PJJTm/ccITEBlwPReiBTwg: posts big blind $0.25
qwr38jl5txoR36M7G5qi4A: sits out 
*** HOLE CARDS ***
uLP/lYn7oKq9xCChBXsXxw: folds 
jXz58rvCgq0VjyVjUBf2mw: folds 
gT0nY7XiR+2FA+B3F4h8HQ: calls $0.25
zDrucyjVn5aeekNEc3cJrA: folds 
86vbuhJsyH+nbEg5qpDLyQ: folds 
56S3mA6Zs3pGR+0p0vUCtg: folds 
MIVCHqCqqlke0Lb0z7glcw: folds 
PJJTm/ccITEBlwPReiBTwg: checks 
*** FLOP *** [Jd 7c 9h]
PJJTm/ccITEBlwPReiBTwg: checks 
gT0nY7XiR+2FA+B3F4h8HQ: bets $0.25
PJJTm/ccITEBlwPReiBTwg: folds 
Uncalled bet ($0.25) returned to gT0nY7XiR+2FA+B3F4h8HQ
gT0nY7XiR+2FA+B3F4h8HQ collected $0.60 from pot
*** SUMMARY ***
Total pot $0.60 | Rake $0 
Board [Jd 7c 9h]
Seat 1: 56S3mA6Zs3pGR+0p0vUCtg (button) folded before Flop (didn't bet)
Seat 2: MIVCHqCqqlke0Lb0z7glcw (small blind) folded before Flop
Seat 3: PJJTm/ccITEBlwPReiBTwg (big blind) folded on the Flop
Seat 4: uLP/lYn7oKq9xCChBXsXxw folded before Flop (didn't bet)
Seat 5: jXz58rvCgq0VjyVjUBf2mw folded before Flop (didn't bet)
Seat 6: gT0nY7XiR+2FA+B3F4h8HQ collected ($0.60)
Seat 7: zDrucyjVn5aeekNEc3cJrA folded before Flop (didn't bet)
Seat 9: 86vbuhJsyH+nbEg5qpDLyQ folded before Flop (didn't bet)




PokerStars Game #59939515306:  Hold'em No Limit ($0.10/$0.25) - 2009/07/01 0:41:52 ET
Table '/AhP8uWRzEEhOATYIdmn0A' 9-max Seat #8 is the button
Seat 1: +sbyWwIcFp9kP0bDtMegfQ ($23.75 in chips) 
Seat 2: nvWCCH1JBjMjQkSaXl2Mog ($17.30 in chips) 
Seat 3: vSkQm2EelzwRGDDQQk0Fqw ($4.65 in chips) 
Seat 5: BEIBUu2pIflPrCL+Iks4CQ ($13.50 in chips) 
Seat 6: 1K6QGyJP9P9xmRac2fH4OQ ($25.35 in chips) 
Seat 7: 4oA316mXLIui1QY63GXBUg ($25 in chips) 
Seat 8: CYkY0dNBaYaKs8HVCVn3mQ ($5 in chips) 
Seat 9: DIBbjEYGs+TVdVgEB/4+3w ($29.35 in chips) 
DIBbjEYGs+TVdVgEB/4+3w: posts small blind $0.10
+sbyWwIcFp9kP0bDtMegfQ: posts big blind $0.25
*** HOLE CARDS ***
nvWCCH1JBjMjQkSaXl2Mog: calls $0.25
vSkQm2EelzwRGDDQQk0Fqw: folds 
BEIBUu2pIflPrCL+Iks4CQ: folds 
1K6QGyJP9P9xmRac2fH4OQ: folds 
4oA316mXLIui1QY63GXBUg: calls $0.25
CYkY0dNBaYaKs8HVCVn3mQ: raises $1.25 to $1.50
DIBbjEYGs+TVdVgEB/4+3w: folds 
+sbyWwIcFp9kP0bDtMegfQ: folds 
nvWCCH1JBjMjQkSaXl2Mog: folds 
4oA316mXLIui1QY63GXBUg: folds 
Uncalled bet ($1.25) returned to CYkY0dNBaYaKs8HVCVn3mQ
CYkY0dNBaYaKs8HVCVn3mQ collected $1.10 from pot
CYkY0dNBaYaKs8HVCVn3mQ: doesn't show hand 
stabil222 joins the table at seat #4 
*** SUMMARY ***
Total pot $1.10 | Rake $0 
Seat 1: +sbyWwIcFp9kP0bDtMegfQ (big blind) folded before Flop
Seat 2: nvWCCH1JBjMjQkSaXl2Mog folded before Flop
Seat 3: vSkQm2EelzwRGDDQQk0Fqw folded before Flop (didn't bet)
Seat 5: BEIBUu2pIflPrCL+Iks4CQ folded before Flop (didn't bet)
Seat 6: 1K6QGyJP9P9xmRac2fH4OQ folded before Flop (didn't bet)
Seat 7: 4oA316mXLIui1QY63GXBUg folded before Flop
Seat 8: CYkY0dNBaYaKs8HVCVn3mQ (button) collected ($1.10)
Seat 9: DIBbjEYGs+TVdVgEB/4+3w (small blind) folded before Flop




PokerStars Game #59939515394:  Hold'em No Limit ($0.10/$0.25) - 2009/07/01 0:41:52 ET
Table 'FBhJjLqab11/gKu8nyB/tw' 9-max Seat #6 is the button
Seat 1: +sbyWwIcFp9kP0bDtMegfQ ($21.80 in chips) 
Seat 2: 1pwQJV/Xr0GWPRefx/78VQ ($2.05 in chips) 
Seat 3: uy9x0X5l7O+IpGjLa77QgQ ($26.90 in chips) 
Seat 4: OTC1Bh+DhK778Qnsj6D8+A ($24.50 in chips) 
Seat 5: vZGoOTJLQLhkPj4I+LNGig ($45.40 in chips) 
Seat 6: QrNgXJWFdS+POsPJcil4aA ($19.50 in chips) 
Seat 7: 5Fj9JGGxQT7Djr6AyIiBVA ($25 in chips) 
Seat 8: 9lE3Zc4pjmKpQK8rDF1aaQ ($20.55 in chips) 
Seat 9: BEIBUu2pIflPrCL+Iks4CQ ($12.15 in chips) 
5Fj9JGGxQT7Djr6AyIiBVA: posts small blind $0.10
9lE3Zc4pjmKpQK8rDF1aaQ: posts big blind $0.25
*** HOLE CARDS ***
BEIBUu2pIflPrCL+Iks4CQ: folds 
+sbyWwIcFp9kP0bDtMegfQ: folds 
1pwQJV/Xr0GWPRefx/78VQ: folds 
uy9x0X5l7O+IpGjLa77QgQ: folds 
OTC1Bh+DhK778Qnsj6D8+A: folds 
vZGoOTJLQLhkPj4I+LNGig: raises $0.75 to $1
QrNgXJWFdS+POsPJcil4aA: folds 
5Fj9JGGxQT7Djr6AyIiBVA: folds 
9lE3Zc4pjmKpQK8rDF1aaQ: folds 
Uncalled bet ($0.75) returned to vZGoOTJLQLhkPj4I+LNGig
vZGoOTJLQLhkPj4I+LNGig collected $0.60 from pot
vZGoOTJLQLhkPj4I+LNGig: doesn't show hand 
*** SUMMARY ***
Total pot $0.60 | Rake $0 
Seat 1: +sbyWwIcFp9kP0bDtMegfQ folded before Flop (didn't bet)
Seat 2: 1pwQJV/Xr0GWPRefx/78VQ folded before Flop (didn't bet)
Seat 3: uy9x0X5l7O+IpGjLa77QgQ folded before Flop (didn't bet)
Seat 4: OTC1Bh+DhK778Qnsj6D8+A folded before Flop (didn't bet)
Seat 5: vZGoOTJLQLhkPj4I+LNGig collected ($0.60)
Seat 6: QrNgXJWFdS+POsPJcil4aA (button) folded before Flop (didn't bet)
Seat 7: 5Fj9JGGxQT7Djr6AyIiBVA (small blind) folded before Flop
Seat 8: 9lE3Zc4pjmKpQK8rDF1aaQ (big blind) folded before Flop
Seat 9: BEIBUu2pIflPrCL+Iks4CQ folded before Flop (didn't bet)




PokerStars Game #59939515406:  Hold'em No Limit ($0.10/$0.25) - 2009/07/01 0:41:52 ET
Table '+VTTYgQLH1awDHk+IAxqGg' 9-max Seat #4 is the button
Seat 1: s7Q6uNouhe7aE8JdFb9E+A ($25.60 in chips) 
Seat 2: 86vbuhJsyH+nbEg5qpDLyQ ($24.15 in chips) 
Seat 3: rSMoem/92WmnPjtw2tSQkA ($29.30 in chips) 
Seat 4: gE5rN2TDY1aXcZn/TOPeZw ($9.45 in chips) 
Seat 5: sD+TKtt36XiiN6jqHiLwDA ($25.70 in chips) 
Seat 6: gAlaEiNZy/H/QuIVwzvHAQ ($9.60 in chips) 
Seat 7: W4TLQcZ2TiM73eIgpIvlGg ($26.55 in chips) 
Seat 8: rg+23WZbUM/1tFGv4XhYYA ($4.50 in chips) 
Seat 9: CFZ+ACzShzC3naaIaOjbYQ ($7.65 in chips) 
sD+TKtt36XiiN6jqHiLwDA: posts small blind $0.10
gAlaEiNZy/H/QuIVwzvHAQ: posts big blind $0.25
*** HOLE CARDS ***
W4TLQcZ2TiM73eIgpIvlGg: calls $0.25
rg+23WZbUM/1tFGv4XhYYA: calls $0.25
CFZ+ACzShzC3naaIaOjbYQ: folds 
s7Q6uNouhe7aE8JdFb9E+A: folds 
86vbuhJsyH+nbEg5qpDLyQ: calls $0.25
rSMoem/92WmnPjtw2tSQkA: calls $0.25
gE5rN2TDY1aXcZn/TOPeZw: folds 
sD+TKtt36XiiN6jqHiLwDA: raises $1.25 to $1.50
gAlaEiNZy/H/QuIVwzvHAQ: calls $1.25
W4TLQcZ2TiM73eIgpIvlGg: folds 
rg+23WZbUM/1tFGv4XhYYA: raises $3 to $4.50 and is all-in
86vbuhJsyH+nbEg5qpDLyQ: folds 
rSMoem/92WmnPjtw2tSQkA: folds 
sD+TKtt36XiiN6jqHiLwDA: raises $21.20 to $25.70 and is all-in
gAlaEiNZy/H/QuIVwzvHAQ: calls $8.10 and is all-in
Uncalled bet ($16.10) returned to sD+TKtt36XiiN6jqHiLwDA
*** FLOP *** [4c 9h 2d]
*** TURN *** [4c 9h 2d] [Qs]
*** RIVER *** [4c 9h 2d Qs] [2s]
*** SHOW DOWN ***
sD+TKtt36XiiN6jqHiLwDA: shows [Jd Js] (two pair, Jacks and Deuces)
gAlaEiNZy/H/QuIVwzvHAQ: mucks hand 
sD+TKtt36XiiN6jqHiLwDA collected $9.70 from side pot
rg+23WZbUM/1tFGv4XhYYA: mucks hand 
gAlaEiNZy/H/QuIVwzvHAQ leaves the table
sD+TKtt36XiiN6jqHiLwDA collected $13.55 from main pot
*** SUMMARY ***
Total pot $24.45 Main pot $13.55. Side pot $9.70. | Rake $1.20 
Board [4c 9h 2d Qs 2s]
Seat 1: s7Q6uNouhe7aE8JdFb9E+A folded before Flop (didn't bet)
Seat 2: 86vbuhJsyH+nbEg5qpDLyQ folded before Flop
Seat 3: rSMoem/92WmnPjtw2tSQkA folded before Flop
Seat 4: gE5rN2TDY1aXcZn/TOPeZw (button) folded before Flop (didn't bet)
Seat 5: sD+TKtt36XiiN6jqHiLwDA (small blind) showed [Jd Js] and won ($23.25) with two pair, Jacks and Deuces
Seat 6: gAlaEiNZy/H/QuIVwzvHAQ (big blind) mucked
Seat 7: W4TLQcZ2TiM73eIgpIvlGg folded before Flop
Seat 8: rg+23WZbUM/1tFGv4XhYYA mucked
Seat 9: CFZ+ACzShzC3naaIaOjbYQ folded before Flop (didn't bet)




PokerStars Game #59939515746:  Hold'em No Limit ($0.10/$0.25) - 2009/07/01 0:41:53 ET
Table '+giHa6FUL6U5/AZnCJEGvQ' 9-max Seat #6 is the button
Seat 1: kYgmoJdHhyWAdwXflGZuKA ($35.80 in chips) 
Seat 2: YN6/TiJBEQVW8LDMQA1vFQ ($9.45 in chips) 
Seat 3: DIBbjEYGs+TVdVgEB/4+3w ($24.15 in chips) 
Seat 4: ljemhp25Zg+nlA9DLCIiUw ($50.10 in chips) 
Seat 5: zDrucyjVn5aeekNEc3cJrA ($47.15 in chips) 
Seat 6: cZ99hugmLBj9KhTlc8nCSw ($25 in chips) 
Seat 7: TeWJxSETzbXGiYKx0y+dtg ($24.30 in chips) 
Seat 8: t2nb95S5EEFOEzNx9Itz0g ($2.60 in chips) 
Seat 9: qwr38jl5txoR36M7G5qi4A ($7.50 in chips) 
TeWJxSETzbXGiYKx0y+dtg: posts small blind $0.10
t2nb95S5EEFOEzNx9Itz0g: posts big blind $0.25
*** HOLE CARDS ***
qwr38jl5txoR36M7G5qi4A: folds 
kYgmoJdHhyWAdwXflGZuKA: calls $0.25
YN6/TiJBEQVW8LDMQA1vFQ: calls $0.25
DIBbjEYGs+TVdVgEB/4+3w: folds 
ljemhp25Zg+nlA9DLCIiUw: folds 
zDrucyjVn5aeekNEc3cJrA: folds 
cZ99hugmLBj9KhTlc8nCSw: raises $1 to $1.25
TeWJxSETzbXGiYKx0y+dtg: folds 
t2nb95S5EEFOEzNx9Itz0g: folds 
kYgmoJdHhyWAdwXflGZuKA: folds 
YN6/TiJBEQVW8LDMQA1vFQ: folds 
Uncalled bet ($1) returned to cZ99hugmLBj9KhTlc8nCSw
cZ99hugmLBj9KhTlc8nCSw collected $1.10 from pot
*** SUMMARY ***
Total pot $1.10 | Rake $0 
Seat 1: kYgmoJdHhyWAdwXflGZuKA folded before Flop
Seat 2: YN6/TiJBEQVW8LDMQA1vFQ folded before Flop
Seat 3: DIBbjEYGs+TVdVgEB/4+3w folded before Flop (didn't bet)
Seat 4: ljemhp25Zg+nlA9DLCIiUw folded before Flop (didn't bet)
Seat 5: zDrucyjVn5aeekNEc3cJrA folded before Flop (didn't bet)
Seat 6: cZ99hugmLBj9KhTlc8nCSw (button) collected ($1.10)
Seat 7: TeWJxSETzbXGiYKx0y+dtg (small blind) folded before Flop
Seat 8: t2nb95S5EEFOEzNx9Itz0g (big blind) folded before Flop
Seat 9: qwr38jl5txoR36M7G5qi4A folded before Flop (didn't bet)




PokerStars Game #59939515532:  Hold'em No Limit ($0.10/$0.25) - 2009/07/01 0:41:53 ET
Table 'ZEXL6Wh4qA4Afx8NnoBBAA' 6-max Seat #6 is the button
Seat 1: qo39V8/pMxxofM2aciLSWQ ($95.35 in chips) 
Seat 2: WrLI51S2iMb8GLMB83gGqA ($25 in chips) 
Seat 4: fZQg9veL7Dd/Z04ZTjC+wQ ($31.90 in chips) 
Seat 6: 3rZnxe2K3O+xcVdF94i8lA ($15.80 in chips) 
qo39V8/pMxxofM2aciLSWQ: posts small blind $0.10
WrLI51S2iMb8GLMB83gGqA: posts big blind $0.25
*** HOLE CARDS ***
fZQg9veL7Dd/Z04ZTjC+wQ: folds 
3rZnxe2K3O+xcVdF94i8lA: raises $0.50 to $0.75
qo39V8/pMxxofM2aciLSWQ: folds 
WrLI51S2iMb8GLMB83gGqA: folds 
Uncalled bet ($0.50) returned to 3rZnxe2K3O+xcVdF94i8lA
3rZnxe2K3O+xcVdF94i8lA collected $0.60 from pot
*** SUMMARY ***
Total pot $0.60 | Rake $0 
Seat 1: qo39V8/pMxxofM2aciLSWQ (small blind) folded before Flop
Seat 2: WrLI51S2iMb8GLMB83gGqA (big blind) folded before Flop
Seat 4: fZQg9veL7Dd/Z04ZTjC+wQ folded before Flop (didn't bet)
Seat 6: 3rZnxe2K3O+xcVdF94i8lA (button) collected ($0.60)




PokerStars Game #59939515782:  Hold'em No Limit ($0.10/$0.25) - 2009/07/01 0:41:53 ET
Table '5SUMWYuPsGiOD0FY0QbgOw' 6-max Seat #3 is the button
Seat 1: pq78iqNUnoL9mPwPKXxOzg ($14.30 in chips) 
Seat 2: wKFJ513ucluNNiMlkXcDOQ ($25 in chips) 
Seat 3: JUE7yMMP0aN5jzhYbdqO6Q ($29.95 in chips) 
Seat 4: hln5cQA1YXs/ERC2LEyoSA ($11.50 in chips) 
Seat 5: v+QfkGiuj9bgtuNoVnDO8w ($28.70 in chips) 
Seat 6: jA7YMtfNUnAaebB7Lj74EA ($24.20 in chips) 
hln5cQA1YXs/ERC2LEyoSA: posts small blind $0.10
v+QfkGiuj9bgtuNoVnDO8w: posts big blind $0.25
*** HOLE CARDS ***
jA7YMtfNUnAaebB7Lj74EA: calls $0.25
pq78iqNUnoL9mPwPKXxOzg: calls $0.25
wKFJ513ucluNNiMlkXcDOQ: folds 
JUE7yMMP0aN5jzhYbdqO6Q: folds 
hln5cQA1YXs/ERC2LEyoSA: folds 
v+QfkGiuj9bgtuNoVnDO8w: checks 
*** FLOP *** [6d 5c Ks]
v+QfkGiuj9bgtuNoVnDO8w: checks 
jA7YMtfNUnAaebB7Lj74EA: checks 
pq78iqNUnoL9mPwPKXxOzg: checks 
*** TURN *** [6d 5c Ks] [3h]
v+QfkGiuj9bgtuNoVnDO8w: checks 
jA7YMtfNUnAaebB7Lj74EA: checks 
pq78iqNUnoL9mPwPKXxOzg: checks 
*** RIVER *** [6d 5c Ks 3h] [6s]
v+QfkGiuj9bgtuNoVnDO8w: bets $0.50
jA7YMtfNUnAaebB7Lj74EA: folds 
pq78iqNUnoL9mPwPKXxOzg: calls $0.50
*** SHOW DOWN ***
v+QfkGiuj9bgtuNoVnDO8w: shows [Js 6h] (three of a kind, Sixes)
pq78iqNUnoL9mPwPKXxOzg: mucks hand 
v+QfkGiuj9bgtuNoVnDO8w collected $1.80 from pot
*** SUMMARY ***
Total pot $1.85 | Rake $0.05 
Board [6d 5c Ks 3h 6s]
Seat 1: pq78iqNUnoL9mPwPKXxOzg mucked
Seat 2: wKFJ513ucluNNiMlkXcDOQ folded before Flop (didn't bet)
Seat 3: JUE7yMMP0aN5jzhYbdqO6Q (button) folded before Flop (didn't bet)
Seat 4: hln5cQA1YXs/ERC2LEyoSA (small blind) folded before Flop
Seat 5: v+QfkGiuj9bgtuNoVnDO8w (big blind) showed [Js 6h] and won ($1.80) with three of a kind, Sixes
Seat 6: jA7YMtfNUnAaebB7Lj74EA folded on the River




PokerStars Game #59939515498:  Hold'em No Limit ($0.10/$0.25) - 2009/07/01 0:41:53 ET
Table 'FE/j6VqBY4j9Uq+VHURQCQ' 6-max Seat #3 is the button
Seat 1: wKFJ513ucluNNiMlkXcDOQ ($43.75 in chips) 
Seat 2: 3zD3qLXT1bEffAoWGnc7wg ($25 in chips) 
Seat 3: Zijzy/UtPWzWVUo81HHVjQ ($51.50 in chips) 
Seat 4: cPO/1/dTcZpLkQFm3jH3Rg ($25.10 in chips) 
Seat 5: wsP46AGpqDjHZQmlRHKa9g ($25.35 in chips) 
Seat 6: kARKwAmU6kWJfiSICTYhVw ($12.80 in chips) 
cPO/1/dTcZpLkQFm3jH3Rg: posts small blind $0.10
wsP46AGpqDjHZQmlRHKa9g: posts big blind $0.25
*** HOLE CARDS ***
kARKwAmU6kWJfiSICTYhVw: folds 
wKFJ513ucluNNiMlkXcDOQ: folds 
3zD3qLXT1bEffAoWGnc7wg: raises $0.50 to $0.75
Zijzy/UtPWzWVUo81HHVjQ: calls $0.75
cPO/1/dTcZpLkQFm3jH3Rg: folds 
wsP46AGpqDjHZQmlRHKa9g: folds 
*** FLOP *** [8d 9c 2d]
3zD3qLXT1bEffAoWGnc7wg: bets $1.25
Zijzy/UtPWzWVUo81HHVjQ: calls $1.25
*** TURN *** [8d 9c 2d] [As]
3zD3qLXT1bEffAoWGnc7wg: checks 
Zijzy/UtPWzWVUo81HHVjQ: checks 
*** RIVER *** [8d 9c 2d As] [Jd]
3zD3qLXT1bEffAoWGnc7wg: bets $2
Zijzy/UtPWzWVUo81HHVjQ: folds 
Uncalled bet ($2) returned to 3zD3qLXT1bEffAoWGnc7wg
3zD3qLXT1bEffAoWGnc7wg collected $4.15 from pot
3zD3qLXT1bEffAoWGnc7wg: doesn't show hand 
*** SUMMARY ***
Total pot $4.35 | Rake $0.20 
Board [8d 9c 2d As Jd]
Seat 1: wKFJ513ucluNNiMlkXcDOQ folded before Flop (didn't bet)
Seat 2: 3zD3qLXT1bEffAoWGnc7wg collected ($4.15)
Seat 3: Zijzy/UtPWzWVUo81HHVjQ (button) folded on the River
Seat 4: cPO/1/dTcZpLkQFm3jH3Rg (small blind) folded before Flop
Seat 5: wsP46AGpqDjHZQmlRHKa9g (big blind) folded before Flop
Seat 6: kARKwAmU6kWJfiSICTYhVw folded before Flop (didn't bet)




PokerStars Game #59939515796:  Hold'em No Limit ($0.10/$0.25) - 2009/07/01 0:41:53 ET
Table '5NipxzzFB2DffzDpddyQoQ' 6-max Seat #4 is the button
Seat 1: TslQs7AQSLbVtr4X8JOOOQ ($11.60 in chips) 
Seat 2: jxrNE4qd8KCOIqHjQcwCrA ($42.50 in chips) 
Seat 3: qGHGf/553gQnDoklMRe3tg ($49.05 in chips) 
Seat 4: Inq44d7PQ+8TbEKfPeuxVQ ($4.10 in chips) 
Seat 5: cS21pIxRHx5Gt42o7hPZzw ($13.30 in chips) 
Seat 6: lYjWCpfCxX2kgcHY3v4Yow ($27.65 in chips) 
cS21pIxRHx5Gt42o7hPZzw: posts small blind $0.10
lYjWCpfCxX2kgcHY3v4Yow: posts big blind $0.25
*** HOLE CARDS ***
TslQs7AQSLbVtr4X8JOOOQ: calls $0.25
jxrNE4qd8KCOIqHjQcwCrA: folds 
qGHGf/553gQnDoklMRe3tg: folds 
Inq44d7PQ+8TbEKfPeuxVQ: folds 
cS21pIxRHx5Gt42o7hPZzw: calls $0.15
lYjWCpfCxX2kgcHY3v4Yow: checks 
*** FLOP *** [8d Ah 8h]
cS21pIxRHx5Gt42o7hPZzw: checks 
lYjWCpfCxX2kgcHY3v4Yow: checks 
TslQs7AQSLbVtr4X8JOOOQ: bets $0.75
cS21pIxRHx5Gt42o7hPZzw: calls $0.75
lYjWCpfCxX2kgcHY3v4Yow: calls $0.75
*** TURN *** [8d Ah 8h] [3h]
cS21pIxRHx5Gt42o7hPZzw: checks 
lYjWCpfCxX2kgcHY3v4Yow: checks 
TslQs7AQSLbVtr4X8JOOOQ: bets $2.50
cS21pIxRHx5Gt42o7hPZzw: calls $2.50
lYjWCpfCxX2kgcHY3v4Yow: folds 
*** RIVER *** [8d Ah 8h 3h] [7d]
cS21pIxRHx5Gt42o7hPZzw: checks 
TslQs7AQSLbVtr4X8JOOOQ: bets $3
cS21pIxRHx5Gt42o7hPZzw: calls $3
*** SHOW DOWN ***
TslQs7AQSLbVtr4X8JOOOQ: shows [Kh 7h] (a flush, Ace high)
cS21pIxRHx5Gt42o7hPZzw: mucks hand 
TslQs7AQSLbVtr4X8JOOOQ collected $13.35 from pot
*** SUMMARY ***
Total pot $14 | Rake $0.65 
Board [8d Ah 8h 3h 7d]
Seat 1: TslQs7AQSLbVtr4X8JOOOQ showed [Kh 7h] and won ($13.35) with a flush, Ace high
Seat 2: jxrNE4qd8KCOIqHjQcwCrA folded before Flop (didn't bet)
Seat 3: qGHGf/553gQnDoklMRe3tg folded before Flop (didn't bet)
Seat 4: Inq44d7PQ+8TbEKfPeuxVQ (button) folded before Flop (didn't bet)
Seat 5: cS21pIxRHx5Gt42o7hPZzw (small blind) mucked
Seat 6: lYjWCpfCxX2kgcHY3v4Yow (big blind) folded on the Turn




PokerStars Game #59939515744:  Hold'em No Limit ($0.10/$0.25) - 2009/07/01 0:41:53 ET
Table 'IRgQPZVA4+IaZZIQshgwyg' 6-max Seat #3 is the button
Seat 1: d0J1xuhsynEY81YHwAvJ5g ($25 in chips) 
Seat 2: 9jSiy0meE9XJKkdIZwyTEQ ($35.45 in chips) 
Seat 3: 8EEqTTh7T1q48sYDqbI2Xg ($26.65 in chips) 
Seat 4: PXXRy0uk7WED5BEf+ReJDQ ($14.90 in chips) 
Seat 5: PbMzPZIePKifKQZfKDkbIw ($27.35 in chips) 
Seat 6: qo39V8/pMxxofM2aciLSWQ ($37.85 in chips) 
PXXRy0uk7WED5BEf+ReJDQ: posts small blind $0.10
PbMzPZIePKifKQZfKDkbIw: posts big blind $0.25
*** HOLE CARDS ***
qo39V8/pMxxofM2aciLSWQ: folds 
d0J1xuhsynEY81YHwAvJ5g: folds 
9jSiy0meE9XJKkdIZwyTEQ: folds 
8EEqTTh7T1q48sYDqbI2Xg: folds 
PXXRy0uk7WED5BEf+ReJDQ: calls $0.15
PbMzPZIePKifKQZfKDkbIw: checks 
*** FLOP *** [Ac 2d 6d]
PXXRy0uk7WED5BEf+ReJDQ: checks 
PbMzPZIePKifKQZfKDkbIw: bets $0.50
PXXRy0uk7WED5BEf+ReJDQ: calls $0.50
*** TURN *** [Ac 2d 6d] [Tc]
PXXRy0uk7WED5BEf+ReJDQ: checks 
PbMzPZIePKifKQZfKDkbIw: bets $1.25
PXXRy0uk7WED5BEf+ReJDQ: folds 
Uncalled bet ($1.25) returned to PbMzPZIePKifKQZfKDkbIw
PbMzPZIePKifKQZfKDkbIw collected $1.45 from pot
*** SUMMARY ***
Total pot $1.50 | Rake $0.05 
Board [Ac 2d 6d Tc]
Seat 1: d0J1xuhsynEY81YHwAvJ5g folded before Flop (didn't bet)
Seat 2: 9jSiy0meE9XJKkdIZwyTEQ folded before Flop (didn't bet)
Seat 3: 8EEqTTh7T1q48sYDqbI2Xg (button) folded before Flop (didn't bet)
Seat 4: PXXRy0uk7WED5BEf+ReJDQ (small blind) folded on the Turn
Seat 5: PbMzPZIePKifKQZfKDkbIw (big blind) collected ($1.45)
Seat 6: qo39V8/pMxxofM2aciLSWQ folded before Flop (didn't bet)




PokerStars Game #59939516060:  Hold'em No Limit ($0.10/$0.25) - 2009/07/01 0:41:53 ET
Table '50f2Xa1b1jp6cfdTAgXFIg' 9-max Seat #9 is the button
Seat 1: JwUqpgqGHS96sdpExhhEqw ($7.85 in chips) 
Seat 4: ghNKXUBl/H+t83JF079ZBA ($29.60 in chips) 
Seat 5: OlPJsgR4xypSg/w1z7Gyvw ($55.50 in chips) 
Seat 6: Vl8zO7J9ZOnk8Og8eXFezg ($40.40 in chips) 
Seat 7: TeWJxSETzbXGiYKx0y+dtg ($25.80 in chips) 
Seat 8: jeKWRUkMaVn8rEUjnJKqpg ($25 in chips) 
Seat 9: gehe91e0IyVT0QU/XBkEyg ($25 in chips) 
JwUqpgqGHS96sdpExhhEqw: posts small blind $0.10
OfGfQFPcghysTDljS9GQSQ: is sitting out 
aZHZRdpOTHSm1zLmzd6+ww: is sitting out 
ghNKXUBl/H+t83JF079ZBA: posts big blind $0.25
*** HOLE CARDS ***
OlPJsgR4xypSg/w1z7Gyvw: raises $0.75 to $1
Vl8zO7J9ZOnk8Og8eXFezg: folds 
aZHZRdpOTHSm1zLmzd6+ww leaves the table
jeKWRUkMaVn8rEUjnJKqpg said, "rofl"
TeWJxSETzbXGiYKx0y+dtg: folds 
jeKWRUkMaVn8rEUjnJKqpg: folds 
OfGfQFPcghysTDljS9GQSQ leaves the table
gehe91e0IyVT0QU/XBkEyg: calls $1
JwUqpgqGHS96sdpExhhEqw: folds 
GQTWTgG7Ydy9q/vohVnKmQ joins the table at seat #3 
ghNKXUBl/H+t83JF079ZBA: calls $0.75
*** FLOP *** [Ks 7s Th]
ghNKXUBl/H+t83JF079ZBA: checks 
F7pnn6czNpHvRM55XcA2EA joins the table at seat #2 
OlPJsgR4xypSg/w1z7Gyvw: bets $1
gehe91e0IyVT0QU/XBkEyg: calls $1
ghNKXUBl/H+t83JF079ZBA: folds 
*** TURN *** [Ks 7s Th] [2c]
OlPJsgR4xypSg/w1z7Gyvw: checks 
gehe91e0IyVT0QU/XBkEyg: bets $2.50
OlPJsgR4xypSg/w1z7Gyvw: folds 
Uncalled bet ($2.50) returned to gehe91e0IyVT0QU/XBkEyg
gehe91e0IyVT0QU/XBkEyg collected $4.90 from pot
*** SUMMARY ***
Total pot $5.10 | Rake $0.20 
Board [Ks 7s Th 2c]
Seat 1: JwUqpgqGHS96sdpExhhEqw (small blind) folded before Flop
Seat 4: ghNKXUBl/H+t83JF079ZBA (big blind) folded on the Flop
Seat 5: OlPJsgR4xypSg/w1z7Gyvw folded on the Turn
Seat 6: Vl8zO7J9ZOnk8Og8eXFezg folded before Flop (didn't bet)
Seat 7: TeWJxSETzbXGiYKx0y+dtg folded before Flop (didn't bet)
Seat 8: jeKWRUkMaVn8rEUjnJKqpg folded before Flop (didn't bet)
Seat 9: gehe91e0IyVT0QU/XBkEyg (button) collected ($4.90)




PokerStars Game #59939515706:  Hold'em No Limit ($0.10/$0.25) - 2009/07/01 0:41:53 ET
Table 'M8kYidAX3ib7pLKW7edFLw' 6-max Seat #4 is the button
Seat 3: q+Sip/IIcvzqgZt1pJAWTw ($7.90 in chips) 
Seat 4: /bjna2FTN7pPjqYGzmDE0Q ($25.55 in chips) 
Seat 5: bDKopKTvPi3W+PEnYUX3tg ($26.10 in chips) 
bDKopKTvPi3W+PEnYUX3tg: posts small blind $0.10
4YSTu0Cdzpppe1lUgCZGCQ: is sitting out 
q+Sip/IIcvzqgZt1pJAWTw: posts big blind $0.25
*** HOLE CARDS ***
/bjna2FTN7pPjqYGzmDE0Q: calls $0.25
bDKopKTvPi3W+PEnYUX3tg: calls $0.15
q+Sip/IIcvzqgZt1pJAWTw: checks 
*** FLOP *** [5d Ts 4h]
bDKopKTvPi3W+PEnYUX3tg: checks 
q+Sip/IIcvzqgZt1pJAWTw: checks 
4YSTu0Cdzpppe1lUgCZGCQ leaves the table
/bjna2FTN7pPjqYGzmDE0Q: bets $0.50
bDKopKTvPi3W+PEnYUX3tg: calls $0.50
q+Sip/IIcvzqgZt1pJAWTw: calls $0.50
*** TURN *** [5d Ts 4h] [4s]
bDKopKTvPi3W+PEnYUX3tg: checks 
q+Sip/IIcvzqgZt1pJAWTw: checks 
/bjna2FTN7pPjqYGzmDE0Q: checks 
*** RIVER *** [5d Ts 4h 4s] [2s]
bDKopKTvPi3W+PEnYUX3tg: checks 
q+Sip/IIcvzqgZt1pJAWTw: bets $0.50
chet188 joins the table at seat #2 
/bjna2FTN7pPjqYGzmDE0Q: folds 
bDKopKTvPi3W+PEnYUX3tg: folds 
Uncalled bet ($0.50) returned to q+Sip/IIcvzqgZt1pJAWTw
q+Sip/IIcvzqgZt1pJAWTw collected $2.15 from pot
q+Sip/IIcvzqgZt1pJAWTw: doesn't show hand 
*** SUMMARY ***
Total pot $2.25 | Rake $0.10 
Board [5d Ts 4h 4s 2s]
Seat 3: q+Sip/IIcvzqgZt1pJAWTw (big blind) collected ($2.15)
Seat 4: /bjna2FTN7pPjqYGzmDE0Q (button) folded on the River
Seat 5: bDKopKTvPi3W+PEnYUX3tg (small blind) folded on the River




PokerStars Game #59939515436:  Hold'em No Limit ($0.10/$0.25) - 2009/07/01 0:41:53 ET
Table '3Ns9nuTkynfwbBfBXzg6ww' 6-max Seat #3 is the button
Seat 3: HyXsCmHsOHAlL2pzZ9IYAg ($8.20 in chips) 
Seat 5: kBQU/db00TVAMeomlhblPg ($19.75 in chips) 
Seat 6: ZZm/rg8aThjE+A2LiItuzA ($8 in chips) 
kBQU/db00TVAMeomlhblPg: posts small blind $0.10
ZZm/rg8aThjE+A2LiItuzA: posts big blind $0.25
*** HOLE CARDS ***
HyXsCmHsOHAlL2pzZ9IYAg: calls $0.25
kBQU/db00TVAMeomlhblPg: calls $0.15
ZZm/rg8aThjE+A2LiItuzA: checks 
*** FLOP *** [5s Td 7s]
kBQU/db00TVAMeomlhblPg: checks 
ZZm/rg8aThjE+A2LiItuzA: bets $0.75
HyXsCmHsOHAlL2pzZ9IYAg: calls $0.75
kBQU/db00TVAMeomlhblPg: folds 
*** TURN *** [5s Td 7s] [6d]
ZZm/rg8aThjE+A2LiItuzA: bets $1.25
HyXsCmHsOHAlL2pzZ9IYAg: calls $1.25
*** RIVER *** [5s Td 7s 6d] [6s]
ZZm/rg8aThjE+A2LiItuzA: checks 
HyXsCmHsOHAlL2pzZ9IYAg: checks 
*** SHOW DOWN ***
ZZm/rg8aThjE+A2LiItuzA: shows [8h 5c] (two pair, Sixes and Fives)
HyXsCmHsOHAlL2pzZ9IYAg: mucks hand 
ZZm/rg8aThjE+A2LiItuzA collected $4.55 from pot
*** SUMMARY ***
Total pot $4.75 | Rake $0.20 
Board [5s Td 7s 6d 6s]
Seat 3: HyXsCmHsOHAlL2pzZ9IYAg (button) mucked
Seat 5: kBQU/db00TVAMeomlhblPg (small blind) folded on the Flop
Seat 6: ZZm/rg8aThjE+A2LiItuzA (big blind) showed [8h 5c] and won ($4.55) with two pair, Sixes and Fives




PokerStars Game #59939515574:  Hold'em No Limit ($0.10/$0.25) - 2009/07/01 0:41:53 ET
Table 'ORSZkZqq+7Ja2PdeCFAytA' 9-max Seat #3 is the button
Seat 1: Gpa8cld5y0mdOomHJgHhlA ($7.75 in chips) 
Seat 2: yduPKWPzL8YlT5Zv/Nmrwg ($11.30 in chips) 
Seat 3: nm4Dj/f+jJEwKVsUnKh73g ($24.40 in chips) 
Gpa8cld5y0mdOomHJgHhlA: posts small blind $0.10
yduPKWPzL8YlT5Zv/Nmrwg: posts big blind $0.25
*** HOLE CARDS ***
fOv1xoqR8m9slwElVu7Y+A joins the table at seat #5 
nm4Dj/f+jJEwKVsUnKh73g: folds 
Gpa8cld5y0mdOomHJgHhlA: calls $0.15
yduPKWPzL8YlT5Zv/Nmrwg: raises $11.05 to $11.30 and is all-in
nm4Dj/f+jJEwKVsUnKh73g leaves the table
Gpa8cld5y0mdOomHJgHhlA: folds 
Uncalled bet ($11.05) returned to yduPKWPzL8YlT5Zv/Nmrwg
yduPKWPzL8YlT5Zv/Nmrwg collected $0.50 from pot
*** SUMMARY ***
Total pot $0.50 | Rake $0 
Seat 1: Gpa8cld5y0mdOomHJgHhlA (small blind) folded before Flop
Seat 2: yduPKWPzL8YlT5Zv/Nmrwg (big blind) collected ($0.50)
Seat 3: nm4Dj/f+jJEwKVsUnKh73g (button) folded before Flop (didn't bet)




PokerStars Game #59939516092:  Hold'em No Limit ($0.10/$0.25) - 2009/07/01 0:41:54 ET
Table 'f9j+4UOgRPXbyNbQkZFm4w' 6-max Seat #1 is the button
Seat 1: trN/oHqTTbPw5MNuKrOpLw ($30.50 in chips) 
Seat 3: wCBHaebpIJ2ZTqigoRi9DA ($22.45 in chips) 
Seat 4: hiTEr3yrERiQp3zHXRioVw ($21.75 in chips) 
Seat 5: 1lxYIAoJdZwAbzIkzWmSkw ($6.60 in chips) 
Seat 6: C84t1kUtjDF/zm38/Dpcng ($13.15 in chips) 
VHBox3ZuV+/MP3dz2hFEBQ will be allowed to play after the button
wCBHaebpIJ2ZTqigoRi9DA: posts small blind $0.10
hiTEr3yrERiQp3zHXRioVw: posts big blind $0.25
*** HOLE CARDS ***
1lxYIAoJdZwAbzIkzWmSkw: folds 
C84t1kUtjDF/zm38/Dpcng: calls $0.25
trN/oHqTTbPw5MNuKrOpLw: folds 
wCBHaebpIJ2ZTqigoRi9DA: calls $0.15
hiTEr3yrERiQp3zHXRioVw: checks 
*** FLOP *** [4s 2d As]
wCBHaebpIJ2ZTqigoRi9DA: checks 
hiTEr3yrERiQp3zHXRioVw: checks 
C84t1kUtjDF/zm38/Dpcng: bets $1
wCBHaebpIJ2ZTqigoRi9DA: folds 
hiTEr3yrERiQp3zHXRioVw: folds 
Uncalled bet ($1) returned to C84t1kUtjDF/zm38/Dpcng
C84t1kUtjDF/zm38/Dpcng collected $0.75 from pot
*** SUMMARY ***
Total pot $0.75 | Rake $0 
Board [4s 2d As]
Seat 1: trN/oHqTTbPw5MNuKrOpLw (button) folded before Flop (didn't bet)
Seat 3: wCBHaebpIJ2ZTqigoRi9DA (small blind) folded on the Flop
Seat 4: hiTEr3yrERiQp3zHXRioVw (big blind) folded on the Flop
Seat 5: 1lxYIAoJdZwAbzIkzWmSkw folded before Flop (didn't bet)
Seat 6: C84t1kUtjDF/zm38/Dpcng collected ($0.75)




PokerStars Game #59939516326:  Hold'em No Limit ($0.10/$0.25) - 2009/07/01 0:41:54 ET
Table 'C8mMnVmvkagwolEzTvh07A' 9-max Seat #9 is the button
Seat 1: t2nb95S5EEFOEzNx9Itz0g ($5.10 in chips) 
Seat 2: CbXUS6Z2rXZxL1AKduNtmQ ($30.10 in chips) 
Seat 3: Th3FldXKQW6hWVVPahaoOQ ($25.35 in chips) 
Seat 4: dfNim92Z6XK1/h5SFW5vDg ($25 in chips) 
Seat 5: iGMlK+EhUflPB6jKQd95Cg ($25 in chips) 
Seat 8: N6fYvIzQLKaydFLKQGtMlQ ($22.55 in chips) 
Seat 9: 4awUyiDYTgylQKXZ9faBVA ($26.60 in chips) 
t2nb95S5EEFOEzNx9Itz0g: posts small blind $0.10
CbXUS6Z2rXZxL1AKduNtmQ: posts big blind $0.25
*** HOLE CARDS ***
Th3FldXKQW6hWVVPahaoOQ: folds 
qmEgnPhQt24xdw/ZRVPLbA has returned
dfNim92Z6XK1/h5SFW5vDg: folds 
iGMlK+EhUflPB6jKQd95Cg: folds 
N6fYvIzQLKaydFLKQGtMlQ: folds 
4awUyiDYTgylQKXZ9faBVA: folds 
t2nb95S5EEFOEzNx9Itz0g: folds 
Uncalled bet ($0.15) returned to CbXUS6Z2rXZxL1AKduNtmQ
CbXUS6Z2rXZxL1AKduNtmQ collected $0.20 from pot
CbXUS6Z2rXZxL1AKduNtmQ: doesn't show hand 
*** SUMMARY ***
Total pot $0.20 | Rake $0 
Seat 1: t2nb95S5EEFOEzNx9Itz0g (small blind) folded before Flop
Seat 2: CbXUS6Z2rXZxL1AKduNtmQ (big blind) collected ($0.20)
Seat 3: Th3FldXKQW6hWVVPahaoOQ folded before Flop (didn't bet)
Seat 4: dfNim92Z6XK1/h5SFW5vDg folded before Flop (didn't bet)
Seat 5: iGMlK+EhUflPB6jKQd95Cg folded before Flop (didn't bet)
Seat 8: N6fYvIzQLKaydFLKQGtMlQ folded before Flop (didn't bet)
Seat 9: 4awUyiDYTgylQKXZ9faBVA (button) folded before Flop (didn't bet)




PokerStars Game #59939516610:  Hold'em No Limit ($0.10/$0.25) - 2009/07/01 0:41:54 ET
Table 'QzXakDK7ZHNjgIpoUFGSKQ' 9-max Seat #3 is the button
Seat 1: vZGoOTJLQLhkPj4I+LNGig ($25 in chips) 
Seat 2: HVKi9hnDyvzObpL08/OarQ ($23.55 in chips) 
Seat 3: E4pjUoTJmJNmancGXn1nSw ($18.95 in chips) 
Seat 4: Yv4fucyyT28mjx8V5lxKJg ($23 in chips) 
Seat 6: c7sk/W5UhCTyhjXh5MT/eg ($11 in chips) 
Seat 7: zUPSsmVPAK0z0iGmEx7WbA ($9.80 in chips) 
Seat 8: HXf7T9U74NXM5C+iMg8Cbg ($6.35 in chips) 
Yv4fucyyT28mjx8V5lxKJg: posts small blind $0.10
c7sk/W5UhCTyhjXh5MT/eg: posts big blind $0.25
vnCdP3GsLTKadDukKcJk/Q: sits out 
*** HOLE CARDS ***
zUPSsmVPAK0z0iGmEx7WbA: folds 
HXf7T9U74NXM5C+iMg8Cbg: folds 
HXf7T9U74NXM5C+iMg8Cbg leaves the table
vZGoOTJLQLhkPj4I+LNGig: folds 
HVKi9hnDyvzObpL08/OarQ: folds 
E4pjUoTJmJNmancGXn1nSw: folds 
Yv4fucyyT28mjx8V5lxKJg: folds 
Uncalled bet ($0.15) returned to c7sk/W5UhCTyhjXh5MT/eg
c7sk/W5UhCTyhjXh5MT/eg collected $0.20 from pot
c7sk/W5UhCTyhjXh5MT/eg: doesn't show hand 
*** SUMMARY ***
Total pot $0.20 | Rake $0 
Seat 1: vZGoOTJLQLhkPj4I+LNGig folded before Flop (didn't bet)
Seat 2: HVKi9hnDyvzObpL08/OarQ folded before Flop (didn't bet)
Seat 3: E4pjUoTJmJNmancGXn1nSw (button) folded before Flop (didn't bet)
Seat 4: Yv4fucyyT28mjx8V5lxKJg (small blind) folded before Flop
Seat 6: c7sk/W5UhCTyhjXh5MT/eg (big blind) collected ($0.20)
Seat 7: zUPSsmVPAK0z0iGmEx7WbA folded before Flop (didn't bet)
Seat 8: HXf7T9U74NXM5C+iMg8Cbg folded before Flop (didn't bet)




PokerStars Game #59939516212:  Hold'em No Limit ($0.10/$0.25) - 2009/07/01 0:41:54 ET
Table 'jxoHy9yJy0bbH/Qx73FoPA' 9-max Seat #8 is the button
Seat 1: jN7A9nKK4RYzhFj4MrekhA ($14.85 in chips) 
Seat 3: /DYYmfrw4B9z+N2z81dNtA ($22.20 in chips) 
Seat 4: RJ/x9oZtt1RZLaJEQwZOxQ ($26.90 in chips) 
Seat 5: vO3QVRovWemcGMkm7ijAIA ($3.80 in chips) 
Seat 6: tYsOBqdU1+x+yFI7zHO7hQ ($51.90 in chips) 
Seat 7: HhlCy99+up/IQbbuxF6uXg ($8.45 in chips) 
Seat 8: hBMUlEpyU74r/fwDgIpXjQ ($30.25 in chips) 
Seat 9: IG1d4tXnNA98OKRYYE3l+A ($53.70 in chips) 
IG1d4tXnNA98OKRYYE3l+A: posts small blind $0.10
jN7A9nKK4RYzhFj4MrekhA: posts big blind $0.25
F7pnn6czNpHvRM55XcA2EA: sits out 
*** HOLE CARDS ***
/DYYmfrw4B9z+N2z81dNtA: folds 
RJ/x9oZtt1RZLaJEQwZOxQ: folds 
vO3QVRovWemcGMkm7ijAIA: raises $0.75 to $1
tYsOBqdU1+x+yFI7zHO7hQ: folds 
HhlCy99+up/IQbbuxF6uXg: folds 
hBMUlEpyU74r/fwDgIpXjQ: raises $2 to $3
IG1d4tXnNA98OKRYYE3l+A: folds 
jN7A9nKK4RYzhFj4MrekhA: folds 
vO3QVRovWemcGMkm7ijAIA: raises $0.80 to $3.80 and is all-in
hBMUlEpyU74r/fwDgIpXjQ: calls $0.80
*** FLOP *** [9c 3d 5s]
*** TURN *** [9c 3d 5s] [Qd]
*** RIVER *** [9c 3d 5s Qd] [9d]
*** SHOW DOWN ***
vO3QVRovWemcGMkm7ijAIA: shows [Jc Ac] (a pair of Nines)
hBMUlEpyU74r/fwDgIpXjQ: shows [Td Th] (two pair, Tens and Nines)
hBMUlEpyU74r/fwDgIpXjQ collected $7.60 from pot
*** SUMMARY ***
Total pot $7.95 | Rake $0.35 
Board [9c 3d 5s Qd 9d]
Seat 1: jN7A9nKK4RYzhFj4MrekhA (big blind) folded before Flop
Seat 3: /DYYmfrw4B9z+N2z81dNtA folded before Flop (didn't bet)
Seat 4: RJ/x9oZtt1RZLaJEQwZOxQ folded before Flop (didn't bet)
Seat 5: vO3QVRovWemcGMkm7ijAIA showed [Jc Ac] and lost with a pair of Nines
Seat 6: tYsOBqdU1+x+yFI7zHO7hQ folded before Flop (didn't bet)
Seat 7: HhlCy99+up/IQbbuxF6uXg folded before Flop (didn't bet)
Seat 8: hBMUlEpyU74r/fwDgIpXjQ (button) showed [Td Th] and won ($7.60) with two pair, Tens and Nines
Seat 9: IG1d4tXnNA98OKRYYE3l+A (small blind) folded before Flop




PokerStars Game #59939517326:  Hold'em No Limit ($0.10/$0.25) - 2009/07/01 0:41:55 ET
Table 'qInMnOOn7vKcj4bU7zju7g' 9-max Seat #1 is the button
Seat 1: 3PjJjazzeHcM4mbFeXmZBg ($4.30 in chips) 
Seat 2: f/H6PsHRl4W1JyNsEDvPtg ($14.50 in chips) 
Seat 3: zDrucyjVn5aeekNEc3cJrA ($28.50 in chips) 
Seat 4: ZbKV588BRlpe7vF42jT9yg ($9.80 in chips) 
Seat 5: aNpwfA31EREwO+ar4XzBCw ($39 in chips) 
Seat 6: r1pFKMwWp74QwhfPWJOAyw ($5 in chips) 
Seat 7: 8B/dhbQjIWe6ASCdgzktNQ ($26.60 in chips) 
Seat 9: K7bAhhMMJ/XcTmGaBZVfFQ ($23.90 in chips) 
f/H6PsHRl4W1JyNsEDvPtg: posts small blind $0.10
zDrucyjVn5aeekNEc3cJrA: posts big blind $0.25
*** HOLE CARDS ***
ZbKV588BRlpe7vF42jT9yg: folds 
aNpwfA31EREwO+ar4XzBCw: folds 
r1pFKMwWp74QwhfPWJOAyw: folds 
8B/dhbQjIWe6ASCdgzktNQ: folds 
K7bAhhMMJ/XcTmGaBZVfFQ: raises $0.50 to $0.75
3PjJjazzeHcM4mbFeXmZBg: folds 
f/H6PsHRl4W1JyNsEDvPtg: folds 
zDrucyjVn5aeekNEc3cJrA: folds 
Uncalled bet ($0.50) returned to K7bAhhMMJ/XcTmGaBZVfFQ
K7bAhhMMJ/XcTmGaBZVfFQ collected $0.60 from pot
3PjJjazzeHcM4mbFeXmZBg leaves the table
*** SUMMARY ***
Total pot $0.60 | Rake $0 
Seat 1: 3PjJjazzeHcM4mbFeXmZBg (button) folded before Flop (didn't bet)
Seat 2: f/H6PsHRl4W1JyNsEDvPtg (small blind) folded before Flop
Seat 3: zDrucyjVn5aeekNEc3cJrA (big blind) folded before Flop
Seat 4: ZbKV588BRlpe7vF42jT9yg folded before Flop (didn't bet)
Seat 5: aNpwfA31EREwO+ar4XzBCw folded before Flop (didn't bet)
Seat 6: r1pFKMwWp74QwhfPWJOAyw folded before Flop (didn't bet)
Seat 7: 8B/dhbQjIWe6ASCdgzktNQ folded before Flop (didn't bet)
Seat 9: K7bAhhMMJ/XcTmGaBZVfFQ collected ($0.60)




PokerStars Game #59939516734:  Hold'em No Limit ($0.10/$0.25) - 2009/07/01 0:41:55 ET
Table 'WEMI3Mtn7dGARDbgNrKibgoG007Tb0LYbfANo6QWd16wx Seat #8 is the button
Seat 1: GEZ4LFjiwTFoPklBgpSnlw ($18.55 in chips) 
Seat 2: zDrucyjVn5aeekNEc3cJrA ($22.25 in chips) 
Seat 3: 56S3mA6Zs3pGR+0p0vUCtg ($24.65 in chips) 
Seat 4: oKO7b50N6TzXbPBr/mcrUA ($21.60 in chips) 
Seat 5: MIVCHqCqqlke0Lb0z7glcw ($24.65 in chips) 
Seat 6: lxVahNAs/pc3YeLt9PSgbg ($19.95 in chips) 
Seat 7: sUVgUtgbfVx6JpvApozwhQ ($5 in chips) 
Seat 8: 0b9BiwFeJrba87+xtIuQxg ($7.30 in chips) 
Seat 9: 86vbuhJsyH+nbEg5qpDLyQ ($25.45 in chips) 
86vbuhJsyH+nbEg5qpDLyQ: posts small blind $0.10
GEZ4LFjiwTFoPklBgpSnlw: posts big blind $0.25
*** HOLE CARDS ***
zDrucyjVn5aeekNEc3cJrA: folds 
56S3mA6Zs3pGR+0p0vUCtg: folds 
oKO7b50N6TzXbPBr/mcrUA: calls $0.25
MIVCHqCqqlke0Lb0z7glcw: folds 
lxVahNAs/pc3YeLt9PSgbg: calls $0.25
sUVgUtgbfVx6JpvApozwhQ: folds 
0b9BiwFeJrba87+xtIuQxg: folds 
86vbuhJsyH+nbEg5qpDLyQ: folds 
GEZ4LFjiwTFoPklBgpSnlw: checks 
*** FLOP *** [3s 9h 5h]
GEZ4LFjiwTFoPklBgpSnlw: checks 
oKO7b50N6TzXbPBr/mcrUA: bets $0.50
lxVahNAs/pc3YeLt9PSgbg: calls $0.50
GEZ4LFjiwTFoPklBgpSnlw: folds 
*** TURN *** [3s 9h 5h] [7c]
oKO7b50N6TzXbPBr/mcrUA: bets $0.75
lxVahNAs/pc3YeLt9PSgbg: raises $1.75 to $2.50
oKO7b50N6TzXbPBr/mcrUA: folds 
Uncalled bet ($1.75) returned to lxVahNAs/pc3YeLt9PSgbg
lxVahNAs/pc3YeLt9PSgbg collected $3.20 from pot
*** SUMMARY ***
Total pot $3.35 | Rake $0.15 
Board [3s 9h 5h 7c]
Seat 1: GEZ4LFjiwTFoPklBgpSnlw (big blind) folded on the Flop
Seat 2: zDrucyjVn5aeekNEc3cJrA folded before Flop (didn't bet)
Seat 3: 56S3mA6Zs3pGR+0p0vUCtg folded before Flop (didn't bet)
Seat 4: oKO7b50N6TzXbPBr/mcrUA folded on the Turn
Seat 5: MIVCHqCqqlke0Lb0z7glcw folded before Flop (didn't bet)
Seat 6: lxVahNAs/pc3YeLt9PSgbg collected ($3.20)
Seat 7: sUVgUtgbfVx6JpvApozwhQ folded before Flop (didn't bet)
Seat 8: 0b9BiwFeJrba87+xtIuQxg (button) folded before Flop (didn't bet)
Seat 9: 86vbuhJsyH+nbEg5qpDLyQ (small blind) folded before Flop




PokerStars Game #59939517094:  Hold'em No Limit ($0.10/$0.25) - 2009/07/01 0:41:55 ET
Table 'KRiZ8S/xwAYkA4EWSX89ow' 9-max Seat #2 is the button
Seat 1: CYkY0dNBaYaKs8HVCVn3mQ ($5.70 in chips) 
Seat 2: vZGoOTJLQLhkPj4I+LNGig ($53.10 in chips) 
Seat 3: /fionJv+b9tkuIj/KKbXYw ($26.05 in chips) 
Seat 4: COsrwJSFHQtxlUcrYtDQPQ ($27.20 in chips) 
Seat 5: t2nb95S5EEFOEzNx9Itz0g ($5.30 in chips) 
Seat 6: DdPXdieucQ+n99u1n3A+rQ ($5.60 in chips) 
Seat 7: cZ99hugmLBj9KhTlc8nCSw ($25 in chips) 
Seat 8: nEg1b6MIksd/4x5eLY735g ($25.60 in chips) 
Seat 9: EcWpc/mcsCWBGKsSdZaXbA ($24.05 in chips) 
/fionJv+b9tkuIj/KKbXYw: posts small blind $0.10
COsrwJSFHQtxlUcrYtDQPQ: posts big blind $0.25
*** HOLE CARDS ***
t2nb95S5EEFOEzNx9Itz0g: folds 
DdPXdieucQ+n99u1n3A+rQ: folds 
cZ99hugmLBj9KhTlc8nCSw: folds 
nEg1b6MIksd/4x5eLY735g: folds 
EcWpc/mcsCWBGKsSdZaXbA: folds 
CYkY0dNBaYaKs8HVCVn3mQ: folds 
vZGoOTJLQLhkPj4I+LNGig: folds 
/fionJv+b9tkuIj/KKbXYw: calls $0.15
COsrwJSFHQtxlUcrYtDQPQ: checks 
*** FLOP *** [Ts 7d Kd]
/fionJv+b9tkuIj/KKbXYw: checks 
COsrwJSFHQtxlUcrYtDQPQ: bets $0.30
/fionJv+b9tkuIj/KKbXYw: calls $0.30
*** TURN *** [Ts 7d Kd] [Td]
/fionJv+b9tkuIj/KKbXYw: checks 
COsrwJSFHQtxlUcrYtDQPQ: checks 
*** RIVER *** [Ts 7d Kd Td] [Qd]
/fionJv+b9tkuIj/KKbXYw: bets $0.75
COsrwJSFHQtxlUcrYtDQPQ: calls $0.75
*** SHOW DOWN ***
/fionJv+b9tkuIj/KKbXYw: shows [As 9c] (a pair of Tens)
COsrwJSFHQtxlUcrYtDQPQ: shows [Js Kh] (two pair, Kings and Tens)
COsrwJSFHQtxlUcrYtDQPQ collected $2.50 from pot
*** SUMMARY ***
Total pot $2.60 | Rake $0.10 
Board [Ts 7d Kd Td Qd]
Seat 1: CYkY0dNBaYaKs8HVCVn3mQ folded before Flop (didn't bet)
Seat 2: vZGoOTJLQLhkPj4I+LNGig (button) folded before Flop (didn't bet)
Seat 3: /fionJv+b9tkuIj/KKbXYw (small blind) showed [As 9c] and lost with a pair of Tens
Seat 4: COsrwJSFHQtxlUcrYtDQPQ (big blind) showed [Js Kh] and won ($2.50) with two pair, Kings and Tens
Seat 5: t2nb95S5EEFOEzNx9Itz0g folded before Flop (didn't bet)
Seat 6: DdPXdieucQ+n99u1n3A+rQ folded before Flop (didn't bet)
Seat 7: cZ99hugmLBj9KhTlc8nCSw folded before Flop (didn't bet)
Seat 8: nEg1b6MIksd/4x5eLY735g folded before Flop (didn't bet)
Seat 9: EcWpc/mcsCWBGKsSdZaXbA folded before Flop (didn't bet)




PokerStars Game #59939516796:  Hold'em No Limit ($0.10/$0.25) - 2009/07/01 0:41:55 ET
Table 'RuT55t7dqtns1CdLsutksg' 9-max Seat #6 is the button
Seat 1: N6WEabmk+J6IGeE7kub1QQ ($41.10 in chips) 
Seat 2: CYkY0dNBaYaKs8HVCVn3mQ ($5.90 in chips) 
Seat 3: xOx0qYgTfvbPkTa+GuX0WA ($16.25 in chips) 
Seat 4: MG90wfSJZnOejs/KD3vlQQ ($26.70 in chips) 
Seat 5: 0D3Q+hLxjPei/5wgaaYhZA ($4.05 in chips) 
Seat 6: CqwJk5Z2+vb2f9j1o7IjKQ ($11.60 in chips) 
Seat 8: yyG4svzOpC1A+sUP/scg6w ($7.25 in chips) 
yyG4svzOpC1A+sUP/scg6w: posts small blind $0.10
N6WEabmk+J6IGeE7kub1QQ: posts big blind $0.25
*** HOLE CARDS ***
CYkY0dNBaYaKs8HVCVn3mQ: folds 
xOx0qYgTfvbPkTa+GuX0WA: folds 
MG90wfSJZnOejs/KD3vlQQ: folds 
0D3Q+hLxjPei/5wgaaYhZA: folds 
CqwJk5Z2+vb2f9j1o7IjKQ: raises $0.25 to $0.50
yyG4svzOpC1A+sUP/scg6w: folds 
N6WEabmk+J6IGeE7kub1QQ: folds 
Uncalled bet ($0.25) returned to CqwJk5Z2+vb2f9j1o7IjKQ
CqwJk5Z2+vb2f9j1o7IjKQ collected $0.60 from pot
CqwJk5Z2+vb2f9j1o7IjKQ: doesn't show hand 
*** SUMMARY ***
Total pot $0.60 | Rake $0 
Seat 1: N6WEabmk+J6IGeE7kub1QQ (big blind) folded before Flop
Seat 2: CYkY0dNBaYaKs8HVCVn3mQ folded before Flop (didn't bet)
Seat 3: xOx0qYgTfvbPkTa+GuX0WA folded before Flop (didn't bet)
Seat 4: MG90wfSJZnOejs/KD3vlQQ folded before Flop (didn't bet)
Seat 5: 0D3Q+hLxjPei/5wgaaYhZA folded before Flop (didn't bet)
Seat 6: CqwJk5Z2+vb2f9j1o7IjKQ (button) collected ($0.60)
Seat 8: yyG4svzOpC1A+sUP/scg6w (small blind) folded before Flop




PokerStars Game #59939517368:  Hold'em No Limit ($0.10/$0.25) - 2009/07/01 0:41:55 ET
Table 'G+4ZdyRoPjgaJY/jxSlZzQ' 9-max Seat #1 is the button
Seat 1: 0Ui5PFTLvpoTRdxcc8BNSQ ($34.05 in chips) 
Seat 2: 4awUyiDYTgylQKXZ9faBVA ($34.80 in chips) 
Seat 3: opOCI2p6kW0tINuVaAqmcQ ($27.70 in chips) 
Seat 4: yindad6WXRlkjbK12URYkA ($10.55 in chips) 
Seat 5: s7Q6uNouhe7aE8JdFb9E+A ($26.25 in chips) 
Seat 6: gehe91e0IyVT0QU/XBkEyg ($27.55 in chips) 
Seat 9: AzTBzPGlrIHrrs1Q8oKcGA ($17.20 in chips) 
4awUyiDYTgylQKXZ9faBVA: posts small blind $0.10
opOCI2p6kW0tINuVaAqmcQ: posts big blind $0.25
Archi91: sits out 
*** HOLE CARDS ***
yindad6WXRlkjbK12URYkA: calls $0.25
s7Q6uNouhe7aE8JdFb9E+A: folds 
gehe91e0IyVT0QU/XBkEyg: folds 
AzTBzPGlrIHrrs1Q8oKcGA: folds 
0Ui5PFTLvpoTRdxcc8BNSQ: folds 
4awUyiDYTgylQKXZ9faBVA: folds 
opOCI2p6kW0tINuVaAqmcQ: checks 
*** FLOP *** [3h 4c 7c]
opOCI2p6kW0tINuVaAqmcQ: bets $0.50
yindad6WXRlkjbK12URYkA: folds 
Uncalled bet ($0.50) returned to opOCI2p6kW0tINuVaAqmcQ
opOCI2p6kW0tINuVaAqmcQ collected $0.60 from pot
opOCI2p6kW0tINuVaAqmcQ: doesn't show hand 
*** SUMMARY ***
Total pot $0.60 | Rake $0 
Board [3h 4c 7c]
Seat 1: 0Ui5PFTLvpoTRdxcc8BNSQ (button) folded before Flop (didn't bet)
Seat 2: 4awUyiDYTgylQKXZ9faBVA (small blind) folded before Flop
Seat 3: opOCI2p6kW0tINuVaAqmcQ (big blind) collected ($0.60)
Seat 4: yindad6WXRlkjbK12URYkA folded on the Flop
Seat 5: s7Q6uNouhe7aE8JdFb9E+A folded before Flop (didn't bet)
Seat 6: gehe91e0IyVT0QU/XBkEyg folded before Flop (didn't bet)
Seat 9: AzTBzPGlrIHrrs1Q8oKcGA folded before Flop (didn't bet)




PokerStars Game #59939517366:  Hold'em No Limit ($0.10/$0.25) - 2009/07/01 0:41:55 ET
Table 'HzFR0rxmDAPu5GzYR0AlYg' 6-max Seat #2 is the button
Seat 1: v+QfkGiuj9bgtuNoVnDO8w ($25 in chips) 
Seat 2: UA5OsKS3VPaxa7uC8La/kA ($52.95 in chips) 
Seat 3: lfAPI6VglUPipZe8BpDaTA ($24.95 in chips) 
Seat 4: uy9x0X5l7O+IpGjLa77QgQ ($60.05 in chips) 
Seat 5: I1TxPvWj8NfG8orglCinNA ($25 in chips) 
lfAPI6VglUPipZe8BpDaTA: posts small blind $0.10
uy9x0X5l7O+IpGjLa77QgQ: posts big blind $0.25
*** HOLE CARDS ***
I1TxPvWj8NfG8orglCinNA: folds 
v+QfkGiuj9bgtuNoVnDO8w: folds 
jp34e617tIzV8tKIWmfAbA joins the table at seat #6 
UA5OsKS3VPaxa7uC8La/kA: folds 
lfAPI6VglUPipZe8BpDaTA: calls $0.15
uy9x0X5l7O+IpGjLa77QgQ: checks 
*** FLOP *** [2d Ad 3s]
lfAPI6VglUPipZe8BpDaTA: checks 
uy9x0X5l7O+IpGjLa77QgQ: checks 
*** TURN *** [2d Ad 3s] [As]
lfAPI6VglUPipZe8BpDaTA: checks 
uy9x0X5l7O+IpGjLa77QgQ: checks 
*** RIVER *** [2d Ad 3s As] [5c]
lfAPI6VglUPipZe8BpDaTA: checks 
uy9x0X5l7O+IpGjLa77QgQ: checks 
*** SHOW DOWN ***
lfAPI6VglUPipZe8BpDaTA: shows [9h Ks] (a pair of Aces)
uy9x0X5l7O+IpGjLa77QgQ: shows [Kh Js] (a pair of Aces - King+Jack kicker)
uy9x0X5l7O+IpGjLa77QgQ collected $0.50 from pot
*** SUMMARY ***
Total pot $0.50 | Rake $0 
Board [2d Ad 3s As 5c]
Seat 1: v+QfkGiuj9bgtuNoVnDO8w folded before Flop (didn't bet)
Seat 2: UA5OsKS3VPaxa7uC8La/kA (button) folded before Flop (didn't bet)
Seat 3: lfAPI6VglUPipZe8BpDaTA (small blind) showed [9h Ks] and lost with a pair of Aces
Seat 4: uy9x0X5l7O+IpGjLa77QgQ (big blind) showed [Kh Js] and won ($0.50) with a pair of Aces
Seat 5: I1TxPvWj8NfG8orglCinNA folded before Flop (didn't bet)




PokerStars Game #59939517028:  Hold'em No Limit ($0.10/$0.25) - 2009/07/01 0:41:55 ET
Table 'BpNkESDX1ip9c0K1hb5h7A' 6-max Seat #6 is the button
Seat 1: 9jSiy0meE9XJKkdIZwyTEQ ($29 in chips) 
Seat 2: gqW2aBCmrIw65BvwjTFN6Q ($25 in chips) 
Seat 3: cHhVLDikFlByGGN+CM3w/A ($25.50 in chips) 
Seat 5: QvTX2yGq3uKJiKPmns4TKQ ($71.55 in chips) 
Seat 6: iUgsn+WyKFjjVd+tj13R2w ($15.35 in chips) 
9jSiy0meE9XJKkdIZwyTEQ: posts small blind $0.10
gqW2aBCmrIw65BvwjTFN6Q: posts big blind $0.25
*** HOLE CARDS ***
cHhVLDikFlByGGN+CM3w/A: raises $0.55 to $0.80
tbhYGxTClzdFLMcTtjvJhg said, "fn AQ and i fn lock up"
QvTX2yGq3uKJiKPmns4TKQ: folds 
tbhYGxTClzdFLMcTtjvJhg said, "not my day"
tbhYGxTClzdFLMcTtjvJhg said, "or week"
tbhYGxTClzdFLMcTtjvJhg said, "or year lol"
iUgsn+WyKFjjVd+tj13R2w: folds 
9jSiy0meE9XJKkdIZwyTEQ: folds 
gqW2aBCmrIw65BvwjTFN6Q: folds 
Uncalled bet ($0.55) returned to cHhVLDikFlByGGN+CM3w/A
cHhVLDikFlByGGN+CM3w/A said, "get in"
cHhVLDikFlByGGN+CM3w/A collected $0.60 from pot
cHhVLDikFlByGGN+CM3w/A: doesn't show hand 
*** SUMMARY ***
Total pot $0.60 | Rake $0 
Seat 1: 9jSiy0meE9XJKkdIZwyTEQ (small blind) folded before Flop
Seat 2: gqW2aBCmrIw65BvwjTFN6Q (big blind) folded before Flop
Seat 3: cHhVLDikFlByGGN+CM3w/A collected ($0.60)
Seat 5: QvTX2yGq3uKJiKPmns4TKQ folded before Flop (didn't bet)
Seat 6: iUgsn+WyKFjjVd+tj13R2w (button) folded before Flop (didn't bet)




PokerStars Game #59939517234:  Hold'em No Limit ($0.10/$0.25) - 2009/07/01 0:41:55 ET
Table 'gkdjhbH1jaE3hwhPRIKMiQ' 6-max Seat #5 is the button
Seat 1: nc79pm0LZRdhncq55evVqA ($25 in chips) 
Seat 2: 1NNFfYMd5Hsphl/FYz9fNA ($33.65 in chips) 
Seat 3: kG34n23qFQA3nzdOJTQ1dA ($24.65 in chips) 
Seat 5: Ew/TYPQIsbQ2X8nm5iAJBg ($24.55 in chips) 
Seat 6: wqphQtauX5Qn7WRJZS1flA ($27.80 in chips) 
wqphQtauX5Qn7WRJZS1flA: posts small blind $0.10
nc79pm0LZRdhncq55evVqA: posts big blind $0.25
*** HOLE CARDS ***
1NNFfYMd5Hsphl/FYz9fNA: folds 
kG34n23qFQA3nzdOJTQ1dA: folds 
Ew/TYPQIsbQ2X8nm5iAJBg: raises $0.75 to $1
wqphQtauX5Qn7WRJZS1flA: folds 
nc79pm0LZRdhncq55evVqA: folds 
Uncalled bet ($0.75) returned to Ew/TYPQIsbQ2X8nm5iAJBg
Ew/TYPQIsbQ2X8nm5iAJBg collected $0.60 from pot
Ew/TYPQIsbQ2X8nm5iAJBg: doesn't show hand 
*** SUMMARY ***
Total pot $0.60 | Rake $0 
Seat 1: nc79pm0LZRdhncq55evVqA (big blind) folded before Flop
Seat 2: 1NNFfYMd5Hsphl/FYz9fNA folded before Flop (didn't bet)
Seat 3: kG34n23qFQA3nzdOJTQ1dA folded before Flop (didn't bet)
Seat 5: Ew/TYPQIsbQ2X8nm5iAJBg (button) collected ($0.60)
Seat 6: wqphQtauX5Qn7WRJZS1flA (small blind) folded before Flop




PokerStars Game #59939517294:  Hold'em No Limit ($0.10/$0.25) - 2009/07/01 0:41:55 ET
Table 'O5NgMYt6EWbLBozZb3kseg' 6-max Seat #4 is the button
Seat 1: T2fEtpqj5ZyZAjEhNtsFAA ($38.80 in chips) 
Seat 2: VWbjqONyDvf8KegytgPLjQ ($59.40 in chips) 
Seat 3: dg3SMYXD7586yGx+LuFM0g ($20 in chips) 
Seat 4: aogAb4Eienxztk8p2v9VVw ($23.50 in chips) 
Seat 5: vu2kzHaDtgr6NM7rdq0chA ($47.70 in chips) 
Seat 6: k9vn40MOqqb+xF+7GZ6v2g ($22.60 in chips) 
vu2kzHaDtgr6NM7rdq0chA: posts small blind $0.10
k9vn40MOqqb+xF+7GZ6v2g: posts big blind $0.25
dg3SMYXD7586yGx+LuFM0g: posts small & big blinds $0.35
*** HOLE CARDS ***
T2fEtpqj5ZyZAjEhNtsFAA: calls $0.25
VWbjqONyDvf8KegytgPLjQ: folds 
dg3SMYXD7586yGx+LuFM0g: checks 
aogAb4Eienxztk8p2v9VVw: calls $0.25
vu2kzHaDtgr6NM7rdq0chA: calls $0.15
k9vn40MOqqb+xF+7GZ6v2g: raises $2 to $2.25
T2fEtpqj5ZyZAjEhNtsFAA: calls $2
dg3SMYXD7586yGx+LuFM0g: calls $2
aogAb4Eienxztk8p2v9VVw: calls $2
vu2kzHaDtgr6NM7rdq0chA: folds 
*** FLOP *** [Kd Jh 6c]
k9vn40MOqqb+xF+7GZ6v2g: checks 
T2fEtpqj5ZyZAjEhNtsFAA: checks 
dg3SMYXD7586yGx+LuFM0g: checks 
aogAb4Eienxztk8p2v9VVw: checks 
*** TURN *** [Kd Jh 6c] [Ks]
k9vn40MOqqb+xF+7GZ6v2g: checks 
T2fEtpqj5ZyZAjEhNtsFAA: checks 
dg3SMYXD7586yGx+LuFM0g: bets $1.25
aogAb4Eienxztk8p2v9VVw: folds 
k9vn40MOqqb+xF+7GZ6v2g: calls $1.25
T2fEtpqj5ZyZAjEhNtsFAA: calls $1.25
*** RIVER *** [Kd Jh 6c Ks] [5c]
k9vn40MOqqb+xF+7GZ6v2g: checks 
T2fEtpqj5ZyZAjEhNtsFAA: checks 
dg3SMYXD7586yGx+LuFM0g: bets $3
k9vn40MOqqb+xF+7GZ6v2g: folds 
T2fEtpqj5ZyZAjEhNtsFAA: calls $3
*** SHOW DOWN ***
dg3SMYXD7586yGx+LuFM0g: shows [3d 7d] (a pair of Kings)
T2fEtpqj5ZyZAjEhNtsFAA: shows [Td Qs] (a pair of Kings - Queen kicker)
T2fEtpqj5ZyZAjEhNtsFAA collected $18.20 from pot
*** SUMMARY ***
Total pot $19.10 | Rake $0.90 
Board [Kd Jh 6c Ks 5c]
Seat 1: T2fEtpqj5ZyZAjEhNtsFAA showed [Td Qs] and won ($18.20) with a pair of Kings
Seat 2: VWbjqONyDvf8KegytgPLjQ folded before Flop (didn't bet)
Seat 3: dg3SMYXD7586yGx+LuFM0g showed [3d 7d] and lost with a pair of Kings
Seat 4: aogAb4Eienxztk8p2v9VVw (button) folded on the Turn
Seat 5: vu2kzHaDtgr6NM7rdq0chA (small blind) folded before Flop
Seat 6: k9vn40MOqqb+xF+7GZ6v2g (big blind) folded on the River




PokerStars Game #59939516818:  Hold'em No Limit ($0.10/$0.25) - 2009/07/01 0:41:55 ET
Table '8PD/MTROSMd6Y8mZeykbpg' 6-max Seat #5 is the button
Seat 1: 32YL2ZEp8NT4JB2RVM9euQ ($19.40 in chips) 
Seat 2: wAKC8C/zN0c8V5v13dm9mA ($25 in chips) 
Seat 3: EV5E02/xfaoDNHy7UQ195Q ($26.15 in chips) 
Seat 4: tTBLQIRkkVpjhASe6+jvXQ ($2.95 in chips) 
Seat 5: z3tQwy28dp5FykDJC/wzQw ($11.85 in chips) 
Seat 6: 096oPBXuIkGUyml0gVo5TA ($18.35 in chips) 
096oPBXuIkGUyml0gVo5TA: posts small blind $0.10
32YL2ZEp8NT4JB2RVM9euQ: posts big blind $0.25
*** HOLE CARDS ***
wAKC8C/zN0c8V5v13dm9mA: folds 
EV5E02/xfaoDNHy7UQ195Q: folds 
tTBLQIRkkVpjhASe6+jvXQ: calls $0.25
z3tQwy28dp5FykDJC/wzQw: folds 
096oPBXuIkGUyml0gVo5TA: calls $0.15
32YL2ZEp8NT4JB2RVM9euQ: checks 
*** FLOP *** [Ad Ah Qs]
096oPBXuIkGUyml0gVo5TA: checks 
32YL2ZEp8NT4JB2RVM9euQ: checks 
tTBLQIRkkVpjhASe6+jvXQ: checks 
*** TURN *** [Ad Ah Qs] [Kh]
096oPBXuIkGUyml0gVo5TA: bets $1
32YL2ZEp8NT4JB2RVM9euQ: folds 
tTBLQIRkkVpjhASe6+jvXQ: folds 
Uncalled bet ($1) returned to 096oPBXuIkGUyml0gVo5TA
096oPBXuIkGUyml0gVo5TA collected $0.75 from pot
096oPBXuIkGUyml0gVo5TA: doesn't show hand 
*** SUMMARY ***
Total pot $0.75 | Rake $0 
Board [Ad Ah Qs Kh]
Seat 1: 32YL2ZEp8NT4JB2RVM9euQ (big blind) folded on the Turn
Seat 2: wAKC8C/zN0c8V5v13dm9mA folded before Flop (didn't bet)
Seat 3: EV5E02/xfaoDNHy7UQ195Q folded before Flop (didn't bet)
Seat 4: tTBLQIRkkVpjhASe6+jvXQ folded on the Turn
Seat 5: z3tQwy28dp5FykDJC/wzQw (button) folded before Flop (didn't bet)
Seat 6: 096oPBXuIkGUyml0gVo5TA (small blind) collected ($0.75)




PokerStars Game #59939517292:  Hold'em No Limit ($0.10/$0.25) - 2009/07/01 0:41:55 ET
Table 'rjcb+nlE+0GuJ6lBhuCkkA' 6-max Seat #1 is the button
Seat 1: 9jSiy0meE9XJKkdIZwyTEQ ($26.05 in chips) 
Seat 2: d9ecz4Yhx6qRKe5k+fUWdw ($18.45 in chips) 
Seat 3: 8ClCHtFXGNplITm+63KB+Q ($25 in chips) 
Seat 4: NzIFHwilc5zU7QhjDTgTZA ($12.80 in chips) 
Seat 5: GC/9yVD59DUCX7hUI7gcLw ($44.10 in chips) 
Seat 6: 0DvgWV5o6c/jYqQCjm4Haw ($33.65 in chips) 
d9ecz4Yhx6qRKe5k+fUWdw: posts small blind $0.10
8ClCHtFXGNplITm+63KB+Q: posts big blind $0.25
*** HOLE CARDS ***
NzIFHwilc5zU7QhjDTgTZA: folds 
GC/9yVD59DUCX7hUI7gcLw: raises $0.75 to $1
0DvgWV5o6c/jYqQCjm4Haw: folds 
9jSiy0meE9XJKkdIZwyTEQ: folds 
d9ecz4Yhx6qRKe5k+fUWdw: folds 
8ClCHtFXGNplITm+63KB+Q: calls $0.75
*** FLOP *** [5c 4c Ad]
8ClCHtFXGNplITm+63KB+Q: checks 
GC/9yVD59DUCX7hUI7gcLw: bets $1.50
8ClCHtFXGNplITm+63KB+Q: calls $1.50
*** TURN *** [5c 4c Ad] [Jd]
8ClCHtFXGNplITm+63KB+Q: checks 
GC/9yVD59DUCX7hUI7gcLw: bets $3.50
d9ecz4Yhx6qRKe5k+fUWdw leaves the table
8ClCHtFXGNplITm+63KB+Q: calls $3.50
*** RIVER *** [5c 4c Ad Jd] [7c]
8ClCHtFXGNplITm+63KB+Q: bets $3.50
GC/9yVD59DUCX7hUI7gcLw: calls $3.50
*** SHOW DOWN ***
8ClCHtFXGNplITm+63KB+Q: shows [Kc Jc] (a flush, King high)
GC/9yVD59DUCX7hUI7gcLw: mucks hand 
8ClCHtFXGNplITm+63KB+Q collected $18.20 from pot
*** SUMMARY ***
Total pot $19.10 | Rake $0.90 
Board [5c 4c Ad Jd 7c]
Seat 1: 9jSiy0meE9XJKkdIZwyTEQ (button) folded before Flop (didn't bet)
Seat 2: d9ecz4Yhx6qRKe5k+fUWdw (small blind) folded before Flop
Seat 3: 8ClCHtFXGNplITm+63KB+Q (big blind) showed [Kc Jc] and won ($18.20) with a flush, King high
Seat 4: NzIFHwilc5zU7QhjDTgTZA folded before Flop (didn't bet)
Seat 5: GC/9yVD59DUCX7hUI7gcLw mucked
Seat 6: 0DvgWV5o6c/jYqQCjm4Haw folded before Flop (didn't bet)




PokerStars Game #59939517986:  Hold'em No Limit ($0.10/$0.25) - 2009/07/01 0:41:56 ET
Table 'nlpa8xI95gAflovnFxB2yg' 6-max Seat #5 is the button
Seat 1: fZQg9veL7Dd/Z04ZTjC+wQ ($64.05 in chips) 
Seat 3: I1TxPvWj8NfG8orglCinNA ($25 in chips) 
Seat 4: 5xjU9nfIjn1MBxIJKZvS5w ($32.35 in chips) 
Seat 5: 6DwBRH+xZ12AAZmeAg+aXw ($25 in chips) 
Seat 6: FPlQHZog0ePFCETQ2KG4hQ ($26 in chips) 
FPlQHZog0ePFCETQ2KG4hQ: posts small blind $0.10
fZQg9veL7Dd/Z04ZTjC+wQ: posts big blind $0.25
WrLI51S2iMb8GLMB83gGqA: sits out 
*** HOLE CARDS ***
I1TxPvWj8NfG8orglCinNA: raises $0.75 to $1
5xjU9nfIjn1MBxIJKZvS5w: folds 
6DwBRH+xZ12AAZmeAg+aXw: folds 
FPlQHZog0ePFCETQ2KG4hQ: folds 
fZQg9veL7Dd/Z04ZTjC+wQ: folds 
Uncalled bet ($0.75) returned to I1TxPvWj8NfG8orglCinNA
I1TxPvWj8NfG8orglCinNA collected $0.60 from pot
I1TxPvWj8NfG8orglCinNA: doesn't show hand 
*** SUMMARY ***
Total pot $0.60 | Rake $0 
Seat 1: fZQg9veL7Dd/Z04ZTjC+wQ (big blind) folded before Flop
Seat 3: I1TxPvWj8NfG8orglCinNA collected ($0.60)
Seat 4: 5xjU9nfIjn1MBxIJKZvS5w folded before Flop (didn't bet)
Seat 5: 6DwBRH+xZ12AAZmeAg+aXw (button) folded before Flop (didn't bet)
Seat 6: FPlQHZog0ePFCETQ2KG4hQ (small blind) folded before Flop




PokerStars Game #59939517794:  Hold'em No Limit ($0.10/$0.25) - 2009/07/01 0:41:56 ET
Table 'isKy4XK8wJM0x735/D4hWA' 6-max Seat #6 is the button
Seat 1: 7FmwVDcdEtxDpHmP4hOXsQ ($25 in chips) 
Seat 2: WrLI51S2iMb8GLMB83gGqA ($27.45 in chips) 
Seat 4: k9vn40MOqqb+xF+7GZ6v2g ($24.65 in chips) 
Seat 5: zlYHXTtJ5tcx9kwK2h5n9A ($37.05 in chips) 
Seat 6: M6xK/VklCvdyyrmvzATlxQ ($13.75 in chips) 
7FmwVDcdEtxDpHmP4hOXsQ: posts small blind $0.10
WrLI51S2iMb8GLMB83gGqA: posts big blind $0.25
jp34e617tIzV8tKIWmfAbA: sits out 
*** HOLE CARDS ***
k9vn40MOqqb+xF+7GZ6v2g: folds 
zlYHXTtJ5tcx9kwK2h5n9A: calls $0.25
M6xK/VklCvdyyrmvzATlxQ: folds 
7FmwVDcdEtxDpHmP4hOXsQ: folds 
WrLI51S2iMb8GLMB83gGqA: checks 
*** FLOP *** [6d 9d Jd]
WrLI51S2iMb8GLMB83gGqA: checks 
zlYHXTtJ5tcx9kwK2h5n9A: bets $0.25
WrLI51S2iMb8GLMB83gGqA: folds 
Uncalled bet ($0.25) returned to zlYHXTtJ5tcx9kwK2h5n9A
zlYHXTtJ5tcx9kwK2h5n9A collected $0.60 from pot
zlYHXTtJ5tcx9kwK2h5n9A: doesn't show hand 
*** SUMMARY ***
Total pot $0.60 | Rake $0 
Board [6d 9d Jd]
Seat 1: 7FmwVDcdEtxDpHmP4hOXsQ (small blind) folded before Flop
Seat 2: WrLI51S2iMb8GLMB83gGqA (big blind) folded on the Flop
Seat 4: k9vn40MOqqb+xF+7GZ6v2g folded before Flop (didn't bet)
Seat 5: zlYHXTtJ5tcx9kwK2h5n9A collected ($0.60)
Seat 6: M6xK/VklCvdyyrmvzATlxQ (button) folded before Flop (didn't bet)




PokerStars Game #59939517560:  Hold'em No Limit ($0.10/$0.25) - 2009/07/01 0:41:56 ET
Table 'sCop8wmj9zlSS2KJqk1QKQ' 9-max Seat #9 is the button
Seat 1: SXqVW4Q0evTUVZG6BbUNIA ($21.65 in chips) 
Seat 2: W4TLQcZ2TiM73eIgpIvlGg ($23.15 in chips) 
Seat 3: 6TWO15+WfJ5HfI8CbJ4a0w ($4.30 in chips) 
Seat 4: KNrY0Y/j01dK9gZK7dx7QA ($14.40 in chips) 
Seat 6: hZuGwtYmFKPmQ+v1wlmdfA ($40.10 in chips) 
Seat 7: 4dd+rKHhaMiTl5LEkADvQQ ($4.90 in chips) 
Seat 9: tOdE7+08fkUzsTpCnhoPDA ($22.10 in chips) 
SXqVW4Q0evTUVZG6BbUNIA: posts small blind $0.10
W4TLQcZ2TiM73eIgpIvlGg: posts big blind $0.25
sD+TKtt36XiiN6jqHiLwDA: sits out 
*** HOLE CARDS ***
opOCI2p6kW0tINuVaAqmcQ joins the table at seat #8 
6TWO15+WfJ5HfI8CbJ4a0w: folds 
KNrY0Y/j01dK9gZK7dx7QA: folds 
hZuGwtYmFKPmQ+v1wlmdfA: folds 
4dd+rKHhaMiTl5LEkADvQQ: folds 
tOdE7+08fkUzsTpCnhoPDA: folds 
SXqVW4Q0evTUVZG6BbUNIA: folds 
Uncalled bet ($0.15) returned to W4TLQcZ2TiM73eIgpIvlGg
W4TLQcZ2TiM73eIgpIvlGg collected $0.20 from pot
*** SUMMARY ***
Total pot $0.20 | Rake $0 
Seat 1: SXqVW4Q0evTUVZG6BbUNIA (small blind) folded before Flop
Seat 2: W4TLQcZ2TiM73eIgpIvlGg (big blind) collected ($0.20)
Seat 3: 6TWO15+WfJ5HfI8CbJ4a0w folded before Flop (didn't bet)
Seat 4: KNrY0Y/j01dK9gZK7dx7QA folded before Flop (didn't bet)
Seat 6: hZuGwtYmFKPmQ+v1wlmdfA folded before Flop (didn't bet)
Seat 7: 4dd+rKHhaMiTl5LEkADvQQ folded before Flop (didn't bet)
Seat 9: tOdE7+08fkUzsTpCnhoPDA (button) folded before Flop (didn't bet)




PokerStars Game #59939517984:  Hold'em No Limit ($0.10/$0.25) - 2009/07/01 0:41:56 ET
Table 'WjNvuuSgTjm8jh0j9vcCgQ' 9-max Seat #3 is the button
Seat 1: NKymidkL3Kg3ILZPvtLSVg ($10 in chips) 
Seat 2: 9gmYYQesalMrUjaF7nKfrQ ($9.65 in chips) 
Seat 3: 8B/dhbQjIWe6ASCdgzktNQ ($25 in chips) 
Seat 5: Qi+clOtyDiibLdH2/1Qy8g ($18.20 in chips) 
Seat 7: DdPXdieucQ+n99u1n3A+rQ ($4.65 in chips) 
Seat 8: ghNKXUBl/H+t83JF079ZBA ($25.35 in chips) 
Seat 9: DiSvPC2iudwL5j9u6Huyww ($30.05 in chips) 
Qi+clOtyDiibLdH2/1Qy8g: posts small blind $0.10
DdPXdieucQ+n99u1n3A+rQ: posts big blind $0.25
*** HOLE CARDS ***
ghNKXUBl/H+t83JF079ZBA: folds 
DiSvPC2iudwL5j9u6Huyww: folds 
NKymidkL3Kg3ILZPvtLSVg: folds 
9gmYYQesalMrUjaF7nKfrQ: folds 
8B/dhbQjIWe6ASCdgzktNQ: raises $0.50 to $0.75
Qi+clOtyDiibLdH2/1Qy8g: calls $0.65
DdPXdieucQ+n99u1n3A+rQ: folds 
*** FLOP *** [2h Jc Jh]
Qi+clOtyDiibLdH2/1Qy8g: checks 
8B/dhbQjIWe6ASCdgzktNQ: checks 
*** TURN *** [2h Jc Jh] [4d]
Qi+clOtyDiibLdH2/1Qy8g: bets $0.50
8B/dhbQjIWe6ASCdgzktNQ: folds 
Uncalled bet ($0.50) returned to Qi+clOtyDiibLdH2/1Qy8g
Qi+clOtyDiibLdH2/1Qy8g collected $1.70 from pot
Qi+clOtyDiibLdH2/1Qy8g: doesn't show hand 
*** SUMMARY ***
Total pot $1.75 | Rake $0.05 
Board [2h Jc Jh 4d]
Seat 1: NKymidkL3Kg3ILZPvtLSVg folded before Flop (didn't bet)
Seat 2: 9gmYYQesalMrUjaF7nKfrQ folded before Flop (didn't bet)
Seat 3: 8B/dhbQjIWe6ASCdgzktNQ (button) folded on the Turn
Seat 5: Qi+clOtyDiibLdH2/1Qy8g (small blind) collected ($1.70)
Seat 7: DdPXdieucQ+n99u1n3A+rQ (big blind) folded before Flop
Seat 8: ghNKXUBl/H+t83JF079ZBA folded before Flop (didn't bet)
Seat 9: DiSvPC2iudwL5j9u6Huyww folded before Flop (didn't bet)




PokerStars Game #59939517684:  Hold'em No Limit ($0.10/$0.25) - 2009/07/01 0:41:56 ET
Table 'sIHZ0lzLr4NGCaBUKhmYhAr562aMIMs5kgo28FEU6lkAax Seat #6 is the button
Seat 1: vZGoOTJLQLhkPj4I+LNGig ($25 in chips) 
Seat 2: N8muFAHrFHW6elSMGuyVLQ ($14.75 in chips) 
Seat 3: vX2B+8jhZFyBctQ3P4IKEw ($10.40 in chips) 
Seat 4: XBq1lBzax7LjRqdJP2TqWg ($13.10 in chips) 
Seat 5: zDrucyjVn5aeekNEc3cJrA ($37.30 in chips) 
Seat 6: rCaXm4/EwAgWqCiClpbsqQ ($10.40 in chips) 
Seat 7: R6nIVAjK7uhK3Hj0f85A+A ($18.45 in chips) 
Seat 8: B6xHiX1SJkS0CUNCKDVwuQ ($25 in chips) 
Seat 9: W4TLQcZ2TiM73eIgpIvlGg ($26.10 in chips) 
R6nIVAjK7uhK3Hj0f85A+A: posts small blind $0.10
B6xHiX1SJkS0CUNCKDVwuQ: posts big blind $0.25
*** HOLE CARDS ***
W4TLQcZ2TiM73eIgpIvlGg: calls $0.25
vZGoOTJLQLhkPj4I+LNGig: folds 
N8muFAHrFHW6elSMGuyVLQ: folds 
vX2B+8jhZFyBctQ3P4IKEw: calls $0.25
XBq1lBzax7LjRqdJP2TqWg: folds 
zDrucyjVn5aeekNEc3cJrA: folds 
rCaXm4/EwAgWqCiClpbsqQ: folds 
R6nIVAjK7uhK3Hj0f85A+A: folds 
B6xHiX1SJkS0CUNCKDVwuQ: checks 
*** FLOP *** [Qh Ac Qc]
B6xHiX1SJkS0CUNCKDVwuQ: checks 
W4TLQcZ2TiM73eIgpIvlGg: checks 
vX2B+8jhZFyBctQ3P4IKEw: checks 
*** TURN *** [Qh Ac Qc] [2d]
B6xHiX1SJkS0CUNCKDVwuQ: checks 
W4TLQcZ2TiM73eIgpIvlGg: checks 
vX2B+8jhZFyBctQ3P4IKEw: checks 
*** RIVER *** [Qh Ac Qc 2d] [As]
B6xHiX1SJkS0CUNCKDVwuQ: checks 
W4TLQcZ2TiM73eIgpIvlGg: checks 
vX2B+8jhZFyBctQ3P4IKEw: checks 
*** SHOW DOWN ***
B6xHiX1SJkS0CUNCKDVwuQ: shows [5h 7h] (two pair, Aces and Queens)
W4TLQcZ2TiM73eIgpIvlGg: shows [8s 7s] (two pair, Aces and Queens - Eight kicker)
vX2B+8jhZFyBctQ3P4IKEw: shows [9c Th] (two pair, Aces and Queens - Ten kicker)
vX2B+8jhZFyBctQ3P4IKEw collected $0.85 from pot
*** SUMMARY ***
Total pot $0.85 | Rake $0 
Board [Qh Ac Qc 2d As]
Seat 1: vZGoOTJLQLhkPj4I+LNGig folded before Flop (didn't bet)
Seat 2: N8muFAHrFHW6elSMGuyVLQ folded before Flop (didn't bet)
Seat 3: vX2B+8jhZFyBctQ3P4IKEw showed [9c Th] and won ($0.85) with two pair, Aces and Queens
Seat 4: XBq1lBzax7LjRqdJP2TqWg folded before Flop (didn't bet)
Seat 5: zDrucyjVn5aeekNEc3cJrA folded before Flop (didn't bet)
Seat 6: rCaXm4/EwAgWqCiClpbsqQ (button) folded before Flop (didn't bet)
Seat 7: R6nIVAjK7uhK3Hj0f85A+A (small blind) folded before Flop
Seat 8: B6xHiX1SJkS0CUNCKDVwuQ (big blind) showed [5h 7h] and lost with two pair, Aces and Queens
Seat 9: W4TLQcZ2TiM73eIgpIvlGg showed [8s 7s] and lost with two pair, Aces and Queens




PokerStars Game #59939518002:  Hold'em No Limit ($0.10/$0.25) - 2009/07/01 0:41:56 ET
Table '8TQqiBvztdoBMTFQQ4MYSA' 9-max Seat #6 is the button
Seat 1: LWN1wPrLH+695JIriXxDuw ($22.85 in chips) 
Seat 2: amD2PwT1xB7aC2k57sa7Ig ($22.70 in chips) 
Seat 3: DIBbjEYGs+TVdVgEB/4+3w ($25.15 in chips) 
Seat 4: EUMLvzDkECHBit+xa+uGjg ($14.45 in chips) 
Seat 5: vZGoOTJLQLhkPj4I+LNGig ($25 in chips) 
Seat 6: MIVCHqCqqlke0Lb0z7glcw ($37.60 in chips) 
Seat 7: STkR8XvpjNv79OOMhrlh2w ($25 in chips) 
Seat 8: 33a0y3nYwUhzkf9PNzg4/Q ($7.90 in chips) 
Seat 9: SXqVW4Q0evTUVZG6BbUNIA ($42.20 in chips) 
STkR8XvpjNv79OOMhrlh2w: posts small blind $0.10
33a0y3nYwUhzkf9PNzg4/Q: posts big blind $0.25
*** HOLE CARDS ***
SXqVW4Q0evTUVZG6BbUNIA: raises $0.75 to $1
LWN1wPrLH+695JIriXxDuw: folds 
amD2PwT1xB7aC2k57sa7Ig: folds 
DIBbjEYGs+TVdVgEB/4+3w: folds 
EUMLvzDkECHBit+xa+uGjg: folds 
vZGoOTJLQLhkPj4I+LNGig: folds 
MIVCHqCqqlke0Lb0z7glcw: folds 
STkR8XvpjNv79OOMhrlh2w: folds 
33a0y3nYwUhzkf9PNzg4/Q: folds 
Uncalled bet ($0.75) returned to SXqVW4Q0evTUVZG6BbUNIA
SXqVW4Q0evTUVZG6BbUNIA collected $0.60 from pot
SXqVW4Q0evTUVZG6BbUNIA: doesn't show hand 
*** SUMMARY ***
Total pot $0.60 | Rake $0 
Seat 1: LWN1wPrLH+695JIriXxDuw folded before Flop (didn't bet)
Seat 2: amD2PwT1xB7aC2k57sa7Ig folded before Flop (didn't bet)
Seat 3: DIBbjEYGs+TVdVgEB/4+3w folded before Flop (didn't bet)
Seat 4: EUMLvzDkECHBit+xa+uGjg folded before Flop (didn't bet)
Seat 5: vZGoOTJLQLhkPj4I+LNGig folded before Flop (didn't bet)
Seat 6: MIVCHqCqqlke0Lb0z7glcw (button) folded before Flop (didn't bet)
Seat 7: STkR8XvpjNv79OOMhrlh2w (small blind) folded before Flop
Seat 8: 33a0y3nYwUhzkf9PNzg4/Q (big blind) folded before Flop
Seat 9: SXqVW4Q0evTUVZG6BbUNIA collected ($0.60)




PokerStars Game #59939518394:  Hold'em No Limit ($0.10/$0.25) - 2009/07/01 0:41:57 ET
Table 'rO1I30HnuCPB0M8qEX1TCQ' 9-max Seat #5 is the button
Seat 1: P32tOtZSz+L5ekobAPq2DA ($3.60 in chips) 
Seat 2: 33y9+GmQ3J84RvZXcraRTw ($21.05 in chips) 
Seat 3: 8Waresd9ixnijISc3GUypg ($12.90 in chips) 
Seat 4: spidnpwmoJ1L6yeNW7D5UA ($24.60 in chips) 
Seat 5: HVKi9hnDyvzObpL08/OarQ ($24.40 in chips) 
Seat 7: 4oA316mXLIui1QY63GXBUg ($30.50 in chips) 
Seat 8: DIBbjEYGs+TVdVgEB/4+3w ($37 in chips) 
Seat 9: PrviAnKmKklf+We6cR33cw ($30.50 in chips) 
4oA316mXLIui1QY63GXBUg: posts small blind $0.10
DIBbjEYGs+TVdVgEB/4+3w: posts big blind $0.25
*** HOLE CARDS ***
PrviAnKmKklf+We6cR33cw: folds 
P32tOtZSz+L5ekobAPq2DA: calls $0.25
33y9+GmQ3J84RvZXcraRTw: folds 
8Waresd9ixnijISc3GUypg: calls $0.25
spidnpwmoJ1L6yeNW7D5UA: calls $0.25
HVKi9hnDyvzObpL08/OarQ: folds 
4oA316mXLIui1QY63GXBUg: calls $0.15
DIBbjEYGs+TVdVgEB/4+3w: checks 
*** FLOP *** [5s 3c 9c]
4oA316mXLIui1QY63GXBUg: checks 
DIBbjEYGs+TVdVgEB/4+3w: checks 
P32tOtZSz+L5ekobAPq2DA: checks 
8Waresd9ixnijISc3GUypg: bets $1
spidnpwmoJ1L6yeNW7D5UA: calls $1
4oA316mXLIui1QY63GXBUg: folds 
vO3QVRovWemcGMkm7ijAIA joins the table at seat #6 
DIBbjEYGs+TVdVgEB/4+3w: folds 
P32tOtZSz+L5ekobAPq2DA: calls $1
*** TURN *** [5s 3c 9c] [2h]
P32tOtZSz+L5ekobAPq2DA: checks 
8Waresd9ixnijISc3GUypg: bets $2.50
spidnpwmoJ1L6yeNW7D5UA: raises $11 to $13.50
P32tOtZSz+L5ekobAPq2DA: calls $2.35 and is all-in
8Waresd9ixnijISc3GUypg: calls $9.15 and is all-in
Uncalled bet ($1.85) returned to spidnpwmoJ1L6yeNW7D5UA
*** RIVER *** [5s 3c 9c 2h] [Ad]
*** SHOW DOWN ***
8Waresd9ixnijISc3GUypg: shows [Tc 9d] (a pair of Nines)
spidnpwmoJ1L6yeNW7D5UA: shows [3d 3h] (three of a kind, Threes)
spidnpwmoJ1L6yeNW7D5UA collected $17.70 from side pot
P32tOtZSz+L5ekobAPq2DA: mucks hand 
spidnpwmoJ1L6yeNW7D5UA collected $10.75 from main pot
8Waresd9ixnijISc3GUypg leaves the table
*** SUMMARY ***
Total pot $29.90 Main pot $10.75. Side pot $17.70. | Rake $1.45 
Board [5s 3c 9c 2h Ad]
Seat 1: P32tOtZSz+L5ekobAPq2DA mucked
Seat 2: 33y9+GmQ3J84RvZXcraRTw folded before Flop (didn't bet)
Seat 3: 8Waresd9ixnijISc3GUypg showed [Tc 9d] and lost with a pair of Nines
Seat 4: spidnpwmoJ1L6yeNW7D5UA showed [3d 3h] and won ($28.45) with three of a kind, Threes
Seat 5: HVKi9hnDyvzObpL08/OarQ (button) folded before Flop (didn't bet)
Seat 7: 4oA316mXLIui1QY63GXBUg (small blind) folded on the Flop
Seat 8: DIBbjEYGs+TVdVgEB/4+3w (big blind) folded on the Flop
Seat 9: PrviAnKmKklf+We6cR33cw folded before Flop (didn't bet)




PokerStars Game #59939518174:  Hold'em No Limit ($0.10/$0.25) - 2009/07/01 0:41:57 ET
Table 'Loy/olZ5qoDOSvX4UTujGg' 6-max Seat #1 is the button
Seat 1: yzFNNFIfC89bBPwpFPx2ow ($28.85 in chips) 
Seat 3: 32YL2ZEp8NT4JB2RVM9euQ ($15.75 in chips) 
Seat 4: /gJNBeCkWL4o85/jvlZ4BA ($27.10 in chips) 
Seat 5: 4YSTu0Cdzpppe1lUgCZGCQ ($35.15 in chips) 
Seat 6: 7FmwVDcdEtxDpHmP4hOXsQ ($52.70 in chips) 
32YL2ZEp8NT4JB2RVM9euQ: posts small blind $0.10
/gJNBeCkWL4o85/jvlZ4BA: posts big blind $0.25
*** HOLE CARDS ***
4YSTu0Cdzpppe1lUgCZGCQ: raises $0.75 to $1
7FmwVDcdEtxDpHmP4hOXsQ: folds 
yzFNNFIfC89bBPwpFPx2ow: calls $1
32YL2ZEp8NT4JB2RVM9euQ: folds 
/gJNBeCkWL4o85/jvlZ4BA: folds 
*** FLOP *** [Ts 4c 5h]
4YSTu0Cdzpppe1lUgCZGCQ: bets $1.25
yzFNNFIfC89bBPwpFPx2ow: calls $1.25
*** TURN *** [Ts 4c 5h] [6h]
4YSTu0Cdzpppe1lUgCZGCQ: checks 
yzFNNFIfC89bBPwpFPx2ow: bets $2.75
4YSTu0Cdzpppe1lUgCZGCQ: raises $5.75 to $8.50
yzFNNFIfC89bBPwpFPx2ow: calls $5.75
*** RIVER *** [Ts 4c 5h 6h] [Ad]
4YSTu0Cdzpppe1lUgCZGCQ: bets $24.40 and is all-in
yzFNNFIfC89bBPwpFPx2ow: calls $18.10 and is all-in
Uncalled bet ($6.30) returned to 4YSTu0Cdzpppe1lUgCZGCQ
*** SHOW DOWN ***
4YSTu0Cdzpppe1lUgCZGCQ: shows [6s 6d] (three of a kind, Sixes)
yzFNNFIfC89bBPwpFPx2ow: mucks hand 
4YSTu0Cdzpppe1lUgCZGCQ collected $56.05 from pot
*** SUMMARY ***
Total pot $58.05 | Rake $2 
Board [Ts 4c 5h 6h Ad]
Seat 1: yzFNNFIfC89bBPwpFPx2ow (button) mucked
Seat 3: 32YL2ZEp8NT4JB2RVM9euQ (small blind) folded before Flop
Seat 4: /gJNBeCkWL4o85/jvlZ4BA (big blind) folded before Flop
Seat 5: 4YSTu0Cdzpppe1lUgCZGCQ showed [6s 6d] and won ($56.05) with three of a kind, Sixes
Seat 6: 7FmwVDcdEtxDpHmP4hOXsQ folded before Flop (didn't bet)




PokerStars Game #59939518342:  Hold'em No Limit ($0.10/$0.25) - 2009/07/01 0:41:57 ET
Table 'aaXqTKUnxrX9DYXtxhWXxA' 6-max Seat #6 is the button
Seat 1: njVkfGYrPiXfq4zLcgfVuA ($12.40 in chips) 
Seat 2: 1Zyw8DT57U6TzxWWRixa6Q ($13.80 in chips) 
Seat 3: cPO/1/dTcZpLkQFm3jH3Rg ($25 in chips) 
Seat 5: kyRaCIljYA6l33lSKQfNsg ($24.90 in chips) 
Seat 6: buyjetgNT1McXtdaP4zynA ($22.10 in chips) 
njVkfGYrPiXfq4zLcgfVuA: posts small blind $0.10
1Zyw8DT57U6TzxWWRixa6Q: posts big blind $0.25
*** HOLE CARDS ***
cPO/1/dTcZpLkQFm3jH3Rg: folds 
kyRaCIljYA6l33lSKQfNsg: folds 
buyjetgNT1McXtdaP4zynA: raises $0.75 to $1
njVkfGYrPiXfq4zLcgfVuA: folds 
1Zyw8DT57U6TzxWWRixa6Q: calls $0.75
*** FLOP *** [Ah Kh Jc]
1Zyw8DT57U6TzxWWRixa6Q: checks 
buyjetgNT1McXtdaP4zynA: checks 
*** TURN *** [Ah Kh Jc] [9s]
1Zyw8DT57U6TzxWWRixa6Q: bets $2
buyjetgNT1McXtdaP4zynA: calls $2
*** RIVER *** [Ah Kh Jc 9s] [Th]
1Zyw8DT57U6TzxWWRixa6Q: checks 
buyjetgNT1McXtdaP4zynA: bets $4.75
1Zyw8DT57U6TzxWWRixa6Q: calls $4.75
*** SHOW DOWN ***
buyjetgNT1McXtdaP4zynA: shows [Qh Ad] (a straight, Ten to Ace)
1Zyw8DT57U6TzxWWRixa6Q: shows [Jd Ac] (two pair, Aces and Jacks)
buyjetgNT1McXtdaP4zynA collected $14.85 from pot
*** SUMMARY ***
Total pot $15.60 | Rake $0.75 
Board [Ah Kh Jc 9s Th]
Seat 1: njVkfGYrPiXfq4zLcgfVuA (small blind) folded before Flop
Seat 2: 1Zyw8DT57U6TzxWWRixa6Q (big blind) showed [Jd Ac] and lost with two pair, Aces and Jacks
Seat 3: cPO/1/dTcZpLkQFm3jH3Rg folded before Flop (didn't bet)
Seat 5: kyRaCIljYA6l33lSKQfNsg folded before Flop (didn't bet)
Seat 6: buyjetgNT1McXtdaP4zynA (button) showed [Qh Ad] and won ($14.85) with a straight, Ten to Ace




PokerStars Game #59939518186:  Hold'em No Limit ($0.10/$0.25) - 2009/07/01 0:41:57 ET
Table '8QBBaev+cI2i/r2H6ml/lg' 9-max Seat #9 is the button
Seat 4: ZoG0obuajzVjwgd7lNHjgg ($1.65 in chips) 
Seat 6: cxE+szmvEUe7vE+z2ozM2Q ($10.50 in chips) 
Seat 9: Ml2bY77EHbM51ZWD7dnIWg ($3.20 in chips) 
ZoG0obuajzVjwgd7lNHjgg: posts small blind $0.10
cxE+szmvEUe7vE+z2ozM2Q: posts big blind $0.25
*** HOLE CARDS ***
Ml2bY77EHbM51ZWD7dnIWg: calls $0.25
ZoG0obuajzVjwgd7lNHjgg: calls $0.15
cxE+szmvEUe7vE+z2ozM2Q: checks 
*** FLOP *** [6d Jd 8s]
ZoG0obuajzVjwgd7lNHjgg: checks 
cxE+szmvEUe7vE+z2ozM2Q: bets $10.25 and is all-in
Ml2bY77EHbM51ZWD7dnIWg: folds 
ZoG0obuajzVjwgd7lNHjgg: folds 
Uncalled bet ($10.25) returned to cxE+szmvEUe7vE+z2ozM2Q
cxE+szmvEUe7vE+z2ozM2Q collected $0.75 from pot
*** SUMMARY ***
Total pot $0.75 | Rake $0 
Board [6d Jd 8s]
Seat 4: ZoG0obuajzVjwgd7lNHjgg (small blind) folded on the Flop
Seat 6: cxE+szmvEUe7vE+z2ozM2Q (big blind) collected ($0.75)
Seat 9: Ml2bY77EHbM51ZWD7dnIWg (button) folded on the Flop




PokerStars Game #59939518530:  Hold'em No Limit ($0.10/$0.25) - 2009/07/01 0:41:57 ET
Table 'APEHQjIcZHDZUA4iOjju2g' 6-max Seat #4 is the button
Seat 1: eHsmIvAb2JREg4O6hNPnXg ($8 in chips) 
Seat 2: 3zD3qLXT1bEffAoWGnc7wg ($25 in chips) 
Seat 3: E7KSkgfIsmIsp0vLnmGFmA ($13.70 in chips) 
Seat 4: EqXTTLKUlDlz7yi6ziyyWA ($37.50 in chips) 
Seat 5: /xN6gc9+8Hew0HxaB6VIVg ($29.60 in chips) 
Seat 6: y7HCJfEmolBCFdi/0j5TRg ($44.70 in chips) 
/xN6gc9+8Hew0HxaB6VIVg: posts small blind $0.10
y7HCJfEmolBCFdi/0j5TRg: posts big blind $0.25
*** HOLE CARDS ***
eHsmIvAb2JREg4O6hNPnXg: raises $0.50 to $0.75
3zD3qLXT1bEffAoWGnc7wg: folds 
E7KSkgfIsmIsp0vLnmGFmA: folds 
EqXTTLKUlDlz7yi6ziyyWA: folds 
/xN6gc9+8Hew0HxaB6VIVg: calls $0.65
y7HCJfEmolBCFdi/0j5TRg: folds 
*** FLOP *** [Ts 9d 6c]
/xN6gc9+8Hew0HxaB6VIVg: bets $0.50
eHsmIvAb2JREg4O6hNPnXg: calls $0.50
*** TURN *** [Ts 9d 6c] [3s]
/xN6gc9+8Hew0HxaB6VIVg: bets $0.75
eHsmIvAb2JREg4O6hNPnXg: folds 
Uncalled bet ($0.75) returned to /xN6gc9+8Hew0HxaB6VIVg
/xN6gc9+8Hew0HxaB6VIVg collected $2.65 from pot
/xN6gc9+8Hew0HxaB6VIVg: doesn't show hand 
*** SUMMARY ***
Total pot $2.75 | Rake $0.10 
Board [Ts 9d 6c 3s]
Seat 1: eHsmIvAb2JREg4O6hNPnXg folded on the Turn
Seat 2: 3zD3qLXT1bEffAoWGnc7wg folded before Flop (didn't bet)
Seat 3: E7KSkgfIsmIsp0vLnmGFmA folded before Flop (didn't bet)
Seat 4: EqXTTLKUlDlz7yi6ziyyWA (button) folded before Flop (didn't bet)
Seat 5: /xN6gc9+8Hew0HxaB6VIVg (small blind) collected ($2.65)
Seat 6: y7HCJfEmolBCFdi/0j5TRg (big blind) folded before Flop




PokerStars Game #59939520496:  Hold'em No Limit ($0.10/$0.25) - 2009/07/01 0:41:58 ET
Table '0w9m+UkNlGMNoPyQqzWk6A' 9-max Seat #6 is the button
Seat 1: 28AHlgXlrYLdiBUJNBoqWA ($25.05 in chips) 
Seat 2: tYsOBqdU1+x+yFI7zHO7hQ ($46.20 in chips) 
Seat 3: VWwtMkIjXloiX/RKh7RGWQ ($8.25 in chips) 
Seat 5: rPXwQUVloUl+qZm3CCtaJw ($17 in chips) 
Seat 6: sWBBy1WroEskLNyJzhkUag ($16.15 in chips) 
Seat 7: lrTLp1zpuCCs/e0pi2M8jw ($8.40 in chips) 
Seat 8: hPhp/RE3cJ5YGaQ2xOHXXg ($5.75 in chips) 
Seat 9: 56S3mA6Zs3pGR+0p0vUCtg ($28.90 in chips) 
lrTLp1zpuCCs/e0pi2M8jw: posts small blind $0.10
hPhp/RE3cJ5YGaQ2xOHXXg: posts big blind $0.25
*** HOLE CARDS ***
56S3mA6Zs3pGR+0p0vUCtg: folds 
28AHlgXlrYLdiBUJNBoqWA: calls $0.25
VBHxUExRAMrbxUq/cVx9Gw joins the table at seat #4 
tYsOBqdU1+x+yFI7zHO7hQ: folds 
VWwtMkIjXloiX/RKh7RGWQ: calls $0.25
rPXwQUVloUl+qZm3CCtaJw: folds 
sWBBy1WroEskLNyJzhkUag: raises $0.75 to $1
lrTLp1zpuCCs/e0pi2M8jw: calls $0.90
hPhp/RE3cJ5YGaQ2xOHXXg: folds 
28AHlgXlrYLdiBUJNBoqWA: calls $0.75
VWwtMkIjXloiX/RKh7RGWQ: calls $0.75
*** FLOP *** [3s Tc 7h]
lrTLp1zpuCCs/e0pi2M8jw: checks 
28AHlgXlrYLdiBUJNBoqWA: checks 
VWwtMkIjXloiX/RKh7RGWQ: checks 
sWBBy1WroEskLNyJzhkUag: bets $1.50
lrTLp1zpuCCs/e0pi2M8jw: folds 
28AHlgXlrYLdiBUJNBoqWA: folds 
VWwtMkIjXloiX/RKh7RGWQ: calls $1.50
*** TURN *** [3s Tc 7h] [Ah]
VWwtMkIjXloiX/RKh7RGWQ: checks 
sWBBy1WroEskLNyJzhkUag: checks 
*** RIVER *** [3s Tc 7h Ah] [4h]
VWwtMkIjXloiX/RKh7RGWQ: checks 
sWBBy1WroEskLNyJzhkUag: bets $3
VWwtMkIjXloiX/RKh7RGWQ: folds 
Uncalled bet ($3) returned to sWBBy1WroEskLNyJzhkUag
sWBBy1WroEskLNyJzhkUag collected $6.90 from pot
sWBBy1WroEskLNyJzhkUag: doesn't show hand 
*** SUMMARY ***
Total pot $7.25 | Rake $0.35 
Board [3s Tc 7h Ah 4h]
Seat 1: 28AHlgXlrYLdiBUJNBoqWA folded on the Flop
Seat 2: tYsOBqdU1+x+yFI7zHO7hQ folded before Flop (didn't bet)
Seat 3: VWwtMkIjXloiX/RKh7RGWQ folded on the River
Seat 5: rPXwQUVloUl+qZm3CCtaJw folded before Flop (didn't bet)
Seat 6: sWBBy1WroEskLNyJzhkUag (button) collected ($6.90)
Seat 7: lrTLp1zpuCCs/e0pi2M8jw (small blind) folded on the Flop
Seat 8: hPhp/RE3cJ5YGaQ2xOHXXg (big blind) folded before Flop
Seat 9: 56S3mA6Zs3pGR+0p0vUCtg folded before Flop (didn't bet)




PokerStars Game #59939520492:  Hold'em No Limit ($0.10/$0.25) - 2009/07/01 0:41:58 ET
Table '2clPgY3+dETPD/8zjXZdFw' 6-max Seat #2 is the button
Seat 1: qllppsCmUqovlriIWCeM/g ($3.55 in chips) 
Seat 2: NzIFHwilc5zU7QhjDTgTZA ($7.10 in chips) 
Seat 3: 6pF9LtHn+EH0ChbOXzox9g ($3.20 in chips) 
Seat 4: 9KPR3sZ+CxRm7bQ8qxFzMQ ($5.25 in chips) 
6pF9LtHn+EH0ChbOXzox9g: posts small blind $0.10
9KPR3sZ+CxRm7bQ8qxFzMQ: posts big blind $0.25
*** HOLE CARDS ***
headtraumajr joins the table at seat #6 
qllppsCmUqovlriIWCeM/g: folds 
NzIFHwilc5zU7QhjDTgTZA: calls $0.25
6pF9LtHn+EH0ChbOXzox9g: calls $0.15
9KPR3sZ+CxRm7bQ8qxFzMQ: checks 
*** FLOP *** [4c Kh 9h]
6pF9LtHn+EH0ChbOXzox9g: bets $0.75
9KPR3sZ+CxRm7bQ8qxFzMQ: calls $0.75
NzIFHwilc5zU7QhjDTgTZA: folds 
*** TURN *** [4c Kh 9h] [6h]
6pF9LtHn+EH0ChbOXzox9g: checks 
9KPR3sZ+CxRm7bQ8qxFzMQ: checks 
*** RIVER *** [4c Kh 9h 6h] [Kd]
6pF9LtHn+EH0ChbOXzox9g: checks 
9KPR3sZ+CxRm7bQ8qxFzMQ: checks 
*** SHOW DOWN ***
6pF9LtHn+EH0ChbOXzox9g: shows [Ad 9c] (two pair, Kings and Nines)
9KPR3sZ+CxRm7bQ8qxFzMQ: mucks hand 
6pF9LtHn+EH0ChbOXzox9g collected $2.15 from pot
*** SUMMARY ***
Total pot $2.25 | Rake $0.10 
Board [4c Kh 9h 6h Kd]
Seat 1: qllppsCmUqovlriIWCeM/g folded before Flop (didn't bet)
Seat 2: NzIFHwilc5zU7QhjDTgTZA (button) folded on the Flop
Seat 3: 6pF9LtHn+EH0ChbOXzox9g (small blind) showed [Ad 9c] and won ($2.15) with two pair, Kings and Nines
Seat 4: 9KPR3sZ+CxRm7bQ8qxFzMQ (big blind) mucked




PokerStars Game #59939520698:  Hold'em No Limit ($0.10/$0.25) - 2009/07/01 0:41:59 ET
Table 'h02LhQ7B/Zk4ETRxxHhGYA' 9-max Seat #5 is the button
Seat 1: sD+TKtt36XiiN6jqHiLwDA ($25 in chips) 
Seat 2: RJ/x9oZtt1RZLaJEQwZOxQ ($27.45 in chips) 
Seat 4: tYsOBqdU1+x+yFI7zHO7hQ ($38.20 in chips) 
Seat 5: cUxk0Jk4lrUQv9CJl0LPlg ($18.35 in chips) 
Seat 6: kN/irnQSdb8jibbN4f1O+Q ($17.80 in chips) 
Seat 7: rUpvA02nErFvZ4yFbDR8XA ($19.45 in chips) 
Seat 8: 7tW694tRVJnYdoa16Dw4RQ ($25.20 in chips) 
Seat 9: 1c/7DHPx5CDTmAfk8/bWeA ($16.25 in chips) 
kN/irnQSdb8jibbN4f1O+Q: posts small blind $0.10
rUpvA02nErFvZ4yFbDR8XA: posts big blind $0.25
*** HOLE CARDS ***
7tW694tRVJnYdoa16Dw4RQ: folds 
kqpa/IbqkUrwPb3hbA7/ww has returned
1c/7DHPx5CDTmAfk8/bWeA: folds 
sD+TKtt36XiiN6jqHiLwDA: folds 
RJ/x9oZtt1RZLaJEQwZOxQ: folds 
tYsOBqdU1+x+yFI7zHO7hQ: folds 
cUxk0Jk4lrUQv9CJl0LPlg: folds 
kN/irnQSdb8jibbN4f1O+Q: folds 
Uncalled bet ($0.15) returned to rUpvA02nErFvZ4yFbDR8XA
kqpa/IbqkUrwPb3hbA7/ww is sitting out
rUpvA02nErFvZ4yFbDR8XA collected $0.20 from pot
rUpvA02nErFvZ4yFbDR8XA: doesn't show hand 
*** SUMMARY ***
Total pot $0.20 | Rake $0 
Seat 1: sD+TKtt36XiiN6jqHiLwDA folded before Flop (didn't bet)
Seat 2: RJ/x9oZtt1RZLaJEQwZOxQ folded before Flop (didn't bet)
Seat 4: tYsOBqdU1+x+yFI7zHO7hQ folded before Flop (didn't bet)
Seat 5: cUxk0Jk4lrUQv9CJl0LPlg (button) folded before Flop (didn't bet)
Seat 6: kN/irnQSdb8jibbN4f1O+Q (small blind) folded before Flop
Seat 7: rUpvA02nErFvZ4yFbDR8XA (big blind) collected ($0.20)
Seat 8: 7tW694tRVJnYdoa16Dw4RQ folded before Flop (didn't bet)
Seat 9: 1c/7DHPx5CDTmAfk8/bWeA folded before Flop (didn't bet)




PokerStars Game #59939520744:  Hold'em No Limit ($0.10/$0.25) - 2009/07/01 0:41:59 ET
Table 'IrJPyZ3JW2iIa+krdoSbJQ' 9-max Seat #4 is the button
Seat 1: 4+E2msto8r80F3SH2gctVA ($25.10 in chips) 
Seat 2: DdPXdieucQ+n99u1n3A+rQ ($9.30 in chips) 
Seat 3: vZGoOTJLQLhkPj4I+LNGig ($25 in chips) 
Seat 4: DnDcAdn9P0zGovMERigpFA ($25 in chips) 
Seat 5: sUVgUtgbfVx6JpvApozwhQ ($6.20 in chips) 
Seat 6: +sbyWwIcFp9kP0bDtMegfQ ($24.30 in chips) 
Seat 7: uH1RN27w9SKa7TpVR9EFrQ ($22.45 in chips) 
Seat 8: VBHxUExRAMrbxUq/cVx9Gw ($5 in chips) 
Seat 9: SXqVW4Q0evTUVZG6BbUNIA ($29.30 in chips) 
sUVgUtgbfVx6JpvApozwhQ: posts small blind $0.10
+sbyWwIcFp9kP0bDtMegfQ: posts big blind $0.25
*** HOLE CARDS ***
uH1RN27w9SKa7TpVR9EFrQ: folds 
VBHxUExRAMrbxUq/cVx9Gw: folds 
SXqVW4Q0evTUVZG6BbUNIA: folds 
4+E2msto8r80F3SH2gctVA: folds 
DdPXdieucQ+n99u1n3A+rQ: folds 
vZGoOTJLQLhkPj4I+LNGig: folds 
DnDcAdn9P0zGovMERigpFA: folds 
sUVgUtgbfVx6JpvApozwhQ: folds 
Uncalled bet ($0.15) returned to +sbyWwIcFp9kP0bDtMegfQ
+sbyWwIcFp9kP0bDtMegfQ collected $0.20 from pot
+sbyWwIcFp9kP0bDtMegfQ: doesn't show hand 
*** SUMMARY ***
Total pot $0.20 | Rake $0 
Seat 1: 4+E2msto8r80F3SH2gctVA folded before Flop (didn't bet)
Seat 2: DdPXdieucQ+n99u1n3A+rQ folded before Flop (didn't bet)
Seat 3: vZGoOTJLQLhkPj4I+LNGig folded before Flop (didn't bet)
Seat 4: DnDcAdn9P0zGovMERigpFA (button) folded before Flop (didn't bet)
Seat 5: sUVgUtgbfVx6JpvApozwhQ (small blind) folded before Flop
Seat 6: +sbyWwIcFp9kP0bDtMegfQ (big blind) collected ($0.20)
Seat 7: uH1RN27w9SKa7TpVR9EFrQ folded before Flop (didn't bet)
Seat 8: VBHxUExRAMrbxUq/cVx9Gw folded before Flop (didn't bet)
Seat 9: SXqVW4Q0evTUVZG6BbUNIA folded before Flop (didn't bet)




PokerStars Game #59939520600:  Hold'em No Limit ($0.10/$0.25) - 2009/07/01 0:41:59 ET
Table 'nyTW9cVtYentc5V7xU/0jA' 6-max Seat #6 is the button
Seat 1: YfxPRDAWfqnGBhiIEdlTYg ($11.40 in chips) 
Seat 2: 7FmwVDcdEtxDpHmP4hOXsQ ($25 in chips) 
Seat 3: kG34n23qFQA3nzdOJTQ1dA ($24.55 in chips) 
Seat 4: r6u7MWSXF30/khcTYkrG9Q ($34.20 in chips) 
Seat 5: BedjMfrlRfPgSq7CXpPAmg ($28.80 in chips) 
Seat 6: dQJByDqHOLbgqX/HobyAJA ($7.35 in chips) 
YfxPRDAWfqnGBhiIEdlTYg: posts small blind $0.10
7FmwVDcdEtxDpHmP4hOXsQ: posts big blind $0.25
*** HOLE CARDS ***
kG34n23qFQA3nzdOJTQ1dA: folds 
r6u7MWSXF30/khcTYkrG9Q: raises $0.50 to $0.75
BedjMfrlRfPgSq7CXpPAmg: folds 
dQJByDqHOLbgqX/HobyAJA: folds 
YfxPRDAWfqnGBhiIEdlTYg: folds 
7FmwVDcdEtxDpHmP4hOXsQ: folds 
Uncalled bet ($0.50) returned to r6u7MWSXF30/khcTYkrG9Q
r6u7MWSXF30/khcTYkrG9Q collected $0.60 from pot
*** SUMMARY ***
Total pot $0.60 | Rake $0 
Seat 1: YfxPRDAWfqnGBhiIEdlTYg (small blind) folded before Flop
Seat 2: 7FmwVDcdEtxDpHmP4hOXsQ (big blind) folded before Flop
Seat 3: kG34n23qFQA3nzdOJTQ1dA folded before Flop (didn't bet)
Seat 4: r6u7MWSXF30/khcTYkrG9Q collected ($0.60)
Seat 5: BedjMfrlRfPgSq7CXpPAmg folded before Flop (didn't bet)
Seat 6: dQJByDqHOLbgqX/HobyAJA (button) folded before Flop (didn't bet)




PokerStars Game #59939520656:  Hold'em No Limit ($0.10/$0.25) - 2009/07/01 0:41:59 ET
Table 'ggwTHpIC5qhhHJSYjK1XCw' 6-max Seat #4 is the button
Seat 1: BYxjLnV1/LL0aZcTbfAOvw ($29 in chips) 
Seat 2: mBAp/L4XPhNEkNUlUTV4Iw ($16.05 in chips) 
Seat 3: SxIIgwXYLkwd6m3wLyPTCw ($25 in chips) 
Seat 4: JFIAqU8lCZ0vWwEl4bdGsg ($25.40 in chips) 
Seat 5: 6zbQpY/G44U1Xvj7DZex0A ($21.80 in chips) 
Seat 6: QOk5VUJeDqXaA3RlMSluGA ($11.20 in chips) 
6zbQpY/G44U1Xvj7DZex0A: posts small blind $0.10
QOk5VUJeDqXaA3RlMSluGA: posts big blind $0.25
*** HOLE CARDS ***
BYxjLnV1/LL0aZcTbfAOvw: raises $0.75 to $1
mBAp/L4XPhNEkNUlUTV4Iw: folds 
SxIIgwXYLkwd6m3wLyPTCw: folds 
JFIAqU8lCZ0vWwEl4bdGsg: folds 
6zbQpY/G44U1Xvj7DZex0A: calls $0.90
QOk5VUJeDqXaA3RlMSluGA: calls $0.75
*** FLOP *** [7d 5d 9s]
6zbQpY/G44U1Xvj7DZex0A: bets $0.25
QOk5VUJeDqXaA3RlMSluGA: raises $1.85 to $2.10
BYxjLnV1/LL0aZcTbfAOvw: raises $3.90 to $6
6zbQpY/G44U1Xvj7DZex0A: folds 
QOk5VUJeDqXaA3RlMSluGA: calls $3.90
*** TURN *** [7d 5d 9s] [Ks]
QOk5VUJeDqXaA3RlMSluGA: checks 
BYxjLnV1/LL0aZcTbfAOvw: bets $6.50
QOk5VUJeDqXaA3RlMSluGA: calls $4.20 and is all-in
Uncalled bet ($2.30) returned to BYxjLnV1/LL0aZcTbfAOvw
*** RIVER *** [7d 5d 9s Ks] [6c]
*** SHOW DOWN ***
QOk5VUJeDqXaA3RlMSluGA: shows [Ah 6s] (a pair of Sixes)
BYxjLnV1/LL0aZcTbfAOvw: shows [Qd Qs] (a pair of Queens)
BYxjLnV1/LL0aZcTbfAOvw collected $22.55 from pot
*** SUMMARY ***
Total pot $23.65 | Rake $1.10 
Board [7d 5d 9s Ks 6c]
Seat 1: BYxjLnV1/LL0aZcTbfAOvw showed [Qd Qs] and won ($22.55) with a pair of Queens
Seat 2: mBAp/L4XPhNEkNUlUTV4Iw folded before Flop (didn't bet)
Seat 3: SxIIgwXYLkwd6m3wLyPTCw folded before Flop (didn't bet)
Seat 4: JFIAqU8lCZ0vWwEl4bdGsg (button) folded before Flop (didn't bet)
Seat 5: 6zbQpY/G44U1Xvj7DZex0A (small blind) folded on the Flop
Seat 6: QOk5VUJeDqXaA3RlMSluGA (big blind) showed [Ah 6s] and lost with a pair of Sixes




PokerStars Game #59939520866:  Hold'em No Limit ($0.10/$0.25) - 2009/07/01 0:41:59 ET
Table 'luMgmRPIo47e7iXDlheIwA' 6-max Seat #3 is the button
Seat 1: z/jAqpWD9ifpbtEpwGyInw ($5.20 in chips) 
Seat 3: W6Y6au0wf7gRAlqJYgOezw ($14.60 in chips) 
Seat 4: n2OZezRXTtdzQt4SuIy8TQ ($25.90 in chips) 
n2OZezRXTtdzQt4SuIy8TQ: posts small blind $0.10
z/jAqpWD9ifpbtEpwGyInw: posts big blind $0.25
*** HOLE CARDS ***
W6Y6au0wf7gRAlqJYgOezw: calls $0.25
n2OZezRXTtdzQt4SuIy8TQ: folds 
z/jAqpWD9ifpbtEpwGyInw: checks 
*** FLOP *** [Ks 5d Qd]
z/jAqpWD9ifpbtEpwGyInw: checks 
W6Y6au0wf7gRAlqJYgOezw: bets $0.25
z/jAqpWD9ifpbtEpwGyInw: folds 
Uncalled bet ($0.25) returned to W6Y6au0wf7gRAlqJYgOezw
W6Y6au0wf7gRAlqJYgOezw collected $0.60 from pot
*** SUMMARY ***
Total pot $0.60 | Rake $0 
Board [Ks 5d Qd]
Seat 1: z/jAqpWD9ifpbtEpwGyInw (big blind) folded on the Flop
Seat 3: W6Y6au0wf7gRAlqJYgOezw (button) collected ($0.60)
Seat 4: n2OZezRXTtdzQt4SuIy8TQ (small blind) folded before Flop




PokerStars Game #59939520974:  Hold'em No Limit ($0.10/$0.25) - 2009/07/01 0:41:59 ET
Table 'M7d9IrgQUUFFy/SZ3ksLYg' 6-max Seat #1 is the button
Seat 1: cPO/1/dTcZpLkQFm3jH3Rg ($32.30 in chips) 
Seat 2: JE/wJXmjw3bpdmjwvh2pcg ($26.80 in chips) 
Seat 3: eHsmIvAb2JREg4O6hNPnXg ($16.05 in chips) 
Seat 4: 7FmwVDcdEtxDpHmP4hOXsQ ($29.90 in chips) 
Seat 6: /gJNBeCkWL4o85/jvlZ4BA ($25.15 in chips) 
JE/wJXmjw3bpdmjwvh2pcg: posts small blind $0.10
eHsmIvAb2JREg4O6hNPnXg: posts big blind $0.25
*** HOLE CARDS ***
7FmwVDcdEtxDpHmP4hOXsQ: folds 
/gJNBeCkWL4o85/jvlZ4BA: folds 
cPO/1/dTcZpLkQFm3jH3Rg: raises $0.55 to $0.80
JE/wJXmjw3bpdmjwvh2pcg: calls $0.70
eHsmIvAb2JREg4O6hNPnXg: calls $0.55
*** FLOP *** [Qc Tc Kd]
JE/wJXmjw3bpdmjwvh2pcg: checks 
eHsmIvAb2JREg4O6hNPnXg: checks 
cPO/1/dTcZpLkQFm3jH3Rg: bets $1.70
JE/wJXmjw3bpdmjwvh2pcg: calls $1.70
eHsmIvAb2JREg4O6hNPnXg: folds 
*** TURN *** [Qc Tc Kd] [3c]
JE/wJXmjw3bpdmjwvh2pcg: checks 
cPO/1/dTcZpLkQFm3jH3Rg: checks 
*** RIVER *** [Qc Tc Kd 3c] [Kc]
JE/wJXmjw3bpdmjwvh2pcg: checks 
cPO/1/dTcZpLkQFm3jH3Rg: checks 
*** SHOW DOWN ***
JE/wJXmjw3bpdmjwvh2pcg: shows [Qd 9d] (two pair, Kings and Queens)
cPO/1/dTcZpLkQFm3jH3Rg: shows [Jh Ks] (three of a kind, Kings)
cPO/1/dTcZpLkQFm3jH3Rg collected $5.55 from pot
*** SUMMARY ***
Total pot $5.80 | Rake $0.25 
Board [Qc Tc Kd 3c Kc]
Seat 1: cPO/1/dTcZpLkQFm3jH3Rg (button) showed [Jh Ks] and won ($5.55) with three of a kind, Kings
Seat 2: JE/wJXmjw3bpdmjwvh2pcg (small blind) showed [Qd 9d] and lost with two pair, Kings and Queens
Seat 3: eHsmIvAb2JREg4O6hNPnXg (big blind) folded on the Flop
Seat 4: 7FmwVDcdEtxDpHmP4hOXsQ folded before Flop (didn't bet)
Seat 6: /gJNBeCkWL4o85/jvlZ4BA folded before Flop (didn't bet)




PokerStars Game #59939520884:  Hold'em No Limit ($0.10/$0.25) - 2009/07/01 0:41:59 ET
Table 'NfXsh0UQA+o/kO9acV3WxA' 9-max Seat #8 is the button
Seat 1: H5Se03ZqSX7tbULXur2MAg ($24.30 in chips) 
Seat 3: 1K6QGyJP9P9xmRac2fH4OQ ($37.80 in chips) 
Seat 4: sQ6szDwWrE+LMh1p4dVexA ($17.10 in chips) 
Seat 5: 3RCAkueG3Vc13VpRStCB+w ($37.80 in chips) 
Seat 7: HPEB+AtKw1+C/cxU0o1ciw ($31.60 in chips) 
Seat 8: +sbyWwIcFp9kP0bDtMegfQ ($24.65 in chips) 
Seat 9: MgMavn/DzTzqKgHTZMsVSw ($24.75 in chips) 
MgMavn/DzTzqKgHTZMsVSw: posts small blind $0.10
H5Se03ZqSX7tbULXur2MAg: posts big blind $0.25
*** HOLE CARDS ***
1K6QGyJP9P9xmRac2fH4OQ: folds 
sQ6szDwWrE+LMh1p4dVexA: folds 
3RCAkueG3Vc13VpRStCB+w: folds 
HPEB+AtKw1+C/cxU0o1ciw: folds 
+sbyWwIcFp9kP0bDtMegfQ: folds 
MgMavn/DzTzqKgHTZMsVSw: folds 
Uncalled bet ($0.15) returned to H5Se03ZqSX7tbULXur2MAg
H5Se03ZqSX7tbULXur2MAg collected $0.20 from pot
*** SUMMARY ***
Total pot $0.20 | Rake $0 
Seat 1: H5Se03ZqSX7tbULXur2MAg (big blind) collected ($0.20)
Seat 3: 1K6QGyJP9P9xmRac2fH4OQ folded before Flop (didn't bet)
Seat 4: sQ6szDwWrE+LMh1p4dVexA folded before Flop (didn't bet)
Seat 5: 3RCAkueG3Vc13VpRStCB+w folded before Flop (didn't bet)
Seat 7: HPEB+AtKw1+C/cxU0o1ciw folded before Flop (didn't bet)
Seat 8: +sbyWwIcFp9kP0bDtMegfQ (button) folded before Flop (didn't bet)
Seat 9: MgMavn/DzTzqKgHTZMsVSw (small blind) folded before Flop




PokerStars Game #59939520918:  Hold'em No Limit ($0.10/$0.25) - 2009/07/01 0:41:59 ET
Table 'SgI2Cobdjtkh0Fd0/eTTDg' 9-max Seat #1 is the button
Seat 1: JRfCWETUoKaEo7sf/Jy3Kg ($23.90 in chips) 
Seat 2: 8B/dhbQjIWe6ASCdgzktNQ ($41.95 in chips) 
Seat 3: OiV1PWZ3IkN29JlmCcnTwQ ($4.90 in chips) 
Seat 4: 18G4P1XstjNvItdGUITxgw ($25 in chips) 
Seat 5: w/RUHfVzKTf7Bc19nucLpQ ($9.45 in chips) 
Seat 7: aJy680tKSaP5er559aSuGA ($22.35 in chips) 
Seat 9: cZ99hugmLBj9KhTlc8nCSw ($25.55 in chips) 
8B/dhbQjIWe6ASCdgzktNQ: posts small blind $0.10
OiV1PWZ3IkN29JlmCcnTwQ: posts big blind $0.25
*** HOLE CARDS ***
18G4P1XstjNvItdGUITxgw: folds 
w/RUHfVzKTf7Bc19nucLpQ: folds 
aJy680tKSaP5er559aSuGA: raises $0.35 to $0.60
cZ99hugmLBj9KhTlc8nCSw: raises $1.15 to $1.75
JRfCWETUoKaEo7sf/Jy3Kg: calls $1.75
8B/dhbQjIWe6ASCdgzktNQ: folds 
OiV1PWZ3IkN29JlmCcnTwQ: folds 
aJy680tKSaP5er559aSuGA: calls $1.15
*** FLOP *** [7h Qh Th]
aJy680tKSaP5er559aSuGA: checks 
cZ99hugmLBj9KhTlc8nCSw: checks 
JRfCWETUoKaEo7sf/Jy3Kg: checks 
*** TURN *** [7h Qh Th] [Ks]
aJy680tKSaP5er559aSuGA: checks 
cZ99hugmLBj9KhTlc8nCSw: checks 
JRfCWETUoKaEo7sf/Jy3Kg: bets $3.25
aJy680tKSaP5er559aSuGA: folds 
cZ99hugmLBj9KhTlc8nCSw: calls $3.25
*** RIVER *** [7h Qh Th Ks] [4c]
cZ99hugmLBj9KhTlc8nCSw: checks 
JRfCWETUoKaEo7sf/Jy3Kg: checks 
*** SHOW DOWN ***
cZ99hugmLBj9KhTlc8nCSw: shows [9d 9c] (a pair of Nines)
JRfCWETUoKaEo7sf/Jy3Kg: shows [Ts Jd] (a pair of Tens)
JRfCWETUoKaEo7sf/Jy3Kg collected $11.55 from pot
*** SUMMARY ***
Total pot $12.10 | Rake $0.55 
Board [7h Qh Th Ks 4c]
Seat 1: JRfCWETUoKaEo7sf/Jy3Kg (button) showed [Ts Jd] and won ($11.55) with a pair of Tens
Seat 2: 8B/dhbQjIWe6ASCdgzktNQ (small blind) folded before Flop
Seat 3: OiV1PWZ3IkN29JlmCcnTwQ (big blind) folded before Flop
Seat 4: 18G4P1XstjNvItdGUITxgw folded before Flop (didn't bet)
Seat 5: w/RUHfVzKTf7Bc19nucLpQ folded before Flop (didn't bet)
Seat 7: aJy680tKSaP5er559aSuGA folded on the Turn
Seat 9: cZ99hugmLBj9KhTlc8nCSw showed [9d 9c] and lost with a pair of Nines




PokerStars Game #59939521266:  Hold'em No Limit ($0.10/$0.25) - 2009/07/01 0:42:00 ET
Table 'Zi9/NqNs3XoL1eWhMCyZyg' 9-max Seat #6 is the button
Seat 2: Th3FldXKQW6hWVVPahaoOQ ($31.05 in chips) 
Seat 3: rUpvA02nErFvZ4yFbDR8XA ($21.65 in chips) 
Seat 4: D3XCkXRktDfPlSguxwfnRA ($13 in chips) 
Seat 5: OiV1PWZ3IkN29JlmCcnTwQ ($4.90 in chips) 
Seat 6: b3P5tPsBbrP+aAO9+Ts/Nw ($37.10 in chips) 
Seat 7: qul+IMROTuFj45eWi2Tpvg ($49.55 in chips) 
Seat 9: tYsOBqdU1+x+yFI7zHO7hQ ($31.10 in chips) 
qul+IMROTuFj45eWi2Tpvg: posts small blind $0.10
tYsOBqdU1+x+yFI7zHO7hQ: posts big blind $0.25
opOCI2p6kW0tINuVaAqmcQ: sits out 
*** HOLE CARDS ***
Th3FldXKQW6hWVVPahaoOQ: folds 
rUpvA02nErFvZ4yFbDR8XA: folds 
D3XCkXRktDfPlSguxwfnRA: calls $0.25
OiV1PWZ3IkN29JlmCcnTwQ: folds 
b3P5tPsBbrP+aAO9+Ts/Nw: folds 
qul+IMROTuFj45eWi2Tpvg: calls $0.15
tYsOBqdU1+x+yFI7zHO7hQ: checks 
*** FLOP *** [5s 7h 6d]
qul+IMROTuFj45eWi2Tpvg: bets $0.75
tYsOBqdU1+x+yFI7zHO7hQ: folds 
D3XCkXRktDfPlSguxwfnRA: folds 
Uncalled bet ($0.75) returned to qul+IMROTuFj45eWi2Tpvg
qul+IMROTuFj45eWi2Tpvg collected $0.75 from pot
*** SUMMARY ***
Total pot $0.75 | Rake $0 
Board [5s 7h 6d]
Seat 2: Th3FldXKQW6hWVVPahaoOQ folded before Flop (didn't bet)
Seat 3: rUpvA02nErFvZ4yFbDR8XA folded before Flop (didn't bet)
Seat 4: D3XCkXRktDfPlSguxwfnRA folded on the Flop
Seat 5: OiV1PWZ3IkN29JlmCcnTwQ folded before Flop (didn't bet)
Seat 6: b3P5tPsBbrP+aAO9+Ts/Nw (button) folded before Flop (didn't bet)
Seat 7: qul+IMROTuFj45eWi2Tpvg (small blind) collected ($0.75)
Seat 9: tYsOBqdU1+x+yFI7zHO7hQ (big blind) folded on the Flop




PokerStars Game #59939521520:  Hold'em No Limit ($0.10/$0.25) - 2009/07/01 0:42:00 ET
Table '4UJB/UOZ5aepyF2v+hIoUg' 6-max Seat #2 is the button
Seat 1: 0/FYfBoKhINaqU/H5OSS1A ($6.45 in chips) 
Seat 2: TTpuqC1Ny2dgaNZLYg+ZXg ($9.50 in chips) 
Seat 3: dKMsTZMrd8Ire/Qysz7FAA ($4.25 in chips) 
Seat 4: UBrY0qLms3NqxITD3VvlAg ($11 in chips) 
Seat 5: hk8pxWcMqHKpvAKgXieLFw ($21.70 in chips) 
Seat 6: RP8Db3hfv5C09Dkfvq1lmw ($17.90 in chips) 
dKMsTZMrd8Ire/Qysz7FAA: posts small blind $0.10
UBrY0qLms3NqxITD3VvlAg: posts big blind $0.25
*** HOLE CARDS ***
hk8pxWcMqHKpvAKgXieLFw: folds 
RP8Db3hfv5C09Dkfvq1lmw: calls $0.25
0/FYfBoKhINaqU/H5OSS1A: folds 
TTpuqC1Ny2dgaNZLYg+ZXg: folds 
dKMsTZMrd8Ire/Qysz7FAA: calls $0.15
UBrY0qLms3NqxITD3VvlAg: checks 
*** FLOP *** [3d Ac 9s]
dKMsTZMrd8Ire/Qysz7FAA: checks 
UBrY0qLms3NqxITD3VvlAg: checks 
RP8Db3hfv5C09Dkfvq1lmw: checks 
*** TURN *** [3d Ac 9s] [Ah]
dKMsTZMrd8Ire/Qysz7FAA: checks 
UBrY0qLms3NqxITD3VvlAg: bets $0.75
RP8Db3hfv5C09Dkfvq1lmw: folds 
dKMsTZMrd8Ire/Qysz7FAA: folds 
Uncalled bet ($0.75) returned to UBrY0qLms3NqxITD3VvlAg
UBrY0qLms3NqxITD3VvlAg collected $0.75 from pot
*** SUMMARY ***
Total pot $0.75 | Rake $0 
Board [3d Ac 9s Ah]
Seat 1: 0/FYfBoKhINaqU/H5OSS1A folded before Flop (didn't bet)
Seat 2: TTpuqC1Ny2dgaNZLYg+ZXg (button) folded before Flop (didn't bet)
Seat 3: dKMsTZMrd8Ire/Qysz7FAA (small blind) folded on the Turn
Seat 4: UBrY0qLms3NqxITD3VvlAg (big blind) collected ($0.75)
Seat 5: hk8pxWcMqHKpvAKgXieLFw folded before Flop (didn't bet)
Seat 6: RP8Db3hfv5C09Dkfvq1lmw folded on the Turn




PokerStars Game #59939521350:  Hold'em No Limit ($0.10/$0.25) - 2009/07/01 0:42:00 ET
Table 'QegsWX65l3n/K0A8XB78yg' 6-max Seat #6 is the button
Seat 1: 8ClCHtFXGNplITm+63KB+Q ($29.05 in chips) 
Seat 2: GC/9yVD59DUCX7hUI7gcLw ($32.90 in chips) 
Seat 3: 9jSiy0meE9XJKkdIZwyTEQ ($25 in chips) 
Seat 4: kyRaCIljYA6l33lSKQfNsg ($24.65 in chips) 
Seat 5: 4YSTu0Cdzpppe1lUgCZGCQ ($56.25 in chips) 
Seat 6: JE/wJXmjw3bpdmjwvh2pcg ($37.15 in chips) 
8ClCHtFXGNplITm+63KB+Q: posts small blind $0.10
GC/9yVD59DUCX7hUI7gcLw: posts big blind $0.25
*** HOLE CARDS ***
9jSiy0meE9XJKkdIZwyTEQ: folds 
kyRaCIljYA6l33lSKQfNsg: raises $0.50 to $0.75
4YSTu0Cdzpppe1lUgCZGCQ: folds 
JE/wJXmjw3bpdmjwvh2pcg: calls $0.75
8ClCHtFXGNplITm+63KB+Q: folds 
GC/9yVD59DUCX7hUI7gcLw: folds 
*** FLOP *** [5h Ks 3d]
kyRaCIljYA6l33lSKQfNsg: bets $1.25
JE/wJXmjw3bpdmjwvh2pcg: folds 
Uncalled bet ($1.25) returned to kyRaCIljYA6l33lSKQfNsg
kyRaCIljYA6l33lSKQfNsg collected $1.80 from pot
kyRaCIljYA6l33lSKQfNsg: doesn't show hand 
*** SUMMARY ***
Total pot $1.85 | Rake $0.05 
Board [5h Ks 3d]
Seat 1: 8ClCHtFXGNplITm+63KB+Q (small blind) folded before Flop
Seat 2: GC/9yVD59DUCX7hUI7gcLw (big blind) folded before Flop
Seat 3: 9jSiy0meE9XJKkdIZwyTEQ folded before Flop (didn't bet)
Seat 4: kyRaCIljYA6l33lSKQfNsg collected ($1.80)
Seat 5: 4YSTu0Cdzpppe1lUgCZGCQ folded before Flop (didn't bet)
Seat 6: JE/wJXmjw3bpdmjwvh2pcg (button) folded on the Flop




PokerStars Game #59939521546:  Hold'em No Limit ($0.10/$0.25) - 2009/07/01 0:42:00 ET
Table 'a0kk1yz54EMczhut3KjrxQ' 6-max Seat #2 is the button
Seat 1: V3LJvbHVJHmOj2fd7zIDhA ($28.65 in chips) 
Seat 2: nc79pm0LZRdhncq55evVqA ($25 in chips) 
Seat 3: FabaCGPqGJLjRL48CMvjiQ ($22.75 in chips) 
Seat 4: FYepjhAvF8ZdVCmqHIy+eQ ($27.70 in chips) 
Seat 5: cPO/1/dTcZpLkQFm3jH3Rg ($26.15 in chips) 
Seat 6: DTzxFTXVrCqrpjq9B9Vg/g ($15.60 in chips) 
FabaCGPqGJLjRL48CMvjiQ: posts small blind $0.10
FYepjhAvF8ZdVCmqHIy+eQ: posts big blind $0.25
*** HOLE CARDS ***
cPO/1/dTcZpLkQFm3jH3Rg: folds 
DTzxFTXVrCqrpjq9B9Vg/g: calls $0.25
V3LJvbHVJHmOj2fd7zIDhA: folds 
nc79pm0LZRdhncq55evVqA: folds 
FabaCGPqGJLjRL48CMvjiQ: calls $0.15
FYepjhAvF8ZdVCmqHIy+eQ: checks 
*** FLOP *** [6s 5s Ac]
FabaCGPqGJLjRL48CMvjiQ: checks 
FYepjhAvF8ZdVCmqHIy+eQ: checks 
DTzxFTXVrCqrpjq9B9Vg/g: bets $1.50
FabaCGPqGJLjRL48CMvjiQ: folds 
FYepjhAvF8ZdVCmqHIy+eQ: folds 
Uncalled bet ($1.50) returned to DTzxFTXVrCqrpjq9B9Vg/g
DTzxFTXVrCqrpjq9B9Vg/g collected $0.75 from pot
*** SUMMARY ***
Total pot $0.75 | Rake $0 
Board [6s 5s Ac]
Seat 1: V3LJvbHVJHmOj2fd7zIDhA folded before Flop (didn't bet)
Seat 2: nc79pm0LZRdhncq55evVqA (button) folded before Flop (didn't bet)
Seat 3: FabaCGPqGJLjRL48CMvjiQ (small blind) folded on the Flop
Seat 4: FYepjhAvF8ZdVCmqHIy+eQ (big blind) folded on the Flop
Seat 5: cPO/1/dTcZpLkQFm3jH3Rg folded before Flop (didn't bet)
Seat 6: DTzxFTXVrCqrpjq9B9Vg/g collected ($0.75)




PokerStars Game #59939521702:  Hold'em No Limit ($0.10/$0.25) - 2009/07/01 0:42:00 ET
Table 'IIO2q2znuuAXmiZ2qFTcmgiHlyuN1lFZ6WTlMBiiMYXAx Seat #4 is the button
Seat 2: R6nIVAjK7uhK3Hj0f85A+A ($29.45 in chips) 
Seat 3: QGjA4xtpxSpgzm+HC+ps4w ($21.75 in chips) 
Seat 4: z5GxcHlYz/GSz6W2uFiTtg ($24.15 in chips) 
Seat 6: M2QO2DxB5Wawg2h8HSpnYA ($13.70 in chips) 
Seat 7: gehe91e0IyVT0QU/XBkEyg ($33.50 in chips) 
Seat 8: TeWJxSETzbXGiYKx0y+dtg ($24.55 in chips) 
M2QO2DxB5Wawg2h8HSpnYA: posts small blind $0.10
gehe91e0IyVT0QU/XBkEyg: posts big blind $0.25
*** HOLE CARDS ***
TeWJxSETzbXGiYKx0y+dtg: folds 
R6nIVAjK7uhK3Hj0f85A+A: folds 
QGjA4xtpxSpgzm+HC+ps4w: folds 
z5GxcHlYz/GSz6W2uFiTtg: calls $0.25
M2QO2DxB5Wawg2h8HSpnYA: calls $0.15
gehe91e0IyVT0QU/XBkEyg: checks 
*** FLOP *** [4s 3s 7h]
M2QO2DxB5Wawg2h8HSpnYA: checks 
gehe91e0IyVT0QU/XBkEyg: bets $0.75
z5GxcHlYz/GSz6W2uFiTtg: folds 
M2QO2DxB5Wawg2h8HSpnYA: folds 
Uncalled bet ($0.75) returned to gehe91e0IyVT0QU/XBkEyg
gehe91e0IyVT0QU/XBkEyg collected $0.75 from pot
*** SUMMARY ***
Total pot $0.75 | Rake $0 
Board [4s 3s 7h]
Seat 2: R6nIVAjK7uhK3Hj0f85A+A folded before Flop (didn't bet)
Seat 3: QGjA4xtpxSpgzm+HC+ps4w folded before Flop (didn't bet)
Seat 4: z5GxcHlYz/GSz6W2uFiTtg (button) folded on the Flop
Seat 6: M2QO2DxB5Wawg2h8HSpnYA (small blind) folded on the Flop
Seat 7: gehe91e0IyVT0QU/XBkEyg (big blind) collected ($0.75)
Seat 8: TeWJxSETzbXGiYKx0y+dtg folded before Flop (didn't bet)




PokerStars Game #59939521216:  Hold'em No Limit ($0.10/$0.25) - 2009/07/01 0:42:00 ET
Table 'ykyWGjhNu7AvZXov27T4ew' 9-max Seat #4 is the button
Seat 2: MG90wfSJZnOejs/KD3vlQQ ($47.10 in chips) 
Seat 3: r1pFKMwWp74QwhfPWJOAyw ($4.45 in chips) 
Seat 4: hBMUlEpyU74r/fwDgIpXjQ ($25.45 in chips) 
Seat 5: lMysP2jE94oJvWGA6K5puw ($7 in chips) 
Seat 6: opOCI2p6kW0tINuVaAqmcQ ($25 in chips) 
Seat 8: tYsOBqdU1+x+yFI7zHO7hQ ($35.85 in chips) 
lMysP2jE94oJvWGA6K5puw: posts small blind $0.10
opOCI2p6kW0tINuVaAqmcQ: posts big blind $0.25
CYkY0dNBaYaKs8HVCVn3mQ: sits out 
*** HOLE CARDS ***
tYsOBqdU1+x+yFI7zHO7hQ: folds 
nm4Dj/f+jJEwKVsUnKh73g joins the table at seat #9 
MG90wfSJZnOejs/KD3vlQQ: folds 
r1pFKMwWp74QwhfPWJOAyw: folds 
hBMUlEpyU74r/fwDgIpXjQ: folds 
lMysP2jE94oJvWGA6K5puw: calls $0.15
opOCI2p6kW0tINuVaAqmcQ: checks 
*** FLOP *** [Qc 5s Ts]
lMysP2jE94oJvWGA6K5puw: checks 
opOCI2p6kW0tINuVaAqmcQ: bets $0.50
lMysP2jE94oJvWGA6K5puw: calls $0.50
*** TURN *** [Qc 5s Ts] [Qs]
lMysP2jE94oJvWGA6K5puw: checks 
opOCI2p6kW0tINuVaAqmcQ: checks 
*** RIVER *** [Qc 5s Ts Qs] [7s]
lMysP2jE94oJvWGA6K5puw: bets $0.75
opOCI2p6kW0tINuVaAqmcQ: raises $3.50 to $4.25
lMysP2jE94oJvWGA6K5puw: folds 
Uncalled bet ($3.50) returned to opOCI2p6kW0tINuVaAqmcQ
opOCI2p6kW0tINuVaAqmcQ collected $2.90 from pot
opOCI2p6kW0tINuVaAqmcQ: doesn't show hand 
*** SUMMARY ***
Total pot $3 | Rake $0.10 
Board [Qc 5s Ts Qs 7s]
Seat 2: MG90wfSJZnOejs/KD3vlQQ folded before Flop (didn't bet)
Seat 3: r1pFKMwWp74QwhfPWJOAyw folded before Flop (didn't bet)
Seat 4: hBMUlEpyU74r/fwDgIpXjQ (button) folded before Flop (didn't bet)
Seat 5: lMysP2jE94oJvWGA6K5puw (small blind) folded on the River
Seat 6: opOCI2p6kW0tINuVaAqmcQ (big blind) collected ($2.90)
Seat 8: tYsOBqdU1+x+yFI7zHO7hQ folded before Flop (didn't bet)




PokerStars Game #59939521518:  Hold'em No Limit ($0.10/$0.25) - 2009/07/01 0:42:00 ET
Table 'vud0GB/ZlDCvUFhBFIaTlg' 9-max Seat #7 is the button
Seat 5: AwAabNdwDsTMb3aTomdOmg ($6.20 in chips) 
Seat 7: RzaVufWfW9CTnVYR7/Ge+w ($1.75 in chips) 
RzaVufWfW9CTnVYR7/Ge+w: posts small blind $0.10
AwAabNdwDsTMb3aTomdOmg: posts big blind $0.25
*** HOLE CARDS ***
RzaVufWfW9CTnVYR7/Ge+w: raises $0.25 to $0.50
AwAabNdwDsTMb3aTomdOmg: folds 
Uncalled bet ($0.25) returned to RzaVufWfW9CTnVYR7/Ge+w
RzaVufWfW9CTnVYR7/Ge+w collected $0.50 from pot
*** SUMMARY ***
Total pot $0.50 | Rake $0 
Seat 5: AwAabNdwDsTMb3aTomdOmg (big blind) folded before Flop
Seat 7: RzaVufWfW9CTnVYR7/Ge+w (button) (small blind) collected ($0.50)




PokerStars Game #59939522130:  Hold'em No Limit ($0.10/$0.25) - 2009/07/01 0:42:01 ET
Table 'SbSV5tlgLp0+/Z+13PW3Hg' 9-max Seat #6 is the button
Seat 1: NAP/FpFXsTsBxjDijlVzEg ($44.45 in chips) 
Seat 2: zDrucyjVn5aeekNEc3cJrA ($19.50 in chips) 
Seat 3: s7Q6uNouhe7aE8JdFb9E+A ($25 in chips) 
Seat 4: NNZypfH1f/VIj3Skf/XIzg ($4.65 in chips) 
Seat 5: z5GxcHlYz/GSz6W2uFiTtg ($19.60 in chips) 
Seat 6: qwr38jl5txoR36M7G5qi4A ($7.90 in chips) 
Seat 7: j4q3p0lesp63b1gZDwLBZw ($6.45 in chips) 
Seat 8: 7cv+9Zc9HIQHNvYsMfV3uA ($25.50 in chips) 
Seat 9: rXm4QDVJt67H20lM6n6Z7Q ($18.50 in chips) 
j4q3p0lesp63b1gZDwLBZw: posts small blind $0.10
7cv+9Zc9HIQHNvYsMfV3uA: posts big blind $0.25
*** HOLE CARDS ***
rXm4QDVJt67H20lM6n6Z7Q: folds 
NAP/FpFXsTsBxjDijlVzEg: folds 
NAP/FpFXsTsBxjDijlVzEg leaves the table
zDrucyjVn5aeekNEc3cJrA: folds 
s7Q6uNouhe7aE8JdFb9E+A: folds 
NNZypfH1f/VIj3Skf/XIzg: raises $0.50 to $0.75
z5GxcHlYz/GSz6W2uFiTtg: folds 
qwr38jl5txoR36M7G5qi4A: folds 
j4q3p0lesp63b1gZDwLBZw: folds 
7cv+9Zc9HIQHNvYsMfV3uA: raises $4.25 to $5
NNZypfH1f/VIj3Skf/XIzg: folds 
Uncalled bet ($4.25) returned to 7cv+9Zc9HIQHNvYsMfV3uA
7cv+9Zc9HIQHNvYsMfV3uA collected $1.60 from pot
7cv+9Zc9HIQHNvYsMfV3uA: doesn't show hand 
*** SUMMARY ***
Total pot $1.60 | Rake $0 
Seat 1: NAP/FpFXsTsBxjDijlVzEg folded before Flop (didn't bet)
Seat 2: zDrucyjVn5aeekNEc3cJrA folded before Flop (didn't bet)
Seat 3: s7Q6uNouhe7aE8JdFb9E+A folded before Flop (didn't bet)
Seat 4: NNZypfH1f/VIj3Skf/XIzg folded before Flop
Seat 5: z5GxcHlYz/GSz6W2uFiTtg folded before Flop (didn't bet)
Seat 6: qwr38jl5txoR36M7G5qi4A (button) folded before Flop (didn't bet)
Seat 7: j4q3p0lesp63b1gZDwLBZw (small blind) folded before Flop
Seat 8: 7cv+9Zc9HIQHNvYsMfV3uA (big blind) collected ($1.60)
Seat 9: rXm4QDVJt67H20lM6n6Z7Q folded before Flop (didn't bet)




PokerStars Game #59939521882:  Hold'em No Limit ($0.10/$0.25) - 2009/07/01 0:42:01 ET
Table 'HQOv+27sJF7e8+zUsBlT2w' 9-max Seat #6 is the button
Seat 1: CbXUS6Z2rXZxL1AKduNtmQ ($26.25 in chips) 
Seat 2: MG90wfSJZnOejs/KD3vlQQ ($25 in chips) 
Seat 3: 18G4P1XstjNvItdGUITxgw ($29.45 in chips) 
Seat 4: kRW/Cdh6F1t40Vs43OFbYA ($16.25 in chips) 
Seat 5: nD+0ILJGeuYzreVIK9/wcA ($16.30 in chips) 
Seat 6: vZGoOTJLQLhkPj4I+LNGig ($32.25 in chips) 
Seat 7: GmzfAfxcxu1kGbPC+9LkVg ($24.15 in chips) 
Seat 8: RaXCy4DBrUrZSg4MF8FyDg ($12.25 in chips) 
Seat 9: gehe91e0IyVT0QU/XBkEyg ($25 in chips) 
GmzfAfxcxu1kGbPC+9LkVg: posts small blind $0.10
RaXCy4DBrUrZSg4MF8FyDg: posts big blind $0.25
*** HOLE CARDS ***
gehe91e0IyVT0QU/XBkEyg: folds 
CbXUS6Z2rXZxL1AKduNtmQ: folds 
MG90wfSJZnOejs/KD3vlQQ: folds 
18G4P1XstjNvItdGUITxgw: folds 
kRW/Cdh6F1t40Vs43OFbYA: folds 
nD+0ILJGeuYzreVIK9/wcA: calls $0.25
vZGoOTJLQLhkPj4I+LNGig: folds 
GmzfAfxcxu1kGbPC+9LkVg: folds 
RaXCy4DBrUrZSg4MF8FyDg: checks 
*** FLOP *** [8s 9s 7s]
RaXCy4DBrUrZSg4MF8FyDg: checks 
nD+0ILJGeuYzreVIK9/wcA: bets $0.50
RaXCy4DBrUrZSg4MF8FyDg: calls $0.50
*** TURN *** [8s 9s 7s] [6h]
RaXCy4DBrUrZSg4MF8FyDg: checks 
nD+0ILJGeuYzreVIK9/wcA: bets $0.50
RaXCy4DBrUrZSg4MF8FyDg: folds 
Uncalled bet ($0.50) returned to nD+0ILJGeuYzreVIK9/wcA
nD+0ILJGeuYzreVIK9/wcA collected $1.55 from pot
nD+0ILJGeuYzreVIK9/wcA: doesn't show hand 
*** SUMMARY ***
Total pot $1.60 | Rake $0.05 
Board [8s 9s 7s 6h]
Seat 1: CbXUS6Z2rXZxL1AKduNtmQ folded before Flop (didn't bet)
Seat 2: MG90wfSJZnOejs/KD3vlQQ folded before Flop (didn't bet)
Seat 3: 18G4P1XstjNvItdGUITxgw folded before Flop (didn't bet)
Seat 4: kRW/Cdh6F1t40Vs43OFbYA folded before Flop (didn't bet)
Seat 5: nD+0ILJGeuYzreVIK9/wcA collected ($1.55)
Seat 6: vZGoOTJLQLhkPj4I+LNGig (button) folded before Flop (didn't bet)
Seat 7: GmzfAfxcxu1kGbPC+9LkVg (small blind) folded before Flop
Seat 8: RaXCy4DBrUrZSg4MF8FyDg (big blind) folded on the Turn
Seat 9: gehe91e0IyVT0QU/XBkEyg folded before Flop (didn't bet)




PokerStars Game #59939521860:  Hold'em No Limit ($0.10/$0.25) - 2009/07/01 0:42:01 ET
Table '0mmHveGuaIfIMQlNE1eqMg' 9-max Seat #3 is the button
Seat 1: 7QzbjWT00wQpau1iqvUmMA ($4.65 in chips) 
Seat 2: rQhYIYXSyH/IivYM1dlV5A ($52.65 in chips) 
Seat 3: ghNKXUBl/H+t83JF079ZBA ($25.75 in chips) 
Seat 4: r0/CtYRRIJAbPQm4qsv8LQ ($35.25 in chips) 
Seat 5: cVVfy+hwCb/YzSIyUWhKEw ($33.45 in chips) 
Seat 6: Xo1w+VqEZh0bV5wYupnNYg ($15.40 in chips) 
Seat 8: jiyia7h6fmxBdWBkH9lH5A ($2.95 in chips) 
Seat 9: W4TLQcZ2TiM73eIgpIvlGg ($34.25 in chips) 
r0/CtYRRIJAbPQm4qsv8LQ: posts small blind $0.10
cVVfy+hwCb/YzSIyUWhKEw: posts big blind $0.25
*** HOLE CARDS ***
Xo1w+VqEZh0bV5wYupnNYg: calls $0.25
jiyia7h6fmxBdWBkH9lH5A: folds 
W4TLQcZ2TiM73eIgpIvlGg: folds 
7QzbjWT00wQpau1iqvUmMA: folds 
rQhYIYXSyH/IivYM1dlV5A: folds 
ghNKXUBl/H+t83JF079ZBA: folds 
r0/CtYRRIJAbPQm4qsv8LQ: folds 
cVVfy+hwCb/YzSIyUWhKEw: checks 
*** FLOP *** [Qs Qd 3h]
cVVfy+hwCb/YzSIyUWhKEw: checks 
Xo1w+VqEZh0bV5wYupnNYg: checks 
*** TURN *** [Qs Qd 3h] [As]
cVVfy+hwCb/YzSIyUWhKEw: checks 
Xo1w+VqEZh0bV5wYupnNYg: checks 
*** RIVER *** [Qs Qd 3h As] [6d]
cVVfy+hwCb/YzSIyUWhKEw: bets $0.25
Xo1w+VqEZh0bV5wYupnNYg: folds 
Uncalled bet ($0.25) returned to cVVfy+hwCb/YzSIyUWhKEw
cVVfy+hwCb/YzSIyUWhKEw collected $0.60 from pot
*** SUMMARY ***
Total pot $0.60 | Rake $0 
Board [Qs Qd 3h As 6d]
Seat 1: 7QzbjWT00wQpau1iqvUmMA folded before Flop (didn't bet)
Seat 2: rQhYIYXSyH/IivYM1dlV5A folded before Flop (didn't bet)
Seat 3: ghNKXUBl/H+t83JF079ZBA (button) folded before Flop (didn't bet)
Seat 4: r0/CtYRRIJAbPQm4qsv8LQ (small blind) folded before Flop
Seat 5: cVVfy+hwCb/YzSIyUWhKEw (big blind) collected ($0.60)
Seat 6: Xo1w+VqEZh0bV5wYupnNYg folded on the River
Seat 8: jiyia7h6fmxBdWBkH9lH5A folded before Flop (didn't bet)
Seat 9: W4TLQcZ2TiM73eIgpIvlGg folded before Flop (didn't bet)




PokerStars Game #59939522154:  Hold'em No Limit ($0.10/$0.25) - 2009/07/01 0:42:01 ET
Table '8UiaYOdeBwzanG6w1SMeFg' 9-max Seat #2 is the button
Seat 2: 18G4P1XstjNvItdGUITxgw ($25 in chips) 
Seat 3: A7xJNkBMCQG6Zuocn2v8YQ ($16.45 in chips) 
Seat 4: H5Se03ZqSX7tbULXur2MAg ($29.85 in chips) 
Seat 5: UmzixCpC0bAc1lDEjgB3NQ ($19.05 in chips) 
Seat 6: N6fYvIzQLKaydFLKQGtMlQ ($23.30 in chips) 
Seat 7: E0iYnEVO2ho7dH3QcCjw7g ($21.25 in chips) 
Seat 8: hBMUlEpyU74r/fwDgIpXjQ ($53.40 in chips) 
A7xJNkBMCQG6Zuocn2v8YQ: posts small blind $0.10
H5Se03ZqSX7tbULXur2MAg: posts big blind $0.25
K4All-In: sits out 
*** HOLE CARDS ***
UmzixCpC0bAc1lDEjgB3NQ: folds 
N6fYvIzQLKaydFLKQGtMlQ: folds 
E0iYnEVO2ho7dH3QcCjw7g: folds 
hBMUlEpyU74r/fwDgIpXjQ: folds 
18G4P1XstjNvItdGUITxgw: folds 
CYkY0dNBaYaKs8HVCVn3mQ joins the table at seat #1 
A7xJNkBMCQG6Zuocn2v8YQ: calls $0.15
H5Se03ZqSX7tbULXur2MAg: checks 
*** FLOP *** [3h Qs 9h]
A7xJNkBMCQG6Zuocn2v8YQ: checks 
H5Se03ZqSX7tbULXur2MAg: bets $0.50
A7xJNkBMCQG6Zuocn2v8YQ: calls $0.50
*** TURN *** [3h Qs 9h] [7s]
A7xJNkBMCQG6Zuocn2v8YQ: bets $0.25
H5Se03ZqSX7tbULXur2MAg: calls $0.25
*** RIVER *** [3h Qs 9h 7s] [Kd]
A7xJNkBMCQG6Zuocn2v8YQ: bets $2.50
H5Se03ZqSX7tbULXur2MAg: folds 
Uncalled bet ($2.50) returned to A7xJNkBMCQG6Zuocn2v8YQ
A7xJNkBMCQG6Zuocn2v8YQ collected $1.95 from pot
*** SUMMARY ***
Total pot $2 | Rake $0.05 
Board [3h Qs 9h 7s Kd]
Seat 2: 18G4P1XstjNvItdGUITxgw (button) folded before Flop (didn't bet)
Seat 3: A7xJNkBMCQG6Zuocn2v8YQ (small blind) collected ($1.95)
Seat 4: H5Se03ZqSX7tbULXur2MAg (big blind) folded on the River
Seat 5: UmzixCpC0bAc1lDEjgB3NQ folded before Flop (didn't bet)
Seat 6: N6fYvIzQLKaydFLKQGtMlQ folded before Flop (didn't bet)
Seat 7: E0iYnEVO2ho7dH3QcCjw7g folded before Flop (didn't bet)
Seat 8: hBMUlEpyU74r/fwDgIpXjQ folded before Flop (didn't bet)




PokerStars Game #59939521960:  Hold'em No Limit ($0.10/$0.25) - 2009/07/01 0:42:01 ET
Table '84TjTrgbsYZladOc4PWf4Q' 6-max Seat #5 is the button
Seat 1: 79ID/ub1Pt/mDpCprVmOoA ($30 in chips) 
Seat 2: qGHGf/553gQnDoklMRe3tg ($31.90 in chips) 
Seat 4: SxIIgwXYLkwd6m3wLyPTCw ($25 in chips) 
Seat 5: SFmT9ZsVopnukjvAzrxTRg ($36.85 in chips) 
Seat 6: 7qRk4YH4/k/08LgJSv7rBQ ($24.75 in chips) 
7qRk4YH4/k/08LgJSv7rBQ: posts small blind $0.10
79ID/ub1Pt/mDpCprVmOoA: posts big blind $0.25
*** HOLE CARDS ***
qGHGf/553gQnDoklMRe3tg: folds 
SxIIgwXYLkwd6m3wLyPTCw: folds 
SFmT9ZsVopnukjvAzrxTRg: folds 
7qRk4YH4/k/08LgJSv7rBQ: folds 
Uncalled bet ($0.15) returned to 79ID/ub1Pt/mDpCprVmOoA
79ID/ub1Pt/mDpCprVmOoA collected $0.20 from pot
79ID/ub1Pt/mDpCprVmOoA: doesn't show hand 
*** SUMMARY ***
Total pot $0.20 | Rake $0 
Seat 1: 79ID/ub1Pt/mDpCprVmOoA (big blind) collected ($0.20)
Seat 2: qGHGf/553gQnDoklMRe3tg folded before Flop (didn't bet)
Seat 4: SxIIgwXYLkwd6m3wLyPTCw folded before Flop (didn't bet)
Seat 5: SFmT9ZsVopnukjvAzrxTRg (button) folded before Flop (didn't bet)
Seat 6: 7qRk4YH4/k/08LgJSv7rBQ (small blind) folded before Flop




PokerStars Game #59939522230:  Hold'em No Limit ($0.10/$0.25) - 2009/07/01 0:42:01 ET
Table 'fIrOIN3HoXM27ZpRwKa6oA' 6-max Seat #1 is the button
Seat 1: I1TxPvWj8NfG8orglCinNA ($38.50 in chips) 
Seat 2: 5tB0F9NjPSUL4FzmzBMs2Q ($37.60 in chips) 
Seat 4: PEUgcMc+CzvN+vLwu5DsLQ ($5.45 in chips) 
Seat 5: 8ClCHtFXGNplITm+63KB+Q ($26.80 in chips) 
Seat 6: v+QfkGiuj9bgtuNoVnDO8w ($29.70 in chips) 
5tB0F9NjPSUL4FzmzBMs2Q: posts small blind $0.10
PEUgcMc+CzvN+vLwu5DsLQ: posts big blind $0.25
*** HOLE CARDS ***
8ClCHtFXGNplITm+63KB+Q: folds 
v+QfkGiuj9bgtuNoVnDO8w: raises $0.75 to $1
I1TxPvWj8NfG8orglCinNA: folds 
5tB0F9NjPSUL4FzmzBMs2Q: calls $0.90
PEUgcMc+CzvN+vLwu5DsLQ: folds 
*** FLOP *** [3s Ks Jc]
5tB0F9NjPSUL4FzmzBMs2Q: bets $1
v+QfkGiuj9bgtuNoVnDO8w: calls $1
*** TURN *** [3s Ks Jc] [Ts]
5tB0F9NjPSUL4FzmzBMs2Q: bets $3
v+QfkGiuj9bgtuNoVnDO8w: folds 
Uncalled bet ($3) returned to 5tB0F9NjPSUL4FzmzBMs2Q
resonator_21 joins the table at seat #3 
5tB0F9NjPSUL4FzmzBMs2Q collected $4.05 from pot
5tB0F9NjPSUL4FzmzBMs2Q: doesn't show hand 
*** SUMMARY ***
Total pot $4.25 | Rake $0.20 
Board [3s Ks Jc Ts]
Seat 1: I1TxPvWj8NfG8orglCinNA (button) folded before Flop (didn't bet)
Seat 2: 5tB0F9NjPSUL4FzmzBMs2Q (small blind) collected ($4.05)
Seat 4: PEUgcMc+CzvN+vLwu5DsLQ (big blind) folded before Flop
Seat 5: 8ClCHtFXGNplITm+63KB+Q folded before Flop (didn't bet)
Seat 6: v+QfkGiuj9bgtuNoVnDO8w folded on the Turn




PokerStars Game #59939522756:  Hold'em No Limit ($0.10/$0.25) - 2009/07/01 0:42:02 ET
Table 'mF3KHGMaTpaBZbtBoyfTeg' 6-max Seat #3 is the button
Seat 1: 0HAB2GdCAM7p7V00xueAVQ ($10.30 in chips) 
Seat 2: 4x9jCqgSw4272dnaIqnanw ($4.50 in chips) 
Seat 3: Hzrn9DZJegEZICufTNYkrg ($14.40 in chips) 
Seat 4: FYepjhAvF8ZdVCmqHIy+eQ ($25.30 in chips) 
Seat 5: sEQx9G5Cu8k1HNdQasxvUA ($27.90 in chips) 
FYepjhAvF8ZdVCmqHIy+eQ: posts small blind $0.10
sEQx9G5Cu8k1HNdQasxvUA: posts big blind $0.25
*** HOLE CARDS ***
0HAB2GdCAM7p7V00xueAVQ: raises $0.25 to $0.50
4x9jCqgSw4272dnaIqnanw: calls $0.50
Hzrn9DZJegEZICufTNYkrg: folds 
FYepjhAvF8ZdVCmqHIy+eQ: folds 
sEQx9G5Cu8k1HNdQasxvUA: raises $10.25 to $10.75
0HAB2GdCAM7p7V00xueAVQ: folds 
4x9jCqgSw4272dnaIqnanw: folds 
Uncalled bet ($10.25) returned to sEQx9G5Cu8k1HNdQasxvUA
sEQx9G5Cu8k1HNdQasxvUA collected $1.60 from pot
sEQx9G5Cu8k1HNdQasxvUA: doesn't show hand 
*** SUMMARY ***
Total pot $1.60 | Rake $0 
Seat 1: 0HAB2GdCAM7p7V00xueAVQ folded before Flop
Seat 2: 4x9jCqgSw4272dnaIqnanw folded before Flop
Seat 3: Hzrn9DZJegEZICufTNYkrg (button) folded before Flop (didn't bet)
Seat 4: FYepjhAvF8ZdVCmqHIy+eQ (small blind) folded before Flop
Seat 5: sEQx9G5Cu8k1HNdQasxvUA (big blind) collected ($1.60)




PokerStars Game #59939522608:  Hold'em No Limit ($0.10/$0.25) - 2009/07/01 0:42:02 ET
Table 'Xi38lWH8L2JHRAsKYVX8Qg' 6-max Seat #3 is the button
Seat 1: AqQ7DFpHkgIzTwDu+rClcg ($6.25 in chips) 
Seat 2: 7iL6KfkJTFbyWmnLYk4+AA ($20.90 in chips) 
Seat 3: 6DwBRH+xZ12AAZmeAg+aXw ($25 in chips) 
Seat 5: 79ID/ub1Pt/mDpCprVmOoA ($25.10 in chips) 
Seat 6: aogAb4Eienxztk8p2v9VVw ($21.50 in chips) 
79ID/ub1Pt/mDpCprVmOoA: posts small blind $0.10
aogAb4Eienxztk8p2v9VVw: posts big blind $0.25
7iL6KfkJTFbyWmnLYk4+AA: posts big blind $0.25
*** HOLE CARDS ***
AqQ7DFpHkgIzTwDu+rClcg: folds 
7iL6KfkJTFbyWmnLYk4+AA: checks 
kG34n23qFQA3nzdOJTQ1dA joins the table at seat #4 
6DwBRH+xZ12AAZmeAg+aXw: folds 
79ID/ub1Pt/mDpCprVmOoA: folds 
aogAb4Eienxztk8p2v9VVw: checks 
*** FLOP *** [Kh Ad Ac]
aogAb4Eienxztk8p2v9VVw: checks 
7iL6KfkJTFbyWmnLYk4+AA: checks 
*** TURN *** [Kh Ad Ac] [Td]
aogAb4Eienxztk8p2v9VVw: checks 
7iL6KfkJTFbyWmnLYk4+AA: checks 
*** RIVER *** [Kh Ad Ac Td] [8h]
aogAb4Eienxztk8p2v9VVw: checks 
7iL6KfkJTFbyWmnLYk4+AA: checks 
*** SHOW DOWN ***
aogAb4Eienxztk8p2v9VVw: shows [2h 8s] (two pair, Aces and Eights)
7iL6KfkJTFbyWmnLYk4+AA: mucks hand 
aogAb4Eienxztk8p2v9VVw collected $0.60 from pot
*** SUMMARY ***
Total pot $0.60 | Rake $0 
Board [Kh Ad Ac Td 8h]
Seat 1: AqQ7DFpHkgIzTwDu+rClcg folded before Flop (didn't bet)
Seat 2: 7iL6KfkJTFbyWmnLYk4+AA mucked
Seat 3: 6DwBRH+xZ12AAZmeAg+aXw (button) folded before Flop (didn't bet)
Seat 5: 79ID/ub1Pt/mDpCprVmOoA (small blind) folded before Flop
Seat 6: aogAb4Eienxztk8p2v9VVw (big blind) showed [2h 8s] and won ($0.60) with two pair, Aces and Eights




PokerStars Game #59939522424:  Hold'em No Limit ($0.10/$0.25) - 2009/07/01 0:42:02 ET
Table '6wawJ+MkkvuC3coG6r+Yhg' 6-max Seat #4 is the button
Seat 1: ELW+DKizJhLK7k40PMkD2Q ($24.90 in chips) 
Seat 2: LtASJ9OlkqGrrUKGQlpGAw ($27.40 in chips) 
Seat 3: KYBwVA7jgmSrbIEbEGElVg ($16.60 in chips) 
Seat 4: cS21pIxRHx5Gt42o7hPZzw ($12 in chips) 
Seat 5: A8uIskXJTblhVXWuYr+lkw ($15.60 in chips) 
Seat 6: oOGZlBAhqtG/HczLL/KLRQ ($19.05 in chips) 
A8uIskXJTblhVXWuYr+lkw: posts small blind $0.10
oOGZlBAhqtG/HczLL/KLRQ: posts big blind $0.25
*** HOLE CARDS ***
ELW+DKizJhLK7k40PMkD2Q: raises $0.75 to $1
LtASJ9OlkqGrrUKGQlpGAw: folds 
KYBwVA7jgmSrbIEbEGElVg: folds 
cS21pIxRHx5Gt42o7hPZzw: folds 
A8uIskXJTblhVXWuYr+lkw: folds 
oOGZlBAhqtG/HczLL/KLRQ: folds 
Uncalled bet ($0.75) returned to ELW+DKizJhLK7k40PMkD2Q
ELW+DKizJhLK7k40PMkD2Q collected $0.60 from pot
*** SUMMARY ***
Total pot $0.60 | Rake $0 
Seat 1: ELW+DKizJhLK7k40PMkD2Q collected ($0.60)
Seat 2: LtASJ9OlkqGrrUKGQlpGAw folded before Flop (didn't bet)
Seat 3: KYBwVA7jgmSrbIEbEGElVg folded before Flop (didn't bet)
Seat 4: cS21pIxRHx5Gt42o7hPZzw (button) folded before Flop (didn't bet)
Seat 5: A8uIskXJTblhVXWuYr+lkw (small blind) folded before Flop
Seat 6: oOGZlBAhqtG/HczLL/KLRQ (big blind) folded before Flop




PokerStars Game #59939522906:  Hold'em No Limit ($0.10/$0.25) - 2009/07/01 0:42:02 ET
Table '2VkNDXXsBj4bSZw/uK5atw' 6-max Seat #1 is the button
Seat 1: 7FmwVDcdEtxDpHmP4hOXsQ ($26.40 in chips) 
Seat 2: gqW2aBCmrIw65BvwjTFN6Q ($25.10 in chips) 
Seat 3: 8D0jr3B4e++Q/cTSnpHdzg ($15 in chips) 
Seat 4: yb6rnd48JuBccThV68VHAQ ($74.65 in chips) 
Seat 5: kyRaCIljYA6l33lSKQfNsg ($24.65 in chips) 
Seat 6: qGHGf/553gQnDoklMRe3tg ($24.90 in chips) 
gqW2aBCmrIw65BvwjTFN6Q: posts small blind $0.10
8D0jr3B4e++Q/cTSnpHdzg: posts big blind $0.25
*** HOLE CARDS ***
yb6rnd48JuBccThV68VHAQ: calls $0.25
kyRaCIljYA6l33lSKQfNsg: folds 
qGHGf/553gQnDoklMRe3tg: folds 
7FmwVDcdEtxDpHmP4hOXsQ: folds 
gqW2aBCmrIw65BvwjTFN6Q: folds 
8D0jr3B4e++Q/cTSnpHdzg: checks 
*** FLOP *** [6h 4d 9s]
8D0jr3B4e++Q/cTSnpHdzg: bets $0.50
yb6rnd48JuBccThV68VHAQ: calls $0.50
*** TURN *** [6h 4d 9s] [6c]
8D0jr3B4e++Q/cTSnpHdzg: bets $1
yb6rnd48JuBccThV68VHAQ: folds 
Uncalled bet ($1) returned to 8D0jr3B4e++Q/cTSnpHdzg
8D0jr3B4e++Q/cTSnpHdzg collected $1.55 from pot
*** SUMMARY ***
Total pot $1.60 | Rake $0.05 
Board [6h 4d 9s 6c]
Seat 1: 7FmwVDcdEtxDpHmP4hOXsQ (button) folded before Flop (didn't bet)
Seat 2: gqW2aBCmrIw65BvwjTFN6Q (small blind) folded before Flop
Seat 3: 8D0jr3B4e++Q/cTSnpHdzg (big blind) collected ($1.55)
Seat 4: yb6rnd48JuBccThV68VHAQ folded on the Turn
Seat 5: kyRaCIljYA6l33lSKQfNsg folded before Flop (didn't bet)
Seat 6: qGHGf/553gQnDoklMRe3tg folded before Flop (didn't bet)




PokerStars Game #59939522624:  Hold'em No Limit ($0.10/$0.25) - 2009/07/01 0:42:02 ET
Table '8qKBgCRnebT9/IvA6SmaPw' 9-max Seat #5 is the button
Seat 1: GTcLfsDTPqgfHyhY9FNDMw ($11.20 in chips) 
Seat 2: SXqVW4Q0evTUVZG6BbUNIA ($78.65 in chips) 
Seat 4: rXm4QDVJt67H20lM6n6Z7Q ($6.50 in chips) 
Seat 5: uJlzv9KL7hgCIqIS2ofoaw ($12.90 in chips) 
Seat 6: z5GxcHlYz/GSz6W2uFiTtg ($23.55 in chips) 
Seat 7: UbybWqarUDNRYlbnju2UUQ ($19.50 in chips) 
Seat 8: M2aiKD/Q1d8lySUIbBxeGg ($35.40 in chips) 
Seat 9: MOlR9YEgKTKLerVIDf8U7w ($48.75 in chips) 
z5GxcHlYz/GSz6W2uFiTtg: posts small blind $0.10
UbybWqarUDNRYlbnju2UUQ: posts big blind $0.25
V6p0jQ/RhUsqpHLmXvEX4Q: sits out 
*** HOLE CARDS ***
M2aiKD/Q1d8lySUIbBxeGg: raises $0.25 to $0.50
MOlR9YEgKTKLerVIDf8U7w: folds 
GTcLfsDTPqgfHyhY9FNDMw: folds 
SXqVW4Q0evTUVZG6BbUNIA: calls $0.50
rXm4QDVJt67H20lM6n6Z7Q: folds 
uJlzv9KL7hgCIqIS2ofoaw: folds 
z5GxcHlYz/GSz6W2uFiTtg: folds 
UbybWqarUDNRYlbnju2UUQ: calls $0.25
*** FLOP *** [7s 9c Kh]
UbybWqarUDNRYlbnju2UUQ: checks 
M2aiKD/Q1d8lySUIbBxeGg: bets $1.25
SXqVW4Q0evTUVZG6BbUNIA: folds 
UbybWqarUDNRYlbnju2UUQ: raises $1.25 to $2.50
M2aiKD/Q1d8lySUIbBxeGg: calls $1.25
*** TURN *** [7s 9c Kh] [Ac]
UbybWqarUDNRYlbnju2UUQ: checks 
M2aiKD/Q1d8lySUIbBxeGg: bets $5
UbybWqarUDNRYlbnju2UUQ: calls $5
*** RIVER *** [7s 9c Kh Ac] [4d]
UbybWqarUDNRYlbnju2UUQ: checks 
M2aiKD/Q1d8lySUIbBxeGg: checks 
*** SHOW DOWN ***
UbybWqarUDNRYlbnju2UUQ: shows [Jh Kd] (a pair of Kings)
M2aiKD/Q1d8lySUIbBxeGg: mucks hand 
UbybWqarUDNRYlbnju2UUQ collected $15.80 from pot
*** SUMMARY ***
Total pot $16.60 | Rake $0.80 
Board [7s 9c Kh Ac 4d]
Seat 1: GTcLfsDTPqgfHyhY9FNDMw folded before Flop (didn't bet)
Seat 2: SXqVW4Q0evTUVZG6BbUNIA folded on the Flop
Seat 4: rXm4QDVJt67H20lM6n6Z7Q folded before Flop (didn't bet)
Seat 5: uJlzv9KL7hgCIqIS2ofoaw (button) folded before Flop (didn't bet)
Seat 6: z5GxcHlYz/GSz6W2uFiTtg (small blind) folded before Flop
Seat 7: UbybWqarUDNRYlbnju2UUQ (big blind) showed [Jh Kd] and won ($15.80) with a pair of Kings
Seat 8: M2aiKD/Q1d8lySUIbBxeGg mucked
Seat 9: MOlR9YEgKTKLerVIDf8U7w folded before Flop (didn't bet)




PokerStars Game #59939522656:  Hold'em No Limit ($0.10/$0.25) - 2009/07/01 0:42:02 ET
Table 'Utmw+yX+E/wdhNDIim90lQ' 9-max Seat #5 is the button
Seat 1: lwlnPm68QGGI/+pnAd4GAw ($60.10 in chips) 
Seat 2: iGMlK+EhUflPB6jKQd95Cg ($25.20 in chips) 
Seat 3: dfNim92Z6XK1/h5SFW5vDg ($25 in chips) 
Seat 4: ifYGvZDHQQ0aam4awTtHwA ($5.55 in chips) 
Seat 5: H9KUl8cmpLgEpOVDA00bCg ($5 in chips) 
Seat 6: OlPJsgR4xypSg/w1z7Gyvw ($19.75 in chips) 
Seat 7: CImUHesK+ZER4v/VCA9IUg ($64.55 in chips) 
Seat 8: DdPXdieucQ+n99u1n3A+rQ ($4.90 in chips) 
Seat 9: Th3FldXKQW6hWVVPahaoOQ ($27.50 in chips) 
OlPJsgR4xypSg/w1z7Gyvw: posts small blind $0.10
CImUHesK+ZER4v/VCA9IUg: posts big blind $0.25
*** HOLE CARDS ***
DdPXdieucQ+n99u1n3A+rQ: folds 
Th3FldXKQW6hWVVPahaoOQ: folds 
lwlnPm68QGGI/+pnAd4GAw: calls $0.25
iGMlK+EhUflPB6jKQd95Cg: folds 
dfNim92Z6XK1/h5SFW5vDg: folds 
ifYGvZDHQQ0aam4awTtHwA: raises $0.50 to $0.75
H9KUl8cmpLgEpOVDA00bCg: folds 
OlPJsgR4xypSg/w1z7Gyvw: folds 
CImUHesK+ZER4v/VCA9IUg: folds 
lwlnPm68QGGI/+pnAd4GAw: calls $0.50
*** FLOP *** [9c Kd Qh]
lwlnPm68QGGI/+pnAd4GAw: checks 
ifYGvZDHQQ0aam4awTtHwA: bets $1.25
lwlnPm68QGGI/+pnAd4GAw: folds 
Uncalled bet ($1.25) returned to ifYGvZDHQQ0aam4awTtHwA
ifYGvZDHQQ0aam4awTtHwA collected $1.80 from pot
*** SUMMARY ***
Total pot $1.85 | Rake $0.05 
Board [9c Kd Qh]
Seat 1: lwlnPm68QGGI/+pnAd4GAw folded on the Flop
Seat 2: iGMlK+EhUflPB6jKQd95Cg folded before Flop (didn't bet)
Seat 3: dfNim92Z6XK1/h5SFW5vDg folded before Flop (didn't bet)
Seat 4: ifYGvZDHQQ0aam4awTtHwA collected ($1.80)
Seat 5: H9KUl8cmpLgEpOVDA00bCg (button) folded before Flop (didn't bet)
Seat 6: OlPJsgR4xypSg/w1z7Gyvw (small blind) folded before Flop
Seat 7: CImUHesK+ZER4v/VCA9IUg (big blind) folded before Flop
Seat 8: DdPXdieucQ+n99u1n3A+rQ folded before Flop (didn't bet)
Seat 9: Th3FldXKQW6hWVVPahaoOQ folded before Flop (didn't bet)




PokerStars Game #59939523582:  Hold'em No Limit ($0.10/$0.25) - 2009/07/01 0:42:03 ET
Table 'nRFAYu63wZNzrz/OBgzFTw' 9-max Seat #9 is the button
Seat 1: N6fYvIzQLKaydFLKQGtMlQ ($24.75 in chips) 
Seat 2: hJ4uYjNmSZdjrKA8cjZqCA ($20.55 in chips) 
Seat 3: EfRs3ibIxn+c9JDErwwNCg ($28.95 in chips) 
Seat 4: OiV1PWZ3IkN29JlmCcnTwQ ($5.50 in chips) 
Seat 5: vKdukiQ4ktU4yJ0Xx3MKnA ($28.80 in chips) 
Seat 6: DnDcAdn9P0zGovMERigpFA ($25 in chips) 
Seat 7: COsrwJSFHQtxlUcrYtDQPQ ($26.60 in chips) 
Seat 8: amHgC+Q9cpfD/2w2yUtNbw ($10 in chips) 
Seat 9: SXqVW4Q0evTUVZG6BbUNIA ($29.50 in chips) 
N6fYvIzQLKaydFLKQGtMlQ: posts small blind $0.10
hJ4uYjNmSZdjrKA8cjZqCA: posts big blind $0.25
amHgC+Q9cpfD/2w2yUtNbw: posts big blind $0.25
*** HOLE CARDS ***
EfRs3ibIxn+c9JDErwwNCg: folds 
OiV1PWZ3IkN29JlmCcnTwQ: folds 
vKdukiQ4ktU4yJ0Xx3MKnA: folds 
DnDcAdn9P0zGovMERigpFA: folds 
COsrwJSFHQtxlUcrYtDQPQ: raises $0.75 to $1
amHgC+Q9cpfD/2w2yUtNbw: folds 
SXqVW4Q0evTUVZG6BbUNIA: folds 
N6fYvIzQLKaydFLKQGtMlQ: folds 
hJ4uYjNmSZdjrKA8cjZqCA: folds 
Uncalled bet ($0.75) returned to COsrwJSFHQtxlUcrYtDQPQ
COsrwJSFHQtxlUcrYtDQPQ collected $0.85 from pot
COsrwJSFHQtxlUcrYtDQPQ: doesn't show hand 
*** SUMMARY ***
Total pot $0.85 | Rake $0 
Seat 1: N6fYvIzQLKaydFLKQGtMlQ (small blind) folded before Flop
Seat 2: hJ4uYjNmSZdjrKA8cjZqCA (big blind) folded before Flop
Seat 3: EfRs3ibIxn+c9JDErwwNCg folded before Flop (didn't bet)
Seat 4: OiV1PWZ3IkN29JlmCcnTwQ folded before Flop (didn't bet)
Seat 5: vKdukiQ4ktU4yJ0Xx3MKnA folded before Flop (didn't bet)
Seat 6: DnDcAdn9P0zGovMERigpFA folded before Flop (didn't bet)
Seat 7: COsrwJSFHQtxlUcrYtDQPQ collected ($0.85)
Seat 8: amHgC+Q9cpfD/2w2yUtNbw folded before Flop
Seat 9: SXqVW4Q0evTUVZG6BbUNIA (button) folded before Flop (didn't bet)




PokerStars Game #59939523336:  Hold'em No Limit ($0.10/$0.25) - 2009/07/01 0:42:03 ET
Table 'ONP9SkU1SytzTLuNlKzIPw' 9-max Seat #4 is the button
Seat 1: s7Q6uNouhe7aE8JdFb9E+A ($33.95 in chips) 
Seat 2: sJNHTWcSlLHRCZ9+YRLLqA ($25.50 in chips) 
Seat 3: 4BZw8NrbfRfUJKKKd1c2vA ($9.40 in chips) 
Seat 4: rKgOH+UzKBirOiqIwBD9Nw ($7.90 in chips) 
Seat 5: lSeLm4BdnSMLtIli62qjAQ ($4 in chips) 
Seat 6: 6X6eofOkuCCdkJdReOpjUQ ($25.10 in chips) 
Seat 7: DiSvPC2iudwL5j9u6Huyww ($26.20 in chips) 
Seat 8: sUVgUtgbfVx6JpvApozwhQ ($5 in chips) 
lSeLm4BdnSMLtIli62qjAQ: posts small blind $0.10
6X6eofOkuCCdkJdReOpjUQ: posts big blind $0.25
yyG4svzOpC1A+sUP/scg6w: sits out 
*** HOLE CARDS ***
DiSvPC2iudwL5j9u6Huyww: folds 
sUVgUtgbfVx6JpvApozwhQ: folds 
s7Q6uNouhe7aE8JdFb9E+A: folds 
sJNHTWcSlLHRCZ9+YRLLqA: folds 
4BZw8NrbfRfUJKKKd1c2vA: folds 
rKgOH+UzKBirOiqIwBD9Nw: calls $0.25
lSeLm4BdnSMLtIli62qjAQ: folds 
6X6eofOkuCCdkJdReOpjUQ: checks 
*** FLOP *** [4c 3h 5c]
6X6eofOkuCCdkJdReOpjUQ: bets $0.25
rKgOH+UzKBirOiqIwBD9Nw: calls $0.25
*** TURN *** [4c 3h 5c] [Js]
6X6eofOkuCCdkJdReOpjUQ: bets $0.50
rKgOH+UzKBirOiqIwBD9Nw: calls $0.50
*** RIVER *** [4c 3h 5c Js] [Th]
6X6eofOkuCCdkJdReOpjUQ: checks 
rKgOH+UzKBirOiqIwBD9Nw: checks 
*** SHOW DOWN ***
6X6eofOkuCCdkJdReOpjUQ: shows [6d 3s] (a pair of Threes)
rKgOH+UzKBirOiqIwBD9Nw: mucks hand 
6X6eofOkuCCdkJdReOpjUQ collected $2 from pot
*** SUMMARY ***
Total pot $2.10 | Rake $0.10 
Board [4c 3h 5c Js Th]
Seat 1: s7Q6uNouhe7aE8JdFb9E+A folded before Flop (didn't bet)
Seat 2: sJNHTWcSlLHRCZ9+YRLLqA folded before Flop (didn't bet)
Seat 3: 4BZw8NrbfRfUJKKKd1c2vA folded before Flop (didn't bet)
Seat 4: rKgOH+UzKBirOiqIwBD9Nw (button) mucked
Seat 5: lSeLm4BdnSMLtIli62qjAQ (small blind) folded before Flop
Seat 6: 6X6eofOkuCCdkJdReOpjUQ (big blind) showed [6d 3s] and won ($2) with a pair of Threes
Seat 7: DiSvPC2iudwL5j9u6Huyww folded before Flop (didn't bet)
Seat 8: sUVgUtgbfVx6JpvApozwhQ folded before Flop (didn't bet)




PokerStars Game #59939523334:  Hold'em No Limit ($0.10/$0.25) - 2009/07/01 0:42:03 ET
Table '52Meibn9NOL4XtVi1p2UpwpyZQRcpxhWj2y2cT/ydvwwx Seat #9 is the button
Seat 1: TeWJxSETzbXGiYKx0y+dtg ($26.70 in chips) 
Seat 2: Th3FldXKQW6hWVVPahaoOQ ($49.05 in chips) 
Seat 3: DgRMoUciGePff+edyvpt6g ($35.20 in chips) 
Seat 5: 4oA316mXLIui1QY63GXBUg ($25 in chips) 
Seat 6: 4awUyiDYTgylQKXZ9faBVA ($26.85 in chips) 
Seat 7: Xpyqpb+DURDWnyJ3xTEIFQ ($29.80 in chips) 
Seat 8: 18G4P1XstjNvItdGUITxgw ($25 in chips) 
Seat 9: 1K6QGyJP9P9xmRac2fH4OQ ($25.35 in chips) 
TeWJxSETzbXGiYKx0y+dtg: posts small blind $0.10
Th3FldXKQW6hWVVPahaoOQ: posts big blind $0.25
Archi91: sits out 
*** HOLE CARDS ***
DgRMoUciGePff+edyvpt6g: calls $0.25
4oA316mXLIui1QY63GXBUg: folds 
4awUyiDYTgylQKXZ9faBVA: folds 
Xpyqpb+DURDWnyJ3xTEIFQ: folds 
18G4P1XstjNvItdGUITxgw: folds 
1K6QGyJP9P9xmRac2fH4OQ: folds 
TeWJxSETzbXGiYKx0y+dtg: folds 
Th3FldXKQW6hWVVPahaoOQ: checks 
*** FLOP *** [6d 2h 7d]
Th3FldXKQW6hWVVPahaoOQ: checks 
DgRMoUciGePff+edyvpt6g: bets $0.25
Th3FldXKQW6hWVVPahaoOQ: folds 
Uncalled bet ($0.25) returned to DgRMoUciGePff+edyvpt6g
DgRMoUciGePff+edyvpt6g collected $0.60 from pot
*** SUMMARY ***
Total pot $0.60 | Rake $0 
Board [6d 2h 7d]
Seat 1: TeWJxSETzbXGiYKx0y+dtg (small blind) folded before Flop
Seat 2: Th3FldXKQW6hWVVPahaoOQ (big blind) folded on the Flop
Seat 3: DgRMoUciGePff+edyvpt6g collected ($0.60)
Seat 5: 4oA316mXLIui1QY63GXBUg folded before Flop (didn't bet)
Seat 6: 4awUyiDYTgylQKXZ9faBVA folded before Flop (didn't bet)
Seat 7: Xpyqpb+DURDWnyJ3xTEIFQ folded before Flop (didn't bet)
Seat 8: 18G4P1XstjNvItdGUITxgw folded before Flop (didn't bet)
Seat 9: 1K6QGyJP9P9xmRac2fH4OQ (button) folded before Flop (didn't bet)




PokerStars Game #59939523436:  Hold'em No Limit ($0.10/$0.25) - 2009/07/01 0:42:03 ET
Table 'KKk6y4pAXeymxYcd0uZLqg' 9-max Seat #5 is the button
Seat 1: HPEB+AtKw1+C/cxU0o1ciw ($24.55 in chips) 
Seat 3: 4oA316mXLIui1QY63GXBUg ($25 in chips) 
Seat 4: GTcLfsDTPqgfHyhY9FNDMw ($15.50 in chips) 
Seat 5: U0VVxBdRWdhRNdbJ+Qky1A ($45.35 in chips) 
Seat 6: LWN1wPrLH+695JIriXxDuw ($11.35 in chips) 
Seat 7: R3KkgiqTvuhazyCqaD9cZg ($10.30 in chips) 
Seat 8: +2kMBNpY4nF1qNCRd8SJLA ($26.10 in chips) 
Seat 9: j4q3p0lesp63b1gZDwLBZw ($5 in chips) 
LWN1wPrLH+695JIriXxDuw: posts small blind $0.10
R3KkgiqTvuhazyCqaD9cZg: posts big blind $0.25
*** HOLE CARDS ***
+2kMBNpY4nF1qNCRd8SJLA: folds 
j4q3p0lesp63b1gZDwLBZw: folds 
HPEB+AtKw1+C/cxU0o1ciw: raises $0.75 to $1
4oA316mXLIui1QY63GXBUg: folds 
GTcLfsDTPqgfHyhY9FNDMw: folds 
U0VVxBdRWdhRNdbJ+Qky1A: folds 
LWN1wPrLH+695JIriXxDuw: folds 
R3KkgiqTvuhazyCqaD9cZg: folds 
Uncalled bet ($0.75) returned to HPEB+AtKw1+C/cxU0o1ciw
HPEB+AtKw1+C/cxU0o1ciw collected $0.60 from pot
HPEB+AtKw1+C/cxU0o1ciw: doesn't show hand 
*** SUMMARY ***
Total pot $0.60 | Rake $0 
Seat 1: HPEB+AtKw1+C/cxU0o1ciw collected ($0.60)
Seat 3: 4oA316mXLIui1QY63GXBUg folded before Flop (didn't bet)
Seat 4: GTcLfsDTPqgfHyhY9FNDMw folded before Flop (didn't bet)
Seat 5: U0VVxBdRWdhRNdbJ+Qky1A (button) folded before Flop (didn't bet)
Seat 6: LWN1wPrLH+695JIriXxDuw (small blind) folded before Flop
Seat 7: R3KkgiqTvuhazyCqaD9cZg (big blind) folded before Flop
Seat 8: +2kMBNpY4nF1qNCRd8SJLA folded before Flop (didn't bet)
Seat 9: j4q3p0lesp63b1gZDwLBZw folded before Flop (didn't bet)




PokerStars Game #59939523392:  Hold'em No Limit ($0.10/$0.25) - 2009/07/01 0:42:03 ET
Table 'K/f0NNaoGuhSz5DrzgVw7Q' 9-max Seat #7 is the button
Seat 2: 18G4P1XstjNvItdGUITxgw ($25 in chips) 
Seat 3: VBHxUExRAMrbxUq/cVx9Gw ($5.25 in chips) 
Seat 4: 3L1qKVpA6QZjrddTpoh2zQ ($12.75 in chips) 
Seat 5: DnDcAdn9P0zGovMERigpFA ($29.90 in chips) 
Seat 6: 3PVK0IdMlq2fElkVzzr4bg ($17.85 in chips) 
Seat 7: st9jtdNbm1W5GfBwRaCVqQ ($22.45 in chips) 
Seat 8: E0iYnEVO2ho7dH3QcCjw7g ($19.75 in chips) 
Seat 9: B5Xu8WsfFPfBlsK3fbAtQQ ($8.70 in chips) 
E0iYnEVO2ho7dH3QcCjw7g: posts small blind $0.10
B5Xu8WsfFPfBlsK3fbAtQQ: posts big blind $0.25
sD+TKtt36XiiN6jqHiLwDA: sits out 
*** HOLE CARDS ***
18G4P1XstjNvItdGUITxgw: folds 
VBHxUExRAMrbxUq/cVx9Gw: raises $0.75 to $1
3L1qKVpA6QZjrddTpoh2zQ: folds 
DnDcAdn9P0zGovMERigpFA: folds 
3PVK0IdMlq2fElkVzzr4bg: folds 
st9jtdNbm1W5GfBwRaCVqQ: calls $1
E0iYnEVO2ho7dH3QcCjw7g: folds 
B5Xu8WsfFPfBlsK3fbAtQQ: calls $0.75
*** FLOP *** [Qd 4c 8d]
B5Xu8WsfFPfBlsK3fbAtQQ: checks 
VBHxUExRAMrbxUq/cVx9Gw: bets $2
st9jtdNbm1W5GfBwRaCVqQ: raises $2.50 to $4.50
B5Xu8WsfFPfBlsK3fbAtQQ: folds 
VBHxUExRAMrbxUq/cVx9Gw: calls $2.25 and is all-in
Uncalled bet ($0.25) returned to st9jtdNbm1W5GfBwRaCVqQ
*** TURN *** [Qd 4c 8d] [3h]
*** RIVER *** [Qd 4c 8d 3h] [Kd]
*** SHOW DOWN ***
VBHxUExRAMrbxUq/cVx9Gw: shows [Ad Ah] (a pair of Aces)
st9jtdNbm1W5GfBwRaCVqQ: shows [Ks Qh] (two pair, Kings and Queens)
st9jtdNbm1W5GfBwRaCVqQ collected $11.05 from pot
*** SUMMARY ***
Total pot $11.60 | Rake $0.55 
Board [Qd 4c 8d 3h Kd]
Seat 2: 18G4P1XstjNvItdGUITxgw folded before Flop (didn't bet)
Seat 3: VBHxUExRAMrbxUq/cVx9Gw showed [Ad Ah] and lost with a pair of Aces
Seat 4: 3L1qKVpA6QZjrddTpoh2zQ folded before Flop (didn't bet)
Seat 5: DnDcAdn9P0zGovMERigpFA folded before Flop (didn't bet)
Seat 6: 3PVK0IdMlq2fElkVzzr4bg folded before Flop (didn't bet)
Seat 7: st9jtdNbm1W5GfBwRaCVqQ (button) showed [Ks Qh] and won ($11.05) with two pair, Kings and Queens
Seat 8: E0iYnEVO2ho7dH3QcCjw7g (small blind) folded before Flop
Seat 9: B5Xu8WsfFPfBlsK3fbAtQQ (big blind) folded on the Flop




PokerStars Game #59939523134:  Hold'em No Limit ($0.10/$0.25) - 2009/07/01 0:42:03 ET
Table 'sIHZ0lzLr4NGCaBUKhmYhA' 6-max Seat #2 is the button
Seat 1: q6WfTUAD9mowIP63ASq2Dg ($34.45 in chips) 
Seat 2: 1xmHIWgZaOCqEMnW2GkFfw ($11.20 in chips) 
Seat 3: SxIIgwXYLkwd6m3wLyPTCw ($25 in chips) 
Seat 4: 4YSTu0Cdzpppe1lUgCZGCQ ($33.55 in chips) 
SxIIgwXYLkwd6m3wLyPTCw: posts small blind $0.10
4YSTu0Cdzpppe1lUgCZGCQ: posts big blind $0.25
VladBah: sits out 
*** HOLE CARDS ***
q6WfTUAD9mowIP63ASq2Dg: folds 
1xmHIWgZaOCqEMnW2GkFfw: folds 
SxIIgwXYLkwd6m3wLyPTCw: folds 
Uncalled bet ($0.15) returned to 4YSTu0Cdzpppe1lUgCZGCQ
4YSTu0Cdzpppe1lUgCZGCQ collected $0.20 from pot
4YSTu0Cdzpppe1lUgCZGCQ: doesn't show hand 
*** SUMMARY ***
Total pot $0.20 | Rake $0 
Seat 1: q6WfTUAD9mowIP63ASq2Dg folded before Flop (didn't bet)
Seat 2: 1xmHIWgZaOCqEMnW2GkFfw (button) folded before Flop (didn't bet)
Seat 3: SxIIgwXYLkwd6m3wLyPTCw (small blind) folded before Flop
Seat 4: 4YSTu0Cdzpppe1lUgCZGCQ (big blind) collected ($0.20)




PokerStars Game #59939523414:  Hold'em No Limit ($0.10/$0.25) - 2009/07/01 0:42:03 ET
Table '9iHhO6FyZVM8XpSc23TIgg' 6-max Seat #6 is the button
Seat 1: NhUN/JpAprdJeamFBgJH1w ($25 in chips) 
Seat 2: ErIN0JRL5srYjT6en1f8YQ ($31.45 in chips) 
Seat 3: EXTSABh+qTpWWrIkxl3wXg ($43.65 in chips) 
Seat 4: cfJccEfyn6IkquPN08hFsA ($32.05 in chips) 
Seat 5: WmfI+HZXhME/HMG8E3/H2w ($31.70 in chips) 
Seat 6: 5z4PIVM9IyDWfUi+/MMdTA ($0.30 in chips) 
NhUN/JpAprdJeamFBgJH1w: posts small blind $0.10
ErIN0JRL5srYjT6en1f8YQ: posts big blind $0.25
*** HOLE CARDS ***
EXTSABh+qTpWWrIkxl3wXg: folds 
cfJccEfyn6IkquPN08hFsA: folds 
WmfI+HZXhME/HMG8E3/H2w: calls $0.25
5z4PIVM9IyDWfUi+/MMdTA: raises $0.05 to $0.30 and is all-in
NhUN/JpAprdJeamFBgJH1w: folds 
ErIN0JRL5srYjT6en1f8YQ: calls $0.05
WmfI+HZXhME/HMG8E3/H2w: calls $0.05
*** FLOP *** [Ad Ah Qd]
ErIN0JRL5srYjT6en1f8YQ: checks 
WmfI+HZXhME/HMG8E3/H2w: checks 
*** TURN *** [Ad Ah Qd] [2d]
ErIN0JRL5srYjT6en1f8YQ: bets $1
WmfI+HZXhME/HMG8E3/H2w: folds 
Uncalled bet ($1) returned to ErIN0JRL5srYjT6en1f8YQ
*** RIVER *** [Ad Ah Qd 2d] [2s]
*** SHOW DOWN ***
ErIN0JRL5srYjT6en1f8YQ: shows [Ac Jh] (a full house, Aces full of Deuces)
5z4PIVM9IyDWfUi+/MMdTA: mucks hand 
ErIN0JRL5srYjT6en1f8YQ collected $0.95 from pot
*** SUMMARY ***
Total pot $1 | Rake $0.05 
Board [Ad Ah Qd 2d 2s]
Seat 1: NhUN/JpAprdJeamFBgJH1w (small blind) folded before Flop
Seat 2: ErIN0JRL5srYjT6en1f8YQ (big blind) showed [Ac Jh] and won ($0.95) with a full house, Aces full of Deuces
Seat 3: EXTSABh+qTpWWrIkxl3wXg folded before Flop (didn't bet)
Seat 4: cfJccEfyn6IkquPN08hFsA folded before Flop (didn't bet)
Seat 5: WmfI+HZXhME/HMG8E3/H2w folded on the Turn
Seat 6: 5z4PIVM9IyDWfUi+/MMdTA (button) mucked




PokerStars Game #59939523856:  Hold'em No Limit ($0.10/$0.25) - 2009/07/01 0:42:04 ET
Table 'nc6OeGk/wtaWV+6N+kgnZQgZetDqJh6q9A3mLO3ThCsASeat #6 is the button
Seat 1: 1YCU970EVCcjs4GQP5Zt0g ($19.15 in chips) 
Seat 2: JFIAqU8lCZ0vWwEl4bdGsg ($25 in chips) 
Seat 3: wKFJ513ucluNNiMlkXcDOQ ($25 in chips) 
Seat 4: eHsmIvAb2JREg4O6hNPnXg ($8.65 in chips) 
Seat 5: mfrkWA3PTeYPkbO6hi98Aw ($38.40 in chips) 
Seat 6: R1hR3/XSBdOHwcbSUJRJbg ($62 in chips) 
1YCU970EVCcjs4GQP5Zt0g: posts small blind $0.10
JFIAqU8lCZ0vWwEl4bdGsg: posts big blind $0.25
*** HOLE CARDS ***
wKFJ513ucluNNiMlkXcDOQ: folds 
eHsmIvAb2JREg4O6hNPnXg: raises $0.50 to $0.75
mfrkWA3PTeYPkbO6hi98Aw: folds 
R1hR3/XSBdOHwcbSUJRJbg: folds 
1YCU970EVCcjs4GQP5Zt0g: folds 
JFIAqU8lCZ0vWwEl4bdGsg: folds 
Uncalled bet ($0.50) returned to eHsmIvAb2JREg4O6hNPnXg
eHsmIvAb2JREg4O6hNPnXg collected $0.60 from pot
*** SUMMARY ***
Total pot $0.60 | Rake $0 
Seat 1: 1YCU970EVCcjs4GQP5Zt0g (small blind) folded before Flop
Seat 2: JFIAqU8lCZ0vWwEl4bdGsg (big blind) folded before Flop
Seat 3: wKFJ513ucluNNiMlkXcDOQ folded before Flop (didn't bet)
Seat 4: eHsmIvAb2JREg4O6hNPnXg collected ($0.60)
Seat 5: mfrkWA3PTeYPkbO6hi98Aw folded before Flop (didn't bet)
Seat 6: R1hR3/XSBdOHwcbSUJRJbg (button) folded before Flop (didn't bet)




PokerStars Game #59939523760:  Hold'em No Limit ($0.10/$0.25) - 2009/07/01 0:42:04 ET
Table 'g6ryG70feTw9nNm+XJLuXw' 6-max Seat #2 is the button
Seat 1: v+QfkGiuj9bgtuNoVnDO8w ($27.60 in chips) 
Seat 2: SxIIgwXYLkwd6m3wLyPTCw ($25 in chips) 
Seat 3: /6h8PvAHQmfuMUZ8OUF6Xw ($26.65 in chips) 
Seat 4: GC/9yVD59DUCX7hUI7gcLw ($37.90 in chips) 
Seat 5: EE16Ua5b1HSsYej5zeXOlA ($25.35 in chips) 
/6h8PvAHQmfuMUZ8OUF6Xw: posts small blind $0.10
GC/9yVD59DUCX7hUI7gcLw: posts big blind $0.25
*** HOLE CARDS ***
EE16Ua5b1HSsYej5zeXOlA: raises $0.60 to $0.85
v+QfkGiuj9bgtuNoVnDO8w: calls $0.85
SxIIgwXYLkwd6m3wLyPTCw: folds 
/6h8PvAHQmfuMUZ8OUF6Xw: calls $0.75
GC/9yVD59DUCX7hUI7gcLw: folds 
*** FLOP *** [8s 2d 2s]
/6h8PvAHQmfuMUZ8OUF6Xw: checks 
EE16Ua5b1HSsYej5zeXOlA: bets $2
v+QfkGiuj9bgtuNoVnDO8w: folds 
/6h8PvAHQmfuMUZ8OUF6Xw: folds 
Uncalled bet ($2) returned to EE16Ua5b1HSsYej5zeXOlA
EE16Ua5b1HSsYej5zeXOlA collected $2.70 from pot
EE16Ua5b1HSsYej5zeXOlA: doesn't show hand 
*** SUMMARY ***
Total pot $2.80 | Rake $0.10 
Board [8s 2d 2s]
Seat 1: v+QfkGiuj9bgtuNoVnDO8w folded on the Flop
Seat 2: SxIIgwXYLkwd6m3wLyPTCw (button) folded before Flop (didn't bet)
Seat 3: /6h8PvAHQmfuMUZ8OUF6Xw (small blind) folded on the Flop
Seat 4: GC/9yVD59DUCX7hUI7gcLw (big blind) folded before Flop
Seat 5: EE16Ua5b1HSsYej5zeXOlA collected ($2.70)




PokerStars Game #59939523844:  Hold'em No Limit ($0.10/$0.25) - 2009/07/01 0:42:04 ET
Table 'KU/HrxqxwDz8HKEhYTZ6uw' 6-max Seat #1 is the button
Seat 1: gaPMxLGp9SOj4Lq6t+/0Ig ($28 in chips) 
Seat 2: kG34n23qFQA3nzdOJTQ1dA ($24.40 in chips) 
Seat 3: 3seg9SJ1y+HUPN0X0XKF5Q ($11.85 in chips) 
Seat 5: 4YSTu0Cdzpppe1lUgCZGCQ ($36.35 in chips) 
Seat 6: QIWnfLSqfMcoFfdDe5LZPg ($9.80 in chips) 
kG34n23qFQA3nzdOJTQ1dA: posts small blind $0.10
3seg9SJ1y+HUPN0X0XKF5Q: posts big blind $0.25
*** HOLE CARDS ***
4YSTu0Cdzpppe1lUgCZGCQ: folds 
QIWnfLSqfMcoFfdDe5LZPg: folds 
gaPMxLGp9SOj4Lq6t+/0Ig: folds 
kG34n23qFQA3nzdOJTQ1dA: folds 
Uncalled bet ($0.15) returned to 3seg9SJ1y+HUPN0X0XKF5Q
3seg9SJ1y+HUPN0X0XKF5Q collected $0.20 from pot
*** SUMMARY ***
Total pot $0.20 | Rake $0 
Seat 1: gaPMxLGp9SOj4Lq6t+/0Ig (button) folded before Flop (didn't bet)
Seat 2: kG34n23qFQA3nzdOJTQ1dA (small blind) folded before Flop
Seat 3: 3seg9SJ1y+HUPN0X0XKF5Q (big blind) collected ($0.20)
Seat 5: 4YSTu0Cdzpppe1lUgCZGCQ folded before Flop (didn't bet)
Seat 6: QIWnfLSqfMcoFfdDe5LZPg folded before Flop (didn't bet)




PokerStars Game #59939524042:  Hold'em No Limit ($0.10/$0.25) - 2009/07/01 0:42:04 ET
Table 'ORSZkZqq+7Ja2PdeCFAytA' 9-max Seat #1 is the button
Seat 1: Gpa8cld5y0mdOomHJgHhlA ($7.50 in chips) 
Seat 2: yduPKWPzL8YlT5Zv/Nmrwg ($11.55 in chips) 
Seat 5: fOv1xoqR8m9slwElVu7Y+A ($15 in chips) 
yduPKWPzL8YlT5Zv/Nmrwg: posts small blind $0.10
fOv1xoqR8m9slwElVu7Y+A: posts big blind $0.25
*** HOLE CARDS ***
Gpa8cld5y0mdOomHJgHhlA: folds 
yduPKWPzL8YlT5Zv/Nmrwg: raises $11.30 to $11.55 and is all-in
fOv1xoqR8m9slwElVu7Y+A: folds 
Uncalled bet ($11.30) returned to yduPKWPzL8YlT5Zv/Nmrwg
yduPKWPzL8YlT5Zv/Nmrwg collected $0.50 from pot
*** SUMMARY ***
Total pot $0.50 | Rake $0 
Seat 1: Gpa8cld5y0mdOomHJgHhlA (button) folded before Flop (didn't bet)
Seat 2: yduPKWPzL8YlT5Zv/Nmrwg (small blind) collected ($0.50)
Seat 5: fOv1xoqR8m9slwElVu7Y+A (big blind) folded before Flop




PokerStars Game #59939524198:  Hold'em No Limit ($0.10/$0.25) - 2009/07/01 0:42:04 ET
Table 'LXz5SsUCyWcm+4JDJh466A' 9-max Seat #1 is the button
Seat 1: MG90wfSJZnOejs/KD3vlQQ ($23.25 in chips) 
Seat 2: H5Se03ZqSX7tbULXur2MAg ($24.25 in chips) 
Seat 3: Iu9xjReQYvxYiqQm8n6MXQ ($5 in chips) 
Seat 5: OiV1PWZ3IkN29JlmCcnTwQ ($5.10 in chips) 
Seat 6: opOCI2p6kW0tINuVaAqmcQ ($25 in chips) 
Seat 7: EnNp9cILTCYQ95g+8MNFGw ($31.50 in chips) 
Seat 8: VlJdQJbqyBs3oxP5BIw7jA ($94.70 in chips) 
Seat 9: 2N94FgK4Y2izKFIB+wJOjw ($10.25 in chips) 
H5Se03ZqSX7tbULXur2MAg: posts small blind $0.10
Iu9xjReQYvxYiqQm8n6MXQ: posts big blind $0.25
*** HOLE CARDS ***
OiV1PWZ3IkN29JlmCcnTwQ: raises $0.75 to $1
opOCI2p6kW0tINuVaAqmcQ: folds 
EnNp9cILTCYQ95g+8MNFGw: calls $1
VlJdQJbqyBs3oxP5BIw7jA: folds 
2N94FgK4Y2izKFIB+wJOjw: folds 
K0b5wNInj6hUGRr6yzKFtw has returned
MG90wfSJZnOejs/KD3vlQQ: folds 
H5Se03ZqSX7tbULXur2MAg: folds 
Iu9xjReQYvxYiqQm8n6MXQ: folds 
*** FLOP *** [8h 4d 5h]
OiV1PWZ3IkN29JlmCcnTwQ: bets $1
EnNp9cILTCYQ95g+8MNFGw: calls $1
*** TURN *** [8h 4d 5h] [2d]
OiV1PWZ3IkN29JlmCcnTwQ: bets $1.75
EnNp9cILTCYQ95g+8MNFGw: folds 
Uncalled bet ($1.75) returned to OiV1PWZ3IkN29JlmCcnTwQ
OiV1PWZ3IkN29JlmCcnTwQ collected $4.15 from pot
OiV1PWZ3IkN29JlmCcnTwQ: doesn't show hand 
*** SUMMARY ***
Total pot $4.35 | Rake $0.20 
Board [8h 4d 5h 2d]
Seat 1: MG90wfSJZnOejs/KD3vlQQ (button) folded before Flop (didn't bet)
Seat 2: H5Se03ZqSX7tbULXur2MAg (small blind) folded before Flop
Seat 3: Iu9xjReQYvxYiqQm8n6MXQ (big blind) folded before Flop
Seat 5: OiV1PWZ3IkN29JlmCcnTwQ collected ($4.15)
Seat 6: opOCI2p6kW0tINuVaAqmcQ folded before Flop (didn't bet)
Seat 7: EnNp9cILTCYQ95g+8MNFGw folded on the Turn
Seat 8: VlJdQJbqyBs3oxP5BIw7jA folded before Flop (didn't bet)
Seat 9: 2N94FgK4Y2izKFIB+wJOjw folded before Flop (didn't bet)




PokerStars Game #59939524220:  Hold'em No Limit ($0.10/$0.25) - 2009/07/01 0:42:04 ET
Table 'LwnjzXstPtSrqrV/oDpnXQ' 9-max Seat #5 is the button
Seat 1: sChhj/mp8dm+nGvBS5mOIA ($18.85 in chips) 
Seat 2: K7bAhhMMJ/XcTmGaBZVfFQ ($28.30 in chips) 
Seat 3: u+XLsbPQIcRvPRnS1bvZww ($12.40 in chips) 
Seat 4: nmvbguGv4wKulGg49bANbQ ($13.25 in chips) 
Seat 5: Th3FldXKQW6hWVVPahaoOQ ($29.15 in chips) 
Seat 6: ljemhp25Zg+nlA9DLCIiUw ($31.15 in chips) 
Seat 7: c/Dw/6HyqldTzIRodAIZmg ($14 in chips) 
Seat 8: h4ggJZYBXV0mEZzYPYKfeA ($32.80 in chips) 
Seat 9: N6fYvIzQLKaydFLKQGtMlQ ($24.40 in chips) 
ljemhp25Zg+nlA9DLCIiUw: posts small blind $0.10
c/Dw/6HyqldTzIRodAIZmg: posts big blind $0.25
*** HOLE CARDS ***
h4ggJZYBXV0mEZzYPYKfeA: folds 
N6fYvIzQLKaydFLKQGtMlQ: folds 
sChhj/mp8dm+nGvBS5mOIA: folds 
K7bAhhMMJ/XcTmGaBZVfFQ: calls $0.25
u+XLsbPQIcRvPRnS1bvZww: calls $0.25
nmvbguGv4wKulGg49bANbQ: folds 
Th3FldXKQW6hWVVPahaoOQ: folds 
ljemhp25Zg+nlA9DLCIiUw: calls $0.15
c/Dw/6HyqldTzIRodAIZmg: checks 
*** FLOP *** [3h Td Kd]
ljemhp25Zg+nlA9DLCIiUw: checks 
c/Dw/6HyqldTzIRodAIZmg: checks 
K7bAhhMMJ/XcTmGaBZVfFQ: checks 
u+XLsbPQIcRvPRnS1bvZww: checks 
*** TURN *** [3h Td Kd] [Ah]
ljemhp25Zg+nlA9DLCIiUw: checks 
c/Dw/6HyqldTzIRodAIZmg: checks 
K7bAhhMMJ/XcTmGaBZVfFQ: checks 
u+XLsbPQIcRvPRnS1bvZww: bets $0.25
ljemhp25Zg+nlA9DLCIiUw: folds 
c/Dw/6HyqldTzIRodAIZmg: folds 
K7bAhhMMJ/XcTmGaBZVfFQ: calls $0.25
*** RIVER *** [3h Td Kd Ah] [As]
K7bAhhMMJ/XcTmGaBZVfFQ: checks 
u+XLsbPQIcRvPRnS1bvZww: bets $0.75
K7bAhhMMJ/XcTmGaBZVfFQ: folds 
Uncalled bet ($0.75) returned to u+XLsbPQIcRvPRnS1bvZww
u+XLsbPQIcRvPRnS1bvZww collected $1.45 from pot
u+XLsbPQIcRvPRnS1bvZww: doesn't show hand 
*** SUMMARY ***
Total pot $1.50 | Rake $0.05 
Board [3h Td Kd Ah As]
Seat 1: sChhj/mp8dm+nGvBS5mOIA folded before Flop (didn't bet)
Seat 2: K7bAhhMMJ/XcTmGaBZVfFQ folded on the River
Seat 3: u+XLsbPQIcRvPRnS1bvZww collected ($1.45)
Seat 4: nmvbguGv4wKulGg49bANbQ folded before Flop (didn't bet)
Seat 5: Th3FldXKQW6hWVVPahaoOQ (button) folded before Flop (didn't bet)
Seat 6: ljemhp25Zg+nlA9DLCIiUw (small blind) folded on the Turn
Seat 7: c/Dw/6HyqldTzIRodAIZmg (big blind) folded on the Turn
Seat 8: h4ggJZYBXV0mEZzYPYKfeA folded before Flop (didn't bet)
Seat 9: N6fYvIzQLKaydFLKQGtMlQ folded before Flop (didn't bet)




PokerStars Game #59939524272:  Hold'em No Limit ($0.10/$0.25) - 2009/07/01 0:42:05 ET
Table '+68ihX5Br1xgGorX6zsCBg' 9-max Seat #6 is the button
Seat 1: qwr38jl5txoR36M7G5qi4A ($8.40 in chips) 
Seat 2: 3PjJjazzeHcM4mbFeXmZBg ($8.60 in chips) 
Seat 3: DIBbjEYGs+TVdVgEB/4+3w ($25.40 in chips) 
Seat 4: STkR8XvpjNv79OOMhrlh2w ($25 in chips) 
Seat 5: AmFFUA8KSwLGIW6CfaP4JQ ($11.80 in chips) 
Seat 6: 8B/dhbQjIWe6ASCdgzktNQ ($25.85 in chips) 
Seat 7: LWN1wPrLH+695JIriXxDuw ($8.80 in chips) 
Seat 8: rUdM7gwmNCaxMNSb2CFPhQ ($12.45 in chips) 
Seat 9: 3wk6bqORFdwo0pZ1g2+Kqw ($22.25 in chips) 
LWN1wPrLH+695JIriXxDuw: posts small blind $0.10
rUdM7gwmNCaxMNSb2CFPhQ: posts big blind $0.25
*** HOLE CARDS ***
3wk6bqORFdwo0pZ1g2+Kqw: folds 
qwr38jl5txoR36M7G5qi4A: folds 
3PjJjazzeHcM4mbFeXmZBg: folds 
3wk6bqORFdwo0pZ1g2+Kqw leaves the table
DIBbjEYGs+TVdVgEB/4+3w: folds 
3PjJjazzeHcM4mbFeXmZBg leaves the table
STkR8XvpjNv79OOMhrlh2w: raises $0.50 to $0.75
AmFFUA8KSwLGIW6CfaP4JQ: folds 
8B/dhbQjIWe6ASCdgzktNQ: folds 
LWN1wPrLH+695JIriXxDuw: folds 
rUdM7gwmNCaxMNSb2CFPhQ: folds 
Uncalled bet ($0.50) returned to STkR8XvpjNv79OOMhrlh2w
STkR8XvpjNv79OOMhrlh2w collected $0.60 from pot
*** SUMMARY ***
Total pot $0.60 | Rake $0 
Seat 1: qwr38jl5txoR36M7G5qi4A folded before Flop (didn't bet)
Seat 2: 3PjJjazzeHcM4mbFeXmZBg folded before Flop (didn't bet)
Seat 3: DIBbjEYGs+TVdVgEB/4+3w folded before Flop (didn't bet)
Seat 4: STkR8XvpjNv79OOMhrlh2w collected ($0.60)
Seat 5: AmFFUA8KSwLGIW6CfaP4JQ folded before Flop (didn't bet)
Seat 6: 8B/dhbQjIWe6ASCdgzktNQ (button) folded before Flop (didn't bet)
Seat 7: LWN1wPrLH+695JIriXxDuw (small blind) folded before Flop
Seat 8: rUdM7gwmNCaxMNSb2CFPhQ (big blind) folded before Flop
Seat 9: 3wk6bqORFdwo0pZ1g2+Kqw folded before Flop (didn't bet)




PokerStars Game #59939524902:  Hold'em No Limit ($0.10/$0.25) - 2009/07/01 0:42:05 ET
Table 'z2yOdY2zyGWG1gh9WV9XtQ' 9-max Seat #2 is the button
Seat 1: k/tPF1MnFJtmPS14iqcejw ($29.35 in chips) 
Seat 2: s7Q6uNouhe7aE8JdFb9E+A ($25 in chips) 
Seat 3: 7AzEFY3y7BINbVpICeVrHA ($7.75 in chips) 
Seat 4: BMTbQu92kfh1+tEQba3Flw ($17.30 in chips) 
Seat 5: DYB0aP91n+Rg/TIhycbaPQ ($13.40 in chips) 
Seat 6: vZGoOTJLQLhkPj4I+LNGig ($28.60 in chips) 
Seat 7: zDrucyjVn5aeekNEc3cJrA ($26.45 in chips) 
Seat 8: hIss79a4pu7GzJZepfgOpg ($25 in chips) 
7AzEFY3y7BINbVpICeVrHA: posts small blind $0.10
BMTbQu92kfh1+tEQba3Flw: posts big blind $0.25
*** HOLE CARDS ***
DYB0aP91n+Rg/TIhycbaPQ: calls $0.25
vZGoOTJLQLhkPj4I+LNGig: calls $0.25
zDrucyjVn5aeekNEc3cJrA: folds 
hIss79a4pu7GzJZepfgOpg: folds 
k/tPF1MnFJtmPS14iqcejw: folds 
s7Q6uNouhe7aE8JdFb9E+A: folds 
7AzEFY3y7BINbVpICeVrHA: calls $0.15
BMTbQu92kfh1+tEQba3Flw: checks 
*** FLOP *** [Kh Kd 3c]
7AzEFY3y7BINbVpICeVrHA: checks 
BMTbQu92kfh1+tEQba3Flw: checks 
DYB0aP91n+Rg/TIhycbaPQ: checks 
vZGoOTJLQLhkPj4I+LNGig: checks 
*** TURN *** [Kh Kd 3c] [8c]
7AzEFY3y7BINbVpICeVrHA: bets $0.25
BMTbQu92kfh1+tEQba3Flw: folds 
DYB0aP91n+Rg/TIhycbaPQ: calls $0.25
vZGoOTJLQLhkPj4I+LNGig: folds 
*** RIVER *** [Kh Kd 3c 8c] [9c]
7AzEFY3y7BINbVpICeVrHA: bets $0.75
DYB0aP91n+Rg/TIhycbaPQ: calls $0.75
*** SHOW DOWN ***
7AzEFY3y7BINbVpICeVrHA: shows [As 8d] (two pair, Kings and Eights)
DYB0aP91n+Rg/TIhycbaPQ: shows [Ks Td] (three of a kind, Kings)
DYB0aP91n+Rg/TIhycbaPQ collected $2.90 from pot
*** SUMMARY ***
Total pot $3 | Rake $0.10 
Board [Kh Kd 3c 8c 9c]
Seat 1: k/tPF1MnFJtmPS14iqcejw folded before Flop (didn't bet)
Seat 2: s7Q6uNouhe7aE8JdFb9E+A (button) folded before Flop (didn't bet)
Seat 3: 7AzEFY3y7BINbVpICeVrHA (small blind) showed [As 8d] and lost with two pair, Kings and Eights
Seat 4: BMTbQu92kfh1+tEQba3Flw (big blind) folded on the Turn
Seat 5: DYB0aP91n+Rg/TIhycbaPQ showed [Ks Td] and won ($2.90) with three of a kind, Kings
Seat 6: vZGoOTJLQLhkPj4I+LNGig folded on the Turn
Seat 7: zDrucyjVn5aeekNEc3cJrA folded before Flop (didn't bet)
Seat 8: hIss79a4pu7GzJZepfgOpg folded before Flop (didn't bet)




PokerStars Game #59939524348:  Hold'em No Limit ($0.10/$0.25) - 2009/07/01 0:42:05 ET
Table 'nc6OeGk/wtaWV+6N+kgnZQ' 6-max Seat #3 is the button
Seat 1: 0/FYfBoKhINaqU/H5OSS1A ($2.25 in chips) 
Seat 3: 8f0dtuUGqDbgE6up1lQAlg ($5.45 in chips) 
Seat 6: yJgjVkWgiJ8vdWZjcUod2A ($8.90 in chips) 
yJgjVkWgiJ8vdWZjcUod2A: posts small blind $0.10
0/FYfBoKhINaqU/H5OSS1A: posts big blind $0.25
*** HOLE CARDS ***
8f0dtuUGqDbgE6up1lQAlg: calls $0.25
yJgjVkWgiJ8vdWZjcUod2A: calls $0.15
0/FYfBoKhINaqU/H5OSS1A: checks 
*** FLOP *** [7d 4c Ac]
yJgjVkWgiJ8vdWZjcUod2A: checks 
0/FYfBoKhINaqU/H5OSS1A: checks 
8f0dtuUGqDbgE6up1lQAlg: checks 
*** TURN *** [7d 4c Ac] [5s]
yJgjVkWgiJ8vdWZjcUod2A: checks 
0/FYfBoKhINaqU/H5OSS1A: checks 
8f0dtuUGqDbgE6up1lQAlg: checks 
*** RIVER *** [7d 4c Ac 5s] [Kc]
yJgjVkWgiJ8vdWZjcUod2A: checks 
0/FYfBoKhINaqU/H5OSS1A: checks 
8f0dtuUGqDbgE6up1lQAlg: bets $2.25
yJgjVkWgiJ8vdWZjcUod2A: folds 
0/FYfBoKhINaqU/H5OSS1A: folds 
Uncalled bet ($2.25) returned to 8f0dtuUGqDbgE6up1lQAlg
8f0dtuUGqDbgE6up1lQAlg collected $0.75 from pot
*** SUMMARY ***
Total pot $0.75 | Rake $0 
Board [7d 4c Ac 5s Kc]
Seat 1: 0/FYfBoKhINaqU/H5OSS1A (big blind) folded on the River
Seat 3: 8f0dtuUGqDbgE6up1lQAlg (button) collected ($0.75)
Seat 6: yJgjVkWgiJ8vdWZjcUod2A (small blind) folded on the River




PokerStars Game #59939524770:  Hold'em No Limit ($0.10/$0.25) - 2009/07/01 0:42:05 ET
Table 'VuY5ej47Cy8nOI3Wogmhzw' 6-max Seat #4 is the button
Seat 1: aXzmR7FhrqQSWNNmNfbVnw ($19.60 in chips) 
Seat 4: FC6tJ9EOiutXO8hnpR4VgQ ($3.90 in chips) 
Seat 6: +v0nBUereMsRzYp2Knh/cQ ($15.65 in chips) 
+v0nBUereMsRzYp2Knh/cQ: posts small blind $0.10
aXzmR7FhrqQSWNNmNfbVnw: posts big blind $0.25
*** HOLE CARDS ***
FC6tJ9EOiutXO8hnpR4VgQ: calls $0.25
+v0nBUereMsRzYp2Knh/cQ: calls $0.15
aXzmR7FhrqQSWNNmNfbVnw: checks 
*** FLOP *** [Ac 4d 9d]
+v0nBUereMsRzYp2Knh/cQ: checks 
aXzmR7FhrqQSWNNmNfbVnw: checks 
FC6tJ9EOiutXO8hnpR4VgQ: checks 
*** TURN *** [Ac 4d 9d] [3d]
+v0nBUereMsRzYp2Knh/cQ: checks 
aXzmR7FhrqQSWNNmNfbVnw: checks 
FC6tJ9EOiutXO8hnpR4VgQ: checks 
*** RIVER *** [Ac 4d 9d 3d] [Qd]
+v0nBUereMsRzYp2Knh/cQ: checks 
aXzmR7FhrqQSWNNmNfbVnw: checks 
FC6tJ9EOiutXO8hnpR4VgQ: bets $0.50
+v0nBUereMsRzYp2Knh/cQ: calls $0.50
aXzmR7FhrqQSWNNmNfbVnw: folds 
*** SHOW DOWN ***
FC6tJ9EOiutXO8hnpR4VgQ: shows [7s 5s] (high card Ace)
+v0nBUereMsRzYp2Knh/cQ: shows [2c As] (a pair of Aces)
+v0nBUereMsRzYp2Knh/cQ collected $1.70 from pot
*** SUMMARY ***
Total pot $1.75 | Rake $0.05 
Board [Ac 4d 9d 3d Qd]
Seat 1: aXzmR7FhrqQSWNNmNfbVnw (big blind) folded on the River
Seat 4: FC6tJ9EOiutXO8hnpR4VgQ (button) showed [7s 5s] and lost with high card Ace
Seat 6: +v0nBUereMsRzYp2Knh/cQ (small blind) showed [2c As] and won ($1.70) with a pair of Aces




PokerStars Game #59939524642:  Hold'em No Limit ($0.10/$0.25) - 2009/07/01 0:42:05 ET
Table 'dNYnr4D4id1jwnEU66Yowg' 9-max Seat #5 is the button
Seat 1: 41pZ+Uce9oq+8wmcVBXWIg ($16.30 in chips) 
Seat 4: d9fERE+24v0MqnylCrXchQ ($5.90 in chips) 
Seat 5: k+2r6di6GXjNpAdrRkW9bA ($18.30 in chips) 
Lu6miJBtf3FVzUdzCWEtqQ will be allowed to play after the button
41pZ+Uce9oq+8wmcVBXWIg: posts small blind $0.10
d9fERE+24v0MqnylCrXchQ: posts big blind $0.25
*** HOLE CARDS ***
k+2r6di6GXjNpAdrRkW9bA: folds 
41pZ+Uce9oq+8wmcVBXWIg: raises $0.25 to $0.50
k+2r6di6GXjNpAdrRkW9bA leaves the table
d9fERE+24v0MqnylCrXchQ: folds 
Uncalled bet ($0.25) returned to 41pZ+Uce9oq+8wmcVBXWIg
41pZ+Uce9oq+8wmcVBXWIg collected $0.50 from pot
*** SUMMARY ***
Total pot $0.50 | Rake $0 
Seat 1: 41pZ+Uce9oq+8wmcVBXWIg (small blind) collected ($0.50)
Seat 4: d9fERE+24v0MqnylCrXchQ (big blind) folded before Flop
Seat 5: k+2r6di6GXjNpAdrRkW9bA (button) folded before Flop (didn't bet)




PokerStars Game #59939524514:  Hold'em No Limit ($0.10/$0.25) - 2009/07/01 0:42:05 ET
Table '0M5QEJGOThqZwQ/sjbjXYw' 6-max Seat #6 is the button
Seat 1: RVBrV53KVTJ2T2VL8ucnfw ($23.90 in chips) 
Seat 2: /gJNBeCkWL4o85/jvlZ4BA ($47.10 in chips) 
Seat 4: fZQg9veL7Dd/Z04ZTjC+wQ ($32.10 in chips) 
Seat 5: ErIN0JRL5srYjT6en1f8YQ ($27.10 in chips) 
Seat 6: mYz11CHiw5KsDCRD5T7/jg ($60.75 in chips) 
RVBrV53KVTJ2T2VL8ucnfw: posts small blind $0.10
/gJNBeCkWL4o85/jvlZ4BA: posts big blind $0.25
*** HOLE CARDS ***
fZQg9veL7Dd/Z04ZTjC+wQ: raises $0.75 to $1
ErIN0JRL5srYjT6en1f8YQ: folds 
mYz11CHiw5KsDCRD5T7/jg: calls $1
RVBrV53KVTJ2T2VL8ucnfw: folds 
/gJNBeCkWL4o85/jvlZ4BA: folds 
*** FLOP *** [4d 3c 3h]
fZQg9veL7Dd/Z04ZTjC+wQ: checks 
mYz11CHiw5KsDCRD5T7/jg: checks 
*** TURN *** [4d 3c 3h] [Js]
fZQg9veL7Dd/Z04ZTjC+wQ: checks 
mYz11CHiw5KsDCRD5T7/jg: checks 
*** RIVER *** [4d 3c 3h Js] [7c]
fZQg9veL7Dd/Z04ZTjC+wQ: bets $2.25
mYz11CHiw5KsDCRD5T7/jg: folds 
Uncalled bet ($2.25) returned to fZQg9veL7Dd/Z04ZTjC+wQ
fZQg9veL7Dd/Z04ZTjC+wQ collected $2.25 from pot
fZQg9veL7Dd/Z04ZTjC+wQ: doesn't show hand 
*** SUMMARY ***
Total pot $2.35 | Rake $0.10 
Board [4d 3c 3h Js 7c]
Seat 1: RVBrV53KVTJ2T2VL8ucnfw (small blind) folded before Flop
Seat 2: /gJNBeCkWL4o85/jvlZ4BA (big blind) folded before Flop
Seat 4: fZQg9veL7Dd/Z04ZTjC+wQ collected ($2.25)
Seat 5: ErIN0JRL5srYjT6en1f8YQ folded before Flop (didn't bet)
Seat 6: mYz11CHiw5KsDCRD5T7/jg (button) folded on the River




PokerStars Game #59939524768:  Hold'em No Limit ($0.10/$0.25) - 2009/07/01 0:42:05 ET
Table 'L5GvbdQO5aCZJSE6pyQ8OA' 6-max Seat #4 is the button
Seat 1: FOcO5GvOP3rgvLGPLVkg5g ($30.35 in chips) 
Seat 2: LxehwDpTQ19ph4Qmc78+Pw ($15.90 in chips) 
Seat 3: wKFJ513ucluNNiMlkXcDOQ ($28.70 in chips) 
Seat 4: ErIN0JRL5srYjT6en1f8YQ ($21.10 in chips) 
Seat 5: pGthjNbaUqdSv6V/A1ekXw ($12.50 in chips) 
Seat 6: v+QfkGiuj9bgtuNoVnDO8w ($35.25 in chips) 
pGthjNbaUqdSv6V/A1ekXw: posts small blind $0.10
v+QfkGiuj9bgtuNoVnDO8w: posts big blind $0.25
*** HOLE CARDS ***
FOcO5GvOP3rgvLGPLVkg5g: folds 
LxehwDpTQ19ph4Qmc78+Pw: calls $0.25
wKFJ513ucluNNiMlkXcDOQ: raises $1 to $1.25
ErIN0JRL5srYjT6en1f8YQ: calls $1.25
pGthjNbaUqdSv6V/A1ekXw: calls $1.15
v+QfkGiuj9bgtuNoVnDO8w: folds 
LxehwDpTQ19ph4Qmc78+Pw: calls $1
*** FLOP *** [Js Ac Th]
pGthjNbaUqdSv6V/A1ekXw: bets $0.25
LxehwDpTQ19ph4Qmc78+Pw: folds 
wKFJ513ucluNNiMlkXcDOQ: folds 
ErIN0JRL5srYjT6en1f8YQ: raises $1 to $1.25
pGthjNbaUqdSv6V/A1ekXw: raises $1 to $2.25
ErIN0JRL5srYjT6en1f8YQ: raises $2.75 to $5
pGthjNbaUqdSv6V/A1ekXw: calls $2.75
*** TURN *** [Js Ac Th] [6h]
pGthjNbaUqdSv6V/A1ekXw: checks 
ErIN0JRL5srYjT6en1f8YQ: bets $6.25
pGthjNbaUqdSv6V/A1ekXw: calls $6.25 and is all-in
*** RIVER *** [Js Ac Th 6h] [Kh]
*** SHOW DOWN ***
pGthjNbaUqdSv6V/A1ekXw: shows [Ts Ad] (two pair, Aces and Tens)
ErIN0JRL5srYjT6en1f8YQ: shows [Kc Qs] (a straight, Ten to Ace)
ErIN0JRL5srYjT6en1f8YQ collected $26.40 from pot
*** SUMMARY ***
Total pot $27.75 | Rake $1.35 
Board [Js Ac Th 6h Kh]
Seat 1: FOcO5GvOP3rgvLGPLVkg5g folded before Flop (didn't bet)
Seat 2: LxehwDpTQ19ph4Qmc78+Pw folded on the Flop
Seat 3: wKFJ513ucluNNiMlkXcDOQ folded on the Flop
Seat 4: ErIN0JRL5srYjT6en1f8YQ (button) showed [Kc Qs] and won ($26.40) with a straight, Ten to Ace
Seat 5: pGthjNbaUqdSv6V/A1ekXw (small blind) showed [Ts Ad] and lost with two pair, Aces and Tens
Seat 6: v+QfkGiuj9bgtuNoVnDO8w (big blind) folded before Flop




PokerStars Game #59939524428:  Hold'em No Limit ($0.10/$0.25) - 2009/07/01 0:42:05 ET
Table 'AJGgX1ZYM8d68SWMvaLttg' 6-max Seat #1 is the button
Seat 1: sT4sjqzVMH/fZHz0hkbIPw ($37.95 in chips) 
Seat 2: zHHLkD2sRljslKKeQv/ZQw ($30.60 in chips) 
Seat 3: 4x9jCqgSw4272dnaIqnanw ($7.35 in chips) 
Seat 4: Lz/GjRDgmgepqTR7qmS86w ($18.35 in chips) 
Seat 5: SFmT9ZsVopnukjvAzrxTRg ($28.60 in chips) 
Seat 6: UA5OsKS3VPaxa7uC8La/kA ($27.75 in chips) 
zHHLkD2sRljslKKeQv/ZQw: posts small blind $0.10
4x9jCqgSw4272dnaIqnanw: posts big blind $0.25
*** HOLE CARDS ***
Lz/GjRDgmgepqTR7qmS86w: raises $0.75 to $1
SFmT9ZsVopnukjvAzrxTRg: folds 
UA5OsKS3VPaxa7uC8La/kA: folds 
sT4sjqzVMH/fZHz0hkbIPw: calls $1
zHHLkD2sRljslKKeQv/ZQw: folds 
4x9jCqgSw4272dnaIqnanw: folds 
*** FLOP *** [7h 2s 3h]
Lz/GjRDgmgepqTR7qmS86w: checks 
sT4sjqzVMH/fZHz0hkbIPw: bets $2
Lz/GjRDgmgepqTR7qmS86w: folds 
Uncalled bet ($2) returned to sT4sjqzVMH/fZHz0hkbIPw
sT4sjqzVMH/fZHz0hkbIPw collected $2.25 from pot
sT4sjqzVMH/fZHz0hkbIPw: doesn't show hand 
*** SUMMARY ***
Total pot $2.35 | Rake $0.10 
Board [7h 2s 3h]
Seat 1: sT4sjqzVMH/fZHz0hkbIPw (button) collected ($2.25)
Seat 2: zHHLkD2sRljslKKeQv/ZQw (small blind) folded before Flop
Seat 3: 4x9jCqgSw4272dnaIqnanw (big blind) folded before Flop
Seat 4: Lz/GjRDgmgepqTR7qmS86w folded on the Flop
Seat 5: SFmT9ZsVopnukjvAzrxTRg folded before Flop (didn't bet)
Seat 6: UA5OsKS3VPaxa7uC8La/kA folded before Flop (didn't bet)




PokerStars Game #59939524574:  Hold'em No Limit ($0.10/$0.25) - 2009/07/01 0:42:05 ET
Table 'AHkg4ChqzcMauBx6Qvz8Nw' 6-max Seat #3 is the button
Seat 1: b32FRB7ak2jmfrI8EsDhfQ ($4.50 in chips) 
Seat 2: /bjna2FTN7pPjqYGzmDE0Q ($21.70 in chips) 
Seat 3: Zi4SmoY9XJ0iI6ixiSZaWQ ($16.40 in chips) 
Seat 4: N7O9jUEx2YiQn1+yRYTHmw ($19.20 in chips) 
Seat 5: LtASJ9OlkqGrrUKGQlpGAw ($37.05 in chips) 
Seat 6: SFmT9ZsVopnukjvAzrxTRg ($53.05 in chips) 
N7O9jUEx2YiQn1+yRYTHmw: posts small blind $0.10
LtASJ9OlkqGrrUKGQlpGAw: posts big blind $0.25
*** HOLE CARDS ***
SFmT9ZsVopnukjvAzrxTRg: folds 
b32FRB7ak2jmfrI8EsDhfQ: raises $4.25 to $4.50 and is all-in
/bjna2FTN7pPjqYGzmDE0Q: calls $4.50
Zi4SmoY9XJ0iI6ixiSZaWQ: folds 
N7O9jUEx2YiQn1+yRYTHmw: raises $4.25 to $8.75
LtASJ9OlkqGrrUKGQlpGAw: folds 
/bjna2FTN7pPjqYGzmDE0Q: calls $4.25
*** FLOP *** [2c 8h 6h]
N7O9jUEx2YiQn1+yRYTHmw: bets $10.45 and is all-in
/bjna2FTN7pPjqYGzmDE0Q: calls $10.45
*** TURN *** [2c 8h 6h] [6s]
*** RIVER *** [2c 8h 6h 6s] [7s]
*** SHOW DOWN ***
N7O9jUEx2YiQn1+yRYTHmw: shows [Ad Ac] (two pair, Aces and Sixes)
/bjna2FTN7pPjqYGzmDE0Q: mucks hand 
N7O9jUEx2YiQn1+yRYTHmw collected $27.95 from side pot
b32FRB7ak2jmfrI8EsDhfQ: shows [9h 5h] (a straight, Five to Nine)
b32FRB7ak2jmfrI8EsDhfQ collected $13.10 from main pot
*** SUMMARY ***
Total pot $43.15 Main pot $13.10. Side pot $27.95. | Rake $2.10 
Board [2c 8h 6h 6s 7s]
Seat 1: b32FRB7ak2jmfrI8EsDhfQ showed [9h 5h] and won ($13.10) with a straight, Five to Nine
Seat 2: /bjna2FTN7pPjqYGzmDE0Q mucked
Seat 3: Zi4SmoY9XJ0iI6ixiSZaWQ (button) folded before Flop (didn't bet)
Seat 4: N7O9jUEx2YiQn1+yRYTHmw (small blind) showed [Ad Ac] and won ($27.95) with two pair, Aces and Sixes
Seat 5: LtASJ9OlkqGrrUKGQlpGAw (big blind) folded before Flop
Seat 6: SFmT9ZsVopnukjvAzrxTRg folded before Flop (didn't bet)




PokerStars Game #59939524296:  Hold'em No Limit ($0.10/$0.25) - 2009/07/01 0:42:05 ET
Table '9lYs7ljXi6AgFAxYHlKLJw' 9-max Seat #4 is the button
Seat 2: N6fYvIzQLKaydFLKQGtMlQ ($21.40 in chips) 
Seat 3: DnDcAdn9P0zGovMERigpFA ($27.50 in chips) 
Seat 4: UANt6y/SmDCY/jIxkBixcw ($30 in chips) 
Seat 5: dfNim92Z6XK1/h5SFW5vDg ($55.30 in chips) 
Seat 7: ghNKXUBl/H+t83JF079ZBA ($30.10 in chips) 
Seat 9: 18G4P1XstjNvItdGUITxgw ($29.60 in chips) 
dfNim92Z6XK1/h5SFW5vDg: posts small blind $0.10
ghNKXUBl/H+t83JF079ZBA: posts big blind $0.25
*** HOLE CARDS ***
tYsOBqdU1+x+yFI7zHO7hQ joins the table at seat #6 
18G4P1XstjNvItdGUITxgw: raises $0.50 to $0.75
UANt6y/SmDCY/jIxkBixcw said, "i didnt do that to be an ***"
N6fYvIzQLKaydFLKQGtMlQ: folds 
K0b5wNInj6hUGRr6yzKFtw has returned
DnDcAdn9P0zGovMERigpFA: raises $2.50 to $3.25
UANt6y/SmDCY/jIxkBixcw: folds 
dfNim92Z6XK1/h5SFW5vDg: folds 
ghNKXUBl/H+t83JF079ZBA: folds 
18G4P1XstjNvItdGUITxgw: calls $2.50
*** FLOP *** [6h 6s Ts]
18G4P1XstjNvItdGUITxgw: checks 
DnDcAdn9P0zGovMERigpFA: bets $4
18G4P1XstjNvItdGUITxgw: calls $4
*** TURN *** [6h 6s Ts] [8h]
18G4P1XstjNvItdGUITxgw: checks 
Archi91 joins the table at seat #8 
DnDcAdn9P0zGovMERigpFA: checks 
*** RIVER *** [6h 6s Ts 8h] [Td]
18G4P1XstjNvItdGUITxgw: checks 
DnDcAdn9P0zGovMERigpFA: checks 
*** SHOW DOWN ***
18G4P1XstjNvItdGUITxgw: shows [Qh Qd] (two pair, Queens and Tens)
DnDcAdn9P0zGovMERigpFA: mucks hand 
18G4P1XstjNvItdGUITxgw collected $14.15 from pot
*** SUMMARY ***
Total pot $14.85 | Rake $0.70 
Board [6h 6s Ts 8h Td]
Seat 2: N6fYvIzQLKaydFLKQGtMlQ folded before Flop (didn't bet)
Seat 3: DnDcAdn9P0zGovMERigpFA mucked
Seat 4: UANt6y/SmDCY/jIxkBixcw (button) folded before Flop (didn't bet)
Seat 5: dfNim92Z6XK1/h5SFW5vDg (small blind) folded before Flop
Seat 7: ghNKXUBl/H+t83JF079ZBA (big blind) folded before Flop
Seat 9: 18G4P1XstjNvItdGUITxgw showed [Qh Qd] and won ($14.15) with two pair, Queens and Tens




PokerStars Game #59939524274:  Hold'em No Limit ($0.10/$0.25) - 2009/07/01 0:42:05 ET
Table '972HGIb0tQN/zRIK4TABEw' 9-max Seat #1 is the button
Seat 1: fHr2+mGa0RFK3qrpZcVUAQ ($10.40 in chips) 
Seat 3: W4TLQcZ2TiM73eIgpIvlGg ($24.15 in chips) 
Seat 4: BnWWUASA3YjU/ovKqaKNpA ($9.85 in chips) 
Seat 7: qS+jfnNoG75bT+uQ8CKhQA ($12.25 in chips) 
Seat 8: DIBbjEYGs+TVdVgEB/4+3w ($47 in chips) 
Seat 9: qUzFLsH4zPL5Zy77O+Qlbw ($2.85 in chips) 
W4TLQcZ2TiM73eIgpIvlGg: posts small blind $0.10
BnWWUASA3YjU/ovKqaKNpA: posts big blind $0.25
*** HOLE CARDS ***
qS+jfnNoG75bT+uQ8CKhQA: folds 
DIBbjEYGs+TVdVgEB/4+3w: folds 
qUzFLsH4zPL5Zy77O+Qlbw: folds 
fHr2+mGa0RFK3qrpZcVUAQ: folds 
W4TLQcZ2TiM73eIgpIvlGg: calls $0.15
BnWWUASA3YjU/ovKqaKNpA: checks 
*** FLOP *** [3d 4h 5s]
W4TLQcZ2TiM73eIgpIvlGg: checks 
BnWWUASA3YjU/ovKqaKNpA: bets $0.75
W4TLQcZ2TiM73eIgpIvlGg: folds 
Uncalled bet ($0.75) returned to BnWWUASA3YjU/ovKqaKNpA
BnWWUASA3YjU/ovKqaKNpA collected $0.50 from pot
BnWWUASA3YjU/ovKqaKNpA: doesn't show hand 
*** SUMMARY ***
Total pot $0.50 | Rake $0 
Board [3d 4h 5s]
Seat 1: fHr2+mGa0RFK3qrpZcVUAQ (button) folded before Flop (didn't bet)
Seat 3: W4TLQcZ2TiM73eIgpIvlGg (small blind) folded on the Flop
Seat 4: BnWWUASA3YjU/ovKqaKNpA (big blind) collected ($0.50)
Seat 7: qS+jfnNoG75bT+uQ8CKhQA folded before Flop (didn't bet)
Seat 8: DIBbjEYGs+TVdVgEB/4+3w folded before Flop (didn't bet)
Seat 9: qUzFLsH4zPL5Zy77O+Qlbw folded before Flop (didn't bet)




PokerStars Game #59939525520:  Hold'em No Limit ($0.10/$0.25) - 2009/07/01 0:42:06 ET
Table 'GxdLtCpYxqT4aAbYqkEEpw' 6-max Seat #1 is the button
Seat 1: heEf/FkFGS9M1NmwH97YIA ($41.35 in chips) 
Seat 2: hADMNbkECXMb2C/C8R2Wlw ($22.90 in chips) 
Seat 3: 9jSiy0meE9XJKkdIZwyTEQ ($31.30 in chips) 
Seat 4: ErIN0JRL5srYjT6en1f8YQ ($28.85 in chips) 
Seat 5: q6WfTUAD9mowIP63ASq2Dg ($40.75 in chips) 
Seat 6: aogAb4Eienxztk8p2v9VVw ($24.50 in chips) 
hADMNbkECXMb2C/C8R2Wlw: posts small blind $0.10
9jSiy0meE9XJKkdIZwyTEQ: posts big blind $0.25
*** HOLE CARDS ***
ErIN0JRL5srYjT6en1f8YQ: folds 
q6WfTUAD9mowIP63ASq2Dg: folds 
aogAb4Eienxztk8p2v9VVw: folds 
heEf/FkFGS9M1NmwH97YIA: calls $0.25
hADMNbkECXMb2C/C8R2Wlw: calls $0.15
9jSiy0meE9XJKkdIZwyTEQ: raises $1.25 to $1.50
heEf/FkFGS9M1NmwH97YIA: calls $1.25
hADMNbkECXMb2C/C8R2Wlw: folds 
*** FLOP *** [Jh Qs 8s]
9jSiy0meE9XJKkdIZwyTEQ: bets $2.30
heEf/FkFGS9M1NmwH97YIA: calls $2.30
*** TURN *** [Jh Qs 8s] [2c]
9jSiy0meE9XJKkdIZwyTEQ: bets $4.90
heEf/FkFGS9M1NmwH97YIA: calls $4.90
*** RIVER *** [Jh Qs 8s 2c] [Kh]
9jSiy0meE9XJKkdIZwyTEQ: bets $9.20
heEf/FkFGS9M1NmwH97YIA: calls $9.20
*** SHOW DOWN ***
9jSiy0meE9XJKkdIZwyTEQ: shows [Qc Ks] (two pair, Kings and Queens)
heEf/FkFGS9M1NmwH97YIA: shows [6h Qh] (a pair of Queens)
9jSiy0meE9XJKkdIZwyTEQ collected $34.30 from pot
*** SUMMARY ***
Total pot $36.05 | Rake $1.75 
Board [Jh Qs 8s 2c Kh]
Seat 1: heEf/FkFGS9M1NmwH97YIA (button) showed [6h Qh] and lost with a pair of Queens
Seat 2: hADMNbkECXMb2C/C8R2Wlw (small blind) folded before Flop
Seat 3: 9jSiy0meE9XJKkdIZwyTEQ (big blind) showed [Qc Ks] and won ($34.30) with two pair, Kings and Queens
Seat 4: ErIN0JRL5srYjT6en1f8YQ folded before Flop (didn't bet)
Seat 5: q6WfTUAD9mowIP63ASq2Dg folded before Flop (didn't bet)
Seat 6: aogAb4Eienxztk8p2v9VVw folded before Flop (didn't bet)




PokerStars Game #59939525386:  Hold'em No Limit ($0.10/$0.25) - 2009/07/01 0:42:06 ET
Table 'wRXcD9iXgBbdvKhWmfnBnw' 6-max Seat #2 is the button
Seat 1: LGWRgaQNaDFSlUGk26f0Ig ($24.55 in chips) 
Seat 2: SS/yfeArhULzIcOPe8MdPg ($25 in chips) 
Seat 3: 6zbQpY/G44U1Xvj7DZex0A ($14.80 in chips) 
Seat 4: mfrkWA3PTeYPkbO6hi98Aw ($26.05 in chips) 
Seat 5: EE16Ua5b1HSsYej5zeXOlA ($29.75 in chips) 
Seat 6: rhWCqDS9OBh/IoXY29BGMw ($19.30 in chips) 
6zbQpY/G44U1Xvj7DZex0A: posts small blind $0.10
mfrkWA3PTeYPkbO6hi98Aw: posts big blind $0.25
*** HOLE CARDS ***
EE16Ua5b1HSsYej5zeXOlA: folds 
rhWCqDS9OBh/IoXY29BGMw: raises $0.50 to $0.75
LGWRgaQNaDFSlUGk26f0Ig: folds 
SS/yfeArhULzIcOPe8MdPg: folds 
6zbQpY/G44U1Xvj7DZex0A: folds 
mfrkWA3PTeYPkbO6hi98Aw: calls $0.50
*** FLOP *** [6d 7c 2s]
mfrkWA3PTeYPkbO6hi98Aw: checks 
rhWCqDS9OBh/IoXY29BGMw: bets $3.50
mfrkWA3PTeYPkbO6hi98Aw: folds 
Uncalled bet ($3.50) returned to rhWCqDS9OBh/IoXY29BGMw
rhWCqDS9OBh/IoXY29BGMw collected $1.55 from pot
*** SUMMARY ***
Total pot $1.60 | Rake $0.05 
Board [6d 7c 2s]
Seat 1: LGWRgaQNaDFSlUGk26f0Ig folded before Flop (didn't bet)
Seat 2: SS/yfeArhULzIcOPe8MdPg (button) folded before Flop (didn't bet)
Seat 3: 6zbQpY/G44U1Xvj7DZex0A (small blind) folded before Flop
Seat 4: mfrkWA3PTeYPkbO6hi98Aw (big blind) folded on the Flop
Seat 5: EE16Ua5b1HSsYej5zeXOlA folded before Flop (didn't bet)
Seat 6: rhWCqDS9OBh/IoXY29BGMw collected ($1.55)




PokerStars Game #59939525128:  Hold'em No Limit ($0.10/$0.25) - 2009/07/01 0:42:06 ET
Table 'MQJMxKDF6VYBWIKv7VfCog' 9-max Seat #4 is the button
Seat 1: cZ99hugmLBj9KhTlc8nCSw ($26.55 in chips) 
Seat 4: JtVGnq5doRa3PublncR+Yw ($24.25 in chips) 
Seat 5: RJ/x9oZtt1RZLaJEQwZOxQ ($25.70 in chips) 
Seat 7: dfNim92Z6XK1/h5SFW5vDg ($52.95 in chips) 
Seat 8: Z9AeOQX3yzuSvKAm/xyovg ($9.30 in chips) 
Seat 9: 1S/fpm+f42V/6MNZre+ccg ($36.10 in chips) 
RJ/x9oZtt1RZLaJEQwZOxQ: posts small blind $0.10
dfNim92Z6XK1/h5SFW5vDg: posts big blind $0.25
*** HOLE CARDS ***
Z9AeOQX3yzuSvKAm/xyovg: folds 
1S/fpm+f42V/6MNZre+ccg: folds 
cZ99hugmLBj9KhTlc8nCSw: folds 
JtVGnq5doRa3PublncR+Yw: folds 
RJ/x9oZtt1RZLaJEQwZOxQ: raises $0.50 to $0.75
dfNim92Z6XK1/h5SFW5vDg: folds 
Uncalled bet ($0.50) returned to RJ/x9oZtt1RZLaJEQwZOxQ
RJ/x9oZtt1RZLaJEQwZOxQ collected $0.50 from pot
RJ/x9oZtt1RZLaJEQwZOxQ: doesn't show hand 
*** SUMMARY ***
Total pot $0.50 | Rake $0 
Seat 1: cZ99hugmLBj9KhTlc8nCSw folded before Flop (didn't bet)
Seat 4: JtVGnq5doRa3PublncR+Yw (button) folded before Flop (didn't bet)
Seat 5: RJ/x9oZtt1RZLaJEQwZOxQ (small blind) collected ($0.50)
Seat 7: dfNim92Z6XK1/h5SFW5vDg (big blind) folded before Flop
Seat 8: Z9AeOQX3yzuSvKAm/xyovg folded before Flop (didn't bet)
Seat 9: 1S/fpm+f42V/6MNZre+ccg folded before Flop (didn't bet)




PokerStars Game #59939525400:  Hold'em No Limit ($0.10/$0.25) - 2009/07/01 0:42:06 ET
Table '+198VWQSWBhYQOcizzuBkw' 6-max Seat #2 is the button
Seat 2: R6AGToFJQOYVZAjC2jXEKw ($28.80 in chips) 
Seat 3: BYxjLnV1/LL0aZcTbfAOvw ($27.60 in chips) 
Seat 4: TgDsTeCdLQt8kWbL00ByRA ($27.25 in chips) 
Seat 5: LtASJ9OlkqGrrUKGQlpGAw ($30.30 in chips) 
Seat 6: 7qRk4YH4/k/08LgJSv7rBQ ($31.25 in chips) 
BYxjLnV1/LL0aZcTbfAOvw: posts small blind $0.10
TgDsTeCdLQt8kWbL00ByRA: posts big blind $0.25
*** HOLE CARDS ***
TIAOPOKER2 joins the table at seat #1 
LtASJ9OlkqGrrUKGQlpGAw: folds 
7qRk4YH4/k/08LgJSv7rBQ: folds 
R6AGToFJQOYVZAjC2jXEKw: raises $0.50 to $0.75
BYxjLnV1/LL0aZcTbfAOvw: folds 
TgDsTeCdLQt8kWbL00ByRA: calls $0.50
*** FLOP *** [4h Qh Js]
TgDsTeCdLQt8kWbL00ByRA: checks 
R6AGToFJQOYVZAjC2jXEKw: bets $1
TgDsTeCdLQt8kWbL00ByRA: calls $1
*** TURN *** [4h Qh Js] [Jc]
TgDsTeCdLQt8kWbL00ByRA: checks 
R6AGToFJQOYVZAjC2jXEKw: checks 
*** RIVER *** [4h Qh Js Jc] [7h]
TgDsTeCdLQt8kWbL00ByRA: bets $1.50
R6AGToFJQOYVZAjC2jXEKw: raises $1.50 to $3
TgDsTeCdLQt8kWbL00ByRA: raises $5.50 to $8.50
R6AGToFJQOYVZAjC2jXEKw: calls $5.50
*** SHOW DOWN ***
TgDsTeCdLQt8kWbL00ByRA: shows [Qs Jd] (a full house, Jacks full of Queens)
R6AGToFJQOYVZAjC2jXEKw: mucks hand 
TgDsTeCdLQt8kWbL00ByRA collected $19.60 from pot
*** SUMMARY ***
Total pot $20.60 | Rake $1 
Board [4h Qh Js Jc 7h]
Seat 2: R6AGToFJQOYVZAjC2jXEKw (button) mucked
Seat 3: BYxjLnV1/LL0aZcTbfAOvw (small blind) folded before Flop
Seat 4: TgDsTeCdLQt8kWbL00ByRA (big blind) showed [Qs Jd] and won ($19.60) with a full house, Jacks full of Queens
Seat 5: LtASJ9OlkqGrrUKGQlpGAw folded before Flop (didn't bet)
Seat 6: 7qRk4YH4/k/08LgJSv7rBQ folded before Flop (didn't bet)




PokerStars Game #59939525126:  Hold'em No Limit ($0.10/$0.25) - 2009/07/01 0:42:06 ET
Table 'OvOqQoL/QnXuXuQjXo2hIQ' 9-max Seat #6 is the button
Seat 3: uJlzv9KL7hgCIqIS2ofoaw ($16.65 in chips) 
Seat 5: sJNHTWcSlLHRCZ9+YRLLqA ($27.95 in chips) 
Seat 6: MIVCHqCqqlke0Lb0z7glcw ($46.05 in chips) 
Seat 7: aNpwfA31EREwO+ar4XzBCw ($27.90 in chips) 
Seat 9: VWUWpMLMj/Q1jRVpF7Aohw ($14.60 in chips) 
aNpwfA31EREwO+ar4XzBCw: posts small blind $0.10
VWUWpMLMj/Q1jRVpF7Aohw: posts big blind $0.25
*** HOLE CARDS ***
uJlzv9KL7hgCIqIS2ofoaw: raises $0.50 to $0.75
sJNHTWcSlLHRCZ9+YRLLqA: folds 
MIVCHqCqqlke0Lb0z7glcw: folds 
aNpwfA31EREwO+ar4XzBCw: folds 
VWUWpMLMj/Q1jRVpF7Aohw: folds 
Uncalled bet ($0.50) returned to uJlzv9KL7hgCIqIS2ofoaw
uJlzv9KL7hgCIqIS2ofoaw collected $0.60 from pot
uJlzv9KL7hgCIqIS2ofoaw: doesn't show hand 
*** SUMMARY ***
Total pot $0.60 | Rake $0 
Seat 3: uJlzv9KL7hgCIqIS2ofoaw collected ($0.60)
Seat 5: sJNHTWcSlLHRCZ9+YRLLqA folded before Flop (didn't bet)
Seat 6: MIVCHqCqqlke0Lb0z7glcw (button) folded before Flop (didn't bet)
Seat 7: aNpwfA31EREwO+ar4XzBCw (small blind) folded before Flop
Seat 9: VWUWpMLMj/Q1jRVpF7Aohw (big blind) folded before Flop




PokerStars Game #59939525512:  Hold'em No Limit ($0.10/$0.25) - 2009/07/01 0:42:06 ET
Table 'BmUMTVcNATeov2rAGYU0Qg' 9-max Seat #8 is the button
Seat 1: v5jnQ1gfh9nLla3kMXG7Yg ($4.50 in chips) 
Seat 2: jJnMGXoBXye+afMd0k0rUw ($11.80 in chips) 
Seat 3: hJ4uYjNmSZdjrKA8cjZqCA ($20 in chips) 
Seat 4: aNpwfA31EREwO+ar4XzBCw ($35.85 in chips) 
Seat 5: EBPuArucumZnjWoW71jHBg ($47.25 in chips) 
Seat 6: JxpnpCmvRAcrEUy7mq1iAg ($5.90 in chips) 
Seat 7: zWJ/yHAvi0TtCR9RMsJosQ ($59.50 in chips) 
Seat 8: f/H6PsHRl4W1JyNsEDvPtg ($11.25 in chips) 
v5jnQ1gfh9nLla3kMXG7Yg: posts small blind $0.10
jJnMGXoBXye+afMd0k0rUw: posts big blind $0.25
*** HOLE CARDS ***
hJ4uYjNmSZdjrKA8cjZqCA: calls $0.25
aNpwfA31EREwO+ar4XzBCw: folds 
EBPuArucumZnjWoW71jHBg: folds 
JxpnpCmvRAcrEUy7mq1iAg: raises $0.75 to $1
zWJ/yHAvi0TtCR9RMsJosQ: folds 
f/H6PsHRl4W1JyNsEDvPtg: folds 
v5jnQ1gfh9nLla3kMXG7Yg: folds 
jJnMGXoBXye+afMd0k0rUw: folds 
hJ4uYjNmSZdjrKA8cjZqCA: calls $0.75
*** FLOP *** [2h Jh Jc]
hJ4uYjNmSZdjrKA8cjZqCA: checks 
JxpnpCmvRAcrEUy7mq1iAg: bets $1
hJ4uYjNmSZdjrKA8cjZqCA: calls $1
*** TURN *** [2h Jh Jc] [Qs]
hJ4uYjNmSZdjrKA8cjZqCA: checks 
JxpnpCmvRAcrEUy7mq1iAg: checks 
*** RIVER *** [2h Jh Jc Qs] [9d]
hJ4uYjNmSZdjrKA8cjZqCA: bets $4.50
JxpnpCmvRAcrEUy7mq1iAg: folds 
Uncalled bet ($4.50) returned to hJ4uYjNmSZdjrKA8cjZqCA
hJ4uYjNmSZdjrKA8cjZqCA collected $4.15 from pot
*** SUMMARY ***
Total pot $4.35 | Rake $0.20 
Board [2h Jh Jc Qs 9d]
Seat 1: v5jnQ1gfh9nLla3kMXG7Yg (small blind) folded before Flop
Seat 2: jJnMGXoBXye+afMd0k0rUw (big blind) folded before Flop
Seat 3: hJ4uYjNmSZdjrKA8cjZqCA collected ($4.15)
Seat 4: aNpwfA31EREwO+ar4XzBCw folded before Flop (didn't bet)
Seat 5: EBPuArucumZnjWoW71jHBg folded before Flop (didn't bet)
Seat 6: JxpnpCmvRAcrEUy7mq1iAg folded on the River
Seat 7: zWJ/yHAvi0TtCR9RMsJosQ folded before Flop (didn't bet)
Seat 8: f/H6PsHRl4W1JyNsEDvPtg (button) folded before Flop (didn't bet)




PokerStars Game #59939525252:  Hold'em No Limit ($0.10/$0.25) - 2009/07/01 0:42:06 ET
Table 'KEoOIegxPF91KooL2AelUA' 6-max Seat #6 is the button
Seat 1: wsP46AGpqDjHZQmlRHKa9g ($28.90 in chips) 
Seat 4: Vv37Oa9niKKVcR6Z7ceetw ($22.20 in chips) 
Seat 5: 2NLC44AHHKHEUooUQFYV+Q ($13.75 in chips) 
Seat 6: Jq3YrbGb738j4tRTnp4PDA ($14.65 in chips) 
wsP46AGpqDjHZQmlRHKa9g: posts small blind $0.10
Vv37Oa9niKKVcR6Z7ceetw: posts big blind $0.25
*** HOLE CARDS ***
2NLC44AHHKHEUooUQFYV+Q: calls $0.25
Jq3YrbGb738j4tRTnp4PDA: folds 
wsP46AGpqDjHZQmlRHKa9g: folds 
Vv37Oa9niKKVcR6Z7ceetw: checks 
*** FLOP *** [Th Qc Kd]
Vv37Oa9niKKVcR6Z7ceetw: checks 
2NLC44AHHKHEUooUQFYV+Q: checks 
*** TURN *** [Th Qc Kd] [Tc]
Vv37Oa9niKKVcR6Z7ceetw: checks 
2NLC44AHHKHEUooUQFYV+Q: checks 
*** RIVER *** [Th Qc Kd Tc] [5h]
Vv37Oa9niKKVcR6Z7ceetw: checks 
2NLC44AHHKHEUooUQFYV+Q: checks 
*** SHOW DOWN ***
Vv37Oa9niKKVcR6Z7ceetw: shows [9d 7d] (a pair of Tens)
2NLC44AHHKHEUooUQFYV+Q: shows [6s 5s] (two pair, Tens and Fives)
2NLC44AHHKHEUooUQFYV+Q collected $0.60 from pot
*** SUMMARY ***
Total pot $0.60 | Rake $0 
Board [Th Qc Kd Tc 5h]
Seat 1: wsP46AGpqDjHZQmlRHKa9g (small blind) folded before Flop
Seat 4: Vv37Oa9niKKVcR6Z7ceetw (big blind) showed [9d 7d] and lost with a pair of Tens
Seat 5: 2NLC44AHHKHEUooUQFYV+Q showed [6s 5s] and won ($0.60) with two pair, Tens and Fives
Seat 6: Jq3YrbGb738j4tRTnp4PDA (button) folded before Flop (didn't bet)




PokerStars Game #59939525704:  Hold'em No Limit ($0.10/$0.25) - 2009/07/01 0:42:07 ET
Table 'biAgO3TKQBU8XcrVAoU5TA' 6-max Seat #2 is the button
Seat 2: 7qRk4YH4/k/08LgJSv7rBQ ($24.85 in chips) 
Seat 3: 7AHdX4G8gYtDJyNY+wK+6Q ($32.10 in chips) 
Seat 4: 2/AObG8G5tKFCPZ+CdivJQ ($8.95 in chips) 
Seat 6: //i5P+6lSkIyZsqb+ojVQA ($14.65 in chips) 
7AHdX4G8gYtDJyNY+wK+6Q: posts small blind $0.10
2/AObG8G5tKFCPZ+CdivJQ: posts big blind $0.25
6DwBRH+xZ12AAZmeAg+aXw: sits out 
i48129QFpEQQ+UN4aNtmww: sits out 
*** HOLE CARDS ***
//i5P+6lSkIyZsqb+ojVQA: calls $0.25
7qRk4YH4/k/08LgJSv7rBQ: folds 
7AHdX4G8gYtDJyNY+wK+6Q: raises $0.50 to $0.75
2/AObG8G5tKFCPZ+CdivJQ: folds 
//i5P+6lSkIyZsqb+ojVQA: folds 
Uncalled bet ($0.50) returned to 7AHdX4G8gYtDJyNY+wK+6Q
7AHdX4G8gYtDJyNY+wK+6Q collected $0.75 from pot
*** SUMMARY ***
Total pot $0.75 | Rake $0 
Seat 2: 7qRk4YH4/k/08LgJSv7rBQ (button) folded before Flop (didn't bet)
Seat 3: 7AHdX4G8gYtDJyNY+wK+6Q (small blind) collected ($0.75)
Seat 4: 2/AObG8G5tKFCPZ+CdivJQ (big blind) folded before Flop
Seat 6: //i5P+6lSkIyZsqb+ojVQA folded before Flop




PokerStars Game #59939525746:  Hold'em No Limit ($0.10/$0.25) - 2009/07/01 0:42:07 ET
Table 'n8mNkPYbe1AIQEkioNesZA' 9-max Seat #6 is the button
Seat 1: /VQLorsEOrMfI+KamzNQEA ($2.40 in chips) 
Seat 2: QEbIGci+itdw+re8RM5fZA ($35 in chips) 
Seat 3: zDrucyjVn5aeekNEc3cJrA ($19.70 in chips) 
Seat 4: ZeR3hkj1gVv9J4yPCmRrjA ($27.60 in chips) 
Seat 5: j5kXXioAn7mKbcDKt4UzMw ($13.90 in chips) 
Seat 6: HPEB+AtKw1+C/cxU0o1ciw ($41.15 in chips) 
Seat 7: BrlfhE2AlcawLAz+eF5BDg ($5.35 in chips) 
Seat 8: N6fYvIzQLKaydFLKQGtMlQ ($27.40 in chips) 
Seat 9: gehe91e0IyVT0QU/XBkEyg ($28.50 in chips) 
BrlfhE2AlcawLAz+eF5BDg: posts small blind $0.10
N6fYvIzQLKaydFLKQGtMlQ: posts big blind $0.25
*** HOLE CARDS ***
gehe91e0IyVT0QU/XBkEyg: folds 
/VQLorsEOrMfI+KamzNQEA: folds 
QEbIGci+itdw+re8RM5fZA: folds 
zDrucyjVn5aeekNEc3cJrA: folds 
ZeR3hkj1gVv9J4yPCmRrjA: raises $0.50 to $0.75
j5kXXioAn7mKbcDKt4UzMw: calls $0.75
HPEB+AtKw1+C/cxU0o1ciw: calls $0.75
BrlfhE2AlcawLAz+eF5BDg: calls $0.65
N6fYvIzQLKaydFLKQGtMlQ: folds 
*** FLOP *** [6s 2s 2c]
BrlfhE2AlcawLAz+eF5BDg: checks 
ZeR3hkj1gVv9J4yPCmRrjA has timed out
ZeR3hkj1gVv9J4yPCmRrjA: checks 
j5kXXioAn7mKbcDKt4UzMw: checks 
HPEB+AtKw1+C/cxU0o1ciw: bets $1.90
BrlfhE2AlcawLAz+eF5BDg: folds 
ZeR3hkj1gVv9J4yPCmRrjA has timed out
ZeR3hkj1gVv9J4yPCmRrjA: folds 
ZeR3hkj1gVv9J4yPCmRrjA is sitting out
j5kXXioAn7mKbcDKt4UzMw: calls $1.90
*** TURN *** [6s 2s 2c] [9c]
j5kXXioAn7mKbcDKt4UzMw: bets $1.50
HPEB+AtKw1+C/cxU0o1ciw: calls $1.50
*** RIVER *** [6s 2s 2c 9c] [Qs]
j5kXXioAn7mKbcDKt4UzMw: bets $2.50
HPEB+AtKw1+C/cxU0o1ciw: folds 
Uncalled bet ($2.50) returned to j5kXXioAn7mKbcDKt4UzMw
j5kXXioAn7mKbcDKt4UzMw collected $9.60 from pot
j5kXXioAn7mKbcDKt4UzMw: doesn't show hand 
*** SUMMARY ***
Total pot $10.05 | Rake $0.45 
Board [6s 2s 2c 9c Qs]
Seat 1: /VQLorsEOrMfI+KamzNQEA folded before Flop (didn't bet)
Seat 2: QEbIGci+itdw+re8RM5fZA folded before Flop (didn't bet)
Seat 3: zDrucyjVn5aeekNEc3cJrA folded before Flop (didn't bet)
Seat 4: ZeR3hkj1gVv9J4yPCmRrjA folded on the Flop
Seat 5: j5kXXioAn7mKbcDKt4UzMw collected ($9.60)
Seat 6: HPEB+AtKw1+C/cxU0o1ciw (button) folded on the River
Seat 7: BrlfhE2AlcawLAz+eF5BDg (small blind) folded on the Flop
Seat 8: N6fYvIzQLKaydFLKQGtMlQ (big blind) folded before Flop
Seat 9: gehe91e0IyVT0QU/XBkEyg folded before Flop (didn't bet)




PokerStars Game #59939526066:  Hold'em No Limit ($0.10/$0.25) - 2009/07/01 0:42:07 ET
Table 'NgexmgEDEzICBeSO7YCrKQ' 6-max Seat #1 is the button
Seat 1: oseFhpinoe+Zg4j5xyBjyQ ($70.75 in chips) 
Seat 2: 32YL2ZEp8NT4JB2RVM9euQ ($15.75 in chips) 
Seat 3: JFIAqU8lCZ0vWwEl4bdGsg ($26.90 in chips) 
Seat 4: xx+iYCDJhHJmNzrfeloyEg ($36.85 in chips) 
Seat 5: /MXkdT8TTs8Qp2LVTQNw6w ($49.15 in chips) 
Seat 6: k9nHZTHt8hYhYRcW8NTb4g ($8.95 in chips) 
32YL2ZEp8NT4JB2RVM9euQ: posts small blind $0.10
JFIAqU8lCZ0vWwEl4bdGsg: posts big blind $0.25
*** HOLE CARDS ***
xx+iYCDJhHJmNzrfeloyEg said, "  I don't know what to think."
xx+iYCDJhHJmNzrfeloyEg: calls $0.25
xx+iYCDJhHJmNzrfeloyEg said, "  so I don't."
/MXkdT8TTs8Qp2LVTQNw6w: folds 
k9nHZTHt8hYhYRcW8NTb4g: folds 
oseFhpinoe+Zg4j5xyBjyQ: folds 
32YL2ZEp8NT4JB2RVM9euQ: folds 
JFIAqU8lCZ0vWwEl4bdGsg: checks 
*** FLOP *** [Kd 9c 5s]
JFIAqU8lCZ0vWwEl4bdGsg: checks 
xx+iYCDJhHJmNzrfeloyEg: bets $0.50
/MXkdT8TTs8Qp2LVTQNw6w said, "better be thinking that i'm bringing my A game today"
JFIAqU8lCZ0vWwEl4bdGsg: folds 
Uncalled bet ($0.50) returned to xx+iYCDJhHJmNzrfeloyEg
xx+iYCDJhHJmNzrfeloyEg collected $0.60 from pot
xx+iYCDJhHJmNzrfeloyEg: doesn't show hand 
*** SUMMARY ***
Total pot $0.60 | Rake $0 
Board [Kd 9c 5s]
Seat 1: oseFhpinoe+Zg4j5xyBjyQ (button) folded before Flop (didn't bet)
Seat 2: 32YL2ZEp8NT4JB2RVM9euQ (small blind) folded before Flop
Seat 3: JFIAqU8lCZ0vWwEl4bdGsg (big blind) folded on the Flop
Seat 4: xx+iYCDJhHJmNzrfeloyEg collected ($0.60)
Seat 5: /MXkdT8TTs8Qp2LVTQNw6w folded before Flop (didn't bet)
Seat 6: k9nHZTHt8hYhYRcW8NTb4g folded before Flop (didn't bet)




PokerStars Game #59939525576:  Hold'em No Limit ($0.10/$0.25) - 2009/07/01 0:42:07 ET
Table 'LLHSnYPAXNI1sFlwPBn1tA' 6-max Seat #1 is the button
Seat 1: tVZW8k4GP+PvZ1DjD/9StA ($10.75 in chips) 
Seat 2: oseFhpinoe+Zg4j5xyBjyQ ($24.30 in chips) 
Seat 3: JFIAqU8lCZ0vWwEl4bdGsg ($27.90 in chips) 
Seat 4: FPlQHZog0ePFCETQ2KG4hQ ($27.20 in chips) 
Seat 5: jXbd3O6QdeNWctmpAsTgHA ($14.40 in chips) 
Seat 6: PCh4iIHq9rXvWY/FeXc/Jg ($31.95 in chips) 
oseFhpinoe+Zg4j5xyBjyQ: posts small blind $0.10
JFIAqU8lCZ0vWwEl4bdGsg: posts big blind $0.25
*** HOLE CARDS ***
FPlQHZog0ePFCETQ2KG4hQ: folds 
jXbd3O6QdeNWctmpAsTgHA: folds 
PCh4iIHq9rXvWY/FeXc/Jg: raises $0.50 to $0.75
tVZW8k4GP+PvZ1DjD/9StA: calls $0.75
oseFhpinoe+Zg4j5xyBjyQ: folds 
JFIAqU8lCZ0vWwEl4bdGsg: raises $2.50 to $3.25
PCh4iIHq9rXvWY/FeXc/Jg: folds 
tVZW8k4GP+PvZ1DjD/9StA: calls $2.50
*** FLOP *** [7d Jh Ad]
JFIAqU8lCZ0vWwEl4bdGsg: bets $5
tVZW8k4GP+PvZ1DjD/9StA: raises $2.50 to $7.50 and is all-in
JFIAqU8lCZ0vWwEl4bdGsg: calls $2.50
*** TURN *** [7d Jh Ad] [6s]
*** RIVER *** [7d Jh Ad 6s] [2s]
*** SHOW DOWN ***
JFIAqU8lCZ0vWwEl4bdGsg: shows [Kh Ks] (a pair of Kings)
tVZW8k4GP+PvZ1DjD/9StA: shows [Ah Th] (a pair of Aces)
tVZW8k4GP+PvZ1DjD/9StA collected $21.25 from pot
*** SUMMARY ***
Total pot $22.35 | Rake $1.10 
Board [7d Jh Ad 6s 2s]
Seat 1: tVZW8k4GP+PvZ1DjD/9StA (button) showed [Ah Th] and won ($21.25) with a pair of Aces
Seat 2: oseFhpinoe+Zg4j5xyBjyQ (small blind) folded before Flop
Seat 3: JFIAqU8lCZ0vWwEl4bdGsg (big blind) showed [Kh Ks] and lost with a pair of Kings
Seat 4: FPlQHZog0ePFCETQ2KG4hQ folded before Flop (didn't bet)
Seat 5: jXbd3O6QdeNWctmpAsTgHA folded before Flop (didn't bet)
Seat 6: PCh4iIHq9rXvWY/FeXc/Jg folded before Flop




PokerStars Game #59939525972:  Hold'em No Limit ($0.10/$0.25) - 2009/07/01 0:42:07 ET
Table 'YmPuuzhvRUvgdYcNs5kZKw' 9-max Seat #7 is the button
Seat 1: Qi+clOtyDiibLdH2/1Qy8g ($25.30 in chips) 
Seat 2: Z5ZtGOON8kmSdSCll9Z3XA ($17 in chips) 
Seat 3: uLP/lYn7oKq9xCChBXsXxw ($24.50 in chips) 
Seat 6: z5GxcHlYz/GSz6W2uFiTtg ($24.30 in chips) 
Seat 7: opOCI2p6kW0tINuVaAqmcQ ($25 in chips) 
Seat 8: IeNTEKD96WqM7qU1RpSvOQ ($11.15 in chips) 
IeNTEKD96WqM7qU1RpSvOQ: posts small blind $0.10
5IeCaraAnS03/jUIjZQAig: is sitting out 
Qi+clOtyDiibLdH2/1Qy8g: posts big blind $0.25
N6fYvIzQLKaydFLKQGtMlQ: sits out 
CvL9Ch1HYCVbTsfpNucitg: sits out 
*** HOLE CARDS ***
Z5ZtGOON8kmSdSCll9Z3XA: folds 
uLP/lYn7oKq9xCChBXsXxw: folds 
5IeCaraAnS03/jUIjZQAig has returned
z5GxcHlYz/GSz6W2uFiTtg: folds 
opOCI2p6kW0tINuVaAqmcQ: folds 
IeNTEKD96WqM7qU1RpSvOQ: calls $0.15
Qi+clOtyDiibLdH2/1Qy8g: checks 
*** FLOP *** [5d 2d Qd]
IeNTEKD96WqM7qU1RpSvOQ: checks 
Qi+clOtyDiibLdH2/1Qy8g: bets $0.50
IeNTEKD96WqM7qU1RpSvOQ: folds 
Uncalled bet ($0.50) returned to Qi+clOtyDiibLdH2/1Qy8g
Qi+clOtyDiibLdH2/1Qy8g collected $0.50 from pot
Qi+clOtyDiibLdH2/1Qy8g: doesn't show hand 
*** SUMMARY ***
Total pot $0.50 | Rake $0 
Board [5d 2d Qd]
Seat 1: Qi+clOtyDiibLdH2/1Qy8g (big blind) collected ($0.50)
Seat 2: Z5ZtGOON8kmSdSCll9Z3XA folded before Flop (didn't bet)
Seat 3: uLP/lYn7oKq9xCChBXsXxw folded before Flop (didn't bet)
Seat 6: z5GxcHlYz/GSz6W2uFiTtg folded before Flop (didn't bet)
Seat 7: opOCI2p6kW0tINuVaAqmcQ (button) folded before Flop (didn't bet)
Seat 8: IeNTEKD96WqM7qU1RpSvOQ (small blind) folded on the Flop




PokerStars Game #59939526204:  Hold'em No Limit ($0.10/$0.25) - 2009/07/01 0:42:08 ET
Table 'vZfV/Uj0q8joA1du9sRJSg' 6-max Seat #2 is the button
Seat 1: OAmGQMdOxnvuBNHdADx0ew ($5.25 in chips) 
Seat 2: wMiE3yTbDJGOLOF9th7KPA ($14 in chips) 
Seat 3: QJ/0wT0pYdWbDuqo9eNJgQ ($6.55 in chips) 
Seat 4: v+QfkGiuj9bgtuNoVnDO8w ($25 in chips) 
Seat 5: FStoHe64SQWqAsjya9pDkQ ($25.25 in chips) 
Seat 6: 8ClCHtFXGNplITm+63KB+Q ($26.20 in chips) 
QJ/0wT0pYdWbDuqo9eNJgQ: posts small blind $0.10
v+QfkGiuj9bgtuNoVnDO8w: posts big blind $0.25
*** HOLE CARDS ***
FStoHe64SQWqAsjya9pDkQ: folds 
8ClCHtFXGNplITm+63KB+Q: folds 
OAmGQMdOxnvuBNHdADx0ew: calls $0.25
wMiE3yTbDJGOLOF9th7KPA: calls $0.25
QJ/0wT0pYdWbDuqo9eNJgQ: calls $0.15
v+QfkGiuj9bgtuNoVnDO8w: checks 
*** FLOP *** [2s 4h 9h]
QJ/0wT0pYdWbDuqo9eNJgQ: checks 
v+QfkGiuj9bgtuNoVnDO8w: bets $1
OAmGQMdOxnvuBNHdADx0ew: folds 
wMiE3yTbDJGOLOF9th7KPA: folds 
QJ/0wT0pYdWbDuqo9eNJgQ: folds 
Uncalled bet ($1) returned to v+QfkGiuj9bgtuNoVnDO8w
v+QfkGiuj9bgtuNoVnDO8w collected $0.95 from pot
v+QfkGiuj9bgtuNoVnDO8w: doesn't show hand 
*** SUMMARY ***
Total pot $1 | Rake $0.05 
Board [2s 4h 9h]
Seat 1: OAmGQMdOxnvuBNHdADx0ew folded on the Flop
Seat 2: wMiE3yTbDJGOLOF9th7KPA (button) folded on the Flop
Seat 3: QJ/0wT0pYdWbDuqo9eNJgQ (small blind) folded on the Flop
Seat 4: v+QfkGiuj9bgtuNoVnDO8w (big blind) collected ($0.95)
Seat 5: FStoHe64SQWqAsjya9pDkQ folded before Flop (didn't bet)
Seat 6: 8ClCHtFXGNplITm+63KB+Q folded before Flop (didn't bet)




PokerStars Game #59939526186:  Hold'em No Limit ($0.10/$0.25) - 2009/07/01 0:42:08 ET
Table '9L7XfAwuM7XsXE8LIg2o5Q' 6-max Seat #6 is the button
Seat 1: H6XbZVba2aKDXlG0la0uow ($9.35 in chips) 
Seat 2: oseFhpinoe+Zg4j5xyBjyQ ($19.10 in chips) 
Seat 3: 9StOHp+Y1T0K13JdgS2oQQ ($5.10 in chips) 
Seat 4: xBOVv8xEXtymVpAA5ZajSw ($77.80 in chips) 
Seat 6: k9nHZTHt8hYhYRcW8NTb4g ($29.20 in chips) 
H6XbZVba2aKDXlG0la0uow: posts small blind $0.10
oseFhpinoe+Zg4j5xyBjyQ: posts big blind $0.25
*** HOLE CARDS ***
9StOHp+Y1T0K13JdgS2oQQ: raises $0.25 to $0.50
xBOVv8xEXtymVpAA5ZajSw: folds 
xBOVv8xEXtymVpAA5ZajSw leaves the table
k9nHZTHt8hYhYRcW8NTb4g: folds 
H6XbZVba2aKDXlG0la0uow: calls $0.40
oseFhpinoe+Zg4j5xyBjyQ: calls $0.25
*** FLOP *** [Qs Th 6h]
H6XbZVba2aKDXlG0la0uow: bets $1
oseFhpinoe+Zg4j5xyBjyQ: folds 
9StOHp+Y1T0K13JdgS2oQQ: raises $1 to $2
jp34e617tIzV8tKIWmfAbA joins the table at seat #4 
H6XbZVba2aKDXlG0la0uow: calls $1
*** TURN *** [Qs Th 6h] [Td]
H6XbZVba2aKDXlG0la0uow: bets $2.75
9StOHp+Y1T0K13JdgS2oQQ: calls $2.60 and is all-in
Uncalled bet ($0.15) returned to H6XbZVba2aKDXlG0la0uow
*** RIVER *** [Qs Th 6h Td] [2d]
*** SHOW DOWN ***
H6XbZVba2aKDXlG0la0uow: shows [Kd 6d] (two pair, Tens and Sixes)
9StOHp+Y1T0K13JdgS2oQQ: shows [Qh Ah] (two pair, Queens and Tens)
9StOHp+Y1T0K13JdgS2oQQ collected $10.20 from pot
*** SUMMARY ***
Total pot $10.70 | Rake $0.50 
Board [Qs Th 6h Td 2d]
Seat 1: H6XbZVba2aKDXlG0la0uow (small blind) showed [Kd 6d] and lost with two pair, Tens and Sixes
Seat 2: oseFhpinoe+Zg4j5xyBjyQ (big blind) folded on the Flop
Seat 3: 9StOHp+Y1T0K13JdgS2oQQ showed [Qh Ah] and won ($10.20) with two pair, Queens and Tens
Seat 4: xBOVv8xEXtymVpAA5ZajSw folded before Flop (didn't bet)
Seat 6: k9nHZTHt8hYhYRcW8NTb4g (button) folded before Flop (didn't bet)




PokerStars Game #59939526592:  Hold'em No Limit ($0.10/$0.25) - 2009/07/01 0:42:08 ET
Table 'zojWVNukhD2n8RTfHCOwwg' 9-max Seat #9 is the button
Seat 1: DIBbjEYGs+TVdVgEB/4+3w ($41.20 in chips) 
Seat 2: ZeR3hkj1gVv9J4yPCmRrjA ($26.60 in chips) 
Seat 3: 1esmRaxnod+zAkE+7BtzMA ($16.85 in chips) 
Seat 4: Pb7qJqn2QUbp+oYBNQxyyA ($26.45 in chips) 
Seat 6: 2xNcp4M2UG8Li2PMEnWcgA ($10.20 in chips) 
Seat 7: H5Se03ZqSX7tbULXur2MAg ($26.95 in chips) 
Seat 8: j4q3p0lesp63b1gZDwLBZw ($5 in chips) 
Seat 9: 4oA316mXLIui1QY63GXBUg ($25.25 in chips) 
DIBbjEYGs+TVdVgEB/4+3w: posts small blind $0.10
ZeR3hkj1gVv9J4yPCmRrjA: posts big blind $0.25
*** HOLE CARDS ***
1esmRaxnod+zAkE+7BtzMA: folds 
Pb7qJqn2QUbp+oYBNQxyyA: folds 
2xNcp4M2UG8Li2PMEnWcgA: folds 
H5Se03ZqSX7tbULXur2MAg: raises $0.50 to $0.75
j4q3p0lesp63b1gZDwLBZw: folds 
4oA316mXLIui1QY63GXBUg: folds 
DIBbjEYGs+TVdVgEB/4+3w: folds 
ZeR3hkj1gVv9J4yPCmRrjA has timed out
ZeR3hkj1gVv9J4yPCmRrjA: folds 
Uncalled bet ($0.50) returned to H5Se03ZqSX7tbULXur2MAg
ZeR3hkj1gVv9J4yPCmRrjA is sitting out
H5Se03ZqSX7tbULXur2MAg collected $0.60 from pot
*** SUMMARY ***
Total pot $0.60 | Rake $0 
Seat 1: DIBbjEYGs+TVdVgEB/4+3w (small blind) folded before Flop
Seat 2: ZeR3hkj1gVv9J4yPCmRrjA (big blind) folded before Flop
Seat 3: 1esmRaxnod+zAkE+7BtzMA folded before Flop (didn't bet)
Seat 4: Pb7qJqn2QUbp+oYBNQxyyA folded before Flop (didn't bet)
Seat 6: 2xNcp4M2UG8Li2PMEnWcgA folded before Flop (didn't bet)
Seat 7: H5Se03ZqSX7tbULXur2MAg collected ($0.60)
Seat 8: j4q3p0lesp63b1gZDwLBZw folded before Flop (didn't bet)
Seat 9: 4oA316mXLIui1QY63GXBUg (button) folded before Flop (didn't bet)




PokerStars Game #59939526834:  Hold'em No Limit ($0.10/$0.25) - 2009/07/01 0:42:09 ET
Table 'R5qKG21jwFDYRcOht9qwqQ' 9-max Seat #5 is the button
Seat 1: OgISYvc5hA85YuDnsXCH+Q ($15.85 in chips) 
Seat 2: N6foVRyErHqcNmshkqextQ ($15.40 in chips) 
Seat 3: M2QO2DxB5Wawg2h8HSpnYA ($10 in chips) 
Seat 4: z5GxcHlYz/GSz6W2uFiTtg ($26.35 in chips) 
Seat 5: 8B/dhbQjIWe6ASCdgzktNQ ($25 in chips) 
Seat 7: HYQiVfBGJsg4smSubKCBmA ($28.25 in chips) 
Seat 8: tYsOBqdU1+x+yFI7zHO7hQ ($25 in chips) 
Seat 9: MG90wfSJZnOejs/KD3vlQQ ($26 in chips) 
HYQiVfBGJsg4smSubKCBmA: posts small blind $0.10
tYsOBqdU1+x+yFI7zHO7hQ: posts big blind $0.25
*** HOLE CARDS ***
MG90wfSJZnOejs/KD3vlQQ: folds 
OgISYvc5hA85YuDnsXCH+Q: folds 
N6foVRyErHqcNmshkqextQ: folds 
M2QO2DxB5Wawg2h8HSpnYA: raises $0.75 to $1
z5GxcHlYz/GSz6W2uFiTtg: folds 
8B/dhbQjIWe6ASCdgzktNQ: folds 
HYQiVfBGJsg4smSubKCBmA: folds 
tYsOBqdU1+x+yFI7zHO7hQ: folds 
Uncalled bet ($0.75) returned to M2QO2DxB5Wawg2h8HSpnYA
M2QO2DxB5Wawg2h8HSpnYA collected $0.60 from pot
M2QO2DxB5Wawg2h8HSpnYA: doesn't show hand 
*** SUMMARY ***
Total pot $0.60 | Rake $0 
Seat 1: OgISYvc5hA85YuDnsXCH+Q folded before Flop (didn't bet)
Seat 2: N6foVRyErHqcNmshkqextQ folded before Flop (didn't bet)
Seat 3: M2QO2DxB5Wawg2h8HSpnYA collected ($0.60)
Seat 4: z5GxcHlYz/GSz6W2uFiTtg folded before Flop (didn't bet)
Seat 5: 8B/dhbQjIWe6ASCdgzktNQ (button) folded before Flop (didn't bet)
Seat 7: HYQiVfBGJsg4smSubKCBmA (small blind) folded before Flop
Seat 8: tYsOBqdU1+x+yFI7zHO7hQ (big blind) folded before Flop
Seat 9: MG90wfSJZnOejs/KD3vlQQ folded before Flop (didn't bet)




PokerStars Game #59939527182:  Hold'em No Limit ($0.10/$0.25) - 2009/07/01 0:42:09 ET
Table 'ohAuixfiLOYDylNUG5mNUw' 9-max Seat #6 is the button
Seat 1: AtRN1hdV8HbL3X4XogDaLA ($32.25 in chips) 
Seat 2: yVwP/Nr5oXkAQp5dmdNUVQ ($23.75 in chips) 
Seat 3: HVKi9hnDyvzObpL08/OarQ ($25.75 in chips) 
Seat 4: jeKWRUkMaVn8rEUjnJKqpg ($25 in chips) 
Seat 6: opOCI2p6kW0tINuVaAqmcQ ($25 in chips) 
Seat 7: WdsZPRB5ooUPinQdaX0QrA ($3.05 in chips) 
Seat 8: ppMlNkhYgErlt4fuJO7ADA ($13.10 in chips) 
Seat 9: hIss79a4pu7GzJZepfgOpg ($26.60 in chips) 
WdsZPRB5ooUPinQdaX0QrA: posts small blind $0.10
ppMlNkhYgErlt4fuJO7ADA: posts big blind $0.25
strongbadia5: sits out 
*** HOLE CARDS ***
hIss79a4pu7GzJZepfgOpg: folds 
AtRN1hdV8HbL3X4XogDaLA: calls $0.25
yVwP/Nr5oXkAQp5dmdNUVQ: raises $0.25 to $0.50
HVKi9hnDyvzObpL08/OarQ: folds 
jeKWRUkMaVn8rEUjnJKqpg: folds 
opOCI2p6kW0tINuVaAqmcQ: folds 
WdsZPRB5ooUPinQdaX0QrA: folds 
ppMlNkhYgErlt4fuJO7ADA: calls $0.25
AtRN1hdV8HbL3X4XogDaLA: calls $0.25
*** FLOP *** [Kc 9d 7c]
ppMlNkhYgErlt4fuJO7ADA: bets $0.75
AtRN1hdV8HbL3X4XogDaLA: calls $0.75
yVwP/Nr5oXkAQp5dmdNUVQ: folds 
*** TURN *** [Kc 9d 7c] [Qs]
ppMlNkhYgErlt4fuJO7ADA: bets $0.75
AtRN1hdV8HbL3X4XogDaLA: calls $0.75
*** RIVER *** [Kc 9d 7c Qs] [Ac]
ppMlNkhYgErlt4fuJO7ADA: bets $0.75
AtRN1hdV8HbL3X4XogDaLA: raises $2.25 to $3
ppMlNkhYgErlt4fuJO7ADA: folds 
Uncalled bet ($2.25) returned to AtRN1hdV8HbL3X4XogDaLA
AtRN1hdV8HbL3X4XogDaLA collected $5.85 from pot
AtRN1hdV8HbL3X4XogDaLA: doesn't show hand 
*** SUMMARY ***
Total pot $6.10 | Rake $0.25 
Board [Kc 9d 7c Qs Ac]
Seat 1: AtRN1hdV8HbL3X4XogDaLA collected ($5.85)
Seat 2: yVwP/Nr5oXkAQp5dmdNUVQ folded on the Flop
Seat 3: HVKi9hnDyvzObpL08/OarQ folded before Flop (didn't bet)
Seat 4: jeKWRUkMaVn8rEUjnJKqpg folded before Flop (didn't bet)
Seat 6: opOCI2p6kW0tINuVaAqmcQ (button) folded before Flop (didn't bet)
Seat 7: WdsZPRB5ooUPinQdaX0QrA (small blind) folded before Flop
Seat 8: ppMlNkhYgErlt4fuJO7ADA (big blind) folded on the River
Seat 9: hIss79a4pu7GzJZepfgOpg folded before Flop (didn't bet)




PokerStars Game #59939527016:  Hold'em No Limit ($0.10/$0.25) - 2009/07/01 0:42:09 ET
Table 'sSe6q4YTb/iS19t2eCFdsA' 9-max Seat #7 is the button
Seat 2: rUpvA02nErFvZ4yFbDR8XA ($28.10 in chips) 
Seat 3: hBMUlEpyU74r/fwDgIpXjQ ($26.20 in chips) 
Seat 4: SXqVW4Q0evTUVZG6BbUNIA ($16.20 in chips) 
Seat 5: qS+jfnNoG75bT+uQ8CKhQA ($10.65 in chips) 
Seat 6: tYsOBqdU1+x+yFI7zHO7hQ ($26.05 in chips) 
Seat 7: t70KGeRtR3naHSqKDixsUg ($13.80 in chips) 
Seat 8: jeKWRUkMaVn8rEUjnJKqpg ($27.15 in chips) 
Seat 9: 4oA316mXLIui1QY63GXBUg ($25.60 in chips) 
jeKWRUkMaVn8rEUjnJKqpg: posts small blind $0.10
4oA316mXLIui1QY63GXBUg: posts big blind $0.25
*** HOLE CARDS ***
rUpvA02nErFvZ4yFbDR8XA: folds 
5z3YkZTfH2GjoLK+6X7z2w has returned
hBMUlEpyU74r/fwDgIpXjQ: folds 
SXqVW4Q0evTUVZG6BbUNIA: folds 
qS+jfnNoG75bT+uQ8CKhQA: calls $0.25
tYsOBqdU1+x+yFI7zHO7hQ: folds 
t70KGeRtR3naHSqKDixsUg: calls $0.25
jeKWRUkMaVn8rEUjnJKqpg: folds 
4oA316mXLIui1QY63GXBUg: checks 
*** FLOP *** [Ah 3c Qh]
4oA316mXLIui1QY63GXBUg: checks 
qS+jfnNoG75bT+uQ8CKhQA: checks 
t70KGeRtR3naHSqKDixsUg: bets $0.25
4oA316mXLIui1QY63GXBUg: folds 
qS+jfnNoG75bT+uQ8CKhQA: calls $0.25
*** TURN *** [Ah 3c Qh] [5h]
qS+jfnNoG75bT+uQ8CKhQA: checks 
t70KGeRtR3naHSqKDixsUg: bets $0.25
qS+jfnNoG75bT+uQ8CKhQA: calls $0.25
*** RIVER *** [Ah 3c Qh 5h] [7s]
qS+jfnNoG75bT+uQ8CKhQA: checks 
t70KGeRtR3naHSqKDixsUg: checks 
*** SHOW DOWN ***
qS+jfnNoG75bT+uQ8CKhQA: shows [As 9s] (a pair of Aces)
t70KGeRtR3naHSqKDixsUg: shows [Ts Qs] (a pair of Queens)
qS+jfnNoG75bT+uQ8CKhQA collected $1.80 from pot
*** SUMMARY ***
Total pot $1.85 | Rake $0.05 
Board [Ah 3c Qh 5h 7s]
Seat 2: rUpvA02nErFvZ4yFbDR8XA folded before Flop (didn't bet)
Seat 3: hBMUlEpyU74r/fwDgIpXjQ folded before Flop (didn't bet)
Seat 4: SXqVW4Q0evTUVZG6BbUNIA folded before Flop (didn't bet)
Seat 5: qS+jfnNoG75bT+uQ8CKhQA showed [As 9s] and won ($1.80) with a pair of Aces
Seat 6: tYsOBqdU1+x+yFI7zHO7hQ folded before Flop (didn't bet)
Seat 7: t70KGeRtR3naHSqKDixsUg (button) showed [Ts Qs] and lost with a pair of Queens
Seat 8: jeKWRUkMaVn8rEUjnJKqpg (small blind) folded before Flop
Seat 9: 4oA316mXLIui1QY63GXBUg (big blind) folded on the Flop




PokerStars Game #59939527336:  Hold'em No Limit ($0.10/$0.25) - 2009/07/01 0:42:09 ET
Table 'P1IJQ2p3ACFySC35W1qwQw' 9-max Seat #4 is the button
Seat 2: E0iYnEVO2ho7dH3QcCjw7g ($21.50 in chips) 
Seat 3: Ml2bY77EHbM51ZWD7dnIWg ($16.80 in chips) 
Seat 4: LuckyShot



PokerStars Game #59939526838:  Hold'em No Limit ($0.10/$0.25) - 2009/07/01 0:42:09 ET
Table 'mdub7rJf3Z5tCT9s/+1+Wg' 9-max Seat #9 is the button
Seat 1: neWdS67T0XWLJXFjrqXj5g ($19.05 in chips) 
Seat 2: vSkQm2EelzwRGDDQQk0Fqw ($4.65 in chips) 
Seat 3: t2nb95S5EEFOEzNx9Itz0g ($5 in chips) 
Seat 4: fDGyaQz0cs2s4FOYxkbIHA ($15 in chips) 
Seat 5: dfNim92Z6XK1/h5SFW5vDg ($25 in chips) 
Seat 6: hAFbY0iBwr4mouozgvjZBg ($49.05 in chips) 
Seat 7: woe+9KKk+L3pZgMTuHcmog ($31.70 in chips) 
Seat 8: cZ99hugmLBj9KhTlc8nCSw ($25 in chips) 
Seat 9: tYsOBqdU1+x+yFI7zHO7hQ ($36.40 in chips) 
neWdS67T0XWLJXFjrqXj5g: posts small blind $0.10
vSkQm2EelzwRGDDQQk0Fqw: posts big blind $0.25
*** HOLE CARDS ***
t2nb95S5EEFOEzNx9Itz0g: folds 
neWdS67T0XWLJXFjrqXj5g said, "nc"
fDGyaQz0cs2s4FOYxkbIHA: folds 
dfNim92Z6XK1/h5SFW5vDg: folds 
hAFbY0iBwr4mouozgvjZBg said, "ty"
hAFbY0iBwr4mouozgvjZBg: calls $0.25
woe+9KKk+L3pZgMTuHcmog: folds 
cZ99hugmLBj9KhTlc8nCSw: folds 
tYsOBqdU1+x+yFI7zHO7hQ: folds 
neWdS67T0XWLJXFjrqXj5g: raises $0.75 to $1
vSkQm2EelzwRGDDQQk0Fqw: folds 
hAFbY0iBwr4mouozgvjZBg: folds 
Uncalled bet ($0.75) returned to neWdS67T0XWLJXFjrqXj5g
neWdS67T0XWLJXFjrqXj5g collected $0.75 from pot
neWdS67T0XWLJXFjrqXj5g: doesn't show hand 
*** SUMMARY ***
Total pot $0.75 | Rake $0 
Seat 1: neWdS67T0XWLJXFjrqXj5g (small blind) collected ($0.75)
Seat 2: vSkQm2EelzwRGDDQQk0Fqw (big blind) folded before Flop
Seat 3: t2nb95S5EEFOEzNx9Itz0g folded before Flop (didn't bet)
Seat 4: fDGyaQz0cs2s4FOYxkbIHA folded before Flop (didn't bet)
Seat 5: dfNim92Z6XK1/h5SFW5vDg folded before Flop (didn't bet)
Seat 6: hAFbY0iBwr4mouozgvjZBg folded before Flop
Seat 7: woe+9KKk+L3pZgMTuHcmog folded before Flop (didn't bet)
Seat 8: cZ99hugmLBj9KhTlc8nCSw folded before Flop (didn't bet)
Seat 9: tYsOBqdU1+x+yFI7zHO7hQ (button) folded before Flop (didn't bet)




PokerStars Game #59939526790:  Hold'em No Limit ($0.10/$0.25) - 2009/07/01 0:42:09 ET
Table 'JJzUs04lHpXg6nboT1/jeg' 6-max Seat #2 is the button
Seat 2: mK0/8tWLTEGESD/9ZUEo5A ($4.25 in chips) 
Seat 3: uUXdcVMNa05rfbntdvplfw ($20.05 in chips) 
Seat 4: nwwpaieDRI0UPyVtChVHOg ($33.60 in chips) 
Seat 5: Vr2XE7yYBdg3RZSURDAPEg ($21.90 in chips) 
Seat 6: sbFQMajC1QuRxa8Jly3usQ ($5 in chips) 
uUXdcVMNa05rfbntdvplfw: posts small blind $0.10
nwwpaieDRI0UPyVtChVHOg: posts big blind $0.25
sbFQMajC1QuRxa8Jly3usQ: posts big blind $0.25
starzjenko: sits out 
*** HOLE CARDS ***
Vr2XE7yYBdg3RZSURDAPEg: raises $0.75 to $1
sbFQMajC1QuRxa8Jly3usQ: calls $0.75
mK0/8tWLTEGESD/9ZUEo5A: folds 
uUXdcVMNa05rfbntdvplfw: folds 
nwwpaieDRI0UPyVtChVHOg: folds 
*** FLOP *** [2h Qh Jc]
Vr2XE7yYBdg3RZSURDAPEg: bets $0.75
sbFQMajC1QuRxa8Jly3usQ: calls $0.75
*** TURN *** [2h Qh Jc] [Th]
Vr2XE7yYBdg3RZSURDAPEg: bets $0.50
sbFQMajC1QuRxa8Jly3usQ: raises $2.75 to $3.25 and is all-in
Vr2XE7yYBdg3RZSURDAPEg: folds 
Uncalled bet ($2.75) returned to sbFQMajC1QuRxa8Jly3usQ
sbFQMajC1QuRxa8Jly3usQ collected $4.65 from pot
*** SUMMARY ***
Total pot $4.85 | Rake $0.20 
Board [2h Qh Jc Th]
Seat 2: mK0/8tWLTEGESD/9ZUEo5A (button) folded before Flop (didn't bet)
Seat 3: uUXdcVMNa05rfbntdvplfw (small blind) folded before Flop
Seat 4: nwwpaieDRI0UPyVtChVHOg (big blind) folded before Flop
Seat 5: Vr2XE7yYBdg3RZSURDAPEg folded on the Turn
Seat 6: sbFQMajC1QuRxa8Jly3usQ collected ($4.65)




PokerStars Game #59939527040:  Hold'em No Limit ($0.10/$0.25) - 2009/07/01 0:42:09 ET
Table 'sJ4KpS2GE5Qrsu1/cFjJUw' 9-max Seat #8 is the button
Seat 1: QsLvCwfSWqP+CfjwUnjpXQ ($16.25 in chips) 
Seat 3: eDil7UzSZCjyh1VP6SVXJQ ($7.30 in chips) 
Seat 8: f8ixGbSVIs6Be0mH69ldVQ ($12.85 in chips) 
QsLvCwfSWqP+CfjwUnjpXQ: posts small blind $0.10
eDil7UzSZCjyh1VP6SVXJQ: posts big blind $0.25
*** HOLE CARDS ***
f8ixGbSVIs6Be0mH69ldVQ: folds 
QsLvCwfSWqP+CfjwUnjpXQ: calls $0.15
eDil7UzSZCjyh1VP6SVXJQ: checks 
*** FLOP *** [4c Td 7h]
QsLvCwfSWqP+CfjwUnjpXQ: checks 
eDil7UzSZCjyh1VP6SVXJQ: bets $0.25
FZrgDbxAanC1xwZxXHJKVA joins the table at seat #5 
QsLvCwfSWqP+CfjwUnjpXQ: raises $0.25 to $0.50
eDil7UzSZCjyh1VP6SVXJQ: calls $0.25
*** TURN *** [4c Td 7h] [4d]
QsLvCwfSWqP+CfjwUnjpXQ: checks 
eDil7UzSZCjyh1VP6SVXJQ: checks 
*** RIVER *** [4c Td 7h 4d] [Kc]
QsLvCwfSWqP+CfjwUnjpXQ: bets $1.25
eDil7UzSZCjyh1VP6SVXJQ: folds 
Uncalled bet ($1.25) returned to QsLvCwfSWqP+CfjwUnjpXQ
txdsj joins the table at seat #6 
QsLvCwfSWqP+CfjwUnjpXQ collected $1.45 from pot
QsLvCwfSWqP+CfjwUnjpXQ: doesn't show hand 
*** SUMMARY ***
Total pot $1.50 | Rake $0.05 
Board [4c Td 7h 4d Kc]
Seat 1: QsLvCwfSWqP+CfjwUnjpXQ (small blind) collected ($1.45)
Seat 3: eDil7UzSZCjyh1VP6SVXJQ (big blind) folded on the River
Seat 8: f8ixGbSVIs6Be0mH69ldVQ (button) folded before Flop (didn't bet)




PokerStars Game #59939527042:  Hold'em No Limit ($0.10/$0.25) - 2009/07/01 0:42:09 ET
Table 'AchTjdLS1zBUbH3ZIx6f0w' 6-max Seat #4 is the button
Seat 1: IzVI+wIP7IS+d0sugIrOPQ ($25.05 in chips) 
Seat 2: kG34n23qFQA3nzdOJTQ1dA ($39.95 in chips) 
Seat 3: ehifenV36yVvJMnV63D3cg ($2.35 in chips) 
Seat 4: q6WfTUAD9mowIP63ASq2Dg ($27.15 in chips) 
Seat 5: oBUDUfeUyCbZBsjxHZgSiw ($37.45 in chips) 
Seat 6: 5tB0F9NjPSUL4FzmzBMs2Q ($25 in chips) 
oBUDUfeUyCbZBsjxHZgSiw: posts small blind $0.10
5tB0F9NjPSUL4FzmzBMs2Q: posts big blind $0.25
*** HOLE CARDS ***
IzVI+wIP7IS+d0sugIrOPQ: folds 
kG34n23qFQA3nzdOJTQ1dA: folds 
ehifenV36yVvJMnV63D3cg: folds 
q6WfTUAD9mowIP63ASq2Dg: raises $0.50 to $0.75
oBUDUfeUyCbZBsjxHZgSiw: folds 
5tB0F9NjPSUL4FzmzBMs2Q: folds 
Uncalled bet ($0.50) returned to q6WfTUAD9mowIP63ASq2Dg
q6WfTUAD9mowIP63ASq2Dg collected $0.60 from pot
*** SUMMARY ***
Total pot $0.60 | Rake $0 
Seat 1: IzVI+wIP7IS+d0sugIrOPQ folded before Flop (didn't bet)
Seat 2: kG34n23qFQA3nzdOJTQ1dA folded before Flop (didn't bet)
Seat 3: ehifenV36yVvJMnV63D3cg folded before Flop (didn't bet)
Seat 4: q6WfTUAD9mowIP63ASq2Dg (button) collected ($0.60)
Seat 5: oBUDUfeUyCbZBsjxHZgSiw (small blind) folded before Flop
Seat 6: 5tB0F9NjPSUL4FzmzBMs2Q (big blind) folded before Flop




PokerStars Game #59939527188:  Hold'em No Limit ($0.10/$0.25) - 2009/07/01 0:42:09 ET
Table 'Pz8SfAzhP5nvWTsJRAxoDg' 6-max Seat #6 is the button
Seat 1: buyjetgNT1McXtdaP4zynA ($40.90 in chips) 
Seat 2: RYLaAIIwK9wxkPswt1yJYw ($23.05 in chips) 
Seat 3: mfrkWA3PTeYPkbO6hi98Aw ($34.90 in chips) 
Seat 4: 9U9Vy/656QCEfKznJWteag ($15.50 in chips) 
Seat 5: FYepjhAvF8ZdVCmqHIy+eQ ($29.95 in chips) 
Seat 6: FStoHe64SQWqAsjya9pDkQ ($25 in chips) 
buyjetgNT1McXtdaP4zynA: posts small blind $0.10
RYLaAIIwK9wxkPswt1yJYw: posts big blind $0.25
*** HOLE CARDS ***
mfrkWA3PTeYPkbO6hi98Aw: folds 
9U9Vy/656QCEfKznJWteag: folds 
FYepjhAvF8ZdVCmqHIy+eQ: folds 
FStoHe64SQWqAsjya9pDkQ: folds 
buyjetgNT1McXtdaP4zynA: folds 
Uncalled bet ($0.15) returned to RYLaAIIwK9wxkPswt1yJYw
RYLaAIIwK9wxkPswt1yJYw collected $0.20 from pot
*** SUMMARY ***
Total pot $0.20 | Rake $0 
Seat 1: buyjetgNT1McXtdaP4zynA (small blind) folded before Flop
Seat 2: RYLaAIIwK9wxkPswt1yJYw (big blind) collected ($0.20)
Seat 3: mfrkWA3PTeYPkbO6hi98Aw folded before Flop (didn't bet)
Seat 4: 9U9Vy/656QCEfKznJWteag folded before Flop (didn't bet)
Seat 5: FYepjhAvF8ZdVCmqHIy+eQ folded before Flop (didn't bet)
Seat 6: FStoHe64SQWqAsjya9pDkQ (button) folded before Flop (didn't bet)




PokerStars Game #59939527074:  Hold'em No Limit ($0.10/$0.25) - 2009/07/01 0:42:09 ET
Table 'z2yOdY2zyGWG1gh9WV9XtQdYNvO8G5kw5SRxb1Dljhog Seat #7 is the button
Seat 2: vEBWvFD+KUWgDBKZKvA3SA ($4.25 in chips) 
Seat 3: 1Cs1GyQcoM1omwY7XZ3uRg ($14.85 in chips) 
Seat 5: W7XGvw6ngGVq2hFwXk8Myg ($16.40 in chips) 
Seat 7: DiSvPC2iudwL5j9u6Huyww ($40.70 in chips) 
Seat 8: 5hAPbqNrvJb8PtLiceXtlg6HoFYfVGBefsR5Vrz62qIw4.50 in chips) 
Seat 9: sUVgUtgbfVx6JpvApozwhQ ($5 in chips) 
5hAPbqNrvJb8PtLiceXtlg6HoFYfVGBefsR5Vrz62qIwsts small blind $0.10
sUVgUtgbfVx6JpvApozwhQ: posts big blind $0.25
sD+TKtt36XiiN6jqHiLwDA: sits out 
uH1RN27w9SKa7TpVR9EFrQ: sits out 
*** HOLE CARDS ***
vEBWvFD+KUWgDBKZKvA3SA: folds 
Z3dcuTANgdUb/J4unoGPFQ leaves the table
1Cs1GyQcoM1omwY7XZ3uRg: calls $0.25
W7XGvw6ngGVq2hFwXk8Myg: folds 
DiSvPC2iudwL5j9u6Huyww: folds 
5hAPbqNrvJb8PtLiceXtlg6HoFYfVGBefsR5Vrz62qIwlds 
sUVgUtgbfVx6JpvApozwhQ: checks 
*** FLOP *** [Jd Ks 9s]
sUVgUtgbfVx6JpvApozwhQ: bets $1
1Cs1GyQcoM1omwY7XZ3uRg: folds 
Uncalled bet ($1) returned to sUVgUtgbfVx6JpvApozwhQ
sUVgUtgbfVx6JpvApozwhQ collected $0.60 from pot
sUVgUtgbfVx6JpvApozwhQ: doesn't show hand 
*** SUMMARY ***
Total pot $0.60 | Rake $0 
Board [Jd Ks 9s]
Seat 2: vEBWvFD+KUWgDBKZKvA3SA folded before Flop (didn't bet)
Seat 3: 1Cs1GyQcoM1omwY7XZ3uRg folded on the Flop
Seat 5: W7XGvw6ngGVq2hFwXk8Myg folded before Flop (didn't bet)
Seat 7: DiSvPC2iudwL5j9u6Huyww (button) folded before Flop (didn't bet)
Seat 8: 5hAPbqNrvJb8PtLiceXtlg6HoFYfVGBefsR5Vrz62qIwall blind) folded before Flop
Seat 9: sUVgUtgbfVx6JpvApozwhQ (big blind) collected ($0.60)




PokerStars Game #59939527720:  Hold'em No Limit ($0.10/$0.25) - 2009/07/01 0:42:10 ET
Table 'fIMYcWwN4/aXFJvH5Z8Ymg' 6-max Seat #4 is the button
Seat 1: 64ZeDpsBsP594VsWmafRTQ ($12.20 in chips) 
Seat 2: vu2kzHaDtgr6NM7rdq0chA ($25.45 in chips) 
Seat 3: bWbV4MVB/vVpiES1Ut4hew ($50.75 in chips) 
Seat 4: 32YL2ZEp8NT4JB2RVM9euQ ($40.40 in chips) 
Seat 5: 9jSiy0meE9XJKkdIZwyTEQ ($29.50 in chips) 
Seat 6: jp34e617tIzV8tKIWmfAbA ($25 in chips) 
9jSiy0meE9XJKkdIZwyTEQ: posts small blind $0.10
jp34e617tIzV8tKIWmfAbA: posts big blind $0.25
*** HOLE CARDS ***
64ZeDpsBsP594VsWmafRTQ: raises $0.50 to $0.75
vu2kzHaDtgr6NM7rdq0chA: calls $0.75
bWbV4MVB/vVpiES1Ut4hew: folds 
32YL2ZEp8NT4JB2RVM9euQ: folds 
9jSiy0meE9XJKkdIZwyTEQ: folds 
jp34e617tIzV8tKIWmfAbA: folds 
*** FLOP *** [7s Qs 8s]
64ZeDpsBsP594VsWmafRTQ: checks 
vu2kzHaDtgr6NM7rdq0chA: bets $1.25
64ZeDpsBsP594VsWmafRTQ: raises $2 to $3.25
vu2kzHaDtgr6NM7rdq0chA: raises $10.75 to $14
64ZeDpsBsP594VsWmafRTQ: folds 
Uncalled bet ($10.75) returned to vu2kzHaDtgr6NM7rdq0chA
vu2kzHaDtgr6NM7rdq0chA collected $7.95 from pot
vu2kzHaDtgr6NM7rdq0chA: doesn't show hand 
*** SUMMARY ***
Total pot $8.35 | Rake $0.40 
Board [7s Qs 8s]
Seat 1: 64ZeDpsBsP594VsWmafRTQ folded on the Flop
Seat 2: vu2kzHaDtgr6NM7rdq0chA collected ($7.95)
Seat 3: bWbV4MVB/vVpiES1Ut4hew folded before Flop (didn't bet)
Seat 4: 32YL2ZEp8NT4JB2RVM9euQ (button) folded before Flop (didn't bet)
Seat 5: 9jSiy0meE9XJKkdIZwyTEQ (small blind) folded before Flop
Seat 6: jp34e617tIzV8tKIWmfAbA (big blind) folded before Flop




PokerStars Game #59939527634:  Hold'em No Limit ($0.10/$0.25) - 2009/07/01 0:42:10 ET
Table 'FgLmv9bi/fJP8ldfbTOpkg' 9-max Seat #8 is the button
Seat 1: opOCI2p6kW0tINuVaAqmcQ ($25.10 in chips) 
Seat 2: mpsfNtnMVDqQHTe92AhIdw ($28.95 in chips) 
Seat 4: WfS0TjI8FyLemNTOo1e9qA ($12.90 in chips) 
Seat 6: oKO7b50N6TzXbPBr/mcrUA ($32.35 in chips) 
Seat 7: eFrBtVXGVoMq1UwCDg8Exg ($24.65 in chips) 
Seat 8: sJNHTWcSlLHRCZ9+YRLLqA ($25 in chips) 
opOCI2p6kW0tINuVaAqmcQ: posts small blind $0.10
mpsfNtnMVDqQHTe92AhIdw: posts big blind $0.25
*** HOLE CARDS ***
WfS0TjI8FyLemNTOo1e9qA: calls $0.25
oKO7b50N6TzXbPBr/mcrUA: raises $0.50 to $0.75
eFrBtVXGVoMq1UwCDg8Exg: folds 
sJNHTWcSlLHRCZ9+YRLLqA: folds 
opOCI2p6kW0tINuVaAqmcQ: folds 
mpsfNtnMVDqQHTe92AhIdw: folds 
WfS0TjI8FyLemNTOo1e9qA: calls $0.50
*** FLOP *** [Jh 2d Td]
WfS0TjI8FyLemNTOo1e9qA: checks 
oKO7b50N6TzXbPBr/mcrUA: bets $0.75
WfS0TjI8FyLemNTOo1e9qA: calls $0.75
*** TURN *** [Jh 2d Td] [2c]
WfS0TjI8FyLemNTOo1e9qA: checks 
oKO7b50N6TzXbPBr/mcrUA: bets $1
WfS0TjI8FyLemNTOo1e9qA: calls $1
*** RIVER *** [Jh 2d Td 2c] [Th]
WfS0TjI8FyLemNTOo1e9qA: bets $1.25
oKO7b50N6TzXbPBr/mcrUA: folds 
Uncalled bet ($1.25) returned to WfS0TjI8FyLemNTOo1e9qA
WfS0TjI8FyLemNTOo1e9qA collected $5.10 from pot
*** SUMMARY ***
Total pot $5.35 | Rake $0.25 
Board [Jh 2d Td 2c Th]
Seat 1: opOCI2p6kW0tINuVaAqmcQ (small blind) folded before Flop
Seat 2: mpsfNtnMVDqQHTe92AhIdw (big blind) folded before Flop
Seat 4: WfS0TjI8FyLemNTOo1e9qA collected ($5.10)
Seat 6: oKO7b50N6TzXbPBr/mcrUA folded on the River
Seat 7: eFrBtVXGVoMq1UwCDg8Exg folded before Flop (didn't bet)
Seat 8: sJNHTWcSlLHRCZ9+YRLLqA (button) folded before Flop (didn't bet)




PokerStars Game #59939527534:  Hold'em No Limit ($0.10/$0.25) - 2009/07/01 0:42:10 ET
Table '6aL2C8IFwHHr6SG6RgXaow' 9-max Seat #5 is the button
Seat 2: +gMmKt3DaQng9M42CmxIZg ($24.20 in chips) 
Seat 4: tAxW5XKyzLgVZEyECMLCGw ($8.25 in chips) 
Seat 5: wre31HfyzQGpIvID1istxw ($13.35 in chips) 
Seat 6: HxDF4QSxC4z39D7teZpprQ ($33.75 in chips) 
Seat 7: rPToQDbLWB+dKnz7fcQSIg ($8.30 in chips) 
Seat 8: rQhYIYXSyH/IivYM1dlV5A ($19.95 in chips) 
Seat 9: yduPKWPzL8YlT5Zv/Nmrwg ($13.65 in chips) 
HxDF4QSxC4z39D7teZpprQ: posts small blind $0.10
rPToQDbLWB+dKnz7fcQSIg: posts big blind $0.25
tAxW5XKyzLgVZEyECMLCGw: posts big blind $0.25
*** HOLE CARDS ***
rQhYIYXSyH/IivYM1dlV5A: folds 
yduPKWPzL8YlT5Zv/Nmrwg: raises $13.40 to $13.65 and is all-in
+gMmKt3DaQng9M42CmxIZg: folds 
tAxW5XKyzLgVZEyECMLCGw: folds 
wre31HfyzQGpIvID1istxw: folds 
HxDF4QSxC4z39D7teZpprQ: folds 
rPToQDbLWB+dKnz7fcQSIg: folds 
Uncalled bet ($13.40) returned to yduPKWPzL8YlT5Zv/Nmrwg
yduPKWPzL8YlT5Zv/Nmrwg collected $0.85 from pot
yduPKWPzL8YlT5Zv/Nmrwg: doesn't show hand 
*** SUMMARY ***
Total pot $0.85 | Rake $0 
Seat 2: +gMmKt3DaQng9M42CmxIZg folded before Flop (didn't bet)
Seat 4: tAxW5XKyzLgVZEyECMLCGw folded before Flop
Seat 5: wre31HfyzQGpIvID1istxw (button) folded before Flop (didn't bet)
Seat 6: HxDF4QSxC4z39D7teZpprQ (small blind) folded before Flop
Seat 7: rPToQDbLWB+dKnz7fcQSIg (big blind) folded before Flop
Seat 8: rQhYIYXSyH/IivYM1dlV5A folded before Flop (didn't bet)
Seat 9: yduPKWPzL8YlT5Zv/Nmrwg collected ($0.85)




PokerStars Game #59939527966:  Hold'em No Limit ($0.10/$0.25) - 2009/07/01 0:42:10 ET
Table '4ZbiE0ZYjzqmgu6+sO1prg' 9-max Seat #1 is the button
Seat 1: N6fYvIzQLKaydFLKQGtMlQ ($25.55 in chips) 
Seat 2: w31DkWCTQDVIzsHIrFRDxA ($16.90 in chips) 
Seat 3: HPEB+AtKw1+C/cxU0o1ciw ($25.15 in chips) 
Seat 4: Eb2mDXvZ4iY02krYdOYwMA ($22.90 in chips) 
Seat 5: COsrwJSFHQtxlUcrYtDQPQ ($25 in chips) 
Seat 6: rXm4QDVJt67H20lM6n6Z7Q ($7.90 in chips) 
Seat 7: 3RCAkueG3Vc13VpRStCB+w ($21.05 in chips) 
Seat 8: cZ99hugmLBj9KhTlc8nCSw ($25 in chips) 
Seat 9: 1K6QGyJP9P9xmRac2fH4OQ ($98.10 in chips) 
w31DkWCTQDVIzsHIrFRDxA: posts small blind $0.10
HPEB+AtKw1+C/cxU0o1ciw: posts big blind $0.25
*** HOLE CARDS ***
Eb2mDXvZ4iY02krYdOYwMA: folds 
COsrwJSFHQtxlUcrYtDQPQ: folds 
rXm4QDVJt67H20lM6n6Z7Q: folds 
3RCAkueG3Vc13VpRStCB+w: folds 
cZ99hugmLBj9KhTlc8nCSw: folds 
1K6QGyJP9P9xmRac2fH4OQ: folds 
N6fYvIzQLKaydFLKQGtMlQ: folds 
w31DkWCTQDVIzsHIrFRDxA: calls $0.15
HPEB+AtKw1+C/cxU0o1ciw: checks 
*** FLOP *** [7h 6s 7d]
w31DkWCTQDVIzsHIrFRDxA: checks 
HPEB+AtKw1+C/cxU0o1ciw: checks 
*** TURN *** [7h 6s 7d] [Tc]
w31DkWCTQDVIzsHIrFRDxA: checks 
HPEB+AtKw1+C/cxU0o1ciw: bets $0.50
w31DkWCTQDVIzsHIrFRDxA: calls $0.50
*** RIVER *** [7h 6s 7d Tc] [2d]
w31DkWCTQDVIzsHIrFRDxA: checks 
HPEB+AtKw1+C/cxU0o1ciw: bets $1
w31DkWCTQDVIzsHIrFRDxA: calls $1
*** SHOW DOWN ***
HPEB+AtKw1+C/cxU0o1ciw: shows [Qc Ts] (two pair, Tens and Sevens)
w31DkWCTQDVIzsHIrFRDxA: mucks hand 
HPEB+AtKw1+C/cxU0o1ciw collected $3.35 from pot
*** SUMMARY ***
Total pot $3.50 | Rake $0.15 
Board [7h 6s 7d Tc 2d]
Seat 1: N6fYvIzQLKaydFLKQGtMlQ (button) folded before Flop (didn't bet)
Seat 2: w31DkWCTQDVIzsHIrFRDxA (small blind) mucked
Seat 3: HPEB+AtKw1+C/cxU0o1ciw (big blind) showed [Qc Ts] and won ($3.35) with two pair, Tens and Sevens
Seat 4: Eb2mDXvZ4iY02krYdOYwMA folded before Flop (didn't bet)
Seat 5: COsrwJSFHQtxlUcrYtDQPQ folded before Flop (didn't bet)
Seat 6: rXm4QDVJt67H20lM6n6Z7Q folded before Flop (didn't bet)
Seat 7: 3RCAkueG3Vc13VpRStCB+w folded before Flop (didn't bet)
Seat 8: cZ99hugmLBj9KhTlc8nCSw folded before Flop (didn't bet)
Seat 9: 1K6QGyJP9P9xmRac2fH4OQ folded before Flop (didn't bet)




PokerStars Game #59939527760:  Hold'em No Limit ($0.10/$0.25) - 2009/07/01 0:42:10 ET
Table 'YYMg5qzxK1m9eGRo4SbxtQ' 9-max Seat #8 is the button
Seat 1: DiSvPC2iudwL5j9u6Huyww ($25 in chips) 
Seat 2: uH1RN27w9SKa7TpVR9EFrQ ($15.25 in chips) 
Seat 3: N6fYvIzQLKaydFLKQGtMlQ ($24.05 in chips) 
Seat 4: H8sSXb2KLK0U38tU9YITDw ($11.25 in chips) 
Seat 5: BEIBUu2pIflPrCL+Iks4CQ ($19.30 in chips) 
Seat 6: gehe91e0IyVT0QU/XBkEyg ($41.60 in chips) 
Seat 7: hPhp/RE3cJ5YGaQ2xOHXXg ($3.95 in chips) 
Seat 8: 18G4P1XstjNvItdGUITxgw ($26.40 in chips) 
Seat 9: +sbyWwIcFp9kP0bDtMegfQ ($36.65 in chips) 
+sbyWwIcFp9kP0bDtMegfQ: posts small blind $0.10
DiSvPC2iudwL5j9u6Huyww: posts big blind $0.25
*** HOLE CARDS ***
uH1RN27w9SKa7TpVR9EFrQ: folds 
N6fYvIzQLKaydFLKQGtMlQ: folds 
H8sSXb2KLK0U38tU9YITDw: folds 
BEIBUu2pIflPrCL+Iks4CQ: folds 
gehe91e0IyVT0QU/XBkEyg: folds 
hPhp/RE3cJ5YGaQ2xOHXXg: folds 
18G4P1XstjNvItdGUITxgw: folds 
+sbyWwIcFp9kP0bDtMegfQ: folds 
Uncalled bet ($0.15) returned to DiSvPC2iudwL5j9u6Huyww
DiSvPC2iudwL5j9u6Huyww collected $0.20 from pot
DiSvPC2iudwL5j9u6Huyww: doesn't show hand 
*** SUMMARY ***
Total pot $0.20 | Rake $0 
Seat 1: DiSvPC2iudwL5j9u6Huyww (big blind) collected ($0.20)
Seat 2: uH1RN27w9SKa7TpVR9EFrQ folded before Flop (didn't bet)
Seat 3: N6fYvIzQLKaydFLKQGtMlQ folded before Flop (didn't bet)
Seat 4: H8sSXb2KLK0U38tU9YITDw folded before Flop (didn't bet)
Seat 5: BEIBUu2pIflPrCL+Iks4CQ folded before Flop (didn't bet)
Seat 6: gehe91e0IyVT0QU/XBkEyg folded before Flop (didn't bet)
Seat 7: hPhp/RE3cJ5YGaQ2xOHXXg folded before Flop (didn't bet)
Seat 8: 18G4P1XstjNvItdGUITxgw (button) folded before Flop (didn't bet)
Seat 9: +sbyWwIcFp9kP0bDtMegfQ (small blind) folded before Flop




PokerStars Game #59939527628:  Hold'em No Limit ($0.10/$0.25) - 2009/07/01 0:42:10 ET
Table 'rpIHGyt2QpgQc5bvptAvDQ' 9-max Seat #5 is the button
Seat 1: pIK8dHf+MqCSMpnx8j9HEw ($17.15 in chips) 
Seat 2: Xpyqpb+DURDWnyJ3xTEIFQ ($27.25 in chips) 
Seat 3: RNWwL4ZL6E6nNwmoYWS4Ug ($12.25 in chips) 
Seat 4: ottZQkg1UDWk85BtBzGJzg ($4.05 in chips) 
Seat 5: F7uW1LiDD9vUDBtB+5gRDg ($22.30 in chips) 
Seat 6: gehe91e0IyVT0QU/XBkEyg ($39.45 in chips) 
Seat 7: SXqVW4Q0evTUVZG6BbUNIA ($29.60 in chips) 
Seat 8: tYsOBqdU1+x+yFI7zHO7hQ ($25 in chips) 
Seat 9: nm4Dj/f+jJEwKVsUnKh73g ($20.75 in chips) 
gehe91e0IyVT0QU/XBkEyg: posts small blind $0.10
SXqVW4Q0evTUVZG6BbUNIA: posts big blind $0.25
*** HOLE CARDS ***
tYsOBqdU1+x+yFI7zHO7hQ: folds 
nm4Dj/f+jJEwKVsUnKh73g: folds 
pIK8dHf+MqCSMpnx8j9HEw: folds 
Xpyqpb+DURDWnyJ3xTEIFQ: folds 
RNWwL4ZL6E6nNwmoYWS4Ug: calls $0.25
ottZQkg1UDWk85BtBzGJzg: raises $3.80 to $4.05 and is all-in
F7uW1LiDD9vUDBtB+5gRDg: calls $4.05
gehe91e0IyVT0QU/XBkEyg: folds 
SXqVW4Q0evTUVZG6BbUNIA: folds 
RNWwL4ZL6E6nNwmoYWS4Ug: folds 
*** FLOP *** [Tc 9c 9s]
*** TURN *** [Tc 9c 9s] [Ad]
*** RIVER *** [Tc 9c 9s Ad] [Qs]
*** SHOW DOWN ***
ottZQkg1UDWk85BtBzGJzg: shows [4h 4s] (two pair, Nines and Fours)
F7uW1LiDD9vUDBtB+5gRDg: shows [Jh As] (two pair, Aces and Nines)
F7uW1LiDD9vUDBtB+5gRDg collected $8.30 from pot
*** SUMMARY ***
Total pot $8.70 | Rake $0.40 
Board [Tc 9c 9s Ad Qs]
Seat 1: pIK8dHf+MqCSMpnx8j9HEw folded before Flop (didn't bet)
Seat 2: Xpyqpb+DURDWnyJ3xTEIFQ folded before Flop (didn't bet)
Seat 3: RNWwL4ZL6E6nNwmoYWS4Ug folded before Flop
Seat 4: ottZQkg1UDWk85BtBzGJzg showed [4h 4s] and lost with two pair, Nines and Fours
Seat 5: F7uW1LiDD9vUDBtB+5gRDg (button) showed [Jh As] and won ($8.30) with two pair, Aces and Nines
Seat 6: gehe91e0IyVT0QU/XBkEyg (small blind) folded before Flop
Seat 7: SXqVW4Q0evTUVZG6BbUNIA (big blind) folded before Flop
Seat 8: tYsOBqdU1+x+yFI7zHO7hQ folded before Flop (didn't bet)
Seat 9: nm4Dj/f+jJEwKVsUnKh73g folded before Flop (didn't bet)




PokerStars Game #59939528004:  Hold'em No Limit ($0.10/$0.25) - 2009/07/01 0:42:10 ET
Table 'I0ZcuiUTeLuGYv26Nah7YA' 9-max Seat #3 is the button
Seat 1: iMiqaPr7dx84UF0wNUeh8A ($19.70 in chips) 
Seat 2: zE0IkNrJoJD964o4eqmCxQ ($4.10 in chips) 
Seat 3: 1S/fpm+f42V/6MNZre+ccg ($26.85 in chips) 
Seat 4: 4awUyiDYTgylQKXZ9faBVA ($28.15 in chips) 
Seat 5: opOCI2p6kW0tINuVaAqmcQ ($44.25 in chips) 
Seat 6: JRV2PblFtPFz51l0Fwyz8g ($24.75 in chips) 
Seat 7: JxpnpCmvRAcrEUy7mq1iAg ($6.10 in chips) 
Seat 8: ijc1q+bpPQR12wxc0sWc4w ($14.25 in chips) 
Seat 9: 2mQl0jr5DPlr6jqhvCq8Xw ($10.15 in chips) 
4awUyiDYTgylQKXZ9faBVA: posts small blind $0.10
opOCI2p6kW0tINuVaAqmcQ: posts big blind $0.25
*** HOLE CARDS ***
JRV2PblFtPFz51l0Fwyz8g: folds 
JxpnpCmvRAcrEUy7mq1iAg: folds 
ijc1q+bpPQR12wxc0sWc4w: calls $0.25
2mQl0jr5DPlr6jqhvCq8Xw: folds 
iMiqaPr7dx84UF0wNUeh8A: folds 
zE0IkNrJoJD964o4eqmCxQ: folds 
1S/fpm+f42V/6MNZre+ccg: folds 
4awUyiDYTgylQKXZ9faBVA: folds 
opOCI2p6kW0tINuVaAqmcQ: checks 
*** FLOP *** [Ad Qd 6h]
opOCI2p6kW0tINuVaAqmcQ: checks 
ijc1q+bpPQR12wxc0sWc4w: bets $0.50
opOCI2p6kW0tINuVaAqmcQ: folds 
Uncalled bet ($0.50) returned to ijc1q+bpPQR12wxc0sWc4w
ijc1q+bpPQR12wxc0sWc4w collected $0.60 from pot
*** SUMMARY ***
Total pot $0.60 | Rake $0 
Board [Ad Qd 6h]
Seat 1: iMiqaPr7dx84UF0wNUeh8A folded before Flop (didn't bet)
Seat 2: zE0IkNrJoJD964o4eqmCxQ folded before Flop (didn't bet)
Seat 3: 1S/fpm+f42V/6MNZre+ccg (button) folded before Flop (didn't bet)
Seat 4: 4awUyiDYTgylQKXZ9faBVA (small blind) folded before Flop
Seat 5: opOCI2p6kW0tINuVaAqmcQ (big blind) folded on the Flop
Seat 6: JRV2PblFtPFz51l0Fwyz8g folded before Flop (didn't bet)
Seat 7: JxpnpCmvRAcrEUy7mq1iAg folded before Flop (didn't bet)
Seat 8: ijc1q+bpPQR12wxc0sWc4w collected ($0.60)
Seat 9: 2mQl0jr5DPlr6jqhvCq8Xw folded before Flop (didn't bet)




PokerStars Game #59939528430:  Hold'em No Limit ($0.10/$0.25) - 2009/07/01 0:42:11 ET
Table 'ZEXL6Wh4qA4Afx8NnoBBAA' 6-max Seat #1 is the button
Seat 1: qo39V8/pMxxofM2aciLSWQ ($95.25 in chips) 
Seat 2: WrLI51S2iMb8GLMB83gGqA ($25 in chips) 
Seat 4: fZQg9veL7Dd/Z04ZTjC+wQ ($31.90 in chips) 
Seat 6: 3rZnxe2K3O+xcVdF94i8lA ($16.15 in chips) 
WrLI51S2iMb8GLMB83gGqA: posts small blind $0.10
fZQg9veL7Dd/Z04ZTjC+wQ: posts big blind $0.25
*** HOLE CARDS ***
3rZnxe2K3O+xcVdF94i8lA: raises $0.25 to $0.50
qo39V8/pMxxofM2aciLSWQ: folds 
WrLI51S2iMb8GLMB83gGqA: folds 
fZQg9veL7Dd/Z04ZTjC+wQ: calls $0.25
*** FLOP *** [7s 4h 7d]
fZQg9veL7Dd/Z04ZTjC+wQ: checks 
3rZnxe2K3O+xcVdF94i8lA: bets $0.25
fZQg9veL7Dd/Z04ZTjC+wQ: folds 
Uncalled bet ($0.25) returned to 3rZnxe2K3O+xcVdF94i8lA
3rZnxe2K3O+xcVdF94i8lA collected $1.05 from pot
3rZnxe2K3O+xcVdF94i8lA: doesn't show hand 
*** SUMMARY ***
Total pot $1.10 | Rake $0.05 
Board [7s 4h 7d]
Seat 1: qo39V8/pMxxofM2aciLSWQ (button) folded before Flop (didn't bet)
Seat 2: WrLI51S2iMb8GLMB83gGqA (small blind) folded before Flop
Seat 4: fZQg9veL7Dd/Z04ZTjC+wQ (big blind) folded on the Flop
Seat 6: 3rZnxe2K3O+xcVdF94i8lA collected ($1.05)




PokerStars Game #59939528160:  Hold'em No Limit ($0.10/$0.25) - 2009/07/01 0:42:11 ET
Table 'fRxOyfaHXkWUDLv4eSxFew' 9-max Seat #9 is the button
Seat 1: OlPJsgR4xypSg/w1z7Gyvw ($19.75 in chips) 
Seat 2: TeWJxSETzbXGiYKx0y+dtg ($25 in chips) 
Seat 3: hBMUlEpyU74r/fwDgIpXjQ ($26.05 in chips) 
Seat 6: N/O9ADKpmqB2ASZuqgodlw ($7.85 in chips) 
Seat 7: 7cv+9Zc9HIQHNvYsMfV3uA ($54.05 in chips) 
Seat 8: 1K6QGyJP9P9xmRac2fH4OQ ($25 in chips) 
Seat 9: H5Se03ZqSX7tbULXur2MAg ($23.45 in chips) 
OlPJsgR4xypSg/w1z7Gyvw: posts small blind $0.10
TeWJxSETzbXGiYKx0y+dtg: posts big blind $0.25
*** HOLE CARDS ***
hBMUlEpyU74r/fwDgIpXjQ: folds 
N/O9ADKpmqB2ASZuqgodlw: folds 
7cv+9Zc9HIQHNvYsMfV3uA: folds 
1K6QGyJP9P9xmRac2fH4OQ: folds 
H5Se03ZqSX7tbULXur2MAg: raises $0.50 to $0.75
OlPJsgR4xypSg/w1z7Gyvw: folds 
TeWJxSETzbXGiYKx0y+dtg: folds 
Uncalled bet ($0.50) returned to H5Se03ZqSX7tbULXur2MAg
H5Se03ZqSX7tbULXur2MAg collected $0.60 from pot
*** SUMMARY ***
Total pot $0.60 | Rake $0 
Seat 1: OlPJsgR4xypSg/w1z7Gyvw (small blind) folded before Flop
Seat 2: TeWJxSETzbXGiYKx0y+dtg (big blind) folded before Flop
Seat 3: hBMUlEpyU74r/fwDgIpXjQ folded before Flop (didn't bet)
Seat 6: N/O9ADKpmqB2ASZuqgodlw folded before Flop (didn't bet)
Seat 7: 7cv+9Zc9HIQHNvYsMfV3uA folded before Flop (didn't bet)
Seat 8: 1K6QGyJP9P9xmRac2fH4OQ folded before Flop (didn't bet)
Seat 9: H5Se03ZqSX7tbULXur2MAg (button) collected ($0.60)




PokerStars Game #59939528078:  Hold'em No Limit ($0.10/$0.25) - 2009/07/01 0:42:11 ET
Table 'gkdjhbH1jaE3hwhPRIKMiQ3lL16FBjWXTx3AjK5lMRwwx Seat #6 is the button
Seat 1: fDGyaQz0cs2s4FOYxkbIHA ($8.40 in chips) 
Seat 2: YK2fIgjF+Z0ARwKKcGh1fw ($17.95 in chips) 
Seat 3: QEbIGci+itdw+re8RM5fZA ($25.90 in chips) 
Seat 5: M/9j4wkHH9i1JM51vgi1VA ($22.50 in chips) 
Seat 6: hBMUlEpyU74r/fwDgIpXjQ ($41.60 in chips) 
Seat 8: ljemhp25Zg+nlA9DLCIiUw ($23.40 in chips) 
Seat 9: b8t3jWrxzeEt9HtZtc9wUQ ($10.35 in chips) 
ljemhp25Zg+nlA9DLCIiUw: posts small blind $0.10
b8t3jWrxzeEt9HtZtc9wUQ: posts big blind $0.25
*** HOLE CARDS ***
fDGyaQz0cs2s4FOYxkbIHA: folds 
YK2fIgjF+Z0ARwKKcGh1fw: folds 
QEbIGci+itdw+re8RM5fZA: folds 
M/9j4wkHH9i1JM51vgi1VA: folds 
hBMUlEpyU74r/fwDgIpXjQ: folds 
Z3a37Ry74FVl+CBZtAONiA joins the table at seat #4 
ljemhp25Zg+nlA9DLCIiUw: calls $0.15
b8t3jWrxzeEt9HtZtc9wUQ: checks 
*** FLOP *** [Qd 3c Td]
ljemhp25Zg+nlA9DLCIiUw: bets $0.50
b8t3jWrxzeEt9HtZtc9wUQ: calls $0.50
*** TURN *** [Qd 3c Td] [5h]
ljemhp25Zg+nlA9DLCIiUw: bets $1
b8t3jWrxzeEt9HtZtc9wUQ: calls $1
*** RIVER *** [Qd 3c Td 5h] [As]
ljemhp25Zg+nlA9DLCIiUw: bets $2
b8t3jWrxzeEt9HtZtc9wUQ: folds 
Uncalled bet ($2) returned to ljemhp25Zg+nlA9DLCIiUw
ljemhp25Zg+nlA9DLCIiUw collected $3.35 from pot
ljemhp25Zg+nlA9DLCIiUw: doesn't show hand 
*** SUMMARY ***
Total pot $3.50 | Rake $0.15 
Board [Qd 3c Td 5h As]
Seat 1: fDGyaQz0cs2s4FOYxkbIHA folded before Flop (didn't bet)
Seat 2: YK2fIgjF+Z0ARwKKcGh1fw folded before Flop (didn't bet)
Seat 3: QEbIGci+itdw+re8RM5fZA folded before Flop (didn't bet)
Seat 5: M/9j4wkHH9i1JM51vgi1VA folded before Flop (didn't bet)
Seat 6: hBMUlEpyU74r/fwDgIpXjQ (button) folded before Flop (didn't bet)
Seat 8: ljemhp25Zg+nlA9DLCIiUw (small blind) collected ($3.35)
Seat 9: b8t3jWrxzeEt9HtZtc9wUQ (big blind) folded on the River




PokerStars Game #59939528254:  Hold'em No Limit ($0.10/$0.25) - 2009/07/01 0:42:11 ET
Table 'ShgkxBDL5IvR1qjzfRNc0A' 6-max Seat #3 is the button
Seat 1: /gJNBeCkWL4o85/jvlZ4BA ($25 in chips) 
Seat 2: mfrkWA3PTeYPkbO6hi98Aw ($37.85 in chips) 
Seat 3: JXSfL0FgBM1dIFwHP09Hnw ($25 in chips) 
Seat 4: kG34n23qFQA3nzdOJTQ1dA ($24.50 in chips) 
Seat 5: ferjiUxLWPNUKxvl8/xD/g ($47.35 in chips) 
Seat 6: 5tB0F9NjPSUL4FzmzBMs2Q ($30.20 in chips) 
kG34n23qFQA3nzdOJTQ1dA: posts small blind $0.10
ferjiUxLWPNUKxvl8/xD/g: posts big blind $0.25
*** HOLE CARDS ***
5tB0F9NjPSUL4FzmzBMs2Q: folds 
/gJNBeCkWL4o85/jvlZ4BA: folds 
mfrkWA3PTeYPkbO6hi98Aw: folds 
JXSfL0FgBM1dIFwHP09Hnw: folds 
kG34n23qFQA3nzdOJTQ1dA: folds 
Uncalled bet ($0.15) returned to ferjiUxLWPNUKxvl8/xD/g
ferjiUxLWPNUKxvl8/xD/g collected $0.20 from pot
ferjiUxLWPNUKxvl8/xD/g: doesn't show hand 
*** SUMMARY ***
Total pot $0.20 | Rake $0 
Seat 1: /gJNBeCkWL4o85/jvlZ4BA folded before Flop (didn't bet)
Seat 2: mfrkWA3PTeYPkbO6hi98Aw folded before Flop (didn't bet)
Seat 3: JXSfL0FgBM1dIFwHP09Hnw (button) folded before Flop (didn't bet)
Seat 4: kG34n23qFQA3nzdOJTQ1dA (small blind) folded before Flop
Seat 5: ferjiUxLWPNUKxvl8/xD/g (big blind) collected ($0.20)
Seat 6: 5tB0F9NjPSUL4FzmzBMs2Q folded before Flop (didn't bet)




PokerStars Game #59939528572:  Hold'em No Limit ($0.10/$0.25) - 2009/07/01 0:42:11 ET
Table 'hfHe8uKeSJMyWAjSdM7ROQ' 6-max Seat #1 is the button
Seat 1: eHsmIvAb2JREg4O6hNPnXg ($17.90 in chips) 
Seat 2: rnpAao581IcvQglpkpnkoQ ($6.80 in chips) 
Seat 3: og6TUWcndKo5oTDQjnQfjw ($31.55 in chips) 
Seat 4: iAfYkegiTr9eE85LoKmEgA ($6.85 in chips) 
Seat 5: euswrBD1XG0Q5hB1iGJBKQ ($24.45 in chips) 
Seat 6: SFmT9ZsVopnukjvAzrxTRg ($25 in chips) 
rnpAao581IcvQglpkpnkoQ: posts small blind $0.10
og6TUWcndKo5oTDQjnQfjw: posts big blind $0.25
*** HOLE CARDS ***
iAfYkegiTr9eE85LoKmEgA: folds 
euswrBD1XG0Q5hB1iGJBKQ: folds 
SFmT9ZsVopnukjvAzrxTRg: folds 
eHsmIvAb2JREg4O6hNPnXg: folds 
rnpAao581IcvQglpkpnkoQ: calls $0.15
og6TUWcndKo5oTDQjnQfjw: raises $0.50 to $0.75
rnpAao581IcvQglpkpnkoQ: calls $0.50
*** FLOP *** [4s 5d 6h]
rnpAao581IcvQglpkpnkoQ: checks 
og6TUWcndKo5oTDQjnQfjw: bets $1
rnpAao581IcvQglpkpnkoQ: folds 
Uncalled bet ($1) returned to og6TUWcndKo5oTDQjnQfjw
og6TUWcndKo5oTDQjnQfjw collected $1.45 from pot
og6TUWcndKo5oTDQjnQfjw: doesn't show hand 
*** SUMMARY ***
Total pot $1.50 | Rake $0.05 
Board [4s 5d 6h]
Seat 1: eHsmIvAb2JREg4O6hNPnXg (button) folded before Flop (didn't bet)
Seat 2: rnpAao581IcvQglpkpnkoQ (small blind) folded on the Flop
Seat 3: og6TUWcndKo5oTDQjnQfjw (big blind) collected ($1.45)
Seat 4: iAfYkegiTr9eE85LoKmEgA folded before Flop (didn't bet)
Seat 5: euswrBD1XG0Q5hB1iGJBKQ folded before Flop (didn't bet)
Seat 6: SFmT9ZsVopnukjvAzrxTRg folded before Flop (didn't bet)




PokerStars Game #59939529018:  Hold'em No Limit ($0.10/$0.25) - 2009/07/01 0:42:12 ET
Table 'l57rayEpPtZotP9nqgSWBg' 6-max Seat #3 is the button
Seat 1: oseFhpinoe+Zg4j5xyBjyQ ($20.40 in chips) 
Seat 2: ErIN0JRL5srYjT6en1f8YQ ($24.80 in chips) 
Seat 3: sEQx9G5Cu8k1HNdQasxvUA ($39.80 in chips) 
Seat 4: NIALbunHAyYqmfMf7mrPhw ($5.55 in chips) 
Seat 5: TSmua8tGK3sTbwi0ynrW9Q ($59.40 in chips) 
NIALbunHAyYqmfMf7mrPhw: posts small blind $0.10
TSmua8tGK3sTbwi0ynrW9Q: posts big blind $0.25
IGRfskE1v9H9Bn+fz8AgNQ: sits out 
*** HOLE CARDS ***
oseFhpinoe+Zg4j5xyBjyQ: calls $0.25
ErIN0JRL5srYjT6en1f8YQ: calls $0.25
sEQx9G5Cu8k1HNdQasxvUA: folds 
NIALbunHAyYqmfMf7mrPhw: calls $0.15
TSmua8tGK3sTbwi0ynrW9Q: checks 
*** FLOP *** [Th 7d 3s]
NIALbunHAyYqmfMf7mrPhw: checks 
TSmua8tGK3sTbwi0ynrW9Q: checks 
oseFhpinoe+Zg4j5xyBjyQ: checks 
ErIN0JRL5srYjT6en1f8YQ: checks 
*** TURN *** [Th 7d 3s] [7c]
NIALbunHAyYqmfMf7mrPhw: bets $0.25
TSmua8tGK3sTbwi0ynrW9Q: folds 
oseFhpinoe+Zg4j5xyBjyQ: folds 
ErIN0JRL5srYjT6en1f8YQ: folds 
Uncalled bet ($0.25) returned to NIALbunHAyYqmfMf7mrPhw
NIALbunHAyYqmfMf7mrPhw collected $0.95 from pot
*** SUMMARY ***
Total pot $1 | Rake $0.05 
Board [Th 7d 3s 7c]
Seat 1: oseFhpinoe+Zg4j5xyBjyQ folded on the Turn
Seat 2: ErIN0JRL5srYjT6en1f8YQ folded on the Turn
Seat 3: sEQx9G5Cu8k1HNdQasxvUA (button) folded before Flop (didn't bet)
Seat 4: NIALbunHAyYqmfMf7mrPhw (small blind) collected ($0.95)
Seat 5: TSmua8tGK3sTbwi0ynrW9Q (big blind) folded on the Turn




PokerStars Game #59939529162:  Hold'em No Limit ($0.10/$0.25) - 2009/07/01 0:42:12 ET
Table 'gkdjhbH1jaE3hwhPRIKMiQ' 6-max Seat #6 is the button
Seat 1: nc79pm0LZRdhncq55evVqA ($25 in chips) 
Seat 2: 1NNFfYMd5Hsphl/FYz9fNA ($33.65 in chips) 
Seat 3: kG34n23qFQA3nzdOJTQ1dA ($24.65 in chips) 
Seat 5: Ew/TYPQIsbQ2X8nm5iAJBg ($24.90 in chips) 
Seat 6: wqphQtauX5Qn7WRJZS1flA ($27.70 in chips) 
nc79pm0LZRdhncq55evVqA: posts small blind $0.10
1NNFfYMd5Hsphl/FYz9fNA: posts big blind $0.25
*** HOLE CARDS ***
kG34n23qFQA3nzdOJTQ1dA: folds 
Ew/TYPQIsbQ2X8nm5iAJBg: folds 
wqphQtauX5Qn7WRJZS1flA: folds 
nc79pm0LZRdhncq55evVqA: raises $0.75 to $1
7uqewvdd5+KjmM7wl58k+w leaves the table
1NNFfYMd5Hsphl/FYz9fNA: folds 
Uncalled bet ($0.75) returned to nc79pm0LZRdhncq55evVqA
nc79pm0LZRdhncq55evVqA collected $0.50 from pot
nc79pm0LZRdhncq55evVqA: doesn't show hand 
*** SUMMARY ***
Total pot $0.50 | Rake $0 
Seat 1: nc79pm0LZRdhncq55evVqA (small blind) collected ($0.50)
Seat 2: 1NNFfYMd5Hsphl/FYz9fNA (big blind) folded before Flop
Seat 3: kG34n23qFQA3nzdOJTQ1dA folded before Flop (didn't bet)
Seat 5: Ew/TYPQIsbQ2X8nm5iAJBg folded before Flop (didn't bet)
Seat 6: wqphQtauX5Qn7WRJZS1flA (button) folded before Flop (didn't bet)




PokerStars Game #59939528694:  Hold'em No Limit ($0.10/$0.25) - 2009/07/01 0:42:12 ET
Table 'MiquQrQZJJq9ZtgRIp9HFQ' 6-max Seat #6 is the button
Seat 1: hM0MSDtq2ow7J40bSR04ig ($4.65 in chips) 
Seat 2: DMQLAmut/l19xN5STQndFg ($2.60 in chips) 
Seat 4: 0HIrwssk0FQvyKULzUTtlg ($21.15 in chips) 
Seat 5: LXN9U+5F+9if/ead2+w1nw ($46.70 in chips) 
Seat 6: X9oXZTg4PhZVR+ilX2OYbA ($12.15 in chips) 
hM0MSDtq2ow7J40bSR04ig: posts small blind $0.10
DMQLAmut/l19xN5STQndFg: posts big blind $0.25
BYxjLnV1/LL0aZcTbfAOvw: sits out 
*** HOLE CARDS ***
0HIrwssk0FQvyKULzUTtlg: folds 
LXN9U+5F+9if/ead2+w1nw: raises $0.50 to $0.75
X9oXZTg4PhZVR+ilX2OYbA: folds 
hM0MSDtq2ow7J40bSR04ig: folds 
DMQLAmut/l19xN5STQndFg: folds 
Uncalled bet ($0.50) returned to LXN9U+5F+9if/ead2+w1nw
LXN9U+5F+9if/ead2+w1nw collected $0.60 from pot
*** SUMMARY ***
Total pot $0.60 | Rake $0 
Seat 1: hM0MSDtq2ow7J40bSR04ig (small blind) folded before Flop
Seat 2: DMQLAmut/l19xN5STQndFg (big blind) folded before Flop
Seat 4: 0HIrwssk0FQvyKULzUTtlg folded before Flop (didn't bet)
Seat 5: LXN9U+5F+9if/ead2+w1nw collected ($0.60)
Seat 6: X9oXZTg4PhZVR+ilX2OYbA (button) folded before Flop (didn't bet)




PokerStars Game #59939529226:  Hold'em No Limit ($0.10/$0.25) - 2009/07/01 0:42:12 ET
Table 'YlRA05h9BJ1EhOUSNUjJdg' 9-max Seat #9 is the button
Seat 1: 5gHh6iDvZdEvYi59Pko1iA ($3 in chips) 
Seat 2: Y2GFAe+PT7xnUUtgqCNDFw ($19.55 in chips) 
Seat 3: C91Mv1usdi9Vq9ljlQVsug ($54.05 in chips) 
Seat 4: HPEB+AtKw1+C/cxU0o1ciw ($30.70 in chips) 
Seat 5: oKO7b50N6TzXbPBr/mcrUA ($24.05 in chips) 
Seat 6: GMMsoUkaAAY5/vm1Kmh9pA ($13.70 in chips) 
Seat 7: oVDuzcEt1umAPOB/u6ZH9g ($25.10 in chips) 
Seat 8: j4q3p0lesp63b1gZDwLBZw ($5 in chips) 
Seat 9: hBMUlEpyU74r/fwDgIpXjQ ($27.30 in chips) 
5gHh6iDvZdEvYi59Pko1iA: posts small blind $0.10
Y2GFAe+PT7xnUUtgqCNDFw: posts big blind $0.25
*** HOLE CARDS ***
C91Mv1usdi9Vq9ljlQVsug: folds 
HPEB+AtKw1+C/cxU0o1ciw: folds 
oKO7b50N6TzXbPBr/mcrUA: calls $0.25
GMMsoUkaAAY5/vm1Kmh9pA: calls $0.25
oVDuzcEt1umAPOB/u6ZH9g: folds 
j4q3p0lesp63b1gZDwLBZw: folds 
hBMUlEpyU74r/fwDgIpXjQ: folds 
5gHh6iDvZdEvYi59Pko1iA: folds 
Y2GFAe+PT7xnUUtgqCNDFw: checks 
*** FLOP *** [5c 6h Jd]
Y2GFAe+PT7xnUUtgqCNDFw: checks 
oKO7b50N6TzXbPBr/mcrUA: bets $0.75
GMMsoUkaAAY5/vm1Kmh9pA: folds 
Y2GFAe+PT7xnUUtgqCNDFw: folds 
Uncalled bet ($0.75) returned to oKO7b50N6TzXbPBr/mcrUA
oKO7b50N6TzXbPBr/mcrUA collected $0.85 from pot
oKO7b50N6TzXbPBr/mcrUA: doesn't show hand 
*** SUMMARY ***
Total pot $0.85 | Rake $0 
Board [5c 6h Jd]
Seat 1: 5gHh6iDvZdEvYi59Pko1iA (small blind) folded before Flop
Seat 2: Y2GFAe+PT7xnUUtgqCNDFw (big blind) folded on the Flop
Seat 3: C91Mv1usdi9Vq9ljlQVsug folded before Flop (didn't bet)
Seat 4: HPEB+AtKw1+C/cxU0o1ciw folded before Flop (didn't bet)
Seat 5: oKO7b50N6TzXbPBr/mcrUA collected ($0.85)
Seat 6: GMMsoUkaAAY5/vm1Kmh9pA folded on the Flop
Seat 7: oVDuzcEt1umAPOB/u6ZH9g folded before Flop (didn't bet)
Seat 8: j4q3p0lesp63b1gZDwLBZw folded before Flop (didn't bet)
Seat 9: hBMUlEpyU74r/fwDgIpXjQ (button) folded before Flop (didn't bet)




PokerStars Game #59939528786:  Hold'em No Limit ($0.10/$0.25) - 2009/07/01 0:42:12 ET
Table 'fvoGXKLawfAadYn02raohg' 9-max Seat #1 is the button
Seat 1: DIBbjEYGs+TVdVgEB/4+3w ($39 in chips) 
Seat 2: Ud3KoJmky17jahFh5jxdNA ($15.50 in chips) 
Seat 3: aNpwfA31EREwO+ar4XzBCw ($25 in chips) 
Seat 4: uibjYTUZq0zsChpZ84TeGQ ($14.80 in chips) 
Seat 5: 1Uq1Gp+AloSwO4jVgEdX+A ($25.85 in chips) 
Seat 6: SXqVW4Q0evTUVZG6BbUNIA ($31.25 in chips) 
Seat 7: 18G4P1XstjNvItdGUITxgw ($25.45 in chips) 
Seat 8: 4GJMmHGKzu+gVtalqRy7dA ($12.85 in chips) 
Seat 9: JKfTHkCJ+e5tjUU+K32h1A ($14.60 in chips) 
Ud3KoJmky17jahFh5jxdNA: posts small blind $0.10
aNpwfA31EREwO+ar4XzBCw: posts big blind $0.25
*** HOLE CARDS ***
uibjYTUZq0zsChpZ84TeGQ: folds 
1Uq1Gp+AloSwO4jVgEdX+A: folds 
SXqVW4Q0evTUVZG6BbUNIA: folds 
18G4P1XstjNvItdGUITxgw: folds 
4GJMmHGKzu+gVtalqRy7dA: folds 
JKfTHkCJ+e5tjUU+K32h1A: calls $0.25
DIBbjEYGs+TVdVgEB/4+3w: raises $0.75 to $1
Ud3KoJmky17jahFh5jxdNA: folds 
aNpwfA31EREwO+ar4XzBCw: folds 
JKfTHkCJ+e5tjUU+K32h1A: calls $0.75
*** FLOP *** [2c As 9s]
JKfTHkCJ+e5tjUU+K32h1A: checks 
DIBbjEYGs+TVdVgEB/4+3w: bets $2.50
JKfTHkCJ+e5tjUU+K32h1A: folds 
Uncalled bet ($2.50) returned to DIBbjEYGs+TVdVgEB/4+3w
DIBbjEYGs+TVdVgEB/4+3w collected $2.25 from pot
*** SUMMARY ***
Total pot $2.35 | Rake $0.10 
Board [2c As 9s]
Seat 1: DIBbjEYGs+TVdVgEB/4+3w (button) collected ($2.25)
Seat 2: Ud3KoJmky17jahFh5jxdNA (small blind) folded before Flop
Seat 3: aNpwfA31EREwO+ar4XzBCw (big blind) folded before Flop
Seat 4: uibjYTUZq0zsChpZ84TeGQ folded before Flop (didn't bet)
Seat 5: 1Uq1Gp+AloSwO4jVgEdX+A folded before Flop (didn't bet)
Seat 6: SXqVW4Q0evTUVZG6BbUNIA folded before Flop (didn't bet)
Seat 7: 18G4P1XstjNvItdGUITxgw folded before Flop (didn't bet)
Seat 8: 4GJMmHGKzu+gVtalqRy7dA folded before Flop (didn't bet)
Seat 9: JKfTHkCJ+e5tjUU+K32h1A folded on the Flop




PokerStars Game #59939528928:  Hold'em No Limit ($0.10/$0.25) - 2009/07/01 0:42:12 ET
Table 'ouLhepGYovxB2x0QxH7cVg' 9-max Seat #1 is the button
Seat 1: ghNKXUBl/H+t83JF079ZBA ($30.35 in chips) 
Seat 2: r1Z5m4PwSI5ANp7qCE1OJw ($14.10 in chips) 
Seat 3: SkLOm0UugROBRt2EfMpOxQ ($24.25 in chips) 
Seat 4: a0Sx6GHY7ln2Ns2C97eXeA ($28.50 in chips) 
Seat 5: 18G4P1XstjNvItdGUITxgw ($25 in chips) 
Seat 6: r6hsffOo1iKmaPYKwAZmFw ($25.30 in chips) 
Seat 7: oHv2mIZJh3H0JR+WOZteZA ($22.20 in chips) 
Seat 8: opOCI2p6kW0tINuVaAqmcQ ($25 in chips) 
Seat 9: fIgGw0jPUR7labvJPaPbeg ($10.80 in chips) 
r1Z5m4PwSI5ANp7qCE1OJw: posts small blind $0.10
SkLOm0UugROBRt2EfMpOxQ: posts big blind $0.25
*** HOLE CARDS ***
a0Sx6GHY7ln2Ns2C97eXeA: calls $0.25
18G4P1XstjNvItdGUITxgw: folds 
r6hsffOo1iKmaPYKwAZmFw: raises $1 to $1.25
oHv2mIZJh3H0JR+WOZteZA: folds 
opOCI2p6kW0tINuVaAqmcQ: folds 
fIgGw0jPUR7labvJPaPbeg: folds 
ghNKXUBl/H+t83JF079ZBA: folds 
r1Z5m4PwSI5ANp7qCE1OJw: folds 
SkLOm0UugROBRt2EfMpOxQ: folds 
a0Sx6GHY7ln2Ns2C97eXeA: folds 
Uncalled bet ($1) returned to r6hsffOo1iKmaPYKwAZmFw
r6hsffOo1iKmaPYKwAZmFw collected $0.85 from pot
r6hsffOo1iKmaPYKwAZmFw: doesn't show hand 
*** SUMMARY ***
Total pot $0.85 | Rake $0 
Seat 1: ghNKXUBl/H+t83JF079ZBA (button) folded before Flop (didn't bet)
Seat 2: r1Z5m4PwSI5ANp7qCE1OJw (small blind) folded before Flop
Seat 3: SkLOm0UugROBRt2EfMpOxQ (big blind) folded before Flop
Seat 4: a0Sx6GHY7ln2Ns2C97eXeA folded before Flop
Seat 5: 18G4P1XstjNvItdGUITxgw folded before Flop (didn't bet)
Seat 6: r6hsffOo1iKmaPYKwAZmFw collected ($0.85)
Seat 7: oHv2mIZJh3H0JR+WOZteZA folded before Flop (didn't bet)
Seat 8: opOCI2p6kW0tINuVaAqmcQ folded before Flop (didn't bet)
Seat 9: fIgGw0jPUR7labvJPaPbeg folded before Flop (didn't bet)




PokerStars Game #59939529674:  Hold'em No Limit ($0.10/$0.25) - 2009/07/01 0:42:13 ET
Table 'm+FQg/QP0VP1ZA3V62WtOg' 9-max Seat #7 is the button
Seat 2: oKO7b50N6TzXbPBr/mcrUA ($19.20 in chips) 
Seat 3: 4oA316mXLIui1QY63GXBUg ($25 in chips) 
Seat 4: 86vbuhJsyH+nbEg5qpDLyQ ($25 in chips) 
Seat 5: DnDcAdn9P0zGovMERigpFA ($25 in chips) 
Seat 6: 0kGr2KqzSs4y4kVqyDiTag ($17.45 in chips) 
Seat 7: MIVCHqCqqlke0Lb0z7glcw ($24.65 in chips) 
Seat 8: tZEGwCRajq0AFS6z46uW9w ($22.50 in chips) 
Seat 9: ghNKXUBl/H+t83JF079ZBA ($25 in chips) 
tZEGwCRajq0AFS6z46uW9w: posts small blind $0.10
ghNKXUBl/H+t83JF079ZBA: posts big blind $0.25
*** HOLE CARDS ***
IK3/w7XV7rd8mVIsuasjYA leaves the table
qwr38jl5txoR36M7G5qi4A joins the table at seat #1 
oKO7b50N6TzXbPBr/mcrUA: raises $0.50 to $0.75
4oA316mXLIui1QY63GXBUg: folds 
86vbuhJsyH+nbEg5qpDLyQ: folds 
DnDcAdn9P0zGovMERigpFA: folds 
0kGr2KqzSs4y4kVqyDiTag: folds 
MIVCHqCqqlke0Lb0z7glcw: folds 
tZEGwCRajq0AFS6z46uW9w: calls $0.65
ghNKXUBl/H+t83JF079ZBA: folds 
*** FLOP *** [4c As Ks]
tZEGwCRajq0AFS6z46uW9w: checks 
oKO7b50N6TzXbPBr/mcrUA: bets $1
tZEGwCRajq0AFS6z46uW9w: calls $1
*** TURN *** [4c As Ks] [Kh]
tZEGwCRajq0AFS6z46uW9w: checks 
oKO7b50N6TzXbPBr/mcrUA: bets $1
tZEGwCRajq0AFS6z46uW9w: calls $1
*** RIVER *** [4c As Ks Kh] [5c]
tZEGwCRajq0AFS6z46uW9w: checks 
oKO7b50N6TzXbPBr/mcrUA: checks 
*** SHOW DOWN ***
tZEGwCRajq0AFS6z46uW9w: shows [Qs Qh] (two pair, Kings and Queens)
oKO7b50N6TzXbPBr/mcrUA: shows [Jh Ah] (two pair, Aces and Kings)
oKO7b50N6TzXbPBr/mcrUA collected $5.50 from pot
*** SUMMARY ***
Total pot $5.75 | Rake $0.25 
Board [4c As Ks Kh 5c]
Seat 2: oKO7b50N6TzXbPBr/mcrUA showed [Jh Ah] and won ($5.50) with two pair, Aces and Kings
Seat 3: 4oA316mXLIui1QY63GXBUg folded before Flop (didn't bet)
Seat 4: 86vbuhJsyH+nbEg5qpDLyQ folded before Flop (didn't bet)
Seat 5: DnDcAdn9P0zGovMERigpFA folded before Flop (didn't bet)
Seat 6: 0kGr2KqzSs4y4kVqyDiTag folded before Flop (didn't bet)
Seat 7: MIVCHqCqqlke0Lb0z7glcw (button) folded before Flop (didn't bet)
Seat 8: tZEGwCRajq0AFS6z46uW9w (small blind) showed [Qs Qh] and lost with two pair, Kings and Queens
Seat 9: ghNKXUBl/H+t83JF079ZBA (big blind) folded before Flop




PokerStars Game #59939529870:  Hold'em No Limit ($0.10/$0.25) - 2009/07/01 0:42:13 ET
Table 'tq5CvS0RUqGkuBK0XTzqqg' 6-max Seat #3 is the button
Seat 1: 39EF5EcifdyPS7v+EnfxLg ($22.55 in chips) 
Seat 2: mfrkWA3PTeYPkbO6hi98Aw ($68.60 in chips) 
Seat 3: PbMzPZIePKifKQZfKDkbIw ($25.50 in chips) 
Seat 4: W7FS+h5B+OhmwF+cTt3ZPQ ($14.40 in chips) 
Seat 5: qGHGf/553gQnDoklMRe3tg ($25 in chips) 
Seat 6: hOfhw8jxWiq14wXGL4Bh/Q ($14.65 in chips) 
W7FS+h5B+OhmwF+cTt3ZPQ: posts small blind $0.10
qGHGf/553gQnDoklMRe3tg: posts big blind $0.25
*** HOLE CARDS ***
hOfhw8jxWiq14wXGL4Bh/Q: folds 
39EF5EcifdyPS7v+EnfxLg: folds 
mfrkWA3PTeYPkbO6hi98Aw: folds 
PbMzPZIePKifKQZfKDkbIw: raises $0.50 to $0.75
W7FS+h5B+OhmwF+cTt3ZPQ: calls $0.65
qGHGf/553gQnDoklMRe3tg: calls $0.50
*** FLOP *** [Qd Th Jc]
W7FS+h5B+OhmwF+cTt3ZPQ: checks 
qGHGf/553gQnDoklMRe3tg: checks 
PbMzPZIePKifKQZfKDkbIw: bets $1.50
W7FS+h5B+OhmwF+cTt3ZPQ: folds 
qGHGf/553gQnDoklMRe3tg: folds 
Uncalled bet ($1.50) returned to PbMzPZIePKifKQZfKDkbIw
PbMzPZIePKifKQZfKDkbIw collected $2.15 from pot
*** SUMMARY ***
Total pot $2.25 | Rake $0.10 
Board [Qd Th Jc]
Seat 1: 39EF5EcifdyPS7v+EnfxLg folded before Flop (didn't bet)
Seat 2: mfrkWA3PTeYPkbO6hi98Aw folded before Flop (didn't bet)
Seat 3: PbMzPZIePKifKQZfKDkbIw (button) collected ($2.15)
Seat 4: W7FS+h5B+OhmwF+cTt3ZPQ (small blind) folded on the Flop
Seat 5: qGHGf/553gQnDoklMRe3tg (big blind) folded on the Flop
Seat 6: hOfhw8jxWiq14wXGL4Bh/Q folded before Flop (didn't bet)




PokerStars Game #59939530092:  Hold'em No Limit ($0.10/$0.25) - 2009/07/01 0:42:14 ET
Table 'O6cwjhrMn9pfzx1Ngn5zkQ' 6-max Seat #3 is the button
Seat 1: k4mJ9nD/YOVTl8/kGW+U6w ($12.95 in chips) 
Seat 2: M6xK/VklCvdyyrmvzATlxQ ($14 in chips) 
Seat 3: EE16Ua5b1HSsYej5zeXOlA ($25 in chips) 
Seat 4: wKFJ513ucluNNiMlkXcDOQ ($32.55 in chips) 
Seat 5: niLn0xUVlqh8If80xRjzCA ($23.55 in chips) 
Seat 6: d0J1xuhsynEY81YHwAvJ5g ($27.05 in chips) 
wKFJ513ucluNNiMlkXcDOQ: posts small blind $0.10
niLn0xUVlqh8If80xRjzCA: posts big blind $0.25
*** HOLE CARDS ***
d0J1xuhsynEY81YHwAvJ5g: folds 
k4mJ9nD/YOVTl8/kGW+U6w: folds 
M6xK/VklCvdyyrmvzATlxQ: folds 
EE16Ua5b1HSsYej5zeXOlA: raises $0.50 to $0.75
wKFJ513ucluNNiMlkXcDOQ: folds 
niLn0xUVlqh8If80xRjzCA: calls $0.50
*** FLOP *** [3h 8s 2d]
niLn0xUVlqh8If80xRjzCA: checks 
EE16Ua5b1HSsYej5zeXOlA: bets $1.15
niLn0xUVlqh8If80xRjzCA: folds 
Uncalled bet ($1.15) returned to EE16Ua5b1HSsYej5zeXOlA
EE16Ua5b1HSsYej5zeXOlA collected $1.55 from pot
EE16Ua5b1HSsYej5zeXOlA: doesn't show hand 
*** SUMMARY ***
Total pot $1.60 | Rake $0.05 
Board [3h 8s 2d]
Seat 1: k4mJ9nD/YOVTl8/kGW+U6w folded before Flop (didn't bet)
Seat 2: M6xK/VklCvdyyrmvzATlxQ folded before Flop (didn't bet)
Seat 3: EE16Ua5b1HSsYej5zeXOlA (button) collected ($1.55)
Seat 4: wKFJ513ucluNNiMlkXcDOQ (small blind) folded before Flop
Seat 5: niLn0xUVlqh8If80xRjzCA (big blind) folded on the Flop
Seat 6: d0J1xuhsynEY81YHwAvJ5g folded before Flop (didn't bet)




PokerStars Game #59939530622:  Hold'em No Limit ($0.10/$0.25) - 2009/07/01 0:42:14 ET
Table 'oZuNsbNJuUyQLGKzQ/4JFg' 6-max Seat #1 is the button
Seat 1: /hq3j+3FbArzS8nEzmqRuw ($4.85 in chips) 
Seat 3: 8ClCHtFXGNplITm+63KB+Q ($36.40 in chips) 
Seat 4: pWN7DVB+VCCiq83kllzEtg ($17.25 in chips) 
Seat 5: IH5lT4+CuQFyy32Qf5ydDw ($21 in chips) 
Seat 6: 34ttqW62uIRrqINCCmLcsw ($20.65 in chips) 
UA5OsKS3VPaxa7uC8La/kA has returned
8ClCHtFXGNplITm+63KB+Q: posts small blind $0.10
pWN7DVB+VCCiq83kllzEtg: posts big blind $0.25
*** HOLE CARDS ***
IH5lT4+CuQFyy32Qf5ydDw: calls $0.25
34ttqW62uIRrqINCCmLcsw: folds 
/hq3j+3FbArzS8nEzmqRuw: calls $0.25
8ClCHtFXGNplITm+63KB+Q: folds 
pWN7DVB+VCCiq83kllzEtg: checks 
*** FLOP *** [5c 8h Qc]
pWN7DVB+VCCiq83kllzEtg: checks 
IH5lT4+CuQFyy32Qf5ydDw: bets $0.75
/hq3j+3FbArzS8nEzmqRuw: raises $1.75 to $2.50
pWN7DVB+VCCiq83kllzEtg: calls $2.50
IH5lT4+CuQFyy32Qf5ydDw: calls $1.75
*** TURN *** [5c 8h Qc] [4d]
pWN7DVB+VCCiq83kllzEtg: checks 
IH5lT4+CuQFyy32Qf5ydDw: checks 
/hq3j+3FbArzS8nEzmqRuw: bets $2.10 and is all-in
pWN7DVB+VCCiq83kllzEtg: calls $2.10
IH5lT4+CuQFyy32Qf5ydDw: calls $2.10
*** RIVER *** [5c 8h Qc 4d] [Kh]
pWN7DVB+VCCiq83kllzEtg: checks 
IH5lT4+CuQFyy32Qf5ydDw: checks 
*** SHOW DOWN ***
pWN7DVB+VCCiq83kllzEtg: shows [7h 4h] (a pair of Fours)
IH5lT4+CuQFyy32Qf5ydDw: shows [4c Ac] (a pair of Fours - Ace kicker)
/hq3j+3FbArzS8nEzmqRuw: shows [Qh Td] (a pair of Queens)
/hq3j+3FbArzS8nEzmqRuw collected $13.95 from pot
*** SUMMARY ***
Total pot $14.65 | Rake $0.70 
Board [5c 8h Qc 4d Kh]
Seat 1: /hq3j+3FbArzS8nEzmqRuw (button) showed [Qh Td] and won ($13.95) with a pair of Queens
Seat 3: 8ClCHtFXGNplITm+63KB+Q (small blind) folded before Flop
Seat 4: pWN7DVB+VCCiq83kllzEtg (big blind) showed [7h 4h] and lost with a pair of Fours
Seat 5: IH5lT4+CuQFyy32Qf5ydDw showed [4c Ac] and lost with a pair of Fours
Seat 6: 34ttqW62uIRrqINCCmLcsw folded before Flop (didn't bet)




PokerStars Game #59939529986:  Hold'em No Limit ($0.10/$0.25) - 2009/07/01 0:42:14 ET
Table '+UzantPJ4smVdrh+4GTu1w' 6-max Seat #3 is the button
Seat 2: tcbEu7VzyHQ+0lh+skbQhQ ($13.25 in chips) 
Seat 3: SS/yfeArhULzIcOPe8MdPg ($51 in chips) 
Seat 4: IGRfskE1v9H9Bn+fz8AgNQ ($24 in chips) 
Seat 5: cj4VBQya7HtVL2zCGd5jLQ ($16.90 in chips) 
Seat 6: BYxjLnV1/LL0aZcTbfAOvw ($48.05 in chips) 
IGRfskE1v9H9Bn+fz8AgNQ: posts small blind $0.10
cj4VBQya7HtVL2zCGd5jLQ: posts big blind $0.25
*** HOLE CARDS ***
BYxjLnV1/LL0aZcTbfAOvw: folds 
tcbEu7VzyHQ+0lh+skbQhQ: calls $0.25
SS/yfeArhULzIcOPe8MdPg: folds 
IGRfskE1v9H9Bn+fz8AgNQ: folds 
cj4VBQya7HtVL2zCGd5jLQ: checks 
*** FLOP *** [Th Kh Td]
cj4VBQya7HtVL2zCGd5jLQ: checks 
3Bm6SLY1pwRvi98HLQUkvg has returned
tcbEu7VzyHQ+0lh+skbQhQ: bets $0.75
cj4VBQya7HtVL2zCGd5jLQ: folds 
Uncalled bet ($0.75) returned to tcbEu7VzyHQ+0lh+skbQhQ
tcbEu7VzyHQ+0lh+skbQhQ collected $0.60 from pot
*** SUMMARY ***
Total pot $0.60 | Rake $0 
Board [Th Kh Td]
Seat 2: tcbEu7VzyHQ+0lh+skbQhQ collected ($0.60)
Seat 3: SS/yfeArhULzIcOPe8MdPg (button) folded before Flop (didn't bet)
Seat 4: IGRfskE1v9H9Bn+fz8AgNQ (small blind) folded before Flop
Seat 5: cj4VBQya7HtVL2zCGd5jLQ (big blind) folded on the Flop
Seat 6: BYxjLnV1/LL0aZcTbfAOvw folded before Flop (didn't bet)




PokerStars Game #59939530340:  Hold'em No Limit ($0.10/$0.25) - 2009/07/01 0:42:14 ET
Table 'o0CDOvKO/bn1WjeymDrXfA' 6-max Seat #6 is the button
Seat 1: 32YL2ZEp8NT4JB2RVM9euQ ($16.35 in chips) 
Seat 2: oc4ZGs0W+3RIg2yPyJw3ig ($30.45 in chips) 
Seat 3: EqXTTLKUlDlz7yi6ziyyWA ($10.85 in chips) 
Seat 5: u/yN5P9f3KlATg6WLWNkBQ ($28.50 in chips) 
Seat 6: Bada343Si4xKu3fNXY99AA ($20.60 in chips) 
32YL2ZEp8NT4JB2RVM9euQ: posts small blind $0.10
oc4ZGs0W+3RIg2yPyJw3ig: posts big blind $0.25
HotTillt: sits out 
*** HOLE CARDS ***
EqXTTLKUlDlz7yi6ziyyWA: folds 
u/yN5P9f3KlATg6WLWNkBQ: raises $1 to $1.25
Bada343Si4xKu3fNXY99AA: folds 
32YL2ZEp8NT4JB2RVM9euQ: folds 
oc4ZGs0W+3RIg2yPyJw3ig: folds 
Uncalled bet ($1) returned to u/yN5P9f3KlATg6WLWNkBQ
u/yN5P9f3KlATg6WLWNkBQ collected $0.60 from pot
u/yN5P9f3KlATg6WLWNkBQ: doesn't show hand 
*** SUMMARY ***
Total pot $0.60 | Rake $0 
Seat 1: 32YL2ZEp8NT4JB2RVM9euQ (small blind) folded before Flop
Seat 2: oc4ZGs0W+3RIg2yPyJw3ig (big blind) folded before Flop
Seat 3: EqXTTLKUlDlz7yi6ziyyWA folded before Flop (didn't bet)
Seat 5: u/yN5P9f3KlATg6WLWNkBQ collected ($0.60)
Seat 6: Bada343Si4xKu3fNXY99AA (button) folded before Flop (didn't bet)




PokerStars Game #59939530478:  Hold'em No Limit ($0.10/$0.25) - 2009/07/01 0:42:14 ET
Table 'iMiAw/kTZXopgYX4HI7sHg' 9-max Seat #9 is the button
Seat 2: qwr38jl5txoR36M7G5qi4A ($7.50 in chips) 
Seat 3: HPEB+AtKw1+C/cxU0o1ciw ($22.55 in chips) 
Seat 4: S+cUFPGjDERB8nh2Ub77Bg ($12.35 in chips) 
Seat 5: UG5jx0ZzlHKfc+tNQpQoMQ ($1.90 in chips) 
Seat 6: mdk0yKND3u0wCmRU4tNRFg ($28.30 in chips) 
Seat 7: aPRz/2GxbXANYpVsQO8pdQ ($24.25 in chips) 
Seat 8: gU2i78hKxj5RUUH6zCK9bA ($6.15 in chips) 
Seat 9: K36tHfxDQBx3OFpy0baDPA ($20.75 in chips) 
1Clf3cPrqoy/YgvWdWK1Xw will be allowed to play after the button
qwr38jl5txoR36M7G5qi4A: posts small blind $0.10
HPEB+AtKw1+C/cxU0o1ciw: posts big blind $0.25
*** HOLE CARDS ***
S+cUFPGjDERB8nh2Ub77Bg: folds 
UG5jx0ZzlHKfc+tNQpQoMQ: folds 
mdk0yKND3u0wCmRU4tNRFg: folds 
aPRz/2GxbXANYpVsQO8pdQ: folds 
gU2i78hKxj5RUUH6zCK9bA: raises $0.50 to $0.75
K36tHfxDQBx3OFpy0baDPA: folds 
qwr38jl5txoR36M7G5qi4A: folds 
HPEB+AtKw1+C/cxU0o1ciw: folds 
Uncalled bet ($0.50) returned to gU2i78hKxj5RUUH6zCK9bA
gU2i78hKxj5RUUH6zCK9bA collected $0.60 from pot
*** SUMMARY ***
Total pot $0.60 | Rake $0 
Seat 2: qwr38jl5txoR36M7G5qi4A (small blind) folded before Flop
Seat 3: HPEB+AtKw1+C/cxU0o1ciw (big blind) folded before Flop
Seat 4: S+cUFPGjDERB8nh2Ub77Bg folded before Flop (didn't bet)
Seat 5: UG5jx0ZzlHKfc+tNQpQoMQ folded before Flop (didn't bet)
Seat 6: mdk0yKND3u0wCmRU4tNRFg folded before Flop (didn't bet)
Seat 7: aPRz/2GxbXANYpVsQO8pdQ folded before Flop (didn't bet)
Seat 8: gU2i78hKxj5RUUH6zCK9bA collected ($0.60)
Seat 9: K36tHfxDQBx3OFpy0baDPA (button) folded before Flop (didn't bet)




PokerStars Game #59939530866:  Hold'em No Limit ($0.10/$0.25) - 2009/07/01 0:42:15 ET
Table 'KTZXQ4LREPjpS54R3DFTsw' 9-max Seat #2 is the button
Seat 1: dSjkBIV7Bv+ZCIWNBguf7w ($30.60 in chips) 
Seat 2: hQgb9iRlpctfdl51mltYlw ($27.60 in chips) 
Seat 3: N6fYvIzQLKaydFLKQGtMlQ ($35.95 in chips) 
Seat 4: K0b5wNInj6hUGRr6yzKFtw ($25 in chips) 
Seat 5: HPEB+AtKw1+C/cxU0o1ciw ($31.60 in chips) 
Seat 6: 1q23ISSsSMhv2lHXBfj9/A ($23.50 in chips) 
Seat 8: s++YekTPLdOGgNR0tlMkdA ($4.20 in chips) 
Seat 9: E4pjUoTJmJNmancGXn1nSw ($18.25 in chips) 
N6fYvIzQLKaydFLKQGtMlQ: posts small blind $0.10
K0b5wNInj6hUGRr6yzKFtw: posts big blind $0.25
yyG4svzOpC1A+sUP/scg6w: sits out 
*** HOLE CARDS ***
HPEB+AtKw1+C/cxU0o1ciw: folds 
1q23ISSsSMhv2lHXBfj9/A: folds 
s++YekTPLdOGgNR0tlMkdA: folds 
E4pjUoTJmJNmancGXn1nSw: folds 
dSjkBIV7Bv+ZCIWNBguf7w: folds 
hQgb9iRlpctfdl51mltYlw: folds 
N6fYvIzQLKaydFLKQGtMlQ: calls $0.15
K0b5wNInj6hUGRr6yzKFtw: raises $0.75 to $1
N6fYvIzQLKaydFLKQGtMlQ: folds 
Uncalled bet ($0.75) returned to K0b5wNInj6hUGRr6yzKFtw
K0b5wNInj6hUGRr6yzKFtw collected $0.50 from pot
K0b5wNInj6hUGRr6yzKFtw: doesn't show hand 
*** SUMMARY ***
Total pot $0.50 | Rake $0 
Seat 1: dSjkBIV7Bv+ZCIWNBguf7w folded before Flop (didn't bet)
Seat 2: hQgb9iRlpctfdl51mltYlw (button) folded before Flop (didn't bet)
Seat 3: N6fYvIzQLKaydFLKQGtMlQ (small blind) folded before Flop
Seat 4: K0b5wNInj6hUGRr6yzKFtw (big blind) collected ($0.50)
Seat 5: HPEB+AtKw1+C/cxU0o1ciw folded before Flop (didn't bet)
Seat 6: 1q23ISSsSMhv2lHXBfj9/A folded before Flop (didn't bet)
Seat 8: s++YekTPLdOGgNR0tlMkdA folded before Flop (didn't bet)
Seat 9: E4pjUoTJmJNmancGXn1nSw folded before Flop (didn't bet)




PokerStars Game #59939530722:  Hold'em No Limit ($0.10/$0.25) - 2009/07/01 0:42:15 ET
Table 'zKwHJD0cmKNUure9qQTfFg' 6-max Seat #2 is the button
Seat 1: zsU1ijOyYEi+40wBKPEbmw ($6.20 in chips) 
Seat 2: XwQK8xvCADxp0bUmji+Zyg ($31.90 in chips) 
Seat 4: v+QfkGiuj9bgtuNoVnDO8w ($25 in chips) 
Seat 5: I1TxPvWj8NfG8orglCinNA ($30.15 in chips) 
Seat 6: BvTq4Tu0zBOsniW3eFCnkQ ($42.50 in chips) 
v+QfkGiuj9bgtuNoVnDO8w: posts small blind $0.10
I1TxPvWj8NfG8orglCinNA: posts big blind $0.25
*** HOLE CARDS ***
wUwfsTnmpHcWa17qFlQr1Q leaves the table
BvTq4Tu0zBOsniW3eFCnkQ: raises $0.75 to $1
zsU1ijOyYEi+40wBKPEbmw: calls $1
XwQK8xvCADxp0bUmji+Zyg: folds 
v+QfkGiuj9bgtuNoVnDO8w: folds 
I1TxPvWj8NfG8orglCinNA: folds 
*** FLOP *** [4s 8d 2d]
BvTq4Tu0zBOsniW3eFCnkQ: bets $1.75
zsU1ijOyYEi+40wBKPEbmw: raises $1.75 to $3.50
BvTq4Tu0zBOsniW3eFCnkQ: folds 
Uncalled bet ($1.75) returned to zsU1ijOyYEi+40wBKPEbmw
zsU1ijOyYEi+40wBKPEbmw collected $5.60 from pot
*** SUMMARY ***
Total pot $5.85 | Rake $0.25 
Board [4s 8d 2d]
Seat 1: zsU1ijOyYEi+40wBKPEbmw collected ($5.60)
Seat 2: XwQK8xvCADxp0bUmji+Zyg (button) folded before Flop (didn't bet)
Seat 4: v+QfkGiuj9bgtuNoVnDO8w (small blind) folded before Flop
Seat 5: I1TxPvWj8NfG8orglCinNA (big blind) folded before Flop
Seat 6: BvTq4Tu0zBOsniW3eFCnkQ folded on the Flop




PokerStars Game #59939530798:  Hold'em No Limit ($0.10/$0.25) - 2009/07/01 0:42:15 ET
Table 'nyTW9cVtYentc5V7xU/0jA' 6-max Seat #1 is the button
Seat 1: YfxPRDAWfqnGBhiIEdlTYg ($11.30 in chips) 
Seat 2: 7FmwVDcdEtxDpHmP4hOXsQ ($25 in chips) 
Seat 3: kG34n23qFQA3nzdOJTQ1dA ($24.55 in chips) 
Seat 4: r6u7MWSXF30/khcTYkrG9Q ($34.55 in chips) 
Seat 5: BedjMfrlRfPgSq7CXpPAmg ($28.80 in chips) 
Seat 6: dQJByDqHOLbgqX/HobyAJA ($7.35 in chips) 
7FmwVDcdEtxDpHmP4hOXsQ: posts small blind $0.10
kG34n23qFQA3nzdOJTQ1dA: posts big blind $0.25
*** HOLE CARDS ***
r6u7MWSXF30/khcTYkrG9Q: raises $0.50 to $0.75
BedjMfrlRfPgSq7CXpPAmg: folds 
dQJByDqHOLbgqX/HobyAJA: folds 
YfxPRDAWfqnGBhiIEdlTYg: calls $0.75
7FmwVDcdEtxDpHmP4hOXsQ: raises $3 to $3.75
kG34n23qFQA3nzdOJTQ1dA: folds 
r6u7MWSXF30/khcTYkrG9Q: folds 
YfxPRDAWfqnGBhiIEdlTYg: folds 
Uncalled bet ($3) returned to 7FmwVDcdEtxDpHmP4hOXsQ
7FmwVDcdEtxDpHmP4hOXsQ collected $2.50 from pot
7FmwVDcdEtxDpHmP4hOXsQ: doesn't show hand 
*** SUMMARY ***
Total pot $2.50 | Rake $0 
Seat 1: YfxPRDAWfqnGBhiIEdlTYg (button) folded before Flop
Seat 2: 7FmwVDcdEtxDpHmP4hOXsQ (small blind) collected ($2.50)
Seat 3: kG34n23qFQA3nzdOJTQ1dA (big blind) folded before Flop
Seat 4: r6u7MWSXF30/khcTYkrG9Q folded before Flop
Seat 5: BedjMfrlRfPgSq7CXpPAmg folded before Flop (didn't bet)
Seat 6: dQJByDqHOLbgqX/HobyAJA folded before Flop (didn't bet)




PokerStars Game #59939531168:  Hold'em No Limit ($0.10/$0.25) - 2009/07/01 0:42:15 ET
Table '63h13e5p7cWe02rClZ1CHw' 6-max Seat #6 is the button
Seat 1: 7VfhiFY533nbUKvyEthASw ($8.15 in chips) 
Seat 2: k9nHZTHt8hYhYRcW8NTb4g ($15.90 in chips) 
Seat 3: 9jSiy0meE9XJKkdIZwyTEQ ($34.25 in chips) 
Seat 4: myagrRAhs0mdgmh5GNqvCw ($4.60 in chips) 
Seat 5: bE34il0XYGjWPD5/vbkMaQ ($24.30 in chips) 
Seat 6: mfrkWA3PTeYPkbO6hi98Aw ($25 in chips) 
7VfhiFY533nbUKvyEthASw: posts small blind $0.10
k9nHZTHt8hYhYRcW8NTb4g: posts big blind $0.25
*** HOLE CARDS ***
9jSiy0meE9XJKkdIZwyTEQ: folds 
myagrRAhs0mdgmh5GNqvCw: folds 
bE34il0XYGjWPD5/vbkMaQ: calls $0.25
mfrkWA3PTeYPkbO6hi98Aw: folds 
7VfhiFY533nbUKvyEthASw: folds 
k9nHZTHt8hYhYRcW8NTb4g: raises $0.75 to $1
bE34il0XYGjWPD5/vbkMaQ: calls $0.75
*** FLOP *** [6c Ks Ac]
k9nHZTHt8hYhYRcW8NTb4g: checks 
bE34il0XYGjWPD5/vbkMaQ: checks 
*** TURN *** [6c Ks Ac] [3h]
k9nHZTHt8hYhYRcW8NTb4g: checks 
bE34il0XYGjWPD5/vbkMaQ: bets $1
k9nHZTHt8hYhYRcW8NTb4g: calls $1
*** RIVER *** [6c Ks Ac 3h] [Ad]
k9nHZTHt8hYhYRcW8NTb4g: checks 
bE34il0XYGjWPD5/vbkMaQ: bets $2.25
k9nHZTHt8hYhYRcW8NTb4g: calls $2.25
*** SHOW DOWN ***
bE34il0XYGjWPD5/vbkMaQ: shows [Qh 8d] (a pair of Aces)
k9nHZTHt8hYhYRcW8NTb4g: shows [Js Jc] (two pair, Aces and Jacks)
k9nHZTHt8hYhYRcW8NTb4g collected $8.20 from pot
*** SUMMARY ***
Total pot $8.60 | Rake $0.40 
Board [6c Ks Ac 3h Ad]
Seat 1: 7VfhiFY533nbUKvyEthASw (small blind) folded before Flop
Seat 2: k9nHZTHt8hYhYRcW8NTb4g (big blind) showed [Js Jc] and won ($8.20) with two pair, Aces and Jacks
Seat 3: 9jSiy0meE9XJKkdIZwyTEQ folded before Flop (didn't bet)
Seat 4: myagrRAhs0mdgmh5GNqvCw folded before Flop (didn't bet)
Seat 5: bE34il0XYGjWPD5/vbkMaQ showed [Qh 8d] and lost with a pair of Aces
Seat 6: mfrkWA3PTeYPkbO6hi98Aw (button) folded before Flop (didn't bet)




PokerStars Game #59939531070:  Hold'em No Limit ($0.10/$0.25) - 2009/07/01 0:42:15 ET
Table 'zW+7jPbOLCvlPu+dUGY5WQ' 6-max Seat #2 is the button
Seat 1: JE/wJXmjw3bpdmjwvh2pcg ($25 in chips) 
Seat 2: DXgVFTcE3WofABsNJ5G/nw ($14.65 in chips) 
Seat 3: BedjMfrlRfPgSq7CXpPAmg ($63.85 in chips) 
Seat 4: Qv4VzEkN09uD11sjKv02Ig ($35.70 in chips) 
Seat 5: SFmT9ZsVopnukjvAzrxTRg ($56.80 in chips) 
Seat 6: BiLBinPhgpKAYzLgKJVU5A ($21.60 in chips) 
BedjMfrlRfPgSq7CXpPAmg: posts small blind $0.10
Qv4VzEkN09uD11sjKv02Ig: posts big blind $0.25
*** HOLE CARDS ***
SFmT9ZsVopnukjvAzrxTRg: folds 
BiLBinPhgpKAYzLgKJVU5A: folds 
JE/wJXmjw3bpdmjwvh2pcg: folds 
DXgVFTcE3WofABsNJ5G/nw: folds 
BedjMfrlRfPgSq7CXpPAmg: folds 
Uncalled bet ($0.15) returned to Qv4VzEkN09uD11sjKv02Ig
Qv4VzEkN09uD11sjKv02Ig collected $0.20 from pot
*** SUMMARY ***
Total pot $0.20 | Rake $0 
Seat 1: JE/wJXmjw3bpdmjwvh2pcg folded before Flop (didn't bet)
Seat 2: DXgVFTcE3WofABsNJ5G/nw (button) folded before Flop (didn't bet)
Seat 3: BedjMfrlRfPgSq7CXpPAmg (small blind) folded before Flop
Seat 4: Qv4VzEkN09uD11sjKv02Ig (big blind) collected ($0.20)
Seat 5: SFmT9ZsVopnukjvAzrxTRg folded before Flop (didn't bet)
Seat 6: BiLBinPhgpKAYzLgKJVU5A folded before Flop (didn't bet)




PokerStars Game #59939530686:  Hold'em No Limit ($0.10/$0.25) - 2009/07/01 0:42:15 ET
Table 'NtEQAxCeIK2io1CGtW658g' 6-max Seat #1 is the button
Seat 1: lnOV7k25gyN7L5t5YKTgIg ($23 in chips) 
Seat 2: nc79pm0LZRdhncq55evVqA ($25.30 in chips) 
Seat 3: m2yWOKfAxqHoy5DDN87Ttw ($24.65 in chips) 
Seat 4: 8296 ($11.65 in chips) 
Seat 5: FStoHe64SQWqAsjya9pDkQ ($26.20 in chips) 
Seat 6: /gJNBeCkWL4o85/jvlZ4BA ($62.35 in chips) 
nc79pm0LZRdhncq55evVqA: posts small blind $0.10
m2yWOKfAxqHoy5DDN87Ttw: posts big blind $0.25
*** HOLE CARDS ***
8296: folds 
FStoHe64SQWqAsjya9pDkQ: folds 
/gJNBeCkWL4o85/jvlZ4BA: folds 
lnOV7k25gyN7L5t5YKTgIg: folds 
nc79pm0LZRdhncq55evVqA: folds 
Uncalled bet ($0.15) returned to m2yWOKfAxqHoy5DDN87Ttw
m2yWOKfAxqHoy5DDN87Ttw collected $0.20 from pot
m2yWOKfAxqHoy5DDN87Ttw: doesn't show hand 
*** SUMMARY ***
Total pot $0.20 | Rake $0 
Seat 1: lnOV7k25gyN7L5t5YKTgIg (button) folded before Flop (didn't bet)
Seat 2: nc79pm0LZRdhncq55evVqA (small blind) folded before Flop
Seat 3: m2yWOKfAxqHoy5DDN87Ttw (big blind) collected ($0.20)
Seat 4: 8296 folded before Flop (didn't bet)
Seat 5: FStoHe64SQWqAsjya9pDkQ folded before Flop (didn't bet)
Seat 6: /gJNBeCkWL4o85/jvlZ4BA folded before Flop (didn't bet)




PokerStars Game #59939531474:  Hold'em No Limit ($0.10/$0.25) - 2009/07/01 0:42:16 ET
Table 'rhQuIjJo0UQ7RRUlF9umHg' 6-max Seat #2 is the button
Seat 1: 5O3Hj9Qg0SqOyKEXoLpjPg ($54.25 in chips) 
Seat 2: Ew/TYPQIsbQ2X8nm5iAJBg ($52.25 in chips) 
Seat 3: nLE5Yo60EmSlJPyg0GgxXg ($15 in chips) 
Seat 4: buyjetgNT1McXtdaP4zynA ($21.65 in chips) 
Seat 5: 7qRk4YH4/k/08LgJSv7rBQ ($25.95 in chips) 
Seat 6: r284m4NA4rtNktI86R8/Yw ($10.95 in chips) 
nLE5Yo60EmSlJPyg0GgxXg: posts small blind $0.10
buyjetgNT1McXtdaP4zynA: posts big blind $0.25
*** HOLE CARDS ***
7qRk4YH4/k/08LgJSv7rBQ: folds 
r284m4NA4rtNktI86R8/Yw: calls $0.25
5O3Hj9Qg0SqOyKEXoLpjPg: folds 
Ew/TYPQIsbQ2X8nm5iAJBg: folds 
nLE5Yo60EmSlJPyg0GgxXg: calls $0.15
buyjetgNT1McXtdaP4zynA: raises $1 to $1.25
r284m4NA4rtNktI86R8/Yw: folds 
nLE5Yo60EmSlJPyg0GgxXg: calls $1
*** FLOP *** [Qs 9h 5h]
nLE5Yo60EmSlJPyg0GgxXg: checks 
buyjetgNT1McXtdaP4zynA: bets $1.75
nLE5Yo60EmSlJPyg0GgxXg: calls $1.75
*** TURN *** [Qs 9h 5h] [5c]
nLE5Yo60EmSlJPyg0GgxXg: checks 
buyjetgNT1McXtdaP4zynA: checks 
*** RIVER *** [Qs 9h 5h 5c] [Ac]
nLE5Yo60EmSlJPyg0GgxXg: checks 
buyjetgNT1McXtdaP4zynA: checks 
*** SHOW DOWN ***
nLE5Yo60EmSlJPyg0GgxXg: shows [7d 8h] (a pair of Fives)
buyjetgNT1McXtdaP4zynA: shows [Ad Jh] (two pair, Aces and Fives)
buyjetgNT1McXtdaP4zynA collected $5.95 from pot
*** SUMMARY ***
Total pot $6.25 | Rake $0.30 
Board [Qs 9h 5h 5c Ac]
Seat 1: 5O3Hj9Qg0SqOyKEXoLpjPg folded before Flop (didn't bet)
Seat 2: Ew/TYPQIsbQ2X8nm5iAJBg (button) folded before Flop (didn't bet)
Seat 3: nLE5Yo60EmSlJPyg0GgxXg (small blind) showed [7d 8h] and lost with a pair of Fives
Seat 4: buyjetgNT1McXtdaP4zynA (big blind) showed [Ad Jh] and won ($5.95) with two pair, Aces and Fives
Seat 5: 7qRk4YH4/k/08LgJSv7rBQ folded before Flop (didn't bet)
Seat 6: r284m4NA4rtNktI86R8/Yw folded before Flop




PokerStars Game #59939531402:  Hold'em No Limit ($0.10/$0.25) - 2009/07/01 0:42:16 ET
Table 'wPWRBZPJl1HAnysw7qRR0A' 6-max Seat #2 is the button
Seat 1: cPO/1/dTcZpLkQFm3jH3Rg ($49.25 in chips) 
Seat 2: 48oT5xFI+5CHUJlfoGrE4w ($7.70 in chips) 
Seat 3: gqW2aBCmrIw65BvwjTFN6Q ($25 in chips) 
Seat 4: kbpWbC+dJNBphHl1jtw7bw ($25 in chips) 
Seat 5: LtASJ9OlkqGrrUKGQlpGAw ($21.55 in chips) 
Seat 6: VLoE/jniCqHZuUkx8Esf6w ($26.80 in chips) 
gqW2aBCmrIw65BvwjTFN6Q: posts small blind $0.10
kbpWbC+dJNBphHl1jtw7bw: posts big blind $0.25
*** HOLE CARDS ***
LtASJ9OlkqGrrUKGQlpGAw has timed out
LtASJ9OlkqGrrUKGQlpGAw: folds 
LtASJ9OlkqGrrUKGQlpGAw is sitting out
VLoE/jniCqHZuUkx8Esf6w: folds 
LtASJ9OlkqGrrUKGQlpGAw has returned
cPO/1/dTcZpLkQFm3jH3Rg: folds 
48oT5xFI+5CHUJlfoGrE4w: folds 
gqW2aBCmrIw65BvwjTFN6Q: raises $0.50 to $0.75
kbpWbC+dJNBphHl1jtw7bw: calls $0.50
*** FLOP *** [4s 8s 3h]
gqW2aBCmrIw65BvwjTFN6Q: bets $1
kbpWbC+dJNBphHl1jtw7bw: calls $1
*** TURN *** [4s 8s 3h] [Ks]
gqW2aBCmrIw65BvwjTFN6Q: checks 
kbpWbC+dJNBphHl1jtw7bw: bets $2.50
gqW2aBCmrIw65BvwjTFN6Q: folds 
Uncalled bet ($2.50) returned to kbpWbC+dJNBphHl1jtw7bw
kbpWbC+dJNBphHl1jtw7bw collected $3.35 from pot
kbpWbC+dJNBphHl1jtw7bw: doesn't show hand 
*** SUMMARY ***
Total pot $3.50 | Rake $0.15 
Board [4s 8s 3h Ks]
Seat 1: cPO/1/dTcZpLkQFm3jH3Rg folded before Flop (didn't bet)
Seat 2: 48oT5xFI+5CHUJlfoGrE4w (button) folded before Flop (didn't bet)
Seat 3: gqW2aBCmrIw65BvwjTFN6Q (small blind) folded on the Turn
Seat 4: kbpWbC+dJNBphHl1jtw7bw (big blind) collected ($3.35)
Seat 5: LtASJ9OlkqGrrUKGQlpGAw folded before Flop (didn't bet)
Seat 6: VLoE/jniCqHZuUkx8Esf6w folded before Flop (didn't bet)




PokerStars Game #59939531450:  Hold'em No Limit ($0.10/$0.25) - 2009/07/01 0:42:16 ET
Table 'MJ1SB76A4qJrlEa+C5e/8w' 6-max Seat #6 is the button
Seat 2: UA5OsKS3VPaxa7uC8La/kA ($29 in chips) 
Seat 3: IrrSNlaIjHnZjG6E7LgmEg ($14.15 in chips) 
Seat 4: 6boOPJDTFiEyZD2WdW0kCA ($15.40 in chips) 
Seat 5: eHsmIvAb2JREg4O6hNPnXg ($7.90 in chips) 
Seat 6: JFIAqU8lCZ0vWwEl4bdGsg ($27.40 in chips) 
UA5OsKS3VPaxa7uC8La/kA: posts small blind $0.10
IrrSNlaIjHnZjG6E7LgmEg: posts big blind $0.25
*** HOLE CARDS ***
6boOPJDTFiEyZD2WdW0kCA: folds 
eHsmIvAb2JREg4O6hNPnXg: folds 
JFIAqU8lCZ0vWwEl4bdGsg: folds 
UA5OsKS3VPaxa7uC8La/kA: folds 
Uncalled bet ($0.15) returned to IrrSNlaIjHnZjG6E7LgmEg
IrrSNlaIjHnZjG6E7LgmEg collected $0.20 from pot
IrrSNlaIjHnZjG6E7LgmEg: doesn't show hand 
*** SUMMARY ***
Total pot $0.20 | Rake $0 
Seat 2: UA5OsKS3VPaxa7uC8La/kA (small blind) folded before Flop
Seat 3: IrrSNlaIjHnZjG6E7LgmEg (big blind) collected ($0.20)
Seat 4: 6boOPJDTFiEyZD2WdW0kCA folded before Flop (didn't bet)
Seat 5: eHsmIvAb2JREg4O6hNPnXg folded before Flop (didn't bet)
Seat 6: JFIAqU8lCZ0vWwEl4bdGsg (button) folded before Flop (didn't bet)




PokerStars Game #59939531642:  Hold'em No Limit ($0.10/$0.25) - 2009/07/01 0:42:16 ET
Table '8QBBaev+cI2i/r2H6ml/lg' 9-max Seat #4 is the button
Seat 4: ZoG0obuajzVjwgd7lNHjgg ($1.40 in chips) 
Seat 6: cxE+szmvEUe7vE+z2ozM2Q ($11 in chips) 
Seat 9: Ml2bY77EHbM51ZWD7dnIWg ($2.95 in chips) 
cxE+szmvEUe7vE+z2ozM2Q: posts small blind $0.10
Ml2bY77EHbM51ZWD7dnIWg: posts big blind $0.25
*** HOLE CARDS ***
ZoG0obuajzVjwgd7lNHjgg: folds 
cxE+szmvEUe7vE+z2ozM2Q: folds 
Uncalled bet ($0.15) returned to Ml2bY77EHbM51ZWD7dnIWg
Ml2bY77EHbM51ZWD7dnIWg collected $0.20 from pot
*** SUMMARY ***
Total pot $0.20 | Rake $0 
Seat 4: ZoG0obuajzVjwgd7lNHjgg (button) folded before Flop (didn't bet)
Seat 6: cxE+szmvEUe7vE+z2ozM2Q (small blind) folded before Flop
Seat 9: Ml2bY77EHbM51ZWD7dnIWg (big blind) collected ($0.20)




PokerStars Game #59939531746:  Hold'em No Limit ($0.10/$0.25) - 2009/07/01 0:42:16 ET
Table 'ORSZkZqq+7Ja2PdeCFAytA' 9-max Seat #2 is the button
Seat 1: Gpa8cld5y0mdOomHJgHhlA ($7.50 in chips) 
Seat 2: yduPKWPzL8YlT5Zv/Nmrwg ($11.80 in chips) 
Seat 5: fOv1xoqR8m9slwElVu7Y+A ($14.75 in chips) 
fOv1xoqR8m9slwElVu7Y+A: posts small blind $0.10
Gpa8cld5y0mdOomHJgHhlA: posts big blind $0.25
*** HOLE CARDS ***
yduPKWPzL8YlT5Zv/Nmrwg: raises $11.55 to $11.80 and is all-in
fOv1xoqR8m9slwElVu7Y+A: folds 
Gpa8cld5y0mdOomHJgHhlA: folds 
Uncalled bet ($11.55) returned to yduPKWPzL8YlT5Zv/Nmrwg
yduPKWPzL8YlT5Zv/Nmrwg collected $0.60 from pot
*** SUMMARY ***
Total pot $0.60 | Rake $0 
Seat 1: Gpa8cld5y0mdOomHJgHhlA (big blind) folded before Flop
Seat 2: yduPKWPzL8YlT5Zv/Nmrwg (button) collected ($0.60)
Seat 5: fOv1xoqR8m9slwElVu7Y+A (small blind) folded before Flop




PokerStars Game #59939531576:  Hold'em No Limit ($0.10/$0.25) - 2009/07/01 0:42:16 ET
Table '4mnXP0EWt9mMZYzTIVDQ0w' 9-max Seat #9 is the button
Seat 1: PTFwg4rGxnfVvj2iP1OI2w ($13.85 in chips) 
Seat 2: j4q3p0lesp63b1gZDwLBZw ($6.50 in chips) 
Seat 4: E0iYnEVO2ho7dH3QcCjw7g ($20.45 in chips) 
Seat 5: sSN8Y0AlsBeidZXPKmwXSw ($13.25 in chips) 
Seat 7: s1y+qfkBnhgc67+X3ThjeA ($27.20 in chips) 
Seat 8: H9KUl8cmpLgEpOVDA00bCg ($4.30 in chips) 
Seat 9: wbCayoP+N6xpKgOfIqZsbA ($21.85 in chips) 
PTFwg4rGxnfVvj2iP1OI2w: posts small blind $0.10
j4q3p0lesp63b1gZDwLBZw: posts big blind $0.25
*** HOLE CARDS ***
n9toqYXSLowQ/sWq842dEQ has returned
E0iYnEVO2ho7dH3QcCjw7g: folds 
sSN8Y0AlsBeidZXPKmwXSw: folds 
s1y+qfkBnhgc67+X3ThjeA: folds 
H9KUl8cmpLgEpOVDA00bCg: folds 
wbCayoP+N6xpKgOfIqZsbA: folds 
PTFwg4rGxnfVvj2iP1OI2w: folds 
Uncalled bet ($0.15) returned to j4q3p0lesp63b1gZDwLBZw
j4q3p0lesp63b1gZDwLBZw collected $0.20 from pot
j4q3p0lesp63b1gZDwLBZw: doesn't show hand 
*** SUMMARY ***
Total pot $0.20 | Rake $0 
Seat 1: PTFwg4rGxnfVvj2iP1OI2w (small blind) folded before Flop
Seat 2: j4q3p0lesp63b1gZDwLBZw (big blind) collected ($0.20)
Seat 4: E0iYnEVO2ho7dH3QcCjw7g folded before Flop (didn't bet)
Seat 5: sSN8Y0AlsBeidZXPKmwXSw folded before Flop (didn't bet)
Seat 7: s1y+qfkBnhgc67+X3ThjeA folded before Flop (didn't bet)
Seat 8: H9KUl8cmpLgEpOVDA00bCg folded before Flop (didn't bet)
Seat 9: wbCayoP+N6xpKgOfIqZsbA (button) folded before Flop (didn't bet)




PokerStars Game #59939531672:  Hold'em No Limit ($0.10/$0.25) - 2009/07/01 0:42:16 ET
Table 'yAHDCs33TIgw3ra63xuU2Q' 9-max Seat #2 is the button
Seat 1: 8B/dhbQjIWe6ASCdgzktNQ ($26.40 in chips) 
Seat 2: LBrhQVB4w41YNd7kMYn/og ($19.80 in chips) 
Seat 3: H9KUl8cmpLgEpOVDA00bCg ($5 in chips) 
Seat 4: rUdM7gwmNCaxMNSb2CFPhQ ($11 in chips) 
Seat 5: 4awUyiDYTgylQKXZ9faBVA ($25 in chips) 
Seat 7: OiV1PWZ3IkN29JlmCcnTwQ ($4.90 in chips) 
Seat 8: tYsOBqdU1+x+yFI7zHO7hQ ($28.70 in chips) 
Seat 9: k+ydNCnnP3Hgwh0AnDYVrA ($13.50 in chips) 
H9KUl8cmpLgEpOVDA00bCg: posts small blind $0.10
rUdM7gwmNCaxMNSb2CFPhQ: posts big blind $0.25
Z5ZtGOON8kmSdSCll9Z3XA: sits out 
*** HOLE CARDS ***
4awUyiDYTgylQKXZ9faBVA: folds 
OiV1PWZ3IkN29JlmCcnTwQ: folds 
tYsOBqdU1+x+yFI7zHO7hQ: folds 
k+ydNCnnP3Hgwh0AnDYVrA: folds 
8B/dhbQjIWe6ASCdgzktNQ: folds 
LBrhQVB4w41YNd7kMYn/og: raises $0.50 to $0.75
H9KUl8cmpLgEpOVDA00bCg: folds 
rUdM7gwmNCaxMNSb2CFPhQ: folds 
Uncalled bet ($0.50) returned to LBrhQVB4w41YNd7kMYn/og
LBrhQVB4w41YNd7kMYn/og collected $0.60 from pot
LBrhQVB4w41YNd7kMYn/og: doesn't show hand 
*** SUMMARY ***
Total pot $0.60 | Rake $0 
Seat 1: 8B/dhbQjIWe6ASCdgzktNQ folded before Flop (didn't bet)
Seat 2: LBrhQVB4w41YNd7kMYn/og (button) collected ($0.60)
Seat 3: H9KUl8cmpLgEpOVDA00bCg (small blind) folded before Flop
Seat 4: rUdM7gwmNCaxMNSb2CFPhQ (big blind) folded before Flop
Seat 5: 4awUyiDYTgylQKXZ9faBVA folded before Flop (didn't bet)
Seat 7: OiV1PWZ3IkN29JlmCcnTwQ folded before Flop (didn't bet)
Seat 8: tYsOBqdU1+x+yFI7zHO7hQ folded before Flop (didn't bet)
Seat 9: k+ydNCnnP3Hgwh0AnDYVrA folded before Flop (didn't bet)




PokerStars Game #59939531890:  Hold'em No Limit ($0.10/$0.25) - 2009/07/01 0:42:16 ET
Table 'KKcpZYT1qeSWLmZFp9A4KA' 9-max Seat #3 is the button
Seat 3: j4q3p0lesp63b1gZDwLBZw ($5.25 in chips) 
Seat 7: QEbIGci+itdw+re8RM5fZA ($25 in chips) 
j4q3p0lesp63b1gZDwLBZw: posts small blind $0.10
Z3a37Ry74FVl+CBZtAONiA: is sitting out 
Z3a37Ry74FVl+CBZtAONiA leaves the table
4awUyiDYTgylQKXZ9faBVA: is sitting out 
4awUyiDYTgylQKXZ9faBVA leaves the table
QEbIGci+itdw+re8RM5fZA: posts big blind $0.25
*** HOLE CARDS ***
j4q3p0lesp63b1gZDwLBZw: folds 
Uncalled bet ($0.15) returned to QEbIGci+itdw+re8RM5fZA
j4q3p0lesp63b1gZDwLBZw leaves the table
QEbIGci+itdw+re8RM5fZA collected $0.20 from pot
QEbIGci+itdw+re8RM5fZA: doesn't show hand 
*** SUMMARY ***
Total pot $0.20 | Rake $0 
Seat 3: j4q3p0lesp63b1gZDwLBZw (button) (small blind) folded before Flop
Seat 7: QEbIGci+itdw+re8RM5fZA (big blind) collected ($0.20)




PokerStars Game #59939531470:  Hold'em No Limit ($0.10/$0.25) - 2009/07/01 0:42:16 ET
Table '/asc7VQ/OpF/oVJ3erB80w' 9-max Seat #1 is the button
Seat 1: OiV1PWZ3IkN29JlmCcnTwQ ($4.90 in chips) 
Seat 2: Th3FldXKQW6hWVVPahaoOQ ($25.55 in chips) 
Seat 3: ie4EwTMMFYxrCXcenJdzsw ($6.80 in chips) 
Seat 4: H9KUl8cmpLgEpOVDA00bCg ($5.25 in chips) 
Seat 5: 8B/dhbQjIWe6ASCdgzktNQ ($25.25 in chips) 
Seat 6: t2nb95S5EEFOEzNx9Itz0g ($3.10 in chips) 
Seat 7: M2QO2DxB5Wawg2h8HSpnYA ($12 in chips) 
Seat 8: T5Hk9oiIr+JDDMnEqwFCrw ($5.55 in chips) 
Seat 9: UkJraTKWQIqFeHOyHQ7afQ ($15.05 in chips) 
Th3FldXKQW6hWVVPahaoOQ: posts small blind $0.10
ie4EwTMMFYxrCXcenJdzsw: posts big blind $0.25
*** HOLE CARDS ***
H9KUl8cmpLgEpOVDA00bCg: folds 
8B/dhbQjIWe6ASCdgzktNQ: folds 
t2nb95S5EEFOEzNx9Itz0g: folds 
M2QO2DxB5Wawg2h8HSpnYA: folds 
T5Hk9oiIr+JDDMnEqwFCrw: folds 
UkJraTKWQIqFeHOyHQ7afQ: calls $0.25
OiV1PWZ3IkN29JlmCcnTwQ: folds 
Th3FldXKQW6hWVVPahaoOQ: folds 
ie4EwTMMFYxrCXcenJdzsw: checks 
*** FLOP *** [4s 9c Jh]
ie4EwTMMFYxrCXcenJdzsw: checks 
UkJraTKWQIqFeHOyHQ7afQ: checks 
*** TURN *** [4s 9c Jh] [2s]
ie4EwTMMFYxrCXcenJdzsw: checks 
UkJraTKWQIqFeHOyHQ7afQ: checks 
*** RIVER *** [4s 9c Jh 2s] [5c]
ie4EwTMMFYxrCXcenJdzsw: checks 
UkJraTKWQIqFeHOyHQ7afQ: checks 
*** SHOW DOWN ***
ie4EwTMMFYxrCXcenJdzsw: shows [3c Ts] (high card Jack)
UkJraTKWQIqFeHOyHQ7afQ: shows [Qs Kh] (high card King)
UkJraTKWQIqFeHOyHQ7afQ collected $0.60 from pot
*** SUMMARY ***
Total pot $0.60 | Rake $0 
Board [4s 9c Jh 2s 5c]
Seat 1: OiV1PWZ3IkN29JlmCcnTwQ (button) folded before Flop (didn't bet)
Seat 2: Th3FldXKQW6hWVVPahaoOQ (small blind) folded before Flop
Seat 3: ie4EwTMMFYxrCXcenJdzsw (big blind) showed [3c Ts] and lost with high card Jack
Seat 4: H9KUl8cmpLgEpOVDA00bCg folded before Flop (didn't bet)
Seat 5: 8B/dhbQjIWe6ASCdgzktNQ folded before Flop (didn't bet)
Seat 6: t2nb95S5EEFOEzNx9Itz0g folded before Flop (didn't bet)
Seat 7: M2QO2DxB5Wawg2h8HSpnYA folded before Flop (didn't bet)
Seat 8: T5Hk9oiIr+JDDMnEqwFCrw folded before Flop (didn't bet)
Seat 9: UkJraTKWQIqFeHOyHQ7afQ showed [Qs Kh] and won ($0.60) with high card King




PokerStars Game #59939531376:  Hold'em No Limit ($0.10/$0.25) - 2009/07/01 0:42:16 ET
Table '6wawJ+MkkvuC3coG6r+YhgZiwAqg4o02gNro+JOAaFNgSeat #5 is the button
Seat 1: j4q3p0lesp63b1gZDwLBZw ($5.60 in chips) 
Seat 2: tYsOBqdU1+x+yFI7zHO7hQ ($31.10 in chips) 
Seat 3: aNpwfA31EREwO+ar4XzBCw ($25 in chips) 
Seat 4: FJflwqC6fqOpM3j0q8Bptw ($22.20 in chips) 
Seat 5: 5hAPbqNrvJb8PtLiceXtlg6HoFYfVGBefsR5Vrz62qIw5 in chips) 
Seat 6: hBMUlEpyU74r/fwDgIpXjQ ($27.70 in chips) 
Seat 7: opOCI2p6kW0tINuVaAqmcQ ($25 in chips) 
Seat 8: CYkY0dNBaYaKs8HVCVn3mQ ($5.35 in chips) 
Seat 9: ljemhp25Zg+nlA9DLCIiUw ($24.65 in chips) 
hBMUlEpyU74r/fwDgIpXjQ: posts small blind $0.10
opOCI2p6kW0tINuVaAqmcQ: posts big blind $0.25
*** HOLE CARDS ***
CYkY0dNBaYaKs8HVCVn3mQ: folds 
ljemhp25Zg+nlA9DLCIiUw: folds 
j4q3p0lesp63b1gZDwLBZw: folds 
tYsOBqdU1+x+yFI7zHO7hQ: folds 
aNpwfA31EREwO+ar4XzBCw: folds 
FJflwqC6fqOpM3j0q8Bptw: folds 
5hAPbqNrvJb8PtLiceXtlg6HoFYfVGBefsR5Vrz62qIwlds 
hBMUlEpyU74r/fwDgIpXjQ: folds 
Uncalled bet ($0.15) returned to opOCI2p6kW0tINuVaAqmcQ
opOCI2p6kW0tINuVaAqmcQ collected $0.20 from pot
opOCI2p6kW0tINuVaAqmcQ: doesn't show hand 
*** SUMMARY ***
Total pot $0.20 | Rake $0 
Seat 1: j4q3p0lesp63b1gZDwLBZw folded before Flop (didn't bet)
Seat 2: tYsOBqdU1+x+yFI7zHO7hQ folded before Flop (didn't bet)
Seat 3: aNpwfA31EREwO+ar4XzBCw folded before Flop (didn't bet)
Seat 4: FJflwqC6fqOpM3j0q8Bptw folded before Flop (didn't bet)
Seat 5: 5hAPbqNrvJb8PtLiceXtlg6HoFYfVGBefsR5Vrz62qIwtton) folded before Flop (didn't bet)
Seat 6: hBMUlEpyU74r/fwDgIpXjQ (small blind) folded before Flop
Seat 7: opOCI2p6kW0tINuVaAqmcQ (big blind) collected ($0.20)
Seat 8: CYkY0dNBaYaKs8HVCVn3mQ folded before Flop (didn't bet)
Seat 9: ljemhp25Zg+nlA9DLCIiUw folded before Flop (didn't bet)




PokerStars Game #59939531674:  Hold'em No Limit ($0.10/$0.25) - 2009/07/01 0:42:16 ET
Table 'tANpk8z1C5o0Pq/hpYShHw' 9-max Seat #9 is the button
Seat 1: rQhYIYXSyH/IivYM1dlV5A ($11.75 in chips) 
Seat 2: og4yH4sZUZdC8jjgW8zPJQ ($10.65 in chips) 
Seat 3: zDrucyjVn5aeekNEc3cJrA ($21.25 in chips) 
Seat 4: dmQRblfPJL8cP867vJRZkg ($5.75 in chips) 
Seat 5: kWxV1qKcmWEussgWafGYNA ($40.60 in chips) 
Seat 6: Vp8EaqUO6YyqsnwsLR8SNQ ($11.25 in chips) 
Seat 7: sv2dZaqHRlfCDrW63Guhvg ($10.40 in chips) 
Seat 8: sPhk0wImgnCyx4aYrPXnHA ($24.40 in chips) 
Seat 9: gE5rN2TDY1aXcZn/TOPeZw ($13.55 in chips) 
rQhYIYXSyH/IivYM1dlV5A: posts small blind $0.10
og4yH4sZUZdC8jjgW8zPJQ: posts big blind $0.25
*** HOLE CARDS ***
zDrucyjVn5aeekNEc3cJrA: folds 
dmQRblfPJL8cP867vJRZkg: folds 
kWxV1qKcmWEussgWafGYNA: folds 
Vp8EaqUO6YyqsnwsLR8SNQ: raises $0.50 to $0.75
sv2dZaqHRlfCDrW63Guhvg: folds 
sPhk0wImgnCyx4aYrPXnHA: raises $0.75 to $1.50
gE5rN2TDY1aXcZn/TOPeZw: folds 
rQhYIYXSyH/IivYM1dlV5A: folds 
og4yH4sZUZdC8jjgW8zPJQ: folds 
Vp8EaqUO6YyqsnwsLR8SNQ: calls $0.75
*** FLOP *** [3c 5h 3s]
Vp8EaqUO6YyqsnwsLR8SNQ: checks 
sPhk0wImgnCyx4aYrPXnHA: bets $3.50
Vp8EaqUO6YyqsnwsLR8SNQ: folds 
Uncalled bet ($3.50) returned to sPhk0wImgnCyx4aYrPXnHA
sPhk0wImgnCyx4aYrPXnHA collected $3.20 from pot
sPhk0wImgnCyx4aYrPXnHA: doesn't show hand 
*** SUMMARY ***
Total pot $3.35 | Rake $0.15 
Board [3c 5h 3s]
Seat 1: rQhYIYXSyH/IivYM1dlV5A (small blind) folded before Flop
Seat 2: og4yH4sZUZdC8jjgW8zPJQ (big blind) folded before Flop
Seat 3: zDrucyjVn5aeekNEc3cJrA folded before Flop (didn't bet)
Seat 4: dmQRblfPJL8cP867vJRZkg folded before Flop (didn't bet)
Seat 5: kWxV1qKcmWEussgWafGYNA folded before Flop (didn't bet)
Seat 6: Vp8EaqUO6YyqsnwsLR8SNQ folded on the Flop
Seat 7: sv2dZaqHRlfCDrW63Guhvg folded before Flop (didn't bet)
Seat 8: sPhk0wImgnCyx4aYrPXnHA collected ($3.20)
Seat 9: gE5rN2TDY1aXcZn/TOPeZw (button) folded before Flop (didn't bet)




PokerStars Game #59939532088:  Hold'em No Limit ($0.10/$0.25) - 2009/07/01 0:42:17 ET
Table 'wixGE3Zge1qBdnpWijIl/w' 9-max Seat #6 is the button
Seat 1: EcWpc/mcsCWBGKsSdZaXbA ($24.65 in chips) 
Seat 2: vbD+Kd6m/X3hUBBcGpUKjA ($7.85 in chips) 
Seat 3: DdPXdieucQ+n99u1n3A+rQ ($4.65 in chips) 
Seat 4: 4oA316mXLIui1QY63GXBUg ($25 in chips) 
Seat 5: MIVCHqCqqlke0Lb0z7glcw ($32 in chips) 
Seat 6: TlEYI/zXzaKGGsmuvWFd2A ($11.45 in chips) 
Seat 7: qIaaweMCAGmy9HZFT4r/6A ($54.65 in chips) 
Seat 8: hIss79a4pu7GzJZepfgOpg ($25 in chips) 
Seat 9: r6hsffOo1iKmaPYKwAZmFw ($25.75 in chips) 
qIaaweMCAGmy9HZFT4r/6A: posts small blind $0.10
hIss79a4pu7GzJZepfgOpg: posts big blind $0.25
*** HOLE CARDS ***
r6hsffOo1iKmaPYKwAZmFw: folds 
EcWpc/mcsCWBGKsSdZaXbA: folds 
vbD+Kd6m/X3hUBBcGpUKjA: folds 
DdPXdieucQ+n99u1n3A+rQ: folds 
4oA316mXLIui1QY63GXBUg: folds 
MIVCHqCqqlke0Lb0z7glcw: folds 
TlEYI/zXzaKGGsmuvWFd2A: raises $0.50 to $0.75
qIaaweMCAGmy9HZFT4r/6A: calls $0.65
hIss79a4pu7GzJZepfgOpg: folds 
*** FLOP *** [7d 8d 9c]
qIaaweMCAGmy9HZFT4r/6A: bets $1
TlEYI/zXzaKGGsmuvWFd2A: calls $1
*** TURN *** [7d 8d 9c] [Qh]
qIaaweMCAGmy9HZFT4r/6A: bets $1
TlEYI/zXzaKGGsmuvWFd2A: calls $1
*** RIVER *** [7d 8d 9c Qh] [8c]
qIaaweMCAGmy9HZFT4r/6A: bets $2
TlEYI/zXzaKGGsmuvWFd2A: calls $2
*** SHOW DOWN ***
qIaaweMCAGmy9HZFT4r/6A: shows [3s 9s] (two pair, Nines and Eights)
TlEYI/zXzaKGGsmuvWFd2A: mucks hand 
qIaaweMCAGmy9HZFT4r/6A collected $9.30 from pot
*** SUMMARY ***
Total pot $9.75 | Rake $0.45 
Board [7d 8d 9c Qh 8c]
Seat 1: EcWpc/mcsCWBGKsSdZaXbA folded before Flop (didn't bet)
Seat 2: vbD+Kd6m/X3hUBBcGpUKjA folded before Flop (didn't bet)
Seat 3: DdPXdieucQ+n99u1n3A+rQ folded before Flop (didn't bet)
Seat 4: 4oA316mXLIui1QY63GXBUg folded before Flop (didn't bet)
Seat 5: MIVCHqCqqlke0Lb0z7glcw folded before Flop (didn't bet)
Seat 6: TlEYI/zXzaKGGsmuvWFd2A (button) mucked
Seat 7: qIaaweMCAGmy9HZFT4r/6A (small blind) showed [3s 9s] and won ($9.30) with two pair, Nines and Eights
Seat 8: hIss79a4pu7GzJZepfgOpg (big blind) folded before Flop
Seat 9: r6hsffOo1iKmaPYKwAZmFw folded before Flop (didn't bet)




PokerStars Game #59939532476:  Hold'em No Limit ($0.10/$0.25) - 2009/07/01 0:42:17 ET
Table 'FBhJjLqab11/gKu8nyB/tw' 9-max Seat #7 is the button
Seat 1: +sbyWwIcFp9kP0bDtMegfQ ($21.80 in chips) 
Seat 2: 1pwQJV/Xr0GWPRefx/78VQ ($2.05 in chips) 
Seat 3: uy9x0X5l7O+IpGjLa77QgQ ($26.90 in chips) 
Seat 4: OTC1Bh+DhK778Qnsj6D8+A ($24.50 in chips) 
Seat 5: vZGoOTJLQLhkPj4I+LNGig ($45.75 in chips) 
Seat 6: QrNgXJWFdS+POsPJcil4aA ($19.50 in chips) 
Seat 7: 5Fj9JGGxQT7Djr6AyIiBVA ($24.90 in chips) 
Seat 8: 9lE3Zc4pjmKpQK8rDF1aaQ ($20.30 in chips) 
Seat 9: BEIBUu2pIflPrCL+Iks4CQ ($12.15 in chips) 
9lE3Zc4pjmKpQK8rDF1aaQ: posts small blind $0.10
BEIBUu2pIflPrCL+Iks4CQ: posts big blind $0.25
*** HOLE CARDS ***
+sbyWwIcFp9kP0bDtMegfQ: raises $0.75 to $1
1pwQJV/Xr0GWPRefx/78VQ: calls $1
uy9x0X5l7O+IpGjLa77QgQ: folds 
OTC1Bh+DhK778Qnsj6D8+A: folds 
vZGoOTJLQLhkPj4I+LNGig: folds 
QrNgXJWFdS+POsPJcil4aA: folds 
5Fj9JGGxQT7Djr6AyIiBVA: calls $1
9lE3Zc4pjmKpQK8rDF1aaQ: calls $0.90
BEIBUu2pIflPrCL+Iks4CQ: folds 
*** FLOP *** [5d 2c Jc]
9lE3Zc4pjmKpQK8rDF1aaQ: checks 
+sbyWwIcFp9kP0bDtMegfQ: bets $2.50
1pwQJV/Xr0GWPRefx/78VQ: calls $1.05 and is all-in
5Fj9JGGxQT7Djr6AyIiBVA: folds 
5Fj9JGGxQT7Djr6AyIiBVA is sitting out
9lE3Zc4pjmKpQK8rDF1aaQ: folds 
Uncalled bet ($1.45) returned to +sbyWwIcFp9kP0bDtMegfQ
*** TURN *** [5d 2c Jc] [3d]
*** RIVER *** [5d 2c Jc 3d] [Qh]
*** SHOW DOWN ***
+sbyWwIcFp9kP0bDtMegfQ: shows [Kh As] (high card Ace)
1pwQJV/Xr0GWPRefx/78VQ: shows [5h Ah] (a pair of Fives)
5Fj9JGGxQT7Djr6AyIiBVA has returned
1pwQJV/Xr0GWPRefx/78VQ collected $6.05 from pot
*** SUMMARY ***
Total pot $6.35 | Rake $0.30 
Board [5d 2c Jc 3d Qh]
Seat 1: +sbyWwIcFp9kP0bDtMegfQ showed [Kh As] and lost with high card Ace
Seat 2: 1pwQJV/Xr0GWPRefx/78VQ showed [5h Ah] and won ($6.05) with a pair of Fives
Seat 3: uy9x0X5l7O+IpGjLa77QgQ folded before Flop (didn't bet)
Seat 4: OTC1Bh+DhK778Qnsj6D8+A folded before Flop (didn't bet)
Seat 5: vZGoOTJLQLhkPj4I+LNGig folded before Flop (didn't bet)
Seat 6: QrNgXJWFdS+POsPJcil4aA folded before Flop (didn't bet)
Seat 7: 5Fj9JGGxQT7Djr6AyIiBVA (button) folded on the Flop
Seat 8: 9lE3Zc4pjmKpQK8rDF1aaQ (small blind) folded on the Flop
Seat 9: BEIBUu2pIflPrCL+Iks4CQ (big blind) folded before Flop




PokerStars Game #59939532024:  Hold'em No Limit ($0.10/$0.25) - 2009/07/01 0:42:17 ET
Table 'bIGKmJgZehWJ+FAo8b85iw' 9-max Seat #1 is the button
Seat 1: yyG4svzOpC1A+sUP/scg6w ($8.85 in chips) 
Seat 2: Ut3g/kEEdCCbe/gbWrHnDg ($18.50 in chips) 
Seat 3: TeWJxSETzbXGiYKx0y+dtg ($36.40 in chips) 
Seat 4: EJRVVUAJEYLdm1qbO8TzuQ ($10.55 in chips) 
Seat 5: 7wo6Sr7QG3Zo6BaBDV1BOw ($7.15 in chips) 
Seat 6: H5Se03ZqSX7tbULXur2MAg ($21.95 in chips) 
Seat 7: DdPXdieucQ+n99u1n3A+rQ ($11.45 in chips) 
Seat 8: +2kMBNpY4nF1qNCRd8SJLA ($25 in chips) 
Seat 9: aNpwfA31EREwO+ar4XzBCw ($25 in chips) 
Ut3g/kEEdCCbe/gbWrHnDg: posts small blind $0.10
TeWJxSETzbXGiYKx0y+dtg: posts big blind $0.25
*** HOLE CARDS ***
EJRVVUAJEYLdm1qbO8TzuQ: folds 
7wo6Sr7QG3Zo6BaBDV1BOw: calls $0.25
H5Se03ZqSX7tbULXur2MAg: calls $0.25
DdPXdieucQ+n99u1n3A+rQ: folds 
+2kMBNpY4nF1qNCRd8SJLA: folds 
aNpwfA31EREwO+ar4XzBCw: folds 
yyG4svzOpC1A+sUP/scg6w: folds 
Ut3g/kEEdCCbe/gbWrHnDg: calls $0.15
TeWJxSETzbXGiYKx0y+dtg: checks 
*** FLOP *** [3s Ac 4h]
Ut3g/kEEdCCbe/gbWrHnDg: checks 
TeWJxSETzbXGiYKx0y+dtg: checks 
7wo6Sr7QG3Zo6BaBDV1BOw: checks 
H5Se03ZqSX7tbULXur2MAg: checks 
*** TURN *** [3s Ac 4h] [6h]
Ut3g/kEEdCCbe/gbWrHnDg: checks 
TeWJxSETzbXGiYKx0y+dtg: checks 
7wo6Sr7QG3Zo6BaBDV1BOw: checks 
H5Se03ZqSX7tbULXur2MAg: checks 
*** RIVER *** [3s Ac 4h 6h] [Js]
Ut3g/kEEdCCbe/gbWrHnDg: checks 
TeWJxSETzbXGiYKx0y+dtg: checks 
7wo6Sr7QG3Zo6BaBDV1BOw: bets $0.75
H5Se03ZqSX7tbULXur2MAg: folds 
Ut3g/kEEdCCbe/gbWrHnDg: folds 
TeWJxSETzbXGiYKx0y+dtg: folds 
Uncalled bet ($0.75) returned to 7wo6Sr7QG3Zo6BaBDV1BOw
7wo6Sr7QG3Zo6BaBDV1BOw collected $0.95 from pot
7wo6Sr7QG3Zo6BaBDV1BOw: doesn't show hand 
*** SUMMARY ***
Total pot $1 | Rake $0.05 
Board [3s Ac 4h 6h Js]
Seat 1: yyG4svzOpC1A+sUP/scg6w (button) folded before Flop (didn't bet)
Seat 2: Ut3g/kEEdCCbe/gbWrHnDg (small blind) folded on the River
Seat 3: TeWJxSETzbXGiYKx0y+dtg (big blind) folded on the River
Seat 4: EJRVVUAJEYLdm1qbO8TzuQ folded before Flop (didn't bet)
Seat 5: 7wo6Sr7QG3Zo6BaBDV1BOw collected ($0.95)
Seat 6: H5Se03ZqSX7tbULXur2MAg folded on the River
Seat 7: DdPXdieucQ+n99u1n3A+rQ folded before Flop (didn't bet)
Seat 8: +2kMBNpY4nF1qNCRd8SJLA folded before Flop (didn't bet)
Seat 9: aNpwfA31EREwO+ar4XzBCw folded before Flop (didn't bet)




PokerStars Game #59939532180:  Hold'em No Limit ($0.10/$0.25) - 2009/07/01 0:42:17 ET
Table '4hfTdIVT/qPsJNfWXLsVIw' 9-max Seat #7 is the button
Seat 1: GbHFBbLqLGz0Pwn6CJeAuw ($23.95 in chips) 
Seat 2: NB5rKy+grn9jKcWXclZ7WA ($32.90 in chips) 
Seat 3: opOCI2p6kW0tINuVaAqmcQ ($26.80 in chips) 
Seat 4: OiV1PWZ3IkN29JlmCcnTwQ ($5.15 in chips) 
Seat 5: wtz6Fi0Zt+cIsTeTHf5zJQ ($5 in chips) 
Seat 6: VWUWpMLMj/Q1jRVpF7Aohw ($9.40 in chips) 
Seat 7: z5GxcHlYz/GSz6W2uFiTtg ($31.75 in chips) 
Seat 9: K5byIbXY6S+c1wAeHitZow ($12.40 in chips) 
K5byIbXY6S+c1wAeHitZow: posts small blind $0.10
GbHFBbLqLGz0Pwn6CJeAuw: posts big blind $0.25
*** HOLE CARDS ***
NB5rKy+grn9jKcWXclZ7WA: folds 
opOCI2p6kW0tINuVaAqmcQ: raises $0.50 to $0.75
OiV1PWZ3IkN29JlmCcnTwQ: folds 
wtz6Fi0Zt+cIsTeTHf5zJQ: folds 
VWUWpMLMj/Q1jRVpF7Aohw: folds 
z5GxcHlYz/GSz6W2uFiTtg: folds 
K5byIbXY6S+c1wAeHitZow: folds 
GbHFBbLqLGz0Pwn6CJeAuw: calls $0.50
*** FLOP *** [Kc 4d 7c]
GbHFBbLqLGz0Pwn6CJeAuw: bets $0.50
jiyia7h6fmxBdWBkH9lH5A joins the table at seat #8 
opOCI2p6kW0tINuVaAqmcQ: folds 
Uncalled bet ($0.50) returned to GbHFBbLqLGz0Pwn6CJeAuw
GbHFBbLqLGz0Pwn6CJeAuw collected $1.55 from pot
GbHFBbLqLGz0Pwn6CJeAuw: doesn't show hand 
*** SUMMARY ***
Total pot $1.60 | Rake $0.05 
Board [Kc 4d 7c]
Seat 1: GbHFBbLqLGz0Pwn6CJeAuw (big blind) collected ($1.55)
Seat 2: NB5rKy+grn9jKcWXclZ7WA folded before Flop (didn't bet)
Seat 3: opOCI2p6kW0tINuVaAqmcQ folded on the Flop
Seat 4: OiV1PWZ3IkN29JlmCcnTwQ folded before Flop (didn't bet)
Seat 5: wtz6Fi0Zt+cIsTeTHf5zJQ folded before Flop (didn't bet)
Seat 6: VWUWpMLMj/Q1jRVpF7Aohw folded before Flop (didn't bet)
Seat 7: z5GxcHlYz/GSz6W2uFiTtg (button) folded before Flop (didn't bet)
Seat 9: K5byIbXY6S+c1wAeHitZow (small blind) folded before Flop




PokerStars Game #59939532282:  Hold'em No Limit ($0.10/$0.25) - 2009/07/01 0:42:17 ET
Table 'luMgmRPIo47e7iXDlheIwA' 6-max Seat #4 is the button
Seat 1: z/jAqpWD9ifpbtEpwGyInw ($4.95 in chips) 
Seat 3: W6Y6au0wf7gRAlqJYgOezw ($14.95 in chips) 
Seat 4: n2OZezRXTtdzQt4SuIy8TQ ($25.80 in chips) 
z/jAqpWD9ifpbtEpwGyInw: posts small blind $0.10
W6Y6au0wf7gRAlqJYgOezw: posts big blind $0.25
*** HOLE CARDS ***
n2OZezRXTtdzQt4SuIy8TQ: folds 
z/jAqpWD9ifpbtEpwGyInw: raises $0.50 to $0.75
W6Y6au0wf7gRAlqJYgOezw: calls $0.50
*** FLOP *** [Ad As 6c]
z/jAqpWD9ifpbtEpwGyInw: bets $0.25
W6Y6au0wf7gRAlqJYgOezw: folds 
Uncalled bet ($0.25) returned to z/jAqpWD9ifpbtEpwGyInw
z/jAqpWD9ifpbtEpwGyInw collected $1.45 from pot
*** SUMMARY ***
Total pot $1.50 | Rake $0.05 
Board [Ad As 6c]
Seat 1: z/jAqpWD9ifpbtEpwGyInw (small blind) collected ($1.45)
Seat 3: W6Y6au0wf7gRAlqJYgOezw (big blind) folded on the Flop
Seat 4: n2OZezRXTtdzQt4SuIy8TQ (button) folded before Flop (didn't bet)




PokerStars Game #59939532240:  Hold'em No Limit ($0.10/$0.25) - 2009/07/01 0:42:17 ET
Table 'KU/HrxqxwDz8HKEhYTZ6uw' 6-max Seat #2 is the button
Seat 1: gaPMxLGp9SOj4Lq6t+/0Ig ($28 in chips) 
Seat 2: kG34n23qFQA3nzdOJTQ1dA ($24.30 in chips) 
Seat 3: 3seg9SJ1y+HUPN0X0XKF5Q ($11.95 in chips) 
Seat 5: 4YSTu0Cdzpppe1lUgCZGCQ ($36.35 in chips) 
Seat 6: QIWnfLSqfMcoFfdDe5LZPg ($9.80 in chips) 
3seg9SJ1y+HUPN0X0XKF5Q: posts small blind $0.10
4YSTu0Cdzpppe1lUgCZGCQ: posts big blind $0.25
*** HOLE CARDS ***
QIWnfLSqfMcoFfdDe5LZPg: raises $0.25 to $0.50
gaPMxLGp9SOj4Lq6t+/0Ig: calls $0.50
kG34n23qFQA3nzdOJTQ1dA: folds 
3seg9SJ1y+HUPN0X0XKF5Q: folds 
4YSTu0Cdzpppe1lUgCZGCQ: calls $0.25
*** FLOP *** [9d Ts 2s]
4YSTu0Cdzpppe1lUgCZGCQ: bets $1.25
QIWnfLSqfMcoFfdDe5LZPg: calls $1.25
gaPMxLGp9SOj4Lq6t+/0Ig: folds 
*** TURN *** [9d Ts 2s] [Jd]
4YSTu0Cdzpppe1lUgCZGCQ: checks 
QIWnfLSqfMcoFfdDe5LZPg: bets $1.75
4YSTu0Cdzpppe1lUgCZGCQ: calls $1.75
*** RIVER *** [9d Ts 2s Jd] [5c]
4YSTu0Cdzpppe1lUgCZGCQ: checks 
QIWnfLSqfMcoFfdDe5LZPg: checks 
*** SHOW DOWN ***
4YSTu0Cdzpppe1lUgCZGCQ: shows [8s 3s] (high card Jack)
QIWnfLSqfMcoFfdDe5LZPg: shows [Tc Qc] (a pair of Tens)
QIWnfLSqfMcoFfdDe5LZPg collected $7.25 from pot
*** SUMMARY ***
Total pot $7.60 | Rake $0.35 
Board [9d Ts 2s Jd 5c]
Seat 1: gaPMxLGp9SOj4Lq6t+/0Ig folded on the Flop
Seat 2: kG34n23qFQA3nzdOJTQ1dA (button) folded before Flop (didn't bet)
Seat 3: 3seg9SJ1y+HUPN0X0XKF5Q (small blind) folded before Flop
Seat 5: 4YSTu0Cdzpppe1lUgCZGCQ (big blind) showed [8s 3s] and lost with high card Jack
Seat 6: QIWnfLSqfMcoFfdDe5LZPg showed [Tc Qc] and won ($7.25) with a pair of Tens




PokerStars Game #59939532096:  Hold'em No Limit ($0.10/$0.25) - 2009/07/01 0:42:17 ET
Table 'nB7Q7zfNfy6ig6DB+rsgWQ' 6-max Seat #5 is the button
Seat 1: ACU3rO57RhDJfAgHTq2ocA ($4.45 in chips) 
Seat 2: g6kf+5FIgWH33PmH6ZecMQ ($15.60 in chips) 
Seat 3: p3NYOxYhkL7txPRSeXHDeg ($34.75 in chips) 
Seat 4: YZjG5I7FqwMKy06BKVBS7w ($7.95 in chips) 
Seat 5: X0/5h4o4LdHWlM7o/9shzg ($6.80 in chips) 
Seat 6: BYxjLnV1/LL0aZcTbfAOvw ($40.40 in chips) 
BYxjLnV1/LL0aZcTbfAOvw: posts small blind $0.10
ACU3rO57RhDJfAgHTq2ocA: posts big blind $0.25
*** HOLE CARDS ***
g6kf+5FIgWH33PmH6ZecMQ: folds 
p3NYOxYhkL7txPRSeXHDeg: folds 
YZjG5I7FqwMKy06BKVBS7w: folds 
X0/5h4o4LdHWlM7o/9shzg: folds 
BYxjLnV1/LL0aZcTbfAOvw: raises $0.75 to $1
ACU3rO57RhDJfAgHTq2ocA: folds 
Uncalled bet ($0.75) returned to BYxjLnV1/LL0aZcTbfAOvw
BYxjLnV1/LL0aZcTbfAOvw collected $0.50 from pot
BYxjLnV1/LL0aZcTbfAOvw: doesn't show hand 
*** SUMMARY ***
Total pot $0.50 | Rake $0 
Seat 1: ACU3rO57RhDJfAgHTq2ocA (big blind) folded before Flop
Seat 2: g6kf+5FIgWH33PmH6ZecMQ folded before Flop (didn't bet)
Seat 3: p3NYOxYhkL7txPRSeXHDeg folded before Flop (didn't bet)
Seat 4: YZjG5I7FqwMKy06BKVBS7w folded before Flop (didn't bet)
Seat 5: X0/5h4o4LdHWlM7o/9shzg (button) folded before Flop (didn't bet)
Seat 6: BYxjLnV1/LL0aZcTbfAOvw (small blind) collected ($0.50)




PokerStars Game #59939532156:  Hold'em No Limit ($0.10/$0.25) - 2009/07/01 0:42:17 ET
Table 'eOXPe2c6mG7DOFKvMsZZfA' 6-max Seat #5 is the button
Seat 1: ShXPHWfjhfmAwLgDdm6bRQ ($7.65 in chips) 
Seat 2: ELW+DKizJhLK7k40PMkD2Q ($34 in chips) 
Seat 3: kReyZ6g6Fu3tQ0nyjDf9kA ($30.25 in chips) 
Seat 4: zHHLkD2sRljslKKeQv/ZQw ($42.05 in chips) 
Seat 5: NhUN/JpAprdJeamFBgJH1w ($25 in chips) 
Seat 6: wKFJ513ucluNNiMlkXcDOQ ($25.45 in chips) 
wKFJ513ucluNNiMlkXcDOQ: posts small blind $0.10
ShXPHWfjhfmAwLgDdm6bRQ: posts big blind $0.25
*** HOLE CARDS ***
ELW+DKizJhLK7k40PMkD2Q: folds 
kReyZ6g6Fu3tQ0nyjDf9kA: calls $0.25
zHHLkD2sRljslKKeQv/ZQw: raises $0.50 to $0.75
NhUN/JpAprdJeamFBgJH1w: folds 
wKFJ513ucluNNiMlkXcDOQ: folds 
ShXPHWfjhfmAwLgDdm6bRQ: raises $6.90 to $7.65 and is all-in
kReyZ6g6Fu3tQ0nyjDf9kA: folds 
zHHLkD2sRljslKKeQv/ZQw: folds 
Uncalled bet ($6.90) returned to ShXPHWfjhfmAwLgDdm6bRQ
ShXPHWfjhfmAwLgDdm6bRQ collected $1.85 from pot
ShXPHWfjhfmAwLgDdm6bRQ: doesn't show hand 
*** SUMMARY ***
Total pot $1.85 | Rake $0 
Seat 1: ShXPHWfjhfmAwLgDdm6bRQ (big blind) collected ($1.85)
Seat 2: ELW+DKizJhLK7k40PMkD2Q folded before Flop (didn't bet)
Seat 3: kReyZ6g6Fu3tQ0nyjDf9kA folded before Flop
Seat 4: zHHLkD2sRljslKKeQv/ZQw folded before Flop
Seat 5: NhUN/JpAprdJeamFBgJH1w (button) folded before Flop (didn't bet)
Seat 6: wKFJ513ucluNNiMlkXcDOQ (small blind) folded before Flop




PokerStars Game #59939532822:  Hold'em No Limit ($0.10/$0.25) - 2009/07/01 0:42:18 ET
Table 'i93c3z9RLowvuJTKA2F4Jg' 6-max Seat #4 is the button
Seat 1: tbSZq5LHglyHk61mH9eDBw ($36 in chips) 
Seat 2: TSmua8tGK3sTbwi0ynrW9Q ($25 in chips) 
Seat 3: tVIFo6yuan1xauX1WIjH2w ($8.80 in chips) 
Seat 4: o86X2Q5GEDU3uP9oj1iFZA ($28.95 in chips) 
Seat 5: lYjWCpfCxX2kgcHY3v4Yow ($31.50 in chips) 
Seat 6: aSrj4lVmn2owyQ1RbbOqxQ ($24 in chips) 
lYjWCpfCxX2kgcHY3v4Yow: posts small blind $0.10
aSrj4lVmn2owyQ1RbbOqxQ: posts big blind $0.25
*** HOLE CARDS ***
tbSZq5LHglyHk61mH9eDBw: calls $0.25
TSmua8tGK3sTbwi0ynrW9Q: folds 
tVIFo6yuan1xauX1WIjH2w: folds 
o86X2Q5GEDU3uP9oj1iFZA: calls $0.25
lYjWCpfCxX2kgcHY3v4Yow: folds 
aSrj4lVmn2owyQ1RbbOqxQ: checks 
*** FLOP *** [Js 7d Qd]
aSrj4lVmn2owyQ1RbbOqxQ: checks 
tbSZq5LHglyHk61mH9eDBw: bets $0.75
o86X2Q5GEDU3uP9oj1iFZA: folds 
aSrj4lVmn2owyQ1RbbOqxQ: folds 
Uncalled bet ($0.75) returned to tbSZq5LHglyHk61mH9eDBw
tbSZq5LHglyHk61mH9eDBw collected $0.85 from pot
*** SUMMARY ***
Total pot $0.85 | Rake $0 
Board [Js 7d Qd]
Seat 1: tbSZq5LHglyHk61mH9eDBw collected ($0.85)
Seat 2: TSmua8tGK3sTbwi0ynrW9Q folded before Flop (didn't bet)
Seat 3: tVIFo6yuan1xauX1WIjH2w folded before Flop (didn't bet)
Seat 4: o86X2Q5GEDU3uP9oj1iFZA (button) folded on the Flop
Seat 5: lYjWCpfCxX2kgcHY3v4Yow (small blind) folded before Flop
Seat 6: aSrj4lVmn2owyQ1RbbOqxQ (big blind) folded on the Flop




PokerStars Game #59939532928:  Hold'em No Limit ($0.10/$0.25) - 2009/07/01 0:42:18 ET
Table 'GgmUtmhrYPRnhkqEEjD/Kw' 9-max Seat #3 is the button
Seat 2: ghNKXUBl/H+t83JF079ZBA ($25 in chips) 
Seat 3: DZek9vrzBExLUFtbWml/Eg ($11.20 in chips) 
Seat 4: uwmAXQRjyA4iX5kaC15P9A ($5.15 in chips) 
Seat 6: 4Ax0vobe1rLVIGZmkFINGA ($17.30 in chips) 
Seat 7: YwDw9cMqkbMznFK77rru4A ($8.55 in chips) 
Seat 8: mKwW7JjB4GQW2YtoYgqIgw ($12.90 in chips) 
uwmAXQRjyA4iX5kaC15P9A: posts small blind $0.10
4Ax0vobe1rLVIGZmkFINGA: posts big blind $0.25
vnCdP3GsLTKadDukKcJk/Q: sits out 
*** HOLE CARDS ***
YwDw9cMqkbMznFK77rru4A: calls $0.25
mKwW7JjB4GQW2YtoYgqIgw: folds 
ghNKXUBl/H+t83JF079ZBA: folds 
DZek9vrzBExLUFtbWml/Eg: raises $0.75 to $1
uwmAXQRjyA4iX5kaC15P9A: folds 
4Ax0vobe1rLVIGZmkFINGA: calls $0.75
YwDw9cMqkbMznFK77rru4A: folds 
*** FLOP *** [6h 5c 2s]
4Ax0vobe1rLVIGZmkFINGA: checks 
DZek9vrzBExLUFtbWml/Eg: bets $1.50
sonofafish61 joins the table at seat #5 
4Ax0vobe1rLVIGZmkFINGA: folds 
Uncalled bet ($1.50) returned to DZek9vrzBExLUFtbWml/Eg
DZek9vrzBExLUFtbWml/Eg collected $2.25 from pot
DZek9vrzBExLUFtbWml/Eg: doesn't show hand 
*** SUMMARY ***
Total pot $2.35 | Rake $0.10 
Board [6h 5c 2s]
Seat 2: ghNKXUBl/H+t83JF079ZBA folded before Flop (didn't bet)
Seat 3: DZek9vrzBExLUFtbWml/Eg (button) collected ($2.25)
Seat 4: uwmAXQRjyA4iX5kaC15P9A (small blind) folded before Flop
Seat 6: 4Ax0vobe1rLVIGZmkFINGA (big blind) folded on the Flop
Seat 7: YwDw9cMqkbMznFK77rru4A folded before Flop
Seat 8: mKwW7JjB4GQW2YtoYgqIgw folded before Flop (didn't bet)




PokerStars Game #59939532890:  Hold'em No Limit ($0.10/$0.25) - 2009/07/01 0:42:18 ET
Table '+fuYjvJy9okLr23QyZtanA' 9-max Seat #4 is the button
Seat 1: s7Q6uNouhe7aE8JdFb9E+A ($29.85 in chips) 
Seat 4: H/l9NZvuOXwQIPOaVdj0rQ ($9.95 in chips) 
Seat 5: h48vKHbhkYz+3RYZCQ0tgA ($15.25 in chips) 
h48vKHbhkYz+3RYZCQ0tgA: posts small blind $0.10
s7Q6uNouhe7aE8JdFb9E+A: posts big blind $0.25
*** HOLE CARDS ***
H/l9NZvuOXwQIPOaVdj0rQ: folds 
h48vKHbhkYz+3RYZCQ0tgA: raises $0.25 to $0.50
s7Q6uNouhe7aE8JdFb9E+A: calls $0.25
*** FLOP *** [6c Tc 2s]
h48vKHbhkYz+3RYZCQ0tgA: checks 
s7Q6uNouhe7aE8JdFb9E+A: checks 
*** TURN *** [6c Tc 2s] [Qs]
h48vKHbhkYz+3RYZCQ0tgA: bets $1
s7Q6uNouhe7aE8JdFb9E+A: calls $1
*** RIVER *** [6c Tc 2s Qs] [As]
h48vKHbhkYz+3RYZCQ0tgA: bets $1
s7Q6uNouhe7aE8JdFb9E+A: calls $1
*** SHOW DOWN ***
h48vKHbhkYz+3RYZCQ0tgA: shows [Ac 5d] (a pair of Aces)
s7Q6uNouhe7aE8JdFb9E+A: mucks hand 
h48vKHbhkYz+3RYZCQ0tgA collected $4.80 from pot
h48vKHbhkYz+3RYZCQ0tgA said, "sorry man"
*** SUMMARY ***
Total pot $5 | Rake $0.20 
Board [6c Tc 2s Qs As]
Seat 1: s7Q6uNouhe7aE8JdFb9E+A (big blind) mucked
Seat 4: H/l9NZvuOXwQIPOaVdj0rQ (button) folded before Flop (didn't bet)
Seat 5: h48vKHbhkYz+3RYZCQ0tgA (small blind) showed [Ac 5d] and won ($4.80) with a pair of Aces




PokerStars Game #59939533736:  Hold'em No Limit ($0.10/$0.25) - 2009/07/01 0:42:19 ET
Table 'dNYnr4D4id1jwnEU66Yowg' 9-max Seat #1 is the button
Seat 1: 41pZ+Uce9oq+8wmcVBXWIg ($16.55 in chips) 
Seat 4: d9fERE+24v0MqnylCrXchQ ($5.65 in chips) 
Seat 6: Lu6miJBtf3FVzUdzCWEtqQ ($19.50 in chips) 
d9fERE+24v0MqnylCrXchQ: posts small blind $0.10
Lu6miJBtf3FVzUdzCWEtqQ: posts big blind $0.25
*** HOLE CARDS ***
41pZ+Uce9oq+8wmcVBXWIg: raises $0.25 to $0.50
d9fERE+24v0MqnylCrXchQ: calls $0.40
Lu6miJBtf3FVzUdzCWEtqQ: calls $0.25
*** FLOP *** [Ah 5c Ad]
d9fERE+24v0MqnylCrXchQ: checks 
Lu6miJBtf3FVzUdzCWEtqQ: checks 
41pZ+Uce9oq+8wmcVBXWIg: checks 
*** TURN *** [Ah 5c Ad] [3h]
d9fERE+24v0MqnylCrXchQ: bets $5.15 and is all-in
Lu6miJBtf3FVzUdzCWEtqQ: folds 
41pZ+Uce9oq+8wmcVBXWIg: calls $5.15
*** RIVER *** [Ah 5c Ad 3h] [Tc]
*** SHOW DOWN ***
d9fERE+24v0MqnylCrXchQ: shows [8s 8d] (two pair, Aces and Eights)
41pZ+Uce9oq+8wmcVBXWIg: shows [As Jh] (three of a kind, Aces)
41pZ+Uce9oq+8wmcVBXWIg collected $11.25 from pot
*** SUMMARY ***
Total pot $11.80 | Rake $0.55 
Board [Ah 5c Ad 3h Tc]
Seat 1: 41pZ+Uce9oq+8wmcVBXWIg (button) showed [As Jh] and won ($11.25) with three of a kind, Aces
Seat 4: d9fERE+24v0MqnylCrXchQ (small blind) showed [8s 8d] and lost with two pair, Aces and Eights
Seat 6: Lu6miJBtf3FVzUdzCWEtqQ (big blind) folded on the Turn




PokerStars Game #59939533632:  Hold'em No Limit ($0.10/$0.25) - 2009/07/01 0:42:19 ET
Table 'B3/JTS7usG3rxMfTbMiZuw' 6-max Seat #5 is the button
Seat 1: wAKC8C/zN0c8V5v13dm9mA ($30.25 in chips) 
Seat 2: 2gqWqkOq59pvtJKe4nS+rw ($22.90 in chips) 
Seat 3: PbMzPZIePKifKQZfKDkbIw ($25 in chips) 
Seat 4: kPCKvyB1yAABEgvF7OaG0g ($25.15 in chips) 
Seat 5: NhUN/JpAprdJeamFBgJH1w ($26.90 in chips) 
6DwBRH+xZ12AAZmeAg+aXw will be allowed to play after the button
wAKC8C/zN0c8V5v13dm9mA: posts small blind $0.10
2gqWqkOq59pvtJKe4nS+rw: posts big blind $0.25
*** HOLE CARDS ***
PbMzPZIePKifKQZfKDkbIw: folds 
kPCKvyB1yAABEgvF7OaG0g: raises $0.25 to $0.50
NhUN/JpAprdJeamFBgJH1w: folds 
wAKC8C/zN0c8V5v13dm9mA: calls $0.40
2gqWqkOq59pvtJKe4nS+rw: calls $0.25
*** FLOP *** [7h 2s 5h]
wAKC8C/zN0c8V5v13dm9mA: checks 
2gqWqkOq59pvtJKe4nS+rw: checks 
kPCKvyB1yAABEgvF7OaG0g: checks 
*** TURN *** [7h 2s 5h] [7d]
wAKC8C/zN0c8V5v13dm9mA: bets $1
2gqWqkOq59pvtJKe4nS+rw: folds 
kPCKvyB1yAABEgvF7OaG0g: calls $1
*** RIVER *** [7h 2s 5h 7d] [Qs]
wAKC8C/zN0c8V5v13dm9mA: checks 
kPCKvyB1yAABEgvF7OaG0g: checks 
*** SHOW DOWN ***
wAKC8C/zN0c8V5v13dm9mA: shows [8c 8h] (two pair, Eights and Sevens)
kPCKvyB1yAABEgvF7OaG0g: mucks hand 
wAKC8C/zN0c8V5v13dm9mA collected $3.35 from pot
*** SUMMARY ***
Total pot $3.50 | Rake $0.15 
Board [7h 2s 5h 7d Qs]
Seat 1: wAKC8C/zN0c8V5v13dm9mA (small blind) showed [8c 8h] and won ($3.35) with two pair, Eights and Sevens
Seat 2: 2gqWqkOq59pvtJKe4nS+rw (big blind) folded on the Turn
Seat 3: PbMzPZIePKifKQZfKDkbIw folded before Flop (didn't bet)
Seat 4: kPCKvyB1yAABEgvF7OaG0g mucked
Seat 5: NhUN/JpAprdJeamFBgJH1w (button) folded before Flop (didn't bet)




PokerStars Game #59939533438:  Hold'em No Limit ($0.10/$0.25) - 2009/07/01 0:42:19 ET
Table 'IdXp6nyeW4FYaEK4qKCnwQ' 9-max Seat #5 is the button
Seat 2: HPEB+AtKw1+C/cxU0o1ciw ($28.55 in chips) 
Seat 5: U41wNf6XauAiBOQaKu2ZIA ($13.15 in chips) 
Seat 6: 1K6QGyJP9P9xmRac2fH4OQ ($33.45 in chips) 
Seat 9: JJH2Xc95hFewheF67vSv4Q ($15 in chips) 
1K6QGyJP9P9xmRac2fH4OQ: posts small blind $0.10
CYkY0dNBaYaKs8HVCVn3mQ: is sitting out 
cZ99hugmLBj9KhTlc8nCSw: is sitting out 
JJH2Xc95hFewheF67vSv4Q: posts big blind $0.25
*** HOLE CARDS ***
HPEB+AtKw1+C/cxU0o1ciw: folds 
cZ99hugmLBj9KhTlc8nCSw leaves the table
jiyia7h6fmxBdWBkH9lH5A has returned
CYkY0dNBaYaKs8HVCVn3mQ leaves the table
U41wNf6XauAiBOQaKu2ZIA: folds 
jiyia7h6fmxBdWBkH9lH5A leaves the table
1K6QGyJP9P9xmRac2fH4OQ: folds 
Uncalled bet ($0.15) returned to JJH2Xc95hFewheF67vSv4Q
1K6QGyJP9P9xmRac2fH4OQ leaves the table
JJH2Xc95hFewheF67vSv4Q collected $0.20 from pot
*** SUMMARY ***
Total pot $0.20 | Rake $0 
Seat 2: HPEB+AtKw1+C/cxU0o1ciw folded before Flop (didn't bet)
Seat 5: U41wNf6XauAiBOQaKu2ZIA (button) folded before Flop (didn't bet)
Seat 6: 1K6QGyJP9P9xmRac2fH4OQ (small blind) folded before Flop
Seat 9: JJH2Xc95hFewheF67vSv4Q (big blind) collected ($0.20)




PokerStars Game #59939533478:  Hold'em No Limit ($0.10/$0.25) - 2009/07/01 0:42:19 ET
Table 'vud0GB/ZlDCvUFhBFIaTlg' 9-max Seat #5 is the button
Seat 5: AwAabNdwDsTMb3aTomdOmg ($5.95 in chips) 
Seat 7: RzaVufWfW9CTnVYR7/Ge+w ($2 in chips) 
AwAabNdwDsTMb3aTomdOmg: posts small blind $0.10
RzaVufWfW9CTnVYR7/Ge+w: posts big blind $0.25
*** HOLE CARDS ***
AwAabNdwDsTMb3aTomdOmg: calls $0.15
RzaVufWfW9CTnVYR7/Ge+w: checks 
*** FLOP *** [8h 9s 8s]
RzaVufWfW9CTnVYR7/Ge+w: checks 
kris_arline joins the table at seat #4 
AwAabNdwDsTMb3aTomdOmg: checks 
*** TURN *** [8h 9s 8s] [Jc]
RzaVufWfW9CTnVYR7/Ge+w: checks 
AwAabNdwDsTMb3aTomdOmg: checks 
*** RIVER *** [8h 9s 8s Jc] [7h]
RzaVufWfW9CTnVYR7/Ge+w: checks 
AwAabNdwDsTMb3aTomdOmg: checks 
*** SHOW DOWN ***
RzaVufWfW9CTnVYR7/Ge+w: shows [3h 6h] (a pair of Eights)
AwAabNdwDsTMb3aTomdOmg: shows [Kd 3d] (a pair of Eights - King kicker)
AwAabNdwDsTMb3aTomdOmg collected $0.50 from pot
*** SUMMARY ***
Total pot $0.50 | Rake $0 
Board [8h 9s 8s Jc 7h]
Seat 5: AwAabNdwDsTMb3aTomdOmg (button) (small blind) showed [Kd 3d] and won ($0.50) with a pair of Eights
Seat 7: RzaVufWfW9CTnVYR7/Ge+w (big blind) showed [3h 6h] and lost with a pair of Eights




PokerStars Game #59939533958:  Hold'em No Limit ($0.10/$0.25) - 2009/07/01 0:42:20 ET
Table 'GoBmKm3klK6VavJE4STfmQ' 9-max Seat #9 is the button
Seat 1: N6fYvIzQLKaydFLKQGtMlQ ($23.30 in chips) 
Seat 2: 1c/7DHPx5CDTmAfk8/bWeA ($15.35 in chips) 
Seat 3: 4awUyiDYTgylQKXZ9faBVA ($26.40 in chips) 
Seat 4: H5Se03ZqSX7tbULXur2MAg ($24.30 in chips) 
Seat 5: 8B/dhbQjIWe6ASCdgzktNQ ($25.20 in chips) 
Seat 6: S3QwXyGCcujfAwNubHpwbw ($5.90 in chips) 
Seat 7: s9a4d23HFxaL70yUWQ0/tQ ($20.90 in chips) 
Seat 8: cZ99hugmLBj9KhTlc8nCSw ($25 in chips) 
Seat 9: 1K6QGyJP9P9xmRac2fH4OQ ($47.70 in chips) 
N6fYvIzQLKaydFLKQGtMlQ: posts small blind $0.10
1c/7DHPx5CDTmAfk8/bWeA: posts big blind $0.25
*** HOLE CARDS ***
4awUyiDYTgylQKXZ9faBVA: folds 
H5Se03ZqSX7tbULXur2MAg: folds 
8B/dhbQjIWe6ASCdgzktNQ: folds 
S3QwXyGCcujfAwNubHpwbw: calls $0.25
s9a4d23HFxaL70yUWQ0/tQ: folds 
cZ99hugmLBj9KhTlc8nCSw: folds 
1K6QGyJP9P9xmRac2fH4OQ: folds 
N6fYvIzQLKaydFLKQGtMlQ: folds 
1c/7DHPx5CDTmAfk8/bWeA: checks 
*** FLOP *** [7h 5c 2d]
1c/7DHPx5CDTmAfk8/bWeA: bets $0.75
S3QwXyGCcujfAwNubHpwbw: calls $0.75
*** TURN *** [7h 5c 2d] [Jc]
1c/7DHPx5CDTmAfk8/bWeA: bets $1
S3QwXyGCcujfAwNubHpwbw: folds 
Uncalled bet ($1) returned to 1c/7DHPx5CDTmAfk8/bWeA
1c/7DHPx5CDTmAfk8/bWeA collected $2 from pot
*** SUMMARY ***
Total pot $2.10 | Rake $0.10 
Board [7h 5c 2d Jc]
Seat 1: N6fYvIzQLKaydFLKQGtMlQ (small blind) folded before Flop
Seat 2: 1c/7DHPx5CDTmAfk8/bWeA (big blind) collected ($2)
Seat 3: 4awUyiDYTgylQKXZ9faBVA folded before Flop (didn't bet)
Seat 4: H5Se03ZqSX7tbULXur2MAg folded before Flop (didn't bet)
Seat 5: 8B/dhbQjIWe6ASCdgzktNQ folded before Flop (didn't bet)
Seat 6: S3QwXyGCcujfAwNubHpwbw folded on the Turn
Seat 7: s9a4d23HFxaL70yUWQ0/tQ folded before Flop (didn't bet)
Seat 8: cZ99hugmLBj9KhTlc8nCSw folded before Flop (didn't bet)
Seat 9: 1K6QGyJP9P9xmRac2fH4OQ (button) folded before Flop (didn't bet)




PokerStars Game #59939534014:  Hold'em No Limit ($0.10/$0.25) - 2009/07/01 0:42:20 ET
Table 'xro+BVoe2Zuw1TYmz/McJQ' 9-max Seat #2 is the button
Seat 1: xEQxarad8/T4jJdpZy5LGw ($7.85 in chips) 
Seat 2: MXCztnYJ58KLHMztZvKrxA ($13.25 in chips) 
Seat 3: COsrwJSFHQtxlUcrYtDQPQ ($36.70 in chips) 
Seat 4: N2LVj3iImgnOoHVf8g0rIw ($18.85 in chips) 
Seat 5: 87Warq49WFhxNpfNtKRmcQ ($28.25 in chips) 
Seat 6: HPEB+AtKw1+C/cxU0o1ciw ($26.25 in chips) 
Seat 7: QEbIGci+itdw+re8RM5fZA ($25 in chips) 
Seat 8: ljemhp25Zg+nlA9DLCIiUw ($25 in chips) 
Seat 9: H5Se03ZqSX7tbULXur2MAg ($24.30 in chips) 
COsrwJSFHQtxlUcrYtDQPQ: posts small blind $0.10
N2LVj3iImgnOoHVf8g0rIw: posts big blind $0.25
*** HOLE CARDS ***
87Warq49WFhxNpfNtKRmcQ: folds 
HPEB+AtKw1+C/cxU0o1ciw: folds 
QEbIGci+itdw+re8RM5fZA: folds 
ljemhp25Zg+nlA9DLCIiUw: folds 
H5Se03ZqSX7tbULXur2MAg: folds 
xEQxarad8/T4jJdpZy5LGw: calls $0.25
MXCztnYJ58KLHMztZvKrxA: calls $0.25
COsrwJSFHQtxlUcrYtDQPQ: folds 
N2LVj3iImgnOoHVf8g0rIw: checks 
*** FLOP *** [9s 7c 2c]
N2LVj3iImgnOoHVf8g0rIw: checks 
xEQxarad8/T4jJdpZy5LGw: checks 
MXCztnYJ58KLHMztZvKrxA: checks 
*** TURN *** [9s 7c 2c] [Jd]
N2LVj3iImgnOoHVf8g0rIw: bets $0.25
xEQxarad8/T4jJdpZy5LGw: folds 
MXCztnYJ58KLHMztZvKrxA: folds 
Uncalled bet ($0.25) returned to N2LVj3iImgnOoHVf8g0rIw
N2LVj3iImgnOoHVf8g0rIw collected $0.85 from pot
*** SUMMARY ***
Total pot $0.85 | Rake $0 
Board [9s 7c 2c Jd]
Seat 1: xEQxarad8/T4jJdpZy5LGw folded on the Turn
Seat 2: MXCztnYJ58KLHMztZvKrxA (button) folded on the Turn
Seat 3: COsrwJSFHQtxlUcrYtDQPQ (small blind) folded before Flop
Seat 4: N2LVj3iImgnOoHVf8g0rIw (big blind) collected ($0.85)
Seat 5: 87Warq49WFhxNpfNtKRmcQ folded before Flop (didn't bet)
Seat 6: HPEB+AtKw1+C/cxU0o1ciw folded before Flop (didn't bet)
Seat 7: QEbIGci+itdw+re8RM5fZA folded before Flop (didn't bet)
Seat 8: ljemhp25Zg+nlA9DLCIiUw folded before Flop (didn't bet)
Seat 9: H5Se03ZqSX7tbULXur2MAg folded before Flop (didn't bet)




PokerStars Game #59939533990:  Hold'em No Limit ($0.10/$0.25) - 2009/07/01 0:42:20 ET
Table 'h02LhQ7B/Zk4ETRxxHhGYA' 9-max Seat #6 is the button
Seat 1: sD+TKtt36XiiN6jqHiLwDA ($25 in chips) 
Seat 2: RJ/x9oZtt1RZLaJEQwZOxQ ($27.45 in chips) 
Seat 4: tYsOBqdU1+x+yFI7zHO7hQ ($38.20 in chips) 
Seat 5: cUxk0Jk4lrUQv9CJl0LPlg ($18.35 in chips) 
Seat 6: kN/irnQSdb8jibbN4f1O+Q ($17.70 in chips) 
Seat 7: rUpvA02nErFvZ4yFbDR8XA ($19.55 in chips) 
Seat 8: 7tW694tRVJnYdoa16Dw4RQ ($25.20 in chips) 
Seat 9: 1c/7DHPx5CDTmAfk8/bWeA ($16.25 in chips) 
rUpvA02nErFvZ4yFbDR8XA: posts small blind $0.10
7tW694tRVJnYdoa16Dw4RQ: posts big blind $0.25
*** HOLE CARDS ***
1c/7DHPx5CDTmAfk8/bWeA: folds 
sD+TKtt36XiiN6jqHiLwDA: folds 
kqpa/IbqkUrwPb3hbA7/ww has returned
RJ/x9oZtt1RZLaJEQwZOxQ: folds 
tYsOBqdU1+x+yFI7zHO7hQ: folds 
cUxk0Jk4lrUQv9CJl0LPlg: calls $0.25
kN/irnQSdb8jibbN4f1O+Q: raises $0.75 to $1
rUpvA02nErFvZ4yFbDR8XA: folds 
7tW694tRVJnYdoa16Dw4RQ: folds 
cUxk0Jk4lrUQv9CJl0LPlg: calls $0.75
*** FLOP *** [3s Kc 8s]
cUxk0Jk4lrUQv9CJl0LPlg: checks 
kN/irnQSdb8jibbN4f1O+Q: bets $1.50
cUxk0Jk4lrUQv9CJl0LPlg: folds 
Uncalled bet ($1.50) returned to kN/irnQSdb8jibbN4f1O+Q
kN/irnQSdb8jibbN4f1O+Q collected $2.25 from pot
*** SUMMARY ***
Total pot $2.35 | Rake $0.10 
Board [3s Kc 8s]
Seat 1: sD+TKtt36XiiN6jqHiLwDA folded before Flop (didn't bet)
Seat 2: RJ/x9oZtt1RZLaJEQwZOxQ folded before Flop (didn't bet)
Seat 4: tYsOBqdU1+x+yFI7zHO7hQ folded before Flop (didn't bet)
Seat 5: cUxk0Jk4lrUQv9CJl0LPlg folded on the Flop
Seat 6: kN/irnQSdb8jibbN4f1O+Q (button) collected ($2.25)
Seat 7: rUpvA02nErFvZ4yFbDR8XA (small blind) folded before Flop
Seat 8: 7tW694tRVJnYdoa16Dw4RQ (big blind) folded before Flop
Seat 9: 1c/7DHPx5CDTmAfk8/bWeA folded before Flop (didn't bet)




PokerStars Game #59939533954:  Hold'em No Limit ($0.10/$0.25) - 2009/07/01 0:42:20 ET
Table 'zgAizkhIUPUrfr6LqN3ifw' 9-max Seat #3 is the button
Seat 1: st9jtdNbm1W5GfBwRaCVqQ ($25.25 in chips) 
Seat 2: s7Q6uNouhe7aE8JdFb9E+A ($26.25 in chips) 
Seat 3: hZuGwtYmFKPmQ+v1wlmdfA ($22.60 in chips) 
Seat 5: DdPXdieucQ+n99u1n3A+rQ ($5.25 in chips) 
Seat 6: TeWJxSETzbXGiYKx0y+dtg ($25 in chips) 
Seat 7: 1S/fpm+f42V/6MNZre+ccg ($25 in chips) 
Seat 8: MIVCHqCqqlke0Lb0z7glcw ($24.15 in chips) 
Seat 9: SXqVW4Q0evTUVZG6BbUNIA ($39.30 in chips) 
DdPXdieucQ+n99u1n3A+rQ: posts small blind $0.10
TeWJxSETzbXGiYKx0y+dtg: posts big blind $0.25
*** HOLE CARDS ***
1S/fpm+f42V/6MNZre+ccg: folds 
MIVCHqCqqlke0Lb0z7glcw: folds 
SXqVW4Q0evTUVZG6BbUNIA: folds 
st9jtdNbm1W5GfBwRaCVqQ: folds 
s7Q6uNouhe7aE8JdFb9E+A: folds 
hZuGwtYmFKPmQ+v1wlmdfA: folds 
DdPXdieucQ+n99u1n3A+rQ: folds 
Uncalled bet ($0.15) returned to TeWJxSETzbXGiYKx0y+dtg
TeWJxSETzbXGiYKx0y+dtg collected $0.20 from pot
TeWJxSETzbXGiYKx0y+dtg: doesn't show hand 
*** SUMMARY ***
Total pot $0.20 | Rake $0 
Seat 1: st9jtdNbm1W5GfBwRaCVqQ folded before Flop (didn't bet)
Seat 2: s7Q6uNouhe7aE8JdFb9E+A folded before Flop (didn't bet)
Seat 3: hZuGwtYmFKPmQ+v1wlmdfA (button) folded before Flop (didn't bet)
Seat 5: DdPXdieucQ+n99u1n3A+rQ (small blind) folded before Flop
Seat 6: TeWJxSETzbXGiYKx0y+dtg (big blind) collected ($0.20)
Seat 7: 1S/fpm+f42V/6MNZre+ccg folded before Flop (didn't bet)
Seat 8: MIVCHqCqqlke0Lb0z7glcw folded before Flop (didn't bet)
Seat 9: SXqVW4Q0evTUVZG6BbUNIA folded before Flop (didn't bet)




PokerStars Game #59939534266:  Hold'em No Limit ($0.10/$0.25) - 2009/07/01 0:42:20 ET
Table '2AUmC2Rslg+QUbLfdgNdfg' 6-max Seat #5 is the button
Seat 2: CCxAG7iPVlAv3brCqrGBEg ($13.90 in chips) 
Seat 3: iauW7L/+7qzAuHow7CD75Q ($6.45 in chips) 
Seat 4: B6R6e73iyJNddUtXtvYr3Q ($47.95 in chips) 
Seat 5: 8ClCHtFXGNplITm+63KB+Q ($22.95 in chips) 
Seat 6: BvTq4Tu0zBOsniW3eFCnkQ ($32.65 in chips) 
BvTq4Tu0zBOsniW3eFCnkQ: posts small blind $0.10
CCxAG7iPVlAv3brCqrGBEg: posts big blind $0.25
*** HOLE CARDS ***
iauW7L/+7qzAuHow7CD75Q: calls $0.25
B6R6e73iyJNddUtXtvYr3Q: folds 
8ClCHtFXGNplITm+63KB+Q: folds 
BvTq4Tu0zBOsniW3eFCnkQ: folds 
lgP2sg9oZJsNSXCt7tbwRg leaves the table
CCxAG7iPVlAv3brCqrGBEg: checks 
*** FLOP *** [Ac Jd 9s]
CCxAG7iPVlAv3brCqrGBEg: checks 
iauW7L/+7qzAuHow7CD75Q: checks 
*** TURN *** [Ac Jd 9s] [Ah]
CCxAG7iPVlAv3brCqrGBEg: checks 
iauW7L/+7qzAuHow7CD75Q: checks 
*** RIVER *** [Ac Jd 9s Ah] [4c]
CCxAG7iPVlAv3brCqrGBEg: checks 
iauW7L/+7qzAuHow7CD75Q: checks 
*** SHOW DOWN ***
CCxAG7iPVlAv3brCqrGBEg: shows [8h 4h] (two pair, Aces and Fours)
iauW7L/+7qzAuHow7CD75Q: mucks hand 
CCxAG7iPVlAv3brCqrGBEg collected $0.60 from pot
*** SUMMARY ***
Total pot $0.60 | Rake $0 
Board [Ac Jd 9s Ah 4c]
Seat 2: CCxAG7iPVlAv3brCqrGBEg (big blind) showed [8h 4h] and won ($0.60) with two pair, Aces and Fours
Seat 3: iauW7L/+7qzAuHow7CD75Q mucked
Seat 4: B6R6e73iyJNddUtXtvYr3Q folded before Flop (didn't bet)
Seat 5: 8ClCHtFXGNplITm+63KB+Q (button) folded before Flop (didn't bet)
Seat 6: BvTq4Tu0zBOsniW3eFCnkQ (small blind) folded before Flop




PokerStars Game #59939534464:  Hold'em No Limit ($0.10/$0.25) - 2009/07/01 0:42:20 ET
Table 'gYBWJG3hEuJg6kphY0yhMg' 9-max Seat #4 is the button
Seat 1: s7Q6uNouhe7aE8JdFb9E+A ($25 in chips) 
Seat 2: z2SmIaQ3+5n/eY1BN5HgPg ($28.70 in chips) 
Seat 4: V6p0jQ/RhUsqpHLmXvEX4Q ($12.10 in chips) 
Seat 5: +sbyWwIcFp9kP0bDtMegfQ ($24.55 in chips) 
Seat 6: 9AI+W5n0har4qZZPPHsjKg ($4.65 in chips) 
Seat 7: xqvFhQD+76TQUT0AVOUMAg ($28 in chips) 
Seat 9: DxA2S3LbITR502Wya4qTnw ($2.45 in chips) 
+sbyWwIcFp9kP0bDtMegfQ: posts small blind $0.10
9AI+W5n0har4qZZPPHsjKg: posts big blind $0.25
j4q3p0lesp63b1gZDwLBZw: sits out 
*** HOLE CARDS ***
xqvFhQD+76TQUT0AVOUMAg: folds 
DxA2S3LbITR502Wya4qTnw: calls $0.25
xqvFhQD+76TQUT0AVOUMAg leaves the table
s7Q6uNouhe7aE8JdFb9E+A: folds 
z2SmIaQ3+5n/eY1BN5HgPg: folds 
CvL9Ch1HYCVbTsfpNucitg joins the table at seat #7 
V6p0jQ/RhUsqpHLmXvEX4Q: folds 
+sbyWwIcFp9kP0bDtMegfQ: calls $0.15
OkWGxhGhDA0lvNLGWmJxug has returned
9AI+W5n0har4qZZPPHsjKg: checks 
*** FLOP *** [9c 5c 8d]
+sbyWwIcFp9kP0bDtMegfQ: checks 
9AI+W5n0har4qZZPPHsjKg: checks 
DxA2S3LbITR502Wya4qTnw: bets $0.75
+sbyWwIcFp9kP0bDtMegfQ: folds 
9AI+W5n0har4qZZPPHsjKg: folds 
Uncalled bet ($0.75) returned to DxA2S3LbITR502Wya4qTnw
DxA2S3LbITR502Wya4qTnw collected $0.75 from pot
DxA2S3LbITR502Wya4qTnw: doesn't show hand 
*** SUMMARY ***
Total pot $0.75 | Rake $0 
Board [9c 5c 8d]
Seat 1: s7Q6uNouhe7aE8JdFb9E+A folded before Flop (didn't bet)
Seat 2: z2SmIaQ3+5n/eY1BN5HgPg folded before Flop (didn't bet)
Seat 4: V6p0jQ/RhUsqpHLmXvEX4Q (button) folded before Flop (didn't bet)
Seat 5: +sbyWwIcFp9kP0bDtMegfQ (small blind) folded on the Flop
Seat 6: 9AI+W5n0har4qZZPPHsjKg (big blind) folded on the Flop
Seat 7: xqvFhQD+76TQUT0AVOUMAg folded before Flop (didn't bet)
Seat 9: DxA2S3LbITR502Wya4qTnw collected ($0.75)




PokerStars Game #59939534314:  Hold'em No Limit ($0.10/$0.25) - 2009/07/01 0:42:20 ET
Table 'pAhiNHs/spaABQia+7gWNQ' 9-max Seat #8 is the button
Seat 1: /VQLorsEOrMfI+KamzNQEA ($4.45 in chips) 
Seat 2: vnCdP3GsLTKadDukKcJk/Q ($25 in chips) 
Seat 3: xEQxarad8/T4jJdpZy5LGw ($9.95 in chips) 
Seat 5: /vn2Qu2dvc9AMMq46Ae0jA ($10.15 in chips) 
Seat 6: FinSxgTdEPV/yPQRl5uhmA ($48.45 in chips) 
Seat 7: 04UcDjK4SUEJctLqNtWFoQ ($9.40 in chips) 
Seat 8: vSkQm2EelzwRGDDQQk0Fqw ($14.30 in chips) 
/VQLorsEOrMfI+KamzNQEA: posts small blind $0.10
vnCdP3GsLTKadDukKcJk/Q: posts big blind $0.25
F7pnn6czNpHvRM55XcA2EA: sits out 
*** HOLE CARDS ***
xEQxarad8/T4jJdpZy5LGw: calls $0.25
/vn2Qu2dvc9AMMq46Ae0jA: folds 
FinSxgTdEPV/yPQRl5uhmA: raises $1 to $1.25
04UcDjK4SUEJctLqNtWFoQ: folds 
vSkQm2EelzwRGDDQQk0Fqw: folds 
/VQLorsEOrMfI+KamzNQEA: raises $3.20 to $4.45 and is all-in
vnCdP3GsLTKadDukKcJk/Q: folds 
xEQxarad8/T4jJdpZy5LGw: folds 
FinSxgTdEPV/yPQRl5uhmA: calls $3.20
*** FLOP *** [Jd 7h Jc]
*** TURN *** [Jd 7h Jc] [8h]
*** RIVER *** [Jd 7h Jc 8h] [9h]
vZGoOTJLQLhkPj4I+LNGig joins the table at seat #9 
*** SHOW DOWN ***
/VQLorsEOrMfI+KamzNQEA: shows [Ad Kd] (a pair of Jacks)
FinSxgTdEPV/yPQRl5uhmA: shows [9d 5d] (two pair, Jacks and Nines)
FinSxgTdEPV/yPQRl5uhmA collected $8.95 from pot
*** SUMMARY ***
Total pot $9.40 | Rake $0.45 
Board [Jd 7h Jc 8h 9h]
Seat 1: /VQLorsEOrMfI+KamzNQEA (small blind) showed [Ad Kd] and lost with a pair of Jacks
Seat 2: vnCdP3GsLTKadDukKcJk/Q (big blind) folded before Flop
Seat 3: xEQxarad8/T4jJdpZy5LGw folded before Flop
Seat 5: /vn2Qu2dvc9AMMq46Ae0jA folded before Flop (didn't bet)
Seat 6: FinSxgTdEPV/yPQRl5uhmA showed [9d 5d] and won ($8.95) with two pair, Jacks and Nines
Seat 7: 04UcDjK4SUEJctLqNtWFoQ folded before Flop (didn't bet)
Seat 8: vSkQm2EelzwRGDDQQk0Fqw (button) folded before Flop (didn't bet)




PokerStars Game #59939534268:  Hold'em No Limit ($0.10/$0.25) - 2009/07/01 0:42:20 ET
Table 'Ok3oDLIsTc2+KxPcI0bAOA' 6-max Seat #4 is the button
Seat 1: agQm3ugZ3qSVYNgNu1ddeA ($27.05 in chips) 
Seat 2: oseFhpinoe+Zg4j5xyBjyQ ($30.35 in chips) 
Seat 3: I1TxPvWj8NfG8orglCinNA ($25 in chips) 
Seat 4: WMiAkibyLuLJ32VI20myug ($11.70 in chips) 
Seat 5: nc79pm0LZRdhncq55evVqA ($28 in chips) 
Seat 6: JFIAqU8lCZ0vWwEl4bdGsg ($29.35 in chips) 
nc79pm0LZRdhncq55evVqA: posts small blind $0.10
JFIAqU8lCZ0vWwEl4bdGsg: posts big blind $0.25
*** HOLE CARDS ***
agQm3ugZ3qSVYNgNu1ddeA: folds 
oseFhpinoe+Zg4j5xyBjyQ: folds 
I1TxPvWj8NfG8orglCinNA: raises $0.75 to $1
WMiAkibyLuLJ32VI20myug has timed out
WMiAkibyLuLJ32VI20myug: folds 
WMiAkibyLuLJ32VI20myug is sitting out
nc79pm0LZRdhncq55evVqA: folds 
JFIAqU8lCZ0vWwEl4bdGsg: folds 
Uncalled bet ($0.75) returned to I1TxPvWj8NfG8orglCinNA
I1TxPvWj8NfG8orglCinNA collected $0.60 from pot
I1TxPvWj8NfG8orglCinNA: doesn't show hand 
*** SUMMARY ***
Total pot $0.60 | Rake $0 
Seat 1: agQm3ugZ3qSVYNgNu1ddeA folded before Flop (didn't bet)
Seat 2: oseFhpinoe+Zg4j5xyBjyQ folded before Flop (didn't bet)
Seat 3: I1TxPvWj8NfG8orglCinNA collected ($0.60)
Seat 4: WMiAkibyLuLJ32VI20myug (button) folded before Flop (didn't bet)
Seat 5: nc79pm0LZRdhncq55evVqA (small blind) folded before Flop
Seat 6: JFIAqU8lCZ0vWwEl4bdGsg (big blind) folded before Flop




PokerStars Game #59939534250:  Hold'em No Limit ($0.10/$0.25) - 2009/07/01 0:42:20 ET
Table 'qryc9C/ELyQ3lubOaELNAQ' 6-max Seat #2 is the button
Seat 1: OZc6kkoTwtITj1ZfreJK1A ($28.85 in chips) 
Seat 2: qvQc9BHp2FhQjrltLiBN+w ($12.10 in chips) 
Seat 3: UXRtG8J9PoBZWTsNtqdoDA ($20.75 in chips) 
Seat 4: v+QfkGiuj9bgtuNoVnDO8w ($29.35 in chips) 
Seat 5: pV5UZbjsgam+HUQEd6G++w ($7.90 in chips) 
Seat 6: t2RfOOoa56xW0ZHJC0+5JQ ($8.45 in chips) 
UXRtG8J9PoBZWTsNtqdoDA: posts small blind $0.10
v+QfkGiuj9bgtuNoVnDO8w: posts big blind $0.25
*** HOLE CARDS ***
pV5UZbjsgam+HUQEd6G++w: raises $0.40 to $0.65
t2RfOOoa56xW0ZHJC0+5JQ: folds 
OZc6kkoTwtITj1ZfreJK1A: folds 
qvQc9BHp2FhQjrltLiBN+w: folds 
UXRtG8J9PoBZWTsNtqdoDA: calls $0.55
v+QfkGiuj9bgtuNoVnDO8w: folds 
*** FLOP *** [5d 4d Jh]
UXRtG8J9PoBZWTsNtqdoDA: checks 
pV5UZbjsgam+HUQEd6G++w: bets $1
UXRtG8J9PoBZWTsNtqdoDA: folds 
Uncalled bet ($1) returned to pV5UZbjsgam+HUQEd6G++w
pV5UZbjsgam+HUQEd6G++w collected $1.50 from pot
pV5UZbjsgam+HUQEd6G++w: doesn't show hand 
*** SUMMARY ***
Total pot $1.55 | Rake $0.05 
Board [5d 4d Jh]
Seat 1: OZc6kkoTwtITj1ZfreJK1A folded before Flop (didn't bet)
Seat 2: qvQc9BHp2FhQjrltLiBN+w (button) folded before Flop (didn't bet)
Seat 3: UXRtG8J9PoBZWTsNtqdoDA (small blind) folded on the Flop
Seat 4: v+QfkGiuj9bgtuNoVnDO8w (big blind) folded before Flop
Seat 5: pV5UZbjsgam+HUQEd6G++w collected ($1.50)
Seat 6: t2RfOOoa56xW0ZHJC0+5JQ folded before Flop (didn't bet)




PokerStars Game #59939535042:  Hold'em No Limit ($0.10/$0.25) - 2009/07/01 0:42:21 ET
Table '6wawJ+MkkvuC3coG6r+Yhg' 6-max Seat #5 is the button
Seat 1: ELW+DKizJhLK7k40PMkD2Q ($25.25 in chips) 
Seat 2: LtASJ9OlkqGrrUKGQlpGAw ($27.40 in chips) 
Seat 3: KYBwVA7jgmSrbIEbEGElVg ($16.60 in chips) 
Seat 4: cS21pIxRHx5Gt42o7hPZzw ($12 in chips) 
Seat 5: A8uIskXJTblhVXWuYr+lkw ($15.50 in chips) 
Seat 6: oOGZlBAhqtG/HczLL/KLRQ ($18.80 in chips) 
oOGZlBAhqtG/HczLL/KLRQ: posts small blind $0.10
ELW+DKizJhLK7k40PMkD2Q: posts big blind $0.25
*** HOLE CARDS ***
LtASJ9OlkqGrrUKGQlpGAw has timed out
LtASJ9OlkqGrrUKGQlpGAw: folds 
LtASJ9OlkqGrrUKGQlpGAw is sitting out
KYBwVA7jgmSrbIEbEGElVg: folds 
cS21pIxRHx5Gt42o7hPZzw: folds 
LtASJ9OlkqGrrUKGQlpGAw has returned
A8uIskXJTblhVXWuYr+lkw: calls $0.25
oOGZlBAhqtG/HczLL/KLRQ: folds 
ELW+DKizJhLK7k40PMkD2Q: raises $1 to $1.25
A8uIskXJTblhVXWuYr+lkw: raises $1 to $2.25
ELW+DKizJhLK7k40PMkD2Q: raises $2.75 to $5
A8uIskXJTblhVXWuYr+lkw: calls $2.75
*** FLOP *** [Kh 5h Jd]
ELW+DKizJhLK7k40PMkD2Q: checks 
A8uIskXJTblhVXWuYr+lkw: bets $3
ELW+DKizJhLK7k40PMkD2Q: raises $17.25 to $20.25 and is all-in
A8uIskXJTblhVXWuYr+lkw: folds 
Uncalled bet ($17.25) returned to ELW+DKizJhLK7k40PMkD2Q
ELW+DKizJhLK7k40PMkD2Q collected $15.35 from pot
*** SUMMARY ***
Total pot $16.10 | Rake $0.75 
Board [Kh 5h Jd]
Seat 1: ELW+DKizJhLK7k40PMkD2Q (big blind) collected ($15.35)
Seat 2: LtASJ9OlkqGrrUKGQlpGAw folded before Flop (didn't bet)
Seat 3: KYBwVA7jgmSrbIEbEGElVg folded before Flop (didn't bet)
Seat 4: cS21pIxRHx5Gt42o7hPZzw folded before Flop (didn't bet)
Seat 5: A8uIskXJTblhVXWuYr+lkw (button) folded on the Flop
Seat 6: oOGZlBAhqtG/HczLL/KLRQ (small blind) folded before Flop




PokerStars Game #59939534578:  Hold'em No Limit ($0.10/$0.25) - 2009/07/01 0:42:21 ET
Table 'hfHe8uKeSJMyWAjSdM7ROQMRfAiS/4JSfnUDlCcZo0wAx Seat #6 is the button
Seat 1: 48oT5xFI+5CHUJlfoGrE4w ($11.40 in chips) 
Seat 2: /gJNBeCkWL4o85/jvlZ4BA ($39.70 in chips) 
Seat 3: FYepjhAvF8ZdVCmqHIy+eQ ($45.75 in chips) 
Seat 4: Go8clNIDGP3feVvzBDG4pg ($19.65 in chips) 
Seat 5: qccGLncfUaN00Few5HsgYg ($28.70 in chips) 
Seat 6: VaDPspfGS2lnEkaGNrNqfg ($8.50 in chips) 
48oT5xFI+5CHUJlfoGrE4w: posts small blind $0.10
/gJNBeCkWL4o85/jvlZ4BA: posts big blind $0.25
*** HOLE CARDS ***
FYepjhAvF8ZdVCmqHIy+eQ: folds 
Go8clNIDGP3feVvzBDG4pg: folds 
qccGLncfUaN00Few5HsgYg: folds 
VaDPspfGS2lnEkaGNrNqfg: calls $0.25
48oT5xFI+5CHUJlfoGrE4w: folds 
/gJNBeCkWL4o85/jvlZ4BA: checks 
*** FLOP *** [7h 8h Ac]
/gJNBeCkWL4o85/jvlZ4BA: checks 
VaDPspfGS2lnEkaGNrNqfg: checks 
*** TURN *** [7h 8h Ac] [3h]
/gJNBeCkWL4o85/jvlZ4BA: checks 
VaDPspfGS2lnEkaGNrNqfg: bets $0.25
/gJNBeCkWL4o85/jvlZ4BA: folds 
Uncalled bet ($0.25) returned to VaDPspfGS2lnEkaGNrNqfg
VaDPspfGS2lnEkaGNrNqfg collected $0.60 from pot
*** SUMMARY ***
Total pot $0.60 | Rake $0 
Board [7h 8h Ac 3h]
Seat 1: 48oT5xFI+5CHUJlfoGrE4w (small blind) folded before Flop
Seat 2: /gJNBeCkWL4o85/jvlZ4BA (big blind) folded on the Turn
Seat 3: FYepjhAvF8ZdVCmqHIy+eQ folded before Flop (didn't bet)
Seat 4: Go8clNIDGP3feVvzBDG4pg folded before Flop (didn't bet)
Seat 5: qccGLncfUaN00Few5HsgYg folded before Flop (didn't bet)
Seat 6: VaDPspfGS2lnEkaGNrNqfg (button) collected ($0.60)




PokerStars Game #59939534542:  Hold'em No Limit ($0.10/$0.25) - 2009/07/01 0:42:21 ET
Table '/JJyyIstHfkT7t/bW+WXgg' 6-max Seat #6 is the button
Seat 1: wsP46AGpqDjHZQmlRHKa9g ($25.15 in chips) 
Seat 2: eRDLpytVTPI4rY3iortMSw ($5.35 in chips) 
Seat 3: oc4ZGs0W+3RIg2yPyJw3ig ($25.85 in chips) 
Seat 4: ELW+DKizJhLK7k40PMkD2Q ($25.80 in chips) 
Seat 5: 2wkoolB4YxxVC2x99F9rcA ($29.75 in chips) 
Seat 6: d338A2rm6NtA1ECEZi4d2g ($17.15 in chips) 
wsP46AGpqDjHZQmlRHKa9g: posts small blind $0.10
eRDLpytVTPI4rY3iortMSw: posts big blind $0.25
*** HOLE CARDS ***
oc4ZGs0W+3RIg2yPyJw3ig: folds 
ELW+DKizJhLK7k40PMkD2Q: folds 
2wkoolB4YxxVC2x99F9rcA: folds 
d338A2rm6NtA1ECEZi4d2g: raises $0.75 to $1
wsP46AGpqDjHZQmlRHKa9g: folds 
eRDLpytVTPI4rY3iortMSw: calls $0.75
*** FLOP *** [3c 3h Ks]
eRDLpytVTPI4rY3iortMSw: checks 
d338A2rm6NtA1ECEZi4d2g: checks 
*** TURN *** [3c 3h Ks] [Tc]
eRDLpytVTPI4rY3iortMSw: bets $0.75
d338A2rm6NtA1ECEZi4d2g: folds 
Uncalled bet ($0.75) returned to eRDLpytVTPI4rY3iortMSw
eRDLpytVTPI4rY3iortMSw collected $2 from pot
eRDLpytVTPI4rY3iortMSw: doesn't show hand 
*** SUMMARY ***
Total pot $2.10 | Rake $0.10 
Board [3c 3h Ks Tc]
Seat 1: wsP46AGpqDjHZQmlRHKa9g (small blind) folded before Flop
Seat 2: eRDLpytVTPI4rY3iortMSw (big blind) collected ($2)
Seat 3: oc4ZGs0W+3RIg2yPyJw3ig folded before Flop (didn't bet)
Seat 4: ELW+DKizJhLK7k40PMkD2Q folded before Flop (didn't bet)
Seat 5: 2wkoolB4YxxVC2x99F9rcA folded before Flop (didn't bet)
Seat 6: d338A2rm6NtA1ECEZi4d2g (button) folded on the Turn




PokerStars Game #59939534958:  Hold'em No Limit ($0.10/$0.25) - 2009/07/01 0:42:21 ET
Table 'sCop8wmj9zlSS2KJqk1QKQ' 9-max Seat #1 is the button
Seat 1: SXqVW4Q0evTUVZG6BbUNIA ($21.55 in chips) 
Seat 2: W4TLQcZ2TiM73eIgpIvlGg ($23.25 in chips) 
Seat 3: 6TWO15+WfJ5HfI8CbJ4a0w ($4.30 in chips) 
Seat 4: KNrY0Y/j01dK9gZK7dx7QA ($14.40 in chips) 
Seat 6: hZuGwtYmFKPmQ+v1wlmdfA ($40.10 in chips) 
Seat 7: 4dd+rKHhaMiTl5LEkADvQQ ($4.90 in chips) 
Seat 9: tOdE7+08fkUzsTpCnhoPDA ($22.10 in chips) 
W4TLQcZ2TiM73eIgpIvlGg: posts small blind $0.10
6TWO15+WfJ5HfI8CbJ4a0w: posts big blind $0.25
sD+TKtt36XiiN6jqHiLwDA: sits out 
opOCI2p6kW0tINuVaAqmcQ: sits out 
*** HOLE CARDS ***
KNrY0Y/j01dK9gZK7dx7QA: folds 
hZuGwtYmFKPmQ+v1wlmdfA: folds 
4dd+rKHhaMiTl5LEkADvQQ: folds 
tOdE7+08fkUzsTpCnhoPDA: folds 
SXqVW4Q0evTUVZG6BbUNIA: folds 
W4TLQcZ2TiM73eIgpIvlGg: calls $0.15
6TWO15+WfJ5HfI8CbJ4a0w: checks 
*** FLOP *** [Qs 4h Ah]
W4TLQcZ2TiM73eIgpIvlGg: checks 
6TWO15+WfJ5HfI8CbJ4a0w: checks 
*** TURN *** [Qs 4h Ah] [4s]
W4TLQcZ2TiM73eIgpIvlGg: checks 
6TWO15+WfJ5HfI8CbJ4a0w: checks 
*** RIVER *** [Qs 4h Ah 4s] [2c]
W4TLQcZ2TiM73eIgpIvlGg: checks 
6TWO15+WfJ5HfI8CbJ4a0w: checks 
*** SHOW DOWN ***
W4TLQcZ2TiM73eIgpIvlGg: shows [2h Kc] (two pair, Fours and Deuces)
6TWO15+WfJ5HfI8CbJ4a0w: mucks hand 
W4TLQcZ2TiM73eIgpIvlGg collected $0.50 from pot
*** SUMMARY ***
Total pot $0.50 | Rake $0 
Board [Qs 4h Ah 4s 2c]
Seat 1: SXqVW4Q0evTUVZG6BbUNIA (button) folded before Flop (didn't bet)
Seat 2: W4TLQcZ2TiM73eIgpIvlGg (small blind) showed [2h Kc] and won ($0.50) with two pair, Fours and Deuces
Seat 3: 6TWO15+WfJ5HfI8CbJ4a0w (big blind) mucked
Seat 4: KNrY0Y/j01dK9gZK7dx7QA folded before Flop (didn't bet)
Seat 6: hZuGwtYmFKPmQ+v1wlmdfA folded before Flop (didn't bet)
Seat 7: 4dd+rKHhaMiTl5LEkADvQQ folded before Flop (didn't bet)
Seat 9: tOdE7+08fkUzsTpCnhoPDA folded before Flop (didn't bet)




PokerStars Game #59939535040:  Hold'em No Limit ($0.10/$0.25) - 2009/07/01 0:42:21 ET
Table 'U0hCzoS0KCJL+eoE054K4Q' 9-max Seat #3 is the button
Seat 2: MG90wfSJZnOejs/KD3vlQQ ($25 in chips) 
Seat 3: u/r4MjA69AbvOh1qLp6Eig ($14.65 in chips) 
Seat 4: REZJH+hR80RwfrJtUNUJOw ($28.80 in chips) 
Seat 5: gN5V9qraLHmhKzjLHzt7qA ($18.70 in chips) 
Seat 7: NNZypfH1f/VIj3Skf/XIzg ($2.25 in chips) 
Seat 8: Xpyqpb+DURDWnyJ3xTEIFQ ($26.80 in chips) 
Seat 9: X9HkgGdfFul8DB9rhTbyFw ($37.35 in chips) 
REZJH+hR80RwfrJtUNUJOw: posts small blind $0.10
gN5V9qraLHmhKzjLHzt7qA: posts big blind $0.25
CYkY0dNBaYaKs8HVCVn3mQ: sits out 
*** HOLE CARDS ***
NNZypfH1f/VIj3Skf/XIzg: folds 
Xpyqpb+DURDWnyJ3xTEIFQ: folds 
X9HkgGdfFul8DB9rhTbyFw: raises $0.50 to $0.75
MG90wfSJZnOejs/KD3vlQQ: calls $0.75
u/r4MjA69AbvOh1qLp6Eig has timed out
u/r4MjA69AbvOh1qLp6Eig: folds 
u/r4MjA69AbvOh1qLp6Eig is sitting out
REZJH+hR80RwfrJtUNUJOw: folds 
gN5V9qraLHmhKzjLHzt7qA: folds 
*** FLOP *** [Tc 8s 6s]
u/r4MjA69AbvOh1qLp6Eig has returned
X9HkgGdfFul8DB9rhTbyFw: checks 
MG90wfSJZnOejs/KD3vlQQ: bets $1.40
X9HkgGdfFul8DB9rhTbyFw: calls $1.40
*** TURN *** [Tc 8s 6s] [Kd]
X9HkgGdfFul8DB9rhTbyFw: checks 
MG90wfSJZnOejs/KD3vlQQ: bets $4
X9HkgGdfFul8DB9rhTbyFw: folds 
Uncalled bet ($4) returned to MG90wfSJZnOejs/KD3vlQQ
MG90wfSJZnOejs/KD3vlQQ collected $4.45 from pot
MG90wfSJZnOejs/KD3vlQQ: doesn't show hand 
*** SUMMARY ***
Total pot $4.65 | Rake $0.20 
Board [Tc 8s 6s Kd]
Seat 2: MG90wfSJZnOejs/KD3vlQQ collected ($4.45)
Seat 3: u/r4MjA69AbvOh1qLp6Eig (button) folded before Flop (didn't bet)
Seat 4: REZJH+hR80RwfrJtUNUJOw (small blind) folded before Flop
Seat 5: gN5V9qraLHmhKzjLHzt7qA (big blind) folded before Flop
Seat 7: NNZypfH1f/VIj3Skf/XIzg folded before Flop (didn't bet)
Seat 8: Xpyqpb+DURDWnyJ3xTEIFQ folded before Flop (didn't bet)
Seat 9: X9HkgGdfFul8DB9rhTbyFw folded on the Turn




PokerStars Game #59939534762:  Hold'em No Limit ($0.10/$0.25) - 2009/07/01 0:42:21 ET
Table 'D1Yq70l0nNCyMV6DA42p+Q' 9-max Seat #8 is the button
Seat 1: z5GxcHlYz/GSz6W2uFiTtg ($14.35 in chips) 
Seat 2: OB0uLxxDeISeDjs0cxaocA ($31.60 in chips) 
Seat 3: j4q3p0lesp63b1gZDwLBZw ($5 in chips) 
Seat 5: gehe91e0IyVT0QU/XBkEyg ($26.05 in chips) 
Seat 6: MgMavn/DzTzqKgHTZMsVSw ($24.50 in chips) 
Seat 7: 9mw49/JQZ9pj0wFynA329g ($14.35 in chips) 
Seat 8: zDrucyjVn5aeekNEc3cJrA ($22.60 in chips) 
z5GxcHlYz/GSz6W2uFiTtg: posts small blind $0.10
OB0uLxxDeISeDjs0cxaocA: posts big blind $0.25
*** HOLE CARDS ***
j4q3p0lesp63b1gZDwLBZw: folds 
gehe91e0IyVT0QU/XBkEyg: calls $0.25
MgMavn/DzTzqKgHTZMsVSw: folds 
9mw49/JQZ9pj0wFynA329g: folds 
zDrucyjVn5aeekNEc3cJrA: folds 
z5GxcHlYz/GSz6W2uFiTtg: calls $0.15
OB0uLxxDeISeDjs0cxaocA: checks 
*** FLOP *** [Jd 7c 9h]
z5GxcHlYz/GSz6W2uFiTtg: bets $0.75
OB0uLxxDeISeDjs0cxaocA: calls $0.75
gehe91e0IyVT0QU/XBkEyg: folds 
*** TURN *** [Jd 7c 9h] [8d]
z5GxcHlYz/GSz6W2uFiTtg: bets $0.50
OB0uLxxDeISeDjs0cxaocA: calls $0.50
*** RIVER *** [Jd 7c 9h 8d] [Ah]
z5GxcHlYz/GSz6W2uFiTtg: bets $3
OB0uLxxDeISeDjs0cxaocA: folds 
Uncalled bet ($3) returned to z5GxcHlYz/GSz6W2uFiTtg
z5GxcHlYz/GSz6W2uFiTtg collected $3.10 from pot
*** SUMMARY ***
Total pot $3.25 | Rake $0.15 
Board [Jd 7c 9h 8d Ah]
Seat 1: z5GxcHlYz/GSz6W2uFiTtg (small blind) collected ($3.10)
Seat 2: OB0uLxxDeISeDjs0cxaocA (big blind) folded on the River
Seat 3: j4q3p0lesp63b1gZDwLBZw folded before Flop (didn't bet)
Seat 5: gehe91e0IyVT0QU/XBkEyg folded on the Flop
Seat 6: MgMavn/DzTzqKgHTZMsVSw folded before Flop (didn't bet)
Seat 7: 9mw49/JQZ9pj0wFynA329g folded before Flop (didn't bet)
Seat 8: zDrucyjVn5aeekNEc3cJrA (button) folded before Flop (didn't bet)




PokerStars Game #59939534582:  Hold'em No Limit ($0.10/$0.25) - 2009/07/01 0:42:21 ET
Table '29D3eoQzK5kOAT0OIDS2uQ' 6-max Seat #4 is the button
Seat 1: kG34n23qFQA3nzdOJTQ1dA ($50.05 in chips) 
Seat 3: z3tQwy28dp5FykDJC/wzQw ($21.20 in chips) 
Seat 4: yzFNNFIfC89bBPwpFPx2ow ($26.25 in chips) 
Seat 5: Q3EMN7b0ie81AFWkDrhCjw ($34.35 in chips) 
Seat 6: bWbV4MVB/vVpiES1Ut4hew ($44.10 in chips) 
Q3EMN7b0ie81AFWkDrhCjw: posts small blind $0.10
bWbV4MVB/vVpiES1Ut4hew: posts big blind $0.25
*** HOLE CARDS ***
kG34n23qFQA3nzdOJTQ1dA: folds 
z3tQwy28dp5FykDJC/wzQw: folds 
yzFNNFIfC89bBPwpFPx2ow: folds 
Q3EMN7b0ie81AFWkDrhCjw: calls $0.15
bWbV4MVB/vVpiES1Ut4hew: raises $1 to $1.25
Q3EMN7b0ie81AFWkDrhCjw: folds 
Uncalled bet ($1) returned to bWbV4MVB/vVpiES1Ut4hew
bWbV4MVB/vVpiES1Ut4hew collected $0.50 from pot
bWbV4MVB/vVpiES1Ut4hew: doesn't show hand 
*** SUMMARY ***
Total pot $0.50 | Rake $0 
Seat 1: kG34n23qFQA3nzdOJTQ1dA folded before Flop (didn't bet)
Seat 3: z3tQwy28dp5FykDJC/wzQw folded before Flop (didn't bet)
Seat 4: yzFNNFIfC89bBPwpFPx2ow (button) folded before Flop (didn't bet)
Seat 5: Q3EMN7b0ie81AFWkDrhCjw (small blind) folded before Flop
Seat 6: bWbV4MVB/vVpiES1Ut4hew (big blind) collected ($0.50)




PokerStars Game #59939535118:  Hold'em No Limit ($0.10/$0.25) - 2009/07/01 0:42:21 ET
Table 'CM/C/FZf3VHIp50RjmBucQ' 9-max Seat #1 is the button
Seat 1: 1Clf3cPrqoy/YgvWdWK1Xw ($5 in chips) 
Seat 2: 1S/fpm+f42V/6MNZre+ccg ($27.85 in chips) 
Seat 3: dfNim92Z6XK1/h5SFW5vDg ($29.75 in chips) 
Seat 4: oXv2YWrxjhmEfQAgUx964Q ($24.80 in chips) 
Seat 5: TeWJxSETzbXGiYKx0y+dtg ($36.80 in chips) 
Seat 6: 4awUyiDYTgylQKXZ9faBVA ($29.45 in chips) 
Seat 8: cZ99hugmLBj9KhTlc8nCSw ($26.15 in chips) 
Seat 9: Yv4fucyyT28mjx8V5lxKJg ($21.15 in chips) 
1S/fpm+f42V/6MNZre+ccg: posts small blind $0.10
dfNim92Z6XK1/h5SFW5vDg: posts big blind $0.25
j4q3p0lesp63b1gZDwLBZw: sits out 
*** HOLE CARDS ***
oXv2YWrxjhmEfQAgUx964Q: raises $0.75 to $1
TeWJxSETzbXGiYKx0y+dtg: folds 
4awUyiDYTgylQKXZ9faBVA: calls $1
cZ99hugmLBj9KhTlc8nCSw: folds 
Yv4fucyyT28mjx8V5lxKJg: calls $1
1Clf3cPrqoy/YgvWdWK1Xw: folds 
1S/fpm+f42V/6MNZre+ccg: folds 
dfNim92Z6XK1/h5SFW5vDg: folds 
*** FLOP *** [8c Qs 4h]
oXv2YWrxjhmEfQAgUx964Q: bets $1.25
4awUyiDYTgylQKXZ9faBVA: calls $1.25
Yv4fucyyT28mjx8V5lxKJg: folds 
*** TURN *** [8c Qs 4h] [3c]
oXv2YWrxjhmEfQAgUx964Q: bets $2.25
4awUyiDYTgylQKXZ9faBVA: raises $4.75 to $7
oXv2YWrxjhmEfQAgUx964Q: calls $4.75
*** RIVER *** [8c Qs 4h 3c] [9d]
oXv2YWrxjhmEfQAgUx964Q: bets $15.55 and is all-in
4awUyiDYTgylQKXZ9faBVA: calls $15.55
*** SHOW DOWN ***
oXv2YWrxjhmEfQAgUx964Q: shows [Kh Qh] (a pair of Queens)
4awUyiDYTgylQKXZ9faBVA: shows [4d 4s] (three of a kind, Fours)
4awUyiDYTgylQKXZ9faBVA collected $48.45 from pot
oXv2YWrxjhmEfQAgUx964Q leaves the table
*** SUMMARY ***
Total pot $50.95 | Rake $2.50 
Board [8c Qs 4h 3c 9d]
Seat 1: 1Clf3cPrqoy/YgvWdWK1Xw (button) folded before Flop (didn't bet)
Seat 2: 1S/fpm+f42V/6MNZre+ccg (small blind) folded before Flop
Seat 3: dfNim92Z6XK1/h5SFW5vDg (big blind) folded before Flop
Seat 4: oXv2YWrxjhmEfQAgUx964Q showed [Kh Qh] and lost with a pair of Queens
Seat 5: TeWJxSETzbXGiYKx0y+dtg folded before Flop (didn't bet)
Seat 6: 4awUyiDYTgylQKXZ9faBVA showed [4d 4s] and won ($48.45) with three of a kind, Fours
Seat 8: cZ99hugmLBj9KhTlc8nCSw folded before Flop (didn't bet)
Seat 9: Yv4fucyyT28mjx8V5lxKJg folded on the Flop




PokerStars Game #59939534920:  Hold'em No Limit ($0.10/$0.25) - 2009/07/01 0:42:21 ET
Table 'jz4TpuH+ag+0iNe2ZcxckQ' 9-max Seat #2 is the button
Seat 1: xw6ysR8BJ8Nvn+ibEf2G9w ($7.10 in chips) 
Seat 2: 18G4P1XstjNvItdGUITxgw ($30.25 in chips) 
Seat 3: Z5NNIVvnhb2IJbLcI79WYQ ($3.25 in chips) 
Seat 4: k+2r6di6GXjNpAdrRkW9bA ($65.05 in chips) 
Seat 5: uJlzv9KL7hgCIqIS2ofoaw ($8.80 in chips) 
Seat 6: ymx/m/7IEqTY+OQPano2gg ($10.70 in chips) 
Seat 7: sJNHTWcSlLHRCZ9+YRLLqA ($25 in chips) 
Seat 9: 8B/dhbQjIWe6ASCdgzktNQ ($25 in chips) 
Z5NNIVvnhb2IJbLcI79WYQ: posts small blind $0.10
k+2r6di6GXjNpAdrRkW9bA: posts big blind $0.25
DlXs37dlX3tb7o/7lYXQSw: sits out 
*** HOLE CARDS ***
uJlzv9KL7hgCIqIS2ofoaw: folds 
ymx/m/7IEqTY+OQPano2gg: calls $0.25
sJNHTWcSlLHRCZ9+YRLLqA: folds 
8B/dhbQjIWe6ASCdgzktNQ: folds 
xw6ysR8BJ8Nvn+ibEf2G9w: calls $0.25
18G4P1XstjNvItdGUITxgw: folds 
Z5NNIVvnhb2IJbLcI79WYQ: calls $0.15
k+2r6di6GXjNpAdrRkW9bA: checks 
*** FLOP *** [2h 8d 3s]
Z5NNIVvnhb2IJbLcI79WYQ: checks 
k+2r6di6GXjNpAdrRkW9bA: bets $0.50
ymx/m/7IEqTY+OQPano2gg: calls $0.50
xw6ysR8BJ8Nvn+ibEf2G9w: calls $0.50
Z5NNIVvnhb2IJbLcI79WYQ: calls $0.50
*** TURN *** [2h 8d 3s] [Ac]
Z5NNIVvnhb2IJbLcI79WYQ: checks 
k+2r6di6GXjNpAdrRkW9bA: bets $0.50
ymx/m/7IEqTY+OQPano2gg: folds 
xw6ysR8BJ8Nvn+ibEf2G9w: calls $0.50
Z5NNIVvnhb2IJbLcI79WYQ: calls $0.50
*** RIVER *** [2h 8d 3s Ac] [6d]
Z5NNIVvnhb2IJbLcI79WYQ: checks 
k+2r6di6GXjNpAdrRkW9bA: bets $1.50
xw6ysR8BJ8Nvn+ibEf2G9w: folds 
Z5NNIVvnhb2IJbLcI79WYQ: calls $1.50
*** SHOW DOWN ***
k+2r6di6GXjNpAdrRkW9bA: shows [8c 6c] (two pair, Eights and Sixes)
Z5NNIVvnhb2IJbLcI79WYQ: mucks hand 
k+2r6di6GXjNpAdrRkW9bA collected $7.15 from pot
*** SUMMARY ***
Total pot $7.50 | Rake $0.35 
Board [2h 8d 3s Ac 6d]
Seat 1: xw6ysR8BJ8Nvn+ibEf2G9w folded on the River
Seat 2: 18G4P1XstjNvItdGUITxgw (button) folded before Flop (didn't bet)
Seat 3: Z5NNIVvnhb2IJbLcI79WYQ (small blind) mucked
Seat 4: k+2r6di6GXjNpAdrRkW9bA (big blind) showed [8c 6c] and won ($7.15) with two pair, Eights and Sixes
Seat 5: uJlzv9KL7hgCIqIS2ofoaw folded before Flop (didn't bet)
Seat 6: ymx/m/7IEqTY+OQPano2gg folded on the Turn
Seat 7: sJNHTWcSlLHRCZ9+YRLLqA folded before Flop (didn't bet)
Seat 9: 8B/dhbQjIWe6ASCdgzktNQ folded before Flop (didn't bet)




PokerStars Game #59939535106:  Hold'em No Limit ($0.10/$0.25) - 2009/07/01 0:42:21 ET
Table '52Meibn9NOL4XtVi1p2Upw' 9-max Seat #5 is the button
Seat 1: LSrAei+fS8MYG9ie/GkG0Q ($13.05 in chips) 
Seat 2: BEIBUu2pIflPrCL+Iks4CQ ($12.25 in chips) 
Seat 3: MzBvksetB8XYtCt0FExJMg ($15.25 in chips) 
Seat 4: rCaXm4/EwAgWqCiClpbsqQ ($8.65 in chips) 
Seat 5: 4oA316mXLIui1QY63GXBUg ($26.75 in chips) 
Seat 6: 1wKfgJ8xXIiuc8C6qjkxhg ($5.80 in chips) 
Seat 7: R3KkgiqTvuhazyCqaD9cZg ($10 in chips) 
Seat 8: eKma8Z98pP7H8m4CEt075w ($23.45 in chips) 
Seat 9: 8B/dhbQjIWe6ASCdgzktNQ ($30.10 in chips) 
1wKfgJ8xXIiuc8C6qjkxhg: posts small blind $0.10
R3KkgiqTvuhazyCqaD9cZg: posts big blind $0.25
*** HOLE CARDS ***
eKma8Z98pP7H8m4CEt075w: folds 
8B/dhbQjIWe6ASCdgzktNQ: folds 
LSrAei+fS8MYG9ie/GkG0Q: folds 
BEIBUu2pIflPrCL+Iks4CQ: folds 
MzBvksetB8XYtCt0FExJMg: calls $0.25
rCaXm4/EwAgWqCiClpbsqQ: folds 
4oA316mXLIui1QY63GXBUg: folds 
1wKfgJ8xXIiuc8C6qjkxhg: calls $0.15
R3KkgiqTvuhazyCqaD9cZg: checks 
*** FLOP *** [Js 3d 3h]
1wKfgJ8xXIiuc8C6qjkxhg: checks 
R3KkgiqTvuhazyCqaD9cZg: checks 
MzBvksetB8XYtCt0FExJMg: bets $0.75
1wKfgJ8xXIiuc8C6qjkxhg: calls $0.75
R3KkgiqTvuhazyCqaD9cZg: folds 
*** TURN *** [Js 3d 3h] [Qc]
1wKfgJ8xXIiuc8C6qjkxhg: checks 
MzBvksetB8XYtCt0FExJMg: bets $0.75
1wKfgJ8xXIiuc8C6qjkxhg: calls $0.75
*** RIVER *** [Js 3d 3h Qc] [Qs]
1wKfgJ8xXIiuc8C6qjkxhg: bets $2
MzBvksetB8XYtCt0FExJMg: calls $2
*** SHOW DOWN ***
1wKfgJ8xXIiuc8C6qjkxhg: shows [7s 3c] (a full house, Threes full of Queens)
MzBvksetB8XYtCt0FExJMg: mucks hand 
1wKfgJ8xXIiuc8C6qjkxhg collected $7.40 from pot
*** SUMMARY ***
Total pot $7.75 | Rake $0.35 
Board [Js 3d 3h Qc Qs]
Seat 1: LSrAei+fS8MYG9ie/GkG0Q folded before Flop (didn't bet)
Seat 2: BEIBUu2pIflPrCL+Iks4CQ folded before Flop (didn't bet)
Seat 3: MzBvksetB8XYtCt0FExJMg mucked
Seat 4: rCaXm4/EwAgWqCiClpbsqQ folded before Flop (didn't bet)
Seat 5: 4oA316mXLIui1QY63GXBUg (button) folded before Flop (didn't bet)
Seat 6: 1wKfgJ8xXIiuc8C6qjkxhg (small blind) showed [7s 3c] and won ($7.40) with a full house, Threes full of Queens
Seat 7: R3KkgiqTvuhazyCqaD9cZg (big blind) folded on the Flop
Seat 8: eKma8Z98pP7H8m4CEt075w folded before Flop (didn't bet)
Seat 9: 8B/dhbQjIWe6ASCdgzktNQ folded before Flop (didn't bet)




PokerStars Game #59939534550:  Hold'em No Limit ($0.10/$0.25) - 2009/07/01 0:42:21 ET
Table 'yZgGBnUGXVCcEJdcqes8tw' 9-max Seat #1 is the button
Seat 1: SXqVW4Q0evTUVZG6BbUNIA ($23.70 in chips) 
Seat 2: MG90wfSJZnOejs/KD3vlQQ ($25 in chips) 
Seat 3: z5GxcHlYz/GSz6W2uFiTtg ($26.40 in chips) 
Seat 4: opOCI2p6kW0tINuVaAqmcQ ($25.70 in chips) 
Seat 5: IGz29GAFM1DpSdXX+wXg3g ($16.90 in chips) 
Seat 6: H9i0g723A2AKb4nSMXqMPQ ($20.65 in chips) 
Seat 7: eC8Pn1D6Y2pct8o62nQfvQ ($28.05 in chips) 
Seat 8: dmYlc+1cjwZMJ7wV+Z0rRg ($25.15 in chips) 
Seat 9: M/9j4wkHH9i1JM51vgi1VA ($30.10 in chips) 
MG90wfSJZnOejs/KD3vlQQ: posts small blind $0.10
z5GxcHlYz/GSz6W2uFiTtg: posts big blind $0.25
*** HOLE CARDS ***
opOCI2p6kW0tINuVaAqmcQ: folds 
IGz29GAFM1DpSdXX+wXg3g: raises $0.25 to $0.50
H9i0g723A2AKb4nSMXqMPQ: folds 
eC8Pn1D6Y2pct8o62nQfvQ: folds 
dmYlc+1cjwZMJ7wV+Z0rRg: folds 
M/9j4wkHH9i1JM51vgi1VA: folds 
SXqVW4Q0evTUVZG6BbUNIA: folds 
MG90wfSJZnOejs/KD3vlQQ: folds 
z5GxcHlYz/GSz6W2uFiTtg: folds 
Uncalled bet ($0.25) returned to IGz29GAFM1DpSdXX+wXg3g
IGz29GAFM1DpSdXX+wXg3g collected $0.60 from pot
*** SUMMARY ***
Total pot $0.60 | Rake $0 
Seat 1: SXqVW4Q0evTUVZG6BbUNIA (button) folded before Flop (didn't bet)
Seat 2: MG90wfSJZnOejs/KD3vlQQ (small blind) folded before Flop
Seat 3: z5GxcHlYz/GSz6W2uFiTtg (big blind) folded before Flop
Seat 4: opOCI2p6kW0tINuVaAqmcQ folded before Flop (didn't bet)
Seat 5: IGz29GAFM1DpSdXX+wXg3g collected ($0.60)
Seat 6: H9i0g723A2AKb4nSMXqMPQ folded before Flop (didn't bet)
Seat 7: eC8Pn1D6Y2pct8o62nQfvQ folded before Flop (didn't bet)
Seat 8: dmYlc+1cjwZMJ7wV+Z0rRg folded before Flop (didn't bet)
Seat 9: M/9j4wkHH9i1JM51vgi1VA folded before Flop (didn't bet)




PokerStars Game #59939535232:  Hold'em No Limit ($0.10/$0.25) - 2009/07/01 0:42:22 ET
Table '1HT8bEDpLPhOXxmqMtzF8w' 9-max Seat #6 is the button
Seat 1: s7Q6uNouhe7aE8JdFb9E+A ($26.20 in chips) 
Seat 2: r6hsffOo1iKmaPYKwAZmFw ($31.25 in chips) 
Seat 3: UJbH2fMMSFUo/jbJteWjjQ ($4.75 in chips) 
Seat 4: Hlc+zGHlRwk7JHfQklkT2g ($15.55 in chips) 
Seat 5: +iRmxp/CsJ/zuqdUG3CXNw ($15 in chips) 
Seat 6: 4oA316mXLIui1QY63GXBUg ($25 in chips) 
Seat 7: DIBbjEYGs+TVdVgEB/4+3w ($30.10 in chips) 
Seat 8: ghNKXUBl/H+t83JF079ZBA ($25 in chips) 
Seat 9: 86vbuhJsyH+nbEg5qpDLyQ ($21.50 in chips) 
DIBbjEYGs+TVdVgEB/4+3w: posts small blind $0.10
ghNKXUBl/H+t83JF079ZBA: posts big blind $0.25
+iRmxp/CsJ/zuqdUG3CXNw: posts small blind $0.10
*** HOLE CARDS ***
86vbuhJsyH+nbEg5qpDLyQ: folds 
s7Q6uNouhe7aE8JdFb9E+A: folds 
r6hsffOo1iKmaPYKwAZmFw: folds 
UJbH2fMMSFUo/jbJteWjjQ: folds 
Hlc+zGHlRwk7JHfQklkT2g: folds 
+iRmxp/CsJ/zuqdUG3CXNw: calls $0.25
4oA316mXLIui1QY63GXBUg: folds 
DIBbjEYGs+TVdVgEB/4+3w: calls $0.15
ghNKXUBl/H+t83JF079ZBA: raises $1.25 to $1.50
+iRmxp/CsJ/zuqdUG3CXNw: folds 
DIBbjEYGs+TVdVgEB/4+3w: folds 
Uncalled bet ($1.25) returned to ghNKXUBl/H+t83JF079ZBA
ghNKXUBl/H+t83JF079ZBA collected $0.85 from pot
ghNKXUBl/H+t83JF079ZBA: doesn't show hand 
*** SUMMARY ***
Total pot $0.85 | Rake $0 
Seat 1: s7Q6uNouhe7aE8JdFb9E+A folded before Flop (didn't bet)
Seat 2: r6hsffOo1iKmaPYKwAZmFw folded before Flop (didn't bet)
Seat 3: UJbH2fMMSFUo/jbJteWjjQ folded before Flop (didn't bet)
Seat 4: Hlc+zGHlRwk7JHfQklkT2g folded before Flop (didn't bet)
Seat 5: +iRmxp/CsJ/zuqdUG3CXNw folded before Flop
Seat 6: 4oA316mXLIui1QY63GXBUg (button) folded before Flop (didn't bet)
Seat 7: DIBbjEYGs+TVdVgEB/4+3w (small blind) folded before Flop
Seat 8: ghNKXUBl/H+t83JF079ZBA (big blind) collected ($0.85)
Seat 9: 86vbuhJsyH+nbEg5qpDLyQ folded before Flop (didn't bet)




PokerStars Game #59939536120:  Hold'em No Limit ($0.10/$0.25) - 2009/07/01 0:42:23 ET
Table 'P2yJ+jwfNsBdF12fLKA6DQ' 9-max Seat #7 is the button
Seat 1: zDrucyjVn5aeekNEc3cJrA ($26.25 in chips) 
Seat 3: aNpwfA31EREwO+ar4XzBCw ($27.20 in chips) 
Seat 4: dfNim92Z6XK1/h5SFW5vDg ($25 in chips) 
Seat 5: KUcJLaHvrSlvGyIGqDQp9A ($15.70 in chips) 
Seat 6: tIIUJycKjdqE3z/SXWAEwA ($2.40 in chips) 
Seat 7: 1/DuWziR8CXhWB71aPQd9Q ($9.65 in chips) 
Seat 8: LWN1wPrLH+695JIriXxDuw ($9.75 in chips) 
Seat 9: Jurq55Mpn9JwRMif6CgVxw ($5.75 in chips) 
LWN1wPrLH+695JIriXxDuw: posts small blind $0.10
Jurq55Mpn9JwRMif6CgVxw: posts big blind $0.25
V6p0jQ/RhUsqpHLmXvEX4Q: sits out 
*** HOLE CARDS ***
tIIUJycKjdqE3z/SXWAEwA said, "lololololol"
zDrucyjVn5aeekNEc3cJrA: folds 
aNpwfA31EREwO+ar4XzBCw: folds 
dfNim92Z6XK1/h5SFW5vDg: folds 
tIIUJycKjdqE3z/SXWAEwA said, "nice calls all the way around"
KUcJLaHvrSlvGyIGqDQp9A: folds 
tIIUJycKjdqE3z/SXWAEwA: folds 
1/DuWziR8CXhWB71aPQd9Q: folds 
LWN1wPrLH+695JIriXxDuw: raises $0.50 to $0.75
Jurq55Mpn9JwRMif6CgVxw: raises $0.50 to $1.25
LWN1wPrLH+695JIriXxDuw: raises $0.50 to $1.75
Jurq55Mpn9JwRMif6CgVxw: raises $4 to $5.75 and is all-in
LWN1wPrLH+695JIriXxDuw: calls $4
*** FLOP *** [9c Qc 5c]
*** TURN *** [9c Qc 5c] [Qh]
*** RIVER *** [9c Qc 5c Qh] [6c]
*** SHOW DOWN ***
LWN1wPrLH+695JIriXxDuw: shows [Jc Js] (a flush, Queen high)
Jurq55Mpn9JwRMif6CgVxw: mucks hand 
LWN1wPrLH+695JIriXxDuw collected $10.95 from pot
*** SUMMARY ***
Total pot $11.50 | Rake $0.55 
Board [9c Qc 5c Qh 6c]
Seat 1: zDrucyjVn5aeekNEc3cJrA folded before Flop (didn't bet)
Seat 3: aNpwfA31EREwO+ar4XzBCw folded before Flop (didn't bet)
Seat 4: dfNim92Z6XK1/h5SFW5vDg folded before Flop (didn't bet)
Seat 5: KUcJLaHvrSlvGyIGqDQp9A folded before Flop (didn't bet)
Seat 6: tIIUJycKjdqE3z/SXWAEwA folded before Flop (didn't bet)
Seat 7: 1/DuWziR8CXhWB71aPQd9Q (button) folded before Flop (didn't bet)
Seat 8: LWN1wPrLH+695JIriXxDuw (small blind) showed [Jc Js] and won ($10.95) with a flush, Queen high
Seat 9: Jurq55Mpn9JwRMif6CgVxw (big blind) mucked




PokerStars Game #59939536198:  Hold'em No Limit ($0.10/$0.25) - 2009/07/01 0:42:23 ET
Table 'IIO2q2znuuAXmiZ2qFTcmg' 6-max Seat #2 is the button
Seat 1: nwwpaieDRI0UPyVtChVHOg ($18.35 in chips) 
Seat 2: cS21pIxRHx5Gt42o7hPZzw ($16.85 in chips) 
Seat 3: hiTEr3yrERiQp3zHXRioVw ($13.65 in chips) 
Seat 4: 0HIrwssk0FQvyKULzUTtlg ($9.75 in chips) 
Seat 5: f9iRHw0d+kV7pbTYwF2+2g ($16.70 in chips) 
hiTEr3yrERiQp3zHXRioVw: posts small blind $0.10
0HIrwssk0FQvyKULzUTtlg: posts big blind $0.25
*** HOLE CARDS ***
f9iRHw0d+kV7pbTYwF2+2g: calls $0.25
nwwpaieDRI0UPyVtChVHOg: calls $0.25
cS21pIxRHx5Gt42o7hPZzw: folds 
hiTEr3yrERiQp3zHXRioVw: folds 
0HIrwssk0FQvyKULzUTtlg: checks 
*** FLOP *** [Qs 8c 8s]
0HIrwssk0FQvyKULzUTtlg: checks 
f9iRHw0d+kV7pbTYwF2+2g: checks 
nwwpaieDRI0UPyVtChVHOg: checks 
*** TURN *** [Qs 8c 8s] [7s]
0HIrwssk0FQvyKULzUTtlg: checks 
f9iRHw0d+kV7pbTYwF2+2g: checks 
nwwpaieDRI0UPyVtChVHOg: checks 
*** RIVER *** [Qs 8c 8s 7s] [4h]
0HIrwssk0FQvyKULzUTtlg: checks 
f9iRHw0d+kV7pbTYwF2+2g: checks 
nwwpaieDRI0UPyVtChVHOg: checks 
*** SHOW DOWN ***
0HIrwssk0FQvyKULzUTtlg: shows [Kc 4s] (two pair, Eights and Fours)
f9iRHw0d+kV7pbTYwF2+2g: mucks hand 
nwwpaieDRI0UPyVtChVHOg: mucks hand 
0HIrwssk0FQvyKULzUTtlg collected $0.85 from pot
*** SUMMARY ***
Total pot $0.85 | Rake $0 
Board [Qs 8c 8s 7s 4h]
Seat 1: nwwpaieDRI0UPyVtChVHOg mucked
Seat 2: cS21pIxRHx5Gt42o7hPZzw (button) folded before Flop (didn't bet)
Seat 3: hiTEr3yrERiQp3zHXRioVw (small blind) folded before Flop
Seat 4: 0HIrwssk0FQvyKULzUTtlg (big blind) showed [Kc 4s] and won ($0.85) with two pair, Eights and Fours
Seat 5: f9iRHw0d+kV7pbTYwF2+2g mucked




PokerStars Game #59939536424:  Hold'em No Limit ($0.10/$0.25) - 2009/07/01 0:42:23 ET
Table 'HbNAGS1OJWQKyfk7UfrYyw' 9-max Seat #6 is the button
Seat 1: YHeeiaUNFin/MUYZJuW1VA ($10.65 in chips) 
Seat 2: Jt0gcXubHx3//kZT9X5jGQ ($28.05 in chips) 
Seat 3: DIBbjEYGs+TVdVgEB/4+3w ($30.20 in chips) 
Seat 5: cu58S48zQeRuppc18okJLA ($16.10 in chips) 
Seat 6: W4TLQcZ2TiM73eIgpIvlGg ($26.35 in chips) 
Seat 7: JJH2Xc95hFewheF67vSv4Q ($11.50 in chips) 
Seat 8: fsTS8sDyZ7BxKQFEMv9xCg ($6 in chips) 
JJH2Xc95hFewheF67vSv4Q: posts small blind $0.10
fsTS8sDyZ7BxKQFEMv9xCg: posts big blind $0.25
*** HOLE CARDS ***
YHeeiaUNFin/MUYZJuW1VA: calls $0.25
Jt0gcXubHx3//kZT9X5jGQ: folds 
DIBbjEYGs+TVdVgEB/4+3w: folds 
cu58S48zQeRuppc18okJLA: calls $0.25
W4TLQcZ2TiM73eIgpIvlGg: calls $0.25
JJH2Xc95hFewheF67vSv4Q: calls $0.15
fsTS8sDyZ7BxKQFEMv9xCg: checks 
*** FLOP *** [5h 3d Ad]
JJH2Xc95hFewheF67vSv4Q: checks 
Jt0gcXubHx3//kZT9X5jGQ leaves the table
fsTS8sDyZ7BxKQFEMv9xCg: checks 
YHeeiaUNFin/MUYZJuW1VA: checks 
cu58S48zQeRuppc18okJLA: checks 
W4TLQcZ2TiM73eIgpIvlGg: checks 
*** TURN *** [5h 3d Ad] [Kd]
JJH2Xc95hFewheF67vSv4Q: checks 
fsTS8sDyZ7BxKQFEMv9xCg: bets $0.25
YHeeiaUNFin/MUYZJuW1VA: folds 
cu58S48zQeRuppc18okJLA: folds 
W4TLQcZ2TiM73eIgpIvlGg: folds 
JJH2Xc95hFewheF67vSv4Q: folds 
Uncalled bet ($0.25) returned to fsTS8sDyZ7BxKQFEMv9xCg
fsTS8sDyZ7BxKQFEMv9xCg collected $1.20 from pot
fsTS8sDyZ7BxKQFEMv9xCg: doesn't show hand 
*** SUMMARY ***
Total pot $1.25 | Rake $0.05 
Board [5h 3d Ad Kd]
Seat 1: YHeeiaUNFin/MUYZJuW1VA folded on the Turn
Seat 2: Jt0gcXubHx3//kZT9X5jGQ folded before Flop (didn't bet)
Seat 3: DIBbjEYGs+TVdVgEB/4+3w folded before Flop (didn't bet)
Seat 5: cu58S48zQeRuppc18okJLA folded on the Turn
Seat 6: W4TLQcZ2TiM73eIgpIvlGg (button) folded on the Turn
Seat 7: JJH2Xc95hFewheF67vSv4Q (small blind) folded on the Turn
Seat 8: fsTS8sDyZ7BxKQFEMv9xCg (big blind) collected ($1.20)




PokerStars Game #59939536240:  Hold'em No Limit ($0.10/$0.25) - 2009/07/01 0:42:23 ET
Table '4XGDnEByOol5up4aB2KbJw' 6-max Seat #3 is the button
Seat 1: kyRaCIljYA6l33lSKQfNsg ($26.30 in chips) 
Seat 2: SFmT9ZsVopnukjvAzrxTRg ($33.85 in chips) 
Seat 3: LtASJ9OlkqGrrUKGQlpGAw ($23.25 in chips) 
Seat 4: sjoibHX/s93+8Kwa5aB1dA ($27.60 in chips) 
Seat 5: Dh01+rohD2p9pXLYeBlC5Q ($18.25 in chips) 
Seat 6: ELW+DKizJhLK7k40PMkD2Q ($28.10 in chips) 
sjoibHX/s93+8Kwa5aB1dA: posts small blind $0.10
Dh01+rohD2p9pXLYeBlC5Q: posts big blind $0.25
*** HOLE CARDS ***
ELW+DKizJhLK7k40PMkD2Q: raises $0.75 to $1
kyRaCIljYA6l33lSKQfNsg: calls $1
SFmT9ZsVopnukjvAzrxTRg: folds 
LtASJ9OlkqGrrUKGQlpGAw: folds 
sjoibHX/s93+8Kwa5aB1dA: folds 
sjoibHX/s93+8Kwa5aB1dA is sitting out
Dh01+rohD2p9pXLYeBlC5Q: calls $0.75
*** FLOP *** [2d Ac 5s]
Dh01+rohD2p9pXLYeBlC5Q: checks 
ELW+DKizJhLK7k40PMkD2Q: bets $1.75
kyRaCIljYA6l33lSKQfNsg: calls $1.75
Dh01+rohD2p9pXLYeBlC5Q: folds 
*** TURN *** [2d Ac 5s] [Ad]
ELW+DKizJhLK7k40PMkD2Q: bets $3.85
kyRaCIljYA6l33lSKQfNsg: calls $3.85
*** RIVER *** [2d Ac 5s Ad] [9c]
ELW+DKizJhLK7k40PMkD2Q: bets $10
kyRaCIljYA6l33lSKQfNsg: folds 
Uncalled bet ($10) returned to ELW+DKizJhLK7k40PMkD2Q
ELW+DKizJhLK7k40PMkD2Q collected $13.60 from pot
*** SUMMARY ***
Total pot $14.30 | Rake $0.70 
Board [2d Ac 5s Ad 9c]
Seat 1: kyRaCIljYA6l33lSKQfNsg folded on the River
Seat 2: SFmT9ZsVopnukjvAzrxTRg folded before Flop (didn't bet)
Seat 3: LtASJ9OlkqGrrUKGQlpGAw (button) folded before Flop (didn't bet)
Seat 4: sjoibHX/s93+8Kwa5aB1dA (small blind) folded before Flop
Seat 5: Dh01+rohD2p9pXLYeBlC5Q (big blind) folded on the Flop
Seat 6: ELW+DKizJhLK7k40PMkD2Q collected ($13.60)




PokerStars Game #59939536702:  Hold'em No Limit ($0.10/$0.25) - 2009/07/01 0:42:24 ET
Table 'edvgY2YQ1I34euq4EVqGnA' 6-max Seat #4 is the button
Seat 1: mvFHK3pE7tCxJEqLjKC70Q ($26.90 in chips) 
Seat 2: 0vuFCuW1P8y6cFZZvuXNPg ($12.20 in chips) 
Seat 3: HjESR5/RHWT5gaSbIVQQ0Q ($17.75 in chips) 
Seat 4: JFIAqU8lCZ0vWwEl4bdGsg ($29.60 in chips) 
Seat 5: EE16Ua5b1HSsYej5zeXOlA ($25.35 in chips) 
Seat 6: kG34n23qFQA3nzdOJTQ1dA ($68.60 in chips) 
EE16Ua5b1HSsYej5zeXOlA: posts small blind $0.10
kG34n23qFQA3nzdOJTQ1dA: posts big blind $0.25
*** HOLE CARDS ***
mvFHK3pE7tCxJEqLjKC70Q: folds 
0vuFCuW1P8y6cFZZvuXNPg said, "jnljlkjlj'lj"
0vuFCuW1P8y6cFZZvuXNPg said, "kjljlkjkljljlkjpoipio"
0vuFCuW1P8y6cFZZvuXNPg said, "ljl.m,jlj'[o"
0vuFCuW1P8y6cFZZvuXNPg said, "lkkljlkj'l'ljljljkl'j'j'j''lj'"
0vuFCuW1P8y6cFZZvuXNPg said, "kljjjjjjjjjjjjjjjjjjjjjjjjjjjjjjjjjjjjjjjjjjjjjjjjjjjjjjjjjjjjjjjjjjjllllllllllllllllllllllllllllllliiiiiiiiiiiiiiiiiiiiiiiiiiiiiiiioooooo0o"
0vuFCuW1P8y6cFZZvuXNPg said, "jjhhhkkl'kl'jhk'lj'klj'j'j'j'lj''"
0vuFCuW1P8y6cFZZvuXNPg said, "j'"
0vuFCuW1P8y6cFZZvuXNPg has timed out while being disconnected
0vuFCuW1P8y6cFZZvuXNPg: folds 
0vuFCuW1P8y6cFZZvuXNPg is sitting out
0vuFCuW1P8y6cFZZvuXNPg is disconnected 
HjESR5/RHWT5gaSbIVQQ0Q: calls $0.25
JFIAqU8lCZ0vWwEl4bdGsg: folds 
EE16Ua5b1HSsYej5zeXOlA: folds 
kG34n23qFQA3nzdOJTQ1dA: checks 
*** FLOP *** [Ts 4d 6h]
kG34n23qFQA3nzdOJTQ1dA: checks 
HjESR5/RHWT5gaSbIVQQ0Q: checks 
*** TURN *** [Ts 4d 6h] [8s]
0vuFCuW1P8y6cFZZvuXNPg is connected 
kG34n23qFQA3nzdOJTQ1dA: checks 
HjESR5/RHWT5gaSbIVQQ0Q: bets $0.50
kG34n23qFQA3nzdOJTQ1dA: folds 
Uncalled bet ($0.50) returned to HjESR5/RHWT5gaSbIVQQ0Q
HjESR5/RHWT5gaSbIVQQ0Q collected $0.60 from pot
*** SUMMARY ***
Total pot $0.60 | Rake $0 
Board [Ts 4d 6h 8s]
Seat 1: mvFHK3pE7tCxJEqLjKC70Q folded before Flop (didn't bet)
Seat 2: 0vuFCuW1P8y6cFZZvuXNPg folded before Flop (didn't bet)
Seat 3: HjESR5/RHWT5gaSbIVQQ0Q collected ($0.60)
Seat 4: JFIAqU8lCZ0vWwEl4bdGsg (button) folded before Flop (didn't bet)
Seat 5: EE16Ua5b1HSsYej5zeXOlA (small blind) folded before Flop
Seat 6: kG34n23qFQA3nzdOJTQ1dA (big blind) folded on the Turn




PokerStars Game #59939536766:  Hold'em No Limit ($0.10/$0.25) - 2009/07/01 0:42:24 ET
Table 'isKy4XK8wJM0x735/D4hWA' 6-max Seat #1 is the button
Seat 1: 7FmwVDcdEtxDpHmP4hOXsQ ($25 in chips) 
Seat 2: WrLI51S2iMb8GLMB83gGqA ($27.20 in chips) 
Seat 3: jp34e617tIzV8tKIWmfAbA ($25 in chips) 
Seat 4: k9vn40MOqqb+xF+7GZ6v2g ($24.65 in chips) 
Seat 5: zlYHXTtJ5tcx9kwK2h5n9A ($37.40 in chips) 
Seat 6: M6xK/VklCvdyyrmvzATlxQ ($13.75 in chips) 
WrLI51S2iMb8GLMB83gGqA: posts small blind $0.10
jp34e617tIzV8tKIWmfAbA: posts big blind $0.25
*** HOLE CARDS ***
k9vn40MOqqb+xF+7GZ6v2g: folds 
zlYHXTtJ5tcx9kwK2h5n9A: calls $0.25
M6xK/VklCvdyyrmvzATlxQ: folds 
7FmwVDcdEtxDpHmP4hOXsQ: folds 
WrLI51S2iMb8GLMB83gGqA: folds 
jp34e617tIzV8tKIWmfAbA: checks 
*** FLOP *** [Th 4h 7s]
jp34e617tIzV8tKIWmfAbA: checks 
zlYHXTtJ5tcx9kwK2h5n9A: bets $0.25
jp34e617tIzV8tKIWmfAbA: folds 
Uncalled bet ($0.25) returned to zlYHXTtJ5tcx9kwK2h5n9A
zlYHXTtJ5tcx9kwK2h5n9A collected $0.60 from pot
zlYHXTtJ5tcx9kwK2h5n9A: doesn't show hand 
*** SUMMARY ***
Total pot $0.60 | Rake $0 
Board [Th 4h 7s]
Seat 1: 7FmwVDcdEtxDpHmP4hOXsQ (button) folded before Flop (didn't bet)
Seat 2: WrLI51S2iMb8GLMB83gGqA (small blind) folded before Flop
Seat 3: jp34e617tIzV8tKIWmfAbA (big blind) folded on the Flop
Seat 4: k9vn40MOqqb+xF+7GZ6v2g folded before Flop (didn't bet)
Seat 5: zlYHXTtJ5tcx9kwK2h5n9A collected ($0.60)
Seat 6: M6xK/VklCvdyyrmvzATlxQ folded before Flop (didn't bet)




PokerStars Game #59939536734:  Hold'em No Limit ($0.10/$0.25) - 2009/07/01 0:42:24 ET
Table 'SHi8+hK6i7E2dJ/3Agbyig' 6-max Seat #1 is the button
Seat 1: gPEN9Zp33YTm/mu9/SYP1w ($26.60 in chips) 
Seat 2: Zijzy/UtPWzWVUo81HHVjQ ($40.90 in chips) 
Seat 3: 2p/OXJK5bWQbcvYltdbSfg ($30.05 in chips) 
Seat 4: +KSG/hZ6NXRHDk1WHcV2+Q ($14.90 in chips) 
Seat 5: T5wrp/d5jarm+SxNy8OQAg ($17.45 in chips) 
Seat 6: NVWCcUck2mqZMp/UrHDLKQ ($11.15 in chips) 
Zijzy/UtPWzWVUo81HHVjQ: posts small blind $0.10
2p/OXJK5bWQbcvYltdbSfg: posts big blind $0.25
*** HOLE CARDS ***
+KSG/hZ6NXRHDk1WHcV2+Q: calls $0.25
T5wrp/d5jarm+SxNy8OQAg: folds 
NVWCcUck2mqZMp/UrHDLKQ: raises $0.75 to $1
gPEN9Zp33YTm/mu9/SYP1w: calls $1
Zijzy/UtPWzWVUo81HHVjQ: folds 
2p/OXJK5bWQbcvYltdbSfg: folds 
+KSG/hZ6NXRHDk1WHcV2+Q: calls $0.75
*** FLOP *** [Th Td 4d]
+KSG/hZ6NXRHDk1WHcV2+Q: checks 
NVWCcUck2mqZMp/UrHDLKQ: bets $1
gPEN9Zp33YTm/mu9/SYP1w: folds 
+KSG/hZ6NXRHDk1WHcV2+Q: folds 
Uncalled bet ($1) returned to NVWCcUck2mqZMp/UrHDLKQ
NVWCcUck2mqZMp/UrHDLKQ collected $3.20 from pot
*** SUMMARY ***
Total pot $3.35 | Rake $0.15 
Board [Th Td 4d]
Seat 1: gPEN9Zp33YTm/mu9/SYP1w (button) folded on the Flop
Seat 2: Zijzy/UtPWzWVUo81HHVjQ (small blind) folded before Flop
Seat 3: 2p/OXJK5bWQbcvYltdbSfg (big blind) folded before Flop
Seat 4: +KSG/hZ6NXRHDk1WHcV2+Q folded on the Flop
Seat 5: T5wrp/d5jarm+SxNy8OQAg folded before Flop (didn't bet)
Seat 6: NVWCcUck2mqZMp/UrHDLKQ collected ($3.20)




PokerStars Game #59939536628:  Hold'em No Limit ($0.10/$0.25) - 2009/07/01 0:42:24 ET
Table 'NfXsh0UQA+o/kO9acV3WxA' 9-max Seat #9 is the button
Seat 1: H5Se03ZqSX7tbULXur2MAg ($24.40 in chips) 
Seat 3: 1K6QGyJP9P9xmRac2fH4OQ ($37.80 in chips) 
Seat 4: sQ6szDwWrE+LMh1p4dVexA ($17.10 in chips) 
Seat 5: 3RCAkueG3Vc13VpRStCB+w ($37.80 in chips) 
Seat 7: HPEB+AtKw1+C/cxU0o1ciw ($31.60 in chips) 
Seat 8: +sbyWwIcFp9kP0bDtMegfQ ($24.65 in chips) 
Seat 9: MgMavn/DzTzqKgHTZMsVSw ($24.65 in chips) 
H5Se03ZqSX7tbULXur2MAg: posts small blind $0.10
1K6QGyJP9P9xmRac2fH4OQ: posts big blind $0.25
*** HOLE CARDS ***
sQ6szDwWrE+LMh1p4dVexA: folds 
3RCAkueG3Vc13VpRStCB+w: folds 
HPEB+AtKw1+C/cxU0o1ciw: folds 
+sbyWwIcFp9kP0bDtMegfQ: folds 
MgMavn/DzTzqKgHTZMsVSw: calls $0.25
H5Se03ZqSX7tbULXur2MAg: calls $0.15
1K6QGyJP9P9xmRac2fH4OQ: checks 
*** FLOP *** [Td Ts 3s]
H5Se03ZqSX7tbULXur2MAg: bets $0.75
1K6QGyJP9P9xmRac2fH4OQ: folds 
MgMavn/DzTzqKgHTZMsVSw: folds 
Uncalled bet ($0.75) returned to H5Se03ZqSX7tbULXur2MAg
H5Se03ZqSX7tbULXur2MAg collected $0.75 from pot
*** SUMMARY ***
Total pot $0.75 | Rake $0 
Board [Td Ts 3s]
Seat 1: H5Se03ZqSX7tbULXur2MAg (small blind) collected ($0.75)
Seat 3: 1K6QGyJP9P9xmRac2fH4OQ (big blind) folded on the Flop
Seat 4: sQ6szDwWrE+LMh1p4dVexA folded before Flop (didn't bet)
Seat 5: 3RCAkueG3Vc13VpRStCB+w folded before Flop (didn't bet)
Seat 7: HPEB+AtKw1+C/cxU0o1ciw folded before Flop (didn't bet)
Seat 8: +sbyWwIcFp9kP0bDtMegfQ folded before Flop (didn't bet)
Seat 9: MgMavn/DzTzqKgHTZMsVSw (button) folded on the Flop




PokerStars Game #59939537566:  Hold'em No Limit ($0.10/$0.25) - 2009/07/01 0:42:25 ET
Table '8QBBaev+cI2i/r2H6ml/lg' 9-max Seat #6 is the button
Seat 4: ZoG0obuajzVjwgd7lNHjgg ($1.40 in chips) 
Seat 6: cxE+szmvEUe7vE+z2ozM2Q ($10.90 in chips) 
Seat 9: Ml2bY77EHbM51ZWD7dnIWg ($3.05 in chips) 
Ml2bY77EHbM51ZWD7dnIWg: posts small blind $0.10
ZoG0obuajzVjwgd7lNHjgg: posts big blind $0.25
*** HOLE CARDS ***
cxE+szmvEUe7vE+z2ozM2Q: folds 
Ml2bY77EHbM51ZWD7dnIWg: calls $0.15
ZoG0obuajzVjwgd7lNHjgg: checks 
*** FLOP *** [2h 9c 5s]
Ml2bY77EHbM51ZWD7dnIWg: bets $0.25
ZoG0obuajzVjwgd7lNHjgg: raises $0.90 to $1.15 and is all-in
Ml2bY77EHbM51ZWD7dnIWg: folds 
Uncalled bet ($0.90) returned to ZoG0obuajzVjwgd7lNHjgg
ZoG0obuajzVjwgd7lNHjgg collected $0.95 from pot
*** SUMMARY ***
Total pot $1 | Rake $0.05 
Board [2h 9c 5s]
Seat 4: ZoG0obuajzVjwgd7lNHjgg (big blind) collected ($0.95)
Seat 6: cxE+szmvEUe7vE+z2ozM2Q (button) folded before Flop (didn't bet)
Seat 9: Ml2bY77EHbM51ZWD7dnIWg (small blind) folded on the Flop




PokerStars Game #59939537142:  Hold'em No Limit ($0.10/$0.25) - 2009/07/01 0:42:25 ET
Table 'MiquQrQZJJq9ZtgRIp9HFQ' 6-max Seat #1 is the button
Seat 1: hM0MSDtq2ow7J40bSR04ig ($4.55 in chips) 
Seat 2: DMQLAmut/l19xN5STQndFg ($2.35 in chips) 
Seat 3: BYxjLnV1/LL0aZcTbfAOvw ($25 in chips) 
Seat 4: 0HIrwssk0FQvyKULzUTtlg ($21.15 in chips) 
Seat 5: LXN9U+5F+9if/ead2+w1nw ($47.05 in chips) 
Seat 6: X9oXZTg4PhZVR+ilX2OYbA ($12.15 in chips) 
DMQLAmut/l19xN5STQndFg: posts small blind $0.10
BYxjLnV1/LL0aZcTbfAOvw: posts big blind $0.25
*** HOLE CARDS ***
0HIrwssk0FQvyKULzUTtlg: folds 
LXN9U+5F+9if/ead2+w1nw: folds 
X9oXZTg4PhZVR+ilX2OYbA: folds 
hM0MSDtq2ow7J40bSR04ig: folds 
DMQLAmut/l19xN5STQndFg: calls $0.15
BYxjLnV1/LL0aZcTbfAOvw: checks 
*** FLOP *** [4s 5c 5d]
DMQLAmut/l19xN5STQndFg: bets $2.10 and is all-in
BYxjLnV1/LL0aZcTbfAOvw: folds 
Uncalled bet ($2.10) returned to DMQLAmut/l19xN5STQndFg
DMQLAmut/l19xN5STQndFg collected $0.50 from pot
DMQLAmut/l19xN5STQndFg: doesn't show hand 
*** SUMMARY ***
Total pot $0.50 | Rake $0 
Board [4s 5c 5d]
Seat 1: hM0MSDtq2ow7J40bSR04ig (button) folded before Flop (didn't bet)
Seat 2: DMQLAmut/l19xN5STQndFg (small blind) collected ($0.50)
Seat 3: BYxjLnV1/LL0aZcTbfAOvw (big blind) folded on the Flop
Seat 4: 0HIrwssk0FQvyKULzUTtlg folded before Flop (didn't bet)
Seat 5: LXN9U+5F+9if/ead2+w1nw folded before Flop (didn't bet)
Seat 6: X9oXZTg4PhZVR+ilX2OYbA folded before Flop (didn't bet)




PokerStars Game #59939537528:  Hold'em No Limit ($0.10/$0.25) - 2009/07/01 0:42:25 ET
Table 'ThBZ355rqvsb8UGb6ajbig' 9-max Seat #6 is the button
Seat 2: 4awUyiDYTgylQKXZ9faBVA ($26.50 in chips) 
Seat 3: LBrhQVB4w41YNd7kMYn/og ($11.85 in chips) 
Seat 4: GFNwOPqg/Zu4ZuokgGADNQ ($15 in chips) 
Seat 5: ljO8CPts14fBjr9/qK0Enw ($10.90 in chips) 
Seat 6: qwr38jl5txoR36M7G5qi4A ($7.50 in chips) 
Seat 7: t2nb95S5EEFOEzNx9Itz0g ($12.70 in chips) 
Seat 8: 6REZ3fl3I5Kaxoupd8cnLg ($27.75 in chips) 
Seat 9: 8B/dhbQjIWe6ASCdgzktNQ ($28.75 in chips) 
t2nb95S5EEFOEzNx9Itz0g: posts small blind $0.10
6REZ3fl3I5Kaxoupd8cnLg: posts big blind $0.25
*** HOLE CARDS ***
8B/dhbQjIWe6ASCdgzktNQ: folds 
4awUyiDYTgylQKXZ9faBVA: folds 
LBrhQVB4w41YNd7kMYn/og: folds 
GFNwOPqg/Zu4ZuokgGADNQ: calls $0.25
ljO8CPts14fBjr9/qK0Enw: calls $0.25
qwr38jl5txoR36M7G5qi4A: folds 
t2nb95S5EEFOEzNx9Itz0g: calls $0.15
6REZ3fl3I5Kaxoupd8cnLg: checks 
*** FLOP *** [Kh 4s Qd]
t2nb95S5EEFOEzNx9Itz0g: checks 
6REZ3fl3I5Kaxoupd8cnLg: checks 
GFNwOPqg/Zu4ZuokgGADNQ: checks 
ljO8CPts14fBjr9/qK0Enw: checks 
*** TURN *** [Kh 4s Qd] [Kd]
t2nb95S5EEFOEzNx9Itz0g: checks 
6REZ3fl3I5Kaxoupd8cnLg: bets $0.25
GFNwOPqg/Zu4ZuokgGADNQ: calls $0.25
ljO8CPts14fBjr9/qK0Enw: folds 
t2nb95S5EEFOEzNx9Itz0g: folds 
*** RIVER *** [Kh 4s Qd Kd] [9c]
6REZ3fl3I5Kaxoupd8cnLg: bets $0.25
GFNwOPqg/Zu4ZuokgGADNQ: calls $0.25
*** SHOW DOWN ***
6REZ3fl3I5Kaxoupd8cnLg: shows [Qc 6c] (two pair, Kings and Queens)
GFNwOPqg/Zu4ZuokgGADNQ: mucks hand 
6REZ3fl3I5Kaxoupd8cnLg collected $1.95 from pot
*** SUMMARY ***
Total pot $2 | Rake $0.05 
Board [Kh 4s Qd Kd 9c]
Seat 2: 4awUyiDYTgylQKXZ9faBVA folded before Flop (didn't bet)
Seat 3: LBrhQVB4w41YNd7kMYn/og folded before Flop (didn't bet)
Seat 4: GFNwOPqg/Zu4ZuokgGADNQ mucked
Seat 5: ljO8CPts14fBjr9/qK0Enw folded on the Turn
Seat 6: qwr38jl5txoR36M7G5qi4A (button) folded before Flop (didn't bet)
Seat 7: t2nb95S5EEFOEzNx9Itz0g (small blind) folded on the Turn
Seat 8: 6REZ3fl3I5Kaxoupd8cnLg (big blind) showed [Qc 6c] and won ($1.95) with two pair, Kings and Queens
Seat 9: 8B/dhbQjIWe6ASCdgzktNQ folded before Flop (didn't bet)




PokerStars Game #59939537094:  Hold'em No Limit ($0.10/$0.25) - 2009/07/01 0:42:25 ET
Table 'djcjiEGabFQO0MNG6jEeJQ' 9-max Seat #2 is the button
Seat 1: K7bAhhMMJ/XcTmGaBZVfFQ ($23.80 in chips) 
Seat 2: 1K6QGyJP9P9xmRac2fH4OQ ($25 in chips) 
Seat 3: 1S/fpm+f42V/6MNZre+ccg ($27.10 in chips) 
Seat 4: E6WojUZ5V/6opnfMNTSjXQ ($15 in chips) 
Seat 5: cZ99hugmLBj9KhTlc8nCSw ($37.15 in chips) 
Seat 6: aNpwfA31EREwO+ar4XzBCw ($59.55 in chips) 
Seat 7: 56S3mA6Zs3pGR+0p0vUCtg ($30.45 in chips) 
Seat 8: +sbyWwIcFp9kP0bDtMegfQ ($55.05 in chips) 
Seat 9: HPEB+AtKw1+C/cxU0o1ciw ($47.65 in chips) 
1S/fpm+f42V/6MNZre+ccg: posts small blind $0.10
E6WojUZ5V/6opnfMNTSjXQ: posts big blind $0.25
*** HOLE CARDS ***
cZ99hugmLBj9KhTlc8nCSw: raises $0.50 to $0.75
aNpwfA31EREwO+ar4XzBCw: folds 
56S3mA6Zs3pGR+0p0vUCtg: folds 
+sbyWwIcFp9kP0bDtMegfQ: calls $0.75
HPEB+AtKw1+C/cxU0o1ciw: folds 
K7bAhhMMJ/XcTmGaBZVfFQ: folds 
1K6QGyJP9P9xmRac2fH4OQ: folds 
1S/fpm+f42V/6MNZre+ccg: folds 
E6WojUZ5V/6opnfMNTSjXQ: calls $0.50
*** FLOP *** [Ac 8d Ah]
E6WojUZ5V/6opnfMNTSjXQ: checks 
cZ99hugmLBj9KhTlc8nCSw: bets $1.50
+sbyWwIcFp9kP0bDtMegfQ: folds 
E6WojUZ5V/6opnfMNTSjXQ: folds 
Uncalled bet ($1.50) returned to cZ99hugmLBj9KhTlc8nCSw
cZ99hugmLBj9KhTlc8nCSw collected $2.25 from pot
*** SUMMARY ***
Total pot $2.35 | Rake $0.10 
Board [Ac 8d Ah]
Seat 1: K7bAhhMMJ/XcTmGaBZVfFQ folded before Flop (didn't bet)
Seat 2: 1K6QGyJP9P9xmRac2fH4OQ (button) folded before Flop (didn't bet)
Seat 3: 1S/fpm+f42V/6MNZre+ccg (small blind) folded before Flop
Seat 4: E6WojUZ5V/6opnfMNTSjXQ (big blind) folded on the Flop
Seat 5: cZ99hugmLBj9KhTlc8nCSw collected ($2.25)
Seat 6: aNpwfA31EREwO+ar4XzBCw folded before Flop (didn't bet)
Seat 7: 56S3mA6Zs3pGR+0p0vUCtg folded before Flop (didn't bet)
Seat 8: +sbyWwIcFp9kP0bDtMegfQ folded on the Flop
Seat 9: HPEB+AtKw1+C/cxU0o1ciw folded before Flop (didn't bet)




PokerStars Game #59939537748:  Hold'em No Limit ($0.10/$0.25) - 2009/07/01 0:42:26 ET
Table '1zj0+miaIL9cvwnT/50pOA' 9-max Seat #6 is the button
Seat 1: spidnpwmoJ1L6yeNW7D5UA ($26.10 in chips) 
Seat 2: HPEB+AtKw1+C/cxU0o1ciw ($28.45 in chips) 
Seat 3: CYkY0dNBaYaKs8HVCVn3mQ ($5.50 in chips) 
Seat 4: 6esz1u5YivjsX0UoeMBm3w ($22.50 in chips) 
Seat 6: ydoFOVgzvZv9ZhuWu9rXAw ($4.65 in chips) 
Seat 7: 6oWOdVz2WG2azNuOj9rMgg ($15.95 in chips) 
Seat 8: HOiu48bZMhEZSoJa8mjiMw ($32.55 in chips) 
Seat 9: OiV1PWZ3IkN29JlmCcnTwQ ($5.60 in chips) 
6oWOdVz2WG2azNuOj9rMgg: posts small blind $0.10
HOiu48bZMhEZSoJa8mjiMw: posts big blind $0.25
*** HOLE CARDS ***
OiV1PWZ3IkN29JlmCcnTwQ: folds 
spidnpwmoJ1L6yeNW7D5UA: raises $0.50 to $0.75
HPEB+AtKw1+C/cxU0o1ciw: folds 
CYkY0dNBaYaKs8HVCVn3mQ: calls $0.75
6esz1u5YivjsX0UoeMBm3w: folds 
ydoFOVgzvZv9ZhuWu9rXAw: folds 
6oWOdVz2WG2azNuOj9rMgg: calls $0.65
HOiu48bZMhEZSoJa8mjiMw: folds 
*** FLOP *** [3c 3h Tc]
6oWOdVz2WG2azNuOj9rMgg: checks 
spidnpwmoJ1L6yeNW7D5UA: bets $1
CYkY0dNBaYaKs8HVCVn3mQ: calls $1
6oWOdVz2WG2azNuOj9rMgg: calls $1
*** TURN *** [3c 3h Tc] [Ts]
6oWOdVz2WG2azNuOj9rMgg: checks 
spidnpwmoJ1L6yeNW7D5UA: bets $1.25
CYkY0dNBaYaKs8HVCVn3mQ: calls $1.25
6oWOdVz2WG2azNuOj9rMgg: folds 
*** RIVER *** [3c 3h Tc Ts] [Js]
spidnpwmoJ1L6yeNW7D5UA: bets $4
CYkY0dNBaYaKs8HVCVn3mQ: calls $2.50 and is all-in
Uncalled bet ($1.50) returned to spidnpwmoJ1L6yeNW7D5UA
*** SHOW DOWN ***
spidnpwmoJ1L6yeNW7D5UA: shows [Th Ah] (a full house, Tens full of Threes)
CYkY0dNBaYaKs8HVCVn3mQ: mucks hand 
spidnpwmoJ1L6yeNW7D5UA collected $12.40 from pot
*** SUMMARY ***
Total pot $13 | Rake $0.60 
Board [3c 3h Tc Ts Js]
Seat 1: spidnpwmoJ1L6yeNW7D5UA showed [Th Ah] and won ($12.40) with a full house, Tens full of Threes
Seat 2: HPEB+AtKw1+C/cxU0o1ciw folded before Flop (didn't bet)
Seat 3: CYkY0dNBaYaKs8HVCVn3mQ mucked
Seat 4: 6esz1u5YivjsX0UoeMBm3w folded before Flop (didn't bet)
Seat 6: ydoFOVgzvZv9ZhuWu9rXAw (button) folded before Flop (didn't bet)
Seat 7: 6oWOdVz2WG2azNuOj9rMgg (small blind) folded on the Turn
Seat 8: HOiu48bZMhEZSoJa8mjiMw (big blind) folded before Flop
Seat 9: OiV1PWZ3IkN29JlmCcnTwQ folded before Flop (didn't bet)




PokerStars Game #59939537744:  Hold'em No Limit ($0.10/$0.25) - 2009/07/01 0:42:26 ET
Table 'WEMI3Mtn7dGARDbgNrKibg' 9-max Seat #8 is the button
Seat 1: 7cv+9Zc9HIQHNvYsMfV3uA ($25 in chips) 
Seat 2: tYsOBqdU1+x+yFI7zHO7hQ ($44.95 in chips) 
Seat 3: jZaChyamGXWcP+qALPP5Jg ($29.80 in chips) 
Seat 5: st9jtdNbm1W5GfBwRaCVqQ ($20.65 in chips) 
Seat 6: VBHxUExRAMrbxUq/cVx9Gw ($5 in chips) 
Seat 7: DnDcAdn9P0zGovMERigpFA ($58.65 in chips) 
Seat 8: ghNKXUBl/H+t83JF079ZBA ($26.95 in chips) 
Seat 9: NTamLAiMZ86c5yM04t96LA ($56.20 in chips) 
NTamLAiMZ86c5yM04t96LA: posts small blind $0.10
7cv+9Zc9HIQHNvYsMfV3uA: posts big blind $0.25
yyG4svzOpC1A+sUP/scg6w: sits out 
*** HOLE CARDS ***
tYsOBqdU1+x+yFI7zHO7hQ: raises $0.75 to $1
jZaChyamGXWcP+qALPP5Jg: folds 
st9jtdNbm1W5GfBwRaCVqQ: folds 
VBHxUExRAMrbxUq/cVx9Gw: folds 
DnDcAdn9P0zGovMERigpFA: folds 
ghNKXUBl/H+t83JF079ZBA: folds 
NTamLAiMZ86c5yM04t96LA: calls $0.90
7cv+9Zc9HIQHNvYsMfV3uA: folds 
*** FLOP *** [7d 8s 2d]
NTamLAiMZ86c5yM04t96LA: checks 
tYsOBqdU1+x+yFI7zHO7hQ: checks 
*** TURN *** [7d 8s 2d] [5d]
NTamLAiMZ86c5yM04t96LA: bets $0.50
tYsOBqdU1+x+yFI7zHO7hQ: calls $0.50
*** RIVER *** [7d 8s 2d 5d] [2h]
NTamLAiMZ86c5yM04t96LA: checks 
tYsOBqdU1+x+yFI7zHO7hQ: checks 
*** SHOW DOWN ***
NTamLAiMZ86c5yM04t96LA: shows [Jh Qc] (a pair of Deuces)
tYsOBqdU1+x+yFI7zHO7hQ: shows [Ac Qs] (a pair of Deuces - Ace kicker)
tYsOBqdU1+x+yFI7zHO7hQ collected $3.10 from pot
*** SUMMARY ***
Total pot $3.25 | Rake $0.15 
Board [7d 8s 2d 5d 2h]
Seat 1: 7cv+9Zc9HIQHNvYsMfV3uA (big blind) folded before Flop
Seat 2: tYsOBqdU1+x+yFI7zHO7hQ showed [Ac Qs] and won ($3.10) with a pair of Deuces
Seat 3: jZaChyamGXWcP+qALPP5Jg folded before Flop (didn't bet)
Seat 5: st9jtdNbm1W5GfBwRaCVqQ folded before Flop (didn't bet)
Seat 6: VBHxUExRAMrbxUq/cVx9Gw folded before Flop (didn't bet)
Seat 7: DnDcAdn9P0zGovMERigpFA folded before Flop (didn't bet)
Seat 8: ghNKXUBl/H+t83JF079ZBA (button) folded before Flop (didn't bet)
Seat 9: NTamLAiMZ86c5yM04t96LA (small blind) showed [Jh Qc] and lost with a pair of Deuces




PokerStars Game #59939537774:  Hold'em No Limit ($0.10/$0.25) - 2009/07/01 0:42:26 ET
Table 'zW+7jPbOLCvlPu+dUGY5WQ' 6-max Seat #3 is the button
Seat 1: JE/wJXmjw3bpdmjwvh2pcg ($25 in chips) 
Seat 2: DXgVFTcE3WofABsNJ5G/nw ($14.65 in chips) 
Seat 3: BedjMfrlRfPgSq7CXpPAmg ($63.75 in chips) 
Seat 4: Qv4VzEkN09uD11sjKv02Ig ($35.80 in chips) 
Seat 5: SFmT9ZsVopnukjvAzrxTRg ($56.80 in chips) 
Seat 6: BiLBinPhgpKAYzLgKJVU5A ($21.60 in chips) 
Qv4VzEkN09uD11sjKv02Ig: posts small blind $0.10
SFmT9ZsVopnukjvAzrxTRg: posts big blind $0.25
*** HOLE CARDS ***
BiLBinPhgpKAYzLgKJVU5A: folds 
JE/wJXmjw3bpdmjwvh2pcg: folds 
DXgVFTcE3WofABsNJ5G/nw: raises $0.50 to $0.75
BedjMfrlRfPgSq7CXpPAmg: folds 
Qv4VzEkN09uD11sjKv02Ig: calls $0.65
SFmT9ZsVopnukjvAzrxTRg: folds 
*** FLOP *** [7c 8s 8c]
Qv4VzEkN09uD11sjKv02Ig: checks 
DXgVFTcE3WofABsNJ5G/nw: bets $1
Qv4VzEkN09uD11sjKv02Ig: calls $1
*** TURN *** [7c 8s 8c] [Jc]
Qv4VzEkN09uD11sjKv02Ig: checks 
DXgVFTcE3WofABsNJ5G/nw: bets $2
Qv4VzEkN09uD11sjKv02Ig: calls $2
*** RIVER *** [7c 8s 8c Jc] [Qh]
Qv4VzEkN09uD11sjKv02Ig: bets $4
DXgVFTcE3WofABsNJ5G/nw: raises $6.90 to $10.90 and is all-in
Qv4VzEkN09uD11sjKv02Ig: calls $6.90
*** SHOW DOWN ***
DXgVFTcE3WofABsNJ5G/nw: shows [9c Tc] (a straight flush, Seven to Jack)
Qv4VzEkN09uD11sjKv02Ig: mucks hand 
DXgVFTcE3WofABsNJ5G/nw collected $28.10 from pot
*** SUMMARY ***
Total pot $29.55 | Rake $1.45 
Board [7c 8s 8c Jc Qh]
Seat 1: JE/wJXmjw3bpdmjwvh2pcg folded before Flop (didn't bet)
Seat 2: DXgVFTcE3WofABsNJ5G/nw showed [9c Tc] and won ($28.10) with a straight flush, Seven to Jack
Seat 3: BedjMfrlRfPgSq7CXpPAmg (button) folded before Flop (didn't bet)
Seat 4: Qv4VzEkN09uD11sjKv02Ig (small blind) mucked
Seat 5: SFmT9ZsVopnukjvAzrxTRg (big blind) folded before Flop
Seat 6: BiLBinPhgpKAYzLgKJVU5A folded before Flop (didn't bet)




PokerStars Game #59939537712:  Hold'em No Limit ($0.10/$0.25) - 2009/07/01 0:42:26 ET
Table 'Qr+t8WGovMECkBv+cV1lrg' 6-max Seat #4 is the button
Seat 1: wFKQltIqUcrrkvre6g+fyw ($33.90 in chips) 
Seat 2: 9h7TNZ1TDGRUJXA6rI+ZTw ($15.45 in chips) 
Seat 3: bjJnMpKgoF+vgHW2f1NCsg ($19.10 in chips) 
Seat 4: 3rlIjSrvbZoI2IILbnetnA ($25.85 in chips) 
Seat 5: iwlxXocltgSdaBmusNXanQ ($13.85 in chips) 
Seat 6: j5NZbEJHsERuXjPHWqc1Nw ($22.05 in chips) 
iwlxXocltgSdaBmusNXanQ: posts small blind $0.10
j5NZbEJHsERuXjPHWqc1Nw: posts big blind $0.25
9h7TNZ1TDGRUJXA6rI+ZTw: posts big blind $0.25
*** HOLE CARDS ***
wFKQltIqUcrrkvre6g+fyw: folds 
wFKQltIqUcrrkvre6g+fyw is sitting out
9h7TNZ1TDGRUJXA6rI+ZTw: checks 
bjJnMpKgoF+vgHW2f1NCsg: calls $0.25
3rlIjSrvbZoI2IILbnetnA: calls $0.25
iwlxXocltgSdaBmusNXanQ: calls $0.15
j5NZbEJHsERuXjPHWqc1Nw: raises $1 to $1.25
9h7TNZ1TDGRUJXA6rI+ZTw: folds 
bjJnMpKgoF+vgHW2f1NCsg: folds 
3rlIjSrvbZoI2IILbnetnA: folds 
iwlxXocltgSdaBmusNXanQ: calls $1
*** FLOP *** [8d 2s 4c]
iwlxXocltgSdaBmusNXanQ: checks 
j5NZbEJHsERuXjPHWqc1Nw: checks 
*** TURN *** [8d 2s 4c] [6h]
iwlxXocltgSdaBmusNXanQ: bets $1.50
j5NZbEJHsERuXjPHWqc1Nw: raises $1.50 to $3
iwlxXocltgSdaBmusNXanQ: calls $1.50
*** RIVER *** [8d 2s 4c 6h] [Ts]
iwlxXocltgSdaBmusNXanQ: checks 
j5NZbEJHsERuXjPHWqc1Nw: bets $5
iwlxXocltgSdaBmusNXanQ: calls $5
*** SHOW DOWN ***
j5NZbEJHsERuXjPHWqc1Nw: shows [Qs 9d] (high card Queen)
iwlxXocltgSdaBmusNXanQ: shows [5d 6d] (a pair of Sixes)
iwlxXocltgSdaBmusNXanQ collected $18.35 from pot
*** SUMMARY ***
Total pot $19.25 | Rake $0.90 
Board [8d 2s 4c 6h Ts]
Seat 1: wFKQltIqUcrrkvre6g+fyw folded before Flop (didn't bet)
Seat 2: 9h7TNZ1TDGRUJXA6rI+ZTw folded before Flop
Seat 3: bjJnMpKgoF+vgHW2f1NCsg folded before Flop
Seat 4: 3rlIjSrvbZoI2IILbnetnA (button) folded before Flop
Seat 5: iwlxXocltgSdaBmusNXanQ (small blind) showed [5d 6d] and won ($18.35) with a pair of Sixes
Seat 6: j5NZbEJHsERuXjPHWqc1Nw (big blind) showed [Qs 9d] and lost with high card Queen




PokerStars Game #59939538194:  Hold'em No Limit ($0.10/$0.25) - 2009/07/01 0:42:26 ET
Table 'mF3KHGMaTpaBZbtBoyfTeg' 6-max Seat #4 is the button
Seat 1: 0HAB2GdCAM7p7V00xueAVQ ($9.80 in chips) 
Seat 2: 4x9jCqgSw4272dnaIqnanw ($4 in chips) 
Seat 3: Hzrn9DZJegEZICufTNYkrg ($14.40 in chips) 
Seat 4: FYepjhAvF8ZdVCmqHIy+eQ ($25.20 in chips) 
Seat 5: sEQx9G5Cu8k1HNdQasxvUA ($29 in chips) 
sEQx9G5Cu8k1HNdQasxvUA: posts small blind $0.10
0HAB2GdCAM7p7V00xueAVQ: posts big blind $0.25
*** HOLE CARDS ***
4x9jCqgSw4272dnaIqnanw: calls $0.25
Hzrn9DZJegEZICufTNYkrg: folds 
FYepjhAvF8ZdVCmqHIy+eQ: folds 
sEQx9G5Cu8k1HNdQasxvUA: calls $0.15
0HAB2GdCAM7p7V00xueAVQ: checks 
*** FLOP *** [Th Qh 7d]
sEQx9G5Cu8k1HNdQasxvUA: checks 
0HAB2GdCAM7p7V00xueAVQ: checks 
4x9jCqgSw4272dnaIqnanw: bets $0.50
sEQx9G5Cu8k1HNdQasxvUA: folds 
0HAB2GdCAM7p7V00xueAVQ: folds 
Uncalled bet ($0.50) returned to 4x9jCqgSw4272dnaIqnanw
4x9jCqgSw4272dnaIqnanw collected $0.75 from pot
*** SUMMARY ***
Total pot $0.75 | Rake $0 
Board [Th Qh 7d]
Seat 1: 0HAB2GdCAM7p7V00xueAVQ (big blind) folded on the Flop
Seat 2: 4x9jCqgSw4272dnaIqnanw collected ($0.75)
Seat 3: Hzrn9DZJegEZICufTNYkrg folded before Flop (didn't bet)
Seat 4: FYepjhAvF8ZdVCmqHIy+eQ (button) folded before Flop (didn't bet)
Seat 5: sEQx9G5Cu8k1HNdQasxvUA (small blind) folded on the Flop




PokerStars Game #59939537838:  Hold'em No Limit ($0.10/$0.25) - 2009/07/01 0:42:26 ET
Table 'OvOqQoL/QnXuXuQjXo2hIQ' 9-max Seat #7 is the button
Seat 3: uJlzv9KL7hgCIqIS2ofoaw ($17 in chips) 
Seat 5: sJNHTWcSlLHRCZ9+YRLLqA ($27.95 in chips) 
Seat 6: MIVCHqCqqlke0Lb0z7glcw ($46.05 in chips) 
Seat 7: aNpwfA31EREwO+ar4XzBCw ($27.80 in chips) 
Seat 9: VWUWpMLMj/Q1jRVpF7Aohw ($14.35 in chips) 
VWUWpMLMj/Q1jRVpF7Aohw: posts small blind $0.10
uJlzv9KL7hgCIqIS2ofoaw: posts big blind $0.25
*** HOLE CARDS ***
sJNHTWcSlLHRCZ9+YRLLqA: folds 
MIVCHqCqqlke0Lb0z7glcw: folds 
aNpwfA31EREwO+ar4XzBCw: raises $0.75 to $1
VWUWpMLMj/Q1jRVpF7Aohw: folds 
uJlzv9KL7hgCIqIS2ofoaw: folds 
Uncalled bet ($0.75) returned to aNpwfA31EREwO+ar4XzBCw
aNpwfA31EREwO+ar4XzBCw collected $0.60 from pot
aNpwfA31EREwO+ar4XzBCw: doesn't show hand 
*** SUMMARY ***
Total pot $0.60 | Rake $0 
Seat 3: uJlzv9KL7hgCIqIS2ofoaw (big blind) folded before Flop
Seat 5: sJNHTWcSlLHRCZ9+YRLLqA folded before Flop (didn't bet)
Seat 6: MIVCHqCqqlke0Lb0z7glcw folded before Flop (didn't bet)
Seat 7: aNpwfA31EREwO+ar4XzBCw (button) collected ($0.60)
Seat 9: VWUWpMLMj/Q1jRVpF7Aohw (small blind) folded before Flop




PokerStars Game #59939537800:  Hold'em No Limit ($0.10/$0.25) - 2009/07/01 0:42:26 ET
Table '3KDMdm1sfxFsNKkjc/PnBg' 9-max Seat #8 is the button
Seat 2: rUpvA02nErFvZ4yFbDR8XA ($19.60 in chips) 
Seat 3: GftT+l+xjKzcY0rMiNZfPg ($22.40 in chips) 
Seat 4: 4xnojP+j2Tm8s9Bh7QC5+Q ($18.50 in chips) 
Seat 5: +2kMBNpY4nF1qNCRd8SJLA ($25.35 in chips) 
Seat 6: N1HHRe1nNMukTQB6qMn6Kw ($16.80 in chips) 
Seat 7: gehe91e0IyVT0QU/XBkEyg ($25 in chips) 
Seat 8: st9jtdNbm1W5GfBwRaCVqQ ($27.05 in chips) 
K0b5wNInj6hUGRr6yzKFtw will be allowed to play after the button
rUpvA02nErFvZ4yFbDR8XA: posts small blind $0.10
GftT+l+xjKzcY0rMiNZfPg: posts big blind $0.25
*** HOLE CARDS ***
4xnojP+j2Tm8s9Bh7QC5+Q: folds 
+2kMBNpY4nF1qNCRd8SJLA: folds 
V6p0jQ/RhUsqpHLmXvEX4Q joins the table at seat #1 
N1HHRe1nNMukTQB6qMn6Kw: folds 
GftT+l+xjKzcY0rMiNZfPg said, "watch your self son"
gehe91e0IyVT0QU/XBkEyg: folds 
st9jtdNbm1W5GfBwRaCVqQ: folds 
rUpvA02nErFvZ4yFbDR8XA: folds 
Uncalled bet ($0.15) returned to GftT+l+xjKzcY0rMiNZfPg
GftT+l+xjKzcY0rMiNZfPg said, "play with fire your going to get burned"
GftT+l+xjKzcY0rMiNZfPg collected $0.20 from pot
*** SUMMARY ***
Total pot $0.20 | Rake $0 
Seat 2: rUpvA02nErFvZ4yFbDR8XA (small blind) folded before Flop
Seat 3: GftT+l+xjKzcY0rMiNZfPg (big blind) collected ($0.20)
Seat 4: 4xnojP+j2Tm8s9Bh7QC5+Q folded before Flop (didn't bet)
Seat 5: +2kMBNpY4nF1qNCRd8SJLA folded before Flop (didn't bet)
Seat 6: N1HHRe1nNMukTQB6qMn6Kw folded before Flop (didn't bet)
Seat 7: gehe91e0IyVT0QU/XBkEyg folded before Flop (didn't bet)
Seat 8: st9jtdNbm1W5GfBwRaCVqQ (button) folded before Flop (didn't bet)




PokerStars Game #59939538436:  Hold'em No Limit ($0.10/$0.25) - 2009/07/01 0:42:27 ET
Table 'ORSZkZqq+7Ja2PdeCFAytA' 9-max Seat #5 is the button
Seat 1: Gpa8cld5y0mdOomHJgHhlA ($7.25 in chips) 
Seat 2: yduPKWPzL8YlT5Zv/Nmrwg ($12.15 in chips) 
Seat 5: fOv1xoqR8m9slwElVu7Y+A ($14.65 in chips) 
Gpa8cld5y0mdOomHJgHhlA: posts small blind $0.10
yduPKWPzL8YlT5Zv/Nmrwg: posts big blind $0.25
*** HOLE CARDS ***
fOv1xoqR8m9slwElVu7Y+A: calls $0.25
Gpa8cld5y0mdOomHJgHhlA: calls $0.15
yduPKWPzL8YlT5Zv/Nmrwg: checks 
*** FLOP *** [Ad As Kd]
Gpa8cld5y0mdOomHJgHhlA: checks 
yduPKWPzL8YlT5Zv/Nmrwg: folds 
yduPKWPzL8YlT5Zv/Nmrwg leaves the table
fOv1xoqR8m9slwElVu7Y+A: bets $0.25
Gpa8cld5y0mdOomHJgHhlA: folds 
Uncalled bet ($0.25) returned to fOv1xoqR8m9slwElVu7Y+A
fOv1xoqR8m9slwElVu7Y+A collected $0.75 from pot
fOv1xoqR8m9slwElVu7Y+A: doesn't show hand 
*** SUMMARY ***
Total pot $0.75 | Rake $0 
Board [Ad As Kd]
Seat 1: Gpa8cld5y0mdOomHJgHhlA (small blind) folded on the Flop
Seat 2: yduPKWPzL8YlT5Zv/Nmrwg (big blind) folded on the Flop
Seat 5: fOv1xoqR8m9slwElVu7Y+A (button) collected ($0.75)




PokerStars Game #59939538720:  Hold'em No Limit ($0.10/$0.25) - 2009/07/01 0:42:27 ET
Table 'ShgkxBDL5IvR1qjzfRNc0A' 6-max Seat #4 is the button
Seat 1: /gJNBeCkWL4o85/jvlZ4BA ($25 in chips) 
Seat 2: mfrkWA3PTeYPkbO6hi98Aw ($37.85 in chips) 
Seat 3: JXSfL0FgBM1dIFwHP09Hnw ($25 in chips) 
Seat 4: kG34n23qFQA3nzdOJTQ1dA ($24.40 in chips) 
Seat 5: ferjiUxLWPNUKxvl8/xD/g ($47.45 in chips) 
Seat 6: 5tB0F9NjPSUL4FzmzBMs2Q ($30.20 in chips) 
ferjiUxLWPNUKxvl8/xD/g: posts small blind $0.10
5tB0F9NjPSUL4FzmzBMs2Q: posts big blind $0.25
*** HOLE CARDS ***
/gJNBeCkWL4o85/jvlZ4BA: folds 
mfrkWA3PTeYPkbO6hi98Aw: folds 
JXSfL0FgBM1dIFwHP09Hnw: folds 
kG34n23qFQA3nzdOJTQ1dA: folds 
ferjiUxLWPNUKxvl8/xD/g: folds 
Uncalled bet ($0.15) returned to 5tB0F9NjPSUL4FzmzBMs2Q
5tB0F9NjPSUL4FzmzBMs2Q collected $0.20 from pot
5tB0F9NjPSUL4FzmzBMs2Q: doesn't show hand 
*** SUMMARY ***
Total pot $0.20 | Rake $0 
Seat 1: /gJNBeCkWL4o85/jvlZ4BA folded before Flop (didn't bet)
Seat 2: mfrkWA3PTeYPkbO6hi98Aw folded before Flop (didn't bet)
Seat 3: JXSfL0FgBM1dIFwHP09Hnw folded before Flop (didn't bet)
Seat 4: kG34n23qFQA3nzdOJTQ1dA (button) folded before Flop (didn't bet)
Seat 5: ferjiUxLWPNUKxvl8/xD/g (small blind) folded before Flop
Seat 6: 5tB0F9NjPSUL4FzmzBMs2Q (big blind) collected ($0.20)




PokerStars Game #59939538686:  Hold'em No Limit ($0.10/$0.25) - 2009/07/01 0:42:27 ET
Table 'HIOfhT0zga/KonFhIl6O3w' 9-max Seat #1 is the button
Seat 1: t2nb95S5EEFOEzNx9Itz0g ($5.85 in chips) 
Seat 2: er86weqXTpTB6/w2dKlYgA ($16.55 in chips) 
Seat 3: RxrlOCIHB/l30KL6EEws0g ($37.15 in chips) 
Seat 4: qwr38jl5txoR36M7G5qi4A ($8.10 in chips) 
Seat 5: K1MDeapSEyKyGPNZGOKfEg ($13.95 in chips) 
Seat 6: cZ99hugmLBj9KhTlc8nCSw ($26.30 in chips) 
Seat 7: H9KUl8cmpLgEpOVDA00bCg ($5.25 in chips) 
Seat 8: 3RCAkueG3Vc13VpRStCB+w ($25.50 in chips) 
Seat 9: dfNim92Z6XK1/h5SFW5vDg ($25.25 in chips) 
er86weqXTpTB6/w2dKlYgA: posts small blind $0.10
RxrlOCIHB/l30KL6EEws0g: posts big blind $0.25
*** HOLE CARDS ***
qwr38jl5txoR36M7G5qi4A: folds 
K1MDeapSEyKyGPNZGOKfEg: folds 
cZ99hugmLBj9KhTlc8nCSw: folds 
H9KUl8cmpLgEpOVDA00bCg: folds 
3RCAkueG3Vc13VpRStCB+w: raises $0.50 to $0.75
dfNim92Z6XK1/h5SFW5vDg: folds 
t2nb95S5EEFOEzNx9Itz0g: folds 
er86weqXTpTB6/w2dKlYgA: folds 
RxrlOCIHB/l30KL6EEws0g: folds 
Uncalled bet ($0.50) returned to 3RCAkueG3Vc13VpRStCB+w
3RCAkueG3Vc13VpRStCB+w collected $0.60 from pot
3RCAkueG3Vc13VpRStCB+w: doesn't show hand 
*** SUMMARY ***
Total pot $0.60 | Rake $0 
Seat 1: t2nb95S5EEFOEzNx9Itz0g (button) folded before Flop (didn't bet)
Seat 2: er86weqXTpTB6/w2dKlYgA (small blind) folded before Flop
Seat 3: RxrlOCIHB/l30KL6EEws0g (big blind) folded before Flop
Seat 4: qwr38jl5txoR36M7G5qi4A folded before Flop (didn't bet)
Seat 5: K1MDeapSEyKyGPNZGOKfEg folded before Flop (didn't bet)
Seat 6: cZ99hugmLBj9KhTlc8nCSw folded before Flop (didn't bet)
Seat 7: H9KUl8cmpLgEpOVDA00bCg folded before Flop (didn't bet)
Seat 8: 3RCAkueG3Vc13VpRStCB+w collected ($0.60)
Seat 9: dfNim92Z6XK1/h5SFW5vDg folded before Flop (didn't bet)




PokerStars Game #59939539272:  Hold'em No Limit ($0.10/$0.25) - 2009/07/01 0:42:28 ET
Table 'l8hUTjBTXBorNUR/tyvSLw' 9-max Seat #3 is the button
Seat 2: ZeR3hkj1gVv9J4yPCmRrjA ($50.50 in chips) 
Seat 3: 6TWO15+WfJ5HfI8CbJ4a0w ($9.05 in chips) 
Seat 4: vPtFvcPtn/Afz0sucO1cmQ ($37.55 in chips) 
Seat 5: S7Ki0P+0AIGPuIfGJjW0gg ($13.60 in chips) 
Seat 6: nkD1GtC3+ft+4U3Od0H10A ($13.70 in chips) 
Seat 7: awxYB5n5W4JUl1V4Xsn26g ($4.65 in chips) 
Seat 8: kZJjw0YSgO2CZKraCg0v8g ($12.40 in chips) 
Seat 9: zDrucyjVn5aeekNEc3cJrA ($35.75 in chips) 
vPtFvcPtn/Afz0sucO1cmQ: posts small blind $0.10
S7Ki0P+0AIGPuIfGJjW0gg: posts big blind $0.25
cZ99hugmLBj9KhTlc8nCSw: sits out 
*** HOLE CARDS ***
nkD1GtC3+ft+4U3Od0H10A: folds 
awxYB5n5W4JUl1V4Xsn26g: folds 
kZJjw0YSgO2CZKraCg0v8g: folds 
zDrucyjVn5aeekNEc3cJrA: folds 
ZeR3hkj1gVv9J4yPCmRrjA has timed out
ZeR3hkj1gVv9J4yPCmRrjA: folds 
ZeR3hkj1gVv9J4yPCmRrjA is sitting out
6TWO15+WfJ5HfI8CbJ4a0w: folds 
vPtFvcPtn/Afz0sucO1cmQ: folds 
Uncalled bet ($0.15) returned to S7Ki0P+0AIGPuIfGJjW0gg
S7Ki0P+0AIGPuIfGJjW0gg collected $0.20 from pot
S7Ki0P+0AIGPuIfGJjW0gg: doesn't show hand 
*** SUMMARY ***
Total pot $0.20 | Rake $0 
Seat 2: ZeR3hkj1gVv9J4yPCmRrjA folded before Flop (didn't bet)
Seat 3: 6TWO15+WfJ5HfI8CbJ4a0w (button) folded before Flop (didn't bet)
Seat 4: vPtFvcPtn/Afz0sucO1cmQ (small blind) folded before Flop
Seat 5: S7Ki0P+0AIGPuIfGJjW0gg (big blind) collected ($0.20)
Seat 6: nkD1GtC3+ft+4U3Od0H10A folded before Flop (didn't bet)
Seat 7: awxYB5n5W4JUl1V4Xsn26g folded before Flop (didn't bet)
Seat 8: kZJjw0YSgO2CZKraCg0v8g folded before Flop (didn't bet)
Seat 9: zDrucyjVn5aeekNEc3cJrA folded before Flop (didn't bet)




PokerStars Game #59939539442:  Hold'em No Limit ($0.10/$0.25) - 2009/07/01 0:42:28 ET
Table '5510FxlYzKi+U6MIpo8IPA' 6-max Seat #1 is the button
Seat 1: KM6ogk7SqyRlk3m9b0h+7A ($19.85 in chips) 
Seat 2: gqW2aBCmrIw65BvwjTFN6Q ($25 in chips) 
Seat 3: v+QfkGiuj9bgtuNoVnDO8w ($29.45 in chips) 
Seat 4: cPO/1/dTcZpLkQFm3jH3Rg ($27.55 in chips) 
Seat 5: 5E1iMY5xyboow7Xm0v7Idw ($13.60 in chips) 
Seat 6: SFmT9ZsVopnukjvAzrxTRg ($28.75 in chips) 
gqW2aBCmrIw65BvwjTFN6Q: posts small blind $0.10
v+QfkGiuj9bgtuNoVnDO8w: posts big blind $0.25
*** HOLE CARDS ***
cPO/1/dTcZpLkQFm3jH3Rg: folds 
5E1iMY5xyboow7Xm0v7Idw: calls $0.25
SFmT9ZsVopnukjvAzrxTRg: folds 
KM6ogk7SqyRlk3m9b0h+7A: folds 
gqW2aBCmrIw65BvwjTFN6Q: calls $0.15
v+QfkGiuj9bgtuNoVnDO8w: checks 
*** FLOP *** [3h 4c 3c]
gqW2aBCmrIw65BvwjTFN6Q: checks 
v+QfkGiuj9bgtuNoVnDO8w: bets $0.75
5E1iMY5xyboow7Xm0v7Idw: calls $0.75
gqW2aBCmrIw65BvwjTFN6Q: folds 
*** TURN *** [3h 4c 3c] [Tc]
v+QfkGiuj9bgtuNoVnDO8w: bets $1.75
5E1iMY5xyboow7Xm0v7Idw: raises $2 to $3.75
v+QfkGiuj9bgtuNoVnDO8w: calls $2
*** RIVER *** [3h 4c 3c Tc] [7h]
v+QfkGiuj9bgtuNoVnDO8w: checks 
5E1iMY5xyboow7Xm0v7Idw: checks 
*** SHOW DOWN ***
v+QfkGiuj9bgtuNoVnDO8w: shows [9s 3d] (three of a kind, Threes)
5E1iMY5xyboow7Xm0v7Idw: mucks hand 
v+QfkGiuj9bgtuNoVnDO8w collected $9.30 from pot
*** SUMMARY ***
Total pot $9.75 | Rake $0.45 
Board [3h 4c 3c Tc 7h]
Seat 1: KM6ogk7SqyRlk3m9b0h+7A (button) folded before Flop (didn't bet)
Seat 2: gqW2aBCmrIw65BvwjTFN6Q (small blind) folded on the Flop
Seat 3: v+QfkGiuj9bgtuNoVnDO8w (big blind) showed [9s 3d] and won ($9.30) with three of a kind, Threes
Seat 4: cPO/1/dTcZpLkQFm3jH3Rg folded before Flop (didn't bet)
Seat 5: 5E1iMY5xyboow7Xm0v7Idw mucked
Seat 6: SFmT9ZsVopnukjvAzrxTRg folded before Flop (didn't bet)




PokerStars Game #59939539342:  Hold'em No Limit ($0.10/$0.25) - 2009/07/01 0:42:28 ET
Table 'nlpa8xI95gAflovnFxB2yg' 6-max Seat #6 is the button
Seat 1: fZQg9veL7Dd/Z04ZTjC+wQ ($63.80 in chips) 
Seat 2: WrLI51S2iMb8GLMB83gGqA ($25 in chips) 
Seat 3: I1TxPvWj8NfG8orglCinNA ($25.35 in chips) 
Seat 4: 5xjU9nfIjn1MBxIJKZvS5w ($32.35 in chips) 
Seat 5: 6DwBRH+xZ12AAZmeAg+aXw ($25 in chips) 
Seat 6: FPlQHZog0ePFCETQ2KG4hQ ($25.90 in chips) 
fZQg9veL7Dd/Z04ZTjC+wQ: posts small blind $0.10
WrLI51S2iMb8GLMB83gGqA: posts big blind $0.25
*** HOLE CARDS ***
I1TxPvWj8NfG8orglCinNA: raises $0.75 to $1
5xjU9nfIjn1MBxIJKZvS5w: folds 
6DwBRH+xZ12AAZmeAg+aXw: calls $1
FPlQHZog0ePFCETQ2KG4hQ: folds 
fZQg9veL7Dd/Z04ZTjC+wQ: raises $4.50 to $5.50
WrLI51S2iMb8GLMB83gGqA: folds 
I1TxPvWj8NfG8orglCinNA: folds 
6DwBRH+xZ12AAZmeAg+aXw: folds 
Uncalled bet ($4.50) returned to fZQg9veL7Dd/Z04ZTjC+wQ
fZQg9veL7Dd/Z04ZTjC+wQ collected $3.25 from pot
fZQg9veL7Dd/Z04ZTjC+wQ: doesn't show hand 
*** SUMMARY ***
Total pot $3.25 | Rake $0 
Seat 1: fZQg9veL7Dd/Z04ZTjC+wQ (small blind) collected ($3.25)
Seat 2: WrLI51S2iMb8GLMB83gGqA (big blind) folded before Flop
Seat 3: I1TxPvWj8NfG8orglCinNA folded before Flop
Seat 4: 5xjU9nfIjn1MBxIJKZvS5w folded before Flop (didn't bet)
Seat 5: 6DwBRH+xZ12AAZmeAg+aXw folded before Flop
Seat 6: FPlQHZog0ePFCETQ2KG4hQ (button) folded before Flop (didn't bet)




PokerStars Game #59939539340:  Hold'em No Limit ($0.10/$0.25) - 2009/07/01 0:42:28 ET
Table 'QegsWX65l3n/K0A8XB78yg' 6-max Seat #1 is the button
Seat 1: 8ClCHtFXGNplITm+63KB+Q ($28.95 in chips) 
Seat 2: GC/9yVD59DUCX7hUI7gcLw ($32.65 in chips) 
Seat 3: 9jSiy0meE9XJKkdIZwyTEQ ($25 in chips) 
Seat 4: kyRaCIljYA6l33lSKQfNsg ($25.70 in chips) 
Seat 5: 4YSTu0Cdzpppe1lUgCZGCQ ($56.25 in chips) 
Seat 6: JE/wJXmjw3bpdmjwvh2pcg ($36.40 in chips) 
GC/9yVD59DUCX7hUI7gcLw: posts small blind $0.10
9jSiy0meE9XJKkdIZwyTEQ: posts big blind $0.25
*** HOLE CARDS ***
kyRaCIljYA6l33lSKQfNsg: folds 
4YSTu0Cdzpppe1lUgCZGCQ: folds 
JE/wJXmjw3bpdmjwvh2pcg: folds 
8ClCHtFXGNplITm+63KB+Q: folds 
GC/9yVD59DUCX7hUI7gcLw: folds 
Uncalled bet ($0.15) returned to 9jSiy0meE9XJKkdIZwyTEQ
9jSiy0meE9XJKkdIZwyTEQ collected $0.20 from pot
9jSiy0meE9XJKkdIZwyTEQ: doesn't show hand 
*** SUMMARY ***
Total pot $0.20 | Rake $0 
Seat 1: 8ClCHtFXGNplITm+63KB+Q (button) folded before Flop (didn't bet)
Seat 2: GC/9yVD59DUCX7hUI7gcLw (small blind) folded before Flop
Seat 3: 9jSiy0meE9XJKkdIZwyTEQ (big blind) collected ($0.20)
Seat 4: kyRaCIljYA6l33lSKQfNsg folded before Flop (didn't bet)
Seat 5: 4YSTu0Cdzpppe1lUgCZGCQ folded before Flop (didn't bet)
Seat 6: JE/wJXmjw3bpdmjwvh2pcg folded before Flop (didn't bet)




PokerStars Game #59939538990:  Hold'em No Limit ($0.10/$0.25) - 2009/07/01 0:42:28 ET
Table 'NtEQAxCeIK2io1CGtW658g' 6-max Seat #2 is the button
Seat 1: lnOV7k25gyN7L5t5YKTgIg ($23 in chips) 
Seat 2: nc79pm0LZRdhncq55evVqA ($25.20 in chips) 
Seat 3: m2yWOKfAxqHoy5DDN87Ttw ($24.75 in chips) 
Seat 4: 8296 ($11.65 in chips) 
Seat 5: FStoHe64SQWqAsjya9pDkQ ($26.20 in chips) 
Seat 6: /gJNBeCkWL4o85/jvlZ4BA ($62.35 in chips) 
m2yWOKfAxqHoy5DDN87Ttw: posts small blind $0.10
8296: posts big blind $0.25
*** HOLE CARDS ***
FStoHe64SQWqAsjya9pDkQ: folds 
/gJNBeCkWL4o85/jvlZ4BA: folds 
lnOV7k25gyN7L5t5YKTgIg: calls $0.25
nc79pm0LZRdhncq55evVqA: folds 
m2yWOKfAxqHoy5DDN87Ttw: raises $0.75 to $1
8296: calls $0.75
lnOV7k25gyN7L5t5YKTgIg: calls $0.75
*** FLOP *** [2h Qs Js]
m2yWOKfAxqHoy5DDN87Ttw: checks 
8296: bets $2
lnOV7k25gyN7L5t5YKTgIg: folds 
m2yWOKfAxqHoy5DDN87Ttw: folds 
Uncalled bet ($2) returned to 8296
8296 collected $2.85 from pot
8296: doesn't show hand 
*** SUMMARY ***
Total pot $3 | Rake $0.15 
Board [2h Qs Js]
Seat 1: lnOV7k25gyN7L5t5YKTgIg folded on the Flop
Seat 2: nc79pm0LZRdhncq55evVqA (button) folded before Flop (didn't bet)
Seat 3: m2yWOKfAxqHoy5DDN87Ttw (small blind) folded on the Flop
Seat 4: 8296 (big blind) collected ($2.85)
Seat 5: FStoHe64SQWqAsjya9pDkQ folded before Flop (didn't bet)
Seat 6: /gJNBeCkWL4o85/jvlZ4BA folded before Flop (didn't bet)




PokerStars Game #59939539532:  Hold'em No Limit ($0.10/$0.25) - 2009/07/01 0:42:28 ET
Table 'Pz8SfAzhP5nvWTsJRAxoDg' 6-max Seat #1 is the button
Seat 1: buyjetgNT1McXtdaP4zynA ($40.80 in chips) 
Seat 2: RYLaAIIwK9wxkPswt1yJYw ($23.15 in chips) 
Seat 3: mfrkWA3PTeYPkbO6hi98Aw ($34.90 in chips) 
Seat 4: 9U9Vy/656QCEfKznJWteag ($15.50 in chips) 
Seat 5: FYepjhAvF8ZdVCmqHIy+eQ ($29.95 in chips) 
Seat 6: FStoHe64SQWqAsjya9pDkQ ($25 in chips) 
RYLaAIIwK9wxkPswt1yJYw: posts small blind $0.10
mfrkWA3PTeYPkbO6hi98Aw: posts big blind $0.25
*** HOLE CARDS ***
9U9Vy/656QCEfKznJWteag: folds 
FYepjhAvF8ZdVCmqHIy+eQ: folds 
FStoHe64SQWqAsjya9pDkQ: raises $0.50 to $0.75
buyjetgNT1McXtdaP4zynA has timed out
buyjetgNT1McXtdaP4zynA: folds 
buyjetgNT1McXtdaP4zynA is sitting out
RYLaAIIwK9wxkPswt1yJYw: folds 
mfrkWA3PTeYPkbO6hi98Aw: folds 
Uncalled bet ($0.50) returned to FStoHe64SQWqAsjya9pDkQ
buyjetgNT1McXtdaP4zynA has returned
FStoHe64SQWqAsjya9pDkQ collected $0.60 from pot
FStoHe64SQWqAsjya9pDkQ: doesn't show hand 
*** SUMMARY ***
Total pot $0.60 | Rake $0 
Seat 1: buyjetgNT1McXtdaP4zynA (button) folded before Flop (didn't bet)
Seat 2: RYLaAIIwK9wxkPswt1yJYw (small blind) folded before Flop
Seat 3: mfrkWA3PTeYPkbO6hi98Aw (big blind) folded before Flop
Seat 4: 9U9Vy/656QCEfKznJWteag folded before Flop (didn't bet)
Seat 5: FYepjhAvF8ZdVCmqHIy+eQ folded before Flop (didn't bet)
Seat 6: FStoHe64SQWqAsjya9pDkQ collected ($0.60)




PokerStars Game #59939539178:  Hold'em No Limit ($0.10/$0.25) - 2009/07/01 0:42:28 ET
Table 'biAgO3TKQBU8XcrVAoU5TA' 6-max Seat #3 is the button
Seat 2: 7qRk4YH4/k/08LgJSv7rBQ ($24.85 in chips) 
Seat 3: 7AHdX4G8gYtDJyNY+wK+6Q ($32.60 in chips) 
Seat 4: 2/AObG8G5tKFCPZ+CdivJQ ($8.70 in chips) 
Seat 5: 6DwBRH+xZ12AAZmeAg+aXw ($25 in chips) 
Seat 6: //i5P+6lSkIyZsqb+ojVQA ($14.40 in chips) 
2/AObG8G5tKFCPZ+CdivJQ: posts small blind $0.10
6DwBRH+xZ12AAZmeAg+aXw: posts big blind $0.25
i48129QFpEQQ+UN4aNtmww: sits out 
*** HOLE CARDS ***
//i5P+6lSkIyZsqb+ojVQA: folds 
7qRk4YH4/k/08LgJSv7rBQ: raises $0.75 to $1
7AHdX4G8gYtDJyNY+wK+6Q: folds 
2/AObG8G5tKFCPZ+CdivJQ: folds 
6DwBRH+xZ12AAZmeAg+aXw: folds 
Uncalled bet ($0.75) returned to 7qRk4YH4/k/08LgJSv7rBQ
7qRk4YH4/k/08LgJSv7rBQ collected $0.60 from pot
7qRk4YH4/k/08LgJSv7rBQ: doesn't show hand 
*** SUMMARY ***
Total pot $0.60 | Rake $0 
Seat 2: 7qRk4YH4/k/08LgJSv7rBQ collected ($0.60)
Seat 3: 7AHdX4G8gYtDJyNY+wK+6Q (button) folded before Flop (didn't bet)
Seat 4: 2/AObG8G5tKFCPZ+CdivJQ (small blind) folded before Flop
Seat 5: 6DwBRH+xZ12AAZmeAg+aXw (big blind) folded before Flop
Seat 6: //i5P+6lSkIyZsqb+ojVQA folded before Flop (didn't bet)




PokerStars Game #59939538998:  Hold'em No Limit ($0.10/$0.25) - 2009/07/01 0:42:28 ET
Table 'BabJGL6tfXQp3leBGbYe8A' 9-max Seat #5 is the button
Seat 2: G5EFgY1bi50mF1iH/+B4yQ ($9.85 in chips) 
Seat 3: Jdj7AsGFrlkCgDXeWK322A ($26.85 in chips) 
Seat 4: Yk91gygnxgAKPGHZ/jPVSw ($7.45 in chips) 
Seat 5: fKqW4kzqpoOv+YKE5kp3FA ($2.80 in chips) 
Seat 6: ELKIDQ6mBSQJr3wiHYHtvw ($7.50 in chips) 
Seat 8: TJEefy+0K5gBV+8LA5OK7Q ($25 in chips) 
Seat 9: xEQxarad8/T4jJdpZy5LGw ($9.80 in chips) 
ELKIDQ6mBSQJr3wiHYHtvw: posts small blind $0.10
TJEefy+0K5gBV+8LA5OK7Q: posts big blind $0.25
qwr38jl5txoR36M7G5qi4A: sits out 
*** HOLE CARDS ***
xEQxarad8/T4jJdpZy5LGw: calls $0.25
G5EFgY1bi50mF1iH/+B4yQ: folds 
Jdj7AsGFrlkCgDXeWK322A: folds 
Yk91gygnxgAKPGHZ/jPVSw: calls $0.25
fKqW4kzqpoOv+YKE5kp3FA: folds 
ELKIDQ6mBSQJr3wiHYHtvw: folds 
TJEefy+0K5gBV+8LA5OK7Q: checks 
*** FLOP *** [7s Jd Th]
TJEefy+0K5gBV+8LA5OK7Q: checks 
xEQxarad8/T4jJdpZy5LGw: checks 
Yk91gygnxgAKPGHZ/jPVSw: checks 
*** TURN *** [7s Jd Th] [As]
TJEefy+0K5gBV+8LA5OK7Q: checks 
xEQxarad8/T4jJdpZy5LGw: bets $0.50
PS2bAPjvHsF4E9tIyk0xBg leaves the table
Yk91gygnxgAKPGHZ/jPVSw: folds 
TJEefy+0K5gBV+8LA5OK7Q: folds 
Uncalled bet ($0.50) returned to xEQxarad8/T4jJdpZy5LGw
xEQxarad8/T4jJdpZy5LGw collected $0.85 from pot
*** SUMMARY ***
Total pot $0.85 | Rake $0 
Board [7s Jd Th As]
Seat 2: G5EFgY1bi50mF1iH/+B4yQ folded before Flop (didn't bet)
Seat 3: Jdj7AsGFrlkCgDXeWK322A folded before Flop (didn't bet)
Seat 4: Yk91gygnxgAKPGHZ/jPVSw folded on the Turn
Seat 5: fKqW4kzqpoOv+YKE5kp3FA (button) folded before Flop (didn't bet)
Seat 6: ELKIDQ6mBSQJr3wiHYHtvw (small blind) folded before Flop
Seat 8: TJEefy+0K5gBV+8LA5OK7Q (big blind) folded on the Turn
Seat 9: xEQxarad8/T4jJdpZy5LGw collected ($0.85)




PokerStars Game #59939539410:  Hold'em No Limit ($0.10/$0.25) - 2009/07/01 0:42:28 ET
Table 'G+4ZdyRoPjgaJY/jxSlZzQ' 9-max Seat #2 is the button
Seat 1: 0Ui5PFTLvpoTRdxcc8BNSQ ($34.05 in chips) 
Seat 2: 4awUyiDYTgylQKXZ9faBVA ($34.70 in chips) 
Seat 3: opOCI2p6kW0tINuVaAqmcQ ($28.05 in chips) 
Seat 4: yindad6WXRlkjbK12URYkA ($10.30 in chips) 
Seat 5: s7Q6uNouhe7aE8JdFb9E+A ($26.25 in chips) 
Seat 6: gehe91e0IyVT0QU/XBkEyg ($27.55 in chips) 
Seat 9: AzTBzPGlrIHrrs1Q8oKcGA ($17.20 in chips) 
opOCI2p6kW0tINuVaAqmcQ: posts small blind $0.10
yindad6WXRlkjbK12URYkA: posts big blind $0.25
Archi91: sits out 
*** HOLE CARDS ***
s7Q6uNouhe7aE8JdFb9E+A: folds 
gehe91e0IyVT0QU/XBkEyg: folds 
AzTBzPGlrIHrrs1Q8oKcGA: folds 
0Ui5PFTLvpoTRdxcc8BNSQ: calls $0.25
4awUyiDYTgylQKXZ9faBVA: folds 
opOCI2p6kW0tINuVaAqmcQ: calls $0.15
yindad6WXRlkjbK12URYkA: checks 
*** FLOP *** [Td Jd 2h]
opOCI2p6kW0tINuVaAqmcQ: checks 
yindad6WXRlkjbK12URYkA: checks 
0Ui5PFTLvpoTRdxcc8BNSQ: checks 
*** TURN *** [Td Jd 2h] [Jc]
opOCI2p6kW0tINuVaAqmcQ: checks 
yindad6WXRlkjbK12URYkA: bets $0.75
0Ui5PFTLvpoTRdxcc8BNSQ: folds 
opOCI2p6kW0tINuVaAqmcQ: raises $0.75 to $1.50
yindad6WXRlkjbK12URYkA: calls $0.75
*** RIVER *** [Td Jd 2h Jc] [3c]
opOCI2p6kW0tINuVaAqmcQ: bets $2
yindad6WXRlkjbK12URYkA: calls $2
*** SHOW DOWN ***
opOCI2p6kW0tINuVaAqmcQ: shows [Js Kd] (three of a kind, Jacks)
yindad6WXRlkjbK12URYkA: mucks hand 
opOCI2p6kW0tINuVaAqmcQ collected $7.40 from pot
*** SUMMARY ***
Total pot $7.75 | Rake $0.35 
Board [Td Jd 2h Jc 3c]
Seat 1: 0Ui5PFTLvpoTRdxcc8BNSQ folded on the Turn
Seat 2: 4awUyiDYTgylQKXZ9faBVA (button) folded before Flop (didn't bet)
Seat 3: opOCI2p6kW0tINuVaAqmcQ (small blind) showed [Js Kd] and won ($7.40) with three of a kind, Jacks
Seat 4: yindad6WXRlkjbK12URYkA (big blind) mucked
Seat 5: s7Q6uNouhe7aE8JdFb9E+A folded before Flop (didn't bet)
Seat 6: gehe91e0IyVT0QU/XBkEyg folded before Flop (didn't bet)
Seat 9: AzTBzPGlrIHrrs1Q8oKcGA folded before Flop (didn't bet)




PokerStars Game #59939539618:  Hold'em No Limit ($0.10/$0.25) - 2009/07/01 0:42:29 ET
Table 'RuT55t7dqtns1CdLsutksg' 9-max Seat #8 is the button
Seat 1: N6WEabmk+J6IGeE7kub1QQ ($40.85 in chips) 
Seat 2: CYkY0dNBaYaKs8HVCVn3mQ ($5.90 in chips) 
Seat 3: xOx0qYgTfvbPkTa+GuX0WA ($16.25 in chips) 
Seat 4: MG90wfSJZnOejs/KD3vlQQ ($26.70 in chips) 
Seat 5: 0D3Q+hLxjPei/5wgaaYhZA ($4.05 in chips) 
Seat 6: CqwJk5Z2+vb2f9j1o7IjKQ ($11.95 in chips) 
Seat 8: yyG4svzOpC1A+sUP/scg6w ($7.15 in chips) 
N6WEabmk+J6IGeE7kub1QQ: posts small blind $0.10
CYkY0dNBaYaKs8HVCVn3mQ: posts big blind $0.25
*** HOLE CARDS ***
xOx0qYgTfvbPkTa+GuX0WA: calls $0.25
MG90wfSJZnOejs/KD3vlQQ: folds 
0D3Q+hLxjPei/5wgaaYhZA: calls $0.25
CqwJk5Z2+vb2f9j1o7IjKQ: calls $0.25
yyG4svzOpC1A+sUP/scg6w: folds 
N6WEabmk+J6IGeE7kub1QQ: calls $0.15
CYkY0dNBaYaKs8HVCVn3mQ: checks 
*** FLOP *** [2h 6c 7h]
N6WEabmk+J6IGeE7kub1QQ: checks 
CYkY0dNBaYaKs8HVCVn3mQ: bets $0.50
xOx0qYgTfvbPkTa+GuX0WA: folds 
0D3Q+hLxjPei/5wgaaYhZA: calls $0.50
CqwJk5Z2+vb2f9j1o7IjKQ: calls $0.50
N6WEabmk+J6IGeE7kub1QQ: folds 
*** TURN *** [2h 6c 7h] [Jh]
CYkY0dNBaYaKs8HVCVn3mQ: checks 
0D3Q+hLxjPei/5wgaaYhZA: checks 
CqwJk5Z2+vb2f9j1o7IjKQ: bets $0.50
CYkY0dNBaYaKs8HVCVn3mQ: folds 
0D3Q+hLxjPei/5wgaaYhZA: folds 
Uncalled bet ($0.50) returned to CqwJk5Z2+vb2f9j1o7IjKQ
CqwJk5Z2+vb2f9j1o7IjKQ collected $2.65 from pot
CqwJk5Z2+vb2f9j1o7IjKQ: doesn't show hand 
*** SUMMARY ***
Total pot $2.75 | Rake $0.10 
Board [2h 6c 7h Jh]
Seat 1: N6WEabmk+J6IGeE7kub1QQ (small blind) folded on the Flop
Seat 2: CYkY0dNBaYaKs8HVCVn3mQ (big blind) folded on the Turn
Seat 3: xOx0qYgTfvbPkTa+GuX0WA folded on the Flop
Seat 4: MG90wfSJZnOejs/KD3vlQQ folded before Flop (didn't bet)
Seat 5: 0D3Q+hLxjPei/5wgaaYhZA folded on the Turn
Seat 6: CqwJk5Z2+vb2f9j1o7IjKQ collected ($2.65)
Seat 8: yyG4svzOpC1A+sUP/scg6w (button) folded before Flop (didn't bet)




PokerStars Game #59939539588:  Hold'em No Limit ($0.10/$0.25) - 2009/07/01 0:42:29 ET
Table 'C8mMnVmvkagwolEzTvh07A' 9-max Seat #1 is the button
Seat 1: t2nb95S5EEFOEzNx9Itz0g ($5 in chips) 
Seat 2: CbXUS6Z2rXZxL1AKduNtmQ ($30.20 in chips) 
Seat 3: Th3FldXKQW6hWVVPahaoOQ ($25.35 in chips) 
Seat 4: dfNim92Z6XK1/h5SFW5vDg ($25 in chips) 
Seat 5: iGMlK+EhUflPB6jKQd95Cg ($25 in chips) 
Seat 7: qmEgnPhQt24xdw/ZRVPLbA ($31.95 in chips) 
Seat 8: N6fYvIzQLKaydFLKQGtMlQ ($22.55 in chips) 
Seat 9: 4awUyiDYTgylQKXZ9faBVA ($26.60 in chips) 
CbXUS6Z2rXZxL1AKduNtmQ: posts small blind $0.10
Th3FldXKQW6hWVVPahaoOQ: posts big blind $0.25
qmEgnPhQt24xdw/ZRVPLbA: posts small & big blinds $0.35
*** HOLE CARDS ***
dfNim92Z6XK1/h5SFW5vDg: folds 
iGMlK+EhUflPB6jKQd95Cg: raises $0.75 to $1
qmEgnPhQt24xdw/ZRVPLbA: folds 
N6fYvIzQLKaydFLKQGtMlQ: folds 
4awUyiDYTgylQKXZ9faBVA: folds 
t2nb95S5EEFOEzNx9Itz0g: raises $4 to $5 and is all-in
CbXUS6Z2rXZxL1AKduNtmQ: folds 
Th3FldXKQW6hWVVPahaoOQ: folds 
iGMlK+EhUflPB6jKQd95Cg: folds 
Uncalled bet ($4) returned to t2nb95S5EEFOEzNx9Itz0g
t2nb95S5EEFOEzNx9Itz0g collected $2.70 from pot
t2nb95S5EEFOEzNx9Itz0g: doesn't show hand 
*** SUMMARY ***
Total pot $2.70 | Rake $0 
Seat 1: t2nb95S5EEFOEzNx9Itz0g (button) collected ($2.70)
Seat 2: CbXUS6Z2rXZxL1AKduNtmQ (small blind) folded before Flop
Seat 3: Th3FldXKQW6hWVVPahaoOQ (big blind) folded before Flop
Seat 4: dfNim92Z6XK1/h5SFW5vDg folded before Flop (didn't bet)
Seat 5: iGMlK+EhUflPB6jKQd95Cg folded before Flop
Seat 7: qmEgnPhQt24xdw/ZRVPLbA folded before Flop
Seat 8: N6fYvIzQLKaydFLKQGtMlQ folded before Flop (didn't bet)
Seat 9: 4awUyiDYTgylQKXZ9faBVA folded before Flop (didn't bet)




PokerStars Game #59939539908:  Hold'em No Limit ($0.10/$0.25) - 2009/07/01 0:42:29 ET
Table 'XX2OuOsa8/8AC+/mR/Az6g' 9-max Seat #2 is the button
Seat 1: 56S3mA6Zs3pGR+0p0vUCtg ($25.70 in chips) 
Seat 2: MIVCHqCqqlke0Lb0z7glcw ($23.80 in chips) 
Seat 3: PJJTm/ccITEBlwPReiBTwg ($12.75 in chips) 
Seat 4: uLP/lYn7oKq9xCChBXsXxw ($24.75 in chips) 
Seat 5: jXz58rvCgq0VjyVjUBf2mw ($24.05 in chips) 
Seat 6: gT0nY7XiR+2FA+B3F4h8HQ ($25.70 in chips) 
Seat 7: zDrucyjVn5aeekNEc3cJrA ($20.45 in chips) 
Seat 9: 86vbuhJsyH+nbEg5qpDLyQ ($43.45 in chips) 
PJJTm/ccITEBlwPReiBTwg: posts small blind $0.10
uLP/lYn7oKq9xCChBXsXxw: posts big blind $0.25
qwr38jl5txoR36M7G5qi4A: sits out 
*** HOLE CARDS ***
jXz58rvCgq0VjyVjUBf2mw: folds 
gT0nY7XiR+2FA+B3F4h8HQ: folds 
zDrucyjVn5aeekNEc3cJrA: folds 
86vbuhJsyH+nbEg5qpDLyQ: folds 
56S3mA6Zs3pGR+0p0vUCtg: folds 
MIVCHqCqqlke0Lb0z7glcw: folds 
PJJTm/ccITEBlwPReiBTwg: calls $0.15
uLP/lYn7oKq9xCChBXsXxw: checks 
*** FLOP *** [3d Jh Qd]
PJJTm/ccITEBlwPReiBTwg: bets $0.25
uLP/lYn7oKq9xCChBXsXxw: calls $0.25
*** TURN *** [3d Jh Qd] [8h]
PJJTm/ccITEBlwPReiBTwg: bets $0.25
uLP/lYn7oKq9xCChBXsXxw: raises $0.75 to $1
PJJTm/ccITEBlwPReiBTwg: folds 
Uncalled bet ($0.75) returned to uLP/lYn7oKq9xCChBXsXxw
uLP/lYn7oKq9xCChBXsXxw collected $1.45 from pot
uLP/lYn7oKq9xCChBXsXxw: doesn't show hand 
*** SUMMARY ***
Total pot $1.50 | Rake $0.05 
Board [3d Jh Qd 8h]
Seat 1: 56S3mA6Zs3pGR+0p0vUCtg folded before Flop (didn't bet)
Seat 2: MIVCHqCqqlke0Lb0z7glcw (button) folded before Flop (didn't bet)
Seat 3: PJJTm/ccITEBlwPReiBTwg (small blind) folded on the Turn
Seat 4: uLP/lYn7oKq9xCChBXsXxw (big blind) collected ($1.45)
Seat 5: jXz58rvCgq0VjyVjUBf2mw folded before Flop (didn't bet)
Seat 6: gT0nY7XiR+2FA+B3F4h8HQ folded before Flop (didn't bet)
Seat 7: zDrucyjVn5aeekNEc3cJrA folded before Flop (didn't bet)
Seat 9: 86vbuhJsyH+nbEg5qpDLyQ folded before Flop (didn't bet)




PokerStars Game #59939539598:  Hold'em No Limit ($0.10/$0.25) - 2009/07/01 0:42:29 ET
Table 'KEoOIegxPF91KooL2AelUA' 6-max Seat #1 is the button
Seat 1: wsP46AGpqDjHZQmlRHKa9g ($28.80 in chips) 
Seat 4: Vv37Oa9niKKVcR6Z7ceetw ($21.95 in chips) 
Seat 5: 2NLC44AHHKHEUooUQFYV+Q ($14.10 in chips) 
Seat 6: Jq3YrbGb738j4tRTnp4PDA ($14.65 in chips) 
Vv37Oa9niKKVcR6Z7ceetw: posts small blind $0.10
2NLC44AHHKHEUooUQFYV+Q: posts big blind $0.25
*** HOLE CARDS ***
Jq3YrbGb738j4tRTnp4PDA: folds 
wsP46AGpqDjHZQmlRHKa9g: raises $0.50 to $0.75
Vv37Oa9niKKVcR6Z7ceetw: folds 
2NLC44AHHKHEUooUQFYV+Q: calls $0.50
*** FLOP *** [5d Qd 2h]
2NLC44AHHKHEUooUQFYV+Q: checks 
wsP46AGpqDjHZQmlRHKa9g: bets $0.75
2NLC44AHHKHEUooUQFYV+Q: calls $0.75
*** TURN *** [5d Qd 2h] [2s]
2NLC44AHHKHEUooUQFYV+Q: checks 
wsP46AGpqDjHZQmlRHKa9g: bets $1.25
2NLC44AHHKHEUooUQFYV+Q: calls $1.25
*** RIVER *** [5d Qd 2h 2s] [5c]
2NLC44AHHKHEUooUQFYV+Q: checks 
wsP46AGpqDjHZQmlRHKa9g: checks 
*** SHOW DOWN ***
2NLC44AHHKHEUooUQFYV+Q: shows [Td Jd] (two pair, Fives and Deuces)
wsP46AGpqDjHZQmlRHKa9g: shows [9d Ad] (two pair, Fives and Deuces - Ace kicker)
wsP46AGpqDjHZQmlRHKa9g collected $5.35 from pot
*** SUMMARY ***
Total pot $5.60 | Rake $0.25 
Board [5d Qd 2h 2s 5c]
Seat 1: wsP46AGpqDjHZQmlRHKa9g (button) showed [9d Ad] and won ($5.35) with two pair, Fives and Deuces
Seat 4: Vv37Oa9niKKVcR6Z7ceetw (small blind) folded before Flop
Seat 5: 2NLC44AHHKHEUooUQFYV+Q (big blind) showed [Td Jd] and lost with two pair, Fives and Deuces
Seat 6: Jq3YrbGb738j4tRTnp4PDA folded before Flop (didn't bet)




PokerStars Game #59939540056:  Hold'em No Limit ($0.10/$0.25) - 2009/07/01 0:42:29 ET
Table '3EebBlzq5yHSY2444L4zlg' 9-max Seat #2 is the button
Seat 1: 8B/dhbQjIWe6ASCdgzktNQ ($32.25 in chips) 
Seat 2: MIVCHqCqqlke0Lb0z7glcw ($24.35 in chips) 
Seat 3: IGbD5vKNhHe60dkdbjg/mw ($30.60 in chips) 
Seat 4: 1S/fpm+f42V/6MNZre+ccg ($25.45 in chips) 
Seat 5: 22Ph+hChb2fjC5+yk/mOew ($14.75 in chips) 
Seat 6: QEbIGci+itdw+re8RM5fZA ($28.15 in chips) 
Seat 7: DiSvPC2iudwL5j9u6Huyww ($27.90 in chips) 
Seat 8: Qi+clOtyDiibLdH2/1Qy8g ($27.85 in chips) 
Seat 9: GTcLfsDTPqgfHyhY9FNDMw ($11.40 in chips) 
IGbD5vKNhHe60dkdbjg/mw: posts small blind $0.10
1S/fpm+f42V/6MNZre+ccg: posts big blind $0.25
*** HOLE CARDS ***
22Ph+hChb2fjC5+yk/mOew: calls $0.25
QEbIGci+itdw+re8RM5fZA: folds 
DiSvPC2iudwL5j9u6Huyww: folds 
Qi+clOtyDiibLdH2/1Qy8g: folds 
GTcLfsDTPqgfHyhY9FNDMw: folds 
8B/dhbQjIWe6ASCdgzktNQ: folds 
IGbD5vKNhHe60dkdbjg/mw said, "3 pair"
MIVCHqCqqlke0Lb0z7glcw: folds 
IGbD5vKNhHe60dkdbjg/mw: calls $0.15
1S/fpm+f42V/6MNZre+ccg: checks 
*** FLOP *** [6s Ad Qc]
IGbD5vKNhHe60dkdbjg/mw: bets $0.25
1S/fpm+f42V/6MNZre+ccg: folds 
22Ph+hChb2fjC5+yk/mOew: calls $0.25
*** TURN *** [6s Ad Qc] [Td]
IGbD5vKNhHe60dkdbjg/mw: bets $0.50
22Ph+hChb2fjC5+yk/mOew: raises $1 to $1.50
IGbD5vKNhHe60dkdbjg/mw: calls $1
*** RIVER *** [6s Ad Qc Td] [Qh]
IGbD5vKNhHe60dkdbjg/mw: checks 
22Ph+hChb2fjC5+yk/mOew: bets $6.25
IGbD5vKNhHe60dkdbjg/mw: calls $6.25
*** SHOW DOWN ***
22Ph+hChb2fjC5+yk/mOew: shows [6c 6d] (a full house, Sixes full of Queens)
IGbD5vKNhHe60dkdbjg/mw: mucks hand 
22Ph+hChb2fjC5+yk/mOew collected $15.95 from pot
*** SUMMARY ***
Total pot $16.75 | Rake $0.80 
Board [6s Ad Qc Td Qh]
Seat 1: 8B/dhbQjIWe6ASCdgzktNQ folded before Flop (didn't bet)
Seat 2: MIVCHqCqqlke0Lb0z7glcw (button) folded before Flop (didn't bet)
Seat 3: IGbD5vKNhHe60dkdbjg/mw (small blind) mucked
Seat 4: 1S/fpm+f42V/6MNZre+ccg (big blind) folded on the Flop
Seat 5: 22Ph+hChb2fjC5+yk/mOew showed [6c 6d] and won ($15.95) with a full house, Sixes full of Queens
Seat 6: QEbIGci+itdw+re8RM5fZA folded before Flop (didn't bet)
Seat 7: DiSvPC2iudwL5j9u6Huyww folded before Flop (didn't bet)
Seat 8: Qi+clOtyDiibLdH2/1Qy8g folded before Flop (didn't bet)
Seat 9: GTcLfsDTPqgfHyhY9FNDMw folded before Flop (didn't bet)




PokerStars Game #59939540170:  Hold'em No Limit ($0.10/$0.25) - 2009/07/01 0:42:29 ET
Table 'a6FCGVBMPcT7J7BDN9q1zQ' 9-max Seat #2 is the button
Seat 1: s7Q6uNouhe7aE8JdFb9E+A ($43.50 in chips) 
Seat 2: h4ggJZYBXV0mEZzYPYKfeA ($34.50 in chips) 
Seat 3: hIss79a4pu7GzJZepfgOpg ($25 in chips) 
Seat 4: ydoFOVgzvZv9ZhuWu9rXAw ($5 in chips) 
Seat 5: JJk2ZoH7BSGLAgqFUL5pMg ($2.40 in chips) 
Seat 6: Z9AeOQX3yzuSvKAm/xyovg ($9.65 in chips) 
Seat 7: V0Yo5zRBVM8DYspLKafebg ($24.65 in chips) 
Seat 8: r6hsffOo1iKmaPYKwAZmFw ($50.10 in chips) 
Seat 9: WwcXelmo9g129XJixVb2NA ($15.85 in chips) 
hIss79a4pu7GzJZepfgOpg: posts small blind $0.10
ydoFOVgzvZv9ZhuWu9rXAw: posts big blind $0.25
*** HOLE CARDS ***
JJk2ZoH7BSGLAgqFUL5pMg: calls $0.25
Z9AeOQX3yzuSvKAm/xyovg: folds 
V0Yo5zRBVM8DYspLKafebg: folds 
r6hsffOo1iKmaPYKwAZmFw: folds 
WwcXelmo9g129XJixVb2NA: folds 
s7Q6uNouhe7aE8JdFb9E+A: folds 
h4ggJZYBXV0mEZzYPYKfeA: calls $0.25
hIss79a4pu7GzJZepfgOpg: folds 
ydoFOVgzvZv9ZhuWu9rXAw: checks 
*** FLOP *** [5s Td Kd]
ydoFOVgzvZv9ZhuWu9rXAw: bets $0.75
JJk2ZoH7BSGLAgqFUL5pMg: folds 
h4ggJZYBXV0mEZzYPYKfeA: folds 
Uncalled bet ($0.75) returned to ydoFOVgzvZv9ZhuWu9rXAw
ydoFOVgzvZv9ZhuWu9rXAw collected $0.85 from pot
ydoFOVgzvZv9ZhuWu9rXAw: doesn't show hand 
*** SUMMARY ***
Total pot $0.85 | Rake $0 
Board [5s Td Kd]
Seat 1: s7Q6uNouhe7aE8JdFb9E+A folded before Flop (didn't bet)
Seat 2: h4ggJZYBXV0mEZzYPYKfeA (button) folded on the Flop
Seat 3: hIss79a4pu7GzJZepfgOpg (small blind) folded before Flop
Seat 4: ydoFOVgzvZv9ZhuWu9rXAw (big blind) collected ($0.85)
Seat 5: JJk2ZoH7BSGLAgqFUL5pMg folded on the Flop
Seat 6: Z9AeOQX3yzuSvKAm/xyovg folded before Flop (didn't bet)
Seat 7: V0Yo5zRBVM8DYspLKafebg folded before Flop (didn't bet)
Seat 8: r6hsffOo1iKmaPYKwAZmFw folded before Flop (didn't bet)
Seat 9: WwcXelmo9g129XJixVb2NA folded before Flop (didn't bet)




PokerStars Game #59939540242:  Hold'em No Limit ($0.10/$0.25) - 2009/07/01 0:42:30 ET
Table 'dVzscin98UhGisTmV9BDcw' 9-max Seat #8 is the button
Seat 1: sBAwXpkpgyhyWbHIQcIJKA ($20.65 in chips) 
Seat 2: dfNim92Z6XK1/h5SFW5vDg ($29.15 in chips) 
Seat 3: 1Clf3cPrqoy/YgvWdWK1Xw ($5.25 in chips) 
Seat 4: aNpwfA31EREwO+ar4XzBCw ($25.25 in chips) 
Seat 5: ZMRQOoxoJ7Alx96gZhP2EQ ($63.95 in chips) 
Seat 6: hBMUlEpyU74r/fwDgIpXjQ ($28.35 in chips) 
Seat 7: nEg1b6MIksd/4x5eLY735g ($60.55 in chips) 
Seat 8: /vn2Qu2dvc9AMMq46Ae0jA ($4.95 in chips) 
Seat 9: OYa/ZJBO+suuezfWsUMhZw ($5.55 in chips) 
OYa/ZJBO+suuezfWsUMhZw: posts small blind $0.10
sBAwXpkpgyhyWbHIQcIJKA: posts big blind $0.25
*** HOLE CARDS ***
dfNim92Z6XK1/h5SFW5vDg: folds 
1Clf3cPrqoy/YgvWdWK1Xw: folds 
aNpwfA31EREwO+ar4XzBCw: folds 
ZMRQOoxoJ7Alx96gZhP2EQ: calls $0.25
hBMUlEpyU74r/fwDgIpXjQ: folds 
nEg1b6MIksd/4x5eLY735g: raises $0.55 to $0.80
/vn2Qu2dvc9AMMq46Ae0jA: folds 
OYa/ZJBO+suuezfWsUMhZw: folds 
sBAwXpkpgyhyWbHIQcIJKA: calls $0.55
ZMRQOoxoJ7Alx96gZhP2EQ: calls $0.55
*** FLOP *** [2s Kd 8d]
sBAwXpkpgyhyWbHIQcIJKA: checks 
ZMRQOoxoJ7Alx96gZhP2EQ: bets $1.25
nEg1b6MIksd/4x5eLY735g: calls $1.25
sBAwXpkpgyhyWbHIQcIJKA: folds 
*** TURN *** [2s Kd 8d] [5d]
ZMRQOoxoJ7Alx96gZhP2EQ: checks 
nEg1b6MIksd/4x5eLY735g: checks 
*** RIVER *** [2s Kd 8d 5d] [Kc]
ZMRQOoxoJ7Alx96gZhP2EQ: checks 
nEg1b6MIksd/4x5eLY735g: bets $4
ZMRQOoxoJ7Alx96gZhP2EQ: folds 
Uncalled bet ($4) returned to nEg1b6MIksd/4x5eLY735g
nEg1b6MIksd/4x5eLY735g collected $4.80 from pot
*** SUMMARY ***
Total pot $5 | Rake $0.20 
Board [2s Kd 8d 5d Kc]
Seat 1: sBAwXpkpgyhyWbHIQcIJKA (big blind) folded on the Flop
Seat 2: dfNim92Z6XK1/h5SFW5vDg folded before Flop (didn't bet)
Seat 3: 1Clf3cPrqoy/YgvWdWK1Xw folded before Flop (didn't bet)
Seat 4: aNpwfA31EREwO+ar4XzBCw folded before Flop (didn't bet)
Seat 5: ZMRQOoxoJ7Alx96gZhP2EQ folded on the River
Seat 6: hBMUlEpyU74r/fwDgIpXjQ folded before Flop (didn't bet)
Seat 7: nEg1b6MIksd/4x5eLY735g collected ($4.80)
Seat 8: /vn2Qu2dvc9AMMq46Ae0jA (button) folded before Flop (didn't bet)
Seat 9: OYa/ZJBO+suuezfWsUMhZw (small blind) folded before Flop




PokerStars Game #59939540398:  Hold'em No Limit ($0.10/$0.25) - 2009/07/01 0:42:30 ET
Table 'x7YStLKc8hpt/pTgSetPKA' 9-max Seat #9 is the button
Seat 1: tYsOBqdU1+x+yFI7zHO7hQ ($25 in chips) 
Seat 2: z5GxcHlYz/GSz6W2uFiTtg ($36.25 in chips) 
Seat 3: S7Ki0P+0AIGPuIfGJjW0gg ($25.45 in chips) 
Seat 5: gxyie8xe6lDdpfG4quHtbw ($9.15 in chips) 
Seat 6: Yv4fucyyT28mjx8V5lxKJg ($31.80 in chips) 
Seat 7: +8FtfKCFr23+6O39P+U45Q ($29.50 in chips) 
Seat 8: jeKWRUkMaVn8rEUjnJKqpg ($33.15 in chips) 
Seat 9: nm4Dj/f+jJEwKVsUnKh73g ($28.05 in chips) 
tYsOBqdU1+x+yFI7zHO7hQ: posts small blind $0.10
z5GxcHlYz/GSz6W2uFiTtg: posts big blind $0.25
upsista: sits out 
*** HOLE CARDS ***
S7Ki0P+0AIGPuIfGJjW0gg: folds 
gxyie8xe6lDdpfG4quHtbw: folds 
Yv4fucyyT28mjx8V5lxKJg: folds 
+8FtfKCFr23+6O39P+U45Q: folds 
jeKWRUkMaVn8rEUjnJKqpg: folds 
nm4Dj/f+jJEwKVsUnKh73g: calls $0.25
tYsOBqdU1+x+yFI7zHO7hQ: raises $1 to $1.25
z5GxcHlYz/GSz6W2uFiTtg: calls $1
nm4Dj/f+jJEwKVsUnKh73g: folds 
*** FLOP *** [9h 2c Qc]
tYsOBqdU1+x+yFI7zHO7hQ: bets $1.75
z5GxcHlYz/GSz6W2uFiTtg: folds 
Uncalled bet ($1.75) returned to tYsOBqdU1+x+yFI7zHO7hQ
tYsOBqdU1+x+yFI7zHO7hQ collected $2.65 from pot
tYsOBqdU1+x+yFI7zHO7hQ: doesn't show hand 
*** SUMMARY ***
Total pot $2.75 | Rake $0.10 
Board [9h 2c Qc]
Seat 1: tYsOBqdU1+x+yFI7zHO7hQ (small blind) collected ($2.65)
Seat 2: z5GxcHlYz/GSz6W2uFiTtg (big blind) folded on the Flop
Seat 3: S7Ki0P+0AIGPuIfGJjW0gg folded before Flop (didn't bet)
Seat 5: gxyie8xe6lDdpfG4quHtbw folded before Flop (didn't bet)
Seat 6: Yv4fucyyT28mjx8V5lxKJg folded before Flop (didn't bet)
Seat 7: +8FtfKCFr23+6O39P+U45Q folded before Flop (didn't bet)
Seat 8: jeKWRUkMaVn8rEUjnJKqpg folded before Flop (didn't bet)
Seat 9: nm4Dj/f+jJEwKVsUnKh73g (button) folded before Flop




PokerStars Game #59939540680:  Hold'em No Limit ($0.10/$0.25) - 2009/07/01 0:42:30 ET
Table '84TjTrgbsYZladOc4PWf4Q' 6-max Seat #6 is the button
Seat 1: 79ID/ub1Pt/mDpCprVmOoA ($30.10 in chips) 
Seat 2: qGHGf/553gQnDoklMRe3tg ($31.90 in chips) 
Seat 4: SxIIgwXYLkwd6m3wLyPTCw ($25 in chips) 
Seat 5: SFmT9ZsVopnukjvAzrxTRg ($36.85 in chips) 
Seat 6: 7qRk4YH4/k/08LgJSv7rBQ ($24.65 in chips) 
79ID/ub1Pt/mDpCprVmOoA: posts small blind $0.10
qGHGf/553gQnDoklMRe3tg: posts big blind $0.25
*** HOLE CARDS ***
SxIIgwXYLkwd6m3wLyPTCw: raises $0.50 to $0.75
SFmT9ZsVopnukjvAzrxTRg: folds 
7qRk4YH4/k/08LgJSv7rBQ: folds 
79ID/ub1Pt/mDpCprVmOoA: folds 
qGHGf/553gQnDoklMRe3tg: folds 
Uncalled bet ($0.50) returned to SxIIgwXYLkwd6m3wLyPTCw
SxIIgwXYLkwd6m3wLyPTCw collected $0.60 from pot
SxIIgwXYLkwd6m3wLyPTCw: doesn't show hand 
*** SUMMARY ***
Total pot $0.60 | Rake $0 
Seat 1: 79ID/ub1Pt/mDpCprVmOoA (small blind) folded before Flop
Seat 2: qGHGf/553gQnDoklMRe3tg (big blind) folded before Flop
Seat 4: SxIIgwXYLkwd6m3wLyPTCw collected ($0.60)
Seat 5: SFmT9ZsVopnukjvAzrxTRg folded before Flop (didn't bet)
Seat 6: 7qRk4YH4/k/08LgJSv7rBQ (button) folded before Flop (didn't bet)




PokerStars Game #59939540226:  Hold'em No Limit ($0.10/$0.25) - 2009/07/01 0:42:30 ET
Table 'vFZR6Kf2Th5xBXT9brGW6A' 6-max Seat #6 is the button
Seat 1: xRkU4+naLuz7dEZFbOn9cw ($34.20 in chips) 
Seat 2: REnO5xiZ66YabxDXq2ncvA ($52.05 in chips) 
Seat 4: 79ID/ub1Pt/mDpCprVmOoA ($26.50 in chips) 
Seat 5: NhUN/JpAprdJeamFBgJH1w ($25 in chips) 
Seat 6: d0J1xuhsynEY81YHwAvJ5g ($29.75 in chips) 
xRkU4+naLuz7dEZFbOn9cw: posts small blind $0.10
REnO5xiZ66YabxDXq2ncvA: posts big blind $0.25
*** HOLE CARDS ***
79ID/ub1Pt/mDpCprVmOoA: folds 
wUwfsTnmpHcWa17qFlQr1Q joins the table at seat #3 
NhUN/JpAprdJeamFBgJH1w: folds 
d0J1xuhsynEY81YHwAvJ5g: raises $0.75 to $1
xRkU4+naLuz7dEZFbOn9cw: folds 
REnO5xiZ66YabxDXq2ncvA: folds 
Uncalled bet ($0.75) returned to d0J1xuhsynEY81YHwAvJ5g
d0J1xuhsynEY81YHwAvJ5g collected $0.60 from pot
d0J1xuhsynEY81YHwAvJ5g: doesn't show hand 
*** SUMMARY ***
Total pot $0.60 | Rake $0 
Seat 1: xRkU4+naLuz7dEZFbOn9cw (small blind) folded before Flop
Seat 2: REnO5xiZ66YabxDXq2ncvA (big blind) folded before Flop
Seat 4: 79ID/ub1Pt/mDpCprVmOoA folded before Flop (didn't bet)
Seat 5: NhUN/JpAprdJeamFBgJH1w folded before Flop (didn't bet)
Seat 6: d0J1xuhsynEY81YHwAvJ5g (button) collected ($0.60)




PokerStars Game #59939540530:  Hold'em No Limit ($0.10/$0.25) - 2009/07/01 0:42:30 ET
Table 'b64Z+5XI1xkQzNfq4QHr3A' 6-max Seat #3 is the button
Seat 1: qccGLncfUaN00Few5HsgYg ($56.50 in chips) 
Seat 2: SS/yfeArhULzIcOPe8MdPg ($34.40 in chips) 
Seat 3: u/yN5P9f3KlATg6WLWNkBQ ($24.50 in chips) 
Seat 4: SxIIgwXYLkwd6m3wLyPTCw ($25 in chips) 
Seat 5: d0J1xuhsynEY81YHwAvJ5g ($33.25 in chips) 
Seat 6: 8ClCHtFXGNplITm+63KB+Q ($38.35 in chips) 
SxIIgwXYLkwd6m3wLyPTCw: posts small blind $0.10
d0J1xuhsynEY81YHwAvJ5g: posts big blind $0.25
*** HOLE CARDS ***
8ClCHtFXGNplITm+63KB+Q: raises $0.75 to $1
qccGLncfUaN00Few5HsgYg: folds 
SS/yfeArhULzIcOPe8MdPg: raises $2.50 to $3.50
u/yN5P9f3KlATg6WLWNkBQ: folds 
SxIIgwXYLkwd6m3wLyPTCw: folds 
d0J1xuhsynEY81YHwAvJ5g: folds 
8ClCHtFXGNplITm+63KB+Q: folds 
Uncalled bet ($2.50) returned to SS/yfeArhULzIcOPe8MdPg
SS/yfeArhULzIcOPe8MdPg collected $2.35 from pot
*** SUMMARY ***
Total pot $2.35 | Rake $0 
Seat 1: qccGLncfUaN00Few5HsgYg folded before Flop (didn't bet)
Seat 2: SS/yfeArhULzIcOPe8MdPg collected ($2.35)
Seat 3: u/yN5P9f3KlATg6WLWNkBQ (button) folded before Flop (didn't bet)
Seat 4: SxIIgwXYLkwd6m3wLyPTCw (small blind) folded before Flop
Seat 5: d0J1xuhsynEY81YHwAvJ5g (big blind) folded before Flop
Seat 6: 8ClCHtFXGNplITm+63KB+Q folded before Flop




PokerStars Game #59939540576:  Hold'em No Limit ($0.10/$0.25) - 2009/07/01 0:42:30 ET
Table 'xPn6TS/y/OWkX7Qa+MUuKA' 6-max Seat #5 is the button
Seat 1: JFIAqU8lCZ0vWwEl4bdGsg ($27.75 in chips) 
Seat 2: buyjetgNT1McXtdaP4zynA ($20.15 in chips) 
Seat 3: o08wk0F4gROLhZS04Iyl3w ($26.35 in chips) 
Seat 4: SS/yfeArhULzIcOPe8MdPg ($28 in chips) 
Seat 5: I1TxPvWj8NfG8orglCinNA ($38.90 in chips) 
Seat 6: oseFhpinoe+Zg4j5xyBjyQ ($54.30 in chips) 
oseFhpinoe+Zg4j5xyBjyQ: posts small blind $0.10
JFIAqU8lCZ0vWwEl4bdGsg: posts big blind $0.25
*** HOLE CARDS ***
buyjetgNT1McXtdaP4zynA: calls $0.25
o08wk0F4gROLhZS04Iyl3w: folds 
SS/yfeArhULzIcOPe8MdPg: raises $1 to $1.25
I1TxPvWj8NfG8orglCinNA: folds 
oseFhpinoe+Zg4j5xyBjyQ: folds 
JFIAqU8lCZ0vWwEl4bdGsg: folds 
buyjetgNT1McXtdaP4zynA: calls $1
*** FLOP *** [2c Th 8d]
buyjetgNT1McXtdaP4zynA: checks 
SS/yfeArhULzIcOPe8MdPg: bets $2
o08wk0F4gROLhZS04Iyl3w is disconnected 
buyjetgNT1McXtdaP4zynA: raises $3.25 to $5.25
o08wk0F4gROLhZS04Iyl3w is connected 
SS/yfeArhULzIcOPe8MdPg: raises $15.50 to $20.75
buyjetgNT1McXtdaP4zynA: folds 
Uncalled bet ($15.50) returned to SS/yfeArhULzIcOPe8MdPg
SS/yfeArhULzIcOPe8MdPg collected $12.70 from pot
SS/yfeArhULzIcOPe8MdPg: doesn't show hand 
*** SUMMARY ***
Total pot $13.35 | Rake $0.65 
Board [2c Th 8d]
Seat 1: JFIAqU8lCZ0vWwEl4bdGsg (big blind) folded before Flop
Seat 2: buyjetgNT1McXtdaP4zynA folded on the Flop
Seat 3: o08wk0F4gROLhZS04Iyl3w folded before Flop (didn't bet)
Seat 4: SS/yfeArhULzIcOPe8MdPg collected ($12.70)
Seat 5: I1TxPvWj8NfG8orglCinNA (button) folded before Flop (didn't bet)
Seat 6: oseFhpinoe+Zg4j5xyBjyQ (small blind) folded before Flop




PokerStars Game #59939541232:  Hold'em No Limit ($0.10/$0.25) - 2009/07/01 0:42:31 ET
Table 'APEHQjIcZHDZUA4iOjju2g' 6-max Seat #5 is the button
Seat 1: eHsmIvAb2JREg4O6hNPnXg ($6.75 in chips) 
Seat 2: 3zD3qLXT1bEffAoWGnc7wg ($25 in chips) 
Seat 3: E7KSkgfIsmIsp0vLnmGFmA ($13.70 in chips) 
Seat 4: EqXTTLKUlDlz7yi6ziyyWA ($37.50 in chips) 
Seat 5: /xN6gc9+8Hew0HxaB6VIVg ($31 in chips) 
Seat 6: y7HCJfEmolBCFdi/0j5TRg ($44.45 in chips) 
y7HCJfEmolBCFdi/0j5TRg: posts small blind $0.10
eHsmIvAb2JREg4O6hNPnXg: posts big blind $0.25
*** HOLE CARDS ***
3zD3qLXT1bEffAoWGnc7wg: folds 
E7KSkgfIsmIsp0vLnmGFmA: folds 
EqXTTLKUlDlz7yi6ziyyWA: folds 
/xN6gc9+8Hew0HxaB6VIVg: folds 
y7HCJfEmolBCFdi/0j5TRg: calls $0.15
eHsmIvAb2JREg4O6hNPnXg: checks 
*** FLOP *** [Ah Td 3s]
y7HCJfEmolBCFdi/0j5TRg: checks 
eHsmIvAb2JREg4O6hNPnXg: checks 
*** TURN *** [Ah Td 3s] [Tc]
y7HCJfEmolBCFdi/0j5TRg: bets $0.40
eHsmIvAb2JREg4O6hNPnXg: folds 
Uncalled bet ($0.40) returned to y7HCJfEmolBCFdi/0j5TRg
y7HCJfEmolBCFdi/0j5TRg collected $0.50 from pot
*** SUMMARY ***
Total pot $0.50 | Rake $0 
Board [Ah Td 3s Tc]
Seat 1: eHsmIvAb2JREg4O6hNPnXg (big blind) folded on the Turn
Seat 2: 3zD3qLXT1bEffAoWGnc7wg folded before Flop (didn't bet)
Seat 3: E7KSkgfIsmIsp0vLnmGFmA folded before Flop (didn't bet)
Seat 4: EqXTTLKUlDlz7yi6ziyyWA folded before Flop (didn't bet)
Seat 5: /xN6gc9+8Hew0HxaB6VIVg (button) folded before Flop (didn't bet)
Seat 6: y7HCJfEmolBCFdi/0j5TRg (small blind) collected ($0.50)




PokerStars Game #59939541150:  Hold'em No Limit ($0.10/$0.25) - 2009/07/01 0:42:31 ET
Table 'T/iCKJXGphRN3xcdwfE/JQ' 6-max Seat #3 is the button
Seat 1: zZ8zH49EwNs0mqgppOaL9g ($25 in chips) 
Seat 3: R6AGToFJQOYVZAjC2jXEKw ($23.85 in chips) 
Seat 4: yzFNNFIfC89bBPwpFPx2ow ($58.25 in chips) 
Seat 5: DzdrMZ6l84e65/zfW+2bcA ($4.60 in chips) 
Seat 6: jKYGBgexhqKT13Xana4EHg ($14.45 in chips) 
yzFNNFIfC89bBPwpFPx2ow: posts small blind $0.10
DzdrMZ6l84e65/zfW+2bcA: posts big blind $0.25
*** HOLE CARDS ***
FHilMb2i2DbUCc9lplszog said, "pfff"
jKYGBgexhqKT13Xana4EHg: folds 
zZ8zH49EwNs0mqgppOaL9g: folds 
FHilMb2i2DbUCc9lplszog leaves the table
R6AGToFJQOYVZAjC2jXEKw: raises $0.75 to $1
yzFNNFIfC89bBPwpFPx2ow: folds 
DzdrMZ6l84e65/zfW+2bcA: folds 
Uncalled bet ($0.75) returned to R6AGToFJQOYVZAjC2jXEKw
R6AGToFJQOYVZAjC2jXEKw collected $0.60 from pot
R6AGToFJQOYVZAjC2jXEKw: doesn't show hand 
*** SUMMARY ***
Total pot $0.60 | Rake $0 
Seat 1: zZ8zH49EwNs0mqgppOaL9g folded before Flop (didn't bet)
Seat 3: R6AGToFJQOYVZAjC2jXEKw (button) collected ($0.60)
Seat 4: yzFNNFIfC89bBPwpFPx2ow (small blind) folded before Flop
Seat 5: DzdrMZ6l84e65/zfW+2bcA (big blind) folded before Flop
Seat 6: jKYGBgexhqKT13Xana4EHg folded before Flop (didn't bet)




PokerStars Game #59939541372:  Hold'em No Limit ($0.10/$0.25) - 2009/07/01 0:42:31 ET
Table 'BpNkESDX1ip9c0K1hb5h7A' 6-max Seat #1 is the button
Seat 1: 9jSiy0meE9XJKkdIZwyTEQ ($28.90 in chips) 
Seat 2: gqW2aBCmrIw65BvwjTFN6Q ($25 in chips) 
Seat 3: cHhVLDikFlByGGN+CM3w/A ($25.85 in chips) 
Seat 5: QvTX2yGq3uKJiKPmns4TKQ ($71.55 in chips) 
Seat 6: iUgsn+WyKFjjVd+tj13R2w ($15.35 in chips) 
tbhYGxTClzdFLMcTtjvJhg said, "O)&^^E#)#)R&)&E{E)E{R(*EQWEQWRWQ"
gqW2aBCmrIw65BvwjTFN6Q: posts small blind $0.10
cHhVLDikFlByGGN+CM3w/A: posts big blind $0.25
*** HOLE CARDS ***
QvTX2yGq3uKJiKPmns4TKQ: folds 
iUgsn+WyKFjjVd+tj13R2w: calls $0.25
9jSiy0meE9XJKkdIZwyTEQ: folds 
gqW2aBCmrIw65BvwjTFN6Q: calls $0.15
cHhVLDikFlByGGN+CM3w/A: raises $1.55 to $1.80
tbhYGxTClzdFLMcTtjvJhg said, "HATE THIS PLACE"
iUgsn+WyKFjjVd+tj13R2w: folds 
gqW2aBCmrIw65BvwjTFN6Q: folds 
Uncalled bet ($1.55) returned to cHhVLDikFlByGGN+CM3w/A
cHhVLDikFlByGGN+CM3w/A collected $0.75 from pot
cHhVLDikFlByGGN+CM3w/A: doesn't show hand 
*** SUMMARY ***
Total pot $0.75 | Rake $0 
Seat 1: 9jSiy0meE9XJKkdIZwyTEQ (button) folded before Flop (didn't bet)
Seat 2: gqW2aBCmrIw65BvwjTFN6Q (small blind) folded before Flop
Seat 3: cHhVLDikFlByGGN+CM3w/A (big blind) collected ($0.75)
Seat 5: QvTX2yGq3uKJiKPmns4TKQ folded before Flop (didn't bet)
Seat 6: iUgsn+WyKFjjVd+tj13R2w folded before Flop




PokerStars Game #59939540846:  Hold'em No Limit ($0.10/$0.25) - 2009/07/01 0:42:31 ET
Table 'yRuHgMpxv4rPBXeM6HFESw' 6-max Seat #2 is the button
Seat 1: MkNgTuvyxpHXkeIm5JITHQ ($8.60 in chips) 
Seat 2: iwlxXocltgSdaBmusNXanQ ($15.45 in chips) 
Seat 4: ypXnt+kzrF/5y8QN2rkt1A ($20.20 in chips) 
Seat 5: gaPMxLGp9SOj4Lq6t+/0Ig ($13.65 in chips) 
Seat 6: 4YSTu0Cdzpppe1lUgCZGCQ ($26.15 in chips) 
zZ8zH49EwNs0mqgppOaL9g will be allowed to play after the button
ypXnt+kzrF/5y8QN2rkt1A: posts small blind $0.10
gaPMxLGp9SOj4Lq6t+/0Ig: posts big blind $0.25
*** HOLE CARDS ***
4YSTu0Cdzpppe1lUgCZGCQ: folds 
MkNgTuvyxpHXkeIm5JITHQ: raises $0.75 to $1
iwlxXocltgSdaBmusNXanQ: folds 
ypXnt+kzrF/5y8QN2rkt1A: calls $0.90
gaPMxLGp9SOj4Lq6t+/0Ig: folds 
*** FLOP *** [7s 4c 5h]
ypXnt+kzrF/5y8QN2rkt1A: bets $0.50
MkNgTuvyxpHXkeIm5JITHQ: folds 
Uncalled bet ($0.50) returned to ypXnt+kzrF/5y8QN2rkt1A
ypXnt+kzrF/5y8QN2rkt1A collected $2.15 from pot
*** SUMMARY ***
Total pot $2.25 | Rake $0.10 
Board [7s 4c 5h]
Seat 1: MkNgTuvyxpHXkeIm5JITHQ folded on the Flop
Seat 2: iwlxXocltgSdaBmusNXanQ (button) folded before Flop (didn't bet)
Seat 4: ypXnt+kzrF/5y8QN2rkt1A (small blind) collected ($2.15)
Seat 5: gaPMxLGp9SOj4Lq6t+/0Ig (big blind) folded before Flop
Seat 6: 4YSTu0Cdzpppe1lUgCZGCQ folded before Flop (didn't bet)




PokerStars Game #59939540922:  Hold'em No Limit ($0.10/$0.25) - 2009/07/01 0:42:31 ET
Table 'M8kYidAX3ib7pLKW7edFLw' 6-max Seat #5 is the button
Seat 3: q+Sip/IIcvzqgZt1pJAWTw ($9.30 in chips) 
Seat 4: /bjna2FTN7pPjqYGzmDE0Q ($24.80 in chips) 
Seat 5: bDKopKTvPi3W+PEnYUX3tg ($25.35 in chips) 
chet188 will be allowed to play after the button
q+Sip/IIcvzqgZt1pJAWTw: posts small blind $0.10
/bjna2FTN7pPjqYGzmDE0Q: posts big blind $0.25
*** HOLE CARDS ***
bDKopKTvPi3W+PEnYUX3tg: raises $0.75 to $1
q+Sip/IIcvzqgZt1pJAWTw: folds 
/bjna2FTN7pPjqYGzmDE0Q: folds 
Uncalled bet ($0.75) returned to bDKopKTvPi3W+PEnYUX3tg
bDKopKTvPi3W+PEnYUX3tg collected $0.60 from pot
bDKopKTvPi3W+PEnYUX3tg: doesn't show hand 
*** SUMMARY ***
Total pot $0.60 | Rake $0 
Seat 3: q+Sip/IIcvzqgZt1pJAWTw (small blind) folded before Flop
Seat 4: /bjna2FTN7pPjqYGzmDE0Q (big blind) folded before Flop
Seat 5: bDKopKTvPi3W+PEnYUX3tg (button) collected ($0.60)




PokerStars Game #59939541236:  Hold'em No Limit ($0.10/$0.25) - 2009/07/01 0:42:31 ET
Table 'IfRHUn9gQQA9I/Z4tn+BoA' 9-max Seat #6 is the button
Seat 1: vSkQm2EelzwRGDDQQk0Fqw ($4.65 in chips) 
Seat 2: zgWbKMp0/btzsnVbQWKXww ($5.55 in chips) 
Seat 3: iAQDnrJCZVD1LzAGxTYegw ($25.25 in chips) 
Seat 4: QEbIGci+itdw+re8RM5fZA ($25 in chips) 
Seat 5: 10584482 ($17.25 in chips) 
Seat 6: UOjoGGQ58/uDS7V0xkjOrQ ($6.55 in chips) 
Seat 7: TeWJxSETzbXGiYKx0y+dtg ($35.80 in chips) 
Seat 8: cZ99hugmLBj9KhTlc8nCSw ($25 in chips) 
TeWJxSETzbXGiYKx0y+dtg: posts small blind $0.10
cZ99hugmLBj9KhTlc8nCSw: posts big blind $0.25
7cv+9Zc9HIQHNvYsMfV3uA: sits out 
*** HOLE CARDS ***
vSkQm2EelzwRGDDQQk0Fqw: folds 
zgWbKMp0/btzsnVbQWKXww: folds 
iAQDnrJCZVD1LzAGxTYegw: folds 
QEbIGci+itdw+re8RM5fZA: folds 
10584482: folds 
UOjoGGQ58/uDS7V0xkjOrQ: folds 
zgWbKMp0/btzsnVbQWKXww leaves the table
TeWJxSETzbXGiYKx0y+dtg: folds 
Uncalled bet ($0.15) returned to cZ99hugmLBj9KhTlc8nCSw
cZ99hugmLBj9KhTlc8nCSw collected $0.20 from pot
cZ99hugmLBj9KhTlc8nCSw: doesn't show hand 
*** SUMMARY ***
Total pot $0.20 | Rake $0 
Seat 1: vSkQm2EelzwRGDDQQk0Fqw folded before Flop (didn't bet)
Seat 2: zgWbKMp0/btzsnVbQWKXww folded before Flop (didn't bet)
Seat 3: iAQDnrJCZVD1LzAGxTYegw folded before Flop (didn't bet)
Seat 4: QEbIGci+itdw+re8RM5fZA folded before Flop (didn't bet)
Seat 5: 10584482 folded before Flop (didn't bet)
Seat 6: UOjoGGQ58/uDS7V0xkjOrQ (button) folded before Flop (didn't bet)
Seat 7: TeWJxSETzbXGiYKx0y+dtg (small blind) folded before Flop
Seat 8: cZ99hugmLBj9KhTlc8nCSw (big blind) collected ($0.20)




PokerStars Game #59939541528:  Hold'em No Limit ($0.10/$0.25) - 2009/07/01 0:42:32 ET
Table 'T/iCKJXGphRN3xcdwfE/JQJYkCJJ5Iv+Tu52jx2lpEcgSeat #3 is the button
Seat 1: Yv4fucyyT28mjx8V5lxKJg ($30.25 in chips) 
Seat 2: hBMUlEpyU74r/fwDgIpXjQ ($35.25 in chips) 
Seat 3: Z5ZtGOON8kmSdSCll9Z3XA ($7.75 in chips) 
Seat 5: 6OVSxS1KoddUCYNkZ4hREw ($28.35 in chips) 
Seat 6: OiV1PWZ3IkN29JlmCcnTwQ ($5 in chips) 
Seat 7: N6fYvIzQLKaydFLKQGtMlQ ($24.90 in chips) 
Seat 8: COsrwJSFHQtxlUcrYtDQPQ ($25 in chips) 
Seat 9: H9KUl8cmpLgEpOVDA00bCg ($5.15 in chips) 
6OVSxS1KoddUCYNkZ4hREw: posts small blind $0.10
OiV1PWZ3IkN29JlmCcnTwQ: posts big blind $0.25
*** HOLE CARDS ***
N6fYvIzQLKaydFLKQGtMlQ: folds 
COsrwJSFHQtxlUcrYtDQPQ: folds 
H9KUl8cmpLgEpOVDA00bCg: folds 
Yv4fucyyT28mjx8V5lxKJg: folds 
hBMUlEpyU74r/fwDgIpXjQ: raises $0.50 to $0.75
Z5ZtGOON8kmSdSCll9Z3XA: folds 
6OVSxS1KoddUCYNkZ4hREw: folds 
OiV1PWZ3IkN29JlmCcnTwQ: folds 
Uncalled bet ($0.50) returned to hBMUlEpyU74r/fwDgIpXjQ
hBMUlEpyU74r/fwDgIpXjQ collected $0.60 from pot
hBMUlEpyU74r/fwDgIpXjQ: doesn't show hand 
*** SUMMARY ***
Total pot $0.60 | Rake $0 
Seat 1: Yv4fucyyT28mjx8V5lxKJg folded before Flop (didn't bet)
Seat 2: hBMUlEpyU74r/fwDgIpXjQ collected ($0.60)
Seat 3: Z5ZtGOON8kmSdSCll9Z3XA (button) folded before Flop (didn't bet)
Seat 5: 6OVSxS1KoddUCYNkZ4hREw (small blind) folded before Flop
Seat 6: OiV1PWZ3IkN29JlmCcnTwQ (big blind) folded before Flop
Seat 7: N6fYvIzQLKaydFLKQGtMlQ folded before Flop (didn't bet)
Seat 8: COsrwJSFHQtxlUcrYtDQPQ folded before Flop (didn't bet)
Seat 9: H9KUl8cmpLgEpOVDA00bCg folded before Flop (didn't bet)




PokerStars Game #59939541884:  Hold'em No Limit ($0.10/$0.25) - 2009/07/01 0:42:32 ET
Table 'RPdw09/gGCIP4xFhDWJgXQ' 9-max Seat #3 is the button
Seat 1: aNpwfA31EREwO+ar4XzBCw ($25 in chips) 
Seat 2: Sd1tfhUq/M96GhXGv1hwFQ ($11 in chips) 
Seat 3: Qi+clOtyDiibLdH2/1Qy8g ($26 in chips) 
Seat 4: z5GxcHlYz/GSz6W2uFiTtg ($21.85 in chips) 
Seat 5: z0kymJfmEW9d8WGcY1n6OA ($2.25 in chips) 
Seat 6: monZeAwXUmIA1l84cUd2hw ($13.05 in chips) 
Seat 7: hIss79a4pu7GzJZepfgOpg ($25 in chips) 
Seat 8: MG90wfSJZnOejs/KD3vlQQ ($25 in chips) 
Seat 9: Yv4fucyyT28mjx8V5lxKJg ($54.20 in chips) 
z5GxcHlYz/GSz6W2uFiTtg: posts small blind $0.10
z0kymJfmEW9d8WGcY1n6OA: posts big blind $0.25
*** HOLE CARDS ***
monZeAwXUmIA1l84cUd2hw: calls $0.25
hIss79a4pu7GzJZepfgOpg: folds 
MG90wfSJZnOejs/KD3vlQQ: folds 
Yv4fucyyT28mjx8V5lxKJg: raises $1 to $1.25
aNpwfA31EREwO+ar4XzBCw: folds 
Sd1tfhUq/M96GhXGv1hwFQ: folds 
Qi+clOtyDiibLdH2/1Qy8g: folds 
z5GxcHlYz/GSz6W2uFiTtg: folds 
z0kymJfmEW9d8WGcY1n6OA: raises $1 to $2.25 and is all-in
monZeAwXUmIA1l84cUd2hw: folds 
Yv4fucyyT28mjx8V5lxKJg: calls $1
*** FLOP *** [Th 7d 4c]
*** TURN *** [Th 7d 4c] [Qc]
*** RIVER *** [Th 7d 4c Qc] [Ts]
*** SHOW DOWN ***
z0kymJfmEW9d8WGcY1n6OA: shows [4h 4d] (a full house, Fours full of Tens)
Yv4fucyyT28mjx8V5lxKJg: mucks hand 
z0kymJfmEW9d8WGcY1n6OA collected $4.65 from pot
*** SUMMARY ***
Total pot $4.85 | Rake $0.20 
Board [Th 7d 4c Qc Ts]
Seat 1: aNpwfA31EREwO+ar4XzBCw folded before Flop (didn't bet)
Seat 2: Sd1tfhUq/M96GhXGv1hwFQ folded before Flop (didn't bet)
Seat 3: Qi+clOtyDiibLdH2/1Qy8g (button) folded before Flop (didn't bet)
Seat 4: z5GxcHlYz/GSz6W2uFiTtg (small blind) folded before Flop
Seat 5: z0kymJfmEW9d8WGcY1n6OA (big blind) showed [4h 4d] and won ($4.65) with a full house, Fours full of Tens
Seat 6: monZeAwXUmIA1l84cUd2hw folded before Flop
Seat 7: hIss79a4pu7GzJZepfgOpg folded before Flop (didn't bet)
Seat 8: MG90wfSJZnOejs/KD3vlQQ folded before Flop (didn't bet)
Seat 9: Yv4fucyyT28mjx8V5lxKJg mucked




PokerStars Game #59939541530:  Hold'em No Limit ($0.10/$0.25) - 2009/07/01 0:42:32 ET
Table 'BdTkgy6SGkgNXul6irMoOw' 9-max Seat #1 is the button
Seat 1: Jd9JmKichu4pvsKjXEKNvA ($4.40 in chips) 
Seat 2: ljemhp25Zg+nlA9DLCIiUw ($39.05 in chips) 
Seat 3: RQ9/w/vIRUIpv009qodF2Q ($9 in chips) 
Seat 4: eygIcrabyU9hI2mw7NQsgg ($23.55 in chips) 
Seat 5: opOCI2p6kW0tINuVaAqmcQ ($25 in chips) 
Seat 6: XlP4n7rTkDteN8BWl//wvg ($20 in chips) 
Seat 7: b8t3jWrxzeEt9HtZtc9wUQ ($15 in chips) 
Seat 8: 8Y1YOndOSMx6Ei47RaGbrw ($15 in chips) 
Seat 9: 5dv9mRGKI/UifM58OINXVQ ($23.15 in chips) 
ljemhp25Zg+nlA9DLCIiUw: posts small blind $0.10
RQ9/w/vIRUIpv009qodF2Q: posts big blind $0.25
b8t3jWrxzeEt9HtZtc9wUQ: posts big blind $0.25
8Y1YOndOSMx6Ei47RaGbrw: posts big blind $0.25
*** HOLE CARDS ***
eygIcrabyU9hI2mw7NQsgg has timed out
eygIcrabyU9hI2mw7NQsgg: folds 
eygIcrabyU9hI2mw7NQsgg is sitting out
eygIcrabyU9hI2mw7NQsgg has returned
opOCI2p6kW0tINuVaAqmcQ: folds 
XlP4n7rTkDteN8BWl//wvg: raises $0.50 to $0.75
b8t3jWrxzeEt9HtZtc9wUQ: calls $0.50
8Y1YOndOSMx6Ei47RaGbrw: calls $0.50
5dv9mRGKI/UifM58OINXVQ: folds 
Jd9JmKichu4pvsKjXEKNvA: folds 
ljemhp25Zg+nlA9DLCIiUw: folds 
RQ9/w/vIRUIpv009qodF2Q: folds 
*** FLOP *** [Qc Ah 9h]
XlP4n7rTkDteN8BWl//wvg: checks 
b8t3jWrxzeEt9HtZtc9wUQ: checks 
8Y1YOndOSMx6Ei47RaGbrw: checks 
*** TURN *** [Qc Ah 9h] [Js]
XlP4n7rTkDteN8BWl//wvg: bets $1.75
b8t3jWrxzeEt9HtZtc9wUQ: folds 
8Y1YOndOSMx6Ei47RaGbrw: folds 
Uncalled bet ($1.75) returned to XlP4n7rTkDteN8BWl//wvg
XlP4n7rTkDteN8BWl//wvg collected $2.50 from pot
XlP4n7rTkDteN8BWl//wvg: doesn't show hand 
*** SUMMARY ***
Total pot $2.60 | Rake $0.10 
Board [Qc Ah 9h Js]
Seat 1: Jd9JmKichu4pvsKjXEKNvA (button) folded before Flop (didn't bet)
Seat 2: ljemhp25Zg+nlA9DLCIiUw (small blind) folded before Flop
Seat 3: RQ9/w/vIRUIpv009qodF2Q (big blind) folded before Flop
Seat 4: eygIcrabyU9hI2mw7NQsgg folded before Flop (didn't bet)
Seat 5: opOCI2p6kW0tINuVaAqmcQ folded before Flop (didn't bet)
Seat 6: XlP4n7rTkDteN8BWl//wvg collected ($2.50)
Seat 7: b8t3jWrxzeEt9HtZtc9wUQ folded on the Turn
Seat 8: 8Y1YOndOSMx6Ei47RaGbrw folded on the Turn
Seat 9: 5dv9mRGKI/UifM58OINXVQ folded before Flop (didn't bet)




PokerStars Game #59939542590:  Hold'em No Limit ($0.10/$0.25) - 2009/07/01 0:42:33 ET
Table 'KKk6y4pAXeymxYcd0uZLqg' 9-max Seat #6 is the button
Seat 1: HPEB+AtKw1+C/cxU0o1ciw ($24.90 in chips) 
Seat 3: 4oA316mXLIui1QY63GXBUg ($25 in chips) 
Seat 4: GTcLfsDTPqgfHyhY9FNDMw ($15.50 in chips) 
Seat 5: U0VVxBdRWdhRNdbJ+Qky1A ($45.35 in chips) 
Seat 6: LWN1wPrLH+695JIriXxDuw ($11.25 in chips) 
Seat 7: R3KkgiqTvuhazyCqaD9cZg ($10.05 in chips) 
Seat 8: +2kMBNpY4nF1qNCRd8SJLA ($26.10 in chips) 
Seat 9: j4q3p0lesp63b1gZDwLBZw ($5 in chips) 
R3KkgiqTvuhazyCqaD9cZg: posts small blind $0.10
+2kMBNpY4nF1qNCRd8SJLA: posts big blind $0.25
*** HOLE CARDS ***
j4q3p0lesp63b1gZDwLBZw: folds 
HPEB+AtKw1+C/cxU0o1ciw: folds 
4oA316mXLIui1QY63GXBUg: folds 
GTcLfsDTPqgfHyhY9FNDMw: folds 
U0VVxBdRWdhRNdbJ+Qky1A: folds 
LWN1wPrLH+695JIriXxDuw: calls $0.25
R3KkgiqTvuhazyCqaD9cZg: folds 
+2kMBNpY4nF1qNCRd8SJLA: checks 
*** FLOP *** [4h 7d 9s]
+2kMBNpY4nF1qNCRd8SJLA: bets $0.50
LWN1wPrLH+695JIriXxDuw: folds 
Uncalled bet ($0.50) returned to +2kMBNpY4nF1qNCRd8SJLA
+2kMBNpY4nF1qNCRd8SJLA collected $0.60 from pot
*** SUMMARY ***
Total pot $0.60 | Rake $0 
Board [4h 7d 9s]
Seat 1: HPEB+AtKw1+C/cxU0o1ciw folded before Flop (didn't bet)
Seat 3: 4oA316mXLIui1QY63GXBUg folded before Flop (didn't bet)
Seat 4: GTcLfsDTPqgfHyhY9FNDMw folded before Flop (didn't bet)
Seat 5: U0VVxBdRWdhRNdbJ+Qky1A folded before Flop (didn't bet)
Seat 6: LWN1wPrLH+695JIriXxDuw (button) folded on the Flop
Seat 7: R3KkgiqTvuhazyCqaD9cZg (small blind) folded before Flop
Seat 8: +2kMBNpY4nF1qNCRd8SJLA (big blind) collected ($0.60)
Seat 9: j4q3p0lesp63b1gZDwLBZw folded before Flop (didn't bet)




PokerStars Game #59939542472:  Hold'em No Limit ($0.10/$0.25) - 2009/07/01 0:42:33 ET
Table '9o8Yb3JpUqurD4pNVmOikQ' 6-max Seat #6 is the button
Seat 1: 5tB0F9NjPSUL4FzmzBMs2Q ($25.10 in chips) 
Seat 2: /gJNBeCkWL4o85/jvlZ4BA ($25 in chips) 
Seat 3: JgRqo1/2phbf7pab7N3BIQ ($13.10 in chips) 
Seat 6: k9vn40MOqqb+xF+7GZ6v2g ($34.55 in chips) 
5tB0F9NjPSUL4FzmzBMs2Q: posts small blind $0.10
/gJNBeCkWL4o85/jvlZ4BA: posts big blind $0.25
*** HOLE CARDS ***
JgRqo1/2phbf7pab7N3BIQ: calls $0.25
k9vn40MOqqb+xF+7GZ6v2g: folds 
5tB0F9NjPSUL4FzmzBMs2Q: folds 
/gJNBeCkWL4o85/jvlZ4BA: checks 
*** FLOP *** [8h 6d Qc]
/gJNBeCkWL4o85/jvlZ4BA: checks 
JgRqo1/2phbf7pab7N3BIQ: bets $0.50
/gJNBeCkWL4o85/jvlZ4BA: folds 
Uncalled bet ($0.50) returned to JgRqo1/2phbf7pab7N3BIQ
JgRqo1/2phbf7pab7N3BIQ collected $0.60 from pot
*** SUMMARY ***
Total pot $0.60 | Rake $0 
Board [8h 6d Qc]
Seat 1: 5tB0F9NjPSUL4FzmzBMs2Q (small blind) folded before Flop
Seat 2: /gJNBeCkWL4o85/jvlZ4BA (big blind) folded on the Flop
Seat 3: JgRqo1/2phbf7pab7N3BIQ collected ($0.60)
Seat 6: k9vn40MOqqb+xF+7GZ6v2g (button) folded before Flop (didn't bet)




PokerStars Game #59939542180:  Hold'em No Limit ($0.10/$0.25) - 2009/07/01 0:42:33 ET
Table 'UVjmXTtsmlX1HxwwZ59akg' 9-max Seat #1 is the button
Seat 1: zDrucyjVn5aeekNEc3cJrA ($28.80 in chips) 
Seat 3: N6fYvIzQLKaydFLKQGtMlQ ($24.65 in chips) 
Seat 4: aNpwfA31EREwO+ar4XzBCw ($25 in chips) 
Seat 6: DnDcAdn9P0zGovMERigpFA ($33.75 in chips) 
COsrwJSFHQtxlUcrYtDQPQ: is sitting out 
N6fYvIzQLKaydFLKQGtMlQ: posts small blind $0.10
aNpwfA31EREwO+ar4XzBCw: posts big blind $0.25
*** HOLE CARDS ***
DnDcAdn9P0zGovMERigpFA: folds 
zDrucyjVn5aeekNEc3cJrA: folds 
N6fYvIzQLKaydFLKQGtMlQ: folds 
Uncalled bet ($0.15) returned to aNpwfA31EREwO+ar4XzBCw
aNpwfA31EREwO+ar4XzBCw collected $0.20 from pot
aNpwfA31EREwO+ar4XzBCw: doesn't show hand 
*** SUMMARY ***
Total pot $0.20 | Rake $0 
Seat 1: zDrucyjVn5aeekNEc3cJrA (button) folded before Flop (didn't bet)
Seat 3: N6fYvIzQLKaydFLKQGtMlQ (small blind) folded before Flop
Seat 4: aNpwfA31EREwO+ar4XzBCw (big blind) collected ($0.20)
Seat 6: DnDcAdn9P0zGovMERigpFA folded before Flop (didn't bet)




PokerStars Game #59939542574:  Hold'em No Limit ($0.10/$0.25) - 2009/07/01 0:42:33 ET
Table 'AJGgX1ZYM8d68SWMvaLttg' 6-max Seat #2 is the button
Seat 1: sT4sjqzVMH/fZHz0hkbIPw ($39.20 in chips) 
Seat 2: zHHLkD2sRljslKKeQv/ZQw ($30.50 in chips) 
Seat 3: 4x9jCqgSw4272dnaIqnanw ($7.10 in chips) 
Seat 4: Lz/GjRDgmgepqTR7qmS86w ($17.35 in chips) 
Seat 5: SFmT9ZsVopnukjvAzrxTRg ($28.60 in chips) 
Seat 6: UA5OsKS3VPaxa7uC8La/kA ($27.75 in chips) 
4x9jCqgSw4272dnaIqnanw: posts small blind $0.10
Lz/GjRDgmgepqTR7qmS86w: posts big blind $0.25
*** HOLE CARDS ***
SFmT9ZsVopnukjvAzrxTRg: folds 
UA5OsKS3VPaxa7uC8La/kA: folds 
sT4sjqzVMH/fZHz0hkbIPw: raises $0.50 to $0.75
zHHLkD2sRljslKKeQv/ZQw: calls $0.75
4x9jCqgSw4272dnaIqnanw: folds 
Lz/GjRDgmgepqTR7qmS86w: calls $0.50
*** FLOP *** [2s As 3h]
Lz/GjRDgmgepqTR7qmS86w: checks 
sT4sjqzVMH/fZHz0hkbIPw: bets $1.25
zHHLkD2sRljslKKeQv/ZQw: folds 
Lz/GjRDgmgepqTR7qmS86w: calls $1.25
*** TURN *** [2s As 3h] [Th]
Lz/GjRDgmgepqTR7qmS86w: checks 
sT4sjqzVMH/fZHz0hkbIPw: bets $2.50
Lz/GjRDgmgepqTR7qmS86w: calls $2.50
*** RIVER *** [2s As 3h Th] [9h]
Lz/GjRDgmgepqTR7qmS86w: checks 
sT4sjqzVMH/fZHz0hkbIPw: bets $7.50
Lz/GjRDgmgepqTR7qmS86w: folds 
Uncalled bet ($7.50) returned to sT4sjqzVMH/fZHz0hkbIPw
sT4sjqzVMH/fZHz0hkbIPw collected $9.40 from pot
sT4sjqzVMH/fZHz0hkbIPw: doesn't show hand 
*** SUMMARY ***
Total pot $9.85 | Rake $0.45 
Board [2s As 3h Th 9h]
Seat 1: sT4sjqzVMH/fZHz0hkbIPw collected ($9.40)
Seat 2: zHHLkD2sRljslKKeQv/ZQw (button) folded on the Flop
Seat 3: 4x9jCqgSw4272dnaIqnanw (small blind) folded before Flop
Seat 4: Lz/GjRDgmgepqTR7qmS86w (big blind) folded on the River
Seat 5: SFmT9ZsVopnukjvAzrxTRg folded before Flop (didn't bet)
Seat 6: UA5OsKS3VPaxa7uC8La/kA folded before Flop (didn't bet)




PokerStars Game #59939542398:  Hold'em No Limit ($0.10/$0.25) - 2009/07/01 0:42:33 ET
Table 'WY+lMaAoIdBZmwk27/RJCA' 6-max Seat #2 is the button
Seat 1: lYjWCpfCxX2kgcHY3v4Yow ($25 in chips) 
Seat 2: cPO/1/dTcZpLkQFm3jH3Rg ($25 in chips) 
Seat 3: 79Q62AM0VB++TQYiBlOYsA ($37.55 in chips) 
Seat 4: cGfAi40F+9odP4v0stvfiQ ($31.50 in chips) 
Seat 5: wKFJ513ucluNNiMlkXcDOQ ($25 in chips) 
Seat 6: I1TxPvWj8NfG8orglCinNA ($27.35 in chips) 
79Q62AM0VB++TQYiBlOYsA: posts small blind $0.10
cGfAi40F+9odP4v0stvfiQ: posts big blind $0.25
*** HOLE CARDS ***
wKFJ513ucluNNiMlkXcDOQ: folds 
I1TxPvWj8NfG8orglCinNA: folds 
lYjWCpfCxX2kgcHY3v4Yow: folds 
cPO/1/dTcZpLkQFm3jH3Rg: raises $0.50 to $0.75
79Q62AM0VB++TQYiBlOYsA: folds 
cGfAi40F+9odP4v0stvfiQ: folds 
Uncalled bet ($0.50) returned to cPO/1/dTcZpLkQFm3jH3Rg
cPO/1/dTcZpLkQFm3jH3Rg collected $0.60 from pot
*** SUMMARY ***
Total pot $0.60 | Rake $0 
Seat 1: lYjWCpfCxX2kgcHY3v4Yow folded before Flop (didn't bet)
Seat 2: cPO/1/dTcZpLkQFm3jH3Rg (button) collected ($0.60)
Seat 3: 79Q62AM0VB++TQYiBlOYsA (small blind) folded before Flop
Seat 4: cGfAi40F+9odP4v0stvfiQ (big blind) folded before Flop
Seat 5: wKFJ513ucluNNiMlkXcDOQ folded before Flop (didn't bet)
Seat 6: I1TxPvWj8NfG8orglCinNA folded before Flop (didn't bet)




PokerStars Game #59939542624:  Hold'em No Limit ($0.10/$0.25) - 2009/07/01 0:42:34 ET
Table 'VQNfcI8vTBCTvRfd3veTLQ' 6-max Seat #4 is the button
Seat 1: ymz+a8dgHSUFPooYplw7Ow ($23.95 in chips) 
Seat 2: KukIGupqqJCXA+Hp2bEFnA ($6.45 in chips) 
Seat 3: LtASJ9OlkqGrrUKGQlpGAw ($23.05 in chips) 
Seat 4: nc79pm0LZRdhncq55evVqA ($25.05 in chips) 
Seat 5: gX2vbKwS/8zZPENAWB7hxQ ($9.85 in chips) 
Seat 6: dlCLwmcvRShnuFDEVkdIEA ($13.25 in chips) 
gX2vbKwS/8zZPENAWB7hxQ: posts small blind $0.10
dlCLwmcvRShnuFDEVkdIEA: posts big blind $0.25
*** HOLE CARDS ***
ymz+a8dgHSUFPooYplw7Ow: raises $0.75 to $1
KukIGupqqJCXA+Hp2bEFnA: folds 
LtASJ9OlkqGrrUKGQlpGAw: folds 
nc79pm0LZRdhncq55evVqA: folds 
gX2vbKwS/8zZPENAWB7hxQ: folds 
dlCLwmcvRShnuFDEVkdIEA: folds 
Uncalled bet ($0.75) returned to ymz+a8dgHSUFPooYplw7Ow
ymz+a8dgHSUFPooYplw7Ow collected $0.60 from pot
ymz+a8dgHSUFPooYplw7Ow: doesn't show hand 
*** SUMMARY ***
Total pot $0.60 | Rake $0 
Seat 1: ymz+a8dgHSUFPooYplw7Ow collected ($0.60)
Seat 2: KukIGupqqJCXA+Hp2bEFnA folded before Flop (didn't bet)
Seat 3: LtASJ9OlkqGrrUKGQlpGAw folded before Flop (didn't bet)
Seat 4: nc79pm0LZRdhncq55evVqA (button) folded before Flop (didn't bet)
Seat 5: gX2vbKwS/8zZPENAWB7hxQ (small blind) folded before Flop
Seat 6: dlCLwmcvRShnuFDEVkdIEA (big blind) folded before Flop




PokerStars Game #59939542820:  Hold'em No Limit ($0.10/$0.25) - 2009/07/01 0:42:34 ET
Table 'f9j+4UOgRPXbyNbQkZFm4w' 6-max Seat #3 is the button
Seat 1: trN/oHqTTbPw5MNuKrOpLw ($30.50 in chips) 
Seat 2: VHBox3ZuV+/MP3dz2hFEBQ ($6 in chips) 
Seat 3: wCBHaebpIJ2ZTqigoRi9DA ($22.20 in chips) 
Seat 4: hiTEr3yrERiQp3zHXRioVw ($21.50 in chips) 
Seat 5: 1lxYIAoJdZwAbzIkzWmSkw ($6.60 in chips) 
Seat 6: C84t1kUtjDF/zm38/Dpcng ($13.65 in chips) 
hiTEr3yrERiQp3zHXRioVw: posts small blind $0.10
1lxYIAoJdZwAbzIkzWmSkw: posts big blind $0.25
VHBox3ZuV+/MP3dz2hFEBQ: posts small & big blinds $0.35
*** HOLE CARDS ***
C84t1kUtjDF/zm38/Dpcng: calls $0.25
trN/oHqTTbPw5MNuKrOpLw: folds 
VHBox3ZuV+/MP3dz2hFEBQ: checks 
wCBHaebpIJ2ZTqigoRi9DA: folds 
hiTEr3yrERiQp3zHXRioVw: folds 
1lxYIAoJdZwAbzIkzWmSkw: checks 
*** FLOP *** [Kd 8h 7h]
1lxYIAoJdZwAbzIkzWmSkw: checks 
C84t1kUtjDF/zm38/Dpcng: bets $0.50
VHBox3ZuV+/MP3dz2hFEBQ: folds 
1lxYIAoJdZwAbzIkzWmSkw: folds 
Uncalled bet ($0.50) returned to C84t1kUtjDF/zm38/Dpcng
C84t1kUtjDF/zm38/Dpcng collected $0.95 from pot
*** SUMMARY ***
Total pot $0.95 | Rake $0 
Board [Kd 8h 7h]
Seat 1: trN/oHqTTbPw5MNuKrOpLw folded before Flop (didn't bet)
Seat 2: VHBox3ZuV+/MP3dz2hFEBQ folded on the Flop
Seat 3: wCBHaebpIJ2ZTqigoRi9DA (button) folded before Flop (didn't bet)
Seat 4: hiTEr3yrERiQp3zHXRioVw (small blind) folded before Flop
Seat 5: 1lxYIAoJdZwAbzIkzWmSkw (big blind) folded on the Flop
Seat 6: C84t1kUtjDF/zm38/Dpcng collected ($0.95)




PokerStars Game #59939543160:  Hold'em No Limit ($0.10/$0.25) - 2009/07/01 0:42:34 ET
Table 'a0kk1yz54EMczhut3KjrxQ' 6-max Seat #3 is the button
Seat 1: V3LJvbHVJHmOj2fd7zIDhA ($28.65 in chips) 
Seat 2: nc79pm0LZRdhncq55evVqA ($25 in chips) 
Seat 3: FabaCGPqGJLjRL48CMvjiQ ($22.50 in chips) 
Seat 4: FYepjhAvF8ZdVCmqHIy+eQ ($27.45 in chips) 
Seat 5: cPO/1/dTcZpLkQFm3jH3Rg ($26.15 in chips) 
Seat 6: DTzxFTXVrCqrpjq9B9Vg/g ($16.10 in chips) 
FYepjhAvF8ZdVCmqHIy+eQ: posts small blind $0.10
cPO/1/dTcZpLkQFm3jH3Rg: posts big blind $0.25
*** HOLE CARDS ***
DTzxFTXVrCqrpjq9B9Vg/g: folds 
V3LJvbHVJHmOj2fd7zIDhA: folds 
nc79pm0LZRdhncq55evVqA: folds 
FabaCGPqGJLjRL48CMvjiQ: raises $0.25 to $0.50
FYepjhAvF8ZdVCmqHIy+eQ: raises $1.50 to $2
cPO/1/dTcZpLkQFm3jH3Rg: folds 
FabaCGPqGJLjRL48CMvjiQ: folds 
Uncalled bet ($1.50) returned to FYepjhAvF8ZdVCmqHIy+eQ
FYepjhAvF8ZdVCmqHIy+eQ collected $1.25 from pot
FYepjhAvF8ZdVCmqHIy+eQ: doesn't show hand 
*** SUMMARY ***
Total pot $1.25 | Rake $0 
Seat 1: V3LJvbHVJHmOj2fd7zIDhA folded before Flop (didn't bet)
Seat 2: nc79pm0LZRdhncq55evVqA folded before Flop (didn't bet)
Seat 3: FabaCGPqGJLjRL48CMvjiQ (button) folded before Flop
Seat 4: FYepjhAvF8ZdVCmqHIy+eQ (small blind) collected ($1.25)
Seat 5: cPO/1/dTcZpLkQFm3jH3Rg (big blind) folded before Flop
Seat 6: DTzxFTXVrCqrpjq9B9Vg/g folded before Flop (didn't bet)




PokerStars Game #59939543090:  Hold'em No Limit ($0.10/$0.25) - 2009/07/01 0:42:34 ET
Table 'nc6OeGk/wtaWV+6N+kgnZQgZetDqJh6q9A3mLO3ThCsASeat #1 is the button
Seat 1: 1YCU970EVCcjs4GQP5Zt0g ($19.05 in chips) 
Seat 2: JFIAqU8lCZ0vWwEl4bdGsg ($25 in chips) 
Seat 4: eHsmIvAb2JREg4O6hNPnXg ($9 in chips) 
Seat 5: mfrkWA3PTeYPkbO6hi98Aw ($38.40 in chips) 
Seat 6: R1hR3/XSBdOHwcbSUJRJbg ($62 in chips) 
JFIAqU8lCZ0vWwEl4bdGsg: posts small blind $0.10
wKFJ513ucluNNiMlkXcDOQ: is sitting out 
eHsmIvAb2JREg4O6hNPnXg: posts big blind $0.25
*** HOLE CARDS ***
wKFJ513ucluNNiMlkXcDOQ leaves the table
mfrkWA3PTeYPkbO6hi98Aw: folds 
jp34e617tIzV8tKIWmfAbA joins the table at seat #3 
R1hR3/XSBdOHwcbSUJRJbg: folds 
1YCU970EVCcjs4GQP5Zt0g: folds 
JFIAqU8lCZ0vWwEl4bdGsg: calls $0.15
eHsmIvAb2JREg4O6hNPnXg: checks 
*** FLOP *** [Kc 8c Th]
JFIAqU8lCZ0vWwEl4bdGsg: checks 
eHsmIvAb2JREg4O6hNPnXg: checks 
*** TURN *** [Kc 8c Th] [Qd]
JFIAqU8lCZ0vWwEl4bdGsg: checks 
eHsmIvAb2JREg4O6hNPnXg: bets $0.50
JFIAqU8lCZ0vWwEl4bdGsg: calls $0.50
*** RIVER *** [Kc 8c Th Qd] [4s]
JFIAqU8lCZ0vWwEl4bdGsg: checks 
eHsmIvAb2JREg4O6hNPnXg: checks 
*** SHOW DOWN ***
JFIAqU8lCZ0vWwEl4bdGsg: shows [9d 7d] (high card King)
eHsmIvAb2JREg4O6hNPnXg: shows [5s 5h] (a pair of Fives)
eHsmIvAb2JREg4O6hNPnXg collected $1.45 from pot
*** SUMMARY ***
Total pot $1.50 | Rake $0.05 
Board [Kc 8c Th Qd 4s]
Seat 1: 1YCU970EVCcjs4GQP5Zt0g (button) folded before Flop (didn't bet)
Seat 2: JFIAqU8lCZ0vWwEl4bdGsg (small blind) showed [9d 7d] and lost with high card King
Seat 4: eHsmIvAb2JREg4O6hNPnXg (big blind) showed [5s 5h] and won ($1.45) with a pair of Fives
Seat 5: mfrkWA3PTeYPkbO6hi98Aw folded before Flop (didn't bet)
Seat 6: R1hR3/XSBdOHwcbSUJRJbg folded before Flop (didn't bet)




PokerStars Game #59939543084:  Hold'em No Limit ($0.10/$0.25) - 2009/07/01 0:42:34 ET
Table 'u5gc8WdJbaPqEonQaM8rHA' 9-max Seat #1 is the button
Seat 1: rXm4QDVJt67H20lM6n6Z7Q ($8.05 in chips) 
Seat 2: YcYxPZXJR8KffyXgr1BkHw ($28.50 in chips) 
Seat 5: 4y3ZJtAlW/aXjQX7SXyjrQ ($25.10 in chips) 
Seat 6: iPe2eRZr++z/LEfORn3WBQ ($16.70 in chips) 
Seat 8: 9j9dK6T4bnFE4nxAg16ycg ($15 in chips) 
YcYxPZXJR8KffyXgr1BkHw: posts small blind $0.10
4y3ZJtAlW/aXjQX7SXyjrQ: posts big blind $0.25
9j9dK6T4bnFE4nxAg16ycg: posts big blind $0.25
*** HOLE CARDS ***
iPe2eRZr++z/LEfORn3WBQ: raises $0.50 to $0.75
9j9dK6T4bnFE4nxAg16ycg: calls $0.50
rXm4QDVJt67H20lM6n6Z7Q: folds 
YcYxPZXJR8KffyXgr1BkHw: folds 
4y3ZJtAlW/aXjQX7SXyjrQ: calls $0.50
*** FLOP *** [Kd Tc Kh]
4y3ZJtAlW/aXjQX7SXyjrQ: checks 
iPe2eRZr++z/LEfORn3WBQ: checks 
9j9dK6T4bnFE4nxAg16ycg: checks 
*** TURN *** [Kd Tc Kh] [6d]
4y3ZJtAlW/aXjQX7SXyjrQ: checks 
iPe2eRZr++z/LEfORn3WBQ: bets $0.75
9j9dK6T4bnFE4nxAg16ycg: calls $0.75
4y3ZJtAlW/aXjQX7SXyjrQ: calls $0.75
*** RIVER *** [Kd Tc Kh 6d] [Qs]
4y3ZJtAlW/aXjQX7SXyjrQ: checks 
iPe2eRZr++z/LEfORn3WBQ: bets $1.25
9j9dK6T4bnFE4nxAg16ycg: raises $1.25 to $2.50
4y3ZJtAlW/aXjQX7SXyjrQ: folds 
iPe2eRZr++z/LEfORn3WBQ: raises $12.70 to $15.20 and is all-in
9j9dK6T4bnFE4nxAg16ycg: calls $11 and is all-in
Uncalled bet ($1.70) returned to iPe2eRZr++z/LEfORn3WBQ
*** SHOW DOWN ***
iPe2eRZr++z/LEfORn3WBQ: shows [6s 6c] (a full house, Sixes full of Kings)
9j9dK6T4bnFE4nxAg16ycg: shows [Kc Ts] (a full house, Kings full of Tens)
9j9dK6T4bnFE4nxAg16ycg collected $30.05 from pot
*** SUMMARY ***
Total pot $31.60 | Rake $1.55 
Board [Kd Tc Kh 6d Qs]
Seat 1: rXm4QDVJt67H20lM6n6Z7Q (button) folded before Flop (didn't bet)
Seat 2: YcYxPZXJR8KffyXgr1BkHw (small blind) folded before Flop
Seat 5: 4y3ZJtAlW/aXjQX7SXyjrQ (big blind) folded on the River
Seat 6: iPe2eRZr++z/LEfORn3WBQ showed [6s 6c] and lost with a full house, Sixes full of Kings
Seat 8: 9j9dK6T4bnFE4nxAg16ycg showed [Kc Ts] and won ($30.05) with a full house, Kings full of Tens




PokerStars Game #59939542714:  Hold'em No Limit ($0.10/$0.25) - 2009/07/01 0:42:34 ET
Table '4mnXP0EWt9mMZYzTIVDQ0w' 9-max Seat #1 is the button
Seat 1: PTFwg4rGxnfVvj2iP1OI2w ($13.75 in chips) 
Seat 2: j4q3p0lesp63b1gZDwLBZw ($6.60 in chips) 
Seat 4: E0iYnEVO2ho7dH3QcCjw7g ($20.45 in chips) 
Seat 5: sSN8Y0AlsBeidZXPKmwXSw ($13.25 in chips) 
Seat 6: n9toqYXSLowQ/sWq842dEQ ($10.25 in chips) 
Seat 7: s1y+qfkBnhgc67+X3ThjeA ($27.20 in chips) 
Seat 8: H9KUl8cmpLgEpOVDA00bCg ($4.30 in chips) 
Seat 9: wbCayoP+N6xpKgOfIqZsbA ($21.85 in chips) 
j4q3p0lesp63b1gZDwLBZw: posts small blind $0.10
E0iYnEVO2ho7dH3QcCjw7g: posts big blind $0.25
*** HOLE CARDS ***
sSN8Y0AlsBeidZXPKmwXSw: folds 
n9toqYXSLowQ/sWq842dEQ: calls $0.25
s1y+qfkBnhgc67+X3ThjeA: calls $0.25
H9KUl8cmpLgEpOVDA00bCg: folds 
wbCayoP+N6xpKgOfIqZsbA: folds 
PTFwg4rGxnfVvj2iP1OI2w: folds 
j4q3p0lesp63b1gZDwLBZw: folds 
E0iYnEVO2ho7dH3QcCjw7g: raises $1.25 to $1.50
n9toqYXSLowQ/sWq842dEQ: folds 
s1y+qfkBnhgc67+X3ThjeA: folds 
Uncalled bet ($1.25) returned to E0iYnEVO2ho7dH3QcCjw7g
E0iYnEVO2ho7dH3QcCjw7g collected $0.85 from pot
*** SUMMARY ***
Total pot $0.85 | Rake $0 
Seat 1: PTFwg4rGxnfVvj2iP1OI2w (button) folded before Flop (didn't bet)
Seat 2: j4q3p0lesp63b1gZDwLBZw (small blind) folded before Flop
Seat 4: E0iYnEVO2ho7dH3QcCjw7g (big blind) collected ($0.85)
Seat 5: sSN8Y0AlsBeidZXPKmwXSw folded before Flop (didn't bet)
Seat 6: n9toqYXSLowQ/sWq842dEQ folded before Flop
Seat 7: s1y+qfkBnhgc67+X3ThjeA folded before Flop
Seat 8: H9KUl8cmpLgEpOVDA00bCg folded before Flop (didn't bet)
Seat 9: wbCayoP+N6xpKgOfIqZsbA folded before Flop (didn't bet)




PokerStars Game #59939543172:  Hold'em No Limit ($0.10/$0.25) - 2009/07/01 0:42:34 ET
Table '3eK1r4Q4BSYFvsKkuTLpIA' 9-max Seat #3 is the button
Seat 1: qwr38jl5txoR36M7G5qi4A ($7.75 in chips) 
Seat 2: 7QzbjWT00wQpau1iqvUmMA ($4.65 in chips) 
Seat 3: 56S3mA6Zs3pGR+0p0vUCtg ($30.95 in chips) 
Seat 5: 1K6QGyJP9P9xmRac2fH4OQ ($31.90 in chips) 
Seat 6: +HvCCmsGSQeatf+GZ9zk8Q ($20.25 in chips) 
Seat 7: GTcLfsDTPqgfHyhY9FNDMw ($8 in chips) 
Seat 8: Cni99AOp8W/F0ZWCuHNcIA ($11.40 in chips) 
Seat 9: +sbyWwIcFp9kP0bDtMegfQ ($37.75 in chips) 
1K6QGyJP9P9xmRac2fH4OQ: posts small blind $0.10
+HvCCmsGSQeatf+GZ9zk8Q: posts big blind $0.25
*** HOLE CARDS ***
GTcLfsDTPqgfHyhY9FNDMw: folds 
Cni99AOp8W/F0ZWCuHNcIA: folds 
+sbyWwIcFp9kP0bDtMegfQ: folds 
qwr38jl5txoR36M7G5qi4A: folds 
7QzbjWT00wQpau1iqvUmMA: folds 
56S3mA6Zs3pGR+0p0vUCtg: folds 
1K6QGyJP9P9xmRac2fH4OQ: calls $0.15
+HvCCmsGSQeatf+GZ9zk8Q: checks 
*** FLOP *** [Js Jh 7s]
1K6QGyJP9P9xmRac2fH4OQ: bets $0.35
S2iyN4Q7njjhguIuE5g1CQ has returned
+HvCCmsGSQeatf+GZ9zk8Q: folds 
Uncalled bet ($0.35) returned to 1K6QGyJP9P9xmRac2fH4OQ
1K6QGyJP9P9xmRac2fH4OQ collected $0.50 from pot
1K6QGyJP9P9xmRac2fH4OQ: doesn't show hand 
*** SUMMARY ***
Total pot $0.50 | Rake $0 
Board [Js Jh 7s]
Seat 1: qwr38jl5txoR36M7G5qi4A folded before Flop (didn't bet)
Seat 2: 7QzbjWT00wQpau1iqvUmMA folded before Flop (didn't bet)
Seat 3: 56S3mA6Zs3pGR+0p0vUCtg (button) folded before Flop (didn't bet)
Seat 5: 1K6QGyJP9P9xmRac2fH4OQ (small blind) collected ($0.50)
Seat 6: +HvCCmsGSQeatf+GZ9zk8Q (big blind) folded on the Flop
Seat 7: GTcLfsDTPqgfHyhY9FNDMw folded before Flop (didn't bet)
Seat 8: Cni99AOp8W/F0ZWCuHNcIA folded before Flop (didn't bet)
Seat 9: +sbyWwIcFp9kP0bDtMegfQ folded before Flop (didn't bet)




PokerStars Game #59939543278:  Hold'em No Limit ($0.10/$0.25) - 2009/07/01 0:42:34 ET
Table 'Mef6A0EMopL6WaFO5/KO9g' 6-max Seat #2 is the button
Seat 1: ELW+DKizJhLK7k40PMkD2Q ($25.75 in chips) 
Seat 2: 8ClCHtFXGNplITm+63KB+Q ($32.25 in chips) 
Seat 3: Wq26opBLDGJe91GRJn2epg ($19.55 in chips) 
Seat 5: WrLI51S2iMb8GLMB83gGqA ($36.25 in chips) 
Wq26opBLDGJe91GRJn2epg: posts small blind $0.10
WrLI51S2iMb8GLMB83gGqA: posts big blind $0.25
jp34e617tIzV8tKIWmfAbA: sits out 
*** HOLE CARDS ***
ELW+DKizJhLK7k40PMkD2Q: folds 
8ClCHtFXGNplITm+63KB+Q: raises $0.75 to $1
Wq26opBLDGJe91GRJn2epg: folds 
WrLI51S2iMb8GLMB83gGqA: folds 
Uncalled bet ($0.75) returned to 8ClCHtFXGNplITm+63KB+Q
8ClCHtFXGNplITm+63KB+Q collected $0.60 from pot
8ClCHtFXGNplITm+63KB+Q: doesn't show hand 
*** SUMMARY ***
Total pot $0.60 | Rake $0 
Seat 1: ELW+DKizJhLK7k40PMkD2Q folded before Flop (didn't bet)
Seat 2: 8ClCHtFXGNplITm+63KB+Q (button) collected ($0.60)
Seat 3: Wq26opBLDGJe91GRJn2epg (small blind) folded before Flop
Seat 5: WrLI51S2iMb8GLMB83gGqA (big blind) folded before Flop




PokerStars Game #59939543508:  Hold'em No Limit ($0.10/$0.25) - 2009/07/01 0:42:35 ET
Table 'nteM56rtr9SxLEblf0fvbw' 9-max Seat #1 is the button
Seat 1: H9KUl8cmpLgEpOVDA00bCg ($5 in chips) 
Seat 2: ljemhp25Zg+nlA9DLCIiUw ($25.70 in chips) 
Seat 4: cZ99hugmLBj9KhTlc8nCSw ($25.50 in chips) 
Seat 5: aJy680tKSaP5er559aSuGA ($10.30 in chips) 
Seat 6: LH8Esb23EO9V9GrKx+ymWQ ($4.75 in chips) 
Seat 7: dfNim92Z6XK1/h5SFW5vDg ($49.30 in chips) 
Seat 8: RJ/x9oZtt1RZLaJEQwZOxQ ($44.40 in chips) 
Seat 9: t2nb95S5EEFOEzNx9Itz0g ($6.55 in chips) 
ljemhp25Zg+nlA9DLCIiUw: posts small blind $0.10
cZ99hugmLBj9KhTlc8nCSw: posts big blind $0.25
*** HOLE CARDS ***
aJy680tKSaP5er559aSuGA: folds 
LH8Esb23EO9V9GrKx+ymWQ: folds 
dfNim92Z6XK1/h5SFW5vDg: folds 
RJ/x9oZtt1RZLaJEQwZOxQ: folds 
t2nb95S5EEFOEzNx9Itz0g: folds 
H9KUl8cmpLgEpOVDA00bCg: folds 
ljemhp25Zg+nlA9DLCIiUw: raises $0.50 to $0.75
cZ99hugmLBj9KhTlc8nCSw: folds 
Uncalled bet ($0.50) returned to ljemhp25Zg+nlA9DLCIiUw
ljemhp25Zg+nlA9DLCIiUw collected $0.50 from pot
ljemhp25Zg+nlA9DLCIiUw: doesn't show hand 
*** SUMMARY ***
Total pot $0.50 | Rake $0 
Seat 1: H9KUl8cmpLgEpOVDA00bCg (button) folded before Flop (didn't bet)
Seat 2: ljemhp25Zg+nlA9DLCIiUw (small blind) collected ($0.50)
Seat 4: cZ99hugmLBj9KhTlc8nCSw (big blind) folded before Flop
Seat 5: aJy680tKSaP5er559aSuGA folded before Flop (didn't bet)
Seat 6: LH8Esb23EO9V9GrKx+ymWQ folded before Flop (didn't bet)
Seat 7: dfNim92Z6XK1/h5SFW5vDg folded before Flop (didn't bet)
Seat 8: RJ/x9oZtt1RZLaJEQwZOxQ folded before Flop (didn't bet)
Seat 9: t2nb95S5EEFOEzNx9Itz0g folded before Flop (didn't bet)




PokerStars Game #59939543766:  Hold'em No Limit ($0.10/$0.25) - 2009/07/01 0:42:35 ET
Table 'IrJPyZ3JW2iIa+krdoSbJQ' 9-max Seat #5 is the button
Seat 1: 4+E2msto8r80F3SH2gctVA ($25.10 in chips) 
Seat 2: DdPXdieucQ+n99u1n3A+rQ ($9.30 in chips) 
Seat 3: vZGoOTJLQLhkPj4I+LNGig ($25 in chips) 
Seat 4: DnDcAdn9P0zGovMERigpFA ($25 in chips) 
Seat 5: sUVgUtgbfVx6JpvApozwhQ ($6.10 in chips) 
Seat 6: +sbyWwIcFp9kP0bDtMegfQ ($24.40 in chips) 
Seat 7: uH1RN27w9SKa7TpVR9EFrQ ($22.45 in chips) 
Seat 8: VBHxUExRAMrbxUq/cVx9Gw ($5 in chips) 
Seat 9: SXqVW4Q0evTUVZG6BbUNIA ($29.30 in chips) 
+sbyWwIcFp9kP0bDtMegfQ: posts small blind $0.10
uH1RN27w9SKa7TpVR9EFrQ: posts big blind $0.25
*** HOLE CARDS ***
VBHxUExRAMrbxUq/cVx9Gw: folds 
SXqVW4Q0evTUVZG6BbUNIA: folds 
4+E2msto8r80F3SH2gctVA: folds 
DdPXdieucQ+n99u1n3A+rQ: folds 
vZGoOTJLQLhkPj4I+LNGig: folds 
DnDcAdn9P0zGovMERigpFA: folds 
sUVgUtgbfVx6JpvApozwhQ: folds 
+sbyWwIcFp9kP0bDtMegfQ: folds 
Uncalled bet ($0.15) returned to uH1RN27w9SKa7TpVR9EFrQ
uH1RN27w9SKa7TpVR9EFrQ collected $0.20 from pot
uH1RN27w9SKa7TpVR9EFrQ: doesn't show hand 
*** SUMMARY ***
Total pot $0.20 | Rake $0 
Seat 1: 4+E2msto8r80F3SH2gctVA folded before Flop (didn't bet)
Seat 2: DdPXdieucQ+n99u1n3A+rQ folded before Flop (didn't bet)
Seat 3: vZGoOTJLQLhkPj4I+LNGig folded before Flop (didn't bet)
Seat 4: DnDcAdn9P0zGovMERigpFA folded before Flop (didn't bet)
Seat 5: sUVgUtgbfVx6JpvApozwhQ (button) folded before Flop (didn't bet)
Seat 6: +sbyWwIcFp9kP0bDtMegfQ (small blind) folded before Flop
Seat 7: uH1RN27w9SKa7TpVR9EFrQ (big blind) collected ($0.20)
Seat 8: VBHxUExRAMrbxUq/cVx9Gw folded before Flop (didn't bet)
Seat 9: SXqVW4Q0evTUVZG6BbUNIA folded before Flop (didn't bet)




PokerStars Game #59939543352:  Hold'em No Limit ($0.10/$0.25) - 2009/07/01 0:42:35 ET
Table 'IdXp6nyeW4FYaEK4qKCnwQ' 9-max Seat #9 is the button
Seat 2: HPEB+AtKw1+C/cxU0o1ciw ($28.55 in chips) 
Seat 5: U41wNf6XauAiBOQaKu2ZIA ($13.15 in chips) 
Seat 9: JJH2Xc95hFewheF67vSv4Q ($15.10 in chips) 
HPEB+AtKw1+C/cxU0o1ciw: posts small blind $0.10
U41wNf6XauAiBOQaKu2ZIA: posts big blind $0.25
*** HOLE CARDS ***
JJH2Xc95hFewheF67vSv4Q: calls $0.25
HPEB+AtKw1+C/cxU0o1ciw: folds 
U41wNf6XauAiBOQaKu2ZIA: checks 
*** FLOP *** [Js 6d 2h]
U41wNf6XauAiBOQaKu2ZIA: bets $0.25
JJH2Xc95hFewheF67vSv4Q: calls $0.25
*** TURN *** [Js 6d 2h] [Ah]
IK3/w7XV7rd8mVIsuasjYA joins the table at seat #4 
U41wNf6XauAiBOQaKu2ZIA: bets $0.25
JJH2Xc95hFewheF67vSv4Q: calls $0.25
*** RIVER *** [Js 6d 2h Ah] [Td]
U41wNf6XauAiBOQaKu2ZIA: bets $0.50
JJH2Xc95hFewheF67vSv4Q: calls $0.50
*** SHOW DOWN ***
U41wNf6XauAiBOQaKu2ZIA: shows [8d Jd] (a pair of Jacks)
JJH2Xc95hFewheF67vSv4Q: mucks hand 
U41wNf6XauAiBOQaKu2ZIA collected $2.50 from pot
*** SUMMARY ***
Total pot $2.60 | Rake $0.10 
Board [Js 6d 2h Ah Td]
Seat 2: HPEB+AtKw1+C/cxU0o1ciw (small blind) folded before Flop
Seat 5: U41wNf6XauAiBOQaKu2ZIA (big blind) showed [8d Jd] and won ($2.50) with a pair of Jacks
Seat 9: JJH2Xc95hFewheF67vSv4Q (button) mucked




