PokerStars Game #59941834380:  Hold'em No Limit ($0.10/$0.25) - 2009/07/01 1:47:38 ET
Table '63uh7ZsO7Tnt+E8b/2bu3A' 6-max Seat #5 is the button
Seat 1: 0av6tRNdi0Ui4f15L7gsVg ($30.20 in chips) 
Seat 2: SFmT9ZsVopnukjvAzrxTRg ($30.30 in chips) 
Seat 3: yVP7GLZBzx47OPi6jzUxMw ($2.35 in chips) 
Seat 4: rnpAao581IcvQglpkpnkoQ ($11.25 in chips) 
Seat 5: GbCVUNssQ7mqsPWr7J4d3w ($9.75 in chips) 
Seat 6: qGHGf/553gQnDoklMRe3tg ($29.25 in chips) 
qGHGf/553gQnDoklMRe3tg: posts small blind $0.10
0av6tRNdi0Ui4f15L7gsVg: posts big blind $0.25
*** HOLE CARDS ***
SFmT9ZsVopnukjvAzrxTRg: folds 
yVP7GLZBzx47OPi6jzUxMw: raises $0.50 to $0.75
rnpAao581IcvQglpkpnkoQ: folds 
GbCVUNssQ7mqsPWr7J4d3w: folds 
qGHGf/553gQnDoklMRe3tg: raises $2.25 to $3
0av6tRNdi0Ui4f15L7gsVg: folds 
yVP7GLZBzx47OPi6jzUxMw: calls $1.60 and is all-in
Uncalled bet ($0.65) returned to qGHGf/553gQnDoklMRe3tg
*** FLOP *** [Ks Td 8d]
*** TURN *** [Ks Td 8d] [8c]
*** RIVER *** [Ks Td 8d 8c] [Jd]
*** SHOW DOWN ***
qGHGf/553gQnDoklMRe3tg: shows [Qh Kh] (two pair, Kings and Eights)
yVP7GLZBzx47OPi6jzUxMw: shows [Kc Js] (two pair, Kings and Jacks)
yVP7GLZBzx47OPi6jzUxMw collected $4.75 from pot
*** SUMMARY ***
Total pot $4.95 | Rake $0.20 
Board [Ks Td 8d 8c Jd]
Seat 1: 0av6tRNdi0Ui4f15L7gsVg (big blind) folded before Flop
Seat 2: SFmT9ZsVopnukjvAzrxTRg folded before Flop (didn't bet)
Seat 3: yVP7GLZBzx47OPi6jzUxMw showed [Kc Js] and won ($4.75) with two pair, Kings and Jacks
Seat 4: rnpAao581IcvQglpkpnkoQ folded before Flop (didn't bet)
Seat 5: GbCVUNssQ7mqsPWr7J4d3w (button) folded before Flop (didn't bet)
Seat 6: qGHGf/553gQnDoklMRe3tg (small blind) showed [Qh Kh] and lost with two pair, Kings and Eights




PokerStars Game #59941834726:  Hold'em No Limit ($0.10/$0.25) - 2009/07/01 1:47:38 ET
Table '29D3eoQzK5kOAT0OIDS2uQ' 6-max Seat #5 is the button
Seat 1: kG34n23qFQA3nzdOJTQ1dA ($46.40 in chips) 
Seat 2: FyE+TQ5JcCqI/tCCHf0jGA ($17.45 in chips) 
Seat 3: z3tQwy28dp5FykDJC/wzQw ($17.20 in chips) 
Seat 4: MqMK8OWPSY1V4stf1Hy5Jw ($34.55 in chips) 
Seat 5: Q3EMN7b0ie81AFWkDrhCjw ($21.60 in chips) 
Seat 6: bWbV4MVB/vVpiES1Ut4hew ($32.90 in chips) 
bWbV4MVB/vVpiES1Ut4hew: posts small blind $0.10
kG34n23qFQA3nzdOJTQ1dA: posts big blind $0.25
*** HOLE CARDS ***
FyE+TQ5JcCqI/tCCHf0jGA: folds 
z3tQwy28dp5FykDJC/wzQw: folds 
MqMK8OWPSY1V4stf1Hy5Jw: raises $0.75 to $1
Q3EMN7b0ie81AFWkDrhCjw: folds 
bWbV4MVB/vVpiES1Ut4hew: calls $0.90
kG34n23qFQA3nzdOJTQ1dA: folds 
*** FLOP *** [3c 3s 8s]
bWbV4MVB/vVpiES1Ut4hew: checks 
MqMK8OWPSY1V4stf1Hy5Jw: bets $1.50
bWbV4MVB/vVpiES1Ut4hew: calls $1.50
*** TURN *** [3c 3s 8s] [Qh]
bWbV4MVB/vVpiES1Ut4hew: checks 
MqMK8OWPSY1V4stf1Hy5Jw: bets $3.50
bWbV4MVB/vVpiES1Ut4hew: raises $8.50 to $12
MqMK8OWPSY1V4stf1Hy5Jw: calls $8.50
*** RIVER *** [3c 3s 8s Qh] [7h]
bWbV4MVB/vVpiES1Ut4hew: bets $18.40 and is all-in
MqMK8OWPSY1V4stf1Hy5Jw: calls $18.40
*** SHOW DOWN ***
bWbV4MVB/vVpiES1Ut4hew: shows [As Jh] (a pair of Threes)
MqMK8OWPSY1V4stf1Hy5Jw: shows [Tc Qd] (two pair, Queens and Threes)
MqMK8OWPSY1V4stf1Hy5Jw collected $63.05 from pot
*** SUMMARY ***
Total pot $66.05 | Rake $3 
Board [3c 3s 8s Qh 7h]
Seat 1: kG34n23qFQA3nzdOJTQ1dA (big blind) folded before Flop
Seat 2: FyE+TQ5JcCqI/tCCHf0jGA folded before Flop (didn't bet)
Seat 3: z3tQwy28dp5FykDJC/wzQw folded before Flop (didn't bet)
Seat 4: MqMK8OWPSY1V4stf1Hy5Jw showed [Tc Qd] and won ($63.05) with two pair, Queens and Threes
Seat 5: Q3EMN7b0ie81AFWkDrhCjw (button) folded before Flop (didn't bet)
Seat 6: bWbV4MVB/vVpiES1Ut4hew (small blind) showed [As Jh] and lost with a pair of Threes




PokerStars Game #59941834774:  Hold'em No Limit ($0.10/$0.25) - 2009/07/01 1:47:38 ET
Table 'APEHQjIcZHDZUA4iOjju2g' 6-max Seat #1 is the button
Seat 1: DE9hRlt14g+JdsRQ4wT7hg ($25 in chips) 
Seat 2: 3zD3qLXT1bEffAoWGnc7wg ($35.25 in chips) 
Seat 3: 3e/idKqDuPE10t6Zvr//SQ ($24.05 in chips) 
Seat 4: w2mQ4VsGljGwWXydz8tw2A ($35.85 in chips) 
Seat 5: /xN6gc9+8Hew0HxaB6VIVg ($46 in chips) 
Seat 6: KXtdqb+rIMkjc0RvHDksGQ ($35.25 in chips) 
3zD3qLXT1bEffAoWGnc7wg: posts small blind $0.10
3e/idKqDuPE10t6Zvr//SQ: posts big blind $0.25
*** HOLE CARDS ***
w2mQ4VsGljGwWXydz8tw2A: folds 
/xN6gc9+8Hew0HxaB6VIVg: calls $0.25
KXtdqb+rIMkjc0RvHDksGQ: folds 
DE9hRlt14g+JdsRQ4wT7hg: folds 
3zD3qLXT1bEffAoWGnc7wg: folds 
3e/idKqDuPE10t6Zvr//SQ: checks 
*** FLOP *** [9h 2d 2s]
3e/idKqDuPE10t6Zvr//SQ: checks 
/xN6gc9+8Hew0HxaB6VIVg: bets $0.25
3e/idKqDuPE10t6Zvr//SQ: calls $0.25
*** TURN *** [9h 2d 2s] [5d]
3e/idKqDuPE10t6Zvr//SQ: checks 
/xN6gc9+8Hew0HxaB6VIVg: checks 
*** RIVER *** [9h 2d 2s 5d] [6s]
3e/idKqDuPE10t6Zvr//SQ: bets $0.75
/xN6gc9+8Hew0HxaB6VIVg: folds 
Uncalled bet ($0.75) returned to 3e/idKqDuPE10t6Zvr//SQ
3e/idKqDuPE10t6Zvr//SQ collected $1.05 from pot
*** SUMMARY ***
Total pot $1.10 | Rake $0.05 
Board [9h 2d 2s 5d 6s]
Seat 1: DE9hRlt14g+JdsRQ4wT7hg (button) folded before Flop (didn't bet)
Seat 2: 3zD3qLXT1bEffAoWGnc7wg (small blind) folded before Flop
Seat 3: 3e/idKqDuPE10t6Zvr//SQ (big blind) collected ($1.05)
Seat 4: w2mQ4VsGljGwWXydz8tw2A folded before Flop (didn't bet)
Seat 5: /xN6gc9+8Hew0HxaB6VIVg folded on the River
Seat 6: KXtdqb+rIMkjc0RvHDksGQ folded before Flop (didn't bet)




PokerStars Game #59941835312:  Hold'em No Limit ($0.10/$0.25) - 2009/07/01 1:47:39 ET
Table '/VaaaFnlEJoYVomG9uxHkA' 9-max Seat #3 is the button
Seat 1: Th3FldXKQW6hWVVPahaoOQ ($26.65 in chips) 
Seat 2: DIkeSkosO/tsUp9d2JVyTA ($54.75 in chips) 
Seat 3: MtVtHDqIJTyUcXkRBBDIVA ($26.15 in chips) 
Seat 4: j4q3p0lesp63b1gZDwLBZw ($5 in chips) 
Seat 5: cZ99hugmLBj9KhTlc8nCSw ($25 in chips) 
Seat 7: F7pnn6czNpHvRM55XcA2EA ($31.60 in chips) 
Seat 8: dfNim92Z6XK1/h5SFW5vDg ($45.75 in chips) 
j4q3p0lesp63b1gZDwLBZw: posts small blind $0.10
cZ99hugmLBj9KhTlc8nCSw: posts big blind $0.25
DdPXdieucQ+n99u1n3A+rQ: sits out 
*** HOLE CARDS ***
F7pnn6czNpHvRM55XcA2EA: folds 
dfNim92Z6XK1/h5SFW5vDg: calls $0.25
Th3FldXKQW6hWVVPahaoOQ: folds 
DIkeSkosO/tsUp9d2JVyTA: folds 
MtVtHDqIJTyUcXkRBBDIVA: folds 
j4q3p0lesp63b1gZDwLBZw: calls $0.15
cZ99hugmLBj9KhTlc8nCSw: checks 
*** FLOP *** [Tc 9s Ac]
j4q3p0lesp63b1gZDwLBZw: bets $0.75
cZ99hugmLBj9KhTlc8nCSw: folds 
dfNim92Z6XK1/h5SFW5vDg: raises $1.25 to $2
j4q3p0lesp63b1gZDwLBZw: raises $2.75 to $4.75 and is all-in
dfNim92Z6XK1/h5SFW5vDg: calls $2.75
*** TURN *** [Tc 9s Ac] [Qh]
*** RIVER *** [Tc 9s Ac Qh] [Ah]
*** SHOW DOWN ***
j4q3p0lesp63b1gZDwLBZw: shows [Jc Kc] (a straight, Ten to Ace)
dfNim92Z6XK1/h5SFW5vDg: shows [9c 9h] (a full house, Nines full of Aces)
dfNim92Z6XK1/h5SFW5vDg collected $9.75 from pot
*** SUMMARY ***
Total pot $10.25 | Rake $0.50 
Board [Tc 9s Ac Qh Ah]
Seat 1: Th3FldXKQW6hWVVPahaoOQ folded before Flop (didn't bet)
Seat 2: DIkeSkosO/tsUp9d2JVyTA folded before Flop (didn't bet)
Seat 3: MtVtHDqIJTyUcXkRBBDIVA (button) folded before Flop (didn't bet)
Seat 4: j4q3p0lesp63b1gZDwLBZw (small blind) showed [Jc Kc] and lost with a straight, Ten to Ace
Seat 5: cZ99hugmLBj9KhTlc8nCSw (big blind) folded on the Flop
Seat 7: F7pnn6czNpHvRM55XcA2EA folded before Flop (didn't bet)
Seat 8: dfNim92Z6XK1/h5SFW5vDg showed [9c 9h] and won ($9.75) with a full house, Nines full of Aces




PokerStars Game #59941834986:  Hold'em No Limit ($0.10/$0.25) - 2009/07/01 1:47:39 ET
Table 'xro+BVoe2Zuw1TYmz/McJQ' 9-max Seat #2 is the button
Seat 2: vSkQm2EelzwRGDDQQk0Fqw ($8.85 in chips) 
Seat 4: N2LVj3iImgnOoHVf8g0rIw ($41.60 in chips) 
Seat 6: HPEB+AtKw1+C/cxU0o1ciw ($26.50 in chips) 
Seat 7: QEbIGci+itdw+re8RM5fZA ($30.80 in chips) 
Seat 8: ljemhp25Zg+nlA9DLCIiUw ($22.65 in chips) 
N2LVj3iImgnOoHVf8g0rIw: posts small blind $0.10
HPEB+AtKw1+C/cxU0o1ciw: posts big blind $0.25
*** HOLE CARDS ***
QEbIGci+itdw+re8RM5fZA: folds 
QEbIGci+itdw+re8RM5fZA leaves the table
ljemhp25Zg+nlA9DLCIiUw: raises $0.50 to $0.75
vSkQm2EelzwRGDDQQk0Fqw: folds 
N2LVj3iImgnOoHVf8g0rIw: calls $0.65
HPEB+AtKw1+C/cxU0o1ciw: folds 
*** FLOP *** [6s 9c 3h]
xUw+6BIJCkgxBKESwlj9Hg joins the table at seat #3 
H7ijH+qgNcEQW9eBvivIYg joins the table at seat #5 
N2LVj3iImgnOoHVf8g0rIw: checks 
ljemhp25Zg+nlA9DLCIiUw: bets $1.25
N2LVj3iImgnOoHVf8g0rIw: folds 
Uncalled bet ($1.25) returned to ljemhp25Zg+nlA9DLCIiUw
ljemhp25Zg+nlA9DLCIiUw collected $1.70 from pot
ljemhp25Zg+nlA9DLCIiUw: doesn't show hand 
*** SUMMARY ***
Total pot $1.75 | Rake $0.05 
Board [6s 9c 3h]
Seat 2: vSkQm2EelzwRGDDQQk0Fqw (button) folded before Flop (didn't bet)
Seat 4: N2LVj3iImgnOoHVf8g0rIw (small blind) folded on the Flop
Seat 6: HPEB+AtKw1+C/cxU0o1ciw (big blind) folded before Flop
Seat 7: QEbIGci+itdw+re8RM5fZA folded before Flop (didn't bet)
Seat 8: ljemhp25Zg+nlA9DLCIiUw collected ($1.70)




PokerStars Game #59941835128:  Hold'em No Limit ($0.10/$0.25) - 2009/07/01 1:47:39 ET
Table 'M7d9IrgQUUFFy/SZ3ksLYg' 6-max Seat #1 is the button
Seat 1: ypmjhffk/YHGc51wgVXUTw ($50.15 in chips) 
Seat 3: epAUIB7h2FJXzUPRIvSkRA ($25.10 in chips) 
Seat 4: 8ClCHtFXGNplITm+63KB+Q ($23.20 in chips) 
Seat 5: kMa8BltUcBQVxnHfqdCfXg ($8.25 in chips) 
8CPg15X6IHYR1pWm9ha1Sw will be allowed to play after the button
epAUIB7h2FJXzUPRIvSkRA: posts small blind $0.10
8ClCHtFXGNplITm+63KB+Q: posts big blind $0.25
*** HOLE CARDS ***
kMa8BltUcBQVxnHfqdCfXg: calls $0.25
ypmjhffk/YHGc51wgVXUTw: raises $0.75 to $1
epAUIB7h2FJXzUPRIvSkRA: folds 
8ClCHtFXGNplITm+63KB+Q: folds 
kMa8BltUcBQVxnHfqdCfXg: folds 
Uncalled bet ($0.75) returned to ypmjhffk/YHGc51wgVXUTw
ypmjhffk/YHGc51wgVXUTw collected $0.85 from pot
ypmjhffk/YHGc51wgVXUTw: doesn't show hand 
*** SUMMARY ***
Total pot $0.85 | Rake $0 
Seat 1: ypmjhffk/YHGc51wgVXUTw (button) collected ($0.85)
Seat 3: epAUIB7h2FJXzUPRIvSkRA (small blind) folded before Flop
Seat 4: 8ClCHtFXGNplITm+63KB+Q (big blind) folded before Flop
Seat 5: kMa8BltUcBQVxnHfqdCfXg folded before Flop




PokerStars Game #59941834900:  Hold'em No Limit ($0.10/$0.25) - 2009/07/01 1:47:39 ET
Table 'P2yJ+jwfNsBdF12fLKA6DQ' 9-max Seat #1 is the button
Seat 1: zDrucyjVn5aeekNEc3cJrA ($21.25 in chips) 
Seat 2: uQwmfH5LEVA5eyghJdyPUg ($15.15 in chips) 
Seat 3: 8EbrQ/EvFWt2cr0GaU82gQ ($5 in chips) 
Seat 4: 6NLAWFPZZfqlVkY8n9RULA ($14 in chips) 
Seat 5: B7VAFAMs/PYlYABlV+EkSA ($7.80 in chips) 
Seat 6: mUoFJKqCzIUABvOFbiINlQ ($14.25 in chips) 
Seat 7: yQc5nLaNmByxI15Jegu61w ($18.15 in chips) 
Seat 8: LMd3gq2uNfbWTfXTnSeQRw ($9.30 in chips) 
Seat 9: dN5zq7QdZCUe7NZFM6cECg ($19.15 in chips) 
uQwmfH5LEVA5eyghJdyPUg: posts small blind $0.10
8EbrQ/EvFWt2cr0GaU82gQ: posts big blind $0.25
*** HOLE CARDS ***
6NLAWFPZZfqlVkY8n9RULA: calls $0.25
B7VAFAMs/PYlYABlV+EkSA: folds 
mUoFJKqCzIUABvOFbiINlQ: folds 
yQc5nLaNmByxI15Jegu61w: calls $0.25
LMd3gq2uNfbWTfXTnSeQRw: calls $0.25
dN5zq7QdZCUe7NZFM6cECg: folds 
zDrucyjVn5aeekNEc3cJrA: calls $0.25
uQwmfH5LEVA5eyghJdyPUg: calls $0.15
8EbrQ/EvFWt2cr0GaU82gQ: checks 
*** FLOP *** [7s Kc Qh]
uQwmfH5LEVA5eyghJdyPUg: checks 
8EbrQ/EvFWt2cr0GaU82gQ: checks 
6NLAWFPZZfqlVkY8n9RULA: checks 
yQc5nLaNmByxI15Jegu61w: checks 
LMd3gq2uNfbWTfXTnSeQRw: checks 
zDrucyjVn5aeekNEc3cJrA: bets $2
uQwmfH5LEVA5eyghJdyPUg: folds 
8EbrQ/EvFWt2cr0GaU82gQ: folds 
6NLAWFPZZfqlVkY8n9RULA: folds 
yQc5nLaNmByxI15Jegu61w: folds 
LMd3gq2uNfbWTfXTnSeQRw: folds 
Uncalled bet ($2) returned to zDrucyjVn5aeekNEc3cJrA
zDrucyjVn5aeekNEc3cJrA collected $1.45 from pot
*** SUMMARY ***
Total pot $1.50 | Rake $0.05 
Board [7s Kc Qh]
Seat 1: zDrucyjVn5aeekNEc3cJrA (button) collected ($1.45)
Seat 2: uQwmfH5LEVA5eyghJdyPUg (small blind) folded on the Flop
Seat 3: 8EbrQ/EvFWt2cr0GaU82gQ (big blind) folded on the Flop
Seat 4: 6NLAWFPZZfqlVkY8n9RULA folded on the Flop
Seat 5: B7VAFAMs/PYlYABlV+EkSA folded before Flop (didn't bet)
Seat 6: mUoFJKqCzIUABvOFbiINlQ folded before Flop (didn't bet)
Seat 7: yQc5nLaNmByxI15Jegu61w folded on the Flop
Seat 8: LMd3gq2uNfbWTfXTnSeQRw folded on the Flop
Seat 9: dN5zq7QdZCUe7NZFM6cECg folded before Flop (didn't bet)




PokerStars Game #59941835420:  Hold'em No Limit ($0.10/$0.25) - 2009/07/01 1:47:40 ET
Table 'by7aHYEDnDd144EXOXa/jA' 9-max Seat #4 is the button
Seat 1: j4q3p0lesp63b1gZDwLBZw ($7.65 in chips) 
Seat 2: vSkQm2EelzwRGDDQQk0Fqw ($8.90 in chips) 
Seat 3: HOEaXncFu2ij+D5/CANAZA ($11.35 in chips) 
Seat 4: 2Xwi447v1rBHM+92U0CduA ($4.40 in chips) 
Seat 5: yyG4svzOpC1A+sUP/scg6w ($3.95 in chips) 
Seat 6: sC4BsflLWW26Qm9m+1AwJQ ($11.15 in chips) 
Seat 8: 7je+LC5Mfs6nL8YBVh4frQ ($3.50 in chips) 
Seat 9: K0b5wNInj6hUGRr6yzKFtw ($25.05 in chips) 
yyG4svzOpC1A+sUP/scg6w: posts small blind $0.10
sC4BsflLWW26Qm9m+1AwJQ: posts big blind $0.25
Z9W7+g1WMhhZDi7DwGbCFA: sits out 
*** HOLE CARDS ***
7je+LC5Mfs6nL8YBVh4frQ: folds 
K0b5wNInj6hUGRr6yzKFtw: folds 
j4q3p0lesp63b1gZDwLBZw: folds 
vSkQm2EelzwRGDDQQk0Fqw: folds 
HOEaXncFu2ij+D5/CANAZA: calls $0.25
2Xwi447v1rBHM+92U0CduA: folds 
yyG4svzOpC1A+sUP/scg6w: folds 
sC4BsflLWW26Qm9m+1AwJQ: checks 
*** FLOP *** [4h Tc 9c]
sC4BsflLWW26Qm9m+1AwJQ: checks 
HOEaXncFu2ij+D5/CANAZA: checks 
*** TURN *** [4h Tc 9c] [3h]
sC4BsflLWW26Qm9m+1AwJQ: checks 
HOEaXncFu2ij+D5/CANAZA: checks 
*** RIVER *** [4h Tc 9c 3h] [2d]
sC4BsflLWW26Qm9m+1AwJQ: checks 
HOEaXncFu2ij+D5/CANAZA: bets $0.25
sC4BsflLWW26Qm9m+1AwJQ: calls $0.25
*** SHOW DOWN ***
HOEaXncFu2ij+D5/CANAZA: shows [Th Qh] (a pair of Tens)
sC4BsflLWW26Qm9m+1AwJQ: mucks hand 
HOEaXncFu2ij+D5/CANAZA collected $1.05 from pot
*** SUMMARY ***
Total pot $1.10 | Rake $0.05 
Board [4h Tc 9c 3h 2d]
Seat 1: j4q3p0lesp63b1gZDwLBZw folded before Flop (didn't bet)
Seat 2: vSkQm2EelzwRGDDQQk0Fqw folded before Flop (didn't bet)
Seat 3: HOEaXncFu2ij+D5/CANAZA showed [Th Qh] and won ($1.05) with a pair of Tens
Seat 4: 2Xwi447v1rBHM+92U0CduA (button) folded before Flop (didn't bet)
Seat 5: yyG4svzOpC1A+sUP/scg6w (small blind) folded before Flop
Seat 6: sC4BsflLWW26Qm9m+1AwJQ (big blind) mucked
Seat 8: 7je+LC5Mfs6nL8YBVh4frQ folded before Flop (didn't bet)
Seat 9: K0b5wNInj6hUGRr6yzKFtw folded before Flop (didn't bet)




PokerStars Game #59941835618:  Hold'em No Limit ($0.10/$0.25) - 2009/07/01 1:47:40 ET
Table 'nc6OeGk/wtaWV+6N+kgnZQ' 6-max Seat #2 is the button
Seat 2: 8ClCHtFXGNplITm+63KB+Q ($37.95 in chips) 
Seat 3: y8wpMWGSX2zHZijurx21mg ($4.10 in chips) 
Seat 4: 3zD3qLXT1bEffAoWGnc7wg ($31.90 in chips) 
Seat 5: HCS0lMAAPmZE2Tl8J/SuKw ($9.85 in chips) 
Seat 6: mFv3iBCtrw9XfCDRB0d46Q ($3.80 in chips) 
y8wpMWGSX2zHZijurx21mg: posts small blind $0.10
3zD3qLXT1bEffAoWGnc7wg: posts big blind $0.25
*** HOLE CARDS ***
HCS0lMAAPmZE2Tl8J/SuKw: folds 
mFv3iBCtrw9XfCDRB0d46Q: raises $3.55 to $3.80 and is all-in
8ClCHtFXGNplITm+63KB+Q: folds 
y8wpMWGSX2zHZijurx21mg: folds 
3zD3qLXT1bEffAoWGnc7wg: folds 
Uncalled bet ($3.55) returned to mFv3iBCtrw9XfCDRB0d46Q
mFv3iBCtrw9XfCDRB0d46Q collected $0.60 from pot
mFv3iBCtrw9XfCDRB0d46Q: doesn't show hand 
*** SUMMARY ***
Total pot $0.60 | Rake $0 
Seat 2: 8ClCHtFXGNplITm+63KB+Q (button) folded before Flop (didn't bet)
Seat 3: y8wpMWGSX2zHZijurx21mg (small blind) folded before Flop
Seat 4: 3zD3qLXT1bEffAoWGnc7wg (big blind) folded before Flop
Seat 5: HCS0lMAAPmZE2Tl8J/SuKw folded before Flop (didn't bet)
Seat 6: mFv3iBCtrw9XfCDRB0d46Q collected ($0.60)




PokerStars Game #59941835720:  Hold'em No Limit ($0.10/$0.25) - 2009/07/01 1:47:40 ET
Table 'isKy4XK8wJM0x735/D4hWA' 6-max Seat #6 is the button
Seat 1: kwsRmpZ1ZaLooISs+zfyKg ($24.15 in chips) 
Seat 2: 6elpmfyt4Zw0yvd8lePSMQ ($39.25 in chips) 
Seat 3: jp34e617tIzV8tKIWmfAbA ($26.05 in chips) 
Seat 4: DFi/Lzkjsfv8QswS80JX9Q ($31.45 in chips) 
Seat 5: lquriepNQBhDV5P1SWHhnA ($25.60 in chips) 
Seat 6: GbCVUNssQ7mqsPWr7J4d3w ($5 in chips) 
kwsRmpZ1ZaLooISs+zfyKg: posts small blind $0.10
6elpmfyt4Zw0yvd8lePSMQ: posts big blind $0.25
*** HOLE CARDS ***
jp34e617tIzV8tKIWmfAbA: folds 
DFi/Lzkjsfv8QswS80JX9Q: folds 
lquriepNQBhDV5P1SWHhnA: folds 
GbCVUNssQ7mqsPWr7J4d3w: folds 
kwsRmpZ1ZaLooISs+zfyKg: raises $0.50 to $0.75
6elpmfyt4Zw0yvd8lePSMQ: folds 
Uncalled bet ($0.50) returned to kwsRmpZ1ZaLooISs+zfyKg
kwsRmpZ1ZaLooISs+zfyKg collected $0.50 from pot
*** SUMMARY ***
Total pot $0.50 | Rake $0 
Seat 1: kwsRmpZ1ZaLooISs+zfyKg (small blind) collected ($0.50)
Seat 2: 6elpmfyt4Zw0yvd8lePSMQ (big blind) folded before Flop
Seat 3: jp34e617tIzV8tKIWmfAbA folded before Flop (didn't bet)
Seat 4: DFi/Lzkjsfv8QswS80JX9Q folded before Flop (didn't bet)
Seat 5: lquriepNQBhDV5P1SWHhnA folded before Flop (didn't bet)
Seat 6: GbCVUNssQ7mqsPWr7J4d3w (button) folded before Flop (didn't bet)




PokerStars Game #59941836084:  Hold'em No Limit ($0.10/$0.25) - 2009/07/01 1:47:41 ET
Table '2AUmC2Rslg+QUbLfdgNdfg' 6-max Seat #2 is the button
Seat 1: YDXAegrCnzc0l6TSDNboXQ ($23.75 in chips) 
Seat 2: PLksyNlTVRVZwxJVC2/1eA ($9.75 in chips) 
Seat 3: JFIAqU8lCZ0vWwEl4bdGsg ($25.45 in chips) 
Seat 4: lquriepNQBhDV5P1SWHhnA ($26.25 in chips) 
Seat 5: AMc4cCwUJhokdGRYIaVPhQ ($36.65 in chips) 
Seat 6: xBWc54v+UTSJOiKpbAbJWg ($10.80 in chips) 
JFIAqU8lCZ0vWwEl4bdGsg: posts small blind $0.10
lquriepNQBhDV5P1SWHhnA: posts big blind $0.25
*** HOLE CARDS ***
AMc4cCwUJhokdGRYIaVPhQ: folds 
xBWc54v+UTSJOiKpbAbJWg: folds 
YDXAegrCnzc0l6TSDNboXQ: calls $0.25
PLksyNlTVRVZwxJVC2/1eA: folds 
JFIAqU8lCZ0vWwEl4bdGsg: calls $0.15
lquriepNQBhDV5P1SWHhnA: checks 
*** FLOP *** [Kh 9s 4h]
JFIAqU8lCZ0vWwEl4bdGsg: checks 
lquriepNQBhDV5P1SWHhnA: checks 
YDXAegrCnzc0l6TSDNboXQ: checks 
*** TURN *** [Kh 9s 4h] [8h]
JFIAqU8lCZ0vWwEl4bdGsg: checks 
lquriepNQBhDV5P1SWHhnA: checks 
YDXAegrCnzc0l6TSDNboXQ: bets $0.25
JFIAqU8lCZ0vWwEl4bdGsg: calls $0.25
lquriepNQBhDV5P1SWHhnA: folds 
*** RIVER *** [Kh 9s 4h 8h] [Kc]
JFIAqU8lCZ0vWwEl4bdGsg: checks 
YDXAegrCnzc0l6TSDNboXQ: checks 
*** SHOW DOWN ***
JFIAqU8lCZ0vWwEl4bdGsg: shows [9c 7d] (two pair, Kings and Nines)
YDXAegrCnzc0l6TSDNboXQ: mucks hand 
JFIAqU8lCZ0vWwEl4bdGsg collected $1.20 from pot
*** SUMMARY ***
Total pot $1.25 | Rake $0.05 
Board [Kh 9s 4h 8h Kc]
Seat 1: YDXAegrCnzc0l6TSDNboXQ mucked
Seat 2: PLksyNlTVRVZwxJVC2/1eA (button) folded before Flop (didn't bet)
Seat 3: JFIAqU8lCZ0vWwEl4bdGsg (small blind) showed [9c 7d] and won ($1.20) with two pair, Kings and Nines
Seat 4: lquriepNQBhDV5P1SWHhnA (big blind) folded on the Turn
Seat 5: AMc4cCwUJhokdGRYIaVPhQ folded before Flop (didn't bet)
Seat 6: xBWc54v+UTSJOiKpbAbJWg folded before Flop (didn't bet)




PokerStars Game #59941835936:  Hold'em No Limit ($0.10/$0.25) - 2009/07/01 1:47:41 ET
Table '+198VWQSWBhYQOcizzuBkw' 6-max Seat #3 is the button
Seat 1: 34ttqW62uIRrqINCCmLcsw ($19.65 in chips) 
Seat 2: iauW7L/+7qzAuHow7CD75Q ($10.35 in chips) 
Seat 3: vw7gefupgmOJJN8lUemdWg ($18.05 in chips) 
Seat 4: TgDsTeCdLQt8kWbL00ByRA ($15 in chips) 
Seat 5: LtASJ9OlkqGrrUKGQlpGAw ($25.35 in chips) 
Seat 6: leEQ84f6wJYu5SB/vj27wg ($3.80 in chips) 
TgDsTeCdLQt8kWbL00ByRA: posts small blind $0.10
LtASJ9OlkqGrrUKGQlpGAw: posts big blind $0.25
*** HOLE CARDS ***
leEQ84f6wJYu5SB/vj27wg: folds 
34ttqW62uIRrqINCCmLcsw: calls $0.25
iauW7L/+7qzAuHow7CD75Q: folds 
vw7gefupgmOJJN8lUemdWg: folds 
TgDsTeCdLQt8kWbL00ByRA: folds 
LtASJ9OlkqGrrUKGQlpGAw: checks 
*** FLOP *** [9s Qs Ah]
LtASJ9OlkqGrrUKGQlpGAw: checks 
34ttqW62uIRrqINCCmLcsw: checks 
*** TURN *** [9s Qs Ah] [4c]
LtASJ9OlkqGrrUKGQlpGAw: checks 
34ttqW62uIRrqINCCmLcsw: checks 
*** RIVER *** [9s Qs Ah 4c] [As]
LtASJ9OlkqGrrUKGQlpGAw: checks 
34ttqW62uIRrqINCCmLcsw: checks 
*** SHOW DOWN ***
LtASJ9OlkqGrrUKGQlpGAw: shows [8s 7d] (a pair of Aces)
34ttqW62uIRrqINCCmLcsw: shows [5h 5c] (two pair, Aces and Fives)
34ttqW62uIRrqINCCmLcsw collected $0.60 from pot
*** SUMMARY ***
Total pot $0.60 | Rake $0 
Board [9s Qs Ah 4c As]
Seat 1: 34ttqW62uIRrqINCCmLcsw showed [5h 5c] and won ($0.60) with two pair, Aces and Fives
Seat 2: iauW7L/+7qzAuHow7CD75Q folded before Flop (didn't bet)
Seat 3: vw7gefupgmOJJN8lUemdWg (button) folded before Flop (didn't bet)
Seat 4: TgDsTeCdLQt8kWbL00ByRA (small blind) folded before Flop
Seat 5: LtASJ9OlkqGrrUKGQlpGAw (big blind) showed [8s 7d] and lost with a pair of Aces
Seat 6: leEQ84f6wJYu5SB/vj27wg folded before Flop (didn't bet)




PokerStars Game #59941836268:  Hold'em No Limit ($0.10/$0.25) - 2009/07/01 1:47:41 ET
Table '+2VxGVfkEqJ1AYfQy/JH2w' 6-max Seat #5 is the button
Seat 1: if4dh6jhJXeN3/qd3qCp9g ($28.25 in chips) 
Seat 2: qllppsCmUqovlriIWCeM/g ($5.15 in chips) 
Seat 3: epAUIB7h2FJXzUPRIvSkRA ($25 in chips) 
Seat 4: y+a/yGW/Jy4bPJFnaeTz5w ($16.60 in chips) 
Seat 5: XD1i5m5PvBDnRzJaG/vINw ($24.65 in chips) 
Seat 6: YQNVDzvw3TmGaFiq9MhRgA ($5.10 in chips) 
YQNVDzvw3TmGaFiq9MhRgA: posts small blind $0.10
if4dh6jhJXeN3/qd3qCp9g: posts big blind $0.25
*** HOLE CARDS ***
qllppsCmUqovlriIWCeM/g: folds 
epAUIB7h2FJXzUPRIvSkRA: folds 
y+a/yGW/Jy4bPJFnaeTz5w: folds 
XD1i5m5PvBDnRzJaG/vINw: raises $0.50 to $0.75
YQNVDzvw3TmGaFiq9MhRgA: raises $4.35 to $5.10 and is all-in
if4dh6jhJXeN3/qd3qCp9g: folds 
XD1i5m5PvBDnRzJaG/vINw: folds 
Uncalled bet ($4.35) returned to YQNVDzvw3TmGaFiq9MhRgA
YQNVDzvw3TmGaFiq9MhRgA collected $1.75 from pot
YQNVDzvw3TmGaFiq9MhRgA: shows [7s 7h] (a pair of Sevens)
*** SUMMARY ***
Total pot $1.75 | Rake $0 
Seat 1: if4dh6jhJXeN3/qd3qCp9g (big blind) folded before Flop
Seat 2: qllppsCmUqovlriIWCeM/g folded before Flop (didn't bet)
Seat 3: epAUIB7h2FJXzUPRIvSkRA folded before Flop (didn't bet)
Seat 4: y+a/yGW/Jy4bPJFnaeTz5w folded before Flop (didn't bet)
Seat 5: XD1i5m5PvBDnRzJaG/vINw (button) folded before Flop
Seat 6: YQNVDzvw3TmGaFiq9MhRgA (small blind) collected ($1.75)




PokerStars Game #59941835972:  Hold'em No Limit ($0.10/$0.25) - 2009/07/01 1:47:41 ET
Table 'vFZR6Kf2Th5xBXT9brGW6A' 6-max Seat #5 is the button
Seat 1: Q1uciOZPBR/WkAlqa6cL4A ($25 in chips) 
Seat 2: QiL+lEgEWwy21jk/ltaRLg ($21.30 in chips) 
Seat 3: SH1WjKVUjPiyXySjWSdazw ($40.85 in chips) 
Seat 4: 79ID/ub1Pt/mDpCprVmOoA ($34.85 in chips) 
Seat 5: SS/yfeArhULzIcOPe8MdPg ($27 in chips) 
Seat 6: 4x9jCqgSw4272dnaIqnanw ($10.65 in chips) 
4x9jCqgSw4272dnaIqnanw: posts small blind $0.10
Q1uciOZPBR/WkAlqa6cL4A: posts big blind $0.25
*** HOLE CARDS ***
QiL+lEgEWwy21jk/ltaRLg: folds 
SH1WjKVUjPiyXySjWSdazw: folds 
79ID/ub1Pt/mDpCprVmOoA: folds 
SS/yfeArhULzIcOPe8MdPg: raises $0.75 to $1
4x9jCqgSw4272dnaIqnanw: folds 
Q1uciOZPBR/WkAlqa6cL4A: folds 
Uncalled bet ($0.75) returned to SS/yfeArhULzIcOPe8MdPg
SS/yfeArhULzIcOPe8MdPg collected $0.60 from pot
*** SUMMARY ***
Total pot $0.60 | Rake $0 
Seat 1: Q1uciOZPBR/WkAlqa6cL4A (big blind) folded before Flop
Seat 2: QiL+lEgEWwy21jk/ltaRLg folded before Flop (didn't bet)
Seat 3: SH1WjKVUjPiyXySjWSdazw folded before Flop (didn't bet)
Seat 4: 79ID/ub1Pt/mDpCprVmOoA folded before Flop (didn't bet)
Seat 5: SS/yfeArhULzIcOPe8MdPg (button) collected ($0.60)
Seat 6: 4x9jCqgSw4272dnaIqnanw (small blind) folded before Flop




PokerStars Game #59941835940:  Hold'em No Limit ($0.10/$0.25) - 2009/07/01 1:47:41 ET
Table 'xkqAWQFDrFt4p81M8UsoNw' 9-max Seat #8 is the button
Seat 1: tLcDklc2rBORNfixyRfVfw ($28.25 in chips) 
Seat 3: xHZZRLAaFUIC8WWI8ljOJA ($24 in chips) 
Seat 4: wGigCmBR/9XWkPpvYos3aQ ($25.10 in chips) 
Seat 6: 6RiVTYll/5D8zICp0MRpKw ($22.75 in chips) 
Seat 7: MG90wfSJZnOejs/KD3vlQQ ($43.50 in chips) 
Seat 8: MaqsqnOOkbNuPf4oWvOtnA ($43.25 in chips) 
Seat 9: Z9AeOQX3yzuSvKAm/xyovg ($9.40 in chips) 
Z9AeOQX3yzuSvKAm/xyovg: posts small blind $0.10
tLcDklc2rBORNfixyRfVfw: posts big blind $0.25
H5Se03ZqSX7tbULXur2MAg: sits out 
*** HOLE CARDS ***
xHZZRLAaFUIC8WWI8ljOJA: folds 
wGigCmBR/9XWkPpvYos3aQ: folds 
6RiVTYll/5D8zICp0MRpKw: folds 
MG90wfSJZnOejs/KD3vlQQ: folds 
MaqsqnOOkbNuPf4oWvOtnA: folds 
Z9AeOQX3yzuSvKAm/xyovg: folds 
Uncalled bet ($0.15) returned to tLcDklc2rBORNfixyRfVfw
tLcDklc2rBORNfixyRfVfw collected $0.20 from pot
tLcDklc2rBORNfixyRfVfw: doesn't show hand 
*** SUMMARY ***
Total pot $0.20 | Rake $0 
Seat 1: tLcDklc2rBORNfixyRfVfw (big blind) collected ($0.20)
Seat 3: xHZZRLAaFUIC8WWI8ljOJA folded before Flop (didn't bet)
Seat 4: wGigCmBR/9XWkPpvYos3aQ folded before Flop (didn't bet)
Seat 6: 6RiVTYll/5D8zICp0MRpKw folded before Flop (didn't bet)
Seat 7: MG90wfSJZnOejs/KD3vlQQ folded before Flop (didn't bet)
Seat 8: MaqsqnOOkbNuPf4oWvOtnA (button) folded before Flop (didn't bet)
Seat 9: Z9AeOQX3yzuSvKAm/xyovg (small blind) folded before Flop




PokerStars Game #59941836100:  Hold'em No Limit ($0.10/$0.25) - 2009/07/01 1:47:41 ET
Table 'ggwTHpIC5qhhHJSYjK1XCw' 6-max Seat #1 is the button
Seat 1: MqMK8OWPSY1V4stf1Hy5Jw ($80.15 in chips) 
Seat 2: /gJNBeCkWL4o85/jvlZ4BA ($26.30 in chips) 
Seat 3: 7cx44/slbeTw+Cy7QB8Trg ($25 in chips) 
Seat 4: JFIAqU8lCZ0vWwEl4bdGsg ($25 in chips) 
Seat 5: BvqhBa7W/To51LhEiIU/lw ($6.05 in chips) 
/gJNBeCkWL4o85/jvlZ4BA: posts small blind $0.10
7cx44/slbeTw+Cy7QB8Trg: posts big blind $0.25
*** HOLE CARDS ***
JFIAqU8lCZ0vWwEl4bdGsg: folds 
BvqhBa7W/To51LhEiIU/lw: folds 
MqMK8OWPSY1V4stf1Hy5Jw: raises $0.50 to $0.75
/gJNBeCkWL4o85/jvlZ4BA: folds 
7cx44/slbeTw+Cy7QB8Trg: folds 
Uncalled bet ($0.50) returned to MqMK8OWPSY1V4stf1Hy5Jw
MqMK8OWPSY1V4stf1Hy5Jw collected $0.60 from pot
MqMK8OWPSY1V4stf1Hy5Jw: doesn't show hand 
*** SUMMARY ***
Total pot $0.60 | Rake $0 
Seat 1: MqMK8OWPSY1V4stf1Hy5Jw (button) collected ($0.60)
Seat 2: /gJNBeCkWL4o85/jvlZ4BA (small blind) folded before Flop
Seat 3: 7cx44/slbeTw+Cy7QB8Trg (big blind) folded before Flop
Seat 4: JFIAqU8lCZ0vWwEl4bdGsg folded before Flop (didn't bet)
Seat 5: BvqhBa7W/To51LhEiIU/lw folded before Flop (didn't bet)




PokerStars Game #59941835870:  Hold'em No Limit ($0.10/$0.25) - 2009/07/01 1:47:41 ET
Table 'JUMeG5SzDyo9HufhgemQeA' 9-max Seat #1 is the button
Seat 1: oLa/tXLfSLLB28mcLGrxcg ($24.05 in chips) 
Seat 2: Jve2LRs9vtGL7NdiNeXY/A ($15.25 in chips) 
Seat 3: IEvLSTIxhlti3EjZDarYnA ($31.50 in chips) 
Seat 4: 9+Um1wMtYNWnmPLUEU4viQ ($17.65 in chips) 
Seat 5: Ne5zBB6oEKrbigKRh6d6Xg ($11.30 in chips) 
Seat 6: wFCwdYKUXoQHhz8qeZuuAw ($25.65 in chips) 
Seat 7: aNpwfA31EREwO+ar4XzBCw ($32.15 in chips) 
Seat 8: zDrucyjVn5aeekNEc3cJrA ($37.35 in chips) 
Seat 9: V6p0jQ/RhUsqpHLmXvEX4Q ($13.45 in chips) 
Jve2LRs9vtGL7NdiNeXY/A: posts small blind $0.10
IEvLSTIxhlti3EjZDarYnA: posts big blind $0.25
*** HOLE CARDS ***
9+Um1wMtYNWnmPLUEU4viQ: raises $0.75 to $1
Ne5zBB6oEKrbigKRh6d6Xg: folds 
wFCwdYKUXoQHhz8qeZuuAw: folds 
aNpwfA31EREwO+ar4XzBCw: folds 
zDrucyjVn5aeekNEc3cJrA: folds 
V6p0jQ/RhUsqpHLmXvEX4Q: folds 
oLa/tXLfSLLB28mcLGrxcg: folds 
Jve2LRs9vtGL7NdiNeXY/A: folds 
IEvLSTIxhlti3EjZDarYnA: folds 
Uncalled bet ($0.75) returned to 9+Um1wMtYNWnmPLUEU4viQ
9+Um1wMtYNWnmPLUEU4viQ collected $0.60 from pot
9+Um1wMtYNWnmPLUEU4viQ: doesn't show hand 
*** SUMMARY ***
Total pot $0.60 | Rake $0 
Seat 1: oLa/tXLfSLLB28mcLGrxcg (button) folded before Flop (didn't bet)
Seat 2: Jve2LRs9vtGL7NdiNeXY/A (small blind) folded before Flop
Seat 3: IEvLSTIxhlti3EjZDarYnA (big blind) folded before Flop
Seat 4: 9+Um1wMtYNWnmPLUEU4viQ collected ($0.60)
Seat 5: Ne5zBB6oEKrbigKRh6d6Xg folded before Flop (didn't bet)
Seat 6: wFCwdYKUXoQHhz8qeZuuAw folded before Flop (didn't bet)
Seat 7: aNpwfA31EREwO+ar4XzBCw folded before Flop (didn't bet)
Seat 8: zDrucyjVn5aeekNEc3cJrA folded before Flop (didn't bet)
Seat 9: V6p0jQ/RhUsqpHLmXvEX4Q folded before Flop (didn't bet)




PokerStars Game #59941836260:  Hold'em No Limit ($0.10/$0.25) - 2009/07/01 1:47:41 ET
Table 'sSe6q4YTb/iS19t2eCFdsA' 9-max Seat #7 is the button
Seat 1: hJ4uYjNmSZdjrKA8cjZqCA ($18.75 in chips) 
Seat 2: 3l+i+xMeyDndSXMF2A5CDA ($6.25 in chips) 
Seat 3: OXPkK84/qv92EMwXPiG5rQ ($9.75 in chips) 
Seat 4: 22dIObOuor/A+IKWkNoAlA ($9.10 in chips) 
Seat 5: qS+jfnNoG75bT+uQ8CKhQA ($9.70 in chips) 
Seat 6: tYsOBqdU1+x+yFI7zHO7hQ ($27 in chips) 
Seat 7: t70KGeRtR3naHSqKDixsUg ($4.20 in chips) 
Seat 8: hvXZ0zFPZFP8Hf6dS36YEw ($15.75 in chips) 
Seat 9: Z9W7+g1WMhhZDi7DwGbCFA ($5 in chips) 
hvXZ0zFPZFP8Hf6dS36YEw: posts small blind $0.10
Z9W7+g1WMhhZDi7DwGbCFA: posts big blind $0.25
*** HOLE CARDS ***
hJ4uYjNmSZdjrKA8cjZqCA: folds 
3l+i+xMeyDndSXMF2A5CDA: folds 
OXPkK84/qv92EMwXPiG5rQ: folds 
22dIObOuor/A+IKWkNoAlA: folds 
qS+jfnNoG75bT+uQ8CKhQA: folds 
tYsOBqdU1+x+yFI7zHO7hQ: folds 
t70KGeRtR3naHSqKDixsUg: calls $0.25
hvXZ0zFPZFP8Hf6dS36YEw: calls $0.15
Z9W7+g1WMhhZDi7DwGbCFA: raises $1.75 to $2
t70KGeRtR3naHSqKDixsUg: folds 
hvXZ0zFPZFP8Hf6dS36YEw: folds 
Uncalled bet ($1.75) returned to Z9W7+g1WMhhZDi7DwGbCFA
Z9W7+g1WMhhZDi7DwGbCFA collected $0.75 from pot
Z9W7+g1WMhhZDi7DwGbCFA: doesn't show hand 
*** SUMMARY ***
Total pot $0.75 | Rake $0 
Seat 1: hJ4uYjNmSZdjrKA8cjZqCA folded before Flop (didn't bet)
Seat 2: 3l+i+xMeyDndSXMF2A5CDA folded before Flop (didn't bet)
Seat 3: OXPkK84/qv92EMwXPiG5rQ folded before Flop (didn't bet)
Seat 4: 22dIObOuor/A+IKWkNoAlA folded before Flop (didn't bet)
Seat 5: qS+jfnNoG75bT+uQ8CKhQA folded before Flop (didn't bet)
Seat 6: tYsOBqdU1+x+yFI7zHO7hQ folded before Flop (didn't bet)
Seat 7: t70KGeRtR3naHSqKDixsUg (button) folded before Flop
Seat 8: hvXZ0zFPZFP8Hf6dS36YEw (small blind) folded before Flop
Seat 9: Z9W7+g1WMhhZDi7DwGbCFA (big blind) collected ($0.75)




PokerStars Game #59941836518:  Hold'em No Limit ($0.10/$0.25) - 2009/07/01 1:47:42 ET
Table 'l8hUTjBTXBorNUR/tyvSLw' 9-max Seat #8 is the button
Seat 1: cZ99hugmLBj9KhTlc8nCSw ($28.20 in chips) 
Seat 2: B6xHiX1SJkS0CUNCKDVwuQ ($21.50 in chips) 
Seat 3: ShCS62CJp4MKfKLKvGKQbA ($9.10 in chips) 
Seat 4: vPtFvcPtn/Afz0sucO1cmQ ($36.70 in chips) 
Seat 5: yyG4svzOpC1A+sUP/scg6w ($6.50 in chips) 
Seat 6: EVqHvqty1ZsuvDFiSXlSqQ ($23.95 in chips) 
Seat 7: F7pnn6czNpHvRM55XcA2EA ($33.90 in chips) 
Seat 8: Mh2r9hTeTEDnh19sRZtW3g ($4.65 in chips) 
Seat 9: zDrucyjVn5aeekNEc3cJrA ($32.45 in chips) 
zDrucyjVn5aeekNEc3cJrA: posts small blind $0.10
cZ99hugmLBj9KhTlc8nCSw: posts big blind $0.25
*** HOLE CARDS ***
B6xHiX1SJkS0CUNCKDVwuQ: folds 
ShCS62CJp4MKfKLKvGKQbA: folds 
vPtFvcPtn/Afz0sucO1cmQ: folds 
yyG4svzOpC1A+sUP/scg6w: calls $0.25
EVqHvqty1ZsuvDFiSXlSqQ: folds 
F7pnn6czNpHvRM55XcA2EA: folds 
Mh2r9hTeTEDnh19sRZtW3g: folds 
zDrucyjVn5aeekNEc3cJrA: calls $0.15
cZ99hugmLBj9KhTlc8nCSw: checks 
*** FLOP *** [4d 9s 4h]
zDrucyjVn5aeekNEc3cJrA: checks 
cZ99hugmLBj9KhTlc8nCSw: checks 
yyG4svzOpC1A+sUP/scg6w: checks 
*** TURN *** [4d 9s 4h] [Qs]
zDrucyjVn5aeekNEc3cJrA: checks 
cZ99hugmLBj9KhTlc8nCSw: checks 
yyG4svzOpC1A+sUP/scg6w: checks 
*** RIVER *** [4d 9s 4h Qs] [6c]
zDrucyjVn5aeekNEc3cJrA: checks 
cZ99hugmLBj9KhTlc8nCSw: checks 
yyG4svzOpC1A+sUP/scg6w: checks 
*** SHOW DOWN ***
zDrucyjVn5aeekNEc3cJrA: shows [Qh 2c] (two pair, Queens and Fours)
cZ99hugmLBj9KhTlc8nCSw: mucks hand 
yyG4svzOpC1A+sUP/scg6w: mucks hand 
zDrucyjVn5aeekNEc3cJrA collected $0.75 from pot
*** SUMMARY ***
Total pot $0.75 | Rake $0 
Board [4d 9s 4h Qs 6c]
Seat 1: cZ99hugmLBj9KhTlc8nCSw (big blind) mucked
Seat 2: B6xHiX1SJkS0CUNCKDVwuQ folded before Flop (didn't bet)
Seat 3: ShCS62CJp4MKfKLKvGKQbA folded before Flop (didn't bet)
Seat 4: vPtFvcPtn/Afz0sucO1cmQ folded before Flop (didn't bet)
Seat 5: yyG4svzOpC1A+sUP/scg6w mucked
Seat 6: EVqHvqty1ZsuvDFiSXlSqQ folded before Flop (didn't bet)
Seat 7: F7pnn6czNpHvRM55XcA2EA folded before Flop (didn't bet)
Seat 8: Mh2r9hTeTEDnh19sRZtW3g (button) folded before Flop (didn't bet)
Seat 9: zDrucyjVn5aeekNEc3cJrA (small blind) showed [Qh 2c] and won ($0.75) with two pair, Queens and Fours




PokerStars Game #59941836660:  Hold'em No Limit ($0.10/$0.25) - 2009/07/01 1:47:42 ET
Table 'KKk6y4pAXeymxYcd0uZLqg' 9-max Seat #5 is the button
Seat 1: HPEB+AtKw1+C/cxU0o1ciw ($24.90 in chips) 
Seat 3: tLcDklc2rBORNfixyRfVfw ($25 in chips) 
Seat 4: YciNm3fUXAQaJeXG1rhrbw ($8.20 in chips) 
Seat 5: wGigCmBR/9XWkPpvYos3aQ ($38.85 in chips) 
Seat 6: QEbIGci+itdw+re8RM5fZA ($25 in chips) 
Seat 7: JjOuv8Vf56aiQjWi/rTPFA ($23.25 in chips) 
Seat 8: +2kMBNpY4nF1qNCRd8SJLA ($36.05 in chips) 
Seat 9: oLa/tXLfSLLB28mcLGrxcg ($25.45 in chips) 
QEbIGci+itdw+re8RM5fZA: posts small blind $0.10
JjOuv8Vf56aiQjWi/rTPFA: posts big blind $0.25
*** HOLE CARDS ***
+2kMBNpY4nF1qNCRd8SJLA: folds 
oLa/tXLfSLLB28mcLGrxcg: folds 
HPEB+AtKw1+C/cxU0o1ciw: folds 
tLcDklc2rBORNfixyRfVfw: calls $0.25
YciNm3fUXAQaJeXG1rhrbw: folds 
wGigCmBR/9XWkPpvYos3aQ: raises $1 to $1.25
QEbIGci+itdw+re8RM5fZA: folds 
JjOuv8Vf56aiQjWi/rTPFA: folds 
tLcDklc2rBORNfixyRfVfw: calls $1
*** FLOP *** [Tc 7s Qd]
tLcDklc2rBORNfixyRfVfw: checks 
wGigCmBR/9XWkPpvYos3aQ: bets $2
tLcDklc2rBORNfixyRfVfw: folds 
Uncalled bet ($2) returned to wGigCmBR/9XWkPpvYos3aQ
wGigCmBR/9XWkPpvYos3aQ collected $2.75 from pot
wGigCmBR/9XWkPpvYos3aQ: doesn't show hand 
*** SUMMARY ***
Total pot $2.85 | Rake $0.10 
Board [Tc 7s Qd]
Seat 1: HPEB+AtKw1+C/cxU0o1ciw folded before Flop (didn't bet)
Seat 3: tLcDklc2rBORNfixyRfVfw folded on the Flop
Seat 4: YciNm3fUXAQaJeXG1rhrbw folded before Flop (didn't bet)
Seat 5: wGigCmBR/9XWkPpvYos3aQ (button) collected ($2.75)
Seat 6: QEbIGci+itdw+re8RM5fZA (small blind) folded before Flop
Seat 7: JjOuv8Vf56aiQjWi/rTPFA (big blind) folded before Flop
Seat 8: +2kMBNpY4nF1qNCRd8SJLA folded before Flop (didn't bet)
Seat 9: oLa/tXLfSLLB28mcLGrxcg folded before Flop (didn't bet)




PokerStars Game #59941836594:  Hold'em No Limit ($0.10/$0.25) - 2009/07/01 1:47:42 ET
Table 'o0CDOvKO/bn1WjeymDrXfA' 6-max Seat #6 is the button
Seat 1: if4dh6jhJXeN3/qd3qCp9g ($28.15 in chips) 
Seat 2: uAJL+E2git8iAiFyAvVOnw ($5.85 in chips) 
Seat 3: OtVWmpxX2/9L8bb1GSKTuA ($21.90 in chips) 
Seat 5: dOIoLBxmpLHSXBN9LZnf0Q ($32.50 in chips) 
Seat 6: SS/yfeArhULzIcOPe8MdPg ($25 in chips) 
if4dh6jhJXeN3/qd3qCp9g: posts small blind $0.10
uAJL+E2git8iAiFyAvVOnw: posts big blind $0.25
i9LqF5rD3bvtbEE7HWgr3Q is connected 
i9LqF5rD3bvtbEE7HWgr3Q: sits out 
*** HOLE CARDS ***
OtVWmpxX2/9L8bb1GSKTuA: folds 
dOIoLBxmpLHSXBN9LZnf0Q: folds 
SS/yfeArhULzIcOPe8MdPg: raises $0.75 to $1
if4dh6jhJXeN3/qd3qCp9g: folds 
uAJL+E2git8iAiFyAvVOnw: folds 
Uncalled bet ($0.75) returned to SS/yfeArhULzIcOPe8MdPg
SS/yfeArhULzIcOPe8MdPg collected $0.60 from pot
SS/yfeArhULzIcOPe8MdPg: doesn't show hand 
*** SUMMARY ***
Total pot $0.60 | Rake $0 
Seat 1: if4dh6jhJXeN3/qd3qCp9g (small blind) folded before Flop
Seat 2: uAJL+E2git8iAiFyAvVOnw (big blind) folded before Flop
Seat 3: OtVWmpxX2/9L8bb1GSKTuA folded before Flop (didn't bet)
Seat 5: dOIoLBxmpLHSXBN9LZnf0Q folded before Flop (didn't bet)
Seat 6: SS/yfeArhULzIcOPe8MdPg (button) collected ($0.60)




PokerStars Game #59941836424:  Hold'em No Limit ($0.10/$0.25) - 2009/07/01 1:47:42 ET
Table 'edvgY2YQ1I34euq4EVqGnA' 6-max Seat #6 is the button
Seat 1: mvFHK3pE7tCxJEqLjKC70Q ($25.10 in chips) 
Seat 2: Hsvkc0/G2VV78oVmWYXecw ($5 in chips) 
Seat 3: mFv3iBCtrw9XfCDRB0d46Q ($3.55 in chips) 
Seat 4: TI/C5Q+DEl4fLR3AofwYdg ($23.40 in chips) 
Seat 5: EE16Ua5b1HSsYej5zeXOlA ($56.75 in chips) 
Seat 6: kG34n23qFQA3nzdOJTQ1dA ($71 in chips) 
mvFHK3pE7tCxJEqLjKC70Q: posts small blind $0.10
Hsvkc0/G2VV78oVmWYXecw: posts big blind $0.25
*** HOLE CARDS ***
mFv3iBCtrw9XfCDRB0d46Q: folds 
TI/C5Q+DEl4fLR3AofwYdg: folds 
EE16Ua5b1HSsYej5zeXOlA: raises $0.50 to $0.75
kG34n23qFQA3nzdOJTQ1dA: folds 
mvFHK3pE7tCxJEqLjKC70Q: calls $0.65
Hsvkc0/G2VV78oVmWYXecw: raises $4.25 to $5 and is all-in
EE16Ua5b1HSsYej5zeXOlA: folds 
mvFHK3pE7tCxJEqLjKC70Q: calls $4.25
*** FLOP *** [Ac 6c Jc]
*** TURN *** [Ac 6c Jc] [Kh]
*** RIVER *** [Ac 6c Jc Kh] [Tc]
*** SHOW DOWN ***
mvFHK3pE7tCxJEqLjKC70Q: shows [Jd Qs] (a straight, Ten to Ace)
Hsvkc0/G2VV78oVmWYXecw: mucks hand 
mvFHK3pE7tCxJEqLjKC70Q collected $10.25 from pot
*** SUMMARY ***
Total pot $10.75 | Rake $0.50 
Board [Ac 6c Jc Kh Tc]
Seat 1: mvFHK3pE7tCxJEqLjKC70Q (small blind) showed [Jd Qs] and won ($10.25) with a straight, Ten to Ace
Seat 2: Hsvkc0/G2VV78oVmWYXecw (big blind) mucked
Seat 3: mFv3iBCtrw9XfCDRB0d46Q folded before Flop (didn't bet)
Seat 4: TI/C5Q+DEl4fLR3AofwYdg folded before Flop (didn't bet)
Seat 5: EE16Ua5b1HSsYej5zeXOlA folded before Flop
Seat 6: kG34n23qFQA3nzdOJTQ1dA (button) folded before Flop (didn't bet)




PokerStars Game #59941836654:  Hold'em No Limit ($0.10/$0.25) - 2009/07/01 1:47:42 ET
Table 'aaXqTKUnxrX9DYXtxhWXxA' 6-max Seat #5 is the button
Seat 1: aSrj4lVmn2owyQ1RbbOqxQ ($27.15 in chips) 
Seat 2: DE9hRlt14g+JdsRQ4wT7hg ($33.35 in chips) 
Seat 3: uUXdcVMNa05rfbntdvplfw ($7.90 in chips) 
Seat 4: 48oT5xFI+5CHUJlfoGrE4w ($8.80 in chips) 
Seat 5: kyRaCIljYA6l33lSKQfNsg ($24.60 in chips) 
Seat 6: buyjetgNT1McXtdaP4zynA ($50.50 in chips) 
buyjetgNT1McXtdaP4zynA: posts small blind $0.10
aSrj4lVmn2owyQ1RbbOqxQ: posts big blind $0.25
*** HOLE CARDS ***
DE9hRlt14g+JdsRQ4wT7hg: folds 
uUXdcVMNa05rfbntdvplfw: folds 
48oT5xFI+5CHUJlfoGrE4w: folds 
kyRaCIljYA6l33lSKQfNsg: raises $0.50 to $0.75
buyjetgNT1McXtdaP4zynA: raises $1.50 to $2.25
aSrj4lVmn2owyQ1RbbOqxQ: folds 
kyRaCIljYA6l33lSKQfNsg: folds 
Uncalled bet ($1.50) returned to buyjetgNT1McXtdaP4zynA
buyjetgNT1McXtdaP4zynA collected $1.75 from pot
*** SUMMARY ***
Total pot $1.75 | Rake $0 
Seat 1: aSrj4lVmn2owyQ1RbbOqxQ (big blind) folded before Flop
Seat 2: DE9hRlt14g+JdsRQ4wT7hg folded before Flop (didn't bet)
Seat 3: uUXdcVMNa05rfbntdvplfw folded before Flop (didn't bet)
Seat 4: 48oT5xFI+5CHUJlfoGrE4w folded before Flop (didn't bet)
Seat 5: kyRaCIljYA6l33lSKQfNsg (button) folded before Flop
Seat 6: buyjetgNT1McXtdaP4zynA (small blind) collected ($1.75)




PokerStars Game #59941836398:  Hold'em No Limit ($0.10/$0.25) - 2009/07/01 1:47:42 ET
Table 'VQNfcI8vTBCTvRfd3veTLQ' 6-max Seat #6 is the button
Seat 1: QiL+lEgEWwy21jk/ltaRLg ($13.60 in chips) 
Seat 2: 79ID/ub1Pt/mDpCprVmOoA ($31.60 in chips) 
Seat 3: LtASJ9OlkqGrrUKGQlpGAw ($11.25 in chips) 
Seat 4: QIWnfLSqfMcoFfdDe5LZPg ($38.15 in chips) 
Seat 5: gX2vbKwS/8zZPENAWB7hxQ ($27.65 in chips) 
Seat 6: LJI7A1YgDM7hgh7o56+ReQ ($27.35 in chips) 
QiL+lEgEWwy21jk/ltaRLg: posts small blind $0.10
79ID/ub1Pt/mDpCprVmOoA: posts big blind $0.25
*** HOLE CARDS ***
LtASJ9OlkqGrrUKGQlpGAw: raises $0.50 to $0.75
QIWnfLSqfMcoFfdDe5LZPg: folds 
gX2vbKwS/8zZPENAWB7hxQ: folds 
LJI7A1YgDM7hgh7o56+ReQ: folds 
QiL+lEgEWwy21jk/ltaRLg: folds 
79ID/ub1Pt/mDpCprVmOoA: folds 
Uncalled bet ($0.50) returned to LtASJ9OlkqGrrUKGQlpGAw
LtASJ9OlkqGrrUKGQlpGAw collected $0.60 from pot
LtASJ9OlkqGrrUKGQlpGAw: doesn't show hand 
*** SUMMARY ***
Total pot $0.60 | Rake $0 
Seat 1: QiL+lEgEWwy21jk/ltaRLg (small blind) folded before Flop
Seat 2: 79ID/ub1Pt/mDpCprVmOoA (big blind) folded before Flop
Seat 3: LtASJ9OlkqGrrUKGQlpGAw collected ($0.60)
Seat 4: QIWnfLSqfMcoFfdDe5LZPg folded before Flop (didn't bet)
Seat 5: gX2vbKwS/8zZPENAWB7hxQ folded before Flop (didn't bet)
Seat 6: LJI7A1YgDM7hgh7o56+ReQ (button) folded before Flop (didn't bet)




PokerStars Game #59941836558:  Hold'em No Limit ($0.10/$0.25) - 2009/07/01 1:47:42 ET
Table 'Xi38lWH8L2JHRAsKYVX8Qg' 6-max Seat #1 is the button
Seat 1: shP7DFAtX7gXcgMJX/OmRQ ($22.55 in chips) 
Seat 2: VOmI0x4dDPnTESZd5B4d1Q ($8.85 in chips) 
Seat 3: 6DwBRH+xZ12AAZmeAg+aXw ($31.45 in chips) 
Seat 4: kG34n23qFQA3nzdOJTQ1dA ($24.50 in chips) 
Seat 5: 79ID/ub1Pt/mDpCprVmOoA ($77.60 in chips) 
Seat 6: kyRaCIljYA6l33lSKQfNsg ($29.75 in chips) 
VOmI0x4dDPnTESZd5B4d1Q: posts small blind $0.10
6DwBRH+xZ12AAZmeAg+aXw: posts big blind $0.25
*** HOLE CARDS ***
kG34n23qFQA3nzdOJTQ1dA: folds 
79ID/ub1Pt/mDpCprVmOoA: folds 
kyRaCIljYA6l33lSKQfNsg: raises $0.50 to $0.75
shP7DFAtX7gXcgMJX/OmRQ: folds 
VOmI0x4dDPnTESZd5B4d1Q has timed out
VOmI0x4dDPnTESZd5B4d1Q: folds 
VOmI0x4dDPnTESZd5B4d1Q is sitting out
6DwBRH+xZ12AAZmeAg+aXw: folds 
Uncalled bet ($0.50) returned to kyRaCIljYA6l33lSKQfNsg
kyRaCIljYA6l33lSKQfNsg collected $0.60 from pot
*** SUMMARY ***
Total pot $0.60 | Rake $0 
Seat 1: shP7DFAtX7gXcgMJX/OmRQ (button) folded before Flop (didn't bet)
Seat 2: VOmI0x4dDPnTESZd5B4d1Q (small blind) folded before Flop
Seat 3: 6DwBRH+xZ12AAZmeAg+aXw (big blind) folded before Flop
Seat 4: kG34n23qFQA3nzdOJTQ1dA folded before Flop (didn't bet)
Seat 5: 79ID/ub1Pt/mDpCprVmOoA folded before Flop (didn't bet)
Seat 6: kyRaCIljYA6l33lSKQfNsg collected ($0.60)




PokerStars Game #59941836576:  Hold'em No Limit ($0.10/$0.25) - 2009/07/01 1:47:42 ET
Table '3LMlz3V4AziGlU+ikmyU8w' 6-max Seat #5 is the button
Seat 1: Wxq4Qyj0DnDXj2+taEOJFQ ($55.50 in chips) 
Seat 2: uR3AbFJLoOX86DOTtTgGcg ($22.90 in chips) 
Seat 3: Hzy03WtPHMYwLYM7hTTxQw ($25 in chips) 
Seat 4: 6DwBRH+xZ12AAZmeAg+aXw ($23.30 in chips) 
Seat 5: tOAk1Og4mVObMBOfvdDYOw ($25.50 in chips) 
Seat 6: 7LpHJVeM6k1mQdC6HXYzww ($25 in chips) 
7LpHJVeM6k1mQdC6HXYzww: posts small blind $0.10
Wxq4Qyj0DnDXj2+taEOJFQ: posts big blind $0.25
*** HOLE CARDS ***
uR3AbFJLoOX86DOTtTgGcg: folds 
Hzy03WtPHMYwLYM7hTTxQw: raises $0.50 to $0.75
6DwBRH+xZ12AAZmeAg+aXw: folds 
tOAk1Og4mVObMBOfvdDYOw: folds 
7LpHJVeM6k1mQdC6HXYzww: raises $2.10 to $2.85
Wxq4Qyj0DnDXj2+taEOJFQ: folds 
Hzy03WtPHMYwLYM7hTTxQw: calls $2.10
*** FLOP *** [3c 5c Qh]
7LpHJVeM6k1mQdC6HXYzww: bets $4
Hzy03WtPHMYwLYM7hTTxQw: raises $6.75 to $10.75
7LpHJVeM6k1mQdC6HXYzww: folds 
Uncalled bet ($6.75) returned to Hzy03WtPHMYwLYM7hTTxQw
Hzy03WtPHMYwLYM7hTTxQw collected $13.30 from pot
Hzy03WtPHMYwLYM7hTTxQw: doesn't show hand 
*** SUMMARY ***
Total pot $13.95 | Rake $0.65 
Board [3c 5c Qh]
Seat 1: Wxq4Qyj0DnDXj2+taEOJFQ (big blind) folded before Flop
Seat 2: uR3AbFJLoOX86DOTtTgGcg folded before Flop (didn't bet)
Seat 3: Hzy03WtPHMYwLYM7hTTxQw collected ($13.30)
Seat 4: 6DwBRH+xZ12AAZmeAg+aXw folded before Flop (didn't bet)
Seat 5: tOAk1Og4mVObMBOfvdDYOw (button) folded before Flop (didn't bet)
Seat 6: 7LpHJVeM6k1mQdC6HXYzww (small blind) folded on the Flop




PokerStars Game #59941836962:  Hold'em No Limit ($0.10/$0.25) - 2009/07/01 1:47:43 ET
Table 'RPdw09/gGCIP4xFhDWJgXQ' 9-max Seat #1 is the button
Seat 1: aNpwfA31EREwO+ar4XzBCw ($27.50 in chips) 
Seat 2: Sd1tfhUq/M96GhXGv1hwFQ ($8.35 in chips) 
Seat 3: g5LAv1J/3Thw1zs/SEyfzw ($18 in chips) 
Seat 5: gehe91e0IyVT0QU/XBkEyg ($31.60 in chips) 
Seat 6: monZeAwXUmIA1l84cUd2hw ($14.50 in chips) 
Seat 7: EP17SQz/iWcuYdNOGeBgkw ($13.65 in chips) 
Seat 8: MG90wfSJZnOejs/KD3vlQQ ($29.80 in chips) 
Seat 9: O02ScVDnDZwH6KjZNJZMzA ($4.40 in chips) 
Sd1tfhUq/M96GhXGv1hwFQ: posts small blind $0.10
g5LAv1J/3Thw1zs/SEyfzw: posts big blind $0.25
*** HOLE CARDS ***
gehe91e0IyVT0QU/XBkEyg: folds 
monZeAwXUmIA1l84cUd2hw: folds 
EP17SQz/iWcuYdNOGeBgkw: calls $0.25
MG90wfSJZnOejs/KD3vlQQ: folds 
O02ScVDnDZwH6KjZNJZMzA: folds 
aNpwfA31EREwO+ar4XzBCw: folds 
Sd1tfhUq/M96GhXGv1hwFQ: calls $0.15
g5LAv1J/3Thw1zs/SEyfzw: checks 
*** FLOP *** [2d Ac 5c]
Sd1tfhUq/M96GhXGv1hwFQ: checks 
g5LAv1J/3Thw1zs/SEyfzw: checks 
EP17SQz/iWcuYdNOGeBgkw: checks 
*** TURN *** [2d Ac 5c] [Kh]
Sd1tfhUq/M96GhXGv1hwFQ: checks 
g5LAv1J/3Thw1zs/SEyfzw: checks 
EP17SQz/iWcuYdNOGeBgkw: checks 
*** RIVER *** [2d Ac 5c Kh] [6h]
Sd1tfhUq/M96GhXGv1hwFQ: checks 
g5LAv1J/3Thw1zs/SEyfzw: bets $0.50
EP17SQz/iWcuYdNOGeBgkw: folds 
Sd1tfhUq/M96GhXGv1hwFQ: folds 
Uncalled bet ($0.50) returned to g5LAv1J/3Thw1zs/SEyfzw
g5LAv1J/3Thw1zs/SEyfzw collected $0.75 from pot
g5LAv1J/3Thw1zs/SEyfzw: doesn't show hand 
*** SUMMARY ***
Total pot $0.75 | Rake $0 
Board [2d Ac 5c Kh 6h]
Seat 1: aNpwfA31EREwO+ar4XzBCw (button) folded before Flop (didn't bet)
Seat 2: Sd1tfhUq/M96GhXGv1hwFQ (small blind) folded on the River
Seat 3: g5LAv1J/3Thw1zs/SEyfzw (big blind) collected ($0.75)
Seat 5: gehe91e0IyVT0QU/XBkEyg folded before Flop (didn't bet)
Seat 6: monZeAwXUmIA1l84cUd2hw folded before Flop (didn't bet)
Seat 7: EP17SQz/iWcuYdNOGeBgkw folded on the River
Seat 8: MG90wfSJZnOejs/KD3vlQQ folded before Flop (didn't bet)
Seat 9: O02ScVDnDZwH6KjZNJZMzA folded before Flop (didn't bet)




PokerStars Game #59941837248:  Hold'em No Limit ($0.10/$0.25) - 2009/07/01 1:47:43 ET
Table 'C47I7CmrmFr8Oo7wOovVwQ' 6-max Seat #4 is the button
Seat 1: v6mkGzCBCCXcgWQNSYVtKg ($11.80 in chips) 
Seat 3: H+8eOP3XJHXjACRDTiIHTQ ($21.75 in chips) 
Seat 4: yY5JuFtDfXWRaZlVby4LLw ($7.90 in chips) 
Seat 5: or309yYY9Y9bfFWtrB0yUg ($8.10 in chips) 
Seat 6: pD7ri5wL3vsa6S1ulMYQmQ ($24.50 in chips) 
or309yYY9Y9bfFWtrB0yUg: posts small blind $0.10
pD7ri5wL3vsa6S1ulMYQmQ: posts big blind $0.25
8JTm/CXBn3+kuQgcUOgPkw: sits out 
*** HOLE CARDS ***
v6mkGzCBCCXcgWQNSYVtKg: folds 
H+8eOP3XJHXjACRDTiIHTQ: folds 
yY5JuFtDfXWRaZlVby4LLw: calls $0.25
or309yYY9Y9bfFWtrB0yUg: calls $0.15
pD7ri5wL3vsa6S1ulMYQmQ: checks 
*** FLOP *** [2s 2c Ts]
or309yYY9Y9bfFWtrB0yUg: checks 
pD7ri5wL3vsa6S1ulMYQmQ: checks 
yY5JuFtDfXWRaZlVby4LLw: checks 
*** TURN *** [2s 2c Ts] [Tc]
or309yYY9Y9bfFWtrB0yUg: checks 
pD7ri5wL3vsa6S1ulMYQmQ: bets $0.75
yY5JuFtDfXWRaZlVby4LLw: calls $0.75
or309yYY9Y9bfFWtrB0yUg: folds 
*** RIVER *** [2s 2c Ts Tc] [7c]
pD7ri5wL3vsa6S1ulMYQmQ: bets $1.25
yY5JuFtDfXWRaZlVby4LLw: calls $1.25
*** SHOW DOWN ***
pD7ri5wL3vsa6S1ulMYQmQ: shows [8d 2d] (a full house, Deuces full of Tens)
yY5JuFtDfXWRaZlVby4LLw: mucks hand 
pD7ri5wL3vsa6S1ulMYQmQ collected $4.55 from pot
*** SUMMARY ***
Total pot $4.75 | Rake $0.20 
Board [2s 2c Ts Tc 7c]
Seat 1: v6mkGzCBCCXcgWQNSYVtKg folded before Flop (didn't bet)
Seat 3: H+8eOP3XJHXjACRDTiIHTQ folded before Flop (didn't bet)
Seat 4: yY5JuFtDfXWRaZlVby4LLw (button) mucked
Seat 5: or309yYY9Y9bfFWtrB0yUg (small blind) folded on the Turn
Seat 6: pD7ri5wL3vsa6S1ulMYQmQ (big blind) showed [8d 2d] and won ($4.55) with a full house, Deuces full of Tens




PokerStars Game #59941837454:  Hold'em No Limit ($0.10/$0.25) - 2009/07/01 1:47:44 ET
Table '+VTTYgQLH1awDHk+IAxqGg' 9-max Seat #4 is the button
Seat 1: arxNSjreDRGFg13EAM2F1w ($26.90 in chips) 
Seat 2: 2wcFsZsqEP5w1StUTVzJCg ($5.85 in chips) 
Seat 3: AiXn/9o1EwOPZUHujnh/bA ($11.65 in chips) 
Seat 4: gE5rN2TDY1aXcZn/TOPeZw ($9.90 in chips) 
Seat 5: sD+TKtt36XiiN6jqHiLwDA ($24.90 in chips) 
Seat 7: ljemhp25Zg+nlA9DLCIiUw ($24.25 in chips) 
Seat 8: 10vzP4r6ldwGLbYHKd9www ($18.85 in chips) 
Seat 9: S7Ki0P+0AIGPuIfGJjW0gg ($61 in chips) 
sD+TKtt36XiiN6jqHiLwDA: posts small blind $0.10
ljemhp25Zg+nlA9DLCIiUw: posts big blind $0.25
*** HOLE CARDS ***
10vzP4r6ldwGLbYHKd9www: raises $0.25 to $0.50
S7Ki0P+0AIGPuIfGJjW0gg: folds 
arxNSjreDRGFg13EAM2F1w: folds 
2wcFsZsqEP5w1StUTVzJCg: folds 
AiXn/9o1EwOPZUHujnh/bA: folds 
gE5rN2TDY1aXcZn/TOPeZw: calls $0.50
sD+TKtt36XiiN6jqHiLwDA: folds 
ljemhp25Zg+nlA9DLCIiUw: folds 
*** FLOP *** [7s 9c 9d]
10vzP4r6ldwGLbYHKd9www: bets $0.50
gE5rN2TDY1aXcZn/TOPeZw: folds 
Uncalled bet ($0.50) returned to 10vzP4r6ldwGLbYHKd9www
10vzP4r6ldwGLbYHKd9www collected $1.30 from pot
*** SUMMARY ***
Total pot $1.35 | Rake $0.05 
Board [7s 9c 9d]
Seat 1: arxNSjreDRGFg13EAM2F1w folded before Flop (didn't bet)
Seat 2: 2wcFsZsqEP5w1StUTVzJCg folded before Flop (didn't bet)
Seat 3: AiXn/9o1EwOPZUHujnh/bA folded before Flop (didn't bet)
Seat 4: gE5rN2TDY1aXcZn/TOPeZw (button) folded on the Flop
Seat 5: sD+TKtt36XiiN6jqHiLwDA (small blind) folded before Flop
Seat 7: ljemhp25Zg+nlA9DLCIiUw (big blind) folded before Flop
Seat 8: 10vzP4r6ldwGLbYHKd9www collected ($1.30)
Seat 9: S7Ki0P+0AIGPuIfGJjW0gg folded before Flop (didn't bet)




PokerStars Game #59941837874:  Hold'em No Limit ($0.10/$0.25) - 2009/07/01 1:47:44 ET
Table '2O5CgfSkSwrr4PDrlZ1RLQ' 6-max Seat #5 is the button
Seat 1: 3skmHD9EOATKdUzzyHh1KA ($29.80 in chips) 
Seat 2: wqphQtauX5Qn7WRJZS1flA ($26.50 in chips) 
Seat 3: oBUDUfeUyCbZBsjxHZgSiw ($21.25 in chips) 
Seat 4: epAUIB7h2FJXzUPRIvSkRA ($25 in chips) 
Seat 5: 0av6tRNdi0Ui4f15L7gsVg ($23.90 in chips) 
Seat 6: tj9xqoqQaDaFw7u1oyZrtA ($56.50 in chips) 
tj9xqoqQaDaFw7u1oyZrtA: posts small blind $0.10
3skmHD9EOATKdUzzyHh1KA: posts big blind $0.25
*** HOLE CARDS ***
wqphQtauX5Qn7WRJZS1flA: folds 
oBUDUfeUyCbZBsjxHZgSiw: raises $0.75 to $1
epAUIB7h2FJXzUPRIvSkRA: folds 
0av6tRNdi0Ui4f15L7gsVg: folds 
tj9xqoqQaDaFw7u1oyZrtA: folds 
3skmHD9EOATKdUzzyHh1KA: calls $0.75
*** FLOP *** [6h 8d Js]
3skmHD9EOATKdUzzyHh1KA: checks 
oBUDUfeUyCbZBsjxHZgSiw: bets $1
3skmHD9EOATKdUzzyHh1KA: calls $1
*** TURN *** [6h 8d Js] [2s]
3skmHD9EOATKdUzzyHh1KA: bets $2.25
oBUDUfeUyCbZBsjxHZgSiw: folds 
Uncalled bet ($2.25) returned to 3skmHD9EOATKdUzzyHh1KA
3skmHD9EOATKdUzzyHh1KA collected $3.90 from pot
3skmHD9EOATKdUzzyHh1KA: doesn't show hand 
*** SUMMARY ***
Total pot $4.10 | Rake $0.20 
Board [6h 8d Js 2s]
Seat 1: 3skmHD9EOATKdUzzyHh1KA (big blind) collected ($3.90)
Seat 2: wqphQtauX5Qn7WRJZS1flA folded before Flop (didn't bet)
Seat 3: oBUDUfeUyCbZBsjxHZgSiw folded on the Turn
Seat 4: epAUIB7h2FJXzUPRIvSkRA folded before Flop (didn't bet)
Seat 5: 0av6tRNdi0Ui4f15L7gsVg (button) folded before Flop (didn't bet)
Seat 6: tj9xqoqQaDaFw7u1oyZrtA (small blind) folded before Flop




PokerStars Game #59941837964:  Hold'em No Limit ($0.10/$0.25) - 2009/07/01 1:47:45 ET
Table '2VkNDXXsBj4bSZw/uK5atw' 6-max Seat #2 is the button
Seat 1: xrf8tAXKQHG99HixCot1Iw ($25.25 in chips) 
Seat 2: v6mkGzCBCCXcgWQNSYVtKg ($12.90 in chips) 
Seat 3: P+6Z5+8H5/Wyt/jHMovNvQ ($24.25 in chips) 
Seat 4: 4kIRqWKE/N0yUAcWVhLSoQ ($14.50 in chips) 
Seat 5: 7f0OkhFEOf3T+rVOFHRLnw ($20.05 in chips) 
Seat 6: n6UPMnVR4v8LFP0rWP73Fg ($12.95 in chips) 
P+6Z5+8H5/Wyt/jHMovNvQ: posts small blind $0.10
4kIRqWKE/N0yUAcWVhLSoQ: posts big blind $0.25
*** HOLE CARDS ***
7f0OkhFEOf3T+rVOFHRLnw: calls $0.25
n6UPMnVR4v8LFP0rWP73Fg: folds 
xrf8tAXKQHG99HixCot1Iw: folds 
v6mkGzCBCCXcgWQNSYVtKg: folds 
P+6Z5+8H5/Wyt/jHMovNvQ: calls $0.15
4kIRqWKE/N0yUAcWVhLSoQ: checks 
*** FLOP *** [Ah 4s Ks]
P+6Z5+8H5/Wyt/jHMovNvQ: bets $0.50
4kIRqWKE/N0yUAcWVhLSoQ: calls $0.50
7f0OkhFEOf3T+rVOFHRLnw: calls $0.50
*** TURN *** [Ah 4s Ks] [3h]
P+6Z5+8H5/Wyt/jHMovNvQ: bets $1.50
4kIRqWKE/N0yUAcWVhLSoQ: folds 
7f0OkhFEOf3T+rVOFHRLnw: folds 
Uncalled bet ($1.50) returned to P+6Z5+8H5/Wyt/jHMovNvQ
P+6Z5+8H5/Wyt/jHMovNvQ collected $2.15 from pot
P+6Z5+8H5/Wyt/jHMovNvQ: doesn't show hand 
*** SUMMARY ***
Total pot $2.25 | Rake $0.10 
Board [Ah 4s Ks 3h]
Seat 1: xrf8tAXKQHG99HixCot1Iw folded before Flop (didn't bet)
Seat 2: v6mkGzCBCCXcgWQNSYVtKg (button) folded before Flop (didn't bet)
Seat 3: P+6Z5+8H5/Wyt/jHMovNvQ (small blind) collected ($2.15)
Seat 4: 4kIRqWKE/N0yUAcWVhLSoQ (big blind) folded on the Turn
Seat 5: 7f0OkhFEOf3T+rVOFHRLnw folded on the Turn
Seat 6: n6UPMnVR4v8LFP0rWP73Fg folded before Flop (didn't bet)




PokerStars Game #59941837930:  Hold'em No Limit ($0.10/$0.25) - 2009/07/01 1:47:45 ET
Table '+68ihX5Br1xgGorX6zsCBg' 9-max Seat #3 is the button
Seat 1: IFB2mhulUVYIbb+KWwDC9w ($3.95 in chips) 
Seat 2: TeAfhXG1R60d8yPEHN3JiA ($27.90 in chips) 
Seat 3: PdIasPkzm2sqZnN41ZRXOg ($4.65 in chips) 
Seat 4: Oi0EiPIjriUb/6zT65YeWA ($27.05 in chips) 
Seat 5: ghNKXUBl/H+t83JF079ZBA ($29 in chips) 
Seat 6: X78b5v/uhqeXXoAijbw/yg ($26.40 in chips) 
Seat 7: V6p0jQ/RhUsqpHLmXvEX4Q ($16.45 in chips) 
Seat 9: DiSvPC2iudwL5j9u6Huyww ($32.75 in chips) 
Oi0EiPIjriUb/6zT65YeWA: posts small blind $0.10
ghNKXUBl/H+t83JF079ZBA: posts big blind $0.25
*** HOLE CARDS ***
X78b5v/uhqeXXoAijbw/yg: folds 
V6p0jQ/RhUsqpHLmXvEX4Q: folds 
DiSvPC2iudwL5j9u6Huyww: folds 
IFB2mhulUVYIbb+KWwDC9w: calls $0.25
TeAfhXG1R60d8yPEHN3JiA: calls $0.25
PdIasPkzm2sqZnN41ZRXOg: folds 
Oi0EiPIjriUb/6zT65YeWA: folds 
ghNKXUBl/H+t83JF079ZBA: checks 
*** FLOP *** [4s Jh 5c]
ghNKXUBl/H+t83JF079ZBA: checks 
IFB2mhulUVYIbb+KWwDC9w: checks 
TeAfhXG1R60d8yPEHN3JiA: checks 
*** TURN *** [4s Jh 5c] [Tc]
ghNKXUBl/H+t83JF079ZBA: checks 
IFB2mhulUVYIbb+KWwDC9w: bets $0.50
TeAfhXG1R60d8yPEHN3JiA: folds 
ghNKXUBl/H+t83JF079ZBA: folds 
Uncalled bet ($0.50) returned to IFB2mhulUVYIbb+KWwDC9w
IFB2mhulUVYIbb+KWwDC9w collected $0.85 from pot
IFB2mhulUVYIbb+KWwDC9w: doesn't show hand 
*** SUMMARY ***
Total pot $0.85 | Rake $0 
Board [4s Jh 5c Tc]
Seat 1: IFB2mhulUVYIbb+KWwDC9w collected ($0.85)
Seat 2: TeAfhXG1R60d8yPEHN3JiA folded on the Turn
Seat 3: PdIasPkzm2sqZnN41ZRXOg (button) folded before Flop (didn't bet)
Seat 4: Oi0EiPIjriUb/6zT65YeWA (small blind) folded before Flop
Seat 5: ghNKXUBl/H+t83JF079ZBA (big blind) folded on the Turn
Seat 6: X78b5v/uhqeXXoAijbw/yg folded before Flop (didn't bet)
Seat 7: V6p0jQ/RhUsqpHLmXvEX4Q folded before Flop (didn't bet)
Seat 9: DiSvPC2iudwL5j9u6Huyww folded before Flop (didn't bet)




PokerStars Game #59941838364:  Hold'em No Limit ($0.10/$0.25) - 2009/07/01 1:47:45 ET
Table 'G+4ZdyRoPjgaJY/jxSlZzQ' 9-max Seat #4 is the button
Seat 1: ghNKXUBl/H+t83JF079ZBA ($23.75 in chips) 
Seat 2: CT7Xj/V/O5rBlhtt+RZeFQ ($25 in chips) 
Seat 3: FaGtAm5QUVcixGhAKIvbLg ($6.25 in chips) 
Seat 4: 3PmVnC/15cl4oyI1TKIt4g ($4.65 in chips) 
Seat 5: BT6Oal0iO4P6kDuT7HFQDw ($24.35 in chips) 
Seat 6: oFwaTjy3ok/+qFghsrcGvg ($22.05 in chips) 
Seat 8: bXpVeaSTPBFSPJmeXxO7nw ($4.65 in chips) 
Seat 9: tLcDklc2rBORNfixyRfVfw ($26.50 in chips) 
BT6Oal0iO4P6kDuT7HFQDw: posts small blind $0.10
oFwaTjy3ok/+qFghsrcGvg: posts big blind $0.25
qwr38jl5txoR36M7G5qi4A: sits out 
*** HOLE CARDS ***
bXpVeaSTPBFSPJmeXxO7nw: folds 
tLcDklc2rBORNfixyRfVfw: folds 
ghNKXUBl/H+t83JF079ZBA: folds 
CT7Xj/V/O5rBlhtt+RZeFQ: calls $0.25
FaGtAm5QUVcixGhAKIvbLg: raises $1.25 to $1.50
3PmVnC/15cl4oyI1TKIt4g: folds 
BT6Oal0iO4P6kDuT7HFQDw: folds 
oFwaTjy3ok/+qFghsrcGvg: folds 
CT7Xj/V/O5rBlhtt+RZeFQ: folds 
Uncalled bet ($1.25) returned to FaGtAm5QUVcixGhAKIvbLg
FaGtAm5QUVcixGhAKIvbLg collected $0.85 from pot
*** SUMMARY ***
Total pot $0.85 | Rake $0 
Seat 1: ghNKXUBl/H+t83JF079ZBA folded before Flop (didn't bet)
Seat 2: CT7Xj/V/O5rBlhtt+RZeFQ folded before Flop
Seat 3: FaGtAm5QUVcixGhAKIvbLg collected ($0.85)
Seat 4: 3PmVnC/15cl4oyI1TKIt4g (button) folded before Flop (didn't bet)
Seat 5: BT6Oal0iO4P6kDuT7HFQDw (small blind) folded before Flop
Seat 6: oFwaTjy3ok/+qFghsrcGvg (big blind) folded before Flop
Seat 8: bXpVeaSTPBFSPJmeXxO7nw folded before Flop (didn't bet)
Seat 9: tLcDklc2rBORNfixyRfVfw folded before Flop (didn't bet)




PokerStars Game #59941838094:  Hold'em No Limit ($0.10/$0.25) - 2009/07/01 1:47:45 ET
Table '0M5QEJGOThqZwQ/sjbjXYw' 6-max Seat #3 is the button
Seat 2: /gJNBeCkWL4o85/jvlZ4BA ($34.60 in chips) 
Seat 3: 3zD3qLXT1bEffAoWGnc7wg ($25 in chips) 
Seat 4: oBUDUfeUyCbZBsjxHZgSiw ($22 in chips) 
Seat 5: cWc85bEzdRzpUMhRKm8pwQ ($33.50 in chips) 
Seat 6: bb63I02U6p9a5MNFa1gCiw ($21 in chips) 
oBUDUfeUyCbZBsjxHZgSiw: posts small blind $0.10
cWc85bEzdRzpUMhRKm8pwQ: posts big blind $0.25
*** HOLE CARDS ***
bb63I02U6p9a5MNFa1gCiw: calls $0.25
/gJNBeCkWL4o85/jvlZ4BA: folds 
3zD3qLXT1bEffAoWGnc7wg: folds 
oBUDUfeUyCbZBsjxHZgSiw: folds 
cWc85bEzdRzpUMhRKm8pwQ: checks 
*** FLOP *** [Jd 3d 8s]
cWc85bEzdRzpUMhRKm8pwQ: checks 
bb63I02U6p9a5MNFa1gCiw: checks 
*** TURN *** [Jd 3d 8s] [4h]
cWc85bEzdRzpUMhRKm8pwQ: checks 
bb63I02U6p9a5MNFa1gCiw: checks 
*** RIVER *** [Jd 3d 8s 4h] [6s]
cWc85bEzdRzpUMhRKm8pwQ: checks 
bb63I02U6p9a5MNFa1gCiw: checks 
*** SHOW DOWN ***
cWc85bEzdRzpUMhRKm8pwQ: shows [2c 9d] (high card Jack)
bb63I02U6p9a5MNFa1gCiw: shows [9c Ks] (high card King)
bb63I02U6p9a5MNFa1gCiw collected $0.60 from pot
*** SUMMARY ***
Total pot $0.60 | Rake $0 
Board [Jd 3d 8s 4h 6s]
Seat 2: /gJNBeCkWL4o85/jvlZ4BA folded before Flop (didn't bet)
Seat 3: 3zD3qLXT1bEffAoWGnc7wg (button) folded before Flop (didn't bet)
Seat 4: oBUDUfeUyCbZBsjxHZgSiw (small blind) folded before Flop
Seat 5: cWc85bEzdRzpUMhRKm8pwQ (big blind) showed [2c 9d] and lost with high card Jack
Seat 6: bb63I02U6p9a5MNFa1gCiw showed [9c Ks] and won ($0.60) with high card King




PokerStars Game #59941838070:  Hold'em No Limit ($0.10/$0.25) - 2009/07/01 1:47:45 ET
Table 'YlRA05h9BJ1EhOUSNUjJdg' 9-max Seat #2 is the button
Seat 1: dtZ84flFEi4Q+SGrHMJRDQ ($25.25 in chips) 
Seat 2: Y2GFAe+PT7xnUUtgqCNDFw ($8.95 in chips) 
Seat 3: Z5ZtGOON8kmSdSCll9Z3XA ($12.95 in chips) 
Seat 4: HPEB+AtKw1+C/cxU0o1ciw ($33.95 in chips) 
Seat 5: sx0lGrkT9fd4yFR+3cXUQg ($11.65 in chips) 
Seat 6: QEbIGci+itdw+re8RM5fZA ($44 in chips) 
Seat 7: dfNim92Z6XK1/h5SFW5vDg ($25 in chips) 
Seat 8: dmYlc+1cjwZMJ7wV+Z0rRg ($32.90 in chips) 
Seat 9: Z9AeOQX3yzuSvKAm/xyovg ($10.10 in chips) 
Z5ZtGOON8kmSdSCll9Z3XA: posts small blind $0.10
HPEB+AtKw1+C/cxU0o1ciw: posts big blind $0.25
*** HOLE CARDS ***
sx0lGrkT9fd4yFR+3cXUQg: folds 
QEbIGci+itdw+re8RM5fZA: folds 
dfNim92Z6XK1/h5SFW5vDg: folds 
dmYlc+1cjwZMJ7wV+Z0rRg: folds 
Z9AeOQX3yzuSvKAm/xyovg: folds 
dtZ84flFEi4Q+SGrHMJRDQ: folds 
Y2GFAe+PT7xnUUtgqCNDFw: folds 
Z5ZtGOON8kmSdSCll9Z3XA: folds 
Uncalled bet ($0.15) returned to HPEB+AtKw1+C/cxU0o1ciw
HPEB+AtKw1+C/cxU0o1ciw collected $0.20 from pot
HPEB+AtKw1+C/cxU0o1ciw: doesn't show hand 
*** SUMMARY ***
Total pot $0.20 | Rake $0 
Seat 1: dtZ84flFEi4Q+SGrHMJRDQ folded before Flop (didn't bet)
Seat 2: Y2GFAe+PT7xnUUtgqCNDFw (button) folded before Flop (didn't bet)
Seat 3: Z5ZtGOON8kmSdSCll9Z3XA (small blind) folded before Flop
Seat 4: HPEB+AtKw1+C/cxU0o1ciw (big blind) collected ($0.20)
Seat 5: sx0lGrkT9fd4yFR+3cXUQg folded before Flop (didn't bet)
Seat 6: QEbIGci+itdw+re8RM5fZA folded before Flop (didn't bet)
Seat 7: dfNim92Z6XK1/h5SFW5vDg folded before Flop (didn't bet)
Seat 8: dmYlc+1cjwZMJ7wV+Z0rRg folded before Flop (didn't bet)
Seat 9: Z9AeOQX3yzuSvKAm/xyovg folded before Flop (didn't bet)




PokerStars Game #59941838534:  Hold'em No Limit ($0.10/$0.25) - 2009/07/01 1:47:46 ET
Table 'vud0GB/ZlDCvUFhBFIaTlg' 9-max Seat #2 is the button
Seat 1: DiSvPC2iudwL5j9u6Huyww ($29.50 in chips) 
Seat 2: tLcDklc2rBORNfixyRfVfw ($25.80 in chips) 
Seat 3: W2YYHvqjaEpRrO7stZkClQ ($4.05 in chips) 
Seat 4: dWgEDExmVO0d+rRmUYCU5w ($15.80 in chips) 
Seat 5: eK8qa6EPcH2zhtbmWSvc9g ($25 in chips) 
Seat 6: gehe91e0IyVT0QU/XBkEyg ($25 in chips) 
Seat 7: iG7VeTyBWf6wYNvZpbTcbw ($20.05 in chips) 
Seat 8: E0iYnEVO2ho7dH3QcCjw7g ($19.75 in chips) 
Seat 9: PdIasPkzm2sqZnN41ZRXOg ($5.20 in chips) 
W2YYHvqjaEpRrO7stZkClQ: posts small blind $0.10
dWgEDExmVO0d+rRmUYCU5w: posts big blind $0.25
*** HOLE CARDS ***
eK8qa6EPcH2zhtbmWSvc9g: folds 
gehe91e0IyVT0QU/XBkEyg: folds 
iG7VeTyBWf6wYNvZpbTcbw: calls $0.25
E0iYnEVO2ho7dH3QcCjw7g: folds 
PdIasPkzm2sqZnN41ZRXOg: folds 
DiSvPC2iudwL5j9u6Huyww: folds 
tLcDklc2rBORNfixyRfVfw: raises $1 to $1.25
W2YYHvqjaEpRrO7stZkClQ: folds 
dWgEDExmVO0d+rRmUYCU5w: folds 
iG7VeTyBWf6wYNvZpbTcbw: calls $1
*** FLOP *** [8c 5h 5d]
iG7VeTyBWf6wYNvZpbTcbw: checks 
tLcDklc2rBORNfixyRfVfw: checks 
*** TURN *** [8c 5h 5d] [9s]
iG7VeTyBWf6wYNvZpbTcbw: checks 
tLcDklc2rBORNfixyRfVfw: checks 
*** RIVER *** [8c 5h 5d 9s] [Qc]
iG7VeTyBWf6wYNvZpbTcbw: checks 
tLcDklc2rBORNfixyRfVfw: checks 
*** SHOW DOWN ***
iG7VeTyBWf6wYNvZpbTcbw: shows [2s 2h] (two pair, Fives and Deuces)
tLcDklc2rBORNfixyRfVfw: mucks hand 
iG7VeTyBWf6wYNvZpbTcbw collected $2.75 from pot
*** SUMMARY ***
Total pot $2.85 | Rake $0.10 
Board [8c 5h 5d 9s Qc]
Seat 1: DiSvPC2iudwL5j9u6Huyww folded before Flop (didn't bet)
Seat 2: tLcDklc2rBORNfixyRfVfw (button) mucked
Seat 3: W2YYHvqjaEpRrO7stZkClQ (small blind) folded before Flop
Seat 4: dWgEDExmVO0d+rRmUYCU5w (big blind) folded before Flop
Seat 5: eK8qa6EPcH2zhtbmWSvc9g folded before Flop (didn't bet)
Seat 6: gehe91e0IyVT0QU/XBkEyg folded before Flop (didn't bet)
Seat 7: iG7VeTyBWf6wYNvZpbTcbw showed [2s 2h] and won ($2.75) with two pair, Fives and Deuces
Seat 8: E0iYnEVO2ho7dH3QcCjw7g folded before Flop (didn't bet)
Seat 9: PdIasPkzm2sqZnN41ZRXOg folded before Flop (didn't bet)




PokerStars Game #59941838816:  Hold'em No Limit ($0.10/$0.25) - 2009/07/01 1:47:46 ET
Table 'ouLhepGYovxB2x0QxH7cVg' 9-max Seat #3 is the button
Seat 1: ghNKXUBl/H+t83JF079ZBA ($25 in chips) 
Seat 2: r1Z5m4PwSI5ANp7qCE1OJw ($23.35 in chips) 
Seat 3: bXpVeaSTPBFSPJmeXxO7nw ($4.90 in chips) 
Seat 4: a0Sx6GHY7ln2Ns2C97eXeA ($37.85 in chips) 
Seat 5: v60REj6f8jzMYT0VsZvaPQ ($11.25 in chips) 
Seat 7: JRV2PblFtPFz51l0Fwyz8g ($24.25 in chips) 
Seat 8: tLcDklc2rBORNfixyRfVfw ($25.35 in chips) 
Seat 9: ljemhp25Zg+nlA9DLCIiUw ($24.35 in chips) 
a0Sx6GHY7ln2Ns2C97eXeA: posts small blind $0.10
v60REj6f8jzMYT0VsZvaPQ: posts big blind $0.25
hYvTc4PYNrAaNAIVoM94Hw: sits out 
*** HOLE CARDS ***
JRV2PblFtPFz51l0Fwyz8g: folds 
tLcDklc2rBORNfixyRfVfw: folds 
ljemhp25Zg+nlA9DLCIiUw: raises $0.50 to $0.75
ghNKXUBl/H+t83JF079ZBA: folds 
r1Z5m4PwSI5ANp7qCE1OJw: folds 
bXpVeaSTPBFSPJmeXxO7nw: folds 
a0Sx6GHY7ln2Ns2C97eXeA: calls $0.65
v60REj6f8jzMYT0VsZvaPQ: folds 
*** FLOP *** [7s 8c 3d]
a0Sx6GHY7ln2Ns2C97eXeA: checks 
ljemhp25Zg+nlA9DLCIiUw: bets $1.25
a0Sx6GHY7ln2Ns2C97eXeA: folds 
Uncalled bet ($1.25) returned to ljemhp25Zg+nlA9DLCIiUw
ljemhp25Zg+nlA9DLCIiUw collected $1.70 from pot
ljemhp25Zg+nlA9DLCIiUw: doesn't show hand 
*** SUMMARY ***
Total pot $1.75 | Rake $0.05 
Board [7s 8c 3d]
Seat 1: ghNKXUBl/H+t83JF079ZBA folded before Flop (didn't bet)
Seat 2: r1Z5m4PwSI5ANp7qCE1OJw folded before Flop (didn't bet)
Seat 3: bXpVeaSTPBFSPJmeXxO7nw (button) folded before Flop (didn't bet)
Seat 4: a0Sx6GHY7ln2Ns2C97eXeA (small blind) folded on the Flop
Seat 5: v60REj6f8jzMYT0VsZvaPQ (big blind) folded before Flop
Seat 7: JRV2PblFtPFz51l0Fwyz8g folded before Flop (didn't bet)
Seat 8: tLcDklc2rBORNfixyRfVfw folded before Flop (didn't bet)
Seat 9: ljemhp25Zg+nlA9DLCIiUw collected ($1.70)




PokerStars Game #59941838454:  Hold'em No Limit ($0.10/$0.25) - 2009/07/01 1:47:46 ET
Table 'sm5gqEvXgLbkkE4dryW/5g' 6-max Seat #2 is the button
Seat 1: v8m8XHovI5tqEA9mvplDSw ($39.85 in chips) 
Seat 2: 5xs5/u2z1CO9zkRvH72MQg ($17.65 in chips) 
Seat 3: UT5XpwOH1ipkOF7n1MqDJA ($21.65 in chips) 
Seat 4: cWc85bEzdRzpUMhRKm8pwQ ($26.15 in chips) 
Seat 6: aogAb4Eienxztk8p2v9VVw ($22.50 in chips) 
UT5XpwOH1ipkOF7n1MqDJA: posts small blind $0.10
cWc85bEzdRzpUMhRKm8pwQ: posts big blind $0.25
*** HOLE CARDS ***
aogAb4Eienxztk8p2v9VVw: folds 
v8m8XHovI5tqEA9mvplDSw: folds 
5xs5/u2z1CO9zkRvH72MQg: calls $0.25
UT5XpwOH1ipkOF7n1MqDJA: calls $0.15
cWc85bEzdRzpUMhRKm8pwQ: checks 
*** FLOP *** [2d 4h Ah]
UT5XpwOH1ipkOF7n1MqDJA: checks 
cWc85bEzdRzpUMhRKm8pwQ: checks 
5xs5/u2z1CO9zkRvH72MQg: checks 
*** TURN *** [2d 4h Ah] [9h]
UT5XpwOH1ipkOF7n1MqDJA: bets $0.75
cWc85bEzdRzpUMhRKm8pwQ: folds 
5xs5/u2z1CO9zkRvH72MQg: calls $0.75
*** RIVER *** [2d 4h Ah 9h] [9c]
UT5XpwOH1ipkOF7n1MqDJA: bets $2
5xs5/u2z1CO9zkRvH72MQg: calls $2
*** SHOW DOWN ***
UT5XpwOH1ipkOF7n1MqDJA: shows [9s Th] (three of a kind, Nines)
5xs5/u2z1CO9zkRvH72MQg: shows [8h Jh] (a flush, Ace high)
5xs5/u2z1CO9zkRvH72MQg collected $5.95 from pot
*** SUMMARY ***
Total pot $6.25 | Rake $0.30 
Board [2d 4h Ah 9h 9c]
Seat 1: v8m8XHovI5tqEA9mvplDSw folded before Flop (didn't bet)
Seat 2: 5xs5/u2z1CO9zkRvH72MQg (button) showed [8h Jh] and won ($5.95) with a flush, Ace high
Seat 3: UT5XpwOH1ipkOF7n1MqDJA (small blind) showed [9s Th] and lost with three of a kind, Nines
Seat 4: cWc85bEzdRzpUMhRKm8pwQ (big blind) folded on the Turn
Seat 6: aogAb4Eienxztk8p2v9VVw folded before Flop (didn't bet)




PokerStars Game #59941838746:  Hold'em No Limit ($0.10/$0.25) - 2009/07/01 1:47:46 ET
Table 'tq5CvS0RUqGkuBK0XTzqqg' 6-max Seat #6 is the button
Seat 1: +ZlnqPoP3Hg4BIUxDfKd/A ($30.20 in chips) 
Seat 2: 2m6ZFAdj01UZd4WtEySXXQ ($4.50 in chips) 
Seat 4: UT5XpwOH1ipkOF7n1MqDJA ($34.55 in chips) 
Seat 5: qGHGf/553gQnDoklMRe3tg ($37.65 in chips) 
Seat 6: QqiZLFrN8iOUT/GHw7ztOA ($24.65 in chips) 
+ZlnqPoP3Hg4BIUxDfKd/A: posts small blind $0.10
2m6ZFAdj01UZd4WtEySXXQ: posts big blind $0.25
08V++DOqzaNrRNsHIwi25w: sits out 
*** HOLE CARDS ***
UT5XpwOH1ipkOF7n1MqDJA: calls $0.25
qGHGf/553gQnDoklMRe3tg: folds 
QqiZLFrN8iOUT/GHw7ztOA: folds 
+ZlnqPoP3Hg4BIUxDfKd/A: calls $0.15
2m6ZFAdj01UZd4WtEySXXQ: checks 
*** FLOP *** [6s 3d Kh]
+ZlnqPoP3Hg4BIUxDfKd/A: checks 
2m6ZFAdj01UZd4WtEySXXQ: checks 
UT5XpwOH1ipkOF7n1MqDJA: checks 
*** TURN *** [6s 3d Kh] [2h]
+ZlnqPoP3Hg4BIUxDfKd/A: checks 
2m6ZFAdj01UZd4WtEySXXQ: checks 
UT5XpwOH1ipkOF7n1MqDJA: checks 
*** RIVER *** [6s 3d Kh 2h] [5d]
+ZlnqPoP3Hg4BIUxDfKd/A: checks 
2m6ZFAdj01UZd4WtEySXXQ: bets $0.50
UT5XpwOH1ipkOF7n1MqDJA: folds 
+ZlnqPoP3Hg4BIUxDfKd/A: folds 
Uncalled bet ($0.50) returned to 2m6ZFAdj01UZd4WtEySXXQ
2m6ZFAdj01UZd4WtEySXXQ collected $0.75 from pot
*** SUMMARY ***
Total pot $0.75 | Rake $0 
Board [6s 3d Kh 2h 5d]
Seat 1: +ZlnqPoP3Hg4BIUxDfKd/A (small blind) folded on the River
Seat 2: 2m6ZFAdj01UZd4WtEySXXQ (big blind) collected ($0.75)
Seat 4: UT5XpwOH1ipkOF7n1MqDJA folded on the River
Seat 5: qGHGf/553gQnDoklMRe3tg folded before Flop (didn't bet)
Seat 6: QqiZLFrN8iOUT/GHw7ztOA (button) folded before Flop (didn't bet)




PokerStars Game #59941838730:  Hold'em No Limit ($0.10/$0.25) - 2009/07/01 1:47:46 ET
Table '972HGIb0tQN/zRIK4TABEw' 9-max Seat #7 is the button
Seat 1: fHr2+mGa0RFK3qrpZcVUAQ ($6.60 in chips) 
Seat 4: aSrj4lVmn2owyQ1RbbOqxQ ($11.90 in chips) 
Seat 5: swK30YlQuxRQO7QFr4ZxCA ($45.70 in chips) 
Seat 7: qS+jfnNoG75bT+uQ8CKhQA ($14.40 in chips) 
A_Bit_Hasty will be allowed to play after the button
fHr2+mGa0RFK3qrpZcVUAQ: posts small blind $0.10
aNpwfA31EREwO+ar4XzBCw: is sitting out 
aSrj4lVmn2owyQ1RbbOqxQ: posts big blind $0.25
*** HOLE CARDS ***
A_Bit_Hasty leaves the table
swK30YlQuxRQO7QFr4ZxCA: folds 
qS+jfnNoG75bT+uQ8CKhQA: folds 
fHr2+mGa0RFK3qrpZcVUAQ: calls $0.15
aSrj4lVmn2owyQ1RbbOqxQ: checks 
*** FLOP *** [9d As Ad]
fHr2+mGa0RFK3qrpZcVUAQ: checks 
aSrj4lVmn2owyQ1RbbOqxQ: bets $0.25
fHr2+mGa0RFK3qrpZcVUAQ: raises $0.25 to $0.50
aSrj4lVmn2owyQ1RbbOqxQ: folds 
Uncalled bet ($0.25) returned to fHr2+mGa0RFK3qrpZcVUAQ
fHr2+mGa0RFK3qrpZcVUAQ collected $0.95 from pot
*** SUMMARY ***
Total pot $1 | Rake $0.05 
Board [9d As Ad]
Seat 1: fHr2+mGa0RFK3qrpZcVUAQ (small blind) collected ($0.95)
Seat 4: aSrj4lVmn2owyQ1RbbOqxQ (big blind) folded on the Flop
Seat 5: swK30YlQuxRQO7QFr4ZxCA folded before Flop (didn't bet)
Seat 7: qS+jfnNoG75bT+uQ8CKhQA (button) folded before Flop (didn't bet)




PokerStars Game #59941838438:  Hold'em No Limit ($0.10/$0.25) - 2009/07/01 1:47:46 ET
Table '6wawJ+MkkvuC3coG6r+Yhg' 6-max Seat #1 is the button
Seat 1: JQZew0FjzS19kTjeNtrE+A ($19.85 in chips) 
Seat 2: LtASJ9OlkqGrrUKGQlpGAw ($33.90 in chips) 
Seat 3: 3zD3qLXT1bEffAoWGnc7wg ($61.25 in chips) 
Seat 4: yxmjNFGiKI3b+XQGJzJVIg ($34.05 in chips) 
Seat 5: FZrgDbxAanC1xwZxXHJKVA ($4.30 in chips) 
Seat 6: B3X187C0tXFUfQpCu8pe8A ($25.15 in chips) 
LtASJ9OlkqGrrUKGQlpGAw: posts small blind $0.10
3zD3qLXT1bEffAoWGnc7wg: posts big blind $0.25
*** HOLE CARDS ***
yxmjNFGiKI3b+XQGJzJVIg: folds 
FZrgDbxAanC1xwZxXHJKVA: folds 
B3X187C0tXFUfQpCu8pe8A: folds 
JQZew0FjzS19kTjeNtrE+A: folds 
LtASJ9OlkqGrrUKGQlpGAw: folds 
Uncalled bet ($0.15) returned to 3zD3qLXT1bEffAoWGnc7wg
3zD3qLXT1bEffAoWGnc7wg collected $0.20 from pot
3zD3qLXT1bEffAoWGnc7wg: doesn't show hand 
*** SUMMARY ***
Total pot $0.20 | Rake $0 
Seat 1: JQZew0FjzS19kTjeNtrE+A (button) folded before Flop (didn't bet)
Seat 2: LtASJ9OlkqGrrUKGQlpGAw (small blind) folded before Flop
Seat 3: 3zD3qLXT1bEffAoWGnc7wg (big blind) collected ($0.20)
Seat 4: yxmjNFGiKI3b+XQGJzJVIg folded before Flop (didn't bet)
Seat 5: FZrgDbxAanC1xwZxXHJKVA folded before Flop (didn't bet)
Seat 6: B3X187C0tXFUfQpCu8pe8A folded before Flop (didn't bet)




PokerStars Game #59941838566:  Hold'em No Limit ($0.10/$0.25) - 2009/07/01 1:47:46 ET
Table 'AchTjdLS1zBUbH3ZIx6f0w' 6-max Seat #3 is the button
Seat 1: rZ0bUtoerhFGDUSRQMnFog ($29.95 in chips) 
Seat 2: kG34n23qFQA3nzdOJTQ1dA ($65.90 in chips) 
Seat 3: k9vn40MOqqb+xF+7GZ6v2g ($29 in chips) 
Seat 4: q6WfTUAD9mowIP63ASq2Dg ($31.45 in chips) 
Seat 5: 0av6tRNdi0Ui4f15L7gsVg ($24.25 in chips) 
Seat 6: epAUIB7h2FJXzUPRIvSkRA ($25.35 in chips) 
q6WfTUAD9mowIP63ASq2Dg: posts small blind $0.10
0av6tRNdi0Ui4f15L7gsVg: posts big blind $0.25
*** HOLE CARDS ***
epAUIB7h2FJXzUPRIvSkRA: folds 
rZ0bUtoerhFGDUSRQMnFog: calls $0.25
kG34n23qFQA3nzdOJTQ1dA: folds 
k9vn40MOqqb+xF+7GZ6v2g: folds 
q6WfTUAD9mowIP63ASq2Dg: calls $0.15
0av6tRNdi0Ui4f15L7gsVg: checks 
*** FLOP *** [Kd Kh 7s]
q6WfTUAD9mowIP63ASq2Dg: checks 
0av6tRNdi0Ui4f15L7gsVg: checks 
rZ0bUtoerhFGDUSRQMnFog: bets $0.50
q6WfTUAD9mowIP63ASq2Dg: folds 
0av6tRNdi0Ui4f15L7gsVg: folds 
Uncalled bet ($0.50) returned to rZ0bUtoerhFGDUSRQMnFog
rZ0bUtoerhFGDUSRQMnFog collected $0.75 from pot
rZ0bUtoerhFGDUSRQMnFog: doesn't show hand 
*** SUMMARY ***
Total pot $0.75 | Rake $0 
Board [Kd Kh 7s]
Seat 1: rZ0bUtoerhFGDUSRQMnFog collected ($0.75)
Seat 2: kG34n23qFQA3nzdOJTQ1dA folded before Flop (didn't bet)
Seat 3: k9vn40MOqqb+xF+7GZ6v2g (button) folded before Flop (didn't bet)
Seat 4: q6WfTUAD9mowIP63ASq2Dg (small blind) folded on the Flop
Seat 5: 0av6tRNdi0Ui4f15L7gsVg (big blind) folded on the Flop
Seat 6: epAUIB7h2FJXzUPRIvSkRA folded before Flop (didn't bet)




PokerStars Game #59941839312:  Hold'em No Limit ($0.10/$0.25) - 2009/07/01 1:47:47 ET
Table '5NipxzzFB2DffzDpddyQoQ' 6-max Seat #2 is the button
Seat 1: W87HPwOk1KtWaYyshBe1gA ($20.65 in chips) 
Seat 2: iauW7L/+7qzAuHow7CD75Q ($6.20 in chips) 
Seat 3: QvTX2yGq3uKJiKPmns4TKQ ($6.30 in chips) 
Seat 4: NTamLAiMZ86c5yM04t96LA ($36.50 in chips) 
Seat 5: faP2NVl/cFTZ1nE4pXzg8Q ($27.90 in chips) 
Seat 6: 7JqTFMyeNSVWsmp/yW35Tw ($27.30 in chips) 
QvTX2yGq3uKJiKPmns4TKQ: posts small blind $0.10
NTamLAiMZ86c5yM04t96LA: posts big blind $0.25
*** HOLE CARDS ***
faP2NVl/cFTZ1nE4pXzg8Q: calls $0.25
W87HPwOk1KtWaYyshBe1gA said, "lol"
7JqTFMyeNSVWsmp/yW35Tw: folds 
W87HPwOk1KtWaYyshBe1gA: folds 
iauW7L/+7qzAuHow7CD75Q: calls $0.25
QvTX2yGq3uKJiKPmns4TKQ: folds 
NTamLAiMZ86c5yM04t96LA: checks 
*** FLOP *** [Ad Th Qs]
W87HPwOk1KtWaYyshBe1gA said, "nh"
NTamLAiMZ86c5yM04t96LA: checks 
faP2NVl/cFTZ1nE4pXzg8Q: bets $1
NTamLAiMZ86c5yM04t96LA said, "TKS"
iauW7L/+7qzAuHow7CD75Q: folds 
NTamLAiMZ86c5yM04t96LA: calls $1
*** TURN *** [Ad Th Qs] [Qc]
NTamLAiMZ86c5yM04t96LA: checks 
faP2NVl/cFTZ1nE4pXzg8Q: bets $2
NTamLAiMZ86c5yM04t96LA: folds 
Uncalled bet ($2) returned to faP2NVl/cFTZ1nE4pXzg8Q
faP2NVl/cFTZ1nE4pXzg8Q collected $2.75 from pot
faP2NVl/cFTZ1nE4pXzg8Q: doesn't show hand 
*** SUMMARY ***
Total pot $2.85 | Rake $0.10 
Board [Ad Th Qs Qc]
Seat 1: W87HPwOk1KtWaYyshBe1gA folded before Flop (didn't bet)
Seat 2: iauW7L/+7qzAuHow7CD75Q (button) folded on the Flop
Seat 3: QvTX2yGq3uKJiKPmns4TKQ (small blind) folded before Flop
Seat 4: NTamLAiMZ86c5yM04t96LA (big blind) folded on the Turn
Seat 5: faP2NVl/cFTZ1nE4pXzg8Q collected ($2.75)
Seat 6: 7JqTFMyeNSVWsmp/yW35Tw folded before Flop (didn't bet)




PokerStars Game #59941839242:  Hold'em No Limit ($0.10/$0.25) - 2009/07/01 1:47:47 ET
Table 'HbNAGS1OJWQKyfk7UfrYyw' 9-max Seat #2 is the button
Seat 1: yewI46YETJjAiiQPL5e+fQ ($5 in chips) 
Seat 2: fjwM06E3HzjUrynPRQi31Q ($6 in chips) 
Seat 3: Yxal0LG80xJqTIctpMLWlg ($3.75 in chips) 
Seat 4: XwQK8xvCADxp0bUmji+Zyg ($15 in chips) 
Seat 6: jntAuOS+eFQDYNiDN8dzag ($12.50 in chips) 
Seat 7: T+MjFnaPZsOyKbE9LYG2Qg ($15 in chips) 
Seat 9: nLE5Yo60EmSlJPyg0GgxXg ($21.10 in chips) 
Yxal0LG80xJqTIctpMLWlg: posts small blind $0.10
XwQK8xvCADxp0bUmji+Zyg: posts big blind $0.25
clJsV3v77RS07bDKY+705w joins the table at seat #5 
T+MjFnaPZsOyKbE9LYG2Qg: posts big blind $0.25
DiSvPC2iudwL5j9u6Huyww: sits out 
nLE5Yo60EmSlJPyg0GgxXg: posts big blind $0.25
yewI46YETJjAiiQPL5e+fQ: posts big blind $0.25
*** HOLE CARDS ***
jntAuOS+eFQDYNiDN8dzag: calls $0.25
T+MjFnaPZsOyKbE9LYG2Qg: checks 
nLE5Yo60EmSlJPyg0GgxXg: raises $2.25 to $2.50
yewI46YETJjAiiQPL5e+fQ: raises $2.25 to $4.75
fjwM06E3HzjUrynPRQi31Q: folds 
Yxal0LG80xJqTIctpMLWlg: folds 
XwQK8xvCADxp0bUmji+Zyg: folds 
jntAuOS+eFQDYNiDN8dzag: calls $4.50
T+MjFnaPZsOyKbE9LYG2Qg: folds 
nLE5Yo60EmSlJPyg0GgxXg: calls $2.25
*** FLOP *** [Tc 8s 5d]
jntAuOS+eFQDYNiDN8dzag: checks 
nLE5Yo60EmSlJPyg0GgxXg: checks 
yewI46YETJjAiiQPL5e+fQ: checks 
*** TURN *** [Tc 8s 5d] [Ks]
jntAuOS+eFQDYNiDN8dzag: checks 
nLE5Yo60EmSlJPyg0GgxXg: bets $5.25
yewI46YETJjAiiQPL5e+fQ: calls $0.25 and is all-in
jntAuOS+eFQDYNiDN8dzag: folds 
Uncalled bet ($5) returned to nLE5Yo60EmSlJPyg0GgxXg
*** RIVER *** [Tc 8s 5d Ks] [8c]
*** SHOW DOWN ***
nLE5Yo60EmSlJPyg0GgxXg: shows [Kh Qh] (two pair, Kings and Eights)
yewI46YETJjAiiQPL5e+fQ: shows [4c Ad] (a pair of Eights)
nLE5Yo60EmSlJPyg0GgxXg collected $14.65 from pot
*** SUMMARY ***
Total pot $15.35 | Rake $0.70 
Board [Tc 8s 5d Ks 8c]
Seat 1: yewI46YETJjAiiQPL5e+fQ showed [4c Ad] and lost with a pair of Eights
Seat 2: fjwM06E3HzjUrynPRQi31Q (button) folded before Flop (didn't bet)
Seat 3: Yxal0LG80xJqTIctpMLWlg (small blind) folded before Flop
Seat 4: XwQK8xvCADxp0bUmji+Zyg (big blind) folded before Flop
Seat 6: jntAuOS+eFQDYNiDN8dzag folded on the Turn
Seat 7: T+MjFnaPZsOyKbE9LYG2Qg folded before Flop
Seat 9: nLE5Yo60EmSlJPyg0GgxXg showed [Kh Qh] and won ($14.65) with two pair, Kings and Eights




PokerStars Game #59941839270:  Hold'em No Limit ($0.10/$0.25) - 2009/07/01 1:47:47 ET
Table 'Y9EhDWuqWWQFM9SelXAj5g' 9-max Seat #5 is the button
Seat 1: zDrucyjVn5aeekNEc3cJrA ($28.40 in chips) 
Seat 2: W+njF1UnarGN2q2zP+R+cg ($11.40 in chips) 
Seat 3: XBq1lBzax7LjRqdJP2TqWg ($3.70 in chips) 
Seat 4: V6p0jQ/RhUsqpHLmXvEX4Q ($13 in chips) 
Seat 5: CvL9Ch1HYCVbTsfpNucitg ($6.20 in chips) 
Seat 6: egvg3mTBBVzMHnJPIQiKcA ($13.75 in chips) 
Seat 8: XDxyajtqmdag0QPvwcOG7Q ($14.60 in chips) 
Seat 9: bOrfviVhRBpaOfMqUc74Tw ($17.65 in chips) 
egvg3mTBBVzMHnJPIQiKcA: posts small blind $0.10
aNpwfA31EREwO+ar4XzBCw: is sitting out 
XDxyajtqmdag0QPvwcOG7Q: posts big blind $0.25
zDrucyjVn5aeekNEc3cJrA: posts small & big blinds $0.35
*** HOLE CARDS ***
bOrfviVhRBpaOfMqUc74Tw: calls $0.25
zDrucyjVn5aeekNEc3cJrA: raises $1 to $1.25
W+njF1UnarGN2q2zP+R+cg: folds 
XBq1lBzax7LjRqdJP2TqWg: raises $2.45 to $3.70 and is all-in
V6p0jQ/RhUsqpHLmXvEX4Q: folds 
CvL9Ch1HYCVbTsfpNucitg: folds 
egvg3mTBBVzMHnJPIQiKcA: folds 
XDxyajtqmdag0QPvwcOG7Q: folds 
bOrfviVhRBpaOfMqUc74Tw: folds 
zDrucyjVn5aeekNEc3cJrA: calls $2.45
*** FLOP *** [Td 7d 2s]
*** TURN *** [Td 7d 2s] [6h]
*** RIVER *** [Td 7d 2s 6h] [Kd]
*** SHOW DOWN ***
zDrucyjVn5aeekNEc3cJrA: shows [Kc Kh] (three of a kind, Kings)
XBq1lBzax7LjRqdJP2TqWg: mucks hand 
zDrucyjVn5aeekNEc3cJrA collected $7.70 from pot
*** SUMMARY ***
Total pot $8.10 | Rake $0.40 
Board [Td 7d 2s 6h Kd]
Seat 1: zDrucyjVn5aeekNEc3cJrA showed [Kc Kh] and won ($7.70) with three of a kind, Kings
Seat 2: W+njF1UnarGN2q2zP+R+cg folded before Flop (didn't bet)
Seat 3: XBq1lBzax7LjRqdJP2TqWg mucked
Seat 4: V6p0jQ/RhUsqpHLmXvEX4Q folded before Flop (didn't bet)
Seat 5: CvL9Ch1HYCVbTsfpNucitg (button) folded before Flop (didn't bet)
Seat 6: egvg3mTBBVzMHnJPIQiKcA (small blind) folded before Flop
Seat 8: XDxyajtqmdag0QPvwcOG7Q (big blind) folded before Flop
Seat 9: bOrfviVhRBpaOfMqUc74Tw folded before Flop




PokerStars Game #59941838902:  Hold'em No Limit ($0.10/$0.25) - 2009/07/01 1:47:47 ET
Table 'P1IJQ2p3ACFySC35W1qwQw' 9-max Seat #7 is the button
Seat 1: bXpVeaSTPBFSPJmeXxO7nw ($5.50 in chips) 
Seat 2: vO3QVRovWemcGMkm7ijAIA ($3.60 in chips) 
Seat 3: PVxvfRTRvkgZf9WtquEkwQ ($28 in chips) 
Seat 4: c/9X4zftzphFxYtxp5kp9w ($27.55 in chips) 
Seat 5: ghNKXUBl/H+t83JF079ZBA ($56.45 in chips) 
Seat 6: ljemhp25Zg+nlA9DLCIiUw ($64.10 in chips) 
Seat 7: 7je+LC5Mfs6nL8YBVh4frQ ($5.10 in chips) 
Seat 8: tLcDklc2rBORNfixyRfVfw ($26.35 in chips) 
tLcDklc2rBORNfixyRfVfw: posts small blind $0.10
bXpVeaSTPBFSPJmeXxO7nw: posts big blind $0.25
*** HOLE CARDS ***
GeMoapCKDLc4ajT0Uk9ZQw joins the table at seat #9 
vO3QVRovWemcGMkm7ijAIA: folds 
PVxvfRTRvkgZf9WtquEkwQ: folds 
c/9X4zftzphFxYtxp5kp9w: folds 
ghNKXUBl/H+t83JF079ZBA: folds 
ljemhp25Zg+nlA9DLCIiUw: raises $0.50 to $0.75
7je+LC5Mfs6nL8YBVh4frQ: folds 
tLcDklc2rBORNfixyRfVfw: folds 
bXpVeaSTPBFSPJmeXxO7nw: folds 
Uncalled bet ($0.50) returned to ljemhp25Zg+nlA9DLCIiUw
ljemhp25Zg+nlA9DLCIiUw collected $0.60 from pot
ljemhp25Zg+nlA9DLCIiUw: doesn't show hand 
*** SUMMARY ***
Total pot $0.60 | Rake $0 
Seat 1: bXpVeaSTPBFSPJmeXxO7nw (big blind) folded before Flop
Seat 2: vO3QVRovWemcGMkm7ijAIA folded before Flop (didn't bet)
Seat 3: PVxvfRTRvkgZf9WtquEkwQ folded before Flop (didn't bet)
Seat 4: c/9X4zftzphFxYtxp5kp9w folded before Flop (didn't bet)
Seat 5: ghNKXUBl/H+t83JF079ZBA folded before Flop (didn't bet)
Seat 6: ljemhp25Zg+nlA9DLCIiUw collected ($0.60)
Seat 7: 7je+LC5Mfs6nL8YBVh4frQ (button) folded before Flop (didn't bet)
Seat 8: tLcDklc2rBORNfixyRfVfw (small blind) folded before Flop




PokerStars Game #59941839010:  Hold'em No Limit ($0.10/$0.25) - 2009/07/01 1:47:47 ET
Table 'zhqgUUprOJ14VxKxPHcT/Q' 9-max Seat #4 is the button
Seat 1: 22dIObOuor/A+IKWkNoAlA ($5.50 in chips) 
Seat 2: GY095KWhBevJ1Ttvl8WseA ($14.25 in chips) 
Seat 3: 4XHsdGnQ76EBdBvsrSs8bA ($20.55 in chips) 
Seat 4: wGigCmBR/9XWkPpvYos3aQ ($33.45 in chips) 
Seat 5: +sbyWwIcFp9kP0bDtMegfQ ($33.35 in chips) 
Seat 6: PdIasPkzm2sqZnN41ZRXOg ($5 in chips) 
Seat 7: sGFnnRCa1YAHAUmWgsW6Qg ($11 in chips) 
Seat 8: EQXHDnIzAsORnIXRNtXRlA ($29.50 in chips) 
Seat 9: 4awUyiDYTgylQKXZ9faBVA ($25 in chips) 
+sbyWwIcFp9kP0bDtMegfQ: posts small blind $0.10
PdIasPkzm2sqZnN41ZRXOg: posts big blind $0.25
*** HOLE CARDS ***
sGFnnRCa1YAHAUmWgsW6Qg: folds 
EQXHDnIzAsORnIXRNtXRlA: folds 
4awUyiDYTgylQKXZ9faBVA: folds 
22dIObOuor/A+IKWkNoAlA: raises $0.75 to $1
GY095KWhBevJ1Ttvl8WseA: folds 
4XHsdGnQ76EBdBvsrSs8bA: folds 
wGigCmBR/9XWkPpvYos3aQ: folds 
+sbyWwIcFp9kP0bDtMegfQ: folds 
PdIasPkzm2sqZnN41ZRXOg: folds 
Uncalled bet ($0.75) returned to 22dIObOuor/A+IKWkNoAlA
22dIObOuor/A+IKWkNoAlA collected $0.60 from pot
22dIObOuor/A+IKWkNoAlA: doesn't show hand 
*** SUMMARY ***
Total pot $0.60 | Rake $0 
Seat 1: 22dIObOuor/A+IKWkNoAlA collected ($0.60)
Seat 2: GY095KWhBevJ1Ttvl8WseA folded before Flop (didn't bet)
Seat 3: 4XHsdGnQ76EBdBvsrSs8bA folded before Flop (didn't bet)
Seat 4: wGigCmBR/9XWkPpvYos3aQ (button) folded before Flop (didn't bet)
Seat 5: +sbyWwIcFp9kP0bDtMegfQ (small blind) folded before Flop
Seat 6: PdIasPkzm2sqZnN41ZRXOg (big blind) folded before Flop
Seat 7: sGFnnRCa1YAHAUmWgsW6Qg folded before Flop (didn't bet)
Seat 8: EQXHDnIzAsORnIXRNtXRlA folded before Flop (didn't bet)
Seat 9: 4awUyiDYTgylQKXZ9faBVA folded before Flop (didn't bet)




PokerStars Game #59941839664:  Hold'em No Limit ($0.10/$0.25) - 2009/07/01 1:47:48 ET
Table 'jxoHy9yJy0bbH/Qx73FoPA' 9-max Seat #1 is the button
Seat 1: j4q3p0lesp63b1gZDwLBZw ($6.60 in chips) 
Seat 2: F7pnn6czNpHvRM55XcA2EA ($45.25 in chips) 
Seat 3: CVqCt93Mk0MhKMaZ4LZDSQ ($9.30 in chips) 
Seat 5: rzZ3wFcwoPyKlQ0mB5JLRQ ($7.75 in chips) 
Seat 6: tYsOBqdU1+x+yFI7zHO7hQ ($62.55 in chips) 
Seat 7: wGigCmBR/9XWkPpvYos3aQ ($26.40 in chips) 
Seat 8: Z9W7+g1WMhhZDi7DwGbCFA ($5 in chips) 
Seat 9: CvL9Ch1HYCVbTsfpNucitg ($4.55 in chips) 
F7pnn6czNpHvRM55XcA2EA: posts small blind $0.10
CVqCt93Mk0MhKMaZ4LZDSQ: posts big blind $0.25
bXpVeaSTPBFSPJmeXxO7nw: sits out 
*** HOLE CARDS ***
rzZ3wFcwoPyKlQ0mB5JLRQ: folds 
tYsOBqdU1+x+yFI7zHO7hQ: folds 
wGigCmBR/9XWkPpvYos3aQ: folds 
Z9W7+g1WMhhZDi7DwGbCFA: folds 
CvL9Ch1HYCVbTsfpNucitg: folds 
j4q3p0lesp63b1gZDwLBZw: folds 
F7pnn6czNpHvRM55XcA2EA: raises $0.50 to $0.75
CVqCt93Mk0MhKMaZ4LZDSQ: folds 
Uncalled bet ($0.50) returned to F7pnn6czNpHvRM55XcA2EA
F7pnn6czNpHvRM55XcA2EA collected $0.50 from pot
F7pnn6czNpHvRM55XcA2EA: doesn't show hand 
*** SUMMARY ***
Total pot $0.50 | Rake $0 
Seat 1: j4q3p0lesp63b1gZDwLBZw (button) folded before Flop (didn't bet)
Seat 2: F7pnn6czNpHvRM55XcA2EA (small blind) collected ($0.50)
Seat 3: CVqCt93Mk0MhKMaZ4LZDSQ (big blind) folded before Flop
Seat 5: rzZ3wFcwoPyKlQ0mB5JLRQ folded before Flop (didn't bet)
Seat 6: tYsOBqdU1+x+yFI7zHO7hQ folded before Flop (didn't bet)
Seat 7: wGigCmBR/9XWkPpvYos3aQ folded before Flop (didn't bet)
Seat 8: Z9W7+g1WMhhZDi7DwGbCFA folded before Flop (didn't bet)
Seat 9: CvL9Ch1HYCVbTsfpNucitg folded before Flop (didn't bet)




PokerStars Game #59941839856:  Hold'em No Limit ($0.10/$0.25) - 2009/07/01 1:47:48 ET
Table '9iHhO6FyZVM8XpSc23TIgg' 6-max Seat #4 is the button
Seat 1: NhUN/JpAprdJeamFBgJH1w ($37.30 in chips) 
Seat 2: bJFzs6QmEEnz4miMfSDtcg ($34.25 in chips) 
Seat 3: TSmua8tGK3sTbwi0ynrW9Q ($25.25 in chips) 
Seat 4: cfJccEfyn6IkquPN08hFsA ($24.35 in chips) 
Seat 5: OMGl+YMGogf2JWIRfT2/Yg ($10.25 in chips) 
Seat 6: iyZxqznXjv3vtvOJymkoLQ ($34.20 in chips) 
OMGl+YMGogf2JWIRfT2/Yg: posts small blind $0.10
iyZxqznXjv3vtvOJymkoLQ: posts big blind $0.25
*** HOLE CARDS ***
NhUN/JpAprdJeamFBgJH1w: folds 
bJFzs6QmEEnz4miMfSDtcg: calls $0.25
OMGl+YMGogf2JWIRfT2/Yg said, "ey"
TSmua8tGK3sTbwi0ynrW9Q: folds 
cfJccEfyn6IkquPN08hFsA: folds 
OMGl+YMGogf2JWIRfT2/Yg: calls $0.15
iyZxqznXjv3vtvOJymkoLQ: checks 
*** FLOP *** [8d Qh Kd]
OMGl+YMGogf2JWIRfT2/Yg: checks 
iyZxqznXjv3vtvOJymkoLQ: checks 
bJFzs6QmEEnz4miMfSDtcg: bets $0.75
OMGl+YMGogf2JWIRfT2/Yg said, "donkey....say it right"
OMGl+YMGogf2JWIRfT2/Yg: folds 
iyZxqznXjv3vtvOJymkoLQ: folds 
Uncalled bet ($0.75) returned to bJFzs6QmEEnz4miMfSDtcg
bJFzs6QmEEnz4miMfSDtcg collected $0.75 from pot
*** SUMMARY ***
Total pot $0.75 | Rake $0 
Board [8d Qh Kd]
Seat 1: NhUN/JpAprdJeamFBgJH1w folded before Flop (didn't bet)
Seat 2: bJFzs6QmEEnz4miMfSDtcg collected ($0.75)
Seat 3: TSmua8tGK3sTbwi0ynrW9Q folded before Flop (didn't bet)
Seat 4: cfJccEfyn6IkquPN08hFsA (button) folded before Flop (didn't bet)
Seat 5: OMGl+YMGogf2JWIRfT2/Yg (small blind) folded on the Flop
Seat 6: iyZxqznXjv3vtvOJymkoLQ (big blind) folded on the Flop




PokerStars Game #59941839456:  Hold'em No Limit ($0.10/$0.25) - 2009/07/01 1:47:48 ET
Table 'WY+lMaAoIdBZmwk27/RJCA' 6-max Seat #6 is the button
Seat 1: zHHLkD2sRljslKKeQv/ZQw ($26.70 in chips) 
Seat 2: NhUN/JpAprdJeamFBgJH1w ($26.90 in chips) 
Seat 3: QqiZLFrN8iOUT/GHw7ztOA ($26.95 in chips) 
Seat 4: 0av6tRNdi0Ui4f15L7gsVg ($25 in chips) 
Seat 5: vqWjZmdQu/Hxw96/IJTWdQ ($27.60 in chips) 
Seat 6: cWc85bEzdRzpUMhRKm8pwQ ($25.75 in chips) 
zHHLkD2sRljslKKeQv/ZQw: posts small blind $0.10
NhUN/JpAprdJeamFBgJH1w: posts big blind $0.25
*** HOLE CARDS ***
QqiZLFrN8iOUT/GHw7ztOA: folds 
0av6tRNdi0Ui4f15L7gsVg: folds 
vqWjZmdQu/Hxw96/IJTWdQ: raises $0.75 to $1
cWc85bEzdRzpUMhRKm8pwQ: folds 
zHHLkD2sRljslKKeQv/ZQw: folds 
NhUN/JpAprdJeamFBgJH1w: folds 
Uncalled bet ($0.75) returned to vqWjZmdQu/Hxw96/IJTWdQ
vqWjZmdQu/Hxw96/IJTWdQ collected $0.60 from pot
vqWjZmdQu/Hxw96/IJTWdQ: doesn't show hand 
*** SUMMARY ***
Total pot $0.60 | Rake $0 
Seat 1: zHHLkD2sRljslKKeQv/ZQw (small blind) folded before Flop
Seat 2: NhUN/JpAprdJeamFBgJH1w (big blind) folded before Flop
Seat 3: QqiZLFrN8iOUT/GHw7ztOA folded before Flop (didn't bet)
Seat 4: 0av6tRNdi0Ui4f15L7gsVg folded before Flop (didn't bet)
Seat 5: vqWjZmdQu/Hxw96/IJTWdQ collected ($0.60)
Seat 6: cWc85bEzdRzpUMhRKm8pwQ (button) folded before Flop (didn't bet)




PokerStars Game #59941840026:  Hold'em No Limit ($0.10/$0.25) - 2009/07/01 1:47:49 ET
Table 'KU/HrxqxwDz8HKEhYTZ6uw' 6-max Seat #4 is the button
Seat 1: 7LKoiQHXpTQXJvWQrw907g ($38.05 in chips) 
Seat 2: kG34n23qFQA3nzdOJTQ1dA ($24.65 in chips) 
Seat 3: SFmT9ZsVopnukjvAzrxTRg ($25.60 in chips) 
Seat 4: AGwMM0FUhYZf81+oXvYQMg ($26.60 in chips) 
Seat 5: iyZxqznXjv3vtvOJymkoLQ ($50.65 in chips) 
Seat 6: qWxkCeqApAWdAA0evrfDvQ ($11.25 in chips) 
iyZxqznXjv3vtvOJymkoLQ: posts small blind $0.10
qWxkCeqApAWdAA0evrfDvQ: posts big blind $0.25
*** HOLE CARDS ***
7LKoiQHXpTQXJvWQrw907g: calls $0.25
kG34n23qFQA3nzdOJTQ1dA: folds 
SFmT9ZsVopnukjvAzrxTRg: folds 
AGwMM0FUhYZf81+oXvYQMg: folds 
iyZxqznXjv3vtvOJymkoLQ: folds 
qWxkCeqApAWdAA0evrfDvQ: raises $0.25 to $0.50
7LKoiQHXpTQXJvWQrw907g: calls $0.25
*** FLOP *** [9c 8d 2c]
qWxkCeqApAWdAA0evrfDvQ: checks 
7LKoiQHXpTQXJvWQrw907g: bets $0.75
qWxkCeqApAWdAA0evrfDvQ: calls $0.75
*** TURN *** [9c 8d 2c] [Ad]
qWxkCeqApAWdAA0evrfDvQ: checks 
7LKoiQHXpTQXJvWQrw907g: checks 
*** RIVER *** [9c 8d 2c Ad] [4s]
qWxkCeqApAWdAA0evrfDvQ: bets $0.75
7LKoiQHXpTQXJvWQrw907g: folds 
Uncalled bet ($0.75) returned to qWxkCeqApAWdAA0evrfDvQ
qWxkCeqApAWdAA0evrfDvQ collected $2.50 from pot
AGwMM0FUhYZf81+oXvYQMg is sitting out
*** SUMMARY ***
Total pot $2.60 | Rake $0.10 
Board [9c 8d 2c Ad 4s]
Seat 1: 7LKoiQHXpTQXJvWQrw907g folded on the River
Seat 2: kG34n23qFQA3nzdOJTQ1dA folded before Flop (didn't bet)
Seat 3: SFmT9ZsVopnukjvAzrxTRg folded before Flop (didn't bet)
Seat 4: AGwMM0FUhYZf81+oXvYQMg (button) folded before Flop (didn't bet)
Seat 5: iyZxqznXjv3vtvOJymkoLQ (small blind) folded before Flop
Seat 6: qWxkCeqApAWdAA0evrfDvQ (big blind) collected ($2.50)




PokerStars Game #59941840104:  Hold'em No Limit ($0.10/$0.25) - 2009/07/01 1:47:49 ET
Table 'nB7Q7zfNfy6ig6DB+rsgWQ' 6-max Seat #1 is the button
Seat 1: Hzy03WtPHMYwLYM7hTTxQw ($23.25 in chips) 
Seat 2: 4BHo0wlX9INjkj2727qE0w ($24.70 in chips) 
Seat 3: p3NYOxYhkL7txPRSeXHDeg ($32.60 in chips) 
Seat 4: DihMHaz4WNETH1bPDe13kA ($80.10 in chips) 
Seat 5: xC0kaiDYM6YTlgODL83O5A ($15.40 in chips) 
Seat 6: MEGIwX0eHRUj63lwYaNhVg ($7.95 in chips) 
4BHo0wlX9INjkj2727qE0w: posts small blind $0.10
p3NYOxYhkL7txPRSeXHDeg: posts big blind $0.25
*** HOLE CARDS ***
DihMHaz4WNETH1bPDe13kA: folds 
xC0kaiDYM6YTlgODL83O5A: calls $0.25
MEGIwX0eHRUj63lwYaNhVg: folds 
Hzy03WtPHMYwLYM7hTTxQw: raises $0.75 to $1
4BHo0wlX9INjkj2727qE0w: folds 
p3NYOxYhkL7txPRSeXHDeg: folds 
xC0kaiDYM6YTlgODL83O5A: calls $0.75
*** FLOP *** [Ah Kh As]
xC0kaiDYM6YTlgODL83O5A: bets $0.75
Hzy03WtPHMYwLYM7hTTxQw: folds 
Uncalled bet ($0.75) returned to xC0kaiDYM6YTlgODL83O5A
xC0kaiDYM6YTlgODL83O5A collected $2.25 from pot
*** SUMMARY ***
Total pot $2.35 | Rake $0.10 
Board [Ah Kh As]
Seat 1: Hzy03WtPHMYwLYM7hTTxQw (button) folded on the Flop
Seat 2: 4BHo0wlX9INjkj2727qE0w (small blind) folded before Flop
Seat 3: p3NYOxYhkL7txPRSeXHDeg (big blind) folded before Flop
Seat 4: DihMHaz4WNETH1bPDe13kA folded before Flop (didn't bet)
Seat 5: xC0kaiDYM6YTlgODL83O5A collected ($2.25)
Seat 6: MEGIwX0eHRUj63lwYaNhVg folded before Flop (didn't bet)




PokerStars Game #59941840402:  Hold'em No Limit ($0.10/$0.25) - 2009/07/01 1:47:49 ET
Table 'luMgmRPIo47e7iXDlheIwA' 6-max Seat #1 is the button
Seat 1: EQ3WxdGe/KZrM6Lx4T02sg ($37.20 in chips) 
Seat 2: NhUN/JpAprdJeamFBgJH1w ($25 in chips) 
Seat 3: w43JQj2oYPpKQVG4Yzlq1w ($25 in chips) 
Seat 4: xrf8tAXKQHG99HixCot1Iw ($26.25 in chips) 
Seat 5: cWc85bEzdRzpUMhRKm8pwQ ($45.25 in chips) 
Seat 6: qGHGf/553gQnDoklMRe3tg ($24.55 in chips) 
NhUN/JpAprdJeamFBgJH1w: posts small blind $0.10
w43JQj2oYPpKQVG4Yzlq1w: posts big blind $0.25
*** HOLE CARDS ***
xrf8tAXKQHG99HixCot1Iw: folds 
cWc85bEzdRzpUMhRKm8pwQ: folds 
qGHGf/553gQnDoklMRe3tg: folds 
EQ3WxdGe/KZrM6Lx4T02sg: calls $0.25
NhUN/JpAprdJeamFBgJH1w: folds 
w43JQj2oYPpKQVG4Yzlq1w: checks 
*** FLOP *** [9d Ac 6s]
w43JQj2oYPpKQVG4Yzlq1w: checks 
EQ3WxdGe/KZrM6Lx4T02sg: bets $0.25
w43JQj2oYPpKQVG4Yzlq1w: folds 
Uncalled bet ($0.25) returned to EQ3WxdGe/KZrM6Lx4T02sg
EQ3WxdGe/KZrM6Lx4T02sg collected $0.60 from pot
*** SUMMARY ***
Total pot $0.60 | Rake $0 
Board [9d Ac 6s]
Seat 1: EQ3WxdGe/KZrM6Lx4T02sg (button) collected ($0.60)
Seat 2: NhUN/JpAprdJeamFBgJH1w (small blind) folded before Flop
Seat 3: w43JQj2oYPpKQVG4Yzlq1w (big blind) folded on the Flop
Seat 4: xrf8tAXKQHG99HixCot1Iw folded before Flop (didn't bet)
Seat 5: cWc85bEzdRzpUMhRKm8pwQ folded before Flop (didn't bet)
Seat 6: qGHGf/553gQnDoklMRe3tg folded before Flop (didn't bet)




PokerStars Game #59941839976:  Hold'em No Limit ($0.10/$0.25) - 2009/07/01 1:47:49 ET
Table '84TjTrgbsYZladOc4PWf4Q' 6-max Seat #5 is the button
Seat 1: /kW0t5kKllzd8HO2uEapHQ ($19.45 in chips) 
Seat 2: RpaEX9P7BCvyfPRLiRNg0A ($48.35 in chips) 
Seat 3: Ar4vsUIUfJ7gbYh1c1m59g ($10.85 in chips) 
Seat 4: SxIIgwXYLkwd6m3wLyPTCw ($25 in chips) 
Seat 5: cezpHJ8FB07dj0xG+LhOvw ($27.10 in chips) 
Seat 6: wCUaomJ6Nq5zomVGdUHP+w ($15.25 in chips) 
wCUaomJ6Nq5zomVGdUHP+w: posts small blind $0.10
/kW0t5kKllzd8HO2uEapHQ: posts big blind $0.25
*** HOLE CARDS ***
RpaEX9P7BCvyfPRLiRNg0A: folds 
Ar4vsUIUfJ7gbYh1c1m59g: raises $0.75 to $1
SxIIgwXYLkwd6m3wLyPTCw: folds 
cezpHJ8FB07dj0xG+LhOvw: folds 
wCUaomJ6Nq5zomVGdUHP+w: folds 
/kW0t5kKllzd8HO2uEapHQ: folds 
Uncalled bet ($0.75) returned to Ar4vsUIUfJ7gbYh1c1m59g
Ar4vsUIUfJ7gbYh1c1m59g collected $0.60 from pot
Ar4vsUIUfJ7gbYh1c1m59g: doesn't show hand 
*** SUMMARY ***
Total pot $0.60 | Rake $0 
Seat 1: /kW0t5kKllzd8HO2uEapHQ (big blind) folded before Flop
Seat 2: RpaEX9P7BCvyfPRLiRNg0A folded before Flop (didn't bet)
Seat 3: Ar4vsUIUfJ7gbYh1c1m59g collected ($0.60)
Seat 4: SxIIgwXYLkwd6m3wLyPTCw folded before Flop (didn't bet)
Seat 5: cezpHJ8FB07dj0xG+LhOvw (button) folded before Flop (didn't bet)
Seat 6: wCUaomJ6Nq5zomVGdUHP+w (small blind) folded before Flop




PokerStars Game #59941840376:  Hold'em No Limit ($0.10/$0.25) - 2009/07/01 1:47:49 ET
Table 'mF3KHGMaTpaBZbtBoyfTeg' 6-max Seat #6 is the button
Seat 1: 0HAB2GdCAM7p7V00xueAVQ ($23.25 in chips) 
Seat 2: xrf8tAXKQHG99HixCot1Iw ($24.80 in chips) 
Seat 3: 9kUKGKkblnIx3m8rlVol6Q ($11.10 in chips) 
Seat 4: FYepjhAvF8ZdVCmqHIy+eQ ($25 in chips) 
Seat 5: 8ClCHtFXGNplITm+63KB+Q ($45.35 in chips) 
Seat 6: kG34n23qFQA3nzdOJTQ1dA ($26.80 in chips) 
0HAB2GdCAM7p7V00xueAVQ: posts small blind $0.10
xrf8tAXKQHG99HixCot1Iw: posts big blind $0.25
*** HOLE CARDS ***
9kUKGKkblnIx3m8rlVol6Q: folds 
FYepjhAvF8ZdVCmqHIy+eQ: folds 
8ClCHtFXGNplITm+63KB+Q: folds 
kG34n23qFQA3nzdOJTQ1dA: folds 
0HAB2GdCAM7p7V00xueAVQ: calls $0.15
xrf8tAXKQHG99HixCot1Iw: checks 
*** FLOP *** [Js Qd 6h]
0HAB2GdCAM7p7V00xueAVQ: checks 
xrf8tAXKQHG99HixCot1Iw: bets $0.25
0HAB2GdCAM7p7V00xueAVQ: folds 
Uncalled bet ($0.25) returned to xrf8tAXKQHG99HixCot1Iw
xrf8tAXKQHG99HixCot1Iw collected $0.50 from pot
xrf8tAXKQHG99HixCot1Iw: doesn't show hand 
*** SUMMARY ***
Total pot $0.50 | Rake $0 
Board [Js Qd 6h]
Seat 1: 0HAB2GdCAM7p7V00xueAVQ (small blind) folded on the Flop
Seat 2: xrf8tAXKQHG99HixCot1Iw (big blind) collected ($0.50)
Seat 3: 9kUKGKkblnIx3m8rlVol6Q folded before Flop (didn't bet)
Seat 4: FYepjhAvF8ZdVCmqHIy+eQ folded before Flop (didn't bet)
Seat 5: 8ClCHtFXGNplITm+63KB+Q folded before Flop (didn't bet)
Seat 6: kG34n23qFQA3nzdOJTQ1dA (button) folded before Flop (didn't bet)




PokerStars Game #59941840118:  Hold'em No Limit ($0.10/$0.25) - 2009/07/01 1:47:49 ET
Table 'LG9H161ZAHDkOww+ih3Ptg' 6-max Seat #1 is the button
Seat 1: avl8CO/tc0F6eVSiB/KNRA ($25.85 in chips) 
Seat 2: kwsRmpZ1ZaLooISs+zfyKg ($25.45 in chips) 
Seat 3: 5Evvx7UYqXTBuvIc/9s/hA ($15.20 in chips) 
Seat 4: 0C28L4/59aRNtHoBhqTcLg ($58.85 in chips) 
Seat 6: v8m8XHovI5tqEA9mvplDSw ($27.60 in chips) 
kwsRmpZ1ZaLooISs+zfyKg: posts small blind $0.10
5Evvx7UYqXTBuvIc/9s/hA: posts big blind $0.25
IDpUHu4U5YRh06nKQqhY8g: sits out 
*** HOLE CARDS ***
0C28L4/59aRNtHoBhqTcLg: folds 
v8m8XHovI5tqEA9mvplDSw: raises $0.75 to $1
avl8CO/tc0F6eVSiB/KNRA: folds 
kwsRmpZ1ZaLooISs+zfyKg: calls $0.90
5Evvx7UYqXTBuvIc/9s/hA: folds 
*** FLOP *** [6s 8h 3s]
kwsRmpZ1ZaLooISs+zfyKg: bets $1.50
v8m8XHovI5tqEA9mvplDSw: calls $1.50
*** TURN *** [6s 8h 3s] [Ad]
kwsRmpZ1ZaLooISs+zfyKg: bets $2
v8m8XHovI5tqEA9mvplDSw: calls $2
*** RIVER *** [6s 8h 3s Ad] [7d]
kwsRmpZ1ZaLooISs+zfyKg: bets $3.10
v8m8XHovI5tqEA9mvplDSw: calls $3.10
*** SHOW DOWN ***
kwsRmpZ1ZaLooISs+zfyKg: shows [Qd Ac] (a pair of Aces)
v8m8XHovI5tqEA9mvplDSw: mucks hand 
kwsRmpZ1ZaLooISs+zfyKg collected $14.70 from pot
*** SUMMARY ***
Total pot $15.45 | Rake $0.75 
Board [6s 8h 3s Ad 7d]
Seat 1: avl8CO/tc0F6eVSiB/KNRA (button) folded before Flop (didn't bet)
Seat 2: kwsRmpZ1ZaLooISs+zfyKg (small blind) showed [Qd Ac] and won ($14.70) with a pair of Aces
Seat 3: 5Evvx7UYqXTBuvIc/9s/hA (big blind) folded before Flop
Seat 4: 0C28L4/59aRNtHoBhqTcLg folded before Flop (didn't bet)
Seat 6: v8m8XHovI5tqEA9mvplDSw mucked




PokerStars Game #59941840866:  Hold'em No Limit ($0.10/$0.25) - 2009/07/01 1:47:50 ET
Table 'FBhJjLqab11/gKu8nyB/tw' 9-max Seat #8 is the button
Seat 1: +sbyWwIcFp9kP0bDtMegfQ ($17.85 in chips) 
Seat 2: 1pwQJV/Xr0GWPRefx/78VQ ($21.75 in chips) 
Seat 3: V6p0jQ/RhUsqpHLmXvEX4Q ($9.35 in chips) 
Seat 4: CvL9Ch1HYCVbTsfpNucitg ($5.50 in chips) 
Seat 5: Mh2r9hTeTEDnh19sRZtW3g ($4.65 in chips) 
Seat 6: cZ99hugmLBj9KhTlc8nCSw ($31.35 in chips) 
Seat 7: CT7Xj/V/O5rBlhtt+RZeFQ ($25 in chips) 
Seat 8: Th3FldXKQW6hWVVPahaoOQ ($27.25 in chips) 
H5Se03ZqSX7tbULXur2MAg will be allowed to play after the button
+sbyWwIcFp9kP0bDtMegfQ: posts small blind $0.10
1pwQJV/Xr0GWPRefx/78VQ: posts big blind $0.25
*** HOLE CARDS ***
V6p0jQ/RhUsqpHLmXvEX4Q: folds 
CvL9Ch1HYCVbTsfpNucitg: folds 
Mh2r9hTeTEDnh19sRZtW3g: folds 
cZ99hugmLBj9KhTlc8nCSw: folds 
CT7Xj/V/O5rBlhtt+RZeFQ: folds 
Th3FldXKQW6hWVVPahaoOQ: folds 
+sbyWwIcFp9kP0bDtMegfQ: raises $0.25 to $0.50
1pwQJV/Xr0GWPRefx/78VQ: calls $0.25
*** FLOP *** [Ks 7d 8c]
+sbyWwIcFp9kP0bDtMegfQ: bets $1
1pwQJV/Xr0GWPRefx/78VQ: folds 
Uncalled bet ($1) returned to +sbyWwIcFp9kP0bDtMegfQ
+sbyWwIcFp9kP0bDtMegfQ collected $0.95 from pot
+sbyWwIcFp9kP0bDtMegfQ: doesn't show hand 
1pwQJV/Xr0GWPRefx/78VQ leaves the table
*** SUMMARY ***
Total pot $1 | Rake $0.05 
Board [Ks 7d 8c]
Seat 1: +sbyWwIcFp9kP0bDtMegfQ (small blind) collected ($0.95)
Seat 2: 1pwQJV/Xr0GWPRefx/78VQ (big blind) folded on the Flop
Seat 3: V6p0jQ/RhUsqpHLmXvEX4Q folded before Flop (didn't bet)
Seat 4: CvL9Ch1HYCVbTsfpNucitg folded before Flop (didn't bet)
Seat 5: Mh2r9hTeTEDnh19sRZtW3g folded before Flop (didn't bet)
Seat 6: cZ99hugmLBj9KhTlc8nCSw folded before Flop (didn't bet)
Seat 7: CT7Xj/V/O5rBlhtt+RZeFQ folded before Flop (didn't bet)
Seat 8: Th3FldXKQW6hWVVPahaoOQ (button) folded before Flop (didn't bet)




PokerStars Game #59941840690:  Hold'em No Limit ($0.10/$0.25) - 2009/07/01 1:47:50 ET
Table '3760QYRYyCWeXf0rLZ5S2g' 9-max Seat #8 is the button
Seat 1: CT7Xj/V/O5rBlhtt+RZeFQ ($27.65 in chips) 
Seat 2: zDrucyjVn5aeekNEc3cJrA ($27.45 in chips) 
Seat 3: X78b5v/uhqeXXoAijbw/yg ($25.60 in chips) 
Seat 4: ziFpkH3wCzqB/qXeq/Hy7g ($25 in chips) 
Seat 5: Bb42QRQMhg5/Y0vHP8/2Xw ($28.70 in chips) 
Seat 6: q+Qdg0Hoir+SyL7haBrUnw ($13.60 in chips) 
Seat 7: 6C2DoQ+GZHBOpb+qyrSnqA ($5.75 in chips) 
Seat 8: clJsV3v77RS07bDKY+705w ($5.25 in chips) 
CT7Xj/V/O5rBlhtt+RZeFQ: posts small blind $0.10
zDrucyjVn5aeekNEc3cJrA: posts big blind $0.25
*** HOLE CARDS ***
X78b5v/uhqeXXoAijbw/yg: folds 
ziFpkH3wCzqB/qXeq/Hy7g: folds 
BCwIzs00xY6DtWGghTGEwg joins the table at seat #9 
Bb42QRQMhg5/Y0vHP8/2Xw: folds 
q+Qdg0Hoir+SyL7haBrUnw: folds 
6C2DoQ+GZHBOpb+qyrSnqA: calls $0.25
clJsV3v77RS07bDKY+705w: folds 
CT7Xj/V/O5rBlhtt+RZeFQ: folds 
zDrucyjVn5aeekNEc3cJrA: checks 
*** FLOP *** [Jh 9s 2c]
zDrucyjVn5aeekNEc3cJrA: checks 
6C2DoQ+GZHBOpb+qyrSnqA: bets $0.25
zDrucyjVn5aeekNEc3cJrA: folds 
Uncalled bet ($0.25) returned to 6C2DoQ+GZHBOpb+qyrSnqA
6C2DoQ+GZHBOpb+qyrSnqA collected $0.60 from pot
*** SUMMARY ***
Total pot $0.60 | Rake $0 
Board [Jh 9s 2c]
Seat 1: CT7Xj/V/O5rBlhtt+RZeFQ (small blind) folded before Flop
Seat 2: zDrucyjVn5aeekNEc3cJrA (big blind) folded on the Flop
Seat 3: X78b5v/uhqeXXoAijbw/yg folded before Flop (didn't bet)
Seat 4: ziFpkH3wCzqB/qXeq/Hy7g folded before Flop (didn't bet)
Seat 5: Bb42QRQMhg5/Y0vHP8/2Xw folded before Flop (didn't bet)
Seat 6: q+Qdg0Hoir+SyL7haBrUnw folded before Flop (didn't bet)
Seat 7: 6C2DoQ+GZHBOpb+qyrSnqA collected ($0.60)
Seat 8: clJsV3v77RS07bDKY+705w (button) folded before Flop (didn't bet)




PokerStars Game #59941840700:  Hold'em No Limit ($0.10/$0.25) - 2009/07/01 1:47:50 ET
Table 'dVzscin98UhGisTmV9BDcw' 9-max Seat #1 is the button
Seat 1: sBAwXpkpgyhyWbHIQcIJKA ($16.80 in chips) 
Seat 2: dfNim92Z6XK1/h5SFW5vDg ($28.10 in chips) 
Seat 3: cZ99hugmLBj9KhTlc8nCSw ($25 in chips) 
Seat 4: aNpwfA31EREwO+ar4XzBCw ($42.25 in chips) 
Seat 6: A/OkFabqdcrG3ozpiYMiNQ ($25.50 in chips) 
Seat 7: cKlmpQMahVsmOaxFQDcoOg ($25.25 in chips) 
Seat 8: /vn2Qu2dvc9AMMq46Ae0jA ($46.75 in chips) 
Seat 9: arxNSjreDRGFg13EAM2F1w ($25 in chips) 
dfNim92Z6XK1/h5SFW5vDg: posts small blind $0.10
cZ99hugmLBj9KhTlc8nCSw: posts big blind $0.25
E0iYnEVO2ho7dH3QcCjw7g: sits out 
*** HOLE CARDS ***
aNpwfA31EREwO+ar4XzBCw: folds 
A/OkFabqdcrG3ozpiYMiNQ: folds 
cKlmpQMahVsmOaxFQDcoOg: folds 
/vn2Qu2dvc9AMMq46Ae0jA: folds 
arxNSjreDRGFg13EAM2F1w: folds 
sBAwXpkpgyhyWbHIQcIJKA: raises $0.75 to $1
dfNim92Z6XK1/h5SFW5vDg: folds 
cZ99hugmLBj9KhTlc8nCSw: folds 
Uncalled bet ($0.75) returned to sBAwXpkpgyhyWbHIQcIJKA
sBAwXpkpgyhyWbHIQcIJKA collected $0.60 from pot
sBAwXpkpgyhyWbHIQcIJKA: doesn't show hand 
*** SUMMARY ***
Total pot $0.60 | Rake $0 
Seat 1: sBAwXpkpgyhyWbHIQcIJKA (button) collected ($0.60)
Seat 2: dfNim92Z6XK1/h5SFW5vDg (small blind) folded before Flop
Seat 3: cZ99hugmLBj9KhTlc8nCSw (big blind) folded before Flop
Seat 4: aNpwfA31EREwO+ar4XzBCw folded before Flop (didn't bet)
Seat 6: A/OkFabqdcrG3ozpiYMiNQ folded before Flop (didn't bet)
Seat 7: cKlmpQMahVsmOaxFQDcoOg folded before Flop (didn't bet)
Seat 8: /vn2Qu2dvc9AMMq46Ae0jA folded before Flop (didn't bet)
Seat 9: arxNSjreDRGFg13EAM2F1w folded before Flop (didn't bet)




PokerStars Game #59941840806:  Hold'em No Limit ($0.10/$0.25) - 2009/07/01 1:47:50 ET
Table 'BabJGL6tfXQp3leBGbYe8A' 9-max Seat #5 is the button
Seat 1: qwr38jl5txoR36M7G5qi4A ($10 in chips) 
Seat 2: dtZ84flFEi4Q+SGrHMJRDQ ($40.50 in chips) 
Seat 3: sD+TKtt36XiiN6jqHiLwDA ($28.80 in chips) 
Seat 4: gehe91e0IyVT0QU/XBkEyg ($28.10 in chips) 
Seat 5: GrNTWMdwy+jC6Lred1eDng ($10 in chips) 
Seat 6: egvg3mTBBVzMHnJPIQiKcA ($13.65 in chips) 
Seat 7: eK8qa6EPcH2zhtbmWSvc9g ($27.85 in chips) 
Seat 8: OXPkK84/qv92EMwXPiG5rQ ($9.75 in chips) 
Seat 9: P+9ymZQ3ktpQu1bn7HIjew ($9.50 in chips) 
egvg3mTBBVzMHnJPIQiKcA: posts small blind $0.10
eK8qa6EPcH2zhtbmWSvc9g: posts big blind $0.25
*** HOLE CARDS ***
OXPkK84/qv92EMwXPiG5rQ: folds 
P+9ymZQ3ktpQu1bn7HIjew: folds 
qwr38jl5txoR36M7G5qi4A: raises $0.50 to $0.75
dtZ84flFEi4Q+SGrHMJRDQ: folds 
sD+TKtt36XiiN6jqHiLwDA: folds 
gehe91e0IyVT0QU/XBkEyg: folds 
GrNTWMdwy+jC6Lred1eDng: folds 
egvg3mTBBVzMHnJPIQiKcA: folds 
eK8qa6EPcH2zhtbmWSvc9g: folds 
Uncalled bet ($0.50) returned to qwr38jl5txoR36M7G5qi4A
qwr38jl5txoR36M7G5qi4A collected $0.60 from pot
*** SUMMARY ***
Total pot $0.60 | Rake $0 
Seat 1: qwr38jl5txoR36M7G5qi4A collected ($0.60)
Seat 2: dtZ84flFEi4Q+SGrHMJRDQ folded before Flop (didn't bet)
Seat 3: sD+TKtt36XiiN6jqHiLwDA folded before Flop (didn't bet)
Seat 4: gehe91e0IyVT0QU/XBkEyg folded before Flop (didn't bet)
Seat 5: GrNTWMdwy+jC6Lred1eDng (button) folded before Flop (didn't bet)
Seat 6: egvg3mTBBVzMHnJPIQiKcA (small blind) folded before Flop
Seat 7: eK8qa6EPcH2zhtbmWSvc9g (big blind) folded before Flop
Seat 8: OXPkK84/qv92EMwXPiG5rQ folded before Flop (didn't bet)
Seat 9: P+9ymZQ3ktpQu1bn7HIjew folded before Flop (didn't bet)




PokerStars Game #59941840742:  Hold'em No Limit ($0.10/$0.25) - 2009/07/01 1:47:50 ET
Table 'fRxOyfaHXkWUDLv4eSxFew' 9-max Seat #3 is the button
Seat 1: 6RiVTYll/5D8zICp0MRpKw ($29.40 in chips) 
Seat 2: M2QO2DxB5Wawg2h8HSpnYA ($10 in chips) 
Seat 3: E0iYnEVO2ho7dH3QcCjw7g ($20 in chips) 
Seat 4: MtVtHDqIJTyUcXkRBBDIVA ($27.70 in chips) 
Seat 5: dmYlc+1cjwZMJ7wV+Z0rRg ($22.75 in chips) 
Seat 6: arxNSjreDRGFg13EAM2F1w ($27.05 in chips) 
Seat 7: 1/DuWziR8CXhWB71aPQd9Q ($11.55 in chips) 
Seat 8: 5n7e7I+px7c6CQmLpPbtsg ($5.90 in chips) 
Seat 9: H5Se03ZqSX7tbULXur2MAg ($32.65 in chips) 
MtVtHDqIJTyUcXkRBBDIVA: posts small blind $0.10
dmYlc+1cjwZMJ7wV+Z0rRg: posts big blind $0.25
*** HOLE CARDS ***
arxNSjreDRGFg13EAM2F1w: folds 
1/DuWziR8CXhWB71aPQd9Q: folds 
5n7e7I+px7c6CQmLpPbtsg: folds 
H5Se03ZqSX7tbULXur2MAg: folds 
6RiVTYll/5D8zICp0MRpKw: folds 
M2QO2DxB5Wawg2h8HSpnYA: raises $0.50 to $0.75
E0iYnEVO2ho7dH3QcCjw7g: raises $1.75 to $2.50
MtVtHDqIJTyUcXkRBBDIVA: folds 
dmYlc+1cjwZMJ7wV+Z0rRg: folds 
M2QO2DxB5Wawg2h8HSpnYA: calls $1.75
*** FLOP *** [4s 7s Kd]
M2QO2DxB5Wawg2h8HSpnYA: checks 
E0iYnEVO2ho7dH3QcCjw7g: bets $3
M2QO2DxB5Wawg2h8HSpnYA: raises $4.50 to $7.50 and is all-in
E0iYnEVO2ho7dH3QcCjw7g: calls $4.50
*** TURN *** [4s 7s Kd] [5h]
*** RIVER *** [4s 7s Kd 5h] [4d]
*** SHOW DOWN ***
M2QO2DxB5Wawg2h8HSpnYA: shows [Th Td] (two pair, Tens and Fours)
E0iYnEVO2ho7dH3QcCjw7g: shows [Qd Qs] (two pair, Queens and Fours)
E0iYnEVO2ho7dH3QcCjw7g collected $19.35 from pot
*** SUMMARY ***
Total pot $20.35 | Rake $1 
Board [4s 7s Kd 5h 4d]
Seat 1: 6RiVTYll/5D8zICp0MRpKw folded before Flop (didn't bet)
Seat 2: M2QO2DxB5Wawg2h8HSpnYA showed [Th Td] and lost with two pair, Tens and Fours
Seat 3: E0iYnEVO2ho7dH3QcCjw7g (button) showed [Qd Qs] and won ($19.35) with two pair, Queens and Fours
Seat 4: MtVtHDqIJTyUcXkRBBDIVA (small blind) folded before Flop
Seat 5: dmYlc+1cjwZMJ7wV+Z0rRg (big blind) folded before Flop
Seat 6: arxNSjreDRGFg13EAM2F1w folded before Flop (didn't bet)
Seat 7: 1/DuWziR8CXhWB71aPQd9Q folded before Flop (didn't bet)
Seat 8: 5n7e7I+px7c6CQmLpPbtsg folded before Flop (didn't bet)
Seat 9: H5Se03ZqSX7tbULXur2MAg folded before Flop (didn't bet)




PokerStars Game #59941840932:  Hold'em No Limit ($0.10/$0.25) - 2009/07/01 1:47:50 ET
Table '9L7XfAwuM7XsXE8LIg2o5Q' 6-max Seat #4 is the button
Seat 1: dOIoLBxmpLHSXBN9LZnf0Q ($23.85 in chips) 
Seat 2: LJI7A1YgDM7hgh7o56+ReQ ($28.55 in chips) 
Seat 3: mFv3iBCtrw9XfCDRB0d46Q ($4.30 in chips) 
Seat 4: jp34e617tIzV8tKIWmfAbA ($38.45 in chips) 
Seat 5: zsU1ijOyYEi+40wBKPEbmw ($20.65 in chips) 
Seat 6: k9nHZTHt8hYhYRcW8NTb4g ($24.85 in chips) 
zsU1ijOyYEi+40wBKPEbmw: posts small blind $0.10
k9nHZTHt8hYhYRcW8NTb4g: posts big blind $0.25
*** HOLE CARDS ***
dOIoLBxmpLHSXBN9LZnf0Q: calls $0.25
LJI7A1YgDM7hgh7o56+ReQ: raises $1 to $1.25
mFv3iBCtrw9XfCDRB0d46Q: folds 
jp34e617tIzV8tKIWmfAbA: folds 
zsU1ijOyYEi+40wBKPEbmw: calls $1.15
k9nHZTHt8hYhYRcW8NTb4g: calls $1
dOIoLBxmpLHSXBN9LZnf0Q: raises $2.25 to $3.50
LJI7A1YgDM7hgh7o56+ReQ: folds 
zsU1ijOyYEi+40wBKPEbmw: calls $2.25
k9nHZTHt8hYhYRcW8NTb4g: calls $2.25
*** FLOP *** [Td Qh Kh]
zsU1ijOyYEi+40wBKPEbmw: bets $17.15 and is all-in
k9nHZTHt8hYhYRcW8NTb4g: folds 
dOIoLBxmpLHSXBN9LZnf0Q: calls $17.15
*** TURN *** [Td Qh Kh] [9s]
*** RIVER *** [Td Qh Kh 9s] [4h]
*** SHOW DOWN ***
zsU1ijOyYEi+40wBKPEbmw: shows [9d Jd] (a straight, Nine to King)
dOIoLBxmpLHSXBN9LZnf0Q: shows [Jc Js] (a straight, Nine to King)
zsU1ijOyYEi+40wBKPEbmw collected $21.90 from pot
dOIoLBxmpLHSXBN9LZnf0Q collected $21.90 from pot
*** SUMMARY ***
Total pot $46.05 | Rake $2.25 
Board [Td Qh Kh 9s 4h]
Seat 1: dOIoLBxmpLHSXBN9LZnf0Q showed [Jc Js] and won ($21.90) with a straight, Nine to King
Seat 2: LJI7A1YgDM7hgh7o56+ReQ folded before Flop
Seat 3: mFv3iBCtrw9XfCDRB0d46Q folded before Flop (didn't bet)
Seat 4: jp34e617tIzV8tKIWmfAbA (button) folded before Flop (didn't bet)
Seat 5: zsU1ijOyYEi+40wBKPEbmw (small blind) showed [9d Jd] and won ($21.90) with a straight, Nine to King
Seat 6: k9nHZTHt8hYhYRcW8NTb4g (big blind) folded on the Flop




PokerStars Game #59941840764:  Hold'em No Limit ($0.10/$0.25) - 2009/07/01 1:47:50 ET
Table 'dZNBGqFYSwfOVZvDJ4VjIQ' 6-max Seat #2 is the button
Seat 1: v+QfkGiuj9bgtuNoVnDO8w ($37.10 in chips) 
Seat 2: 3zD3qLXT1bEffAoWGnc7wg ($29.30 in chips) 
Seat 3: kyRaCIljYA6l33lSKQfNsg ($28.05 in chips) 
Seat 4: mFv3iBCtrw9XfCDRB0d46Q ($5.80 in chips) 
Seat 5: +ZlnqPoP3Hg4BIUxDfKd/A ($29.60 in chips) 
Seat 6: ypmjhffk/YHGc51wgVXUTw ($29.40 in chips) 
kyRaCIljYA6l33lSKQfNsg: posts small blind $0.10
mFv3iBCtrw9XfCDRB0d46Q: posts big blind $0.25
*** HOLE CARDS ***
+ZlnqPoP3Hg4BIUxDfKd/A: folds 
ypmjhffk/YHGc51wgVXUTw: folds 
v+QfkGiuj9bgtuNoVnDO8w: raises $0.75 to $1
3zD3qLXT1bEffAoWGnc7wg: calls $1
kyRaCIljYA6l33lSKQfNsg: folds 
mFv3iBCtrw9XfCDRB0d46Q: folds 
*** FLOP *** [Jd 5c Qc]
v+QfkGiuj9bgtuNoVnDO8w: bets $1.75
3zD3qLXT1bEffAoWGnc7wg: folds 
Uncalled bet ($1.75) returned to v+QfkGiuj9bgtuNoVnDO8w
v+QfkGiuj9bgtuNoVnDO8w collected $2.25 from pot
v+QfkGiuj9bgtuNoVnDO8w: doesn't show hand 
*** SUMMARY ***
Total pot $2.35 | Rake $0.10 
Board [Jd 5c Qc]
Seat 1: v+QfkGiuj9bgtuNoVnDO8w collected ($2.25)
Seat 2: 3zD3qLXT1bEffAoWGnc7wg (button) folded on the Flop
Seat 3: kyRaCIljYA6l33lSKQfNsg (small blind) folded before Flop
Seat 4: mFv3iBCtrw9XfCDRB0d46Q (big blind) folded before Flop
Seat 5: +ZlnqPoP3Hg4BIUxDfKd/A folded before Flop (didn't bet)
Seat 6: ypmjhffk/YHGc51wgVXUTw folded before Flop (didn't bet)




PokerStars Game #59941840826:  Hold'em No Limit ($0.10/$0.25) - 2009/07/01 1:47:50 ET
Table 'IRgQPZVA4+IaZZIQshgwyg' 6-max Seat #6 is the button
Seat 1: cezpHJ8FB07dj0xG+LhOvw ($27.30 in chips) 
Seat 2: lquriepNQBhDV5P1SWHhnA ($29.05 in chips) 
Seat 3: DihMHaz4WNETH1bPDe13kA ($27.80 in chips) 
Seat 4: DE9hRlt14g+JdsRQ4wT7hg ($25 in chips) 
Seat 5: w43JQj2oYPpKQVG4Yzlq1w ($25 in chips) 
Seat 6: x9/USY6PsmgUGQeluFLKDw ($21.30 in chips) 
cezpHJ8FB07dj0xG+LhOvw: posts small blind $0.10
lquriepNQBhDV5P1SWHhnA: posts big blind $0.25
w43JQj2oYPpKQVG4Yzlq1w: posts big blind $0.25
*** HOLE CARDS ***
DihMHaz4WNETH1bPDe13kA: folds 
DE9hRlt14g+JdsRQ4wT7hg: raises $1 to $1.25
w43JQj2oYPpKQVG4Yzlq1w: folds 
x9/USY6PsmgUGQeluFLKDw: folds 
cezpHJ8FB07dj0xG+LhOvw: folds 
lquriepNQBhDV5P1SWHhnA: folds 
Uncalled bet ($1) returned to DE9hRlt14g+JdsRQ4wT7hg
DE9hRlt14g+JdsRQ4wT7hg collected $0.85 from pot
DE9hRlt14g+JdsRQ4wT7hg: doesn't show hand 
*** SUMMARY ***
Total pot $0.85 | Rake $0 
Seat 1: cezpHJ8FB07dj0xG+LhOvw (small blind) folded before Flop
Seat 2: lquriepNQBhDV5P1SWHhnA (big blind) folded before Flop
Seat 3: DihMHaz4WNETH1bPDe13kA folded before Flop (didn't bet)
Seat 4: DE9hRlt14g+JdsRQ4wT7hg collected ($0.85)
Seat 5: w43JQj2oYPpKQVG4Yzlq1w folded before Flop
Seat 6: x9/USY6PsmgUGQeluFLKDw (button) folded before Flop (didn't bet)




PokerStars Game #59941840850:  Hold'em No Limit ($0.10/$0.25) - 2009/07/01 1:47:50 ET
Table 'Ok3oDLIsTc2+KxPcI0bAOA' 6-max Seat #1 is the button
Seat 1: agQm3ugZ3qSVYNgNu1ddeA ($39.15 in chips) 
Seat 2: wPSNSp4HYtytRMXTu3oPSQ ($28.65 in chips) 
Seat 3: lquriepNQBhDV5P1SWHhnA ($36.45 in chips) 
Seat 4: LJI7A1YgDM7hgh7o56+ReQ ($34.05 in chips) 
Seat 5: DFi/Lzkjsfv8QswS80JX9Q ($30.10 in chips) 
Seat 6: Hsvkc0/G2VV78oVmWYXecw ($5.80 in chips) 
wPSNSp4HYtytRMXTu3oPSQ: posts small blind $0.10
lquriepNQBhDV5P1SWHhnA: posts big blind $0.25
*** HOLE CARDS ***
LJI7A1YgDM7hgh7o56+ReQ: folds 
DFi/Lzkjsfv8QswS80JX9Q: folds 
Hsvkc0/G2VV78oVmWYXecw: folds 
agQm3ugZ3qSVYNgNu1ddeA: raises $0.50 to $0.75
wPSNSp4HYtytRMXTu3oPSQ: calls $0.65
lquriepNQBhDV5P1SWHhnA: folds 
*** FLOP *** [6s Jd Jh]
wPSNSp4HYtytRMXTu3oPSQ: checks 
agQm3ugZ3qSVYNgNu1ddeA: bets $1.50
wPSNSp4HYtytRMXTu3oPSQ: folds 
Uncalled bet ($1.50) returned to agQm3ugZ3qSVYNgNu1ddeA
agQm3ugZ3qSVYNgNu1ddeA collected $1.70 from pot
agQm3ugZ3qSVYNgNu1ddeA: doesn't show hand 
*** SUMMARY ***
Total pot $1.75 | Rake $0.05 
Board [6s Jd Jh]
Seat 1: agQm3ugZ3qSVYNgNu1ddeA (button) collected ($1.70)
Seat 2: wPSNSp4HYtytRMXTu3oPSQ (small blind) folded on the Flop
Seat 3: lquriepNQBhDV5P1SWHhnA (big blind) folded before Flop
Seat 4: LJI7A1YgDM7hgh7o56+ReQ folded before Flop (didn't bet)
Seat 5: DFi/Lzkjsfv8QswS80JX9Q folded before Flop (didn't bet)
Seat 6: Hsvkc0/G2VV78oVmWYXecw folded before Flop (didn't bet)




PokerStars Game #59941840706:  Hold'em No Limit ($0.10/$0.25) - 2009/07/01 1:47:50 ET
Table 'MRfAiS/4JSfnUDlCcZo0wAhfHe8uKeSJMyWAjSdM7ROQx Seat #3 is the button
Seat 1: 48oT5xFI+5CHUJlfoGrE4w ($30.15 in chips) 
Seat 2: /gJNBeCkWL4o85/jvlZ4BA ($28.85 in chips) 
Seat 3: FYepjhAvF8ZdVCmqHIy+eQ ($38.85 in chips) 
Seat 4: b4wRQV3APH8irVk6bUFe2Q ($36.70 in chips) 
Seat 5: Q1uciOZPBR/WkAlqa6cL4A ($25 in chips) 
Seat 6: df01R5ThvHspD8FgKmaDvQ ($25.35 in chips) 
b4wRQV3APH8irVk6bUFe2Q: posts small blind $0.10
Q1uciOZPBR/WkAlqa6cL4A: posts big blind $0.25
*** HOLE CARDS ***
df01R5ThvHspD8FgKmaDvQ: folds 
48oT5xFI+5CHUJlfoGrE4w: calls $0.25
/gJNBeCkWL4o85/jvlZ4BA: folds 
FYepjhAvF8ZdVCmqHIy+eQ: folds 
b4wRQV3APH8irVk6bUFe2Q: folds 
Q1uciOZPBR/WkAlqa6cL4A: checks 
*** FLOP *** [Js 8d 4h]
Q1uciOZPBR/WkAlqa6cL4A: checks 
48oT5xFI+5CHUJlfoGrE4w: checks 
*** TURN *** [Js 8d 4h] [4d]
Q1uciOZPBR/WkAlqa6cL4A: checks 
48oT5xFI+5CHUJlfoGrE4w: checks 
*** RIVER *** [Js 8d 4h 4d] [Jd]
Q1uciOZPBR/WkAlqa6cL4A: checks 
48oT5xFI+5CHUJlfoGrE4w: checks 
*** SHOW DOWN ***
Q1uciOZPBR/WkAlqa6cL4A: shows [Ah 6d] (two pair, Jacks and Fours)
48oT5xFI+5CHUJlfoGrE4w: mucks hand 
Q1uciOZPBR/WkAlqa6cL4A collected $0.60 from pot
*** SUMMARY ***
Total pot $0.60 | Rake $0 
Board [Js 8d 4h 4d Jd]
Seat 1: 48oT5xFI+5CHUJlfoGrE4w mucked
Seat 2: /gJNBeCkWL4o85/jvlZ4BA folded before Flop (didn't bet)
Seat 3: FYepjhAvF8ZdVCmqHIy+eQ (button) folded before Flop (didn't bet)
Seat 4: b4wRQV3APH8irVk6bUFe2Q (small blind) folded before Flop
Seat 5: Q1uciOZPBR/WkAlqa6cL4A (big blind) showed [Ah 6d] and won ($0.60) with two pair, Jacks and Fours
Seat 6: df01R5ThvHspD8FgKmaDvQ folded before Flop (didn't bet)




PokerStars Game #59941841122:  Hold'em No Limit ($0.10/$0.25) - 2009/07/01 1:47:51 ET
Table '5SUMWYuPsGiOD0FY0QbgOw' 6-max Seat #2 is the button
Seat 1: SFmT9ZsVopnukjvAzrxTRg ($25 in chips) 
Seat 2: xrf8tAXKQHG99HixCot1Iw ($38.50 in chips) 
Seat 3: MqMK8OWPSY1V4stf1Hy5Jw ($38.80 in chips) 
Seat 4: BV+K0Phf5VBHr7aZPKqbUQ ($25 in chips) 
Seat 5: v+QfkGiuj9bgtuNoVnDO8w ($40.80 in chips) 
Seat 6: jA7YMtfNUnAaebB7Lj74EA ($24.80 in chips) 
MqMK8OWPSY1V4stf1Hy5Jw: posts small blind $0.10
BV+K0Phf5VBHr7aZPKqbUQ: posts big blind $0.25
*** HOLE CARDS ***
v+QfkGiuj9bgtuNoVnDO8w: folds 
jA7YMtfNUnAaebB7Lj74EA: calls $0.25
SFmT9ZsVopnukjvAzrxTRg: folds 
xrf8tAXKQHG99HixCot1Iw: raises $0.75 to $1
MqMK8OWPSY1V4stf1Hy5Jw: folds 
BV+K0Phf5VBHr7aZPKqbUQ: folds 
jA7YMtfNUnAaebB7Lj74EA: calls $0.75
*** FLOP *** [6s 2d Ac]
jA7YMtfNUnAaebB7Lj74EA: checks 
xrf8tAXKQHG99HixCot1Iw: bets $1.25
jA7YMtfNUnAaebB7Lj74EA: folds 
Uncalled bet ($1.25) returned to xrf8tAXKQHG99HixCot1Iw
xrf8tAXKQHG99HixCot1Iw collected $2.25 from pot
xrf8tAXKQHG99HixCot1Iw: doesn't show hand 
*** SUMMARY ***
Total pot $2.35 | Rake $0.10 
Board [6s 2d Ac]
Seat 1: SFmT9ZsVopnukjvAzrxTRg folded before Flop (didn't bet)
Seat 2: xrf8tAXKQHG99HixCot1Iw (button) collected ($2.25)
Seat 3: MqMK8OWPSY1V4stf1Hy5Jw (small blind) folded before Flop
Seat 4: BV+K0Phf5VBHr7aZPKqbUQ (big blind) folded before Flop
Seat 5: v+QfkGiuj9bgtuNoVnDO8w folded before Flop (didn't bet)
Seat 6: jA7YMtfNUnAaebB7Lj74EA folded on the Flop




PokerStars Game #59941841188:  Hold'em No Limit ($0.10/$0.25) - 2009/07/01 1:47:51 ET
Table 'oZuNsbNJuUyQLGKzQ/4JFg' 6-max Seat #3 is the button
Seat 1: vqWjZmdQu/Hxw96/IJTWdQ ($25 in chips) 
Seat 2: UA5OsKS3VPaxa7uC8La/kA ($35.40 in chips) 
Seat 3: 8ClCHtFXGNplITm+63KB+Q ($50.65 in chips) 
Seat 4: 9bpVv1/Qh9IYtXuCtl5VtQ ($25.55 in chips) 
Seat 5: oBUDUfeUyCbZBsjxHZgSiw ($26.60 in chips) 
Seat 6: fwg6dK1+r4jy/y+JqenYYQ ($13.80 in chips) 
9bpVv1/Qh9IYtXuCtl5VtQ: posts small blind $0.10
oBUDUfeUyCbZBsjxHZgSiw: posts big blind $0.25
*** HOLE CARDS ***
fwg6dK1+r4jy/y+JqenYYQ: folds 
vqWjZmdQu/Hxw96/IJTWdQ: folds 
UA5OsKS3VPaxa7uC8La/kA: folds 
8ClCHtFXGNplITm+63KB+Q: folds 
9bpVv1/Qh9IYtXuCtl5VtQ: folds 
Uncalled bet ($0.15) returned to oBUDUfeUyCbZBsjxHZgSiw
oBUDUfeUyCbZBsjxHZgSiw collected $0.20 from pot
*** SUMMARY ***
Total pot $0.20 | Rake $0 
Seat 1: vqWjZmdQu/Hxw96/IJTWdQ folded before Flop (didn't bet)
Seat 2: UA5OsKS3VPaxa7uC8La/kA folded before Flop (didn't bet)
Seat 3: 8ClCHtFXGNplITm+63KB+Q (button) folded before Flop (didn't bet)
Seat 4: 9bpVv1/Qh9IYtXuCtl5VtQ (small blind) folded before Flop
Seat 5: oBUDUfeUyCbZBsjxHZgSiw (big blind) collected ($0.20)
Seat 6: fwg6dK1+r4jy/y+JqenYYQ folded before Flop (didn't bet)




PokerStars Game #59941841030:  Hold'em No Limit ($0.10/$0.25) - 2009/07/01 1:47:51 ET
Table 'R5qKG21jwFDYRcOht9qwqQ' 9-max Seat #7 is the button
Seat 1: N5sUK8M0br9djLrW97V9pQ ($25 in chips) 
Seat 2: N6foVRyErHqcNmshkqextQ ($13.80 in chips) 
Seat 3: M2QO2DxB5Wawg2h8HSpnYA ($10 in chips) 
Seat 5: zUXhymECc2C9W9ZNw6qppA ($8.55 in chips) 
Seat 6: EP17SQz/iWcuYdNOGeBgkw ($15.90 in chips) 
Seat 7: zgi+EUykT/pZQpoUG6+oEg ($4.65 in chips) 
Seat 9: MG90wfSJZnOejs/KD3vlQQ ($37.60 in chips) 
tYsOBqdU1+x+yFI7zHO7hQ: is sitting out 
MG90wfSJZnOejs/KD3vlQQ: posts small blind $0.10
N5sUK8M0br9djLrW97V9pQ: posts big blind $0.25
*** HOLE CARDS ***
tYsOBqdU1+x+yFI7zHO7hQ leaves the table
N6foVRyErHqcNmshkqextQ: folds 
M2QO2DxB5Wawg2h8HSpnYA: folds 
zUXhymECc2C9W9ZNw6qppA: folds 
EP17SQz/iWcuYdNOGeBgkw: folds 
zgi+EUykT/pZQpoUG6+oEg: folds 
MG90wfSJZnOejs/KD3vlQQ: raises $0.50 to $0.75
N5sUK8M0br9djLrW97V9pQ: calls $0.50
*** FLOP *** [5h 8c Ac]
hYvTc4PYNrAaNAIVoM94Hw joins the table at seat #8 
MG90wfSJZnOejs/KD3vlQQ: bets $1.20
N5sUK8M0br9djLrW97V9pQ: folds 
Uncalled bet ($1.20) returned to MG90wfSJZnOejs/KD3vlQQ
MG90wfSJZnOejs/KD3vlQQ collected $1.45 from pot
MG90wfSJZnOejs/KD3vlQQ: doesn't show hand 
*** SUMMARY ***
Total pot $1.50 | Rake $0.05 
Board [5h 8c Ac]
Seat 1: N5sUK8M0br9djLrW97V9pQ (big blind) folded on the Flop
Seat 2: N6foVRyErHqcNmshkqextQ folded before Flop (didn't bet)
Seat 3: M2QO2DxB5Wawg2h8HSpnYA folded before Flop (didn't bet)
Seat 5: zUXhymECc2C9W9ZNw6qppA folded before Flop (didn't bet)
Seat 6: EP17SQz/iWcuYdNOGeBgkw folded before Flop (didn't bet)
Seat 7: zgi+EUykT/pZQpoUG6+oEg (button) folded before Flop (didn't bet)
Seat 9: MG90wfSJZnOejs/KD3vlQQ (small blind) collected ($1.45)




PokerStars Game #59941841028:  Hold'em No Limit ($0.10/$0.25) - 2009/07/01 1:47:51 ET
Table 'HIOfhT0zga/KonFhIl6O3w' 9-max Seat #3 is the button
Seat 1: oLa/tXLfSLLB28mcLGrxcg ($26.20 in chips) 
Seat 2: er86weqXTpTB6/w2dKlYgA ($16.50 in chips) 
Seat 3: X6+pSIPfovPcE87t+LmUKQ ($4.50 in chips) 
Seat 4: qwr38jl5txoR36M7G5qi4A ($8.40 in chips) 
Seat 5: K1MDeapSEyKyGPNZGOKfEg ($36.80 in chips) 
Seat 6: MThMMgdB293VOucmN9sliQ ($25.95 in chips) 
Seat 7: wvlPJBB0PtYkfeeSRDaIvQ ($13.45 in chips) 
Seat 9: dfNim92Z6XK1/h5SFW5vDg ($28.70 in chips) 
qwr38jl5txoR36M7G5qi4A: posts small blind $0.10
K1MDeapSEyKyGPNZGOKfEg: posts big blind $0.25
SpiiQQAzy4MUgV3I5W8giw: sits out 
*** HOLE CARDS ***
MThMMgdB293VOucmN9sliQ: calls $0.25
wvlPJBB0PtYkfeeSRDaIvQ: folds 
dfNim92Z6XK1/h5SFW5vDg: folds 
oLa/tXLfSLLB28mcLGrxcg: folds 
er86weqXTpTB6/w2dKlYgA: folds 
X6+pSIPfovPcE87t+LmUKQ: folds 
qwr38jl5txoR36M7G5qi4A: calls $0.15
K1MDeapSEyKyGPNZGOKfEg: checks 
*** FLOP *** [6h 5d Tc]
qwr38jl5txoR36M7G5qi4A: checks 
K1MDeapSEyKyGPNZGOKfEg: checks 
MThMMgdB293VOucmN9sliQ: checks 
*** TURN *** [6h 5d Tc] [6s]
qwr38jl5txoR36M7G5qi4A: checks 
K1MDeapSEyKyGPNZGOKfEg: bets $0.50
MThMMgdB293VOucmN9sliQ: folds 
qwr38jl5txoR36M7G5qi4A: folds 
Uncalled bet ($0.50) returned to K1MDeapSEyKyGPNZGOKfEg
K1MDeapSEyKyGPNZGOKfEg collected $0.75 from pot
*** SUMMARY ***
Total pot $0.75 | Rake $0 
Board [6h 5d Tc 6s]
Seat 1: oLa/tXLfSLLB28mcLGrxcg folded before Flop (didn't bet)
Seat 2: er86weqXTpTB6/w2dKlYgA folded before Flop (didn't bet)
Seat 3: X6+pSIPfovPcE87t+LmUKQ (button) folded before Flop (didn't bet)
Seat 4: qwr38jl5txoR36M7G5qi4A (small blind) folded on the Turn
Seat 5: K1MDeapSEyKyGPNZGOKfEg (big blind) collected ($0.75)
Seat 6: MThMMgdB293VOucmN9sliQ folded on the Turn
Seat 7: wvlPJBB0PtYkfeeSRDaIvQ folded before Flop (didn't bet)
Seat 9: dfNim92Z6XK1/h5SFW5vDg folded before Flop (didn't bet)




PokerStars Game #59941841890:  Hold'em No Limit ($0.10/$0.25) - 2009/07/01 1:47:52 ET
Table 'KAnP7XvDtlku47YfJwdOVw' 9-max Seat #1 is the button
Seat 1: cH3q40adP+kFogl+2MtbkQ ($12.35 in chips) 
Seat 2: E0iYnEVO2ho7dH3QcCjw7g ($21.60 in chips) 
Seat 3: W6tExOcYX7qiy6Qdp+ZwFA ($7.60 in chips) 
Seat 4: OiV1PWZ3IkN29JlmCcnTwQ ($4.65 in chips) 
Seat 5: MG90wfSJZnOejs/KD3vlQQ ($34 in chips) 
Seat 7: Lro4e37x4FUa5P3yzDjskw ($6.80 in chips) 
Seat 8: OneeONzF0MoH0pEdcBndwA ($22.45 in chips) 
Seat 9: HDDm1BkZtdsRyw2DJdqq6A ($23.55 in chips) 
E0iYnEVO2ho7dH3QcCjw7g: posts small blind $0.10
W6tExOcYX7qiy6Qdp+ZwFA: posts big blind $0.25
*** HOLE CARDS ***
OiV1PWZ3IkN29JlmCcnTwQ: folds 
OiV1PWZ3IkN29JlmCcnTwQ leaves the table
MG90wfSJZnOejs/KD3vlQQ: folds 
18G4P1XstjNvItdGUITxgw joins the table at seat #4 
Lro4e37x4FUa5P3yzDjskw: calls $0.25
OneeONzF0MoH0pEdcBndwA: folds 
HDDm1BkZtdsRyw2DJdqq6A: calls $0.25
cH3q40adP+kFogl+2MtbkQ: raises $0.25 to $0.50
E0iYnEVO2ho7dH3QcCjw7g: folds 
W6tExOcYX7qiy6Qdp+ZwFA: folds 
Lro4e37x4FUa5P3yzDjskw: folds 
HDDm1BkZtdsRyw2DJdqq6A: calls $0.25
*** FLOP *** [4c 8d 3d]
HDDm1BkZtdsRyw2DJdqq6A: bets $0.50
cH3q40adP+kFogl+2MtbkQ: raises $0.50 to $1
HDDm1BkZtdsRyw2DJdqq6A: calls $0.50
*** TURN *** [4c 8d 3d] [Js]
HDDm1BkZtdsRyw2DJdqq6A: checks 
cH3q40adP+kFogl+2MtbkQ: bets $0.75
HDDm1BkZtdsRyw2DJdqq6A: calls $0.75
*** RIVER *** [4c 8d 3d Js] [2c]
HDDm1BkZtdsRyw2DJdqq6A: checks 
cH3q40adP+kFogl+2MtbkQ: bets $3.75
HDDm1BkZtdsRyw2DJdqq6A: folds 
Uncalled bet ($3.75) returned to cH3q40adP+kFogl+2MtbkQ
cH3q40adP+kFogl+2MtbkQ collected $4.90 from pot
*** SUMMARY ***
Total pot $5.10 | Rake $0.20 
Board [4c 8d 3d Js 2c]
Seat 1: cH3q40adP+kFogl+2MtbkQ (button) collected ($4.90)
Seat 2: E0iYnEVO2ho7dH3QcCjw7g (small blind) folded before Flop
Seat 3: W6tExOcYX7qiy6Qdp+ZwFA (big blind) folded before Flop
Seat 4: OiV1PWZ3IkN29JlmCcnTwQ folded before Flop (didn't bet)
Seat 5: MG90wfSJZnOejs/KD3vlQQ folded before Flop (didn't bet)
Seat 7: Lro4e37x4FUa5P3yzDjskw folded before Flop
Seat 8: OneeONzF0MoH0pEdcBndwA folded before Flop (didn't bet)
Seat 9: HDDm1BkZtdsRyw2DJdqq6A folded on the River




PokerStars Game #59941841982:  Hold'em No Limit ($0.10/$0.25) - 2009/07/01 1:47:52 ET
Table 'rO1I30HnuCPB0M8qEX1TCQ' 9-max Seat #3 is the button
Seat 1: nAWaA+gDUSWOad+I9mKUEg ($10 in chips) 
Seat 2: z1hPotrGOZjUjyoopZ7Ulg ($25.40 in chips) 
Seat 3: 2wcFsZsqEP5w1StUTVzJCg ($12.80 in chips) 
Seat 4: yyG4svzOpC1A+sUP/scg6w ($10.15 in chips) 
Seat 5: WQe4GbiYBiPsb5WKFKkijQ ($10 in chips) 
Seat 6: 5n7e7I+px7c6CQmLpPbtsg ($4.65 in chips) 
Seat 7: bXpVeaSTPBFSPJmeXxO7nw ($5 in chips) 
Seat 9: wnerYvSRWT9Sm4X3ip/c8w ($25.80 in chips) 
yyG4svzOpC1A+sUP/scg6w: posts small blind $0.10
WQe4GbiYBiPsb5WKFKkijQ: posts big blind $0.25
CGjLyv/AvljZy2g76nYkzQ joins the table at seat #8 
nAWaA+gDUSWOad+I9mKUEg: posts big blind $0.25
*** HOLE CARDS ***
5n7e7I+px7c6CQmLpPbtsg: folds 
bXpVeaSTPBFSPJmeXxO7nw: folds 
wnerYvSRWT9Sm4X3ip/c8w: raises $1 to $1.25
nAWaA+gDUSWOad+I9mKUEg: raises $1 to $2.25
z1hPotrGOZjUjyoopZ7Ulg: folds 
2wcFsZsqEP5w1StUTVzJCg: folds 
yyG4svzOpC1A+sUP/scg6w: folds 
WQe4GbiYBiPsb5WKFKkijQ: folds 
wnerYvSRWT9Sm4X3ip/c8w: raises $10.25 to $12.50
nAWaA+gDUSWOad+I9mKUEg: calls $7.75 and is all-in
Uncalled bet ($2.50) returned to wnerYvSRWT9Sm4X3ip/c8w
*** FLOP *** [9h 3d As]
*** TURN *** [9h 3d As] [9s]
*** RIVER *** [9h 3d As 9s] [7d]
*** SHOW DOWN ***
wnerYvSRWT9Sm4X3ip/c8w: shows [Ad Ac] (a full house, Aces full of Nines)
nAWaA+gDUSWOad+I9mKUEg: mucks hand 
wnerYvSRWT9Sm4X3ip/c8w collected $19.35 from pot
nAWaA+gDUSWOad+I9mKUEg leaves the table
*** SUMMARY ***
Total pot $20.35 | Rake $1 
Board [9h 3d As 9s 7d]
Seat 1: nAWaA+gDUSWOad+I9mKUEg mucked
Seat 2: z1hPotrGOZjUjyoopZ7Ulg folded before Flop (didn't bet)
Seat 3: 2wcFsZsqEP5w1StUTVzJCg (button) folded before Flop (didn't bet)
Seat 4: yyG4svzOpC1A+sUP/scg6w (small blind) folded before Flop
Seat 5: WQe4GbiYBiPsb5WKFKkijQ (big blind) folded before Flop
Seat 6: 5n7e7I+px7c6CQmLpPbtsg folded before Flop (didn't bet)
Seat 7: bXpVeaSTPBFSPJmeXxO7nw folded before Flop (didn't bet)
Seat 9: wnerYvSRWT9Sm4X3ip/c8w showed [Ad Ac] and won ($19.35) with a full house, Aces full of Nines




PokerStars Game #59941841624:  Hold'em No Limit ($0.10/$0.25) - 2009/07/01 1:47:52 ET
Table 'pAhiNHs/spaABQia+7gWNQ' 9-max Seat #6 is the button
Seat 1: ipgcO7Pa6LC8XWpVttZfnA ($5 in chips) 
Seat 2: dfNim92Z6XK1/h5SFW5vDg ($25.25 in chips) 
Seat 4: Qduu7ikeizo6q6Ei9YvcJA ($47.75 in chips) 
Seat 5: OlPJsgR4xypSg/w1z7Gyvw ($33.60 in chips) 
Seat 6: oLa/tXLfSLLB28mcLGrxcg ($24.90 in chips) 
Seat 7: +WTkVY3GeLxqGQBbMZQiWQ ($4.90 in chips) 
Seat 8: PskTLlFIRHSp61inskRzVg ($14 in chips) 
Seat 9: zgi+EUykT/pZQpoUG6+oEg ($6.15 in chips) 
+WTkVY3GeLxqGQBbMZQiWQ: posts small blind $0.10
PskTLlFIRHSp61inskRzVg: posts big blind $0.25
bXpVeaSTPBFSPJmeXxO7nw: sits out 
*** HOLE CARDS ***
zgi+EUykT/pZQpoUG6+oEg: folds 
ipgcO7Pa6LC8XWpVttZfnA: folds 
dfNim92Z6XK1/h5SFW5vDg: folds 
Qduu7ikeizo6q6Ei9YvcJA: folds 
OlPJsgR4xypSg/w1z7Gyvw: folds 
oLa/tXLfSLLB28mcLGrxcg: raises $0.75 to $1
+WTkVY3GeLxqGQBbMZQiWQ: raises $0.75 to $1.75
PskTLlFIRHSp61inskRzVg: raises $0.75 to $2.50
oLa/tXLfSLLB28mcLGrxcg: folds 
+WTkVY3GeLxqGQBbMZQiWQ: raises $2 to $4.50
PskTLlFIRHSp61inskRzVg: calls $2
*** FLOP *** [9c 3h 5c]
+WTkVY3GeLxqGQBbMZQiWQ: bets $0.40 and is all-in
PskTLlFIRHSp61inskRzVg: calls $0.40
*** TURN *** [9c 3h 5c] [Td]
*** RIVER *** [9c 3h 5c Td] [4d]
*** SHOW DOWN ***
+WTkVY3GeLxqGQBbMZQiWQ: shows [Ac Ah] (a pair of Aces)
PskTLlFIRHSp61inskRzVg: mucks hand 
+WTkVY3GeLxqGQBbMZQiWQ collected $10.30 from pot
*** SUMMARY ***
Total pot $10.80 | Rake $0.50 
Board [9c 3h 5c Td 4d]
Seat 1: ipgcO7Pa6LC8XWpVttZfnA folded before Flop (didn't bet)
Seat 2: dfNim92Z6XK1/h5SFW5vDg folded before Flop (didn't bet)
Seat 4: Qduu7ikeizo6q6Ei9YvcJA folded before Flop (didn't bet)
Seat 5: OlPJsgR4xypSg/w1z7Gyvw folded before Flop (didn't bet)
Seat 6: oLa/tXLfSLLB28mcLGrxcg (button) folded before Flop
Seat 7: +WTkVY3GeLxqGQBbMZQiWQ (small blind) showed [Ac Ah] and won ($10.30) with a pair of Aces
Seat 8: PskTLlFIRHSp61inskRzVg (big blind) mucked
Seat 9: zgi+EUykT/pZQpoUG6+oEg folded before Flop (didn't bet)




PokerStars Game #59941841964:  Hold'em No Limit ($0.10/$0.25) - 2009/07/01 1:47:52 ET
Table 'GxdLtCpYxqT4aAbYqkEEpw' 6-max Seat #1 is the button
Seat 1: 2d/PU00mMdO9azAaXqcSbw ($10.05 in chips) 
Seat 2: MCCWc70bl051s/EF6nHRcA ($24.50 in chips) 
Seat 4: 6wzJiRvp8HY6t+MQGnSIzA ($11.15 in chips) 
Seat 5: q6WfTUAD9mowIP63ASq2Dg ($45.25 in chips) 
Seat 6: DFi/Lzkjsfv8QswS80JX9Q ($25 in chips) 
MCCWc70bl051s/EF6nHRcA: posts small blind $0.10
6wzJiRvp8HY6t+MQGnSIzA: posts big blind $0.25
*** HOLE CARDS ***
q6WfTUAD9mowIP63ASq2Dg: folds 
DFi/Lzkjsfv8QswS80JX9Q: folds 
2d/PU00mMdO9azAaXqcSbw: folds 
MCCWc70bl051s/EF6nHRcA: folds 
Uncalled bet ($0.15) returned to 6wzJiRvp8HY6t+MQGnSIzA
6wzJiRvp8HY6t+MQGnSIzA collected $0.20 from pot
*** SUMMARY ***
Total pot $0.20 | Rake $0 
Seat 1: 2d/PU00mMdO9azAaXqcSbw (button) folded before Flop (didn't bet)
Seat 2: MCCWc70bl051s/EF6nHRcA (small blind) folded before Flop
Seat 4: 6wzJiRvp8HY6t+MQGnSIzA (big blind) collected ($0.20)
Seat 5: q6WfTUAD9mowIP63ASq2Dg folded before Flop (didn't bet)
Seat 6: DFi/Lzkjsfv8QswS80JX9Q folded before Flop (didn't bet)




PokerStars Game #59941841658:  Hold'em No Limit ($0.10/$0.25) - 2009/07/01 1:47:52 ET
Table 'fIMYcWwN4/aXFJvH5Z8Ymg' 6-max Seat #1 is the button
Seat 1: DihMHaz4WNETH1bPDe13kA ($25 in chips) 
Seat 2: Mhj3q7cxev+XjXZxEE6/Cw ($25.70 in chips) 
Seat 3: 9bpVv1/Qh9IYtXuCtl5VtQ ($24.65 in chips) 
Seat 5: lquriepNQBhDV5P1SWHhnA ($25.35 in chips) 
Seat 6: jp34e617tIzV8tKIWmfAbA ($28.70 in chips) 
Mhj3q7cxev+XjXZxEE6/Cw: posts small blind $0.10
9bpVv1/Qh9IYtXuCtl5VtQ: posts big blind $0.25
7cx44/slbeTw+Cy7QB8Trg: sits out 
*** HOLE CARDS ***
lquriepNQBhDV5P1SWHhnA: folds 
jp34e617tIzV8tKIWmfAbA: folds 
DihMHaz4WNETH1bPDe13kA: folds 
Mhj3q7cxev+XjXZxEE6/Cw: folds 
Uncalled bet ($0.15) returned to 9bpVv1/Qh9IYtXuCtl5VtQ
9bpVv1/Qh9IYtXuCtl5VtQ collected $0.20 from pot
9bpVv1/Qh9IYtXuCtl5VtQ: doesn't show hand 
*** SUMMARY ***
Total pot $0.20 | Rake $0 
Seat 1: DihMHaz4WNETH1bPDe13kA (button) folded before Flop (didn't bet)
Seat 2: Mhj3q7cxev+XjXZxEE6/Cw (small blind) folded before Flop
Seat 3: 9bpVv1/Qh9IYtXuCtl5VtQ (big blind) collected ($0.20)
Seat 5: lquriepNQBhDV5P1SWHhnA folded before Flop (didn't bet)
Seat 6: jp34e617tIzV8tKIWmfAbA folded before Flop (didn't bet)




PokerStars Game #59941841846:  Hold'em No Limit ($0.10/$0.25) - 2009/07/01 1:47:52 ET
Table 'bIGKmJgZehWJ+FAo8b85iw' 9-max Seat #5 is the button
Seat 1: yyG4svzOpC1A+sUP/scg6w ($7.50 in chips) 
Seat 2: cCjRCvseA9rZn7Xr+GCCHg ($25.80 in chips) 
Seat 3: /FyMUX+W/tpNFcRWbUTJxQ ($23.50 in chips) 
Seat 4: LGxBRjCRn6KlQ/6B4eoXbA ($38.55 in chips) 
Seat 5: uLP/lYn7oKq9xCChBXsXxw ($24.65 in chips) 
Seat 6: PFNLAvMkr8qKc7xCiH0wTA ($16.95 in chips) 
Seat 7: mMd8CDS/but3UC+Zp7Up2w ($20 in chips) 
Seat 8: +2kMBNpY4nF1qNCRd8SJLA ($54.20 in chips) 
Seat 9: aNpwfA31EREwO+ar4XzBCw ($31.75 in chips) 
PFNLAvMkr8qKc7xCiH0wTA: posts small blind $0.10
mMd8CDS/but3UC+Zp7Up2w: posts big blind $0.25
*** HOLE CARDS ***
+2kMBNpY4nF1qNCRd8SJLA: folds 
aNpwfA31EREwO+ar4XzBCw: folds 
yyG4svzOpC1A+sUP/scg6w: folds 
cCjRCvseA9rZn7Xr+GCCHg: folds 
/FyMUX+W/tpNFcRWbUTJxQ has timed out
/FyMUX+W/tpNFcRWbUTJxQ: folds 
/FyMUX+W/tpNFcRWbUTJxQ is sitting out
LGxBRjCRn6KlQ/6B4eoXbA: raises $0.75 to $1
uLP/lYn7oKq9xCChBXsXxw: folds 
/FyMUX+W/tpNFcRWbUTJxQ has returned
PFNLAvMkr8qKc7xCiH0wTA: calls $0.90
mMd8CDS/but3UC+Zp7Up2w: folds 
*** FLOP *** [9c 3d Qc]
PFNLAvMkr8qKc7xCiH0wTA: checks 
LGxBRjCRn6KlQ/6B4eoXbA: bets $2
PFNLAvMkr8qKc7xCiH0wTA: raises $4 to $6
LGxBRjCRn6KlQ/6B4eoXbA: folds 
Uncalled bet ($4) returned to PFNLAvMkr8qKc7xCiH0wTA
PFNLAvMkr8qKc7xCiH0wTA collected $5.95 from pot
PFNLAvMkr8qKc7xCiH0wTA: doesn't show hand 
*** SUMMARY ***
Total pot $6.25 | Rake $0.30 
Board [9c 3d Qc]
Seat 1: yyG4svzOpC1A+sUP/scg6w folded before Flop (didn't bet)
Seat 2: cCjRCvseA9rZn7Xr+GCCHg folded before Flop (didn't bet)
Seat 3: /FyMUX+W/tpNFcRWbUTJxQ folded before Flop (didn't bet)
Seat 4: LGxBRjCRn6KlQ/6B4eoXbA folded on the Flop
Seat 5: uLP/lYn7oKq9xCChBXsXxw (button) folded before Flop (didn't bet)
Seat 6: PFNLAvMkr8qKc7xCiH0wTA (small blind) collected ($5.95)
Seat 7: mMd8CDS/but3UC+Zp7Up2w (big blind) folded before Flop
Seat 8: +2kMBNpY4nF1qNCRd8SJLA folded before Flop (didn't bet)
Seat 9: aNpwfA31EREwO+ar4XzBCw folded before Flop (didn't bet)




PokerStars Game #59941841638:  Hold'em No Limit ($0.10/$0.25) - 2009/07/01 1:47:52 ET
Table 'tANpk8z1C5o0Pq/hpYShHw' 9-max Seat #7 is the button
Seat 1: rQhYIYXSyH/IivYM1dlV5A ($17.50 in chips) 
Seat 2: og4yH4sZUZdC8jjgW8zPJQ ($8.60 in chips) 
Seat 3: zDrucyjVn5aeekNEc3cJrA ($18.55 in chips) 
Seat 4: j4q3p0lesp63b1gZDwLBZw ($5 in chips) 
Seat 5: X6+pSIPfovPcE87t+LmUKQ ($8.55 in chips) 
Seat 6: kN0AWJG6biW8tHtuF+wTjA ($10.30 in chips) 
Seat 7: aNpwfA31EREwO+ar4XzBCw ($26.95 in chips) 
Seat 8: Z9W7+g1WMhhZDi7DwGbCFA ($5 in chips) 
Seat 9: gE5rN2TDY1aXcZn/TOPeZw ($7.70 in chips) 
Z9W7+g1WMhhZDi7DwGbCFA: posts small blind $0.10
gE5rN2TDY1aXcZn/TOPeZw: posts big blind $0.25
*** HOLE CARDS ***
rQhYIYXSyH/IivYM1dlV5A: folds 
og4yH4sZUZdC8jjgW8zPJQ: raises $0.25 to $0.50
zDrucyjVn5aeekNEc3cJrA: folds 
j4q3p0lesp63b1gZDwLBZw: folds 
X6+pSIPfovPcE87t+LmUKQ: folds 
kN0AWJG6biW8tHtuF+wTjA: folds 
aNpwfA31EREwO+ar4XzBCw: folds 
Z9W7+g1WMhhZDi7DwGbCFA: calls $0.40
gE5rN2TDY1aXcZn/TOPeZw: calls $0.25
*** FLOP *** [4h 3c 4c]
Z9W7+g1WMhhZDi7DwGbCFA: bets $0.50
gE5rN2TDY1aXcZn/TOPeZw: folds 
og4yH4sZUZdC8jjgW8zPJQ: raises $2.50 to $3
Z9W7+g1WMhhZDi7DwGbCFA: calls $2.50
*** TURN *** [4h 3c 4c] [3d]
Z9W7+g1WMhhZDi7DwGbCFA: bets $1.50 and is all-in
og4yH4sZUZdC8jjgW8zPJQ: calls $1.50
*** RIVER *** [4h 3c 4c 3d] [7d]
*** SHOW DOWN ***
Z9W7+g1WMhhZDi7DwGbCFA: shows [6d 4d] (a full house, Fours full of Threes)
og4yH4sZUZdC8jjgW8zPJQ: mucks hand 
Z9W7+g1WMhhZDi7DwGbCFA collected $10 from pot
*** SUMMARY ***
Total pot $10.50 | Rake $0.50 
Board [4h 3c 4c 3d 7d]
Seat 1: rQhYIYXSyH/IivYM1dlV5A folded before Flop (didn't bet)
Seat 2: og4yH4sZUZdC8jjgW8zPJQ mucked
Seat 3: zDrucyjVn5aeekNEc3cJrA folded before Flop (didn't bet)
Seat 4: j4q3p0lesp63b1gZDwLBZw folded before Flop (didn't bet)
Seat 5: X6+pSIPfovPcE87t+LmUKQ folded before Flop (didn't bet)
Seat 6: kN0AWJG6biW8tHtuF+wTjA folded before Flop (didn't bet)
Seat 7: aNpwfA31EREwO+ar4XzBCw (button) folded before Flop (didn't bet)
Seat 8: Z9W7+g1WMhhZDi7DwGbCFA (small blind) showed [6d 4d] and won ($10) with a full house, Fours full of Threes
Seat 9: gE5rN2TDY1aXcZn/TOPeZw (big blind) folded on the Flop




PokerStars Game #59941841552:  Hold'em No Limit ($0.10/$0.25) - 2009/07/01 1:47:52 ET
Table 'G26g8jde1eR+mmabeFeSlw' 9-max Seat #9 is the button
Seat 1: wnerYvSRWT9Sm4X3ip/c8w ($24.75 in chips) 
Seat 2: BFYwQ0J4xWUQvouudojivA ($17.45 in chips) 
Seat 3: WKL8nUFr7TumC4EjLyqYzw ($6.50 in chips) 
Seat 4: 8EbrQ/EvFWt2cr0GaU82gQ ($5.75 in chips) 
Seat 5: hJ4uYjNmSZdjrKA8cjZqCA ($30.45 in chips) 
Seat 6: AHGkesF/mi4sDMpqrxBUoA ($8.55 in chips) 
Seat 7: nm4Dj/f+jJEwKVsUnKh73g ($37.50 in chips) 
Seat 8: CvL9Ch1HYCVbTsfpNucitg ($5.50 in chips) 
Seat 9: VWUWpMLMj/Q1jRVpF7Aohw ($13.30 in chips) 
wnerYvSRWT9Sm4X3ip/c8w: posts small blind $0.10
BFYwQ0J4xWUQvouudojivA: posts big blind $0.25
*** HOLE CARDS ***
WKL8nUFr7TumC4EjLyqYzw: folds 
8EbrQ/EvFWt2cr0GaU82gQ: folds 
hJ4uYjNmSZdjrKA8cjZqCA: folds 
AHGkesF/mi4sDMpqrxBUoA: folds 
nm4Dj/f+jJEwKVsUnKh73g: folds 
CvL9Ch1HYCVbTsfpNucitg: folds 
VWUWpMLMj/Q1jRVpF7Aohw: folds 
wnerYvSRWT9Sm4X3ip/c8w: folds 
Uncalled bet ($0.15) returned to BFYwQ0J4xWUQvouudojivA
BFYwQ0J4xWUQvouudojivA collected $0.20 from pot
*** SUMMARY ***
Total pot $0.20 | Rake $0 
Seat 1: wnerYvSRWT9Sm4X3ip/c8w (small blind) folded before Flop
Seat 2: BFYwQ0J4xWUQvouudojivA (big blind) collected ($0.20)
Seat 3: WKL8nUFr7TumC4EjLyqYzw folded before Flop (didn't bet)
Seat 4: 8EbrQ/EvFWt2cr0GaU82gQ folded before Flop (didn't bet)
Seat 5: hJ4uYjNmSZdjrKA8cjZqCA folded before Flop (didn't bet)
Seat 6: AHGkesF/mi4sDMpqrxBUoA folded before Flop (didn't bet)
Seat 7: nm4Dj/f+jJEwKVsUnKh73g folded before Flop (didn't bet)
Seat 8: CvL9Ch1HYCVbTsfpNucitg folded before Flop (didn't bet)
Seat 9: VWUWpMLMj/Q1jRVpF7Aohw (button) folded before Flop (didn't bet)




PokerStars Game #59941841664:  Hold'em No Limit ($0.10/$0.25) - 2009/07/01 1:47:52 ET
Table '63h13e5p7cWe02rClZ1CHw' 6-max Seat #1 is the button
Seat 1: pokjbbEcXXPlADXdSGHtZw ($21.70 in chips) 
Seat 2: k9nHZTHt8hYhYRcW8NTb4g ($23.65 in chips) 
Seat 3: mFv3iBCtrw9XfCDRB0d46Q ($4.65 in chips) 
Seat 4: xrf8tAXKQHG99HixCot1Iw ($28.35 in chips) 
Seat 5: iyZxqznXjv3vtvOJymkoLQ ($44.45 in chips) 
Seat 6: mfrkWA3PTeYPkbO6hi98Aw ($39.05 in chips) 
k9nHZTHt8hYhYRcW8NTb4g: posts small blind $0.10
mFv3iBCtrw9XfCDRB0d46Q: posts big blind $0.25
*** HOLE CARDS ***
xrf8tAXKQHG99HixCot1Iw: folds 
iyZxqznXjv3vtvOJymkoLQ: folds 
mfrkWA3PTeYPkbO6hi98Aw: folds 
pokjbbEcXXPlADXdSGHtZw: folds 
k9nHZTHt8hYhYRcW8NTb4g: raises $0.50 to $0.75
mFv3iBCtrw9XfCDRB0d46Q: folds 
Uncalled bet ($0.50) returned to k9nHZTHt8hYhYRcW8NTb4g
k9nHZTHt8hYhYRcW8NTb4g collected $0.50 from pot
*** SUMMARY ***
Total pot $0.50 | Rake $0 
Seat 1: pokjbbEcXXPlADXdSGHtZw (button) folded before Flop (didn't bet)
Seat 2: k9nHZTHt8hYhYRcW8NTb4g (small blind) collected ($0.50)
Seat 3: mFv3iBCtrw9XfCDRB0d46Q (big blind) folded before Flop
Seat 4: xrf8tAXKQHG99HixCot1Iw folded before Flop (didn't bet)
Seat 5: iyZxqznXjv3vtvOJymkoLQ folded before Flop (didn't bet)
Seat 6: mfrkWA3PTeYPkbO6hi98Aw folded before Flop (didn't bet)




PokerStars Game #59941841782:  Hold'em No Limit ($0.10/$0.25) - 2009/07/01 1:47:52 ET
Table 'NtCSSONEf1zaJo3042tQug' 6-max Seat #3 is the button
Seat 1: KXtdqb+rIMkjc0RvHDksGQ ($34.90 in chips) 
Seat 2: vqWjZmdQu/Hxw96/IJTWdQ ($25 in chips) 
Seat 3: 9kUKGKkblnIx3m8rlVol6Q ($15.65 in chips) 
Seat 4: HxD1kB8zCmalQSdWAkKmlg ($28.60 in chips) 
Seat 5: tOAk1Og4mVObMBOfvdDYOw ($31.55 in chips) 
Seat 6: LxehwDpTQ19ph4Qmc78+Pw ($31.40 in chips) 
HxD1kB8zCmalQSdWAkKmlg: posts small blind $0.10
tOAk1Og4mVObMBOfvdDYOw: posts big blind $0.25
*** HOLE CARDS ***
LxehwDpTQ19ph4Qmc78+Pw: folds 
KXtdqb+rIMkjc0RvHDksGQ: folds 
vqWjZmdQu/Hxw96/IJTWdQ: folds 
9kUKGKkblnIx3m8rlVol6Q: folds 
HxD1kB8zCmalQSdWAkKmlg: folds 
Uncalled bet ($0.15) returned to tOAk1Og4mVObMBOfvdDYOw
tOAk1Og4mVObMBOfvdDYOw collected $0.20 from pot
tOAk1Og4mVObMBOfvdDYOw: doesn't show hand 
*** SUMMARY ***
Total pot $0.20 | Rake $0 
Seat 1: KXtdqb+rIMkjc0RvHDksGQ folded before Flop (didn't bet)
Seat 2: vqWjZmdQu/Hxw96/IJTWdQ folded before Flop (didn't bet)
Seat 3: 9kUKGKkblnIx3m8rlVol6Q (button) folded before Flop (didn't bet)
Seat 4: HxD1kB8zCmalQSdWAkKmlg (small blind) folded before Flop
Seat 5: tOAk1Og4mVObMBOfvdDYOw (big blind) collected ($0.20)
Seat 6: LxehwDpTQ19ph4Qmc78+Pw folded before Flop (didn't bet)




PokerStars Game #59941841690:  Hold'em No Limit ($0.10/$0.25) - 2009/07/01 1:47:52 ET
Table 'Qr+t8WGovMECkBv+cV1lrg' 6-max Seat #2 is the button
Seat 1: EeUZtMU058v2ObUACOF4Og ($44.75 in chips) 
Seat 2: vqWjZmdQu/Hxw96/IJTWdQ ($41.60 in chips) 
Seat 3: uZKkrGByYgd4/ZBX2d4z+w ($11 in chips) 
Seat 4: 1NNFfYMd5Hsphl/FYz9fNA ($60.15 in chips) 
Seat 5: 9q7YGTKe9k5fYb4fmZc3Ww ($32 in chips) 
Seat 6: 9U3ZKjCsarN0DjR6mSE8Ug ($14 in chips) 
uZKkrGByYgd4/ZBX2d4z+w: posts small blind $0.10
1NNFfYMd5Hsphl/FYz9fNA: posts big blind $0.25
*** HOLE CARDS ***
uZKkrGByYgd4/ZBX2d4z+w said, "sickening"
9q7YGTKe9k5fYb4fmZc3Ww: folds 
9U3ZKjCsarN0DjR6mSE8Ug: raises $0.50 to $0.75
EeUZtMU058v2ObUACOF4Og: folds 
vqWjZmdQu/Hxw96/IJTWdQ: folds 
uZKkrGByYgd4/ZBX2d4z+w said, "but than again"
uZKkrGByYgd4/ZBX2d4z+w said, "all too predictable"
uZKkrGByYgd4/ZBX2d4z+w: folds 
1NNFfYMd5Hsphl/FYz9fNA: folds 
Uncalled bet ($0.50) returned to 9U3ZKjCsarN0DjR6mSE8Ug
9U3ZKjCsarN0DjR6mSE8Ug collected $0.60 from pot
9U3ZKjCsarN0DjR6mSE8Ug: doesn't show hand 
*** SUMMARY ***
Total pot $0.60 | Rake $0 
Seat 1: EeUZtMU058v2ObUACOF4Og folded before Flop (didn't bet)
Seat 2: vqWjZmdQu/Hxw96/IJTWdQ (button) folded before Flop (didn't bet)
Seat 3: uZKkrGByYgd4/ZBX2d4z+w (small blind) folded before Flop
Seat 4: 1NNFfYMd5Hsphl/FYz9fNA (big blind) folded before Flop
Seat 5: 9q7YGTKe9k5fYb4fmZc3Ww folded before Flop (didn't bet)
Seat 6: 9U3ZKjCsarN0DjR6mSE8Ug collected ($0.60)




PokerStars Game #59941842100:  Hold'em No Limit ($0.10/$0.25) - 2009/07/01 1:47:53 ET
Table 'yAHDCs33TIgw3ra63xuU2Q' 9-max Seat #6 is the button
Seat 2: j4q3p0lesp63b1gZDwLBZw ($5 in chips) 
Seat 3: g6UPjSyxNLffCi+EqqIlEg ($20.30 in chips) 
Seat 4: j5spkbnOCRiLGiH6iqBaqw ($8.80 in chips) 
Seat 5: 4awUyiDYTgylQKXZ9faBVA ($38.35 in chips) 
Seat 6: DnDcAdn9P0zGovMERigpFA ($25.95 in chips) 
Seat 9: MtVtHDqIJTyUcXkRBBDIVA ($25 in chips) 
MtVtHDqIJTyUcXkRBBDIVA: posts small blind $0.10
j4q3p0lesp63b1gZDwLBZw: posts big blind $0.25
*** HOLE CARDS ***
g6UPjSyxNLffCi+EqqIlEg: folds 
j5spkbnOCRiLGiH6iqBaqw: folds 
4awUyiDYTgylQKXZ9faBVA: folds 
DnDcAdn9P0zGovMERigpFA: raises $0.75 to $1
MtVtHDqIJTyUcXkRBBDIVA: folds 
j4q3p0lesp63b1gZDwLBZw: folds 
Uncalled bet ($0.75) returned to DnDcAdn9P0zGovMERigpFA
DnDcAdn9P0zGovMERigpFA collected $0.60 from pot
DnDcAdn9P0zGovMERigpFA: doesn't show hand 
*** SUMMARY ***
Total pot $0.60 | Rake $0 
Seat 2: j4q3p0lesp63b1gZDwLBZw (big blind) folded before Flop
Seat 3: g6UPjSyxNLffCi+EqqIlEg folded before Flop (didn't bet)
Seat 4: j5spkbnOCRiLGiH6iqBaqw folded before Flop (didn't bet)
Seat 5: 4awUyiDYTgylQKXZ9faBVA folded before Flop (didn't bet)
Seat 6: DnDcAdn9P0zGovMERigpFA (button) collected ($0.60)
Seat 9: MtVtHDqIJTyUcXkRBBDIVA (small blind) folded before Flop




PokerStars Game #59941842442:  Hold'em No Limit ($0.10/$0.25) - 2009/07/01 1:47:53 ET
Table 'JJzUs04lHpXg6nboT1/jeg' 6-max Seat #3 is the button
Seat 1: MqMK8OWPSY1V4stf1Hy5Jw ($36.70 in chips) 
Seat 2: jxfR29d+dK/7h7s3SvCk+g ($8.10 in chips) 
Seat 3: 4zXbHDe39qNX46dAo81b4w ($10.55 in chips) 
Seat 4: 7cx44/slbeTw+Cy7QB8Trg ($24.75 in chips) 
Seat 5: QvTX2yGq3uKJiKPmns4TKQ ($18.60 in chips) 
7cx44/slbeTw+Cy7QB8Trg: posts small blind $0.10
QvTX2yGq3uKJiKPmns4TKQ: posts big blind $0.25
*** HOLE CARDS ***
MqMK8OWPSY1V4stf1Hy5Jw: folds 
jxfR29d+dK/7h7s3SvCk+g: folds 
4zXbHDe39qNX46dAo81b4w: folds 
7cx44/slbeTw+Cy7QB8Trg: raises $0.75 to $1
QvTX2yGq3uKJiKPmns4TKQ: folds 
Uncalled bet ($0.75) returned to 7cx44/slbeTw+Cy7QB8Trg
7cx44/slbeTw+Cy7QB8Trg collected $0.50 from pot
7cx44/slbeTw+Cy7QB8Trg: doesn't show hand 
*** SUMMARY ***
Total pot $0.50 | Rake $0 
Seat 1: MqMK8OWPSY1V4stf1Hy5Jw folded before Flop (didn't bet)
Seat 2: jxfR29d+dK/7h7s3SvCk+g folded before Flop (didn't bet)
Seat 3: 4zXbHDe39qNX46dAo81b4w (button) folded before Flop (didn't bet)
Seat 4: 7cx44/slbeTw+Cy7QB8Trg (small blind) collected ($0.50)
Seat 5: QvTX2yGq3uKJiKPmns4TKQ (big blind) folded before Flop




PokerStars Game #59941842478:  Hold'em No Limit ($0.10/$0.25) - 2009/07/01 1:47:53 ET
Table 'VuY5ej47Cy8nOI3Wogmhzw' 6-max Seat #3 is the button
Seat 1: EeUZtMU058v2ObUACOF4Og ($41.35 in chips) 
Seat 2: AM6Yl+3esmhhMBlSnQhWbg ($13.60 in chips) 
Seat 3: v+QfkGiuj9bgtuNoVnDO8w ($41.10 in chips) 
Seat 4: QqiZLFrN8iOUT/GHw7ztOA ($26.25 in chips) 
Seat 6: +KblIivb6tainScpwm14RQ ($5.75 in chips) 
QqiZLFrN8iOUT/GHw7ztOA: posts small blind $0.10
+KblIivb6tainScpwm14RQ: posts big blind $0.25
*** HOLE CARDS ***
EeUZtMU058v2ObUACOF4Og: raises $0.75 to $1
AM6Yl+3esmhhMBlSnQhWbg: folds 
m2yWOKfAxqHoy5DDN87Ttw joins the table at seat #5 
v+QfkGiuj9bgtuNoVnDO8w: folds 
QqiZLFrN8iOUT/GHw7ztOA: folds 
+KblIivb6tainScpwm14RQ: calls $0.75
*** FLOP *** [8d 6s Qh]
+KblIivb6tainScpwm14RQ: checks 
EeUZtMU058v2ObUACOF4Og: bets $1.75
+KblIivb6tainScpwm14RQ: calls $1.75
*** TURN *** [8d 6s Qh] [4h]
+KblIivb6tainScpwm14RQ: bets $3 and is all-in
EeUZtMU058v2ObUACOF4Og: calls $3
*** RIVER *** [8d 6s Qh 4h] [9s]
*** SHOW DOWN ***
+KblIivb6tainScpwm14RQ: shows [8h 9c] (two pair, Nines and Eights)
EeUZtMU058v2ObUACOF4Og: mucks hand 
+KblIivb6tainScpwm14RQ collected $11.05 from pot
*** SUMMARY ***
Total pot $11.60 | Rake $0.55 
Board [8d 6s Qh 4h 9s]
Seat 1: EeUZtMU058v2ObUACOF4Og mucked
Seat 2: AM6Yl+3esmhhMBlSnQhWbg folded before Flop (didn't bet)
Seat 3: v+QfkGiuj9bgtuNoVnDO8w (button) folded before Flop (didn't bet)
Seat 4: QqiZLFrN8iOUT/GHw7ztOA (small blind) folded before Flop
Seat 6: +KblIivb6tainScpwm14RQ (big blind) showed [8h 9c] and won ($11.05) with two pair, Nines and Eights




PokerStars Game #59941842654:  Hold'em No Limit ($0.10/$0.25) - 2009/07/01 1:47:54 ET
Table 'L5GvbdQO5aCZJSE6pyQ8OA' 6-max Seat #4 is the button
Seat 2: DihMHaz4WNETH1bPDe13kA ($31.40 in chips) 
Seat 3: JFIAqU8lCZ0vWwEl4bdGsg ($25.70 in chips) 
Seat 4: trN/oHqTTbPw5MNuKrOpLw ($28.30 in chips) 
Seat 5: LyDHtw3/yniNHW+DvLXbog ($26.75 in chips) 
Seat 6: v+QfkGiuj9bgtuNoVnDO8w ($39.05 in chips) 
LyDHtw3/yniNHW+DvLXbog: posts small blind $0.10
v+QfkGiuj9bgtuNoVnDO8w: posts big blind $0.25
*** HOLE CARDS ***
DihMHaz4WNETH1bPDe13kA: folds 
JFIAqU8lCZ0vWwEl4bdGsg: folds 
trN/oHqTTbPw5MNuKrOpLw: raises $0.75 to $1
LyDHtw3/yniNHW+DvLXbog: calls $0.90
v+QfkGiuj9bgtuNoVnDO8w: folds 
*** FLOP *** [7h Kh 6c]
LyDHtw3/yniNHW+DvLXbog: checks 
trN/oHqTTbPw5MNuKrOpLw: bets $1.50
LyDHtw3/yniNHW+DvLXbog: raises $2.25 to $3.75
trN/oHqTTbPw5MNuKrOpLw: folds 
Uncalled bet ($2.25) returned to LyDHtw3/yniNHW+DvLXbog
LyDHtw3/yniNHW+DvLXbog collected $5 from pot
LyDHtw3/yniNHW+DvLXbog: doesn't show hand 
*** SUMMARY ***
Total pot $5.25 | Rake $0.25 
Board [7h Kh 6c]
Seat 2: DihMHaz4WNETH1bPDe13kA folded before Flop (didn't bet)
Seat 3: JFIAqU8lCZ0vWwEl4bdGsg folded before Flop (didn't bet)
Seat 4: trN/oHqTTbPw5MNuKrOpLw (button) folded on the Flop
Seat 5: LyDHtw3/yniNHW+DvLXbog (small blind) collected ($5)
Seat 6: v+QfkGiuj9bgtuNoVnDO8w (big blind) folded before Flop




PokerStars Game #59941843596:  Hold'em No Limit ($0.10/$0.25) - 2009/07/01 1:47:55 ET
Table '4ZbiE0ZYjzqmgu6+sO1prg' 9-max Seat #5 is the button
Seat 1: eXiRSFoUjkV5taBc4N8rMQ ($9.45 in chips) 
Seat 2: 9lvO/qyU+xrU95Teu1fv0g ($5.20 in chips) 
Seat 3: HPEB+AtKw1+C/cxU0o1ciw ($25.20 in chips) 
Seat 4: w1ukf8uPa4+WH561TtVRxA ($25.25 in chips) 
Seat 5: +2kMBNpY4nF1qNCRd8SJLA ($43.60 in chips) 
Seat 7: aNpwfA31EREwO+ar4XzBCw ($26.05 in chips) 
Seat 8: cZ99hugmLBj9KhTlc8nCSw ($29.60 in chips) 
Seat 9: RCqMONFrSPSArZh2Jsar/w ($20.35 in chips) 
aNpwfA31EREwO+ar4XzBCw: posts small blind $0.10
cZ99hugmLBj9KhTlc8nCSw: posts big blind $0.25
*** HOLE CARDS ***
RCqMONFrSPSArZh2Jsar/w: folds 
eXiRSFoUjkV5taBc4N8rMQ: folds 
9lvO/qyU+xrU95Teu1fv0g: raises $0.75 to $1
HPEB+AtKw1+C/cxU0o1ciw: folds 
w1ukf8uPa4+WH561TtVRxA: folds 
+2kMBNpY4nF1qNCRd8SJLA: folds 
aNpwfA31EREwO+ar4XzBCw: folds 
cZ99hugmLBj9KhTlc8nCSw: folds 
Uncalled bet ($0.75) returned to 9lvO/qyU+xrU95Teu1fv0g
UmzixCpC0bAc1lDEjgB3NQ has returned
9lvO/qyU+xrU95Teu1fv0g collected $0.60 from pot
9lvO/qyU+xrU95Teu1fv0g: shows [Ac Ad] (a pair of Aces)
*** SUMMARY ***
Total pot $0.60 | Rake $0 
Seat 1: eXiRSFoUjkV5taBc4N8rMQ folded before Flop (didn't bet)
Seat 2: 9lvO/qyU+xrU95Teu1fv0g collected ($0.60)
Seat 3: HPEB+AtKw1+C/cxU0o1ciw folded before Flop (didn't bet)
Seat 4: w1ukf8uPa4+WH561TtVRxA folded before Flop (didn't bet)
Seat 5: +2kMBNpY4nF1qNCRd8SJLA (button) folded before Flop (didn't bet)
Seat 7: aNpwfA31EREwO+ar4XzBCw (small blind) folded before Flop
Seat 8: cZ99hugmLBj9KhTlc8nCSw (big blind) folded before Flop
Seat 9: RCqMONFrSPSArZh2Jsar/w folded before Flop (didn't bet)




PokerStars Game #59941843170:  Hold'em No Limit ($0.10/$0.25) - 2009/07/01 1:47:55 ET
Table 'x7YStLKc8hpt/pTgSetPKA' 9-max Seat #4 is the button
Seat 1: tYsOBqdU1+x+yFI7zHO7hQ ($25.90 in chips) 
Seat 3: S7Ki0P+0AIGPuIfGJjW0gg ($10.60 in chips) 
Seat 4: ydoFOVgzvZv9ZhuWu9rXAw ($4.80 in chips) 
Seat 5: tLcDklc2rBORNfixyRfVfw ($25 in chips) 
Seat 6: 9YN2IkT2JYYKFErZtZvCtA ($49.25 in chips) 
Seat 7: dtZ84flFEi4Q+SGrHMJRDQ ($26 in chips) 
Seat 8: j4q3p0lesp63b1gZDwLBZw ($5 in chips) 
Seat 9: nm4Dj/f+jJEwKVsUnKh73g ($37.20 in chips) 
tLcDklc2rBORNfixyRfVfw: posts small blind $0.10
9YN2IkT2JYYKFErZtZvCtA: posts big blind $0.25
*** HOLE CARDS ***
dtZ84flFEi4Q+SGrHMJRDQ: folds 
j4q3p0lesp63b1gZDwLBZw: folds 
nm4Dj/f+jJEwKVsUnKh73g: folds 
tYsOBqdU1+x+yFI7zHO7hQ: folds 
S7Ki0P+0AIGPuIfGJjW0gg: folds 
ydoFOVgzvZv9ZhuWu9rXAw: folds 
tLcDklc2rBORNfixyRfVfw: folds 
Uncalled bet ($0.15) returned to 9YN2IkT2JYYKFErZtZvCtA
9YN2IkT2JYYKFErZtZvCtA collected $0.20 from pot
9YN2IkT2JYYKFErZtZvCtA: doesn't show hand 
*** SUMMARY ***
Total pot $0.20 | Rake $0 
Seat 1: tYsOBqdU1+x+yFI7zHO7hQ folded before Flop (didn't bet)
Seat 3: S7Ki0P+0AIGPuIfGJjW0gg folded before Flop (didn't bet)
Seat 4: ydoFOVgzvZv9ZhuWu9rXAw (button) folded before Flop (didn't bet)
Seat 5: tLcDklc2rBORNfixyRfVfw (small blind) folded before Flop
Seat 6: 9YN2IkT2JYYKFErZtZvCtA (big blind) collected ($0.20)
Seat 7: dtZ84flFEi4Q+SGrHMJRDQ folded before Flop (didn't bet)
Seat 8: j4q3p0lesp63b1gZDwLBZw folded before Flop (didn't bet)
Seat 9: nm4Dj/f+jJEwKVsUnKh73g folded before Flop (didn't bet)




PokerStars Game #59941843126:  Hold'em No Limit ($0.10/$0.25) - 2009/07/01 1:47:55 ET
Table 'M7d9IrgQUUFFy/SZ3ksLYg' 6-max Seat #3 is the button
Seat 1: ypmjhffk/YHGc51wgVXUTw ($50.75 in chips) 
Seat 3: epAUIB7h2FJXzUPRIvSkRA ($25 in chips) 
Seat 4: 8ClCHtFXGNplITm+63KB+Q ($22.95 in chips) 
Seat 5: kMa8BltUcBQVxnHfqdCfXg ($8 in chips) 
8ClCHtFXGNplITm+63KB+Q: posts small blind $0.10
kMa8BltUcBQVxnHfqdCfXg: posts big blind $0.25
8CPg15X6IHYR1pWm9ha1Sw: sits out 
*** HOLE CARDS ***
ypmjhffk/YHGc51wgVXUTw: folds 
epAUIB7h2FJXzUPRIvSkRA: raises $0.75 to $1
8ClCHtFXGNplITm+63KB+Q: folds 
kMa8BltUcBQVxnHfqdCfXg: calls $0.75
*** FLOP *** [8s Kh 5d]
kMa8BltUcBQVxnHfqdCfXg: bets $0.25
epAUIB7h2FJXzUPRIvSkRA: raises $1.50 to $1.75
kMa8BltUcBQVxnHfqdCfXg: folds 
Uncalled bet ($1.50) returned to epAUIB7h2FJXzUPRIvSkRA
epAUIB7h2FJXzUPRIvSkRA collected $2.50 from pot
epAUIB7h2FJXzUPRIvSkRA: doesn't show hand 
*** SUMMARY ***
Total pot $2.60 | Rake $0.10 
Board [8s Kh 5d]
Seat 1: ypmjhffk/YHGc51wgVXUTw folded before Flop (didn't bet)
Seat 3: epAUIB7h2FJXzUPRIvSkRA (button) collected ($2.50)
Seat 4: 8ClCHtFXGNplITm+63KB+Q (small blind) folded before Flop
Seat 5: kMa8BltUcBQVxnHfqdCfXg (big blind) folded on the Flop




PokerStars Game #59941843502:  Hold'em No Limit ($0.10/$0.25) - 2009/07/01 1:47:55 ET
Table 'YONIZZNvg4uZ4xNUO1deeA' 6-max Seat #3 is the button
Seat 1: GbCVUNssQ7mqsPWr7J4d3w ($4.65 in chips) 
Seat 2: evMMX/0gSDH791KdSAOaSg ($17.20 in chips) 
Seat 3: Eksrep3hySi2jeDHuaWiOQ ($11 in chips) 
Seat 4: w43JQj2oYPpKQVG4Yzlq1w ($25.10 in chips) 
Seat 5: if4dh6jhJXeN3/qd3qCp9g ($25 in chips) 
Seat 6: eL3+wCBjFGfQ5FMdIZihwA ($27 in chips) 
w43JQj2oYPpKQVG4Yzlq1w: posts small blind $0.10
if4dh6jhJXeN3/qd3qCp9g: posts big blind $0.25
*** HOLE CARDS ***
eL3+wCBjFGfQ5FMdIZihwA: folds 
GbCVUNssQ7mqsPWr7J4d3w: folds 
evMMX/0gSDH791KdSAOaSg: raises $0.50 to $0.75
Eksrep3hySi2jeDHuaWiOQ: calls $0.75
w43JQj2oYPpKQVG4Yzlq1w: folds 
if4dh6jhJXeN3/qd3qCp9g: folds 
*** FLOP *** [Th Jh 7h]
evMMX/0gSDH791KdSAOaSg: checks 
Eksrep3hySi2jeDHuaWiOQ: bets $0.25
evMMX/0gSDH791KdSAOaSg: calls $0.25
*** TURN *** [Th Jh 7h] [Td]
evMMX/0gSDH791KdSAOaSg: checks 
Eksrep3hySi2jeDHuaWiOQ: checks 
*** RIVER *** [Th Jh 7h Td] [Qd]
evMMX/0gSDH791KdSAOaSg: checks 
Eksrep3hySi2jeDHuaWiOQ: checks 
*** SHOW DOWN ***
evMMX/0gSDH791KdSAOaSg: shows [Ac Js] (two pair, Jacks and Tens)
Eksrep3hySi2jeDHuaWiOQ: mucks hand 
evMMX/0gSDH791KdSAOaSg collected $2.25 from pot
*** SUMMARY ***
Total pot $2.35 | Rake $0.10 
Board [Th Jh 7h Td Qd]
Seat 1: GbCVUNssQ7mqsPWr7J4d3w folded before Flop (didn't bet)
Seat 2: evMMX/0gSDH791KdSAOaSg showed [Ac Js] and won ($2.25) with two pair, Jacks and Tens
Seat 3: Eksrep3hySi2jeDHuaWiOQ (button) mucked
Seat 4: w43JQj2oYPpKQVG4Yzlq1w (small blind) folded before Flop
Seat 5: if4dh6jhJXeN3/qd3qCp9g (big blind) folded before Flop
Seat 6: eL3+wCBjFGfQ5FMdIZihwA folded before Flop (didn't bet)




PokerStars Game #59941843446:  Hold'em No Limit ($0.10/$0.25) - 2009/07/01 1:47:55 ET
Table 'ukli1Y7ieC5JQMTEFxM2Nw' 6-max Seat #3 is the button
Seat 1: N162H80ZIQevUf2EzGahCA ($8.80 in chips) 
Seat 2: u/yN5P9f3KlATg6WLWNkBQ ($42.55 in chips) 
Seat 3: ExeoJ1G/rSmWa3tRz7TlCA ($23.10 in chips) 
Seat 4: if4dh6jhJXeN3/qd3qCp9g ($27.10 in chips) 
Seat 5: Se+H4Z4PDr6+eIUDJX1rpg ($17.65 in chips) 
Seat 6: 32YL2ZEp8NT4JB2RVM9euQ ($30.15 in chips) 
if4dh6jhJXeN3/qd3qCp9g: posts small blind $0.10
Se+H4Z4PDr6+eIUDJX1rpg: posts big blind $0.25
*** HOLE CARDS ***
32YL2ZEp8NT4JB2RVM9euQ: raises $0.75 to $1
N162H80ZIQevUf2EzGahCA: calls $1
u/yN5P9f3KlATg6WLWNkBQ: folds 
ExeoJ1G/rSmWa3tRz7TlCA: folds 
if4dh6jhJXeN3/qd3qCp9g: folds 
Se+H4Z4PDr6+eIUDJX1rpg: folds 
*** FLOP *** [Td 4c 7d]
32YL2ZEp8NT4JB2RVM9euQ: checks 
N162H80ZIQevUf2EzGahCA: checks 
*** TURN *** [Td 4c 7d] [3d]
32YL2ZEp8NT4JB2RVM9euQ: checks 
N162H80ZIQevUf2EzGahCA: checks 
*** RIVER *** [Td 4c 7d 3d] [8c]
32YL2ZEp8NT4JB2RVM9euQ: checks 
N162H80ZIQevUf2EzGahCA: checks 
*** SHOW DOWN ***
32YL2ZEp8NT4JB2RVM9euQ: shows [5d 5s] (a pair of Fives)
N162H80ZIQevUf2EzGahCA: mucks hand 
32YL2ZEp8NT4JB2RVM9euQ collected $2.25 from pot
*** SUMMARY ***
Total pot $2.35 | Rake $0.10 
Board [Td 4c 7d 3d 8c]
Seat 1: N162H80ZIQevUf2EzGahCA mucked
Seat 2: u/yN5P9f3KlATg6WLWNkBQ folded before Flop (didn't bet)
Seat 3: ExeoJ1G/rSmWa3tRz7TlCA (button) folded before Flop (didn't bet)
Seat 4: if4dh6jhJXeN3/qd3qCp9g (small blind) folded before Flop
Seat 5: Se+H4Z4PDr6+eIUDJX1rpg (big blind) folded before Flop
Seat 6: 32YL2ZEp8NT4JB2RVM9euQ showed [5d 5s] and won ($2.25) with a pair of Fives




PokerStars Game #59941844178:  Hold'em No Limit ($0.10/$0.25) - 2009/07/01 1:47:56 ET
Table 'eOXPe2c6mG7DOFKvMsZZfA' 6-max Seat #4 is the button
Seat 1: s21kVGMLPAoHdWR+muSonw ($26.25 in chips) 
Seat 2: gaPMxLGp9SOj4Lq6t+/0Ig ($7.10 in chips) 
Seat 3: kReyZ6g6Fu3tQ0nyjDf9kA ($25.35 in chips) 
Seat 4: zHHLkD2sRljslKKeQv/ZQw ($33.85 in chips) 
Seat 5: NhUN/JpAprdJeamFBgJH1w ($34.15 in chips) 
Seat 6: Qpv/hb5ak7LeaDig1L5L8w ($13.60 in chips) 
NhUN/JpAprdJeamFBgJH1w: posts small blind $0.10
Qpv/hb5ak7LeaDig1L5L8w: posts big blind $0.25
*** HOLE CARDS ***
s21kVGMLPAoHdWR+muSonw: folds 
gaPMxLGp9SOj4Lq6t+/0Ig: folds 
kReyZ6g6Fu3tQ0nyjDf9kA: folds 
zHHLkD2sRljslKKeQv/ZQw: raises $0.50 to $0.75
NhUN/JpAprdJeamFBgJH1w: folds 
Qpv/hb5ak7LeaDig1L5L8w: calls $0.50
*** FLOP *** [6s Th As]
Qpv/hb5ak7LeaDig1L5L8w: checks 
zHHLkD2sRljslKKeQv/ZQw: bets $1
Qpv/hb5ak7LeaDig1L5L8w: raises $1.50 to $2.50
zHHLkD2sRljslKKeQv/ZQw: folds 
Uncalled bet ($1.50) returned to Qpv/hb5ak7LeaDig1L5L8w
Qpv/hb5ak7LeaDig1L5L8w collected $3.45 from pot
*** SUMMARY ***
Total pot $3.60 | Rake $0.15 
Board [6s Th As]
Seat 1: s21kVGMLPAoHdWR+muSonw folded before Flop (didn't bet)
Seat 2: gaPMxLGp9SOj4Lq6t+/0Ig folded before Flop (didn't bet)
Seat 3: kReyZ6g6Fu3tQ0nyjDf9kA folded before Flop (didn't bet)
Seat 4: zHHLkD2sRljslKKeQv/ZQw (button) folded on the Flop
Seat 5: NhUN/JpAprdJeamFBgJH1w (small blind) folded before Flop
Seat 6: Qpv/hb5ak7LeaDig1L5L8w (big blind) collected ($3.45)




PokerStars Game #59941843670:  Hold'em No Limit ($0.10/$0.25) - 2009/07/01 1:47:56 ET
Table 'mk323gviqdkOY5Aek/1EWg' 6-max Seat #6 is the button
Seat 1: 7cx44/slbeTw+Cy7QB8Trg ($24.75 in chips) 
Seat 2: GC/9yVD59DUCX7hUI7gcLw ($55.65 in chips) 
Seat 3: NuqYPwTLZYQhxOoVK3Yqlw ($25 in chips) 
Seat 4: +baiVgI/ETnBARLe5mARCw ($11.55 in chips) 
Seat 5: kjYRzIfvZNNflYMYRkkSVA ($36.30 in chips) 
Seat 6: KkXSr5xFjxLSD3wtAvT+WQ ($8.65 in chips) 
7cx44/slbeTw+Cy7QB8Trg: posts small blind $0.10
GC/9yVD59DUCX7hUI7gcLw: posts big blind $0.25
*** HOLE CARDS ***
NuqYPwTLZYQhxOoVK3Yqlw: folds 
+baiVgI/ETnBARLe5mARCw: folds 
kjYRzIfvZNNflYMYRkkSVA: folds 
KkXSr5xFjxLSD3wtAvT+WQ: calls $0.25
7cx44/slbeTw+Cy7QB8Trg: folds 
GC/9yVD59DUCX7hUI7gcLw: checks 
*** FLOP *** [Qc 8h 8c]
GC/9yVD59DUCX7hUI7gcLw: checks 
KkXSr5xFjxLSD3wtAvT+WQ: checks 
*** TURN *** [Qc 8h 8c] [4c]
GC/9yVD59DUCX7hUI7gcLw: checks 
KkXSr5xFjxLSD3wtAvT+WQ: checks 
*** RIVER *** [Qc 8h 8c 4c] [As]
GC/9yVD59DUCX7hUI7gcLw: checks 
KkXSr5xFjxLSD3wtAvT+WQ: checks 
*** SHOW DOWN ***
GC/9yVD59DUCX7hUI7gcLw: shows [9d 5s] (a pair of Eights)
KkXSr5xFjxLSD3wtAvT+WQ: shows [Js 9h] (a pair of Eights - Ace+Queen+Jack kicker)
KkXSr5xFjxLSD3wtAvT+WQ collected $0.60 from pot
*** SUMMARY ***
Total pot $0.60 | Rake $0 
Board [Qc 8h 8c 4c As]
Seat 1: 7cx44/slbeTw+Cy7QB8Trg (small blind) folded before Flop
Seat 2: GC/9yVD59DUCX7hUI7gcLw (big blind) showed [9d 5s] and lost with a pair of Eights
Seat 3: NuqYPwTLZYQhxOoVK3Yqlw folded before Flop (didn't bet)
Seat 4: +baiVgI/ETnBARLe5mARCw folded before Flop (didn't bet)
Seat 5: kjYRzIfvZNNflYMYRkkSVA folded before Flop (didn't bet)
Seat 6: KkXSr5xFjxLSD3wtAvT+WQ (button) showed [Js 9h] and won ($0.60) with a pair of Eights




PokerStars Game #59941843834:  Hold'em No Limit ($0.10/$0.25) - 2009/07/01 1:47:56 ET
Table 'sgdCtiuCu2BDZhyDi6RzTA' 6-max Seat #1 is the button
Seat 1: 3zD3qLXT1bEffAoWGnc7wg ($35.40 in chips) 
Seat 2: XD1i5m5PvBDnRzJaG/vINw ($23.80 in chips) 
Seat 3: eL3+wCBjFGfQ5FMdIZihwA ($25.50 in chips) 
Seat 4: rVKEgilmMX+EkKzDVvhmxA ($7.10 in chips) 
Seat 5: 0tQitW75xfmVWKldYHjmOQ ($3.05 in chips) 
Seat 6: KODslGU8ikCYS0/29dUkhg ($35.05 in chips) 
XD1i5m5PvBDnRzJaG/vINw: posts small blind $0.10
eL3+wCBjFGfQ5FMdIZihwA: posts big blind $0.25
*** HOLE CARDS ***
rVKEgilmMX+EkKzDVvhmxA: folds 
0tQitW75xfmVWKldYHjmOQ: folds 
KODslGU8ikCYS0/29dUkhg: calls $0.25
3zD3qLXT1bEffAoWGnc7wg: folds 
XD1i5m5PvBDnRzJaG/vINw: folds 
eL3+wCBjFGfQ5FMdIZihwA: checks 
*** FLOP *** [6c Ks 3c]
eL3+wCBjFGfQ5FMdIZihwA: checks 
KODslGU8ikCYS0/29dUkhg: checks 
*** TURN *** [6c Ks 3c] [3d]
eL3+wCBjFGfQ5FMdIZihwA: bets $0.50
KODslGU8ikCYS0/29dUkhg: calls $0.50
*** RIVER *** [6c Ks 3c 3d] [8c]
eL3+wCBjFGfQ5FMdIZihwA: bets $1.50
KODslGU8ikCYS0/29dUkhg: calls $1.50
*** SHOW DOWN ***
eL3+wCBjFGfQ5FMdIZihwA: shows [6d 6s] (a full house, Sixes full of Threes)
KODslGU8ikCYS0/29dUkhg: mucks hand 
eL3+wCBjFGfQ5FMdIZihwA collected $4.40 from pot
*** SUMMARY ***
Total pot $4.60 | Rake $0.20 
Board [6c Ks 3c 3d 8c]
Seat 1: 3zD3qLXT1bEffAoWGnc7wg (button) folded before Flop (didn't bet)
Seat 2: XD1i5m5PvBDnRzJaG/vINw (small blind) folded before Flop
Seat 3: eL3+wCBjFGfQ5FMdIZihwA (big blind) showed [6d 6s] and won ($4.40) with a full house, Sixes full of Threes
Seat 4: rVKEgilmMX+EkKzDVvhmxA folded before Flop (didn't bet)
Seat 5: 0tQitW75xfmVWKldYHjmOQ folded before Flop (didn't bet)
Seat 6: KODslGU8ikCYS0/29dUkhg mucked




PokerStars Game #59941844180:  Hold'em No Limit ($0.10/$0.25) - 2009/07/01 1:47:56 ET
Table '9SExUHslNkrPJ4XsrePaVw' 9-max Seat #5 is the button
Seat 1: RHqgdFvufLCYe54+qd2gcA ($4.50 in chips) 
Seat 2: cZ99hugmLBj9KhTlc8nCSw ($44.10 in chips) 
Seat 3: EP17SQz/iWcuYdNOGeBgkw ($13.80 in chips) 
Seat 4: 4awUyiDYTgylQKXZ9faBVA ($25 in chips) 
Seat 5: L+eJnUyhY8bMNYw755K8XQ ($15.40 in chips) 
Seat 6: YPJ90cgNXDABdYJcqmwB0A ($20.70 in chips) 
Seat 8: tLcDklc2rBORNfixyRfVfw ($25.35 in chips) 
Seat 9: /THNzAxdv2lBxcf4XTj/0g ($9.35 in chips) 
YPJ90cgNXDABdYJcqmwB0A: posts small blind $0.10
tLcDklc2rBORNfixyRfVfw: posts big blind $0.25
*** HOLE CARDS ***
/THNzAxdv2lBxcf4XTj/0g: folds 
RHqgdFvufLCYe54+qd2gcA: folds 
cZ99hugmLBj9KhTlc8nCSw: folds 
EP17SQz/iWcuYdNOGeBgkw: folds 
4awUyiDYTgylQKXZ9faBVA: raises $0.75 to $1
L+eJnUyhY8bMNYw755K8XQ: folds 
YPJ90cgNXDABdYJcqmwB0A: folds 
tLcDklc2rBORNfixyRfVfw: raises $2 to $3
sx0lGrkT9fd4yFR+3cXUQg joins the table at seat #7 
4awUyiDYTgylQKXZ9faBVA: folds 
Uncalled bet ($2) returned to tLcDklc2rBORNfixyRfVfw
tLcDklc2rBORNfixyRfVfw collected $2.10 from pot
tLcDklc2rBORNfixyRfVfw: doesn't show hand 
*** SUMMARY ***
Total pot $2.10 | Rake $0 
Seat 1: RHqgdFvufLCYe54+qd2gcA folded before Flop (didn't bet)
Seat 2: cZ99hugmLBj9KhTlc8nCSw folded before Flop (didn't bet)
Seat 3: EP17SQz/iWcuYdNOGeBgkw folded before Flop (didn't bet)
Seat 4: 4awUyiDYTgylQKXZ9faBVA folded before Flop
Seat 5: L+eJnUyhY8bMNYw755K8XQ (button) folded before Flop (didn't bet)
Seat 6: YPJ90cgNXDABdYJcqmwB0A (small blind) folded before Flop
Seat 8: tLcDklc2rBORNfixyRfVfw (big blind) collected ($2.10)
Seat 9: /THNzAxdv2lBxcf4XTj/0g folded before Flop (didn't bet)




PokerStars Game #59941843952:  Hold'em No Limit ($0.10/$0.25) - 2009/07/01 1:47:56 ET
Table 'ykyWGjhNu7AvZXov27T4ew' 9-max Seat #1 is the button
Seat 1: skUI2T7o4P1rz460mMbAOg ($10.25 in chips) 
Seat 2: MG90wfSJZnOejs/KD3vlQQ ($39.35 in chips) 
Seat 3: NPI9ArW8kwrb6a2IAL6xMQ ($27.20 in chips) 
Seat 4: W6tExOcYX7qiy6Qdp+ZwFA ($5.90 in chips) 
Seat 5: CmngQmkKTp8tkl6GMRTl6w ($8.50 in chips) 
Seat 6: AiXn/9o1EwOPZUHujnh/bA ($20.15 in chips) 
Seat 7: npAYqa85pqnzfOK5ukX+BQ ($21.30 in chips) 
Seat 8: tYsOBqdU1+x+yFI7zHO7hQ ($48.85 in chips) 
Seat 9: wk9M6R3w+aDHpr8WV87RmQ ($11.25 in chips) 
MG90wfSJZnOejs/KD3vlQQ: posts small blind $0.10
NPI9ArW8kwrb6a2IAL6xMQ: posts big blind $0.25
wk9M6R3w+aDHpr8WV87RmQ: posts small & big blinds $0.35
*** HOLE CARDS ***
W6tExOcYX7qiy6Qdp+ZwFA: folds 
CmngQmkKTp8tkl6GMRTl6w: folds 
AiXn/9o1EwOPZUHujnh/bA: folds 
npAYqa85pqnzfOK5ukX+BQ: folds 
tYsOBqdU1+x+yFI7zHO7hQ: folds 
wk9M6R3w+aDHpr8WV87RmQ: checks 
skUI2T7o4P1rz460mMbAOg: folds 
MG90wfSJZnOejs/KD3vlQQ: calls $0.15
NPI9ArW8kwrb6a2IAL6xMQ: raises $0.25 to $0.50
wk9M6R3w+aDHpr8WV87RmQ: calls $0.25
MG90wfSJZnOejs/KD3vlQQ: calls $0.25
*** FLOP *** [2s 7s Kc]
MG90wfSJZnOejs/KD3vlQQ: checks 
NPI9ArW8kwrb6a2IAL6xMQ: bets $0.25
wk9M6R3w+aDHpr8WV87RmQ: folds 
MG90wfSJZnOejs/KD3vlQQ: folds 
Uncalled bet ($0.25) returned to NPI9ArW8kwrb6a2IAL6xMQ
NPI9ArW8kwrb6a2IAL6xMQ collected $1.55 from pot
*** SUMMARY ***
Total pot $1.60 | Rake $0.05 
Board [2s 7s Kc]
Seat 1: skUI2T7o4P1rz460mMbAOg (button) folded before Flop (didn't bet)
Seat 2: MG90wfSJZnOejs/KD3vlQQ (small blind) folded on the Flop
Seat 3: NPI9ArW8kwrb6a2IAL6xMQ (big blind) collected ($1.55)
Seat 4: W6tExOcYX7qiy6Qdp+ZwFA folded before Flop (didn't bet)
Seat 5: CmngQmkKTp8tkl6GMRTl6w folded before Flop (didn't bet)
Seat 6: AiXn/9o1EwOPZUHujnh/bA folded before Flop (didn't bet)
Seat 7: npAYqa85pqnzfOK5ukX+BQ folded before Flop (didn't bet)
Seat 8: tYsOBqdU1+x+yFI7zHO7hQ folded before Flop (didn't bet)
Seat 9: wk9M6R3w+aDHpr8WV87RmQ folded on the Flop




PokerStars Game #59941844088:  Hold'em No Limit ($0.10/$0.25) - 2009/07/01 1:47:56 ET
Table 'Utmw+yX+E/wdhNDIim90lQ' 9-max Seat #5 is the button
Seat 1: cZ99hugmLBj9KhTlc8nCSw ($31.95 in chips) 
Seat 2: iGMlK+EhUflPB6jKQd95Cg ($27.35 in chips) 
Seat 3: dfNim92Z6XK1/h5SFW5vDg ($25 in chips) 
Seat 4: ifYGvZDHQQ0aam4awTtHwA ($25.85 in chips) 
Seat 5: ghNKXUBl/H+t83JF079ZBA ($25 in chips) 
Seat 6: OlPJsgR4xypSg/w1z7Gyvw ($34.15 in chips) 
Seat 7: CImUHesK+ZER4v/VCA9IUg ($49.80 in chips) 
Seat 8: Mh2r9hTeTEDnh19sRZtW3g ($5 in chips) 
Seat 9: Th3FldXKQW6hWVVPahaoOQ ($27.50 in chips) 
OlPJsgR4xypSg/w1z7Gyvw: posts small blind $0.10
CImUHesK+ZER4v/VCA9IUg: posts big blind $0.25
*** HOLE CARDS ***
Mh2r9hTeTEDnh19sRZtW3g: folds 
Th3FldXKQW6hWVVPahaoOQ: folds 
cZ99hugmLBj9KhTlc8nCSw: folds 
iGMlK+EhUflPB6jKQd95Cg: folds 
dfNim92Z6XK1/h5SFW5vDg: raises $0.75 to $1
ifYGvZDHQQ0aam4awTtHwA: calls $1
ghNKXUBl/H+t83JF079ZBA: calls $1
OlPJsgR4xypSg/w1z7Gyvw: calls $0.90
CImUHesK+ZER4v/VCA9IUg: folds 
*** FLOP *** [Ah Kc 2h]
OlPJsgR4xypSg/w1z7Gyvw: checks 
dfNim92Z6XK1/h5SFW5vDg: checks 
ifYGvZDHQQ0aam4awTtHwA: bets $2
ghNKXUBl/H+t83JF079ZBA: folds 
OlPJsgR4xypSg/w1z7Gyvw: folds 
dfNim92Z6XK1/h5SFW5vDg: folds 
Uncalled bet ($2) returned to ifYGvZDHQQ0aam4awTtHwA
ifYGvZDHQQ0aam4awTtHwA collected $4.05 from pot
*** SUMMARY ***
Total pot $4.25 | Rake $0.20 
Board [Ah Kc 2h]
Seat 1: cZ99hugmLBj9KhTlc8nCSw folded before Flop (didn't bet)
Seat 2: iGMlK+EhUflPB6jKQd95Cg folded before Flop (didn't bet)
Seat 3: dfNim92Z6XK1/h5SFW5vDg folded on the Flop
Seat 4: ifYGvZDHQQ0aam4awTtHwA collected ($4.05)
Seat 5: ghNKXUBl/H+t83JF079ZBA (button) folded on the Flop
Seat 6: OlPJsgR4xypSg/w1z7Gyvw (small blind) folded on the Flop
Seat 7: CImUHesK+ZER4v/VCA9IUg (big blind) folded before Flop
Seat 8: Mh2r9hTeTEDnh19sRZtW3g folded before Flop (didn't bet)
Seat 9: Th3FldXKQW6hWVVPahaoOQ folded before Flop (didn't bet)




PokerStars Game #59941844300:  Hold'em No Limit ($0.10/$0.25) - 2009/07/01 1:47:57 ET
Table '9lYs7ljXi6AgFAxYHlKLJw' 9-max Seat #9 is the button
Seat 1: K0b5wNInj6hUGRr6yzKFtw ($36.90 in chips) 
Seat 2: 0XACOSNrAWmqNv9k1nF8rw ($16.70 in chips) 
Seat 3: arxNSjreDRGFg13EAM2F1w ($33.45 in chips) 
Seat 4: UANt6y/SmDCY/jIxkBixcw ($33 in chips) 
Seat 5: dfNim92Z6XK1/h5SFW5vDg ($51.95 in chips) 
Seat 6: tYsOBqdU1+x+yFI7zHO7hQ ($25 in chips) 
Seat 7: ghNKXUBl/H+t83JF079ZBA ($28.05 in chips) 
Seat 8: 9YN2IkT2JYYKFErZtZvCtA ($18.60 in chips) 
Seat 9: cKlmpQMahVsmOaxFQDcoOg ($18.65 in chips) 
K0b5wNInj6hUGRr6yzKFtw: posts small blind $0.10
0XACOSNrAWmqNv9k1nF8rw: posts big blind $0.25
*** HOLE CARDS ***
arxNSjreDRGFg13EAM2F1w: folds 
UANt6y/SmDCY/jIxkBixcw: folds 
dfNim92Z6XK1/h5SFW5vDg: calls $0.25
tYsOBqdU1+x+yFI7zHO7hQ: folds 
ghNKXUBl/H+t83JF079ZBA: calls $0.25
9YN2IkT2JYYKFErZtZvCtA: folds 
cKlmpQMahVsmOaxFQDcoOg: folds 
K0b5wNInj6hUGRr6yzKFtw: calls $0.15
0XACOSNrAWmqNv9k1nF8rw: checks 
*** FLOP *** [3s 2d Tc]
K0b5wNInj6hUGRr6yzKFtw: checks 
0XACOSNrAWmqNv9k1nF8rw: checks 
dfNim92Z6XK1/h5SFW5vDg: checks 
ghNKXUBl/H+t83JF079ZBA: bets $0.75
K0b5wNInj6hUGRr6yzKFtw: folds 
0XACOSNrAWmqNv9k1nF8rw: folds 
dfNim92Z6XK1/h5SFW5vDg: folds 
Uncalled bet ($0.75) returned to ghNKXUBl/H+t83JF079ZBA
ghNKXUBl/H+t83JF079ZBA collected $0.95 from pot
ghNKXUBl/H+t83JF079ZBA: doesn't show hand 
*** SUMMARY ***
Total pot $1 | Rake $0.05 
Board [3s 2d Tc]
Seat 1: K0b5wNInj6hUGRr6yzKFtw (small blind) folded on the Flop
Seat 2: 0XACOSNrAWmqNv9k1nF8rw (big blind) folded on the Flop
Seat 3: arxNSjreDRGFg13EAM2F1w folded before Flop (didn't bet)
Seat 4: UANt6y/SmDCY/jIxkBixcw folded before Flop (didn't bet)
Seat 5: dfNim92Z6XK1/h5SFW5vDg folded on the Flop
Seat 6: tYsOBqdU1+x+yFI7zHO7hQ folded before Flop (didn't bet)
Seat 7: ghNKXUBl/H+t83JF079ZBA collected ($0.95)
Seat 8: 9YN2IkT2JYYKFErZtZvCtA folded before Flop (didn't bet)
Seat 9: cKlmpQMahVsmOaxFQDcoOg (button) folded before Flop (didn't bet)




PokerStars Game #59941844434:  Hold'em No Limit ($0.10/$0.25) - 2009/07/01 1:47:57 ET
Table 'hOE09W281uSob0XeJmUcRg' 6-max Seat #2 is the button
Seat 1: mfrkWA3PTeYPkbO6hi98Aw ($26.95 in chips) 
Seat 2: lRKJ8o/CnOPFwfHHm6ioMw ($12.80 in chips) 
Seat 3: y+a/yGW/Jy4bPJFnaeTz5w ($13.35 in chips) 
Seat 5: JFIAqU8lCZ0vWwEl4bdGsg ($26.15 in chips) 
Seat 6: x4ZJ8E/TUrtoB7WiHcv8WA ($16.10 in chips) 
y+a/yGW/Jy4bPJFnaeTz5w: posts small blind $0.10
JFIAqU8lCZ0vWwEl4bdGsg: posts big blind $0.25
*** HOLE CARDS ***
x4ZJ8E/TUrtoB7WiHcv8WA: folds 
mfrkWA3PTeYPkbO6hi98Aw: folds 
lRKJ8o/CnOPFwfHHm6ioMw: calls $0.25
y+a/yGW/Jy4bPJFnaeTz5w: calls $0.15
JFIAqU8lCZ0vWwEl4bdGsg: checks 
*** FLOP *** [6c 8s 3h]
y+a/yGW/Jy4bPJFnaeTz5w: checks 
JFIAqU8lCZ0vWwEl4bdGsg: checks 
lRKJ8o/CnOPFwfHHm6ioMw: checks 
*** TURN *** [6c 8s 3h] [6d]
y+a/yGW/Jy4bPJFnaeTz5w: checks 
JFIAqU8lCZ0vWwEl4bdGsg: checks 
lRKJ8o/CnOPFwfHHm6ioMw: checks 
*** RIVER *** [6c 8s 3h 6d] [7h]
y+a/yGW/Jy4bPJFnaeTz5w: checks 
JFIAqU8lCZ0vWwEl4bdGsg: checks 
lRKJ8o/CnOPFwfHHm6ioMw: checks 
*** SHOW DOWN ***
y+a/yGW/Jy4bPJFnaeTz5w: shows [Ks 9s] (a pair of Sixes)
JFIAqU8lCZ0vWwEl4bdGsg: shows [Td Ac] (a pair of Sixes - Ace kicker)
lRKJ8o/CnOPFwfHHm6ioMw: mucks hand 
JFIAqU8lCZ0vWwEl4bdGsg collected $0.75 from pot
*** SUMMARY ***
Total pot $0.75 | Rake $0 
Board [6c 8s 3h 6d 7h]
Seat 1: mfrkWA3PTeYPkbO6hi98Aw folded before Flop (didn't bet)
Seat 2: lRKJ8o/CnOPFwfHHm6ioMw (button) mucked
Seat 3: y+a/yGW/Jy4bPJFnaeTz5w (small blind) showed [Ks 9s] and lost with a pair of Sixes
Seat 5: JFIAqU8lCZ0vWwEl4bdGsg (big blind) showed [Td Ac] and won ($0.75) with a pair of Sixes
Seat 6: x4ZJ8E/TUrtoB7WiHcv8WA folded before Flop (didn't bet)




PokerStars Game #59941844544:  Hold'em No Limit ($0.10/$0.25) - 2009/07/01 1:47:57 ET
Table 'wPWRBZPJl1HAnysw7qRR0A' 6-max Seat #3 is the button
Seat 1: m7ne1MOFTQXlsXT7/R/rug ($6.40 in chips) 
Seat 2: xC0kaiDYM6YTlgODL83O5A ($14.65 in chips) 
Seat 3: 1ZpoLWO2nm2w1Nd1v9Sr3g ($8.05 in chips) 
Seat 4: epAUIB7h2FJXzUPRIvSkRA ($52.90 in chips) 
Seat 5: y0B+UpYpOUJz3JWtlJQBSA ($15.75 in chips) 
epAUIB7h2FJXzUPRIvSkRA: posts small blind $0.10
y0B+UpYpOUJz3JWtlJQBSA: posts big blind $0.25
*** HOLE CARDS ***
Voldemort219 leaves the table
m7ne1MOFTQXlsXT7/R/rug: calls $0.25
VXTONriS+Ohik+r0FeicIw joins the table at seat #6 
xC0kaiDYM6YTlgODL83O5A: folds 
1ZpoLWO2nm2w1Nd1v9Sr3g: raises $1 to $1.25
epAUIB7h2FJXzUPRIvSkRA: folds 
y0B+UpYpOUJz3JWtlJQBSA: folds 
m7ne1MOFTQXlsXT7/R/rug: raises $5.15 to $6.40 and is all-in
1ZpoLWO2nm2w1Nd1v9Sr3g: calls $5.15
*** FLOP *** [8s Td 4h]
*** TURN *** [8s Td 4h] [3c]
*** RIVER *** [8s Td 4h 3c] [Jh]
*** SHOW DOWN ***
m7ne1MOFTQXlsXT7/R/rug: shows [5s 5c] (a pair of Fives)
1ZpoLWO2nm2w1Nd1v9Sr3g: mucks hand 
m7ne1MOFTQXlsXT7/R/rug collected $12.50 from pot
*** SUMMARY ***
Total pot $13.15 | Rake $0.65 
Board [8s Td 4h 3c Jh]
Seat 1: m7ne1MOFTQXlsXT7/R/rug showed [5s 5c] and won ($12.50) with a pair of Fives
Seat 2: xC0kaiDYM6YTlgODL83O5A folded before Flop (didn't bet)
Seat 3: 1ZpoLWO2nm2w1Nd1v9Sr3g (button) mucked
Seat 4: epAUIB7h2FJXzUPRIvSkRA (small blind) folded before Flop
Seat 5: y0B+UpYpOUJz3JWtlJQBSA (big blind) folded before Flop




PokerStars Game #59941844546:  Hold'em No Limit ($0.10/$0.25) - 2009/07/01 1:47:57 ET
Table 'DhkrdW2UOy2PfjSW28Kq8w' 6-max Seat #6 is the button
Seat 2: v+QfkGiuj9bgtuNoVnDO8w ($27.40 in chips) 
Seat 3: B3X187C0tXFUfQpCu8pe8A ($18.90 in chips) 
Seat 4: 59HJSCM1X37BkMpI9N0mEw ($25 in chips) 
Seat 5: cS21pIxRHx5Gt42o7hPZzw ($11.70 in chips) 
Seat 6: DihMHaz4WNETH1bPDe13kA ($27.10 in chips) 
Mhj3q7cxev+XjXZxEE6/Cw will be allowed to play after the button
v+QfkGiuj9bgtuNoVnDO8w: posts small blind $0.10
B3X187C0tXFUfQpCu8pe8A: posts big blind $0.25
59HJSCM1X37BkMpI9N0mEw: posts small & big blinds $0.35
cS21pIxRHx5Gt42o7hPZzw: posts big blind $0.25
*** HOLE CARDS ***
59HJSCM1X37BkMpI9N0mEw: checks 
cS21pIxRHx5Gt42o7hPZzw: checks 
DihMHaz4WNETH1bPDe13kA: folds 
v+QfkGiuj9bgtuNoVnDO8w: folds 
B3X187C0tXFUfQpCu8pe8A: checks 
*** FLOP *** [Jd 3s 4h]
B3X187C0tXFUfQpCu8pe8A: checks 
59HJSCM1X37BkMpI9N0mEw: checks 
cS21pIxRHx5Gt42o7hPZzw: checks 
*** TURN *** [Jd 3s 4h] [6c]
B3X187C0tXFUfQpCu8pe8A: checks 
59HJSCM1X37BkMpI9N0mEw: checks 
cS21pIxRHx5Gt42o7hPZzw: checks 
*** RIVER *** [Jd 3s 4h 6c] [3d]
B3X187C0tXFUfQpCu8pe8A: checks 
59HJSCM1X37BkMpI9N0mEw: bets $0.25
cS21pIxRHx5Gt42o7hPZzw: folds 
B3X187C0tXFUfQpCu8pe8A: calls $0.25
*** SHOW DOWN ***
59HJSCM1X37BkMpI9N0mEw: shows [4s 9c] (two pair, Fours and Threes)
B3X187C0tXFUfQpCu8pe8A: shows [6s 8s] (two pair, Sixes and Threes)
B3X187C0tXFUfQpCu8pe8A collected $1.40 from pot
*** SUMMARY ***
Total pot $1.45 | Rake $0.05 
Board [Jd 3s 4h 6c 3d]
Seat 2: v+QfkGiuj9bgtuNoVnDO8w (small blind) folded before Flop
Seat 3: B3X187C0tXFUfQpCu8pe8A (big blind) showed [6s 8s] and won ($1.40) with two pair, Sixes and Threes
Seat 4: 59HJSCM1X37BkMpI9N0mEw showed [4s 9c] and lost with two pair, Fours and Threes
Seat 5: cS21pIxRHx5Gt42o7hPZzw folded on the River
Seat 6: DihMHaz4WNETH1bPDe13kA (button) folded before Flop (didn't bet)




PokerStars Game #59941844320:  Hold'em No Limit ($0.10/$0.25) - 2009/07/01 1:47:57 ET
Table '6wawJ+MkkvuC3coG6r+Yhg' 6-max Seat #2 is the button
Seat 1: JQZew0FjzS19kTjeNtrE+A ($19.85 in chips) 
Seat 2: LtASJ9OlkqGrrUKGQlpGAw ($33.80 in chips) 
Seat 3: 3zD3qLXT1bEffAoWGnc7wg ($61.35 in chips) 
Seat 4: yxmjNFGiKI3b+XQGJzJVIg ($34.05 in chips) 
Seat 5: FZrgDbxAanC1xwZxXHJKVA ($4.30 in chips) 
Seat 6: B3X187C0tXFUfQpCu8pe8A ($25.15 in chips) 
3zD3qLXT1bEffAoWGnc7wg: posts small blind $0.10
yxmjNFGiKI3b+XQGJzJVIg: posts big blind $0.25
*** HOLE CARDS ***
FZrgDbxAanC1xwZxXHJKVA: folds 
B3X187C0tXFUfQpCu8pe8A: folds 
JQZew0FjzS19kTjeNtrE+A: folds 
LtASJ9OlkqGrrUKGQlpGAw: folds 
3zD3qLXT1bEffAoWGnc7wg: folds 
Uncalled bet ($0.15) returned to yxmjNFGiKI3b+XQGJzJVIg
yxmjNFGiKI3b+XQGJzJVIg collected $0.20 from pot
yxmjNFGiKI3b+XQGJzJVIg is sitting out
*** SUMMARY ***
Total pot $0.20 | Rake $0 
Seat 1: JQZew0FjzS19kTjeNtrE+A folded before Flop (didn't bet)
Seat 2: LtASJ9OlkqGrrUKGQlpGAw (button) folded before Flop (didn't bet)
Seat 3: 3zD3qLXT1bEffAoWGnc7wg (small blind) folded before Flop
Seat 4: yxmjNFGiKI3b+XQGJzJVIg (big blind) collected ($0.20)
Seat 5: FZrgDbxAanC1xwZxXHJKVA folded before Flop (didn't bet)
Seat 6: B3X187C0tXFUfQpCu8pe8A folded before Flop (didn't bet)




PokerStars Game #59941844246:  Hold'em No Limit ($0.10/$0.25) - 2009/07/01 1:47:57 ET
Table 'nlpa8xI95gAflovnFxB2yg' 6-max Seat #5 is the button
Seat 1: fZQg9veL7Dd/Z04ZTjC+wQ ($61.80 in chips) 
Seat 2: Yuyy/pDz3yAO3EbHYRYnKw ($24.15 in chips) 
Seat 3: DihMHaz4WNETH1bPDe13kA ($25 in chips) 
Seat 4: if4dh6jhJXeN3/qd3qCp9g ($52 in chips) 
Seat 5: FDWzjQgBA5K04jOIY/j22w ($6.40 in chips) 
Seat 6: ATNFxN8fYVfSZMQW8dvbvw ($5.75 in chips) 
ATNFxN8fYVfSZMQW8dvbvw: posts small blind $0.10
fZQg9veL7Dd/Z04ZTjC+wQ: posts big blind $0.25
*** HOLE CARDS ***
Yuyy/pDz3yAO3EbHYRYnKw: folds 
DihMHaz4WNETH1bPDe13kA: folds 
if4dh6jhJXeN3/qd3qCp9g: folds 
FDWzjQgBA5K04jOIY/j22w: raises $0.25 to $0.50
ATNFxN8fYVfSZMQW8dvbvw: calls $0.40
fZQg9veL7Dd/Z04ZTjC+wQ: folds 
*** FLOP *** [5d 9d 4h]
ATNFxN8fYVfSZMQW8dvbvw: checks 
FDWzjQgBA5K04jOIY/j22w: bets $0.80
ATNFxN8fYVfSZMQW8dvbvw: folds 
Uncalled bet ($0.80) returned to FDWzjQgBA5K04jOIY/j22w
FDWzjQgBA5K04jOIY/j22w collected $1.20 from pot
FDWzjQgBA5K04jOIY/j22w: doesn't show hand 
*** SUMMARY ***
Total pot $1.25 | Rake $0.05 
Board [5d 9d 4h]
Seat 1: fZQg9veL7Dd/Z04ZTjC+wQ (big blind) folded before Flop
Seat 2: Yuyy/pDz3yAO3EbHYRYnKw folded before Flop (didn't bet)
Seat 3: DihMHaz4WNETH1bPDe13kA folded before Flop (didn't bet)
Seat 4: if4dh6jhJXeN3/qd3qCp9g folded before Flop (didn't bet)
Seat 5: FDWzjQgBA5K04jOIY/j22w (button) collected ($1.20)
Seat 6: ATNFxN8fYVfSZMQW8dvbvw (small blind) folded on the Flop




PokerStars Game #59941844944:  Hold'em No Limit ($0.10/$0.25) - 2009/07/01 1:47:58 ET
Table 'xPn6TS/y/OWkX7Qa+MUuKA' 6-max Seat #3 is the button
Seat 1: JFIAqU8lCZ0vWwEl4bdGsg ($42.70 in chips) 
Seat 2: buyjetgNT1McXtdaP4zynA ($27.95 in chips) 
Seat 3: q6WfTUAD9mowIP63ASq2Dg ($24.15 in chips) 
Seat 4: SS/yfeArhULzIcOPe8MdPg ($28.40 in chips) 
Seat 5: lquriepNQBhDV5P1SWHhnA ($28.60 in chips) 
Seat 6: DihMHaz4WNETH1bPDe13kA ($25 in chips) 
SS/yfeArhULzIcOPe8MdPg: posts small blind $0.10
lquriepNQBhDV5P1SWHhnA: posts big blind $0.25
*** HOLE CARDS ***
DihMHaz4WNETH1bPDe13kA: folds 
JFIAqU8lCZ0vWwEl4bdGsg: folds 
buyjetgNT1McXtdaP4zynA: calls $0.25
q6WfTUAD9mowIP63ASq2Dg: folds 
SS/yfeArhULzIcOPe8MdPg: folds 
lquriepNQBhDV5P1SWHhnA: checks 
*** FLOP *** [Jc 4h Ts]
lquriepNQBhDV5P1SWHhnA: checks 
buyjetgNT1McXtdaP4zynA: checks 
*** TURN *** [Jc 4h Ts] [5h]
lquriepNQBhDV5P1SWHhnA: checks 
buyjetgNT1McXtdaP4zynA: checks 
*** RIVER *** [Jc 4h Ts 5h] [5s]
lquriepNQBhDV5P1SWHhnA: bets $0.50
buyjetgNT1McXtdaP4zynA: folds 
Uncalled bet ($0.50) returned to lquriepNQBhDV5P1SWHhnA
lquriepNQBhDV5P1SWHhnA collected $0.60 from pot
lquriepNQBhDV5P1SWHhnA: doesn't show hand 
*** SUMMARY ***
Total pot $0.60 | Rake $0 
Board [Jc 4h Ts 5h 5s]
Seat 1: JFIAqU8lCZ0vWwEl4bdGsg folded before Flop (didn't bet)
Seat 2: buyjetgNT1McXtdaP4zynA folded on the River
Seat 3: q6WfTUAD9mowIP63ASq2Dg (button) folded before Flop (didn't bet)
Seat 4: SS/yfeArhULzIcOPe8MdPg (small blind) folded before Flop
Seat 5: lquriepNQBhDV5P1SWHhnA (big blind) collected ($0.60)
Seat 6: DihMHaz4WNETH1bPDe13kA folded before Flop (didn't bet)




PokerStars Game #59941845148:  Hold'em No Limit ($0.10/$0.25) - 2009/07/01 1:47:58 ET
Table 'UVjmXTtsmlX1HxwwZ59akg' 9-max Seat #2 is the button
Seat 1: zDrucyjVn5aeekNEc3cJrA ($47.85 in chips) 
Seat 2: q+Qdg0Hoir+SyL7haBrUnw ($7.80 in chips) 
Seat 3: GmzfAfxcxu1kGbPC+9LkVg ($24.40 in chips) 
Seat 5: Bb42QRQMhg5/Y0vHP8/2Xw ($39.95 in chips) 
Seat 6: st9jtdNbm1W5GfBwRaCVqQ ($27.60 in chips) 
Seat 7: d7YasxuGLPiL7pj8IcGThw ($4.75 in chips) 
Seat 9: ljemhp25Zg+nlA9DLCIiUw ($25.25 in chips) 
GmzfAfxcxu1kGbPC+9LkVg: posts small blind $0.10
X78b5v/uhqeXXoAijbw/yg: is sitting out 
Bb42QRQMhg5/Y0vHP8/2Xw: posts big blind $0.25
zDrucyjVn5aeekNEc3cJrA: posts small & big blinds $0.35
*** HOLE CARDS ***
X78b5v/uhqeXXoAijbw/yg leaves the table
st9jtdNbm1W5GfBwRaCVqQ: folds 
d7YasxuGLPiL7pj8IcGThw: folds 
ljemhp25Zg+nlA9DLCIiUw: folds 
zDrucyjVn5aeekNEc3cJrA: checks 
18G4P1XstjNvItdGUITxgw joins the table at seat #4 
q+Qdg0Hoir+SyL7haBrUnw: folds 
GmzfAfxcxu1kGbPC+9LkVg: calls $0.15
Bb42QRQMhg5/Y0vHP8/2Xw: checks 
*** FLOP *** [Ac As Ah]
GmzfAfxcxu1kGbPC+9LkVg: checks 
Bb42QRQMhg5/Y0vHP8/2Xw: checks 
d7YasxuGLPiL7pj8IcGThw said, "wow"
zDrucyjVn5aeekNEc3cJrA: checks 
*** TURN *** [Ac As Ah] [Qs]
GmzfAfxcxu1kGbPC+9LkVg: checks 
Bb42QRQMhg5/Y0vHP8/2Xw: checks 
zDrucyjVn5aeekNEc3cJrA: bets $2
GmzfAfxcxu1kGbPC+9LkVg: folds 
Bb42QRQMhg5/Y0vHP8/2Xw: folds 
Uncalled bet ($2) returned to zDrucyjVn5aeekNEc3cJrA
zDrucyjVn5aeekNEc3cJrA collected $0.85 from pot
*** SUMMARY ***
Total pot $0.85 | Rake $0 
Board [Ac As Ah Qs]
Seat 1: zDrucyjVn5aeekNEc3cJrA collected ($0.85)
Seat 2: q+Qdg0Hoir+SyL7haBrUnw (button) folded before Flop (didn't bet)
Seat 3: GmzfAfxcxu1kGbPC+9LkVg (small blind) folded on the Turn
Seat 5: Bb42QRQMhg5/Y0vHP8/2Xw (big blind) folded on the Turn
Seat 6: st9jtdNbm1W5GfBwRaCVqQ folded before Flop (didn't bet)
Seat 7: d7YasxuGLPiL7pj8IcGThw folded before Flop (didn't bet)
Seat 9: ljemhp25Zg+nlA9DLCIiUw folded before Flop (didn't bet)




PokerStars Game #59941845206:  Hold'em No Limit ($0.10/$0.25) - 2009/07/01 1:47:58 ET
Table '0XPo7K54oZIfG0xlNAcDRw' 9-max Seat #8 is the button
Seat 2: Prl9QvWQw/mISF4dSnnQUQ ($10.10 in chips) 
Seat 3: RHqgdFvufLCYe54+qd2gcA ($4.75 in chips) 
Seat 4: RubYqfvGrz2z+5ReNIj9QQ ($31.10 in chips) 
Seat 5: iOmwbUN7u4JFkV6VCA49aA ($16.25 in chips) 
Seat 6: M1nKET7WOTLbVPuAbJa3EA ($14.65 in chips) 
Seat 7: tYsOBqdU1+x+yFI7zHO7hQ ($28.45 in chips) 
Seat 8: v5jnQ1gfh9nLla3kMXG7Yg ($14.45 in chips) 
Seat 9: CmngQmkKTp8tkl6GMRTl6w ($13.35 in chips) 
CmngQmkKTp8tkl6GMRTl6w: posts small blind $0.10
7cv+9Zc9HIQHNvYsMfV3uA: is sitting out 
Prl9QvWQw/mISF4dSnnQUQ: posts big blind $0.25
*** HOLE CARDS ***
iOmwbUN7u4JFkV6VCA49aA said, "donk"
7cv+9Zc9HIQHNvYsMfV3uA leaves the table
RHqgdFvufLCYe54+qd2gcA: calls $0.25
RubYqfvGrz2z+5ReNIj9QQ: folds 
iOmwbUN7u4JFkV6VCA49aA: folds 
M1nKET7WOTLbVPuAbJa3EA: calls $0.25
4awUyiDYTgylQKXZ9faBVA joins the table at seat #1 
tYsOBqdU1+x+yFI7zHO7hQ: folds 
v5jnQ1gfh9nLla3kMXG7Yg: calls $0.25
CmngQmkKTp8tkl6GMRTl6w: folds 
Prl9QvWQw/mISF4dSnnQUQ: checks 
*** FLOP *** [2s 4d 8h]
Prl9QvWQw/mISF4dSnnQUQ: checks 
RHqgdFvufLCYe54+qd2gcA: bets $0.75
M1nKET7WOTLbVPuAbJa3EA: folds 
v5jnQ1gfh9nLla3kMXG7Yg: calls $0.75
Prl9QvWQw/mISF4dSnnQUQ: folds 
*** TURN *** [2s 4d 8h] [4s]
RHqgdFvufLCYe54+qd2gcA: checks 
v5jnQ1gfh9nLla3kMXG7Yg: checks 
*** RIVER *** [2s 4d 8h 4s] [Js]
RHqgdFvufLCYe54+qd2gcA: checks 
v5jnQ1gfh9nLla3kMXG7Yg: bets $3.75
RHqgdFvufLCYe54+qd2gcA: folds 
Uncalled bet ($3.75) returned to v5jnQ1gfh9nLla3kMXG7Yg
v5jnQ1gfh9nLla3kMXG7Yg collected $2.50 from pot
*** SUMMARY ***
Total pot $2.60 | Rake $0.10 
Board [2s 4d 8h 4s Js]
Seat 2: Prl9QvWQw/mISF4dSnnQUQ (big blind) folded on the Flop
Seat 3: RHqgdFvufLCYe54+qd2gcA folded on the River
Seat 4: RubYqfvGrz2z+5ReNIj9QQ folded before Flop (didn't bet)
Seat 5: iOmwbUN7u4JFkV6VCA49aA folded before Flop (didn't bet)
Seat 6: M1nKET7WOTLbVPuAbJa3EA folded on the Flop
Seat 7: tYsOBqdU1+x+yFI7zHO7hQ folded before Flop (didn't bet)
Seat 8: v5jnQ1gfh9nLla3kMXG7Yg (button) collected ($2.50)
Seat 9: CmngQmkKTp8tkl6GMRTl6w (small blind) folded before Flop




PokerStars Game #59941845038:  Hold'em No Limit ($0.10/$0.25) - 2009/07/01 1:47:58 ET
Table 'emoxgHTxg9Uqeu06oLzLyg' 6-max Seat #2 is the button
Seat 1: epAUIB7h2FJXzUPRIvSkRA ($25 in chips) 
Seat 2: wIFhgE1PVdX6Xf6aVlSTPg ($28.20 in chips) 
Seat 3: uD5epdBxuyc30pF1dO958Q ($10.15 in chips) 
Seat 4: 3VAbqAWh8ncE2SJOYIx2ZQ ($11 in chips) 
Seat 5: OIjOiBfQstWrK/RuXx7zcw ($6.95 in chips) 
uD5epdBxuyc30pF1dO958Q: posts small blind $0.10
3VAbqAWh8ncE2SJOYIx2ZQ: posts big blind $0.25
u3Ol7kv1LmvszuHNm9rc6w: sits out 
*** HOLE CARDS ***
OIjOiBfQstWrK/RuXx7zcw: folds 
epAUIB7h2FJXzUPRIvSkRA: folds 
wIFhgE1PVdX6Xf6aVlSTPg: folds 
uD5epdBxuyc30pF1dO958Q: calls $0.15
3VAbqAWh8ncE2SJOYIx2ZQ: checks 
*** FLOP *** [6h Kd 8s]
uD5epdBxuyc30pF1dO958Q: checks 
3VAbqAWh8ncE2SJOYIx2ZQ: bets $0.50
uD5epdBxuyc30pF1dO958Q: folds 
Uncalled bet ($0.50) returned to 3VAbqAWh8ncE2SJOYIx2ZQ
3VAbqAWh8ncE2SJOYIx2ZQ collected $0.50 from pot
*** SUMMARY ***
Total pot $0.50 | Rake $0 
Board [6h Kd 8s]
Seat 1: epAUIB7h2FJXzUPRIvSkRA folded before Flop (didn't bet)
Seat 2: wIFhgE1PVdX6Xf6aVlSTPg (button) folded before Flop (didn't bet)
Seat 3: uD5epdBxuyc30pF1dO958Q (small blind) folded on the Flop
Seat 4: 3VAbqAWh8ncE2SJOYIx2ZQ (big blind) collected ($0.50)
Seat 5: OIjOiBfQstWrK/RuXx7zcw folded before Flop (didn't bet)




PokerStars Game #59941844774:  Hold'em No Limit ($0.10/$0.25) - 2009/07/01 1:47:58 ET
Table '5VWnrlxdjwVfMWkVS2WE7A' 6-max Seat #6 is the button
Seat 1: 82p+w3EmUaFFHuwpSeGY1w ($14.25 in chips) 
Seat 2: LJI7A1YgDM7hgh7o56+ReQ ($42.45 in chips) 
Seat 3: SFmT9ZsVopnukjvAzrxTRg ($37.35 in chips) 
Seat 4: Pb/gJ3OxOZx57fFp0MDgkg ($35.20 in chips) 
Seat 6: LtASJ9OlkqGrrUKGQlpGAw ($5.15 in chips) 
82p+w3EmUaFFHuwpSeGY1w: posts small blind $0.10
LJI7A1YgDM7hgh7o56+ReQ: posts big blind $0.25
*** HOLE CARDS ***
SFmT9ZsVopnukjvAzrxTRg: folds 
Pb/gJ3OxOZx57fFp0MDgkg: folds 
LtASJ9OlkqGrrUKGQlpGAw: folds 
82p+w3EmUaFFHuwpSeGY1w: calls $0.15
LJI7A1YgDM7hgh7o56+ReQ: checks 
*** FLOP *** [9d 8d Td]
32YL2ZEp8NT4JB2RVM9euQ joins the table at seat #5 
82p+w3EmUaFFHuwpSeGY1w: checks 
LJI7A1YgDM7hgh7o56+ReQ: checks 
*** TURN *** [9d 8d Td] [Tc]
82p+w3EmUaFFHuwpSeGY1w: checks 
LJI7A1YgDM7hgh7o56+ReQ: bets $0.50
82p+w3EmUaFFHuwpSeGY1w: folds 
Uncalled bet ($0.50) returned to LJI7A1YgDM7hgh7o56+ReQ
LJI7A1YgDM7hgh7o56+ReQ collected $0.50 from pot
LJI7A1YgDM7hgh7o56+ReQ: doesn't show hand 
*** SUMMARY ***
Total pot $0.50 | Rake $0 
Board [9d 8d Td Tc]
Seat 1: 82p+w3EmUaFFHuwpSeGY1w (small blind) folded on the Turn
Seat 2: LJI7A1YgDM7hgh7o56+ReQ (big blind) collected ($0.50)
Seat 3: SFmT9ZsVopnukjvAzrxTRg folded before Flop (didn't bet)
Seat 4: Pb/gJ3OxOZx57fFp0MDgkg folded before Flop (didn't bet)
Seat 6: LtASJ9OlkqGrrUKGQlpGAw (button) folded before Flop (didn't bet)




PokerStars Game #59941844914:  Hold'em No Limit ($0.10/$0.25) - 2009/07/01 1:47:58 ET
Table '8Z6T3ssCpo3VV849U4RgBw' 9-max Seat #3 is the button
Seat 1: Z9W7+g1WMhhZDi7DwGbCFA ($6.15 in chips) 
Seat 2: SpiiQQAzy4MUgV3I5W8giw ($19.10 in chips) 
Seat 3: tLcDklc2rBORNfixyRfVfw ($41.15 in chips) 
Seat 4: RCqMONFrSPSArZh2Jsar/w ($19.90 in chips) 
Seat 5: zDrucyjVn5aeekNEc3cJrA ($16 in chips) 
Seat 6: sGFnnRCa1YAHAUmWgsW6Qg ($9 in chips) 
Seat 7: oLa/tXLfSLLB28mcLGrxcg ($24.05 in chips) 
Seat 8: PdIasPkzm2sqZnN41ZRXOg ($5.25 in chips) 
Seat 9: HDDm1BkZtdsRyw2DJdqq6A ($27.50 in chips) 
RCqMONFrSPSArZh2Jsar/w: posts small blind $0.10
zDrucyjVn5aeekNEc3cJrA: posts big blind $0.25
*** HOLE CARDS ***
sGFnnRCa1YAHAUmWgsW6Qg: folds 
sGFnnRCa1YAHAUmWgsW6Qg leaves the table
oLa/tXLfSLLB28mcLGrxcg: folds 
PdIasPkzm2sqZnN41ZRXOg: folds 
HDDm1BkZtdsRyw2DJdqq6A: calls $0.25
Z9W7+g1WMhhZDi7DwGbCFA: folds 
4qA/3Ajg3pP6fqW+IX9/fQ joins the table at seat #6 
SpiiQQAzy4MUgV3I5W8giw: folds 
tLcDklc2rBORNfixyRfVfw: folds 
RCqMONFrSPSArZh2Jsar/w: calls $0.15
zDrucyjVn5aeekNEc3cJrA: checks 
*** FLOP *** [Ac 6c 5c]
RCqMONFrSPSArZh2Jsar/w: checks 
zDrucyjVn5aeekNEc3cJrA: checks 
HDDm1BkZtdsRyw2DJdqq6A: checks 
*** TURN *** [Ac 6c 5c] [Td]
RCqMONFrSPSArZh2Jsar/w: bets $0.75
zDrucyjVn5aeekNEc3cJrA: folds 
HDDm1BkZtdsRyw2DJdqq6A: calls $0.75
*** RIVER *** [Ac 6c 5c Td] [4h]
RCqMONFrSPSArZh2Jsar/w: bets $1
HDDm1BkZtdsRyw2DJdqq6A: raises $2 to $3
RCqMONFrSPSArZh2Jsar/w: calls $2
*** SHOW DOWN ***
HDDm1BkZtdsRyw2DJdqq6A: shows [Ad 4c] (two pair, Aces and Fours)
RCqMONFrSPSArZh2Jsar/w: mucks hand 
HDDm1BkZtdsRyw2DJdqq6A collected $7.85 from pot
*** SUMMARY ***
Total pot $8.25 | Rake $0.40 
Board [Ac 6c 5c Td 4h]
Seat 1: Z9W7+g1WMhhZDi7DwGbCFA folded before Flop (didn't bet)
Seat 2: SpiiQQAzy4MUgV3I5W8giw folded before Flop (didn't bet)
Seat 3: tLcDklc2rBORNfixyRfVfw (button) folded before Flop (didn't bet)
Seat 4: RCqMONFrSPSArZh2Jsar/w (small blind) mucked
Seat 5: zDrucyjVn5aeekNEc3cJrA (big blind) folded on the Turn
Seat 6: sGFnnRCa1YAHAUmWgsW6Qg folded before Flop (didn't bet)
Seat 7: oLa/tXLfSLLB28mcLGrxcg folded before Flop (didn't bet)
Seat 8: PdIasPkzm2sqZnN41ZRXOg folded before Flop (didn't bet)
Seat 9: HDDm1BkZtdsRyw2DJdqq6A showed [Ad 4c] and won ($7.85) with two pair, Aces and Fours




PokerStars Game #59941845608:  Hold'em No Limit ($0.10/$0.25) - 2009/07/01 1:47:59 ET
Table 'zKwHJD0cmKNUure9qQTfFg' 6-max Seat #4 is the button
Seat 1: Hzrn9DZJegEZICufTNYkrg ($19.10 in chips) 
Seat 2: xrf8tAXKQHG99HixCot1Iw ($25 in chips) 
Seat 3: m9aw7LBAB5YX2ZqMtMkhqA ($14.25 in chips) 
Seat 4: v+QfkGiuj9bgtuNoVnDO8w ($25 in chips) 
Seat 5: E4AqQ1egsnu0oH2RqsbCmQ ($4.75 in chips) 
Seat 6: edio/rLJ06xeZOfLhoL3UA ($10.75 in chips) 
E4AqQ1egsnu0oH2RqsbCmQ: posts small blind $0.10
edio/rLJ06xeZOfLhoL3UA: posts big blind $0.25
*** HOLE CARDS ***
Hzrn9DZJegEZICufTNYkrg: calls $0.25
xrf8tAXKQHG99HixCot1Iw: raises $0.75 to $1
m9aw7LBAB5YX2ZqMtMkhqA: folds 
v+QfkGiuj9bgtuNoVnDO8w: folds 
E4AqQ1egsnu0oH2RqsbCmQ: folds 
edio/rLJ06xeZOfLhoL3UA: calls $0.75
Hzrn9DZJegEZICufTNYkrg: folds 
*** FLOP *** [Tc Js 6h]
edio/rLJ06xeZOfLhoL3UA: checks 
xrf8tAXKQHG99HixCot1Iw: bets $1.25
edio/rLJ06xeZOfLhoL3UA: calls $1.25
*** TURN *** [Tc Js 6h] [2c]
edio/rLJ06xeZOfLhoL3UA: checks 
xrf8tAXKQHG99HixCot1Iw: checks 
*** RIVER *** [Tc Js 6h 2c] [Jd]
edio/rLJ06xeZOfLhoL3UA: bets $3.25
xrf8tAXKQHG99HixCot1Iw: calls $3.25
*** SHOW DOWN ***
edio/rLJ06xeZOfLhoL3UA: shows [4s 5s] (a pair of Jacks)
xrf8tAXKQHG99HixCot1Iw: shows [Qh Ad] (a pair of Jacks - Ace kicker)
xrf8tAXKQHG99HixCot1Iw collected $10.80 from pot
*** SUMMARY ***
Total pot $11.35 | Rake $0.55 
Board [Tc Js 6h 2c Jd]
Seat 1: Hzrn9DZJegEZICufTNYkrg folded before Flop
Seat 2: xrf8tAXKQHG99HixCot1Iw showed [Qh Ad] and won ($10.80) with a pair of Jacks
Seat 3: m9aw7LBAB5YX2ZqMtMkhqA folded before Flop (didn't bet)
Seat 4: v+QfkGiuj9bgtuNoVnDO8w (button) folded before Flop (didn't bet)
Seat 5: E4AqQ1egsnu0oH2RqsbCmQ (small blind) folded before Flop
Seat 6: edio/rLJ06xeZOfLhoL3UA (big blind) showed [4s 5s] and lost with a pair of Jacks




PokerStars Game #59941845700:  Hold'em No Limit ($0.10/$0.25) - 2009/07/01 1:47:59 ET
Table 'nIRjSqm6RYUWJlyW2loYKA' 6-max Seat #6 is the button
Seat 1: w43JQj2oYPpKQVG4Yzlq1w ($25 in chips) 
Seat 2: NndRCAk4vU5JGDhTyy5LZg ($14.55 in chips) 
Seat 3: HbKNMWUwblC7HKtRCUhBWw ($27.10 in chips) 
Seat 4: /ZSSWvl8im2y38j1uEUAGA ($9.50 in chips) 
Seat 5: df01R5ThvHspD8FgKmaDvQ ($24.40 in chips) 
Seat 6: OIjOiBfQstWrK/RuXx7zcw ($5.15 in chips) 
w43JQj2oYPpKQVG4Yzlq1w: posts small blind $0.10
NndRCAk4vU5JGDhTyy5LZg: posts big blind $0.25
*** HOLE CARDS ***
HbKNMWUwblC7HKtRCUhBWw: folds 
/ZSSWvl8im2y38j1uEUAGA: calls $0.25
df01R5ThvHspD8FgKmaDvQ: folds 
OIjOiBfQstWrK/RuXx7zcw: calls $0.25
w43JQj2oYPpKQVG4Yzlq1w: folds 
NndRCAk4vU5JGDhTyy5LZg: checks 
*** FLOP *** [5d Ts Jc]
HbKNMWUwblC7HKtRCUhBWw leaves the table
NndRCAk4vU5JGDhTyy5LZg: checks 
/ZSSWvl8im2y38j1uEUAGA: checks 
OIjOiBfQstWrK/RuXx7zcw: bets $0.25
NndRCAk4vU5JGDhTyy5LZg: calls $0.25
/ZSSWvl8im2y38j1uEUAGA: calls $0.25
*** TURN *** [5d Ts Jc] [Qd]
NndRCAk4vU5JGDhTyy5LZg: checks 
/ZSSWvl8im2y38j1uEUAGA: checks 
OIjOiBfQstWrK/RuXx7zcw: bets $0.75
qjs7u/BI35gu5OgtqfLCZw joins the table at seat #3 
NndRCAk4vU5JGDhTyy5LZg: folds 
/ZSSWvl8im2y38j1uEUAGA: calls $0.75
*** RIVER *** [5d Ts Jc Qd] [Ac]
/ZSSWvl8im2y38j1uEUAGA: checks 
OIjOiBfQstWrK/RuXx7zcw: bets $1.75
/ZSSWvl8im2y38j1uEUAGA: folds 
Uncalled bet ($1.75) returned to OIjOiBfQstWrK/RuXx7zcw
OIjOiBfQstWrK/RuXx7zcw collected $2.95 from pot
OIjOiBfQstWrK/RuXx7zcw: doesn't show hand 
*** SUMMARY ***
Total pot $3.10 | Rake $0.15 
Board [5d Ts Jc Qd Ac]
Seat 1: w43JQj2oYPpKQVG4Yzlq1w (small blind) folded before Flop
Seat 2: NndRCAk4vU5JGDhTyy5LZg (big blind) folded on the Turn
Seat 3: HbKNMWUwblC7HKtRCUhBWw folded before Flop (didn't bet)
Seat 4: /ZSSWvl8im2y38j1uEUAGA folded on the River
Seat 5: df01R5ThvHspD8FgKmaDvQ folded before Flop (didn't bet)
Seat 6: OIjOiBfQstWrK/RuXx7zcw (button) collected ($2.95)




PokerStars Game #59941846254:  Hold'em No Limit ($0.10/$0.25) - 2009/07/01 1:48:00 ET
Table 'NgexmgEDEzICBeSO7YCrKQ' 6-max Seat #6 is the button
Seat 1: cezpHJ8FB07dj0xG+LhOvw ($29.20 in chips) 
Seat 2: 32YL2ZEp8NT4JB2RVM9euQ ($21.55 in chips) 
Seat 3: JFIAqU8lCZ0vWwEl4bdGsg ($27.55 in chips) 
Seat 4: xx+iYCDJhHJmNzrfeloyEg ($22.30 in chips) 
Seat 5: /MXkdT8TTs8Qp2LVTQNw6w ($42.45 in chips) 
Seat 6: k9nHZTHt8hYhYRcW8NTb4g ($11.30 in chips) 
cezpHJ8FB07dj0xG+LhOvw: posts small blind $0.10
32YL2ZEp8NT4JB2RVM9euQ: posts big blind $0.25
*** HOLE CARDS ***
JFIAqU8lCZ0vWwEl4bdGsg: folds 
xx+iYCDJhHJmNzrfeloyEg: folds 
/MXkdT8TTs8Qp2LVTQNw6w: calls $0.25
k9nHZTHt8hYhYRcW8NTb4g: folds 
cezpHJ8FB07dj0xG+LhOvw: raises $1.25 to $1.50
32YL2ZEp8NT4JB2RVM9euQ: folds 
/MXkdT8TTs8Qp2LVTQNw6w: folds 
Uncalled bet ($1.25) returned to cezpHJ8FB07dj0xG+LhOvw
cezpHJ8FB07dj0xG+LhOvw collected $0.75 from pot
*** SUMMARY ***
Total pot $0.75 | Rake $0 
Seat 1: cezpHJ8FB07dj0xG+LhOvw (small blind) collected ($0.75)
Seat 2: 32YL2ZEp8NT4JB2RVM9euQ (big blind) folded before Flop
Seat 3: JFIAqU8lCZ0vWwEl4bdGsg folded before Flop (didn't bet)
Seat 4: xx+iYCDJhHJmNzrfeloyEg folded before Flop (didn't bet)
Seat 5: /MXkdT8TTs8Qp2LVTQNw6w folded before Flop
Seat 6: k9nHZTHt8hYhYRcW8NTb4g (button) folded before Flop (didn't bet)




PokerStars Game #59941846150:  Hold'em No Limit ($0.10/$0.25) - 2009/07/01 1:48:00 ET
Table 'mVdLgAdN9rGe6mMwSrDdGQ' 6-max Seat #1 is the button
Seat 1: OyJ0KTHA5cwh0/yCo1/rdA ($11.85 in chips) 
Seat 2: n9QqWD4tpbongUBX2Oi58w ($5.70 in chips) 
Seat 3: +baiVgI/ETnBARLe5mARCw ($13.95 in chips) 
Seat 4: scNSjC6yyKvvfklSkuzLrw ($18.05 in chips) 
Seat 5: +TMG/MBWpiEnc9t7i07eTA ($24.65 in chips) 
Seat 6: DihMHaz4WNETH1bPDe13kA ($47.45 in chips) 
n9QqWD4tpbongUBX2Oi58w: posts small blind $0.10
+baiVgI/ETnBARLe5mARCw: posts big blind $0.25
*** HOLE CARDS ***
scNSjC6yyKvvfklSkuzLrw: folds 
+TMG/MBWpiEnc9t7i07eTA: folds 
DihMHaz4WNETH1bPDe13kA: raises $0.50 to $0.75
OyJ0KTHA5cwh0/yCo1/rdA: folds 
n9QqWD4tpbongUBX2Oi58w: folds 
+baiVgI/ETnBARLe5mARCw: folds 
Uncalled bet ($0.50) returned to DihMHaz4WNETH1bPDe13kA
DihMHaz4WNETH1bPDe13kA collected $0.60 from pot
*** SUMMARY ***
Total pot $0.60 | Rake $0 
Seat 1: OyJ0KTHA5cwh0/yCo1/rdA (button) folded before Flop (didn't bet)
Seat 2: n9QqWD4tpbongUBX2Oi58w (small blind) folded before Flop
Seat 3: +baiVgI/ETnBARLe5mARCw (big blind) folded before Flop
Seat 4: scNSjC6yyKvvfklSkuzLrw folded before Flop (didn't bet)
Seat 5: +TMG/MBWpiEnc9t7i07eTA folded before Flop (didn't bet)
Seat 6: DihMHaz4WNETH1bPDe13kA collected ($0.60)




PokerStars Game #59941845984:  Hold'em No Limit ($0.10/$0.25) - 2009/07/01 1:48:00 ET
Table 'MJ1SB76A4qJrlEa+C5e/8w' 6-max Seat #5 is the button
Seat 1: 0KDZiuXQg6UI9cqBR/AUnQ ($26 in chips) 
Seat 2: UA5OsKS3VPaxa7uC8La/kA ($37.40 in chips) 
Seat 3: DihMHaz4WNETH1bPDe13kA ($32.55 in chips) 
Seat 4: SFmT9ZsVopnukjvAzrxTRg ($27.80 in chips) 
Seat 5: Hsvkc0/G2VV78oVmWYXecw ($5.25 in chips) 
Seat 6: JFIAqU8lCZ0vWwEl4bdGsg ($30.05 in chips) 
JFIAqU8lCZ0vWwEl4bdGsg: posts small blind $0.10
0KDZiuXQg6UI9cqBR/AUnQ: posts big blind $0.25
*** HOLE CARDS ***
UA5OsKS3VPaxa7uC8La/kA: folds 
DihMHaz4WNETH1bPDe13kA: folds 
SFmT9ZsVopnukjvAzrxTRg: folds 
Hsvkc0/G2VV78oVmWYXecw: folds 
JFIAqU8lCZ0vWwEl4bdGsg: raises $0.60 to $0.85
0KDZiuXQg6UI9cqBR/AUnQ: calls $0.60
*** FLOP *** [5c Kd 5s]
JFIAqU8lCZ0vWwEl4bdGsg: bets $1.25
0KDZiuXQg6UI9cqBR/AUnQ: calls $1.25
*** TURN *** [5c Kd 5s] [Js]
JFIAqU8lCZ0vWwEl4bdGsg: checks 
0KDZiuXQg6UI9cqBR/AUnQ: checks 
*** RIVER *** [5c Kd 5s Js] [2s]
JFIAqU8lCZ0vWwEl4bdGsg: bets $3
0KDZiuXQg6UI9cqBR/AUnQ: calls $3
*** SHOW DOWN ***
JFIAqU8lCZ0vWwEl4bdGsg: shows [Ad 5h] (three of a kind, Fives)
0KDZiuXQg6UI9cqBR/AUnQ: mucks hand 
JFIAqU8lCZ0vWwEl4bdGsg collected $9.70 from pot
*** SUMMARY ***
Total pot $10.20 | Rake $0.50 
Board [5c Kd 5s Js 2s]
Seat 1: 0KDZiuXQg6UI9cqBR/AUnQ (big blind) mucked
Seat 2: UA5OsKS3VPaxa7uC8La/kA folded before Flop (didn't bet)
Seat 3: DihMHaz4WNETH1bPDe13kA folded before Flop (didn't bet)
Seat 4: SFmT9ZsVopnukjvAzrxTRg folded before Flop (didn't bet)
Seat 5: Hsvkc0/G2VV78oVmWYXecw (button) folded before Flop (didn't bet)
Seat 6: JFIAqU8lCZ0vWwEl4bdGsg (small blind) showed [Ad 5h] and won ($9.70) with three of a kind, Fives




PokerStars Game #59941846128:  Hold'em No Limit ($0.10/$0.25) - 2009/07/01 1:48:00 ET
Table 'XX2OuOsa8/8AC+/mR/Az6g' 9-max Seat #9 is the button
Seat 1: 56S3mA6Zs3pGR+0p0vUCtg ($24.50 in chips) 
Seat 2: Bb42QRQMhg5/Y0vHP8/2Xw ($26.85 in chips) 
Seat 3: oLa/tXLfSLLB28mcLGrxcg ($24.60 in chips) 
Seat 5: SpiiQQAzy4MUgV3I5W8giw ($21.15 in chips) 
Seat 6: RCqMONFrSPSArZh2Jsar/w ($20.20 in chips) 
Seat 8: qwr38jl5txoR36M7G5qi4A ($10 in chips) 
Seat 9: V6p0jQ/RhUsqpHLmXvEX4Q ($12 in chips) 
56S3mA6Zs3pGR+0p0vUCtg: posts small blind $0.10
Bb42QRQMhg5/Y0vHP8/2Xw: posts big blind $0.25
*** HOLE CARDS ***
oLa/tXLfSLLB28mcLGrxcg: folds 
SpiiQQAzy4MUgV3I5W8giw: folds 
RCqMONFrSPSArZh2Jsar/w: folds 
qwr38jl5txoR36M7G5qi4A: raises $0.50 to $0.75
V6p0jQ/RhUsqpHLmXvEX4Q: folds 
56S3mA6Zs3pGR+0p0vUCtg: folds 
Bb42QRQMhg5/Y0vHP8/2Xw: folds 
Uncalled bet ($0.50) returned to qwr38jl5txoR36M7G5qi4A
qwr38jl5txoR36M7G5qi4A collected $0.60 from pot
qwr38jl5txoR36M7G5qi4A: doesn't show hand 
*** SUMMARY ***
Total pot $0.60 | Rake $0 
Seat 1: 56S3mA6Zs3pGR+0p0vUCtg (small blind) folded before Flop
Seat 2: Bb42QRQMhg5/Y0vHP8/2Xw (big blind) folded before Flop
Seat 3: oLa/tXLfSLLB28mcLGrxcg folded before Flop (didn't bet)
Seat 5: SpiiQQAzy4MUgV3I5W8giw folded before Flop (didn't bet)
Seat 6: RCqMONFrSPSArZh2Jsar/w folded before Flop (didn't bet)
Seat 8: qwr38jl5txoR36M7G5qi4A collected ($0.60)
Seat 9: V6p0jQ/RhUsqpHLmXvEX4Q (button) folded before Flop (didn't bet)




PokerStars Game #59941846184:  Hold'em No Limit ($0.10/$0.25) - 2009/07/01 1:48:00 ET
Table 'ohAuixfiLOYDylNUG5mNUw' 9-max Seat #8 is the button
Seat 1: qwr38jl5txoR36M7G5qi4A ($10 in chips) 
Seat 2: Th3FldXKQW6hWVVPahaoOQ ($26.15 in chips) 
Seat 3: gSakoFAgDDzXSb2eNBWKcg ($14.15 in chips) 
Seat 4: clJsV3v77RS07bDKY+705w ($5 in chips) 
Seat 6: MtVtHDqIJTyUcXkRBBDIVA ($25 in chips) 
Seat 8: ppMlNkhYgErlt4fuJO7ADA ($4.95 in chips) 
Seat 9: CT7Xj/V/O5rBlhtt+RZeFQ ($25.35 in chips) 
CT7Xj/V/O5rBlhtt+RZeFQ: posts small blind $0.10
qwr38jl5txoR36M7G5qi4A: posts big blind $0.25
y6clPkgMYve3yX9UTvvFUw: sits out 
*** HOLE CARDS ***
Th3FldXKQW6hWVVPahaoOQ: folds 
gSakoFAgDDzXSb2eNBWKcg: raises $0.75 to $1
clJsV3v77RS07bDKY+705w: folds 
MtVtHDqIJTyUcXkRBBDIVA: folds 
ppMlNkhYgErlt4fuJO7ADA: folds 
CT7Xj/V/O5rBlhtt+RZeFQ: folds 
qwr38jl5txoR36M7G5qi4A: folds 
Uncalled bet ($0.75) returned to gSakoFAgDDzXSb2eNBWKcg
gSakoFAgDDzXSb2eNBWKcg collected $0.60 from pot
*** SUMMARY ***
Total pot $0.60 | Rake $0 
Seat 1: qwr38jl5txoR36M7G5qi4A (big blind) folded before Flop
Seat 2: Th3FldXKQW6hWVVPahaoOQ folded before Flop (didn't bet)
Seat 3: gSakoFAgDDzXSb2eNBWKcg collected ($0.60)
Seat 4: clJsV3v77RS07bDKY+705w folded before Flop (didn't bet)
Seat 6: MtVtHDqIJTyUcXkRBBDIVA folded before Flop (didn't bet)
Seat 8: ppMlNkhYgErlt4fuJO7ADA (button) folded before Flop (didn't bet)
Seat 9: CT7Xj/V/O5rBlhtt+RZeFQ (small blind) folded before Flop




PokerStars Game #59941846030:  Hold'em No Limit ($0.10/$0.25) - 2009/07/01 1:48:00 ET
Table 'aT31tt16YvQM/Ue69HPLpA' 9-max Seat #2 is the button
Seat 2: PdIasPkzm2sqZnN41ZRXOg ($4.65 in chips) 
Seat 4: wGigCmBR/9XWkPpvYos3aQ ($26.35 in chips) 
Seat 5: s2xLPOl/vhl/26apJ3vsOQ ($37.65 in chips) 
Seat 6: 7cv+9Zc9HIQHNvYsMfV3uA ($59.95 in chips) 
Seat 7: W8cIfrCR+zA8pCNyIuHu8g ($35.20 in chips) 
Seat 8: W6tExOcYX7qiy6Qdp+ZwFA ($4.65 in chips) 
Seat 9: TvIuLx9zUCE+9Li58iImOQ ($13.95 in chips) 
tYsOBqdU1+x+yFI7zHO7hQ: is sitting out 
wGigCmBR/9XWkPpvYos3aQ: posts small blind $0.10
s2xLPOl/vhl/26apJ3vsOQ: posts big blind $0.25
*** HOLE CARDS ***
tYsOBqdU1+x+yFI7zHO7hQ leaves the table
RidetheLuck leaves the table
7cv+9Zc9HIQHNvYsMfV3uA: folds 
7cv+9Zc9HIQHNvYsMfV3uA leaves the table
W8cIfrCR+zA8pCNyIuHu8g: raises $0.25 to $0.50
W6tExOcYX7qiy6Qdp+ZwFA: folds 
TvIuLx9zUCE+9Li58iImOQ: folds 
PdIasPkzm2sqZnN41ZRXOg: folds 
wGigCmBR/9XWkPpvYos3aQ: folds 
s2xLPOl/vhl/26apJ3vsOQ: calls $0.25
*** FLOP *** [5d Qc 3c]
s2xLPOl/vhl/26apJ3vsOQ: checks 
W8cIfrCR+zA8pCNyIuHu8g: bets $0.50
s2xLPOl/vhl/26apJ3vsOQ: calls $0.50
*** TURN *** [5d Qc 3c] [4d]
s2xLPOl/vhl/26apJ3vsOQ: checks 
ghG12/paEL5VoDN85sW6RA joins the table at seat #6 
W8cIfrCR+zA8pCNyIuHu8g: bets $3
s2xLPOl/vhl/26apJ3vsOQ: calls $3
*** RIVER *** [5d Qc 3c 4d] [Th]
s2xLPOl/vhl/26apJ3vsOQ: checks 
W8cIfrCR+zA8pCNyIuHu8g: bets $6
swK30YlQuxRQO7QFr4ZxCA joins the table at seat #3 
wxmepRUXfX1jdQfUD5uENQ joins the table at seat #1 
s2xLPOl/vhl/26apJ3vsOQ: folds 
Uncalled bet ($6) returned to W8cIfrCR+zA8pCNyIuHu8g
W8cIfrCR+zA8pCNyIuHu8g collected $7.70 from pot
W8cIfrCR+zA8pCNyIuHu8g: doesn't show hand 
*** SUMMARY ***
Total pot $8.10 | Rake $0.40 
Board [5d Qc 3c 4d Th]
Seat 2: PdIasPkzm2sqZnN41ZRXOg (button) folded before Flop (didn't bet)
Seat 4: wGigCmBR/9XWkPpvYos3aQ (small blind) folded before Flop
Seat 5: s2xLPOl/vhl/26apJ3vsOQ (big blind) folded on the River
Seat 6: 7cv+9Zc9HIQHNvYsMfV3uA folded before Flop (didn't bet)
Seat 7: W8cIfrCR+zA8pCNyIuHu8g collected ($7.70)
Seat 8: W6tExOcYX7qiy6Qdp+ZwFA folded before Flop (didn't bet)
Seat 9: TvIuLx9zUCE+9Li58iImOQ folded before Flop (didn't bet)




PokerStars Game #59941845932:  Hold'em No Limit ($0.10/$0.25) - 2009/07/01 1:48:00 ET
Table '+giHa6FUL6U5/AZnCJEGvQ' 9-max Seat #4 is the button
Seat 4: 10f7J+bM02ZfDHx0PgkNSg ($14.95 in chips) 
Seat 5: zDrucyjVn5aeekNEc3cJrA ($45.15 in chips) 
Seat 6: GTMnTen6sQSoCpS9sggLbg ($24.30 in chips) 
zDrucyjVn5aeekNEc3cJrA: posts small blind $0.10
GTMnTen6sQSoCpS9sggLbg: posts big blind $0.25
clkou: sits out 
*** HOLE CARDS ***
10f7J+bM02ZfDHx0PgkNSg: folds 
zDrucyjVn5aeekNEc3cJrA: calls $0.15
GTMnTen6sQSoCpS9sggLbg: checks 
*** FLOP *** [Qc 3c 7d]
zDrucyjVn5aeekNEc3cJrA: checks 
GTMnTen6sQSoCpS9sggLbg: bets $0.50
zDrucyjVn5aeekNEc3cJrA: calls $0.50
*** TURN *** [Qc 3c 7d] [Ks]
10f7J+bM02ZfDHx0PgkNSg leaves the table
zDrucyjVn5aeekNEc3cJrA: checks 
clkou leaves the table
GTMnTen6sQSoCpS9sggLbg: bets $1.50
zDrucyjVn5aeekNEc3cJrA: folds 
Uncalled bet ($1.50) returned to GTMnTen6sQSoCpS9sggLbg
GTMnTen6sQSoCpS9sggLbg collected $1.45 from pot
GTMnTen6sQSoCpS9sggLbg: doesn't show hand 
*** SUMMARY ***
Total pot $1.50 | Rake $0.05 
Board [Qc 3c 7d Ks]
Seat 4: 10f7J+bM02ZfDHx0PgkNSg (button) folded before Flop (didn't bet)
Seat 5: zDrucyjVn5aeekNEc3cJrA (small blind) folded on the Turn
Seat 6: GTMnTen6sQSoCpS9sggLbg (big blind) collected ($1.45)




PokerStars Game #59941846288:  Hold'em No Limit ($0.10/$0.25) - 2009/07/01 1:48:00 ET
Table 'IfRHUn9gQQA9I/Z4tn+BoA' 9-max Seat #7 is the button
Seat 1: imHPFFqvfHGzsBBWeGuy4w ($24.10 in chips) 
Seat 2: VWUWpMLMj/Q1jRVpF7Aohw ($16.95 in chips) 
Seat 3: ModuIAhh03puxW6XFxQ3Nw ($16 in chips) 
Seat 4: QEbIGci+itdw+re8RM5fZA ($35.50 in chips) 
Seat 5: DdPXdieucQ+n99u1n3A+rQ ($4.65 in chips) 
Seat 6: UOjoGGQ58/uDS7V0xkjOrQ ($24.65 in chips) 
Seat 7: YzqSxP03XxZPbgPifgt69g ($28.75 in chips) 
Seat 8: cZ99hugmLBj9KhTlc8nCSw ($27.85 in chips) 
cZ99hugmLBj9KhTlc8nCSw: posts small blind $0.10
7cv+9Zc9HIQHNvYsMfV3uA: is sitting out 
imHPFFqvfHGzsBBWeGuy4w: posts big blind $0.25
*** HOLE CARDS ***
7cv+9Zc9HIQHNvYsMfV3uA leaves the table
VWUWpMLMj/Q1jRVpF7Aohw: folds 
ModuIAhh03puxW6XFxQ3Nw: folds 
QEbIGci+itdw+re8RM5fZA: folds 
ModuIAhh03puxW6XFxQ3Nw leaves the table
DdPXdieucQ+n99u1n3A+rQ: raises $0.75 to $1
UOjoGGQ58/uDS7V0xkjOrQ: folds 
18G4P1XstjNvItdGUITxgw joins the table at seat #9 
YzqSxP03XxZPbgPifgt69g: folds 
cZ99hugmLBj9KhTlc8nCSw: folds 
imHPFFqvfHGzsBBWeGuy4w: folds 
Uncalled bet ($0.75) returned to DdPXdieucQ+n99u1n3A+rQ
DdPXdieucQ+n99u1n3A+rQ collected $0.60 from pot
DdPXdieucQ+n99u1n3A+rQ: doesn't show hand 
*** SUMMARY ***
Total pot $0.60 | Rake $0 
Seat 1: imHPFFqvfHGzsBBWeGuy4w (big blind) folded before Flop
Seat 2: VWUWpMLMj/Q1jRVpF7Aohw folded before Flop (didn't bet)
Seat 3: ModuIAhh03puxW6XFxQ3Nw folded before Flop (didn't bet)
Seat 4: QEbIGci+itdw+re8RM5fZA folded before Flop (didn't bet)
Seat 5: DdPXdieucQ+n99u1n3A+rQ collected ($0.60)
Seat 6: UOjoGGQ58/uDS7V0xkjOrQ folded before Flop (didn't bet)
Seat 7: YzqSxP03XxZPbgPifgt69g (button) folded before Flop (didn't bet)
Seat 8: cZ99hugmLBj9KhTlc8nCSw (small blind) folded before Flop




PokerStars Game #59941845888:  Hold'em No Limit ($0.10/$0.25) - 2009/07/01 1:48:00 ET
Table 'AJGgX1ZYM8d68SWMvaLttg' 6-max Seat #5 is the button
Seat 1: Q1uciOZPBR/WkAlqa6cL4A ($25 in chips) 
Seat 2: zHHLkD2sRljslKKeQv/ZQw ($25 in chips) 
Seat 3: 8ClCHtFXGNplITm+63KB+Q ($38.70 in chips) 
Seat 4: e30C3DfdG5TfPnR16/oMmA ($20.35 in chips) 
Seat 5: Hsvkc0/G2VV78oVmWYXecw ($5 in chips) 
UA5OsKS3VPaxa7uC8La/kA will be allowed to play after the button
Q1uciOZPBR/WkAlqa6cL4A: posts small blind $0.10
zHHLkD2sRljslKKeQv/ZQw: posts big blind $0.25
*** HOLE CARDS ***
8ClCHtFXGNplITm+63KB+Q: folds 
e30C3DfdG5TfPnR16/oMmA: folds 
Hsvkc0/G2VV78oVmWYXecw: folds 
Q1uciOZPBR/WkAlqa6cL4A: folds 
Uncalled bet ($0.15) returned to zHHLkD2sRljslKKeQv/ZQw
zHHLkD2sRljslKKeQv/ZQw collected $0.20 from pot
*** SUMMARY ***
Total pot $0.20 | Rake $0 
Seat 1: Q1uciOZPBR/WkAlqa6cL4A (small blind) folded before Flop
Seat 2: zHHLkD2sRljslKKeQv/ZQw (big blind) collected ($0.20)
Seat 3: 8ClCHtFXGNplITm+63KB+Q folded before Flop (didn't bet)
Seat 4: e30C3DfdG5TfPnR16/oMmA folded before Flop (didn't bet)
Seat 5: Hsvkc0/G2VV78oVmWYXecw (button) folded before Flop (didn't bet)




PokerStars Game #59941846432:  Hold'em No Limit ($0.10/$0.25) - 2009/07/01 1:48:01 ET
Table 'YYMg5qzxK1m9eGRo4SbxtQ' 9-max Seat #4 is the button
Seat 1: 3PmVnC/15cl4oyI1TKIt4g ($5 in chips) 
Seat 2: f/H6PsHRl4W1JyNsEDvPtg ($13.85 in chips) 
Seat 3: eK8qa6EPcH2zhtbmWSvc9g ($25.25 in chips) 
Seat 4: ROxrieegd9WYtWcUKJAlbg ($12.50 in chips) 
Seat 5: 4awUyiDYTgylQKXZ9faBVA ($25 in chips) 
Seat 6: S5VeQLgBIiHrfs9AB2vBwA ($4.45 in chips) 
Seat 8: xoBFd/5k+L/pFn9VW1VyWg ($14.20 in chips) 
Seat 9: +sbyWwIcFp9kP0bDtMegfQ ($31.60 in chips) 
4awUyiDYTgylQKXZ9faBVA: posts small blind $0.10
S5VeQLgBIiHrfs9AB2vBwA: posts big blind $0.25
sUVgUtgbfVx6JpvApozwhQ: sits out 
*** HOLE CARDS ***
xoBFd/5k+L/pFn9VW1VyWg: folds 
+sbyWwIcFp9kP0bDtMegfQ: folds 
3PmVnC/15cl4oyI1TKIt4g: folds 
f/H6PsHRl4W1JyNsEDvPtg: calls $0.25
eK8qa6EPcH2zhtbmWSvc9g: folds 
ROxrieegd9WYtWcUKJAlbg: folds 
4awUyiDYTgylQKXZ9faBVA: folds 
S5VeQLgBIiHrfs9AB2vBwA: checks 
*** FLOP *** [5d Qd Kh]
S5VeQLgBIiHrfs9AB2vBwA: bets $1
f/H6PsHRl4W1JyNsEDvPtg: calls $1
*** TURN *** [5d Qd Kh] [Th]
S5VeQLgBIiHrfs9AB2vBwA: checks 
f/H6PsHRl4W1JyNsEDvPtg: bets $1
S5VeQLgBIiHrfs9AB2vBwA: folds 
Uncalled bet ($1) returned to f/H6PsHRl4W1JyNsEDvPtg
f/H6PsHRl4W1JyNsEDvPtg collected $2.50 from pot
*** SUMMARY ***
Total pot $2.60 | Rake $0.10 
Board [5d Qd Kh Th]
Seat 1: 3PmVnC/15cl4oyI1TKIt4g folded before Flop (didn't bet)
Seat 2: f/H6PsHRl4W1JyNsEDvPtg collected ($2.50)
Seat 3: eK8qa6EPcH2zhtbmWSvc9g folded before Flop (didn't bet)
Seat 4: ROxrieegd9WYtWcUKJAlbg (button) folded before Flop (didn't bet)
Seat 5: 4awUyiDYTgylQKXZ9faBVA (small blind) folded before Flop
Seat 6: S5VeQLgBIiHrfs9AB2vBwA (big blind) folded on the Turn
Seat 8: xoBFd/5k+L/pFn9VW1VyWg folded before Flop (didn't bet)
Seat 9: +sbyWwIcFp9kP0bDtMegfQ folded before Flop (didn't bet)




PokerStars Game #59941846410:  Hold'em No Limit ($0.10/$0.25) - 2009/07/01 1:48:01 ET
Table 'BpNkESDX1ip9c0K1hb5h7A' 6-max Seat #2 is the button
Seat 1: 5YZdVjBPZVEdubN4xEMPEg ($15.50 in chips) 
Seat 2: 9U3ZKjCsarN0DjR6mSE8Ug ($19.60 in chips) 
Seat 3: fZQg9veL7Dd/Z04ZTjC+wQ ($37.75 in chips) 
Seat 4: kG34n23qFQA3nzdOJTQ1dA ($26.50 in chips) 
Seat 6: 8EEqTTh7T1q48sYDqbI2Xg ($19.50 in chips) 
fZQg9veL7Dd/Z04ZTjC+wQ: posts small blind $0.10
kG34n23qFQA3nzdOJTQ1dA: posts big blind $0.25
OMGl+YMGogf2JWIRfT2/Yg: sits out 
*** HOLE CARDS ***
8EEqTTh7T1q48sYDqbI2Xg: folds 
5YZdVjBPZVEdubN4xEMPEg: folds 
9U3ZKjCsarN0DjR6mSE8Ug: folds 
fZQg9veL7Dd/Z04ZTjC+wQ: folds 
Uncalled bet ($0.15) returned to kG34n23qFQA3nzdOJTQ1dA
5YZdVjBPZVEdubN4xEMPEg said, "wouha"
kG34n23qFQA3nzdOJTQ1dA collected $0.20 from pot
*** SUMMARY ***
Total pot $0.20 | Rake $0 
Seat 1: 5YZdVjBPZVEdubN4xEMPEg folded before Flop (didn't bet)
Seat 2: 9U3ZKjCsarN0DjR6mSE8Ug (button) folded before Flop (didn't bet)
Seat 3: fZQg9veL7Dd/Z04ZTjC+wQ (small blind) folded before Flop
Seat 4: kG34n23qFQA3nzdOJTQ1dA (big blind) collected ($0.20)
Seat 6: 8EEqTTh7T1q48sYDqbI2Xg folded before Flop (didn't bet)




PokerStars Game #59941846370:  Hold'em No Limit ($0.10/$0.25) - 2009/07/01 1:48:01 ET
Table '8QBBaev+cI2i/r2H6ml/lg' 9-max Seat #9 is the button
Seat 1: s2xLPOl/vhl/26apJ3vsOQ ($36.55 in chips) 
Seat 2: y7tkvDmwKjURBkr73SZPXw ($12.25 in chips) 
Seat 3: zgi+EUykT/pZQpoUG6+oEg ($4.30 in chips) 
Seat 4: ytpGB2nr/CLVHnyKMRiEFQ ($16 in chips) 
Seat 5: 0QdZrkFD7aGKeBXPGbIomA ($11.45 in chips) 
Seat 6: X6+pSIPfovPcE87t+LmUKQ ($5.25 in chips) 
Seat 7: eK8qa6EPcH2zhtbmWSvc9g ($30.70 in chips) 
Seat 8: vr1IK/Q4HXm8s8V0/dePzQ ($11.60 in chips) 
Seat 9: EUMLvzDkECHBit+xa+uGjg ($23.75 in chips) 
s2xLPOl/vhl/26apJ3vsOQ: posts small blind $0.10
y7tkvDmwKjURBkr73SZPXw: posts big blind $0.25
*** HOLE CARDS ***
zgi+EUykT/pZQpoUG6+oEg: folds 
ytpGB2nr/CLVHnyKMRiEFQ: calls $0.25
0QdZrkFD7aGKeBXPGbIomA: folds 
X6+pSIPfovPcE87t+LmUKQ: calls $0.25
eK8qa6EPcH2zhtbmWSvc9g: raises $0.75 to $1
vr1IK/Q4HXm8s8V0/dePzQ: folds 
EUMLvzDkECHBit+xa+uGjg: folds 
s2xLPOl/vhl/26apJ3vsOQ: folds 
y7tkvDmwKjURBkr73SZPXw: calls $0.75
ytpGB2nr/CLVHnyKMRiEFQ: calls $0.75
X6+pSIPfovPcE87t+LmUKQ: folds 
*** FLOP *** [9h 7s 2s]
y7tkvDmwKjURBkr73SZPXw: checks 
ytpGB2nr/CLVHnyKMRiEFQ: bets $1.50
eK8qa6EPcH2zhtbmWSvc9g: folds 
y7tkvDmwKjURBkr73SZPXw: folds 
Uncalled bet ($1.50) returned to ytpGB2nr/CLVHnyKMRiEFQ
ytpGB2nr/CLVHnyKMRiEFQ collected $3.20 from pot
*** SUMMARY ***
Total pot $3.35 | Rake $0.15 
Board [9h 7s 2s]
Seat 1: s2xLPOl/vhl/26apJ3vsOQ (small blind) folded before Flop
Seat 2: y7tkvDmwKjURBkr73SZPXw (big blind) folded on the Flop
Seat 3: zgi+EUykT/pZQpoUG6+oEg folded before Flop (didn't bet)
Seat 4: ytpGB2nr/CLVHnyKMRiEFQ collected ($3.20)
Seat 5: 0QdZrkFD7aGKeBXPGbIomA folded before Flop (didn't bet)
Seat 6: X6+pSIPfovPcE87t+LmUKQ folded before Flop
Seat 7: eK8qa6EPcH2zhtbmWSvc9g folded on the Flop
Seat 8: vr1IK/Q4HXm8s8V0/dePzQ folded before Flop (didn't bet)
Seat 9: EUMLvzDkECHBit+xa+uGjg (button) folded before Flop (didn't bet)




PokerStars Game #59941846372:  Hold'em No Limit ($0.10/$0.25) - 2009/07/01 1:48:01 ET
Table 'C8mMnVmvkagwolEzTvh07A' 9-max Seat #1 is the button
Seat 1: PqvgxdSg9z5VmrWpbYuz+g ($27.15 in chips) 
Seat 2: Bb42QRQMhg5/Y0vHP8/2Xw ($25 in chips) 
Seat 3: Th3FldXKQW6hWVVPahaoOQ ($35.35 in chips) 
Seat 4: dfNim92Z6XK1/h5SFW5vDg ($25 in chips) 
Seat 5: iGMlK+EhUflPB6jKQd95Cg ($25.35 in chips) 
Seat 6: AiXn/9o1EwOPZUHujnh/bA ($18.50 in chips) 
Seat 9: 4awUyiDYTgylQKXZ9faBVA ($37.40 in chips) 
Bb42QRQMhg5/Y0vHP8/2Xw: posts small blind $0.10
Th3FldXKQW6hWVVPahaoOQ: posts big blind $0.25
*** HOLE CARDS ***
dfNim92Z6XK1/h5SFW5vDg: folds 
iGMlK+EhUflPB6jKQd95Cg: folds 
AiXn/9o1EwOPZUHujnh/bA: folds 
4awUyiDYTgylQKXZ9faBVA: folds 
PqvgxdSg9z5VmrWpbYuz+g: folds 
Bb42QRQMhg5/Y0vHP8/2Xw: calls $0.15
Th3FldXKQW6hWVVPahaoOQ: checks 
*** FLOP *** [Qs 7h 4h]
Bb42QRQMhg5/Y0vHP8/2Xw: checks 
Th3FldXKQW6hWVVPahaoOQ: bets $0.50
Bb42QRQMhg5/Y0vHP8/2Xw: folds 
Uncalled bet ($0.50) returned to Th3FldXKQW6hWVVPahaoOQ
Th3FldXKQW6hWVVPahaoOQ collected $0.50 from pot
Th3FldXKQW6hWVVPahaoOQ: doesn't show hand 
*** SUMMARY ***
Total pot $0.50 | Rake $0 
Board [Qs 7h 4h]
Seat 1: PqvgxdSg9z5VmrWpbYuz+g (button) folded before Flop (didn't bet)
Seat 2: Bb42QRQMhg5/Y0vHP8/2Xw (small blind) folded on the Flop
Seat 3: Th3FldXKQW6hWVVPahaoOQ (big blind) collected ($0.50)
Seat 4: dfNim92Z6XK1/h5SFW5vDg folded before Flop (didn't bet)
Seat 5: iGMlK+EhUflPB6jKQd95Cg folded before Flop (didn't bet)
Seat 6: AiXn/9o1EwOPZUHujnh/bA folded before Flop (didn't bet)
Seat 9: 4awUyiDYTgylQKXZ9faBVA folded before Flop (didn't bet)




PokerStars Game #59941846584:  Hold'em No Limit ($0.10/$0.25) - 2009/07/01 1:48:01 ET
Table '2vH5RcmkT0F4XNS/EmmyMA' 6-max Seat #2 is the button
Seat 1: hOaWAImn5/MZDAWAPlYHCw ($8.10 in chips) 
Seat 2: W6Y6au0wf7gRAlqJYgOezw ($11.50 in chips) 
Seat 3: t8P79jKZYh/Wpx2V73pSqg ($24.70 in chips) 
Seat 4: FC6tJ9EOiutXO8hnpR4VgQ ($10.85 in chips) 
Seat 5: Hsvkc0/G2VV78oVmWYXecw ($5.15 in chips) 
Seat 6: if4dh6jhJXeN3/qd3qCp9g ($25 in chips) 
t8P79jKZYh/Wpx2V73pSqg: posts small blind $0.10
FC6tJ9EOiutXO8hnpR4VgQ: posts big blind $0.25
*** HOLE CARDS ***
Hsvkc0/G2VV78oVmWYXecw: folds 
if4dh6jhJXeN3/qd3qCp9g: folds 
hOaWAImn5/MZDAWAPlYHCw: calls $0.25
W6Y6au0wf7gRAlqJYgOezw: calls $0.25
t8P79jKZYh/Wpx2V73pSqg: folds 
FC6tJ9EOiutXO8hnpR4VgQ: checks 
*** FLOP *** [7h 4s Ac]
FC6tJ9EOiutXO8hnpR4VgQ: checks 
hOaWAImn5/MZDAWAPlYHCw: bets $0.50
W6Y6au0wf7gRAlqJYgOezw: calls $0.50
FC6tJ9EOiutXO8hnpR4VgQ: raises $0.75 to $1.25
hOaWAImn5/MZDAWAPlYHCw: calls $0.75
W6Y6au0wf7gRAlqJYgOezw: folds 
*** TURN *** [7h 4s Ac] [Ah]
FC6tJ9EOiutXO8hnpR4VgQ: checks 
hOaWAImn5/MZDAWAPlYHCw: checks 
*** RIVER *** [7h 4s Ac Ah] [7c]
FC6tJ9EOiutXO8hnpR4VgQ: bets $2.25
hOaWAImn5/MZDAWAPlYHCw: folds 
Uncalled bet ($2.25) returned to FC6tJ9EOiutXO8hnpR4VgQ
FC6tJ9EOiutXO8hnpR4VgQ collected $3.70 from pot
FC6tJ9EOiutXO8hnpR4VgQ: doesn't show hand 
*** SUMMARY ***
Total pot $3.85 | Rake $0.15 
Board [7h 4s Ac Ah 7c]
Seat 1: hOaWAImn5/MZDAWAPlYHCw folded on the River
Seat 2: W6Y6au0wf7gRAlqJYgOezw (button) folded on the Flop
Seat 3: t8P79jKZYh/Wpx2V73pSqg (small blind) folded before Flop
Seat 4: FC6tJ9EOiutXO8hnpR4VgQ (big blind) collected ($3.70)
Seat 5: Hsvkc0/G2VV78oVmWYXecw folded before Flop (didn't bet)
Seat 6: if4dh6jhJXeN3/qd3qCp9g folded before Flop (didn't bet)




PokerStars Game #59941846406:  Hold'em No Limit ($0.10/$0.25) - 2009/07/01 1:48:01 ET
Table 'wRXcD9iXgBbdvKhWmfnBnw' 6-max Seat #6 is the button
Seat 1: Mhj3q7cxev+XjXZxEE6/Cw ($25 in chips) 
Seat 2: vUr8qM1UsCElsCI9B/McdQ ($23.10 in chips) 
Seat 3: SxIIgwXYLkwd6m3wLyPTCw ($25 in chips) 
Seat 4: mnuJq+Q1IXKm/pCy+OzxmQ ($19.25 in chips) 
Seat 5: EE16Ua5b1HSsYej5zeXOlA ($47.45 in chips) 
Seat 6: JFIAqU8lCZ0vWwEl4bdGsg ($34 in chips) 
Mhj3q7cxev+XjXZxEE6/Cw: posts small blind $0.10
vUr8qM1UsCElsCI9B/McdQ: posts big blind $0.25
SxIIgwXYLkwd6m3wLyPTCw: posts big blind $0.25
*** HOLE CARDS ***
SxIIgwXYLkwd6m3wLyPTCw: checks 
mnuJq+Q1IXKm/pCy+OzxmQ: folds 
EE16Ua5b1HSsYej5zeXOlA: raises $1 to $1.25
JFIAqU8lCZ0vWwEl4bdGsg: folds 
Mhj3q7cxev+XjXZxEE6/Cw: folds 
vUr8qM1UsCElsCI9B/McdQ: calls $1
SxIIgwXYLkwd6m3wLyPTCw: folds 
*** FLOP *** [5s 3c Kh]
vUr8qM1UsCElsCI9B/McdQ: checks 
EE16Ua5b1HSsYej5zeXOlA: bets $1.85
vUr8qM1UsCElsCI9B/McdQ: folds 
Uncalled bet ($1.85) returned to EE16Ua5b1HSsYej5zeXOlA
EE16Ua5b1HSsYej5zeXOlA collected $2.75 from pot
EE16Ua5b1HSsYej5zeXOlA: doesn't show hand 
*** SUMMARY ***
Total pot $2.85 | Rake $0.10 
Board [5s 3c Kh]
Seat 1: Mhj3q7cxev+XjXZxEE6/Cw (small blind) folded before Flop
Seat 2: vUr8qM1UsCElsCI9B/McdQ (big blind) folded on the Flop
Seat 3: SxIIgwXYLkwd6m3wLyPTCw folded before Flop
Seat 4: mnuJq+Q1IXKm/pCy+OzxmQ folded before Flop (didn't bet)
Seat 5: EE16Ua5b1HSsYej5zeXOlA collected ($2.75)
Seat 6: JFIAqU8lCZ0vWwEl4bdGsg (button) folded before Flop (didn't bet)




PokerStars Game #59941847042:  Hold'em No Limit ($0.10/$0.25) - 2009/07/01 1:48:02 ET
Table 'fHv1Mk7ZbLjprZTGWKPiEQ' 6-max Seat #2 is the button
Seat 1: OIjOiBfQstWrK/RuXx7zcw ($3.70 in chips) 
Seat 2: 9U3ZKjCsarN0DjR6mSE8Ug ($14.05 in chips) 
Seat 3: /gJNBeCkWL4o85/jvlZ4BA ($25 in chips) 
Seat 4: TSmua8tGK3sTbwi0ynrW9Q ($58.80 in chips) 
Seat 5: LJI7A1YgDM7hgh7o56+ReQ ($26.30 in chips) 
Seat 6: AjG0X+rNtc2W08eph8oqpw ($53.40 in chips) 
/gJNBeCkWL4o85/jvlZ4BA: posts small blind $0.10
TSmua8tGK3sTbwi0ynrW9Q: posts big blind $0.25
*** HOLE CARDS ***
LJI7A1YgDM7hgh7o56+ReQ: raises $0.75 to $1
AjG0X+rNtc2W08eph8oqpw: calls $1
OIjOiBfQstWrK/RuXx7zcw: folds 
9U3ZKjCsarN0DjR6mSE8Ug: folds 
/gJNBeCkWL4o85/jvlZ4BA: folds 
TSmua8tGK3sTbwi0ynrW9Q: calls $0.75
*** FLOP *** [Js 9h 8s]
TSmua8tGK3sTbwi0ynrW9Q: checks 
LJI7A1YgDM7hgh7o56+ReQ: checks 
AjG0X+rNtc2W08eph8oqpw: checks 
*** TURN *** [Js 9h 8s] [5d]
TSmua8tGK3sTbwi0ynrW9Q: bets $1.50
LJI7A1YgDM7hgh7o56+ReQ: folds 
AjG0X+rNtc2W08eph8oqpw: folds 
Uncalled bet ($1.50) returned to TSmua8tGK3sTbwi0ynrW9Q
TSmua8tGK3sTbwi0ynrW9Q collected $2.95 from pot
*** SUMMARY ***
Total pot $3.10 | Rake $0.15 
Board [Js 9h 8s 5d]
Seat 1: OIjOiBfQstWrK/RuXx7zcw folded before Flop (didn't bet)
Seat 2: 9U3ZKjCsarN0DjR6mSE8Ug (button) folded before Flop (didn't bet)
Seat 3: /gJNBeCkWL4o85/jvlZ4BA (small blind) folded before Flop
Seat 4: TSmua8tGK3sTbwi0ynrW9Q (big blind) collected ($2.95)
Seat 5: LJI7A1YgDM7hgh7o56+ReQ folded on the Turn
Seat 6: AjG0X+rNtc2W08eph8oqpw folded on the Turn




PokerStars Game #59941847308:  Hold'em No Limit ($0.10/$0.25) - 2009/07/01 1:48:02 ET
Table '8PD/MTROSMd6Y8mZeykbpg' 6-max Seat #4 is the button
Seat 1: fxNpaToxECtD2Goelmg9vA ($28.85 in chips) 
Seat 2: 4TM16KVgEiQpLi4bVVWbVQ ($25.15 in chips) 
Seat 3: vqWjZmdQu/Hxw96/IJTWdQ ($25 in chips) 
Seat 4: DFi/Lzkjsfv8QswS80JX9Q ($53.35 in chips) 
Seat 5: z3tQwy28dp5FykDJC/wzQw ($26.30 in chips) 
Seat 6: trN/oHqTTbPw5MNuKrOpLw ($25 in chips) 
z3tQwy28dp5FykDJC/wzQw: posts small blind $0.10
trN/oHqTTbPw5MNuKrOpLw: posts big blind $0.25
*** HOLE CARDS ***
fxNpaToxECtD2Goelmg9vA: folds 
4TM16KVgEiQpLi4bVVWbVQ: folds 
vqWjZmdQu/Hxw96/IJTWdQ: raises $0.50 to $0.75
DFi/Lzkjsfv8QswS80JX9Q: raises $2.25 to $3
z3tQwy28dp5FykDJC/wzQw: folds 
trN/oHqTTbPw5MNuKrOpLw: folds 
vqWjZmdQu/Hxw96/IJTWdQ: folds 
Uncalled bet ($2.25) returned to DFi/Lzkjsfv8QswS80JX9Q
DFi/Lzkjsfv8QswS80JX9Q collected $1.85 from pot
DFi/Lzkjsfv8QswS80JX9Q: doesn't show hand 
*** SUMMARY ***
Total pot $1.85 | Rake $0 
Seat 1: fxNpaToxECtD2Goelmg9vA folded before Flop (didn't bet)
Seat 2: 4TM16KVgEiQpLi4bVVWbVQ folded before Flop (didn't bet)
Seat 3: vqWjZmdQu/Hxw96/IJTWdQ folded before Flop
Seat 4: DFi/Lzkjsfv8QswS80JX9Q (button) collected ($1.85)
Seat 5: z3tQwy28dp5FykDJC/wzQw (small blind) folded before Flop
Seat 6: trN/oHqTTbPw5MNuKrOpLw (big blind) folded before Flop




PokerStars Game #59941847154:  Hold'em No Limit ($0.10/$0.25) - 2009/07/01 1:48:02 ET
Table 'vFZR6Kf2Th5xBXT9brGW6A' 6-max Seat #6 is the button
Seat 1: Q1uciOZPBR/WkAlqa6cL4A ($25 in chips) 
Seat 2: QiL+lEgEWwy21jk/ltaRLg ($21.30 in chips) 
Seat 3: SH1WjKVUjPiyXySjWSdazw ($40.85 in chips) 
Seat 4: 79ID/ub1Pt/mDpCprVmOoA ($34.85 in chips) 
Seat 5: SS/yfeArhULzIcOPe8MdPg ($27.35 in chips) 
Seat 6: 4x9jCqgSw4272dnaIqnanw ($10.55 in chips) 
Q1uciOZPBR/WkAlqa6cL4A: posts small blind $0.10
QiL+lEgEWwy21jk/ltaRLg: posts big blind $0.25
*** HOLE CARDS ***
SH1WjKVUjPiyXySjWSdazw: calls $0.25
79ID/ub1Pt/mDpCprVmOoA: folds 
SS/yfeArhULzIcOPe8MdPg: folds 
4x9jCqgSw4272dnaIqnanw: folds 
Q1uciOZPBR/WkAlqa6cL4A: folds 
QiL+lEgEWwy21jk/ltaRLg: checks 
*** FLOP *** [4d Kd 6d]
QiL+lEgEWwy21jk/ltaRLg: bets $0.25
SH1WjKVUjPiyXySjWSdazw: calls $0.25
*** TURN *** [4d Kd 6d] [As]
QiL+lEgEWwy21jk/ltaRLg: checks 
SH1WjKVUjPiyXySjWSdazw: checks 
*** RIVER *** [4d Kd 6d As] [9s]
QiL+lEgEWwy21jk/ltaRLg: bets $0.25
SH1WjKVUjPiyXySjWSdazw: calls $0.25
*** SHOW DOWN ***
QiL+lEgEWwy21jk/ltaRLg: shows [2d 9h] (a pair of Nines)
SH1WjKVUjPiyXySjWSdazw: shows [Th 9d] (a pair of Nines - Ace+King+Ten kicker)
SH1WjKVUjPiyXySjWSdazw collected $1.55 from pot
*** SUMMARY ***
Total pot $1.60 | Rake $0.05 
Board [4d Kd 6d As 9s]
Seat 1: Q1uciOZPBR/WkAlqa6cL4A (small blind) folded before Flop
Seat 2: QiL+lEgEWwy21jk/ltaRLg (big blind) showed [2d 9h] and lost with a pair of Nines
Seat 3: SH1WjKVUjPiyXySjWSdazw showed [Th 9d] and won ($1.55) with a pair of Nines
Seat 4: 79ID/ub1Pt/mDpCprVmOoA folded before Flop (didn't bet)
Seat 5: SS/yfeArhULzIcOPe8MdPg folded before Flop (didn't bet)
Seat 6: 4x9jCqgSw4272dnaIqnanw (button) folded before Flop (didn't bet)




PokerStars Game #59941846882:  Hold'em No Limit ($0.10/$0.25) - 2009/07/01 1:48:02 ET
Table 'a6FCGVBMPcT7J7BDN9q1zQ' 9-max Seat #7 is the button
Seat 2: M2QO2DxB5Wawg2h8HSpnYA ($13.45 in chips) 
Seat 3: tLcDklc2rBORNfixyRfVfw ($25 in chips) 
Seat 5: dtZ84flFEi4Q+SGrHMJRDQ ($26.55 in chips) 
Seat 6: dfNim92Z6XK1/h5SFW5vDg ($25 in chips) 
Seat 7: V0Yo5zRBVM8DYspLKafebg ($7.35 in chips) 
Seat 8: r6hsffOo1iKmaPYKwAZmFw ($64.70 in chips) 
Seat 9: wGigCmBR/9XWkPpvYos3aQ ($28.35 in chips) 
r6hsffOo1iKmaPYKwAZmFw: posts small blind $0.10
wGigCmBR/9XWkPpvYos3aQ: posts big blind $0.25
bXpVeaSTPBFSPJmeXxO7nw: sits out 
8EbrQ/EvFWt2cr0GaU82gQ: sits out 
*** HOLE CARDS ***
M2QO2DxB5Wawg2h8HSpnYA: folds 
tLcDklc2rBORNfixyRfVfw: folds 
dtZ84flFEi4Q+SGrHMJRDQ: raises $0.50 to $0.75
dfNim92Z6XK1/h5SFW5vDg: folds 
V0Yo5zRBVM8DYspLKafebg: calls $0.75
r6hsffOo1iKmaPYKwAZmFw: folds 
wGigCmBR/9XWkPpvYos3aQ: raises $2.65 to $3.40
dtZ84flFEi4Q+SGrHMJRDQ: folds 
V0Yo5zRBVM8DYspLKafebg: folds 
Uncalled bet ($2.65) returned to wGigCmBR/9XWkPpvYos3aQ
wGigCmBR/9XWkPpvYos3aQ collected $2.35 from pot
wGigCmBR/9XWkPpvYos3aQ: doesn't show hand 
*** SUMMARY ***
Total pot $2.35 | Rake $0 
Seat 2: M2QO2DxB5Wawg2h8HSpnYA folded before Flop (didn't bet)
Seat 3: tLcDklc2rBORNfixyRfVfw folded before Flop (didn't bet)
Seat 5: dtZ84flFEi4Q+SGrHMJRDQ folded before Flop
Seat 6: dfNim92Z6XK1/h5SFW5vDg folded before Flop (didn't bet)
Seat 7: V0Yo5zRBVM8DYspLKafebg (button) folded before Flop
Seat 8: r6hsffOo1iKmaPYKwAZmFw (small blind) folded before Flop
Seat 9: wGigCmBR/9XWkPpvYos3aQ (big blind) collected ($2.35)




PokerStars Game #59941846932:  Hold'em No Limit ($0.10/$0.25) - 2009/07/01 1:48:02 ET
Table 'aisAlB9GIV21BwfUW3+Nbg' 9-max Seat #5 is the button
Seat 1: SqibpGx+lf+brY0fJVvD0w ($24.30 in chips) 
Seat 2: Z9AeOQX3yzuSvKAm/xyovg ($12.20 in chips) 
Seat 3: CvL9Ch1HYCVbTsfpNucitg ($4.55 in chips) 
Seat 4: sD+TKtt36XiiN6jqHiLwDA ($25.10 in chips) 
Seat 5: ghNKXUBl/H+t83JF079ZBA ($25.90 in chips) 
Seat 6: 9gmYYQesalMrUjaF7nKfrQ ($15.95 in chips) 
Seat 7: jGjM+5lCSe6f2MEwxQGOAg ($23.10 in chips) 
Seat 8: VWUWpMLMj/Q1jRVpF7Aohw ($26.30 in chips) 
Seat 9: N0hGpTAEAj9k5msS6LPLAw ($20.60 in chips) 
9gmYYQesalMrUjaF7nKfrQ: posts small blind $0.10
jGjM+5lCSe6f2MEwxQGOAg: posts big blind $0.25
*** HOLE CARDS ***
VWUWpMLMj/Q1jRVpF7Aohw: folds 
N0hGpTAEAj9k5msS6LPLAw: folds 
SqibpGx+lf+brY0fJVvD0w: calls $0.25
Z9AeOQX3yzuSvKAm/xyovg: folds 
Z9AeOQX3yzuSvKAm/xyovg is sitting out
CvL9Ch1HYCVbTsfpNucitg: folds 
sD+TKtt36XiiN6jqHiLwDA: folds 
ghNKXUBl/H+t83JF079ZBA: folds 
9gmYYQesalMrUjaF7nKfrQ: folds 
jGjM+5lCSe6f2MEwxQGOAg: checks 
*** FLOP *** [2s Td 3h]
jGjM+5lCSe6f2MEwxQGOAg: bets $0.25
SqibpGx+lf+brY0fJVvD0w: raises $0.50 to $0.75
jGjM+5lCSe6f2MEwxQGOAg: folds 
Uncalled bet ($0.50) returned to SqibpGx+lf+brY0fJVvD0w
SqibpGx+lf+brY0fJVvD0w collected $1.05 from pot
*** SUMMARY ***
Total pot $1.10 | Rake $0.05 
Board [2s Td 3h]
Seat 1: SqibpGx+lf+brY0fJVvD0w collected ($1.05)
Seat 2: Z9AeOQX3yzuSvKAm/xyovg folded before Flop (didn't bet)
Seat 3: CvL9Ch1HYCVbTsfpNucitg folded before Flop (didn't bet)
Seat 4: sD+TKtt36XiiN6jqHiLwDA folded before Flop (didn't bet)
Seat 5: ghNKXUBl/H+t83JF079ZBA (button) folded before Flop (didn't bet)
Seat 6: 9gmYYQesalMrUjaF7nKfrQ (small blind) folded before Flop
Seat 7: jGjM+5lCSe6f2MEwxQGOAg (big blind) folded on the Flop
Seat 8: VWUWpMLMj/Q1jRVpF7Aohw folded before Flop (didn't bet)
Seat 9: N0hGpTAEAj9k5msS6LPLAw folded before Flop (didn't bet)




PokerStars Game #59941847556:  Hold'em No Limit ($0.10/$0.25) - 2009/07/01 1:48:03 ET
Table '3KDMdm1sfxFsNKkjc/PnBg' 9-max Seat #2 is the button
Seat 1: RN77cWdo2Yfi3gUEKq3PdA ($15 in chips) 
Seat 2: 5WLo/V8l3QfpUdK9JPp99w ($24.20 in chips) 
Seat 3: OXPkK84/qv92EMwXPiG5rQ ($9.75 in chips) 
Seat 4: F7pnn6czNpHvRM55XcA2EA ($38.20 in chips) 
Seat 5: +2kMBNpY4nF1qNCRd8SJLA ($30.45 in chips) 
Seat 6: sGFnnRCa1YAHAUmWgsW6Qg ($13.40 in chips) 
Seat 7: gehe91e0IyVT0QU/XBkEyg ($31.80 in chips) 
Seat 8: LFnLiiWho1pLiR1Xvp5d/w ($6.05 in chips) 
Seat 9: K0b5wNInj6hUGRr6yzKFtw ($32.60 in chips) 
OXPkK84/qv92EMwXPiG5rQ: posts small blind $0.10
F7pnn6czNpHvRM55XcA2EA: posts big blind $0.25
RN77cWdo2Yfi3gUEKq3PdA: posts big blind $0.25
*** HOLE CARDS ***
+2kMBNpY4nF1qNCRd8SJLA: folds 
sGFnnRCa1YAHAUmWgsW6Qg: folds 
gehe91e0IyVT0QU/XBkEyg: folds 
LFnLiiWho1pLiR1Xvp5d/w: calls $0.25
K0b5wNInj6hUGRr6yzKFtw: calls $0.25
RN77cWdo2Yfi3gUEKq3PdA: checks 
5WLo/V8l3QfpUdK9JPp99w: raises $0.25 to $0.50
OXPkK84/qv92EMwXPiG5rQ: calls $0.40
F7pnn6czNpHvRM55XcA2EA: calls $0.25
LFnLiiWho1pLiR1Xvp5d/w: raises $0.75 to $1.25
K0b5wNInj6hUGRr6yzKFtw: folds 
RN77cWdo2Yfi3gUEKq3PdA: folds 
5WLo/V8l3QfpUdK9JPp99w: raises $0.75 to $2
OXPkK84/qv92EMwXPiG5rQ: folds 
F7pnn6czNpHvRM55XcA2EA: folds 
LFnLiiWho1pLiR1Xvp5d/w: raises $1 to $3
5WLo/V8l3QfpUdK9JPp99w: raises $4.50 to $7.50
LFnLiiWho1pLiR1Xvp5d/w: calls $3.05 and is all-in
Uncalled bet ($1.45) returned to 5WLo/V8l3QfpUdK9JPp99w
*** FLOP *** [Qs Tc 6h]
*** TURN *** [Qs Tc 6h] [9s]
*** RIVER *** [Qs Tc 6h 9s] [4s]
*** SHOW DOWN ***
LFnLiiWho1pLiR1Xvp5d/w: shows [Ad Kd] (high card Ace)
5WLo/V8l3QfpUdK9JPp99w: shows [Ac As] (a pair of Aces)
5WLo/V8l3QfpUdK9JPp99w collected $12.95 from pot
*** SUMMARY ***
Total pot $13.60 | Rake $0.65 
Board [Qs Tc 6h 9s 4s]
Seat 1: RN77cWdo2Yfi3gUEKq3PdA folded before Flop
Seat 2: 5WLo/V8l3QfpUdK9JPp99w (button) showed [Ac As] and won ($12.95) with a pair of Aces
Seat 3: OXPkK84/qv92EMwXPiG5rQ (small blind) folded before Flop
Seat 4: F7pnn6czNpHvRM55XcA2EA (big blind) folded before Flop
Seat 5: +2kMBNpY4nF1qNCRd8SJLA folded before Flop (didn't bet)
Seat 6: sGFnnRCa1YAHAUmWgsW6Qg folded before Flop (didn't bet)
Seat 7: gehe91e0IyVT0QU/XBkEyg folded before Flop (didn't bet)
Seat 8: LFnLiiWho1pLiR1Xvp5d/w showed [Ad Kd] and lost with high card Ace
Seat 9: K0b5wNInj6hUGRr6yzKFtw folded before Flop




PokerStars Game #59941847350:  Hold'em No Limit ($0.10/$0.25) - 2009/07/01 1:48:03 ET
Table 'uFgIyfWPagvEVGEb86da7A' 9-max Seat #5 is the button
Seat 1: CT7Xj/V/O5rBlhtt+RZeFQ ($25.75 in chips) 
Seat 2: o3zvoO+PsqGti+1NZGNRrQ ($1.25 in chips) 
Seat 3: eGAnPT3w+iltM7HF59dzIg ($5.65 in chips) 
Seat 4: IGRfskE1v9H9Bn+fz8AgNQ ($26.90 in chips) 
Seat 5: X78b5v/uhqeXXoAijbw/yg ($28.55 in chips) 
Seat 6: zDrucyjVn5aeekNEc3cJrA ($27 in chips) 
Seat 7: 9zx7Mlww974uHUqoiq2eXA ($11.85 in chips) 
Seat 8: uLP/lYn7oKq9xCChBXsXxw ($25.55 in chips) 
Seat 9: sL5EaDXc90Iyxlm8ERXRQw ($18.35 in chips) 
zDrucyjVn5aeekNEc3cJrA: posts small blind $0.10
9zx7Mlww974uHUqoiq2eXA: posts big blind $0.25
*** HOLE CARDS ***
uLP/lYn7oKq9xCChBXsXxw: folds 
sL5EaDXc90Iyxlm8ERXRQw: folds 
CT7Xj/V/O5rBlhtt+RZeFQ: folds 
o3zvoO+PsqGti+1NZGNRrQ: folds 
eGAnPT3w+iltM7HF59dzIg: folds 
IGRfskE1v9H9Bn+fz8AgNQ: folds 
X78b5v/uhqeXXoAijbw/yg: folds 
zDrucyjVn5aeekNEc3cJrA: calls $0.15
9zx7Mlww974uHUqoiq2eXA: raises $0.25 to $0.50
zDrucyjVn5aeekNEc3cJrA: folds 
Uncalled bet ($0.25) returned to 9zx7Mlww974uHUqoiq2eXA
9zx7Mlww974uHUqoiq2eXA collected $0.50 from pot
*** SUMMARY ***
Total pot $0.50 | Rake $0 
Seat 1: CT7Xj/V/O5rBlhtt+RZeFQ folded before Flop (didn't bet)
Seat 2: o3zvoO+PsqGti+1NZGNRrQ folded before Flop (didn't bet)
Seat 3: eGAnPT3w+iltM7HF59dzIg folded before Flop (didn't bet)
Seat 4: IGRfskE1v9H9Bn+fz8AgNQ folded before Flop (didn't bet)
Seat 5: X78b5v/uhqeXXoAijbw/yg (button) folded before Flop (didn't bet)
Seat 6: zDrucyjVn5aeekNEc3cJrA (small blind) folded before Flop
Seat 7: 9zx7Mlww974uHUqoiq2eXA (big blind) collected ($0.50)
Seat 8: uLP/lYn7oKq9xCChBXsXxw folded before Flop (didn't bet)
Seat 9: sL5EaDXc90Iyxlm8ERXRQw folded before Flop (didn't bet)




PokerStars Game #59941847320:  Hold'em No Limit ($0.10/$0.25) - 2009/07/01 1:48:03 ET
Table '3lL16FBjWXTx3AjK5lMRww' 9-max Seat #3 is the button
Seat 1: fDGyaQz0cs2s4FOYxkbIHA ($16.55 in chips) 
Seat 2: c/9X4zftzphFxYtxp5kp9w ($21.55 in chips) 
Seat 3: QEbIGci+itdw+re8RM5fZA ($27.10 in chips) 
Seat 4: Z3a37Ry74FVl+CBZtAONiA ($7.40 in chips) 
Seat 5: M/9j4wkHH9i1JM51vgi1VA ($37.30 in chips) 
Seat 6: zUXhymECc2C9W9ZNw6qppA ($9.15 in chips) 
Seat 7: 6RiVTYll/5D8zICp0MRpKw ($24.95 in chips) 
Seat 8: ljemhp25Zg+nlA9DLCIiUw ($24.75 in chips) 
Seat 9: 00Ybni1cxfHtqmdWwh31Xg ($10.30 in chips) 
Z3a37Ry74FVl+CBZtAONiA: posts small blind $0.10
M/9j4wkHH9i1JM51vgi1VA: posts big blind $0.25
*** HOLE CARDS ***
zUXhymECc2C9W9ZNw6qppA: folds 
6RiVTYll/5D8zICp0MRpKw: folds 
ljemhp25Zg+nlA9DLCIiUw: calls $0.25
00Ybni1cxfHtqmdWwh31Xg has timed out
00Ybni1cxfHtqmdWwh31Xg: folds 
00Ybni1cxfHtqmdWwh31Xg is sitting out
fDGyaQz0cs2s4FOYxkbIHA: folds 
c/9X4zftzphFxYtxp5kp9w: folds 
QEbIGci+itdw+re8RM5fZA: raises $0.75 to $1
Z3a37Ry74FVl+CBZtAONiA: calls $0.90
M/9j4wkHH9i1JM51vgi1VA: folds 
ljemhp25Zg+nlA9DLCIiUw: folds 
*** FLOP *** [5d Kd 2s]
00Ybni1cxfHtqmdWwh31Xg has returned
Z3a37Ry74FVl+CBZtAONiA: checks 
QEbIGci+itdw+re8RM5fZA: bets $1.50
Z3a37Ry74FVl+CBZtAONiA: folds 
Uncalled bet ($1.50) returned to QEbIGci+itdw+re8RM5fZA
QEbIGci+itdw+re8RM5fZA collected $2.40 from pot
QEbIGci+itdw+re8RM5fZA: doesn't show hand 
*** SUMMARY ***
Total pot $2.50 | Rake $0.10 
Board [5d Kd 2s]
Seat 1: fDGyaQz0cs2s4FOYxkbIHA folded before Flop (didn't bet)
Seat 2: c/9X4zftzphFxYtxp5kp9w folded before Flop (didn't bet)
Seat 3: QEbIGci+itdw+re8RM5fZA (button) collected ($2.40)
Seat 4: Z3a37Ry74FVl+CBZtAONiA (small blind) folded on the Flop
Seat 5: M/9j4wkHH9i1JM51vgi1VA (big blind) folded before Flop
Seat 6: zUXhymECc2C9W9ZNw6qppA folded before Flop (didn't bet)
Seat 7: 6RiVTYll/5D8zICp0MRpKw folded before Flop (didn't bet)
Seat 8: ljemhp25Zg+nlA9DLCIiUw folded before Flop
Seat 9: 00Ybni1cxfHtqmdWwh31Xg folded before Flop (didn't bet)




PokerStars Game #59941847484:  Hold'em No Limit ($0.10/$0.25) - 2009/07/01 1:48:03 ET
Table 'CBnRhp0d6E2+/NtM7Vbruw' 9-max Seat #9 is the button
Seat 1: 18G4P1XstjNvItdGUITxgw ($25 in chips) 
Seat 2: cZ99hugmLBj9KhTlc8nCSw ($26.85 in chips) 
Seat 3: aNpwfA31EREwO+ar4XzBCw ($34.05 in chips) 
Seat 5: CT7Xj/V/O5rBlhtt+RZeFQ ($25 in chips) 
Seat 6: CvL9Ch1HYCVbTsfpNucitg ($4.30 in chips) 
Seat 7: j4q3p0lesp63b1gZDwLBZw ($5 in chips) 
Seat 8: MG90wfSJZnOejs/KD3vlQQ ($25.35 in chips) 
Seat 9: xHZZRLAaFUIC8WWI8ljOJA ($29.55 in chips) 
18G4P1XstjNvItdGUITxgw: posts small blind $0.10
cZ99hugmLBj9KhTlc8nCSw: posts big blind $0.25
*** HOLE CARDS ***
aNpwfA31EREwO+ar4XzBCw: raises $0.75 to $1
CT7Xj/V/O5rBlhtt+RZeFQ: raises $1 to $2
CvL9Ch1HYCVbTsfpNucitg: folds 
j4q3p0lesp63b1gZDwLBZw: folds 
MG90wfSJZnOejs/KD3vlQQ: folds 
xHZZRLAaFUIC8WWI8ljOJA: folds 
18G4P1XstjNvItdGUITxgw: folds 
cZ99hugmLBj9KhTlc8nCSw: folds 
aNpwfA31EREwO+ar4XzBCw: raises $3.25 to $5.25
CT7Xj/V/O5rBlhtt+RZeFQ: folds 
Uncalled bet ($3.25) returned to aNpwfA31EREwO+ar4XzBCw
aNpwfA31EREwO+ar4XzBCw collected $4.35 from pot
aNpwfA31EREwO+ar4XzBCw: doesn't show hand 
*** SUMMARY ***
Total pot $4.35 | Rake $0 
Seat 1: 18G4P1XstjNvItdGUITxgw (small blind) folded before Flop
Seat 2: cZ99hugmLBj9KhTlc8nCSw (big blind) folded before Flop
Seat 3: aNpwfA31EREwO+ar4XzBCw collected ($4.35)
Seat 5: CT7Xj/V/O5rBlhtt+RZeFQ folded before Flop
Seat 6: CvL9Ch1HYCVbTsfpNucitg folded before Flop (didn't bet)
Seat 7: j4q3p0lesp63b1gZDwLBZw folded before Flop (didn't bet)
Seat 8: MG90wfSJZnOejs/KD3vlQQ folded before Flop (didn't bet)
Seat 9: xHZZRLAaFUIC8WWI8ljOJA (button) folded before Flop (didn't bet)




PokerStars Game #59941847496:  Hold'em No Limit ($0.10/$0.25) - 2009/07/01 1:48:03 ET
Table 'xkqAWQFDrFt4p81M8UsoNw' 9-max Seat #9 is the button
Seat 1: tLcDklc2rBORNfixyRfVfw ($28.35 in chips) 
Seat 3: xHZZRLAaFUIC8WWI8ljOJA ($24 in chips) 
Seat 4: wGigCmBR/9XWkPpvYos3aQ ($25.10 in chips) 
Seat 6: 6RiVTYll/5D8zICp0MRpKw ($22.75 in chips) 
Seat 7: MG90wfSJZnOejs/KD3vlQQ ($43.50 in chips) 
Seat 8: MaqsqnOOkbNuPf4oWvOtnA ($43.25 in chips) 
Seat 9: Z9AeOQX3yzuSvKAm/xyovg ($9.30 in chips) 
tLcDklc2rBORNfixyRfVfw: posts small blind $0.10
xHZZRLAaFUIC8WWI8ljOJA: posts big blind $0.25
H5Se03ZqSX7tbULXur2MAg: sits out 
*** HOLE CARDS ***
wGigCmBR/9XWkPpvYos3aQ: folds 
6RiVTYll/5D8zICp0MRpKw: raises $0.50 to $0.75
MG90wfSJZnOejs/KD3vlQQ: calls $0.75
MaqsqnOOkbNuPf4oWvOtnA: folds 
Z9AeOQX3yzuSvKAm/xyovg: folds 
tLcDklc2rBORNfixyRfVfw: folds 
xHZZRLAaFUIC8WWI8ljOJA: folds 
*** FLOP *** [Qd 8h Ac]
6RiVTYll/5D8zICp0MRpKw: checks 
MG90wfSJZnOejs/KD3vlQQ: bets $1.40
6RiVTYll/5D8zICp0MRpKw: folds 
Uncalled bet ($1.40) returned to MG90wfSJZnOejs/KD3vlQQ
MG90wfSJZnOejs/KD3vlQQ collected $1.80 from pot
MG90wfSJZnOejs/KD3vlQQ: doesn't show hand 
*** SUMMARY ***
Total pot $1.85 | Rake $0.05 
Board [Qd 8h Ac]
Seat 1: tLcDklc2rBORNfixyRfVfw (small blind) folded before Flop
Seat 3: xHZZRLAaFUIC8WWI8ljOJA (big blind) folded before Flop
Seat 4: wGigCmBR/9XWkPpvYos3aQ folded before Flop (didn't bet)
Seat 6: 6RiVTYll/5D8zICp0MRpKw folded on the Flop
Seat 7: MG90wfSJZnOejs/KD3vlQQ collected ($1.80)
Seat 8: MaqsqnOOkbNuPf4oWvOtnA folded before Flop (didn't bet)
Seat 9: Z9AeOQX3yzuSvKAm/xyovg (button) folded before Flop (didn't bet)




PokerStars Game #59941847750:  Hold'em No Limit ($0.10/$0.25) - 2009/07/01 1:48:03 ET
Table 'IuqVbFI+pwnJjvwBCGSGAw' 6-max Seat #2 is the button
Seat 1: LyDHtw3/yniNHW+DvLXbog ($28.10 in chips) 
Seat 2: w43JQj2oYPpKQVG4Yzlq1w ($25 in chips) 
Seat 3: QiL+lEgEWwy21jk/ltaRLg ($21.15 in chips) 
Seat 4: DE9hRlt14g+JdsRQ4wT7hg ($27.05 in chips) 
Seat 5: if4dh6jhJXeN3/qd3qCp9g ($24.60 in chips) 
Seat 6: xC0kaiDYM6YTlgODL83O5A ($13.15 in chips) 
QiL+lEgEWwy21jk/ltaRLg: posts small blind $0.10
DE9hRlt14g+JdsRQ4wT7hg: posts big blind $0.25
*** HOLE CARDS ***
if4dh6jhJXeN3/qd3qCp9g: folds 
xC0kaiDYM6YTlgODL83O5A: folds 
LyDHtw3/yniNHW+DvLXbog: folds 
w43JQj2oYPpKQVG4Yzlq1w: folds 
QiL+lEgEWwy21jk/ltaRLg: folds 
Uncalled bet ($0.15) returned to DE9hRlt14g+JdsRQ4wT7hg
DE9hRlt14g+JdsRQ4wT7hg collected $0.20 from pot
DE9hRlt14g+JdsRQ4wT7hg: doesn't show hand 
*** SUMMARY ***
Total pot $0.20 | Rake $0 
Seat 1: LyDHtw3/yniNHW+DvLXbog folded before Flop (didn't bet)
Seat 2: w43JQj2oYPpKQVG4Yzlq1w (button) folded before Flop (didn't bet)
Seat 3: QiL+lEgEWwy21jk/ltaRLg (small blind) folded before Flop
Seat 4: DE9hRlt14g+JdsRQ4wT7hg (big blind) collected ($0.20)
Seat 5: if4dh6jhJXeN3/qd3qCp9g folded before Flop (didn't bet)
Seat 6: xC0kaiDYM6YTlgODL83O5A folded before Flop (didn't bet)




PokerStars Game #59941847398:  Hold'em No Limit ($0.10/$0.25) - 2009/07/01 1:48:03 ET
Table 'oJpFwZj9+FUGHX90Un8s9Q' 6-max Seat #6 is the button
Seat 1: 6DwBRH+xZ12AAZmeAg+aXw ($23.65 in chips) 
Seat 2: NtrVQ9UIql0rDCnKDKZ5FQ ($19.70 in chips) 
Seat 3: kyRaCIljYA6l33lSKQfNsg ($22.90 in chips) 
Seat 4: 6elpmfyt4Zw0yvd8lePSMQ ($20.55 in chips) 
Seat 5: kG34n23qFQA3nzdOJTQ1dA ($55.45 in chips) 
Seat 6: 7LpHJVeM6k1mQdC6HXYzww ($25 in chips) 
6DwBRH+xZ12AAZmeAg+aXw: posts small blind $0.10
NtrVQ9UIql0rDCnKDKZ5FQ: posts big blind $0.25
*** HOLE CARDS ***
kyRaCIljYA6l33lSKQfNsg: folds 
6elpmfyt4Zw0yvd8lePSMQ: raises $0.50 to $0.75
kG34n23qFQA3nzdOJTQ1dA: folds 
7LpHJVeM6k1mQdC6HXYzww: folds 
6DwBRH+xZ12AAZmeAg+aXw: folds 
NtrVQ9UIql0rDCnKDKZ5FQ: folds 
Uncalled bet ($0.50) returned to 6elpmfyt4Zw0yvd8lePSMQ
6elpmfyt4Zw0yvd8lePSMQ collected $0.60 from pot
6elpmfyt4Zw0yvd8lePSMQ: doesn't show hand 
*** SUMMARY ***
Total pot $0.60 | Rake $0 
Seat 1: 6DwBRH+xZ12AAZmeAg+aXw (small blind) folded before Flop
Seat 2: NtrVQ9UIql0rDCnKDKZ5FQ (big blind) folded before Flop
Seat 3: kyRaCIljYA6l33lSKQfNsg folded before Flop (didn't bet)
Seat 4: 6elpmfyt4Zw0yvd8lePSMQ collected ($0.60)
Seat 5: kG34n23qFQA3nzdOJTQ1dA folded before Flop (didn't bet)
Seat 6: 7LpHJVeM6k1mQdC6HXYzww (button) folded before Flop (didn't bet)




PokerStars Game #59941848026:  Hold'em No Limit ($0.10/$0.25) - 2009/07/01 1:48:04 ET
Table 'FuFyQHmlO/QqQp//rDRrPg' 6-max Seat #6 is the button
Seat 1: jp34e617tIzV8tKIWmfAbA ($27.90 in chips) 
Seat 2: G3h3THGB1j3qdHDVHpnJWg ($31.10 in chips) 
Seat 3: EeUZtMU058v2ObUACOF4Og ($29.60 in chips) 
Seat 4: Ahsa9Yk5NPmCqQstq1EoQA ($21.80 in chips) 
Seat 5: xrf8tAXKQHG99HixCot1Iw ($25.25 in chips) 
Seat 6: 6DwBRH+xZ12AAZmeAg+aXw ($51.10 in chips) 
jp34e617tIzV8tKIWmfAbA: posts small blind $0.10
G3h3THGB1j3qdHDVHpnJWg: posts big blind $0.25
*** HOLE CARDS ***
EeUZtMU058v2ObUACOF4Og: folds 
Ahsa9Yk5NPmCqQstq1EoQA: raises $0.75 to $1
xrf8tAXKQHG99HixCot1Iw: folds 
6DwBRH+xZ12AAZmeAg+aXw: folds 
jp34e617tIzV8tKIWmfAbA: folds 
G3h3THGB1j3qdHDVHpnJWg: folds 
Uncalled bet ($0.75) returned to Ahsa9Yk5NPmCqQstq1EoQA
Ahsa9Yk5NPmCqQstq1EoQA collected $0.60 from pot
*** SUMMARY ***
Total pot $0.60 | Rake $0 
Seat 1: jp34e617tIzV8tKIWmfAbA (small blind) folded before Flop
Seat 2: G3h3THGB1j3qdHDVHpnJWg (big blind) folded before Flop
Seat 3: EeUZtMU058v2ObUACOF4Og folded before Flop (didn't bet)
Seat 4: Ahsa9Yk5NPmCqQstq1EoQA collected ($0.60)
Seat 5: xrf8tAXKQHG99HixCot1Iw folded before Flop (didn't bet)
Seat 6: 6DwBRH+xZ12AAZmeAg+aXw (button) folded before Flop (didn't bet)




PokerStars Game #59941848074:  Hold'em No Limit ($0.10/$0.25) - 2009/07/01 1:48:04 ET
Table 'NtEQAxCeIK2io1CGtW658g' 6-max Seat #1 is the button
Seat 1: X437kMQ7AujoaDgjguhU9w ($10.95 in chips) 
Seat 2: DgyznDqq/mLiCqQGMzc+Aw ($9.75 in chips) 
Seat 3: 5nwDw10uIM0XEyLhla0oGA ($24.45 in chips) 
Seat 4: 8296 ($9.45 in chips) 
Seat 5: Hsvkc0/G2VV78oVmWYXecw ($6.85 in chips) 
Seat 6: /gJNBeCkWL4o85/jvlZ4BA ($64.35 in chips) 
DgyznDqq/mLiCqQGMzc+Aw: posts small blind $0.10
5nwDw10uIM0XEyLhla0oGA: posts big blind $0.25
*** HOLE CARDS ***
8296: calls $0.25
Hsvkc0/G2VV78oVmWYXecw: folds 
/gJNBeCkWL4o85/jvlZ4BA: folds 
X437kMQ7AujoaDgjguhU9w: calls $0.25
DgyznDqq/mLiCqQGMzc+Aw: folds 
5nwDw10uIM0XEyLhla0oGA: checks 
*** FLOP *** [3c As 6s]
5nwDw10uIM0XEyLhla0oGA: checks 
8296: checks 
X437kMQ7AujoaDgjguhU9w: bets $0.75
5nwDw10uIM0XEyLhla0oGA: folds 
8296: folds 
Uncalled bet ($0.75) returned to X437kMQ7AujoaDgjguhU9w
X437kMQ7AujoaDgjguhU9w collected $0.85 from pot
X437kMQ7AujoaDgjguhU9w: doesn't show hand 
*** SUMMARY ***
Total pot $0.85 | Rake $0 
Board [3c As 6s]
Seat 1: X437kMQ7AujoaDgjguhU9w (button) collected ($0.85)
Seat 2: DgyznDqq/mLiCqQGMzc+Aw (small blind) folded before Flop
Seat 3: 5nwDw10uIM0XEyLhla0oGA (big blind) folded on the Flop
Seat 4: 8296 folded on the Flop
Seat 5: Hsvkc0/G2VV78oVmWYXecw folded before Flop (didn't bet)
Seat 6: /gJNBeCkWL4o85/jvlZ4BA folded before Flop (didn't bet)




PokerStars Game #59941848328:  Hold'em No Limit ($0.10/$0.25) - 2009/07/01 1:48:04 ET
Table 'MiquQrQZJJq9ZtgRIp9HFQ' 6-max Seat #6 is the button
Seat 1: c3J/KYZ4cNsUEuz8v57I5A ($24.75 in chips) 
Seat 2: 2+6voGl1T1DO63JePptI3g ($22.50 in chips) 
Seat 3: 9h7TNZ1TDGRUJXA6rI+ZTw ($9.75 in chips) 
Seat 4: wAKC8C/zN0c8V5v13dm9mA ($54.45 in chips) 
Seat 5: iyZxqznXjv3vtvOJymkoLQ ($26.75 in chips) 
Seat 6: GbCVUNssQ7mqsPWr7J4d3w ($4.65 in chips) 
c3J/KYZ4cNsUEuz8v57I5A: posts small blind $0.10
2+6voGl1T1DO63JePptI3g: posts big blind $0.25
*** HOLE CARDS ***
9h7TNZ1TDGRUJXA6rI+ZTw: folds 
wAKC8C/zN0c8V5v13dm9mA: raises $0.75 to $1
iyZxqznXjv3vtvOJymkoLQ: folds 
GbCVUNssQ7mqsPWr7J4d3w: folds 
c3J/KYZ4cNsUEuz8v57I5A: folds 
2+6voGl1T1DO63JePptI3g: calls $0.75
*** FLOP *** [Th 7d 2c]
2+6voGl1T1DO63JePptI3g: bets $2.25
wAKC8C/zN0c8V5v13dm9mA: calls $2.25
*** TURN *** [Th 7d 2c] [8h]
2+6voGl1T1DO63JePptI3g: bets $7.50
wAKC8C/zN0c8V5v13dm9mA: folds 
Uncalled bet ($7.50) returned to 2+6voGl1T1DO63JePptI3g
2+6voGl1T1DO63JePptI3g collected $6.30 from pot
*** SUMMARY ***
Total pot $6.60 | Rake $0.30 
Board [Th 7d 2c 8h]
Seat 1: c3J/KYZ4cNsUEuz8v57I5A (small blind) folded before Flop
Seat 2: 2+6voGl1T1DO63JePptI3g (big blind) collected ($6.30)
Seat 3: 9h7TNZ1TDGRUJXA6rI+ZTw folded before Flop (didn't bet)
Seat 4: wAKC8C/zN0c8V5v13dm9mA folded on the Turn
Seat 5: iyZxqznXjv3vtvOJymkoLQ folded before Flop (didn't bet)
Seat 6: GbCVUNssQ7mqsPWr7J4d3w (button) folded before Flop (didn't bet)




PokerStars Game #59941848110:  Hold'em No Limit ($0.10/$0.25) - 2009/07/01 1:48:04 ET
Table 'm+FQg/QP0VP1ZA3V62WtOg' 9-max Seat #7 is the button
Seat 3: +KblIivb6tainScpwm14RQ ($6.50 in chips) 
Seat 5: wf5j8xvJtko6ZXyCbzzlVQ ($8.65 in chips) 
Seat 6: CT7Xj/V/O5rBlhtt+RZeFQ ($38.60 in chips) 
Seat 7: TPAF9YkMsjQFq978RNWZEQ ($26.25 in chips) 
Seat 8: E0iYnEVO2ho7dH3QcCjw7g ($19.75 in chips) 
Seat 9: zUXhymECc2C9W9ZNw6qppA ($4.05 in chips) 
E0iYnEVO2ho7dH3QcCjw7g: posts small blind $0.10
zUXhymECc2C9W9ZNw6qppA: posts big blind $0.25
qwr38jl5txoR36M7G5qi4A: sits out 
yqkowiRWZ6NvRN9UUkYIlA: sits out 
dubÃ©705: sits out 
*** HOLE CARDS ***
+KblIivb6tainScpwm14RQ has timed out
+KblIivb6tainScpwm14RQ: folds 
+KblIivb6tainScpwm14RQ is sitting out
wf5j8xvJtko6ZXyCbzzlVQ: folds 
+KblIivb6tainScpwm14RQ has returned
CT7Xj/V/O5rBlhtt+RZeFQ: folds 
TPAF9YkMsjQFq978RNWZEQ: calls $0.25
E0iYnEVO2ho7dH3QcCjw7g: folds 
zUXhymECc2C9W9ZNw6qppA: checks 
*** FLOP *** [7c 2d 4s]
zUXhymECc2C9W9ZNw6qppA: checks 
TPAF9YkMsjQFq978RNWZEQ: bets $0.25
zUXhymECc2C9W9ZNw6qppA: calls $0.25
*** TURN *** [7c 2d 4s] [9d]
zUXhymECc2C9W9ZNw6qppA: checks 
TPAF9YkMsjQFq978RNWZEQ: checks 
*** RIVER *** [7c 2d 4s 9d] [Ah]
zUXhymECc2C9W9ZNw6qppA: checks 
TPAF9YkMsjQFq978RNWZEQ: bets $1
zUXhymECc2C9W9ZNw6qppA: folds 
Uncalled bet ($1) returned to TPAF9YkMsjQFq978RNWZEQ
TPAF9YkMsjQFq978RNWZEQ collected $1.05 from pot
*** SUMMARY ***
Total pot $1.10 | Rake $0.05 
Board [7c 2d 4s 9d Ah]
Seat 3: +KblIivb6tainScpwm14RQ folded before Flop (didn't bet)
Seat 5: wf5j8xvJtko6ZXyCbzzlVQ folded before Flop (didn't bet)
Seat 6: CT7Xj/V/O5rBlhtt+RZeFQ folded before Flop (didn't bet)
Seat 7: TPAF9YkMsjQFq978RNWZEQ (button) collected ($1.05)
Seat 8: E0iYnEVO2ho7dH3QcCjw7g (small blind) folded before Flop
Seat 9: zUXhymECc2C9W9ZNw6qppA (big blind) folded on the River




PokerStars Game #59941848228:  Hold'em No Limit ($0.10/$0.25) - 2009/07/01 1:48:04 ET
Table 'rpIHGyt2QpgQc5bvptAvDQ' 9-max Seat #4 is the button
Seat 1: E0iYnEVO2ho7dH3QcCjw7g ($24.10 in chips) 
Seat 3: N6a/f6AW8S8G3JFw9IFxAg ($18.50 in chips) 
Seat 4: ASXDkj9tmvF/T2AsNuxg7g ($5.85 in chips) 
Seat 5: XhSvfX1gy0yx/qeW+SOeTw ($8.05 in chips) 
Seat 6: Mq1ESwxx3LEsA4HjKKjU3Q ($19.25 in chips) 
Seat 7: GHgIdzlzMAmRmmX7jgXtuQ ($2.50 in chips) 
Seat 8: oUgIL46CfA9GCdIuN1TVSw ($8.95 in chips) 
XhSvfX1gy0yx/qeW+SOeTw: posts small blind $0.10
Mq1ESwxx3LEsA4HjKKjU3Q: posts big blind $0.25
sUVgUtgbfVx6JpvApozwhQ: sits out 
*** HOLE CARDS ***
GHgIdzlzMAmRmmX7jgXtuQ: calls $0.25
oUgIL46CfA9GCdIuN1TVSw: folds 
E0iYnEVO2ho7dH3QcCjw7g: folds 
N6a/f6AW8S8G3JFw9IFxAg: calls $0.25
FX0yWp7Ul3dMebXB0cFjEw has returned
ASXDkj9tmvF/T2AsNuxg7g: calls $0.25
XhSvfX1gy0yx/qeW+SOeTw: calls $0.15
Mq1ESwxx3LEsA4HjKKjU3Q: checks 
*** FLOP *** [7d Js Kd]
XhSvfX1gy0yx/qeW+SOeTw: checks 
Mq1ESwxx3LEsA4HjKKjU3Q: checks 
GHgIdzlzMAmRmmX7jgXtuQ: bets $0.25
N6a/f6AW8S8G3JFw9IFxAg: calls $0.25
ASXDkj9tmvF/T2AsNuxg7g: folds 
XhSvfX1gy0yx/qeW+SOeTw: calls $0.25
Mq1ESwxx3LEsA4HjKKjU3Q: calls $0.25
*** TURN *** [7d Js Kd] [Tc]
XhSvfX1gy0yx/qeW+SOeTw: checks 
Mq1ESwxx3LEsA4HjKKjU3Q: checks 
GHgIdzlzMAmRmmX7jgXtuQ: bets $0.25
N6a/f6AW8S8G3JFw9IFxAg: raises $1 to $1.25
XhSvfX1gy0yx/qeW+SOeTw: folds 
Mq1ESwxx3LEsA4HjKKjU3Q: folds 
GHgIdzlzMAmRmmX7jgXtuQ: calls $1
*** RIVER *** [7d Js Kd Tc] [3c]
GHgIdzlzMAmRmmX7jgXtuQ: checks 
N6a/f6AW8S8G3JFw9IFxAg: bets $2
GHgIdzlzMAmRmmX7jgXtuQ: folds 
Uncalled bet ($2) returned to N6a/f6AW8S8G3JFw9IFxAg
N6a/f6AW8S8G3JFw9IFxAg collected $4.55 from pot
*** SUMMARY ***
Total pot $4.75 | Rake $0.20 
Board [7d Js Kd Tc 3c]
Seat 1: E0iYnEVO2ho7dH3QcCjw7g folded before Flop (didn't bet)
Seat 3: N6a/f6AW8S8G3JFw9IFxAg collected ($4.55)
Seat 4: ASXDkj9tmvF/T2AsNuxg7g (button) folded on the Flop
Seat 5: XhSvfX1gy0yx/qeW+SOeTw (small blind) folded on the Turn
Seat 6: Mq1ESwxx3LEsA4HjKKjU3Q (big blind) folded on the Turn
Seat 7: GHgIdzlzMAmRmmX7jgXtuQ folded on the River
Seat 8: oUgIL46CfA9GCdIuN1TVSw folded before Flop (didn't bet)




PokerStars Game #59941848326:  Hold'em No Limit ($0.10/$0.25) - 2009/07/01 1:48:04 ET
Table 'CM/C/FZf3VHIp50RjmBucQ' 9-max Seat #6 is the button
Seat 1: P8h+GtgJJRwRh2YdssBtbg ($4.75 in chips) 
Seat 2: +aNWwNic2LVhXcMqH+ezrA ($14.90 in chips) 
Seat 3: HPEB+AtKw1+C/cxU0o1ciw ($54.45 in chips) 
Seat 4: FYIiLXWy4mKC5ZGa/fnS0g ($15.65 in chips) 
Seat 5: t3m1RlE+8m1yb0ojo8ikCw ($13.40 in chips) 
Seat 6: FqpibuVWLNsAN/Z7ROZLnA ($6.55 in chips) 
Seat 7: +T7KwHtNiHQt6JhQegSH/w ($4.50 in chips) 
Seat 8: 5pDhXQ+RVy0BGcwfJAJfbg ($25 in chips) 
+T7KwHtNiHQt6JhQegSH/w: posts small blind $0.10
5pDhXQ+RVy0BGcwfJAJfbg: posts big blind $0.25
W6tExOcYX7qiy6Qdp+ZwFA: sits out 
*** HOLE CARDS ***
P8h+GtgJJRwRh2YdssBtbg: raises $0.25 to $0.50
+aNWwNic2LVhXcMqH+ezrA: folds 
HPEB+AtKw1+C/cxU0o1ciw: folds 
FYIiLXWy4mKC5ZGa/fnS0g: folds 
t3m1RlE+8m1yb0ojo8ikCw: folds 
FqpibuVWLNsAN/Z7ROZLnA: folds 
+T7KwHtNiHQt6JhQegSH/w: calls $0.40
5pDhXQ+RVy0BGcwfJAJfbg: folds 
*** FLOP *** [5h Qh Ah]
+T7KwHtNiHQt6JhQegSH/w: bets $4 and is all-in
FqpibuVWLNsAN/Z7ROZLnA is sitting out
P8h+GtgJJRwRh2YdssBtbg: folds 
Uncalled bet ($4) returned to +T7KwHtNiHQt6JhQegSH/w
FqpibuVWLNsAN/Z7ROZLnA has returned
+T7KwHtNiHQt6JhQegSH/w collected $1.20 from pot
+T7KwHtNiHQt6JhQegSH/w: doesn't show hand 
*** SUMMARY ***
Total pot $1.25 | Rake $0.05 
Board [5h Qh Ah]
Seat 1: P8h+GtgJJRwRh2YdssBtbg folded on the Flop
Seat 2: +aNWwNic2LVhXcMqH+ezrA folded before Flop (didn't bet)
Seat 3: HPEB+AtKw1+C/cxU0o1ciw folded before Flop (didn't bet)
Seat 4: FYIiLXWy4mKC5ZGa/fnS0g folded before Flop (didn't bet)
Seat 5: t3m1RlE+8m1yb0ojo8ikCw folded before Flop (didn't bet)
Seat 6: FqpibuVWLNsAN/Z7ROZLnA (button) folded before Flop (didn't bet)
Seat 7: +T7KwHtNiHQt6JhQegSH/w (small blind) collected ($1.20)
Seat 8: 5pDhXQ+RVy0BGcwfJAJfbg (big blind) folded before Flop




PokerStars Game #59941848034:  Hold'em No Limit ($0.10/$0.25) - 2009/07/01 1:48:04 ET
Table 'SgI2Cobdjtkh0Fd0/eTTDg' 9-max Seat #9 is the button
Seat 2: uUc5QTI8+ZdC95UnznCsqg ($14.60 in chips) 
Seat 3: GeMoapCKDLc4ajT0Uk9ZQw ($10 in chips) 
Seat 4: s1y+qfkBnhgc67+X3ThjeA ($8.15 in chips) 
Seat 5: RHqgdFvufLCYe54+qd2gcA ($6.25 in chips) 
Seat 6: 6RiVTYll/5D8zICp0MRpKw ($27.85 in chips) 
Seat 7: RY9uq/FyiWrrnWBl/zGQKg ($19.50 in chips) 
Seat 8: wzU16tcf+7nj2MYKa4h7+Q ($15 in chips) 
Seat 9: cZ99hugmLBj9KhTlc8nCSw ($30.60 in chips) 
p4VoE724cQin02zatf/NOw will be allowed to play after the button
uUc5QTI8+ZdC95UnznCsqg: posts small blind $0.10
GeMoapCKDLc4ajT0Uk9ZQw: posts big blind $0.25
RY9uq/FyiWrrnWBl/zGQKg: posts big blind $0.25
wzU16tcf+7nj2MYKa4h7+Q: posts big blind $0.25
*** HOLE CARDS ***
s1y+qfkBnhgc67+X3ThjeA: folds 
RHqgdFvufLCYe54+qd2gcA: folds 
6RiVTYll/5D8zICp0MRpKw: folds 
RY9uq/FyiWrrnWBl/zGQKg: checks 
wzU16tcf+7nj2MYKa4h7+Q: checks 
cZ99hugmLBj9KhTlc8nCSw: folds 
uUc5QTI8+ZdC95UnznCsqg: calls $0.15
GeMoapCKDLc4ajT0Uk9ZQw: checks 
*** FLOP *** [5s 3c 2c]
uUc5QTI8+ZdC95UnznCsqg: checks 
GeMoapCKDLc4ajT0Uk9ZQw: checks 
RY9uq/FyiWrrnWBl/zGQKg: checks 
wzU16tcf+7nj2MYKa4h7+Q: checks 
*** TURN *** [5s 3c 2c] [Qh]
uUc5QTI8+ZdC95UnznCsqg: checks 
GeMoapCKDLc4ajT0Uk9ZQw: checks 
RY9uq/FyiWrrnWBl/zGQKg: bets $0.25
wzU16tcf+7nj2MYKa4h7+Q: calls $0.25
uUc5QTI8+ZdC95UnznCsqg: calls $0.25
GeMoapCKDLc4ajT0Uk9ZQw: folds 
*** RIVER *** [5s 3c 2c Qh] [Jd]
uUc5QTI8+ZdC95UnznCsqg: checks 
RY9uq/FyiWrrnWBl/zGQKg: bets $0.25
wzU16tcf+7nj2MYKa4h7+Q: folds 
uUc5QTI8+ZdC95UnznCsqg: folds 
Uncalled bet ($0.25) returned to RY9uq/FyiWrrnWBl/zGQKg
RY9uq/FyiWrrnWBl/zGQKg collected $1.70 from pot
*** SUMMARY ***
Total pot $1.75 | Rake $0.05 
Board [5s 3c 2c Qh Jd]
Seat 2: uUc5QTI8+ZdC95UnznCsqg (small blind) folded on the River
Seat 3: GeMoapCKDLc4ajT0Uk9ZQw (big blind) folded on the Turn
Seat 4: s1y+qfkBnhgc67+X3ThjeA folded before Flop (didn't bet)
Seat 5: RHqgdFvufLCYe54+qd2gcA folded before Flop (didn't bet)
Seat 6: 6RiVTYll/5D8zICp0MRpKw folded before Flop (didn't bet)
Seat 7: RY9uq/FyiWrrnWBl/zGQKg collected ($1.70)
Seat 8: wzU16tcf+7nj2MYKa4h7+Q folded on the River
Seat 9: cZ99hugmLBj9KhTlc8nCSw (button) folded before Flop (didn't bet)




PokerStars Game #59941848608:  Hold'em No Limit ($0.10/$0.25) - 2009/07/01 1:48:05 ET
Table 'oxYpQNT8OHNCvpMIFi7UoA' 9-max Seat #4 is the button
Seat 1: EVqHvqty1ZsuvDFiSXlSqQ ($33.20 in chips) 
Seat 2: 8+iP8mvFyeAviW/yUH1CJg ($32 in chips) 
Seat 3: ubsjZomMWSV0hAiBLa7K1A ($19.80 in chips) 
Seat 4: eK8qa6EPcH2zhtbmWSvc9g ($25 in chips) 
Seat 5: ZoqLw33zTU6EsjOkfv/cGw ($18.90 in chips) 
Seat 6: VBHxUExRAMrbxUq/cVx9Gw ($5.40 in chips) 
Seat 7: X78b5v/uhqeXXoAijbw/yg ($35.65 in chips) 
Seat 9: pN3IHvAKm2fz+sTRARTcrg ($25 in chips) 
ZoqLw33zTU6EsjOkfv/cGw: posts small blind $0.10
VBHxUExRAMrbxUq/cVx9Gw: posts big blind $0.25
*** HOLE CARDS ***
X78b5v/uhqeXXoAijbw/yg: folds 
pN3IHvAKm2fz+sTRARTcrg: folds 
EVqHvqty1ZsuvDFiSXlSqQ: calls $0.25
8+iP8mvFyeAviW/yUH1CJg: folds 
ubsjZomMWSV0hAiBLa7K1A: folds 
eK8qa6EPcH2zhtbmWSvc9g: folds 
ZoqLw33zTU6EsjOkfv/cGw: calls $0.15
VBHxUExRAMrbxUq/cVx9Gw: checks 
*** FLOP *** [As Kh 3s]
ZoqLw33zTU6EsjOkfv/cGw: checks 
VBHxUExRAMrbxUq/cVx9Gw: checks 
EVqHvqty1ZsuvDFiSXlSqQ: checks 
*** TURN *** [As Kh 3s] [6s]
ZoqLw33zTU6EsjOkfv/cGw: bets $1.50
VBHxUExRAMrbxUq/cVx9Gw: folds 
EVqHvqty1ZsuvDFiSXlSqQ: folds 
Uncalled bet ($1.50) returned to ZoqLw33zTU6EsjOkfv/cGw
ZoqLw33zTU6EsjOkfv/cGw collected $0.75 from pot
ZoqLw33zTU6EsjOkfv/cGw: doesn't show hand 
*** SUMMARY ***
Total pot $0.75 | Rake $0 
Board [As Kh 3s 6s]
Seat 1: EVqHvqty1ZsuvDFiSXlSqQ folded on the Turn
Seat 2: 8+iP8mvFyeAviW/yUH1CJg folded before Flop (didn't bet)
Seat 3: ubsjZomMWSV0hAiBLa7K1A folded before Flop (didn't bet)
Seat 4: eK8qa6EPcH2zhtbmWSvc9g (button) folded before Flop (didn't bet)
Seat 5: ZoqLw33zTU6EsjOkfv/cGw (small blind) collected ($0.75)
Seat 6: VBHxUExRAMrbxUq/cVx9Gw (big blind) folded on the Turn
Seat 7: X78b5v/uhqeXXoAijbw/yg folded before Flop (didn't bet)
Seat 9: pN3IHvAKm2fz+sTRARTcrg folded before Flop (didn't bet)




PokerStars Game #59941848402:  Hold'em No Limit ($0.10/$0.25) - 2009/07/01 1:48:05 ET
Table 'pyZQRcpxhWj2y2cT/ydvww52Meibn9NOL4XtVi1p2Upwx Seat #5 is the button
Seat 1: egvg3mTBBVzMHnJPIQiKcA ($16.30 in chips) 
Seat 2: Th3FldXKQW6hWVVPahaoOQ ($101.80 in chips) 
Seat 3: zgi+EUykT/pZQpoUG6+oEg ($4.30 in chips) 
Seat 4: NjesyqE7PJi4nEOa0oOq9w ($15.65 in chips) 
Seat 5: 5n7e7I+px7c6CQmLpPbtsg ($4.35 in chips) 
Seat 6: uvfXVx90QtCYG4geTioN+A ($24.75 in chips) 
Seat 8: ipgcO7Pa6LC8XWpVttZfnA ($5 in chips) 
Seat 9: bC+Wg1ntzw3N48OwuR1eag ($5.15 in chips) 
uvfXVx90QtCYG4geTioN+A: posts small blind $0.10
sGFnnRCa1YAHAUmWgsW6Qg: is sitting out 
sGFnnRCa1YAHAUmWgsW6Qg leaves the table
ipgcO7Pa6LC8XWpVttZfnA: posts big blind $0.25
*** HOLE CARDS ***
mMd8CDS/but3UC+Zp7Up2w joins the table at seat #7 
bC+Wg1ntzw3N48OwuR1eag: raises $0.25 to $0.50
egvg3mTBBVzMHnJPIQiKcA: folds 
Th3FldXKQW6hWVVPahaoOQ: folds 
zgi+EUykT/pZQpoUG6+oEg: folds 
NjesyqE7PJi4nEOa0oOq9w: folds 
5n7e7I+px7c6CQmLpPbtsg: folds 
uvfXVx90QtCYG4geTioN+A: calls $0.40
ipgcO7Pa6LC8XWpVttZfnA: folds 
*** FLOP *** [4d 3d Kc]
uvfXVx90QtCYG4geTioN+A: checks 
bC+Wg1ntzw3N48OwuR1eag: bets $0.25
uvfXVx90QtCYG4geTioN+A: calls $0.25
*** TURN *** [4d 3d Kc] [5c]
uvfXVx90QtCYG4geTioN+A: checks 
bC+Wg1ntzw3N48OwuR1eag is disconnected 
bC+Wg1ntzw3N48OwuR1eag is connected 
bC+Wg1ntzw3N48OwuR1eag: bets $0.50
uvfXVx90QtCYG4geTioN+A: calls $0.50
*** RIVER *** [4d 3d Kc 5c] [9h]
uvfXVx90QtCYG4geTioN+A: checks 
bC+Wg1ntzw3N48OwuR1eag: bets $0.90
uvfXVx90QtCYG4geTioN+A: folds 
Uncalled bet ($0.90) returned to bC+Wg1ntzw3N48OwuR1eag
bC+Wg1ntzw3N48OwuR1eag collected $2.65 from pot
bC+Wg1ntzw3N48OwuR1eag: doesn't show hand 
*** SUMMARY ***
Total pot $2.75 | Rake $0.10 
Board [4d 3d Kc 5c 9h]
Seat 1: egvg3mTBBVzMHnJPIQiKcA folded before Flop (didn't bet)
Seat 2: Th3FldXKQW6hWVVPahaoOQ folded before Flop (didn't bet)
Seat 3: zgi+EUykT/pZQpoUG6+oEg folded before Flop (didn't bet)
Seat 4: NjesyqE7PJi4nEOa0oOq9w folded before Flop (didn't bet)
Seat 5: 5n7e7I+px7c6CQmLpPbtsg (button) folded before Flop (didn't bet)
Seat 6: uvfXVx90QtCYG4geTioN+A (small blind) folded on the River
Seat 8: ipgcO7Pa6LC8XWpVttZfnA (big blind) folded before Flop
Seat 9: bC+Wg1ntzw3N48OwuR1eag collected ($2.65)




PokerStars Game #59941848802:  Hold'em No Limit ($0.10/$0.25) - 2009/07/01 1:48:05 ET
Table 'KEoOIegxPF91KooL2AelUA' 6-max Seat #2 is the button
Seat 2: 0Bg59Tnte1Tc7C4i9Jd9cQ ($5.40 in chips) 
Seat 3: zxeVQGaMKDsDzmSY+AInjA ($13.20 in chips) 
Seat 4: Wo60l2GQnSEc3bxPVyvIUw ($9.10 in chips) 
Seat 5: 08V++DOqzaNrRNsHIwi25w ($51.75 in chips) 
Seat 6: AMrBn4Vx9aAo/vv6WHLk6w ($2.65 in chips) 
zxeVQGaMKDsDzmSY+AInjA: posts small blind $0.10
Wo60l2GQnSEc3bxPVyvIUw: posts big blind $0.25
32YL2ZEp8NT4JB2RVM9euQ: sits out 
*** HOLE CARDS ***
08V++DOqzaNrRNsHIwi25w: folds 
AMrBn4Vx9aAo/vv6WHLk6w: raises $0.50 to $0.75
0Bg59Tnte1Tc7C4i9Jd9cQ: folds 
zxeVQGaMKDsDzmSY+AInjA: folds 
Wo60l2GQnSEc3bxPVyvIUw: raises $1.75 to $2.50
AMrBn4Vx9aAo/vv6WHLk6w: folds 
Uncalled bet ($1.75) returned to Wo60l2GQnSEc3bxPVyvIUw
Wo60l2GQnSEc3bxPVyvIUw collected $1.60 from pot
*** SUMMARY ***
Total pot $1.60 | Rake $0 
Seat 2: 0Bg59Tnte1Tc7C4i9Jd9cQ (button) folded before Flop (didn't bet)
Seat 3: zxeVQGaMKDsDzmSY+AInjA (small blind) folded before Flop
Seat 4: Wo60l2GQnSEc3bxPVyvIUw (big blind) collected ($1.60)
Seat 5: 08V++DOqzaNrRNsHIwi25w folded before Flop (didn't bet)
Seat 6: AMrBn4Vx9aAo/vv6WHLk6w folded before Flop




PokerStars Game #59941848418:  Hold'em No Limit ($0.10/$0.25) - 2009/07/01 1:48:05 ET
Table 'PCxB2W9H6ma8SwsZlImuOw' 9-max Seat #2 is the button
Seat 1: SqibpGx+lf+brY0fJVvD0w ($24.75 in chips) 
Seat 2: bXpVeaSTPBFSPJmeXxO7nw ($4.65 in chips) 
Seat 3: J2a/QHAWUgo6beDRoEyg2g ($6.70 in chips) 
Seat 4: RsPwA2DnzOke3hD/Of/DUg ($2.55 in chips) 
Seat 5: GZO7tOXatVoX17M2DqPcUQ ($21.40 in chips) 
Seat 6: 5/6dWEBUHldD7iGXa2LwsQ ($16.20 in chips) 
Seat 7: c/9X4zftzphFxYtxp5kp9w ($27.75 in chips) 
Seat 8: Pt637jKksB5MzP0UNJAAkw ($25.60 in chips) 
Seat 9: COwSH15MvHaRF7en6/TRZQ ($6.70 in chips) 
J2a/QHAWUgo6beDRoEyg2g: posts small blind $0.10
RsPwA2DnzOke3hD/Of/DUg: posts big blind $0.25
*** HOLE CARDS ***
GZO7tOXatVoX17M2DqPcUQ: calls $0.25
5/6dWEBUHldD7iGXa2LwsQ: folds 
c/9X4zftzphFxYtxp5kp9w: folds 
Pt637jKksB5MzP0UNJAAkw: folds 
COwSH15MvHaRF7en6/TRZQ: folds 
SqibpGx+lf+brY0fJVvD0w: raises $0.75 to $1
bXpVeaSTPBFSPJmeXxO7nw: folds 
J2a/QHAWUgo6beDRoEyg2g: folds 
RsPwA2DnzOke3hD/Of/DUg: folds 
GZO7tOXatVoX17M2DqPcUQ: calls $0.75
*** FLOP *** [Jh Jd Qh]
GZO7tOXatVoX17M2DqPcUQ: bets $1.75
SqibpGx+lf+brY0fJVvD0w: calls $1.75
*** TURN *** [Jh Jd Qh] [Tc]
GZO7tOXatVoX17M2DqPcUQ: bets $2.50
SqibpGx+lf+brY0fJVvD0w: calls $2.50
*** RIVER *** [Jh Jd Qh Tc] [6d]
GZO7tOXatVoX17M2DqPcUQ: bets $4
SqibpGx+lf+brY0fJVvD0w: calls $4
*** SHOW DOWN ***
GZO7tOXatVoX17M2DqPcUQ: shows [Qd Kh] (two pair, Queens and Jacks)
SqibpGx+lf+brY0fJVvD0w: shows [Qc As] (two pair, Queens and Jacks - Ace kicker)
SqibpGx+lf+brY0fJVvD0w collected $17.95 from pot
*** SUMMARY ***
Total pot $18.85 | Rake $0.90 
Board [Jh Jd Qh Tc 6d]
Seat 1: SqibpGx+lf+brY0fJVvD0w showed [Qc As] and won ($17.95) with two pair, Queens and Jacks
Seat 2: bXpVeaSTPBFSPJmeXxO7nw (button) folded before Flop (didn't bet)
Seat 3: J2a/QHAWUgo6beDRoEyg2g (small blind) folded before Flop
Seat 4: RsPwA2DnzOke3hD/Of/DUg (big blind) folded before Flop
Seat 5: GZO7tOXatVoX17M2DqPcUQ showed [Qd Kh] and lost with two pair, Queens and Jacks
Seat 6: 5/6dWEBUHldD7iGXa2LwsQ folded before Flop (didn't bet)
Seat 7: c/9X4zftzphFxYtxp5kp9w folded before Flop (didn't bet)
Seat 8: Pt637jKksB5MzP0UNJAAkw folded before Flop (didn't bet)
Seat 9: COwSH15MvHaRF7en6/TRZQ folded before Flop (didn't bet)




PokerStars Game #59941848630:  Hold'em No Limit ($0.10/$0.25) - 2009/07/01 1:48:05 ET
Table 'g6ryG70feTw9nNm+XJLuXw' 6-max Seat #5 is the button
Seat 1: v+QfkGiuj9bgtuNoVnDO8w ($35.60 in chips) 
Seat 2: SxIIgwXYLkwd6m3wLyPTCw ($33.90 in chips) 
Seat 3: cezpHJ8FB07dj0xG+LhOvw ($25 in chips) 
Seat 4: GC/9yVD59DUCX7hUI7gcLw ($45 in chips) 
Seat 5: EE16Ua5b1HSsYej5zeXOlA ($25 in chips) 
Seat 6: Mhj3q7cxev+XjXZxEE6/Cw ($25 in chips) 
Mhj3q7cxev+XjXZxEE6/Cw: posts small blind $0.10
v+QfkGiuj9bgtuNoVnDO8w: posts big blind $0.25
*** HOLE CARDS ***
SxIIgwXYLkwd6m3wLyPTCw: folds 
cezpHJ8FB07dj0xG+LhOvw: folds 
GC/9yVD59DUCX7hUI7gcLw: folds 
EE16Ua5b1HSsYej5zeXOlA: folds 
Mhj3q7cxev+XjXZxEE6/Cw: raises $0.50 to $0.75
v+QfkGiuj9bgtuNoVnDO8w: calls $0.50
*** FLOP *** [8h 9d 8s]
Mhj3q7cxev+XjXZxEE6/Cw: bets $1
v+QfkGiuj9bgtuNoVnDO8w: folds 
Uncalled bet ($1) returned to Mhj3q7cxev+XjXZxEE6/Cw
Mhj3q7cxev+XjXZxEE6/Cw collected $1.45 from pot
Mhj3q7cxev+XjXZxEE6/Cw: doesn't show hand 
*** SUMMARY ***
Total pot $1.50 | Rake $0.05 
Board [8h 9d 8s]
Seat 1: v+QfkGiuj9bgtuNoVnDO8w (big blind) folded on the Flop
Seat 2: SxIIgwXYLkwd6m3wLyPTCw folded before Flop (didn't bet)
Seat 3: cezpHJ8FB07dj0xG+LhOvw folded before Flop (didn't bet)
Seat 4: GC/9yVD59DUCX7hUI7gcLw folded before Flop (didn't bet)
Seat 5: EE16Ua5b1HSsYej5zeXOlA (button) folded before Flop (didn't bet)
Seat 6: Mhj3q7cxev+XjXZxEE6/Cw (small blind) collected ($1.45)




PokerStars Game #59941848472:  Hold'em No Limit ($0.10/$0.25) - 2009/07/01 1:48:05 ET
Table 'HzFR0rxmDAPu5GzYR0AlYg' 6-max Seat #6 is the button
Seat 1: v+QfkGiuj9bgtuNoVnDO8w ($31.80 in chips) 
Seat 2: UA5OsKS3VPaxa7uC8La/kA ($51.60 in chips) 
Seat 3: kG34n23qFQA3nzdOJTQ1dA ($24.90 in chips) 
Seat 4: Mhj3q7cxev+XjXZxEE6/Cw ($25.35 in chips) 
Seat 5: lquriepNQBhDV5P1SWHhnA ($29.50 in chips) 
Seat 6: jp34e617tIzV8tKIWmfAbA ($35.55 in chips) 
v+QfkGiuj9bgtuNoVnDO8w: posts small blind $0.10
UA5OsKS3VPaxa7uC8La/kA: posts big blind $0.25
*** HOLE CARDS ***
kG34n23qFQA3nzdOJTQ1dA: folds 
Mhj3q7cxev+XjXZxEE6/Cw: folds 
lquriepNQBhDV5P1SWHhnA: raises $0.50 to $0.75
jp34e617tIzV8tKIWmfAbA: folds 
v+QfkGiuj9bgtuNoVnDO8w: raises $2 to $2.75
UA5OsKS3VPaxa7uC8La/kA: folds 
lquriepNQBhDV5P1SWHhnA: calls $2
*** FLOP *** [4c Tc Qd]
v+QfkGiuj9bgtuNoVnDO8w: bets $4.25
lquriepNQBhDV5P1SWHhnA: folds 
Uncalled bet ($4.25) returned to v+QfkGiuj9bgtuNoVnDO8w
v+QfkGiuj9bgtuNoVnDO8w collected $5.50 from pot
v+QfkGiuj9bgtuNoVnDO8w: doesn't show hand 
*** SUMMARY ***
Total pot $5.75 | Rake $0.25 
Board [4c Tc Qd]
Seat 1: v+QfkGiuj9bgtuNoVnDO8w (small blind) collected ($5.50)
Seat 2: UA5OsKS3VPaxa7uC8La/kA (big blind) folded before Flop
Seat 3: kG34n23qFQA3nzdOJTQ1dA folded before Flop (didn't bet)
Seat 4: Mhj3q7cxev+XjXZxEE6/Cw folded before Flop (didn't bet)
Seat 5: lquriepNQBhDV5P1SWHhnA folded on the Flop
Seat 6: jp34e617tIzV8tKIWmfAbA (button) folded before Flop (didn't bet)




PokerStars Game #59941848906:  Hold'em No Limit ($0.10/$0.25) - 2009/07/01 1:48:06 ET
Table 'jdhJTJjFq2KTttwJcd+7nQ' 6-max Seat #6 is the button
Seat 1: LtASJ9OlkqGrrUKGQlpGAw ($26.60 in chips) 
Seat 2: Hsvkc0/G2VV78oVmWYXecw ($5 in chips) 
Seat 3: vqWjZmdQu/Hxw96/IJTWdQ ($29.30 in chips) 
Seat 4: vx7FwRcelVSsvNYAdp/z0A ($6.50 in chips) 
Seat 5: BV+K0Phf5VBHr7aZPKqbUQ ($25.75 in chips) 
Seat 6: yb6rnd48JuBccThV68VHAQ ($15.55 in chips) 
LtASJ9OlkqGrrUKGQlpGAw: posts small blind $0.10
Hsvkc0/G2VV78oVmWYXecw: posts big blind $0.25
*** HOLE CARDS ***
vqWjZmdQu/Hxw96/IJTWdQ: folds 
vx7FwRcelVSsvNYAdp/z0A: calls $0.25
BV+K0Phf5VBHr7aZPKqbUQ: raises $1 to $1.25
yb6rnd48JuBccThV68VHAQ: folds 
LtASJ9OlkqGrrUKGQlpGAw: folds 
Hsvkc0/G2VV78oVmWYXecw: folds 
vx7FwRcelVSsvNYAdp/z0A: calls $1
*** FLOP *** [6s 5s 2h]
vx7FwRcelVSsvNYAdp/z0A: bets $0.25
BV+K0Phf5VBHr7aZPKqbUQ: raises $2 to $2.25
vx7FwRcelVSsvNYAdp/z0A: folds 
Uncalled bet ($2) returned to BV+K0Phf5VBHr7aZPKqbUQ
BV+K0Phf5VBHr7aZPKqbUQ collected $3.20 from pot
BV+K0Phf5VBHr7aZPKqbUQ: doesn't show hand 
*** SUMMARY ***
Total pot $3.35 | Rake $0.15 
Board [6s 5s 2h]
Seat 1: LtASJ9OlkqGrrUKGQlpGAw (small blind) folded before Flop
Seat 2: Hsvkc0/G2VV78oVmWYXecw (big blind) folded before Flop
Seat 3: vqWjZmdQu/Hxw96/IJTWdQ folded before Flop (didn't bet)
Seat 4: vx7FwRcelVSsvNYAdp/z0A folded on the Flop
Seat 5: BV+K0Phf5VBHr7aZPKqbUQ collected ($3.20)
Seat 6: yb6rnd48JuBccThV68VHAQ (button) folded before Flop (didn't bet)




PokerStars Game #59941849148:  Hold'em No Limit ($0.10/$0.25) - 2009/07/01 1:48:06 ET
Table '3Ns9nuTkynfwbBfBXzg6ww' 6-max Seat #4 is the button
Seat 1: epAUIB7h2FJXzUPRIvSkRA ($25.70 in chips) 
Seat 2: zxeVQGaMKDsDzmSY+AInjA ($31.65 in chips) 
Seat 3: eL3+wCBjFGfQ5FMdIZihwA ($23.95 in chips) 
Seat 4: qGHGf/553gQnDoklMRe3tg ($30.25 in chips) 
Seat 5: wqphQtauX5Qn7WRJZS1flA ($24.15 in chips) 
Seat 6: DE9hRlt14g+JdsRQ4wT7hg ($39.10 in chips) 
wqphQtauX5Qn7WRJZS1flA: posts small blind $0.10
DE9hRlt14g+JdsRQ4wT7hg: posts big blind $0.25
*** HOLE CARDS ***
epAUIB7h2FJXzUPRIvSkRA: folds 
zxeVQGaMKDsDzmSY+AInjA: calls $0.25
eL3+wCBjFGfQ5FMdIZihwA: folds 
qGHGf/553gQnDoklMRe3tg: raises $1 to $1.25
wqphQtauX5Qn7WRJZS1flA: folds 
DE9hRlt14g+JdsRQ4wT7hg: folds 
zxeVQGaMKDsDzmSY+AInjA: folds 
Uncalled bet ($1) returned to qGHGf/553gQnDoklMRe3tg
qGHGf/553gQnDoklMRe3tg collected $0.85 from pot
*** SUMMARY ***
Total pot $0.85 | Rake $0 
Seat 1: epAUIB7h2FJXzUPRIvSkRA folded before Flop (didn't bet)
Seat 2: zxeVQGaMKDsDzmSY+AInjA folded before Flop
Seat 3: eL3+wCBjFGfQ5FMdIZihwA folded before Flop (didn't bet)
Seat 4: qGHGf/553gQnDoklMRe3tg (button) collected ($0.85)
Seat 5: wqphQtauX5Qn7WRJZS1flA (small blind) folded before Flop
Seat 6: DE9hRlt14g+JdsRQ4wT7hg (big blind) folded before Flop




PokerStars Game #59941849044:  Hold'em No Limit ($0.10/$0.25) - 2009/07/01 1:48:06 ET
Table '7/qMNloI0nSXWiX5Y1watA' 9-max Seat #4 is the button
Seat 1: /LyhaB3V6jkgOfXORidqRQ ($8.20 in chips) 
Seat 2: wGigCmBR/9XWkPpvYos3aQ ($25.10 in chips) 
Seat 3: W2YYHvqjaEpRrO7stZkClQ ($5 in chips) 
Seat 4: K0LdhPeU31rviEPo6Sv3TA ($8.30 in chips) 
Seat 6: Y3DZ6qQlLeBhixDj4M9vmg ($14.85 in chips) 
Seat 8: ljemhp25Zg+nlA9DLCIiUw ($26.40 in chips) 
Seat 9: dmYlc+1cjwZMJ7wV+Z0rRg ($27.05 in chips) 
botones was removed from the table for failing to post
Y3DZ6qQlLeBhixDj4M9vmg: posts small blind $0.10
ljemhp25Zg+nlA9DLCIiUw: posts big blind $0.25
*** HOLE CARDS ***
dmYlc+1cjwZMJ7wV+Z0rRg: folds 
/LyhaB3V6jkgOfXORidqRQ: raises $0.50 to $0.75
wGigCmBR/9XWkPpvYos3aQ: calls $0.75
W2YYHvqjaEpRrO7stZkClQ: folds 
K0LdhPeU31rviEPo6Sv3TA: folds 
Y3DZ6qQlLeBhixDj4M9vmg: calls $0.65
ljemhp25Zg+nlA9DLCIiUw: folds 
*** FLOP *** [Kd 9h Qc]
Y3DZ6qQlLeBhixDj4M9vmg: checks 
GeMoapCKDLc4ajT0Uk9ZQw joins the table at seat #5 
/LyhaB3V6jkgOfXORidqRQ: bets $1
wGigCmBR/9XWkPpvYos3aQ: folds 
Y3DZ6qQlLeBhixDj4M9vmg: calls $1
*** TURN *** [Kd 9h Qc] [8d]
Y3DZ6qQlLeBhixDj4M9vmg: checks 
/LyhaB3V6jkgOfXORidqRQ: bets $1
Y3DZ6qQlLeBhixDj4M9vmg: folds 
Uncalled bet ($1) returned to /LyhaB3V6jkgOfXORidqRQ
/LyhaB3V6jkgOfXORidqRQ collected $4.30 from pot
*** SUMMARY ***
Total pot $4.50 | Rake $0.20 
Board [Kd 9h Qc 8d]
Seat 1: /LyhaB3V6jkgOfXORidqRQ collected ($4.30)
Seat 2: wGigCmBR/9XWkPpvYos3aQ folded on the Flop
Seat 3: W2YYHvqjaEpRrO7stZkClQ folded before Flop (didn't bet)
Seat 4: K0LdhPeU31rviEPo6Sv3TA (button) folded before Flop (didn't bet)
Seat 6: Y3DZ6qQlLeBhixDj4M9vmg (small blind) folded on the Turn
Seat 8: ljemhp25Zg+nlA9DLCIiUw (big blind) folded before Flop
Seat 9: dmYlc+1cjwZMJ7wV+Z0rRg folded before Flop (didn't bet)




PokerStars Game #59941849250:  Hold'em No Limit ($0.10/$0.25) - 2009/07/01 1:48:06 ET
Table 'WjNvuuSgTjm8jh0j9vcCgQ' 9-max Seat #2 is the button
Seat 1: q+Qdg0Hoir+SyL7haBrUnw ($7.70 in chips) 
Seat 2: ghNKXUBl/H+t83JF079ZBA ($24.90 in chips) 
Seat 3: pSKReiGBNW9NsF2jAZnlwg ($21.35 in chips) 
Seat 4: X78b5v/uhqeXXoAijbw/yg ($31.35 in chips) 
Seat 5: ziFpkH3wCzqB/qXeq/Hy7g ($26.95 in chips) 
Seat 6: ubsjZomMWSV0hAiBLa7K1A ($20.60 in chips) 
Seat 7: NSX8YOj+RznxoL+rO1YU4w ($17.65 in chips) 
Seat 8: hZuGwtYmFKPmQ+v1wlmdfA ($17.40 in chips) 
Seat 9: CT7Xj/V/O5rBlhtt+RZeFQ ($25.25 in chips) 
pSKReiGBNW9NsF2jAZnlwg: posts small blind $0.10
X78b5v/uhqeXXoAijbw/yg: posts big blind $0.25
*** HOLE CARDS ***
ziFpkH3wCzqB/qXeq/Hy7g: folds 
ubsjZomMWSV0hAiBLa7K1A: folds 
NSX8YOj+RznxoL+rO1YU4w: calls $0.25
hZuGwtYmFKPmQ+v1wlmdfA: folds 
hZuGwtYmFKPmQ+v1wlmdfA leaves the table
CT7Xj/V/O5rBlhtt+RZeFQ: folds 
q+Qdg0Hoir+SyL7haBrUnw: folds 
ghNKXUBl/H+t83JF079ZBA: folds 
pSKReiGBNW9NsF2jAZnlwg: raises $0.50 to $0.75
X78b5v/uhqeXXoAijbw/yg: folds 
NSX8YOj+RznxoL+rO1YU4w: calls $0.50
*** FLOP *** [4h 9s 5d]
clJsV3v77RS07bDKY+705w joins the table at seat #8 
pSKReiGBNW9NsF2jAZnlwg: bets $1.50
NSX8YOj+RznxoL+rO1YU4w: folds 
Uncalled bet ($1.50) returned to pSKReiGBNW9NsF2jAZnlwg
pSKReiGBNW9NsF2jAZnlwg collected $1.70 from pot
*** SUMMARY ***
Total pot $1.75 | Rake $0.05 
Board [4h 9s 5d]
Seat 1: q+Qdg0Hoir+SyL7haBrUnw folded before Flop (didn't bet)
Seat 2: ghNKXUBl/H+t83JF079ZBA (button) folded before Flop (didn't bet)
Seat 3: pSKReiGBNW9NsF2jAZnlwg (small blind) collected ($1.70)
Seat 4: X78b5v/uhqeXXoAijbw/yg (big blind) folded before Flop
Seat 5: ziFpkH3wCzqB/qXeq/Hy7g folded before Flop (didn't bet)
Seat 6: ubsjZomMWSV0hAiBLa7K1A folded before Flop (didn't bet)
Seat 7: NSX8YOj+RznxoL+rO1YU4w folded on the Flop
Seat 8: hZuGwtYmFKPmQ+v1wlmdfA folded before Flop (didn't bet)
Seat 9: CT7Xj/V/O5rBlhtt+RZeFQ folded before Flop (didn't bet)




PokerStars Game #59941849210:  Hold'em No Limit ($0.10/$0.25) - 2009/07/01 1:48:06 ET
Table 'YlRA05h9BJ1EhOUSNUjJdg' 9-max Seat #3 is the button
Seat 1: dtZ84flFEi4Q+SGrHMJRDQ ($25.25 in chips) 
Seat 2: Y2GFAe+PT7xnUUtgqCNDFw ($8.95 in chips) 
Seat 3: Z5ZtGOON8kmSdSCll9Z3XA ($12.85 in chips) 
Seat 4: HPEB+AtKw1+C/cxU0o1ciw ($34.05 in chips) 
Seat 5: sx0lGrkT9fd4yFR+3cXUQg ($11.65 in chips) 
Seat 6: QEbIGci+itdw+re8RM5fZA ($44 in chips) 
Seat 7: dfNim92Z6XK1/h5SFW5vDg ($25 in chips) 
Seat 8: dmYlc+1cjwZMJ7wV+Z0rRg ($32.90 in chips) 
Seat 9: Z9AeOQX3yzuSvKAm/xyovg ($10.10 in chips) 
HPEB+AtKw1+C/cxU0o1ciw: posts small blind $0.10
sx0lGrkT9fd4yFR+3cXUQg: posts big blind $0.25
*** HOLE CARDS ***
QEbIGci+itdw+re8RM5fZA: folds 
dfNim92Z6XK1/h5SFW5vDg: folds 
dmYlc+1cjwZMJ7wV+Z0rRg: folds 
Z9AeOQX3yzuSvKAm/xyovg: calls $0.25
dtZ84flFEi4Q+SGrHMJRDQ: raises $0.75 to $1
Y2GFAe+PT7xnUUtgqCNDFw: folds 
Z5ZtGOON8kmSdSCll9Z3XA: folds 
HPEB+AtKw1+C/cxU0o1ciw: folds 
sx0lGrkT9fd4yFR+3cXUQg: folds 
Z9AeOQX3yzuSvKAm/xyovg: calls $0.75
*** FLOP *** [8s 9d Qh]
Z9AeOQX3yzuSvKAm/xyovg: bets $2.25
dtZ84flFEi4Q+SGrHMJRDQ: folds 
Uncalled bet ($2.25) returned to Z9AeOQX3yzuSvKAm/xyovg
Z9AeOQX3yzuSvKAm/xyovg collected $2.25 from pot
*** SUMMARY ***
Total pot $2.35 | Rake $0.10 
Board [8s 9d Qh]
Seat 1: dtZ84flFEi4Q+SGrHMJRDQ folded on the Flop
Seat 2: Y2GFAe+PT7xnUUtgqCNDFw folded before Flop (didn't bet)
Seat 3: Z5ZtGOON8kmSdSCll9Z3XA (button) folded before Flop (didn't bet)
Seat 4: HPEB+AtKw1+C/cxU0o1ciw (small blind) folded before Flop
Seat 5: sx0lGrkT9fd4yFR+3cXUQg (big blind) folded before Flop
Seat 6: QEbIGci+itdw+re8RM5fZA folded before Flop (didn't bet)
Seat 7: dfNim92Z6XK1/h5SFW5vDg folded before Flop (didn't bet)
Seat 8: dmYlc+1cjwZMJ7wV+Z0rRg folded before Flop (didn't bet)
Seat 9: Z9AeOQX3yzuSvKAm/xyovg collected ($2.25)




PokerStars Game #59941849220:  Hold'em No Limit ($0.10/$0.25) - 2009/07/01 1:48:06 ET
Table 'nc6OeGk/wtaWV+6N+kgnZQ' 6-max Seat #3 is the button
Seat 2: 8ClCHtFXGNplITm+63KB+Q ($37.95 in chips) 
Seat 3: y8wpMWGSX2zHZijurx21mg ($4 in chips) 
Seat 4: 3zD3qLXT1bEffAoWGnc7wg ($31.65 in chips) 
Seat 5: HCS0lMAAPmZE2Tl8J/SuKw ($9.85 in chips) 
Seat 6: mFv3iBCtrw9XfCDRB0d46Q ($4.15 in chips) 
3zD3qLXT1bEffAoWGnc7wg: posts small blind $0.10
HCS0lMAAPmZE2Tl8J/SuKw: posts big blind $0.25
*** HOLE CARDS ***
mFv3iBCtrw9XfCDRB0d46Q: folds 
8ClCHtFXGNplITm+63KB+Q: folds 
y8wpMWGSX2zHZijurx21mg: folds 
3zD3qLXT1bEffAoWGnc7wg: folds 
Uncalled bet ($0.15) returned to HCS0lMAAPmZE2Tl8J/SuKw
HCS0lMAAPmZE2Tl8J/SuKw collected $0.20 from pot
*** SUMMARY ***
Total pot $0.20 | Rake $0 
Seat 2: 8ClCHtFXGNplITm+63KB+Q folded before Flop (didn't bet)
Seat 3: y8wpMWGSX2zHZijurx21mg (button) folded before Flop (didn't bet)
Seat 4: 3zD3qLXT1bEffAoWGnc7wg (small blind) folded before Flop
Seat 5: HCS0lMAAPmZE2Tl8J/SuKw (big blind) collected ($0.20)
Seat 6: mFv3iBCtrw9XfCDRB0d46Q folded before Flop (didn't bet)




PokerStars Game #59941848846:  Hold'em No Limit ($0.10/$0.25) - 2009/07/01 1:48:06 ET
Table 'S6s+TmTlAjLHclBRvN5/fw' 9-max Seat #5 is the button
Seat 2: lQXp8ud1KwKUS+00XK0YEQ ($4.75 in chips) 
Seat 3: z2SmIaQ3+5n/eY1BN5HgPg ($5.35 in chips) 
Seat 4: RSal7+azPhXeqQO5L8XPfg ($16.95 in chips) 
Seat 5: 8hSJOE8UscCqt6t47gp0/g ($6.40 in chips) 
QkBggokTsSaL9vRv6V8nzQ will be allowed to play after the button
lQXp8ud1KwKUS+00XK0YEQ: posts small blind $0.10
z2SmIaQ3+5n/eY1BN5HgPg: posts big blind $0.25
*** HOLE CARDS ***
z2SmIaQ3+5n/eY1BN5HgPg said, "\nxt round"
RSal7+azPhXeqQO5L8XPfg: calls $0.25
8hSJOE8UscCqt6t47gp0/g: calls $0.25
lQXp8ud1KwKUS+00XK0YEQ: calls $0.15
z2SmIaQ3+5n/eY1BN5HgPg: checks 
*** FLOP *** [9s 4h 3h]
lQXp8ud1KwKUS+00XK0YEQ: checks 
z2SmIaQ3+5n/eY1BN5HgPg: checks 
RSal7+azPhXeqQO5L8XPfg: bets $0.50
8hSJOE8UscCqt6t47gp0/g: calls $0.50
lQXp8ud1KwKUS+00XK0YEQ: folds 
z2SmIaQ3+5n/eY1BN5HgPg: folds 
*** TURN *** [9s 4h 3h] [9c]
RSal7+azPhXeqQO5L8XPfg: bets $0.75
8hSJOE8UscCqt6t47gp0/g: calls $0.75
*** RIVER *** [9s 4h 3h 9c] [8d]
RSal7+azPhXeqQO5L8XPfg: bets $1.25
8hSJOE8UscCqt6t47gp0/g: calls $1.25
*** SHOW DOWN ***
RSal7+azPhXeqQO5L8XPfg: shows [4c Qc] (two pair, Nines and Fours)
8hSJOE8UscCqt6t47gp0/g: shows [Ks 4d] (two pair, Nines and Fours - King kicker)
8hSJOE8UscCqt6t47gp0/g collected $5.75 from pot
z2SmIaQ3+5n/eY1BN5HgPg said, "n1"
*** SUMMARY ***
Total pot $6 | Rake $0.25 
Board [9s 4h 3h 9c 8d]
Seat 2: lQXp8ud1KwKUS+00XK0YEQ (small blind) folded on the Flop
Seat 3: z2SmIaQ3+5n/eY1BN5HgPg (big blind) folded on the Flop
Seat 4: RSal7+azPhXeqQO5L8XPfg showed [4c Qc] and lost with two pair, Nines and Fours
Seat 5: 8hSJOE8UscCqt6t47gp0/g (button) showed [Ks 4d] and won ($5.75) with two pair, Nines and Fours




PokerStars Game #59941849424:  Hold'em No Limit ($0.10/$0.25) - 2009/07/01 1:48:07 ET
Table 'mdub7rJf3Z5tCT9s/+1+Wg' 9-max Seat #4 is the button
Seat 1: cZ99hugmLBj9KhTlc8nCSw ($28.90 in chips) 
Seat 2: 539MC3AwKLWVFwzABc644Q ($10.90 in chips) 
Seat 3: PdIasPkzm2sqZnN41ZRXOg ($5.60 in chips) 
Seat 4: fDGyaQz0cs2s4FOYxkbIHA ($14.50 in chips) 
Seat 5: dfNim92Z6XK1/h5SFW5vDg ($26 in chips) 
Seat 6: T/CCwAWe2yhO0c4oHNwicw ($23.25 in chips) 
Seat 7: woe+9KKk+L3pZgMTuHcmog ($15.55 in chips) 
Seat 9: tYsOBqdU1+x+yFI7zHO7hQ ($36.05 in chips) 
dfNim92Z6XK1/h5SFW5vDg: posts small blind $0.10
T/CCwAWe2yhO0c4oHNwicw: posts big blind $0.25
bXpVeaSTPBFSPJmeXxO7nw: sits out 
*** HOLE CARDS ***
woe+9KKk+L3pZgMTuHcmog: folds 
tYsOBqdU1+x+yFI7zHO7hQ: folds 
cZ99hugmLBj9KhTlc8nCSw: folds 
539MC3AwKLWVFwzABc644Q: folds 
PdIasPkzm2sqZnN41ZRXOg: folds 
fDGyaQz0cs2s4FOYxkbIHA: folds 
dfNim92Z6XK1/h5SFW5vDg: folds 
Uncalled bet ($0.15) returned to T/CCwAWe2yhO0c4oHNwicw
T/CCwAWe2yhO0c4oHNwicw collected $0.20 from pot
T/CCwAWe2yhO0c4oHNwicw: doesn't show hand 
*** SUMMARY ***
Total pot $0.20 | Rake $0 
Seat 1: cZ99hugmLBj9KhTlc8nCSw folded before Flop (didn't bet)
Seat 2: 539MC3AwKLWVFwzABc644Q folded before Flop (didn't bet)
Seat 3: PdIasPkzm2sqZnN41ZRXOg folded before Flop (didn't bet)
Seat 4: fDGyaQz0cs2s4FOYxkbIHA (button) folded before Flop (didn't bet)
Seat 5: dfNim92Z6XK1/h5SFW5vDg (small blind) folded before Flop
Seat 6: T/CCwAWe2yhO0c4oHNwicw (big blind) collected ($0.20)
Seat 7: woe+9KKk+L3pZgMTuHcmog folded before Flop (didn't bet)
Seat 9: tYsOBqdU1+x+yFI7zHO7hQ folded before Flop (didn't bet)




PokerStars Game #59941849612:  Hold'em No Limit ($0.10/$0.25) - 2009/07/01 1:48:07 ET
Table 'G26g8jde1eR+mmabeFeSlw' 9-max Seat #1 is the button
Seat 1: wnerYvSRWT9Sm4X3ip/c8w ($24.65 in chips) 
Seat 2: BFYwQ0J4xWUQvouudojivA ($17.55 in chips) 
Seat 3: WKL8nUFr7TumC4EjLyqYzw ($6.50 in chips) 
Seat 4: 8EbrQ/EvFWt2cr0GaU82gQ ($5.75 in chips) 
Seat 5: hJ4uYjNmSZdjrKA8cjZqCA ($30.45 in chips) 
Seat 6: AHGkesF/mi4sDMpqrxBUoA ($8.55 in chips) 
Seat 7: nm4Dj/f+jJEwKVsUnKh73g ($37.50 in chips) 
Seat 8: CvL9Ch1HYCVbTsfpNucitg ($5.50 in chips) 
Seat 9: VWUWpMLMj/Q1jRVpF7Aohw ($13.30 in chips) 
BFYwQ0J4xWUQvouudojivA: posts small blind $0.10
WKL8nUFr7TumC4EjLyqYzw: posts big blind $0.25
*** HOLE CARDS ***
8EbrQ/EvFWt2cr0GaU82gQ: folds 
hJ4uYjNmSZdjrKA8cjZqCA: calls $0.25
AHGkesF/mi4sDMpqrxBUoA: folds 
nm4Dj/f+jJEwKVsUnKh73g: raises $0.25 to $0.50
CvL9Ch1HYCVbTsfpNucitg: raises $1.50 to $2
VWUWpMLMj/Q1jRVpF7Aohw: folds 
wnerYvSRWT9Sm4X3ip/c8w: folds 
BFYwQ0J4xWUQvouudojivA: folds 
WKL8nUFr7TumC4EjLyqYzw: folds 
hJ4uYjNmSZdjrKA8cjZqCA: calls $1.75
nm4Dj/f+jJEwKVsUnKh73g: calls $1.50
*** FLOP *** [6c 9c Jd]
hJ4uYjNmSZdjrKA8cjZqCA: checks 
nm4Dj/f+jJEwKVsUnKh73g: checks 
CvL9Ch1HYCVbTsfpNucitg: checks 
*** TURN *** [6c 9c Jd] [4s]
hJ4uYjNmSZdjrKA8cjZqCA: checks 
nm4Dj/f+jJEwKVsUnKh73g: checks 
CvL9Ch1HYCVbTsfpNucitg: checks 
*** RIVER *** [6c 9c Jd 4s] [6s]
hJ4uYjNmSZdjrKA8cjZqCA: checks 
nm4Dj/f+jJEwKVsUnKh73g: checks 
CvL9Ch1HYCVbTsfpNucitg: checks 
*** SHOW DOWN ***
hJ4uYjNmSZdjrKA8cjZqCA: shows [5c 5h] (two pair, Sixes and Fives)
nm4Dj/f+jJEwKVsUnKh73g: mucks hand 
CvL9Ch1HYCVbTsfpNucitg: mucks hand 
hJ4uYjNmSZdjrKA8cjZqCA collected $6.05 from pot
*** SUMMARY ***
Total pot $6.35 | Rake $0.30 
Board [6c 9c Jd 4s 6s]
Seat 1: wnerYvSRWT9Sm4X3ip/c8w (button) folded before Flop (didn't bet)
Seat 2: BFYwQ0J4xWUQvouudojivA (small blind) folded before Flop
Seat 3: WKL8nUFr7TumC4EjLyqYzw (big blind) folded before Flop
Seat 4: 8EbrQ/EvFWt2cr0GaU82gQ folded before Flop (didn't bet)
Seat 5: hJ4uYjNmSZdjrKA8cjZqCA showed [5c 5h] and won ($6.05) with two pair, Sixes and Fives
Seat 6: AHGkesF/mi4sDMpqrxBUoA folded before Flop (didn't bet)
Seat 7: nm4Dj/f+jJEwKVsUnKh73g mucked
Seat 8: CvL9Ch1HYCVbTsfpNucitg mucked
Seat 9: VWUWpMLMj/Q1jRVpF7Aohw folded before Flop (didn't bet)




PokerStars Game #59941849456:  Hold'em No Limit ($0.10/$0.25) - 2009/07/01 1:48:07 ET
Table 'ROYvQOMwUrvL3SOiHYcrWg' 9-max Seat #3 is the button
Seat 1: 22dIObOuor/A+IKWkNoAlA ($5.40 in chips) 
Seat 2: gehe91e0IyVT0QU/XBkEyg ($25.15 in chips) 
Seat 3: 8EbrQ/EvFWt2cr0GaU82gQ ($4.30 in chips) 
Seat 4: SHegmCn8B0InbWE/zFlvOw ($21.80 in chips) 
Seat 5: 7je+LC5Mfs6nL8YBVh4frQ ($5 in chips) 
Seat 6: P+9ymZQ3ktpQu1bn7HIjew ($20.50 in chips) 
Seat 7: tYsOBqdU1+x+yFI7zHO7hQ ($25 in chips) 
Seat 8: biJWLZ27fafNeBI2oT1KJw ($28.15 in chips) 
Seat 9: uhrboV251dcgYniYTdFIcA ($25.35 in chips) 
SHegmCn8B0InbWE/zFlvOw: posts small blind $0.10
7je+LC5Mfs6nL8YBVh4frQ: posts big blind $0.25
*** HOLE CARDS ***
P+9ymZQ3ktpQu1bn7HIjew: folds 
tYsOBqdU1+x+yFI7zHO7hQ: folds 
biJWLZ27fafNeBI2oT1KJw: folds 
uhrboV251dcgYniYTdFIcA: folds 
22dIObOuor/A+IKWkNoAlA: folds 
gehe91e0IyVT0QU/XBkEyg: folds 
8EbrQ/EvFWt2cr0GaU82gQ: raises $0.50 to $0.75
SHegmCn8B0InbWE/zFlvOw: raises $0.50 to $1.25
7je+LC5Mfs6nL8YBVh4frQ: folds 
8EbrQ/EvFWt2cr0GaU82gQ: raises $3.05 to $4.30 and is all-in
SHegmCn8B0InbWE/zFlvOw: calls $3.05
*** FLOP *** [3s Qc Qd]
*** TURN *** [3s Qc Qd] [2s]
*** RIVER *** [3s Qc Qd 2s] [5c]
*** SHOW DOWN ***
SHegmCn8B0InbWE/zFlvOw: shows [Ks Kh] (two pair, Kings and Queens)
8EbrQ/EvFWt2cr0GaU82gQ: mucks hand 
SHegmCn8B0InbWE/zFlvOw collected $8.45 from pot
*** SUMMARY ***
Total pot $8.85 | Rake $0.40 
Board [3s Qc Qd 2s 5c]
Seat 1: 22dIObOuor/A+IKWkNoAlA folded before Flop (didn't bet)
Seat 2: gehe91e0IyVT0QU/XBkEyg folded before Flop (didn't bet)
Seat 3: 8EbrQ/EvFWt2cr0GaU82gQ (button) mucked
Seat 4: SHegmCn8B0InbWE/zFlvOw (small blind) showed [Ks Kh] and won ($8.45) with two pair, Kings and Queens
Seat 5: 7je+LC5Mfs6nL8YBVh4frQ (big blind) folded before Flop
Seat 6: P+9ymZQ3ktpQu1bn7HIjew folded before Flop (didn't bet)
Seat 7: tYsOBqdU1+x+yFI7zHO7hQ folded before Flop (didn't bet)
Seat 8: biJWLZ27fafNeBI2oT1KJw folded before Flop (didn't bet)
Seat 9: uhrboV251dcgYniYTdFIcA folded before Flop (didn't bet)




PokerStars Game #59941849698:  Hold'em No Limit ($0.10/$0.25) - 2009/07/01 1:48:07 ET
Table 'djcjiEGabFQO0MNG6jEeJQ' 9-max Seat #8 is the button
Seat 1: Bb42QRQMhg5/Y0vHP8/2Xw ($25.60 in chips) 
Seat 2: WKL8nUFr7TumC4EjLyqYzw ($5.25 in chips) 
Seat 3: zgi+EUykT/pZQpoUG6+oEg ($4.65 in chips) 
Seat 4: 2wcFsZsqEP5w1StUTVzJCg ($9.55 in chips) 
Seat 6: aNpwfA31EREwO+ar4XzBCw ($78.50 in chips) 
Seat 8: +sbyWwIcFp9kP0bDtMegfQ ($46.25 in chips) 
Seat 9: HPEB+AtKw1+C/cxU0o1ciw ($46.60 in chips) 
HPEB+AtKw1+C/cxU0o1ciw: posts small blind $0.10
Bb42QRQMhg5/Y0vHP8/2Xw: posts big blind $0.25
*** HOLE CARDS ***
WKL8nUFr7TumC4EjLyqYzw: folds 
zgi+EUykT/pZQpoUG6+oEg: folds 
2wcFsZsqEP5w1StUTVzJCg: folds 
9QQ67diwg/DShNDBou2R8Q joins the table at seat #5 
aNpwfA31EREwO+ar4XzBCw: folds 
+sbyWwIcFp9kP0bDtMegfQ: folds 
HPEB+AtKw1+C/cxU0o1ciw: folds 
Uncalled bet ($0.15) returned to Bb42QRQMhg5/Y0vHP8/2Xw
Bb42QRQMhg5/Y0vHP8/2Xw collected $0.20 from pot
*** SUMMARY ***
Total pot $0.20 | Rake $0 
Seat 1: Bb42QRQMhg5/Y0vHP8/2Xw (big blind) collected ($0.20)
Seat 2: WKL8nUFr7TumC4EjLyqYzw folded before Flop (didn't bet)
Seat 3: zgi+EUykT/pZQpoUG6+oEg folded before Flop (didn't bet)
Seat 4: 2wcFsZsqEP5w1StUTVzJCg folded before Flop (didn't bet)
Seat 6: aNpwfA31EREwO+ar4XzBCw folded before Flop (didn't bet)
Seat 8: +sbyWwIcFp9kP0bDtMegfQ (button) folded before Flop (didn't bet)
Seat 9: HPEB+AtKw1+C/cxU0o1ciw (small blind) folded before Flop




PokerStars Game #59941849628:  Hold'em No Limit ($0.10/$0.25) - 2009/07/01 1:48:07 ET
Table 'tErGGDyESv/0llKumVeZuQ' 9-max Seat #7 is the button
Seat 1: 3PmVnC/15cl4oyI1TKIt4g ($5 in chips) 
Seat 2: pN3IHvAKm2fz+sTRARTcrg ($28.85 in chips) 
Seat 4: yqkowiRWZ6NvRN9UUkYIlA ($5 in chips) 
Seat 5: 6RQUxA3jk+ePxB/+Hc0IKw ($16.05 in chips) 
Seat 7: uhrboV251dcgYniYTdFIcA ($28.80 in chips) 
Seat 8: clJsV3v77RS07bDKY+705w ($5 in chips) 
Seat 9: d6n762oPkegG086ZJyV5MA ($17.70 in chips) 
clJsV3v77RS07bDKY+705w: posts small blind $0.10
d6n762oPkegG086ZJyV5MA: posts big blind $0.25
qwr38jl5txoR36M7G5qi4A: sits out 
*** HOLE CARDS ***
3PmVnC/15cl4oyI1TKIt4g: folds 
pN3IHvAKm2fz+sTRARTcrg: folds 
yqkowiRWZ6NvRN9UUkYIlA: folds 
6RQUxA3jk+ePxB/+Hc0IKw: folds 
uhrboV251dcgYniYTdFIcA: calls $0.25
clJsV3v77RS07bDKY+705w: raises $1 to $1.25
d6n762oPkegG086ZJyV5MA: calls $1
uhrboV251dcgYniYTdFIcA: calls $1
*** FLOP *** [9d Kc 9h]
clJsV3v77RS07bDKY+705w: bets $2
d6n762oPkegG086ZJyV5MA: calls $2
uhrboV251dcgYniYTdFIcA: folds 
*** TURN *** [9d Kc 9h] [Qc]
clJsV3v77RS07bDKY+705w: bets $1.75 and is all-in
d6n762oPkegG086ZJyV5MA: calls $1.75
*** RIVER *** [9d Kc 9h Qc] [8h]
*** SHOW DOWN ***
clJsV3v77RS07bDKY+705w: shows [Ac As] (two pair, Aces and Nines)
d6n762oPkegG086ZJyV5MA: shows [9s Qh] (a full house, Nines full of Queens)
d6n762oPkegG086ZJyV5MA collected $10.75 from pot
*** SUMMARY ***
Total pot $11.25 | Rake $0.50 
Board [9d Kc 9h Qc 8h]
Seat 1: 3PmVnC/15cl4oyI1TKIt4g folded before Flop (didn't bet)
Seat 2: pN3IHvAKm2fz+sTRARTcrg folded before Flop (didn't bet)
Seat 4: yqkowiRWZ6NvRN9UUkYIlA folded before Flop (didn't bet)
Seat 5: 6RQUxA3jk+ePxB/+Hc0IKw folded before Flop (didn't bet)
Seat 7: uhrboV251dcgYniYTdFIcA (button) folded on the Flop
Seat 8: clJsV3v77RS07bDKY+705w (small blind) showed [Ac As] and lost with two pair, Aces and Nines
Seat 9: d6n762oPkegG086ZJyV5MA (big blind) showed [9s Qh] and won ($10.75) with a full house, Nines full of Queens




PokerStars Game #59941849312:  Hold'em No Limit ($0.10/$0.25) - 2009/07/01 1:48:07 ET
Table 'wGizWOswEL6P5QrvVkno/g' 6-max Seat #2 is the button
Seat 1: Qbfkn+ucISvbd1Xh32zAGA ($32 in chips) 
Seat 2: mfrkWA3PTeYPkbO6hi98Aw ($28.75 in chips) 
Seat 6: BuAE7g7dRfuqGPmQDlGyGg ($17.35 in chips) 
i9LqF5rD3bvtbEE7HWgr3Q will be allowed to play after the button
yF9xHMEAvA+7Gn+eDkuVIg will be allowed to play after the button
w43JQj2oYPpKQVG4Yzlq1w will be allowed to play after the button
BuAE7g7dRfuqGPmQDlGyGg: posts small blind $0.10
Qbfkn+ucISvbd1Xh32zAGA: posts big blind $0.25
*** HOLE CARDS ***
mfrkWA3PTeYPkbO6hi98Aw: folds 
BuAE7g7dRfuqGPmQDlGyGg: calls $0.15
Qbfkn+ucISvbd1Xh32zAGA: checks 
*** FLOP *** [9d 2h 2s]
BuAE7g7dRfuqGPmQDlGyGg: checks 
Qbfkn+ucISvbd1Xh32zAGA: checks 
*** TURN *** [9d 2h 2s] [4c]
BuAE7g7dRfuqGPmQDlGyGg: bets $0.25
Qbfkn+ucISvbd1Xh32zAGA: calls $0.25
*** RIVER *** [9d 2h 2s 4c] [Qc]
BuAE7g7dRfuqGPmQDlGyGg: bets $1.25
Qbfkn+ucISvbd1Xh32zAGA: calls $1.25
*** SHOW DOWN ***
BuAE7g7dRfuqGPmQDlGyGg: shows [Th 3c] (a pair of Deuces)
Qbfkn+ucISvbd1Xh32zAGA: shows [4d 5h] (two pair, Fours and Deuces)
Qbfkn+ucISvbd1Xh32zAGA collected $3.35 from pot
*** SUMMARY ***
Total pot $3.50 | Rake $0.15 
Board [9d 2h 2s 4c Qc]
Seat 1: Qbfkn+ucISvbd1Xh32zAGA (big blind) showed [4d 5h] and won ($3.35) with two pair, Fours and Deuces
Seat 2: mfrkWA3PTeYPkbO6hi98Aw (button) folded before Flop (didn't bet)
Seat 6: BuAE7g7dRfuqGPmQDlGyGg (small blind) showed [Th 3c] and lost with a pair of Deuces




PokerStars Game #59941849448:  Hold'em No Limit ($0.10/$0.25) - 2009/07/01 1:48:07 ET
Table '0XPo7K54oZIfG0xlNAcDRwnQC9LRg01NEuKFHF1nrDEw-max Seat #2 is the button
Seat 1: qf+LMbROj8/qY878wkFHbQ ($14.30 in chips) 
Seat 2: ZhV6dUX9NQhT4zf7t+ZLJg ($21.80 in chips) 
Seat 3: 6+g0Lb6vfRDZkElV8ieHyQ ($26.20 in chips) 
Seat 4: u3Ol7kv1LmvszuHNm9rc6w ($25 in chips) 
Seat 5: kG34n23qFQA3nzdOJTQ1dA ($28.45 in chips) 
Seat 6: xQVFeVUDopz+akuEo2wXpQ ($55.30 in chips) 
6+g0Lb6vfRDZkElV8ieHyQ: posts small blind $0.10
u3Ol7kv1LmvszuHNm9rc6w: posts big blind $0.25
*** HOLE CARDS ***
kG34n23qFQA3nzdOJTQ1dA: folds 
xQVFeVUDopz+akuEo2wXpQ: folds 
qf+LMbROj8/qY878wkFHbQ: raises $0.50 to $0.75
ZhV6dUX9NQhT4zf7t+ZLJg: calls $0.75
6+g0Lb6vfRDZkElV8ieHyQ: folds 
u3Ol7kv1LmvszuHNm9rc6w: folds 
*** FLOP *** [2c Js 8d]
qf+LMbROj8/qY878wkFHbQ: bets $1.25
ZhV6dUX9NQhT4zf7t+ZLJg: raises $2.75 to $4
qf+LMbROj8/qY878wkFHbQ: folds 
Uncalled bet ($2.75) returned to ZhV6dUX9NQhT4zf7t+ZLJg
ZhV6dUX9NQhT4zf7t+ZLJg collected $4.15 from pot
*** SUMMARY ***
Total pot $4.35 | Rake $0.20 
Board [2c Js 8d]
Seat 1: qf+LMbROj8/qY878wkFHbQ folded on the Flop
Seat 2: ZhV6dUX9NQhT4zf7t+ZLJg (button) collected ($4.15)
Seat 3: 6+g0Lb6vfRDZkElV8ieHyQ (small blind) folded before Flop
Seat 4: u3Ol7kv1LmvszuHNm9rc6w (big blind) folded before Flop
Seat 5: kG34n23qFQA3nzdOJTQ1dA folded before Flop (didn't bet)
Seat 6: xQVFeVUDopz+akuEo2wXpQ folded before Flop (didn't bet)




PokerStars Game #59941849408:  Hold'em No Limit ($0.10/$0.25) - 2009/07/01 1:48:07 ET
Table 'IUwZ/e0bDHZPgsIWx0RnNg' 6-max Seat #1 is the button
Seat 1: V66QiVCQPofyl3a+dpPHQQ ($5.95 in chips) 
Seat 2: mvFHK3pE7tCxJEqLjKC70Q ($55.70 in chips) 
Seat 3: dOX4wnYV2sEqvDbF+8KSCw ($26.25 in chips) 
Seat 4: OIjOiBfQstWrK/RuXx7zcw ($4.45 in chips) 
Seat 5: 9bpVv1/Qh9IYtXuCtl5VtQ ($24.65 in chips) 
Seat 6: NhUN/JpAprdJeamFBgJH1w ($38.90 in chips) 
mvFHK3pE7tCxJEqLjKC70Q: posts small blind $0.10
dOX4wnYV2sEqvDbF+8KSCw: posts big blind $0.25
*** HOLE CARDS ***
OIjOiBfQstWrK/RuXx7zcw: raises $1 to $1.25
9bpVv1/Qh9IYtXuCtl5VtQ: folds 
NhUN/JpAprdJeamFBgJH1w: folds 
V66QiVCQPofyl3a+dpPHQQ: folds 
mvFHK3pE7tCxJEqLjKC70Q: folds 
dOX4wnYV2sEqvDbF+8KSCw: folds 
Uncalled bet ($1) returned to OIjOiBfQstWrK/RuXx7zcw
OIjOiBfQstWrK/RuXx7zcw collected $0.60 from pot
OIjOiBfQstWrK/RuXx7zcw: doesn't show hand 
*** SUMMARY ***
Total pot $0.60 | Rake $0 
Seat 1: V66QiVCQPofyl3a+dpPHQQ (button) folded before Flop (didn't bet)
Seat 2: mvFHK3pE7tCxJEqLjKC70Q (small blind) folded before Flop
Seat 3: dOX4wnYV2sEqvDbF+8KSCw (big blind) folded before Flop
Seat 4: OIjOiBfQstWrK/RuXx7zcw collected ($0.60)
Seat 5: 9bpVv1/Qh9IYtXuCtl5VtQ folded before Flop (didn't bet)
Seat 6: NhUN/JpAprdJeamFBgJH1w folded before Flop (didn't bet)




PokerStars Game #59941849446:  Hold'em No Limit ($0.10/$0.25) - 2009/07/01 1:48:07 ET
Table '4UJB/UOZ5aepyF2v+hIoUg' 6-max Seat #3 is the button
Seat 1: 08V++DOqzaNrRNsHIwi25w ($27 in chips) 
Seat 2: mFv3iBCtrw9XfCDRB0d46Q ($3.70 in chips) 
Seat 3: zlYHXTtJ5tcx9kwK2h5n9A ($44.05 in chips) 
Seat 4: R6AGToFJQOYVZAjC2jXEKw ($22.20 in chips) 
Seat 5: 3zD3qLXT1bEffAoWGnc7wg ($26.15 in chips) 
Seat 6: 2aphcinkTZT0B0Uoah6cvQ ($12.85 in chips) 
R6AGToFJQOYVZAjC2jXEKw: posts small blind $0.10
3zD3qLXT1bEffAoWGnc7wg: posts big blind $0.25
*** HOLE CARDS ***
2aphcinkTZT0B0Uoah6cvQ: folds 
08V++DOqzaNrRNsHIwi25w: folds 
mFv3iBCtrw9XfCDRB0d46Q: folds 
zlYHXTtJ5tcx9kwK2h5n9A: folds 
R6AGToFJQOYVZAjC2jXEKw: raises $0.50 to $0.75
3zD3qLXT1bEffAoWGnc7wg: folds 
Uncalled bet ($0.50) returned to R6AGToFJQOYVZAjC2jXEKw
R6AGToFJQOYVZAjC2jXEKw collected $0.50 from pot
R6AGToFJQOYVZAjC2jXEKw: doesn't show hand 
*** SUMMARY ***
Total pot $0.50 | Rake $0 
Seat 1: 08V++DOqzaNrRNsHIwi25w folded before Flop (didn't bet)
Seat 2: mFv3iBCtrw9XfCDRB0d46Q folded before Flop (didn't bet)
Seat 3: zlYHXTtJ5tcx9kwK2h5n9A (button) folded before Flop (didn't bet)
Seat 4: R6AGToFJQOYVZAjC2jXEKw (small blind) collected ($0.50)
Seat 5: 3zD3qLXT1bEffAoWGnc7wg (big blind) folded before Flop
Seat 6: 2aphcinkTZT0B0Uoah6cvQ folded before Flop (didn't bet)




PokerStars Game #59941850166:  Hold'em No Limit ($0.10/$0.25) - 2009/07/01 1:48:08 ET
Table 'rhQuIjJo0UQ7RRUlF9umHg' 6-max Seat #2 is the button
Seat 1: 5O3Hj9Qg0SqOyKEXoLpjPg ($140.40 in chips) 
Seat 2: Ew/TYPQIsbQ2X8nm5iAJBg ($25 in chips) 
Seat 3: if4dh6jhJXeN3/qd3qCp9g ($27.15 in chips) 
Seat 4: buyjetgNT1McXtdaP4zynA ($37.15 in chips) 
Seat 5: dOX4wnYV2sEqvDbF+8KSCw ($68.65 in chips) 
Seat 6: /gJNBeCkWL4o85/jvlZ4BA ($52.05 in chips) 
if4dh6jhJXeN3/qd3qCp9g: posts small blind $0.10
buyjetgNT1McXtdaP4zynA: posts big blind $0.25
*** HOLE CARDS ***
dOX4wnYV2sEqvDbF+8KSCw: folds 
/gJNBeCkWL4o85/jvlZ4BA: calls $0.25
5O3Hj9Qg0SqOyKEXoLpjPg: calls $0.25
Ew/TYPQIsbQ2X8nm5iAJBg: folds 
if4dh6jhJXeN3/qd3qCp9g: folds 
buyjetgNT1McXtdaP4zynA: raises $1.25 to $1.50
/gJNBeCkWL4o85/jvlZ4BA: calls $1.25
5O3Hj9Qg0SqOyKEXoLpjPg: calls $1.25
*** FLOP *** [8h Qs 9c]
buyjetgNT1McXtdaP4zynA: bets $4
/gJNBeCkWL4o85/jvlZ4BA: folds 
5O3Hj9Qg0SqOyKEXoLpjPg: calls $4
*** TURN *** [8h Qs 9c] [Ah]
buyjetgNT1McXtdaP4zynA: bets $10
5O3Hj9Qg0SqOyKEXoLpjPg: calls $10
*** RIVER *** [8h Qs 9c Ah] [7h]
buyjetgNT1McXtdaP4zynA: bets $21.65 and is all-in
5O3Hj9Qg0SqOyKEXoLpjPg: calls $21.65
*** SHOW DOWN ***
buyjetgNT1McXtdaP4zynA: shows [Jd Qd] (a pair of Queens)
5O3Hj9Qg0SqOyKEXoLpjPg: shows [Ac Th] (a pair of Aces)
5O3Hj9Qg0SqOyKEXoLpjPg collected $72.90 from pot
*** SUMMARY ***
Total pot $75.90 | Rake $3 
Board [8h Qs 9c Ah 7h]
Seat 1: 5O3Hj9Qg0SqOyKEXoLpjPg showed [Ac Th] and won ($72.90) with a pair of Aces
Seat 2: Ew/TYPQIsbQ2X8nm5iAJBg (button) folded before Flop (didn't bet)
Seat 3: if4dh6jhJXeN3/qd3qCp9g (small blind) folded before Flop
Seat 4: buyjetgNT1McXtdaP4zynA (big blind) showed [Jd Qd] and lost with a pair of Queens
Seat 5: dOX4wnYV2sEqvDbF+8KSCw folded before Flop (didn't bet)
Seat 6: /gJNBeCkWL4o85/jvlZ4BA folded on the Flop




PokerStars Game #59941850106:  Hold'em No Limit ($0.10/$0.25) - 2009/07/01 1:48:08 ET
Table '63uh7ZsO7Tnt+E8b/2bu3A' 6-max Seat #6 is the button
Seat 1: 0av6tRNdi0Ui4f15L7gsVg ($29.95 in chips) 
Seat 2: SFmT9ZsVopnukjvAzrxTRg ($30.30 in chips) 
Seat 3: yVP7GLZBzx47OPi6jzUxMw ($4.75 in chips) 
Seat 4: rnpAao581IcvQglpkpnkoQ ($11.25 in chips) 
Seat 5: GbCVUNssQ7mqsPWr7J4d3w ($9.75 in chips) 
Seat 6: qGHGf/553gQnDoklMRe3tg ($26.90 in chips) 
0av6tRNdi0Ui4f15L7gsVg: posts small blind $0.10
SFmT9ZsVopnukjvAzrxTRg: posts big blind $0.25
*** HOLE CARDS ***
yVP7GLZBzx47OPi6jzUxMw: folds 
rnpAao581IcvQglpkpnkoQ: folds 
GbCVUNssQ7mqsPWr7J4d3w: folds 
qGHGf/553gQnDoklMRe3tg: folds 
0av6tRNdi0Ui4f15L7gsVg: folds 
Uncalled bet ($0.15) returned to SFmT9ZsVopnukjvAzrxTRg
SFmT9ZsVopnukjvAzrxTRg collected $0.20 from pot
SFmT9ZsVopnukjvAzrxTRg: doesn't show hand 
*** SUMMARY ***
Total pot $0.20 | Rake $0 
Seat 1: 0av6tRNdi0Ui4f15L7gsVg (small blind) folded before Flop
Seat 2: SFmT9ZsVopnukjvAzrxTRg (big blind) collected ($0.20)
Seat 3: yVP7GLZBzx47OPi6jzUxMw folded before Flop (didn't bet)
Seat 4: rnpAao581IcvQglpkpnkoQ folded before Flop (didn't bet)
Seat 5: GbCVUNssQ7mqsPWr7J4d3w folded before Flop (didn't bet)
Seat 6: qGHGf/553gQnDoklMRe3tg (button) folded before Flop (didn't bet)




PokerStars Game #59941849912:  Hold'em No Limit ($0.10/$0.25) - 2009/07/01 1:48:08 ET
Table 'VQNfcI8vTBCTvRfd3veTLQ' 6-max Seat #1 is the button
Seat 1: QiL+lEgEWwy21jk/ltaRLg ($13.50 in chips) 
Seat 2: 79ID/ub1Pt/mDpCprVmOoA ($31.35 in chips) 
Seat 3: LtASJ9OlkqGrrUKGQlpGAw ($11.60 in chips) 
Seat 4: QIWnfLSqfMcoFfdDe5LZPg ($38.15 in chips) 
Seat 5: gX2vbKwS/8zZPENAWB7hxQ ($27.65 in chips) 
Seat 6: LJI7A1YgDM7hgh7o56+ReQ ($27.35 in chips) 
79ID/ub1Pt/mDpCprVmOoA: posts small blind $0.10
LtASJ9OlkqGrrUKGQlpGAw: posts big blind $0.25
*** HOLE CARDS ***
QIWnfLSqfMcoFfdDe5LZPg: calls $0.25
gX2vbKwS/8zZPENAWB7hxQ: raises $0.50 to $0.75
LJI7A1YgDM7hgh7o56+ReQ: folds 
QiL+lEgEWwy21jk/ltaRLg: folds 
79ID/ub1Pt/mDpCprVmOoA: folds 
LtASJ9OlkqGrrUKGQlpGAw: folds 
QIWnfLSqfMcoFfdDe5LZPg: calls $0.50
*** FLOP *** [6c Ks 9d]
QIWnfLSqfMcoFfdDe5LZPg: checks 
gX2vbKwS/8zZPENAWB7hxQ: bets $1
QIWnfLSqfMcoFfdDe5LZPg: calls $1
*** TURN *** [6c Ks 9d] [Jh]
QIWnfLSqfMcoFfdDe5LZPg: checks 
gX2vbKwS/8zZPENAWB7hxQ: checks 
*** RIVER *** [6c Ks 9d Jh] [9c]
QIWnfLSqfMcoFfdDe5LZPg: bets $13.75
gX2vbKwS/8zZPENAWB7hxQ: folds 
Uncalled bet ($13.75) returned to QIWnfLSqfMcoFfdDe5LZPg
QIWnfLSqfMcoFfdDe5LZPg collected $3.70 from pot
*** SUMMARY ***
Total pot $3.85 | Rake $0.15 
Board [6c Ks 9d Jh 9c]
Seat 1: QiL+lEgEWwy21jk/ltaRLg (button) folded before Flop (didn't bet)
Seat 2: 79ID/ub1Pt/mDpCprVmOoA (small blind) folded before Flop
Seat 3: LtASJ9OlkqGrrUKGQlpGAw (big blind) folded before Flop
Seat 4: QIWnfLSqfMcoFfdDe5LZPg collected ($3.70)
Seat 5: gX2vbKwS/8zZPENAWB7hxQ folded on the River
Seat 6: LJI7A1YgDM7hgh7o56+ReQ folded before Flop (didn't bet)




PokerStars Game #59941849922:  Hold'em No Limit ($0.10/$0.25) - 2009/07/01 1:48:08 ET
Table '1HT8bEDpLPhOXxmqMtzF8w' 9-max Seat #2 is the button
Seat 1: YkkKQUDI0iWatY4h0WWaAQ ($12.90 in chips) 
Seat 2: r6hsffOo1iKmaPYKwAZmFw ($29 in chips) 
Seat 3: oLa/tXLfSLLB28mcLGrxcg ($23.75 in chips) 
Seat 6: bXpVeaSTPBFSPJmeXxO7nw ($5.25 in chips) 
Seat 7: PMhmqYBPHOAXjH25lRz69g ($16.80 in chips) 
Seat 8: ghNKXUBl/H+t83JF079ZBA ($33.15 in chips) 
Seat 9: Z9W7+g1WMhhZDi7DwGbCFA ($5 in chips) 
oLa/tXLfSLLB28mcLGrxcg: posts small blind $0.10
aNpwfA31EREwO+ar4XzBCw: is sitting out 
bXpVeaSTPBFSPJmeXxO7nw: posts big blind $0.25
*** HOLE CARDS ***
PMhmqYBPHOAXjH25lRz69g: calls $0.25
ghNKXUBl/H+t83JF079ZBA: folds 
Z9W7+g1WMhhZDi7DwGbCFA: folds 
YkkKQUDI0iWatY4h0WWaAQ: calls $0.25
r6hsffOo1iKmaPYKwAZmFw: folds 
oLa/tXLfSLLB28mcLGrxcg: calls $0.15
bXpVeaSTPBFSPJmeXxO7nw: raises $5 to $5.25 and is all-in
PMhmqYBPHOAXjH25lRz69g: folds 
YkkKQUDI0iWatY4h0WWaAQ: folds 
oLa/tXLfSLLB28mcLGrxcg: folds 
Uncalled bet ($5) returned to bXpVeaSTPBFSPJmeXxO7nw
bXpVeaSTPBFSPJmeXxO7nw collected $1 from pot
bXpVeaSTPBFSPJmeXxO7nw: doesn't show hand 
*** SUMMARY ***
Total pot $1 | Rake $0 
Seat 1: YkkKQUDI0iWatY4h0WWaAQ folded before Flop
Seat 2: r6hsffOo1iKmaPYKwAZmFw (button) folded before Flop (didn't bet)
Seat 3: oLa/tXLfSLLB28mcLGrxcg (small blind) folded before Flop
Seat 6: bXpVeaSTPBFSPJmeXxO7nw (big blind) collected ($1)
Seat 7: PMhmqYBPHOAXjH25lRz69g folded before Flop
Seat 8: ghNKXUBl/H+t83JF079ZBA folded before Flop (didn't bet)
Seat 9: Z9W7+g1WMhhZDi7DwGbCFA folded before Flop (didn't bet)




PokerStars Game #59941850112:  Hold'em No Limit ($0.10/$0.25) - 2009/07/01 1:48:08 ET
Table 'nFlmVztKq1HJEWfxmdl15w' 9-max Seat #5 is the button
Seat 1: cZ99hugmLBj9KhTlc8nCSw ($25 in chips) 
Seat 2: Th3FldXKQW6hWVVPahaoOQ ($38.40 in chips) 
Seat 3: DdPXdieucQ+n99u1n3A+rQ ($5.70 in chips) 
Seat 4: +5dSUwD+/k2ktlnutSMivw ($12 in chips) 
Seat 5: Tx6zQdk5Ozt9ObEBlU7jeg ($34.60 in chips) 
Seat 6: 4awUyiDYTgylQKXZ9faBVA ($36.25 in chips) 
Seat 7: dfNim92Z6XK1/h5SFW5vDg ($35.30 in chips) 
Seat 8: +2kMBNpY4nF1qNCRd8SJLA ($33.65 in chips) 
Seat 9: DnDcAdn9P0zGovMERigpFA ($25 in chips) 
4awUyiDYTgylQKXZ9faBVA: posts small blind $0.10
dfNim92Z6XK1/h5SFW5vDg: posts big blind $0.25
*** HOLE CARDS ***
+2kMBNpY4nF1qNCRd8SJLA: folds 
DnDcAdn9P0zGovMERigpFA: folds 
cZ99hugmLBj9KhTlc8nCSw: raises $0.50 to $0.75
Th3FldXKQW6hWVVPahaoOQ: folds 
DdPXdieucQ+n99u1n3A+rQ: folds 
+5dSUwD+/k2ktlnutSMivw: calls $0.75
Tx6zQdk5Ozt9ObEBlU7jeg: calls $0.75
4awUyiDYTgylQKXZ9faBVA: folds 
dfNim92Z6XK1/h5SFW5vDg: folds 
*** FLOP *** [8c Ah 9d]
cZ99hugmLBj9KhTlc8nCSw: bets $1.75
+5dSUwD+/k2ktlnutSMivw: folds 
Tx6zQdk5Ozt9ObEBlU7jeg: folds 
Uncalled bet ($1.75) returned to cZ99hugmLBj9KhTlc8nCSw
cZ99hugmLBj9KhTlc8nCSw collected $2.50 from pot
cZ99hugmLBj9KhTlc8nCSw: doesn't show hand 
*** SUMMARY ***
Total pot $2.60 | Rake $0.10 
Board [8c Ah 9d]
Seat 1: cZ99hugmLBj9KhTlc8nCSw collected ($2.50)
Seat 2: Th3FldXKQW6hWVVPahaoOQ folded before Flop (didn't bet)
Seat 3: DdPXdieucQ+n99u1n3A+rQ folded before Flop (didn't bet)
Seat 4: +5dSUwD+/k2ktlnutSMivw folded on the Flop
Seat 5: Tx6zQdk5Ozt9ObEBlU7jeg (button) folded on the Flop
Seat 6: 4awUyiDYTgylQKXZ9faBVA (small blind) folded before Flop
Seat 7: dfNim92Z6XK1/h5SFW5vDg (big blind) folded before Flop
Seat 8: +2kMBNpY4nF1qNCRd8SJLA folded before Flop (didn't bet)
Seat 9: DnDcAdn9P0zGovMERigpFA folded before Flop (didn't bet)




PokerStars Game #59941850064:  Hold'em No Limit ($0.10/$0.25) - 2009/07/01 1:48:08 ET
Table 'GxdLtCpYxqT4aAbYqkEEpw' 6-max Seat #2 is the button
Seat 1: 2d/PU00mMdO9azAaXqcSbw ($10.05 in chips) 
Seat 2: MCCWc70bl051s/EF6nHRcA ($24.40 in chips) 
Seat 4: 6wzJiRvp8HY6t+MQGnSIzA ($11.25 in chips) 
Seat 5: q6WfTUAD9mowIP63ASq2Dg ($45.25 in chips) 
Seat 6: DFi/Lzkjsfv8QswS80JX9Q ($25 in chips) 
6wzJiRvp8HY6t+MQGnSIzA: posts small blind $0.10
q6WfTUAD9mowIP63ASq2Dg: posts big blind $0.25
*** HOLE CARDS ***
DFi/Lzkjsfv8QswS80JX9Q: folds 
LpmZGzLpOmfZUF7EV4ZlrQ is connected 
LpmZGzLpOmfZUF7EV4ZlrQ has returned
2d/PU00mMdO9azAaXqcSbw: calls $0.25
MCCWc70bl051s/EF6nHRcA: calls $0.25
6wzJiRvp8HY6t+MQGnSIzA: calls $0.15
q6WfTUAD9mowIP63ASq2Dg: checks 
*** FLOP *** [Th Qs 8s]
6wzJiRvp8HY6t+MQGnSIzA: checks 
q6WfTUAD9mowIP63ASq2Dg: checks 
2d/PU00mMdO9azAaXqcSbw: checks 
MCCWc70bl051s/EF6nHRcA: bets $0.50
6wzJiRvp8HY6t+MQGnSIzA: calls $0.50
q6WfTUAD9mowIP63ASq2Dg: folds 
2d/PU00mMdO9azAaXqcSbw: calls $0.50
*** TURN *** [Th Qs 8s] [5d]
6wzJiRvp8HY6t+MQGnSIzA: checks 
2d/PU00mMdO9azAaXqcSbw: checks 
MCCWc70bl051s/EF6nHRcA: checks 
*** RIVER *** [Th Qs 8s 5d] [Kd]
6wzJiRvp8HY6t+MQGnSIzA: bets $1.50
2d/PU00mMdO9azAaXqcSbw: folds 
MCCWc70bl051s/EF6nHRcA: folds 
Uncalled bet ($1.50) returned to 6wzJiRvp8HY6t+MQGnSIzA
6wzJiRvp8HY6t+MQGnSIzA collected $2.40 from pot
6wzJiRvp8HY6t+MQGnSIzA: doesn't show hand 
*** SUMMARY ***
Total pot $2.50 | Rake $0.10 
Board [Th Qs 8s 5d Kd]
Seat 1: 2d/PU00mMdO9azAaXqcSbw folded on the River
Seat 2: MCCWc70bl051s/EF6nHRcA (button) folded on the River
Seat 4: 6wzJiRvp8HY6t+MQGnSIzA (small blind) collected ($2.40)
Seat 5: q6WfTUAD9mowIP63ASq2Dg (big blind) folded on the Flop
Seat 6: DFi/Lzkjsfv8QswS80JX9Q folded before Flop (didn't bet)




PokerStars Game #59941849854:  Hold'em No Limit ($0.10/$0.25) - 2009/07/01 1:48:08 ET
Table 'ggwTHpIC5qhhHJSYjK1XCw' 6-max Seat #2 is the button
Seat 1: MqMK8OWPSY1V4stf1Hy5Jw ($80.50 in chips) 
Seat 2: /gJNBeCkWL4o85/jvlZ4BA ($26.20 in chips) 
Seat 3: 7cx44/slbeTw+Cy7QB8Trg ($24.75 in chips) 
Seat 4: JFIAqU8lCZ0vWwEl4bdGsg ($25 in chips) 
Seat 5: BvqhBa7W/To51LhEiIU/lw ($6.05 in chips) 
7cx44/slbeTw+Cy7QB8Trg: posts small blind $0.10
JFIAqU8lCZ0vWwEl4bdGsg: posts big blind $0.25
*** HOLE CARDS ***
BvqhBa7W/To51LhEiIU/lw: calls $0.25
MqMK8OWPSY1V4stf1Hy5Jw: folds 
/gJNBeCkWL4o85/jvlZ4BA: folds 
7cx44/slbeTw+Cy7QB8Trg: calls $0.15
JFIAqU8lCZ0vWwEl4bdGsg: checks 
*** FLOP *** [Td 9d 6c]
7cx44/slbeTw+Cy7QB8Trg: checks 
JFIAqU8lCZ0vWwEl4bdGsg: checks 
BvqhBa7W/To51LhEiIU/lw: bets $0.50
7cx44/slbeTw+Cy7QB8Trg: folds 
JFIAqU8lCZ0vWwEl4bdGsg: folds 
Uncalled bet ($0.50) returned to BvqhBa7W/To51LhEiIU/lw
BvqhBa7W/To51LhEiIU/lw collected $0.75 from pot
BvqhBa7W/To51LhEiIU/lw: doesn't show hand 
*** SUMMARY ***
Total pot $0.75 | Rake $0 
Board [Td 9d 6c]
Seat 1: MqMK8OWPSY1V4stf1Hy5Jw folded before Flop (didn't bet)
Seat 2: /gJNBeCkWL4o85/jvlZ4BA (button) folded before Flop (didn't bet)
Seat 3: 7cx44/slbeTw+Cy7QB8Trg (small blind) folded on the Flop
Seat 4: JFIAqU8lCZ0vWwEl4bdGsg (big blind) folded on the Flop
Seat 5: BvqhBa7W/To51LhEiIU/lw collected ($0.75)




PokerStars Game #59941850742:  Hold'em No Limit ($0.10/$0.25) - 2009/07/01 1:48:09 ET
Table '/asc7VQ/OpF/oVJ3erB80w' 9-max Seat #4 is the button
Seat 2: +LseQ4csMghI3KY4cLSGMQ ($20.95 in chips) 
Seat 3: WEb58GPxGJGcxGh34AFZRQ ($6.50 in chips) 
Seat 4: Rjy74A2wdEiDWplMcUbA+w ($8.25 in chips) 
Seat 5: QB9VESHry/CRTDKMGwKwsQ ($40.95 in chips) 
Seat 6: wnerYvSRWT9Sm4X3ip/c8w ($25 in chips) 
Seat 7: 7Qlge5BZqMQvXxiy4HU3Hw ($6.25 in chips) 
Seat 8: jB7U2KxE3pjvDhvZHXK2Ag ($18.60 in chips) 
Seat 9: zUXhymECc2C9W9ZNw6qppA ($19.05 in chips) 
QB9VESHry/CRTDKMGwKwsQ: posts small blind $0.10
wnerYvSRWT9Sm4X3ip/c8w: posts big blind $0.25
*** HOLE CARDS ***
7Qlge5BZqMQvXxiy4HU3Hw: calls $0.25
7Qlge5BZqMQvXxiy4HU3Hw said, "k"
WEb58GPxGJGcxGh34AFZRQ said, "it takes a couple times for him to understand"
jB7U2KxE3pjvDhvZHXK2Ag: calls $0.25
zUXhymECc2C9W9ZNw6qppA: folds 
+LseQ4csMghI3KY4cLSGMQ: calls $0.25
WEb58GPxGJGcxGh34AFZRQ: folds 
Rjy74A2wdEiDWplMcUbA+w: folds 
QB9VESHry/CRTDKMGwKwsQ: calls $0.15
wnerYvSRWT9Sm4X3ip/c8w: checks 
*** FLOP *** [8c 2s Jh]
QB9VESHry/CRTDKMGwKwsQ: checks 
wnerYvSRWT9Sm4X3ip/c8w: checks 
7Qlge5BZqMQvXxiy4HU3Hw: bets $1
jB7U2KxE3pjvDhvZHXK2Ag: folds 
WEb58GPxGJGcxGh34AFZRQ said, "too busy crying to catch it the first time"
+LseQ4csMghI3KY4cLSGMQ: folds 
QB9VESHry/CRTDKMGwKwsQ: folds 
wnerYvSRWT9Sm4X3ip/c8w: folds 
Uncalled bet ($1) returned to 7Qlge5BZqMQvXxiy4HU3Hw
7Qlge5BZqMQvXxiy4HU3Hw said, "** quack head"
7Qlge5BZqMQvXxiy4HU3Hw collected $1.20 from pot
*** SUMMARY ***
Total pot $1.25 | Rake $0.05 
Board [8c 2s Jh]
Seat 2: +LseQ4csMghI3KY4cLSGMQ folded on the Flop
Seat 3: WEb58GPxGJGcxGh34AFZRQ folded before Flop (didn't bet)
Seat 4: Rjy74A2wdEiDWplMcUbA+w (button) folded before Flop (didn't bet)
Seat 5: QB9VESHry/CRTDKMGwKwsQ (small blind) folded on the Flop
Seat 6: wnerYvSRWT9Sm4X3ip/c8w (big blind) folded on the Flop
Seat 7: 7Qlge5BZqMQvXxiy4HU3Hw collected ($1.20)
Seat 8: jB7U2KxE3pjvDhvZHXK2Ag folded on the Flop
Seat 9: zUXhymECc2C9W9ZNw6qppA folded before Flop (didn't bet)




PokerStars Game #59941850848:  Hold'em No Limit ($0.10/$0.25) - 2009/07/01 1:48:09 ET
Table 'NfXsh0UQA+o/kO9acV3WxA' 9-max Seat #8 is the button
Seat 1: pN3IHvAKm2fz+sTRARTcrg ($24.65 in chips) 
Seat 2: mhpFs2SZupy4zLRb62FLFA ($25 in chips) 
Seat 3: wCUaomJ6Nq5zomVGdUHP+w ($18.05 in chips) 
Seat 4: r6hsffOo1iKmaPYKwAZmFw ($30.05 in chips) 
Seat 5: zgi+EUykT/pZQpoUG6+oEg ($4.65 in chips) 
Seat 7: yqkowiRWZ6NvRN9UUkYIlA ($5 in chips) 
Seat 8: +sbyWwIcFp9kP0bDtMegfQ ($39.50 in chips) 
Seat 9: uhrboV251dcgYniYTdFIcA ($28.95 in chips) 
uhrboV251dcgYniYTdFIcA: posts small blind $0.10
pN3IHvAKm2fz+sTRARTcrg: posts big blind $0.25
qwr38jl5txoR36M7G5qi4A: sits out 
*** HOLE CARDS ***
mhpFs2SZupy4zLRb62FLFA: folds 
wCUaomJ6Nq5zomVGdUHP+w: calls $0.25
r6hsffOo1iKmaPYKwAZmFw: folds 
zgi+EUykT/pZQpoUG6+oEg: folds 
yqkowiRWZ6NvRN9UUkYIlA: folds 
+sbyWwIcFp9kP0bDtMegfQ: folds 
uhrboV251dcgYniYTdFIcA: folds 
pN3IHvAKm2fz+sTRARTcrg: checks 
*** FLOP *** [2h 6s 7c]
pN3IHvAKm2fz+sTRARTcrg: checks 
wCUaomJ6Nq5zomVGdUHP+w: checks 
*** TURN *** [2h 6s 7c] [Tc]
pN3IHvAKm2fz+sTRARTcrg: checks 
wCUaomJ6Nq5zomVGdUHP+w: checks 
*** RIVER *** [2h 6s 7c Tc] [7s]
pN3IHvAKm2fz+sTRARTcrg: checks 
wCUaomJ6Nq5zomVGdUHP+w: bets $1
pN3IHvAKm2fz+sTRARTcrg: folds 
Uncalled bet ($1) returned to wCUaomJ6Nq5zomVGdUHP+w
wCUaomJ6Nq5zomVGdUHP+w collected $0.60 from pot
wCUaomJ6Nq5zomVGdUHP+w: doesn't show hand 
*** SUMMARY ***
Total pot $0.60 | Rake $0 
Board [2h 6s 7c Tc 7s]
Seat 1: pN3IHvAKm2fz+sTRARTcrg (big blind) folded on the River
Seat 2: mhpFs2SZupy4zLRb62FLFA folded before Flop (didn't bet)
Seat 3: wCUaomJ6Nq5zomVGdUHP+w collected ($0.60)
Seat 4: r6hsffOo1iKmaPYKwAZmFw folded before Flop (didn't bet)
Seat 5: zgi+EUykT/pZQpoUG6+oEg folded before Flop (didn't bet)
Seat 7: yqkowiRWZ6NvRN9UUkYIlA folded before Flop (didn't bet)
Seat 8: +sbyWwIcFp9kP0bDtMegfQ (button) folded before Flop (didn't bet)
Seat 9: uhrboV251dcgYniYTdFIcA (small blind) folded before Flop




PokerStars Game #59941850526:  Hold'em No Limit ($0.10/$0.25) - 2009/07/01 1:48:09 ET
Table 'D1Yq70l0nNCyMV6DA42p+Q' 9-max Seat #2 is the button
Seat 2: zgi+EUykT/pZQpoUG6+oEg ($3.95 in chips) 
Seat 3: 9lvO/qyU+xrU95Teu1fv0g ($5.25 in chips) 
Seat 4: VWUWpMLMj/Q1jRVpF7Aohw ($8.90 in chips) 
Seat 5: gehe91e0IyVT0QU/XBkEyg ($25 in chips) 
Seat 6: wGigCmBR/9XWkPpvYos3aQ ($33.20 in chips) 
Seat 7: Lqytncc1Dsgt654eEBp/uw ($36.75 in chips) 
Seat 8: zDrucyjVn5aeekNEc3cJrA ($24 in chips) 
Seat 9: h5wEs8qXrBqfLa9GjaSBzg ($17.50 in chips) 
9lvO/qyU+xrU95Teu1fv0g: posts small blind $0.10
VWUWpMLMj/Q1jRVpF7Aohw: posts big blind $0.25
*** HOLE CARDS ***
gehe91e0IyVT0QU/XBkEyg: folds 
wGigCmBR/9XWkPpvYos3aQ: folds 
Lqytncc1Dsgt654eEBp/uw: folds 
zDrucyjVn5aeekNEc3cJrA: folds 
h5wEs8qXrBqfLa9GjaSBzg: folds 
zgi+EUykT/pZQpoUG6+oEg: folds 
9lvO/qyU+xrU95Teu1fv0g: folds 
Uncalled bet ($0.15) returned to VWUWpMLMj/Q1jRVpF7Aohw
VWUWpMLMj/Q1jRVpF7Aohw collected $0.20 from pot
*** SUMMARY ***
Total pot $0.20 | Rake $0 
Seat 2: zgi+EUykT/pZQpoUG6+oEg (button) folded before Flop (didn't bet)
Seat 3: 9lvO/qyU+xrU95Teu1fv0g (small blind) folded before Flop
Seat 4: VWUWpMLMj/Q1jRVpF7Aohw (big blind) collected ($0.20)
Seat 5: gehe91e0IyVT0QU/XBkEyg folded before Flop (didn't bet)
Seat 6: wGigCmBR/9XWkPpvYos3aQ folded before Flop (didn't bet)
Seat 7: Lqytncc1Dsgt654eEBp/uw folded before Flop (didn't bet)
Seat 8: zDrucyjVn5aeekNEc3cJrA folded before Flop (didn't bet)
Seat 9: h5wEs8qXrBqfLa9GjaSBzg folded before Flop (didn't bet)




PokerStars Game #59941850772:  Hold'em No Limit ($0.10/$0.25) - 2009/07/01 1:48:09 ET
Table 'IdXp6nyeW4FYaEK4qKCnwQ' 9-max Seat #7 is the button
Seat 1: tLcDklc2rBORNfixyRfVfw ($25 in chips) 
Seat 2: HPEB+AtKw1+C/cxU0o1ciw ($30.85 in chips) 
Seat 3: eK8qa6EPcH2zhtbmWSvc9g ($34.30 in chips) 
Seat 4: j4q3p0lesp63b1gZDwLBZw ($5.35 in chips) 
Seat 6: arxNSjreDRGFg13EAM2F1w ($30.50 in chips) 
Seat 7: w1ukf8uPa4+WH561TtVRxA ($36.90 in chips) 
Seat 8: dtZ84flFEi4Q+SGrHMJRDQ ($29.85 in chips) 
Seat 9: s2xLPOl/vhl/26apJ3vsOQ ($29.25 in chips) 
dtZ84flFEi4Q+SGrHMJRDQ: posts small blind $0.10
s2xLPOl/vhl/26apJ3vsOQ: posts big blind $0.25
*** HOLE CARDS ***
tLcDklc2rBORNfixyRfVfw: folds 
HPEB+AtKw1+C/cxU0o1ciw: folds 
eK8qa6EPcH2zhtbmWSvc9g: folds 
eK8qa6EPcH2zhtbmWSvc9g leaves the table
j4q3p0lesp63b1gZDwLBZw: folds 
arxNSjreDRGFg13EAM2F1w: folds 
w1ukf8uPa4+WH561TtVRxA: raises $0.50 to $0.75
dtZ84flFEi4Q+SGrHMJRDQ: folds 
s2xLPOl/vhl/26apJ3vsOQ: folds 
Uncalled bet ($0.50) returned to w1ukf8uPa4+WH561TtVRxA
w1ukf8uPa4+WH561TtVRxA collected $0.60 from pot
w1ukf8uPa4+WH561TtVRxA: doesn't show hand 
*** SUMMARY ***
Total pot $0.60 | Rake $0 
Seat 1: tLcDklc2rBORNfixyRfVfw folded before Flop (didn't bet)
Seat 2: HPEB+AtKw1+C/cxU0o1ciw folded before Flop (didn't bet)
Seat 3: eK8qa6EPcH2zhtbmWSvc9g folded before Flop (didn't bet)
Seat 4: j4q3p0lesp63b1gZDwLBZw folded before Flop (didn't bet)
Seat 6: arxNSjreDRGFg13EAM2F1w folded before Flop (didn't bet)
Seat 7: w1ukf8uPa4+WH561TtVRxA (button) collected ($0.60)
Seat 8: dtZ84flFEi4Q+SGrHMJRDQ (small blind) folded before Flop
Seat 9: s2xLPOl/vhl/26apJ3vsOQ (big blind) folded before Flop




PokerStars Game #59941850550:  Hold'em No Limit ($0.10/$0.25) - 2009/07/01 1:48:09 ET
Table 'jz4TpuH+ag+0iNe2ZcxckQ' 9-max Seat #9 is the button
Seat 2: clJsV3v77RS07bDKY+705w ($6.20 in chips) 
Seat 3: egvg3mTBBVzMHnJPIQiKcA ($15.55 in chips) 
Seat 4: k+2r6di6GXjNpAdrRkW9bA ($58.15 in chips) 
Seat 5: v1BVHNGLbP/nx7QO6K7+Jw ($37.50 in chips) 
Seat 6: gO1uiTGTzn5Cd3PECuws1g ($13.65 in chips) 
Seat 7: tLcDklc2rBORNfixyRfVfw ($43.05 in chips) 
Seat 8: uhrboV251dcgYniYTdFIcA ($25 in chips) 
Seat 9: W2YYHvqjaEpRrO7stZkClQ ($5.30 in chips) 
4awUyiDYTgylQKXZ9faBVA will be allowed to play after the button
clJsV3v77RS07bDKY+705w: posts small blind $0.10
egvg3mTBBVzMHnJPIQiKcA: posts big blind $0.25
*** HOLE CARDS ***
k+2r6di6GXjNpAdrRkW9bA: folds 
v1BVHNGLbP/nx7QO6K7+Jw: folds 
gO1uiTGTzn5Cd3PECuws1g: folds 
tLcDklc2rBORNfixyRfVfw: folds 
uhrboV251dcgYniYTdFIcA: raises $0.75 to $1
W2YYHvqjaEpRrO7stZkClQ: folds 
clJsV3v77RS07bDKY+705w: folds 
egvg3mTBBVzMHnJPIQiKcA: folds 
Uncalled bet ($0.75) returned to uhrboV251dcgYniYTdFIcA
uhrboV251dcgYniYTdFIcA collected $0.60 from pot
uhrboV251dcgYniYTdFIcA: doesn't show hand 
*** SUMMARY ***
Total pot $0.60 | Rake $0 
Seat 2: clJsV3v77RS07bDKY+705w (small blind) folded before Flop
Seat 3: egvg3mTBBVzMHnJPIQiKcA (big blind) folded before Flop
Seat 4: k+2r6di6GXjNpAdrRkW9bA folded before Flop (didn't bet)
Seat 5: v1BVHNGLbP/nx7QO6K7+Jw folded before Flop (didn't bet)
Seat 6: gO1uiTGTzn5Cd3PECuws1g folded before Flop (didn't bet)
Seat 7: tLcDklc2rBORNfixyRfVfw folded before Flop (didn't bet)
Seat 8: uhrboV251dcgYniYTdFIcA collected ($0.60)
Seat 9: W2YYHvqjaEpRrO7stZkClQ (button) folded before Flop (didn't bet)




PokerStars Game #59941850796:  Hold'em No Limit ($0.10/$0.25) - 2009/07/01 1:48:09 ET
Table 'WEMI3Mtn7dGARDbgNrKibg' 9-max Seat #5 is the button
Seat 1: Th3FldXKQW6hWVVPahaoOQ ($30.50 in chips) 
Seat 2: tYsOBqdU1+x+yFI7zHO7hQ ($49.55 in chips) 
Seat 3: qwr38jl5txoR36M7G5qi4A ($10 in chips) 
Seat 4: Z5NNIVvnhb2IJbLcI79WYQ ($10.55 in chips) 
Seat 5: yzPZQFeaQTNf1YK3a0zRIw ($8.95 in chips) 
Seat 6: arxNSjreDRGFg13EAM2F1w ($25.20 in chips) 
Seat 7: DnDcAdn9P0zGovMERigpFA ($54.90 in chips) 
Seat 8: ghNKXUBl/H+t83JF079ZBA ($29.60 in chips) 
Seat 9: 2wcFsZsqEP5w1StUTVzJCg ($4.50 in chips) 
arxNSjreDRGFg13EAM2F1w: posts small blind $0.10
DnDcAdn9P0zGovMERigpFA: posts big blind $0.25
*** HOLE CARDS ***
ghNKXUBl/H+t83JF079ZBA: folds 
2wcFsZsqEP5w1StUTVzJCg: folds 
Th3FldXKQW6hWVVPahaoOQ: folds 
tYsOBqdU1+x+yFI7zHO7hQ: folds 
qwr38jl5txoR36M7G5qi4A: folds 
Z5NNIVvnhb2IJbLcI79WYQ: folds 
yzPZQFeaQTNf1YK3a0zRIw: raises $0.25 to $0.50
arxNSjreDRGFg13EAM2F1w: folds 
DnDcAdn9P0zGovMERigpFA: folds 
Uncalled bet ($0.25) returned to yzPZQFeaQTNf1YK3a0zRIw
yzPZQFeaQTNf1YK3a0zRIw collected $0.60 from pot
yzPZQFeaQTNf1YK3a0zRIw: doesn't show hand 
*** SUMMARY ***
Total pot $0.60 | Rake $0 
Seat 1: Th3FldXKQW6hWVVPahaoOQ folded before Flop (didn't bet)
Seat 2: tYsOBqdU1+x+yFI7zHO7hQ folded before Flop (didn't bet)
Seat 3: qwr38jl5txoR36M7G5qi4A folded before Flop (didn't bet)
Seat 4: Z5NNIVvnhb2IJbLcI79WYQ folded before Flop (didn't bet)
Seat 5: yzPZQFeaQTNf1YK3a0zRIw (button) collected ($0.60)
Seat 6: arxNSjreDRGFg13EAM2F1w (small blind) folded before Flop
Seat 7: DnDcAdn9P0zGovMERigpFA (big blind) folded before Flop
Seat 8: ghNKXUBl/H+t83JF079ZBA folded before Flop (didn't bet)
Seat 9: 2wcFsZsqEP5w1StUTVzJCg folded before Flop (didn't bet)




PokerStars Game #59941850900:  Hold'em No Limit ($0.10/$0.25) - 2009/07/01 1:48:09 ET
Table 'nc6OeGk/wtaWV+6N+kgnZQgZetDqJh6q9A3mLO3ThCsASeat #3 is the button
Seat 1: DihMHaz4WNETH1bPDe13kA ($25 in chips) 
Seat 2: JFIAqU8lCZ0vWwEl4bdGsg ($34.85 in chips) 
Seat 3: jp34e617tIzV8tKIWmfAbA ($33.80 in chips) 
Seat 4: BV+K0Phf5VBHr7aZPKqbUQ ($29.70 in chips) 
Seat 5: EKTLAV1bAterT0Mc1G6lBg5hAPbqNrvJb8PtLiceXtlg4.50 in chips) 
Seat 6: Mhj3q7cxev+XjXZxEE6/Cw ($25 in chips) 
BV+K0Phf5VBHr7aZPKqbUQ: posts small blind $0.10
EKTLAV1bAterT0Mc1G6lBg5hAPbqNrvJb8PtLiceXtlgsts big blind $0.25
*** HOLE CARDS ***
Mhj3q7cxev+XjXZxEE6/Cw: folds 
DihMHaz4WNETH1bPDe13kA: folds 
JFIAqU8lCZ0vWwEl4bdGsg: raises $0.60 to $0.85
jp34e617tIzV8tKIWmfAbA: folds 
BV+K0Phf5VBHr7aZPKqbUQ: folds 
EKTLAV1bAterT0Mc1G6lBg5hAPbqNrvJb8PtLiceXtlglds 
Uncalled bet ($0.60) returned to JFIAqU8lCZ0vWwEl4bdGsg
EKTLAV1bAterT0Mc1G6lBg5hAPbqNrvJb8PtLiceXtlgves the table
JFIAqU8lCZ0vWwEl4bdGsg collected $0.60 from pot
JFIAqU8lCZ0vWwEl4bdGsg: doesn't show hand 
*** SUMMARY ***
Total pot $0.60 | Rake $0 
Seat 1: DihMHaz4WNETH1bPDe13kA folded before Flop (didn't bet)
Seat 2: JFIAqU8lCZ0vWwEl4bdGsg collected ($0.60)
Seat 3: jp34e617tIzV8tKIWmfAbA (button) folded before Flop (didn't bet)
Seat 4: BV+K0Phf5VBHr7aZPKqbUQ (small blind) folded before Flop
Seat 5: EKTLAV1bAterT0Mc1G6lBg5hAPbqNrvJb8PtLiceXtlgg blind) folded before Flop
Seat 6: Mhj3q7cxev+XjXZxEE6/Cw folded before Flop (didn't bet)




PokerStars Game #59941850824:  Hold'em No Limit ($0.10/$0.25) - 2009/07/01 1:48:09 ET
Table '+198VWQSWBhYQOcizzuBkw' 6-max Seat #4 is the button
Seat 1: 34ttqW62uIRrqINCCmLcsw ($20 in chips) 
Seat 2: iauW7L/+7qzAuHow7CD75Q ($10.35 in chips) 
Seat 3: vw7gefupgmOJJN8lUemdWg ($18.05 in chips) 
Seat 4: TgDsTeCdLQt8kWbL00ByRA ($14.90 in chips) 
Seat 5: LtASJ9OlkqGrrUKGQlpGAw ($25.10 in chips) 
Seat 6: leEQ84f6wJYu5SB/vj27wg ($3.80 in chips) 
LtASJ9OlkqGrrUKGQlpGAw: posts small blind $0.10
leEQ84f6wJYu5SB/vj27wg: posts big blind $0.25
*** HOLE CARDS ***
34ttqW62uIRrqINCCmLcsw: folds 
iauW7L/+7qzAuHow7CD75Q: calls $0.25
vw7gefupgmOJJN8lUemdWg: calls $0.25
TgDsTeCdLQt8kWbL00ByRA: calls $0.25
LtASJ9OlkqGrrUKGQlpGAw: folds 
leEQ84f6wJYu5SB/vj27wg: checks 
*** FLOP *** [7s 7h 4c]
leEQ84f6wJYu5SB/vj27wg: checks 
iauW7L/+7qzAuHow7CD75Q: checks 
vw7gefupgmOJJN8lUemdWg: checks 
TgDsTeCdLQt8kWbL00ByRA: checks 
*** TURN *** [7s 7h 4c] [2s]
leEQ84f6wJYu5SB/vj27wg: checks 
iauW7L/+7qzAuHow7CD75Q: checks 
vw7gefupgmOJJN8lUemdWg: checks 
TgDsTeCdLQt8kWbL00ByRA: checks 
*** RIVER *** [7s 7h 4c 2s] [5s]
leEQ84f6wJYu5SB/vj27wg: checks 
iauW7L/+7qzAuHow7CD75Q: checks 
vw7gefupgmOJJN8lUemdWg: checks 
TgDsTeCdLQt8kWbL00ByRA: checks 
*** SHOW DOWN ***
leEQ84f6wJYu5SB/vj27wg: shows [Kc Qc] (a pair of Sevens)
iauW7L/+7qzAuHow7CD75Q: mucks hand 
vw7gefupgmOJJN8lUemdWg: shows [Ac 3h] (a straight, Ace to Five)
TgDsTeCdLQt8kWbL00ByRA: mucks hand 
vw7gefupgmOJJN8lUemdWg collected $1.05 from pot
*** SUMMARY ***
Total pot $1.10 | Rake $0.05 
Board [7s 7h 4c 2s 5s]
Seat 1: 34ttqW62uIRrqINCCmLcsw folded before Flop (didn't bet)
Seat 2: iauW7L/+7qzAuHow7CD75Q mucked
Seat 3: vw7gefupgmOJJN8lUemdWg showed [Ac 3h] and won ($1.05) with a straight, Ace to Five
Seat 4: TgDsTeCdLQt8kWbL00ByRA (button) mucked
Seat 5: LtASJ9OlkqGrrUKGQlpGAw (small blind) folded before Flop
Seat 6: leEQ84f6wJYu5SB/vj27wg (big blind) showed [Kc Qc] and lost with a pair of Sevens




PokerStars Game #59941850540:  Hold'em No Limit ($0.10/$0.25) - 2009/07/01 1:48:09 ET
Table 'xmJKTGBeWCwutccj3YfupQ' 6-max Seat #6 is the button
Seat 1: sVbkVl4OznxBCfi66UB9vw ($40.70 in chips) 
Seat 2: QqiZLFrN8iOUT/GHw7ztOA ($25 in chips) 
Seat 3: T5wrp/d5jarm+SxNy8OQAg ($25.50 in chips) 
Seat 4: uWjhTVMpuIroxXcmD3Okug ($17 in chips) 
Seat 5: DE9hRlt14g+JdsRQ4wT7hg ($29.60 in chips) 
Seat 6: 9bpVv1/Qh9IYtXuCtl5VtQ ($15.60 in chips) 
sVbkVl4OznxBCfi66UB9vw: posts small blind $0.10
QqiZLFrN8iOUT/GHw7ztOA: posts big blind $0.25
*** HOLE CARDS ***
T5wrp/d5jarm+SxNy8OQAg: folds 
uWjhTVMpuIroxXcmD3Okug: folds 
T5wrp/d5jarm+SxNy8OQAg said, "nh"
DE9hRlt14g+JdsRQ4wT7hg: folds 
9bpVv1/Qh9IYtXuCtl5VtQ: folds 
uWjhTVMpuIroxXcmD3Okug said, "ty"
sVbkVl4OznxBCfi66UB9vw: raises $0.50 to $0.75
QqiZLFrN8iOUT/GHw7ztOA: folds 
Uncalled bet ($0.50) returned to sVbkVl4OznxBCfi66UB9vw
sVbkVl4OznxBCfi66UB9vw collected $0.50 from pot
sVbkVl4OznxBCfi66UB9vw: doesn't show hand 
*** SUMMARY ***
Total pot $0.50 | Rake $0 
Seat 1: sVbkVl4OznxBCfi66UB9vw (small blind) collected ($0.50)
Seat 2: QqiZLFrN8iOUT/GHw7ztOA (big blind) folded before Flop
Seat 3: T5wrp/d5jarm+SxNy8OQAg folded before Flop (didn't bet)
Seat 4: uWjhTVMpuIroxXcmD3Okug folded before Flop (didn't bet)
Seat 5: DE9hRlt14g+JdsRQ4wT7hg folded before Flop (didn't bet)
Seat 6: 9bpVv1/Qh9IYtXuCtl5VtQ (button) folded before Flop (didn't bet)




PokerStars Game #59941850798:  Hold'em No Limit ($0.10/$0.25) - 2009/07/01 1:48:09 ET
Table 'fIMYcWwN4/aXFJvH5Z8Ymg' 6-max Seat #2 is the button
Seat 1: DihMHaz4WNETH1bPDe13kA ($25 in chips) 
Seat 2: Mhj3q7cxev+XjXZxEE6/Cw ($25.60 in chips) 
Seat 3: 9bpVv1/Qh9IYtXuCtl5VtQ ($24.75 in chips) 
Seat 4: 7cx44/slbeTw+Cy7QB8Trg ($25 in chips) 
Seat 5: lquriepNQBhDV5P1SWHhnA ($25.35 in chips) 
Seat 6: jp34e617tIzV8tKIWmfAbA ($28.70 in chips) 
9bpVv1/Qh9IYtXuCtl5VtQ: posts small blind $0.10
7cx44/slbeTw+Cy7QB8Trg: posts big blind $0.25
*** HOLE CARDS ***
lquriepNQBhDV5P1SWHhnA: folds 
jp34e617tIzV8tKIWmfAbA: folds 
DihMHaz4WNETH1bPDe13kA: raises $0.50 to $0.75
Mhj3q7cxev+XjXZxEE6/Cw: folds 
9bpVv1/Qh9IYtXuCtl5VtQ: folds 
7cx44/slbeTw+Cy7QB8Trg: folds 
Uncalled bet ($0.50) returned to DihMHaz4WNETH1bPDe13kA
DihMHaz4WNETH1bPDe13kA collected $0.60 from pot
*** SUMMARY ***
Total pot $0.60 | Rake $0 
Seat 1: DihMHaz4WNETH1bPDe13kA collected ($0.60)
Seat 2: Mhj3q7cxev+XjXZxEE6/Cw (button) folded before Flop (didn't bet)
Seat 3: 9bpVv1/Qh9IYtXuCtl5VtQ (small blind) folded before Flop
Seat 4: 7cx44/slbeTw+Cy7QB8Trg (big blind) folded before Flop
Seat 5: lquriepNQBhDV5P1SWHhnA folded before Flop (didn't bet)
Seat 6: jp34e617tIzV8tKIWmfAbA folded before Flop (didn't bet)




PokerStars Game #59941850672:  Hold'em No Limit ($0.10/$0.25) - 2009/07/01 1:48:09 ET
Table 'SbSV5tlgLp0+/Z+13PW3Hg' 9-max Seat #3 is the button
Seat 1: x+W5+3qsdY4Iszf0hoH+Aw ($18.80 in chips) 
Seat 3: CT7Xj/V/O5rBlhtt+RZeFQ ($25.60 in chips) 
Seat 4: puj3K/wrNjEj86ZL/MyfLA ($9.25 in chips) 
Seat 6: pN3IHvAKm2fz+sTRARTcrg ($25.40 in chips) 
Seat 8: qBdqLaJhO+1itcMk70bsfA ($7.65 in chips) 
Seat 9: X78b5v/uhqeXXoAijbw/yg ($25 in chips) 
puj3K/wrNjEj86ZL/MyfLA: posts small blind $0.10
aNpwfA31EREwO+ar4XzBCw: is sitting out 
pN3IHvAKm2fz+sTRARTcrg: posts big blind $0.25
3PmVnC/15cl4oyI1TKIt4g: sits out 
*** HOLE CARDS ***
qBdqLaJhO+1itcMk70bsfA: calls $0.25
X78b5v/uhqeXXoAijbw/yg: calls $0.25
x+W5+3qsdY4Iszf0hoH+Aw: folds 
CT7Xj/V/O5rBlhtt+RZeFQ: folds 
puj3K/wrNjEj86ZL/MyfLA: calls $0.15
pN3IHvAKm2fz+sTRARTcrg: checks 
*** FLOP *** [2d As Qc]
puj3K/wrNjEj86ZL/MyfLA: checks 
pN3IHvAKm2fz+sTRARTcrg: checks 
qBdqLaJhO+1itcMk70bsfA: checks 
X78b5v/uhqeXXoAijbw/yg: checks 
*** TURN *** [2d As Qc] [9d]
puj3K/wrNjEj86ZL/MyfLA: checks 
pN3IHvAKm2fz+sTRARTcrg: checks 
qBdqLaJhO+1itcMk70bsfA: bets $0.50
X78b5v/uhqeXXoAijbw/yg: folds 
puj3K/wrNjEj86ZL/MyfLA: folds 
pN3IHvAKm2fz+sTRARTcrg: folds 
Uncalled bet ($0.50) returned to qBdqLaJhO+1itcMk70bsfA
qBdqLaJhO+1itcMk70bsfA collected $0.95 from pot
zDrucyjVn5aeekNEc3cJrA has returned
*** SUMMARY ***
Total pot $1 | Rake $0.05 
Board [2d As Qc 9d]
Seat 1: x+W5+3qsdY4Iszf0hoH+Aw folded before Flop (didn't bet)
Seat 3: CT7Xj/V/O5rBlhtt+RZeFQ (button) folded before Flop (didn't bet)
Seat 4: puj3K/wrNjEj86ZL/MyfLA (small blind) folded on the Turn
Seat 6: pN3IHvAKm2fz+sTRARTcrg (big blind) folded on the Turn
Seat 8: qBdqLaJhO+1itcMk70bsfA collected ($0.95)
Seat 9: X78b5v/uhqeXXoAijbw/yg folded on the Turn




PokerStars Game #59941851476:  Hold'em No Limit ($0.10/$0.25) - 2009/07/01 1:48:10 ET
Table 'sJ4KpS2GE5Qrsu1/cFjJUw' 9-max Seat #1 is the button
Seat 1: eDlQ+S+6L4e6gM1dkZhGgQ ($19.40 in chips) 
Seat 3: eK8qa6EPcH2zhtbmWSvc9g ($25 in chips) 
Seat 4: npAYqa85pqnzfOK5ukX+BQ ($24 in chips) 
Seat 5: Q/gZC63lfOMr7YhWKPCxoQ ($8.10 in chips) 
Seat 6: OefE+Csvj5KR7ClGf3Hc2g ($3.85 in chips) 
Seat 7: Wi8djHgewBlVhpKWfp7isQ ($8.60 in chips) 
Seat 8: S7Ki0P+0AIGPuIfGJjW0gg ($30.95 in chips) 
Seat 9: 3PmVnC/15cl4oyI1TKIt4g ($4.40 in chips) 
eK8qa6EPcH2zhtbmWSvc9g: posts small blind $0.10
npAYqa85pqnzfOK5ukX+BQ: posts big blind $0.25
*** HOLE CARDS ***
Q/gZC63lfOMr7YhWKPCxoQ: folds 
OefE+Csvj5KR7ClGf3Hc2g: folds 
Wi8djHgewBlVhpKWfp7isQ: calls $0.25
S7Ki0P+0AIGPuIfGJjW0gg: calls $0.25
3PmVnC/15cl4oyI1TKIt4g: folds 
eDlQ+S+6L4e6gM1dkZhGgQ: folds 
eK8qa6EPcH2zhtbmWSvc9g: folds 
npAYqa85pqnzfOK5ukX+BQ: checks 
*** FLOP *** [Jh Ts As]
npAYqa85pqnzfOK5ukX+BQ: checks 
Wi8djHgewBlVhpKWfp7isQ: bets $0.75
S7Ki0P+0AIGPuIfGJjW0gg: folds 
npAYqa85pqnzfOK5ukX+BQ: folds 
Uncalled bet ($0.75) returned to Wi8djHgewBlVhpKWfp7isQ
Wi8djHgewBlVhpKWfp7isQ collected $0.85 from pot
Wi8djHgewBlVhpKWfp7isQ: doesn't show hand 
*** SUMMARY ***
Total pot $0.85 | Rake $0 
Board [Jh Ts As]
Seat 1: eDlQ+S+6L4e6gM1dkZhGgQ (button) folded before Flop (didn't bet)
Seat 3: eK8qa6EPcH2zhtbmWSvc9g (small blind) folded before Flop
Seat 4: npAYqa85pqnzfOK5ukX+BQ (big blind) folded on the Flop
Seat 5: Q/gZC63lfOMr7YhWKPCxoQ folded before Flop (didn't bet)
Seat 6: OefE+Csvj5KR7ClGf3Hc2g folded before Flop (didn't bet)
Seat 7: Wi8djHgewBlVhpKWfp7isQ collected ($0.85)
Seat 8: S7Ki0P+0AIGPuIfGJjW0gg folded on the Flop
Seat 9: 3PmVnC/15cl4oyI1TKIt4g folded before Flop (didn't bet)




PokerStars Game #59941851364:  Hold'em No Limit ($0.10/$0.25) - 2009/07/01 1:48:10 ET
Table 'h02LhQ7B/Zk4ETRxxHhGYA' 9-max Seat #3 is the button
Seat 1: sD+TKtt36XiiN6jqHiLwDA ($24.75 in chips) 
Seat 2: 9lvO/qyU+xrU95Teu1fv0g ($7.05 in chips) 
Seat 3: arxNSjreDRGFg13EAM2F1w ($30.40 in chips) 
Seat 5: cUxk0Jk4lrUQv9CJl0LPlg ($28.25 in chips) 
Seat 6: UvM6sxFT7el5hVDehvWvTA ($31.20 in chips) 
Seat 7: y7w8+Oqq4SkI1dkRDCx2Zg ($3.50 in chips) 
Seat 8: mUoFJKqCzIUABvOFbiINlQ ($14.25 in chips) 
Seat 9: HcU1ud5gMXGuhN1QChAhfQ ($24.75 in chips) 
cUxk0Jk4lrUQv9CJl0LPlg: posts small blind $0.10
UvM6sxFT7el5hVDehvWvTA: posts big blind $0.25
*** HOLE CARDS ***
y7w8+Oqq4SkI1dkRDCx2Zg: folds 
mUoFJKqCzIUABvOFbiINlQ: calls $0.25
HcU1ud5gMXGuhN1QChAhfQ: folds 
sD+TKtt36XiiN6jqHiLwDA: folds 
9lvO/qyU+xrU95Teu1fv0g: folds 
arxNSjreDRGFg13EAM2F1w: folds 
cUxk0Jk4lrUQv9CJl0LPlg: calls $0.15
UvM6sxFT7el5hVDehvWvTA: checks 
*** FLOP *** [9s 6d Ah]
ZyPfMsrS7T70lNdYA6rJ7w joins the table at seat #4 
cUxk0Jk4lrUQv9CJl0LPlg: checks 
UvM6sxFT7el5hVDehvWvTA: bets $0.50
mUoFJKqCzIUABvOFbiINlQ: raises $1.25 to $1.75
cUxk0Jk4lrUQv9CJl0LPlg: folds 
UvM6sxFT7el5hVDehvWvTA: folds 
Uncalled bet ($1.25) returned to mUoFJKqCzIUABvOFbiINlQ
mUoFJKqCzIUABvOFbiINlQ collected $1.70 from pot
mUoFJKqCzIUABvOFbiINlQ: doesn't show hand 
*** SUMMARY ***
Total pot $1.75 | Rake $0.05 
Board [9s 6d Ah]
Seat 1: sD+TKtt36XiiN6jqHiLwDA folded before Flop (didn't bet)
Seat 2: 9lvO/qyU+xrU95Teu1fv0g folded before Flop (didn't bet)
Seat 3: arxNSjreDRGFg13EAM2F1w (button) folded before Flop (didn't bet)
Seat 5: cUxk0Jk4lrUQv9CJl0LPlg (small blind) folded on the Flop
Seat 6: UvM6sxFT7el5hVDehvWvTA (big blind) folded on the Flop
Seat 7: y7w8+Oqq4SkI1dkRDCx2Zg folded before Flop (didn't bet)
Seat 8: mUoFJKqCzIUABvOFbiINlQ collected ($1.70)
Seat 9: HcU1ud5gMXGuhN1QChAhfQ folded before Flop (didn't bet)




PokerStars Game #59941851984:  Hold'em No Limit ($0.10/$0.25) - 2009/07/01 1:48:11 ET
Table 'b64Z+5XI1xkQzNfq4QHr3A' 6-max Seat #3 is the button
Seat 3: 7cx44/slbeTw+Cy7QB8Trg ($24.75 in chips) 
Seat 4: 564zqq2DUHXR3tdsOJU6JA ($19.65 in chips) 
Seat 5: JFIAqU8lCZ0vWwEl4bdGsg ($58.10 in chips) 
Seat 6: 8ClCHtFXGNplITm+63KB+Q ($33 in chips) 
564zqq2DUHXR3tdsOJU6JA: posts small blind $0.10
JFIAqU8lCZ0vWwEl4bdGsg: posts big blind $0.25
*** HOLE CARDS ***
8ClCHtFXGNplITm+63KB+Q: folds 
7cx44/slbeTw+Cy7QB8Trg: folds 
564zqq2DUHXR3tdsOJU6JA: calls $0.15
JFIAqU8lCZ0vWwEl4bdGsg: checks 
*** FLOP *** [Ac 3h 5s]
564zqq2DUHXR3tdsOJU6JA: bets $0.25
A6SjYLoKeIpFjPq0BK/2WA said, "r u ****ing serious"
A6SjYLoKeIpFjPq0BK/2WA has returned
JFIAqU8lCZ0vWwEl4bdGsg: folds 
Uncalled bet ($0.25) returned to 564zqq2DUHXR3tdsOJU6JA
564zqq2DUHXR3tdsOJU6JA collected $0.50 from pot
564zqq2DUHXR3tdsOJU6JA: doesn't show hand 
*** SUMMARY ***
Total pot $0.50 | Rake $0 
Board [Ac 3h 5s]
Seat 3: 7cx44/slbeTw+Cy7QB8Trg (button) folded before Flop (didn't bet)
Seat 4: 564zqq2DUHXR3tdsOJU6JA (small blind) collected ($0.50)
Seat 5: JFIAqU8lCZ0vWwEl4bdGsg (big blind) folded on the Flop
Seat 6: 8ClCHtFXGNplITm+63KB+Q folded before Flop (didn't bet)




PokerStars Game #59941851906:  Hold'em No Limit ($0.10/$0.25) - 2009/07/01 1:48:11 ET
Table 'LwnjzXstPtSrqrV/oDpnXQ' 9-max Seat #6 is the button
Seat 1: 9YN2IkT2JYYKFErZtZvCtA ($21.20 in chips) 
Seat 2: uLP/lYn7oKq9xCChBXsXxw ($26.65 in chips) 
Seat 3: 7je+LC5Mfs6nL8YBVh4frQ ($3.80 in chips) 
Seat 4: CmngQmkKTp8tkl6GMRTl6w ($8.75 in chips) 
Seat 5: Th3FldXKQW6hWVVPahaoOQ ($25.90 in chips) 
Seat 6: ljemhp25Zg+nlA9DLCIiUw ($39.50 in chips) 
Seat 7: c/Dw/6HyqldTzIRodAIZmg ($13.50 in chips) 
Seat 8: ShXPHWfjhfmAwLgDdm6bRQ ($13.30 in chips) 
Seat 9: q6WfTUAD9mowIP63ASq2Dgz/khFDKGihQjwgoiKKPOeg65 in chips) 
c/Dw/6HyqldTzIRodAIZmg: posts small blind $0.10
ShXPHWfjhfmAwLgDdm6bRQ: posts big blind $0.25
*** HOLE CARDS ***
q6WfTUAD9mowIP63ASq2Dgz/khFDKGihQjwgoiKKPOegs 
9YN2IkT2JYYKFErZtZvCtA: folds 
uLP/lYn7oKq9xCChBXsXxw: folds 
7je+LC5Mfs6nL8YBVh4frQ: folds 
CmngQmkKTp8tkl6GMRTl6w: folds 
Th3FldXKQW6hWVVPahaoOQ: raises $0.50 to $0.75
ljemhp25Zg+nlA9DLCIiUw: folds 
c/Dw/6HyqldTzIRodAIZmg: folds 
ShXPHWfjhfmAwLgDdm6bRQ: folds 
Uncalled bet ($0.50) returned to Th3FldXKQW6hWVVPahaoOQ
Th3FldXKQW6hWVVPahaoOQ collected $0.60 from pot
Th3FldXKQW6hWVVPahaoOQ: doesn't show hand 
*** SUMMARY ***
Total pot $0.60 | Rake $0 
Seat 1: 9YN2IkT2JYYKFErZtZvCtA folded before Flop (didn't bet)
Seat 2: uLP/lYn7oKq9xCChBXsXxw folded before Flop (didn't bet)
Seat 3: 7je+LC5Mfs6nL8YBVh4frQ folded before Flop (didn't bet)
Seat 4: CmngQmkKTp8tkl6GMRTl6w folded before Flop (didn't bet)
Seat 5: Th3FldXKQW6hWVVPahaoOQ collected ($0.60)
Seat 6: ljemhp25Zg+nlA9DLCIiUw (button) folded before Flop (didn't bet)
Seat 7: c/Dw/6HyqldTzIRodAIZmg (small blind) folded before Flop
Seat 8: ShXPHWfjhfmAwLgDdm6bRQ (big blind) folded before Flop
Seat 9: q6WfTUAD9mowIP63ASq2Dgz/khFDKGihQjwgoiKKPOegd before Flop (didn't bet)




PokerStars Game #59941851500:  Hold'em No Limit ($0.10/$0.25) - 2009/07/01 1:48:11 ET
Table 'U0hCzoS0KCJL+eoE054K4Q' 9-max Seat #3 is the button
Seat 1: XVEauYThJRhSTUAMxB/2ow ($37.20 in chips) 
Seat 2: MG90wfSJZnOejs/KD3vlQQ ($28.50 in chips) 
Seat 3: 8Cp1H3sSs8+jTTwLfeYKcw ($25.55 in chips) 
Seat 4: Bb42QRQMhg5/Y0vHP8/2Xw ($25 in chips) 
Seat 5: zgi+EUykT/pZQpoUG6+oEg ($6 in chips) 
Seat 6: V6p0jQ/RhUsqpHLmXvEX4Q ($11.90 in chips) 
Seat 7: uetHVityNsFnyX2bBnKe2A ($18.35 in chips) 
Seat 8: K0b5wNInj6hUGRr6yzKFtw ($27.45 in chips) 
Seat 9: wGigCmBR/9XWkPpvYos3aQ ($33.90 in chips) 
Bb42QRQMhg5/Y0vHP8/2Xw: posts small blind $0.10
zgi+EUykT/pZQpoUG6+oEg: posts big blind $0.25
*** HOLE CARDS ***
V6p0jQ/RhUsqpHLmXvEX4Q: folds 
uetHVityNsFnyX2bBnKe2A: folds 
K0b5wNInj6hUGRr6yzKFtw: folds 
wGigCmBR/9XWkPpvYos3aQ: raises $0.65 to $0.90
XVEauYThJRhSTUAMxB/2ow: folds 
MG90wfSJZnOejs/KD3vlQQ: folds 
8Cp1H3sSs8+jTTwLfeYKcw: folds 
Bb42QRQMhg5/Y0vHP8/2Xw: folds 
zgi+EUykT/pZQpoUG6+oEg: folds 
Uncalled bet ($0.65) returned to wGigCmBR/9XWkPpvYos3aQ
wGigCmBR/9XWkPpvYos3aQ collected $0.60 from pot
wGigCmBR/9XWkPpvYos3aQ: doesn't show hand 
*** SUMMARY ***
Total pot $0.60 | Rake $0 
Seat 1: XVEauYThJRhSTUAMxB/2ow folded before Flop (didn't bet)
Seat 2: MG90wfSJZnOejs/KD3vlQQ folded before Flop (didn't bet)
Seat 3: 8Cp1H3sSs8+jTTwLfeYKcw (button) folded before Flop (didn't bet)
Seat 4: Bb42QRQMhg5/Y0vHP8/2Xw (small blind) folded before Flop
Seat 5: zgi+EUykT/pZQpoUG6+oEg (big blind) folded before Flop
Seat 6: V6p0jQ/RhUsqpHLmXvEX4Q folded before Flop (didn't bet)
Seat 7: uetHVityNsFnyX2bBnKe2A folded before Flop (didn't bet)
Seat 8: K0b5wNInj6hUGRr6yzKFtw folded before Flop (didn't bet)
Seat 9: wGigCmBR/9XWkPpvYos3aQ collected ($0.60)




PokerStars Game #59941851960:  Hold'em No Limit ($0.10/$0.25) - 2009/07/01 1:48:11 ET
Table 'hfHe8uKeSJMyWAjSdM7ROQ' 6-max Seat #5 is the button
Seat 1: eHsmIvAb2JREg4O6hNPnXg ($44.90 in chips) 
Seat 2: QvTX2yGq3uKJiKPmns4TKQ ($29.55 in chips) 
Seat 3: oAzQdB2jFOH1NxFUPjYUGg ($21.50 in chips) 
Seat 4: b4wRQV3APH8irVk6bUFe2Q ($27.45 in chips) 
Seat 5: euswrBD1XG0Q5hB1iGJBKQ ($60.80 in chips) 
Seat 6: eL3+wCBjFGfQ5FMdIZihwA ($24.75 in chips) 
eL3+wCBjFGfQ5FMdIZihwA: posts small blind $0.10
eHsmIvAb2JREg4O6hNPnXg: posts big blind $0.25
*** HOLE CARDS ***
QvTX2yGq3uKJiKPmns4TKQ: folds 
oAzQdB2jFOH1NxFUPjYUGg: folds 
b4wRQV3APH8irVk6bUFe2Q: raises $0.75 to $1
euswrBD1XG0Q5hB1iGJBKQ: folds 
eL3+wCBjFGfQ5FMdIZihwA: folds 
eHsmIvAb2JREg4O6hNPnXg: folds 
Uncalled bet ($0.75) returned to b4wRQV3APH8irVk6bUFe2Q
b4wRQV3APH8irVk6bUFe2Q collected $0.60 from pot
*** SUMMARY ***
Total pot $0.60 | Rake $0 
Seat 1: eHsmIvAb2JREg4O6hNPnXg (big blind) folded before Flop
Seat 2: QvTX2yGq3uKJiKPmns4TKQ folded before Flop (didn't bet)
Seat 3: oAzQdB2jFOH1NxFUPjYUGg folded before Flop (didn't bet)
Seat 4: b4wRQV3APH8irVk6bUFe2Q collected ($0.60)
Seat 5: euswrBD1XG0Q5hB1iGJBKQ (button) folded before Flop (didn't bet)
Seat 6: eL3+wCBjFGfQ5FMdIZihwA (small blind) folded before Flop




PokerStars Game #59941851744:  Hold'em No Limit ($0.10/$0.25) - 2009/07/01 1:48:11 ET
Table 'isKy4XK8wJM0x735/D4hWA' 6-max Seat #1 is the button
Seat 1: kwsRmpZ1ZaLooISs+zfyKg ($24.40 in chips) 
Seat 2: 6elpmfyt4Zw0yvd8lePSMQ ($39 in chips) 
Seat 3: jp34e617tIzV8tKIWmfAbA ($26.05 in chips) 
Seat 4: DFi/Lzkjsfv8QswS80JX9Q ($31.45 in chips) 
Seat 5: lquriepNQBhDV5P1SWHhnA ($25.60 in chips) 
Seat 6: GbCVUNssQ7mqsPWr7J4d3w ($5 in chips) 
6elpmfyt4Zw0yvd8lePSMQ: posts small blind $0.10
jp34e617tIzV8tKIWmfAbA: posts big blind $0.25
*** HOLE CARDS ***
DFi/Lzkjsfv8QswS80JX9Q: raises $0.75 to $1
lquriepNQBhDV5P1SWHhnA: folds 
GbCVUNssQ7mqsPWr7J4d3w: folds 
kwsRmpZ1ZaLooISs+zfyKg: folds 
6elpmfyt4Zw0yvd8lePSMQ: folds 
jp34e617tIzV8tKIWmfAbA: folds 
Uncalled bet ($0.75) returned to DFi/Lzkjsfv8QswS80JX9Q
DFi/Lzkjsfv8QswS80JX9Q collected $0.60 from pot
DFi/Lzkjsfv8QswS80JX9Q: doesn't show hand 
*** SUMMARY ***
Total pot $0.60 | Rake $0 
Seat 1: kwsRmpZ1ZaLooISs+zfyKg (button) folded before Flop (didn't bet)
Seat 2: 6elpmfyt4Zw0yvd8lePSMQ (small blind) folded before Flop
Seat 3: jp34e617tIzV8tKIWmfAbA (big blind) folded before Flop
Seat 4: DFi/Lzkjsfv8QswS80JX9Q collected ($0.60)
Seat 5: lquriepNQBhDV5P1SWHhnA folded before Flop (didn't bet)
Seat 6: GbCVUNssQ7mqsPWr7J4d3w folded before Flop (didn't bet)




PokerStars Game #59941851540:  Hold'em No Limit ($0.10/$0.25) - 2009/07/01 1:48:11 ET
Table 'yAHDCs33TIgw3ra63xuU2Q' 9-max Seat #9 is the button
Seat 2: j4q3p0lesp63b1gZDwLBZw ($5 in chips) 
Seat 3: g6UPjSyxNLffCi+EqqIlEg ($20.30 in chips) 
Seat 4: j5spkbnOCRiLGiH6iqBaqw ($8.80 in chips) 
Seat 5: 4awUyiDYTgylQKXZ9faBVA ($38.35 in chips) 
Seat 6: DnDcAdn9P0zGovMERigpFA ($26.30 in chips) 
Seat 9: MtVtHDqIJTyUcXkRBBDIVA ($25 in chips) 
j4q3p0lesp63b1gZDwLBZw: posts small blind $0.10
g6UPjSyxNLffCi+EqqIlEg: posts big blind $0.25
*** HOLE CARDS ***
j5spkbnOCRiLGiH6iqBaqw: folds 
4awUyiDYTgylQKXZ9faBVA: folds 
DnDcAdn9P0zGovMERigpFA: folds 
MtVtHDqIJTyUcXkRBBDIVA: folds 
j4q3p0lesp63b1gZDwLBZw: folds 
Uncalled bet ($0.15) returned to g6UPjSyxNLffCi+EqqIlEg
g6UPjSyxNLffCi+EqqIlEg collected $0.20 from pot
g6UPjSyxNLffCi+EqqIlEg: doesn't show hand 
*** SUMMARY ***
Total pot $0.20 | Rake $0 
Seat 2: j4q3p0lesp63b1gZDwLBZw (small blind) folded before Flop
Seat 3: g6UPjSyxNLffCi+EqqIlEg (big blind) collected ($0.20)
Seat 4: j5spkbnOCRiLGiH6iqBaqw folded before Flop (didn't bet)
Seat 5: 4awUyiDYTgylQKXZ9faBVA folded before Flop (didn't bet)
Seat 6: DnDcAdn9P0zGovMERigpFA folded before Flop (didn't bet)
Seat 9: MtVtHDqIJTyUcXkRBBDIVA (button) folded before Flop (didn't bet)




PokerStars Game #59941851704:  Hold'em No Limit ($0.10/$0.25) - 2009/07/01 1:48:11 ET
Table 'v+LTGPWbrLum+Ggd4ef6lg' 9-max Seat #2 is the button
Seat 1: zUXhymECc2C9W9ZNw6qppA ($9.30 in chips) 
Seat 2: r/xYbgD9yVdKFWRgSQD/+Q ($11.20 in chips) 
Seat 3: 7ovWM9c1nQLTFritEGRG/A ($2.85 in chips) 
Seat 5: +8OkYWUhGfkDbAtQl/ovYQ ($22.90 in chips) 
Seat 7: kUxTO3D2eQcx4oJIpJAK4Q ($7.35 in chips) 
Seat 8: +sbyWwIcFp9kP0bDtMegfQ ($41.20 in chips) 
Seat 9: cZ99hugmLBj9KhTlc8nCSw ($25 in chips) 
7ovWM9c1nQLTFritEGRG/A: posts small blind $0.10
bXpVeaSTPBFSPJmeXxO7nw: is sitting out 
bXpVeaSTPBFSPJmeXxO7nw leaves the table
+8OkYWUhGfkDbAtQl/ovYQ: posts big blind $0.25
+qc/EYCgLC65SpGvr35eNg: sits out 
*** HOLE CARDS ***
kUxTO3D2eQcx4oJIpJAK4Q: folds 
yqkowiRWZ6NvRN9UUkYIlA joins the table at seat #4 
+sbyWwIcFp9kP0bDtMegfQ: folds 
cZ99hugmLBj9KhTlc8nCSw: folds 
zUXhymECc2C9W9ZNw6qppA: folds 
r/xYbgD9yVdKFWRgSQD/+Q: calls $0.25
7ovWM9c1nQLTFritEGRG/A: calls $0.15
+8OkYWUhGfkDbAtQl/ovYQ: checks 
*** FLOP *** [5d Ad 9c]
7ovWM9c1nQLTFritEGRG/A: checks 
+8OkYWUhGfkDbAtQl/ovYQ: bets $0.25
r/xYbgD9yVdKFWRgSQD/+Q: folds 
7ovWM9c1nQLTFritEGRG/A: folds 
Uncalled bet ($0.25) returned to +8OkYWUhGfkDbAtQl/ovYQ
+8OkYWUhGfkDbAtQl/ovYQ collected $0.75 from pot
+8OkYWUhGfkDbAtQl/ovYQ: doesn't show hand 
*** SUMMARY ***
Total pot $0.75 | Rake $0 
Board [5d Ad 9c]
Seat 1: zUXhymECc2C9W9ZNw6qppA folded before Flop (didn't bet)
Seat 2: r/xYbgD9yVdKFWRgSQD/+Q (button) folded on the Flop
Seat 3: 7ovWM9c1nQLTFritEGRG/A (small blind) folded on the Flop
Seat 5: +8OkYWUhGfkDbAtQl/ovYQ (big blind) collected ($0.75)
Seat 7: kUxTO3D2eQcx4oJIpJAK4Q folded before Flop (didn't bet)
Seat 8: +sbyWwIcFp9kP0bDtMegfQ folded before Flop (didn't bet)
Seat 9: cZ99hugmLBj9KhTlc8nCSw folded before Flop (didn't bet)




PokerStars Game #59941852472:  Hold'em No Limit ($0.10/$0.25) - 2009/07/01 1:48:12 ET
Table 'z2yOdY2zyGWG1gh9WV9XtQ' 9-max Seat #4 is the button
Seat 1: 8iyfEWL3auLDt9HEV3U5Vg ($24.75 in chips) 
Seat 3: X78b5v/uhqeXXoAijbw/yg ($26.90 in chips) 
Seat 4: Bb42QRQMhg5/Y0vHP8/2Xw ($25 in chips) 
Seat 6: NBYmTySMtIicyMj5Vjzqhw ($31.65 in chips) 
Seat 7: zDrucyjVn5aeekNEc3cJrA ($22 in chips) 
Seat 8: u+J1MTXS2qhNVMbsBemNLg ($5 in chips) 
Seat 9: wGigCmBR/9XWkPpvYos3aQ ($34.65 in chips) 
NBYmTySMtIicyMj5Vjzqhw: posts small blind $0.10
zDrucyjVn5aeekNEc3cJrA: posts big blind $0.25
/OxeiWKPcgcer/U4z8Kqxw joins the table at seat #2 
u+J1MTXS2qhNVMbsBemNLg: posts big blind $0.25
*** HOLE CARDS ***
u+J1MTXS2qhNVMbsBemNLg: checks 
wGigCmBR/9XWkPpvYos3aQ: folds 
8iyfEWL3auLDt9HEV3U5Vg: folds 
X78b5v/uhqeXXoAijbw/yg: folds 
4qA/3Ajg3pP6fqW+IX9/fQ joins the table at seat #5 
Bb42QRQMhg5/Y0vHP8/2Xw: folds 
NBYmTySMtIicyMj5Vjzqhw: calls $0.15
zDrucyjVn5aeekNEc3cJrA: checks 
*** FLOP *** [8h Kd 2h]
NBYmTySMtIicyMj5Vjzqhw: checks 
zDrucyjVn5aeekNEc3cJrA: checks 
u+J1MTXS2qhNVMbsBemNLg: checks 
*** TURN *** [8h Kd 2h] [Ac]
NBYmTySMtIicyMj5Vjzqhw: checks 
zDrucyjVn5aeekNEc3cJrA: checks 
u+J1MTXS2qhNVMbsBemNLg: checks 
*** RIVER *** [8h Kd 2h Ac] [As]
NBYmTySMtIicyMj5Vjzqhw: checks 
zDrucyjVn5aeekNEc3cJrA: checks 
u+J1MTXS2qhNVMbsBemNLg: bets $0.25
NBYmTySMtIicyMj5Vjzqhw: folds 
zDrucyjVn5aeekNEc3cJrA: calls $0.25
*** SHOW DOWN ***
u+J1MTXS2qhNVMbsBemNLg: shows [2d 9s] (two pair, Aces and Deuces)
zDrucyjVn5aeekNEc3cJrA: shows [7c Kc] (two pair, Aces and Kings)
zDrucyjVn5aeekNEc3cJrA collected $1.20 from pot
*** SUMMARY ***
Total pot $1.25 | Rake $0.05 
Board [8h Kd 2h Ac As]
Seat 1: 8iyfEWL3auLDt9HEV3U5Vg folded before Flop (didn't bet)
Seat 3: X78b5v/uhqeXXoAijbw/yg folded before Flop (didn't bet)
Seat 4: Bb42QRQMhg5/Y0vHP8/2Xw (button) folded before Flop (didn't bet)
Seat 6: NBYmTySMtIicyMj5Vjzqhw (small blind) folded on the River
Seat 7: zDrucyjVn5aeekNEc3cJrA (big blind) showed [7c Kc] and won ($1.20) with two pair, Aces and Kings
Seat 8: u+J1MTXS2qhNVMbsBemNLg showed [2d 9s] and lost with two pair, Aces and Deuces
Seat 9: wGigCmBR/9XWkPpvYos3aQ folded before Flop (didn't bet)




PokerStars Game #59941852372:  Hold'em No Limit ($0.10/$0.25) - 2009/07/01 1:48:12 ET
Table 'nyTW9cVtYentc5V7xU/0jA' 6-max Seat #1 is the button
Seat 1: HI20pVxSHPZ29u9IDkmICg ($12.15 in chips) 
Seat 2: v6mkGzCBCCXcgWQNSYVtKg ($8.30 in chips) 
Seat 3: kG34n23qFQA3nzdOJTQ1dA ($35.75 in chips) 
Seat 4: NkB3D4eVHHXvB9Edaugc1Q ($33.15 in chips) 
Seat 5: zZAcuQ0EvirdEuiIbeaocQ ($3.60 in chips) 
Seat 6: Cwf8Ho8JHNvwzsv9ah8uRQ ($19.40 in chips) 
v6mkGzCBCCXcgWQNSYVtKg: posts small blind $0.10
kG34n23qFQA3nzdOJTQ1dA: posts big blind $0.25
Cwf8Ho8JHNvwzsv9ah8uRQ: posts big blind $0.25
*** HOLE CARDS ***
NkB3D4eVHHXvB9Edaugc1Q: calls $0.25
zZAcuQ0EvirdEuiIbeaocQ: folds 
Cwf8Ho8JHNvwzsv9ah8uRQ: checks 
HI20pVxSHPZ29u9IDkmICg: raises $0.50 to $0.75
v6mkGzCBCCXcgWQNSYVtKg: folds 
kG34n23qFQA3nzdOJTQ1dA: folds 
NkB3D4eVHHXvB9Edaugc1Q: calls $0.50
Cwf8Ho8JHNvwzsv9ah8uRQ: folds 
*** FLOP *** [7h 8h 7s]
NkB3D4eVHHXvB9Edaugc1Q: bets $0.25
HI20pVxSHPZ29u9IDkmICg: raises $0.75 to $1
NkB3D4eVHHXvB9Edaugc1Q: calls $0.75
*** TURN *** [7h 8h 7s] [9d]
NkB3D4eVHHXvB9Edaugc1Q: checks 
HI20pVxSHPZ29u9IDkmICg: checks 
*** RIVER *** [7h 8h 7s 9d] [5s]
NkB3D4eVHHXvB9Edaugc1Q: bets $2.75
v6mkGzCBCCXcgWQNSYVtKg leaves the table
HI20pVxSHPZ29u9IDkmICg: folds 
Uncalled bet ($2.75) returned to NkB3D4eVHHXvB9Edaugc1Q
NkB3D4eVHHXvB9Edaugc1Q collected $3.90 from pot
NkB3D4eVHHXvB9Edaugc1Q: doesn't show hand 
*** SUMMARY ***
Total pot $4.10 | Rake $0.20 
Board [7h 8h 7s 9d 5s]
Seat 1: HI20pVxSHPZ29u9IDkmICg (button) folded on the River
Seat 2: v6mkGzCBCCXcgWQNSYVtKg (small blind) folded before Flop
Seat 3: kG34n23qFQA3nzdOJTQ1dA (big blind) folded before Flop
Seat 4: NkB3D4eVHHXvB9Edaugc1Q collected ($3.90)
Seat 5: zZAcuQ0EvirdEuiIbeaocQ folded before Flop (didn't bet)
Seat 6: Cwf8Ho8JHNvwzsv9ah8uRQ folded before Flop




PokerStars Game #59941852400:  Hold'em No Limit ($0.10/$0.25) - 2009/07/01 1:48:12 ET
Table '9o8Yb3JpUqurD4pNVmOikQ' 6-max Seat #5 is the button
Seat 1: SFmT9ZsVopnukjvAzrxTRg ($27.55 in chips) 
Seat 2: /gJNBeCkWL4o85/jvlZ4BA ($26.50 in chips) 
Seat 3: JgRqo1/2phbf7pab7N3BIQ ($23.50 in chips) 
Seat 4: j5NZbEJHsERuXjPHWqc1Nw ($10.35 in chips) 
Seat 5: QqiZLFrN8iOUT/GHw7ztOA ($23.80 in chips) 
Seat 6: LyDHtw3/yniNHW+DvLXbog ($25.45 in chips) 
LyDHtw3/yniNHW+DvLXbog: posts small blind $0.10
SFmT9ZsVopnukjvAzrxTRg: posts big blind $0.25
*** HOLE CARDS ***
/gJNBeCkWL4o85/jvlZ4BA: folds 
JgRqo1/2phbf7pab7N3BIQ: calls $0.25
j5NZbEJHsERuXjPHWqc1Nw: calls $0.25
QqiZLFrN8iOUT/GHw7ztOA: folds 
LyDHtw3/yniNHW+DvLXbog: folds 
SFmT9ZsVopnukjvAzrxTRg: raises $1.25 to $1.50
JgRqo1/2phbf7pab7N3BIQ: folds 
j5NZbEJHsERuXjPHWqc1Nw: folds 
Uncalled bet ($1.25) returned to SFmT9ZsVopnukjvAzrxTRg
SFmT9ZsVopnukjvAzrxTRg collected $0.85 from pot
SFmT9ZsVopnukjvAzrxTRg: doesn't show hand 
*** SUMMARY ***
Total pot $0.85 | Rake $0 
Seat 1: SFmT9ZsVopnukjvAzrxTRg (big blind) collected ($0.85)
Seat 2: /gJNBeCkWL4o85/jvlZ4BA folded before Flop (didn't bet)
Seat 3: JgRqo1/2phbf7pab7N3BIQ folded before Flop
Seat 4: j5NZbEJHsERuXjPHWqc1Nw folded before Flop
Seat 5: QqiZLFrN8iOUT/GHw7ztOA (button) folded before Flop (didn't bet)
Seat 6: LyDHtw3/yniNHW+DvLXbog (small blind) folded before Flop




PokerStars Game #59941852082:  Hold'em No Limit ($0.10/$0.25) - 2009/07/01 1:48:12 ET
Table 'APEHQjIcZHDZUA4iOjju2g' 6-max Seat #2 is the button
Seat 1: DE9hRlt14g+JdsRQ4wT7hg ($25 in chips) 
Seat 2: 3zD3qLXT1bEffAoWGnc7wg ($35.15 in chips) 
Seat 3: 3e/idKqDuPE10t6Zvr//SQ ($24.60 in chips) 
Seat 4: w2mQ4VsGljGwWXydz8tw2A ($35.85 in chips) 
Seat 5: /xN6gc9+8Hew0HxaB6VIVg ($45.50 in chips) 
Seat 6: KXtdqb+rIMkjc0RvHDksGQ ($35.25 in chips) 
3e/idKqDuPE10t6Zvr//SQ: posts small blind $0.10
w2mQ4VsGljGwWXydz8tw2A: posts big blind $0.25
*** HOLE CARDS ***
/xN6gc9+8Hew0HxaB6VIVg: folds 
KXtdqb+rIMkjc0RvHDksGQ: raises $0.75 to $1
DE9hRlt14g+JdsRQ4wT7hg: folds 
3zD3qLXT1bEffAoWGnc7wg: calls $1
3e/idKqDuPE10t6Zvr//SQ: calls $0.90
w2mQ4VsGljGwWXydz8tw2A: calls $0.75
*** FLOP *** [3h 3c Td]
3e/idKqDuPE10t6Zvr//SQ: checks 
w2mQ4VsGljGwWXydz8tw2A: checks 
KXtdqb+rIMkjc0RvHDksGQ: bets $2.50
3zD3qLXT1bEffAoWGnc7wg: folds 
3e/idKqDuPE10t6Zvr//SQ: calls $2.50
w2mQ4VsGljGwWXydz8tw2A: folds 
*** TURN *** [3h 3c Td] [Ad]
3e/idKqDuPE10t6Zvr//SQ: checks 
KXtdqb+rIMkjc0RvHDksGQ: checks 
*** RIVER *** [3h 3c Td Ad] [Qd]
3e/idKqDuPE10t6Zvr//SQ: bets $1
KXtdqb+rIMkjc0RvHDksGQ: calls $1
*** SHOW DOWN ***
3e/idKqDuPE10t6Zvr//SQ: shows [Kh Th] (two pair, Tens and Threes)
KXtdqb+rIMkjc0RvHDksGQ: shows [Ac Jh] (two pair, Aces and Threes)
KXtdqb+rIMkjc0RvHDksGQ collected $10.50 from pot
*** SUMMARY ***
Total pot $11 | Rake $0.50 
Board [3h 3c Td Ad Qd]
Seat 1: DE9hRlt14g+JdsRQ4wT7hg folded before Flop (didn't bet)
Seat 2: 3zD3qLXT1bEffAoWGnc7wg (button) folded on the Flop
Seat 3: 3e/idKqDuPE10t6Zvr//SQ (small blind) showed [Kh Th] and lost with two pair, Tens and Threes
Seat 4: w2mQ4VsGljGwWXydz8tw2A (big blind) folded on the Flop
Seat 5: /xN6gc9+8Hew0HxaB6VIVg folded before Flop (didn't bet)
Seat 6: KXtdqb+rIMkjc0RvHDksGQ showed [Ac Jh] and won ($10.50) with two pair, Aces and Threes




PokerStars Game #59941852096:  Hold'em No Limit ($0.10/$0.25) - 2009/07/01 1:48:12 ET
Table 'Do4nrTNDYpK3sQjwFxX+Og' 6-max Seat #1 is the button
Seat 1: 7JrQNOR9wRBxq9ijFhWieg ($37.65 in chips) 
Seat 2: tzMoGl9F0PUr5NibYueeSw ($67.45 in chips) 
Seat 3: TSmua8tGK3sTbwi0ynrW9Q ($26.75 in chips) 
Seat 4: cWc85bEzdRzpUMhRKm8pwQ ($33.05 in chips) 
Seat 6: lBoEwOFgzcERLIRUkUoRTw ($23.20 in chips) 
tzMoGl9F0PUr5NibYueeSw: posts small blind $0.10
TSmua8tGK3sTbwi0ynrW9Q: posts big blind $0.25
aogAb4Eienxztk8p2v9VVw: sits out 
*** HOLE CARDS ***
cWc85bEzdRzpUMhRKm8pwQ: folds 
lBoEwOFgzcERLIRUkUoRTw: folds 
7JrQNOR9wRBxq9ijFhWieg: raises $0.50 to $0.75
aogAb4Eienxztk8p2v9VVw leaves the table
tzMoGl9F0PUr5NibYueeSw: calls $0.65
TSmua8tGK3sTbwi0ynrW9Q: folds 
*** FLOP *** [5c Qd Ac]
SxIIgwXYLkwd6m3wLyPTCw joins the table at seat #5 
tzMoGl9F0PUr5NibYueeSw: bets $1
7JrQNOR9wRBxq9ijFhWieg: folds 
Uncalled bet ($1) returned to tzMoGl9F0PUr5NibYueeSw
tzMoGl9F0PUr5NibYueeSw collected $1.70 from pot
tzMoGl9F0PUr5NibYueeSw: doesn't show hand 
*** SUMMARY ***
Total pot $1.75 | Rake $0.05 
Board [5c Qd Ac]
Seat 1: 7JrQNOR9wRBxq9ijFhWieg (button) folded on the Flop
Seat 2: tzMoGl9F0PUr5NibYueeSw (small blind) collected ($1.70)
Seat 3: TSmua8tGK3sTbwi0ynrW9Q (big blind) folded before Flop
Seat 4: cWc85bEzdRzpUMhRKm8pwQ folded before Flop (didn't bet)
Seat 6: lBoEwOFgzcERLIRUkUoRTw folded before Flop (didn't bet)




PokerStars Game #59941852526:  Hold'em No Limit ($0.10/$0.25) - 2009/07/01 1:48:12 ET
Table '2clPgY3+dETPD/8zjXZdFw' 6-max Seat #5 is the button
Seat 1: 7cx44/slbeTw+Cy7QB8Trg ($24.75 in chips) 
Seat 2: cWc85bEzdRzpUMhRKm8pwQ ($25.30 in chips) 
Seat 3: FL1UWpN6oReBdznWDOy9Gg ($15.95 in chips) 
Seat 4: ljjhtb6FVPTx9AT9HNdtqg ($24.75 in chips) 
Seat 5: LJI7A1YgDM7hgh7o56+ReQ ($29.55 in chips) 
AnnaskyII was removed from the table for failing to post
7cx44/slbeTw+Cy7QB8Trg: posts small blind $0.10
cWc85bEzdRzpUMhRKm8pwQ: posts big blind $0.25
*** HOLE CARDS ***
FL1UWpN6oReBdznWDOy9Gg: folds 
ljjhtb6FVPTx9AT9HNdtqg: raises $0.50 to $0.75
c3J/KYZ4cNsUEuz8v57I5A joins the table at seat #6 
LJI7A1YgDM7hgh7o56+ReQ: folds 
7cx44/slbeTw+Cy7QB8Trg: folds 
cWc85bEzdRzpUMhRKm8pwQ: folds 
Uncalled bet ($0.50) returned to ljjhtb6FVPTx9AT9HNdtqg
ljjhtb6FVPTx9AT9HNdtqg collected $0.60 from pot
*** SUMMARY ***
Total pot $0.60 | Rake $0 
Seat 1: 7cx44/slbeTw+Cy7QB8Trg (small blind) folded before Flop
Seat 2: cWc85bEzdRzpUMhRKm8pwQ (big blind) folded before Flop
Seat 3: FL1UWpN6oReBdznWDOy9Gg folded before Flop (didn't bet)
Seat 4: ljjhtb6FVPTx9AT9HNdtqg collected ($0.60)
Seat 5: LJI7A1YgDM7hgh7o56+ReQ (button) folded before Flop (didn't bet)




PokerStars Game #59941853050:  Hold'em No Limit ($0.10/$0.25) - 2009/07/01 1:48:13 ET
Table 'wixGE3Zge1qBdnpWijIl/w' 9-max Seat #8 is the button
Seat 1: 4GJMmHGKzu+gVtalqRy7dA ($27.20 in chips) 
Seat 2: DnDcAdn9P0zGovMERigpFA ($77.60 in chips) 
Seat 3: Bb42QRQMhg5/Y0vHP8/2Xw ($25 in chips) 
Seat 5: H5Se03ZqSX7tbULXur2MAg ($22.70 in chips) 
Seat 6: AP/rNvbsacTb4XtaAgKPiQ ($15.45 in chips) 
Seat 7: mMd8CDS/but3UC+Zp7Up2w ($20.70 in chips) 
Seat 8: ShCS62CJp4MKfKLKvGKQbA ($14.80 in chips) 
Seat 9: r6hsffOo1iKmaPYKwAZmFw ($28.90 in chips) 
r6hsffOo1iKmaPYKwAZmFw: posts small blind $0.10
4GJMmHGKzu+gVtalqRy7dA: posts big blind $0.25
X6+pSIPfovPcE87t+LmUKQ: sits out 
*** HOLE CARDS ***
DnDcAdn9P0zGovMERigpFA: folds 
Bb42QRQMhg5/Y0vHP8/2Xw: folds 
H5Se03ZqSX7tbULXur2MAg: raises $0.50 to $0.75
AP/rNvbsacTb4XtaAgKPiQ: folds 
mMd8CDS/but3UC+Zp7Up2w: folds 
ShCS62CJp4MKfKLKvGKQbA: folds 
r6hsffOo1iKmaPYKwAZmFw: folds 
4GJMmHGKzu+gVtalqRy7dA: folds 
Uncalled bet ($0.50) returned to H5Se03ZqSX7tbULXur2MAg
H5Se03ZqSX7tbULXur2MAg collected $0.60 from pot
*** SUMMARY ***
Total pot $0.60 | Rake $0 
Seat 1: 4GJMmHGKzu+gVtalqRy7dA (big blind) folded before Flop
Seat 2: DnDcAdn9P0zGovMERigpFA folded before Flop (didn't bet)
Seat 3: Bb42QRQMhg5/Y0vHP8/2Xw folded before Flop (didn't bet)
Seat 5: H5Se03ZqSX7tbULXur2MAg collected ($0.60)
Seat 6: AP/rNvbsacTb4XtaAgKPiQ folded before Flop (didn't bet)
Seat 7: mMd8CDS/but3UC+Zp7Up2w folded before Flop (didn't bet)
Seat 8: ShCS62CJp4MKfKLKvGKQbA (button) folded before Flop (didn't bet)
Seat 9: r6hsffOo1iKmaPYKwAZmFw (small blind) folded before Flop




PokerStars Game #59941852852:  Hold'em No Limit ($0.10/$0.25) - 2009/07/01 1:48:13 ET
Table 'x7YStLKc8hpt/pTgSetPKA' 9-max Seat #5 is the button
Seat 1: tYsOBqdU1+x+yFI7zHO7hQ ($25.90 in chips) 
Seat 3: S7Ki0P+0AIGPuIfGJjW0gg ($10.60 in chips) 
Seat 4: ydoFOVgzvZv9ZhuWu9rXAw ($4.80 in chips) 
Seat 5: tLcDklc2rBORNfixyRfVfw ($25 in chips) 
Seat 6: 9YN2IkT2JYYKFErZtZvCtA ($49.35 in chips) 
Seat 7: dtZ84flFEi4Q+SGrHMJRDQ ($26 in chips) 
Seat 8: j4q3p0lesp63b1gZDwLBZw ($5 in chips) 
Seat 9: nm4Dj/f+jJEwKVsUnKh73g ($37.20 in chips) 
9YN2IkT2JYYKFErZtZvCtA: posts small blind $0.10
dtZ84flFEi4Q+SGrHMJRDQ: posts big blind $0.25
*** HOLE CARDS ***
j4q3p0lesp63b1gZDwLBZw: raises $0.75 to $1
nm4Dj/f+jJEwKVsUnKh73g: folds 
tYsOBqdU1+x+yFI7zHO7hQ: folds 
S7Ki0P+0AIGPuIfGJjW0gg: folds 
ydoFOVgzvZv9ZhuWu9rXAw: folds 
tLcDklc2rBORNfixyRfVfw: folds 
9YN2IkT2JYYKFErZtZvCtA: folds 
dtZ84flFEi4Q+SGrHMJRDQ: calls $0.75
*** FLOP *** [6s 5c Qc]
dtZ84flFEi4Q+SGrHMJRDQ: checks 
j4q3p0lesp63b1gZDwLBZw: bets $1.75
dtZ84flFEi4Q+SGrHMJRDQ: folds 
Uncalled bet ($1.75) returned to j4q3p0lesp63b1gZDwLBZw
j4q3p0lesp63b1gZDwLBZw collected $2 from pot
j4q3p0lesp63b1gZDwLBZw: doesn't show hand 
*** SUMMARY ***
Total pot $2.10 | Rake $0.10 
Board [6s 5c Qc]
Seat 1: tYsOBqdU1+x+yFI7zHO7hQ folded before Flop (didn't bet)
Seat 3: S7Ki0P+0AIGPuIfGJjW0gg folded before Flop (didn't bet)
Seat 4: ydoFOVgzvZv9ZhuWu9rXAw folded before Flop (didn't bet)
Seat 5: tLcDklc2rBORNfixyRfVfw (button) folded before Flop (didn't bet)
Seat 6: 9YN2IkT2JYYKFErZtZvCtA (small blind) folded before Flop
Seat 7: dtZ84flFEi4Q+SGrHMJRDQ (big blind) folded on the Flop
Seat 8: j4q3p0lesp63b1gZDwLBZw collected ($2)
Seat 9: nm4Dj/f+jJEwKVsUnKh73g folded before Flop (didn't bet)




PokerStars Game #59941853054:  Hold'em No Limit ($0.10/$0.25) - 2009/07/01 1:48:13 ET
Table 'srBTB98reCdD1TffxE6o7g' 6-max Seat #1 is the button
Seat 1: SFmT9ZsVopnukjvAzrxTRg ($36.90 in chips) 
Seat 2: mfrkWA3PTeYPkbO6hi98Aw ($25.10 in chips) 
Seat 4: 6DwBRH+xZ12AAZmeAg+aXw ($16.20 in chips) 
Seat 5: K1zv48sQUGQiaLk5VWWDqw ($24.75 in chips) 
Seat 6: BV+K0Phf5VBHr7aZPKqbUQ ($31.60 in chips) 
mfrkWA3PTeYPkbO6hi98Aw: posts small blind $0.10
6DwBRH+xZ12AAZmeAg+aXw: posts big blind $0.25
*** HOLE CARDS ***
K1zv48sQUGQiaLk5VWWDqw: raises $0.50 to $0.75
BV+K0Phf5VBHr7aZPKqbUQ: folds 
SFmT9ZsVopnukjvAzrxTRg: folds 
mfrkWA3PTeYPkbO6hi98Aw: folds 
6DwBRH+xZ12AAZmeAg+aXw: folds 
Uncalled bet ($0.50) returned to K1zv48sQUGQiaLk5VWWDqw
K1zv48sQUGQiaLk5VWWDqw collected $0.60 from pot
K1zv48sQUGQiaLk5VWWDqw: doesn't show hand 
*** SUMMARY ***
Total pot $0.60 | Rake $0 
Seat 1: SFmT9ZsVopnukjvAzrxTRg (button) folded before Flop (didn't bet)
Seat 2: mfrkWA3PTeYPkbO6hi98Aw (small blind) folded before Flop
Seat 4: 6DwBRH+xZ12AAZmeAg+aXw (big blind) folded before Flop
Seat 5: K1zv48sQUGQiaLk5VWWDqw collected ($0.60)
Seat 6: BV+K0Phf5VBHr7aZPKqbUQ folded before Flop (didn't bet)




PokerStars Game #59941852732:  Hold'em No Limit ($0.10/$0.25) - 2009/07/01 1:48:13 ET
Table '63h13e5p7cWe02rClZ1CHw' 6-max Seat #2 is the button
Seat 1: pokjbbEcXXPlADXdSGHtZw ($21.70 in chips) 
Seat 2: k9nHZTHt8hYhYRcW8NTb4g ($23.90 in chips) 
Seat 3: mFv3iBCtrw9XfCDRB0d46Q ($4.40 in chips) 
Seat 4: xrf8tAXKQHG99HixCot1Iw ($28.35 in chips) 
Seat 5: iyZxqznXjv3vtvOJymkoLQ ($44.45 in chips) 
Seat 6: mfrkWA3PTeYPkbO6hi98Aw ($39.05 in chips) 
mFv3iBCtrw9XfCDRB0d46Q: posts small blind $0.10
xrf8tAXKQHG99HixCot1Iw: posts big blind $0.25
*** HOLE CARDS ***
iyZxqznXjv3vtvOJymkoLQ: folds 
mfrkWA3PTeYPkbO6hi98Aw: folds 
pokjbbEcXXPlADXdSGHtZw: folds 
k9nHZTHt8hYhYRcW8NTb4g: raises $0.50 to $0.75
mFv3iBCtrw9XfCDRB0d46Q: folds 
xrf8tAXKQHG99HixCot1Iw: folds 
Uncalled bet ($0.50) returned to k9nHZTHt8hYhYRcW8NTb4g
k9nHZTHt8hYhYRcW8NTb4g collected $0.60 from pot
k9nHZTHt8hYhYRcW8NTb4g: doesn't show hand 
*** SUMMARY ***
Total pot $0.60 | Rake $0 
Seat 1: pokjbbEcXXPlADXdSGHtZw folded before Flop (didn't bet)
Seat 2: k9nHZTHt8hYhYRcW8NTb4g (button) collected ($0.60)
Seat 3: mFv3iBCtrw9XfCDRB0d46Q (small blind) folded before Flop
Seat 4: xrf8tAXKQHG99HixCot1Iw (big blind) folded before Flop
Seat 5: iyZxqznXjv3vtvOJymkoLQ folded before Flop (didn't bet)
Seat 6: mfrkWA3PTeYPkbO6hi98Aw folded before Flop (didn't bet)




PokerStars Game #59941853026:  Hold'em No Limit ($0.10/$0.25) - 2009/07/01 1:48:13 ET
Table 'Loy/olZ5qoDOSvX4UTujGg' 6-max Seat #4 is the button
Seat 1: HipgaJhkN4ie/tTw4dK3Ug ($9.05 in chips) 
Seat 2: 4z7mPbMLNp4TezHXin63Vw ($15.30 in chips) 
Seat 3: 32YL2ZEp8NT4JB2RVM9euQ ($15.35 in chips) 
Seat 4: /gJNBeCkWL4o85/jvlZ4BA ($30.75 in chips) 
Seat 5: Ar4vsUIUfJ7gbYh1c1m59g ($19 in chips) 
Seat 6: qGHGf/553gQnDoklMRe3tg ($25.15 in chips) 
Ar4vsUIUfJ7gbYh1c1m59g: posts small blind $0.10
qGHGf/553gQnDoklMRe3tg: posts big blind $0.25
*** HOLE CARDS ***
HipgaJhkN4ie/tTw4dK3Ug: raises $0.50 to $0.75
4z7mPbMLNp4TezHXin63Vw: folds 
32YL2ZEp8NT4JB2RVM9euQ: folds 
/gJNBeCkWL4o85/jvlZ4BA: folds 
Ar4vsUIUfJ7gbYh1c1m59g: folds 
qGHGf/553gQnDoklMRe3tg: folds 
Uncalled bet ($0.50) returned to HipgaJhkN4ie/tTw4dK3Ug
HipgaJhkN4ie/tTw4dK3Ug collected $0.60 from pot
HipgaJhkN4ie/tTw4dK3Ug: shows [Jc Jd] (a pair of Jacks)
*** SUMMARY ***
Total pot $0.60 | Rake $0 
Seat 1: HipgaJhkN4ie/tTw4dK3Ug collected ($0.60)
Seat 2: 4z7mPbMLNp4TezHXin63Vw folded before Flop (didn't bet)
Seat 3: 32YL2ZEp8NT4JB2RVM9euQ folded before Flop (didn't bet)
Seat 4: /gJNBeCkWL4o85/jvlZ4BA (button) folded before Flop (didn't bet)
Seat 5: Ar4vsUIUfJ7gbYh1c1m59g (small blind) folded before Flop
Seat 6: qGHGf/553gQnDoklMRe3tg (big blind) folded before Flop




PokerStars Game #59941853112:  Hold'em No Limit ($0.10/$0.25) - 2009/07/01 1:48:14 ET
Table 'Dun24l/X8kjpUHWBhkVOFw' 6-max Seat #4 is the button
Seat 1: u3Ol7kv1LmvszuHNm9rc6w ($22.40 in chips) 
Seat 2: 6hUmfDYq+83kvxWoTBQmfw ($30.40 in chips) 
Seat 3: +E5iJKkKVfaTgTqzuXXv0g ($13.15 in chips) 
Seat 4: 7/ROHX4tuLekJ2diYIlMkw ($3.05 in chips) 
Seat 5: KYBwVA7jgmSrbIEbEGElVg ($22.55 in chips) 
Seat 6: xrf8tAXKQHG99HixCot1Iw ($24.80 in chips) 
KYBwVA7jgmSrbIEbEGElVg: posts small blind $0.10
xrf8tAXKQHG99HixCot1Iw: posts big blind $0.25
*** HOLE CARDS ***
u3Ol7kv1LmvszuHNm9rc6w: folds 
6hUmfDYq+83kvxWoTBQmfw: calls $0.25
+E5iJKkKVfaTgTqzuXXv0g: folds 
7/ROHX4tuLekJ2diYIlMkw: folds 
KYBwVA7jgmSrbIEbEGElVg: calls $0.15
xrf8tAXKQHG99HixCot1Iw: checks 
*** FLOP *** [Kc 7h Ac]
KYBwVA7jgmSrbIEbEGElVg: checks 
xrf8tAXKQHG99HixCot1Iw: checks 
6hUmfDYq+83kvxWoTBQmfw: bets $1
KYBwVA7jgmSrbIEbEGElVg: folds 
xrf8tAXKQHG99HixCot1Iw: folds 
Uncalled bet ($1) returned to 6hUmfDYq+83kvxWoTBQmfw
6hUmfDYq+83kvxWoTBQmfw collected $0.75 from pot
*** SUMMARY ***
Total pot $0.75 | Rake $0 
Board [Kc 7h Ac]
Seat 1: u3Ol7kv1LmvszuHNm9rc6w folded before Flop (didn't bet)
Seat 2: 6hUmfDYq+83kvxWoTBQmfw collected ($0.75)
Seat 3: +E5iJKkKVfaTgTqzuXXv0g folded before Flop (didn't bet)
Seat 4: 7/ROHX4tuLekJ2diYIlMkw (button) folded before Flop (didn't bet)
Seat 5: KYBwVA7jgmSrbIEbEGElVg (small blind) folded on the Flop
Seat 6: xrf8tAXKQHG99HixCot1Iw (big blind) folded on the Flop




PokerStars Game #59941853366:  Hold'em No Limit ($0.10/$0.25) - 2009/07/01 1:48:14 ET
Table 'jItkp2PNTbH9Cf7gqsAF7g' 9-max Seat #8 is the button
Seat 1: wGigCmBR/9XWkPpvYos3aQ ($26.85 in chips) 
Seat 2: qwr38jl5txoR36M7G5qi4A ($7.95 in chips) 
Seat 3: 0YaJElQVLqWThIZnqq3w1g ($12.10 in chips) 
Seat 4: oJOvZw/Iayou0f0k6dkBhg ($3.85 in chips) 
Seat 5: NO6qGDOw12lhu3zh1xW3Bg ($20.65 in chips) 
Seat 6: cZ99hugmLBj9KhTlc8nCSw ($54 in chips) 
Seat 8: cq6LACCDFivk2+PeoiB2sw ($8.05 in chips) 
Seat 9: dtZ84flFEi4Q+SGrHMJRDQ ($25 in chips) 
dtZ84flFEi4Q+SGrHMJRDQ: posts small blind $0.10
wGigCmBR/9XWkPpvYos3aQ: posts big blind $0.25
*** HOLE CARDS ***
qwr38jl5txoR36M7G5qi4A: folds 
0YaJElQVLqWThIZnqq3w1g: calls $0.25
oJOvZw/Iayou0f0k6dkBhg: calls $0.25
NO6qGDOw12lhu3zh1xW3Bg: calls $0.25
cZ99hugmLBj9KhTlc8nCSw: folds 
cq6LACCDFivk2+PeoiB2sw: folds 
dtZ84flFEi4Q+SGrHMJRDQ: folds 
wGigCmBR/9XWkPpvYos3aQ: checks 
*** FLOP *** [Kd 6h Qh]
wGigCmBR/9XWkPpvYos3aQ: checks 
0YaJElQVLqWThIZnqq3w1g: checks 
oJOvZw/Iayou0f0k6dkBhg: checks 
NO6qGDOw12lhu3zh1xW3Bg: bets $1
wGigCmBR/9XWkPpvYos3aQ: folds 
0YaJElQVLqWThIZnqq3w1g: folds 
oJOvZw/Iayou0f0k6dkBhg: calls $1
*** TURN *** [Kd 6h Qh] [Qs]
oJOvZw/Iayou0f0k6dkBhg: bets $2.60 and is all-in
NO6qGDOw12lhu3zh1xW3Bg: folds 
Uncalled bet ($2.60) returned to oJOvZw/Iayou0f0k6dkBhg
oJOvZw/Iayou0f0k6dkBhg collected $2.95 from pot
*** SUMMARY ***
Total pot $3.10 | Rake $0.15 
Board [Kd 6h Qh Qs]
Seat 1: wGigCmBR/9XWkPpvYos3aQ (big blind) folded on the Flop
Seat 2: qwr38jl5txoR36M7G5qi4A folded before Flop (didn't bet)
Seat 3: 0YaJElQVLqWThIZnqq3w1g folded on the Flop
Seat 4: oJOvZw/Iayou0f0k6dkBhg collected ($2.95)
Seat 5: NO6qGDOw12lhu3zh1xW3Bg folded on the Turn
Seat 6: cZ99hugmLBj9KhTlc8nCSw folded before Flop (didn't bet)
Seat 8: cq6LACCDFivk2+PeoiB2sw (button) folded before Flop (didn't bet)
Seat 9: dtZ84flFEi4Q+SGrHMJRDQ (small blind) folded before Flop




PokerStars Game #59941853556:  Hold'em No Limit ($0.10/$0.25) - 2009/07/01 1:48:14 ET
Table 'BmUMTVcNATeov2rAGYU0Qg' 9-max Seat #5 is the button
Seat 1: QEbIGci+itdw+re8RM5fZA ($33.60 in chips) 
Seat 2: jJnMGXoBXye+afMd0k0rUw ($11.65 in chips) 
Seat 3: ir5Jy8ck6DrdqgJ/3chcWw ($10.40 in chips) 
Seat 4: aNpwfA31EREwO+ar4XzBCw ($37.35 in chips) 
Seat 5: QBNcj9fHxkh/+s/oVw+JmQ ($24 in chips) 
Seat 6: w1ukf8uPa4+WH561TtVRxA ($25 in chips) 
Seat 7: CmngQmkKTp8tkl6GMRTl6w ($8.50 in chips) 
Seat 8: Jve2LRs9vtGL7NdiNeXY/A ($15 in chips) 
Seat 9: /artgaAtyUtUtD8FZo6puA ($9.10 in chips) 
w1ukf8uPa4+WH561TtVRxA: posts small blind $0.10
CmngQmkKTp8tkl6GMRTl6w: posts big blind $0.25
Jve2LRs9vtGL7NdiNeXY/A: posts big blind $0.25
*** HOLE CARDS ***
Jve2LRs9vtGL7NdiNeXY/A: checks 
/artgaAtyUtUtD8FZo6puA: folds 
QEbIGci+itdw+re8RM5fZA: folds 
jJnMGXoBXye+afMd0k0rUw: folds 
ir5Jy8ck6DrdqgJ/3chcWw: folds 
aNpwfA31EREwO+ar4XzBCw: folds 
QBNcj9fHxkh/+s/oVw+JmQ: folds 
w1ukf8uPa4+WH561TtVRxA: folds 
CmngQmkKTp8tkl6GMRTl6w: checks 
*** FLOP *** [Ts Td 6s]
CmngQmkKTp8tkl6GMRTl6w: checks 
Jve2LRs9vtGL7NdiNeXY/A: bets $0.50
CmngQmkKTp8tkl6GMRTl6w: calls $0.50
*** TURN *** [Ts Td 6s] [6c]
CmngQmkKTp8tkl6GMRTl6w: checks 
Jve2LRs9vtGL7NdiNeXY/A: bets $0.25
CmngQmkKTp8tkl6GMRTl6w: raises $0.75 to $1
Jve2LRs9vtGL7NdiNeXY/A: calls $0.75
*** RIVER *** [Ts Td 6s 6c] [3h]
CmngQmkKTp8tkl6GMRTl6w: bets $2.50
Jve2LRs9vtGL7NdiNeXY/A: folds 
Uncalled bet ($2.50) returned to CmngQmkKTp8tkl6GMRTl6w
CmngQmkKTp8tkl6GMRTl6w collected $3.45 from pot
CmngQmkKTp8tkl6GMRTl6w: doesn't show hand 
*** SUMMARY ***
Total pot $3.60 | Rake $0.15 
Board [Ts Td 6s 6c 3h]
Seat 1: QEbIGci+itdw+re8RM5fZA folded before Flop (didn't bet)
Seat 2: jJnMGXoBXye+afMd0k0rUw folded before Flop (didn't bet)
Seat 3: ir5Jy8ck6DrdqgJ/3chcWw folded before Flop (didn't bet)
Seat 4: aNpwfA31EREwO+ar4XzBCw folded before Flop (didn't bet)
Seat 5: QBNcj9fHxkh/+s/oVw+JmQ (button) folded before Flop (didn't bet)
Seat 6: w1ukf8uPa4+WH561TtVRxA (small blind) folded before Flop
Seat 7: CmngQmkKTp8tkl6GMRTl6w (big blind) collected ($3.45)
Seat 8: Jve2LRs9vtGL7NdiNeXY/A folded on the River
Seat 9: /artgaAtyUtUtD8FZo6puA folded before Flop (didn't bet)




PokerStars Game #59941853142:  Hold'em No Limit ($0.10/$0.25) - 2009/07/01 1:48:14 ET
Table '0mmHveGuaIfIMQlNE1eqMg' 9-max Seat #1 is the button
Seat 1: ydoFOVgzvZv9ZhuWu9rXAw ($4.90 in chips) 
Seat 2: rQhYIYXSyH/IivYM1dlV5A ($68.60 in chips) 
Seat 3: ghNKXUBl/H+t83JF079ZBA ($25 in chips) 
Seat 4: DnDcAdn9P0zGovMERigpFA ($36.10 in chips) 
Seat 5: Pt637jKksB5MzP0UNJAAkw ($3.45 in chips) 
Seat 6: 6RiVTYll/5D8zICp0MRpKw ($23.70 in chips) 
Seat 7: 5n7e7I+px7c6CQmLpPbtsg ($11.30 in chips) 
Seat 8: 0XACOSNrAWmqNv9k1nF8rw ($14.65 in chips) 
Seat 9: UNw/UrAelsQeSS17Rro/BA ($10.90 in chips) 
rQhYIYXSyH/IivYM1dlV5A: posts small blind $0.10
ghNKXUBl/H+t83JF079ZBA: posts big blind $0.25
*** HOLE CARDS ***
DnDcAdn9P0zGovMERigpFA: raises $0.75 to $1
Pt637jKksB5MzP0UNJAAkw: folds 
6RiVTYll/5D8zICp0MRpKw: folds 
5n7e7I+px7c6CQmLpPbtsg: folds 
0XACOSNrAWmqNv9k1nF8rw: folds 
UNw/UrAelsQeSS17Rro/BA: folds 
ydoFOVgzvZv9ZhuWu9rXAw: folds 
rQhYIYXSyH/IivYM1dlV5A: folds 
ghNKXUBl/H+t83JF079ZBA: folds 
Uncalled bet ($0.75) returned to DnDcAdn9P0zGovMERigpFA
DnDcAdn9P0zGovMERigpFA collected $0.60 from pot
DnDcAdn9P0zGovMERigpFA: doesn't show hand 
*** SUMMARY ***
Total pot $0.60 | Rake $0 
Seat 1: ydoFOVgzvZv9ZhuWu9rXAw (button) folded before Flop (didn't bet)
Seat 2: rQhYIYXSyH/IivYM1dlV5A (small blind) folded before Flop
Seat 3: ghNKXUBl/H+t83JF079ZBA (big blind) folded before Flop
Seat 4: DnDcAdn9P0zGovMERigpFA collected ($0.60)
Seat 5: Pt637jKksB5MzP0UNJAAkw folded before Flop (didn't bet)
Seat 6: 6RiVTYll/5D8zICp0MRpKw folded before Flop (didn't bet)
Seat 7: 5n7e7I+px7c6CQmLpPbtsg folded before Flop (didn't bet)
Seat 8: 0XACOSNrAWmqNv9k1nF8rw folded before Flop (didn't bet)
Seat 9: UNw/UrAelsQeSS17Rro/BA folded before Flop (didn't bet)




PokerStars Game #59941853694:  Hold'em No Limit ($0.10/$0.25) - 2009/07/01 1:48:15 ET
Table '1zj0+miaIL9cvwnT/50pOA' 9-max Seat #6 is the button
Seat 1: PVxvfRTRvkgZf9WtquEkwQ ($25 in chips) 
Seat 2: HPEB+AtKw1+C/cxU0o1ciw ($42.95 in chips) 
Seat 3: dtZ84flFEi4Q+SGrHMJRDQ ($29.35 in chips) 
Seat 4: PdIasPkzm2sqZnN41ZRXOg ($5 in chips) 
Seat 5: 57qrNGHDvf6GhB8zVLsAtQ ($8.05 in chips) 
Seat 6: YZaC69gFrepA6oCGtu7E0w ($29.20 in chips) 
Seat 7: 6RiVTYll/5D8zICp0MRpKw ($29.10 in chips) 
Seat 8: Ihhh49x48fayPIyvl2Rsmg ($35.10 in chips) 
Seat 9: AyqFvLFzJDE7yMbXP362BA ($19.30 in chips) 
6RiVTYll/5D8zICp0MRpKw: posts small blind $0.10
Ihhh49x48fayPIyvl2Rsmg: posts big blind $0.25
*** HOLE CARDS ***
AyqFvLFzJDE7yMbXP362BA: folds 
PVxvfRTRvkgZf9WtquEkwQ: folds 
HPEB+AtKw1+C/cxU0o1ciw: folds 
dtZ84flFEi4Q+SGrHMJRDQ: folds 
PdIasPkzm2sqZnN41ZRXOg: raises $1 to $1.25
57qrNGHDvf6GhB8zVLsAtQ: folds 
YZaC69gFrepA6oCGtu7E0w: folds 
6RiVTYll/5D8zICp0MRpKw: folds 
Ihhh49x48fayPIyvl2Rsmg: folds 
Uncalled bet ($1) returned to PdIasPkzm2sqZnN41ZRXOg
PdIasPkzm2sqZnN41ZRXOg collected $0.60 from pot
PdIasPkzm2sqZnN41ZRXOg: doesn't show hand 
*** SUMMARY ***
Total pot $0.60 | Rake $0 
Seat 1: PVxvfRTRvkgZf9WtquEkwQ folded before Flop (didn't bet)
Seat 2: HPEB+AtKw1+C/cxU0o1ciw folded before Flop (didn't bet)
Seat 3: dtZ84flFEi4Q+SGrHMJRDQ folded before Flop (didn't bet)
Seat 4: PdIasPkzm2sqZnN41ZRXOg collected ($0.60)
Seat 5: 57qrNGHDvf6GhB8zVLsAtQ folded before Flop (didn't bet)
Seat 6: YZaC69gFrepA6oCGtu7E0w (button) folded before Flop (didn't bet)
Seat 7: 6RiVTYll/5D8zICp0MRpKw (small blind) folded before Flop
Seat 8: Ihhh49x48fayPIyvl2Rsmg (big blind) folded before Flop
Seat 9: AyqFvLFzJDE7yMbXP362BA folded before Flop (didn't bet)




PokerStars Game #59941854016:  Hold'em No Limit ($0.10/$0.25) - 2009/07/01 1:48:15 ET
Table 'sCop8wmj9zlSS2KJqk1QKQ' 9-max Seat #9 is the button
Seat 1: dtZ84flFEi4Q+SGrHMJRDQ ($40.60 in chips) 
Seat 2: YZaC69gFrepA6oCGtu7E0w ($39.95 in chips) 
Seat 3: M/9j4wkHH9i1JM51vgi1VA ($24.60 in chips) 
Seat 4: msUzkZl2RntUnTl6E8WaNA ($15.90 in chips) 
Seat 5: RHqgdFvufLCYe54+qd2gcA ($8.95 in chips) 
Seat 6: hZuGwtYmFKPmQ+v1wlmdfA ($37.45 in chips) 
Seat 8: xnVwSkROfRtOw4eSoDANtw ($20.30 in chips) 
Seat 9: tLcDklc2rBORNfixyRfVfw ($25 in chips) 
dtZ84flFEi4Q+SGrHMJRDQ: posts small blind $0.10
YZaC69gFrepA6oCGtu7E0w: posts big blind $0.25
18G4P1XstjNvItdGUITxgw: sits out 
*** HOLE CARDS ***
M/9j4wkHH9i1JM51vgi1VA: folds 
msUzkZl2RntUnTl6E8WaNA: calls $0.25
RHqgdFvufLCYe54+qd2gcA: folds 
hZuGwtYmFKPmQ+v1wlmdfA: folds 
hZuGwtYmFKPmQ+v1wlmdfA leaves the table
xnVwSkROfRtOw4eSoDANtw: calls $0.25
tLcDklc2rBORNfixyRfVfw: folds 
dtZ84flFEi4Q+SGrHMJRDQ: calls $0.15
YZaC69gFrepA6oCGtu7E0w: checks 
*** FLOP *** [Ac 7s Kd]
6RiVTYll/5D8zICp0MRpKw joins the table at seat #6 
dtZ84flFEi4Q+SGrHMJRDQ: checks 
YZaC69gFrepA6oCGtu7E0w: bets $0.50
msUzkZl2RntUnTl6E8WaNA: folds 
xnVwSkROfRtOw4eSoDANtw: calls $0.50
dtZ84flFEi4Q+SGrHMJRDQ: calls $0.50
*** TURN *** [Ac 7s Kd] [6c]
dtZ84flFEi4Q+SGrHMJRDQ: checks 
YZaC69gFrepA6oCGtu7E0w: bets $2
xnVwSkROfRtOw4eSoDANtw: folds 
dtZ84flFEi4Q+SGrHMJRDQ: folds 
Uncalled bet ($2) returned to YZaC69gFrepA6oCGtu7E0w
YZaC69gFrepA6oCGtu7E0w collected $2.40 from pot
*** SUMMARY ***
Total pot $2.50 | Rake $0.10 
Board [Ac 7s Kd 6c]
Seat 1: dtZ84flFEi4Q+SGrHMJRDQ (small blind) folded on the Turn
Seat 2: YZaC69gFrepA6oCGtu7E0w (big blind) collected ($2.40)
Seat 3: M/9j4wkHH9i1JM51vgi1VA folded before Flop (didn't bet)
Seat 4: msUzkZl2RntUnTl6E8WaNA folded on the Flop
Seat 5: RHqgdFvufLCYe54+qd2gcA folded before Flop (didn't bet)
Seat 6: hZuGwtYmFKPmQ+v1wlmdfA folded before Flop (didn't bet)
Seat 8: xnVwSkROfRtOw4eSoDANtw folded on the Turn
Seat 9: tLcDklc2rBORNfixyRfVfw (button) folded before Flop (didn't bet)




PokerStars Game #59941853914:  Hold'em No Limit ($0.10/$0.25) - 2009/07/01 1:48:15 ET
Table 'T/iCKJXGphRN3xcdwfE/JQ' 6-max Seat #6 is the button
Seat 1: wAKC8C/zN0c8V5v13dm9mA ($26.25 in chips) 
Seat 2: EeUZtMU058v2ObUACOF4Og ($32 in chips) 
Seat 3: IWAjoCPXtc1XUaZdp+pCpA ($22.10 in chips) 
Seat 5: gaPMxLGp9SOj4Lq6t+/0Ig ($8.85 in chips) 
Seat 6: Ey4Kn6PlnYb2srYYBJHvzg ($12.80 in chips) 
wAKC8C/zN0c8V5v13dm9mA: posts small blind $0.10
EeUZtMU058v2ObUACOF4Og: posts big blind $0.25
m2yWOKfAxqHoy5DDN87Ttw: sits out 
*** HOLE CARDS ***
IWAjoCPXtc1XUaZdp+pCpA: folds 
gaPMxLGp9SOj4Lq6t+/0Ig: raises $0.50 to $0.75
Ey4Kn6PlnYb2srYYBJHvzg: raises $0.75 to $1.50
wAKC8C/zN0c8V5v13dm9mA: folds 
EeUZtMU058v2ObUACOF4Og: folds 
gaPMxLGp9SOj4Lq6t+/0Ig: calls $0.75
*** FLOP *** [7s Ah 2d]
gaPMxLGp9SOj4Lq6t+/0Ig: bets $7.35 and is all-in
Ey4Kn6PlnYb2srYYBJHvzg: calls $7.35
*** TURN *** [7s Ah 2d] [Qc]
*** RIVER *** [7s Ah 2d Qc] [Td]
*** SHOW DOWN ***
gaPMxLGp9SOj4Lq6t+/0Ig: shows [As 4s] (a pair of Aces)
Ey4Kn6PlnYb2srYYBJHvzg: shows [Kc Ad] (a pair of Aces - King kicker)
Ey4Kn6PlnYb2srYYBJHvzg collected $17.20 from pot
*** SUMMARY ***
Total pot $18.05 | Rake $0.85 
Board [7s Ah 2d Qc Td]
Seat 1: wAKC8C/zN0c8V5v13dm9mA (small blind) folded before Flop
Seat 2: EeUZtMU058v2ObUACOF4Og (big blind) folded before Flop
Seat 3: IWAjoCPXtc1XUaZdp+pCpA folded before Flop (didn't bet)
Seat 5: gaPMxLGp9SOj4Lq6t+/0Ig showed [As 4s] and lost with a pair of Aces
Seat 6: Ey4Kn6PlnYb2srYYBJHvzg (button) showed [Kc Ad] and won ($17.20) with a pair of Aces




PokerStars Game #59941853898:  Hold'em No Limit ($0.10/$0.25) - 2009/07/01 1:48:15 ET
Table 'M8kYidAX3ib7pLKW7edFLw' 6-max Seat #3 is the button
Seat 1: jp34e617tIzV8tKIWmfAbA ($25 in chips) 
Seat 2: ypmjhffk/YHGc51wgVXUTw ($25 in chips) 
Seat 3: cezpHJ8FB07dj0xG+LhOvw ($26.75 in chips) 
Seat 4: Hsvkc0/G2VV78oVmWYXecw ($5.05 in chips) 
Seat 5: bDKopKTvPi3W+PEnYUX3tg ($47.85 in chips) 
Seat 6: NqFoyDgzLwu4dOmSRXnFBA ($25.25 in chips) 
Hsvkc0/G2VV78oVmWYXecw: posts small blind $0.10
bDKopKTvPi3W+PEnYUX3tg: posts big blind $0.25
*** HOLE CARDS ***
NqFoyDgzLwu4dOmSRXnFBA: folds 
jp34e617tIzV8tKIWmfAbA: folds 
ypmjhffk/YHGc51wgVXUTw: folds 
cezpHJ8FB07dj0xG+LhOvw: raises $0.35 to $0.60
Hsvkc0/G2VV78oVmWYXecw: raises $1.40 to $2
bDKopKTvPi3W+PEnYUX3tg: folds 
cezpHJ8FB07dj0xG+LhOvw: folds 
Uncalled bet ($1.40) returned to Hsvkc0/G2VV78oVmWYXecw
Hsvkc0/G2VV78oVmWYXecw collected $1.45 from pot
Hsvkc0/G2VV78oVmWYXecw: doesn't show hand 
*** SUMMARY ***
Total pot $1.45 | Rake $0 
Seat 1: jp34e617tIzV8tKIWmfAbA folded before Flop (didn't bet)
Seat 2: ypmjhffk/YHGc51wgVXUTw folded before Flop (didn't bet)
Seat 3: cezpHJ8FB07dj0xG+LhOvw (button) folded before Flop
Seat 4: Hsvkc0/G2VV78oVmWYXecw (small blind) collected ($1.45)
Seat 5: bDKopKTvPi3W+PEnYUX3tg (big blind) folded before Flop
Seat 6: NqFoyDgzLwu4dOmSRXnFBA folded before Flop (didn't bet)




PokerStars Game #59941853794:  Hold'em No Limit ($0.10/$0.25) - 2009/07/01 1:48:15 ET
Table '+UzantPJ4smVdrh+4GTu1w' 6-max Seat #1 is the button
Seat 1: TSmua8tGK3sTbwi0ynrW9Q ($38.25 in chips) 
Seat 2: tcbEu7VzyHQ+0lh+skbQhQ ($29.85 in chips) 
Seat 3: SS/yfeArhULzIcOPe8MdPg ($34.50 in chips) 
Seat 4: UmcUp27+PbgBItv3ZNlAWQ ($26.80 in chips) 
Seat 5: cj4VBQya7HtVL2zCGd5jLQ ($55.70 in chips) 
Seat 6: fZQg9veL7Dd/Z04ZTjC+wQ ($25 in chips) 
tcbEu7VzyHQ+0lh+skbQhQ: posts small blind $0.10
SS/yfeArhULzIcOPe8MdPg: posts big blind $0.25
*** HOLE CARDS ***
UmcUp27+PbgBItv3ZNlAWQ: folds 
cj4VBQya7HtVL2zCGd5jLQ: folds 
fZQg9veL7Dd/Z04ZTjC+wQ: folds 
TSmua8tGK3sTbwi0ynrW9Q: folds 
tcbEu7VzyHQ+0lh+skbQhQ: folds 
Uncalled bet ($0.15) returned to SS/yfeArhULzIcOPe8MdPg
SS/yfeArhULzIcOPe8MdPg collected $0.20 from pot
*** SUMMARY ***
Total pot $0.20 | Rake $0 
Seat 1: TSmua8tGK3sTbwi0ynrW9Q (button) folded before Flop (didn't bet)
Seat 2: tcbEu7VzyHQ+0lh+skbQhQ (small blind) folded before Flop
Seat 3: SS/yfeArhULzIcOPe8MdPg (big blind) collected ($0.20)
Seat 4: UmcUp27+PbgBItv3ZNlAWQ folded before Flop (didn't bet)
Seat 5: cj4VBQya7HtVL2zCGd5jLQ folded before Flop (didn't bet)
Seat 6: fZQg9veL7Dd/Z04ZTjC+wQ folded before Flop (didn't bet)




PokerStars Game #59941853968:  Hold'em No Limit ($0.10/$0.25) - 2009/07/01 1:48:15 ET
Table 'GrYi0DZOHD1EvB+qiLExNw' 9-max Seat #6 is the button
Seat 2: Th3FldXKQW6hWVVPahaoOQ ($46.70 in chips) 
Seat 3: RHqgdFvufLCYe54+qd2gcA ($4.75 in chips) 
Seat 4: 8x95tVlB4uFBVHp71KihMA ($35.40 in chips) 
Seat 5: cZ99hugmLBj9KhTlc8nCSw ($25 in chips) 
Seat 6: arxNSjreDRGFg13EAM2F1w ($25.25 in chips) 
Seat 7: 9lvO/qyU+xrU95Teu1fv0g ($23.30 in chips) 
Seat 9: 5hAPbqNrvJb8PtLiceXtlg ($13.75 in chips) 
9lvO/qyU+xrU95Teu1fv0g: posts small blind $0.10
MtVtHDqIJTyUcXkRBBDIVA: is sitting out 
5hAPbqNrvJb8PtLiceXtlg: posts big blind $0.25
7je+LC5Mfs6nL8YBVh4frQ: sits out 
*** HOLE CARDS ***
Th3FldXKQW6hWVVPahaoOQ: folds 
RHqgdFvufLCYe54+qd2gcA: folds 
8x95tVlB4uFBVHp71KihMA: calls $0.25
cZ99hugmLBj9KhTlc8nCSw: folds 
arxNSjreDRGFg13EAM2F1w: folds 
9lvO/qyU+xrU95Teu1fv0g: folds 
5hAPbqNrvJb8PtLiceXtlg: checks 
*** FLOP *** [7d 6c 7s]
5hAPbqNrvJb8PtLiceXtlg: checks 
8x95tVlB4uFBVHp71KihMA: checks 
*** TURN *** [7d 6c 7s] [Kd]
5hAPbqNrvJb8PtLiceXtlg: checks 
8x95tVlB4uFBVHp71KihMA: bets $0.25
5hAPbqNrvJb8PtLiceXtlg: folds 
Uncalled bet ($0.25) returned to 8x95tVlB4uFBVHp71KihMA
8x95tVlB4uFBVHp71KihMA collected $0.60 from pot
*** SUMMARY ***
Total pot $0.60 | Rake $0 
Board [7d 6c 7s Kd]
Seat 2: Th3FldXKQW6hWVVPahaoOQ folded before Flop (didn't bet)
Seat 3: RHqgdFvufLCYe54+qd2gcA folded before Flop (didn't bet)
Seat 4: 8x95tVlB4uFBVHp71KihMA collected ($0.60)
Seat 5: cZ99hugmLBj9KhTlc8nCSw folded before Flop (didn't bet)
Seat 6: arxNSjreDRGFg13EAM2F1w (button) folded before Flop (didn't bet)
Seat 7: 9lvO/qyU+xrU95Teu1fv0g (small blind) folded before Flop
Seat 9: 5hAPbqNrvJb8PtLiceXtlg (big blind) folded on the Turn




PokerStars Game #59941854694:  Hold'em No Limit ($0.10/$0.25) - 2009/07/01 1:48:16 ET
Table 'O5NgMYt6EWbLBozZb3kseg' 6-max Seat #4 is the button
Seat 1: AxhCSFlGEh+FAc+VUD31JQ ($12.75 in chips) 
Seat 2: ZZm/rg8aThjE+A2LiItuzA ($9.75 in chips) 
Seat 3: nEezgRkm8mxa3J5ySz1mJQ ($3.85 in chips) 
Seat 4: ItRgvLhXTZHvtZowz+dbIw ($12.90 in chips) 
Seat 5: u3Ol7kv1LmvszuHNm9rc6w ($24.75 in chips) 
Seat 6: 3m6VfX7io8SA31qh1zCkgQ ($14.15 in chips) 
u3Ol7kv1LmvszuHNm9rc6w: posts small blind $0.10
3m6VfX7io8SA31qh1zCkgQ: posts big blind $0.25
*** HOLE CARDS ***
AxhCSFlGEh+FAc+VUD31JQ: raises $0.75 to $1
ZZm/rg8aThjE+A2LiItuzA: folds 
nEezgRkm8mxa3J5ySz1mJQ: raises $2.85 to $3.85 and is all-in
ItRgvLhXTZHvtZowz+dbIw: folds 
u3Ol7kv1LmvszuHNm9rc6w: folds 
3m6VfX7io8SA31qh1zCkgQ: calls $3.60
AxhCSFlGEh+FAc+VUD31JQ: calls $2.85
*** FLOP *** [Td 4h Ks]
3m6VfX7io8SA31qh1zCkgQ: checks 
AxhCSFlGEh+FAc+VUD31JQ: bets $8.90 and is all-in
3m6VfX7io8SA31qh1zCkgQ: calls $8.90
*** TURN *** [Td 4h Ks] [3c]
*** RIVER *** [Td 4h Ks 3c] [7c]
*** SHOW DOWN ***
3m6VfX7io8SA31qh1zCkgQ: shows [Tc Th] (three of a kind, Tens)
AxhCSFlGEh+FAc+VUD31JQ: mucks hand 
3m6VfX7io8SA31qh1zCkgQ collected $16.95 from side pot
nEezgRkm8mxa3J5ySz1mJQ: mucks hand 
3m6VfX7io8SA31qh1zCkgQ collected $11.10 from main pot
nEezgRkm8mxa3J5ySz1mJQ leaves the table
AxhCSFlGEh+FAc+VUD31JQ leaves the table
*** SUMMARY ***
Total pot $29.45 Main pot $11.10. Side pot $16.95. | Rake $1.40 
Board [Td 4h Ks 3c 7c]
Seat 1: AxhCSFlGEh+FAc+VUD31JQ mucked
Seat 2: ZZm/rg8aThjE+A2LiItuzA folded before Flop (didn't bet)
Seat 3: nEezgRkm8mxa3J5ySz1mJQ mucked
Seat 4: ItRgvLhXTZHvtZowz+dbIw (button) folded before Flop (didn't bet)
Seat 5: u3Ol7kv1LmvszuHNm9rc6w (small blind) folded before Flop
Seat 6: 3m6VfX7io8SA31qh1zCkgQ (big blind) showed [Tc Th] and won ($28.05) with three of a kind, Tens




PokerStars Game #59941854230:  Hold'em No Limit ($0.10/$0.25) - 2009/07/01 1:48:16 ET
Table 'rjcb+nlE+0GuJ6lBhuCkkA' 6-max Seat #4 is the button
Seat 1: lBoEwOFgzcERLIRUkUoRTw ($13.25 in chips) 
Seat 2: lJphax9e7/+O/3YCKPJ0yQ ($7.70 in chips) 
Seat 3: 8ClCHtFXGNplITm+63KB+Q ($66.20 in chips) 
Seat 4: BV+K0Phf5VBHr7aZPKqbUQ ($35.15 in chips) 
Seat 5: GC/9yVD59DUCX7hUI7gcLw ($28.75 in chips) 
Seat 6: 32YL2ZEp8NT4JB2RVM9euQ ($16.05 in chips) 
GC/9yVD59DUCX7hUI7gcLw: posts small blind $0.10
32YL2ZEp8NT4JB2RVM9euQ: posts big blind $0.25
*** HOLE CARDS ***
lBoEwOFgzcERLIRUkUoRTw: folds 
lJphax9e7/+O/3YCKPJ0yQ: folds 
8ClCHtFXGNplITm+63KB+Q: folds 
BV+K0Phf5VBHr7aZPKqbUQ: raises $0.50 to $0.75
GC/9yVD59DUCX7hUI7gcLw: folds 
32YL2ZEp8NT4JB2RVM9euQ: folds 
Uncalled bet ($0.50) returned to BV+K0Phf5VBHr7aZPKqbUQ
BV+K0Phf5VBHr7aZPKqbUQ collected $0.60 from pot
BV+K0Phf5VBHr7aZPKqbUQ: doesn't show hand 
*** SUMMARY ***
Total pot $0.60 | Rake $0 
Seat 1: lBoEwOFgzcERLIRUkUoRTw folded before Flop (didn't bet)
Seat 2: lJphax9e7/+O/3YCKPJ0yQ folded before Flop (didn't bet)
Seat 3: 8ClCHtFXGNplITm+63KB+Q folded before Flop (didn't bet)
Seat 4: BV+K0Phf5VBHr7aZPKqbUQ (button) collected ($0.60)
Seat 5: GC/9yVD59DUCX7hUI7gcLw (small blind) folded before Flop
Seat 6: 32YL2ZEp8NT4JB2RVM9euQ (big blind) folded before Flop




PokerStars Game #59941854386:  Hold'em No Limit ($0.10/$0.25) - 2009/07/01 1:48:16 ET
Table 'gYBWJG3hEuJg6kphY0yhMg' 9-max Seat #3 is the button
Seat 1: AcL/hxc9eT0dCr2TYk/0Dg ($25.80 in chips) 
Seat 2: RCqMONFrSPSArZh2Jsar/w ($20 in chips) 
Seat 3: wGigCmBR/9XWkPpvYos3aQ ($25 in chips) 
Seat 4: V6p0jQ/RhUsqpHLmXvEX4Q ($10.90 in chips) 
Seat 5: +sbyWwIcFp9kP0bDtMegfQ ($28.75 in chips) 
Seat 7: aIEQGxUJwm61WfazSNFCdA ($10.55 in chips) 
Seat 8: 7je+LC5Mfs6nL8YBVh4frQ ($4.75 in chips) 
Seat 9: Bb42QRQMhg5/Y0vHP8/2Xw ($28.05 in chips) 
V6p0jQ/RhUsqpHLmXvEX4Q: posts small blind $0.10
+sbyWwIcFp9kP0bDtMegfQ: posts big blind $0.25
Z9W7+g1WMhhZDi7DwGbCFA: sits out 
*** HOLE CARDS ***
aIEQGxUJwm61WfazSNFCdA: raises $0.50 to $0.75
7je+LC5Mfs6nL8YBVh4frQ: folds 
Bb42QRQMhg5/Y0vHP8/2Xw: folds 
AcL/hxc9eT0dCr2TYk/0Dg: folds 
RCqMONFrSPSArZh2Jsar/w: calls $0.75
wGigCmBR/9XWkPpvYos3aQ: folds 
V6p0jQ/RhUsqpHLmXvEX4Q: folds 
+sbyWwIcFp9kP0bDtMegfQ: calls $0.50
*** FLOP *** [Jd Kd 6s]
+sbyWwIcFp9kP0bDtMegfQ: checks 
aIEQGxUJwm61WfazSNFCdA: bets $1.25
RCqMONFrSPSArZh2Jsar/w: folds 
+sbyWwIcFp9kP0bDtMegfQ: folds 
Uncalled bet ($1.25) returned to aIEQGxUJwm61WfazSNFCdA
aIEQGxUJwm61WfazSNFCdA collected $2.25 from pot
aIEQGxUJwm61WfazSNFCdA: doesn't show hand 
*** SUMMARY ***
Total pot $2.35 | Rake $0.10 
Board [Jd Kd 6s]
Seat 1: AcL/hxc9eT0dCr2TYk/0Dg folded before Flop (didn't bet)
Seat 2: RCqMONFrSPSArZh2Jsar/w folded on the Flop
Seat 3: wGigCmBR/9XWkPpvYos3aQ (button) folded before Flop (didn't bet)
Seat 4: V6p0jQ/RhUsqpHLmXvEX4Q (small blind) folded before Flop
Seat 5: +sbyWwIcFp9kP0bDtMegfQ (big blind) folded on the Flop
Seat 7: aIEQGxUJwm61WfazSNFCdA collected ($2.25)
Seat 8: 7je+LC5Mfs6nL8YBVh4frQ folded before Flop (didn't bet)
Seat 9: Bb42QRQMhg5/Y0vHP8/2Xw folded before Flop (didn't bet)




PokerStars Game #59941854654:  Hold'em No Limit ($0.10/$0.25) - 2009/07/01 1:48:16 ET
Table 'GgmUtmhrYPRnhkqEEjD/Kw' 9-max Seat #7 is the button
Seat 2: ghNKXUBl/H+t83JF079ZBA ($25.15 in chips) 
Seat 3: dYvYZ723QlKIPiDa0pkedQ ($8.25 in chips) 
Seat 4: dfNim92Z6XK1/h5SFW5vDg ($25 in chips) 
Seat 5: ljemhp25Zg+nlA9DLCIiUw ($26.85 in chips) 
Seat 6: 4Ax0vobe1rLVIGZmkFINGA ($19.25 in chips) 
Seat 7: YwDw9cMqkbMznFK77rru4A ($4.55 in chips) 
Seat 8: DdPXdieucQ+n99u1n3A+rQ ($4.40 in chips) 
Seat 9: V6p0jQ/RhUsqpHLmXvEX4Q ($15.55 in chips) 
DdPXdieucQ+n99u1n3A+rQ: posts small blind $0.10
V6p0jQ/RhUsqpHLmXvEX4Q: posts big blind $0.25
bXpVeaSTPBFSPJmeXxO7nw: sits out 
*** HOLE CARDS ***
ghNKXUBl/H+t83JF079ZBA: raises $0.75 to $1
dYvYZ723QlKIPiDa0pkedQ: calls $1
dfNim92Z6XK1/h5SFW5vDg: folds 
ljemhp25Zg+nlA9DLCIiUw: folds 
4Ax0vobe1rLVIGZmkFINGA: calls $1
YwDw9cMqkbMznFK77rru4A: folds 
DdPXdieucQ+n99u1n3A+rQ: folds 
V6p0jQ/RhUsqpHLmXvEX4Q: folds 
*** FLOP *** [Qh 6s 4c]
ghNKXUBl/H+t83JF079ZBA: checks 
dYvYZ723QlKIPiDa0pkedQ: checks 
4Ax0vobe1rLVIGZmkFINGA: checks 
*** TURN *** [Qh 6s 4c] [5s]
ghNKXUBl/H+t83JF079ZBA: bets $3
dYvYZ723QlKIPiDa0pkedQ: folds 
4Ax0vobe1rLVIGZmkFINGA: raises $3 to $6
ghNKXUBl/H+t83JF079ZBA: raises $18.15 to $24.15 and is all-in
4Ax0vobe1rLVIGZmkFINGA: calls $12.25 and is all-in
Uncalled bet ($5.90) returned to ghNKXUBl/H+t83JF079ZBA
*** RIVER *** [Qh 6s 4c 5s] [Kh]
*** SHOW DOWN ***
ghNKXUBl/H+t83JF079ZBA: shows [7s 8s] (a straight, Four to Eight)
4Ax0vobe1rLVIGZmkFINGA: shows [8h 7c] (a straight, Four to Eight)
ghNKXUBl/H+t83JF079ZBA collected $18.95 from pot
4Ax0vobe1rLVIGZmkFINGA collected $18.95 from pot
*** SUMMARY ***
Total pot $39.85 | Rake $1.95 
Board [Qh 6s 4c 5s Kh]
Seat 2: ghNKXUBl/H+t83JF079ZBA showed [7s 8s] and won ($18.95) with a straight, Four to Eight
Seat 3: dYvYZ723QlKIPiDa0pkedQ folded on the Turn
Seat 4: dfNim92Z6XK1/h5SFW5vDg folded before Flop (didn't bet)
Seat 5: ljemhp25Zg+nlA9DLCIiUw folded before Flop (didn't bet)
Seat 6: 4Ax0vobe1rLVIGZmkFINGA showed [8h 7c] and won ($18.95) with a straight, Four to Eight
Seat 7: YwDw9cMqkbMznFK77rru4A (button) folded before Flop (didn't bet)
Seat 8: DdPXdieucQ+n99u1n3A+rQ (small blind) folded before Flop
Seat 9: V6p0jQ/RhUsqpHLmXvEX4Q (big blind) folded before Flop




PokerStars Game #59941854146:  Hold'em No Limit ($0.10/$0.25) - 2009/07/01 1:48:16 ET
Table 'axb9RsG8Zj1A0LEukTeFrQ' 9-max Seat #6 is the button
Seat 1: qwr38jl5txoR36M7G5qi4A ($8.50 in chips) 
Seat 2: zDrucyjVn5aeekNEc3cJrA ($21.40 in chips) 
Seat 3: H5Se03ZqSX7tbULXur2MAg ($23.10 in chips) 
Seat 4: tLcDklc2rBORNfixyRfVfw ($25 in chips) 
Seat 5: rLSSHKOHnb6yzVfDoQM/RA ($18.10 in chips) 
Seat 6: Iu9xjReQYvxYiqQm8n6MXQ ($4.25 in chips) 
Seat 7: PdIasPkzm2sqZnN41ZRXOg ($4.75 in chips) 
Seat 8: VBHxUExRAMrbxUq/cVx9Gw ($5 in chips) 
Seat 9: qbQE8CifKB4+OEvNF/61Rw ($57.95 in chips) 
PdIasPkzm2sqZnN41ZRXOg: posts small blind $0.10
VBHxUExRAMrbxUq/cVx9Gw: posts big blind $0.25
*** HOLE CARDS ***
qbQE8CifKB4+OEvNF/61Rw: calls $0.25
qwr38jl5txoR36M7G5qi4A: folds 
zDrucyjVn5aeekNEc3cJrA: folds 
H5Se03ZqSX7tbULXur2MAg: raises $1.25 to $1.50
tLcDklc2rBORNfixyRfVfw: folds 
rLSSHKOHnb6yzVfDoQM/RA: calls $1.50
Iu9xjReQYvxYiqQm8n6MXQ: folds 
PdIasPkzm2sqZnN41ZRXOg: folds 
VBHxUExRAMrbxUq/cVx9Gw: folds 
qbQE8CifKB4+OEvNF/61Rw: folds 
*** FLOP *** [7d Qs 2h]
H5Se03ZqSX7tbULXur2MAg: checks 
rLSSHKOHnb6yzVfDoQM/RA: checks 
*** TURN *** [7d Qs 2h] [Ks]
H5Se03ZqSX7tbULXur2MAg: bets $2.25
rLSSHKOHnb6yzVfDoQM/RA: folds 
Uncalled bet ($2.25) returned to H5Se03ZqSX7tbULXur2MAg
H5Se03ZqSX7tbULXur2MAg collected $3.45 from pot
*** SUMMARY ***
Total pot $3.60 | Rake $0.15 
Board [7d Qs 2h Ks]
Seat 1: qwr38jl5txoR36M7G5qi4A folded before Flop (didn't bet)
Seat 2: zDrucyjVn5aeekNEc3cJrA folded before Flop (didn't bet)
Seat 3: H5Se03ZqSX7tbULXur2MAg collected ($3.45)
Seat 4: tLcDklc2rBORNfixyRfVfw folded before Flop (didn't bet)
Seat 5: rLSSHKOHnb6yzVfDoQM/RA folded on the Turn
Seat 6: Iu9xjReQYvxYiqQm8n6MXQ (button) folded before Flop (didn't bet)
Seat 7: PdIasPkzm2sqZnN41ZRXOg (small blind) folded before Flop
Seat 8: VBHxUExRAMrbxUq/cVx9Gw (big blind) folded before Flop
Seat 9: qbQE8CifKB4+OEvNF/61Rw folded before Flop




PokerStars Game #59941854296:  Hold'em No Limit ($0.10/$0.25) - 2009/07/01 1:48:16 ET
Table 'G+4ZdyRoPjgaJY/jxSlZzQ' 9-max Seat #5 is the button
Seat 1: ghNKXUBl/H+t83JF079ZBA ($23.75 in chips) 
Seat 2: CT7Xj/V/O5rBlhtt+RZeFQ ($25 in chips) 
Seat 3: FaGtAm5QUVcixGhAKIvbLg ($6.85 in chips) 
Seat 4: 3PmVnC/15cl4oyI1TKIt4g ($4.65 in chips) 
Seat 5: BT6Oal0iO4P6kDuT7HFQDw ($24.25 in chips) 
Seat 6: oFwaTjy3ok/+qFghsrcGvg ($21.80 in chips) 
Seat 7: qwr38jl5txoR36M7G5qi4A ($10 in chips) 
Seat 8: bXpVeaSTPBFSPJmeXxO7nw ($4.65 in chips) 
Seat 9: tLcDklc2rBORNfixyRfVfw ($26.50 in chips) 
oFwaTjy3ok/+qFghsrcGvg: posts small blind $0.10
qwr38jl5txoR36M7G5qi4A: posts big blind $0.25
*** HOLE CARDS ***
bXpVeaSTPBFSPJmeXxO7nw: folds 
tLcDklc2rBORNfixyRfVfw: folds 
ghNKXUBl/H+t83JF079ZBA: folds 
CT7Xj/V/O5rBlhtt+RZeFQ: folds 
FaGtAm5QUVcixGhAKIvbLg: calls $0.25
3PmVnC/15cl4oyI1TKIt4g: folds 
BT6Oal0iO4P6kDuT7HFQDw: calls $0.25
oFwaTjy3ok/+qFghsrcGvg: calls $0.15
qwr38jl5txoR36M7G5qi4A: raises $1.50 to $1.75
FaGtAm5QUVcixGhAKIvbLg: folds 
BT6Oal0iO4P6kDuT7HFQDw: folds 
oFwaTjy3ok/+qFghsrcGvg: folds 
Uncalled bet ($1.50) returned to qwr38jl5txoR36M7G5qi4A
qwr38jl5txoR36M7G5qi4A collected $1 from pot
*** SUMMARY ***
Total pot $1 | Rake $0 
Seat 1: ghNKXUBl/H+t83JF079ZBA folded before Flop (didn't bet)
Seat 2: CT7Xj/V/O5rBlhtt+RZeFQ folded before Flop (didn't bet)
Seat 3: FaGtAm5QUVcixGhAKIvbLg folded before Flop
Seat 4: 3PmVnC/15cl4oyI1TKIt4g folded before Flop (didn't bet)
Seat 5: BT6Oal0iO4P6kDuT7HFQDw (button) folded before Flop
Seat 6: oFwaTjy3ok/+qFghsrcGvg (small blind) folded before Flop
Seat 7: qwr38jl5txoR36M7G5qi4A (big blind) collected ($1)
Seat 8: bXpVeaSTPBFSPJmeXxO7nw folded before Flop (didn't bet)
Seat 9: tLcDklc2rBORNfixyRfVfw folded before Flop (didn't bet)




PokerStars Game #59941854772:  Hold'em No Limit ($0.10/$0.25) - 2009/07/01 1:48:17 ET
Table 'jxoHy9yJy0bbH/Qx73FoPA' 9-max Seat #2 is the button
Seat 1: j4q3p0lesp63b1gZDwLBZw ($6.60 in chips) 
Seat 2: F7pnn6czNpHvRM55XcA2EA ($45.50 in chips) 
Seat 3: CVqCt93Mk0MhKMaZ4LZDSQ ($9.05 in chips) 
Seat 4: bXpVeaSTPBFSPJmeXxO7nw ($5 in chips) 
Seat 5: rzZ3wFcwoPyKlQ0mB5JLRQ ($7.75 in chips) 
Seat 6: tYsOBqdU1+x+yFI7zHO7hQ ($62.55 in chips) 
Seat 7: wGigCmBR/9XWkPpvYos3aQ ($26.40 in chips) 
Seat 8: Z9W7+g1WMhhZDi7DwGbCFA ($5 in chips) 
Seat 9: CvL9Ch1HYCVbTsfpNucitg ($4.55 in chips) 
CVqCt93Mk0MhKMaZ4LZDSQ: posts small blind $0.10
bXpVeaSTPBFSPJmeXxO7nw: posts big blind $0.25
*** HOLE CARDS ***
rzZ3wFcwoPyKlQ0mB5JLRQ: folds 
tYsOBqdU1+x+yFI7zHO7hQ: folds 
wGigCmBR/9XWkPpvYos3aQ: folds 
Z9W7+g1WMhhZDi7DwGbCFA: folds 
CvL9Ch1HYCVbTsfpNucitg: raises $0.75 to $1
j4q3p0lesp63b1gZDwLBZw: folds 
F7pnn6czNpHvRM55XcA2EA: folds 
CVqCt93Mk0MhKMaZ4LZDSQ: folds 
rzZ3wFcwoPyKlQ0mB5JLRQ is sitting out
rzZ3wFcwoPyKlQ0mB5JLRQ leaves the table
bXpVeaSTPBFSPJmeXxO7nw: folds 
Uncalled bet ($0.75) returned to CvL9Ch1HYCVbTsfpNucitg
CvL9Ch1HYCVbTsfpNucitg collected $0.60 from pot
CvL9Ch1HYCVbTsfpNucitg: doesn't show hand 
*** SUMMARY ***
Total pot $0.60 | Rake $0 
Seat 1: j4q3p0lesp63b1gZDwLBZw folded before Flop (didn't bet)
Seat 2: F7pnn6czNpHvRM55XcA2EA (button) folded before Flop (didn't bet)
Seat 3: CVqCt93Mk0MhKMaZ4LZDSQ (small blind) folded before Flop
Seat 4: bXpVeaSTPBFSPJmeXxO7nw (big blind) folded before Flop
Seat 5: rzZ3wFcwoPyKlQ0mB5JLRQ folded before Flop (didn't bet)
Seat 6: tYsOBqdU1+x+yFI7zHO7hQ folded before Flop (didn't bet)
Seat 7: wGigCmBR/9XWkPpvYos3aQ folded before Flop (didn't bet)
Seat 8: Z9W7+g1WMhhZDi7DwGbCFA folded before Flop (didn't bet)
Seat 9: CvL9Ch1HYCVbTsfpNucitg collected ($0.60)




PokerStars Game #59941855078:  Hold'em No Limit ($0.10/$0.25) - 2009/07/01 1:48:17 ET
Table 'Zi9/NqNs3XoL1eWhMCyZyg' 9-max Seat #1 is the button
Seat 1: X6+pSIPfovPcE87t+LmUKQ ($4.50 in chips) 
Seat 2: 1wKfgJ8xXIiuc8C6qjkxhg ($5.20 in chips) 
Seat 3: ETC7YyRJTa2Ovhln64Ni5Q ($27.75 in chips) 
Seat 4: dmYlc+1cjwZMJ7wV+Z0rRg ($23.75 in chips) 
Seat 5: JTINtdu/1/EQCVfalLD/xQ ($10.30 in chips) 
Seat 6: YQhfmYhgnDDlWCAFmBb36Q ($16.25 in chips) 
Seat 7: 0QdZrkFD7aGKeBXPGbIomA ($2.20 in chips) 
Seat 8: nm4Dj/f+jJEwKVsUnKh73g ($35.40 in chips) 
1wKfgJ8xXIiuc8C6qjkxhg: posts small blind $0.10
ETC7YyRJTa2Ovhln64Ni5Q: posts big blind $0.25
*** HOLE CARDS ***
dmYlc+1cjwZMJ7wV+Z0rRg: folds 
3l+i+xMeyDndSXMF2A5CDA joins the table at seat #9 
JTINtdu/1/EQCVfalLD/xQ: folds 
YQhfmYhgnDDlWCAFmBb36Q: folds 
0QdZrkFD7aGKeBXPGbIomA: folds 
nm4Dj/f+jJEwKVsUnKh73g: raises $0.25 to $0.50
X6+pSIPfovPcE87t+LmUKQ: folds 
1wKfgJ8xXIiuc8C6qjkxhg: folds 
ETC7YyRJTa2Ovhln64Ni5Q: calls $0.25
*** FLOP *** [7h 4c Ah]
ETC7YyRJTa2Ovhln64Ni5Q: checks 
nm4Dj/f+jJEwKVsUnKh73g: checks 
*** TURN *** [7h 4c Ah] [Ad]
ETC7YyRJTa2Ovhln64Ni5Q: checks 
nm4Dj/f+jJEwKVsUnKh73g: checks 
*** RIVER *** [7h 4c Ah Ad] [Jc]
ETC7YyRJTa2Ovhln64Ni5Q: bets $0.75
nm4Dj/f+jJEwKVsUnKh73g: folds 
Uncalled bet ($0.75) returned to ETC7YyRJTa2Ovhln64Ni5Q
ETC7YyRJTa2Ovhln64Ni5Q collected $1.05 from pot
*** SUMMARY ***
Total pot $1.10 | Rake $0.05 
Board [7h 4c Ah Ad Jc]
Seat 1: X6+pSIPfovPcE87t+LmUKQ (button) folded before Flop (didn't bet)
Seat 2: 1wKfgJ8xXIiuc8C6qjkxhg (small blind) folded before Flop
Seat 3: ETC7YyRJTa2Ovhln64Ni5Q (big blind) collected ($1.05)
Seat 4: dmYlc+1cjwZMJ7wV+Z0rRg folded before Flop (didn't bet)
Seat 5: JTINtdu/1/EQCVfalLD/xQ folded before Flop (didn't bet)
Seat 6: YQhfmYhgnDDlWCAFmBb36Q folded before Flop (didn't bet)
Seat 7: 0QdZrkFD7aGKeBXPGbIomA folded before Flop (didn't bet)
Seat 8: nm4Dj/f+jJEwKVsUnKh73g folded on the River




PokerStars Game #59941854844:  Hold'em No Limit ($0.10/$0.25) - 2009/07/01 1:48:17 ET
Table 'P1IJQ2p3ACFySC35W1qwQw' 9-max Seat #8 is the button
Seat 1: bXpVeaSTPBFSPJmeXxO7nw ($5.25 in chips) 
Seat 2: vO3QVRovWemcGMkm7ijAIA ($3.60 in chips) 
Seat 3: PVxvfRTRvkgZf9WtquEkwQ ($28 in chips) 
Seat 4: c/9X4zftzphFxYtxp5kp9w ($27.55 in chips) 
Seat 5: ghNKXUBl/H+t83JF079ZBA ($56.45 in chips) 
Seat 6: ljemhp25Zg+nlA9DLCIiUw ($64.45 in chips) 
Seat 7: 7je+LC5Mfs6nL8YBVh4frQ ($5.10 in chips) 
Seat 8: tLcDklc2rBORNfixyRfVfw ($26.25 in chips) 
GeMoapCKDLc4ajT0Uk9ZQw will be allowed to play after the button
bXpVeaSTPBFSPJmeXxO7nw: posts small blind $0.10
vO3QVRovWemcGMkm7ijAIA: posts big blind $0.25
*** HOLE CARDS ***
PVxvfRTRvkgZf9WtquEkwQ: calls $0.25
c/9X4zftzphFxYtxp5kp9w: calls $0.25
ghNKXUBl/H+t83JF079ZBA: folds 
ljemhp25Zg+nlA9DLCIiUw: folds 
7je+LC5Mfs6nL8YBVh4frQ: folds 
tLcDklc2rBORNfixyRfVfw: folds 
bXpVeaSTPBFSPJmeXxO7nw: folds 
vO3QVRovWemcGMkm7ijAIA: checks 
*** FLOP *** [Kc Ac Tc]
vO3QVRovWemcGMkm7ijAIA: checks 
PVxvfRTRvkgZf9WtquEkwQ: checks 
c/9X4zftzphFxYtxp5kp9w: checks 
*** TURN *** [Kc Ac Tc] [5s]
vO3QVRovWemcGMkm7ijAIA: bets $0.50
PVxvfRTRvkgZf9WtquEkwQ: folds 
c/9X4zftzphFxYtxp5kp9w: calls $0.50
*** RIVER *** [Kc Ac Tc 5s] [7s]
vO3QVRovWemcGMkm7ijAIA: bets $0.50
c/9X4zftzphFxYtxp5kp9w: calls $0.50
*** SHOW DOWN ***
vO3QVRovWemcGMkm7ijAIA: shows [Kh 5c] (two pair, Kings and Fives)
c/9X4zftzphFxYtxp5kp9w: mucks hand 
vO3QVRovWemcGMkm7ijAIA collected $2.75 from pot
*** SUMMARY ***
Total pot $2.85 | Rake $0.10 
Board [Kc Ac Tc 5s 7s]
Seat 1: bXpVeaSTPBFSPJmeXxO7nw (small blind) folded before Flop
Seat 2: vO3QVRovWemcGMkm7ijAIA (big blind) showed [Kh 5c] and won ($2.75) with two pair, Kings and Fives
Seat 3: PVxvfRTRvkgZf9WtquEkwQ folded on the Turn
Seat 4: c/9X4zftzphFxYtxp5kp9w mucked
Seat 5: ghNKXUBl/H+t83JF079ZBA folded before Flop (didn't bet)
Seat 6: ljemhp25Zg+nlA9DLCIiUw folded before Flop (didn't bet)
Seat 7: 7je+LC5Mfs6nL8YBVh4frQ folded before Flop (didn't bet)
Seat 8: tLcDklc2rBORNfixyRfVfw (button) folded before Flop (didn't bet)




PokerStars Game #59941854944:  Hold'em No Limit ($0.10/$0.25) - 2009/07/01 1:48:17 ET
Table 'o0CDOvKO/bn1WjeymDrXfA' 6-max Seat #1 is the button
Seat 1: if4dh6jhJXeN3/qd3qCp9g ($28.05 in chips) 
Seat 2: uAJL+E2git8iAiFyAvVOnw ($5.60 in chips) 
Seat 3: OtVWmpxX2/9L8bb1GSKTuA ($21.90 in chips) 
Seat 5: dOIoLBxmpLHSXBN9LZnf0Q ($32.50 in chips) 
Seat 6: SS/yfeArhULzIcOPe8MdPg ($25.35 in chips) 
uAJL+E2git8iAiFyAvVOnw: posts small blind $0.10
OtVWmpxX2/9L8bb1GSKTuA: posts big blind $0.25
i9LqF5rD3bvtbEE7HWgr3Q: sits out 
*** HOLE CARDS ***
dOIoLBxmpLHSXBN9LZnf0Q: folds 
SS/yfeArhULzIcOPe8MdPg: raises $0.75 to $1
if4dh6jhJXeN3/qd3qCp9g: calls $1
uAJL+E2git8iAiFyAvVOnw: raises $4.60 to $5.60 and is all-in
OtVWmpxX2/9L8bb1GSKTuA: folds 
SS/yfeArhULzIcOPe8MdPg: folds 
if4dh6jhJXeN3/qd3qCp9g: folds 
Uncalled bet ($4.60) returned to uAJL+E2git8iAiFyAvVOnw
uAJL+E2git8iAiFyAvVOnw collected $3.25 from pot
*** SUMMARY ***
Total pot $3.25 | Rake $0 
Seat 1: if4dh6jhJXeN3/qd3qCp9g (button) folded before Flop
Seat 2: uAJL+E2git8iAiFyAvVOnw (small blind) collected ($3.25)
Seat 3: OtVWmpxX2/9L8bb1GSKTuA (big blind) folded before Flop
Seat 5: dOIoLBxmpLHSXBN9LZnf0Q folded before Flop (didn't bet)
Seat 6: SS/yfeArhULzIcOPe8MdPg folded before Flop




PokerStars Game #59941854776:  Hold'em No Limit ($0.10/$0.25) - 2009/07/01 1:48:17 ET
Table 'SHi8+hK6i7E2dJ/3Agbyig' 6-max Seat #5 is the button
Seat 1: gPEN9Zp33YTm/mu9/SYP1w ($26.25 in chips) 
Seat 2: LJI7A1YgDM7hgh7o56+ReQ ($25 in chips) 
Seat 4: u0ikXOhAPSCLmg+l17oGRw ($24.40 in chips) 
Seat 5: v8m8XHovI5tqEA9mvplDSw ($48.95 in chips) 
Seat 6: cWc85bEzdRzpUMhRKm8pwQ ($32.05 in chips) 
cWc85bEzdRzpUMhRKm8pwQ: posts small blind $0.10
gPEN9Zp33YTm/mu9/SYP1w: posts big blind $0.25
VXTONriS+Ohik+r0FeicIw: sits out 
*** HOLE CARDS ***
LJI7A1YgDM7hgh7o56+ReQ: folds 
u0ikXOhAPSCLmg+l17oGRw: calls $0.25
v8m8XHovI5tqEA9mvplDSw: folds 
cWc85bEzdRzpUMhRKm8pwQ: folds 
gPEN9Zp33YTm/mu9/SYP1w: raises $1.75 to $2
u0ikXOhAPSCLmg+l17oGRw: calls $1.75
*** FLOP *** [Ac Qs Ts]
gPEN9Zp33YTm/mu9/SYP1w: checks 
u0ikXOhAPSCLmg+l17oGRw: checks 
*** TURN *** [Ac Qs Ts] [9d]
gPEN9Zp33YTm/mu9/SYP1w: checks 
u0ikXOhAPSCLmg+l17oGRw: checks 
*** RIVER *** [Ac Qs Ts 9d] [4h]
gPEN9Zp33YTm/mu9/SYP1w: bets $3.50
u0ikXOhAPSCLmg+l17oGRw: folds 
Uncalled bet ($3.50) returned to gPEN9Zp33YTm/mu9/SYP1w
gPEN9Zp33YTm/mu9/SYP1w collected $3.90 from pot
*** SUMMARY ***
Total pot $4.10 | Rake $0.20 
Board [Ac Qs Ts 9d 4h]
Seat 1: gPEN9Zp33YTm/mu9/SYP1w (big blind) collected ($3.90)
Seat 2: LJI7A1YgDM7hgh7o56+ReQ folded before Flop (didn't bet)
Seat 4: u0ikXOhAPSCLmg+l17oGRw folded on the River
Seat 5: v8m8XHovI5tqEA9mvplDSw (button) folded before Flop (didn't bet)
Seat 6: cWc85bEzdRzpUMhRKm8pwQ (small blind) folded before Flop




PokerStars Game #59941855110:  Hold'em No Limit ($0.10/$0.25) - 2009/07/01 1:48:17 ET
Table 'NtCSSONEf1zaJo3042tQug' 6-max Seat #4 is the button
Seat 1: KXtdqb+rIMkjc0RvHDksGQ ($34.90 in chips) 
Seat 2: vqWjZmdQu/Hxw96/IJTWdQ ($25 in chips) 
Seat 3: 9kUKGKkblnIx3m8rlVol6Q ($15.65 in chips) 
Seat 4: HxD1kB8zCmalQSdWAkKmlg ($28.50 in chips) 
Seat 5: tOAk1Og4mVObMBOfvdDYOw ($31.65 in chips) 
Seat 6: LxehwDpTQ19ph4Qmc78+Pw ($31.40 in chips) 
tOAk1Og4mVObMBOfvdDYOw: posts small blind $0.10
LxehwDpTQ19ph4Qmc78+Pw: posts big blind $0.25
*** HOLE CARDS ***
KXtdqb+rIMkjc0RvHDksGQ: folds 
vqWjZmdQu/Hxw96/IJTWdQ: folds 
9kUKGKkblnIx3m8rlVol6Q: folds 
HxD1kB8zCmalQSdWAkKmlg: raises $0.75 to $1
tOAk1Og4mVObMBOfvdDYOw: calls $0.90
LxehwDpTQ19ph4Qmc78+Pw: calls $0.75
*** FLOP *** [Qh 5s 7d]
tOAk1Og4mVObMBOfvdDYOw: checks 
LxehwDpTQ19ph4Qmc78+Pw: bets $2.50
HxD1kB8zCmalQSdWAkKmlg: folds 
tOAk1Og4mVObMBOfvdDYOw: folds 
Uncalled bet ($2.50) returned to LxehwDpTQ19ph4Qmc78+Pw
LxehwDpTQ19ph4Qmc78+Pw collected $2.85 from pot
LxehwDpTQ19ph4Qmc78+Pw: doesn't show hand 
*** SUMMARY ***
Total pot $3 | Rake $0.15 
Board [Qh 5s 7d]
Seat 1: KXtdqb+rIMkjc0RvHDksGQ folded before Flop (didn't bet)
Seat 2: vqWjZmdQu/Hxw96/IJTWdQ folded before Flop (didn't bet)
Seat 3: 9kUKGKkblnIx3m8rlVol6Q folded before Flop (didn't bet)
Seat 4: HxD1kB8zCmalQSdWAkKmlg (button) folded on the Flop
Seat 5: tOAk1Og4mVObMBOfvdDYOw (small blind) folded on the Flop
Seat 6: LxehwDpTQ19ph4Qmc78+Pw (big blind) collected ($2.85)




PokerStars Game #59941854972:  Hold'em No Limit ($0.10/$0.25) - 2009/07/01 1:48:17 ET
Table 'ER5H84HUgJx7HyDLnELLeA' 6-max Seat #1 is the button
Seat 1: LJI7A1YgDM7hgh7o56+ReQ ($26.25 in chips) 
Seat 2: buyjetgNT1McXtdaP4zynA ($21 in chips) 
Seat 3: cS21pIxRHx5Gt42o7hPZzw ($13 in chips) 
Seat 4: vqWjZmdQu/Hxw96/IJTWdQ ($25 in chips) 
Seat 5: mfrkWA3PTeYPkbO6hi98Aw ($26.35 in chips) 
Seat 6: 3zD3qLXT1bEffAoWGnc7wg ($51 in chips) 
buyjetgNT1McXtdaP4zynA: posts small blind $0.10
cS21pIxRHx5Gt42o7hPZzw: posts big blind $0.25
*** HOLE CARDS ***
vqWjZmdQu/Hxw96/IJTWdQ: folds 
mfrkWA3PTeYPkbO6hi98Aw: folds 
3zD3qLXT1bEffAoWGnc7wg: raises $0.50 to $0.75
LJI7A1YgDM7hgh7o56+ReQ: folds 
buyjetgNT1McXtdaP4zynA: folds 
cS21pIxRHx5Gt42o7hPZzw: folds 
Uncalled bet ($0.50) returned to 3zD3qLXT1bEffAoWGnc7wg
3zD3qLXT1bEffAoWGnc7wg collected $0.60 from pot
3zD3qLXT1bEffAoWGnc7wg: doesn't show hand 
*** SUMMARY ***
Total pot $0.60 | Rake $0 
Seat 1: LJI7A1YgDM7hgh7o56+ReQ (button) folded before Flop (didn't bet)
Seat 2: buyjetgNT1McXtdaP4zynA (small blind) folded before Flop
Seat 3: cS21pIxRHx5Gt42o7hPZzw (big blind) folded before Flop
Seat 4: vqWjZmdQu/Hxw96/IJTWdQ folded before Flop (didn't bet)
Seat 5: mfrkWA3PTeYPkbO6hi98Aw folded before Flop (didn't bet)
Seat 6: 3zD3qLXT1bEffAoWGnc7wg collected ($0.60)




PokerStars Game #59941854868:  Hold'em No Limit ($0.10/$0.25) - 2009/07/01 1:48:17 ET
Table '/JJyyIstHfkT7t/bW+WXgg' 6-max Seat #5 is the button
Seat 1: xC0kaiDYM6YTlgODL83O5A ($15 in chips) 
Seat 2: obJgSnVgWWWaAUtVILo77Q ($18 in chips) 
Seat 3: DR0nVIhVP77oEBlO9J8vlg ($37.10 in chips) 
Seat 4: JFIAqU8lCZ0vWwEl4bdGsg ($35.80 in chips) 
Seat 5: +ZlnqPoP3Hg4BIUxDfKd/A ($45.70 in chips) 
Seat 6: UmcUp27+PbgBItv3ZNlAWQ ($25.25 in chips) 
UmcUp27+PbgBItv3ZNlAWQ: posts small blind $0.10
xC0kaiDYM6YTlgODL83O5A: posts big blind $0.25
*** HOLE CARDS ***
obJgSnVgWWWaAUtVILo77Q: folds 
DR0nVIhVP77oEBlO9J8vlg: calls $0.25
JFIAqU8lCZ0vWwEl4bdGsg: raises $1 to $1.25
+ZlnqPoP3Hg4BIUxDfKd/A: folds 
UmcUp27+PbgBItv3ZNlAWQ: folds 
xC0kaiDYM6YTlgODL83O5A: folds 
DR0nVIhVP77oEBlO9J8vlg: folds 
Uncalled bet ($1) returned to JFIAqU8lCZ0vWwEl4bdGsg
JFIAqU8lCZ0vWwEl4bdGsg collected $0.85 from pot
JFIAqU8lCZ0vWwEl4bdGsg: doesn't show hand 
*** SUMMARY ***
Total pot $0.85 | Rake $0 
Seat 1: xC0kaiDYM6YTlgODL83O5A (big blind) folded before Flop
Seat 2: obJgSnVgWWWaAUtVILo77Q folded before Flop (didn't bet)
Seat 3: DR0nVIhVP77oEBlO9J8vlg folded before Flop
Seat 4: JFIAqU8lCZ0vWwEl4bdGsg collected ($0.85)
Seat 5: +ZlnqPoP3Hg4BIUxDfKd/A (button) folded before Flop (didn't bet)
Seat 6: UmcUp27+PbgBItv3ZNlAWQ (small blind) folded before Flop




PokerStars Game #59941855040:  Hold'em No Limit ($0.10/$0.25) - 2009/07/01 1:48:17 ET
Table '6aL2C8IFwHHr6SG6RgXaow' 9-max Seat #8 is the button
Seat 3: clJsV3v77RS07bDKY+705w ($5 in chips) 
Seat 4: BT6Oal0iO4P6kDuT7HFQDw ($19.05 in chips) 
Seat 5: wre31HfyzQGpIvID1istxw ($21.45 in chips) 
Seat 6: gehe91e0IyVT0QU/XBkEyg ($26.75 in chips) 
Seat 7: E0iYnEVO2ho7dH3QcCjw7g ($20 in chips) 
Seat 8: rQhYIYXSyH/IivYM1dlV5A ($21.95 in chips) 
Seat 9: CgIo2ItZqi4o3ayVG6HanQ ($23.25 in chips) 
CgIo2ItZqi4o3ayVG6HanQ: posts small blind $0.10
bXpVeaSTPBFSPJmeXxO7nw: is sitting out 
clJsV3v77RS07bDKY+705w: posts big blind $0.25
E0iYnEVO2ho7dH3QcCjw7g: posts big blind $0.25
*** HOLE CARDS ***
bXpVeaSTPBFSPJmeXxO7nw leaves the table
BT6Oal0iO4P6kDuT7HFQDw: raises $0.50 to $0.75
wre31HfyzQGpIvID1istxw: folds 
gehe91e0IyVT0QU/XBkEyg: folds 
FcL757vvzKRPFZ6h7YsPHA joins the table at seat #1 
E0iYnEVO2ho7dH3QcCjw7g: folds 
rQhYIYXSyH/IivYM1dlV5A: folds 
CgIo2ItZqi4o3ayVG6HanQ: folds 
clJsV3v77RS07bDKY+705w: folds 
Uncalled bet ($0.50) returned to BT6Oal0iO4P6kDuT7HFQDw
BT6Oal0iO4P6kDuT7HFQDw collected $0.85 from pot
BT6Oal0iO4P6kDuT7HFQDw: doesn't show hand 
*** SUMMARY ***
Total pot $0.85 | Rake $0 
Seat 3: clJsV3v77RS07bDKY+705w (big blind) folded before Flop
Seat 4: BT6Oal0iO4P6kDuT7HFQDw collected ($0.85)
Seat 5: wre31HfyzQGpIvID1istxw folded before Flop (didn't bet)
Seat 6: gehe91e0IyVT0QU/XBkEyg folded before Flop (didn't bet)
Seat 7: E0iYnEVO2ho7dH3QcCjw7g folded before Flop
Seat 8: rQhYIYXSyH/IivYM1dlV5A (button) folded before Flop (didn't bet)
Seat 9: CgIo2ItZqi4o3ayVG6HanQ (small blind) folded before Flop




PokerStars Game #59941855414:  Hold'em No Limit ($0.10/$0.25) - 2009/07/01 1:48:18 ET
Table 'oJpFwZj9+FUGHX90Un8s9Q' 6-max Seat #1 is the button
Seat 1: 6DwBRH+xZ12AAZmeAg+aXw ($23.55 in chips) 
Seat 2: NtrVQ9UIql0rDCnKDKZ5FQ ($19.45 in chips) 
Seat 3: kyRaCIljYA6l33lSKQfNsg ($25 in chips) 
Seat 4: 6elpmfyt4Zw0yvd8lePSMQ ($20.90 in chips) 
Seat 5: kG34n23qFQA3nzdOJTQ1dA ($55.45 in chips) 
Seat 6: 7LpHJVeM6k1mQdC6HXYzww ($25 in chips) 
NtrVQ9UIql0rDCnKDKZ5FQ: posts small blind $0.10
kyRaCIljYA6l33lSKQfNsg: posts big blind $0.25
*** HOLE CARDS ***
6elpmfyt4Zw0yvd8lePSMQ: folds 
kG34n23qFQA3nzdOJTQ1dA: folds 
7LpHJVeM6k1mQdC6HXYzww: raises $0.55 to $0.80
6DwBRH+xZ12AAZmeAg+aXw: folds 
NtrVQ9UIql0rDCnKDKZ5FQ: folds 
kyRaCIljYA6l33lSKQfNsg: folds 
Uncalled bet ($0.55) returned to 7LpHJVeM6k1mQdC6HXYzww
7LpHJVeM6k1mQdC6HXYzww collected $0.60 from pot
7LpHJVeM6k1mQdC6HXYzww: doesn't show hand 
*** SUMMARY ***
Total pot $0.60 | Rake $0 
Seat 1: 6DwBRH+xZ12AAZmeAg+aXw (button) folded before Flop (didn't bet)
Seat 2: NtrVQ9UIql0rDCnKDKZ5FQ (small blind) folded before Flop
Seat 3: kyRaCIljYA6l33lSKQfNsg (big blind) folded before Flop
Seat 4: 6elpmfyt4Zw0yvd8lePSMQ folded before Flop (didn't bet)
Seat 5: kG34n23qFQA3nzdOJTQ1dA folded before Flop (didn't bet)
Seat 6: 7LpHJVeM6k1mQdC6HXYzww collected ($0.60)




PokerStars Game #59941855512:  Hold'em No Limit ($0.10/$0.25) - 2009/07/01 1:48:18 ET
Table '60nA7av6bws9VnNmVwculA' 6-max Seat #3 is the button
Seat 1: if4dh6jhJXeN3/qd3qCp9g ($24.65 in chips) 
Seat 2: Bada343Si4xKu3fNXY99AA ($2.75 in chips) 
Seat 3: mnuJq+Q1IXKm/pCy+OzxmQ ($21.65 in chips) 
Seat 4: +baiVgI/ETnBARLe5mARCw ($18.35 in chips) 
Seat 5: zXh+lOT41Q2iWgCNj+OcRw ($12.35 in chips) 
Seat 6: mfrkWA3PTeYPkbO6hi98Aw ($24.75 in chips) 
+baiVgI/ETnBARLe5mARCw: posts small blind $0.10
zXh+lOT41Q2iWgCNj+OcRw: posts big blind $0.25
*** HOLE CARDS ***
mfrkWA3PTeYPkbO6hi98Aw: folds 
if4dh6jhJXeN3/qd3qCp9g: folds 
Bada343Si4xKu3fNXY99AA: folds 
mnuJq+Q1IXKm/pCy+OzxmQ: calls $0.25
+baiVgI/ETnBARLe5mARCw: folds 
zXh+lOT41Q2iWgCNj+OcRw: checks 
*** FLOP *** [Qs 2d Th]
zXh+lOT41Q2iWgCNj+OcRw: bets $0.25
mnuJq+Q1IXKm/pCy+OzxmQ: calls $0.25
*** TURN *** [Qs 2d Th] [6s]
zXh+lOT41Q2iWgCNj+OcRw: bets $0.25
mnuJq+Q1IXKm/pCy+OzxmQ: calls $0.25
*** RIVER *** [Qs 2d Th 6s] [Js]
zXh+lOT41Q2iWgCNj+OcRw: checks 
mnuJq+Q1IXKm/pCy+OzxmQ: checks 
*** SHOW DOWN ***
zXh+lOT41Q2iWgCNj+OcRw: shows [As 2h] (a pair of Deuces)
mnuJq+Q1IXKm/pCy+OzxmQ: shows [9d Jd] (a pair of Jacks)
mnuJq+Q1IXKm/pCy+OzxmQ collected $1.55 from pot
*** SUMMARY ***
Total pot $1.60 | Rake $0.05 
Board [Qs 2d Th 6s Js]
Seat 1: if4dh6jhJXeN3/qd3qCp9g folded before Flop (didn't bet)
Seat 2: Bada343Si4xKu3fNXY99AA folded before Flop (didn't bet)
Seat 3: mnuJq+Q1IXKm/pCy+OzxmQ (button) showed [9d Jd] and won ($1.55) with a pair of Jacks
Seat 4: +baiVgI/ETnBARLe5mARCw (small blind) folded before Flop
Seat 5: zXh+lOT41Q2iWgCNj+OcRw (big blind) showed [As 2h] and lost with a pair of Deuces
Seat 6: mfrkWA3PTeYPkbO6hi98Aw folded before Flop (didn't bet)




PokerStars Game #59941855204:  Hold'em No Limit ($0.10/$0.25) - 2009/07/01 1:48:18 ET
Table 'KYX9dFNuOA9l2PV46IebqQ' 9-max Seat #6 is the button
Seat 1: qZqVFan2U+GAA/c5LQFbcw ($15.30 in chips) 
Seat 3: Uq3NSX4cIFaXe7pbXQuU+Q ($7.35 in chips) 
Seat 4: ly/lwri2xlF+wmFsvottuQ ($4.75 in chips) 
Seat 5: g7MXhRmNZxv1lIkKkUKa4w ($12.90 in chips) 
Seat 6: 4QYM+pWPc3J+6i8Zv8LvLg ($22.30 in chips) 
Seat 7: FVZtQJMz59M6BoiON/88Xg ($6.85 in chips) 
Seat 8: KRWTiGM4xH+MkvPtJz4+SA ($24.40 in chips) 
Seat 9: 6NECk10orj8iqgD3pZ2A0Q ($6.65 in chips) 
FVZtQJMz59M6BoiON/88Xg: posts small blind $0.10
KRWTiGM4xH+MkvPtJz4+SA: posts big blind $0.25
GeMoapCKDLc4ajT0Uk9ZQw: sits out 
*** HOLE CARDS ***
6NECk10orj8iqgD3pZ2A0Q: folds 
qZqVFan2U+GAA/c5LQFbcw: folds 
Uq3NSX4cIFaXe7pbXQuU+Q: folds 
ly/lwri2xlF+wmFsvottuQ: folds 
g7MXhRmNZxv1lIkKkUKa4w: folds 
4QYM+pWPc3J+6i8Zv8LvLg: calls $0.25
FVZtQJMz59M6BoiON/88Xg: calls $0.15
KRWTiGM4xH+MkvPtJz4+SA: checks 
*** FLOP *** [Qd 4s Tc]
FVZtQJMz59M6BoiON/88Xg: checks 
KRWTiGM4xH+MkvPtJz4+SA: bets $0.50
4QYM+pWPc3J+6i8Zv8LvLg: calls $0.50
FVZtQJMz59M6BoiON/88Xg: folds 
*** TURN *** [Qd 4s Tc] [9s]
KRWTiGM4xH+MkvPtJz4+SA: bets $0.50
4QYM+pWPc3J+6i8Zv8LvLg: calls $0.50
*** RIVER *** [Qd 4s Tc 9s] [Jd]
KRWTiGM4xH+MkvPtJz4+SA: checks 
4QYM+pWPc3J+6i8Zv8LvLg: bets $6.75
KRWTiGM4xH+MkvPtJz4+SA: folds 
Uncalled bet ($6.75) returned to 4QYM+pWPc3J+6i8Zv8LvLg
4QYM+pWPc3J+6i8Zv8LvLg collected $2.65 from pot
*** SUMMARY ***
Total pot $2.75 | Rake $0.10 
Board [Qd 4s Tc 9s Jd]
Seat 1: qZqVFan2U+GAA/c5LQFbcw folded before Flop (didn't bet)
Seat 3: Uq3NSX4cIFaXe7pbXQuU+Q folded before Flop (didn't bet)
Seat 4: ly/lwri2xlF+wmFsvottuQ folded before Flop (didn't bet)
Seat 5: g7MXhRmNZxv1lIkKkUKa4w folded before Flop (didn't bet)
Seat 6: 4QYM+pWPc3J+6i8Zv8LvLg (button) collected ($2.65)
Seat 7: FVZtQJMz59M6BoiON/88Xg (small blind) folded on the Flop
Seat 8: KRWTiGM4xH+MkvPtJz4+SA (big blind) folded on the River
Seat 9: 6NECk10orj8iqgD3pZ2A0Q folded before Flop (didn't bet)




PokerStars Game #59941855656:  Hold'em No Limit ($0.10/$0.25) - 2009/07/01 1:48:18 ET
Table '/AhP8uWRzEEhOATYIdmn0A' 9-max Seat #9 is the button
Seat 1: +sbyWwIcFp9kP0bDtMegfQ ($37.55 in chips) 
Seat 2: nx5EoCNZFR03YUOXyT22wQ ($17.30 in chips) 
Seat 3: jx6dnobNHstDG0tabsbKHQ ($3.30 in chips) 
Seat 4: bXpVeaSTPBFSPJmeXxO7nw ($6 in chips) 
Seat 6: 8EbrQ/EvFWt2cr0GaU82gQ ($5 in chips) 
Seat 7: cZ99hugmLBj9KhTlc8nCSw ($25 in chips) 
Seat 8: K86cg2ifCMFAlmzsfTDjig ($26.55 in chips) 
Seat 9: OfGfQFPcghysTDljS9GQSQ ($10.60 in chips) 
+sbyWwIcFp9kP0bDtMegfQ: posts small blind $0.10
nx5EoCNZFR03YUOXyT22wQ: posts big blind $0.25
iZ1f67Ok/207yzIQOu1Kdg: sits out 
*** HOLE CARDS ***
jx6dnobNHstDG0tabsbKHQ: folds 
bXpVeaSTPBFSPJmeXxO7nw: folds 
8EbrQ/EvFWt2cr0GaU82gQ: folds 
cZ99hugmLBj9KhTlc8nCSw: folds 
K86cg2ifCMFAlmzsfTDjig: calls $0.25
OfGfQFPcghysTDljS9GQSQ: folds 
+sbyWwIcFp9kP0bDtMegfQ: folds 
nx5EoCNZFR03YUOXyT22wQ: raises $0.50 to $0.75
K86cg2ifCMFAlmzsfTDjig: calls $0.50
*** FLOP *** [3c 8h 5c]
nx5EoCNZFR03YUOXyT22wQ: bets $1.50
K86cg2ifCMFAlmzsfTDjig: calls $1.50
*** TURN *** [3c 8h 5c] [9d]
nx5EoCNZFR03YUOXyT22wQ: bets $3.25
K86cg2ifCMFAlmzsfTDjig: raises $3.25 to $6.50
nx5EoCNZFR03YUOXyT22wQ: raises $8.55 to $15.05 and is all-in
K86cg2ifCMFAlmzsfTDjig: calls $8.55
*** RIVER *** [3c 8h 5c 9d] [5s]
*** SHOW DOWN ***
nx5EoCNZFR03YUOXyT22wQ: shows [Tc Th] (two pair, Tens and Fives)
K86cg2ifCMFAlmzsfTDjig: shows [7c 6h] (a straight, Five to Nine)
K86cg2ifCMFAlmzsfTDjig collected $33 from pot
*** SUMMARY ***
Total pot $34.70 | Rake $1.70 
Board [3c 8h 5c 9d 5s]
Seat 1: +sbyWwIcFp9kP0bDtMegfQ (small blind) folded before Flop
Seat 2: nx5EoCNZFR03YUOXyT22wQ (big blind) showed [Tc Th] and lost with two pair, Tens and Fives
Seat 3: jx6dnobNHstDG0tabsbKHQ folded before Flop (didn't bet)
Seat 4: bXpVeaSTPBFSPJmeXxO7nw folded before Flop (didn't bet)
Seat 6: 8EbrQ/EvFWt2cr0GaU82gQ folded before Flop (didn't bet)
Seat 7: cZ99hugmLBj9KhTlc8nCSw folded before Flop (didn't bet)
Seat 8: K86cg2ifCMFAlmzsfTDjig showed [7c 6h] and won ($33) with a straight, Five to Nine
Seat 9: OfGfQFPcghysTDljS9GQSQ (button) folded before Flop (didn't bet)




PokerStars Game #59941855218:  Hold'em No Limit ($0.10/$0.25) - 2009/07/01 1:48:18 ET
Table 'AJGgX1ZYM8d68SWMvaLttg' 6-max Seat #1 is the button
Seat 1: Q1uciOZPBR/WkAlqa6cL4A ($25 in chips) 
Seat 2: zHHLkD2sRljslKKeQv/ZQw ($25.10 in chips) 
Seat 3: 8ClCHtFXGNplITm+63KB+Q ($38.70 in chips) 
Seat 4: e30C3DfdG5TfPnR16/oMmA ($20.35 in chips) 
Seat 5: Hsvkc0/G2VV78oVmWYXecw ($5 in chips) 
zHHLkD2sRljslKKeQv/ZQw: posts small blind $0.10
8ClCHtFXGNplITm+63KB+Q: posts big blind $0.25
UA5OsKS3VPaxa7uC8La/kA: sits out 
*** HOLE CARDS ***
e30C3DfdG5TfPnR16/oMmA: raises $0.25 to $0.50
Hsvkc0/G2VV78oVmWYXecw: folds 
Q1uciOZPBR/WkAlqa6cL4A: folds 
zHHLkD2sRljslKKeQv/ZQw: folds 
8ClCHtFXGNplITm+63KB+Q: folds 
Uncalled bet ($0.25) returned to e30C3DfdG5TfPnR16/oMmA
e30C3DfdG5TfPnR16/oMmA collected $0.60 from pot
*** SUMMARY ***
Total pot $0.60 | Rake $0 
Seat 1: Q1uciOZPBR/WkAlqa6cL4A (button) folded before Flop (didn't bet)
Seat 2: zHHLkD2sRljslKKeQv/ZQw (small blind) folded before Flop
Seat 3: 8ClCHtFXGNplITm+63KB+Q (big blind) folded before Flop
Seat 4: e30C3DfdG5TfPnR16/oMmA collected ($0.60)
Seat 5: Hsvkc0/G2VV78oVmWYXecw folded before Flop (didn't bet)




PokerStars Game #59941855906:  Hold'em No Limit ($0.10/$0.25) - 2009/07/01 1:48:19 ET
Table 'Qr+t8WGovMECkBv+cV1lrg' 6-max Seat #3 is the button
Seat 1: EeUZtMU058v2ObUACOF4Og ($44.75 in chips) 
Seat 2: vqWjZmdQu/Hxw96/IJTWdQ ($41.60 in chips) 
Seat 3: uZKkrGByYgd4/ZBX2d4z+w ($10.90 in chips) 
Seat 4: 1NNFfYMd5Hsphl/FYz9fNA ($59.90 in chips) 
Seat 6: 9U3ZKjCsarN0DjR6mSE8Ug ($14.35 in chips) 
1NNFfYMd5Hsphl/FYz9fNA: posts small blind $0.10
9q7YGTKe9k5fYb4fmZc3Ww: is sitting out 
9U3ZKjCsarN0DjR6mSE8Ug: posts big blind $0.25
*** HOLE CARDS ***
9q7YGTKe9k5fYb4fmZc3Ww leaves the table
EeUZtMU058v2ObUACOF4Og: folds 
vqWjZmdQu/Hxw96/IJTWdQ: folds 
I50OxuNg9riRq9sywF6jMQ joins the table at seat #5 
uZKkrGByYgd4/ZBX2d4z+w: folds 
1NNFfYMd5Hsphl/FYz9fNA: folds 
Uncalled bet ($0.15) returned to 9U3ZKjCsarN0DjR6mSE8Ug
9U3ZKjCsarN0DjR6mSE8Ug collected $0.20 from pot
9U3ZKjCsarN0DjR6mSE8Ug: doesn't show hand 
*** SUMMARY ***
Total pot $0.20 | Rake $0 
Seat 1: EeUZtMU058v2ObUACOF4Og folded before Flop (didn't bet)
Seat 2: vqWjZmdQu/Hxw96/IJTWdQ folded before Flop (didn't bet)
Seat 3: uZKkrGByYgd4/ZBX2d4z+w (button) folded before Flop (didn't bet)
Seat 4: 1NNFfYMd5Hsphl/FYz9fNA (small blind) folded before Flop
Seat 6: 9U3ZKjCsarN0DjR6mSE8Ug (big blind) collected ($0.20)




PokerStars Game #59941856016:  Hold'em No Limit ($0.10/$0.25) - 2009/07/01 1:48:19 ET
Table 'ZEXL6Wh4qA4Afx8NnoBBAA' 6-max Seat #4 is the button
Seat 1: v8m8XHovI5tqEA9mvplDSw ($27.45 in chips) 
Seat 2: 6DwBRH+xZ12AAZmeAg+aXw ($23.50 in chips) 
Seat 3: +ZlnqPoP3Hg4BIUxDfKd/A ($31.70 in chips) 
Seat 4: FpN4KbLjlyRRKiVaQcoLqA ($26.85 in chips) 
Seat 5: if4dh6jhJXeN3/qd3qCp9g ($39.65 in chips) 
Seat 6: Lh8SlCq3OSDKWLUgAI/Lxw ($1.75 in chips) 
if4dh6jhJXeN3/qd3qCp9g: posts small blind $0.10
Lh8SlCq3OSDKWLUgAI/Lxw: posts big blind $0.25
*** HOLE CARDS ***
v8m8XHovI5tqEA9mvplDSw: folds 
6DwBRH+xZ12AAZmeAg+aXw: folds 
+ZlnqPoP3Hg4BIUxDfKd/A: folds 
FpN4KbLjlyRRKiVaQcoLqA: folds 
if4dh6jhJXeN3/qd3qCp9g: folds 
Uncalled bet ($0.15) returned to Lh8SlCq3OSDKWLUgAI/Lxw
Lh8SlCq3OSDKWLUgAI/Lxw collected $0.20 from pot
Lh8SlCq3OSDKWLUgAI/Lxw: doesn't show hand 
*** SUMMARY ***
Total pot $0.20 | Rake $0 
Seat 1: v8m8XHovI5tqEA9mvplDSw folded before Flop (didn't bet)
Seat 2: 6DwBRH+xZ12AAZmeAg+aXw folded before Flop (didn't bet)
Seat 3: +ZlnqPoP3Hg4BIUxDfKd/A folded before Flop (didn't bet)
Seat 4: FpN4KbLjlyRRKiVaQcoLqA (button) folded before Flop (didn't bet)
Seat 5: if4dh6jhJXeN3/qd3qCp9g (small blind) folded before Flop
Seat 6: Lh8SlCq3OSDKWLUgAI/Lxw (big blind) collected ($0.20)




PokerStars Game #59941855798:  Hold'em No Limit ($0.10/$0.25) - 2009/07/01 1:48:19 ET
Table 'aaXqTKUnxrX9DYXtxhWXxA' 6-max Seat #6 is the button
Seat 1: aSrj4lVmn2owyQ1RbbOqxQ ($26.90 in chips) 
Seat 2: DE9hRlt14g+JdsRQ4wT7hg ($33.35 in chips) 
Seat 3: uUXdcVMNa05rfbntdvplfw ($7.90 in chips) 
Seat 4: 48oT5xFI+5CHUJlfoGrE4w ($8.80 in chips) 
Seat 5: kyRaCIljYA6l33lSKQfNsg ($23.85 in chips) 
Seat 6: buyjetgNT1McXtdaP4zynA ($51.50 in chips) 
aSrj4lVmn2owyQ1RbbOqxQ: posts small blind $0.10
DE9hRlt14g+JdsRQ4wT7hg: posts big blind $0.25
*** HOLE CARDS ***
uUXdcVMNa05rfbntdvplfw: raises $0.25 to $0.50
48oT5xFI+5CHUJlfoGrE4w: folds 
kyRaCIljYA6l33lSKQfNsg: folds 
buyjetgNT1McXtdaP4zynA: folds 
aSrj4lVmn2owyQ1RbbOqxQ: calls $0.40
DE9hRlt14g+JdsRQ4wT7hg: calls $0.25
*** FLOP *** [3d 4s 6h]
aSrj4lVmn2owyQ1RbbOqxQ: checks 
DE9hRlt14g+JdsRQ4wT7hg: checks 
uUXdcVMNa05rfbntdvplfw: bets $1
aSrj4lVmn2owyQ1RbbOqxQ: folds 
DE9hRlt14g+JdsRQ4wT7hg: folds 
Uncalled bet ($1) returned to uUXdcVMNa05rfbntdvplfw
uUXdcVMNa05rfbntdvplfw collected $1.45 from pot
*** SUMMARY ***
Total pot $1.50 | Rake $0.05 
Board [3d 4s 6h]
Seat 1: aSrj4lVmn2owyQ1RbbOqxQ (small blind) folded on the Flop
Seat 2: DE9hRlt14g+JdsRQ4wT7hg (big blind) folded on the Flop
Seat 3: uUXdcVMNa05rfbntdvplfw collected ($1.45)
Seat 4: 48oT5xFI+5CHUJlfoGrE4w folded before Flop (didn't bet)
Seat 5: kyRaCIljYA6l33lSKQfNsg folded before Flop (didn't bet)
Seat 6: buyjetgNT1McXtdaP4zynA (button) folded before Flop (didn't bet)




PokerStars Game #59941856018:  Hold'em No Limit ($0.10/$0.25) - 2009/07/01 1:48:19 ET
Table 'QegsWX65l3n/K0A8XB78yg' 6-max Seat #2 is the button
Seat 1: p6adJRMXMBLr+xtQzqazIQ ($12 in chips) 
Seat 2: GC/9yVD59DUCX7hUI7gcLw ($57 in chips) 
Seat 3: iIgNoBh+3/Ix1/fLsg+HuA ($5.75 in chips) 
Seat 4: epAUIB7h2FJXzUPRIvSkRA ($25 in chips) 
Seat 5: QqiZLFrN8iOUT/GHw7ztOA ($29.30 in chips) 
Seat 6: 5PWs02z65jSO5pr/M6wx/w ($6.45 in chips) 
iIgNoBh+3/Ix1/fLsg+HuA: posts small blind $0.10
epAUIB7h2FJXzUPRIvSkRA: posts big blind $0.25
*** HOLE CARDS ***
QqiZLFrN8iOUT/GHw7ztOA: folds 
5PWs02z65jSO5pr/M6wx/w: folds 
p6adJRMXMBLr+xtQzqazIQ: raises $0.75 to $1
GC/9yVD59DUCX7hUI7gcLw: folds 
iIgNoBh+3/Ix1/fLsg+HuA: folds 
epAUIB7h2FJXzUPRIvSkRA: folds 
Uncalled bet ($0.75) returned to p6adJRMXMBLr+xtQzqazIQ
p6adJRMXMBLr+xtQzqazIQ collected $0.60 from pot
*** SUMMARY ***
Total pot $0.60 | Rake $0 
Seat 1: p6adJRMXMBLr+xtQzqazIQ collected ($0.60)
Seat 2: GC/9yVD59DUCX7hUI7gcLw (button) folded before Flop (didn't bet)
Seat 3: iIgNoBh+3/Ix1/fLsg+HuA (small blind) folded before Flop
Seat 4: epAUIB7h2FJXzUPRIvSkRA (big blind) folded before Flop
Seat 5: QqiZLFrN8iOUT/GHw7ztOA folded before Flop (didn't bet)
Seat 6: 5PWs02z65jSO5pr/M6wx/w folded before Flop (didn't bet)




PokerStars Game #59941855744:  Hold'em No Limit ($0.10/$0.25) - 2009/07/01 1:48:19 ET
Table 'BpNkESDX1ip9c0K1hb5h7A' 6-max Seat #3 is the button
Seat 1: 5YZdVjBPZVEdubN4xEMPEg ($15.50 in chips) 
Seat 2: 9U3ZKjCsarN0DjR6mSE8Ug ($19.60 in chips) 
Seat 3: fZQg9veL7Dd/Z04ZTjC+wQ ($37.65 in chips) 
Seat 4: kG34n23qFQA3nzdOJTQ1dA ($26.60 in chips) 
Seat 5: OMGl+YMGogf2JWIRfT2/Yg ($5 in chips) 
Seat 6: 8EEqTTh7T1q48sYDqbI2Xg ($19.50 in chips) 
kG34n23qFQA3nzdOJTQ1dA: posts small blind $0.10
OMGl+YMGogf2JWIRfT2/Yg: posts big blind $0.25
*** HOLE CARDS ***
8EEqTTh7T1q48sYDqbI2Xg: calls $0.25
5YZdVjBPZVEdubN4xEMPEg: raises $0.50 to $0.75
9U3ZKjCsarN0DjR6mSE8Ug: folds 
fZQg9veL7Dd/Z04ZTjC+wQ: folds 
kG34n23qFQA3nzdOJTQ1dA: folds 
OMGl+YMGogf2JWIRfT2/Yg: calls $0.50
8EEqTTh7T1q48sYDqbI2Xg: calls $0.50
*** FLOP *** [Qc 3s Td]
OMGl+YMGogf2JWIRfT2/Yg: checks 
8EEqTTh7T1q48sYDqbI2Xg: checks 
5YZdVjBPZVEdubN4xEMPEg: bets $0.75
OMGl+YMGogf2JWIRfT2/Yg: folds 
8EEqTTh7T1q48sYDqbI2Xg: calls $0.75
*** TURN *** [Qc 3s Td] [3h]
8EEqTTh7T1q48sYDqbI2Xg: checks 
5YZdVjBPZVEdubN4xEMPEg: checks 
*** RIVER *** [Qc 3s Td 3h] [Jh]
8EEqTTh7T1q48sYDqbI2Xg: bets $1.50
5YZdVjBPZVEdubN4xEMPEg: calls $1.50
*** SHOW DOWN ***
8EEqTTh7T1q48sYDqbI2Xg: shows [Qs Ks] (two pair, Queens and Threes)
5YZdVjBPZVEdubN4xEMPEg: mucks hand 
8EEqTTh7T1q48sYDqbI2Xg collected $6.55 from pot
*** SUMMARY ***
Total pot $6.85 | Rake $0.30 
Board [Qc 3s Td 3h Jh]
Seat 1: 5YZdVjBPZVEdubN4xEMPEg mucked
Seat 2: 9U3ZKjCsarN0DjR6mSE8Ug folded before Flop (didn't bet)
Seat 3: fZQg9veL7Dd/Z04ZTjC+wQ (button) folded before Flop (didn't bet)
Seat 4: kG34n23qFQA3nzdOJTQ1dA (small blind) folded before Flop
Seat 5: OMGl+YMGogf2JWIRfT2/Yg (big blind) folded on the Flop
Seat 6: 8EEqTTh7T1q48sYDqbI2Xg showed [Qs Ks] and won ($6.55) with two pair, Queens and Threes




PokerStars Game #59941855900:  Hold'em No Limit ($0.10/$0.25) - 2009/07/01 1:48:19 ET
Table 'Mef6A0EMopL6WaFO5/KO9g' 6-max Seat #3 is the button
Seat 1: GbCVUNssQ7mqsPWr7J4d3w ($5 in chips) 
Seat 2: 8ClCHtFXGNplITm+63KB+Q ($29.70 in chips) 
Seat 3: Wq26opBLDGJe91GRJn2epg ($17.80 in chips) 
Seat 4: lquriepNQBhDV5P1SWHhnA ($25 in chips) 
Seat 5: DihMHaz4WNETH1bPDe13kA ($25 in chips) 
Seat 6: jp34e617tIzV8tKIWmfAbA ($37.55 in chips) 
lquriepNQBhDV5P1SWHhnA: posts small blind $0.10
DihMHaz4WNETH1bPDe13kA: posts big blind $0.25
*** HOLE CARDS ***
jp34e617tIzV8tKIWmfAbA: folds 
GbCVUNssQ7mqsPWr7J4d3w: folds 
8ClCHtFXGNplITm+63KB+Q: folds 
Wq26opBLDGJe91GRJn2epg: raises $0.50 to $0.75
lquriepNQBhDV5P1SWHhnA: folds 
DihMHaz4WNETH1bPDe13kA: raises $1.60 to $2.35
Wq26opBLDGJe91GRJn2epg: calls $1.60
*** FLOP *** [Qh Ad 8c]
DihMHaz4WNETH1bPDe13kA: bets $3.55
Wq26opBLDGJe91GRJn2epg: raises $11.90 to $15.45 and is all-in
DihMHaz4WNETH1bPDe13kA: calls $11.90
*** TURN *** [Qh Ad 8c] [9s]
*** RIVER *** [Qh Ad 8c 9s] [6h]
*** SHOW DOWN ***
DihMHaz4WNETH1bPDe13kA: shows [Jh Th] (a straight, Eight to Queen)
Wq26opBLDGJe91GRJn2epg: mucks hand 
DihMHaz4WNETH1bPDe13kA collected $33.95 from pot
*** SUMMARY ***
Total pot $35.70 | Rake $1.75 
Board [Qh Ad 8c 9s 6h]
Seat 1: GbCVUNssQ7mqsPWr7J4d3w folded before Flop (didn't bet)
Seat 2: 8ClCHtFXGNplITm+63KB+Q folded before Flop (didn't bet)
Seat 3: Wq26opBLDGJe91GRJn2epg (button) mucked
Seat 4: lquriepNQBhDV5P1SWHhnA (small blind) folded before Flop
Seat 5: DihMHaz4WNETH1bPDe13kA (big blind) showed [Jh Th] and won ($33.95) with a straight, Eight to Queen
Seat 6: jp34e617tIzV8tKIWmfAbA folded before Flop (didn't bet)




PokerStars Game #59941856380:  Hold'em No Limit ($0.10/$0.25) - 2009/07/01 1:48:20 ET
Table 'Pz8SfAzhP5nvWTsJRAxoDg' 6-max Seat #4 is the button
Seat 1: QiL+lEgEWwy21jk/ltaRLg ($47.15 in chips) 
Seat 2: k021eD5in2AjaloW5PalMg ($18.80 in chips) 
Seat 3: mfrkWA3PTeYPkbO6hi98Aw ($26.60 in chips) 
Seat 4: 4lJto+Qj0K4JrFKvHaPTLw ($67.65 in chips) 
Seat 5: FYepjhAvF8ZdVCmqHIy+eQ ($25 in chips) 
Seat 6: QvTX2yGq3uKJiKPmns4TKQ ($18.05 in chips) 
FYepjhAvF8ZdVCmqHIy+eQ: posts small blind $0.10
QvTX2yGq3uKJiKPmns4TKQ: posts big blind $0.25
*** HOLE CARDS ***
QiL+lEgEWwy21jk/ltaRLg: folds 
k021eD5in2AjaloW5PalMg: folds 
mfrkWA3PTeYPkbO6hi98Aw: raises $0.75 to $1
4lJto+Qj0K4JrFKvHaPTLw: calls $1
FYepjhAvF8ZdVCmqHIy+eQ: folds 
QvTX2yGq3uKJiKPmns4TKQ: folds 
*** FLOP *** [7s 4h 7d]
mfrkWA3PTeYPkbO6hi98Aw: bets $1.75
4lJto+Qj0K4JrFKvHaPTLw: raises $2.25 to $4
mfrkWA3PTeYPkbO6hi98Aw: raises $6 to $10
4lJto+Qj0K4JrFKvHaPTLw: folds 
Uncalled bet ($6) returned to mfrkWA3PTeYPkbO6hi98Aw
mfrkWA3PTeYPkbO6hi98Aw collected $9.85 from pot
mfrkWA3PTeYPkbO6hi98Aw: doesn't show hand 
*** SUMMARY ***
Total pot $10.35 | Rake $0.50 
Board [7s 4h 7d]
Seat 1: QiL+lEgEWwy21jk/ltaRLg folded before Flop (didn't bet)
Seat 2: k021eD5in2AjaloW5PalMg folded before Flop (didn't bet)
Seat 3: mfrkWA3PTeYPkbO6hi98Aw collected ($9.85)
Seat 4: 4lJto+Qj0K4JrFKvHaPTLw (button) folded on the Flop
Seat 5: FYepjhAvF8ZdVCmqHIy+eQ (small blind) folded before Flop
Seat 6: QvTX2yGq3uKJiKPmns4TKQ (big blind) folded before Flop




PokerStars Game #59941856368:  Hold'em No Limit ($0.10/$0.25) - 2009/07/01 1:48:20 ET
Table '+VTTYgQLH1awDHk+IAxqGg' 9-max Seat #5 is the button
Seat 1: arxNSjreDRGFg13EAM2F1w ($26.90 in chips) 
Seat 2: 2wcFsZsqEP5w1StUTVzJCg ($5.85 in chips) 
Seat 3: AiXn/9o1EwOPZUHujnh/bA ($11.65 in chips) 
Seat 4: gE5rN2TDY1aXcZn/TOPeZw ($9.40 in chips) 
Seat 5: sD+TKtt36XiiN6jqHiLwDA ($24.80 in chips) 
Seat 7: ljemhp25Zg+nlA9DLCIiUw ($24 in chips) 
Seat 8: 10vzP4r6ldwGLbYHKd9www ($19.65 in chips) 
Seat 9: S7Ki0P+0AIGPuIfGJjW0gg ($61 in chips) 
ljemhp25Zg+nlA9DLCIiUw: posts small blind $0.10
10vzP4r6ldwGLbYHKd9www: posts big blind $0.25
*** HOLE CARDS ***
S7Ki0P+0AIGPuIfGJjW0gg: folds 
arxNSjreDRGFg13EAM2F1w: folds 
2wcFsZsqEP5w1StUTVzJCg: raises $0.25 to $0.50
AiXn/9o1EwOPZUHujnh/bA: folds 
gE5rN2TDY1aXcZn/TOPeZw: calls $0.50
sD+TKtt36XiiN6jqHiLwDA: folds 
ljemhp25Zg+nlA9DLCIiUw: folds 
10vzP4r6ldwGLbYHKd9www: calls $0.25
*** FLOP *** [9c 2s Kd]
I_EAT_ACES89 leaves the table
10vzP4r6ldwGLbYHKd9www: checks 
2wcFsZsqEP5w1StUTVzJCg: bets $1
gE5rN2TDY1aXcZn/TOPeZw: folds 
10vzP4r6ldwGLbYHKd9www: folds 
Uncalled bet ($1) returned to 2wcFsZsqEP5w1StUTVzJCg
2wcFsZsqEP5w1StUTVzJCg collected $1.55 from pot
*** SUMMARY ***
Total pot $1.60 | Rake $0.05 
Board [9c 2s Kd]
Seat 1: arxNSjreDRGFg13EAM2F1w folded before Flop (didn't bet)
Seat 2: 2wcFsZsqEP5w1StUTVzJCg collected ($1.55)
Seat 3: AiXn/9o1EwOPZUHujnh/bA folded before Flop (didn't bet)
Seat 4: gE5rN2TDY1aXcZn/TOPeZw folded on the Flop
Seat 5: sD+TKtt36XiiN6jqHiLwDA (button) folded before Flop (didn't bet)
Seat 7: ljemhp25Zg+nlA9DLCIiUw (small blind) folded before Flop
Seat 8: 10vzP4r6ldwGLbYHKd9www (big blind) folded on the Flop
Seat 9: S7Ki0P+0AIGPuIfGJjW0gg folded before Flop (didn't bet)




PokerStars Game #59941856506:  Hold'em No Limit ($0.10/$0.25) - 2009/07/01 1:48:20 ET
Table '+fuYjvJy9okLr23QyZtanA' 9-max Seat #5 is the button
Seat 2: tLcDklc2rBORNfixyRfVfw ($25 in chips) 
Seat 3: eK8qa6EPcH2zhtbmWSvc9g ($52.30 in chips) 
Seat 4: Bb42QRQMhg5/Y0vHP8/2Xw ($30.15 in chips) 
Seat 5: bXpVeaSTPBFSPJmeXxO7nw ($4.30 in chips) 
Seat 6: wGigCmBR/9XWkPpvYos3aQ ($30.80 in chips) 
Seat 7: dfNim92Z6XK1/h5SFW5vDg ($37.50 in chips) 
Seat 8: KqS/lY/fNB9qUxokm9QfeA ($8.70 in chips) 
Seat 9: OMhlmt2waO3z43ZSFNMmog ($29.95 in chips) 
wGigCmBR/9XWkPpvYos3aQ: posts small blind $0.10
dfNim92Z6XK1/h5SFW5vDg: posts big blind $0.25
*** HOLE CARDS ***
KqS/lY/fNB9qUxokm9QfeA: folds 
OMhlmt2waO3z43ZSFNMmog: folds 
tLcDklc2rBORNfixyRfVfw: folds 
eK8qa6EPcH2zhtbmWSvc9g: folds 
Bb42QRQMhg5/Y0vHP8/2Xw: folds 
bXpVeaSTPBFSPJmeXxO7nw: folds 
wGigCmBR/9XWkPpvYos3aQ: folds 
Uncalled bet ($0.15) returned to dfNim92Z6XK1/h5SFW5vDg
dfNim92Z6XK1/h5SFW5vDg collected $0.20 from pot
dfNim92Z6XK1/h5SFW5vDg: doesn't show hand 
*** SUMMARY ***
Total pot $0.20 | Rake $0 
Seat 2: tLcDklc2rBORNfixyRfVfw folded before Flop (didn't bet)
Seat 3: eK8qa6EPcH2zhtbmWSvc9g folded before Flop (didn't bet)
Seat 4: Bb42QRQMhg5/Y0vHP8/2Xw folded before Flop (didn't bet)
Seat 5: bXpVeaSTPBFSPJmeXxO7nw (button) folded before Flop (didn't bet)
Seat 6: wGigCmBR/9XWkPpvYos3aQ (small blind) folded before Flop
Seat 7: dfNim92Z6XK1/h5SFW5vDg (big blind) collected ($0.20)
Seat 8: KqS/lY/fNB9qUxokm9QfeA folded before Flop (didn't bet)
Seat 9: OMhlmt2waO3z43ZSFNMmog folded before Flop (didn't bet)




PokerStars Game #59941856458:  Hold'em No Limit ($0.10/$0.25) - 2009/07/01 1:48:20 ET
Table '6wawJ+MkkvuC3coG6r+Yhg' 6-max Seat #3 is the button
Seat 1: JQZew0FjzS19kTjeNtrE+A ($19.85 in chips) 
Seat 2: LtASJ9OlkqGrrUKGQlpGAw ($33.80 in chips) 
Seat 3: 3zD3qLXT1bEffAoWGnc7wg ($61.25 in chips) 
Seat 5: FZrgDbxAanC1xwZxXHJKVA ($4.30 in chips) 
Seat 6: B3X187C0tXFUfQpCu8pe8A ($25.15 in chips) 
FZrgDbxAanC1xwZxXHJKVA: posts small blind $0.10
B3X187C0tXFUfQpCu8pe8A: posts big blind $0.25
*** HOLE CARDS ***
yxmjNFGiKI3b+XQGJzJVIg leaves the table
JQZew0FjzS19kTjeNtrE+A: folds 
LtASJ9OlkqGrrUKGQlpGAw: raises $0.50 to $0.75
3zD3qLXT1bEffAoWGnc7wg: folds 
FZrgDbxAanC1xwZxXHJKVA: folds 
B3X187C0tXFUfQpCu8pe8A: folds 
Uncalled bet ($0.50) returned to LtASJ9OlkqGrrUKGQlpGAw
LtASJ9OlkqGrrUKGQlpGAw collected $0.60 from pot
LtASJ9OlkqGrrUKGQlpGAw: doesn't show hand 
*** SUMMARY ***
Total pot $0.60 | Rake $0 
Seat 1: JQZew0FjzS19kTjeNtrE+A folded before Flop (didn't bet)
Seat 2: LtASJ9OlkqGrrUKGQlpGAw collected ($0.60)
Seat 3: 3zD3qLXT1bEffAoWGnc7wg (button) folded before Flop (didn't bet)
Seat 5: FZrgDbxAanC1xwZxXHJKVA (small blind) folded before Flop
Seat 6: B3X187C0tXFUfQpCu8pe8A (big blind) folded before Flop




PokerStars Game #59941856570:  Hold'em No Limit ($0.10/$0.25) - 2009/07/01 1:48:20 ET
Table 'Xi38lWH8L2JHRAsKYVX8Qg' 6-max Seat #3 is the button
Seat 1: shP7DFAtX7gXcgMJX/OmRQ ($22.55 in chips) 
Seat 3: 6DwBRH+xZ12AAZmeAg+aXw ($31.20 in chips) 
Seat 4: kG34n23qFQA3nzdOJTQ1dA ($24.50 in chips) 
Seat 5: 79ID/ub1Pt/mDpCprVmOoA ($77.60 in chips) 
Seat 6: kyRaCIljYA6l33lSKQfNsg ($30.10 in chips) 
kG34n23qFQA3nzdOJTQ1dA: posts small blind $0.10
79ID/ub1Pt/mDpCprVmOoA: posts big blind $0.25
*** HOLE CARDS ***
kyRaCIljYA6l33lSKQfNsg: folds 
shP7DFAtX7gXcgMJX/OmRQ: calls $0.25
6DwBRH+xZ12AAZmeAg+aXw: folds 
kG34n23qFQA3nzdOJTQ1dA: folds 
79ID/ub1Pt/mDpCprVmOoA: checks 
*** FLOP *** [As Kc 9d]
79ID/ub1Pt/mDpCprVmOoA: checks 
shP7DFAtX7gXcgMJX/OmRQ: checks 
*** TURN *** [As Kc 9d] [5s]
79ID/ub1Pt/mDpCprVmOoA: checks 
shP7DFAtX7gXcgMJX/OmRQ: bets $0.75
79ID/ub1Pt/mDpCprVmOoA: folds 
Uncalled bet ($0.75) returned to shP7DFAtX7gXcgMJX/OmRQ
shP7DFAtX7gXcgMJX/OmRQ collected $0.60 from pot
shP7DFAtX7gXcgMJX/OmRQ: doesn't show hand 
*** SUMMARY ***
Total pot $0.60 | Rake $0 
Board [As Kc 9d 5s]
Seat 1: shP7DFAtX7gXcgMJX/OmRQ collected ($0.60)
Seat 3: 6DwBRH+xZ12AAZmeAg+aXw (button) folded before Flop (didn't bet)
Seat 4: kG34n23qFQA3nzdOJTQ1dA (small blind) folded before Flop
Seat 5: 79ID/ub1Pt/mDpCprVmOoA (big blind) folded on the Turn
Seat 6: kyRaCIljYA6l33lSKQfNsg folded before Flop (didn't bet)




PokerStars Game #59941857210:  Hold'em No Limit ($0.10/$0.25) - 2009/07/01 1:48:21 ET
Table '0M5QEJGOThqZwQ/sjbjXYw' 6-max Seat #4 is the button
Seat 2: /gJNBeCkWL4o85/jvlZ4BA ($34.60 in chips) 
Seat 3: 3zD3qLXT1bEffAoWGnc7wg ($25 in chips) 
Seat 4: oBUDUfeUyCbZBsjxHZgSiw ($21.90 in chips) 
Seat 5: cWc85bEzdRzpUMhRKm8pwQ ($33.25 in chips) 
Seat 6: bb63I02U6p9a5MNFa1gCiw ($21.35 in chips) 
cWc85bEzdRzpUMhRKm8pwQ: posts small blind $0.10
bb63I02U6p9a5MNFa1gCiw: posts big blind $0.25
*** HOLE CARDS ***
/gJNBeCkWL4o85/jvlZ4BA: folds 
3zD3qLXT1bEffAoWGnc7wg: folds 
oBUDUfeUyCbZBsjxHZgSiw: folds 
cWc85bEzdRzpUMhRKm8pwQ: folds 
Uncalled bet ($0.15) returned to bb63I02U6p9a5MNFa1gCiw
bb63I02U6p9a5MNFa1gCiw collected $0.20 from pot
bb63I02U6p9a5MNFa1gCiw: doesn't show hand 
*** SUMMARY ***
Total pot $0.20 | Rake $0 
Seat 2: /gJNBeCkWL4o85/jvlZ4BA folded before Flop (didn't bet)
Seat 3: 3zD3qLXT1bEffAoWGnc7wg folded before Flop (didn't bet)
Seat 4: oBUDUfeUyCbZBsjxHZgSiw (button) folded before Flop (didn't bet)
Seat 5: cWc85bEzdRzpUMhRKm8pwQ (small blind) folded before Flop
Seat 6: bb63I02U6p9a5MNFa1gCiw (big blind) collected ($0.20)




PokerStars Game #59941857154:  Hold'em No Limit ($0.10/$0.25) - 2009/07/01 1:48:21 ET
Table '3lS+sU5k6mwJCS2nFMmQ6Q' 9-max Seat #1 is the button
Seat 1: VWUWpMLMj/Q1jRVpF7Aohw ($13.55 in chips) 
Seat 2: PdIasPkzm2sqZnN41ZRXOg ($4.75 in chips) 
Seat 3: 1DXccE2UUK5DIRVGlOKnTA ($12.45 in chips) 
Seat 4: ydoFOVgzvZv9ZhuWu9rXAw ($10.70 in chips) 
Seat 5: NcPAt5YjVvDFEJTTgAVj8g ($5.25 in chips) 
Seat 6: hJ4uYjNmSZdjrKA8cjZqCA ($35.75 in chips) 
Seat 7: Th3FldXKQW6hWVVPahaoOQ ($31.55 in chips) 
Seat 8: 9lvO/qyU+xrU95Teu1fv0g ($5.25 in chips) 
Seat 9: 4awUyiDYTgylQKXZ9faBVA ($48.85 in chips) 
PdIasPkzm2sqZnN41ZRXOg: posts small blind $0.10
1DXccE2UUK5DIRVGlOKnTA: posts big blind $0.25
*** HOLE CARDS ***
ydoFOVgzvZv9ZhuWu9rXAw: folds 
ydoFOVgzvZv9ZhuWu9rXAw leaves the table
NcPAt5YjVvDFEJTTgAVj8g: calls $0.25
hJ4uYjNmSZdjrKA8cjZqCA: calls $0.25
Th3FldXKQW6hWVVPahaoOQ: folds 
9lvO/qyU+xrU95Teu1fv0g: calls $0.25
4awUyiDYTgylQKXZ9faBVA: folds 
VWUWpMLMj/Q1jRVpF7Aohw: folds 
PdIasPkzm2sqZnN41ZRXOg: raises $4.50 to $4.75 and is all-in
GeMoapCKDLc4ajT0Uk9ZQw joins the table at seat #4 
1DXccE2UUK5DIRVGlOKnTA: folds 
NcPAt5YjVvDFEJTTgAVj8g: folds 
hJ4uYjNmSZdjrKA8cjZqCA: folds 
9lvO/qyU+xrU95Teu1fv0g: folds 
Uncalled bet ($4.50) returned to PdIasPkzm2sqZnN41ZRXOg
NcPAt5YjVvDFEJTTgAVj8g is sitting out
PdIasPkzm2sqZnN41ZRXOg collected $1.25 from pot
PdIasPkzm2sqZnN41ZRXOg: doesn't show hand 
*** SUMMARY ***
Total pot $1.25 | Rake $0 
Seat 1: VWUWpMLMj/Q1jRVpF7Aohw (button) folded before Flop (didn't bet)
Seat 2: PdIasPkzm2sqZnN41ZRXOg (small blind) collected ($1.25)
Seat 3: 1DXccE2UUK5DIRVGlOKnTA (big blind) folded before Flop
Seat 4: ydoFOVgzvZv9ZhuWu9rXAw folded before Flop (didn't bet)
Seat 5: NcPAt5YjVvDFEJTTgAVj8g folded before Flop
Seat 6: hJ4uYjNmSZdjrKA8cjZqCA folded before Flop
Seat 7: Th3FldXKQW6hWVVPahaoOQ folded before Flop (didn't bet)
Seat 8: 9lvO/qyU+xrU95Teu1fv0g folded before Flop
Seat 9: 4awUyiDYTgylQKXZ9faBVA folded before Flop (didn't bet)




PokerStars Game #59941857232:  Hold'em No Limit ($0.10/$0.25) - 2009/07/01 1:48:21 ET
Table 'ouLhepGYovxB2x0QxH7cVg' 9-max Seat #4 is the button
Seat 1: ghNKXUBl/H+t83JF079ZBA ($25 in chips) 
Seat 2: r1Z5m4PwSI5ANp7qCE1OJw ($23.35 in chips) 
Seat 3: bXpVeaSTPBFSPJmeXxO7nw ($4.90 in chips) 
Seat 4: a0Sx6GHY7ln2Ns2C97eXeA ($37.10 in chips) 
Seat 5: v60REj6f8jzMYT0VsZvaPQ ($11 in chips) 
Seat 6: hYvTc4PYNrAaNAIVoM94Hw ($5 in chips) 
Seat 7: JRV2PblFtPFz51l0Fwyz8g ($24.25 in chips) 
Seat 8: tLcDklc2rBORNfixyRfVfw ($25.35 in chips) 
Seat 9: ljemhp25Zg+nlA9DLCIiUw ($25.30 in chips) 
v60REj6f8jzMYT0VsZvaPQ: posts small blind $0.10
hYvTc4PYNrAaNAIVoM94Hw: posts big blind $0.25
*** HOLE CARDS ***
JRV2PblFtPFz51l0Fwyz8g: folds 
tLcDklc2rBORNfixyRfVfw: folds 
ljemhp25Zg+nlA9DLCIiUw: folds 
ghNKXUBl/H+t83JF079ZBA: folds 
r1Z5m4PwSI5ANp7qCE1OJw: folds 
bXpVeaSTPBFSPJmeXxO7nw: folds 
a0Sx6GHY7ln2Ns2C97eXeA: raises $0.50 to $0.75
v60REj6f8jzMYT0VsZvaPQ: folds 
hYvTc4PYNrAaNAIVoM94Hw: folds 
Uncalled bet ($0.50) returned to a0Sx6GHY7ln2Ns2C97eXeA
a0Sx6GHY7ln2Ns2C97eXeA collected $0.60 from pot
*** SUMMARY ***
Total pot $0.60 | Rake $0 
Seat 1: ghNKXUBl/H+t83JF079ZBA folded before Flop (didn't bet)
Seat 2: r1Z5m4PwSI5ANp7qCE1OJw folded before Flop (didn't bet)
Seat 3: bXpVeaSTPBFSPJmeXxO7nw folded before Flop (didn't bet)
Seat 4: a0Sx6GHY7ln2Ns2C97eXeA (button) collected ($0.60)
Seat 5: v60REj6f8jzMYT0VsZvaPQ (small blind) folded before Flop
Seat 6: hYvTc4PYNrAaNAIVoM94Hw (big blind) folded before Flop
Seat 7: JRV2PblFtPFz51l0Fwyz8g folded before Flop (didn't bet)
Seat 8: tLcDklc2rBORNfixyRfVfw folded before Flop (didn't bet)
Seat 9: ljemhp25Zg+nlA9DLCIiUw folded before Flop (didn't bet)




PokerStars Game #59941856828:  Hold'em No Limit ($0.10/$0.25) - 2009/07/01 1:48:21 ET
Table '5SUMWYuPsGiOD0FY0QbgOw' 6-max Seat #3 is the button
Seat 1: SFmT9ZsVopnukjvAzrxTRg ($25 in chips) 
Seat 2: xrf8tAXKQHG99HixCot1Iw ($39.75 in chips) 
Seat 3: MqMK8OWPSY1V4stf1Hy5Jw ($38.70 in chips) 
Seat 4: BV+K0Phf5VBHr7aZPKqbUQ ($25 in chips) 
Seat 5: v+QfkGiuj9bgtuNoVnDO8w ($40.80 in chips) 
Seat 6: jA7YMtfNUnAaebB7Lj74EA ($23.80 in chips) 
BV+K0Phf5VBHr7aZPKqbUQ: posts small blind $0.10
v+QfkGiuj9bgtuNoVnDO8w: posts big blind $0.25
*** HOLE CARDS ***
jA7YMtfNUnAaebB7Lj74EA: calls $0.25
SFmT9ZsVopnukjvAzrxTRg: folds 
xrf8tAXKQHG99HixCot1Iw: folds 
MqMK8OWPSY1V4stf1Hy5Jw: raises $0.75 to $1
BV+K0Phf5VBHr7aZPKqbUQ: folds 
v+QfkGiuj9bgtuNoVnDO8w: folds 
jA7YMtfNUnAaebB7Lj74EA: calls $0.75
*** FLOP *** [6d 4s 4c]
jA7YMtfNUnAaebB7Lj74EA: checks 
MqMK8OWPSY1V4stf1Hy5Jw: bets $1.25
jA7YMtfNUnAaebB7Lj74EA: folds 
Uncalled bet ($1.25) returned to MqMK8OWPSY1V4stf1Hy5Jw
MqMK8OWPSY1V4stf1Hy5Jw collected $2.25 from pot
MqMK8OWPSY1V4stf1Hy5Jw: doesn't show hand 
*** SUMMARY ***
Total pot $2.35 | Rake $0.10 
Board [6d 4s 4c]
Seat 1: SFmT9ZsVopnukjvAzrxTRg folded before Flop (didn't bet)
Seat 2: xrf8tAXKQHG99HixCot1Iw folded before Flop (didn't bet)
Seat 3: MqMK8OWPSY1V4stf1Hy5Jw (button) collected ($2.25)
Seat 4: BV+K0Phf5VBHr7aZPKqbUQ (small blind) folded before Flop
Seat 5: v+QfkGiuj9bgtuNoVnDO8w (big blind) folded before Flop
Seat 6: jA7YMtfNUnAaebB7Lj74EA folded on the Flop




PokerStars Game #59941857102:  Hold'em No Limit ($0.10/$0.25) - 2009/07/01 1:48:21 ET
Table 'oZuNsbNJuUyQLGKzQ/4JFg' 6-max Seat #4 is the button
Seat 1: vqWjZmdQu/Hxw96/IJTWdQ ($25 in chips) 
Seat 2: UA5OsKS3VPaxa7uC8La/kA ($35.40 in chips) 
Seat 3: 8ClCHtFXGNplITm+63KB+Q ($50.65 in chips) 
Seat 4: 9bpVv1/Qh9IYtXuCtl5VtQ ($25.45 in chips) 
Seat 5: oBUDUfeUyCbZBsjxHZgSiw ($26.70 in chips) 
Seat 6: fwg6dK1+r4jy/y+JqenYYQ ($13.80 in chips) 
oBUDUfeUyCbZBsjxHZgSiw: posts small blind $0.10
fwg6dK1+r4jy/y+JqenYYQ: posts big blind $0.25
*** HOLE CARDS ***
vqWjZmdQu/Hxw96/IJTWdQ: folds 
UA5OsKS3VPaxa7uC8La/kA: folds 
8ClCHtFXGNplITm+63KB+Q: raises $0.75 to $1
9bpVv1/Qh9IYtXuCtl5VtQ: calls $1
oBUDUfeUyCbZBsjxHZgSiw: calls $0.90
fwg6dK1+r4jy/y+JqenYYQ: calls $0.75
*** FLOP *** [5h 8c Ks]
oBUDUfeUyCbZBsjxHZgSiw: checks 
fwg6dK1+r4jy/y+JqenYYQ: bets $0.25
8ClCHtFXGNplITm+63KB+Q: folds 
9bpVv1/Qh9IYtXuCtl5VtQ: raises $2.75 to $3
oBUDUfeUyCbZBsjxHZgSiw: calls $3
fwg6dK1+r4jy/y+JqenYYQ: folds 
*** TURN *** [5h 8c Ks] [Jc]
oBUDUfeUyCbZBsjxHZgSiw: checks 
9bpVv1/Qh9IYtXuCtl5VtQ: bets $5
oBUDUfeUyCbZBsjxHZgSiw: folds 
Uncalled bet ($5) returned to 9bpVv1/Qh9IYtXuCtl5VtQ
9bpVv1/Qh9IYtXuCtl5VtQ collected $9.75 from pot
9bpVv1/Qh9IYtXuCtl5VtQ: doesn't show hand 
*** SUMMARY ***
Total pot $10.25 | Rake $0.50 
Board [5h 8c Ks Jc]
Seat 1: vqWjZmdQu/Hxw96/IJTWdQ folded before Flop (didn't bet)
Seat 2: UA5OsKS3VPaxa7uC8La/kA folded before Flop (didn't bet)
Seat 3: 8ClCHtFXGNplITm+63KB+Q folded on the Flop
Seat 4: 9bpVv1/Qh9IYtXuCtl5VtQ (button) collected ($9.75)
Seat 5: oBUDUfeUyCbZBsjxHZgSiw (small blind) folded on the Turn
Seat 6: fwg6dK1+r4jy/y+JqenYYQ (big blind) folded on the Flop




PokerStars Game #59941857140:  Hold'em No Limit ($0.10/$0.25) - 2009/07/01 1:48:21 ET
Table 'WY+lMaAoIdBZmwk27/RJCA' 6-max Seat #1 is the button
Seat 1: zHHLkD2sRljslKKeQv/ZQw ($26.60 in chips) 
Seat 2: NhUN/JpAprdJeamFBgJH1w ($26.65 in chips) 
Seat 3: QqiZLFrN8iOUT/GHw7ztOA ($26.95 in chips) 
Seat 4: 0av6tRNdi0Ui4f15L7gsVg ($25 in chips) 
Seat 5: vqWjZmdQu/Hxw96/IJTWdQ ($27.95 in chips) 
Seat 6: cWc85bEzdRzpUMhRKm8pwQ ($25.75 in chips) 
NhUN/JpAprdJeamFBgJH1w: posts small blind $0.10
QqiZLFrN8iOUT/GHw7ztOA: posts big blind $0.25
*** HOLE CARDS ***
0av6tRNdi0Ui4f15L7gsVg: folds 
vqWjZmdQu/Hxw96/IJTWdQ: folds 
cWc85bEzdRzpUMhRKm8pwQ: raises $0.75 to $1
zHHLkD2sRljslKKeQv/ZQw: folds 
NhUN/JpAprdJeamFBgJH1w: folds 
QqiZLFrN8iOUT/GHw7ztOA: folds 
Uncalled bet ($0.75) returned to cWc85bEzdRzpUMhRKm8pwQ
cWc85bEzdRzpUMhRKm8pwQ collected $0.60 from pot
*** SUMMARY ***
Total pot $0.60 | Rake $0 
Seat 1: zHHLkD2sRljslKKeQv/ZQw (button) folded before Flop (didn't bet)
Seat 2: NhUN/JpAprdJeamFBgJH1w (small blind) folded before Flop
Seat 3: QqiZLFrN8iOUT/GHw7ztOA (big blind) folded before Flop
Seat 4: 0av6tRNdi0Ui4f15L7gsVg folded before Flop (didn't bet)
Seat 5: vqWjZmdQu/Hxw96/IJTWdQ folded before Flop (didn't bet)
Seat 6: cWc85bEzdRzpUMhRKm8pwQ collected ($0.60)




PokerStars Game #59941857020:  Hold'em No Limit ($0.10/$0.25) - 2009/07/01 1:48:21 ET
Table 'Qk/910N2Yhg8u5vqTJk50Q' 9-max Seat #5 is the button
Seat 2: Th3FldXKQW6hWVVPahaoOQ ($45.05 in chips) 
Seat 3: ghNKXUBl/H+t83JF079ZBA ($25.65 in chips) 
Seat 4: hYvTc4PYNrAaNAIVoM94Hw ($5 in chips) 
Seat 5: zReBEigsxqZnag0RZAgpgA ($14.75 in chips) 
Seat 7: aNpwfA31EREwO+ar4XzBCw ($25 in chips) 
Seat 8: 9PMD136+PrUsTwnP6fczyA ($15.75 in chips) 
Seat 9: M2QO2DxB5Wawg2h8HSpnYA ($17.70 in chips) 
U41wNf6XauAiBOQaKu2ZIA will be allowed to play after the button
aNpwfA31EREwO+ar4XzBCw: posts small blind $0.10
9PMD136+PrUsTwnP6fczyA: posts big blind $0.25
hYvTc4PYNrAaNAIVoM94Hw: posts big blind $0.25
*** HOLE CARDS ***
M2QO2DxB5Wawg2h8HSpnYA: calls $0.25
Th3FldXKQW6hWVVPahaoOQ: folds 
ghNKXUBl/H+t83JF079ZBA: folds 
hYvTc4PYNrAaNAIVoM94Hw: checks 
zReBEigsxqZnag0RZAgpgA: calls $0.25
aNpwfA31EREwO+ar4XzBCw: calls $0.15
9PMD136+PrUsTwnP6fczyA: checks 
*** FLOP *** [8h Tc Js]
aNpwfA31EREwO+ar4XzBCw: checks 
9PMD136+PrUsTwnP6fczyA: checks 
M2QO2DxB5Wawg2h8HSpnYA: checks 
hYvTc4PYNrAaNAIVoM94Hw: checks 
zReBEigsxqZnag0RZAgpgA: bets $1
aNpwfA31EREwO+ar4XzBCw: calls $1
9PMD136+PrUsTwnP6fczyA: folds 
M2QO2DxB5Wawg2h8HSpnYA: folds 
9PMD136+PrUsTwnP6fczyA leaves the table
hYvTc4PYNrAaNAIVoM94Hw: folds 
*** TURN *** [8h Tc Js] [2d]
aNpwfA31EREwO+ar4XzBCw: checks 
zReBEigsxqZnag0RZAgpgA: checks 
*** RIVER *** [8h Tc Js 2d] [Ac]
aNpwfA31EREwO+ar4XzBCw: checks 
zReBEigsxqZnag0RZAgpgA: checks 
*** SHOW DOWN ***
aNpwfA31EREwO+ar4XzBCw: shows [Jh Kd] (a pair of Jacks)
zReBEigsxqZnag0RZAgpgA: mucks hand 
5pDhXQ+RVy0BGcwfJAJfbg joins the table at seat #8 
aNpwfA31EREwO+ar4XzBCw collected $3.10 from pot
*** SUMMARY ***
Total pot $3.25 | Rake $0.15 
Board [8h Tc Js 2d Ac]
Seat 2: Th3FldXKQW6hWVVPahaoOQ folded before Flop (didn't bet)
Seat 3: ghNKXUBl/H+t83JF079ZBA folded before Flop (didn't bet)
Seat 4: hYvTc4PYNrAaNAIVoM94Hw folded on the Flop
Seat 5: zReBEigsxqZnag0RZAgpgA (button) mucked
Seat 7: aNpwfA31EREwO+ar4XzBCw (small blind) showed [Jh Kd] and won ($3.10) with a pair of Jacks
Seat 8: 9PMD136+PrUsTwnP6fczyA (big blind) folded on the Flop
Seat 9: M2QO2DxB5Wawg2h8HSpnYA folded on the Flop




PokerStars Game #59941857640:  Hold'em No Limit ($0.10/$0.25) - 2009/07/01 1:48:22 ET
Table 'rtxA1Y01Nrq5VoyzTAuusQ' 9-max Seat #1 is the button
Seat 1: w1ukf8uPa4+WH561TtVRxA ($26.55 in chips) 
Seat 2: Th3FldXKQW6hWVVPahaoOQ ($25 in chips) 
Seat 3: K9fS1IUr5GpiJG7VkJ7IbA ($7.55 in chips) 
Seat 4: RHqgdFvufLCYe54+qd2gcA ($5 in chips) 
Seat 5: MtVtHDqIJTyUcXkRBBDIVA ($30.70 in chips) 
Seat 8: DnDcAdn9P0zGovMERigpFA ($25 in chips) 
Seat 9: HPEB+AtKw1+C/cxU0o1ciw ($22.35 in chips) 
Th3FldXKQW6hWVVPahaoOQ: posts small blind $0.10
K9fS1IUr5GpiJG7VkJ7IbA: posts big blind $0.25
W6tExOcYX7qiy6Qdp+ZwFA: sits out 
*** HOLE CARDS ***
RHqgdFvufLCYe54+qd2gcA: folds 
MtVtHDqIJTyUcXkRBBDIVA: raises $0.50 to $0.75
DnDcAdn9P0zGovMERigpFA: folds 
HPEB+AtKw1+C/cxU0o1ciw: folds 
w1ukf8uPa4+WH561TtVRxA: folds 
Th3FldXKQW6hWVVPahaoOQ: folds 
K9fS1IUr5GpiJG7VkJ7IbA: calls $0.50
*** FLOP *** [Jc 2h Qs]
K9fS1IUr5GpiJG7VkJ7IbA: checks 
MtVtHDqIJTyUcXkRBBDIVA: bets $1
K9fS1IUr5GpiJG7VkJ7IbA: calls $1
*** TURN *** [Jc 2h Qs] [4d]
K9fS1IUr5GpiJG7VkJ7IbA: checks 
MtVtHDqIJTyUcXkRBBDIVA: bets $1.75
K9fS1IUr5GpiJG7VkJ7IbA: folds 
Uncalled bet ($1.75) returned to MtVtHDqIJTyUcXkRBBDIVA
MtVtHDqIJTyUcXkRBBDIVA collected $3.45 from pot
MtVtHDqIJTyUcXkRBBDIVA: doesn't show hand 
*** SUMMARY ***
Total pot $3.60 | Rake $0.15 
Board [Jc 2h Qs 4d]
Seat 1: w1ukf8uPa4+WH561TtVRxA (button) folded before Flop (didn't bet)
Seat 2: Th3FldXKQW6hWVVPahaoOQ (small blind) folded before Flop
Seat 3: K9fS1IUr5GpiJG7VkJ7IbA (big blind) folded on the Turn
Seat 4: RHqgdFvufLCYe54+qd2gcA folded before Flop (didn't bet)
Seat 5: MtVtHDqIJTyUcXkRBBDIVA collected ($3.45)
Seat 8: DnDcAdn9P0zGovMERigpFA folded before Flop (didn't bet)
Seat 9: HPEB+AtKw1+C/cxU0o1ciw folded before Flop (didn't bet)




PokerStars Game #59941857348:  Hold'em No Limit ($0.10/$0.25) - 2009/07/01 1:48:22 ET
Table '4XGDnEByOol5up4aB2KbJw' 6-max Seat #1 is the button
Seat 1: kyRaCIljYA6l33lSKQfNsg ($26.15 in chips) 
Seat 2: SFmT9ZsVopnukjvAzrxTRg ($46.20 in chips) 
Seat 3: LtASJ9OlkqGrrUKGQlpGAw ($20.90 in chips) 
Seat 4: BV+K0Phf5VBHr7aZPKqbUQ ($25 in chips) 
Seat 5: Dh01+rohD2p9pXLYeBlC5Q ($17.25 in chips) 
Seat 6: a7Ux7aERFGCbT/L3ojVfAg ($10.65 in chips) 
SFmT9ZsVopnukjvAzrxTRg: posts small blind $0.10
LtASJ9OlkqGrrUKGQlpGAw: posts big blind $0.25
*** HOLE CARDS ***
BV+K0Phf5VBHr7aZPKqbUQ: folds 
Dh01+rohD2p9pXLYeBlC5Q: folds 
a7Ux7aERFGCbT/L3ojVfAg: calls $0.25
kyRaCIljYA6l33lSKQfNsg: raises $0.50 to $0.75
SFmT9ZsVopnukjvAzrxTRg: folds 
LtASJ9OlkqGrrUKGQlpGAw: folds 
a7Ux7aERFGCbT/L3ojVfAg: folds 
Uncalled bet ($0.50) returned to kyRaCIljYA6l33lSKQfNsg
kyRaCIljYA6l33lSKQfNsg collected $0.85 from pot
*** SUMMARY ***
Total pot $0.85 | Rake $0 
Seat 1: kyRaCIljYA6l33lSKQfNsg (button) collected ($0.85)
Seat 2: SFmT9ZsVopnukjvAzrxTRg (small blind) folded before Flop
Seat 3: LtASJ9OlkqGrrUKGQlpGAw (big blind) folded before Flop
Seat 4: BV+K0Phf5VBHr7aZPKqbUQ folded before Flop (didn't bet)
Seat 5: Dh01+rohD2p9pXLYeBlC5Q folded before Flop (didn't bet)
Seat 6: a7Ux7aERFGCbT/L3ojVfAg folded before Flop




PokerStars Game #59941857692:  Hold'em No Limit ($0.10/$0.25) - 2009/07/01 1:48:22 ET
Table 'nXVbUw6/HYwA6x21+IZ3XQ' 9-max Seat #5 is the button
Seat 1: zDrucyjVn5aeekNEc3cJrA ($16.75 in chips) 
Seat 2: 9lvO/qyU+xrU95Teu1fv0g ($10.25 in chips) 
Seat 3: MB0wa15P+9QHcBApEdgQFw ($11.60 in chips) 
Seat 4: SpiiQQAzy4MUgV3I5W8giw ($24.65 in chips) 
Seat 5: M/9j4wkHH9i1JM51vgi1VA ($31.60 in chips) 
Seat 6: ljemhp25Zg+nlA9DLCIiUw ($26.95 in chips) 
Seat 7: ShCS62CJp4MKfKLKvGKQbA ($11.60 in chips) 
Seat 8: dfNim92Z6XK1/h5SFW5vDg ($25 in chips) 
Seat 9: OTCjTlu92MEBtX/i9Gm7yA ($9.85 in chips) 
ljemhp25Zg+nlA9DLCIiUw: posts small blind $0.10
ShCS62CJp4MKfKLKvGKQbA: posts big blind $0.25
*** HOLE CARDS ***
dfNim92Z6XK1/h5SFW5vDg: folds 
OTCjTlu92MEBtX/i9Gm7yA: calls $0.25
zDrucyjVn5aeekNEc3cJrA: calls $0.25
9lvO/qyU+xrU95Teu1fv0g: folds 
MB0wa15P+9QHcBApEdgQFw: folds 
SpiiQQAzy4MUgV3I5W8giw: folds 
M/9j4wkHH9i1JM51vgi1VA: folds 
ljemhp25Zg+nlA9DLCIiUw: folds 
ShCS62CJp4MKfKLKvGKQbA: checks 
*** FLOP *** [5s 4d Kc]
ShCS62CJp4MKfKLKvGKQbA: checks 
OTCjTlu92MEBtX/i9Gm7yA: checks 
zDrucyjVn5aeekNEc3cJrA: checks 
*** TURN *** [5s 4d Kc] [Ac]
ShCS62CJp4MKfKLKvGKQbA: checks 
OTCjTlu92MEBtX/i9Gm7yA: checks 
zDrucyjVn5aeekNEc3cJrA: checks 
*** RIVER *** [5s 4d Kc Ac] [Qd]
ShCS62CJp4MKfKLKvGKQbA: checks 
OTCjTlu92MEBtX/i9Gm7yA: checks 
zDrucyjVn5aeekNEc3cJrA: checks 
*** SHOW DOWN ***
ShCS62CJp4MKfKLKvGKQbA: shows [9h Td] (high card Ace)
OTCjTlu92MEBtX/i9Gm7yA: mucks hand 
zDrucyjVn5aeekNEc3cJrA: shows [7s 7d] (a pair of Sevens)
zDrucyjVn5aeekNEc3cJrA collected $0.85 from pot
*** SUMMARY ***
Total pot $0.85 | Rake $0 
Board [5s 4d Kc Ac Qd]
Seat 1: zDrucyjVn5aeekNEc3cJrA showed [7s 7d] and won ($0.85) with a pair of Sevens
Seat 2: 9lvO/qyU+xrU95Teu1fv0g folded before Flop (didn't bet)
Seat 3: MB0wa15P+9QHcBApEdgQFw folded before Flop (didn't bet)
Seat 4: SpiiQQAzy4MUgV3I5W8giw folded before Flop (didn't bet)
Seat 5: M/9j4wkHH9i1JM51vgi1VA (button) folded before Flop (didn't bet)
Seat 6: ljemhp25Zg+nlA9DLCIiUw (small blind) folded before Flop
Seat 7: ShCS62CJp4MKfKLKvGKQbA (big blind) showed [9h Td] and lost with high card Ace
Seat 8: dfNim92Z6XK1/h5SFW5vDg folded before Flop (didn't bet)
Seat 9: OTCjTlu92MEBtX/i9Gm7yA mucked




PokerStars Game #59941857326:  Hold'em No Limit ($0.10/$0.25) - 2009/07/01 1:48:22 ET
Table 'gnrUwXkIPE0C8xl6cB4Hyw' 9-max Seat #6 is the button
Seat 1: EQXHDnIzAsORnIXRNtXRlA ($22.60 in chips) 
Seat 2: 7je+LC5Mfs6nL8YBVh4frQ ($5 in chips) 
Seat 3: PdIasPkzm2sqZnN41ZRXOg ($5 in chips) 
Seat 4: wGigCmBR/9XWkPpvYos3aQ ($25 in chips) 
Seat 5: gehe91e0IyVT0QU/XBkEyg ($31.55 in chips) 
Seat 6: dtZ84flFEi4Q+SGrHMJRDQ ($25.80 in chips) 
Seat 7: OXPkK84/qv92EMwXPiG5rQ ($9.70 in chips) 
Seat 8: 4awUyiDYTgylQKXZ9faBVA ($60.65 in chips) 
Seat 9: F7pnn6czNpHvRM55XcA2EA ($25.50 in chips) 
OXPkK84/qv92EMwXPiG5rQ: posts small blind $0.10
4awUyiDYTgylQKXZ9faBVA: posts big blind $0.25
*** HOLE CARDS ***
F7pnn6czNpHvRM55XcA2EA: folds 
EQXHDnIzAsORnIXRNtXRlA: raises $0.50 to $0.75
7je+LC5Mfs6nL8YBVh4frQ: folds 
PdIasPkzm2sqZnN41ZRXOg: folds 
wGigCmBR/9XWkPpvYos3aQ: folds 
gehe91e0IyVT0QU/XBkEyg: folds 
dtZ84flFEi4Q+SGrHMJRDQ: folds 
OXPkK84/qv92EMwXPiG5rQ: folds 
4awUyiDYTgylQKXZ9faBVA: folds 
Uncalled bet ($0.50) returned to EQXHDnIzAsORnIXRNtXRlA
EQXHDnIzAsORnIXRNtXRlA collected $0.60 from pot
*** SUMMARY ***
Total pot $0.60 | Rake $0 
Seat 1: EQXHDnIzAsORnIXRNtXRlA collected ($0.60)
Seat 2: 7je+LC5Mfs6nL8YBVh4frQ folded before Flop (didn't bet)
Seat 3: PdIasPkzm2sqZnN41ZRXOg folded before Flop (didn't bet)
Seat 4: wGigCmBR/9XWkPpvYos3aQ folded before Flop (didn't bet)
Seat 5: gehe91e0IyVT0QU/XBkEyg folded before Flop (didn't bet)
Seat 6: dtZ84flFEi4Q+SGrHMJRDQ (button) folded before Flop (didn't bet)
Seat 7: OXPkK84/qv92EMwXPiG5rQ (small blind) folded before Flop
Seat 8: 4awUyiDYTgylQKXZ9faBVA (big blind) folded before Flop
Seat 9: F7pnn6czNpHvRM55XcA2EA folded before Flop (didn't bet)




PokerStars Game #59941857426:  Hold'em No Limit ($0.10/$0.25) - 2009/07/01 1:48:22 ET
Table 'iMiAw/kTZXopgYX4HI7sHg' 9-max Seat #6 is the button
Seat 1: PdIasPkzm2sqZnN41ZRXOg ($5 in chips) 
Seat 2: qwr38jl5txoR36M7G5qi4A ($8.25 in chips) 
Seat 3: HPEB+AtKw1+C/cxU0o1ciw ($27.90 in chips) 
Seat 4: Z9W7+g1WMhhZDi7DwGbCFA ($5 in chips) 
Seat 5: 22dIObOuor/A+IKWkNoAlA ($5.70 in chips) 
Seat 6: Bb42QRQMhg5/Y0vHP8/2Xw ($29.05 in chips) 
Seat 7: ipLwYjdAXnvG54zETKPvbQ ($14.75 in chips) 
Seat 8: tLcDklc2rBORNfixyRfVfw ($29.90 in chips) 
Seat 9: 7cv+9Zc9HIQHNvYsMfV3uA ($25 in chips) 
ipLwYjdAXnvG54zETKPvbQ: posts small blind $0.10
tLcDklc2rBORNfixyRfVfw: posts big blind $0.25
*** HOLE CARDS ***
7cv+9Zc9HIQHNvYsMfV3uA: folds 
7cv+9Zc9HIQHNvYsMfV3uA leaves the table
PdIasPkzm2sqZnN41ZRXOg: folds 
qwr38jl5txoR36M7G5qi4A: folds 
HPEB+AtKw1+C/cxU0o1ciw: folds 
Z9W7+g1WMhhZDi7DwGbCFA: folds 
22dIObOuor/A+IKWkNoAlA: folds 
Bb42QRQMhg5/Y0vHP8/2Xw: folds 
ipLwYjdAXnvG54zETKPvbQ: folds 
Uncalled bet ($0.15) returned to tLcDklc2rBORNfixyRfVfw
fxHuzml2pBE+ABvr6emfng joins the table at seat #9 
tLcDklc2rBORNfixyRfVfw collected $0.20 from pot
tLcDklc2rBORNfixyRfVfw: doesn't show hand 
*** SUMMARY ***
Total pot $0.20 | Rake $0 
Seat 1: PdIasPkzm2sqZnN41ZRXOg folded before Flop (didn't bet)
Seat 2: qwr38jl5txoR36M7G5qi4A folded before Flop (didn't bet)
Seat 3: HPEB+AtKw1+C/cxU0o1ciw folded before Flop (didn't bet)
Seat 4: Z9W7+g1WMhhZDi7DwGbCFA folded before Flop (didn't bet)
Seat 5: 22dIObOuor/A+IKWkNoAlA folded before Flop (didn't bet)
Seat 6: Bb42QRQMhg5/Y0vHP8/2Xw (button) folded before Flop (didn't bet)
Seat 7: ipLwYjdAXnvG54zETKPvbQ (small blind) folded before Flop
Seat 8: tLcDklc2rBORNfixyRfVfw (big blind) collected ($0.20)
Seat 9: 7cv+9Zc9HIQHNvYsMfV3uA folded before Flop (didn't bet)




PokerStars Game #59941857790:  Hold'em No Limit ($0.10/$0.25) - 2009/07/01 1:48:22 ET
Table '4hfTdIVT/qPsJNfWXLsVIw' 9-max Seat #1 is the button
Seat 1: GbHFBbLqLGz0Pwn6CJeAuw ($36.05 in chips) 
Seat 2: Pt637jKksB5MzP0UNJAAkw ($39.95 in chips) 
Seat 3: xnVwSkROfRtOw4eSoDANtw ($4.45 in chips) 
Seat 5: dtZ84flFEi4Q+SGrHMJRDQ ($25.10 in chips) 
Seat 6: VWUWpMLMj/Q1jRVpF7Aohw ($12.90 in chips) 
Seat 7: d7YasxuGLPiL7pj8IcGThw ($5.70 in chips) 
Seat 8: 7cv+9Zc9HIQHNvYsMfV3uA ($33.30 in chips) 
Seat 9: 9njEKzpOKC62MllUFUBWrA ($24 in chips) 
Pt637jKksB5MzP0UNJAAkw: posts small blind $0.10
xnVwSkROfRtOw4eSoDANtw: posts big blind $0.25
3PmVnC/15cl4oyI1TKIt4g: sits out 
*** HOLE CARDS ***
dtZ84flFEi4Q+SGrHMJRDQ: folds 
VWUWpMLMj/Q1jRVpF7Aohw: folds 
d7YasxuGLPiL7pj8IcGThw: folds 
7cv+9Zc9HIQHNvYsMfV3uA: folds 
9njEKzpOKC62MllUFUBWrA: folds 
GbHFBbLqLGz0Pwn6CJeAuw: calls $0.25
Pt637jKksB5MzP0UNJAAkw: folds 
xnVwSkROfRtOw4eSoDANtw: checks 
*** FLOP *** [5c 4c Kd]
xnVwSkROfRtOw4eSoDANtw: checks 
GbHFBbLqLGz0Pwn6CJeAuw: checks 
*** TURN *** [5c 4c Kd] [6h]
xnVwSkROfRtOw4eSoDANtw: bets $0.50
GbHFBbLqLGz0Pwn6CJeAuw: calls $0.50
*** RIVER *** [5c 4c Kd 6h] [6d]
xnVwSkROfRtOw4eSoDANtw: bets $0.75
GbHFBbLqLGz0Pwn6CJeAuw: raises $0.75 to $1.50
xnVwSkROfRtOw4eSoDANtw: calls $0.75
*** SHOW DOWN ***
GbHFBbLqLGz0Pwn6CJeAuw: shows [7s 8s] (a straight, Four to Eight)
xnVwSkROfRtOw4eSoDANtw: mucks hand 
GbHFBbLqLGz0Pwn6CJeAuw collected $4.40 from pot
*** SUMMARY ***
Total pot $4.60 | Rake $0.20 
Board [5c 4c Kd 6h 6d]
Seat 1: GbHFBbLqLGz0Pwn6CJeAuw (button) showed [7s 8s] and won ($4.40) with a straight, Four to Eight
Seat 2: Pt637jKksB5MzP0UNJAAkw (small blind) folded before Flop
Seat 3: xnVwSkROfRtOw4eSoDANtw (big blind) mucked
Seat 5: dtZ84flFEi4Q+SGrHMJRDQ folded before Flop (didn't bet)
Seat 6: VWUWpMLMj/Q1jRVpF7Aohw folded before Flop (didn't bet)
Seat 7: d7YasxuGLPiL7pj8IcGThw folded before Flop (didn't bet)
Seat 8: 7cv+9Zc9HIQHNvYsMfV3uA folded before Flop (didn't bet)
Seat 9: 9njEKzpOKC62MllUFUBWrA folded before Flop (didn't bet)




PokerStars Game #59941857644:  Hold'em No Limit ($0.10/$0.25) - 2009/07/01 1:48:22 ET
Table 'JJzUs04lHpXg6nboT1/jeg' 6-max Seat #4 is the button
Seat 1: MqMK8OWPSY1V4stf1Hy5Jw ($36.70 in chips) 
Seat 2: jxfR29d+dK/7h7s3SvCk+g ($8.10 in chips) 
Seat 3: 4zXbHDe39qNX46dAo81b4w ($10.55 in chips) 
Seat 4: 7cx44/slbeTw+Cy7QB8Trg ($25 in chips) 
Seat 5: QvTX2yGq3uKJiKPmns4TKQ ($18.35 in chips) 
QvTX2yGq3uKJiKPmns4TKQ: posts small blind $0.10
MqMK8OWPSY1V4stf1Hy5Jw: posts big blind $0.25
*** HOLE CARDS ***
jxfR29d+dK/7h7s3SvCk+g: folds 
4zXbHDe39qNX46dAo81b4w: raises $0.25 to $0.50
7cx44/slbeTw+Cy7QB8Trg: folds 
QvTX2yGq3uKJiKPmns4TKQ: folds 
MqMK8OWPSY1V4stf1Hy5Jw: calls $0.25
*** FLOP *** [Ts Jh Js]
MqMK8OWPSY1V4stf1Hy5Jw: checks 
4zXbHDe39qNX46dAo81b4w: bets $0.50
MqMK8OWPSY1V4stf1Hy5Jw: folds 
Uncalled bet ($0.50) returned to 4zXbHDe39qNX46dAo81b4w
MqMK8OWPSY1V4stf1Hy5Jw leaves the table
4zXbHDe39qNX46dAo81b4w collected $1.05 from pot
*** SUMMARY ***
Total pot $1.10 | Rake $0.05 
Board [Ts Jh Js]
Seat 1: MqMK8OWPSY1V4stf1Hy5Jw (big blind) folded on the Flop
Seat 2: jxfR29d+dK/7h7s3SvCk+g folded before Flop (didn't bet)
Seat 3: 4zXbHDe39qNX46dAo81b4w collected ($1.05)
Seat 4: 7cx44/slbeTw+Cy7QB8Trg (button) folded before Flop (didn't bet)
Seat 5: QvTX2yGq3uKJiKPmns4TKQ (small blind) folded before Flop




PokerStars Game #59941857744:  Hold'em No Limit ($0.10/$0.25) - 2009/07/01 1:48:22 ET
Table 'FE/j6VqBY4j9Uq+VHURQCQ' 6-max Seat #2 is the button
Seat 1: ypmjhffk/YHGc51wgVXUTw ($41.65 in chips) 
Seat 2: 3zD3qLXT1bEffAoWGnc7wg ($36.75 in chips) 
Seat 3: lBoEwOFgzcERLIRUkUoRTw ($27.60 in chips) 
Seat 4: 7JyPCA0J2grhXQYxe1h3+A ($7.10 in chips) 
Seat 5: bJFzs6QmEEnz4miMfSDtcg ($14.75 in chips) 
lBoEwOFgzcERLIRUkUoRTw: posts small blind $0.10
7JyPCA0J2grhXQYxe1h3+A: posts big blind $0.25
Q1uciOZPBR/WkAlqa6cL4A: sits out 
*** HOLE CARDS ***
bJFzs6QmEEnz4miMfSDtcg: folds 
ypmjhffk/YHGc51wgVXUTw: folds 
3zD3qLXT1bEffAoWGnc7wg: folds 
lBoEwOFgzcERLIRUkUoRTw: folds 
Uncalled bet ($0.15) returned to 7JyPCA0J2grhXQYxe1h3+A
7JyPCA0J2grhXQYxe1h3+A collected $0.20 from pot
7JyPCA0J2grhXQYxe1h3+A: doesn't show hand 
*** SUMMARY ***
Total pot $0.20 | Rake $0 
Seat 1: ypmjhffk/YHGc51wgVXUTw folded before Flop (didn't bet)
Seat 2: 3zD3qLXT1bEffAoWGnc7wg (button) folded before Flop (didn't bet)
Seat 3: lBoEwOFgzcERLIRUkUoRTw (small blind) folded before Flop
Seat 4: 7JyPCA0J2grhXQYxe1h3+A (big blind) collected ($0.20)
Seat 5: bJFzs6QmEEnz4miMfSDtcg folded before Flop (didn't bet)




PokerStars Game #59941858158:  Hold'em No Limit ($0.10/$0.25) - 2009/07/01 1:48:23 ET
Table 'O6cwjhrMn9pfzx1Ngn5zkQ' 6-max Seat #3 is the button
Seat 1: LJI7A1YgDM7hgh7o56+ReQ ($27.45 in chips) 
Seat 3: EE16Ua5b1HSsYej5zeXOlA ($26.15 in chips) 
Seat 4: mfrkWA3PTeYPkbO6hi98Aw ($24.75 in chips) 
Seat 5: niLn0xUVlqh8If80xRjzCA ($27.90 in chips) 
Seat 6: 4TM16KVgEiQpLi4bVVWbVQ ($32.80 in chips) 
mfrkWA3PTeYPkbO6hi98Aw: posts small blind $0.10
niLn0xUVlqh8If80xRjzCA: posts big blind $0.25
8CPg15X6IHYR1pWm9ha1Sw: sits out 
*** HOLE CARDS ***
4TM16KVgEiQpLi4bVVWbVQ: folds 
LJI7A1YgDM7hgh7o56+ReQ: folds 
EE16Ua5b1HSsYej5zeXOlA: folds 
mfrkWA3PTeYPkbO6hi98Aw: calls $0.15
niLn0xUVlqh8If80xRjzCA: checks 
*** FLOP *** [9d 5c Kh]
mfrkWA3PTeYPkbO6hi98Aw: checks 
niLn0xUVlqh8If80xRjzCA: checks 
*** TURN *** [9d 5c Kh] [As]
mfrkWA3PTeYPkbO6hi98Aw: checks 
niLn0xUVlqh8If80xRjzCA: checks 
*** RIVER *** [9d 5c Kh As] [Qh]
mfrkWA3PTeYPkbO6hi98Aw: checks 
niLn0xUVlqh8If80xRjzCA: bets $0.25
mfrkWA3PTeYPkbO6hi98Aw: folds 
Uncalled bet ($0.25) returned to niLn0xUVlqh8If80xRjzCA
niLn0xUVlqh8If80xRjzCA collected $0.50 from pot
niLn0xUVlqh8If80xRjzCA: doesn't show hand 
*** SUMMARY ***
Total pot $0.50 | Rake $0 
Board [9d 5c Kh As Qh]
Seat 1: LJI7A1YgDM7hgh7o56+ReQ folded before Flop (didn't bet)
Seat 3: EE16Ua5b1HSsYej5zeXOlA (button) folded before Flop (didn't bet)
Seat 4: mfrkWA3PTeYPkbO6hi98Aw (small blind) folded on the River
Seat 5: niLn0xUVlqh8If80xRjzCA (big blind) collected ($0.50)
Seat 6: 4TM16KVgEiQpLi4bVVWbVQ folded before Flop (didn't bet)




PokerStars Game #59941858132:  Hold'em No Limit ($0.10/$0.25) - 2009/07/01 1:48:23 ET
Table 'sSe6q4YTb/iS19t2eCFdsA' 9-max Seat #8 is the button
Seat 1: hJ4uYjNmSZdjrKA8cjZqCA ($18.75 in chips) 
Seat 2: 3l+i+xMeyDndSXMF2A5CDA ($6.25 in chips) 
Seat 3: OXPkK84/qv92EMwXPiG5rQ ($9.75 in chips) 
Seat 4: 22dIObOuor/A+IKWkNoAlA ($9.10 in chips) 
Seat 5: qS+jfnNoG75bT+uQ8CKhQA ($9.70 in chips) 
Seat 6: tYsOBqdU1+x+yFI7zHO7hQ ($27 in chips) 
Seat 7: t70KGeRtR3naHSqKDixsUg ($3.95 in chips) 
Seat 8: hvXZ0zFPZFP8Hf6dS36YEw ($15.50 in chips) 
Seat 9: Z9W7+g1WMhhZDi7DwGbCFA ($5.50 in chips) 
Z9W7+g1WMhhZDi7DwGbCFA: posts small blind $0.10
hJ4uYjNmSZdjrKA8cjZqCA: posts big blind $0.25
*** HOLE CARDS ***
3l+i+xMeyDndSXMF2A5CDA: folds 
OXPkK84/qv92EMwXPiG5rQ: folds 
22dIObOuor/A+IKWkNoAlA: folds 
qS+jfnNoG75bT+uQ8CKhQA: folds 
tYsOBqdU1+x+yFI7zHO7hQ: folds 
t70KGeRtR3naHSqKDixsUg: folds 
hvXZ0zFPZFP8Hf6dS36YEw: calls $0.25
Z9W7+g1WMhhZDi7DwGbCFA: calls $0.15
hJ4uYjNmSZdjrKA8cjZqCA: checks 
*** FLOP *** [2c 2d 8c]
Z9W7+g1WMhhZDi7DwGbCFA: checks 
hJ4uYjNmSZdjrKA8cjZqCA: checks 
hvXZ0zFPZFP8Hf6dS36YEw: bets $0.75
Z9W7+g1WMhhZDi7DwGbCFA: folds 
hJ4uYjNmSZdjrKA8cjZqCA: folds 
Uncalled bet ($0.75) returned to hvXZ0zFPZFP8Hf6dS36YEw
hvXZ0zFPZFP8Hf6dS36YEw collected $0.75 from pot
*** SUMMARY ***
Total pot $0.75 | Rake $0 
Board [2c 2d 8c]
Seat 1: hJ4uYjNmSZdjrKA8cjZqCA (big blind) folded on the Flop
Seat 2: 3l+i+xMeyDndSXMF2A5CDA folded before Flop (didn't bet)
Seat 3: OXPkK84/qv92EMwXPiG5rQ folded before Flop (didn't bet)
Seat 4: 22dIObOuor/A+IKWkNoAlA folded before Flop (didn't bet)
Seat 5: qS+jfnNoG75bT+uQ8CKhQA folded before Flop (didn't bet)
Seat 6: tYsOBqdU1+x+yFI7zHO7hQ folded before Flop (didn't bet)
Seat 7: t70KGeRtR3naHSqKDixsUg folded before Flop (didn't bet)
Seat 8: hvXZ0zFPZFP8Hf6dS36YEw (button) collected ($0.75)
Seat 9: Z9W7+g1WMhhZDi7DwGbCFA (small blind) folded on the Flop




PokerStars Game #59941857936:  Hold'em No Limit ($0.10/$0.25) - 2009/07/01 1:48:23 ET
Table 'luMgmRPIo47e7iXDlheIwA' 6-max Seat #2 is the button
Seat 1: EQ3WxdGe/KZrM6Lx4T02sg ($37.55 in chips) 
Seat 2: NhUN/JpAprdJeamFBgJH1w ($25 in chips) 
Seat 3: w43JQj2oYPpKQVG4Yzlq1w ($25 in chips) 
Seat 4: xrf8tAXKQHG99HixCot1Iw ($26.25 in chips) 
Seat 5: cWc85bEzdRzpUMhRKm8pwQ ($45.25 in chips) 
Seat 6: qGHGf/553gQnDoklMRe3tg ($24.55 in chips) 
w43JQj2oYPpKQVG4Yzlq1w: posts small blind $0.10
xrf8tAXKQHG99HixCot1Iw: posts big blind $0.25
*** HOLE CARDS ***
cWc85bEzdRzpUMhRKm8pwQ: folds 
qGHGf/553gQnDoklMRe3tg: folds 
EQ3WxdGe/KZrM6Lx4T02sg: raises $0.25 to $0.50
NhUN/JpAprdJeamFBgJH1w: folds 
w43JQj2oYPpKQVG4Yzlq1w: folds 
xrf8tAXKQHG99HixCot1Iw: folds 
Uncalled bet ($0.25) returned to EQ3WxdGe/KZrM6Lx4T02sg
EQ3WxdGe/KZrM6Lx4T02sg collected $0.60 from pot
*** SUMMARY ***
Total pot $0.60 | Rake $0 
Seat 1: EQ3WxdGe/KZrM6Lx4T02sg collected ($0.60)
Seat 2: NhUN/JpAprdJeamFBgJH1w (button) folded before Flop (didn't bet)
Seat 3: w43JQj2oYPpKQVG4Yzlq1w (small blind) folded before Flop
Seat 4: xrf8tAXKQHG99HixCot1Iw (big blind) folded before Flop
Seat 5: cWc85bEzdRzpUMhRKm8pwQ folded before Flop (didn't bet)
Seat 6: qGHGf/553gQnDoklMRe3tg folded before Flop (didn't bet)




PokerStars Game #59941858184:  Hold'em No Limit ($0.10/$0.25) - 2009/07/01 1:48:23 ET
Table '5NipxzzFB2DffzDpddyQoQ' 6-max Seat #3 is the button
Seat 1: W87HPwOk1KtWaYyshBe1gA ($20.65 in chips) 
Seat 2: iauW7L/+7qzAuHow7CD75Q ($5.95 in chips) 
Seat 3: QvTX2yGq3uKJiKPmns4TKQ ($6.20 in chips) 
Seat 4: NTamLAiMZ86c5yM04t96LA ($35.25 in chips) 
Seat 5: faP2NVl/cFTZ1nE4pXzg8Q ($29.40 in chips) 
Seat 6: 7JqTFMyeNSVWsmp/yW35Tw ($27.30 in chips) 
NTamLAiMZ86c5yM04t96LA: posts small blind $0.10
faP2NVl/cFTZ1nE4pXzg8Q: posts big blind $0.25
*** HOLE CARDS ***
7JqTFMyeNSVWsmp/yW35Tw: folds 
W87HPwOk1KtWaYyshBe1gA: folds 
iauW7L/+7qzAuHow7CD75Q: calls $0.25
QvTX2yGq3uKJiKPmns4TKQ: raises $1 to $1.25
NTamLAiMZ86c5yM04t96LA: calls $1.15
faP2NVl/cFTZ1nE4pXzg8Q: calls $1
iauW7L/+7qzAuHow7CD75Q: calls $1
*** FLOP *** [4h Qs 8c]
NTamLAiMZ86c5yM04t96LA: checks 
faP2NVl/cFTZ1nE4pXzg8Q: checks 
iauW7L/+7qzAuHow7CD75Q: checks 
QvTX2yGq3uKJiKPmns4TKQ: bets $4.95 and is all-in
NTamLAiMZ86c5yM04t96LA: folds 
faP2NVl/cFTZ1nE4pXzg8Q: calls $4.95
iauW7L/+7qzAuHow7CD75Q: folds 
*** TURN *** [4h Qs 8c] [7d]
*** RIVER *** [4h Qs 8c 7d] [9d]
*** SHOW DOWN ***
faP2NVl/cFTZ1nE4pXzg8Q: shows [4c 6c] (a pair of Fours)
QvTX2yGq3uKJiKPmns4TKQ: shows [4s Ac] (a pair of Fours - Ace kicker)
QvTX2yGq3uKJiKPmns4TKQ collected $14.20 from pot
*** SUMMARY ***
Total pot $14.90 | Rake $0.70 
Board [4h Qs 8c 7d 9d]
Seat 1: W87HPwOk1KtWaYyshBe1gA folded before Flop (didn't bet)
Seat 2: iauW7L/+7qzAuHow7CD75Q folded on the Flop
Seat 3: QvTX2yGq3uKJiKPmns4TKQ (button) showed [4s Ac] and won ($14.20) with a pair of Fours
Seat 4: NTamLAiMZ86c5yM04t96LA (small blind) folded on the Flop
Seat 5: faP2NVl/cFTZ1nE4pXzg8Q (big blind) showed [4c 6c] and lost with a pair of Fours
Seat 6: 7JqTFMyeNSVWsmp/yW35Tw folded before Flop (didn't bet)




PokerStars Game #59941858266:  Hold'em No Limit ($0.10/$0.25) - 2009/07/01 1:48:23 ET
Table 'AchTjdLS1zBUbH3ZIx6f0w' 6-max Seat #4 is the button
Seat 1: rZ0bUtoerhFGDUSRQMnFog ($30.45 in chips) 
Seat 2: kG34n23qFQA3nzdOJTQ1dA ($65.90 in chips) 
Seat 3: k9vn40MOqqb+xF+7GZ6v2g ($29 in chips) 
Seat 4: q6WfTUAD9mowIP63ASq2Dg ($31.20 in chips) 
Seat 5: 0av6tRNdi0Ui4f15L7gsVg ($24 in chips) 
Seat 6: epAUIB7h2FJXzUPRIvSkRA ($25.35 in chips) 
0av6tRNdi0Ui4f15L7gsVg: posts small blind $0.10
epAUIB7h2FJXzUPRIvSkRA: posts big blind $0.25
*** HOLE CARDS ***
rZ0bUtoerhFGDUSRQMnFog: calls $0.25
kG34n23qFQA3nzdOJTQ1dA: folds 
k9vn40MOqqb+xF+7GZ6v2g: folds 
q6WfTUAD9mowIP63ASq2Dg: folds 
0av6tRNdi0Ui4f15L7gsVg: folds 
epAUIB7h2FJXzUPRIvSkRA: checks 
*** FLOP *** [8d 2h Kh]
epAUIB7h2FJXzUPRIvSkRA: checks 
rZ0bUtoerhFGDUSRQMnFog: checks 
*** TURN *** [8d 2h Kh] [7d]
epAUIB7h2FJXzUPRIvSkRA: checks 
rZ0bUtoerhFGDUSRQMnFog: checks 
*** RIVER *** [8d 2h Kh 7d] [Qh]
epAUIB7h2FJXzUPRIvSkRA: checks 
rZ0bUtoerhFGDUSRQMnFog: checks 
*** SHOW DOWN ***
epAUIB7h2FJXzUPRIvSkRA: shows [6h 4d] (high card King)
rZ0bUtoerhFGDUSRQMnFog: shows [9c Js] (high card King - Queen+Jack kicker)
rZ0bUtoerhFGDUSRQMnFog collected $0.60 from pot
*** SUMMARY ***
Total pot $0.60 | Rake $0 
Board [8d 2h Kh 7d Qh]
Seat 1: rZ0bUtoerhFGDUSRQMnFog showed [9c Js] and won ($0.60) with high card King
Seat 2: kG34n23qFQA3nzdOJTQ1dA folded before Flop (didn't bet)
Seat 3: k9vn40MOqqb+xF+7GZ6v2g folded before Flop (didn't bet)
Seat 4: q6WfTUAD9mowIP63ASq2Dg (button) folded before Flop (didn't bet)
Seat 5: 0av6tRNdi0Ui4f15L7gsVg (small blind) folded before Flop
Seat 6: epAUIB7h2FJXzUPRIvSkRA (big blind) showed [6h 4d] and lost with high card King




PokerStars Game #59941858776:  Hold'em No Limit ($0.10/$0.25) - 2009/07/01 1:48:24 ET
Table 'FuFyQHmlO/QqQp//rDRrPg' 6-max Seat #1 is the button
Seat 1: jp34e617tIzV8tKIWmfAbA ($27.80 in chips) 
Seat 2: G3h3THGB1j3qdHDVHpnJWg ($30.85 in chips) 
Seat 3: EeUZtMU058v2ObUACOF4Og ($29.60 in chips) 
Seat 4: Ahsa9Yk5NPmCqQstq1EoQA ($22.15 in chips) 
Seat 5: xrf8tAXKQHG99HixCot1Iw ($25.25 in chips) 
Seat 6: 6DwBRH+xZ12AAZmeAg+aXw ($51.10 in chips) 
G3h3THGB1j3qdHDVHpnJWg: posts small blind $0.10
EeUZtMU058v2ObUACOF4Og: posts big blind $0.25
*** HOLE CARDS ***
Ahsa9Yk5NPmCqQstq1EoQA: calls $0.25
xrf8tAXKQHG99HixCot1Iw: folds 
6DwBRH+xZ12AAZmeAg+aXw: folds 
jp34e617tIzV8tKIWmfAbA: folds 
G3h3THGB1j3qdHDVHpnJWg: raises $1.75 to $2
EeUZtMU058v2ObUACOF4Og: folds 
Ahsa9Yk5NPmCqQstq1EoQA: calls $1.75
*** FLOP *** [8h 4s 3c]
G3h3THGB1j3qdHDVHpnJWg: checks 
Ahsa9Yk5NPmCqQstq1EoQA: checks 
*** TURN *** [8h 4s 3c] [3d]
G3h3THGB1j3qdHDVHpnJWg: bets $1.75
Ahsa9Yk5NPmCqQstq1EoQA: calls $1.75
*** RIVER *** [8h 4s 3c 3d] [Td]
G3h3THGB1j3qdHDVHpnJWg: bets $3
Ahsa9Yk5NPmCqQstq1EoQA: calls $3
*** SHOW DOWN ***
G3h3THGB1j3qdHDVHpnJWg: shows [8c 8d] (a full house, Eights full of Threes)
Ahsa9Yk5NPmCqQstq1EoQA: mucks hand 
G3h3THGB1j3qdHDVHpnJWg collected $13.10 from pot
*** SUMMARY ***
Total pot $13.75 | Rake $0.65 
Board [8h 4s 3c 3d Td]
Seat 1: jp34e617tIzV8tKIWmfAbA (button) folded before Flop (didn't bet)
Seat 2: G3h3THGB1j3qdHDVHpnJWg (small blind) showed [8c 8d] and won ($13.10) with a full house, Eights full of Threes
Seat 3: EeUZtMU058v2ObUACOF4Og (big blind) folded before Flop
Seat 4: Ahsa9Yk5NPmCqQstq1EoQA mucked
Seat 5: xrf8tAXKQHG99HixCot1Iw folded before Flop (didn't bet)
Seat 6: 6DwBRH+xZ12AAZmeAg+aXw folded before Flop (didn't bet)




PokerStars Game #59941858618:  Hold'em No Limit ($0.10/$0.25) - 2009/07/01 1:48:24 ET
Table 'BabJGL6tfXQp3leBGbYe8A' 9-max Seat #6 is the button
Seat 1: qwr38jl5txoR36M7G5qi4A ($10.35 in chips) 
Seat 2: dtZ84flFEi4Q+SGrHMJRDQ ($40.50 in chips) 
Seat 3: sD+TKtt36XiiN6jqHiLwDA ($28.80 in chips) 
Seat 4: gehe91e0IyVT0QU/XBkEyg ($28.10 in chips) 
Seat 5: GrNTWMdwy+jC6Lred1eDng ($10 in chips) 
Seat 6: egvg3mTBBVzMHnJPIQiKcA ($13.55 in chips) 
Seat 7: eK8qa6EPcH2zhtbmWSvc9g ($27.60 in chips) 
Seat 8: OXPkK84/qv92EMwXPiG5rQ ($9.75 in chips) 
Seat 9: P+9ymZQ3ktpQu1bn7HIjew ($9.50 in chips) 
eK8qa6EPcH2zhtbmWSvc9g: posts small blind $0.10
OXPkK84/qv92EMwXPiG5rQ: posts big blind $0.25
*** HOLE CARDS ***
P+9ymZQ3ktpQu1bn7HIjew: folds 
qwr38jl5txoR36M7G5qi4A: folds 
dtZ84flFEi4Q+SGrHMJRDQ: folds 
sD+TKtt36XiiN6jqHiLwDA: folds 
gehe91e0IyVT0QU/XBkEyg: folds 
GrNTWMdwy+jC6Lred1eDng: folds 
egvg3mTBBVzMHnJPIQiKcA: raises $0.50 to $0.75
eK8qa6EPcH2zhtbmWSvc9g: folds 
OXPkK84/qv92EMwXPiG5rQ: folds 
Uncalled bet ($0.50) returned to egvg3mTBBVzMHnJPIQiKcA
egvg3mTBBVzMHnJPIQiKcA collected $0.60 from pot
egvg3mTBBVzMHnJPIQiKcA: doesn't show hand 
*** SUMMARY ***
Total pot $0.60 | Rake $0 
Seat 1: qwr38jl5txoR36M7G5qi4A folded before Flop (didn't bet)
Seat 2: dtZ84flFEi4Q+SGrHMJRDQ folded before Flop (didn't bet)
Seat 3: sD+TKtt36XiiN6jqHiLwDA folded before Flop (didn't bet)
Seat 4: gehe91e0IyVT0QU/XBkEyg folded before Flop (didn't bet)
Seat 5: GrNTWMdwy+jC6Lred1eDng folded before Flop (didn't bet)
Seat 6: egvg3mTBBVzMHnJPIQiKcA (button) collected ($0.60)
Seat 7: eK8qa6EPcH2zhtbmWSvc9g (small blind) folded before Flop
Seat 8: OXPkK84/qv92EMwXPiG5rQ (big blind) folded before Flop
Seat 9: P+9ymZQ3ktpQu1bn7HIjew folded before Flop (didn't bet)




PokerStars Game #59941858582:  Hold'em No Limit ($0.10/$0.25) - 2009/07/01 1:48:24 ET
Table 'pgrBYaOEx/BuqK5iAtlFzw' 9-max Seat #4 is the button
Seat 1: 6O+8t5ikoK+pNiFXnN/Fyw ($18.60 in chips) 
Seat 2: 2Xwi447v1rBHM+92U0CduA ($3.65 in chips) 
Seat 3: Bb42QRQMhg5/Y0vHP8/2Xw ($25 in chips) 
Seat 4: oLa/tXLfSLLB28mcLGrxcg ($23.90 in chips) 
Seat 5: BWzInv8o0kN1pJybv/VjpQ ($28.50 in chips) 
Seat 6: eubS00Znk+qsx0B0+7/Zow ($19.10 in chips) 
Seat 7: eK8qa6EPcH2zhtbmWSvc9g ($25 in chips) 
Seat 8: tLcDklc2rBORNfixyRfVfw ($27.45 in chips) 
BWzInv8o0kN1pJybv/VjpQ: posts small blind $0.10
eubS00Znk+qsx0B0+7/Zow: posts big blind $0.25
Z9W7+g1WMhhZDi7DwGbCFA: sits out 
*** HOLE CARDS ***
eK8qa6EPcH2zhtbmWSvc9g: folds 
tLcDklc2rBORNfixyRfVfw: folds 
6O+8t5ikoK+pNiFXnN/Fyw: folds 
2Xwi447v1rBHM+92U0CduA: calls $0.25
Bb42QRQMhg5/Y0vHP8/2Xw: folds 
oLa/tXLfSLLB28mcLGrxcg: folds 
BWzInv8o0kN1pJybv/VjpQ: raises $0.50 to $0.75
eubS00Znk+qsx0B0+7/Zow: folds 
2Xwi447v1rBHM+92U0CduA: calls $0.50
*** FLOP *** [8c 9h 9d]
BWzInv8o0kN1pJybv/VjpQ: bets $0.75
2Xwi447v1rBHM+92U0CduA: raises $2.15 to $2.90 and is all-in
BWzInv8o0kN1pJybv/VjpQ: calls $2.15
*** TURN *** [8c 9h 9d] [Ks]
*** RIVER *** [8c 9h 9d Ks] [7c]
*** SHOW DOWN ***
BWzInv8o0kN1pJybv/VjpQ: shows [Ac Jc] (a pair of Nines)
2Xwi447v1rBHM+92U0CduA: shows [Tc Js] (a straight, Seven to Jack)
2Xwi447v1rBHM+92U0CduA collected $7.20 from pot
*** SUMMARY ***
Total pot $7.55 | Rake $0.35 
Board [8c 9h 9d Ks 7c]
Seat 1: 6O+8t5ikoK+pNiFXnN/Fyw folded before Flop (didn't bet)
Seat 2: 2Xwi447v1rBHM+92U0CduA showed [Tc Js] and won ($7.20) with a straight, Seven to Jack
Seat 3: Bb42QRQMhg5/Y0vHP8/2Xw folded before Flop (didn't bet)
Seat 4: oLa/tXLfSLLB28mcLGrxcg (button) folded before Flop (didn't bet)
Seat 5: BWzInv8o0kN1pJybv/VjpQ (small blind) showed [Ac Jc] and lost with a pair of Nines
Seat 6: eubS00Znk+qsx0B0+7/Zow (big blind) folded before Flop
Seat 7: eK8qa6EPcH2zhtbmWSvc9g folded before Flop (didn't bet)
Seat 8: tLcDklc2rBORNfixyRfVfw folded before Flop (didn't bet)




PokerStars Game #59941858412:  Hold'em No Limit ($0.10/$0.25) - 2009/07/01 1:48:24 ET
Table 'KEoOIegxPF91KooL2AelUA' 6-max Seat #3 is the button
Seat 2: 0Bg59Tnte1Tc7C4i9Jd9cQ ($5.40 in chips) 
Seat 3: zxeVQGaMKDsDzmSY+AInjA ($13.10 in chips) 
Seat 4: Wo60l2GQnSEc3bxPVyvIUw ($9.95 in chips) 
Seat 5: 08V++DOqzaNrRNsHIwi25w ($51.75 in chips) 
Seat 6: AMrBn4Vx9aAo/vv6WHLk6w ($1.90 in chips) 
Wo60l2GQnSEc3bxPVyvIUw: posts small blind $0.10
08V++DOqzaNrRNsHIwi25w: posts big blind $0.25
32YL2ZEp8NT4JB2RVM9euQ: sits out 
*** HOLE CARDS ***
AMrBn4Vx9aAo/vv6WHLk6w: raises $0.50 to $0.75
0Bg59Tnte1Tc7C4i9Jd9cQ: folds 
zxeVQGaMKDsDzmSY+AInjA: folds 
Wo60l2GQnSEc3bxPVyvIUw: raises $2.25 to $3
08V++DOqzaNrRNsHIwi25w: folds 
AMrBn4Vx9aAo/vv6WHLk6w: calls $1.15 and is all-in
Uncalled bet ($1.10) returned to Wo60l2GQnSEc3bxPVyvIUw
*** FLOP *** [9h 6h 5h]
*** TURN *** [9h 6h 5h] [5s]
*** RIVER *** [9h 6h 5h 5s] [Kc]
*** SHOW DOWN ***
Wo60l2GQnSEc3bxPVyvIUw: shows [3c 3h] (two pair, Fives and Threes)
AMrBn4Vx9aAo/vv6WHLk6w: shows [8s 8c] (two pair, Eights and Fives)
AMrBn4Vx9aAo/vv6WHLk6w collected $3.85 from pot
*** SUMMARY ***
Total pot $4.05 | Rake $0.20 
Board [9h 6h 5h 5s Kc]
Seat 2: 0Bg59Tnte1Tc7C4i9Jd9cQ folded before Flop (didn't bet)
Seat 3: zxeVQGaMKDsDzmSY+AInjA (button) folded before Flop (didn't bet)
Seat 4: Wo60l2GQnSEc3bxPVyvIUw (small blind) showed [3c 3h] and lost with two pair, Fives and Threes
Seat 5: 08V++DOqzaNrRNsHIwi25w (big blind) folded before Flop
Seat 6: AMrBn4Vx9aAo/vv6WHLk6w showed [8s 8c] and won ($3.85) with two pair, Eights and Fives




PokerStars Game #59941859000:  Hold'em No Limit ($0.10/$0.25) - 2009/07/01 1:48:25 ET
Table 'QzXakDK7ZHNjgIpoUFGSKQ' 9-max Seat #4 is the button
Seat 1: w1ukf8uPa4+WH561TtVRxA ($25 in chips) 
Seat 2: QEbIGci+itdw+re8RM5fZA ($25 in chips) 
Seat 3: eK8qa6EPcH2zhtbmWSvc9g ($25.30 in chips) 
Seat 4: 12pxJGeALcKLTBryE6kFxA ($14.15 in chips) 
Seat 5: MtVtHDqIJTyUcXkRBBDIVA ($31.30 in chips) 
Seat 6: gehe91e0IyVT0QU/XBkEyg ($25 in chips) 
Seat 7: wGigCmBR/9XWkPpvYos3aQ ($29.90 in chips) 
Seat 9: lwrOE80tuooHfIBx/4LUSw ($23.90 in chips) 
MtVtHDqIJTyUcXkRBBDIVA: posts small blind $0.10
gehe91e0IyVT0QU/XBkEyg: posts big blind $0.25
Z9W7+g1WMhhZDi7DwGbCFA: sits out 
*** HOLE CARDS ***
wGigCmBR/9XWkPpvYos3aQ: folds 
lwrOE80tuooHfIBx/4LUSw: folds 
w1ukf8uPa4+WH561TtVRxA: folds 
QEbIGci+itdw+re8RM5fZA: raises $0.50 to $0.75
eK8qa6EPcH2zhtbmWSvc9g: folds 
12pxJGeALcKLTBryE6kFxA: folds 
MtVtHDqIJTyUcXkRBBDIVA: folds 
gehe91e0IyVT0QU/XBkEyg: raises $1.75 to $2.50
QEbIGci+itdw+re8RM5fZA: folds 
Uncalled bet ($1.75) returned to gehe91e0IyVT0QU/XBkEyg
gehe91e0IyVT0QU/XBkEyg collected $1.60 from pot
gehe91e0IyVT0QU/XBkEyg: doesn't show hand 
*** SUMMARY ***
Total pot $1.60 | Rake $0 
Seat 1: w1ukf8uPa4+WH561TtVRxA folded before Flop (didn't bet)
Seat 2: QEbIGci+itdw+re8RM5fZA folded before Flop
Seat 3: eK8qa6EPcH2zhtbmWSvc9g folded before Flop (didn't bet)
Seat 4: 12pxJGeALcKLTBryE6kFxA (button) folded before Flop (didn't bet)
Seat 5: MtVtHDqIJTyUcXkRBBDIVA (small blind) folded before Flop
Seat 6: gehe91e0IyVT0QU/XBkEyg (big blind) collected ($1.60)
Seat 7: wGigCmBR/9XWkPpvYos3aQ folded before Flop (didn't bet)
Seat 9: lwrOE80tuooHfIBx/4LUSw folded before Flop (didn't bet)




PokerStars Game #59941858824:  Hold'em No Limit ($0.10/$0.25) - 2009/07/01 1:48:25 ET
Table '52Meibn9NOL4XtVi1p2Upw' 9-max Seat #7 is the button
Seat 1: W6tExOcYX7qiy6Qdp+ZwFA ($6.55 in chips) 
Seat 3: Bb42QRQMhg5/Y0vHP8/2Xw ($26.25 in chips) 
Seat 4: oLa/tXLfSLLB28mcLGrxcg ($31.65 in chips) 
Seat 5: MXCztnYJ58KLHMztZvKrxA ($3.60 in chips) 
Seat 6: N5sUK8M0br9djLrW97V9pQ ($29.50 in chips) 
Seat 7: Qduu7ikeizo6q6Ei9YvcJA ($25 in chips) 
Seat 8: w7VrLGwaVQzOQXfRqJitMQ ($21.60 in chips) 
Seat 9: RCqMONFrSPSArZh2Jsar/w ($19.65 in chips) 
w7VrLGwaVQzOQXfRqJitMQ: posts small blind $0.10
RCqMONFrSPSArZh2Jsar/w: posts big blind $0.25
CGjLyv/AvljZy2g76nYkzQ: sits out 
*** HOLE CARDS ***
W6tExOcYX7qiy6Qdp+ZwFA: folds 
Bb42QRQMhg5/Y0vHP8/2Xw: calls $0.25
oLa/tXLfSLLB28mcLGrxcg: folds 
MXCztnYJ58KLHMztZvKrxA: calls $0.25
N5sUK8M0br9djLrW97V9pQ: folds 
Qduu7ikeizo6q6Ei9YvcJA: calls $0.25
w7VrLGwaVQzOQXfRqJitMQ: folds 
RCqMONFrSPSArZh2Jsar/w: checks 
*** FLOP *** [4h 7s 8h]
RCqMONFrSPSArZh2Jsar/w: checks 
Bb42QRQMhg5/Y0vHP8/2Xw: checks 
MXCztnYJ58KLHMztZvKrxA: checks 
Qduu7ikeizo6q6Ei9YvcJA: checks 
*** TURN *** [4h 7s 8h] [9d]
RCqMONFrSPSArZh2Jsar/w: bets $0.75
Bb42QRQMhg5/Y0vHP8/2Xw: folds 
MXCztnYJ58KLHMztZvKrxA: raises $1.25 to $2
Qduu7ikeizo6q6Ei9YvcJA: folds 
RCqMONFrSPSArZh2Jsar/w: calls $1.25
*** RIVER *** [4h 7s 8h 9d] [Ks]
RCqMONFrSPSArZh2Jsar/w: checks 
MXCztnYJ58KLHMztZvKrxA: bets $1.35 and is all-in
RCqMONFrSPSArZh2Jsar/w: calls $1.35
*** SHOW DOWN ***
MXCztnYJ58KLHMztZvKrxA: shows [Kd 9h] (two pair, Kings and Nines)
RCqMONFrSPSArZh2Jsar/w: mucks hand 
MXCztnYJ58KLHMztZvKrxA collected $7.45 from pot
*** SUMMARY ***
Total pot $7.80 | Rake $0.35 
Board [4h 7s 8h 9d Ks]
Seat 1: W6tExOcYX7qiy6Qdp+ZwFA folded before Flop (didn't bet)
Seat 3: Bb42QRQMhg5/Y0vHP8/2Xw folded on the Turn
Seat 4: oLa/tXLfSLLB28mcLGrxcg folded before Flop (didn't bet)
Seat 5: MXCztnYJ58KLHMztZvKrxA showed [Kd 9h] and won ($7.45) with two pair, Kings and Nines
Seat 6: N5sUK8M0br9djLrW97V9pQ folded before Flop (didn't bet)
Seat 7: Qduu7ikeizo6q6Ei9YvcJA (button) folded on the Turn
Seat 8: w7VrLGwaVQzOQXfRqJitMQ (small blind) folded before Flop
Seat 9: RCqMONFrSPSArZh2Jsar/w (big blind) mucked




PokerStars Game #59941859126:  Hold'em No Limit ($0.10/$0.25) - 2009/07/01 1:48:25 ET
Table 'jz4TpuH+ag+0iNe2ZcxckQ' 9-max Seat #2 is the button
Seat 2: clJsV3v77RS07bDKY+705w ($6.10 in chips) 
Seat 3: egvg3mTBBVzMHnJPIQiKcA ($15.30 in chips) 
Seat 4: k+2r6di6GXjNpAdrRkW9bA ($58.15 in chips) 
Seat 5: v1BVHNGLbP/nx7QO6K7+Jw ($37.50 in chips) 
Seat 6: gO1uiTGTzn5Cd3PECuws1g ($13.65 in chips) 
Seat 7: tLcDklc2rBORNfixyRfVfw ($43.05 in chips) 
Seat 8: uhrboV251dcgYniYTdFIcA ($25.35 in chips) 
Seat 9: W2YYHvqjaEpRrO7stZkClQ ($5.30 in chips) 
egvg3mTBBVzMHnJPIQiKcA: posts small blind $0.10
k+2r6di6GXjNpAdrRkW9bA: posts big blind $0.25
4awUyiDYTgylQKXZ9faBVA: sits out 
*** HOLE CARDS ***
v1BVHNGLbP/nx7QO6K7+Jw has timed out
v1BVHNGLbP/nx7QO6K7+Jw: folds 
v1BVHNGLbP/nx7QO6K7+Jw is sitting out
v1BVHNGLbP/nx7QO6K7+Jw has returned
gO1uiTGTzn5Cd3PECuws1g: raises $0.25 to $0.50
tLcDklc2rBORNfixyRfVfw: folds 
uhrboV251dcgYniYTdFIcA: folds 
W2YYHvqjaEpRrO7stZkClQ: folds 
clJsV3v77RS07bDKY+705w: folds 
egvg3mTBBVzMHnJPIQiKcA: raises $0.50 to $1
k+2r6di6GXjNpAdrRkW9bA: folds 
gO1uiTGTzn5Cd3PECuws1g: raises $0.50 to $1.50
egvg3mTBBVzMHnJPIQiKcA: calls $0.50
*** FLOP *** [4h 7c 7d]
egvg3mTBBVzMHnJPIQiKcA: bets $1.75
gO1uiTGTzn5Cd3PECuws1g: calls $1.75
*** TURN *** [4h 7c 7d] [9h]
egvg3mTBBVzMHnJPIQiKcA: bets $2
gO1uiTGTzn5Cd3PECuws1g: folds 
Uncalled bet ($2) returned to egvg3mTBBVzMHnJPIQiKcA
egvg3mTBBVzMHnJPIQiKcA collected $6.45 from pot
*** SUMMARY ***
Total pot $6.75 | Rake $0.30 
Board [4h 7c 7d 9h]
Seat 2: clJsV3v77RS07bDKY+705w (button) folded before Flop (didn't bet)
Seat 3: egvg3mTBBVzMHnJPIQiKcA (small blind) collected ($6.45)
Seat 4: k+2r6di6GXjNpAdrRkW9bA (big blind) folded before Flop
Seat 5: v1BVHNGLbP/nx7QO6K7+Jw folded before Flop (didn't bet)
Seat 6: gO1uiTGTzn5Cd3PECuws1g folded on the Turn
Seat 7: tLcDklc2rBORNfixyRfVfw folded before Flop (didn't bet)
Seat 8: uhrboV251dcgYniYTdFIcA folded before Flop (didn't bet)
Seat 9: W2YYHvqjaEpRrO7stZkClQ folded before Flop (didn't bet)




PokerStars Game #59941859268:  Hold'em No Limit ($0.10/$0.25) - 2009/07/01 1:48:25 ET
Table 'dVzscin98UhGisTmV9BDcw' 9-max Seat #2 is the button
Seat 1: sBAwXpkpgyhyWbHIQcIJKA ($17.15 in chips) 
Seat 2: dfNim92Z6XK1/h5SFW5vDg ($28 in chips) 
Seat 3: cZ99hugmLBj9KhTlc8nCSw ($25 in chips) 
Seat 5: E0iYnEVO2ho7dH3QcCjw7g ($20 in chips) 
Seat 6: A/OkFabqdcrG3ozpiYMiNQ ($25.50 in chips) 
Seat 7: cKlmpQMahVsmOaxFQDcoOg ($25.25 in chips) 
Seat 8: /vn2Qu2dvc9AMMq46Ae0jA ($46.75 in chips) 
Seat 9: arxNSjreDRGFg13EAM2F1w ($25 in chips) 
cZ99hugmLBj9KhTlc8nCSw: posts small blind $0.10
aNpwfA31EREwO+ar4XzBCw: is sitting out 
E0iYnEVO2ho7dH3QcCjw7g: posts big blind $0.25
*** HOLE CARDS ***
A/OkFabqdcrG3ozpiYMiNQ: calls $0.25
cKlmpQMahVsmOaxFQDcoOg: folds 
/vn2Qu2dvc9AMMq46Ae0jA: folds 
arxNSjreDRGFg13EAM2F1w: folds 
sBAwXpkpgyhyWbHIQcIJKA: folds 
dfNim92Z6XK1/h5SFW5vDg: folds 
cZ99hugmLBj9KhTlc8nCSw: folds 
E0iYnEVO2ho7dH3QcCjw7g: checks 
*** FLOP *** [5d 6d 7h]
E0iYnEVO2ho7dH3QcCjw7g: checks 
A/OkFabqdcrG3ozpiYMiNQ: bets $0.50
E0iYnEVO2ho7dH3QcCjw7g: calls $0.50
*** TURN *** [5d 6d 7h] [7d]
E0iYnEVO2ho7dH3QcCjw7g: checks 
A/OkFabqdcrG3ozpiYMiNQ: bets $1
E0iYnEVO2ho7dH3QcCjw7g: calls $1
*** RIVER *** [5d 6d 7h 7d] [5c]
E0iYnEVO2ho7dH3QcCjw7g: bets $3.25
A/OkFabqdcrG3ozpiYMiNQ: calls $3.25
*** SHOW DOWN ***
E0iYnEVO2ho7dH3QcCjw7g: shows [7s Jd] (a full house, Sevens full of Fives)
A/OkFabqdcrG3ozpiYMiNQ: mucks hand 
E0iYnEVO2ho7dH3QcCjw7g collected $9.65 from pot
*** SUMMARY ***
Total pot $10.10 | Rake $0.45 
Board [5d 6d 7h 7d 5c]
Seat 1: sBAwXpkpgyhyWbHIQcIJKA folded before Flop (didn't bet)
Seat 2: dfNim92Z6XK1/h5SFW5vDg (button) folded before Flop (didn't bet)
Seat 3: cZ99hugmLBj9KhTlc8nCSw (small blind) folded before Flop
Seat 5: E0iYnEVO2ho7dH3QcCjw7g (big blind) showed [7s Jd] and won ($9.65) with a full house, Sevens full of Fives
Seat 6: A/OkFabqdcrG3ozpiYMiNQ mucked
Seat 7: cKlmpQMahVsmOaxFQDcoOg folded before Flop (didn't bet)
Seat 8: /vn2Qu2dvc9AMMq46Ae0jA folded before Flop (didn't bet)
Seat 9: arxNSjreDRGFg13EAM2F1w folded before Flop (didn't bet)




PokerStars Game #59941859004:  Hold'em No Limit ($0.10/$0.25) - 2009/07/01 1:48:25 ET
Table '63uh7ZsO7Tnt+E8b/2bu3A' 6-max Seat #1 is the button
Seat 1: 0av6tRNdi0Ui4f15L7gsVg ($29.85 in chips) 
Seat 2: SFmT9ZsVopnukjvAzrxTRg ($30.40 in chips) 
Seat 3: yVP7GLZBzx47OPi6jzUxMw ($4.75 in chips) 
Seat 4: rnpAao581IcvQglpkpnkoQ ($11.25 in chips) 
Seat 5: GbCVUNssQ7mqsPWr7J4d3w ($9.75 in chips) 
Seat 6: qGHGf/553gQnDoklMRe3tg ($26.90 in chips) 
SFmT9ZsVopnukjvAzrxTRg: posts small blind $0.10
yVP7GLZBzx47OPi6jzUxMw: posts big blind $0.25
*** HOLE CARDS ***
rnpAao581IcvQglpkpnkoQ: calls $0.25
GbCVUNssQ7mqsPWr7J4d3w: folds 
qGHGf/553gQnDoklMRe3tg: folds 
0av6tRNdi0Ui4f15L7gsVg: folds 
SFmT9ZsVopnukjvAzrxTRg: folds 
yVP7GLZBzx47OPi6jzUxMw: checks 
*** FLOP *** [8s 3s Tc]
yVP7GLZBzx47OPi6jzUxMw: checks 
rnpAao581IcvQglpkpnkoQ: checks 
*** TURN *** [8s 3s Tc] [2c]
yVP7GLZBzx47OPi6jzUxMw: checks 
rnpAao581IcvQglpkpnkoQ: checks 
*** RIVER *** [8s 3s Tc 2c] [2h]
yVP7GLZBzx47OPi6jzUxMw: checks 
rnpAao581IcvQglpkpnkoQ: checks 
*** SHOW DOWN ***
yVP7GLZBzx47OPi6jzUxMw: shows [8d 4s] (two pair, Eights and Deuces)
rnpAao581IcvQglpkpnkoQ: mucks hand 
yVP7GLZBzx47OPi6jzUxMw collected $0.60 from pot
*** SUMMARY ***
Total pot $0.60 | Rake $0 
Board [8s 3s Tc 2c 2h]
Seat 1: 0av6tRNdi0Ui4f15L7gsVg (button) folded before Flop (didn't bet)
Seat 2: SFmT9ZsVopnukjvAzrxTRg (small blind) folded before Flop
Seat 3: yVP7GLZBzx47OPi6jzUxMw (big blind) showed [8d 4s] and won ($0.60) with two pair, Eights and Deuces
Seat 4: rnpAao581IcvQglpkpnkoQ mucked
Seat 5: GbCVUNssQ7mqsPWr7J4d3w folded before Flop (didn't bet)
Seat 6: qGHGf/553gQnDoklMRe3tg folded before Flop (didn't bet)




PokerStars Game #59941859204:  Hold'em No Limit ($0.10/$0.25) - 2009/07/01 1:48:25 ET
Table 'xmJKTGBeWCwutccj3YfupQ' 6-max Seat #1 is the button
Seat 1: sVbkVl4OznxBCfi66UB9vw ($40.95 in chips) 
Seat 2: QqiZLFrN8iOUT/GHw7ztOA ($24.75 in chips) 
Seat 3: T5wrp/d5jarm+SxNy8OQAg ($25.50 in chips) 
Seat 4: uWjhTVMpuIroxXcmD3Okug ($17 in chips) 
Seat 5: DE9hRlt14g+JdsRQ4wT7hg ($29.60 in chips) 
Seat 6: 9bpVv1/Qh9IYtXuCtl5VtQ ($25 in chips) 
QqiZLFrN8iOUT/GHw7ztOA: posts small blind $0.10
T5wrp/d5jarm+SxNy8OQAg: posts big blind $0.25
*** HOLE CARDS ***
9bpVv1/Qh9IYtXuCtl5VtQ said, "fish hand"
uWjhTVMpuIroxXcmD3Okug: calls $0.25
DE9hRlt14g+JdsRQ4wT7hg: folds 
9bpVv1/Qh9IYtXuCtl5VtQ: folds 
sVbkVl4OznxBCfi66UB9vw: calls $0.25
QqiZLFrN8iOUT/GHw7ztOA: folds 
T5wrp/d5jarm+SxNy8OQAg: checks 
*** FLOP *** [9c Jc 2s]
T5wrp/d5jarm+SxNy8OQAg: checks 
uWjhTVMpuIroxXcmD3Okug said, "wait you called with nothing correct"
uWjhTVMpuIroxXcmD3Okug: checks 
sVbkVl4OznxBCfi66UB9vw: checks 
*** TURN *** [9c Jc 2s] [Jd]
T5wrp/d5jarm+SxNy8OQAg: bets $0.50
uWjhTVMpuIroxXcmD3Okug: folds 
sVbkVl4OznxBCfi66UB9vw: folds 
Uncalled bet ($0.50) returned to T5wrp/d5jarm+SxNy8OQAg
T5wrp/d5jarm+SxNy8OQAg collected $0.85 from pot
*** SUMMARY ***
Total pot $0.85 | Rake $0 
Board [9c Jc 2s Jd]
Seat 1: sVbkVl4OznxBCfi66UB9vw (button) folded on the Turn
Seat 2: QqiZLFrN8iOUT/GHw7ztOA (small blind) folded before Flop
Seat 3: T5wrp/d5jarm+SxNy8OQAg (big blind) collected ($0.85)
Seat 4: uWjhTVMpuIroxXcmD3Okug folded on the Turn
Seat 5: DE9hRlt14g+JdsRQ4wT7hg folded before Flop (didn't bet)
Seat 6: 9bpVv1/Qh9IYtXuCtl5VtQ folded before Flop (didn't bet)




PokerStars Game #59941859672:  Hold'em No Limit ($0.10/$0.25) - 2009/07/01 1:48:26 ET
Table 'IuqVbFI+pwnJjvwBCGSGAw' 6-max Seat #3 is the button
Seat 1: LyDHtw3/yniNHW+DvLXbog ($28.10 in chips) 
Seat 2: w43JQj2oYPpKQVG4Yzlq1w ($25 in chips) 
Seat 3: QiL+lEgEWwy21jk/ltaRLg ($21.05 in chips) 
Seat 4: DE9hRlt14g+JdsRQ4wT7hg ($27.15 in chips) 
Seat 5: if4dh6jhJXeN3/qd3qCp9g ($24.60 in chips) 
Seat 6: xC0kaiDYM6YTlgODL83O5A ($13.15 in chips) 
DE9hRlt14g+JdsRQ4wT7hg: posts small blind $0.10
if4dh6jhJXeN3/qd3qCp9g: posts big blind $0.25
*** HOLE CARDS ***
xC0kaiDYM6YTlgODL83O5A: folds 
LyDHtw3/yniNHW+DvLXbog: folds 
w43JQj2oYPpKQVG4Yzlq1w: folds 
QiL+lEgEWwy21jk/ltaRLg: folds 
DE9hRlt14g+JdsRQ4wT7hg: folds 
Uncalled bet ($0.15) returned to if4dh6jhJXeN3/qd3qCp9g
if4dh6jhJXeN3/qd3qCp9g collected $0.20 from pot
if4dh6jhJXeN3/qd3qCp9g: doesn't show hand 
*** SUMMARY ***
Total pot $0.20 | Rake $0 
Seat 1: LyDHtw3/yniNHW+DvLXbog folded before Flop (didn't bet)
Seat 2: w43JQj2oYPpKQVG4Yzlq1w folded before Flop (didn't bet)
Seat 3: QiL+lEgEWwy21jk/ltaRLg (button) folded before Flop (didn't bet)
Seat 4: DE9hRlt14g+JdsRQ4wT7hg (small blind) folded before Flop
Seat 5: if4dh6jhJXeN3/qd3qCp9g (big blind) collected ($0.20)
Seat 6: xC0kaiDYM6YTlgODL83O5A folded before Flop (didn't bet)




PokerStars Game #59941859824:  Hold'em No Limit ($0.10/$0.25) - 2009/07/01 1:48:26 ET
Table '9SExUHslNkrPJ4XsrePaVw' 9-max Seat #6 is the button
Seat 1: RHqgdFvufLCYe54+qd2gcA ($4.50 in chips) 
Seat 2: cZ99hugmLBj9KhTlc8nCSw ($44.10 in chips) 
Seat 3: EP17SQz/iWcuYdNOGeBgkw ($13.80 in chips) 
Seat 4: 4awUyiDYTgylQKXZ9faBVA ($25 in chips) 
Seat 5: L+eJnUyhY8bMNYw755K8XQ ($15.40 in chips) 
Seat 6: YPJ90cgNXDABdYJcqmwB0A ($20.60 in chips) 
Seat 8: tLcDklc2rBORNfixyRfVfw ($26.45 in chips) 
Seat 9: /THNzAxdv2lBxcf4XTj/0g ($9.35 in chips) 
sx0lGrkT9fd4yFR+3cXUQg will be allowed to play after the button
tLcDklc2rBORNfixyRfVfw: posts small blind $0.10
/THNzAxdv2lBxcf4XTj/0g: posts big blind $0.25
*** HOLE CARDS ***
RHqgdFvufLCYe54+qd2gcA: folds 
cZ99hugmLBj9KhTlc8nCSw: folds 
EP17SQz/iWcuYdNOGeBgkw: folds 
4awUyiDYTgylQKXZ9faBVA: folds 
L+eJnUyhY8bMNYw755K8XQ: folds 
YPJ90cgNXDABdYJcqmwB0A: folds 
tLcDklc2rBORNfixyRfVfw: folds 
Uncalled bet ($0.15) returned to /THNzAxdv2lBxcf4XTj/0g
/THNzAxdv2lBxcf4XTj/0g collected $0.20 from pot
*** SUMMARY ***
Total pot $0.20 | Rake $0 
Seat 1: RHqgdFvufLCYe54+qd2gcA folded before Flop (didn't bet)
Seat 2: cZ99hugmLBj9KhTlc8nCSw folded before Flop (didn't bet)
Seat 3: EP17SQz/iWcuYdNOGeBgkw folded before Flop (didn't bet)
Seat 4: 4awUyiDYTgylQKXZ9faBVA folded before Flop (didn't bet)
Seat 5: L+eJnUyhY8bMNYw755K8XQ folded before Flop (didn't bet)
Seat 6: YPJ90cgNXDABdYJcqmwB0A (button) folded before Flop (didn't bet)
Seat 8: tLcDklc2rBORNfixyRfVfw (small blind) folded before Flop
Seat 9: /THNzAxdv2lBxcf4XTj/0g (big blind) collected ($0.20)




PokerStars Game #59941859502:  Hold'em No Limit ($0.10/$0.25) - 2009/07/01 1:48:26 ET
Table 'KU/HrxqxwDz8HKEhYTZ6uw' 6-max Seat #5 is the button
Seat 1: 7LKoiQHXpTQXJvWQrw907g ($36.80 in chips) 
Seat 2: kG34n23qFQA3nzdOJTQ1dA ($24.65 in chips) 
Seat 3: SFmT9ZsVopnukjvAzrxTRg ($25.60 in chips) 
Seat 5: iyZxqznXjv3vtvOJymkoLQ ($50.55 in chips) 
Seat 6: qWxkCeqApAWdAA0evrfDvQ ($12.50 in chips) 
qWxkCeqApAWdAA0evrfDvQ: posts small blind $0.10
7LKoiQHXpTQXJvWQrw907g: posts big blind $0.25
*** HOLE CARDS ***
kG34n23qFQA3nzdOJTQ1dA: folds 
SFmT9ZsVopnukjvAzrxTRg: folds 
iyZxqznXjv3vtvOJymkoLQ: raises $0.75 to $1
qWxkCeqApAWdAA0evrfDvQ: folds 
7LKoiQHXpTQXJvWQrw907g: calls $0.75
*** FLOP *** [Js Th Ts]
7LKoiQHXpTQXJvWQrw907g: checks 
iyZxqznXjv3vtvOJymkoLQ: checks 
*** TURN *** [Js Th Ts] [3c]
7LKoiQHXpTQXJvWQrw907g: bets $1.25
iyZxqznXjv3vtvOJymkoLQ: calls $1.25
*** RIVER *** [Js Th Ts 3c] [6c]
7LKoiQHXpTQXJvWQrw907g: checks 
iyZxqznXjv3vtvOJymkoLQ: checks 
*** SHOW DOWN ***
7LKoiQHXpTQXJvWQrw907g: shows [Qs Kc] (a pair of Tens)
iyZxqznXjv3vtvOJymkoLQ: shows [Ad Qh] (a pair of Tens - Ace kicker)
iyZxqznXjv3vtvOJymkoLQ collected $4.40 from pot
*** SUMMARY ***
Total pot $4.60 | Rake $0.20 
Board [Js Th Ts 3c 6c]
Seat 1: 7LKoiQHXpTQXJvWQrw907g (big blind) showed [Qs Kc] and lost with a pair of Tens
Seat 2: kG34n23qFQA3nzdOJTQ1dA folded before Flop (didn't bet)
Seat 3: SFmT9ZsVopnukjvAzrxTRg folded before Flop (didn't bet)
Seat 5: iyZxqznXjv3vtvOJymkoLQ (button) showed [Ad Qh] and won ($4.40) with a pair of Tens
Seat 6: qWxkCeqApAWdAA0evrfDvQ (small blind) folded before Flop




PokerStars Game #59941859630:  Hold'em No Limit ($0.10/$0.25) - 2009/07/01 1:48:26 ET
Table 'zW+7jPbOLCvlPu+dUGY5WQ' 6-max Seat #1 is the button
Seat 1: eL3+wCBjFGfQ5FMdIZihwA ($26.15 in chips) 
Seat 2: cEMJmfAUQZmMChZe6aacKw ($9.95 in chips) 
Seat 4: i48129QFpEQQ+UN4aNtmww ($16.55 in chips) 
Seat 5: Hsvkc0/G2VV78oVmWYXecw ($7.50 in chips) 
Seat 6: qGHGf/553gQnDoklMRe3tg ($25 in chips) 
cEMJmfAUQZmMChZe6aacKw: posts small blind $0.10
i48129QFpEQQ+UN4aNtmww: posts big blind $0.25
*** HOLE CARDS ***
Hsvkc0/G2VV78oVmWYXecw: folds 
Hsvkc0/G2VV78oVmWYXecw leaves the table
qGHGf/553gQnDoklMRe3tg: folds 
eL3+wCBjFGfQ5FMdIZihwA: raises $0.50 to $0.75
cEMJmfAUQZmMChZe6aacKw: folds 
i48129QFpEQQ+UN4aNtmww: folds 
Uncalled bet ($0.50) returned to eL3+wCBjFGfQ5FMdIZihwA
eL3+wCBjFGfQ5FMdIZihwA collected $0.60 from pot
*** SUMMARY ***
Total pot $0.60 | Rake $0 
Seat 1: eL3+wCBjFGfQ5FMdIZihwA (button) collected ($0.60)
Seat 2: cEMJmfAUQZmMChZe6aacKw (small blind) folded before Flop
Seat 4: i48129QFpEQQ+UN4aNtmww (big blind) folded before Flop
Seat 5: Hsvkc0/G2VV78oVmWYXecw folded before Flop (didn't bet)
Seat 6: qGHGf/553gQnDoklMRe3tg folded before Flop (didn't bet)




PokerStars Game #59941859812:  Hold'em No Limit ($0.10/$0.25) - 2009/07/01 1:48:26 ET
Table 'dZNBGqFYSwfOVZvDJ4VjIQ' 6-max Seat #3 is the button
Seat 1: v+QfkGiuj9bgtuNoVnDO8w ($38.35 in chips) 
Seat 2: 3zD3qLXT1bEffAoWGnc7wg ($28.30 in chips) 
Seat 3: kyRaCIljYA6l33lSKQfNsg ($27.95 in chips) 
Seat 5: +ZlnqPoP3Hg4BIUxDfKd/A ($29.60 in chips) 
Seat 6: ypmjhffk/YHGc51wgVXUTw ($29.40 in chips) 
mFv3iBCtrw9XfCDRB0d46Q: is sitting out 
+ZlnqPoP3Hg4BIUxDfKd/A: posts small blind $0.10
ypmjhffk/YHGc51wgVXUTw: posts big blind $0.25
*** HOLE CARDS ***
v+QfkGiuj9bgtuNoVnDO8w: folds 
3zD3qLXT1bEffAoWGnc7wg: folds 
kyRaCIljYA6l33lSKQfNsg: folds 
+ZlnqPoP3Hg4BIUxDfKd/A: calls $0.15
ypmjhffk/YHGc51wgVXUTw: checks 
*** FLOP *** [6c 3c Ks]
+ZlnqPoP3Hg4BIUxDfKd/A: bets $0.50
ypmjhffk/YHGc51wgVXUTw: folds 
Uncalled bet ($0.50) returned to +ZlnqPoP3Hg4BIUxDfKd/A
+ZlnqPoP3Hg4BIUxDfKd/A collected $0.50 from pot
+ZlnqPoP3Hg4BIUxDfKd/A: doesn't show hand 
*** SUMMARY ***
Total pot $0.50 | Rake $0 
Board [6c 3c Ks]
Seat 1: v+QfkGiuj9bgtuNoVnDO8w folded before Flop (didn't bet)
Seat 2: 3zD3qLXT1bEffAoWGnc7wg folded before Flop (didn't bet)
Seat 3: kyRaCIljYA6l33lSKQfNsg (button) folded before Flop (didn't bet)
Seat 5: +ZlnqPoP3Hg4BIUxDfKd/A (small blind) collected ($0.50)
Seat 6: ypmjhffk/YHGc51wgVXUTw (big blind) folded on the Flop




PokerStars Game #59941860150:  Hold'em No Limit ($0.10/$0.25) - 2009/07/01 1:48:27 ET
Table 'nc6OeGk/wtaWV+6N+kgnZQ' 6-max Seat #4 is the button
Seat 2: 8ClCHtFXGNplITm+63KB+Q ($37.95 in chips) 
Seat 3: y8wpMWGSX2zHZijurx21mg ($4 in chips) 
Seat 4: 3zD3qLXT1bEffAoWGnc7wg ($31.55 in chips) 
Seat 5: HCS0lMAAPmZE2Tl8J/SuKw ($9.95 in chips) 
HCS0lMAAPmZE2Tl8J/SuKw: posts small blind $0.10
mFv3iBCtrw9XfCDRB0d46Q: is sitting out 
8ClCHtFXGNplITm+63KB+Q: posts big blind $0.25
*** HOLE CARDS ***
y8wpMWGSX2zHZijurx21mg: folds 
3zD3qLXT1bEffAoWGnc7wg: folds 
HCS0lMAAPmZE2Tl8J/SuKw: calls $0.15
8ClCHtFXGNplITm+63KB+Q: checks 
*** FLOP *** [Js Qd 6c]
HCS0lMAAPmZE2Tl8J/SuKw: bets $0.50
8ClCHtFXGNplITm+63KB+Q: folds 
Uncalled bet ($0.50) returned to HCS0lMAAPmZE2Tl8J/SuKw
HCS0lMAAPmZE2Tl8J/SuKw collected $0.50 from pot
*** SUMMARY ***
Total pot $0.50 | Rake $0 
Board [Js Qd 6c]
Seat 2: 8ClCHtFXGNplITm+63KB+Q (big blind) folded on the Flop
Seat 3: y8wpMWGSX2zHZijurx21mg folded before Flop (didn't bet)
Seat 4: 3zD3qLXT1bEffAoWGnc7wg (button) folded before Flop (didn't bet)
Seat 5: HCS0lMAAPmZE2Tl8J/SuKw (small blind) collected ($0.50)




PokerStars Game #59941860192:  Hold'em No Limit ($0.10/$0.25) - 2009/07/01 1:48:27 ET
Table 'biAgO3TKQBU8XcrVAoU5TA' 6-max Seat #5 is the button
Seat 1: jhDPlkir8wBYAddboBuF7Q ($14.30 in chips) 
Seat 2: GbCVUNssQ7mqsPWr7J4d3w ($7.15 in chips) 
Seat 3: mfrkWA3PTeYPkbO6hi98Aw ($29.40 in chips) 
Seat 4: Hsvkc0/G2VV78oVmWYXecw ($5 in chips) 
Seat 5: n6UPMnVR4v8LFP0rWP73Fg ($15.35 in chips) 
Seat 6: wMiE3yTbDJGOLOF9th7KPA ($8.35 in chips) 
wMiE3yTbDJGOLOF9th7KPA: posts small blind $0.10
jhDPlkir8wBYAddboBuF7Q: posts big blind $0.25
*** HOLE CARDS ***
GbCVUNssQ7mqsPWr7J4d3w: folds 
mfrkWA3PTeYPkbO6hi98Aw: folds 
Hsvkc0/G2VV78oVmWYXecw: folds 
n6UPMnVR4v8LFP0rWP73Fg: folds 
wMiE3yTbDJGOLOF9th7KPA: calls $0.15
jhDPlkir8wBYAddboBuF7Q: checks 
*** FLOP *** [4h As Qs]
wMiE3yTbDJGOLOF9th7KPA: checks 
jhDPlkir8wBYAddboBuF7Q: bets $0.75
wMiE3yTbDJGOLOF9th7KPA: raises $7.35 to $8.10 and is all-in
jhDPlkir8wBYAddboBuF7Q: folds 
Uncalled bet ($7.35) returned to wMiE3yTbDJGOLOF9th7KPA
wMiE3yTbDJGOLOF9th7KPA collected $1.90 from pot
*** SUMMARY ***
Total pot $2 | Rake $0.10 
Board [4h As Qs]
Seat 1: jhDPlkir8wBYAddboBuF7Q (big blind) folded on the Flop
Seat 2: GbCVUNssQ7mqsPWr7J4d3w folded before Flop (didn't bet)
Seat 3: mfrkWA3PTeYPkbO6hi98Aw folded before Flop (didn't bet)
Seat 4: Hsvkc0/G2VV78oVmWYXecw folded before Flop (didn't bet)
Seat 5: n6UPMnVR4v8LFP0rWP73Fg (button) folded before Flop (didn't bet)
Seat 6: wMiE3yTbDJGOLOF9th7KPA (small blind) collected ($1.90)




PokerStars Game #59941860082:  Hold'em No Limit ($0.10/$0.25) - 2009/07/01 1:48:27 ET
Table '+UzantPJ4smVdrh+4GTu1w' 6-max Seat #2 is the button
Seat 1: TSmua8tGK3sTbwi0ynrW9Q ($38.25 in chips) 
Seat 2: tcbEu7VzyHQ+0lh+skbQhQ ($29.75 in chips) 
Seat 3: SS/yfeArhULzIcOPe8MdPg ($34.60 in chips) 
Seat 4: UmcUp27+PbgBItv3ZNlAWQ ($26.80 in chips) 
Seat 5: cj4VBQya7HtVL2zCGd5jLQ ($55.70 in chips) 
Seat 6: fZQg9veL7Dd/Z04ZTjC+wQ ($25 in chips) 
SS/yfeArhULzIcOPe8MdPg: posts small blind $0.10
UmcUp27+PbgBItv3ZNlAWQ: posts big blind $0.25
*** HOLE CARDS ***
cj4VBQya7HtVL2zCGd5jLQ: folds 
fZQg9veL7Dd/Z04ZTjC+wQ: folds 
TSmua8tGK3sTbwi0ynrW9Q: folds 
tcbEu7VzyHQ+0lh+skbQhQ: raises $1 to $1.25
SS/yfeArhULzIcOPe8MdPg: calls $1.15
UmcUp27+PbgBItv3ZNlAWQ: folds 
*** FLOP *** [Qd 5c 7h]
SS/yfeArhULzIcOPe8MdPg: checks 
tcbEu7VzyHQ+0lh+skbQhQ: bets $1.50
SS/yfeArhULzIcOPe8MdPg: calls $1.50
*** TURN *** [Qd 5c 7h] [Jh]
SS/yfeArhULzIcOPe8MdPg: checks 
tcbEu7VzyHQ+0lh+skbQhQ: checks 
*** RIVER *** [Qd 5c 7h Jh] [Th]
SS/yfeArhULzIcOPe8MdPg: checks 
tcbEu7VzyHQ+0lh+skbQhQ: bets $5
SS/yfeArhULzIcOPe8MdPg: folds 
Uncalled bet ($5) returned to tcbEu7VzyHQ+0lh+skbQhQ
SS/yfeArhULzIcOPe8MdPg said, "nh"
tcbEu7VzyHQ+0lh+skbQhQ collected $5.50 from pot
*** SUMMARY ***
Total pot $5.75 | Rake $0.25 
Board [Qd 5c 7h Jh Th]
Seat 1: TSmua8tGK3sTbwi0ynrW9Q folded before Flop (didn't bet)
Seat 2: tcbEu7VzyHQ+0lh+skbQhQ (button) collected ($5.50)
Seat 3: SS/yfeArhULzIcOPe8MdPg (small blind) folded on the River
Seat 4: UmcUp27+PbgBItv3ZNlAWQ (big blind) folded before Flop
Seat 5: cj4VBQya7HtVL2zCGd5jLQ folded before Flop (didn't bet)
Seat 6: fZQg9veL7Dd/Z04ZTjC+wQ folded before Flop (didn't bet)




PokerStars Game #59941860698:  Hold'em No Limit ($0.10/$0.25) - 2009/07/01 1:48:28 ET
Table '4UJB/UOZ5aepyF2v+hIoUg' 6-max Seat #4 is the button
Seat 1: 08V++DOqzaNrRNsHIwi25w ($27 in chips) 
Seat 2: mFv3iBCtrw9XfCDRB0d46Q ($3.70 in chips) 
Seat 3: zlYHXTtJ5tcx9kwK2h5n9A ($44.05 in chips) 
Seat 4: R6AGToFJQOYVZAjC2jXEKw ($22.45 in chips) 
Seat 5: 3zD3qLXT1bEffAoWGnc7wg ($25.90 in chips) 
Seat 6: 2aphcinkTZT0B0Uoah6cvQ ($12.85 in chips) 
3zD3qLXT1bEffAoWGnc7wg: posts small blind $0.10
2aphcinkTZT0B0Uoah6cvQ: posts big blind $0.25
*** HOLE CARDS ***
08V++DOqzaNrRNsHIwi25w: folds 
mFv3iBCtrw9XfCDRB0d46Q: folds 
zlYHXTtJ5tcx9kwK2h5n9A: calls $0.25
R6AGToFJQOYVZAjC2jXEKw: raises $1 to $1.25
3zD3qLXT1bEffAoWGnc7wg: folds 
2aphcinkTZT0B0Uoah6cvQ: folds 
zlYHXTtJ5tcx9kwK2h5n9A: calls $1
*** FLOP *** [Kc 4c Th]
zlYHXTtJ5tcx9kwK2h5n9A: checks 
R6AGToFJQOYVZAjC2jXEKw: bets $1.50
zlYHXTtJ5tcx9kwK2h5n9A: calls $1.50
*** TURN *** [Kc 4c Th] [8c]
zlYHXTtJ5tcx9kwK2h5n9A: checks 
R6AGToFJQOYVZAjC2jXEKw: checks 
*** RIVER *** [Kc 4c Th 8c] [Ad]
zlYHXTtJ5tcx9kwK2h5n9A: bets $5
R6AGToFJQOYVZAjC2jXEKw: calls $5
*** SHOW DOWN ***
zlYHXTtJ5tcx9kwK2h5n9A: shows [Qd Jc] (a straight, Ten to Ace)
R6AGToFJQOYVZAjC2jXEKw: mucks hand 
zlYHXTtJ5tcx9kwK2h5n9A collected $15.10 from pot
*** SUMMARY ***
Total pot $15.85 | Rake $0.75 
Board [Kc 4c Th 8c Ad]
Seat 1: 08V++DOqzaNrRNsHIwi25w folded before Flop (didn't bet)
Seat 2: mFv3iBCtrw9XfCDRB0d46Q folded before Flop (didn't bet)
Seat 3: zlYHXTtJ5tcx9kwK2h5n9A showed [Qd Jc] and won ($15.10) with a straight, Ten to Ace
Seat 4: R6AGToFJQOYVZAjC2jXEKw (button) mucked
Seat 5: 3zD3qLXT1bEffAoWGnc7wg (small blind) folded before Flop
Seat 6: 2aphcinkTZT0B0Uoah6cvQ (big blind) folded before Flop




PokerStars Game #59941860704:  Hold'em No Limit ($0.10/$0.25) - 2009/07/01 1:48:28 ET
Table 'mk323gviqdkOY5Aek/1EWg' 6-max Seat #1 is the button
Seat 1: 7cx44/slbeTw+Cy7QB8Trg ($24.65 in chips) 
Seat 2: GC/9yVD59DUCX7hUI7gcLw ($55.40 in chips) 
Seat 3: NuqYPwTLZYQhxOoVK3Yqlw ($25 in chips) 
Seat 4: +baiVgI/ETnBARLe5mARCw ($11.55 in chips) 
Seat 5: kjYRzIfvZNNflYMYRkkSVA ($36.30 in chips) 
Seat 6: KkXSr5xFjxLSD3wtAvT+WQ ($9 in chips) 
GC/9yVD59DUCX7hUI7gcLw: posts small blind $0.10
NuqYPwTLZYQhxOoVK3Yqlw: posts big blind $0.25
*** HOLE CARDS ***
+baiVgI/ETnBARLe5mARCw: folds 
kjYRzIfvZNNflYMYRkkSVA: raises $0.50 to $0.75
KkXSr5xFjxLSD3wtAvT+WQ: folds 
7cx44/slbeTw+Cy7QB8Trg: folds 
GC/9yVD59DUCX7hUI7gcLw: folds 
NuqYPwTLZYQhxOoVK3Yqlw: folds 
Uncalled bet ($0.50) returned to kjYRzIfvZNNflYMYRkkSVA
kjYRzIfvZNNflYMYRkkSVA collected $0.60 from pot
kjYRzIfvZNNflYMYRkkSVA: doesn't show hand 
*** SUMMARY ***
Total pot $0.60 | Rake $0 
Seat 1: 7cx44/slbeTw+Cy7QB8Trg (button) folded before Flop (didn't bet)
Seat 2: GC/9yVD59DUCX7hUI7gcLw (small blind) folded before Flop
Seat 3: NuqYPwTLZYQhxOoVK3Yqlw (big blind) folded before Flop
Seat 4: +baiVgI/ETnBARLe5mARCw folded before Flop (didn't bet)
Seat 5: kjYRzIfvZNNflYMYRkkSVA collected ($0.60)
Seat 6: KkXSr5xFjxLSD3wtAvT+WQ folded before Flop (didn't bet)




PokerStars Game #59941860592:  Hold'em No Limit ($0.10/$0.25) - 2009/07/01 1:48:28 ET
Table 'WEMI3Mtn7dGARDbgNrKibgoG007Tb0LYbfANo6QWd16wx Seat #8 is the button
Seat 1: DiSvPC2iudwL5j9u6Huyww ($46.65 in chips) 
Seat 2: zDrucyjVn5aeekNEc3cJrA ($15 in chips) 
Seat 4: zgi+EUykT/pZQpoUG6+oEg ($5 in chips) 
Seat 5: 8f0dtuUGqDbgE6up1lQAlg ($5.25 in chips) 
Seat 6: yqkowiRWZ6NvRN9UUkYIlA ($5 in chips) 
Seat 7: Mh2r9hTeTEDnh19sRZtW3g ($5 in chips) 
Seat 8: q4cNXFZGNhLfrTyVrIy6Mg ($14.30 in chips) 
Seat 9: EVqHvqty1ZsuvDFiSXlSqQ ($29.10 in chips) 
EVqHvqty1ZsuvDFiSXlSqQ: posts small blind $0.10
DiSvPC2iudwL5j9u6Huyww: posts big blind $0.25
pN3IHvAKm2fz+sTRARTcrg: sits out 
*** HOLE CARDS ***
zDrucyjVn5aeekNEc3cJrA: folds 
zgi+EUykT/pZQpoUG6+oEg: folds 
8f0dtuUGqDbgE6up1lQAlg: calls $0.25
yqkowiRWZ6NvRN9UUkYIlA: folds 
Mh2r9hTeTEDnh19sRZtW3g: folds 
q4cNXFZGNhLfrTyVrIy6Mg: calls $0.25
EVqHvqty1ZsuvDFiSXlSqQ: calls $0.15
DiSvPC2iudwL5j9u6Huyww: checks 
*** FLOP *** [Jd 7d 3h]
EVqHvqty1ZsuvDFiSXlSqQ: checks 
DiSvPC2iudwL5j9u6Huyww: checks 
8f0dtuUGqDbgE6up1lQAlg: checks 
q4cNXFZGNhLfrTyVrIy6Mg: bets $0.25
EVqHvqty1ZsuvDFiSXlSqQ: folds 
DiSvPC2iudwL5j9u6Huyww: folds 
8f0dtuUGqDbgE6up1lQAlg: folds 
Uncalled bet ($0.25) returned to q4cNXFZGNhLfrTyVrIy6Mg
q4cNXFZGNhLfrTyVrIy6Mg collected $0.95 from pot
q4cNXFZGNhLfrTyVrIy6Mg: doesn't show hand 
*** SUMMARY ***
Total pot $1 | Rake $0.05 
Board [Jd 7d 3h]
Seat 1: DiSvPC2iudwL5j9u6Huyww (big blind) folded on the Flop
Seat 2: zDrucyjVn5aeekNEc3cJrA folded before Flop (didn't bet)
Seat 4: zgi+EUykT/pZQpoUG6+oEg folded before Flop (didn't bet)
Seat 5: 8f0dtuUGqDbgE6up1lQAlg folded on the Flop
Seat 6: yqkowiRWZ6NvRN9UUkYIlA folded before Flop (didn't bet)
Seat 7: Mh2r9hTeTEDnh19sRZtW3g folded before Flop (didn't bet)
Seat 8: q4cNXFZGNhLfrTyVrIy6Mg (button) collected ($0.95)
Seat 9: EVqHvqty1ZsuvDFiSXlSqQ (small blind) folded on the Flop




PokerStars Game #59941860882:  Hold'em No Limit ($0.10/$0.25) - 2009/07/01 1:48:28 ET
Table 'M7d9IrgQUUFFy/SZ3ksLYg' 6-max Seat #4 is the button
Seat 1: ypmjhffk/YHGc51wgVXUTw ($50.75 in chips) 
Seat 3: epAUIB7h2FJXzUPRIvSkRA ($26.25 in chips) 
Seat 4: 8ClCHtFXGNplITm+63KB+Q ($22.85 in chips) 
Seat 5: kMa8BltUcBQVxnHfqdCfXg ($6.75 in chips) 
kMa8BltUcBQVxnHfqdCfXg: posts small blind $0.10
ypmjhffk/YHGc51wgVXUTw: posts big blind $0.25
8CPg15X6IHYR1pWm9ha1Sw: sits out 
*** HOLE CARDS ***
epAUIB7h2FJXzUPRIvSkRA: folds 
8ClCHtFXGNplITm+63KB+Q: folds 
kMa8BltUcBQVxnHfqdCfXg: raises $0.25 to $0.50
ypmjhffk/YHGc51wgVXUTw: folds 
Uncalled bet ($0.25) returned to kMa8BltUcBQVxnHfqdCfXg
kMa8BltUcBQVxnHfqdCfXg collected $0.50 from pot
*** SUMMARY ***
Total pot $0.50 | Rake $0 
Seat 1: ypmjhffk/YHGc51wgVXUTw (big blind) folded before Flop
Seat 3: epAUIB7h2FJXzUPRIvSkRA folded before Flop (didn't bet)
Seat 4: 8ClCHtFXGNplITm+63KB+Q (button) folded before Flop (didn't bet)
Seat 5: kMa8BltUcBQVxnHfqdCfXg (small blind) collected ($0.50)




PokerStars Game #59941860978:  Hold'em No Limit ($0.10/$0.25) - 2009/07/01 1:48:29 ET
Table '6wawJ+MkkvuC3coG6r+YhgZiwAqg4o02gNro+JOAaFNgSeat #3 is the button
Seat 1: 6RiVTYll/5D8zICp0MRpKw ($29.85 in chips) 
Seat 3: aNpwfA31EREwO+ar4XzBCw ($28.65 in chips) 
Seat 4: RHqgdFvufLCYe54+qd2gcA ($4.75 in chips) 
Seat 5: 5hAPbqNrvJb8PtLiceXtlg6HoFYfVGBefsR5Vrz62qIw2.15 in chips) 
Seat 6: 5n7e7I+px7c6CQmLpPbtsg ($5 in chips) 
Seat 7: yyG4svzOpC1A+sUP/scg6w ($7.20 in chips) 
Seat 8: VLIsy+xjx3olLSYO3JLS6g ($14.70 in chips) 
Seat 9: ljemhp25Zg+nlA9DLCIiUw ($24.90 in chips) 
RHqgdFvufLCYe54+qd2gcA: posts small blind $0.10
5hAPbqNrvJb8PtLiceXtlg6HoFYfVGBefsR5Vrz62qIwsts big blind $0.25
VCKtuATyvAq9H2JSAQxPbA: sits out 
*** HOLE CARDS ***
5n7e7I+px7c6CQmLpPbtsg: folds 
yyG4svzOpC1A+sUP/scg6w: folds 
VLIsy+xjx3olLSYO3JLS6g: folds 
ljemhp25Zg+nlA9DLCIiUw: raises $0.50 to $0.75
6RiVTYll/5D8zICp0MRpKw: folds 
aNpwfA31EREwO+ar4XzBCw: folds 
RHqgdFvufLCYe54+qd2gcA: calls $0.65
5hAPbqNrvJb8PtLiceXtlg6HoFYfVGBefsR5Vrz62qIwlls $0.50
*** FLOP *** [Js 4h 6h]
RHqgdFvufLCYe54+qd2gcA: checks 
5hAPbqNrvJb8PtLiceXtlg6HoFYfVGBefsR5Vrz62qIwecks 
ljemhp25Zg+nlA9DLCIiUw: checks 
*** TURN *** [Js 4h 6h] [9h]
RHqgdFvufLCYe54+qd2gcA: bets $1
5hAPbqNrvJb8PtLiceXtlg6HoFYfVGBefsR5Vrz62qIwlls $1
ljemhp25Zg+nlA9DLCIiUw: folds 
*** RIVER *** [Js 4h 6h 9h] [5h]
RHqgdFvufLCYe54+qd2gcA: bets $1.75
5hAPbqNrvJb8PtLiceXtlg6HoFYfVGBefsR5Vrz62qIwlls $1.75
*** SHOW DOWN ***
RHqgdFvufLCYe54+qd2gcA: shows [Qd Ah] (a flush, Ace high)
5hAPbqNrvJb8PtLiceXtlg6HoFYfVGBefsR5Vrz62qIwcks hand 
RHqgdFvufLCYe54+qd2gcA collected $7.40 from pot
*** SUMMARY ***
Total pot $7.75 | Rake $0.35 
Board [Js 4h 6h 9h 5h]
Seat 1: 6RiVTYll/5D8zICp0MRpKw folded before Flop (didn't bet)
Seat 3: aNpwfA31EREwO+ar4XzBCw (button) folded before Flop (didn't bet)
Seat 4: RHqgdFvufLCYe54+qd2gcA (small blind) showed [Qd Ah] and won ($7.40) with a flush, Ace high
Seat 5: 5hAPbqNrvJb8PtLiceXtlg6HoFYfVGBefsR5Vrz62qIwg blind) mucked
Seat 6: 5n7e7I+px7c6CQmLpPbtsg folded before Flop (didn't bet)
Seat 7: yyG4svzOpC1A+sUP/scg6w folded before Flop (didn't bet)
Seat 8: VLIsy+xjx3olLSYO3JLS6g folded before Flop (didn't bet)
Seat 9: ljemhp25Zg+nlA9DLCIiUw folded on the Turn




PokerStars Game #59941861122:  Hold'em No Limit ($0.10/$0.25) - 2009/07/01 1:48:29 ET
Table 'edvgY2YQ1I34euq4EVqGnA' 6-max Seat #1 is the button
Seat 1: mvFHK3pE7tCxJEqLjKC70Q ($30.35 in chips) 
Seat 2: Hsvkc0/G2VV78oVmWYXecw ($5 in chips) 
Seat 4: TI/C5Q+DEl4fLR3AofwYdg ($23.40 in chips) 
Seat 5: EE16Ua5b1HSsYej5zeXOlA ($56 in chips) 
Seat 6: kG34n23qFQA3nzdOJTQ1dA ($71 in chips) 
Hsvkc0/G2VV78oVmWYXecw: posts small blind $0.10
mFv3iBCtrw9XfCDRB0d46Q: is sitting out 
TI/C5Q+DEl4fLR3AofwYdg: posts big blind $0.25
*** HOLE CARDS ***
EE16Ua5b1HSsYej5zeXOlA: folds 
kG34n23qFQA3nzdOJTQ1dA: folds 
mvFHK3pE7tCxJEqLjKC70Q: folds 
Hsvkc0/G2VV78oVmWYXecw: calls $0.15
TI/C5Q+DEl4fLR3AofwYdg: checks 
*** FLOP *** [7d 8c 9s]
Hsvkc0/G2VV78oVmWYXecw: bets $1
TI/C5Q+DEl4fLR3AofwYdg: folds 
Uncalled bet ($1) returned to Hsvkc0/G2VV78oVmWYXecw
Hsvkc0/G2VV78oVmWYXecw collected $0.50 from pot
Hsvkc0/G2VV78oVmWYXecw: doesn't show hand 
*** SUMMARY ***
Total pot $0.50 | Rake $0 
Board [7d 8c 9s]
Seat 1: mvFHK3pE7tCxJEqLjKC70Q (button) folded before Flop (didn't bet)
Seat 2: Hsvkc0/G2VV78oVmWYXecw (small blind) collected ($0.50)
Seat 4: TI/C5Q+DEl4fLR3AofwYdg (big blind) folded on the Flop
Seat 5: EE16Ua5b1HSsYej5zeXOlA folded before Flop (didn't bet)
Seat 6: kG34n23qFQA3nzdOJTQ1dA folded before Flop (didn't bet)




PokerStars Game #59941860932:  Hold'em No Limit ($0.10/$0.25) - 2009/07/01 1:48:29 ET
Table 'srBTB98reCdD1TffxE6o7g' 6-max Seat #2 is the button
Seat 1: SFmT9ZsVopnukjvAzrxTRg ($36.90 in chips) 
Seat 2: mfrkWA3PTeYPkbO6hi98Aw ($25 in chips) 
Seat 4: 6DwBRH+xZ12AAZmeAg+aXw ($15.95 in chips) 
Seat 5: K1zv48sQUGQiaLk5VWWDqw ($25.10 in chips) 
Seat 6: BV+K0Phf5VBHr7aZPKqbUQ ($31.60 in chips) 
6DwBRH+xZ12AAZmeAg+aXw: posts small blind $0.10
K1zv48sQUGQiaLk5VWWDqw: posts big blind $0.25
*** HOLE CARDS ***
BV+K0Phf5VBHr7aZPKqbUQ: folds 
SFmT9ZsVopnukjvAzrxTRg: folds 
mfrkWA3PTeYPkbO6hi98Aw: folds 
6DwBRH+xZ12AAZmeAg+aXw: raises $0.50 to $0.75
K1zv48sQUGQiaLk5VWWDqw: folds 
Uncalled bet ($0.50) returned to 6DwBRH+xZ12AAZmeAg+aXw
6DwBRH+xZ12AAZmeAg+aXw collected $0.50 from pot
6DwBRH+xZ12AAZmeAg+aXw: doesn't show hand 
*** SUMMARY ***
Total pot $0.50 | Rake $0 
Seat 1: SFmT9ZsVopnukjvAzrxTRg folded before Flop (didn't bet)
Seat 2: mfrkWA3PTeYPkbO6hi98Aw (button) folded before Flop (didn't bet)
Seat 4: 6DwBRH+xZ12AAZmeAg+aXw (small blind) collected ($0.50)
Seat 5: K1zv48sQUGQiaLk5VWWDqw (big blind) folded before Flop
Seat 6: BV+K0Phf5VBHr7aZPKqbUQ folded before Flop (didn't bet)




PokerStars Game #59941861036:  Hold'em No Limit ($0.10/$0.25) - 2009/07/01 1:48:29 ET
Table 'IRgQPZVA4+IaZZIQshgwyg' 6-max Seat #1 is the button
Seat 1: cezpHJ8FB07dj0xG+LhOvw ($27.20 in chips) 
Seat 2: lquriepNQBhDV5P1SWHhnA ($28.80 in chips) 
Seat 3: DihMHaz4WNETH1bPDe13kA ($27.80 in chips) 
Seat 4: DE9hRlt14g+JdsRQ4wT7hg ($25.60 in chips) 
Seat 5: w43JQj2oYPpKQVG4Yzlq1w ($25 in chips) 
Seat 6: x9/USY6PsmgUGQeluFLKDw ($21.30 in chips) 
lquriepNQBhDV5P1SWHhnA: posts small blind $0.10
DihMHaz4WNETH1bPDe13kA: posts big blind $0.25
*** HOLE CARDS ***
DE9hRlt14g+JdsRQ4wT7hg: folds 
w43JQj2oYPpKQVG4Yzlq1w: folds 
x9/USY6PsmgUGQeluFLKDw: folds 
cezpHJ8FB07dj0xG+LhOvw: raises $0.50 to $0.75
lquriepNQBhDV5P1SWHhnA: folds 
DihMHaz4WNETH1bPDe13kA: folds 
Uncalled bet ($0.50) returned to cezpHJ8FB07dj0xG+LhOvw
cezpHJ8FB07dj0xG+LhOvw collected $0.60 from pot
*** SUMMARY ***
Total pot $0.60 | Rake $0 
Seat 1: cezpHJ8FB07dj0xG+LhOvw (button) collected ($0.60)
Seat 2: lquriepNQBhDV5P1SWHhnA (small blind) folded before Flop
Seat 3: DihMHaz4WNETH1bPDe13kA (big blind) folded before Flop
Seat 4: DE9hRlt14g+JdsRQ4wT7hg folded before Flop (didn't bet)
Seat 5: w43JQj2oYPpKQVG4Yzlq1w folded before Flop (didn't bet)
Seat 6: x9/USY6PsmgUGQeluFLKDw folded before Flop (didn't bet)




PokerStars Game #59941861032:  Hold'em No Limit ($0.10/$0.25) - 2009/07/01 1:48:29 ET
Table 'qryc9C/ELyQ3lubOaELNAQ' 6-max Seat #6 is the button
Seat 1: OZc6kkoTwtITj1ZfreJK1A ($67.35 in chips) 
Seat 2: LtASJ9OlkqGrrUKGQlpGAw ($30.30 in chips) 
Seat 3: wvIIdlbCgePONQwXjx9xzQ ($4.20 in chips) 
Seat 4: v+QfkGiuj9bgtuNoVnDO8w ($25 in chips) 
Seat 5: 9StOHp+Y1T0K13JdgS2oQQ ($37.05 in chips) 
Seat 6: xmdItDBraeGrrs3wzz1J3w ($18.50 in chips) 
OZc6kkoTwtITj1ZfreJK1A: posts small blind $0.10
LtASJ9OlkqGrrUKGQlpGAw: posts big blind $0.25
*** HOLE CARDS ***
wvIIdlbCgePONQwXjx9xzQ: folds 
v+QfkGiuj9bgtuNoVnDO8w: folds 
9StOHp+Y1T0K13JdgS2oQQ: folds 
xmdItDBraeGrrs3wzz1J3w: raises $0.75 to $1
OZc6kkoTwtITj1ZfreJK1A: folds 
LtASJ9OlkqGrrUKGQlpGAw: folds 
Uncalled bet ($0.75) returned to xmdItDBraeGrrs3wzz1J3w
xmdItDBraeGrrs3wzz1J3w collected $0.60 from pot
*** SUMMARY ***
Total pot $0.60 | Rake $0 
Seat 1: OZc6kkoTwtITj1ZfreJK1A (small blind) folded before Flop
Seat 2: LtASJ9OlkqGrrUKGQlpGAw (big blind) folded before Flop
Seat 3: wvIIdlbCgePONQwXjx9xzQ folded before Flop (didn't bet)
Seat 4: v+QfkGiuj9bgtuNoVnDO8w folded before Flop (didn't bet)
Seat 5: 9StOHp+Y1T0K13JdgS2oQQ folded before Flop (didn't bet)
Seat 6: xmdItDBraeGrrs3wzz1J3w (button) collected ($0.60)




PokerStars Game #59941861412:  Hold'em No Limit ($0.10/$0.25) - 2009/07/01 1:48:29 ET
Table 'vZfV/Uj0q8joA1du9sRJSg' 6-max Seat #5 is the button
Seat 1: Hsvkc0/G2VV78oVmWYXecw ($6.05 in chips) 
Seat 2: wMiE3yTbDJGOLOF9th7KPA ($4.95 in chips) 
Seat 3: cWc85bEzdRzpUMhRKm8pwQ ($25 in chips) 
Seat 4: v+QfkGiuj9bgtuNoVnDO8w ($43.50 in chips) 
Seat 5: kyRaCIljYA6l33lSKQfNsg ($29.30 in chips) 
Seat 6: 8ClCHtFXGNplITm+63KB+Q ($48.80 in chips) 
8ClCHtFXGNplITm+63KB+Q: posts small blind $0.10
Hsvkc0/G2VV78oVmWYXecw: posts big blind $0.25
*** HOLE CARDS ***
wMiE3yTbDJGOLOF9th7KPA: calls $0.25
cWc85bEzdRzpUMhRKm8pwQ: folds 
v+QfkGiuj9bgtuNoVnDO8w: folds 
kyRaCIljYA6l33lSKQfNsg: folds 
8ClCHtFXGNplITm+63KB+Q: folds 
Hsvkc0/G2VV78oVmWYXecw: checks 
*** FLOP *** [7c As 7d]
Hsvkc0/G2VV78oVmWYXecw: checks 
wMiE3yTbDJGOLOF9th7KPA: bets $0.25
Hsvkc0/G2VV78oVmWYXecw: folds 
Uncalled bet ($0.25) returned to wMiE3yTbDJGOLOF9th7KPA
wMiE3yTbDJGOLOF9th7KPA collected $0.60 from pot
*** SUMMARY ***
Total pot $0.60 | Rake $0 
Board [7c As 7d]
Seat 1: Hsvkc0/G2VV78oVmWYXecw (big blind) folded on the Flop
Seat 2: wMiE3yTbDJGOLOF9th7KPA collected ($0.60)
Seat 3: cWc85bEzdRzpUMhRKm8pwQ folded before Flop (didn't bet)
Seat 4: v+QfkGiuj9bgtuNoVnDO8w folded before Flop (didn't bet)
Seat 5: kyRaCIljYA6l33lSKQfNsg (button) folded before Flop (didn't bet)
Seat 6: 8ClCHtFXGNplITm+63KB+Q (small blind) folded before Flop




PokerStars Game #59941861242:  Hold'em No Limit ($0.10/$0.25) - 2009/07/01 1:48:29 ET
Table 'XX2OuOsa8/8AC+/mR/Az6g' 9-max Seat #1 is the button
Seat 1: 56S3mA6Zs3pGR+0p0vUCtg ($24.40 in chips) 
Seat 2: Bb42QRQMhg5/Y0vHP8/2Xw ($26.60 in chips) 
Seat 3: oLa/tXLfSLLB28mcLGrxcg ($24.60 in chips) 
Seat 5: SpiiQQAzy4MUgV3I5W8giw ($21.15 in chips) 
Seat 6: RCqMONFrSPSArZh2Jsar/w ($20.20 in chips) 
Seat 8: qwr38jl5txoR36M7G5qi4A ($10.35 in chips) 
Seat 9: V6p0jQ/RhUsqpHLmXvEX4Q ($12 in chips) 
Bb42QRQMhg5/Y0vHP8/2Xw: posts small blind $0.10
oLa/tXLfSLLB28mcLGrxcg: posts big blind $0.25
*** HOLE CARDS ***
5pDhXQ+RVy0BGcwfJAJfbg joins the table at seat #4 
SpiiQQAzy4MUgV3I5W8giw: folds 
RCqMONFrSPSArZh2Jsar/w: folds 
qwr38jl5txoR36M7G5qi4A: folds 
V6p0jQ/RhUsqpHLmXvEX4Q: folds 
56S3mA6Zs3pGR+0p0vUCtg: folds 
Bb42QRQMhg5/Y0vHP8/2Xw: folds 
Uncalled bet ($0.15) returned to oLa/tXLfSLLB28mcLGrxcg
oLa/tXLfSLLB28mcLGrxcg collected $0.20 from pot
oLa/tXLfSLLB28mcLGrxcg: doesn't show hand 
*** SUMMARY ***
Total pot $0.20 | Rake $0 
Seat 1: 56S3mA6Zs3pGR+0p0vUCtg (button) folded before Flop (didn't bet)
Seat 2: Bb42QRQMhg5/Y0vHP8/2Xw (small blind) folded before Flop
Seat 3: oLa/tXLfSLLB28mcLGrxcg (big blind) collected ($0.20)
Seat 5: SpiiQQAzy4MUgV3I5W8giw folded before Flop (didn't bet)
Seat 6: RCqMONFrSPSArZh2Jsar/w folded before Flop (didn't bet)
Seat 8: qwr38jl5txoR36M7G5qi4A folded before Flop (didn't bet)
Seat 9: V6p0jQ/RhUsqpHLmXvEX4Q folded before Flop (didn't bet)




PokerStars Game #59941861778:  Hold'em No Limit ($0.10/$0.25) - 2009/07/01 1:48:30 ET
Table 'qInMnOOn7vKcj4bU7zju7g' 9-max Seat #8 is the button
Seat 1: CT7Xj/V/O5rBlhtt+RZeFQ ($38.40 in chips) 
Seat 2: HgIyqrvSG8TRRZl5mlzfHA ($67.60 in chips) 
Seat 3: zDrucyjVn5aeekNEc3cJrA ($25.80 in chips) 
Seat 4: ScCuCTbi71/EWsLKZXaZeg ($12 in chips) 
Seat 5: KlccfkOygm1GJZoSZYEgBw ($13.15 in chips) 
Seat 6: 4awUyiDYTgylQKXZ9faBVA ($25 in chips) 
Seat 7: st9jtdNbm1W5GfBwRaCVqQ ($25 in chips) 
Seat 8: Mh2r9hTeTEDnh19sRZtW3g ($11.35 in chips) 
Seat 9: sbArFaUiGjfmf5dg1O4ffg ($3.45 in chips) 
sbArFaUiGjfmf5dg1O4ffg: posts small blind $0.10
CT7Xj/V/O5rBlhtt+RZeFQ: posts big blind $0.25
st9jtdNbm1W5GfBwRaCVqQ: posts big blind $0.25
*** HOLE CARDS ***
HgIyqrvSG8TRRZl5mlzfHA: calls $0.25
KlccfkOygm1GJZoSZYEgBw said, "wow nort ur a fish too"
zDrucyjVn5aeekNEc3cJrA: folds 
ScCuCTbi71/EWsLKZXaZeg: raises $1.75 to $2
KlccfkOygm1GJZoSZYEgBw: folds 
4awUyiDYTgylQKXZ9faBVA: folds 
st9jtdNbm1W5GfBwRaCVqQ: folds 
Mh2r9hTeTEDnh19sRZtW3g: folds 
sbArFaUiGjfmf5dg1O4ffg: folds 
CT7Xj/V/O5rBlhtt+RZeFQ: folds 
HgIyqrvSG8TRRZl5mlzfHA: raises $1.75 to $3.75
ScCuCTbi71/EWsLKZXaZeg: calls $1.75
*** FLOP *** [3h 9d As]
HgIyqrvSG8TRRZl5mlzfHA: checks 
ScCuCTbi71/EWsLKZXaZeg: bets $2
HgIyqrvSG8TRRZl5mlzfHA: calls $2
*** TURN *** [3h 9d As] [8h]
HgIyqrvSG8TRRZl5mlzfHA: checks 
ScCuCTbi71/EWsLKZXaZeg: checks 
*** RIVER *** [3h 9d As 8h] [2c]
HgIyqrvSG8TRRZl5mlzfHA: checks 
ScCuCTbi71/EWsLKZXaZeg: checks 
*** SHOW DOWN ***
HgIyqrvSG8TRRZl5mlzfHA: shows [Ts Td] (a pair of Tens)
ScCuCTbi71/EWsLKZXaZeg: shows [Tc Ah] (a pair of Aces)
ScCuCTbi71/EWsLKZXaZeg collected $11.55 from pot
*** SUMMARY ***
Total pot $12.10 | Rake $0.55 
Board [3h 9d As 8h 2c]
Seat 1: CT7Xj/V/O5rBlhtt+RZeFQ (big blind) folded before Flop
Seat 2: HgIyqrvSG8TRRZl5mlzfHA showed [Ts Td] and lost with a pair of Tens
Seat 3: zDrucyjVn5aeekNEc3cJrA folded before Flop (didn't bet)
Seat 4: ScCuCTbi71/EWsLKZXaZeg showed [Tc Ah] and won ($11.55) with a pair of Aces
Seat 5: KlccfkOygm1GJZoSZYEgBw folded before Flop (didn't bet)
Seat 6: 4awUyiDYTgylQKXZ9faBVA folded before Flop (didn't bet)
Seat 7: st9jtdNbm1W5GfBwRaCVqQ folded before Flop
Seat 8: Mh2r9hTeTEDnh19sRZtW3g (button) folded before Flop (didn't bet)
Seat 9: sbArFaUiGjfmf5dg1O4ffg (small blind) folded before Flop




PokerStars Game #59941862032:  Hold'em No Limit ($0.10/$0.25) - 2009/07/01 1:48:31 ET
Table 'Of/T60zpXg1GcjrZ7Lm//Q' 9-max Seat #9 is the button
Seat 1: Lro4e37x4FUa5P3yzDjskw ($17.95 in chips) 
Seat 2: qwr38jl5txoR36M7G5qi4A ($9.90 in chips) 
Seat 3: 6RiVTYll/5D8zICp0MRpKw ($25 in chips) 
Seat 4: Czut6V7acIqUJrrobjKAZg ($5.40 in chips) 
Seat 5: IiLkthQMEje9LS79rCFQ1Q ($22.75 in chips) 
Seat 6: tYsOBqdU1+x+yFI7zHO7hQ ($31.45 in chips) 
Seat 7: PVxvfRTRvkgZf9WtquEkwQ ($25 in chips) 
Seat 8: ghNKXUBl/H+t83JF079ZBA ($26.15 in chips) 
Seat 9: egvg3mTBBVzMHnJPIQiKcA ($15.05 in chips) 
Lro4e37x4FUa5P3yzDjskw: posts small blind $0.10
qwr38jl5txoR36M7G5qi4A: posts big blind $0.25
*** HOLE CARDS ***
6RiVTYll/5D8zICp0MRpKw: folds 
Czut6V7acIqUJrrobjKAZg: folds 
IiLkthQMEje9LS79rCFQ1Q: folds 
tYsOBqdU1+x+yFI7zHO7hQ: folds 
IiLkthQMEje9LS79rCFQ1Q leaves the table
PVxvfRTRvkgZf9WtquEkwQ: folds 
ghNKXUBl/H+t83JF079ZBA: raises $0.50 to $0.75
egvg3mTBBVzMHnJPIQiKcA: folds 
Lro4e37x4FUa5P3yzDjskw: folds 
qwr38jl5txoR36M7G5qi4A: folds 
Uncalled bet ($0.50) returned to ghNKXUBl/H+t83JF079ZBA
ghNKXUBl/H+t83JF079ZBA collected $0.60 from pot
ghNKXUBl/H+t83JF079ZBA: doesn't show hand 
*** SUMMARY ***
Total pot $0.60 | Rake $0 
Seat 1: Lro4e37x4FUa5P3yzDjskw (small blind) folded before Flop
Seat 2: qwr38jl5txoR36M7G5qi4A (big blind) folded before Flop
Seat 3: 6RiVTYll/5D8zICp0MRpKw folded before Flop (didn't bet)
Seat 4: Czut6V7acIqUJrrobjKAZg folded before Flop (didn't bet)
Seat 5: IiLkthQMEje9LS79rCFQ1Q folded before Flop (didn't bet)
Seat 6: tYsOBqdU1+x+yFI7zHO7hQ folded before Flop (didn't bet)
Seat 7: PVxvfRTRvkgZf9WtquEkwQ folded before Flop (didn't bet)
Seat 8: ghNKXUBl/H+t83JF079ZBA collected ($0.60)
Seat 9: egvg3mTBBVzMHnJPIQiKcA (button) folded before Flop (didn't bet)




PokerStars Game #59941862114:  Hold'em No Limit ($0.10/$0.25) - 2009/07/01 1:48:31 ET
Table 'R5qKG21jwFDYRcOht9qwqQ' 9-max Seat #9 is the button
Seat 1: N5sUK8M0br9djLrW97V9pQ ($24.25 in chips) 
Seat 2: N6foVRyErHqcNmshkqextQ ($13.80 in chips) 
Seat 3: M2QO2DxB5Wawg2h8HSpnYA ($10 in chips) 
Seat 5: zUXhymECc2C9W9ZNw6qppA ($8.55 in chips) 
Seat 6: EP17SQz/iWcuYdNOGeBgkw ($15.90 in chips) 
Seat 7: zgi+EUykT/pZQpoUG6+oEg ($4.65 in chips) 
Seat 8: hYvTc4PYNrAaNAIVoM94Hw ($5 in chips) 
Seat 9: MG90wfSJZnOejs/KD3vlQQ ($38.30 in chips) 
N5sUK8M0br9djLrW97V9pQ: posts small blind $0.10
N6foVRyErHqcNmshkqextQ: posts big blind $0.25
hYvTc4PYNrAaNAIVoM94Hw: posts big blind $0.25
*** HOLE CARDS ***
M2QO2DxB5Wawg2h8HSpnYA: folds 
zUXhymECc2C9W9ZNw6qppA: raises $0.50 to $0.75
EP17SQz/iWcuYdNOGeBgkw: folds 
zgi+EUykT/pZQpoUG6+oEg: folds 
hYvTc4PYNrAaNAIVoM94Hw: folds 
MG90wfSJZnOejs/KD3vlQQ: folds 
N5sUK8M0br9djLrW97V9pQ: folds 
N6foVRyErHqcNmshkqextQ: folds 
Uncalled bet ($0.50) returned to zUXhymECc2C9W9ZNw6qppA
zUXhymECc2C9W9ZNw6qppA collected $0.85 from pot
*** SUMMARY ***
Total pot $0.85 | Rake $0 
Seat 1: N5sUK8M0br9djLrW97V9pQ (small blind) folded before Flop
Seat 2: N6foVRyErHqcNmshkqextQ (big blind) folded before Flop
Seat 3: M2QO2DxB5Wawg2h8HSpnYA folded before Flop (didn't bet)
Seat 5: zUXhymECc2C9W9ZNw6qppA collected ($0.85)
Seat 6: EP17SQz/iWcuYdNOGeBgkw folded before Flop (didn't bet)
Seat 7: zgi+EUykT/pZQpoUG6+oEg folded before Flop (didn't bet)
Seat 8: hYvTc4PYNrAaNAIVoM94Hw folded before Flop
Seat 9: MG90wfSJZnOejs/KD3vlQQ (button) folded before Flop (didn't bet)




PokerStars Game #59941861986:  Hold'em No Limit ($0.10/$0.25) - 2009/07/01 1:48:31 ET
Table 'emoxgHTxg9Uqeu06oLzLyg' 6-max Seat #3 is the button
Seat 1: epAUIB7h2FJXzUPRIvSkRA ($25 in chips) 
Seat 2: wIFhgE1PVdX6Xf6aVlSTPg ($28.20 in chips) 
Seat 3: uD5epdBxuyc30pF1dO958Q ($9.90 in chips) 
Seat 4: 3VAbqAWh8ncE2SJOYIx2ZQ ($11.25 in chips) 
Seat 5: OIjOiBfQstWrK/RuXx7zcw ($6.95 in chips) 
3VAbqAWh8ncE2SJOYIx2ZQ: posts small blind $0.10
OIjOiBfQstWrK/RuXx7zcw: posts big blind $0.25
u3Ol7kv1LmvszuHNm9rc6w: sits out 
*** HOLE CARDS ***
epAUIB7h2FJXzUPRIvSkRA: folds 
wIFhgE1PVdX6Xf6aVlSTPg: folds 
uD5epdBxuyc30pF1dO958Q: calls $0.25
3VAbqAWh8ncE2SJOYIx2ZQ: calls $0.15
OIjOiBfQstWrK/RuXx7zcw: raises $1 to $1.25
uD5epdBxuyc30pF1dO958Q: folds 
3VAbqAWh8ncE2SJOYIx2ZQ: calls $1
*** FLOP *** [5h 9s 9h]
3VAbqAWh8ncE2SJOYIx2ZQ: checks 
OIjOiBfQstWrK/RuXx7zcw: bets $2
3VAbqAWh8ncE2SJOYIx2ZQ: folds 
Uncalled bet ($2) returned to OIjOiBfQstWrK/RuXx7zcw
OIjOiBfQstWrK/RuXx7zcw collected $2.65 from pot
OIjOiBfQstWrK/RuXx7zcw: doesn't show hand 
*** SUMMARY ***
Total pot $2.75 | Rake $0.10 
Board [5h 9s 9h]
Seat 1: epAUIB7h2FJXzUPRIvSkRA folded before Flop (didn't bet)
Seat 2: wIFhgE1PVdX6Xf6aVlSTPg folded before Flop (didn't bet)
Seat 3: uD5epdBxuyc30pF1dO958Q (button) folded before Flop
Seat 4: 3VAbqAWh8ncE2SJOYIx2ZQ (small blind) folded on the Flop
Seat 5: OIjOiBfQstWrK/RuXx7zcw (big blind) collected ($2.65)




PokerStars Game #59941862250:  Hold'em No Limit ($0.10/$0.25) - 2009/07/01 1:48:31 ET
Table 'C47I7CmrmFr8Oo7wOovVwQ' 6-max Seat #5 is the button
Seat 1: v6mkGzCBCCXcgWQNSYVtKg ($11.80 in chips) 
Seat 3: H+8eOP3XJHXjACRDTiIHTQ ($21.75 in chips) 
Seat 4: yY5JuFtDfXWRaZlVby4LLw ($5.65 in chips) 
Seat 5: or309yYY9Y9bfFWtrB0yUg ($7.85 in chips) 
Seat 6: pD7ri5wL3vsa6S1ulMYQmQ ($26.80 in chips) 
pD7ri5wL3vsa6S1ulMYQmQ: posts small blind $0.10
v6mkGzCBCCXcgWQNSYVtKg: posts big blind $0.25
8JTm/CXBn3+kuQgcUOgPkw: sits out 
*** HOLE CARDS ***
H+8eOP3XJHXjACRDTiIHTQ: calls $0.25
yY5JuFtDfXWRaZlVby4LLw: folds 
or309yYY9Y9bfFWtrB0yUg: raises $0.50 to $0.75
pD7ri5wL3vsa6S1ulMYQmQ: calls $0.65
v6mkGzCBCCXcgWQNSYVtKg: calls $0.50
H+8eOP3XJHXjACRDTiIHTQ: calls $0.50
*** FLOP *** [Jh 2s Ad]
pD7ri5wL3vsa6S1ulMYQmQ: checks 
v6mkGzCBCCXcgWQNSYVtKg: checks 
H+8eOP3XJHXjACRDTiIHTQ: checks 
or309yYY9Y9bfFWtrB0yUg: bets $1.50
pD7ri5wL3vsa6S1ulMYQmQ: folds 
v6mkGzCBCCXcgWQNSYVtKg: folds 
v6mkGzCBCCXcgWQNSYVtKg leaves the table
H+8eOP3XJHXjACRDTiIHTQ: folds 
Uncalled bet ($1.50) returned to or309yYY9Y9bfFWtrB0yUg
or309yYY9Y9bfFWtrB0yUg collected $2.85 from pot
*** SUMMARY ***
Total pot $3 | Rake $0.15 
Board [Jh 2s Ad]
Seat 1: v6mkGzCBCCXcgWQNSYVtKg (big blind) folded on the Flop
Seat 3: H+8eOP3XJHXjACRDTiIHTQ folded on the Flop
Seat 4: yY5JuFtDfXWRaZlVby4LLw folded before Flop (didn't bet)
Seat 5: or309yYY9Y9bfFWtrB0yUg (button) collected ($2.85)
Seat 6: pD7ri5wL3vsa6S1ulMYQmQ (small blind) folded on the Flop




PokerStars Game #59941862028:  Hold'em No Limit ($0.10/$0.25) - 2009/07/01 1:48:31 ET
Table '/VaaaFnlEJoYVomG9uxHkA' 9-max Seat #4 is the button
Seat 1: Th3FldXKQW6hWVVPahaoOQ ($26.65 in chips) 
Seat 2: DIkeSkosO/tsUp9d2JVyTA ($54.75 in chips) 
Seat 3: MtVtHDqIJTyUcXkRBBDIVA ($26.15 in chips) 
Seat 4: j4q3p0lesp63b1gZDwLBZw ($5 in chips) 
Seat 5: cZ99hugmLBj9KhTlc8nCSw ($25 in chips) 
Seat 7: F7pnn6czNpHvRM55XcA2EA ($31.60 in chips) 
Seat 8: dfNim92Z6XK1/h5SFW5vDg ($50.50 in chips) 
cZ99hugmLBj9KhTlc8nCSw: posts small blind $0.10
F7pnn6czNpHvRM55XcA2EA: posts big blind $0.25
DdPXdieucQ+n99u1n3A+rQ: sits out 
*** HOLE CARDS ***
dfNim92Z6XK1/h5SFW5vDg: raises $0.75 to $1
Th3FldXKQW6hWVVPahaoOQ: folds 
DIkeSkosO/tsUp9d2JVyTA: folds 
MtVtHDqIJTyUcXkRBBDIVA: folds 
j4q3p0lesp63b1gZDwLBZw: folds 
cZ99hugmLBj9KhTlc8nCSw: folds 
F7pnn6czNpHvRM55XcA2EA: folds 
Uncalled bet ($0.75) returned to dfNim92Z6XK1/h5SFW5vDg
dfNim92Z6XK1/h5SFW5vDg collected $0.60 from pot
dfNim92Z6XK1/h5SFW5vDg: doesn't show hand 
*** SUMMARY ***
Total pot $0.60 | Rake $0 
Seat 1: Th3FldXKQW6hWVVPahaoOQ folded before Flop (didn't bet)
Seat 2: DIkeSkosO/tsUp9d2JVyTA folded before Flop (didn't bet)
Seat 3: MtVtHDqIJTyUcXkRBBDIVA folded before Flop (didn't bet)
Seat 4: j4q3p0lesp63b1gZDwLBZw (button) folded before Flop (didn't bet)
Seat 5: cZ99hugmLBj9KhTlc8nCSw (small blind) folded before Flop
Seat 7: F7pnn6czNpHvRM55XcA2EA (big blind) folded before Flop
Seat 8: dfNim92Z6XK1/h5SFW5vDg collected ($0.60)




PokerStars Game #59941862084:  Hold'em No Limit ($0.10/$0.25) - 2009/07/01 1:48:31 ET
Table '+2VxGVfkEqJ1AYfQy/JH2w' 6-max Seat #6 is the button
Seat 1: if4dh6jhJXeN3/qd3qCp9g ($28 in chips) 
Seat 2: qllppsCmUqovlriIWCeM/g ($5.15 in chips) 
Seat 3: epAUIB7h2FJXzUPRIvSkRA ($25 in chips) 
Seat 4: y+a/yGW/Jy4bPJFnaeTz5w ($16.60 in chips) 
Seat 5: XD1i5m5PvBDnRzJaG/vINw ($23.90 in chips) 
Seat 6: YQNVDzvw3TmGaFiq9MhRgA ($6.10 in chips) 
if4dh6jhJXeN3/qd3qCp9g: posts small blind $0.10
qllppsCmUqovlriIWCeM/g: posts big blind $0.25
*** HOLE CARDS ***
epAUIB7h2FJXzUPRIvSkRA: folds 
y+a/yGW/Jy4bPJFnaeTz5w: folds 
XD1i5m5PvBDnRzJaG/vINw: folds 
YQNVDzvw3TmGaFiq9MhRgA: folds 
if4dh6jhJXeN3/qd3qCp9g: raises $0.75 to $1
qllppsCmUqovlriIWCeM/g: calls $0.75
*** FLOP *** [Qc Qd 6d]
if4dh6jhJXeN3/qd3qCp9g: checks 
qllppsCmUqovlriIWCeM/g: checks 
*** TURN *** [Qc Qd 6d] [2d]
if4dh6jhJXeN3/qd3qCp9g: checks 
qllppsCmUqovlriIWCeM/g: bets $4.15 and is all-in
if4dh6jhJXeN3/qd3qCp9g: folds 
Uncalled bet ($4.15) returned to qllppsCmUqovlriIWCeM/g
qllppsCmUqovlriIWCeM/g collected $1.90 from pot
qllppsCmUqovlriIWCeM/g: shows [8c Qh] (three of a kind, Queens)
*** SUMMARY ***
Total pot $2 | Rake $0.10 
Board [Qc Qd 6d 2d]
Seat 1: if4dh6jhJXeN3/qd3qCp9g (small blind) folded on the Turn
Seat 2: qllppsCmUqovlriIWCeM/g (big blind) collected ($1.90)
Seat 3: epAUIB7h2FJXzUPRIvSkRA folded before Flop (didn't bet)
Seat 4: y+a/yGW/Jy4bPJFnaeTz5w folded before Flop (didn't bet)
Seat 5: XD1i5m5PvBDnRzJaG/vINw folded before Flop (didn't bet)
Seat 6: YQNVDzvw3TmGaFiq9MhRgA (button) folded before Flop (didn't bet)




PokerStars Game #59941862608:  Hold'em No Limit ($0.10/$0.25) - 2009/07/01 1:48:32 ET
Table '84TjTrgbsYZladOc4PWf4Q' 6-max Seat #6 is the button
Seat 1: /kW0t5kKllzd8HO2uEapHQ ($19.20 in chips) 
Seat 2: RpaEX9P7BCvyfPRLiRNg0A ($48.35 in chips) 
Seat 3: Ar4vsUIUfJ7gbYh1c1m59g ($11.20 in chips) 
Seat 4: SxIIgwXYLkwd6m3wLyPTCw ($25 in chips) 
Seat 5: cezpHJ8FB07dj0xG+LhOvw ($27.10 in chips) 
Seat 6: wCUaomJ6Nq5zomVGdUHP+w ($15.15 in chips) 
/kW0t5kKllzd8HO2uEapHQ: posts small blind $0.10
RpaEX9P7BCvyfPRLiRNg0A: posts big blind $0.25
*** HOLE CARDS ***
Ar4vsUIUfJ7gbYh1c1m59g: folds 
SxIIgwXYLkwd6m3wLyPTCw: folds 
cezpHJ8FB07dj0xG+LhOvw: raises $0.50 to $0.75
wCUaomJ6Nq5zomVGdUHP+w: folds 
/kW0t5kKllzd8HO2uEapHQ: raises $0.50 to $1.25
RpaEX9P7BCvyfPRLiRNg0A: folds 
cezpHJ8FB07dj0xG+LhOvw: calls $0.50
*** FLOP *** [9d 3s 4c]
/kW0t5kKllzd8HO2uEapHQ: bets $0.75
cezpHJ8FB07dj0xG+LhOvw: calls $0.75
*** TURN *** [9d 3s 4c] [6d]
/kW0t5kKllzd8HO2uEapHQ: checks 
cezpHJ8FB07dj0xG+LhOvw: bets $3
/kW0t5kKllzd8HO2uEapHQ: folds 
Uncalled bet ($3) returned to cezpHJ8FB07dj0xG+LhOvw
cezpHJ8FB07dj0xG+LhOvw collected $4.05 from pot
*** SUMMARY ***
Total pot $4.25 | Rake $0.20 
Board [9d 3s 4c 6d]
Seat 1: /kW0t5kKllzd8HO2uEapHQ (small blind) folded on the Turn
Seat 2: RpaEX9P7BCvyfPRLiRNg0A (big blind) folded before Flop
Seat 3: Ar4vsUIUfJ7gbYh1c1m59g folded before Flop (didn't bet)
Seat 4: SxIIgwXYLkwd6m3wLyPTCw folded before Flop (didn't bet)
Seat 5: cezpHJ8FB07dj0xG+LhOvw collected ($4.05)
Seat 6: wCUaomJ6Nq5zomVGdUHP+w (button) folded before Flop (didn't bet)




PokerStars Game #59941862778:  Hold'em No Limit ($0.10/$0.25) - 2009/07/01 1:48:32 ET
Table 'mF3KHGMaTpaBZbtBoyfTeg' 6-max Seat #1 is the button
Seat 1: 0HAB2GdCAM7p7V00xueAVQ ($23 in chips) 
Seat 2: xrf8tAXKQHG99HixCot1Iw ($25.05 in chips) 
Seat 3: 9kUKGKkblnIx3m8rlVol6Q ($11.10 in chips) 
Seat 4: FYepjhAvF8ZdVCmqHIy+eQ ($25 in chips) 
Seat 5: 8ClCHtFXGNplITm+63KB+Q ($45.35 in chips) 
Seat 6: kG34n23qFQA3nzdOJTQ1dA ($26.80 in chips) 
xrf8tAXKQHG99HixCot1Iw: posts small blind $0.10
9kUKGKkblnIx3m8rlVol6Q: posts big blind $0.25
*** HOLE CARDS ***
FYepjhAvF8ZdVCmqHIy+eQ: raises $0.75 to $1
8ClCHtFXGNplITm+63KB+Q: folds 
kG34n23qFQA3nzdOJTQ1dA: folds 
0HAB2GdCAM7p7V00xueAVQ: calls $1
xrf8tAXKQHG99HixCot1Iw: folds 
9kUKGKkblnIx3m8rlVol6Q: calls $0.75
*** FLOP *** [Qs 5c 3s]
9kUKGKkblnIx3m8rlVol6Q: checks 
FYepjhAvF8ZdVCmqHIy+eQ: bets $2.50
0HAB2GdCAM7p7V00xueAVQ: calls $2.50
9kUKGKkblnIx3m8rlVol6Q: raises $3.50 to $6
FYepjhAvF8ZdVCmqHIy+eQ: folds 
0HAB2GdCAM7p7V00xueAVQ: calls $3.50
*** TURN *** [Qs 5c 3s] [4s]
9kUKGKkblnIx3m8rlVol6Q: checks 
0HAB2GdCAM7p7V00xueAVQ: bets $16 and is all-in
9kUKGKkblnIx3m8rlVol6Q: calls $4.10 and is all-in
Uncalled bet ($11.90) returned to 0HAB2GdCAM7p7V00xueAVQ
*** RIVER *** [Qs 5c 3s 4s] [8s]
*** SHOW DOWN ***
9kUKGKkblnIx3m8rlVol6Q: shows [Qc Td] (a pair of Queens)
0HAB2GdCAM7p7V00xueAVQ: shows [Qd Ad] (a pair of Queens - Ace kicker)
0HAB2GdCAM7p7V00xueAVQ collected $24.60 from pot
*** SUMMARY ***
Total pot $25.80 | Rake $1.20 
Board [Qs 5c 3s 4s 8s]
Seat 1: 0HAB2GdCAM7p7V00xueAVQ (button) showed [Qd Ad] and won ($24.60) with a pair of Queens
Seat 2: xrf8tAXKQHG99HixCot1Iw (small blind) folded before Flop
Seat 3: 9kUKGKkblnIx3m8rlVol6Q (big blind) showed [Qc Td] and lost with a pair of Queens
Seat 4: FYepjhAvF8ZdVCmqHIy+eQ folded on the Flop
Seat 5: 8ClCHtFXGNplITm+63KB+Q folded before Flop (didn't bet)
Seat 6: kG34n23qFQA3nzdOJTQ1dA folded before Flop (didn't bet)




PokerStars Game #59941862744:  Hold'em No Limit ($0.10/$0.25) - 2009/07/01 1:48:32 ET
Table '8PD/MTROSMd6Y8mZeykbpg' 6-max Seat #5 is the button
Seat 1: fxNpaToxECtD2Goelmg9vA ($28.85 in chips) 
Seat 2: 4TM16KVgEiQpLi4bVVWbVQ ($25.15 in chips) 
Seat 3: vqWjZmdQu/Hxw96/IJTWdQ ($25 in chips) 
Seat 4: DFi/Lzkjsfv8QswS80JX9Q ($54.45 in chips) 
Seat 5: z3tQwy28dp5FykDJC/wzQw ($26.20 in chips) 
Seat 6: trN/oHqTTbPw5MNuKrOpLw ($25 in chips) 
trN/oHqTTbPw5MNuKrOpLw: posts small blind $0.10
fxNpaToxECtD2Goelmg9vA: posts big blind $0.25
*** HOLE CARDS ***
4TM16KVgEiQpLi4bVVWbVQ: folds 
vqWjZmdQu/Hxw96/IJTWdQ: folds 
DFi/Lzkjsfv8QswS80JX9Q: folds 
z3tQwy28dp5FykDJC/wzQw: folds 
trN/oHqTTbPw5MNuKrOpLw: raises $0.50 to $0.75
fxNpaToxECtD2Goelmg9vA: folds 
Uncalled bet ($0.50) returned to trN/oHqTTbPw5MNuKrOpLw
trN/oHqTTbPw5MNuKrOpLw collected $0.50 from pot
trN/oHqTTbPw5MNuKrOpLw: doesn't show hand 
*** SUMMARY ***
Total pot $0.50 | Rake $0 
Seat 1: fxNpaToxECtD2Goelmg9vA (big blind) folded before Flop
Seat 2: 4TM16KVgEiQpLi4bVVWbVQ folded before Flop (didn't bet)
Seat 3: vqWjZmdQu/Hxw96/IJTWdQ folded before Flop (didn't bet)
Seat 4: DFi/Lzkjsfv8QswS80JX9Q folded before Flop (didn't bet)
Seat 5: z3tQwy28dp5FykDJC/wzQw (button) folded before Flop (didn't bet)
Seat 6: trN/oHqTTbPw5MNuKrOpLw (small blind) collected ($0.50)




PokerStars Game #59941862736:  Hold'em No Limit ($0.10/$0.25) - 2009/07/01 1:48:32 ET
Table '3Ns9nuTkynfwbBfBXzg6ww' 6-max Seat #5 is the button
Seat 1: epAUIB7h2FJXzUPRIvSkRA ($25.70 in chips) 
Seat 2: zxeVQGaMKDsDzmSY+AInjA ($31.40 in chips) 
Seat 3: eL3+wCBjFGfQ5FMdIZihwA ($23.95 in chips) 
Seat 4: qGHGf/553gQnDoklMRe3tg ($30.85 in chips) 
Seat 5: wqphQtauX5Qn7WRJZS1flA ($24.05 in chips) 
Seat 6: DE9hRlt14g+JdsRQ4wT7hg ($38.85 in chips) 
DE9hRlt14g+JdsRQ4wT7hg: posts small blind $0.10
epAUIB7h2FJXzUPRIvSkRA: posts big blind $0.25
*** HOLE CARDS ***
zxeVQGaMKDsDzmSY+AInjA: raises $0.75 to $1
eL3+wCBjFGfQ5FMdIZihwA: folds 
qGHGf/553gQnDoklMRe3tg: folds 
wqphQtauX5Qn7WRJZS1flA: folds 
DE9hRlt14g+JdsRQ4wT7hg: folds 
epAUIB7h2FJXzUPRIvSkRA: folds 
Uncalled bet ($0.75) returned to zxeVQGaMKDsDzmSY+AInjA
zxeVQGaMKDsDzmSY+AInjA collected $0.60 from pot
zxeVQGaMKDsDzmSY+AInjA: doesn't show hand 
*** SUMMARY ***
Total pot $0.60 | Rake $0 
Seat 1: epAUIB7h2FJXzUPRIvSkRA (big blind) folded before Flop
Seat 2: zxeVQGaMKDsDzmSY+AInjA collected ($0.60)
Seat 3: eL3+wCBjFGfQ5FMdIZihwA folded before Flop (didn't bet)
Seat 4: qGHGf/553gQnDoklMRe3tg folded before Flop (didn't bet)
Seat 5: wqphQtauX5Qn7WRJZS1flA (button) folded before Flop (didn't bet)
Seat 6: DE9hRlt14g+JdsRQ4wT7hg (small blind) folded before Flop




PokerStars Game #59941862680:  Hold'em No Limit ($0.10/$0.25) - 2009/07/01 1:48:32 ET
Table 'ohAuixfiLOYDylNUG5mNUw' 9-max Seat #9 is the button
Seat 1: qwr38jl5txoR36M7G5qi4A ($10 in chips) 
Seat 2: Th3FldXKQW6hWVVPahaoOQ ($26.15 in chips) 
Seat 3: gSakoFAgDDzXSb2eNBWKcg ($14.50 in chips) 
Seat 4: clJsV3v77RS07bDKY+705w ($5 in chips) 
Seat 6: MtVtHDqIJTyUcXkRBBDIVA ($25 in chips) 
Seat 8: ppMlNkhYgErlt4fuJO7ADA ($4.95 in chips) 
Seat 9: CT7Xj/V/O5rBlhtt+RZeFQ ($25.25 in chips) 
qwr38jl5txoR36M7G5qi4A: posts small blind $0.10
Th3FldXKQW6hWVVPahaoOQ: posts big blind $0.25
y6clPkgMYve3yX9UTvvFUw: sits out 
*** HOLE CARDS ***
gSakoFAgDDzXSb2eNBWKcg: folds 
clJsV3v77RS07bDKY+705w: folds 
MtVtHDqIJTyUcXkRBBDIVA: raises $0.50 to $0.75
ppMlNkhYgErlt4fuJO7ADA: folds 
CT7Xj/V/O5rBlhtt+RZeFQ: folds 
qwr38jl5txoR36M7G5qi4A: folds 
Th3FldXKQW6hWVVPahaoOQ: folds 
Uncalled bet ($0.50) returned to MtVtHDqIJTyUcXkRBBDIVA
MtVtHDqIJTyUcXkRBBDIVA collected $0.60 from pot
MtVtHDqIJTyUcXkRBBDIVA: doesn't show hand 
*** SUMMARY ***
Total pot $0.60 | Rake $0 
Seat 1: qwr38jl5txoR36M7G5qi4A (small blind) folded before Flop
Seat 2: Th3FldXKQW6hWVVPahaoOQ (big blind) folded before Flop
Seat 3: gSakoFAgDDzXSb2eNBWKcg folded before Flop (didn't bet)
Seat 4: clJsV3v77RS07bDKY+705w folded before Flop (didn't bet)
Seat 6: MtVtHDqIJTyUcXkRBBDIVA collected ($0.60)
Seat 8: ppMlNkhYgErlt4fuJO7ADA folded before Flop (didn't bet)
Seat 9: CT7Xj/V/O5rBlhtt+RZeFQ (button) folded before Flop (didn't bet)




PokerStars Game #59941862864:  Hold'em No Limit ($0.10/$0.25) - 2009/07/01 1:48:32 ET
Table 'n8mNkPYbe1AIQEkioNesZA' 9-max Seat #1 is the button
Seat 1: 9lvO/qyU+xrU95Teu1fv0g ($5.20 in chips) 
Seat 2: QEbIGci+itdw+re8RM5fZA ($29.05 in chips) 
Seat 3: zDrucyjVn5aeekNEc3cJrA ($19 in chips) 
Seat 4: zgi+EUykT/pZQpoUG6+oEg ($5 in chips) 
Seat 5: wGigCmBR/9XWkPpvYos3aQ ($28.40 in chips) 
Seat 6: HPEB+AtKw1+C/cxU0o1ciw ($46.55 in chips) 
Seat 8: aNpwfA31EREwO+ar4XzBCw ($32.20 in chips) 
Seat 9: gehe91e0IyVT0QU/XBkEyg ($27.90 in chips) 
QEbIGci+itdw+re8RM5fZA: posts small blind $0.10
zDrucyjVn5aeekNEc3cJrA: posts big blind $0.25
*** HOLE CARDS ***
zgi+EUykT/pZQpoUG6+oEg: folds 
wGigCmBR/9XWkPpvYos3aQ: folds 
vNfw/x/HNt0WgQC8SveThg has returned
HPEB+AtKw1+C/cxU0o1ciw: folds 
aNpwfA31EREwO+ar4XzBCw: folds 
vNfw/x/HNt0WgQC8SveThg is sitting out
vNfw/x/HNt0WgQC8SveThg has returned
gehe91e0IyVT0QU/XBkEyg: raises $0.75 to $1
9lvO/qyU+xrU95Teu1fv0g: folds 
QEbIGci+itdw+re8RM5fZA: folds 
zDrucyjVn5aeekNEc3cJrA: folds 
Uncalled bet ($0.75) returned to gehe91e0IyVT0QU/XBkEyg
gehe91e0IyVT0QU/XBkEyg collected $0.60 from pot
*** SUMMARY ***
Total pot $0.60 | Rake $0 
Seat 1: 9lvO/qyU+xrU95Teu1fv0g (button) folded before Flop (didn't bet)
Seat 2: QEbIGci+itdw+re8RM5fZA (small blind) folded before Flop
Seat 3: zDrucyjVn5aeekNEc3cJrA (big blind) folded before Flop
Seat 4: zgi+EUykT/pZQpoUG6+oEg folded before Flop (didn't bet)
Seat 5: wGigCmBR/9XWkPpvYos3aQ folded before Flop (didn't bet)
Seat 6: HPEB+AtKw1+C/cxU0o1ciw folded before Flop (didn't bet)
Seat 8: aNpwfA31EREwO+ar4XzBCw folded before Flop (didn't bet)
Seat 9: gehe91e0IyVT0QU/XBkEyg collected ($0.60)




PokerStars Game #59941862574:  Hold'em No Limit ($0.10/$0.25) - 2009/07/01 1:48:32 ET
Table '3eK1r4Q4BSYFvsKkuTLpIA' 9-max Seat #6 is the button
Seat 1: vSkQm2EelzwRGDDQQk0Fqw ($4.30 in chips) 
Seat 2: aNpwfA31EREwO+ar4XzBCw ($28.10 in chips) 
Seat 3: 56S3mA6Zs3pGR+0p0vUCtg ($35.85 in chips) 
Seat 4: +2kMBNpY4nF1qNCRd8SJLA ($25 in chips) 
Seat 5: 775TiRJajPtN/ucpTmHrXA ($13.55 in chips) 
Seat 6: +HvCCmsGSQeatf+GZ9zk8Q ($29.20 in chips) 
Seat 7: ljemhp25Zg+nlA9DLCIiUw ($24.75 in chips) 
Seat 8: /29aHLC+Q6KCDcNv2bPfAg ($18.55 in chips) 
Seat 9: +sbyWwIcFp9kP0bDtMegfQ ($60.40 in chips) 
ljemhp25Zg+nlA9DLCIiUw: posts small blind $0.10
/29aHLC+Q6KCDcNv2bPfAg: posts big blind $0.25
*** HOLE CARDS ***
+sbyWwIcFp9kP0bDtMegfQ: folds 
vSkQm2EelzwRGDDQQk0Fqw: folds 
aNpwfA31EREwO+ar4XzBCw: folds 
56S3mA6Zs3pGR+0p0vUCtg: folds 
+2kMBNpY4nF1qNCRd8SJLA: folds 
775TiRJajPtN/ucpTmHrXA: folds 
+HvCCmsGSQeatf+GZ9zk8Q: calls $0.25
ljemhp25Zg+nlA9DLCIiUw: folds 
/29aHLC+Q6KCDcNv2bPfAg: checks 
*** FLOP *** [Td 4d 8s]
/29aHLC+Q6KCDcNv2bPfAg: checks 
+HvCCmsGSQeatf+GZ9zk8Q: bets $0.25
/29aHLC+Q6KCDcNv2bPfAg: calls $0.25
*** TURN *** [Td 4d 8s] [9h]
/29aHLC+Q6KCDcNv2bPfAg: checks 
+HvCCmsGSQeatf+GZ9zk8Q: bets $0.50
/29aHLC+Q6KCDcNv2bPfAg: folds 
Uncalled bet ($0.50) returned to +HvCCmsGSQeatf+GZ9zk8Q
+HvCCmsGSQeatf+GZ9zk8Q collected $1.05 from pot
+HvCCmsGSQeatf+GZ9zk8Q: doesn't show hand 
*** SUMMARY ***
Total pot $1.10 | Rake $0.05 
Board [Td 4d 8s 9h]
Seat 1: vSkQm2EelzwRGDDQQk0Fqw folded before Flop (didn't bet)
Seat 2: aNpwfA31EREwO+ar4XzBCw folded before Flop (didn't bet)
Seat 3: 56S3mA6Zs3pGR+0p0vUCtg folded before Flop (didn't bet)
Seat 4: +2kMBNpY4nF1qNCRd8SJLA folded before Flop (didn't bet)
Seat 5: 775TiRJajPtN/ucpTmHrXA folded before Flop (didn't bet)
Seat 6: +HvCCmsGSQeatf+GZ9zk8Q (button) collected ($1.05)
Seat 7: ljemhp25Zg+nlA9DLCIiUw (small blind) folded before Flop
Seat 8: /29aHLC+Q6KCDcNv2bPfAg (big blind) folded on the Turn
Seat 9: +sbyWwIcFp9kP0bDtMegfQ folded before Flop (didn't bet)




PokerStars Game #59941863460:  Hold'em No Limit ($0.10/$0.25) - 2009/07/01 1:48:33 ET
Table 'pPgW4R3kdH26lLi1MnE92w' 9-max Seat #4 is the button
Seat 1: F4P6SxCNY4vxdb318G9RwA ($18.60 in chips) 
Seat 2: cZ99hugmLBj9KhTlc8nCSw ($27.15 in chips) 
Seat 3: WaS7+xnv4bIVHoru6nxczA ($14.25 in chips) 
Seat 4: iZ1f67Ok/207yzIQOu1Kdg ($4.65 in chips) 
Seat 5: HPEB+AtKw1+C/cxU0o1ciw ($21.25 in chips) 
Seat 6: +qc/EYCgLC65SpGvr35eNg ($25 in chips) 
Seat 7: sD+TKtt36XiiN6jqHiLwDA ($29.05 in chips) 
Seat 8: clJsV3v77RS07bDKY+705w ($5 in chips) 
Seat 9: tcbEu7VzyHQ+0lh+skbQhQ ($65.40 in chips) 
HPEB+AtKw1+C/cxU0o1ciw: posts small blind $0.10
+qc/EYCgLC65SpGvr35eNg: posts big blind $0.25
*** HOLE CARDS ***
sD+TKtt36XiiN6jqHiLwDA: folds 
clJsV3v77RS07bDKY+705w: folds 
tcbEu7VzyHQ+0lh+skbQhQ: calls $0.25
F4P6SxCNY4vxdb318G9RwA: calls $0.25
cZ99hugmLBj9KhTlc8nCSw: raises $1 to $1.25
WaS7+xnv4bIVHoru6nxczA: folds 
iZ1f67Ok/207yzIQOu1Kdg: folds 
HPEB+AtKw1+C/cxU0o1ciw: folds 
+qc/EYCgLC65SpGvr35eNg: folds 
tcbEu7VzyHQ+0lh+skbQhQ: folds 
F4P6SxCNY4vxdb318G9RwA: folds 
Uncalled bet ($1) returned to cZ99hugmLBj9KhTlc8nCSw
cZ99hugmLBj9KhTlc8nCSw collected $1.10 from pot
*** SUMMARY ***
Total pot $1.10 | Rake $0 
Seat 1: F4P6SxCNY4vxdb318G9RwA folded before Flop
Seat 2: cZ99hugmLBj9KhTlc8nCSw collected ($1.10)
Seat 3: WaS7+xnv4bIVHoru6nxczA folded before Flop (didn't bet)
Seat 4: iZ1f67Ok/207yzIQOu1Kdg (button) folded before Flop (didn't bet)
Seat 5: HPEB+AtKw1+C/cxU0o1ciw (small blind) folded before Flop
Seat 6: +qc/EYCgLC65SpGvr35eNg (big blind) folded before Flop
Seat 7: sD+TKtt36XiiN6jqHiLwDA folded before Flop (didn't bet)
Seat 8: clJsV3v77RS07bDKY+705w folded before Flop (didn't bet)
Seat 9: tcbEu7VzyHQ+0lh+skbQhQ folded before Flop




PokerStars Game #59941863248:  Hold'em No Limit ($0.10/$0.25) - 2009/07/01 1:48:33 ET
Table 'WEMI3Mtn7dGARDbgNrKibgQvLFJzpzymuOsaaRYi+8fgx Seat #4 is the button
Seat 1: cZ99hugmLBj9KhTlc8nCSw ($26.70 in chips) 
Seat 2: PdIasPkzm2sqZnN41ZRXOg ($5 in chips) 
Seat 3: Qduu7ikeizo6q6Ei9YvcJA ($24.65 in chips) 
Seat 4: tLcDklc2rBORNfixyRfVfw ($25.25 in chips) 
Seat 5: MG90wfSJZnOejs/KD3vlQQ ($36.25 in chips) 
Seat 6: vKdukiQ4ktU4yJ0Xx3MKnA ($8.10 in chips) 
Seat 7: rQhYIYXSyH/IivYM1dlV5A ($11.20 in chips) 
Seat 8: gehe91e0IyVT0QU/XBkEyg ($27.35 in chips) 
Seat 9: BWzInv8o0kN1pJybv/VjpQ ($44.80 in chips) 
MG90wfSJZnOejs/KD3vlQQ: posts small blind $0.10
vKdukiQ4ktU4yJ0Xx3MKnA: posts big blind $0.25
*** HOLE CARDS ***
rQhYIYXSyH/IivYM1dlV5A: folds 
gehe91e0IyVT0QU/XBkEyg: folds 
BWzInv8o0kN1pJybv/VjpQ: folds 
cZ99hugmLBj9KhTlc8nCSw: folds 
PdIasPkzm2sqZnN41ZRXOg: folds 
Qduu7ikeizo6q6Ei9YvcJA: raises $0.75 to $1
tLcDklc2rBORNfixyRfVfw: folds 
MG90wfSJZnOejs/KD3vlQQ: folds 
vKdukiQ4ktU4yJ0Xx3MKnA: folds 
Uncalled bet ($0.75) returned to Qduu7ikeizo6q6Ei9YvcJA
Qduu7ikeizo6q6Ei9YvcJA collected $0.60 from pot
Qduu7ikeizo6q6Ei9YvcJA: doesn't show hand 
*** SUMMARY ***
Total pot $0.60 | Rake $0 
Seat 1: cZ99hugmLBj9KhTlc8nCSw folded before Flop (didn't bet)
Seat 2: PdIasPkzm2sqZnN41ZRXOg folded before Flop (didn't bet)
Seat 3: Qduu7ikeizo6q6Ei9YvcJA collected ($0.60)
Seat 4: tLcDklc2rBORNfixyRfVfw (button) folded before Flop (didn't bet)
Seat 5: MG90wfSJZnOejs/KD3vlQQ (small blind) folded before Flop
Seat 6: vKdukiQ4ktU4yJ0Xx3MKnA (big blind) folded before Flop
Seat 7: rQhYIYXSyH/IivYM1dlV5A folded before Flop (didn't bet)
Seat 8: gehe91e0IyVT0QU/XBkEyg folded before Flop (didn't bet)
Seat 9: BWzInv8o0kN1pJybv/VjpQ folded before Flop (didn't bet)




PokerStars Game #59941863238:  Hold'em No Limit ($0.10/$0.25) - 2009/07/01 1:48:33 ET
Table 'KTZXQ4LREPjpS54R3DFTsw' 9-max Seat #4 is the button
Seat 1: dSjkBIV7Bv+ZCIWNBguf7w ($40.85 in chips) 
Seat 2: OlPJsgR4xypSg/w1z7Gyvw ($16 in chips) 
Seat 3: H5Se03ZqSX7tbULXur2MAg ($28.50 in chips) 
Seat 4: K0b5wNInj6hUGRr6yzKFtw ($64 in chips) 
Seat 5: HPEB+AtKw1+C/cxU0o1ciw ($28.95 in chips) 
Seat 6: Mh2r9hTeTEDnh19sRZtW3g ($5.70 in chips) 
Seat 7: yyG4svzOpC1A+sUP/scg6w ($10.95 in chips) 
Seat 9: V6p0jQ/RhUsqpHLmXvEX4Q ($12.45 in chips) 
HPEB+AtKw1+C/cxU0o1ciw: posts small blind $0.10
Mh2r9hTeTEDnh19sRZtW3g: posts big blind $0.25
mMd8CDS/but3UC+Zp7Up2w: sits out 
*** HOLE CARDS ***
yyG4svzOpC1A+sUP/scg6w: folds 
V6p0jQ/RhUsqpHLmXvEX4Q: folds 
dSjkBIV7Bv+ZCIWNBguf7w: folds 
OlPJsgR4xypSg/w1z7Gyvw: raises $0.75 to $1
H5Se03ZqSX7tbULXur2MAg: folds 
K0b5wNInj6hUGRr6yzKFtw: folds 
HPEB+AtKw1+C/cxU0o1ciw: folds 
Mh2r9hTeTEDnh19sRZtW3g: folds 
Uncalled bet ($0.75) returned to OlPJsgR4xypSg/w1z7Gyvw
OlPJsgR4xypSg/w1z7Gyvw collected $0.60 from pot
OlPJsgR4xypSg/w1z7Gyvw: doesn't show hand 
*** SUMMARY ***
Total pot $0.60 | Rake $0 
Seat 1: dSjkBIV7Bv+ZCIWNBguf7w folded before Flop (didn't bet)
Seat 2: OlPJsgR4xypSg/w1z7Gyvw collected ($0.60)
Seat 3: H5Se03ZqSX7tbULXur2MAg folded before Flop (didn't bet)
Seat 4: K0b5wNInj6hUGRr6yzKFtw (button) folded before Flop (didn't bet)
Seat 5: HPEB+AtKw1+C/cxU0o1ciw (small blind) folded before Flop
Seat 6: Mh2r9hTeTEDnh19sRZtW3g (big blind) folded before Flop
Seat 7: yyG4svzOpC1A+sUP/scg6w folded before Flop (didn't bet)
Seat 9: V6p0jQ/RhUsqpHLmXvEX4Q folded before Flop (didn't bet)




PokerStars Game #59941863440:  Hold'em No Limit ($0.10/$0.25) - 2009/07/01 1:48:33 ET
Table 'mdub7rJf3Z5tCT9s/+1+Wg' 9-max Seat #5 is the button
Seat 1: cZ99hugmLBj9KhTlc8nCSw ($28.90 in chips) 
Seat 2: 539MC3AwKLWVFwzABc644Q ($10.90 in chips) 
Seat 3: PdIasPkzm2sqZnN41ZRXOg ($5.60 in chips) 
Seat 4: fDGyaQz0cs2s4FOYxkbIHA ($14.50 in chips) 
Seat 5: dfNim92Z6XK1/h5SFW5vDg ($25.90 in chips) 
Seat 6: T/CCwAWe2yhO0c4oHNwicw ($23.35 in chips) 
Seat 7: woe+9KKk+L3pZgMTuHcmog ($15.55 in chips) 
Seat 9: tYsOBqdU1+x+yFI7zHO7hQ ($36.05 in chips) 
T/CCwAWe2yhO0c4oHNwicw: posts small blind $0.10
woe+9KKk+L3pZgMTuHcmog: posts big blind $0.25
bXpVeaSTPBFSPJmeXxO7nw: sits out 
*** HOLE CARDS ***
tYsOBqdU1+x+yFI7zHO7hQ: folds 
cZ99hugmLBj9KhTlc8nCSw: folds 
539MC3AwKLWVFwzABc644Q: folds 
PdIasPkzm2sqZnN41ZRXOg: calls $0.25
fDGyaQz0cs2s4FOYxkbIHA has timed out
fDGyaQz0cs2s4FOYxkbIHA: folds 
fDGyaQz0cs2s4FOYxkbIHA is sitting out
dfNim92Z6XK1/h5SFW5vDg: folds 
T/CCwAWe2yhO0c4oHNwicw: folds 
fDGyaQz0cs2s4FOYxkbIHA has returned
woe+9KKk+L3pZgMTuHcmog: checks 
*** FLOP *** [8c 2h 3h]
woe+9KKk+L3pZgMTuHcmog: checks 
PdIasPkzm2sqZnN41ZRXOg: checks 
*** TURN *** [8c 2h 3h] [6d]
woe+9KKk+L3pZgMTuHcmog: checks 
PdIasPkzm2sqZnN41ZRXOg: checks 
*** RIVER *** [8c 2h 3h 6d] [Ks]
woe+9KKk+L3pZgMTuHcmog: checks 
PdIasPkzm2sqZnN41ZRXOg: checks 
*** SHOW DOWN ***
woe+9KKk+L3pZgMTuHcmog: shows [Ah 5h] (high card Ace)
PdIasPkzm2sqZnN41ZRXOg: shows [9c Ac] (high card Ace - King+Nine kicker)
PdIasPkzm2sqZnN41ZRXOg collected $0.60 from pot
*** SUMMARY ***
Total pot $0.60 | Rake $0 
Board [8c 2h 3h 6d Ks]
Seat 1: cZ99hugmLBj9KhTlc8nCSw folded before Flop (didn't bet)
Seat 2: 539MC3AwKLWVFwzABc644Q folded before Flop (didn't bet)
Seat 3: PdIasPkzm2sqZnN41ZRXOg showed [9c Ac] and won ($0.60) with high card Ace
Seat 4: fDGyaQz0cs2s4FOYxkbIHA folded before Flop (didn't bet)
Seat 5: dfNim92Z6XK1/h5SFW5vDg (button) folded before Flop (didn't bet)
Seat 6: T/CCwAWe2yhO0c4oHNwicw (small blind) folded before Flop
Seat 7: woe+9KKk+L3pZgMTuHcmog (big blind) showed [Ah 5h] and lost with high card Ace
Seat 9: tYsOBqdU1+x+yFI7zHO7hQ folded before Flop (didn't bet)




PokerStars Game #59941863364:  Hold'em No Limit ($0.10/$0.25) - 2009/07/01 1:48:33 ET
Table '6wawJ+MkkvuC3coG6r+Yhg' 6-max Seat #5 is the button
Seat 1: JQZew0FjzS19kTjeNtrE+A ($19.85 in chips) 
Seat 2: LtASJ9OlkqGrrUKGQlpGAw ($34.15 in chips) 
Seat 3: 3zD3qLXT1bEffAoWGnc7wg ($61.25 in chips) 
Seat 5: FZrgDbxAanC1xwZxXHJKVA ($4.20 in chips) 
Seat 6: B3X187C0tXFUfQpCu8pe8A ($24.90 in chips) 
9U3ZKjCsarN0DjR6mSE8Ug joins the table at seat #4 
B3X187C0tXFUfQpCu8pe8A: posts small blind $0.10
JQZew0FjzS19kTjeNtrE+A: posts big blind $0.25
*** HOLE CARDS ***
LtASJ9OlkqGrrUKGQlpGAw: folds 
3zD3qLXT1bEffAoWGnc7wg: raises $0.50 to $0.75
FZrgDbxAanC1xwZxXHJKVA: raises $0.50 to $1.25
B3X187C0tXFUfQpCu8pe8A: folds 
JQZew0FjzS19kTjeNtrE+A: calls $1
3zD3qLXT1bEffAoWGnc7wg: calls $0.50
*** FLOP *** [2c 8h 3s]
JQZew0FjzS19kTjeNtrE+A: checks 
3zD3qLXT1bEffAoWGnc7wg: checks 
FZrgDbxAanC1xwZxXHJKVA: bets $0.75
JQZew0FjzS19kTjeNtrE+A: calls $0.75
3zD3qLXT1bEffAoWGnc7wg: folds 
*** TURN *** [2c 8h 3s] [Ad]
JQZew0FjzS19kTjeNtrE+A: checks 
FZrgDbxAanC1xwZxXHJKVA: checks 
*** RIVER *** [2c 8h 3s Ad] [Qc]
JQZew0FjzS19kTjeNtrE+A: checks 
FZrgDbxAanC1xwZxXHJKVA: checks 
*** SHOW DOWN ***
JQZew0FjzS19kTjeNtrE+A: shows [3d 5d] (a pair of Threes)
FZrgDbxAanC1xwZxXHJKVA: shows [Qh Kh] (a pair of Queens)
FZrgDbxAanC1xwZxXHJKVA collected $5.10 from pot
*** SUMMARY ***
Total pot $5.35 | Rake $0.25 
Board [2c 8h 3s Ad Qc]
Seat 1: JQZew0FjzS19kTjeNtrE+A (big blind) showed [3d 5d] and lost with a pair of Threes
Seat 2: LtASJ9OlkqGrrUKGQlpGAw folded before Flop (didn't bet)
Seat 3: 3zD3qLXT1bEffAoWGnc7wg folded on the Flop
Seat 5: FZrgDbxAanC1xwZxXHJKVA (button) showed [Qh Kh] and won ($5.10) with a pair of Queens
Seat 6: B3X187C0tXFUfQpCu8pe8A (small blind) folded before Flop




PokerStars Game #59941863264:  Hold'em No Limit ($0.10/$0.25) - 2009/07/01 1:48:33 ET
Table 'VuY5ej47Cy8nOI3Wogmhzw' 6-max Seat #4 is the button
Seat 1: EeUZtMU058v2ObUACOF4Og ($35.60 in chips) 
Seat 2: AM6Yl+3esmhhMBlSnQhWbg ($15.10 in chips) 
Seat 3: v+QfkGiuj9bgtuNoVnDO8w ($41.10 in chips) 
Seat 4: QqiZLFrN8iOUT/GHw7ztOA ($26.15 in chips) 
Seat 6: +KblIivb6tainScpwm14RQ ($11.05 in chips) 
m2yWOKfAxqHoy5DDN87Ttw will be allowed to play after the button
+KblIivb6tainScpwm14RQ: posts small blind $0.10
EeUZtMU058v2ObUACOF4Og: posts big blind $0.25
*** HOLE CARDS ***
AM6Yl+3esmhhMBlSnQhWbg: raises $0.50 to $0.75
v+QfkGiuj9bgtuNoVnDO8w: calls $0.75
QqiZLFrN8iOUT/GHw7ztOA: folds 
+KblIivb6tainScpwm14RQ: folds 
EeUZtMU058v2ObUACOF4Og: folds 
*** FLOP *** [2h 9h 2d]
AM6Yl+3esmhhMBlSnQhWbg: bets $0.75
v+QfkGiuj9bgtuNoVnDO8w: raises $2 to $2.75
AM6Yl+3esmhhMBlSnQhWbg: folds 
Uncalled bet ($2) returned to v+QfkGiuj9bgtuNoVnDO8w
v+QfkGiuj9bgtuNoVnDO8w collected $3.20 from pot
v+QfkGiuj9bgtuNoVnDO8w: doesn't show hand 
*** SUMMARY ***
Total pot $3.35 | Rake $0.15 
Board [2h 9h 2d]
Seat 1: EeUZtMU058v2ObUACOF4Og (big blind) folded before Flop
Seat 2: AM6Yl+3esmhhMBlSnQhWbg folded on the Flop
Seat 3: v+QfkGiuj9bgtuNoVnDO8w collected ($3.20)
Seat 4: QqiZLFrN8iOUT/GHw7ztOA (button) folded before Flop (didn't bet)
Seat 6: +KblIivb6tainScpwm14RQ (small blind) folded before Flop




PokerStars Game #59941863132:  Hold'em No Limit ($0.10/$0.25) - 2009/07/01 1:48:33 ET
Table '63h13e5p7cWe02rClZ1CHw' 6-max Seat #3 is the button
Seat 1: pokjbbEcXXPlADXdSGHtZw ($21.70 in chips) 
Seat 2: k9nHZTHt8hYhYRcW8NTb4g ($24.25 in chips) 
Seat 3: mFv3iBCtrw9XfCDRB0d46Q ($4.30 in chips) 
Seat 4: xrf8tAXKQHG99HixCot1Iw ($28.10 in chips) 
Seat 5: iyZxqznXjv3vtvOJymkoLQ ($44.45 in chips) 
Seat 6: mfrkWA3PTeYPkbO6hi98Aw ($39.05 in chips) 
xrf8tAXKQHG99HixCot1Iw: posts small blind $0.10
iyZxqznXjv3vtvOJymkoLQ: posts big blind $0.25
*** HOLE CARDS ***
mfrkWA3PTeYPkbO6hi98Aw: folds 
pokjbbEcXXPlADXdSGHtZw: folds 
k9nHZTHt8hYhYRcW8NTb4g: raises $0.50 to $0.75
mFv3iBCtrw9XfCDRB0d46Q: folds 
xrf8tAXKQHG99HixCot1Iw: folds 
iyZxqznXjv3vtvOJymkoLQ: folds 
Uncalled bet ($0.50) returned to k9nHZTHt8hYhYRcW8NTb4g
k9nHZTHt8hYhYRcW8NTb4g collected $0.60 from pot
k9nHZTHt8hYhYRcW8NTb4g: doesn't show hand 
*** SUMMARY ***
Total pot $0.60 | Rake $0 
Seat 1: pokjbbEcXXPlADXdSGHtZw folded before Flop (didn't bet)
Seat 2: k9nHZTHt8hYhYRcW8NTb4g collected ($0.60)
Seat 3: mFv3iBCtrw9XfCDRB0d46Q (button) folded before Flop (didn't bet)
Seat 4: xrf8tAXKQHG99HixCot1Iw (small blind) folded before Flop
Seat 5: iyZxqznXjv3vtvOJymkoLQ (big blind) folded before Flop
Seat 6: mfrkWA3PTeYPkbO6hi98Aw folded before Flop (didn't bet)




PokerStars Game #59941863300:  Hold'em No Limit ($0.10/$0.25) - 2009/07/01 1:48:33 ET
Table 'oJpFwZj9+FUGHX90Un8s9Q' 6-max Seat #2 is the button
Seat 1: 6DwBRH+xZ12AAZmeAg+aXw ($23.55 in chips) 
Seat 2: NtrVQ9UIql0rDCnKDKZ5FQ ($19.35 in chips) 
Seat 3: kyRaCIljYA6l33lSKQfNsg ($24.75 in chips) 
Seat 4: 6elpmfyt4Zw0yvd8lePSMQ ($20.90 in chips) 
Seat 5: kG34n23qFQA3nzdOJTQ1dA ($55.45 in chips) 
Seat 6: 7LpHJVeM6k1mQdC6HXYzww ($25.35 in chips) 
kyRaCIljYA6l33lSKQfNsg: posts small blind $0.10
6elpmfyt4Zw0yvd8lePSMQ: posts big blind $0.25
*** HOLE CARDS ***
kG34n23qFQA3nzdOJTQ1dA: folds 
7LpHJVeM6k1mQdC6HXYzww: folds 
6DwBRH+xZ12AAZmeAg+aXw: folds 
NtrVQ9UIql0rDCnKDKZ5FQ: calls $0.25
kyRaCIljYA6l33lSKQfNsg: folds 
6elpmfyt4Zw0yvd8lePSMQ: checks 
*** FLOP *** [8h Jh 3d]
6elpmfyt4Zw0yvd8lePSMQ: checks 
NtrVQ9UIql0rDCnKDKZ5FQ: bets $0.25
6elpmfyt4Zw0yvd8lePSMQ: folds 
Uncalled bet ($0.25) returned to NtrVQ9UIql0rDCnKDKZ5FQ
NtrVQ9UIql0rDCnKDKZ5FQ collected $0.60 from pot
*** SUMMARY ***
Total pot $0.60 | Rake $0 
Board [8h Jh 3d]
Seat 1: 6DwBRH+xZ12AAZmeAg+aXw folded before Flop (didn't bet)
Seat 2: NtrVQ9UIql0rDCnKDKZ5FQ (button) collected ($0.60)
Seat 3: kyRaCIljYA6l33lSKQfNsg (small blind) folded before Flop
Seat 4: 6elpmfyt4Zw0yvd8lePSMQ (big blind) folded on the Flop
Seat 5: kG34n23qFQA3nzdOJTQ1dA folded before Flop (didn't bet)
Seat 6: 7LpHJVeM6k1mQdC6HXYzww folded before Flop (didn't bet)




PokerStars Game #59941863570:  Hold'em No Limit ($0.10/$0.25) - 2009/07/01 1:48:34 ET
Table 'NgexmgEDEzICBeSO7YCrKQ' 6-max Seat #1 is the button
Seat 1: cezpHJ8FB07dj0xG+LhOvw ($29.70 in chips) 
Seat 2: 32YL2ZEp8NT4JB2RVM9euQ ($21.30 in chips) 
Seat 3: JFIAqU8lCZ0vWwEl4bdGsg ($27.55 in chips) 
Seat 4: xx+iYCDJhHJmNzrfeloyEg ($22.30 in chips) 
Seat 5: /MXkdT8TTs8Qp2LVTQNw6w ($42.20 in chips) 
Seat 6: k9nHZTHt8hYhYRcW8NTb4g ($11.30 in chips) 
32YL2ZEp8NT4JB2RVM9euQ: posts small blind $0.10
JFIAqU8lCZ0vWwEl4bdGsg: posts big blind $0.25
*** HOLE CARDS ***
xx+iYCDJhHJmNzrfeloyEg said, "  Only way I can get the flop to hit my cards, is to muck my cards."
xx+iYCDJhHJmNzrfeloyEg: calls $0.25
/MXkdT8TTs8Qp2LVTQNw6w said, "been there"
/MXkdT8TTs8Qp2LVTQNw6w: calls $0.25
k9nHZTHt8hYhYRcW8NTb4g: folds 
cezpHJ8FB07dj0xG+LhOvw: raises $1.25 to $1.50
32YL2ZEp8NT4JB2RVM9euQ: raises $2.25 to $3.75
JFIAqU8lCZ0vWwEl4bdGsg: folds 
xx+iYCDJhHJmNzrfeloyEg: folds 
/MXkdT8TTs8Qp2LVTQNw6w: folds 
cezpHJ8FB07dj0xG+LhOvw: folds 
Uncalled bet ($2.25) returned to 32YL2ZEp8NT4JB2RVM9euQ
32YL2ZEp8NT4JB2RVM9euQ collected $3.75 from pot
32YL2ZEp8NT4JB2RVM9euQ: doesn't show hand 
*** SUMMARY ***
Total pot $3.75 | Rake $0 
Seat 1: cezpHJ8FB07dj0xG+LhOvw (button) folded before Flop
Seat 2: 32YL2ZEp8NT4JB2RVM9euQ (small blind) collected ($3.75)
Seat 3: JFIAqU8lCZ0vWwEl4bdGsg (big blind) folded before Flop
Seat 4: xx+iYCDJhHJmNzrfeloyEg folded before Flop
Seat 5: /MXkdT8TTs8Qp2LVTQNw6w folded before Flop
Seat 6: k9nHZTHt8hYhYRcW8NTb4g folded before Flop (didn't bet)




PokerStars Game #59941863974:  Hold'em No Limit ($0.10/$0.25) - 2009/07/01 1:48:34 ET
Table 'Ok3oDLIsTc2+KxPcI0bAOA' 6-max Seat #2 is the button
Seat 1: agQm3ugZ3qSVYNgNu1ddeA ($40.10 in chips) 
Seat 2: wPSNSp4HYtytRMXTu3oPSQ ($27.90 in chips) 
Seat 3: lquriepNQBhDV5P1SWHhnA ($36.20 in chips) 
Seat 4: LJI7A1YgDM7hgh7o56+ReQ ($34.05 in chips) 
Seat 5: DFi/Lzkjsfv8QswS80JX9Q ($30.10 in chips) 
Seat 6: Hsvkc0/G2VV78oVmWYXecw ($5.80 in chips) 
lquriepNQBhDV5P1SWHhnA: posts small blind $0.10
LJI7A1YgDM7hgh7o56+ReQ: posts big blind $0.25
*** HOLE CARDS ***
DFi/Lzkjsfv8QswS80JX9Q: folds 
Hsvkc0/G2VV78oVmWYXecw: folds 
agQm3ugZ3qSVYNgNu1ddeA: calls $0.25
wPSNSp4HYtytRMXTu3oPSQ: calls $0.25
lquriepNQBhDV5P1SWHhnA: calls $0.15
LJI7A1YgDM7hgh7o56+ReQ: checks 
*** FLOP *** [Jc Th 2c]
lquriepNQBhDV5P1SWHhnA: checks 
LJI7A1YgDM7hgh7o56+ReQ: checks 
agQm3ugZ3qSVYNgNu1ddeA: checks 
wPSNSp4HYtytRMXTu3oPSQ: checks 
*** TURN *** [Jc Th 2c] [Ks]
lquriepNQBhDV5P1SWHhnA: bets $0.75
LJI7A1YgDM7hgh7o56+ReQ: folds 
agQm3ugZ3qSVYNgNu1ddeA: folds 
wPSNSp4HYtytRMXTu3oPSQ: folds 
Uncalled bet ($0.75) returned to lquriepNQBhDV5P1SWHhnA
lquriepNQBhDV5P1SWHhnA collected $0.95 from pot
lquriepNQBhDV5P1SWHhnA: doesn't show hand 
*** SUMMARY ***
Total pot $1 | Rake $0.05 
Board [Jc Th 2c Ks]
Seat 1: agQm3ugZ3qSVYNgNu1ddeA folded on the Turn
Seat 2: wPSNSp4HYtytRMXTu3oPSQ (button) folded on the Turn
Seat 3: lquriepNQBhDV5P1SWHhnA (small blind) collected ($0.95)
Seat 4: LJI7A1YgDM7hgh7o56+ReQ (big blind) folded on the Turn
Seat 5: DFi/Lzkjsfv8QswS80JX9Q folded before Flop (didn't bet)
Seat 6: Hsvkc0/G2VV78oVmWYXecw folded before Flop (didn't bet)




PokerStars Game #59941863838:  Hold'em No Limit ($0.10/$0.25) - 2009/07/01 1:48:34 ET
Table 'hfHe8uKeSJMyWAjSdM7ROQ' 6-max Seat #6 is the button
Seat 1: eHsmIvAb2JREg4O6hNPnXg ($44.65 in chips) 
Seat 2: QvTX2yGq3uKJiKPmns4TKQ ($29.55 in chips) 
Seat 3: oAzQdB2jFOH1NxFUPjYUGg ($21.50 in chips) 
Seat 4: b4wRQV3APH8irVk6bUFe2Q ($27.80 in chips) 
Seat 5: euswrBD1XG0Q5hB1iGJBKQ ($60.80 in chips) 
Seat 6: eL3+wCBjFGfQ5FMdIZihwA ($24.65 in chips) 
eHsmIvAb2JREg4O6hNPnXg: posts small blind $0.10
QvTX2yGq3uKJiKPmns4TKQ: posts big blind $0.25
*** HOLE CARDS ***
oAzQdB2jFOH1NxFUPjYUGg: folds 
b4wRQV3APH8irVk6bUFe2Q: raises $0.50 to $0.75
oAzQdB2jFOH1NxFUPjYUGg leaves the table
euswrBD1XG0Q5hB1iGJBKQ: folds 
eL3+wCBjFGfQ5FMdIZihwA: raises $1.50 to $2.25
eHsmIvAb2JREg4O6hNPnXg: folds 
QvTX2yGq3uKJiKPmns4TKQ: folds 
b4wRQV3APH8irVk6bUFe2Q: calls $1.50
*** FLOP *** [4s Kd Ad]
dOX4wnYV2sEqvDbF+8KSCw joins the table at seat #3 
b4wRQV3APH8irVk6bUFe2Q: checks 
eL3+wCBjFGfQ5FMdIZihwA: bets $3.75
b4wRQV3APH8irVk6bUFe2Q: calls $3.75
*** TURN *** [4s Kd Ad] [4c]
b4wRQV3APH8irVk6bUFe2Q: checks 
eL3+wCBjFGfQ5FMdIZihwA: checks 
*** RIVER *** [4s Kd Ad 4c] [3c]
b4wRQV3APH8irVk6bUFe2Q: checks 
eL3+wCBjFGfQ5FMdIZihwA: checks 
*** SHOW DOWN ***
b4wRQV3APH8irVk6bUFe2Q: shows [Ac 5c] (two pair, Aces and Fours)
eL3+wCBjFGfQ5FMdIZihwA: mucks hand 
b4wRQV3APH8irVk6bUFe2Q collected $11.75 from pot
*** SUMMARY ***
Total pot $12.35 | Rake $0.60 
Board [4s Kd Ad 4c 3c]
Seat 1: eHsmIvAb2JREg4O6hNPnXg (small blind) folded before Flop
Seat 2: QvTX2yGq3uKJiKPmns4TKQ (big blind) folded before Flop
Seat 3: oAzQdB2jFOH1NxFUPjYUGg folded before Flop (didn't bet)
Seat 4: b4wRQV3APH8irVk6bUFe2Q showed [Ac 5c] and won ($11.75) with two pair, Aces and Fours
Seat 5: euswrBD1XG0Q5hB1iGJBKQ folded before Flop (didn't bet)
Seat 6: eL3+wCBjFGfQ5FMdIZihwA (button) mucked




PokerStars Game #59941864046:  Hold'em No Limit ($0.10/$0.25) - 2009/07/01 1:48:34 ET
Table 'yAHDCs33TIgw3ra63xuU2Q' 9-max Seat #2 is the button
Seat 2: j4q3p0lesp63b1gZDwLBZw ($5 in chips) 
Seat 3: g6UPjSyxNLffCi+EqqIlEg ($20.40 in chips) 
Seat 4: j5spkbnOCRiLGiH6iqBaqw ($8.80 in chips) 
Seat 5: 4awUyiDYTgylQKXZ9faBVA ($38.35 in chips) 
Seat 6: DnDcAdn9P0zGovMERigpFA ($26.30 in chips) 
Seat 9: MtVtHDqIJTyUcXkRBBDIVA ($25 in chips) 
g6UPjSyxNLffCi+EqqIlEg: posts small blind $0.10
j5spkbnOCRiLGiH6iqBaqw: posts big blind $0.25
*** HOLE CARDS ***
4awUyiDYTgylQKXZ9faBVA: folds 
DnDcAdn9P0zGovMERigpFA: folds 
MtVtHDqIJTyUcXkRBBDIVA: folds 
j4q3p0lesp63b1gZDwLBZw: folds 
g6UPjSyxNLffCi+EqqIlEg: calls $0.15
PCA4x6k6ozLkTt7qDUqp7w joins the table at seat #8 
j5spkbnOCRiLGiH6iqBaqw: checks 
*** FLOP *** [Ad Kh 5c]
g6UPjSyxNLffCi+EqqIlEg: bets $0.25
j5spkbnOCRiLGiH6iqBaqw: calls $0.25
*** TURN *** [Ad Kh 5c] [Jd]
g6UPjSyxNLffCi+EqqIlEg: bets $0.75
Z9AeOQX3yzuSvKAm/xyovg joins the table at seat #1 
j5spkbnOCRiLGiH6iqBaqw: calls $0.75
*** RIVER *** [Ad Kh 5c Jd] [Th]
g6UPjSyxNLffCi+EqqIlEg: bets $1.50
j5spkbnOCRiLGiH6iqBaqw: calls $1.50
*** SHOW DOWN ***
g6UPjSyxNLffCi+EqqIlEg: shows [6h 3s] (high card Ace)
j5spkbnOCRiLGiH6iqBaqw: shows [Tc Qs] (a straight, Ten to Ace)
j5spkbnOCRiLGiH6iqBaqw collected $5.25 from pot
*** SUMMARY ***
Total pot $5.50 | Rake $0.25 
Board [Ad Kh 5c Jd Th]
Seat 2: j4q3p0lesp63b1gZDwLBZw (button) folded before Flop (didn't bet)
Seat 3: g6UPjSyxNLffCi+EqqIlEg (small blind) showed [6h 3s] and lost with high card Ace
Seat 4: j5spkbnOCRiLGiH6iqBaqw (big blind) showed [Tc Qs] and won ($5.25) with a straight, Ten to Ace
Seat 5: 4awUyiDYTgylQKXZ9faBVA folded before Flop (didn't bet)
Seat 6: DnDcAdn9P0zGovMERigpFA folded before Flop (didn't bet)
Seat 9: MtVtHDqIJTyUcXkRBBDIVA folded before Flop (didn't bet)




PokerStars Game #59941863554:  Hold'em No Limit ($0.10/$0.25) - 2009/07/01 1:48:34 ET
Table 'IfRHUn9gQQA9I/Z4tn+BoA' 9-max Seat #8 is the button
Seat 1: imHPFFqvfHGzsBBWeGuy4w ($23.85 in chips) 
Seat 2: VWUWpMLMj/Q1jRVpF7Aohw ($16.95 in chips) 
Seat 4: QEbIGci+itdw+re8RM5fZA ($35.50 in chips) 
Seat 5: DdPXdieucQ+n99u1n3A+rQ ($5 in chips) 
Seat 6: UOjoGGQ58/uDS7V0xkjOrQ ($24.65 in chips) 
Seat 7: YzqSxP03XxZPbgPifgt69g ($28.75 in chips) 
Seat 8: cZ99hugmLBj9KhTlc8nCSw ($27.75 in chips) 
18G4P1XstjNvItdGUITxgw will be allowed to play after the button
imHPFFqvfHGzsBBWeGuy4w: posts small blind $0.10
VWUWpMLMj/Q1jRVpF7Aohw: posts big blind $0.25
*** HOLE CARDS ***
QEbIGci+itdw+re8RM5fZA: folds 
DdPXdieucQ+n99u1n3A+rQ: folds 
UOjoGGQ58/uDS7V0xkjOrQ: raises $0.25 to $0.50
YzqSxP03XxZPbgPifgt69g: folds 
cZ99hugmLBj9KhTlc8nCSw: folds 
imHPFFqvfHGzsBBWeGuy4w: folds 
VWUWpMLMj/Q1jRVpF7Aohw: calls $0.25
*** FLOP *** [Kh 4d 8h]
VWUWpMLMj/Q1jRVpF7Aohw: checks 
UOjoGGQ58/uDS7V0xkjOrQ: bets $0.25
VWUWpMLMj/Q1jRVpF7Aohw: folds 
Uncalled bet ($0.25) returned to UOjoGGQ58/uDS7V0xkjOrQ
4qA/3Ajg3pP6fqW+IX9/fQ joins the table at seat #3 
UOjoGGQ58/uDS7V0xkjOrQ collected $1.05 from pot
UOjoGGQ58/uDS7V0xkjOrQ: doesn't show hand 
*** SUMMARY ***
Total pot $1.10 | Rake $0.05 
Board [Kh 4d 8h]
Seat 1: imHPFFqvfHGzsBBWeGuy4w (small blind) folded before Flop
Seat 2: VWUWpMLMj/Q1jRVpF7Aohw (big blind) folded on the Flop
Seat 4: QEbIGci+itdw+re8RM5fZA folded before Flop (didn't bet)
Seat 5: DdPXdieucQ+n99u1n3A+rQ folded before Flop (didn't bet)
Seat 6: UOjoGGQ58/uDS7V0xkjOrQ collected ($1.05)
Seat 7: YzqSxP03XxZPbgPifgt69g folded before Flop (didn't bet)
Seat 8: cZ99hugmLBj9KhTlc8nCSw (button) folded before Flop (didn't bet)




PokerStars Game #59941863648:  Hold'em No Limit ($0.10/$0.25) - 2009/07/01 1:48:34 ET
Table '50f2Xa1b1jp6cfdTAgXFIg' 9-max Seat #3 is the button
Seat 1: E0iYnEVO2ho7dH3QcCjw7g ($19.65 in chips) 
Seat 3: RSojRXQHk0IRANbJYopT9g ($23.75 in chips) 
Seat 4: ghNKXUBl/H+t83JF079ZBA ($27.10 in chips) 
Seat 5: C1w4aCCgQVVSgNijoEahAg ($16.75 in chips) 
Seat 6: tLcDklc2rBORNfixyRfVfw ($27.50 in chips) 
Seat 7: w1ukf8uPa4+WH561TtVRxA ($25 in chips) 
Seat 8: x+W5+3qsdY4Iszf0hoH+Aw ($14.55 in chips) 
Seat 9: gehe91e0IyVT0QU/XBkEyg ($25 in chips) 
ghNKXUBl/H+t83JF079ZBA: posts small blind $0.10
C1w4aCCgQVVSgNijoEahAg: posts big blind $0.25
*** HOLE CARDS ***
tLcDklc2rBORNfixyRfVfw: folds 
w1ukf8uPa4+WH561TtVRxA: folds 
x+W5+3qsdY4Iszf0hoH+Aw: raises $0.50 to $0.75
gehe91e0IyVT0QU/XBkEyg: calls $0.75
E0iYnEVO2ho7dH3QcCjw7g: folds 
RSojRXQHk0IRANbJYopT9g: calls $0.75
ghNKXUBl/H+t83JF079ZBA: folds 
C1w4aCCgQVVSgNijoEahAg: calls $0.50
*** FLOP *** [2c Ad Ac]
C1w4aCCgQVVSgNijoEahAg: checks 
x+W5+3qsdY4Iszf0hoH+Aw: checks 
gehe91e0IyVT0QU/XBkEyg: checks 
RSojRXQHk0IRANbJYopT9g: bets $0.25
C1w4aCCgQVVSgNijoEahAg: calls $0.25
x+W5+3qsdY4Iszf0hoH+Aw: folds 
gehe91e0IyVT0QU/XBkEyg: calls $0.25
*** TURN *** [2c Ad Ac] [4d]
C1w4aCCgQVVSgNijoEahAg: checks 
gehe91e0IyVT0QU/XBkEyg: checks 
RSojRXQHk0IRANbJYopT9g: bets $0.50
C1w4aCCgQVVSgNijoEahAg: calls $0.50
gehe91e0IyVT0QU/XBkEyg: raises $2 to $2.50
RSojRXQHk0IRANbJYopT9g: calls $2
C1w4aCCgQVVSgNijoEahAg: folds 
*** RIVER *** [2c Ad Ac 4d] [2s]
gehe91e0IyVT0QU/XBkEyg: bets $5
RSojRXQHk0IRANbJYopT9g: calls $5
*** SHOW DOWN ***
gehe91e0IyVT0QU/XBkEyg: shows [Jh Ah] (a full house, Aces full of Deuces)
RSojRXQHk0IRANbJYopT9g: shows [As 9s] (a full house, Aces full of Deuces)
gehe91e0IyVT0QU/XBkEyg collected $9.25 from pot
RSojRXQHk0IRANbJYopT9g collected $9.20 from pot
*** SUMMARY ***
Total pot $19.35 | Rake $0.90 
Board [2c Ad Ac 4d 2s]
Seat 1: E0iYnEVO2ho7dH3QcCjw7g folded before Flop (didn't bet)
Seat 3: RSojRXQHk0IRANbJYopT9g (button) showed [As 9s] and won ($9.20) with a full house, Aces full of Deuces
Seat 4: ghNKXUBl/H+t83JF079ZBA (small blind) folded before Flop
Seat 5: C1w4aCCgQVVSgNijoEahAg (big blind) folded on the Turn
Seat 6: tLcDklc2rBORNfixyRfVfw folded before Flop (didn't bet)
Seat 7: w1ukf8uPa4+WH561TtVRxA folded before Flop (didn't bet)
Seat 8: x+W5+3qsdY4Iszf0hoH+Aw folded on the Flop
Seat 9: gehe91e0IyVT0QU/XBkEyg showed [Jh Ah] and won ($9.25) with a full house, Aces full of Deuces




PokerStars Game #59941863834:  Hold'em No Limit ($0.10/$0.25) - 2009/07/01 1:48:34 ET
Table 'aisAlB9GIV21BwfUW3+Nbg' 9-max Seat #6 is the button
Seat 1: SqibpGx+lf+brY0fJVvD0w ($24.85 in chips) 
Seat 3: CvL9Ch1HYCVbTsfpNucitg ($4.55 in chips) 
Seat 4: sD+TKtt36XiiN6jqHiLwDA ($25.10 in chips) 
Seat 5: ghNKXUBl/H+t83JF079ZBA ($25.90 in chips) 
Seat 6: 9gmYYQesalMrUjaF7nKfrQ ($15.85 in chips) 
Seat 7: jGjM+5lCSe6f2MEwxQGOAg ($22.60 in chips) 
Seat 8: VWUWpMLMj/Q1jRVpF7Aohw ($26.30 in chips) 
Seat 9: N0hGpTAEAj9k5msS6LPLAw ($20.60 in chips) 
jGjM+5lCSe6f2MEwxQGOAg: posts small blind $0.10
VWUWpMLMj/Q1jRVpF7Aohw: posts big blind $0.25
*** HOLE CARDS ***
N0hGpTAEAj9k5msS6LPLAw: folds 
SqibpGx+lf+brY0fJVvD0w: folds 
CvL9Ch1HYCVbTsfpNucitg: folds 
sD+TKtt36XiiN6jqHiLwDA: calls $0.25
ghNKXUBl/H+t83JF079ZBA: raises $1 to $1.25
9gmYYQesalMrUjaF7nKfrQ: folds 
jGjM+5lCSe6f2MEwxQGOAg: folds 
VWUWpMLMj/Q1jRVpF7Aohw: folds 
sD+TKtt36XiiN6jqHiLwDA: calls $1
*** FLOP *** [3c 6s 5s]
sD+TKtt36XiiN6jqHiLwDA: checks 
ghNKXUBl/H+t83JF079ZBA: bets $1.75
sD+TKtt36XiiN6jqHiLwDA: folds 
Uncalled bet ($1.75) returned to ghNKXUBl/H+t83JF079ZBA
ghNKXUBl/H+t83JF079ZBA collected $2.75 from pot
ghNKXUBl/H+t83JF079ZBA: doesn't show hand 
*** SUMMARY ***
Total pot $2.85 | Rake $0.10 
Board [3c 6s 5s]
Seat 1: SqibpGx+lf+brY0fJVvD0w folded before Flop (didn't bet)
Seat 3: CvL9Ch1HYCVbTsfpNucitg folded before Flop (didn't bet)
Seat 4: sD+TKtt36XiiN6jqHiLwDA folded on the Flop
Seat 5: ghNKXUBl/H+t83JF079ZBA collected ($2.75)
Seat 6: 9gmYYQesalMrUjaF7nKfrQ (button) folded before Flop (didn't bet)
Seat 7: jGjM+5lCSe6f2MEwxQGOAg (small blind) folded before Flop
Seat 8: VWUWpMLMj/Q1jRVpF7Aohw (big blind) folded before Flop
Seat 9: N0hGpTAEAj9k5msS6LPLAw folded before Flop (didn't bet)




PokerStars Game #59941863898:  Hold'em No Limit ($0.10/$0.25) - 2009/07/01 1:48:34 ET
Table 'nc6OeGk/wtaWV+6N+kgnZQgZetDqJh6q9A3mLO3ThCsASeat #4 is the button
Seat 1: DihMHaz4WNETH1bPDe13kA ($25 in chips) 
Seat 2: JFIAqU8lCZ0vWwEl4bdGsg ($35.20 in chips) 
Seat 3: jp34e617tIzV8tKIWmfAbA ($33.80 in chips) 
Seat 4: BV+K0Phf5VBHr7aZPKqbUQ ($29.60 in chips) 
Seat 6: Mhj3q7cxev+XjXZxEE6/Cw ($25 in chips) 
Mhj3q7cxev+XjXZxEE6/Cw: posts small blind $0.10
DihMHaz4WNETH1bPDe13kA: posts big blind $0.25
*** HOLE CARDS ***
SxIIgwXYLkwd6m3wLyPTCw joins the table at seat #5 
JFIAqU8lCZ0vWwEl4bdGsg: folds 
jp34e617tIzV8tKIWmfAbA: raises $0.50 to $0.75
BV+K0Phf5VBHr7aZPKqbUQ: folds 
Mhj3q7cxev+XjXZxEE6/Cw: calls $0.65
DihMHaz4WNETH1bPDe13kA: folds 
*** FLOP *** [3d Qs 2c]
Mhj3q7cxev+XjXZxEE6/Cw: checks 
jp34e617tIzV8tKIWmfAbA: checks 
*** TURN *** [3d Qs 2c] [9s]
Mhj3q7cxev+XjXZxEE6/Cw: checks 
jp34e617tIzV8tKIWmfAbA: bets $1.25
Mhj3q7cxev+XjXZxEE6/Cw: folds 
Uncalled bet ($1.25) returned to jp34e617tIzV8tKIWmfAbA
jp34e617tIzV8tKIWmfAbA collected $1.70 from pot
*** SUMMARY ***
Total pot $1.75 | Rake $0.05 
Board [3d Qs 2c 9s]
Seat 1: DihMHaz4WNETH1bPDe13kA (big blind) folded before Flop
Seat 2: JFIAqU8lCZ0vWwEl4bdGsg folded before Flop (didn't bet)
Seat 3: jp34e617tIzV8tKIWmfAbA collected ($1.70)
Seat 4: BV+K0Phf5VBHr7aZPKqbUQ (button) folded before Flop (didn't bet)
Seat 6: Mhj3q7cxev+XjXZxEE6/Cw (small blind) folded on the Turn




PokerStars Game #59941863848:  Hold'em No Limit ($0.10/$0.25) - 2009/07/01 1:48:34 ET
Table 'FE/j6VqBY4j9Uq+VHURQCQ' 6-max Seat #3 is the button
Seat 1: ypmjhffk/YHGc51wgVXUTw ($41.65 in chips) 
Seat 2: 3zD3qLXT1bEffAoWGnc7wg ($36.75 in chips) 
Seat 3: lBoEwOFgzcERLIRUkUoRTw ($27.50 in chips) 
Seat 4: 7JyPCA0J2grhXQYxe1h3+A ($7.20 in chips) 
Seat 5: bJFzs6QmEEnz4miMfSDtcg ($14.75 in chips) 
7JyPCA0J2grhXQYxe1h3+A: posts small blind $0.10
bJFzs6QmEEnz4miMfSDtcg: posts big blind $0.25
Q1uciOZPBR/WkAlqa6cL4A: sits out 
*** HOLE CARDS ***
ypmjhffk/YHGc51wgVXUTw: raises $0.50 to $0.75
3zD3qLXT1bEffAoWGnc7wg: folds 
lBoEwOFgzcERLIRUkUoRTw: folds 
7JyPCA0J2grhXQYxe1h3+A: folds 
bJFzs6QmEEnz4miMfSDtcg: calls $0.50
*** FLOP *** [Jh 8s Tc]
bJFzs6QmEEnz4miMfSDtcg: checks 
ypmjhffk/YHGc51wgVXUTw: bets $1.25
bJFzs6QmEEnz4miMfSDtcg: raises $1.75 to $3
ypmjhffk/YHGc51wgVXUTw: folds 
Uncalled bet ($1.75) returned to bJFzs6QmEEnz4miMfSDtcg
bJFzs6QmEEnz4miMfSDtcg collected $3.90 from pot
*** SUMMARY ***
Total pot $4.10 | Rake $0.20 
Board [Jh 8s Tc]
Seat 1: ypmjhffk/YHGc51wgVXUTw folded on the Flop
Seat 2: 3zD3qLXT1bEffAoWGnc7wg folded before Flop (didn't bet)
Seat 3: lBoEwOFgzcERLIRUkUoRTw (button) folded before Flop (didn't bet)
Seat 4: 7JyPCA0J2grhXQYxe1h3+A (small blind) folded before Flop
Seat 5: bJFzs6QmEEnz4miMfSDtcg (big blind) collected ($3.90)




PokerStars Game #59941863808:  Hold'em No Limit ($0.10/$0.25) - 2009/07/01 1:48:34 ET
Table 'z2yOdY2zyGWG1gh9WV9XtQdYNvO8G5kw5SRxb1Dljhog Seat #4 is the button
Seat 1: vSkQm2EelzwRGDDQQk0Fqw ($17.30 in chips) 
Seat 2: PkBmevN3LdXkPj1LHOoTnQ ($1.35 in chips) 
Seat 3: 1Cs1GyQcoM1omwY7XZ3uRg ($12 in chips) 
Seat 4: sD+TKtt36XiiN6jqHiLwDA ($28.10 in chips) 
Seat 5: W7XGvw6ngGVq2hFwXk8Myg ($26.10 in chips) 
Seat 6: 22dIObOuor/A+IKWkNoAlA ($7.80 in chips) 
Seat 7: DiSvPC2iudwL5j9u6Huyww ($39.75 in chips) 
Seat 8: 5hAPbqNrvJb8PtLiceXtlg6HoFYfVGBefsR5Vrz62qIw0 in chips) 
Seat 9: PdIasPkzm2sqZnN41ZRXOg ($5 in chips) 
W7XGvw6ngGVq2hFwXk8Myg: posts small blind $0.10
22dIObOuor/A+IKWkNoAlA: posts big blind $0.25
*** HOLE CARDS ***
DiSvPC2iudwL5j9u6Huyww: folds 
5hAPbqNrvJb8PtLiceXtlg6HoFYfVGBefsR5Vrz62qIwlds 
PdIasPkzm2sqZnN41ZRXOg: folds 
vSkQm2EelzwRGDDQQk0Fqw: folds 
PkBmevN3LdXkPj1LHOoTnQ: folds 
1Cs1GyQcoM1omwY7XZ3uRg: folds 
sD+TKtt36XiiN6jqHiLwDA: folds 
W7XGvw6ngGVq2hFwXk8Myg: calls $0.15
22dIObOuor/A+IKWkNoAlA: raises $1 to $1.25
W7XGvw6ngGVq2hFwXk8Myg: folds 
Uncalled bet ($1) returned to 22dIObOuor/A+IKWkNoAlA
22dIObOuor/A+IKWkNoAlA collected $0.50 from pot
22dIObOuor/A+IKWkNoAlA: doesn't show hand 
*** SUMMARY ***
Total pot $0.50 | Rake $0 
Seat 1: vSkQm2EelzwRGDDQQk0Fqw folded before Flop (didn't bet)
Seat 2: PkBmevN3LdXkPj1LHOoTnQ folded before Flop (didn't bet)
Seat 3: 1Cs1GyQcoM1omwY7XZ3uRg folded before Flop (didn't bet)
Seat 4: sD+TKtt36XiiN6jqHiLwDA (button) folded before Flop (didn't bet)
Seat 5: W7XGvw6ngGVq2hFwXk8Myg (small blind) folded before Flop
Seat 6: 22dIObOuor/A+IKWkNoAlA (big blind) collected ($0.50)
Seat 7: DiSvPC2iudwL5j9u6Huyww folded before Flop (didn't bet)
Seat 8: 5hAPbqNrvJb8PtLiceXtlg6HoFYfVGBefsR5Vrz62qIwded before Flop (didn't bet)
Seat 9: PdIasPkzm2sqZnN41ZRXOg folded before Flop (didn't bet)




PokerStars Game #59941864590:  Hold'em No Limit ($0.10/$0.25) - 2009/07/01 1:48:35 ET
Table 'LwnjzXstPtSrqrV/oDpnXQ' 9-max Seat #7 is the button
Seat 1: 9YN2IkT2JYYKFErZtZvCtA ($21.20 in chips) 
Seat 2: uLP/lYn7oKq9xCChBXsXxw ($26.65 in chips) 
Seat 3: 7je+LC5Mfs6nL8YBVh4frQ ($3.80 in chips) 
Seat 4: CmngQmkKTp8tkl6GMRTl6w ($8.75 in chips) 
Seat 5: Th3FldXKQW6hWVVPahaoOQ ($26.25 in chips) 
Seat 6: ljemhp25Zg+nlA9DLCIiUw ($39.50 in chips) 
Seat 7: c/Dw/6HyqldTzIRodAIZmg ($13.40 in chips) 
Seat 8: ShXPHWfjhfmAwLgDdm6bRQ ($13.05 in chips) 
Seat 9: q6WfTUAD9mowIP63ASq2Dgz/khFDKGihQjwgoiKKPOeg65 in chips) 
ShXPHWfjhfmAwLgDdm6bRQ: posts small blind $0.10
q6WfTUAD9mowIP63ASq2Dgz/khFDKGihQjwgoiKKPOegs big blind $0.25
*** HOLE CARDS ***
9YN2IkT2JYYKFErZtZvCtA: folds 
uLP/lYn7oKq9xCChBXsXxw: folds 
7je+LC5Mfs6nL8YBVh4frQ: folds 
CmngQmkKTp8tkl6GMRTl6w: folds 
Th3FldXKQW6hWVVPahaoOQ: folds 
ljemhp25Zg+nlA9DLCIiUw: folds 
c/Dw/6HyqldTzIRodAIZmg: folds 
ShXPHWfjhfmAwLgDdm6bRQ: calls $0.15
q6WfTUAD9mowIP63ASq2Dgz/khFDKGihQjwgoiKKPOeges $0.50 to $0.75
ShXPHWfjhfmAwLgDdm6bRQ: calls $0.50
*** FLOP *** [Th 7d As]
ShXPHWfjhfmAwLgDdm6bRQ: checks 
q6WfTUAD9mowIP63ASq2Dgz/khFDKGihQjwgoiKKPOeg $0.25
ShXPHWfjhfmAwLgDdm6bRQ: raises $0.75 to $1
q6WfTUAD9mowIP63ASq2Dgz/khFDKGihQjwgoiKKPOeges $22.90 to $23.90 and is all-in
ShXPHWfjhfmAwLgDdm6bRQ: folds 
Uncalled bet ($22.90) returned to q6WfTUAD9mowIP63ASq2Dgz/khFDKGihQjwgoiKKPOegq6WfTUAD9mowIP63ASq2Dgt collected $3.35 from pot
q6WfTUAD9mowIP63ASq2Dgz/khFDKGihQjwgoiKKPOegn't show hand 
*** SUMMARY ***
Total pot $3.50 | Rake $0.15 
Board [Th 7d As]
Seat 1: 9YN2IkT2JYYKFErZtZvCtA folded before Flop (didn't bet)
Seat 2: uLP/lYn7oKq9xCChBXsXxw folded before Flop (didn't bet)
Seat 3: 7je+LC5Mfs6nL8YBVh4frQ folded before Flop (didn't bet)
Seat 4: CmngQmkKTp8tkl6GMRTl6w folded before Flop (didn't bet)
Seat 5: Th3FldXKQW6hWVVPahaoOQ folded before Flop (didn't bet)
Seat 6: ljemhp25Zg+nlA9DLCIiUw folded before Flop (didn't bet)
Seat 7: c/Dw/6HyqldTzIRodAIZmg (button) folded before Flop (didn't bet)
Seat 8: ShXPHWfjhfmAwLgDdm6bRQ (small blind) folded on the Flop
Seat 9: q6WfTUAD9mowIP63ASq2Dgz/khFDKGihQjwgoiKKPOegblind) collected ($3.35)




PokerStars Game #59941864470:  Hold'em No Limit ($0.10/$0.25) - 2009/07/01 1:48:35 ET
Table 'by7aHYEDnDd144EXOXa/jA' 9-max Seat #5 is the button
Seat 1: j4q3p0lesp63b1gZDwLBZw ($7.65 in chips) 
Seat 2: vSkQm2EelzwRGDDQQk0Fqw ($8.90 in chips) 
Seat 3: HOEaXncFu2ij+D5/CANAZA ($11.90 in chips) 
Seat 4: 2Xwi447v1rBHM+92U0CduA ($4.40 in chips) 
Seat 5: yyG4svzOpC1A+sUP/scg6w ($3.85 in chips) 
Seat 6: sC4BsflLWW26Qm9m+1AwJQ ($10.65 in chips) 
Seat 7: Z9W7+g1WMhhZDi7DwGbCFA ($5 in chips) 
Seat 8: 7je+LC5Mfs6nL8YBVh4frQ ($3.50 in chips) 
Seat 9: K0b5wNInj6hUGRr6yzKFtw ($25.05 in chips) 
sC4BsflLWW26Qm9m+1AwJQ: posts small blind $0.10
Z9W7+g1WMhhZDi7DwGbCFA: posts big blind $0.25
*** HOLE CARDS ***
7je+LC5Mfs6nL8YBVh4frQ: folds 
K0b5wNInj6hUGRr6yzKFtw: folds 
j4q3p0lesp63b1gZDwLBZw: folds 
vSkQm2EelzwRGDDQQk0Fqw: folds 
HOEaXncFu2ij+D5/CANAZA: folds 
2Xwi447v1rBHM+92U0CduA: folds 
yyG4svzOpC1A+sUP/scg6w: folds 
sC4BsflLWW26Qm9m+1AwJQ: calls $0.15
Z9W7+g1WMhhZDi7DwGbCFA: checks 
*** FLOP *** [Ah 3s 8s]
sC4BsflLWW26Qm9m+1AwJQ: bets $0.25
Z9W7+g1WMhhZDi7DwGbCFA: calls $0.25
*** TURN *** [Ah 3s 8s] [Qd]
sC4BsflLWW26Qm9m+1AwJQ: checks 
Z9W7+g1WMhhZDi7DwGbCFA: checks 
*** RIVER *** [Ah 3s 8s Qd] [2d]
sC4BsflLWW26Qm9m+1AwJQ: checks 
Z9W7+g1WMhhZDi7DwGbCFA: bets $0.50
sC4BsflLWW26Qm9m+1AwJQ: folds 
Uncalled bet ($0.50) returned to Z9W7+g1WMhhZDi7DwGbCFA
Z9W7+g1WMhhZDi7DwGbCFA collected $0.95 from pot
Z9W7+g1WMhhZDi7DwGbCFA: doesn't show hand 
*** SUMMARY ***
Total pot $1 | Rake $0.05 
Board [Ah 3s 8s Qd 2d]
Seat 1: j4q3p0lesp63b1gZDwLBZw folded before Flop (didn't bet)
Seat 2: vSkQm2EelzwRGDDQQk0Fqw folded before Flop (didn't bet)
Seat 3: HOEaXncFu2ij+D5/CANAZA folded before Flop (didn't bet)
Seat 4: 2Xwi447v1rBHM+92U0CduA folded before Flop (didn't bet)
Seat 5: yyG4svzOpC1A+sUP/scg6w (button) folded before Flop (didn't bet)
Seat 6: sC4BsflLWW26Qm9m+1AwJQ (small blind) folded on the River
Seat 7: Z9W7+g1WMhhZDi7DwGbCFA (big blind) collected ($0.95)
Seat 8: 7je+LC5Mfs6nL8YBVh4frQ folded before Flop (didn't bet)
Seat 9: K0b5wNInj6hUGRr6yzKFtw folded before Flop (didn't bet)




PokerStars Game #59941864200:  Hold'em No Limit ($0.10/$0.25) - 2009/07/01 1:48:35 ET
Table 'nB7Q7zfNfy6ig6DB+rsgWQ' 6-max Seat #2 is the button
Seat 1: Hzy03WtPHMYwLYM7hTTxQw ($22.25 in chips) 
Seat 2: 4BHo0wlX9INjkj2727qE0w ($25 in chips) 
Seat 3: p3NYOxYhkL7txPRSeXHDeg ($32.35 in chips) 
Seat 4: DihMHaz4WNETH1bPDe13kA ($80.10 in chips) 
Seat 5: xC0kaiDYM6YTlgODL83O5A ($16.65 in chips) 
Seat 6: MEGIwX0eHRUj63lwYaNhVg ($7.95 in chips) 
p3NYOxYhkL7txPRSeXHDeg: posts small blind $0.10
DihMHaz4WNETH1bPDe13kA: posts big blind $0.25
*** HOLE CARDS ***
xC0kaiDYM6YTlgODL83O5A: folds 
MEGIwX0eHRUj63lwYaNhVg: folds 
Hzy03WtPHMYwLYM7hTTxQw: folds 
4BHo0wlX9INjkj2727qE0w: calls $0.25
p3NYOxYhkL7txPRSeXHDeg: folds 
DihMHaz4WNETH1bPDe13kA: raises $1 to $1.25
4BHo0wlX9INjkj2727qE0w: folds 
Uncalled bet ($1) returned to DihMHaz4WNETH1bPDe13kA
DihMHaz4WNETH1bPDe13kA collected $0.60 from pot
*** SUMMARY ***
Total pot $0.60 | Rake $0 
Seat 1: Hzy03WtPHMYwLYM7hTTxQw folded before Flop (didn't bet)
Seat 2: 4BHo0wlX9INjkj2727qE0w (button) folded before Flop
Seat 3: p3NYOxYhkL7txPRSeXHDeg (small blind) folded before Flop
Seat 4: DihMHaz4WNETH1bPDe13kA (big blind) collected ($0.60)
Seat 5: xC0kaiDYM6YTlgODL83O5A folded before Flop (didn't bet)
Seat 6: MEGIwX0eHRUj63lwYaNhVg folded before Flop (didn't bet)




PokerStars Game #59941864110:  Hold'em No Limit ($0.10/$0.25) - 2009/07/01 1:48:35 ET
Table 'vFZR6Kf2Th5xBXT9brGW6A' 6-max Seat #1 is the button
Seat 1: Q1uciOZPBR/WkAlqa6cL4A ($25 in chips) 
Seat 2: QiL+lEgEWwy21jk/ltaRLg ($20.55 in chips) 
Seat 3: SH1WjKVUjPiyXySjWSdazw ($41.65 in chips) 
Seat 4: 79ID/ub1Pt/mDpCprVmOoA ($34.85 in chips) 
Seat 5: SS/yfeArhULzIcOPe8MdPg ($27.35 in chips) 
Seat 6: 4x9jCqgSw4272dnaIqnanw ($10.55 in chips) 
QiL+lEgEWwy21jk/ltaRLg: posts small blind $0.10
SH1WjKVUjPiyXySjWSdazw: posts big blind $0.25
*** HOLE CARDS ***
79ID/ub1Pt/mDpCprVmOoA: folds 
SS/yfeArhULzIcOPe8MdPg: folds 
4x9jCqgSw4272dnaIqnanw: folds 
Q1uciOZPBR/WkAlqa6cL4A: folds 
QiL+lEgEWwy21jk/ltaRLg: calls $0.15
SH1WjKVUjPiyXySjWSdazw: checks 
*** FLOP *** [4c 6h Kh]
QiL+lEgEWwy21jk/ltaRLg: bets $0.25
SH1WjKVUjPiyXySjWSdazw: folds 
Uncalled bet ($0.25) returned to QiL+lEgEWwy21jk/ltaRLg
QiL+lEgEWwy21jk/ltaRLg collected $0.50 from pot
*** SUMMARY ***
Total pot $0.50 | Rake $0 
Board [4c 6h Kh]
Seat 1: Q1uciOZPBR/WkAlqa6cL4A (button) folded before Flop (didn't bet)
Seat 2: QiL+lEgEWwy21jk/ltaRLg (small blind) collected ($0.50)
Seat 3: SH1WjKVUjPiyXySjWSdazw (big blind) folded on the Flop
Seat 4: 79ID/ub1Pt/mDpCprVmOoA folded before Flop (didn't bet)
Seat 5: SS/yfeArhULzIcOPe8MdPg folded before Flop (didn't bet)
Seat 6: 4x9jCqgSw4272dnaIqnanw folded before Flop (didn't bet)




PokerStars Game #59941864462:  Hold'em No Limit ($0.10/$0.25) - 2009/07/01 1:48:35 ET
Table 'MRfAiS/4JSfnUDlCcZo0wAhfHe8uKeSJMyWAjSdM7ROQx Seat #4 is the button
Seat 1: 48oT5xFI+5CHUJlfoGrE4w ($29.90 in chips) 
Seat 2: /gJNBeCkWL4o85/jvlZ4BA ($28.85 in chips) 
Seat 3: FYepjhAvF8ZdVCmqHIy+eQ ($38.85 in chips) 
Seat 4: b4wRQV3APH8irVk6bUFe2Q ($36.60 in chips) 
Seat 5: Q1uciOZPBR/WkAlqa6cL4A ($25.35 in chips) 
Seat 6: df01R5ThvHspD8FgKmaDvQ ($25.35 in chips) 
Q1uciOZPBR/WkAlqa6cL4A: posts small blind $0.10
df01R5ThvHspD8FgKmaDvQ: posts big blind $0.25
*** HOLE CARDS ***
48oT5xFI+5CHUJlfoGrE4w: folds 
/gJNBeCkWL4o85/jvlZ4BA: raises $0.75 to $1
FYepjhAvF8ZdVCmqHIy+eQ: folds 
b4wRQV3APH8irVk6bUFe2Q: folds 
Q1uciOZPBR/WkAlqa6cL4A: calls $0.90
df01R5ThvHspD8FgKmaDvQ: folds 
*** FLOP *** [3c 7d 6h]
Q1uciOZPBR/WkAlqa6cL4A: checks 
/gJNBeCkWL4o85/jvlZ4BA: bets $1.50
Q1uciOZPBR/WkAlqa6cL4A: calls $1.50
*** TURN *** [3c 7d 6h] [5h]
Q1uciOZPBR/WkAlqa6cL4A: bets $3
/gJNBeCkWL4o85/jvlZ4BA: folds 
Uncalled bet ($3) returned to Q1uciOZPBR/WkAlqa6cL4A
Q1uciOZPBR/WkAlqa6cL4A collected $5 from pot
Q1uciOZPBR/WkAlqa6cL4A: doesn't show hand 
*** SUMMARY ***
Total pot $5.25 | Rake $0.25 
Board [3c 7d 6h 5h]
Seat 1: 48oT5xFI+5CHUJlfoGrE4w folded before Flop (didn't bet)
Seat 2: /gJNBeCkWL4o85/jvlZ4BA folded on the Turn
Seat 3: FYepjhAvF8ZdVCmqHIy+eQ folded before Flop (didn't bet)
Seat 4: b4wRQV3APH8irVk6bUFe2Q (button) folded before Flop (didn't bet)
Seat 5: Q1uciOZPBR/WkAlqa6cL4A (small blind) collected ($5)
Seat 6: df01R5ThvHspD8FgKmaDvQ (big blind) folded before Flop




PokerStars Game #59941864132:  Hold'em No Limit ($0.10/$0.25) - 2009/07/01 1:48:35 ET
Table 'NtEQAxCeIK2io1CGtW658g' 6-max Seat #2 is the button
Seat 1: X437kMQ7AujoaDgjguhU9w ($11.55 in chips) 
Seat 2: DgyznDqq/mLiCqQGMzc+Aw ($9.65 in chips) 
Seat 3: 5nwDw10uIM0XEyLhla0oGA ($24.20 in chips) 
Seat 4: 8296 ($9.20 in chips) 
Seat 5: Hsvkc0/G2VV78oVmWYXecw ($6.85 in chips) 
Seat 6: /gJNBeCkWL4o85/jvlZ4BA ($64.35 in chips) 
5nwDw10uIM0XEyLhla0oGA: posts small blind $0.10
8296: posts big blind $0.25
*** HOLE CARDS ***
Hsvkc0/G2VV78oVmWYXecw: folds 
/gJNBeCkWL4o85/jvlZ4BA: folds 
X437kMQ7AujoaDgjguhU9w: folds 
DgyznDqq/mLiCqQGMzc+Aw: calls $0.25
5nwDw10uIM0XEyLhla0oGA: calls $0.15
8296: checks 
*** FLOP *** [4h Jd Ad]
5nwDw10uIM0XEyLhla0oGA: checks 
8296: checks 
DgyznDqq/mLiCqQGMzc+Aw: bets $0.25
5nwDw10uIM0XEyLhla0oGA: calls $0.25
8296: raises $0.25 to $0.50
DgyznDqq/mLiCqQGMzc+Aw: folds 
5nwDw10uIM0XEyLhla0oGA: calls $0.25
*** TURN *** [4h Jd Ad] [Qh]
5nwDw10uIM0XEyLhla0oGA: checks 
8296: checks 
*** RIVER *** [4h Jd Ad Qh] [Ah]
5nwDw10uIM0XEyLhla0oGA: checks 
8296: bets $0.50
5nwDw10uIM0XEyLhla0oGA: raises $6.50 to $7
8296: calls $6.50
*** SHOW DOWN ***
5nwDw10uIM0XEyLhla0oGA: shows [8c Td] (a pair of Aces)
8296: shows [3h Ac] (three of a kind, Aces)
8296 collected $15.25 from pot
*** SUMMARY ***
Total pot $16 | Rake $0.75 
Board [4h Jd Ad Qh Ah]
Seat 1: X437kMQ7AujoaDgjguhU9w folded before Flop (didn't bet)
Seat 2: DgyznDqq/mLiCqQGMzc+Aw (button) folded on the Flop
Seat 3: 5nwDw10uIM0XEyLhla0oGA (small blind) showed [8c Td] and lost with a pair of Aces
Seat 4: 8296 (big blind) showed [3h Ac] and won ($15.25) with three of a kind, Aces
Seat 5: Hsvkc0/G2VV78oVmWYXecw folded before Flop (didn't bet)
Seat 6: /gJNBeCkWL4o85/jvlZ4BA folded before Flop (didn't bet)




PokerStars Game #59941864360:  Hold'em No Limit ($0.10/$0.25) - 2009/07/01 1:48:35 ET
Table 'isKy4XK8wJM0x735/D4hWA' 6-max Seat #2 is the button
Seat 1: kwsRmpZ1ZaLooISs+zfyKg ($24.40 in chips) 
Seat 2: 6elpmfyt4Zw0yvd8lePSMQ ($38.90 in chips) 
Seat 3: jp34e617tIzV8tKIWmfAbA ($25.80 in chips) 
Seat 4: DFi/Lzkjsfv8QswS80JX9Q ($31.80 in chips) 
Seat 5: lquriepNQBhDV5P1SWHhnA ($25.60 in chips) 
Seat 6: GbCVUNssQ7mqsPWr7J4d3w ($5 in chips) 
jp34e617tIzV8tKIWmfAbA: posts small blind $0.10
DFi/Lzkjsfv8QswS80JX9Q: posts big blind $0.25
*** HOLE CARDS ***
lquriepNQBhDV5P1SWHhnA: folds 
GbCVUNssQ7mqsPWr7J4d3w: folds 
kwsRmpZ1ZaLooISs+zfyKg: raises $0.50 to $0.75
6elpmfyt4Zw0yvd8lePSMQ: folds 
jp34e617tIzV8tKIWmfAbA: folds 
DFi/Lzkjsfv8QswS80JX9Q: folds 
Uncalled bet ($0.50) returned to kwsRmpZ1ZaLooISs+zfyKg
kwsRmpZ1ZaLooISs+zfyKg collected $0.60 from pot
*** SUMMARY ***
Total pot $0.60 | Rake $0 
Seat 1: kwsRmpZ1ZaLooISs+zfyKg collected ($0.60)
Seat 2: 6elpmfyt4Zw0yvd8lePSMQ (button) folded before Flop (didn't bet)
Seat 3: jp34e617tIzV8tKIWmfAbA (small blind) folded before Flop
Seat 4: DFi/Lzkjsfv8QswS80JX9Q (big blind) folded before Flop
Seat 5: lquriepNQBhDV5P1SWHhnA folded before Flop (didn't bet)
Seat 6: GbCVUNssQ7mqsPWr7J4d3w folded before Flop (didn't bet)




PokerStars Game #59941864816:  Hold'em No Limit ($0.10/$0.25) - 2009/07/01 1:48:36 ET
Table '9iHhO6FyZVM8XpSc23TIgg' 6-max Seat #5 is the button
Seat 1: NhUN/JpAprdJeamFBgJH1w ($37.30 in chips) 
Seat 2: bJFzs6QmEEnz4miMfSDtcg ($34.75 in chips) 
Seat 3: TSmua8tGK3sTbwi0ynrW9Q ($25.25 in chips) 
Seat 4: cfJccEfyn6IkquPN08hFsA ($24.35 in chips) 
Seat 5: OMGl+YMGogf2JWIRfT2/Yg ($10 in chips) 
Seat 6: iyZxqznXjv3vtvOJymkoLQ ($33.95 in chips) 
iyZxqznXjv3vtvOJymkoLQ: posts small blind $0.10
NhUN/JpAprdJeamFBgJH1w: posts big blind $0.25
*** HOLE CARDS ***
bJFzs6QmEEnz4miMfSDtcg said, "lol ok"
bJFzs6QmEEnz4miMfSDtcg: calls $0.25
TSmua8tGK3sTbwi0ynrW9Q: folds 
cfJccEfyn6IkquPN08hFsA: raises $0.50 to $0.75
OMGl+YMGogf2JWIRfT2/Yg: folds 
iyZxqznXjv3vtvOJymkoLQ: folds 
NhUN/JpAprdJeamFBgJH1w: folds 
bJFzs6QmEEnz4miMfSDtcg: calls $0.50
*** FLOP *** [5d 2d Ts]
bJFzs6QmEEnz4miMfSDtcg: checks 
cfJccEfyn6IkquPN08hFsA: bets $1
bJFzs6QmEEnz4miMfSDtcg: folds 
Uncalled bet ($1) returned to cfJccEfyn6IkquPN08hFsA
cfJccEfyn6IkquPN08hFsA collected $1.80 from pot
cfJccEfyn6IkquPN08hFsA: doesn't show hand 
*** SUMMARY ***
Total pot $1.85 | Rake $0.05 
Board [5d 2d Ts]
Seat 1: NhUN/JpAprdJeamFBgJH1w (big blind) folded before Flop
Seat 2: bJFzs6QmEEnz4miMfSDtcg folded on the Flop
Seat 3: TSmua8tGK3sTbwi0ynrW9Q folded before Flop (didn't bet)
Seat 4: cfJccEfyn6IkquPN08hFsA collected ($1.80)
Seat 5: OMGl+YMGogf2JWIRfT2/Yg (button) folded before Flop (didn't bet)
Seat 6: iyZxqznXjv3vtvOJymkoLQ (small blind) folded before Flop




PokerStars Game #59941865028:  Hold'em No Limit ($0.10/$0.25) - 2009/07/01 1:48:36 ET
Table 'Ez9TB43XM4QgMDQkIW9DYw' 9-max Seat #3 is the button
Seat 1: ShCS62CJp4MKfKLKvGKQbA ($9.95 in chips) 
Seat 2: PFNLAvMkr8qKc7xCiH0wTA ($17 in chips) 
Seat 3: PdIasPkzm2sqZnN41ZRXOg ($5 in chips) 
Seat 4: ubsjZomMWSV0hAiBLa7K1A ($20.55 in chips) 
Seat 6: 76o85YBHJ9veRYp2LPuluQ ($18.95 in chips) 
Seat 7: Bb42QRQMhg5/Y0vHP8/2Xw ($55.95 in chips) 
Seat 8: +2kMBNpY4nF1qNCRd8SJLA ($28.75 in chips) 
Seat 9: QEbIGci+itdw+re8RM5fZA ($25 in chips) 
ubsjZomMWSV0hAiBLa7K1A: posts small blind $0.10
bXpVeaSTPBFSPJmeXxO7nw: is sitting out 
bXpVeaSTPBFSPJmeXxO7nw leaves the table
76o85YBHJ9veRYp2LPuluQ: posts big blind $0.25
*** HOLE CARDS ***
Bb42QRQMhg5/Y0vHP8/2Xw: folds 
+2kMBNpY4nF1qNCRd8SJLA: folds 
QEbIGci+itdw+re8RM5fZA: folds 
ShCS62CJp4MKfKLKvGKQbA: folds 
18G4P1XstjNvItdGUITxgw joins the table at seat #5 
PFNLAvMkr8qKc7xCiH0wTA: folds 
PdIasPkzm2sqZnN41ZRXOg: folds 
ubsjZomMWSV0hAiBLa7K1A: folds 
Uncalled bet ($0.15) returned to 76o85YBHJ9veRYp2LPuluQ
76o85YBHJ9veRYp2LPuluQ collected $0.20 from pot
76o85YBHJ9veRYp2LPuluQ: doesn't show hand 
*** SUMMARY ***
Total pot $0.20 | Rake $0 
Seat 1: ShCS62CJp4MKfKLKvGKQbA folded before Flop (didn't bet)
Seat 2: PFNLAvMkr8qKc7xCiH0wTA folded before Flop (didn't bet)
Seat 3: PdIasPkzm2sqZnN41ZRXOg (button) folded before Flop (didn't bet)
Seat 4: ubsjZomMWSV0hAiBLa7K1A (small blind) folded before Flop
Seat 6: 76o85YBHJ9veRYp2LPuluQ (big blind) collected ($0.20)
Seat 7: Bb42QRQMhg5/Y0vHP8/2Xw folded before Flop (didn't bet)
Seat 8: +2kMBNpY4nF1qNCRd8SJLA folded before Flop (didn't bet)
Seat 9: QEbIGci+itdw+re8RM5fZA folded before Flop (didn't bet)




PokerStars Game #59941865548:  Hold'em No Limit ($0.10/$0.25) - 2009/07/01 1:48:37 ET
Table 'TJS4XvvOjO3k7mH74HJw5g' 9-max Seat #1 is the button
Seat 1: K8I2mpRME07ZlOsT2x75Lg ($7.95 in chips) 
Seat 2: yqkowiRWZ6NvRN9UUkYIlA ($9.85 in chips) 
Seat 3: 8EbrQ/EvFWt2cr0GaU82gQ ($5 in chips) 
Seat 5: UlMB386Cfzy3EwurQoBjcA ($9.70 in chips) 
Seat 6: SRik8xyC/rVIBoX7VaOoMA ($8.90 in chips) 
Seat 7: B9u+i1s5aZZkmLTLUopTBg ($14.40 in chips) 
Seat 8: Qv4VzEkN09uD11sjKv02Ig ($17.95 in chips) 
Seat 9: +sbyWwIcFp9kP0bDtMegfQ ($42.30 in chips) 
yqkowiRWZ6NvRN9UUkYIlA: posts small blind $0.10
8EbrQ/EvFWt2cr0GaU82gQ: posts big blind $0.25
clJsV3v77RS07bDKY+705w: sits out 
*** HOLE CARDS ***
UlMB386Cfzy3EwurQoBjcA: folds 
SRik8xyC/rVIBoX7VaOoMA: folds 
SRik8xyC/rVIBoX7VaOoMA leaves the table
3PmVnC/15cl4oyI1TKIt4g joins the table at seat #6 
B9u+i1s5aZZkmLTLUopTBg: folds 
Qv4VzEkN09uD11sjKv02Ig: folds 
+sbyWwIcFp9kP0bDtMegfQ: folds 
K8I2mpRME07ZlOsT2x75Lg: folds 
yqkowiRWZ6NvRN9UUkYIlA: raises $0.50 to $0.75
8EbrQ/EvFWt2cr0GaU82gQ: folds 
Uncalled bet ($0.50) returned to yqkowiRWZ6NvRN9UUkYIlA
yqkowiRWZ6NvRN9UUkYIlA collected $0.50 from pot
yqkowiRWZ6NvRN9UUkYIlA: doesn't show hand 
*** SUMMARY ***
Total pot $0.50 | Rake $0 
Seat 1: K8I2mpRME07ZlOsT2x75Lg (button) folded before Flop (didn't bet)
Seat 2: yqkowiRWZ6NvRN9UUkYIlA (small blind) collected ($0.50)
Seat 3: 8EbrQ/EvFWt2cr0GaU82gQ (big blind) folded before Flop
Seat 5: UlMB386Cfzy3EwurQoBjcA folded before Flop (didn't bet)
Seat 6: SRik8xyC/rVIBoX7VaOoMA folded before Flop (didn't bet)
Seat 7: B9u+i1s5aZZkmLTLUopTBg folded before Flop (didn't bet)
Seat 8: Qv4VzEkN09uD11sjKv02Ig folded before Flop (didn't bet)
Seat 9: +sbyWwIcFp9kP0bDtMegfQ folded before Flop (didn't bet)




PokerStars Game #59941865502:  Hold'em No Limit ($0.10/$0.25) - 2009/07/01 1:48:37 ET
Table 'AJGgX1ZYM8d68SWMvaLttg' 6-max Seat #2 is the button
Seat 1: Q1uciOZPBR/WkAlqa6cL4A ($25 in chips) 
Seat 2: zHHLkD2sRljslKKeQv/ZQw ($25 in chips) 
Seat 3: 8ClCHtFXGNplITm+63KB+Q ($38.45 in chips) 
Seat 4: e30C3DfdG5TfPnR16/oMmA ($20.70 in chips) 
Seat 5: Hsvkc0/G2VV78oVmWYXecw ($5 in chips) 
8ClCHtFXGNplITm+63KB+Q: posts small blind $0.10
e30C3DfdG5TfPnR16/oMmA: posts big blind $0.25
UA5OsKS3VPaxa7uC8La/kA: sits out 
*** HOLE CARDS ***
Hsvkc0/G2VV78oVmWYXecw: folds 
Q1uciOZPBR/WkAlqa6cL4A: raises $0.75 to $1
zHHLkD2sRljslKKeQv/ZQw: calls $1
8ClCHtFXGNplITm+63KB+Q: folds 
e30C3DfdG5TfPnR16/oMmA: folds 
*** FLOP *** [4c 5c 5h]
Q1uciOZPBR/WkAlqa6cL4A: checks 
zHHLkD2sRljslKKeQv/ZQw: checks 
*** TURN *** [4c 5c 5h] [2s]
Q1uciOZPBR/WkAlqa6cL4A: checks 
zHHLkD2sRljslKKeQv/ZQw: checks 
*** RIVER *** [4c 5c 5h 2s] [6h]
Q1uciOZPBR/WkAlqa6cL4A: checks 
zHHLkD2sRljslKKeQv/ZQw: checks 
*** SHOW DOWN ***
Q1uciOZPBR/WkAlqa6cL4A: shows [Th Jh] (a pair of Fives)
zHHLkD2sRljslKKeQv/ZQw: shows [Ah 8d] (a pair of Fives - Ace kicker)
zHHLkD2sRljslKKeQv/ZQw collected $2.25 from pot
*** SUMMARY ***
Total pot $2.35 | Rake $0.10 
Board [4c 5c 5h 2s 6h]
Seat 1: Q1uciOZPBR/WkAlqa6cL4A showed [Th Jh] and lost with a pair of Fives
Seat 2: zHHLkD2sRljslKKeQv/ZQw (button) showed [Ah 8d] and won ($2.25) with a pair of Fives
Seat 3: 8ClCHtFXGNplITm+63KB+Q (small blind) folded before Flop
Seat 4: e30C3DfdG5TfPnR16/oMmA (big blind) folded before Flop
Seat 5: Hsvkc0/G2VV78oVmWYXecw folded before Flop (didn't bet)




PokerStars Game #59941865536:  Hold'em No Limit ($0.10/$0.25) - 2009/07/01 1:48:37 ET
Table 'mVdLgAdN9rGe6mMwSrDdGQ' 6-max Seat #2 is the button
Seat 1: OyJ0KTHA5cwh0/yCo1/rdA ($11.85 in chips) 
Seat 2: n9QqWD4tpbongUBX2Oi58w ($5.60 in chips) 
Seat 3: +baiVgI/ETnBARLe5mARCw ($13.70 in chips) 
Seat 4: scNSjC6yyKvvfklSkuzLrw ($18.05 in chips) 
Seat 5: +TMG/MBWpiEnc9t7i07eTA ($24.65 in chips) 
Seat 6: DihMHaz4WNETH1bPDe13kA ($47.80 in chips) 
+baiVgI/ETnBARLe5mARCw: posts small blind $0.10
scNSjC6yyKvvfklSkuzLrw: posts big blind $0.25
*** HOLE CARDS ***
+TMG/MBWpiEnc9t7i07eTA: folds 
DihMHaz4WNETH1bPDe13kA: folds 
OyJ0KTHA5cwh0/yCo1/rdA: raises $0.50 to $0.75
n9QqWD4tpbongUBX2Oi58w: calls $0.75
+baiVgI/ETnBARLe5mARCw: raises $1 to $1.75
scNSjC6yyKvvfklSkuzLrw: folds 
OyJ0KTHA5cwh0/yCo1/rdA: folds 
n9QqWD4tpbongUBX2Oi58w: calls $1
*** FLOP *** [4h 4c 2h]
+baiVgI/ETnBARLe5mARCw: bets $2
n9QqWD4tpbongUBX2Oi58w: folds 
Uncalled bet ($2) returned to +baiVgI/ETnBARLe5mARCw
+baiVgI/ETnBARLe5mARCw collected $4.30 from pot
+baiVgI/ETnBARLe5mARCw: doesn't show hand 
*** SUMMARY ***
Total pot $4.50 | Rake $0.20 
Board [4h 4c 2h]
Seat 1: OyJ0KTHA5cwh0/yCo1/rdA folded before Flop
Seat 2: n9QqWD4tpbongUBX2Oi58w (button) folded on the Flop
Seat 3: +baiVgI/ETnBARLe5mARCw (small blind) collected ($4.30)
Seat 4: scNSjC6yyKvvfklSkuzLrw (big blind) folded before Flop
Seat 5: +TMG/MBWpiEnc9t7i07eTA folded before Flop (didn't bet)
Seat 6: DihMHaz4WNETH1bPDe13kA folded before Flop (didn't bet)




PokerStars Game #59941865794:  Hold'em No Limit ($0.10/$0.25) - 2009/07/01 1:48:38 ET
Table 'Loy/olZ5qoDOSvX4UTujGg' 6-max Seat #5 is the button
Seat 1: HipgaJhkN4ie/tTw4dK3Ug ($9.40 in chips) 
Seat 2: 4z7mPbMLNp4TezHXin63Vw ($15.30 in chips) 
Seat 3: 32YL2ZEp8NT4JB2RVM9euQ ($15.35 in chips) 
Seat 4: /gJNBeCkWL4o85/jvlZ4BA ($30.75 in chips) 
Seat 5: Ar4vsUIUfJ7gbYh1c1m59g ($18.90 in chips) 
Seat 6: qGHGf/553gQnDoklMRe3tg ($24.90 in chips) 
qGHGf/553gQnDoklMRe3tg: posts small blind $0.10
HipgaJhkN4ie/tTw4dK3Ug: posts big blind $0.25
*** HOLE CARDS ***
4z7mPbMLNp4TezHXin63Vw: calls $0.25
32YL2ZEp8NT4JB2RVM9euQ: folds 
/gJNBeCkWL4o85/jvlZ4BA: folds 
Ar4vsUIUfJ7gbYh1c1m59g: folds 
qGHGf/553gQnDoklMRe3tg: folds 
HipgaJhkN4ie/tTw4dK3Ug: raises $0.25 to $0.50
4z7mPbMLNp4TezHXin63Vw: calls $0.25
*** FLOP *** [3d 7c 2c]
HipgaJhkN4ie/tTw4dK3Ug: checks 
4z7mPbMLNp4TezHXin63Vw: checks 
*** TURN *** [3d 7c 2c] [Tc]
HipgaJhkN4ie/tTw4dK3Ug: checks 
4z7mPbMLNp4TezHXin63Vw: checks 
*** RIVER *** [3d 7c 2c Tc] [5c]
HipgaJhkN4ie/tTw4dK3Ug: bets $1
4z7mPbMLNp4TezHXin63Vw: folds 
Uncalled bet ($1) returned to HipgaJhkN4ie/tTw4dK3Ug
HipgaJhkN4ie/tTw4dK3Ug collected $1.05 from pot
HipgaJhkN4ie/tTw4dK3Ug: shows [Ad As] (a pair of Aces)
*** SUMMARY ***
Total pot $1.10 | Rake $0.05 
Board [3d 7c 2c Tc 5c]
Seat 1: HipgaJhkN4ie/tTw4dK3Ug (big blind) collected ($1.05)
Seat 2: 4z7mPbMLNp4TezHXin63Vw folded on the River
Seat 3: 32YL2ZEp8NT4JB2RVM9euQ folded before Flop (didn't bet)
Seat 4: /gJNBeCkWL4o85/jvlZ4BA folded before Flop (didn't bet)
Seat 5: Ar4vsUIUfJ7gbYh1c1m59g (button) folded before Flop (didn't bet)
Seat 6: qGHGf/553gQnDoklMRe3tg (small blind) folded before Flop




PokerStars Game #59941865796:  Hold'em No Limit ($0.10/$0.25) - 2009/07/01 1:48:38 ET
Table 'ZEXL6Wh4qA4Afx8NnoBBAA' 6-max Seat #5 is the button
Seat 1: v8m8XHovI5tqEA9mvplDSw ($27.45 in chips) 
Seat 2: 6DwBRH+xZ12AAZmeAg+aXw ($23.50 in chips) 
Seat 3: +ZlnqPoP3Hg4BIUxDfKd/A ($31.70 in chips) 
Seat 4: FpN4KbLjlyRRKiVaQcoLqA ($26.85 in chips) 
Seat 5: if4dh6jhJXeN3/qd3qCp9g ($39.55 in chips) 
Seat 6: Lh8SlCq3OSDKWLUgAI/Lxw ($1.85 in chips) 
Lh8SlCq3OSDKWLUgAI/Lxw: posts small blind $0.10
v8m8XHovI5tqEA9mvplDSw: posts big blind $0.25
*** HOLE CARDS ***
6DwBRH+xZ12AAZmeAg+aXw: raises $0.50 to $0.75
+ZlnqPoP3Hg4BIUxDfKd/A: folds 
FpN4KbLjlyRRKiVaQcoLqA: calls $0.75
if4dh6jhJXeN3/qd3qCp9g: calls $0.75
Lh8SlCq3OSDKWLUgAI/Lxw: folds 
v8m8XHovI5tqEA9mvplDSw: folds 
*** FLOP *** [Ad 6c 8d]
6DwBRH+xZ12AAZmeAg+aXw: checks 
FpN4KbLjlyRRKiVaQcoLqA: bets $0.75
if4dh6jhJXeN3/qd3qCp9g: folds 
6DwBRH+xZ12AAZmeAg+aXw: calls $0.75
*** TURN *** [Ad 6c 8d] [2d]
6DwBRH+xZ12AAZmeAg+aXw: checks 
FpN4KbLjlyRRKiVaQcoLqA: bets $1
6DwBRH+xZ12AAZmeAg+aXw: folds 
Uncalled bet ($1) returned to FpN4KbLjlyRRKiVaQcoLqA
FpN4KbLjlyRRKiVaQcoLqA collected $3.90 from pot
FpN4KbLjlyRRKiVaQcoLqA: doesn't show hand 
*** SUMMARY ***
Total pot $4.10 | Rake $0.20 
Board [Ad 6c 8d 2d]
Seat 1: v8m8XHovI5tqEA9mvplDSw (big blind) folded before Flop
Seat 2: 6DwBRH+xZ12AAZmeAg+aXw folded on the Turn
Seat 3: +ZlnqPoP3Hg4BIUxDfKd/A folded before Flop (didn't bet)
Seat 4: FpN4KbLjlyRRKiVaQcoLqA collected ($3.90)
Seat 5: if4dh6jhJXeN3/qd3qCp9g (button) folded on the Flop
Seat 6: Lh8SlCq3OSDKWLUgAI/Lxw (small blind) folded before Flop




PokerStars Game #59941865970:  Hold'em No Limit ($0.10/$0.25) - 2009/07/01 1:48:38 ET
Table 'HIOfhT0zga/KonFhIl6O3w' 9-max Seat #4 is the button
Seat 1: oLa/tXLfSLLB28mcLGrxcg ($26.20 in chips) 
Seat 2: er86weqXTpTB6/w2dKlYgA ($16.50 in chips) 
Seat 3: X6+pSIPfovPcE87t+LmUKQ ($4.50 in chips) 
Seat 4: qwr38jl5txoR36M7G5qi4A ($8.15 in chips) 
Seat 5: K1MDeapSEyKyGPNZGOKfEg ($37.30 in chips) 
Seat 6: MThMMgdB293VOucmN9sliQ ($25.70 in chips) 
Seat 7: wvlPJBB0PtYkfeeSRDaIvQ ($13.45 in chips) 
Seat 9: dfNim92Z6XK1/h5SFW5vDg ($28.70 in chips) 
K1MDeapSEyKyGPNZGOKfEg: posts small blind $0.10
MThMMgdB293VOucmN9sliQ: posts big blind $0.25
SpiiQQAzy4MUgV3I5W8giw: sits out 
*** HOLE CARDS ***
wvlPJBB0PtYkfeeSRDaIvQ: folds 
dfNim92Z6XK1/h5SFW5vDg: folds 
oLa/tXLfSLLB28mcLGrxcg: calls $0.25
er86weqXTpTB6/w2dKlYgA: folds 
X6+pSIPfovPcE87t+LmUKQ: folds 
qwr38jl5txoR36M7G5qi4A: folds 
K1MDeapSEyKyGPNZGOKfEg: calls $0.15
MThMMgdB293VOucmN9sliQ: checks 
*** FLOP *** [4s Ts 2d]
K1MDeapSEyKyGPNZGOKfEg: checks 
MThMMgdB293VOucmN9sliQ: checks 
oLa/tXLfSLLB28mcLGrxcg: checks 
*** TURN *** [4s Ts 2d] [7c]
K1MDeapSEyKyGPNZGOKfEg: checks 
MThMMgdB293VOucmN9sliQ: checks 
oLa/tXLfSLLB28mcLGrxcg: bets $0.25
K1MDeapSEyKyGPNZGOKfEg: calls $0.25
MThMMgdB293VOucmN9sliQ: calls $0.25
*** RIVER *** [4s Ts 2d 7c] [2h]
K1MDeapSEyKyGPNZGOKfEg: checks 
MThMMgdB293VOucmN9sliQ: checks 
oLa/tXLfSLLB28mcLGrxcg: checks 
*** SHOW DOWN ***
K1MDeapSEyKyGPNZGOKfEg: shows [7h 6c] (two pair, Sevens and Deuces)
MThMMgdB293VOucmN9sliQ: mucks hand 
oLa/tXLfSLLB28mcLGrxcg: shows [Ad 7d] (two pair, Sevens and Deuces - Ace kicker)
oLa/tXLfSLLB28mcLGrxcg collected $1.45 from pot
*** SUMMARY ***
Total pot $1.50 | Rake $0.05 
Board [4s Ts 2d 7c 2h]
Seat 1: oLa/tXLfSLLB28mcLGrxcg showed [Ad 7d] and won ($1.45) with two pair, Sevens and Deuces
Seat 2: er86weqXTpTB6/w2dKlYgA folded before Flop (didn't bet)
Seat 3: X6+pSIPfovPcE87t+LmUKQ folded before Flop (didn't bet)
Seat 4: qwr38jl5txoR36M7G5qi4A (button) folded before Flop (didn't bet)
Seat 5: K1MDeapSEyKyGPNZGOKfEg (small blind) showed [7h 6c] and lost with two pair, Sevens and Deuces
Seat 6: MThMMgdB293VOucmN9sliQ (big blind) mucked
Seat 7: wvlPJBB0PtYkfeeSRDaIvQ folded before Flop (didn't bet)
Seat 9: dfNim92Z6XK1/h5SFW5vDg folded before Flop (didn't bet)




PokerStars Game #59941865808:  Hold'em No Limit ($0.10/$0.25) - 2009/07/01 1:48:38 ET
Table 'ThBZ355rqvsb8UGb6ajbig' 9-max Seat #5 is the button
Seat 1: Z9W7+g1WMhhZDi7DwGbCFA ($10.70 in chips) 
Seat 2: 4awUyiDYTgylQKXZ9faBVA ($25.95 in chips) 
Seat 3: H5Se03ZqSX7tbULXur2MAg ($28.05 in chips) 
Seat 4: zgi+EUykT/pZQpoUG6+oEg ($4.30 in chips) 
Seat 5: cKlmpQMahVsmOaxFQDcoOg ($24.60 in chips) 
Seat 6: qwr38jl5txoR36M7G5qi4A ($11.10 in chips) 
Seat 7: zUXhymECc2C9W9ZNw6qppA ($16.05 in chips) 
Seat 9: sD+TKtt36XiiN6jqHiLwDA ($23.85 in chips) 
qwr38jl5txoR36M7G5qi4A: posts small blind $0.10
zUXhymECc2C9W9ZNw6qppA: posts big blind $0.25
*** HOLE CARDS ***
sD+TKtt36XiiN6jqHiLwDA: calls $0.25
PdIasPkzm2sqZnN41ZRXOg leaves the table
Z9W7+g1WMhhZDi7DwGbCFA: calls $0.25
4awUyiDYTgylQKXZ9faBVA: folds 
H5Se03ZqSX7tbULXur2MAg: calls $0.25
zgi+EUykT/pZQpoUG6+oEg: raises $1.25 to $1.50
cKlmpQMahVsmOaxFQDcoOg: folds 
qwr38jl5txoR36M7G5qi4A: folds 
zUXhymECc2C9W9ZNw6qppA: folds 
sD+TKtt36XiiN6jqHiLwDA: folds 
Z9W7+g1WMhhZDi7DwGbCFA: folds 
H5Se03ZqSX7tbULXur2MAg: folds 
Uncalled bet ($1.25) returned to zgi+EUykT/pZQpoUG6+oEg
pplNliE3WonjkPRf+GZq2A joins the table at seat #8 
zgi+EUykT/pZQpoUG6+oEg collected $1.35 from pot
zgi+EUykT/pZQpoUG6+oEg: doesn't show hand 
*** SUMMARY ***
Total pot $1.35 | Rake $0 
Seat 1: Z9W7+g1WMhhZDi7DwGbCFA folded before Flop
Seat 2: 4awUyiDYTgylQKXZ9faBVA folded before Flop (didn't bet)
Seat 3: H5Se03ZqSX7tbULXur2MAg folded before Flop
Seat 4: zgi+EUykT/pZQpoUG6+oEg collected ($1.35)
Seat 5: cKlmpQMahVsmOaxFQDcoOg (button) folded before Flop (didn't bet)
Seat 6: qwr38jl5txoR36M7G5qi4A (small blind) folded before Flop
Seat 7: zUXhymECc2C9W9ZNw6qppA (big blind) folded before Flop
Seat 9: sD+TKtt36XiiN6jqHiLwDA folded before Flop




PokerStars Game #59941865728:  Hold'em No Limit ($0.10/$0.25) - 2009/07/01 1:48:38 ET
Table 'AUM6O+mgQAaLDZKMQ/5/gA' 9-max Seat #6 is the button
Seat 1: EIObtVVE4WXRXvLGJA6NHw ($10 in chips) 
Seat 3: CvL9Ch1HYCVbTsfpNucitg ($5 in chips) 
Seat 4: 4awUyiDYTgylQKXZ9faBVA ($27.70 in chips) 
Seat 5: +2kMBNpY4nF1qNCRd8SJLA ($25.30 in chips) 
Seat 6: v5jnQ1gfh9nLla3kMXG7Yg ($10.65 in chips) 
Seat 7: Bb42QRQMhg5/Y0vHP8/2Xw ($28.60 in chips) 
Seat 8: zDrucyjVn5aeekNEc3cJrA ($17.40 in chips) 
Seat 9: eK8qa6EPcH2zhtbmWSvc9g ($29.70 in chips) 
Bb42QRQMhg5/Y0vHP8/2Xw: posts small blind $0.10
zDrucyjVn5aeekNEc3cJrA: posts big blind $0.25
*** HOLE CARDS ***
eK8qa6EPcH2zhtbmWSvc9g: folds 
EIObtVVE4WXRXvLGJA6NHw: folds 
CvL9Ch1HYCVbTsfpNucitg: folds 
4awUyiDYTgylQKXZ9faBVA: folds 
+2kMBNpY4nF1qNCRd8SJLA: folds 
v5jnQ1gfh9nLla3kMXG7Yg: calls $0.25
Bb42QRQMhg5/Y0vHP8/2Xw: folds 
zDrucyjVn5aeekNEc3cJrA: checks 
*** FLOP *** [7d Ad Ks]
zDrucyjVn5aeekNEc3cJrA: checks 
v5jnQ1gfh9nLla3kMXG7Yg: checks 
*** TURN *** [7d Ad Ks] [5h]
zDrucyjVn5aeekNEc3cJrA: checks 
v5jnQ1gfh9nLla3kMXG7Yg: checks 
*** RIVER *** [7d Ad Ks 5h] [3h]
z5GxcHlYz/GSz6W2uFiTtg has returned
zDrucyjVn5aeekNEc3cJrA: checks 
v5jnQ1gfh9nLla3kMXG7Yg: bets $1.25
zDrucyjVn5aeekNEc3cJrA: folds 
Uncalled bet ($1.25) returned to v5jnQ1gfh9nLla3kMXG7Yg
v5jnQ1gfh9nLla3kMXG7Yg collected $0.60 from pot
v5jnQ1gfh9nLla3kMXG7Yg: doesn't show hand 
*** SUMMARY ***
Total pot $0.60 | Rake $0 
Board [7d Ad Ks 5h 3h]
Seat 1: EIObtVVE4WXRXvLGJA6NHw folded before Flop (didn't bet)
Seat 3: CvL9Ch1HYCVbTsfpNucitg folded before Flop (didn't bet)
Seat 4: 4awUyiDYTgylQKXZ9faBVA folded before Flop (didn't bet)
Seat 5: +2kMBNpY4nF1qNCRd8SJLA folded before Flop (didn't bet)
Seat 6: v5jnQ1gfh9nLla3kMXG7Yg (button) collected ($0.60)
Seat 7: Bb42QRQMhg5/Y0vHP8/2Xw (small blind) folded before Flop
Seat 8: zDrucyjVn5aeekNEc3cJrA (big blind) folded on the River
Seat 9: eK8qa6EPcH2zhtbmWSvc9g folded before Flop (didn't bet)




PokerStars Game #59941865950:  Hold'em No Limit ($0.10/$0.25) - 2009/07/01 1:48:38 ET
Table 'a6FCGVBMPcT7J7BDN9q1zQ' 9-max Seat #8 is the button
Seat 1: bXpVeaSTPBFSPJmeXxO7nw ($5 in chips) 
Seat 2: M2QO2DxB5Wawg2h8HSpnYA ($13.45 in chips) 
Seat 3: tLcDklc2rBORNfixyRfVfw ($25 in chips) 
Seat 5: dtZ84flFEi4Q+SGrHMJRDQ ($25.80 in chips) 
Seat 6: dfNim92Z6XK1/h5SFW5vDg ($25 in chips) 
Seat 7: V0Yo5zRBVM8DYspLKafebg ($6.60 in chips) 
Seat 8: r6hsffOo1iKmaPYKwAZmFw ($64.60 in chips) 
Seat 9: wGigCmBR/9XWkPpvYos3aQ ($29.95 in chips) 
wGigCmBR/9XWkPpvYos3aQ: posts small blind $0.10
bXpVeaSTPBFSPJmeXxO7nw: posts big blind $0.25
8EbrQ/EvFWt2cr0GaU82gQ: sits out 
*** HOLE CARDS ***
M2QO2DxB5Wawg2h8HSpnYA: folds 
tLcDklc2rBORNfixyRfVfw: folds 
dtZ84flFEi4Q+SGrHMJRDQ: folds 
dfNim92Z6XK1/h5SFW5vDg: folds 
V0Yo5zRBVM8DYspLKafebg: calls $0.25
r6hsffOo1iKmaPYKwAZmFw: calls $0.25
wGigCmBR/9XWkPpvYos3aQ: folds 
bXpVeaSTPBFSPJmeXxO7nw: checks 
*** FLOP *** [7h Jh Jc]
bXpVeaSTPBFSPJmeXxO7nw: checks 
V0Yo5zRBVM8DYspLKafebg: bets $1
r6hsffOo1iKmaPYKwAZmFw: folds 
bXpVeaSTPBFSPJmeXxO7nw: folds 
Uncalled bet ($1) returned to V0Yo5zRBVM8DYspLKafebg
V0Yo5zRBVM8DYspLKafebg collected $0.85 from pot
*** SUMMARY ***
Total pot $0.85 | Rake $0 
Board [7h Jh Jc]
Seat 1: bXpVeaSTPBFSPJmeXxO7nw (big blind) folded on the Flop
Seat 2: M2QO2DxB5Wawg2h8HSpnYA folded before Flop (didn't bet)
Seat 3: tLcDklc2rBORNfixyRfVfw folded before Flop (didn't bet)
Seat 5: dtZ84flFEi4Q+SGrHMJRDQ folded before Flop (didn't bet)
Seat 6: dfNim92Z6XK1/h5SFW5vDg folded before Flop (didn't bet)
Seat 7: V0Yo5zRBVM8DYspLKafebg collected ($0.85)
Seat 8: r6hsffOo1iKmaPYKwAZmFw (button) folded on the Flop
Seat 9: wGigCmBR/9XWkPpvYos3aQ (small blind) folded before Flop




PokerStars Game #59941866632:  Hold'em No Limit ($0.10/$0.25) - 2009/07/01 1:48:39 ET
Table 'djcjiEGabFQO0MNG6jEeJQ' 9-max Seat #9 is the button
Seat 1: Bb42QRQMhg5/Y0vHP8/2Xw ($25.70 in chips) 
Seat 2: WKL8nUFr7TumC4EjLyqYzw ($5.25 in chips) 
Seat 3: zgi+EUykT/pZQpoUG6+oEg ($4.65 in chips) 
Seat 4: 2wcFsZsqEP5w1StUTVzJCg ($9.55 in chips) 
Seat 5: 9QQ67diwg/DShNDBou2R8Q ($25 in chips) 
Seat 6: aNpwfA31EREwO+ar4XzBCw ($78.50 in chips) 
Seat 8: +sbyWwIcFp9kP0bDtMegfQ ($46.25 in chips) 
Seat 9: HPEB+AtKw1+C/cxU0o1ciw ($46.50 in chips) 
Bb42QRQMhg5/Y0vHP8/2Xw: posts small blind $0.10
WKL8nUFr7TumC4EjLyqYzw: posts big blind $0.25
9QQ67diwg/DShNDBou2R8Q: posts big blind $0.25
*** HOLE CARDS ***
zgi+EUykT/pZQpoUG6+oEg: raises $0.75 to $1
2wcFsZsqEP5w1StUTVzJCg: folds 
9QQ67diwg/DShNDBou2R8Q: folds 
aNpwfA31EREwO+ar4XzBCw: folds 
+sbyWwIcFp9kP0bDtMegfQ: folds 
5pDhXQ+RVy0BGcwfJAJfbg joins the table at seat #7 
HPEB+AtKw1+C/cxU0o1ciw: folds 
Bb42QRQMhg5/Y0vHP8/2Xw: calls $0.90
WKL8nUFr7TumC4EjLyqYzw: folds 
*** FLOP *** [5h 7h 4d]
Bb42QRQMhg5/Y0vHP8/2Xw: bets $1
zgi+EUykT/pZQpoUG6+oEg: raises $2.65 to $3.65 and is all-in
Bb42QRQMhg5/Y0vHP8/2Xw: calls $2.65
*** TURN *** [5h 7h 4d] [5d]
*** RIVER *** [5h 7h 4d 5d] [Kh]
*** SHOW DOWN ***
Bb42QRQMhg5/Y0vHP8/2Xw: shows [Td Ts] (two pair, Tens and Fives)
zgi+EUykT/pZQpoUG6+oEg: shows [Qd Qs] (two pair, Queens and Fives)
zgi+EUykT/pZQpoUG6+oEg collected $9.35 from pot
*** SUMMARY ***
Total pot $9.80 | Rake $0.45 
Board [5h 7h 4d 5d Kh]
Seat 1: Bb42QRQMhg5/Y0vHP8/2Xw (small blind) showed [Td Ts] and lost with two pair, Tens and Fives
Seat 2: WKL8nUFr7TumC4EjLyqYzw (big blind) folded before Flop
Seat 3: zgi+EUykT/pZQpoUG6+oEg showed [Qd Qs] and won ($9.35) with two pair, Queens and Fives
Seat 4: 2wcFsZsqEP5w1StUTVzJCg folded before Flop (didn't bet)
Seat 5: 9QQ67diwg/DShNDBou2R8Q folded before Flop
Seat 6: aNpwfA31EREwO+ar4XzBCw folded before Flop (didn't bet)
Seat 8: +sbyWwIcFp9kP0bDtMegfQ folded before Flop (didn't bet)
Seat 9: HPEB+AtKw1+C/cxU0o1ciw (button) folded before Flop (didn't bet)




PokerStars Game #59941866480:  Hold'em No Limit ($0.10/$0.25) - 2009/07/01 1:48:39 ET
Table '2clPgY3+dETPD/8zjXZdFw' 6-max Seat #1 is the button
Seat 1: 7cx44/slbeTw+Cy7QB8Trg ($24.65 in chips) 
Seat 2: cWc85bEzdRzpUMhRKm8pwQ ($25.05 in chips) 
Seat 3: FL1UWpN6oReBdznWDOy9Gg ($15.95 in chips) 
Seat 4: ljjhtb6FVPTx9AT9HNdtqg ($25.10 in chips) 
Seat 5: LJI7A1YgDM7hgh7o56+ReQ ($29.55 in chips) 
cWc85bEzdRzpUMhRKm8pwQ: posts small blind $0.10
FL1UWpN6oReBdznWDOy9Gg: posts big blind $0.25
c3J/KYZ4cNsUEuz8v57I5A: sits out 
*** HOLE CARDS ***
ljjhtb6FVPTx9AT9HNdtqg: folds 
LJI7A1YgDM7hgh7o56+ReQ: folds 
7cx44/slbeTw+Cy7QB8Trg: raises $0.50 to $0.75
cWc85bEzdRzpUMhRKm8pwQ: folds 
FL1UWpN6oReBdznWDOy9Gg: calls $0.50
*** FLOP *** [9h 9s Ad]
FL1UWpN6oReBdznWDOy9Gg: checks 
7cx44/slbeTw+Cy7QB8Trg: checks 
*** TURN *** [9h 9s Ad] [Ah]
FL1UWpN6oReBdznWDOy9Gg: checks 
7cx44/slbeTw+Cy7QB8Trg: checks 
*** RIVER *** [9h 9s Ad Ah] [5d]
FL1UWpN6oReBdznWDOy9Gg: checks 
7cx44/slbeTw+Cy7QB8Trg: checks 
*** SHOW DOWN ***
FL1UWpN6oReBdznWDOy9Gg: shows [Qc 5c] (two pair, Aces and Nines)
7cx44/slbeTw+Cy7QB8Trg: shows [Kc Jc] (two pair, Aces and Nines - King kicker)
7cx44/slbeTw+Cy7QB8Trg collected $1.55 from pot
*** SUMMARY ***
Total pot $1.60 | Rake $0.05 
Board [9h 9s Ad Ah 5d]
Seat 1: 7cx44/slbeTw+Cy7QB8Trg (button) showed [Kc Jc] and won ($1.55) with two pair, Aces and Nines
Seat 2: cWc85bEzdRzpUMhRKm8pwQ (small blind) folded before Flop
Seat 3: FL1UWpN6oReBdznWDOy9Gg (big blind) showed [Qc 5c] and lost with two pair, Aces and Nines
Seat 4: ljjhtb6FVPTx9AT9HNdtqg folded before Flop (didn't bet)
Seat 5: LJI7A1YgDM7hgh7o56+ReQ folded before Flop (didn't bet)




PokerStars Game #59941866320:  Hold'em No Limit ($0.10/$0.25) - 2009/07/01 1:48:39 ET
Table 'rjcb+nlE+0GuJ6lBhuCkkA' 6-max Seat #5 is the button
Seat 1: lBoEwOFgzcERLIRUkUoRTw ($13.25 in chips) 
Seat 2: lJphax9e7/+O/3YCKPJ0yQ ($7.70 in chips) 
Seat 3: 8ClCHtFXGNplITm+63KB+Q ($66.20 in chips) 
Seat 4: BV+K0Phf5VBHr7aZPKqbUQ ($35.50 in chips) 
Seat 5: GC/9yVD59DUCX7hUI7gcLw ($28.65 in chips) 
Seat 6: 32YL2ZEp8NT4JB2RVM9euQ ($15.80 in chips) 
32YL2ZEp8NT4JB2RVM9euQ: posts small blind $0.10
lBoEwOFgzcERLIRUkUoRTw: posts big blind $0.25
*** HOLE CARDS ***
lJphax9e7/+O/3YCKPJ0yQ: calls $0.25
8ClCHtFXGNplITm+63KB+Q: folds 
BV+K0Phf5VBHr7aZPKqbUQ: folds 
GC/9yVD59DUCX7hUI7gcLw: raises $1 to $1.25
32YL2ZEp8NT4JB2RVM9euQ: folds 
lBoEwOFgzcERLIRUkUoRTw: folds 
lJphax9e7/+O/3YCKPJ0yQ: calls $1
*** FLOP *** [Th Td 4c]
lJphax9e7/+O/3YCKPJ0yQ: checks 
GC/9yVD59DUCX7hUI7gcLw: bets $2
lJphax9e7/+O/3YCKPJ0yQ: folds 
Uncalled bet ($2) returned to GC/9yVD59DUCX7hUI7gcLw
GC/9yVD59DUCX7hUI7gcLw collected $2.75 from pot
*** SUMMARY ***
Total pot $2.85 | Rake $0.10 
Board [Th Td 4c]
Seat 1: lBoEwOFgzcERLIRUkUoRTw (big blind) folded before Flop
Seat 2: lJphax9e7/+O/3YCKPJ0yQ folded on the Flop
Seat 3: 8ClCHtFXGNplITm+63KB+Q folded before Flop (didn't bet)
Seat 4: BV+K0Phf5VBHr7aZPKqbUQ folded before Flop (didn't bet)
Seat 5: GC/9yVD59DUCX7hUI7gcLw (button) collected ($2.75)
Seat 6: 32YL2ZEp8NT4JB2RVM9euQ (small blind) folded before Flop




PokerStars Game #59941867030:  Hold'em No Limit ($0.10/$0.25) - 2009/07/01 1:48:40 ET
Table 'M8kYidAX3ib7pLKW7edFLw' 6-max Seat #4 is the button
Seat 1: jp34e617tIzV8tKIWmfAbA ($25 in chips) 
Seat 2: ypmjhffk/YHGc51wgVXUTw ($25 in chips) 
Seat 3: cezpHJ8FB07dj0xG+LhOvw ($26.15 in chips) 
Seat 4: Hsvkc0/G2VV78oVmWYXecw ($5.90 in chips) 
Seat 5: bDKopKTvPi3W+PEnYUX3tg ($47.60 in chips) 
Seat 6: NqFoyDgzLwu4dOmSRXnFBA ($25.25 in chips) 
bDKopKTvPi3W+PEnYUX3tg: posts small blind $0.10
NqFoyDgzLwu4dOmSRXnFBA: posts big blind $0.25
*** HOLE CARDS ***
jp34e617tIzV8tKIWmfAbA: folds 
ypmjhffk/YHGc51wgVXUTw: folds 
cezpHJ8FB07dj0xG+LhOvw: folds 
Hsvkc0/G2VV78oVmWYXecw: raises $0.50 to $0.75
bDKopKTvPi3W+PEnYUX3tg: folds 
NqFoyDgzLwu4dOmSRXnFBA: folds 
Uncalled bet ($0.50) returned to Hsvkc0/G2VV78oVmWYXecw
Hsvkc0/G2VV78oVmWYXecw collected $0.60 from pot
Hsvkc0/G2VV78oVmWYXecw: doesn't show hand 
*** SUMMARY ***
Total pot $0.60 | Rake $0 
Seat 1: jp34e617tIzV8tKIWmfAbA folded before Flop (didn't bet)
Seat 2: ypmjhffk/YHGc51wgVXUTw folded before Flop (didn't bet)
Seat 3: cezpHJ8FB07dj0xG+LhOvw folded before Flop (didn't bet)
Seat 4: Hsvkc0/G2VV78oVmWYXecw (button) collected ($0.60)
Seat 5: bDKopKTvPi3W+PEnYUX3tg (small blind) folded before Flop
Seat 6: NqFoyDgzLwu4dOmSRXnFBA (big blind) folded before Flop




PokerStars Game #59941866724:  Hold'em No Limit ($0.10/$0.25) - 2009/07/01 1:48:40 ET
Table 'wPWRBZPJl1HAnysw7qRR0A' 6-max Seat #4 is the button
Seat 1: m7ne1MOFTQXlsXT7/R/rug ($12.50 in chips) 
Seat 2: xC0kaiDYM6YTlgODL83O5A ($14.65 in chips) 
Seat 3: 1ZpoLWO2nm2w1Nd1v9Sr3g ($1.65 in chips) 
Seat 4: epAUIB7h2FJXzUPRIvSkRA ($52.80 in chips) 
Seat 5: y0B+UpYpOUJz3JWtlJQBSA ($15.50 in chips) 
Seat 6: VXTONriS+Ohik+r0FeicIw ($25 in chips) 
y0B+UpYpOUJz3JWtlJQBSA: posts small blind $0.10
VXTONriS+Ohik+r0FeicIw: posts big blind $0.25
*** HOLE CARDS ***
m7ne1MOFTQXlsXT7/R/rug: folds 
xC0kaiDYM6YTlgODL83O5A: calls $0.25
1ZpoLWO2nm2w1Nd1v9Sr3g: raises $1.40 to $1.65 and is all-in
epAUIB7h2FJXzUPRIvSkRA: folds 
y0B+UpYpOUJz3JWtlJQBSA: folds 
VXTONriS+Ohik+r0FeicIw: folds 
xC0kaiDYM6YTlgODL83O5A: calls $1.40
*** FLOP *** [Ts 5d 6s]
*** TURN *** [Ts 5d 6s] [8s]
*** RIVER *** [Ts 5d 6s 8s] [4s]
*** SHOW DOWN ***
xC0kaiDYM6YTlgODL83O5A: shows [Th 8d] (two pair, Tens and Eights)
1ZpoLWO2nm2w1Nd1v9Sr3g: shows [6c 6d] (three of a kind, Sixes)
1ZpoLWO2nm2w1Nd1v9Sr3g collected $3.50 from pot
*** SUMMARY ***
Total pot $3.65 | Rake $0.15 
Board [Ts 5d 6s 8s 4s]
Seat 1: m7ne1MOFTQXlsXT7/R/rug folded before Flop (didn't bet)
Seat 2: xC0kaiDYM6YTlgODL83O5A showed [Th 8d] and lost with two pair, Tens and Eights
Seat 3: 1ZpoLWO2nm2w1Nd1v9Sr3g showed [6c 6d] and won ($3.50) with three of a kind, Sixes
Seat 4: epAUIB7h2FJXzUPRIvSkRA (button) folded before Flop (didn't bet)
Seat 5: y0B+UpYpOUJz3JWtlJQBSA (small blind) folded before Flop
Seat 6: VXTONriS+Ohik+r0FeicIw (big blind) folded before Flop




PokerStars Game #59941866930:  Hold'em No Limit ($0.10/$0.25) - 2009/07/01 1:48:40 ET
Table 'jdhJTJjFq2KTttwJcd+7nQ' 6-max Seat #1 is the button
Seat 1: LtASJ9OlkqGrrUKGQlpGAw ($26.50 in chips) 
Seat 2: Hsvkc0/G2VV78oVmWYXecw ($5 in chips) 
Seat 3: vqWjZmdQu/Hxw96/IJTWdQ ($29.30 in chips) 
Seat 4: vx7FwRcelVSsvNYAdp/z0A ($5 in chips) 
Seat 5: BV+K0Phf5VBHr7aZPKqbUQ ($27.45 in chips) 
Seat 6: yb6rnd48JuBccThV68VHAQ ($15.55 in chips) 
Hsvkc0/G2VV78oVmWYXecw: posts small blind $0.10
vqWjZmdQu/Hxw96/IJTWdQ: posts big blind $0.25
*** HOLE CARDS ***
vx7FwRcelVSsvNYAdp/z0A: raises $0.25 to $0.50
BV+K0Phf5VBHr7aZPKqbUQ: folds 
yb6rnd48JuBccThV68VHAQ: folds 
LtASJ9OlkqGrrUKGQlpGAw: folds 
Hsvkc0/G2VV78oVmWYXecw: folds 
vqWjZmdQu/Hxw96/IJTWdQ: folds 
Uncalled bet ($0.25) returned to vx7FwRcelVSsvNYAdp/z0A
vx7FwRcelVSsvNYAdp/z0A collected $0.60 from pot
vx7FwRcelVSsvNYAdp/z0A: doesn't show hand 
*** SUMMARY ***
Total pot $0.60 | Rake $0 
Seat 1: LtASJ9OlkqGrrUKGQlpGAw (button) folded before Flop (didn't bet)
Seat 2: Hsvkc0/G2VV78oVmWYXecw (small blind) folded before Flop
Seat 3: vqWjZmdQu/Hxw96/IJTWdQ (big blind) folded before Flop
Seat 4: vx7FwRcelVSsvNYAdp/z0A collected ($0.60)
Seat 5: BV+K0Phf5VBHr7aZPKqbUQ folded before Flop (didn't bet)
Seat 6: yb6rnd48JuBccThV68VHAQ folded before Flop (didn't bet)




PokerStars Game #59941867140:  Hold'em No Limit ($0.10/$0.25) - 2009/07/01 1:48:40 ET
Table 'b64Z+5XI1xkQzNfq4QHr3A' 6-max Seat #4 is the button
Seat 2: A6SjYLoKeIpFjPq0BK/2WA ($10 in chips) 
Seat 3: 7cx44/slbeTw+Cy7QB8Trg ($24.75 in chips) 
Seat 4: 564zqq2DUHXR3tdsOJU6JA ($19.90 in chips) 
Seat 5: JFIAqU8lCZ0vWwEl4bdGsg ($57.85 in chips) 
Seat 6: 8ClCHtFXGNplITm+63KB+Q ($33 in chips) 
JFIAqU8lCZ0vWwEl4bdGsg: posts small blind $0.10
8ClCHtFXGNplITm+63KB+Q: posts big blind $0.25
*** HOLE CARDS ***
A6SjYLoKeIpFjPq0BK/2WA: raises $9.75 to $10 and is all-in
7cx44/slbeTw+Cy7QB8Trg: folds 
564zqq2DUHXR3tdsOJU6JA: folds 
A6SjYLoKeIpFjPq0BK/2WA said, "doosh"
JFIAqU8lCZ0vWwEl4bdGsg: folds 
8ClCHtFXGNplITm+63KB+Q: folds 
Uncalled bet ($9.75) returned to A6SjYLoKeIpFjPq0BK/2WA
A6SjYLoKeIpFjPq0BK/2WA collected $0.60 from pot
A6SjYLoKeIpFjPq0BK/2WA: doesn't show hand 
*** SUMMARY ***
Total pot $0.60 | Rake $0 
Seat 2: A6SjYLoKeIpFjPq0BK/2WA collected ($0.60)
Seat 3: 7cx44/slbeTw+Cy7QB8Trg folded before Flop (didn't bet)
Seat 4: 564zqq2DUHXR3tdsOJU6JA (button) folded before Flop (didn't bet)
Seat 5: JFIAqU8lCZ0vWwEl4bdGsg (small blind) folded before Flop
Seat 6: 8ClCHtFXGNplITm+63KB+Q (big blind) folded before Flop




PokerStars Game #59941867092:  Hold'em No Limit ($0.10/$0.25) - 2009/07/01 1:48:40 ET
Table 'xro+BVoe2Zuw1TYmz/McJQ' 9-max Seat #4 is the button
Seat 2: vSkQm2EelzwRGDDQQk0Fqw ($8.85 in chips) 
Seat 3: xUw+6BIJCkgxBKESwlj9Hg ($5 in chips) 
Seat 4: N2LVj3iImgnOoHVf8g0rIw ($40.85 in chips) 
Seat 6: HPEB+AtKw1+C/cxU0o1ciw ($26.25 in chips) 
Seat 8: ljemhp25Zg+nlA9DLCIiUw ($25 in chips) 
H7ijH+qgNcEQW9eBvivIYg will be allowed to play after the button
HPEB+AtKw1+C/cxU0o1ciw: posts small blind $0.10
ljemhp25Zg+nlA9DLCIiUw: posts big blind $0.25
xUw+6BIJCkgxBKESwlj9Hg: posts big blind $0.25
*** HOLE CARDS ***
vSkQm2EelzwRGDDQQk0Fqw: raises $0.75 to $1
xUw+6BIJCkgxBKESwlj9Hg: calls $0.75
N2LVj3iImgnOoHVf8g0rIw: calls $1
HPEB+AtKw1+C/cxU0o1ciw: folds 
ljemhp25Zg+nlA9DLCIiUw: folds 
*** FLOP *** [7d 4s 6d]
vSkQm2EelzwRGDDQQk0Fqw: checks 
xUw+6BIJCkgxBKESwlj9Hg: checks 
N2LVj3iImgnOoHVf8g0rIw: bets $1.25
vSkQm2EelzwRGDDQQk0Fqw: folds 
xUw+6BIJCkgxBKESwlj9Hg: folds 
Uncalled bet ($1.25) returned to N2LVj3iImgnOoHVf8g0rIw
N2LVj3iImgnOoHVf8g0rIw collected $3.20 from pot
*** SUMMARY ***
Total pot $3.35 | Rake $0.15 
Board [7d 4s 6d]
Seat 2: vSkQm2EelzwRGDDQQk0Fqw folded on the Flop
Seat 3: xUw+6BIJCkgxBKESwlj9Hg folded on the Flop
Seat 4: N2LVj3iImgnOoHVf8g0rIw (button) collected ($3.20)
Seat 6: HPEB+AtKw1+C/cxU0o1ciw (small blind) folded before Flop
Seat 8: ljemhp25Zg+nlA9DLCIiUw (big blind) folded before Flop




PokerStars Game #59941867314:  Hold'em No Limit ($0.10/$0.25) - 2009/07/01 1:48:41 ET
Table '0M5QEJGOThqZwQ/sjbjXYw' 6-max Seat #5 is the button
Seat 2: /gJNBeCkWL4o85/jvlZ4BA ($34.60 in chips) 
Seat 3: 3zD3qLXT1bEffAoWGnc7wg ($25 in chips) 
Seat 4: oBUDUfeUyCbZBsjxHZgSiw ($21.90 in chips) 
Seat 5: cWc85bEzdRzpUMhRKm8pwQ ($33.15 in chips) 
Seat 6: bb63I02U6p9a5MNFa1gCiw ($21.45 in chips) 
bb63I02U6p9a5MNFa1gCiw: posts small blind $0.10
/gJNBeCkWL4o85/jvlZ4BA: posts big blind $0.25
*** HOLE CARDS ***
3zD3qLXT1bEffAoWGnc7wg: folds 
oBUDUfeUyCbZBsjxHZgSiw: raises $0.75 to $1
cWc85bEzdRzpUMhRKm8pwQ: calls $1
bb63I02U6p9a5MNFa1gCiw: folds 
/gJNBeCkWL4o85/jvlZ4BA: folds 
*** FLOP *** [Qh 9d 7c]
oBUDUfeUyCbZBsjxHZgSiw: bets $1.25
cWc85bEzdRzpUMhRKm8pwQ: calls $1.25
*** TURN *** [Qh 9d 7c] [Jc]
oBUDUfeUyCbZBsjxHZgSiw: bets $2.75
cWc85bEzdRzpUMhRKm8pwQ: raises $5 to $7.75
oBUDUfeUyCbZBsjxHZgSiw: calls $5
*** RIVER *** [Qh 9d 7c Jc] [Kd]
oBUDUfeUyCbZBsjxHZgSiw: checks 
cWc85bEzdRzpUMhRKm8pwQ: bets $12
oBUDUfeUyCbZBsjxHZgSiw: calls $11.90 and is all-in
Uncalled bet ($0.10) returned to cWc85bEzdRzpUMhRKm8pwQ
*** SHOW DOWN ***
cWc85bEzdRzpUMhRKm8pwQ: shows [Kh Th] (a straight, Nine to King)
oBUDUfeUyCbZBsjxHZgSiw: mucks hand 
cWc85bEzdRzpUMhRKm8pwQ collected $42.15 from pot
*** SUMMARY ***
Total pot $44.15 | Rake $2 
Board [Qh 9d 7c Jc Kd]
Seat 2: /gJNBeCkWL4o85/jvlZ4BA (big blind) folded before Flop
Seat 3: 3zD3qLXT1bEffAoWGnc7wg folded before Flop (didn't bet)
Seat 4: oBUDUfeUyCbZBsjxHZgSiw mucked
Seat 5: cWc85bEzdRzpUMhRKm8pwQ (button) showed [Kh Th] and won ($42.15) with a straight, Nine to King
Seat 6: bb63I02U6p9a5MNFa1gCiw (small blind) folded before Flop




PokerStars Game #59941867580:  Hold'em No Limit ($0.10/$0.25) - 2009/07/01 1:48:41 ET
Table '1zj0+miaIL9cvwnT/50pOA' 9-max Seat #7 is the button
Seat 1: PVxvfRTRvkgZf9WtquEkwQ ($25 in chips) 
Seat 2: HPEB+AtKw1+C/cxU0o1ciw ($42.95 in chips) 
Seat 3: dtZ84flFEi4Q+SGrHMJRDQ ($29.35 in chips) 
Seat 4: PdIasPkzm2sqZnN41ZRXOg ($5.35 in chips) 
Seat 5: 57qrNGHDvf6GhB8zVLsAtQ ($8.05 in chips) 
Seat 6: YZaC69gFrepA6oCGtu7E0w ($29.20 in chips) 
Seat 7: 6RiVTYll/5D8zICp0MRpKw ($29 in chips) 
Seat 8: Ihhh49x48fayPIyvl2Rsmg ($34.85 in chips) 
Seat 9: AyqFvLFzJDE7yMbXP362BA ($19.30 in chips) 
Ihhh49x48fayPIyvl2Rsmg: posts small blind $0.10
AyqFvLFzJDE7yMbXP362BA: posts big blind $0.25
*** HOLE CARDS ***
PVxvfRTRvkgZf9WtquEkwQ: folds 
HPEB+AtKw1+C/cxU0o1ciw: calls $0.25
dtZ84flFEi4Q+SGrHMJRDQ: folds 
PdIasPkzm2sqZnN41ZRXOg: folds 
57qrNGHDvf6GhB8zVLsAtQ: folds 
YZaC69gFrepA6oCGtu7E0w: calls $0.25
6RiVTYll/5D8zICp0MRpKw: folds 
Ihhh49x48fayPIyvl2Rsmg: raises $1 to $1.25
AyqFvLFzJDE7yMbXP362BA: folds 
HPEB+AtKw1+C/cxU0o1ciw: calls $1
YZaC69gFrepA6oCGtu7E0w: folds 
*** FLOP *** [Ac 2h Ts]
Ihhh49x48fayPIyvl2Rsmg: checks 
HPEB+AtKw1+C/cxU0o1ciw: bets $1.25
Ihhh49x48fayPIyvl2Rsmg: calls $1.25
*** TURN *** [Ac 2h Ts] [Ah]
Ihhh49x48fayPIyvl2Rsmg: checks 
HPEB+AtKw1+C/cxU0o1ciw: checks 
*** RIVER *** [Ac 2h Ts Ah] [2d]
Ihhh49x48fayPIyvl2Rsmg: checks 
HPEB+AtKw1+C/cxU0o1ciw: checks 
*** SHOW DOWN ***
Ihhh49x48fayPIyvl2Rsmg: shows [Kh Ks] (two pair, Aces and Kings)
HPEB+AtKw1+C/cxU0o1ciw: mucks hand 
Ihhh49x48fayPIyvl2Rsmg collected $5.25 from pot
*** SUMMARY ***
Total pot $5.50 | Rake $0.25 
Board [Ac 2h Ts Ah 2d]
Seat 1: PVxvfRTRvkgZf9WtquEkwQ folded before Flop (didn't bet)
Seat 2: HPEB+AtKw1+C/cxU0o1ciw mucked
Seat 3: dtZ84flFEi4Q+SGrHMJRDQ folded before Flop (didn't bet)
Seat 4: PdIasPkzm2sqZnN41ZRXOg folded before Flop (didn't bet)
Seat 5: 57qrNGHDvf6GhB8zVLsAtQ folded before Flop (didn't bet)
Seat 6: YZaC69gFrepA6oCGtu7E0w folded before Flop
Seat 7: 6RiVTYll/5D8zICp0MRpKw (button) folded before Flop (didn't bet)
Seat 8: Ihhh49x48fayPIyvl2Rsmg (small blind) showed [Kh Ks] and won ($5.25) with two pair, Aces and Kings
Seat 9: AyqFvLFzJDE7yMbXP362BA (big blind) folded before Flop




PokerStars Game #59941867350:  Hold'em No Limit ($0.10/$0.25) - 2009/07/01 1:48:41 ET
Table 'WEMI3Mtn7dGARDbgNrKibg' 9-max Seat #6 is the button
Seat 1: Th3FldXKQW6hWVVPahaoOQ ($30.50 in chips) 
Seat 2: tYsOBqdU1+x+yFI7zHO7hQ ($49.55 in chips) 
Seat 3: qwr38jl5txoR36M7G5qi4A ($10 in chips) 
Seat 4: Z5NNIVvnhb2IJbLcI79WYQ ($10.55 in chips) 
Seat 5: yzPZQFeaQTNf1YK3a0zRIw ($9.30 in chips) 
Seat 6: arxNSjreDRGFg13EAM2F1w ($25.10 in chips) 
Seat 7: DnDcAdn9P0zGovMERigpFA ($54.65 in chips) 
Seat 8: ghNKXUBl/H+t83JF079ZBA ($29.60 in chips) 
Seat 9: 2wcFsZsqEP5w1StUTVzJCg ($4.50 in chips) 
DnDcAdn9P0zGovMERigpFA: posts small blind $0.10
ghNKXUBl/H+t83JF079ZBA: posts big blind $0.25
*** HOLE CARDS ***
2wcFsZsqEP5w1StUTVzJCg: folds 
Th3FldXKQW6hWVVPahaoOQ: folds 
tYsOBqdU1+x+yFI7zHO7hQ: folds 
qwr38jl5txoR36M7G5qi4A: folds 
Z5NNIVvnhb2IJbLcI79WYQ: folds 
yzPZQFeaQTNf1YK3a0zRIw: folds 
arxNSjreDRGFg13EAM2F1w: folds 
DnDcAdn9P0zGovMERigpFA: raises $0.50 to $0.75
ghNKXUBl/H+t83JF079ZBA: folds 
Uncalled bet ($0.50) returned to DnDcAdn9P0zGovMERigpFA
DnDcAdn9P0zGovMERigpFA collected $0.50 from pot
DnDcAdn9P0zGovMERigpFA: doesn't show hand 
*** SUMMARY ***
Total pot $0.50 | Rake $0 
Seat 1: Th3FldXKQW6hWVVPahaoOQ folded before Flop (didn't bet)
Seat 2: tYsOBqdU1+x+yFI7zHO7hQ folded before Flop (didn't bet)
Seat 3: qwr38jl5txoR36M7G5qi4A folded before Flop (didn't bet)
Seat 4: Z5NNIVvnhb2IJbLcI79WYQ folded before Flop (didn't bet)
Seat 5: yzPZQFeaQTNf1YK3a0zRIw folded before Flop (didn't bet)
Seat 6: arxNSjreDRGFg13EAM2F1w (button) folded before Flop (didn't bet)
Seat 7: DnDcAdn9P0zGovMERigpFA (small blind) collected ($0.50)
Seat 8: ghNKXUBl/H+t83JF079ZBA (big blind) folded before Flop
Seat 9: 2wcFsZsqEP5w1StUTVzJCg folded before Flop (didn't bet)




PokerStars Game #59941867462:  Hold'em No Limit ($0.10/$0.25) - 2009/07/01 1:48:41 ET
Table 'IUwZ/e0bDHZPgsIWx0RnNg' 6-max Seat #2 is the button
Seat 1: V66QiVCQPofyl3a+dpPHQQ ($5.95 in chips) 
Seat 2: mvFHK3pE7tCxJEqLjKC70Q ($55.60 in chips) 
Seat 3: dOX4wnYV2sEqvDbF+8KSCw ($26 in chips) 
Seat 4: OIjOiBfQstWrK/RuXx7zcw ($4.80 in chips) 
Seat 5: 9bpVv1/Qh9IYtXuCtl5VtQ ($24.65 in chips) 
Seat 6: NhUN/JpAprdJeamFBgJH1w ($38.90 in chips) 
dOX4wnYV2sEqvDbF+8KSCw: posts small blind $0.10
OIjOiBfQstWrK/RuXx7zcw: posts big blind $0.25
*** HOLE CARDS ***
9bpVv1/Qh9IYtXuCtl5VtQ: folds 
NhUN/JpAprdJeamFBgJH1w: folds 
V66QiVCQPofyl3a+dpPHQQ: folds 
mvFHK3pE7tCxJEqLjKC70Q: folds 
dOX4wnYV2sEqvDbF+8KSCw: calls $0.15
OIjOiBfQstWrK/RuXx7zcw: checks 
*** FLOP *** [Jh 8c 8s]
dOX4wnYV2sEqvDbF+8KSCw: checks 
OIjOiBfQstWrK/RuXx7zcw: bets $0.25
dOX4wnYV2sEqvDbF+8KSCw: folds 
Uncalled bet ($0.25) returned to OIjOiBfQstWrK/RuXx7zcw
OIjOiBfQstWrK/RuXx7zcw collected $0.50 from pot
OIjOiBfQstWrK/RuXx7zcw: doesn't show hand 
*** SUMMARY ***
Total pot $0.50 | Rake $0 
Board [Jh 8c 8s]
Seat 1: V66QiVCQPofyl3a+dpPHQQ folded before Flop (didn't bet)
Seat 2: mvFHK3pE7tCxJEqLjKC70Q (button) folded before Flop (didn't bet)
Seat 3: dOX4wnYV2sEqvDbF+8KSCw (small blind) folded on the Flop
Seat 4: OIjOiBfQstWrK/RuXx7zcw (big blind) collected ($0.50)
Seat 5: 9bpVv1/Qh9IYtXuCtl5VtQ folded before Flop (didn't bet)
Seat 6: NhUN/JpAprdJeamFBgJH1w folded before Flop (didn't bet)




PokerStars Game #59941867168:  Hold'em No Limit ($0.10/$0.25) - 2009/07/01 1:48:41 ET
Table 'ukli1Y7ieC5JQMTEFxM2Nw' 6-max Seat #4 is the button
Seat 1: N162H80ZIQevUf2EzGahCA ($7.80 in chips) 
Seat 2: u/yN5P9f3KlATg6WLWNkBQ ($42.55 in chips) 
Seat 3: ExeoJ1G/rSmWa3tRz7TlCA ($23.10 in chips) 
Seat 4: if4dh6jhJXeN3/qd3qCp9g ($27 in chips) 
Seat 5: Se+H4Z4PDr6+eIUDJX1rpg ($17.40 in chips) 
Seat 6: 32YL2ZEp8NT4JB2RVM9euQ ($31.40 in chips) 
Se+H4Z4PDr6+eIUDJX1rpg: posts small blind $0.10
32YL2ZEp8NT4JB2RVM9euQ: posts big blind $0.25
*** HOLE CARDS ***
N162H80ZIQevUf2EzGahCA: calls $0.25
u/yN5P9f3KlATg6WLWNkBQ: folds 
ExeoJ1G/rSmWa3tRz7TlCA: folds 
if4dh6jhJXeN3/qd3qCp9g: calls $0.25
Se+H4Z4PDr6+eIUDJX1rpg: calls $0.15
32YL2ZEp8NT4JB2RVM9euQ: checks 
*** FLOP *** [Qd 4h Ks]
Se+H4Z4PDr6+eIUDJX1rpg: checks 
32YL2ZEp8NT4JB2RVM9euQ: checks 
N162H80ZIQevUf2EzGahCA: checks 
if4dh6jhJXeN3/qd3qCp9g: checks 
*** TURN *** [Qd 4h Ks] [5d]
Se+H4Z4PDr6+eIUDJX1rpg: checks 
32YL2ZEp8NT4JB2RVM9euQ: checks 
N162H80ZIQevUf2EzGahCA: checks 
if4dh6jhJXeN3/qd3qCp9g: checks 
*** RIVER *** [Qd 4h Ks 5d] [5s]
Se+H4Z4PDr6+eIUDJX1rpg: checks 
32YL2ZEp8NT4JB2RVM9euQ: checks 
N162H80ZIQevUf2EzGahCA: checks 
if4dh6jhJXeN3/qd3qCp9g: checks 
*** SHOW DOWN ***
Se+H4Z4PDr6+eIUDJX1rpg: shows [Ts 2s] (a pair of Fives)
32YL2ZEp8NT4JB2RVM9euQ: shows [9c Jh] (a pair of Fives - King+Queen+Jack kicker)
N162H80ZIQevUf2EzGahCA: mucks hand 
if4dh6jhJXeN3/qd3qCp9g: mucks hand 
32YL2ZEp8NT4JB2RVM9euQ collected $0.95 from pot
*** SUMMARY ***
Total pot $1 | Rake $0.05 
Board [Qd 4h Ks 5d 5s]
Seat 1: N162H80ZIQevUf2EzGahCA mucked
Seat 2: u/yN5P9f3KlATg6WLWNkBQ folded before Flop (didn't bet)
Seat 3: ExeoJ1G/rSmWa3tRz7TlCA folded before Flop (didn't bet)
Seat 4: if4dh6jhJXeN3/qd3qCp9g (button) mucked
Seat 5: Se+H4Z4PDr6+eIUDJX1rpg (small blind) showed [Ts 2s] and lost with a pair of Fives
Seat 6: 32YL2ZEp8NT4JB2RVM9euQ (big blind) showed [9c Jh] and won ($0.95) with a pair of Fives




PokerStars Game #59941867270:  Hold'em No Limit ($0.10/$0.25) - 2009/07/01 1:48:41 ET
Table 'WY+lMaAoIdBZmwk27/RJCA' 6-max Seat #2 is the button
Seat 1: zHHLkD2sRljslKKeQv/ZQw ($26.60 in chips) 
Seat 2: NhUN/JpAprdJeamFBgJH1w ($26.55 in chips) 
Seat 3: QqiZLFrN8iOUT/GHw7ztOA ($26.70 in chips) 
Seat 4: 0av6tRNdi0Ui4f15L7gsVg ($25 in chips) 
Seat 5: vqWjZmdQu/Hxw96/IJTWdQ ($27.95 in chips) 
Seat 6: cWc85bEzdRzpUMhRKm8pwQ ($26.10 in chips) 
QqiZLFrN8iOUT/GHw7ztOA: posts small blind $0.10
0av6tRNdi0Ui4f15L7gsVg: posts big blind $0.25
*** HOLE CARDS ***
vqWjZmdQu/Hxw96/IJTWdQ: folds 
cWc85bEzdRzpUMhRKm8pwQ: folds 
zHHLkD2sRljslKKeQv/ZQw: folds 
NhUN/JpAprdJeamFBgJH1w: raises $0.75 to $1
QqiZLFrN8iOUT/GHw7ztOA: folds 
0av6tRNdi0Ui4f15L7gsVg: calls $0.75
*** FLOP *** [2c 4h 5c]
0av6tRNdi0Ui4f15L7gsVg: checks 
NhUN/JpAprdJeamFBgJH1w: checks 
*** TURN *** [2c 4h 5c] [Tc]
0av6tRNdi0Ui4f15L7gsVg: bets $0.75
NhUN/JpAprdJeamFBgJH1w: raises $1.50 to $2.25
0av6tRNdi0Ui4f15L7gsVg: folds 
Uncalled bet ($1.50) returned to NhUN/JpAprdJeamFBgJH1w
NhUN/JpAprdJeamFBgJH1w collected $3.45 from pot
NhUN/JpAprdJeamFBgJH1w: doesn't show hand 
*** SUMMARY ***
Total pot $3.60 | Rake $0.15 
Board [2c 4h 5c Tc]
Seat 1: zHHLkD2sRljslKKeQv/ZQw folded before Flop (didn't bet)
Seat 2: NhUN/JpAprdJeamFBgJH1w (button) collected ($3.45)
Seat 3: QqiZLFrN8iOUT/GHw7ztOA (small blind) folded before Flop
Seat 4: 0av6tRNdi0Ui4f15L7gsVg (big blind) folded on the Turn
Seat 5: vqWjZmdQu/Hxw96/IJTWdQ folded before Flop (didn't bet)
Seat 6: cWc85bEzdRzpUMhRKm8pwQ folded before Flop (didn't bet)




PokerStars Game #59941867780:  Hold'em No Limit ($0.10/$0.25) - 2009/07/01 1:48:42 ET
Table 'sgdCtiuCu2BDZhyDi6RzTA' 6-max Seat #2 is the button
Seat 1: 3zD3qLXT1bEffAoWGnc7wg ($35.40 in chips) 
Seat 2: XD1i5m5PvBDnRzJaG/vINw ($23.70 in chips) 
Seat 3: eL3+wCBjFGfQ5FMdIZihwA ($27.65 in chips) 
Seat 4: rVKEgilmMX+EkKzDVvhmxA ($7.10 in chips) 
Seat 5: 0tQitW75xfmVWKldYHjmOQ ($3.05 in chips) 
Seat 6: KODslGU8ikCYS0/29dUkhg ($32.80 in chips) 
eL3+wCBjFGfQ5FMdIZihwA: posts small blind $0.10
rVKEgilmMX+EkKzDVvhmxA: posts big blind $0.25
*** HOLE CARDS ***
0tQitW75xfmVWKldYHjmOQ: folds 
KODslGU8ikCYS0/29dUkhg: calls $0.25
3zD3qLXT1bEffAoWGnc7wg: folds 
XD1i5m5PvBDnRzJaG/vINw: raises $0.50 to $0.75
eL3+wCBjFGfQ5FMdIZihwA: folds 
rVKEgilmMX+EkKzDVvhmxA: calls $0.50
KODslGU8ikCYS0/29dUkhg: folds 
*** FLOP *** [6c 7c Jd]
rVKEgilmMX+EkKzDVvhmxA: checks 
XD1i5m5PvBDnRzJaG/vINw: bets $0.75
rVKEgilmMX+EkKzDVvhmxA: folds 
Uncalled bet ($0.75) returned to XD1i5m5PvBDnRzJaG/vINw
XD1i5m5PvBDnRzJaG/vINw collected $1.80 from pot
XD1i5m5PvBDnRzJaG/vINw: doesn't show hand 
*** SUMMARY ***
Total pot $1.85 | Rake $0.05 
Board [6c 7c Jd]
Seat 1: 3zD3qLXT1bEffAoWGnc7wg folded before Flop (didn't bet)
Seat 2: XD1i5m5PvBDnRzJaG/vINw (button) collected ($1.80)
Seat 3: eL3+wCBjFGfQ5FMdIZihwA (small blind) folded before Flop
Seat 4: rVKEgilmMX+EkKzDVvhmxA (big blind) folded on the Flop
Seat 5: 0tQitW75xfmVWKldYHjmOQ folded before Flop (didn't bet)
Seat 6: KODslGU8ikCYS0/29dUkhg folded before Flop




PokerStars Game #59941867816:  Hold'em No Limit ($0.10/$0.25) - 2009/07/01 1:48:42 ET
Table 'r562aMIMs5kgo28FEU6lkA' 9-max Seat #8 is the button
Seat 1: H5Se03ZqSX7tbULXur2MAg ($14.80 in chips) 
Seat 2: N8muFAHrFHW6elSMGuyVLQ ($25.35 in chips) 
Seat 3: xoBFd/5k+L/pFn9VW1VyWg ($10.10 in chips) 
Seat 4: V6p0jQ/RhUsqpHLmXvEX4Q ($19.75 in chips) 
Seat 5: zDrucyjVn5aeekNEc3cJrA ($35.20 in chips) 
Seat 6: RCqMONFrSPSArZh2Jsar/w ($20 in chips) 
Seat 7: Bb42QRQMhg5/Y0vHP8/2Xw ($25 in chips) 
Seat 8: B6xHiX1SJkS0CUNCKDVwuQ ($20.90 in chips) 
Seat 9: yyG4svzOpC1A+sUP/scg6w ($7.25 in chips) 
yyG4svzOpC1A+sUP/scg6w: posts small blind $0.10
H5Se03ZqSX7tbULXur2MAg: posts big blind $0.25
*** HOLE CARDS ***
N8muFAHrFHW6elSMGuyVLQ: folds 
xoBFd/5k+L/pFn9VW1VyWg: calls $0.25
V6p0jQ/RhUsqpHLmXvEX4Q: folds 
zDrucyjVn5aeekNEc3cJrA: folds 
RCqMONFrSPSArZh2Jsar/w: folds 
Bb42QRQMhg5/Y0vHP8/2Xw: folds 
B6xHiX1SJkS0CUNCKDVwuQ: folds 
yyG4svzOpC1A+sUP/scg6w: calls $0.15
H5Se03ZqSX7tbULXur2MAg: checks 
*** FLOP *** [2d Ad Ac]
yyG4svzOpC1A+sUP/scg6w: checks 
H5Se03ZqSX7tbULXur2MAg: checks 
xoBFd/5k+L/pFn9VW1VyWg: checks 
*** TURN *** [2d Ad Ac] [Ks]
yyG4svzOpC1A+sUP/scg6w: checks 
H5Se03ZqSX7tbULXur2MAg: checks 
xoBFd/5k+L/pFn9VW1VyWg: checks 
*** RIVER *** [2d Ad Ac Ks] [8c]
yyG4svzOpC1A+sUP/scg6w: checks 
H5Se03ZqSX7tbULXur2MAg: checks 
xoBFd/5k+L/pFn9VW1VyWg said, "damn"
xoBFd/5k+L/pFn9VW1VyWg: checks 
*** SHOW DOWN ***
yyG4svzOpC1A+sUP/scg6w: shows [7c 4c] (a pair of Aces)
H5Se03ZqSX7tbULXur2MAg: shows [Tc 2h] (two pair, Aces and Deuces)
xoBFd/5k+L/pFn9VW1VyWg: shows [Ah As] (four of a kind, Aces)
xoBFd/5k+L/pFn9VW1VyWg collected $0.75 from pot
*** SUMMARY ***
Total pot $0.75 | Rake $0 
Board [2d Ad Ac Ks 8c]
Seat 1: H5Se03ZqSX7tbULXur2MAg (big blind) showed [Tc 2h] and lost with two pair, Aces and Deuces
Seat 2: N8muFAHrFHW6elSMGuyVLQ folded before Flop (didn't bet)
Seat 3: xoBFd/5k+L/pFn9VW1VyWg showed [Ah As] and won ($0.75) with four of a kind, Aces
Seat 4: V6p0jQ/RhUsqpHLmXvEX4Q folded before Flop (didn't bet)
Seat 5: zDrucyjVn5aeekNEc3cJrA folded before Flop (didn't bet)
Seat 6: RCqMONFrSPSArZh2Jsar/w folded before Flop (didn't bet)
Seat 7: Bb42QRQMhg5/Y0vHP8/2Xw folded before Flop (didn't bet)
Seat 8: B6xHiX1SJkS0CUNCKDVwuQ (button) folded before Flop (didn't bet)
Seat 9: yyG4svzOpC1A+sUP/scg6w (small blind) showed [7c 4c] and lost with a pair of Aces




PokerStars Game #59941867930:  Hold'em No Limit ($0.10/$0.25) - 2009/07/01 1:48:42 ET
Table '4mnXP0EWt9mMZYzTIVDQ0w' 9-max Seat #9 is the button
Seat 1: Z5y2J55JmfLYR6/DPAGHwQ ($20.85 in chips) 
Seat 2: BLEU2x2bnGRovIelAY6slA ($24.90 in chips) 
Seat 4: 9lvO/qyU+xrU95Teu1fv0g ($6.50 in chips) 
Seat 5: sSN8Y0AlsBeidZXPKmwXSw ($25.10 in chips) 
Seat 6: 5yjzPss7Y4kAWNDat3e0yQ ($35.65 in chips) 
Seat 7: TtioUKOdJQDGtQyRAYC5Xg ($5.75 in chips) 
Seat 8: 9YN2IkT2JYYKFErZtZvCtA ($14.05 in chips) 
Seat 9: N/O9ADKpmqB2ASZuqgodlw ($8.90 in chips) 
Z5y2J55JmfLYR6/DPAGHwQ: posts small blind $0.10
BLEU2x2bnGRovIelAY6slA: posts big blind $0.25
Ns4HpwO7Oiffvyla/ie56w: sits out 
*** HOLE CARDS ***
9lvO/qyU+xrU95Teu1fv0g: raises $1 to $1.25
sSN8Y0AlsBeidZXPKmwXSw: folds 
5yjzPss7Y4kAWNDat3e0yQ: folds 
TtioUKOdJQDGtQyRAYC5Xg: folds 
9YN2IkT2JYYKFErZtZvCtA: folds 
N/O9ADKpmqB2ASZuqgodlw: folds 
Z5y2J55JmfLYR6/DPAGHwQ: calls $1.15
BLEU2x2bnGRovIelAY6slA: calls $1
*** FLOP *** [3s 5d 2s]
Z5y2J55JmfLYR6/DPAGHwQ: checks 
BLEU2x2bnGRovIelAY6slA: checks 
9lvO/qyU+xrU95Teu1fv0g: bets $2.50
Z5y2J55JmfLYR6/DPAGHwQ: calls $2.50
BLEU2x2bnGRovIelAY6slA: folds 
*** TURN *** [3s 5d 2s] [Ah]
Z5y2J55JmfLYR6/DPAGHwQ: checks 
9lvO/qyU+xrU95Teu1fv0g: bets $2.75 and is all-in
Z5y2J55JmfLYR6/DPAGHwQ: folds 
Uncalled bet ($2.75) returned to 9lvO/qyU+xrU95Teu1fv0g
9lvO/qyU+xrU95Teu1fv0g collected $8.35 from pot
*** SUMMARY ***
Total pot $8.75 | Rake $0.40 
Board [3s 5d 2s Ah]
Seat 1: Z5y2J55JmfLYR6/DPAGHwQ (small blind) folded on the Turn
Seat 2: BLEU2x2bnGRovIelAY6slA (big blind) folded on the Flop
Seat 4: 9lvO/qyU+xrU95Teu1fv0g collected ($8.35)
Seat 5: sSN8Y0AlsBeidZXPKmwXSw folded before Flop (didn't bet)
Seat 6: 5yjzPss7Y4kAWNDat3e0yQ folded before Flop (didn't bet)
Seat 7: TtioUKOdJQDGtQyRAYC5Xg folded before Flop (didn't bet)
Seat 8: 9YN2IkT2JYYKFErZtZvCtA folded before Flop (didn't bet)
Seat 9: N/O9ADKpmqB2ASZuqgodlw (button) folded before Flop (didn't bet)




PokerStars Game #59941867904:  Hold'em No Limit ($0.10/$0.25) - 2009/07/01 1:48:42 ET
Table 'ktio12Pyq06LsrFhIorSqA' 9-max Seat #4 is the button
Seat 1: OneeONzF0MoH0pEdcBndwA ($37.80 in chips) 
Seat 2: tGsFgUKjSctVaAXabrlZxw ($4.95 in chips) 
Seat 3: Z9W7+g1WMhhZDi7DwGbCFA ($5 in chips) 
Seat 4: 0QdZrkFD7aGKeBXPGbIomA ($11.15 in chips) 
Seat 5: e0pV1oisCAilWiG0FCxY6A ($16 in chips) 
Seat 6: jQL6XIewylQ8MmZhhq2YFg ($37.10 in chips) 
Seat 7: XGCfQsxa6PfAg3kJtzUmww ($22.10 in chips) 
Seat 9: H5Se03ZqSX7tbULXur2MAg ($25.55 in chips) 
e0pV1oisCAilWiG0FCxY6A: posts small blind $0.10
jQL6XIewylQ8MmZhhq2YFg: posts big blind $0.25
Z5y2J55JmfLYR6/DPAGHwQ: sits out 
*** HOLE CARDS ***
jQL6XIewylQ8MmZhhq2YFg said, "this is a phucking dream or something"
XGCfQsxa6PfAg3kJtzUmww has timed out
XGCfQsxa6PfAg3kJtzUmww: folds 
XGCfQsxa6PfAg3kJtzUmww is sitting out
XGCfQsxa6PfAg3kJtzUmww has returned
H5Se03ZqSX7tbULXur2MAg: folds 
OneeONzF0MoH0pEdcBndwA: folds 
0QdZrkFD7aGKeBXPGbIomA said, "yes"
tGsFgUKjSctVaAXabrlZxw: calls $0.25
Z9W7+g1WMhhZDi7DwGbCFA: folds 
0QdZrkFD7aGKeBXPGbIomA: folds 
e0pV1oisCAilWiG0FCxY6A: calls $0.15
jQL6XIewylQ8MmZhhq2YFg: checks 
*** FLOP *** [Qc 9s Kd]
jQL6XIewylQ8MmZhhq2YFg said, "phuck u wank"
0QdZrkFD7aGKeBXPGbIomA said, "long song"
e0pV1oisCAilWiG0FCxY6A: bets $0.50
jQL6XIewylQ8MmZhhq2YFg: raises $0.50 to $1
tGsFgUKjSctVaAXabrlZxw: folds 
e0pV1oisCAilWiG0FCxY6A: calls $0.50
*** TURN *** [Qc 9s Kd] [Ah]
e0pV1oisCAilWiG0FCxY6A: checks 
jQL6XIewylQ8MmZhhq2YFg: checks 
*** RIVER *** [Qc 9s Kd Ah] [7s]
e0pV1oisCAilWiG0FCxY6A: bets $0.75
jQL6XIewylQ8MmZhhq2YFg: calls $0.75
*** SHOW DOWN ***
e0pV1oisCAilWiG0FCxY6A: shows [6h 9c] (a pair of Nines)
jQL6XIewylQ8MmZhhq2YFg: shows [Kc 2d] (a pair of Kings)
jQL6XIewylQ8MmZhhq2YFg collected $4.05 from pot
*** SUMMARY ***
Total pot $4.25 | Rake $0.20 
Board [Qc 9s Kd Ah 7s]
Seat 1: OneeONzF0MoH0pEdcBndwA folded before Flop (didn't bet)
Seat 2: tGsFgUKjSctVaAXabrlZxw folded on the Flop
Seat 3: Z9W7+g1WMhhZDi7DwGbCFA folded before Flop (didn't bet)
Seat 4: 0QdZrkFD7aGKeBXPGbIomA (button) folded before Flop (didn't bet)
Seat 5: e0pV1oisCAilWiG0FCxY6A (small blind) showed [6h 9c] and lost with a pair of Nines
Seat 6: jQL6XIewylQ8MmZhhq2YFg (big blind) showed [Kc 2d] and won ($4.05) with a pair of Kings
Seat 7: XGCfQsxa6PfAg3kJtzUmww folded before Flop (didn't bet)
Seat 9: H5Se03ZqSX7tbULXur2MAg folded before Flop (didn't bet)




PokerStars Game #59941867808:  Hold'em No Limit ($0.10/$0.25) - 2009/07/01 1:48:42 ET
Table 'LG9H161ZAHDkOww+ih3Ptg' 6-max Seat #2 is the button
Seat 1: avl8CO/tc0F6eVSiB/KNRA ($25.85 in chips) 
Seat 2: kwsRmpZ1ZaLooISs+zfyKg ($32.55 in chips) 
Seat 3: 5Evvx7UYqXTBuvIc/9s/hA ($14.95 in chips) 
Seat 4: 0C28L4/59aRNtHoBhqTcLg ($58.85 in chips) 
Seat 6: v8m8XHovI5tqEA9mvplDSw ($20 in chips) 
5Evvx7UYqXTBuvIc/9s/hA: posts small blind $0.10
0C28L4/59aRNtHoBhqTcLg: posts big blind $0.25
IDpUHu4U5YRh06nKQqhY8g: sits out 
*** HOLE CARDS ***
v8m8XHovI5tqEA9mvplDSw: folds 
avl8CO/tc0F6eVSiB/KNRA: folds 
kwsRmpZ1ZaLooISs+zfyKg: folds 
5Evvx7UYqXTBuvIc/9s/hA: calls $0.15
0C28L4/59aRNtHoBhqTcLg: checks 
*** FLOP *** [Ad 8d Kc]
5Evvx7UYqXTBuvIc/9s/hA: bets $0.25
0C28L4/59aRNtHoBhqTcLg: folds 
Uncalled bet ($0.25) returned to 5Evvx7UYqXTBuvIc/9s/hA
5Evvx7UYqXTBuvIc/9s/hA collected $0.50 from pot
*** SUMMARY ***
Total pot $0.50 | Rake $0 
Board [Ad 8d Kc]
Seat 1: avl8CO/tc0F6eVSiB/KNRA folded before Flop (didn't bet)
Seat 2: kwsRmpZ1ZaLooISs+zfyKg (button) folded before Flop (didn't bet)
Seat 3: 5Evvx7UYqXTBuvIc/9s/hA (small blind) collected ($0.50)
Seat 4: 0C28L4/59aRNtHoBhqTcLg (big blind) folded on the Flop
Seat 6: v8m8XHovI5tqEA9mvplDSw folded before Flop (didn't bet)




PokerStars Game #59941867818:  Hold'em No Limit ($0.10/$0.25) - 2009/07/01 1:48:42 ET
Table 'wGizWOswEL6P5QrvVkno/g' 6-max Seat #6 is the button
Seat 1: Qbfkn+ucISvbd1Xh32zAGA ($33.60 in chips) 
Seat 2: mfrkWA3PTeYPkbO6hi98Aw ($28.75 in chips) 
Seat 4: yF9xHMEAvA+7Gn+eDkuVIg ($5 in chips) 
Seat 5: w43JQj2oYPpKQVG4Yzlq1w ($25 in chips) 
Seat 6: BuAE7g7dRfuqGPmQDlGyGg ($15.60 in chips) 
Qbfkn+ucISvbd1Xh32zAGA: posts small blind $0.10
mfrkWA3PTeYPkbO6hi98Aw: posts big blind $0.25
i9LqF5rD3bvtbEE7HWgr3Q: sits out 
yF9xHMEAvA+7Gn+eDkuVIg: posts big blind $0.25
w43JQj2oYPpKQVG4Yzlq1w: posts big blind $0.25
*** HOLE CARDS ***
yF9xHMEAvA+7Gn+eDkuVIg: checks 
w43JQj2oYPpKQVG4Yzlq1w: checks 
BuAE7g7dRfuqGPmQDlGyGg: raises $0.35 to $0.60
Qbfkn+ucISvbd1Xh32zAGA: calls $0.50
mfrkWA3PTeYPkbO6hi98Aw: folds 
yF9xHMEAvA+7Gn+eDkuVIg: calls $0.35
w43JQj2oYPpKQVG4Yzlq1w: folds 
*** FLOP *** [7h 9c 8s]
Qbfkn+ucISvbd1Xh32zAGA: checks 
yF9xHMEAvA+7Gn+eDkuVIg: checks 
BuAE7g7dRfuqGPmQDlGyGg: bets $2
Qbfkn+ucISvbd1Xh32zAGA: calls $2
yF9xHMEAvA+7Gn+eDkuVIg: calls $2
*** TURN *** [7h 9c 8s] [2h]
Qbfkn+ucISvbd1Xh32zAGA: checks 
yF9xHMEAvA+7Gn+eDkuVIg: checks 
BuAE7g7dRfuqGPmQDlGyGg: bets $5.75
Qbfkn+ucISvbd1Xh32zAGA: folds 
yF9xHMEAvA+7Gn+eDkuVIg: folds 
Uncalled bet ($5.75) returned to BuAE7g7dRfuqGPmQDlGyGg
BuAE7g7dRfuqGPmQDlGyGg collected $7.90 from pot
*** SUMMARY ***
Total pot $8.30 | Rake $0.40 
Board [7h 9c 8s 2h]
Seat 1: Qbfkn+ucISvbd1Xh32zAGA (small blind) folded on the Turn
Seat 2: mfrkWA3PTeYPkbO6hi98Aw (big blind) folded before Flop
Seat 4: yF9xHMEAvA+7Gn+eDkuVIg folded on the Turn
Seat 5: w43JQj2oYPpKQVG4Yzlq1w folded before Flop
Seat 6: BuAE7g7dRfuqGPmQDlGyGg (button) collected ($7.90)




PokerStars Game #59941868332:  Hold'em No Limit ($0.10/$0.25) - 2009/07/01 1:48:43 ET
Table 'L5GvbdQO5aCZJSE6pyQ8OA' 6-max Seat #5 is the button
Seat 2: DihMHaz4WNETH1bPDe13kA ($31.40 in chips) 
Seat 3: JFIAqU8lCZ0vWwEl4bdGsg ($25.70 in chips) 
Seat 4: trN/oHqTTbPw5MNuKrOpLw ($25.80 in chips) 
Seat 5: LyDHtw3/yniNHW+DvLXbog ($29.25 in chips) 
Seat 6: v+QfkGiuj9bgtuNoVnDO8w ($38.80 in chips) 
v+QfkGiuj9bgtuNoVnDO8w: posts small blind $0.10
DihMHaz4WNETH1bPDe13kA: posts big blind $0.25
*** HOLE CARDS ***
JFIAqU8lCZ0vWwEl4bdGsg: folds 
trN/oHqTTbPw5MNuKrOpLw: raises $0.50 to $0.75
LyDHtw3/yniNHW+DvLXbog: folds 
v+QfkGiuj9bgtuNoVnDO8w: folds 
DihMHaz4WNETH1bPDe13kA: calls $0.50
*** FLOP *** [Ks Tc 5s]
DihMHaz4WNETH1bPDe13kA: checks 
trN/oHqTTbPw5MNuKrOpLw: bets $1
DihMHaz4WNETH1bPDe13kA: folds 
Uncalled bet ($1) returned to trN/oHqTTbPw5MNuKrOpLw
trN/oHqTTbPw5MNuKrOpLw collected $1.55 from pot
trN/oHqTTbPw5MNuKrOpLw: doesn't show hand 
eFj4lr1nuXLyCWNTShr1bg has returned
*** SUMMARY ***
Total pot $1.60 | Rake $0.05 
Board [Ks Tc 5s]
Seat 2: DihMHaz4WNETH1bPDe13kA (big blind) folded on the Flop
Seat 3: JFIAqU8lCZ0vWwEl4bdGsg folded before Flop (didn't bet)
Seat 4: trN/oHqTTbPw5MNuKrOpLw collected ($1.55)
Seat 5: LyDHtw3/yniNHW+DvLXbog (button) folded before Flop (didn't bet)
Seat 6: v+QfkGiuj9bgtuNoVnDO8w (small blind) folded before Flop




PokerStars Game #59941868500:  Hold'em No Limit ($0.10/$0.25) - 2009/07/01 1:48:43 ET
Table 'M7d9IrgQUUFFy/SZ3ksLYg' 6-max Seat #5 is the button
Seat 1: ypmjhffk/YHGc51wgVXUTw ($50.50 in chips) 
Seat 2: 8CPg15X6IHYR1pWm9ha1Sw ($25 in chips) 
Seat 3: epAUIB7h2FJXzUPRIvSkRA ($26.25 in chips) 
Seat 4: 8ClCHtFXGNplITm+63KB+Q ($22.85 in chips) 
Seat 5: kMa8BltUcBQVxnHfqdCfXg ($7 in chips) 
ypmjhffk/YHGc51wgVXUTw: posts small blind $0.10
8CPg15X6IHYR1pWm9ha1Sw: posts big blind $0.25
*** HOLE CARDS ***
epAUIB7h2FJXzUPRIvSkRA: folds 
8ClCHtFXGNplITm+63KB+Q: folds 
kMa8BltUcBQVxnHfqdCfXg: calls $0.25
ypmjhffk/YHGc51wgVXUTw: calls $0.15
8CPg15X6IHYR1pWm9ha1Sw: checks 
*** FLOP *** [Qh Qd 4d]
ypmjhffk/YHGc51wgVXUTw: checks 
8CPg15X6IHYR1pWm9ha1Sw: checks 
kMa8BltUcBQVxnHfqdCfXg: checks 
*** TURN *** [Qh Qd 4d] [6d]
ypmjhffk/YHGc51wgVXUTw: checks 
8CPg15X6IHYR1pWm9ha1Sw: checks 
kMa8BltUcBQVxnHfqdCfXg: bets $0.50
ypmjhffk/YHGc51wgVXUTw: folds 
8CPg15X6IHYR1pWm9ha1Sw: folds 
Uncalled bet ($0.50) returned to kMa8BltUcBQVxnHfqdCfXg
kMa8BltUcBQVxnHfqdCfXg collected $0.75 from pot
*** SUMMARY ***
Total pot $0.75 | Rake $0 
Board [Qh Qd 4d 6d]
Seat 1: ypmjhffk/YHGc51wgVXUTw (small blind) folded on the Turn
Seat 2: 8CPg15X6IHYR1pWm9ha1Sw (big blind) folded on the Turn
Seat 3: epAUIB7h2FJXzUPRIvSkRA folded before Flop (didn't bet)
Seat 4: 8ClCHtFXGNplITm+63KB+Q folded before Flop (didn't bet)
Seat 5: kMa8BltUcBQVxnHfqdCfXg (button) collected ($0.75)




PokerStars Game #59941868616:  Hold'em No Limit ($0.10/$0.25) - 2009/07/01 1:48:43 ET
Table '972HGIb0tQN/zRIK4TABEw' 9-max Seat #1 is the button
Seat 1: fHr2+mGa0RFK3qrpZcVUAQ ($7.05 in chips) 
Seat 4: aSrj4lVmn2owyQ1RbbOqxQ ($11.40 in chips) 
Seat 5: swK30YlQuxRQO7QFr4ZxCA ($45.70 in chips) 
Seat 7: qS+jfnNoG75bT+uQ8CKhQA ($14.40 in chips) 
aSrj4lVmn2owyQ1RbbOqxQ: posts small blind $0.10
swK30YlQuxRQO7QFr4ZxCA: posts big blind $0.25
*** HOLE CARDS ***
qS+jfnNoG75bT+uQ8CKhQA: folds 
fHr2+mGa0RFK3qrpZcVUAQ: folds 
qS+jfnNoG75bT+uQ8CKhQA leaves the table
J8wkBH9zC2TQV57EauHXog joins the table at seat #2 
aSrj4lVmn2owyQ1RbbOqxQ: calls $0.15
swK30YlQuxRQO7QFr4ZxCA: checks 
*** FLOP *** [Js 9d Ad]
aSrj4lVmn2owyQ1RbbOqxQ: checks 
swK30YlQuxRQO7QFr4ZxCA: checks 
*** TURN *** [Js 9d Ad] [5s]
aSrj4lVmn2owyQ1RbbOqxQ: bets $0.50
swK30YlQuxRQO7QFr4ZxCA: folds 
Uncalled bet ($0.50) returned to aSrj4lVmn2owyQ1RbbOqxQ
swK30YlQuxRQO7QFr4ZxCA is sitting out
aSrj4lVmn2owyQ1RbbOqxQ collected $0.50 from pot
aSrj4lVmn2owyQ1RbbOqxQ: doesn't show hand 
swK30YlQuxRQO7QFr4ZxCA leaves the table
*** SUMMARY ***
Total pot $0.50 | Rake $0 
Board [Js 9d Ad 5s]
Seat 1: fHr2+mGa0RFK3qrpZcVUAQ (button) folded before Flop (didn't bet)
Seat 4: aSrj4lVmn2owyQ1RbbOqxQ (small blind) collected ($0.50)
Seat 5: swK30YlQuxRQO7QFr4ZxCA (big blind) folded on the Turn
Seat 7: qS+jfnNoG75bT+uQ8CKhQA folded before Flop (didn't bet)




PokerStars Game #59941868634:  Hold'em No Limit ($0.10/$0.25) - 2009/07/01 1:48:43 ET
Table '0mmHveGuaIfIMQlNE1eqMg' 9-max Seat #2 is the button
Seat 1: ydoFOVgzvZv9ZhuWu9rXAw ($5 in chips) 
Seat 2: rQhYIYXSyH/IivYM1dlV5A ($68.50 in chips) 
Seat 3: ghNKXUBl/H+t83JF079ZBA ($25 in chips) 
Seat 4: DnDcAdn9P0zGovMERigpFA ($36.45 in chips) 
Seat 5: Pt637jKksB5MzP0UNJAAkw ($3.45 in chips) 
Seat 6: 6RiVTYll/5D8zICp0MRpKw ($23.70 in chips) 
Seat 7: 5n7e7I+px7c6CQmLpPbtsg ($11.30 in chips) 
Seat 8: 0XACOSNrAWmqNv9k1nF8rw ($14.65 in chips) 
Seat 9: UNw/UrAelsQeSS17Rro/BA ($10.90 in chips) 
ghNKXUBl/H+t83JF079ZBA: posts small blind $0.10
DnDcAdn9P0zGovMERigpFA: posts big blind $0.25
*** HOLE CARDS ***
Pt637jKksB5MzP0UNJAAkw: calls $0.25
6RiVTYll/5D8zICp0MRpKw: folds 
5n7e7I+px7c6CQmLpPbtsg: folds 
0XACOSNrAWmqNv9k1nF8rw has timed out
0XACOSNrAWmqNv9k1nF8rw: folds 
0XACOSNrAWmqNv9k1nF8rw is sitting out
UNw/UrAelsQeSS17Rro/BA: folds 
ydoFOVgzvZv9ZhuWu9rXAw: folds 
rQhYIYXSyH/IivYM1dlV5A: folds 
0XACOSNrAWmqNv9k1nF8rw has returned
ghNKXUBl/H+t83JF079ZBA: calls $0.15
DnDcAdn9P0zGovMERigpFA: raises $1 to $1.25
Pt637jKksB5MzP0UNJAAkw: raises $2.20 to $3.45 and is all-in
ghNKXUBl/H+t83JF079ZBA: folds 
DnDcAdn9P0zGovMERigpFA: calls $2.20
*** FLOP *** [8c 8d 2s]
*** TURN *** [8c 8d 2s] [Qd]
*** RIVER *** [8c 8d 2s Qd] [7c]
*** SHOW DOWN ***
DnDcAdn9P0zGovMERigpFA: shows [Qc Ac] (two pair, Queens and Eights)
Pt637jKksB5MzP0UNJAAkw: mucks hand 
DnDcAdn9P0zGovMERigpFA collected $6.80 from pot
*** SUMMARY ***
Total pot $7.15 | Rake $0.35 
Board [8c 8d 2s Qd 7c]
Seat 1: ydoFOVgzvZv9ZhuWu9rXAw folded before Flop (didn't bet)
Seat 2: rQhYIYXSyH/IivYM1dlV5A (button) folded before Flop (didn't bet)
Seat 3: ghNKXUBl/H+t83JF079ZBA (small blind) folded before Flop
Seat 4: DnDcAdn9P0zGovMERigpFA (big blind) showed [Qc Ac] and won ($6.80) with two pair, Queens and Eights
Seat 5: Pt637jKksB5MzP0UNJAAkw mucked
Seat 6: 6RiVTYll/5D8zICp0MRpKw folded before Flop (didn't bet)
Seat 7: 5n7e7I+px7c6CQmLpPbtsg folded before Flop (didn't bet)
Seat 8: 0XACOSNrAWmqNv9k1nF8rw folded before Flop (didn't bet)
Seat 9: UNw/UrAelsQeSS17Rro/BA folded before Flop (didn't bet)




PokerStars Game #59941868312:  Hold'em No Limit ($0.10/$0.25) - 2009/07/01 1:48:43 ET
Table 'dNYnr4D4id1jwnEU66Yowg' 9-max Seat #6 is the button
Seat 1: 9lvO/qyU+xrU95Teu1fv0g ($4.40 in chips) 
Seat 2: Qduu7ikeizo6q6Ei9YvcJA ($26.05 in chips) 
Seat 3: IOx4EH8+y3jYZJc/LTRvOw ($25.75 in chips) 
Seat 4: VBHxUExRAMrbxUq/cVx9Gw ($5 in chips) 
Seat 5: 7cv+9Zc9HIQHNvYsMfV3uA ($27.05 in chips) 
Seat 6: 8EbrQ/EvFWt2cr0GaU82gQ ($4.15 in chips) 
Seat 7: DiSvPC2iudwL5j9u6Huyww ($25 in chips) 
Seat 8: RCqMONFrSPSArZh2Jsar/w ($34.10 in chips) 
Seat 9: /FE4MKSoQhXaDp4PBoLM2g ($11.85 in chips) 
DiSvPC2iudwL5j9u6Huyww: posts small blind $0.10
RCqMONFrSPSArZh2Jsar/w: posts big blind $0.25
*** HOLE CARDS ***
/FE4MKSoQhXaDp4PBoLM2g: folds 
9lvO/qyU+xrU95Teu1fv0g: raises $0.75 to $1
Qduu7ikeizo6q6Ei9YvcJA: folds 
IOx4EH8+y3jYZJc/LTRvOw: folds 
VBHxUExRAMrbxUq/cVx9Gw: folds 
7cv+9Zc9HIQHNvYsMfV3uA: folds 
8EbrQ/EvFWt2cr0GaU82gQ: folds 
DiSvPC2iudwL5j9u6Huyww: folds 
RCqMONFrSPSArZh2Jsar/w: folds 
Uncalled bet ($0.75) returned to 9lvO/qyU+xrU95Teu1fv0g
9lvO/qyU+xrU95Teu1fv0g collected $0.60 from pot
*** SUMMARY ***
Total pot $0.60 | Rake $0 
Seat 1: 9lvO/qyU+xrU95Teu1fv0g collected ($0.60)
Seat 2: Qduu7ikeizo6q6Ei9YvcJA folded before Flop (didn't bet)
Seat 3: IOx4EH8+y3jYZJc/LTRvOw folded before Flop (didn't bet)
Seat 4: VBHxUExRAMrbxUq/cVx9Gw folded before Flop (didn't bet)
Seat 5: 7cv+9Zc9HIQHNvYsMfV3uA folded before Flop (didn't bet)
Seat 6: 8EbrQ/EvFWt2cr0GaU82gQ (button) folded before Flop (didn't bet)
Seat 7: DiSvPC2iudwL5j9u6Huyww (small blind) folded before Flop
Seat 8: RCqMONFrSPSArZh2Jsar/w (big blind) folded before Flop
Seat 9: /FE4MKSoQhXaDp4PBoLM2g folded before Flop (didn't bet)




PokerStars Game #59941868330:  Hold'em No Limit ($0.10/$0.25) - 2009/07/01 1:48:43 ET
Table 'eOXPe2c6mG7DOFKvMsZZfA' 6-max Seat #5 is the button
Seat 1: s21kVGMLPAoHdWR+muSonw ($26.25 in chips) 
Seat 2: gaPMxLGp9SOj4Lq6t+/0Ig ($7.10 in chips) 
Seat 3: kReyZ6g6Fu3tQ0nyjDf9kA ($25.35 in chips) 
Seat 4: zHHLkD2sRljslKKeQv/ZQw ($32.10 in chips) 
Seat 5: NhUN/JpAprdJeamFBgJH1w ($34.05 in chips) 
Seat 6: Qpv/hb5ak7LeaDig1L5L8w ($15.30 in chips) 
Qpv/hb5ak7LeaDig1L5L8w: posts small blind $0.10
s21kVGMLPAoHdWR+muSonw: posts big blind $0.25
*** HOLE CARDS ***
gaPMxLGp9SOj4Lq6t+/0Ig: folds 
kReyZ6g6Fu3tQ0nyjDf9kA: folds 
zHHLkD2sRljslKKeQv/ZQw: calls $0.25
NhUN/JpAprdJeamFBgJH1w: folds 
Qpv/hb5ak7LeaDig1L5L8w: folds 
s21kVGMLPAoHdWR+muSonw: checks 
*** FLOP *** [Td 3d Ad]
s21kVGMLPAoHdWR+muSonw: checks 
zHHLkD2sRljslKKeQv/ZQw: checks 
*** TURN *** [Td 3d Ad] [4h]
s21kVGMLPAoHdWR+muSonw: checks 
zHHLkD2sRljslKKeQv/ZQw: checks 
*** RIVER *** [Td 3d Ad 4h] [5h]
s21kVGMLPAoHdWR+muSonw: checks 
zHHLkD2sRljslKKeQv/ZQw: checks 
*** SHOW DOWN ***
s21kVGMLPAoHdWR+muSonw: shows [Kc Qd] (high card Ace)
zHHLkD2sRljslKKeQv/ZQw: shows [8h Tc] (a pair of Tens)
zHHLkD2sRljslKKeQv/ZQw collected $0.60 from pot
*** SUMMARY ***
Total pot $0.60 | Rake $0 
Board [Td 3d Ad 4h 5h]
Seat 1: s21kVGMLPAoHdWR+muSonw (big blind) showed [Kc Qd] and lost with high card Ace
Seat 2: gaPMxLGp9SOj4Lq6t+/0Ig folded before Flop (didn't bet)
Seat 3: kReyZ6g6Fu3tQ0nyjDf9kA folded before Flop (didn't bet)
Seat 4: zHHLkD2sRljslKKeQv/ZQw showed [8h Tc] and won ($0.60) with a pair of Tens
Seat 5: NhUN/JpAprdJeamFBgJH1w (button) folded before Flop (didn't bet)
Seat 6: Qpv/hb5ak7LeaDig1L5L8w (small blind) folded before Flop




PokerStars Game #59941868726:  Hold'em No Limit ($0.10/$0.25) - 2009/07/01 1:48:43 ET
Table 'QegsWX65l3n/K0A8XB78yg' 6-max Seat #3 is the button
Seat 1: p6adJRMXMBLr+xtQzqazIQ ($12.35 in chips) 
Seat 2: GC/9yVD59DUCX7hUI7gcLw ($57 in chips) 
Seat 3: iIgNoBh+3/Ix1/fLsg+HuA ($5.65 in chips) 
Seat 4: epAUIB7h2FJXzUPRIvSkRA ($25 in chips) 
Seat 5: QqiZLFrN8iOUT/GHw7ztOA ($29.30 in chips) 
Seat 6: 5PWs02z65jSO5pr/M6wx/w ($6.45 in chips) 
epAUIB7h2FJXzUPRIvSkRA: posts small blind $0.10
QqiZLFrN8iOUT/GHw7ztOA: posts big blind $0.25
*** HOLE CARDS ***
5PWs02z65jSO5pr/M6wx/w: folds 
p6adJRMXMBLr+xtQzqazIQ: folds 
GC/9yVD59DUCX7hUI7gcLw: raises $0.75 to $1
iIgNoBh+3/Ix1/fLsg+HuA: folds 
epAUIB7h2FJXzUPRIvSkRA: folds 
QqiZLFrN8iOUT/GHw7ztOA: folds 
Uncalled bet ($0.75) returned to GC/9yVD59DUCX7hUI7gcLw
GC/9yVD59DUCX7hUI7gcLw collected $0.60 from pot
*** SUMMARY ***
Total pot $0.60 | Rake $0 
Seat 1: p6adJRMXMBLr+xtQzqazIQ folded before Flop (didn't bet)
Seat 2: GC/9yVD59DUCX7hUI7gcLw collected ($0.60)
Seat 3: iIgNoBh+3/Ix1/fLsg+HuA (button) folded before Flop (didn't bet)
Seat 4: epAUIB7h2FJXzUPRIvSkRA (small blind) folded before Flop
Seat 5: QqiZLFrN8iOUT/GHw7ztOA (big blind) folded before Flop
Seat 6: 5PWs02z65jSO5pr/M6wx/w folded before Flop (didn't bet)




PokerStars Game #59941868326:  Hold'em No Limit ($0.10/$0.25) - 2009/07/01 1:48:43 ET
Table 'zKwHJD0cmKNUure9qQTfFg' 6-max Seat #5 is the button
Seat 1: Hzrn9DZJegEZICufTNYkrg ($18.85 in chips) 
Seat 2: xrf8tAXKQHG99HixCot1Iw ($30.30 in chips) 
Seat 3: m9aw7LBAB5YX2ZqMtMkhqA ($14.25 in chips) 
Seat 4: v+QfkGiuj9bgtuNoVnDO8w ($25 in chips) 
Seat 5: E4AqQ1egsnu0oH2RqsbCmQ ($4.65 in chips) 
Seat 6: edio/rLJ06xeZOfLhoL3UA ($5.25 in chips) 
edio/rLJ06xeZOfLhoL3UA: posts small blind $0.10
Hzrn9DZJegEZICufTNYkrg: posts big blind $0.25
*** HOLE CARDS ***
xrf8tAXKQHG99HixCot1Iw: folds 
m9aw7LBAB5YX2ZqMtMkhqA: folds 
v+QfkGiuj9bgtuNoVnDO8w: folds 
E4AqQ1egsnu0oH2RqsbCmQ: folds 
edio/rLJ06xeZOfLhoL3UA: calls $0.15
Hzrn9DZJegEZICufTNYkrg: checks 
*** FLOP *** [9s 3h Qc]
edio/rLJ06xeZOfLhoL3UA: checks 
Hzrn9DZJegEZICufTNYkrg: checks 
*** TURN *** [9s 3h Qc] [3c]
edio/rLJ06xeZOfLhoL3UA: bets $0.75
Hzrn9DZJegEZICufTNYkrg: folds 
Uncalled bet ($0.75) returned to edio/rLJ06xeZOfLhoL3UA
edio/rLJ06xeZOfLhoL3UA collected $0.50 from pot
edio/rLJ06xeZOfLhoL3UA: doesn't show hand 
*** SUMMARY ***
Total pot $0.50 | Rake $0 
Board [9s 3h Qc 3c]
Seat 1: Hzrn9DZJegEZICufTNYkrg (big blind) folded on the Turn
Seat 2: xrf8tAXKQHG99HixCot1Iw folded before Flop (didn't bet)
Seat 3: m9aw7LBAB5YX2ZqMtMkhqA folded before Flop (didn't bet)
Seat 4: v+QfkGiuj9bgtuNoVnDO8w folded before Flop (didn't bet)
Seat 5: E4AqQ1egsnu0oH2RqsbCmQ (button) folded before Flop (didn't bet)
Seat 6: edio/rLJ06xeZOfLhoL3UA (small blind) collected ($0.50)




PokerStars Game #59941868782:  Hold'em No Limit ($0.10/$0.25) - 2009/07/01 1:48:44 ET
Table 'nlpa8xI95gAflovnFxB2yg' 6-max Seat #6 is the button
Seat 1: fZQg9veL7Dd/Z04ZTjC+wQ ($61.55 in chips) 
Seat 2: Yuyy/pDz3yAO3EbHYRYnKw ($24.15 in chips) 
Seat 3: DihMHaz4WNETH1bPDe13kA ($25 in chips) 
Seat 4: if4dh6jhJXeN3/qd3qCp9g ($52 in chips) 
Seat 5: FDWzjQgBA5K04jOIY/j22w ($7.10 in chips) 
Seat 6: ATNFxN8fYVfSZMQW8dvbvw ($5.25 in chips) 
fZQg9veL7Dd/Z04ZTjC+wQ: posts small blind $0.10
Yuyy/pDz3yAO3EbHYRYnKw: posts big blind $0.25
*** HOLE CARDS ***
DihMHaz4WNETH1bPDe13kA: folds 
if4dh6jhJXeN3/qd3qCp9g: raises $0.75 to $1
FDWzjQgBA5K04jOIY/j22w: folds 
ATNFxN8fYVfSZMQW8dvbvw: folds 
fZQg9veL7Dd/Z04ZTjC+wQ: folds 
Yuyy/pDz3yAO3EbHYRYnKw: folds 
Uncalled bet ($0.75) returned to if4dh6jhJXeN3/qd3qCp9g
if4dh6jhJXeN3/qd3qCp9g collected $0.60 from pot
if4dh6jhJXeN3/qd3qCp9g: doesn't show hand 
*** SUMMARY ***
Total pot $0.60 | Rake $0 
Seat 1: fZQg9veL7Dd/Z04ZTjC+wQ (small blind) folded before Flop
Seat 2: Yuyy/pDz3yAO3EbHYRYnKw (big blind) folded before Flop
Seat 3: DihMHaz4WNETH1bPDe13kA folded before Flop (didn't bet)
Seat 4: if4dh6jhJXeN3/qd3qCp9g collected ($0.60)
Seat 5: FDWzjQgBA5K04jOIY/j22w folded before Flop (didn't bet)
Seat 6: ATNFxN8fYVfSZMQW8dvbvw (button) folded before Flop (didn't bet)




PokerStars Game #59941868900:  Hold'em No Limit ($0.10/$0.25) - 2009/07/01 1:48:44 ET
Table 'IdXp6nyeW4FYaEK4qKCnwQ' 9-max Seat #8 is the button
Seat 1: tLcDklc2rBORNfixyRfVfw ($25 in chips) 
Seat 2: HPEB+AtKw1+C/cxU0o1ciw ($30.85 in chips) 
Seat 4: j4q3p0lesp63b1gZDwLBZw ($5.35 in chips) 
Seat 6: arxNSjreDRGFg13EAM2F1w ($30.50 in chips) 
Seat 7: w1ukf8uPa4+WH561TtVRxA ($37.25 in chips) 
Seat 8: dtZ84flFEi4Q+SGrHMJRDQ ($29.75 in chips) 
Seat 9: s2xLPOl/vhl/26apJ3vsOQ ($29 in chips) 
s2xLPOl/vhl/26apJ3vsOQ: posts small blind $0.10
tLcDklc2rBORNfixyRfVfw: posts big blind $0.25
*** HOLE CARDS ***
HPEB+AtKw1+C/cxU0o1ciw: folds 
j4q3p0lesp63b1gZDwLBZw: folds 
arxNSjreDRGFg13EAM2F1w: folds 
w1ukf8uPa4+WH561TtVRxA: folds 
dtZ84flFEi4Q+SGrHMJRDQ: folds 
s2xLPOl/vhl/26apJ3vsOQ: folds 
Uncalled bet ($0.15) returned to tLcDklc2rBORNfixyRfVfw
tLcDklc2rBORNfixyRfVfw collected $0.20 from pot
tLcDklc2rBORNfixyRfVfw: doesn't show hand 
*** SUMMARY ***
Total pot $0.20 | Rake $0 
Seat 1: tLcDklc2rBORNfixyRfVfw (big blind) collected ($0.20)
Seat 2: HPEB+AtKw1+C/cxU0o1ciw folded before Flop (didn't bet)
Seat 4: j4q3p0lesp63b1gZDwLBZw folded before Flop (didn't bet)
Seat 6: arxNSjreDRGFg13EAM2F1w folded before Flop (didn't bet)
Seat 7: w1ukf8uPa4+WH561TtVRxA folded before Flop (didn't bet)
Seat 8: dtZ84flFEi4Q+SGrHMJRDQ (button) folded before Flop (didn't bet)
Seat 9: s2xLPOl/vhl/26apJ3vsOQ (small blind) folded before Flop




PokerStars Game #59941869014:  Hold'em No Limit ($0.10/$0.25) - 2009/07/01 1:48:44 ET
Table 'RUOqTfzbAVGS5x+J9aZMHA' 9-max Seat #6 is the button
Seat 1: DnDcAdn9P0zGovMERigpFA ($26.15 in chips) 
Seat 2: Z5ZtGOON8kmSdSCll9Z3XA ($8 in chips) 
Seat 3: Th3FldXKQW6hWVVPahaoOQ ($25 in chips) 
Seat 4: K9Az8li/CO2TicltVWKamA ($26.75 in chips) 
Seat 5: MtVtHDqIJTyUcXkRBBDIVA ($32.75 in chips) 
Seat 6: ljemhp25Zg+nlA9DLCIiUw ($48 in chips) 
Seat 7: zgi+EUykT/pZQpoUG6+oEg ($4.05 in chips) 
Seat 8: dfNim92Z6XK1/h5SFW5vDg ($29.20 in chips) 
Seat 9: cZ99hugmLBj9KhTlc8nCSw ($25 in chips) 
zgi+EUykT/pZQpoUG6+oEg: posts small blind $0.10
dfNim92Z6XK1/h5SFW5vDg: posts big blind $0.25
*** HOLE CARDS ***
cZ99hugmLBj9KhTlc8nCSw: folds 
DnDcAdn9P0zGovMERigpFA: folds 
Z5ZtGOON8kmSdSCll9Z3XA: folds 
Th3FldXKQW6hWVVPahaoOQ: folds 
K9Az8li/CO2TicltVWKamA: folds 
MtVtHDqIJTyUcXkRBBDIVA: raises $0.50 to $0.75
ljemhp25Zg+nlA9DLCIiUw: folds 
zgi+EUykT/pZQpoUG6+oEg: folds 
dfNim92Z6XK1/h5SFW5vDg: calls $0.50
*** FLOP *** [4d Ts Ac]
dfNim92Z6XK1/h5SFW5vDg: checks 
MtVtHDqIJTyUcXkRBBDIVA: bets $1.50
dfNim92Z6XK1/h5SFW5vDg: folds 
Uncalled bet ($1.50) returned to MtVtHDqIJTyUcXkRBBDIVA
MtVtHDqIJTyUcXkRBBDIVA collected $1.55 from pot
MtVtHDqIJTyUcXkRBBDIVA: doesn't show hand 
*** SUMMARY ***
Total pot $1.60 | Rake $0.05 
Board [4d Ts Ac]
Seat 1: DnDcAdn9P0zGovMERigpFA folded before Flop (didn't bet)
Seat 2: Z5ZtGOON8kmSdSCll9Z3XA folded before Flop (didn't bet)
Seat 3: Th3FldXKQW6hWVVPahaoOQ folded before Flop (didn't bet)
Seat 4: K9Az8li/CO2TicltVWKamA folded before Flop (didn't bet)
Seat 5: MtVtHDqIJTyUcXkRBBDIVA collected ($1.55)
Seat 6: ljemhp25Zg+nlA9DLCIiUw (button) folded before Flop (didn't bet)
Seat 7: zgi+EUykT/pZQpoUG6+oEg (small blind) folded before Flop
Seat 8: dfNim92Z6XK1/h5SFW5vDg (big blind) folded on the Flop
Seat 9: cZ99hugmLBj9KhTlc8nCSw folded before Flop (didn't bet)




PokerStars Game #59941868972:  Hold'em No Limit ($0.10/$0.25) - 2009/07/01 1:48:44 ET
Table 'zhqgUUprOJ14VxKxPHcT/Q' 9-max Seat #5 is the button
Seat 1: 22dIObOuor/A+IKWkNoAlA ($5.85 in chips) 
Seat 2: GY095KWhBevJ1Ttvl8WseA ($14.25 in chips) 
Seat 3: 4XHsdGnQ76EBdBvsrSs8bA ($20.55 in chips) 
Seat 4: wGigCmBR/9XWkPpvYos3aQ ($33.45 in chips) 
Seat 5: +sbyWwIcFp9kP0bDtMegfQ ($33.25 in chips) 
Seat 6: PdIasPkzm2sqZnN41ZRXOg ($4.75 in chips) 
Seat 8: EQXHDnIzAsORnIXRNtXRlA ($29.50 in chips) 
Seat 9: 4awUyiDYTgylQKXZ9faBVA ($25 in chips) 
PdIasPkzm2sqZnN41ZRXOg: posts small blind $0.10
sGFnnRCa1YAHAUmWgsW6Qg: is sitting out 
sGFnnRCa1YAHAUmWgsW6Qg leaves the table
EQXHDnIzAsORnIXRNtXRlA: posts big blind $0.25
*** HOLE CARDS ***
4awUyiDYTgylQKXZ9faBVA: folds 
bXpVeaSTPBFSPJmeXxO7nw joins the table at seat #7 
22dIObOuor/A+IKWkNoAlA: folds 
GY095KWhBevJ1Ttvl8WseA: folds 
4XHsdGnQ76EBdBvsrSs8bA: folds 
wGigCmBR/9XWkPpvYos3aQ: folds 
+sbyWwIcFp9kP0bDtMegfQ: folds 
PdIasPkzm2sqZnN41ZRXOg: folds 
Uncalled bet ($0.15) returned to EQXHDnIzAsORnIXRNtXRlA
EQXHDnIzAsORnIXRNtXRlA collected $0.20 from pot
*** SUMMARY ***
Total pot $0.20 | Rake $0 
Seat 1: 22dIObOuor/A+IKWkNoAlA folded before Flop (didn't bet)
Seat 2: GY095KWhBevJ1Ttvl8WseA folded before Flop (didn't bet)
Seat 3: 4XHsdGnQ76EBdBvsrSs8bA folded before Flop (didn't bet)
Seat 4: wGigCmBR/9XWkPpvYos3aQ folded before Flop (didn't bet)
Seat 5: +sbyWwIcFp9kP0bDtMegfQ (button) folded before Flop (didn't bet)
Seat 6: PdIasPkzm2sqZnN41ZRXOg (small blind) folded before Flop
Seat 8: EQXHDnIzAsORnIXRNtXRlA (big blind) collected ($0.20)
Seat 9: 4awUyiDYTgylQKXZ9faBVA folded before Flop (didn't bet)




PokerStars Game #59941869070:  Hold'em No Limit ($0.10/$0.25) - 2009/07/01 1:48:44 ET
Table 'hOE09W281uSob0XeJmUcRg' 6-max Seat #3 is the button
Seat 1: mfrkWA3PTeYPkbO6hi98Aw ($26.95 in chips) 
Seat 2: lRKJ8o/CnOPFwfHHm6ioMw ($12.55 in chips) 
Seat 3: y+a/yGW/Jy4bPJFnaeTz5w ($13.10 in chips) 
Seat 5: JFIAqU8lCZ0vWwEl4bdGsg ($26.65 in chips) 
Seat 6: x4ZJ8E/TUrtoB7WiHcv8WA ($16.10 in chips) 
JFIAqU8lCZ0vWwEl4bdGsg: posts small blind $0.10
x4ZJ8E/TUrtoB7WiHcv8WA: posts big blind $0.25
*** HOLE CARDS ***
mfrkWA3PTeYPkbO6hi98Aw: folds 
lRKJ8o/CnOPFwfHHm6ioMw: raises $0.25 to $0.50
y+a/yGW/Jy4bPJFnaeTz5w: calls $0.50
JFIAqU8lCZ0vWwEl4bdGsg: folds 
x4ZJ8E/TUrtoB7WiHcv8WA: calls $0.25
*** FLOP *** [8h Qs 3c]
x4ZJ8E/TUrtoB7WiHcv8WA: checks 
lRKJ8o/CnOPFwfHHm6ioMw: bets $0.25
y+a/yGW/Jy4bPJFnaeTz5w: folds 
x4ZJ8E/TUrtoB7WiHcv8WA: calls $0.25
*** TURN *** [8h Qs 3c] [7d]
x4ZJ8E/TUrtoB7WiHcv8WA: checks 
lRKJ8o/CnOPFwfHHm6ioMw: checks 
*** RIVER *** [8h Qs 3c 7d] [4d]
x4ZJ8E/TUrtoB7WiHcv8WA: bets $1.75
lRKJ8o/CnOPFwfHHm6ioMw: folds 
Uncalled bet ($1.75) returned to x4ZJ8E/TUrtoB7WiHcv8WA
x4ZJ8E/TUrtoB7WiHcv8WA collected $2 from pot
x4ZJ8E/TUrtoB7WiHcv8WA: doesn't show hand 
*** SUMMARY ***
Total pot $2.10 | Rake $0.10 
Board [8h Qs 3c 7d 4d]
Seat 1: mfrkWA3PTeYPkbO6hi98Aw folded before Flop (didn't bet)
Seat 2: lRKJ8o/CnOPFwfHHm6ioMw folded on the River
Seat 3: y+a/yGW/Jy4bPJFnaeTz5w (button) folded on the Flop
Seat 5: JFIAqU8lCZ0vWwEl4bdGsg (small blind) folded before Flop
Seat 6: x4ZJ8E/TUrtoB7WiHcv8WA (big blind) collected ($2)




PokerStars Game #59941868968:  Hold'em No Limit ($0.10/$0.25) - 2009/07/01 1:48:44 ET
Table 'g+mPuNJBCHKE9ents7ZGtg' 6-max Seat #1 is the button
Seat 1: cezpHJ8FB07dj0xG+LhOvw ($58.15 in chips) 
Seat 2: fZQg9veL7Dd/Z04ZTjC+wQ ($64.70 in chips) 
Seat 4: yVrjRIW0SMxgpvqSIPSe/w ($14.60 in chips) 
Seat 5: D3ikCR8c/o9jB5irZ3uGlw ($12.25 in chips) 
Seat 6: Mn2V28t5aGq2d09z+/o6Fw ($24.85 in chips) 
fZQg9veL7Dd/Z04ZTjC+wQ: posts small blind $0.10
FYepjhAvF8ZdVCmqHIy+eQ: is sitting out 
yVrjRIW0SMxgpvqSIPSe/w: posts big blind $0.25
*** HOLE CARDS ***
D3ikCR8c/o9jB5irZ3uGlw: folds 
FYepjhAvF8ZdVCmqHIy+eQ leaves the table
Mn2V28t5aGq2d09z+/o6Fw: folds 
cezpHJ8FB07dj0xG+LhOvw: folds 
fZQg9veL7Dd/Z04ZTjC+wQ: folds 
Uncalled bet ($0.15) returned to yVrjRIW0SMxgpvqSIPSe/w
8CPg15X6IHYR1pWm9ha1Sw joins the table at seat #3 
yVrjRIW0SMxgpvqSIPSe/w collected $0.20 from pot
*** SUMMARY ***
Total pot $0.20 | Rake $0 
Seat 1: cezpHJ8FB07dj0xG+LhOvw (button) folded before Flop (didn't bet)
Seat 2: fZQg9veL7Dd/Z04ZTjC+wQ (small blind) folded before Flop
Seat 4: yVrjRIW0SMxgpvqSIPSe/w (big blind) collected ($0.20)
Seat 5: D3ikCR8c/o9jB5irZ3uGlw folded before Flop (didn't bet)
Seat 6: Mn2V28t5aGq2d09z+/o6Fw folded before Flop (didn't bet)




PokerStars Game #59941869224:  Hold'em No Limit ($0.10/$0.25) - 2009/07/01 1:48:44 ET
Table '5VWnrlxdjwVfMWkVS2WE7A' 6-max Seat #1 is the button
Seat 1: 82p+w3EmUaFFHuwpSeGY1w ($14 in chips) 
Seat 2: LJI7A1YgDM7hgh7o56+ReQ ($42.70 in chips) 
Seat 3: SFmT9ZsVopnukjvAzrxTRg ($37.35 in chips) 
Seat 4: Pb/gJ3OxOZx57fFp0MDgkg ($35.20 in chips) 
Seat 6: LtASJ9OlkqGrrUKGQlpGAw ($5.15 in chips) 
LJI7A1YgDM7hgh7o56+ReQ: posts small blind $0.10
SFmT9ZsVopnukjvAzrxTRg: posts big blind $0.25
32YL2ZEp8NT4JB2RVM9euQ: sits out 
*** HOLE CARDS ***
Pb/gJ3OxOZx57fFp0MDgkg: folds 
LtASJ9OlkqGrrUKGQlpGAw: folds 
82p+w3EmUaFFHuwpSeGY1w: calls $0.25
LJI7A1YgDM7hgh7o56+ReQ: folds 
SFmT9ZsVopnukjvAzrxTRg: checks 
*** FLOP *** [Js 5h 9d]
SFmT9ZsVopnukjvAzrxTRg: checks 
82p+w3EmUaFFHuwpSeGY1w: bets $0.50
SFmT9ZsVopnukjvAzrxTRg: folds 
Uncalled bet ($0.50) returned to 82p+w3EmUaFFHuwpSeGY1w
82p+w3EmUaFFHuwpSeGY1w collected $0.60 from pot
82p+w3EmUaFFHuwpSeGY1w: doesn't show hand 
*** SUMMARY ***
Total pot $0.60 | Rake $0 
Board [Js 5h 9d]
Seat 1: 82p+w3EmUaFFHuwpSeGY1w (button) collected ($0.60)
Seat 2: LJI7A1YgDM7hgh7o56+ReQ (small blind) folded before Flop
Seat 3: SFmT9ZsVopnukjvAzrxTRg (big blind) folded on the Flop
Seat 4: Pb/gJ3OxOZx57fFp0MDgkg folded before Flop (didn't bet)
Seat 6: LtASJ9OlkqGrrUKGQlpGAw folded before Flop (didn't bet)




PokerStars Game #59941868836:  Hold'em No Limit ($0.10/$0.25) - 2009/07/01 1:48:44 ET
Table '0w9m+UkNlGMNoPyQqzWk6A' 9-max Seat #3 is the button
Seat 3: VWwtMkIjXloiX/RKh7RGWQ ($11.80 in chips) 
Seat 5: HPEB+AtKw1+C/cxU0o1ciw ($48.05 in chips) 
Seat 6: CgIo2ItZqi4o3ayVG6HanQ ($25.40 in chips) 
Seat 7: 57qrNGHDvf6GhB8zVLsAtQ ($4.45 in chips) 
Seat 9: KqS/lY/fNB9qUxokm9QfeA ($11.60 in chips) 
HPEB+AtKw1+C/cxU0o1ciw: posts small blind $0.10
CgIo2ItZqi4o3ayVG6HanQ: posts big blind $0.25
cZ99hugmLBj9KhTlc8nCSw: sits out 
18G4P1XstjNvItdGUITxgw: sits out 
M1nKET7WOTLbVPuAbJa3EA: sits out 
*** HOLE CARDS ***
57qrNGHDvf6GhB8zVLsAtQ: folds 
KqS/lY/fNB9qUxokm9QfeA: raises $0.50 to $0.75
VWwtMkIjXloiX/RKh7RGWQ: folds 
HPEB+AtKw1+C/cxU0o1ciw: calls $0.65
CgIo2ItZqi4o3ayVG6HanQ: folds 
*** FLOP *** [9d Ks 3d]
HPEB+AtKw1+C/cxU0o1ciw: checks 
KqS/lY/fNB9qUxokm9QfeA: bets $0.75
HPEB+AtKw1+C/cxU0o1ciw: calls $0.75
*** TURN *** [9d Ks 3d] [6s]
HPEB+AtKw1+C/cxU0o1ciw: checks 
KqS/lY/fNB9qUxokm9QfeA: checks 
*** RIVER *** [9d Ks 3d 6s] [Js]
HPEB+AtKw1+C/cxU0o1ciw: checks 
KqS/lY/fNB9qUxokm9QfeA: bets $1.50
HPEB+AtKw1+C/cxU0o1ciw: folds 
Uncalled bet ($1.50) returned to KqS/lY/fNB9qUxokm9QfeA
KqS/lY/fNB9qUxokm9QfeA collected $3.10 from pot
*** SUMMARY ***
Total pot $3.25 | Rake $0.15 
Board [9d Ks 3d 6s Js]
Seat 3: VWwtMkIjXloiX/RKh7RGWQ (button) folded before Flop (didn't bet)
Seat 5: HPEB+AtKw1+C/cxU0o1ciw (small blind) folded on the River
Seat 6: CgIo2ItZqi4o3ayVG6HanQ (big blind) folded before Flop
Seat 7: 57qrNGHDvf6GhB8zVLsAtQ folded before Flop (didn't bet)
Seat 9: KqS/lY/fNB9qUxokm9QfeA collected ($3.10)




PokerStars Game #59941869468:  Hold'em No Limit ($0.10/$0.25) - 2009/07/01 1:48:45 ET
Table 'Yb2CyZosw7N3yRRVLhKnKg' 9-max Seat #6 is the button
Seat 1: c/9X4zftzphFxYtxp5kp9w ($11.55 in chips) 
Seat 2: dtZ84flFEi4Q+SGrHMJRDQ ($26.15 in chips) 
Seat 3: wUanlt/hhheMA+jOrJk2Tg ($9.40 in chips) 
Seat 4: FG10kumpruEJ3PQJ7oGglQ ($12.45 in chips) 
Seat 6: CgIo2ItZqi4o3ayVG6HanQ ($48 in chips) 
Seat 7: ljemhp25Zg+nlA9DLCIiUw ($24.85 in chips) 
Seat 8: HxDF4QSxC4z39D7teZpprQ ($13.55 in chips) 
Seat 9: 6DVf3fwEGECnjQ4Yp9AsFw ($16.55 in chips) 
ljemhp25Zg+nlA9DLCIiUw: posts small blind $0.10
HxDF4QSxC4z39D7teZpprQ: posts big blind $0.25
*** HOLE CARDS ***
6DVf3fwEGECnjQ4Yp9AsFw: folds 
c/9X4zftzphFxYtxp5kp9w: folds 
ydoFOVgzvZv9ZhuWu9rXAw joins the table at seat #5 
dtZ84flFEi4Q+SGrHMJRDQ: folds 
wUanlt/hhheMA+jOrJk2Tg: calls $0.25
FG10kumpruEJ3PQJ7oGglQ: raises $0.50 to $0.75
CgIo2ItZqi4o3ayVG6HanQ: raises $1.25 to $2
ljemhp25Zg+nlA9DLCIiUw: folds 
HxDF4QSxC4z39D7teZpprQ: folds 
wUanlt/hhheMA+jOrJk2Tg: folds 
FG10kumpruEJ3PQJ7oGglQ: calls $1.25
*** FLOP *** [8s Ts Ac]
FG10kumpruEJ3PQJ7oGglQ: checks 
CgIo2ItZqi4o3ayVG6HanQ: bets $2.25
FG10kumpruEJ3PQJ7oGglQ: calls $2.25
*** TURN *** [8s Ts Ac] [4s]
FG10kumpruEJ3PQJ7oGglQ: checks 
CgIo2ItZqi4o3ayVG6HanQ: checks 
*** RIVER *** [8s Ts Ac 4s] [9h]
FG10kumpruEJ3PQJ7oGglQ: checks 
CgIo2ItZqi4o3ayVG6HanQ: checks 
*** SHOW DOWN ***
FG10kumpruEJ3PQJ7oGglQ: shows [5s Ad] (a pair of Aces)
CgIo2ItZqi4o3ayVG6HanQ: mucks hand 
FG10kumpruEJ3PQJ7oGglQ collected $8.70 from pot
*** SUMMARY ***
Total pot $9.10 | Rake $0.40 
Board [8s Ts Ac 4s 9h]
Seat 1: c/9X4zftzphFxYtxp5kp9w folded before Flop (didn't bet)
Seat 2: dtZ84flFEi4Q+SGrHMJRDQ folded before Flop (didn't bet)
Seat 3: wUanlt/hhheMA+jOrJk2Tg folded before Flop
Seat 4: FG10kumpruEJ3PQJ7oGglQ showed [5s Ad] and won ($8.70) with a pair of Aces
Seat 6: CgIo2ItZqi4o3ayVG6HanQ (button) mucked
Seat 7: ljemhp25Zg+nlA9DLCIiUw (small blind) folded before Flop
Seat 8: HxDF4QSxC4z39D7teZpprQ (big blind) folded before Flop
Seat 9: 6DVf3fwEGECnjQ4Yp9AsFw folded before Flop (didn't bet)




PokerStars Game #59941869358:  Hold'em No Limit ($0.10/$0.25) - 2009/07/01 1:48:45 ET
Table 'K/f0NNaoGuhSz5DrzgVw7Q' 9-max Seat #1 is the button
Seat 1: sD+TKtt36XiiN6jqHiLwDA ($25.70 in chips) 
Seat 2: zgi+EUykT/pZQpoUG6+oEg ($4.75 in chips) 
Seat 4: 9bCz0uv2nUmznwuI0OjVGw ($11.80 in chips) 
Seat 5: DnDcAdn9P0zGovMERigpFA ($40.60 in chips) 
Seat 6: 3PVK0IdMlq2fElkVzzr4bg ($7.60 in chips) 
Seat 7: egvg3mTBBVzMHnJPIQiKcA ($14.65 in chips) 
Seat 8: RCqMONFrSPSArZh2Jsar/w ($24.65 in chips) 
Seat 9: tLcDklc2rBORNfixyRfVfw ($25 in chips) 
zgi+EUykT/pZQpoUG6+oEg: posts small blind $0.10
9bCz0uv2nUmznwuI0OjVGw: posts big blind $0.25
*** HOLE CARDS ***
DnDcAdn9P0zGovMERigpFA: raises $0.75 to $1
3PVK0IdMlq2fElkVzzr4bg: folds 
egvg3mTBBVzMHnJPIQiKcA: folds 
RCqMONFrSPSArZh2Jsar/w: folds 
tLcDklc2rBORNfixyRfVfw: folds 
sD+TKtt36XiiN6jqHiLwDA: folds 
zgi+EUykT/pZQpoUG6+oEg: folds 
9bCz0uv2nUmznwuI0OjVGw: folds 
Uncalled bet ($0.75) returned to DnDcAdn9P0zGovMERigpFA
DnDcAdn9P0zGovMERigpFA collected $0.60 from pot
DnDcAdn9P0zGovMERigpFA: doesn't show hand 
*** SUMMARY ***
Total pot $0.60 | Rake $0 
Seat 1: sD+TKtt36XiiN6jqHiLwDA (button) folded before Flop (didn't bet)
Seat 2: zgi+EUykT/pZQpoUG6+oEg (small blind) folded before Flop
Seat 4: 9bCz0uv2nUmznwuI0OjVGw (big blind) folded before Flop
Seat 5: DnDcAdn9P0zGovMERigpFA collected ($0.60)
Seat 6: 3PVK0IdMlq2fElkVzzr4bg folded before Flop (didn't bet)
Seat 7: egvg3mTBBVzMHnJPIQiKcA folded before Flop (didn't bet)
Seat 8: RCqMONFrSPSArZh2Jsar/w folded before Flop (didn't bet)
Seat 9: tLcDklc2rBORNfixyRfVfw folded before Flop (didn't bet)




PokerStars Game #59941869360:  Hold'em No Limit ($0.10/$0.25) - 2009/07/01 1:48:45 ET
Table 'IrJPyZ3JW2iIa+krdoSbJQ' 9-max Seat #9 is the button
Seat 1: Bb42QRQMhg5/Y0vHP8/2Xw ($26 in chips) 
Seat 2: X78b5v/uhqeXXoAijbw/yg ($42.95 in chips) 
Seat 3: CT7Xj/V/O5rBlhtt+RZeFQ ($25 in chips) 
Seat 4: bXpVeaSTPBFSPJmeXxO7nw ($4.65 in chips) 
Seat 5: tLcDklc2rBORNfixyRfVfw ($30.30 in chips) 
Seat 6: +sbyWwIcFp9kP0bDtMegfQ ($24.60 in chips) 
Seat 7: ozqb9Z1ZOsDwxxq9IKmjUA ($9.75 in chips) 
Seat 8: zZqOSFjPK4R4cwx0dONetw ($15 in chips) 
Seat 9: Mh2r9hTeTEDnh19sRZtW3g ($9.55 in chips) 
Bb42QRQMhg5/Y0vHP8/2Xw: posts small blind $0.10
X78b5v/uhqeXXoAijbw/yg: posts big blind $0.25
*** HOLE CARDS ***
CT7Xj/V/O5rBlhtt+RZeFQ: folds 
bXpVeaSTPBFSPJmeXxO7nw: folds 
tLcDklc2rBORNfixyRfVfw: raises $0.75 to $1
+sbyWwIcFp9kP0bDtMegfQ: folds 
ozqb9Z1ZOsDwxxq9IKmjUA: folds 
zZqOSFjPK4R4cwx0dONetw: folds 
Mh2r9hTeTEDnh19sRZtW3g: folds 
Bb42QRQMhg5/Y0vHP8/2Xw: folds 
X78b5v/uhqeXXoAijbw/yg: folds 
Uncalled bet ($0.75) returned to tLcDklc2rBORNfixyRfVfw
tLcDklc2rBORNfixyRfVfw collected $0.60 from pot
tLcDklc2rBORNfixyRfVfw: doesn't show hand 
*** SUMMARY ***
Total pot $0.60 | Rake $0 
Seat 1: Bb42QRQMhg5/Y0vHP8/2Xw (small blind) folded before Flop
Seat 2: X78b5v/uhqeXXoAijbw/yg (big blind) folded before Flop
Seat 3: CT7Xj/V/O5rBlhtt+RZeFQ folded before Flop (didn't bet)
Seat 4: bXpVeaSTPBFSPJmeXxO7nw folded before Flop (didn't bet)
Seat 5: tLcDklc2rBORNfixyRfVfw collected ($0.60)
Seat 6: +sbyWwIcFp9kP0bDtMegfQ folded before Flop (didn't bet)
Seat 7: ozqb9Z1ZOsDwxxq9IKmjUA folded before Flop (didn't bet)
Seat 8: zZqOSFjPK4R4cwx0dONetw folded before Flop (didn't bet)
Seat 9: Mh2r9hTeTEDnh19sRZtW3g (button) folded before Flop (didn't bet)




PokerStars Game #59941869402:  Hold'em No Limit ($0.10/$0.25) - 2009/07/01 1:48:45 ET
Table 'xPn6TS/y/OWkX7Qa+MUuKA' 6-max Seat #4 is the button
Seat 1: JFIAqU8lCZ0vWwEl4bdGsg ($42.70 in chips) 
Seat 2: buyjetgNT1McXtdaP4zynA ($27.70 in chips) 
Seat 3: q6WfTUAD9mowIP63ASq2Dg ($24.15 in chips) 
Seat 4: SS/yfeArhULzIcOPe8MdPg ($28.30 in chips) 
Seat 5: lquriepNQBhDV5P1SWHhnA ($28.95 in chips) 
Seat 6: DihMHaz4WNETH1bPDe13kA ($25 in chips) 
lquriepNQBhDV5P1SWHhnA: posts small blind $0.10
DihMHaz4WNETH1bPDe13kA: posts big blind $0.25
*** HOLE CARDS ***
JFIAqU8lCZ0vWwEl4bdGsg: folds 
buyjetgNT1McXtdaP4zynA: folds 
q6WfTUAD9mowIP63ASq2Dg: folds 
SS/yfeArhULzIcOPe8MdPg: raises $0.75 to $1
lquriepNQBhDV5P1SWHhnA: folds 
DihMHaz4WNETH1bPDe13kA: folds 
Uncalled bet ($0.75) returned to SS/yfeArhULzIcOPe8MdPg
SS/yfeArhULzIcOPe8MdPg collected $0.60 from pot
*** SUMMARY ***
Total pot $0.60 | Rake $0 
Seat 1: JFIAqU8lCZ0vWwEl4bdGsg folded before Flop (didn't bet)
Seat 2: buyjetgNT1McXtdaP4zynA folded before Flop (didn't bet)
Seat 3: q6WfTUAD9mowIP63ASq2Dg folded before Flop (didn't bet)
Seat 4: SS/yfeArhULzIcOPe8MdPg (button) collected ($0.60)
Seat 5: lquriepNQBhDV5P1SWHhnA (small blind) folded before Flop
Seat 6: DihMHaz4WNETH1bPDe13kA (big blind) folded before Flop




PokerStars Game #59941869416:  Hold'em No Limit ($0.10/$0.25) - 2009/07/01 1:48:45 ET
Table 'fIMYcWwN4/aXFJvH5Z8Ymg' 6-max Seat #3 is the button
Seat 1: DihMHaz4WNETH1bPDe13kA ($25.35 in chips) 
Seat 2: Mhj3q7cxev+XjXZxEE6/Cw ($25.60 in chips) 
Seat 3: 9bpVv1/Qh9IYtXuCtl5VtQ ($24.65 in chips) 
Seat 4: 7cx44/slbeTw+Cy7QB8Trg ($24.75 in chips) 
Seat 5: lquriepNQBhDV5P1SWHhnA ($25.35 in chips) 
Seat 6: jp34e617tIzV8tKIWmfAbA ($28.70 in chips) 
7cx44/slbeTw+Cy7QB8Trg: posts small blind $0.10
lquriepNQBhDV5P1SWHhnA: posts big blind $0.25
*** HOLE CARDS ***
jp34e617tIzV8tKIWmfAbA: folds 
DihMHaz4WNETH1bPDe13kA: folds 
Mhj3q7cxev+XjXZxEE6/Cw: raises $0.50 to $0.75
9bpVv1/Qh9IYtXuCtl5VtQ: folds 
7cx44/slbeTw+Cy7QB8Trg: folds 
lquriepNQBhDV5P1SWHhnA: folds 
Uncalled bet ($0.50) returned to Mhj3q7cxev+XjXZxEE6/Cw
Mhj3q7cxev+XjXZxEE6/Cw collected $0.60 from pot
Mhj3q7cxev+XjXZxEE6/Cw: doesn't show hand 
*** SUMMARY ***
Total pot $0.60 | Rake $0 
Seat 1: DihMHaz4WNETH1bPDe13kA folded before Flop (didn't bet)
Seat 2: Mhj3q7cxev+XjXZxEE6/Cw collected ($0.60)
Seat 3: 9bpVv1/Qh9IYtXuCtl5VtQ (button) folded before Flop (didn't bet)
Seat 4: 7cx44/slbeTw+Cy7QB8Trg (small blind) folded before Flop
Seat 5: lquriepNQBhDV5P1SWHhnA (big blind) folded before Flop
Seat 6: jp34e617tIzV8tKIWmfAbA folded before Flop (didn't bet)




PokerStars Game #59941870006:  Hold'em No Limit ($0.10/$0.25) - 2009/07/01 1:48:46 ET
Table '2O5CgfSkSwrr4PDrlZ1RLQ' 6-max Seat #6 is the button
Seat 1: 3skmHD9EOATKdUzzyHh1KA ($31.70 in chips) 
Seat 2: wqphQtauX5Qn7WRJZS1flA ($26.50 in chips) 
Seat 3: oBUDUfeUyCbZBsjxHZgSiw ($19.25 in chips) 
Seat 4: epAUIB7h2FJXzUPRIvSkRA ($25 in chips) 
Seat 5: 0av6tRNdi0Ui4f15L7gsVg ($23.90 in chips) 
Seat 6: tj9xqoqQaDaFw7u1oyZrtA ($56.40 in chips) 
3skmHD9EOATKdUzzyHh1KA: posts small blind $0.10
wqphQtauX5Qn7WRJZS1flA: posts big blind $0.25
*** HOLE CARDS ***
oBUDUfeUyCbZBsjxHZgSiw: folds 
epAUIB7h2FJXzUPRIvSkRA: folds 
0av6tRNdi0Ui4f15L7gsVg: folds 
tj9xqoqQaDaFw7u1oyZrtA: calls $0.25
3skmHD9EOATKdUzzyHh1KA: folds 
wqphQtauX5Qn7WRJZS1flA: checks 
*** FLOP *** [Kd 2s Ac]
wqphQtauX5Qn7WRJZS1flA: bets $0.50
tj9xqoqQaDaFw7u1oyZrtA: raises $0.50 to $1
wqphQtauX5Qn7WRJZS1flA: calls $0.50
*** TURN *** [Kd 2s Ac] [8c]
wqphQtauX5Qn7WRJZS1flA: checks 
tj9xqoqQaDaFw7u1oyZrtA: bets $1.25
wqphQtauX5Qn7WRJZS1flA: calls $1.25
*** RIVER *** [Kd 2s Ac 8c] [2c]
wqphQtauX5Qn7WRJZS1flA: checks 
tj9xqoqQaDaFw7u1oyZrtA: checks 
*** SHOW DOWN ***
wqphQtauX5Qn7WRJZS1flA: shows [Ad 3c] (two pair, Aces and Deuces)
tj9xqoqQaDaFw7u1oyZrtA: mucks hand 
wqphQtauX5Qn7WRJZS1flA collected $4.85 from pot
*** SUMMARY ***
Total pot $5.10 | Rake $0.25 
Board [Kd 2s Ac 8c 2c]
Seat 1: 3skmHD9EOATKdUzzyHh1KA (small blind) folded before Flop
Seat 2: wqphQtauX5Qn7WRJZS1flA (big blind) showed [Ad 3c] and won ($4.85) with two pair, Aces and Deuces
Seat 3: oBUDUfeUyCbZBsjxHZgSiw folded before Flop (didn't bet)
Seat 4: epAUIB7h2FJXzUPRIvSkRA folded before Flop (didn't bet)
Seat 5: 0av6tRNdi0Ui4f15L7gsVg folded before Flop (didn't bet)
Seat 6: tj9xqoqQaDaFw7u1oyZrtA (button) mucked




PokerStars Game #59941869792:  Hold'em No Limit ($0.10/$0.25) - 2009/07/01 1:48:46 ET
Table 'C8mMnVmvkagwolEzTvh07A' 9-max Seat #2 is the button
Seat 1: PqvgxdSg9z5VmrWpbYuz+g ($27.15 in chips) 
Seat 2: Bb42QRQMhg5/Y0vHP8/2Xw ($25 in chips) 
Seat 3: Th3FldXKQW6hWVVPahaoOQ ($35.60 in chips) 
Seat 4: dfNim92Z6XK1/h5SFW5vDg ($25 in chips) 
Seat 5: iGMlK+EhUflPB6jKQd95Cg ($25.35 in chips) 
Seat 6: AiXn/9o1EwOPZUHujnh/bA ($18.50 in chips) 
Seat 9: 4awUyiDYTgylQKXZ9faBVA ($37.40 in chips) 
Th3FldXKQW6hWVVPahaoOQ: posts small blind $0.10
dfNim92Z6XK1/h5SFW5vDg: posts big blind $0.25
*** HOLE CARDS ***
iGMlK+EhUflPB6jKQd95Cg: folds 
AiXn/9o1EwOPZUHujnh/bA: folds 
4awUyiDYTgylQKXZ9faBVA: folds 
PqvgxdSg9z5VmrWpbYuz+g: folds 
Bb42QRQMhg5/Y0vHP8/2Xw: raises $0.75 to $1
Th3FldXKQW6hWVVPahaoOQ: folds 
dfNim92Z6XK1/h5SFW5vDg: folds 
Uncalled bet ($0.75) returned to Bb42QRQMhg5/Y0vHP8/2Xw
Bb42QRQMhg5/Y0vHP8/2Xw collected $0.60 from pot
*** SUMMARY ***
Total pot $0.60 | Rake $0 
Seat 1: PqvgxdSg9z5VmrWpbYuz+g folded before Flop (didn't bet)
Seat 2: Bb42QRQMhg5/Y0vHP8/2Xw (button) collected ($0.60)
Seat 3: Th3FldXKQW6hWVVPahaoOQ (small blind) folded before Flop
Seat 4: dfNim92Z6XK1/h5SFW5vDg (big blind) folded before Flop
Seat 5: iGMlK+EhUflPB6jKQd95Cg folded before Flop (didn't bet)
Seat 6: AiXn/9o1EwOPZUHujnh/bA folded before Flop (didn't bet)
Seat 9: 4awUyiDYTgylQKXZ9faBVA folded before Flop (didn't bet)




PokerStars Game #59941870042:  Hold'em No Limit ($0.10/$0.25) - 2009/07/01 1:48:46 ET
Table 'h02LhQ7B/Zk4ETRxxHhGYA' 9-max Seat #5 is the button
Seat 1: sD+TKtt36XiiN6jqHiLwDA ($24.75 in chips) 
Seat 2: 9lvO/qyU+xrU95Teu1fv0g ($7.05 in chips) 
Seat 3: arxNSjreDRGFg13EAM2F1w ($30.40 in chips) 
Seat 4: ZyPfMsrS7T70lNdYA6rJ7w ($11 in chips) 
Seat 5: cUxk0Jk4lrUQv9CJl0LPlg ($28 in chips) 
Seat 6: UvM6sxFT7el5hVDehvWvTA ($30.45 in chips) 
Seat 7: y7w8+Oqq4SkI1dkRDCx2Zg ($3.50 in chips) 
Seat 8: mUoFJKqCzIUABvOFbiINlQ ($15.20 in chips) 
Seat 9: HcU1ud5gMXGuhN1QChAhfQ ($24.75 in chips) 
UvM6sxFT7el5hVDehvWvTA: posts small blind $0.10
y7w8+Oqq4SkI1dkRDCx2Zg: posts big blind $0.25
ZyPfMsrS7T70lNdYA6rJ7w: posts big blind $0.25
*** HOLE CARDS ***
mUoFJKqCzIUABvOFbiINlQ: folds 
HcU1ud5gMXGuhN1QChAhfQ: folds 
sD+TKtt36XiiN6jqHiLwDA: folds 
9lvO/qyU+xrU95Teu1fv0g: folds 
arxNSjreDRGFg13EAM2F1w: folds 
ZyPfMsrS7T70lNdYA6rJ7w: checks 
cUxk0Jk4lrUQv9CJl0LPlg: folds 
UvM6sxFT7el5hVDehvWvTA: calls $0.15
y7w8+Oqq4SkI1dkRDCx2Zg: checks 
*** FLOP *** [Kd Ah 5c]
UvM6sxFT7el5hVDehvWvTA: checks 
y7w8+Oqq4SkI1dkRDCx2Zg: checks 
ZyPfMsrS7T70lNdYA6rJ7w: bets $0.25
UvM6sxFT7el5hVDehvWvTA: raises $0.50 to $0.75
y7w8+Oqq4SkI1dkRDCx2Zg: folds 
ZyPfMsrS7T70lNdYA6rJ7w: folds 
Uncalled bet ($0.50) returned to UvM6sxFT7el5hVDehvWvTA
UvM6sxFT7el5hVDehvWvTA collected $1.20 from pot
UvM6sxFT7el5hVDehvWvTA: doesn't show hand 
*** SUMMARY ***
Total pot $1.25 | Rake $0.05 
Board [Kd Ah 5c]
Seat 1: sD+TKtt36XiiN6jqHiLwDA folded before Flop (didn't bet)
Seat 2: 9lvO/qyU+xrU95Teu1fv0g folded before Flop (didn't bet)
Seat 3: arxNSjreDRGFg13EAM2F1w folded before Flop (didn't bet)
Seat 4: ZyPfMsrS7T70lNdYA6rJ7w folded on the Flop
Seat 5: cUxk0Jk4lrUQv9CJl0LPlg (button) folded before Flop (didn't bet)
Seat 6: UvM6sxFT7el5hVDehvWvTA (small blind) collected ($1.20)
Seat 7: y7w8+Oqq4SkI1dkRDCx2Zg (big blind) folded on the Flop
Seat 8: mUoFJKqCzIUABvOFbiINlQ folded before Flop (didn't bet)
Seat 9: HcU1ud5gMXGuhN1QChAhfQ folded before Flop (didn't bet)




PokerStars Game #59941870518:  Hold'em No Limit ($0.10/$0.25) - 2009/07/01 1:48:47 ET
Table '9SExUHslNkrPJ4XsrePaVw' 9-max Seat #8 is the button
Seat 1: RHqgdFvufLCYe54+qd2gcA ($4.50 in chips) 
Seat 2: cZ99hugmLBj9KhTlc8nCSw ($44.10 in chips) 
Seat 3: EP17SQz/iWcuYdNOGeBgkw ($13.80 in chips) 
Seat 4: 4awUyiDYTgylQKXZ9faBVA ($25 in chips) 
Seat 5: L+eJnUyhY8bMNYw755K8XQ ($15.40 in chips) 
Seat 6: YPJ90cgNXDABdYJcqmwB0A ($20.60 in chips) 
Seat 7: sx0lGrkT9fd4yFR+3cXUQg ($12 in chips) 
Seat 8: tLcDklc2rBORNfixyRfVfw ($26.35 in chips) 
Seat 9: /THNzAxdv2lBxcf4XTj/0g ($9.45 in chips) 
/THNzAxdv2lBxcf4XTj/0g: posts small blind $0.10
RHqgdFvufLCYe54+qd2gcA: posts big blind $0.25
sx0lGrkT9fd4yFR+3cXUQg: posts big blind $0.25
*** HOLE CARDS ***
cZ99hugmLBj9KhTlc8nCSw: folds 
EP17SQz/iWcuYdNOGeBgkw: folds 
4awUyiDYTgylQKXZ9faBVA: raises $1 to $1.25
L+eJnUyhY8bMNYw755K8XQ: folds 
YPJ90cgNXDABdYJcqmwB0A: folds 
sx0lGrkT9fd4yFR+3cXUQg: folds 
tLcDklc2rBORNfixyRfVfw: folds 
/THNzAxdv2lBxcf4XTj/0g: calls $1.15
RHqgdFvufLCYe54+qd2gcA: folds 
*** FLOP *** [3c 5c Kd]
/THNzAxdv2lBxcf4XTj/0g: checks 
4awUyiDYTgylQKXZ9faBVA: bets $1.50
/THNzAxdv2lBxcf4XTj/0g: raises $3.25 to $4.75
4awUyiDYTgylQKXZ9faBVA: folds 
Uncalled bet ($3.25) returned to /THNzAxdv2lBxcf4XTj/0g
/THNzAxdv2lBxcf4XTj/0g collected $5.75 from pot
/THNzAxdv2lBxcf4XTj/0g: doesn't show hand 
*** SUMMARY ***
Total pot $6 | Rake $0.25 
Board [3c 5c Kd]
Seat 1: RHqgdFvufLCYe54+qd2gcA (big blind) folded before Flop
Seat 2: cZ99hugmLBj9KhTlc8nCSw folded before Flop (didn't bet)
Seat 3: EP17SQz/iWcuYdNOGeBgkw folded before Flop (didn't bet)
Seat 4: 4awUyiDYTgylQKXZ9faBVA folded on the Flop
Seat 5: L+eJnUyhY8bMNYw755K8XQ folded before Flop (didn't bet)
Seat 6: YPJ90cgNXDABdYJcqmwB0A folded before Flop (didn't bet)
Seat 7: sx0lGrkT9fd4yFR+3cXUQg folded before Flop
Seat 8: tLcDklc2rBORNfixyRfVfw (button) folded before Flop (didn't bet)
Seat 9: /THNzAxdv2lBxcf4XTj/0g (small blind) collected ($5.75)




PokerStars Game #59941870530:  Hold'em No Limit ($0.10/$0.25) - 2009/07/01 1:48:47 ET
Table '8QBBaev+cI2i/r2H6ml/lg' 9-max Seat #1 is the button
Seat 1: s2xLPOl/vhl/26apJ3vsOQ ($36.45 in chips) 
Seat 2: y7tkvDmwKjURBkr73SZPXw ($11.25 in chips) 
Seat 3: zgi+EUykT/pZQpoUG6+oEg ($4.30 in chips) 
Seat 4: ytpGB2nr/CLVHnyKMRiEFQ ($18.20 in chips) 
Seat 5: 0QdZrkFD7aGKeBXPGbIomA ($11.45 in chips) 
Seat 6: X6+pSIPfovPcE87t+LmUKQ ($5 in chips) 
Seat 7: eK8qa6EPcH2zhtbmWSvc9g ($29.70 in chips) 
Seat 8: vr1IK/Q4HXm8s8V0/dePzQ ($11.60 in chips) 
Seat 9: EUMLvzDkECHBit+xa+uGjg ($23.75 in chips) 
y7tkvDmwKjURBkr73SZPXw: posts small blind $0.10
zgi+EUykT/pZQpoUG6+oEg: posts big blind $0.25
*** HOLE CARDS ***
ytpGB2nr/CLVHnyKMRiEFQ: folds 
0QdZrkFD7aGKeBXPGbIomA: folds 
X6+pSIPfovPcE87t+LmUKQ: folds 
eK8qa6EPcH2zhtbmWSvc9g: raises $0.50 to $0.75
vr1IK/Q4HXm8s8V0/dePzQ: folds 
EUMLvzDkECHBit+xa+uGjg: folds 
s2xLPOl/vhl/26apJ3vsOQ: folds 
y7tkvDmwKjURBkr73SZPXw: folds 
zgi+EUykT/pZQpoUG6+oEg: folds 
Uncalled bet ($0.50) returned to eK8qa6EPcH2zhtbmWSvc9g
eK8qa6EPcH2zhtbmWSvc9g collected $0.60 from pot
eK8qa6EPcH2zhtbmWSvc9g: doesn't show hand 
*** SUMMARY ***
Total pot $0.60 | Rake $0 
Seat 1: s2xLPOl/vhl/26apJ3vsOQ (button) folded before Flop (didn't bet)
Seat 2: y7tkvDmwKjURBkr73SZPXw (small blind) folded before Flop
Seat 3: zgi+EUykT/pZQpoUG6+oEg (big blind) folded before Flop
Seat 4: ytpGB2nr/CLVHnyKMRiEFQ folded before Flop (didn't bet)
Seat 5: 0QdZrkFD7aGKeBXPGbIomA folded before Flop (didn't bet)
Seat 6: X6+pSIPfovPcE87t+LmUKQ folded before Flop (didn't bet)
Seat 7: eK8qa6EPcH2zhtbmWSvc9g collected ($0.60)
Seat 8: vr1IK/Q4HXm8s8V0/dePzQ folded before Flop (didn't bet)
Seat 9: EUMLvzDkECHBit+xa+uGjg folded before Flop (didn't bet)




PokerStars Game #59941870480:  Hold'em No Limit ($0.10/$0.25) - 2009/07/01 1:48:47 ET
Table 'Xi38lWH8L2JHRAsKYVX8Qg' 6-max Seat #4 is the button
Seat 1: shP7DFAtX7gXcgMJX/OmRQ ($22.90 in chips) 
Seat 3: 6DwBRH+xZ12AAZmeAg+aXw ($31.20 in chips) 
Seat 4: kG34n23qFQA3nzdOJTQ1dA ($24.40 in chips) 
Seat 5: 79ID/ub1Pt/mDpCprVmOoA ($77.35 in chips) 
Seat 6: kyRaCIljYA6l33lSKQfNsg ($30.10 in chips) 
79ID/ub1Pt/mDpCprVmOoA: posts small blind $0.10
kyRaCIljYA6l33lSKQfNsg: posts big blind $0.25
*** HOLE CARDS ***
shP7DFAtX7gXcgMJX/OmRQ: folds 
6DwBRH+xZ12AAZmeAg+aXw: raises $0.50 to $0.75
kG34n23qFQA3nzdOJTQ1dA: folds 
79ID/ub1Pt/mDpCprVmOoA: folds 
kyRaCIljYA6l33lSKQfNsg: folds 
Uncalled bet ($0.50) returned to 6DwBRH+xZ12AAZmeAg+aXw
6DwBRH+xZ12AAZmeAg+aXw collected $0.60 from pot
6DwBRH+xZ12AAZmeAg+aXw: doesn't show hand 
*** SUMMARY ***
Total pot $0.60 | Rake $0 
Seat 1: shP7DFAtX7gXcgMJX/OmRQ folded before Flop (didn't bet)
Seat 3: 6DwBRH+xZ12AAZmeAg+aXw collected ($0.60)
Seat 4: kG34n23qFQA3nzdOJTQ1dA (button) folded before Flop (didn't bet)
Seat 5: 79ID/ub1Pt/mDpCprVmOoA (small blind) folded before Flop
Seat 6: kyRaCIljYA6l33lSKQfNsg (big blind) folded before Flop




PokerStars Game #59941871218:  Hold'em No Limit ($0.10/$0.25) - 2009/07/01 1:48:48 ET
Table 'ggwTHpIC5qhhHJSYjK1XCw' 6-max Seat #3 is the button
Seat 1: MqMK8OWPSY1V4stf1Hy5Jw ($80.50 in chips) 
Seat 2: /gJNBeCkWL4o85/jvlZ4BA ($26.20 in chips) 
Seat 3: 7cx44/slbeTw+Cy7QB8Trg ($24.50 in chips) 
Seat 4: JFIAqU8lCZ0vWwEl4bdGsg ($25 in chips) 
Seat 5: BvqhBa7W/To51LhEiIU/lw ($6.55 in chips) 
JFIAqU8lCZ0vWwEl4bdGsg: posts small blind $0.10
BvqhBa7W/To51LhEiIU/lw: posts big blind $0.25
*** HOLE CARDS ***
MqMK8OWPSY1V4stf1Hy5Jw: folds 
MqMK8OWPSY1V4stf1Hy5Jw leaves the table
/gJNBeCkWL4o85/jvlZ4BA: folds 
7cx44/slbeTw+Cy7QB8Trg: folds 
JFIAqU8lCZ0vWwEl4bdGsg: folds 
Uncalled bet ($0.15) returned to BvqhBa7W/To51LhEiIU/lw
BvqhBa7W/To51LhEiIU/lw collected $0.20 from pot
BvqhBa7W/To51LhEiIU/lw: doesn't show hand 
*** SUMMARY ***
Total pot $0.20 | Rake $0 
Seat 1: MqMK8OWPSY1V4stf1Hy5Jw folded before Flop (didn't bet)
Seat 2: /gJNBeCkWL4o85/jvlZ4BA folded before Flop (didn't bet)
Seat 3: 7cx44/slbeTw+Cy7QB8Trg (button) folded before Flop (didn't bet)
Seat 4: JFIAqU8lCZ0vWwEl4bdGsg (small blind) folded before Flop
Seat 5: BvqhBa7W/To51LhEiIU/lw (big blind) collected ($0.20)




PokerStars Game #59941871048:  Hold'em No Limit ($0.10/$0.25) - 2009/07/01 1:48:48 ET
Table 'srBTB98reCdD1TffxE6o7g' 6-max Seat #4 is the button
Seat 1: SFmT9ZsVopnukjvAzrxTRg ($36.90 in chips) 
Seat 2: mfrkWA3PTeYPkbO6hi98Aw ($25 in chips) 
Seat 4: 6DwBRH+xZ12AAZmeAg+aXw ($16.20 in chips) 
Seat 5: K1zv48sQUGQiaLk5VWWDqw ($24.85 in chips) 
Seat 6: BV+K0Phf5VBHr7aZPKqbUQ ($31.60 in chips) 
K1zv48sQUGQiaLk5VWWDqw: posts small blind $0.10
BV+K0Phf5VBHr7aZPKqbUQ: posts big blind $0.25
*** HOLE CARDS ***
SFmT9ZsVopnukjvAzrxTRg: folds 
mfrkWA3PTeYPkbO6hi98Aw: folds 
6DwBRH+xZ12AAZmeAg+aXw: folds 
K1zv48sQUGQiaLk5VWWDqw: raises $0.50 to $0.75
BV+K0Phf5VBHr7aZPKqbUQ: calls $0.50
*** FLOP *** [Kh 4c Ac]
K1zv48sQUGQiaLk5VWWDqw: bets $1
BV+K0Phf5VBHr7aZPKqbUQ: folds 
Uncalled bet ($1) returned to K1zv48sQUGQiaLk5VWWDqw
K1zv48sQUGQiaLk5VWWDqw collected $1.45 from pot
K1zv48sQUGQiaLk5VWWDqw: doesn't show hand 
*** SUMMARY ***
Total pot $1.50 | Rake $0.05 
Board [Kh 4c Ac]
Seat 1: SFmT9ZsVopnukjvAzrxTRg folded before Flop (didn't bet)
Seat 2: mfrkWA3PTeYPkbO6hi98Aw folded before Flop (didn't bet)
Seat 4: 6DwBRH+xZ12AAZmeAg+aXw (button) folded before Flop (didn't bet)
Seat 5: K1zv48sQUGQiaLk5VWWDqw (small blind) collected ($1.45)
Seat 6: BV+K0Phf5VBHr7aZPKqbUQ (big blind) folded on the Flop




PokerStars Game #59941870980:  Hold'em No Limit ($0.10/$0.25) - 2009/07/01 1:48:48 ET
Table 'Qr+t8WGovMECkBv+cV1lrg' 6-max Seat #4 is the button
Seat 1: EeUZtMU058v2ObUACOF4Og ($44.75 in chips) 
Seat 2: vqWjZmdQu/Hxw96/IJTWdQ ($41.60 in chips) 
Seat 3: uZKkrGByYgd4/ZBX2d4z+w ($10.90 in chips) 
Seat 4: 1NNFfYMd5Hsphl/FYz9fNA ($59.80 in chips) 
Seat 6: 9U3ZKjCsarN0DjR6mSE8Ug ($14.45 in chips) 
I50OxuNg9riRq9sywF6jMQ will be allowed to play after the button
9U3ZKjCsarN0DjR6mSE8Ug: posts small blind $0.10
EeUZtMU058v2ObUACOF4Og: posts big blind $0.25
*** HOLE CARDS ***
vqWjZmdQu/Hxw96/IJTWdQ: folds 
uZKkrGByYgd4/ZBX2d4z+w: folds 
1NNFfYMd5Hsphl/FYz9fNA: raises $0.50 to $0.75
9U3ZKjCsarN0DjR6mSE8Ug: folds 
EeUZtMU058v2ObUACOF4Og: folds 
Uncalled bet ($0.50) returned to 1NNFfYMd5Hsphl/FYz9fNA
1NNFfYMd5Hsphl/FYz9fNA collected $0.60 from pot
1NNFfYMd5Hsphl/FYz9fNA: doesn't show hand 
*** SUMMARY ***
Total pot $0.60 | Rake $0 
Seat 1: EeUZtMU058v2ObUACOF4Og (big blind) folded before Flop
Seat 2: vqWjZmdQu/Hxw96/IJTWdQ folded before Flop (didn't bet)
Seat 3: uZKkrGByYgd4/ZBX2d4z+w folded before Flop (didn't bet)
Seat 4: 1NNFfYMd5Hsphl/FYz9fNA (button) collected ($0.60)
Seat 6: 9U3ZKjCsarN0DjR6mSE8Ug (small blind) folded before Flop




PokerStars Game #59941871018:  Hold'em No Limit ($0.10/$0.25) - 2009/07/01 1:48:48 ET
Table '9lYs7ljXi6AgFAxYHlKLJw' 9-max Seat #1 is the button
Seat 1: K0b5wNInj6hUGRr6yzKFtw ($36.65 in chips) 
Seat 2: 0XACOSNrAWmqNv9k1nF8rw ($16.45 in chips) 
Seat 3: arxNSjreDRGFg13EAM2F1w ($33.45 in chips) 
Seat 4: UANt6y/SmDCY/jIxkBixcw ($33 in chips) 
Seat 5: dfNim92Z6XK1/h5SFW5vDg ($51.70 in chips) 
Seat 6: tYsOBqdU1+x+yFI7zHO7hQ ($25 in chips) 
Seat 7: ghNKXUBl/H+t83JF079ZBA ($28.75 in chips) 
Seat 8: 9YN2IkT2JYYKFErZtZvCtA ($18.60 in chips) 
Seat 9: cKlmpQMahVsmOaxFQDcoOg ($18.65 in chips) 
0XACOSNrAWmqNv9k1nF8rw: posts small blind $0.10
arxNSjreDRGFg13EAM2F1w: posts big blind $0.25
*** HOLE CARDS ***
UANt6y/SmDCY/jIxkBixcw: folds 
dfNim92Z6XK1/h5SFW5vDg: calls $0.25
tYsOBqdU1+x+yFI7zHO7hQ: folds 
ghNKXUBl/H+t83JF079ZBA: folds 
9YN2IkT2JYYKFErZtZvCtA: folds 
cKlmpQMahVsmOaxFQDcoOg: calls $0.25
K0b5wNInj6hUGRr6yzKFtw: folds 
0XACOSNrAWmqNv9k1nF8rw: folds 
arxNSjreDRGFg13EAM2F1w: checks 
*** FLOP *** [5s 5d 4s]
arxNSjreDRGFg13EAM2F1w: checks 
dfNim92Z6XK1/h5SFW5vDg: bets $0.50
cKlmpQMahVsmOaxFQDcoOg: folds 
arxNSjreDRGFg13EAM2F1w: calls $0.50
*** TURN *** [5s 5d 4s] [7s]
arxNSjreDRGFg13EAM2F1w: bets $0.75
dfNim92Z6XK1/h5SFW5vDg: raises $2.25 to $3
arxNSjreDRGFg13EAM2F1w: calls $2.25
*** RIVER *** [5s 5d 4s 7s] [5c]
arxNSjreDRGFg13EAM2F1w: bets $5
dfNim92Z6XK1/h5SFW5vDg said, "lol"
dfNim92Z6XK1/h5SFW5vDg said, "444"
dfNim92Z6XK1/h5SFW5vDg: folds 
Uncalled bet ($5) returned to arxNSjreDRGFg13EAM2F1w
arxNSjreDRGFg13EAM2F1w collected $7.50 from pot
arxNSjreDRGFg13EAM2F1w: doesn't show hand 
*** SUMMARY ***
Total pot $7.85 | Rake $0.35 
Board [5s 5d 4s 7s 5c]
Seat 1: K0b5wNInj6hUGRr6yzKFtw (button) folded before Flop (didn't bet)
Seat 2: 0XACOSNrAWmqNv9k1nF8rw (small blind) folded before Flop
Seat 3: arxNSjreDRGFg13EAM2F1w (big blind) collected ($7.50)
Seat 4: UANt6y/SmDCY/jIxkBixcw folded before Flop (didn't bet)
Seat 5: dfNim92Z6XK1/h5SFW5vDg folded on the River
Seat 6: tYsOBqdU1+x+yFI7zHO7hQ folded before Flop (didn't bet)
Seat 7: ghNKXUBl/H+t83JF079ZBA folded before Flop (didn't bet)
Seat 8: 9YN2IkT2JYYKFErZtZvCtA folded before Flop (didn't bet)
Seat 9: cKlmpQMahVsmOaxFQDcoOg folded on the Flop




PokerStars Game #59941870820:  Hold'em No Limit ($0.10/$0.25) - 2009/07/01 1:48:48 ET
Table 'IuqVbFI+pwnJjvwBCGSGAw' 6-max Seat #4 is the button
Seat 1: LyDHtw3/yniNHW+DvLXbog ($28.10 in chips) 
Seat 2: w43JQj2oYPpKQVG4Yzlq1w ($25 in chips) 
Seat 3: QiL+lEgEWwy21jk/ltaRLg ($21.05 in chips) 
Seat 4: DE9hRlt14g+JdsRQ4wT7hg ($27.05 in chips) 
Seat 5: if4dh6jhJXeN3/qd3qCp9g ($24.70 in chips) 
Seat 6: xC0kaiDYM6YTlgODL83O5A ($13.15 in chips) 
if4dh6jhJXeN3/qd3qCp9g: posts small blind $0.10
xC0kaiDYM6YTlgODL83O5A: posts big blind $0.25
*** HOLE CARDS ***
LyDHtw3/yniNHW+DvLXbog: folds 
w43JQj2oYPpKQVG4Yzlq1w: folds 
QiL+lEgEWwy21jk/ltaRLg: folds 
DE9hRlt14g+JdsRQ4wT7hg: raises $0.75 to $1
if4dh6jhJXeN3/qd3qCp9g: calls $0.90
xC0kaiDYM6YTlgODL83O5A: folds 
*** FLOP *** [Qs Jc 6d]
if4dh6jhJXeN3/qd3qCp9g: checks 
DE9hRlt14g+JdsRQ4wT7hg: bets $1.50
if4dh6jhJXeN3/qd3qCp9g: folds 
Uncalled bet ($1.50) returned to DE9hRlt14g+JdsRQ4wT7hg
DE9hRlt14g+JdsRQ4wT7hg collected $2.15 from pot
DE9hRlt14g+JdsRQ4wT7hg: doesn't show hand 
*** SUMMARY ***
Total pot $2.25 | Rake $0.10 
Board [Qs Jc 6d]
Seat 1: LyDHtw3/yniNHW+DvLXbog folded before Flop (didn't bet)
Seat 2: w43JQj2oYPpKQVG4Yzlq1w folded before Flop (didn't bet)
Seat 3: QiL+lEgEWwy21jk/ltaRLg folded before Flop (didn't bet)
Seat 4: DE9hRlt14g+JdsRQ4wT7hg (button) collected ($2.15)
Seat 5: if4dh6jhJXeN3/qd3qCp9g (small blind) folded on the Flop
Seat 6: xC0kaiDYM6YTlgODL83O5A (big blind) folded before Flop




PokerStars Game #59941870894:  Hold'em No Limit ($0.10/$0.25) - 2009/07/01 1:48:48 ET
Table '3LMlz3V4AziGlU+ikmyU8w' 6-max Seat #6 is the button
Seat 1: Wxq4Qyj0DnDXj2+taEOJFQ ($55.25 in chips) 
Seat 2: uR3AbFJLoOX86DOTtTgGcg ($25 in chips) 
Seat 3: Hzy03WtPHMYwLYM7hTTxQw ($31.45 in chips) 
Seat 4: 6DwBRH+xZ12AAZmeAg+aXw ($23.30 in chips) 
Seat 5: tOAk1Og4mVObMBOfvdDYOw ($25.50 in chips) 
Seat 6: 7LpHJVeM6k1mQdC6HXYzww ($25 in chips) 
Wxq4Qyj0DnDXj2+taEOJFQ: posts small blind $0.10
uR3AbFJLoOX86DOTtTgGcg: posts big blind $0.25
*** HOLE CARDS ***
Hzy03WtPHMYwLYM7hTTxQw: folds 
6DwBRH+xZ12AAZmeAg+aXw: folds 
tOAk1Og4mVObMBOfvdDYOw: raises $0.75 to $1
7LpHJVeM6k1mQdC6HXYzww: folds 
Wxq4Qyj0DnDXj2+taEOJFQ: folds 
uR3AbFJLoOX86DOTtTgGcg: folds 
Uncalled bet ($0.75) returned to tOAk1Og4mVObMBOfvdDYOw
tOAk1Og4mVObMBOfvdDYOw collected $0.60 from pot
tOAk1Og4mVObMBOfvdDYOw: doesn't show hand 
*** SUMMARY ***
Total pot $0.60 | Rake $0 
Seat 1: Wxq4Qyj0DnDXj2+taEOJFQ (small blind) folded before Flop
Seat 2: uR3AbFJLoOX86DOTtTgGcg (big blind) folded before Flop
Seat 3: Hzy03WtPHMYwLYM7hTTxQw folded before Flop (didn't bet)
Seat 4: 6DwBRH+xZ12AAZmeAg+aXw folded before Flop (didn't bet)
Seat 5: tOAk1Og4mVObMBOfvdDYOw collected ($0.60)
Seat 6: 7LpHJVeM6k1mQdC6HXYzww (button) folded before Flop (didn't bet)




PokerStars Game #59941870814:  Hold'em No Limit ($0.10/$0.25) - 2009/07/01 1:48:48 ET
Table '9o8Yb3JpUqurD4pNVmOikQ' 6-max Seat #6 is the button
Seat 1: SFmT9ZsVopnukjvAzrxTRg ($28.15 in chips) 
Seat 2: /gJNBeCkWL4o85/jvlZ4BA ($26.50 in chips) 
Seat 3: JgRqo1/2phbf7pab7N3BIQ ($23.25 in chips) 
Seat 4: j5NZbEJHsERuXjPHWqc1Nw ($10.10 in chips) 
Seat 5: QqiZLFrN8iOUT/GHw7ztOA ($23.80 in chips) 
Seat 6: LyDHtw3/yniNHW+DvLXbog ($25.35 in chips) 
SFmT9ZsVopnukjvAzrxTRg: posts small blind $0.10
/gJNBeCkWL4o85/jvlZ4BA: posts big blind $0.25
*** HOLE CARDS ***
JgRqo1/2phbf7pab7N3BIQ: folds 
j5NZbEJHsERuXjPHWqc1Nw: calls $0.25
QqiZLFrN8iOUT/GHw7ztOA: folds 
LyDHtw3/yniNHW+DvLXbog: folds 
SFmT9ZsVopnukjvAzrxTRg: folds 
/gJNBeCkWL4o85/jvlZ4BA: checks 
*** FLOP *** [4c Jh Tc]
/gJNBeCkWL4o85/jvlZ4BA: checks 
j5NZbEJHsERuXjPHWqc1Nw: bets $1
/gJNBeCkWL4o85/jvlZ4BA: folds 
Uncalled bet ($1) returned to j5NZbEJHsERuXjPHWqc1Nw
j5NZbEJHsERuXjPHWqc1Nw collected $0.60 from pot
*** SUMMARY ***
Total pot $0.60 | Rake $0 
Board [4c Jh Tc]
Seat 1: SFmT9ZsVopnukjvAzrxTRg (small blind) folded before Flop
Seat 2: /gJNBeCkWL4o85/jvlZ4BA (big blind) folded on the Flop
Seat 3: JgRqo1/2phbf7pab7N3BIQ folded before Flop (didn't bet)
Seat 4: j5NZbEJHsERuXjPHWqc1Nw collected ($0.60)
Seat 5: QqiZLFrN8iOUT/GHw7ztOA folded before Flop (didn't bet)
Seat 6: LyDHtw3/yniNHW+DvLXbog (button) folded before Flop (didn't bet)




PokerStars Game #59941871372:  Hold'em No Limit ($0.10/$0.25) - 2009/07/01 1:48:49 ET
Table '0XPo7K54oZIfG0xlNAcDRwnQC9LRg01NEuKFHF1nrDEw-max Seat #3 is the button
Seat 1: qf+LMbROj8/qY878wkFHbQ ($12.30 in chips) 
Seat 2: ZhV6dUX9NQhT4zf7t+ZLJg ($23.95 in chips) 
Seat 3: 6+g0Lb6vfRDZkElV8ieHyQ ($26.10 in chips) 
Seat 4: u3Ol7kv1LmvszuHNm9rc6w ($24.75 in chips) 
Seat 5: kG34n23qFQA3nzdOJTQ1dA ($28.45 in chips) 
Seat 6: xQVFeVUDopz+akuEo2wXpQ ($55.30 in chips) 
u3Ol7kv1LmvszuHNm9rc6w: posts small blind $0.10
kG34n23qFQA3nzdOJTQ1dA: posts big blind $0.25
*** HOLE CARDS ***
xQVFeVUDopz+akuEo2wXpQ: raises $0.25 to $0.50
qf+LMbROj8/qY878wkFHbQ: folds 
ZhV6dUX9NQhT4zf7t+ZLJg: folds 
6+g0Lb6vfRDZkElV8ieHyQ: folds 
u3Ol7kv1LmvszuHNm9rc6w: folds 
kG34n23qFQA3nzdOJTQ1dA: folds 
Uncalled bet ($0.25) returned to xQVFeVUDopz+akuEo2wXpQ
xQVFeVUDopz+akuEo2wXpQ collected $0.60 from pot
*** SUMMARY ***
Total pot $0.60 | Rake $0 
Seat 1: qf+LMbROj8/qY878wkFHbQ folded before Flop (didn't bet)
Seat 2: ZhV6dUX9NQhT4zf7t+ZLJg folded before Flop (didn't bet)
Seat 3: 6+g0Lb6vfRDZkElV8ieHyQ (button) folded before Flop (didn't bet)
Seat 4: u3Ol7kv1LmvszuHNm9rc6w (small blind) folded before Flop
Seat 5: kG34n23qFQA3nzdOJTQ1dA (big blind) folded before Flop
Seat 6: xQVFeVUDopz+akuEo2wXpQ collected ($0.60)




PokerStars Game #59941871422:  Hold'em No Limit ($0.10/$0.25) - 2009/07/01 1:48:49 ET
Table 'luMgmRPIo47e7iXDlheIwA' 6-max Seat #3 is the button
Seat 1: EQ3WxdGe/KZrM6Lx4T02sg ($37.90 in chips) 
Seat 2: NhUN/JpAprdJeamFBgJH1w ($25 in chips) 
Seat 3: w43JQj2oYPpKQVG4Yzlq1w ($25 in chips) 
Seat 4: xrf8tAXKQHG99HixCot1Iw ($26 in chips) 
Seat 5: cWc85bEzdRzpUMhRKm8pwQ ($45.25 in chips) 
Seat 6: qGHGf/553gQnDoklMRe3tg ($24.55 in chips) 
xrf8tAXKQHG99HixCot1Iw: posts small blind $0.10
cWc85bEzdRzpUMhRKm8pwQ: posts big blind $0.25
*** HOLE CARDS ***
qGHGf/553gQnDoklMRe3tg: folds 
EQ3WxdGe/KZrM6Lx4T02sg: folds 
NhUN/JpAprdJeamFBgJH1w: raises $0.75 to $1
w43JQj2oYPpKQVG4Yzlq1w: folds 
xrf8tAXKQHG99HixCot1Iw: folds 
cWc85bEzdRzpUMhRKm8pwQ: folds 
Uncalled bet ($0.75) returned to NhUN/JpAprdJeamFBgJH1w
NhUN/JpAprdJeamFBgJH1w collected $0.60 from pot
NhUN/JpAprdJeamFBgJH1w: doesn't show hand 
*** SUMMARY ***
Total pot $0.60 | Rake $0 
Seat 1: EQ3WxdGe/KZrM6Lx4T02sg folded before Flop (didn't bet)
Seat 2: NhUN/JpAprdJeamFBgJH1w collected ($0.60)
Seat 3: w43JQj2oYPpKQVG4Yzlq1w (button) folded before Flop (didn't bet)
Seat 4: xrf8tAXKQHG99HixCot1Iw (small blind) folded before Flop
Seat 5: cWc85bEzdRzpUMhRKm8pwQ (big blind) folded before Flop
Seat 6: qGHGf/553gQnDoklMRe3tg folded before Flop (didn't bet)




PokerStars Game #59941871692:  Hold'em No Limit ($0.10/$0.25) - 2009/07/01 1:48:49 ET
Table '63uh7ZsO7Tnt+E8b/2bu3A' 6-max Seat #2 is the button
Seat 1: 0av6tRNdi0Ui4f15L7gsVg ($29.85 in chips) 
Seat 2: SFmT9ZsVopnukjvAzrxTRg ($30.30 in chips) 
Seat 3: yVP7GLZBzx47OPi6jzUxMw ($5.10 in chips) 
Seat 4: rnpAao581IcvQglpkpnkoQ ($11 in chips) 
Seat 5: GbCVUNssQ7mqsPWr7J4d3w ($9.75 in chips) 
Seat 6: qGHGf/553gQnDoklMRe3tg ($26.90 in chips) 
yVP7GLZBzx47OPi6jzUxMw: posts small blind $0.10
rnpAao581IcvQglpkpnkoQ: posts big blind $0.25
*** HOLE CARDS ***
GbCVUNssQ7mqsPWr7J4d3w: folds 
qGHGf/553gQnDoklMRe3tg: folds 
0av6tRNdi0Ui4f15L7gsVg: folds 
GbCVUNssQ7mqsPWr7J4d3w leaves the table
SFmT9ZsVopnukjvAzrxTRg: folds 
yVP7GLZBzx47OPi6jzUxMw: calls $0.15
rnpAao581IcvQglpkpnkoQ: checks 
*** FLOP *** [As 8h Ts]
yVP7GLZBzx47OPi6jzUxMw: bets $0.25
rnpAao581IcvQglpkpnkoQ: raises $1 to $1.25
Hsvkc0/G2VV78oVmWYXecw joins the table at seat #5 
yVP7GLZBzx47OPi6jzUxMw: calls $1
*** TURN *** [As 8h Ts] [7h]
yVP7GLZBzx47OPi6jzUxMw: checks 
rnpAao581IcvQglpkpnkoQ: checks 
*** RIVER *** [As 8h Ts 7h] [5c]
yVP7GLZBzx47OPi6jzUxMw: checks 
rnpAao581IcvQglpkpnkoQ: checks 
*** SHOW DOWN ***
yVP7GLZBzx47OPi6jzUxMw: shows [6s 2s] (high card Ace)
rnpAao581IcvQglpkpnkoQ: shows [9d Ah] (a pair of Aces)
rnpAao581IcvQglpkpnkoQ collected $2.85 from pot
*** SUMMARY ***
Total pot $3 | Rake $0.15 
Board [As 8h Ts 7h 5c]
Seat 1: 0av6tRNdi0Ui4f15L7gsVg folded before Flop (didn't bet)
Seat 2: SFmT9ZsVopnukjvAzrxTRg (button) folded before Flop (didn't bet)
Seat 3: yVP7GLZBzx47OPi6jzUxMw (small blind) showed [6s 2s] and lost with high card Ace
Seat 4: rnpAao581IcvQglpkpnkoQ (big blind) showed [9d Ah] and won ($2.85) with a pair of Aces
Seat 5: GbCVUNssQ7mqsPWr7J4d3w folded before Flop (didn't bet)
Seat 6: qGHGf/553gQnDoklMRe3tg folded before Flop (didn't bet)




PokerStars Game #59941871532:  Hold'em No Limit ($0.10/$0.25) - 2009/07/01 1:48:49 ET
Table 'IIO2q2znuuAXmiZ2qFTcmg' 6-max Seat #3 is the button
Seat 3: j0aDOn9Nft1HLTQvGu1UwA ($5 in chips) 
Seat 5: iHZrkhpIO/3+tKuAoPx8HQ ($15 in chips) 
Seat 6: eccZOodwLtdyXmuZVw+l1w ($9.40 in chips) 
iHZrkhpIO/3+tKuAoPx8HQ: posts small blind $0.10
eccZOodwLtdyXmuZVw+l1w: posts big blind $0.25
*** HOLE CARDS ***
i9LqF5rD3bvtbEE7HWgr3Q joins the table at seat #2 
j0aDOn9Nft1HLTQvGu1UwA: calls $0.25
iHZrkhpIO/3+tKuAoPx8HQ: calls $0.15
eccZOodwLtdyXmuZVw+l1w: raises $9.15 to $9.40 and is all-in
j0aDOn9Nft1HLTQvGu1UwA: calls $4.75 and is all-in
iHZrkhpIO/3+tKuAoPx8HQ: folds 
Uncalled bet ($4.40) returned to eccZOodwLtdyXmuZVw+l1w
*** FLOP *** [As Qc 9c]
*** TURN *** [As Qc 9c] [5d]
*** RIVER *** [As Qc 9c 5d] [Ad]
*** SHOW DOWN ***
eccZOodwLtdyXmuZVw+l1w: shows [9s Js] (two pair, Aces and Nines)
j0aDOn9Nft1HLTQvGu1UwA: shows [Ac 4s] (three of a kind, Aces)
j0aDOn9Nft1HLTQvGu1UwA collected $9.75 from pot
*** SUMMARY ***
Total pot $10.25 | Rake $0.50 
Board [As Qc 9c 5d Ad]
Seat 3: j0aDOn9Nft1HLTQvGu1UwA (button) showed [Ac 4s] and won ($9.75) with three of a kind, Aces
Seat 5: iHZrkhpIO/3+tKuAoPx8HQ (small blind) folded before Flop
Seat 6: eccZOodwLtdyXmuZVw+l1w (big blind) showed [9s Js] and lost with two pair, Aces and Nines




PokerStars Game #59941872362:  Hold'em No Limit ($0.10/$0.25) - 2009/07/01 1:48:50 ET
Table 'ER5H84HUgJx7HyDLnELLeA' 6-max Seat #2 is the button
Seat 1: LJI7A1YgDM7hgh7o56+ReQ ($26.25 in chips) 
Seat 2: buyjetgNT1McXtdaP4zynA ($20.90 in chips) 
Seat 3: cS21pIxRHx5Gt42o7hPZzw ($12.75 in chips) 
Seat 4: vqWjZmdQu/Hxw96/IJTWdQ ($25 in chips) 
Seat 5: mfrkWA3PTeYPkbO6hi98Aw ($26.35 in chips) 
Seat 6: 3zD3qLXT1bEffAoWGnc7wg ($51.35 in chips) 
cS21pIxRHx5Gt42o7hPZzw: posts small blind $0.10
vqWjZmdQu/Hxw96/IJTWdQ: posts big blind $0.25
*** HOLE CARDS ***
mfrkWA3PTeYPkbO6hi98Aw: folds 
3zD3qLXT1bEffAoWGnc7wg: folds 
LJI7A1YgDM7hgh7o56+ReQ: folds 
buyjetgNT1McXtdaP4zynA has timed out
buyjetgNT1McXtdaP4zynA: folds 
buyjetgNT1McXtdaP4zynA is sitting out
cS21pIxRHx5Gt42o7hPZzw: calls $0.15
vqWjZmdQu/Hxw96/IJTWdQ: checks 
*** FLOP *** [9s 5c 3d]
cS21pIxRHx5Gt42o7hPZzw: checks 
buyjetgNT1McXtdaP4zynA said, "un junky"
vqWjZmdQu/Hxw96/IJTWdQ: checks 
*** TURN *** [9s 5c 3d] [4c]
cS21pIxRHx5Gt42o7hPZzw: bets $1
vqWjZmdQu/Hxw96/IJTWdQ: folds 
Uncalled bet ($1) returned to cS21pIxRHx5Gt42o7hPZzw
cS21pIxRHx5Gt42o7hPZzw collected $0.50 from pot
cS21pIxRHx5Gt42o7hPZzw: doesn't show hand 
*** SUMMARY ***
Total pot $0.50 | Rake $0 
Board [9s 5c 3d 4c]
Seat 1: LJI7A1YgDM7hgh7o56+ReQ folded before Flop (didn't bet)
Seat 2: buyjetgNT1McXtdaP4zynA (button) folded before Flop (didn't bet)
Seat 3: cS21pIxRHx5Gt42o7hPZzw (small blind) collected ($0.50)
Seat 4: vqWjZmdQu/Hxw96/IJTWdQ (big blind) folded on the Turn
Seat 5: mfrkWA3PTeYPkbO6hi98Aw folded before Flop (didn't bet)
Seat 6: 3zD3qLXT1bEffAoWGnc7wg folded before Flop (didn't bet)




PokerStars Game #59941872536:  Hold'em No Limit ($0.10/$0.25) - 2009/07/01 1:48:51 ET
Table 'fHv1Mk7ZbLjprZTGWKPiEQ' 6-max Seat #3 is the button
Seat 1: OIjOiBfQstWrK/RuXx7zcw ($3.70 in chips) 
Seat 2: 9U3ZKjCsarN0DjR6mSE8Ug ($14.05 in chips) 
Seat 3: /gJNBeCkWL4o85/jvlZ4BA ($25 in chips) 
Seat 4: TSmua8tGK3sTbwi0ynrW9Q ($60.75 in chips) 
Seat 5: LJI7A1YgDM7hgh7o56+ReQ ($25.30 in chips) 
Seat 6: AjG0X+rNtc2W08eph8oqpw ($52.40 in chips) 
TSmua8tGK3sTbwi0ynrW9Q: posts small blind $0.10
LJI7A1YgDM7hgh7o56+ReQ: posts big blind $0.25
*** HOLE CARDS ***
AjG0X+rNtc2W08eph8oqpw: folds 
OIjOiBfQstWrK/RuXx7zcw has timed out
OIjOiBfQstWrK/RuXx7zcw: folds 
OIjOiBfQstWrK/RuXx7zcw is sitting out
9U3ZKjCsarN0DjR6mSE8Ug: folds 
OIjOiBfQstWrK/RuXx7zcw has returned
/gJNBeCkWL4o85/jvlZ4BA: folds 
TSmua8tGK3sTbwi0ynrW9Q: raises $0.50 to $0.75
LJI7A1YgDM7hgh7o56+ReQ: raises $2.25 to $3
TSmua8tGK3sTbwi0ynrW9Q: folds 
Uncalled bet ($2.25) returned to LJI7A1YgDM7hgh7o56+ReQ
LJI7A1YgDM7hgh7o56+ReQ collected $1.50 from pot
LJI7A1YgDM7hgh7o56+ReQ: doesn't show hand 
*** SUMMARY ***
Total pot $1.50 | Rake $0 
Seat 1: OIjOiBfQstWrK/RuXx7zcw folded before Flop (didn't bet)
Seat 2: 9U3ZKjCsarN0DjR6mSE8Ug folded before Flop (didn't bet)
Seat 3: /gJNBeCkWL4o85/jvlZ4BA (button) folded before Flop (didn't bet)
Seat 4: TSmua8tGK3sTbwi0ynrW9Q (small blind) folded before Flop
Seat 5: LJI7A1YgDM7hgh7o56+ReQ (big blind) collected ($1.50)
Seat 6: AjG0X+rNtc2W08eph8oqpw folded before Flop (didn't bet)




PokerStars Game #59941872894:  Hold'em No Limit ($0.10/$0.25) - 2009/07/01 1:48:51 ET
Table 'nIRjSqm6RYUWJlyW2loYKA' 6-max Seat #1 is the button
Seat 1: w43JQj2oYPpKQVG4Yzlq1w ($25 in chips) 
Seat 2: NndRCAk4vU5JGDhTyy5LZg ($14.05 in chips) 
Seat 3: qjs7u/BI35gu5OgtqfLCZw ($12.30 in chips) 
Seat 4: /ZSSWvl8im2y38j1uEUAGA ($8.25 in chips) 
Seat 5: df01R5ThvHspD8FgKmaDvQ ($24.40 in chips) 
Seat 6: OIjOiBfQstWrK/RuXx7zcw ($6.85 in chips) 
NndRCAk4vU5JGDhTyy5LZg: posts small blind $0.10
qjs7u/BI35gu5OgtqfLCZw: posts big blind $0.25
*** HOLE CARDS ***
/ZSSWvl8im2y38j1uEUAGA: folds 
df01R5ThvHspD8FgKmaDvQ: folds 
OIjOiBfQstWrK/RuXx7zcw: folds 
w43JQj2oYPpKQVG4Yzlq1w: folds 
NndRCAk4vU5JGDhTyy5LZg: folds 
Uncalled bet ($0.15) returned to qjs7u/BI35gu5OgtqfLCZw
qjs7u/BI35gu5OgtqfLCZw collected $0.20 from pot
qjs7u/BI35gu5OgtqfLCZw: doesn't show hand 
*** SUMMARY ***
Total pot $0.20 | Rake $0 
Seat 1: w43JQj2oYPpKQVG4Yzlq1w (button) folded before Flop (didn't bet)
Seat 2: NndRCAk4vU5JGDhTyy5LZg (small blind) folded before Flop
Seat 3: qjs7u/BI35gu5OgtqfLCZw (big blind) collected ($0.20)
Seat 4: /ZSSWvl8im2y38j1uEUAGA folded before Flop (didn't bet)
Seat 5: df01R5ThvHspD8FgKmaDvQ folded before Flop (didn't bet)
Seat 6: OIjOiBfQstWrK/RuXx7zcw folded before Flop (didn't bet)




PokerStars Game #59941872412:  Hold'em No Limit ($0.10/$0.25) - 2009/07/01 1:48:51 ET
Table 'Y9EhDWuqWWQFM9SelXAj5g' 9-max Seat #6 is the button
Seat 1: zDrucyjVn5aeekNEc3cJrA ($32.30 in chips) 
Seat 2: W+njF1UnarGN2q2zP+R+cg ($11.40 in chips) 
Seat 4: V6p0jQ/RhUsqpHLmXvEX4Q ($13 in chips) 
Seat 5: CvL9Ch1HYCVbTsfpNucitg ($6.20 in chips) 
Seat 6: egvg3mTBBVzMHnJPIQiKcA ($13.65 in chips) 
Seat 8: XDxyajtqmdag0QPvwcOG7Q ($14.35 in chips) 
Seat 9: bOrfviVhRBpaOfMqUc74Tw ($17.40 in chips) 
XDxyajtqmdag0QPvwcOG7Q: posts small blind $0.10
bOrfviVhRBpaOfMqUc74Tw: posts big blind $0.25
*** HOLE CARDS ***
zDrucyjVn5aeekNEc3cJrA: folds 
W+njF1UnarGN2q2zP+R+cg: raises $0.25 to $0.50
V6p0jQ/RhUsqpHLmXvEX4Q: folds 
CvL9Ch1HYCVbTsfpNucitg: folds 
egvg3mTBBVzMHnJPIQiKcA: folds 
XDxyajtqmdag0QPvwcOG7Q: folds 
bOrfviVhRBpaOfMqUc74Tw: calls $0.25
*** FLOP *** [5c 4s 5s]
bOrfviVhRBpaOfMqUc74Tw: checks 
W+njF1UnarGN2q2zP+R+cg: bets $1.25
bOrfviVhRBpaOfMqUc74Tw: folds 
Uncalled bet ($1.25) returned to W+njF1UnarGN2q2zP+R+cg
W+njF1UnarGN2q2zP+R+cg collected $1.05 from pot
W+njF1UnarGN2q2zP+R+cg: doesn't show hand 
XBq1lBzax7LjRqdJP2TqWg has returned
*** SUMMARY ***
Total pot $1.10 | Rake $0.05 
Board [5c 4s 5s]
Seat 1: zDrucyjVn5aeekNEc3cJrA folded before Flop (didn't bet)
Seat 2: W+njF1UnarGN2q2zP+R+cg collected ($1.05)
Seat 4: V6p0jQ/RhUsqpHLmXvEX4Q folded before Flop (didn't bet)
Seat 5: CvL9Ch1HYCVbTsfpNucitg folded before Flop (didn't bet)
Seat 6: egvg3mTBBVzMHnJPIQiKcA (button) folded before Flop (didn't bet)
Seat 8: XDxyajtqmdag0QPvwcOG7Q (small blind) folded before Flop
Seat 9: bOrfviVhRBpaOfMqUc74Tw (big blind) folded on the Flop




PokerStars Game #59941872554:  Hold'em No Limit ($0.10/$0.25) - 2009/07/01 1:48:51 ET
Table 'P2yJ+jwfNsBdF12fLKA6DQ' 9-max Seat #2 is the button
Seat 1: zDrucyjVn5aeekNEc3cJrA ($22.45 in chips) 
Seat 2: uQwmfH5LEVA5eyghJdyPUg ($14.90 in chips) 
Seat 3: 8EbrQ/EvFWt2cr0GaU82gQ ($4.75 in chips) 
Seat 4: 6NLAWFPZZfqlVkY8n9RULA ($13.75 in chips) 
Seat 5: B7VAFAMs/PYlYABlV+EkSA ($7.80 in chips) 
Seat 6: mUoFJKqCzIUABvOFbiINlQ ($14.25 in chips) 
Seat 7: yQc5nLaNmByxI15Jegu61w ($17.90 in chips) 
Seat 8: LMd3gq2uNfbWTfXTnSeQRw ($9.05 in chips) 
Seat 9: dN5zq7QdZCUe7NZFM6cECg ($19.15 in chips) 
8EbrQ/EvFWt2cr0GaU82gQ: posts small blind $0.10
6NLAWFPZZfqlVkY8n9RULA: posts big blind $0.25
*** HOLE CARDS ***
B7VAFAMs/PYlYABlV+EkSA: folds 
mUoFJKqCzIUABvOFbiINlQ: calls $0.25
yQc5nLaNmByxI15Jegu61w: calls $0.25
LMd3gq2uNfbWTfXTnSeQRw: calls $0.25
dN5zq7QdZCUe7NZFM6cECg: folds 
zDrucyjVn5aeekNEc3cJrA: calls $0.25
uQwmfH5LEVA5eyghJdyPUg: folds 
8EbrQ/EvFWt2cr0GaU82gQ: folds 
6NLAWFPZZfqlVkY8n9RULA: checks 
*** FLOP *** [6s 4h Qc]
6NLAWFPZZfqlVkY8n9RULA: checks 
mUoFJKqCzIUABvOFbiINlQ: checks 
yQc5nLaNmByxI15Jegu61w: checks 
LMd3gq2uNfbWTfXTnSeQRw: checks 
zDrucyjVn5aeekNEc3cJrA: checks 
*** TURN *** [6s 4h Qc] [3s]
6NLAWFPZZfqlVkY8n9RULA: checks 
mUoFJKqCzIUABvOFbiINlQ: checks 
yQc5nLaNmByxI15Jegu61w: checks 
LMd3gq2uNfbWTfXTnSeQRw: bets $0.75
zDrucyjVn5aeekNEc3cJrA: folds 
6NLAWFPZZfqlVkY8n9RULA: folds 
mUoFJKqCzIUABvOFbiINlQ: folds 
yQc5nLaNmByxI15Jegu61w: folds 
Uncalled bet ($0.75) returned to LMd3gq2uNfbWTfXTnSeQRw
LMd3gq2uNfbWTfXTnSeQRw collected $1.30 from pot
*** SUMMARY ***
Total pot $1.35 | Rake $0.05 
Board [6s 4h Qc 3s]
Seat 1: zDrucyjVn5aeekNEc3cJrA folded on the Turn
Seat 2: uQwmfH5LEVA5eyghJdyPUg (button) folded before Flop (didn't bet)
Seat 3: 8EbrQ/EvFWt2cr0GaU82gQ (small blind) folded before Flop
Seat 4: 6NLAWFPZZfqlVkY8n9RULA (big blind) folded on the Turn
Seat 5: B7VAFAMs/PYlYABlV+EkSA folded before Flop (didn't bet)
Seat 6: mUoFJKqCzIUABvOFbiINlQ folded on the Turn
Seat 7: yQc5nLaNmByxI15Jegu61w folded on the Turn
Seat 8: LMd3gq2uNfbWTfXTnSeQRw collected ($1.30)
Seat 9: dN5zq7QdZCUe7NZFM6cECg folded before Flop (didn't bet)




PokerStars Game #59941872530:  Hold'em No Limit ($0.10/$0.25) - 2009/07/01 1:48:51 ET
Table 'YlRA05h9BJ1EhOUSNUjJdg' 9-max Seat #4 is the button
Seat 1: dtZ84flFEi4Q+SGrHMJRDQ ($25 in chips) 
Seat 2: Y2GFAe+PT7xnUUtgqCNDFw ($8.95 in chips) 
Seat 3: Z5ZtGOON8kmSdSCll9Z3XA ($12.85 in chips) 
Seat 4: HPEB+AtKw1+C/cxU0o1ciw ($33.95 in chips) 
Seat 5: sx0lGrkT9fd4yFR+3cXUQg ($11.40 in chips) 
Seat 6: QEbIGci+itdw+re8RM5fZA ($44 in chips) 
Seat 7: dfNim92Z6XK1/h5SFW5vDg ($25 in chips) 
Seat 8: dmYlc+1cjwZMJ7wV+Z0rRg ($32.90 in chips) 
Seat 9: Z9AeOQX3yzuSvKAm/xyovg ($11.35 in chips) 
sx0lGrkT9fd4yFR+3cXUQg: posts small blind $0.10
QEbIGci+itdw+re8RM5fZA: posts big blind $0.25
*** HOLE CARDS ***
dfNim92Z6XK1/h5SFW5vDg: folds 
dmYlc+1cjwZMJ7wV+Z0rRg: folds 
Z9AeOQX3yzuSvKAm/xyovg: folds 
Z9AeOQX3yzuSvKAm/xyovg leaves the table
dtZ84flFEi4Q+SGrHMJRDQ: folds 
Y2GFAe+PT7xnUUtgqCNDFw: calls $0.25
Z5ZtGOON8kmSdSCll9Z3XA: folds 
HPEB+AtKw1+C/cxU0o1ciw: folds 
sx0lGrkT9fd4yFR+3cXUQg: calls $0.15
QEbIGci+itdw+re8RM5fZA: checks 
*** FLOP *** [3d Qc 9d]
sx0lGrkT9fd4yFR+3cXUQg: checks 
QEbIGci+itdw+re8RM5fZA: checks 
Y2GFAe+PT7xnUUtgqCNDFw: checks 
*** TURN *** [3d Qc 9d] [Ks]
sx0lGrkT9fd4yFR+3cXUQg: checks 
GeMoapCKDLc4ajT0Uk9ZQw joins the table at seat #9 
QEbIGci+itdw+re8RM5fZA: checks 
Y2GFAe+PT7xnUUtgqCNDFw: checks 
*** RIVER *** [3d Qc 9d Ks] [8c]
sx0lGrkT9fd4yFR+3cXUQg: checks 
QEbIGci+itdw+re8RM5fZA: checks 
Y2GFAe+PT7xnUUtgqCNDFw: checks 
*** SHOW DOWN ***
sx0lGrkT9fd4yFR+3cXUQg: shows [5c 6h] (high card King)
QEbIGci+itdw+re8RM5fZA: shows [Ah Ts] (high card Ace)
Y2GFAe+PT7xnUUtgqCNDFw: mucks hand 
QEbIGci+itdw+re8RM5fZA collected $0.75 from pot
*** SUMMARY ***
Total pot $0.75 | Rake $0 
Board [3d Qc 9d Ks 8c]
Seat 1: dtZ84flFEi4Q+SGrHMJRDQ folded before Flop (didn't bet)
Seat 2: Y2GFAe+PT7xnUUtgqCNDFw mucked
Seat 3: Z5ZtGOON8kmSdSCll9Z3XA folded before Flop (didn't bet)
Seat 4: HPEB+AtKw1+C/cxU0o1ciw (button) folded before Flop (didn't bet)
Seat 5: sx0lGrkT9fd4yFR+3cXUQg (small blind) showed [5c 6h] and lost with high card King
Seat 6: QEbIGci+itdw+re8RM5fZA (big blind) showed [Ah Ts] and won ($0.75) with high card Ace
Seat 7: dfNim92Z6XK1/h5SFW5vDg folded before Flop (didn't bet)
Seat 8: dmYlc+1cjwZMJ7wV+Z0rRg folded before Flop (didn't bet)
Seat 9: Z9AeOQX3yzuSvKAm/xyovg folded before Flop (didn't bet)




PokerStars Game #59941872824:  Hold'em No Limit ($0.10/$0.25) - 2009/07/01 1:48:51 ET
Table 'oxYpQNT8OHNCvpMIFi7UoA' 9-max Seat #5 is the button
Seat 1: EVqHvqty1ZsuvDFiSXlSqQ ($32.95 in chips) 
Seat 2: 8+iP8mvFyeAviW/yUH1CJg ($32 in chips) 
Seat 3: ubsjZomMWSV0hAiBLa7K1A ($19.80 in chips) 
Seat 4: eK8qa6EPcH2zhtbmWSvc9g ($25 in chips) 
Seat 5: ZoqLw33zTU6EsjOkfv/cGw ($19.40 in chips) 
Seat 6: VBHxUExRAMrbxUq/cVx9Gw ($5.15 in chips) 
Seat 7: X78b5v/uhqeXXoAijbw/yg ($35.65 in chips) 
Seat 9: pN3IHvAKm2fz+sTRARTcrg ($25 in chips) 
VBHxUExRAMrbxUq/cVx9Gw: posts small blind $0.10
X78b5v/uhqeXXoAijbw/yg: posts big blind $0.25
*** HOLE CARDS ***
pN3IHvAKm2fz+sTRARTcrg: folds 
EVqHvqty1ZsuvDFiSXlSqQ: calls $0.25
8+iP8mvFyeAviW/yUH1CJg: calls $0.25
ubsjZomMWSV0hAiBLa7K1A: folds 
eK8qa6EPcH2zhtbmWSvc9g: folds 
ZoqLw33zTU6EsjOkfv/cGw: calls $0.25
VBHxUExRAMrbxUq/cVx9Gw: folds 
X78b5v/uhqeXXoAijbw/yg: checks 
*** FLOP *** [Ac 4d Ks]
X78b5v/uhqeXXoAijbw/yg: checks 
EVqHvqty1ZsuvDFiSXlSqQ: checks 
8+iP8mvFyeAviW/yUH1CJg: checks 
ZoqLw33zTU6EsjOkfv/cGw: checks 
*** TURN *** [Ac 4d Ks] [Kd]
X78b5v/uhqeXXoAijbw/yg: checks 
IrishMike123 is disconnected 
IrishMike123 is connected 
EVqHvqty1ZsuvDFiSXlSqQ: checks 
8+iP8mvFyeAviW/yUH1CJg: checks 
ZoqLw33zTU6EsjOkfv/cGw: checks 
*** RIVER *** [Ac 4d Ks Kd] [6h]
X78b5v/uhqeXXoAijbw/yg: checks 
IrishMike123 has returned
EVqHvqty1ZsuvDFiSXlSqQ: checks 
8+iP8mvFyeAviW/yUH1CJg: bets $1.50
ZoqLw33zTU6EsjOkfv/cGw: folds 
X78b5v/uhqeXXoAijbw/yg: folds 
EVqHvqty1ZsuvDFiSXlSqQ: folds 
Uncalled bet ($1.50) returned to 8+iP8mvFyeAviW/yUH1CJg
8+iP8mvFyeAviW/yUH1CJg collected $1.05 from pot
8+iP8mvFyeAviW/yUH1CJg: shows [2h As] (two pair, Aces and Kings)
*** SUMMARY ***
Total pot $1.10 | Rake $0.05 
Board [Ac 4d Ks Kd 6h]
Seat 1: EVqHvqty1ZsuvDFiSXlSqQ folded on the River
Seat 2: 8+iP8mvFyeAviW/yUH1CJg collected ($1.05)
Seat 3: ubsjZomMWSV0hAiBLa7K1A folded before Flop (didn't bet)
Seat 4: eK8qa6EPcH2zhtbmWSvc9g folded before Flop (didn't bet)
Seat 5: ZoqLw33zTU6EsjOkfv/cGw (button) folded on the River
Seat 6: VBHxUExRAMrbxUq/cVx9Gw (small blind) folded before Flop
Seat 7: X78b5v/uhqeXXoAijbw/yg (big blind) folded on the River
Seat 9: pN3IHvAKm2fz+sTRARTcrg folded before Flop (didn't bet)




PokerStars Game #59941873366:  Hold'em No Limit ($0.10/$0.25) - 2009/07/01 1:48:52 ET
Table 'S6s+TmTlAjLHclBRvN5/fw' 9-max Seat #2 is the button
Seat 2: lQXp8ud1KwKUS+00XK0YEQ ($4.50 in chips) 
Seat 3: z2SmIaQ3+5n/eY1BN5HgPg ($5.10 in chips) 
Seat 4: RSal7+azPhXeqQO5L8XPfg ($14.20 in chips) 
Seat 5: 8hSJOE8UscCqt6t47gp0/g ($9.40 in chips) 
Seat 6: QkBggokTsSaL9vRv6V8nzQ ($11.80 in chips) 
z2SmIaQ3+5n/eY1BN5HgPg: posts small blind $0.10
RSal7+azPhXeqQO5L8XPfg: posts big blind $0.25
QkBggokTsSaL9vRv6V8nzQ: posts big blind $0.25
*** HOLE CARDS ***
8hSJOE8UscCqt6t47gp0/g: calls $0.25
QkBggokTsSaL9vRv6V8nzQ: raises $0.75 to $1
lQXp8ud1KwKUS+00XK0YEQ: calls $1
z2SmIaQ3+5n/eY1BN5HgPg: folds 
RSal7+azPhXeqQO5L8XPfg: calls $0.75
8hSJOE8UscCqt6t47gp0/g: folds 
*** FLOP *** [3h 7h 5s]
RSal7+azPhXeqQO5L8XPfg: bets $0.50
QkBggokTsSaL9vRv6V8nzQ: raises $2 to $2.50
lQXp8ud1KwKUS+00XK0YEQ: raises $1 to $3.50 and is all-in
RSal7+azPhXeqQO5L8XPfg: calls $3
QkBggokTsSaL9vRv6V8nzQ: calls $1
*** TURN *** [3h 7h 5s] [Ts]
RSal7+azPhXeqQO5L8XPfg: bets $0.50
QkBggokTsSaL9vRv6V8nzQ: calls $0.50
*** RIVER *** [3h 7h 5s Ts] [4h]
RSal7+azPhXeqQO5L8XPfg: bets $4.50
z2SmIaQ3+5n/eY1BN5HgPg said, "lol"
QkBggokTsSaL9vRv6V8nzQ: folds 
Uncalled bet ($4.50) returned to RSal7+azPhXeqQO5L8XPfg
*** SHOW DOWN ***
RSal7+azPhXeqQO5L8XPfg: shows [8h 6h] (a flush, Eight high)
RSal7+azPhXeqQO5L8XPfg collected $0.95 from side pot
lQXp8ud1KwKUS+00XK0YEQ: mucks hand 
RSal7+azPhXeqQO5L8XPfg collected $13.20 from main pot
lQXp8ud1KwKUS+00XK0YEQ leaves the table
*** SUMMARY ***
Total pot $14.85 Main pot $13.20. Side pot $0.95. | Rake $0.70 
Board [3h 7h 5s Ts 4h]
Seat 2: lQXp8ud1KwKUS+00XK0YEQ (button) mucked
Seat 3: z2SmIaQ3+5n/eY1BN5HgPg (small blind) folded before Flop
Seat 4: RSal7+azPhXeqQO5L8XPfg (big blind) showed [8h 6h] and won ($14.15) with a flush, Eight high
Seat 5: 8hSJOE8UscCqt6t47gp0/g folded before Flop
Seat 6: QkBggokTsSaL9vRv6V8nzQ folded on the River




PokerStars Game #59941873218:  Hold'em No Limit ($0.10/$0.25) - 2009/07/01 1:48:52 ET
Table 'CM/C/FZf3VHIp50RjmBucQ' 9-max Seat #7 is the button
Seat 1: P8h+GtgJJRwRh2YdssBtbg ($4.25 in chips) 
Seat 2: +aNWwNic2LVhXcMqH+ezrA ($14.90 in chips) 
Seat 3: HPEB+AtKw1+C/cxU0o1ciw ($54.45 in chips) 
Seat 4: FYIiLXWy4mKC5ZGa/fnS0g ($15.65 in chips) 
Seat 5: t3m1RlE+8m1yb0ojo8ikCw ($13.40 in chips) 
Seat 6: FqpibuVWLNsAN/Z7ROZLnA ($6.55 in chips) 
Seat 7: +T7KwHtNiHQt6JhQegSH/w ($5.20 in chips) 
Seat 8: 5pDhXQ+RVy0BGcwfJAJfbg ($24.75 in chips) 
Seat 9: W6tExOcYX7qiy6Qdp+ZwFA ($5 in chips) 
5pDhXQ+RVy0BGcwfJAJfbg: posts small blind $0.10
W6tExOcYX7qiy6Qdp+ZwFA: posts big blind $0.25
*** HOLE CARDS ***
P8h+GtgJJRwRh2YdssBtbg: folds 
+aNWwNic2LVhXcMqH+ezrA: raises $0.25 to $0.50
HPEB+AtKw1+C/cxU0o1ciw: folds 
FYIiLXWy4mKC5ZGa/fnS0g: folds 
t3m1RlE+8m1yb0ojo8ikCw: folds 
FqpibuVWLNsAN/Z7ROZLnA: folds 
+T7KwHtNiHQt6JhQegSH/w: folds 
5pDhXQ+RVy0BGcwfJAJfbg: folds 
W6tExOcYX7qiy6Qdp+ZwFA: raises $4.50 to $5 and is all-in
+aNWwNic2LVhXcMqH+ezrA: calls $4.50
*** FLOP *** [6c 9d 8h]
*** TURN *** [6c 9d 8h] [7h]
*** RIVER *** [6c 9d 8h 7h] [Ah]
*** SHOW DOWN ***
W6tExOcYX7qiy6Qdp+ZwFA: shows [8d 8s] (three of a kind, Eights)
+aNWwNic2LVhXcMqH+ezrA: shows [5s As] (a straight, Five to Nine)
+aNWwNic2LVhXcMqH+ezrA collected $9.60 from pot
*** SUMMARY ***
Total pot $10.10 | Rake $0.50 
Board [6c 9d 8h 7h Ah]
Seat 1: P8h+GtgJJRwRh2YdssBtbg folded before Flop (didn't bet)
Seat 2: +aNWwNic2LVhXcMqH+ezrA showed [5s As] and won ($9.60) with a straight, Five to Nine
Seat 3: HPEB+AtKw1+C/cxU0o1ciw folded before Flop (didn't bet)
Seat 4: FYIiLXWy4mKC5ZGa/fnS0g folded before Flop (didn't bet)
Seat 5: t3m1RlE+8m1yb0ojo8ikCw folded before Flop (didn't bet)
Seat 6: FqpibuVWLNsAN/Z7ROZLnA folded before Flop (didn't bet)
Seat 7: +T7KwHtNiHQt6JhQegSH/w (button) folded before Flop (didn't bet)
Seat 8: 5pDhXQ+RVy0BGcwfJAJfbg (small blind) folded before Flop
Seat 9: W6tExOcYX7qiy6Qdp+ZwFA (big blind) showed [8d 8s] and lost with three of a kind, Eights




PokerStars Game #59941873232:  Hold'em No Limit ($0.10/$0.25) - 2009/07/01 1:48:52 ET
Table '7/qMNloI0nSXWiX5Y1watA' 9-max Seat #6 is the button
Seat 1: /LyhaB3V6jkgOfXORidqRQ ($10.75 in chips) 
Seat 2: wGigCmBR/9XWkPpvYos3aQ ($25 in chips) 
Seat 3: W2YYHvqjaEpRrO7stZkClQ ($5 in chips) 
Seat 4: K0LdhPeU31rviEPo6Sv3TA ($8.30 in chips) 
Seat 6: Y3DZ6qQlLeBhixDj4M9vmg ($13.10 in chips) 
Seat 8: ljemhp25Zg+nlA9DLCIiUw ($26.15 in chips) 
Seat 9: dmYlc+1cjwZMJ7wV+Z0rRg ($27.05 in chips) 
ljemhp25Zg+nlA9DLCIiUw: posts small blind $0.10
dmYlc+1cjwZMJ7wV+Z0rRg: posts big blind $0.25
GeMoapCKDLc4ajT0Uk9ZQw: sits out 
*** HOLE CARDS ***
/LyhaB3V6jkgOfXORidqRQ: folds 
wGigCmBR/9XWkPpvYos3aQ: folds 
W2YYHvqjaEpRrO7stZkClQ: folds 
K0LdhPeU31rviEPo6Sv3TA: raises $0.50 to $0.75
Y3DZ6qQlLeBhixDj4M9vmg: calls $0.75
ljemhp25Zg+nlA9DLCIiUw: folds 
dmYlc+1cjwZMJ7wV+Z0rRg: folds 
*** FLOP *** [9s Qs 7c]
K0LdhPeU31rviEPo6Sv3TA: bets $1.25
Y3DZ6qQlLeBhixDj4M9vmg: folds 
Uncalled bet ($1.25) returned to K0LdhPeU31rviEPo6Sv3TA
K0LdhPeU31rviEPo6Sv3TA collected $1.80 from pot
K0LdhPeU31rviEPo6Sv3TA: doesn't show hand 
*** SUMMARY ***
Total pot $1.85 | Rake $0.05 
Board [9s Qs 7c]
Seat 1: /LyhaB3V6jkgOfXORidqRQ folded before Flop (didn't bet)
Seat 2: wGigCmBR/9XWkPpvYos3aQ folded before Flop (didn't bet)
Seat 3: W2YYHvqjaEpRrO7stZkClQ folded before Flop (didn't bet)
Seat 4: K0LdhPeU31rviEPo6Sv3TA collected ($1.80)
Seat 6: Y3DZ6qQlLeBhixDj4M9vmg (button) folded on the Flop
Seat 8: ljemhp25Zg+nlA9DLCIiUw (small blind) folded before Flop
Seat 9: dmYlc+1cjwZMJ7wV+Z0rRg (big blind) folded before Flop




PokerStars Game #59941873108:  Hold'em No Limit ($0.10/$0.25) - 2009/07/01 1:48:52 ET
Table '6aL2C8IFwHHr6SG6RgXaow' 9-max Seat #9 is the button
Seat 3: clJsV3v77RS07bDKY+705w ($5 in chips) 
Seat 4: BT6Oal0iO4P6kDuT7HFQDw ($19.65 in chips) 
Seat 5: wre31HfyzQGpIvID1istxw ($21.45 in chips) 
Seat 6: gehe91e0IyVT0QU/XBkEyg ($26.75 in chips) 
Seat 7: E0iYnEVO2ho7dH3QcCjw7g ($19.75 in chips) 
Seat 8: rQhYIYXSyH/IivYM1dlV5A ($21.95 in chips) 
Seat 9: CgIo2ItZqi4o3ayVG6HanQ ($23.15 in chips) 
FcL757vvzKRPFZ6h7YsPHA will be allowed to play after the button
clJsV3v77RS07bDKY+705w: posts small blind $0.10
BT6Oal0iO4P6kDuT7HFQDw: posts big blind $0.25
*** HOLE CARDS ***
UmzixCpC0bAc1lDEjgB3NQ has returned
wre31HfyzQGpIvID1istxw: calls $0.25
gehe91e0IyVT0QU/XBkEyg: folds 
E0iYnEVO2ho7dH3QcCjw7g: folds 
rQhYIYXSyH/IivYM1dlV5A: folds 
CgIo2ItZqi4o3ayVG6HanQ: calls $0.25
clJsV3v77RS07bDKY+705w: folds 
BT6Oal0iO4P6kDuT7HFQDw: checks 
*** FLOP *** [5d Qh Qs]
BT6Oal0iO4P6kDuT7HFQDw: checks 
wre31HfyzQGpIvID1istxw: checks 
CgIo2ItZqi4o3ayVG6HanQ: checks 
*** TURN *** [5d Qh Qs] [4h]
BT6Oal0iO4P6kDuT7HFQDw: checks 
wre31HfyzQGpIvID1istxw: checks 
CgIo2ItZqi4o3ayVG6HanQ: bets $1
BT6Oal0iO4P6kDuT7HFQDw: folds 
wre31HfyzQGpIvID1istxw: folds 
Uncalled bet ($1) returned to CgIo2ItZqi4o3ayVG6HanQ
CgIo2ItZqi4o3ayVG6HanQ collected $0.85 from pot
*** SUMMARY ***
Total pot $0.85 | Rake $0 
Board [5d Qh Qs 4h]
Seat 3: clJsV3v77RS07bDKY+705w (small blind) folded before Flop
Seat 4: BT6Oal0iO4P6kDuT7HFQDw (big blind) folded on the Turn
Seat 5: wre31HfyzQGpIvID1istxw folded on the Turn
Seat 6: gehe91e0IyVT0QU/XBkEyg folded before Flop (didn't bet)
Seat 7: E0iYnEVO2ho7dH3QcCjw7g folded before Flop (didn't bet)
Seat 8: rQhYIYXSyH/IivYM1dlV5A folded before Flop (didn't bet)
Seat 9: CgIo2ItZqi4o3ayVG6HanQ (button) collected ($0.85)




PokerStars Game #59941873352:  Hold'em No Limit ($0.10/$0.25) - 2009/07/01 1:48:52 ET
Table '2AUmC2Rslg+QUbLfdgNdfg' 6-max Seat #3 is the button
Seat 1: YDXAegrCnzc0l6TSDNboXQ ($23.25 in chips) 
Seat 2: PLksyNlTVRVZwxJVC2/1eA ($25 in chips) 
Seat 3: JFIAqU8lCZ0vWwEl4bdGsg ($26.15 in chips) 
Seat 4: lquriepNQBhDV5P1SWHhnA ($26 in chips) 
Seat 5: AMc4cCwUJhokdGRYIaVPhQ ($36.65 in chips) 
Seat 6: xBWc54v+UTSJOiKpbAbJWg ($10.80 in chips) 
lquriepNQBhDV5P1SWHhnA: posts small blind $0.10
AMc4cCwUJhokdGRYIaVPhQ: posts big blind $0.25
*** HOLE CARDS ***
xBWc54v+UTSJOiKpbAbJWg: folds 
YDXAegrCnzc0l6TSDNboXQ: folds 
PLksyNlTVRVZwxJVC2/1eA: folds 
JFIAqU8lCZ0vWwEl4bdGsg: raises $0.60 to $0.85
lquriepNQBhDV5P1SWHhnA: folds 
AMc4cCwUJhokdGRYIaVPhQ: raises $0.60 to $1.45
JFIAqU8lCZ0vWwEl4bdGsg: calls $0.60
*** FLOP *** [Ah 7d As]
AMc4cCwUJhokdGRYIaVPhQ: checks 
JFIAqU8lCZ0vWwEl4bdGsg: bets $2
AMc4cCwUJhokdGRYIaVPhQ: raises $2 to $4
JFIAqU8lCZ0vWwEl4bdGsg: raises $6 to $10
AMc4cCwUJhokdGRYIaVPhQ: folds 
Uncalled bet ($6) returned to JFIAqU8lCZ0vWwEl4bdGsg
JFIAqU8lCZ0vWwEl4bdGsg collected $10.50 from pot
JFIAqU8lCZ0vWwEl4bdGsg: doesn't show hand 
*** SUMMARY ***
Total pot $11 | Rake $0.50 
Board [Ah 7d As]
Seat 1: YDXAegrCnzc0l6TSDNboXQ folded before Flop (didn't bet)
Seat 2: PLksyNlTVRVZwxJVC2/1eA folded before Flop (didn't bet)
Seat 3: JFIAqU8lCZ0vWwEl4bdGsg (button) collected ($10.50)
Seat 4: lquriepNQBhDV5P1SWHhnA (small blind) folded before Flop
Seat 5: AMc4cCwUJhokdGRYIaVPhQ (big blind) folded on the Flop
Seat 6: xBWc54v+UTSJOiKpbAbJWg folded before Flop (didn't bet)




PokerStars Game #59941873154:  Hold'em No Limit ($0.10/$0.25) - 2009/07/01 1:48:52 ET
Table 'l57rayEpPtZotP9nqgSWBg' 6-max Seat #3 is the button
Seat 1: DihMHaz4WNETH1bPDe13kA ($56.50 in chips) 
Seat 2: p6adJRMXMBLr+xtQzqazIQ ($15.05 in chips) 
Seat 3: xC0kaiDYM6YTlgODL83O5A ($25 in chips) 
Seat 4: OqkdGXy1SCzuN5Q0wNlFSg ($21.60 in chips) 
Seat 5: WKJHaZPUgrpTVyLOEjLYmg ($12.20 in chips) 
Seat 6: IGRfskE1v9H9Bn+fz8AgNQ ($15.55 in chips) 
OqkdGXy1SCzuN5Q0wNlFSg: posts small blind $0.10
WKJHaZPUgrpTVyLOEjLYmg: posts big blind $0.25
*** HOLE CARDS ***
IGRfskE1v9H9Bn+fz8AgNQ: folds 
DihMHaz4WNETH1bPDe13kA: raises $0.50 to $0.75
p6adJRMXMBLr+xtQzqazIQ: folds 
xC0kaiDYM6YTlgODL83O5A: folds 
OqkdGXy1SCzuN5Q0wNlFSg: folds 
WKJHaZPUgrpTVyLOEjLYmg: folds 
Uncalled bet ($0.50) returned to DihMHaz4WNETH1bPDe13kA
DihMHaz4WNETH1bPDe13kA collected $0.60 from pot
*** SUMMARY ***
Total pot $0.60 | Rake $0 
Seat 1: DihMHaz4WNETH1bPDe13kA collected ($0.60)
Seat 2: p6adJRMXMBLr+xtQzqazIQ folded before Flop (didn't bet)
Seat 3: xC0kaiDYM6YTlgODL83O5A (button) folded before Flop (didn't bet)
Seat 4: OqkdGXy1SCzuN5Q0wNlFSg (small blind) folded before Flop
Seat 5: WKJHaZPUgrpTVyLOEjLYmg (big blind) folded before Flop
Seat 6: IGRfskE1v9H9Bn+fz8AgNQ folded before Flop (didn't bet)




PokerStars Game #59941873096:  Hold'em No Limit ($0.10/$0.25) - 2009/07/01 1:48:52 ET
Table 'AHkg4ChqzcMauBx6Qvz8Nw' 6-max Seat #2 is the button
Seat 1: +RDf7SmUjY2kK0PzdBEYqg ($6.05 in chips) 
Seat 2: Vi0JMrTI2BGrPL7UIulJtA ($4.05 in chips) 
Seat 3: 9dToMv2GJLfi00HcpfMnIw ($25.50 in chips) 
Seat 4: Eznneya0vB6S+eXJdVleHA ($21.90 in chips) 
Seat 5: Bada343Si4xKu3fNXY99AA ($4.20 in chips) 
Seat 6: Hsvkc0/G2VV78oVmWYXecw ($5 in chips) 
9dToMv2GJLfi00HcpfMnIw: posts small blind $0.10
Eznneya0vB6S+eXJdVleHA: posts big blind $0.25
*** HOLE CARDS ***
Bada343Si4xKu3fNXY99AA: folds 
Hsvkc0/G2VV78oVmWYXecw: folds 
+RDf7SmUjY2kK0PzdBEYqg: calls $0.25
Vi0JMrTI2BGrPL7UIulJtA: calls $0.25
9dToMv2GJLfi00HcpfMnIw: raises $0.50 to $0.75
Eznneya0vB6S+eXJdVleHA: folds 
+RDf7SmUjY2kK0PzdBEYqg: calls $0.50
Vi0JMrTI2BGrPL7UIulJtA: calls $0.50
*** FLOP *** [Qd 5d 9s]
9dToMv2GJLfi00HcpfMnIw: bets $0.75
+RDf7SmUjY2kK0PzdBEYqg: calls $0.75
Vi0JMrTI2BGrPL7UIulJtA: folds 
*** TURN *** [Qd 5d 9s] [9d]
9dToMv2GJLfi00HcpfMnIw: bets $1
+RDf7SmUjY2kK0PzdBEYqg: calls $1
*** RIVER *** [Qd 5d 9s 9d] [Js]
9dToMv2GJLfi00HcpfMnIw: bets $1.50
+RDf7SmUjY2kK0PzdBEYqg: calls $1.50
*** SHOW DOWN ***
9dToMv2GJLfi00HcpfMnIw: shows [As Qc] (two pair, Queens and Nines)
+RDf7SmUjY2kK0PzdBEYqg: mucks hand 
9dToMv2GJLfi00HcpfMnIw collected $8.60 from pot
*** SUMMARY ***
Total pot $9 | Rake $0.40 
Board [Qd 5d 9s 9d Js]
Seat 1: +RDf7SmUjY2kK0PzdBEYqg mucked
Seat 2: Vi0JMrTI2BGrPL7UIulJtA (button) folded on the Flop
Seat 3: 9dToMv2GJLfi00HcpfMnIw (small blind) showed [As Qc] and won ($8.60) with two pair, Queens and Nines
Seat 4: Eznneya0vB6S+eXJdVleHA (big blind) folded before Flop
Seat 5: Bada343Si4xKu3fNXY99AA folded before Flop (didn't bet)
Seat 6: Hsvkc0/G2VV78oVmWYXecw folded before Flop (didn't bet)




PokerStars Game #59941873754:  Hold'em No Limit ($0.10/$0.25) - 2009/07/01 1:48:53 ET
Table 'YONIZZNvg4uZ4xNUO1deeA' 6-max Seat #4 is the button
Seat 1: GbCVUNssQ7mqsPWr7J4d3w ($4.65 in chips) 
Seat 2: evMMX/0gSDH791KdSAOaSg ($18.45 in chips) 
Seat 3: Eksrep3hySi2jeDHuaWiOQ ($10 in chips) 
Seat 4: w43JQj2oYPpKQVG4Yzlq1w ($25 in chips) 
Seat 5: if4dh6jhJXeN3/qd3qCp9g ($24.75 in chips) 
Seat 6: eL3+wCBjFGfQ5FMdIZihwA ($27 in chips) 
if4dh6jhJXeN3/qd3qCp9g: posts small blind $0.10
eL3+wCBjFGfQ5FMdIZihwA: posts big blind $0.25
*** HOLE CARDS ***
GbCVUNssQ7mqsPWr7J4d3w: folds 
evMMX/0gSDH791KdSAOaSg: folds 
Eksrep3hySi2jeDHuaWiOQ: raises $0.50 to $0.75
w43JQj2oYPpKQVG4Yzlq1w: folds 
if4dh6jhJXeN3/qd3qCp9g: folds 
eL3+wCBjFGfQ5FMdIZihwA: calls $0.50
*** FLOP *** [Tc Qh 2c]
eL3+wCBjFGfQ5FMdIZihwA: checks 
Eksrep3hySi2jeDHuaWiOQ: bets $0.50
eL3+wCBjFGfQ5FMdIZihwA: calls $0.50
*** TURN *** [Tc Qh 2c] [7h]
eL3+wCBjFGfQ5FMdIZihwA: bets $2.50
Eksrep3hySi2jeDHuaWiOQ: folds 
Uncalled bet ($2.50) returned to eL3+wCBjFGfQ5FMdIZihwA
eL3+wCBjFGfQ5FMdIZihwA collected $2.50 from pot
*** SUMMARY ***
Total pot $2.60 | Rake $0.10 
Board [Tc Qh 2c 7h]
Seat 1: GbCVUNssQ7mqsPWr7J4d3w folded before Flop (didn't bet)
Seat 2: evMMX/0gSDH791KdSAOaSg folded before Flop (didn't bet)
Seat 3: Eksrep3hySi2jeDHuaWiOQ folded on the Turn
Seat 4: w43JQj2oYPpKQVG4Yzlq1w (button) folded before Flop (didn't bet)
Seat 5: if4dh6jhJXeN3/qd3qCp9g (small blind) folded before Flop
Seat 6: eL3+wCBjFGfQ5FMdIZihwA (big blind) collected ($2.50)




PokerStars Game #59941873700:  Hold'em No Limit ($0.10/$0.25) - 2009/07/01 1:48:53 ET
Table 'mk323gviqdkOY5Aek/1EWg' 6-max Seat #2 is the button
Seat 1: 7cx44/slbeTw+Cy7QB8Trg ($24.65 in chips) 
Seat 2: GC/9yVD59DUCX7hUI7gcLw ($55.30 in chips) 
Seat 3: NuqYPwTLZYQhxOoVK3Yqlw ($24.75 in chips) 
Seat 4: +baiVgI/ETnBARLe5mARCw ($11.55 in chips) 
Seat 5: kjYRzIfvZNNflYMYRkkSVA ($36.65 in chips) 
Seat 6: KkXSr5xFjxLSD3wtAvT+WQ ($9 in chips) 
NuqYPwTLZYQhxOoVK3Yqlw: posts small blind $0.10
+baiVgI/ETnBARLe5mARCw: posts big blind $0.25
*** HOLE CARDS ***
kjYRzIfvZNNflYMYRkkSVA: folds 
KkXSr5xFjxLSD3wtAvT+WQ: folds 
7cx44/slbeTw+Cy7QB8Trg: raises $0.50 to $0.75
GC/9yVD59DUCX7hUI7gcLw: folds 
NuqYPwTLZYQhxOoVK3Yqlw: folds 
+baiVgI/ETnBARLe5mARCw: folds 
Uncalled bet ($0.50) returned to 7cx44/slbeTw+Cy7QB8Trg
7cx44/slbeTw+Cy7QB8Trg collected $0.60 from pot
7cx44/slbeTw+Cy7QB8Trg: doesn't show hand 
*** SUMMARY ***
Total pot $0.60 | Rake $0 
Seat 1: 7cx44/slbeTw+Cy7QB8Trg collected ($0.60)
Seat 2: GC/9yVD59DUCX7hUI7gcLw (button) folded before Flop (didn't bet)
Seat 3: NuqYPwTLZYQhxOoVK3Yqlw (small blind) folded before Flop
Seat 4: +baiVgI/ETnBARLe5mARCw (big blind) folded before Flop
Seat 5: kjYRzIfvZNNflYMYRkkSVA folded before Flop (didn't bet)
Seat 6: KkXSr5xFjxLSD3wtAvT+WQ folded before Flop (didn't bet)




PokerStars Game #59941873676:  Hold'em No Limit ($0.10/$0.25) - 2009/07/01 1:48:53 ET
Table 'sDHjMRwfSiz7+NDdZLUiyA' 9-max Seat #8 is the button
Seat 1: VGwr1eqhvdUtMfBFCvBnmg ($12.90 in chips) 
Seat 2: ljemhp25Zg+nlA9DLCIiUw ($25.45 in chips) 
Seat 3: SGA1WpAnQxFdFAYyt362gQ ($18.05 in chips) 
Seat 4: eK8qa6EPcH2zhtbmWSvc9g ($25.80 in chips) 
Seat 5: IGRfskE1v9H9Bn+fz8AgNQ ($36.10 in chips) 
Seat 6: 1qa0qHOCKZM3Uipx9DxYtQ ($15.80 in chips) 
Seat 7: K0b5wNInj6hUGRr6yzKFtw ($37.30 in chips) 
Seat 8: 3hMkm4U5yTRrkGJkxfijaQ ($1.65 in chips) 
Seat 9: 3PmVnC/15cl4oyI1TKIt4g ($3.80 in chips) 
3PmVnC/15cl4oyI1TKIt4g: posts small blind $0.10
VGwr1eqhvdUtMfBFCvBnmg: posts big blind $0.25
*** HOLE CARDS ***
ljemhp25Zg+nlA9DLCIiUw: folds 
SGA1WpAnQxFdFAYyt362gQ: folds 
eK8qa6EPcH2zhtbmWSvc9g: folds 
IGRfskE1v9H9Bn+fz8AgNQ: folds 
1qa0qHOCKZM3Uipx9DxYtQ: folds 
K0b5wNInj6hUGRr6yzKFtw: folds 
3hMkm4U5yTRrkGJkxfijaQ: folds 
3hMkm4U5yTRrkGJkxfijaQ is sitting out
3PmVnC/15cl4oyI1TKIt4g: raises $0.50 to $0.75
VGwr1eqhvdUtMfBFCvBnmg: calls $0.50
*** FLOP *** [2c Kh 4h]
3PmVnC/15cl4oyI1TKIt4g: bets $1
VGwr1eqhvdUtMfBFCvBnmg: folds 
Uncalled bet ($1) returned to 3PmVnC/15cl4oyI1TKIt4g
3PmVnC/15cl4oyI1TKIt4g collected $1.45 from pot
3PmVnC/15cl4oyI1TKIt4g: doesn't show hand 
*** SUMMARY ***
Total pot $1.50 | Rake $0.05 
Board [2c Kh 4h]
Seat 1: VGwr1eqhvdUtMfBFCvBnmg (big blind) folded on the Flop
Seat 2: ljemhp25Zg+nlA9DLCIiUw folded before Flop (didn't bet)
Seat 3: SGA1WpAnQxFdFAYyt362gQ folded before Flop (didn't bet)
Seat 4: eK8qa6EPcH2zhtbmWSvc9g folded before Flop (didn't bet)
Seat 5: IGRfskE1v9H9Bn+fz8AgNQ folded before Flop (didn't bet)
Seat 6: 1qa0qHOCKZM3Uipx9DxYtQ folded before Flop (didn't bet)
Seat 7: K0b5wNInj6hUGRr6yzKFtw folded before Flop (didn't bet)
Seat 8: 3hMkm4U5yTRrkGJkxfijaQ (button) folded before Flop (didn't bet)
Seat 9: 3PmVnC/15cl4oyI1TKIt4g (small blind) collected ($1.45)




PokerStars Game #59941873500:  Hold'em No Limit ($0.10/$0.25) - 2009/07/01 1:48:53 ET
Table 'Is9eNmJA1KnBOw0lcVkxUQ' 9-max Seat #4 is the button
Seat 1: 56S3mA6Zs3pGR+0p0vUCtg ($32 in chips) 
Seat 2: VllYilcih0t+gMD4GTRlgQ ($59.05 in chips) 
Seat 3: ubsjZomMWSV0hAiBLa7K1A ($18.40 in chips) 
Seat 4: cZ99hugmLBj9KhTlc8nCSw ($25 in chips) 
Seat 5: Qduu7ikeizo6q6Ei9YvcJA ($24.75 in chips) 
Seat 6: HapyJHxV6lc3eqoT7yWL2A ($12.05 in chips) 
Seat 7: aNpwfA31EREwO+ar4XzBCw ($28.30 in chips) 
Seat 8: Th3FldXKQW6hWVVPahaoOQ ($25.50 in chips) 
Seat 9: DdPXdieucQ+n99u1n3A+rQ ($4.90 in chips) 
Qduu7ikeizo6q6Ei9YvcJA: posts small blind $0.10
HapyJHxV6lc3eqoT7yWL2A: posts big blind $0.25
*** HOLE CARDS ***
aNpwfA31EREwO+ar4XzBCw: folds 
Th3FldXKQW6hWVVPahaoOQ: folds 
DdPXdieucQ+n99u1n3A+rQ: raises $0.75 to $1
56S3mA6Zs3pGR+0p0vUCtg: folds 
VllYilcih0t+gMD4GTRlgQ: folds 
ubsjZomMWSV0hAiBLa7K1A: folds 
cZ99hugmLBj9KhTlc8nCSw: folds 
Qduu7ikeizo6q6Ei9YvcJA: folds 
HapyJHxV6lc3eqoT7yWL2A: calls $0.75
*** FLOP *** [9c Kc 6h]
HapyJHxV6lc3eqoT7yWL2A: checks 
DdPXdieucQ+n99u1n3A+rQ: bets $1.75
HapyJHxV6lc3eqoT7yWL2A: folds 
Uncalled bet ($1.75) returned to DdPXdieucQ+n99u1n3A+rQ
DdPXdieucQ+n99u1n3A+rQ collected $2 from pot
DdPXdieucQ+n99u1n3A+rQ: doesn't show hand 
*** SUMMARY ***
Total pot $2.10 | Rake $0.10 
Board [9c Kc 6h]
Seat 1: 56S3mA6Zs3pGR+0p0vUCtg folded before Flop (didn't bet)
Seat 2: VllYilcih0t+gMD4GTRlgQ folded before Flop (didn't bet)
Seat 3: ubsjZomMWSV0hAiBLa7K1A folded before Flop (didn't bet)
Seat 4: cZ99hugmLBj9KhTlc8nCSw (button) folded before Flop (didn't bet)
Seat 5: Qduu7ikeizo6q6Ei9YvcJA (small blind) folded before Flop
Seat 6: HapyJHxV6lc3eqoT7yWL2A (big blind) folded on the Flop
Seat 7: aNpwfA31EREwO+ar4XzBCw folded before Flop (didn't bet)
Seat 8: Th3FldXKQW6hWVVPahaoOQ folded before Flop (didn't bet)
Seat 9: DdPXdieucQ+n99u1n3A+rQ collected ($2)




PokerStars Game #59941873780:  Hold'em No Limit ($0.10/$0.25) - 2009/07/01 1:48:53 ET
Table 'iMiAw/kTZXopgYX4HI7sHg' 9-max Seat #7 is the button
Seat 1: PdIasPkzm2sqZnN41ZRXOg ($5 in chips) 
Seat 2: qwr38jl5txoR36M7G5qi4A ($8.25 in chips) 
Seat 3: HPEB+AtKw1+C/cxU0o1ciw ($27.90 in chips) 
Seat 4: Z9W7+g1WMhhZDi7DwGbCFA ($5 in chips) 
Seat 5: 22dIObOuor/A+IKWkNoAlA ($5.70 in chips) 
Seat 6: Bb42QRQMhg5/Y0vHP8/2Xw ($29.05 in chips) 
Seat 7: ipLwYjdAXnvG54zETKPvbQ ($14.65 in chips) 
Seat 8: tLcDklc2rBORNfixyRfVfw ($30 in chips) 
Seat 9: fxHuzml2pBE+ABvr6emfng ($15 in chips) 
tLcDklc2rBORNfixyRfVfw: posts small blind $0.10
fxHuzml2pBE+ABvr6emfng: posts big blind $0.25
*** HOLE CARDS ***
PdIasPkzm2sqZnN41ZRXOg: folds 
qwr38jl5txoR36M7G5qi4A: folds 
HPEB+AtKw1+C/cxU0o1ciw: folds 
Z9W7+g1WMhhZDi7DwGbCFA: calls $0.25
22dIObOuor/A+IKWkNoAlA: calls $0.25
Bb42QRQMhg5/Y0vHP8/2Xw: folds 
ipLwYjdAXnvG54zETKPvbQ: calls $0.25
tLcDklc2rBORNfixyRfVfw: folds 
fxHuzml2pBE+ABvr6emfng: checks 
*** FLOP *** [2s Qc 5d]
fxHuzml2pBE+ABvr6emfng: checks 
Z9W7+g1WMhhZDi7DwGbCFA: bets $0.50
22dIObOuor/A+IKWkNoAlA: folds 
ipLwYjdAXnvG54zETKPvbQ: calls $0.50
fxHuzml2pBE+ABvr6emfng: folds 
*** TURN *** [2s Qc 5d] [2d]
Z9W7+g1WMhhZDi7DwGbCFA: bets $1
ipLwYjdAXnvG54zETKPvbQ: calls $1
*** RIVER *** [2s Qc 5d 2d] [Jh]
Z9W7+g1WMhhZDi7DwGbCFA: bets $3.25 and is all-in
ipLwYjdAXnvG54zETKPvbQ: folds 
Uncalled bet ($3.25) returned to Z9W7+g1WMhhZDi7DwGbCFA
Z9W7+g1WMhhZDi7DwGbCFA collected $3.90 from pot
Z9W7+g1WMhhZDi7DwGbCFA: doesn't show hand 
*** SUMMARY ***
Total pot $4.10 | Rake $0.20 
Board [2s Qc 5d 2d Jh]
Seat 1: PdIasPkzm2sqZnN41ZRXOg folded before Flop (didn't bet)
Seat 2: qwr38jl5txoR36M7G5qi4A folded before Flop (didn't bet)
Seat 3: HPEB+AtKw1+C/cxU0o1ciw folded before Flop (didn't bet)
Seat 4: Z9W7+g1WMhhZDi7DwGbCFA collected ($3.90)
Seat 5: 22dIObOuor/A+IKWkNoAlA folded on the Flop
Seat 6: Bb42QRQMhg5/Y0vHP8/2Xw folded before Flop (didn't bet)
Seat 7: ipLwYjdAXnvG54zETKPvbQ (button) folded on the River
Seat 8: tLcDklc2rBORNfixyRfVfw (small blind) folded before Flop
Seat 9: fxHuzml2pBE+ABvr6emfng (big blind) folded on the Flop




PokerStars Game #59941873914:  Hold'em No Limit ($0.10/$0.25) - 2009/07/01 1:48:53 ET
Table '+fuYjvJy9okLr23QyZtanA' 9-max Seat #6 is the button
Seat 2: tLcDklc2rBORNfixyRfVfw ($25 in chips) 
Seat 3: eK8qa6EPcH2zhtbmWSvc9g ($52.30 in chips) 
Seat 4: Bb42QRQMhg5/Y0vHP8/2Xw ($30.15 in chips) 
Seat 5: bXpVeaSTPBFSPJmeXxO7nw ($4.30 in chips) 
Seat 6: wGigCmBR/9XWkPpvYos3aQ ($30.70 in chips) 
Seat 7: dfNim92Z6XK1/h5SFW5vDg ($37.60 in chips) 
Seat 8: KqS/lY/fNB9qUxokm9QfeA ($8.70 in chips) 
Seat 9: OMhlmt2waO3z43ZSFNMmog ($29.95 in chips) 
dfNim92Z6XK1/h5SFW5vDg: posts small blind $0.10
KqS/lY/fNB9qUxokm9QfeA: posts big blind $0.25
*** HOLE CARDS ***
OMhlmt2waO3z43ZSFNMmog: folds 
tLcDklc2rBORNfixyRfVfw: folds 
eK8qa6EPcH2zhtbmWSvc9g: folds 
Bb42QRQMhg5/Y0vHP8/2Xw: folds 
bXpVeaSTPBFSPJmeXxO7nw: folds 
wGigCmBR/9XWkPpvYos3aQ: raises $0.65 to $0.90
dfNim92Z6XK1/h5SFW5vDg: folds 
KqS/lY/fNB9qUxokm9QfeA: raises $7.80 to $8.70 and is all-in
wGigCmBR/9XWkPpvYos3aQ: folds 
Uncalled bet ($7.80) returned to KqS/lY/fNB9qUxokm9QfeA
KqS/lY/fNB9qUxokm9QfeA collected $1.90 from pot
*** SUMMARY ***
Total pot $1.90 | Rake $0 
Seat 2: tLcDklc2rBORNfixyRfVfw folded before Flop (didn't bet)
Seat 3: eK8qa6EPcH2zhtbmWSvc9g folded before Flop (didn't bet)
Seat 4: Bb42QRQMhg5/Y0vHP8/2Xw folded before Flop (didn't bet)
Seat 5: bXpVeaSTPBFSPJmeXxO7nw folded before Flop (didn't bet)
Seat 6: wGigCmBR/9XWkPpvYos3aQ (button) folded before Flop
Seat 7: dfNim92Z6XK1/h5SFW5vDg (small blind) folded before Flop
Seat 8: KqS/lY/fNB9qUxokm9QfeA (big blind) collected ($1.90)
Seat 9: OMhlmt2waO3z43ZSFNMmog folded before Flop (didn't bet)




PokerStars Game #59941873688:  Hold'em No Limit ($0.10/$0.25) - 2009/07/01 1:48:53 ET
Table 'KU/HrxqxwDz8HKEhYTZ6uw' 6-max Seat #6 is the button
Seat 1: 7LKoiQHXpTQXJvWQrw907g ($34.55 in chips) 
Seat 2: kG34n23qFQA3nzdOJTQ1dA ($24.65 in chips) 
Seat 3: SFmT9ZsVopnukjvAzrxTRg ($25.60 in chips) 
Seat 5: iyZxqznXjv3vtvOJymkoLQ ($52.70 in chips) 
Seat 6: qWxkCeqApAWdAA0evrfDvQ ($12.40 in chips) 
7LKoiQHXpTQXJvWQrw907g: posts small blind $0.10
kG34n23qFQA3nzdOJTQ1dA: posts big blind $0.25
*** HOLE CARDS ***
SFmT9ZsVopnukjvAzrxTRg: folds 
iyZxqznXjv3vtvOJymkoLQ: folds 
qWxkCeqApAWdAA0evrfDvQ: raises $0.75 to $1
7LKoiQHXpTQXJvWQrw907g: folds 
kG34n23qFQA3nzdOJTQ1dA: folds 
Uncalled bet ($0.75) returned to qWxkCeqApAWdAA0evrfDvQ
qWxkCeqApAWdAA0evrfDvQ collected $0.60 from pot
*** SUMMARY ***
Total pot $0.60 | Rake $0 
Seat 1: 7LKoiQHXpTQXJvWQrw907g (small blind) folded before Flop
Seat 2: kG34n23qFQA3nzdOJTQ1dA (big blind) folded before Flop
Seat 3: SFmT9ZsVopnukjvAzrxTRg folded before Flop (didn't bet)
Seat 5: iyZxqznXjv3vtvOJymkoLQ folded before Flop (didn't bet)
Seat 6: qWxkCeqApAWdAA0evrfDvQ (button) collected ($0.60)




PokerStars Game #59941873608:  Hold'em No Limit ($0.10/$0.25) - 2009/07/01 1:48:53 ET
Table 'KEoOIegxPF91KooL2AelUA' 6-max Seat #4 is the button
Seat 2: 0Bg59Tnte1Tc7C4i9Jd9cQ ($5.40 in chips) 
Seat 3: zxeVQGaMKDsDzmSY+AInjA ($13.10 in chips) 
Seat 4: Wo60l2GQnSEc3bxPVyvIUw ($8.05 in chips) 
Seat 5: 08V++DOqzaNrRNsHIwi25w ($51.50 in chips) 
Seat 6: AMrBn4Vx9aAo/vv6WHLk6w ($3.85 in chips) 
08V++DOqzaNrRNsHIwi25w: posts small blind $0.10
AMrBn4Vx9aAo/vv6WHLk6w: posts big blind $0.25
32YL2ZEp8NT4JB2RVM9euQ: sits out 
*** HOLE CARDS ***
0Bg59Tnte1Tc7C4i9Jd9cQ: folds 
zxeVQGaMKDsDzmSY+AInjA: folds 
Wo60l2GQnSEc3bxPVyvIUw: raises $1.25 to $1.50
08V++DOqzaNrRNsHIwi25w: folds 
AMrBn4Vx9aAo/vv6WHLk6w: folds 
Uncalled bet ($1.25) returned to Wo60l2GQnSEc3bxPVyvIUw
Wo60l2GQnSEc3bxPVyvIUw collected $0.60 from pot
*** SUMMARY ***
Total pot $0.60 | Rake $0 
Seat 2: 0Bg59Tnte1Tc7C4i9Jd9cQ folded before Flop (didn't bet)
Seat 3: zxeVQGaMKDsDzmSY+AInjA folded before Flop (didn't bet)
Seat 4: Wo60l2GQnSEc3bxPVyvIUw (button) collected ($0.60)
Seat 5: 08V++DOqzaNrRNsHIwi25w (small blind) folded before Flop
Seat 6: AMrBn4Vx9aAo/vv6WHLk6w (big blind) folded before Flop




PokerStars Game #59941873882:  Hold'em No Limit ($0.10/$0.25) - 2009/07/01 1:48:53 ET
Table 'nc6OeGk/wtaWV+6N+kgnZQ' 6-max Seat #5 is the button
Seat 2: 8ClCHtFXGNplITm+63KB+Q ($37.70 in chips) 
Seat 3: y8wpMWGSX2zHZijurx21mg ($4 in chips) 
Seat 4: 3zD3qLXT1bEffAoWGnc7wg ($31.55 in chips) 
Seat 5: HCS0lMAAPmZE2Tl8J/SuKw ($10.20 in chips) 
8ClCHtFXGNplITm+63KB+Q: posts small blind $0.10
y8wpMWGSX2zHZijurx21mg: posts big blind $0.25
*** HOLE CARDS ***
3zD3qLXT1bEffAoWGnc7wg: folds 
HCS0lMAAPmZE2Tl8J/SuKw: folds 
8ClCHtFXGNplITm+63KB+Q: folds 
Uncalled bet ($0.15) returned to y8wpMWGSX2zHZijurx21mg
y8wpMWGSX2zHZijurx21mg collected $0.20 from pot
*** SUMMARY ***
Total pot $0.20 | Rake $0 
Seat 2: 8ClCHtFXGNplITm+63KB+Q (small blind) folded before Flop
Seat 3: y8wpMWGSX2zHZijurx21mg (big blind) collected ($0.20)
Seat 4: 3zD3qLXT1bEffAoWGnc7wg folded before Flop (didn't bet)
Seat 5: HCS0lMAAPmZE2Tl8J/SuKw (button) folded before Flop (didn't bet)




PokerStars Game #59941874116:  Hold'em No Limit ($0.10/$0.25) - 2009/07/01 1:48:54 ET
Table 'XX2OuOsa8/8AC+/mR/Az6g' 9-max Seat #2 is the button
Seat 1: 56S3mA6Zs3pGR+0p0vUCtg ($24.40 in chips) 
Seat 2: Bb42QRQMhg5/Y0vHP8/2Xw ($26.50 in chips) 
Seat 3: oLa/tXLfSLLB28mcLGrxcg ($24.70 in chips) 
Seat 4: 5pDhXQ+RVy0BGcwfJAJfbg ($25 in chips) 
Seat 5: SpiiQQAzy4MUgV3I5W8giw ($21.15 in chips) 
Seat 6: RCqMONFrSPSArZh2Jsar/w ($20.20 in chips) 
Seat 8: qwr38jl5txoR36M7G5qi4A ($10.35 in chips) 
Seat 9: V6p0jQ/RhUsqpHLmXvEX4Q ($12 in chips) 
oLa/tXLfSLLB28mcLGrxcg: posts small blind $0.10
5pDhXQ+RVy0BGcwfJAJfbg: posts big blind $0.25
*** HOLE CARDS ***
SpiiQQAzy4MUgV3I5W8giw: folds 
RCqMONFrSPSArZh2Jsar/w: calls $0.25
qwr38jl5txoR36M7G5qi4A: folds 
V6p0jQ/RhUsqpHLmXvEX4Q: folds 
56S3mA6Zs3pGR+0p0vUCtg: folds 
Bb42QRQMhg5/Y0vHP8/2Xw: folds 
oLa/tXLfSLLB28mcLGrxcg: folds 
5pDhXQ+RVy0BGcwfJAJfbg: checks 
*** FLOP *** [9d 8c 9c]
5pDhXQ+RVy0BGcwfJAJfbg: checks 
RCqMONFrSPSArZh2Jsar/w: bets $0.25
5pDhXQ+RVy0BGcwfJAJfbg: folds 
Uncalled bet ($0.25) returned to RCqMONFrSPSArZh2Jsar/w
RCqMONFrSPSArZh2Jsar/w collected $0.60 from pot
RCqMONFrSPSArZh2Jsar/w: doesn't show hand 
*** SUMMARY ***
Total pot $0.60 | Rake $0 
Board [9d 8c 9c]
Seat 1: 56S3mA6Zs3pGR+0p0vUCtg folded before Flop (didn't bet)
Seat 2: Bb42QRQMhg5/Y0vHP8/2Xw (button) folded before Flop (didn't bet)
Seat 3: oLa/tXLfSLLB28mcLGrxcg (small blind) folded before Flop
Seat 4: 5pDhXQ+RVy0BGcwfJAJfbg (big blind) folded on the Flop
Seat 5: SpiiQQAzy4MUgV3I5W8giw folded before Flop (didn't bet)
Seat 6: RCqMONFrSPSArZh2Jsar/w collected ($0.60)
Seat 8: qwr38jl5txoR36M7G5qi4A folded before Flop (didn't bet)
Seat 9: V6p0jQ/RhUsqpHLmXvEX4Q folded before Flop (didn't bet)




PokerStars Game #59941874352:  Hold'em No Limit ($0.10/$0.25) - 2009/07/01 1:48:54 ET
Table 'zW+7jPbOLCvlPu+dUGY5WQ' 6-max Seat #2 is the button
Seat 1: eL3+wCBjFGfQ5FMdIZihwA ($26.50 in chips) 
Seat 2: cEMJmfAUQZmMChZe6aacKw ($9.85 in chips) 
Seat 4: i48129QFpEQQ+UN4aNtmww ($16.30 in chips) 
Seat 6: qGHGf/553gQnDoklMRe3tg ($25 in chips) 
i48129QFpEQQ+UN4aNtmww: posts small blind $0.10
qGHGf/553gQnDoklMRe3tg: posts big blind $0.25
*** HOLE CARDS ***
eL3+wCBjFGfQ5FMdIZihwA: raises $0.50 to $0.75
Jax781 joins the table at seat #5 
cEMJmfAUQZmMChZe6aacKw: calls $0.75
i48129QFpEQQ+UN4aNtmww: calls $0.65
qGHGf/553gQnDoklMRe3tg: calls $0.50
*** FLOP *** [9d Td 2s]
i48129QFpEQQ+UN4aNtmww: checks 
qGHGf/553gQnDoklMRe3tg: checks 
eL3+wCBjFGfQ5FMdIZihwA: checks 
cEMJmfAUQZmMChZe6aacKw: bets $2
i48129QFpEQQ+UN4aNtmww: folds 
qGHGf/553gQnDoklMRe3tg: folds 
eL3+wCBjFGfQ5FMdIZihwA: calls $2
*** TURN *** [9d Td 2s] [5h]
eL3+wCBjFGfQ5FMdIZihwA: checks 
cEMJmfAUQZmMChZe6aacKw: bets $1.25
eL3+wCBjFGfQ5FMdIZihwA: calls $1.25
*** RIVER *** [9d Td 2s 5h] [8h]
eL3+wCBjFGfQ5FMdIZihwA: bets $6
cEMJmfAUQZmMChZe6aacKw: folds 
Uncalled bet ($6) returned to eL3+wCBjFGfQ5FMdIZihwA
eL3+wCBjFGfQ5FMdIZihwA collected $9.05 from pot
*** SUMMARY ***
Total pot $9.50 | Rake $0.45 
Board [9d Td 2s 5h 8h]
Seat 1: eL3+wCBjFGfQ5FMdIZihwA collected ($9.05)
Seat 2: cEMJmfAUQZmMChZe6aacKw (button) folded on the River
Seat 4: i48129QFpEQQ+UN4aNtmww (small blind) folded on the Flop
Seat 6: qGHGf/553gQnDoklMRe3tg (big blind) folded on the Flop




PokerStars Game #59941874046:  Hold'em No Limit ($0.10/$0.25) - 2009/07/01 1:48:54 ET
Table 'i93c3z9RLowvuJTKA2F4Jg' 6-max Seat #2 is the button
Seat 1: tbSZq5LHglyHk61mH9eDBw ($30.10 in chips) 
Seat 2: TSmua8tGK3sTbwi0ynrW9Q ($25.95 in chips) 
Seat 3: v8m8XHovI5tqEA9mvplDSw ($26.55 in chips) 
Seat 4: o86X2Q5GEDU3uP9oj1iFZA ($37.15 in chips) 
Seat 6: FpN4KbLjlyRRKiVaQcoLqA ($18.25 in chips) 
v8m8XHovI5tqEA9mvplDSw: posts small blind $0.10
o86X2Q5GEDU3uP9oj1iFZA: posts big blind $0.25
TI/C5Q+DEl4fLR3AofwYdg: sits out 
*** HOLE CARDS ***
FpN4KbLjlyRRKiVaQcoLqA: folds 
tbSZq5LHglyHk61mH9eDBw: folds 
TSmua8tGK3sTbwi0ynrW9Q: folds 
v8m8XHovI5tqEA9mvplDSw: folds 
Uncalled bet ($0.15) returned to o86X2Q5GEDU3uP9oj1iFZA
o86X2Q5GEDU3uP9oj1iFZA collected $0.20 from pot
*** SUMMARY ***
Total pot $0.20 | Rake $0 
Seat 1: tbSZq5LHglyHk61mH9eDBw folded before Flop (didn't bet)
Seat 2: TSmua8tGK3sTbwi0ynrW9Q (button) folded before Flop (didn't bet)
Seat 3: v8m8XHovI5tqEA9mvplDSw (small blind) folded before Flop
Seat 4: o86X2Q5GEDU3uP9oj1iFZA (big blind) collected ($0.20)
Seat 6: FpN4KbLjlyRRKiVaQcoLqA folded before Flop (didn't bet)




PokerStars Game #59941874450:  Hold'em No Limit ($0.10/$0.25) - 2009/07/01 1:48:54 ET
Table 'v+LTGPWbrLum+Ggd4ef6lg' 9-max Seat #3 is the button
Seat 1: zUXhymECc2C9W9ZNw6qppA ($9.30 in chips) 
Seat 2: r/xYbgD9yVdKFWRgSQD/+Q ($10.95 in chips) 
Seat 3: 7ovWM9c1nQLTFritEGRG/A ($2.60 in chips) 
Seat 5: +8OkYWUhGfkDbAtQl/ovYQ ($23.40 in chips) 
Seat 7: kUxTO3D2eQcx4oJIpJAK4Q ($7.35 in chips) 
Seat 8: +sbyWwIcFp9kP0bDtMegfQ ($41.20 in chips) 
Seat 9: cZ99hugmLBj9KhTlc8nCSw ($25 in chips) 
yqkowiRWZ6NvRN9UUkYIlA will be allowed to play after the button
+8OkYWUhGfkDbAtQl/ovYQ: posts small blind $0.10
+qc/EYCgLC65SpGvr35eNg: is sitting out 
kUxTO3D2eQcx4oJIpJAK4Q: posts big blind $0.25
*** HOLE CARDS ***
+sbyWwIcFp9kP0bDtMegfQ: folds 
cZ99hugmLBj9KhTlc8nCSw: folds 
zUXhymECc2C9W9ZNw6qppA: folds 
r/xYbgD9yVdKFWRgSQD/+Q: folds 
r/xYbgD9yVdKFWRgSQD/+Q leaves the table
7ovWM9c1nQLTFritEGRG/A: calls $0.25
+8OkYWUhGfkDbAtQl/ovYQ: calls $0.15
kUxTO3D2eQcx4oJIpJAK4Q: checks 
*** FLOP *** [Ks Jc 6c]
+8OkYWUhGfkDbAtQl/ovYQ: checks 
clJsV3v77RS07bDKY+705w joins the table at seat #2 
kUxTO3D2eQcx4oJIpJAK4Q: checks 
7ovWM9c1nQLTFritEGRG/A: bets $2.35 and is all-in
+8OkYWUhGfkDbAtQl/ovYQ: folds 
kUxTO3D2eQcx4oJIpJAK4Q: folds 
Uncalled bet ($2.35) returned to 7ovWM9c1nQLTFritEGRG/A
7ovWM9c1nQLTFritEGRG/A collected $0.75 from pot
7ovWM9c1nQLTFritEGRG/A: doesn't show hand 
*** SUMMARY ***
Total pot $0.75 | Rake $0 
Board [Ks Jc 6c]
Seat 1: zUXhymECc2C9W9ZNw6qppA folded before Flop (didn't bet)
Seat 2: r/xYbgD9yVdKFWRgSQD/+Q folded before Flop (didn't bet)
Seat 3: 7ovWM9c1nQLTFritEGRG/A (button) collected ($0.75)
Seat 5: +8OkYWUhGfkDbAtQl/ovYQ (small blind) folded on the Flop
Seat 7: kUxTO3D2eQcx4oJIpJAK4Q (big blind) folded on the Flop
Seat 8: +sbyWwIcFp9kP0bDtMegfQ folded before Flop (didn't bet)
Seat 9: cZ99hugmLBj9KhTlc8nCSw folded before Flop (didn't bet)




PokerStars Game #59941874772:  Hold'em No Limit ($0.10/$0.25) - 2009/07/01 1:48:55 ET
Table 'oJpFwZj9+FUGHX90Un8s9Q' 6-max Seat #3 is the button
Seat 1: 6DwBRH+xZ12AAZmeAg+aXw ($23.55 in chips) 
Seat 2: NtrVQ9UIql0rDCnKDKZ5FQ ($19.70 in chips) 
Seat 3: kyRaCIljYA6l33lSKQfNsg ($24.65 in chips) 
Seat 4: 6elpmfyt4Zw0yvd8lePSMQ ($20.65 in chips) 
Seat 5: kG34n23qFQA3nzdOJTQ1dA ($55.45 in chips) 
Seat 6: 7LpHJVeM6k1mQdC6HXYzww ($25.35 in chips) 
6elpmfyt4Zw0yvd8lePSMQ: posts small blind $0.10
kG34n23qFQA3nzdOJTQ1dA: posts big blind $0.25
*** HOLE CARDS ***
7LpHJVeM6k1mQdC6HXYzww: raises $0.55 to $0.80
6DwBRH+xZ12AAZmeAg+aXw: folds 
NtrVQ9UIql0rDCnKDKZ5FQ: folds 
kyRaCIljYA6l33lSKQfNsg: folds 
6elpmfyt4Zw0yvd8lePSMQ: folds 
kG34n23qFQA3nzdOJTQ1dA: folds 
Uncalled bet ($0.55) returned to 7LpHJVeM6k1mQdC6HXYzww
7LpHJVeM6k1mQdC6HXYzww collected $0.60 from pot
7LpHJVeM6k1mQdC6HXYzww: doesn't show hand 
*** SUMMARY ***
Total pot $0.60 | Rake $0 
Seat 1: 6DwBRH+xZ12AAZmeAg+aXw folded before Flop (didn't bet)
Seat 2: NtrVQ9UIql0rDCnKDKZ5FQ folded before Flop (didn't bet)
Seat 3: kyRaCIljYA6l33lSKQfNsg (button) folded before Flop (didn't bet)
Seat 4: 6elpmfyt4Zw0yvd8lePSMQ (small blind) folded before Flop
Seat 5: kG34n23qFQA3nzdOJTQ1dA (big blind) folded before Flop
Seat 6: 7LpHJVeM6k1mQdC6HXYzww collected ($0.60)




PokerStars Game #59941874882:  Hold'em No Limit ($0.10/$0.25) - 2009/07/01 1:48:55 ET
Table 'AchTjdLS1zBUbH3ZIx6f0w' 6-max Seat #5 is the button
Seat 1: rZ0bUtoerhFGDUSRQMnFog ($30.80 in chips) 
Seat 2: kG34n23qFQA3nzdOJTQ1dA ($65.90 in chips) 
Seat 3: k9vn40MOqqb+xF+7GZ6v2g ($29 in chips) 
Seat 4: q6WfTUAD9mowIP63ASq2Dg ($31.20 in chips) 
Seat 5: 0av6tRNdi0Ui4f15L7gsVg ($23.90 in chips) 
Seat 6: epAUIB7h2FJXzUPRIvSkRA ($25.10 in chips) 
epAUIB7h2FJXzUPRIvSkRA: posts small blind $0.10
rZ0bUtoerhFGDUSRQMnFog: posts big blind $0.25
*** HOLE CARDS ***
kG34n23qFQA3nzdOJTQ1dA: folds 
k9vn40MOqqb+xF+7GZ6v2g: folds 
q6WfTUAD9mowIP63ASq2Dg: folds 
0av6tRNdi0Ui4f15L7gsVg: folds 
epAUIB7h2FJXzUPRIvSkRA: raises $0.75 to $1
rZ0bUtoerhFGDUSRQMnFog: calls $0.75
*** FLOP *** [6d 3s 4s]
epAUIB7h2FJXzUPRIvSkRA: bets $1.50
rZ0bUtoerhFGDUSRQMnFog: folds 
Uncalled bet ($1.50) returned to epAUIB7h2FJXzUPRIvSkRA
epAUIB7h2FJXzUPRIvSkRA collected $1.90 from pot
epAUIB7h2FJXzUPRIvSkRA: doesn't show hand 
*** SUMMARY ***
Total pot $2 | Rake $0.10 
Board [6d 3s 4s]
Seat 1: rZ0bUtoerhFGDUSRQMnFog (big blind) folded on the Flop
Seat 2: kG34n23qFQA3nzdOJTQ1dA folded before Flop (didn't bet)
Seat 3: k9vn40MOqqb+xF+7GZ6v2g folded before Flop (didn't bet)
Seat 4: q6WfTUAD9mowIP63ASq2Dg folded before Flop (didn't bet)
Seat 5: 0av6tRNdi0Ui4f15L7gsVg (button) folded before Flop (didn't bet)
Seat 6: epAUIB7h2FJXzUPRIvSkRA (small blind) collected ($1.90)




PokerStars Game #59941874880:  Hold'em No Limit ($0.10/$0.25) - 2009/07/01 1:48:55 ET
Table '4ZbiE0ZYjzqmgu6+sO1prg' 9-max Seat #7 is the button
Seat 1: eXiRSFoUjkV5taBc4N8rMQ ($9.45 in chips) 
Seat 2: 9lvO/qyU+xrU95Teu1fv0g ($5.55 in chips) 
Seat 3: HPEB+AtKw1+C/cxU0o1ciw ($25.20 in chips) 
Seat 4: w1ukf8uPa4+WH561TtVRxA ($25.25 in chips) 
Seat 5: +2kMBNpY4nF1qNCRd8SJLA ($43.60 in chips) 
Seat 6: UmzixCpC0bAc1lDEjgB3NQ ($10 in chips) 
Seat 7: aNpwfA31EREwO+ar4XzBCw ($25.95 in chips) 
Seat 8: cZ99hugmLBj9KhTlc8nCSw ($29.35 in chips) 
Seat 9: RCqMONFrSPSArZh2Jsar/w ($20.35 in chips) 
cZ99hugmLBj9KhTlc8nCSw: posts small blind $0.10
RCqMONFrSPSArZh2Jsar/w: posts big blind $0.25
UmzixCpC0bAc1lDEjgB3NQ: posts small & big blinds $0.35
*** HOLE CARDS ***
eXiRSFoUjkV5taBc4N8rMQ: calls $0.25
9lvO/qyU+xrU95Teu1fv0g: folds 
HPEB+AtKw1+C/cxU0o1ciw: folds 
w1ukf8uPa4+WH561TtVRxA: folds 
+2kMBNpY4nF1qNCRd8SJLA: folds 
UmzixCpC0bAc1lDEjgB3NQ: checks 
aNpwfA31EREwO+ar4XzBCw: folds 
cZ99hugmLBj9KhTlc8nCSw: folds 
RCqMONFrSPSArZh2Jsar/w: checks 
*** FLOP *** [5s Ah 4s]
RCqMONFrSPSArZh2Jsar/w: checks 
eXiRSFoUjkV5taBc4N8rMQ: checks 
UmzixCpC0bAc1lDEjgB3NQ: bets $0.25
RCqMONFrSPSArZh2Jsar/w: calls $0.25
eXiRSFoUjkV5taBc4N8rMQ: calls $0.25
*** TURN *** [5s Ah 4s] [5c]
RCqMONFrSPSArZh2Jsar/w: checks 
eXiRSFoUjkV5taBc4N8rMQ: checks 
UmzixCpC0bAc1lDEjgB3NQ: bets $0.75
RCqMONFrSPSArZh2Jsar/w: folds 
eXiRSFoUjkV5taBc4N8rMQ: folds 
Uncalled bet ($0.75) returned to UmzixCpC0bAc1lDEjgB3NQ
UmzixCpC0bAc1lDEjgB3NQ collected $1.65 from pot
eXiRSFoUjkV5taBc4N8rMQ leaves the table
*** SUMMARY ***
Total pot $1.70 | Rake $0.05 
Board [5s Ah 4s 5c]
Seat 1: eXiRSFoUjkV5taBc4N8rMQ folded on the Turn
Seat 2: 9lvO/qyU+xrU95Teu1fv0g folded before Flop (didn't bet)
Seat 3: HPEB+AtKw1+C/cxU0o1ciw folded before Flop (didn't bet)
Seat 4: w1ukf8uPa4+WH561TtVRxA folded before Flop (didn't bet)
Seat 5: +2kMBNpY4nF1qNCRd8SJLA folded before Flop (didn't bet)
Seat 6: UmzixCpC0bAc1lDEjgB3NQ collected ($1.65)
Seat 7: aNpwfA31EREwO+ar4XzBCw (button) folded before Flop (didn't bet)
Seat 8: cZ99hugmLBj9KhTlc8nCSw (small blind) folded before Flop
Seat 9: RCqMONFrSPSArZh2Jsar/w (big blind) folded on the Turn




PokerStars Game #59941874760:  Hold'em No Limit ($0.10/$0.25) - 2009/07/01 1:48:55 ET
Table 'ouLhepGYovxB2x0QxH7cVg' 9-max Seat #5 is the button
Seat 1: ghNKXUBl/H+t83JF079ZBA ($25 in chips) 
Seat 2: r1Z5m4PwSI5ANp7qCE1OJw ($23.35 in chips) 
Seat 3: bXpVeaSTPBFSPJmeXxO7nw ($4.90 in chips) 
Seat 4: a0Sx6GHY7ln2Ns2C97eXeA ($37.45 in chips) 
Seat 5: v60REj6f8jzMYT0VsZvaPQ ($10.90 in chips) 
Seat 6: hYvTc4PYNrAaNAIVoM94Hw ($4.75 in chips) 
Seat 7: JRV2PblFtPFz51l0Fwyz8g ($24.25 in chips) 
Seat 8: tLcDklc2rBORNfixyRfVfw ($25.35 in chips) 
Seat 9: ljemhp25Zg+nlA9DLCIiUw ($25.30 in chips) 
hYvTc4PYNrAaNAIVoM94Hw: posts small blind $0.10
JRV2PblFtPFz51l0Fwyz8g: posts big blind $0.25
*** HOLE CARDS ***
tLcDklc2rBORNfixyRfVfw: folds 
ljemhp25Zg+nlA9DLCIiUw: folds 
ghNKXUBl/H+t83JF079ZBA: folds 
r1Z5m4PwSI5ANp7qCE1OJw: folds 
bXpVeaSTPBFSPJmeXxO7nw: folds 
a0Sx6GHY7ln2Ns2C97eXeA: raises $0.50 to $0.75
v60REj6f8jzMYT0VsZvaPQ: folds 
hYvTc4PYNrAaNAIVoM94Hw: folds 
JRV2PblFtPFz51l0Fwyz8g: calls $0.50
*** FLOP *** [9c Td Kd]
JRV2PblFtPFz51l0Fwyz8g: checks 
a0Sx6GHY7ln2Ns2C97eXeA: bets $1.25
JRV2PblFtPFz51l0Fwyz8g: raises $2.25 to $3.50
a0Sx6GHY7ln2Ns2C97eXeA: raises $8.50 to $12
JRV2PblFtPFz51l0Fwyz8g: raises $11.50 to $23.50 and is all-in
a0Sx6GHY7ln2Ns2C97eXeA: calls $11.50
*** TURN *** [9c Td Kd] [Qh]
*** RIVER *** [9c Td Kd Qh] [Th]
*** SHOW DOWN ***
JRV2PblFtPFz51l0Fwyz8g: shows [Ad Ks] (two pair, Kings and Tens)
a0Sx6GHY7ln2Ns2C97eXeA: shows [Tc 9h] (a full house, Tens full of Nines)
a0Sx6GHY7ln2Ns2C97eXeA collected $46.20 from pot
*** SUMMARY ***
Total pot $48.60 | Rake $2.40 
Board [9c Td Kd Qh Th]
Seat 1: ghNKXUBl/H+t83JF079ZBA folded before Flop (didn't bet)
Seat 2: r1Z5m4PwSI5ANp7qCE1OJw folded before Flop (didn't bet)
Seat 3: bXpVeaSTPBFSPJmeXxO7nw folded before Flop (didn't bet)
Seat 4: a0Sx6GHY7ln2Ns2C97eXeA showed [Tc 9h] and won ($46.20) with a full house, Tens full of Nines
Seat 5: v60REj6f8jzMYT0VsZvaPQ (button) folded before Flop (didn't bet)
Seat 6: hYvTc4PYNrAaNAIVoM94Hw (small blind) folded before Flop
Seat 7: JRV2PblFtPFz51l0Fwyz8g (big blind) showed [Ad Ks] and lost with two pair, Kings and Tens
Seat 8: tLcDklc2rBORNfixyRfVfw folded before Flop (didn't bet)
Seat 9: ljemhp25Zg+nlA9DLCIiUw folded before Flop (didn't bet)




PokerStars Game #59941875460:  Hold'em No Limit ($0.10/$0.25) - 2009/07/01 1:48:56 ET
Table 'CBnRhp0d6E2+/NtM7Vbruw' 9-max Seat #1 is the button
Seat 1: 18G4P1XstjNvItdGUITxgw ($25 in chips) 
Seat 2: cZ99hugmLBj9KhTlc8nCSw ($26.60 in chips) 
Seat 5: CT7Xj/V/O5rBlhtt+RZeFQ ($25 in chips) 
Seat 6: CvL9Ch1HYCVbTsfpNucitg ($4.30 in chips) 
Seat 7: j4q3p0lesp63b1gZDwLBZw ($5 in chips) 
Seat 8: MG90wfSJZnOejs/KD3vlQQ ($25.35 in chips) 
Seat 9: xHZZRLAaFUIC8WWI8ljOJA ($29.55 in chips) 
cZ99hugmLBj9KhTlc8nCSw: posts small blind $0.10
aNpwfA31EREwO+ar4XzBCw: is sitting out 
CT7Xj/V/O5rBlhtt+RZeFQ: posts big blind $0.25
*** HOLE CARDS ***
CvL9Ch1HYCVbTsfpNucitg: folds 
aNpwfA31EREwO+ar4XzBCw leaves the table
j4q3p0lesp63b1gZDwLBZw: folds 
MG90wfSJZnOejs/KD3vlQQ: folds 
xHZZRLAaFUIC8WWI8ljOJA: folds 
18G4P1XstjNvItdGUITxgw: folds 
cZ99hugmLBj9KhTlc8nCSw: folds 
Uncalled bet ($0.15) returned to CT7Xj/V/O5rBlhtt+RZeFQ
CT7Xj/V/O5rBlhtt+RZeFQ collected $0.20 from pot
CT7Xj/V/O5rBlhtt+RZeFQ: doesn't show hand 
*** SUMMARY ***
Total pot $0.20 | Rake $0 
Seat 1: 18G4P1XstjNvItdGUITxgw (button) folded before Flop (didn't bet)
Seat 2: cZ99hugmLBj9KhTlc8nCSw (small blind) folded before Flop
Seat 5: CT7Xj/V/O5rBlhtt+RZeFQ (big blind) collected ($0.20)
Seat 6: CvL9Ch1HYCVbTsfpNucitg folded before Flop (didn't bet)
Seat 7: j4q3p0lesp63b1gZDwLBZw folded before Flop (didn't bet)
Seat 8: MG90wfSJZnOejs/KD3vlQQ folded before Flop (didn't bet)
Seat 9: xHZZRLAaFUIC8WWI8ljOJA folded before Flop (didn't bet)




PokerStars Game #59941875658:  Hold'em No Limit ($0.10/$0.25) - 2009/07/01 1:48:57 ET
Table '/VaaaFnlEJoYVomG9uxHkA' 9-max Seat #5 is the button
Seat 1: Th3FldXKQW6hWVVPahaoOQ ($26.65 in chips) 
Seat 2: DIkeSkosO/tsUp9d2JVyTA ($54.75 in chips) 
Seat 3: MtVtHDqIJTyUcXkRBBDIVA ($26.15 in chips) 
Seat 4: j4q3p0lesp63b1gZDwLBZw ($5 in chips) 
Seat 5: cZ99hugmLBj9KhTlc8nCSw ($25 in chips) 
Seat 7: F7pnn6czNpHvRM55XcA2EA ($31.35 in chips) 
Seat 8: dfNim92Z6XK1/h5SFW5vDg ($50.85 in chips) 
F7pnn6czNpHvRM55XcA2EA: posts small blind $0.10
dfNim92Z6XK1/h5SFW5vDg: posts big blind $0.25
DdPXdieucQ+n99u1n3A+rQ: sits out 
*** HOLE CARDS ***
Th3FldXKQW6hWVVPahaoOQ: folds 
DIkeSkosO/tsUp9d2JVyTA: folds 
MtVtHDqIJTyUcXkRBBDIVA: folds 
j4q3p0lesp63b1gZDwLBZw: raises $0.75 to $1
cZ99hugmLBj9KhTlc8nCSw: folds 
F7pnn6czNpHvRM55XcA2EA: folds 
dfNim92Z6XK1/h5SFW5vDg: folds 
Uncalled bet ($0.75) returned to j4q3p0lesp63b1gZDwLBZw
j4q3p0lesp63b1gZDwLBZw collected $0.60 from pot
j4q3p0lesp63b1gZDwLBZw: doesn't show hand 
*** SUMMARY ***
Total pot $0.60 | Rake $0 
Seat 1: Th3FldXKQW6hWVVPahaoOQ folded before Flop (didn't bet)
Seat 2: DIkeSkosO/tsUp9d2JVyTA folded before Flop (didn't bet)
Seat 3: MtVtHDqIJTyUcXkRBBDIVA folded before Flop (didn't bet)
Seat 4: j4q3p0lesp63b1gZDwLBZw collected ($0.60)
Seat 5: cZ99hugmLBj9KhTlc8nCSw (button) folded before Flop (didn't bet)
Seat 7: F7pnn6czNpHvRM55XcA2EA (small blind) folded before Flop
Seat 8: dfNim92Z6XK1/h5SFW5vDg (big blind) folded before Flop




PokerStars Game #59941875844:  Hold'em No Limit ($0.10/$0.25) - 2009/07/01 1:48:57 ET
Table 'rO1I30HnuCPB0M8qEX1TCQ' 9-max Seat #4 is the button
Seat 2: z1hPotrGOZjUjyoopZ7Ulg ($25.40 in chips) 
Seat 3: 2wcFsZsqEP5w1StUTVzJCg ($12.80 in chips) 
Seat 4: yyG4svzOpC1A+sUP/scg6w ($10.05 in chips) 
Seat 5: WQe4GbiYBiPsb5WKFKkijQ ($9.75 in chips) 
Seat 6: 5n7e7I+px7c6CQmLpPbtsg ($4.65 in chips) 
Seat 7: bXpVeaSTPBFSPJmeXxO7nw ($5 in chips) 
Seat 9: wnerYvSRWT9Sm4X3ip/c8w ($35.15 in chips) 
WQe4GbiYBiPsb5WKFKkijQ: posts small blind $0.10
5n7e7I+px7c6CQmLpPbtsg: posts big blind $0.25
CGjLyv/AvljZy2g76nYkzQ: sits out 
*** HOLE CARDS ***
bXpVeaSTPBFSPJmeXxO7nw: folds 
wnerYvSRWT9Sm4X3ip/c8w: folds 
z1hPotrGOZjUjyoopZ7Ulg: calls $0.25
2wcFsZsqEP5w1StUTVzJCg: folds 
yyG4svzOpC1A+sUP/scg6w: folds 
Chowtowin joins the table at seat #1 
WQe4GbiYBiPsb5WKFKkijQ: calls $0.15
5n7e7I+px7c6CQmLpPbtsg: checks 
*** FLOP *** [Jd 9s Tc]
WQe4GbiYBiPsb5WKFKkijQ: bets $0.50
5n7e7I+px7c6CQmLpPbtsg: folds 
z1hPotrGOZjUjyoopZ7Ulg: folds 
Uncalled bet ($0.50) returned to WQe4GbiYBiPsb5WKFKkijQ
WQe4GbiYBiPsb5WKFKkijQ collected $0.75 from pot
WQe4GbiYBiPsb5WKFKkijQ: doesn't show hand 
*** SUMMARY ***
Total pot $0.75 | Rake $0 
Board [Jd 9s Tc]
Seat 2: z1hPotrGOZjUjyoopZ7Ulg folded on the Flop
Seat 3: 2wcFsZsqEP5w1StUTVzJCg folded before Flop (didn't bet)
Seat 4: yyG4svzOpC1A+sUP/scg6w (button) folded before Flop (didn't bet)
Seat 5: WQe4GbiYBiPsb5WKFKkijQ (small blind) collected ($0.75)
Seat 6: 5n7e7I+px7c6CQmLpPbtsg (big blind) folded on the Flop
Seat 7: bXpVeaSTPBFSPJmeXxO7nw folded before Flop (didn't bet)
Seat 9: wnerYvSRWT9Sm4X3ip/c8w folded before Flop (didn't bet)




PokerStars Game #59941875552:  Hold'em No Limit ($0.10/$0.25) - 2009/07/01 1:48:57 ET
Table 'HzFR0rxmDAPu5GzYR0AlYg' 6-max Seat #1 is the button
Seat 1: v+QfkGiuj9bgtuNoVnDO8w ($34.55 in chips) 
Seat 2: UA5OsKS3VPaxa7uC8La/kA ($51.35 in chips) 
Seat 3: kG34n23qFQA3nzdOJTQ1dA ($24.90 in chips) 
Seat 4: Mhj3q7cxev+XjXZxEE6/Cw ($25.35 in chips) 
Seat 5: lquriepNQBhDV5P1SWHhnA ($26.75 in chips) 
Seat 6: jp34e617tIzV8tKIWmfAbA ($35.55 in chips) 
UA5OsKS3VPaxa7uC8La/kA: posts small blind $0.10
kG34n23qFQA3nzdOJTQ1dA: posts big blind $0.25
*** HOLE CARDS ***
Mhj3q7cxev+XjXZxEE6/Cw: folds 
lquriepNQBhDV5P1SWHhnA: raises $0.50 to $0.75
jp34e617tIzV8tKIWmfAbA: folds 
v+QfkGiuj9bgtuNoVnDO8w: folds 
UA5OsKS3VPaxa7uC8La/kA: folds 
kG34n23qFQA3nzdOJTQ1dA: folds 
Uncalled bet ($0.50) returned to lquriepNQBhDV5P1SWHhnA
lquriepNQBhDV5P1SWHhnA collected $0.60 from pot
lquriepNQBhDV5P1SWHhnA: doesn't show hand 
*** SUMMARY ***
Total pot $0.60 | Rake $0 
Seat 1: v+QfkGiuj9bgtuNoVnDO8w (button) folded before Flop (didn't bet)
Seat 2: UA5OsKS3VPaxa7uC8La/kA (small blind) folded before Flop
Seat 3: kG34n23qFQA3nzdOJTQ1dA (big blind) folded before Flop
Seat 4: Mhj3q7cxev+XjXZxEE6/Cw folded before Flop (didn't bet)
Seat 5: lquriepNQBhDV5P1SWHhnA collected ($0.60)
Seat 6: jp34e617tIzV8tKIWmfAbA folded before Flop (didn't bet)




PokerStars Game #59941875616:  Hold'em No Limit ($0.10/$0.25) - 2009/07/01 1:48:57 ET
Table 'isKy4XK8wJM0x735/D4hWA' 6-max Seat #3 is the button
Seat 1: kwsRmpZ1ZaLooISs+zfyKg ($24.75 in chips) 
Seat 2: 6elpmfyt4Zw0yvd8lePSMQ ($38.90 in chips) 
Seat 3: jp34e617tIzV8tKIWmfAbA ($25.70 in chips) 
Seat 4: DFi/Lzkjsfv8QswS80JX9Q ($31.55 in chips) 
Seat 5: lquriepNQBhDV5P1SWHhnA ($25.60 in chips) 
Seat 6: GbCVUNssQ7mqsPWr7J4d3w ($5 in chips) 
DFi/Lzkjsfv8QswS80JX9Q: posts small blind $0.10
lquriepNQBhDV5P1SWHhnA: posts big blind $0.25
*** HOLE CARDS ***
GbCVUNssQ7mqsPWr7J4d3w: folds 
kwsRmpZ1ZaLooISs+zfyKg: raises $0.75 to $1
6elpmfyt4Zw0yvd8lePSMQ: folds 
jp34e617tIzV8tKIWmfAbA: folds 
DFi/Lzkjsfv8QswS80JX9Q: folds 
lquriepNQBhDV5P1SWHhnA: folds 
Uncalled bet ($0.75) returned to kwsRmpZ1ZaLooISs+zfyKg
kwsRmpZ1ZaLooISs+zfyKg collected $0.60 from pot
*** SUMMARY ***
Total pot $0.60 | Rake $0 
Seat 1: kwsRmpZ1ZaLooISs+zfyKg collected ($0.60)
Seat 2: 6elpmfyt4Zw0yvd8lePSMQ folded before Flop (didn't bet)
Seat 3: jp34e617tIzV8tKIWmfAbA (button) folded before Flop (didn't bet)
Seat 4: DFi/Lzkjsfv8QswS80JX9Q (small blind) folded before Flop
Seat 5: lquriepNQBhDV5P1SWHhnA (big blind) folded before Flop
Seat 6: GbCVUNssQ7mqsPWr7J4d3w folded before Flop (didn't bet)




PokerStars Game #59941875584:  Hold'em No Limit ($0.10/$0.25) - 2009/07/01 1:48:57 ET
Table 'vZfV/Uj0q8joA1du9sRJSg' 6-max Seat #6 is the button
Seat 1: Hsvkc0/G2VV78oVmWYXecw ($5.80 in chips) 
Seat 2: wMiE3yTbDJGOLOF9th7KPA ($5.30 in chips) 
Seat 3: cWc85bEzdRzpUMhRKm8pwQ ($25 in chips) 
Seat 4: v+QfkGiuj9bgtuNoVnDO8w ($43.50 in chips) 
Seat 5: kyRaCIljYA6l33lSKQfNsg ($29.30 in chips) 
Seat 6: 8ClCHtFXGNplITm+63KB+Q ($48.70 in chips) 
Hsvkc0/G2VV78oVmWYXecw: posts small blind $0.10
wMiE3yTbDJGOLOF9th7KPA: posts big blind $0.25
*** HOLE CARDS ***
cWc85bEzdRzpUMhRKm8pwQ: folds 
v+QfkGiuj9bgtuNoVnDO8w: folds 
kyRaCIljYA6l33lSKQfNsg: folds 
8ClCHtFXGNplITm+63KB+Q: folds 
Hsvkc0/G2VV78oVmWYXecw: raises $0.50 to $0.75
wMiE3yTbDJGOLOF9th7KPA: calls $0.50
*** FLOP *** [Qd 5d 3c]
Hsvkc0/G2VV78oVmWYXecw: bets $1.25
wMiE3yTbDJGOLOF9th7KPA: raises $3.30 to $4.55 and is all-in
Hsvkc0/G2VV78oVmWYXecw: calls $3.30
*** TURN *** [Qd 5d 3c] [Qh]
*** RIVER *** [Qd 5d 3c Qh] [Ac]
*** SHOW DOWN ***
Hsvkc0/G2VV78oVmWYXecw: shows [Ad 9d] (two pair, Aces and Queens)
wMiE3yTbDJGOLOF9th7KPA: shows [4s Qs] (three of a kind, Queens)
wMiE3yTbDJGOLOF9th7KPA collected $10.10 from pot
*** SUMMARY ***
Total pot $10.60 | Rake $0.50 
Board [Qd 5d 3c Qh Ac]
Seat 1: Hsvkc0/G2VV78oVmWYXecw (small blind) showed [Ad 9d] and lost with two pair, Aces and Queens
Seat 2: wMiE3yTbDJGOLOF9th7KPA (big blind) showed [4s Qs] and won ($10.10) with three of a kind, Queens
Seat 3: cWc85bEzdRzpUMhRKm8pwQ folded before Flop (didn't bet)
Seat 4: v+QfkGiuj9bgtuNoVnDO8w folded before Flop (didn't bet)
Seat 5: kyRaCIljYA6l33lSKQfNsg folded before Flop (didn't bet)
Seat 6: 8ClCHtFXGNplITm+63KB+Q (button) folded before Flop (didn't bet)




PokerStars Game #59941875714:  Hold'em No Limit ($0.10/$0.25) - 2009/07/01 1:48:57 ET
Table 'o0CDOvKO/bn1WjeymDrXfA' 6-max Seat #2 is the button
Seat 1: if4dh6jhJXeN3/qd3qCp9g ($27.05 in chips) 
Seat 2: uAJL+E2git8iAiFyAvVOnw ($7.85 in chips) 
Seat 3: OtVWmpxX2/9L8bb1GSKTuA ($21.65 in chips) 
Seat 4: i9LqF5rD3bvtbEE7HWgr3Q ($25 in chips) 
Seat 5: dOIoLBxmpLHSXBN9LZnf0Q ($32.50 in chips) 
Seat 6: SS/yfeArhULzIcOPe8MdPg ($25 in chips) 
OtVWmpxX2/9L8bb1GSKTuA: posts small blind $0.10
i9LqF5rD3bvtbEE7HWgr3Q: posts big blind $0.25
*** HOLE CARDS ***
dOIoLBxmpLHSXBN9LZnf0Q: folds 
SS/yfeArhULzIcOPe8MdPg: folds 
if4dh6jhJXeN3/qd3qCp9g: folds 
uAJL+E2git8iAiFyAvVOnw: raises $0.75 to $1
OtVWmpxX2/9L8bb1GSKTuA: folds 
i9LqF5rD3bvtbEE7HWgr3Q: folds 
Uncalled bet ($0.75) returned to uAJL+E2git8iAiFyAvVOnw
uAJL+E2git8iAiFyAvVOnw collected $0.60 from pot
*** SUMMARY ***
Total pot $0.60 | Rake $0 
Seat 1: if4dh6jhJXeN3/qd3qCp9g folded before Flop (didn't bet)
Seat 2: uAJL+E2git8iAiFyAvVOnw (button) collected ($0.60)
Seat 3: OtVWmpxX2/9L8bb1GSKTuA (small blind) folded before Flop
Seat 4: i9LqF5rD3bvtbEE7HWgr3Q (big blind) folded before Flop
Seat 5: dOIoLBxmpLHSXBN9LZnf0Q folded before Flop (didn't bet)
Seat 6: SS/yfeArhULzIcOPe8MdPg folded before Flop (didn't bet)




PokerStars Game #59941875506:  Hold'em No Limit ($0.10/$0.25) - 2009/07/01 1:48:57 ET
Table 'Jj2eLzVCUVAGBmM+Og79iQ' 9-max Seat #7 is the button
Seat 1: ShXPHWfjhfmAwLgDdm6bRQ ($7.25 in chips) 
Seat 3: HPEB+AtKw1+C/cxU0o1ciw ($24.40 in chips) 
Seat 4: aNpwfA31EREwO+ar4XzBCw ($44.60 in chips) 
Seat 5: UkF1eqqUN0CCiimXAuN7og ($4.65 in chips) 
Seat 6: jZURAM/dgGCX+5lATlZugw ($17.35 in chips) 
Seat 7: K0b5wNInj6hUGRr6yzKFtw ($59.15 in chips) 
Seat 8: H5Se03ZqSX7tbULXur2MAg ($33.90 in chips) 
Seat 9: vSkQm2EelzwRGDDQQk0Fqw ($5 in chips) 
H5Se03ZqSX7tbULXur2MAg: posts small blind $0.10
vSkQm2EelzwRGDDQQk0Fqw: posts big blind $0.25
*** HOLE CARDS ***
Jgold2790 leaves the table
ShXPHWfjhfmAwLgDdm6bRQ: folds 
HPEB+AtKw1+C/cxU0o1ciw: folds 
aNpwfA31EREwO+ar4XzBCw: folds 
UkF1eqqUN0CCiimXAuN7og: folds 
jZURAM/dgGCX+5lATlZugw: folds 
K0b5wNInj6hUGRr6yzKFtw: raises $0.75 to $1
H5Se03ZqSX7tbULXur2MAg: folds 
vSkQm2EelzwRGDDQQk0Fqw: folds 
Uncalled bet ($0.75) returned to K0b5wNInj6hUGRr6yzKFtw
K0b5wNInj6hUGRr6yzKFtw collected $0.60 from pot
K0b5wNInj6hUGRr6yzKFtw: doesn't show hand 
*** SUMMARY ***
Total pot $0.60 | Rake $0 
Seat 1: ShXPHWfjhfmAwLgDdm6bRQ folded before Flop (didn't bet)
Seat 3: HPEB+AtKw1+C/cxU0o1ciw folded before Flop (didn't bet)
Seat 4: aNpwfA31EREwO+ar4XzBCw folded before Flop (didn't bet)
Seat 5: UkF1eqqUN0CCiimXAuN7og folded before Flop (didn't bet)
Seat 6: jZURAM/dgGCX+5lATlZugw folded before Flop (didn't bet)
Seat 7: K0b5wNInj6hUGRr6yzKFtw (button) collected ($0.60)
Seat 8: H5Se03ZqSX7tbULXur2MAg (small blind) folded before Flop
Seat 9: vSkQm2EelzwRGDDQQk0Fqw (big blind) folded before Flop




PokerStars Game #59941875778:  Hold'em No Limit ($0.10/$0.25) - 2009/07/01 1:48:57 ET
Table '3760QYRYyCWeXf0rLZ5S2g' 9-max Seat #1 is the button
Seat 1: CT7Xj/V/O5rBlhtt+RZeFQ ($27.55 in chips) 
Seat 2: zDrucyjVn5aeekNEc3cJrA ($27.20 in chips) 
Seat 4: ziFpkH3wCzqB/qXeq/Hy7g ($25 in chips) 
Seat 5: Bb42QRQMhg5/Y0vHP8/2Xw ($28.70 in chips) 
Seat 6: q+Qdg0Hoir+SyL7haBrUnw ($13.60 in chips) 
Seat 7: 6C2DoQ+GZHBOpb+qyrSnqA ($6.10 in chips) 
Seat 8: clJsV3v77RS07bDKY+705w ($5.25 in chips) 
Seat 9: BCwIzs00xY6DtWGghTGEwg ($15 in chips) 
zDrucyjVn5aeekNEc3cJrA: posts small blind $0.10
X78b5v/uhqeXXoAijbw/yg: is sitting out 
ziFpkH3wCzqB/qXeq/Hy7g: posts big blind $0.25
BCwIzs00xY6DtWGghTGEwg: posts big blind $0.25
*** HOLE CARDS ***
X78b5v/uhqeXXoAijbw/yg leaves the table
Bb42QRQMhg5/Y0vHP8/2Xw: calls $0.25
4qA/3Ajg3pP6fqW+IX9/fQ joins the table at seat #3 
q+Qdg0Hoir+SyL7haBrUnw: folds 
6C2DoQ+GZHBOpb+qyrSnqA: folds 
clJsV3v77RS07bDKY+705w: folds 
BCwIzs00xY6DtWGghTGEwg: checks 
CT7Xj/V/O5rBlhtt+RZeFQ: folds 
zDrucyjVn5aeekNEc3cJrA: calls $0.15
ziFpkH3wCzqB/qXeq/Hy7g: checks 
*** FLOP *** [9d Ad 7d]
zDrucyjVn5aeekNEc3cJrA: checks 
ziFpkH3wCzqB/qXeq/Hy7g: checks 
Bb42QRQMhg5/Y0vHP8/2Xw: bets $0.50
BCwIzs00xY6DtWGghTGEwg: folds 
zDrucyjVn5aeekNEc3cJrA: folds 
ziFpkH3wCzqB/qXeq/Hy7g: folds 
Uncalled bet ($0.50) returned to Bb42QRQMhg5/Y0vHP8/2Xw
Bb42QRQMhg5/Y0vHP8/2Xw collected $0.95 from pot
*** SUMMARY ***
Total pot $1 | Rake $0.05 
Board [9d Ad 7d]
Seat 1: CT7Xj/V/O5rBlhtt+RZeFQ (button) folded before Flop (didn't bet)
Seat 2: zDrucyjVn5aeekNEc3cJrA (small blind) folded on the Flop
Seat 4: ziFpkH3wCzqB/qXeq/Hy7g (big blind) folded on the Flop
Seat 5: Bb42QRQMhg5/Y0vHP8/2Xw collected ($0.95)
Seat 6: q+Qdg0Hoir+SyL7haBrUnw folded before Flop (didn't bet)
Seat 7: 6C2DoQ+GZHBOpb+qyrSnqA folded before Flop (didn't bet)
Seat 8: clJsV3v77RS07bDKY+705w folded before Flop (didn't bet)
Seat 9: BCwIzs00xY6DtWGghTGEwg folded on the Flop




PokerStars Game #59941876022:  Hold'em No Limit ($0.10/$0.25) - 2009/07/01 1:48:58 ET
Table '0XPo7K54oZIfG0xlNAcDRw' 9-max Seat #9 is the button
Seat 2: Prl9QvWQw/mISF4dSnnQUQ ($9.85 in chips) 
Seat 3: RHqgdFvufLCYe54+qd2gcA ($3.75 in chips) 
Seat 4: RubYqfvGrz2z+5ReNIj9QQ ($31.10 in chips) 
Seat 5: iOmwbUN7u4JFkV6VCA49aA ($16.25 in chips) 
Seat 6: M1nKET7WOTLbVPuAbJa3EA ($14.40 in chips) 
Seat 7: tYsOBqdU1+x+yFI7zHO7hQ ($28.45 in chips) 
Seat 8: v5jnQ1gfh9nLla3kMXG7Yg ($15.95 in chips) 
Seat 9: CmngQmkKTp8tkl6GMRTl6w ($13.25 in chips) 
4awUyiDYTgylQKXZ9faBVA will be allowed to play after the button
Prl9QvWQw/mISF4dSnnQUQ: posts small blind $0.10
RHqgdFvufLCYe54+qd2gcA: posts big blind $0.25
*** HOLE CARDS ***
RubYqfvGrz2z+5ReNIj9QQ: folds 
iOmwbUN7u4JFkV6VCA49aA: folds 
M1nKET7WOTLbVPuAbJa3EA: folds 
tYsOBqdU1+x+yFI7zHO7hQ: folds 
v5jnQ1gfh9nLla3kMXG7Yg: folds 
CmngQmkKTp8tkl6GMRTl6w: folds 
Prl9QvWQw/mISF4dSnnQUQ: calls $0.15
RHqgdFvufLCYe54+qd2gcA: checks 
*** FLOP *** [4s 5c 8s]
Prl9QvWQw/mISF4dSnnQUQ: checks 
RHqgdFvufLCYe54+qd2gcA: checks 
*** TURN *** [4s 5c 8s] [5h]
Prl9QvWQw/mISF4dSnnQUQ: bets $0.50
iOmwbUN7u4JFkV6VCA49aA said, "weak"
RHqgdFvufLCYe54+qd2gcA: folds 
Uncalled bet ($0.50) returned to Prl9QvWQw/mISF4dSnnQUQ
Prl9QvWQw/mISF4dSnnQUQ collected $0.50 from pot
*** SUMMARY ***
Total pot $0.50 | Rake $0 
Board [4s 5c 8s 5h]
Seat 2: Prl9QvWQw/mISF4dSnnQUQ (small blind) collected ($0.50)
Seat 3: RHqgdFvufLCYe54+qd2gcA (big blind) folded on the Turn
Seat 4: RubYqfvGrz2z+5ReNIj9QQ folded before Flop (didn't bet)
Seat 5: iOmwbUN7u4JFkV6VCA49aA folded before Flop (didn't bet)
Seat 6: M1nKET7WOTLbVPuAbJa3EA folded before Flop (didn't bet)
Seat 7: tYsOBqdU1+x+yFI7zHO7hQ folded before Flop (didn't bet)
Seat 8: v5jnQ1gfh9nLla3kMXG7Yg folded before Flop (didn't bet)
Seat 9: CmngQmkKTp8tkl6GMRTl6w (button) folded before Flop (didn't bet)




PokerStars Game #59941876090:  Hold'em No Limit ($0.10/$0.25) - 2009/07/01 1:48:58 ET
Table 'D1Yq70l0nNCyMV6DA42p+Q' 9-max Seat #3 is the button
Seat 2: zgi+EUykT/pZQpoUG6+oEg ($5 in chips) 
Seat 3: 9lvO/qyU+xrU95Teu1fv0g ($5.15 in chips) 
Seat 4: VWUWpMLMj/Q1jRVpF7Aohw ($9 in chips) 
Seat 5: gehe91e0IyVT0QU/XBkEyg ($25 in chips) 
Seat 6: wGigCmBR/9XWkPpvYos3aQ ($33.20 in chips) 
Seat 7: Lqytncc1Dsgt654eEBp/uw ($36.75 in chips) 
Seat 8: zDrucyjVn5aeekNEc3cJrA ($24 in chips) 
Seat 9: h5wEs8qXrBqfLa9GjaSBzg ($17.50 in chips) 
VWUWpMLMj/Q1jRVpF7Aohw: posts small blind $0.10
gehe91e0IyVT0QU/XBkEyg: posts big blind $0.25
*** HOLE CARDS ***
wGigCmBR/9XWkPpvYos3aQ: folds 
Lqytncc1Dsgt654eEBp/uw: raises $0.75 to $1
zDrucyjVn5aeekNEc3cJrA: folds 
h5wEs8qXrBqfLa9GjaSBzg: folds 
zgi+EUykT/pZQpoUG6+oEg: folds 
9lvO/qyU+xrU95Teu1fv0g: raises $2 to $3
VWUWpMLMj/Q1jRVpF7Aohw: folds 
gehe91e0IyVT0QU/XBkEyg: folds 
Lqytncc1Dsgt654eEBp/uw: folds 
Uncalled bet ($2) returned to 9lvO/qyU+xrU95Teu1fv0g
9lvO/qyU+xrU95Teu1fv0g collected $2.35 from pot
9lvO/qyU+xrU95Teu1fv0g: shows [Ad Ac] (a pair of Aces)
*** SUMMARY ***
Total pot $2.35 | Rake $0 
Seat 2: zgi+EUykT/pZQpoUG6+oEg folded before Flop (didn't bet)
Seat 3: 9lvO/qyU+xrU95Teu1fv0g (button) collected ($2.35)
Seat 4: VWUWpMLMj/Q1jRVpF7Aohw (small blind) folded before Flop
Seat 5: gehe91e0IyVT0QU/XBkEyg (big blind) folded before Flop
Seat 6: wGigCmBR/9XWkPpvYos3aQ folded before Flop (didn't bet)
Seat 7: Lqytncc1Dsgt654eEBp/uw folded before Flop
Seat 8: zDrucyjVn5aeekNEc3cJrA folded before Flop (didn't bet)
Seat 9: h5wEs8qXrBqfLa9GjaSBzg folded before Flop (didn't bet)




PokerStars Game #59941876424:  Hold'em No Limit ($0.10/$0.25) - 2009/07/01 1:48:58 ET
Table 'g+mPuNJBCHKE9ents7ZGtg' 6-max Seat #2 is the button
Seat 1: cezpHJ8FB07dj0xG+LhOvw ($58.15 in chips) 
Seat 2: fZQg9veL7Dd/Z04ZTjC+wQ ($64.60 in chips) 
Seat 4: yVrjRIW0SMxgpvqSIPSe/w ($14.70 in chips) 
Seat 5: D3ikCR8c/o9jB5irZ3uGlw ($12.25 in chips) 
Seat 6: Mn2V28t5aGq2d09z+/o6Fw ($24.85 in chips) 
8CPg15X6IHYR1pWm9ha1Sw will be allowed to play after the button
yVrjRIW0SMxgpvqSIPSe/w: posts small blind $0.10
D3ikCR8c/o9jB5irZ3uGlw: posts big blind $0.25
*** HOLE CARDS ***
Mn2V28t5aGq2d09z+/o6Fw: folds 
cezpHJ8FB07dj0xG+LhOvw: raises $0.50 to $0.75
fZQg9veL7Dd/Z04ZTjC+wQ: folds 
yVrjRIW0SMxgpvqSIPSe/w: folds 
D3ikCR8c/o9jB5irZ3uGlw: folds 
Uncalled bet ($0.50) returned to cezpHJ8FB07dj0xG+LhOvw
cezpHJ8FB07dj0xG+LhOvw collected $0.60 from pot
*** SUMMARY ***
Total pot $0.60 | Rake $0 
Seat 1: cezpHJ8FB07dj0xG+LhOvw collected ($0.60)
Seat 2: fZQg9veL7Dd/Z04ZTjC+wQ (button) folded before Flop (didn't bet)
Seat 4: yVrjRIW0SMxgpvqSIPSe/w (small blind) folded before Flop
Seat 5: D3ikCR8c/o9jB5irZ3uGlw (big blind) folded before Flop
Seat 6: Mn2V28t5aGq2d09z+/o6Fw folded before Flop (didn't bet)




PokerStars Game #59941876406:  Hold'em No Limit ($0.10/$0.25) - 2009/07/01 1:48:58 ET
Table 'nFlmVztKq1HJEWfxmdl15w' 9-max Seat #6 is the button
Seat 1: cZ99hugmLBj9KhTlc8nCSw ($26.75 in chips) 
Seat 2: Th3FldXKQW6hWVVPahaoOQ ($38.40 in chips) 
Seat 3: DdPXdieucQ+n99u1n3A+rQ ($5.70 in chips) 
Seat 4: +5dSUwD+/k2ktlnutSMivw ($11.25 in chips) 
Seat 5: Tx6zQdk5Ozt9ObEBlU7jeg ($33.85 in chips) 
Seat 6: 4awUyiDYTgylQKXZ9faBVA ($36.15 in chips) 
Seat 7: dfNim92Z6XK1/h5SFW5vDg ($35.05 in chips) 
Seat 8: +2kMBNpY4nF1qNCRd8SJLA ($33.65 in chips) 
Seat 9: DnDcAdn9P0zGovMERigpFA ($25 in chips) 
dfNim92Z6XK1/h5SFW5vDg: posts small blind $0.10
+2kMBNpY4nF1qNCRd8SJLA: posts big blind $0.25
*** HOLE CARDS ***
DnDcAdn9P0zGovMERigpFA: folds 
cZ99hugmLBj9KhTlc8nCSw: raises $0.50 to $0.75
Th3FldXKQW6hWVVPahaoOQ: folds 
DdPXdieucQ+n99u1n3A+rQ: folds 
+5dSUwD+/k2ktlnutSMivw: calls $0.75
Tx6zQdk5Ozt9ObEBlU7jeg: calls $0.75
4awUyiDYTgylQKXZ9faBVA: folds 
dfNim92Z6XK1/h5SFW5vDg: folds 
+2kMBNpY4nF1qNCRd8SJLA: folds 
*** FLOP *** [8c 9c 8s]
cZ99hugmLBj9KhTlc8nCSw: bets $1.75
+5dSUwD+/k2ktlnutSMivw: folds 
Tx6zQdk5Ozt9ObEBlU7jeg: calls $1.75
*** TURN *** [8c 9c 8s] [5s]
cZ99hugmLBj9KhTlc8nCSw: bets $4
Tx6zQdk5Ozt9ObEBlU7jeg: calls $4
*** RIVER *** [8c 9c 8s 5s] [3h]
cZ99hugmLBj9KhTlc8nCSw: bets $5
Tx6zQdk5Ozt9ObEBlU7jeg: raises $5 to $10
cZ99hugmLBj9KhTlc8nCSw: folds 
Uncalled bet ($5) returned to Tx6zQdk5Ozt9ObEBlU7jeg
Tx6zQdk5Ozt9ObEBlU7jeg collected $22.95 from pot
Tx6zQdk5Ozt9ObEBlU7jeg: doesn't show hand 
*** SUMMARY ***
Total pot $24.10 | Rake $1.15 
Board [8c 9c 8s 5s 3h]
Seat 1: cZ99hugmLBj9KhTlc8nCSw folded on the River
Seat 2: Th3FldXKQW6hWVVPahaoOQ folded before Flop (didn't bet)
Seat 3: DdPXdieucQ+n99u1n3A+rQ folded before Flop (didn't bet)
Seat 4: +5dSUwD+/k2ktlnutSMivw folded on the Flop
Seat 5: Tx6zQdk5Ozt9ObEBlU7jeg collected ($22.95)
Seat 6: 4awUyiDYTgylQKXZ9faBVA (button) folded before Flop (didn't bet)
Seat 7: dfNim92Z6XK1/h5SFW5vDg (small blind) folded before Flop
Seat 8: +2kMBNpY4nF1qNCRd8SJLA (big blind) folded before Flop
Seat 9: DnDcAdn9P0zGovMERigpFA folded before Flop (didn't bet)




PokerStars Game #59941876328:  Hold'em No Limit ($0.10/$0.25) - 2009/07/01 1:48:58 ET
Table 'vud0GB/ZlDCvUFhBFIaTlg' 9-max Seat #3 is the button
Seat 1: DiSvPC2iudwL5j9u6Huyww ($29.50 in chips) 
Seat 2: tLcDklc2rBORNfixyRfVfw ($25 in chips) 
Seat 3: W2YYHvqjaEpRrO7stZkClQ ($5.05 in chips) 
Seat 4: dWgEDExmVO0d+rRmUYCU5w ($15.55 in chips) 
Seat 5: eK8qa6EPcH2zhtbmWSvc9g ($25 in chips) 
Seat 6: gehe91e0IyVT0QU/XBkEyg ($25 in chips) 
Seat 7: iG7VeTyBWf6wYNvZpbTcbw ($21.55 in chips) 
Seat 8: E0iYnEVO2ho7dH3QcCjw7g ($19.75 in chips) 
Seat 9: PdIasPkzm2sqZnN41ZRXOg ($5.20 in chips) 
dWgEDExmVO0d+rRmUYCU5w: posts small blind $0.10
eK8qa6EPcH2zhtbmWSvc9g: posts big blind $0.25
*** HOLE CARDS ***
gehe91e0IyVT0QU/XBkEyg: folds 
iG7VeTyBWf6wYNvZpbTcbw: calls $0.25
E0iYnEVO2ho7dH3QcCjw7g: folds 
PdIasPkzm2sqZnN41ZRXOg: folds 
DiSvPC2iudwL5j9u6Huyww: folds 
tLcDklc2rBORNfixyRfVfw: folds 
W2YYHvqjaEpRrO7stZkClQ: folds 
dWgEDExmVO0d+rRmUYCU5w: calls $0.15
eK8qa6EPcH2zhtbmWSvc9g: checks 
*** FLOP *** [Qh 9d Kd]
dWgEDExmVO0d+rRmUYCU5w: checks 
eK8qa6EPcH2zhtbmWSvc9g: bets $0.45
iG7VeTyBWf6wYNvZpbTcbw: folds 
dWgEDExmVO0d+rRmUYCU5w: folds 
Uncalled bet ($0.45) returned to eK8qa6EPcH2zhtbmWSvc9g
dWgEDExmVO0d+rRmUYCU5w leaves the table
eK8qa6EPcH2zhtbmWSvc9g collected $0.75 from pot
eK8qa6EPcH2zhtbmWSvc9g: doesn't show hand 
*** SUMMARY ***
Total pot $0.75 | Rake $0 
Board [Qh 9d Kd]
Seat 1: DiSvPC2iudwL5j9u6Huyww folded before Flop (didn't bet)
Seat 2: tLcDklc2rBORNfixyRfVfw folded before Flop (didn't bet)
Seat 3: W2YYHvqjaEpRrO7stZkClQ (button) folded before Flop (didn't bet)
Seat 4: dWgEDExmVO0d+rRmUYCU5w (small blind) folded on the Flop
Seat 5: eK8qa6EPcH2zhtbmWSvc9g (big blind) collected ($0.75)
Seat 6: gehe91e0IyVT0QU/XBkEyg folded before Flop (didn't bet)
Seat 7: iG7VeTyBWf6wYNvZpbTcbw folded on the Flop
Seat 8: E0iYnEVO2ho7dH3QcCjw7g folded before Flop (didn't bet)
Seat 9: PdIasPkzm2sqZnN41ZRXOg folded before Flop (didn't bet)




PokerStars Game #59941876208:  Hold'em No Limit ($0.10/$0.25) - 2009/07/01 1:48:58 ET
Table '4XGDnEByOol5up4aB2KbJw' 6-max Seat #2 is the button
Seat 1: kyRaCIljYA6l33lSKQfNsg ($26.75 in chips) 
Seat 2: SFmT9ZsVopnukjvAzrxTRg ($46.10 in chips) 
Seat 3: LtASJ9OlkqGrrUKGQlpGAw ($20.65 in chips) 
Seat 4: BV+K0Phf5VBHr7aZPKqbUQ ($25 in chips) 
Seat 5: Dh01+rohD2p9pXLYeBlC5Q ($17.25 in chips) 
Seat 6: a7Ux7aERFGCbT/L3ojVfAg ($10.40 in chips) 
LtASJ9OlkqGrrUKGQlpGAw: posts small blind $0.10
BV+K0Phf5VBHr7aZPKqbUQ: posts big blind $0.25
*** HOLE CARDS ***
Dh01+rohD2p9pXLYeBlC5Q: folds 
a7Ux7aERFGCbT/L3ojVfAg: folds 
kyRaCIljYA6l33lSKQfNsg: raises $0.50 to $0.75
SFmT9ZsVopnukjvAzrxTRg: folds 
LtASJ9OlkqGrrUKGQlpGAw: folds 
BV+K0Phf5VBHr7aZPKqbUQ: folds 
Uncalled bet ($0.50) returned to kyRaCIljYA6l33lSKQfNsg
kyRaCIljYA6l33lSKQfNsg collected $0.60 from pot
*** SUMMARY ***
Total pot $0.60 | Rake $0 
Seat 1: kyRaCIljYA6l33lSKQfNsg collected ($0.60)
Seat 2: SFmT9ZsVopnukjvAzrxTRg (button) folded before Flop (didn't bet)
Seat 3: LtASJ9OlkqGrrUKGQlpGAw (small blind) folded before Flop
Seat 4: BV+K0Phf5VBHr7aZPKqbUQ (big blind) folded before Flop
Seat 5: Dh01+rohD2p9pXLYeBlC5Q folded before Flop (didn't bet)
Seat 6: a7Ux7aERFGCbT/L3ojVfAg folded before Flop (didn't bet)




PokerStars Game #59941876020:  Hold'em No Limit ($0.10/$0.25) - 2009/07/01 1:48:58 ET
Table '8PD/MTROSMd6Y8mZeykbpg' 6-max Seat #6 is the button
Seat 1: fxNpaToxECtD2Goelmg9vA ($28.60 in chips) 
Seat 2: 4TM16KVgEiQpLi4bVVWbVQ ($25.15 in chips) 
Seat 3: vqWjZmdQu/Hxw96/IJTWdQ ($25 in chips) 
Seat 4: DFi/Lzkjsfv8QswS80JX9Q ($54.45 in chips) 
Seat 5: z3tQwy28dp5FykDJC/wzQw ($26.20 in chips) 
Seat 6: trN/oHqTTbPw5MNuKrOpLw ($25.25 in chips) 
fxNpaToxECtD2Goelmg9vA: posts small blind $0.10
4TM16KVgEiQpLi4bVVWbVQ: posts big blind $0.25
*** HOLE CARDS ***
vqWjZmdQu/Hxw96/IJTWdQ: folds 
DFi/Lzkjsfv8QswS80JX9Q: raises $0.75 to $1
z3tQwy28dp5FykDJC/wzQw: folds 
trN/oHqTTbPw5MNuKrOpLw: folds 
fxNpaToxECtD2Goelmg9vA: folds 
4TM16KVgEiQpLi4bVVWbVQ: folds 
Uncalled bet ($0.75) returned to DFi/Lzkjsfv8QswS80JX9Q
DFi/Lzkjsfv8QswS80JX9Q collected $0.60 from pot
DFi/Lzkjsfv8QswS80JX9Q: doesn't show hand 
*** SUMMARY ***
Total pot $0.60 | Rake $0 
Seat 1: fxNpaToxECtD2Goelmg9vA (small blind) folded before Flop
Seat 2: 4TM16KVgEiQpLi4bVVWbVQ (big blind) folded before Flop
Seat 3: vqWjZmdQu/Hxw96/IJTWdQ folded before Flop (didn't bet)
Seat 4: DFi/Lzkjsfv8QswS80JX9Q collected ($0.60)
Seat 5: z3tQwy28dp5FykDJC/wzQw folded before Flop (didn't bet)
Seat 6: trN/oHqTTbPw5MNuKrOpLw (button) folded before Flop (didn't bet)




PokerStars Game #59941876364:  Hold'em No Limit ($0.10/$0.25) - 2009/07/01 1:48:58 ET
Table 'MJ1SB76A4qJrlEa+C5e/8w' 6-max Seat #6 is the button
Seat 1: 0KDZiuXQg6UI9cqBR/AUnQ ($20.90 in chips) 
Seat 2: UA5OsKS3VPaxa7uC8La/kA ($37.40 in chips) 
Seat 3: DihMHaz4WNETH1bPDe13kA ($32.55 in chips) 
Seat 4: SFmT9ZsVopnukjvAzrxTRg ($27.80 in chips) 
Seat 5: Hsvkc0/G2VV78oVmWYXecw ($5.25 in chips) 
Seat 6: JFIAqU8lCZ0vWwEl4bdGsg ($34.65 in chips) 
0KDZiuXQg6UI9cqBR/AUnQ: posts small blind $0.10
UA5OsKS3VPaxa7uC8La/kA: posts big blind $0.25
*** HOLE CARDS ***
DihMHaz4WNETH1bPDe13kA: folds 
SFmT9ZsVopnukjvAzrxTRg: folds 
Hsvkc0/G2VV78oVmWYXecw: folds 
JFIAqU8lCZ0vWwEl4bdGsg: folds 
0KDZiuXQg6UI9cqBR/AUnQ is disconnected 
0KDZiuXQg6UI9cqBR/AUnQ is connected 
0KDZiuXQg6UI9cqBR/AUnQ: folds 
Uncalled bet ($0.15) returned to UA5OsKS3VPaxa7uC8La/kA
UA5OsKS3VPaxa7uC8La/kA collected $0.20 from pot
*** SUMMARY ***
Total pot $0.20 | Rake $0 
Seat 1: 0KDZiuXQg6UI9cqBR/AUnQ (small blind) folded before Flop
Seat 2: UA5OsKS3VPaxa7uC8La/kA (big blind) collected ($0.20)
Seat 3: DihMHaz4WNETH1bPDe13kA folded before Flop (didn't bet)
Seat 4: SFmT9ZsVopnukjvAzrxTRg folded before Flop (didn't bet)
Seat 5: Hsvkc0/G2VV78oVmWYXecw folded before Flop (didn't bet)
Seat 6: JFIAqU8lCZ0vWwEl4bdGsg (button) folded before Flop (didn't bet)




PokerStars Game #59941875938:  Hold'em No Limit ($0.10/$0.25) - 2009/07/01 1:48:58 ET
Table 'FBhJjLqab11/gKu8nyB/tw' 9-max Seat #1 is the button
Seat 1: +sbyWwIcFp9kP0bDtMegfQ ($18.30 in chips) 
Seat 3: V6p0jQ/RhUsqpHLmXvEX4Q ($9.35 in chips) 
Seat 4: CvL9Ch1HYCVbTsfpNucitg ($5.50 in chips) 
Seat 5: Mh2r9hTeTEDnh19sRZtW3g ($4.65 in chips) 
Seat 6: cZ99hugmLBj9KhTlc8nCSw ($31.35 in chips) 
Seat 7: CT7Xj/V/O5rBlhtt+RZeFQ ($25 in chips) 
Seat 8: Th3FldXKQW6hWVVPahaoOQ ($27.25 in chips) 
V6p0jQ/RhUsqpHLmXvEX4Q: posts small blind $0.10
CvL9Ch1HYCVbTsfpNucitg: posts big blind $0.25
18G4P1XstjNvItdGUITxgw joins the table at seat #2 
H5Se03ZqSX7tbULXur2MAg: sits out 
*** HOLE CARDS ***
Mh2r9hTeTEDnh19sRZtW3g: folds 
cZ99hugmLBj9KhTlc8nCSw: raises $0.50 to $0.75
CT7Xj/V/O5rBlhtt+RZeFQ: folds 
Th3FldXKQW6hWVVPahaoOQ: folds 
+sbyWwIcFp9kP0bDtMegfQ: folds 
V6p0jQ/RhUsqpHLmXvEX4Q: folds 
CvL9Ch1HYCVbTsfpNucitg: folds 
Uncalled bet ($0.50) returned to cZ99hugmLBj9KhTlc8nCSw
cZ99hugmLBj9KhTlc8nCSw collected $0.60 from pot
*** SUMMARY ***
Total pot $0.60 | Rake $0 
Seat 1: +sbyWwIcFp9kP0bDtMegfQ (button) folded before Flop (didn't bet)
Seat 3: V6p0jQ/RhUsqpHLmXvEX4Q (small blind) folded before Flop
Seat 4: CvL9Ch1HYCVbTsfpNucitg (big blind) folded before Flop
Seat 5: Mh2r9hTeTEDnh19sRZtW3g folded before Flop (didn't bet)
Seat 6: cZ99hugmLBj9KhTlc8nCSw collected ($0.60)
Seat 7: CT7Xj/V/O5rBlhtt+RZeFQ folded before Flop (didn't bet)
Seat 8: Th3FldXKQW6hWVVPahaoOQ folded before Flop (didn't bet)




PokerStars Game #59941876892:  Hold'em No Limit ($0.10/$0.25) - 2009/07/01 1:48:59 ET
Table 'jxoHy9yJy0bbH/Qx73FoPA' 9-max Seat #3 is the button
Seat 1: j4q3p0lesp63b1gZDwLBZw ($6.60 in chips) 
Seat 2: F7pnn6czNpHvRM55XcA2EA ($45.50 in chips) 
Seat 3: CVqCt93Mk0MhKMaZ4LZDSQ ($8.95 in chips) 
Seat 4: bXpVeaSTPBFSPJmeXxO7nw ($4.75 in chips) 
Seat 7: wGigCmBR/9XWkPpvYos3aQ ($26.40 in chips) 
Seat 8: Z9W7+g1WMhhZDi7DwGbCFA ($5 in chips) 
Seat 9: CvL9Ch1HYCVbTsfpNucitg ($4.90 in chips) 
bXpVeaSTPBFSPJmeXxO7nw: posts small blind $0.10
tYsOBqdU1+x+yFI7zHO7hQ: is sitting out 
wGigCmBR/9XWkPpvYos3aQ: posts big blind $0.25
*** HOLE CARDS ***
Z9W7+g1WMhhZDi7DwGbCFA: folds 
tYsOBqdU1+x+yFI7zHO7hQ leaves the table
CvL9Ch1HYCVbTsfpNucitg: folds 
j4q3p0lesp63b1gZDwLBZw: folds 
F7pnn6czNpHvRM55XcA2EA: folds 
CVqCt93Mk0MhKMaZ4LZDSQ: raises $0.75 to $1
bXpVeaSTPBFSPJmeXxO7nw: folds 
wGigCmBR/9XWkPpvYos3aQ: folds 
Uncalled bet ($0.75) returned to CVqCt93Mk0MhKMaZ4LZDSQ
CVqCt93Mk0MhKMaZ4LZDSQ collected $0.60 from pot
*** SUMMARY ***
Total pot $0.60 | Rake $0 
Seat 1: j4q3p0lesp63b1gZDwLBZw folded before Flop (didn't bet)
Seat 2: F7pnn6czNpHvRM55XcA2EA folded before Flop (didn't bet)
Seat 3: CVqCt93Mk0MhKMaZ4LZDSQ (button) collected ($0.60)
Seat 4: bXpVeaSTPBFSPJmeXxO7nw (small blind) folded before Flop
Seat 7: wGigCmBR/9XWkPpvYos3aQ (big blind) folded before Flop
Seat 8: Z9W7+g1WMhhZDi7DwGbCFA folded before Flop (didn't bet)
Seat 9: CvL9Ch1HYCVbTsfpNucitg folded before Flop (didn't bet)




PokerStars Game #59941876824:  Hold'em No Limit ($0.10/$0.25) - 2009/07/01 1:48:59 ET
Table 'tErGGDyESv/0llKumVeZuQ' 9-max Seat #8 is the button
Seat 1: 3PmVnC/15cl4oyI1TKIt4g ($5 in chips) 
Seat 2: pN3IHvAKm2fz+sTRARTcrg ($28.85 in chips) 
Seat 4: yqkowiRWZ6NvRN9UUkYIlA ($5 in chips) 
Seat 5: 6RQUxA3jk+ePxB/+Hc0IKw ($16.05 in chips) 
Seat 7: uhrboV251dcgYniYTdFIcA ($27.55 in chips) 
Seat 8: clJsV3v77RS07bDKY+705w ($5 in chips) 
Seat 9: d6n762oPkegG086ZJyV5MA ($23.45 in chips) 
d6n762oPkegG086ZJyV5MA: posts small blind $0.10
3PmVnC/15cl4oyI1TKIt4g: posts big blind $0.25
qwr38jl5txoR36M7G5qi4A: sits out 
*** HOLE CARDS ***
pN3IHvAKm2fz+sTRARTcrg: folds 
yqkowiRWZ6NvRN9UUkYIlA: folds 
6RQUxA3jk+ePxB/+Hc0IKw: folds 
uhrboV251dcgYniYTdFIcA: folds 
clJsV3v77RS07bDKY+705w: folds 
d6n762oPkegG086ZJyV5MA: folds 
Uncalled bet ($0.15) returned to 3PmVnC/15cl4oyI1TKIt4g
3PmVnC/15cl4oyI1TKIt4g collected $0.20 from pot
3PmVnC/15cl4oyI1TKIt4g: doesn't show hand 
*** SUMMARY ***
Total pot $0.20 | Rake $0 
Seat 1: 3PmVnC/15cl4oyI1TKIt4g (big blind) collected ($0.20)
Seat 2: pN3IHvAKm2fz+sTRARTcrg folded before Flop (didn't bet)
Seat 4: yqkowiRWZ6NvRN9UUkYIlA folded before Flop (didn't bet)
Seat 5: 6RQUxA3jk+ePxB/+Hc0IKw folded before Flop (didn't bet)
Seat 7: uhrboV251dcgYniYTdFIcA folded before Flop (didn't bet)
Seat 8: clJsV3v77RS07bDKY+705w (button) folded before Flop (didn't bet)
Seat 9: d6n762oPkegG086ZJyV5MA (small blind) folded before Flop




PokerStars Game #59941876882:  Hold'em No Limit ($0.10/$0.25) - 2009/07/01 1:48:59 ET
Table 'NtCSSONEf1zaJo3042tQug' 6-max Seat #5 is the button
Seat 1: KXtdqb+rIMkjc0RvHDksGQ ($34.90 in chips) 
Seat 2: vqWjZmdQu/Hxw96/IJTWdQ ($25 in chips) 
Seat 3: 9kUKGKkblnIx3m8rlVol6Q ($15.65 in chips) 
Seat 4: HxD1kB8zCmalQSdWAkKmlg ($27.50 in chips) 
Seat 5: tOAk1Og4mVObMBOfvdDYOw ($30.65 in chips) 
Seat 6: LxehwDpTQ19ph4Qmc78+Pw ($33.25 in chips) 
LxehwDpTQ19ph4Qmc78+Pw: posts small blind $0.10
KXtdqb+rIMkjc0RvHDksGQ: posts big blind $0.25
*** HOLE CARDS ***
vqWjZmdQu/Hxw96/IJTWdQ: raises $0.75 to $1
9kUKGKkblnIx3m8rlVol6Q: calls $1
HxD1kB8zCmalQSdWAkKmlg: folds 
tOAk1Og4mVObMBOfvdDYOw: folds 
LxehwDpTQ19ph4Qmc78+Pw: calls $0.90
KXtdqb+rIMkjc0RvHDksGQ: folds 
*** FLOP *** [Th 7s Jc]
LxehwDpTQ19ph4Qmc78+Pw: checks 
vqWjZmdQu/Hxw96/IJTWdQ: checks 
9kUKGKkblnIx3m8rlVol6Q: checks 
*** TURN *** [Th 7s Jc] [4d]
LxehwDpTQ19ph4Qmc78+Pw: bets $1.75
vqWjZmdQu/Hxw96/IJTWdQ: folds 
9kUKGKkblnIx3m8rlVol6Q: folds 
Uncalled bet ($1.75) returned to LxehwDpTQ19ph4Qmc78+Pw
LxehwDpTQ19ph4Qmc78+Pw collected $3.10 from pot
LxehwDpTQ19ph4Qmc78+Pw: doesn't show hand 
*** SUMMARY ***
Total pot $3.25 | Rake $0.15 
Board [Th 7s Jc 4d]
Seat 1: KXtdqb+rIMkjc0RvHDksGQ (big blind) folded before Flop
Seat 2: vqWjZmdQu/Hxw96/IJTWdQ folded on the Turn
Seat 3: 9kUKGKkblnIx3m8rlVol6Q folded on the Turn
Seat 4: HxD1kB8zCmalQSdWAkKmlg folded before Flop (didn't bet)
Seat 5: tOAk1Og4mVObMBOfvdDYOw (button) folded before Flop (didn't bet)
Seat 6: LxehwDpTQ19ph4Qmc78+Pw (small blind) collected ($3.10)




PokerStars Game #59941876674:  Hold'em No Limit ($0.10/$0.25) - 2009/07/01 1:48:59 ET
Table 'aaXqTKUnxrX9DYXtxhWXxA' 6-max Seat #1 is the button
Seat 1: aSrj4lVmn2owyQ1RbbOqxQ ($26.40 in chips) 
Seat 2: DE9hRlt14g+JdsRQ4wT7hg ($32.85 in chips) 
Seat 3: uUXdcVMNa05rfbntdvplfw ($8.85 in chips) 
Seat 4: 48oT5xFI+5CHUJlfoGrE4w ($8.80 in chips) 
Seat 5: kyRaCIljYA6l33lSKQfNsg ($23.85 in chips) 
Seat 6: buyjetgNT1McXtdaP4zynA ($51.50 in chips) 
DE9hRlt14g+JdsRQ4wT7hg: posts small blind $0.10
uUXdcVMNa05rfbntdvplfw: posts big blind $0.25
*** HOLE CARDS ***
48oT5xFI+5CHUJlfoGrE4w: folds 
kyRaCIljYA6l33lSKQfNsg: folds 
buyjetgNT1McXtdaP4zynA has timed out
buyjetgNT1McXtdaP4zynA: folds 
buyjetgNT1McXtdaP4zynA is sitting out
aSrj4lVmn2owyQ1RbbOqxQ: raises $0.50 to $0.75
DE9hRlt14g+JdsRQ4wT7hg: folds 
uUXdcVMNa05rfbntdvplfw: calls $0.50
*** FLOP *** [Kd 3h 9c]
uUXdcVMNa05rfbntdvplfw: bets $0.25
buyjetgNT1McXtdaP4zynA has returned
aSrj4lVmn2owyQ1RbbOqxQ: raises $0.75 to $1
uUXdcVMNa05rfbntdvplfw: folds 
Uncalled bet ($0.75) returned to aSrj4lVmn2owyQ1RbbOqxQ
aSrj4lVmn2owyQ1RbbOqxQ collected $2 from pot
aSrj4lVmn2owyQ1RbbOqxQ: doesn't show hand 
*** SUMMARY ***
Total pot $2.10 | Rake $0.10 
Board [Kd 3h 9c]
Seat 1: aSrj4lVmn2owyQ1RbbOqxQ (button) collected ($2)
Seat 2: DE9hRlt14g+JdsRQ4wT7hg (small blind) folded before Flop
Seat 3: uUXdcVMNa05rfbntdvplfw (big blind) folded on the Flop
Seat 4: 48oT5xFI+5CHUJlfoGrE4w folded before Flop (didn't bet)
Seat 5: kyRaCIljYA6l33lSKQfNsg folded before Flop (didn't bet)
Seat 6: buyjetgNT1McXtdaP4zynA folded before Flop (didn't bet)




PokerStars Game #59941876704:  Hold'em No Limit ($0.10/$0.25) - 2009/07/01 1:48:59 ET
Table '5NipxzzFB2DffzDpddyQoQ' 6-max Seat #4 is the button
Seat 1: W87HPwOk1KtWaYyshBe1gA ($20.65 in chips) 
Seat 2: iauW7L/+7qzAuHow7CD75Q ($4.70 in chips) 
Seat 3: QvTX2yGq3uKJiKPmns4TKQ ($14.20 in chips) 
Seat 4: NTamLAiMZ86c5yM04t96LA ($34 in chips) 
Seat 5: faP2NVl/cFTZ1nE4pXzg8Q ($23.20 in chips) 
Seat 6: 7JqTFMyeNSVWsmp/yW35Tw ($27.30 in chips) 
faP2NVl/cFTZ1nE4pXzg8Q: posts small blind $0.10
7JqTFMyeNSVWsmp/yW35Tw: posts big blind $0.25
*** HOLE CARDS ***
W87HPwOk1KtWaYyshBe1gA: folds 
iauW7L/+7qzAuHow7CD75Q: folds 
QvTX2yGq3uKJiKPmns4TKQ: folds 
NTamLAiMZ86c5yM04t96LA: folds 
7JqTFMyeNSVWsmp/yW35Tw said, "rotflmao"
faP2NVl/cFTZ1nE4pXzg8Q: raises $1 to $1.25
iauW7L/+7qzAuHow7CD75Q said, "damn"
7JqTFMyeNSVWsmp/yW35Tw: folds 
Uncalled bet ($1) returned to faP2NVl/cFTZ1nE4pXzg8Q
iauW7L/+7qzAuHow7CD75Q said, "had A8"
faP2NVl/cFTZ1nE4pXzg8Q collected $0.50 from pot
faP2NVl/cFTZ1nE4pXzg8Q: shows [9d 9h] (a pair of Nines)
NTamLAiMZ86c5yM04t96LA said, "dum"
*** SUMMARY ***
Total pot $0.50 | Rake $0 
Seat 1: W87HPwOk1KtWaYyshBe1gA folded before Flop (didn't bet)
Seat 2: iauW7L/+7qzAuHow7CD75Q folded before Flop (didn't bet)
Seat 3: QvTX2yGq3uKJiKPmns4TKQ folded before Flop (didn't bet)
Seat 4: NTamLAiMZ86c5yM04t96LA (button) folded before Flop (didn't bet)
Seat 5: faP2NVl/cFTZ1nE4pXzg8Q (small blind) collected ($0.50)
Seat 6: 7JqTFMyeNSVWsmp/yW35Tw (big blind) folded before Flop




PokerStars Game #59941876752:  Hold'em No Limit ($0.10/$0.25) - 2009/07/01 1:48:59 ET
Table 'wRXcD9iXgBbdvKhWmfnBnw' 6-max Seat #1 is the button
Seat 1: Mhj3q7cxev+XjXZxEE6/Cw ($25 in chips) 
Seat 2: vUr8qM1UsCElsCI9B/McdQ ($21.85 in chips) 
Seat 3: SxIIgwXYLkwd6m3wLyPTCw ($25 in chips) 
Seat 4: mnuJq+Q1IXKm/pCy+OzxmQ ($19.25 in chips) 
Seat 5: EE16Ua5b1HSsYej5zeXOlA ($48.95 in chips) 
Seat 6: JFIAqU8lCZ0vWwEl4bdGsg ($34 in chips) 
vUr8qM1UsCElsCI9B/McdQ: posts small blind $0.10
SxIIgwXYLkwd6m3wLyPTCw: posts big blind $0.25
*** HOLE CARDS ***
mnuJq+Q1IXKm/pCy+OzxmQ: raises $0.50 to $0.75
EE16Ua5b1HSsYej5zeXOlA: folds 
JFIAqU8lCZ0vWwEl4bdGsg: folds 
Mhj3q7cxev+XjXZxEE6/Cw: folds 
vUr8qM1UsCElsCI9B/McdQ: folds 
SxIIgwXYLkwd6m3wLyPTCw: folds 
Uncalled bet ($0.50) returned to mnuJq+Q1IXKm/pCy+OzxmQ
mnuJq+Q1IXKm/pCy+OzxmQ collected $0.60 from pot
mnuJq+Q1IXKm/pCy+OzxmQ: doesn't show hand 
*** SUMMARY ***
Total pot $0.60 | Rake $0 
Seat 1: Mhj3q7cxev+XjXZxEE6/Cw (button) folded before Flop (didn't bet)
Seat 2: vUr8qM1UsCElsCI9B/McdQ (small blind) folded before Flop
Seat 3: SxIIgwXYLkwd6m3wLyPTCw (big blind) folded before Flop
Seat 4: mnuJq+Q1IXKm/pCy+OzxmQ collected ($0.60)
Seat 5: EE16Ua5b1HSsYej5zeXOlA folded before Flop (didn't bet)
Seat 6: JFIAqU8lCZ0vWwEl4bdGsg folded before Flop (didn't bet)




PokerStars Game #59941876478:  Hold'em No Limit ($0.10/$0.25) - 2009/07/01 1:48:59 ET
Table 'NfXsh0UQA+o/kO9acV3WxA' 9-max Seat #9 is the button
Seat 1: pN3IHvAKm2fz+sTRARTcrg ($24.40 in chips) 
Seat 2: mhpFs2SZupy4zLRb62FLFA ($25 in chips) 
Seat 3: wCUaomJ6Nq5zomVGdUHP+w ($18.40 in chips) 
Seat 4: r6hsffOo1iKmaPYKwAZmFw ($30.05 in chips) 
Seat 5: zgi+EUykT/pZQpoUG6+oEg ($4.65 in chips) 
Seat 7: yqkowiRWZ6NvRN9UUkYIlA ($5 in chips) 
Seat 8: +sbyWwIcFp9kP0bDtMegfQ ($39.50 in chips) 
Seat 9: uhrboV251dcgYniYTdFIcA ($28.85 in chips) 
pN3IHvAKm2fz+sTRARTcrg: posts small blind $0.10
mhpFs2SZupy4zLRb62FLFA: posts big blind $0.25
qwr38jl5txoR36M7G5qi4A: sits out 
*** HOLE CARDS ***
wCUaomJ6Nq5zomVGdUHP+w: raises $0.50 to $0.75
r6hsffOo1iKmaPYKwAZmFw: folds 
zgi+EUykT/pZQpoUG6+oEg: folds 
yqkowiRWZ6NvRN9UUkYIlA: folds 
+sbyWwIcFp9kP0bDtMegfQ: raises $2.25 to $3
uhrboV251dcgYniYTdFIcA: folds 
pN3IHvAKm2fz+sTRARTcrg: folds 
mhpFs2SZupy4zLRb62FLFA: folds 
wCUaomJ6Nq5zomVGdUHP+w: folds 
Uncalled bet ($2.25) returned to +sbyWwIcFp9kP0bDtMegfQ
+sbyWwIcFp9kP0bDtMegfQ collected $1.85 from pot
+sbyWwIcFp9kP0bDtMegfQ: doesn't show hand 
*** SUMMARY ***
Total pot $1.85 | Rake $0 
Seat 1: pN3IHvAKm2fz+sTRARTcrg (small blind) folded before Flop
Seat 2: mhpFs2SZupy4zLRb62FLFA (big blind) folded before Flop
Seat 3: wCUaomJ6Nq5zomVGdUHP+w folded before Flop
Seat 4: r6hsffOo1iKmaPYKwAZmFw folded before Flop (didn't bet)
Seat 5: zgi+EUykT/pZQpoUG6+oEg folded before Flop (didn't bet)
Seat 7: yqkowiRWZ6NvRN9UUkYIlA folded before Flop (didn't bet)
Seat 8: +sbyWwIcFp9kP0bDtMegfQ collected ($1.85)
Seat 9: uhrboV251dcgYniYTdFIcA (button) folded before Flop (didn't bet)




PokerStars Game #59941876622:  Hold'em No Limit ($0.10/$0.25) - 2009/07/01 1:48:59 ET
Table '+VTTYgQLH1awDHk+IAxqGg' 9-max Seat #7 is the button
Seat 1: arxNSjreDRGFg13EAM2F1w ($26.90 in chips) 
Seat 2: 2wcFsZsqEP5w1StUTVzJCg ($6.90 in chips) 
Seat 3: AiXn/9o1EwOPZUHujnh/bA ($11.65 in chips) 
Seat 4: gE5rN2TDY1aXcZn/TOPeZw ($8.90 in chips) 
Seat 5: sD+TKtt36XiiN6jqHiLwDA ($24.80 in chips) 
Seat 7: ljemhp25Zg+nlA9DLCIiUw ($23.90 in chips) 
Seat 8: 10vzP4r6ldwGLbYHKd9www ($19.15 in chips) 
Seat 9: S7Ki0P+0AIGPuIfGJjW0gg ($61 in chips) 
10vzP4r6ldwGLbYHKd9www: posts small blind $0.10
S7Ki0P+0AIGPuIfGJjW0gg: posts big blind $0.25
*** HOLE CARDS ***
arxNSjreDRGFg13EAM2F1w: folds 
2wcFsZsqEP5w1StUTVzJCg: folds 
AiXn/9o1EwOPZUHujnh/bA: folds 
gE5rN2TDY1aXcZn/TOPeZw: folds 
sD+TKtt36XiiN6jqHiLwDA: folds 
ljemhp25Zg+nlA9DLCIiUw: folds 
10vzP4r6ldwGLbYHKd9www: calls $0.15
S7Ki0P+0AIGPuIfGJjW0gg: checks 
*** FLOP *** [7s Qd 4c]
10vzP4r6ldwGLbYHKd9www: checks 
S7Ki0P+0AIGPuIfGJjW0gg: bets $0.50
10vzP4r6ldwGLbYHKd9www: folds 
Uncalled bet ($0.50) returned to S7Ki0P+0AIGPuIfGJjW0gg
clJsV3v77RS07bDKY+705w joins the table at seat #6 
S7Ki0P+0AIGPuIfGJjW0gg collected $0.50 from pot
S7Ki0P+0AIGPuIfGJjW0gg: doesn't show hand 
*** SUMMARY ***
Total pot $0.50 | Rake $0 
Board [7s Qd 4c]
Seat 1: arxNSjreDRGFg13EAM2F1w folded before Flop (didn't bet)
Seat 2: 2wcFsZsqEP5w1StUTVzJCg folded before Flop (didn't bet)
Seat 3: AiXn/9o1EwOPZUHujnh/bA folded before Flop (didn't bet)
Seat 4: gE5rN2TDY1aXcZn/TOPeZw folded before Flop (didn't bet)
Seat 5: sD+TKtt36XiiN6jqHiLwDA folded before Flop (didn't bet)
Seat 7: ljemhp25Zg+nlA9DLCIiUw (button) folded before Flop (didn't bet)
Seat 8: 10vzP4r6ldwGLbYHKd9www (small blind) folded on the Flop
Seat 9: S7Ki0P+0AIGPuIfGJjW0gg (big blind) collected ($0.50)




PokerStars Game #59941876796:  Hold'em No Limit ($0.10/$0.25) - 2009/07/01 1:48:59 ET
Table 'rhQuIjJo0UQ7RRUlF9umHg' 6-max Seat #3 is the button
Seat 1: 5O3Hj9Qg0SqOyKEXoLpjPg ($176.15 in chips) 
Seat 2: Ew/TYPQIsbQ2X8nm5iAJBg ($25 in chips) 
Seat 3: if4dh6jhJXeN3/qd3qCp9g ($27.05 in chips) 
Seat 5: dOX4wnYV2sEqvDbF+8KSCw ($68.65 in chips) 
Seat 6: /gJNBeCkWL4o85/jvlZ4BA ($50.55 in chips) 
dOX4wnYV2sEqvDbF+8KSCw: posts small blind $0.10
/gJNBeCkWL4o85/jvlZ4BA: posts big blind $0.25
*** HOLE CARDS ***
5O3Hj9Qg0SqOyKEXoLpjPg: folds 
Ew/TYPQIsbQ2X8nm5iAJBg: raises $0.50 to $0.75
if4dh6jhJXeN3/qd3qCp9g: folds 
dOX4wnYV2sEqvDbF+8KSCw: folds 
/gJNBeCkWL4o85/jvlZ4BA: calls $0.50
*** FLOP *** [Kc Ks 4s]
/gJNBeCkWL4o85/jvlZ4BA: checks 
Ew/TYPQIsbQ2X8nm5iAJBg: bets $0.75
/gJNBeCkWL4o85/jvlZ4BA: calls $0.75
*** TURN *** [Kc Ks 4s] [4h]
/gJNBeCkWL4o85/jvlZ4BA: checks 
Ew/TYPQIsbQ2X8nm5iAJBg: checks 
*** RIVER *** [Kc Ks 4s 4h] [9c]
/gJNBeCkWL4o85/jvlZ4BA: checks 
Ew/TYPQIsbQ2X8nm5iAJBg: bets $0.25
/gJNBeCkWL4o85/jvlZ4BA: calls $0.25
buyjetgNT1McXtdaP4zynA said, "unbel. have fun junky"
*** SHOW DOWN ***
Ew/TYPQIsbQ2X8nm5iAJBg: shows [9h Th] (two pair, Kings and Nines)
/gJNBeCkWL4o85/jvlZ4BA: mucks hand 
Ew/TYPQIsbQ2X8nm5iAJBg collected $3.45 from pot
buyjetgNT1McXtdaP4zynA has returned
*** SUMMARY ***
Total pot $3.60 | Rake $0.15 
Board [Kc Ks 4s 4h 9c]
Seat 1: 5O3Hj9Qg0SqOyKEXoLpjPg folded before Flop (didn't bet)
Seat 2: Ew/TYPQIsbQ2X8nm5iAJBg showed [9h Th] and won ($3.45) with two pair, Kings and Nines
Seat 3: if4dh6jhJXeN3/qd3qCp9g (button) folded before Flop (didn't bet)
Seat 5: dOX4wnYV2sEqvDbF+8KSCw (small blind) folded before Flop
Seat 6: /gJNBeCkWL4o85/jvlZ4BA (big blind) mucked




PokerStars Game #59941877300:  Hold'em No Limit ($0.10/$0.25) - 2009/07/01 1:49:00 ET
Table 'wixGE3Zge1qBdnpWijIl/w' 9-max Seat #9 is the button
Seat 1: 4GJMmHGKzu+gVtalqRy7dA ($26.95 in chips) 
Seat 2: DnDcAdn9P0zGovMERigpFA ($77.60 in chips) 
Seat 3: Bb42QRQMhg5/Y0vHP8/2Xw ($25 in chips) 
Seat 5: H5Se03ZqSX7tbULXur2MAg ($23.05 in chips) 
Seat 6: AP/rNvbsacTb4XtaAgKPiQ ($15.45 in chips) 
Seat 7: mMd8CDS/but3UC+Zp7Up2w ($20.70 in chips) 
Seat 8: ShCS62CJp4MKfKLKvGKQbA ($14.80 in chips) 
Seat 9: r6hsffOo1iKmaPYKwAZmFw ($28.80 in chips) 
4GJMmHGKzu+gVtalqRy7dA: posts small blind $0.10
DnDcAdn9P0zGovMERigpFA: posts big blind $0.25
X6+pSIPfovPcE87t+LmUKQ: sits out 
*** HOLE CARDS ***
Bb42QRQMhg5/Y0vHP8/2Xw: folds 
H5Se03ZqSX7tbULXur2MAg: folds 
AP/rNvbsacTb4XtaAgKPiQ: calls $0.25
mMd8CDS/but3UC+Zp7Up2w: folds 
ShCS62CJp4MKfKLKvGKQbA: folds 
r6hsffOo1iKmaPYKwAZmFw: folds 
4GJMmHGKzu+gVtalqRy7dA: calls $0.15
DnDcAdn9P0zGovMERigpFA: checks 
*** FLOP *** [9s 4c 6h]
4GJMmHGKzu+gVtalqRy7dA: bets $0.25
DnDcAdn9P0zGovMERigpFA: folds 
AP/rNvbsacTb4XtaAgKPiQ: folds 
Uncalled bet ($0.25) returned to 4GJMmHGKzu+gVtalqRy7dA
4GJMmHGKzu+gVtalqRy7dA collected $0.75 from pot
4GJMmHGKzu+gVtalqRy7dA: shows [5h 6s] (a pair of Sixes)
*** SUMMARY ***
Total pot $0.75 | Rake $0 
Board [9s 4c 6h]
Seat 1: 4GJMmHGKzu+gVtalqRy7dA (small blind) collected ($0.75)
Seat 2: DnDcAdn9P0zGovMERigpFA (big blind) folded on the Flop
Seat 3: Bb42QRQMhg5/Y0vHP8/2Xw folded before Flop (didn't bet)
Seat 5: H5Se03ZqSX7tbULXur2MAg folded before Flop (didn't bet)
Seat 6: AP/rNvbsacTb4XtaAgKPiQ folded on the Flop
Seat 7: mMd8CDS/but3UC+Zp7Up2w folded before Flop (didn't bet)
Seat 8: ShCS62CJp4MKfKLKvGKQbA folded before Flop (didn't bet)
Seat 9: r6hsffOo1iKmaPYKwAZmFw (button) folded before Flop (didn't bet)




PokerStars Game #59941877044:  Hold'em No Limit ($0.10/$0.25) - 2009/07/01 1:49:00 ET
Table 'sJ4KpS2GE5Qrsu1/cFjJUw' 9-max Seat #3 is the button
Seat 1: eDlQ+S+6L4e6gM1dkZhGgQ ($19.40 in chips) 
Seat 3: eK8qa6EPcH2zhtbmWSvc9g ($25 in chips) 
Seat 4: npAYqa85pqnzfOK5ukX+BQ ($23.75 in chips) 
Seat 5: Q/gZC63lfOMr7YhWKPCxoQ ($8.10 in chips) 
Seat 6: OefE+Csvj5KR7ClGf3Hc2g ($3.85 in chips) 
Seat 7: Wi8djHgewBlVhpKWfp7isQ ($9.20 in chips) 
Seat 8: S7Ki0P+0AIGPuIfGJjW0gg ($30.70 in chips) 
Seat 9: 3PmVnC/15cl4oyI1TKIt4g ($4.40 in chips) 
npAYqa85pqnzfOK5ukX+BQ: posts small blind $0.10
Q/gZC63lfOMr7YhWKPCxoQ: posts big blind $0.25
*** HOLE CARDS ***
OefE+Csvj5KR7ClGf3Hc2g: folds 
Wi8djHgewBlVhpKWfp7isQ: folds 
S7Ki0P+0AIGPuIfGJjW0gg: folds 
3PmVnC/15cl4oyI1TKIt4g: folds 
eDlQ+S+6L4e6gM1dkZhGgQ: calls $0.25
eK8qa6EPcH2zhtbmWSvc9g: folds 
npAYqa85pqnzfOK5ukX+BQ: folds 
Q/gZC63lfOMr7YhWKPCxoQ: checks 
*** FLOP *** [Kc 9c 3s]
npAYqa85pqnzfOK5ukX+BQ is sitting out
Q/gZC63lfOMr7YhWKPCxoQ: checks 
eDlQ+S+6L4e6gM1dkZhGgQ: checks 
*** TURN *** [Kc 9c 3s] [9s]
ydoFOVgzvZv9ZhuWu9rXAw joins the table at seat #2 
Q/gZC63lfOMr7YhWKPCxoQ: checks 
eDlQ+S+6L4e6gM1dkZhGgQ: checks 
*** RIVER *** [Kc 9c 3s 9s] [5d]
Q/gZC63lfOMr7YhWKPCxoQ: bets $0.25
eDlQ+S+6L4e6gM1dkZhGgQ: raises $0.25 to $0.50
Q/gZC63lfOMr7YhWKPCxoQ: folds 
Uncalled bet ($0.25) returned to eDlQ+S+6L4e6gM1dkZhGgQ
eDlQ+S+6L4e6gM1dkZhGgQ collected $1.05 from pot
*** SUMMARY ***
Total pot $1.10 | Rake $0.05 
Board [Kc 9c 3s 9s 5d]
Seat 1: eDlQ+S+6L4e6gM1dkZhGgQ collected ($1.05)
Seat 3: eK8qa6EPcH2zhtbmWSvc9g (button) folded before Flop (didn't bet)
Seat 4: npAYqa85pqnzfOK5ukX+BQ (small blind) folded before Flop
Seat 5: Q/gZC63lfOMr7YhWKPCxoQ (big blind) folded on the River
Seat 6: OefE+Csvj5KR7ClGf3Hc2g folded before Flop (didn't bet)
Seat 7: Wi8djHgewBlVhpKWfp7isQ folded before Flop (didn't bet)
Seat 8: S7Ki0P+0AIGPuIfGJjW0gg folded before Flop (didn't bet)
Seat 9: 3PmVnC/15cl4oyI1TKIt4g folded before Flop (didn't bet)




PokerStars Game #59941877126:  Hold'em No Limit ($0.10/$0.25) - 2009/07/01 1:49:00 ET
Table 'IfRHUn9gQQA9I/Z4tn+BoA' 9-max Seat #1 is the button
Seat 1: imHPFFqvfHGzsBBWeGuy4w ($23.75 in chips) 
Seat 2: VWUWpMLMj/Q1jRVpF7Aohw ($16.45 in chips) 
Seat 3: 4qA/3Ajg3pP6fqW+IX9/fQ ($5 in chips) 
Seat 4: QEbIGci+itdw+re8RM5fZA ($35.50 in chips) 
Seat 5: DdPXdieucQ+n99u1n3A+rQ ($5 in chips) 
Seat 6: UOjoGGQ58/uDS7V0xkjOrQ ($25.20 in chips) 
Seat 7: YzqSxP03XxZPbgPifgt69g ($28.75 in chips) 
Seat 8: cZ99hugmLBj9KhTlc8nCSw ($27.75 in chips) 
VWUWpMLMj/Q1jRVpF7Aohw: posts small blind $0.10
4qA/3Ajg3pP6fqW+IX9/fQ: posts big blind $0.25
18G4P1XstjNvItdGUITxgw: sits out 
*** HOLE CARDS ***
QEbIGci+itdw+re8RM5fZA: folds 
DdPXdieucQ+n99u1n3A+rQ: folds 
UOjoGGQ58/uDS7V0xkjOrQ: calls $0.25
YzqSxP03XxZPbgPifgt69g: folds 
cZ99hugmLBj9KhTlc8nCSw: folds 
imHPFFqvfHGzsBBWeGuy4w: folds 
VWUWpMLMj/Q1jRVpF7Aohw: calls $0.15
4qA/3Ajg3pP6fqW+IX9/fQ: checks 
*** FLOP *** [6c 7s 5d]
VWUWpMLMj/Q1jRVpF7Aohw: checks 
4qA/3Ajg3pP6fqW+IX9/fQ: checks 
UOjoGGQ58/uDS7V0xkjOrQ: bets $0.75
VWUWpMLMj/Q1jRVpF7Aohw: folds 
4qA/3Ajg3pP6fqW+IX9/fQ: folds 
Uncalled bet ($0.75) returned to UOjoGGQ58/uDS7V0xkjOrQ
UOjoGGQ58/uDS7V0xkjOrQ collected $0.75 from pot
UOjoGGQ58/uDS7V0xkjOrQ: doesn't show hand 
*** SUMMARY ***
Total pot $0.75 | Rake $0 
Board [6c 7s 5d]
Seat 1: imHPFFqvfHGzsBBWeGuy4w (button) folded before Flop (didn't bet)
Seat 2: VWUWpMLMj/Q1jRVpF7Aohw (small blind) folded on the Flop
Seat 3: 4qA/3Ajg3pP6fqW+IX9/fQ (big blind) folded on the Flop
Seat 4: QEbIGci+itdw+re8RM5fZA folded before Flop (didn't bet)
Seat 5: DdPXdieucQ+n99u1n3A+rQ folded before Flop (didn't bet)
Seat 6: UOjoGGQ58/uDS7V0xkjOrQ collected ($0.75)
Seat 7: YzqSxP03XxZPbgPifgt69g folded before Flop (didn't bet)
Seat 8: cZ99hugmLBj9KhTlc8nCSw folded before Flop (didn't bet)




PokerStars Game #59941877096:  Hold'em No Limit ($0.10/$0.25) - 2009/07/01 1:49:00 ET
Table '3EebBlzq5yHSY2444L4zlg' 9-max Seat #8 is the button
Seat 1: XMSS6mD5B42I8wasdOMipQ ($29.50 in chips) 
Seat 2: b9UnopCOpq2MWP1DwqSO3Q ($17.70 in chips) 
Seat 3: IGbD5vKNhHe60dkdbjg/mw ($17.30 in chips) 
Seat 5: PFNLAvMkr8qKc7xCiH0wTA ($51.95 in chips) 
Seat 6: QEbIGci+itdw+re8RM5fZA ($50 in chips) 
Seat 7: DiSvPC2iudwL5j9u6Huyww ($48.35 in chips) 
Seat 8: dtZ84flFEi4Q+SGrHMJRDQ ($28.70 in chips) 
Seat 9: iZmSlSzYu5fJ67tDdQzymQ ($25 in chips) 
iZmSlSzYu5fJ67tDdQzymQ: posts small blind $0.10
XMSS6mD5B42I8wasdOMipQ: posts big blind $0.25
PdIasPkzm2sqZnN41ZRXOg: sits out 
*** HOLE CARDS ***
b9UnopCOpq2MWP1DwqSO3Q: folds 
IGbD5vKNhHe60dkdbjg/mw: raises $0.25 to $0.50
PFNLAvMkr8qKc7xCiH0wTA: folds 
QEbIGci+itdw+re8RM5fZA: folds 
DiSvPC2iudwL5j9u6Huyww: folds 
dtZ84flFEi4Q+SGrHMJRDQ: folds 
iZmSlSzYu5fJ67tDdQzymQ: folds 
XMSS6mD5B42I8wasdOMipQ: folds 
Uncalled bet ($0.25) returned to IGbD5vKNhHe60dkdbjg/mw
IGbD5vKNhHe60dkdbjg/mw collected $0.60 from pot
*** SUMMARY ***
Total pot $0.60 | Rake $0 
Seat 1: XMSS6mD5B42I8wasdOMipQ (big blind) folded before Flop
Seat 2: b9UnopCOpq2MWP1DwqSO3Q folded before Flop (didn't bet)
Seat 3: IGbD5vKNhHe60dkdbjg/mw collected ($0.60)
Seat 5: PFNLAvMkr8qKc7xCiH0wTA folded before Flop (didn't bet)
Seat 6: QEbIGci+itdw+re8RM5fZA folded before Flop (didn't bet)
Seat 7: DiSvPC2iudwL5j9u6Huyww folded before Flop (didn't bet)
Seat 8: dtZ84flFEi4Q+SGrHMJRDQ (button) folded before Flop (didn't bet)
Seat 9: iZmSlSzYu5fJ67tDdQzymQ (small blind) folded before Flop




PokerStars Game #59941877242:  Hold'em No Limit ($0.10/$0.25) - 2009/07/01 1:49:00 ET
Table 'edvgY2YQ1I34euq4EVqGnA' 6-max Seat #2 is the button
Seat 1: mvFHK3pE7tCxJEqLjKC70Q ($30.35 in chips) 
Seat 2: Hsvkc0/G2VV78oVmWYXecw ($5.25 in chips) 
Seat 4: TI/C5Q+DEl4fLR3AofwYdg ($23.15 in chips) 
Seat 5: EE16Ua5b1HSsYej5zeXOlA ($56 in chips) 
Seat 6: kG34n23qFQA3nzdOJTQ1dA ($71 in chips) 
TI/C5Q+DEl4fLR3AofwYdg: posts small blind $0.10
EE16Ua5b1HSsYej5zeXOlA: posts big blind $0.25
*** HOLE CARDS ***
kG34n23qFQA3nzdOJTQ1dA: folds 
mvFHK3pE7tCxJEqLjKC70Q: folds 
Hsvkc0/G2VV78oVmWYXecw: folds 
TI/C5Q+DEl4fLR3AofwYdg: folds 
Uncalled bet ($0.15) returned to EE16Ua5b1HSsYej5zeXOlA
EE16Ua5b1HSsYej5zeXOlA collected $0.20 from pot
EE16Ua5b1HSsYej5zeXOlA: doesn't show hand 
*** SUMMARY ***
Total pot $0.20 | Rake $0 
Seat 1: mvFHK3pE7tCxJEqLjKC70Q folded before Flop (didn't bet)
Seat 2: Hsvkc0/G2VV78oVmWYXecw (button) folded before Flop (didn't bet)
Seat 4: TI/C5Q+DEl4fLR3AofwYdg (small blind) folded before Flop
Seat 5: EE16Ua5b1HSsYej5zeXOlA (big blind) collected ($0.20)
Seat 6: kG34n23qFQA3nzdOJTQ1dA folded before Flop (didn't bet)




PokerStars Game #59941877188:  Hold'em No Limit ($0.10/$0.25) - 2009/07/01 1:49:00 ET
Table 'dZNBGqFYSwfOVZvDJ4VjIQ' 6-max Seat #5 is the button
Seat 1: v+QfkGiuj9bgtuNoVnDO8w ($38.35 in chips) 
Seat 2: 3zD3qLXT1bEffAoWGnc7wg ($28.30 in chips) 
Seat 3: kyRaCIljYA6l33lSKQfNsg ($27.95 in chips) 
Seat 5: +ZlnqPoP3Hg4BIUxDfKd/A ($29.85 in chips) 
Seat 6: ypmjhffk/YHGc51wgVXUTw ($29.15 in chips) 
ypmjhffk/YHGc51wgVXUTw: posts small blind $0.10
v+QfkGiuj9bgtuNoVnDO8w: posts big blind $0.25
*** HOLE CARDS ***
3zD3qLXT1bEffAoWGnc7wg: folds 
kyRaCIljYA6l33lSKQfNsg: raises $0.50 to $0.75
+ZlnqPoP3Hg4BIUxDfKd/A: calls $0.75
ypmjhffk/YHGc51wgVXUTw: folds 
v+QfkGiuj9bgtuNoVnDO8w: folds 
*** FLOP *** [Jh 6c 6h]
kyRaCIljYA6l33lSKQfNsg: bets $1.25
+ZlnqPoP3Hg4BIUxDfKd/A: folds 
Uncalled bet ($1.25) returned to kyRaCIljYA6l33lSKQfNsg
kyRaCIljYA6l33lSKQfNsg collected $1.80 from pot
*** SUMMARY ***
Total pot $1.85 | Rake $0.05 
Board [Jh 6c 6h]
Seat 1: v+QfkGiuj9bgtuNoVnDO8w (big blind) folded before Flop
Seat 2: 3zD3qLXT1bEffAoWGnc7wg folded before Flop (didn't bet)
Seat 3: kyRaCIljYA6l33lSKQfNsg collected ($1.80)
Seat 5: +ZlnqPoP3Hg4BIUxDfKd/A (button) folded on the Flop
Seat 6: ypmjhffk/YHGc51wgVXUTw (small blind) folded before Flop




PokerStars Game #59941877346:  Hold'em No Limit ($0.10/$0.25) - 2009/07/01 1:49:00 ET
Table 'Xi38lWH8L2JHRAsKYVX8Qg' 6-max Seat #5 is the button
Seat 1: shP7DFAtX7gXcgMJX/OmRQ ($22.90 in chips) 
Seat 3: 6DwBRH+xZ12AAZmeAg+aXw ($31.55 in chips) 
Seat 4: kG34n23qFQA3nzdOJTQ1dA ($24.40 in chips) 
Seat 5: 79ID/ub1Pt/mDpCprVmOoA ($77.25 in chips) 
Seat 6: kyRaCIljYA6l33lSKQfNsg ($29.85 in chips) 
kyRaCIljYA6l33lSKQfNsg: posts small blind $0.10
shP7DFAtX7gXcgMJX/OmRQ: posts big blind $0.25
*** HOLE CARDS ***
6DwBRH+xZ12AAZmeAg+aXw: folds 
kG34n23qFQA3nzdOJTQ1dA: folds 
79ID/ub1Pt/mDpCprVmOoA: folds 
kyRaCIljYA6l33lSKQfNsg: folds 
Uncalled bet ($0.15) returned to shP7DFAtX7gXcgMJX/OmRQ
shP7DFAtX7gXcgMJX/OmRQ collected $0.20 from pot
shP7DFAtX7gXcgMJX/OmRQ: doesn't show hand 
*** SUMMARY ***
Total pot $0.20 | Rake $0 
Seat 1: shP7DFAtX7gXcgMJX/OmRQ (big blind) collected ($0.20)
Seat 3: 6DwBRH+xZ12AAZmeAg+aXw folded before Flop (didn't bet)
Seat 4: kG34n23qFQA3nzdOJTQ1dA folded before Flop (didn't bet)
Seat 5: 79ID/ub1Pt/mDpCprVmOoA (button) folded before Flop (didn't bet)
Seat 6: kyRaCIljYA6l33lSKQfNsg (small blind) folded before Flop




PokerStars Game #59941876968:  Hold'em No Limit ($0.10/$0.25) - 2009/07/01 1:49:00 ET
Table 'QegsWX65l3n/K0A8XB78yg' 6-max Seat #4 is the button
Seat 1: p6adJRMXMBLr+xtQzqazIQ ($12.35 in chips) 
Seat 2: GC/9yVD59DUCX7hUI7gcLw ($57.35 in chips) 
Seat 3: iIgNoBh+3/Ix1/fLsg+HuA ($5.65 in chips) 
Seat 4: epAUIB7h2FJXzUPRIvSkRA ($25 in chips) 
Seat 5: QqiZLFrN8iOUT/GHw7ztOA ($29.05 in chips) 
Seat 6: 5PWs02z65jSO5pr/M6wx/w ($6.45 in chips) 
QqiZLFrN8iOUT/GHw7ztOA: posts small blind $0.10
5PWs02z65jSO5pr/M6wx/w: posts big blind $0.25
*** HOLE CARDS ***
p6adJRMXMBLr+xtQzqazIQ: folds 
GC/9yVD59DUCX7hUI7gcLw: raises $0.75 to $1
iIgNoBh+3/Ix1/fLsg+HuA: folds 
epAUIB7h2FJXzUPRIvSkRA: calls $1
QqiZLFrN8iOUT/GHw7ztOA: folds 
5PWs02z65jSO5pr/M6wx/w: folds 
*** FLOP *** [Td 5c Qs]
GC/9yVD59DUCX7hUI7gcLw: bets $1.50
epAUIB7h2FJXzUPRIvSkRA: folds 
Uncalled bet ($1.50) returned to GC/9yVD59DUCX7hUI7gcLw
GC/9yVD59DUCX7hUI7gcLw collected $2.25 from pot
*** SUMMARY ***
Total pot $2.35 | Rake $0.10 
Board [Td 5c Qs]
Seat 1: p6adJRMXMBLr+xtQzqazIQ folded before Flop (didn't bet)
Seat 2: GC/9yVD59DUCX7hUI7gcLw collected ($2.25)
Seat 3: iIgNoBh+3/Ix1/fLsg+HuA folded before Flop (didn't bet)
Seat 4: epAUIB7h2FJXzUPRIvSkRA (button) folded on the Flop
Seat 5: QqiZLFrN8iOUT/GHw7ztOA (small blind) folded before Flop
Seat 6: 5PWs02z65jSO5pr/M6wx/w (big blind) folded before Flop




PokerStars Game #59941877404:  Hold'em No Limit ($0.10/$0.25) - 2009/07/01 1:49:00 ET
Table 'Dun24l/X8kjpUHWBhkVOFw' 6-max Seat #5 is the button
Seat 1: u3Ol7kv1LmvszuHNm9rc6w ($22.40 in chips) 
Seat 2: 6hUmfDYq+83kvxWoTBQmfw ($30.90 in chips) 
Seat 3: +E5iJKkKVfaTgTqzuXXv0g ($13.15 in chips) 
Seat 4: 7/ROHX4tuLekJ2diYIlMkw ($3.05 in chips) 
Seat 5: KYBwVA7jgmSrbIEbEGElVg ($22.30 in chips) 
Seat 6: xrf8tAXKQHG99HixCot1Iw ($25 in chips) 
xrf8tAXKQHG99HixCot1Iw: posts small blind $0.10
u3Ol7kv1LmvszuHNm9rc6w: posts big blind $0.25
*** HOLE CARDS ***
6hUmfDYq+83kvxWoTBQmfw: calls $0.25
+E5iJKkKVfaTgTqzuXXv0g: calls $0.25
7/ROHX4tuLekJ2diYIlMkw: raises $0.25 to $0.50
KYBwVA7jgmSrbIEbEGElVg: calls $0.50
xrf8tAXKQHG99HixCot1Iw: folds 
u3Ol7kv1LmvszuHNm9rc6w: calls $0.25
6hUmfDYq+83kvxWoTBQmfw: calls $0.25
+E5iJKkKVfaTgTqzuXXv0g: folds 
*** FLOP *** [Ks 4d 4c]
u3Ol7kv1LmvszuHNm9rc6w: checks 
6hUmfDYq+83kvxWoTBQmfw: checks 
7/ROHX4tuLekJ2diYIlMkw: folds 
7/ROHX4tuLekJ2diYIlMkw leaves the table
KYBwVA7jgmSrbIEbEGElVg: bets $1
u3Ol7kv1LmvszuHNm9rc6w: folds 
6hUmfDYq+83kvxWoTBQmfw: folds 
Uncalled bet ($1) returned to KYBwVA7jgmSrbIEbEGElVg
KYBwVA7jgmSrbIEbEGElVg collected $2.25 from pot
*** SUMMARY ***
Total pot $2.35 | Rake $0.10 
Board [Ks 4d 4c]
Seat 1: u3Ol7kv1LmvszuHNm9rc6w (big blind) folded on the Flop
Seat 2: 6hUmfDYq+83kvxWoTBQmfw folded on the Flop
Seat 3: +E5iJKkKVfaTgTqzuXXv0g folded before Flop
Seat 4: 7/ROHX4tuLekJ2diYIlMkw folded on the Flop
Seat 5: KYBwVA7jgmSrbIEbEGElVg (button) collected ($2.25)
Seat 6: xrf8tAXKQHG99HixCot1Iw (small blind) folded before Flop




PokerStars Game #59941877270:  Hold'em No Limit ($0.10/$0.25) - 2009/07/01 1:49:00 ET
Table '1HT8bEDpLPhOXxmqMtzF8w' 9-max Seat #3 is the button
Seat 1: YkkKQUDI0iWatY4h0WWaAQ ($12.65 in chips) 
Seat 2: r6hsffOo1iKmaPYKwAZmFw ($29 in chips) 
Seat 3: oLa/tXLfSLLB28mcLGrxcg ($23.50 in chips) 
Seat 6: bXpVeaSTPBFSPJmeXxO7nw ($6 in chips) 
Seat 7: PMhmqYBPHOAXjH25lRz69g ($16.55 in chips) 
Seat 8: ghNKXUBl/H+t83JF079ZBA ($33.15 in chips) 
Seat 9: Z9W7+g1WMhhZDi7DwGbCFA ($5 in chips) 
bXpVeaSTPBFSPJmeXxO7nw: posts small blind $0.10
PMhmqYBPHOAXjH25lRz69g: posts big blind $0.25
*** HOLE CARDS ***
ghNKXUBl/H+t83JF079ZBA: folds 
Z9W7+g1WMhhZDi7DwGbCFA: folds 
YkkKQUDI0iWatY4h0WWaAQ: folds 
r6hsffOo1iKmaPYKwAZmFw: folds 
oLa/tXLfSLLB28mcLGrxcg: folds 
bXpVeaSTPBFSPJmeXxO7nw: folds 
Uncalled bet ($0.15) returned to PMhmqYBPHOAXjH25lRz69g
PMhmqYBPHOAXjH25lRz69g collected $0.20 from pot
PMhmqYBPHOAXjH25lRz69g: doesn't show hand 
*** SUMMARY ***
Total pot $0.20 | Rake $0 
Seat 1: YkkKQUDI0iWatY4h0WWaAQ folded before Flop (didn't bet)
Seat 2: r6hsffOo1iKmaPYKwAZmFw folded before Flop (didn't bet)
Seat 3: oLa/tXLfSLLB28mcLGrxcg (button) folded before Flop (didn't bet)
Seat 6: bXpVeaSTPBFSPJmeXxO7nw (small blind) folded before Flop
Seat 7: PMhmqYBPHOAXjH25lRz69g (big blind) collected ($0.20)
Seat 8: ghNKXUBl/H+t83JF079ZBA folded before Flop (didn't bet)
Seat 9: Z9W7+g1WMhhZDi7DwGbCFA folded before Flop (didn't bet)




PokerStars Game #59941877916:  Hold'em No Limit ($0.10/$0.25) - 2009/07/01 1:49:01 ET
Table '+198VWQSWBhYQOcizzuBkw' 6-max Seat #5 is the button
Seat 1: 34ttqW62uIRrqINCCmLcsw ($20 in chips) 
Seat 2: iauW7L/+7qzAuHow7CD75Q ($10.10 in chips) 
Seat 3: vw7gefupgmOJJN8lUemdWg ($18.85 in chips) 
Seat 4: TgDsTeCdLQt8kWbL00ByRA ($14.65 in chips) 
Seat 5: LtASJ9OlkqGrrUKGQlpGAw ($25 in chips) 
Seat 6: leEQ84f6wJYu5SB/vj27wg ($3.55 in chips) 
leEQ84f6wJYu5SB/vj27wg: posts small blind $0.10
34ttqW62uIRrqINCCmLcsw: posts big blind $0.25
*** HOLE CARDS ***
iauW7L/+7qzAuHow7CD75Q: calls $0.25
vw7gefupgmOJJN8lUemdWg: raises $0.50 to $0.75
TgDsTeCdLQt8kWbL00ByRA: folds 
LtASJ9OlkqGrrUKGQlpGAw: folds 
leEQ84f6wJYu5SB/vj27wg: calls $0.65
34ttqW62uIRrqINCCmLcsw: calls $0.50
iauW7L/+7qzAuHow7CD75Q: calls $0.50
*** FLOP *** [2s Jc Th]
leEQ84f6wJYu5SB/vj27wg: checks 
34ttqW62uIRrqINCCmLcsw: checks 
iauW7L/+7qzAuHow7CD75Q: bets $0.75
vw7gefupgmOJJN8lUemdWg: calls $0.75
leEQ84f6wJYu5SB/vj27wg: folds 
34ttqW62uIRrqINCCmLcsw: folds 
*** TURN *** [2s Jc Th] [4c]
iauW7L/+7qzAuHow7CD75Q: bets $1.25
vw7gefupgmOJJN8lUemdWg: folds 
Uncalled bet ($1.25) returned to iauW7L/+7qzAuHow7CD75Q
iauW7L/+7qzAuHow7CD75Q collected $4.30 from pot
*** SUMMARY ***
Total pot $4.50 | Rake $0.20 
Board [2s Jc Th 4c]
Seat 1: 34ttqW62uIRrqINCCmLcsw (big blind) folded on the Flop
Seat 2: iauW7L/+7qzAuHow7CD75Q collected ($4.30)
Seat 3: vw7gefupgmOJJN8lUemdWg folded on the Turn
Seat 4: TgDsTeCdLQt8kWbL00ByRA folded before Flop (didn't bet)
Seat 5: LtASJ9OlkqGrrUKGQlpGAw (button) folded before Flop (didn't bet)
Seat 6: leEQ84f6wJYu5SB/vj27wg (small blind) folded on the Flop




PokerStars Game #59941877876:  Hold'em No Limit ($0.10/$0.25) - 2009/07/01 1:49:01 ET
Table 'Of/T60zpXg1GcjrZ7Lm//Q' 9-max Seat #1 is the button
Seat 1: Lro4e37x4FUa5P3yzDjskw ($17.85 in chips) 
Seat 2: qwr38jl5txoR36M7G5qi4A ($9.65 in chips) 
Seat 3: 6RiVTYll/5D8zICp0MRpKw ($25 in chips) 
Seat 4: Czut6V7acIqUJrrobjKAZg ($5.40 in chips) 
Seat 6: tYsOBqdU1+x+yFI7zHO7hQ ($31.45 in chips) 
Seat 7: PVxvfRTRvkgZf9WtquEkwQ ($25 in chips) 
Seat 8: ghNKXUBl/H+t83JF079ZBA ($26.50 in chips) 
Seat 9: egvg3mTBBVzMHnJPIQiKcA ($15.05 in chips) 
qwr38jl5txoR36M7G5qi4A: posts small blind $0.10
6RiVTYll/5D8zICp0MRpKw: posts big blind $0.25
*** HOLE CARDS ***
Czut6V7acIqUJrrobjKAZg: folds 
tYsOBqdU1+x+yFI7zHO7hQ: folds 
PVxvfRTRvkgZf9WtquEkwQ: folds 
ghNKXUBl/H+t83JF079ZBA: folds 
egvg3mTBBVzMHnJPIQiKcA: folds 
6mStmDUknIn/RyBEoiIyoQ joins the table at seat #5 
Lro4e37x4FUa5P3yzDjskw: raises $0.25 to $0.50
qwr38jl5txoR36M7G5qi4A: folds 
6RiVTYll/5D8zICp0MRpKw: calls $0.25
*** FLOP *** [4s Kh Ad]
6RiVTYll/5D8zICp0MRpKw: checks 
Lro4e37x4FUa5P3yzDjskw: bets $1
6RiVTYll/5D8zICp0MRpKw: calls $1
*** TURN *** [4s Kh Ad] [3s]
6RiVTYll/5D8zICp0MRpKw: checks 
Lro4e37x4FUa5P3yzDjskw: bets $0.75
6RiVTYll/5D8zICp0MRpKw: calls $0.75
*** RIVER *** [4s Kh Ad 3s] [Ah]
6RiVTYll/5D8zICp0MRpKw: checks 
Lro4e37x4FUa5P3yzDjskw: bets $1.75
6RiVTYll/5D8zICp0MRpKw: folds 
Uncalled bet ($1.75) returned to Lro4e37x4FUa5P3yzDjskw
Lro4e37x4FUa5P3yzDjskw collected $4.40 from pot
*** SUMMARY ***
Total pot $4.60 | Rake $0.20 
Board [4s Kh Ad 3s Ah]
Seat 1: Lro4e37x4FUa5P3yzDjskw (button) collected ($4.40)
Seat 2: qwr38jl5txoR36M7G5qi4A (small blind) folded before Flop
Seat 3: 6RiVTYll/5D8zICp0MRpKw (big blind) folded on the River
Seat 4: Czut6V7acIqUJrrobjKAZg folded before Flop (didn't bet)
Seat 6: tYsOBqdU1+x+yFI7zHO7hQ folded before Flop (didn't bet)
Seat 7: PVxvfRTRvkgZf9WtquEkwQ folded before Flop (didn't bet)
Seat 8: ghNKXUBl/H+t83JF079ZBA folded before Flop (didn't bet)
Seat 9: egvg3mTBBVzMHnJPIQiKcA folded before Flop (didn't bet)




PokerStars Game #59941877796:  Hold'em No Limit ($0.10/$0.25) - 2009/07/01 1:49:01 ET
Table 'KKk6y4pAXeymxYcd0uZLqg' 9-max Seat #6 is the button
Seat 1: HPEB+AtKw1+C/cxU0o1ciw ($24.90 in chips) 
Seat 3: tLcDklc2rBORNfixyRfVfw ($25 in chips) 
Seat 4: YciNm3fUXAQaJeXG1rhrbw ($8.20 in chips) 
Seat 5: wGigCmBR/9XWkPpvYos3aQ ($40.35 in chips) 
Seat 6: QEbIGci+itdw+re8RM5fZA ($25 in chips) 
Seat 7: JjOuv8Vf56aiQjWi/rTPFA ($23 in chips) 
Seat 8: +2kMBNpY4nF1qNCRd8SJLA ($36.05 in chips) 
Seat 9: oLa/tXLfSLLB28mcLGrxcg ($25.45 in chips) 
JjOuv8Vf56aiQjWi/rTPFA: posts small blind $0.10
+2kMBNpY4nF1qNCRd8SJLA: posts big blind $0.25
*** HOLE CARDS ***
oLa/tXLfSLLB28mcLGrxcg: folds 
HPEB+AtKw1+C/cxU0o1ciw: folds 
tLcDklc2rBORNfixyRfVfw: folds 
YciNm3fUXAQaJeXG1rhrbw: folds 
YciNm3fUXAQaJeXG1rhrbw leaves the table
wGigCmBR/9XWkPpvYos3aQ: raises $0.55 to $0.80
QEbIGci+itdw+re8RM5fZA: folds 
JjOuv8Vf56aiQjWi/rTPFA: folds 
+2kMBNpY4nF1qNCRd8SJLA: folds 
Uncalled bet ($0.55) returned to wGigCmBR/9XWkPpvYos3aQ
18G4P1XstjNvItdGUITxgw joins the table at seat #4 
wGigCmBR/9XWkPpvYos3aQ collected $0.60 from pot
wGigCmBR/9XWkPpvYos3aQ: doesn't show hand 
*** SUMMARY ***
Total pot $0.60 | Rake $0 
Seat 1: HPEB+AtKw1+C/cxU0o1ciw folded before Flop (didn't bet)
Seat 3: tLcDklc2rBORNfixyRfVfw folded before Flop (didn't bet)
Seat 4: YciNm3fUXAQaJeXG1rhrbw folded before Flop (didn't bet)
Seat 5: wGigCmBR/9XWkPpvYos3aQ collected ($0.60)
Seat 6: QEbIGci+itdw+re8RM5fZA (button) folded before Flop (didn't bet)
Seat 7: JjOuv8Vf56aiQjWi/rTPFA (small blind) folded before Flop
Seat 8: +2kMBNpY4nF1qNCRd8SJLA (big blind) folded before Flop
Seat 9: oLa/tXLfSLLB28mcLGrxcg folded before Flop (didn't bet)




PokerStars Game #59941877540:  Hold'em No Limit ($0.10/$0.25) - 2009/07/01 1:49:01 ET
Table 'YYMg5qzxK1m9eGRo4SbxtQ' 9-max Seat #5 is the button
Seat 1: 3PmVnC/15cl4oyI1TKIt4g ($5 in chips) 
Seat 2: f/H6PsHRl4W1JyNsEDvPtg ($15.10 in chips) 
Seat 3: eK8qa6EPcH2zhtbmWSvc9g ($25.25 in chips) 
Seat 4: ROxrieegd9WYtWcUKJAlbg ($12.50 in chips) 
Seat 5: 4awUyiDYTgylQKXZ9faBVA ($25 in chips) 
Seat 6: S5VeQLgBIiHrfs9AB2vBwA ($3.20 in chips) 
Seat 7: sUVgUtgbfVx6JpvApozwhQ ($5 in chips) 
Seat 8: xoBFd/5k+L/pFn9VW1VyWg ($14.20 in chips) 
Seat 9: +sbyWwIcFp9kP0bDtMegfQ ($31.60 in chips) 
S5VeQLgBIiHrfs9AB2vBwA: posts small blind $0.10
sUVgUtgbfVx6JpvApozwhQ: posts big blind $0.25
*** HOLE CARDS ***
xoBFd/5k+L/pFn9VW1VyWg: folds 
+sbyWwIcFp9kP0bDtMegfQ: folds 
3PmVnC/15cl4oyI1TKIt4g: folds 
f/H6PsHRl4W1JyNsEDvPtg: folds 
eK8qa6EPcH2zhtbmWSvc9g: folds 
ROxrieegd9WYtWcUKJAlbg: calls $0.25
4awUyiDYTgylQKXZ9faBVA: folds 
S5VeQLgBIiHrfs9AB2vBwA: calls $0.15
sUVgUtgbfVx6JpvApozwhQ: raises $0.75 to $1
ROxrieegd9WYtWcUKJAlbg: calls $0.75
S5VeQLgBIiHrfs9AB2vBwA: calls $0.75
*** FLOP *** [9h Kc 6c]
S5VeQLgBIiHrfs9AB2vBwA: checks 
sUVgUtgbfVx6JpvApozwhQ: bets $0.75
ROxrieegd9WYtWcUKJAlbg: calls $0.75
S5VeQLgBIiHrfs9AB2vBwA: folds 
*** TURN *** [9h Kc 6c] [Qc]
sUVgUtgbfVx6JpvApozwhQ: bets $3.25 and is all-in
ROxrieegd9WYtWcUKJAlbg: folds 
Uncalled bet ($3.25) returned to sUVgUtgbfVx6JpvApozwhQ
sUVgUtgbfVx6JpvApozwhQ collected $4.30 from pot
sUVgUtgbfVx6JpvApozwhQ: doesn't show hand 
*** SUMMARY ***
Total pot $4.50 | Rake $0.20 
Board [9h Kc 6c Qc]
Seat 1: 3PmVnC/15cl4oyI1TKIt4g folded before Flop (didn't bet)
Seat 2: f/H6PsHRl4W1JyNsEDvPtg folded before Flop (didn't bet)
Seat 3: eK8qa6EPcH2zhtbmWSvc9g folded before Flop (didn't bet)
Seat 4: ROxrieegd9WYtWcUKJAlbg folded on the Turn
Seat 5: 4awUyiDYTgylQKXZ9faBVA (button) folded before Flop (didn't bet)
Seat 6: S5VeQLgBIiHrfs9AB2vBwA (small blind) folded on the Flop
Seat 7: sUVgUtgbfVx6JpvApozwhQ (big blind) collected ($4.30)
Seat 8: xoBFd/5k+L/pFn9VW1VyWg folded before Flop (didn't bet)
Seat 9: +sbyWwIcFp9kP0bDtMegfQ folded before Flop (didn't bet)




PokerStars Game #59941877588:  Hold'em No Limit ($0.10/$0.25) - 2009/07/01 1:49:01 ET
Table '3lL16FBjWXTx3AjK5lMRww' 9-max Seat #4 is the button
Seat 1: fDGyaQz0cs2s4FOYxkbIHA ($16.55 in chips) 
Seat 2: c/9X4zftzphFxYtxp5kp9w ($21.55 in chips) 
Seat 3: QEbIGci+itdw+re8RM5fZA ($28.50 in chips) 
Seat 4: Z3a37Ry74FVl+CBZtAONiA ($6.40 in chips) 
Seat 5: M/9j4wkHH9i1JM51vgi1VA ($37.05 in chips) 
Seat 6: zUXhymECc2C9W9ZNw6qppA ($9.15 in chips) 
Seat 7: 6RiVTYll/5D8zICp0MRpKw ($24.95 in chips) 
Seat 8: ljemhp25Zg+nlA9DLCIiUw ($24.50 in chips) 
Seat 9: 00Ybni1cxfHtqmdWwh31Xg ($10.30 in chips) 
M/9j4wkHH9i1JM51vgi1VA: posts small blind $0.10
zUXhymECc2C9W9ZNw6qppA: posts big blind $0.25
*** HOLE CARDS ***
6RiVTYll/5D8zICp0MRpKw: raises $0.75 to $1
ljemhp25Zg+nlA9DLCIiUw: folds 
00Ybni1cxfHtqmdWwh31Xg: folds 
fDGyaQz0cs2s4FOYxkbIHA: calls $1
c/9X4zftzphFxYtxp5kp9w: folds 
QEbIGci+itdw+re8RM5fZA: folds 
Z3a37Ry74FVl+CBZtAONiA: folds 
M/9j4wkHH9i1JM51vgi1VA: folds 
zUXhymECc2C9W9ZNw6qppA: folds 
*** FLOP *** [5c Th Kc]
6RiVTYll/5D8zICp0MRpKw: bets $1.50
fDGyaQz0cs2s4FOYxkbIHA: folds 
Uncalled bet ($1.50) returned to 6RiVTYll/5D8zICp0MRpKw
6RiVTYll/5D8zICp0MRpKw collected $2.25 from pot
*** SUMMARY ***
Total pot $2.35 | Rake $0.10 
Board [5c Th Kc]
Seat 1: fDGyaQz0cs2s4FOYxkbIHA folded on the Flop
Seat 2: c/9X4zftzphFxYtxp5kp9w folded before Flop (didn't bet)
Seat 3: QEbIGci+itdw+re8RM5fZA folded before Flop (didn't bet)
Seat 4: Z3a37Ry74FVl+CBZtAONiA (button) folded before Flop (didn't bet)
Seat 5: M/9j4wkHH9i1JM51vgi1VA (small blind) folded before Flop
Seat 6: zUXhymECc2C9W9ZNw6qppA (big blind) folded before Flop
Seat 7: 6RiVTYll/5D8zICp0MRpKw collected ($2.25)
Seat 8: ljemhp25Zg+nlA9DLCIiUw folded before Flop (didn't bet)
Seat 9: 00Ybni1cxfHtqmdWwh31Xg folded before Flop (didn't bet)




PokerStars Game #59941878286:  Hold'em No Limit ($0.10/$0.25) - 2009/07/01 1:49:02 ET
Table 'ykyWGjhNu7AvZXov27T4ew' 9-max Seat #2 is the button
Seat 1: skUI2T7o4P1rz460mMbAOg ($10.25 in chips) 
Seat 2: MG90wfSJZnOejs/KD3vlQQ ($38.85 in chips) 
Seat 3: NPI9ArW8kwrb6a2IAL6xMQ ($28.25 in chips) 
Seat 4: W6tExOcYX7qiy6Qdp+ZwFA ($5.90 in chips) 
Seat 5: CmngQmkKTp8tkl6GMRTl6w ($8.50 in chips) 
Seat 6: AiXn/9o1EwOPZUHujnh/bA ($20.15 in chips) 
Seat 7: npAYqa85pqnzfOK5ukX+BQ ($21.30 in chips) 
Seat 8: tYsOBqdU1+x+yFI7zHO7hQ ($48.85 in chips) 
Seat 9: wk9M6R3w+aDHpr8WV87RmQ ($10.65 in chips) 
NPI9ArW8kwrb6a2IAL6xMQ: posts small blind $0.10
W6tExOcYX7qiy6Qdp+ZwFA: posts big blind $0.25
*** HOLE CARDS ***
CmngQmkKTp8tkl6GMRTl6w: folds 
AiXn/9o1EwOPZUHujnh/bA: folds 
npAYqa85pqnzfOK5ukX+BQ: folds 
tYsOBqdU1+x+yFI7zHO7hQ: folds 
wk9M6R3w+aDHpr8WV87RmQ: raises $0.75 to $1
skUI2T7o4P1rz460mMbAOg: folds 
MG90wfSJZnOejs/KD3vlQQ: folds 
npAYqa85pqnzfOK5ukX+BQ is sitting out
NPI9ArW8kwrb6a2IAL6xMQ: calls $0.90
W6tExOcYX7qiy6Qdp+ZwFA: raises $2 to $3
wk9M6R3w+aDHpr8WV87RmQ: calls $2
NPI9ArW8kwrb6a2IAL6xMQ: calls $2
*** FLOP *** [4c 7h 4h]
NPI9ArW8kwrb6a2IAL6xMQ: checks 
W6tExOcYX7qiy6Qdp+ZwFA: bets $2.90 and is all-in
wk9M6R3w+aDHpr8WV87RmQ: raises $3.10 to $6
NPI9ArW8kwrb6a2IAL6xMQ: folds 
Uncalled bet ($3.10) returned to wk9M6R3w+aDHpr8WV87RmQ
*** TURN *** [4c 7h 4h] [5c]
*** RIVER *** [4c 7h 4h 5c] [3h]
*** SHOW DOWN ***
W6tExOcYX7qiy6Qdp+ZwFA: shows [As Ad] (two pair, Aces and Fours)
wk9M6R3w+aDHpr8WV87RmQ: mucks hand 
W6tExOcYX7qiy6Qdp+ZwFA collected $14.10 from pot
*** SUMMARY ***
Total pot $14.80 | Rake $0.70 
Board [4c 7h 4h 5c 3h]
Seat 1: skUI2T7o4P1rz460mMbAOg folded before Flop (didn't bet)
Seat 2: MG90wfSJZnOejs/KD3vlQQ (button) folded before Flop (didn't bet)
Seat 3: NPI9ArW8kwrb6a2IAL6xMQ (small blind) folded on the Flop
Seat 4: W6tExOcYX7qiy6Qdp+ZwFA (big blind) showed [As Ad] and won ($14.10) with two pair, Aces and Fours
Seat 5: CmngQmkKTp8tkl6GMRTl6w folded before Flop (didn't bet)
Seat 6: AiXn/9o1EwOPZUHujnh/bA folded before Flop (didn't bet)
Seat 7: npAYqa85pqnzfOK5ukX+BQ folded before Flop (didn't bet)
Seat 8: tYsOBqdU1+x+yFI7zHO7hQ folded before Flop (didn't bet)
Seat 9: wk9M6R3w+aDHpr8WV87RmQ mucked




PokerStars Game #59941878158:  Hold'em No Limit ($0.10/$0.25) - 2009/07/01 1:49:02 ET
Table 'U0hCzoS0KCJL+eoE054K4Q' 9-max Seat #4 is the button
Seat 1: XVEauYThJRhSTUAMxB/2ow ($37.20 in chips) 
Seat 2: MG90wfSJZnOejs/KD3vlQQ ($28.50 in chips) 
Seat 3: 8Cp1H3sSs8+jTTwLfeYKcw ($25.55 in chips) 
Seat 4: Bb42QRQMhg5/Y0vHP8/2Xw ($25 in chips) 
Seat 5: zgi+EUykT/pZQpoUG6+oEg ($5.75 in chips) 
Seat 6: V6p0jQ/RhUsqpHLmXvEX4Q ($11.90 in chips) 
Seat 7: uetHVityNsFnyX2bBnKe2A ($18.35 in chips) 
Seat 8: K0b5wNInj6hUGRr6yzKFtw ($27.45 in chips) 
Seat 9: wGigCmBR/9XWkPpvYos3aQ ($34.25 in chips) 
zgi+EUykT/pZQpoUG6+oEg: posts small blind $0.10
V6p0jQ/RhUsqpHLmXvEX4Q: posts big blind $0.25
*** HOLE CARDS ***
uetHVityNsFnyX2bBnKe2A: folds 
K0b5wNInj6hUGRr6yzKFtw: folds 
wGigCmBR/9XWkPpvYos3aQ: folds 
XVEauYThJRhSTUAMxB/2ow: folds 
MG90wfSJZnOejs/KD3vlQQ: raises $0.50 to $0.75
8Cp1H3sSs8+jTTwLfeYKcw: folds 
Bb42QRQMhg5/Y0vHP8/2Xw: folds 
zgi+EUykT/pZQpoUG6+oEg: folds 
V6p0jQ/RhUsqpHLmXvEX4Q: folds 
Uncalled bet ($0.50) returned to MG90wfSJZnOejs/KD3vlQQ
MG90wfSJZnOejs/KD3vlQQ collected $0.60 from pot
MG90wfSJZnOejs/KD3vlQQ: doesn't show hand 
*** SUMMARY ***
Total pot $0.60 | Rake $0 
Seat 1: XVEauYThJRhSTUAMxB/2ow folded before Flop (didn't bet)
Seat 2: MG90wfSJZnOejs/KD3vlQQ collected ($0.60)
Seat 3: 8Cp1H3sSs8+jTTwLfeYKcw folded before Flop (didn't bet)
Seat 4: Bb42QRQMhg5/Y0vHP8/2Xw (button) folded before Flop (didn't bet)
Seat 5: zgi+EUykT/pZQpoUG6+oEg (small blind) folded before Flop
Seat 6: V6p0jQ/RhUsqpHLmXvEX4Q (big blind) folded before Flop
Seat 7: uetHVityNsFnyX2bBnKe2A folded before Flop (didn't bet)
Seat 8: K0b5wNInj6hUGRr6yzKFtw folded before Flop (didn't bet)
Seat 9: wGigCmBR/9XWkPpvYos3aQ folded before Flop (didn't bet)




PokerStars Game #59941878316:  Hold'em No Limit ($0.10/$0.25) - 2009/07/01 1:49:02 ET
Table 'gnrUwXkIPE0C8xl6cB4Hyw' 9-max Seat #7 is the button
Seat 1: EQXHDnIzAsORnIXRNtXRlA ($22.95 in chips) 
Seat 2: 7je+LC5Mfs6nL8YBVh4frQ ($5 in chips) 
Seat 3: PdIasPkzm2sqZnN41ZRXOg ($5 in chips) 
Seat 4: wGigCmBR/9XWkPpvYos3aQ ($25 in chips) 
Seat 5: gehe91e0IyVT0QU/XBkEyg ($31.55 in chips) 
Seat 6: dtZ84flFEi4Q+SGrHMJRDQ ($25.80 in chips) 
Seat 7: OXPkK84/qv92EMwXPiG5rQ ($9.60 in chips) 
Seat 8: 4awUyiDYTgylQKXZ9faBVA ($60.40 in chips) 
Seat 9: F7pnn6czNpHvRM55XcA2EA ($25.50 in chips) 
4awUyiDYTgylQKXZ9faBVA: posts small blind $0.10
F7pnn6czNpHvRM55XcA2EA: posts big blind $0.25
*** HOLE CARDS ***
EQXHDnIzAsORnIXRNtXRlA: folds 
7je+LC5Mfs6nL8YBVh4frQ: folds 
PdIasPkzm2sqZnN41ZRXOg: folds 
wGigCmBR/9XWkPpvYos3aQ: folds 
gehe91e0IyVT0QU/XBkEyg: folds 
dtZ84flFEi4Q+SGrHMJRDQ: folds 
OXPkK84/qv92EMwXPiG5rQ: calls $0.25
4awUyiDYTgylQKXZ9faBVA: folds 
F7pnn6czNpHvRM55XcA2EA: raises $0.75 to $1
OXPkK84/qv92EMwXPiG5rQ: calls $0.75
*** FLOP *** [9d 6s 4d]
F7pnn6czNpHvRM55XcA2EA: checks 
OXPkK84/qv92EMwXPiG5rQ: bets $1
F7pnn6czNpHvRM55XcA2EA: raises $2 to $3
OXPkK84/qv92EMwXPiG5rQ: calls $2
*** TURN *** [9d 6s 4d] [9c]
F7pnn6czNpHvRM55XcA2EA: bets $5.75
OXPkK84/qv92EMwXPiG5rQ: calls $5.60 and is all-in
Uncalled bet ($0.15) returned to F7pnn6czNpHvRM55XcA2EA
*** RIVER *** [9d 6s 4d 9c] [2h]
*** SHOW DOWN ***
F7pnn6czNpHvRM55XcA2EA: shows [Kh Ks] (two pair, Kings and Nines)
OXPkK84/qv92EMwXPiG5rQ: shows [Qh 9h] (three of a kind, Nines)
OXPkK84/qv92EMwXPiG5rQ collected $18.40 from pot
*** SUMMARY ***
Total pot $19.30 | Rake $0.90 
Board [9d 6s 4d 9c 2h]
Seat 1: EQXHDnIzAsORnIXRNtXRlA folded before Flop (didn't bet)
Seat 2: 7je+LC5Mfs6nL8YBVh4frQ folded before Flop (didn't bet)
Seat 3: PdIasPkzm2sqZnN41ZRXOg folded before Flop (didn't bet)
Seat 4: wGigCmBR/9XWkPpvYos3aQ folded before Flop (didn't bet)
Seat 5: gehe91e0IyVT0QU/XBkEyg folded before Flop (didn't bet)
Seat 6: dtZ84flFEi4Q+SGrHMJRDQ folded before Flop (didn't bet)
Seat 7: OXPkK84/qv92EMwXPiG5rQ (button) showed [Qh 9h] and won ($18.40) with three of a kind, Nines
Seat 8: 4awUyiDYTgylQKXZ9faBVA (small blind) folded before Flop
Seat 9: F7pnn6czNpHvRM55XcA2EA (big blind) showed [Kh Ks] and lost with two pair, Kings and Nines




PokerStars Game #59941878280:  Hold'em No Limit ($0.10/$0.25) - 2009/07/01 1:49:02 ET
Table '+68ihX5Br1xgGorX6zsCBg' 9-max Seat #4 is the button
Seat 1: IFB2mhulUVYIbb+KWwDC9w ($4.55 in chips) 
Seat 2: TeAfhXG1R60d8yPEHN3JiA ($27.65 in chips) 
Seat 3: PdIasPkzm2sqZnN41ZRXOg ($5 in chips) 
Seat 4: Oi0EiPIjriUb/6zT65YeWA ($26.95 in chips) 
Seat 5: ghNKXUBl/H+t83JF079ZBA ($28.75 in chips) 
Seat 6: X78b5v/uhqeXXoAijbw/yg ($26.40 in chips) 
Seat 7: V6p0jQ/RhUsqpHLmXvEX4Q ($16.45 in chips) 
Seat 9: DiSvPC2iudwL5j9u6Huyww ($32.75 in chips) 
ghNKXUBl/H+t83JF079ZBA: posts small blind $0.10
X78b5v/uhqeXXoAijbw/yg: posts big blind $0.25
*** HOLE CARDS ***
V6p0jQ/RhUsqpHLmXvEX4Q: folds 
DiSvPC2iudwL5j9u6Huyww: folds 
IFB2mhulUVYIbb+KWwDC9w: folds 
TeAfhXG1R60d8yPEHN3JiA: folds 
PdIasPkzm2sqZnN41ZRXOg: folds 
Oi0EiPIjriUb/6zT65YeWA: raises $0.50 to $0.75
ghNKXUBl/H+t83JF079ZBA: folds 
X78b5v/uhqeXXoAijbw/yg: folds 
Uncalled bet ($0.50) returned to Oi0EiPIjriUb/6zT65YeWA
Oi0EiPIjriUb/6zT65YeWA collected $0.60 from pot
Oi0EiPIjriUb/6zT65YeWA: doesn't show hand 
*** SUMMARY ***
Total pot $0.60 | Rake $0 
Seat 1: IFB2mhulUVYIbb+KWwDC9w folded before Flop (didn't bet)
Seat 2: TeAfhXG1R60d8yPEHN3JiA folded before Flop (didn't bet)
Seat 3: PdIasPkzm2sqZnN41ZRXOg folded before Flop (didn't bet)
Seat 4: Oi0EiPIjriUb/6zT65YeWA (button) collected ($0.60)
Seat 5: ghNKXUBl/H+t83JF079ZBA (small blind) folded before Flop
Seat 6: X78b5v/uhqeXXoAijbw/yg (big blind) folded before Flop
Seat 7: V6p0jQ/RhUsqpHLmXvEX4Q folded before Flop (didn't bet)
Seat 9: DiSvPC2iudwL5j9u6Huyww folded before Flop (didn't bet)




PokerStars Game #59941878318:  Hold'em No Limit ($0.10/$0.25) - 2009/07/01 1:49:02 ET
Table '63h13e5p7cWe02rClZ1CHw' 6-max Seat #4 is the button
Seat 1: pokjbbEcXXPlADXdSGHtZw ($21.70 in chips) 
Seat 2: k9nHZTHt8hYhYRcW8NTb4g ($24.60 in chips) 
Seat 3: mFv3iBCtrw9XfCDRB0d46Q ($4.30 in chips) 
Seat 4: xrf8tAXKQHG99HixCot1Iw ($28 in chips) 
Seat 5: iyZxqznXjv3vtvOJymkoLQ ($44.20 in chips) 
Seat 6: mfrkWA3PTeYPkbO6hi98Aw ($39.05 in chips) 
iyZxqznXjv3vtvOJymkoLQ: posts small blind $0.10
mfrkWA3PTeYPkbO6hi98Aw: posts big blind $0.25
*** HOLE CARDS ***
pokjbbEcXXPlADXdSGHtZw: folds 
k9nHZTHt8hYhYRcW8NTb4g: raises $0.50 to $0.75
mFv3iBCtrw9XfCDRB0d46Q: folds 
xrf8tAXKQHG99HixCot1Iw: folds 
iyZxqznXjv3vtvOJymkoLQ: folds 
mfrkWA3PTeYPkbO6hi98Aw: folds 
Uncalled bet ($0.50) returned to k9nHZTHt8hYhYRcW8NTb4g
k9nHZTHt8hYhYRcW8NTb4g collected $0.60 from pot
k9nHZTHt8hYhYRcW8NTb4g: doesn't show hand 
*** SUMMARY ***
Total pot $0.60 | Rake $0 
Seat 1: pokjbbEcXXPlADXdSGHtZw folded before Flop (didn't bet)
Seat 2: k9nHZTHt8hYhYRcW8NTb4g collected ($0.60)
Seat 3: mFv3iBCtrw9XfCDRB0d46Q folded before Flop (didn't bet)
Seat 4: xrf8tAXKQHG99HixCot1Iw (button) folded before Flop (didn't bet)
Seat 5: iyZxqznXjv3vtvOJymkoLQ (small blind) folded before Flop
Seat 6: mfrkWA3PTeYPkbO6hi98Aw (big blind) folded before Flop




PokerStars Game #59941878186:  Hold'em No Limit ($0.10/$0.25) - 2009/07/01 1:49:02 ET
Table '9L7XfAwuM7XsXE8LIg2o5Q' 6-max Seat #5 is the button
Seat 1: dOIoLBxmpLHSXBN9LZnf0Q ($25.10 in chips) 
Seat 2: LJI7A1YgDM7hgh7o56+ReQ ($27.30 in chips) 
Seat 3: mFv3iBCtrw9XfCDRB0d46Q ($4.30 in chips) 
Seat 4: jp34e617tIzV8tKIWmfAbA ($38.45 in chips) 
Seat 5: zsU1ijOyYEi+40wBKPEbmw ($21.90 in chips) 
Seat 6: k9nHZTHt8hYhYRcW8NTb4g ($21.35 in chips) 
k9nHZTHt8hYhYRcW8NTb4g: posts small blind $0.10
dOIoLBxmpLHSXBN9LZnf0Q: posts big blind $0.25
*** HOLE CARDS ***
LJI7A1YgDM7hgh7o56+ReQ: folds 
mFv3iBCtrw9XfCDRB0d46Q: folds 
jp34e617tIzV8tKIWmfAbA: folds 
zsU1ijOyYEi+40wBKPEbmw: folds 
k9nHZTHt8hYhYRcW8NTb4g: raises $0.50 to $0.75
dOIoLBxmpLHSXBN9LZnf0Q: calls $0.50
*** FLOP *** [8c Jd 9d]
k9nHZTHt8hYhYRcW8NTb4g: bets $0.75
dOIoLBxmpLHSXBN9LZnf0Q: calls $0.75
*** TURN *** [8c Jd 9d] [7h]
k9nHZTHt8hYhYRcW8NTb4g: checks 
dOIoLBxmpLHSXBN9LZnf0Q: bets $1
k9nHZTHt8hYhYRcW8NTb4g: calls $1
*** RIVER *** [8c Jd 9d 7h] [7d]
k9nHZTHt8hYhYRcW8NTb4g: checks 
dOIoLBxmpLHSXBN9LZnf0Q: checks 
*** SHOW DOWN ***
k9nHZTHt8hYhYRcW8NTb4g: shows [Kd Qh] (a pair of Sevens)
dOIoLBxmpLHSXBN9LZnf0Q: shows [Jh 3h] (two pair, Jacks and Sevens)
dOIoLBxmpLHSXBN9LZnf0Q collected $4.80 from pot
zsU1ijOyYEi+40wBKPEbmw leaves the table
*** SUMMARY ***
Total pot $5 | Rake $0.20 
Board [8c Jd 9d 7h 7d]
Seat 1: dOIoLBxmpLHSXBN9LZnf0Q (big blind) showed [Jh 3h] and won ($4.80) with two pair, Jacks and Sevens
Seat 2: LJI7A1YgDM7hgh7o56+ReQ folded before Flop (didn't bet)
Seat 3: mFv3iBCtrw9XfCDRB0d46Q folded before Flop (didn't bet)
Seat 4: jp34e617tIzV8tKIWmfAbA folded before Flop (didn't bet)
Seat 5: zsU1ijOyYEi+40wBKPEbmw (button) folded before Flop (didn't bet)
Seat 6: k9nHZTHt8hYhYRcW8NTb4g (small blind) showed [Kd Qh] and lost with a pair of Sevens




PokerStars Game #59941878364:  Hold'em No Limit ($0.10/$0.25) - 2009/07/01 1:49:02 ET
Table '3Ns9nuTkynfwbBfBXzg6ww' 6-max Seat #6 is the button
Seat 1: epAUIB7h2FJXzUPRIvSkRA ($25.45 in chips) 
Seat 2: zxeVQGaMKDsDzmSY+AInjA ($31.75 in chips) 
Seat 3: eL3+wCBjFGfQ5FMdIZihwA ($23.95 in chips) 
Seat 4: qGHGf/553gQnDoklMRe3tg ($30.85 in chips) 
Seat 5: wqphQtauX5Qn7WRJZS1flA ($24.05 in chips) 
Seat 6: DE9hRlt14g+JdsRQ4wT7hg ($38.75 in chips) 
epAUIB7h2FJXzUPRIvSkRA: posts small blind $0.10
zxeVQGaMKDsDzmSY+AInjA: posts big blind $0.25
*** HOLE CARDS ***
eL3+wCBjFGfQ5FMdIZihwA: folds 
qGHGf/553gQnDoklMRe3tg: folds 
wqphQtauX5Qn7WRJZS1flA: folds 
DE9hRlt14g+JdsRQ4wT7hg: folds 
epAUIB7h2FJXzUPRIvSkRA: raises $0.75 to $1
zxeVQGaMKDsDzmSY+AInjA: folds 
Uncalled bet ($0.75) returned to epAUIB7h2FJXzUPRIvSkRA
epAUIB7h2FJXzUPRIvSkRA collected $0.50 from pot
epAUIB7h2FJXzUPRIvSkRA: doesn't show hand 
*** SUMMARY ***
Total pot $0.50 | Rake $0 
Seat 1: epAUIB7h2FJXzUPRIvSkRA (small blind) collected ($0.50)
Seat 2: zxeVQGaMKDsDzmSY+AInjA (big blind) folded before Flop
Seat 3: eL3+wCBjFGfQ5FMdIZihwA folded before Flop (didn't bet)
Seat 4: qGHGf/553gQnDoklMRe3tg folded before Flop (didn't bet)
Seat 5: wqphQtauX5Qn7WRJZS1flA folded before Flop (didn't bet)
Seat 6: DE9hRlt14g+JdsRQ4wT7hg (button) folded before Flop (didn't bet)




PokerStars Game #59941878258:  Hold'em No Limit ($0.10/$0.25) - 2009/07/01 1:49:02 ET
Table 'm+FQg/QP0VP1ZA3V62WtOg' 9-max Seat #8 is the button
Seat 1: qwr38jl5txoR36M7G5qi4A ($10 in chips) 
Seat 3: +KblIivb6tainScpwm14RQ ($6.50 in chips) 
Seat 5: wf5j8xvJtko6ZXyCbzzlVQ ($8.65 in chips) 
Seat 6: CT7Xj/V/O5rBlhtt+RZeFQ ($38.60 in chips) 
Seat 7: TPAF9YkMsjQFq978RNWZEQ ($26.80 in chips) 
Seat 8: E0iYnEVO2ho7dH3QcCjw7g ($19.65 in chips) 
Seat 9: zUXhymECc2C9W9ZNw6qppA ($13.55 in chips) 
zUXhymECc2C9W9ZNw6qppA: posts small blind $0.10
qwr38jl5txoR36M7G5qi4A: posts big blind $0.25
yqkowiRWZ6NvRN9UUkYIlA: sits out 
dubÃ©705: sits out 
*** HOLE CARDS ***
+KblIivb6tainScpwm14RQ: folds 
wf5j8xvJtko6ZXyCbzzlVQ: raises $0.25 to $0.50
CT7Xj/V/O5rBlhtt+RZeFQ: folds 
TPAF9YkMsjQFq978RNWZEQ: calls $0.50
E0iYnEVO2ho7dH3QcCjw7g: folds 
zUXhymECc2C9W9ZNw6qppA: folds 
qwr38jl5txoR36M7G5qi4A: folds 
*** FLOP *** [2c 2d Ac]
wf5j8xvJtko6ZXyCbzzlVQ: bets $0.25
TPAF9YkMsjQFq978RNWZEQ: folds 
Uncalled bet ($0.25) returned to wf5j8xvJtko6ZXyCbzzlVQ
wf5j8xvJtko6ZXyCbzzlVQ collected $1.30 from pot
*** SUMMARY ***
Total pot $1.35 | Rake $0.05 
Board [2c 2d Ac]
Seat 1: qwr38jl5txoR36M7G5qi4A (big blind) folded before Flop
Seat 3: +KblIivb6tainScpwm14RQ folded before Flop (didn't bet)
Seat 5: wf5j8xvJtko6ZXyCbzzlVQ collected ($1.30)
Seat 6: CT7Xj/V/O5rBlhtt+RZeFQ folded before Flop (didn't bet)
Seat 7: TPAF9YkMsjQFq978RNWZEQ folded on the Flop
Seat 8: E0iYnEVO2ho7dH3QcCjw7g (button) folded before Flop (didn't bet)
Seat 9: zUXhymECc2C9W9ZNw6qppA (small blind) folded before Flop




PokerStars Game #59941878192:  Hold'em No Limit ($0.10/$0.25) - 2009/07/01 1:49:02 ET
Table 'JPFXJXa5xBkjZ/W15BKqeQ' 9-max Seat #7 is the button
Seat 2: XMSS6mD5B42I8wasdOMipQ ($13.10 in chips) 
Seat 3: 56S3mA6Zs3pGR+0p0vUCtg ($19.20 in chips) 
Seat 4: wGigCmBR/9XWkPpvYos3aQ ($32.30 in chips) 
Seat 5: cZ99hugmLBj9KhTlc8nCSw ($25.60 in chips) 
Seat 6: tLcDklc2rBORNfixyRfVfw ($25 in chips) 
Seat 7: PdIasPkzm2sqZnN41ZRXOg ($4.65 in chips) 
Seat 9: V6p0jQ/RhUsqpHLmXvEX4Q ($12.35 in chips) 
V6p0jQ/RhUsqpHLmXvEX4Q: posts small blind $0.10
acerpok: is sitting out 
XMSS6mD5B42I8wasdOMipQ: posts big blind $0.25
*** HOLE CARDS ***
56S3mA6Zs3pGR+0p0vUCtg: folds 
wGigCmBR/9XWkPpvYos3aQ: folds 
cZ99hugmLBj9KhTlc8nCSw: folds 
tLcDklc2rBORNfixyRfVfw: folds 
PdIasPkzm2sqZnN41ZRXOg: raises $1 to $1.25
V6p0jQ/RhUsqpHLmXvEX4Q: folds 
XMSS6mD5B42I8wasdOMipQ: folds 
Uncalled bet ($1) returned to PdIasPkzm2sqZnN41ZRXOg
PdIasPkzm2sqZnN41ZRXOg collected $0.60 from pot
PdIasPkzm2sqZnN41ZRXOg: doesn't show hand 
acerpok leaves the table
*** SUMMARY ***
Total pot $0.60 | Rake $0 
Seat 2: XMSS6mD5B42I8wasdOMipQ (big blind) folded before Flop
Seat 3: 56S3mA6Zs3pGR+0p0vUCtg folded before Flop (didn't bet)
Seat 4: wGigCmBR/9XWkPpvYos3aQ folded before Flop (didn't bet)
Seat 5: cZ99hugmLBj9KhTlc8nCSw folded before Flop (didn't bet)
Seat 6: tLcDklc2rBORNfixyRfVfw folded before Flop (didn't bet)
Seat 7: PdIasPkzm2sqZnN41ZRXOg (button) collected ($0.60)
Seat 9: V6p0jQ/RhUsqpHLmXvEX4Q (small blind) folded before Flop




PokerStars Game #59941879030:  Hold'em No Limit ($0.10/$0.25) - 2009/07/01 1:49:03 ET
Table 'M8kYidAX3ib7pLKW7edFLw' 6-max Seat #5 is the button
Seat 1: jp34e617tIzV8tKIWmfAbA ($25 in chips) 
Seat 2: ypmjhffk/YHGc51wgVXUTw ($25 in chips) 
Seat 3: cezpHJ8FB07dj0xG+LhOvw ($26.15 in chips) 
Seat 4: Hsvkc0/G2VV78oVmWYXecw ($6.25 in chips) 
Seat 5: bDKopKTvPi3W+PEnYUX3tg ($47.50 in chips) 
Seat 6: NqFoyDgzLwu4dOmSRXnFBA ($25 in chips) 
NqFoyDgzLwu4dOmSRXnFBA: posts small blind $0.10
jp34e617tIzV8tKIWmfAbA: posts big blind $0.25
*** HOLE CARDS ***
ypmjhffk/YHGc51wgVXUTw: folds 
cezpHJ8FB07dj0xG+LhOvw: folds 
Hsvkc0/G2VV78oVmWYXecw: folds 
bDKopKTvPi3W+PEnYUX3tg: folds 
NqFoyDgzLwu4dOmSRXnFBA: raises $0.75 to $1
jp34e617tIzV8tKIWmfAbA: calls $0.75
*** FLOP *** [2c 4d 3h]
NqFoyDgzLwu4dOmSRXnFBA: checks 
jp34e617tIzV8tKIWmfAbA: checks 
*** TURN *** [2c 4d 3h] [7d]
NqFoyDgzLwu4dOmSRXnFBA: checks 
jp34e617tIzV8tKIWmfAbA: checks 
*** RIVER *** [2c 4d 3h 7d] [Ks]
NqFoyDgzLwu4dOmSRXnFBA: bets $0.50
jp34e617tIzV8tKIWmfAbA: calls $0.50
*** SHOW DOWN ***
NqFoyDgzLwu4dOmSRXnFBA: shows [Td Qh] (high card King)
jp34e617tIzV8tKIWmfAbA: shows [Qd Ah] (high card Ace)
jp34e617tIzV8tKIWmfAbA collected $2.90 from pot
bDKopKTvPi3W+PEnYUX3tg leaves the table
*** SUMMARY ***
Total pot $3 | Rake $0.10 
Board [2c 4d 3h 7d Ks]
Seat 1: jp34e617tIzV8tKIWmfAbA (big blind) showed [Qd Ah] and won ($2.90) with high card Ace
Seat 2: ypmjhffk/YHGc51wgVXUTw folded before Flop (didn't bet)
Seat 3: cezpHJ8FB07dj0xG+LhOvw folded before Flop (didn't bet)
Seat 4: Hsvkc0/G2VV78oVmWYXecw folded before Flop (didn't bet)
Seat 5: bDKopKTvPi3W+PEnYUX3tg (button) folded before Flop (didn't bet)
Seat 6: NqFoyDgzLwu4dOmSRXnFBA (small blind) showed [Td Qh] and lost with high card King




PokerStars Game #59941878946:  Hold'em No Limit ($0.10/$0.25) - 2009/07/01 1:49:03 ET
Table 'MiquQrQZJJq9ZtgRIp9HFQ' 6-max Seat #1 is the button
Seat 1: c3J/KYZ4cNsUEuz8v57I5A ($24.65 in chips) 
Seat 2: 2+6voGl1T1DO63JePptI3g ($25.55 in chips) 
Seat 3: 9h7TNZ1TDGRUJXA6rI+ZTw ($9.75 in chips) 
Seat 4: wAKC8C/zN0c8V5v13dm9mA ($51.20 in chips) 
Seat 5: iyZxqznXjv3vtvOJymkoLQ ($26.75 in chips) 
Seat 6: GbCVUNssQ7mqsPWr7J4d3w ($4.65 in chips) 
2+6voGl1T1DO63JePptI3g: posts small blind $0.10
9h7TNZ1TDGRUJXA6rI+ZTw: posts big blind $0.25
*** HOLE CARDS ***
wAKC8C/zN0c8V5v13dm9mA: folds 
iyZxqznXjv3vtvOJymkoLQ: folds 
GbCVUNssQ7mqsPWr7J4d3w: folds 
c3J/KYZ4cNsUEuz8v57I5A: folds 
2+6voGl1T1DO63JePptI3g: folds 
Uncalled bet ($0.15) returned to 9h7TNZ1TDGRUJXA6rI+ZTw
9h7TNZ1TDGRUJXA6rI+ZTw collected $0.20 from pot
*** SUMMARY ***
Total pot $0.20 | Rake $0 
Seat 1: c3J/KYZ4cNsUEuz8v57I5A (button) folded before Flop (didn't bet)
Seat 2: 2+6voGl1T1DO63JePptI3g (small blind) folded before Flop
Seat 3: 9h7TNZ1TDGRUJXA6rI+ZTw (big blind) collected ($0.20)
Seat 4: wAKC8C/zN0c8V5v13dm9mA folded before Flop (didn't bet)
Seat 5: iyZxqznXjv3vtvOJymkoLQ folded before Flop (didn't bet)
Seat 6: GbCVUNssQ7mqsPWr7J4d3w folded before Flop (didn't bet)




PokerStars Game #59941879498:  Hold'em No Limit ($0.10/$0.25) - 2009/07/01 1:49:04 ET
Table '0XPo7K54oZIfG0xlNAcDRwnQC9LRg01NEuKFHF1nrDEw-max Seat #4 is the button
Seat 1: qf+LMbROj8/qY878wkFHbQ ($12.30 in chips) 
Seat 2: ZhV6dUX9NQhT4zf7t+ZLJg ($23.95 in chips) 
Seat 3: 6+g0Lb6vfRDZkElV8ieHyQ ($26.10 in chips) 
Seat 4: u3Ol7kv1LmvszuHNm9rc6w ($24.65 in chips) 
Seat 5: kG34n23qFQA3nzdOJTQ1dA ($28.20 in chips) 
Seat 6: xQVFeVUDopz+akuEo2wXpQ ($55.65 in chips) 
kG34n23qFQA3nzdOJTQ1dA: posts small blind $0.10
xQVFeVUDopz+akuEo2wXpQ: posts big blind $0.25
*** HOLE CARDS ***
qf+LMbROj8/qY878wkFHbQ: calls $0.25
ZhV6dUX9NQhT4zf7t+ZLJg: folds 
6+g0Lb6vfRDZkElV8ieHyQ: folds 
u3Ol7kv1LmvszuHNm9rc6w: folds 
kG34n23qFQA3nzdOJTQ1dA: calls $0.15
xQVFeVUDopz+akuEo2wXpQ: checks 
*** FLOP *** [3d 5d Td]
kG34n23qFQA3nzdOJTQ1dA: checks 
xQVFeVUDopz+akuEo2wXpQ: checks 
qf+LMbROj8/qY878wkFHbQ: bets $0.75
kG34n23qFQA3nzdOJTQ1dA: folds 
xQVFeVUDopz+akuEo2wXpQ: folds 
Uncalled bet ($0.75) returned to qf+LMbROj8/qY878wkFHbQ
qf+LMbROj8/qY878wkFHbQ collected $0.75 from pot
qf+LMbROj8/qY878wkFHbQ: doesn't show hand 
*** SUMMARY ***
Total pot $0.75 | Rake $0 
Board [3d 5d Td]
Seat 1: qf+LMbROj8/qY878wkFHbQ collected ($0.75)
Seat 2: ZhV6dUX9NQhT4zf7t+ZLJg folded before Flop (didn't bet)
Seat 3: 6+g0Lb6vfRDZkElV8ieHyQ folded before Flop (didn't bet)
Seat 4: u3Ol7kv1LmvszuHNm9rc6w (button) folded before Flop (didn't bet)
Seat 5: kG34n23qFQA3nzdOJTQ1dA (small blind) folded on the Flop
Seat 6: xQVFeVUDopz+akuEo2wXpQ (big blind) folded on the Flop




PokerStars Game #59941879312:  Hold'em No Limit ($0.10/$0.25) - 2009/07/01 1:49:04 ET
Table 'nlpa8xI95gAflovnFxB2yg' 6-max Seat #1 is the button
Seat 1: fZQg9veL7Dd/Z04ZTjC+wQ ($61.45 in chips) 
Seat 2: Yuyy/pDz3yAO3EbHYRYnKw ($23.90 in chips) 
Seat 3: DihMHaz4WNETH1bPDe13kA ($25 in chips) 
Seat 4: if4dh6jhJXeN3/qd3qCp9g ($52.35 in chips) 
Seat 5: FDWzjQgBA5K04jOIY/j22w ($7.10 in chips) 
Seat 6: ATNFxN8fYVfSZMQW8dvbvw ($5.25 in chips) 
Yuyy/pDz3yAO3EbHYRYnKw: posts small blind $0.10
DihMHaz4WNETH1bPDe13kA: posts big blind $0.25
*** HOLE CARDS ***
if4dh6jhJXeN3/qd3qCp9g: folds 
FDWzjQgBA5K04jOIY/j22w: raises $0.50 to $0.75
ATNFxN8fYVfSZMQW8dvbvw: folds 
fZQg9veL7Dd/Z04ZTjC+wQ: folds 
Yuyy/pDz3yAO3EbHYRYnKw: folds 
DihMHaz4WNETH1bPDe13kA: folds 
Uncalled bet ($0.50) returned to FDWzjQgBA5K04jOIY/j22w
FDWzjQgBA5K04jOIY/j22w collected $0.60 from pot
FDWzjQgBA5K04jOIY/j22w: doesn't show hand 
*** SUMMARY ***
Total pot $0.60 | Rake $0 
Seat 1: fZQg9veL7Dd/Z04ZTjC+wQ (button) folded before Flop (didn't bet)
Seat 2: Yuyy/pDz3yAO3EbHYRYnKw (small blind) folded before Flop
Seat 3: DihMHaz4WNETH1bPDe13kA (big blind) folded before Flop
Seat 4: if4dh6jhJXeN3/qd3qCp9g folded before Flop (didn't bet)
Seat 5: FDWzjQgBA5K04jOIY/j22w collected ($0.60)
Seat 6: ATNFxN8fYVfSZMQW8dvbvw folded before Flop (didn't bet)




PokerStars Game #59941879582:  Hold'em No Limit ($0.10/$0.25) - 2009/07/01 1:49:04 ET
Table 'vFZR6Kf2Th5xBXT9brGW6A' 6-max Seat #2 is the button
Seat 1: Q1uciOZPBR/WkAlqa6cL4A ($25 in chips) 
Seat 2: QiL+lEgEWwy21jk/ltaRLg ($20.80 in chips) 
Seat 3: SH1WjKVUjPiyXySjWSdazw ($41.40 in chips) 
Seat 4: 79ID/ub1Pt/mDpCprVmOoA ($34.85 in chips) 
Seat 5: SS/yfeArhULzIcOPe8MdPg ($27.35 in chips) 
Seat 6: 4x9jCqgSw4272dnaIqnanw ($10.55 in chips) 
SH1WjKVUjPiyXySjWSdazw: posts small blind $0.10
79ID/ub1Pt/mDpCprVmOoA: posts big blind $0.25
*** HOLE CARDS ***
SS/yfeArhULzIcOPe8MdPg: folds 
4x9jCqgSw4272dnaIqnanw: folds 
Q1uciOZPBR/WkAlqa6cL4A: folds 
QiL+lEgEWwy21jk/ltaRLg: folds 
SH1WjKVUjPiyXySjWSdazw: folds 
Uncalled bet ($0.15) returned to 79ID/ub1Pt/mDpCprVmOoA
79ID/ub1Pt/mDpCprVmOoA collected $0.20 from pot
79ID/ub1Pt/mDpCprVmOoA: doesn't show hand 
*** SUMMARY ***
Total pot $0.20 | Rake $0 
Seat 1: Q1uciOZPBR/WkAlqa6cL4A folded before Flop (didn't bet)
Seat 2: QiL+lEgEWwy21jk/ltaRLg (button) folded before Flop (didn't bet)
Seat 3: SH1WjKVUjPiyXySjWSdazw (small blind) folded before Flop
Seat 4: 79ID/ub1Pt/mDpCprVmOoA (big blind) collected ($0.20)
Seat 5: SS/yfeArhULzIcOPe8MdPg folded before Flop (didn't bet)
Seat 6: 4x9jCqgSw4272dnaIqnanw folded before Flop (didn't bet)




PokerStars Game #59941879666:  Hold'em No Limit ($0.10/$0.25) - 2009/07/01 1:49:04 ET
Table 'Qr+t8WGovMECkBv+cV1lrg' 6-max Seat #6 is the button
Seat 1: EeUZtMU058v2ObUACOF4Og ($44.50 in chips) 
Seat 2: vqWjZmdQu/Hxw96/IJTWdQ ($41.60 in chips) 
Seat 3: uZKkrGByYgd4/ZBX2d4z+w ($10.90 in chips) 
Seat 4: 1NNFfYMd5Hsphl/FYz9fNA ($60.15 in chips) 
Seat 5: I50OxuNg9riRq9sywF6jMQ ($5 in chips) 
Seat 6: 9U3ZKjCsarN0DjR6mSE8Ug ($14.35 in chips) 
EeUZtMU058v2ObUACOF4Og: posts small blind $0.10
vqWjZmdQu/Hxw96/IJTWdQ: posts big blind $0.25
I50OxuNg9riRq9sywF6jMQ: posts big blind $0.25
*** HOLE CARDS ***
uZKkrGByYgd4/ZBX2d4z+w: folds 
1NNFfYMd5Hsphl/FYz9fNA: folds 
I50OxuNg9riRq9sywF6jMQ: checks 
9U3ZKjCsarN0DjR6mSE8Ug: folds 
EeUZtMU058v2ObUACOF4Og: calls $0.15
vqWjZmdQu/Hxw96/IJTWdQ: checks 
*** FLOP *** [5s 8c 9h]
EeUZtMU058v2ObUACOF4Og: bets $0.75
vqWjZmdQu/Hxw96/IJTWdQ: folds 
I50OxuNg9riRq9sywF6jMQ: folds 
Uncalled bet ($0.75) returned to EeUZtMU058v2ObUACOF4Og
EeUZtMU058v2ObUACOF4Og collected $0.75 from pot
EeUZtMU058v2ObUACOF4Og: doesn't show hand 
*** SUMMARY ***
Total pot $0.75 | Rake $0 
Board [5s 8c 9h]
Seat 1: EeUZtMU058v2ObUACOF4Og (small blind) collected ($0.75)
Seat 2: vqWjZmdQu/Hxw96/IJTWdQ (big blind) folded on the Flop
Seat 3: uZKkrGByYgd4/ZBX2d4z+w folded before Flop (didn't bet)
Seat 4: 1NNFfYMd5Hsphl/FYz9fNA folded before Flop (didn't bet)
Seat 5: I50OxuNg9riRq9sywF6jMQ folded on the Flop
Seat 6: 9U3ZKjCsarN0DjR6mSE8Ug (button) folded before Flop (didn't bet)




PokerStars Game #59941879614:  Hold'em No Limit ($0.10/$0.25) - 2009/07/01 1:49:04 ET
Table 'b64Z+5XI1xkQzNfq4QHr3A' 6-max Seat #5 is the button
Seat 2: A6SjYLoKeIpFjPq0BK/2WA ($10.35 in chips) 
Seat 3: 7cx44/slbeTw+Cy7QB8Trg ($24.75 in chips) 
Seat 4: 564zqq2DUHXR3tdsOJU6JA ($19.90 in chips) 
Seat 5: JFIAqU8lCZ0vWwEl4bdGsg ($57.75 in chips) 
Seat 6: 8ClCHtFXGNplITm+63KB+Q ($32.75 in chips) 
8ClCHtFXGNplITm+63KB+Q: posts small blind $0.10
A6SjYLoKeIpFjPq0BK/2WA: posts big blind $0.25
*** HOLE CARDS ***
7cx44/slbeTw+Cy7QB8Trg: folds 
564zqq2DUHXR3tdsOJU6JA: calls $0.25
JFIAqU8lCZ0vWwEl4bdGsg: folds 
8ClCHtFXGNplITm+63KB+Q: raises $1 to $1.25
A6SjYLoKeIpFjPq0BK/2WA: calls $1
564zqq2DUHXR3tdsOJU6JA: calls $1
*** FLOP *** [9c Kh Qh]
8ClCHtFXGNplITm+63KB+Q: checks 
A6SjYLoKeIpFjPq0BK/2WA: checks 
564zqq2DUHXR3tdsOJU6JA: checks 
*** TURN *** [9c Kh Qh] [Ad]
8ClCHtFXGNplITm+63KB+Q: checks 
A6SjYLoKeIpFjPq0BK/2WA: checks 
564zqq2DUHXR3tdsOJU6JA: checks 
*** RIVER *** [9c Kh Qh Ad] [As]
8ClCHtFXGNplITm+63KB+Q: checks 
A6SjYLoKeIpFjPq0BK/2WA: bets $1.75
564zqq2DUHXR3tdsOJU6JA: calls $1.75
8ClCHtFXGNplITm+63KB+Q: folds 
*** SHOW DOWN ***
A6SjYLoKeIpFjPq0BK/2WA: shows [7h Ah] (three of a kind, Aces)
564zqq2DUHXR3tdsOJU6JA: mucks hand 
A6SjYLoKeIpFjPq0BK/2WA collected $6.90 from pot
A6SjYLoKeIpFjPq0BK/2WA said, "donkey"
*** SUMMARY ***
Total pot $7.25 | Rake $0.35 
Board [9c Kh Qh Ad As]
Seat 2: A6SjYLoKeIpFjPq0BK/2WA (big blind) showed [7h Ah] and won ($6.90) with three of a kind, Aces
Seat 3: 7cx44/slbeTw+Cy7QB8Trg folded before Flop (didn't bet)
Seat 4: 564zqq2DUHXR3tdsOJU6JA mucked
Seat 5: JFIAqU8lCZ0vWwEl4bdGsg (button) folded before Flop (didn't bet)
Seat 6: 8ClCHtFXGNplITm+63KB+Q (small blind) folded on the River




PokerStars Game #59941879384:  Hold'em No Limit ($0.10/$0.25) - 2009/07/01 1:49:04 ET
Table 'sm5gqEvXgLbkkE4dryW/5g' 6-max Seat #3 is the button
Seat 1: v8m8XHovI5tqEA9mvplDSw ($39.85 in chips) 
Seat 2: 5xs5/u2z1CO9zkRvH72MQg ($20.60 in chips) 
Seat 3: UT5XpwOH1ipkOF7n1MqDJA ($18.65 in chips) 
Seat 4: cWc85bEzdRzpUMhRKm8pwQ ($25.90 in chips) 
Seat 6: aogAb4Eienxztk8p2v9VVw ($22.50 in chips) 
cWc85bEzdRzpUMhRKm8pwQ: posts small blind $0.10
aogAb4Eienxztk8p2v9VVw: posts big blind $0.25
*** HOLE CARDS ***
v8m8XHovI5tqEA9mvplDSw: folds 
5xs5/u2z1CO9zkRvH72MQg: calls $0.25
UT5XpwOH1ipkOF7n1MqDJA: calls $0.25
cWc85bEzdRzpUMhRKm8pwQ: folds 
aogAb4Eienxztk8p2v9VVw: checks 
*** FLOP *** [6c 5s Qs]
aogAb4Eienxztk8p2v9VVw: checks 
5xs5/u2z1CO9zkRvH72MQg: bets $1.35
UT5XpwOH1ipkOF7n1MqDJA: calls $1.35
aogAb4Eienxztk8p2v9VVw: folds 
*** TURN *** [6c 5s Qs] [7d]
5xs5/u2z1CO9zkRvH72MQg: bets $1
UT5XpwOH1ipkOF7n1MqDJA: raises $3 to $4
5xs5/u2z1CO9zkRvH72MQg: folds 
Uncalled bet ($3) returned to UT5XpwOH1ipkOF7n1MqDJA
UT5XpwOH1ipkOF7n1MqDJA collected $5.30 from pot
*** SUMMARY ***
Total pot $5.55 | Rake $0.25 
Board [6c 5s Qs 7d]
Seat 1: v8m8XHovI5tqEA9mvplDSw folded before Flop (didn't bet)
Seat 2: 5xs5/u2z1CO9zkRvH72MQg folded on the Turn
Seat 3: UT5XpwOH1ipkOF7n1MqDJA (button) collected ($5.30)
Seat 4: cWc85bEzdRzpUMhRKm8pwQ (small blind) folded before Flop
Seat 6: aogAb4Eienxztk8p2v9VVw (big blind) folded on the Flop




PokerStars Game #59941879292:  Hold'em No Limit ($0.10/$0.25) - 2009/07/01 1:49:04 ET
Table 'nc6OeGk/wtaWV+6N+kgnZQ' 6-max Seat #2 is the button
Seat 2: 8ClCHtFXGNplITm+63KB+Q ($37.60 in chips) 
Seat 3: y8wpMWGSX2zHZijurx21mg ($4.10 in chips) 
Seat 4: 3zD3qLXT1bEffAoWGnc7wg ($31.55 in chips) 
Seat 5: HCS0lMAAPmZE2Tl8J/SuKw ($10.20 in chips) 
y8wpMWGSX2zHZijurx21mg: posts small blind $0.10
3zD3qLXT1bEffAoWGnc7wg: posts big blind $0.25
*** HOLE CARDS ***
HCS0lMAAPmZE2Tl8J/SuKw: calls $0.25
8ClCHtFXGNplITm+63KB+Q: folds 
y8wpMWGSX2zHZijurx21mg: folds 
3zD3qLXT1bEffAoWGnc7wg: checks 
*** FLOP *** [6s 3d Th]
3zD3qLXT1bEffAoWGnc7wg: checks 
HCS0lMAAPmZE2Tl8J/SuKw: checks 
*** TURN *** [6s 3d Th] [Qd]
3zD3qLXT1bEffAoWGnc7wg: checks 
HCS0lMAAPmZE2Tl8J/SuKw: bets $0.75
3zD3qLXT1bEffAoWGnc7wg: folds 
Uncalled bet ($0.75) returned to HCS0lMAAPmZE2Tl8J/SuKw
HCS0lMAAPmZE2Tl8J/SuKw collected $0.60 from pot
*** SUMMARY ***
Total pot $0.60 | Rake $0 
Board [6s 3d Th Qd]
Seat 2: 8ClCHtFXGNplITm+63KB+Q (button) folded before Flop (didn't bet)
Seat 3: y8wpMWGSX2zHZijurx21mg (small blind) folded before Flop
Seat 4: 3zD3qLXT1bEffAoWGnc7wg (big blind) folded on the Turn
Seat 5: HCS0lMAAPmZE2Tl8J/SuKw collected ($0.60)




PokerStars Game #59941879656:  Hold'em No Limit ($0.10/$0.25) - 2009/07/01 1:49:04 ET
Table 'BabJGL6tfXQp3leBGbYe8A' 9-max Seat #7 is the button
Seat 1: qwr38jl5txoR36M7G5qi4A ($10.35 in chips) 
Seat 2: dtZ84flFEi4Q+SGrHMJRDQ ($40.50 in chips) 
Seat 3: sD+TKtt36XiiN6jqHiLwDA ($28.80 in chips) 
Seat 4: gehe91e0IyVT0QU/XBkEyg ($28.10 in chips) 
Seat 5: GrNTWMdwy+jC6Lred1eDng ($10 in chips) 
Seat 6: egvg3mTBBVzMHnJPIQiKcA ($13.90 in chips) 
Seat 7: eK8qa6EPcH2zhtbmWSvc9g ($27.50 in chips) 
Seat 8: OXPkK84/qv92EMwXPiG5rQ ($9.50 in chips) 
Seat 9: P+9ymZQ3ktpQu1bn7HIjew ($9.50 in chips) 
OXPkK84/qv92EMwXPiG5rQ: posts small blind $0.10
P+9ymZQ3ktpQu1bn7HIjew: posts big blind $0.25
*** HOLE CARDS ***
qwr38jl5txoR36M7G5qi4A: folds 
dtZ84flFEi4Q+SGrHMJRDQ: folds 
sD+TKtt36XiiN6jqHiLwDA: folds 
gehe91e0IyVT0QU/XBkEyg: calls $0.25
GrNTWMdwy+jC6Lred1eDng: folds 
egvg3mTBBVzMHnJPIQiKcA: folds 
eK8qa6EPcH2zhtbmWSvc9g: calls $0.25
OXPkK84/qv92EMwXPiG5rQ: calls $0.15
P+9ymZQ3ktpQu1bn7HIjew: checks 
*** FLOP *** [Ah Ks 6h]
OXPkK84/qv92EMwXPiG5rQ: checks 
P+9ymZQ3ktpQu1bn7HIjew: checks 
gehe91e0IyVT0QU/XBkEyg: checks 
eK8qa6EPcH2zhtbmWSvc9g: bets $0.55
OXPkK84/qv92EMwXPiG5rQ: folds 
P+9ymZQ3ktpQu1bn7HIjew: folds 
gehe91e0IyVT0QU/XBkEyg: folds 
Uncalled bet ($0.55) returned to eK8qa6EPcH2zhtbmWSvc9g
eK8qa6EPcH2zhtbmWSvc9g collected $0.95 from pot
eK8qa6EPcH2zhtbmWSvc9g: doesn't show hand 
*** SUMMARY ***
Total pot $1 | Rake $0.05 
Board [Ah Ks 6h]
Seat 1: qwr38jl5txoR36M7G5qi4A folded before Flop (didn't bet)
Seat 2: dtZ84flFEi4Q+SGrHMJRDQ folded before Flop (didn't bet)
Seat 3: sD+TKtt36XiiN6jqHiLwDA folded before Flop (didn't bet)
Seat 4: gehe91e0IyVT0QU/XBkEyg folded on the Flop
Seat 5: GrNTWMdwy+jC6Lred1eDng folded before Flop (didn't bet)
Seat 6: egvg3mTBBVzMHnJPIQiKcA folded before Flop (didn't bet)
Seat 7: eK8qa6EPcH2zhtbmWSvc9g (button) collected ($0.95)
Seat 8: OXPkK84/qv92EMwXPiG5rQ (small blind) folded on the Flop
Seat 9: P+9ymZQ3ktpQu1bn7HIjew (big blind) folded on the Flop




PokerStars Game #59941879584:  Hold'em No Limit ($0.10/$0.25) - 2009/07/01 1:49:04 ET
Table 'ROYvQOMwUrvL3SOiHYcrWg' 9-max Seat #4 is the button
Seat 1: 22dIObOuor/A+IKWkNoAlA ($5.40 in chips) 
Seat 2: gehe91e0IyVT0QU/XBkEyg ($25.15 in chips) 
Seat 3: 8EbrQ/EvFWt2cr0GaU82gQ ($5 in chips) 
Seat 4: SHegmCn8B0InbWE/zFlvOw ($25.95 in chips) 
Seat 5: 7je+LC5Mfs6nL8YBVh4frQ ($4.75 in chips) 
Seat 6: P+9ymZQ3ktpQu1bn7HIjew ($20.50 in chips) 
Seat 7: tYsOBqdU1+x+yFI7zHO7hQ ($25 in chips) 
Seat 8: biJWLZ27fafNeBI2oT1KJw ($28.15 in chips) 
Seat 9: uhrboV251dcgYniYTdFIcA ($25.35 in chips) 
7je+LC5Mfs6nL8YBVh4frQ: posts small blind $0.10
P+9ymZQ3ktpQu1bn7HIjew: posts big blind $0.25
*** HOLE CARDS ***
tYsOBqdU1+x+yFI7zHO7hQ: folds 
biJWLZ27fafNeBI2oT1KJw: folds 
uhrboV251dcgYniYTdFIcA: folds 
22dIObOuor/A+IKWkNoAlA: folds 
gehe91e0IyVT0QU/XBkEyg: folds 
8EbrQ/EvFWt2cr0GaU82gQ: folds 
SHegmCn8B0InbWE/zFlvOw: raises $0.25 to $0.50
7je+LC5Mfs6nL8YBVh4frQ: folds 
P+9ymZQ3ktpQu1bn7HIjew: folds 
Uncalled bet ($0.25) returned to SHegmCn8B0InbWE/zFlvOw
SHegmCn8B0InbWE/zFlvOw collected $0.60 from pot
*** SUMMARY ***
Total pot $0.60 | Rake $0 
Seat 1: 22dIObOuor/A+IKWkNoAlA folded before Flop (didn't bet)
Seat 2: gehe91e0IyVT0QU/XBkEyg folded before Flop (didn't bet)
Seat 3: 8EbrQ/EvFWt2cr0GaU82gQ folded before Flop (didn't bet)
Seat 4: SHegmCn8B0InbWE/zFlvOw (button) collected ($0.60)
Seat 5: 7je+LC5Mfs6nL8YBVh4frQ (small blind) folded before Flop
Seat 6: P+9ymZQ3ktpQu1bn7HIjew (big blind) folded before Flop
Seat 7: tYsOBqdU1+x+yFI7zHO7hQ folded before Flop (didn't bet)
Seat 8: biJWLZ27fafNeBI2oT1KJw folded before Flop (didn't bet)
Seat 9: uhrboV251dcgYniYTdFIcA folded before Flop (didn't bet)




PokerStars Game #59941880144:  Hold'em No Limit ($0.10/$0.25) - 2009/07/01 1:49:05 ET
Table 'R5qKG21jwFDYRcOht9qwqQ' 9-max Seat #1 is the button
Seat 1: N5sUK8M0br9djLrW97V9pQ ($24.15 in chips) 
Seat 2: N6foVRyErHqcNmshkqextQ ($13.55 in chips) 
Seat 3: M2QO2DxB5Wawg2h8HSpnYA ($10 in chips) 
Seat 5: zUXhymECc2C9W9ZNw6qppA ($9.15 in chips) 
Seat 6: EP17SQz/iWcuYdNOGeBgkw ($15.90 in chips) 
Seat 7: zgi+EUykT/pZQpoUG6+oEg ($4.65 in chips) 
Seat 8: hYvTc4PYNrAaNAIVoM94Hw ($4.75 in chips) 
Seat 9: MG90wfSJZnOejs/KD3vlQQ ($38.30 in chips) 
N6foVRyErHqcNmshkqextQ: posts small blind $0.10
M2QO2DxB5Wawg2h8HSpnYA: posts big blind $0.25
*** HOLE CARDS ***
zUXhymECc2C9W9ZNw6qppA: folds 
EP17SQz/iWcuYdNOGeBgkw: folds 
zgi+EUykT/pZQpoUG6+oEg: folds 
hYvTc4PYNrAaNAIVoM94Hw: calls $0.25
MG90wfSJZnOejs/KD3vlQQ: folds 
N5sUK8M0br9djLrW97V9pQ: folds 
N6foVRyErHqcNmshkqextQ: calls $0.15
M2QO2DxB5Wawg2h8HSpnYA: checks 
*** FLOP *** [7h Jh 7d]
N6foVRyErHqcNmshkqextQ: checks 
M2QO2DxB5Wawg2h8HSpnYA: checks 
hYvTc4PYNrAaNAIVoM94Hw: bets $0.50
N6foVRyErHqcNmshkqextQ: raises $0.75 to $1.25
M2QO2DxB5Wawg2h8HSpnYA: folds 
hYvTc4PYNrAaNAIVoM94Hw: calls $0.75
*** TURN *** [7h Jh 7d] [6s]
N6foVRyErHqcNmshkqextQ: bets $1.50
hYvTc4PYNrAaNAIVoM94Hw: raises $1.75 to $3.25 and is all-in
N6foVRyErHqcNmshkqextQ: calls $1.75
*** RIVER *** [7h Jh 7d 6s] [Td]
*** SHOW DOWN ***
N6foVRyErHqcNmshkqextQ: shows [Jc 8c] (two pair, Jacks and Sevens)
hYvTc4PYNrAaNAIVoM94Hw: shows [9h Js] (two pair, Jacks and Sevens)
N6foVRyErHqcNmshkqextQ collected $4.65 from pot
hYvTc4PYNrAaNAIVoM94Hw collected $4.65 from pot
*** SUMMARY ***
Total pot $9.75 | Rake $0.45 
Board [7h Jh 7d 6s Td]
Seat 1: N5sUK8M0br9djLrW97V9pQ (button) folded before Flop (didn't bet)
Seat 2: N6foVRyErHqcNmshkqextQ (small blind) showed [Jc 8c] and won ($4.65) with two pair, Jacks and Sevens
Seat 3: M2QO2DxB5Wawg2h8HSpnYA (big blind) folded on the Flop
Seat 5: zUXhymECc2C9W9ZNw6qppA folded before Flop (didn't bet)
Seat 6: EP17SQz/iWcuYdNOGeBgkw folded before Flop (didn't bet)
Seat 7: zgi+EUykT/pZQpoUG6+oEg folded before Flop (didn't bet)
Seat 8: hYvTc4PYNrAaNAIVoM94Hw showed [9h Js] and won ($4.65) with two pair, Jacks and Sevens
Seat 9: MG90wfSJZnOejs/KD3vlQQ folded before Flop (didn't bet)




PokerStars Game #59941879832:  Hold'em No Limit ($0.10/$0.25) - 2009/07/01 1:49:05 ET
Table 'pAhiNHs/spaABQia+7gWNQ' 9-max Seat #7 is the button
Seat 1: ipgcO7Pa6LC8XWpVttZfnA ($5 in chips) 
Seat 2: dfNim92Z6XK1/h5SFW5vDg ($25.25 in chips) 
Seat 4: Qduu7ikeizo6q6Ei9YvcJA ($47.75 in chips) 
Seat 5: OlPJsgR4xypSg/w1z7Gyvw ($33.60 in chips) 
Seat 6: oLa/tXLfSLLB28mcLGrxcg ($23.90 in chips) 
Seat 7: +WTkVY3GeLxqGQBbMZQiWQ ($10.30 in chips) 
Seat 8: PskTLlFIRHSp61inskRzVg ($9.10 in chips) 
Seat 9: zgi+EUykT/pZQpoUG6+oEg ($6.15 in chips) 
PskTLlFIRHSp61inskRzVg: posts small blind $0.10
zgi+EUykT/pZQpoUG6+oEg: posts big blind $0.25
bXpVeaSTPBFSPJmeXxO7nw: sits out 
*** HOLE CARDS ***
ipgcO7Pa6LC8XWpVttZfnA: folds 
dfNim92Z6XK1/h5SFW5vDg: folds 
Qduu7ikeizo6q6Ei9YvcJA: folds 
OlPJsgR4xypSg/w1z7Gyvw: folds 
oLa/tXLfSLLB28mcLGrxcg: folds 
+WTkVY3GeLxqGQBbMZQiWQ: folds 
PskTLlFIRHSp61inskRzVg: raises $1.75 to $2
zgi+EUykT/pZQpoUG6+oEg: folds 
Uncalled bet ($1.75) returned to PskTLlFIRHSp61inskRzVg
PskTLlFIRHSp61inskRzVg collected $0.50 from pot
PskTLlFIRHSp61inskRzVg: doesn't show hand 
*** SUMMARY ***
Total pot $0.50 | Rake $0 
Seat 1: ipgcO7Pa6LC8XWpVttZfnA folded before Flop (didn't bet)
Seat 2: dfNim92Z6XK1/h5SFW5vDg folded before Flop (didn't bet)
Seat 4: Qduu7ikeizo6q6Ei9YvcJA folded before Flop (didn't bet)
Seat 5: OlPJsgR4xypSg/w1z7Gyvw folded before Flop (didn't bet)
Seat 6: oLa/tXLfSLLB28mcLGrxcg folded before Flop (didn't bet)
Seat 7: +WTkVY3GeLxqGQBbMZQiWQ (button) folded before Flop (didn't bet)
Seat 8: PskTLlFIRHSp61inskRzVg (small blind) collected ($0.50)
Seat 9: zgi+EUykT/pZQpoUG6+oEg (big blind) folded before Flop




PokerStars Game #59941880078:  Hold'em No Limit ($0.10/$0.25) - 2009/07/01 1:49:05 ET
Table 'luMgmRPIo47e7iXDlheIwA' 6-max Seat #4 is the button
Seat 1: EQ3WxdGe/KZrM6Lx4T02sg ($37.90 in chips) 
Seat 2: NhUN/JpAprdJeamFBgJH1w ($25.35 in chips) 
Seat 3: w43JQj2oYPpKQVG4Yzlq1w ($25 in chips) 
Seat 4: xrf8tAXKQHG99HixCot1Iw ($25.90 in chips) 
Seat 5: cWc85bEzdRzpUMhRKm8pwQ ($45 in chips) 
Seat 6: qGHGf/553gQnDoklMRe3tg ($24.55 in chips) 
cWc85bEzdRzpUMhRKm8pwQ: posts small blind $0.10
qGHGf/553gQnDoklMRe3tg: posts big blind $0.25
*** HOLE CARDS ***
EQ3WxdGe/KZrM6Lx4T02sg: calls $0.25
NhUN/JpAprdJeamFBgJH1w: folds 
w43JQj2oYPpKQVG4Yzlq1w: raises $0.75 to $1
xrf8tAXKQHG99HixCot1Iw: folds 
cWc85bEzdRzpUMhRKm8pwQ: folds 
qGHGf/553gQnDoklMRe3tg: folds 
EQ3WxdGe/KZrM6Lx4T02sg: folds 
Uncalled bet ($0.75) returned to w43JQj2oYPpKQVG4Yzlq1w
w43JQj2oYPpKQVG4Yzlq1w collected $0.85 from pot
*** SUMMARY ***
Total pot $0.85 | Rake $0 
Seat 1: EQ3WxdGe/KZrM6Lx4T02sg folded before Flop
Seat 2: NhUN/JpAprdJeamFBgJH1w folded before Flop (didn't bet)
Seat 3: w43JQj2oYPpKQVG4Yzlq1w collected ($0.85)
Seat 4: xrf8tAXKQHG99HixCot1Iw (button) folded before Flop (didn't bet)
Seat 5: cWc85bEzdRzpUMhRKm8pwQ (small blind) folded before Flop
Seat 6: qGHGf/553gQnDoklMRe3tg (big blind) folded before Flop




PokerStars Game #59941880034:  Hold'em No Limit ($0.10/$0.25) - 2009/07/01 1:49:05 ET
Table '5SUMWYuPsGiOD0FY0QbgOw' 6-max Seat #4 is the button
Seat 1: SFmT9ZsVopnukjvAzrxTRg ($25 in chips) 
Seat 2: xrf8tAXKQHG99HixCot1Iw ($39.75 in chips) 
Seat 3: MqMK8OWPSY1V4stf1Hy5Jw ($39.95 in chips) 
Seat 4: BV+K0Phf5VBHr7aZPKqbUQ ($25 in chips) 
Seat 5: v+QfkGiuj9bgtuNoVnDO8w ($40.55 in chips) 
Seat 6: jA7YMtfNUnAaebB7Lj74EA ($22.80 in chips) 
v+QfkGiuj9bgtuNoVnDO8w: posts small blind $0.10
jA7YMtfNUnAaebB7Lj74EA: posts big blind $0.25
*** HOLE CARDS ***
SFmT9ZsVopnukjvAzrxTRg: folds 
xrf8tAXKQHG99HixCot1Iw: raises $0.50 to $0.75
MqMK8OWPSY1V4stf1Hy5Jw: folds 
MqMK8OWPSY1V4stf1Hy5Jw leaves the table
BV+K0Phf5VBHr7aZPKqbUQ: raises $2 to $2.75
v+QfkGiuj9bgtuNoVnDO8w: folds 
jA7YMtfNUnAaebB7Lj74EA: folds 
xrf8tAXKQHG99HixCot1Iw: folds 
Uncalled bet ($2) returned to BV+K0Phf5VBHr7aZPKqbUQ
BV+K0Phf5VBHr7aZPKqbUQ collected $1.85 from pot
BV+K0Phf5VBHr7aZPKqbUQ: doesn't show hand 
*** SUMMARY ***
Total pot $1.85 | Rake $0 
Seat 1: SFmT9ZsVopnukjvAzrxTRg folded before Flop (didn't bet)
Seat 2: xrf8tAXKQHG99HixCot1Iw folded before Flop
Seat 3: MqMK8OWPSY1V4stf1Hy5Jw folded before Flop (didn't bet)
Seat 4: BV+K0Phf5VBHr7aZPKqbUQ (button) collected ($1.85)
Seat 5: v+QfkGiuj9bgtuNoVnDO8w (small blind) folded before Flop
Seat 6: jA7YMtfNUnAaebB7Lj74EA (big blind) folded before Flop




PokerStars Game #59941880076:  Hold'em No Limit ($0.10/$0.25) - 2009/07/01 1:49:05 ET
Table '60nA7av6bws9VnNmVwculA' 6-max Seat #4 is the button
Seat 1: if4dh6jhJXeN3/qd3qCp9g ($24.65 in chips) 
Seat 2: Bada343Si4xKu3fNXY99AA ($2.75 in chips) 
Seat 3: mnuJq+Q1IXKm/pCy+OzxmQ ($22.45 in chips) 
Seat 4: +baiVgI/ETnBARLe5mARCw ($18.25 in chips) 
Seat 5: zXh+lOT41Q2iWgCNj+OcRw ($11.60 in chips) 
Seat 6: mfrkWA3PTeYPkbO6hi98Aw ($24.75 in chips) 
zXh+lOT41Q2iWgCNj+OcRw: posts small blind $0.10
mfrkWA3PTeYPkbO6hi98Aw: posts big blind $0.25
*** HOLE CARDS ***
if4dh6jhJXeN3/qd3qCp9g: folds 
Bada343Si4xKu3fNXY99AA: folds 
mnuJq+Q1IXKm/pCy+OzxmQ: folds 
+baiVgI/ETnBARLe5mARCw: raises $0.50 to $0.75
zXh+lOT41Q2iWgCNj+OcRw: folds 
mfrkWA3PTeYPkbO6hi98Aw: folds 
Uncalled bet ($0.50) returned to +baiVgI/ETnBARLe5mARCw
+baiVgI/ETnBARLe5mARCw collected $0.60 from pot
+baiVgI/ETnBARLe5mARCw: doesn't show hand 
*** SUMMARY ***
Total pot $0.60 | Rake $0 
Seat 1: if4dh6jhJXeN3/qd3qCp9g folded before Flop (didn't bet)
Seat 2: Bada343Si4xKu3fNXY99AA folded before Flop (didn't bet)
Seat 3: mnuJq+Q1IXKm/pCy+OzxmQ folded before Flop (didn't bet)
Seat 4: +baiVgI/ETnBARLe5mARCw (button) collected ($0.60)
Seat 5: zXh+lOT41Q2iWgCNj+OcRw (small blind) folded before Flop
Seat 6: mfrkWA3PTeYPkbO6hi98Aw (big blind) folded before Flop




PokerStars Game #59941880254:  Hold'em No Limit ($0.10/$0.25) - 2009/07/01 1:49:06 ET
Table 'nB7Q7zfNfy6ig6DB+rsgWQ' 6-max Seat #3 is the button
Seat 1: Hzy03WtPHMYwLYM7hTTxQw ($22.25 in chips) 
Seat 2: 4BHo0wlX9INjkj2727qE0w ($24.75 in chips) 
Seat 3: p3NYOxYhkL7txPRSeXHDeg ($32.25 in chips) 
Seat 4: DihMHaz4WNETH1bPDe13kA ($80.45 in chips) 
Seat 5: xC0kaiDYM6YTlgODL83O5A ($16.65 in chips) 
Seat 6: MEGIwX0eHRUj63lwYaNhVg ($7.95 in chips) 
DihMHaz4WNETH1bPDe13kA: posts small blind $0.10
xC0kaiDYM6YTlgODL83O5A: posts big blind $0.25
*** HOLE CARDS ***
MEGIwX0eHRUj63lwYaNhVg: folds 
Hzy03WtPHMYwLYM7hTTxQw: raises $0.50 to $0.75
4BHo0wlX9INjkj2727qE0w: calls $0.75
p3NYOxYhkL7txPRSeXHDeg: calls $0.75
DihMHaz4WNETH1bPDe13kA: folds 
xC0kaiDYM6YTlgODL83O5A: folds 
*** FLOP *** [8h 4c 7h]
Hzy03WtPHMYwLYM7hTTxQw: checks 
4BHo0wlX9INjkj2727qE0w: bets $0.75
p3NYOxYhkL7txPRSeXHDeg: folds 
Hzy03WtPHMYwLYM7hTTxQw: folds 
Uncalled bet ($0.75) returned to 4BHo0wlX9INjkj2727qE0w
4BHo0wlX9INjkj2727qE0w collected $2.50 from pot
*** SUMMARY ***
Total pot $2.60 | Rake $0.10 
Board [8h 4c 7h]
Seat 1: Hzy03WtPHMYwLYM7hTTxQw folded on the Flop
Seat 2: 4BHo0wlX9INjkj2727qE0w collected ($2.50)
Seat 3: p3NYOxYhkL7txPRSeXHDeg (button) folded on the Flop
Seat 4: DihMHaz4WNETH1bPDe13kA (small blind) folded before Flop
Seat 5: xC0kaiDYM6YTlgODL83O5A (big blind) folded before Flop
Seat 6: MEGIwX0eHRUj63lwYaNhVg folded before Flop (didn't bet)




PokerStars Game #59941880522:  Hold'em No Limit ($0.10/$0.25) - 2009/07/01 1:49:06 ET
Table 'KEoOIegxPF91KooL2AelUA' 6-max Seat #5 is the button
Seat 1: 32YL2ZEp8NT4JB2RVM9euQ ($16 in chips) 
Seat 2: 0Bg59Tnte1Tc7C4i9Jd9cQ ($5.40 in chips) 
Seat 3: zxeVQGaMKDsDzmSY+AInjA ($13.10 in chips) 
Seat 4: Wo60l2GQnSEc3bxPVyvIUw ($8.40 in chips) 
Seat 5: 08V++DOqzaNrRNsHIwi25w ($51.40 in chips) 
Seat 6: AMrBn4Vx9aAo/vv6WHLk6w ($3.60 in chips) 
AMrBn4Vx9aAo/vv6WHLk6w: posts small blind $0.10
32YL2ZEp8NT4JB2RVM9euQ: posts big blind $0.25
*** HOLE CARDS ***
0Bg59Tnte1Tc7C4i9Jd9cQ: raises $0.50 to $0.75
zxeVQGaMKDsDzmSY+AInjA: calls $0.75
Wo60l2GQnSEc3bxPVyvIUw: raises $7.65 to $8.40 and is all-in
08V++DOqzaNrRNsHIwi25w: folds 
08V++DOqzaNrRNsHIwi25w leaves the table
AMrBn4Vx9aAo/vv6WHLk6w: folds 
32YL2ZEp8NT4JB2RVM9euQ: folds 
0Bg59Tnte1Tc7C4i9Jd9cQ: folds 
VXTONriS+Ohik+r0FeicIw joins the table at seat #5 
zxeVQGaMKDsDzmSY+AInjA: folds 
Uncalled bet ($7.65) returned to Wo60l2GQnSEc3bxPVyvIUw
Wo60l2GQnSEc3bxPVyvIUw collected $2.60 from pot
*** SUMMARY ***
Total pot $2.60 | Rake $0 
Seat 1: 32YL2ZEp8NT4JB2RVM9euQ (big blind) folded before Flop
Seat 2: 0Bg59Tnte1Tc7C4i9Jd9cQ folded before Flop
Seat 3: zxeVQGaMKDsDzmSY+AInjA folded before Flop
Seat 4: Wo60l2GQnSEc3bxPVyvIUw collected ($2.60)
Seat 5: 08V++DOqzaNrRNsHIwi25w (button) folded before Flop (didn't bet)
Seat 6: AMrBn4Vx9aAo/vv6WHLk6w (small blind) folded before Flop




PokerStars Game #59941880280:  Hold'em No Limit ($0.10/$0.25) - 2009/07/01 1:49:06 ET
Table '/JJyyIstHfkT7t/bW+WXgg' 6-max Seat #6 is the button
Seat 1: xC0kaiDYM6YTlgODL83O5A ($14.75 in chips) 
Seat 2: obJgSnVgWWWaAUtVILo77Q ($18 in chips) 
Seat 3: DR0nVIhVP77oEBlO9J8vlg ($36.85 in chips) 
Seat 4: JFIAqU8lCZ0vWwEl4bdGsg ($36.40 in chips) 
Seat 5: +ZlnqPoP3Hg4BIUxDfKd/A ($45.70 in chips) 
Seat 6: UmcUp27+PbgBItv3ZNlAWQ ($25.15 in chips) 
xC0kaiDYM6YTlgODL83O5A: posts small blind $0.10
obJgSnVgWWWaAUtVILo77Q: posts big blind $0.25
*** HOLE CARDS ***
DR0nVIhVP77oEBlO9J8vlg: calls $0.25
JFIAqU8lCZ0vWwEl4bdGsg: folds 
+ZlnqPoP3Hg4BIUxDfKd/A: folds 
UmcUp27+PbgBItv3ZNlAWQ: folds 
xC0kaiDYM6YTlgODL83O5A: calls $0.15
obJgSnVgWWWaAUtVILo77Q: raises $0.75 to $1
DR0nVIhVP77oEBlO9J8vlg: calls $0.75
xC0kaiDYM6YTlgODL83O5A: folds 
*** FLOP *** [9d 6s 8h]
obJgSnVgWWWaAUtVILo77Q: checks 
DR0nVIhVP77oEBlO9J8vlg: bets $1.25
obJgSnVgWWWaAUtVILo77Q: raises $2.25 to $3.50
DR0nVIhVP77oEBlO9J8vlg: calls $2.25
*** TURN *** [9d 6s 8h] [4h]
obJgSnVgWWWaAUtVILo77Q: bets $6.25
DR0nVIhVP77oEBlO9J8vlg: calls $6.25
*** RIVER *** [9d 6s 8h 4h] [5c]
obJgSnVgWWWaAUtVILo77Q: bets $7.25 and is all-in
DR0nVIhVP77oEBlO9J8vlg: folds 
Uncalled bet ($7.25) returned to obJgSnVgWWWaAUtVILo77Q
obJgSnVgWWWaAUtVILo77Q collected $20.70 from pot
obJgSnVgWWWaAUtVILo77Q: doesn't show hand 
*** SUMMARY ***
Total pot $21.75 | Rake $1.05 
Board [9d 6s 8h 4h 5c]
Seat 1: xC0kaiDYM6YTlgODL83O5A (small blind) folded before Flop
Seat 2: obJgSnVgWWWaAUtVILo77Q (big blind) collected ($20.70)
Seat 3: DR0nVIhVP77oEBlO9J8vlg folded on the River
Seat 4: JFIAqU8lCZ0vWwEl4bdGsg folded before Flop (didn't bet)
Seat 5: +ZlnqPoP3Hg4BIUxDfKd/A folded before Flop (didn't bet)
Seat 6: UmcUp27+PbgBItv3ZNlAWQ (button) folded before Flop (didn't bet)




PokerStars Game #59941880592:  Hold'em No Limit ($0.10/$0.25) - 2009/07/01 1:49:06 ET
Table 'xkqAWQFDrFt4p81M8UsoNw' 9-max Seat #1 is the button
Seat 1: tLcDklc2rBORNfixyRfVfw ($28.25 in chips) 
Seat 3: xHZZRLAaFUIC8WWI8ljOJA ($23.75 in chips) 
Seat 4: wGigCmBR/9XWkPpvYos3aQ ($25.10 in chips) 
Seat 6: 6RiVTYll/5D8zICp0MRpKw ($25 in chips) 
Seat 7: MG90wfSJZnOejs/KD3vlQQ ($44.55 in chips) 
Seat 8: MaqsqnOOkbNuPf4oWvOtnA ($43.25 in chips) 
Seat 9: Z9AeOQX3yzuSvKAm/xyovg ($9.30 in chips) 
xHZZRLAaFUIC8WWI8ljOJA: posts small blind $0.10
wGigCmBR/9XWkPpvYos3aQ: posts big blind $0.25
H5Se03ZqSX7tbULXur2MAg: sits out 
*** HOLE CARDS ***
6RiVTYll/5D8zICp0MRpKw: folds 
MG90wfSJZnOejs/KD3vlQQ: folds 
MaqsqnOOkbNuPf4oWvOtnA: folds 
Z9AeOQX3yzuSvKAm/xyovg: folds 
tLcDklc2rBORNfixyRfVfw: raises $0.75 to $1
xHZZRLAaFUIC8WWI8ljOJA: folds 
wGigCmBR/9XWkPpvYos3aQ: folds 
Uncalled bet ($0.75) returned to tLcDklc2rBORNfixyRfVfw
tLcDklc2rBORNfixyRfVfw collected $0.60 from pot
tLcDklc2rBORNfixyRfVfw: doesn't show hand 
*** SUMMARY ***
Total pot $0.60 | Rake $0 
Seat 1: tLcDklc2rBORNfixyRfVfw (button) collected ($0.60)
Seat 3: xHZZRLAaFUIC8WWI8ljOJA (small blind) folded before Flop
Seat 4: wGigCmBR/9XWkPpvYos3aQ (big blind) folded before Flop
Seat 6: 6RiVTYll/5D8zICp0MRpKw folded before Flop (didn't bet)
Seat 7: MG90wfSJZnOejs/KD3vlQQ folded before Flop (didn't bet)
Seat 8: MaqsqnOOkbNuPf4oWvOtnA folded before Flop (didn't bet)
Seat 9: Z9AeOQX3yzuSvKAm/xyovg folded before Flop (didn't bet)




PokerStars Game #59941880336:  Hold'em No Limit ($0.10/$0.25) - 2009/07/01 1:49:06 ET
Table 'Zi9/NqNs3XoL1eWhMCyZyg' 9-max Seat #2 is the button
Seat 1: X6+pSIPfovPcE87t+LmUKQ ($4.50 in chips) 
Seat 2: 1wKfgJ8xXIiuc8C6qjkxhg ($5.10 in chips) 
Seat 3: ETC7YyRJTa2Ovhln64Ni5Q ($28.30 in chips) 
Seat 4: dmYlc+1cjwZMJ7wV+Z0rRg ($23.75 in chips) 
Seat 5: JTINtdu/1/EQCVfalLD/xQ ($10.30 in chips) 
Seat 6: YQhfmYhgnDDlWCAFmBb36Q ($16.25 in chips) 
Seat 7: 0QdZrkFD7aGKeBXPGbIomA ($2.20 in chips) 
Seat 8: nm4Dj/f+jJEwKVsUnKh73g ($34.90 in chips) 
ETC7YyRJTa2Ovhln64Ni5Q: posts small blind $0.10
dmYlc+1cjwZMJ7wV+Z0rRg: posts big blind $0.25
3l+i+xMeyDndSXMF2A5CDA: sits out 
*** HOLE CARDS ***
JTINtdu/1/EQCVfalLD/xQ: calls $0.25
YQhfmYhgnDDlWCAFmBb36Q: calls $0.25
0QdZrkFD7aGKeBXPGbIomA: folds 
nm4Dj/f+jJEwKVsUnKh73g: folds 
X6+pSIPfovPcE87t+LmUKQ: folds 
1wKfgJ8xXIiuc8C6qjkxhg: folds 
ETC7YyRJTa2Ovhln64Ni5Q: calls $0.15
dmYlc+1cjwZMJ7wV+Z0rRg: checks 
*** FLOP *** [3h Jh 2c]
ETC7YyRJTa2Ovhln64Ni5Q: checks 
dmYlc+1cjwZMJ7wV+Z0rRg: checks 
JTINtdu/1/EQCVfalLD/xQ: checks 
YQhfmYhgnDDlWCAFmBb36Q: bets $0.50
ETC7YyRJTa2Ovhln64Ni5Q: folds 
dmYlc+1cjwZMJ7wV+Z0rRg: folds 
JTINtdu/1/EQCVfalLD/xQ: folds 
Uncalled bet ($0.50) returned to YQhfmYhgnDDlWCAFmBb36Q
JTINtdu/1/EQCVfalLD/xQ is sitting out
JTINtdu/1/EQCVfalLD/xQ leaves the table
YQhfmYhgnDDlWCAFmBb36Q collected $0.95 from pot
YQhfmYhgnDDlWCAFmBb36Q: doesn't show hand 
*** SUMMARY ***
Total pot $1 | Rake $0.05 
Board [3h Jh 2c]
Seat 1: X6+pSIPfovPcE87t+LmUKQ folded before Flop (didn't bet)
Seat 2: 1wKfgJ8xXIiuc8C6qjkxhg (button) folded before Flop (didn't bet)
Seat 3: ETC7YyRJTa2Ovhln64Ni5Q (small blind) folded on the Flop
Seat 4: dmYlc+1cjwZMJ7wV+Z0rRg (big blind) folded on the Flop
Seat 5: JTINtdu/1/EQCVfalLD/xQ folded on the Flop
Seat 6: YQhfmYhgnDDlWCAFmBb36Q collected ($0.95)
Seat 7: 0QdZrkFD7aGKeBXPGbIomA folded before Flop (didn't bet)
Seat 8: nm4Dj/f+jJEwKVsUnKh73g folded before Flop (didn't bet)




PokerStars Game #59941880524:  Hold'em No Limit ($0.10/$0.25) - 2009/07/01 1:49:06 ET
Table 'sSe6q4YTb/iS19t2eCFdsA' 9-max Seat #9 is the button
Seat 1: hJ4uYjNmSZdjrKA8cjZqCA ($18.50 in chips) 
Seat 2: 3l+i+xMeyDndSXMF2A5CDA ($6.25 in chips) 
Seat 3: OXPkK84/qv92EMwXPiG5rQ ($9.75 in chips) 
Seat 4: 22dIObOuor/A+IKWkNoAlA ($9.10 in chips) 
Seat 5: qS+jfnNoG75bT+uQ8CKhQA ($9.70 in chips) 
Seat 6: tYsOBqdU1+x+yFI7zHO7hQ ($27 in chips) 
Seat 7: t70KGeRtR3naHSqKDixsUg ($3.95 in chips) 
Seat 8: hvXZ0zFPZFP8Hf6dS36YEw ($16 in chips) 
Seat 9: Z9W7+g1WMhhZDi7DwGbCFA ($5.25 in chips) 
hJ4uYjNmSZdjrKA8cjZqCA: posts small blind $0.10
3l+i+xMeyDndSXMF2A5CDA: posts big blind $0.25
*** HOLE CARDS ***
OXPkK84/qv92EMwXPiG5rQ: folds 
22dIObOuor/A+IKWkNoAlA: folds 
qS+jfnNoG75bT+uQ8CKhQA: folds 
tYsOBqdU1+x+yFI7zHO7hQ: folds 
t70KGeRtR3naHSqKDixsUg: raises $0.25 to $0.50
hvXZ0zFPZFP8Hf6dS36YEw: folds 
Z9W7+g1WMhhZDi7DwGbCFA: folds 
hJ4uYjNmSZdjrKA8cjZqCA: folds 
3l+i+xMeyDndSXMF2A5CDA: calls $0.25
*** FLOP *** [2c 8c Ac]
3l+i+xMeyDndSXMF2A5CDA: checks 
t70KGeRtR3naHSqKDixsUg: checks 
*** TURN *** [2c 8c Ac] [5d]
3l+i+xMeyDndSXMF2A5CDA: checks 
t70KGeRtR3naHSqKDixsUg: checks 
*** RIVER *** [2c 8c Ac 5d] [Kd]
3l+i+xMeyDndSXMF2A5CDA: checks 
t70KGeRtR3naHSqKDixsUg: bets $0.25
3l+i+xMeyDndSXMF2A5CDA: calls $0.25
*** SHOW DOWN ***
t70KGeRtR3naHSqKDixsUg: shows [Js As] (a pair of Aces)
3l+i+xMeyDndSXMF2A5CDA: mucks hand 
t70KGeRtR3naHSqKDixsUg collected $1.55 from pot
*** SUMMARY ***
Total pot $1.60 | Rake $0.05 
Board [2c 8c Ac 5d Kd]
Seat 1: hJ4uYjNmSZdjrKA8cjZqCA (small blind) folded before Flop
Seat 2: 3l+i+xMeyDndSXMF2A5CDA (big blind) mucked
Seat 3: OXPkK84/qv92EMwXPiG5rQ folded before Flop (didn't bet)
Seat 4: 22dIObOuor/A+IKWkNoAlA folded before Flop (didn't bet)
Seat 5: qS+jfnNoG75bT+uQ8CKhQA folded before Flop (didn't bet)
Seat 6: tYsOBqdU1+x+yFI7zHO7hQ folded before Flop (didn't bet)
Seat 7: t70KGeRtR3naHSqKDixsUg showed [Js As] and won ($1.55) with a pair of Aces
Seat 8: hvXZ0zFPZFP8Hf6dS36YEw folded before Flop (didn't bet)
Seat 9: Z9W7+g1WMhhZDi7DwGbCFA (button) folded before Flop (didn't bet)




PokerStars Game #59941881136:  Hold'em No Limit ($0.10/$0.25) - 2009/07/01 1:49:07 ET
Table '/asc7VQ/OpF/oVJ3erB80w' 9-max Seat #5 is the button
Seat 2: +LseQ4csMghI3KY4cLSGMQ ($20.70 in chips) 
Seat 3: WEb58GPxGJGcxGh34AFZRQ ($6.50 in chips) 
Seat 4: Rjy74A2wdEiDWplMcUbA+w ($8.25 in chips) 
Seat 5: QB9VESHry/CRTDKMGwKwsQ ($40.70 in chips) 
Seat 6: wnerYvSRWT9Sm4X3ip/c8w ($24.75 in chips) 
Seat 7: 7Qlge5BZqMQvXxiy4HU3Hw ($7.20 in chips) 
Seat 8: jB7U2KxE3pjvDhvZHXK2Ag ($18.35 in chips) 
Seat 9: zUXhymECc2C9W9ZNw6qppA ($19.05 in chips) 
wnerYvSRWT9Sm4X3ip/c8w: posts small blind $0.10
7Qlge5BZqMQvXxiy4HU3Hw: posts big blind $0.25
*** HOLE CARDS ***
jB7U2KxE3pjvDhvZHXK2Ag: calls $0.25
zUXhymECc2C9W9ZNw6qppA: folds 
7Qlge5BZqMQvXxiy4HU3Hw said, "f"
+LseQ4csMghI3KY4cLSGMQ: calls $0.25
7Qlge5BZqMQvXxiy4HU3Hw said, "u"
WEb58GPxGJGcxGh34AFZRQ: raises $0.25 to $0.50
Rjy74A2wdEiDWplMcUbA+w: calls $0.50
QB9VESHry/CRTDKMGwKwsQ: folds 
wnerYvSRWT9Sm4X3ip/c8w: folds 
7Qlge5BZqMQvXxiy4HU3Hw: calls $0.25
jB7U2KxE3pjvDhvZHXK2Ag: calls $0.25
+LseQ4csMghI3KY4cLSGMQ: calls $0.25
*** FLOP *** [5d 9h 7c]
7Qlge5BZqMQvXxiy4HU3Hw: checks 
jB7U2KxE3pjvDhvZHXK2Ag: checks 
WEb58GPxGJGcxGh34AFZRQ said, "ah, didn't realize they let children play on this site"
+LseQ4csMghI3KY4cLSGMQ: checks 
Mvskymzsky was removed from the table for failing to post
WEb58GPxGJGcxGh34AFZRQ said, "now time to turn you off"
WEb58GPxGJGcxGh34AFZRQ: checks 
3PmVnC/15cl4oyI1TKIt4g joins the table at seat #1 
Rjy74A2wdEiDWplMcUbA+w: checks 
*** TURN *** [5d 9h 7c] [Jd]
7Qlge5BZqMQvXxiy4HU3Hw said, "me either suck out man"
7Qlge5BZqMQvXxiy4HU3Hw: checks 
jB7U2KxE3pjvDhvZHXK2Ag: checks 
+LseQ4csMghI3KY4cLSGMQ: checks 
WEb58GPxGJGcxGh34AFZRQ: checks 
zUXhymECc2C9W9ZNw6qppA is disconnected 
Rjy74A2wdEiDWplMcUbA+w: checks 
*** RIVER *** [5d 9h 7c Jd] [4s]
7Qlge5BZqMQvXxiy4HU3Hw: bets $1
jB7U2KxE3pjvDhvZHXK2Ag: folds 
+LseQ4csMghI3KY4cLSGMQ: folds 
WEb58GPxGJGcxGh34AFZRQ: raises $2 to $3
Rjy74A2wdEiDWplMcUbA+w: folds 
7Qlge5BZqMQvXxiy4HU3Hw: folds 
Uncalled bet ($2) returned to WEb58GPxGJGcxGh34AFZRQ
WEb58GPxGJGcxGh34AFZRQ collected $4.40 from pot
WEb58GPxGJGcxGh34AFZRQ: doesn't show hand 
*** SUMMARY ***
Total pot $4.60 | Rake $0.20 
Board [5d 9h 7c Jd 4s]
Seat 2: +LseQ4csMghI3KY4cLSGMQ folded on the River
Seat 3: WEb58GPxGJGcxGh34AFZRQ collected ($4.40)
Seat 4: Rjy74A2wdEiDWplMcUbA+w folded on the River
Seat 5: QB9VESHry/CRTDKMGwKwsQ (button) folded before Flop (didn't bet)
Seat 6: wnerYvSRWT9Sm4X3ip/c8w (small blind) folded before Flop
Seat 7: 7Qlge5BZqMQvXxiy4HU3Hw (big blind) folded on the River
Seat 8: jB7U2KxE3pjvDhvZHXK2Ag folded on the River
Seat 9: zUXhymECc2C9W9ZNw6qppA folded before Flop (didn't bet)




PokerStars Game #59941881244:  Hold'em No Limit ($0.10/$0.25) - 2009/07/01 1:49:07 ET
Table 'KU/HrxqxwDz8HKEhYTZ6uw' 6-max Seat #1 is the button
Seat 1: 7LKoiQHXpTQXJvWQrw907g ($34.45 in chips) 
Seat 2: kG34n23qFQA3nzdOJTQ1dA ($24.40 in chips) 
Seat 3: SFmT9ZsVopnukjvAzrxTRg ($25.60 in chips) 
Seat 5: iyZxqznXjv3vtvOJymkoLQ ($52.70 in chips) 
Seat 6: qWxkCeqApAWdAA0evrfDvQ ($12.75 in chips) 
kG34n23qFQA3nzdOJTQ1dA: posts small blind $0.10
SFmT9ZsVopnukjvAzrxTRg: posts big blind $0.25
*** HOLE CARDS ***
iyZxqznXjv3vtvOJymkoLQ: folds 
qWxkCeqApAWdAA0evrfDvQ: calls $0.25
7LKoiQHXpTQXJvWQrw907g: calls $0.25
kG34n23qFQA3nzdOJTQ1dA: folds 
SFmT9ZsVopnukjvAzrxTRg: checks 
*** FLOP *** [3d Ks 8s]
SFmT9ZsVopnukjvAzrxTRg: bets $0.75
qWxkCeqApAWdAA0evrfDvQ: folds 
7LKoiQHXpTQXJvWQrw907g: folds 
Uncalled bet ($0.75) returned to SFmT9ZsVopnukjvAzrxTRg
SFmT9ZsVopnukjvAzrxTRg collected $0.85 from pot
SFmT9ZsVopnukjvAzrxTRg: doesn't show hand 
*** SUMMARY ***
Total pot $0.85 | Rake $0 
Board [3d Ks 8s]
Seat 1: 7LKoiQHXpTQXJvWQrw907g (button) folded on the Flop
Seat 2: kG34n23qFQA3nzdOJTQ1dA (small blind) folded before Flop
Seat 3: SFmT9ZsVopnukjvAzrxTRg (big blind) collected ($0.85)
Seat 5: iyZxqznXjv3vtvOJymkoLQ folded before Flop (didn't bet)
Seat 6: qWxkCeqApAWdAA0evrfDvQ folded on the Flop




PokerStars Game #59941880796:  Hold'em No Limit ($0.10/$0.25) - 2009/07/01 1:49:07 ET
Table 'qryc9C/ELyQ3lubOaELNAQ' 6-max Seat #1 is the button
Seat 1: OZc6kkoTwtITj1ZfreJK1A ($67.25 in chips) 
Seat 2: LtASJ9OlkqGrrUKGQlpGAw ($30.05 in chips) 
Seat 3: wvIIdlbCgePONQwXjx9xzQ ($4.20 in chips) 
Seat 4: v+QfkGiuj9bgtuNoVnDO8w ($25 in chips) 
Seat 5: 9StOHp+Y1T0K13JdgS2oQQ ($37.05 in chips) 
Seat 6: xmdItDBraeGrrs3wzz1J3w ($18.85 in chips) 
LtASJ9OlkqGrrUKGQlpGAw: posts small blind $0.10
wvIIdlbCgePONQwXjx9xzQ: posts big blind $0.25
*** HOLE CARDS ***
v+QfkGiuj9bgtuNoVnDO8w: folds 
9StOHp+Y1T0K13JdgS2oQQ: raises $0.50 to $0.75
xmdItDBraeGrrs3wzz1J3w: folds 
OZc6kkoTwtITj1ZfreJK1A: calls $0.75
LtASJ9OlkqGrrUKGQlpGAw: folds 
wvIIdlbCgePONQwXjx9xzQ: calls $0.50
*** FLOP *** [8d 8s 3s]
wvIIdlbCgePONQwXjx9xzQ: checks 
9StOHp+Y1T0K13JdgS2oQQ: bets $1
OZc6kkoTwtITj1ZfreJK1A: folds 
wvIIdlbCgePONQwXjx9xzQ: folds 
Uncalled bet ($1) returned to 9StOHp+Y1T0K13JdgS2oQQ
9StOHp+Y1T0K13JdgS2oQQ collected $2.25 from pot
9StOHp+Y1T0K13JdgS2oQQ: doesn't show hand 
*** SUMMARY ***
Total pot $2.35 | Rake $0.10 
Board [8d 8s 3s]
Seat 1: OZc6kkoTwtITj1ZfreJK1A (button) folded on the Flop
Seat 2: LtASJ9OlkqGrrUKGQlpGAw (small blind) folded before Flop
Seat 3: wvIIdlbCgePONQwXjx9xzQ (big blind) folded on the Flop
Seat 4: v+QfkGiuj9bgtuNoVnDO8w folded before Flop (didn't bet)
Seat 5: 9StOHp+Y1T0K13JdgS2oQQ collected ($2.25)
Seat 6: xmdItDBraeGrrs3wzz1J3w folded before Flop (didn't bet)




PokerStars Game #59941880960:  Hold'em No Limit ($0.10/$0.25) - 2009/07/01 1:49:07 ET
Table '3LMlz3V4AziGlU+ikmyU8w' 6-max Seat #1 is the button
Seat 1: Wxq4Qyj0DnDXj2+taEOJFQ ($55.15 in chips) 
Seat 2: uR3AbFJLoOX86DOTtTgGcg ($24.75 in chips) 
Seat 3: Hzy03WtPHMYwLYM7hTTxQw ($31.45 in chips) 
Seat 4: 6DwBRH+xZ12AAZmeAg+aXw ($23.30 in chips) 
Seat 5: tOAk1Og4mVObMBOfvdDYOw ($25.85 in chips) 
Seat 6: 7LpHJVeM6k1mQdC6HXYzww ($25 in chips) 
uR3AbFJLoOX86DOTtTgGcg: posts small blind $0.10
Hzy03WtPHMYwLYM7hTTxQw: posts big blind $0.25
*** HOLE CARDS ***
6DwBRH+xZ12AAZmeAg+aXw: folds 
tOAk1Og4mVObMBOfvdDYOw: raises $0.75 to $1
7LpHJVeM6k1mQdC6HXYzww: calls $1
Wxq4Qyj0DnDXj2+taEOJFQ: raises $1 to $2
uR3AbFJLoOX86DOTtTgGcg: folds 
Hzy03WtPHMYwLYM7hTTxQw: folds 
tOAk1Og4mVObMBOfvdDYOw: calls $1
7LpHJVeM6k1mQdC6HXYzww: calls $1
*** FLOP *** [9s 6s 3h]
tOAk1Og4mVObMBOfvdDYOw: checks 
7LpHJVeM6k1mQdC6HXYzww: checks 
Wxq4Qyj0DnDXj2+taEOJFQ: bets $4
tOAk1Og4mVObMBOfvdDYOw: folds 
7LpHJVeM6k1mQdC6HXYzww: raises $6 to $10
Wxq4Qyj0DnDXj2+taEOJFQ: calls $6
*** TURN *** [9s 6s 3h] [Jh]
7LpHJVeM6k1mQdC6HXYzww: bets $13 and is all-in
Wxq4Qyj0DnDXj2+taEOJFQ: calls $13
*** RIVER *** [9s 6s 3h Jh] [7s]
*** SHOW DOWN ***
7LpHJVeM6k1mQdC6HXYzww: shows [3d 3s] (three of a kind, Threes)
Wxq4Qyj0DnDXj2+taEOJFQ: mucks hand 
7LpHJVeM6k1mQdC6HXYzww collected $49.80 from pot
*** SUMMARY ***
Total pot $52.35 | Rake $2.55 
Board [9s 6s 3h Jh 7s]
Seat 1: Wxq4Qyj0DnDXj2+taEOJFQ (button) mucked
Seat 2: uR3AbFJLoOX86DOTtTgGcg (small blind) folded before Flop
Seat 3: Hzy03WtPHMYwLYM7hTTxQw (big blind) folded before Flop
Seat 4: 6DwBRH+xZ12AAZmeAg+aXw folded before Flop (didn't bet)
Seat 5: tOAk1Og4mVObMBOfvdDYOw folded on the Flop
Seat 6: 7LpHJVeM6k1mQdC6HXYzww showed [3d 3s] and won ($49.80) with three of a kind, Threes




PokerStars Game #59941880846:  Hold'em No Limit ($0.10/$0.25) - 2009/07/01 1:49:07 ET
Table 'fIMYcWwN4/aXFJvH5Z8Ymg' 6-max Seat #4 is the button
Seat 1: DihMHaz4WNETH1bPDe13kA ($25.35 in chips) 
Seat 2: Mhj3q7cxev+XjXZxEE6/Cw ($25.95 in chips) 
Seat 3: 9bpVv1/Qh9IYtXuCtl5VtQ ($24.65 in chips) 
Seat 4: 7cx44/slbeTw+Cy7QB8Trg ($24.65 in chips) 
Seat 5: lquriepNQBhDV5P1SWHhnA ($25.10 in chips) 
Seat 6: jp34e617tIzV8tKIWmfAbA ($28.70 in chips) 
lquriepNQBhDV5P1SWHhnA: posts small blind $0.10
jp34e617tIzV8tKIWmfAbA: posts big blind $0.25
*** HOLE CARDS ***
DihMHaz4WNETH1bPDe13kA: raises $0.50 to $0.75
Mhj3q7cxev+XjXZxEE6/Cw: folds 
9bpVv1/Qh9IYtXuCtl5VtQ: folds 
7cx44/slbeTw+Cy7QB8Trg: folds 
lquriepNQBhDV5P1SWHhnA: folds 
jp34e617tIzV8tKIWmfAbA: folds 
Uncalled bet ($0.50) returned to DihMHaz4WNETH1bPDe13kA
DihMHaz4WNETH1bPDe13kA collected $0.60 from pot
*** SUMMARY ***
Total pot $0.60 | Rake $0 
Seat 1: DihMHaz4WNETH1bPDe13kA collected ($0.60)
Seat 2: Mhj3q7cxev+XjXZxEE6/Cw folded before Flop (didn't bet)
Seat 3: 9bpVv1/Qh9IYtXuCtl5VtQ folded before Flop (didn't bet)
Seat 4: 7cx44/slbeTw+Cy7QB8Trg (button) folded before Flop (didn't bet)
Seat 5: lquriepNQBhDV5P1SWHhnA (small blind) folded before Flop
Seat 6: jp34e617tIzV8tKIWmfAbA (big blind) folded before Flop




PokerStars Game #59941881754:  Hold'em No Limit ($0.10/$0.25) - 2009/07/01 1:49:08 ET
Table 'oJpFwZj9+FUGHX90Un8s9Q' 6-max Seat #4 is the button
Seat 1: 6DwBRH+xZ12AAZmeAg+aXw ($23.55 in chips) 
Seat 2: NtrVQ9UIql0rDCnKDKZ5FQ ($19.70 in chips) 
Seat 3: kyRaCIljYA6l33lSKQfNsg ($24.65 in chips) 
Seat 4: 6elpmfyt4Zw0yvd8lePSMQ ($20.55 in chips) 
Seat 5: kG34n23qFQA3nzdOJTQ1dA ($55.20 in chips) 
Seat 6: 7LpHJVeM6k1mQdC6HXYzww ($25.70 in chips) 
kG34n23qFQA3nzdOJTQ1dA: posts small blind $0.10
7LpHJVeM6k1mQdC6HXYzww: posts big blind $0.25
*** HOLE CARDS ***
6DwBRH+xZ12AAZmeAg+aXw: raises $0.50 to $0.75
NtrVQ9UIql0rDCnKDKZ5FQ: folds 
kyRaCIljYA6l33lSKQfNsg: folds 
6elpmfyt4Zw0yvd8lePSMQ: calls $0.75
kG34n23qFQA3nzdOJTQ1dA: folds 
7LpHJVeM6k1mQdC6HXYzww: calls $0.50
*** FLOP *** [Js 8c 2c]
7LpHJVeM6k1mQdC6HXYzww: checks 
6DwBRH+xZ12AAZmeAg+aXw: bets $1.50
6elpmfyt4Zw0yvd8lePSMQ: folds 
7LpHJVeM6k1mQdC6HXYzww: folds 
Uncalled bet ($1.50) returned to 6DwBRH+xZ12AAZmeAg+aXw
6DwBRH+xZ12AAZmeAg+aXw collected $2.25 from pot
6DwBRH+xZ12AAZmeAg+aXw: doesn't show hand 
*** SUMMARY ***
Total pot $2.35 | Rake $0.10 
Board [Js 8c 2c]
Seat 1: 6DwBRH+xZ12AAZmeAg+aXw collected ($2.25)
Seat 2: NtrVQ9UIql0rDCnKDKZ5FQ folded before Flop (didn't bet)
Seat 3: kyRaCIljYA6l33lSKQfNsg folded before Flop (didn't bet)
Seat 4: 6elpmfyt4Zw0yvd8lePSMQ (button) folded on the Flop
Seat 5: kG34n23qFQA3nzdOJTQ1dA (small blind) folded before Flop
Seat 6: 7LpHJVeM6k1mQdC6HXYzww (big blind) folded on the Flop




PokerStars Game #59941881460:  Hold'em No Limit ($0.10/$0.25) - 2009/07/01 1:49:08 ET
Table 'tq5CvS0RUqGkuBK0XTzqqg' 6-max Seat #1 is the button
Seat 1: +ZlnqPoP3Hg4BIUxDfKd/A ($29.95 in chips) 
Seat 2: 2m6ZFAdj01UZd4WtEySXXQ ($5 in chips) 
Seat 3: 08V++DOqzaNrRNsHIwi25w ($25 in chips) 
Seat 4: UT5XpwOH1ipkOF7n1MqDJA ($34.30 in chips) 
Seat 5: qGHGf/553gQnDoklMRe3tg ($37.65 in chips) 
Seat 6: QqiZLFrN8iOUT/GHw7ztOA ($24.65 in chips) 
2m6ZFAdj01UZd4WtEySXXQ: posts small blind $0.10
08V++DOqzaNrRNsHIwi25w: posts big blind $0.25
*** HOLE CARDS ***
UT5XpwOH1ipkOF7n1MqDJA: folds 
qGHGf/553gQnDoklMRe3tg: folds 
QqiZLFrN8iOUT/GHw7ztOA: folds 
+ZlnqPoP3Hg4BIUxDfKd/A: folds 
2m6ZFAdj01UZd4WtEySXXQ: folds 
Uncalled bet ($0.15) returned to 08V++DOqzaNrRNsHIwi25w
08V++DOqzaNrRNsHIwi25w collected $0.20 from pot
08V++DOqzaNrRNsHIwi25w: doesn't show hand 
*** SUMMARY ***
Total pot $0.20 | Rake $0 
Seat 1: +ZlnqPoP3Hg4BIUxDfKd/A (button) folded before Flop (didn't bet)
Seat 2: 2m6ZFAdj01UZd4WtEySXXQ (small blind) folded before Flop
Seat 3: 08V++DOqzaNrRNsHIwi25w (big blind) collected ($0.20)
Seat 4: UT5XpwOH1ipkOF7n1MqDJA folded before Flop (didn't bet)
Seat 5: qGHGf/553gQnDoklMRe3tg folded before Flop (didn't bet)
Seat 6: QqiZLFrN8iOUT/GHw7ztOA folded before Flop (didn't bet)




PokerStars Game #59941881596:  Hold'em No Limit ($0.10/$0.25) - 2009/07/01 1:49:08 ET
Table 'ohAuixfiLOYDylNUG5mNUw' 9-max Seat #1 is the button
Seat 1: qwr38jl5txoR36M7G5qi4A ($10 in chips) 
Seat 2: Th3FldXKQW6hWVVPahaoOQ ($25.90 in chips) 
Seat 3: gSakoFAgDDzXSb2eNBWKcg ($14.50 in chips) 
Seat 4: clJsV3v77RS07bDKY+705w ($5 in chips) 
Seat 6: MtVtHDqIJTyUcXkRBBDIVA ($25.35 in chips) 
Seat 8: ppMlNkhYgErlt4fuJO7ADA ($4.95 in chips) 
Seat 9: CT7Xj/V/O5rBlhtt+RZeFQ ($25.25 in chips) 
Th3FldXKQW6hWVVPahaoOQ: posts small blind $0.10
gSakoFAgDDzXSb2eNBWKcg: posts big blind $0.25
y6clPkgMYve3yX9UTvvFUw: sits out 
*** HOLE CARDS ***
clJsV3v77RS07bDKY+705w: folds 
MtVtHDqIJTyUcXkRBBDIVA: folds 
ppMlNkhYgErlt4fuJO7ADA: folds 
CT7Xj/V/O5rBlhtt+RZeFQ: folds 
qwr38jl5txoR36M7G5qi4A: folds 
Th3FldXKQW6hWVVPahaoOQ: folds 
Uncalled bet ($0.15) returned to gSakoFAgDDzXSb2eNBWKcg
gSakoFAgDDzXSb2eNBWKcg collected $0.20 from pot
*** SUMMARY ***
Total pot $0.20 | Rake $0 
Seat 1: qwr38jl5txoR36M7G5qi4A (button) folded before Flop (didn't bet)
Seat 2: Th3FldXKQW6hWVVPahaoOQ (small blind) folded before Flop
Seat 3: gSakoFAgDDzXSb2eNBWKcg (big blind) collected ($0.20)
Seat 4: clJsV3v77RS07bDKY+705w folded before Flop (didn't bet)
Seat 6: MtVtHDqIJTyUcXkRBBDIVA folded before Flop (didn't bet)
Seat 8: ppMlNkhYgErlt4fuJO7ADA folded before Flop (didn't bet)
Seat 9: CT7Xj/V/O5rBlhtt+RZeFQ folded before Flop (didn't bet)




PokerStars Game #59941881636:  Hold'em No Limit ($0.10/$0.25) - 2009/07/01 1:49:08 ET
Table 'gYBWJG3hEuJg6kphY0yhMg' 9-max Seat #4 is the button
Seat 1: AcL/hxc9eT0dCr2TYk/0Dg ($25.80 in chips) 
Seat 2: RCqMONFrSPSArZh2Jsar/w ($19.25 in chips) 
Seat 3: wGigCmBR/9XWkPpvYos3aQ ($25 in chips) 
Seat 4: V6p0jQ/RhUsqpHLmXvEX4Q ($12.35 in chips) 
Seat 5: +sbyWwIcFp9kP0bDtMegfQ ($28 in chips) 
Seat 6: Z9W7+g1WMhhZDi7DwGbCFA ($5 in chips) 
Seat 7: aIEQGxUJwm61WfazSNFCdA ($12.05 in chips) 
Seat 8: 7je+LC5Mfs6nL8YBVh4frQ ($4.75 in chips) 
Seat 9: Bb42QRQMhg5/Y0vHP8/2Xw ($28.05 in chips) 
+sbyWwIcFp9kP0bDtMegfQ: posts small blind $0.10
Z9W7+g1WMhhZDi7DwGbCFA: posts big blind $0.25
*** HOLE CARDS ***
aIEQGxUJwm61WfazSNFCdA: raises $1 to $1.25
7je+LC5Mfs6nL8YBVh4frQ: folds 
Bb42QRQMhg5/Y0vHP8/2Xw: folds 
AcL/hxc9eT0dCr2TYk/0Dg: calls $1.25
RCqMONFrSPSArZh2Jsar/w: folds 
wGigCmBR/9XWkPpvYos3aQ: folds 
V6p0jQ/RhUsqpHLmXvEX4Q: folds 
+sbyWwIcFp9kP0bDtMegfQ: folds 
Z9W7+g1WMhhZDi7DwGbCFA: folds 
*** FLOP *** [4s 6c Kd]
aIEQGxUJwm61WfazSNFCdA: checks 
AcL/hxc9eT0dCr2TYk/0Dg: checks 
*** TURN *** [4s 6c Kd] [5c]
aIEQGxUJwm61WfazSNFCdA: bets $1.50
AcL/hxc9eT0dCr2TYk/0Dg: folds 
Uncalled bet ($1.50) returned to aIEQGxUJwm61WfazSNFCdA
aIEQGxUJwm61WfazSNFCdA collected $2.75 from pot
aIEQGxUJwm61WfazSNFCdA: doesn't show hand 
*** SUMMARY ***
Total pot $2.85 | Rake $0.10 
Board [4s 6c Kd 5c]
Seat 1: AcL/hxc9eT0dCr2TYk/0Dg folded on the Turn
Seat 2: RCqMONFrSPSArZh2Jsar/w folded before Flop (didn't bet)
Seat 3: wGigCmBR/9XWkPpvYos3aQ folded before Flop (didn't bet)
Seat 4: V6p0jQ/RhUsqpHLmXvEX4Q (button) folded before Flop (didn't bet)
Seat 5: +sbyWwIcFp9kP0bDtMegfQ (small blind) folded before Flop
Seat 6: Z9W7+g1WMhhZDi7DwGbCFA (big blind) folded before Flop
Seat 7: aIEQGxUJwm61WfazSNFCdA collected ($2.75)
Seat 8: 7je+LC5Mfs6nL8YBVh4frQ folded before Flop (didn't bet)
Seat 9: Bb42QRQMhg5/Y0vHP8/2Xw folded before Flop (didn't bet)




PokerStars Game #59941881544:  Hold'em No Limit ($0.10/$0.25) - 2009/07/01 1:49:08 ET
Table 'P1IJQ2p3ACFySC35W1qwQw' 9-max Seat #1 is the button
Seat 1: bXpVeaSTPBFSPJmeXxO7nw ($5.15 in chips) 
Seat 2: vO3QVRovWemcGMkm7ijAIA ($5.10 in chips) 
Seat 3: PVxvfRTRvkgZf9WtquEkwQ ($27.75 in chips) 
Seat 4: c/9X4zftzphFxYtxp5kp9w ($26.30 in chips) 
Seat 5: ghNKXUBl/H+t83JF079ZBA ($56.45 in chips) 
Seat 6: ljemhp25Zg+nlA9DLCIiUw ($64.45 in chips) 
Seat 7: 7je+LC5Mfs6nL8YBVh4frQ ($5.10 in chips) 
Seat 8: tLcDklc2rBORNfixyRfVfw ($26.25 in chips) 
Seat 9: GeMoapCKDLc4ajT0Uk9ZQw ($10 in chips) 
vO3QVRovWemcGMkm7ijAIA: posts small blind $0.10
PVxvfRTRvkgZf9WtquEkwQ: posts big blind $0.25
GeMoapCKDLc4ajT0Uk9ZQw: posts big blind $0.25
*** HOLE CARDS ***
c/9X4zftzphFxYtxp5kp9w: calls $0.25
ghNKXUBl/H+t83JF079ZBA: folds 
ljemhp25Zg+nlA9DLCIiUw: folds 
7je+LC5Mfs6nL8YBVh4frQ: folds 
tLcDklc2rBORNfixyRfVfw: folds 
GeMoapCKDLc4ajT0Uk9ZQw: checks 
bXpVeaSTPBFSPJmeXxO7nw: folds 
vO3QVRovWemcGMkm7ijAIA: calls $0.15
PVxvfRTRvkgZf9WtquEkwQ: checks 
*** FLOP *** [3s 4c Ah]
vO3QVRovWemcGMkm7ijAIA: checks 
PVxvfRTRvkgZf9WtquEkwQ: checks 
c/9X4zftzphFxYtxp5kp9w: bets $0.75
GeMoapCKDLc4ajT0Uk9ZQw: folds 
vO3QVRovWemcGMkm7ijAIA: folds 
PVxvfRTRvkgZf9WtquEkwQ: folds 
Uncalled bet ($0.75) returned to c/9X4zftzphFxYtxp5kp9w
c/9X4zftzphFxYtxp5kp9w collected $0.95 from pot
*** SUMMARY ***
Total pot $1 | Rake $0.05 
Board [3s 4c Ah]
Seat 1: bXpVeaSTPBFSPJmeXxO7nw (button) folded before Flop (didn't bet)
Seat 2: vO3QVRovWemcGMkm7ijAIA (small blind) folded on the Flop
Seat 3: PVxvfRTRvkgZf9WtquEkwQ (big blind) folded on the Flop
Seat 4: c/9X4zftzphFxYtxp5kp9w collected ($0.95)
Seat 5: ghNKXUBl/H+t83JF079ZBA folded before Flop (didn't bet)
Seat 6: ljemhp25Zg+nlA9DLCIiUw folded before Flop (didn't bet)
Seat 7: 7je+LC5Mfs6nL8YBVh4frQ folded before Flop (didn't bet)
Seat 8: tLcDklc2rBORNfixyRfVfw folded before Flop (didn't bet)
Seat 9: GeMoapCKDLc4ajT0Uk9ZQw folded on the Flop




PokerStars Game #59941881936:  Hold'em No Limit ($0.10/$0.25) - 2009/07/01 1:49:09 ET
Table '+giHa6FUL6U5/AZnCJEGvQ' 9-max Seat #6 is the button
Seat 5: zDrucyjVn5aeekNEc3cJrA ($44.40 in chips) 
Seat 6: GTMnTen6sQSoCpS9sggLbg ($25 in chips) 
GTMnTen6sQSoCpS9sggLbg: posts small blind $0.10
zDrucyjVn5aeekNEc3cJrA: posts big blind $0.25
*** HOLE CARDS ***
GTMnTen6sQSoCpS9sggLbg: calls $0.15
zDrucyjVn5aeekNEc3cJrA: checks 
*** FLOP *** [5h Ad 9d]
zDrucyjVn5aeekNEc3cJrA: checks 
GTMnTen6sQSoCpS9sggLbg: checks 
*** TURN *** [5h Ad 9d] [8c]
zDrucyjVn5aeekNEc3cJrA: checks 
GTMnTen6sQSoCpS9sggLbg: checks 
*** RIVER *** [5h Ad 9d 8c] [4h]
zDrucyjVn5aeekNEc3cJrA: bets $1
GTMnTen6sQSoCpS9sggLbg: folds 
Uncalled bet ($1) returned to zDrucyjVn5aeekNEc3cJrA
zDrucyjVn5aeekNEc3cJrA collected $0.50 from pot
*** SUMMARY ***
Total pot $0.50 | Rake $0 
Board [5h Ad 9d 8c 4h]
Seat 5: zDrucyjVn5aeekNEc3cJrA (big blind) collected ($0.50)
Seat 6: GTMnTen6sQSoCpS9sggLbg (button) (small blind) folded on the River




PokerStars Game #59941882086:  Hold'em No Limit ($0.10/$0.25) - 2009/07/01 1:49:09 ET
Table 'fRxOyfaHXkWUDLv4eSxFew' 9-max Seat #4 is the button
Seat 1: 6RiVTYll/5D8zICp0MRpKw ($29.40 in chips) 
Seat 2: M2QO2DxB5Wawg2h8HSpnYA ($10 in chips) 
Seat 3: E0iYnEVO2ho7dH3QcCjw7g ($29.35 in chips) 
Seat 4: MtVtHDqIJTyUcXkRBBDIVA ($27.60 in chips) 
Seat 5: dmYlc+1cjwZMJ7wV+Z0rRg ($22.50 in chips) 
Seat 6: arxNSjreDRGFg13EAM2F1w ($27.05 in chips) 
Seat 7: 1/DuWziR8CXhWB71aPQd9Q ($11.55 in chips) 
Seat 8: 5n7e7I+px7c6CQmLpPbtsg ($5.90 in chips) 
Seat 9: H5Se03ZqSX7tbULXur2MAg ($32.65 in chips) 
dmYlc+1cjwZMJ7wV+Z0rRg: posts small blind $0.10
arxNSjreDRGFg13EAM2F1w: posts big blind $0.25
*** HOLE CARDS ***
1/DuWziR8CXhWB71aPQd9Q: folds 
5n7e7I+px7c6CQmLpPbtsg: folds 
H5Se03ZqSX7tbULXur2MAg: folds 
6RiVTYll/5D8zICp0MRpKw: folds 
M2QO2DxB5Wawg2h8HSpnYA: folds 
E0iYnEVO2ho7dH3QcCjw7g: folds 
MtVtHDqIJTyUcXkRBBDIVA: folds 
dmYlc+1cjwZMJ7wV+Z0rRg: folds 
Uncalled bet ($0.15) returned to arxNSjreDRGFg13EAM2F1w
arxNSjreDRGFg13EAM2F1w collected $0.20 from pot
arxNSjreDRGFg13EAM2F1w: doesn't show hand 
*** SUMMARY ***
Total pot $0.20 | Rake $0 
Seat 1: 6RiVTYll/5D8zICp0MRpKw folded before Flop (didn't bet)
Seat 2: M2QO2DxB5Wawg2h8HSpnYA folded before Flop (didn't bet)
Seat 3: E0iYnEVO2ho7dH3QcCjw7g folded before Flop (didn't bet)
Seat 4: MtVtHDqIJTyUcXkRBBDIVA (button) folded before Flop (didn't bet)
Seat 5: dmYlc+1cjwZMJ7wV+Z0rRg (small blind) folded before Flop
Seat 6: arxNSjreDRGFg13EAM2F1w (big blind) collected ($0.20)
Seat 7: 1/DuWziR8CXhWB71aPQd9Q folded before Flop (didn't bet)
Seat 8: 5n7e7I+px7c6CQmLpPbtsg folded before Flop (didn't bet)
Seat 9: H5Se03ZqSX7tbULXur2MAg folded before Flop (didn't bet)




PokerStars Game #59941882022:  Hold'em No Limit ($0.10/$0.25) - 2009/07/01 1:49:09 ET
Table 'WEMI3Mtn7dGARDbgNrKibgQvLFJzpzymuOsaaRYi+8fgx Seat #5 is the button
Seat 1: cZ99hugmLBj9KhTlc8nCSw ($26.70 in chips) 
Seat 2: PdIasPkzm2sqZnN41ZRXOg ($5 in chips) 
Seat 3: Qduu7ikeizo6q6Ei9YvcJA ($25 in chips) 
Seat 4: tLcDklc2rBORNfixyRfVfw ($25.25 in chips) 
Seat 5: MG90wfSJZnOejs/KD3vlQQ ($36.15 in chips) 
Seat 6: vKdukiQ4ktU4yJ0Xx3MKnA ($7.85 in chips) 
Seat 7: rQhYIYXSyH/IivYM1dlV5A ($11.20 in chips) 
Seat 8: gehe91e0IyVT0QU/XBkEyg ($27.35 in chips) 
Seat 9: BWzInv8o0kN1pJybv/VjpQ ($44.80 in chips) 
vKdukiQ4ktU4yJ0Xx3MKnA: posts small blind $0.10
rQhYIYXSyH/IivYM1dlV5A: posts big blind $0.25
*** HOLE CARDS ***
gehe91e0IyVT0QU/XBkEyg: folds 
BWzInv8o0kN1pJybv/VjpQ: folds 
cZ99hugmLBj9KhTlc8nCSw: folds 
PdIasPkzm2sqZnN41ZRXOg: folds 
Qduu7ikeizo6q6Ei9YvcJA: folds 
tLcDklc2rBORNfixyRfVfw: folds 
MG90wfSJZnOejs/KD3vlQQ: raises $0.50 to $0.75
vKdukiQ4ktU4yJ0Xx3MKnA: calls $0.65
rQhYIYXSyH/IivYM1dlV5A: folds 
*** FLOP *** [9d 2d Jd]
vKdukiQ4ktU4yJ0Xx3MKnA: checks 
MG90wfSJZnOejs/KD3vlQQ: bets $0.80
vKdukiQ4ktU4yJ0Xx3MKnA: folds 
Uncalled bet ($0.80) returned to MG90wfSJZnOejs/KD3vlQQ
MG90wfSJZnOejs/KD3vlQQ collected $1.70 from pot
MG90wfSJZnOejs/KD3vlQQ: doesn't show hand 
*** SUMMARY ***
Total pot $1.75 | Rake $0.05 
Board [9d 2d Jd]
Seat 1: cZ99hugmLBj9KhTlc8nCSw folded before Flop (didn't bet)
Seat 2: PdIasPkzm2sqZnN41ZRXOg folded before Flop (didn't bet)
Seat 3: Qduu7ikeizo6q6Ei9YvcJA folded before Flop (didn't bet)
Seat 4: tLcDklc2rBORNfixyRfVfw folded before Flop (didn't bet)
Seat 5: MG90wfSJZnOejs/KD3vlQQ (button) collected ($1.70)
Seat 6: vKdukiQ4ktU4yJ0Xx3MKnA (small blind) folded on the Flop
Seat 7: rQhYIYXSyH/IivYM1dlV5A (big blind) folded before Flop
Seat 8: gehe91e0IyVT0QU/XBkEyg folded before Flop (didn't bet)
Seat 9: BWzInv8o0kN1pJybv/VjpQ folded before Flop (didn't bet)




PokerStars Game #59941882048:  Hold'em No Limit ($0.10/$0.25) - 2009/07/01 1:49:09 ET
Table 'LG9H161ZAHDkOww+ih3Ptg' 6-max Seat #3 is the button
Seat 1: avl8CO/tc0F6eVSiB/KNRA ($25.85 in chips) 
Seat 2: kwsRmpZ1ZaLooISs+zfyKg ($32.55 in chips) 
Seat 3: 5Evvx7UYqXTBuvIc/9s/hA ($15.20 in chips) 
Seat 4: 0C28L4/59aRNtHoBhqTcLg ($58.60 in chips) 
Seat 5: IDpUHu4U5YRh06nKQqhY8g ($10 in chips) 
Seat 6: v8m8XHovI5tqEA9mvplDSw ($25 in chips) 
0C28L4/59aRNtHoBhqTcLg: posts small blind $0.10
IDpUHu4U5YRh06nKQqhY8g: posts big blind $0.25
*** HOLE CARDS ***
v8m8XHovI5tqEA9mvplDSw: folds 
avl8CO/tc0F6eVSiB/KNRA: folds 
kwsRmpZ1ZaLooISs+zfyKg: folds 
5Evvx7UYqXTBuvIc/9s/hA: folds 
0C28L4/59aRNtHoBhqTcLg: calls $0.15
IDpUHu4U5YRh06nKQqhY8g: checks 
*** FLOP *** [Qd 8c 8s]
0C28L4/59aRNtHoBhqTcLg: checks 
IDpUHu4U5YRh06nKQqhY8g: checks 
*** TURN *** [Qd 8c 8s] [4d]
0C28L4/59aRNtHoBhqTcLg: checks 
IDpUHu4U5YRh06nKQqhY8g: bets $0.25
0C28L4/59aRNtHoBhqTcLg: folds 
Uncalled bet ($0.25) returned to IDpUHu4U5YRh06nKQqhY8g
IDpUHu4U5YRh06nKQqhY8g collected $0.50 from pot
IDpUHu4U5YRh06nKQqhY8g: doesn't show hand 
*** SUMMARY ***
Total pot $0.50 | Rake $0 
Board [Qd 8c 8s 4d]
Seat 1: avl8CO/tc0F6eVSiB/KNRA folded before Flop (didn't bet)
Seat 2: kwsRmpZ1ZaLooISs+zfyKg folded before Flop (didn't bet)
Seat 3: 5Evvx7UYqXTBuvIc/9s/hA (button) folded before Flop (didn't bet)
Seat 4: 0C28L4/59aRNtHoBhqTcLg (small blind) folded on the Turn
Seat 5: IDpUHu4U5YRh06nKQqhY8g (big blind) collected ($0.50)
Seat 6: v8m8XHovI5tqEA9mvplDSw folded before Flop (didn't bet)




PokerStars Game #59941882092:  Hold'em No Limit ($0.10/$0.25) - 2009/07/01 1:49:09 ET
Table 'Pz8SfAzhP5nvWTsJRAxoDg' 6-max Seat #5 is the button
Seat 1: QiL+lEgEWwy21jk/ltaRLg ($47.15 in chips) 
Seat 2: k021eD5in2AjaloW5PalMg ($18.80 in chips) 
Seat 3: mfrkWA3PTeYPkbO6hi98Aw ($31.45 in chips) 
Seat 4: 4lJto+Qj0K4JrFKvHaPTLw ($62.65 in chips) 
Seat 5: FYepjhAvF8ZdVCmqHIy+eQ ($25 in chips) 
Seat 6: QvTX2yGq3uKJiKPmns4TKQ ($17.80 in chips) 
QvTX2yGq3uKJiKPmns4TKQ: posts small blind $0.10
QiL+lEgEWwy21jk/ltaRLg: posts big blind $0.25
*** HOLE CARDS ***
k021eD5in2AjaloW5PalMg: folds 
mfrkWA3PTeYPkbO6hi98Aw: folds 
4lJto+Qj0K4JrFKvHaPTLw: raises $0.75 to $1
FYepjhAvF8ZdVCmqHIy+eQ: folds 
QvTX2yGq3uKJiKPmns4TKQ: folds 
QiL+lEgEWwy21jk/ltaRLg: folds 
Uncalled bet ($0.75) returned to 4lJto+Qj0K4JrFKvHaPTLw
4lJto+Qj0K4JrFKvHaPTLw collected $0.60 from pot
*** SUMMARY ***
Total pot $0.60 | Rake $0 
Seat 1: QiL+lEgEWwy21jk/ltaRLg (big blind) folded before Flop
Seat 2: k021eD5in2AjaloW5PalMg folded before Flop (didn't bet)
Seat 3: mfrkWA3PTeYPkbO6hi98Aw folded before Flop (didn't bet)
Seat 4: 4lJto+Qj0K4JrFKvHaPTLw collected ($0.60)
Seat 5: FYepjhAvF8ZdVCmqHIy+eQ (button) folded before Flop (didn't bet)
Seat 6: QvTX2yGq3uKJiKPmns4TKQ (small blind) folded before Flop




PokerStars Game #59941882148:  Hold'em No Limit ($0.10/$0.25) - 2009/07/01 1:49:09 ET
Table 'xmJKTGBeWCwutccj3YfupQ' 6-max Seat #2 is the button
Seat 1: sVbkVl4OznxBCfi66UB9vw ($40.70 in chips) 
Seat 2: QqiZLFrN8iOUT/GHw7ztOA ($24.65 in chips) 
Seat 3: T5wrp/d5jarm+SxNy8OQAg ($26.10 in chips) 
Seat 4: uWjhTVMpuIroxXcmD3Okug ($16.75 in chips) 
Seat 5: DE9hRlt14g+JdsRQ4wT7hg ($29.60 in chips) 
Seat 6: 9bpVv1/Qh9IYtXuCtl5VtQ ($25 in chips) 
T5wrp/d5jarm+SxNy8OQAg: posts small blind $0.10
uWjhTVMpuIroxXcmD3Okug: posts big blind $0.25
*** HOLE CARDS ***
DE9hRlt14g+JdsRQ4wT7hg: folds 
9bpVv1/Qh9IYtXuCtl5VtQ: folds 
9bpVv1/Qh9IYtXuCtl5VtQ said, "u had nothing aswell"
sVbkVl4OznxBCfi66UB9vw: raises $0.45 to $0.70
QqiZLFrN8iOUT/GHw7ztOA: folds 
T5wrp/d5jarm+SxNy8OQAg: calls $0.60
uWjhTVMpuIroxXcmD3Okug said, "yeah but i didnt call"
uWjhTVMpuIroxXcmD3Okug: folds 
*** FLOP *** [Tc 3d 9s]
uWjhTVMpuIroxXcmD3Okug said, "you did"
T5wrp/d5jarm+SxNy8OQAg: checks 
uWjhTVMpuIroxXcmD3Okug said, "it didnt matter what i had really"
sVbkVl4OznxBCfi66UB9vw: bets $1.60
T5wrp/d5jarm+SxNy8OQAg: folds 
Uncalled bet ($1.60) returned to sVbkVl4OznxBCfi66UB9vw
sVbkVl4OznxBCfi66UB9vw collected $1.60 from pot
sVbkVl4OznxBCfi66UB9vw: doesn't show hand 
*** SUMMARY ***
Total pot $1.65 | Rake $0.05 
Board [Tc 3d 9s]
Seat 1: sVbkVl4OznxBCfi66UB9vw collected ($1.60)
Seat 2: QqiZLFrN8iOUT/GHw7ztOA (button) folded before Flop (didn't bet)
Seat 3: T5wrp/d5jarm+SxNy8OQAg (small blind) folded on the Flop
Seat 4: uWjhTVMpuIroxXcmD3Okug (big blind) folded before Flop
Seat 5: DE9hRlt14g+JdsRQ4wT7hg folded before Flop (didn't bet)
Seat 6: 9bpVv1/Qh9IYtXuCtl5VtQ folded before Flop (didn't bet)




PokerStars Game #59941882302:  Hold'em No Limit ($0.10/$0.25) - 2009/07/01 1:49:10 ET
Table 'wPWRBZPJl1HAnysw7qRR0A' 6-max Seat #5 is the button
Seat 1: m7ne1MOFTQXlsXT7/R/rug ($12.50 in chips) 
Seat 2: xC0kaiDYM6YTlgODL83O5A ($13 in chips) 
Seat 3: 1ZpoLWO2nm2w1Nd1v9Sr3g ($3.50 in chips) 
Seat 4: epAUIB7h2FJXzUPRIvSkRA ($52.80 in chips) 
Seat 5: y0B+UpYpOUJz3JWtlJQBSA ($15.40 in chips) 
Seat 6: VXTONriS+Ohik+r0FeicIw ($25 in chips) 
VXTONriS+Ohik+r0FeicIw: posts small blind $0.10
m7ne1MOFTQXlsXT7/R/rug: posts big blind $0.25
*** HOLE CARDS ***
xC0kaiDYM6YTlgODL83O5A: folds 
1ZpoLWO2nm2w1Nd1v9Sr3g: raises $3.25 to $3.50 and is all-in
epAUIB7h2FJXzUPRIvSkRA: folds 
y0B+UpYpOUJz3JWtlJQBSA: folds 
VXTONriS+Ohik+r0FeicIw: folds 
m7ne1MOFTQXlsXT7/R/rug: folds 
Uncalled bet ($3.25) returned to 1ZpoLWO2nm2w1Nd1v9Sr3g
1ZpoLWO2nm2w1Nd1v9Sr3g collected $0.60 from pot
1ZpoLWO2nm2w1Nd1v9Sr3g: doesn't show hand 
*** SUMMARY ***
Total pot $0.60 | Rake $0 
Seat 1: m7ne1MOFTQXlsXT7/R/rug (big blind) folded before Flop
Seat 2: xC0kaiDYM6YTlgODL83O5A folded before Flop (didn't bet)
Seat 3: 1ZpoLWO2nm2w1Nd1v9Sr3g collected ($0.60)
Seat 4: epAUIB7h2FJXzUPRIvSkRA folded before Flop (didn't bet)
Seat 5: y0B+UpYpOUJz3JWtlJQBSA (button) folded before Flop (didn't bet)
Seat 6: VXTONriS+Ohik+r0FeicIw (small blind) folded before Flop




PokerStars Game #59941882644:  Hold'em No Limit ($0.10/$0.25) - 2009/07/01 1:49:10 ET
Table 'dNYnr4D4id1jwnEU66Yowg' 9-max Seat #7 is the button
Seat 1: 9lvO/qyU+xrU95Teu1fv0g ($4.75 in chips) 
Seat 2: Qduu7ikeizo6q6Ei9YvcJA ($26.05 in chips) 
Seat 3: IOx4EH8+y3jYZJc/LTRvOw ($25.75 in chips) 
Seat 4: VBHxUExRAMrbxUq/cVx9Gw ($5 in chips) 
Seat 5: 7cv+9Zc9HIQHNvYsMfV3uA ($27.05 in chips) 
Seat 6: 8EbrQ/EvFWt2cr0GaU82gQ ($4.15 in chips) 
Seat 7: DiSvPC2iudwL5j9u6Huyww ($25 in chips) 
Seat 8: RCqMONFrSPSArZh2Jsar/w ($33.85 in chips) 
Seat 9: /FE4MKSoQhXaDp4PBoLM2g ($11.85 in chips) 
RCqMONFrSPSArZh2Jsar/w: posts small blind $0.10
/FE4MKSoQhXaDp4PBoLM2g: posts big blind $0.25
*** HOLE CARDS ***
9lvO/qyU+xrU95Teu1fv0g: folds 
Qduu7ikeizo6q6Ei9YvcJA: raises $0.75 to $1
IOx4EH8+y3jYZJc/LTRvOw: calls $1
VBHxUExRAMrbxUq/cVx9Gw: folds 
7cv+9Zc9HIQHNvYsMfV3uA: folds 
8EbrQ/EvFWt2cr0GaU82gQ: folds 
DiSvPC2iudwL5j9u6Huyww: folds 
RCqMONFrSPSArZh2Jsar/w: calls $0.90
/FE4MKSoQhXaDp4PBoLM2g: calls $0.75
*** FLOP *** [5h Qd Th]
RCqMONFrSPSArZh2Jsar/w: checks 
/FE4MKSoQhXaDp4PBoLM2g: checks 
Qduu7ikeizo6q6Ei9YvcJA: checks 
IOx4EH8+y3jYZJc/LTRvOw: checks 
*** TURN *** [5h Qd Th] [2s]
RCqMONFrSPSArZh2Jsar/w: checks 
/FE4MKSoQhXaDp4PBoLM2g: checks 
Qduu7ikeizo6q6Ei9YvcJA: bets $2.25
IOx4EH8+y3jYZJc/LTRvOw: folds 
RCqMONFrSPSArZh2Jsar/w: folds 
/FE4MKSoQhXaDp4PBoLM2g: calls $2.25
*** RIVER *** [5h Qd Th 2s] [6d]
/FE4MKSoQhXaDp4PBoLM2g: checks 
Qduu7ikeizo6q6Ei9YvcJA: bets $4.25
/FE4MKSoQhXaDp4PBoLM2g: calls $4.25
*** SHOW DOWN ***
Qduu7ikeizo6q6Ei9YvcJA: shows [Tc Ad] (a pair of Tens)
/FE4MKSoQhXaDp4PBoLM2g: mucks hand 
Qduu7ikeizo6q6Ei9YvcJA collected $16.20 from pot
*** SUMMARY ***
Total pot $17 | Rake $0.80 
Board [5h Qd Th 2s 6d]
Seat 1: 9lvO/qyU+xrU95Teu1fv0g folded before Flop (didn't bet)
Seat 2: Qduu7ikeizo6q6Ei9YvcJA showed [Tc Ad] and won ($16.20) with a pair of Tens
Seat 3: IOx4EH8+y3jYZJc/LTRvOw folded on the Turn
Seat 4: VBHxUExRAMrbxUq/cVx9Gw folded before Flop (didn't bet)
Seat 5: 7cv+9Zc9HIQHNvYsMfV3uA folded before Flop (didn't bet)
Seat 6: 8EbrQ/EvFWt2cr0GaU82gQ folded before Flop (didn't bet)
Seat 7: DiSvPC2iudwL5j9u6Huyww (button) folded before Flop (didn't bet)
Seat 8: RCqMONFrSPSArZh2Jsar/w (small blind) folded on the Turn
Seat 9: /FE4MKSoQhXaDp4PBoLM2g (big blind) mucked




PokerStars Game #59941882490:  Hold'em No Limit ($0.10/$0.25) - 2009/07/01 1:49:10 ET
Table '4hfTdIVT/qPsJNfWXLsVIw' 9-max Seat #2 is the button
Seat 1: GbHFBbLqLGz0Pwn6CJeAuw ($38.20 in chips) 
Seat 2: Pt637jKksB5MzP0UNJAAkw ($39.85 in chips) 
Seat 3: xnVwSkROfRtOw4eSoDANtw ($2.20 in chips) 
Seat 4: 3PmVnC/15cl4oyI1TKIt4g ($5.85 in chips) 
Seat 5: dtZ84flFEi4Q+SGrHMJRDQ ($25.10 in chips) 
Seat 6: VWUWpMLMj/Q1jRVpF7Aohw ($12.90 in chips) 
Seat 7: d7YasxuGLPiL7pj8IcGThw ($5.70 in chips) 
Seat 8: 7cv+9Zc9HIQHNvYsMfV3uA ($33.30 in chips) 
Seat 9: 9njEKzpOKC62MllUFUBWrA ($24 in chips) 
xnVwSkROfRtOw4eSoDANtw: posts small blind $0.10
3PmVnC/15cl4oyI1TKIt4g: posts big blind $0.25
*** HOLE CARDS ***
dtZ84flFEi4Q+SGrHMJRDQ: raises $0.75 to $1
VWUWpMLMj/Q1jRVpF7Aohw: folds 
d7YasxuGLPiL7pj8IcGThw: folds 
7cv+9Zc9HIQHNvYsMfV3uA: folds 
9njEKzpOKC62MllUFUBWrA: calls $1
GbHFBbLqLGz0Pwn6CJeAuw: folds 
Pt637jKksB5MzP0UNJAAkw: folds 
xnVwSkROfRtOw4eSoDANtw: folds 
3PmVnC/15cl4oyI1TKIt4g: folds 
*** FLOP *** [Kh 8d 3d]
dtZ84flFEi4Q+SGrHMJRDQ: checks 
9njEKzpOKC62MllUFUBWrA: checks 
*** TURN *** [Kh 8d 3d] [Qc]
dtZ84flFEi4Q+SGrHMJRDQ: bets $1.25
9njEKzpOKC62MllUFUBWrA: folds 
Uncalled bet ($1.25) returned to dtZ84flFEi4Q+SGrHMJRDQ
dtZ84flFEi4Q+SGrHMJRDQ collected $2.25 from pot
dtZ84flFEi4Q+SGrHMJRDQ: doesn't show hand 
*** SUMMARY ***
Total pot $2.35 | Rake $0.10 
Board [Kh 8d 3d Qc]
Seat 1: GbHFBbLqLGz0Pwn6CJeAuw folded before Flop (didn't bet)
Seat 2: Pt637jKksB5MzP0UNJAAkw (button) folded before Flop (didn't bet)
Seat 3: xnVwSkROfRtOw4eSoDANtw (small blind) folded before Flop
Seat 4: 3PmVnC/15cl4oyI1TKIt4g (big blind) folded before Flop
Seat 5: dtZ84flFEi4Q+SGrHMJRDQ collected ($2.25)
Seat 6: VWUWpMLMj/Q1jRVpF7Aohw folded before Flop (didn't bet)
Seat 7: d7YasxuGLPiL7pj8IcGThw folded before Flop (didn't bet)
Seat 8: 7cv+9Zc9HIQHNvYsMfV3uA folded before Flop (didn't bet)
Seat 9: 9njEKzpOKC62MllUFUBWrA folded on the Turn




PokerStars Game #59941882616:  Hold'em No Limit ($0.10/$0.25) - 2009/07/01 1:49:10 ET
Table 'uFgIyfWPagvEVGEb86da7A' 9-max Seat #6 is the button
Seat 1: CT7Xj/V/O5rBlhtt+RZeFQ ($25.75 in chips) 
Seat 2: o3zvoO+PsqGti+1NZGNRrQ ($1.25 in chips) 
Seat 3: eGAnPT3w+iltM7HF59dzIg ($5.65 in chips) 
Seat 4: IGRfskE1v9H9Bn+fz8AgNQ ($26.90 in chips) 
Seat 5: X78b5v/uhqeXXoAijbw/yg ($28.55 in chips) 
Seat 6: zDrucyjVn5aeekNEc3cJrA ($26.75 in chips) 
Seat 7: 9zx7Mlww974uHUqoiq2eXA ($12.10 in chips) 
Seat 8: uLP/lYn7oKq9xCChBXsXxw ($25.55 in chips) 
Seat 9: sL5EaDXc90Iyxlm8ERXRQw ($18.35 in chips) 
9zx7Mlww974uHUqoiq2eXA: posts small blind $0.10
uLP/lYn7oKq9xCChBXsXxw: posts big blind $0.25
*** HOLE CARDS ***
sL5EaDXc90Iyxlm8ERXRQw: folds 
CT7Xj/V/O5rBlhtt+RZeFQ: folds 
o3zvoO+PsqGti+1NZGNRrQ: folds 
eGAnPT3w+iltM7HF59dzIg: calls $0.25
IGRfskE1v9H9Bn+fz8AgNQ: calls $0.25
X78b5v/uhqeXXoAijbw/yg: folds 
zDrucyjVn5aeekNEc3cJrA: folds 
9zx7Mlww974uHUqoiq2eXA: calls $0.15
uLP/lYn7oKq9xCChBXsXxw: checks 
*** FLOP *** [3h Qs 7c]
9zx7Mlww974uHUqoiq2eXA: checks 
uLP/lYn7oKq9xCChBXsXxw: checks 
eGAnPT3w+iltM7HF59dzIg: checks 
IGRfskE1v9H9Bn+fz8AgNQ: bets $0.75
9zx7Mlww974uHUqoiq2eXA: folds 
uLP/lYn7oKq9xCChBXsXxw: folds 
eGAnPT3w+iltM7HF59dzIg: folds 
Uncalled bet ($0.75) returned to IGRfskE1v9H9Bn+fz8AgNQ
IGRfskE1v9H9Bn+fz8AgNQ collected $0.95 from pot
IGRfskE1v9H9Bn+fz8AgNQ: doesn't show hand 
*** SUMMARY ***
Total pot $1 | Rake $0.05 
Board [3h Qs 7c]
Seat 1: CT7Xj/V/O5rBlhtt+RZeFQ folded before Flop (didn't bet)
Seat 2: o3zvoO+PsqGti+1NZGNRrQ folded before Flop (didn't bet)
Seat 3: eGAnPT3w+iltM7HF59dzIg folded on the Flop
Seat 4: IGRfskE1v9H9Bn+fz8AgNQ collected ($0.95)
Seat 5: X78b5v/uhqeXXoAijbw/yg folded before Flop (didn't bet)
Seat 6: zDrucyjVn5aeekNEc3cJrA (button) folded before Flop (didn't bet)
Seat 7: 9zx7Mlww974uHUqoiq2eXA (small blind) folded on the Flop
Seat 8: uLP/lYn7oKq9xCChBXsXxw (big blind) folded on the Flop
Seat 9: sL5EaDXc90Iyxlm8ERXRQw folded before Flop (didn't bet)




PokerStars Game #59941882458:  Hold'em No Limit ($0.10/$0.25) - 2009/07/01 1:49:10 ET
Table 'T/iCKJXGphRN3xcdwfE/JQ' 6-max Seat #1 is the button
Seat 1: wAKC8C/zN0c8V5v13dm9mA ($26.15 in chips) 
Seat 2: EeUZtMU058v2ObUACOF4Og ($31.75 in chips) 
Seat 3: IWAjoCPXtc1XUaZdp+pCpA ($22.10 in chips) 
Seat 6: Ey4Kn6PlnYb2srYYBJHvzg ($21.15 in chips) 
EeUZtMU058v2ObUACOF4Og: posts small blind $0.10
IWAjoCPXtc1XUaZdp+pCpA: posts big blind $0.25
m2yWOKfAxqHoy5DDN87Ttw: sits out 
*** HOLE CARDS ***
gaPMxLGp9SOj4Lq6t+/0Ig leaves the table
Ey4Kn6PlnYb2srYYBJHvzg: folds 
wAKC8C/zN0c8V5v13dm9mA: folds 
EeUZtMU058v2ObUACOF4Og: folds 
Uncalled bet ($0.15) returned to IWAjoCPXtc1XUaZdp+pCpA
IWAjoCPXtc1XUaZdp+pCpA collected $0.20 from pot
*** SUMMARY ***
Total pot $0.20 | Rake $0 
Seat 1: wAKC8C/zN0c8V5v13dm9mA (button) folded before Flop (didn't bet)
Seat 2: EeUZtMU058v2ObUACOF4Og (small blind) folded before Flop
Seat 3: IWAjoCPXtc1XUaZdp+pCpA (big blind) collected ($0.20)
Seat 6: Ey4Kn6PlnYb2srYYBJHvzg folded before Flop (didn't bet)




PokerStars Game #59941883308:  Hold'em No Limit ($0.10/$0.25) - 2009/07/01 1:49:11 ET
Table 'KAnP7XvDtlku47YfJwdOVw' 9-max Seat #2 is the button
Seat 1: cH3q40adP+kFogl+2MtbkQ ($15 in chips) 
Seat 2: E0iYnEVO2ho7dH3QcCjw7g ($21.50 in chips) 
Seat 3: W6tExOcYX7qiy6Qdp+ZwFA ($7.35 in chips) 
Seat 4: 18G4P1XstjNvItdGUITxgw ($25 in chips) 
Seat 5: MG90wfSJZnOejs/KD3vlQQ ($34 in chips) 
Seat 7: Lro4e37x4FUa5P3yzDjskw ($6.55 in chips) 
Seat 8: OneeONzF0MoH0pEdcBndwA ($22.45 in chips) 
Seat 9: HDDm1BkZtdsRyw2DJdqq6A ($21.30 in chips) 
W6tExOcYX7qiy6Qdp+ZwFA: posts small blind $0.10
18G4P1XstjNvItdGUITxgw: posts big blind $0.25
*** HOLE CARDS ***
MG90wfSJZnOejs/KD3vlQQ: folds 
Lro4e37x4FUa5P3yzDjskw: raises $0.25 to $0.50
OneeONzF0MoH0pEdcBndwA: folds 
HDDm1BkZtdsRyw2DJdqq6A: folds 
cH3q40adP+kFogl+2MtbkQ: folds 
E0iYnEVO2ho7dH3QcCjw7g: calls $0.50
W6tExOcYX7qiy6Qdp+ZwFA: folds 
18G4P1XstjNvItdGUITxgw: folds 
*** FLOP *** [5s 8h 4d]
Lro4e37x4FUa5P3yzDjskw: bets $1
E0iYnEVO2ho7dH3QcCjw7g: calls $1
*** TURN *** [5s 8h 4d] [2d]
Lro4e37x4FUa5P3yzDjskw: bets $1
z5GxcHlYz/GSz6W2uFiTtg has returned
E0iYnEVO2ho7dH3QcCjw7g: calls $1
*** RIVER *** [5s 8h 4d 2d] [Kh]
Lro4e37x4FUa5P3yzDjskw: bets $1.50
E0iYnEVO2ho7dH3QcCjw7g: folds 
Uncalled bet ($1.50) returned to Lro4e37x4FUa5P3yzDjskw
Lro4e37x4FUa5P3yzDjskw collected $5.10 from pot
*** SUMMARY ***
Total pot $5.35 | Rake $0.25 
Board [5s 8h 4d 2d Kh]
Seat 1: cH3q40adP+kFogl+2MtbkQ folded before Flop (didn't bet)
Seat 2: E0iYnEVO2ho7dH3QcCjw7g (button) folded on the River
Seat 3: W6tExOcYX7qiy6Qdp+ZwFA (small blind) folded before Flop
Seat 4: 18G4P1XstjNvItdGUITxgw (big blind) folded before Flop
Seat 5: MG90wfSJZnOejs/KD3vlQQ folded before Flop (didn't bet)
Seat 7: Lro4e37x4FUa5P3yzDjskw collected ($5.10)
Seat 8: OneeONzF0MoH0pEdcBndwA folded before Flop (didn't bet)
Seat 9: HDDm1BkZtdsRyw2DJdqq6A folded before Flop (didn't bet)




PokerStars Game #59941883072:  Hold'em No Limit ($0.10/$0.25) - 2009/07/01 1:49:11 ET
Table 'WjNvuuSgTjm8jh0j9vcCgQ' 9-max Seat #3 is the button
Seat 1: q+Qdg0Hoir+SyL7haBrUnw ($7.70 in chips) 
Seat 2: ghNKXUBl/H+t83JF079ZBA ($24.90 in chips) 
Seat 3: pSKReiGBNW9NsF2jAZnlwg ($22.30 in chips) 
Seat 4: X78b5v/uhqeXXoAijbw/yg ($31.10 in chips) 
Seat 5: ziFpkH3wCzqB/qXeq/Hy7g ($26.95 in chips) 
Seat 6: ubsjZomMWSV0hAiBLa7K1A ($20.60 in chips) 
Seat 7: NSX8YOj+RznxoL+rO1YU4w ($16.90 in chips) 
Seat 9: CT7Xj/V/O5rBlhtt+RZeFQ ($25.25 in chips) 
X78b5v/uhqeXXoAijbw/yg: posts small blind $0.10
ziFpkH3wCzqB/qXeq/Hy7g: posts big blind $0.25
clJsV3v77RS07bDKY+705w: sits out 
*** HOLE CARDS ***
ubsjZomMWSV0hAiBLa7K1A: folds 
NSX8YOj+RznxoL+rO1YU4w: calls $0.25
CT7Xj/V/O5rBlhtt+RZeFQ: folds 
q+Qdg0Hoir+SyL7haBrUnw: folds 
ghNKXUBl/H+t83JF079ZBA: folds 
pSKReiGBNW9NsF2jAZnlwg: calls $0.25
X78b5v/uhqeXXoAijbw/yg: folds 
ziFpkH3wCzqB/qXeq/Hy7g: checks 
*** FLOP *** [Ks Jh Jc]
ziFpkH3wCzqB/qXeq/Hy7g: checks 
NSX8YOj+RznxoL+rO1YU4w: checks 
pSKReiGBNW9NsF2jAZnlwg: checks 
*** TURN *** [Ks Jh Jc] [Kd]
ziFpkH3wCzqB/qXeq/Hy7g: checks 
NSX8YOj+RznxoL+rO1YU4w: bets $0.50
pSKReiGBNW9NsF2jAZnlwg: calls $0.50
ziFpkH3wCzqB/qXeq/Hy7g: folds 
*** RIVER *** [Ks Jh Jc Kd] [6s]
NSX8YOj+RznxoL+rO1YU4w: bets $0.50
pSKReiGBNW9NsF2jAZnlwg: calls $0.50
*** SHOW DOWN ***
NSX8YOj+RznxoL+rO1YU4w: shows [Ts Jd] (a full house, Jacks full of Kings)
pSKReiGBNW9NsF2jAZnlwg: mucks hand 
NSX8YOj+RznxoL+rO1YU4w collected $2.75 from pot
*** SUMMARY ***
Total pot $2.85 | Rake $0.10 
Board [Ks Jh Jc Kd 6s]
Seat 1: q+Qdg0Hoir+SyL7haBrUnw folded before Flop (didn't bet)
Seat 2: ghNKXUBl/H+t83JF079ZBA folded before Flop (didn't bet)
Seat 3: pSKReiGBNW9NsF2jAZnlwg (button) mucked
Seat 4: X78b5v/uhqeXXoAijbw/yg (small blind) folded before Flop
Seat 5: ziFpkH3wCzqB/qXeq/Hy7g (big blind) folded on the Turn
Seat 6: ubsjZomMWSV0hAiBLa7K1A folded before Flop (didn't bet)
Seat 7: NSX8YOj+RznxoL+rO1YU4w showed [Ts Jd] and won ($2.75) with a full house, Jacks full of Kings
Seat 9: CT7Xj/V/O5rBlhtt+RZeFQ folded before Flop (didn't bet)




PokerStars Game #59941883210:  Hold'em No Limit ($0.10/$0.25) - 2009/07/01 1:49:11 ET
Table 'tANpk8z1C5o0Pq/hpYShHw' 9-max Seat #8 is the button
Seat 1: rQhYIYXSyH/IivYM1dlV5A ($17.50 in chips) 
Seat 2: og4yH4sZUZdC8jjgW8zPJQ ($3.60 in chips) 
Seat 3: zDrucyjVn5aeekNEc3cJrA ($18.55 in chips) 
Seat 4: j4q3p0lesp63b1gZDwLBZw ($5 in chips) 
Seat 5: X6+pSIPfovPcE87t+LmUKQ ($8.55 in chips) 
Seat 6: kN0AWJG6biW8tHtuF+wTjA ($10.30 in chips) 
Seat 7: aNpwfA31EREwO+ar4XzBCw ($26.95 in chips) 
Seat 8: Z9W7+g1WMhhZDi7DwGbCFA ($10 in chips) 
Seat 9: gE5rN2TDY1aXcZn/TOPeZw ($7.20 in chips) 
gE5rN2TDY1aXcZn/TOPeZw: posts small blind $0.10
rQhYIYXSyH/IivYM1dlV5A: posts big blind $0.25
*** HOLE CARDS ***
og4yH4sZUZdC8jjgW8zPJQ: calls $0.25
zDrucyjVn5aeekNEc3cJrA: folds 
j4q3p0lesp63b1gZDwLBZw: folds 
X6+pSIPfovPcE87t+LmUKQ: raises $0.75 to $1
kN0AWJG6biW8tHtuF+wTjA: folds 
aNpwfA31EREwO+ar4XzBCw: folds 
Z9W7+g1WMhhZDi7DwGbCFA: folds 
Z9W7+g1WMhhZDi7DwGbCFA leaves the table
gE5rN2TDY1aXcZn/TOPeZw: calls $0.90
rQhYIYXSyH/IivYM1dlV5A: folds 
og4yH4sZUZdC8jjgW8zPJQ: calls $0.75
*** FLOP *** [8d Qs 5d]
V6p0jQ/RhUsqpHLmXvEX4Q joins the table at seat #8 
gE5rN2TDY1aXcZn/TOPeZw: checks 
og4yH4sZUZdC8jjgW8zPJQ: checks 
X6+pSIPfovPcE87t+LmUKQ: checks 
*** TURN *** [8d Qs 5d] [3d]
gE5rN2TDY1aXcZn/TOPeZw: bets $0.25
og4yH4sZUZdC8jjgW8zPJQ: folds 
X6+pSIPfovPcE87t+LmUKQ: calls $0.25
*** RIVER *** [8d Qs 5d 3d] [9c]
gE5rN2TDY1aXcZn/TOPeZw: bets $0.50
X6+pSIPfovPcE87t+LmUKQ: calls $0.50
*** SHOW DOWN ***
gE5rN2TDY1aXcZn/TOPeZw: shows [Th Qh] (a pair of Queens)
X6+pSIPfovPcE87t+LmUKQ: shows [Ac Kc] (high card Ace)
gE5rN2TDY1aXcZn/TOPeZw collected $4.55 from pot
X6+pSIPfovPcE87t+LmUKQ said, "grrr"
*** SUMMARY ***
Total pot $4.75 | Rake $0.20 
Board [8d Qs 5d 3d 9c]
Seat 1: rQhYIYXSyH/IivYM1dlV5A (big blind) folded before Flop
Seat 2: og4yH4sZUZdC8jjgW8zPJQ folded on the Turn
Seat 3: zDrucyjVn5aeekNEc3cJrA folded before Flop (didn't bet)
Seat 4: j4q3p0lesp63b1gZDwLBZw folded before Flop (didn't bet)
Seat 5: X6+pSIPfovPcE87t+LmUKQ showed [Ac Kc] and lost with high card Ace
Seat 6: kN0AWJG6biW8tHtuF+wTjA folded before Flop (didn't bet)
Seat 7: aNpwfA31EREwO+ar4XzBCw folded before Flop (didn't bet)
Seat 8: Z9W7+g1WMhhZDi7DwGbCFA (button) folded before Flop (didn't bet)
Seat 9: gE5rN2TDY1aXcZn/TOPeZw (small blind) showed [Th Qh] and won ($4.55) with a pair of Queens




PokerStars Game #59941883208:  Hold'em No Limit ($0.10/$0.25) - 2009/07/01 1:49:11 ET
Table 'Jz+kWRxWNGk9w24fdQEveA' 9-max Seat #3 is the button
Seat 1: Z9W7+g1WMhhZDi7DwGbCFA ($5 in chips) 
Seat 2: ljemhp25Zg+nlA9DLCIiUw ($37.75 in chips) 
Seat 3: N5sUK8M0br9djLrW97V9pQ ($25.70 in chips) 
Seat 4: HPEB+AtKw1+C/cxU0o1ciw ($28.75 in chips) 
Seat 5: d6eSA7wOH5mRaSyVDVRBLw ($11.75 in chips) 
Seat 6: BXkjaKe7T/rw37TNNtBVwQ ($5.35 in chips) 
Seat 7: wGigCmBR/9XWkPpvYos3aQ ($27.35 in chips) 
Seat 8: j4q3p0lesp63b1gZDwLBZw ($5 in chips) 
Seat 9: V6p0jQ/RhUsqpHLmXvEX4Q ($17.35 in chips) 
HPEB+AtKw1+C/cxU0o1ciw: posts small blind $0.10
d6eSA7wOH5mRaSyVDVRBLw: posts big blind $0.25
*** HOLE CARDS ***
BXkjaKe7T/rw37TNNtBVwQ: calls $0.25
wGigCmBR/9XWkPpvYos3aQ: folds 
j4q3p0lesp63b1gZDwLBZw: folds 
V6p0jQ/RhUsqpHLmXvEX4Q: folds 
Z9W7+g1WMhhZDi7DwGbCFA: folds 
ljemhp25Zg+nlA9DLCIiUw: folds 
N5sUK8M0br9djLrW97V9pQ: raises $0.75 to $1
HPEB+AtKw1+C/cxU0o1ciw: folds 
d6eSA7wOH5mRaSyVDVRBLw: calls $0.75
BXkjaKe7T/rw37TNNtBVwQ: calls $0.75
*** FLOP *** [Td 2h 2s]
d6eSA7wOH5mRaSyVDVRBLw: checks 
BXkjaKe7T/rw37TNNtBVwQ: checks 
N5sUK8M0br9djLrW97V9pQ: bets $1.75
d6eSA7wOH5mRaSyVDVRBLw: calls $1.75
BXkjaKe7T/rw37TNNtBVwQ: folds 
*** TURN *** [Td 2h 2s] [5c]
d6eSA7wOH5mRaSyVDVRBLw: checks 
N5sUK8M0br9djLrW97V9pQ: bets $2.50
d6eSA7wOH5mRaSyVDVRBLw: calls $2.50
*** RIVER *** [Td 2h 2s 5c] [Jd]
d6eSA7wOH5mRaSyVDVRBLw: bets $6.50 and is all-in
N5sUK8M0br9djLrW97V9pQ: folds 
Uncalled bet ($6.50) returned to d6eSA7wOH5mRaSyVDVRBLw
d6eSA7wOH5mRaSyVDVRBLw collected $11.05 from pot
d6eSA7wOH5mRaSyVDVRBLw: doesn't show hand 
*** SUMMARY ***
Total pot $11.60 | Rake $0.55 
Board [Td 2h 2s 5c Jd]
Seat 1: Z9W7+g1WMhhZDi7DwGbCFA folded before Flop (didn't bet)
Seat 2: ljemhp25Zg+nlA9DLCIiUw folded before Flop (didn't bet)
Seat 3: N5sUK8M0br9djLrW97V9pQ (button) folded on the River
Seat 4: HPEB+AtKw1+C/cxU0o1ciw (small blind) folded before Flop
Seat 5: d6eSA7wOH5mRaSyVDVRBLw (big blind) collected ($11.05)
Seat 6: BXkjaKe7T/rw37TNNtBVwQ folded on the Flop
Seat 7: wGigCmBR/9XWkPpvYos3aQ folded before Flop (didn't bet)
Seat 8: j4q3p0lesp63b1gZDwLBZw folded before Flop (didn't bet)
Seat 9: V6p0jQ/RhUsqpHLmXvEX4Q folded before Flop (didn't bet)




PokerStars Game #59941883196:  Hold'em No Limit ($0.10/$0.25) - 2009/07/01 1:49:11 ET
Table 'emoxgHTxg9Uqeu06oLzLyg' 6-max Seat #4 is the button
Seat 1: epAUIB7h2FJXzUPRIvSkRA ($25 in chips) 
Seat 2: wIFhgE1PVdX6Xf6aVlSTPg ($28.20 in chips) 
Seat 3: uD5epdBxuyc30pF1dO958Q ($9.65 in chips) 
Seat 4: 3VAbqAWh8ncE2SJOYIx2ZQ ($10 in chips) 
Seat 5: OIjOiBfQstWrK/RuXx7zcw ($8.35 in chips) 
Seat 6: u3Ol7kv1LmvszuHNm9rc6w ($25 in chips) 
OIjOiBfQstWrK/RuXx7zcw: posts small blind $0.10
u3Ol7kv1LmvszuHNm9rc6w: posts big blind $0.25
*** HOLE CARDS ***
epAUIB7h2FJXzUPRIvSkRA: folds 
wIFhgE1PVdX6Xf6aVlSTPg: folds 
uD5epdBxuyc30pF1dO958Q: folds 
3VAbqAWh8ncE2SJOYIx2ZQ: calls $0.25
OIjOiBfQstWrK/RuXx7zcw: calls $0.15
u3Ol7kv1LmvszuHNm9rc6w: checks 
*** FLOP *** [2c 3d 3s]
OIjOiBfQstWrK/RuXx7zcw: checks 
u3Ol7kv1LmvszuHNm9rc6w: checks 
3VAbqAWh8ncE2SJOYIx2ZQ: bets $0.25
OIjOiBfQstWrK/RuXx7zcw: calls $0.25
u3Ol7kv1LmvszuHNm9rc6w: calls $0.25
*** TURN *** [2c 3d 3s] [Th]
OIjOiBfQstWrK/RuXx7zcw: checks 
u3Ol7kv1LmvszuHNm9rc6w: checks 
3VAbqAWh8ncE2SJOYIx2ZQ: bets $2
OIjOiBfQstWrK/RuXx7zcw: folds 
u3Ol7kv1LmvszuHNm9rc6w: calls $2
*** RIVER *** [2c 3d 3s Th] [8c]
u3Ol7kv1LmvszuHNm9rc6w: checks 
3VAbqAWh8ncE2SJOYIx2ZQ: bets $3.50
u3Ol7kv1LmvszuHNm9rc6w: calls $3.50
*** SHOW DOWN ***
3VAbqAWh8ncE2SJOYIx2ZQ: shows [Ah Ad] (two pair, Aces and Threes)
u3Ol7kv1LmvszuHNm9rc6w: mucks hand 
3VAbqAWh8ncE2SJOYIx2ZQ collected $11.90 from pot
*** SUMMARY ***
Total pot $12.50 | Rake $0.60 
Board [2c 3d 3s Th 8c]
Seat 1: epAUIB7h2FJXzUPRIvSkRA folded before Flop (didn't bet)
Seat 2: wIFhgE1PVdX6Xf6aVlSTPg folded before Flop (didn't bet)
Seat 3: uD5epdBxuyc30pF1dO958Q folded before Flop (didn't bet)
Seat 4: 3VAbqAWh8ncE2SJOYIx2ZQ (button) showed [Ah Ad] and won ($11.90) with two pair, Aces and Threes
Seat 5: OIjOiBfQstWrK/RuXx7zcw (small blind) folded on the Turn
Seat 6: u3Ol7kv1LmvszuHNm9rc6w (big blind) mucked




PokerStars Game #59941883320:  Hold'em No Limit ($0.10/$0.25) - 2009/07/01 1:49:11 ET
Table 'C8mMnVmvkagwolEzTvh07A' 9-max Seat #3 is the button
Seat 1: PqvgxdSg9z5VmrWpbYuz+g ($27.15 in chips) 
Seat 2: Bb42QRQMhg5/Y0vHP8/2Xw ($25.35 in chips) 
Seat 3: Th3FldXKQW6hWVVPahaoOQ ($35.50 in chips) 
Seat 4: dfNim92Z6XK1/h5SFW5vDg ($25 in chips) 
Seat 5: iGMlK+EhUflPB6jKQd95Cg ($25.35 in chips) 
Seat 6: AiXn/9o1EwOPZUHujnh/bA ($18.50 in chips) 
Seat 9: 4awUyiDYTgylQKXZ9faBVA ($37.40 in chips) 
dfNim92Z6XK1/h5SFW5vDg: posts small blind $0.10
iGMlK+EhUflPB6jKQd95Cg: posts big blind $0.25
*** HOLE CARDS ***
AiXn/9o1EwOPZUHujnh/bA: folds 
4awUyiDYTgylQKXZ9faBVA: raises $0.75 to $1
PqvgxdSg9z5VmrWpbYuz+g: calls $1
Bb42QRQMhg5/Y0vHP8/2Xw: folds 
Th3FldXKQW6hWVVPahaoOQ: calls $1
dfNim92Z6XK1/h5SFW5vDg: folds 
iGMlK+EhUflPB6jKQd95Cg: folds 
*** FLOP *** [Ac 3h Jc]
4awUyiDYTgylQKXZ9faBVA: bets $1.75
PqvgxdSg9z5VmrWpbYuz+g: folds 
Th3FldXKQW6hWVVPahaoOQ: folds 
Uncalled bet ($1.75) returned to 4awUyiDYTgylQKXZ9faBVA
4awUyiDYTgylQKXZ9faBVA collected $3.20 from pot
4awUyiDYTgylQKXZ9faBVA: doesn't show hand 
*** SUMMARY ***
Total pot $3.35 | Rake $0.15 
Board [Ac 3h Jc]
Seat 1: PqvgxdSg9z5VmrWpbYuz+g folded on the Flop
Seat 2: Bb42QRQMhg5/Y0vHP8/2Xw folded before Flop (didn't bet)
Seat 3: Th3FldXKQW6hWVVPahaoOQ (button) folded on the Flop
Seat 4: dfNim92Z6XK1/h5SFW5vDg (small blind) folded before Flop
Seat 5: iGMlK+EhUflPB6jKQd95Cg (big blind) folded before Flop
Seat 6: AiXn/9o1EwOPZUHujnh/bA folded before Flop (didn't bet)
Seat 9: 4awUyiDYTgylQKXZ9faBVA collected ($3.20)




PokerStars Game #59941883668:  Hold'em No Limit ($0.10/$0.25) - 2009/07/01 1:49:12 ET
Table 'IRgQPZVA4+IaZZIQshgwyg' 6-max Seat #2 is the button
Seat 1: cezpHJ8FB07dj0xG+LhOvw ($27.55 in chips) 
Seat 2: lquriepNQBhDV5P1SWHhnA ($28.70 in chips) 
Seat 3: DihMHaz4WNETH1bPDe13kA ($27.55 in chips) 
Seat 4: DE9hRlt14g+JdsRQ4wT7hg ($25.60 in chips) 
Seat 5: w43JQj2oYPpKQVG4Yzlq1w ($25 in chips) 
Seat 6: x9/USY6PsmgUGQeluFLKDw ($21.30 in chips) 
DihMHaz4WNETH1bPDe13kA: posts small blind $0.10
DE9hRlt14g+JdsRQ4wT7hg: posts big blind $0.25
*** HOLE CARDS ***
w43JQj2oYPpKQVG4Yzlq1w: folds 
x9/USY6PsmgUGQeluFLKDw: folds 
cezpHJ8FB07dj0xG+LhOvw: folds 
lquriepNQBhDV5P1SWHhnA: folds 
DihMHaz4WNETH1bPDe13kA: folds 
Uncalled bet ($0.15) returned to DE9hRlt14g+JdsRQ4wT7hg
DE9hRlt14g+JdsRQ4wT7hg collected $0.20 from pot
DE9hRlt14g+JdsRQ4wT7hg: doesn't show hand 
*** SUMMARY ***
Total pot $0.20 | Rake $0 
Seat 1: cezpHJ8FB07dj0xG+LhOvw folded before Flop (didn't bet)
Seat 2: lquriepNQBhDV5P1SWHhnA (button) folded before Flop (didn't bet)
Seat 3: DihMHaz4WNETH1bPDe13kA (small blind) folded before Flop
Seat 4: DE9hRlt14g+JdsRQ4wT7hg (big blind) collected ($0.20)
Seat 5: w43JQj2oYPpKQVG4Yzlq1w folded before Flop (didn't bet)
Seat 6: x9/USY6PsmgUGQeluFLKDw folded before Flop (didn't bet)




PokerStars Game #59941883658:  Hold'em No Limit ($0.10/$0.25) - 2009/07/01 1:49:12 ET
Table 'K/f0NNaoGuhSz5DrzgVw7Q' 9-max Seat #2 is the button
Seat 1: sD+TKtt36XiiN6jqHiLwDA ($25.70 in chips) 
Seat 2: zgi+EUykT/pZQpoUG6+oEg ($4.65 in chips) 
Seat 4: 9bCz0uv2nUmznwuI0OjVGw ($11.55 in chips) 
Seat 5: DnDcAdn9P0zGovMERigpFA ($40.95 in chips) 
Seat 6: 3PVK0IdMlq2fElkVzzr4bg ($7.60 in chips) 
Seat 7: egvg3mTBBVzMHnJPIQiKcA ($14.65 in chips) 
Seat 8: RCqMONFrSPSArZh2Jsar/w ($24.65 in chips) 
Seat 9: tLcDklc2rBORNfixyRfVfw ($25 in chips) 
9bCz0uv2nUmznwuI0OjVGw: posts small blind $0.10
DnDcAdn9P0zGovMERigpFA: posts big blind $0.25
*** HOLE CARDS ***
3PVK0IdMlq2fElkVzzr4bg: folds 
egvg3mTBBVzMHnJPIQiKcA: folds 
RCqMONFrSPSArZh2Jsar/w: folds 
tLcDklc2rBORNfixyRfVfw: folds 
sD+TKtt36XiiN6jqHiLwDA: folds 
zgi+EUykT/pZQpoUG6+oEg: folds 
9bCz0uv2nUmznwuI0OjVGw: calls $0.15
DnDcAdn9P0zGovMERigpFA: checks 
*** FLOP *** [Tc Td 7c]
9bCz0uv2nUmznwuI0OjVGw: checks 
DnDcAdn9P0zGovMERigpFA: checks 
*** TURN *** [Tc Td 7c] [7s]
9bCz0uv2nUmznwuI0OjVGw: bets $0.25
DnDcAdn9P0zGovMERigpFA: folds 
Uncalled bet ($0.25) returned to 9bCz0uv2nUmznwuI0OjVGw
9bCz0uv2nUmznwuI0OjVGw collected $0.50 from pot
9bCz0uv2nUmznwuI0OjVGw: doesn't show hand 
*** SUMMARY ***
Total pot $0.50 | Rake $0 
Board [Tc Td 7c 7s]
Seat 1: sD+TKtt36XiiN6jqHiLwDA folded before Flop (didn't bet)
Seat 2: zgi+EUykT/pZQpoUG6+oEg (button) folded before Flop (didn't bet)
Seat 4: 9bCz0uv2nUmznwuI0OjVGw (small blind) collected ($0.50)
Seat 5: DnDcAdn9P0zGovMERigpFA (big blind) folded on the Turn
Seat 6: 3PVK0IdMlq2fElkVzzr4bg folded before Flop (didn't bet)
Seat 7: egvg3mTBBVzMHnJPIQiKcA folded before Flop (didn't bet)
Seat 8: RCqMONFrSPSArZh2Jsar/w folded before Flop (didn't bet)
Seat 9: tLcDklc2rBORNfixyRfVfw folded before Flop (didn't bet)




PokerStars Game #59941884330:  Hold'em No Limit ($0.10/$0.25) - 2009/07/01 1:49:13 ET
Table 'g+mPuNJBCHKE9ents7ZGtg' 6-max Seat #4 is the button
Seat 1: cezpHJ8FB07dj0xG+LhOvw ($58.50 in chips) 
Seat 2: fZQg9veL7Dd/Z04ZTjC+wQ ($64.60 in chips) 
Seat 4: yVrjRIW0SMxgpvqSIPSe/w ($14.60 in chips) 
Seat 5: D3ikCR8c/o9jB5irZ3uGlw ($12 in chips) 
Seat 6: Mn2V28t5aGq2d09z+/o6Fw ($24.85 in chips) 
D3ikCR8c/o9jB5irZ3uGlw: posts small blind $0.10
Mn2V28t5aGq2d09z+/o6Fw: posts big blind $0.25
8CPg15X6IHYR1pWm9ha1Sw: sits out 
*** HOLE CARDS ***
cezpHJ8FB07dj0xG+LhOvw: folds 
fZQg9veL7Dd/Z04ZTjC+wQ: folds 
yVrjRIW0SMxgpvqSIPSe/w: raises $0.75 to $1
D3ikCR8c/o9jB5irZ3uGlw: folds 
Mn2V28t5aGq2d09z+/o6Fw: folds 
Uncalled bet ($0.75) returned to yVrjRIW0SMxgpvqSIPSe/w
yVrjRIW0SMxgpvqSIPSe/w collected $0.60 from pot
*** SUMMARY ***
Total pot $0.60 | Rake $0 
Seat 1: cezpHJ8FB07dj0xG+LhOvw folded before Flop (didn't bet)
Seat 2: fZQg9veL7Dd/Z04ZTjC+wQ folded before Flop (didn't bet)
Seat 4: yVrjRIW0SMxgpvqSIPSe/w (button) collected ($0.60)
Seat 5: D3ikCR8c/o9jB5irZ3uGlw (small blind) folded before Flop
Seat 6: Mn2V28t5aGq2d09z+/o6Fw (big blind) folded before Flop




PokerStars Game #59941884054:  Hold'em No Limit ($0.10/$0.25) - 2009/07/01 1:49:13 ET
Table 'n8mNkPYbe1AIQEkioNesZA' 9-max Seat #2 is the button
Seat 1: 9lvO/qyU+xrU95Teu1fv0g ($5.20 in chips) 
Seat 2: QEbIGci+itdw+re8RM5fZA ($28.95 in chips) 
Seat 3: zDrucyjVn5aeekNEc3cJrA ($18.75 in chips) 
Seat 4: zgi+EUykT/pZQpoUG6+oEg ($5 in chips) 
Seat 5: wGigCmBR/9XWkPpvYos3aQ ($28.40 in chips) 
Seat 6: HPEB+AtKw1+C/cxU0o1ciw ($46.55 in chips) 
Seat 7: vNfw/x/HNt0WgQC8SveThg ($5 in chips) 
Seat 8: aNpwfA31EREwO+ar4XzBCw ($32.20 in chips) 
Seat 9: gehe91e0IyVT0QU/XBkEyg ($28.25 in chips) 
zDrucyjVn5aeekNEc3cJrA: posts small blind $0.10
zgi+EUykT/pZQpoUG6+oEg: posts big blind $0.25
*** HOLE CARDS ***
wGigCmBR/9XWkPpvYos3aQ: folds 
HPEB+AtKw1+C/cxU0o1ciw: folds 
vNfw/x/HNt0WgQC8SveThg: folds 
aNpwfA31EREwO+ar4XzBCw: folds 
gehe91e0IyVT0QU/XBkEyg: folds 
9lvO/qyU+xrU95Teu1fv0g: folds 
QEbIGci+itdw+re8RM5fZA: raises $0.50 to $0.75
zDrucyjVn5aeekNEc3cJrA: folds 
zgi+EUykT/pZQpoUG6+oEg: folds 
Uncalled bet ($0.50) returned to QEbIGci+itdw+re8RM5fZA
QEbIGci+itdw+re8RM5fZA collected $0.60 from pot
QEbIGci+itdw+re8RM5fZA: doesn't show hand 
*** SUMMARY ***
Total pot $0.60 | Rake $0 
Seat 1: 9lvO/qyU+xrU95Teu1fv0g folded before Flop (didn't bet)
Seat 2: QEbIGci+itdw+re8RM5fZA (button) collected ($0.60)
Seat 3: zDrucyjVn5aeekNEc3cJrA (small blind) folded before Flop
Seat 4: zgi+EUykT/pZQpoUG6+oEg (big blind) folded before Flop
Seat 5: wGigCmBR/9XWkPpvYos3aQ folded before Flop (didn't bet)
Seat 6: HPEB+AtKw1+C/cxU0o1ciw folded before Flop (didn't bet)
Seat 7: vNfw/x/HNt0WgQC8SveThg folded before Flop (didn't bet)
Seat 8: aNpwfA31EREwO+ar4XzBCw folded before Flop (didn't bet)
Seat 9: gehe91e0IyVT0QU/XBkEyg folded before Flop (didn't bet)




PokerStars Game #59941884132:  Hold'em No Limit ($0.10/$0.25) - 2009/07/01 1:49:13 ET
Table 'WEMI3Mtn7dGARDbgNrKibg' 9-max Seat #7 is the button
Seat 1: Th3FldXKQW6hWVVPahaoOQ ($30.50 in chips) 
Seat 2: tYsOBqdU1+x+yFI7zHO7hQ ($49.55 in chips) 
Seat 3: qwr38jl5txoR36M7G5qi4A ($10 in chips) 
Seat 4: Z5NNIVvnhb2IJbLcI79WYQ ($10.55 in chips) 
Seat 5: yzPZQFeaQTNf1YK3a0zRIw ($9.30 in chips) 
Seat 6: arxNSjreDRGFg13EAM2F1w ($25.10 in chips) 
Seat 7: DnDcAdn9P0zGovMERigpFA ($54.90 in chips) 
Seat 8: ghNKXUBl/H+t83JF079ZBA ($29.35 in chips) 
Seat 9: 2wcFsZsqEP5w1StUTVzJCg ($4.50 in chips) 
ghNKXUBl/H+t83JF079ZBA: posts small blind $0.10
2wcFsZsqEP5w1StUTVzJCg: posts big blind $0.25
*** HOLE CARDS ***
Th3FldXKQW6hWVVPahaoOQ: folds 
tYsOBqdU1+x+yFI7zHO7hQ: raises $0.75 to $1
qwr38jl5txoR36M7G5qi4A: folds 
Z5NNIVvnhb2IJbLcI79WYQ: folds 
yzPZQFeaQTNf1YK3a0zRIw: folds 
arxNSjreDRGFg13EAM2F1w: folds 
DnDcAdn9P0zGovMERigpFA: folds 
ghNKXUBl/H+t83JF079ZBA: folds 
2wcFsZsqEP5w1StUTVzJCg: folds 
Uncalled bet ($0.75) returned to tYsOBqdU1+x+yFI7zHO7hQ
tYsOBqdU1+x+yFI7zHO7hQ collected $0.60 from pot
tYsOBqdU1+x+yFI7zHO7hQ: doesn't show hand 
*** SUMMARY ***
Total pot $0.60 | Rake $0 
Seat 1: Th3FldXKQW6hWVVPahaoOQ folded before Flop (didn't bet)
Seat 2: tYsOBqdU1+x+yFI7zHO7hQ collected ($0.60)
Seat 3: qwr38jl5txoR36M7G5qi4A folded before Flop (didn't bet)
Seat 4: Z5NNIVvnhb2IJbLcI79WYQ folded before Flop (didn't bet)
Seat 5: yzPZQFeaQTNf1YK3a0zRIw folded before Flop (didn't bet)
Seat 6: arxNSjreDRGFg13EAM2F1w folded before Flop (didn't bet)
Seat 7: DnDcAdn9P0zGovMERigpFA (button) folded before Flop (didn't bet)
Seat 8: ghNKXUBl/H+t83JF079ZBA (small blind) folded before Flop
Seat 9: 2wcFsZsqEP5w1StUTVzJCg (big blind) folded before Flop




PokerStars Game #59941884364:  Hold'em No Limit ($0.10/$0.25) - 2009/07/01 1:49:13 ET
Table 'Do4nrTNDYpK3sQjwFxX+Og' 6-max Seat #2 is the button
Seat 1: 7JrQNOR9wRBxq9ijFhWieg ($36.90 in chips) 
Seat 2: tzMoGl9F0PUr5NibYueeSw ($68.40 in chips) 
Seat 3: TSmua8tGK3sTbwi0ynrW9Q ($26.50 in chips) 
Seat 4: cWc85bEzdRzpUMhRKm8pwQ ($33.05 in chips) 
Seat 5: SxIIgwXYLkwd6m3wLyPTCw ($25 in chips) 
Seat 6: lBoEwOFgzcERLIRUkUoRTw ($23.20 in chips) 
TSmua8tGK3sTbwi0ynrW9Q: posts small blind $0.10
cWc85bEzdRzpUMhRKm8pwQ: posts big blind $0.25
SxIIgwXYLkwd6m3wLyPTCw: posts big blind $0.25
*** HOLE CARDS ***
SxIIgwXYLkwd6m3wLyPTCw: checks 
lBoEwOFgzcERLIRUkUoRTw: folds 
7JrQNOR9wRBxq9ijFhWieg: folds 
tzMoGl9F0PUr5NibYueeSw: raises $0.75 to $1
TSmua8tGK3sTbwi0ynrW9Q: calls $0.90
cWc85bEzdRzpUMhRKm8pwQ: folds 
SxIIgwXYLkwd6m3wLyPTCw: folds 
*** FLOP *** [4d 5h Tc]
TSmua8tGK3sTbwi0ynrW9Q: checks 
tzMoGl9F0PUr5NibYueeSw: bets $1.50
TSmua8tGK3sTbwi0ynrW9Q: calls $1.50
*** TURN *** [4d 5h Tc] [8s]
TSmua8tGK3sTbwi0ynrW9Q: checks 
tzMoGl9F0PUr5NibYueeSw: checks 
*** RIVER *** [4d 5h Tc 8s] [Ks]
TSmua8tGK3sTbwi0ynrW9Q: checks 
tzMoGl9F0PUr5NibYueeSw: checks 
*** SHOW DOWN ***
TSmua8tGK3sTbwi0ynrW9Q: shows [Qs Jh] (high card King)
tzMoGl9F0PUr5NibYueeSw: shows [Td Ad] (a pair of Tens)
tzMoGl9F0PUr5NibYueeSw collected $5.25 from pot
*** SUMMARY ***
Total pot $5.50 | Rake $0.25 
Board [4d 5h Tc 8s Ks]
Seat 1: 7JrQNOR9wRBxq9ijFhWieg folded before Flop (didn't bet)
Seat 2: tzMoGl9F0PUr5NibYueeSw (button) showed [Td Ad] and won ($5.25) with a pair of Tens
Seat 3: TSmua8tGK3sTbwi0ynrW9Q (small blind) showed [Qs Jh] and lost with high card King
Seat 4: cWc85bEzdRzpUMhRKm8pwQ (big blind) folded before Flop
Seat 5: SxIIgwXYLkwd6m3wLyPTCw folded before Flop
Seat 6: lBoEwOFgzcERLIRUkUoRTw folded before Flop (didn't bet)




PokerStars Game #59941884606:  Hold'em No Limit ($0.10/$0.25) - 2009/07/01 1:49:14 ET
Table 'g6ryG70feTw9nNm+XJLuXw' 6-max Seat #6 is the button
Seat 1: v+QfkGiuj9bgtuNoVnDO8w ($34.85 in chips) 
Seat 2: SxIIgwXYLkwd6m3wLyPTCw ($33.90 in chips) 
Seat 3: cezpHJ8FB07dj0xG+LhOvw ($25 in chips) 
Seat 4: GC/9yVD59DUCX7hUI7gcLw ($45 in chips) 
Seat 5: EE16Ua5b1HSsYej5zeXOlA ($25 in chips) 
Seat 6: Mhj3q7cxev+XjXZxEE6/Cw ($25.70 in chips) 
v+QfkGiuj9bgtuNoVnDO8w: posts small blind $0.10
SxIIgwXYLkwd6m3wLyPTCw: posts big blind $0.25
*** HOLE CARDS ***
cezpHJ8FB07dj0xG+LhOvw: raises $0.75 to $1
GC/9yVD59DUCX7hUI7gcLw: folds 
EE16Ua5b1HSsYej5zeXOlA: folds 
Mhj3q7cxev+XjXZxEE6/Cw: folds 
v+QfkGiuj9bgtuNoVnDO8w: folds 
SxIIgwXYLkwd6m3wLyPTCw: folds 
Uncalled bet ($0.75) returned to cezpHJ8FB07dj0xG+LhOvw
cezpHJ8FB07dj0xG+LhOvw collected $0.60 from pot
*** SUMMARY ***
Total pot $0.60 | Rake $0 
Seat 1: v+QfkGiuj9bgtuNoVnDO8w (small blind) folded before Flop
Seat 2: SxIIgwXYLkwd6m3wLyPTCw (big blind) folded before Flop
Seat 3: cezpHJ8FB07dj0xG+LhOvw collected ($0.60)
Seat 4: GC/9yVD59DUCX7hUI7gcLw folded before Flop (didn't bet)
Seat 5: EE16Ua5b1HSsYej5zeXOlA folded before Flop (didn't bet)
Seat 6: Mhj3q7cxev+XjXZxEE6/Cw (button) folded before Flop (didn't bet)




PokerStars Game #59941884672:  Hold'em No Limit ($0.10/$0.25) - 2009/07/01 1:49:14 ET
Table 'MRfAiS/4JSfnUDlCcZo0wAhfHe8uKeSJMyWAjSdM7ROQx Seat #5 is the button
Seat 1: 48oT5xFI+5CHUJlfoGrE4w ($29.90 in chips) 
Seat 2: /gJNBeCkWL4o85/jvlZ4BA ($26.35 in chips) 
Seat 3: FYepjhAvF8ZdVCmqHIy+eQ ($38.85 in chips) 
Seat 4: b4wRQV3APH8irVk6bUFe2Q ($36.60 in chips) 
Seat 5: Q1uciOZPBR/WkAlqa6cL4A ($27.85 in chips) 
Seat 6: df01R5ThvHspD8FgKmaDvQ ($25.10 in chips) 
df01R5ThvHspD8FgKmaDvQ: posts small blind $0.10
48oT5xFI+5CHUJlfoGrE4w: posts big blind $0.25
*** HOLE CARDS ***
/gJNBeCkWL4o85/jvlZ4BA: folds 
FYepjhAvF8ZdVCmqHIy+eQ: folds 
b4wRQV3APH8irVk6bUFe2Q: raises $0.50 to $0.75
Q1uciOZPBR/WkAlqa6cL4A: folds 
df01R5ThvHspD8FgKmaDvQ: folds 
48oT5xFI+5CHUJlfoGrE4w: folds 
Uncalled bet ($0.50) returned to b4wRQV3APH8irVk6bUFe2Q
b4wRQV3APH8irVk6bUFe2Q collected $0.60 from pot
*** SUMMARY ***
Total pot $0.60 | Rake $0 
Seat 1: 48oT5xFI+5CHUJlfoGrE4w (big blind) folded before Flop
Seat 2: /gJNBeCkWL4o85/jvlZ4BA folded before Flop (didn't bet)
Seat 3: FYepjhAvF8ZdVCmqHIy+eQ folded before Flop (didn't bet)
Seat 4: b4wRQV3APH8irVk6bUFe2Q collected ($0.60)
Seat 5: Q1uciOZPBR/WkAlqa6cL4A (button) folded before Flop (didn't bet)
Seat 6: df01R5ThvHspD8FgKmaDvQ (small blind) folded before Flop




PokerStars Game #59941884552:  Hold'em No Limit ($0.10/$0.25) - 2009/07/01 1:49:14 ET
Table 'O6cwjhrMn9pfzx1Ngn5zkQ' 6-max Seat #4 is the button
Seat 1: LJI7A1YgDM7hgh7o56+ReQ ($27.45 in chips) 
Seat 3: EE16Ua5b1HSsYej5zeXOlA ($26.15 in chips) 
Seat 4: mfrkWA3PTeYPkbO6hi98Aw ($24.50 in chips) 
Seat 5: niLn0xUVlqh8If80xRjzCA ($28.15 in chips) 
Seat 6: 4TM16KVgEiQpLi4bVVWbVQ ($32.80 in chips) 
niLn0xUVlqh8If80xRjzCA: posts small blind $0.10
4TM16KVgEiQpLi4bVVWbVQ: posts big blind $0.25
8CPg15X6IHYR1pWm9ha1Sw: sits out 
*** HOLE CARDS ***
LJI7A1YgDM7hgh7o56+ReQ: folds 
EE16Ua5b1HSsYej5zeXOlA: folds 
mfrkWA3PTeYPkbO6hi98Aw: folds 
niLn0xUVlqh8If80xRjzCA: calls $0.15
4TM16KVgEiQpLi4bVVWbVQ: checks 
*** FLOP *** [Qs 2c 8h]
niLn0xUVlqh8If80xRjzCA: checks 
4TM16KVgEiQpLi4bVVWbVQ: checks 
*** TURN *** [Qs 2c 8h] [6c]
niLn0xUVlqh8If80xRjzCA: bets $0.25
4TM16KVgEiQpLi4bVVWbVQ: calls $0.25
*** RIVER *** [Qs 2c 8h 6c] [9h]
niLn0xUVlqh8If80xRjzCA: bets $0.25
4TM16KVgEiQpLi4bVVWbVQ: folds 
Uncalled bet ($0.25) returned to niLn0xUVlqh8If80xRjzCA
niLn0xUVlqh8If80xRjzCA collected $0.95 from pot
niLn0xUVlqh8If80xRjzCA: doesn't show hand 
*** SUMMARY ***
Total pot $1 | Rake $0.05 
Board [Qs 2c 8h 6c 9h]
Seat 1: LJI7A1YgDM7hgh7o56+ReQ folded before Flop (didn't bet)
Seat 3: EE16Ua5b1HSsYej5zeXOlA folded before Flop (didn't bet)
Seat 4: mfrkWA3PTeYPkbO6hi98Aw (button) folded before Flop (didn't bet)
Seat 5: niLn0xUVlqh8If80xRjzCA (small blind) collected ($0.95)
Seat 6: 4TM16KVgEiQpLi4bVVWbVQ (big blind) folded on the River




PokerStars Game #59941884454:  Hold'em No Limit ($0.10/$0.25) - 2009/07/01 1:49:14 ET
Table '2VkNDXXsBj4bSZw/uK5atw' 6-max Seat #4 is the button
Seat 1: xrf8tAXKQHG99HixCot1Iw ($25.25 in chips) 
Seat 3: P+6Z5+8H5/Wyt/jHMovNvQ ($24.65 in chips) 
Seat 4: 4kIRqWKE/N0yUAcWVhLSoQ ($13.65 in chips) 
Seat 5: 7f0OkhFEOf3T+rVOFHRLnw ($20.30 in chips) 
Seat 6: n6UPMnVR4v8LFP0rWP73Fg ($12.95 in chips) 
7f0OkhFEOf3T+rVOFHRLnw: posts small blind $0.10
n6UPMnVR4v8LFP0rWP73Fg: posts big blind $0.25
*** HOLE CARDS ***
xrf8tAXKQHG99HixCot1Iw: folds 
P+6Z5+8H5/Wyt/jHMovNvQ: calls $0.25
GbCVUNssQ7mqsPWr7J4d3w joins the table at seat #2 
4kIRqWKE/N0yUAcWVhLSoQ: folds 
7f0OkhFEOf3T+rVOFHRLnw: calls $0.15
n6UPMnVR4v8LFP0rWP73Fg: checks 
*** FLOP *** [6h Jc Ac]
7f0OkhFEOf3T+rVOFHRLnw: checks 
n6UPMnVR4v8LFP0rWP73Fg: bets $0.50
P+6Z5+8H5/Wyt/jHMovNvQ: folds 
7f0OkhFEOf3T+rVOFHRLnw: calls $0.50
*** TURN *** [6h Jc Ac] [Td]
7f0OkhFEOf3T+rVOFHRLnw: checks 
n6UPMnVR4v8LFP0rWP73Fg: checks 
*** RIVER *** [6h Jc Ac Td] [Kc]
7f0OkhFEOf3T+rVOFHRLnw: bets $1.75
n6UPMnVR4v8LFP0rWP73Fg: folds 
Uncalled bet ($1.75) returned to 7f0OkhFEOf3T+rVOFHRLnw
7f0OkhFEOf3T+rVOFHRLnw collected $1.70 from pot
*** SUMMARY ***
Total pot $1.75 | Rake $0.05 
Board [6h Jc Ac Td Kc]
Seat 1: xrf8tAXKQHG99HixCot1Iw folded before Flop (didn't bet)
Seat 3: P+6Z5+8H5/Wyt/jHMovNvQ folded on the Flop
Seat 4: 4kIRqWKE/N0yUAcWVhLSoQ (button) folded before Flop (didn't bet)
Seat 5: 7f0OkhFEOf3T+rVOFHRLnw (small blind) collected ($1.70)
Seat 6: n6UPMnVR4v8LFP0rWP73Fg (big blind) folded on the River




PokerStars Game #59941884640:  Hold'em No Limit ($0.10/$0.25) - 2009/07/01 1:49:14 ET
Table 'VuY5ej47Cy8nOI3Wogmhzw' 6-max Seat #6 is the button
Seat 1: EeUZtMU058v2ObUACOF4Og ($35.35 in chips) 
Seat 2: AM6Yl+3esmhhMBlSnQhWbg ($13.60 in chips) 
Seat 3: v+QfkGiuj9bgtuNoVnDO8w ($42.80 in chips) 
Seat 4: QqiZLFrN8iOUT/GHw7ztOA ($26.15 in chips) 
Seat 6: +KblIivb6tainScpwm14RQ ($10.95 in chips) 
EeUZtMU058v2ObUACOF4Og: posts small blind $0.10
AM6Yl+3esmhhMBlSnQhWbg: posts big blind $0.25
m2yWOKfAxqHoy5DDN87Ttw: sits out 
*** HOLE CARDS ***
v+QfkGiuj9bgtuNoVnDO8w: folds 
QqiZLFrN8iOUT/GHw7ztOA: raises $0.75 to $1
+KblIivb6tainScpwm14RQ: folds 
EeUZtMU058v2ObUACOF4Og: calls $0.90
AM6Yl+3esmhhMBlSnQhWbg: calls $0.75
*** FLOP *** [5d Tc Jc]
EeUZtMU058v2ObUACOF4Og: checks 
AM6Yl+3esmhhMBlSnQhWbg: bets $2
QqiZLFrN8iOUT/GHw7ztOA: calls $2
EeUZtMU058v2ObUACOF4Og: raises $4 to $6
AM6Yl+3esmhhMBlSnQhWbg: raises $6.60 to $12.60 and is all-in
QqiZLFrN8iOUT/GHw7ztOA: raises $12.55 to $25.15 and is all-in
EeUZtMU058v2ObUACOF4Og: folds 
Uncalled bet ($12.55) returned to QqiZLFrN8iOUT/GHw7ztOA
*** TURN *** [5d Tc Jc] [3h]
*** RIVER *** [5d Tc Jc 3h] [4s]
*** SHOW DOWN ***
AM6Yl+3esmhhMBlSnQhWbg: shows [8h 9h] (high card Jack)
QqiZLFrN8iOUT/GHw7ztOA: shows [6c 7c] (a straight, Three to Seven)
QqiZLFrN8iOUT/GHw7ztOA collected $32.50 from pot
*** SUMMARY ***
Total pot $34.20 | Rake $1.70 
Board [5d Tc Jc 3h 4s]
Seat 1: EeUZtMU058v2ObUACOF4Og (small blind) folded on the Flop
Seat 2: AM6Yl+3esmhhMBlSnQhWbg (big blind) showed [8h 9h] and lost with high card Jack
Seat 3: v+QfkGiuj9bgtuNoVnDO8w folded before Flop (didn't bet)
Seat 4: QqiZLFrN8iOUT/GHw7ztOA showed [6c 7c] and won ($32.50) with a straight, Three to Seven
Seat 6: +KblIivb6tainScpwm14RQ (button) folded before Flop (didn't bet)




PokerStars Game #59941884724:  Hold'em No Limit ($0.10/$0.25) - 2009/07/01 1:49:14 ET
Table 'O5NgMYt6EWbLBozZb3kseg' 6-max Seat #5 is the button
Seat 2: ZZm/rg8aThjE+A2LiItuzA ($9.75 in chips) 
Seat 4: ItRgvLhXTZHvtZowz+dbIw ($12.90 in chips) 
Seat 5: u3Ol7kv1LmvszuHNm9rc6w ($24.65 in chips) 
Seat 6: 3m6VfX7io8SA31qh1zCkgQ ($29.45 in chips) 
3m6VfX7io8SA31qh1zCkgQ: posts small blind $0.10
ZZm/rg8aThjE+A2LiItuzA: posts big blind $0.25
*** HOLE CARDS ***
ItRgvLhXTZHvtZowz+dbIw: folds 
u3Ol7kv1LmvszuHNm9rc6w: folds 
majicjordan joins the table at seat #1 
3m6VfX7io8SA31qh1zCkgQ: raises $0.25 to $0.50
0bf6ZOD3FadOOzjtjXlcRQ joins the table at seat #3 
ZZm/rg8aThjE+A2LiItuzA: calls $0.25
*** FLOP *** [6c 8c 5d]
3m6VfX7io8SA31qh1zCkgQ: bets $0.75
ZZm/rg8aThjE+A2LiItuzA: calls $0.75
*** TURN *** [6c 8c 5d] [Qh]
3m6VfX7io8SA31qh1zCkgQ: checks 
ZZm/rg8aThjE+A2LiItuzA: bets $1.25
3m6VfX7io8SA31qh1zCkgQ: calls $1.25
*** RIVER *** [6c 8c 5d Qh] [Ad]
3m6VfX7io8SA31qh1zCkgQ: checks 
ZZm/rg8aThjE+A2LiItuzA: checks 
*** SHOW DOWN ***
3m6VfX7io8SA31qh1zCkgQ: shows [Js 4d] (high card Ace)
ZZm/rg8aThjE+A2LiItuzA: shows [8d 4h] (a pair of Eights)
ZZm/rg8aThjE+A2LiItuzA collected $4.80 from pot
*** SUMMARY ***
Total pot $5 | Rake $0.20 
Board [6c 8c 5d Qh Ad]
Seat 2: ZZm/rg8aThjE+A2LiItuzA (big blind) showed [8d 4h] and won ($4.80) with a pair of Eights
Seat 4: ItRgvLhXTZHvtZowz+dbIw folded before Flop (didn't bet)
Seat 5: u3Ol7kv1LmvszuHNm9rc6w (button) folded before Flop (didn't bet)
Seat 6: 3m6VfX7io8SA31qh1zCkgQ (small blind) showed [Js 4d] and lost with high card Ace




PokerStars Game #59941885364:  Hold'em No Limit ($0.10/$0.25) - 2009/07/01 1:49:15 ET
Table 'GrYi0DZOHD1EvB+qiLExNw' 9-max Seat #7 is the button
Seat 1: 7je+LC5Mfs6nL8YBVh4frQ ($5 in chips) 
Seat 2: Th3FldXKQW6hWVVPahaoOQ ($46.70 in chips) 
Seat 3: RHqgdFvufLCYe54+qd2gcA ($4.75 in chips) 
Seat 4: 8x95tVlB4uFBVHp71KihMA ($35.75 in chips) 
Seat 5: cZ99hugmLBj9KhTlc8nCSw ($25 in chips) 
Seat 6: arxNSjreDRGFg13EAM2F1w ($25.25 in chips) 
Seat 7: 9lvO/qyU+xrU95Teu1fv0g ($23.20 in chips) 
Seat 9: 5hAPbqNrvJb8PtLiceXtlg ($13.50 in chips) 
5hAPbqNrvJb8PtLiceXtlg: posts small blind $0.10
7je+LC5Mfs6nL8YBVh4frQ: posts big blind $0.25
*** HOLE CARDS ***
Th3FldXKQW6hWVVPahaoOQ: folds 
RHqgdFvufLCYe54+qd2gcA: folds 
8x95tVlB4uFBVHp71KihMA: folds 
cZ99hugmLBj9KhTlc8nCSw: folds 
arxNSjreDRGFg13EAM2F1w: raises $0.50 to $0.75
9lvO/qyU+xrU95Teu1fv0g: folds 
5hAPbqNrvJb8PtLiceXtlg: calls $0.65
7je+LC5Mfs6nL8YBVh4frQ: folds 
*** FLOP *** [Jh Ks Qh]
5hAPbqNrvJb8PtLiceXtlg: bets $1.25
arxNSjreDRGFg13EAM2F1w: folds 
Uncalled bet ($1.25) returned to 5hAPbqNrvJb8PtLiceXtlg
5hAPbqNrvJb8PtLiceXtlg collected $1.70 from pot
*** SUMMARY ***
Total pot $1.75 | Rake $0.05 
Board [Jh Ks Qh]
Seat 1: 7je+LC5Mfs6nL8YBVh4frQ (big blind) folded before Flop
Seat 2: Th3FldXKQW6hWVVPahaoOQ folded before Flop (didn't bet)
Seat 3: RHqgdFvufLCYe54+qd2gcA folded before Flop (didn't bet)
Seat 4: 8x95tVlB4uFBVHp71KihMA folded before Flop (didn't bet)
Seat 5: cZ99hugmLBj9KhTlc8nCSw folded before Flop (didn't bet)
Seat 6: arxNSjreDRGFg13EAM2F1w folded on the Flop
Seat 7: 9lvO/qyU+xrU95Teu1fv0g (button) folded before Flop (didn't bet)
Seat 9: 5hAPbqNrvJb8PtLiceXtlg (small blind) collected ($1.70)




PokerStars Game #59941885076:  Hold'em No Limit ($0.10/$0.25) - 2009/07/01 1:49:15 ET
Table 'Xi38lWH8L2JHRAsKYVX8Qg' 6-max Seat #6 is the button
Seat 1: shP7DFAtX7gXcgMJX/OmRQ ($23 in chips) 
Seat 3: 6DwBRH+xZ12AAZmeAg+aXw ($31.55 in chips) 
Seat 4: kG34n23qFQA3nzdOJTQ1dA ($24.40 in chips) 
Seat 5: 79ID/ub1Pt/mDpCprVmOoA ($77.25 in chips) 
Seat 6: kyRaCIljYA6l33lSKQfNsg ($29.75 in chips) 
shP7DFAtX7gXcgMJX/OmRQ: posts small blind $0.10
6DwBRH+xZ12AAZmeAg+aXw: posts big blind $0.25
*** HOLE CARDS ***
kG34n23qFQA3nzdOJTQ1dA: folds 
79ID/ub1Pt/mDpCprVmOoA: raises $0.50 to $0.75
VOmI0x4dDPnTESZd5B4d1Q has returned
kyRaCIljYA6l33lSKQfNsg: raises $1.75 to $2.50
shP7DFAtX7gXcgMJX/OmRQ: folds 
6DwBRH+xZ12AAZmeAg+aXw: folds 
79ID/ub1Pt/mDpCprVmOoA: folds 
Uncalled bet ($1.75) returned to kyRaCIljYA6l33lSKQfNsg
kyRaCIljYA6l33lSKQfNsg collected $1.85 from pot
*** SUMMARY ***
Total pot $1.85 | Rake $0 
Seat 1: shP7DFAtX7gXcgMJX/OmRQ (small blind) folded before Flop
Seat 3: 6DwBRH+xZ12AAZmeAg+aXw (big blind) folded before Flop
Seat 4: kG34n23qFQA3nzdOJTQ1dA folded before Flop (didn't bet)
Seat 5: 79ID/ub1Pt/mDpCprVmOoA folded before Flop
Seat 6: kyRaCIljYA6l33lSKQfNsg (button) collected ($1.85)




PokerStars Game #59941885072:  Hold'em No Limit ($0.10/$0.25) - 2009/07/01 1:49:15 ET
Table 'LwnjzXstPtSrqrV/oDpnXQ' 9-max Seat #8 is the button
Seat 1: 9YN2IkT2JYYKFErZtZvCtA ($21.20 in chips) 
Seat 2: uLP/lYn7oKq9xCChBXsXxw ($26.65 in chips) 
Seat 3: 7je+LC5Mfs6nL8YBVh4frQ ($3.80 in chips) 
Seat 4: CmngQmkKTp8tkl6GMRTl6w ($8.75 in chips) 
Seat 5: Th3FldXKQW6hWVVPahaoOQ ($26.25 in chips) 
Seat 6: ljemhp25Zg+nlA9DLCIiUw ($39.50 in chips) 
Seat 7: c/Dw/6HyqldTzIRodAIZmg ($13.40 in chips) 
Seat 8: ShXPHWfjhfmAwLgDdm6bRQ ($11.30 in chips) 
Seat 9: q6WfTUAD9mowIP63ASq2Dgz/khFDKGihQjwgoiKKPOeg25 in chips) 
q6WfTUAD9mowIP63ASq2Dgz/khFDKGihQjwgoiKKPOegs small blind $0.10
9YN2IkT2JYYKFErZtZvCtA: posts big blind $0.25
*** HOLE CARDS ***
uLP/lYn7oKq9xCChBXsXxw: folds 
7je+LC5Mfs6nL8YBVh4frQ: folds 
CmngQmkKTp8tkl6GMRTl6w: folds 
Th3FldXKQW6hWVVPahaoOQ: folds 
ljemhp25Zg+nlA9DLCIiUw: folds 
c/Dw/6HyqldTzIRodAIZmg: folds 
ShXPHWfjhfmAwLgDdm6bRQ: folds 
q6WfTUAD9mowIP63ASq2Dgz/khFDKGihQjwgoiKKPOegs 
Uncalled bet ($0.15) returned to 9YN2IkT2JYYKFErZtZvCtA
9YN2IkT2JYYKFErZtZvCtA collected $0.20 from pot
9YN2IkT2JYYKFErZtZvCtA: doesn't show hand 
*** SUMMARY ***
Total pot $0.20 | Rake $0 
Seat 1: 9YN2IkT2JYYKFErZtZvCtA (big blind) collected ($0.20)
Seat 2: uLP/lYn7oKq9xCChBXsXxw folded before Flop (didn't bet)
Seat 3: 7je+LC5Mfs6nL8YBVh4frQ folded before Flop (didn't bet)
Seat 4: CmngQmkKTp8tkl6GMRTl6w folded before Flop (didn't bet)
Seat 5: Th3FldXKQW6hWVVPahaoOQ folded before Flop (didn't bet)
Seat 6: ljemhp25Zg+nlA9DLCIiUw folded before Flop (didn't bet)
Seat 7: c/Dw/6HyqldTzIRodAIZmg folded before Flop (didn't bet)
Seat 8: ShXPHWfjhfmAwLgDdm6bRQ (button) folded before Flop (didn't bet)
Seat 9: q6WfTUAD9mowIP63ASq2Dgz/khFDKGihQjwgoiKKPOegl blind) folded before Flop




PokerStars Game #59941885102:  Hold'em No Limit ($0.10/$0.25) - 2009/07/01 1:49:15 ET
Table 'G26g8jde1eR+mmabeFeSlw' 9-max Seat #2 is the button
Seat 1: wnerYvSRWT9Sm4X3ip/c8w ($24.65 in chips) 
Seat 2: BFYwQ0J4xWUQvouudojivA ($17.45 in chips) 
Seat 3: WKL8nUFr7TumC4EjLyqYzw ($6.25 in chips) 
Seat 4: 8EbrQ/EvFWt2cr0GaU82gQ ($5.75 in chips) 
Seat 5: hJ4uYjNmSZdjrKA8cjZqCA ($34.50 in chips) 
Seat 6: AHGkesF/mi4sDMpqrxBUoA ($8.55 in chips) 
Seat 7: nm4Dj/f+jJEwKVsUnKh73g ($35.50 in chips) 
Seat 8: CvL9Ch1HYCVbTsfpNucitg ($3.50 in chips) 
Seat 9: VWUWpMLMj/Q1jRVpF7Aohw ($13.30 in chips) 
WKL8nUFr7TumC4EjLyqYzw: posts small blind $0.10
8EbrQ/EvFWt2cr0GaU82gQ: posts big blind $0.25
*** HOLE CARDS ***
hJ4uYjNmSZdjrKA8cjZqCA: folds 
AHGkesF/mi4sDMpqrxBUoA: folds 
nm4Dj/f+jJEwKVsUnKh73g: raises $0.25 to $0.50
CvL9Ch1HYCVbTsfpNucitg: folds 
VWUWpMLMj/Q1jRVpF7Aohw: folds 
wnerYvSRWT9Sm4X3ip/c8w: folds 
BFYwQ0J4xWUQvouudojivA: calls $0.50
WKL8nUFr7TumC4EjLyqYzw: calls $0.40
8EbrQ/EvFWt2cr0GaU82gQ: folds 
*** FLOP *** [6h 4c 2c]
WKL8nUFr7TumC4EjLyqYzw: checks 
nm4Dj/f+jJEwKVsUnKh73g: checks 
BFYwQ0J4xWUQvouudojivA: checks 
*** TURN *** [6h 4c 2c] [Qd]
WKL8nUFr7TumC4EjLyqYzw: bets $0.50
nm4Dj/f+jJEwKVsUnKh73g: calls $0.50
BFYwQ0J4xWUQvouudojivA: calls $0.50
*** RIVER *** [6h 4c 2c Qd] [4s]
WKL8nUFr7TumC4EjLyqYzw: bets $0.25
nm4Dj/f+jJEwKVsUnKh73g: raises $0.50 to $0.75
BFYwQ0J4xWUQvouudojivA: calls $0.75
WKL8nUFr7TumC4EjLyqYzw: folds 
*** SHOW DOWN ***
nm4Dj/f+jJEwKVsUnKh73g: shows [Ah Qh] (two pair, Queens and Fours)
BFYwQ0J4xWUQvouudojivA: mucks hand 
nm4Dj/f+jJEwKVsUnKh73g collected $4.80 from pot
*** SUMMARY ***
Total pot $5 | Rake $0.20 
Board [6h 4c 2c Qd 4s]
Seat 1: wnerYvSRWT9Sm4X3ip/c8w folded before Flop (didn't bet)
Seat 2: BFYwQ0J4xWUQvouudojivA (button) mucked
Seat 3: WKL8nUFr7TumC4EjLyqYzw (small blind) folded on the River
Seat 4: 8EbrQ/EvFWt2cr0GaU82gQ (big blind) folded before Flop
Seat 5: hJ4uYjNmSZdjrKA8cjZqCA folded before Flop (didn't bet)
Seat 6: AHGkesF/mi4sDMpqrxBUoA folded before Flop (didn't bet)
Seat 7: nm4Dj/f+jJEwKVsUnKh73g showed [Ah Qh] and won ($4.80) with two pair, Queens and Fours
Seat 8: CvL9Ch1HYCVbTsfpNucitg folded before Flop (didn't bet)
Seat 9: VWUWpMLMj/Q1jRVpF7Aohw folded before Flop (didn't bet)




PokerStars Game #59941885462:  Hold'em No Limit ($0.10/$0.25) - 2009/07/01 1:49:15 ET
Table 'mVdLgAdN9rGe6mMwSrDdGQ' 6-max Seat #3 is the button
Seat 1: OyJ0KTHA5cwh0/yCo1/rdA ($11.10 in chips) 
Seat 2: n9QqWD4tpbongUBX2Oi58w ($3.85 in chips) 
Seat 3: +baiVgI/ETnBARLe5mARCw ($16.25 in chips) 
Seat 4: scNSjC6yyKvvfklSkuzLrw ($17.80 in chips) 
Seat 5: +TMG/MBWpiEnc9t7i07eTA ($24.65 in chips) 
Seat 6: DihMHaz4WNETH1bPDe13kA ($47.80 in chips) 
scNSjC6yyKvvfklSkuzLrw: posts small blind $0.10
+TMG/MBWpiEnc9t7i07eTA: posts big blind $0.25
*** HOLE CARDS ***
DihMHaz4WNETH1bPDe13kA: folds 
OyJ0KTHA5cwh0/yCo1/rdA: folds 
n9QqWD4tpbongUBX2Oi58w: raises $1 to $1.25
+baiVgI/ETnBARLe5mARCw: folds 
scNSjC6yyKvvfklSkuzLrw: calls $1.15
+TMG/MBWpiEnc9t7i07eTA: calls $1
*** FLOP *** [9h 2c Kc]
scNSjC6yyKvvfklSkuzLrw: checks 
+TMG/MBWpiEnc9t7i07eTA: checks 
n9QqWD4tpbongUBX2Oi58w: bets $2.60 and is all-in
scNSjC6yyKvvfklSkuzLrw: raises $2.60 to $5.20
+TMG/MBWpiEnc9t7i07eTA: folds 
Uncalled bet ($2.60) returned to scNSjC6yyKvvfklSkuzLrw
*** TURN *** [9h 2c Kc] [2d]
*** RIVER *** [9h 2c Kc 2d] [9d]
*** SHOW DOWN ***
scNSjC6yyKvvfklSkuzLrw: shows [Ad Ah] (two pair, Aces and Nines)
n9QqWD4tpbongUBX2Oi58w: mucks hand 
scNSjC6yyKvvfklSkuzLrw collected $8.55 from pot
*** SUMMARY ***
Total pot $8.95 | Rake $0.40 
Board [9h 2c Kc 2d 9d]
Seat 1: OyJ0KTHA5cwh0/yCo1/rdA folded before Flop (didn't bet)
Seat 2: n9QqWD4tpbongUBX2Oi58w mucked
Seat 3: +baiVgI/ETnBARLe5mARCw (button) folded before Flop (didn't bet)
Seat 4: scNSjC6yyKvvfklSkuzLrw (small blind) showed [Ad Ah] and won ($8.55) with two pair, Aces and Nines
Seat 5: +TMG/MBWpiEnc9t7i07eTA (big blind) folded on the Flop
Seat 6: DihMHaz4WNETH1bPDe13kA folded before Flop (didn't bet)




PokerStars Game #59941885154:  Hold'em No Limit ($0.10/$0.25) - 2009/07/01 1:49:15 ET
Table '5NipxzzFB2DffzDpddyQoQ' 6-max Seat #5 is the button
Seat 1: W87HPwOk1KtWaYyshBe1gA ($20.65 in chips) 
Seat 2: iauW7L/+7qzAuHow7CD75Q ($4.70 in chips) 
Seat 3: QvTX2yGq3uKJiKPmns4TKQ ($14.20 in chips) 
Seat 4: NTamLAiMZ86c5yM04t96LA ($34 in chips) 
Seat 5: faP2NVl/cFTZ1nE4pXzg8Q ($23.45 in chips) 
Seat 6: 7JqTFMyeNSVWsmp/yW35Tw ($27.05 in chips) 
7JqTFMyeNSVWsmp/yW35Tw: posts small blind $0.10
W87HPwOk1KtWaYyshBe1gA: posts big blind $0.25
*** HOLE CARDS ***
iauW7L/+7qzAuHow7CD75Q: folds 
QvTX2yGq3uKJiKPmns4TKQ: folds 
NTamLAiMZ86c5yM04t96LA said, "i had poket 3s"
NTamLAiMZ86c5yM04t96LA: calls $0.25
faP2NVl/cFTZ1nE4pXzg8Q: calls $0.25
7JqTFMyeNSVWsmp/yW35Tw: raises $2.25 to $2.50
iauW7L/+7qzAuHow7CD75Q said, "bdiddy pushed me out"
W87HPwOk1KtWaYyshBe1gA: folds 
NTamLAiMZ86c5yM04t96LA: calls $2.25
W87HPwOk1KtWaYyshBe1gA is sitting out
faP2NVl/cFTZ1nE4pXzg8Q: calls $2.25
*** FLOP *** [Qd 8s Ad]
7JqTFMyeNSVWsmp/yW35Tw: bets $4
NTamLAiMZ86c5yM04t96LA: calls $4
faP2NVl/cFTZ1nE4pXzg8Q: folds 
*** TURN *** [Qd 8s Ad] [Kd]
7JqTFMyeNSVWsmp/yW35Tw: bets $7.50
NTamLAiMZ86c5yM04t96LA: raises $20 to $27.50 and is all-in
7JqTFMyeNSVWsmp/yW35Tw: calls $13.05 and is all-in
Uncalled bet ($6.95) returned to NTamLAiMZ86c5yM04t96LA
*** RIVER *** [Qd 8s Ad Kd] [8d]
*** SHOW DOWN ***
7JqTFMyeNSVWsmp/yW35Tw: shows [Ah Ac] (a full house, Aces full of Eights)
NTamLAiMZ86c5yM04t96LA: mucks hand 
7JqTFMyeNSVWsmp/yW35Tw collected $54.05 from pot
*** SUMMARY ***
Total pot $56.85 | Rake $2.80 
Board [Qd 8s Ad Kd 8d]
Seat 1: W87HPwOk1KtWaYyshBe1gA (big blind) folded before Flop
Seat 2: iauW7L/+7qzAuHow7CD75Q folded before Flop (didn't bet)
Seat 3: QvTX2yGq3uKJiKPmns4TKQ folded before Flop (didn't bet)
Seat 4: NTamLAiMZ86c5yM04t96LA mucked
Seat 5: faP2NVl/cFTZ1nE4pXzg8Q (button) folded on the Flop
Seat 6: 7JqTFMyeNSVWsmp/yW35Tw (small blind) showed [Ah Ac] and won ($54.05) with a full house, Aces full of Eights




PokerStars Game #59941885832:  Hold'em No Limit ($0.10/$0.25) - 2009/07/01 1:49:16 ET
Table 'zKwHJD0cmKNUure9qQTfFg' 6-max Seat #6 is the button
Seat 1: Hzrn9DZJegEZICufTNYkrg ($18.60 in chips) 
Seat 2: xrf8tAXKQHG99HixCot1Iw ($30.30 in chips) 
Seat 3: m9aw7LBAB5YX2ZqMtMkhqA ($14.25 in chips) 
Seat 4: v+QfkGiuj9bgtuNoVnDO8w ($25 in chips) 
Seat 5: E4AqQ1egsnu0oH2RqsbCmQ ($4.65 in chips) 
Seat 6: edio/rLJ06xeZOfLhoL3UA ($5.50 in chips) 
Hzrn9DZJegEZICufTNYkrg: posts small blind $0.10
xrf8tAXKQHG99HixCot1Iw: posts big blind $0.25
*** HOLE CARDS ***
m9aw7LBAB5YX2ZqMtMkhqA: folds 
v+QfkGiuj9bgtuNoVnDO8w: folds 
E4AqQ1egsnu0oH2RqsbCmQ: folds 
edio/rLJ06xeZOfLhoL3UA: raises $0.75 to $1
Hzrn9DZJegEZICufTNYkrg: folds 
xrf8tAXKQHG99HixCot1Iw: folds 
Uncalled bet ($0.75) returned to edio/rLJ06xeZOfLhoL3UA
edio/rLJ06xeZOfLhoL3UA collected $0.60 from pot
edio/rLJ06xeZOfLhoL3UA: doesn't show hand 
*** SUMMARY ***
Total pot $0.60 | Rake $0 
Seat 1: Hzrn9DZJegEZICufTNYkrg (small blind) folded before Flop
Seat 2: xrf8tAXKQHG99HixCot1Iw (big blind) folded before Flop
Seat 3: m9aw7LBAB5YX2ZqMtMkhqA folded before Flop (didn't bet)
Seat 4: v+QfkGiuj9bgtuNoVnDO8w folded before Flop (didn't bet)
Seat 5: E4AqQ1egsnu0oH2RqsbCmQ folded before Flop (didn't bet)
Seat 6: edio/rLJ06xeZOfLhoL3UA (button) collected ($0.60)




PokerStars Game #59941886272:  Hold'em No Limit ($0.10/$0.25) - 2009/07/01 1:49:17 ET
Table 'FuFyQHmlO/QqQp//rDRrPg' 6-max Seat #2 is the button
Seat 1: jp34e617tIzV8tKIWmfAbA ($27.80 in chips) 
Seat 2: G3h3THGB1j3qdHDVHpnJWg ($37.20 in chips) 
Seat 3: EeUZtMU058v2ObUACOF4Og ($29.35 in chips) 
Seat 4: Ahsa9Yk5NPmCqQstq1EoQA ($15.40 in chips) 
Seat 5: xrf8tAXKQHG99HixCot1Iw ($25.25 in chips) 
Seat 6: 6DwBRH+xZ12AAZmeAg+aXw ($51.10 in chips) 
EeUZtMU058v2ObUACOF4Og: posts small blind $0.10
Ahsa9Yk5NPmCqQstq1EoQA: posts big blind $0.25
*** HOLE CARDS ***
xrf8tAXKQHG99HixCot1Iw: folds 
6DwBRH+xZ12AAZmeAg+aXw: folds 
jp34e617tIzV8tKIWmfAbA: raises $0.50 to $0.75
G3h3THGB1j3qdHDVHpnJWg: folds 
EeUZtMU058v2ObUACOF4Og: folds 
Ahsa9Yk5NPmCqQstq1EoQA: folds 
Uncalled bet ($0.50) returned to jp34e617tIzV8tKIWmfAbA
jp34e617tIzV8tKIWmfAbA collected $0.60 from pot
*** SUMMARY ***
Total pot $0.60 | Rake $0 
Seat 1: jp34e617tIzV8tKIWmfAbA collected ($0.60)
Seat 2: G3h3THGB1j3qdHDVHpnJWg (button) folded before Flop (didn't bet)
Seat 3: EeUZtMU058v2ObUACOF4Og (small blind) folded before Flop
Seat 4: Ahsa9Yk5NPmCqQstq1EoQA (big blind) folded before Flop
Seat 5: xrf8tAXKQHG99HixCot1Iw folded before Flop (didn't bet)
Seat 6: 6DwBRH+xZ12AAZmeAg+aXw folded before Flop (didn't bet)




PokerStars Game #59941886412:  Hold'em No Limit ($0.10/$0.25) - 2009/07/01 1:49:17 ET
Table '9iHhO6FyZVM8XpSc23TIgg' 6-max Seat #6 is the button
Seat 1: NhUN/JpAprdJeamFBgJH1w ($37.05 in chips) 
Seat 2: bJFzs6QmEEnz4miMfSDtcg ($34 in chips) 
Seat 3: TSmua8tGK3sTbwi0ynrW9Q ($25.25 in chips) 
Seat 4: cfJccEfyn6IkquPN08hFsA ($25.40 in chips) 
Seat 5: OMGl+YMGogf2JWIRfT2/Yg ($10 in chips) 
Seat 6: iyZxqznXjv3vtvOJymkoLQ ($33.85 in chips) 
NhUN/JpAprdJeamFBgJH1w: posts small blind $0.10
bJFzs6QmEEnz4miMfSDtcg: posts big blind $0.25
*** HOLE CARDS ***
TSmua8tGK3sTbwi0ynrW9Q: folds 
cfJccEfyn6IkquPN08hFsA: folds 
OMGl+YMGogf2JWIRfT2/Yg: folds 
iyZxqznXjv3vtvOJymkoLQ: folds 
NhUN/JpAprdJeamFBgJH1w: raises $0.50 to $0.75
bJFzs6QmEEnz4miMfSDtcg: folds 
Uncalled bet ($0.50) returned to NhUN/JpAprdJeamFBgJH1w
NhUN/JpAprdJeamFBgJH1w collected $0.50 from pot
NhUN/JpAprdJeamFBgJH1w: doesn't show hand 
*** SUMMARY ***
Total pot $0.50 | Rake $0 
Seat 1: NhUN/JpAprdJeamFBgJH1w (small blind) collected ($0.50)
Seat 2: bJFzs6QmEEnz4miMfSDtcg (big blind) folded before Flop
Seat 3: TSmua8tGK3sTbwi0ynrW9Q folded before Flop (didn't bet)
Seat 4: cfJccEfyn6IkquPN08hFsA folded before Flop (didn't bet)
Seat 5: OMGl+YMGogf2JWIRfT2/Yg folded before Flop (didn't bet)
Seat 6: iyZxqznXjv3vtvOJymkoLQ (button) folded before Flop (didn't bet)




PokerStars Game #59941886002:  Hold'em No Limit ($0.10/$0.25) - 2009/07/01 1:49:17 ET
Table 'isKy4XK8wJM0x735/D4hWA' 6-max Seat #4 is the button
Seat 1: kwsRmpZ1ZaLooISs+zfyKg ($25.10 in chips) 
Seat 2: 6elpmfyt4Zw0yvd8lePSMQ ($38.90 in chips) 
Seat 3: jp34e617tIzV8tKIWmfAbA ($25.70 in chips) 
Seat 4: DFi/Lzkjsfv8QswS80JX9Q ($31.45 in chips) 
Seat 5: lquriepNQBhDV5P1SWHhnA ($25.35 in chips) 
Seat 6: GbCVUNssQ7mqsPWr7J4d3w ($5 in chips) 
lquriepNQBhDV5P1SWHhnA: posts small blind $0.10
GbCVUNssQ7mqsPWr7J4d3w: posts big blind $0.25
*** HOLE CARDS ***
kwsRmpZ1ZaLooISs+zfyKg: folds 
6elpmfyt4Zw0yvd8lePSMQ: folds 
jp34e617tIzV8tKIWmfAbA: raises $0.50 to $0.75
DFi/Lzkjsfv8QswS80JX9Q: folds 
lquriepNQBhDV5P1SWHhnA: folds 
GbCVUNssQ7mqsPWr7J4d3w: folds 
Uncalled bet ($0.50) returned to jp34e617tIzV8tKIWmfAbA
jp34e617tIzV8tKIWmfAbA collected $0.60 from pot
*** SUMMARY ***
Total pot $0.60 | Rake $0 
Seat 1: kwsRmpZ1ZaLooISs+zfyKg folded before Flop (didn't bet)
Seat 2: 6elpmfyt4Zw0yvd8lePSMQ folded before Flop (didn't bet)
Seat 3: jp34e617tIzV8tKIWmfAbA collected ($0.60)
Seat 4: DFi/Lzkjsfv8QswS80JX9Q (button) folded before Flop (didn't bet)
Seat 5: lquriepNQBhDV5P1SWHhnA (small blind) folded before Flop
Seat 6: GbCVUNssQ7mqsPWr7J4d3w (big blind) folded before Flop




PokerStars Game #59941886180:  Hold'em No Limit ($0.10/$0.25) - 2009/07/01 1:49:17 ET
Table 'sgdCtiuCu2BDZhyDi6RzTA' 6-max Seat #3 is the button
Seat 1: 3zD3qLXT1bEffAoWGnc7wg ($35.40 in chips) 
Seat 2: XD1i5m5PvBDnRzJaG/vINw ($24.75 in chips) 
Seat 3: eL3+wCBjFGfQ5FMdIZihwA ($27.55 in chips) 
Seat 4: rVKEgilmMX+EkKzDVvhmxA ($6.35 in chips) 
Seat 5: 0tQitW75xfmVWKldYHjmOQ ($3.05 in chips) 
Seat 6: KODslGU8ikCYS0/29dUkhg ($32.55 in chips) 
rVKEgilmMX+EkKzDVvhmxA: posts small blind $0.10
0tQitW75xfmVWKldYHjmOQ: posts big blind $0.25
*** HOLE CARDS ***
KODslGU8ikCYS0/29dUkhg: calls $0.25
3zD3qLXT1bEffAoWGnc7wg: folds 
XD1i5m5PvBDnRzJaG/vINw: raises $0.50 to $0.75
eL3+wCBjFGfQ5FMdIZihwA: folds 
rVKEgilmMX+EkKzDVvhmxA: folds 
0tQitW75xfmVWKldYHjmOQ: calls $0.50
KODslGU8ikCYS0/29dUkhg: raises $0.50 to $1.25
XD1i5m5PvBDnRzJaG/vINw: calls $0.50
0tQitW75xfmVWKldYHjmOQ: calls $0.50
*** FLOP *** [6s 7c 4h]
0tQitW75xfmVWKldYHjmOQ: checks 
KODslGU8ikCYS0/29dUkhg: bets $1.50
XD1i5m5PvBDnRzJaG/vINw: folds 
0tQitW75xfmVWKldYHjmOQ: folds 
Uncalled bet ($1.50) returned to KODslGU8ikCYS0/29dUkhg
KODslGU8ikCYS0/29dUkhg collected $3.70 from pot
KODslGU8ikCYS0/29dUkhg: doesn't show hand 
*** SUMMARY ***
Total pot $3.85 | Rake $0.15 
Board [6s 7c 4h]
Seat 1: 3zD3qLXT1bEffAoWGnc7wg folded before Flop (didn't bet)
Seat 2: XD1i5m5PvBDnRzJaG/vINw folded on the Flop
Seat 3: eL3+wCBjFGfQ5FMdIZihwA (button) folded before Flop (didn't bet)
Seat 4: rVKEgilmMX+EkKzDVvhmxA (small blind) folded before Flop
Seat 5: 0tQitW75xfmVWKldYHjmOQ (big blind) folded on the Flop
Seat 6: KODslGU8ikCYS0/29dUkhg collected ($3.70)




PokerStars Game #59941886130:  Hold'em No Limit ($0.10/$0.25) - 2009/07/01 1:49:17 ET
Table '3eK1r4Q4BSYFvsKkuTLpIA' 9-max Seat #7 is the button
Seat 1: vSkQm2EelzwRGDDQQk0Fqw ($4.30 in chips) 
Seat 2: aNpwfA31EREwO+ar4XzBCw ($28.10 in chips) 
Seat 3: 56S3mA6Zs3pGR+0p0vUCtg ($35.85 in chips) 
Seat 4: +2kMBNpY4nF1qNCRd8SJLA ($25 in chips) 
Seat 5: 775TiRJajPtN/ucpTmHrXA ($13.55 in chips) 
Seat 6: +HvCCmsGSQeatf+GZ9zk8Q ($29.75 in chips) 
Seat 7: ljemhp25Zg+nlA9DLCIiUw ($24.65 in chips) 
Seat 8: /29aHLC+Q6KCDcNv2bPfAg ($18.05 in chips) 
Seat 9: +sbyWwIcFp9kP0bDtMegfQ ($60.40 in chips) 
/29aHLC+Q6KCDcNv2bPfAg: posts small blind $0.10
+sbyWwIcFp9kP0bDtMegfQ: posts big blind $0.25
*** HOLE CARDS ***
vSkQm2EelzwRGDDQQk0Fqw: folds 
aNpwfA31EREwO+ar4XzBCw: folds 
56S3mA6Zs3pGR+0p0vUCtg: folds 
+2kMBNpY4nF1qNCRd8SJLA: folds 
775TiRJajPtN/ucpTmHrXA: calls $0.25
+HvCCmsGSQeatf+GZ9zk8Q: calls $0.25
ljemhp25Zg+nlA9DLCIiUw: folds 
/29aHLC+Q6KCDcNv2bPfAg: calls $0.15
+sbyWwIcFp9kP0bDtMegfQ: checks 
*** FLOP *** [4d Jd 9s]
/29aHLC+Q6KCDcNv2bPfAg: bets $0.25
+sbyWwIcFp9kP0bDtMegfQ: folds 
775TiRJajPtN/ucpTmHrXA: raises $2.50 to $2.75
+HvCCmsGSQeatf+GZ9zk8Q: folds 
/29aHLC+Q6KCDcNv2bPfAg: calls $2.50
*** TURN *** [4d Jd 9s] [Tc]
/29aHLC+Q6KCDcNv2bPfAg: checks 
775TiRJajPtN/ucpTmHrXA: bets $4.75
/29aHLC+Q6KCDcNv2bPfAg: calls $4.75
*** RIVER *** [4d Jd 9s Tc] [Ts]
/29aHLC+Q6KCDcNv2bPfAg: checks 
775TiRJajPtN/ucpTmHrXA: checks 
*** SHOW DOWN ***
/29aHLC+Q6KCDcNv2bPfAg: shows [Jc 4c] (two pair, Jacks and Tens)
775TiRJajPtN/ucpTmHrXA: shows [Td 8d] (three of a kind, Tens)
775TiRJajPtN/ucpTmHrXA collected $15.25 from pot
*** SUMMARY ***
Total pot $16 | Rake $0.75 
Board [4d Jd 9s Tc Ts]
Seat 1: vSkQm2EelzwRGDDQQk0Fqw folded before Flop (didn't bet)
Seat 2: aNpwfA31EREwO+ar4XzBCw folded before Flop (didn't bet)
Seat 3: 56S3mA6Zs3pGR+0p0vUCtg folded before Flop (didn't bet)
Seat 4: +2kMBNpY4nF1qNCRd8SJLA folded before Flop (didn't bet)
Seat 5: 775TiRJajPtN/ucpTmHrXA showed [Td 8d] and won ($15.25) with three of a kind, Tens
Seat 6: +HvCCmsGSQeatf+GZ9zk8Q folded on the Flop
Seat 7: ljemhp25Zg+nlA9DLCIiUw (button) folded before Flop (didn't bet)
Seat 8: /29aHLC+Q6KCDcNv2bPfAg (small blind) showed [Jc 4c] and lost with two pair, Jacks and Tens
Seat 9: +sbyWwIcFp9kP0bDtMegfQ (big blind) folded on the Flop




PokerStars Game #59941886048:  Hold'em No Limit ($0.10/$0.25) - 2009/07/01 1:49:17 ET
Table 'x7YStLKc8hpt/pTgSetPKA' 9-max Seat #6 is the button
Seat 1: tYsOBqdU1+x+yFI7zHO7hQ ($25.90 in chips) 
Seat 3: S7Ki0P+0AIGPuIfGJjW0gg ($10.60 in chips) 
Seat 4: ydoFOVgzvZv9ZhuWu9rXAw ($5 in chips) 
Seat 5: tLcDklc2rBORNfixyRfVfw ($25 in chips) 
Seat 6: 9YN2IkT2JYYKFErZtZvCtA ($49.25 in chips) 
Seat 7: dtZ84flFEi4Q+SGrHMJRDQ ($25 in chips) 
Seat 8: j4q3p0lesp63b1gZDwLBZw ($6 in chips) 
Seat 9: nm4Dj/f+jJEwKVsUnKh73g ($37.20 in chips) 
dtZ84flFEi4Q+SGrHMJRDQ: posts small blind $0.10
j4q3p0lesp63b1gZDwLBZw: posts big blind $0.25
*** HOLE CARDS ***
nm4Dj/f+jJEwKVsUnKh73g: calls $0.25
tYsOBqdU1+x+yFI7zHO7hQ: folds 
S7Ki0P+0AIGPuIfGJjW0gg: folds 
ydoFOVgzvZv9ZhuWu9rXAw: folds 
tLcDklc2rBORNfixyRfVfw: folds 
9YN2IkT2JYYKFErZtZvCtA: folds 
dtZ84flFEi4Q+SGrHMJRDQ: folds 
j4q3p0lesp63b1gZDwLBZw: checks 
*** FLOP *** [Qs 2s 3s]
j4q3p0lesp63b1gZDwLBZw: checks 
nm4Dj/f+jJEwKVsUnKh73g: bets $0.25
j4q3p0lesp63b1gZDwLBZw: folds 
Uncalled bet ($0.25) returned to nm4Dj/f+jJEwKVsUnKh73g
nm4Dj/f+jJEwKVsUnKh73g collected $0.60 from pot
nm4Dj/f+jJEwKVsUnKh73g: doesn't show hand 
*** SUMMARY ***
Total pot $0.60 | Rake $0 
Board [Qs 2s 3s]
Seat 1: tYsOBqdU1+x+yFI7zHO7hQ folded before Flop (didn't bet)
Seat 3: S7Ki0P+0AIGPuIfGJjW0gg folded before Flop (didn't bet)
Seat 4: ydoFOVgzvZv9ZhuWu9rXAw folded before Flop (didn't bet)
Seat 5: tLcDklc2rBORNfixyRfVfw folded before Flop (didn't bet)
Seat 6: 9YN2IkT2JYYKFErZtZvCtA (button) folded before Flop (didn't bet)
Seat 7: dtZ84flFEi4Q+SGrHMJRDQ (small blind) folded before Flop
Seat 8: j4q3p0lesp63b1gZDwLBZw (big blind) folded on the Flop
Seat 9: nm4Dj/f+jJEwKVsUnKh73g collected ($0.60)




PokerStars Game #59941886318:  Hold'em No Limit ($0.10/$0.25) - 2009/07/01 1:49:17 ET
Table 'KYX9dFNuOA9l2PV46IebqQ' 9-max Seat #7 is the button
Seat 1: qZqVFan2U+GAA/c5LQFbcw ($15.30 in chips) 
Seat 3: Uq3NSX4cIFaXe7pbXQuU+Q ($7.35 in chips) 
Seat 4: ly/lwri2xlF+wmFsvottuQ ($4.75 in chips) 
Seat 5: g7MXhRmNZxv1lIkKkUKa4w ($12.90 in chips) 
Seat 6: 4QYM+pWPc3J+6i8Zv8LvLg ($23.70 in chips) 
Seat 7: FVZtQJMz59M6BoiON/88Xg ($6.60 in chips) 
Seat 8: KRWTiGM4xH+MkvPtJz4+SA ($23.15 in chips) 
Seat 9: 6NECk10orj8iqgD3pZ2A0Q ($6.65 in chips) 
KRWTiGM4xH+MkvPtJz4+SA: posts small blind $0.10
6NECk10orj8iqgD3pZ2A0Q: posts big blind $0.25
GeMoapCKDLc4ajT0Uk9ZQw: sits out 
*** HOLE CARDS ***
qZqVFan2U+GAA/c5LQFbcw: folds 
Uq3NSX4cIFaXe7pbXQuU+Q: raises $1.25 to $1.50
ly/lwri2xlF+wmFsvottuQ: folds 
g7MXhRmNZxv1lIkKkUKa4w: folds 
4QYM+pWPc3J+6i8Zv8LvLg: folds 
FVZtQJMz59M6BoiON/88Xg: folds 
KRWTiGM4xH+MkvPtJz4+SA: folds 
6NECk10orj8iqgD3pZ2A0Q: folds 
Uncalled bet ($1.25) returned to Uq3NSX4cIFaXe7pbXQuU+Q
Uq3NSX4cIFaXe7pbXQuU+Q collected $0.60 from pot
*** SUMMARY ***
Total pot $0.60 | Rake $0 
Seat 1: qZqVFan2U+GAA/c5LQFbcw folded before Flop (didn't bet)
Seat 3: Uq3NSX4cIFaXe7pbXQuU+Q collected ($0.60)
Seat 4: ly/lwri2xlF+wmFsvottuQ folded before Flop (didn't bet)
Seat 5: g7MXhRmNZxv1lIkKkUKa4w folded before Flop (didn't bet)
Seat 6: 4QYM+pWPc3J+6i8Zv8LvLg folded before Flop (didn't bet)
Seat 7: FVZtQJMz59M6BoiON/88Xg (button) folded before Flop (didn't bet)
Seat 8: KRWTiGM4xH+MkvPtJz4+SA (small blind) folded before Flop
Seat 9: 6NECk10orj8iqgD3pZ2A0Q (big blind) folded before Flop




PokerStars Game #59941886370:  Hold'em No Limit ($0.10/$0.25) - 2009/07/01 1:49:17 ET
Table 'edvgY2YQ1I34euq4EVqGnA' 6-max Seat #4 is the button
Seat 1: mvFHK3pE7tCxJEqLjKC70Q ($30.35 in chips) 
Seat 2: Hsvkc0/G2VV78oVmWYXecw ($5.25 in chips) 
Seat 4: TI/C5Q+DEl4fLR3AofwYdg ($23.05 in chips) 
Seat 5: EE16Ua5b1HSsYej5zeXOlA ($56.10 in chips) 
Seat 6: kG34n23qFQA3nzdOJTQ1dA ($71 in chips) 
EE16Ua5b1HSsYej5zeXOlA: posts small blind $0.10
kG34n23qFQA3nzdOJTQ1dA: posts big blind $0.25
*** HOLE CARDS ***
mvFHK3pE7tCxJEqLjKC70Q: folds 
Hsvkc0/G2VV78oVmWYXecw: folds 
TI/C5Q+DEl4fLR3AofwYdg: raises $0.25 to $0.50
EE16Ua5b1HSsYej5zeXOlA: folds 
kG34n23qFQA3nzdOJTQ1dA: calls $0.25
*** FLOP *** [Tc 8c 9d]
kG34n23qFQA3nzdOJTQ1dA: checks 
TI/C5Q+DEl4fLR3AofwYdg: checks 
*** TURN *** [Tc 8c 9d] [9c]
kG34n23qFQA3nzdOJTQ1dA: checks 
TI/C5Q+DEl4fLR3AofwYdg: checks 
*** RIVER *** [Tc 8c 9d 9c] [6c]
kG34n23qFQA3nzdOJTQ1dA: checks 
TI/C5Q+DEl4fLR3AofwYdg: bets $0.50
kG34n23qFQA3nzdOJTQ1dA: folds 
Uncalled bet ($0.50) returned to TI/C5Q+DEl4fLR3AofwYdg
TI/C5Q+DEl4fLR3AofwYdg collected $1.05 from pot
TI/C5Q+DEl4fLR3AofwYdg: doesn't show hand 
*** SUMMARY ***
Total pot $1.10 | Rake $0.05 
Board [Tc 8c 9d 9c 6c]
Seat 1: mvFHK3pE7tCxJEqLjKC70Q folded before Flop (didn't bet)
Seat 2: Hsvkc0/G2VV78oVmWYXecw folded before Flop (didn't bet)
Seat 4: TI/C5Q+DEl4fLR3AofwYdg (button) collected ($1.05)
Seat 5: EE16Ua5b1HSsYej5zeXOlA (small blind) folded before Flop
Seat 6: kG34n23qFQA3nzdOJTQ1dA (big blind) folded on the River




PokerStars Game #59941886710:  Hold'em No Limit ($0.10/$0.25) - 2009/07/01 1:49:18 ET
Table 'QzXakDK7ZHNjgIpoUFGSKQ' 9-max Seat #5 is the button
Seat 1: w1ukf8uPa4+WH561TtVRxA ($25 in chips) 
Seat 2: QEbIGci+itdw+re8RM5fZA ($25 in chips) 
Seat 3: eK8qa6EPcH2zhtbmWSvc9g ($25.30 in chips) 
Seat 4: 12pxJGeALcKLTBryE6kFxA ($14.15 in chips) 
Seat 5: MtVtHDqIJTyUcXkRBBDIVA ($31.20 in chips) 
Seat 6: gehe91e0IyVT0QU/XBkEyg ($25.85 in chips) 
Seat 7: wGigCmBR/9XWkPpvYos3aQ ($29.90 in chips) 
Seat 9: lwrOE80tuooHfIBx/4LUSw ($23.90 in chips) 
gehe91e0IyVT0QU/XBkEyg: posts small blind $0.10
wGigCmBR/9XWkPpvYos3aQ: posts big blind $0.25
Z9W7+g1WMhhZDi7DwGbCFA: sits out 
*** HOLE CARDS ***
lwrOE80tuooHfIBx/4LUSw: calls $0.25
w1ukf8uPa4+WH561TtVRxA: folds 
QEbIGci+itdw+re8RM5fZA: folds 
eK8qa6EPcH2zhtbmWSvc9g: folds 
12pxJGeALcKLTBryE6kFxA: folds 
MtVtHDqIJTyUcXkRBBDIVA: folds 
gehe91e0IyVT0QU/XBkEyg: folds 
wGigCmBR/9XWkPpvYos3aQ: checks 
*** FLOP *** [Qh 5c Jc]
wGigCmBR/9XWkPpvYos3aQ: bets $0.50
lwrOE80tuooHfIBx/4LUSw: calls $0.50
*** TURN *** [Qh 5c Jc] [Ts]
wGigCmBR/9XWkPpvYos3aQ: bets $1.10
lwrOE80tuooHfIBx/4LUSw: calls $1.10
*** RIVER *** [Qh 5c Jc Ts] [9s]
wGigCmBR/9XWkPpvYos3aQ: checks 
lwrOE80tuooHfIBx/4LUSw: bets $1.75
wGigCmBR/9XWkPpvYos3aQ: folds 
Uncalled bet ($1.75) returned to lwrOE80tuooHfIBx/4LUSw
lwrOE80tuooHfIBx/4LUSw collected $3.65 from pot
lwrOE80tuooHfIBx/4LUSw: doesn't show hand 
*** SUMMARY ***
Total pot $3.80 | Rake $0.15 
Board [Qh 5c Jc Ts 9s]
Seat 1: w1ukf8uPa4+WH561TtVRxA folded before Flop (didn't bet)
Seat 2: QEbIGci+itdw+re8RM5fZA folded before Flop (didn't bet)
Seat 3: eK8qa6EPcH2zhtbmWSvc9g folded before Flop (didn't bet)
Seat 4: 12pxJGeALcKLTBryE6kFxA folded before Flop (didn't bet)
Seat 5: MtVtHDqIJTyUcXkRBBDIVA (button) folded before Flop (didn't bet)
Seat 6: gehe91e0IyVT0QU/XBkEyg (small blind) folded before Flop
Seat 7: wGigCmBR/9XWkPpvYos3aQ (big blind) folded on the River
Seat 9: lwrOE80tuooHfIBx/4LUSw collected ($3.65)




PokerStars Game #59941886484:  Hold'em No Limit ($0.10/$0.25) - 2009/07/01 1:49:18 ET
Table 'RPdw09/gGCIP4xFhDWJgXQ' 9-max Seat #2 is the button
Seat 1: aNpwfA31EREwO+ar4XzBCw ($27.50 in chips) 
Seat 2: Sd1tfhUq/M96GhXGv1hwFQ ($8.10 in chips) 
Seat 3: g5LAv1J/3Thw1zs/SEyfzw ($18.50 in chips) 
Seat 5: gehe91e0IyVT0QU/XBkEyg ($31.60 in chips) 
Seat 6: monZeAwXUmIA1l84cUd2hw ($14.50 in chips) 
Seat 7: EP17SQz/iWcuYdNOGeBgkw ($13.40 in chips) 
Seat 8: MG90wfSJZnOejs/KD3vlQQ ($29.80 in chips) 
Seat 9: O02ScVDnDZwH6KjZNJZMzA ($4.40 in chips) 
g5LAv1J/3Thw1zs/SEyfzw: posts small blind $0.10
gehe91e0IyVT0QU/XBkEyg: posts big blind $0.25
*** HOLE CARDS ***
monZeAwXUmIA1l84cUd2hw: calls $0.25
EP17SQz/iWcuYdNOGeBgkw: folds 
MG90wfSJZnOejs/KD3vlQQ: folds 
O02ScVDnDZwH6KjZNJZMzA: folds 
aNpwfA31EREwO+ar4XzBCw: folds 
Sd1tfhUq/M96GhXGv1hwFQ: calls $0.25
g5LAv1J/3Thw1zs/SEyfzw: calls $0.15
gehe91e0IyVT0QU/XBkEyg: checks 
*** FLOP *** [6d 6s Td]
g5LAv1J/3Thw1zs/SEyfzw: checks 
z5GxcHlYz/GSz6W2uFiTtg has returned
gehe91e0IyVT0QU/XBkEyg: checks 
monZeAwXUmIA1l84cUd2hw: checks 
Sd1tfhUq/M96GhXGv1hwFQ: checks 
*** TURN *** [6d 6s Td] [4s]
g5LAv1J/3Thw1zs/SEyfzw: bets $0.25
gehe91e0IyVT0QU/XBkEyg: folds 
monZeAwXUmIA1l84cUd2hw: raises $0.25 to $0.50
Sd1tfhUq/M96GhXGv1hwFQ: folds 
g5LAv1J/3Thw1zs/SEyfzw: calls $0.25
*** RIVER *** [6d 6s Td 4s] [9s]
g5LAv1J/3Thw1zs/SEyfzw: bets $0.75
monZeAwXUmIA1l84cUd2hw: folds 
Uncalled bet ($0.75) returned to g5LAv1J/3Thw1zs/SEyfzw
g5LAv1J/3Thw1zs/SEyfzw collected $1.95 from pot
g5LAv1J/3Thw1zs/SEyfzw: doesn't show hand 
*** SUMMARY ***
Total pot $2 | Rake $0.05 
Board [6d 6s Td 4s 9s]
Seat 1: aNpwfA31EREwO+ar4XzBCw folded before Flop (didn't bet)
Seat 2: Sd1tfhUq/M96GhXGv1hwFQ (button) folded on the Turn
Seat 3: g5LAv1J/3Thw1zs/SEyfzw (small blind) collected ($1.95)
Seat 5: gehe91e0IyVT0QU/XBkEyg (big blind) folded on the Turn
Seat 6: monZeAwXUmIA1l84cUd2hw folded on the River
Seat 7: EP17SQz/iWcuYdNOGeBgkw folded before Flop (didn't bet)
Seat 8: MG90wfSJZnOejs/KD3vlQQ folded before Flop (didn't bet)
Seat 9: O02ScVDnDZwH6KjZNJZMzA folded before Flop (didn't bet)




PokerStars Game #59941886506:  Hold'em No Limit ($0.10/$0.25) - 2009/07/01 1:49:18 ET
Table 'rpIHGyt2QpgQc5bvptAvDQ' 9-max Seat #5 is the button
Seat 1: E0iYnEVO2ho7dH3QcCjw7g ($24.10 in chips) 
Seat 2: FX0yWp7Ul3dMebXB0cFjEw ($5 in chips) 
Seat 3: N6a/f6AW8S8G3JFw9IFxAg ($21.30 in chips) 
Seat 4: ASXDkj9tmvF/T2AsNuxg7g ($5.60 in chips) 
Seat 5: XhSvfX1gy0yx/qeW+SOeTw ($7.55 in chips) 
Seat 6: Mq1ESwxx3LEsA4HjKKjU3Q ($18.75 in chips) 
Seat 7: GHgIdzlzMAmRmmX7jgXtuQ ($0.75 in chips) 
Seat 8: oUgIL46CfA9GCdIuN1TVSw ($8.95 in chips) 
Mq1ESwxx3LEsA4HjKKjU3Q: posts small blind $0.10
GHgIdzlzMAmRmmX7jgXtuQ: posts big blind $0.25
sUVgUtgbfVx6JpvApozwhQ: sits out 
*** HOLE CARDS ***
oUgIL46CfA9GCdIuN1TVSw: calls $0.25
E0iYnEVO2ho7dH3QcCjw7g: folds 
FX0yWp7Ul3dMebXB0cFjEw: folds 
N6a/f6AW8S8G3JFw9IFxAg: folds 
ASXDkj9tmvF/T2AsNuxg7g: raises $0.75 to $1
XhSvfX1gy0yx/qeW+SOeTw: folds 
Mq1ESwxx3LEsA4HjKKjU3Q: folds 
GHgIdzlzMAmRmmX7jgXtuQ: calls $0.50 and is all-in
oUgIL46CfA9GCdIuN1TVSw: folds 
Uncalled bet ($0.25) returned to ASXDkj9tmvF/T2AsNuxg7g
*** FLOP *** [9d 5c Ah]
*** TURN *** [9d 5c Ah] [Jc]
*** RIVER *** [9d 5c Ah Jc] [2h]
*** SHOW DOWN ***
GHgIdzlzMAmRmmX7jgXtuQ: shows [8c 2s] (a pair of Deuces)
ASXDkj9tmvF/T2AsNuxg7g: mucks hand 
GHgIdzlzMAmRmmX7jgXtuQ collected $1.80 from pot
*** SUMMARY ***
Total pot $1.85 | Rake $0.05 
Board [9d 5c Ah Jc 2h]
Seat 1: E0iYnEVO2ho7dH3QcCjw7g folded before Flop (didn't bet)
Seat 2: FX0yWp7Ul3dMebXB0cFjEw folded before Flop (didn't bet)
Seat 3: N6a/f6AW8S8G3JFw9IFxAg folded before Flop (didn't bet)
Seat 4: ASXDkj9tmvF/T2AsNuxg7g mucked
Seat 5: XhSvfX1gy0yx/qeW+SOeTw (button) folded before Flop (didn't bet)
Seat 6: Mq1ESwxx3LEsA4HjKKjU3Q (small blind) folded before Flop
Seat 7: GHgIdzlzMAmRmmX7jgXtuQ (big blind) showed [8c 2s] and won ($1.80) with a pair of Deuces
Seat 8: oUgIL46CfA9GCdIuN1TVSw folded before Flop




PokerStars Game #59941886544:  Hold'em No Limit ($0.10/$0.25) - 2009/07/01 1:49:18 ET
Table 'ORSZkZqq+7Ja2PdeCFAytA' 9-max Seat #7 is the button
Seat 1: 3FkcXBaxKqxYVagfYUZlmw ($16.35 in chips) 
Seat 3: s9a4d23HFxaL70yUWQ0/tQ ($19.10 in chips) 
Seat 4: tbgfV2Egwn85xEt865GWQQ ($17.80 in chips) 
Seat 5: +lWbsq4dTcA70SX/+hnmpg ($5.40 in chips) 
Seat 7: clJsV3v77RS07bDKY+705w ($10.80 in chips) 
Seat 8: npAYqa85pqnzfOK5ukX+BQ ($19.40 in chips) 
Seat 9: cMTFs4oCtNInkpDIecxT/w ($15.95 in chips) 
npAYqa85pqnzfOK5ukX+BQ: posts small blind $0.10
cMTFs4oCtNInkpDIecxT/w: posts big blind $0.25
j4q3p0lesp63b1gZDwLBZw: sits out 
*** HOLE CARDS ***
3FkcXBaxKqxYVagfYUZlmw: raises $0.25 to $0.50
cMTFs4oCtNInkpDIecxT/w said, "no way"
s9a4d23HFxaL70yUWQ0/tQ: folds 
tbgfV2Egwn85xEt865GWQQ: folds 
gMF+EMhmwpnaM5TFQquf2A has returned
+lWbsq4dTcA70SX/+hnmpg: raises $1 to $1.50
clJsV3v77RS07bDKY+705w: folds 
cMTFs4oCtNInkpDIecxT/w said, "nh"
npAYqa85pqnzfOK5ukX+BQ: calls $1.40
cMTFs4oCtNInkpDIecxT/w: folds 
3FkcXBaxKqxYVagfYUZlmw: raises $14.85 to $16.35 and is all-in
+lWbsq4dTcA70SX/+hnmpg: calls $3.90 and is all-in
npAYqa85pqnzfOK5ukX+BQ: folds 
Uncalled bet ($10.95) returned to 3FkcXBaxKqxYVagfYUZlmw
npAYqa85pqnzfOK5ukX+BQ is sitting out
*** FLOP *** [3s Jh 7s]
*** TURN *** [3s Jh 7s] [2c]
*** RIVER *** [3s Jh 7s 2c] [5c]
*** SHOW DOWN ***
3FkcXBaxKqxYVagfYUZlmw: shows [Kd Ks] (a pair of Kings)
+lWbsq4dTcA70SX/+hnmpg: mucks hand 
3FkcXBaxKqxYVagfYUZlmw collected $11.95 from pot
*** SUMMARY ***
Total pot $12.55 | Rake $0.60 
Board [3s Jh 7s 2c 5c]
Seat 1: 3FkcXBaxKqxYVagfYUZlmw showed [Kd Ks] and won ($11.95) with a pair of Kings
Seat 3: s9a4d23HFxaL70yUWQ0/tQ folded before Flop (didn't bet)
Seat 4: tbgfV2Egwn85xEt865GWQQ folded before Flop (didn't bet)
Seat 5: +lWbsq4dTcA70SX/+hnmpg mucked
Seat 7: clJsV3v77RS07bDKY+705w (button) folded before Flop (didn't bet)
Seat 8: npAYqa85pqnzfOK5ukX+BQ (small blind) folded before Flop
Seat 9: cMTFs4oCtNInkpDIecxT/w (big blind) folded before Flop




PokerStars Game #59941887186:  Hold'em No Limit ($0.10/$0.25) - 2009/07/01 1:49:19 ET
Table 'tErGGDyESv/0llKumVeZuQ' 9-max Seat #9 is the button
Seat 1: 3PmVnC/15cl4oyI1TKIt4g ($5.10 in chips) 
Seat 2: pN3IHvAKm2fz+sTRARTcrg ($28.85 in chips) 
Seat 4: yqkowiRWZ6NvRN9UUkYIlA ($5 in chips) 
Seat 5: 6RQUxA3jk+ePxB/+Hc0IKw ($16.05 in chips) 
Seat 7: uhrboV251dcgYniYTdFIcA ($27.55 in chips) 
Seat 8: clJsV3v77RS07bDKY+705w ($5 in chips) 
Seat 9: d6n762oPkegG086ZJyV5MA ($23.35 in chips) 
3PmVnC/15cl4oyI1TKIt4g: posts small blind $0.10
pN3IHvAKm2fz+sTRARTcrg: posts big blind $0.25
qwr38jl5txoR36M7G5qi4A: sits out 
*** HOLE CARDS ***
yqkowiRWZ6NvRN9UUkYIlA: folds 
6RQUxA3jk+ePxB/+Hc0IKw: folds 
uhrboV251dcgYniYTdFIcA: raises $0.75 to $1
clJsV3v77RS07bDKY+705w: folds 
d6n762oPkegG086ZJyV5MA: calls $1
3PmVnC/15cl4oyI1TKIt4g: folds 
pN3IHvAKm2fz+sTRARTcrg: folds 
*** FLOP *** [Kc 8c 3s]
zDrucyjVn5aeekNEc3cJrA has returned
uhrboV251dcgYniYTdFIcA: bets $1
d6n762oPkegG086ZJyV5MA: calls $1
*** TURN *** [Kc 8c 3s] [8d]
uhrboV251dcgYniYTdFIcA: checks 
d6n762oPkegG086ZJyV5MA: checks 
*** RIVER *** [Kc 8c 3s 8d] [Jd]
uhrboV251dcgYniYTdFIcA: checks 
d6n762oPkegG086ZJyV5MA: bets $2.50
uhrboV251dcgYniYTdFIcA: calls $2.50
*** SHOW DOWN ***
d6n762oPkegG086ZJyV5MA: shows [Ah 8s] (three of a kind, Eights)
uhrboV251dcgYniYTdFIcA: mucks hand 
d6n762oPkegG086ZJyV5MA collected $8.90 from pot
uhrboV251dcgYniYTdFIcA said, "lol"
*** SUMMARY ***
Total pot $9.35 | Rake $0.45 
Board [Kc 8c 3s 8d Jd]
Seat 1: 3PmVnC/15cl4oyI1TKIt4g (small blind) folded before Flop
Seat 2: pN3IHvAKm2fz+sTRARTcrg (big blind) folded before Flop
Seat 4: yqkowiRWZ6NvRN9UUkYIlA folded before Flop (didn't bet)
Seat 5: 6RQUxA3jk+ePxB/+Hc0IKw folded before Flop (didn't bet)
Seat 7: uhrboV251dcgYniYTdFIcA mucked
Seat 8: clJsV3v77RS07bDKY+705w folded before Flop (didn't bet)
Seat 9: d6n762oPkegG086ZJyV5MA (button) showed [Ah 8s] and won ($8.90) with three of a kind, Eights




PokerStars Game #59941887234:  Hold'em No Limit ($0.10/$0.25) - 2009/07/01 1:49:19 ET
Table 'Loy/olZ5qoDOSvX4UTujGg' 6-max Seat #6 is the button
Seat 1: HipgaJhkN4ie/tTw4dK3Ug ($9.95 in chips) 
Seat 2: 4z7mPbMLNp4TezHXin63Vw ($14.80 in chips) 
Seat 3: 32YL2ZEp8NT4JB2RVM9euQ ($15.35 in chips) 
Seat 4: /gJNBeCkWL4o85/jvlZ4BA ($30.75 in chips) 
Seat 5: Ar4vsUIUfJ7gbYh1c1m59g ($18.90 in chips) 
Seat 6: qGHGf/553gQnDoklMRe3tg ($24.80 in chips) 
HipgaJhkN4ie/tTw4dK3Ug: posts small blind $0.10
4z7mPbMLNp4TezHXin63Vw: posts big blind $0.25
*** HOLE CARDS ***
32YL2ZEp8NT4JB2RVM9euQ: folds 
/gJNBeCkWL4o85/jvlZ4BA: folds 
Ar4vsUIUfJ7gbYh1c1m59g: raises $0.50 to $0.75
qGHGf/553gQnDoklMRe3tg: folds 
HipgaJhkN4ie/tTw4dK3Ug: folds 
4z7mPbMLNp4TezHXin63Vw: folds 
Uncalled bet ($0.50) returned to Ar4vsUIUfJ7gbYh1c1m59g
Ar4vsUIUfJ7gbYh1c1m59g collected $0.60 from pot
*** SUMMARY ***
Total pot $0.60 | Rake $0 
Seat 1: HipgaJhkN4ie/tTw4dK3Ug (small blind) folded before Flop
Seat 2: 4z7mPbMLNp4TezHXin63Vw (big blind) folded before Flop
Seat 3: 32YL2ZEp8NT4JB2RVM9euQ folded before Flop (didn't bet)
Seat 4: /gJNBeCkWL4o85/jvlZ4BA folded before Flop (didn't bet)
Seat 5: Ar4vsUIUfJ7gbYh1c1m59g collected ($0.60)
Seat 6: qGHGf/553gQnDoklMRe3tg (button) folded before Flop (didn't bet)




PokerStars Game #59941887364:  Hold'em No Limit ($0.10/$0.25) - 2009/07/01 1:49:19 ET
Table 'BpNkESDX1ip9c0K1hb5h7A' 6-max Seat #4 is the button
Seat 1: 5YZdVjBPZVEdubN4xEMPEg ($12.50 in chips) 
Seat 2: 9U3ZKjCsarN0DjR6mSE8Ug ($19.60 in chips) 
Seat 3: fZQg9veL7Dd/Z04ZTjC+wQ ($37.65 in chips) 
Seat 4: kG34n23qFQA3nzdOJTQ1dA ($26.50 in chips) 
Seat 5: OMGl+YMGogf2JWIRfT2/Yg ($4.25 in chips) 
Seat 6: 8EEqTTh7T1q48sYDqbI2Xg ($23.05 in chips) 
OMGl+YMGogf2JWIRfT2/Yg: posts small blind $0.10
8EEqTTh7T1q48sYDqbI2Xg: posts big blind $0.25
*** HOLE CARDS ***
5YZdVjBPZVEdubN4xEMPEg: folds 
9U3ZKjCsarN0DjR6mSE8Ug: folds 
fZQg9veL7Dd/Z04ZTjC+wQ: raises $0.25 to $0.50
kG34n23qFQA3nzdOJTQ1dA: folds 
OMGl+YMGogf2JWIRfT2/Yg: calls $0.40
8EEqTTh7T1q48sYDqbI2Xg: calls $0.25
*** FLOP *** [2s As Tc]
OMGl+YMGogf2JWIRfT2/Yg: checks 
8EEqTTh7T1q48sYDqbI2Xg: checks 
fZQg9veL7Dd/Z04ZTjC+wQ: checks 
*** TURN *** [2s As Tc] [7h]
OMGl+YMGogf2JWIRfT2/Yg: bets $0.50
8EEqTTh7T1q48sYDqbI2Xg: calls $0.50
fZQg9veL7Dd/Z04ZTjC+wQ: folds 
*** RIVER *** [2s As Tc 7h] [Qs]
OMGl+YMGogf2JWIRfT2/Yg: bets $0.50
8EEqTTh7T1q48sYDqbI2Xg: folds 
Uncalled bet ($0.50) returned to OMGl+YMGogf2JWIRfT2/Yg
OMGl+YMGogf2JWIRfT2/Yg collected $2.40 from pot
OMGl+YMGogf2JWIRfT2/Yg: doesn't show hand 
*** SUMMARY ***
Total pot $2.50 | Rake $0.10 
Board [2s As Tc 7h Qs]
Seat 1: 5YZdVjBPZVEdubN4xEMPEg folded before Flop (didn't bet)
Seat 2: 9U3ZKjCsarN0DjR6mSE8Ug folded before Flop (didn't bet)
Seat 3: fZQg9veL7Dd/Z04ZTjC+wQ folded on the Turn
Seat 4: kG34n23qFQA3nzdOJTQ1dA (button) folded before Flop (didn't bet)
Seat 5: OMGl+YMGogf2JWIRfT2/Yg (small blind) collected ($2.40)
Seat 6: 8EEqTTh7T1q48sYDqbI2Xg (big blind) folded on the River




PokerStars Game #59941887082:  Hold'em No Limit ($0.10/$0.25) - 2009/07/01 1:49:19 ET
Table 'nIRjSqm6RYUWJlyW2loYKA' 6-max Seat #2 is the button
Seat 1: w43JQj2oYPpKQVG4Yzlq1w ($25 in chips) 
Seat 2: NndRCAk4vU5JGDhTyy5LZg ($13.95 in chips) 
Seat 3: qjs7u/BI35gu5OgtqfLCZw ($12.40 in chips) 
Seat 4: /ZSSWvl8im2y38j1uEUAGA ($8.25 in chips) 
Seat 5: df01R5ThvHspD8FgKmaDvQ ($24.40 in chips) 
Seat 6: OIjOiBfQstWrK/RuXx7zcw ($6.85 in chips) 
qjs7u/BI35gu5OgtqfLCZw: posts small blind $0.10
/ZSSWvl8im2y38j1uEUAGA: posts big blind $0.25
*** HOLE CARDS ***
df01R5ThvHspD8FgKmaDvQ: raises $0.50 to $0.75
OIjOiBfQstWrK/RuXx7zcw: folds 
w43JQj2oYPpKQVG4Yzlq1w: folds 
NndRCAk4vU5JGDhTyy5LZg: folds 
qjs7u/BI35gu5OgtqfLCZw: folds 
/ZSSWvl8im2y38j1uEUAGA: folds 
Uncalled bet ($0.50) returned to df01R5ThvHspD8FgKmaDvQ
df01R5ThvHspD8FgKmaDvQ collected $0.60 from pot
*** SUMMARY ***
Total pot $0.60 | Rake $0 
Seat 1: w43JQj2oYPpKQVG4Yzlq1w folded before Flop (didn't bet)
Seat 2: NndRCAk4vU5JGDhTyy5LZg (button) folded before Flop (didn't bet)
Seat 3: qjs7u/BI35gu5OgtqfLCZw (small blind) folded before Flop
Seat 4: /ZSSWvl8im2y38j1uEUAGA (big blind) folded before Flop
Seat 5: df01R5ThvHspD8FgKmaDvQ collected ($0.60)
Seat 6: OIjOiBfQstWrK/RuXx7zcw folded before Flop (didn't bet)




PokerStars Game #59941887424:  Hold'em No Limit ($0.10/$0.25) - 2009/07/01 1:49:19 ET
Table 'tq5CvS0RUqGkuBK0XTzqqg' 6-max Seat #2 is the button
Seat 1: +ZlnqPoP3Hg4BIUxDfKd/A ($29.95 in chips) 
Seat 2: 2m6ZFAdj01UZd4WtEySXXQ ($4.90 in chips) 
Seat 3: 08V++DOqzaNrRNsHIwi25w ($25.10 in chips) 
Seat 4: UT5XpwOH1ipkOF7n1MqDJA ($34.30 in chips) 
Seat 5: qGHGf/553gQnDoklMRe3tg ($37.65 in chips) 
Seat 6: QqiZLFrN8iOUT/GHw7ztOA ($24.65 in chips) 
08V++DOqzaNrRNsHIwi25w: posts small blind $0.10
UT5XpwOH1ipkOF7n1MqDJA: posts big blind $0.25
*** HOLE CARDS ***
qGHGf/553gQnDoklMRe3tg: raises $0.75 to $1
QqiZLFrN8iOUT/GHw7ztOA: folds 
+ZlnqPoP3Hg4BIUxDfKd/A: folds 
2m6ZFAdj01UZd4WtEySXXQ: folds 
08V++DOqzaNrRNsHIwi25w: folds 
UT5XpwOH1ipkOF7n1MqDJA: folds 
Uncalled bet ($0.75) returned to qGHGf/553gQnDoklMRe3tg
08V++DOqzaNrRNsHIwi25w leaves the table
qGHGf/553gQnDoklMRe3tg collected $0.60 from pot
*** SUMMARY ***
Total pot $0.60 | Rake $0 
Seat 1: +ZlnqPoP3Hg4BIUxDfKd/A folded before Flop (didn't bet)
Seat 2: 2m6ZFAdj01UZd4WtEySXXQ (button) folded before Flop (didn't bet)
Seat 3: 08V++DOqzaNrRNsHIwi25w (small blind) folded before Flop
Seat 4: UT5XpwOH1ipkOF7n1MqDJA (big blind) folded before Flop
Seat 5: qGHGf/553gQnDoklMRe3tg collected ($0.60)
Seat 6: QqiZLFrN8iOUT/GHw7ztOA folded before Flop (didn't bet)




PokerStars Game #59941887162:  Hold'em No Limit ($0.10/$0.25) - 2009/07/01 1:49:19 ET
Table 'TJS4XvvOjO3k7mH74HJw5g' 9-max Seat #2 is the button
Seat 1: K8I2mpRME07ZlOsT2x75Lg ($7.95 in chips) 
Seat 2: yqkowiRWZ6NvRN9UUkYIlA ($10.10 in chips) 
Seat 3: 8EbrQ/EvFWt2cr0GaU82gQ ($4.75 in chips) 
Seat 4: clJsV3v77RS07bDKY+705w ($5 in chips) 
Seat 5: UlMB386Cfzy3EwurQoBjcA ($9.70 in chips) 
Seat 7: B9u+i1s5aZZkmLTLUopTBg ($14.40 in chips) 
Seat 8: Qv4VzEkN09uD11sjKv02Ig ($17.95 in chips) 
Seat 9: +sbyWwIcFp9kP0bDtMegfQ ($42.30 in chips) 
8EbrQ/EvFWt2cr0GaU82gQ: posts small blind $0.10
clJsV3v77RS07bDKY+705w: posts big blind $0.25
3PmVnC/15cl4oyI1TKIt4g: sits out 
*** HOLE CARDS ***
UlMB386Cfzy3EwurQoBjcA: folds 
B9u+i1s5aZZkmLTLUopTBg: calls $0.25
Qv4VzEkN09uD11sjKv02Ig: folds 
+sbyWwIcFp9kP0bDtMegfQ: folds 
K8I2mpRME07ZlOsT2x75Lg: folds 
yqkowiRWZ6NvRN9UUkYIlA: folds 
8EbrQ/EvFWt2cr0GaU82gQ: folds 
clJsV3v77RS07bDKY+705w: checks 
*** FLOP *** [Jc 2h 3c]
clJsV3v77RS07bDKY+705w: checks 
B9u+i1s5aZZkmLTLUopTBg: checks 
*** TURN *** [Jc 2h 3c] [9d]
clJsV3v77RS07bDKY+705w: checks 
B9u+i1s5aZZkmLTLUopTBg: bets $0.25
clJsV3v77RS07bDKY+705w: folds 
Uncalled bet ($0.25) returned to B9u+i1s5aZZkmLTLUopTBg
B9u+i1s5aZZkmLTLUopTBg collected $0.60 from pot
*** SUMMARY ***
Total pot $0.60 | Rake $0 
Board [Jc 2h 3c 9d]
Seat 1: K8I2mpRME07ZlOsT2x75Lg folded before Flop (didn't bet)
Seat 2: yqkowiRWZ6NvRN9UUkYIlA (button) folded before Flop (didn't bet)
Seat 3: 8EbrQ/EvFWt2cr0GaU82gQ (small blind) folded before Flop
Seat 4: clJsV3v77RS07bDKY+705w (big blind) folded on the Turn
Seat 5: UlMB386Cfzy3EwurQoBjcA folded before Flop (didn't bet)
Seat 7: B9u+i1s5aZZkmLTLUopTBg collected ($0.60)
Seat 8: Qv4VzEkN09uD11sjKv02Ig folded before Flop (didn't bet)
Seat 9: +sbyWwIcFp9kP0bDtMegfQ folded before Flop (didn't bet)




PokerStars Game #59941887080:  Hold'em No Limit ($0.10/$0.25) - 2009/07/01 1:49:19 ET
Table 'ThBZ355rqvsb8UGb6ajbig' 9-max Seat #6 is the button
Seat 1: Z9W7+g1WMhhZDi7DwGbCFA ($10.45 in chips) 
Seat 2: 4awUyiDYTgylQKXZ9faBVA ($25.95 in chips) 
Seat 3: H5Se03ZqSX7tbULXur2MAg ($27.80 in chips) 
Seat 4: zgi+EUykT/pZQpoUG6+oEg ($5.40 in chips) 
Seat 5: cKlmpQMahVsmOaxFQDcoOg ($24.60 in chips) 
Seat 6: qwr38jl5txoR36M7G5qi4A ($11 in chips) 
Seat 7: zUXhymECc2C9W9ZNw6qppA ($15.80 in chips) 
Seat 8: pplNliE3WonjkPRf+GZq2A ($25 in chips) 
Seat 9: sD+TKtt36XiiN6jqHiLwDA ($24.75 in chips) 
zUXhymECc2C9W9ZNw6qppA: posts small blind $0.10
pplNliE3WonjkPRf+GZq2A: posts big blind $0.25
*** HOLE CARDS ***
sD+TKtt36XiiN6jqHiLwDA: folds 
Z9W7+g1WMhhZDi7DwGbCFA: folds 
4awUyiDYTgylQKXZ9faBVA: folds 
H5Se03ZqSX7tbULXur2MAg: folds 
zgi+EUykT/pZQpoUG6+oEg: folds 
cKlmpQMahVsmOaxFQDcoOg: folds 
qwr38jl5txoR36M7G5qi4A: folds 
zUXhymECc2C9W9ZNw6qppA is disconnected 
zUXhymECc2C9W9ZNw6qppA has timed out while disconnected
zUXhymECc2C9W9ZNw6qppA: folds 
Uncalled bet ($0.15) returned to pplNliE3WonjkPRf+GZq2A
zUXhymECc2C9W9ZNw6qppA is sitting out
pplNliE3WonjkPRf+GZq2A collected $0.20 from pot
*** SUMMARY ***
Total pot $0.20 | Rake $0 
Seat 1: Z9W7+g1WMhhZDi7DwGbCFA folded before Flop (didn't bet)
Seat 2: 4awUyiDYTgylQKXZ9faBVA folded before Flop (didn't bet)
Seat 3: H5Se03ZqSX7tbULXur2MAg folded before Flop (didn't bet)
Seat 4: zgi+EUykT/pZQpoUG6+oEg folded before Flop (didn't bet)
Seat 5: cKlmpQMahVsmOaxFQDcoOg folded before Flop (didn't bet)
Seat 6: qwr38jl5txoR36M7G5qi4A (button) folded before Flop (didn't bet)
Seat 7: zUXhymECc2C9W9ZNw6qppA (small blind) folded before Flop
Seat 8: pplNliE3WonjkPRf+GZq2A (big blind) collected ($0.20)
Seat 9: sD+TKtt36XiiN6jqHiLwDA folded before Flop (didn't bet)




PokerStars Game #59941887714:  Hold'em No Limit ($0.10/$0.25) - 2009/07/01 1:49:20 ET
Table 'srBTB98reCdD1TffxE6o7g' 6-max Seat #5 is the button
Seat 1: SFmT9ZsVopnukjvAzrxTRg ($36.90 in chips) 
Seat 2: mfrkWA3PTeYPkbO6hi98Aw ($25 in chips) 
Seat 4: 6DwBRH+xZ12AAZmeAg+aXw ($16.20 in chips) 
Seat 5: K1zv48sQUGQiaLk5VWWDqw ($25.55 in chips) 
Seat 6: BV+K0Phf5VBHr7aZPKqbUQ ($30.85 in chips) 
BV+K0Phf5VBHr7aZPKqbUQ: posts small blind $0.10
SFmT9ZsVopnukjvAzrxTRg: posts big blind $0.25
*** HOLE CARDS ***
VOmI0x4dDPnTESZd5B4d1Q has returned
mfrkWA3PTeYPkbO6hi98Aw: folds 
6DwBRH+xZ12AAZmeAg+aXw: folds 
K1zv48sQUGQiaLk5VWWDqw: calls $0.25
BV+K0Phf5VBHr7aZPKqbUQ: folds 
SFmT9ZsVopnukjvAzrxTRg: checks 
*** FLOP *** [4h Jd 7c]
SFmT9ZsVopnukjvAzrxTRg: checks 
K1zv48sQUGQiaLk5VWWDqw: bets $0.25
SFmT9ZsVopnukjvAzrxTRg: folds 
Uncalled bet ($0.25) returned to K1zv48sQUGQiaLk5VWWDqw
K1zv48sQUGQiaLk5VWWDqw collected $0.60 from pot
K1zv48sQUGQiaLk5VWWDqw: doesn't show hand 
*** SUMMARY ***
Total pot $0.60 | Rake $0 
Board [4h Jd 7c]
Seat 1: SFmT9ZsVopnukjvAzrxTRg (big blind) folded on the Flop
Seat 2: mfrkWA3PTeYPkbO6hi98Aw folded before Flop (didn't bet)
Seat 4: 6DwBRH+xZ12AAZmeAg+aXw folded before Flop (didn't bet)
Seat 5: K1zv48sQUGQiaLk5VWWDqw (button) collected ($0.60)
Seat 6: BV+K0Phf5VBHr7aZPKqbUQ (small blind) folded before Flop




PokerStars Game #59941887582:  Hold'em No Limit ($0.10/$0.25) - 2009/07/01 1:49:20 ET
Table 'Ok3oDLIsTc2+KxPcI0bAOA' 6-max Seat #3 is the button
Seat 1: agQm3ugZ3qSVYNgNu1ddeA ($39.85 in chips) 
Seat 2: wPSNSp4HYtytRMXTu3oPSQ ($27.65 in chips) 
Seat 3: lquriepNQBhDV5P1SWHhnA ($36.90 in chips) 
Seat 4: LJI7A1YgDM7hgh7o56+ReQ ($33.80 in chips) 
Seat 5: DFi/Lzkjsfv8QswS80JX9Q ($30.10 in chips) 
Seat 6: Hsvkc0/G2VV78oVmWYXecw ($5.80 in chips) 
LJI7A1YgDM7hgh7o56+ReQ: posts small blind $0.10
DFi/Lzkjsfv8QswS80JX9Q: posts big blind $0.25
*** HOLE CARDS ***
Hsvkc0/G2VV78oVmWYXecw: folds 
agQm3ugZ3qSVYNgNu1ddeA: folds 
wPSNSp4HYtytRMXTu3oPSQ: raises $1 to $1.25
lquriepNQBhDV5P1SWHhnA: folds 
LJI7A1YgDM7hgh7o56+ReQ: folds 
DFi/Lzkjsfv8QswS80JX9Q: folds 
Uncalled bet ($1) returned to wPSNSp4HYtytRMXTu3oPSQ
wPSNSp4HYtytRMXTu3oPSQ collected $0.60 from pot
wPSNSp4HYtytRMXTu3oPSQ: doesn't show hand 
*** SUMMARY ***
Total pot $0.60 | Rake $0 
Seat 1: agQm3ugZ3qSVYNgNu1ddeA folded before Flop (didn't bet)
Seat 2: wPSNSp4HYtytRMXTu3oPSQ collected ($0.60)
Seat 3: lquriepNQBhDV5P1SWHhnA (button) folded before Flop (didn't bet)
Seat 4: LJI7A1YgDM7hgh7o56+ReQ (small blind) folded before Flop
Seat 5: DFi/Lzkjsfv8QswS80JX9Q (big blind) folded before Flop
Seat 6: Hsvkc0/G2VV78oVmWYXecw folded before Flop (didn't bet)




PokerStars Game #59941887864:  Hold'em No Limit ($0.10/$0.25) - 2009/07/01 1:49:20 ET
Table 'MiquQrQZJJq9ZtgRIp9HFQ' 6-max Seat #2 is the button
Seat 1: c3J/KYZ4cNsUEuz8v57I5A ($24.65 in chips) 
Seat 2: 2+6voGl1T1DO63JePptI3g ($25.45 in chips) 
Seat 3: 9h7TNZ1TDGRUJXA6rI+ZTw ($9.85 in chips) 
Seat 4: wAKC8C/zN0c8V5v13dm9mA ($51.20 in chips) 
Seat 5: iyZxqznXjv3vtvOJymkoLQ ($26.75 in chips) 
Seat 6: GbCVUNssQ7mqsPWr7J4d3w ($4.65 in chips) 
9h7TNZ1TDGRUJXA6rI+ZTw: posts small blind $0.10
wAKC8C/zN0c8V5v13dm9mA: posts big blind $0.25
*** HOLE CARDS ***
iyZxqznXjv3vtvOJymkoLQ: folds 
GbCVUNssQ7mqsPWr7J4d3w: folds 
c3J/KYZ4cNsUEuz8v57I5A: folds 
2+6voGl1T1DO63JePptI3g has timed out
2+6voGl1T1DO63JePptI3g: folds 
2+6voGl1T1DO63JePptI3g is sitting out
9h7TNZ1TDGRUJXA6rI+ZTw: folds 
Uncalled bet ($0.15) returned to wAKC8C/zN0c8V5v13dm9mA
wAKC8C/zN0c8V5v13dm9mA collected $0.20 from pot
*** SUMMARY ***
Total pot $0.20 | Rake $0 
Seat 1: c3J/KYZ4cNsUEuz8v57I5A folded before Flop (didn't bet)
Seat 2: 2+6voGl1T1DO63JePptI3g (button) folded before Flop (didn't bet)
Seat 3: 9h7TNZ1TDGRUJXA6rI+ZTw (small blind) folded before Flop
Seat 4: wAKC8C/zN0c8V5v13dm9mA (big blind) collected ($0.20)
Seat 5: iyZxqznXjv3vtvOJymkoLQ folded before Flop (didn't bet)
Seat 6: GbCVUNssQ7mqsPWr7J4d3w folded before Flop (didn't bet)




PokerStars Game #59941887678:  Hold'em No Limit ($0.10/$0.25) - 2009/07/01 1:49:20 ET
Table 'IdXp6nyeW4FYaEK4qKCnwQ' 9-max Seat #9 is the button
Seat 1: tLcDklc2rBORNfixyRfVfw ($25.10 in chips) 
Seat 2: HPEB+AtKw1+C/cxU0o1ciw ($30.85 in chips) 
Seat 4: j4q3p0lesp63b1gZDwLBZw ($5.35 in chips) 
Seat 6: arxNSjreDRGFg13EAM2F1w ($30.50 in chips) 
Seat 7: w1ukf8uPa4+WH561TtVRxA ($37.25 in chips) 
Seat 8: dtZ84flFEi4Q+SGrHMJRDQ ($29.75 in chips) 
Seat 9: s2xLPOl/vhl/26apJ3vsOQ ($28.90 in chips) 
tLcDklc2rBORNfixyRfVfw: posts small blind $0.10
HPEB+AtKw1+C/cxU0o1ciw: posts big blind $0.25
*** HOLE CARDS ***
j4q3p0lesp63b1gZDwLBZw: folds 
arxNSjreDRGFg13EAM2F1w: folds 
w1ukf8uPa4+WH561TtVRxA: folds 
dtZ84flFEi4Q+SGrHMJRDQ: folds 
s2xLPOl/vhl/26apJ3vsOQ: raises $0.75 to $1
tLcDklc2rBORNfixyRfVfw: folds 
HPEB+AtKw1+C/cxU0o1ciw: folds 
Uncalled bet ($0.75) returned to s2xLPOl/vhl/26apJ3vsOQ
s2xLPOl/vhl/26apJ3vsOQ collected $0.60 from pot
*** SUMMARY ***
Total pot $0.60 | Rake $0 
Seat 1: tLcDklc2rBORNfixyRfVfw (small blind) folded before Flop
Seat 2: HPEB+AtKw1+C/cxU0o1ciw (big blind) folded before Flop
Seat 4: j4q3p0lesp63b1gZDwLBZw folded before Flop (didn't bet)
Seat 6: arxNSjreDRGFg13EAM2F1w folded before Flop (didn't bet)
Seat 7: w1ukf8uPa4+WH561TtVRxA folded before Flop (didn't bet)
Seat 8: dtZ84flFEi4Q+SGrHMJRDQ folded before Flop (didn't bet)
Seat 9: s2xLPOl/vhl/26apJ3vsOQ (button) collected ($0.60)




PokerStars Game #59941888214:  Hold'em No Limit ($0.10/$0.25) - 2009/07/01 1:49:21 ET
Table 'IIO2q2znuuAXmiZ2qFTcmg' 6-max Seat #5 is the button
Seat 2: i9LqF5rD3bvtbEE7HWgr3Q ($25 in chips) 
Seat 3: j0aDOn9Nft1HLTQvGu1UwA ($9.75 in chips) 
Seat 5: iHZrkhpIO/3+tKuAoPx8HQ ($14.75 in chips) 
Seat 6: eccZOodwLtdyXmuZVw+l1w ($4.40 in chips) 
eccZOodwLtdyXmuZVw+l1w: posts small blind $0.10
i9LqF5rD3bvtbEE7HWgr3Q: posts big blind $0.25
*** HOLE CARDS ***
j0aDOn9Nft1HLTQvGu1UwA: raises $0.25 to $0.50
iHZrkhpIO/3+tKuAoPx8HQ: folds 
eccZOodwLtdyXmuZVw+l1w: raises $3.90 to $4.40 and is all-in
i9LqF5rD3bvtbEE7HWgr3Q: folds 
j0aDOn9Nft1HLTQvGu1UwA: calls $3.90
*** FLOP *** [Kh Tc 9s]
*** TURN *** [Kh Tc 9s] [9d]
*** RIVER *** [Kh Tc 9s 9d] [As]
*** SHOW DOWN ***
eccZOodwLtdyXmuZVw+l1w: shows [5h 6c] (a pair of Nines)
j0aDOn9Nft1HLTQvGu1UwA: shows [4d Ad] (two pair, Aces and Nines)
j0aDOn9Nft1HLTQvGu1UwA collected $8.60 from pot
*** SUMMARY ***
Total pot $9.05 | Rake $0.45 
Board [Kh Tc 9s 9d As]
Seat 2: i9LqF5rD3bvtbEE7HWgr3Q (big blind) folded before Flop
Seat 3: j0aDOn9Nft1HLTQvGu1UwA showed [4d Ad] and won ($8.60) with two pair, Aces and Nines
Seat 5: iHZrkhpIO/3+tKuAoPx8HQ (button) folded before Flop (didn't bet)
Seat 6: eccZOodwLtdyXmuZVw+l1w (small blind) showed [5h 6c] and lost with a pair of Nines




PokerStars Game #59941887992:  Hold'em No Limit ($0.10/$0.25) - 2009/07/01 1:49:21 ET
Table 'Utmw+yX+E/wdhNDIim90lQ' 9-max Seat #6 is the button
Seat 1: cZ99hugmLBj9KhTlc8nCSw ($31.95 in chips) 
Seat 2: iGMlK+EhUflPB6jKQd95Cg ($27.35 in chips) 
Seat 3: dfNim92Z6XK1/h5SFW5vDg ($25 in chips) 
Seat 4: ifYGvZDHQQ0aam4awTtHwA ($28.90 in chips) 
Seat 5: ghNKXUBl/H+t83JF079ZBA ($25 in chips) 
Seat 6: OlPJsgR4xypSg/w1z7Gyvw ($33.15 in chips) 
Seat 7: CImUHesK+ZER4v/VCA9IUg ($49.55 in chips) 
Seat 8: Mh2r9hTeTEDnh19sRZtW3g ($5 in chips) 
Seat 9: Th3FldXKQW6hWVVPahaoOQ ($27.50 in chips) 
CImUHesK+ZER4v/VCA9IUg: posts small blind $0.10
Mh2r9hTeTEDnh19sRZtW3g: posts big blind $0.25
*** HOLE CARDS ***
Th3FldXKQW6hWVVPahaoOQ: folds 
cZ99hugmLBj9KhTlc8nCSw: folds 
iGMlK+EhUflPB6jKQd95Cg: folds 
dfNim92Z6XK1/h5SFW5vDg: folds 
ifYGvZDHQQ0aam4awTtHwA: raises $0.25 to $0.50
ghNKXUBl/H+t83JF079ZBA: folds 
OlPJsgR4xypSg/w1z7Gyvw: folds 
CImUHesK+ZER4v/VCA9IUg: folds 
Mh2r9hTeTEDnh19sRZtW3g: folds 
Uncalled bet ($0.25) returned to ifYGvZDHQQ0aam4awTtHwA
ifYGvZDHQQ0aam4awTtHwA collected $0.60 from pot
*** SUMMARY ***
Total pot $0.60 | Rake $0 
Seat 1: cZ99hugmLBj9KhTlc8nCSw folded before Flop (didn't bet)
Seat 2: iGMlK+EhUflPB6jKQd95Cg folded before Flop (didn't bet)
Seat 3: dfNim92Z6XK1/h5SFW5vDg folded before Flop (didn't bet)
Seat 4: ifYGvZDHQQ0aam4awTtHwA collected ($0.60)
Seat 5: ghNKXUBl/H+t83JF079ZBA folded before Flop (didn't bet)
Seat 6: OlPJsgR4xypSg/w1z7Gyvw (button) folded before Flop (didn't bet)
Seat 7: CImUHesK+ZER4v/VCA9IUg (small blind) folded before Flop
Seat 8: Mh2r9hTeTEDnh19sRZtW3g (big blind) folded before Flop
Seat 9: Th3FldXKQW6hWVVPahaoOQ folded before Flop (didn't bet)




PokerStars Game #59941888804:  Hold'em No Limit ($0.10/$0.25) - 2009/07/01 1:49:22 ET
Table 'JUMeG5SzDyo9HufhgemQeA' 9-max Seat #2 is the button
Seat 1: oLa/tXLfSLLB28mcLGrxcg ($24.05 in chips) 
Seat 2: Jve2LRs9vtGL7NdiNeXY/A ($15.15 in chips) 
Seat 3: IEvLSTIxhlti3EjZDarYnA ($31.25 in chips) 
Seat 4: 9+Um1wMtYNWnmPLUEU4viQ ($18 in chips) 
Seat 5: Ne5zBB6oEKrbigKRh6d6Xg ($11.30 in chips) 
Seat 6: wFCwdYKUXoQHhz8qeZuuAw ($25.65 in chips) 
Seat 7: aNpwfA31EREwO+ar4XzBCw ($32.15 in chips) 
Seat 8: zDrucyjVn5aeekNEc3cJrA ($37.35 in chips) 
Seat 9: V6p0jQ/RhUsqpHLmXvEX4Q ($13.45 in chips) 
IEvLSTIxhlti3EjZDarYnA: posts small blind $0.10
9+Um1wMtYNWnmPLUEU4viQ: posts big blind $0.25
*** HOLE CARDS ***
Ne5zBB6oEKrbigKRh6d6Xg: folds 
wFCwdYKUXoQHhz8qeZuuAw: calls $0.25
aNpwfA31EREwO+ar4XzBCw: folds 
zDrucyjVn5aeekNEc3cJrA: folds 
V6p0jQ/RhUsqpHLmXvEX4Q: raises $0.75 to $1
oLa/tXLfSLLB28mcLGrxcg: folds 
Jve2LRs9vtGL7NdiNeXY/A: folds 
IEvLSTIxhlti3EjZDarYnA: folds 
9+Um1wMtYNWnmPLUEU4viQ: folds 
wFCwdYKUXoQHhz8qeZuuAw: calls $0.75
*** FLOP *** [Qd 2d 3d]
wFCwdYKUXoQHhz8qeZuuAw: checks 
V6p0jQ/RhUsqpHLmXvEX4Q: bets $2
wFCwdYKUXoQHhz8qeZuuAw: folds 
Uncalled bet ($2) returned to V6p0jQ/RhUsqpHLmXvEX4Q
V6p0jQ/RhUsqpHLmXvEX4Q collected $2.25 from pot
*** SUMMARY ***
Total pot $2.35 | Rake $0.10 
Board [Qd 2d 3d]
Seat 1: oLa/tXLfSLLB28mcLGrxcg folded before Flop (didn't bet)
Seat 2: Jve2LRs9vtGL7NdiNeXY/A (button) folded before Flop (didn't bet)
Seat 3: IEvLSTIxhlti3EjZDarYnA (small blind) folded before Flop
Seat 4: 9+Um1wMtYNWnmPLUEU4viQ (big blind) folded before Flop
Seat 5: Ne5zBB6oEKrbigKRh6d6Xg folded before Flop (didn't bet)
Seat 6: wFCwdYKUXoQHhz8qeZuuAw folded on the Flop
Seat 7: aNpwfA31EREwO+ar4XzBCw folded before Flop (didn't bet)
Seat 8: zDrucyjVn5aeekNEc3cJrA folded before Flop (didn't bet)
Seat 9: V6p0jQ/RhUsqpHLmXvEX4Q collected ($2.25)




PokerStars Game #59941888648:  Hold'em No Limit ($0.10/$0.25) - 2009/07/01 1:49:22 ET
Table 'LXz5SsUCyWcm+4JDJh466A' 9-max Seat #3 is the button
Seat 1: MG90wfSJZnOejs/KD3vlQQ ($24.65 in chips) 
Seat 2: H5Se03ZqSX7tbULXur2MAg ($22.60 in chips) 
Seat 3: dfNim92Z6XK1/h5SFW5vDg ($25 in chips) 
Seat 4: K0b5wNInj6hUGRr6yzKFtw ($27.35 in chips) 
Seat 5: CGZe30OcuMyA3kN5MnfQcQ ($15.95 in chips) 
Seat 6: 6RiVTYll/5D8zICp0MRpKw ($24.75 in chips) 
Seat 8: zOHElTcFiTsexeDCkAPYkQ ($35.60 in chips) 
Seat 9: dtZ84flFEi4Q+SGrHMJRDQ ($25 in chips) 
K0b5wNInj6hUGRr6yzKFtw: posts small blind $0.10
CGZe30OcuMyA3kN5MnfQcQ: posts big blind $0.25
*** HOLE CARDS ***
6RiVTYll/5D8zICp0MRpKw: folds 
zOHElTcFiTsexeDCkAPYkQ: raises $0.75 to $1
J2a/QHAWUgo6beDRoEyg2g has returned
dtZ84flFEi4Q+SGrHMJRDQ: folds 
MG90wfSJZnOejs/KD3vlQQ: raises $2.10 to $3.10
H5Se03ZqSX7tbULXur2MAg: folds 
dfNim92Z6XK1/h5SFW5vDg: folds 
K0b5wNInj6hUGRr6yzKFtw: folds 
CGZe30OcuMyA3kN5MnfQcQ: folds 
zOHElTcFiTsexeDCkAPYkQ: raises $2.10 to $5.20
MG90wfSJZnOejs/KD3vlQQ: raises $10.80 to $16
zOHElTcFiTsexeDCkAPYkQ: calls $10.80
*** FLOP *** [5h 5s 9c]
zOHElTcFiTsexeDCkAPYkQ: bets $6
MG90wfSJZnOejs/KD3vlQQ: raises $2.65 to $8.65 and is all-in
zOHElTcFiTsexeDCkAPYkQ: calls $2.65
*** TURN *** [5h 5s 9c] [8c]
*** RIVER *** [5h 5s 9c 8c] [Tc]
*** SHOW DOWN ***
zOHElTcFiTsexeDCkAPYkQ: shows [Ac 5c] (a flush, Ace high)
MG90wfSJZnOejs/KD3vlQQ: mucks hand 
zOHElTcFiTsexeDCkAPYkQ collected $47.25 from pot
*** SUMMARY ***
Total pot $49.65 | Rake $2.40 
Board [5h 5s 9c 8c Tc]
Seat 1: MG90wfSJZnOejs/KD3vlQQ mucked
Seat 2: H5Se03ZqSX7tbULXur2MAg folded before Flop (didn't bet)
Seat 3: dfNim92Z6XK1/h5SFW5vDg (button) folded before Flop (didn't bet)
Seat 4: K0b5wNInj6hUGRr6yzKFtw (small blind) folded before Flop
Seat 5: CGZe30OcuMyA3kN5MnfQcQ (big blind) folded before Flop
Seat 6: 6RiVTYll/5D8zICp0MRpKw folded before Flop (didn't bet)
Seat 8: zOHElTcFiTsexeDCkAPYkQ showed [Ac 5c] and won ($47.25) with a flush, Ace high
Seat 9: dtZ84flFEi4Q+SGrHMJRDQ folded before Flop (didn't bet)




PokerStars Game #59941888772:  Hold'em No Limit ($0.10/$0.25) - 2009/07/01 1:49:22 ET
Table 'JJzUs04lHpXg6nboT1/jeg' 6-max Seat #5 is the button
Seat 2: jxfR29d+dK/7h7s3SvCk+g ($8.10 in chips) 
Seat 3: 4zXbHDe39qNX46dAo81b4w ($11.10 in chips) 
Seat 4: 7cx44/slbeTw+Cy7QB8Trg ($25 in chips) 
Seat 5: QvTX2yGq3uKJiKPmns4TKQ ($18.25 in chips) 
jxfR29d+dK/7h7s3SvCk+g: posts small blind $0.10
4zXbHDe39qNX46dAo81b4w: posts big blind $0.25
*** HOLE CARDS ***
7cx44/slbeTw+Cy7QB8Trg: folds 
QvTX2yGq3uKJiKPmns4TKQ: folds 
jxfR29d+dK/7h7s3SvCk+g: calls $0.15
4zXbHDe39qNX46dAo81b4w: checks 
*** FLOP *** [Qc 4d Kd]
jxfR29d+dK/7h7s3SvCk+g: bets $0.50
4zXbHDe39qNX46dAo81b4w: folds 
Uncalled bet ($0.50) returned to jxfR29d+dK/7h7s3SvCk+g
vEZ/HxVuyR6kaq0BtZoUgQ joins the table at seat #1 
jxfR29d+dK/7h7s3SvCk+g collected $0.50 from pot
*** SUMMARY ***
Total pot $0.50 | Rake $0 
Board [Qc 4d Kd]
Seat 2: jxfR29d+dK/7h7s3SvCk+g (small blind) collected ($0.50)
Seat 3: 4zXbHDe39qNX46dAo81b4w (big blind) folded on the Flop
Seat 4: 7cx44/slbeTw+Cy7QB8Trg folded before Flop (didn't bet)
Seat 5: QvTX2yGq3uKJiKPmns4TKQ (button) folded before Flop (didn't bet)




PokerStars Game #59941888838:  Hold'em No Limit ($0.10/$0.25) - 2009/07/01 1:49:22 ET
Table '5VWnrlxdjwVfMWkVS2WE7A' 6-max Seat #2 is the button
Seat 1: 82p+w3EmUaFFHuwpSeGY1w ($14.35 in chips) 
Seat 2: LJI7A1YgDM7hgh7o56+ReQ ($42.60 in chips) 
Seat 3: SFmT9ZsVopnukjvAzrxTRg ($37.10 in chips) 
Seat 4: Pb/gJ3OxOZx57fFp0MDgkg ($35.20 in chips) 
Seat 6: LtASJ9OlkqGrrUKGQlpGAw ($5.15 in chips) 
SFmT9ZsVopnukjvAzrxTRg: posts small blind $0.10
Pb/gJ3OxOZx57fFp0MDgkg: posts big blind $0.25
32YL2ZEp8NT4JB2RVM9euQ: sits out 
*** HOLE CARDS ***
LtASJ9OlkqGrrUKGQlpGAw: folds 
82p+w3EmUaFFHuwpSeGY1w: calls $0.25
LJI7A1YgDM7hgh7o56+ReQ: raises $1 to $1.25
SFmT9ZsVopnukjvAzrxTRg: folds 
Pb/gJ3OxOZx57fFp0MDgkg: folds 
82p+w3EmUaFFHuwpSeGY1w: calls $1
*** FLOP *** [7d Jc 5c]
82p+w3EmUaFFHuwpSeGY1w: checks 
LJI7A1YgDM7hgh7o56+ReQ: bets $2.25
82p+w3EmUaFFHuwpSeGY1w: folds 
Uncalled bet ($2.25) returned to LJI7A1YgDM7hgh7o56+ReQ
LJI7A1YgDM7hgh7o56+ReQ collected $2.75 from pot
LJI7A1YgDM7hgh7o56+ReQ: doesn't show hand 
*** SUMMARY ***
Total pot $2.85 | Rake $0.10 
Board [7d Jc 5c]
Seat 1: 82p+w3EmUaFFHuwpSeGY1w folded on the Flop
Seat 2: LJI7A1YgDM7hgh7o56+ReQ (button) collected ($2.75)
Seat 3: SFmT9ZsVopnukjvAzrxTRg (small blind) folded before Flop
Seat 4: Pb/gJ3OxOZx57fFp0MDgkg (big blind) folded before Flop
Seat 6: LtASJ9OlkqGrrUKGQlpGAw folded before Flop (didn't bet)




PokerStars Game #59941888624:  Hold'em No Limit ($0.10/$0.25) - 2009/07/01 1:49:22 ET
Table 'DhkrdW2UOy2PfjSW28Kq8w' 6-max Seat #2 is the button
Seat 2: v+QfkGiuj9bgtuNoVnDO8w ($27.30 in chips) 
Seat 3: B3X187C0tXFUfQpCu8pe8A ($19.80 in chips) 
Seat 4: 59HJSCM1X37BkMpI9N0mEw ($24.40 in chips) 
Seat 5: cS21pIxRHx5Gt42o7hPZzw ($11.45 in chips) 
Seat 6: DihMHaz4WNETH1bPDe13kA ($27.10 in chips) 
B3X187C0tXFUfQpCu8pe8A: posts small blind $0.10
59HJSCM1X37BkMpI9N0mEw: posts big blind $0.25
Mhj3q7cxev+XjXZxEE6/Cw: sits out 
*** HOLE CARDS ***
cS21pIxRHx5Gt42o7hPZzw: folds 
DihMHaz4WNETH1bPDe13kA: folds 
v+QfkGiuj9bgtuNoVnDO8w: folds 
B3X187C0tXFUfQpCu8pe8A: calls $0.15
59HJSCM1X37BkMpI9N0mEw: checks 
*** FLOP *** [5d 7s 8s]
B3X187C0tXFUfQpCu8pe8A: checks 
59HJSCM1X37BkMpI9N0mEw: checks 
*** TURN *** [5d 7s 8s] [6d]
B3X187C0tXFUfQpCu8pe8A: bets $0.50
59HJSCM1X37BkMpI9N0mEw: calls $0.50
*** RIVER *** [5d 7s 8s 6d] [4c]
B3X187C0tXFUfQpCu8pe8A: bets $1
59HJSCM1X37BkMpI9N0mEw: calls $1
*** SHOW DOWN ***
B3X187C0tXFUfQpCu8pe8A: shows [9h Qd] (a straight, Five to Nine)
59HJSCM1X37BkMpI9N0mEw: mucks hand 
B3X187C0tXFUfQpCu8pe8A collected $3.35 from pot
*** SUMMARY ***
Total pot $3.50 | Rake $0.15 
Board [5d 7s 8s 6d 4c]
Seat 2: v+QfkGiuj9bgtuNoVnDO8w (button) folded before Flop (didn't bet)
Seat 3: B3X187C0tXFUfQpCu8pe8A (small blind) showed [9h Qd] and won ($3.35) with a straight, Five to Nine
Seat 4: 59HJSCM1X37BkMpI9N0mEw (big blind) mucked
Seat 5: cS21pIxRHx5Gt42o7hPZzw folded before Flop (didn't bet)
Seat 6: DihMHaz4WNETH1bPDe13kA folded before Flop (didn't bet)




PokerStars Game #59941888782:  Hold'em No Limit ($0.10/$0.25) - 2009/07/01 1:49:22 ET
Table '972HGIb0tQN/zRIK4TABEw' 9-max Seat #4 is the button
Seat 1: fHr2+mGa0RFK3qrpZcVUAQ ($7.05 in chips) 
Seat 2: J8wkBH9zC2TQV57EauHXog ($10 in chips) 
Seat 4: aSrj4lVmn2owyQ1RbbOqxQ ($11.65 in chips) 
fHr2+mGa0RFK3qrpZcVUAQ: posts small blind $0.10
J8wkBH9zC2TQV57EauHXog: posts big blind $0.25
*** HOLE CARDS ***
aSrj4lVmn2owyQ1RbbOqxQ: folds 
fHr2+mGa0RFK3qrpZcVUAQ: calls $0.15
J8wkBH9zC2TQV57EauHXog: checks 
*** FLOP *** [3d Kc As]
fHr2+mGa0RFK3qrpZcVUAQ: checks 
J8wkBH9zC2TQV57EauHXog: checks 
*** TURN *** [3d Kc As] [Jh]
fHr2+mGa0RFK3qrpZcVUAQ: checks 
J8wkBH9zC2TQV57EauHXog: checks 
*** RIVER *** [3d Kc As Jh] [2h]
fHr2+mGa0RFK3qrpZcVUAQ: checks 
J8wkBH9zC2TQV57EauHXog: checks 
*** SHOW DOWN ***
fHr2+mGa0RFK3qrpZcVUAQ: shows [2s 9h] (a pair of Deuces)
J8wkBH9zC2TQV57EauHXog: shows [2c 7d] (a pair of Deuces)
fHr2+mGa0RFK3qrpZcVUAQ collected $0.25 from pot
J8wkBH9zC2TQV57EauHXog collected $0.25 from pot
J8wkBH9zC2TQV57EauHXog is sitting out
*** SUMMARY ***
Total pot $0.50 | Rake $0 
Board [3d Kc As Jh 2h]
Seat 1: fHr2+mGa0RFK3qrpZcVUAQ (small blind) showed [2s 9h] and won ($0.25) with a pair of Deuces
Seat 2: J8wkBH9zC2TQV57EauHXog (big blind) showed [2c 7d] and won ($0.25) with a pair of Deuces
Seat 4: aSrj4lVmn2owyQ1RbbOqxQ (button) folded before Flop (didn't bet)




PokerStars Game #59941888842:  Hold'em No Limit ($0.10/$0.25) - 2009/07/01 1:49:22 ET
Table '63uh7ZsO7Tnt+E8b/2bu3A' 6-max Seat #3 is the button
Seat 1: 0av6tRNdi0Ui4f15L7gsVg ($29.85 in chips) 
Seat 2: SFmT9ZsVopnukjvAzrxTRg ($30.30 in chips) 
Seat 3: yVP7GLZBzx47OPi6jzUxMw ($3.60 in chips) 
Seat 4: rnpAao581IcvQglpkpnkoQ ($12.35 in chips) 
Seat 5: Hsvkc0/G2VV78oVmWYXecw ($5 in chips) 
Seat 6: qGHGf/553gQnDoklMRe3tg ($26.90 in chips) 
rnpAao581IcvQglpkpnkoQ: posts small blind $0.10
Hsvkc0/G2VV78oVmWYXecw: posts big blind $0.25
*** HOLE CARDS ***
qGHGf/553gQnDoklMRe3tg: folds 
0av6tRNdi0Ui4f15L7gsVg: raises $0.50 to $0.75
SFmT9ZsVopnukjvAzrxTRg: calls $0.75
yVP7GLZBzx47OPi6jzUxMw: folds 
rnpAao581IcvQglpkpnkoQ: folds 
Hsvkc0/G2VV78oVmWYXecw: folds 
*** FLOP *** [Jh Js 7h]
0av6tRNdi0Ui4f15L7gsVg: checks 
SFmT9ZsVopnukjvAzrxTRg: bets $1.25
0av6tRNdi0Ui4f15L7gsVg: calls $1.25
*** TURN *** [Jh Js 7h] [8h]
0av6tRNdi0Ui4f15L7gsVg: checks 
SFmT9ZsVopnukjvAzrxTRg: bets $3
0av6tRNdi0Ui4f15L7gsVg: calls $3
*** RIVER *** [Jh Js 7h 8h] [4c]
0av6tRNdi0Ui4f15L7gsVg: checks 
SFmT9ZsVopnukjvAzrxTRg: bets $3
0av6tRNdi0Ui4f15L7gsVg: calls $3
*** SHOW DOWN ***
SFmT9ZsVopnukjvAzrxTRg: shows [Jc Tc] (three of a kind, Jacks)
0av6tRNdi0Ui4f15L7gsVg: shows [Qh Th] (a flush, Queen high)
0av6tRNdi0Ui4f15L7gsVg collected $15.60 from pot
*** SUMMARY ***
Total pot $16.35 | Rake $0.75 
Board [Jh Js 7h 8h 4c]
Seat 1: 0av6tRNdi0Ui4f15L7gsVg showed [Qh Th] and won ($15.60) with a flush, Queen high
Seat 2: SFmT9ZsVopnukjvAzrxTRg showed [Jc Tc] and lost with three of a kind, Jacks
Seat 3: yVP7GLZBzx47OPi6jzUxMw (button) folded before Flop (didn't bet)
Seat 4: rnpAao581IcvQglpkpnkoQ (small blind) folded before Flop
Seat 5: Hsvkc0/G2VV78oVmWYXecw (big blind) folded before Flop
Seat 6: qGHGf/553gQnDoklMRe3tg folded before Flop (didn't bet)




PokerStars Game #59941888780:  Hold'em No Limit ($0.10/$0.25) - 2009/07/01 1:49:22 ET
Table '4XGDnEByOol5up4aB2KbJw' 6-max Seat #3 is the button
Seat 1: kyRaCIljYA6l33lSKQfNsg ($27.10 in chips) 
Seat 2: SFmT9ZsVopnukjvAzrxTRg ($46.10 in chips) 
Seat 3: LtASJ9OlkqGrrUKGQlpGAw ($20.55 in chips) 
Seat 4: BV+K0Phf5VBHr7aZPKqbUQ ($25 in chips) 
Seat 5: Dh01+rohD2p9pXLYeBlC5Q ($17.25 in chips) 
Seat 6: a7Ux7aERFGCbT/L3ojVfAg ($10.40 in chips) 
BV+K0Phf5VBHr7aZPKqbUQ: posts small blind $0.10
Dh01+rohD2p9pXLYeBlC5Q: posts big blind $0.25
*** HOLE CARDS ***
a7Ux7aERFGCbT/L3ojVfAg: folds 
kyRaCIljYA6l33lSKQfNsg: folds 
SFmT9ZsVopnukjvAzrxTRg: folds 
LtASJ9OlkqGrrUKGQlpGAw: raises $0.50 to $0.75
BV+K0Phf5VBHr7aZPKqbUQ: folds 
Dh01+rohD2p9pXLYeBlC5Q: calls $0.50
*** FLOP *** [2s Qh 5d]
Dh01+rohD2p9pXLYeBlC5Q: checks 
LtASJ9OlkqGrrUKGQlpGAw: checks 
*** TURN *** [2s Qh 5d] [8h]
Dh01+rohD2p9pXLYeBlC5Q: checks 
LtASJ9OlkqGrrUKGQlpGAw: bets $1.25
Dh01+rohD2p9pXLYeBlC5Q: calls $1.25
*** RIVER *** [2s Qh 5d 8h] [5h]
Dh01+rohD2p9pXLYeBlC5Q: bets $4.50
LtASJ9OlkqGrrUKGQlpGAw: folds 
Uncalled bet ($4.50) returned to Dh01+rohD2p9pXLYeBlC5Q
Dh01+rohD2p9pXLYeBlC5Q collected $3.90 from pot
*** SUMMARY ***
Total pot $4.10 | Rake $0.20 
Board [2s Qh 5d 8h 5h]
Seat 1: kyRaCIljYA6l33lSKQfNsg folded before Flop (didn't bet)
Seat 2: SFmT9ZsVopnukjvAzrxTRg folded before Flop (didn't bet)
Seat 3: LtASJ9OlkqGrrUKGQlpGAw (button) folded on the River
Seat 4: BV+K0Phf5VBHr7aZPKqbUQ (small blind) folded before Flop
Seat 5: Dh01+rohD2p9pXLYeBlC5Q (big blind) collected ($3.90)
Seat 6: a7Ux7aERFGCbT/L3ojVfAg folded before Flop (didn't bet)




PokerStars Game #59941888688:  Hold'em No Limit ($0.10/$0.25) - 2009/07/01 1:49:22 ET
Table 'vFZR6Kf2Th5xBXT9brGW6A' 6-max Seat #3 is the button
Seat 1: Q1uciOZPBR/WkAlqa6cL4A ($25 in chips) 
Seat 2: QiL+lEgEWwy21jk/ltaRLg ($20.80 in chips) 
Seat 3: SH1WjKVUjPiyXySjWSdazw ($41.30 in chips) 
Seat 4: 79ID/ub1Pt/mDpCprVmOoA ($34.95 in chips) 
Seat 5: SS/yfeArhULzIcOPe8MdPg ($27.35 in chips) 
Seat 6: 4x9jCqgSw4272dnaIqnanw ($10.55 in chips) 
79ID/ub1Pt/mDpCprVmOoA: posts small blind $0.10
SS/yfeArhULzIcOPe8MdPg: posts big blind $0.25
*** HOLE CARDS ***
4x9jCqgSw4272dnaIqnanw: folds 
Q1uciOZPBR/WkAlqa6cL4A: folds 
QiL+lEgEWwy21jk/ltaRLg: folds 
SH1WjKVUjPiyXySjWSdazw: calls $0.25
79ID/ub1Pt/mDpCprVmOoA: folds 
SS/yfeArhULzIcOPe8MdPg: checks 
*** FLOP *** [Ks Kd 7d]
SS/yfeArhULzIcOPe8MdPg: checks 
SH1WjKVUjPiyXySjWSdazw: bets $0.25
SS/yfeArhULzIcOPe8MdPg: folds 
Uncalled bet ($0.25) returned to SH1WjKVUjPiyXySjWSdazw
SH1WjKVUjPiyXySjWSdazw collected $0.60 from pot
*** SUMMARY ***
Total pot $0.60 | Rake $0 
Board [Ks Kd 7d]
Seat 1: Q1uciOZPBR/WkAlqa6cL4A folded before Flop (didn't bet)
Seat 2: QiL+lEgEWwy21jk/ltaRLg folded before Flop (didn't bet)
Seat 3: SH1WjKVUjPiyXySjWSdazw (button) collected ($0.60)
Seat 4: 79ID/ub1Pt/mDpCprVmOoA (small blind) folded before Flop
Seat 5: SS/yfeArhULzIcOPe8MdPg (big blind) folded on the Flop
Seat 6: 4x9jCqgSw4272dnaIqnanw folded before Flop (didn't bet)




PokerStars Game #59941889370:  Hold'em No Limit ($0.10/$0.25) - 2009/07/01 1:49:23 ET
Table 'NgexmgEDEzICBeSO7YCrKQ' 6-max Seat #2 is the button
Seat 1: cezpHJ8FB07dj0xG+LhOvw ($28.20 in chips) 
Seat 2: 32YL2ZEp8NT4JB2RVM9euQ ($23.55 in chips) 
Seat 3: JFIAqU8lCZ0vWwEl4bdGsg ($27.30 in chips) 
Seat 4: xx+iYCDJhHJmNzrfeloyEg ($22.05 in chips) 
Seat 5: /MXkdT8TTs8Qp2LVTQNw6w ($41.95 in chips) 
Seat 6: k9nHZTHt8hYhYRcW8NTb4g ($11.30 in chips) 
JFIAqU8lCZ0vWwEl4bdGsg: posts small blind $0.10
xx+iYCDJhHJmNzrfeloyEg: posts big blind $0.25
*** HOLE CARDS ***
/MXkdT8TTs8Qp2LVTQNw6w: folds 
k9nHZTHt8hYhYRcW8NTb4g: folds 
cezpHJ8FB07dj0xG+LhOvw: raises $0.50 to $0.75
32YL2ZEp8NT4JB2RVM9euQ: folds 
JFIAqU8lCZ0vWwEl4bdGsg: folds 
xx+iYCDJhHJmNzrfeloyEg: folds 
Uncalled bet ($0.50) returned to cezpHJ8FB07dj0xG+LhOvw
cezpHJ8FB07dj0xG+LhOvw collected $0.60 from pot
*** SUMMARY ***
Total pot $0.60 | Rake $0 
Seat 1: cezpHJ8FB07dj0xG+LhOvw collected ($0.60)
Seat 2: 32YL2ZEp8NT4JB2RVM9euQ (button) folded before Flop (didn't bet)
Seat 3: JFIAqU8lCZ0vWwEl4bdGsg (small blind) folded before Flop
Seat 4: xx+iYCDJhHJmNzrfeloyEg (big blind) folded before Flop
Seat 5: /MXkdT8TTs8Qp2LVTQNw6w folded before Flop (didn't bet)
Seat 6: k9nHZTHt8hYhYRcW8NTb4g folded before Flop (didn't bet)




PokerStars Game #59941889138:  Hold'em No Limit ($0.10/$0.25) - 2009/07/01 1:49:23 ET
Table '/AhP8uWRzEEhOATYIdmn0A' 9-max Seat #1 is the button
Seat 1: +sbyWwIcFp9kP0bDtMegfQ ($37.45 in chips) 
Seat 3: jx6dnobNHstDG0tabsbKHQ ($3.30 in chips) 
Seat 5: iZ1f67Ok/207yzIQOu1Kdg ($5 in chips) 
Seat 6: 8EbrQ/EvFWt2cr0GaU82gQ ($5 in chips) 
Seat 7: cZ99hugmLBj9KhTlc8nCSw ($25 in chips) 
Seat 8: K86cg2ifCMFAlmzsfTDjig ($42.25 in chips) 
Seat 9: OfGfQFPcghysTDljS9GQSQ ($10.60 in chips) 
jx6dnobNHstDG0tabsbKHQ: posts small blind $0.10
bXpVeaSTPBFSPJmeXxO7nw: is sitting out 
bXpVeaSTPBFSPJmeXxO7nw leaves the table
nx5EoCNZFR03YUOXyT22wQ leaves the table
iZ1f67Ok/207yzIQOu1Kdg: posts big blind $0.25
*** HOLE CARDS ***
8EbrQ/EvFWt2cr0GaU82gQ: folds 
+qc/EYCgLC65SpGvr35eNg joins the table at seat #4 
DdPXdieucQ+n99u1n3A+rQ joins the table at seat #2 
cZ99hugmLBj9KhTlc8nCSw: folds 
K86cg2ifCMFAlmzsfTDjig: raises $42 to $42.25 and is all-in
OfGfQFPcghysTDljS9GQSQ: folds 
+sbyWwIcFp9kP0bDtMegfQ: folds 
jx6dnobNHstDG0tabsbKHQ: folds 
iZ1f67Ok/207yzIQOu1Kdg: folds 
Uncalled bet ($42) returned to K86cg2ifCMFAlmzsfTDjig
K86cg2ifCMFAlmzsfTDjig collected $0.60 from pot
K86cg2ifCMFAlmzsfTDjig: doesn't show hand 
*** SUMMARY ***
Total pot $0.60 | Rake $0 
Seat 1: +sbyWwIcFp9kP0bDtMegfQ (button) folded before Flop (didn't bet)
Seat 3: jx6dnobNHstDG0tabsbKHQ (small blind) folded before Flop
Seat 5: iZ1f67Ok/207yzIQOu1Kdg (big blind) folded before Flop
Seat 6: 8EbrQ/EvFWt2cr0GaU82gQ folded before Flop (didn't bet)
Seat 7: cZ99hugmLBj9KhTlc8nCSw folded before Flop (didn't bet)
Seat 8: K86cg2ifCMFAlmzsfTDjig collected ($0.60)
Seat 9: OfGfQFPcghysTDljS9GQSQ folded before Flop (didn't bet)




PokerStars Game #59941889292:  Hold'em No Limit ($0.10/$0.25) - 2009/07/01 1:49:23 ET
Table '3lS+sU5k6mwJCS2nFMmQ6Q' 9-max Seat #2 is the button
Seat 1: VWUWpMLMj/Q1jRVpF7Aohw ($13.55 in chips) 
Seat 2: PdIasPkzm2sqZnN41ZRXOg ($5.75 in chips) 
Seat 3: 1DXccE2UUK5DIRVGlOKnTA ($12.20 in chips) 
Seat 4: GeMoapCKDLc4ajT0Uk9ZQw ($10 in chips) 
Seat 6: hJ4uYjNmSZdjrKA8cjZqCA ($35.50 in chips) 
Seat 7: Th3FldXKQW6hWVVPahaoOQ ($31.55 in chips) 
Seat 8: 9lvO/qyU+xrU95Teu1fv0g ($5 in chips) 
Seat 9: 4awUyiDYTgylQKXZ9faBVA ($48.85 in chips) 
1DXccE2UUK5DIRVGlOKnTA: posts small blind $0.10
GeMoapCKDLc4ajT0Uk9ZQw: posts big blind $0.25
*** HOLE CARDS ***
hJ4uYjNmSZdjrKA8cjZqCA: folds 
Th3FldXKQW6hWVVPahaoOQ: folds 
9lvO/qyU+xrU95Teu1fv0g: folds 
4awUyiDYTgylQKXZ9faBVA: folds 
VWUWpMLMj/Q1jRVpF7Aohw: folds 
PdIasPkzm2sqZnN41ZRXOg: folds 
1DXccE2UUK5DIRVGlOKnTA: calls $0.15
GeMoapCKDLc4ajT0Uk9ZQw: checks 
*** FLOP *** [Jd Ac Jc]
1DXccE2UUK5DIRVGlOKnTA: bets $0.75
GeMoapCKDLc4ajT0Uk9ZQw: folds 
Uncalled bet ($0.75) returned to 1DXccE2UUK5DIRVGlOKnTA
1DXccE2UUK5DIRVGlOKnTA collected $0.50 from pot
*** SUMMARY ***
Total pot $0.50 | Rake $0 
Board [Jd Ac Jc]
Seat 1: VWUWpMLMj/Q1jRVpF7Aohw folded before Flop (didn't bet)
Seat 2: PdIasPkzm2sqZnN41ZRXOg (button) folded before Flop (didn't bet)
Seat 3: 1DXccE2UUK5DIRVGlOKnTA (small blind) collected ($0.50)
Seat 4: GeMoapCKDLc4ajT0Uk9ZQw (big blind) folded on the Flop
Seat 6: hJ4uYjNmSZdjrKA8cjZqCA folded before Flop (didn't bet)
Seat 7: Th3FldXKQW6hWVVPahaoOQ folded before Flop (didn't bet)
Seat 8: 9lvO/qyU+xrU95Teu1fv0g folded before Flop (didn't bet)
Seat 9: 4awUyiDYTgylQKXZ9faBVA folded before Flop (didn't bet)




PokerStars Game #59941889398:  Hold'em No Limit ($0.10/$0.25) - 2009/07/01 1:49:23 ET
Table 'T/iCKJXGphRN3xcdwfE/JQ' 6-max Seat #2 is the button
Seat 1: wAKC8C/zN0c8V5v13dm9mA ($26.15 in chips) 
Seat 2: EeUZtMU058v2ObUACOF4Og ($31.65 in chips) 
Seat 3: IWAjoCPXtc1XUaZdp+pCpA ($22.20 in chips) 
Seat 4: m2yWOKfAxqHoy5DDN87Ttw ($25 in chips) 
Seat 6: Ey4Kn6PlnYb2srYYBJHvzg ($21.15 in chips) 
IWAjoCPXtc1XUaZdp+pCpA: posts small blind $0.10
m2yWOKfAxqHoy5DDN87Ttw: posts big blind $0.25
*** HOLE CARDS ***
Ey4Kn6PlnYb2srYYBJHvzg: calls $0.25
wAKC8C/zN0c8V5v13dm9mA: folds 
EeUZtMU058v2ObUACOF4Og: raises $0.75 to $1
IWAjoCPXtc1XUaZdp+pCpA: folds 
m2yWOKfAxqHoy5DDN87Ttw: folds 
Ey4Kn6PlnYb2srYYBJHvzg: calls $0.75
*** FLOP *** [Qh Th 8d]
Ey4Kn6PlnYb2srYYBJHvzg: checks 
y85armT09GoP0OGsamp0jA joins the table at seat #5 
EeUZtMU058v2ObUACOF4Og: bets $1.50
Ey4Kn6PlnYb2srYYBJHvzg: folds 
Uncalled bet ($1.50) returned to EeUZtMU058v2ObUACOF4Og
EeUZtMU058v2ObUACOF4Og collected $2.25 from pot
EeUZtMU058v2ObUACOF4Og: doesn't show hand 
*** SUMMARY ***
Total pot $2.35 | Rake $0.10 
Board [Qh Th 8d]
Seat 1: wAKC8C/zN0c8V5v13dm9mA folded before Flop (didn't bet)
Seat 2: EeUZtMU058v2ObUACOF4Og (button) collected ($2.25)
Seat 3: IWAjoCPXtc1XUaZdp+pCpA (small blind) folded before Flop
Seat 4: m2yWOKfAxqHoy5DDN87Ttw (big blind) folded before Flop
Seat 6: Ey4Kn6PlnYb2srYYBJHvzg folded on the Flop




PokerStars Game #59941889110:  Hold'em No Limit ($0.10/$0.25) - 2009/07/01 1:49:23 ET
Table 'G+4ZdyRoPjgaJY/jxSlZzQ' 9-max Seat #6 is the button
Seat 1: ghNKXUBl/H+t83JF079ZBA ($23.75 in chips) 
Seat 2: CT7Xj/V/O5rBlhtt+RZeFQ ($25 in chips) 
Seat 3: FaGtAm5QUVcixGhAKIvbLg ($6.60 in chips) 
Seat 4: 3PmVnC/15cl4oyI1TKIt4g ($4.65 in chips) 
Seat 5: BT6Oal0iO4P6kDuT7HFQDw ($24 in chips) 
Seat 6: oFwaTjy3ok/+qFghsrcGvg ($21.55 in chips) 
Seat 7: qwr38jl5txoR36M7G5qi4A ($10.75 in chips) 
Seat 8: bXpVeaSTPBFSPJmeXxO7nw ($4.65 in chips) 
Seat 9: tLcDklc2rBORNfixyRfVfw ($26.50 in chips) 
qwr38jl5txoR36M7G5qi4A: posts small blind $0.10
bXpVeaSTPBFSPJmeXxO7nw: posts big blind $0.25
*** HOLE CARDS ***
tLcDklc2rBORNfixyRfVfw: folds 
ghNKXUBl/H+t83JF079ZBA: folds 
CT7Xj/V/O5rBlhtt+RZeFQ: folds 
FaGtAm5QUVcixGhAKIvbLg: raises $0.25 to $0.50
3PmVnC/15cl4oyI1TKIt4g: folds 
BT6Oal0iO4P6kDuT7HFQDw: calls $0.50
oFwaTjy3ok/+qFghsrcGvg: folds 
qwr38jl5txoR36M7G5qi4A: folds 
bXpVeaSTPBFSPJmeXxO7nw: folds 
*** FLOP *** [Th 5d 3c]
FaGtAm5QUVcixGhAKIvbLg: bets $6.10 and is all-in
BT6Oal0iO4P6kDuT7HFQDw: folds 
Uncalled bet ($6.10) returned to FaGtAm5QUVcixGhAKIvbLg
FaGtAm5QUVcixGhAKIvbLg collected $1.30 from pot
*** SUMMARY ***
Total pot $1.35 | Rake $0.05 
Board [Th 5d 3c]
Seat 1: ghNKXUBl/H+t83JF079ZBA folded before Flop (didn't bet)
Seat 2: CT7Xj/V/O5rBlhtt+RZeFQ folded before Flop (didn't bet)
Seat 3: FaGtAm5QUVcixGhAKIvbLg collected ($1.30)
Seat 4: 3PmVnC/15cl4oyI1TKIt4g folded before Flop (didn't bet)
Seat 5: BT6Oal0iO4P6kDuT7HFQDw folded on the Flop
Seat 6: oFwaTjy3ok/+qFghsrcGvg (button) folded before Flop (didn't bet)
Seat 7: qwr38jl5txoR36M7G5qi4A (small blind) folded before Flop
Seat 8: bXpVeaSTPBFSPJmeXxO7nw (big blind) folded before Flop
Seat 9: tLcDklc2rBORNfixyRfVfw folded before Flop (didn't bet)




PokerStars Game #59941889604:  Hold'em No Limit ($0.10/$0.25) - 2009/07/01 1:49:24 ET
Table 'l8hUTjBTXBorNUR/tyvSLw' 9-max Seat #9 is the button
Seat 1: cZ99hugmLBj9KhTlc8nCSw ($27.95 in chips) 
Seat 2: B6xHiX1SJkS0CUNCKDVwuQ ($21.50 in chips) 
Seat 3: ShCS62CJp4MKfKLKvGKQbA ($9.10 in chips) 
Seat 4: vPtFvcPtn/Afz0sucO1cmQ ($36.70 in chips) 
Seat 5: yyG4svzOpC1A+sUP/scg6w ($6.25 in chips) 
Seat 6: EVqHvqty1ZsuvDFiSXlSqQ ($23.95 in chips) 
Seat 7: F7pnn6czNpHvRM55XcA2EA ($33.90 in chips) 
Seat 8: Mh2r9hTeTEDnh19sRZtW3g ($4.65 in chips) 
Seat 9: zDrucyjVn5aeekNEc3cJrA ($32.95 in chips) 
cZ99hugmLBj9KhTlc8nCSw: posts small blind $0.10
B6xHiX1SJkS0CUNCKDVwuQ: posts big blind $0.25
*** HOLE CARDS ***
ShCS62CJp4MKfKLKvGKQbA: folds 
vPtFvcPtn/Afz0sucO1cmQ: folds 
yyG4svzOpC1A+sUP/scg6w: calls $0.25
EVqHvqty1ZsuvDFiSXlSqQ: folds 
F7pnn6czNpHvRM55XcA2EA: folds 
Mh2r9hTeTEDnh19sRZtW3g: folds 
zDrucyjVn5aeekNEc3cJrA: folds 
cZ99hugmLBj9KhTlc8nCSw: folds 
B6xHiX1SJkS0CUNCKDVwuQ: checks 
*** FLOP *** [7c 3c Jh]
B6xHiX1SJkS0CUNCKDVwuQ: checks 
yyG4svzOpC1A+sUP/scg6w: bets $0.50
B6xHiX1SJkS0CUNCKDVwuQ: folds 
Uncalled bet ($0.50) returned to yyG4svzOpC1A+sUP/scg6w
yyG4svzOpC1A+sUP/scg6w collected $0.60 from pot
*** SUMMARY ***
Total pot $0.60 | Rake $0 
Board [7c 3c Jh]
Seat 1: cZ99hugmLBj9KhTlc8nCSw (small blind) folded before Flop
Seat 2: B6xHiX1SJkS0CUNCKDVwuQ (big blind) folded on the Flop
Seat 3: ShCS62CJp4MKfKLKvGKQbA folded before Flop (didn't bet)
Seat 4: vPtFvcPtn/Afz0sucO1cmQ folded before Flop (didn't bet)
Seat 5: yyG4svzOpC1A+sUP/scg6w collected ($0.60)
Seat 6: EVqHvqty1ZsuvDFiSXlSqQ folded before Flop (didn't bet)
Seat 7: F7pnn6czNpHvRM55XcA2EA folded before Flop (didn't bet)
Seat 8: Mh2r9hTeTEDnh19sRZtW3g folded before Flop (didn't bet)
Seat 9: zDrucyjVn5aeekNEc3cJrA (button) folded before Flop (didn't bet)




PokerStars Game #59941889982:  Hold'em No Limit ($0.10/$0.25) - 2009/07/01 1:49:24 ET
Table 'PCxB2W9H6ma8SwsZlImuOw' 9-max Seat #3 is the button
Seat 1: SqibpGx+lf+brY0fJVvD0w ($33.45 in chips) 
Seat 2: bXpVeaSTPBFSPJmeXxO7nw ($4.65 in chips) 
Seat 3: J2a/QHAWUgo6beDRoEyg2g ($6.60 in chips) 
Seat 4: RsPwA2DnzOke3hD/Of/DUg ($2.30 in chips) 
Seat 5: GZO7tOXatVoX17M2DqPcUQ ($12.15 in chips) 
Seat 6: 5/6dWEBUHldD7iGXa2LwsQ ($16.20 in chips) 
Seat 7: c/9X4zftzphFxYtxp5kp9w ($27.75 in chips) 
Seat 8: Pt637jKksB5MzP0UNJAAkw ($25.60 in chips) 
Seat 9: COwSH15MvHaRF7en6/TRZQ ($6.70 in chips) 
RsPwA2DnzOke3hD/Of/DUg: posts small blind $0.10
GZO7tOXatVoX17M2DqPcUQ: posts big blind $0.25
*** HOLE CARDS ***
5/6dWEBUHldD7iGXa2LwsQ: raises $0.50 to $0.75
c/9X4zftzphFxYtxp5kp9w: calls $0.75
Pt637jKksB5MzP0UNJAAkw: folds 
COwSH15MvHaRF7en6/TRZQ: folds 
SqibpGx+lf+brY0fJVvD0w: calls $0.75
bXpVeaSTPBFSPJmeXxO7nw: folds 
J2a/QHAWUgo6beDRoEyg2g: calls $0.75
RsPwA2DnzOke3hD/Of/DUg: folds 
GZO7tOXatVoX17M2DqPcUQ: raises $11.40 to $12.15 and is all-in
5/6dWEBUHldD7iGXa2LwsQ: folds 
c/9X4zftzphFxYtxp5kp9w: folds 
SqibpGx+lf+brY0fJVvD0w: folds 
J2a/QHAWUgo6beDRoEyg2g: folds 
Uncalled bet ($11.40) returned to GZO7tOXatVoX17M2DqPcUQ
GZO7tOXatVoX17M2DqPcUQ collected $3.85 from pot
*** SUMMARY ***
Total pot $3.85 | Rake $0 
Seat 1: SqibpGx+lf+brY0fJVvD0w folded before Flop
Seat 2: bXpVeaSTPBFSPJmeXxO7nw folded before Flop (didn't bet)
Seat 3: J2a/QHAWUgo6beDRoEyg2g (button) folded before Flop
Seat 4: RsPwA2DnzOke3hD/Of/DUg (small blind) folded before Flop
Seat 5: GZO7tOXatVoX17M2DqPcUQ (big blind) collected ($3.85)
Seat 6: 5/6dWEBUHldD7iGXa2LwsQ folded before Flop
Seat 7: c/9X4zftzphFxYtxp5kp9w folded before Flop
Seat 8: Pt637jKksB5MzP0UNJAAkw folded before Flop (didn't bet)
Seat 9: COwSH15MvHaRF7en6/TRZQ folded before Flop (didn't bet)




PokerStars Game #59941889968:  Hold'em No Limit ($0.10/$0.25) - 2009/07/01 1:49:24 ET
Table '/VaaaFnlEJoYVomG9uxHkA' 9-max Seat #7 is the button
Seat 1: Th3FldXKQW6hWVVPahaoOQ ($26.65 in chips) 
Seat 2: DIkeSkosO/tsUp9d2JVyTA ($54.75 in chips) 
Seat 3: MtVtHDqIJTyUcXkRBBDIVA ($26.15 in chips) 
Seat 4: j4q3p0lesp63b1gZDwLBZw ($5.35 in chips) 
Seat 5: cZ99hugmLBj9KhTlc8nCSw ($25 in chips) 
Seat 7: F7pnn6czNpHvRM55XcA2EA ($31.25 in chips) 
Seat 8: dfNim92Z6XK1/h5SFW5vDg ($50.60 in chips) 
Seat 9: DdPXdieucQ+n99u1n3A+rQ ($5 in chips) 
dfNim92Z6XK1/h5SFW5vDg: posts small blind $0.10
DdPXdieucQ+n99u1n3A+rQ: posts big blind $0.25
*** HOLE CARDS ***
Th3FldXKQW6hWVVPahaoOQ: folds 
DIkeSkosO/tsUp9d2JVyTA: folds 
MtVtHDqIJTyUcXkRBBDIVA: raises $0.50 to $0.75
j4q3p0lesp63b1gZDwLBZw: folds 
cZ99hugmLBj9KhTlc8nCSw: folds 
F7pnn6czNpHvRM55XcA2EA: folds 
dfNim92Z6XK1/h5SFW5vDg: folds 
DdPXdieucQ+n99u1n3A+rQ: folds 
Uncalled bet ($0.50) returned to MtVtHDqIJTyUcXkRBBDIVA
MtVtHDqIJTyUcXkRBBDIVA collected $0.60 from pot
MtVtHDqIJTyUcXkRBBDIVA: doesn't show hand 
*** SUMMARY ***
Total pot $0.60 | Rake $0 
Seat 1: Th3FldXKQW6hWVVPahaoOQ folded before Flop (didn't bet)
Seat 2: DIkeSkosO/tsUp9d2JVyTA folded before Flop (didn't bet)
Seat 3: MtVtHDqIJTyUcXkRBBDIVA collected ($0.60)
Seat 4: j4q3p0lesp63b1gZDwLBZw folded before Flop (didn't bet)
Seat 5: cZ99hugmLBj9KhTlc8nCSw folded before Flop (didn't bet)
Seat 7: F7pnn6czNpHvRM55XcA2EA (button) folded before Flop (didn't bet)
Seat 8: dfNim92Z6XK1/h5SFW5vDg (small blind) folded before Flop
Seat 9: DdPXdieucQ+n99u1n3A+rQ (big blind) folded before Flop




PokerStars Game #59941889666:  Hold'em No Limit ($0.10/$0.25) - 2009/07/01 1:49:24 ET
Table 'AJGgX1ZYM8d68SWMvaLttg' 6-max Seat #3 is the button
Seat 1: Q1uciOZPBR/WkAlqa6cL4A ($25 in chips) 
Seat 2: zHHLkD2sRljslKKeQv/ZQw ($26.25 in chips) 
Seat 3: 8ClCHtFXGNplITm+63KB+Q ($38.35 in chips) 
Seat 4: e30C3DfdG5TfPnR16/oMmA ($20.45 in chips) 
Seat 5: Hsvkc0/G2VV78oVmWYXecw ($5 in chips) 
e30C3DfdG5TfPnR16/oMmA: posts small blind $0.10
Hsvkc0/G2VV78oVmWYXecw: posts big blind $0.25
UA5OsKS3VPaxa7uC8La/kA: sits out 
*** HOLE CARDS ***
Q1uciOZPBR/WkAlqa6cL4A: folds 
zHHLkD2sRljslKKeQv/ZQw: raises $0.50 to $0.75
8ClCHtFXGNplITm+63KB+Q: folds 
e30C3DfdG5TfPnR16/oMmA: calls $0.65
Hsvkc0/G2VV78oVmWYXecw: folds 
*** FLOP *** [As 4c 6s]
e30C3DfdG5TfPnR16/oMmA: bets $0.75
zHHLkD2sRljslKKeQv/ZQw: folds 
Uncalled bet ($0.75) returned to e30C3DfdG5TfPnR16/oMmA
e30C3DfdG5TfPnR16/oMmA collected $1.70 from pot
*** SUMMARY ***
Total pot $1.75 | Rake $0.05 
Board [As 4c 6s]
Seat 1: Q1uciOZPBR/WkAlqa6cL4A folded before Flop (didn't bet)
Seat 2: zHHLkD2sRljslKKeQv/ZQw folded on the Flop
Seat 3: 8ClCHtFXGNplITm+63KB+Q (button) folded before Flop (didn't bet)
Seat 4: e30C3DfdG5TfPnR16/oMmA (small blind) collected ($1.70)
Seat 5: Hsvkc0/G2VV78oVmWYXecw (big blind) folded before Flop




PokerStars Game #59941889818:  Hold'em No Limit ($0.10/$0.25) - 2009/07/01 1:49:24 ET
Table 'dZNBGqFYSwfOVZvDJ4VjIQ' 6-max Seat #6 is the button
Seat 1: v+QfkGiuj9bgtuNoVnDO8w ($38.10 in chips) 
Seat 2: 3zD3qLXT1bEffAoWGnc7wg ($28.30 in chips) 
Seat 3: kyRaCIljYA6l33lSKQfNsg ($29 in chips) 
Seat 5: +ZlnqPoP3Hg4BIUxDfKd/A ($29.10 in chips) 
Seat 6: ypmjhffk/YHGc51wgVXUTw ($29.05 in chips) 
v+QfkGiuj9bgtuNoVnDO8w: posts small blind $0.10
3zD3qLXT1bEffAoWGnc7wg: posts big blind $0.25
*** HOLE CARDS ***
kyRaCIljYA6l33lSKQfNsg: raises $0.50 to $0.75
+ZlnqPoP3Hg4BIUxDfKd/A: folds 
ypmjhffk/YHGc51wgVXUTw: folds 
v+QfkGiuj9bgtuNoVnDO8w: folds 
3zD3qLXT1bEffAoWGnc7wg: folds 
Uncalled bet ($0.50) returned to kyRaCIljYA6l33lSKQfNsg
kyRaCIljYA6l33lSKQfNsg collected $0.60 from pot
*** SUMMARY ***
Total pot $0.60 | Rake $0 
Seat 1: v+QfkGiuj9bgtuNoVnDO8w (small blind) folded before Flop
Seat 2: 3zD3qLXT1bEffAoWGnc7wg (big blind) folded before Flop
Seat 3: kyRaCIljYA6l33lSKQfNsg collected ($0.60)
Seat 5: +ZlnqPoP3Hg4BIUxDfKd/A folded before Flop (didn't bet)
Seat 6: ypmjhffk/YHGc51wgVXUTw (button) folded before Flop (didn't bet)




PokerStars Game #59941889912:  Hold'em No Limit ($0.10/$0.25) - 2009/07/01 1:49:24 ET
Table 'biAgO3TKQBU8XcrVAoU5TA' 6-max Seat #6 is the button
Seat 1: jhDPlkir8wBYAddboBuF7Q ($13.30 in chips) 
Seat 3: mfrkWA3PTeYPkbO6hi98Aw ($29.40 in chips) 
Seat 4: Hsvkc0/G2VV78oVmWYXecw ($5 in chips) 
Seat 5: n6UPMnVR4v8LFP0rWP73Fg ($15.35 in chips) 
Seat 6: wMiE3yTbDJGOLOF9th7KPA ($9.25 in chips) 
jhDPlkir8wBYAddboBuF7Q: posts small blind $0.10
GbCVUNssQ7mqsPWr7J4d3w: is sitting out 
mfrkWA3PTeYPkbO6hi98Aw: posts big blind $0.25
*** HOLE CARDS ***
GbCVUNssQ7mqsPWr7J4d3w has returned
GbCVUNssQ7mqsPWr7J4d3w leaves the table
Hsvkc0/G2VV78oVmWYXecw: raises $0.50 to $0.75
n6UPMnVR4v8LFP0rWP73Fg: folds 
wMiE3yTbDJGOLOF9th7KPA: calls $0.75
jhDPlkir8wBYAddboBuF7Q: calls $0.65
mfrkWA3PTeYPkbO6hi98Aw: calls $0.50
*** FLOP *** [4s Qd 4d]
jhDPlkir8wBYAddboBuF7Q: bets $0.75
mfrkWA3PTeYPkbO6hi98Aw: raises $2.25 to $3
Hsvkc0/G2VV78oVmWYXecw: folds 
wMiE3yTbDJGOLOF9th7KPA: raises $5.50 to $8.50 and is all-in
tayolor1made joins the table at seat #2 
jhDPlkir8wBYAddboBuF7Q: folds 
mfrkWA3PTeYPkbO6hi98Aw: calls $5.50
*** TURN *** [4s Qd 4d] [Jd]
*** RIVER *** [4s Qd 4d Jd] [8s]
*** SHOW DOWN ***
mfrkWA3PTeYPkbO6hi98Aw: shows [Qh Ah] (two pair, Queens and Fours)
wMiE3yTbDJGOLOF9th7KPA: shows [4c Jc] (a full house, Fours full of Jacks)
wMiE3yTbDJGOLOF9th7KPA collected $19.75 from pot
*** SUMMARY ***
Total pot $20.75 | Rake $1 
Board [4s Qd 4d Jd 8s]
Seat 1: jhDPlkir8wBYAddboBuF7Q (small blind) folded on the Flop
Seat 3: mfrkWA3PTeYPkbO6hi98Aw (big blind) showed [Qh Ah] and lost with two pair, Queens and Fours
Seat 4: Hsvkc0/G2VV78oVmWYXecw folded on the Flop
Seat 5: n6UPMnVR4v8LFP0rWP73Fg folded before Flop (didn't bet)
Seat 6: wMiE3yTbDJGOLOF9th7KPA (button) showed [4c Jc] and won ($19.75) with a full house, Fours full of Jacks




PokerStars Game #59941889990:  Hold'em No Limit ($0.10/$0.25) - 2009/07/01 1:49:24 ET
Table 'QegsWX65l3n/K0A8XB78yg' 6-max Seat #5 is the button
Seat 1: p6adJRMXMBLr+xtQzqazIQ ($12.35 in chips) 
Seat 2: GC/9yVD59DUCX7hUI7gcLw ($58.60 in chips) 
Seat 3: iIgNoBh+3/Ix1/fLsg+HuA ($5.65 in chips) 
Seat 4: epAUIB7h2FJXzUPRIvSkRA ($25 in chips) 
Seat 5: QqiZLFrN8iOUT/GHw7ztOA ($28.95 in chips) 
Seat 6: 5PWs02z65jSO5pr/M6wx/w ($6.20 in chips) 
5PWs02z65jSO5pr/M6wx/w: posts small blind $0.10
p6adJRMXMBLr+xtQzqazIQ: posts big blind $0.25
*** HOLE CARDS ***
GC/9yVD59DUCX7hUI7gcLw: folds 
iIgNoBh+3/Ix1/fLsg+HuA: raises $0.50 to $0.75
epAUIB7h2FJXzUPRIvSkRA: folds 
QqiZLFrN8iOUT/GHw7ztOA: folds 
5PWs02z65jSO5pr/M6wx/w: folds 
p6adJRMXMBLr+xtQzqazIQ: folds 
Uncalled bet ($0.50) returned to iIgNoBh+3/Ix1/fLsg+HuA
iIgNoBh+3/Ix1/fLsg+HuA collected $0.60 from pot
iIgNoBh+3/Ix1/fLsg+HuA: doesn't show hand 
*** SUMMARY ***
Total pot $0.60 | Rake $0 
Seat 1: p6adJRMXMBLr+xtQzqazIQ (big blind) folded before Flop
Seat 2: GC/9yVD59DUCX7hUI7gcLw folded before Flop (didn't bet)
Seat 3: iIgNoBh+3/Ix1/fLsg+HuA collected ($0.60)
Seat 4: epAUIB7h2FJXzUPRIvSkRA folded before Flop (didn't bet)
Seat 5: QqiZLFrN8iOUT/GHw7ztOA (button) folded before Flop (didn't bet)
Seat 6: 5PWs02z65jSO5pr/M6wx/w (small blind) folded before Flop




PokerStars Game #59941890082:  Hold'em No Limit ($0.10/$0.25) - 2009/07/01 1:49:25 ET
Table 'Pz8SfAzhP5nvWTsJRAxoDg' 6-max Seat #6 is the button
Seat 1: QiL+lEgEWwy21jk/ltaRLg ($46.90 in chips) 
Seat 2: k021eD5in2AjaloW5PalMg ($18.80 in chips) 
Seat 3: mfrkWA3PTeYPkbO6hi98Aw ($31.45 in chips) 
Seat 4: 4lJto+Qj0K4JrFKvHaPTLw ($63 in chips) 
Seat 5: FYepjhAvF8ZdVCmqHIy+eQ ($25 in chips) 
Seat 6: QvTX2yGq3uKJiKPmns4TKQ ($17.70 in chips) 
QiL+lEgEWwy21jk/ltaRLg: posts small blind $0.10
k021eD5in2AjaloW5PalMg: posts big blind $0.25
*** HOLE CARDS ***
mfrkWA3PTeYPkbO6hi98Aw: folds 
4lJto+Qj0K4JrFKvHaPTLw: raises $0.75 to $1
FYepjhAvF8ZdVCmqHIy+eQ: folds 
QvTX2yGq3uKJiKPmns4TKQ: folds 
QiL+lEgEWwy21jk/ltaRLg: folds 
k021eD5in2AjaloW5PalMg: folds 
Uncalled bet ($0.75) returned to 4lJto+Qj0K4JrFKvHaPTLw
4lJto+Qj0K4JrFKvHaPTLw collected $0.60 from pot
4lJto+Qj0K4JrFKvHaPTLw: doesn't show hand 
*** SUMMARY ***
Total pot $0.60 | Rake $0 
Seat 1: QiL+lEgEWwy21jk/ltaRLg (small blind) folded before Flop
Seat 2: k021eD5in2AjaloW5PalMg (big blind) folded before Flop
Seat 3: mfrkWA3PTeYPkbO6hi98Aw folded before Flop (didn't bet)
Seat 4: 4lJto+Qj0K4JrFKvHaPTLw collected ($0.60)
Seat 5: FYepjhAvF8ZdVCmqHIy+eQ folded before Flop (didn't bet)
Seat 6: QvTX2yGq3uKJiKPmns4TKQ (button) folded before Flop (didn't bet)




PokerStars Game #59941890472:  Hold'em No Limit ($0.10/$0.25) - 2009/07/01 1:49:25 ET
Table 'mk323gviqdkOY5Aek/1EWg' 6-max Seat #3 is the button
Seat 1: 7cx44/slbeTw+Cy7QB8Trg ($25 in chips) 
Seat 2: GC/9yVD59DUCX7hUI7gcLw ($55.30 in chips) 
Seat 3: NuqYPwTLZYQhxOoVK3Yqlw ($24.65 in chips) 
Seat 4: +baiVgI/ETnBARLe5mARCw ($11.30 in chips) 
Seat 5: kjYRzIfvZNNflYMYRkkSVA ($36.65 in chips) 
Seat 6: KkXSr5xFjxLSD3wtAvT+WQ ($9 in chips) 
+baiVgI/ETnBARLe5mARCw: posts small blind $0.10
kjYRzIfvZNNflYMYRkkSVA: posts big blind $0.25
*** HOLE CARDS ***
KkXSr5xFjxLSD3wtAvT+WQ: calls $0.25
7cx44/slbeTw+Cy7QB8Trg: folds 
GC/9yVD59DUCX7hUI7gcLw: raises $1 to $1.25
NuqYPwTLZYQhxOoVK3Yqlw: calls $1.25
+baiVgI/ETnBARLe5mARCw: folds 
kjYRzIfvZNNflYMYRkkSVA: folds 
KkXSr5xFjxLSD3wtAvT+WQ: calls $1
*** FLOP *** [9d 8s 3s]
KkXSr5xFjxLSD3wtAvT+WQ: checks 
GC/9yVD59DUCX7hUI7gcLw: checks 
NuqYPwTLZYQhxOoVK3Yqlw: bets $2.50
KkXSr5xFjxLSD3wtAvT+WQ: folds 
GC/9yVD59DUCX7hUI7gcLw: folds 
Uncalled bet ($2.50) returned to NuqYPwTLZYQhxOoVK3Yqlw
NuqYPwTLZYQhxOoVK3Yqlw collected $3.90 from pot
NuqYPwTLZYQhxOoVK3Yqlw: doesn't show hand 
*** SUMMARY ***
Total pot $4.10 | Rake $0.20 
Board [9d 8s 3s]
Seat 1: 7cx44/slbeTw+Cy7QB8Trg folded before Flop (didn't bet)
Seat 2: GC/9yVD59DUCX7hUI7gcLw folded on the Flop
Seat 3: NuqYPwTLZYQhxOoVK3Yqlw (button) collected ($3.90)
Seat 4: +baiVgI/ETnBARLe5mARCw (small blind) folded before Flop
Seat 5: kjYRzIfvZNNflYMYRkkSVA (big blind) folded before Flop
Seat 6: KkXSr5xFjxLSD3wtAvT+WQ folded on the Flop




PokerStars Game #59941890378:  Hold'em No Limit ($0.10/$0.25) - 2009/07/01 1:49:25 ET
Table '7/qMNloI0nSXWiX5Y1watA' 9-max Seat #8 is the button
Seat 1: /LyhaB3V6jkgOfXORidqRQ ($10.75 in chips) 
Seat 2: wGigCmBR/9XWkPpvYos3aQ ($25 in chips) 
Seat 3: W2YYHvqjaEpRrO7stZkClQ ($5 in chips) 
Seat 4: K0LdhPeU31rviEPo6Sv3TA ($9.35 in chips) 
Seat 6: Y3DZ6qQlLeBhixDj4M9vmg ($12.35 in chips) 
Seat 8: ljemhp25Zg+nlA9DLCIiUw ($26.05 in chips) 
Seat 9: dmYlc+1cjwZMJ7wV+Z0rRg ($26.80 in chips) 
dmYlc+1cjwZMJ7wV+Z0rRg: posts small blind $0.10
/LyhaB3V6jkgOfXORidqRQ: posts big blind $0.25
GeMoapCKDLc4ajT0Uk9ZQw: sits out 
*** HOLE CARDS ***
wGigCmBR/9XWkPpvYos3aQ: folds 
W2YYHvqjaEpRrO7stZkClQ: folds 
K0LdhPeU31rviEPo6Sv3TA: folds 
Y3DZ6qQlLeBhixDj4M9vmg: folds 
ljemhp25Zg+nlA9DLCIiUw: folds 
Y3DZ6qQlLeBhixDj4M9vmg leaves the table
dmYlc+1cjwZMJ7wV+Z0rRg: raises $0.50 to $0.75
/LyhaB3V6jkgOfXORidqRQ: folds 
Uncalled bet ($0.50) returned to dmYlc+1cjwZMJ7wV+Z0rRg
dmYlc+1cjwZMJ7wV+Z0rRg collected $0.50 from pot
dmYlc+1cjwZMJ7wV+Z0rRg: doesn't show hand 
*** SUMMARY ***
Total pot $0.50 | Rake $0 
Seat 1: /LyhaB3V6jkgOfXORidqRQ (big blind) folded before Flop
Seat 2: wGigCmBR/9XWkPpvYos3aQ folded before Flop (didn't bet)
Seat 3: W2YYHvqjaEpRrO7stZkClQ folded before Flop (didn't bet)
Seat 4: K0LdhPeU31rviEPo6Sv3TA folded before Flop (didn't bet)
Seat 6: Y3DZ6qQlLeBhixDj4M9vmg folded before Flop (didn't bet)
Seat 8: ljemhp25Zg+nlA9DLCIiUw (button) folded before Flop (didn't bet)
Seat 9: dmYlc+1cjwZMJ7wV+Z0rRg (small blind) collected ($0.50)




PokerStars Game #59941890422:  Hold'em No Limit ($0.10/$0.25) - 2009/07/01 1:49:25 ET
Table 'zhqgUUprOJ14VxKxPHcT/Q' 9-max Seat #6 is the button
Seat 1: 22dIObOuor/A+IKWkNoAlA ($5.85 in chips) 
Seat 2: GY095KWhBevJ1Ttvl8WseA ($14.25 in chips) 
Seat 3: 4XHsdGnQ76EBdBvsrSs8bA ($20.55 in chips) 
Seat 4: wGigCmBR/9XWkPpvYos3aQ ($33.45 in chips) 
Seat 5: +sbyWwIcFp9kP0bDtMegfQ ($33.25 in chips) 
Seat 6: PdIasPkzm2sqZnN41ZRXOg ($5 in chips) 
Seat 8: EQXHDnIzAsORnIXRNtXRlA ($29.60 in chips) 
bXpVeaSTPBFSPJmeXxO7nw will be allowed to play after the button
EQXHDnIzAsORnIXRNtXRlA: posts small blind $0.10
4awUyiDYTgylQKXZ9faBVA: is sitting out 
4awUyiDYTgylQKXZ9faBVA leaves the table
22dIObOuor/A+IKWkNoAlA: posts big blind $0.25
*** HOLE CARDS ***
GY095KWhBevJ1Ttvl8WseA: folds 
4XHsdGnQ76EBdBvsrSs8bA: raises $0.25 to $0.50
CGjLyv/AvljZy2g76nYkzQ joins the table at seat #9 
wGigCmBR/9XWkPpvYos3aQ: folds 
+sbyWwIcFp9kP0bDtMegfQ: folds 
PdIasPkzm2sqZnN41ZRXOg: folds 
EQXHDnIzAsORnIXRNtXRlA: folds 
22dIObOuor/A+IKWkNoAlA: folds 
Uncalled bet ($0.25) returned to 4XHsdGnQ76EBdBvsrSs8bA
4XHsdGnQ76EBdBvsrSs8bA collected $0.60 from pot
4XHsdGnQ76EBdBvsrSs8bA: doesn't show hand 
*** SUMMARY ***
Total pot $0.60 | Rake $0 
Seat 1: 22dIObOuor/A+IKWkNoAlA (big blind) folded before Flop
Seat 2: GY095KWhBevJ1Ttvl8WseA folded before Flop (didn't bet)
Seat 3: 4XHsdGnQ76EBdBvsrSs8bA collected ($0.60)
Seat 4: wGigCmBR/9XWkPpvYos3aQ folded before Flop (didn't bet)
Seat 5: +sbyWwIcFp9kP0bDtMegfQ folded before Flop (didn't bet)
Seat 6: PdIasPkzm2sqZnN41ZRXOg (button) folded before Flop (didn't bet)
Seat 8: EQXHDnIzAsORnIXRNtXRlA (small blind) folded before Flop




PokerStars Game #59941890020:  Hold'em No Limit ($0.10/$0.25) - 2009/07/01 1:49:25 ET
Table 'nyTW9cVtYentc5V7xU/0jA' 6-max Seat #3 is the button
Seat 1: HI20pVxSHPZ29u9IDkmICg ($10.40 in chips) 
Seat 3: kG34n23qFQA3nzdOJTQ1dA ($35.50 in chips) 
Seat 4: NkB3D4eVHHXvB9Edaugc1Q ($35.30 in chips) 
Seat 5: zZAcuQ0EvirdEuiIbeaocQ ($3.60 in chips) 
Seat 6: Cwf8Ho8JHNvwzsv9ah8uRQ ($19.15 in chips) 
NkB3D4eVHHXvB9Edaugc1Q: posts small blind $0.10
zZAcuQ0EvirdEuiIbeaocQ: posts big blind $0.25
*** HOLE CARDS ***
Cwf8Ho8JHNvwzsv9ah8uRQ: folds 
HI20pVxSHPZ29u9IDkmICg: raises $0.50 to $0.75
kG34n23qFQA3nzdOJTQ1dA: folds 
NkB3D4eVHHXvB9Edaugc1Q: folds 
glad1kkk joins the table at seat #2 
zZAcuQ0EvirdEuiIbeaocQ: calls $0.50
*** FLOP *** [Js 7s 4d]
zZAcuQ0EvirdEuiIbeaocQ: checks 
HI20pVxSHPZ29u9IDkmICg: bets $0.75
zZAcuQ0EvirdEuiIbeaocQ: calls $0.75
*** TURN *** [Js 7s 4d] [2d]
zZAcuQ0EvirdEuiIbeaocQ: checks 
HI20pVxSHPZ29u9IDkmICg: bets $2.50
zZAcuQ0EvirdEuiIbeaocQ: calls $2.10 and is all-in
Uncalled bet ($0.40) returned to HI20pVxSHPZ29u9IDkmICg
*** RIVER *** [Js 7s 4d 2d] [7d]
*** SHOW DOWN ***
zZAcuQ0EvirdEuiIbeaocQ: shows [Ah Ad] (two pair, Aces and Sevens)
HI20pVxSHPZ29u9IDkmICg: mucks hand 
zZAcuQ0EvirdEuiIbeaocQ collected $6.95 from pot
*** SUMMARY ***
Total pot $7.30 | Rake $0.35 
Board [Js 7s 4d 2d 7d]
Seat 1: HI20pVxSHPZ29u9IDkmICg mucked
Seat 3: kG34n23qFQA3nzdOJTQ1dA (button) folded before Flop (didn't bet)
Seat 4: NkB3D4eVHHXvB9Edaugc1Q (small blind) folded before Flop
Seat 5: zZAcuQ0EvirdEuiIbeaocQ (big blind) showed [Ah Ad] and won ($6.95) with two pair, Aces and Sevens
Seat 6: Cwf8Ho8JHNvwzsv9ah8uRQ folded before Flop (didn't bet)




PokerStars Game #59941890330:  Hold'em No Limit ($0.10/$0.25) - 2009/07/01 1:49:25 ET
Table 'Mef6A0EMopL6WaFO5/KO9g' 6-max Seat #4 is the button
Seat 1: GbCVUNssQ7mqsPWr7J4d3w ($5 in chips) 
Seat 2: 8ClCHtFXGNplITm+63KB+Q ($29.70 in chips) 
Seat 4: lquriepNQBhDV5P1SWHhnA ($25 in chips) 
Seat 5: DihMHaz4WNETH1bPDe13kA ($41.15 in chips) 
Seat 6: jp34e617tIzV8tKIWmfAbA ($37.55 in chips) 
DihMHaz4WNETH1bPDe13kA: posts small blind $0.10
jp34e617tIzV8tKIWmfAbA: posts big blind $0.25
*** HOLE CARDS ***
GbCVUNssQ7mqsPWr7J4d3w: folds 
Wq26opBLDGJe91GRJn2epg has returned
8ClCHtFXGNplITm+63KB+Q: folds 
lquriepNQBhDV5P1SWHhnA: folds 
DihMHaz4WNETH1bPDe13kA: folds 
Uncalled bet ($0.15) returned to jp34e617tIzV8tKIWmfAbA
Wq26opBLDGJe91GRJn2epg leaves the table
jp34e617tIzV8tKIWmfAbA collected $0.20 from pot
*** SUMMARY ***
Total pot $0.20 | Rake $0 
Seat 1: GbCVUNssQ7mqsPWr7J4d3w folded before Flop (didn't bet)
Seat 2: 8ClCHtFXGNplITm+63KB+Q folded before Flop (didn't bet)
Seat 4: lquriepNQBhDV5P1SWHhnA (button) folded before Flop (didn't bet)
Seat 5: DihMHaz4WNETH1bPDe13kA (small blind) folded before Flop
Seat 6: jp34e617tIzV8tKIWmfAbA (big blind) collected ($0.20)




PokerStars Game #59941890928:  Hold'em No Limit ($0.10/$0.25) - 2009/07/01 1:49:26 ET
Table 'yZgGBnUGXVCcEJdcqes8tw' 9-max Seat #1 is the button
Seat 1: 6RiVTYll/5D8zICp0MRpKw ($30.30 in chips) 
Seat 2: MG90wfSJZnOejs/KD3vlQQ ($25 in chips) 
Seat 4: M2QO2DxB5Wawg2h8HSpnYA ($10 in chips) 
Seat 5: dfNim92Z6XK1/h5SFW5vDg ($25.85 in chips) 
Seat 6: RHqgdFvufLCYe54+qd2gcA ($5 in chips) 
Seat 7: eC8Pn1D6Y2pct8o62nQfvQ ($31.20 in chips) 
Seat 8: dtZ84flFEi4Q+SGrHMJRDQ ($29.80 in chips) 
Seat 9: M/9j4wkHH9i1JM51vgi1VA ($23.40 in chips) 
MG90wfSJZnOejs/KD3vlQQ: posts small blind $0.10
M2QO2DxB5Wawg2h8HSpnYA: posts big blind $0.25
*** HOLE CARDS ***
dfNim92Z6XK1/h5SFW5vDg: folds 
RHqgdFvufLCYe54+qd2gcA: folds 
eC8Pn1D6Y2pct8o62nQfvQ: folds 
dtZ84flFEi4Q+SGrHMJRDQ: folds 
M/9j4wkHH9i1JM51vgi1VA: folds 
6RiVTYll/5D8zICp0MRpKw: folds 
MG90wfSJZnOejs/KD3vlQQ: folds 
Uncalled bet ($0.15) returned to M2QO2DxB5Wawg2h8HSpnYA
M2QO2DxB5Wawg2h8HSpnYA collected $0.20 from pot
M2QO2DxB5Wawg2h8HSpnYA: doesn't show hand 
*** SUMMARY ***
Total pot $0.20 | Rake $0 
Seat 1: 6RiVTYll/5D8zICp0MRpKw (button) folded before Flop (didn't bet)
Seat 2: MG90wfSJZnOejs/KD3vlQQ (small blind) folded before Flop
Seat 4: M2QO2DxB5Wawg2h8HSpnYA (big blind) collected ($0.20)
Seat 5: dfNim92Z6XK1/h5SFW5vDg folded before Flop (didn't bet)
Seat 6: RHqgdFvufLCYe54+qd2gcA folded before Flop (didn't bet)
Seat 7: eC8Pn1D6Y2pct8o62nQfvQ folded before Flop (didn't bet)
Seat 8: dtZ84flFEi4Q+SGrHMJRDQ folded before Flop (didn't bet)
Seat 9: M/9j4wkHH9i1JM51vgi1VA folded before Flop (didn't bet)




PokerStars Game #59941890792:  Hold'em No Limit ($0.10/$0.25) - 2009/07/01 1:49:26 ET
Table 'dVzscin98UhGisTmV9BDcw' 9-max Seat #3 is the button
Seat 1: sBAwXpkpgyhyWbHIQcIJKA ($17.15 in chips) 
Seat 2: dfNim92Z6XK1/h5SFW5vDg ($28 in chips) 
Seat 3: cZ99hugmLBj9KhTlc8nCSw ($25 in chips) 
Seat 5: E0iYnEVO2ho7dH3QcCjw7g ($24.65 in chips) 
Seat 6: A/OkFabqdcrG3ozpiYMiNQ ($20.50 in chips) 
Seat 7: cKlmpQMahVsmOaxFQDcoOg ($25.25 in chips) 
Seat 8: /vn2Qu2dvc9AMMq46Ae0jA ($46.75 in chips) 
Seat 9: arxNSjreDRGFg13EAM2F1w ($25 in chips) 
E0iYnEVO2ho7dH3QcCjw7g: posts small blind $0.10
A/OkFabqdcrG3ozpiYMiNQ: posts big blind $0.25
*** HOLE CARDS ***
cKlmpQMahVsmOaxFQDcoOg: folds 
/vn2Qu2dvc9AMMq46Ae0jA: calls $0.25
arxNSjreDRGFg13EAM2F1w: folds 
sBAwXpkpgyhyWbHIQcIJKA: folds 
dfNim92Z6XK1/h5SFW5vDg: raises $1.25 to $1.50
cZ99hugmLBj9KhTlc8nCSw: folds 
E0iYnEVO2ho7dH3QcCjw7g: folds 
A/OkFabqdcrG3ozpiYMiNQ: folds 
/vn2Qu2dvc9AMMq46Ae0jA: calls $1.25
*** FLOP *** [8d Tc 8s]
/vn2Qu2dvc9AMMq46Ae0jA: checks 
dfNim92Z6XK1/h5SFW5vDg: bets $2
/vn2Qu2dvc9AMMq46Ae0jA: raises $2 to $4
dfNim92Z6XK1/h5SFW5vDg: calls $2
*** TURN *** [8d Tc 8s] [7c]
/vn2Qu2dvc9AMMq46Ae0jA: bets $3.25
dfNim92Z6XK1/h5SFW5vDg: calls $3.25
*** RIVER *** [8d Tc 8s 7c] [9s]
/vn2Qu2dvc9AMMq46Ae0jA: checks 
aNpwfA31EREwO+ar4XzBCw leaves the table
dfNim92Z6XK1/h5SFW5vDg: bets $2.50
/vn2Qu2dvc9AMMq46Ae0jA: calls $2.50
*** SHOW DOWN ***
dfNim92Z6XK1/h5SFW5vDg: shows [Js Jh] (a straight, Seven to Jack)
/vn2Qu2dvc9AMMq46Ae0jA: mucks hand 
dfNim92Z6XK1/h5SFW5vDg collected $21.75 from pot
*** SUMMARY ***
Total pot $22.85 | Rake $1.10 
Board [8d Tc 8s 7c 9s]
Seat 1: sBAwXpkpgyhyWbHIQcIJKA folded before Flop (didn't bet)
Seat 2: dfNim92Z6XK1/h5SFW5vDg showed [Js Jh] and won ($21.75) with a straight, Seven to Jack
Seat 3: cZ99hugmLBj9KhTlc8nCSw (button) folded before Flop (didn't bet)
Seat 5: E0iYnEVO2ho7dH3QcCjw7g (small blind) folded before Flop
Seat 6: A/OkFabqdcrG3ozpiYMiNQ (big blind) folded before Flop
Seat 7: cKlmpQMahVsmOaxFQDcoOg folded before Flop (didn't bet)
Seat 8: /vn2Qu2dvc9AMMq46Ae0jA mucked
Seat 9: arxNSjreDRGFg13EAM2F1w folded before Flop (didn't bet)




PokerStars Game #59941890568:  Hold'em No Limit ($0.10/$0.25) - 2009/07/01 1:49:26 ET
Table '8QBBaev+cI2i/r2H6ml/lg' 9-max Seat #2 is the button
Seat 1: s2xLPOl/vhl/26apJ3vsOQ ($36.45 in chips) 
Seat 2: y7tkvDmwKjURBkr73SZPXw ($11.15 in chips) 
Seat 3: zgi+EUykT/pZQpoUG6+oEg ($4.05 in chips) 
Seat 4: ytpGB2nr/CLVHnyKMRiEFQ ($18.20 in chips) 
Seat 5: 0QdZrkFD7aGKeBXPGbIomA ($11.45 in chips) 
Seat 6: X6+pSIPfovPcE87t+LmUKQ ($5 in chips) 
Seat 7: eK8qa6EPcH2zhtbmWSvc9g ($30.05 in chips) 
Seat 8: vr1IK/Q4HXm8s8V0/dePzQ ($11.60 in chips) 
Seat 9: EUMLvzDkECHBit+xa+uGjg ($23.75 in chips) 
zgi+EUykT/pZQpoUG6+oEg: posts small blind $0.10
ytpGB2nr/CLVHnyKMRiEFQ: posts big blind $0.25
*** HOLE CARDS ***
0QdZrkFD7aGKeBXPGbIomA: folds 
X6+pSIPfovPcE87t+LmUKQ: folds 
eK8qa6EPcH2zhtbmWSvc9g: folds 
vr1IK/Q4HXm8s8V0/dePzQ: folds 
EUMLvzDkECHBit+xa+uGjg: folds 
s2xLPOl/vhl/26apJ3vsOQ: raises $0.75 to $1
y7tkvDmwKjURBkr73SZPXw: calls $1
zgi+EUykT/pZQpoUG6+oEg: folds 
ytpGB2nr/CLVHnyKMRiEFQ: calls $0.75
*** FLOP *** [Kc Tc Ah]
ytpGB2nr/CLVHnyKMRiEFQ: checks 
s2xLPOl/vhl/26apJ3vsOQ: checks 
y7tkvDmwKjURBkr73SZPXw: checks 
*** TURN *** [Kc Tc Ah] [5h]
ytpGB2nr/CLVHnyKMRiEFQ: checks 
s2xLPOl/vhl/26apJ3vsOQ: bets $1.25
y7tkvDmwKjURBkr73SZPXw: folds 
ytpGB2nr/CLVHnyKMRiEFQ: folds 
Uncalled bet ($1.25) returned to s2xLPOl/vhl/26apJ3vsOQ
s2xLPOl/vhl/26apJ3vsOQ collected $2.95 from pot
*** SUMMARY ***
Total pot $3.10 | Rake $0.15 
Board [Kc Tc Ah 5h]
Seat 1: s2xLPOl/vhl/26apJ3vsOQ collected ($2.95)
Seat 2: y7tkvDmwKjURBkr73SZPXw (button) folded on the Turn
Seat 3: zgi+EUykT/pZQpoUG6+oEg (small blind) folded before Flop
Seat 4: ytpGB2nr/CLVHnyKMRiEFQ (big blind) folded on the Turn
Seat 5: 0QdZrkFD7aGKeBXPGbIomA folded before Flop (didn't bet)
Seat 6: X6+pSIPfovPcE87t+LmUKQ folded before Flop (didn't bet)
Seat 7: eK8qa6EPcH2zhtbmWSvc9g folded before Flop (didn't bet)
Seat 8: vr1IK/Q4HXm8s8V0/dePzQ folded before Flop (didn't bet)
Seat 9: EUMLvzDkECHBit+xa+uGjg folded before Flop (didn't bet)




PokerStars Game #59941890680:  Hold'em No Limit ($0.10/$0.25) - 2009/07/01 1:49:26 ET
Table '8PD/MTROSMd6Y8mZeykbpg' 6-max Seat #1 is the button
Seat 1: fxNpaToxECtD2Goelmg9vA ($28.50 in chips) 
Seat 2: 4TM16KVgEiQpLi4bVVWbVQ ($24.90 in chips) 
Seat 3: vqWjZmdQu/Hxw96/IJTWdQ ($25 in chips) 
Seat 4: DFi/Lzkjsfv8QswS80JX9Q ($54.80 in chips) 
Seat 5: z3tQwy28dp5FykDJC/wzQw ($26.20 in chips) 
Seat 6: trN/oHqTTbPw5MNuKrOpLw ($25.25 in chips) 
4TM16KVgEiQpLi4bVVWbVQ: posts small blind $0.10
vqWjZmdQu/Hxw96/IJTWdQ: posts big blind $0.25
*** HOLE CARDS ***
DFi/Lzkjsfv8QswS80JX9Q: raises $0.75 to $1
z3tQwy28dp5FykDJC/wzQw: folds 
trN/oHqTTbPw5MNuKrOpLw: folds 
fxNpaToxECtD2Goelmg9vA: folds 
4TM16KVgEiQpLi4bVVWbVQ: raises $1 to $2
vqWjZmdQu/Hxw96/IJTWdQ: folds 
DFi/Lzkjsfv8QswS80JX9Q: calls $1
*** FLOP *** [9s 4s 3h]
4TM16KVgEiQpLi4bVVWbVQ: bets $2.75
DFi/Lzkjsfv8QswS80JX9Q: folds 
Uncalled bet ($2.75) returned to 4TM16KVgEiQpLi4bVVWbVQ
4TM16KVgEiQpLi4bVVWbVQ collected $4.05 from pot
*** SUMMARY ***
Total pot $4.25 | Rake $0.20 
Board [9s 4s 3h]
Seat 1: fxNpaToxECtD2Goelmg9vA (button) folded before Flop (didn't bet)
Seat 2: 4TM16KVgEiQpLi4bVVWbVQ (small blind) collected ($4.05)
Seat 3: vqWjZmdQu/Hxw96/IJTWdQ (big blind) folded before Flop
Seat 4: DFi/Lzkjsfv8QswS80JX9Q folded on the Flop
Seat 5: z3tQwy28dp5FykDJC/wzQw folded before Flop (didn't bet)
Seat 6: trN/oHqTTbPw5MNuKrOpLw folded before Flop (didn't bet)




PokerStars Game #59941890948:  Hold'em No Limit ($0.10/$0.25) - 2009/07/01 1:49:26 ET
Table 'wPWRBZPJl1HAnysw7qRR0A' 6-max Seat #6 is the button
Seat 1: m7ne1MOFTQXlsXT7/R/rug ($12.25 in chips) 
Seat 2: xC0kaiDYM6YTlgODL83O5A ($23 in chips) 
Seat 3: 1ZpoLWO2nm2w1Nd1v9Sr3g ($3.85 in chips) 
Seat 4: epAUIB7h2FJXzUPRIvSkRA ($52.80 in chips) 
Seat 5: y0B+UpYpOUJz3JWtlJQBSA ($15.40 in chips) 
Seat 6: VXTONriS+Ohik+r0FeicIw ($25 in chips) 
m7ne1MOFTQXlsXT7/R/rug: posts small blind $0.10
xC0kaiDYM6YTlgODL83O5A: posts big blind $0.25
*** HOLE CARDS ***
1ZpoLWO2nm2w1Nd1v9Sr3g: calls $0.25
epAUIB7h2FJXzUPRIvSkRA: folds 
y0B+UpYpOUJz3JWtlJQBSA: folds 
VXTONriS+Ohik+r0FeicIw: raises $1 to $1.25
m7ne1MOFTQXlsXT7/R/rug: folds 
xC0kaiDYM6YTlgODL83O5A: folds 
1ZpoLWO2nm2w1Nd1v9Sr3g: folds 
Uncalled bet ($1) returned to VXTONriS+Ohik+r0FeicIw
VXTONriS+Ohik+r0FeicIw collected $0.85 from pot
VXTONriS+Ohik+r0FeicIw: doesn't show hand 
*** SUMMARY ***
Total pot $0.85 | Rake $0 
Seat 1: m7ne1MOFTQXlsXT7/R/rug (small blind) folded before Flop
Seat 2: xC0kaiDYM6YTlgODL83O5A (big blind) folded before Flop
Seat 3: 1ZpoLWO2nm2w1Nd1v9Sr3g folded before Flop
Seat 4: epAUIB7h2FJXzUPRIvSkRA folded before Flop (didn't bet)
Seat 5: y0B+UpYpOUJz3JWtlJQBSA folded before Flop (didn't bet)
Seat 6: VXTONriS+Ohik+r0FeicIw (button) collected ($0.85)




PokerStars Game #59941891438:  Hold'em No Limit ($0.10/$0.25) - 2009/07/01 1:49:27 ET
Table '+2VxGVfkEqJ1AYfQy/JH2w' 6-max Seat #1 is the button
Seat 1: if4dh6jhJXeN3/qd3qCp9g ($27 in chips) 
Seat 2: qllppsCmUqovlriIWCeM/g ($6.05 in chips) 
Seat 3: epAUIB7h2FJXzUPRIvSkRA ($25 in chips) 
Seat 4: y+a/yGW/Jy4bPJFnaeTz5w ($16.60 in chips) 
Seat 5: XD1i5m5PvBDnRzJaG/vINw ($23.90 in chips) 
Seat 6: YQNVDzvw3TmGaFiq9MhRgA ($6.10 in chips) 
qllppsCmUqovlriIWCeM/g: posts small blind $0.10
epAUIB7h2FJXzUPRIvSkRA: posts big blind $0.25
*** HOLE CARDS ***
y+a/yGW/Jy4bPJFnaeTz5w: folds 
XD1i5m5PvBDnRzJaG/vINw: folds 
YQNVDzvw3TmGaFiq9MhRgA: calls $0.25
if4dh6jhJXeN3/qd3qCp9g: folds 
qllppsCmUqovlriIWCeM/g: calls $0.15
epAUIB7h2FJXzUPRIvSkRA: checks 
*** FLOP *** [8c 9c Qh]
qllppsCmUqovlriIWCeM/g: bets $5.80 and is all-in
epAUIB7h2FJXzUPRIvSkRA: folds 
YQNVDzvw3TmGaFiq9MhRgA: folds 
Uncalled bet ($5.80) returned to qllppsCmUqovlriIWCeM/g
qllppsCmUqovlriIWCeM/g collected $0.75 from pot
*** SUMMARY ***
Total pot $0.75 | Rake $0 
Board [8c 9c Qh]
Seat 1: if4dh6jhJXeN3/qd3qCp9g (button) folded before Flop (didn't bet)
Seat 2: qllppsCmUqovlriIWCeM/g (small blind) collected ($0.75)
Seat 3: epAUIB7h2FJXzUPRIvSkRA (big blind) folded on the Flop
Seat 4: y+a/yGW/Jy4bPJFnaeTz5w folded before Flop (didn't bet)
Seat 5: XD1i5m5PvBDnRzJaG/vINw folded before Flop (didn't bet)
Seat 6: YQNVDzvw3TmGaFiq9MhRgA folded on the Flop




PokerStars Game #59941891512:  Hold'em No Limit ($0.10/$0.25) - 2009/07/01 1:49:27 ET
Table 'ZEXL6Wh4qA4Afx8NnoBBAA' 6-max Seat #6 is the button
Seat 1: v8m8XHovI5tqEA9mvplDSw ($27.20 in chips) 
Seat 2: 6DwBRH+xZ12AAZmeAg+aXw ($22 in chips) 
Seat 3: +ZlnqPoP3Hg4BIUxDfKd/A ($31.70 in chips) 
Seat 4: FpN4KbLjlyRRKiVaQcoLqA ($29.25 in chips) 
Seat 5: if4dh6jhJXeN3/qd3qCp9g ($38.80 in chips) 
Seat 6: Lh8SlCq3OSDKWLUgAI/Lxw ($1.75 in chips) 
v8m8XHovI5tqEA9mvplDSw: posts small blind $0.10
6DwBRH+xZ12AAZmeAg+aXw: posts big blind $0.25
*** HOLE CARDS ***
+ZlnqPoP3Hg4BIUxDfKd/A: folds 
FpN4KbLjlyRRKiVaQcoLqA: calls $0.25
if4dh6jhJXeN3/qd3qCp9g: folds 
Lh8SlCq3OSDKWLUgAI/Lxw: folds 
v8m8XHovI5tqEA9mvplDSw: calls $0.15
6DwBRH+xZ12AAZmeAg+aXw: checks 
*** FLOP *** [Ad Qc 9d]
v8m8XHovI5tqEA9mvplDSw: checks 
6DwBRH+xZ12AAZmeAg+aXw: checks 
FpN4KbLjlyRRKiVaQcoLqA: bets $0.50
v8m8XHovI5tqEA9mvplDSw: folds 
6DwBRH+xZ12AAZmeAg+aXw: folds 
Uncalled bet ($0.50) returned to FpN4KbLjlyRRKiVaQcoLqA
FpN4KbLjlyRRKiVaQcoLqA collected $0.75 from pot
FpN4KbLjlyRRKiVaQcoLqA: doesn't show hand 
*** SUMMARY ***
Total pot $0.75 | Rake $0 
Board [Ad Qc 9d]
Seat 1: v8m8XHovI5tqEA9mvplDSw (small blind) folded on the Flop
Seat 2: 6DwBRH+xZ12AAZmeAg+aXw (big blind) folded on the Flop
Seat 3: +ZlnqPoP3Hg4BIUxDfKd/A folded before Flop (didn't bet)
Seat 4: FpN4KbLjlyRRKiVaQcoLqA collected ($0.75)
Seat 5: if4dh6jhJXeN3/qd3qCp9g folded before Flop (didn't bet)
Seat 6: Lh8SlCq3OSDKWLUgAI/Lxw (button) folded before Flop (didn't bet)




PokerStars Game #59941891556:  Hold'em No Limit ($0.10/$0.25) - 2009/07/01 1:49:27 ET
Table '3Ns9nuTkynfwbBfBXzg6ww' 6-max Seat #1 is the button
Seat 1: epAUIB7h2FJXzUPRIvSkRA ($25.70 in chips) 
Seat 2: zxeVQGaMKDsDzmSY+AInjA ($31.50 in chips) 
Seat 3: eL3+wCBjFGfQ5FMdIZihwA ($23.95 in chips) 
Seat 4: qGHGf/553gQnDoklMRe3tg ($30.85 in chips) 
Seat 5: wqphQtauX5Qn7WRJZS1flA ($24.05 in chips) 
Seat 6: DE9hRlt14g+JdsRQ4wT7hg ($38.75 in chips) 
zxeVQGaMKDsDzmSY+AInjA: posts small blind $0.10
eL3+wCBjFGfQ5FMdIZihwA: posts big blind $0.25
*** HOLE CARDS ***
qGHGf/553gQnDoklMRe3tg: folds 
wqphQtauX5Qn7WRJZS1flA: folds 
DE9hRlt14g+JdsRQ4wT7hg: raises $0.75 to $1
epAUIB7h2FJXzUPRIvSkRA: folds 
zxeVQGaMKDsDzmSY+AInjA: folds 
eL3+wCBjFGfQ5FMdIZihwA: folds 
Uncalled bet ($0.75) returned to DE9hRlt14g+JdsRQ4wT7hg
DE9hRlt14g+JdsRQ4wT7hg collected $0.60 from pot
DE9hRlt14g+JdsRQ4wT7hg: doesn't show hand 
*** SUMMARY ***
Total pot $0.60 | Rake $0 
Seat 1: epAUIB7h2FJXzUPRIvSkRA (button) folded before Flop (didn't bet)
Seat 2: zxeVQGaMKDsDzmSY+AInjA (small blind) folded before Flop
Seat 3: eL3+wCBjFGfQ5FMdIZihwA (big blind) folded before Flop
Seat 4: qGHGf/553gQnDoklMRe3tg folded before Flop (didn't bet)
Seat 5: wqphQtauX5Qn7WRJZS1flA folded before Flop (didn't bet)
Seat 6: DE9hRlt14g+JdsRQ4wT7hg collected ($0.60)




PokerStars Game #59941891200:  Hold'em No Limit ($0.10/$0.25) - 2009/07/01 1:49:27 ET
Table '9o8Yb3JpUqurD4pNVmOikQ' 6-max Seat #1 is the button
Seat 1: SFmT9ZsVopnukjvAzrxTRg ($28.05 in chips) 
Seat 2: /gJNBeCkWL4o85/jvlZ4BA ($26.25 in chips) 
Seat 3: JgRqo1/2phbf7pab7N3BIQ ($23.25 in chips) 
Seat 4: j5NZbEJHsERuXjPHWqc1Nw ($10.45 in chips) 
Seat 5: QqiZLFrN8iOUT/GHw7ztOA ($23.80 in chips) 
Seat 6: LyDHtw3/yniNHW+DvLXbog ($25.35 in chips) 
/gJNBeCkWL4o85/jvlZ4BA: posts small blind $0.10
JgRqo1/2phbf7pab7N3BIQ: posts big blind $0.25
*** HOLE CARDS ***
j5NZbEJHsERuXjPHWqc1Nw: folds 
QqiZLFrN8iOUT/GHw7ztOA: folds 
LyDHtw3/yniNHW+DvLXbog: folds 
SFmT9ZsVopnukjvAzrxTRg: folds 
j5NZbEJHsERuXjPHWqc1Nw leaves the table
/gJNBeCkWL4o85/jvlZ4BA: raises $0.75 to $1
JgRqo1/2phbf7pab7N3BIQ: folds 
Uncalled bet ($0.75) returned to /gJNBeCkWL4o85/jvlZ4BA
/gJNBeCkWL4o85/jvlZ4BA collected $0.50 from pot
*** SUMMARY ***
Total pot $0.50 | Rake $0 
Seat 1: SFmT9ZsVopnukjvAzrxTRg (button) folded before Flop (didn't bet)
Seat 2: /gJNBeCkWL4o85/jvlZ4BA (small blind) collected ($0.50)
Seat 3: JgRqo1/2phbf7pab7N3BIQ (big blind) folded before Flop
Seat 4: j5NZbEJHsERuXjPHWqc1Nw folded before Flop (didn't bet)
Seat 5: QqiZLFrN8iOUT/GHw7ztOA folded before Flop (didn't bet)
Seat 6: LyDHtw3/yniNHW+DvLXbog folded before Flop (didn't bet)




PokerStars Game #59941891300:  Hold'em No Limit ($0.10/$0.25) - 2009/07/01 1:49:27 ET
Table 'wRXcD9iXgBbdvKhWmfnBnw' 6-max Seat #2 is the button
Seat 1: Mhj3q7cxev+XjXZxEE6/Cw ($25 in chips) 
Seat 2: vUr8qM1UsCElsCI9B/McdQ ($21.75 in chips) 
Seat 3: SxIIgwXYLkwd6m3wLyPTCw ($25 in chips) 
Seat 4: mnuJq+Q1IXKm/pCy+OzxmQ ($19.60 in chips) 
Seat 5: EE16Ua5b1HSsYej5zeXOlA ($48.95 in chips) 
Seat 6: JFIAqU8lCZ0vWwEl4bdGsg ($34 in chips) 
SxIIgwXYLkwd6m3wLyPTCw: posts small blind $0.10
mnuJq+Q1IXKm/pCy+OzxmQ: posts big blind $0.25
*** HOLE CARDS ***
EE16Ua5b1HSsYej5zeXOlA: folds 
JFIAqU8lCZ0vWwEl4bdGsg: folds 
Mhj3q7cxev+XjXZxEE6/Cw: folds 
vUr8qM1UsCElsCI9B/McdQ: calls $0.25
SxIIgwXYLkwd6m3wLyPTCw: raises $0.75 to $1
mnuJq+Q1IXKm/pCy+OzxmQ: folds 
vUr8qM1UsCElsCI9B/McdQ: calls $0.75
*** FLOP *** [Ac 2d Tc]
SxIIgwXYLkwd6m3wLyPTCw: bets $1.50
vUr8qM1UsCElsCI9B/McdQ: folds 
Uncalled bet ($1.50) returned to SxIIgwXYLkwd6m3wLyPTCw
SxIIgwXYLkwd6m3wLyPTCw collected $2.15 from pot
SxIIgwXYLkwd6m3wLyPTCw: doesn't show hand 
*** SUMMARY ***
Total pot $2.25 | Rake $0.10 
Board [Ac 2d Tc]
Seat 1: Mhj3q7cxev+XjXZxEE6/Cw folded before Flop (didn't bet)
Seat 2: vUr8qM1UsCElsCI9B/McdQ (button) folded on the Flop
Seat 3: SxIIgwXYLkwd6m3wLyPTCw (small blind) collected ($2.15)
Seat 4: mnuJq+Q1IXKm/pCy+OzxmQ (big blind) folded before Flop
Seat 5: EE16Ua5b1HSsYej5zeXOlA folded before Flop (didn't bet)
Seat 6: JFIAqU8lCZ0vWwEl4bdGsg folded before Flop (didn't bet)




PokerStars Game #59941891228:  Hold'em No Limit ($0.10/$0.25) - 2009/07/01 1:49:27 ET
Table 'RUOqTfzbAVGS5x+J9aZMHA' 9-max Seat #7 is the button
Seat 1: DnDcAdn9P0zGovMERigpFA ($26.15 in chips) 
Seat 2: Z5ZtGOON8kmSdSCll9Z3XA ($8 in chips) 
Seat 3: Th3FldXKQW6hWVVPahaoOQ ($25 in chips) 
Seat 4: K9Az8li/CO2TicltVWKamA ($26.75 in chips) 
Seat 5: MtVtHDqIJTyUcXkRBBDIVA ($33.55 in chips) 
Seat 6: ljemhp25Zg+nlA9DLCIiUw ($48 in chips) 
Seat 7: zgi+EUykT/pZQpoUG6+oEg ($5 in chips) 
Seat 8: dfNim92Z6XK1/h5SFW5vDg ($28.45 in chips) 
Seat 9: cZ99hugmLBj9KhTlc8nCSw ($25 in chips) 
dfNim92Z6XK1/h5SFW5vDg: posts small blind $0.10
cZ99hugmLBj9KhTlc8nCSw: posts big blind $0.25
*** HOLE CARDS ***
DnDcAdn9P0zGovMERigpFA: raises $0.50 to $0.75
Z5ZtGOON8kmSdSCll9Z3XA: calls $0.75
Th3FldXKQW6hWVVPahaoOQ: folds 
K9Az8li/CO2TicltVWKamA: folds 
MtVtHDqIJTyUcXkRBBDIVA: folds 
ljemhp25Zg+nlA9DLCIiUw: folds 
zgi+EUykT/pZQpoUG6+oEg: folds 
dfNim92Z6XK1/h5SFW5vDg: folds 
cZ99hugmLBj9KhTlc8nCSw: folds 
*** FLOP *** [3c Jc 6h]
DnDcAdn9P0zGovMERigpFA: bets $1.25
Z5ZtGOON8kmSdSCll9Z3XA: calls $1.25
*** TURN *** [3c Jc 6h] [Qd]
DnDcAdn9P0zGovMERigpFA: bets $3
Z5ZtGOON8kmSdSCll9Z3XA: folds 
Uncalled bet ($3) returned to DnDcAdn9P0zGovMERigpFA
DnDcAdn9P0zGovMERigpFA collected $4.15 from pot
DnDcAdn9P0zGovMERigpFA: doesn't show hand 
*** SUMMARY ***
Total pot $4.35 | Rake $0.20 
Board [3c Jc 6h Qd]
Seat 1: DnDcAdn9P0zGovMERigpFA collected ($4.15)
Seat 2: Z5ZtGOON8kmSdSCll9Z3XA folded on the Turn
Seat 3: Th3FldXKQW6hWVVPahaoOQ folded before Flop (didn't bet)
Seat 4: K9Az8li/CO2TicltVWKamA folded before Flop (didn't bet)
Seat 5: MtVtHDqIJTyUcXkRBBDIVA folded before Flop (didn't bet)
Seat 6: ljemhp25Zg+nlA9DLCIiUw folded before Flop (didn't bet)
Seat 7: zgi+EUykT/pZQpoUG6+oEg (button) folded before Flop (didn't bet)
Seat 8: dfNim92Z6XK1/h5SFW5vDg (small blind) folded before Flop
Seat 9: cZ99hugmLBj9KhTlc8nCSw (big blind) folded before Flop




PokerStars Game #59941891350:  Hold'em No Limit ($0.10/$0.25) - 2009/07/01 1:49:27 ET
Table 'm+FQg/QP0VP1ZA3V62WtOg' 9-max Seat #9 is the button
Seat 1: qwr38jl5txoR36M7G5qi4A ($10 in chips) 
Seat 2: yqkowiRWZ6NvRN9UUkYIlA ($5 in chips) 
Seat 3: +KblIivb6tainScpwm14RQ ($6.50 in chips) 
Seat 5: wf5j8xvJtko6ZXyCbzzlVQ ($9.45 in chips) 
Seat 6: CT7Xj/V/O5rBlhtt+RZeFQ ($38.60 in chips) 
Seat 7: TPAF9YkMsjQFq978RNWZEQ ($26.30 in chips) 
Seat 8: E0iYnEVO2ho7dH3QcCjw7g ($19.65 in chips) 
Seat 9: zUXhymECc2C9W9ZNw6qppA ($13.45 in chips) 
qwr38jl5txoR36M7G5qi4A: posts small blind $0.10
yqkowiRWZ6NvRN9UUkYIlA: posts big blind $0.25
dubÃ©705: sits out 
*** HOLE CARDS ***
+KblIivb6tainScpwm14RQ: calls $0.25
wf5j8xvJtko6ZXyCbzzlVQ: folds 
CT7Xj/V/O5rBlhtt+RZeFQ: folds 
TPAF9YkMsjQFq978RNWZEQ: raises $0.50 to $0.75
E0iYnEVO2ho7dH3QcCjw7g: folds 
zUXhymECc2C9W9ZNw6qppA: folds 
qwr38jl5txoR36M7G5qi4A: calls $0.65
yqkowiRWZ6NvRN9UUkYIlA: folds 
+KblIivb6tainScpwm14RQ: calls $0.50
*** FLOP *** [Qs 2d 6s]
qwr38jl5txoR36M7G5qi4A: checks 
+KblIivb6tainScpwm14RQ: checks 
TPAF9YkMsjQFq978RNWZEQ: bets $1
qwr38jl5txoR36M7G5qi4A: folds 
+KblIivb6tainScpwm14RQ: calls $1
*** TURN *** [Qs 2d 6s] [7d]
+KblIivb6tainScpwm14RQ: checks 
TPAF9YkMsjQFq978RNWZEQ: bets $1
+KblIivb6tainScpwm14RQ: calls $1
*** RIVER *** [Qs 2d 6s 7d] [5d]
zUXhymECc2C9W9ZNw6qppA is disconnected 
+KblIivb6tainScpwm14RQ: bets $1.50
TPAF9YkMsjQFq978RNWZEQ: calls $1.50
*** SHOW DOWN ***
+KblIivb6tainScpwm14RQ: shows [5h 6h] (two pair, Sixes and Fives)
TPAF9YkMsjQFq978RNWZEQ: mucks hand 
+KblIivb6tainScpwm14RQ collected $9.05 from pot
*** SUMMARY ***
Total pot $9.50 | Rake $0.45 
Board [Qs 2d 6s 7d 5d]
Seat 1: qwr38jl5txoR36M7G5qi4A (small blind) folded on the Flop
Seat 2: yqkowiRWZ6NvRN9UUkYIlA (big blind) folded before Flop
Seat 3: +KblIivb6tainScpwm14RQ showed [5h 6h] and won ($9.05) with two pair, Sixes and Fives
Seat 5: wf5j8xvJtko6ZXyCbzzlVQ folded before Flop (didn't bet)
Seat 6: CT7Xj/V/O5rBlhtt+RZeFQ folded before Flop (didn't bet)
Seat 7: TPAF9YkMsjQFq978RNWZEQ mucked
Seat 8: E0iYnEVO2ho7dH3QcCjw7g folded before Flop (didn't bet)
Seat 9: zUXhymECc2C9W9ZNw6qppA (button) folded before Flop (didn't bet)




PokerStars Game #59941891290:  Hold'em No Limit ($0.10/$0.25) - 2009/07/01 1:49:27 ET
Table 'M7d9IrgQUUFFy/SZ3ksLYg' 6-max Seat #1 is the button
Seat 1: ypmjhffk/YHGc51wgVXUTw ($50.25 in chips) 
Seat 2: 8CPg15X6IHYR1pWm9ha1Sw ($25 in chips) 
Seat 3: epAUIB7h2FJXzUPRIvSkRA ($26.25 in chips) 
Seat 4: 8ClCHtFXGNplITm+63KB+Q ($22.85 in chips) 
Seat 5: kMa8BltUcBQVxnHfqdCfXg ($7.50 in chips) 
8CPg15X6IHYR1pWm9ha1Sw: posts small blind $0.10
epAUIB7h2FJXzUPRIvSkRA: posts big blind $0.25
*** HOLE CARDS ***
8ClCHtFXGNplITm+63KB+Q: folds 
kMa8BltUcBQVxnHfqdCfXg: calls $0.25
ypmjhffk/YHGc51wgVXUTw: raises $0.75 to $1
8CPg15X6IHYR1pWm9ha1Sw: folds 
epAUIB7h2FJXzUPRIvSkRA: folds 
kMa8BltUcBQVxnHfqdCfXg: folds 
Uncalled bet ($0.75) returned to ypmjhffk/YHGc51wgVXUTw
ypmjhffk/YHGc51wgVXUTw collected $0.85 from pot
ypmjhffk/YHGc51wgVXUTw: doesn't show hand 
*** SUMMARY ***
Total pot $0.85 | Rake $0 
Seat 1: ypmjhffk/YHGc51wgVXUTw (button) collected ($0.85)
Seat 2: 8CPg15X6IHYR1pWm9ha1Sw (small blind) folded before Flop
Seat 3: epAUIB7h2FJXzUPRIvSkRA (big blind) folded before Flop
Seat 4: 8ClCHtFXGNplITm+63KB+Q folded before Flop (didn't bet)
Seat 5: kMa8BltUcBQVxnHfqdCfXg folded before Flop




PokerStars Game #59941892100:  Hold'em No Limit ($0.10/$0.25) - 2009/07/01 1:49:28 ET
Table 'yAHDCs33TIgw3ra63xuU2Q' 9-max Seat #3 is the button
Seat 1: Z9AeOQX3yzuSvKAm/xyovg ($10 in chips) 
Seat 2: j4q3p0lesp63b1gZDwLBZw ($5 in chips) 
Seat 3: g6UPjSyxNLffCi+EqqIlEg ($17.65 in chips) 
Seat 4: j5spkbnOCRiLGiH6iqBaqw ($11.30 in chips) 
Seat 5: 4awUyiDYTgylQKXZ9faBVA ($38.35 in chips) 
Seat 6: DnDcAdn9P0zGovMERigpFA ($26.30 in chips) 
Seat 8: PCA4x6k6ozLkTt7qDUqp7w ($15 in chips) 
Seat 9: MtVtHDqIJTyUcXkRBBDIVA ($25 in chips) 
j5spkbnOCRiLGiH6iqBaqw: posts small blind $0.10
4awUyiDYTgylQKXZ9faBVA: posts big blind $0.25
PCA4x6k6ozLkTt7qDUqp7w: posts big blind $0.25
Z9AeOQX3yzuSvKAm/xyovg: posts big blind $0.25
*** HOLE CARDS ***
g6UPjSyxNLffCi+EqqIlEg said, "no raise?"
DnDcAdn9P0zGovMERigpFA: folds 
PCA4x6k6ozLkTt7qDUqp7w: checks 
MtVtHDqIJTyUcXkRBBDIVA: folds 
Z9AeOQX3yzuSvKAm/xyovg: checks 
j4q3p0lesp63b1gZDwLBZw: folds 
g6UPjSyxNLffCi+EqqIlEg: calls $0.25
j5spkbnOCRiLGiH6iqBaqw: calls $0.15
4awUyiDYTgylQKXZ9faBVA: checks 
*** FLOP *** [Qd As Qs]
j5spkbnOCRiLGiH6iqBaqw: checks 
4awUyiDYTgylQKXZ9faBVA: checks 
PCA4x6k6ozLkTt7qDUqp7w: bets $0.50
Z9AeOQX3yzuSvKAm/xyovg: folds 
g6UPjSyxNLffCi+EqqIlEg: folds 
j5spkbnOCRiLGiH6iqBaqw: folds 
4awUyiDYTgylQKXZ9faBVA: raises $1.25 to $1.75
PCA4x6k6ozLkTt7qDUqp7w: calls $1.25
*** TURN *** [Qd As Qs] [6d]
4awUyiDYTgylQKXZ9faBVA: checks 
PCA4x6k6ozLkTt7qDUqp7w: bets $4.25
g6UPjSyxNLffCi+EqqIlEg leaves the table
4awUyiDYTgylQKXZ9faBVA: folds 
Uncalled bet ($4.25) returned to PCA4x6k6ozLkTt7qDUqp7w
PCA4x6k6ozLkTt7qDUqp7w collected $4.55 from pot
*** SUMMARY ***
Total pot $4.75 | Rake $0.20 
Board [Qd As Qs 6d]
Seat 1: Z9AeOQX3yzuSvKAm/xyovg folded on the Flop
Seat 2: j4q3p0lesp63b1gZDwLBZw folded before Flop (didn't bet)
Seat 3: g6UPjSyxNLffCi+EqqIlEg (button) folded on the Flop
Seat 4: j5spkbnOCRiLGiH6iqBaqw (small blind) folded on the Flop
Seat 5: 4awUyiDYTgylQKXZ9faBVA (big blind) folded on the Turn
Seat 6: DnDcAdn9P0zGovMERigpFA folded before Flop (didn't bet)
Seat 8: PCA4x6k6ozLkTt7qDUqp7w collected ($4.55)
Seat 9: MtVtHDqIJTyUcXkRBBDIVA folded before Flop (didn't bet)




PokerStars Game #59941891968:  Hold'em No Limit ($0.10/$0.25) - 2009/07/01 1:49:28 ET
Table 'KU/HrxqxwDz8HKEhYTZ6uw' 6-max Seat #2 is the button
Seat 1: 7LKoiQHXpTQXJvWQrw907g ($34.20 in chips) 
Seat 2: kG34n23qFQA3nzdOJTQ1dA ($24.30 in chips) 
Seat 3: SFmT9ZsVopnukjvAzrxTRg ($26.20 in chips) 
Seat 5: iyZxqznXjv3vtvOJymkoLQ ($52.70 in chips) 
Seat 6: qWxkCeqApAWdAA0evrfDvQ ($12.50 in chips) 
SFmT9ZsVopnukjvAzrxTRg: posts small blind $0.10
iyZxqznXjv3vtvOJymkoLQ: posts big blind $0.25
*** HOLE CARDS ***
qWxkCeqApAWdAA0evrfDvQ: calls $0.25
7LKoiQHXpTQXJvWQrw907g: raises $0.50 to $0.75
kG34n23qFQA3nzdOJTQ1dA: folds 
SFmT9ZsVopnukjvAzrxTRg: folds 
iyZxqznXjv3vtvOJymkoLQ: folds 
qWxkCeqApAWdAA0evrfDvQ: calls $0.50
*** FLOP *** [7c Jc 4c]
qWxkCeqApAWdAA0evrfDvQ: checks 
7LKoiQHXpTQXJvWQrw907g: bets $1.25
qWxkCeqApAWdAA0evrfDvQ: calls $1.25
*** TURN *** [7c Jc 4c] [Jh]
qWxkCeqApAWdAA0evrfDvQ: checks 
7LKoiQHXpTQXJvWQrw907g: bets $3
qWxkCeqApAWdAA0evrfDvQ: folds 
Uncalled bet ($3) returned to 7LKoiQHXpTQXJvWQrw907g
7LKoiQHXpTQXJvWQrw907g collected $4.15 from pot
*** SUMMARY ***
Total pot $4.35 | Rake $0.20 
Board [7c Jc 4c Jh]
Seat 1: 7LKoiQHXpTQXJvWQrw907g collected ($4.15)
Seat 2: kG34n23qFQA3nzdOJTQ1dA (button) folded before Flop (didn't bet)
Seat 3: SFmT9ZsVopnukjvAzrxTRg (small blind) folded before Flop
Seat 5: iyZxqznXjv3vtvOJymkoLQ (big blind) folded before Flop
Seat 6: qWxkCeqApAWdAA0evrfDvQ folded on the Turn




PokerStars Game #59941891938:  Hold'em No Limit ($0.10/$0.25) - 2009/07/01 1:49:28 ET
Table '0w9m+UkNlGMNoPyQqzWk6A' 9-max Seat #5 is the button
Seat 3: VWwtMkIjXloiX/RKh7RGWQ ($11.80 in chips) 
Seat 5: HPEB+AtKw1+C/cxU0o1ciw ($46.55 in chips) 
Seat 6: CgIo2ItZqi4o3ayVG6HanQ ($25.15 in chips) 
Seat 7: 57qrNGHDvf6GhB8zVLsAtQ ($4.45 in chips) 
Seat 9: KqS/lY/fNB9qUxokm9QfeA ($13.20 in chips) 
CgIo2ItZqi4o3ayVG6HanQ: posts small blind $0.10
57qrNGHDvf6GhB8zVLsAtQ: posts big blind $0.25
cZ99hugmLBj9KhTlc8nCSw: sits out 
18G4P1XstjNvItdGUITxgw: sits out 
M1nKET7WOTLbVPuAbJa3EA: sits out 
*** HOLE CARDS ***
KqS/lY/fNB9qUxokm9QfeA: raises $0.50 to $0.75
VWwtMkIjXloiX/RKh7RGWQ: calls $0.75
HPEB+AtKw1+C/cxU0o1ciw: folds 
CgIo2ItZqi4o3ayVG6HanQ: calls $0.65
57qrNGHDvf6GhB8zVLsAtQ: folds 
*** FLOP *** [Ks 9s Qd]
CgIo2ItZqi4o3ayVG6HanQ: checks 
KqS/lY/fNB9qUxokm9QfeA: checks 
VWwtMkIjXloiX/RKh7RGWQ: bets $1
CgIo2ItZqi4o3ayVG6HanQ: calls $1
KqS/lY/fNB9qUxokm9QfeA: folds 
*** TURN *** [Ks 9s Qd] [5s]
CgIo2ItZqi4o3ayVG6HanQ: checks 
VWwtMkIjXloiX/RKh7RGWQ: checks 
*** RIVER *** [Ks 9s Qd 5s] [Qs]
CgIo2ItZqi4o3ayVG6HanQ: bets $1.75
z5GxcHlYz/GSz6W2uFiTtg has returned
VWwtMkIjXloiX/RKh7RGWQ: folds 
Uncalled bet ($1.75) returned to CgIo2ItZqi4o3ayVG6HanQ
CgIo2ItZqi4o3ayVG6HanQ collected $4.30 from pot
*** SUMMARY ***
Total pot $4.50 | Rake $0.20 
Board [Ks 9s Qd 5s Qs]
Seat 3: VWwtMkIjXloiX/RKh7RGWQ folded on the River
Seat 5: HPEB+AtKw1+C/cxU0o1ciw (button) folded before Flop (didn't bet)
Seat 6: CgIo2ItZqi4o3ayVG6HanQ (small blind) collected ($4.30)
Seat 7: 57qrNGHDvf6GhB8zVLsAtQ (big blind) folded before Flop
Seat 9: KqS/lY/fNB9qUxokm9QfeA folded on the Flop




PokerStars Game #59941891868:  Hold'em No Limit ($0.10/$0.25) - 2009/07/01 1:49:28 ET
Table 'xPn6TS/y/OWkX7Qa+MUuKA' 6-max Seat #5 is the button
Seat 1: JFIAqU8lCZ0vWwEl4bdGsg ($42.70 in chips) 
Seat 2: buyjetgNT1McXtdaP4zynA ($27.70 in chips) 
Seat 3: q6WfTUAD9mowIP63ASq2Dg ($24.15 in chips) 
Seat 4: SS/yfeArhULzIcOPe8MdPg ($28.65 in chips) 
Seat 5: lquriepNQBhDV5P1SWHhnA ($28.85 in chips) 
Seat 6: DihMHaz4WNETH1bPDe13kA ($25 in chips) 
DihMHaz4WNETH1bPDe13kA: posts small blind $0.10
JFIAqU8lCZ0vWwEl4bdGsg: posts big blind $0.25
*** HOLE CARDS ***
buyjetgNT1McXtdaP4zynA: raises $0.75 to $1
q6WfTUAD9mowIP63ASq2Dg: folds 
SS/yfeArhULzIcOPe8MdPg: folds 
lquriepNQBhDV5P1SWHhnA: folds 
DihMHaz4WNETH1bPDe13kA: folds 
JFIAqU8lCZ0vWwEl4bdGsg: folds 
Uncalled bet ($0.75) returned to buyjetgNT1McXtdaP4zynA
buyjetgNT1McXtdaP4zynA collected $0.60 from pot
*** SUMMARY ***
Total pot $0.60 | Rake $0 
Seat 1: JFIAqU8lCZ0vWwEl4bdGsg (big blind) folded before Flop
Seat 2: buyjetgNT1McXtdaP4zynA collected ($0.60)
Seat 3: q6WfTUAD9mowIP63ASq2Dg folded before Flop (didn't bet)
Seat 4: SS/yfeArhULzIcOPe8MdPg folded before Flop (didn't bet)
Seat 5: lquriepNQBhDV5P1SWHhnA (button) folded before Flop (didn't bet)
Seat 6: DihMHaz4WNETH1bPDe13kA (small blind) folded before Flop




PokerStars Game #59941891892:  Hold'em No Limit ($0.10/$0.25) - 2009/07/01 1:49:28 ET
Table 'IUwZ/e0bDHZPgsIWx0RnNg' 6-max Seat #3 is the button
Seat 1: V66QiVCQPofyl3a+dpPHQQ ($5.95 in chips) 
Seat 2: mvFHK3pE7tCxJEqLjKC70Q ($55.60 in chips) 
Seat 3: dOX4wnYV2sEqvDbF+8KSCw ($25.75 in chips) 
Seat 4: OIjOiBfQstWrK/RuXx7zcw ($5.05 in chips) 
Seat 5: 9bpVv1/Qh9IYtXuCtl5VtQ ($24.65 in chips) 
Seat 6: NhUN/JpAprdJeamFBgJH1w ($38.90 in chips) 
OIjOiBfQstWrK/RuXx7zcw: posts small blind $0.10
9bpVv1/Qh9IYtXuCtl5VtQ: posts big blind $0.25
*** HOLE CARDS ***
NhUN/JpAprdJeamFBgJH1w: folds 
V66QiVCQPofyl3a+dpPHQQ: calls $0.25
mvFHK3pE7tCxJEqLjKC70Q: folds 
dOX4wnYV2sEqvDbF+8KSCw: folds 
OIjOiBfQstWrK/RuXx7zcw: calls $0.15
9bpVv1/Qh9IYtXuCtl5VtQ: raises $1 to $1.25
V66QiVCQPofyl3a+dpPHQQ: calls $1
OIjOiBfQstWrK/RuXx7zcw: folds 
*** FLOP *** [8d 8h 4d]
9bpVv1/Qh9IYtXuCtl5VtQ: checks 
V66QiVCQPofyl3a+dpPHQQ: checks 
*** TURN *** [8d 8h 4d] [9h]
9bpVv1/Qh9IYtXuCtl5VtQ: checks 
V66QiVCQPofyl3a+dpPHQQ: checks 
*** RIVER *** [8d 8h 4d 9h] [5h]
9bpVv1/Qh9IYtXuCtl5VtQ: bets $5
V66QiVCQPofyl3a+dpPHQQ: folds 
Uncalled bet ($5) returned to 9bpVv1/Qh9IYtXuCtl5VtQ
9bpVv1/Qh9IYtXuCtl5VtQ collected $2.65 from pot
9bpVv1/Qh9IYtXuCtl5VtQ: doesn't show hand 
*** SUMMARY ***
Total pot $2.75 | Rake $0.10 
Board [8d 8h 4d 9h 5h]
Seat 1: V66QiVCQPofyl3a+dpPHQQ folded on the River
Seat 2: mvFHK3pE7tCxJEqLjKC70Q folded before Flop (didn't bet)
Seat 3: dOX4wnYV2sEqvDbF+8KSCw (button) folded before Flop (didn't bet)
Seat 4: OIjOiBfQstWrK/RuXx7zcw (small blind) folded before Flop
Seat 5: 9bpVv1/Qh9IYtXuCtl5VtQ (big blind) collected ($2.65)
Seat 6: NhUN/JpAprdJeamFBgJH1w folded before Flop (didn't bet)




PokerStars Game #59941891834:  Hold'em No Limit ($0.10/$0.25) - 2009/07/01 1:49:28 ET
Table 'HzFR0rxmDAPu5GzYR0AlYg' 6-max Seat #2 is the button
Seat 1: v+QfkGiuj9bgtuNoVnDO8w ($34.55 in chips) 
Seat 2: UA5OsKS3VPaxa7uC8La/kA ($51.25 in chips) 
Seat 3: kG34n23qFQA3nzdOJTQ1dA ($24.65 in chips) 
Seat 4: Mhj3q7cxev+XjXZxEE6/Cw ($25.35 in chips) 
Seat 5: lquriepNQBhDV5P1SWHhnA ($27.10 in chips) 
Seat 6: jp34e617tIzV8tKIWmfAbA ($35.55 in chips) 
kG34n23qFQA3nzdOJTQ1dA: posts small blind $0.10
Mhj3q7cxev+XjXZxEE6/Cw: posts big blind $0.25
*** HOLE CARDS ***
lquriepNQBhDV5P1SWHhnA: folds 
jp34e617tIzV8tKIWmfAbA: folds 
v+QfkGiuj9bgtuNoVnDO8w: folds 
UA5OsKS3VPaxa7uC8La/kA: raises $0.50 to $0.75
kG34n23qFQA3nzdOJTQ1dA: folds 
Mhj3q7cxev+XjXZxEE6/Cw: folds 
Uncalled bet ($0.50) returned to UA5OsKS3VPaxa7uC8La/kA
UA5OsKS3VPaxa7uC8La/kA collected $0.60 from pot
*** SUMMARY ***
Total pot $0.60 | Rake $0 
Seat 1: v+QfkGiuj9bgtuNoVnDO8w folded before Flop (didn't bet)
Seat 2: UA5OsKS3VPaxa7uC8La/kA (button) collected ($0.60)
Seat 3: kG34n23qFQA3nzdOJTQ1dA (small blind) folded before Flop
Seat 4: Mhj3q7cxev+XjXZxEE6/Cw (big blind) folded before Flop
Seat 5: lquriepNQBhDV5P1SWHhnA folded before Flop (didn't bet)
Seat 6: jp34e617tIzV8tKIWmfAbA folded before Flop (didn't bet)




PokerStars Game #59941891666:  Hold'em No Limit ($0.10/$0.25) - 2009/07/01 1:49:28 ET
Table 'CBnRhp0d6E2+/NtM7Vbruw' 9-max Seat #2 is the button
Seat 1: 18G4P1XstjNvItdGUITxgw ($25 in chips) 
Seat 2: cZ99hugmLBj9KhTlc8nCSw ($26.50 in chips) 
Seat 5: CT7Xj/V/O5rBlhtt+RZeFQ ($25.10 in chips) 
Seat 6: CvL9Ch1HYCVbTsfpNucitg ($4.30 in chips) 
Seat 7: j4q3p0lesp63b1gZDwLBZw ($5 in chips) 
Seat 8: MG90wfSJZnOejs/KD3vlQQ ($25.35 in chips) 
Seat 9: xHZZRLAaFUIC8WWI8ljOJA ($29.55 in chips) 
CT7Xj/V/O5rBlhtt+RZeFQ: posts small blind $0.10
CvL9Ch1HYCVbTsfpNucitg: posts big blind $0.25
*** HOLE CARDS ***
j4q3p0lesp63b1gZDwLBZw: folds 
MG90wfSJZnOejs/KD3vlQQ: folds 
xHZZRLAaFUIC8WWI8ljOJA: folds 
18G4P1XstjNvItdGUITxgw: folds 
cZ99hugmLBj9KhTlc8nCSw: folds 
CT7Xj/V/O5rBlhtt+RZeFQ: calls $0.15
CvL9Ch1HYCVbTsfpNucitg: checks 
*** FLOP *** [7s Jd 5s]
CT7Xj/V/O5rBlhtt+RZeFQ: checks 
CvL9Ch1HYCVbTsfpNucitg: checks 
*** TURN *** [7s Jd 5s] [6d]
CT7Xj/V/O5rBlhtt+RZeFQ: bets $1
CvL9Ch1HYCVbTsfpNucitg: folds 
Uncalled bet ($1) returned to CT7Xj/V/O5rBlhtt+RZeFQ
CT7Xj/V/O5rBlhtt+RZeFQ collected $0.50 from pot
CT7Xj/V/O5rBlhtt+RZeFQ: doesn't show hand 
Y3DZ6qQlLeBhixDj4M9vmg joins the table at seat #3 
*** SUMMARY ***
Total pot $0.50 | Rake $0 
Board [7s Jd 5s 6d]
Seat 1: 18G4P1XstjNvItdGUITxgw folded before Flop (didn't bet)
Seat 2: cZ99hugmLBj9KhTlc8nCSw (button) folded before Flop (didn't bet)
Seat 5: CT7Xj/V/O5rBlhtt+RZeFQ (small blind) collected ($0.50)
Seat 6: CvL9Ch1HYCVbTsfpNucitg (big blind) folded on the Turn
Seat 7: j4q3p0lesp63b1gZDwLBZw folded before Flop (didn't bet)
Seat 8: MG90wfSJZnOejs/KD3vlQQ folded before Flop (didn't bet)
Seat 9: xHZZRLAaFUIC8WWI8ljOJA folded before Flop (didn't bet)




PokerStars Game #59941892196:  Hold'em No Limit ($0.10/$0.25) - 2009/07/01 1:49:29 ET
Table '1HT8bEDpLPhOXxmqMtzF8w' 9-max Seat #6 is the button
Seat 1: YkkKQUDI0iWatY4h0WWaAQ ($12.65 in chips) 
Seat 2: r6hsffOo1iKmaPYKwAZmFw ($29 in chips) 
Seat 3: oLa/tXLfSLLB28mcLGrxcg ($23.50 in chips) 
Seat 6: bXpVeaSTPBFSPJmeXxO7nw ($5.90 in chips) 
Seat 7: PMhmqYBPHOAXjH25lRz69g ($16.65 in chips) 
Seat 8: ghNKXUBl/H+t83JF079ZBA ($33.15 in chips) 
Seat 9: Z9W7+g1WMhhZDi7DwGbCFA ($5 in chips) 
PMhmqYBPHOAXjH25lRz69g: posts small blind $0.10
ghNKXUBl/H+t83JF079ZBA: posts big blind $0.25
*** HOLE CARDS ***
Z9W7+g1WMhhZDi7DwGbCFA: folds 
YkkKQUDI0iWatY4h0WWaAQ: folds 
r6hsffOo1iKmaPYKwAZmFw: folds 
oLa/tXLfSLLB28mcLGrxcg: folds 
bXpVeaSTPBFSPJmeXxO7nw: folds 
PMhmqYBPHOAXjH25lRz69g: calls $0.15
ghNKXUBl/H+t83JF079ZBA: checks 
*** FLOP *** [2d Kd Js]
PMhmqYBPHOAXjH25lRz69g: checks 
ghNKXUBl/H+t83JF079ZBA: checks 
*** TURN *** [2d Kd Js] [Jh]
PMhmqYBPHOAXjH25lRz69g: checks 
ghNKXUBl/H+t83JF079ZBA: bets $0.25
PMhmqYBPHOAXjH25lRz69g: folds 
Uncalled bet ($0.25) returned to ghNKXUBl/H+t83JF079ZBA
ghNKXUBl/H+t83JF079ZBA collected $0.50 from pot
ghNKXUBl/H+t83JF079ZBA: doesn't show hand 
*** SUMMARY ***
Total pot $0.50 | Rake $0 
Board [2d Kd Js Jh]
Seat 1: YkkKQUDI0iWatY4h0WWaAQ folded before Flop (didn't bet)
Seat 2: r6hsffOo1iKmaPYKwAZmFw folded before Flop (didn't bet)
Seat 3: oLa/tXLfSLLB28mcLGrxcg folded before Flop (didn't bet)
Seat 6: bXpVeaSTPBFSPJmeXxO7nw (button) folded before Flop (didn't bet)
Seat 7: PMhmqYBPHOAXjH25lRz69g (small blind) folded on the Turn
Seat 8: ghNKXUBl/H+t83JF079ZBA (big blind) collected ($0.50)
Seat 9: Z9W7+g1WMhhZDi7DwGbCFA folded before Flop (didn't bet)




PokerStars Game #59941892416:  Hold'em No Limit ($0.10/$0.25) - 2009/07/01 1:49:29 ET
Table '63h13e5p7cWe02rClZ1CHw' 6-max Seat #5 is the button
Seat 1: pokjbbEcXXPlADXdSGHtZw ($21.70 in chips) 
Seat 2: k9nHZTHt8hYhYRcW8NTb4g ($24.95 in chips) 
Seat 3: mFv3iBCtrw9XfCDRB0d46Q ($4.30 in chips) 
Seat 4: xrf8tAXKQHG99HixCot1Iw ($28 in chips) 
Seat 5: iyZxqznXjv3vtvOJymkoLQ ($44.10 in chips) 
Seat 6: mfrkWA3PTeYPkbO6hi98Aw ($38.80 in chips) 
mfrkWA3PTeYPkbO6hi98Aw: posts small blind $0.10
pokjbbEcXXPlADXdSGHtZw: posts big blind $0.25
*** HOLE CARDS ***
k9nHZTHt8hYhYRcW8NTb4g: folds 
mFv3iBCtrw9XfCDRB0d46Q: folds 
xrf8tAXKQHG99HixCot1Iw: folds 
iyZxqznXjv3vtvOJymkoLQ: raises $0.75 to $1
mfrkWA3PTeYPkbO6hi98Aw: folds 
pokjbbEcXXPlADXdSGHtZw: folds 
Uncalled bet ($0.75) returned to iyZxqznXjv3vtvOJymkoLQ
iyZxqznXjv3vtvOJymkoLQ collected $0.60 from pot
iyZxqznXjv3vtvOJymkoLQ: doesn't show hand 
*** SUMMARY ***
Total pot $0.60 | Rake $0 
Seat 1: pokjbbEcXXPlADXdSGHtZw (big blind) folded before Flop
Seat 2: k9nHZTHt8hYhYRcW8NTb4g folded before Flop (didn't bet)
Seat 3: mFv3iBCtrw9XfCDRB0d46Q folded before Flop (didn't bet)
Seat 4: xrf8tAXKQHG99HixCot1Iw folded before Flop (didn't bet)
Seat 5: iyZxqznXjv3vtvOJymkoLQ (button) collected ($0.60)
Seat 6: mfrkWA3PTeYPkbO6hi98Aw (small blind) folded before Flop




PokerStars Game #59941892258:  Hold'em No Limit ($0.10/$0.25) - 2009/07/01 1:49:29 ET
Table '2O5CgfSkSwrr4PDrlZ1RLQ' 6-max Seat #1 is the button
Seat 1: 3skmHD9EOATKdUzzyHh1KA ($31.60 in chips) 
Seat 2: wqphQtauX5Qn7WRJZS1flA ($28.85 in chips) 
Seat 3: oBUDUfeUyCbZBsjxHZgSiw ($19.25 in chips) 
Seat 4: epAUIB7h2FJXzUPRIvSkRA ($25 in chips) 
Seat 5: 0av6tRNdi0Ui4f15L7gsVg ($23.90 in chips) 
Seat 6: tj9xqoqQaDaFw7u1oyZrtA ($53.90 in chips) 
wqphQtauX5Qn7WRJZS1flA: posts small blind $0.10
oBUDUfeUyCbZBsjxHZgSiw: posts big blind $0.25
*** HOLE CARDS ***
epAUIB7h2FJXzUPRIvSkRA: folds 
0av6tRNdi0Ui4f15L7gsVg: folds 
tj9xqoqQaDaFw7u1oyZrtA: calls $0.25
3skmHD9EOATKdUzzyHh1KA: folds 
wqphQtauX5Qn7WRJZS1flA: folds 
oBUDUfeUyCbZBsjxHZgSiw: raises $0.75 to $1
tj9xqoqQaDaFw7u1oyZrtA: calls $0.75
*** FLOP *** [2h Kd Kh]
oBUDUfeUyCbZBsjxHZgSiw: checks 
tj9xqoqQaDaFw7u1oyZrtA: checks 
*** TURN *** [2h Kd Kh] [2c]
oBUDUfeUyCbZBsjxHZgSiw: checks 
tj9xqoqQaDaFw7u1oyZrtA: checks 
*** RIVER *** [2h Kd Kh 2c] [9s]
oBUDUfeUyCbZBsjxHZgSiw: checks 
tj9xqoqQaDaFw7u1oyZrtA: checks 
*** SHOW DOWN ***
oBUDUfeUyCbZBsjxHZgSiw: shows [Jc Ah] (two pair, Kings and Deuces)
tj9xqoqQaDaFw7u1oyZrtA: mucks hand 
oBUDUfeUyCbZBsjxHZgSiw collected $2 from pot
*** SUMMARY ***
Total pot $2.10 | Rake $0.10 
Board [2h Kd Kh 2c 9s]
Seat 1: 3skmHD9EOATKdUzzyHh1KA (button) folded before Flop (didn't bet)
Seat 2: wqphQtauX5Qn7WRJZS1flA (small blind) folded before Flop
Seat 3: oBUDUfeUyCbZBsjxHZgSiw (big blind) showed [Jc Ah] and won ($2) with two pair, Kings and Deuces
Seat 4: epAUIB7h2FJXzUPRIvSkRA folded before Flop (didn't bet)
Seat 5: 0av6tRNdi0Ui4f15L7gsVg folded before Flop (didn't bet)
Seat 6: tj9xqoqQaDaFw7u1oyZrtA mucked




PokerStars Game #59941892452:  Hold'em No Limit ($0.10/$0.25) - 2009/07/01 1:49:29 ET
Table 'nlpa8xI95gAflovnFxB2yg' 6-max Seat #2 is the button
Seat 1: fZQg9veL7Dd/Z04ZTjC+wQ ($61.45 in chips) 
Seat 2: Yuyy/pDz3yAO3EbHYRYnKw ($23.80 in chips) 
Seat 3: DihMHaz4WNETH1bPDe13kA ($25 in chips) 
Seat 4: if4dh6jhJXeN3/qd3qCp9g ($52.35 in chips) 
Seat 5: FDWzjQgBA5K04jOIY/j22w ($7.45 in chips) 
Seat 6: ATNFxN8fYVfSZMQW8dvbvw ($5.25 in chips) 
DihMHaz4WNETH1bPDe13kA: posts small blind $0.10
if4dh6jhJXeN3/qd3qCp9g: posts big blind $0.25
*** HOLE CARDS ***
FDWzjQgBA5K04jOIY/j22w: calls $0.25
ATNFxN8fYVfSZMQW8dvbvw: folds 
fZQg9veL7Dd/Z04ZTjC+wQ: folds 
Yuyy/pDz3yAO3EbHYRYnKw: folds 
DihMHaz4WNETH1bPDe13kA: calls $0.15
if4dh6jhJXeN3/qd3qCp9g: checks 
*** FLOP *** [2s Qd 7d]
DihMHaz4WNETH1bPDe13kA: bets $0.50
if4dh6jhJXeN3/qd3qCp9g: folds 
FDWzjQgBA5K04jOIY/j22w: folds 
Uncalled bet ($0.50) returned to DihMHaz4WNETH1bPDe13kA
FDWzjQgBA5K04jOIY/j22w leaves the table
DihMHaz4WNETH1bPDe13kA collected $0.75 from pot
*** SUMMARY ***
Total pot $0.75 | Rake $0 
Board [2s Qd 7d]
Seat 1: fZQg9veL7Dd/Z04ZTjC+wQ folded before Flop (didn't bet)
Seat 2: Yuyy/pDz3yAO3EbHYRYnKw (button) folded before Flop (didn't bet)
Seat 3: DihMHaz4WNETH1bPDe13kA (small blind) collected ($0.75)
Seat 4: if4dh6jhJXeN3/qd3qCp9g (big blind) folded on the Flop
Seat 5: FDWzjQgBA5K04jOIY/j22w folded on the Flop
Seat 6: ATNFxN8fYVfSZMQW8dvbvw folded before Flop (didn't bet)




PokerStars Game #59941892206:  Hold'em No Limit ($0.10/$0.25) - 2009/07/01 1:49:29 ET
Table 'o0CDOvKO/bn1WjeymDrXfA' 6-max Seat #3 is the button
Seat 1: if4dh6jhJXeN3/qd3qCp9g ($27.05 in chips) 
Seat 2: uAJL+E2git8iAiFyAvVOnw ($8.20 in chips) 
Seat 3: OtVWmpxX2/9L8bb1GSKTuA ($21.55 in chips) 
Seat 4: i9LqF5rD3bvtbEE7HWgr3Q ($25 in chips) 
Seat 5: dOIoLBxmpLHSXBN9LZnf0Q ($32.50 in chips) 
Seat 6: SS/yfeArhULzIcOPe8MdPg ($25 in chips) 
i9LqF5rD3bvtbEE7HWgr3Q: posts small blind $0.10
dOIoLBxmpLHSXBN9LZnf0Q: posts big blind $0.25
*** HOLE CARDS ***
SS/yfeArhULzIcOPe8MdPg: folds 
if4dh6jhJXeN3/qd3qCp9g: folds 
uAJL+E2git8iAiFyAvVOnw: folds 
OtVWmpxX2/9L8bb1GSKTuA: folds 
i9LqF5rD3bvtbEE7HWgr3Q: folds 
Uncalled bet ($0.15) returned to dOIoLBxmpLHSXBN9LZnf0Q
dOIoLBxmpLHSXBN9LZnf0Q collected $0.20 from pot
dOIoLBxmpLHSXBN9LZnf0Q: doesn't show hand 
*** SUMMARY ***
Total pot $0.20 | Rake $0 
Seat 1: if4dh6jhJXeN3/qd3qCp9g folded before Flop (didn't bet)
Seat 2: uAJL+E2git8iAiFyAvVOnw folded before Flop (didn't bet)
Seat 3: OtVWmpxX2/9L8bb1GSKTuA (button) folded before Flop (didn't bet)
Seat 4: i9LqF5rD3bvtbEE7HWgr3Q (small blind) folded before Flop
Seat 5: dOIoLBxmpLHSXBN9LZnf0Q (big blind) collected ($0.20)
Seat 6: SS/yfeArhULzIcOPe8MdPg folded before Flop (didn't bet)




PokerStars Game #59941892532:  Hold'em No Limit ($0.10/$0.25) - 2009/07/01 1:49:29 ET
Table 'GgmUtmhrYPRnhkqEEjD/Kw' 9-max Seat #8 is the button
Seat 1: bXpVeaSTPBFSPJmeXxO7nw ($5 in chips) 
Seat 2: ghNKXUBl/H+t83JF079ZBA ($25 in chips) 
Seat 3: dYvYZ723QlKIPiDa0pkedQ ($7.25 in chips) 
Seat 4: dfNim92Z6XK1/h5SFW5vDg ($25 in chips) 
Seat 5: ljemhp25Zg+nlA9DLCIiUw ($26.85 in chips) 
Seat 6: 4Ax0vobe1rLVIGZmkFINGA ($18.95 in chips) 
Seat 7: YwDw9cMqkbMznFK77rru4A ($4.55 in chips) 
Seat 8: DdPXdieucQ+n99u1n3A+rQ ($4.30 in chips) 
Seat 9: V6p0jQ/RhUsqpHLmXvEX4Q ($15.30 in chips) 
V6p0jQ/RhUsqpHLmXvEX4Q: posts small blind $0.10
bXpVeaSTPBFSPJmeXxO7nw: posts big blind $0.25
*** HOLE CARDS ***
ghNKXUBl/H+t83JF079ZBA: folds 
dYvYZ723QlKIPiDa0pkedQ: calls $0.25
dfNim92Z6XK1/h5SFW5vDg: folds 
ljemhp25Zg+nlA9DLCIiUw: folds 
4Ax0vobe1rLVIGZmkFINGA: folds 
YwDw9cMqkbMznFK77rru4A: folds 
DdPXdieucQ+n99u1n3A+rQ: folds 
V6p0jQ/RhUsqpHLmXvEX4Q: folds 
bXpVeaSTPBFSPJmeXxO7nw: checks 
*** FLOP *** [4d Qc 3d]
bXpVeaSTPBFSPJmeXxO7nw: checks 
dYvYZ723QlKIPiDa0pkedQ: checks 
*** TURN *** [4d Qc 3d] [Kd]
bXpVeaSTPBFSPJmeXxO7nw: checks 
dYvYZ723QlKIPiDa0pkedQ: checks 
*** RIVER *** [4d Qc 3d Kd] [7d]
bXpVeaSTPBFSPJmeXxO7nw: checks 
dYvYZ723QlKIPiDa0pkedQ: checks 
*** SHOW DOWN ***
bXpVeaSTPBFSPJmeXxO7nw: shows [As 3c] (a pair of Threes)
dYvYZ723QlKIPiDa0pkedQ: shows [5s 7s] (a pair of Sevens)
dYvYZ723QlKIPiDa0pkedQ collected $0.60 from pot
*** SUMMARY ***
Total pot $0.60 | Rake $0 
Board [4d Qc 3d Kd 7d]
Seat 1: bXpVeaSTPBFSPJmeXxO7nw (big blind) showed [As 3c] and lost with a pair of Threes
Seat 2: ghNKXUBl/H+t83JF079ZBA folded before Flop (didn't bet)
Seat 3: dYvYZ723QlKIPiDa0pkedQ showed [5s 7s] and won ($0.60) with a pair of Sevens
Seat 4: dfNim92Z6XK1/h5SFW5vDg folded before Flop (didn't bet)
Seat 5: ljemhp25Zg+nlA9DLCIiUw folded before Flop (didn't bet)
Seat 6: 4Ax0vobe1rLVIGZmkFINGA folded before Flop (didn't bet)
Seat 7: YwDw9cMqkbMznFK77rru4A folded before Flop (didn't bet)
Seat 8: DdPXdieucQ+n99u1n3A+rQ (button) folded before Flop (didn't bet)
Seat 9: V6p0jQ/RhUsqpHLmXvEX4Q (small blind) folded before Flop




PokerStars Game #59941892740:  Hold'em No Limit ($0.10/$0.25) - 2009/07/01 1:49:30 ET
Table '9SExUHslNkrPJ4XsrePaVw' 9-max Seat #9 is the button
Seat 1: RHqgdFvufLCYe54+qd2gcA ($4.25 in chips) 
Seat 2: cZ99hugmLBj9KhTlc8nCSw ($44.10 in chips) 
Seat 3: EP17SQz/iWcuYdNOGeBgkw ($13.80 in chips) 
Seat 4: 4awUyiDYTgylQKXZ9faBVA ($25 in chips) 
Seat 5: L+eJnUyhY8bMNYw755K8XQ ($15.40 in chips) 
Seat 6: YPJ90cgNXDABdYJcqmwB0A ($20.60 in chips) 
Seat 7: sx0lGrkT9fd4yFR+3cXUQg ($11.75 in chips) 
Seat 8: tLcDklc2rBORNfixyRfVfw ($26.35 in chips) 
Seat 9: /THNzAxdv2lBxcf4XTj/0g ($12.45 in chips) 
RHqgdFvufLCYe54+qd2gcA: posts small blind $0.10
cZ99hugmLBj9KhTlc8nCSw: posts big blind $0.25
*** HOLE CARDS ***
EP17SQz/iWcuYdNOGeBgkw: folds 
4awUyiDYTgylQKXZ9faBVA: folds 
L+eJnUyhY8bMNYw755K8XQ: folds 
YPJ90cgNXDABdYJcqmwB0A: folds 
sx0lGrkT9fd4yFR+3cXUQg: folds 
tLcDklc2rBORNfixyRfVfw: folds 
/THNzAxdv2lBxcf4XTj/0g: calls $0.25
RHqgdFvufLCYe54+qd2gcA: folds 
cZ99hugmLBj9KhTlc8nCSw: checks 
*** FLOP *** [Qc Kd 4d]
cZ99hugmLBj9KhTlc8nCSw: checks 
/THNzAxdv2lBxcf4XTj/0g: checks 
*** TURN *** [Qc Kd 4d] [9c]
cZ99hugmLBj9KhTlc8nCSw: checks 
/THNzAxdv2lBxcf4XTj/0g: checks 
*** RIVER *** [Qc Kd 4d 9c] [9s]
cZ99hugmLBj9KhTlc8nCSw: checks 
/THNzAxdv2lBxcf4XTj/0g: checks 
*** SHOW DOWN ***
cZ99hugmLBj9KhTlc8nCSw: shows [2h 5h] (a pair of Nines)
/THNzAxdv2lBxcf4XTj/0g: shows [Jc As] (a pair of Nines - Ace kicker)
/THNzAxdv2lBxcf4XTj/0g collected $0.60 from pot
*** SUMMARY ***
Total pot $0.60 | Rake $0 
Board [Qc Kd 4d 9c 9s]
Seat 1: RHqgdFvufLCYe54+qd2gcA (small blind) folded before Flop
Seat 2: cZ99hugmLBj9KhTlc8nCSw (big blind) showed [2h 5h] and lost with a pair of Nines
Seat 3: EP17SQz/iWcuYdNOGeBgkw folded before Flop (didn't bet)
Seat 4: 4awUyiDYTgylQKXZ9faBVA folded before Flop (didn't bet)
Seat 5: L+eJnUyhY8bMNYw755K8XQ folded before Flop (didn't bet)
Seat 6: YPJ90cgNXDABdYJcqmwB0A folded before Flop (didn't bet)
Seat 7: sx0lGrkT9fd4yFR+3cXUQg folded before Flop (didn't bet)
Seat 8: tLcDklc2rBORNfixyRfVfw folded before Flop (didn't bet)
Seat 9: /THNzAxdv2lBxcf4XTj/0g (button) showed [Jc As] and won ($0.60) with a pair of Nines




PokerStars Game #59941892744:  Hold'em No Limit ($0.10/$0.25) - 2009/07/01 1:49:30 ET
Table 'Jj2eLzVCUVAGBmM+Og79iQ' 9-max Seat #8 is the button
Seat 1: ShXPHWfjhfmAwLgDdm6bRQ ($7.25 in chips) 
Seat 3: HPEB+AtKw1+C/cxU0o1ciw ($24.40 in chips) 
Seat 4: aNpwfA31EREwO+ar4XzBCw ($44.60 in chips) 
Seat 5: UkF1eqqUN0CCiimXAuN7og ($4.65 in chips) 
Seat 6: jZURAM/dgGCX+5lATlZugw ($17.35 in chips) 
Seat 7: K0b5wNInj6hUGRr6yzKFtw ($59.50 in chips) 
Seat 8: H5Se03ZqSX7tbULXur2MAg ($33.80 in chips) 
Seat 9: vSkQm2EelzwRGDDQQk0Fqw ($4.75 in chips) 
vSkQm2EelzwRGDDQQk0Fqw: posts small blind $0.10
ShXPHWfjhfmAwLgDdm6bRQ: posts big blind $0.25
*** HOLE CARDS ***
HPEB+AtKw1+C/cxU0o1ciw: folds 
aNpwfA31EREwO+ar4XzBCw: folds 
UkF1eqqUN0CCiimXAuN7og: folds 
jZURAM/dgGCX+5lATlZugw: folds 
3BXzvZqgd3pARIFGfMXHww joins the table at seat #2 
K0b5wNInj6hUGRr6yzKFtw: raises $0.75 to $1
H5Se03ZqSX7tbULXur2MAg: folds 
vSkQm2EelzwRGDDQQk0Fqw: folds 
ShXPHWfjhfmAwLgDdm6bRQ: folds 
Uncalled bet ($0.75) returned to K0b5wNInj6hUGRr6yzKFtw
K0b5wNInj6hUGRr6yzKFtw collected $0.60 from pot
K0b5wNInj6hUGRr6yzKFtw: doesn't show hand 
*** SUMMARY ***
Total pot $0.60 | Rake $0 
Seat 1: ShXPHWfjhfmAwLgDdm6bRQ (big blind) folded before Flop
Seat 3: HPEB+AtKw1+C/cxU0o1ciw folded before Flop (didn't bet)
Seat 4: aNpwfA31EREwO+ar4XzBCw folded before Flop (didn't bet)
Seat 5: UkF1eqqUN0CCiimXAuN7og folded before Flop (didn't bet)
Seat 6: jZURAM/dgGCX+5lATlZugw folded before Flop (didn't bet)
Seat 7: K0b5wNInj6hUGRr6yzKFtw collected ($0.60)
Seat 8: H5Se03ZqSX7tbULXur2MAg (button) folded before Flop (didn't bet)
Seat 9: vSkQm2EelzwRGDDQQk0Fqw (small blind) folded before Flop




PokerStars Game #59941893188:  Hold'em No Limit ($0.10/$0.25) - 2009/07/01 1:49:30 ET
Table '6wawJ+MkkvuC3coG6r+Yhg' 6-max Seat #6 is the button
Seat 1: JQZew0FjzS19kTjeNtrE+A ($17.85 in chips) 
Seat 2: LtASJ9OlkqGrrUKGQlpGAw ($34.15 in chips) 
Seat 3: 3zD3qLXT1bEffAoWGnc7wg ($60 in chips) 
Seat 5: FZrgDbxAanC1xwZxXHJKVA ($7.30 in chips) 
Seat 6: B3X187C0tXFUfQpCu8pe8A ($24.80 in chips) 
JQZew0FjzS19kTjeNtrE+A: posts small blind $0.10
LtASJ9OlkqGrrUKGQlpGAw: posts big blind $0.25
9U3ZKjCsarN0DjR6mSE8Ug: sits out 
*** HOLE CARDS ***
3zD3qLXT1bEffAoWGnc7wg: calls $0.25
FZrgDbxAanC1xwZxXHJKVA: folds 
B3X187C0tXFUfQpCu8pe8A: folds 
FZrgDbxAanC1xwZxXHJKVA leaves the table
JQZew0FjzS19kTjeNtrE+A: calls $0.15
LtASJ9OlkqGrrUKGQlpGAw: checks 
*** FLOP *** [Kc 5c Jd]
JQZew0FjzS19kTjeNtrE+A: bets $0.75
GbCVUNssQ7mqsPWr7J4d3w joins the table at seat #5 
LtASJ9OlkqGrrUKGQlpGAw: raises $1.25 to $2
3zD3qLXT1bEffAoWGnc7wg: folds 
JQZew0FjzS19kTjeNtrE+A: calls $1.25
*** TURN *** [Kc 5c Jd] [8h]
JQZew0FjzS19kTjeNtrE+A: checks 
LtASJ9OlkqGrrUKGQlpGAw: bets $3.25
JQZew0FjzS19kTjeNtrE+A: folds 
Uncalled bet ($3.25) returned to LtASJ9OlkqGrrUKGQlpGAw
LtASJ9OlkqGrrUKGQlpGAw collected $4.55 from pot
LtASJ9OlkqGrrUKGQlpGAw: doesn't show hand 
*** SUMMARY ***
Total pot $4.75 | Rake $0.20 
Board [Kc 5c Jd 8h]
Seat 1: JQZew0FjzS19kTjeNtrE+A (small blind) folded on the Turn
Seat 2: LtASJ9OlkqGrrUKGQlpGAw (big blind) collected ($4.55)
Seat 3: 3zD3qLXT1bEffAoWGnc7wg folded on the Flop
Seat 5: FZrgDbxAanC1xwZxXHJKVA folded before Flop (didn't bet)
Seat 6: B3X187C0tXFUfQpCu8pe8A (button) folded before Flop (didn't bet)




PokerStars Game #59941893010:  Hold'em No Limit ($0.10/$0.25) - 2009/07/01 1:49:30 ET
Table 'SHi8+hK6i7E2dJ/3Agbyig' 6-max Seat #6 is the button
Seat 1: gPEN9Zp33YTm/mu9/SYP1w ($28.15 in chips) 
Seat 2: LJI7A1YgDM7hgh7o56+ReQ ($25 in chips) 
Seat 4: u0ikXOhAPSCLmg+l17oGRw ($22.40 in chips) 
Seat 5: v8m8XHovI5tqEA9mvplDSw ($48.95 in chips) 
Seat 6: cWc85bEzdRzpUMhRKm8pwQ ($31.95 in chips) 
gPEN9Zp33YTm/mu9/SYP1w: posts small blind $0.10
LJI7A1YgDM7hgh7o56+ReQ: posts big blind $0.25
VXTONriS+Ohik+r0FeicIw: sits out 
*** HOLE CARDS ***
u0ikXOhAPSCLmg+l17oGRw: calls $0.25
v8m8XHovI5tqEA9mvplDSw: folds 
cWc85bEzdRzpUMhRKm8pwQ: folds 
gPEN9Zp33YTm/mu9/SYP1w: folds 
LJI7A1YgDM7hgh7o56+ReQ: checks 
*** FLOP *** [2h 2d Jd]
LJI7A1YgDM7hgh7o56+ReQ: checks 
u0ikXOhAPSCLmg+l17oGRw: checks 
*** TURN *** [2h 2d Jd] [7d]
LJI7A1YgDM7hgh7o56+ReQ: checks 
u0ikXOhAPSCLmg+l17oGRw: checks 
*** RIVER *** [2h 2d Jd 7d] [6c]
LJI7A1YgDM7hgh7o56+ReQ: checks 
u0ikXOhAPSCLmg+l17oGRw: checks 
*** SHOW DOWN ***
LJI7A1YgDM7hgh7o56+ReQ: shows [Ad 5c] (a pair of Deuces)
u0ikXOhAPSCLmg+l17oGRw: mucks hand 
LJI7A1YgDM7hgh7o56+ReQ collected $0.60 from pot
*** SUMMARY ***
Total pot $0.60 | Rake $0 
Board [2h 2d Jd 7d 6c]
Seat 1: gPEN9Zp33YTm/mu9/SYP1w (small blind) folded before Flop
Seat 2: LJI7A1YgDM7hgh7o56+ReQ (big blind) showed [Ad 5c] and won ($0.60) with a pair of Deuces
Seat 4: u0ikXOhAPSCLmg+l17oGRw mucked
Seat 5: v8m8XHovI5tqEA9mvplDSw folded before Flop (didn't bet)
Seat 6: cWc85bEzdRzpUMhRKm8pwQ (button) folded before Flop (didn't bet)




PokerStars Game #59941892832:  Hold'em No Limit ($0.10/$0.25) - 2009/07/01 1:49:30 ET
Table '2clPgY3+dETPD/8zjXZdFw' 6-max Seat #2 is the button
Seat 1: 7cx44/slbeTw+Cy7QB8Trg ($25.45 in chips) 
Seat 2: cWc85bEzdRzpUMhRKm8pwQ ($25 in chips) 
Seat 3: FL1UWpN6oReBdznWDOy9Gg ($15.20 in chips) 
Seat 4: ljjhtb6FVPTx9AT9HNdtqg ($25.10 in chips) 
Seat 5: LJI7A1YgDM7hgh7o56+ReQ ($29.55 in chips) 
FL1UWpN6oReBdznWDOy9Gg: posts small blind $0.10
ljjhtb6FVPTx9AT9HNdtqg: posts big blind $0.25
c3J/KYZ4cNsUEuz8v57I5A: sits out 
*** HOLE CARDS ***
LJI7A1YgDM7hgh7o56+ReQ: folds 
7cx44/slbeTw+Cy7QB8Trg: folds 
cWc85bEzdRzpUMhRKm8pwQ: folds 
FL1UWpN6oReBdznWDOy9Gg: calls $0.15
ljjhtb6FVPTx9AT9HNdtqg: raises $0.50 to $0.75
FL1UWpN6oReBdznWDOy9Gg: calls $0.50
*** FLOP *** [Qc Js Ts]
FL1UWpN6oReBdznWDOy9Gg: bets $0.25
ljjhtb6FVPTx9AT9HNdtqg: calls $0.25
*** TURN *** [Qc Js Ts] [9d]
FL1UWpN6oReBdznWDOy9Gg: bets $0.25
ljjhtb6FVPTx9AT9HNdtqg: calls $0.25
*** RIVER *** [Qc Js Ts 9d] [7h]
FL1UWpN6oReBdznWDOy9Gg: bets $0.25
ljjhtb6FVPTx9AT9HNdtqg: folds 
Uncalled bet ($0.25) returned to FL1UWpN6oReBdznWDOy9Gg
FL1UWpN6oReBdznWDOy9Gg collected $2.40 from pot
FL1UWpN6oReBdznWDOy9Gg: doesn't show hand 
*** SUMMARY ***
Total pot $2.50 | Rake $0.10 
Board [Qc Js Ts 9d 7h]
Seat 1: 7cx44/slbeTw+Cy7QB8Trg folded before Flop (didn't bet)
Seat 2: cWc85bEzdRzpUMhRKm8pwQ (button) folded before Flop (didn't bet)
Seat 3: FL1UWpN6oReBdznWDOy9Gg (small blind) collected ($2.40)
Seat 4: ljjhtb6FVPTx9AT9HNdtqg (big blind) folded on the River
Seat 5: LJI7A1YgDM7hgh7o56+ReQ folded before Flop (didn't bet)




PokerStars Game #59941893146:  Hold'em No Limit ($0.10/$0.25) - 2009/07/01 1:49:30 ET
Table 'IuqVbFI+pwnJjvwBCGSGAw' 6-max Seat #5 is the button
Seat 1: LyDHtw3/yniNHW+DvLXbog ($28.10 in chips) 
Seat 2: w43JQj2oYPpKQVG4Yzlq1w ($25 in chips) 
Seat 3: QiL+lEgEWwy21jk/ltaRLg ($21.05 in chips) 
Seat 4: DE9hRlt14g+JdsRQ4wT7hg ($28.20 in chips) 
Seat 5: if4dh6jhJXeN3/qd3qCp9g ($23.70 in chips) 
Seat 6: xC0kaiDYM6YTlgODL83O5A ($12.90 in chips) 
xC0kaiDYM6YTlgODL83O5A: posts small blind $0.10
LyDHtw3/yniNHW+DvLXbog: posts big blind $0.25
*** HOLE CARDS ***
w43JQj2oYPpKQVG4Yzlq1w: raises $0.75 to $1
QiL+lEgEWwy21jk/ltaRLg: folds 
DE9hRlt14g+JdsRQ4wT7hg: folds 
if4dh6jhJXeN3/qd3qCp9g: folds 
xC0kaiDYM6YTlgODL83O5A: folds 
LyDHtw3/yniNHW+DvLXbog: folds 
Uncalled bet ($0.75) returned to w43JQj2oYPpKQVG4Yzlq1w
w43JQj2oYPpKQVG4Yzlq1w collected $0.60 from pot
*** SUMMARY ***
Total pot $0.60 | Rake $0 
Seat 1: LyDHtw3/yniNHW+DvLXbog (big blind) folded before Flop
Seat 2: w43JQj2oYPpKQVG4Yzlq1w collected ($0.60)
Seat 3: QiL+lEgEWwy21jk/ltaRLg folded before Flop (didn't bet)
Seat 4: DE9hRlt14g+JdsRQ4wT7hg folded before Flop (didn't bet)
Seat 5: if4dh6jhJXeN3/qd3qCp9g (button) folded before Flop (didn't bet)
Seat 6: xC0kaiDYM6YTlgODL83O5A (small blind) folded before Flop




PokerStars Game #59941892930:  Hold'em No Limit ($0.10/$0.25) - 2009/07/01 1:49:30 ET
Table 'vZfV/Uj0q8joA1du9sRJSg' 6-max Seat #1 is the button
Seat 1: Hsvkc0/G2VV78oVmWYXecw ($5 in chips) 
Seat 2: wMiE3yTbDJGOLOF9th7KPA ($10.10 in chips) 
Seat 3: cWc85bEzdRzpUMhRKm8pwQ ($25 in chips) 
Seat 4: v+QfkGiuj9bgtuNoVnDO8w ($43.50 in chips) 
Seat 5: kyRaCIljYA6l33lSKQfNsg ($29.30 in chips) 
Seat 6: 8ClCHtFXGNplITm+63KB+Q ($48.70 in chips) 
wMiE3yTbDJGOLOF9th7KPA: posts small blind $0.10
cWc85bEzdRzpUMhRKm8pwQ: posts big blind $0.25
*** HOLE CARDS ***
v+QfkGiuj9bgtuNoVnDO8w: folds 
kyRaCIljYA6l33lSKQfNsg: folds 
8ClCHtFXGNplITm+63KB+Q: folds 
Hsvkc0/G2VV78oVmWYXecw: raises $0.50 to $0.75
wMiE3yTbDJGOLOF9th7KPA: calls $0.65
cWc85bEzdRzpUMhRKm8pwQ: folds 
*** FLOP *** [5c 3s 6d]
wMiE3yTbDJGOLOF9th7KPA: bets $0.50
Hsvkc0/G2VV78oVmWYXecw: folds 
Uncalled bet ($0.50) returned to wMiE3yTbDJGOLOF9th7KPA
wMiE3yTbDJGOLOF9th7KPA collected $1.70 from pot
*** SUMMARY ***
Total pot $1.75 | Rake $0.05 
Board [5c 3s 6d]
Seat 1: Hsvkc0/G2VV78oVmWYXecw (button) folded on the Flop
Seat 2: wMiE3yTbDJGOLOF9th7KPA (small blind) collected ($1.70)
Seat 3: cWc85bEzdRzpUMhRKm8pwQ (big blind) folded before Flop
Seat 4: v+QfkGiuj9bgtuNoVnDO8w folded before Flop (didn't bet)
Seat 5: kyRaCIljYA6l33lSKQfNsg folded before Flop (didn't bet)
Seat 6: 8ClCHtFXGNplITm+63KB+Q folded before Flop (didn't bet)




PokerStars Game #59941893658:  Hold'em No Limit ($0.10/$0.25) - 2009/07/01 1:49:31 ET
Table 'Y9EhDWuqWWQFM9SelXAj5g' 9-max Seat #8 is the button
Seat 1: zDrucyjVn5aeekNEc3cJrA ($32.30 in chips) 
Seat 2: W+njF1UnarGN2q2zP+R+cg ($11.95 in chips) 
Seat 4: V6p0jQ/RhUsqpHLmXvEX4Q ($13 in chips) 
Seat 5: CvL9Ch1HYCVbTsfpNucitg ($6.20 in chips) 
Seat 6: egvg3mTBBVzMHnJPIQiKcA ($13.65 in chips) 
Seat 8: XDxyajtqmdag0QPvwcOG7Q ($14.25 in chips) 
Seat 9: bOrfviVhRBpaOfMqUc74Tw ($16.90 in chips) 
bOrfviVhRBpaOfMqUc74Tw: posts small blind $0.10
zDrucyjVn5aeekNEc3cJrA: posts big blind $0.25
*** HOLE CARDS ***
W+njF1UnarGN2q2zP+R+cg: folds 
XBq1lBzax7LjRqdJP2TqWg has returned
V6p0jQ/RhUsqpHLmXvEX4Q: folds 
CvL9Ch1HYCVbTsfpNucitg: folds 
egvg3mTBBVzMHnJPIQiKcA: folds 
XDxyajtqmdag0QPvwcOG7Q: raises $0.75 to $1
bOrfviVhRBpaOfMqUc74Tw: folds 
zDrucyjVn5aeekNEc3cJrA: folds 
Uncalled bet ($0.75) returned to XDxyajtqmdag0QPvwcOG7Q
XDxyajtqmdag0QPvwcOG7Q collected $0.60 from pot
*** SUMMARY ***
Total pot $0.60 | Rake $0 
Seat 1: zDrucyjVn5aeekNEc3cJrA (big blind) folded before Flop
Seat 2: W+njF1UnarGN2q2zP+R+cg folded before Flop (didn't bet)
Seat 4: V6p0jQ/RhUsqpHLmXvEX4Q folded before Flop (didn't bet)
Seat 5: CvL9Ch1HYCVbTsfpNucitg folded before Flop (didn't bet)
Seat 6: egvg3mTBBVzMHnJPIQiKcA folded before Flop (didn't bet)
Seat 8: XDxyajtqmdag0QPvwcOG7Q (button) collected ($0.60)
Seat 9: bOrfviVhRBpaOfMqUc74Tw (small blind) folded before Flop




PokerStars Game #59941893288:  Hold'em No Limit ($0.10/$0.25) - 2009/07/01 1:49:31 ET
Table '+VTTYgQLH1awDHk+IAxqGg' 9-max Seat #8 is the button
Seat 1: arxNSjreDRGFg13EAM2F1w ($26.90 in chips) 
Seat 2: 2wcFsZsqEP5w1StUTVzJCg ($6.90 in chips) 
Seat 3: AiXn/9o1EwOPZUHujnh/bA ($11.65 in chips) 
Seat 4: gE5rN2TDY1aXcZn/TOPeZw ($8.90 in chips) 
Seat 5: sD+TKtt36XiiN6jqHiLwDA ($24.80 in chips) 
Seat 6: clJsV3v77RS07bDKY+705w ($5 in chips) 
Seat 7: ljemhp25Zg+nlA9DLCIiUw ($23.90 in chips) 
Seat 8: 10vzP4r6ldwGLbYHKd9www ($18.90 in chips) 
Seat 9: S7Ki0P+0AIGPuIfGJjW0gg ($61.25 in chips) 
S7Ki0P+0AIGPuIfGJjW0gg: posts small blind $0.10
arxNSjreDRGFg13EAM2F1w: posts big blind $0.25
clJsV3v77RS07bDKY+705w: posts big blind $0.25
*** HOLE CARDS ***
2wcFsZsqEP5w1StUTVzJCg: folds 
AiXn/9o1EwOPZUHujnh/bA: calls $0.25
gE5rN2TDY1aXcZn/TOPeZw: folds 
sD+TKtt36XiiN6jqHiLwDA: folds 
clJsV3v77RS07bDKY+705w: checks 
ljemhp25Zg+nlA9DLCIiUw: calls $0.25
10vzP4r6ldwGLbYHKd9www: calls $0.25
S7Ki0P+0AIGPuIfGJjW0gg: folds 
arxNSjreDRGFg13EAM2F1w: checks 
*** FLOP *** [Qs 7s 5s]
arxNSjreDRGFg13EAM2F1w: checks 
AiXn/9o1EwOPZUHujnh/bA: checks 
clJsV3v77RS07bDKY+705w: bets $0.75
ljemhp25Zg+nlA9DLCIiUw: folds 
10vzP4r6ldwGLbYHKd9www: folds 
arxNSjreDRGFg13EAM2F1w: folds 
AiXn/9o1EwOPZUHujnh/bA: folds 
Uncalled bet ($0.75) returned to clJsV3v77RS07bDKY+705w
clJsV3v77RS07bDKY+705w collected $1.30 from pot
clJsV3v77RS07bDKY+705w: doesn't show hand 
*** SUMMARY ***
Total pot $1.35 | Rake $0.05 
Board [Qs 7s 5s]
Seat 1: arxNSjreDRGFg13EAM2F1w (big blind) folded on the Flop
Seat 2: 2wcFsZsqEP5w1StUTVzJCg folded before Flop (didn't bet)
Seat 3: AiXn/9o1EwOPZUHujnh/bA folded on the Flop
Seat 4: gE5rN2TDY1aXcZn/TOPeZw folded before Flop (didn't bet)
Seat 5: sD+TKtt36XiiN6jqHiLwDA folded before Flop (didn't bet)
Seat 6: clJsV3v77RS07bDKY+705w collected ($1.30)
Seat 7: ljemhp25Zg+nlA9DLCIiUw folded on the Flop
Seat 8: 10vzP4r6ldwGLbYHKd9www (button) folded on the Flop
Seat 9: S7Ki0P+0AIGPuIfGJjW0gg (small blind) folded before Flop




PokerStars Game #59941893862:  Hold'em No Limit ($0.10/$0.25) - 2009/07/01 1:49:32 ET
Table 'SgI2Cobdjtkh0Fd0/eTTDg' 9-max Seat #2 is the button
Seat 1: p4VoE724cQin02zatf/NOw ($5 in chips) 
Seat 2: uUc5QTI8+ZdC95UnznCsqg ($14.10 in chips) 
Seat 3: GeMoapCKDLc4ajT0Uk9ZQw ($9.75 in chips) 
Seat 4: s1y+qfkBnhgc67+X3ThjeA ($8.15 in chips) 
Seat 5: RHqgdFvufLCYe54+qd2gcA ($6.25 in chips) 
Seat 6: 6RiVTYll/5D8zICp0MRpKw ($27.85 in chips) 
Seat 7: RY9uq/FyiWrrnWBl/zGQKg ($20.70 in chips) 
Seat 8: wzU16tcf+7nj2MYKa4h7+Q ($14.50 in chips) 
Seat 9: cZ99hugmLBj9KhTlc8nCSw ($30.60 in chips) 
GeMoapCKDLc4ajT0Uk9ZQw: posts small blind $0.10
s1y+qfkBnhgc67+X3ThjeA: posts big blind $0.25
p4VoE724cQin02zatf/NOw: posts big blind $0.25
*** HOLE CARDS ***
RHqgdFvufLCYe54+qd2gcA: folds 
6RiVTYll/5D8zICp0MRpKw: folds 
RY9uq/FyiWrrnWBl/zGQKg: raises $0.75 to $1
wzU16tcf+7nj2MYKa4h7+Q: calls $1
cZ99hugmLBj9KhTlc8nCSw: folds 
p4VoE724cQin02zatf/NOw: folds 
uUc5QTI8+ZdC95UnznCsqg: folds 
GeMoapCKDLc4ajT0Uk9ZQw: folds 
s1y+qfkBnhgc67+X3ThjeA: folds 
*** FLOP *** [Ah Jh 9h]
RY9uq/FyiWrrnWBl/zGQKg: bets $0.75
wzU16tcf+7nj2MYKa4h7+Q: calls $0.75
*** TURN *** [Ah Jh 9h] [8s]
RY9uq/FyiWrrnWBl/zGQKg: bets $0.25
wzU16tcf+7nj2MYKa4h7+Q: calls $0.25
*** RIVER *** [Ah Jh 9h 8s] [Qd]
RY9uq/FyiWrrnWBl/zGQKg: bets $2
wzU16tcf+7nj2MYKa4h7+Q: calls $2
*** SHOW DOWN ***
RY9uq/FyiWrrnWBl/zGQKg: shows [Td Kc] (a straight, Ten to Ace)
wzU16tcf+7nj2MYKa4h7+Q: mucks hand 
RY9uq/FyiWrrnWBl/zGQKg collected $8.20 from pot
*** SUMMARY ***
Total pot $8.60 | Rake $0.40 
Board [Ah Jh 9h 8s Qd]
Seat 1: p4VoE724cQin02zatf/NOw folded before Flop
Seat 2: uUc5QTI8+ZdC95UnznCsqg (button) folded before Flop (didn't bet)
Seat 3: GeMoapCKDLc4ajT0Uk9ZQw (small blind) folded before Flop
Seat 4: s1y+qfkBnhgc67+X3ThjeA (big blind) folded before Flop
Seat 5: RHqgdFvufLCYe54+qd2gcA folded before Flop (didn't bet)
Seat 6: 6RiVTYll/5D8zICp0MRpKw folded before Flop (didn't bet)
Seat 7: RY9uq/FyiWrrnWBl/zGQKg showed [Td Kc] and won ($8.20) with a straight, Ten to Ace
Seat 8: wzU16tcf+7nj2MYKa4h7+Q mucked
Seat 9: cZ99hugmLBj9KhTlc8nCSw folded before Flop (didn't bet)




PokerStars Game #59941893854:  Hold'em No Limit ($0.10/$0.25) - 2009/07/01 1:49:32 ET
Table 'djcjiEGabFQO0MNG6jEeJQ' 9-max Seat #1 is the button
Seat 1: Bb42QRQMhg5/Y0vHP8/2Xw ($25 in chips) 
Seat 2: WKL8nUFr7TumC4EjLyqYzw ($5 in chips) 
Seat 4: 2wcFsZsqEP5w1StUTVzJCg ($9.55 in chips) 
Seat 5: 9QQ67diwg/DShNDBou2R8Q ($24.75 in chips) 
Seat 6: aNpwfA31EREwO+ar4XzBCw ($78.50 in chips) 
Seat 7: 5pDhXQ+RVy0BGcwfJAJfbg ($25 in chips) 
Seat 8: +sbyWwIcFp9kP0bDtMegfQ ($46.25 in chips) 
Seat 9: HPEB+AtKw1+C/cxU0o1ciw ($46.50 in chips) 
WKL8nUFr7TumC4EjLyqYzw: posts small blind $0.10
zgi+EUykT/pZQpoUG6+oEg: is sitting out 
2wcFsZsqEP5w1StUTVzJCg: posts big blind $0.25
5pDhXQ+RVy0BGcwfJAJfbg: posts big blind $0.25
*** HOLE CARDS ***
9QQ67diwg/DShNDBou2R8Q: folds 
zgi+EUykT/pZQpoUG6+oEg leaves the table
aNpwfA31EREwO+ar4XzBCw: folds 
5pDhXQ+RVy0BGcwfJAJfbg: raises $0.75 to $1
+sbyWwIcFp9kP0bDtMegfQ: folds 
HPEB+AtKw1+C/cxU0o1ciw: folds 
Bb42QRQMhg5/Y0vHP8/2Xw: folds 
WKL8nUFr7TumC4EjLyqYzw: calls $0.90
2wcFsZsqEP5w1StUTVzJCg: folds 
*** FLOP *** [8d Tc 3d]
WKL8nUFr7TumC4EjLyqYzw: checks 
5pDhXQ+RVy0BGcwfJAJfbg: checks 
*** TURN *** [8d Tc 3d] [9s]
WKL8nUFr7TumC4EjLyqYzw: bets $0.50
Johnny Viva joins the table at seat #3 
5pDhXQ+RVy0BGcwfJAJfbg: calls $0.50
*** RIVER *** [8d Tc 3d 9s] [2c]
WKL8nUFr7TumC4EjLyqYzw: checks 
5pDhXQ+RVy0BGcwfJAJfbg: checks 
*** SHOW DOWN ***
WKL8nUFr7TumC4EjLyqYzw: shows [Qc Kd] (high card King)
5pDhXQ+RVy0BGcwfJAJfbg: shows [Jh Ac] (high card Ace)
5pDhXQ+RVy0BGcwfJAJfbg collected $3.10 from pot
*** SUMMARY ***
Total pot $3.25 | Rake $0.15 
Board [8d Tc 3d 9s 2c]
Seat 1: Bb42QRQMhg5/Y0vHP8/2Xw (button) folded before Flop (didn't bet)
Seat 2: WKL8nUFr7TumC4EjLyqYzw (small blind) showed [Qc Kd] and lost with high card King
Seat 4: 2wcFsZsqEP5w1StUTVzJCg (big blind) folded before Flop
Seat 5: 9QQ67diwg/DShNDBou2R8Q folded before Flop (didn't bet)
Seat 6: aNpwfA31EREwO+ar4XzBCw folded before Flop (didn't bet)
Seat 7: 5pDhXQ+RVy0BGcwfJAJfbg showed [Jh Ac] and won ($3.10) with high card Ace
Seat 8: +sbyWwIcFp9kP0bDtMegfQ folded before Flop (didn't bet)
Seat 9: HPEB+AtKw1+C/cxU0o1ciw folded before Flop (didn't bet)




PokerStars Game #59941894016:  Hold'em No Limit ($0.10/$0.25) - 2009/07/01 1:49:32 ET
Table 'NfXsh0UQA+o/kO9acV3WxA' 9-max Seat #1 is the button
Seat 1: pN3IHvAKm2fz+sTRARTcrg ($24.30 in chips) 
Seat 2: mhpFs2SZupy4zLRb62FLFA ($24.75 in chips) 
Seat 3: wCUaomJ6Nq5zomVGdUHP+w ($17.65 in chips) 
Seat 4: r6hsffOo1iKmaPYKwAZmFw ($30.05 in chips) 
Seat 5: zgi+EUykT/pZQpoUG6+oEg ($4.65 in chips) 
Seat 7: yqkowiRWZ6NvRN9UUkYIlA ($5 in chips) 
Seat 8: +sbyWwIcFp9kP0bDtMegfQ ($40.60 in chips) 
Seat 9: uhrboV251dcgYniYTdFIcA ($28.85 in chips) 
mhpFs2SZupy4zLRb62FLFA: posts small blind $0.10
wCUaomJ6Nq5zomVGdUHP+w: posts big blind $0.25
qwr38jl5txoR36M7G5qi4A: sits out 
*** HOLE CARDS ***
r6hsffOo1iKmaPYKwAZmFw: folds 
zgi+EUykT/pZQpoUG6+oEg: folds 
yqkowiRWZ6NvRN9UUkYIlA: folds 
+sbyWwIcFp9kP0bDtMegfQ: folds 
uhrboV251dcgYniYTdFIcA: folds 
pN3IHvAKm2fz+sTRARTcrg: raises $0.75 to $1
mhpFs2SZupy4zLRb62FLFA: folds 
wCUaomJ6Nq5zomVGdUHP+w: raises $1.50 to $2.50
pN3IHvAKm2fz+sTRARTcrg: calls $1.50
*** FLOP *** [6h 6s 2s]
wCUaomJ6Nq5zomVGdUHP+w: bets $2
pN3IHvAKm2fz+sTRARTcrg: folds 
Uncalled bet ($2) returned to wCUaomJ6Nq5zomVGdUHP+w
wCUaomJ6Nq5zomVGdUHP+w collected $4.85 from pot
wCUaomJ6Nq5zomVGdUHP+w: doesn't show hand 
*** SUMMARY ***
Total pot $5.10 | Rake $0.25 
Board [6h 6s 2s]
Seat 1: pN3IHvAKm2fz+sTRARTcrg (button) folded on the Flop
Seat 2: mhpFs2SZupy4zLRb62FLFA (small blind) folded before Flop
Seat 3: wCUaomJ6Nq5zomVGdUHP+w (big blind) collected ($4.85)
Seat 4: r6hsffOo1iKmaPYKwAZmFw folded before Flop (didn't bet)
Seat 5: zgi+EUykT/pZQpoUG6+oEg folded before Flop (didn't bet)
Seat 7: yqkowiRWZ6NvRN9UUkYIlA folded before Flop (didn't bet)
Seat 8: +sbyWwIcFp9kP0bDtMegfQ folded before Flop (didn't bet)
Seat 9: uhrboV251dcgYniYTdFIcA folded before Flop (didn't bet)




PokerStars Game #59941893816:  Hold'em No Limit ($0.10/$0.25) - 2009/07/01 1:49:32 ET
Table 'pAhiNHs/spaABQia+7gWNQ' 9-max Seat #8 is the button
Seat 1: ipgcO7Pa6LC8XWpVttZfnA ($5 in chips) 
Seat 2: dfNim92Z6XK1/h5SFW5vDg ($25.25 in chips) 
Seat 4: Qduu7ikeizo6q6Ei9YvcJA ($47.75 in chips) 
Seat 5: OlPJsgR4xypSg/w1z7Gyvw ($33.60 in chips) 
Seat 6: oLa/tXLfSLLB28mcLGrxcg ($23.90 in chips) 
Seat 7: +WTkVY3GeLxqGQBbMZQiWQ ($10.30 in chips) 
Seat 8: PskTLlFIRHSp61inskRzVg ($9.35 in chips) 
Seat 9: zgi+EUykT/pZQpoUG6+oEg ($5.90 in chips) 
zgi+EUykT/pZQpoUG6+oEg: posts small blind $0.10
ipgcO7Pa6LC8XWpVttZfnA: posts big blind $0.25
bXpVeaSTPBFSPJmeXxO7nw: sits out 
*** HOLE CARDS ***
dfNim92Z6XK1/h5SFW5vDg: folds 
Qduu7ikeizo6q6Ei9YvcJA: folds 
OlPJsgR4xypSg/w1z7Gyvw: folds 
oLa/tXLfSLLB28mcLGrxcg: calls $0.25
+WTkVY3GeLxqGQBbMZQiWQ: folds 
PskTLlFIRHSp61inskRzVg: folds 
zgi+EUykT/pZQpoUG6+oEg: folds 
ipgcO7Pa6LC8XWpVttZfnA: checks 
*** FLOP *** [Td Kh Qc]
ipgcO7Pa6LC8XWpVttZfnA: checks 
oLa/tXLfSLLB28mcLGrxcg: checks 
*** TURN *** [Td Kh Qc] [5c]
ipgcO7Pa6LC8XWpVttZfnA: checks 
oLa/tXLfSLLB28mcLGrxcg: checks 
*** RIVER *** [Td Kh Qc 5c] [Kc]
ipgcO7Pa6LC8XWpVttZfnA: checks 
oLa/tXLfSLLB28mcLGrxcg: checks 
*** SHOW DOWN ***
ipgcO7Pa6LC8XWpVttZfnA: shows [4d Jc] (a pair of Kings)
oLa/tXLfSLLB28mcLGrxcg: shows [9d 9s] (two pair, Kings and Nines)
oLa/tXLfSLLB28mcLGrxcg collected $0.60 from pot
*** SUMMARY ***
Total pot $0.60 | Rake $0 
Board [Td Kh Qc 5c Kc]
Seat 1: ipgcO7Pa6LC8XWpVttZfnA (big blind) showed [4d Jc] and lost with a pair of Kings
Seat 2: dfNim92Z6XK1/h5SFW5vDg folded before Flop (didn't bet)
Seat 4: Qduu7ikeizo6q6Ei9YvcJA folded before Flop (didn't bet)
Seat 5: OlPJsgR4xypSg/w1z7Gyvw folded before Flop (didn't bet)
Seat 6: oLa/tXLfSLLB28mcLGrxcg showed [9d 9s] and won ($0.60) with two pair, Kings and Nines
Seat 7: +WTkVY3GeLxqGQBbMZQiWQ folded before Flop (didn't bet)
Seat 8: PskTLlFIRHSp61inskRzVg (button) folded before Flop (didn't bet)
Seat 9: zgi+EUykT/pZQpoUG6+oEg (small blind) folded before Flop




PokerStars Game #59941894152:  Hold'em No Limit ($0.10/$0.25) - 2009/07/01 1:49:32 ET
Table 'g+mPuNJBCHKE9ents7ZGtg' 6-max Seat #5 is the button
Seat 1: cezpHJ8FB07dj0xG+LhOvw ($58.50 in chips) 
Seat 2: fZQg9veL7Dd/Z04ZTjC+wQ ($64.60 in chips) 
Seat 4: yVrjRIW0SMxgpvqSIPSe/w ($14.95 in chips) 
Seat 5: D3ikCR8c/o9jB5irZ3uGlw ($11.90 in chips) 
Seat 6: Mn2V28t5aGq2d09z+/o6Fw ($24.60 in chips) 
Mn2V28t5aGq2d09z+/o6Fw: posts small blind $0.10
cezpHJ8FB07dj0xG+LhOvw: posts big blind $0.25
8CPg15X6IHYR1pWm9ha1Sw: sits out 
*** HOLE CARDS ***
fZQg9veL7Dd/Z04ZTjC+wQ: raises $0.50 to $0.75
yVrjRIW0SMxgpvqSIPSe/w: folds 
D3ikCR8c/o9jB5irZ3uGlw: calls $0.75
Mn2V28t5aGq2d09z+/o6Fw: folds 
cezpHJ8FB07dj0xG+LhOvw: folds 
*** FLOP *** [2s 3c Ah]
fZQg9veL7Dd/Z04ZTjC+wQ: checks 
D3ikCR8c/o9jB5irZ3uGlw: checks 
*** TURN *** [2s 3c Ah] [6c]
fZQg9veL7Dd/Z04ZTjC+wQ: bets $0.75
D3ikCR8c/o9jB5irZ3uGlw: calls $0.75
*** RIVER *** [2s 3c Ah 6c] [3h]
fZQg9veL7Dd/Z04ZTjC+wQ: bets $2.25
D3ikCR8c/o9jB5irZ3uGlw: raises $3.75 to $6
fZQg9veL7Dd/Z04ZTjC+wQ: calls $3.75
*** SHOW DOWN ***
D3ikCR8c/o9jB5irZ3uGlw: shows [Qd 3d] (three of a kind, Threes)
fZQg9veL7Dd/Z04ZTjC+wQ: mucks hand 
D3ikCR8c/o9jB5irZ3uGlw collected $14.60 from pot
*** SUMMARY ***
Total pot $15.35 | Rake $0.75 
Board [2s 3c Ah 6c 3h]
Seat 1: cezpHJ8FB07dj0xG+LhOvw (big blind) folded before Flop
Seat 2: fZQg9veL7Dd/Z04ZTjC+wQ mucked
Seat 4: yVrjRIW0SMxgpvqSIPSe/w folded before Flop (didn't bet)
Seat 5: D3ikCR8c/o9jB5irZ3uGlw (button) showed [Qd 3d] and won ($14.60) with three of a kind, Threes
Seat 6: Mn2V28t5aGq2d09z+/o6Fw (small blind) folded before Flop




PokerStars Game #59941894094:  Hold'em No Limit ($0.10/$0.25) - 2009/07/01 1:49:32 ET
Table 'KEoOIegxPF91KooL2AelUA' 6-max Seat #6 is the button
Seat 1: 32YL2ZEp8NT4JB2RVM9euQ ($15.75 in chips) 
Seat 2: 0Bg59Tnte1Tc7C4i9Jd9cQ ($4.65 in chips) 
Seat 3: zxeVQGaMKDsDzmSY+AInjA ($12.35 in chips) 
Seat 4: Wo60l2GQnSEc3bxPVyvIUw ($10.25 in chips) 
Seat 6: AMrBn4Vx9aAo/vv6WHLk6w ($3.50 in chips) 
32YL2ZEp8NT4JB2RVM9euQ: posts small blind $0.10
0Bg59Tnte1Tc7C4i9Jd9cQ: posts big blind $0.25
VXTONriS+Ohik+r0FeicIw: sits out 
*** HOLE CARDS ***
zxeVQGaMKDsDzmSY+AInjA: folds 
Wo60l2GQnSEc3bxPVyvIUw: folds 
AMrBn4Vx9aAo/vv6WHLk6w: folds 
32YL2ZEp8NT4JB2RVM9euQ: raises $0.75 to $1
0Bg59Tnte1Tc7C4i9Jd9cQ: calls $0.75
*** FLOP *** [Qd Th 7h]
32YL2ZEp8NT4JB2RVM9euQ: checks 
0Bg59Tnte1Tc7C4i9Jd9cQ: checks 
*** TURN *** [Qd Th 7h] [6d]
32YL2ZEp8NT4JB2RVM9euQ: checks 
0Bg59Tnte1Tc7C4i9Jd9cQ: checks 
*** RIVER *** [Qd Th 7h 6d] [Ts]
32YL2ZEp8NT4JB2RVM9euQ: checks 
0Bg59Tnte1Tc7C4i9Jd9cQ: checks 
*** SHOW DOWN ***
32YL2ZEp8NT4JB2RVM9euQ: shows [Ks Ah] (a pair of Tens)
0Bg59Tnte1Tc7C4i9Jd9cQ: mucks hand 
32YL2ZEp8NT4JB2RVM9euQ collected $1.90 from pot
*** SUMMARY ***
Total pot $2 | Rake $0.10 
Board [Qd Th 7h 6d Ts]
Seat 1: 32YL2ZEp8NT4JB2RVM9euQ (small blind) showed [Ks Ah] and won ($1.90) with a pair of Tens
Seat 2: 0Bg59Tnte1Tc7C4i9Jd9cQ (big blind) mucked
Seat 3: zxeVQGaMKDsDzmSY+AInjA folded before Flop (didn't bet)
Seat 4: Wo60l2GQnSEc3bxPVyvIUw folded before Flop (didn't bet)
Seat 6: AMrBn4Vx9aAo/vv6WHLk6w (button) folded before Flop (didn't bet)




PokerStars Game #59941893944:  Hold'em No Limit ($0.10/$0.25) - 2009/07/01 1:49:32 ET
Table 'ohAuixfiLOYDylNUG5mNUw' 9-max Seat #2 is the button
Seat 1: qwr38jl5txoR36M7G5qi4A ($10 in chips) 
Seat 2: Th3FldXKQW6hWVVPahaoOQ ($25.80 in chips) 
Seat 3: gSakoFAgDDzXSb2eNBWKcg ($14.60 in chips) 
Seat 4: clJsV3v77RS07bDKY+705w ($5 in chips) 
Seat 6: MtVtHDqIJTyUcXkRBBDIVA ($25.35 in chips) 
Seat 8: ppMlNkhYgErlt4fuJO7ADA ($4.95 in chips) 
Seat 9: CT7Xj/V/O5rBlhtt+RZeFQ ($25.25 in chips) 
gSakoFAgDDzXSb2eNBWKcg: posts small blind $0.10
clJsV3v77RS07bDKY+705w: posts big blind $0.25
y6clPkgMYve3yX9UTvvFUw has timed out while being disconnected
y6clPkgMYve3yX9UTvvFUw: is sitting out 
*** HOLE CARDS ***
y6clPkgMYve3yX9UTvvFUw is disconnected 
MtVtHDqIJTyUcXkRBBDIVA: folds 
ppMlNkhYgErlt4fuJO7ADA: folds 
y6clPkgMYve3yX9UTvvFUw is connected 
CT7Xj/V/O5rBlhtt+RZeFQ: folds 
qwr38jl5txoR36M7G5qi4A: folds 
y6clPkgMYve3yX9UTvvFUw has returned
Th3FldXKQW6hWVVPahaoOQ: raises $0.50 to $0.75
gSakoFAgDDzXSb2eNBWKcg: folds 
clJsV3v77RS07bDKY+705w: folds 
Uncalled bet ($0.50) returned to Th3FldXKQW6hWVVPahaoOQ
Th3FldXKQW6hWVVPahaoOQ collected $0.60 from pot
Th3FldXKQW6hWVVPahaoOQ: doesn't show hand 
*** SUMMARY ***
Total pot $0.60 | Rake $0 
Seat 1: qwr38jl5txoR36M7G5qi4A folded before Flop (didn't bet)
Seat 2: Th3FldXKQW6hWVVPahaoOQ (button) collected ($0.60)
Seat 3: gSakoFAgDDzXSb2eNBWKcg (small blind) folded before Flop
Seat 4: clJsV3v77RS07bDKY+705w (big blind) folded before Flop
Seat 6: MtVtHDqIJTyUcXkRBBDIVA folded before Flop (didn't bet)
Seat 8: ppMlNkhYgErlt4fuJO7ADA folded before Flop (didn't bet)
Seat 9: CT7Xj/V/O5rBlhtt+RZeFQ folded before Flop (didn't bet)




PokerStars Game #59941893922:  Hold'em No Limit ($0.10/$0.25) - 2009/07/01 1:49:32 ET
Table 'FE/j6VqBY4j9Uq+VHURQCQ' 6-max Seat #4 is the button
Seat 1: ypmjhffk/YHGc51wgVXUTw ($39.65 in chips) 
Seat 2: 3zD3qLXT1bEffAoWGnc7wg ($36.75 in chips) 
Seat 3: lBoEwOFgzcERLIRUkUoRTw ($27.50 in chips) 
Seat 4: 7JyPCA0J2grhXQYxe1h3+A ($7.10 in chips) 
Seat 5: bJFzs6QmEEnz4miMfSDtcg ($16.65 in chips) 
Seat 6: Q1uciOZPBR/WkAlqa6cL4A ($25 in chips) 
bJFzs6QmEEnz4miMfSDtcg: posts small blind $0.10
Q1uciOZPBR/WkAlqa6cL4A: posts big blind $0.25
*** HOLE CARDS ***
ypmjhffk/YHGc51wgVXUTw: folds 
3zD3qLXT1bEffAoWGnc7wg: raises $0.50 to $0.75
lBoEwOFgzcERLIRUkUoRTw: folds 
7JyPCA0J2grhXQYxe1h3+A: folds 
bJFzs6QmEEnz4miMfSDtcg: folds 
Q1uciOZPBR/WkAlqa6cL4A: folds 
Uncalled bet ($0.50) returned to 3zD3qLXT1bEffAoWGnc7wg
3zD3qLXT1bEffAoWGnc7wg collected $0.60 from pot
3zD3qLXT1bEffAoWGnc7wg: doesn't show hand 
*** SUMMARY ***
Total pot $0.60 | Rake $0 
Seat 1: ypmjhffk/YHGc51wgVXUTw folded before Flop (didn't bet)
Seat 2: 3zD3qLXT1bEffAoWGnc7wg collected ($0.60)
Seat 3: lBoEwOFgzcERLIRUkUoRTw folded before Flop (didn't bet)
Seat 4: 7JyPCA0J2grhXQYxe1h3+A (button) folded before Flop (didn't bet)
Seat 5: bJFzs6QmEEnz4miMfSDtcg (small blind) folded before Flop
Seat 6: Q1uciOZPBR/WkAlqa6cL4A (big blind) folded before Flop




PokerStars Game #59941893698:  Hold'em No Limit ($0.10/$0.25) - 2009/07/01 1:49:32 ET
Table 'zKwHJD0cmKNUure9qQTfFg' 6-max Seat #1 is the button
Seat 1: Hzrn9DZJegEZICufTNYkrg ($18.50 in chips) 
Seat 2: xrf8tAXKQHG99HixCot1Iw ($30.05 in chips) 
Seat 3: m9aw7LBAB5YX2ZqMtMkhqA ($14.25 in chips) 
Seat 4: v+QfkGiuj9bgtuNoVnDO8w ($25 in chips) 
Seat 5: E4AqQ1egsnu0oH2RqsbCmQ ($4.65 in chips) 
Seat 6: edio/rLJ06xeZOfLhoL3UA ($5.85 in chips) 
xrf8tAXKQHG99HixCot1Iw: posts small blind $0.10
m9aw7LBAB5YX2ZqMtMkhqA: posts big blind $0.25
*** HOLE CARDS ***
v+QfkGiuj9bgtuNoVnDO8w: folds 
E4AqQ1egsnu0oH2RqsbCmQ: folds 
edio/rLJ06xeZOfLhoL3UA: folds 
Hzrn9DZJegEZICufTNYkrg: folds 
xrf8tAXKQHG99HixCot1Iw: raises $0.50 to $0.75
m9aw7LBAB5YX2ZqMtMkhqA: folds 
Uncalled bet ($0.50) returned to xrf8tAXKQHG99HixCot1Iw
xrf8tAXKQHG99HixCot1Iw collected $0.50 from pot
xrf8tAXKQHG99HixCot1Iw: doesn't show hand 
*** SUMMARY ***
Total pot $0.50 | Rake $0 
Seat 1: Hzrn9DZJegEZICufTNYkrg (button) folded before Flop (didn't bet)
Seat 2: xrf8tAXKQHG99HixCot1Iw (small blind) collected ($0.50)
Seat 3: m9aw7LBAB5YX2ZqMtMkhqA (big blind) folded before Flop
Seat 4: v+QfkGiuj9bgtuNoVnDO8w folded before Flop (didn't bet)
Seat 5: E4AqQ1egsnu0oH2RqsbCmQ folded before Flop (didn't bet)
Seat 6: edio/rLJ06xeZOfLhoL3UA folded before Flop (didn't bet)




PokerStars Game #59941893996:  Hold'em No Limit ($0.10/$0.25) - 2009/07/01 1:49:32 ET
Table 'Qr+t8WGovMECkBv+cV1lrg' 6-max Seat #1 is the button
Seat 1: EeUZtMU058v2ObUACOF4Og ($45 in chips) 
Seat 2: vqWjZmdQu/Hxw96/IJTWdQ ($41.35 in chips) 
Seat 3: uZKkrGByYgd4/ZBX2d4z+w ($10.90 in chips) 
Seat 4: 1NNFfYMd5Hsphl/FYz9fNA ($60.15 in chips) 
Seat 5: I50OxuNg9riRq9sywF6jMQ ($5 in chips) 
Seat 6: 9U3ZKjCsarN0DjR6mSE8Ug ($14.35 in chips) 
vqWjZmdQu/Hxw96/IJTWdQ: posts small blind $0.10
uZKkrGByYgd4/ZBX2d4z+w: posts big blind $0.25
*** HOLE CARDS ***
1NNFfYMd5Hsphl/FYz9fNA: folds 
I50OxuNg9riRq9sywF6jMQ: folds 
9U3ZKjCsarN0DjR6mSE8Ug: folds 
EeUZtMU058v2ObUACOF4Og: raises $0.75 to $1
vqWjZmdQu/Hxw96/IJTWdQ: folds 
uZKkrGByYgd4/ZBX2d4z+w: calls $0.75
*** FLOP *** [8h Td 9c]
uZKkrGByYgd4/ZBX2d4z+w: checks 
EeUZtMU058v2ObUACOF4Og: bets $1.25
uZKkrGByYgd4/ZBX2d4z+w: raises $1.75 to $3
EeUZtMU058v2ObUACOF4Og: raises $3 to $6
uZKkrGByYgd4/ZBX2d4z+w: raises $3.90 to $9.90 and is all-in
EeUZtMU058v2ObUACOF4Og: calls $3.90
*** TURN *** [8h Td 9c] [7s]
*** RIVER *** [8h Td 9c 7s] [Ac]
*** SHOW DOWN ***
uZKkrGByYgd4/ZBX2d4z+w: shows [8d 8c] (three of a kind, Eights)
EeUZtMU058v2ObUACOF4Og: shows [Qd Qs] (a pair of Queens)
uZKkrGByYgd4/ZBX2d4z+w collected $20.85 from pot
*** SUMMARY ***
Total pot $21.90 | Rake $1.05 
Board [8h Td 9c 7s Ac]
Seat 1: EeUZtMU058v2ObUACOF4Og (button) showed [Qd Qs] and lost with a pair of Queens
Seat 2: vqWjZmdQu/Hxw96/IJTWdQ (small blind) folded before Flop
Seat 3: uZKkrGByYgd4/ZBX2d4z+w (big blind) showed [8d 8c] and won ($20.85) with three of a kind, Eights
Seat 4: 1NNFfYMd5Hsphl/FYz9fNA folded before Flop (didn't bet)
Seat 5: I50OxuNg9riRq9sywF6jMQ folded before Flop (didn't bet)
Seat 6: 9U3ZKjCsarN0DjR6mSE8Ug folded before Flop (didn't bet)




PokerStars Game #59941893832:  Hold'em No Limit ($0.10/$0.25) - 2009/07/01 1:49:32 ET
Table '60nA7av6bws9VnNmVwculA' 6-max Seat #5 is the button
Seat 1: if4dh6jhJXeN3/qd3qCp9g ($24.65 in chips) 
Seat 2: Bada343Si4xKu3fNXY99AA ($2.75 in chips) 
Seat 3: mnuJq+Q1IXKm/pCy+OzxmQ ($22.45 in chips) 
Seat 4: +baiVgI/ETnBARLe5mARCw ($18.60 in chips) 
Seat 5: zXh+lOT41Q2iWgCNj+OcRw ($11.50 in chips) 
Seat 6: mfrkWA3PTeYPkbO6hi98Aw ($24.50 in chips) 
mfrkWA3PTeYPkbO6hi98Aw: posts small blind $0.10
if4dh6jhJXeN3/qd3qCp9g: posts big blind $0.25
*** HOLE CARDS ***
Bada343Si4xKu3fNXY99AA: folds 
mnuJq+Q1IXKm/pCy+OzxmQ: folds 
+baiVgI/ETnBARLe5mARCw: folds 
zXh+lOT41Q2iWgCNj+OcRw: calls $0.25
mfrkWA3PTeYPkbO6hi98Aw: folds 
if4dh6jhJXeN3/qd3qCp9g: checks 
*** FLOP *** [Ad 2c 8c]
if4dh6jhJXeN3/qd3qCp9g: checks 
zXh+lOT41Q2iWgCNj+OcRw: bets $0.50
if4dh6jhJXeN3/qd3qCp9g: folds 
Uncalled bet ($0.50) returned to zXh+lOT41Q2iWgCNj+OcRw
zXh+lOT41Q2iWgCNj+OcRw collected $0.60 from pot
*** SUMMARY ***
Total pot $0.60 | Rake $0 
Board [Ad 2c 8c]
Seat 1: if4dh6jhJXeN3/qd3qCp9g (big blind) folded on the Flop
Seat 2: Bada343Si4xKu3fNXY99AA folded before Flop (didn't bet)
Seat 3: mnuJq+Q1IXKm/pCy+OzxmQ folded before Flop (didn't bet)
Seat 4: +baiVgI/ETnBARLe5mARCw folded before Flop (didn't bet)
Seat 5: zXh+lOT41Q2iWgCNj+OcRw (button) collected ($0.60)
Seat 6: mfrkWA3PTeYPkbO6hi98Aw (small blind) folded before Flop




PokerStars Game #59941894462:  Hold'em No Limit ($0.10/$0.25) - 2009/07/01 1:49:33 ET
Table 'WEMI3Mtn7dGARDbgNrKibgoG007Tb0LYbfANo6QWd16wx Seat #9 is the button
Seat 1: DiSvPC2iudwL5j9u6Huyww ($46.40 in chips) 
Seat 2: zDrucyjVn5aeekNEc3cJrA ($15 in chips) 
Seat 4: zgi+EUykT/pZQpoUG6+oEg ($5 in chips) 
Seat 5: 8f0dtuUGqDbgE6up1lQAlg ($5 in chips) 
Seat 6: yqkowiRWZ6NvRN9UUkYIlA ($5 in chips) 
Seat 7: Mh2r9hTeTEDnh19sRZtW3g ($5 in chips) 
Seat 8: q4cNXFZGNhLfrTyVrIy6Mg ($15 in chips) 
Seat 9: EVqHvqty1ZsuvDFiSXlSqQ ($28.85 in chips) 
DiSvPC2iudwL5j9u6Huyww: posts small blind $0.10
zDrucyjVn5aeekNEc3cJrA: posts big blind $0.25
pN3IHvAKm2fz+sTRARTcrg: sits out 
*** HOLE CARDS ***
zgi+EUykT/pZQpoUG6+oEg: folds 
8f0dtuUGqDbgE6up1lQAlg: calls $0.25
yqkowiRWZ6NvRN9UUkYIlA: folds 
Mh2r9hTeTEDnh19sRZtW3g: folds 
q4cNXFZGNhLfrTyVrIy6Mg: calls $0.25
EVqHvqty1ZsuvDFiSXlSqQ: folds 
DiSvPC2iudwL5j9u6Huyww: folds 
zDrucyjVn5aeekNEc3cJrA: checks 
*** FLOP *** [8c 4d 5h]
zDrucyjVn5aeekNEc3cJrA: checks 
8f0dtuUGqDbgE6up1lQAlg: checks 
q4cNXFZGNhLfrTyVrIy6Mg: bets $0.25
zDrucyjVn5aeekNEc3cJrA: calls $0.25
8f0dtuUGqDbgE6up1lQAlg: folds 
*** TURN *** [8c 4d 5h] [6s]
zDrucyjVn5aeekNEc3cJrA: checks 
q4cNXFZGNhLfrTyVrIy6Mg: bets $1.50
zDrucyjVn5aeekNEc3cJrA: folds 
Uncalled bet ($1.50) returned to q4cNXFZGNhLfrTyVrIy6Mg
q4cNXFZGNhLfrTyVrIy6Mg collected $1.30 from pot
q4cNXFZGNhLfrTyVrIy6Mg: doesn't show hand 
*** SUMMARY ***
Total pot $1.35 | Rake $0.05 
Board [8c 4d 5h 6s]
Seat 1: DiSvPC2iudwL5j9u6Huyww (small blind) folded before Flop
Seat 2: zDrucyjVn5aeekNEc3cJrA (big blind) folded on the Turn
Seat 4: zgi+EUykT/pZQpoUG6+oEg folded before Flop (didn't bet)
Seat 5: 8f0dtuUGqDbgE6up1lQAlg folded on the Flop
Seat 6: yqkowiRWZ6NvRN9UUkYIlA folded before Flop (didn't bet)
Seat 7: Mh2r9hTeTEDnh19sRZtW3g folded before Flop (didn't bet)
Seat 8: q4cNXFZGNhLfrTyVrIy6Mg collected ($1.30)
Seat 9: EVqHvqty1ZsuvDFiSXlSqQ (button) folded before Flop (didn't bet)




PokerStars Game #59941894284:  Hold'em No Limit ($0.10/$0.25) - 2009/07/01 1:49:33 ET
Table 'pPgW4R3kdH26lLi1MnE92w' 9-max Seat #5 is the button
Seat 1: F4P6SxCNY4vxdb318G9RwA ($18.35 in chips) 
Seat 2: cZ99hugmLBj9KhTlc8nCSw ($28 in chips) 
Seat 3: WaS7+xnv4bIVHoru6nxczA ($14.25 in chips) 
Seat 4: iZ1f67Ok/207yzIQOu1Kdg ($4.65 in chips) 
Seat 5: HPEB+AtKw1+C/cxU0o1ciw ($21.15 in chips) 
Seat 6: +qc/EYCgLC65SpGvr35eNg ($24.75 in chips) 
Seat 7: sD+TKtt36XiiN6jqHiLwDA ($29.05 in chips) 
Seat 8: clJsV3v77RS07bDKY+705w ($5 in chips) 
Seat 9: tcbEu7VzyHQ+0lh+skbQhQ ($65.15 in chips) 
+qc/EYCgLC65SpGvr35eNg: posts small blind $0.10
sD+TKtt36XiiN6jqHiLwDA: posts big blind $0.25
*** HOLE CARDS ***
clJsV3v77RS07bDKY+705w: folds 
tcbEu7VzyHQ+0lh+skbQhQ: calls $0.25
F4P6SxCNY4vxdb318G9RwA: folds 
cZ99hugmLBj9KhTlc8nCSw: folds 
WaS7+xnv4bIVHoru6nxczA: calls $0.25
iZ1f67Ok/207yzIQOu1Kdg: raises $1 to $1.25
HPEB+AtKw1+C/cxU0o1ciw: calls $1.25
+qc/EYCgLC65SpGvr35eNg: folds 
sD+TKtt36XiiN6jqHiLwDA: folds 
tcbEu7VzyHQ+0lh+skbQhQ: folds 
WaS7+xnv4bIVHoru6nxczA: folds 
*** FLOP *** [Kh 9s 2d]
iZ1f67Ok/207yzIQOu1Kdg: bets $1.25
HPEB+AtKw1+C/cxU0o1ciw: raises $7.25 to $8.50
iZ1f67Ok/207yzIQOu1Kdg: folds 
Uncalled bet ($7.25) returned to HPEB+AtKw1+C/cxU0o1ciw
HPEB+AtKw1+C/cxU0o1ciw collected $5.60 from pot
HPEB+AtKw1+C/cxU0o1ciw: doesn't show hand 
*** SUMMARY ***
Total pot $5.85 | Rake $0.25 
Board [Kh 9s 2d]
Seat 1: F4P6SxCNY4vxdb318G9RwA folded before Flop (didn't bet)
Seat 2: cZ99hugmLBj9KhTlc8nCSw folded before Flop (didn't bet)
Seat 3: WaS7+xnv4bIVHoru6nxczA folded before Flop
Seat 4: iZ1f67Ok/207yzIQOu1Kdg folded on the Flop
Seat 5: HPEB+AtKw1+C/cxU0o1ciw (button) collected ($5.60)
Seat 6: +qc/EYCgLC65SpGvr35eNg (small blind) folded before Flop
Seat 7: sD+TKtt36XiiN6jqHiLwDA (big blind) folded before Flop
Seat 8: clJsV3v77RS07bDKY+705w folded before Flop (didn't bet)
Seat 9: tcbEu7VzyHQ+0lh+skbQhQ folded before Flop




PokerStars Game #59941894368:  Hold'em No Limit ($0.10/$0.25) - 2009/07/01 1:49:33 ET
Table '6wawJ+MkkvuC3coG6r+YhgZiwAqg4o02gNro+JOAaFNgSeat #4 is the button
Seat 1: 6RiVTYll/5D8zICp0MRpKw ($29.85 in chips) 
Seat 2: VCKtuATyvAq9H2JSAQxPbA ($15 in chips) 
Seat 3: aNpwfA31EREwO+ar4XzBCw ($28.65 in chips) 
Seat 4: RHqgdFvufLCYe54+qd2gcA ($8.65 in chips) 
Seat 5: 5hAPbqNrvJb8PtLiceXtlg6HoFYfVGBefsR5Vrz62qIw.65 in chips) 
Seat 6: 5n7e7I+px7c6CQmLpPbtsg ($5 in chips) 
Seat 7: yyG4svzOpC1A+sUP/scg6w ($7.20 in chips) 
Seat 8: VLIsy+xjx3olLSYO3JLS6g ($14.70 in chips) 
Seat 9: ljemhp25Zg+nlA9DLCIiUw ($24.15 in chips) 
5hAPbqNrvJb8PtLiceXtlg6HoFYfVGBefsR5Vrz62qIwsts small blind $0.10
5n7e7I+px7c6CQmLpPbtsg: posts big blind $0.25
VCKtuATyvAq9H2JSAQxPbA: posts big blind $0.25
*** HOLE CARDS ***
yyG4svzOpC1A+sUP/scg6w: calls $0.25
VLIsy+xjx3olLSYO3JLS6g: calls $0.25
ljemhp25Zg+nlA9DLCIiUw: folds 
6RiVTYll/5D8zICp0MRpKw: folds 
VCKtuATyvAq9H2JSAQxPbA: checks 
aNpwfA31EREwO+ar4XzBCw: folds 
RHqgdFvufLCYe54+qd2gcA: raises $1 to $1.25
5hAPbqNrvJb8PtLiceXtlg6HoFYfVGBefsR5Vrz62qIwlds 
5n7e7I+px7c6CQmLpPbtsg: folds 
yyG4svzOpC1A+sUP/scg6w: calls $1
VLIsy+xjx3olLSYO3JLS6g: calls $1
VCKtuATyvAq9H2JSAQxPbA: folds 
*** FLOP *** [9s 2h Td]
yyG4svzOpC1A+sUP/scg6w: checks 
VLIsy+xjx3olLSYO3JLS6g: checks 
RHqgdFvufLCYe54+qd2gcA: bets $3
yyG4svzOpC1A+sUP/scg6w: folds 
VLIsy+xjx3olLSYO3JLS6g: folds 
Uncalled bet ($3) returned to RHqgdFvufLCYe54+qd2gcA
RHqgdFvufLCYe54+qd2gcA collected $4.15 from pot
RHqgdFvufLCYe54+qd2gcA: doesn't show hand 
*** SUMMARY ***
Total pot $4.35 | Rake $0.20 
Board [9s 2h Td]
Seat 1: 6RiVTYll/5D8zICp0MRpKw folded before Flop (didn't bet)
Seat 2: VCKtuATyvAq9H2JSAQxPbA folded before Flop
Seat 3: aNpwfA31EREwO+ar4XzBCw folded before Flop (didn't bet)
Seat 4: RHqgdFvufLCYe54+qd2gcA (button) collected ($4.15)
Seat 5: 5hAPbqNrvJb8PtLiceXtlg6HoFYfVGBefsR5Vrz62qIwall blind) folded before Flop
Seat 6: 5n7e7I+px7c6CQmLpPbtsg (big blind) folded before Flop
Seat 7: yyG4svzOpC1A+sUP/scg6w folded on the Flop
Seat 8: VLIsy+xjx3olLSYO3JLS6g folded on the Flop
Seat 9: ljemhp25Zg+nlA9DLCIiUw folded before Flop (didn't bet)




PokerStars Game #59941894286:  Hold'em No Limit ($0.10/$0.25) - 2009/07/01 1:49:33 ET
Table 'axb9RsG8Zj1A0LEukTeFrQ' 9-max Seat #7 is the button
Seat 1: qwr38jl5txoR36M7G5qi4A ($8.50 in chips) 
Seat 2: zDrucyjVn5aeekNEc3cJrA ($21.40 in chips) 
Seat 3: H5Se03ZqSX7tbULXur2MAg ($25.05 in chips) 
Seat 4: tLcDklc2rBORNfixyRfVfw ($25 in chips) 
Seat 5: rLSSHKOHnb6yzVfDoQM/RA ($16.60 in chips) 
Seat 6: Iu9xjReQYvxYiqQm8n6MXQ ($4.25 in chips) 
Seat 7: PdIasPkzm2sqZnN41ZRXOg ($5 in chips) 
Seat 8: VBHxUExRAMrbxUq/cVx9Gw ($4.75 in chips) 
Seat 9: qbQE8CifKB4+OEvNF/61Rw ($57.70 in chips) 
VBHxUExRAMrbxUq/cVx9Gw: posts small blind $0.10
qbQE8CifKB4+OEvNF/61Rw: posts big blind $0.25
*** HOLE CARDS ***
qwr38jl5txoR36M7G5qi4A: folds 
zDrucyjVn5aeekNEc3cJrA: folds 
H5Se03ZqSX7tbULXur2MAg: folds 
tLcDklc2rBORNfixyRfVfw: raises $0.75 to $1
rLSSHKOHnb6yzVfDoQM/RA: folds 
Iu9xjReQYvxYiqQm8n6MXQ: folds 
PdIasPkzm2sqZnN41ZRXOg: folds 
VBHxUExRAMrbxUq/cVx9Gw: folds 
qbQE8CifKB4+OEvNF/61Rw: folds 
Uncalled bet ($0.75) returned to tLcDklc2rBORNfixyRfVfw
tLcDklc2rBORNfixyRfVfw collected $0.60 from pot
tLcDklc2rBORNfixyRfVfw: doesn't show hand 
*** SUMMARY ***
Total pot $0.60 | Rake $0 
Seat 1: qwr38jl5txoR36M7G5qi4A folded before Flop (didn't bet)
Seat 2: zDrucyjVn5aeekNEc3cJrA folded before Flop (didn't bet)
Seat 3: H5Se03ZqSX7tbULXur2MAg folded before Flop (didn't bet)
Seat 4: tLcDklc2rBORNfixyRfVfw collected ($0.60)
Seat 5: rLSSHKOHnb6yzVfDoQM/RA folded before Flop (didn't bet)
Seat 6: Iu9xjReQYvxYiqQm8n6MXQ folded before Flop (didn't bet)
Seat 7: PdIasPkzm2sqZnN41ZRXOg (button) folded before Flop (didn't bet)
Seat 8: VBHxUExRAMrbxUq/cVx9Gw (small blind) folded before Flop
Seat 9: qbQE8CifKB4+OEvNF/61Rw (big blind) folded before Flop




PokerStars Game #59941894974:  Hold'em No Limit ($0.10/$0.25) - 2009/07/01 1:49:34 ET
Table 'aisAlB9GIV21BwfUW3+Nbg' 9-max Seat #7 is the button
Seat 1: SqibpGx+lf+brY0fJVvD0w ($24.85 in chips) 
Seat 3: CvL9Ch1HYCVbTsfpNucitg ($4.55 in chips) 
Seat 4: sD+TKtt36XiiN6jqHiLwDA ($25 in chips) 
Seat 5: ghNKXUBl/H+t83JF079ZBA ($27.40 in chips) 
Seat 6: 9gmYYQesalMrUjaF7nKfrQ ($15.85 in chips) 
Seat 7: jGjM+5lCSe6f2MEwxQGOAg ($22.50 in chips) 
Seat 8: VWUWpMLMj/Q1jRVpF7Aohw ($26.05 in chips) 
Seat 9: N0hGpTAEAj9k5msS6LPLAw ($20.60 in chips) 
VWUWpMLMj/Q1jRVpF7Aohw: posts small blind $0.10
N0hGpTAEAj9k5msS6LPLAw: posts big blind $0.25
*** HOLE CARDS ***
SqibpGx+lf+brY0fJVvD0w: folds 
CvL9Ch1HYCVbTsfpNucitg: folds 
sD+TKtt36XiiN6jqHiLwDA: calls $0.25
ghNKXUBl/H+t83JF079ZBA: folds 
9gmYYQesalMrUjaF7nKfrQ: folds 
jGjM+5lCSe6f2MEwxQGOAg: raises $0.25 to $0.50
VWUWpMLMj/Q1jRVpF7Aohw: folds 
N0hGpTAEAj9k5msS6LPLAw: folds 
sD+TKtt36XiiN6jqHiLwDA: calls $0.25
*** FLOP *** [8c 3c Js]
sD+TKtt36XiiN6jqHiLwDA: checks 
jGjM+5lCSe6f2MEwxQGOAg: bets $0.75
sD+TKtt36XiiN6jqHiLwDA: calls $0.75
*** TURN *** [8c 3c Js] [6s]
Z9AeOQX3yzuSvKAm/xyovg leaves the table
sD+TKtt36XiiN6jqHiLwDA: checks 
jGjM+5lCSe6f2MEwxQGOAg: checks 
*** RIVER *** [8c 3c Js 6s] [6h]
sD+TKtt36XiiN6jqHiLwDA: checks 
zgi+EUykT/pZQpoUG6+oEg joins the table at seat #2 
jGjM+5lCSe6f2MEwxQGOAg: checks 
*** SHOW DOWN ***
sD+TKtt36XiiN6jqHiLwDA: shows [Ac 2c] (a pair of Sixes)
jGjM+5lCSe6f2MEwxQGOAg: mucks hand 
sD+TKtt36XiiN6jqHiLwDA collected $2.75 from pot
*** SUMMARY ***
Total pot $2.85 | Rake $0.10 
Board [8c 3c Js 6s 6h]
Seat 1: SqibpGx+lf+brY0fJVvD0w folded before Flop (didn't bet)
Seat 3: CvL9Ch1HYCVbTsfpNucitg folded before Flop (didn't bet)
Seat 4: sD+TKtt36XiiN6jqHiLwDA showed [Ac 2c] and won ($2.75) with a pair of Sixes
Seat 5: ghNKXUBl/H+t83JF079ZBA folded before Flop (didn't bet)
Seat 6: 9gmYYQesalMrUjaF7nKfrQ folded before Flop (didn't bet)
Seat 7: jGjM+5lCSe6f2MEwxQGOAg (button) mucked
Seat 8: VWUWpMLMj/Q1jRVpF7Aohw (small blind) folded before Flop
Seat 9: N0hGpTAEAj9k5msS6LPLAw (big blind) folded before Flop




PokerStars Game #59941894984:  Hold'em No Limit ($0.10/$0.25) - 2009/07/01 1:49:34 ET
Table 'Ez9TB43XM4QgMDQkIW9DYw' 9-max Seat #4 is the button
Seat 1: ShCS62CJp4MKfKLKvGKQbA ($9.95 in chips) 
Seat 2: PFNLAvMkr8qKc7xCiH0wTA ($17 in chips) 
Seat 3: PdIasPkzm2sqZnN41ZRXOg ($5 in chips) 
Seat 4: ubsjZomMWSV0hAiBLa7K1A ($20.45 in chips) 
Seat 6: 76o85YBHJ9veRYp2LPuluQ ($19.05 in chips) 
Seat 7: Bb42QRQMhg5/Y0vHP8/2Xw ($55.95 in chips) 
Seat 8: +2kMBNpY4nF1qNCRd8SJLA ($28.75 in chips) 
Seat 9: QEbIGci+itdw+re8RM5fZA ($25 in chips) 
18G4P1XstjNvItdGUITxgw will be allowed to play after the button
76o85YBHJ9veRYp2LPuluQ: posts small blind $0.10
Bb42QRQMhg5/Y0vHP8/2Xw: posts big blind $0.25
*** HOLE CARDS ***
+2kMBNpY4nF1qNCRd8SJLA: folds 
QEbIGci+itdw+re8RM5fZA: folds 
ShCS62CJp4MKfKLKvGKQbA: raises $0.75 to $1
PFNLAvMkr8qKc7xCiH0wTA: folds 
PdIasPkzm2sqZnN41ZRXOg: folds 
ubsjZomMWSV0hAiBLa7K1A: folds 
76o85YBHJ9veRYp2LPuluQ: calls $0.90
Bb42QRQMhg5/Y0vHP8/2Xw: folds 
*** FLOP *** [3h Qc Qs]
76o85YBHJ9veRYp2LPuluQ: checks 
ShCS62CJp4MKfKLKvGKQbA: checks 
*** TURN *** [3h Qc Qs] [Js]
76o85YBHJ9veRYp2LPuluQ: checks 
ShCS62CJp4MKfKLKvGKQbA: checks 
*** RIVER *** [3h Qc Qs Js] [3d]
76o85YBHJ9veRYp2LPuluQ: bets $0.50
ShCS62CJp4MKfKLKvGKQbA: calls $0.50
*** SHOW DOWN ***
76o85YBHJ9veRYp2LPuluQ: shows [8d 8h] (two pair, Queens and Eights)
ShCS62CJp4MKfKLKvGKQbA: shows [Kh Kd] (two pair, Kings and Queens)
ShCS62CJp4MKfKLKvGKQbA collected $3.10 from pot
*** SUMMARY ***
Total pot $3.25 | Rake $0.15 
Board [3h Qc Qs Js 3d]
Seat 1: ShCS62CJp4MKfKLKvGKQbA showed [Kh Kd] and won ($3.10) with two pair, Kings and Queens
Seat 2: PFNLAvMkr8qKc7xCiH0wTA folded before Flop (didn't bet)
Seat 3: PdIasPkzm2sqZnN41ZRXOg folded before Flop (didn't bet)
Seat 4: ubsjZomMWSV0hAiBLa7K1A (button) folded before Flop (didn't bet)
Seat 6: 76o85YBHJ9veRYp2LPuluQ (small blind) showed [8d 8h] and lost with two pair, Queens and Eights
Seat 7: Bb42QRQMhg5/Y0vHP8/2Xw (big blind) folded before Flop
Seat 8: +2kMBNpY4nF1qNCRd8SJLA folded before Flop (didn't bet)
Seat 9: QEbIGci+itdw+re8RM5fZA folded before Flop (didn't bet)




PokerStars Game #59941894944:  Hold'em No Limit ($0.10/$0.25) - 2009/07/01 1:49:34 ET
Table '+fuYjvJy9okLr23QyZtanA' 9-max Seat #7 is the button
Seat 2: tLcDklc2rBORNfixyRfVfw ($25 in chips) 
Seat 3: eK8qa6EPcH2zhtbmWSvc9g ($52.30 in chips) 
Seat 4: Bb42QRQMhg5/Y0vHP8/2Xw ($30.15 in chips) 
Seat 5: bXpVeaSTPBFSPJmeXxO7nw ($4.30 in chips) 
Seat 6: wGigCmBR/9XWkPpvYos3aQ ($29.80 in chips) 
Seat 7: dfNim92Z6XK1/h5SFW5vDg ($37.50 in chips) 
Seat 8: KqS/lY/fNB9qUxokm9QfeA ($9.70 in chips) 
Seat 9: OMhlmt2waO3z43ZSFNMmog ($29.95 in chips) 
KqS/lY/fNB9qUxokm9QfeA: posts small blind $0.10
OMhlmt2waO3z43ZSFNMmog: posts big blind $0.25
*** HOLE CARDS ***
tLcDklc2rBORNfixyRfVfw: folds 
eK8qa6EPcH2zhtbmWSvc9g: folds 
Bb42QRQMhg5/Y0vHP8/2Xw: raises $0.75 to $1
bXpVeaSTPBFSPJmeXxO7nw: folds 
wGigCmBR/9XWkPpvYos3aQ: folds 
dfNim92Z6XK1/h5SFW5vDg: calls $1
KqS/lY/fNB9qUxokm9QfeA: calls $0.90
OMhlmt2waO3z43ZSFNMmog: folds 
*** FLOP *** [Td Jc 3h]
KqS/lY/fNB9qUxokm9QfeA: checks 
Bb42QRQMhg5/Y0vHP8/2Xw: bets $1.75
dfNim92Z6XK1/h5SFW5vDg: folds 
KqS/lY/fNB9qUxokm9QfeA: folds 
Uncalled bet ($1.75) returned to Bb42QRQMhg5/Y0vHP8/2Xw
Bb42QRQMhg5/Y0vHP8/2Xw collected $3.10 from pot
*** SUMMARY ***
Total pot $3.25 | Rake $0.15 
Board [Td Jc 3h]
Seat 2: tLcDklc2rBORNfixyRfVfw folded before Flop (didn't bet)
Seat 3: eK8qa6EPcH2zhtbmWSvc9g folded before Flop (didn't bet)
Seat 4: Bb42QRQMhg5/Y0vHP8/2Xw collected ($3.10)
Seat 5: bXpVeaSTPBFSPJmeXxO7nw folded before Flop (didn't bet)
Seat 6: wGigCmBR/9XWkPpvYos3aQ folded before Flop (didn't bet)
Seat 7: dfNim92Z6XK1/h5SFW5vDg (button) folded on the Flop
Seat 8: KqS/lY/fNB9qUxokm9QfeA (small blind) folded on the Flop
Seat 9: OMhlmt2waO3z43ZSFNMmog (big blind) folded before Flop




PokerStars Game #59941894760:  Hold'em No Limit ($0.10/$0.25) - 2009/07/01 1:49:34 ET
Table 'Loy/olZ5qoDOSvX4UTujGg' 6-max Seat #1 is the button
Seat 1: HipgaJhkN4ie/tTw4dK3Ug ($9.85 in chips) 
Seat 2: 4z7mPbMLNp4TezHXin63Vw ($14.55 in chips) 
Seat 3: 32YL2ZEp8NT4JB2RVM9euQ ($15.35 in chips) 
Seat 4: /gJNBeCkWL4o85/jvlZ4BA ($30.75 in chips) 
Seat 5: Ar4vsUIUfJ7gbYh1c1m59g ($19.25 in chips) 
Seat 6: qGHGf/553gQnDoklMRe3tg ($24.80 in chips) 
4z7mPbMLNp4TezHXin63Vw: posts small blind $0.10
32YL2ZEp8NT4JB2RVM9euQ: posts big blind $0.25
*** HOLE CARDS ***
/gJNBeCkWL4o85/jvlZ4BA: folds 
Ar4vsUIUfJ7gbYh1c1m59g: folds 
qGHGf/553gQnDoklMRe3tg: raises $0.75 to $1
HipgaJhkN4ie/tTw4dK3Ug: folds 
4z7mPbMLNp4TezHXin63Vw: folds 
32YL2ZEp8NT4JB2RVM9euQ: folds 
Uncalled bet ($0.75) returned to qGHGf/553gQnDoklMRe3tg
qGHGf/553gQnDoklMRe3tg collected $0.60 from pot
*** SUMMARY ***
Total pot $0.60 | Rake $0 
Seat 1: HipgaJhkN4ie/tTw4dK3Ug (button) folded before Flop (didn't bet)
Seat 2: 4z7mPbMLNp4TezHXin63Vw (small blind) folded before Flop
Seat 3: 32YL2ZEp8NT4JB2RVM9euQ (big blind) folded before Flop
Seat 4: /gJNBeCkWL4o85/jvlZ4BA folded before Flop (didn't bet)
Seat 5: Ar4vsUIUfJ7gbYh1c1m59g folded before Flop (didn't bet)
Seat 6: qGHGf/553gQnDoklMRe3tg collected ($0.60)




PokerStars Game #59941895100:  Hold'em No Limit ($0.10/$0.25) - 2009/07/01 1:49:34 ET
Table 'oZuNsbNJuUyQLGKzQ/4JFg' 6-max Seat #5 is the button
Seat 1: vqWjZmdQu/Hxw96/IJTWdQ ($25 in chips) 
Seat 2: UA5OsKS3VPaxa7uC8La/kA ($35.40 in chips) 
Seat 3: 8ClCHtFXGNplITm+63KB+Q ($49.65 in chips) 
Seat 4: 9bpVv1/Qh9IYtXuCtl5VtQ ($31.20 in chips) 
Seat 5: oBUDUfeUyCbZBsjxHZgSiw ($22.70 in chips) 
Seat 6: fwg6dK1+r4jy/y+JqenYYQ ($12.55 in chips) 
fwg6dK1+r4jy/y+JqenYYQ: posts small blind $0.10
vqWjZmdQu/Hxw96/IJTWdQ: posts big blind $0.25
*** HOLE CARDS ***
UA5OsKS3VPaxa7uC8La/kA: folds 
8ClCHtFXGNplITm+63KB+Q: raises $0.75 to $1
9bpVv1/Qh9IYtXuCtl5VtQ: folds 
oBUDUfeUyCbZBsjxHZgSiw has timed out
oBUDUfeUyCbZBsjxHZgSiw: folds 
oBUDUfeUyCbZBsjxHZgSiw is sitting out
fwg6dK1+r4jy/y+JqenYYQ: folds 
vqWjZmdQu/Hxw96/IJTWdQ: calls $0.75
*** FLOP *** [2h 4c Kd]
vqWjZmdQu/Hxw96/IJTWdQ: checks 
oBUDUfeUyCbZBsjxHZgSiw has returned
8ClCHtFXGNplITm+63KB+Q: bets $1.50
vqWjZmdQu/Hxw96/IJTWdQ: folds 
Uncalled bet ($1.50) returned to 8ClCHtFXGNplITm+63KB+Q
8ClCHtFXGNplITm+63KB+Q collected $2 from pot
8ClCHtFXGNplITm+63KB+Q: doesn't show hand 
*** SUMMARY ***
Total pot $2.10 | Rake $0.10 
Board [2h 4c Kd]
Seat 1: vqWjZmdQu/Hxw96/IJTWdQ (big blind) folded on the Flop
Seat 2: UA5OsKS3VPaxa7uC8La/kA folded before Flop (didn't bet)
Seat 3: 8ClCHtFXGNplITm+63KB+Q collected ($2)
Seat 4: 9bpVv1/Qh9IYtXuCtl5VtQ folded before Flop (didn't bet)
Seat 5: oBUDUfeUyCbZBsjxHZgSiw (button) folded before Flop (didn't bet)
Seat 6: fwg6dK1+r4jy/y+JqenYYQ (small blind) folded before Flop




PokerStars Game #59941894942:  Hold'em No Limit ($0.10/$0.25) - 2009/07/01 1:49:34 ET
Table 'g6ryG70feTw9nNm+XJLuXw' 6-max Seat #1 is the button
Seat 1: v+QfkGiuj9bgtuNoVnDO8w ($34.75 in chips) 
Seat 2: SxIIgwXYLkwd6m3wLyPTCw ($33.65 in chips) 
Seat 3: cezpHJ8FB07dj0xG+LhOvw ($25.35 in chips) 
Seat 4: GC/9yVD59DUCX7hUI7gcLw ($45 in chips) 
Seat 5: EE16Ua5b1HSsYej5zeXOlA ($25 in chips) 
Seat 6: Mhj3q7cxev+XjXZxEE6/Cw ($25.70 in chips) 
SxIIgwXYLkwd6m3wLyPTCw: posts small blind $0.10
cezpHJ8FB07dj0xG+LhOvw: posts big blind $0.25
*** HOLE CARDS ***
GC/9yVD59DUCX7hUI7gcLw: folds 
EE16Ua5b1HSsYej5zeXOlA: folds 
Mhj3q7cxev+XjXZxEE6/Cw: folds 
v+QfkGiuj9bgtuNoVnDO8w: folds 
SxIIgwXYLkwd6m3wLyPTCw: raises $0.75 to $1
cezpHJ8FB07dj0xG+LhOvw: folds 
Uncalled bet ($0.75) returned to SxIIgwXYLkwd6m3wLyPTCw
SxIIgwXYLkwd6m3wLyPTCw collected $0.50 from pot
SxIIgwXYLkwd6m3wLyPTCw: doesn't show hand 
*** SUMMARY ***
Total pot $0.50 | Rake $0 
Seat 1: v+QfkGiuj9bgtuNoVnDO8w (button) folded before Flop (didn't bet)
Seat 2: SxIIgwXYLkwd6m3wLyPTCw (small blind) collected ($0.50)
Seat 3: cezpHJ8FB07dj0xG+LhOvw (big blind) folded before Flop
Seat 4: GC/9yVD59DUCX7hUI7gcLw folded before Flop (didn't bet)
Seat 5: EE16Ua5b1HSsYej5zeXOlA folded before Flop (didn't bet)
Seat 6: Mhj3q7cxev+XjXZxEE6/Cw folded before Flop (didn't bet)




PokerStars Game #59941894802:  Hold'em No Limit ($0.10/$0.25) - 2009/07/01 1:49:34 ET
Table 'VQNfcI8vTBCTvRfd3veTLQ' 6-max Seat #2 is the button
Seat 1: QiL+lEgEWwy21jk/ltaRLg ($13.50 in chips) 
Seat 2: 79ID/ub1Pt/mDpCprVmOoA ($31.25 in chips) 
Seat 3: LtASJ9OlkqGrrUKGQlpGAw ($11.35 in chips) 
Seat 4: QIWnfLSqfMcoFfdDe5LZPg ($40.10 in chips) 
Seat 5: gX2vbKwS/8zZPENAWB7hxQ ($25.90 in chips) 
Seat 6: LJI7A1YgDM7hgh7o56+ReQ ($27.35 in chips) 
LtASJ9OlkqGrrUKGQlpGAw: posts small blind $0.10
QIWnfLSqfMcoFfdDe5LZPg: posts big blind $0.25
*** HOLE CARDS ***
gX2vbKwS/8zZPENAWB7hxQ: folds 
LJI7A1YgDM7hgh7o56+ReQ: raises $0.75 to $1
QiL+lEgEWwy21jk/ltaRLg: folds 
79ID/ub1Pt/mDpCprVmOoA: folds 
LtASJ9OlkqGrrUKGQlpGAw: folds 
QIWnfLSqfMcoFfdDe5LZPg: folds 
Uncalled bet ($0.75) returned to LJI7A1YgDM7hgh7o56+ReQ
LJI7A1YgDM7hgh7o56+ReQ collected $0.60 from pot
LJI7A1YgDM7hgh7o56+ReQ: doesn't show hand 
*** SUMMARY ***
Total pot $0.60 | Rake $0 
Seat 1: QiL+lEgEWwy21jk/ltaRLg folded before Flop (didn't bet)
Seat 2: 79ID/ub1Pt/mDpCprVmOoA (button) folded before Flop (didn't bet)
Seat 3: LtASJ9OlkqGrrUKGQlpGAw (small blind) folded before Flop
Seat 4: QIWnfLSqfMcoFfdDe5LZPg (big blind) folded before Flop
Seat 5: gX2vbKwS/8zZPENAWB7hxQ folded before Flop (didn't bet)
Seat 6: LJI7A1YgDM7hgh7o56+ReQ collected ($0.60)




PokerStars Game #59941895096:  Hold'em No Limit ($0.10/$0.25) - 2009/07/01 1:49:34 ET
Table 'rtxA1Y01Nrq5VoyzTAuusQ' 9-max Seat #2 is the button
Seat 1: w1ukf8uPa4+WH561TtVRxA ($26.55 in chips) 
Seat 2: Th3FldXKQW6hWVVPahaoOQ ($25 in chips) 
Seat 3: K9fS1IUr5GpiJG7VkJ7IbA ($5.80 in chips) 
Seat 4: RHqgdFvufLCYe54+qd2gcA ($5 in chips) 
Seat 5: MtVtHDqIJTyUcXkRBBDIVA ($32.40 in chips) 
Seat 8: DnDcAdn9P0zGovMERigpFA ($25 in chips) 
Seat 9: HPEB+AtKw1+C/cxU0o1ciw ($22.35 in chips) 
K9fS1IUr5GpiJG7VkJ7IbA: posts small blind $0.10
RHqgdFvufLCYe54+qd2gcA: posts big blind $0.25
W6tExOcYX7qiy6Qdp+ZwFA: sits out 
*** HOLE CARDS ***
MtVtHDqIJTyUcXkRBBDIVA: folds 
DnDcAdn9P0zGovMERigpFA: folds 
HPEB+AtKw1+C/cxU0o1ciw: folds 
w1ukf8uPa4+WH561TtVRxA: folds 
Th3FldXKQW6hWVVPahaoOQ: raises $0.50 to $0.75
K9fS1IUr5GpiJG7VkJ7IbA: calls $0.65
RHqgdFvufLCYe54+qd2gcA: folds 
*** FLOP *** [9h 3d Qs]
K9fS1IUr5GpiJG7VkJ7IbA: bets $0.50
Th3FldXKQW6hWVVPahaoOQ: raises $1 to $1.50
K9fS1IUr5GpiJG7VkJ7IbA: calls $1
*** TURN *** [9h 3d Qs] [5c]
K9fS1IUr5GpiJG7VkJ7IbA: bets $1.25
Th3FldXKQW6hWVVPahaoOQ: folds 
Uncalled bet ($1.25) returned to K9fS1IUr5GpiJG7VkJ7IbA
K9fS1IUr5GpiJG7VkJ7IbA collected $4.55 from pot
*** SUMMARY ***
Total pot $4.75 | Rake $0.20 
Board [9h 3d Qs 5c]
Seat 1: w1ukf8uPa4+WH561TtVRxA folded before Flop (didn't bet)
Seat 2: Th3FldXKQW6hWVVPahaoOQ (button) folded on the Turn
Seat 3: K9fS1IUr5GpiJG7VkJ7IbA (small blind) collected ($4.55)
Seat 4: RHqgdFvufLCYe54+qd2gcA (big blind) folded before Flop
Seat 5: MtVtHDqIJTyUcXkRBBDIVA folded before Flop (didn't bet)
Seat 8: DnDcAdn9P0zGovMERigpFA folded before Flop (didn't bet)
Seat 9: HPEB+AtKw1+C/cxU0o1ciw folded before Flop (didn't bet)




PokerStars Game #59941895490:  Hold'em No Limit ($0.10/$0.25) - 2009/07/01 1:49:35 ET
Table 'jxoHy9yJy0bbH/Qx73FoPA' 9-max Seat #4 is the button
Seat 1: j4q3p0lesp63b1gZDwLBZw ($6.60 in chips) 
Seat 2: F7pnn6czNpHvRM55XcA2EA ($45.50 in chips) 
Seat 3: CVqCt93Mk0MhKMaZ4LZDSQ ($9.30 in chips) 
Seat 4: bXpVeaSTPBFSPJmeXxO7nw ($4.65 in chips) 
Seat 7: wGigCmBR/9XWkPpvYos3aQ ($26.15 in chips) 
Seat 8: Z9W7+g1WMhhZDi7DwGbCFA ($5 in chips) 
Seat 9: CvL9Ch1HYCVbTsfpNucitg ($4.90 in chips) 
wGigCmBR/9XWkPpvYos3aQ: posts small blind $0.10
Z9W7+g1WMhhZDi7DwGbCFA: posts big blind $0.25
*** HOLE CARDS ***
CvL9Ch1HYCVbTsfpNucitg: folds 
aintblinkin joins the table at seat #6 
j4q3p0lesp63b1gZDwLBZw: raises $0.75 to $1
F7pnn6czNpHvRM55XcA2EA: folds 
CVqCt93Mk0MhKMaZ4LZDSQ: folds 
maracudja joins the table at seat #5 
aintblinkin leaves the table
bXpVeaSTPBFSPJmeXxO7nw: folds 
wGigCmBR/9XWkPpvYos3aQ: folds 
Z9W7+g1WMhhZDi7DwGbCFA: folds 
Uncalled bet ($0.75) returned to j4q3p0lesp63b1gZDwLBZw
j4q3p0lesp63b1gZDwLBZw collected $0.60 from pot
j4q3p0lesp63b1gZDwLBZw: doesn't show hand 
*** SUMMARY ***
Total pot $0.60 | Rake $0 
Seat 1: j4q3p0lesp63b1gZDwLBZw collected ($0.60)
Seat 2: F7pnn6czNpHvRM55XcA2EA folded before Flop (didn't bet)
Seat 3: CVqCt93Mk0MhKMaZ4LZDSQ folded before Flop (didn't bet)
Seat 4: bXpVeaSTPBFSPJmeXxO7nw (button) folded before Flop (didn't bet)
Seat 7: wGigCmBR/9XWkPpvYos3aQ (small blind) folded before Flop
Seat 8: Z9W7+g1WMhhZDi7DwGbCFA (big blind) folded before Flop
Seat 9: CvL9Ch1HYCVbTsfpNucitg folded before Flop (didn't bet)




PokerStars Game #59941895736:  Hold'em No Limit ($0.10/$0.25) - 2009/07/01 1:49:35 ET
Table 'Qk/910N2Yhg8u5vqTJk50Q' 9-max Seat #7 is the button
Seat 2: Th3FldXKQW6hWVVPahaoOQ ($45.05 in chips) 
Seat 3: ghNKXUBl/H+t83JF079ZBA ($25.65 in chips) 
Seat 4: hYvTc4PYNrAaNAIVoM94Hw ($4.75 in chips) 
Seat 5: zReBEigsxqZnag0RZAgpgA ($13.50 in chips) 
Seat 6: U41wNf6XauAiBOQaKu2ZIA ($10 in chips) 
Seat 7: aNpwfA31EREwO+ar4XzBCw ($26.85 in chips) 
Seat 9: M2QO2DxB5Wawg2h8HSpnYA ($17.45 in chips) 
5pDhXQ+RVy0BGcwfJAJfbg will be allowed to play after the button
M2QO2DxB5Wawg2h8HSpnYA: posts small blind $0.10
Th3FldXKQW6hWVVPahaoOQ: posts big blind $0.25
U41wNf6XauAiBOQaKu2ZIA: posts big blind $0.25
*** HOLE CARDS ***
ghNKXUBl/H+t83JF079ZBA: folds 
hYvTc4PYNrAaNAIVoM94Hw: folds 
zDrucyjVn5aeekNEc3cJrA has returned
zReBEigsxqZnag0RZAgpgA: calls $0.25
U41wNf6XauAiBOQaKu2ZIA: checks 
aNpwfA31EREwO+ar4XzBCw: folds 
M2QO2DxB5Wawg2h8HSpnYA: folds 
Th3FldXKQW6hWVVPahaoOQ: checks 
*** FLOP *** [Ks 4c Qh]
Th3FldXKQW6hWVVPahaoOQ: checks 
zReBEigsxqZnag0RZAgpgA: checks 
U41wNf6XauAiBOQaKu2ZIA: checks 
*** TURN *** [Ks 4c Qh] [Jh]
Th3FldXKQW6hWVVPahaoOQ: checks 
zReBEigsxqZnag0RZAgpgA: bets $0.50
U41wNf6XauAiBOQaKu2ZIA: folds 
Th3FldXKQW6hWVVPahaoOQ: folds 
Uncalled bet ($0.50) returned to zReBEigsxqZnag0RZAgpgA
zReBEigsxqZnag0RZAgpgA collected $0.85 from pot
*** SUMMARY ***
Total pot $0.85 | Rake $0 
Board [Ks 4c Qh Jh]
Seat 2: Th3FldXKQW6hWVVPahaoOQ (big blind) folded on the Turn
Seat 3: ghNKXUBl/H+t83JF079ZBA folded before Flop (didn't bet)
Seat 4: hYvTc4PYNrAaNAIVoM94Hw folded before Flop (didn't bet)
Seat 5: zReBEigsxqZnag0RZAgpgA collected ($0.85)
Seat 6: U41wNf6XauAiBOQaKu2ZIA folded on the Turn
Seat 7: aNpwfA31EREwO+ar4XzBCw (button) folded before Flop (didn't bet)
Seat 9: M2QO2DxB5Wawg2h8HSpnYA (small blind) folded before Flop




PokerStars Game #59941895412:  Hold'em No Limit ($0.10/$0.25) - 2009/07/01 1:49:35 ET
Table 'sCop8wmj9zlSS2KJqk1QKQ' 9-max Seat #1 is the button
Seat 1: dtZ84flFEi4Q+SGrHMJRDQ ($39.85 in chips) 
Seat 2: YZaC69gFrepA6oCGtu7E0w ($41.60 in chips) 
Seat 3: M/9j4wkHH9i1JM51vgi1VA ($24.60 in chips) 
Seat 4: msUzkZl2RntUnTl6E8WaNA ($15.65 in chips) 
Seat 5: RHqgdFvufLCYe54+qd2gcA ($8.95 in chips) 
Seat 8: xnVwSkROfRtOw4eSoDANtw ($19.55 in chips) 
Seat 9: tLcDklc2rBORNfixyRfVfw ($25 in chips) 
YZaC69gFrepA6oCGtu7E0w: posts small blind $0.10
M/9j4wkHH9i1JM51vgi1VA: posts big blind $0.25
6RiVTYll/5D8zICp0MRpKw: sits out 
18G4P1XstjNvItdGUITxgw: sits out 
*** HOLE CARDS ***
msUzkZl2RntUnTl6E8WaNA: folds 
RHqgdFvufLCYe54+qd2gcA: calls $0.25
xnVwSkROfRtOw4eSoDANtw: folds 
tLcDklc2rBORNfixyRfVfw: folds 
dtZ84flFEi4Q+SGrHMJRDQ: folds 
YZaC69gFrepA6oCGtu7E0w: calls $0.15
M/9j4wkHH9i1JM51vgi1VA: checks 
*** FLOP *** [8c 4h 9s]
YZaC69gFrepA6oCGtu7E0w: checks 
M/9j4wkHH9i1JM51vgi1VA: checks 
RHqgdFvufLCYe54+qd2gcA: checks 
*** TURN *** [8c 4h 9s] [4s]
YZaC69gFrepA6oCGtu7E0w: checks 
M/9j4wkHH9i1JM51vgi1VA: checks 
RHqgdFvufLCYe54+qd2gcA: checks 
*** RIVER *** [8c 4h 9s 4s] [Jd]
YZaC69gFrepA6oCGtu7E0w: bets $0.25
M/9j4wkHH9i1JM51vgi1VA: calls $0.25
RHqgdFvufLCYe54+qd2gcA: folds 
*** SHOW DOWN ***
YZaC69gFrepA6oCGtu7E0w: shows [Ac Th] (a pair of Fours)
M/9j4wkHH9i1JM51vgi1VA: shows [Js 3s] (two pair, Jacks and Fours)
M/9j4wkHH9i1JM51vgi1VA collected $1.20 from pot
*** SUMMARY ***
Total pot $1.25 | Rake $0.05 
Board [8c 4h 9s 4s Jd]
Seat 1: dtZ84flFEi4Q+SGrHMJRDQ (button) folded before Flop (didn't bet)
Seat 2: YZaC69gFrepA6oCGtu7E0w (small blind) showed [Ac Th] and lost with a pair of Fours
Seat 3: M/9j4wkHH9i1JM51vgi1VA (big blind) showed [Js 3s] and won ($1.20) with two pair, Jacks and Fours
Seat 4: msUzkZl2RntUnTl6E8WaNA folded before Flop (didn't bet)
Seat 5: RHqgdFvufLCYe54+qd2gcA folded on the River
Seat 8: xnVwSkROfRtOw4eSoDANtw folded before Flop (didn't bet)
Seat 9: tLcDklc2rBORNfixyRfVfw folded before Flop (didn't bet)




PokerStars Game #59941895686:  Hold'em No Limit ($0.10/$0.25) - 2009/07/01 1:49:35 ET
Table 'sDHjMRwfSiz7+NDdZLUiyA' 9-max Seat #9 is the button
Seat 1: VGwr1eqhvdUtMfBFCvBnmg ($12.15 in chips) 
Seat 2: ljemhp25Zg+nlA9DLCIiUw ($25.45 in chips) 
Seat 3: SGA1WpAnQxFdFAYyt362gQ ($18.05 in chips) 
Seat 4: eK8qa6EPcH2zhtbmWSvc9g ($25.80 in chips) 
Seat 5: IGRfskE1v9H9Bn+fz8AgNQ ($36.10 in chips) 
Seat 6: 1qa0qHOCKZM3Uipx9DxYtQ ($15.80 in chips) 
Seat 7: K0b5wNInj6hUGRr6yzKFtw ($37.30 in chips) 
Seat 9: 3PmVnC/15cl4oyI1TKIt4g ($4.50 in chips) 
VGwr1eqhvdUtMfBFCvBnmg: posts small blind $0.10
ljemhp25Zg+nlA9DLCIiUw: posts big blind $0.25
*** HOLE CARDS ***
SGA1WpAnQxFdFAYyt362gQ: folds 
eK8qa6EPcH2zhtbmWSvc9g: folds 
IGRfskE1v9H9Bn+fz8AgNQ: folds 
1qa0qHOCKZM3Uipx9DxYtQ: raises $0.25 to $0.50
K0b5wNInj6hUGRr6yzKFtw: folds 
3PmVnC/15cl4oyI1TKIt4g: folds 
VGwr1eqhvdUtMfBFCvBnmg: folds 
ljemhp25Zg+nlA9DLCIiUw: calls $0.25
*** FLOP *** [Jc Th Jd]
ljemhp25Zg+nlA9DLCIiUw: checks 
1qa0qHOCKZM3Uipx9DxYtQ: bets $0.50
ljemhp25Zg+nlA9DLCIiUw: folds 
Uncalled bet ($0.50) returned to 1qa0qHOCKZM3Uipx9DxYtQ
1qa0qHOCKZM3Uipx9DxYtQ collected $1.05 from pot
1qa0qHOCKZM3Uipx9DxYtQ: doesn't show hand 
*** SUMMARY ***
Total pot $1.10 | Rake $0.05 
Board [Jc Th Jd]
Seat 1: VGwr1eqhvdUtMfBFCvBnmg (small blind) folded before Flop
Seat 2: ljemhp25Zg+nlA9DLCIiUw (big blind) folded on the Flop
Seat 3: SGA1WpAnQxFdFAYyt362gQ folded before Flop (didn't bet)
Seat 4: eK8qa6EPcH2zhtbmWSvc9g folded before Flop (didn't bet)
Seat 5: IGRfskE1v9H9Bn+fz8AgNQ folded before Flop (didn't bet)
Seat 6: 1qa0qHOCKZM3Uipx9DxYtQ collected ($1.05)
Seat 7: K0b5wNInj6hUGRr6yzKFtw folded before Flop (didn't bet)
Seat 9: 3PmVnC/15cl4oyI1TKIt4g (button) folded before Flop (didn't bet)




PokerStars Game #59941895262:  Hold'em No Limit ($0.10/$0.25) - 2009/07/01 1:49:35 ET
Table '5SUMWYuPsGiOD0FY0QbgOw' 6-max Seat #5 is the button
Seat 1: SFmT9ZsVopnukjvAzrxTRg ($25 in chips) 
Seat 2: xrf8tAXKQHG99HixCot1Iw ($39 in chips) 
Seat 4: BV+K0Phf5VBHr7aZPKqbUQ ($26.10 in chips) 
Seat 5: v+QfkGiuj9bgtuNoVnDO8w ($40.45 in chips) 
Seat 6: jA7YMtfNUnAaebB7Lj74EA ($22.55 in chips) 
jA7YMtfNUnAaebB7Lj74EA: posts small blind $0.10
SFmT9ZsVopnukjvAzrxTRg: posts big blind $0.25
*** HOLE CARDS ***
xrf8tAXKQHG99HixCot1Iw: folds 
BV+K0Phf5VBHr7aZPKqbUQ: folds 
v+QfkGiuj9bgtuNoVnDO8w: folds 
jA7YMtfNUnAaebB7Lj74EA: calls $0.15
SFmT9ZsVopnukjvAzrxTRg: checks 
*** FLOP *** [9d 9h Js]
i9LqF5rD3bvtbEE7HWgr3Q joins the table at seat #3 
jA7YMtfNUnAaebB7Lj74EA: checks 
SFmT9ZsVopnukjvAzrxTRg: checks 
*** TURN *** [9d 9h Js] [Jc]
jA7YMtfNUnAaebB7Lj74EA: checks 
SFmT9ZsVopnukjvAzrxTRg: checks 
*** RIVER *** [9d 9h Js Jc] [5d]
jA7YMtfNUnAaebB7Lj74EA: checks 
SFmT9ZsVopnukjvAzrxTRg: checks 
*** SHOW DOWN ***
jA7YMtfNUnAaebB7Lj74EA: shows [Kh 4s] (two pair, Jacks and Nines)
SFmT9ZsVopnukjvAzrxTRg: mucks hand 
jA7YMtfNUnAaebB7Lj74EA collected $0.50 from pot
*** SUMMARY ***
Total pot $0.50 | Rake $0 
Board [9d 9h Js Jc 5d]
Seat 1: SFmT9ZsVopnukjvAzrxTRg (big blind) mucked
Seat 2: xrf8tAXKQHG99HixCot1Iw folded before Flop (didn't bet)
Seat 4: BV+K0Phf5VBHr7aZPKqbUQ folded before Flop (didn't bet)
Seat 5: v+QfkGiuj9bgtuNoVnDO8w (button) folded before Flop (didn't bet)
Seat 6: jA7YMtfNUnAaebB7Lj74EA (small blind) showed [Kh 4s] and won ($0.50) with two pair, Jacks and Nines




PokerStars Game #59941895378:  Hold'em No Limit ($0.10/$0.25) - 2009/07/01 1:49:35 ET
Table 'xro+BVoe2Zuw1TYmz/McJQ' 9-max Seat #6 is the button
Seat 3: xUw+6BIJCkgxBKESwlj9Hg ($4 in chips) 
Seat 4: N2LVj3iImgnOoHVf8g0rIw ($43.05 in chips) 
Seat 5: H7ijH+qgNcEQW9eBvivIYg ($15 in chips) 
Seat 6: HPEB+AtKw1+C/cxU0o1ciw ($26.15 in chips) 
Seat 8: ljemhp25Zg+nlA9DLCIiUw ($24.75 in chips) 
ljemhp25Zg+nlA9DLCIiUw: posts small blind $0.10
vSkQm2EelzwRGDDQQk0Fqw: is sitting out 
vSkQm2EelzwRGDDQQk0Fqw leaves the table
xUw+6BIJCkgxBKESwlj9Hg: posts big blind $0.25
H7ijH+qgNcEQW9eBvivIYg: posts big blind $0.25
*** HOLE CARDS ***
N2LVj3iImgnOoHVf8g0rIw: folds 
H7ijH+qgNcEQW9eBvivIYg: checks 
HPEB+AtKw1+C/cxU0o1ciw: folds 
ljemhp25Zg+nlA9DLCIiUw: folds 
xUw+6BIJCkgxBKESwlj9Hg: checks 
*** FLOP *** [Jc 3h 5d]
xUw+6BIJCkgxBKESwlj9Hg: checks 
H7ijH+qgNcEQW9eBvivIYg: bets $0.25
xUw+6BIJCkgxBKESwlj9Hg: folds 
Uncalled bet ($0.25) returned to H7ijH+qgNcEQW9eBvivIYg
H7ijH+qgNcEQW9eBvivIYg collected $0.60 from pot
H7ijH+qgNcEQW9eBvivIYg: doesn't show hand 
*** SUMMARY ***
Total pot $0.60 | Rake $0 
Board [Jc 3h 5d]
Seat 3: xUw+6BIJCkgxBKESwlj9Hg (big blind) folded on the Flop
Seat 4: N2LVj3iImgnOoHVf8g0rIw folded before Flop (didn't bet)
Seat 5: H7ijH+qgNcEQW9eBvivIYg collected ($0.60)
Seat 6: HPEB+AtKw1+C/cxU0o1ciw (button) folded before Flop (didn't bet)
Seat 8: ljemhp25Zg+nlA9DLCIiUw (small blind) folded before Flop




PokerStars Game #59941895510:  Hold'em No Limit ($0.10/$0.25) - 2009/07/01 1:49:35 ET
Table 'CM/C/FZf3VHIp50RjmBucQ' 9-max Seat #8 is the button
Seat 1: P8h+GtgJJRwRh2YdssBtbg ($4.25 in chips) 
Seat 2: +aNWwNic2LVhXcMqH+ezrA ($19.50 in chips) 
Seat 3: HPEB+AtKw1+C/cxU0o1ciw ($54.45 in chips) 
Seat 4: FYIiLXWy4mKC5ZGa/fnS0g ($15.65 in chips) 
Seat 5: t3m1RlE+8m1yb0ojo8ikCw ($13.40 in chips) 
Seat 6: FqpibuVWLNsAN/Z7ROZLnA ($6.55 in chips) 
Seat 7: +T7KwHtNiHQt6JhQegSH/w ($5.20 in chips) 
Seat 8: 5pDhXQ+RVy0BGcwfJAJfbg ($24.65 in chips) 
Seat 9: W6tExOcYX7qiy6Qdp+ZwFA ($5 in chips) 
W6tExOcYX7qiy6Qdp+ZwFA: posts small blind $0.10
P8h+GtgJJRwRh2YdssBtbg: posts big blind $0.25
*** HOLE CARDS ***
+aNWwNic2LVhXcMqH+ezrA: folds 
+aNWwNic2LVhXcMqH+ezrA leaves the table
HPEB+AtKw1+C/cxU0o1ciw: folds 
FYIiLXWy4mKC5ZGa/fnS0g: calls $0.25
t3m1RlE+8m1yb0ojo8ikCw: calls $0.25
FqpibuVWLNsAN/Z7ROZLnA: raises $0.75 to $1
+T7KwHtNiHQt6JhQegSH/w: calls $1
5pDhXQ+RVy0BGcwfJAJfbg: folds 
W6tExOcYX7qiy6Qdp+ZwFA: folds 
P8h+GtgJJRwRh2YdssBtbg: calls $0.75
FYIiLXWy4mKC5ZGa/fnS0g: folds 
t3m1RlE+8m1yb0ojo8ikCw: calls $0.75
*** FLOP *** [Ad 5s 4c]
P8h+GtgJJRwRh2YdssBtbg: checks 
t3m1RlE+8m1yb0ojo8ikCw: checks 
FqpibuVWLNsAN/Z7ROZLnA: checks 
+T7KwHtNiHQt6JhQegSH/w: bets $2
P8h+GtgJJRwRh2YdssBtbg: folds 
OXPkK84/qv92EMwXPiG5rQ joins the table at seat #2 
t3m1RlE+8m1yb0ojo8ikCw: folds 
FqpibuVWLNsAN/Z7ROZLnA: folds 
Uncalled bet ($2) returned to +T7KwHtNiHQt6JhQegSH/w
+T7KwHtNiHQt6JhQegSH/w collected $4.15 from pot
+T7KwHtNiHQt6JhQegSH/w: doesn't show hand 
*** SUMMARY ***
Total pot $4.35 | Rake $0.20 
Board [Ad 5s 4c]
Seat 1: P8h+GtgJJRwRh2YdssBtbg (big blind) folded on the Flop
Seat 2: +aNWwNic2LVhXcMqH+ezrA folded before Flop (didn't bet)
Seat 3: HPEB+AtKw1+C/cxU0o1ciw folded before Flop (didn't bet)
Seat 4: FYIiLXWy4mKC5ZGa/fnS0g folded before Flop
Seat 5: t3m1RlE+8m1yb0ojo8ikCw folded on the Flop
Seat 6: FqpibuVWLNsAN/Z7ROZLnA folded on the Flop
Seat 7: +T7KwHtNiHQt6JhQegSH/w collected ($4.15)
Seat 8: 5pDhXQ+RVy0BGcwfJAJfbg (button) folded before Flop (didn't bet)
Seat 9: W6tExOcYX7qiy6Qdp+ZwFA (small blind) folded before Flop




PokerStars Game #59941895340:  Hold'em No Limit ($0.10/$0.25) - 2009/07/01 1:49:35 ET
Table 'h02LhQ7B/Zk4ETRxxHhGYA' 9-max Seat #6 is the button
Seat 1: sD+TKtt36XiiN6jqHiLwDA ($24.75 in chips) 
Seat 2: 9lvO/qyU+xrU95Teu1fv0g ($7.05 in chips) 
Seat 3: arxNSjreDRGFg13EAM2F1w ($30.40 in chips) 
Seat 4: ZyPfMsrS7T70lNdYA6rJ7w ($10.50 in chips) 
Seat 5: cUxk0Jk4lrUQv9CJl0LPlg ($28 in chips) 
Seat 6: UvM6sxFT7el5hVDehvWvTA ($31.15 in chips) 
Seat 7: y7w8+Oqq4SkI1dkRDCx2Zg ($3.25 in chips) 
Seat 8: mUoFJKqCzIUABvOFbiINlQ ($15.20 in chips) 
Seat 9: HcU1ud5gMXGuhN1QChAhfQ ($24.75 in chips) 
y7w8+Oqq4SkI1dkRDCx2Zg: posts small blind $0.10
mUoFJKqCzIUABvOFbiINlQ: posts big blind $0.25
*** HOLE CARDS ***
HcU1ud5gMXGuhN1QChAhfQ: calls $0.25
sD+TKtt36XiiN6jqHiLwDA: calls $0.25
9lvO/qyU+xrU95Teu1fv0g: folds 
arxNSjreDRGFg13EAM2F1w: folds 
ZyPfMsrS7T70lNdYA6rJ7w: folds 
cUxk0Jk4lrUQv9CJl0LPlg has timed out
cUxk0Jk4lrUQv9CJl0LPlg: folds 
cUxk0Jk4lrUQv9CJl0LPlg is sitting out
UvM6sxFT7el5hVDehvWvTA: calls $0.25
y7w8+Oqq4SkI1dkRDCx2Zg: calls $0.15
mUoFJKqCzIUABvOFbiINlQ: checks 
*** FLOP *** [8c 3s 9c]
cUxk0Jk4lrUQv9CJl0LPlg has returned
y7w8+Oqq4SkI1dkRDCx2Zg: checks 
mUoFJKqCzIUABvOFbiINlQ: checks 
HcU1ud5gMXGuhN1QChAhfQ: checks 
sD+TKtt36XiiN6jqHiLwDA: checks 
UvM6sxFT7el5hVDehvWvTA: checks 
*** TURN *** [8c 3s 9c] [4h]
y7w8+Oqq4SkI1dkRDCx2Zg: checks 
mUoFJKqCzIUABvOFbiINlQ: checks 
HcU1ud5gMXGuhN1QChAhfQ: checks 
sD+TKtt36XiiN6jqHiLwDA: checks 
UvM6sxFT7el5hVDehvWvTA: checks 
*** RIVER *** [8c 3s 9c 4h] [6h]
y7w8+Oqq4SkI1dkRDCx2Zg: checks 
mUoFJKqCzIUABvOFbiINlQ: checks 
HcU1ud5gMXGuhN1QChAhfQ: checks 
sD+TKtt36XiiN6jqHiLwDA: checks 
UvM6sxFT7el5hVDehvWvTA: bets $0.50
y7w8+Oqq4SkI1dkRDCx2Zg: folds 
mUoFJKqCzIUABvOFbiINlQ: folds 
HcU1ud5gMXGuhN1QChAhfQ: folds 
sD+TKtt36XiiN6jqHiLwDA: calls $0.50
*** SHOW DOWN ***
UvM6sxFT7el5hVDehvWvTA: shows [Jd Kc] (high card King)
sD+TKtt36XiiN6jqHiLwDA: shows [5c 5s] (a pair of Fives)
sD+TKtt36XiiN6jqHiLwDA collected $2.15 from pot
*** SUMMARY ***
Total pot $2.25 | Rake $0.10 
Board [8c 3s 9c 4h 6h]
Seat 1: sD+TKtt36XiiN6jqHiLwDA showed [5c 5s] and won ($2.15) with a pair of Fives
Seat 2: 9lvO/qyU+xrU95Teu1fv0g folded before Flop (didn't bet)
Seat 3: arxNSjreDRGFg13EAM2F1w folded before Flop (didn't bet)
Seat 4: ZyPfMsrS7T70lNdYA6rJ7w folded before Flop (didn't bet)
Seat 5: cUxk0Jk4lrUQv9CJl0LPlg folded before Flop (didn't bet)
Seat 6: UvM6sxFT7el5hVDehvWvTA (button) showed [Jd Kc] and lost with high card King
Seat 7: y7w8+Oqq4SkI1dkRDCx2Zg (small blind) folded on the River
Seat 8: mUoFJKqCzIUABvOFbiINlQ (big blind) folded on the River
Seat 9: HcU1ud5gMXGuhN1QChAhfQ folded on the River




PokerStars Game #59941895636:  Hold'em No Limit ($0.10/$0.25) - 2009/07/01 1:49:35 ET
Table 'BmUMTVcNATeov2rAGYU0Qg' 9-max Seat #6 is the button
Seat 1: QEbIGci+itdw+re8RM5fZA ($33.60 in chips) 
Seat 2: jJnMGXoBXye+afMd0k0rUw ($11.65 in chips) 
Seat 3: ir5Jy8ck6DrdqgJ/3chcWw ($10.40 in chips) 
Seat 4: aNpwfA31EREwO+ar4XzBCw ($37.35 in chips) 
Seat 5: QBNcj9fHxkh/+s/oVw+JmQ ($24 in chips) 
Seat 6: w1ukf8uPa4+WH561TtVRxA ($25 in chips) 
Seat 7: CmngQmkKTp8tkl6GMRTl6w ($10.20 in chips) 
Seat 8: Jve2LRs9vtGL7NdiNeXY/A ($13.25 in chips) 
Seat 9: /artgaAtyUtUtD8FZo6puA ($9.10 in chips) 
CmngQmkKTp8tkl6GMRTl6w: posts small blind $0.10
Jve2LRs9vtGL7NdiNeXY/A: posts big blind $0.25
*** HOLE CARDS ***
/artgaAtyUtUtD8FZo6puA: folds 
QEbIGci+itdw+re8RM5fZA: folds 
jJnMGXoBXye+afMd0k0rUw: folds 
ir5Jy8ck6DrdqgJ/3chcWw: folds 
aNpwfA31EREwO+ar4XzBCw: folds 
QBNcj9fHxkh/+s/oVw+JmQ: folds 
w1ukf8uPa4+WH561TtVRxA: raises $0.50 to $0.75
CmngQmkKTp8tkl6GMRTl6w: folds 
Jve2LRs9vtGL7NdiNeXY/A: folds 
Uncalled bet ($0.50) returned to w1ukf8uPa4+WH561TtVRxA
w1ukf8uPa4+WH561TtVRxA collected $0.60 from pot
w1ukf8uPa4+WH561TtVRxA: doesn't show hand 
*** SUMMARY ***
Total pot $0.60 | Rake $0 
Seat 1: QEbIGci+itdw+re8RM5fZA folded before Flop (didn't bet)
Seat 2: jJnMGXoBXye+afMd0k0rUw folded before Flop (didn't bet)
Seat 3: ir5Jy8ck6DrdqgJ/3chcWw folded before Flop (didn't bet)
Seat 4: aNpwfA31EREwO+ar4XzBCw folded before Flop (didn't bet)
Seat 5: QBNcj9fHxkh/+s/oVw+JmQ folded before Flop (didn't bet)
Seat 6: w1ukf8uPa4+WH561TtVRxA (button) collected ($0.60)
Seat 7: CmngQmkKTp8tkl6GMRTl6w (small blind) folded before Flop
Seat 8: Jve2LRs9vtGL7NdiNeXY/A (big blind) folded before Flop
Seat 9: /artgaAtyUtUtD8FZo6puA folded before Flop (didn't bet)




PokerStars Game #59941895918:  Hold'em No Limit ($0.10/$0.25) - 2009/07/01 1:49:36 ET
Table 'by7aHYEDnDd144EXOXa/jA' 9-max Seat #6 is the button
Seat 1: j4q3p0lesp63b1gZDwLBZw ($7.65 in chips) 
Seat 2: vSkQm2EelzwRGDDQQk0Fqw ($8.90 in chips) 
Seat 3: HOEaXncFu2ij+D5/CANAZA ($11.90 in chips) 
Seat 4: 2Xwi447v1rBHM+92U0CduA ($4.40 in chips) 
Seat 5: yyG4svzOpC1A+sUP/scg6w ($3.85 in chips) 
Seat 6: sC4BsflLWW26Qm9m+1AwJQ ($10.15 in chips) 
Seat 7: Z9W7+g1WMhhZDi7DwGbCFA ($5.45 in chips) 
Seat 8: 7je+LC5Mfs6nL8YBVh4frQ ($3.50 in chips) 
Seat 9: K0b5wNInj6hUGRr6yzKFtw ($25.05 in chips) 
Z9W7+g1WMhhZDi7DwGbCFA: posts small blind $0.10
7je+LC5Mfs6nL8YBVh4frQ: posts big blind $0.25
*** HOLE CARDS ***
K0b5wNInj6hUGRr6yzKFtw: folds 
j4q3p0lesp63b1gZDwLBZw: folds 
vSkQm2EelzwRGDDQQk0Fqw: folds 
HOEaXncFu2ij+D5/CANAZA: folds 
2Xwi447v1rBHM+92U0CduA: folds 
yyG4svzOpC1A+sUP/scg6w: folds 
sC4BsflLWW26Qm9m+1AwJQ: folds 
Z9W7+g1WMhhZDi7DwGbCFA: folds 
Uncalled bet ($0.15) returned to 7je+LC5Mfs6nL8YBVh4frQ
7je+LC5Mfs6nL8YBVh4frQ collected $0.20 from pot
7je+LC5Mfs6nL8YBVh4frQ: doesn't show hand 
*** SUMMARY ***
Total pot $0.20 | Rake $0 
Seat 1: j4q3p0lesp63b1gZDwLBZw folded before Flop (didn't bet)
Seat 2: vSkQm2EelzwRGDDQQk0Fqw folded before Flop (didn't bet)
Seat 3: HOEaXncFu2ij+D5/CANAZA folded before Flop (didn't bet)
Seat 4: 2Xwi447v1rBHM+92U0CduA folded before Flop (didn't bet)
Seat 5: yyG4svzOpC1A+sUP/scg6w folded before Flop (didn't bet)
Seat 6: sC4BsflLWW26Qm9m+1AwJQ (button) folded before Flop (didn't bet)
Seat 7: Z9W7+g1WMhhZDi7DwGbCFA (small blind) folded before Flop
Seat 8: 7je+LC5Mfs6nL8YBVh4frQ (big blind) collected ($0.20)
Seat 9: K0b5wNInj6hUGRr6yzKFtw folded before Flop (didn't bet)




PokerStars Game #59941896288:  Hold'em No Limit ($0.10/$0.25) - 2009/07/01 1:49:36 ET
Table 'ggwTHpIC5qhhHJSYjK1XCw' 6-max Seat #4 is the button
Seat 2: /gJNBeCkWL4o85/jvlZ4BA ($26.20 in chips) 
Seat 3: 7cx44/slbeTw+Cy7QB8Trg ($24.50 in chips) 
Seat 4: JFIAqU8lCZ0vWwEl4bdGsg ($25 in chips) 
Seat 5: BvqhBa7W/To51LhEiIU/lw ($6.65 in chips) 
BvqhBa7W/To51LhEiIU/lw: posts small blind $0.10
/gJNBeCkWL4o85/jvlZ4BA: posts big blind $0.25
*** HOLE CARDS ***
7cx44/slbeTw+Cy7QB8Trg: folds 
JFIAqU8lCZ0vWwEl4bdGsg: folds 
BvqhBa7W/To51LhEiIU/lw: calls $0.15
/gJNBeCkWL4o85/jvlZ4BA: checks 
*** FLOP *** [2c 6h 8d]
raf216 has returned
BvqhBa7W/To51LhEiIU/lw: bets $0.25
/gJNBeCkWL4o85/jvlZ4BA: calls $0.25
*** TURN *** [2c 6h 8d] [5s]
BvqhBa7W/To51LhEiIU/lw: bets $0.25
/gJNBeCkWL4o85/jvlZ4BA: calls $0.25
*** RIVER *** [2c 6h 8d 5s] [Jc]
BvqhBa7W/To51LhEiIU/lw: bets $0.25
/gJNBeCkWL4o85/jvlZ4BA: calls $0.25
*** SHOW DOWN ***
BvqhBa7W/To51LhEiIU/lw: shows [9h 8h] (a pair of Eights)
/gJNBeCkWL4o85/jvlZ4BA: mucks hand 
BZG35 joins the table at seat #1 
BvqhBa7W/To51LhEiIU/lw collected $1.95 from pot
*** SUMMARY ***
Total pot $2 | Rake $0.05 
Board [2c 6h 8d 5s Jc]
Seat 2: /gJNBeCkWL4o85/jvlZ4BA (big blind) mucked
Seat 3: 7cx44/slbeTw+Cy7QB8Trg folded before Flop (didn't bet)
Seat 4: JFIAqU8lCZ0vWwEl4bdGsg (button) folded before Flop (didn't bet)
Seat 5: BvqhBa7W/To51LhEiIU/lw (small blind) showed [9h 8h] and won ($1.95) with a pair of Eights




PokerStars Game #59941895898:  Hold'em No Limit ($0.10/$0.25) - 2009/07/01 1:49:36 ET
Table 'UVjmXTtsmlX1HxwwZ59akg' 9-max Seat #3 is the button
Seat 1: zDrucyjVn5aeekNEc3cJrA ($48.35 in chips) 
Seat 2: q+Qdg0Hoir+SyL7haBrUnw ($7.80 in chips) 
Seat 3: GmzfAfxcxu1kGbPC+9LkVg ($24.15 in chips) 
Seat 5: Bb42QRQMhg5/Y0vHP8/2Xw ($39.70 in chips) 
Seat 6: st9jtdNbm1W5GfBwRaCVqQ ($27.60 in chips) 
Seat 7: d7YasxuGLPiL7pj8IcGThw ($4.75 in chips) 
Seat 9: ljemhp25Zg+nlA9DLCIiUw ($25.25 in chips) 
18G4P1XstjNvItdGUITxgw will be allowed to play after the button
Bb42QRQMhg5/Y0vHP8/2Xw: posts small blind $0.10
st9jtdNbm1W5GfBwRaCVqQ: posts big blind $0.25
*** HOLE CARDS ***
d7YasxuGLPiL7pj8IcGThw: folds 
ljemhp25Zg+nlA9DLCIiUw: folds 
zDrucyjVn5aeekNEc3cJrA: folds 
q+Qdg0Hoir+SyL7haBrUnw: folds 
GmzfAfxcxu1kGbPC+9LkVg: calls $0.25
Bb42QRQMhg5/Y0vHP8/2Xw: calls $0.15
st9jtdNbm1W5GfBwRaCVqQ: checks 
*** FLOP *** [Jc Jd 4d]
Bb42QRQMhg5/Y0vHP8/2Xw: checks 
st9jtdNbm1W5GfBwRaCVqQ: bets $0.50
GmzfAfxcxu1kGbPC+9LkVg: calls $0.50
Bb42QRQMhg5/Y0vHP8/2Xw: folds 
*** TURN *** [Jc Jd 4d] [6c]
st9jtdNbm1W5GfBwRaCVqQ: bets $1
GmzfAfxcxu1kGbPC+9LkVg: calls $1
*** RIVER *** [Jc Jd 4d 6c] [Td]
st9jtdNbm1W5GfBwRaCVqQ: checks 
GmzfAfxcxu1kGbPC+9LkVg: bets $2
st9jtdNbm1W5GfBwRaCVqQ: calls $2
*** SHOW DOWN ***
GmzfAfxcxu1kGbPC+9LkVg: shows [7d Ad] (a flush, Ace high)
st9jtdNbm1W5GfBwRaCVqQ: mucks hand 
GmzfAfxcxu1kGbPC+9LkVg collected $7.40 from pot
*** SUMMARY ***
Total pot $7.75 | Rake $0.35 
Board [Jc Jd 4d 6c Td]
Seat 1: zDrucyjVn5aeekNEc3cJrA folded before Flop (didn't bet)
Seat 2: q+Qdg0Hoir+SyL7haBrUnw folded before Flop (didn't bet)
Seat 3: GmzfAfxcxu1kGbPC+9LkVg (button) showed [7d Ad] and won ($7.40) with a flush, Ace high
Seat 5: Bb42QRQMhg5/Y0vHP8/2Xw (small blind) folded on the Flop
Seat 6: st9jtdNbm1W5GfBwRaCVqQ (big blind) mucked
Seat 7: d7YasxuGLPiL7pj8IcGThw folded before Flop (didn't bet)
Seat 9: ljemhp25Zg+nlA9DLCIiUw folded before Flop (didn't bet)




PokerStars Game #59941895856:  Hold'em No Limit ($0.10/$0.25) - 2009/07/01 1:49:36 ET
Table 'HbNAGS1OJWQKyfk7UfrYyw' 9-max Seat #3 is the button
Seat 2: fjwM06E3HzjUrynPRQi31Q ($6 in chips) 
Seat 3: Yxal0LG80xJqTIctpMLWlg ($3.65 in chips) 
Seat 4: XwQK8xvCADxp0bUmji+Zyg ($14.75 in chips) 
Seat 5: clJsV3v77RS07bDKY+705w ($5 in chips) 
Seat 6: jntAuOS+eFQDYNiDN8dzag ($7.75 in chips) 
Seat 7: T+MjFnaPZsOyKbE9LYG2Qg ($14.75 in chips) 
Seat 9: nLE5Yo60EmSlJPyg0GgxXg ($30.75 in chips) 
XwQK8xvCADxp0bUmji+Zyg: posts small blind $0.10
clJsV3v77RS07bDKY+705w: posts big blind $0.25
DiSvPC2iudwL5j9u6Huyww: sits out 
*** HOLE CARDS ***
jntAuOS+eFQDYNiDN8dzag: raises $1.25 to $1.50
yewI46YETJjAiiQPL5e+fQ leaves the table
T+MjFnaPZsOyKbE9LYG2Qg: folds 
nLE5Yo60EmSlJPyg0GgxXg: folds 
3PmVnC/15cl4oyI1TKIt4g joins the table at seat #1 
fjwM06E3HzjUrynPRQi31Q: folds 
Yxal0LG80xJqTIctpMLWlg: calls $1.50
XwQK8xvCADxp0bUmji+Zyg: calls $1.40
clJsV3v77RS07bDKY+705w: folds 
*** FLOP *** [Ah Ac 8c]
XwQK8xvCADxp0bUmji+Zyg: checks 
jntAuOS+eFQDYNiDN8dzag: checks 
Yxal0LG80xJqTIctpMLWlg: checks 
*** TURN *** [Ah Ac 8c] [2h]
XwQK8xvCADxp0bUmji+Zyg: bets $0.25
jntAuOS+eFQDYNiDN8dzag: calls $0.25
Yxal0LG80xJqTIctpMLWlg: folds 
*** RIVER *** [Ah Ac 8c 2h] [9d]
XwQK8xvCADxp0bUmji+Zyg: bets $1
jntAuOS+eFQDYNiDN8dzag: folds 
Uncalled bet ($1) returned to XwQK8xvCADxp0bUmji+Zyg
XwQK8xvCADxp0bUmji+Zyg collected $5 from pot
*** SUMMARY ***
Total pot $5.25 | Rake $0.25 
Board [Ah Ac 8c 2h 9d]
Seat 2: fjwM06E3HzjUrynPRQi31Q folded before Flop (didn't bet)
Seat 3: Yxal0LG80xJqTIctpMLWlg (button) folded on the Turn
Seat 4: XwQK8xvCADxp0bUmji+Zyg (small blind) collected ($5)
Seat 5: clJsV3v77RS07bDKY+705w (big blind) folded before Flop
Seat 6: jntAuOS+eFQDYNiDN8dzag folded on the River
Seat 7: T+MjFnaPZsOyKbE9LYG2Qg folded before Flop (didn't bet)
Seat 9: nLE5Yo60EmSlJPyg0GgxXg folded before Flop (didn't bet)




PokerStars Game #59941896046:  Hold'em No Limit ($0.10/$0.25) - 2009/07/01 1:49:36 ET
Table 'eOXPe2c6mG7DOFKvMsZZfA' 6-max Seat #6 is the button
Seat 1: s21kVGMLPAoHdWR+muSonw ($26 in chips) 
Seat 2: gaPMxLGp9SOj4Lq6t+/0Ig ($7.10 in chips) 
Seat 3: kReyZ6g6Fu3tQ0nyjDf9kA ($25.35 in chips) 
Seat 4: zHHLkD2sRljslKKeQv/ZQw ($32.45 in chips) 
Seat 5: NhUN/JpAprdJeamFBgJH1w ($34.05 in chips) 
Seat 6: Qpv/hb5ak7LeaDig1L5L8w ($15.20 in chips) 
s21kVGMLPAoHdWR+muSonw: posts small blind $0.10
gaPMxLGp9SOj4Lq6t+/0Ig: posts big blind $0.25
*** HOLE CARDS ***
kReyZ6g6Fu3tQ0nyjDf9kA: calls $0.25
zHHLkD2sRljslKKeQv/ZQw: raises $0.50 to $0.75
NhUN/JpAprdJeamFBgJH1w: folds 
Qpv/hb5ak7LeaDig1L5L8w: calls $0.75
s21kVGMLPAoHdWR+muSonw: folds 
gaPMxLGp9SOj4Lq6t+/0Ig: raises $6.35 to $7.10 and is all-in
kReyZ6g6Fu3tQ0nyjDf9kA: folds 
zHHLkD2sRljslKKeQv/ZQw: folds 
Qpv/hb5ak7LeaDig1L5L8w: folds 
Uncalled bet ($6.35) returned to gaPMxLGp9SOj4Lq6t+/0Ig
gaPMxLGp9SOj4Lq6t+/0Ig collected $2.60 from pot
gaPMxLGp9SOj4Lq6t+/0Ig: doesn't show hand 
*** SUMMARY ***
Total pot $2.60 | Rake $0 
Seat 1: s21kVGMLPAoHdWR+muSonw (small blind) folded before Flop
Seat 2: gaPMxLGp9SOj4Lq6t+/0Ig (big blind) collected ($2.60)
Seat 3: kReyZ6g6Fu3tQ0nyjDf9kA folded before Flop
Seat 4: zHHLkD2sRljslKKeQv/ZQw folded before Flop
Seat 5: NhUN/JpAprdJeamFBgJH1w folded before Flop (didn't bet)
Seat 6: Qpv/hb5ak7LeaDig1L5L8w (button) folded before Flop




PokerStars Game #59941895834:  Hold'em No Limit ($0.10/$0.25) - 2009/07/01 1:49:36 ET
Table '2vH5RcmkT0F4XNS/EmmyMA' 6-max Seat #3 is the button
Seat 1: hOaWAImn5/MZDAWAPlYHCw ($6.60 in chips) 
Seat 2: W6Y6au0wf7gRAlqJYgOezw ($10.75 in chips) 
Seat 3: t8P79jKZYh/Wpx2V73pSqg ($24.60 in chips) 
Seat 4: FC6tJ9EOiutXO8hnpR4VgQ ($13.05 in chips) 
Seat 5: Hsvkc0/G2VV78oVmWYXecw ($5.15 in chips) 
Seat 6: if4dh6jhJXeN3/qd3qCp9g ($25 in chips) 
FC6tJ9EOiutXO8hnpR4VgQ: posts small blind $0.10
Hsvkc0/G2VV78oVmWYXecw: posts big blind $0.25
*** HOLE CARDS ***
if4dh6jhJXeN3/qd3qCp9g: raises $0.75 to $1
hOaWAImn5/MZDAWAPlYHCw: folds 
hOaWAImn5/MZDAWAPlYHCw leaves the table
W6Y6au0wf7gRAlqJYgOezw: folds 
t8P79jKZYh/Wpx2V73pSqg: folds 
FC6tJ9EOiutXO8hnpR4VgQ: folds 
Hsvkc0/G2VV78oVmWYXecw: folds 
Uncalled bet ($0.75) returned to if4dh6jhJXeN3/qd3qCp9g
if4dh6jhJXeN3/qd3qCp9g collected $0.60 from pot
if4dh6jhJXeN3/qd3qCp9g: doesn't show hand 
*** SUMMARY ***
Total pot $0.60 | Rake $0 
Seat 1: hOaWAImn5/MZDAWAPlYHCw folded before Flop (didn't bet)
Seat 2: W6Y6au0wf7gRAlqJYgOezw folded before Flop (didn't bet)
Seat 3: t8P79jKZYh/Wpx2V73pSqg (button) folded before Flop (didn't bet)
Seat 4: FC6tJ9EOiutXO8hnpR4VgQ (small blind) folded before Flop
Seat 5: Hsvkc0/G2VV78oVmWYXecw (big blind) folded before Flop
Seat 6: if4dh6jhJXeN3/qd3qCp9g collected ($0.60)




PokerStars Game #59941896502:  Hold'em No Limit ($0.10/$0.25) - 2009/07/01 1:49:37 ET
Table '0XPo7K54oZIfG0xlNAcDRwnQC9LRg01NEuKFHF1nrDEw-max Seat #5 is the button
Seat 1: qf+LMbROj8/qY878wkFHbQ ($15.30 in chips) 
Seat 2: ZhV6dUX9NQhT4zf7t+ZLJg ($23.95 in chips) 
Seat 3: 6+g0Lb6vfRDZkElV8ieHyQ ($26.10 in chips) 
Seat 4: u3Ol7kv1LmvszuHNm9rc6w ($24.65 in chips) 
Seat 5: kG34n23qFQA3nzdOJTQ1dA ($27.95 in chips) 
Seat 6: xQVFeVUDopz+akuEo2wXpQ ($55.40 in chips) 
xQVFeVUDopz+akuEo2wXpQ: posts small blind $0.10
qf+LMbROj8/qY878wkFHbQ: posts big blind $0.25
*** HOLE CARDS ***
ZhV6dUX9NQhT4zf7t+ZLJg: calls $0.25
6+g0Lb6vfRDZkElV8ieHyQ: folds 
u3Ol7kv1LmvszuHNm9rc6w: folds 
kG34n23qFQA3nzdOJTQ1dA: folds 
xQVFeVUDopz+akuEo2wXpQ: calls $0.15
qf+LMbROj8/qY878wkFHbQ: raises $1 to $1.25
ZhV6dUX9NQhT4zf7t+ZLJg: folds 
xQVFeVUDopz+akuEo2wXpQ: calls $1
*** FLOP *** [Js Th 7h]
xQVFeVUDopz+akuEo2wXpQ: checks 
qf+LMbROj8/qY878wkFHbQ: bets $1.75
xQVFeVUDopz+akuEo2wXpQ: calls $1.75
*** TURN *** [Js Th 7h] [2h]
xQVFeVUDopz+akuEo2wXpQ: checks 
qf+LMbROj8/qY878wkFHbQ: checks 
*** RIVER *** [Js Th 7h 2h] [4d]
xQVFeVUDopz+akuEo2wXpQ: checks 
qf+LMbROj8/qY878wkFHbQ: checks 
*** SHOW DOWN ***
xQVFeVUDopz+akuEo2wXpQ: shows [Ks 9d] (high card King)
qf+LMbROj8/qY878wkFHbQ: shows [Qd Ad] (high card Ace)
qf+LMbROj8/qY878wkFHbQ collected $5.95 from pot
*** SUMMARY ***
Total pot $6.25 | Rake $0.30 
Board [Js Th 7h 2h 4d]
Seat 1: qf+LMbROj8/qY878wkFHbQ (big blind) showed [Qd Ad] and won ($5.95) with high card Ace
Seat 2: ZhV6dUX9NQhT4zf7t+ZLJg folded before Flop
Seat 3: 6+g0Lb6vfRDZkElV8ieHyQ folded before Flop (didn't bet)
Seat 4: u3Ol7kv1LmvszuHNm9rc6w folded before Flop (didn't bet)
Seat 5: kG34n23qFQA3nzdOJTQ1dA (button) folded before Flop (didn't bet)
Seat 6: xQVFeVUDopz+akuEo2wXpQ (small blind) showed [Ks 9d] and lost with high card King




PokerStars Game #59941896768:  Hold'em No Limit ($0.10/$0.25) - 2009/07/01 1:49:37 ET
Table 'i93c3z9RLowvuJTKA2F4Jg' 6-max Seat #3 is the button
Seat 1: tbSZq5LHglyHk61mH9eDBw ($30.10 in chips) 
Seat 2: TSmua8tGK3sTbwi0ynrW9Q ($25.95 in chips) 
Seat 3: v8m8XHovI5tqEA9mvplDSw ($26.45 in chips) 
Seat 4: o86X2Q5GEDU3uP9oj1iFZA ($37.25 in chips) 
Seat 5: TI/C5Q+DEl4fLR3AofwYdg ($15 in chips) 
Seat 6: FpN4KbLjlyRRKiVaQcoLqA ($18.25 in chips) 
o86X2Q5GEDU3uP9oj1iFZA: posts small blind $0.10
TI/C5Q+DEl4fLR3AofwYdg: posts big blind $0.25
*** HOLE CARDS ***
FpN4KbLjlyRRKiVaQcoLqA: raises $0.25 to $0.50
tbSZq5LHglyHk61mH9eDBw: calls $0.50
TSmua8tGK3sTbwi0ynrW9Q: folds 
v8m8XHovI5tqEA9mvplDSw: folds 
o86X2Q5GEDU3uP9oj1iFZA: calls $0.40
TI/C5Q+DEl4fLR3AofwYdg: calls $0.25
*** FLOP *** [8h 5d 9h]
o86X2Q5GEDU3uP9oj1iFZA: checks 
TI/C5Q+DEl4fLR3AofwYdg: checks 
FpN4KbLjlyRRKiVaQcoLqA: checks 
tbSZq5LHglyHk61mH9eDBw: checks 
*** TURN *** [8h 5d 9h] [Ts]
o86X2Q5GEDU3uP9oj1iFZA: bets $1
TI/C5Q+DEl4fLR3AofwYdg: folds 
FpN4KbLjlyRRKiVaQcoLqA: calls $1
tbSZq5LHglyHk61mH9eDBw: folds 
*** RIVER *** [8h 5d 9h Ts] [6s]
o86X2Q5GEDU3uP9oj1iFZA: checks 
FpN4KbLjlyRRKiVaQcoLqA: bets $5
o86X2Q5GEDU3uP9oj1iFZA: folds 
Uncalled bet ($5) returned to FpN4KbLjlyRRKiVaQcoLqA
FpN4KbLjlyRRKiVaQcoLqA collected $3.85 from pot
FpN4KbLjlyRRKiVaQcoLqA: doesn't show hand 
*** SUMMARY ***
Total pot $4 | Rake $0.15 
Board [8h 5d 9h Ts 6s]
Seat 1: tbSZq5LHglyHk61mH9eDBw folded on the Turn
Seat 2: TSmua8tGK3sTbwi0ynrW9Q folded before Flop (didn't bet)
Seat 3: v8m8XHovI5tqEA9mvplDSw (button) folded before Flop (didn't bet)
Seat 4: o86X2Q5GEDU3uP9oj1iFZA (small blind) folded on the River
Seat 5: TI/C5Q+DEl4fLR3AofwYdg (big blind) folded on the Turn
Seat 6: FpN4KbLjlyRRKiVaQcoLqA collected ($3.85)




PokerStars Game #59941896360:  Hold'em No Limit ($0.10/$0.25) - 2009/07/01 1:49:37 ET
Table '4UJB/UOZ5aepyF2v+hIoUg' 6-max Seat #5 is the button
Seat 1: 08V++DOqzaNrRNsHIwi25w ($27 in chips) 
Seat 2: mFv3iBCtrw9XfCDRB0d46Q ($3.70 in chips) 
Seat 3: zlYHXTtJ5tcx9kwK2h5n9A ($51.40 in chips) 
Seat 4: R6AGToFJQOYVZAjC2jXEKw ($14.70 in chips) 
Seat 5: 3zD3qLXT1bEffAoWGnc7wg ($25.80 in chips) 
Seat 6: 2aphcinkTZT0B0Uoah6cvQ ($12.60 in chips) 
2aphcinkTZT0B0Uoah6cvQ: posts small blind $0.10
08V++DOqzaNrRNsHIwi25w: posts big blind $0.25
*** HOLE CARDS ***
mFv3iBCtrw9XfCDRB0d46Q: folds 
zlYHXTtJ5tcx9kwK2h5n9A: folds 
R6AGToFJQOYVZAjC2jXEKw: folds 
3zD3qLXT1bEffAoWGnc7wg: folds 
2aphcinkTZT0B0Uoah6cvQ: calls $0.15
08V++DOqzaNrRNsHIwi25w: raises $1 to $1.25
2aphcinkTZT0B0Uoah6cvQ: calls $1
*** FLOP *** [3d 8c 5d]
2aphcinkTZT0B0Uoah6cvQ: checks 
08V++DOqzaNrRNsHIwi25w: bets $1.50
2aphcinkTZT0B0Uoah6cvQ: calls $1.50
*** TURN *** [3d 8c 5d] [9c]
2aphcinkTZT0B0Uoah6cvQ: checks 
08V++DOqzaNrRNsHIwi25w: checks 
*** RIVER *** [3d 8c 5d 9c] [Qs]
2aphcinkTZT0B0Uoah6cvQ: bets $5
08V++DOqzaNrRNsHIwi25w: folds 
Uncalled bet ($5) returned to 2aphcinkTZT0B0Uoah6cvQ
2aphcinkTZT0B0Uoah6cvQ collected $5.25 from pot
2aphcinkTZT0B0Uoah6cvQ: doesn't show hand 
*** SUMMARY ***
Total pot $5.50 | Rake $0.25 
Board [3d 8c 5d 9c Qs]
Seat 1: 08V++DOqzaNrRNsHIwi25w (big blind) folded on the River
Seat 2: mFv3iBCtrw9XfCDRB0d46Q folded before Flop (didn't bet)
Seat 3: zlYHXTtJ5tcx9kwK2h5n9A folded before Flop (didn't bet)
Seat 4: R6AGToFJQOYVZAjC2jXEKw folded before Flop (didn't bet)
Seat 5: 3zD3qLXT1bEffAoWGnc7wg (button) folded before Flop (didn't bet)
Seat 6: 2aphcinkTZT0B0Uoah6cvQ (small blind) collected ($5.25)




PokerStars Game #59941896304:  Hold'em No Limit ($0.10/$0.25) - 2009/07/01 1:49:37 ET
Table 'KKk6y4pAXeymxYcd0uZLqg' 9-max Seat #7 is the button
Seat 1: HPEB+AtKw1+C/cxU0o1ciw ($24.90 in chips) 
Seat 3: tLcDklc2rBORNfixyRfVfw ($25 in chips) 
Seat 5: wGigCmBR/9XWkPpvYos3aQ ($40.70 in chips) 
Seat 6: QEbIGci+itdw+re8RM5fZA ($25 in chips) 
Seat 7: JjOuv8Vf56aiQjWi/rTPFA ($22.90 in chips) 
Seat 8: +2kMBNpY4nF1qNCRd8SJLA ($35.80 in chips) 
Seat 9: oLa/tXLfSLLB28mcLGrxcg ($25.45 in chips) 
+2kMBNpY4nF1qNCRd8SJLA: posts small blind $0.10
oLa/tXLfSLLB28mcLGrxcg: posts big blind $0.25
18G4P1XstjNvItdGUITxgw: sits out 
*** HOLE CARDS ***
jeffro7474 has returned
HPEB+AtKw1+C/cxU0o1ciw: folds 
tLcDklc2rBORNfixyRfVfw: folds 
wGigCmBR/9XWkPpvYos3aQ: folds 
QEbIGci+itdw+re8RM5fZA: folds 
JjOuv8Vf56aiQjWi/rTPFA: folds 
+2kMBNpY4nF1qNCRd8SJLA: raises $0.75 to $1
oLa/tXLfSLLB28mcLGrxcg: folds 
Uncalled bet ($0.75) returned to +2kMBNpY4nF1qNCRd8SJLA
+2kMBNpY4nF1qNCRd8SJLA collected $0.50 from pot
+2kMBNpY4nF1qNCRd8SJLA: doesn't show hand 
*** SUMMARY ***
Total pot $0.50 | Rake $0 
Seat 1: HPEB+AtKw1+C/cxU0o1ciw folded before Flop (didn't bet)
Seat 3: tLcDklc2rBORNfixyRfVfw folded before Flop (didn't bet)
Seat 5: wGigCmBR/9XWkPpvYos3aQ folded before Flop (didn't bet)
Seat 6: QEbIGci+itdw+re8RM5fZA folded before Flop (didn't bet)
Seat 7: JjOuv8Vf56aiQjWi/rTPFA (button) folded before Flop (didn't bet)
Seat 8: +2kMBNpY4nF1qNCRd8SJLA (small blind) collected ($0.50)
Seat 9: oLa/tXLfSLLB28mcLGrxcg (big blind) folded before Flop




PokerStars Game #59941896748:  Hold'em No Limit ($0.10/$0.25) - 2009/07/01 1:49:37 ET
Table 'hg+KpirwreMnBAFQr/SEUA' 9-max Seat #1 is the button
Seat 1: H5Se03ZqSX7tbULXur2MAg ($37.05 in chips) 
Seat 2: cpnBzHjFACn5zAY56UIvNA ($20.35 in chips) 
Seat 3: DdyXKuBx0HAOC7dWZmGxWg ($22 in chips) 
Seat 5: +2kMBNpY4nF1qNCRd8SJLA ($25 in chips) 
Seat 6: Bb42QRQMhg5/Y0vHP8/2Xw ($25.35 in chips) 
Seat 7: 5LSuZS4qvcUri/Byfkln7w ($7.25 in chips) 
Seat 8: HPEB+AtKw1+C/cxU0o1ciw ($22.90 in chips) 
Seat 9: xbecloQJYmBOSkzT9lZ+rg ($20 in chips) 
cpnBzHjFACn5zAY56UIvNA: posts small blind $0.10
DdyXKuBx0HAOC7dWZmGxWg: posts big blind $0.25
Z9W7+g1WMhhZDi7DwGbCFA: sits out 
*** HOLE CARDS ***
+2kMBNpY4nF1qNCRd8SJLA: folds 
Bb42QRQMhg5/Y0vHP8/2Xw: folds 
5LSuZS4qvcUri/Byfkln7w: folds 
HPEB+AtKw1+C/cxU0o1ciw: folds 
xbecloQJYmBOSkzT9lZ+rg: folds 
H5Se03ZqSX7tbULXur2MAg: raises $0.50 to $0.75
cpnBzHjFACn5zAY56UIvNA: folds 
DdyXKuBx0HAOC7dWZmGxWg: raises $0.50 to $1.25
H5Se03ZqSX7tbULXur2MAg: calls $0.50
*** FLOP *** [2d 8h Qc]
DdyXKuBx0HAOC7dWZmGxWg: bets $1.75
H5Se03ZqSX7tbULXur2MAg: folds 
Uncalled bet ($1.75) returned to DdyXKuBx0HAOC7dWZmGxWg
DdyXKuBx0HAOC7dWZmGxWg collected $2.50 from pot
DdyXKuBx0HAOC7dWZmGxWg: doesn't show hand 
*** SUMMARY ***
Total pot $2.60 | Rake $0.10 
Board [2d 8h Qc]
Seat 1: H5Se03ZqSX7tbULXur2MAg (button) folded on the Flop
Seat 2: cpnBzHjFACn5zAY56UIvNA (small blind) folded before Flop
Seat 3: DdyXKuBx0HAOC7dWZmGxWg (big blind) collected ($2.50)
Seat 5: +2kMBNpY4nF1qNCRd8SJLA folded before Flop (didn't bet)
Seat 6: Bb42QRQMhg5/Y0vHP8/2Xw folded before Flop (didn't bet)
Seat 7: 5LSuZS4qvcUri/Byfkln7w folded before Flop (didn't bet)
Seat 8: HPEB+AtKw1+C/cxU0o1ciw folded before Flop (didn't bet)
Seat 9: xbecloQJYmBOSkzT9lZ+rg folded before Flop (didn't bet)




PokerStars Game #59941896364:  Hold'em No Limit ($0.10/$0.25) - 2009/07/01 1:49:37 ET
Table 'rhQuIjJo0UQ7RRUlF9umHg' 6-max Seat #5 is the button
Seat 1: 5O3Hj9Qg0SqOyKEXoLpjPg ($176.15 in chips) 
Seat 2: Ew/TYPQIsbQ2X8nm5iAJBg ($26.70 in chips) 
Seat 3: if4dh6jhJXeN3/qd3qCp9g ($27.05 in chips) 
Seat 5: dOX4wnYV2sEqvDbF+8KSCw ($68.55 in chips) 
Seat 6: /gJNBeCkWL4o85/jvlZ4BA ($48.80 in chips) 
/gJNBeCkWL4o85/jvlZ4BA: posts small blind $0.10
5O3Hj9Qg0SqOyKEXoLpjPg: posts big blind $0.25
*** HOLE CARDS ***
Ew/TYPQIsbQ2X8nm5iAJBg: folds 
5O3Hj9Qg0SqOyKEXoLpjPg said, "u too sweaty"
buyjetgNT1McXtdaP4zynA leaves the table
if4dh6jhJXeN3/qd3qCp9g: folds 
dOX4wnYV2sEqvDbF+8KSCw: raises $0.75 to $1
/gJNBeCkWL4o85/jvlZ4BA: folds 
5O3Hj9Qg0SqOyKEXoLpjPg: calls $0.75
*** FLOP *** [4s 7c Tc]
aogAb4Eienxztk8p2v9VVw joins the table at seat #4 
5O3Hj9Qg0SqOyKEXoLpjPg: checks 
dOX4wnYV2sEqvDbF+8KSCw: checks 
*** TURN *** [4s 7c Tc] [6d]
5O3Hj9Qg0SqOyKEXoLpjPg: bets $0.50
dOX4wnYV2sEqvDbF+8KSCw: folds 
Uncalled bet ($0.50) returned to 5O3Hj9Qg0SqOyKEXoLpjPg
5O3Hj9Qg0SqOyKEXoLpjPg collected $2 from pot
5O3Hj9Qg0SqOyKEXoLpjPg: doesn't show hand 
*** SUMMARY ***
Total pot $2.10 | Rake $0.10 
Board [4s 7c Tc 6d]
Seat 1: 5O3Hj9Qg0SqOyKEXoLpjPg (big blind) collected ($2)
Seat 2: Ew/TYPQIsbQ2X8nm5iAJBg folded before Flop (didn't bet)
Seat 3: if4dh6jhJXeN3/qd3qCp9g folded before Flop (didn't bet)
Seat 5: dOX4wnYV2sEqvDbF+8KSCw (button) folded on the Turn
Seat 6: /gJNBeCkWL4o85/jvlZ4BA (small blind) folded before Flop




PokerStars Game #59941897244:  Hold'em No Limit ($0.10/$0.25) - 2009/07/01 1:49:38 ET
Table 'jItkp2PNTbH9Cf7gqsAF7g' 9-max Seat #9 is the button
Seat 1: wGigCmBR/9XWkPpvYos3aQ ($26.60 in chips) 
Seat 2: qwr38jl5txoR36M7G5qi4A ($7.95 in chips) 
Seat 3: 0YaJElQVLqWThIZnqq3w1g ($11.85 in chips) 
Seat 4: oJOvZw/Iayou0f0k6dkBhg ($5.55 in chips) 
Seat 5: NO6qGDOw12lhu3zh1xW3Bg ($19.40 in chips) 
Seat 6: cZ99hugmLBj9KhTlc8nCSw ($54 in chips) 
Seat 8: cq6LACCDFivk2+PeoiB2sw ($8.05 in chips) 
Seat 9: dtZ84flFEi4Q+SGrHMJRDQ ($25 in chips) 
wGigCmBR/9XWkPpvYos3aQ: posts small blind $0.10
qwr38jl5txoR36M7G5qi4A: posts big blind $0.25
*** HOLE CARDS ***
0YaJElQVLqWThIZnqq3w1g: raises $0.50 to $0.75
oJOvZw/Iayou0f0k6dkBhg: folds 
NO6qGDOw12lhu3zh1xW3Bg: folds 
cZ99hugmLBj9KhTlc8nCSw: folds 
cq6LACCDFivk2+PeoiB2sw: folds 
dtZ84flFEi4Q+SGrHMJRDQ: folds 
wGigCmBR/9XWkPpvYos3aQ: folds 
qwr38jl5txoR36M7G5qi4A: folds 
Uncalled bet ($0.50) returned to 0YaJElQVLqWThIZnqq3w1g
0YaJElQVLqWThIZnqq3w1g collected $0.60 from pot
0YaJElQVLqWThIZnqq3w1g: doesn't show hand 
*** SUMMARY ***
Total pot $0.60 | Rake $0 
Seat 1: wGigCmBR/9XWkPpvYos3aQ (small blind) folded before Flop
Seat 2: qwr38jl5txoR36M7G5qi4A (big blind) folded before Flop
Seat 3: 0YaJElQVLqWThIZnqq3w1g collected ($0.60)
Seat 4: oJOvZw/Iayou0f0k6dkBhg folded before Flop (didn't bet)
Seat 5: NO6qGDOw12lhu3zh1xW3Bg folded before Flop (didn't bet)
Seat 6: cZ99hugmLBj9KhTlc8nCSw folded before Flop (didn't bet)
Seat 8: cq6LACCDFivk2+PeoiB2sw folded before Flop (didn't bet)
Seat 9: dtZ84flFEi4Q+SGrHMJRDQ (button) folded before Flop (didn't bet)




PokerStars Game #59941896810:  Hold'em No Limit ($0.10/$0.25) - 2009/07/01 1:49:38 ET
Table '+68ihX5Br1xgGorX6zsCBg' 9-max Seat #5 is the button
Seat 1: IFB2mhulUVYIbb+KWwDC9w ($4.55 in chips) 
Seat 2: TeAfhXG1R60d8yPEHN3JiA ($27.65 in chips) 
Seat 3: PdIasPkzm2sqZnN41ZRXOg ($5 in chips) 
Seat 4: Oi0EiPIjriUb/6zT65YeWA ($27.30 in chips) 
Seat 5: ghNKXUBl/H+t83JF079ZBA ($28.65 in chips) 
Seat 6: X78b5v/uhqeXXoAijbw/yg ($26.15 in chips) 
Seat 7: V6p0jQ/RhUsqpHLmXvEX4Q ($16.45 in chips) 
Seat 9: DiSvPC2iudwL5j9u6Huyww ($32.75 in chips) 
X78b5v/uhqeXXoAijbw/yg: posts small blind $0.10
V6p0jQ/RhUsqpHLmXvEX4Q: posts big blind $0.25
*** HOLE CARDS ***
DiSvPC2iudwL5j9u6Huyww: folds 
IFB2mhulUVYIbb+KWwDC9w: calls $0.25
TeAfhXG1R60d8yPEHN3JiA: raises $0.25 to $0.50
PdIasPkzm2sqZnN41ZRXOg: folds 
Oi0EiPIjriUb/6zT65YeWA: folds 
ghNKXUBl/H+t83JF079ZBA: folds 
X78b5v/uhqeXXoAijbw/yg: folds 
V6p0jQ/RhUsqpHLmXvEX4Q: calls $0.25
IFB2mhulUVYIbb+KWwDC9w: calls $0.25
*** FLOP *** [7d 7c 5s]
V6p0jQ/RhUsqpHLmXvEX4Q: bets $0.75
IFB2mhulUVYIbb+KWwDC9w: folds 
TeAfhXG1R60d8yPEHN3JiA: calls $0.75
*** TURN *** [7d 7c 5s] [4d]
V6p0jQ/RhUsqpHLmXvEX4Q: checks 
TeAfhXG1R60d8yPEHN3JiA: bets $1
V6p0jQ/RhUsqpHLmXvEX4Q: raises $2.25 to $3.25
TeAfhXG1R60d8yPEHN3JiA: folds 
Uncalled bet ($2.25) returned to V6p0jQ/RhUsqpHLmXvEX4Q
V6p0jQ/RhUsqpHLmXvEX4Q collected $4.90 from pot
*** SUMMARY ***
Total pot $5.10 | Rake $0.20 
Board [7d 7c 5s 4d]
Seat 1: IFB2mhulUVYIbb+KWwDC9w folded on the Flop
Seat 2: TeAfhXG1R60d8yPEHN3JiA folded on the Turn
Seat 3: PdIasPkzm2sqZnN41ZRXOg folded before Flop (didn't bet)
Seat 4: Oi0EiPIjriUb/6zT65YeWA folded before Flop (didn't bet)
Seat 5: ghNKXUBl/H+t83JF079ZBA (button) folded before Flop (didn't bet)
Seat 6: X78b5v/uhqeXXoAijbw/yg (small blind) folded before Flop
Seat 7: V6p0jQ/RhUsqpHLmXvEX4Q (big blind) collected ($4.90)
Seat 9: DiSvPC2iudwL5j9u6Huyww folded before Flop (didn't bet)




PokerStars Game #59941897046:  Hold'em No Limit ($0.10/$0.25) - 2009/07/01 1:49:38 ET
Table 'aT31tt16YvQM/Ue69HPLpA' 9-max Seat #4 is the button
Seat 2: PdIasPkzm2sqZnN41ZRXOg ($4.65 in chips) 
Seat 3: swK30YlQuxRQO7QFr4ZxCA ($25 in chips) 
Seat 4: wGigCmBR/9XWkPpvYos3aQ ($26.25 in chips) 
Seat 5: s2xLPOl/vhl/26apJ3vsOQ ($33.65 in chips) 
Seat 6: ghG12/paEL5VoDN85sW6RA ($15 in chips) 
Seat 7: W8cIfrCR+zA8pCNyIuHu8g ($38.90 in chips) 
Seat 8: W6tExOcYX7qiy6Qdp+ZwFA ($4.65 in chips) 
Seat 9: TvIuLx9zUCE+9Li58iImOQ ($13.95 in chips) 
s2xLPOl/vhl/26apJ3vsOQ: posts small blind $0.10
ghG12/paEL5VoDN85sW6RA: posts big blind $0.25
wxmepRUXfX1jdQfUD5uENQ: sits out 
swK30YlQuxRQO7QFr4ZxCA: posts big blind $0.25
*** HOLE CARDS ***
W8cIfrCR+zA8pCNyIuHu8g: folds 
W6tExOcYX7qiy6Qdp+ZwFA: folds 
TvIuLx9zUCE+9Li58iImOQ: folds 
PdIasPkzm2sqZnN41ZRXOg: folds 
swK30YlQuxRQO7QFr4ZxCA: checks 
wGigCmBR/9XWkPpvYos3aQ: folds 
s2xLPOl/vhl/26apJ3vsOQ: folds 
ghG12/paEL5VoDN85sW6RA: checks 
*** FLOP *** [7s Kd 8h]
ghG12/paEL5VoDN85sW6RA: checks 
swK30YlQuxRQO7QFr4ZxCA: bets $0.25
ghG12/paEL5VoDN85sW6RA: folds 
Uncalled bet ($0.25) returned to swK30YlQuxRQO7QFr4ZxCA
swK30YlQuxRQO7QFr4ZxCA collected $0.60 from pot
*** SUMMARY ***
Total pot $0.60 | Rake $0 
Board [7s Kd 8h]
Seat 2: PdIasPkzm2sqZnN41ZRXOg folded before Flop (didn't bet)
Seat 3: swK30YlQuxRQO7QFr4ZxCA collected ($0.60)
Seat 4: wGigCmBR/9XWkPpvYos3aQ (button) folded before Flop (didn't bet)
Seat 5: s2xLPOl/vhl/26apJ3vsOQ (small blind) folded before Flop
Seat 6: ghG12/paEL5VoDN85sW6RA (big blind) folded on the Flop
Seat 7: W8cIfrCR+zA8pCNyIuHu8g folded before Flop (didn't bet)
Seat 8: W6tExOcYX7qiy6Qdp+ZwFA folded before Flop (didn't bet)
Seat 9: TvIuLx9zUCE+9Li58iImOQ folded before Flop (didn't bet)




PokerStars Game #59941897044:  Hold'em No Limit ($0.10/$0.25) - 2009/07/01 1:49:38 ET
Table '84TjTrgbsYZladOc4PWf4Q' 6-max Seat #1 is the button
Seat 1: /kW0t5kKllzd8HO2uEapHQ ($17.20 in chips) 
Seat 2: RpaEX9P7BCvyfPRLiRNg0A ($48.10 in chips) 
Seat 3: Ar4vsUIUfJ7gbYh1c1m59g ($11.20 in chips) 
Seat 4: SxIIgwXYLkwd6m3wLyPTCw ($25 in chips) 
Seat 5: cezpHJ8FB07dj0xG+LhOvw ($29.15 in chips) 
Seat 6: wCUaomJ6Nq5zomVGdUHP+w ($15.15 in chips) 
RpaEX9P7BCvyfPRLiRNg0A: posts small blind $0.10
Ar4vsUIUfJ7gbYh1c1m59g: posts big blind $0.25
*** HOLE CARDS ***
SxIIgwXYLkwd6m3wLyPTCw: raises $0.50 to $0.75
cezpHJ8FB07dj0xG+LhOvw: folds 
wCUaomJ6Nq5zomVGdUHP+w: calls $0.75
/kW0t5kKllzd8HO2uEapHQ: folds 
RpaEX9P7BCvyfPRLiRNg0A: calls $0.65
Ar4vsUIUfJ7gbYh1c1m59g: folds 
*** FLOP *** [2s 6d Td]
RpaEX9P7BCvyfPRLiRNg0A: checks 
SxIIgwXYLkwd6m3wLyPTCw: bets $1.75
wCUaomJ6Nq5zomVGdUHP+w: calls $1.75
RpaEX9P7BCvyfPRLiRNg0A: folds 
*** TURN *** [2s 6d Td] [9c]
SxIIgwXYLkwd6m3wLyPTCw: bets $3.50
wCUaomJ6Nq5zomVGdUHP+w: calls $3.50
*** RIVER *** [2s 6d Td 9c] [Kc]
SxIIgwXYLkwd6m3wLyPTCw: bets $0.25
wCUaomJ6Nq5zomVGdUHP+w: calls $0.25
*** SHOW DOWN ***
SxIIgwXYLkwd6m3wLyPTCw: shows [Js Ac] (high card Ace)
wCUaomJ6Nq5zomVGdUHP+w: shows [Kd 4d] (a pair of Kings)
wCUaomJ6Nq5zomVGdUHP+w collected $12.90 from pot
*** SUMMARY ***
Total pot $13.50 | Rake $0.60 
Board [2s 6d Td 9c Kc]
Seat 1: /kW0t5kKllzd8HO2uEapHQ (button) folded before Flop (didn't bet)
Seat 2: RpaEX9P7BCvyfPRLiRNg0A (small blind) folded on the Flop
Seat 3: Ar4vsUIUfJ7gbYh1c1m59g (big blind) folded before Flop
Seat 4: SxIIgwXYLkwd6m3wLyPTCw showed [Js Ac] and lost with high card Ace
Seat 5: cezpHJ8FB07dj0xG+LhOvw folded before Flop (didn't bet)
Seat 6: wCUaomJ6Nq5zomVGdUHP+w showed [Kd 4d] and won ($12.90) with a pair of Kings




PokerStars Game #59941897344:  Hold'em No Limit ($0.10/$0.25) - 2009/07/01 1:49:39 ET
Table 'FuFyQHmlO/QqQp//rDRrPg' 6-max Seat #3 is the button
Seat 1: jp34e617tIzV8tKIWmfAbA ($28.15 in chips) 
Seat 2: G3h3THGB1j3qdHDVHpnJWg ($37.20 in chips) 
Seat 3: EeUZtMU058v2ObUACOF4Og ($29.25 in chips) 
Seat 4: Ahsa9Yk5NPmCqQstq1EoQA ($15.15 in chips) 
Seat 5: xrf8tAXKQHG99HixCot1Iw ($25.25 in chips) 
Seat 6: 6DwBRH+xZ12AAZmeAg+aXw ($51.10 in chips) 
Ahsa9Yk5NPmCqQstq1EoQA: posts small blind $0.10
xrf8tAXKQHG99HixCot1Iw: posts big blind $0.25
*** HOLE CARDS ***
6DwBRH+xZ12AAZmeAg+aXw: raises $0.50 to $0.75
jp34e617tIzV8tKIWmfAbA: folds 
G3h3THGB1j3qdHDVHpnJWg: folds 
EeUZtMU058v2ObUACOF4Og: folds 
Ahsa9Yk5NPmCqQstq1EoQA: calls $0.65
xrf8tAXKQHG99HixCot1Iw: calls $0.50
*** FLOP *** [7s 3c As]
Ahsa9Yk5NPmCqQstq1EoQA: checks 
xrf8tAXKQHG99HixCot1Iw: bets $1.25
6DwBRH+xZ12AAZmeAg+aXw: folds 
Ahsa9Yk5NPmCqQstq1EoQA: folds 
Uncalled bet ($1.25) returned to xrf8tAXKQHG99HixCot1Iw
xrf8tAXKQHG99HixCot1Iw collected $2.15 from pot
xrf8tAXKQHG99HixCot1Iw: doesn't show hand 
*** SUMMARY ***
Total pot $2.25 | Rake $0.10 
Board [7s 3c As]
Seat 1: jp34e617tIzV8tKIWmfAbA folded before Flop (didn't bet)
Seat 2: G3h3THGB1j3qdHDVHpnJWg folded before Flop (didn't bet)
Seat 3: EeUZtMU058v2ObUACOF4Og (button) folded before Flop (didn't bet)
Seat 4: Ahsa9Yk5NPmCqQstq1EoQA (small blind) folded on the Flop
Seat 5: xrf8tAXKQHG99HixCot1Iw (big blind) collected ($2.15)
Seat 6: 6DwBRH+xZ12AAZmeAg+aXw folded on the Flop




PokerStars Game #59941897342:  Hold'em No Limit ($0.10/$0.25) - 2009/07/01 1:49:39 ET
Table 'IRgQPZVA4+IaZZIQshgwyg' 6-max Seat #3 is the button
Seat 1: cezpHJ8FB07dj0xG+LhOvw ($27.55 in chips) 
Seat 2: lquriepNQBhDV5P1SWHhnA ($28.70 in chips) 
Seat 3: DihMHaz4WNETH1bPDe13kA ($27.45 in chips) 
Seat 4: DE9hRlt14g+JdsRQ4wT7hg ($25.70 in chips) 
Seat 5: w43JQj2oYPpKQVG4Yzlq1w ($25 in chips) 
Seat 6: x9/USY6PsmgUGQeluFLKDw ($21.30 in chips) 
DE9hRlt14g+JdsRQ4wT7hg: posts small blind $0.10
w43JQj2oYPpKQVG4Yzlq1w: posts big blind $0.25
*** HOLE CARDS ***
x9/USY6PsmgUGQeluFLKDw: folds 
cezpHJ8FB07dj0xG+LhOvw: folds 
lquriepNQBhDV5P1SWHhnA: folds 
DihMHaz4WNETH1bPDe13kA: folds 
DE9hRlt14g+JdsRQ4wT7hg: folds 
Uncalled bet ($0.15) returned to w43JQj2oYPpKQVG4Yzlq1w
w43JQj2oYPpKQVG4Yzlq1w collected $0.20 from pot
w43JQj2oYPpKQVG4Yzlq1w: doesn't show hand 
*** SUMMARY ***
Total pot $0.20 | Rake $0 
Seat 1: cezpHJ8FB07dj0xG+LhOvw folded before Flop (didn't bet)
Seat 2: lquriepNQBhDV5P1SWHhnA folded before Flop (didn't bet)
Seat 3: DihMHaz4WNETH1bPDe13kA (button) folded before Flop (didn't bet)
Seat 4: DE9hRlt14g+JdsRQ4wT7hg (small blind) folded before Flop
Seat 5: w43JQj2oYPpKQVG4Yzlq1w (big blind) collected ($0.20)
Seat 6: x9/USY6PsmgUGQeluFLKDw folded before Flop (didn't bet)




PokerStars Game #59941897716:  Hold'em No Limit ($0.10/$0.25) - 2009/07/01 1:49:39 ET
Table 'MRfAiS/4JSfnUDlCcZo0wAhfHe8uKeSJMyWAjSdM7ROQx Seat #6 is the button
Seat 1: 48oT5xFI+5CHUJlfoGrE4w ($29.65 in chips) 
Seat 2: /gJNBeCkWL4o85/jvlZ4BA ($26.35 in chips) 
Seat 3: FYepjhAvF8ZdVCmqHIy+eQ ($38.85 in chips) 
Seat 4: b4wRQV3APH8irVk6bUFe2Q ($36.95 in chips) 
Seat 5: Q1uciOZPBR/WkAlqa6cL4A ($27.85 in chips) 
Seat 6: df01R5ThvHspD8FgKmaDvQ ($25 in chips) 
48oT5xFI+5CHUJlfoGrE4w: posts small blind $0.10
/gJNBeCkWL4o85/jvlZ4BA: posts big blind $0.25
*** HOLE CARDS ***
FYepjhAvF8ZdVCmqHIy+eQ: raises $0.75 to $1
b4wRQV3APH8irVk6bUFe2Q: folds 
Q1uciOZPBR/WkAlqa6cL4A: folds 
df01R5ThvHspD8FgKmaDvQ: folds 
48oT5xFI+5CHUJlfoGrE4w: folds 
/gJNBeCkWL4o85/jvlZ4BA: folds 
Uncalled bet ($0.75) returned to FYepjhAvF8ZdVCmqHIy+eQ
FYepjhAvF8ZdVCmqHIy+eQ collected $0.60 from pot
FYepjhAvF8ZdVCmqHIy+eQ: doesn't show hand 
*** SUMMARY ***
Total pot $0.60 | Rake $0 
Seat 1: 48oT5xFI+5CHUJlfoGrE4w (small blind) folded before Flop
Seat 2: /gJNBeCkWL4o85/jvlZ4BA (big blind) folded before Flop
Seat 3: FYepjhAvF8ZdVCmqHIy+eQ collected ($0.60)
Seat 4: b4wRQV3APH8irVk6bUFe2Q folded before Flop (didn't bet)
Seat 5: Q1uciOZPBR/WkAlqa6cL4A folded before Flop (didn't bet)
Seat 6: df01R5ThvHspD8FgKmaDvQ (button) folded before Flop (didn't bet)




PokerStars Game #59941897662:  Hold'em No Limit ($0.10/$0.25) - 2009/07/01 1:49:39 ET
Table '29D3eoQzK5kOAT0OIDS2uQ' 6-max Seat #1 is the button
Seat 1: kG34n23qFQA3nzdOJTQ1dA ($46.15 in chips) 
Seat 2: FyE+TQ5JcCqI/tCCHf0jGA ($17.45 in chips) 
Seat 3: z3tQwy28dp5FykDJC/wzQw ($17.20 in chips) 
Seat 4: MqMK8OWPSY1V4stf1Hy5Jw ($64.70 in chips) 
Seat 5: Q3EMN7b0ie81AFWkDrhCjw ($21.60 in chips) 
FyE+TQ5JcCqI/tCCHf0jGA: posts small blind $0.10
z3tQwy28dp5FykDJC/wzQw: posts big blind $0.25
*** HOLE CARDS ***
MqMK8OWPSY1V4stf1Hy5Jw: folds 
Q3EMN7b0ie81AFWkDrhCjw: raises $0.50 to $0.75
kG34n23qFQA3nzdOJTQ1dA: calls $0.75
FyE+TQ5JcCqI/tCCHf0jGA: calls $0.65
z3tQwy28dp5FykDJC/wzQw said, "nice call"
z3tQwy28dp5FykDJC/wzQw: calls $0.50
*** FLOP *** [3s Kd 7h]
FyE+TQ5JcCqI/tCCHf0jGA: checks 
z3tQwy28dp5FykDJC/wzQw: bets $0.75
Q3EMN7b0ie81AFWkDrhCjw: calls $0.75
kG34n23qFQA3nzdOJTQ1dA: calls $0.75
FyE+TQ5JcCqI/tCCHf0jGA: folds 
*** TURN *** [3s Kd 7h] [6c]
bWbV4MVB/vVpiES1Ut4hew has returned
z3tQwy28dp5FykDJC/wzQw: checks 
Q3EMN7b0ie81AFWkDrhCjw: bets $1.50
kG34n23qFQA3nzdOJTQ1dA: calls $1.50
z3tQwy28dp5FykDJC/wzQw: folds 
*** RIVER *** [3s Kd 7h 6c] [Kh]
Q3EMN7b0ie81AFWkDrhCjw: bets $3
kG34n23qFQA3nzdOJTQ1dA: folds 
Uncalled bet ($3) returned to Q3EMN7b0ie81AFWkDrhCjw
Q3EMN7b0ie81AFWkDrhCjw collected $7.85 from pot
*** SUMMARY ***
Total pot $8.25 | Rake $0.40 
Board [3s Kd 7h 6c Kh]
Seat 1: kG34n23qFQA3nzdOJTQ1dA (button) folded on the River
Seat 2: FyE+TQ5JcCqI/tCCHf0jGA (small blind) folded on the Flop
Seat 3: z3tQwy28dp5FykDJC/wzQw (big blind) folded on the Turn
Seat 4: MqMK8OWPSY1V4stf1Hy5Jw folded before Flop (didn't bet)
Seat 5: Q3EMN7b0ie81AFWkDrhCjw collected ($7.85)




PokerStars Game #59941897892:  Hold'em No Limit ($0.10/$0.25) - 2009/07/01 1:49:40 ET
Table '3EebBlzq5yHSY2444L4zlg' 9-max Seat #9 is the button
Seat 1: XMSS6mD5B42I8wasdOMipQ ($29.25 in chips) 
Seat 2: b9UnopCOpq2MWP1DwqSO3Q ($17.70 in chips) 
Seat 3: IGbD5vKNhHe60dkdbjg/mw ($17.65 in chips) 
Seat 5: PFNLAvMkr8qKc7xCiH0wTA ($51.95 in chips) 
Seat 6: QEbIGci+itdw+re8RM5fZA ($50 in chips) 
Seat 7: DiSvPC2iudwL5j9u6Huyww ($48.35 in chips) 
Seat 8: dtZ84flFEi4Q+SGrHMJRDQ ($28.70 in chips) 
Seat 9: iZmSlSzYu5fJ67tDdQzymQ ($24.90 in chips) 
XMSS6mD5B42I8wasdOMipQ: posts small blind $0.10
b9UnopCOpq2MWP1DwqSO3Q: posts big blind $0.25
PdIasPkzm2sqZnN41ZRXOg: sits out 
*** HOLE CARDS ***
IGbD5vKNhHe60dkdbjg/mw: folds 
PFNLAvMkr8qKc7xCiH0wTA: folds 
QEbIGci+itdw+re8RM5fZA: folds 
IGbD5vKNhHe60dkdbjg/mw leaves the table
DiSvPC2iudwL5j9u6Huyww: raises $0.75 to $1
dtZ84flFEi4Q+SGrHMJRDQ: folds 
18G4P1XstjNvItdGUITxgw joins the table at seat #3 
iZmSlSzYu5fJ67tDdQzymQ: calls $1
XMSS6mD5B42I8wasdOMipQ: folds 
b9UnopCOpq2MWP1DwqSO3Q: folds 
*** FLOP *** [Tc Qh Td]
DiSvPC2iudwL5j9u6Huyww: checks 
iZmSlSzYu5fJ67tDdQzymQ: checks 
*** TURN *** [Tc Qh Td] [Jh]
DiSvPC2iudwL5j9u6Huyww: bets $1
iZmSlSzYu5fJ67tDdQzymQ: folds 
Uncalled bet ($1) returned to DiSvPC2iudwL5j9u6Huyww
DiSvPC2iudwL5j9u6Huyww collected $2.25 from pot
DiSvPC2iudwL5j9u6Huyww: doesn't show hand 
*** SUMMARY ***
Total pot $2.35 | Rake $0.10 
Board [Tc Qh Td Jh]
Seat 1: XMSS6mD5B42I8wasdOMipQ (small blind) folded before Flop
Seat 2: b9UnopCOpq2MWP1DwqSO3Q (big blind) folded before Flop
Seat 3: IGbD5vKNhHe60dkdbjg/mw folded before Flop (didn't bet)
Seat 5: PFNLAvMkr8qKc7xCiH0wTA folded before Flop (didn't bet)
Seat 6: QEbIGci+itdw+re8RM5fZA folded before Flop (didn't bet)
Seat 7: DiSvPC2iudwL5j9u6Huyww collected ($2.25)
Seat 8: dtZ84flFEi4Q+SGrHMJRDQ folded before Flop (didn't bet)
Seat 9: iZmSlSzYu5fJ67tDdQzymQ (button) folded on the Turn




PokerStars Game #59941897866:  Hold'em No Limit ($0.10/$0.25) - 2009/07/01 1:49:40 ET
Table 'ROYvQOMwUrvL3SOiHYcrWg' 9-max Seat #5 is the button
Seat 1: 22dIObOuor/A+IKWkNoAlA ($5.40 in chips) 
Seat 2: gehe91e0IyVT0QU/XBkEyg ($25.15 in chips) 
Seat 3: 8EbrQ/EvFWt2cr0GaU82gQ ($5 in chips) 
Seat 4: SHegmCn8B0InbWE/zFlvOw ($26.30 in chips) 
Seat 5: 7je+LC5Mfs6nL8YBVh4frQ ($4.65 in chips) 
Seat 6: P+9ymZQ3ktpQu1bn7HIjew ($20.25 in chips) 
Seat 8: biJWLZ27fafNeBI2oT1KJw ($28.15 in chips) 
Seat 9: uhrboV251dcgYniYTdFIcA ($25.35 in chips) 
P+9ymZQ3ktpQu1bn7HIjew: posts small blind $0.10
tYsOBqdU1+x+yFI7zHO7hQ: is sitting out 
biJWLZ27fafNeBI2oT1KJw: posts big blind $0.25
*** HOLE CARDS ***
uhrboV251dcgYniYTdFIcA: raises $0.75 to $1
22dIObOuor/A+IKWkNoAlA: folds 
gehe91e0IyVT0QU/XBkEyg: folds 
8EbrQ/EvFWt2cr0GaU82gQ: folds 
SHegmCn8B0InbWE/zFlvOw: raises $1.50 to $2.50
7je+LC5Mfs6nL8YBVh4frQ: folds 
P+9ymZQ3ktpQu1bn7HIjew: folds 
biJWLZ27fafNeBI2oT1KJw: folds 
tYsOBqdU1+x+yFI7zHO7hQ leaves the table
uhrboV251dcgYniYTdFIcA: calls $1.50
*** FLOP *** [7s Ks 5d]
uhrboV251dcgYniYTdFIcA: checks 
18G4P1XstjNvItdGUITxgw joins the table at seat #7 
SHegmCn8B0InbWE/zFlvOw: bets $1.75
uhrboV251dcgYniYTdFIcA: calls $1.75
*** TURN *** [7s Ks 5d] [2s]
uhrboV251dcgYniYTdFIcA: checks 
SHegmCn8B0InbWE/zFlvOw: bets $2.50
uhrboV251dcgYniYTdFIcA: calls $2.50
*** RIVER *** [7s Ks 5d 2s] [4d]
uhrboV251dcgYniYTdFIcA: bets $9.25
SHegmCn8B0InbWE/zFlvOw: folds 
Uncalled bet ($9.25) returned to uhrboV251dcgYniYTdFIcA
uhrboV251dcgYniYTdFIcA collected $13.20 from pot
uhrboV251dcgYniYTdFIcA: doesn't show hand 
*** SUMMARY ***
Total pot $13.85 | Rake $0.65 
Board [7s Ks 5d 2s 4d]
Seat 1: 22dIObOuor/A+IKWkNoAlA folded before Flop (didn't bet)
Seat 2: gehe91e0IyVT0QU/XBkEyg folded before Flop (didn't bet)
Seat 3: 8EbrQ/EvFWt2cr0GaU82gQ folded before Flop (didn't bet)
Seat 4: SHegmCn8B0InbWE/zFlvOw folded on the River
Seat 5: 7je+LC5Mfs6nL8YBVh4frQ (button) folded before Flop (didn't bet)
Seat 6: P+9ymZQ3ktpQu1bn7HIjew (small blind) folded before Flop
Seat 8: biJWLZ27fafNeBI2oT1KJw (big blind) folded before Flop
Seat 9: uhrboV251dcgYniYTdFIcA collected ($13.20)




PokerStars Game #59941898232:  Hold'em No Limit ($0.10/$0.25) - 2009/07/01 1:49:40 ET
Table 'L5GvbdQO5aCZJSE6pyQ8OA' 6-max Seat #6 is the button
Seat 2: DihMHaz4WNETH1bPDe13kA ($30.65 in chips) 
Seat 3: JFIAqU8lCZ0vWwEl4bdGsg ($25.70 in chips) 
Seat 4: trN/oHqTTbPw5MNuKrOpLw ($26.60 in chips) 
Seat 5: LyDHtw3/yniNHW+DvLXbog ($29.25 in chips) 
Seat 6: v+QfkGiuj9bgtuNoVnDO8w ($38.70 in chips) 
eFj4lr1nuXLyCWNTShr1bg will be allowed to play after the button
DihMHaz4WNETH1bPDe13kA: posts small blind $0.10
JFIAqU8lCZ0vWwEl4bdGsg: posts big blind $0.25
*** HOLE CARDS ***
trN/oHqTTbPw5MNuKrOpLw: calls $0.25
LyDHtw3/yniNHW+DvLXbog: folds 
v+QfkGiuj9bgtuNoVnDO8w: folds 
DihMHaz4WNETH1bPDe13kA: folds 
JFIAqU8lCZ0vWwEl4bdGsg: checks 
*** FLOP *** [Td Qh 3h]
JFIAqU8lCZ0vWwEl4bdGsg: bets $0.60
trN/oHqTTbPw5MNuKrOpLw: raises $1.40 to $2
JFIAqU8lCZ0vWwEl4bdGsg: folds 
Uncalled bet ($1.40) returned to trN/oHqTTbPw5MNuKrOpLw
trN/oHqTTbPw5MNuKrOpLw collected $1.75 from pot
trN/oHqTTbPw5MNuKrOpLw: doesn't show hand 
*** SUMMARY ***
Total pot $1.80 | Rake $0.05 
Board [Td Qh 3h]
Seat 2: DihMHaz4WNETH1bPDe13kA (small blind) folded before Flop
Seat 3: JFIAqU8lCZ0vWwEl4bdGsg (big blind) folded on the Flop
Seat 4: trN/oHqTTbPw5MNuKrOpLw collected ($1.75)
Seat 5: LyDHtw3/yniNHW+DvLXbog folded before Flop (didn't bet)
Seat 6: v+QfkGiuj9bgtuNoVnDO8w (button) folded before Flop (didn't bet)




PokerStars Game #59941897822:  Hold'em No Limit ($0.10/$0.25) - 2009/07/01 1:49:40 ET
Table 'MJ1SB76A4qJrlEa+C5e/8w' 6-max Seat #1 is the button
Seat 1: 0KDZiuXQg6UI9cqBR/AUnQ ($20.80 in chips) 
Seat 2: UA5OsKS3VPaxa7uC8La/kA ($37.50 in chips) 
Seat 3: DihMHaz4WNETH1bPDe13kA ($32.55 in chips) 
Seat 4: SFmT9ZsVopnukjvAzrxTRg ($27.80 in chips) 
Seat 5: Hsvkc0/G2VV78oVmWYXecw ($5.25 in chips) 
Seat 6: JFIAqU8lCZ0vWwEl4bdGsg ($34.65 in chips) 
UA5OsKS3VPaxa7uC8La/kA: posts small blind $0.10
DihMHaz4WNETH1bPDe13kA: posts big blind $0.25
*** HOLE CARDS ***
SFmT9ZsVopnukjvAzrxTRg: raises $0.75 to $1
Hsvkc0/G2VV78oVmWYXecw: folds 
JFIAqU8lCZ0vWwEl4bdGsg: folds 
0KDZiuXQg6UI9cqBR/AUnQ: calls $1
UA5OsKS3VPaxa7uC8La/kA: folds 
DihMHaz4WNETH1bPDe13kA: folds 
*** FLOP *** [6c 2s 2d]
SFmT9ZsVopnukjvAzrxTRg: bets $1.50
0KDZiuXQg6UI9cqBR/AUnQ is disconnected 
0KDZiuXQg6UI9cqBR/AUnQ is connected 
0KDZiuXQg6UI9cqBR/AUnQ: calls $1.50
*** TURN *** [6c 2s 2d] [5h]
SFmT9ZsVopnukjvAzrxTRg: bets $3.50
0KDZiuXQg6UI9cqBR/AUnQ: folds 
Uncalled bet ($3.50) returned to SFmT9ZsVopnukjvAzrxTRg
SFmT9ZsVopnukjvAzrxTRg collected $5.10 from pot
SFmT9ZsVopnukjvAzrxTRg: doesn't show hand 
*** SUMMARY ***
Total pot $5.35 | Rake $0.25 
Board [6c 2s 2d 5h]
Seat 1: 0KDZiuXQg6UI9cqBR/AUnQ (button) folded on the Turn
Seat 2: UA5OsKS3VPaxa7uC8La/kA (small blind) folded before Flop
Seat 3: DihMHaz4WNETH1bPDe13kA (big blind) folded before Flop
Seat 4: SFmT9ZsVopnukjvAzrxTRg collected ($5.10)
Seat 5: Hsvkc0/G2VV78oVmWYXecw folded before Flop (didn't bet)
Seat 6: JFIAqU8lCZ0vWwEl4bdGsg folded before Flop (didn't bet)




PokerStars Game #59941897992:  Hold'em No Limit ($0.10/$0.25) - 2009/07/01 1:49:40 ET
Table 'nIRjSqm6RYUWJlyW2loYKA' 6-max Seat #3 is the button
Seat 1: w43JQj2oYPpKQVG4Yzlq1w ($25 in chips) 
Seat 2: NndRCAk4vU5JGDhTyy5LZg ($13.95 in chips) 
Seat 3: qjs7u/BI35gu5OgtqfLCZw ($12.30 in chips) 
Seat 4: /ZSSWvl8im2y38j1uEUAGA ($8 in chips) 
Seat 5: df01R5ThvHspD8FgKmaDvQ ($24.75 in chips) 
Seat 6: OIjOiBfQstWrK/RuXx7zcw ($6.85 in chips) 
/ZSSWvl8im2y38j1uEUAGA: posts small blind $0.10
df01R5ThvHspD8FgKmaDvQ: posts big blind $0.25
*** HOLE CARDS ***
OIjOiBfQstWrK/RuXx7zcw: folds 
w43JQj2oYPpKQVG4Yzlq1w: folds 
NndRCAk4vU5JGDhTyy5LZg: calls $0.25
qjs7u/BI35gu5OgtqfLCZw: raises $0.25 to $0.50
/ZSSWvl8im2y38j1uEUAGA: calls $0.40
df01R5ThvHspD8FgKmaDvQ: folds 
NndRCAk4vU5JGDhTyy5LZg: calls $0.25
*** FLOP *** [Ts 9s 8h]
/ZSSWvl8im2y38j1uEUAGA: bets $1
NndRCAk4vU5JGDhTyy5LZg: folds 
qjs7u/BI35gu5OgtqfLCZw: calls $1
*** TURN *** [Ts 9s 8h] [4h]
/ZSSWvl8im2y38j1uEUAGA: checks 
qjs7u/BI35gu5OgtqfLCZw: bets $2
/ZSSWvl8im2y38j1uEUAGA: calls $2
*** RIVER *** [Ts 9s 8h 4h] [Ad]
/ZSSWvl8im2y38j1uEUAGA: checks 
qjs7u/BI35gu5OgtqfLCZw: bets $2.50
/ZSSWvl8im2y38j1uEUAGA: folds 
Uncalled bet ($2.50) returned to qjs7u/BI35gu5OgtqfLCZw
qjs7u/BI35gu5OgtqfLCZw collected $7.40 from pot
qjs7u/BI35gu5OgtqfLCZw: doesn't show hand 
*** SUMMARY ***
Total pot $7.75 | Rake $0.35 
Board [Ts 9s 8h 4h Ad]
Seat 1: w43JQj2oYPpKQVG4Yzlq1w folded before Flop (didn't bet)
Seat 2: NndRCAk4vU5JGDhTyy5LZg folded on the Flop
Seat 3: qjs7u/BI35gu5OgtqfLCZw (button) collected ($7.40)
Seat 4: /ZSSWvl8im2y38j1uEUAGA (small blind) folded on the River
Seat 5: df01R5ThvHspD8FgKmaDvQ (big blind) folded before Flop
Seat 6: OIjOiBfQstWrK/RuXx7zcw folded before Flop (didn't bet)




PokerStars Game #59941898288:  Hold'em No Limit ($0.10/$0.25) - 2009/07/01 1:49:40 ET
Table 'AchTjdLS1zBUbH3ZIx6f0w' 6-max Seat #6 is the button
Seat 1: rZ0bUtoerhFGDUSRQMnFog ($29.80 in chips) 
Seat 2: kG34n23qFQA3nzdOJTQ1dA ($65.90 in chips) 
Seat 3: k9vn40MOqqb+xF+7GZ6v2g ($29 in chips) 
Seat 4: q6WfTUAD9mowIP63ASq2Dg ($31.20 in chips) 
Seat 5: 0av6tRNdi0Ui4f15L7gsVg ($23.90 in chips) 
Seat 6: epAUIB7h2FJXzUPRIvSkRA ($26 in chips) 
rZ0bUtoerhFGDUSRQMnFog: posts small blind $0.10
kG34n23qFQA3nzdOJTQ1dA: posts big blind $0.25
*** HOLE CARDS ***
k9vn40MOqqb+xF+7GZ6v2g: calls $0.25
q6WfTUAD9mowIP63ASq2Dg: calls $0.25
0av6tRNdi0Ui4f15L7gsVg: calls $0.25
epAUIB7h2FJXzUPRIvSkRA: calls $0.25
rZ0bUtoerhFGDUSRQMnFog: folds 
kG34n23qFQA3nzdOJTQ1dA: checks 
*** FLOP *** [7h 2d 4d]
kG34n23qFQA3nzdOJTQ1dA: checks 
k9vn40MOqqb+xF+7GZ6v2g: checks 
q6WfTUAD9mowIP63ASq2Dg: checks 
0av6tRNdi0Ui4f15L7gsVg: checks 
epAUIB7h2FJXzUPRIvSkRA: checks 
*** TURN *** [7h 2d 4d] [4h]
kG34n23qFQA3nzdOJTQ1dA: checks 
k9vn40MOqqb+xF+7GZ6v2g: checks 
q6WfTUAD9mowIP63ASq2Dg: checks 
0av6tRNdi0Ui4f15L7gsVg: checks 
epAUIB7h2FJXzUPRIvSkRA: checks 
*** RIVER *** [7h 2d 4d 4h] [7c]
kG34n23qFQA3nzdOJTQ1dA: checks 
k9vn40MOqqb+xF+7GZ6v2g: checks 
q6WfTUAD9mowIP63ASq2Dg: checks 
0av6tRNdi0Ui4f15L7gsVg: checks 
epAUIB7h2FJXzUPRIvSkRA: checks 
*** SHOW DOWN ***
kG34n23qFQA3nzdOJTQ1dA: shows [5s Qc] (two pair, Sevens and Fours)
k9vn40MOqqb+xF+7GZ6v2g: shows [Qh Ac] (two pair, Sevens and Fours - Ace kicker)
q6WfTUAD9mowIP63ASq2Dg: mucks hand 
0av6tRNdi0Ui4f15L7gsVg: mucks hand 
epAUIB7h2FJXzUPRIvSkRA: mucks hand 
k9vn40MOqqb+xF+7GZ6v2g collected $1.30 from pot
*** SUMMARY ***
Total pot $1.35 | Rake $0.05 
Board [7h 2d 4d 4h 7c]
Seat 1: rZ0bUtoerhFGDUSRQMnFog (small blind) folded before Flop
Seat 2: kG34n23qFQA3nzdOJTQ1dA (big blind) showed [5s Qc] and lost with two pair, Sevens and Fours
Seat 3: k9vn40MOqqb+xF+7GZ6v2g showed [Qh Ac] and won ($1.30) with two pair, Sevens and Fours
Seat 4: q6WfTUAD9mowIP63ASq2Dg mucked
Seat 5: 0av6tRNdi0Ui4f15L7gsVg mucked
Seat 6: epAUIB7h2FJXzUPRIvSkRA (button) mucked




PokerStars Game #59941897902:  Hold'em No Limit ($0.10/$0.25) - 2009/07/01 1:49:40 ET
Table 'WY+lMaAoIdBZmwk27/RJCA' 6-max Seat #3 is the button
Seat 1: zHHLkD2sRljslKKeQv/ZQw ($26.60 in chips) 
Seat 2: NhUN/JpAprdJeamFBgJH1w ($28.25 in chips) 
Seat 3: QqiZLFrN8iOUT/GHw7ztOA ($26.60 in chips) 
Seat 4: 0av6tRNdi0Ui4f15L7gsVg ($23.25 in chips) 
Seat 5: vqWjZmdQu/Hxw96/IJTWdQ ($27.95 in chips) 
Seat 6: cWc85bEzdRzpUMhRKm8pwQ ($26.10 in chips) 
0av6tRNdi0Ui4f15L7gsVg: posts small blind $0.10
vqWjZmdQu/Hxw96/IJTWdQ: posts big blind $0.25
*** HOLE CARDS ***
cWc85bEzdRzpUMhRKm8pwQ: folds 
zHHLkD2sRljslKKeQv/ZQw: folds 
NhUN/JpAprdJeamFBgJH1w: folds 
QqiZLFrN8iOUT/GHw7ztOA: folds 
0av6tRNdi0Ui4f15L7gsVg: folds 
Uncalled bet ($0.15) returned to vqWjZmdQu/Hxw96/IJTWdQ
vqWjZmdQu/Hxw96/IJTWdQ collected $0.20 from pot
vqWjZmdQu/Hxw96/IJTWdQ: doesn't show hand 
*** SUMMARY ***
Total pot $0.20 | Rake $0 
Seat 1: zHHLkD2sRljslKKeQv/ZQw folded before Flop (didn't bet)
Seat 2: NhUN/JpAprdJeamFBgJH1w folded before Flop (didn't bet)
Seat 3: QqiZLFrN8iOUT/GHw7ztOA (button) folded before Flop (didn't bet)
Seat 4: 0av6tRNdi0Ui4f15L7gsVg (small blind) folded before Flop
Seat 5: vqWjZmdQu/Hxw96/IJTWdQ (big blind) collected ($0.20)
Seat 6: cWc85bEzdRzpUMhRKm8pwQ folded before Flop (didn't bet)




PokerStars Game #59941898326:  Hold'em No Limit ($0.10/$0.25) - 2009/07/01 1:49:41 ET
Table '7/qMNloI0nSXWiX5Y1watA' 9-max Seat #9 is the button
Seat 1: /LyhaB3V6jkgOfXORidqRQ ($10.50 in chips) 
Seat 2: wGigCmBR/9XWkPpvYos3aQ ($25 in chips) 
Seat 3: W2YYHvqjaEpRrO7stZkClQ ($5 in chips) 
Seat 4: K0LdhPeU31rviEPo6Sv3TA ($9.35 in chips) 
Seat 8: ljemhp25Zg+nlA9DLCIiUw ($26.05 in chips) 
Seat 9: dmYlc+1cjwZMJ7wV+Z0rRg ($27.05 in chips) 
/LyhaB3V6jkgOfXORidqRQ: posts small blind $0.10
wGigCmBR/9XWkPpvYos3aQ: posts big blind $0.25
GeMoapCKDLc4ajT0Uk9ZQw: sits out 
*** HOLE CARDS ***
W2YYHvqjaEpRrO7stZkClQ: folds 
K0LdhPeU31rviEPo6Sv3TA: folds 
ljemhp25Zg+nlA9DLCIiUw: folds 
dmYlc+1cjwZMJ7wV+Z0rRg: raises $0.50 to $0.75
/LyhaB3V6jkgOfXORidqRQ: folds 
wGigCmBR/9XWkPpvYos3aQ: folds 
Uncalled bet ($0.50) returned to dmYlc+1cjwZMJ7wV+Z0rRg
dmYlc+1cjwZMJ7wV+Z0rRg collected $0.60 from pot
dmYlc+1cjwZMJ7wV+Z0rRg: doesn't show hand 
*** SUMMARY ***
Total pot $0.60 | Rake $0 
Seat 1: /LyhaB3V6jkgOfXORidqRQ (small blind) folded before Flop
Seat 2: wGigCmBR/9XWkPpvYos3aQ (big blind) folded before Flop
Seat 3: W2YYHvqjaEpRrO7stZkClQ folded before Flop (didn't bet)
Seat 4: K0LdhPeU31rviEPo6Sv3TA folded before Flop (didn't bet)
Seat 8: ljemhp25Zg+nlA9DLCIiUw folded before Flop (didn't bet)
Seat 9: dmYlc+1cjwZMJ7wV+Z0rRg (button) collected ($0.60)




PokerStars Game #59941898330:  Hold'em No Limit ($0.10/$0.25) - 2009/07/01 1:49:41 ET
Table 'a6FCGVBMPcT7J7BDN9q1zQ' 9-max Seat #9 is the button
Seat 1: bXpVeaSTPBFSPJmeXxO7nw ($4.75 in chips) 
Seat 2: M2QO2DxB5Wawg2h8HSpnYA ($13.45 in chips) 
Seat 3: tLcDklc2rBORNfixyRfVfw ($25 in chips) 
Seat 5: dtZ84flFEi4Q+SGrHMJRDQ ($25.80 in chips) 
Seat 6: dfNim92Z6XK1/h5SFW5vDg ($25 in chips) 
Seat 7: V0Yo5zRBVM8DYspLKafebg ($7.20 in chips) 
Seat 8: r6hsffOo1iKmaPYKwAZmFw ($64.35 in chips) 
Seat 9: wGigCmBR/9XWkPpvYos3aQ ($29.85 in chips) 
bXpVeaSTPBFSPJmeXxO7nw: posts small blind $0.10
M2QO2DxB5Wawg2h8HSpnYA: posts big blind $0.25
8EbrQ/EvFWt2cr0GaU82gQ: sits out 
*** HOLE CARDS ***
tLcDklc2rBORNfixyRfVfw: folds 
dtZ84flFEi4Q+SGrHMJRDQ: folds 
dfNim92Z6XK1/h5SFW5vDg: folds 
V0Yo5zRBVM8DYspLKafebg: calls $0.25
r6hsffOo1iKmaPYKwAZmFw: folds 
wGigCmBR/9XWkPpvYos3aQ: folds 
bXpVeaSTPBFSPJmeXxO7nw: folds 
M2QO2DxB5Wawg2h8HSpnYA: checks 
*** FLOP *** [Qs As 8h]
M2QO2DxB5Wawg2h8HSpnYA: checks 
V0Yo5zRBVM8DYspLKafebg: bets $1
M2QO2DxB5Wawg2h8HSpnYA: folds 
Uncalled bet ($1) returned to V0Yo5zRBVM8DYspLKafebg
V0Yo5zRBVM8DYspLKafebg collected $0.60 from pot
*** SUMMARY ***
Total pot $0.60 | Rake $0 
Board [Qs As 8h]
Seat 1: bXpVeaSTPBFSPJmeXxO7nw (small blind) folded before Flop
Seat 2: M2QO2DxB5Wawg2h8HSpnYA (big blind) folded on the Flop
Seat 3: tLcDklc2rBORNfixyRfVfw folded before Flop (didn't bet)
Seat 5: dtZ84flFEi4Q+SGrHMJRDQ folded before Flop (didn't bet)
Seat 6: dfNim92Z6XK1/h5SFW5vDg folded before Flop (didn't bet)
Seat 7: V0Yo5zRBVM8DYspLKafebg collected ($0.60)
Seat 8: r6hsffOo1iKmaPYKwAZmFw folded before Flop (didn't bet)
Seat 9: wGigCmBR/9XWkPpvYos3aQ (button) folded before Flop (didn't bet)




PokerStars Game #59941898350:  Hold'em No Limit ($0.10/$0.25) - 2009/07/01 1:49:41 ET
Table 'hOE09W281uSob0XeJmUcRg' 6-max Seat #5 is the button
Seat 1: mfrkWA3PTeYPkbO6hi98Aw ($26.95 in chips) 
Seat 2: lRKJ8o/CnOPFwfHHm6ioMw ($11.80 in chips) 
Seat 3: y+a/yGW/Jy4bPJFnaeTz5w ($12.60 in chips) 
Seat 5: JFIAqU8lCZ0vWwEl4bdGsg ($26.55 in chips) 
Seat 6: x4ZJ8E/TUrtoB7WiHcv8WA ($17.35 in chips) 
x4ZJ8E/TUrtoB7WiHcv8WA: posts small blind $0.10
mfrkWA3PTeYPkbO6hi98Aw: posts big blind $0.25
*** HOLE CARDS ***
lRKJ8o/CnOPFwfHHm6ioMw: folds 
y+a/yGW/Jy4bPJFnaeTz5w: calls $0.25
JFIAqU8lCZ0vWwEl4bdGsg: folds 
x4ZJ8E/TUrtoB7WiHcv8WA: raises $0.25 to $0.50
mfrkWA3PTeYPkbO6hi98Aw: folds 
y+a/yGW/Jy4bPJFnaeTz5w: calls $0.25
*** FLOP *** [Ah Qh 6d]
x4ZJ8E/TUrtoB7WiHcv8WA: bets $0.50
y+a/yGW/Jy4bPJFnaeTz5w: folds 
Uncalled bet ($0.50) returned to x4ZJ8E/TUrtoB7WiHcv8WA
x4ZJ8E/TUrtoB7WiHcv8WA collected $1.20 from pot
x4ZJ8E/TUrtoB7WiHcv8WA: doesn't show hand 
*** SUMMARY ***
Total pot $1.25 | Rake $0.05 
Board [Ah Qh 6d]
Seat 1: mfrkWA3PTeYPkbO6hi98Aw (big blind) folded before Flop
Seat 2: lRKJ8o/CnOPFwfHHm6ioMw folded before Flop (didn't bet)
Seat 3: y+a/yGW/Jy4bPJFnaeTz5w folded on the Flop
Seat 5: JFIAqU8lCZ0vWwEl4bdGsg (button) folded before Flop (didn't bet)
Seat 6: x4ZJ8E/TUrtoB7WiHcv8WA (small blind) collected ($1.20)




PokerStars Game #59941898332:  Hold'em No Limit ($0.10/$0.25) - 2009/07/01 1:49:41 ET
Table 'dZNBGqFYSwfOVZvDJ4VjIQ' 6-max Seat #1 is the button
Seat 1: v+QfkGiuj9bgtuNoVnDO8w ($38 in chips) 
Seat 2: 3zD3qLXT1bEffAoWGnc7wg ($28.05 in chips) 
Seat 3: kyRaCIljYA6l33lSKQfNsg ($29.35 in chips) 
Seat 5: +ZlnqPoP3Hg4BIUxDfKd/A ($29.10 in chips) 
Seat 6: ypmjhffk/YHGc51wgVXUTw ($29.05 in chips) 
3zD3qLXT1bEffAoWGnc7wg: posts small blind $0.10
kyRaCIljYA6l33lSKQfNsg: posts big blind $0.25
*** HOLE CARDS ***
+ZlnqPoP3Hg4BIUxDfKd/A: folds 
ypmjhffk/YHGc51wgVXUTw: folds 
v+QfkGiuj9bgtuNoVnDO8w: folds 
3zD3qLXT1bEffAoWGnc7wg: folds 
Uncalled bet ($0.15) returned to kyRaCIljYA6l33lSKQfNsg
kyRaCIljYA6l33lSKQfNsg collected $0.20 from pot
*** SUMMARY ***
Total pot $0.20 | Rake $0 
Seat 1: v+QfkGiuj9bgtuNoVnDO8w (button) folded before Flop (didn't bet)
Seat 2: 3zD3qLXT1bEffAoWGnc7wg (small blind) folded before Flop
Seat 3: kyRaCIljYA6l33lSKQfNsg (big blind) collected ($0.20)
Seat 5: +ZlnqPoP3Hg4BIUxDfKd/A folded before Flop (didn't bet)
Seat 6: ypmjhffk/YHGc51wgVXUTw folded before Flop (didn't bet)




PokerStars Game #59941898656:  Hold'em No Limit ($0.10/$0.25) - 2009/07/01 1:49:41 ET
Table 'ER5H84HUgJx7HyDLnELLeA' 6-max Seat #3 is the button
Seat 1: LJI7A1YgDM7hgh7o56+ReQ ($26.25 in chips) 
Seat 3: cS21pIxRHx5Gt42o7hPZzw ($13 in chips) 
Seat 4: vqWjZmdQu/Hxw96/IJTWdQ ($25 in chips) 
Seat 5: mfrkWA3PTeYPkbO6hi98Aw ($26.35 in chips) 
Seat 6: 3zD3qLXT1bEffAoWGnc7wg ($51.35 in chips) 
vqWjZmdQu/Hxw96/IJTWdQ: posts small blind $0.10
mfrkWA3PTeYPkbO6hi98Aw: posts big blind $0.25
*** HOLE CARDS ***
3zD3qLXT1bEffAoWGnc7wg: folds 
buyjetgNT1McXtdaP4zynA has returned
LJI7A1YgDM7hgh7o56+ReQ: folds 
cS21pIxRHx5Gt42o7hPZzw: folds 
vqWjZmdQu/Hxw96/IJTWdQ: folds 
Uncalled bet ($0.15) returned to mfrkWA3PTeYPkbO6hi98Aw
mfrkWA3PTeYPkbO6hi98Aw collected $0.20 from pot
mfrkWA3PTeYPkbO6hi98Aw: doesn't show hand 
*** SUMMARY ***
Total pot $0.20 | Rake $0 
Seat 1: LJI7A1YgDM7hgh7o56+ReQ folded before Flop (didn't bet)
Seat 3: cS21pIxRHx5Gt42o7hPZzw (button) folded before Flop (didn't bet)
Seat 4: vqWjZmdQu/Hxw96/IJTWdQ (small blind) folded before Flop
Seat 5: mfrkWA3PTeYPkbO6hi98Aw (big blind) collected ($0.20)
Seat 6: 3zD3qLXT1bEffAoWGnc7wg folded before Flop (didn't bet)




PokerStars Game #59941898826:  Hold'em No Limit ($0.10/$0.25) - 2009/07/01 1:49:41 ET
Table 'Xi38lWH8L2JHRAsKYVX8Qg' 6-max Seat #1 is the button
Seat 1: shP7DFAtX7gXcgMJX/OmRQ ($22.90 in chips) 
Seat 3: 6DwBRH+xZ12AAZmeAg+aXw ($31.30 in chips) 
Seat 4: kG34n23qFQA3nzdOJTQ1dA ($24.40 in chips) 
Seat 5: 79ID/ub1Pt/mDpCprVmOoA ($76.50 in chips) 
Seat 6: kyRaCIljYA6l33lSKQfNsg ($30.85 in chips) 
VOmI0x4dDPnTESZd5B4d1Q will be allowed to play after the button
6DwBRH+xZ12AAZmeAg+aXw: posts small blind $0.10
kG34n23qFQA3nzdOJTQ1dA: posts big blind $0.25
*** HOLE CARDS ***
79ID/ub1Pt/mDpCprVmOoA: folds 
kyRaCIljYA6l33lSKQfNsg: raises $0.50 to $0.75
shP7DFAtX7gXcgMJX/OmRQ: calls $0.75
6DwBRH+xZ12AAZmeAg+aXw: folds 
kG34n23qFQA3nzdOJTQ1dA: folds 
*** FLOP *** [2s 8s Td]
kyRaCIljYA6l33lSKQfNsg: checks 
shP7DFAtX7gXcgMJX/OmRQ: checks 
*** TURN *** [2s 8s Td] [Jc]
kyRaCIljYA6l33lSKQfNsg: checks 
shP7DFAtX7gXcgMJX/OmRQ: checks 
*** RIVER *** [2s 8s Td Jc] [9h]
kyRaCIljYA6l33lSKQfNsg: checks 
shP7DFAtX7gXcgMJX/OmRQ: bets $1
kyRaCIljYA6l33lSKQfNsg: folds 
Uncalled bet ($1) returned to shP7DFAtX7gXcgMJX/OmRQ
shP7DFAtX7gXcgMJX/OmRQ collected $1.80 from pot
shP7DFAtX7gXcgMJX/OmRQ: doesn't show hand 
*** SUMMARY ***
Total pot $1.85 | Rake $0.05 
Board [2s 8s Td Jc 9h]
Seat 1: shP7DFAtX7gXcgMJX/OmRQ (button) collected ($1.80)
Seat 3: 6DwBRH+xZ12AAZmeAg+aXw (small blind) folded before Flop
Seat 4: kG34n23qFQA3nzdOJTQ1dA (big blind) folded before Flop
Seat 5: 79ID/ub1Pt/mDpCprVmOoA folded before Flop (didn't bet)
Seat 6: kyRaCIljYA6l33lSKQfNsg folded on the River




PokerStars Game #59941898760:  Hold'em No Limit ($0.10/$0.25) - 2009/07/01 1:49:41 ET
Table '4mnXP0EWt9mMZYzTIVDQ0w' 9-max Seat #1 is the button
Seat 1: Z5y2J55JmfLYR6/DPAGHwQ ($17.10 in chips) 
Seat 2: BLEU2x2bnGRovIelAY6slA ($23.65 in chips) 
Seat 3: Ns4HpwO7Oiffvyla/ie56w ($14.65 in chips) 
Seat 4: 9lvO/qyU+xrU95Teu1fv0g ($11.10 in chips) 
Seat 5: sSN8Y0AlsBeidZXPKmwXSw ($25.10 in chips) 
Seat 6: 5yjzPss7Y4kAWNDat3e0yQ ($35.65 in chips) 
Seat 7: TtioUKOdJQDGtQyRAYC5Xg ($5.75 in chips) 
Seat 8: 9YN2IkT2JYYKFErZtZvCtA ($14.05 in chips) 
Seat 9: N/O9ADKpmqB2ASZuqgodlw ($8.90 in chips) 
BLEU2x2bnGRovIelAY6slA: posts small blind $0.10
Ns4HpwO7Oiffvyla/ie56w: posts big blind $0.25
*** HOLE CARDS ***
9lvO/qyU+xrU95Teu1fv0g: folds 
sSN8Y0AlsBeidZXPKmwXSw: folds 
5yjzPss7Y4kAWNDat3e0yQ: folds 
TtioUKOdJQDGtQyRAYC5Xg: folds 
9YN2IkT2JYYKFErZtZvCtA: folds 
N/O9ADKpmqB2ASZuqgodlw: folds 
Z5y2J55JmfLYR6/DPAGHwQ: folds 
BLEU2x2bnGRovIelAY6slA: calls $0.15
Ns4HpwO7Oiffvyla/ie56w: checks 
*** FLOP *** [8d 9d Qc]
BLEU2x2bnGRovIelAY6slA: checks 
Ns4HpwO7Oiffvyla/ie56w: checks 
*** TURN *** [8d 9d Qc] [2c]
BLEU2x2bnGRovIelAY6slA: checks 
Ns4HpwO7Oiffvyla/ie56w: bets $0.25
BLEU2x2bnGRovIelAY6slA: calls $0.25
*** RIVER *** [8d 9d Qc 2c] [7h]
BLEU2x2bnGRovIelAY6slA: bets $1
Ns4HpwO7Oiffvyla/ie56w: calls $1
*** SHOW DOWN ***
BLEU2x2bnGRovIelAY6slA: shows [5s 6h] (a straight, Five to Nine)
Ns4HpwO7Oiffvyla/ie56w: mucks hand 
BLEU2x2bnGRovIelAY6slA collected $2.90 from pot
*** SUMMARY ***
Total pot $3 | Rake $0.10 
Board [8d 9d Qc 2c 7h]
Seat 1: Z5y2J55JmfLYR6/DPAGHwQ (button) folded before Flop (didn't bet)
Seat 2: BLEU2x2bnGRovIelAY6slA (small blind) showed [5s 6h] and won ($2.90) with a straight, Five to Nine
Seat 3: Ns4HpwO7Oiffvyla/ie56w (big blind) mucked
Seat 4: 9lvO/qyU+xrU95Teu1fv0g folded before Flop (didn't bet)
Seat 5: sSN8Y0AlsBeidZXPKmwXSw folded before Flop (didn't bet)
Seat 6: 5yjzPss7Y4kAWNDat3e0yQ folded before Flop (didn't bet)
Seat 7: TtioUKOdJQDGtQyRAYC5Xg folded before Flop (didn't bet)
Seat 8: 9YN2IkT2JYYKFErZtZvCtA folded before Flop (didn't bet)
Seat 9: N/O9ADKpmqB2ASZuqgodlw folded before Flop (didn't bet)




PokerStars Game #59941898456:  Hold'em No Limit ($0.10/$0.25) - 2009/07/01 1:49:41 ET
Table 'IrJPyZ3JW2iIa+krdoSbJQ' 9-max Seat #1 is the button
Seat 1: Bb42QRQMhg5/Y0vHP8/2Xw ($25.90 in chips) 
Seat 2: X78b5v/uhqeXXoAijbw/yg ($42.70 in chips) 
Seat 3: CT7Xj/V/O5rBlhtt+RZeFQ ($25 in chips) 
Seat 4: bXpVeaSTPBFSPJmeXxO7nw ($4.65 in chips) 
Seat 5: tLcDklc2rBORNfixyRfVfw ($30.65 in chips) 
Seat 6: +sbyWwIcFp9kP0bDtMegfQ ($24.60 in chips) 
Seat 7: ozqb9Z1ZOsDwxxq9IKmjUA ($9.75 in chips) 
Seat 8: zZqOSFjPK4R4cwx0dONetw ($15 in chips) 
Seat 9: Mh2r9hTeTEDnh19sRZtW3g ($9.55 in chips) 
X78b5v/uhqeXXoAijbw/yg: posts small blind $0.10
CT7Xj/V/O5rBlhtt+RZeFQ: posts big blind $0.25
*** HOLE CARDS ***
bXpVeaSTPBFSPJmeXxO7nw: folds 
tLcDklc2rBORNfixyRfVfw: folds 
+sbyWwIcFp9kP0bDtMegfQ: folds 
ozqb9Z1ZOsDwxxq9IKmjUA: calls $0.25
zZqOSFjPK4R4cwx0dONetw: folds 
Mh2r9hTeTEDnh19sRZtW3g: folds 
Bb42QRQMhg5/Y0vHP8/2Xw: folds 
X78b5v/uhqeXXoAijbw/yg: folds 
CT7Xj/V/O5rBlhtt+RZeFQ: checks 
*** FLOP *** [5h As 7s]
CT7Xj/V/O5rBlhtt+RZeFQ: checks 
ozqb9Z1ZOsDwxxq9IKmjUA: checks 
*** TURN *** [5h As 7s] [6s]
CT7Xj/V/O5rBlhtt+RZeFQ: checks 
ozqb9Z1ZOsDwxxq9IKmjUA: checks 
*** RIVER *** [5h As 7s 6s] [3d]
CT7Xj/V/O5rBlhtt+RZeFQ: checks 
ozqb9Z1ZOsDwxxq9IKmjUA: checks 
*** SHOW DOWN ***
CT7Xj/V/O5rBlhtt+RZeFQ: shows [9d 9h] (a pair of Nines)
ozqb9Z1ZOsDwxxq9IKmjUA: mucks hand 
CT7Xj/V/O5rBlhtt+RZeFQ collected $0.60 from pot
*** SUMMARY ***
Total pot $0.60 | Rake $0 
Board [5h As 7s 6s 3d]
Seat 1: Bb42QRQMhg5/Y0vHP8/2Xw (button) folded before Flop (didn't bet)
Seat 2: X78b5v/uhqeXXoAijbw/yg (small blind) folded before Flop
Seat 3: CT7Xj/V/O5rBlhtt+RZeFQ (big blind) showed [9d 9h] and won ($0.60) with a pair of Nines
Seat 4: bXpVeaSTPBFSPJmeXxO7nw folded before Flop (didn't bet)
Seat 5: tLcDklc2rBORNfixyRfVfw folded before Flop (didn't bet)
Seat 6: +sbyWwIcFp9kP0bDtMegfQ folded before Flop (didn't bet)
Seat 7: ozqb9Z1ZOsDwxxq9IKmjUA mucked
Seat 8: zZqOSFjPK4R4cwx0dONetw folded before Flop (didn't bet)
Seat 9: Mh2r9hTeTEDnh19sRZtW3g folded before Flop (didn't bet)




PokerStars Game #59941899368:  Hold'em No Limit ($0.10/$0.25) - 2009/07/01 1:49:42 ET
Table 'vud0GB/ZlDCvUFhBFIaTlg' 9-max Seat #5 is the button
Seat 1: DiSvPC2iudwL5j9u6Huyww ($29.50 in chips) 
Seat 2: tLcDklc2rBORNfixyRfVfw ($25 in chips) 
Seat 3: W2YYHvqjaEpRrO7stZkClQ ($5.05 in chips) 
Seat 5: eK8qa6EPcH2zhtbmWSvc9g ($25.50 in chips) 
Seat 6: gehe91e0IyVT0QU/XBkEyg ($25 in chips) 
Seat 7: iG7VeTyBWf6wYNvZpbTcbw ($21.30 in chips) 
Seat 8: E0iYnEVO2ho7dH3QcCjw7g ($19.75 in chips) 
Seat 9: PdIasPkzm2sqZnN41ZRXOg ($5.20 in chips) 
gehe91e0IyVT0QU/XBkEyg: posts small blind $0.10
iG7VeTyBWf6wYNvZpbTcbw: posts big blind $0.25
*** HOLE CARDS ***
E0iYnEVO2ho7dH3QcCjw7g: folds 
aintblinkin joins the table at seat #4 
PdIasPkzm2sqZnN41ZRXOg: folds 
DiSvPC2iudwL5j9u6Huyww: folds 
tLcDklc2rBORNfixyRfVfw: folds 
W2YYHvqjaEpRrO7stZkClQ: folds 
eK8qa6EPcH2zhtbmWSvc9g: folds 
gehe91e0IyVT0QU/XBkEyg: folds 
Uncalled bet ($0.15) returned to iG7VeTyBWf6wYNvZpbTcbw
iG7VeTyBWf6wYNvZpbTcbw collected $0.20 from pot
*** SUMMARY ***
Total pot $0.20 | Rake $0 
Seat 1: DiSvPC2iudwL5j9u6Huyww folded before Flop (didn't bet)
Seat 2: tLcDklc2rBORNfixyRfVfw folded before Flop (didn't bet)
Seat 3: W2YYHvqjaEpRrO7stZkClQ folded before Flop (didn't bet)
Seat 5: eK8qa6EPcH2zhtbmWSvc9g (button) folded before Flop (didn't bet)
Seat 6: gehe91e0IyVT0QU/XBkEyg (small blind) folded before Flop
Seat 7: iG7VeTyBWf6wYNvZpbTcbw (big blind) collected ($0.20)
Seat 8: E0iYnEVO2ho7dH3QcCjw7g folded before Flop (didn't bet)
Seat 9: PdIasPkzm2sqZnN41ZRXOg folded before Flop (didn't bet)




PokerStars Game #59941898968:  Hold'em No Limit ($0.10/$0.25) - 2009/07/01 1:49:42 ET
Table '9iHhO6FyZVM8XpSc23TIgg' 6-max Seat #1 is the button
Seat 1: NhUN/JpAprdJeamFBgJH1w ($37.30 in chips) 
Seat 2: bJFzs6QmEEnz4miMfSDtcg ($33.75 in chips) 
Seat 3: TSmua8tGK3sTbwi0ynrW9Q ($25.25 in chips) 
Seat 4: cfJccEfyn6IkquPN08hFsA ($25.40 in chips) 
Seat 5: OMGl+YMGogf2JWIRfT2/Yg ($10 in chips) 
Seat 6: iyZxqznXjv3vtvOJymkoLQ ($33.85 in chips) 
bJFzs6QmEEnz4miMfSDtcg: posts small blind $0.10
TSmua8tGK3sTbwi0ynrW9Q: posts big blind $0.25
*** HOLE CARDS ***
cfJccEfyn6IkquPN08hFsA: folds 
OMGl+YMGogf2JWIRfT2/Yg: folds 
iyZxqznXjv3vtvOJymkoLQ: folds 
NhUN/JpAprdJeamFBgJH1w: raises $0.75 to $1
bJFzs6QmEEnz4miMfSDtcg: calls $0.90
TSmua8tGK3sTbwi0ynrW9Q: calls $0.75
*** FLOP *** [5h Ks 2d]
bJFzs6QmEEnz4miMfSDtcg: checks 
TSmua8tGK3sTbwi0ynrW9Q: checks 
NhUN/JpAprdJeamFBgJH1w: bets $2
bJFzs6QmEEnz4miMfSDtcg: folds 
TSmua8tGK3sTbwi0ynrW9Q: calls $2
*** TURN *** [5h Ks 2d] [9h]
TSmua8tGK3sTbwi0ynrW9Q: checks 
NhUN/JpAprdJeamFBgJH1w: checks 
*** RIVER *** [5h Ks 2d 9h] [4d]
TSmua8tGK3sTbwi0ynrW9Q: bets $4
NhUN/JpAprdJeamFBgJH1w has timed out
NhUN/JpAprdJeamFBgJH1w: folds 
Uncalled bet ($4) returned to TSmua8tGK3sTbwi0ynrW9Q
NhUN/JpAprdJeamFBgJH1w is sitting out
TSmua8tGK3sTbwi0ynrW9Q collected $6.70 from pot
*** SUMMARY ***
Total pot $7 | Rake $0.30 
Board [5h Ks 2d 9h 4d]
Seat 1: NhUN/JpAprdJeamFBgJH1w (button) folded on the River
Seat 2: bJFzs6QmEEnz4miMfSDtcg (small blind) folded on the Flop
Seat 3: TSmua8tGK3sTbwi0ynrW9Q (big blind) collected ($6.70)
Seat 4: cfJccEfyn6IkquPN08hFsA folded before Flop (didn't bet)
Seat 5: OMGl+YMGogf2JWIRfT2/Yg folded before Flop (didn't bet)
Seat 6: iyZxqznXjv3vtvOJymkoLQ folded before Flop (didn't bet)




PokerStars Game #59941899158:  Hold'em No Limit ($0.10/$0.25) - 2009/07/01 1:49:42 ET
Table 'rjcb+nlE+0GuJ6lBhuCkkA' 6-max Seat #6 is the button
Seat 1: lBoEwOFgzcERLIRUkUoRTw ($13 in chips) 
Seat 2: lJphax9e7/+O/3YCKPJ0yQ ($6.45 in chips) 
Seat 3: 8ClCHtFXGNplITm+63KB+Q ($66.20 in chips) 
Seat 4: BV+K0Phf5VBHr7aZPKqbUQ ($35.50 in chips) 
Seat 5: GC/9yVD59DUCX7hUI7gcLw ($30.15 in chips) 
Seat 6: 32YL2ZEp8NT4JB2RVM9euQ ($15.70 in chips) 
lBoEwOFgzcERLIRUkUoRTw: posts small blind $0.10
lJphax9e7/+O/3YCKPJ0yQ: posts big blind $0.25
*** HOLE CARDS ***
8ClCHtFXGNplITm+63KB+Q: folds 
BV+K0Phf5VBHr7aZPKqbUQ: folds 
GC/9yVD59DUCX7hUI7gcLw: folds 
32YL2ZEp8NT4JB2RVM9euQ: folds 
lBoEwOFgzcERLIRUkUoRTw: folds 
Uncalled bet ($0.15) returned to lJphax9e7/+O/3YCKPJ0yQ
lJphax9e7/+O/3YCKPJ0yQ collected $0.20 from pot
*** SUMMARY ***
Total pot $0.20 | Rake $0 
Seat 1: lBoEwOFgzcERLIRUkUoRTw (small blind) folded before Flop
Seat 2: lJphax9e7/+O/3YCKPJ0yQ (big blind) collected ($0.20)
Seat 3: 8ClCHtFXGNplITm+63KB+Q folded before Flop (didn't bet)
Seat 4: BV+K0Phf5VBHr7aZPKqbUQ folded before Flop (didn't bet)
Seat 5: GC/9yVD59DUCX7hUI7gcLw folded before Flop (didn't bet)
Seat 6: 32YL2ZEp8NT4JB2RVM9euQ (button) folded before Flop (didn't bet)




PokerStars Game #59941899320:  Hold'em No Limit ($0.10/$0.25) - 2009/07/01 1:49:42 ET
Table 'jdhJTJjFq2KTttwJcd+7nQ' 6-max Seat #3 is the button
Seat 1: LtASJ9OlkqGrrUKGQlpGAw ($26.50 in chips) 
Seat 2: Hsvkc0/G2VV78oVmWYXecw ($5 in chips) 
Seat 3: vqWjZmdQu/Hxw96/IJTWdQ ($28.80 in chips) 
Seat 4: vx7FwRcelVSsvNYAdp/z0A ($5.85 in chips) 
Seat 5: BV+K0Phf5VBHr7aZPKqbUQ ($27.45 in chips) 
Seat 6: yb6rnd48JuBccThV68VHAQ ($15.30 in chips) 
vx7FwRcelVSsvNYAdp/z0A: posts small blind $0.10
BV+K0Phf5VBHr7aZPKqbUQ: posts big blind $0.25
*** HOLE CARDS ***
yb6rnd48JuBccThV68VHAQ: calls $0.25
LtASJ9OlkqGrrUKGQlpGAw: folds 
Hsvkc0/G2VV78oVmWYXecw: raises $0.75 to $1
vqWjZmdQu/Hxw96/IJTWdQ: folds 
vx7FwRcelVSsvNYAdp/z0A: calls $0.90
BV+K0Phf5VBHr7aZPKqbUQ: raises $7 to $8
yb6rnd48JuBccThV68VHAQ: folds 
Hsvkc0/G2VV78oVmWYXecw: calls $4 and is all-in
vx7FwRcelVSsvNYAdp/z0A: folds 
Uncalled bet ($3) returned to BV+K0Phf5VBHr7aZPKqbUQ
*** FLOP *** [6s 6d 9h]
*** TURN *** [6s 6d 9h] [Qs]
*** RIVER *** [6s 6d 9h Qs] [Tc]
*** SHOW DOWN ***
BV+K0Phf5VBHr7aZPKqbUQ: shows [Qc Qd] (a full house, Queens full of Sixes)
Hsvkc0/G2VV78oVmWYXecw: mucks hand 
BV+K0Phf5VBHr7aZPKqbUQ collected $10.70 from pot
*** SUMMARY ***
Total pot $11.25 | Rake $0.55 
Board [6s 6d 9h Qs Tc]
Seat 1: LtASJ9OlkqGrrUKGQlpGAw folded before Flop (didn't bet)
Seat 2: Hsvkc0/G2VV78oVmWYXecw mucked
Seat 3: vqWjZmdQu/Hxw96/IJTWdQ (button) folded before Flop (didn't bet)
Seat 4: vx7FwRcelVSsvNYAdp/z0A (small blind) folded before Flop
Seat 5: BV+K0Phf5VBHr7aZPKqbUQ (big blind) showed [Qc Qd] and won ($10.70) with a full house, Queens full of Sixes
Seat 6: yb6rnd48JuBccThV68VHAQ folded before Flop




PokerStars Game #59941899908:  Hold'em No Limit ($0.10/$0.25) - 2009/07/01 1:49:43 ET
Table 'luMgmRPIo47e7iXDlheIwA' 6-max Seat #5 is the button
Seat 1: EQ3WxdGe/KZrM6Lx4T02sg ($37.65 in chips) 
Seat 2: NhUN/JpAprdJeamFBgJH1w ($25.35 in chips) 
Seat 3: w43JQj2oYPpKQVG4Yzlq1w ($25.60 in chips) 
Seat 4: xrf8tAXKQHG99HixCot1Iw ($25.90 in chips) 
Seat 5: cWc85bEzdRzpUMhRKm8pwQ ($44.90 in chips) 
Seat 6: qGHGf/553gQnDoklMRe3tg ($24.30 in chips) 
qGHGf/553gQnDoklMRe3tg: posts small blind $0.10
EQ3WxdGe/KZrM6Lx4T02sg: posts big blind $0.25
*** HOLE CARDS ***
NhUN/JpAprdJeamFBgJH1w: raises $0.75 to $1
w43JQj2oYPpKQVG4Yzlq1w: calls $1
xrf8tAXKQHG99HixCot1Iw: folds 
cWc85bEzdRzpUMhRKm8pwQ: folds 
qGHGf/553gQnDoklMRe3tg: folds 
EQ3WxdGe/KZrM6Lx4T02sg: folds 
*** FLOP *** [6s Kc 5c]
NhUN/JpAprdJeamFBgJH1w: bets $1.75
w43JQj2oYPpKQVG4Yzlq1w: calls $1.75
*** TURN *** [6s Kc 5c] [Qc]
NhUN/JpAprdJeamFBgJH1w: bets $3.50
w43JQj2oYPpKQVG4Yzlq1w: calls $3.50
*** RIVER *** [6s Kc 5c Qc] [Ah]
NhUN/JpAprdJeamFBgJH1w: checks 
w43JQj2oYPpKQVG4Yzlq1w: bets $3.75
NhUN/JpAprdJeamFBgJH1w: folds 
Uncalled bet ($3.75) returned to w43JQj2oYPpKQVG4Yzlq1w
w43JQj2oYPpKQVG4Yzlq1w collected $12.25 from pot
*** SUMMARY ***
Total pot $12.85 | Rake $0.60 
Board [6s Kc 5c Qc Ah]
Seat 1: EQ3WxdGe/KZrM6Lx4T02sg (big blind) folded before Flop
Seat 2: NhUN/JpAprdJeamFBgJH1w folded on the River
Seat 3: w43JQj2oYPpKQVG4Yzlq1w collected ($12.25)
Seat 4: xrf8tAXKQHG99HixCot1Iw folded before Flop (didn't bet)
Seat 5: cWc85bEzdRzpUMhRKm8pwQ (button) folded before Flop (didn't bet)
Seat 6: qGHGf/553gQnDoklMRe3tg (small blind) folded before Flop




PokerStars Game #59941899694:  Hold'em No Limit ($0.10/$0.25) - 2009/07/01 1:49:43 ET
Table 'l57rayEpPtZotP9nqgSWBg' 6-max Seat #4 is the button
Seat 1: DihMHaz4WNETH1bPDe13kA ($56.85 in chips) 
Seat 2: p6adJRMXMBLr+xtQzqazIQ ($15.05 in chips) 
Seat 3: xC0kaiDYM6YTlgODL83O5A ($25 in chips) 
Seat 4: OqkdGXy1SCzuN5Q0wNlFSg ($21.50 in chips) 
Seat 5: WKJHaZPUgrpTVyLOEjLYmg ($11.95 in chips) 
Seat 6: IGRfskE1v9H9Bn+fz8AgNQ ($15.55 in chips) 
WKJHaZPUgrpTVyLOEjLYmg: posts small blind $0.10
IGRfskE1v9H9Bn+fz8AgNQ: posts big blind $0.25
*** HOLE CARDS ***
DihMHaz4WNETH1bPDe13kA: folds 
p6adJRMXMBLr+xtQzqazIQ: folds 
xC0kaiDYM6YTlgODL83O5A: calls $0.25
OqkdGXy1SCzuN5Q0wNlFSg: raises $1 to $1.25
WKJHaZPUgrpTVyLOEjLYmg: folds 
IGRfskE1v9H9Bn+fz8AgNQ: folds 
xC0kaiDYM6YTlgODL83O5A: folds 
Uncalled bet ($1) returned to OqkdGXy1SCzuN5Q0wNlFSg
OqkdGXy1SCzuN5Q0wNlFSg collected $0.85 from pot
*** SUMMARY ***
Total pot $0.85 | Rake $0 
Seat 1: DihMHaz4WNETH1bPDe13kA folded before Flop (didn't bet)
Seat 2: p6adJRMXMBLr+xtQzqazIQ folded before Flop (didn't bet)
Seat 3: xC0kaiDYM6YTlgODL83O5A folded before Flop
Seat 4: OqkdGXy1SCzuN5Q0wNlFSg (button) collected ($0.85)
Seat 5: WKJHaZPUgrpTVyLOEjLYmg (small blind) folded before Flop
Seat 6: IGRfskE1v9H9Bn+fz8AgNQ (big blind) folded before Flop




PokerStars Game #59941899772:  Hold'em No Limit ($0.10/$0.25) - 2009/07/01 1:49:43 ET
Table 'Ok3oDLIsTc2+KxPcI0bAOA' 6-max Seat #4 is the button
Seat 1: agQm3ugZ3qSVYNgNu1ddeA ($39.85 in chips) 
Seat 2: wPSNSp4HYtytRMXTu3oPSQ ($28 in chips) 
Seat 3: lquriepNQBhDV5P1SWHhnA ($36.90 in chips) 
Seat 4: LJI7A1YgDM7hgh7o56+ReQ ($33.70 in chips) 
Seat 5: DFi/Lzkjsfv8QswS80JX9Q ($29.85 in chips) 
Seat 6: Hsvkc0/G2VV78oVmWYXecw ($5.80 in chips) 
DFi/Lzkjsfv8QswS80JX9Q: posts small blind $0.10
Hsvkc0/G2VV78oVmWYXecw: posts big blind $0.25
*** HOLE CARDS ***
agQm3ugZ3qSVYNgNu1ddeA: folds 
wPSNSp4HYtytRMXTu3oPSQ: folds 
lquriepNQBhDV5P1SWHhnA: folds 
LJI7A1YgDM7hgh7o56+ReQ: raises $0.50 to $0.75
DFi/Lzkjsfv8QswS80JX9Q: folds 
Hsvkc0/G2VV78oVmWYXecw: folds 
Uncalled bet ($0.50) returned to LJI7A1YgDM7hgh7o56+ReQ
LJI7A1YgDM7hgh7o56+ReQ collected $0.60 from pot
LJI7A1YgDM7hgh7o56+ReQ: doesn't show hand 
*** SUMMARY ***
Total pot $0.60 | Rake $0 
Seat 1: agQm3ugZ3qSVYNgNu1ddeA folded before Flop (didn't bet)
Seat 2: wPSNSp4HYtytRMXTu3oPSQ folded before Flop (didn't bet)
Seat 3: lquriepNQBhDV5P1SWHhnA folded before Flop (didn't bet)
Seat 4: LJI7A1YgDM7hgh7o56+ReQ (button) collected ($0.60)
Seat 5: DFi/Lzkjsfv8QswS80JX9Q (small blind) folded before Flop
Seat 6: Hsvkc0/G2VV78oVmWYXecw (big blind) folded before Flop




PokerStars Game #59941899720:  Hold'em No Limit ($0.10/$0.25) - 2009/07/01 1:49:43 ET
Table 'ukli1Y7ieC5JQMTEFxM2Nw' 6-max Seat #5 is the button
Seat 1: N162H80ZIQevUf2EzGahCA ($7.55 in chips) 
Seat 2: u/yN5P9f3KlATg6WLWNkBQ ($42.55 in chips) 
Seat 3: ExeoJ1G/rSmWa3tRz7TlCA ($23.10 in chips) 
Seat 4: if4dh6jhJXeN3/qd3qCp9g ($26.75 in chips) 
Seat 5: Se+H4Z4PDr6+eIUDJX1rpg ($17.15 in chips) 
Seat 6: 32YL2ZEp8NT4JB2RVM9euQ ($32.10 in chips) 
32YL2ZEp8NT4JB2RVM9euQ: posts small blind $0.10
N162H80ZIQevUf2EzGahCA: posts big blind $0.25
*** HOLE CARDS ***
u/yN5P9f3KlATg6WLWNkBQ: folds 
ExeoJ1G/rSmWa3tRz7TlCA: folds 
if4dh6jhJXeN3/qd3qCp9g: folds 
u/yN5P9f3KlATg6WLWNkBQ leaves the table
Se+H4Z4PDr6+eIUDJX1rpg: raises $0.75 to $1
32YL2ZEp8NT4JB2RVM9euQ: folds 
N162H80ZIQevUf2EzGahCA: calls $0.75
*** FLOP *** [5h Qs 6h]
N162H80ZIQevUf2EzGahCA: checks 
Se+H4Z4PDr6+eIUDJX1rpg: bets $2
N162H80ZIQevUf2EzGahCA: folds 
Uncalled bet ($2) returned to Se+H4Z4PDr6+eIUDJX1rpg
Se+H4Z4PDr6+eIUDJX1rpg collected $2 from pot
Se+H4Z4PDr6+eIUDJX1rpg: doesn't show hand 
*** SUMMARY ***
Total pot $2.10 | Rake $0.10 
Board [5h Qs 6h]
Seat 1: N162H80ZIQevUf2EzGahCA (big blind) folded on the Flop
Seat 2: u/yN5P9f3KlATg6WLWNkBQ folded before Flop (didn't bet)
Seat 3: ExeoJ1G/rSmWa3tRz7TlCA folded before Flop (didn't bet)
Seat 4: if4dh6jhJXeN3/qd3qCp9g folded before Flop (didn't bet)
Seat 5: Se+H4Z4PDr6+eIUDJX1rpg (button) collected ($2)
Seat 6: 32YL2ZEp8NT4JB2RVM9euQ (small blind) folded before Flop




PokerStars Game #59941899670:  Hold'em No Limit ($0.10/$0.25) - 2009/07/01 1:49:43 ET
Table 'Pz8SfAzhP5nvWTsJRAxoDg' 6-max Seat #1 is the button
Seat 1: QiL+lEgEWwy21jk/ltaRLg ($46.80 in chips) 
Seat 2: k021eD5in2AjaloW5PalMg ($18.55 in chips) 
Seat 3: mfrkWA3PTeYPkbO6hi98Aw ($31.45 in chips) 
Seat 4: 4lJto+Qj0K4JrFKvHaPTLw ($63.35 in chips) 
Seat 5: FYepjhAvF8ZdVCmqHIy+eQ ($25 in chips) 
Seat 6: QvTX2yGq3uKJiKPmns4TKQ ($17.70 in chips) 
k021eD5in2AjaloW5PalMg: posts small blind $0.10
mfrkWA3PTeYPkbO6hi98Aw: posts big blind $0.25
*** HOLE CARDS ***
4lJto+Qj0K4JrFKvHaPTLw: folds 
FYepjhAvF8ZdVCmqHIy+eQ: folds 
QvTX2yGq3uKJiKPmns4TKQ: folds 
QiL+lEgEWwy21jk/ltaRLg: folds 
k021eD5in2AjaloW5PalMg: folds 
Uncalled bet ($0.15) returned to mfrkWA3PTeYPkbO6hi98Aw
mfrkWA3PTeYPkbO6hi98Aw collected $0.20 from pot
mfrkWA3PTeYPkbO6hi98Aw: doesn't show hand 
*** SUMMARY ***
Total pot $0.20 | Rake $0 
Seat 1: QiL+lEgEWwy21jk/ltaRLg (button) folded before Flop (didn't bet)
Seat 2: k021eD5in2AjaloW5PalMg (small blind) folded before Flop
Seat 3: mfrkWA3PTeYPkbO6hi98Aw (big blind) collected ($0.20)
Seat 4: 4lJto+Qj0K4JrFKvHaPTLw folded before Flop (didn't bet)
Seat 5: FYepjhAvF8ZdVCmqHIy+eQ folded before Flop (didn't bet)
Seat 6: QvTX2yGq3uKJiKPmns4TKQ folded before Flop (didn't bet)




PokerStars Game #59941899882:  Hold'em No Limit ($0.10/$0.25) - 2009/07/01 1:49:43 ET
Table 'APEHQjIcZHDZUA4iOjju2g' 6-max Seat #4 is the button
Seat 1: DE9hRlt14g+JdsRQ4wT7hg ($25 in chips) 
Seat 2: 3zD3qLXT1bEffAoWGnc7wg ($34.15 in chips) 
Seat 3: 3e/idKqDuPE10t6Zvr//SQ ($20.10 in chips) 
Seat 4: w2mQ4VsGljGwWXydz8tw2A ($34.60 in chips) 
Seat 5: /xN6gc9+8Hew0HxaB6VIVg ($45.75 in chips) 
Seat 6: KXtdqb+rIMkjc0RvHDksGQ ($41.25 in chips) 
/xN6gc9+8Hew0HxaB6VIVg: posts small blind $0.10
KXtdqb+rIMkjc0RvHDksGQ: posts big blind $0.25
*** HOLE CARDS ***
DE9hRlt14g+JdsRQ4wT7hg: folds 
3zD3qLXT1bEffAoWGnc7wg: raises $0.50 to $0.75
3e/idKqDuPE10t6Zvr//SQ: folds 
w2mQ4VsGljGwWXydz8tw2A: folds 
/xN6gc9+8Hew0HxaB6VIVg: folds 
KXtdqb+rIMkjc0RvHDksGQ: raises $2.25 to $3
3zD3qLXT1bEffAoWGnc7wg: folds 
Uncalled bet ($2.25) returned to KXtdqb+rIMkjc0RvHDksGQ
KXtdqb+rIMkjc0RvHDksGQ collected $1.60 from pot
KXtdqb+rIMkjc0RvHDksGQ: doesn't show hand 
*** SUMMARY ***
Total pot $1.60 | Rake $0 
Seat 1: DE9hRlt14g+JdsRQ4wT7hg folded before Flop (didn't bet)
Seat 2: 3zD3qLXT1bEffAoWGnc7wg folded before Flop
Seat 3: 3e/idKqDuPE10t6Zvr//SQ folded before Flop (didn't bet)
Seat 4: w2mQ4VsGljGwWXydz8tw2A (button) folded before Flop (didn't bet)
Seat 5: /xN6gc9+8Hew0HxaB6VIVg (small blind) folded before Flop
Seat 6: KXtdqb+rIMkjc0RvHDksGQ (big blind) collected ($1.60)




PokerStars Game #59941899510:  Hold'em No Limit ($0.10/$0.25) - 2009/07/01 1:49:43 ET
Table 'Zi9/NqNs3XoL1eWhMCyZyg' 9-max Seat #3 is the button
Seat 1: X6+pSIPfovPcE87t+LmUKQ ($4.50 in chips) 
Seat 2: 1wKfgJ8xXIiuc8C6qjkxhg ($5.10 in chips) 
Seat 3: ETC7YyRJTa2Ovhln64Ni5Q ($28.05 in chips) 
Seat 4: dmYlc+1cjwZMJ7wV+Z0rRg ($23.50 in chips) 
Seat 6: YQhfmYhgnDDlWCAFmBb36Q ($16.95 in chips) 
Seat 7: 0QdZrkFD7aGKeBXPGbIomA ($2.20 in chips) 
Seat 8: nm4Dj/f+jJEwKVsUnKh73g ($34.90 in chips) 
dmYlc+1cjwZMJ7wV+Z0rRg: posts small blind $0.10
YQhfmYhgnDDlWCAFmBb36Q: posts big blind $0.25
3l+i+xMeyDndSXMF2A5CDA: sits out 
*** HOLE CARDS ***
0QdZrkFD7aGKeBXPGbIomA: folds 
nm4Dj/f+jJEwKVsUnKh73g: calls $0.25
X6+pSIPfovPcE87t+LmUKQ: folds 
LuckyPounce joins the table at seat #5 
1wKfgJ8xXIiuc8C6qjkxhg: folds 
ETC7YyRJTa2Ovhln64Ni5Q: calls $0.25
dmYlc+1cjwZMJ7wV+Z0rRg: folds 
YQhfmYhgnDDlWCAFmBb36Q: checks 
*** FLOP *** [9d Kc 9s]
YQhfmYhgnDDlWCAFmBb36Q: bets $0.50
nm4Dj/f+jJEwKVsUnKh73g: folds 
ETC7YyRJTa2Ovhln64Ni5Q: folds 
Uncalled bet ($0.50) returned to YQhfmYhgnDDlWCAFmBb36Q
YQhfmYhgnDDlWCAFmBb36Q collected $0.85 from pot
YQhfmYhgnDDlWCAFmBb36Q: doesn't show hand 
*** SUMMARY ***
Total pot $0.85 | Rake $0 
Board [9d Kc 9s]
Seat 1: X6+pSIPfovPcE87t+LmUKQ folded before Flop (didn't bet)
Seat 2: 1wKfgJ8xXIiuc8C6qjkxhg folded before Flop (didn't bet)
Seat 3: ETC7YyRJTa2Ovhln64Ni5Q (button) folded on the Flop
Seat 4: dmYlc+1cjwZMJ7wV+Z0rRg (small blind) folded before Flop
Seat 6: YQhfmYhgnDDlWCAFmBb36Q (big blind) collected ($0.85)
Seat 7: 0QdZrkFD7aGKeBXPGbIomA folded before Flop (didn't bet)
Seat 8: nm4Dj/f+jJEwKVsUnKh73g folded on the Flop




PokerStars Game #59941899504:  Hold'em No Limit ($0.10/$0.25) - 2009/07/01 1:49:43 ET
Table 'JPFXJXa5xBkjZ/W15BKqeQ' 9-max Seat #9 is the button
Seat 2: XMSS6mD5B42I8wasdOMipQ ($12.85 in chips) 
Seat 3: 56S3mA6Zs3pGR+0p0vUCtg ($19.20 in chips) 
Seat 4: wGigCmBR/9XWkPpvYos3aQ ($32.30 in chips) 
Seat 5: cZ99hugmLBj9KhTlc8nCSw ($25.60 in chips) 
Seat 6: tLcDklc2rBORNfixyRfVfw ($25 in chips) 
Seat 7: PdIasPkzm2sqZnN41ZRXOg ($5 in chips) 
Seat 9: V6p0jQ/RhUsqpHLmXvEX4Q ($12.25 in chips) 
XMSS6mD5B42I8wasdOMipQ: posts small blind $0.10
56S3mA6Zs3pGR+0p0vUCtg: posts big blind $0.25
*** HOLE CARDS ***
wGigCmBR/9XWkPpvYos3aQ: folds 
zgi+EUykT/pZQpoUG6+oEg joins the table at seat #1 
cZ99hugmLBj9KhTlc8nCSw: folds 
tLcDklc2rBORNfixyRfVfw: folds 
PdIasPkzm2sqZnN41ZRXOg: folds 
V6p0jQ/RhUsqpHLmXvEX4Q: folds 
XMSS6mD5B42I8wasdOMipQ: folds 
Uncalled bet ($0.15) returned to 56S3mA6Zs3pGR+0p0vUCtg
56S3mA6Zs3pGR+0p0vUCtg collected $0.20 from pot
56S3mA6Zs3pGR+0p0vUCtg: doesn't show hand 
*** SUMMARY ***
Total pot $0.20 | Rake $0 
Seat 2: XMSS6mD5B42I8wasdOMipQ (small blind) folded before Flop
Seat 3: 56S3mA6Zs3pGR+0p0vUCtg (big blind) collected ($0.20)
Seat 4: wGigCmBR/9XWkPpvYos3aQ folded before Flop (didn't bet)
Seat 5: cZ99hugmLBj9KhTlc8nCSw folded before Flop (didn't bet)
Seat 6: tLcDklc2rBORNfixyRfVfw folded before Flop (didn't bet)
Seat 7: PdIasPkzm2sqZnN41ZRXOg folded before Flop (didn't bet)
Seat 9: V6p0jQ/RhUsqpHLmXvEX4Q (button) folded before Flop (didn't bet)




PokerStars Game #59941899512:  Hold'em No Limit ($0.10/$0.25) - 2009/07/01 1:49:43 ET
Table 'rO1I30HnuCPB0M8qEX1TCQ' 9-max Seat #5 is the button
Seat 2: z1hPotrGOZjUjyoopZ7Ulg ($25.15 in chips) 
Seat 3: 2wcFsZsqEP5w1StUTVzJCg ($12.80 in chips) 
Seat 4: yyG4svzOpC1A+sUP/scg6w ($10.05 in chips) 
Seat 5: WQe4GbiYBiPsb5WKFKkijQ ($10.25 in chips) 
Seat 6: 5n7e7I+px7c6CQmLpPbtsg ($4.40 in chips) 
Seat 8: CGjLyv/AvljZy2g76nYkzQ ($25 in chips) 
Seat 9: wnerYvSRWT9Sm4X3ip/c8w ($35.15 in chips) 
5n7e7I+px7c6CQmLpPbtsg: posts small blind $0.10
bXpVeaSTPBFSPJmeXxO7nw: is sitting out 
bXpVeaSTPBFSPJmeXxO7nw leaves the table
CGjLyv/AvljZy2g76nYkzQ: posts big blind $0.25
Chowtowin: sits out 
*** HOLE CARDS ***
wnerYvSRWT9Sm4X3ip/c8w: folds 
AiXn/9o1EwOPZUHujnh/bA joins the table at seat #7 
z1hPotrGOZjUjyoopZ7Ulg: folds 
2wcFsZsqEP5w1StUTVzJCg: folds 
yyG4svzOpC1A+sUP/scg6w: calls $0.25
WQe4GbiYBiPsb5WKFKkijQ: raises $0.25 to $0.50
5n7e7I+px7c6CQmLpPbtsg: raises $1 to $1.50
CGjLyv/AvljZy2g76nYkzQ: folds 
yyG4svzOpC1A+sUP/scg6w: folds 
WQe4GbiYBiPsb5WKFKkijQ: calls $1
*** FLOP *** [Ad 3c 6d]
5n7e7I+px7c6CQmLpPbtsg: bets $2.90 and is all-in
WQe4GbiYBiPsb5WKFKkijQ: folds 
Uncalled bet ($2.90) returned to 5n7e7I+px7c6CQmLpPbtsg
5n7e7I+px7c6CQmLpPbtsg collected $3.35 from pot
5n7e7I+px7c6CQmLpPbtsg: doesn't show hand 
*** SUMMARY ***
Total pot $3.50 | Rake $0.15 
Board [Ad 3c 6d]
Seat 2: z1hPotrGOZjUjyoopZ7Ulg folded before Flop (didn't bet)
Seat 3: 2wcFsZsqEP5w1StUTVzJCg folded before Flop (didn't bet)
Seat 4: yyG4svzOpC1A+sUP/scg6w folded before Flop
Seat 5: WQe4GbiYBiPsb5WKFKkijQ (button) folded on the Flop
Seat 6: 5n7e7I+px7c6CQmLpPbtsg (small blind) collected ($3.35)
Seat 8: CGjLyv/AvljZy2g76nYkzQ (big blind) folded before Flop
Seat 9: wnerYvSRWT9Sm4X3ip/c8w folded before Flop (didn't bet)




PokerStars Game #59941899756:  Hold'em No Limit ($0.10/$0.25) - 2009/07/01 1:49:43 ET
Table 'D1Yq70l0nNCyMV6DA42p+Q' 9-max Seat #4 is the button
Seat 2: zgi+EUykT/pZQpoUG6+oEg ($5 in chips) 
Seat 3: 9lvO/qyU+xrU95Teu1fv0g ($6.50 in chips) 
Seat 4: VWUWpMLMj/Q1jRVpF7Aohw ($8.90 in chips) 
Seat 5: gehe91e0IyVT0QU/XBkEyg ($25 in chips) 
Seat 6: wGigCmBR/9XWkPpvYos3aQ ($33.20 in chips) 
Seat 7: Lqytncc1Dsgt654eEBp/uw ($35.75 in chips) 
Seat 8: zDrucyjVn5aeekNEc3cJrA ($24 in chips) 
Seat 9: h5wEs8qXrBqfLa9GjaSBzg ($17.50 in chips) 
gehe91e0IyVT0QU/XBkEyg: posts small blind $0.10
wGigCmBR/9XWkPpvYos3aQ: posts big blind $0.25
*** HOLE CARDS ***
Lqytncc1Dsgt654eEBp/uw: folds 
Lqytncc1Dsgt654eEBp/uw is sitting out
zDrucyjVn5aeekNEc3cJrA: folds 
h5wEs8qXrBqfLa9GjaSBzg: calls $0.25
zgi+EUykT/pZQpoUG6+oEg: folds 
9lvO/qyU+xrU95Teu1fv0g: folds 
VWUWpMLMj/Q1jRVpF7Aohw: folds 
gehe91e0IyVT0QU/XBkEyg: folds 
wGigCmBR/9XWkPpvYos3aQ: checks 
*** FLOP *** [8c 5c Th]
z5GxcHlYz/GSz6W2uFiTtg has returned
wGigCmBR/9XWkPpvYos3aQ: checks 
h5wEs8qXrBqfLa9GjaSBzg: checks 
*** TURN *** [8c 5c Th] [5h]
wGigCmBR/9XWkPpvYos3aQ: bets $0.40
h5wEs8qXrBqfLa9GjaSBzg: folds 
Uncalled bet ($0.40) returned to wGigCmBR/9XWkPpvYos3aQ
wGigCmBR/9XWkPpvYos3aQ collected $0.60 from pot
wGigCmBR/9XWkPpvYos3aQ: doesn't show hand 
*** SUMMARY ***
Total pot $0.60 | Rake $0 
Board [8c 5c Th 5h]
Seat 2: zgi+EUykT/pZQpoUG6+oEg folded before Flop (didn't bet)
Seat 3: 9lvO/qyU+xrU95Teu1fv0g folded before Flop (didn't bet)
Seat 4: VWUWpMLMj/Q1jRVpF7Aohw (button) folded before Flop (didn't bet)
Seat 5: gehe91e0IyVT0QU/XBkEyg (small blind) folded before Flop
Seat 6: wGigCmBR/9XWkPpvYos3aQ (big blind) collected ($0.60)
Seat 7: Lqytncc1Dsgt654eEBp/uw folded before Flop (didn't bet)
Seat 8: zDrucyjVn5aeekNEc3cJrA folded before Flop (didn't bet)
Seat 9: h5wEs8qXrBqfLa9GjaSBzg folded on the Turn




PokerStars Game #59941899480:  Hold'em No Limit ($0.10/$0.25) - 2009/07/01 1:49:43 ET
Table 'pgrBYaOEx/BuqK5iAtlFzw' 9-max Seat #5 is the button
Seat 1: 6O+8t5ikoK+pNiFXnN/Fyw ($18.60 in chips) 
Seat 2: 2Xwi447v1rBHM+92U0CduA ($7.20 in chips) 
Seat 3: Bb42QRQMhg5/Y0vHP8/2Xw ($25 in chips) 
Seat 4: oLa/tXLfSLLB28mcLGrxcg ($23.90 in chips) 
Seat 5: BWzInv8o0kN1pJybv/VjpQ ($24.85 in chips) 
Seat 6: eubS00Znk+qsx0B0+7/Zow ($18.85 in chips) 
Seat 7: eK8qa6EPcH2zhtbmWSvc9g ($25 in chips) 
Seat 8: tLcDklc2rBORNfixyRfVfw ($27.45 in chips) 
eubS00Znk+qsx0B0+7/Zow: posts small blind $0.10
eK8qa6EPcH2zhtbmWSvc9g: posts big blind $0.25
Z9W7+g1WMhhZDi7DwGbCFA: sits out 
*** HOLE CARDS ***
tLcDklc2rBORNfixyRfVfw: folds 
6O+8t5ikoK+pNiFXnN/Fyw: raises $0.25 to $0.50
2Xwi447v1rBHM+92U0CduA: folds 
Bb42QRQMhg5/Y0vHP8/2Xw: folds 
oLa/tXLfSLLB28mcLGrxcg: folds 
BWzInv8o0kN1pJybv/VjpQ: folds 
eubS00Znk+qsx0B0+7/Zow: calls $0.40
eK8qa6EPcH2zhtbmWSvc9g: folds 
*** FLOP *** [2h Kd Qc]
eubS00Znk+qsx0B0+7/Zow: checks 
6O+8t5ikoK+pNiFXnN/Fyw: bets $1
eubS00Znk+qsx0B0+7/Zow: calls $1
*** TURN *** [2h Kd Qc] [2s]
eubS00Znk+qsx0B0+7/Zow: checks 
6O+8t5ikoK+pNiFXnN/Fyw: checks 
*** RIVER *** [2h Kd Qc 2s] [4s]
eubS00Znk+qsx0B0+7/Zow: bets $1.50
6O+8t5ikoK+pNiFXnN/Fyw: folds 
Uncalled bet ($1.50) returned to eubS00Znk+qsx0B0+7/Zow
eubS00Znk+qsx0B0+7/Zow collected $3.10 from pot
eubS00Znk+qsx0B0+7/Zow: doesn't show hand 
*** SUMMARY ***
Total pot $3.25 | Rake $0.15 
Board [2h Kd Qc 2s 4s]
Seat 1: 6O+8t5ikoK+pNiFXnN/Fyw folded on the River
Seat 2: 2Xwi447v1rBHM+92U0CduA folded before Flop (didn't bet)
Seat 3: Bb42QRQMhg5/Y0vHP8/2Xw folded before Flop (didn't bet)
Seat 4: oLa/tXLfSLLB28mcLGrxcg folded before Flop (didn't bet)
Seat 5: BWzInv8o0kN1pJybv/VjpQ (button) folded before Flop (didn't bet)
Seat 6: eubS00Znk+qsx0B0+7/Zow (small blind) collected ($3.10)
Seat 7: eK8qa6EPcH2zhtbmWSvc9g (big blind) folded before Flop
Seat 8: tLcDklc2rBORNfixyRfVfw folded before Flop (didn't bet)




PokerStars Game #59941899472:  Hold'em No Limit ($0.10/$0.25) - 2009/07/01 1:49:43 ET
Table 'tq5CvS0RUqGkuBK0XTzqqg' 6-max Seat #4 is the button
Seat 1: +ZlnqPoP3Hg4BIUxDfKd/A ($29.95 in chips) 
Seat 2: 2m6ZFAdj01UZd4WtEySXXQ ($4.90 in chips) 
Seat 4: UT5XpwOH1ipkOF7n1MqDJA ($34.05 in chips) 
Seat 5: qGHGf/553gQnDoklMRe3tg ($38 in chips) 
Seat 6: QqiZLFrN8iOUT/GHw7ztOA ($24.65 in chips) 
qGHGf/553gQnDoklMRe3tg: posts small blind $0.10
QqiZLFrN8iOUT/GHw7ztOA: posts big blind $0.25
*** HOLE CARDS ***
VXTONriS+Ohik+r0FeicIw joins the table at seat #3 
+ZlnqPoP3Hg4BIUxDfKd/A has timed out
+ZlnqPoP3Hg4BIUxDfKd/A: folds 
+ZlnqPoP3Hg4BIUxDfKd/A is sitting out
+ZlnqPoP3Hg4BIUxDfKd/A has returned
2m6ZFAdj01UZd4WtEySXXQ: folds 
UT5XpwOH1ipkOF7n1MqDJA: raises $0.75 to $1
qGHGf/553gQnDoklMRe3tg: folds 
QqiZLFrN8iOUT/GHw7ztOA: folds 
Uncalled bet ($0.75) returned to UT5XpwOH1ipkOF7n1MqDJA
UT5XpwOH1ipkOF7n1MqDJA collected $0.60 from pot
*** SUMMARY ***
Total pot $0.60 | Rake $0 
Seat 1: +ZlnqPoP3Hg4BIUxDfKd/A folded before Flop (didn't bet)
Seat 2: 2m6ZFAdj01UZd4WtEySXXQ folded before Flop (didn't bet)
Seat 4: UT5XpwOH1ipkOF7n1MqDJA (button) collected ($0.60)
Seat 5: qGHGf/553gQnDoklMRe3tg (small blind) folded before Flop
Seat 6: QqiZLFrN8iOUT/GHw7ztOA (big blind) folded before Flop




PokerStars Game #59941899408:  Hold'em No Limit ($0.10/$0.25) - 2009/07/01 1:49:43 ET
Table '3lL16FBjWXTx3AjK5lMRww' 9-max Seat #5 is the button
Seat 1: fDGyaQz0cs2s4FOYxkbIHA ($15.55 in chips) 
Seat 2: c/9X4zftzphFxYtxp5kp9w ($21.55 in chips) 
Seat 3: QEbIGci+itdw+re8RM5fZA ($28.50 in chips) 
Seat 4: Z3a37Ry74FVl+CBZtAONiA ($6.40 in chips) 
Seat 5: M/9j4wkHH9i1JM51vgi1VA ($36.95 in chips) 
Seat 6: zUXhymECc2C9W9ZNw6qppA ($8.90 in chips) 
Seat 7: 6RiVTYll/5D8zICp0MRpKw ($26.20 in chips) 
Seat 8: ljemhp25Zg+nlA9DLCIiUw ($24.50 in chips) 
Seat 9: 00Ybni1cxfHtqmdWwh31Xg ($10.30 in chips) 
zUXhymECc2C9W9ZNw6qppA: posts small blind $0.10
6RiVTYll/5D8zICp0MRpKw: posts big blind $0.25
*** HOLE CARDS ***
ljemhp25Zg+nlA9DLCIiUw: folds 
00Ybni1cxfHtqmdWwh31Xg: folds 
fDGyaQz0cs2s4FOYxkbIHA: folds 
c/9X4zftzphFxYtxp5kp9w: folds 
QEbIGci+itdw+re8RM5fZA: folds 
Z3a37Ry74FVl+CBZtAONiA: folds 
M/9j4wkHH9i1JM51vgi1VA: folds 
zUXhymECc2C9W9ZNw6qppA is disconnected 
zUXhymECc2C9W9ZNw6qppA has timed out while disconnected
zUXhymECc2C9W9ZNw6qppA: folds 
Uncalled bet ($0.15) returned to 6RiVTYll/5D8zICp0MRpKw
zUXhymECc2C9W9ZNw6qppA is sitting out
6RiVTYll/5D8zICp0MRpKw collected $0.20 from pot
*** SUMMARY ***
Total pot $0.20 | Rake $0 
Seat 1: fDGyaQz0cs2s4FOYxkbIHA folded before Flop (didn't bet)
Seat 2: c/9X4zftzphFxYtxp5kp9w folded before Flop (didn't bet)
Seat 3: QEbIGci+itdw+re8RM5fZA folded before Flop (didn't bet)
Seat 4: Z3a37Ry74FVl+CBZtAONiA folded before Flop (didn't bet)
Seat 5: M/9j4wkHH9i1JM51vgi1VA (button) folded before Flop (didn't bet)
Seat 6: zUXhymECc2C9W9ZNw6qppA (small blind) folded before Flop
Seat 7: 6RiVTYll/5D8zICp0MRpKw (big blind) collected ($0.20)
Seat 8: ljemhp25Zg+nlA9DLCIiUw folded before Flop (didn't bet)
Seat 9: 00Ybni1cxfHtqmdWwh31Xg folded before Flop (didn't bet)




PokerStars Game #59941899946:  Hold'em No Limit ($0.10/$0.25) - 2009/07/01 1:49:44 ET
Table 'sSe6q4YTb/iS19t2eCFdsA' 9-max Seat #1 is the button
Seat 1: hJ4uYjNmSZdjrKA8cjZqCA ($18.40 in chips) 
Seat 2: 3l+i+xMeyDndSXMF2A5CDA ($5.50 in chips) 
Seat 3: OXPkK84/qv92EMwXPiG5rQ ($9.75 in chips) 
Seat 4: 22dIObOuor/A+IKWkNoAlA ($9.10 in chips) 
Seat 5: qS+jfnNoG75bT+uQ8CKhQA ($9.70 in chips) 
Seat 6: tYsOBqdU1+x+yFI7zHO7hQ ($27 in chips) 
Seat 7: t70KGeRtR3naHSqKDixsUg ($4.75 in chips) 
Seat 8: hvXZ0zFPZFP8Hf6dS36YEw ($16 in chips) 
Seat 9: Z9W7+g1WMhhZDi7DwGbCFA ($5.25 in chips) 
3l+i+xMeyDndSXMF2A5CDA: posts small blind $0.10
OXPkK84/qv92EMwXPiG5rQ: posts big blind $0.25
*** HOLE CARDS ***
22dIObOuor/A+IKWkNoAlA: folds 
qS+jfnNoG75bT+uQ8CKhQA: calls $0.25
tYsOBqdU1+x+yFI7zHO7hQ: folds 
t70KGeRtR3naHSqKDixsUg: calls $0.25
hvXZ0zFPZFP8Hf6dS36YEw: folds 
Z9W7+g1WMhhZDi7DwGbCFA: folds 
hJ4uYjNmSZdjrKA8cjZqCA: folds 
3l+i+xMeyDndSXMF2A5CDA: folds 
OXPkK84/qv92EMwXPiG5rQ: checks 
*** FLOP *** [6h 6s Ac]
OXPkK84/qv92EMwXPiG5rQ: checks 
qS+jfnNoG75bT+uQ8CKhQA: checks 
t70KGeRtR3naHSqKDixsUg: checks 
*** TURN *** [6h 6s Ac] [3d]
OXPkK84/qv92EMwXPiG5rQ: checks 
qS+jfnNoG75bT+uQ8CKhQA: bets $0.50
t70KGeRtR3naHSqKDixsUg: folds 
OXPkK84/qv92EMwXPiG5rQ: folds 
Uncalled bet ($0.50) returned to qS+jfnNoG75bT+uQ8CKhQA
qS+jfnNoG75bT+uQ8CKhQA collected $0.85 from pot
*** SUMMARY ***
Total pot $0.85 | Rake $0 
Board [6h 6s Ac 3d]
Seat 1: hJ4uYjNmSZdjrKA8cjZqCA (button) folded before Flop (didn't bet)
Seat 2: 3l+i+xMeyDndSXMF2A5CDA (small blind) folded before Flop
Seat 3: OXPkK84/qv92EMwXPiG5rQ (big blind) folded on the Turn
Seat 4: 22dIObOuor/A+IKWkNoAlA folded before Flop (didn't bet)
Seat 5: qS+jfnNoG75bT+uQ8CKhQA collected ($0.85)
Seat 6: tYsOBqdU1+x+yFI7zHO7hQ folded before Flop (didn't bet)
Seat 7: t70KGeRtR3naHSqKDixsUg folded on the Turn
Seat 8: hvXZ0zFPZFP8Hf6dS36YEw folded before Flop (didn't bet)
Seat 9: Z9W7+g1WMhhZDi7DwGbCFA folded before Flop (didn't bet)




PokerStars Game #59941899944:  Hold'em No Limit ($0.10/$0.25) - 2009/07/01 1:49:44 ET
Table 'x7YStLKc8hpt/pTgSetPKA' 9-max Seat #7 is the button
Seat 1: tYsOBqdU1+x+yFI7zHO7hQ ($25.90 in chips) 
Seat 3: S7Ki0P+0AIGPuIfGJjW0gg ($10.60 in chips) 
Seat 4: ydoFOVgzvZv9ZhuWu9rXAw ($5 in chips) 
Seat 5: tLcDklc2rBORNfixyRfVfw ($25 in chips) 
Seat 6: 9YN2IkT2JYYKFErZtZvCtA ($49.25 in chips) 
Seat 7: dtZ84flFEi4Q+SGrHMJRDQ ($25 in chips) 
Seat 8: j4q3p0lesp63b1gZDwLBZw ($5.75 in chips) 
Seat 9: nm4Dj/f+jJEwKVsUnKh73g ($37.55 in chips) 
j4q3p0lesp63b1gZDwLBZw: posts small blind $0.10
nm4Dj/f+jJEwKVsUnKh73g: posts big blind $0.25
*** HOLE CARDS ***
tYsOBqdU1+x+yFI7zHO7hQ: folds 
S7Ki0P+0AIGPuIfGJjW0gg: calls $0.25
ydoFOVgzvZv9ZhuWu9rXAw: folds 
tLcDklc2rBORNfixyRfVfw: folds 
9YN2IkT2JYYKFErZtZvCtA: folds 
dtZ84flFEi4Q+SGrHMJRDQ: folds 
j4q3p0lesp63b1gZDwLBZw: calls $0.15
nm4Dj/f+jJEwKVsUnKh73g: checks 
*** FLOP *** [Js 4c Qs]
z5GxcHlYz/GSz6W2uFiTtg has returned
j4q3p0lesp63b1gZDwLBZw: checks 
nm4Dj/f+jJEwKVsUnKh73g: checks 
S7Ki0P+0AIGPuIfGJjW0gg: checks 
*** TURN *** [Js 4c Qs] [Ah]
j4q3p0lesp63b1gZDwLBZw: checks 
nm4Dj/f+jJEwKVsUnKh73g: checks 
S7Ki0P+0AIGPuIfGJjW0gg: bets $0.75
j4q3p0lesp63b1gZDwLBZw: folds 
nm4Dj/f+jJEwKVsUnKh73g: folds 
Uncalled bet ($0.75) returned to S7Ki0P+0AIGPuIfGJjW0gg
S7Ki0P+0AIGPuIfGJjW0gg collected $0.75 from pot
S7Ki0P+0AIGPuIfGJjW0gg: doesn't show hand 
*** SUMMARY ***
Total pot $0.75 | Rake $0 
Board [Js 4c Qs Ah]
Seat 1: tYsOBqdU1+x+yFI7zHO7hQ folded before Flop (didn't bet)
Seat 3: S7Ki0P+0AIGPuIfGJjW0gg collected ($0.75)
Seat 4: ydoFOVgzvZv9ZhuWu9rXAw folded before Flop (didn't bet)
Seat 5: tLcDklc2rBORNfixyRfVfw folded before Flop (didn't bet)
Seat 6: 9YN2IkT2JYYKFErZtZvCtA folded before Flop (didn't bet)
Seat 7: dtZ84flFEi4Q+SGrHMJRDQ (button) folded before Flop (didn't bet)
Seat 8: j4q3p0lesp63b1gZDwLBZw (small blind) folded on the Turn
Seat 9: nm4Dj/f+jJEwKVsUnKh73g (big blind) folded on the Turn




PokerStars Game #59941900018:  Hold'em No Limit ($0.10/$0.25) - 2009/07/01 1:49:44 ET
Table 'Dun24l/X8kjpUHWBhkVOFw' 6-max Seat #6 is the button
Seat 1: u3Ol7kv1LmvszuHNm9rc6w ($21.90 in chips) 
Seat 2: 6hUmfDYq+83kvxWoTBQmfw ($30.40 in chips) 
Seat 3: +E5iJKkKVfaTgTqzuXXv0g ($12.90 in chips) 
Seat 5: KYBwVA7jgmSrbIEbEGElVg ($24.05 in chips) 
Seat 6: xrf8tAXKQHG99HixCot1Iw ($24.90 in chips) 
u3Ol7kv1LmvszuHNm9rc6w: posts small blind $0.10
6hUmfDYq+83kvxWoTBQmfw: posts big blind $0.25
*** HOLE CARDS ***
aogAb4Eienxztk8p2v9VVw joins the table at seat #4 
+E5iJKkKVfaTgTqzuXXv0g: folds 
KYBwVA7jgmSrbIEbEGElVg: calls $0.25
+E5iJKkKVfaTgTqzuXXv0g leaves the table
xrf8tAXKQHG99HixCot1Iw: raises $0.75 to $1
u3Ol7kv1LmvszuHNm9rc6w: folds 
6hUmfDYq+83kvxWoTBQmfw: calls $0.75
KYBwVA7jgmSrbIEbEGElVg: calls $0.75
*** FLOP *** [Qc Ts 4s]
6hUmfDYq+83kvxWoTBQmfw: bets $0.25
KYBwVA7jgmSrbIEbEGElVg: raises $1 to $1.25
CholoPro joins the table at seat #3 
xrf8tAXKQHG99HixCot1Iw: folds 
6hUmfDYq+83kvxWoTBQmfw: calls $1
*** TURN *** [Qc Ts 4s] [Qd]
6hUmfDYq+83kvxWoTBQmfw: checks 
KYBwVA7jgmSrbIEbEGElVg: bets $3
6hUmfDYq+83kvxWoTBQmfw: calls $3
*** RIVER *** [Qc Ts 4s Qd] [Kh]
6hUmfDYq+83kvxWoTBQmfw: checks 
KYBwVA7jgmSrbIEbEGElVg: bets $7.25
6hUmfDYq+83kvxWoTBQmfw: folds 
Uncalled bet ($7.25) returned to KYBwVA7jgmSrbIEbEGElVg
KYBwVA7jgmSrbIEbEGElVg collected $11.05 from pot
*** SUMMARY ***
Total pot $11.60 | Rake $0.55 
Board [Qc Ts 4s Qd Kh]
Seat 1: u3Ol7kv1LmvszuHNm9rc6w (small blind) folded before Flop
Seat 2: 6hUmfDYq+83kvxWoTBQmfw (big blind) folded on the River
Seat 3: +E5iJKkKVfaTgTqzuXXv0g folded before Flop (didn't bet)
Seat 5: KYBwVA7jgmSrbIEbEGElVg collected ($11.05)
Seat 6: xrf8tAXKQHG99HixCot1Iw (button) folded on the Flop




PokerStars Game #59941900062:  Hold'em No Limit ($0.10/$0.25) - 2009/07/01 1:49:44 ET
Table 'LG9H161ZAHDkOww+ih3Ptg' 6-max Seat #4 is the button
Seat 1: avl8CO/tc0F6eVSiB/KNRA ($25.85 in chips) 
Seat 2: kwsRmpZ1ZaLooISs+zfyKg ($32.55 in chips) 
Seat 3: 5Evvx7UYqXTBuvIc/9s/hA ($15.20 in chips) 
Seat 4: 0C28L4/59aRNtHoBhqTcLg ($58.35 in chips) 
Seat 5: IDpUHu4U5YRh06nKQqhY8g ($10.25 in chips) 
Seat 6: v8m8XHovI5tqEA9mvplDSw ($25 in chips) 
IDpUHu4U5YRh06nKQqhY8g: posts small blind $0.10
v8m8XHovI5tqEA9mvplDSw: posts big blind $0.25
*** HOLE CARDS ***
avl8CO/tc0F6eVSiB/KNRA: folds 
avl8CO/tc0F6eVSiB/KNRA is sitting out
avl8CO/tc0F6eVSiB/KNRA leaves the table
kwsRmpZ1ZaLooISs+zfyKg: raises $0.75 to $1
vEZ/HxVuyR6kaq0BtZoUgQ joins the table at seat #1 
5Evvx7UYqXTBuvIc/9s/hA has timed out
5Evvx7UYqXTBuvIc/9s/hA: folds 
5Evvx7UYqXTBuvIc/9s/hA is sitting out
0C28L4/59aRNtHoBhqTcLg: calls $1
IDpUHu4U5YRh06nKQqhY8g: folds 
v8m8XHovI5tqEA9mvplDSw: folds 
*** FLOP *** [8c As 4s]
kwsRmpZ1ZaLooISs+zfyKg: bets $1
0C28L4/59aRNtHoBhqTcLg: calls $1
*** TURN *** [8c As 4s] [Th]
kwsRmpZ1ZaLooISs+zfyKg: bets $2
0C28L4/59aRNtHoBhqTcLg: folds 
Uncalled bet ($2) returned to kwsRmpZ1ZaLooISs+zfyKg
kwsRmpZ1ZaLooISs+zfyKg collected $4.15 from pot
5Evvx7UYqXTBuvIc/9s/hA has returned
*** SUMMARY ***
Total pot $4.35 | Rake $0.20 
Board [8c As 4s Th]
Seat 1: avl8CO/tc0F6eVSiB/KNRA folded before Flop (didn't bet)
Seat 2: kwsRmpZ1ZaLooISs+zfyKg collected ($4.15)
Seat 3: 5Evvx7UYqXTBuvIc/9s/hA folded before Flop (didn't bet)
Seat 4: 0C28L4/59aRNtHoBhqTcLg (button) folded on the Turn
Seat 5: IDpUHu4U5YRh06nKQqhY8g (small blind) folded before Flop
Seat 6: v8m8XHovI5tqEA9mvplDSw (big blind) folded before Flop




PokerStars Game #59941900076:  Hold'em No Limit ($0.10/$0.25) - 2009/07/01 1:49:44 ET
Table 'fIMYcWwN4/aXFJvH5Z8Ymg' 6-max Seat #5 is the button
Seat 1: DihMHaz4WNETH1bPDe13kA ($25.70 in chips) 
Seat 2: Mhj3q7cxev+XjXZxEE6/Cw ($25.95 in chips) 
Seat 3: 9bpVv1/Qh9IYtXuCtl5VtQ ($24.65 in chips) 
Seat 4: 7cx44/slbeTw+Cy7QB8Trg ($24.65 in chips) 
Seat 5: lquriepNQBhDV5P1SWHhnA ($25 in chips) 
Seat 6: jp34e617tIzV8tKIWmfAbA ($28.45 in chips) 
jp34e617tIzV8tKIWmfAbA: posts small blind $0.10
DihMHaz4WNETH1bPDe13kA: posts big blind $0.25
*** HOLE CARDS ***
Mhj3q7cxev+XjXZxEE6/Cw: raises $0.75 to $1
9bpVv1/Qh9IYtXuCtl5VtQ: folds 
7cx44/slbeTw+Cy7QB8Trg: folds 
lquriepNQBhDV5P1SWHhnA: folds 
jp34e617tIzV8tKIWmfAbA: folds 
DihMHaz4WNETH1bPDe13kA: folds 
Uncalled bet ($0.75) returned to Mhj3q7cxev+XjXZxEE6/Cw
Mhj3q7cxev+XjXZxEE6/Cw collected $0.60 from pot
Mhj3q7cxev+XjXZxEE6/Cw: doesn't show hand 
*** SUMMARY ***
Total pot $0.60 | Rake $0 
Seat 1: DihMHaz4WNETH1bPDe13kA (big blind) folded before Flop
Seat 2: Mhj3q7cxev+XjXZxEE6/Cw collected ($0.60)
Seat 3: 9bpVv1/Qh9IYtXuCtl5VtQ folded before Flop (didn't bet)
Seat 4: 7cx44/slbeTw+Cy7QB8Trg folded before Flop (didn't bet)
Seat 5: lquriepNQBhDV5P1SWHhnA (button) folded before Flop (didn't bet)
Seat 6: jp34e617tIzV8tKIWmfAbA (small blind) folded before Flop




PokerStars Game #59941900768:  Hold'em No Limit ($0.10/$0.25) - 2009/07/01 1:49:45 ET
Table 'isKy4XK8wJM0x735/D4hWA' 6-max Seat #5 is the button
Seat 1: kwsRmpZ1ZaLooISs+zfyKg ($25.10 in chips) 
Seat 2: 6elpmfyt4Zw0yvd8lePSMQ ($38.90 in chips) 
Seat 3: jp34e617tIzV8tKIWmfAbA ($26.05 in chips) 
Seat 4: DFi/Lzkjsfv8QswS80JX9Q ($31.45 in chips) 
Seat 5: lquriepNQBhDV5P1SWHhnA ($25.25 in chips) 
Seat 6: GbCVUNssQ7mqsPWr7J4d3w ($4.75 in chips) 
GbCVUNssQ7mqsPWr7J4d3w: posts small blind $0.10
kwsRmpZ1ZaLooISs+zfyKg: posts big blind $0.25
*** HOLE CARDS ***
6elpmfyt4Zw0yvd8lePSMQ: folds 
jp34e617tIzV8tKIWmfAbA: folds 
DFi/Lzkjsfv8QswS80JX9Q: folds 
lquriepNQBhDV5P1SWHhnA: folds 
GbCVUNssQ7mqsPWr7J4d3w: folds 
Uncalled bet ($0.15) returned to kwsRmpZ1ZaLooISs+zfyKg
kwsRmpZ1ZaLooISs+zfyKg collected $0.20 from pot
*** SUMMARY ***
Total pot $0.20 | Rake $0 
Seat 1: kwsRmpZ1ZaLooISs+zfyKg (big blind) collected ($0.20)
Seat 2: 6elpmfyt4Zw0yvd8lePSMQ folded before Flop (didn't bet)
Seat 3: jp34e617tIzV8tKIWmfAbA folded before Flop (didn't bet)
Seat 4: DFi/Lzkjsfv8QswS80JX9Q folded before Flop (didn't bet)
Seat 5: lquriepNQBhDV5P1SWHhnA (button) folded before Flop (didn't bet)
Seat 6: GbCVUNssQ7mqsPWr7J4d3w (small blind) folded before Flop




PokerStars Game #59941900950:  Hold'em No Limit ($0.10/$0.25) - 2009/07/01 1:49:45 ET
Table 'Mef6A0EMopL6WaFO5/KO9g' 6-max Seat #5 is the button
Seat 1: GbCVUNssQ7mqsPWr7J4d3w ($5 in chips) 
Seat 2: 8ClCHtFXGNplITm+63KB+Q ($29.70 in chips) 
Seat 4: lquriepNQBhDV5P1SWHhnA ($25 in chips) 
Seat 5: DihMHaz4WNETH1bPDe13kA ($41.05 in chips) 
Seat 6: jp34e617tIzV8tKIWmfAbA ($37.65 in chips) 
jp34e617tIzV8tKIWmfAbA: posts small blind $0.10
GbCVUNssQ7mqsPWr7J4d3w: posts big blind $0.25
*** HOLE CARDS ***
8ClCHtFXGNplITm+63KB+Q: folds 
lquriepNQBhDV5P1SWHhnA: folds 
DihMHaz4WNETH1bPDe13kA: raises $0.50 to $0.75
jp34e617tIzV8tKIWmfAbA: folds 
GbCVUNssQ7mqsPWr7J4d3w: folds 
Uncalled bet ($0.50) returned to DihMHaz4WNETH1bPDe13kA
DihMHaz4WNETH1bPDe13kA collected $0.60 from pot
*** SUMMARY ***
Total pot $0.60 | Rake $0 
Seat 1: GbCVUNssQ7mqsPWr7J4d3w (big blind) folded before Flop
Seat 2: 8ClCHtFXGNplITm+63KB+Q folded before Flop (didn't bet)
Seat 4: lquriepNQBhDV5P1SWHhnA folded before Flop (didn't bet)
Seat 5: DihMHaz4WNETH1bPDe13kA (button) collected ($0.60)
Seat 6: jp34e617tIzV8tKIWmfAbA (small blind) folded before Flop




PokerStars Game #59941901256:  Hold'em No Limit ($0.10/$0.25) - 2009/07/01 1:49:46 ET
Table 'MiquQrQZJJq9ZtgRIp9HFQ' 6-max Seat #3 is the button
Seat 1: c3J/KYZ4cNsUEuz8v57I5A ($24.65 in chips) 
Seat 3: 9h7TNZ1TDGRUJXA6rI+ZTw ($9.75 in chips) 
Seat 4: wAKC8C/zN0c8V5v13dm9mA ($51.30 in chips) 
Seat 5: iyZxqznXjv3vtvOJymkoLQ ($26.75 in chips) 
Seat 6: GbCVUNssQ7mqsPWr7J4d3w ($4.65 in chips) 
wAKC8C/zN0c8V5v13dm9mA: posts small blind $0.10
iyZxqznXjv3vtvOJymkoLQ: posts big blind $0.25
*** HOLE CARDS ***
GbCVUNssQ7mqsPWr7J4d3w: folds 
c3J/KYZ4cNsUEuz8v57I5A: folds 
9h7TNZ1TDGRUJXA6rI+ZTw: folds 
wAKC8C/zN0c8V5v13dm9mA: raises $0.75 to $1
iyZxqznXjv3vtvOJymkoLQ: folds 
Uncalled bet ($0.75) returned to wAKC8C/zN0c8V5v13dm9mA
wAKC8C/zN0c8V5v13dm9mA collected $0.50 from pot
*** SUMMARY ***
Total pot $0.50 | Rake $0 
Seat 1: c3J/KYZ4cNsUEuz8v57I5A folded before Flop (didn't bet)
Seat 3: 9h7TNZ1TDGRUJXA6rI+ZTw (button) folded before Flop (didn't bet)
Seat 4: wAKC8C/zN0c8V5v13dm9mA (small blind) collected ($0.50)
Seat 5: iyZxqznXjv3vtvOJymkoLQ (big blind) folded before Flop
Seat 6: GbCVUNssQ7mqsPWr7J4d3w folded before Flop (didn't bet)




PokerStars Game #59941901390:  Hold'em No Limit ($0.10/$0.25) - 2009/07/01 1:49:46 ET
Table 'LwnjzXstPtSrqrV/oDpnXQ' 9-max Seat #9 is the button
Seat 1: 9YN2IkT2JYYKFErZtZvCtA ($21.30 in chips) 
Seat 2: uLP/lYn7oKq9xCChBXsXxw ($26.65 in chips) 
Seat 3: 7je+LC5Mfs6nL8YBVh4frQ ($3.80 in chips) 
Seat 4: CmngQmkKTp8tkl6GMRTl6w ($8.75 in chips) 
Seat 5: Th3FldXKQW6hWVVPahaoOQ ($26.25 in chips) 
Seat 6: ljemhp25Zg+nlA9DLCIiUw ($39.50 in chips) 
Seat 7: c/Dw/6HyqldTzIRodAIZmg ($13.40 in chips) 
Seat 8: ShXPHWfjhfmAwLgDdm6bRQ ($11.30 in chips) 
Seat 9: q6WfTUAD9mowIP63ASq2Dgz/khFDKGihQjwgoiKKPOeg15 in chips) 
9YN2IkT2JYYKFErZtZvCtA: posts small blind $0.10
uLP/lYn7oKq9xCChBXsXxw: posts big blind $0.25
*** HOLE CARDS ***
7je+LC5Mfs6nL8YBVh4frQ: folds 
CmngQmkKTp8tkl6GMRTl6w: folds 
Th3FldXKQW6hWVVPahaoOQ: folds 
ljemhp25Zg+nlA9DLCIiUw: folds 
c/Dw/6HyqldTzIRodAIZmg: folds 
ShXPHWfjhfmAwLgDdm6bRQ: folds 
q6WfTUAD9mowIP63ASq2Dgz/khFDKGihQjwgoiKKPOegs 
9YN2IkT2JYYKFErZtZvCtA: raises $0.50 to $0.75
uLP/lYn7oKq9xCChBXsXxw: folds 
Uncalled bet ($0.50) returned to 9YN2IkT2JYYKFErZtZvCtA
9YN2IkT2JYYKFErZtZvCtA collected $0.50 from pot
9YN2IkT2JYYKFErZtZvCtA: doesn't show hand 
*** SUMMARY ***
Total pot $0.50 | Rake $0 
Seat 1: 9YN2IkT2JYYKFErZtZvCtA (small blind) collected ($0.50)
Seat 2: uLP/lYn7oKq9xCChBXsXxw (big blind) folded before Flop
Seat 3: 7je+LC5Mfs6nL8YBVh4frQ folded before Flop (didn't bet)
Seat 4: CmngQmkKTp8tkl6GMRTl6w folded before Flop (didn't bet)
Seat 5: Th3FldXKQW6hWVVPahaoOQ folded before Flop (didn't bet)
Seat 6: ljemhp25Zg+nlA9DLCIiUw folded before Flop (didn't bet)
Seat 7: c/Dw/6HyqldTzIRodAIZmg folded before Flop (didn't bet)
Seat 8: ShXPHWfjhfmAwLgDdm6bRQ folded before Flop (didn't bet)
Seat 9: q6WfTUAD9mowIP63ASq2Dgz/khFDKGihQjwgoiKKPOegon) folded before Flop (didn't bet)




PokerStars Game #59941901300:  Hold'em No Limit ($0.10/$0.25) - 2009/07/01 1:49:46 ET
Table '8Z6T3ssCpo3VV849U4RgBw' 9-max Seat #4 is the button
Seat 1: Z9W7+g1WMhhZDi7DwGbCFA ($6.15 in chips) 
Seat 2: SpiiQQAzy4MUgV3I5W8giw ($19.10 in chips) 
Seat 3: tLcDklc2rBORNfixyRfVfw ($41.15 in chips) 
Seat 4: RCqMONFrSPSArZh2Jsar/w ($15.90 in chips) 
Seat 5: zDrucyjVn5aeekNEc3cJrA ($15.75 in chips) 
Seat 6: 4qA/3Ajg3pP6fqW+IX9/fQ ($5 in chips) 
Seat 7: oLa/tXLfSLLB28mcLGrxcg ($24.05 in chips) 
Seat 8: PdIasPkzm2sqZnN41ZRXOg ($5.25 in chips) 
Seat 9: HDDm1BkZtdsRyw2DJdqq6A ($31.35 in chips) 
zDrucyjVn5aeekNEc3cJrA: posts small blind $0.10
4qA/3Ajg3pP6fqW+IX9/fQ: posts big blind $0.25
*** HOLE CARDS ***
oLa/tXLfSLLB28mcLGrxcg: calls $0.25
PdIasPkzm2sqZnN41ZRXOg: folds 
HDDm1BkZtdsRyw2DJdqq6A: calls $0.25
Z9W7+g1WMhhZDi7DwGbCFA: folds 
SpiiQQAzy4MUgV3I5W8giw: folds 
tLcDklc2rBORNfixyRfVfw: calls $0.25
RCqMONFrSPSArZh2Jsar/w: folds 
zDrucyjVn5aeekNEc3cJrA: folds 
4qA/3Ajg3pP6fqW+IX9/fQ: checks 
*** FLOP *** [3h Td Ad]
4qA/3Ajg3pP6fqW+IX9/fQ: checks 
oLa/tXLfSLLB28mcLGrxcg: checks 
HDDm1BkZtdsRyw2DJdqq6A: checks 
tLcDklc2rBORNfixyRfVfw: checks 
*** TURN *** [3h Td Ad] [Jd]
4qA/3Ajg3pP6fqW+IX9/fQ: checks 
oLa/tXLfSLLB28mcLGrxcg: checks 
HDDm1BkZtdsRyw2DJdqq6A: checks 
tLcDklc2rBORNfixyRfVfw: checks 
*** RIVER *** [3h Td Ad Jd] [7d]
4qA/3Ajg3pP6fqW+IX9/fQ: checks 
oLa/tXLfSLLB28mcLGrxcg: checks 
HDDm1BkZtdsRyw2DJdqq6A: checks 
tLcDklc2rBORNfixyRfVfw: checks 
*** SHOW DOWN ***
4qA/3Ajg3pP6fqW+IX9/fQ: shows [2s 6s] (high card Ace)
oLa/tXLfSLLB28mcLGrxcg: shows [8d 8s] (a flush, Ace high)
HDDm1BkZtdsRyw2DJdqq6A: mucks hand 
tLcDklc2rBORNfixyRfVfw: mucks hand 
oLa/tXLfSLLB28mcLGrxcg collected $1.05 from pot
*** SUMMARY ***
Total pot $1.10 | Rake $0.05 
Board [3h Td Ad Jd 7d]
Seat 1: Z9W7+g1WMhhZDi7DwGbCFA folded before Flop (didn't bet)
Seat 2: SpiiQQAzy4MUgV3I5W8giw folded before Flop (didn't bet)
Seat 3: tLcDklc2rBORNfixyRfVfw mucked
Seat 4: RCqMONFrSPSArZh2Jsar/w (button) folded before Flop (didn't bet)
Seat 5: zDrucyjVn5aeekNEc3cJrA (small blind) folded before Flop
Seat 6: 4qA/3Ajg3pP6fqW+IX9/fQ (big blind) showed [2s 6s] and lost with high card Ace
Seat 7: oLa/tXLfSLLB28mcLGrxcg showed [8d 8s] and won ($1.05) with a flush, Ace high
Seat 8: PdIasPkzm2sqZnN41ZRXOg folded before Flop (didn't bet)
Seat 9: HDDm1BkZtdsRyw2DJdqq6A mucked




PokerStars Game #59941901344:  Hold'em No Limit ($0.10/$0.25) - 2009/07/01 1:49:46 ET
Table 'WEMI3Mtn7dGARDbgNrKibg' 9-max Seat #8 is the button
Seat 1: Th3FldXKQW6hWVVPahaoOQ ($30.50 in chips) 
Seat 2: tYsOBqdU1+x+yFI7zHO7hQ ($49.90 in chips) 
Seat 3: qwr38jl5txoR36M7G5qi4A ($10 in chips) 
Seat 4: Z5NNIVvnhb2IJbLcI79WYQ ($10.55 in chips) 
Seat 5: yzPZQFeaQTNf1YK3a0zRIw ($9.30 in chips) 
Seat 6: arxNSjreDRGFg13EAM2F1w ($25.10 in chips) 
Seat 7: DnDcAdn9P0zGovMERigpFA ($54.90 in chips) 
Seat 8: ghNKXUBl/H+t83JF079ZBA ($29.25 in chips) 
Seat 9: 2wcFsZsqEP5w1StUTVzJCg ($4.25 in chips) 
2wcFsZsqEP5w1StUTVzJCg: posts small blind $0.10
Th3FldXKQW6hWVVPahaoOQ: posts big blind $0.25
*** HOLE CARDS ***
tYsOBqdU1+x+yFI7zHO7hQ: folds 
qwr38jl5txoR36M7G5qi4A: folds 
Z5NNIVvnhb2IJbLcI79WYQ: folds 
yzPZQFeaQTNf1YK3a0zRIw: folds 
arxNSjreDRGFg13EAM2F1w: folds 
DnDcAdn9P0zGovMERigpFA: folds 
ghNKXUBl/H+t83JF079ZBA: folds 
2wcFsZsqEP5w1StUTVzJCg: calls $0.15
Th3FldXKQW6hWVVPahaoOQ: checks 
*** FLOP *** [Ah Jd Th]
2wcFsZsqEP5w1StUTVzJCg: bets $0.25
Th3FldXKQW6hWVVPahaoOQ: calls $0.25
*** TURN *** [Ah Jd Th] [Qd]
2wcFsZsqEP5w1StUTVzJCg: checks 
Th3FldXKQW6hWVVPahaoOQ: checks 
*** RIVER *** [Ah Jd Th Qd] [Kd]
2wcFsZsqEP5w1StUTVzJCg: checks 
Th3FldXKQW6hWVVPahaoOQ: checks 
*** SHOW DOWN ***
2wcFsZsqEP5w1StUTVzJCg: shows [4d Ac] (a straight, Ten to Ace)
Th3FldXKQW6hWVVPahaoOQ: shows [3d 3h] (a straight, Ten to Ace)
2wcFsZsqEP5w1StUTVzJCg collected $0.50 from pot
Th3FldXKQW6hWVVPahaoOQ collected $0.45 from pot
*** SUMMARY ***
Total pot $1 | Rake $0.05 
Board [Ah Jd Th Qd Kd]
Seat 1: Th3FldXKQW6hWVVPahaoOQ (big blind) showed [3d 3h] and won ($0.45) with a straight, Ten to Ace
Seat 2: tYsOBqdU1+x+yFI7zHO7hQ folded before Flop (didn't bet)
Seat 3: qwr38jl5txoR36M7G5qi4A folded before Flop (didn't bet)
Seat 4: Z5NNIVvnhb2IJbLcI79WYQ folded before Flop (didn't bet)
Seat 5: yzPZQFeaQTNf1YK3a0zRIw folded before Flop (didn't bet)
Seat 6: arxNSjreDRGFg13EAM2F1w folded before Flop (didn't bet)
Seat 7: DnDcAdn9P0zGovMERigpFA folded before Flop (didn't bet)
Seat 8: ghNKXUBl/H+t83JF079ZBA (button) folded before Flop (didn't bet)
Seat 9: 2wcFsZsqEP5w1StUTVzJCg (small blind) showed [4d Ac] and won ($0.50) with a straight, Ten to Ace




PokerStars Game #59941901272:  Hold'em No Limit ($0.10/$0.25) - 2009/07/01 1:49:46 ET
Table '3Ns9nuTkynfwbBfBXzg6ww' 6-max Seat #2 is the button
Seat 1: epAUIB7h2FJXzUPRIvSkRA ($25.70 in chips) 
Seat 2: zxeVQGaMKDsDzmSY+AInjA ($31.40 in chips) 
Seat 3: eL3+wCBjFGfQ5FMdIZihwA ($23.70 in chips) 
Seat 4: qGHGf/553gQnDoklMRe3tg ($30.85 in chips) 
Seat 5: wqphQtauX5Qn7WRJZS1flA ($24.05 in chips) 
Seat 6: DE9hRlt14g+JdsRQ4wT7hg ($39.10 in chips) 
eL3+wCBjFGfQ5FMdIZihwA: posts small blind $0.10
qGHGf/553gQnDoklMRe3tg: posts big blind $0.25
*** HOLE CARDS ***
wqphQtauX5Qn7WRJZS1flA: folds 
DE9hRlt14g+JdsRQ4wT7hg: folds 
epAUIB7h2FJXzUPRIvSkRA: raises $0.75 to $1
zxeVQGaMKDsDzmSY+AInjA: folds 
eL3+wCBjFGfQ5FMdIZihwA: folds 
qGHGf/553gQnDoklMRe3tg: folds 
Uncalled bet ($0.75) returned to epAUIB7h2FJXzUPRIvSkRA
epAUIB7h2FJXzUPRIvSkRA collected $0.60 from pot
epAUIB7h2FJXzUPRIvSkRA: doesn't show hand 
*** SUMMARY ***
Total pot $0.60 | Rake $0 
Seat 1: epAUIB7h2FJXzUPRIvSkRA collected ($0.60)
Seat 2: zxeVQGaMKDsDzmSY+AInjA (button) folded before Flop (didn't bet)
Seat 3: eL3+wCBjFGfQ5FMdIZihwA (small blind) folded before Flop
Seat 4: qGHGf/553gQnDoklMRe3tg (big blind) folded before Flop
Seat 5: wqphQtauX5Qn7WRJZS1flA folded before Flop (didn't bet)
Seat 6: DE9hRlt14g+JdsRQ4wT7hg folded before Flop (didn't bet)




PokerStars Game #59941901548:  Hold'em No Limit ($0.10/$0.25) - 2009/07/01 1:49:47 ET
Table 'FE/j6VqBY4j9Uq+VHURQCQ' 6-max Seat #5 is the button
Seat 1: ypmjhffk/YHGc51wgVXUTw ($39.65 in chips) 
Seat 2: 3zD3qLXT1bEffAoWGnc7wg ($37.10 in chips) 
Seat 3: lBoEwOFgzcERLIRUkUoRTw ($27.50 in chips) 
Seat 4: 7JyPCA0J2grhXQYxe1h3+A ($7.10 in chips) 
Seat 5: bJFzs6QmEEnz4miMfSDtcg ($16.55 in chips) 
Seat 6: Q1uciOZPBR/WkAlqa6cL4A ($25 in chips) 
Q1uciOZPBR/WkAlqa6cL4A: posts small blind $0.10
ypmjhffk/YHGc51wgVXUTw: posts big blind $0.25
*** HOLE CARDS ***
3zD3qLXT1bEffAoWGnc7wg: folds 
lBoEwOFgzcERLIRUkUoRTw: folds 
7JyPCA0J2grhXQYxe1h3+A: folds 
bJFzs6QmEEnz4miMfSDtcg: raises $0.50 to $0.75
Q1uciOZPBR/WkAlqa6cL4A: folds 
ypmjhffk/YHGc51wgVXUTw: folds 
Uncalled bet ($0.50) returned to bJFzs6QmEEnz4miMfSDtcg
bJFzs6QmEEnz4miMfSDtcg collected $0.60 from pot
*** SUMMARY ***
Total pot $0.60 | Rake $0 
Seat 1: ypmjhffk/YHGc51wgVXUTw (big blind) folded before Flop
Seat 2: 3zD3qLXT1bEffAoWGnc7wg folded before Flop (didn't bet)
Seat 3: lBoEwOFgzcERLIRUkUoRTw folded before Flop (didn't bet)
Seat 4: 7JyPCA0J2grhXQYxe1h3+A folded before Flop (didn't bet)
Seat 5: bJFzs6QmEEnz4miMfSDtcg (button) collected ($0.60)
Seat 6: Q1uciOZPBR/WkAlqa6cL4A (small blind) folded before Flop




PokerStars Game #59941901850:  Hold'em No Limit ($0.10/$0.25) - 2009/07/01 1:49:47 ET
Table 'zKwHJD0cmKNUure9qQTfFg' 6-max Seat #2 is the button
Seat 1: Hzrn9DZJegEZICufTNYkrg ($18.50 in chips) 
Seat 2: xrf8tAXKQHG99HixCot1Iw ($30.30 in chips) 
Seat 3: m9aw7LBAB5YX2ZqMtMkhqA ($14 in chips) 
Seat 4: v+QfkGiuj9bgtuNoVnDO8w ($25 in chips) 
Seat 5: E4AqQ1egsnu0oH2RqsbCmQ ($4.65 in chips) 
Seat 6: edio/rLJ06xeZOfLhoL3UA ($5.85 in chips) 
m9aw7LBAB5YX2ZqMtMkhqA: posts small blind $0.10
v+QfkGiuj9bgtuNoVnDO8w: posts big blind $0.25
*** HOLE CARDS ***
E4AqQ1egsnu0oH2RqsbCmQ: folds 
edio/rLJ06xeZOfLhoL3UA: folds 
Hzrn9DZJegEZICufTNYkrg: calls $0.25
xrf8tAXKQHG99HixCot1Iw: raises $0.75 to $1
m9aw7LBAB5YX2ZqMtMkhqA: folds 
v+QfkGiuj9bgtuNoVnDO8w: folds 
Hzrn9DZJegEZICufTNYkrg: calls $0.75
*** FLOP *** [4h 9s 6d]
Hzrn9DZJegEZICufTNYkrg: checks 
xrf8tAXKQHG99HixCot1Iw: bets $1.25
Hzrn9DZJegEZICufTNYkrg: folds 
Uncalled bet ($1.25) returned to xrf8tAXKQHG99HixCot1Iw
xrf8tAXKQHG99HixCot1Iw collected $2.25 from pot
xrf8tAXKQHG99HixCot1Iw: doesn't show hand 
*** SUMMARY ***
Total pot $2.35 | Rake $0.10 
Board [4h 9s 6d]
Seat 1: Hzrn9DZJegEZICufTNYkrg folded on the Flop
Seat 2: xrf8tAXKQHG99HixCot1Iw (button) collected ($2.25)
Seat 3: m9aw7LBAB5YX2ZqMtMkhqA (small blind) folded before Flop
Seat 4: v+QfkGiuj9bgtuNoVnDO8w (big blind) folded before Flop
Seat 5: E4AqQ1egsnu0oH2RqsbCmQ folded before Flop (didn't bet)
Seat 6: edio/rLJ06xeZOfLhoL3UA folded before Flop (didn't bet)




PokerStars Game #59941901512:  Hold'em No Limit ($0.10/$0.25) - 2009/07/01 1:49:47 ET
Table 'qryc9C/ELyQ3lubOaELNAQ' 6-max Seat #2 is the button
Seat 1: OZc6kkoTwtITj1ZfreJK1A ($66.50 in chips) 
Seat 2: LtASJ9OlkqGrrUKGQlpGAw ($29.95 in chips) 
Seat 3: wvIIdlbCgePONQwXjx9xzQ ($3.45 in chips) 
Seat 4: v+QfkGiuj9bgtuNoVnDO8w ($25 in chips) 
Seat 5: 9StOHp+Y1T0K13JdgS2oQQ ($38.55 in chips) 
Seat 6: xmdItDBraeGrrs3wzz1J3w ($18.85 in chips) 
wvIIdlbCgePONQwXjx9xzQ: posts small blind $0.10
v+QfkGiuj9bgtuNoVnDO8w: posts big blind $0.25
*** HOLE CARDS ***
9StOHp+Y1T0K13JdgS2oQQ: folds 
xmdItDBraeGrrs3wzz1J3w: folds 
OZc6kkoTwtITj1ZfreJK1A: folds 
LtASJ9OlkqGrrUKGQlpGAw: folds 
wvIIdlbCgePONQwXjx9xzQ: folds 
Uncalled bet ($0.15) returned to v+QfkGiuj9bgtuNoVnDO8w
v+QfkGiuj9bgtuNoVnDO8w collected $0.20 from pot
v+QfkGiuj9bgtuNoVnDO8w: doesn't show hand 
*** SUMMARY ***
Total pot $0.20 | Rake $0 
Seat 1: OZc6kkoTwtITj1ZfreJK1A folded before Flop (didn't bet)
Seat 2: LtASJ9OlkqGrrUKGQlpGAw (button) folded before Flop (didn't bet)
Seat 3: wvIIdlbCgePONQwXjx9xzQ (small blind) folded before Flop
Seat 4: v+QfkGiuj9bgtuNoVnDO8w (big blind) collected ($0.20)
Seat 5: 9StOHp+Y1T0K13JdgS2oQQ folded before Flop (didn't bet)
Seat 6: xmdItDBraeGrrs3wzz1J3w folded before Flop (didn't bet)




PokerStars Game #59941901570:  Hold'em No Limit ($0.10/$0.25) - 2009/07/01 1:49:47 ET
Table '4hfTdIVT/qPsJNfWXLsVIw' 9-max Seat #3 is the button
Seat 1: GbHFBbLqLGz0Pwn6CJeAuw ($38.20 in chips) 
Seat 2: Pt637jKksB5MzP0UNJAAkw ($39.85 in chips) 
Seat 3: xnVwSkROfRtOw4eSoDANtw ($2.10 in chips) 
Seat 4: 3PmVnC/15cl4oyI1TKIt4g ($5.60 in chips) 
Seat 5: dtZ84flFEi4Q+SGrHMJRDQ ($26.35 in chips) 
Seat 6: VWUWpMLMj/Q1jRVpF7Aohw ($12.90 in chips) 
Seat 7: d7YasxuGLPiL7pj8IcGThw ($5.70 in chips) 
Seat 8: 7cv+9Zc9HIQHNvYsMfV3uA ($33.30 in chips) 
Seat 9: 9njEKzpOKC62MllUFUBWrA ($23 in chips) 
3PmVnC/15cl4oyI1TKIt4g: posts small blind $0.10
dtZ84flFEi4Q+SGrHMJRDQ: posts big blind $0.25
*** HOLE CARDS ***
VWUWpMLMj/Q1jRVpF7Aohw: calls $0.25
d7YasxuGLPiL7pj8IcGThw: raises $0.50 to $0.75
7cv+9Zc9HIQHNvYsMfV3uA: calls $0.75
9njEKzpOKC62MllUFUBWrA: folds 
GbHFBbLqLGz0Pwn6CJeAuw: folds 
Pt637jKksB5MzP0UNJAAkw: folds 
xnVwSkROfRtOw4eSoDANtw: folds 
3PmVnC/15cl4oyI1TKIt4g: folds 
dtZ84flFEi4Q+SGrHMJRDQ: folds 
VWUWpMLMj/Q1jRVpF7Aohw: calls $0.50
*** FLOP *** [Qc 5s 8d]
VWUWpMLMj/Q1jRVpF7Aohw: checks 
d7YasxuGLPiL7pj8IcGThw: bets $0.75
7cv+9Zc9HIQHNvYsMfV3uA: folds 
VWUWpMLMj/Q1jRVpF7Aohw: folds 
Uncalled bet ($0.75) returned to d7YasxuGLPiL7pj8IcGThw
d7YasxuGLPiL7pj8IcGThw collected $2.50 from pot
*** SUMMARY ***
Total pot $2.60 | Rake $0.10 
Board [Qc 5s 8d]
Seat 1: GbHFBbLqLGz0Pwn6CJeAuw folded before Flop (didn't bet)
Seat 2: Pt637jKksB5MzP0UNJAAkw folded before Flop (didn't bet)
Seat 3: xnVwSkROfRtOw4eSoDANtw (button) folded before Flop (didn't bet)
Seat 4: 3PmVnC/15cl4oyI1TKIt4g (small blind) folded before Flop
Seat 5: dtZ84flFEi4Q+SGrHMJRDQ (big blind) folded before Flop
Seat 6: VWUWpMLMj/Q1jRVpF7Aohw folded on the Flop
Seat 7: d7YasxuGLPiL7pj8IcGThw collected ($2.50)
Seat 8: 7cv+9Zc9HIQHNvYsMfV3uA folded on the Flop
Seat 9: 9njEKzpOKC62MllUFUBWrA folded before Flop (didn't bet)




PokerStars Game #59941901534:  Hold'em No Limit ($0.10/$0.25) - 2009/07/01 1:49:47 ET
Table 'fRxOyfaHXkWUDLv4eSxFew' 9-max Seat #5 is the button
Seat 1: 6RiVTYll/5D8zICp0MRpKw ($29.40 in chips) 
Seat 2: M2QO2DxB5Wawg2h8HSpnYA ($10 in chips) 
Seat 3: E0iYnEVO2ho7dH3QcCjw7g ($29.35 in chips) 
Seat 4: MtVtHDqIJTyUcXkRBBDIVA ($27.60 in chips) 
Seat 5: dmYlc+1cjwZMJ7wV+Z0rRg ($22.40 in chips) 
Seat 6: arxNSjreDRGFg13EAM2F1w ($27.15 in chips) 
Seat 7: 1/DuWziR8CXhWB71aPQd9Q ($11.55 in chips) 
Seat 8: 5n7e7I+px7c6CQmLpPbtsg ($5.90 in chips) 
Seat 9: H5Se03ZqSX7tbULXur2MAg ($32.65 in chips) 
arxNSjreDRGFg13EAM2F1w: posts small blind $0.10
1/DuWziR8CXhWB71aPQd9Q: posts big blind $0.25
*** HOLE CARDS ***
5n7e7I+px7c6CQmLpPbtsg: folds 
H5Se03ZqSX7tbULXur2MAg: folds 
6RiVTYll/5D8zICp0MRpKw: folds 
M2QO2DxB5Wawg2h8HSpnYA: folds 
E0iYnEVO2ho7dH3QcCjw7g: raises $0.75 to $1
MtVtHDqIJTyUcXkRBBDIVA: folds 
dmYlc+1cjwZMJ7wV+Z0rRg: folds 
arxNSjreDRGFg13EAM2F1w: folds 
1/DuWziR8CXhWB71aPQd9Q: folds 
Uncalled bet ($0.75) returned to E0iYnEVO2ho7dH3QcCjw7g
E0iYnEVO2ho7dH3QcCjw7g collected $0.60 from pot
*** SUMMARY ***
Total pot $0.60 | Rake $0 
Seat 1: 6RiVTYll/5D8zICp0MRpKw folded before Flop (didn't bet)
Seat 2: M2QO2DxB5Wawg2h8HSpnYA folded before Flop (didn't bet)
Seat 3: E0iYnEVO2ho7dH3QcCjw7g collected ($0.60)
Seat 4: MtVtHDqIJTyUcXkRBBDIVA folded before Flop (didn't bet)
Seat 5: dmYlc+1cjwZMJ7wV+Z0rRg (button) folded before Flop (didn't bet)
Seat 6: arxNSjreDRGFg13EAM2F1w (small blind) folded before Flop
Seat 7: 1/DuWziR8CXhWB71aPQd9Q (big blind) folded before Flop
Seat 8: 5n7e7I+px7c6CQmLpPbtsg folded before Flop (didn't bet)
Seat 9: H5Se03ZqSX7tbULXur2MAg folded before Flop (didn't bet)




PokerStars Game #59941901592:  Hold'em No Limit ($0.10/$0.25) - 2009/07/01 1:49:47 ET
Table 'z2yOdY2zyGWG1gh9WV9XtQdYNvO8G5kw5SRxb1Dljhog Seat #5 is the button
Seat 1: vSkQm2EelzwRGDDQQk0Fqw ($17.30 in chips) 
Seat 2: PkBmevN3LdXkPj1LHOoTnQ ($1.35 in chips) 
Seat 3: 1Cs1GyQcoM1omwY7XZ3uRg ($12 in chips) 
Seat 4: sD+TKtt36XiiN6jqHiLwDA ($28.10 in chips) 
Seat 5: W7XGvw6ngGVq2hFwXk8Myg ($25.85 in chips) 
Seat 6: 22dIObOuor/A+IKWkNoAlA ($8.05 in chips) 
Seat 7: DiSvPC2iudwL5j9u6Huyww ($39.75 in chips) 
Seat 8: 5hAPbqNrvJb8PtLiceXtlg6HoFYfVGBefsR5Vrz62qIw0 in chips) 
Seat 9: PdIasPkzm2sqZnN41ZRXOg ($5 in chips) 
22dIObOuor/A+IKWkNoAlA: posts small blind $0.10
DiSvPC2iudwL5j9u6Huyww: posts big blind $0.25
*** HOLE CARDS ***
5hAPbqNrvJb8PtLiceXtlg6HoFYfVGBefsR5Vrz62qIwises $0.50 to $0.75
PdIasPkzm2sqZnN41ZRXOg: folds 
vSkQm2EelzwRGDDQQk0Fqw: folds 
PkBmevN3LdXkPj1LHOoTnQ: folds 
1Cs1GyQcoM1omwY7XZ3uRg: folds 
sD+TKtt36XiiN6jqHiLwDA: folds 
W7XGvw6ngGVq2hFwXk8Myg: calls $0.75
22dIObOuor/A+IKWkNoAlA: folds 
DiSvPC2iudwL5j9u6Huyww: folds 
*** FLOP *** [4s Tc Js]
5hAPbqNrvJb8PtLiceXtlg6HoFYfVGBefsR5Vrz62qIwts $1
W7XGvw6ngGVq2hFwXk8Myg: folds 
Uncalled bet ($1) returned to 5hAPbqNrvJb8PtLiceXtlg6HoFYfVGBefsR5Vrz62qIw5hAPbqNrvJb8PtLiceXtlg3011 collected $1.80 from pot
*** SUMMARY ***
Total pot $1.85 | Rake $0.05 
Board [4s Tc Js]
Seat 1: vSkQm2EelzwRGDDQQk0Fqw folded before Flop (didn't bet)
Seat 2: PkBmevN3LdXkPj1LHOoTnQ folded before Flop (didn't bet)
Seat 3: 1Cs1GyQcoM1omwY7XZ3uRg folded before Flop (didn't bet)
Seat 4: sD+TKtt36XiiN6jqHiLwDA folded before Flop (didn't bet)
Seat 5: W7XGvw6ngGVq2hFwXk8Myg (button) folded on the Flop
Seat 6: 22dIObOuor/A+IKWkNoAlA (small blind) folded before Flop
Seat 7: DiSvPC2iudwL5j9u6Huyww (big blind) folded before Flop
Seat 8: 5hAPbqNrvJb8PtLiceXtlg6HoFYfVGBefsR5Vrz62qIwlected ($1.80)
Seat 9: PdIasPkzm2sqZnN41ZRXOg folded before Flop (didn't bet)




PokerStars Game #59941901696:  Hold'em No Limit ($0.10/$0.25) - 2009/07/01 1:49:47 ET
Table '0XPo7K54oZIfG0xlNAcDRw' 9-max Seat #2 is the button
Seat 2: Prl9QvWQw/mISF4dSnnQUQ ($10.10 in chips) 
Seat 3: RHqgdFvufLCYe54+qd2gcA ($5 in chips) 
Seat 4: RubYqfvGrz2z+5ReNIj9QQ ($31.10 in chips) 
Seat 5: iOmwbUN7u4JFkV6VCA49aA ($16.25 in chips) 
Seat 6: M1nKET7WOTLbVPuAbJa3EA ($14.40 in chips) 
Seat 7: tYsOBqdU1+x+yFI7zHO7hQ ($28.45 in chips) 
Seat 8: v5jnQ1gfh9nLla3kMXG7Yg ($15.95 in chips) 
Seat 9: CmngQmkKTp8tkl6GMRTl6w ($13.25 in chips) 
RHqgdFvufLCYe54+qd2gcA: posts small blind $0.10
RubYqfvGrz2z+5ReNIj9QQ: posts big blind $0.25
4awUyiDYTgylQKXZ9faBVA: sits out 
*** HOLE CARDS ***
iOmwbUN7u4JFkV6VCA49aA: raises $0.25 to $0.50
M1nKET7WOTLbVPuAbJa3EA: folds 
tYsOBqdU1+x+yFI7zHO7hQ: folds 
v5jnQ1gfh9nLla3kMXG7Yg: folds 
CmngQmkKTp8tkl6GMRTl6w: folds 
Prl9QvWQw/mISF4dSnnQUQ: folds 
RHqgdFvufLCYe54+qd2gcA: folds 
RubYqfvGrz2z+5ReNIj9QQ: folds 
Uncalled bet ($0.25) returned to iOmwbUN7u4JFkV6VCA49aA
iOmwbUN7u4JFkV6VCA49aA collected $0.60 from pot
iOmwbUN7u4JFkV6VCA49aA: doesn't show hand 
*** SUMMARY ***
Total pot $0.60 | Rake $0 
Seat 2: Prl9QvWQw/mISF4dSnnQUQ (button) folded before Flop (didn't bet)
Seat 3: RHqgdFvufLCYe54+qd2gcA (small blind) folded before Flop
Seat 4: RubYqfvGrz2z+5ReNIj9QQ (big blind) folded before Flop
Seat 5: iOmwbUN7u4JFkV6VCA49aA collected ($0.60)
Seat 6: M1nKET7WOTLbVPuAbJa3EA folded before Flop (didn't bet)
Seat 7: tYsOBqdU1+x+yFI7zHO7hQ folded before Flop (didn't bet)
Seat 8: v5jnQ1gfh9nLla3kMXG7Yg folded before Flop (didn't bet)
Seat 9: CmngQmkKTp8tkl6GMRTl6w folded before Flop (didn't bet)




PokerStars Game #59941901578:  Hold'em No Limit ($0.10/$0.25) - 2009/07/01 1:49:47 ET
Table 'YlRA05h9BJ1EhOUSNUjJdg' 9-max Seat #5 is the button
Seat 1: dtZ84flFEi4Q+SGrHMJRDQ ($25 in chips) 
Seat 2: Y2GFAe+PT7xnUUtgqCNDFw ($8.70 in chips) 
Seat 3: Z5ZtGOON8kmSdSCll9Z3XA ($12.85 in chips) 
Seat 4: HPEB+AtKw1+C/cxU0o1ciw ($33.95 in chips) 
Seat 5: sx0lGrkT9fd4yFR+3cXUQg ($11.15 in chips) 
Seat 6: QEbIGci+itdw+re8RM5fZA ($44.50 in chips) 
Seat 7: dfNim92Z6XK1/h5SFW5vDg ($25 in chips) 
Seat 8: dmYlc+1cjwZMJ7wV+Z0rRg ($32.90 in chips) 
QEbIGci+itdw+re8RM5fZA: posts small blind $0.10
dfNim92Z6XK1/h5SFW5vDg: posts big blind $0.25
GeMoapCKDLc4ajT0Uk9ZQw: sits out 
*** HOLE CARDS ***
dmYlc+1cjwZMJ7wV+Z0rRg: folds 
dtZ84flFEi4Q+SGrHMJRDQ: folds 
Y2GFAe+PT7xnUUtgqCNDFw: calls $0.25
Z5ZtGOON8kmSdSCll9Z3XA: folds 
HPEB+AtKw1+C/cxU0o1ciw: folds 
sx0lGrkT9fd4yFR+3cXUQg: folds 
QEbIGci+itdw+re8RM5fZA: folds 
dfNim92Z6XK1/h5SFW5vDg: checks 
*** FLOP *** [6s Qc Kh]
dfNim92Z6XK1/h5SFW5vDg: checks 
Y2GFAe+PT7xnUUtgqCNDFw: checks 
*** TURN *** [6s Qc Kh] [5c]
dfNim92Z6XK1/h5SFW5vDg: checks 
Y2GFAe+PT7xnUUtgqCNDFw: checks 
*** RIVER *** [6s Qc Kh 5c] [7d]
dfNim92Z6XK1/h5SFW5vDg: checks 
Y2GFAe+PT7xnUUtgqCNDFw: checks 
*** SHOW DOWN ***
dfNim92Z6XK1/h5SFW5vDg: shows [Jd 8h] (high card King)
Y2GFAe+PT7xnUUtgqCNDFw: shows [9c Ad] (high card Ace)
Y2GFAe+PT7xnUUtgqCNDFw collected $0.60 from pot
*** SUMMARY ***
Total pot $0.60 | Rake $0 
Board [6s Qc Kh 5c 7d]
Seat 1: dtZ84flFEi4Q+SGrHMJRDQ folded before Flop (didn't bet)
Seat 2: Y2GFAe+PT7xnUUtgqCNDFw showed [9c Ad] and won ($0.60) with high card Ace
Seat 3: Z5ZtGOON8kmSdSCll9Z3XA folded before Flop (didn't bet)
Seat 4: HPEB+AtKw1+C/cxU0o1ciw folded before Flop (didn't bet)
Seat 5: sx0lGrkT9fd4yFR+3cXUQg (button) folded before Flop (didn't bet)
Seat 6: QEbIGci+itdw+re8RM5fZA (small blind) folded before Flop
Seat 7: dfNim92Z6XK1/h5SFW5vDg (big blind) showed [Jd 8h] and lost with high card King
Seat 8: dmYlc+1cjwZMJ7wV+Z0rRg folded before Flop (didn't bet)




PokerStars Game #59941901684:  Hold'em No Limit ($0.10/$0.25) - 2009/07/01 1:49:47 ET
Table 'C47I7CmrmFr8Oo7wOovVwQ' 6-max Seat #3 is the button
Seat 2: 8JTm/CXBn3+kuQgcUOgPkw ($25 in chips) 
Seat 3: H+8eOP3XJHXjACRDTiIHTQ ($21.95 in chips) 
Seat 4: yY5JuFtDfXWRaZlVby4LLw ($5.15 in chips) 
Seat 5: or309yYY9Y9bfFWtrB0yUg ($9.95 in chips) 
Seat 6: pD7ri5wL3vsa6S1ulMYQmQ ($25.55 in chips) 
yY5JuFtDfXWRaZlVby4LLw: posts small blind $0.10
or309yYY9Y9bfFWtrB0yUg: posts big blind $0.25
8JTm/CXBn3+kuQgcUOgPkw: posts big blind $0.25
*** HOLE CARDS ***
pD7ri5wL3vsa6S1ulMYQmQ: calls $0.25
jxarturo joins the table at seat #1 
8JTm/CXBn3+kuQgcUOgPkw: checks 
H+8eOP3XJHXjACRDTiIHTQ: folds 
yY5JuFtDfXWRaZlVby4LLw: calls $0.15
or309yYY9Y9bfFWtrB0yUg: checks 
*** FLOP *** [7s Ac Th]
yY5JuFtDfXWRaZlVby4LLw: checks 
or309yYY9Y9bfFWtrB0yUg: checks 
pD7ri5wL3vsa6S1ulMYQmQ: bets $0.75
8JTm/CXBn3+kuQgcUOgPkw: folds 
yY5JuFtDfXWRaZlVby4LLw: calls $0.75
or309yYY9Y9bfFWtrB0yUg: folds 
*** TURN *** [7s Ac Th] [6s]
yY5JuFtDfXWRaZlVby4LLw: checks 
pD7ri5wL3vsa6S1ulMYQmQ: bets $1.25
yY5JuFtDfXWRaZlVby4LLw: folds 
Uncalled bet ($1.25) returned to pD7ri5wL3vsa6S1ulMYQmQ
pD7ri5wL3vsa6S1ulMYQmQ collected $2.40 from pot
*** SUMMARY ***
Total pot $2.50 | Rake $0.10 
Board [7s Ac Th 6s]
Seat 2: 8JTm/CXBn3+kuQgcUOgPkw folded on the Flop
Seat 3: H+8eOP3XJHXjACRDTiIHTQ (button) folded before Flop (didn't bet)
Seat 4: yY5JuFtDfXWRaZlVby4LLw (small blind) folded on the Turn
Seat 5: or309yYY9Y9bfFWtrB0yUg (big blind) folded on the Flop
Seat 6: pD7ri5wL3vsa6S1ulMYQmQ collected ($2.40)




PokerStars Game #59941901802:  Hold'em No Limit ($0.10/$0.25) - 2009/07/01 1:49:47 ET
Table 'nc6OeGk/wtaWV+6N+kgnZQ' 6-max Seat #3 is the button
Seat 2: 8ClCHtFXGNplITm+63KB+Q ($37.60 in chips) 
Seat 3: y8wpMWGSX2zHZijurx21mg ($4 in chips) 
Seat 4: 3zD3qLXT1bEffAoWGnc7wg ($31.30 in chips) 
Seat 5: HCS0lMAAPmZE2Tl8J/SuKw ($10.55 in chips) 
3zD3qLXT1bEffAoWGnc7wg: posts small blind $0.10
HCS0lMAAPmZE2Tl8J/SuKw: posts big blind $0.25
*** HOLE CARDS ***
8ClCHtFXGNplITm+63KB+Q: folds 
y8wpMWGSX2zHZijurx21mg: calls $0.25
3zD3qLXT1bEffAoWGnc7wg: folds 
HCS0lMAAPmZE2Tl8J/SuKw: checks 
*** FLOP *** [4d Jc Kc]
mFv3iBCtrw9XfCDRB0d46Q leaves the table
HCS0lMAAPmZE2Tl8J/SuKw: checks 
y8wpMWGSX2zHZijurx21mg: bets $0.50
HCS0lMAAPmZE2Tl8J/SuKw: calls $0.50
*** TURN *** [4d Jc Kc] [5h]
HCS0lMAAPmZE2Tl8J/SuKw: checks 
Fodao7 joins the table at seat #6 
y8wpMWGSX2zHZijurx21mg: bets $0.50
HCS0lMAAPmZE2Tl8J/SuKw: calls $0.50
*** RIVER *** [4d Jc Kc 5h] [Qd]
HCS0lMAAPmZE2Tl8J/SuKw: checks 
y8wpMWGSX2zHZijurx21mg: bets $0.25
HCS0lMAAPmZE2Tl8J/SuKw: calls $0.25
*** SHOW DOWN ***
y8wpMWGSX2zHZijurx21mg: shows [Kh Td] (a pair of Kings)
HCS0lMAAPmZE2Tl8J/SuKw: mucks hand 
y8wpMWGSX2zHZijurx21mg collected $2.95 from pot
*** SUMMARY ***
Total pot $3.10 | Rake $0.15 
Board [4d Jc Kc 5h Qd]
Seat 2: 8ClCHtFXGNplITm+63KB+Q folded before Flop (didn't bet)
Seat 3: y8wpMWGSX2zHZijurx21mg (button) showed [Kh Td] and won ($2.95) with a pair of Kings
Seat 4: 3zD3qLXT1bEffAoWGnc7wg (small blind) folded before Flop
Seat 5: HCS0lMAAPmZE2Tl8J/SuKw (big blind) mucked




PokerStars Game #59941902150:  Hold'em No Limit ($0.10/$0.25) - 2009/07/01 1:49:48 ET
Table 'KTZXQ4LREPjpS54R3DFTsw' 9-max Seat #5 is the button
Seat 1: dSjkBIV7Bv+ZCIWNBguf7w ($40.85 in chips) 
Seat 2: OlPJsgR4xypSg/w1z7Gyvw ($16.35 in chips) 
Seat 3: H5Se03ZqSX7tbULXur2MAg ($28.50 in chips) 
Seat 4: K0b5wNInj6hUGRr6yzKFtw ($64 in chips) 
Seat 5: HPEB+AtKw1+C/cxU0o1ciw ($28.85 in chips) 
Seat 6: Mh2r9hTeTEDnh19sRZtW3g ($5.45 in chips) 
Seat 7: yyG4svzOpC1A+sUP/scg6w ($10.95 in chips) 
Seat 9: V6p0jQ/RhUsqpHLmXvEX4Q ($12.45 in chips) 
Mh2r9hTeTEDnh19sRZtW3g: posts small blind $0.10
yyG4svzOpC1A+sUP/scg6w: posts big blind $0.25
mMd8CDS/but3UC+Zp7Up2w: sits out 
*** HOLE CARDS ***
V6p0jQ/RhUsqpHLmXvEX4Q: raises $0.50 to $0.75
dSjkBIV7Bv+ZCIWNBguf7w: folds 
OlPJsgR4xypSg/w1z7Gyvw: folds 
H5Se03ZqSX7tbULXur2MAg: calls $0.75
K0b5wNInj6hUGRr6yzKFtw: folds 
HPEB+AtKw1+C/cxU0o1ciw: folds 
Mh2r9hTeTEDnh19sRZtW3g: folds 
yyG4svzOpC1A+sUP/scg6w: folds 
*** FLOP *** [Ks 4c 2c]
V6p0jQ/RhUsqpHLmXvEX4Q: bets $1.50
H5Se03ZqSX7tbULXur2MAg: calls $1.50
*** TURN *** [Ks 4c 2c] [6h]
V6p0jQ/RhUsqpHLmXvEX4Q: checks 
H5Se03ZqSX7tbULXur2MAg: bets $1.75
K0b5wNInj6hUGRr6yzKFtw leaves the table
V6p0jQ/RhUsqpHLmXvEX4Q: folds 
Uncalled bet ($1.75) returned to H5Se03ZqSX7tbULXur2MAg
H5Se03ZqSX7tbULXur2MAg collected $4.65 from pot
H5Se03ZqSX7tbULXur2MAg: doesn't show hand 
*** SUMMARY ***
Total pot $4.85 | Rake $0.20 
Board [Ks 4c 2c 6h]
Seat 1: dSjkBIV7Bv+ZCIWNBguf7w folded before Flop (didn't bet)
Seat 2: OlPJsgR4xypSg/w1z7Gyvw folded before Flop (didn't bet)
Seat 3: H5Se03ZqSX7tbULXur2MAg collected ($4.65)
Seat 4: K0b5wNInj6hUGRr6yzKFtw folded before Flop (didn't bet)
Seat 5: HPEB+AtKw1+C/cxU0o1ciw (button) folded before Flop (didn't bet)
Seat 6: Mh2r9hTeTEDnh19sRZtW3g (small blind) folded before Flop
Seat 7: yyG4svzOpC1A+sUP/scg6w (big blind) folded before Flop
Seat 9: V6p0jQ/RhUsqpHLmXvEX4Q folded on the Turn




PokerStars Game #59941902122:  Hold'em No Limit ($0.10/$0.25) - 2009/07/01 1:49:48 ET
Table 'SbSV5tlgLp0+/Z+13PW3Hg' 9-max Seat #4 is the button
Seat 1: x+W5+3qsdY4Iszf0hoH+Aw ($18.80 in chips) 
Seat 2: zDrucyjVn5aeekNEc3cJrA ($13.80 in chips) 
Seat 3: CT7Xj/V/O5rBlhtt+RZeFQ ($25.60 in chips) 
Seat 4: puj3K/wrNjEj86ZL/MyfLA ($9 in chips) 
Seat 6: pN3IHvAKm2fz+sTRARTcrg ($25.15 in chips) 
Seat 7: 3PmVnC/15cl4oyI1TKIt4g ($5 in chips) 
Seat 8: qBdqLaJhO+1itcMk70bsfA ($8.35 in chips) 
Seat 9: X78b5v/uhqeXXoAijbw/yg ($25 in chips) 
pN3IHvAKm2fz+sTRARTcrg: posts small blind $0.10
3PmVnC/15cl4oyI1TKIt4g: posts big blind $0.25
zDrucyjVn5aeekNEc3cJrA: posts small & big blinds $0.35
*** HOLE CARDS ***
qBdqLaJhO+1itcMk70bsfA: folds 
X78b5v/uhqeXXoAijbw/yg: folds 
x+W5+3qsdY4Iszf0hoH+Aw: calls $0.25
zDrucyjVn5aeekNEc3cJrA: raises $0.75 to $1
CT7Xj/V/O5rBlhtt+RZeFQ: folds 
puj3K/wrNjEj86ZL/MyfLA: folds 
pN3IHvAKm2fz+sTRARTcrg: folds 
3PmVnC/15cl4oyI1TKIt4g: folds 
x+W5+3qsdY4Iszf0hoH+Aw: folds 
Uncalled bet ($0.75) returned to zDrucyjVn5aeekNEc3cJrA
zDrucyjVn5aeekNEc3cJrA collected $0.95 from pot
*** SUMMARY ***
Total pot $0.95 | Rake $0 
Seat 1: x+W5+3qsdY4Iszf0hoH+Aw folded before Flop
Seat 2: zDrucyjVn5aeekNEc3cJrA collected ($0.95)
Seat 3: CT7Xj/V/O5rBlhtt+RZeFQ folded before Flop (didn't bet)
Seat 4: puj3K/wrNjEj86ZL/MyfLA (button) folded before Flop (didn't bet)
Seat 6: pN3IHvAKm2fz+sTRARTcrg (small blind) folded before Flop
Seat 7: 3PmVnC/15cl4oyI1TKIt4g (big blind) folded before Flop
Seat 8: qBdqLaJhO+1itcMk70bsfA folded before Flop (didn't bet)
Seat 9: X78b5v/uhqeXXoAijbw/yg folded before Flop (didn't bet)




PokerStars Game #59941902120:  Hold'em No Limit ($0.10/$0.25) - 2009/07/01 1:49:48 ET
Table 'pyZQRcpxhWj2y2cT/ydvww52Meibn9NOL4XtVi1p2Upwx Seat #6 is the button
Seat 1: egvg3mTBBVzMHnJPIQiKcA ($16.30 in chips) 
Seat 2: Th3FldXKQW6hWVVPahaoOQ ($101.80 in chips) 
Seat 3: zgi+EUykT/pZQpoUG6+oEg ($4.30 in chips) 
Seat 4: NjesyqE7PJi4nEOa0oOq9w ($15.65 in chips) 
Seat 5: 5n7e7I+px7c6CQmLpPbtsg ($4.35 in chips) 
Seat 6: uvfXVx90QtCYG4geTioN+A ($23.50 in chips) 
Seat 8: ipgcO7Pa6LC8XWpVttZfnA ($4.75 in chips) 
Seat 9: bC+Wg1ntzw3N48OwuR1eag ($6.55 in chips) 
mMd8CDS/but3UC+Zp7Up2w will be allowed to play after the button
ipgcO7Pa6LC8XWpVttZfnA: posts small blind $0.10
bC+Wg1ntzw3N48OwuR1eag: posts big blind $0.25
*** HOLE CARDS ***
egvg3mTBBVzMHnJPIQiKcA: calls $0.25
Th3FldXKQW6hWVVPahaoOQ: folds 
zgi+EUykT/pZQpoUG6+oEg: folds 
NjesyqE7PJi4nEOa0oOq9w: raises $0.75 to $1
5n7e7I+px7c6CQmLpPbtsg: folds 
uvfXVx90QtCYG4geTioN+A: folds 
ipgcO7Pa6LC8XWpVttZfnA: folds 
bC+Wg1ntzw3N48OwuR1eag: calls $0.75
egvg3mTBBVzMHnJPIQiKcA: calls $0.75
*** FLOP *** [8d Qs Jc]
bC+Wg1ntzw3N48OwuR1eag: checks 
egvg3mTBBVzMHnJPIQiKcA: bets $0.50
NjesyqE7PJi4nEOa0oOq9w: calls $0.50
bC+Wg1ntzw3N48OwuR1eag: calls $0.50
*** TURN *** [8d Qs Jc] [5c]
bC+Wg1ntzw3N48OwuR1eag: checks 
egvg3mTBBVzMHnJPIQiKcA: bets $0.75
NjesyqE7PJi4nEOa0oOq9w: calls $0.75
bC+Wg1ntzw3N48OwuR1eag: calls $0.75
*** RIVER *** [8d Qs Jc 5c] [6d]
bC+Wg1ntzw3N48OwuR1eag: checks 
egvg3mTBBVzMHnJPIQiKcA: bets $0.75
NjesyqE7PJi4nEOa0oOq9w: calls $0.75
bC+Wg1ntzw3N48OwuR1eag: folds 
*** SHOW DOWN ***
egvg3mTBBVzMHnJPIQiKcA: shows [Qd 7d] (a pair of Queens)
NjesyqE7PJi4nEOa0oOq9w: mucks hand 
egvg3mTBBVzMHnJPIQiKcA collected $7.95 from pot
*** SUMMARY ***
Total pot $8.35 | Rake $0.40 
Board [8d Qs Jc 5c 6d]
Seat 1: egvg3mTBBVzMHnJPIQiKcA showed [Qd 7d] and won ($7.95) with a pair of Queens
Seat 2: Th3FldXKQW6hWVVPahaoOQ folded before Flop (didn't bet)
Seat 3: zgi+EUykT/pZQpoUG6+oEg folded before Flop (didn't bet)
Seat 4: NjesyqE7PJi4nEOa0oOq9w mucked
Seat 5: 5n7e7I+px7c6CQmLpPbtsg folded before Flop (didn't bet)
Seat 6: uvfXVx90QtCYG4geTioN+A (button) folded before Flop (didn't bet)
Seat 8: ipgcO7Pa6LC8XWpVttZfnA (small blind) folded before Flop
Seat 9: bC+Wg1ntzw3N48OwuR1eag (big blind) folded on the River




PokerStars Game #59941902274:  Hold'em No Limit ($0.10/$0.25) - 2009/07/01 1:49:48 ET
Table '2AUmC2Rslg+QUbLfdgNdfg' 6-max Seat #4 is the button
Seat 1: YDXAegrCnzc0l6TSDNboXQ ($23.25 in chips) 
Seat 2: PLksyNlTVRVZwxJVC2/1eA ($25 in chips) 
Seat 3: JFIAqU8lCZ0vWwEl4bdGsg ($31.20 in chips) 
Seat 4: lquriepNQBhDV5P1SWHhnA ($25.90 in chips) 
Seat 5: AMc4cCwUJhokdGRYIaVPhQ ($31.20 in chips) 
Seat 6: xBWc54v+UTSJOiKpbAbJWg ($10.80 in chips) 
AMc4cCwUJhokdGRYIaVPhQ: posts small blind $0.10
xBWc54v+UTSJOiKpbAbJWg: posts big blind $0.25
*** HOLE CARDS ***
YDXAegrCnzc0l6TSDNboXQ: raises $0.75 to $1
PLksyNlTVRVZwxJVC2/1eA: folds 
JFIAqU8lCZ0vWwEl4bdGsg: folds 
lquriepNQBhDV5P1SWHhnA: folds 
AMc4cCwUJhokdGRYIaVPhQ: folds 
xBWc54v+UTSJOiKpbAbJWg: folds 
Uncalled bet ($0.75) returned to YDXAegrCnzc0l6TSDNboXQ
YDXAegrCnzc0l6TSDNboXQ collected $0.60 from pot
*** SUMMARY ***
Total pot $0.60 | Rake $0 
Seat 1: YDXAegrCnzc0l6TSDNboXQ collected ($0.60)
Seat 2: PLksyNlTVRVZwxJVC2/1eA folded before Flop (didn't bet)
Seat 3: JFIAqU8lCZ0vWwEl4bdGsg folded before Flop (didn't bet)
Seat 4: lquriepNQBhDV5P1SWHhnA (button) folded before Flop (didn't bet)
Seat 5: AMc4cCwUJhokdGRYIaVPhQ (small blind) folded before Flop
Seat 6: xBWc54v+UTSJOiKpbAbJWg (big blind) folded before Flop




PokerStars Game #59941902010:  Hold'em No Limit ($0.10/$0.25) - 2009/07/01 1:49:48 ET
Table 'fHv1Mk7ZbLjprZTGWKPiEQ' 6-max Seat #4 is the button
Seat 1: OIjOiBfQstWrK/RuXx7zcw ($3.70 in chips) 
Seat 2: 9U3ZKjCsarN0DjR6mSE8Ug ($14.05 in chips) 
Seat 3: /gJNBeCkWL4o85/jvlZ4BA ($25 in chips) 
Seat 4: TSmua8tGK3sTbwi0ynrW9Q ($60 in chips) 
Seat 5: LJI7A1YgDM7hgh7o56+ReQ ($26.05 in chips) 
Seat 6: AjG0X+rNtc2W08eph8oqpw ($52.40 in chips) 
LJI7A1YgDM7hgh7o56+ReQ: posts small blind $0.10
AjG0X+rNtc2W08eph8oqpw: posts big blind $0.25
*** HOLE CARDS ***
OIjOiBfQstWrK/RuXx7zcw: folds 
9U3ZKjCsarN0DjR6mSE8Ug: folds 
/gJNBeCkWL4o85/jvlZ4BA: folds 
TSmua8tGK3sTbwi0ynrW9Q: folds 
LJI7A1YgDM7hgh7o56+ReQ: folds 
Uncalled bet ($0.15) returned to AjG0X+rNtc2W08eph8oqpw
AjG0X+rNtc2W08eph8oqpw collected $0.20 from pot
AjG0X+rNtc2W08eph8oqpw: doesn't show hand 
*** SUMMARY ***
Total pot $0.20 | Rake $0 
Seat 1: OIjOiBfQstWrK/RuXx7zcw folded before Flop (didn't bet)
Seat 2: 9U3ZKjCsarN0DjR6mSE8Ug folded before Flop (didn't bet)
Seat 3: /gJNBeCkWL4o85/jvlZ4BA folded before Flop (didn't bet)
Seat 4: TSmua8tGK3sTbwi0ynrW9Q (button) folded before Flop (didn't bet)
Seat 5: LJI7A1YgDM7hgh7o56+ReQ (small blind) folded before Flop
Seat 6: AjG0X+rNtc2W08eph8oqpw (big blind) collected ($0.20)




PokerStars Game #59941902214:  Hold'em No Limit ($0.10/$0.25) - 2009/07/01 1:49:48 ET
Table 'QegsWX65l3n/K0A8XB78yg' 6-max Seat #6 is the button
Seat 1: p6adJRMXMBLr+xtQzqazIQ ($12.10 in chips) 
Seat 2: GC/9yVD59DUCX7hUI7gcLw ($58.60 in chips) 
Seat 3: iIgNoBh+3/Ix1/fLsg+HuA ($6 in chips) 
Seat 4: epAUIB7h2FJXzUPRIvSkRA ($25 in chips) 
Seat 5: QqiZLFrN8iOUT/GHw7ztOA ($28.95 in chips) 
Seat 6: 5PWs02z65jSO5pr/M6wx/w ($6.10 in chips) 
p6adJRMXMBLr+xtQzqazIQ: posts small blind $0.10
GC/9yVD59DUCX7hUI7gcLw: posts big blind $0.25
*** HOLE CARDS ***
iIgNoBh+3/Ix1/fLsg+HuA: folds 
epAUIB7h2FJXzUPRIvSkRA: folds 
QqiZLFrN8iOUT/GHw7ztOA: folds 
5PWs02z65jSO5pr/M6wx/w: raises $0.25 to $0.50
p6adJRMXMBLr+xtQzqazIQ: calls $0.40
GC/9yVD59DUCX7hUI7gcLw: calls $0.25
*** FLOP *** [Qc Ts 5c]
p6adJRMXMBLr+xtQzqazIQ: checks 
GC/9yVD59DUCX7hUI7gcLw: checks 
5PWs02z65jSO5pr/M6wx/w: checks 
*** TURN *** [Qc Ts 5c] [4s]
p6adJRMXMBLr+xtQzqazIQ: bets $0.75
GC/9yVD59DUCX7hUI7gcLw: calls $0.75
5PWs02z65jSO5pr/M6wx/w: calls $0.75
*** RIVER *** [Qc Ts 5c 4s] [Kc]
p6adJRMXMBLr+xtQzqazIQ: bets $1.75
GC/9yVD59DUCX7hUI7gcLw: calls $1.75
5PWs02z65jSO5pr/M6wx/w: calls $1.75
*** SHOW DOWN ***
p6adJRMXMBLr+xtQzqazIQ: shows [9h Kd] (a pair of Kings)
GC/9yVD59DUCX7hUI7gcLw: shows [Ks Tc] (two pair, Kings and Tens)
5PWs02z65jSO5pr/M6wx/w: shows [Js Ad] (a straight, Ten to Ace)
5PWs02z65jSO5pr/M6wx/w collected $8.60 from pot
*** SUMMARY ***
Total pot $9 | Rake $0.40 
Board [Qc Ts 5c 4s Kc]
Seat 1: p6adJRMXMBLr+xtQzqazIQ (small blind) showed [9h Kd] and lost with a pair of Kings
Seat 2: GC/9yVD59DUCX7hUI7gcLw (big blind) showed [Ks Tc] and lost with two pair, Kings and Tens
Seat 3: iIgNoBh+3/Ix1/fLsg+HuA folded before Flop (didn't bet)
Seat 4: epAUIB7h2FJXzUPRIvSkRA folded before Flop (didn't bet)
Seat 5: QqiZLFrN8iOUT/GHw7ztOA folded before Flop (didn't bet)
Seat 6: 5PWs02z65jSO5pr/M6wx/w (button) showed [Js Ad] and won ($8.60) with a straight, Ten to Ace




PokerStars Game #59941902114:  Hold'em No Limit ($0.10/$0.25) - 2009/07/01 1:49:48 ET
Table 'NtEQAxCeIK2io1CGtW658g' 6-max Seat #3 is the button
Seat 1: X437kMQ7AujoaDgjguhU9w ($11.55 in chips) 
Seat 2: DgyznDqq/mLiCqQGMzc+Aw ($9.15 in chips) 
Seat 3: 5nwDw10uIM0XEyLhla0oGA ($16.45 in chips) 
Seat 4: 8296 ($16.70 in chips) 
Seat 5: Hsvkc0/G2VV78oVmWYXecw ($6.85 in chips) 
Seat 6: /gJNBeCkWL4o85/jvlZ4BA ($64.35 in chips) 
8296: posts small blind $0.10
Hsvkc0/G2VV78oVmWYXecw: posts big blind $0.25
*** HOLE CARDS ***
/gJNBeCkWL4o85/jvlZ4BA: folds 
X437kMQ7AujoaDgjguhU9w: folds 
DgyznDqq/mLiCqQGMzc+Aw: folds 
5nwDw10uIM0XEyLhla0oGA: folds 
8296: folds 
Uncalled bet ($0.15) returned to Hsvkc0/G2VV78oVmWYXecw
Hsvkc0/G2VV78oVmWYXecw collected $0.20 from pot
Hsvkc0/G2VV78oVmWYXecw: doesn't show hand 
*** SUMMARY ***
Total pot $0.20 | Rake $0 
Seat 1: X437kMQ7AujoaDgjguhU9w folded before Flop (didn't bet)
Seat 2: DgyznDqq/mLiCqQGMzc+Aw folded before Flop (didn't bet)
Seat 3: 5nwDw10uIM0XEyLhla0oGA (button) folded before Flop (didn't bet)
Seat 4: 8296 (small blind) folded before Flop
Seat 5: Hsvkc0/G2VV78oVmWYXecw (big blind) collected ($0.20)
Seat 6: /gJNBeCkWL4o85/jvlZ4BA folded before Flop (didn't bet)




PokerStars Game #59941902338:  Hold'em No Limit ($0.10/$0.25) - 2009/07/01 1:49:48 ET
Table 'IIO2q2znuuAXmiZ2qFTcmg' 6-max Seat #2 is the button
Seat 2: i9LqF5rD3bvtbEE7HWgr3Q ($25 in chips) 
Seat 3: j0aDOn9Nft1HLTQvGu1UwA ($13.95 in chips) 
Seat 5: iHZrkhpIO/3+tKuAoPx8HQ ($14.75 in chips) 
j0aDOn9Nft1HLTQvGu1UwA: posts small blind $0.10
iHZrkhpIO/3+tKuAoPx8HQ: posts big blind $0.25
*** HOLE CARDS ***
i9LqF5rD3bvtbEE7HWgr3Q: raises $0.50 to $0.75
j0aDOn9Nft1HLTQvGu1UwA: calls $0.65
iHZrkhpIO/3+tKuAoPx8HQ: folds 
*** FLOP *** [7c Ad 8h]
eccZOodwLtdyXmuZVw+l1w leaves the table
j0aDOn9Nft1HLTQvGu1UwA: bets $0.50
i9LqF5rD3bvtbEE7HWgr3Q: calls $0.50
*** TURN *** [7c Ad 8h] [Th]
madmiko joins the table at seat #6 
j0aDOn9Nft1HLTQvGu1UwA: bets $0.25
i9LqF5rD3bvtbEE7HWgr3Q: calls $0.25
*** RIVER *** [7c Ad 8h Th] [Qh]
j0aDOn9Nft1HLTQvGu1UwA: bets $0.25
i9LqF5rD3bvtbEE7HWgr3Q: calls $0.25
*** SHOW DOWN ***
j0aDOn9Nft1HLTQvGu1UwA: shows [Js 8c] (a pair of Eights)
i9LqF5rD3bvtbEE7HWgr3Q: shows [Ac 4d] (a pair of Aces)
i9LqF5rD3bvtbEE7HWgr3Q collected $3.60 from pot
*** SUMMARY ***
Total pot $3.75 | Rake $0.15 
Board [7c Ad 8h Th Qh]
Seat 2: i9LqF5rD3bvtbEE7HWgr3Q (button) showed [Ac 4d] and won ($3.60) with a pair of Aces
Seat 3: j0aDOn9Nft1HLTQvGu1UwA (small blind) showed [Js 8c] and lost with a pair of Eights
Seat 5: iHZrkhpIO/3+tKuAoPx8HQ (big blind) folded before Flop




PokerStars Game #59941902606:  Hold'em No Limit ($0.10/$0.25) - 2009/07/01 1:49:49 ET
Table 'IdXp6nyeW4FYaEK4qKCnwQ' 9-max Seat #1 is the button
Seat 1: tLcDklc2rBORNfixyRfVfw ($25 in chips) 
Seat 2: HPEB+AtKw1+C/cxU0o1ciw ($30.60 in chips) 
Seat 4: j4q3p0lesp63b1gZDwLBZw ($5.35 in chips) 
Seat 6: arxNSjreDRGFg13EAM2F1w ($30.50 in chips) 
Seat 7: w1ukf8uPa4+WH561TtVRxA ($37.25 in chips) 
Seat 8: dtZ84flFEi4Q+SGrHMJRDQ ($29.75 in chips) 
Seat 9: s2xLPOl/vhl/26apJ3vsOQ ($29.25 in chips) 
HPEB+AtKw1+C/cxU0o1ciw: posts small blind $0.10
j4q3p0lesp63b1gZDwLBZw: posts big blind $0.25
*** HOLE CARDS ***
arxNSjreDRGFg13EAM2F1w: folds 
w1ukf8uPa4+WH561TtVRxA: folds 
dtZ84flFEi4Q+SGrHMJRDQ: folds 
s2xLPOl/vhl/26apJ3vsOQ: raises $0.75 to $1
tLcDklc2rBORNfixyRfVfw: folds 
aintblinkin joins the table at seat #3 
HPEB+AtKw1+C/cxU0o1ciw: folds 
j4q3p0lesp63b1gZDwLBZw: folds 
Uncalled bet ($0.75) returned to s2xLPOl/vhl/26apJ3vsOQ
s2xLPOl/vhl/26apJ3vsOQ collected $0.60 from pot
*** SUMMARY ***
Total pot $0.60 | Rake $0 
Seat 1: tLcDklc2rBORNfixyRfVfw (button) folded before Flop (didn't bet)
Seat 2: HPEB+AtKw1+C/cxU0o1ciw (small blind) folded before Flop
Seat 4: j4q3p0lesp63b1gZDwLBZw (big blind) folded before Flop
Seat 6: arxNSjreDRGFg13EAM2F1w folded before Flop (didn't bet)
Seat 7: w1ukf8uPa4+WH561TtVRxA folded before Flop (didn't bet)
Seat 8: dtZ84flFEi4Q+SGrHMJRDQ folded before Flop (didn't bet)
Seat 9: s2xLPOl/vhl/26apJ3vsOQ collected ($0.60)




PokerStars Game #59941902716:  Hold'em No Limit ($0.10/$0.25) - 2009/07/01 1:49:49 ET
Table 'v+LTGPWbrLum+Ggd4ef6lg' 9-max Seat #5 is the button
Seat 1: zUXhymECc2C9W9ZNw6qppA ($9.30 in chips) 
Seat 2: clJsV3v77RS07bDKY+705w ($5 in chips) 
Seat 3: 7ovWM9c1nQLTFritEGRG/A ($3.10 in chips) 
Seat 5: +8OkYWUhGfkDbAtQl/ovYQ ($23.15 in chips) 
Seat 7: kUxTO3D2eQcx4oJIpJAK4Q ($7.10 in chips) 
Seat 8: +sbyWwIcFp9kP0bDtMegfQ ($41.20 in chips) 
Seat 9: cZ99hugmLBj9KhTlc8nCSw ($25 in chips) 
kUxTO3D2eQcx4oJIpJAK4Q: posts small blind $0.10
+sbyWwIcFp9kP0bDtMegfQ: posts big blind $0.25
clJsV3v77RS07bDKY+705w: posts big blind $0.25
yqkowiRWZ6NvRN9UUkYIlA: sits out 
*** HOLE CARDS ***
cZ99hugmLBj9KhTlc8nCSw: folds 
zUXhymECc2C9W9ZNw6qppA is disconnected 
zUXhymECc2C9W9ZNw6qppA has timed out while disconnected
zUXhymECc2C9W9ZNw6qppA: folds 
zUXhymECc2C9W9ZNw6qppA is sitting out
clJsV3v77RS07bDKY+705w: checks 
7ovWM9c1nQLTFritEGRG/A: folds 
+8OkYWUhGfkDbAtQl/ovYQ: folds 
kUxTO3D2eQcx4oJIpJAK4Q: raises $0.75 to $1
+sbyWwIcFp9kP0bDtMegfQ: calls $0.75
clJsV3v77RS07bDKY+705w: folds 
*** FLOP *** [2d Jh 9d]
kUxTO3D2eQcx4oJIpJAK4Q: bets $1.25
+sbyWwIcFp9kP0bDtMegfQ: folds 
Uncalled bet ($1.25) returned to kUxTO3D2eQcx4oJIpJAK4Q
kUxTO3D2eQcx4oJIpJAK4Q collected $2.15 from pot
*** SUMMARY ***
Total pot $2.25 | Rake $0.10 
Board [2d Jh 9d]
Seat 1: zUXhymECc2C9W9ZNw6qppA folded before Flop (didn't bet)
Seat 2: clJsV3v77RS07bDKY+705w folded before Flop
Seat 3: 7ovWM9c1nQLTFritEGRG/A folded before Flop (didn't bet)
Seat 5: +8OkYWUhGfkDbAtQl/ovYQ (button) folded before Flop (didn't bet)
Seat 7: kUxTO3D2eQcx4oJIpJAK4Q (small blind) collected ($2.15)
Seat 8: +sbyWwIcFp9kP0bDtMegfQ (big blind) folded on the Flop
Seat 9: cZ99hugmLBj9KhTlc8nCSw folded before Flop (didn't bet)




PokerStars Game #59941902616:  Hold'em No Limit ($0.10/$0.25) - 2009/07/01 1:49:49 ET
Table 'NtCSSONEf1zaJo3042tQug' 6-max Seat #6 is the button
Seat 1: KXtdqb+rIMkjc0RvHDksGQ ($34.65 in chips) 
Seat 2: vqWjZmdQu/Hxw96/IJTWdQ ($25 in chips) 
Seat 3: 9kUKGKkblnIx3m8rlVol6Q ($14.65 in chips) 
Seat 4: HxD1kB8zCmalQSdWAkKmlg ($27.50 in chips) 
Seat 5: tOAk1Og4mVObMBOfvdDYOw ($30.65 in chips) 
Seat 6: LxehwDpTQ19ph4Qmc78+Pw ($35.35 in chips) 
KXtdqb+rIMkjc0RvHDksGQ: posts small blind $0.10
vqWjZmdQu/Hxw96/IJTWdQ: posts big blind $0.25
*** HOLE CARDS ***
9kUKGKkblnIx3m8rlVol6Q: folds 
HxD1kB8zCmalQSdWAkKmlg: folds 
tOAk1Og4mVObMBOfvdDYOw: raises $0.75 to $1
LxehwDpTQ19ph4Qmc78+Pw: folds 
KXtdqb+rIMkjc0RvHDksGQ: raises $2.50 to $3.50
vqWjZmdQu/Hxw96/IJTWdQ: folds 
tOAk1Og4mVObMBOfvdDYOw: raises $10.45 to $13.95
KXtdqb+rIMkjc0RvHDksGQ: folds 
Uncalled bet ($10.45) returned to tOAk1Og4mVObMBOfvdDYOw
tOAk1Og4mVObMBOfvdDYOw collected $7.25 from pot
tOAk1Og4mVObMBOfvdDYOw: doesn't show hand 
*** SUMMARY ***
Total pot $7.25 | Rake $0 
Seat 1: KXtdqb+rIMkjc0RvHDksGQ (small blind) folded before Flop
Seat 2: vqWjZmdQu/Hxw96/IJTWdQ (big blind) folded before Flop
Seat 3: 9kUKGKkblnIx3m8rlVol6Q folded before Flop (didn't bet)
Seat 4: HxD1kB8zCmalQSdWAkKmlg folded before Flop (didn't bet)
Seat 5: tOAk1Og4mVObMBOfvdDYOw collected ($7.25)
Seat 6: LxehwDpTQ19ph4Qmc78+Pw (button) folded before Flop (didn't bet)




PokerStars Game #59941902556:  Hold'em No Limit ($0.10/$0.25) - 2009/07/01 1:49:49 ET
Table 'xmJKTGBeWCwutccj3YfupQ' 6-max Seat #3 is the button
Seat 1: sVbkVl4OznxBCfi66UB9vw ($41.60 in chips) 
Seat 2: QqiZLFrN8iOUT/GHw7ztOA ($24.65 in chips) 
Seat 3: T5wrp/d5jarm+SxNy8OQAg ($25.40 in chips) 
Seat 4: uWjhTVMpuIroxXcmD3Okug ($16.50 in chips) 
Seat 5: DE9hRlt14g+JdsRQ4wT7hg ($29.60 in chips) 
Seat 6: 9bpVv1/Qh9IYtXuCtl5VtQ ($25 in chips) 
uWjhTVMpuIroxXcmD3Okug: posts small blind $0.10
DE9hRlt14g+JdsRQ4wT7hg: posts big blind $0.25
*** HOLE CARDS ***
9bpVv1/Qh9IYtXuCtl5VtQ: folds 
sVbkVl4OznxBCfi66UB9vw: raises $0.45 to $0.70
QqiZLFrN8iOUT/GHw7ztOA: calls $0.70
T5wrp/d5jarm+SxNy8OQAg: calls $0.70
uWjhTVMpuIroxXcmD3Okug: calls $0.60
DE9hRlt14g+JdsRQ4wT7hg: calls $0.45
*** FLOP *** [5d 2s Ts]
uWjhTVMpuIroxXcmD3Okug: checks 
DE9hRlt14g+JdsRQ4wT7hg: bets $2.25
sVbkVl4OznxBCfi66UB9vw: folds 
QqiZLFrN8iOUT/GHw7ztOA: folds 
T5wrp/d5jarm+SxNy8OQAg: calls $2.25
uWjhTVMpuIroxXcmD3Okug: folds 
*** TURN *** [5d 2s Ts] [Jh]
DE9hRlt14g+JdsRQ4wT7hg: bets $5
T5wrp/d5jarm+SxNy8OQAg: calls $5
*** RIVER *** [5d 2s Ts Jh] [8d]
DE9hRlt14g+JdsRQ4wT7hg: checks 
T5wrp/d5jarm+SxNy8OQAg: checks 
*** SHOW DOWN ***
DE9hRlt14g+JdsRQ4wT7hg: shows [Tc Kc] (a pair of Tens)
T5wrp/d5jarm+SxNy8OQAg: mucks hand 
DE9hRlt14g+JdsRQ4wT7hg collected $17.15 from pot
*** SUMMARY ***
Total pot $18 | Rake $0.85 
Board [5d 2s Ts Jh 8d]
Seat 1: sVbkVl4OznxBCfi66UB9vw folded on the Flop
Seat 2: QqiZLFrN8iOUT/GHw7ztOA folded on the Flop
Seat 3: T5wrp/d5jarm+SxNy8OQAg (button) mucked
Seat 4: uWjhTVMpuIroxXcmD3Okug (small blind) folded on the Flop
Seat 5: DE9hRlt14g+JdsRQ4wT7hg (big blind) showed [Tc Kc] and won ($17.15) with a pair of Tens
Seat 6: 9bpVv1/Qh9IYtXuCtl5VtQ folded before Flop (didn't bet)




PokerStars Game #59941902900:  Hold'em No Limit ($0.10/$0.25) - 2009/07/01 1:49:49 ET
Table 'jz4TpuH+ag+0iNe2ZcxckQ' 9-max Seat #3 is the button
Seat 2: clJsV3v77RS07bDKY+705w ($6.10 in chips) 
Seat 3: egvg3mTBBVzMHnJPIQiKcA ($18.50 in chips) 
Seat 4: k+2r6di6GXjNpAdrRkW9bA ($57.90 in chips) 
Seat 5: v1BVHNGLbP/nx7QO6K7+Jw ($37.50 in chips) 
Seat 6: gO1uiTGTzn5Cd3PECuws1g ($10.40 in chips) 
Seat 7: tLcDklc2rBORNfixyRfVfw ($43.05 in chips) 
Seat 8: uhrboV251dcgYniYTdFIcA ($25.35 in chips) 
Seat 9: W2YYHvqjaEpRrO7stZkClQ ($5.30 in chips) 
k+2r6di6GXjNpAdrRkW9bA: posts small blind $0.10
v1BVHNGLbP/nx7QO6K7+Jw: posts big blind $0.25
4awUyiDYTgylQKXZ9faBVA: sits out 
*** HOLE CARDS ***
gO1uiTGTzn5Cd3PECuws1g: calls $0.25
tLcDklc2rBORNfixyRfVfw: raises $1 to $1.25
uhrboV251dcgYniYTdFIcA: folds 
W2YYHvqjaEpRrO7stZkClQ: folds 
clJsV3v77RS07bDKY+705w: folds 
egvg3mTBBVzMHnJPIQiKcA: folds 
k+2r6di6GXjNpAdrRkW9bA: folds 
v1BVHNGLbP/nx7QO6K7+Jw: calls $1
gO1uiTGTzn5Cd3PECuws1g: calls $1
*** FLOP *** [8d Qh As]
v1BVHNGLbP/nx7QO6K7+Jw: bets $0.25
gO1uiTGTzn5Cd3PECuws1g: raises $0.25 to $0.50
tLcDklc2rBORNfixyRfVfw: raises $3 to $3.50
v1BVHNGLbP/nx7QO6K7+Jw: calls $3.25
gO1uiTGTzn5Cd3PECuws1g: folds 
*** TURN *** [8d Qh As] [2d]
v1BVHNGLbP/nx7QO6K7+Jw: checks 
tLcDklc2rBORNfixyRfVfw: bets $5
v1BVHNGLbP/nx7QO6K7+Jw: calls $5
*** RIVER *** [8d Qh As 2d] [2h]
v1BVHNGLbP/nx7QO6K7+Jw: checks 
tLcDklc2rBORNfixyRfVfw: bets $5
v1BVHNGLbP/nx7QO6K7+Jw: folds 
Uncalled bet ($5) returned to tLcDklc2rBORNfixyRfVfw
tLcDklc2rBORNfixyRfVfw collected $20.35 from pot
tLcDklc2rBORNfixyRfVfw: doesn't show hand 
*** SUMMARY ***
Total pot $21.35 | Rake $1 
Board [8d Qh As 2d 2h]
Seat 2: clJsV3v77RS07bDKY+705w folded before Flop (didn't bet)
Seat 3: egvg3mTBBVzMHnJPIQiKcA (button) folded before Flop (didn't bet)
Seat 4: k+2r6di6GXjNpAdrRkW9bA (small blind) folded before Flop
Seat 5: v1BVHNGLbP/nx7QO6K7+Jw (big blind) folded on the River
Seat 6: gO1uiTGTzn5Cd3PECuws1g folded on the Flop
Seat 7: tLcDklc2rBORNfixyRfVfw collected ($20.35)
Seat 8: uhrboV251dcgYniYTdFIcA folded before Flop (didn't bet)
Seat 9: W2YYHvqjaEpRrO7stZkClQ folded before Flop (didn't bet)




PokerStars Game #59941903242:  Hold'em No Limit ($0.10/$0.25) - 2009/07/01 1:49:50 ET
Table 'HIOfhT0zga/KonFhIl6O3w' 9-max Seat #5 is the button
Seat 1: oLa/tXLfSLLB28mcLGrxcg ($27.15 in chips) 
Seat 2: er86weqXTpTB6/w2dKlYgA ($16.50 in chips) 
Seat 3: X6+pSIPfovPcE87t+LmUKQ ($4.50 in chips) 
Seat 4: qwr38jl5txoR36M7G5qi4A ($8.15 in chips) 
Seat 5: K1MDeapSEyKyGPNZGOKfEg ($36.80 in chips) 
Seat 6: MThMMgdB293VOucmN9sliQ ($25.20 in chips) 
Seat 7: wvlPJBB0PtYkfeeSRDaIvQ ($13.45 in chips) 
Seat 9: dfNim92Z6XK1/h5SFW5vDg ($28.70 in chips) 
MThMMgdB293VOucmN9sliQ: posts small blind $0.10
wvlPJBB0PtYkfeeSRDaIvQ: posts big blind $0.25
SpiiQQAzy4MUgV3I5W8giw: sits out 
*** HOLE CARDS ***
dfNim92Z6XK1/h5SFW5vDg: folds 
oLa/tXLfSLLB28mcLGrxcg: folds 
er86weqXTpTB6/w2dKlYgA: calls $0.25
X6+pSIPfovPcE87t+LmUKQ: folds 
qwr38jl5txoR36M7G5qi4A: raises $1 to $1.25
K1MDeapSEyKyGPNZGOKfEg: folds 
MThMMgdB293VOucmN9sliQ: folds 
wvlPJBB0PtYkfeeSRDaIvQ: folds 
er86weqXTpTB6/w2dKlYgA: calls $1
*** FLOP *** [5s 8c 2c]
er86weqXTpTB6/w2dKlYgA: bets $0.50
qwr38jl5txoR36M7G5qi4A: raises $2 to $2.50
er86weqXTpTB6/w2dKlYgA: calls $2
*** TURN *** [5s 8c 2c] [Jd]
er86weqXTpTB6/w2dKlYgA: bets $0.75
qwr38jl5txoR36M7G5qi4A: raises $3.65 to $4.40 and is all-in
er86weqXTpTB6/w2dKlYgA: calls $3.65
*** RIVER *** [5s 8c 2c Jd] [Qd]
*** SHOW DOWN ***
er86weqXTpTB6/w2dKlYgA: shows [Ac Kc] (high card Ace)
qwr38jl5txoR36M7G5qi4A: shows [Ts Tc] (a pair of Tens)
qwr38jl5txoR36M7G5qi4A collected $15.85 from pot
*** SUMMARY ***
Total pot $16.65 | Rake $0.80 
Board [5s 8c 2c Jd Qd]
Seat 1: oLa/tXLfSLLB28mcLGrxcg folded before Flop (didn't bet)
Seat 2: er86weqXTpTB6/w2dKlYgA showed [Ac Kc] and lost with high card Ace
Seat 3: X6+pSIPfovPcE87t+LmUKQ folded before Flop (didn't bet)
Seat 4: qwr38jl5txoR36M7G5qi4A showed [Ts Tc] and won ($15.85) with a pair of Tens
Seat 5: K1MDeapSEyKyGPNZGOKfEg (button) folded before Flop (didn't bet)
Seat 6: MThMMgdB293VOucmN9sliQ (small blind) folded before Flop
Seat 7: wvlPJBB0PtYkfeeSRDaIvQ (big blind) folded before Flop
Seat 9: dfNim92Z6XK1/h5SFW5vDg folded before Flop (didn't bet)




PokerStars Game #59941903198:  Hold'em No Limit ($0.10/$0.25) - 2009/07/01 1:49:50 ET
Table '2VkNDXXsBj4bSZw/uK5atw' 6-max Seat #5 is the button
Seat 1: xrf8tAXKQHG99HixCot1Iw ($25.25 in chips) 
Seat 3: P+6Z5+8H5/Wyt/jHMovNvQ ($24.40 in chips) 
Seat 4: 4kIRqWKE/N0yUAcWVhLSoQ ($13.65 in chips) 
Seat 5: 7f0OkhFEOf3T+rVOFHRLnw ($21.25 in chips) 
Seat 6: n6UPMnVR4v8LFP0rWP73Fg ($12.20 in chips) 
n6UPMnVR4v8LFP0rWP73Fg: posts small blind $0.10
xrf8tAXKQHG99HixCot1Iw: posts big blind $0.25
GbCVUNssQ7mqsPWr7J4d3w: sits out 
*** HOLE CARDS ***
P+6Z5+8H5/Wyt/jHMovNvQ: calls $0.25
4kIRqWKE/N0yUAcWVhLSoQ: folds 
7f0OkhFEOf3T+rVOFHRLnw: folds 
n6UPMnVR4v8LFP0rWP73Fg: folds 
xrf8tAXKQHG99HixCot1Iw: checks 
*** FLOP *** [7c 6s As]
xrf8tAXKQHG99HixCot1Iw: checks 
P+6Z5+8H5/Wyt/jHMovNvQ: bets $0.50
xrf8tAXKQHG99HixCot1Iw: folds 
Uncalled bet ($0.50) returned to P+6Z5+8H5/Wyt/jHMovNvQ
P+6Z5+8H5/Wyt/jHMovNvQ collected $0.60 from pot
P+6Z5+8H5/Wyt/jHMovNvQ: doesn't show hand 
*** SUMMARY ***
Total pot $0.60 | Rake $0 
Board [7c 6s As]
Seat 1: xrf8tAXKQHG99HixCot1Iw (big blind) folded on the Flop
Seat 3: P+6Z5+8H5/Wyt/jHMovNvQ collected ($0.60)
Seat 4: 4kIRqWKE/N0yUAcWVhLSoQ folded before Flop (didn't bet)
Seat 5: 7f0OkhFEOf3T+rVOFHRLnw (button) folded before Flop (didn't bet)
Seat 6: n6UPMnVR4v8LFP0rWP73Fg (small blind) folded before Flop




PokerStars Game #59941903310:  Hold'em No Limit ($0.10/$0.25) - 2009/07/01 1:49:50 ET
Table 'HzFR0rxmDAPu5GzYR0AlYg' 6-max Seat #3 is the button
Seat 1: v+QfkGiuj9bgtuNoVnDO8w ($34.55 in chips) 
Seat 2: UA5OsKS3VPaxa7uC8La/kA ($51.60 in chips) 
Seat 3: kG34n23qFQA3nzdOJTQ1dA ($24.55 in chips) 
Seat 4: Mhj3q7cxev+XjXZxEE6/Cw ($25.10 in chips) 
Seat 5: lquriepNQBhDV5P1SWHhnA ($27.10 in chips) 
Seat 6: jp34e617tIzV8tKIWmfAbA ($35.55 in chips) 
Mhj3q7cxev+XjXZxEE6/Cw: posts small blind $0.10
lquriepNQBhDV5P1SWHhnA: posts big blind $0.25
*** HOLE CARDS ***
jp34e617tIzV8tKIWmfAbA: folds 
v+QfkGiuj9bgtuNoVnDO8w: raises $0.75 to $1
UA5OsKS3VPaxa7uC8La/kA: folds 
kG34n23qFQA3nzdOJTQ1dA: folds 
Mhj3q7cxev+XjXZxEE6/Cw: folds 
lquriepNQBhDV5P1SWHhnA: folds 
Uncalled bet ($0.75) returned to v+QfkGiuj9bgtuNoVnDO8w
v+QfkGiuj9bgtuNoVnDO8w collected $0.60 from pot
v+QfkGiuj9bgtuNoVnDO8w: doesn't show hand 
*** SUMMARY ***
Total pot $0.60 | Rake $0 
Seat 1: v+QfkGiuj9bgtuNoVnDO8w collected ($0.60)
Seat 2: UA5OsKS3VPaxa7uC8La/kA folded before Flop (didn't bet)
Seat 3: kG34n23qFQA3nzdOJTQ1dA (button) folded before Flop (didn't bet)
Seat 4: Mhj3q7cxev+XjXZxEE6/Cw (small blind) folded before Flop
Seat 5: lquriepNQBhDV5P1SWHhnA (big blind) folded before Flop
Seat 6: jp34e617tIzV8tKIWmfAbA folded before Flop (didn't bet)




PokerStars Game #59941903394:  Hold'em No Limit ($0.10/$0.25) - 2009/07/01 1:49:50 ET
Table 'srBTB98reCdD1TffxE6o7g' 6-max Seat #6 is the button
Seat 1: SFmT9ZsVopnukjvAzrxTRg ($36.65 in chips) 
Seat 2: mfrkWA3PTeYPkbO6hi98Aw ($25 in chips) 
Seat 3: VOmI0x4dDPnTESZd5B4d1Q ($42.05 in chips) 
Seat 4: 6DwBRH+xZ12AAZmeAg+aXw ($16.20 in chips) 
Seat 5: K1zv48sQUGQiaLk5VWWDqw ($25.90 in chips) 
Seat 6: BV+K0Phf5VBHr7aZPKqbUQ ($30.75 in chips) 
SFmT9ZsVopnukjvAzrxTRg: posts small blind $0.10
mfrkWA3PTeYPkbO6hi98Aw: posts big blind $0.25
VOmI0x4dDPnTESZd5B4d1Q: posts small & big blinds $0.35
*** HOLE CARDS ***
VOmI0x4dDPnTESZd5B4d1Q: raises $1.75 to $2
6DwBRH+xZ12AAZmeAg+aXw: folds 
K1zv48sQUGQiaLk5VWWDqw: folds 
BV+K0Phf5VBHr7aZPKqbUQ: folds 
SFmT9ZsVopnukjvAzrxTRg: folds 
mfrkWA3PTeYPkbO6hi98Aw: folds 
Uncalled bet ($1.75) returned to VOmI0x4dDPnTESZd5B4d1Q
VOmI0x4dDPnTESZd5B4d1Q collected $0.70 from pot
*** SUMMARY ***
Total pot $0.70 | Rake $0 
Seat 1: SFmT9ZsVopnukjvAzrxTRg (small blind) folded before Flop
Seat 2: mfrkWA3PTeYPkbO6hi98Aw (big blind) folded before Flop
Seat 3: VOmI0x4dDPnTESZd5B4d1Q collected ($0.70)
Seat 4: 6DwBRH+xZ12AAZmeAg+aXw folded before Flop (didn't bet)
Seat 5: K1zv48sQUGQiaLk5VWWDqw folded before Flop (didn't bet)
Seat 6: BV+K0Phf5VBHr7aZPKqbUQ (button) folded before Flop (didn't bet)




PokerStars Game #59941903442:  Hold'em No Limit ($0.10/$0.25) - 2009/07/01 1:49:50 ET
Table 'oJpFwZj9+FUGHX90Un8s9Q' 6-max Seat #5 is the button
Seat 1: 6DwBRH+xZ12AAZmeAg+aXw ($25.05 in chips) 
Seat 2: NtrVQ9UIql0rDCnKDKZ5FQ ($19.70 in chips) 
Seat 3: kyRaCIljYA6l33lSKQfNsg ($24.65 in chips) 
Seat 4: 6elpmfyt4Zw0yvd8lePSMQ ($19.80 in chips) 
Seat 5: kG34n23qFQA3nzdOJTQ1dA ($55.10 in chips) 
Seat 6: 7LpHJVeM6k1mQdC6HXYzww ($25 in chips) 
7LpHJVeM6k1mQdC6HXYzww: posts small blind $0.10
6DwBRH+xZ12AAZmeAg+aXw: posts big blind $0.25
*** HOLE CARDS ***
NtrVQ9UIql0rDCnKDKZ5FQ: calls $0.25
kyRaCIljYA6l33lSKQfNsg: folds 
6elpmfyt4Zw0yvd8lePSMQ: folds 
kG34n23qFQA3nzdOJTQ1dA: folds 
7LpHJVeM6k1mQdC6HXYzww: folds 
6DwBRH+xZ12AAZmeAg+aXw: checks 
*** FLOP *** [6d Tc 9c]
6DwBRH+xZ12AAZmeAg+aXw: checks 
NtrVQ9UIql0rDCnKDKZ5FQ: bets $0.25
6DwBRH+xZ12AAZmeAg+aXw: calls $0.25
*** TURN *** [6d Tc 9c] [7h]
6DwBRH+xZ12AAZmeAg+aXw: checks 
NtrVQ9UIql0rDCnKDKZ5FQ: checks 
*** RIVER *** [6d Tc 9c 7h] [4c]
6DwBRH+xZ12AAZmeAg+aXw: checks 
NtrVQ9UIql0rDCnKDKZ5FQ: checks 
*** SHOW DOWN ***
6DwBRH+xZ12AAZmeAg+aXw: shows [Td 2c] (a pair of Tens)
NtrVQ9UIql0rDCnKDKZ5FQ: mucks hand 
6DwBRH+xZ12AAZmeAg+aXw collected $1.05 from pot
*** SUMMARY ***
Total pot $1.10 | Rake $0.05 
Board [6d Tc 9c 7h 4c]
Seat 1: 6DwBRH+xZ12AAZmeAg+aXw (big blind) showed [Td 2c] and won ($1.05) with a pair of Tens
Seat 2: NtrVQ9UIql0rDCnKDKZ5FQ mucked
Seat 3: kyRaCIljYA6l33lSKQfNsg folded before Flop (didn't bet)
Seat 4: 6elpmfyt4Zw0yvd8lePSMQ folded before Flop (didn't bet)
Seat 5: kG34n23qFQA3nzdOJTQ1dA (button) folded before Flop (didn't bet)
Seat 6: 7LpHJVeM6k1mQdC6HXYzww (small blind) folded before Flop




PokerStars Game #59941903642:  Hold'em No Limit ($0.10/$0.25) - 2009/07/01 1:49:51 ET
Table 'GxdLtCpYxqT4aAbYqkEEpw' 6-max Seat #4 is the button
Seat 1: 2d/PU00mMdO9azAaXqcSbw ($9.30 in chips) 
Seat 2: MCCWc70bl051s/EF6nHRcA ($23.65 in chips) 
Seat 3: LpmZGzLpOmfZUF7EV4ZlrQ ($16.25 in chips) 
Seat 4: 6wzJiRvp8HY6t+MQGnSIzA ($12.90 in chips) 
Seat 5: q6WfTUAD9mowIP63ASq2Dg ($45 in chips) 
Seat 6: DFi/Lzkjsfv8QswS80JX9Q ($25 in chips) 
q6WfTUAD9mowIP63ASq2Dg: posts small blind $0.10
DFi/Lzkjsfv8QswS80JX9Q: posts big blind $0.25
LpmZGzLpOmfZUF7EV4ZlrQ: posts small & big blinds $0.35
*** HOLE CARDS ***
2d/PU00mMdO9azAaXqcSbw: calls $0.25
MCCWc70bl051s/EF6nHRcA: folds 
LpmZGzLpOmfZUF7EV4ZlrQ: checks 
6wzJiRvp8HY6t+MQGnSIzA: calls $0.25
q6WfTUAD9mowIP63ASq2Dg: folds 
DFi/Lzkjsfv8QswS80JX9Q: checks 
*** FLOP *** [4c 2s 7s]
DFi/Lzkjsfv8QswS80JX9Q: checks 
2d/PU00mMdO9azAaXqcSbw: checks 
LpmZGzLpOmfZUF7EV4ZlrQ: checks 
6wzJiRvp8HY6t+MQGnSIzA: checks 
*** TURN *** [4c 2s 7s] [Ad]
DFi/Lzkjsfv8QswS80JX9Q: checks 
2d/PU00mMdO9azAaXqcSbw: checks 
LpmZGzLpOmfZUF7EV4ZlrQ: checks 
6wzJiRvp8HY6t+MQGnSIzA: bets $0.75
DFi/Lzkjsfv8QswS80JX9Q: folds 
2d/PU00mMdO9azAaXqcSbw: folds 
LpmZGzLpOmfZUF7EV4ZlrQ: folds 
Uncalled bet ($0.75) returned to 6wzJiRvp8HY6t+MQGnSIzA
6wzJiRvp8HY6t+MQGnSIzA collected $1.15 from pot
6wzJiRvp8HY6t+MQGnSIzA: doesn't show hand 
*** SUMMARY ***
Total pot $1.20 | Rake $0.05 
Board [4c 2s 7s Ad]
Seat 1: 2d/PU00mMdO9azAaXqcSbw folded on the Turn
Seat 2: MCCWc70bl051s/EF6nHRcA folded before Flop (didn't bet)
Seat 3: LpmZGzLpOmfZUF7EV4ZlrQ folded on the Turn
Seat 4: 6wzJiRvp8HY6t+MQGnSIzA (button) collected ($1.15)
Seat 5: q6WfTUAD9mowIP63ASq2Dg (small blind) folded before Flop
Seat 6: DFi/Lzkjsfv8QswS80JX9Q (big blind) folded on the Turn




PokerStars Game #59941903656:  Hold'em No Limit ($0.10/$0.25) - 2009/07/01 1:49:51 ET
Table '+UzantPJ4smVdrh+4GTu1w' 6-max Seat #3 is the button
Seat 1: TSmua8tGK3sTbwi0ynrW9Q ($38.25 in chips) 
Seat 2: tcbEu7VzyHQ+0lh+skbQhQ ($32.50 in chips) 
Seat 3: SS/yfeArhULzIcOPe8MdPg ($31.85 in chips) 
Seat 4: UmcUp27+PbgBItv3ZNlAWQ ($26.55 in chips) 
Seat 5: cj4VBQya7HtVL2zCGd5jLQ ($55.70 in chips) 
Seat 6: fZQg9veL7Dd/Z04ZTjC+wQ ($25 in chips) 
UmcUp27+PbgBItv3ZNlAWQ: posts small blind $0.10
cj4VBQya7HtVL2zCGd5jLQ: posts big blind $0.25
*** HOLE CARDS ***
fZQg9veL7Dd/Z04ZTjC+wQ: folds 
TSmua8tGK3sTbwi0ynrW9Q: raises $0.75 to $1
SS/yfeArhULzIcOPe8MdPg said, "folded KQ for u"
tcbEu7VzyHQ+0lh+skbQhQ: calls $1
SS/yfeArhULzIcOPe8MdPg: folds 
UmcUp27+PbgBItv3ZNlAWQ: folds 
cj4VBQya7HtVL2zCGd5jLQ: folds 
*** FLOP *** [7s 7h 6h]
TSmua8tGK3sTbwi0ynrW9Q: bets $1.25
tcbEu7VzyHQ+0lh+skbQhQ: folds 
Uncalled bet ($1.25) returned to TSmua8tGK3sTbwi0ynrW9Q
TSmua8tGK3sTbwi0ynrW9Q collected $2.25 from pot
*** SUMMARY ***
Total pot $2.35 | Rake $0.10 
Board [7s 7h 6h]
Seat 1: TSmua8tGK3sTbwi0ynrW9Q collected ($2.25)
Seat 2: tcbEu7VzyHQ+0lh+skbQhQ folded on the Flop
Seat 3: SS/yfeArhULzIcOPe8MdPg (button) folded before Flop (didn't bet)
Seat 4: UmcUp27+PbgBItv3ZNlAWQ (small blind) folded before Flop
Seat 5: cj4VBQya7HtVL2zCGd5jLQ (big blind) folded before Flop
Seat 6: fZQg9veL7Dd/Z04ZTjC+wQ folded before Flop (didn't bet)




PokerStars Game #59941903478:  Hold'em No Limit ($0.10/$0.25) - 2009/07/01 1:49:51 ET
Table '9L7XfAwuM7XsXE8LIg2o5Q' 6-max Seat #6 is the button
Seat 1: dOIoLBxmpLHSXBN9LZnf0Q ($27.40 in chips) 
Seat 2: LJI7A1YgDM7hgh7o56+ReQ ($27.30 in chips) 
Seat 3: mFv3iBCtrw9XfCDRB0d46Q ($4.30 in chips) 
Seat 4: jp34e617tIzV8tKIWmfAbA ($38.45 in chips) 
Seat 6: k9nHZTHt8hYhYRcW8NTb4g ($18.85 in chips) 
dOIoLBxmpLHSXBN9LZnf0Q: posts small blind $0.10
LJI7A1YgDM7hgh7o56+ReQ: posts big blind $0.25
*** HOLE CARDS ***
mFv3iBCtrw9XfCDRB0d46Q: folds 
jp34e617tIzV8tKIWmfAbA: folds 
k9nHZTHt8hYhYRcW8NTb4g: folds 
dOIoLBxmpLHSXBN9LZnf0Q: folds 
Uncalled bet ($0.15) returned to LJI7A1YgDM7hgh7o56+ReQ
Beethoven87 joins the table at seat #5 
LJI7A1YgDM7hgh7o56+ReQ collected $0.20 from pot
LJI7A1YgDM7hgh7o56+ReQ: doesn't show hand 
*** SUMMARY ***
Total pot $0.20 | Rake $0 
Seat 1: dOIoLBxmpLHSXBN9LZnf0Q (small blind) folded before Flop
Seat 2: LJI7A1YgDM7hgh7o56+ReQ (big blind) collected ($0.20)
Seat 3: mFv3iBCtrw9XfCDRB0d46Q folded before Flop (didn't bet)
Seat 4: jp34e617tIzV8tKIWmfAbA folded before Flop (didn't bet)
Seat 6: k9nHZTHt8hYhYRcW8NTb4g (button) folded before Flop (didn't bet)




PokerStars Game #59941904398:  Hold'em No Limit ($0.10/$0.25) - 2009/07/01 1:49:52 ET
Table '3KDMdm1sfxFsNKkjc/PnBg' 9-max Seat #3 is the button
Seat 1: RN77cWdo2Yfi3gUEKq3PdA ($14.75 in chips) 
Seat 2: 5WLo/V8l3QfpUdK9JPp99w ($31.10 in chips) 
Seat 3: OXPkK84/qv92EMwXPiG5rQ ($9.25 in chips) 
Seat 4: F7pnn6czNpHvRM55XcA2EA ($37.70 in chips) 
Seat 5: +2kMBNpY4nF1qNCRd8SJLA ($30.45 in chips) 
Seat 6: sGFnnRCa1YAHAUmWgsW6Qg ($13.40 in chips) 
Seat 7: gehe91e0IyVT0QU/XBkEyg ($31.80 in chips) 
Seat 9: K0b5wNInj6hUGRr6yzKFtw ($32.35 in chips) 
F7pnn6czNpHvRM55XcA2EA: posts small blind $0.10
+2kMBNpY4nF1qNCRd8SJLA: posts big blind $0.25
*** HOLE CARDS ***
LFnLiiWho1pLiR1Xvp5d/w leaves the table
sGFnnRCa1YAHAUmWgsW6Qg: folds 
sGFnnRCa1YAHAUmWgsW6Qg leaves the table
CGjLyv/AvljZy2g76nYkzQ joins the table at seat #8 
gehe91e0IyVT0QU/XBkEyg: raises $0.75 to $1
K0b5wNInj6hUGRr6yzKFtw: folds 
RN77cWdo2Yfi3gUEKq3PdA: folds 
5WLo/V8l3QfpUdK9JPp99w: folds 
OXPkK84/qv92EMwXPiG5rQ: folds 
F7pnn6czNpHvRM55XcA2EA: folds 
+2kMBNpY4nF1qNCRd8SJLA: folds 
Uncalled bet ($0.75) returned to gehe91e0IyVT0QU/XBkEyg
gehe91e0IyVT0QU/XBkEyg collected $0.60 from pot
gehe91e0IyVT0QU/XBkEyg: doesn't show hand 
yq2rcghljWKV3+gbDEsK+g joins the table at seat #6 
*** SUMMARY ***
Total pot $0.60 | Rake $0 
Seat 1: RN77cWdo2Yfi3gUEKq3PdA folded before Flop (didn't bet)
Seat 2: 5WLo/V8l3QfpUdK9JPp99w folded before Flop (didn't bet)
Seat 3: OXPkK84/qv92EMwXPiG5rQ (button) folded before Flop (didn't bet)
Seat 4: F7pnn6czNpHvRM55XcA2EA (small blind) folded before Flop
Seat 5: +2kMBNpY4nF1qNCRd8SJLA (big blind) folded before Flop
Seat 6: sGFnnRCa1YAHAUmWgsW6Qg folded before Flop (didn't bet)
Seat 7: gehe91e0IyVT0QU/XBkEyg collected ($0.60)
Seat 9: K0b5wNInj6hUGRr6yzKFtw folded before Flop (didn't bet)




PokerStars Game #59941904288:  Hold'em No Limit ($0.10/$0.25) - 2009/07/01 1:49:52 ET
Table 'dZNBGqFYSwfOVZvDJ4VjIQ' 6-max Seat #2 is the button
Seat 1: v+QfkGiuj9bgtuNoVnDO8w ($38 in chips) 
Seat 2: 3zD3qLXT1bEffAoWGnc7wg ($27.95 in chips) 
Seat 3: kyRaCIljYA6l33lSKQfNsg ($29.45 in chips) 
Seat 5: +ZlnqPoP3Hg4BIUxDfKd/A ($29.10 in chips) 
Seat 6: ypmjhffk/YHGc51wgVXUTw ($29.05 in chips) 
kyRaCIljYA6l33lSKQfNsg: posts small blind $0.10
+ZlnqPoP3Hg4BIUxDfKd/A: posts big blind $0.25
*** HOLE CARDS ***
ypmjhffk/YHGc51wgVXUTw: folds 
v+QfkGiuj9bgtuNoVnDO8w: folds 
3zD3qLXT1bEffAoWGnc7wg: folds 
kyRaCIljYA6l33lSKQfNsg: folds 
Uncalled bet ($0.15) returned to +ZlnqPoP3Hg4BIUxDfKd/A
+ZlnqPoP3Hg4BIUxDfKd/A collected $0.20 from pot
+ZlnqPoP3Hg4BIUxDfKd/A: doesn't show hand 
*** SUMMARY ***
Total pot $0.20 | Rake $0 
Seat 1: v+QfkGiuj9bgtuNoVnDO8w folded before Flop (didn't bet)
Seat 2: 3zD3qLXT1bEffAoWGnc7wg (button) folded before Flop (didn't bet)
Seat 3: kyRaCIljYA6l33lSKQfNsg (small blind) folded before Flop
Seat 5: +ZlnqPoP3Hg4BIUxDfKd/A (big blind) collected ($0.20)
Seat 6: ypmjhffk/YHGc51wgVXUTw folded before Flop (didn't bet)




PokerStars Game #59941904330:  Hold'em No Limit ($0.10/$0.25) - 2009/07/01 1:49:52 ET
Table 'KEoOIegxPF91KooL2AelUA' 6-max Seat #1 is the button
Seat 1: 32YL2ZEp8NT4JB2RVM9euQ ($16.65 in chips) 
Seat 2: 0Bg59Tnte1Tc7C4i9Jd9cQ ($3.65 in chips) 
Seat 3: zxeVQGaMKDsDzmSY+AInjA ($12.35 in chips) 
Seat 4: Wo60l2GQnSEc3bxPVyvIUw ($10.25 in chips) 
Seat 6: AMrBn4Vx9aAo/vv6WHLk6w ($3.50 in chips) 
0Bg59Tnte1Tc7C4i9Jd9cQ: posts small blind $0.10
zxeVQGaMKDsDzmSY+AInjA: posts big blind $0.25
VXTONriS+Ohik+r0FeicIw: sits out 
*** HOLE CARDS ***
Wo60l2GQnSEc3bxPVyvIUw: calls $0.25
AMrBn4Vx9aAo/vv6WHLk6w: folds 
32YL2ZEp8NT4JB2RVM9euQ: folds 
0Bg59Tnte1Tc7C4i9Jd9cQ: calls $0.15
zxeVQGaMKDsDzmSY+AInjA: checks 
*** FLOP *** [3d 6h 3c]
0Bg59Tnte1Tc7C4i9Jd9cQ: checks 
zxeVQGaMKDsDzmSY+AInjA: checks 
Wo60l2GQnSEc3bxPVyvIUw: bets $1
0Bg59Tnte1Tc7C4i9Jd9cQ: raises $2.40 to $3.40 and is all-in
zxeVQGaMKDsDzmSY+AInjA: folds 
Wo60l2GQnSEc3bxPVyvIUw: folds 
Uncalled bet ($2.40) returned to 0Bg59Tnte1Tc7C4i9Jd9cQ
0Bg59Tnte1Tc7C4i9Jd9cQ collected $2.65 from pot
0Bg59Tnte1Tc7C4i9Jd9cQ: doesn't show hand 
*** SUMMARY ***
Total pot $2.75 | Rake $0.10 
Board [3d 6h 3c]
Seat 1: 32YL2ZEp8NT4JB2RVM9euQ (button) folded before Flop (didn't bet)
Seat 2: 0Bg59Tnte1Tc7C4i9Jd9cQ (small blind) collected ($2.65)
Seat 3: zxeVQGaMKDsDzmSY+AInjA (big blind) folded on the Flop
Seat 4: Wo60l2GQnSEc3bxPVyvIUw folded on the Flop
Seat 6: AMrBn4Vx9aAo/vv6WHLk6w folded before Flop (didn't bet)




PokerStars Game #59941904202:  Hold'em No Limit ($0.10/$0.25) - 2009/07/01 1:49:52 ET
Table 'JJzUs04lHpXg6nboT1/jeg' 6-max Seat #2 is the button
Seat 2: jxfR29d+dK/7h7s3SvCk+g ($8.35 in chips) 
Seat 3: 4zXbHDe39qNX46dAo81b4w ($10.85 in chips) 
Seat 4: 7cx44/slbeTw+Cy7QB8Trg ($25 in chips) 
Seat 5: QvTX2yGq3uKJiKPmns4TKQ ($18.25 in chips) 
4zXbHDe39qNX46dAo81b4w: posts small blind $0.10
7cx44/slbeTw+Cy7QB8Trg: posts big blind $0.25
vEZ/HxVuyR6kaq0BtZoUgQ: sits out 
*** HOLE CARDS ***
wqphQtauX5Qn7WRJZS1flA has returned
QvTX2yGq3uKJiKPmns4TKQ: folds 
QvTX2yGq3uKJiKPmns4TKQ leaves the table
jxfR29d+dK/7h7s3SvCk+g: raises $0.50 to $0.75
4zXbHDe39qNX46dAo81b4w: folds 
wqphQtauX5Qn7WRJZS1flA leaves the table
7cx44/slbeTw+Cy7QB8Trg: folds 
Uncalled bet ($0.50) returned to jxfR29d+dK/7h7s3SvCk+g
jxfR29d+dK/7h7s3SvCk+g collected $0.60 from pot
*** SUMMARY ***
Total pot $0.60 | Rake $0 
Seat 2: jxfR29d+dK/7h7s3SvCk+g (button) collected ($0.60)
Seat 3: 4zXbHDe39qNX46dAo81b4w (small blind) folded before Flop
Seat 4: 7cx44/slbeTw+Cy7QB8Trg (big blind) folded before Flop
Seat 5: QvTX2yGq3uKJiKPmns4TKQ folded before Flop (didn't bet)




PokerStars Game #59941904236:  Hold'em No Limit ($0.10/$0.25) - 2009/07/01 1:49:52 ET
Table 'AHkg4ChqzcMauBx6Qvz8Nw' 6-max Seat #3 is the button
Seat 1: +RDf7SmUjY2kK0PzdBEYqg ($2.05 in chips) 
Seat 2: Vi0JMrTI2BGrPL7UIulJtA ($3.30 in chips) 
Seat 3: 9dToMv2GJLfi00HcpfMnIw ($30.10 in chips) 
Seat 4: Eznneya0vB6S+eXJdVleHA ($21.65 in chips) 
Seat 5: Bada343Si4xKu3fNXY99AA ($4.20 in chips) 
Seat 6: Hsvkc0/G2VV78oVmWYXecw ($5 in chips) 
Eznneya0vB6S+eXJdVleHA: posts small blind $0.10
Bada343Si4xKu3fNXY99AA: posts big blind $0.25
*** HOLE CARDS ***
Hsvkc0/G2VV78oVmWYXecw: folds 
+RDf7SmUjY2kK0PzdBEYqg: folds 
Vi0JMrTI2BGrPL7UIulJtA: folds 
9dToMv2GJLfi00HcpfMnIw: folds 
Eznneya0vB6S+eXJdVleHA: calls $0.15
Bada343Si4xKu3fNXY99AA: checks 
*** FLOP *** [Qc Td Ts]
Eznneya0vB6S+eXJdVleHA: bets $0.25
Bada343Si4xKu3fNXY99AA: folds 
Uncalled bet ($0.25) returned to Eznneya0vB6S+eXJdVleHA
Eznneya0vB6S+eXJdVleHA collected $0.50 from pot
Eznneya0vB6S+eXJdVleHA: doesn't show hand 
*** SUMMARY ***
Total pot $0.50 | Rake $0 
Board [Qc Td Ts]
Seat 1: +RDf7SmUjY2kK0PzdBEYqg folded before Flop (didn't bet)
Seat 2: Vi0JMrTI2BGrPL7UIulJtA folded before Flop (didn't bet)
Seat 3: 9dToMv2GJLfi00HcpfMnIw (button) folded before Flop (didn't bet)
Seat 4: Eznneya0vB6S+eXJdVleHA (small blind) collected ($0.50)
Seat 5: Bada343Si4xKu3fNXY99AA (big blind) folded on the Flop
Seat 6: Hsvkc0/G2VV78oVmWYXecw folded before Flop (didn't bet)




PokerStars Game #59941904290:  Hold'em No Limit ($0.10/$0.25) - 2009/07/01 1:49:52 ET
Table 'YONIZZNvg4uZ4xNUO1deeA' 6-max Seat #5 is the button
Seat 1: GbCVUNssQ7mqsPWr7J4d3w ($4.65 in chips) 
Seat 2: evMMX/0gSDH791KdSAOaSg ($18.45 in chips) 
Seat 3: Eksrep3hySi2jeDHuaWiOQ ($8.75 in chips) 
Seat 4: w43JQj2oYPpKQVG4Yzlq1w ($25 in chips) 
Seat 5: if4dh6jhJXeN3/qd3qCp9g ($24.65 in chips) 
Seat 6: eL3+wCBjFGfQ5FMdIZihwA ($28.25 in chips) 
eL3+wCBjFGfQ5FMdIZihwA: posts small blind $0.10
GbCVUNssQ7mqsPWr7J4d3w: posts big blind $0.25
*** HOLE CARDS ***
evMMX/0gSDH791KdSAOaSg: raises $0.75 to $1
Eksrep3hySi2jeDHuaWiOQ: folds 
w43JQj2oYPpKQVG4Yzlq1w: folds 
if4dh6jhJXeN3/qd3qCp9g: folds 
eL3+wCBjFGfQ5FMdIZihwA: folds 
GbCVUNssQ7mqsPWr7J4d3w: folds 
Uncalled bet ($0.75) returned to evMMX/0gSDH791KdSAOaSg
evMMX/0gSDH791KdSAOaSg collected $0.60 from pot
*** SUMMARY ***
Total pot $0.60 | Rake $0 
Seat 1: GbCVUNssQ7mqsPWr7J4d3w (big blind) folded before Flop
Seat 2: evMMX/0gSDH791KdSAOaSg collected ($0.60)
Seat 3: Eksrep3hySi2jeDHuaWiOQ folded before Flop (didn't bet)
Seat 4: w43JQj2oYPpKQVG4Yzlq1w folded before Flop (didn't bet)
Seat 5: if4dh6jhJXeN3/qd3qCp9g (button) folded before Flop (didn't bet)
Seat 6: eL3+wCBjFGfQ5FMdIZihwA (small blind) folded before Flop




PokerStars Game #59941904358:  Hold'em No Limit ($0.10/$0.25) - 2009/07/01 1:49:52 ET
Table 'rjcb+nlE+0GuJ6lBhuCkkA' 6-max Seat #1 is the button
Seat 1: lBoEwOFgzcERLIRUkUoRTw ($12.90 in chips) 
Seat 2: lJphax9e7/+O/3YCKPJ0yQ ($6.55 in chips) 
Seat 3: 8ClCHtFXGNplITm+63KB+Q ($66.20 in chips) 
Seat 4: BV+K0Phf5VBHr7aZPKqbUQ ($35.50 in chips) 
Seat 5: GC/9yVD59DUCX7hUI7gcLw ($30.15 in chips) 
Seat 6: 32YL2ZEp8NT4JB2RVM9euQ ($15.70 in chips) 
lJphax9e7/+O/3YCKPJ0yQ: posts small blind $0.10
8ClCHtFXGNplITm+63KB+Q: posts big blind $0.25
*** HOLE CARDS ***
BV+K0Phf5VBHr7aZPKqbUQ: folds 
GC/9yVD59DUCX7hUI7gcLw: raises $0.75 to $1
32YL2ZEp8NT4JB2RVM9euQ: folds 
lBoEwOFgzcERLIRUkUoRTw: folds 
lJphax9e7/+O/3YCKPJ0yQ: folds 
8ClCHtFXGNplITm+63KB+Q: folds 
Uncalled bet ($0.75) returned to GC/9yVD59DUCX7hUI7gcLw
GC/9yVD59DUCX7hUI7gcLw collected $0.60 from pot
*** SUMMARY ***
Total pot $0.60 | Rake $0 
Seat 1: lBoEwOFgzcERLIRUkUoRTw (button) folded before Flop (didn't bet)
Seat 2: lJphax9e7/+O/3YCKPJ0yQ (small blind) folded before Flop
Seat 3: 8ClCHtFXGNplITm+63KB+Q (big blind) folded before Flop
Seat 4: BV+K0Phf5VBHr7aZPKqbUQ folded before Flop (didn't bet)
Seat 5: GC/9yVD59DUCX7hUI7gcLw collected ($0.60)
Seat 6: 32YL2ZEp8NT4JB2RVM9euQ folded before Flop (didn't bet)




PokerStars Game #59941904634:  Hold'em No Limit ($0.10/$0.25) - 2009/07/01 1:49:53 ET
Table 'nB7Q7zfNfy6ig6DB+rsgWQ' 6-max Seat #4 is the button
Seat 1: Hzy03WtPHMYwLYM7hTTxQw ($25 in chips) 
Seat 2: 4BHo0wlX9INjkj2727qE0w ($26.50 in chips) 
Seat 3: p3NYOxYhkL7txPRSeXHDeg ($31.50 in chips) 
Seat 4: DihMHaz4WNETH1bPDe13kA ($80.35 in chips) 
Seat 5: xC0kaiDYM6YTlgODL83O5A ($16.40 in chips) 
Seat 6: MEGIwX0eHRUj63lwYaNhVg ($7.95 in chips) 
xC0kaiDYM6YTlgODL83O5A: posts small blind $0.10
MEGIwX0eHRUj63lwYaNhVg: posts big blind $0.25
*** HOLE CARDS ***
Hzy03WtPHMYwLYM7hTTxQw: folds 
4BHo0wlX9INjkj2727qE0w: folds 
p3NYOxYhkL7txPRSeXHDeg: folds 
DihMHaz4WNETH1bPDe13kA: raises $0.50 to $0.75
xC0kaiDYM6YTlgODL83O5A: folds 
MEGIwX0eHRUj63lwYaNhVg: folds 
Uncalled bet ($0.50) returned to DihMHaz4WNETH1bPDe13kA
DihMHaz4WNETH1bPDe13kA collected $0.60 from pot
*** SUMMARY ***
Total pot $0.60 | Rake $0 
Seat 1: Hzy03WtPHMYwLYM7hTTxQw folded before Flop (didn't bet)
Seat 2: 4BHo0wlX9INjkj2727qE0w folded before Flop (didn't bet)
Seat 3: p3NYOxYhkL7txPRSeXHDeg folded before Flop (didn't bet)
Seat 4: DihMHaz4WNETH1bPDe13kA (button) collected ($0.60)
Seat 5: xC0kaiDYM6YTlgODL83O5A (small blind) folded before Flop
Seat 6: MEGIwX0eHRUj63lwYaNhVg (big blind) folded before Flop




PokerStars Game #59941904904:  Hold'em No Limit ($0.10/$0.25) - 2009/07/01 1:49:53 ET
Table 'IfRHUn9gQQA9I/Z4tn+BoA' 9-max Seat #2 is the button
Seat 1: imHPFFqvfHGzsBBWeGuy4w ($23.75 in chips) 
Seat 2: VWUWpMLMj/Q1jRVpF7Aohw ($16.20 in chips) 
Seat 3: 4qA/3Ajg3pP6fqW+IX9/fQ ($4.75 in chips) 
Seat 4: QEbIGci+itdw+re8RM5fZA ($35.50 in chips) 
Seat 5: DdPXdieucQ+n99u1n3A+rQ ($5 in chips) 
Seat 6: UOjoGGQ58/uDS7V0xkjOrQ ($25.70 in chips) 
Seat 7: YzqSxP03XxZPbgPifgt69g ($28.75 in chips) 
Seat 8: cZ99hugmLBj9KhTlc8nCSw ($27.75 in chips) 
4qA/3Ajg3pP6fqW+IX9/fQ: posts small blind $0.10
QEbIGci+itdw+re8RM5fZA: posts big blind $0.25
18G4P1XstjNvItdGUITxgw: sits out 
*** HOLE CARDS ***
DdPXdieucQ+n99u1n3A+rQ: folds 
UOjoGGQ58/uDS7V0xkjOrQ: calls $0.25
YzqSxP03XxZPbgPifgt69g: raises $1.75 to $2
cZ99hugmLBj9KhTlc8nCSw: folds 
imHPFFqvfHGzsBBWeGuy4w: folds 
VWUWpMLMj/Q1jRVpF7Aohw: folds 
4qA/3Ajg3pP6fqW+IX9/fQ: folds 
QEbIGci+itdw+re8RM5fZA: folds 
UOjoGGQ58/uDS7V0xkjOrQ: calls $1.75
*** FLOP *** [8s As 7c]
UOjoGGQ58/uDS7V0xkjOrQ: bets $2.75
YzqSxP03XxZPbgPifgt69g: calls $2.75
*** TURN *** [8s As 7c] [9h]
UOjoGGQ58/uDS7V0xkjOrQ: checks 
YzqSxP03XxZPbgPifgt69g: bets $8
UOjoGGQ58/uDS7V0xkjOrQ: folds 
Uncalled bet ($8) returned to YzqSxP03XxZPbgPifgt69g
YzqSxP03XxZPbgPifgt69g collected $9.40 from pot
YzqSxP03XxZPbgPifgt69g: doesn't show hand 
*** SUMMARY ***
Total pot $9.85 | Rake $0.45 
Board [8s As 7c 9h]
Seat 1: imHPFFqvfHGzsBBWeGuy4w folded before Flop (didn't bet)
Seat 2: VWUWpMLMj/Q1jRVpF7Aohw (button) folded before Flop (didn't bet)
Seat 3: 4qA/3Ajg3pP6fqW+IX9/fQ (small blind) folded before Flop
Seat 4: QEbIGci+itdw+re8RM5fZA (big blind) folded before Flop
Seat 5: DdPXdieucQ+n99u1n3A+rQ folded before Flop (didn't bet)
Seat 6: UOjoGGQ58/uDS7V0xkjOrQ folded on the Turn
Seat 7: YzqSxP03XxZPbgPifgt69g collected ($9.40)
Seat 8: cZ99hugmLBj9KhTlc8nCSw folded before Flop (didn't bet)




PokerStars Game #59941904766:  Hold'em No Limit ($0.10/$0.25) - 2009/07/01 1:49:53 ET
Table 'rpIHGyt2QpgQc5bvptAvDQ' 9-max Seat #6 is the button
Seat 1: E0iYnEVO2ho7dH3QcCjw7g ($24.10 in chips) 
Seat 2: FX0yWp7Ul3dMebXB0cFjEw ($5 in chips) 
Seat 3: N6a/f6AW8S8G3JFw9IFxAg ($21.30 in chips) 
Seat 4: ASXDkj9tmvF/T2AsNuxg7g ($4.85 in chips) 
Seat 5: XhSvfX1gy0yx/qeW+SOeTw ($7.55 in chips) 
Seat 6: Mq1ESwxx3LEsA4HjKKjU3Q ($18.65 in chips) 
Seat 7: GHgIdzlzMAmRmmX7jgXtuQ ($1.80 in chips) 
Seat 8: oUgIL46CfA9GCdIuN1TVSw ($8.70 in chips) 
GHgIdzlzMAmRmmX7jgXtuQ: posts small blind $0.10
oUgIL46CfA9GCdIuN1TVSw: posts big blind $0.25
sUVgUtgbfVx6JpvApozwhQ: sits out 
*** HOLE CARDS ***
E0iYnEVO2ho7dH3QcCjw7g: folds 
FX0yWp7Ul3dMebXB0cFjEw: folds 
N6a/f6AW8S8G3JFw9IFxAg: folds 
ASXDkj9tmvF/T2AsNuxg7g said, "KQ V 82"
ASXDkj9tmvF/T2AsNuxg7g said, "lol"
ASXDkj9tmvF/T2AsNuxg7g: raises $0.75 to $1
ASXDkj9tmvF/T2AsNuxg7g said, "wow"
XhSvfX1gy0yx/qeW+SOeTw: calls $1
Mq1ESwxx3LEsA4HjKKjU3Q: folds 
GHgIdzlzMAmRmmX7jgXtuQ: folds 
oUgIL46CfA9GCdIuN1TVSw: folds 
*** FLOP *** [6d 2s Jd]
ASXDkj9tmvF/T2AsNuxg7g: bets $1.25
XhSvfX1gy0yx/qeW+SOeTw: calls $1.25
*** TURN *** [6d 2s Jd] [As]
ASXDkj9tmvF/T2AsNuxg7g: bets $1
XhSvfX1gy0yx/qeW+SOeTw: calls $1
*** RIVER *** [6d 2s Jd As] [Ac]
ASXDkj9tmvF/T2AsNuxg7g: bets $1.60 and is all-in
XhSvfX1gy0yx/qeW+SOeTw: calls $1.60
*** SHOW DOWN ***
ASXDkj9tmvF/T2AsNuxg7g: shows [Kh Qd] (a pair of Aces)
XhSvfX1gy0yx/qeW+SOeTw: shows [4c 6c] (two pair, Aces and Sixes)
XhSvfX1gy0yx/qeW+SOeTw collected $9.60 from pot
*** SUMMARY ***
Total pot $10.05 | Rake $0.45 
Board [6d 2s Jd As Ac]
Seat 1: E0iYnEVO2ho7dH3QcCjw7g folded before Flop (didn't bet)
Seat 2: FX0yWp7Ul3dMebXB0cFjEw folded before Flop (didn't bet)
Seat 3: N6a/f6AW8S8G3JFw9IFxAg folded before Flop (didn't bet)
Seat 4: ASXDkj9tmvF/T2AsNuxg7g showed [Kh Qd] and lost with a pair of Aces
Seat 5: XhSvfX1gy0yx/qeW+SOeTw showed [4c 6c] and won ($9.60) with two pair, Aces and Sixes
Seat 6: Mq1ESwxx3LEsA4HjKKjU3Q (button) folded before Flop (didn't bet)
Seat 7: GHgIdzlzMAmRmmX7jgXtuQ (small blind) folded before Flop
Seat 8: oUgIL46CfA9GCdIuN1TVSw (big blind) folded before Flop




PokerStars Game #59941904602:  Hold'em No Limit ($0.10/$0.25) - 2009/07/01 1:49:53 ET
Table 'M7d9IrgQUUFFy/SZ3ksLYg' 6-max Seat #2 is the button
Seat 1: ypmjhffk/YHGc51wgVXUTw ($50.85 in chips) 
Seat 2: 8CPg15X6IHYR1pWm9ha1Sw ($25 in chips) 
Seat 3: epAUIB7h2FJXzUPRIvSkRA ($26 in chips) 
Seat 4: 8ClCHtFXGNplITm+63KB+Q ($22.85 in chips) 
Seat 5: kMa8BltUcBQVxnHfqdCfXg ($7.25 in chips) 
epAUIB7h2FJXzUPRIvSkRA: posts small blind $0.10
8ClCHtFXGNplITm+63KB+Q: posts big blind $0.25
*** HOLE CARDS ***
kMa8BltUcBQVxnHfqdCfXg: calls $0.25
ypmjhffk/YHGc51wgVXUTw: folds 
8CPg15X6IHYR1pWm9ha1Sw: raises $0.75 to $1
epAUIB7h2FJXzUPRIvSkRA: folds 
8ClCHtFXGNplITm+63KB+Q: folds 
kMa8BltUcBQVxnHfqdCfXg: calls $0.75
*** FLOP *** [3h Qh 3s]
kMa8BltUcBQVxnHfqdCfXg: bets $0.25
8CPg15X6IHYR1pWm9ha1Sw: raises $1.50 to $1.75
kMa8BltUcBQVxnHfqdCfXg: folds 
Uncalled bet ($1.50) returned to 8CPg15X6IHYR1pWm9ha1Sw
8CPg15X6IHYR1pWm9ha1Sw collected $2.75 from pot
*** SUMMARY ***
Total pot $2.85 | Rake $0.10 
Board [3h Qh 3s]
Seat 1: ypmjhffk/YHGc51wgVXUTw folded before Flop (didn't bet)
Seat 2: 8CPg15X6IHYR1pWm9ha1Sw (button) collected ($2.75)
Seat 3: epAUIB7h2FJXzUPRIvSkRA (small blind) folded before Flop
Seat 4: 8ClCHtFXGNplITm+63KB+Q (big blind) folded before Flop
Seat 5: kMa8BltUcBQVxnHfqdCfXg folded on the Flop




PokerStars Game #59941905342:  Hold'em No Limit ($0.10/$0.25) - 2009/07/01 1:49:54 ET
Table 'Is9eNmJA1KnBOw0lcVkxUQ' 9-max Seat #5 is the button
Seat 1: 56S3mA6Zs3pGR+0p0vUCtg ($32 in chips) 
Seat 2: VllYilcih0t+gMD4GTRlgQ ($59.05 in chips) 
Seat 3: ubsjZomMWSV0hAiBLa7K1A ($18.40 in chips) 
Seat 4: cZ99hugmLBj9KhTlc8nCSw ($25 in chips) 
Seat 5: Qduu7ikeizo6q6Ei9YvcJA ($24.65 in chips) 
Seat 6: HapyJHxV6lc3eqoT7yWL2A ($11.05 in chips) 
Seat 8: Th3FldXKQW6hWVVPahaoOQ ($25.50 in chips) 
Seat 9: DdPXdieucQ+n99u1n3A+rQ ($5.90 in chips) 
HapyJHxV6lc3eqoT7yWL2A: posts small blind $0.10
aNpwfA31EREwO+ar4XzBCw: is sitting out 
Th3FldXKQW6hWVVPahaoOQ: posts big blind $0.25
*** HOLE CARDS ***
aNpwfA31EREwO+ar4XzBCw leaves the table
DdPXdieucQ+n99u1n3A+rQ: raises $0.75 to $1
56S3mA6Zs3pGR+0p0vUCtg: calls $1
VllYilcih0t+gMD4GTRlgQ: folds 
18G4P1XstjNvItdGUITxgw joins the table at seat #7 
ubsjZomMWSV0hAiBLa7K1A: folds 
cZ99hugmLBj9KhTlc8nCSw: folds 
Qduu7ikeizo6q6Ei9YvcJA: folds 
HapyJHxV6lc3eqoT7yWL2A: calls $0.90
Th3FldXKQW6hWVVPahaoOQ: calls $0.75
*** FLOP *** [Ac 4d Jh]
HapyJHxV6lc3eqoT7yWL2A: checks 
Th3FldXKQW6hWVVPahaoOQ: checks 
DdPXdieucQ+n99u1n3A+rQ: checks 
56S3mA6Zs3pGR+0p0vUCtg: checks 
*** TURN *** [Ac 4d Jh] [7d]
HapyJHxV6lc3eqoT7yWL2A: checks 
Th3FldXKQW6hWVVPahaoOQ: checks 
DdPXdieucQ+n99u1n3A+rQ: checks 
56S3mA6Zs3pGR+0p0vUCtg: checks 
*** RIVER *** [Ac 4d Jh 7d] [Qs]
HapyJHxV6lc3eqoT7yWL2A: checks 
Th3FldXKQW6hWVVPahaoOQ: checks 
DdPXdieucQ+n99u1n3A+rQ: checks 
56S3mA6Zs3pGR+0p0vUCtg: checks 
*** SHOW DOWN ***
HapyJHxV6lc3eqoT7yWL2A: shows [6c 7c] (a pair of Sevens)
Th3FldXKQW6hWVVPahaoOQ: shows [Td Th] (a pair of Tens)
DdPXdieucQ+n99u1n3A+rQ: shows [Kh Ks] (a pair of Kings)
56S3mA6Zs3pGR+0p0vUCtg: mucks hand 
DdPXdieucQ+n99u1n3A+rQ collected $3.80 from pot
*** SUMMARY ***
Total pot $4 | Rake $0.20 
Board [Ac 4d Jh 7d Qs]
Seat 1: 56S3mA6Zs3pGR+0p0vUCtg mucked
Seat 2: VllYilcih0t+gMD4GTRlgQ folded before Flop (didn't bet)
Seat 3: ubsjZomMWSV0hAiBLa7K1A folded before Flop (didn't bet)
Seat 4: cZ99hugmLBj9KhTlc8nCSw folded before Flop (didn't bet)
Seat 5: Qduu7ikeizo6q6Ei9YvcJA (button) folded before Flop (didn't bet)
Seat 6: HapyJHxV6lc3eqoT7yWL2A (small blind) showed [6c 7c] and lost with a pair of Sevens
Seat 8: Th3FldXKQW6hWVVPahaoOQ (big blind) showed [Td Th] and lost with a pair of Tens
Seat 9: DdPXdieucQ+n99u1n3A+rQ showed [Kh Ks] and won ($3.80) with a pair of Kings




PokerStars Game #59941905240:  Hold'em No Limit ($0.10/$0.25) - 2009/07/01 1:49:54 ET
Table '63h13e5p7cWe02rClZ1CHw' 6-max Seat #6 is the button
Seat 1: pokjbbEcXXPlADXdSGHtZw ($21.45 in chips) 
Seat 2: k9nHZTHt8hYhYRcW8NTb4g ($24.95 in chips) 
Seat 3: mFv3iBCtrw9XfCDRB0d46Q ($4.30 in chips) 
Seat 4: xrf8tAXKQHG99HixCot1Iw ($28 in chips) 
Seat 5: iyZxqznXjv3vtvOJymkoLQ ($44.45 in chips) 
Seat 6: mfrkWA3PTeYPkbO6hi98Aw ($38.70 in chips) 
pokjbbEcXXPlADXdSGHtZw: posts small blind $0.10
k9nHZTHt8hYhYRcW8NTb4g: posts big blind $0.25
*** HOLE CARDS ***
mFv3iBCtrw9XfCDRB0d46Q: folds 
xrf8tAXKQHG99HixCot1Iw: raises $0.50 to $0.75
iyZxqznXjv3vtvOJymkoLQ: folds 
mfrkWA3PTeYPkbO6hi98Aw: folds 
pokjbbEcXXPlADXdSGHtZw: folds 
k9nHZTHt8hYhYRcW8NTb4g: folds 
Uncalled bet ($0.50) returned to xrf8tAXKQHG99HixCot1Iw
xrf8tAXKQHG99HixCot1Iw collected $0.60 from pot
xrf8tAXKQHG99HixCot1Iw: doesn't show hand 
*** SUMMARY ***
Total pot $0.60 | Rake $0 
Seat 1: pokjbbEcXXPlADXdSGHtZw (small blind) folded before Flop
Seat 2: k9nHZTHt8hYhYRcW8NTb4g (big blind) folded before Flop
Seat 3: mFv3iBCtrw9XfCDRB0d46Q folded before Flop (didn't bet)
Seat 4: xrf8tAXKQHG99HixCot1Iw collected ($0.60)
Seat 5: iyZxqznXjv3vtvOJymkoLQ folded before Flop (didn't bet)
Seat 6: mfrkWA3PTeYPkbO6hi98Aw (button) folded before Flop (didn't bet)




PokerStars Game #59941905056:  Hold'em No Limit ($0.10/$0.25) - 2009/07/01 1:49:54 ET
Table 'VQNfcI8vTBCTvRfd3veTLQ' 6-max Seat #3 is the button
Seat 1: QiL+lEgEWwy21jk/ltaRLg ($13.50 in chips) 
Seat 2: 79ID/ub1Pt/mDpCprVmOoA ($31.25 in chips) 
Seat 3: LtASJ9OlkqGrrUKGQlpGAw ($11.25 in chips) 
Seat 4: QIWnfLSqfMcoFfdDe5LZPg ($39.85 in chips) 
Seat 5: gX2vbKwS/8zZPENAWB7hxQ ($25.90 in chips) 
Seat 6: LJI7A1YgDM7hgh7o56+ReQ ($27.70 in chips) 
QIWnfLSqfMcoFfdDe5LZPg: posts small blind $0.10
gX2vbKwS/8zZPENAWB7hxQ: posts big blind $0.25
*** HOLE CARDS ***
LJI7A1YgDM7hgh7o56+ReQ: folds 
QiL+lEgEWwy21jk/ltaRLg: folds 
79ID/ub1Pt/mDpCprVmOoA: folds 
LtASJ9OlkqGrrUKGQlpGAw: folds 
QIWnfLSqfMcoFfdDe5LZPg: folds 
Uncalled bet ($0.15) returned to gX2vbKwS/8zZPENAWB7hxQ
gX2vbKwS/8zZPENAWB7hxQ collected $0.20 from pot
*** SUMMARY ***
Total pot $0.20 | Rake $0 
Seat 1: QiL+lEgEWwy21jk/ltaRLg folded before Flop (didn't bet)
Seat 2: 79ID/ub1Pt/mDpCprVmOoA folded before Flop (didn't bet)
Seat 3: LtASJ9OlkqGrrUKGQlpGAw (button) folded before Flop (didn't bet)
Seat 4: QIWnfLSqfMcoFfdDe5LZPg (small blind) folded before Flop
Seat 5: gX2vbKwS/8zZPENAWB7hxQ (big blind) collected ($0.20)
Seat 6: LJI7A1YgDM7hgh7o56+ReQ folded before Flop (didn't bet)




PokerStars Game #59941905160:  Hold'em No Limit ($0.10/$0.25) - 2009/07/01 1:49:54 ET
Table 'o0CDOvKO/bn1WjeymDrXfA' 6-max Seat #4 is the button
Seat 1: if4dh6jhJXeN3/qd3qCp9g ($27.05 in chips) 
Seat 2: uAJL+E2git8iAiFyAvVOnw ($8.20 in chips) 
Seat 3: OtVWmpxX2/9L8bb1GSKTuA ($21.55 in chips) 
Seat 4: i9LqF5rD3bvtbEE7HWgr3Q ($25 in chips) 
Seat 5: dOIoLBxmpLHSXBN9LZnf0Q ($32.60 in chips) 
Seat 6: SS/yfeArhULzIcOPe8MdPg ($25 in chips) 
dOIoLBxmpLHSXBN9LZnf0Q: posts small blind $0.10
SS/yfeArhULzIcOPe8MdPg: posts big blind $0.25
*** HOLE CARDS ***
if4dh6jhJXeN3/qd3qCp9g: folds 
uAJL+E2git8iAiFyAvVOnw: calls $0.25
OtVWmpxX2/9L8bb1GSKTuA: folds 
i9LqF5rD3bvtbEE7HWgr3Q: folds 
dOIoLBxmpLHSXBN9LZnf0Q: calls $0.15
SS/yfeArhULzIcOPe8MdPg: checks 
*** FLOP *** [Ad Ks 4h]
dOIoLBxmpLHSXBN9LZnf0Q: bets $0.50
SS/yfeArhULzIcOPe8MdPg: folds 
uAJL+E2git8iAiFyAvVOnw: calls $0.50
*** TURN *** [Ad Ks 4h] [8d]
dOIoLBxmpLHSXBN9LZnf0Q: bets $31.85 and is all-in
uAJL+E2git8iAiFyAvVOnw: calls $7.45 and is all-in
Uncalled bet ($24.40) returned to dOIoLBxmpLHSXBN9LZnf0Q
*** RIVER *** [Ad Ks 4h 8d] [Qc]
*** SHOW DOWN ***
dOIoLBxmpLHSXBN9LZnf0Q: shows [Ac 4s] (two pair, Aces and Fours)
uAJL+E2git8iAiFyAvVOnw: mucks hand 
dOIoLBxmpLHSXBN9LZnf0Q collected $15.85 from pot
uAJL+E2git8iAiFyAvVOnw leaves the table
*** SUMMARY ***
Total pot $16.65 | Rake $0.80 
Board [Ad Ks 4h 8d Qc]
Seat 1: if4dh6jhJXeN3/qd3qCp9g folded before Flop (didn't bet)
Seat 2: uAJL+E2git8iAiFyAvVOnw mucked
Seat 3: OtVWmpxX2/9L8bb1GSKTuA folded before Flop (didn't bet)
Seat 4: i9LqF5rD3bvtbEE7HWgr3Q (button) folded before Flop (didn't bet)
Seat 5: dOIoLBxmpLHSXBN9LZnf0Q (small blind) showed [Ac 4s] and won ($15.85) with two pair, Aces and Fours
Seat 6: SS/yfeArhULzIcOPe8MdPg (big blind) folded on the Flop




PokerStars Game #59941905394:  Hold'em No Limit ($0.10/$0.25) - 2009/07/01 1:49:54 ET
Table 'Pz8SfAzhP5nvWTsJRAxoDg' 6-max Seat #2 is the button
Seat 1: QiL+lEgEWwy21jk/ltaRLg ($46.80 in chips) 
Seat 2: k021eD5in2AjaloW5PalMg ($18.45 in chips) 
Seat 3: mfrkWA3PTeYPkbO6hi98Aw ($31.55 in chips) 
Seat 4: 4lJto+Qj0K4JrFKvHaPTLw ($63.35 in chips) 
Seat 5: FYepjhAvF8ZdVCmqHIy+eQ ($25 in chips) 
Seat 6: QvTX2yGq3uKJiKPmns4TKQ ($17.70 in chips) 
mfrkWA3PTeYPkbO6hi98Aw: posts small blind $0.10
4lJto+Qj0K4JrFKvHaPTLw: posts big blind $0.25
*** HOLE CARDS ***
FYepjhAvF8ZdVCmqHIy+eQ: raises $0.75 to $1
QvTX2yGq3uKJiKPmns4TKQ: folds 
QiL+lEgEWwy21jk/ltaRLg: folds 
k021eD5in2AjaloW5PalMg: folds 
mfrkWA3PTeYPkbO6hi98Aw: folds 
4lJto+Qj0K4JrFKvHaPTLw: folds 
Uncalled bet ($0.75) returned to FYepjhAvF8ZdVCmqHIy+eQ
FYepjhAvF8ZdVCmqHIy+eQ collected $0.60 from pot
*** SUMMARY ***
Total pot $0.60 | Rake $0 
Seat 1: QiL+lEgEWwy21jk/ltaRLg folded before Flop (didn't bet)
Seat 2: k021eD5in2AjaloW5PalMg (button) folded before Flop (didn't bet)
Seat 3: mfrkWA3PTeYPkbO6hi98Aw (small blind) folded before Flop
Seat 4: 4lJto+Qj0K4JrFKvHaPTLw (big blind) folded before Flop
Seat 5: FYepjhAvF8ZdVCmqHIy+eQ collected ($0.60)
Seat 6: QvTX2yGq3uKJiKPmns4TKQ folded before Flop (didn't bet)




PokerStars Game #59941905102:  Hold'em No Limit ($0.10/$0.25) - 2009/07/01 1:49:54 ET
Table 'sJ4KpS2GE5Qrsu1/cFjJUw' 9-max Seat #5 is the button
Seat 1: eDlQ+S+6L4e6gM1dkZhGgQ ($19.95 in chips) 
Seat 3: eK8qa6EPcH2zhtbmWSvc9g ($25 in chips) 
Seat 5: Q/gZC63lfOMr7YhWKPCxoQ ($7.60 in chips) 
Seat 6: OefE+Csvj5KR7ClGf3Hc2g ($3.85 in chips) 
Seat 7: Wi8djHgewBlVhpKWfp7isQ ($9.20 in chips) 
Seat 8: S7Ki0P+0AIGPuIfGJjW0gg ($30.70 in chips) 
Seat 9: 3PmVnC/15cl4oyI1TKIt4g ($4.40 in chips) 
OefE+Csvj5KR7ClGf3Hc2g: posts small blind $0.10
Wi8djHgewBlVhpKWfp7isQ: posts big blind $0.25
ydoFOVgzvZv9ZhuWu9rXAw: sits out 
*** HOLE CARDS ***
S7Ki0P+0AIGPuIfGJjW0gg: folds 
3PmVnC/15cl4oyI1TKIt4g: folds 
eDlQ+S+6L4e6gM1dkZhGgQ: folds 
eK8qa6EPcH2zhtbmWSvc9g: folds 
Q/gZC63lfOMr7YhWKPCxoQ: raises $0.25 to $0.50
OefE+Csvj5KR7ClGf3Hc2g: folds 
Wi8djHgewBlVhpKWfp7isQ: calls $0.25
*** FLOP *** [6c 5c 8s]
Wi8djHgewBlVhpKWfp7isQ: checks 
Q/gZC63lfOMr7YhWKPCxoQ: bets $0.25
Wi8djHgewBlVhpKWfp7isQ: calls $0.25
*** TURN *** [6c 5c 8s] [Kc]
Wi8djHgewBlVhpKWfp7isQ: checks 
Q/gZC63lfOMr7YhWKPCxoQ: bets $0.25
Wi8djHgewBlVhpKWfp7isQ: folds 
Uncalled bet ($0.25) returned to Q/gZC63lfOMr7YhWKPCxoQ
Q/gZC63lfOMr7YhWKPCxoQ collected $1.55 from pot
Q/gZC63lfOMr7YhWKPCxoQ: doesn't show hand 
*** SUMMARY ***
Total pot $1.60 | Rake $0.05 
Board [6c 5c 8s Kc]
Seat 1: eDlQ+S+6L4e6gM1dkZhGgQ folded before Flop (didn't bet)
Seat 3: eK8qa6EPcH2zhtbmWSvc9g folded before Flop (didn't bet)
Seat 5: Q/gZC63lfOMr7YhWKPCxoQ (button) collected ($1.55)
Seat 6: OefE+Csvj5KR7ClGf3Hc2g (small blind) folded before Flop
Seat 7: Wi8djHgewBlVhpKWfp7isQ (big blind) folded on the Turn
Seat 8: S7Ki0P+0AIGPuIfGJjW0gg folded before Flop (didn't bet)
Seat 9: 3PmVnC/15cl4oyI1TKIt4g folded before Flop (didn't bet)




PokerStars Game #59941905890:  Hold'em No Limit ($0.10/$0.25) - 2009/07/01 1:49:55 ET
Table 'Loy/olZ5qoDOSvX4UTujGg' 6-max Seat #2 is the button
Seat 1: HipgaJhkN4ie/tTw4dK3Ug ($9.85 in chips) 
Seat 2: 4z7mPbMLNp4TezHXin63Vw ($14.45 in chips) 
Seat 3: 32YL2ZEp8NT4JB2RVM9euQ ($15.10 in chips) 
Seat 4: /gJNBeCkWL4o85/jvlZ4BA ($30.75 in chips) 
Seat 5: Ar4vsUIUfJ7gbYh1c1m59g ($19.25 in chips) 
Seat 6: qGHGf/553gQnDoklMRe3tg ($25.15 in chips) 
32YL2ZEp8NT4JB2RVM9euQ: posts small blind $0.10
/gJNBeCkWL4o85/jvlZ4BA: posts big blind $0.25
*** HOLE CARDS ***
Ar4vsUIUfJ7gbYh1c1m59g: folds 
qGHGf/553gQnDoklMRe3tg: folds 
HipgaJhkN4ie/tTw4dK3Ug: raises $0.25 to $0.50
4z7mPbMLNp4TezHXin63Vw: folds 
32YL2ZEp8NT4JB2RVM9euQ: folds 
/gJNBeCkWL4o85/jvlZ4BA: calls $0.25
*** FLOP *** [5d 7s 3s]
/gJNBeCkWL4o85/jvlZ4BA: checks 
HipgaJhkN4ie/tTw4dK3Ug: bets $0.50
/gJNBeCkWL4o85/jvlZ4BA: folds 
Uncalled bet ($0.50) returned to HipgaJhkN4ie/tTw4dK3Ug
HipgaJhkN4ie/tTw4dK3Ug collected $1.05 from pot
*** SUMMARY ***
Total pot $1.10 | Rake $0.05 
Board [5d 7s 3s]
Seat 1: HipgaJhkN4ie/tTw4dK3Ug collected ($1.05)
Seat 2: 4z7mPbMLNp4TezHXin63Vw (button) folded before Flop (didn't bet)
Seat 3: 32YL2ZEp8NT4JB2RVM9euQ (small blind) folded before Flop
Seat 4: /gJNBeCkWL4o85/jvlZ4BA (big blind) folded on the Flop
Seat 5: Ar4vsUIUfJ7gbYh1c1m59g folded before Flop (didn't bet)
Seat 6: qGHGf/553gQnDoklMRe3tg folded before Flop (didn't bet)




PokerStars Game #59941905946:  Hold'em No Limit ($0.10/$0.25) - 2009/07/01 1:49:55 ET
Table '0mmHveGuaIfIMQlNE1eqMg' 9-max Seat #3 is the button
Seat 1: ydoFOVgzvZv9ZhuWu9rXAw ($5 in chips) 
Seat 2: rQhYIYXSyH/IivYM1dlV5A ($68.50 in chips) 
Seat 3: ghNKXUBl/H+t83JF079ZBA ($25 in chips) 
Seat 4: DnDcAdn9P0zGovMERigpFA ($39.80 in chips) 
Seat 6: 6RiVTYll/5D8zICp0MRpKw ($23.70 in chips) 
Seat 7: 5n7e7I+px7c6CQmLpPbtsg ($11.30 in chips) 
Seat 8: 0XACOSNrAWmqNv9k1nF8rw ($14.65 in chips) 
Seat 9: UNw/UrAelsQeSS17Rro/BA ($10.90 in chips) 
DnDcAdn9P0zGovMERigpFA: posts small blind $0.10
6RiVTYll/5D8zICp0MRpKw: posts big blind $0.25
*** HOLE CARDS ***
Pt637jKksB5MzP0UNJAAkw leaves the table
5n7e7I+px7c6CQmLpPbtsg: folds 
0XACOSNrAWmqNv9k1nF8rw: calls $0.25
UNw/UrAelsQeSS17Rro/BA: raises $0.50 to $0.75
maracudja joins the table at seat #5 
ydoFOVgzvZv9ZhuWu9rXAw: folds 
rQhYIYXSyH/IivYM1dlV5A: folds 
ghNKXUBl/H+t83JF079ZBA: folds 
5n7e7I+px7c6CQmLpPbtsg leaves the table
DnDcAdn9P0zGovMERigpFA: folds 
aintblinkin joins the table at seat #7 
6RiVTYll/5D8zICp0MRpKw: folds 
0XACOSNrAWmqNv9k1nF8rw: calls $0.50
*** FLOP *** [Ad As 7h]
0XACOSNrAWmqNv9k1nF8rw: checks 
UNw/UrAelsQeSS17Rro/BA: bets $0.75
0XACOSNrAWmqNv9k1nF8rw: calls $0.75
*** TURN *** [Ad As 7h] [8c]
0XACOSNrAWmqNv9k1nF8rw: checks 
UNw/UrAelsQeSS17Rro/BA: bets $0.75
0XACOSNrAWmqNv9k1nF8rw: calls $0.75
*** RIVER *** [Ad As 7h 8c] [Qh]
0XACOSNrAWmqNv9k1nF8rw: checks 
UNw/UrAelsQeSS17Rro/BA: checks 
*** SHOW DOWN ***
0XACOSNrAWmqNv9k1nF8rw: shows [Tc Ah] (three of a kind, Aces)
UNw/UrAelsQeSS17Rro/BA: mucks hand 
0XACOSNrAWmqNv9k1nF8rw collected $4.65 from pot
*** SUMMARY ***
Total pot $4.85 | Rake $0.20 
Board [Ad As 7h 8c Qh]
Seat 1: ydoFOVgzvZv9ZhuWu9rXAw folded before Flop (didn't bet)
Seat 2: rQhYIYXSyH/IivYM1dlV5A folded before Flop (didn't bet)
Seat 3: ghNKXUBl/H+t83JF079ZBA (button) folded before Flop (didn't bet)
Seat 4: DnDcAdn9P0zGovMERigpFA (small blind) folded before Flop
Seat 6: 6RiVTYll/5D8zICp0MRpKw (big blind) folded before Flop
Seat 7: 5n7e7I+px7c6CQmLpPbtsg folded before Flop (didn't bet)
Seat 8: 0XACOSNrAWmqNv9k1nF8rw showed [Tc Ah] and won ($4.65) with three of a kind, Aces
Seat 9: UNw/UrAelsQeSS17Rro/BA mucked




PokerStars Game #59941906010:  Hold'em No Limit ($0.10/$0.25) - 2009/07/01 1:49:55 ET
Table 'U0hCzoS0KCJL+eoE054K4Q' 9-max Seat #5 is the button
Seat 1: XVEauYThJRhSTUAMxB/2ow ($37.20 in chips) 
Seat 2: MG90wfSJZnOejs/KD3vlQQ ($28.85 in chips) 
Seat 3: 8Cp1H3sSs8+jTTwLfeYKcw ($25.55 in chips) 
Seat 4: Bb42QRQMhg5/Y0vHP8/2Xw ($25 in chips) 
Seat 5: zgi+EUykT/pZQpoUG6+oEg ($5.65 in chips) 
Seat 6: V6p0jQ/RhUsqpHLmXvEX4Q ($11.65 in chips) 
Seat 7: uetHVityNsFnyX2bBnKe2A ($18.35 in chips) 
Seat 8: K0b5wNInj6hUGRr6yzKFtw ($27.45 in chips) 
Seat 9: wGigCmBR/9XWkPpvYos3aQ ($34.25 in chips) 
V6p0jQ/RhUsqpHLmXvEX4Q: posts small blind $0.10
uetHVityNsFnyX2bBnKe2A: posts big blind $0.25
*** HOLE CARDS ***
K0b5wNInj6hUGRr6yzKFtw: folds 
wGigCmBR/9XWkPpvYos3aQ: folds 
XVEauYThJRhSTUAMxB/2ow: raises $0.50 to $0.75
MG90wfSJZnOejs/KD3vlQQ: folds 
8Cp1H3sSs8+jTTwLfeYKcw: folds 
Bb42QRQMhg5/Y0vHP8/2Xw: folds 
zgi+EUykT/pZQpoUG6+oEg: folds 
V6p0jQ/RhUsqpHLmXvEX4Q: folds 
uetHVityNsFnyX2bBnKe2A: folds 
Uncalled bet ($0.50) returned to XVEauYThJRhSTUAMxB/2ow
XVEauYThJRhSTUAMxB/2ow collected $0.60 from pot
XVEauYThJRhSTUAMxB/2ow: doesn't show hand 
*** SUMMARY ***
Total pot $0.60 | Rake $0 
Seat 1: XVEauYThJRhSTUAMxB/2ow collected ($0.60)
Seat 2: MG90wfSJZnOejs/KD3vlQQ folded before Flop (didn't bet)
Seat 3: 8Cp1H3sSs8+jTTwLfeYKcw folded before Flop (didn't bet)
Seat 4: Bb42QRQMhg5/Y0vHP8/2Xw folded before Flop (didn't bet)
Seat 5: zgi+EUykT/pZQpoUG6+oEg (button) folded before Flop (didn't bet)
Seat 6: V6p0jQ/RhUsqpHLmXvEX4Q (small blind) folded before Flop
Seat 7: uetHVityNsFnyX2bBnKe2A (big blind) folded before Flop
Seat 8: K0b5wNInj6hUGRr6yzKFtw folded before Flop (didn't bet)
Seat 9: wGigCmBR/9XWkPpvYos3aQ folded before Flop (didn't bet)




PokerStars Game #59941905970:  Hold'em No Limit ($0.10/$0.25) - 2009/07/01 1:49:55 ET
Table 'WEMI3Mtn7dGARDbgNrKibgQvLFJzpzymuOsaaRYi+8fgx Seat #6 is the button
Seat 1: cZ99hugmLBj9KhTlc8nCSw ($26.70 in chips) 
Seat 2: PdIasPkzm2sqZnN41ZRXOg ($5 in chips) 
Seat 3: Qduu7ikeizo6q6Ei9YvcJA ($25 in chips) 
Seat 4: tLcDklc2rBORNfixyRfVfw ($25.25 in chips) 
Seat 5: MG90wfSJZnOejs/KD3vlQQ ($37.10 in chips) 
Seat 6: vKdukiQ4ktU4yJ0Xx3MKnA ($7.10 in chips) 
Seat 7: rQhYIYXSyH/IivYM1dlV5A ($10.95 in chips) 
Seat 8: gehe91e0IyVT0QU/XBkEyg ($27.35 in chips) 
Seat 9: BWzInv8o0kN1pJybv/VjpQ ($44.80 in chips) 
rQhYIYXSyH/IivYM1dlV5A: posts small blind $0.10
gehe91e0IyVT0QU/XBkEyg: posts big blind $0.25
*** HOLE CARDS ***
BWzInv8o0kN1pJybv/VjpQ: folds 
cZ99hugmLBj9KhTlc8nCSw: folds 
PdIasPkzm2sqZnN41ZRXOg: folds 
Qduu7ikeizo6q6Ei9YvcJA: folds 
tLcDklc2rBORNfixyRfVfw: folds 
MG90wfSJZnOejs/KD3vlQQ: raises $0.50 to $0.75
vKdukiQ4ktU4yJ0Xx3MKnA: folds 
rQhYIYXSyH/IivYM1dlV5A: folds 
gehe91e0IyVT0QU/XBkEyg: folds 
Uncalled bet ($0.50) returned to MG90wfSJZnOejs/KD3vlQQ
MG90wfSJZnOejs/KD3vlQQ collected $0.60 from pot
MG90wfSJZnOejs/KD3vlQQ: doesn't show hand 
*** SUMMARY ***
Total pot $0.60 | Rake $0 
Seat 1: cZ99hugmLBj9KhTlc8nCSw folded before Flop (didn't bet)
Seat 2: PdIasPkzm2sqZnN41ZRXOg folded before Flop (didn't bet)
Seat 3: Qduu7ikeizo6q6Ei9YvcJA folded before Flop (didn't bet)
Seat 4: tLcDklc2rBORNfixyRfVfw folded before Flop (didn't bet)
Seat 5: MG90wfSJZnOejs/KD3vlQQ collected ($0.60)
Seat 6: vKdukiQ4ktU4yJ0Xx3MKnA (button) folded before Flop (didn't bet)
Seat 7: rQhYIYXSyH/IivYM1dlV5A (small blind) folded before Flop
Seat 8: gehe91e0IyVT0QU/XBkEyg (big blind) folded before Flop
Seat 9: BWzInv8o0kN1pJybv/VjpQ folded before Flop (didn't bet)




PokerStars Game #59941906582:  Hold'em No Limit ($0.10/$0.25) - 2009/07/01 1:49:56 ET
Table 'mdub7rJf3Z5tCT9s/+1+Wg' 9-max Seat #6 is the button
Seat 1: cZ99hugmLBj9KhTlc8nCSw ($28.90 in chips) 
Seat 2: 539MC3AwKLWVFwzABc644Q ($10.90 in chips) 
Seat 3: PdIasPkzm2sqZnN41ZRXOg ($5.95 in chips) 
Seat 4: fDGyaQz0cs2s4FOYxkbIHA ($14.50 in chips) 
Seat 5: dfNim92Z6XK1/h5SFW5vDg ($25.90 in chips) 
Seat 6: T/CCwAWe2yhO0c4oHNwicw ($23.25 in chips) 
Seat 7: woe+9KKk+L3pZgMTuHcmog ($15.30 in chips) 
Seat 8: bXpVeaSTPBFSPJmeXxO7nw ($5 in chips) 
Seat 9: tYsOBqdU1+x+yFI7zHO7hQ ($36.05 in chips) 
woe+9KKk+L3pZgMTuHcmog: posts small blind $0.10
bXpVeaSTPBFSPJmeXxO7nw: posts big blind $0.25
*** HOLE CARDS ***
tYsOBqdU1+x+yFI7zHO7hQ: folds 
cZ99hugmLBj9KhTlc8nCSw: folds 
539MC3AwKLWVFwzABc644Q: folds 
PdIasPkzm2sqZnN41ZRXOg: raises $0.75 to $1
fDGyaQz0cs2s4FOYxkbIHA: folds 
dfNim92Z6XK1/h5SFW5vDg: folds 
T/CCwAWe2yhO0c4oHNwicw: raises $2 to $3
woe+9KKk+L3pZgMTuHcmog: folds 
bXpVeaSTPBFSPJmeXxO7nw: folds 
PdIasPkzm2sqZnN41ZRXOg: raises $2.95 to $5.95 and is all-in
T/CCwAWe2yhO0c4oHNwicw: calls $2.95
*** FLOP *** [Ts 8h Jd]
*** TURN *** [Ts 8h Jd] [7s]
*** RIVER *** [Ts 8h Jd 7s] [Th]
*** SHOW DOWN ***
PdIasPkzm2sqZnN41ZRXOg: shows [Kh Ks] (two pair, Kings and Tens)
T/CCwAWe2yhO0c4oHNwicw: mucks hand 
PdIasPkzm2sqZnN41ZRXOg collected $11.65 from pot
*** SUMMARY ***
Total pot $12.25 | Rake $0.60 
Board [Ts 8h Jd 7s Th]
Seat 1: cZ99hugmLBj9KhTlc8nCSw folded before Flop (didn't bet)
Seat 2: 539MC3AwKLWVFwzABc644Q folded before Flop (didn't bet)
Seat 3: PdIasPkzm2sqZnN41ZRXOg showed [Kh Ks] and won ($11.65) with two pair, Kings and Tens
Seat 4: fDGyaQz0cs2s4FOYxkbIHA folded before Flop (didn't bet)
Seat 5: dfNim92Z6XK1/h5SFW5vDg folded before Flop (didn't bet)
Seat 6: T/CCwAWe2yhO0c4oHNwicw (button) mucked
Seat 7: woe+9KKk+L3pZgMTuHcmog (small blind) folded before Flop
Seat 8: bXpVeaSTPBFSPJmeXxO7nw (big blind) folded before Flop
Seat 9: tYsOBqdU1+x+yFI7zHO7hQ folded before Flop (didn't bet)




PokerStars Game #59941906460:  Hold'em No Limit ($0.10/$0.25) - 2009/07/01 1:49:56 ET
Table 'xkqAWQFDrFt4p81M8UsoNw' 9-max Seat #3 is the button
Seat 1: tLcDklc2rBORNfixyRfVfw ($28.60 in chips) 
Seat 3: xHZZRLAaFUIC8WWI8ljOJA ($23.65 in chips) 
Seat 4: wGigCmBR/9XWkPpvYos3aQ ($25 in chips) 
Seat 5: H5Se03ZqSX7tbULXur2MAg ($25 in chips) 
Seat 6: 6RiVTYll/5D8zICp0MRpKw ($25 in chips) 
Seat 7: MG90wfSJZnOejs/KD3vlQQ ($44.55 in chips) 
Seat 8: MaqsqnOOkbNuPf4oWvOtnA ($43.25 in chips) 
Seat 9: Z9AeOQX3yzuSvKAm/xyovg ($9.30 in chips) 
wGigCmBR/9XWkPpvYos3aQ: posts small blind $0.10
H5Se03ZqSX7tbULXur2MAg: posts big blind $0.25
*** HOLE CARDS ***
6RiVTYll/5D8zICp0MRpKw: folds 
MG90wfSJZnOejs/KD3vlQQ: folds 
MaqsqnOOkbNuPf4oWvOtnA: raises $0.25 to $0.50
Z9AeOQX3yzuSvKAm/xyovg: raises $0.75 to $1.25
tLcDklc2rBORNfixyRfVfw: folds 
xHZZRLAaFUIC8WWI8ljOJA: folds 
wGigCmBR/9XWkPpvYos3aQ: folds 
z5GxcHlYz/GSz6W2uFiTtg has returned
H5Se03ZqSX7tbULXur2MAg: folds 
MaqsqnOOkbNuPf4oWvOtnA: calls $0.75
*** FLOP *** [Ah Qd Ad]
MaqsqnOOkbNuPf4oWvOtnA: bets $0.25
Z9AeOQX3yzuSvKAm/xyovg: calls $0.25
*** TURN *** [Ah Qd Ad] [7h]
MaqsqnOOkbNuPf4oWvOtnA: bets $0.25
Z9AeOQX3yzuSvKAm/xyovg: calls $0.25
*** RIVER *** [Ah Qd Ad 7h] [Js]
MaqsqnOOkbNuPf4oWvOtnA: bets $0.25
Z9AeOQX3yzuSvKAm/xyovg: folds 
Uncalled bet ($0.25) returned to MaqsqnOOkbNuPf4oWvOtnA
MaqsqnOOkbNuPf4oWvOtnA collected $3.70 from pot
*** SUMMARY ***
Total pot $3.85 | Rake $0.15 
Board [Ah Qd Ad 7h Js]
Seat 1: tLcDklc2rBORNfixyRfVfw folded before Flop (didn't bet)
Seat 3: xHZZRLAaFUIC8WWI8ljOJA (button) folded before Flop (didn't bet)
Seat 4: wGigCmBR/9XWkPpvYos3aQ (small blind) folded before Flop
Seat 5: H5Se03ZqSX7tbULXur2MAg (big blind) folded before Flop
Seat 6: 6RiVTYll/5D8zICp0MRpKw folded before Flop (didn't bet)
Seat 7: MG90wfSJZnOejs/KD3vlQQ folded before Flop (didn't bet)
Seat 8: MaqsqnOOkbNuPf4oWvOtnA collected ($3.70)
Seat 9: Z9AeOQX3yzuSvKAm/xyovg folded on the River




PokerStars Game #59941906182:  Hold'em No Limit ($0.10/$0.25) - 2009/07/01 1:49:56 ET
Table 'KYX9dFNuOA9l2PV46IebqQ' 9-max Seat #8 is the button
Seat 1: qZqVFan2U+GAA/c5LQFbcw ($15.30 in chips) 
Seat 3: Uq3NSX4cIFaXe7pbXQuU+Q ($7.70 in chips) 
Seat 4: ly/lwri2xlF+wmFsvottuQ ($4.75 in chips) 
Seat 5: g7MXhRmNZxv1lIkKkUKa4w ($12.90 in chips) 
Seat 6: 4QYM+pWPc3J+6i8Zv8LvLg ($23.70 in chips) 
Seat 7: FVZtQJMz59M6BoiON/88Xg ($6.60 in chips) 
Seat 8: KRWTiGM4xH+MkvPtJz4+SA ($23.05 in chips) 
Seat 9: 6NECk10orj8iqgD3pZ2A0Q ($6.40 in chips) 
6NECk10orj8iqgD3pZ2A0Q: posts small blind $0.10
qZqVFan2U+GAA/c5LQFbcw: posts big blind $0.25
GeMoapCKDLc4ajT0Uk9ZQw: sits out 
*** HOLE CARDS ***
Uq3NSX4cIFaXe7pbXQuU+Q: raises $0.25 to $0.50
ly/lwri2xlF+wmFsvottuQ: calls $0.50
g7MXhRmNZxv1lIkKkUKa4w: calls $0.50
4QYM+pWPc3J+6i8Zv8LvLg: calls $0.50
FVZtQJMz59M6BoiON/88Xg: calls $0.50
KRWTiGM4xH+MkvPtJz4+SA: calls $0.50
6NECk10orj8iqgD3pZ2A0Q: folds 
qZqVFan2U+GAA/c5LQFbcw: calls $0.25
*** FLOP *** [7h 3h 8s]
qZqVFan2U+GAA/c5LQFbcw: checks 
Uq3NSX4cIFaXe7pbXQuU+Q: checks 
ly/lwri2xlF+wmFsvottuQ: checks 
g7MXhRmNZxv1lIkKkUKa4w: checks 
4QYM+pWPc3J+6i8Zv8LvLg: bets $2.25
FVZtQJMz59M6BoiON/88Xg: calls $2.25
KRWTiGM4xH+MkvPtJz4+SA: folds 
qZqVFan2U+GAA/c5LQFbcw: folds 
Uq3NSX4cIFaXe7pbXQuU+Q: folds 
ly/lwri2xlF+wmFsvottuQ: folds 
g7MXhRmNZxv1lIkKkUKa4w: calls $2.25
*** TURN *** [7h 3h 8s] [Jh]
g7MXhRmNZxv1lIkKkUKa4w: checks 
4QYM+pWPc3J+6i8Zv8LvLg: checks 
FVZtQJMz59M6BoiON/88Xg: checks 
*** RIVER *** [7h 3h 8s Jh] [2c]
g7MXhRmNZxv1lIkKkUKa4w: bets $10.15 and is all-in
4QYM+pWPc3J+6i8Zv8LvLg: folds 
FVZtQJMz59M6BoiON/88Xg: folds 
Uncalled bet ($10.15) returned to g7MXhRmNZxv1lIkKkUKa4w
g7MXhRmNZxv1lIkKkUKa4w collected $9.85 from pot
g7MXhRmNZxv1lIkKkUKa4w: doesn't show hand 
*** SUMMARY ***
Total pot $10.35 | Rake $0.50 
Board [7h 3h 8s Jh 2c]
Seat 1: qZqVFan2U+GAA/c5LQFbcw (big blind) folded on the Flop
Seat 3: Uq3NSX4cIFaXe7pbXQuU+Q folded on the Flop
Seat 4: ly/lwri2xlF+wmFsvottuQ folded on the Flop
Seat 5: g7MXhRmNZxv1lIkKkUKa4w collected ($9.85)
Seat 6: 4QYM+pWPc3J+6i8Zv8LvLg folded on the River
Seat 7: FVZtQJMz59M6BoiON/88Xg folded on the River
Seat 8: KRWTiGM4xH+MkvPtJz4+SA (button) folded on the Flop
Seat 9: 6NECk10orj8iqgD3pZ2A0Q (small blind) folded before Flop




PokerStars Game #59941906504:  Hold'em No Limit ($0.10/$0.25) - 2009/07/01 1:49:56 ET
Table 'edvgY2YQ1I34euq4EVqGnA' 6-max Seat #5 is the button
Seat 1: mvFHK3pE7tCxJEqLjKC70Q ($30.35 in chips) 
Seat 2: Hsvkc0/G2VV78oVmWYXecw ($5.25 in chips) 
Seat 4: TI/C5Q+DEl4fLR3AofwYdg ($23.60 in chips) 
Seat 5: EE16Ua5b1HSsYej5zeXOlA ($56 in chips) 
Seat 6: kG34n23qFQA3nzdOJTQ1dA ($70.50 in chips) 
kG34n23qFQA3nzdOJTQ1dA: posts small blind $0.10
mvFHK3pE7tCxJEqLjKC70Q: posts big blind $0.25
*** HOLE CARDS ***
Hsvkc0/G2VV78oVmWYXecw: folds 
TI/C5Q+DEl4fLR3AofwYdg: folds 
EE16Ua5b1HSsYej5zeXOlA: folds 
kG34n23qFQA3nzdOJTQ1dA: folds 
Uncalled bet ($0.15) returned to mvFHK3pE7tCxJEqLjKC70Q
mvFHK3pE7tCxJEqLjKC70Q collected $0.20 from pot
mFv3iBCtrw9XfCDRB0d46Q leaves the table
mvFHK3pE7tCxJEqLjKC70Q: doesn't show hand 
*** SUMMARY ***
Total pot $0.20 | Rake $0 
Seat 1: mvFHK3pE7tCxJEqLjKC70Q (big blind) collected ($0.20)
Seat 2: Hsvkc0/G2VV78oVmWYXecw folded before Flop (didn't bet)
Seat 4: TI/C5Q+DEl4fLR3AofwYdg folded before Flop (didn't bet)
Seat 5: EE16Ua5b1HSsYej5zeXOlA (button) folded before Flop (didn't bet)
Seat 6: kG34n23qFQA3nzdOJTQ1dA (small blind) folded before Flop




PokerStars Game #59941906670:  Hold'em No Limit ($0.10/$0.25) - 2009/07/01 1:49:57 ET
Table 'K/f0NNaoGuhSz5DrzgVw7Q' 9-max Seat #4 is the button
Seat 1: sD+TKtt36XiiN6jqHiLwDA ($25.70 in chips) 
Seat 2: zgi+EUykT/pZQpoUG6+oEg ($4.65 in chips) 
Seat 4: 9bCz0uv2nUmznwuI0OjVGw ($11.80 in chips) 
Seat 5: DnDcAdn9P0zGovMERigpFA ($40.70 in chips) 
Seat 6: 3PVK0IdMlq2fElkVzzr4bg ($7.60 in chips) 
Seat 7: egvg3mTBBVzMHnJPIQiKcA ($14.65 in chips) 
Seat 8: RCqMONFrSPSArZh2Jsar/w ($24.65 in chips) 
Seat 9: tLcDklc2rBORNfixyRfVfw ($25 in chips) 
DnDcAdn9P0zGovMERigpFA: posts small blind $0.10
3PVK0IdMlq2fElkVzzr4bg: posts big blind $0.25
*** HOLE CARDS ***
egvg3mTBBVzMHnJPIQiKcA: folds 
RCqMONFrSPSArZh2Jsar/w: folds 
tLcDklc2rBORNfixyRfVfw: folds 
sD+TKtt36XiiN6jqHiLwDA: calls $0.25
zgi+EUykT/pZQpoUG6+oEg: folds 
9bCz0uv2nUmznwuI0OjVGw: folds 
DnDcAdn9P0zGovMERigpFA: folds 
3PVK0IdMlq2fElkVzzr4bg: checks 
*** FLOP *** [Jh 8h 4d]
3PVK0IdMlq2fElkVzzr4bg: checks 
sD+TKtt36XiiN6jqHiLwDA: bets $0.75
3PVK0IdMlq2fElkVzzr4bg: folds 
Uncalled bet ($0.75) returned to sD+TKtt36XiiN6jqHiLwDA
sD+TKtt36XiiN6jqHiLwDA collected $0.60 from pot
sD+TKtt36XiiN6jqHiLwDA: doesn't show hand 
*** SUMMARY ***
Total pot $0.60 | Rake $0 
Board [Jh 8h 4d]
Seat 1: sD+TKtt36XiiN6jqHiLwDA collected ($0.60)
Seat 2: zgi+EUykT/pZQpoUG6+oEg folded before Flop (didn't bet)
Seat 4: 9bCz0uv2nUmznwuI0OjVGw (button) folded before Flop (didn't bet)
Seat 5: DnDcAdn9P0zGovMERigpFA (small blind) folded before Flop
Seat 6: 3PVK0IdMlq2fElkVzzr4bg (big blind) folded on the Flop
Seat 7: egvg3mTBBVzMHnJPIQiKcA folded before Flop (didn't bet)
Seat 8: RCqMONFrSPSArZh2Jsar/w folded before Flop (didn't bet)
Seat 9: tLcDklc2rBORNfixyRfVfw folded before Flop (didn't bet)




PokerStars Game #59941906672:  Hold'em No Limit ($0.10/$0.25) - 2009/07/01 1:49:57 ET
Table 'zhqgUUprOJ14VxKxPHcT/Q' 9-max Seat #8 is the button
Seat 1: 22dIObOuor/A+IKWkNoAlA ($5.60 in chips) 
Seat 2: GY095KWhBevJ1Ttvl8WseA ($14.25 in chips) 
Seat 3: 4XHsdGnQ76EBdBvsrSs8bA ($20.90 in chips) 
Seat 4: wGigCmBR/9XWkPpvYos3aQ ($33.45 in chips) 
Seat 5: +sbyWwIcFp9kP0bDtMegfQ ($33.25 in chips) 
Seat 6: PdIasPkzm2sqZnN41ZRXOg ($5 in chips) 
Seat 8: EQXHDnIzAsORnIXRNtXRlA ($29.50 in chips) 
CGjLyv/AvljZy2g76nYkzQ will be allowed to play after the button
22dIObOuor/A+IKWkNoAlA: posts small blind $0.10
GY095KWhBevJ1Ttvl8WseA: posts big blind $0.25
bXpVeaSTPBFSPJmeXxO7nw: sits out 
*** HOLE CARDS ***
4XHsdGnQ76EBdBvsrSs8bA: folds 
wGigCmBR/9XWkPpvYos3aQ: folds 
+sbyWwIcFp9kP0bDtMegfQ: folds 
PdIasPkzm2sqZnN41ZRXOg: folds 
EQXHDnIzAsORnIXRNtXRlA: folds 
22dIObOuor/A+IKWkNoAlA: folds 
Uncalled bet ($0.15) returned to GY095KWhBevJ1Ttvl8WseA
GY095KWhBevJ1Ttvl8WseA collected $0.20 from pot
GY095KWhBevJ1Ttvl8WseA: doesn't show hand 
*** SUMMARY ***
Total pot $0.20 | Rake $0 
Seat 1: 22dIObOuor/A+IKWkNoAlA (small blind) folded before Flop
Seat 2: GY095KWhBevJ1Ttvl8WseA (big blind) collected ($0.20)
Seat 3: 4XHsdGnQ76EBdBvsrSs8bA folded before Flop (didn't bet)
Seat 4: wGigCmBR/9XWkPpvYos3aQ folded before Flop (didn't bet)
Seat 5: +sbyWwIcFp9kP0bDtMegfQ folded before Flop (didn't bet)
Seat 6: PdIasPkzm2sqZnN41ZRXOg folded before Flop (didn't bet)
Seat 8: EQXHDnIzAsORnIXRNtXRlA (button) folded before Flop (didn't bet)




PokerStars Game #59941907534:  Hold'em No Limit ($0.10/$0.25) - 2009/07/01 1:49:58 ET
Table 'jxoHy9yJy0bbH/Qx73FoPA' 9-max Seat #7 is the button
Seat 1: j4q3p0lesp63b1gZDwLBZw ($6.95 in chips) 
Seat 2: F7pnn6czNpHvRM55XcA2EA ($45.50 in chips) 
Seat 3: CVqCt93Mk0MhKMaZ4LZDSQ ($9.30 in chips) 
Seat 4: bXpVeaSTPBFSPJmeXxO7nw ($4.65 in chips) 
Seat 7: wGigCmBR/9XWkPpvYos3aQ ($26.05 in chips) 
Seat 8: Z9W7+g1WMhhZDi7DwGbCFA ($5 in chips) 
Seat 9: CvL9Ch1HYCVbTsfpNucitg ($4.90 in chips) 
Z9W7+g1WMhhZDi7DwGbCFA: posts small blind $0.10
CvL9Ch1HYCVbTsfpNucitg: posts big blind $0.25
maracudja: sits out 
*** HOLE CARDS ***
j4q3p0lesp63b1gZDwLBZw: folds 
Z9AeOQX3yzuSvKAm/xyovg joins the table at seat #6 
F7pnn6czNpHvRM55XcA2EA: folds 
CVqCt93Mk0MhKMaZ4LZDSQ: folds 
bXpVeaSTPBFSPJmeXxO7nw: folds 
wGigCmBR/9XWkPpvYos3aQ: raises $0.65 to $0.90
Z9W7+g1WMhhZDi7DwGbCFA: folds 
CvL9Ch1HYCVbTsfpNucitg: folds 
Uncalled bet ($0.65) returned to wGigCmBR/9XWkPpvYos3aQ
wGigCmBR/9XWkPpvYos3aQ collected $0.60 from pot
wGigCmBR/9XWkPpvYos3aQ: doesn't show hand 
*** SUMMARY ***
Total pot $0.60 | Rake $0 
Seat 1: j4q3p0lesp63b1gZDwLBZw folded before Flop (didn't bet)
Seat 2: F7pnn6czNpHvRM55XcA2EA folded before Flop (didn't bet)
Seat 3: CVqCt93Mk0MhKMaZ4LZDSQ folded before Flop (didn't bet)
Seat 4: bXpVeaSTPBFSPJmeXxO7nw folded before Flop (didn't bet)
Seat 7: wGigCmBR/9XWkPpvYos3aQ (button) collected ($0.60)
Seat 8: Z9W7+g1WMhhZDi7DwGbCFA (small blind) folded before Flop
Seat 9: CvL9Ch1HYCVbTsfpNucitg (big blind) folded before Flop




PokerStars Game #59941907324:  Hold'em No Limit ($0.10/$0.25) - 2009/07/01 1:49:58 ET
Table 'xPn6TS/y/OWkX7Qa+MUuKA' 6-max Seat #6 is the button
Seat 1: JFIAqU8lCZ0vWwEl4bdGsg ($42.45 in chips) 
Seat 2: buyjetgNT1McXtdaP4zynA ($28.05 in chips) 
Seat 3: q6WfTUAD9mowIP63ASq2Dg ($24.15 in chips) 
Seat 4: SS/yfeArhULzIcOPe8MdPg ($28.65 in chips) 
Seat 5: lquriepNQBhDV5P1SWHhnA ($28.85 in chips) 
Seat 6: DihMHaz4WNETH1bPDe13kA ($25 in chips) 
JFIAqU8lCZ0vWwEl4bdGsg: posts small blind $0.10
buyjetgNT1McXtdaP4zynA: posts big blind $0.25
*** HOLE CARDS ***
q6WfTUAD9mowIP63ASq2Dg: folds 
SS/yfeArhULzIcOPe8MdPg: raises $0.75 to $1
lquriepNQBhDV5P1SWHhnA: folds 
DihMHaz4WNETH1bPDe13kA: folds 
JFIAqU8lCZ0vWwEl4bdGsg: folds 
buyjetgNT1McXtdaP4zynA: calls $0.75
*** FLOP *** [7s 8d Ac]
buyjetgNT1McXtdaP4zynA: bets $1.50
SS/yfeArhULzIcOPe8MdPg: calls $1.50
*** TURN *** [7s 8d Ac] [2s]
buyjetgNT1McXtdaP4zynA: bets $5
lquriepNQBhDV5P1SWHhnA leaves the table
SS/yfeArhULzIcOPe8MdPg: calls $5
*** RIVER *** [7s 8d Ac 2s] [5s]
buyjetgNT1McXtdaP4zynA: bets $20.55 and is all-in
SS/yfeArhULzIcOPe8MdPg said, "vnh"
Cmela joins the table at seat #5 
SS/yfeArhULzIcOPe8MdPg: folds 
Uncalled bet ($20.55) returned to buyjetgNT1McXtdaP4zynA
buyjetgNT1McXtdaP4zynA collected $14.40 from pot
buyjetgNT1McXtdaP4zynA: doesn't show hand 
*** SUMMARY ***
Total pot $15.10 | Rake $0.70 
Board [7s 8d Ac 2s 5s]
Seat 1: JFIAqU8lCZ0vWwEl4bdGsg (small blind) folded before Flop
Seat 2: buyjetgNT1McXtdaP4zynA (big blind) collected ($14.40)
Seat 3: q6WfTUAD9mowIP63ASq2Dg folded before Flop (didn't bet)
Seat 4: SS/yfeArhULzIcOPe8MdPg folded on the River
Seat 5: lquriepNQBhDV5P1SWHhnA folded before Flop (didn't bet)
Seat 6: DihMHaz4WNETH1bPDe13kA (button) folded before Flop (didn't bet)




PokerStars Game #59941907466:  Hold'em No Limit ($0.10/$0.25) - 2009/07/01 1:49:58 ET
Table 'aaXqTKUnxrX9DYXtxhWXxA' 6-max Seat #2 is the button
Seat 1: aSrj4lVmn2owyQ1RbbOqxQ ($27.40 in chips) 
Seat 2: DE9hRlt14g+JdsRQ4wT7hg ($32.75 in chips) 
Seat 3: uUXdcVMNa05rfbntdvplfw ($7.85 in chips) 
Seat 4: 48oT5xFI+5CHUJlfoGrE4w ($8.80 in chips) 
Seat 5: kyRaCIljYA6l33lSKQfNsg ($23.85 in chips) 
Seat 6: buyjetgNT1McXtdaP4zynA ($51.50 in chips) 
uUXdcVMNa05rfbntdvplfw: posts small blind $0.10
48oT5xFI+5CHUJlfoGrE4w: posts big blind $0.25
*** HOLE CARDS ***
kyRaCIljYA6l33lSKQfNsg: folds 
buyjetgNT1McXtdaP4zynA: folds 
aSrj4lVmn2owyQ1RbbOqxQ: raises $0.75 to $1
DE9hRlt14g+JdsRQ4wT7hg: folds 
uUXdcVMNa05rfbntdvplfw: folds 
48oT5xFI+5CHUJlfoGrE4w: calls $0.75
*** FLOP *** [Td 6h Jc]
48oT5xFI+5CHUJlfoGrE4w: checks 
aSrj4lVmn2owyQ1RbbOqxQ: checks 
*** TURN *** [Td 6h Jc] [2h]
48oT5xFI+5CHUJlfoGrE4w: checks 
aSrj4lVmn2owyQ1RbbOqxQ: bets $1.50
48oT5xFI+5CHUJlfoGrE4w: folds 
Uncalled bet ($1.50) returned to aSrj4lVmn2owyQ1RbbOqxQ
aSrj4lVmn2owyQ1RbbOqxQ collected $2 from pot
aSrj4lVmn2owyQ1RbbOqxQ: doesn't show hand 
*** SUMMARY ***
Total pot $2.10 | Rake $0.10 
Board [Td 6h Jc 2h]
Seat 1: aSrj4lVmn2owyQ1RbbOqxQ collected ($2)
Seat 2: DE9hRlt14g+JdsRQ4wT7hg (button) folded before Flop (didn't bet)
Seat 3: uUXdcVMNa05rfbntdvplfw (small blind) folded before Flop
Seat 4: 48oT5xFI+5CHUJlfoGrE4w (big blind) folded on the Turn
Seat 5: kyRaCIljYA6l33lSKQfNsg folded before Flop (didn't bet)
Seat 6: buyjetgNT1McXtdaP4zynA folded before Flop (didn't bet)




PokerStars Game #59941907138:  Hold'em No Limit ($0.10/$0.25) - 2009/07/01 1:49:58 ET
Table 'wPWRBZPJl1HAnysw7qRR0A' 6-max Seat #1 is the button
Seat 1: m7ne1MOFTQXlsXT7/R/rug ($12.15 in chips) 
Seat 2: xC0kaiDYM6YTlgODL83O5A ($22.75 in chips) 
Seat 3: 1ZpoLWO2nm2w1Nd1v9Sr3g ($3.60 in chips) 
Seat 4: epAUIB7h2FJXzUPRIvSkRA ($52.80 in chips) 
Seat 5: y0B+UpYpOUJz3JWtlJQBSA ($15.40 in chips) 
Seat 6: VXTONriS+Ohik+r0FeicIw ($25.60 in chips) 
xC0kaiDYM6YTlgODL83O5A: posts small blind $0.10
1ZpoLWO2nm2w1Nd1v9Sr3g: posts big blind $0.25
*** HOLE CARDS ***
epAUIB7h2FJXzUPRIvSkRA: raises $0.75 to $1
y0B+UpYpOUJz3JWtlJQBSA: folds 
VXTONriS+Ohik+r0FeicIw: folds 
m7ne1MOFTQXlsXT7/R/rug: folds 
xC0kaiDYM6YTlgODL83O5A: folds 
1ZpoLWO2nm2w1Nd1v9Sr3g: calls $0.75
*** FLOP *** [3h 2s Qs]
1ZpoLWO2nm2w1Nd1v9Sr3g: bets $2.60 and is all-in
epAUIB7h2FJXzUPRIvSkRA: calls $2.60
*** TURN *** [3h 2s Qs] [5d]
*** RIVER *** [3h 2s Qs 5d] [4d]
*** SHOW DOWN ***
1ZpoLWO2nm2w1Nd1v9Sr3g: shows [8d Ah] (a straight, Ace to Five)
epAUIB7h2FJXzUPRIvSkRA: mucks hand 
1ZpoLWO2nm2w1Nd1v9Sr3g collected $6.95 from pot
*** SUMMARY ***
Total pot $7.30 | Rake $0.35 
Board [3h 2s Qs 5d 4d]
Seat 1: m7ne1MOFTQXlsXT7/R/rug (button) folded before Flop (didn't bet)
Seat 2: xC0kaiDYM6YTlgODL83O5A (small blind) folded before Flop
Seat 3: 1ZpoLWO2nm2w1Nd1v9Sr3g (big blind) showed [8d Ah] and won ($6.95) with a straight, Ace to Five
Seat 4: epAUIB7h2FJXzUPRIvSkRA mucked
Seat 5: y0B+UpYpOUJz3JWtlJQBSA folded before Flop (didn't bet)
Seat 6: VXTONriS+Ohik+r0FeicIw folded before Flop (didn't bet)




PokerStars Game #59941907310:  Hold'em No Limit ($0.10/$0.25) - 2009/07/01 1:49:58 ET
Table 'MRfAiS/4JSfnUDlCcZo0wAhfHe8uKeSJMyWAjSdM7ROQx Seat #1 is the button
Seat 1: 48oT5xFI+5CHUJlfoGrE4w ($29.55 in chips) 
Seat 2: /gJNBeCkWL4o85/jvlZ4BA ($26.10 in chips) 
Seat 4: b4wRQV3APH8irVk6bUFe2Q ($36.95 in chips) 
Seat 5: Q1uciOZPBR/WkAlqa6cL4A ($27.85 in chips) 
Seat 6: df01R5ThvHspD8FgKmaDvQ ($25 in chips) 
/gJNBeCkWL4o85/jvlZ4BA: posts small blind $0.10
FYepjhAvF8ZdVCmqHIy+eQ: is sitting out 
b4wRQV3APH8irVk6bUFe2Q: posts big blind $0.25
*** HOLE CARDS ***
FYepjhAvF8ZdVCmqHIy+eQ leaves the table
Q1uciOZPBR/WkAlqa6cL4A: folds 
df01R5ThvHspD8FgKmaDvQ: folds 
48oT5xFI+5CHUJlfoGrE4w: folds 
/gJNBeCkWL4o85/jvlZ4BA: calls $0.15
b4wRQV3APH8irVk6bUFe2Q: checks 
*** FLOP *** [9h 8h 5d]
/gJNBeCkWL4o85/jvlZ4BA: checks 
b4wRQV3APH8irVk6bUFe2Q: bets $0.25
/gJNBeCkWL4o85/jvlZ4BA: folds 
Uncalled bet ($0.25) returned to b4wRQV3APH8irVk6bUFe2Q
b4wRQV3APH8irVk6bUFe2Q collected $0.50 from pot
*** SUMMARY ***
Total pot $0.50 | Rake $0 
Board [9h 8h 5d]
Seat 1: 48oT5xFI+5CHUJlfoGrE4w (button) folded before Flop (didn't bet)
Seat 2: /gJNBeCkWL4o85/jvlZ4BA (small blind) folded on the Flop
Seat 4: b4wRQV3APH8irVk6bUFe2Q (big blind) collected ($0.50)
Seat 5: Q1uciOZPBR/WkAlqa6cL4A folded before Flop (didn't bet)
Seat 6: df01R5ThvHspD8FgKmaDvQ folded before Flop (didn't bet)




PokerStars Game #59941907452:  Hold'em No Limit ($0.10/$0.25) - 2009/07/01 1:49:58 ET
Table 'MiquQrQZJJq9ZtgRIp9HFQ' 6-max Seat #4 is the button
Seat 1: c3J/KYZ4cNsUEuz8v57I5A ($24.65 in chips) 
Seat 3: 9h7TNZ1TDGRUJXA6rI+ZTw ($9.75 in chips) 
Seat 4: wAKC8C/zN0c8V5v13dm9mA ($51.55 in chips) 
Seat 5: iyZxqznXjv3vtvOJymkoLQ ($26.50 in chips) 
Seat 6: GbCVUNssQ7mqsPWr7J4d3w ($4.65 in chips) 
iyZxqznXjv3vtvOJymkoLQ: posts small blind $0.10
GbCVUNssQ7mqsPWr7J4d3w: posts big blind $0.25
*** HOLE CARDS ***
c3J/KYZ4cNsUEuz8v57I5A: folds 
2+6voGl1T1DO63JePptI3g has returned
9h7TNZ1TDGRUJXA6rI+ZTw: folds 
wAKC8C/zN0c8V5v13dm9mA: folds 
iyZxqznXjv3vtvOJymkoLQ: folds 
Uncalled bet ($0.15) returned to GbCVUNssQ7mqsPWr7J4d3w
GbCVUNssQ7mqsPWr7J4d3w collected $0.20 from pot
GbCVUNssQ7mqsPWr7J4d3w: doesn't show hand 
*** SUMMARY ***
Total pot $0.20 | Rake $0 
Seat 1: c3J/KYZ4cNsUEuz8v57I5A folded before Flop (didn't bet)
Seat 3: 9h7TNZ1TDGRUJXA6rI+ZTw folded before Flop (didn't bet)
Seat 4: wAKC8C/zN0c8V5v13dm9mA (button) folded before Flop (didn't bet)
Seat 5: iyZxqznXjv3vtvOJymkoLQ (small blind) folded before Flop
Seat 6: GbCVUNssQ7mqsPWr7J4d3w (big blind) collected ($0.20)




PokerStars Game #59941907370:  Hold'em No Limit ($0.10/$0.25) - 2009/07/01 1:49:58 ET
Table 'nXVbUw6/HYwA6x21+IZ3XQ' 9-max Seat #6 is the button
Seat 1: zDrucyjVn5aeekNEc3cJrA ($17.35 in chips) 
Seat 2: 9lvO/qyU+xrU95Teu1fv0g ($10.25 in chips) 
Seat 3: MB0wa15P+9QHcBApEdgQFw ($11.60 in chips) 
Seat 4: SpiiQQAzy4MUgV3I5W8giw ($24.65 in chips) 
Seat 5: M/9j4wkHH9i1JM51vgi1VA ($31.60 in chips) 
Seat 6: ljemhp25Zg+nlA9DLCIiUw ($26.85 in chips) 
Seat 7: ShCS62CJp4MKfKLKvGKQbA ($11.35 in chips) 
Seat 8: dfNim92Z6XK1/h5SFW5vDg ($25 in chips) 
Seat 9: OTCjTlu92MEBtX/i9Gm7yA ($9.60 in chips) 
ShCS62CJp4MKfKLKvGKQbA: posts small blind $0.10
dfNim92Z6XK1/h5SFW5vDg: posts big blind $0.25
*** HOLE CARDS ***
OTCjTlu92MEBtX/i9Gm7yA: folds 
zDrucyjVn5aeekNEc3cJrA: folds 
9lvO/qyU+xrU95Teu1fv0g: folds 
MB0wa15P+9QHcBApEdgQFw: calls $0.25
SpiiQQAzy4MUgV3I5W8giw: folds 
M/9j4wkHH9i1JM51vgi1VA: folds 
ljemhp25Zg+nlA9DLCIiUw: folds 
ShCS62CJp4MKfKLKvGKQbA: calls $0.15
dfNim92Z6XK1/h5SFW5vDg: checks 
*** FLOP *** [8d 8h Ks]
ShCS62CJp4MKfKLKvGKQbA: checks 
dfNim92Z6XK1/h5SFW5vDg: checks 
MB0wa15P+9QHcBApEdgQFw: checks 
*** TURN *** [8d 8h Ks] [6h]
ShCS62CJp4MKfKLKvGKQbA: bets $0.25
dfNim92Z6XK1/h5SFW5vDg: folds 
MB0wa15P+9QHcBApEdgQFw: folds 
Uncalled bet ($0.25) returned to ShCS62CJp4MKfKLKvGKQbA
ShCS62CJp4MKfKLKvGKQbA collected $0.75 from pot
ShCS62CJp4MKfKLKvGKQbA: doesn't show hand 
*** SUMMARY ***
Total pot $0.75 | Rake $0 
Board [8d 8h Ks 6h]
Seat 1: zDrucyjVn5aeekNEc3cJrA folded before Flop (didn't bet)
Seat 2: 9lvO/qyU+xrU95Teu1fv0g folded before Flop (didn't bet)
Seat 3: MB0wa15P+9QHcBApEdgQFw folded on the Turn
Seat 4: SpiiQQAzy4MUgV3I5W8giw folded before Flop (didn't bet)
Seat 5: M/9j4wkHH9i1JM51vgi1VA folded before Flop (didn't bet)
Seat 6: ljemhp25Zg+nlA9DLCIiUw (button) folded before Flop (didn't bet)
Seat 7: ShCS62CJp4MKfKLKvGKQbA (small blind) collected ($0.75)
Seat 8: dfNim92Z6XK1/h5SFW5vDg (big blind) folded on the Turn
Seat 9: OTCjTlu92MEBtX/i9Gm7yA folded before Flop (didn't bet)




PokerStars Game #59941907304:  Hold'em No Limit ($0.10/$0.25) - 2009/07/01 1:49:58 ET
Table 'bIGKmJgZehWJ+FAo8b85iw' 9-max Seat #6 is the button
Seat 1: yyG4svzOpC1A+sUP/scg6w ($7.50 in chips) 
Seat 2: cCjRCvseA9rZn7Xr+GCCHg ($25.80 in chips) 
Seat 3: /FyMUX+W/tpNFcRWbUTJxQ ($23.50 in chips) 
Seat 4: LGxBRjCRn6KlQ/6B4eoXbA ($35.55 in chips) 
Seat 5: uLP/lYn7oKq9xCChBXsXxw ($24.65 in chips) 
Seat 6: PFNLAvMkr8qKc7xCiH0wTA ($19.90 in chips) 
Seat 7: mMd8CDS/but3UC+Zp7Up2w ($19.75 in chips) 
Seat 8: +2kMBNpY4nF1qNCRd8SJLA ($54.20 in chips) 
Seat 9: aNpwfA31EREwO+ar4XzBCw ($31.75 in chips) 
mMd8CDS/but3UC+Zp7Up2w: posts small blind $0.10
+2kMBNpY4nF1qNCRd8SJLA: posts big blind $0.25
*** HOLE CARDS ***
aNpwfA31EREwO+ar4XzBCw: calls $0.25
yyG4svzOpC1A+sUP/scg6w: folds 
cCjRCvseA9rZn7Xr+GCCHg: folds 
/FyMUX+W/tpNFcRWbUTJxQ: folds 
LGxBRjCRn6KlQ/6B4eoXbA: raises $1 to $1.25
uLP/lYn7oKq9xCChBXsXxw: folds 
PFNLAvMkr8qKc7xCiH0wTA: folds 
mMd8CDS/but3UC+Zp7Up2w: folds 
+2kMBNpY4nF1qNCRd8SJLA: folds 
aNpwfA31EREwO+ar4XzBCw: folds 
Uncalled bet ($1) returned to LGxBRjCRn6KlQ/6B4eoXbA
LGxBRjCRn6KlQ/6B4eoXbA collected $0.85 from pot
LGxBRjCRn6KlQ/6B4eoXbA: doesn't show hand 
*** SUMMARY ***
Total pot $0.85 | Rake $0 
Seat 1: yyG4svzOpC1A+sUP/scg6w folded before Flop (didn't bet)
Seat 2: cCjRCvseA9rZn7Xr+GCCHg folded before Flop (didn't bet)
Seat 3: /FyMUX+W/tpNFcRWbUTJxQ folded before Flop (didn't bet)
Seat 4: LGxBRjCRn6KlQ/6B4eoXbA collected ($0.85)
Seat 5: uLP/lYn7oKq9xCChBXsXxw folded before Flop (didn't bet)
Seat 6: PFNLAvMkr8qKc7xCiH0wTA (button) folded before Flop (didn't bet)
Seat 7: mMd8CDS/but3UC+Zp7Up2w (small blind) folded before Flop
Seat 8: +2kMBNpY4nF1qNCRd8SJLA (big blind) folded before Flop
Seat 9: aNpwfA31EREwO+ar4XzBCw folded before Flop




PokerStars Game #59941907174:  Hold'em No Limit ($0.10/$0.25) - 2009/07/01 1:49:58 ET
Table '6aL2C8IFwHHr6SG6RgXaow' 9-max Seat #3 is the button
Seat 1: FcL757vvzKRPFZ6h7YsPHA ($10.20 in chips) 
Seat 2: UmzixCpC0bAc1lDEjgB3NQ ($14.70 in chips) 
Seat 3: clJsV3v77RS07bDKY+705w ($5 in chips) 
Seat 4: BT6Oal0iO4P6kDuT7HFQDw ($19.40 in chips) 
Seat 5: wre31HfyzQGpIvID1istxw ($21.20 in chips) 
Seat 6: gehe91e0IyVT0QU/XBkEyg ($26.75 in chips) 
Seat 7: E0iYnEVO2ho7dH3QcCjw7g ($19.75 in chips) 
Seat 8: rQhYIYXSyH/IivYM1dlV5A ($21.95 in chips) 
Seat 9: CgIo2ItZqi4o3ayVG6HanQ ($23.75 in chips) 
BT6Oal0iO4P6kDuT7HFQDw: posts small blind $0.10
wre31HfyzQGpIvID1istxw: posts big blind $0.25
FcL757vvzKRPFZ6h7YsPHA: posts big blind $0.25
UmzixCpC0bAc1lDEjgB3NQ: posts small & big blinds $0.35
*** HOLE CARDS ***
gehe91e0IyVT0QU/XBkEyg: calls $0.25
E0iYnEVO2ho7dH3QcCjw7g: folds 
rQhYIYXSyH/IivYM1dlV5A: folds 
CgIo2ItZqi4o3ayVG6HanQ: calls $0.25
FcL757vvzKRPFZ6h7YsPHA: checks 
UmzixCpC0bAc1lDEjgB3NQ: checks 
clJsV3v77RS07bDKY+705w: folds 
BT6Oal0iO4P6kDuT7HFQDw: calls $0.15
wre31HfyzQGpIvID1istxw: raises $0.75 to $1
gehe91e0IyVT0QU/XBkEyg: folds 
CgIo2ItZqi4o3ayVG6HanQ: folds 
FcL757vvzKRPFZ6h7YsPHA: folds 
UmzixCpC0bAc1lDEjgB3NQ: calls $0.75
BT6Oal0iO4P6kDuT7HFQDw: folds 
*** FLOP *** [8d 8s 2h]
wre31HfyzQGpIvID1istxw: bets $2.50
UmzixCpC0bAc1lDEjgB3NQ: folds 
Uncalled bet ($2.50) returned to wre31HfyzQGpIvID1istxw
wre31HfyzQGpIvID1istxw collected $2.95 from pot
wre31HfyzQGpIvID1istxw: doesn't show hand 
*** SUMMARY ***
Total pot $3.10 | Rake $0.15 
Board [8d 8s 2h]
Seat 1: FcL757vvzKRPFZ6h7YsPHA folded before Flop
Seat 2: UmzixCpC0bAc1lDEjgB3NQ folded on the Flop
Seat 3: clJsV3v77RS07bDKY+705w (button) folded before Flop (didn't bet)
Seat 4: BT6Oal0iO4P6kDuT7HFQDw (small blind) folded before Flop
Seat 5: wre31HfyzQGpIvID1istxw (big blind) collected ($2.95)
Seat 6: gehe91e0IyVT0QU/XBkEyg folded before Flop
Seat 7: E0iYnEVO2ho7dH3QcCjw7g folded before Flop (didn't bet)
Seat 8: rQhYIYXSyH/IivYM1dlV5A folded before Flop (didn't bet)
Seat 9: CgIo2ItZqi4o3ayVG6HanQ folded before Flop




PokerStars Game #59941907832:  Hold'em No Limit ($0.10/$0.25) - 2009/07/01 1:49:59 ET
Table 'YYMg5qzxK1m9eGRo4SbxtQ' 9-max Seat #6 is the button
Seat 1: 3PmVnC/15cl4oyI1TKIt4g ($5 in chips) 
Seat 2: f/H6PsHRl4W1JyNsEDvPtg ($15.10 in chips) 
Seat 3: eK8qa6EPcH2zhtbmWSvc9g ($25.25 in chips) 
Seat 4: ROxrieegd9WYtWcUKJAlbg ($10.75 in chips) 
Seat 5: 4awUyiDYTgylQKXZ9faBVA ($25 in chips) 
Seat 6: S5VeQLgBIiHrfs9AB2vBwA ($2.20 in chips) 
Seat 7: sUVgUtgbfVx6JpvApozwhQ ($7.55 in chips) 
Seat 8: xoBFd/5k+L/pFn9VW1VyWg ($14.20 in chips) 
Seat 9: +sbyWwIcFp9kP0bDtMegfQ ($31.60 in chips) 
sUVgUtgbfVx6JpvApozwhQ: posts small blind $0.10
xoBFd/5k+L/pFn9VW1VyWg: posts big blind $0.25
*** HOLE CARDS ***
+sbyWwIcFp9kP0bDtMegfQ: folds 
3PmVnC/15cl4oyI1TKIt4g: folds 
f/H6PsHRl4W1JyNsEDvPtg: raises $0.25 to $0.50
eK8qa6EPcH2zhtbmWSvc9g: folds 
ROxrieegd9WYtWcUKJAlbg: calls $0.50
4awUyiDYTgylQKXZ9faBVA: folds 
S5VeQLgBIiHrfs9AB2vBwA: calls $0.50
sUVgUtgbfVx6JpvApozwhQ: folds 
xoBFd/5k+L/pFn9VW1VyWg: calls $0.25
*** FLOP *** [5h Qh 7c]
xoBFd/5k+L/pFn9VW1VyWg: checks 
f/H6PsHRl4W1JyNsEDvPtg: checks 
ROxrieegd9WYtWcUKJAlbg: checks 
S5VeQLgBIiHrfs9AB2vBwA: bets $1
xoBFd/5k+L/pFn9VW1VyWg: folds 
f/H6PsHRl4W1JyNsEDvPtg: folds 
ROxrieegd9WYtWcUKJAlbg: folds 
Uncalled bet ($1) returned to S5VeQLgBIiHrfs9AB2vBwA
S5VeQLgBIiHrfs9AB2vBwA collected $2 from pot
S5VeQLgBIiHrfs9AB2vBwA: doesn't show hand 
*** SUMMARY ***
Total pot $2.10 | Rake $0.10 
Board [5h Qh 7c]
Seat 1: 3PmVnC/15cl4oyI1TKIt4g folded before Flop (didn't bet)
Seat 2: f/H6PsHRl4W1JyNsEDvPtg folded on the Flop
Seat 3: eK8qa6EPcH2zhtbmWSvc9g folded before Flop (didn't bet)
Seat 4: ROxrieegd9WYtWcUKJAlbg folded on the Flop
Seat 5: 4awUyiDYTgylQKXZ9faBVA folded before Flop (didn't bet)
Seat 6: S5VeQLgBIiHrfs9AB2vBwA (button) collected ($2)
Seat 7: sUVgUtgbfVx6JpvApozwhQ (small blind) folded before Flop
Seat 8: xoBFd/5k+L/pFn9VW1VyWg (big blind) folded on the Flop
Seat 9: +sbyWwIcFp9kP0bDtMegfQ folded before Flop (didn't bet)




PokerStars Game #59941908058:  Hold'em No Limit ($0.10/$0.25) - 2009/07/01 1:49:59 ET
Table 'Utmw+yX+E/wdhNDIim90lQ' 9-max Seat #7 is the button
Seat 1: cZ99hugmLBj9KhTlc8nCSw ($31.95 in chips) 
Seat 2: iGMlK+EhUflPB6jKQd95Cg ($27.35 in chips) 
Seat 3: dfNim92Z6XK1/h5SFW5vDg ($25 in chips) 
Seat 4: ifYGvZDHQQ0aam4awTtHwA ($29.25 in chips) 
Seat 5: ghNKXUBl/H+t83JF079ZBA ($25 in chips) 
Seat 6: OlPJsgR4xypSg/w1z7Gyvw ($33.15 in chips) 
Seat 7: CImUHesK+ZER4v/VCA9IUg ($49.45 in chips) 
Seat 8: Mh2r9hTeTEDnh19sRZtW3g ($4.75 in chips) 
Seat 9: Th3FldXKQW6hWVVPahaoOQ ($27.50 in chips) 
Mh2r9hTeTEDnh19sRZtW3g: posts small blind $0.10
Th3FldXKQW6hWVVPahaoOQ: posts big blind $0.25
*** HOLE CARDS ***
cZ99hugmLBj9KhTlc8nCSw: folds 
iGMlK+EhUflPB6jKQd95Cg: folds 
dfNim92Z6XK1/h5SFW5vDg: folds 
ifYGvZDHQQ0aam4awTtHwA: folds 
ifYGvZDHQQ0aam4awTtHwA leaves the table
bXpVeaSTPBFSPJmeXxO7nw joins the table at seat #4 
ghNKXUBl/H+t83JF079ZBA: raises $0.75 to $1
OlPJsgR4xypSg/w1z7Gyvw: folds 
CImUHesK+ZER4v/VCA9IUg: calls $1
Mh2r9hTeTEDnh19sRZtW3g: folds 
Th3FldXKQW6hWVVPahaoOQ: folds 
*** FLOP *** [Ac 2h 9d]
ghNKXUBl/H+t83JF079ZBA: bets $1.50
CImUHesK+ZER4v/VCA9IUg: folds 
Uncalled bet ($1.50) returned to ghNKXUBl/H+t83JF079ZBA
ghNKXUBl/H+t83JF079ZBA collected $2.25 from pot
ghNKXUBl/H+t83JF079ZBA: doesn't show hand 
*** SUMMARY ***
Total pot $2.35 | Rake $0.10 
Board [Ac 2h 9d]
Seat 1: cZ99hugmLBj9KhTlc8nCSw folded before Flop (didn't bet)
Seat 2: iGMlK+EhUflPB6jKQd95Cg folded before Flop (didn't bet)
Seat 3: dfNim92Z6XK1/h5SFW5vDg folded before Flop (didn't bet)
Seat 4: ifYGvZDHQQ0aam4awTtHwA folded before Flop (didn't bet)
Seat 5: ghNKXUBl/H+t83JF079ZBA collected ($2.25)
Seat 6: OlPJsgR4xypSg/w1z7Gyvw folded before Flop (didn't bet)
Seat 7: CImUHesK+ZER4v/VCA9IUg (button) folded on the Flop
Seat 8: Mh2r9hTeTEDnh19sRZtW3g (small blind) folded before Flop
Seat 9: Th3FldXKQW6hWVVPahaoOQ (big blind) folded before Flop




PokerStars Game #59941907606:  Hold'em No Limit ($0.10/$0.25) - 2009/07/01 1:49:59 ET
Table 'b64Z+5XI1xkQzNfq4QHr3A' 6-max Seat #6 is the button
Seat 2: A6SjYLoKeIpFjPq0BK/2WA ($14.25 in chips) 
Seat 3: 7cx44/slbeTw+Cy7QB8Trg ($24.75 in chips) 
Seat 4: 564zqq2DUHXR3tdsOJU6JA ($16.90 in chips) 
Seat 5: JFIAqU8lCZ0vWwEl4bdGsg ($57.75 in chips) 
Seat 6: 8ClCHtFXGNplITm+63KB+Q ($31.50 in chips) 
A6SjYLoKeIpFjPq0BK/2WA: posts small blind $0.10
7cx44/slbeTw+Cy7QB8Trg: posts big blind $0.25
*** HOLE CARDS ***
564zqq2DUHXR3tdsOJU6JA: folds 
JFIAqU8lCZ0vWwEl4bdGsg: folds 
8ClCHtFXGNplITm+63KB+Q: folds 
A6SjYLoKeIpFjPq0BK/2WA: calls $0.15
7cx44/slbeTw+Cy7QB8Trg: raises $0.75 to $1
A6SjYLoKeIpFjPq0BK/2WA: folds 
Uncalled bet ($0.75) returned to 7cx44/slbeTw+Cy7QB8Trg
7cx44/slbeTw+Cy7QB8Trg collected $0.50 from pot
7cx44/slbeTw+Cy7QB8Trg: doesn't show hand 
*** SUMMARY ***
Total pot $0.50 | Rake $0 
Seat 2: A6SjYLoKeIpFjPq0BK/2WA (small blind) folded before Flop
Seat 3: 7cx44/slbeTw+Cy7QB8Trg (big blind) collected ($0.50)
Seat 4: 564zqq2DUHXR3tdsOJU6JA folded before Flop (didn't bet)
Seat 5: JFIAqU8lCZ0vWwEl4bdGsg folded before Flop (didn't bet)
Seat 6: 8ClCHtFXGNplITm+63KB+Q (button) folded before Flop (didn't bet)




PokerStars Game #59941907770:  Hold'em No Limit ($0.10/$0.25) - 2009/07/01 1:49:59 ET
Table 'KU/HrxqxwDz8HKEhYTZ6uw' 6-max Seat #3 is the button
Seat 1: 7LKoiQHXpTQXJvWQrw907g ($36.35 in chips) 
Seat 2: kG34n23qFQA3nzdOJTQ1dA ($24.30 in chips) 
Seat 3: SFmT9ZsVopnukjvAzrxTRg ($26.10 in chips) 
Seat 5: iyZxqznXjv3vtvOJymkoLQ ($52.45 in chips) 
Seat 6: qWxkCeqApAWdAA0evrfDvQ ($10.50 in chips) 
iyZxqznXjv3vtvOJymkoLQ: posts small blind $0.10
qWxkCeqApAWdAA0evrfDvQ: posts big blind $0.25
*** HOLE CARDS ***
7LKoiQHXpTQXJvWQrw907g: calls $0.25
kG34n23qFQA3nzdOJTQ1dA: folds 
SFmT9ZsVopnukjvAzrxTRg: folds 
iyZxqznXjv3vtvOJymkoLQ: folds 
qWxkCeqApAWdAA0evrfDvQ: checks 
*** FLOP *** [8h 7c Ad]
qWxkCeqApAWdAA0evrfDvQ: checks 
7LKoiQHXpTQXJvWQrw907g: checks 
*** TURN *** [8h 7c Ad] [3d]
qWxkCeqApAWdAA0evrfDvQ: checks 
7LKoiQHXpTQXJvWQrw907g: bets $0.50
qWxkCeqApAWdAA0evrfDvQ: folds 
Uncalled bet ($0.50) returned to 7LKoiQHXpTQXJvWQrw907g
7LKoiQHXpTQXJvWQrw907g collected $0.60 from pot
*** SUMMARY ***
Total pot $0.60 | Rake $0 
Board [8h 7c Ad 3d]
Seat 1: 7LKoiQHXpTQXJvWQrw907g collected ($0.60)
Seat 2: kG34n23qFQA3nzdOJTQ1dA folded before Flop (didn't bet)
Seat 3: SFmT9ZsVopnukjvAzrxTRg (button) folded before Flop (didn't bet)
Seat 5: iyZxqznXjv3vtvOJymkoLQ (small blind) folded before Flop
Seat 6: qWxkCeqApAWdAA0evrfDvQ (big blind) folded on the Turn




PokerStars Game #59941907680:  Hold'em No Limit ($0.10/$0.25) - 2009/07/01 1:49:59 ET
Table 'M8kYidAX3ib7pLKW7edFLw' 6-max Seat #6 is the button
Seat 1: jp34e617tIzV8tKIWmfAbA ($26.40 in chips) 
Seat 2: ypmjhffk/YHGc51wgVXUTw ($25 in chips) 
Seat 3: cezpHJ8FB07dj0xG+LhOvw ($26.15 in chips) 
Seat 4: Hsvkc0/G2VV78oVmWYXecw ($6.25 in chips) 
Seat 6: NqFoyDgzLwu4dOmSRXnFBA ($23.50 in chips) 
jp34e617tIzV8tKIWmfAbA: posts small blind $0.10
ypmjhffk/YHGc51wgVXUTw: posts big blind $0.25
*** HOLE CARDS ***
cezpHJ8FB07dj0xG+LhOvw: raises $0.75 to $1
Hsvkc0/G2VV78oVmWYXecw: folds 
NqFoyDgzLwu4dOmSRXnFBA: calls $1
jp34e617tIzV8tKIWmfAbA: folds 
ypmjhffk/YHGc51wgVXUTw: folds 
*** FLOP *** [8h 9c Td]
GbCVUNssQ7mqsPWr7J4d3w joins the table at seat #5 
cezpHJ8FB07dj0xG+LhOvw: bets $2
NqFoyDgzLwu4dOmSRXnFBA: folds 
Uncalled bet ($2) returned to cezpHJ8FB07dj0xG+LhOvw
cezpHJ8FB07dj0xG+LhOvw collected $2.25 from pot
*** SUMMARY ***
Total pot $2.35 | Rake $0.10 
Board [8h 9c Td]
Seat 1: jp34e617tIzV8tKIWmfAbA (small blind) folded before Flop
Seat 2: ypmjhffk/YHGc51wgVXUTw (big blind) folded before Flop
Seat 3: cezpHJ8FB07dj0xG+LhOvw collected ($2.25)
Seat 4: Hsvkc0/G2VV78oVmWYXecw folded before Flop (didn't bet)
Seat 6: NqFoyDgzLwu4dOmSRXnFBA (button) folded on the Flop




PokerStars Game #59941907622:  Hold'em No Limit ($0.10/$0.25) - 2009/07/01 1:49:59 ET
Table 'wGizWOswEL6P5QrvVkno/g' 6-max Seat #1 is the button
Seat 1: Qbfkn+ucISvbd1Xh32zAGA ($31 in chips) 
Seat 2: mfrkWA3PTeYPkbO6hi98Aw ($28.50 in chips) 
Seat 3: i9LqF5rD3bvtbEE7HWgr3Q ($25 in chips) 
Seat 4: yF9xHMEAvA+7Gn+eDkuVIg ($2.40 in chips) 
Seat 5: w43JQj2oYPpKQVG4Yzlq1w ($25 in chips) 
Seat 6: BuAE7g7dRfuqGPmQDlGyGg ($20.90 in chips) 
mfrkWA3PTeYPkbO6hi98Aw: posts small blind $0.10
i9LqF5rD3bvtbEE7HWgr3Q: posts big blind $0.25
*** HOLE CARDS ***
yF9xHMEAvA+7Gn+eDkuVIg: folds 
w43JQj2oYPpKQVG4Yzlq1w: folds 
BuAE7g7dRfuqGPmQDlGyGg: raises $0.65 to $0.90
Qbfkn+ucISvbd1Xh32zAGA: raises $1.60 to $2.50
mfrkWA3PTeYPkbO6hi98Aw: folds 
i9LqF5rD3bvtbEE7HWgr3Q: folds 
BuAE7g7dRfuqGPmQDlGyGg: calls $1.60
*** FLOP *** [2c Qs 9d]
BuAE7g7dRfuqGPmQDlGyGg: checks 
Qbfkn+ucISvbd1Xh32zAGA: bets $3
BuAE7g7dRfuqGPmQDlGyGg: folds 
Uncalled bet ($3) returned to Qbfkn+ucISvbd1Xh32zAGA
Qbfkn+ucISvbd1Xh32zAGA collected $5.10 from pot
Qbfkn+ucISvbd1Xh32zAGA: doesn't show hand 
*** SUMMARY ***
Total pot $5.35 | Rake $0.25 
Board [2c Qs 9d]
Seat 1: Qbfkn+ucISvbd1Xh32zAGA (button) collected ($5.10)
Seat 2: mfrkWA3PTeYPkbO6hi98Aw (small blind) folded before Flop
Seat 3: i9LqF5rD3bvtbEE7HWgr3Q (big blind) folded before Flop
Seat 4: yF9xHMEAvA+7Gn+eDkuVIg folded before Flop (didn't bet)
Seat 5: w43JQj2oYPpKQVG4Yzlq1w folded before Flop (didn't bet)
Seat 6: BuAE7g7dRfuqGPmQDlGyGg folded on the Flop




PokerStars Game #59941907700:  Hold'em No Limit ($0.10/$0.25) - 2009/07/01 1:49:59 ET
Table 'IRgQPZVA4+IaZZIQshgwyg' 6-max Seat #4 is the button
Seat 1: cezpHJ8FB07dj0xG+LhOvw ($27.55 in chips) 
Seat 2: lquriepNQBhDV5P1SWHhnA ($28.70 in chips) 
Seat 3: DihMHaz4WNETH1bPDe13kA ($27.45 in chips) 
Seat 4: DE9hRlt14g+JdsRQ4wT7hg ($25.60 in chips) 
Seat 5: w43JQj2oYPpKQVG4Yzlq1w ($25.10 in chips) 
Seat 6: x9/USY6PsmgUGQeluFLKDw ($21.30 in chips) 
w43JQj2oYPpKQVG4Yzlq1w: posts small blind $0.10
x9/USY6PsmgUGQeluFLKDw: posts big blind $0.25
*** HOLE CARDS ***
cezpHJ8FB07dj0xG+LhOvw: folds 
lquriepNQBhDV5P1SWHhnA: folds 
DihMHaz4WNETH1bPDe13kA: folds 
DE9hRlt14g+JdsRQ4wT7hg: raises $0.75 to $1
w43JQj2oYPpKQVG4Yzlq1w: raises $2 to $3
x9/USY6PsmgUGQeluFLKDw: folds 
DE9hRlt14g+JdsRQ4wT7hg: calls $2
*** FLOP *** [6h Js 9d]
lquriepNQBhDV5P1SWHhnA leaves the table
w43JQj2oYPpKQVG4Yzlq1w: bets $3.50
DE9hRlt14g+JdsRQ4wT7hg: folds 
Uncalled bet ($3.50) returned to w43JQj2oYPpKQVG4Yzlq1w
w43JQj2oYPpKQVG4Yzlq1w collected $5.95 from pot
w43JQj2oYPpKQVG4Yzlq1w: doesn't show hand 
*** SUMMARY ***
Total pot $6.25 | Rake $0.30 
Board [6h Js 9d]
Seat 1: cezpHJ8FB07dj0xG+LhOvw folded before Flop (didn't bet)
Seat 2: lquriepNQBhDV5P1SWHhnA folded before Flop (didn't bet)
Seat 3: DihMHaz4WNETH1bPDe13kA folded before Flop (didn't bet)
Seat 4: DE9hRlt14g+JdsRQ4wT7hg (button) folded on the Flop
Seat 5: w43JQj2oYPpKQVG4Yzlq1w (small blind) collected ($5.95)
Seat 6: x9/USY6PsmgUGQeluFLKDw (big blind) folded before Flop




PokerStars Game #59941908220:  Hold'em No Limit ($0.10/$0.25) - 2009/07/01 1:50:00 ET
Table 'emoxgHTxg9Uqeu06oLzLyg' 6-max Seat #5 is the button
Seat 1: epAUIB7h2FJXzUPRIvSkRA ($25 in chips) 
Seat 2: wIFhgE1PVdX6Xf6aVlSTPg ($28.20 in chips) 
Seat 3: uD5epdBxuyc30pF1dO958Q ($9.65 in chips) 
Seat 4: 3VAbqAWh8ncE2SJOYIx2ZQ ($15.90 in chips) 
Seat 5: OIjOiBfQstWrK/RuXx7zcw ($7.85 in chips) 
Seat 6: u3Ol7kv1LmvszuHNm9rc6w ($19 in chips) 
u3Ol7kv1LmvszuHNm9rc6w: posts small blind $0.10
epAUIB7h2FJXzUPRIvSkRA: posts big blind $0.25
*** HOLE CARDS ***
wIFhgE1PVdX6Xf6aVlSTPg: raises $0.65 to $0.90
uD5epdBxuyc30pF1dO958Q: folds 
3VAbqAWh8ncE2SJOYIx2ZQ: folds 
OIjOiBfQstWrK/RuXx7zcw: folds 
u3Ol7kv1LmvszuHNm9rc6w: folds 
epAUIB7h2FJXzUPRIvSkRA: folds 
Uncalled bet ($0.65) returned to wIFhgE1PVdX6Xf6aVlSTPg
wIFhgE1PVdX6Xf6aVlSTPg collected $0.60 from pot
wIFhgE1PVdX6Xf6aVlSTPg: doesn't show hand 
*** SUMMARY ***
Total pot $0.60 | Rake $0 
Seat 1: epAUIB7h2FJXzUPRIvSkRA (big blind) folded before Flop
Seat 2: wIFhgE1PVdX6Xf6aVlSTPg collected ($0.60)
Seat 3: uD5epdBxuyc30pF1dO958Q folded before Flop (didn't bet)
Seat 4: 3VAbqAWh8ncE2SJOYIx2ZQ folded before Flop (didn't bet)
Seat 5: OIjOiBfQstWrK/RuXx7zcw (button) folded before Flop (didn't bet)
Seat 6: u3Ol7kv1LmvszuHNm9rc6w (small blind) folded before Flop




PokerStars Game #59941908358:  Hold'em No Limit ($0.10/$0.25) - 2009/07/01 1:50:00 ET
Table 'ORSZkZqq+7Ja2PdeCFAytA' 9-max Seat #9 is the button
Seat 1: 3FkcXBaxKqxYVagfYUZlmw ($22.90 in chips) 
Seat 2: j4q3p0lesp63b1gZDwLBZw ($5 in chips) 
Seat 3: s9a4d23HFxaL70yUWQ0/tQ ($19.10 in chips) 
Seat 4: tbgfV2Egwn85xEt865GWQQ ($17.80 in chips) 
Seat 6: gMF+EMhmwpnaM5TFQquf2A ($4.90 in chips) 
Seat 7: clJsV3v77RS07bDKY+705w ($10.80 in chips) 
Seat 9: cMTFs4oCtNInkpDIecxT/w ($15.70 in chips) 
3FkcXBaxKqxYVagfYUZlmw: posts small blind $0.10
j4q3p0lesp63b1gZDwLBZw: posts big blind $0.25
*** HOLE CARDS ***
s9a4d23HFxaL70yUWQ0/tQ: folds 
+lWbsq4dTcA70SX/+hnmpg has returned
tbgfV2Egwn85xEt865GWQQ: raises $0.75 to $1
gMF+EMhmwpnaM5TFQquf2A: folds 
clJsV3v77RS07bDKY+705w: folds 
cMTFs4oCtNInkpDIecxT/w: calls $1
3FkcXBaxKqxYVagfYUZlmw: calls $0.90
j4q3p0lesp63b1gZDwLBZw: raises $4 to $5 and is all-in
tbgfV2Egwn85xEt865GWQQ: folds 
cMTFs4oCtNInkpDIecxT/w: folds 
3FkcXBaxKqxYVagfYUZlmw: calls $4
*** FLOP *** [3h 6c Kd]
*** TURN *** [3h 6c Kd] [Th]
*** RIVER *** [3h 6c Kd Th] [6d]
*** SHOW DOWN ***
3FkcXBaxKqxYVagfYUZlmw: shows [Ah Qd] (a pair of Sixes)
j4q3p0lesp63b1gZDwLBZw: shows [8c 8h] (two pair, Eights and Sixes)
j4q3p0lesp63b1gZDwLBZw collected $11.40 from pot
*** SUMMARY ***
Total pot $12 | Rake $0.60 
Board [3h 6c Kd Th 6d]
Seat 1: 3FkcXBaxKqxYVagfYUZlmw (small blind) showed [Ah Qd] and lost with a pair of Sixes
Seat 2: j4q3p0lesp63b1gZDwLBZw (big blind) showed [8c 8h] and won ($11.40) with two pair, Eights and Sixes
Seat 3: s9a4d23HFxaL70yUWQ0/tQ folded before Flop (didn't bet)
Seat 4: tbgfV2Egwn85xEt865GWQQ folded before Flop
Seat 6: gMF+EMhmwpnaM5TFQquf2A folded before Flop (didn't bet)
Seat 7: clJsV3v77RS07bDKY+705w folded before Flop (didn't bet)
Seat 9: cMTFs4oCtNInkpDIecxT/w (button) folded before Flop




PokerStars Game #59941908534:  Hold'em No Limit ($0.10/$0.25) - 2009/07/01 1:50:00 ET
Table 'GrYi0DZOHD1EvB+qiLExNw' 9-max Seat #9 is the button
Seat 1: 7je+LC5Mfs6nL8YBVh4frQ ($4.75 in chips) 
Seat 2: Th3FldXKQW6hWVVPahaoOQ ($46.70 in chips) 
Seat 3: RHqgdFvufLCYe54+qd2gcA ($4.75 in chips) 
Seat 4: 8x95tVlB4uFBVHp71KihMA ($35.75 in chips) 
Seat 5: cZ99hugmLBj9KhTlc8nCSw ($25 in chips) 
Seat 6: arxNSjreDRGFg13EAM2F1w ($25 in chips) 
Seat 7: 9lvO/qyU+xrU95Teu1fv0g ($23.20 in chips) 
Seat 9: 5hAPbqNrvJb8PtLiceXtlg ($14.45 in chips) 
7je+LC5Mfs6nL8YBVh4frQ: posts small blind $0.10
Th3FldXKQW6hWVVPahaoOQ: posts big blind $0.25
*** HOLE CARDS ***
RHqgdFvufLCYe54+qd2gcA: folds 
8x95tVlB4uFBVHp71KihMA: folds 
cZ99hugmLBj9KhTlc8nCSw: folds 
arxNSjreDRGFg13EAM2F1w: folds 
9lvO/qyU+xrU95Teu1fv0g: folds 
5hAPbqNrvJb8PtLiceXtlg: folds 
7je+LC5Mfs6nL8YBVh4frQ: folds 
Uncalled bet ($0.15) returned to Th3FldXKQW6hWVVPahaoOQ
Th3FldXKQW6hWVVPahaoOQ collected $0.20 from pot
Th3FldXKQW6hWVVPahaoOQ: doesn't show hand 
*** SUMMARY ***
Total pot $0.20 | Rake $0 
Seat 1: 7je+LC5Mfs6nL8YBVh4frQ (small blind) folded before Flop
Seat 2: Th3FldXKQW6hWVVPahaoOQ (big blind) collected ($0.20)
Seat 3: RHqgdFvufLCYe54+qd2gcA folded before Flop (didn't bet)
Seat 4: 8x95tVlB4uFBVHp71KihMA folded before Flop (didn't bet)
Seat 5: cZ99hugmLBj9KhTlc8nCSw folded before Flop (didn't bet)
Seat 6: arxNSjreDRGFg13EAM2F1w folded before Flop (didn't bet)
Seat 7: 9lvO/qyU+xrU95Teu1fv0g folded before Flop (didn't bet)
Seat 9: 5hAPbqNrvJb8PtLiceXtlg (button) folded before Flop (didn't bet)




PokerStars Game #59941908184:  Hold'em No Limit ($0.10/$0.25) - 2009/07/01 1:50:00 ET
Table 'mVdLgAdN9rGe6mMwSrDdGQ' 6-max Seat #4 is the button
Seat 1: OyJ0KTHA5cwh0/yCo1/rdA ($11.10 in chips) 
Seat 3: +baiVgI/ETnBARLe5mARCw ($16.25 in chips) 
Seat 4: scNSjC6yyKvvfklSkuzLrw ($22.50 in chips) 
Seat 5: +TMG/MBWpiEnc9t7i07eTA ($23.40 in chips) 
Seat 6: DihMHaz4WNETH1bPDe13kA ($47.80 in chips) 
+TMG/MBWpiEnc9t7i07eTA: posts small blind $0.10
DihMHaz4WNETH1bPDe13kA: posts big blind $0.25
*** HOLE CARDS ***
n9QqWD4tpbongUBX2Oi58w said, "****in idiot"
OyJ0KTHA5cwh0/yCo1/rdA: folds 
+baiVgI/ETnBARLe5mARCw: folds 
n9QqWD4tpbongUBX2Oi58w said, "limp player"
scNSjC6yyKvvfklSkuzLrw: folds 
+TMG/MBWpiEnc9t7i07eTA: calls $0.15
n9QqWD4tpbongUBX2Oi58w said, "s.l.u.t"
DihMHaz4WNETH1bPDe13kA: checks 
*** FLOP *** [Jc Tc Jh]
+TMG/MBWpiEnc9t7i07eTA: checks 
DihMHaz4WNETH1bPDe13kA: bets $0.35
n9QqWD4tpbongUBX2Oi58w has returned
+TMG/MBWpiEnc9t7i07eTA: folds 
Uncalled bet ($0.35) returned to DihMHaz4WNETH1bPDe13kA
DihMHaz4WNETH1bPDe13kA collected $0.50 from pot
*** SUMMARY ***
Total pot $0.50 | Rake $0 
Board [Jc Tc Jh]
Seat 1: OyJ0KTHA5cwh0/yCo1/rdA folded before Flop (didn't bet)
Seat 3: +baiVgI/ETnBARLe5mARCw folded before Flop (didn't bet)
Seat 4: scNSjC6yyKvvfklSkuzLrw (button) folded before Flop (didn't bet)
Seat 5: +TMG/MBWpiEnc9t7i07eTA (small blind) folded on the Flop
Seat 6: DihMHaz4WNETH1bPDe13kA (big blind) collected ($0.50)




PokerStars Game #59941908814:  Hold'em No Limit ($0.10/$0.25) - 2009/07/01 1:50:01 ET
Table '3lS+sU5k6mwJCS2nFMmQ6Q' 9-max Seat #3 is the button
Seat 1: VWUWpMLMj/Q1jRVpF7Aohw ($13.55 in chips) 
Seat 2: PdIasPkzm2sqZnN41ZRXOg ($5.75 in chips) 
Seat 3: 1DXccE2UUK5DIRVGlOKnTA ($12.45 in chips) 
Seat 4: GeMoapCKDLc4ajT0Uk9ZQw ($9.75 in chips) 
Seat 6: hJ4uYjNmSZdjrKA8cjZqCA ($35.50 in chips) 
Seat 7: Th3FldXKQW6hWVVPahaoOQ ($31.55 in chips) 
Seat 8: 9lvO/qyU+xrU95Teu1fv0g ($5 in chips) 
Seat 9: 4awUyiDYTgylQKXZ9faBVA ($48.85 in chips) 
GeMoapCKDLc4ajT0Uk9ZQw: posts small blind $0.10
hJ4uYjNmSZdjrKA8cjZqCA: posts big blind $0.25
*** HOLE CARDS ***
Th3FldXKQW6hWVVPahaoOQ: folds 
9lvO/qyU+xrU95Teu1fv0g: folds 
4awUyiDYTgylQKXZ9faBVA: raises $0.75 to $1
VWUWpMLMj/Q1jRVpF7Aohw: folds 
PdIasPkzm2sqZnN41ZRXOg: folds 
1DXccE2UUK5DIRVGlOKnTA: raises $11.45 to $12.45 and is all-in
GeMoapCKDLc4ajT0Uk9ZQw: folds 
hJ4uYjNmSZdjrKA8cjZqCA: folds 
4awUyiDYTgylQKXZ9faBVA: folds 
Uncalled bet ($11.45) returned to 1DXccE2UUK5DIRVGlOKnTA
1DXccE2UUK5DIRVGlOKnTA collected $2.35 from pot
*** SUMMARY ***
Total pot $2.35 | Rake $0 
Seat 1: VWUWpMLMj/Q1jRVpF7Aohw folded before Flop (didn't bet)
Seat 2: PdIasPkzm2sqZnN41ZRXOg folded before Flop (didn't bet)
Seat 3: 1DXccE2UUK5DIRVGlOKnTA (button) collected ($2.35)
Seat 4: GeMoapCKDLc4ajT0Uk9ZQw (small blind) folded before Flop
Seat 6: hJ4uYjNmSZdjrKA8cjZqCA (big blind) folded before Flop
Seat 7: Th3FldXKQW6hWVVPahaoOQ folded before Flop (didn't bet)
Seat 8: 9lvO/qyU+xrU95Teu1fv0g folded before Flop (didn't bet)
Seat 9: 4awUyiDYTgylQKXZ9faBVA folded before Flop




PokerStars Game #59941908678:  Hold'em No Limit ($0.10/$0.25) - 2009/07/01 1:50:01 ET
Table 'FBhJjLqab11/gKu8nyB/tw' 9-max Seat #3 is the button
Seat 1: +sbyWwIcFp9kP0bDtMegfQ ($18.30 in chips) 
Seat 3: V6p0jQ/RhUsqpHLmXvEX4Q ($12.35 in chips) 
Seat 4: CvL9Ch1HYCVbTsfpNucitg ($5.25 in chips) 
Seat 5: Mh2r9hTeTEDnh19sRZtW3g ($4.65 in chips) 
Seat 6: cZ99hugmLBj9KhTlc8nCSw ($31.70 in chips) 
Seat 7: CT7Xj/V/O5rBlhtt+RZeFQ ($25 in chips) 
Seat 8: Th3FldXKQW6hWVVPahaoOQ ($27.25 in chips) 
CvL9Ch1HYCVbTsfpNucitg: posts small blind $0.10
Mh2r9hTeTEDnh19sRZtW3g: posts big blind $0.25
H5Se03ZqSX7tbULXur2MAg: sits out 
18G4P1XstjNvItdGUITxgw: sits out 
*** HOLE CARDS ***
cZ99hugmLBj9KhTlc8nCSw: folds 
CT7Xj/V/O5rBlhtt+RZeFQ: folds 
Th3FldXKQW6hWVVPahaoOQ: folds 
+sbyWwIcFp9kP0bDtMegfQ: folds 
V6p0jQ/RhUsqpHLmXvEX4Q: folds 
CvL9Ch1HYCVbTsfpNucitg: folds 
Uncalled bet ($0.15) returned to Mh2r9hTeTEDnh19sRZtW3g
Mh2r9hTeTEDnh19sRZtW3g collected $0.20 from pot
Mh2r9hTeTEDnh19sRZtW3g: doesn't show hand 
*** SUMMARY ***
Total pot $0.20 | Rake $0 
Seat 1: +sbyWwIcFp9kP0bDtMegfQ folded before Flop (didn't bet)
Seat 3: V6p0jQ/RhUsqpHLmXvEX4Q (button) folded before Flop (didn't bet)
Seat 4: CvL9Ch1HYCVbTsfpNucitg (small blind) folded before Flop
Seat 5: Mh2r9hTeTEDnh19sRZtW3g (big blind) collected ($0.20)
Seat 6: cZ99hugmLBj9KhTlc8nCSw folded before Flop (didn't bet)
Seat 7: CT7Xj/V/O5rBlhtt+RZeFQ folded before Flop (didn't bet)
Seat 8: Th3FldXKQW6hWVVPahaoOQ folded before Flop (didn't bet)




PokerStars Game #59941908974:  Hold'em No Limit ($0.10/$0.25) - 2009/07/01 1:50:01 ET
Table 'g6ryG70feTw9nNm+XJLuXw' 6-max Seat #2 is the button
Seat 1: v+QfkGiuj9bgtuNoVnDO8w ($34.75 in chips) 
Seat 2: SxIIgwXYLkwd6m3wLyPTCw ($33.90 in chips) 
Seat 3: cezpHJ8FB07dj0xG+LhOvw ($25.10 in chips) 
Seat 4: GC/9yVD59DUCX7hUI7gcLw ($45 in chips) 
Seat 5: EE16Ua5b1HSsYej5zeXOlA ($25 in chips) 
Seat 6: Mhj3q7cxev+XjXZxEE6/Cw ($25.70 in chips) 
cezpHJ8FB07dj0xG+LhOvw: posts small blind $0.10
GC/9yVD59DUCX7hUI7gcLw: posts big blind $0.25
*** HOLE CARDS ***
EE16Ua5b1HSsYej5zeXOlA: folds 
Mhj3q7cxev+XjXZxEE6/Cw: folds 
v+QfkGiuj9bgtuNoVnDO8w: raises $0.75 to $1
SxIIgwXYLkwd6m3wLyPTCw: folds 
cezpHJ8FB07dj0xG+LhOvw: folds 
GC/9yVD59DUCX7hUI7gcLw: folds 
Uncalled bet ($0.75) returned to v+QfkGiuj9bgtuNoVnDO8w
v+QfkGiuj9bgtuNoVnDO8w collected $0.60 from pot
v+QfkGiuj9bgtuNoVnDO8w: doesn't show hand 
*** SUMMARY ***
Total pot $0.60 | Rake $0 
Seat 1: v+QfkGiuj9bgtuNoVnDO8w collected ($0.60)
Seat 2: SxIIgwXYLkwd6m3wLyPTCw (button) folded before Flop (didn't bet)
Seat 3: cezpHJ8FB07dj0xG+LhOvw (small blind) folded before Flop
Seat 4: GC/9yVD59DUCX7hUI7gcLw (big blind) folded before Flop
Seat 5: EE16Ua5b1HSsYej5zeXOlA folded before Flop (didn't bet)
Seat 6: Mhj3q7cxev+XjXZxEE6/Cw folded before Flop (didn't bet)




PokerStars Game #59941908642:  Hold'em No Limit ($0.10/$0.25) - 2009/07/01 1:50:01 ET
Table 'IuqVbFI+pwnJjvwBCGSGAw' 6-max Seat #6 is the button
Seat 1: LyDHtw3/yniNHW+DvLXbog ($27.85 in chips) 
Seat 2: w43JQj2oYPpKQVG4Yzlq1w ($25.35 in chips) 
Seat 3: QiL+lEgEWwy21jk/ltaRLg ($21.05 in chips) 
Seat 4: DE9hRlt14g+JdsRQ4wT7hg ($28.20 in chips) 
Seat 5: if4dh6jhJXeN3/qd3qCp9g ($23.70 in chips) 
Seat 6: xC0kaiDYM6YTlgODL83O5A ($12.80 in chips) 
LyDHtw3/yniNHW+DvLXbog: posts small blind $0.10
w43JQj2oYPpKQVG4Yzlq1w: posts big blind $0.25
*** HOLE CARDS ***
QiL+lEgEWwy21jk/ltaRLg: calls $0.25
DE9hRlt14g+JdsRQ4wT7hg: folds 
if4dh6jhJXeN3/qd3qCp9g: raises $1 to $1.25
xC0kaiDYM6YTlgODL83O5A: folds 
LyDHtw3/yniNHW+DvLXbog: folds 
w43JQj2oYPpKQVG4Yzlq1w: folds 
QiL+lEgEWwy21jk/ltaRLg: folds 
Uncalled bet ($1) returned to if4dh6jhJXeN3/qd3qCp9g
if4dh6jhJXeN3/qd3qCp9g collected $0.85 from pot
if4dh6jhJXeN3/qd3qCp9g: doesn't show hand 
*** SUMMARY ***
Total pot $0.85 | Rake $0 
Seat 1: LyDHtw3/yniNHW+DvLXbog (small blind) folded before Flop
Seat 2: w43JQj2oYPpKQVG4Yzlq1w (big blind) folded before Flop
Seat 3: QiL+lEgEWwy21jk/ltaRLg folded before Flop
Seat 4: DE9hRlt14g+JdsRQ4wT7hg folded before Flop (didn't bet)
Seat 5: if4dh6jhJXeN3/qd3qCp9g collected ($0.85)
Seat 6: xC0kaiDYM6YTlgODL83O5A (button) folded before Flop (didn't bet)




PokerStars Game #59941909426:  Hold'em No Limit ($0.10/$0.25) - 2009/07/01 1:50:02 ET
Table '60nA7av6bws9VnNmVwculA' 6-max Seat #6 is the button
Seat 1: if4dh6jhJXeN3/qd3qCp9g ($24.40 in chips) 
Seat 2: Bada343Si4xKu3fNXY99AA ($2.75 in chips) 
Seat 3: mnuJq+Q1IXKm/pCy+OzxmQ ($22.45 in chips) 
Seat 4: +baiVgI/ETnBARLe5mARCw ($18.60 in chips) 
Seat 5: zXh+lOT41Q2iWgCNj+OcRw ($11.85 in chips) 
Seat 6: mfrkWA3PTeYPkbO6hi98Aw ($24.40 in chips) 
if4dh6jhJXeN3/qd3qCp9g: posts small blind $0.10
Bada343Si4xKu3fNXY99AA: posts big blind $0.25
*** HOLE CARDS ***
mnuJq+Q1IXKm/pCy+OzxmQ: folds 
+baiVgI/ETnBARLe5mARCw: folds 
zXh+lOT41Q2iWgCNj+OcRw: calls $0.25
mfrkWA3PTeYPkbO6hi98Aw: folds 
if4dh6jhJXeN3/qd3qCp9g: raises $1 to $1.25
Bada343Si4xKu3fNXY99AA: calls $1
zXh+lOT41Q2iWgCNj+OcRw: folds 
*** FLOP *** [7d 2d 3d]
if4dh6jhJXeN3/qd3qCp9g: bets $1.50
Bada343Si4xKu3fNXY99AA: calls $1.50 and is all-in
*** TURN *** [7d 2d 3d] [6c]
*** RIVER *** [7d 2d 3d 6c] [7c]
*** SHOW DOWN ***
if4dh6jhJXeN3/qd3qCp9g: shows [Qh Qc] (two pair, Queens and Sevens)
Bada343Si4xKu3fNXY99AA: shows [Ad 5d] (a flush, Ace high)
Bada343Si4xKu3fNXY99AA collected $5.50 from pot
*** SUMMARY ***
Total pot $5.75 | Rake $0.25 
Board [7d 2d 3d 6c 7c]
Seat 1: if4dh6jhJXeN3/qd3qCp9g (small blind) showed [Qh Qc] and lost with two pair, Queens and Sevens
Seat 2: Bada343Si4xKu3fNXY99AA (big blind) showed [Ad 5d] and won ($5.50) with a flush, Ace high
Seat 3: mnuJq+Q1IXKm/pCy+OzxmQ folded before Flop (didn't bet)
Seat 4: +baiVgI/ETnBARLe5mARCw folded before Flop (didn't bet)
Seat 5: zXh+lOT41Q2iWgCNj+OcRw folded before Flop
Seat 6: mfrkWA3PTeYPkbO6hi98Aw (button) folded before Flop (didn't bet)




PokerStars Game #59941909142:  Hold'em No Limit ($0.10/$0.25) - 2009/07/01 1:50:02 ET
Table '7/qMNloI0nSXWiX5Y1watA' 9-max Seat #1 is the button
Seat 1: /LyhaB3V6jkgOfXORidqRQ ($10.40 in chips) 
Seat 2: wGigCmBR/9XWkPpvYos3aQ ($25 in chips) 
Seat 3: W2YYHvqjaEpRrO7stZkClQ ($5 in chips) 
Seat 4: K0LdhPeU31rviEPo6Sv3TA ($9.35 in chips) 
Seat 8: ljemhp25Zg+nlA9DLCIiUw ($26.05 in chips) 
Seat 9: dmYlc+1cjwZMJ7wV+Z0rRg ($27.40 in chips) 
wGigCmBR/9XWkPpvYos3aQ: posts small blind $0.10
W2YYHvqjaEpRrO7stZkClQ: posts big blind $0.25
GeMoapCKDLc4ajT0Uk9ZQw: sits out 
*** HOLE CARDS ***
K0LdhPeU31rviEPo6Sv3TA: folds 
ljemhp25Zg+nlA9DLCIiUw: folds 
dmYlc+1cjwZMJ7wV+Z0rRg: folds 
/LyhaB3V6jkgOfXORidqRQ: folds 
wGigCmBR/9XWkPpvYos3aQ: raises $0.65 to $0.90
W2YYHvqjaEpRrO7stZkClQ: folds 
Uncalled bet ($0.65) returned to wGigCmBR/9XWkPpvYos3aQ
wGigCmBR/9XWkPpvYos3aQ collected $0.50 from pot
wGigCmBR/9XWkPpvYos3aQ: doesn't show hand 
*** SUMMARY ***
Total pot $0.50 | Rake $0 
Seat 1: /LyhaB3V6jkgOfXORidqRQ (button) folded before Flop (didn't bet)
Seat 2: wGigCmBR/9XWkPpvYos3aQ (small blind) collected ($0.50)
Seat 3: W2YYHvqjaEpRrO7stZkClQ (big blind) folded before Flop
Seat 4: K0LdhPeU31rviEPo6Sv3TA folded before Flop (didn't bet)
Seat 8: ljemhp25Zg+nlA9DLCIiUw folded before Flop (didn't bet)
Seat 9: dmYlc+1cjwZMJ7wV+Z0rRg folded before Flop (didn't bet)




PokerStars Game #59941909458:  Hold'em No Limit ($0.10/$0.25) - 2009/07/01 1:50:02 ET
Table 'XX2OuOsa8/8AC+/mR/Az6g' 9-max Seat #3 is the button
Seat 1: 56S3mA6Zs3pGR+0p0vUCtg ($24.40 in chips) 
Seat 2: Bb42QRQMhg5/Y0vHP8/2Xw ($26.50 in chips) 
Seat 3: oLa/tXLfSLLB28mcLGrxcg ($24.60 in chips) 
Seat 4: 5pDhXQ+RVy0BGcwfJAJfbg ($24.75 in chips) 
Seat 5: SpiiQQAzy4MUgV3I5W8giw ($21.15 in chips) 
Seat 6: RCqMONFrSPSArZh2Jsar/w ($20.55 in chips) 
Seat 8: qwr38jl5txoR36M7G5qi4A ($10.35 in chips) 
Seat 9: V6p0jQ/RhUsqpHLmXvEX4Q ($12 in chips) 
5pDhXQ+RVy0BGcwfJAJfbg: posts small blind $0.10
SpiiQQAzy4MUgV3I5W8giw: posts big blind $0.25
*** HOLE CARDS ***
RCqMONFrSPSArZh2Jsar/w: calls $0.25
qwr38jl5txoR36M7G5qi4A: folds 
V6p0jQ/RhUsqpHLmXvEX4Q: folds 
56S3mA6Zs3pGR+0p0vUCtg: raises $1 to $1.25
Bb42QRQMhg5/Y0vHP8/2Xw: calls $1.25
oLa/tXLfSLLB28mcLGrxcg: calls $1.25
5pDhXQ+RVy0BGcwfJAJfbg: folds 
SpiiQQAzy4MUgV3I5W8giw: folds 
RCqMONFrSPSArZh2Jsar/w: raises $4.50 to $5.75
56S3mA6Zs3pGR+0p0vUCtg: folds 
Bb42QRQMhg5/Y0vHP8/2Xw: folds 
oLa/tXLfSLLB28mcLGrxcg: folds 
Uncalled bet ($4.50) returned to RCqMONFrSPSArZh2Jsar/w
RCqMONFrSPSArZh2Jsar/w collected $5.35 from pot
RCqMONFrSPSArZh2Jsar/w: doesn't show hand 
*** SUMMARY ***
Total pot $5.35 | Rake $0 
Seat 1: 56S3mA6Zs3pGR+0p0vUCtg folded before Flop
Seat 2: Bb42QRQMhg5/Y0vHP8/2Xw folded before Flop
Seat 3: oLa/tXLfSLLB28mcLGrxcg (button) folded before Flop
Seat 4: 5pDhXQ+RVy0BGcwfJAJfbg (small blind) folded before Flop
Seat 5: SpiiQQAzy4MUgV3I5W8giw (big blind) folded before Flop
Seat 6: RCqMONFrSPSArZh2Jsar/w collected ($5.35)
Seat 8: qwr38jl5txoR36M7G5qi4A folded before Flop (didn't bet)
Seat 9: V6p0jQ/RhUsqpHLmXvEX4Q folded before Flop (didn't bet)




PokerStars Game #59941909112:  Hold'em No Limit ($0.10/$0.25) - 2009/07/01 1:50:02 ET
Table 'yZgGBnUGXVCcEJdcqes8tw' 9-max Seat #2 is the button
Seat 1: 6RiVTYll/5D8zICp0MRpKw ($30.30 in chips) 
Seat 2: MG90wfSJZnOejs/KD3vlQQ ($25 in chips) 
Seat 4: M2QO2DxB5Wawg2h8HSpnYA ($10.10 in chips) 
Seat 5: dfNim92Z6XK1/h5SFW5vDg ($25.85 in chips) 
Seat 6: RHqgdFvufLCYe54+qd2gcA ($5 in chips) 
Seat 7: eC8Pn1D6Y2pct8o62nQfvQ ($31.20 in chips) 
Seat 8: dtZ84flFEi4Q+SGrHMJRDQ ($29.80 in chips) 
Seat 9: M/9j4wkHH9i1JM51vgi1VA ($23.40 in chips) 
M2QO2DxB5Wawg2h8HSpnYA: posts small blind $0.10
dfNim92Z6XK1/h5SFW5vDg: posts big blind $0.25
*** HOLE CARDS ***
RHqgdFvufLCYe54+qd2gcA: folds 
eC8Pn1D6Y2pct8o62nQfvQ: folds 
z5GxcHlYz/GSz6W2uFiTtg has returned
dtZ84flFEi4Q+SGrHMJRDQ: folds 
M/9j4wkHH9i1JM51vgi1VA: folds 
6RiVTYll/5D8zICp0MRpKw: folds 
MG90wfSJZnOejs/KD3vlQQ: folds 
M2QO2DxB5Wawg2h8HSpnYA: calls $0.15
dfNim92Z6XK1/h5SFW5vDg: checks 
*** FLOP *** [Ac 6h 4c]
M2QO2DxB5Wawg2h8HSpnYA: checks 
dfNim92Z6XK1/h5SFW5vDg: checks 
*** TURN *** [Ac 6h 4c] [2h]
M2QO2DxB5Wawg2h8HSpnYA: checks 
dfNim92Z6XK1/h5SFW5vDg: checks 
*** RIVER *** [Ac 6h 4c 2h] [8c]
M2QO2DxB5Wawg2h8HSpnYA: checks 
dfNim92Z6XK1/h5SFW5vDg: checks 
*** SHOW DOWN ***
M2QO2DxB5Wawg2h8HSpnYA: shows [9c Jh] (high card Ace)
dfNim92Z6XK1/h5SFW5vDg: shows [Ts Kc] (high card Ace - King kicker)
dfNim92Z6XK1/h5SFW5vDg collected $0.50 from pot
*** SUMMARY ***
Total pot $0.50 | Rake $0 
Board [Ac 6h 4c 2h 8c]
Seat 1: 6RiVTYll/5D8zICp0MRpKw folded before Flop (didn't bet)
Seat 2: MG90wfSJZnOejs/KD3vlQQ (button) folded before Flop (didn't bet)
Seat 4: M2QO2DxB5Wawg2h8HSpnYA (small blind) showed [9c Jh] and lost with high card Ace
Seat 5: dfNim92Z6XK1/h5SFW5vDg (big blind) showed [Ts Kc] and won ($0.50) with high card Ace
Seat 6: RHqgdFvufLCYe54+qd2gcA folded before Flop (didn't bet)
Seat 7: eC8Pn1D6Y2pct8o62nQfvQ folded before Flop (didn't bet)
Seat 8: dtZ84flFEi4Q+SGrHMJRDQ folded before Flop (didn't bet)
Seat 9: M/9j4wkHH9i1JM51vgi1VA folded before Flop (didn't bet)




PokerStars Game #59941909370:  Hold'em No Limit ($0.10/$0.25) - 2009/07/01 1:50:02 ET
Table 'z2yOdY2zyGWG1gh9WV9XtQ' 9-max Seat #6 is the button
Seat 1: 8iyfEWL3auLDt9HEV3U5Vg ($24.75 in chips) 
Seat 2: /OxeiWKPcgcer/U4z8Kqxw ($15 in chips) 
Seat 3: X78b5v/uhqeXXoAijbw/yg ($26.90 in chips) 
Seat 4: Bb42QRQMhg5/Y0vHP8/2Xw ($25 in chips) 
Seat 6: NBYmTySMtIicyMj5Vjzqhw ($31.40 in chips) 
Seat 7: zDrucyjVn5aeekNEc3cJrA ($22.70 in chips) 
Seat 8: u+J1MTXS2qhNVMbsBemNLg ($4.50 in chips) 
Seat 9: wGigCmBR/9XWkPpvYos3aQ ($34.65 in chips) 
zDrucyjVn5aeekNEc3cJrA: posts small blind $0.10
u+J1MTXS2qhNVMbsBemNLg: posts big blind $0.25
/OxeiWKPcgcer/U4z8Kqxw: posts big blind $0.25
4qA/3Ajg3pP6fqW+IX9/fQ: sits out 
*** HOLE CARDS ***
wGigCmBR/9XWkPpvYos3aQ: folds 
8iyfEWL3auLDt9HEV3U5Vg: raises $0.50 to $0.75
/OxeiWKPcgcer/U4z8Kqxw: folds 
X78b5v/uhqeXXoAijbw/yg: folds 
Bb42QRQMhg5/Y0vHP8/2Xw: folds 
NBYmTySMtIicyMj5Vjzqhw: folds 
zDrucyjVn5aeekNEc3cJrA: folds 
u+J1MTXS2qhNVMbsBemNLg: folds 
Uncalled bet ($0.50) returned to 8iyfEWL3auLDt9HEV3U5Vg
u+J1MTXS2qhNVMbsBemNLg leaves the table
8iyfEWL3auLDt9HEV3U5Vg collected $0.85 from pot
8iyfEWL3auLDt9HEV3U5Vg: doesn't show hand 
*** SUMMARY ***
Total pot $0.85 | Rake $0 
Seat 1: 8iyfEWL3auLDt9HEV3U5Vg collected ($0.85)
Seat 2: /OxeiWKPcgcer/U4z8Kqxw folded before Flop
Seat 3: X78b5v/uhqeXXoAijbw/yg folded before Flop (didn't bet)
Seat 4: Bb42QRQMhg5/Y0vHP8/2Xw folded before Flop (didn't bet)
Seat 6: NBYmTySMtIicyMj5Vjzqhw (button) folded before Flop (didn't bet)
Seat 7: zDrucyjVn5aeekNEc3cJrA (small blind) folded before Flop
Seat 8: u+J1MTXS2qhNVMbsBemNLg (big blind) folded before Flop
Seat 9: wGigCmBR/9XWkPpvYos3aQ folded before Flop (didn't bet)




PokerStars Game #59941909216:  Hold'em No Limit ($0.10/$0.25) - 2009/07/01 1:50:02 ET
Table 'S6s+TmTlAjLHclBRvN5/fw' 9-max Seat #3 is the button
Seat 3: z2SmIaQ3+5n/eY1BN5HgPg ($5 in chips) 
Seat 4: RSal7+azPhXeqQO5L8XPfg ($23.35 in chips) 
Seat 5: 8hSJOE8UscCqt6t47gp0/g ($9.15 in chips) 
Seat 6: QkBggokTsSaL9vRv6V8nzQ ($6.80 in chips) 
RSal7+azPhXeqQO5L8XPfg: posts small blind $0.10
8hSJOE8UscCqt6t47gp0/g: posts big blind $0.25
*** HOLE CARDS ***
QkBggokTsSaL9vRv6V8nzQ: raises $1.75 to $2
z2SmIaQ3+5n/eY1BN5HgPg: folds 
RSal7+azPhXeqQO5L8XPfg: calls $1.90
8hSJOE8UscCqt6t47gp0/g: folds 
*** FLOP *** [7h Kc 3c]
RSal7+azPhXeqQO5L8XPfg: checks 
QkBggokTsSaL9vRv6V8nzQ: checks 
*** TURN *** [7h Kc 3c] [5s]
RSal7+azPhXeqQO5L8XPfg: bets $0.75
QkBggokTsSaL9vRv6V8nzQ: calls $0.75
*** RIVER *** [7h Kc 3c 5s] [Ac]
RSal7+azPhXeqQO5L8XPfg: bets $1.75
QkBggokTsSaL9vRv6V8nzQ: raises $2.30 to $4.05 and is all-in
RSal7+azPhXeqQO5L8XPfg: folds 
Uncalled bet ($2.30) returned to QkBggokTsSaL9vRv6V8nzQ
QkBggokTsSaL9vRv6V8nzQ collected $8.80 from pot
z2SmIaQ3+5n/eY1BN5HgPg said, "n1"
QkBggokTsSaL9vRv6V8nzQ: doesn't show hand 
*** SUMMARY ***
Total pot $9.25 | Rake $0.45 
Board [7h Kc 3c 5s Ac]
Seat 3: z2SmIaQ3+5n/eY1BN5HgPg (button) folded before Flop (didn't bet)
Seat 4: RSal7+azPhXeqQO5L8XPfg (small blind) folded on the River
Seat 5: 8hSJOE8UscCqt6t47gp0/g (big blind) folded before Flop
Seat 6: QkBggokTsSaL9vRv6V8nzQ collected ($8.80)




PokerStars Game #59941909680:  Hold'em No Limit ($0.10/$0.25) - 2009/07/01 1:50:03 ET
Table '5SUMWYuPsGiOD0FY0QbgOw' 6-max Seat #6 is the button
Seat 1: SFmT9ZsVopnukjvAzrxTRg ($25 in chips) 
Seat 2: xrf8tAXKQHG99HixCot1Iw ($39 in chips) 
Seat 4: BV+K0Phf5VBHr7aZPKqbUQ ($26.10 in chips) 
Seat 5: v+QfkGiuj9bgtuNoVnDO8w ($40.45 in chips) 
Seat 6: jA7YMtfNUnAaebB7Lj74EA ($22.80 in chips) 
SFmT9ZsVopnukjvAzrxTRg: posts small blind $0.10
xrf8tAXKQHG99HixCot1Iw: posts big blind $0.25
i9LqF5rD3bvtbEE7HWgr3Q: sits out 
*** HOLE CARDS ***
BV+K0Phf5VBHr7aZPKqbUQ: folds 
v+QfkGiuj9bgtuNoVnDO8w: folds 
jA7YMtfNUnAaebB7Lj74EA: calls $0.25
SFmT9ZsVopnukjvAzrxTRg: folds 
xrf8tAXKQHG99HixCot1Iw: checks 
*** FLOP *** [Ks Kd Qs]
xrf8tAXKQHG99HixCot1Iw: checks 
jA7YMtfNUnAaebB7Lj74EA: bets $0.25
xrf8tAXKQHG99HixCot1Iw: folds 
Uncalled bet ($0.25) returned to jA7YMtfNUnAaebB7Lj74EA
jA7YMtfNUnAaebB7Lj74EA collected $0.60 from pot
*** SUMMARY ***
Total pot $0.60 | Rake $0 
Board [Ks Kd Qs]
Seat 1: SFmT9ZsVopnukjvAzrxTRg (small blind) folded before Flop
Seat 2: xrf8tAXKQHG99HixCot1Iw (big blind) folded on the Flop
Seat 4: BV+K0Phf5VBHr7aZPKqbUQ folded before Flop (didn't bet)
Seat 5: v+QfkGiuj9bgtuNoVnDO8w folded before Flop (didn't bet)
Seat 6: jA7YMtfNUnAaebB7Lj74EA (button) collected ($0.60)




PokerStars Game #59941909920:  Hold'em No Limit ($0.10/$0.25) - 2009/07/01 1:50:03 ET
Table '2vH5RcmkT0F4XNS/EmmyMA' 6-max Seat #4 is the button
Seat 2: W6Y6au0wf7gRAlqJYgOezw ($10.75 in chips) 
Seat 3: t8P79jKZYh/Wpx2V73pSqg ($24.60 in chips) 
Seat 4: FC6tJ9EOiutXO8hnpR4VgQ ($12.95 in chips) 
Seat 5: Hsvkc0/G2VV78oVmWYXecw ($5 in chips) 
Seat 6: if4dh6jhJXeN3/qd3qCp9g ($25.35 in chips) 
Hsvkc0/G2VV78oVmWYXecw: posts small blind $0.10
if4dh6jhJXeN3/qd3qCp9g: posts big blind $0.25
*** HOLE CARDS ***
W6Y6au0wf7gRAlqJYgOezw: raises $0.75 to $1
t8P79jKZYh/Wpx2V73pSqg: folds 
FC6tJ9EOiutXO8hnpR4VgQ: folds 
Hsvkc0/G2VV78oVmWYXecw: folds 
if4dh6jhJXeN3/qd3qCp9g: folds 
Uncalled bet ($0.75) returned to W6Y6au0wf7gRAlqJYgOezw
W6Y6au0wf7gRAlqJYgOezw collected $0.60 from pot
*** SUMMARY ***
Total pot $0.60 | Rake $0 
Seat 2: W6Y6au0wf7gRAlqJYgOezw collected ($0.60)
Seat 3: t8P79jKZYh/Wpx2V73pSqg folded before Flop (didn't bet)
Seat 4: FC6tJ9EOiutXO8hnpR4VgQ (button) folded before Flop (didn't bet)
Seat 5: Hsvkc0/G2VV78oVmWYXecw (small blind) folded before Flop
Seat 6: if4dh6jhJXeN3/qd3qCp9g (big blind) folded before Flop




PokerStars Game #59941910022:  Hold'em No Limit ($0.10/$0.25) - 2009/07/01 1:50:03 ET
Table '972HGIb0tQN/zRIK4TABEw' 9-max Seat #1 is the button
Seat 1: fHr2+mGa0RFK3qrpZcVUAQ ($7.05 in chips) 
Seat 4: aSrj4lVmn2owyQ1RbbOqxQ ($11.65 in chips) 
fHr2+mGa0RFK3qrpZcVUAQ: posts small blind $0.10
aSrj4lVmn2owyQ1RbbOqxQ: posts big blind $0.25
*** HOLE CARDS ***
fHr2+mGa0RFK3qrpZcVUAQ: calls $0.15
aSrj4lVmn2owyQ1RbbOqxQ: raises $0.50 to $0.75
fHr2+mGa0RFK3qrpZcVUAQ: raises $0.50 to $1.25
aSrj4lVmn2owyQ1RbbOqxQ: calls $0.50
*** FLOP *** [Kc 9h 7h]
aSrj4lVmn2owyQ1RbbOqxQ: checks 
fHr2+mGa0RFK3qrpZcVUAQ: bets $0.25
aSrj4lVmn2owyQ1RbbOqxQ: calls $0.25
*** TURN *** [Kc 9h 7h] [Jh]
aSrj4lVmn2owyQ1RbbOqxQ: checks 
fHr2+mGa0RFK3qrpZcVUAQ: bets $0.75
aSrj4lVmn2owyQ1RbbOqxQ: raises $1.25 to $2
fHr2+mGa0RFK3qrpZcVUAQ: raises $3.55 to $5.55 and is all-in
aSrj4lVmn2owyQ1RbbOqxQ: calls $3.55
*** RIVER *** [Kc 9h 7h Jh] [5d]
*** SHOW DOWN ***
aSrj4lVmn2owyQ1RbbOqxQ: shows [Jc Th] (a pair of Jacks)
fHr2+mGa0RFK3qrpZcVUAQ: shows [Ac Ah] (a pair of Aces)
fHr2+mGa0RFK3qrpZcVUAQ collected $13.40 from pot
*** SUMMARY ***
Total pot $14.10 | Rake $0.70 
Board [Kc 9h 7h Jh 5d]
Seat 1: fHr2+mGa0RFK3qrpZcVUAQ (button) (small blind) showed [Ac Ah] and won ($13.40) with a pair of Aces
Seat 4: aSrj4lVmn2owyQ1RbbOqxQ (big blind) showed [Jc Th] and lost with a pair of Jacks




PokerStars Game #59941909732:  Hold'em No Limit ($0.10/$0.25) - 2009/07/01 1:50:03 ET
Table 'FE/j6VqBY4j9Uq+VHURQCQ' 6-max Seat #6 is the button
Seat 1: ypmjhffk/YHGc51wgVXUTw ($39.40 in chips) 
Seat 2: 3zD3qLXT1bEffAoWGnc7wg ($37.10 in chips) 
Seat 3: lBoEwOFgzcERLIRUkUoRTw ($27.50 in chips) 
Seat 4: 7JyPCA0J2grhXQYxe1h3+A ($7.10 in chips) 
Seat 5: bJFzs6QmEEnz4miMfSDtcg ($16.90 in chips) 
Seat 6: Q1uciOZPBR/WkAlqa6cL4A ($25 in chips) 
ypmjhffk/YHGc51wgVXUTw: posts small blind $0.10
3zD3qLXT1bEffAoWGnc7wg: posts big blind $0.25
*** HOLE CARDS ***
lBoEwOFgzcERLIRUkUoRTw: folds 
7JyPCA0J2grhXQYxe1h3+A: folds 
bJFzs6QmEEnz4miMfSDtcg: folds 
Q1uciOZPBR/WkAlqa6cL4A: folds 
ypmjhffk/YHGc51wgVXUTw: folds 
Uncalled bet ($0.15) returned to 3zD3qLXT1bEffAoWGnc7wg
3zD3qLXT1bEffAoWGnc7wg collected $0.20 from pot
3zD3qLXT1bEffAoWGnc7wg: doesn't show hand 
*** SUMMARY ***
Total pot $0.20 | Rake $0 
Seat 1: ypmjhffk/YHGc51wgVXUTw (small blind) folded before Flop
Seat 2: 3zD3qLXT1bEffAoWGnc7wg (big blind) collected ($0.20)
Seat 3: lBoEwOFgzcERLIRUkUoRTw folded before Flop (didn't bet)
Seat 4: 7JyPCA0J2grhXQYxe1h3+A folded before Flop (didn't bet)
Seat 5: bJFzs6QmEEnz4miMfSDtcg folded before Flop (didn't bet)
Seat 6: Q1uciOZPBR/WkAlqa6cL4A (button) folded before Flop (didn't bet)




PokerStars Game #59941909746:  Hold'em No Limit ($0.10/$0.25) - 2009/07/01 1:50:03 ET
Table '8PD/MTROSMd6Y8mZeykbpg' 6-max Seat #2 is the button
Seat 1: fxNpaToxECtD2Goelmg9vA ($28.50 in chips) 
Seat 2: 4TM16KVgEiQpLi4bVVWbVQ ($26.95 in chips) 
Seat 3: vqWjZmdQu/Hxw96/IJTWdQ ($25 in chips) 
Seat 4: DFi/Lzkjsfv8QswS80JX9Q ($52.80 in chips) 
Seat 5: z3tQwy28dp5FykDJC/wzQw ($26.20 in chips) 
Seat 6: trN/oHqTTbPw5MNuKrOpLw ($25.25 in chips) 
vqWjZmdQu/Hxw96/IJTWdQ: posts small blind $0.10
DFi/Lzkjsfv8QswS80JX9Q: posts big blind $0.25
*** HOLE CARDS ***
z3tQwy28dp5FykDJC/wzQw: folds 
trN/oHqTTbPw5MNuKrOpLw: folds 
fxNpaToxECtD2Goelmg9vA: folds 
4TM16KVgEiQpLi4bVVWbVQ: raises $0.75 to $1
vqWjZmdQu/Hxw96/IJTWdQ: folds 
DFi/Lzkjsfv8QswS80JX9Q: calls $0.75
*** FLOP *** [4d 9s Jh]
DFi/Lzkjsfv8QswS80JX9Q: checks 
4TM16KVgEiQpLi4bVVWbVQ: bets $1.50
DFi/Lzkjsfv8QswS80JX9Q: calls $1.50
*** TURN *** [4d 9s Jh] [4c]
DFi/Lzkjsfv8QswS80JX9Q: checks 
4TM16KVgEiQpLi4bVVWbVQ: bets $2.50
DFi/Lzkjsfv8QswS80JX9Q: calls $2.50
*** RIVER *** [4d 9s Jh 4c] [6s]
DFi/Lzkjsfv8QswS80JX9Q: checks 
4TM16KVgEiQpLi4bVVWbVQ: bets $3.50
DFi/Lzkjsfv8QswS80JX9Q: folds 
Uncalled bet ($3.50) returned to 4TM16KVgEiQpLi4bVVWbVQ
4TM16KVgEiQpLi4bVVWbVQ collected $9.65 from pot
*** SUMMARY ***
Total pot $10.10 | Rake $0.45 
Board [4d 9s Jh 4c 6s]
Seat 1: fxNpaToxECtD2Goelmg9vA folded before Flop (didn't bet)
Seat 2: 4TM16KVgEiQpLi4bVVWbVQ (button) collected ($9.65)
Seat 3: vqWjZmdQu/Hxw96/IJTWdQ (small blind) folded before Flop
Seat 4: DFi/Lzkjsfv8QswS80JX9Q (big blind) folded on the River
Seat 5: z3tQwy28dp5FykDJC/wzQw folded before Flop (didn't bet)
Seat 6: trN/oHqTTbPw5MNuKrOpLw folded before Flop (didn't bet)




PokerStars Game #59941909616:  Hold'em No Limit ($0.10/$0.25) - 2009/07/01 1:50:03 ET
Table 'NtEQAxCeIK2io1CGtW658g' 6-max Seat #4 is the button
Seat 1: X437kMQ7AujoaDgjguhU9w ($11.55 in chips) 
Seat 2: DgyznDqq/mLiCqQGMzc+Aw ($9.15 in chips) 
Seat 3: 5nwDw10uIM0XEyLhla0oGA ($16.45 in chips) 
Seat 4: 8296 ($16.60 in chips) 
Seat 5: Hsvkc0/G2VV78oVmWYXecw ($6.95 in chips) 
Seat 6: /gJNBeCkWL4o85/jvlZ4BA ($64.35 in chips) 
Hsvkc0/G2VV78oVmWYXecw: posts small blind $0.10
/gJNBeCkWL4o85/jvlZ4BA: posts big blind $0.25
*** HOLE CARDS ***
X437kMQ7AujoaDgjguhU9w: raises $0.25 to $0.50
DgyznDqq/mLiCqQGMzc+Aw: folds 
5nwDw10uIM0XEyLhla0oGA: raises $1.25 to $1.75
8296: folds 
Hsvkc0/G2VV78oVmWYXecw: folds 
/gJNBeCkWL4o85/jvlZ4BA: calls $1.50
X437kMQ7AujoaDgjguhU9w: folds 
*** FLOP *** [8c 2s 7h]
/gJNBeCkWL4o85/jvlZ4BA: checks 
5nwDw10uIM0XEyLhla0oGA: checks 
*** TURN *** [8c 2s 7h] [8h]
/gJNBeCkWL4o85/jvlZ4BA: bets $0.75
5nwDw10uIM0XEyLhla0oGA: calls $0.75
*** RIVER *** [8c 2s 7h 8h] [9c]
/gJNBeCkWL4o85/jvlZ4BA: bets $4
5nwDw10uIM0XEyLhla0oGA: calls $4
*** SHOW DOWN ***
/gJNBeCkWL4o85/jvlZ4BA: shows [7d 7s] (a full house, Sevens full of Eights)
5nwDw10uIM0XEyLhla0oGA: mucks hand 
/gJNBeCkWL4o85/jvlZ4BA collected $12.95 from pot
*** SUMMARY ***
Total pot $13.60 | Rake $0.65 
Board [8c 2s 7h 8h 9c]
Seat 1: X437kMQ7AujoaDgjguhU9w folded before Flop
Seat 2: DgyznDqq/mLiCqQGMzc+Aw folded before Flop (didn't bet)
Seat 3: 5nwDw10uIM0XEyLhla0oGA mucked
Seat 4: 8296 (button) folded before Flop (didn't bet)
Seat 5: Hsvkc0/G2VV78oVmWYXecw (small blind) folded before Flop
Seat 6: /gJNBeCkWL4o85/jvlZ4BA (big blind) showed [7d 7s] and won ($12.95) with a full house, Sevens full of Eights




PokerStars Game #59941909964:  Hold'em No Limit ($0.10/$0.25) - 2009/07/01 1:50:03 ET
Table 'WY+lMaAoIdBZmwk27/RJCA' 6-max Seat #4 is the button
Seat 1: zHHLkD2sRljslKKeQv/ZQw ($26.60 in chips) 
Seat 2: NhUN/JpAprdJeamFBgJH1w ($28.25 in chips) 
Seat 3: QqiZLFrN8iOUT/GHw7ztOA ($26.60 in chips) 
Seat 4: 0av6tRNdi0Ui4f15L7gsVg ($23.15 in chips) 
Seat 5: vqWjZmdQu/Hxw96/IJTWdQ ($28.05 in chips) 
Seat 6: cWc85bEzdRzpUMhRKm8pwQ ($26.10 in chips) 
vqWjZmdQu/Hxw96/IJTWdQ: posts small blind $0.10
cWc85bEzdRzpUMhRKm8pwQ: posts big blind $0.25
*** HOLE CARDS ***
zHHLkD2sRljslKKeQv/ZQw: calls $0.25
NhUN/JpAprdJeamFBgJH1w: folds 
QqiZLFrN8iOUT/GHw7ztOA: folds 
0av6tRNdi0Ui4f15L7gsVg: folds 
vqWjZmdQu/Hxw96/IJTWdQ: folds 
cWc85bEzdRzpUMhRKm8pwQ: checks 
*** FLOP *** [Th Jc 4s]
cWc85bEzdRzpUMhRKm8pwQ: checks 
zHHLkD2sRljslKKeQv/ZQw: checks 
*** TURN *** [Th Jc 4s] [6d]
cWc85bEzdRzpUMhRKm8pwQ: checks 
zHHLkD2sRljslKKeQv/ZQw: checks 
*** RIVER *** [Th Jc 4s 6d] [Kh]
cWc85bEzdRzpUMhRKm8pwQ: checks 
zHHLkD2sRljslKKeQv/ZQw: checks 
*** SHOW DOWN ***
cWc85bEzdRzpUMhRKm8pwQ: shows [4c Ah] (a pair of Fours)
zHHLkD2sRljslKKeQv/ZQw: mucks hand 
cWc85bEzdRzpUMhRKm8pwQ collected $0.60 from pot
*** SUMMARY ***
Total pot $0.60 | Rake $0 
Board [Th Jc 4s 6d Kh]
Seat 1: zHHLkD2sRljslKKeQv/ZQw mucked
Seat 2: NhUN/JpAprdJeamFBgJH1w folded before Flop (didn't bet)
Seat 3: QqiZLFrN8iOUT/GHw7ztOA folded before Flop (didn't bet)
Seat 4: 0av6tRNdi0Ui4f15L7gsVg (button) folded before Flop (didn't bet)
Seat 5: vqWjZmdQu/Hxw96/IJTWdQ (small blind) folded before Flop
Seat 6: cWc85bEzdRzpUMhRKm8pwQ (big blind) showed [4c Ah] and won ($0.60) with a pair of Fours




PokerStars Game #59941910480:  Hold'em No Limit ($0.10/$0.25) - 2009/07/01 1:50:04 ET
Table '+2VxGVfkEqJ1AYfQy/JH2w' 6-max Seat #2 is the button
Seat 1: if4dh6jhJXeN3/qd3qCp9g ($27 in chips) 
Seat 2: qllppsCmUqovlriIWCeM/g ($6.55 in chips) 
Seat 3: epAUIB7h2FJXzUPRIvSkRA ($25 in chips) 
Seat 4: y+a/yGW/Jy4bPJFnaeTz5w ($16.60 in chips) 
Seat 5: XD1i5m5PvBDnRzJaG/vINw ($23.90 in chips) 
Seat 6: YQNVDzvw3TmGaFiq9MhRgA ($5.85 in chips) 
epAUIB7h2FJXzUPRIvSkRA: posts small blind $0.10
y+a/yGW/Jy4bPJFnaeTz5w: posts big blind $0.25
*** HOLE CARDS ***
XD1i5m5PvBDnRzJaG/vINw: folds 
YQNVDzvw3TmGaFiq9MhRgA: folds 
if4dh6jhJXeN3/qd3qCp9g: raises $0.50 to $0.75
qllppsCmUqovlriIWCeM/g: calls $0.75
epAUIB7h2FJXzUPRIvSkRA: folds 
y+a/yGW/Jy4bPJFnaeTz5w: folds 
*** FLOP *** [3c 6c 7h]
if4dh6jhJXeN3/qd3qCp9g: bets $1
qllppsCmUqovlriIWCeM/g: folds 
Uncalled bet ($1) returned to if4dh6jhJXeN3/qd3qCp9g
if4dh6jhJXeN3/qd3qCp9g collected $1.80 from pot
if4dh6jhJXeN3/qd3qCp9g: doesn't show hand 
*** SUMMARY ***
Total pot $1.85 | Rake $0.05 
Board [3c 6c 7h]
Seat 1: if4dh6jhJXeN3/qd3qCp9g collected ($1.80)
Seat 2: qllppsCmUqovlriIWCeM/g (button) folded on the Flop
Seat 3: epAUIB7h2FJXzUPRIvSkRA (small blind) folded before Flop
Seat 4: y+a/yGW/Jy4bPJFnaeTz5w (big blind) folded before Flop
Seat 5: XD1i5m5PvBDnRzJaG/vINw folded before Flop (didn't bet)
Seat 6: YQNVDzvw3TmGaFiq9MhRgA folded before Flop (didn't bet)




PokerStars Game #59941910334:  Hold'em No Limit ($0.10/$0.25) - 2009/07/01 1:50:04 ET
Table 'mk323gviqdkOY5Aek/1EWg' 6-max Seat #4 is the button
Seat 1: 7cx44/slbeTw+Cy7QB8Trg ($25 in chips) 
Seat 2: GC/9yVD59DUCX7hUI7gcLw ($54.05 in chips) 
Seat 3: NuqYPwTLZYQhxOoVK3Yqlw ($27.30 in chips) 
Seat 4: +baiVgI/ETnBARLe5mARCw ($11.20 in chips) 
Seat 5: kjYRzIfvZNNflYMYRkkSVA ($36.40 in chips) 
Seat 6: KkXSr5xFjxLSD3wtAvT+WQ ($7.75 in chips) 
kjYRzIfvZNNflYMYRkkSVA: posts small blind $0.10
KkXSr5xFjxLSD3wtAvT+WQ: posts big blind $0.25
*** HOLE CARDS ***
7cx44/slbeTw+Cy7QB8Trg: folds 
GC/9yVD59DUCX7hUI7gcLw: folds 
NuqYPwTLZYQhxOoVK3Yqlw: folds 
+baiVgI/ETnBARLe5mARCw: folds 
kjYRzIfvZNNflYMYRkkSVA: folds 
Uncalled bet ($0.15) returned to KkXSr5xFjxLSD3wtAvT+WQ
KkXSr5xFjxLSD3wtAvT+WQ collected $0.20 from pot
KkXSr5xFjxLSD3wtAvT+WQ: doesn't show hand 
*** SUMMARY ***
Total pot $0.20 | Rake $0 
Seat 1: 7cx44/slbeTw+Cy7QB8Trg folded before Flop (didn't bet)
Seat 2: GC/9yVD59DUCX7hUI7gcLw folded before Flop (didn't bet)
Seat 3: NuqYPwTLZYQhxOoVK3Yqlw folded before Flop (didn't bet)
Seat 4: +baiVgI/ETnBARLe5mARCw (button) folded before Flop (didn't bet)
Seat 5: kjYRzIfvZNNflYMYRkkSVA (small blind) folded before Flop
Seat 6: KkXSr5xFjxLSD3wtAvT+WQ (big blind) collected ($0.20)




PokerStars Game #59941910130:  Hold'em No Limit ($0.10/$0.25) - 2009/07/01 1:50:04 ET
Table 'mF3KHGMaTpaBZbtBoyfTeg' 6-max Seat #2 is the button
Seat 1: 0HAB2GdCAM7p7V00xueAVQ ($36.50 in chips) 
Seat 2: xrf8tAXKQHG99HixCot1Iw ($24.95 in chips) 
Seat 5: 8ClCHtFXGNplITm+63KB+Q ($45.35 in chips) 
Seat 6: kG34n23qFQA3nzdOJTQ1dA ($26.80 in chips) 
FYepjhAvF8ZdVCmqHIy+eQ: is sitting out 
8ClCHtFXGNplITm+63KB+Q: posts small blind $0.10
kG34n23qFQA3nzdOJTQ1dA: posts big blind $0.25
*** HOLE CARDS ***
FYepjhAvF8ZdVCmqHIy+eQ leaves the table
0HAB2GdCAM7p7V00xueAVQ: calls $0.25
9kUKGKkblnIx3m8rlVol6Q has returned
xrf8tAXKQHG99HixCot1Iw: raises $0.75 to $1
8ClCHtFXGNplITm+63KB+Q: folds 
kG34n23qFQA3nzdOJTQ1dA: folds 
0HAB2GdCAM7p7V00xueAVQ: calls $0.75
*** FLOP *** [8h 8s As]
0HAB2GdCAM7p7V00xueAVQ: checks 
xrf8tAXKQHG99HixCot1Iw: bets $1.25
0HAB2GdCAM7p7V00xueAVQ: calls $1.25
*** TURN *** [8h 8s As] [Qd]
0HAB2GdCAM7p7V00xueAVQ: checks 
xrf8tAXKQHG99HixCot1Iw: checks 
*** RIVER *** [8h 8s As Qd] [Js]
0HAB2GdCAM7p7V00xueAVQ: checks 
xrf8tAXKQHG99HixCot1Iw: bets $3.75
0HAB2GdCAM7p7V00xueAVQ: folds 
Uncalled bet ($3.75) returned to xrf8tAXKQHG99HixCot1Iw
xrf8tAXKQHG99HixCot1Iw collected $4.65 from pot
xrf8tAXKQHG99HixCot1Iw: doesn't show hand 
*** SUMMARY ***
Total pot $4.85 | Rake $0.20 
Board [8h 8s As Qd Js]
Seat 1: 0HAB2GdCAM7p7V00xueAVQ folded on the River
Seat 2: xrf8tAXKQHG99HixCot1Iw (button) collected ($4.65)
Seat 5: 8ClCHtFXGNplITm+63KB+Q (small blind) folded before Flop
Seat 6: kG34n23qFQA3nzdOJTQ1dA (big blind) folded before Flop




PokerStars Game #59941911120:  Hold'em No Limit ($0.10/$0.25) - 2009/07/01 1:50:05 ET
Table 'O6cwjhrMn9pfzx1Ngn5zkQ' 6-max Seat #5 is the button
Seat 1: LJI7A1YgDM7hgh7o56+ReQ ($27.45 in chips) 
Seat 3: EE16Ua5b1HSsYej5zeXOlA ($26.15 in chips) 
Seat 4: mfrkWA3PTeYPkbO6hi98Aw ($24.50 in chips) 
Seat 5: niLn0xUVlqh8If80xRjzCA ($28.60 in chips) 
Seat 6: 4TM16KVgEiQpLi4bVVWbVQ ($32.30 in chips) 
4TM16KVgEiQpLi4bVVWbVQ: posts small blind $0.10
LJI7A1YgDM7hgh7o56+ReQ: posts big blind $0.25
8CPg15X6IHYR1pWm9ha1Sw: sits out 
*** HOLE CARDS ***
EE16Ua5b1HSsYej5zeXOlA: folds 
mfrkWA3PTeYPkbO6hi98Aw: raises $0.75 to $1
niLn0xUVlqh8If80xRjzCA: folds 
4TM16KVgEiQpLi4bVVWbVQ: folds 
LJI7A1YgDM7hgh7o56+ReQ: folds 
Uncalled bet ($0.75) returned to mfrkWA3PTeYPkbO6hi98Aw
mfrkWA3PTeYPkbO6hi98Aw collected $0.60 from pot
mfrkWA3PTeYPkbO6hi98Aw: doesn't show hand 
*** SUMMARY ***
Total pot $0.60 | Rake $0 
Seat 1: LJI7A1YgDM7hgh7o56+ReQ (big blind) folded before Flop
Seat 3: EE16Ua5b1HSsYej5zeXOlA folded before Flop (didn't bet)
Seat 4: mfrkWA3PTeYPkbO6hi98Aw collected ($0.60)
Seat 5: niLn0xUVlqh8If80xRjzCA (button) folded before Flop (didn't bet)
Seat 6: 4TM16KVgEiQpLi4bVVWbVQ (small blind) folded before Flop




PokerStars Game #59941910734:  Hold'em No Limit ($0.10/$0.25) - 2009/07/01 1:50:05 ET
Table 'BmUMTVcNATeov2rAGYU0Qg' 9-max Seat #7 is the button
Seat 1: QEbIGci+itdw+re8RM5fZA ($33.60 in chips) 
Seat 2: jJnMGXoBXye+afMd0k0rUw ($11.65 in chips) 
Seat 3: ir5Jy8ck6DrdqgJ/3chcWw ($10.40 in chips) 
Seat 4: aNpwfA31EREwO+ar4XzBCw ($37.35 in chips) 
Seat 5: QBNcj9fHxkh/+s/oVw+JmQ ($24 in chips) 
Seat 6: w1ukf8uPa4+WH561TtVRxA ($25.35 in chips) 
Seat 7: CmngQmkKTp8tkl6GMRTl6w ($10.10 in chips) 
Seat 8: Jve2LRs9vtGL7NdiNeXY/A ($13 in chips) 
Seat 9: /artgaAtyUtUtD8FZo6puA ($9.10 in chips) 
Jve2LRs9vtGL7NdiNeXY/A: posts small blind $0.10
/artgaAtyUtUtD8FZo6puA: posts big blind $0.25
*** HOLE CARDS ***
QEbIGci+itdw+re8RM5fZA: folds 
jJnMGXoBXye+afMd0k0rUw: folds 
ir5Jy8ck6DrdqgJ/3chcWw: calls $0.25
aNpwfA31EREwO+ar4XzBCw: folds 
QBNcj9fHxkh/+s/oVw+JmQ: folds 
w1ukf8uPa4+WH561TtVRxA: folds 
CmngQmkKTp8tkl6GMRTl6w: folds 
Jve2LRs9vtGL7NdiNeXY/A: calls $0.15
/artgaAtyUtUtD8FZo6puA: checks 
*** FLOP *** [5s Ah Jc]
Jve2LRs9vtGL7NdiNeXY/A: checks 
/artgaAtyUtUtD8FZo6puA: checks 
ir5Jy8ck6DrdqgJ/3chcWw: bets $0.50
Jve2LRs9vtGL7NdiNeXY/A: folds 
/artgaAtyUtUtD8FZo6puA: calls $0.50
*** TURN *** [5s Ah Jc] [5c]
/artgaAtyUtUtD8FZo6puA: checks 
ir5Jy8ck6DrdqgJ/3chcWw: bets $0.50
/artgaAtyUtUtD8FZo6puA: calls $0.50
*** RIVER *** [5s Ah Jc 5c] [8h]
/artgaAtyUtUtD8FZo6puA: bets $0.25
ir5Jy8ck6DrdqgJ/3chcWw: raises $0.75 to $1
/artgaAtyUtUtD8FZo6puA: raises $6.85 to $7.85 and is all-in
ir5Jy8ck6DrdqgJ/3chcWw: calls $6.85
*** SHOW DOWN ***
/artgaAtyUtUtD8FZo6puA: shows [Ad Jh] (two pair, Aces and Jacks)
ir5Jy8ck6DrdqgJ/3chcWw: shows [5h As] (a full house, Fives full of Aces)
ir5Jy8ck6DrdqgJ/3chcWw collected $17.55 from pot
*** SUMMARY ***
Total pot $18.45 | Rake $0.90 
Board [5s Ah Jc 5c 8h]
Seat 1: QEbIGci+itdw+re8RM5fZA folded before Flop (didn't bet)
Seat 2: jJnMGXoBXye+afMd0k0rUw folded before Flop (didn't bet)
Seat 3: ir5Jy8ck6DrdqgJ/3chcWw showed [5h As] and won ($17.55) with a full house, Fives full of Aces
Seat 4: aNpwfA31EREwO+ar4XzBCw folded before Flop (didn't bet)
Seat 5: QBNcj9fHxkh/+s/oVw+JmQ folded before Flop (didn't bet)
Seat 6: w1ukf8uPa4+WH561TtVRxA folded before Flop (didn't bet)
Seat 7: CmngQmkKTp8tkl6GMRTl6w (button) folded before Flop (didn't bet)
Seat 8: Jve2LRs9vtGL7NdiNeXY/A (small blind) folded on the Flop
Seat 9: /artgaAtyUtUtD8FZo6puA (big blind) showed [Ad Jh] and lost with two pair, Aces and Jacks




PokerStars Game #59941910752:  Hold'em No Limit ($0.10/$0.25) - 2009/07/01 1:50:05 ET
Table 'BabJGL6tfXQp3leBGbYe8A' 9-max Seat #8 is the button
Seat 1: qwr38jl5txoR36M7G5qi4A ($10.35 in chips) 
Seat 2: dtZ84flFEi4Q+SGrHMJRDQ ($40.50 in chips) 
Seat 3: sD+TKtt36XiiN6jqHiLwDA ($28.80 in chips) 
Seat 4: gehe91e0IyVT0QU/XBkEyg ($27.85 in chips) 
Seat 5: GrNTWMdwy+jC6Lred1eDng ($10 in chips) 
Seat 6: egvg3mTBBVzMHnJPIQiKcA ($13.90 in chips) 
Seat 7: eK8qa6EPcH2zhtbmWSvc9g ($28.20 in chips) 
Seat 8: OXPkK84/qv92EMwXPiG5rQ ($9.25 in chips) 
Seat 9: P+9ymZQ3ktpQu1bn7HIjew ($9.25 in chips) 
P+9ymZQ3ktpQu1bn7HIjew: posts small blind $0.10
qwr38jl5txoR36M7G5qi4A: posts big blind $0.25
*** HOLE CARDS ***
dtZ84flFEi4Q+SGrHMJRDQ: folds 
sD+TKtt36XiiN6jqHiLwDA: folds 
gehe91e0IyVT0QU/XBkEyg: folds 
GrNTWMdwy+jC6Lred1eDng: folds 
egvg3mTBBVzMHnJPIQiKcA: folds 
eK8qa6EPcH2zhtbmWSvc9g: folds 
OXPkK84/qv92EMwXPiG5rQ: folds 
P+9ymZQ3ktpQu1bn7HIjew: folds 
Uncalled bet ($0.15) returned to qwr38jl5txoR36M7G5qi4A
qwr38jl5txoR36M7G5qi4A collected $0.20 from pot
qwr38jl5txoR36M7G5qi4A: doesn't show hand 
*** SUMMARY ***
Total pot $0.20 | Rake $0 
Seat 1: qwr38jl5txoR36M7G5qi4A (big blind) collected ($0.20)
Seat 2: dtZ84flFEi4Q+SGrHMJRDQ folded before Flop (didn't bet)
Seat 3: sD+TKtt36XiiN6jqHiLwDA folded before Flop (didn't bet)
Seat 4: gehe91e0IyVT0QU/XBkEyg folded before Flop (didn't bet)
Seat 5: GrNTWMdwy+jC6Lred1eDng folded before Flop (didn't bet)
Seat 6: egvg3mTBBVzMHnJPIQiKcA folded before Flop (didn't bet)
Seat 7: eK8qa6EPcH2zhtbmWSvc9g folded before Flop (didn't bet)
Seat 8: OXPkK84/qv92EMwXPiG5rQ (button) folded before Flop (didn't bet)
Seat 9: P+9ymZQ3ktpQu1bn7HIjew (small blind) folded before Flop




PokerStars Game #59941910880:  Hold'em No Limit ($0.10/$0.25) - 2009/07/01 1:50:05 ET
Table 'r562aMIMs5kgo28FEU6lkA' 9-max Seat #9 is the button
Seat 1: H5Se03ZqSX7tbULXur2MAg ($14.55 in chips) 
Seat 2: N8muFAHrFHW6elSMGuyVLQ ($25.35 in chips) 
Seat 3: xoBFd/5k+L/pFn9VW1VyWg ($10.60 in chips) 
Seat 4: V6p0jQ/RhUsqpHLmXvEX4Q ($19.75 in chips) 
Seat 5: zDrucyjVn5aeekNEc3cJrA ($35.20 in chips) 
Seat 6: RCqMONFrSPSArZh2Jsar/w ($20 in chips) 
Seat 7: Bb42QRQMhg5/Y0vHP8/2Xw ($25 in chips) 
Seat 8: B6xHiX1SJkS0CUNCKDVwuQ ($20.90 in chips) 
Seat 9: yyG4svzOpC1A+sUP/scg6w ($7 in chips) 
H5Se03ZqSX7tbULXur2MAg: posts small blind $0.10
N8muFAHrFHW6elSMGuyVLQ: posts big blind $0.25
*** HOLE CARDS ***
xoBFd/5k+L/pFn9VW1VyWg: folds 
V6p0jQ/RhUsqpHLmXvEX4Q: folds 
zDrucyjVn5aeekNEc3cJrA: folds 
RCqMONFrSPSArZh2Jsar/w: folds 
Bb42QRQMhg5/Y0vHP8/2Xw: folds 
B6xHiX1SJkS0CUNCKDVwuQ: calls $0.25
yyG4svzOpC1A+sUP/scg6w: folds 
H5Se03ZqSX7tbULXur2MAg: folds 
N8muFAHrFHW6elSMGuyVLQ: checks 
*** FLOP *** [3c Qs Ac]
N8muFAHrFHW6elSMGuyVLQ: checks 
B6xHiX1SJkS0CUNCKDVwuQ: checks 
*** TURN *** [3c Qs Ac] [5s]
N8muFAHrFHW6elSMGuyVLQ: bets $0.50
B6xHiX1SJkS0CUNCKDVwuQ: folds 
Uncalled bet ($0.50) returned to N8muFAHrFHW6elSMGuyVLQ
N8muFAHrFHW6elSMGuyVLQ collected $0.60 from pot
N8muFAHrFHW6elSMGuyVLQ: doesn't show hand 
*** SUMMARY ***
Total pot $0.60 | Rake $0 
Board [3c Qs Ac 5s]
Seat 1: H5Se03ZqSX7tbULXur2MAg (small blind) folded before Flop
Seat 2: N8muFAHrFHW6elSMGuyVLQ (big blind) collected ($0.60)
Seat 3: xoBFd/5k+L/pFn9VW1VyWg folded before Flop (didn't bet)
Seat 4: V6p0jQ/RhUsqpHLmXvEX4Q folded before Flop (didn't bet)
Seat 5: zDrucyjVn5aeekNEc3cJrA folded before Flop (didn't bet)
Seat 6: RCqMONFrSPSArZh2Jsar/w folded before Flop (didn't bet)
Seat 7: Bb42QRQMhg5/Y0vHP8/2Xw folded before Flop (didn't bet)
Seat 8: B6xHiX1SJkS0CUNCKDVwuQ folded on the Turn
Seat 9: yyG4svzOpC1A+sUP/scg6w (button) folded before Flop (didn't bet)




PokerStars Game #59941911032:  Hold'em No Limit ($0.10/$0.25) - 2009/07/01 1:50:05 ET
Table 'Jj2eLzVCUVAGBmM+Og79iQ' 9-max Seat #9 is the button
Seat 1: ShXPHWfjhfmAwLgDdm6bRQ ($7 in chips) 
Seat 2: 3BXzvZqgd3pARIFGfMXHww ($5 in chips) 
Seat 3: HPEB+AtKw1+C/cxU0o1ciw ($24.40 in chips) 
Seat 4: aNpwfA31EREwO+ar4XzBCw ($44.60 in chips) 
Seat 5: UkF1eqqUN0CCiimXAuN7og ($4.65 in chips) 
Seat 6: jZURAM/dgGCX+5lATlZugw ($17.35 in chips) 
Seat 7: K0b5wNInj6hUGRr6yzKFtw ($59.85 in chips) 
Seat 8: H5Se03ZqSX7tbULXur2MAg ($33.80 in chips) 
Seat 9: vSkQm2EelzwRGDDQQk0Fqw ($4.65 in chips) 
ShXPHWfjhfmAwLgDdm6bRQ: posts small blind $0.10
3BXzvZqgd3pARIFGfMXHww: posts big blind $0.25
*** HOLE CARDS ***
HPEB+AtKw1+C/cxU0o1ciw: folds 
aNpwfA31EREwO+ar4XzBCw: folds 
UkF1eqqUN0CCiimXAuN7og: folds 
jZURAM/dgGCX+5lATlZugw: folds 
K0b5wNInj6hUGRr6yzKFtw: folds 
H5Se03ZqSX7tbULXur2MAg: folds 
vSkQm2EelzwRGDDQQk0Fqw: folds 
ShXPHWfjhfmAwLgDdm6bRQ: folds 
Uncalled bet ($0.15) returned to 3BXzvZqgd3pARIFGfMXHww
3BXzvZqgd3pARIFGfMXHww collected $0.20 from pot
*** SUMMARY ***
Total pot $0.20 | Rake $0 
Seat 1: ShXPHWfjhfmAwLgDdm6bRQ (small blind) folded before Flop
Seat 2: 3BXzvZqgd3pARIFGfMXHww (big blind) collected ($0.20)
Seat 3: HPEB+AtKw1+C/cxU0o1ciw folded before Flop (didn't bet)
Seat 4: aNpwfA31EREwO+ar4XzBCw folded before Flop (didn't bet)
Seat 5: UkF1eqqUN0CCiimXAuN7og folded before Flop (didn't bet)
Seat 6: jZURAM/dgGCX+5lATlZugw folded before Flop (didn't bet)
Seat 7: K0b5wNInj6hUGRr6yzKFtw folded before Flop (didn't bet)
Seat 8: H5Se03ZqSX7tbULXur2MAg folded before Flop (didn't bet)
Seat 9: vSkQm2EelzwRGDDQQk0Fqw (button) folded before Flop (didn't bet)




PokerStars Game #59941910626:  Hold'em No Limit ($0.10/$0.25) - 2009/07/01 1:50:05 ET
Table 'tErGGDyESv/0llKumVeZuQ' 9-max Seat #1 is the button
Seat 1: 3PmVnC/15cl4oyI1TKIt4g ($5 in chips) 
Seat 2: pN3IHvAKm2fz+sTRARTcrg ($28.60 in chips) 
Seat 3: qwr38jl5txoR36M7G5qi4A ($10 in chips) 
Seat 4: yqkowiRWZ6NvRN9UUkYIlA ($5 in chips) 
Seat 5: 6RQUxA3jk+ePxB/+Hc0IKw ($16.05 in chips) 
Seat 6: zDrucyjVn5aeekNEc3cJrA ($59.95 in chips) 
Seat 7: uhrboV251dcgYniYTdFIcA ($25 in chips) 
Seat 8: clJsV3v77RS07bDKY+705w ($5 in chips) 
Seat 9: d6n762oPkegG086ZJyV5MA ($27.75 in chips) 
pN3IHvAKm2fz+sTRARTcrg: posts small blind $0.10
qwr38jl5txoR36M7G5qi4A: posts big blind $0.25
zDrucyjVn5aeekNEc3cJrA: posts small & big blinds $0.35
*** HOLE CARDS ***
yqkowiRWZ6NvRN9UUkYIlA: folds 
6RQUxA3jk+ePxB/+Hc0IKw: calls $0.25
zDrucyjVn5aeekNEc3cJrA: checks 
uhrboV251dcgYniYTdFIcA: folds 
clJsV3v77RS07bDKY+705w: folds 
d6n762oPkegG086ZJyV5MA: calls $0.25
3PmVnC/15cl4oyI1TKIt4g: calls $0.25
pN3IHvAKm2fz+sTRARTcrg: calls $0.15
qwr38jl5txoR36M7G5qi4A: checks 
*** FLOP *** [9s Td 2c]
pN3IHvAKm2fz+sTRARTcrg: checks 
qwr38jl5txoR36M7G5qi4A: checks 
6RQUxA3jk+ePxB/+Hc0IKw: bets $2
zDrucyjVn5aeekNEc3cJrA: folds 
d6n762oPkegG086ZJyV5MA: folds 
3PmVnC/15cl4oyI1TKIt4g: folds 
pN3IHvAKm2fz+sTRARTcrg: folds 
qwr38jl5txoR36M7G5qi4A: folds 
Uncalled bet ($2) returned to 6RQUxA3jk+ePxB/+Hc0IKw
6RQUxA3jk+ePxB/+Hc0IKw collected $1.55 from pot
6RQUxA3jk+ePxB/+Hc0IKw: doesn't show hand 
*** SUMMARY ***
Total pot $1.60 | Rake $0.05 
Board [9s Td 2c]
Seat 1: 3PmVnC/15cl4oyI1TKIt4g (button) folded on the Flop
Seat 2: pN3IHvAKm2fz+sTRARTcrg (small blind) folded on the Flop
Seat 3: qwr38jl5txoR36M7G5qi4A (big blind) folded on the Flop
Seat 4: yqkowiRWZ6NvRN9UUkYIlA folded before Flop (didn't bet)
Seat 5: 6RQUxA3jk+ePxB/+Hc0IKw collected ($1.55)
Seat 6: zDrucyjVn5aeekNEc3cJrA folded on the Flop
Seat 7: uhrboV251dcgYniYTdFIcA folded before Flop (didn't bet)
Seat 8: clJsV3v77RS07bDKY+705w folded before Flop (didn't bet)
Seat 9: d6n762oPkegG086ZJyV5MA folded on the Flop




PokerStars Game #59941910786:  Hold'em No Limit ($0.10/$0.25) - 2009/07/01 1:50:05 ET
Table 'Do4nrTNDYpK3sQjwFxX+Og' 6-max Seat #3 is the button
Seat 1: 7JrQNOR9wRBxq9ijFhWieg ($36.90 in chips) 
Seat 2: tzMoGl9F0PUr5NibYueeSw ($71.15 in chips) 
Seat 3: TSmua8tGK3sTbwi0ynrW9Q ($25 in chips) 
Seat 4: cWc85bEzdRzpUMhRKm8pwQ ($32.80 in chips) 
Seat 5: SxIIgwXYLkwd6m3wLyPTCw ($25 in chips) 
Seat 6: lBoEwOFgzcERLIRUkUoRTw ($23.20 in chips) 
cWc85bEzdRzpUMhRKm8pwQ: posts small blind $0.10
SxIIgwXYLkwd6m3wLyPTCw: posts big blind $0.25
*** HOLE CARDS ***
lBoEwOFgzcERLIRUkUoRTw: raises $0.75 to $1
7JrQNOR9wRBxq9ijFhWieg: folds 
tzMoGl9F0PUr5NibYueeSw: folds 
TSmua8tGK3sTbwi0ynrW9Q: folds 
cWc85bEzdRzpUMhRKm8pwQ: folds 
SxIIgwXYLkwd6m3wLyPTCw: calls $0.75
*** FLOP *** [9h 6c 2c]
SxIIgwXYLkwd6m3wLyPTCw: checks 
lBoEwOFgzcERLIRUkUoRTw: bets $5
SxIIgwXYLkwd6m3wLyPTCw: folds 
Uncalled bet ($5) returned to lBoEwOFgzcERLIRUkUoRTw
lBoEwOFgzcERLIRUkUoRTw collected $2 from pot
*** SUMMARY ***
Total pot $2.10 | Rake $0.10 
Board [9h 6c 2c]
Seat 1: 7JrQNOR9wRBxq9ijFhWieg folded before Flop (didn't bet)
Seat 2: tzMoGl9F0PUr5NibYueeSw folded before Flop (didn't bet)
Seat 3: TSmua8tGK3sTbwi0ynrW9Q (button) folded before Flop (didn't bet)
Seat 4: cWc85bEzdRzpUMhRKm8pwQ (small blind) folded before Flop
Seat 5: SxIIgwXYLkwd6m3wLyPTCw (big blind) folded on the Flop
Seat 6: lBoEwOFgzcERLIRUkUoRTw collected ($2)




PokerStars Game #59941910696:  Hold'em No Limit ($0.10/$0.25) - 2009/07/01 1:50:05 ET
Table 'ER5H84HUgJx7HyDLnELLeA' 6-max Seat #4 is the button
Seat 1: LJI7A1YgDM7hgh7o56+ReQ ($26.25 in chips) 
Seat 2: buyjetgNT1McXtdaP4zynA ($20.90 in chips) 
Seat 3: cS21pIxRHx5Gt42o7hPZzw ($13 in chips) 
Seat 4: vqWjZmdQu/Hxw96/IJTWdQ ($25 in chips) 
Seat 5: mfrkWA3PTeYPkbO6hi98Aw ($26.45 in chips) 
Seat 6: 3zD3qLXT1bEffAoWGnc7wg ($51.35 in chips) 
mfrkWA3PTeYPkbO6hi98Aw: posts small blind $0.10
3zD3qLXT1bEffAoWGnc7wg: posts big blind $0.25
*** HOLE CARDS ***
LJI7A1YgDM7hgh7o56+ReQ: folds 
buyjetgNT1McXtdaP4zynA: calls $0.25
cS21pIxRHx5Gt42o7hPZzw: folds 
vqWjZmdQu/Hxw96/IJTWdQ: folds 
mfrkWA3PTeYPkbO6hi98Aw: calls $0.15
3zD3qLXT1bEffAoWGnc7wg: checks 
*** FLOP *** [Ks Js 5d]
mfrkWA3PTeYPkbO6hi98Aw: checks 
3zD3qLXT1bEffAoWGnc7wg: checks 
buyjetgNT1McXtdaP4zynA: checks 
*** TURN *** [Ks Js 5d] [Ts]
mfrkWA3PTeYPkbO6hi98Aw: checks 
3zD3qLXT1bEffAoWGnc7wg: checks 
buyjetgNT1McXtdaP4zynA: checks 
*** RIVER *** [Ks Js 5d Ts] [7s]
mfrkWA3PTeYPkbO6hi98Aw: checks 
3zD3qLXT1bEffAoWGnc7wg: checks 
buyjetgNT1McXtdaP4zynA: checks 
*** SHOW DOWN ***
mfrkWA3PTeYPkbO6hi98Aw: shows [3s 3h] (a flush, King high)
3zD3qLXT1bEffAoWGnc7wg: mucks hand 
buyjetgNT1McXtdaP4zynA: shows [5s 4c] (a flush, King high - Five higher)
buyjetgNT1McXtdaP4zynA collected $0.75 from pot
*** SUMMARY ***
Total pot $0.75 | Rake $0 
Board [Ks Js 5d Ts 7s]
Seat 1: LJI7A1YgDM7hgh7o56+ReQ folded before Flop (didn't bet)
Seat 2: buyjetgNT1McXtdaP4zynA showed [5s 4c] and won ($0.75) with a flush, King high
Seat 3: cS21pIxRHx5Gt42o7hPZzw folded before Flop (didn't bet)
Seat 4: vqWjZmdQu/Hxw96/IJTWdQ (button) folded before Flop (didn't bet)
Seat 5: mfrkWA3PTeYPkbO6hi98Aw (small blind) showed [3s 3h] and lost with a flush, King high
Seat 6: 3zD3qLXT1bEffAoWGnc7wg (big blind) mucked




PokerStars Game #59941910770:  Hold'em No Limit ($0.10/$0.25) - 2009/07/01 1:50:05 ET
Table 'BpNkESDX1ip9c0K1hb5h7A' 6-max Seat #5 is the button
Seat 1: 5YZdVjBPZVEdubN4xEMPEg ($12.50 in chips) 
Seat 2: 9U3ZKjCsarN0DjR6mSE8Ug ($19.60 in chips) 
Seat 3: fZQg9veL7Dd/Z04ZTjC+wQ ($37.15 in chips) 
Seat 4: kG34n23qFQA3nzdOJTQ1dA ($26.50 in chips) 
Seat 5: OMGl+YMGogf2JWIRfT2/Yg ($5.65 in chips) 
Seat 6: 8EEqTTh7T1q48sYDqbI2Xg ($22.05 in chips) 
8EEqTTh7T1q48sYDqbI2Xg: posts small blind $0.10
5YZdVjBPZVEdubN4xEMPEg: posts big blind $0.25
*** HOLE CARDS ***
9U3ZKjCsarN0DjR6mSE8Ug: folds 
fZQg9veL7Dd/Z04ZTjC+wQ: folds 
kG34n23qFQA3nzdOJTQ1dA: folds 
OMGl+YMGogf2JWIRfT2/Yg: calls $0.25
8EEqTTh7T1q48sYDqbI2Xg: calls $0.15
5YZdVjBPZVEdubN4xEMPEg: raises $0.75 to $1
OMGl+YMGogf2JWIRfT2/Yg: calls $0.75
8EEqTTh7T1q48sYDqbI2Xg: folds 
*** FLOP *** [Ks Th Tc]
5YZdVjBPZVEdubN4xEMPEg: checks 
OMGl+YMGogf2JWIRfT2/Yg: bets $0.65
5YZdVjBPZVEdubN4xEMPEg: calls $0.65
*** TURN *** [Ks Th Tc] [9s]
5YZdVjBPZVEdubN4xEMPEg: checks 
OMGl+YMGogf2JWIRfT2/Yg: bets $1.50
5YZdVjBPZVEdubN4xEMPEg: folds 
Uncalled bet ($1.50) returned to OMGl+YMGogf2JWIRfT2/Yg
OMGl+YMGogf2JWIRfT2/Yg collected $3.40 from pot
OMGl+YMGogf2JWIRfT2/Yg: doesn't show hand 
*** SUMMARY ***
Total pot $3.55 | Rake $0.15 
Board [Ks Th Tc 9s]
Seat 1: 5YZdVjBPZVEdubN4xEMPEg (big blind) folded on the Turn
Seat 2: 9U3ZKjCsarN0DjR6mSE8Ug folded before Flop (didn't bet)
Seat 3: fZQg9veL7Dd/Z04ZTjC+wQ folded before Flop (didn't bet)
Seat 4: kG34n23qFQA3nzdOJTQ1dA folded before Flop (didn't bet)
Seat 5: OMGl+YMGogf2JWIRfT2/Yg (button) collected ($3.40)
Seat 6: 8EEqTTh7T1q48sYDqbI2Xg (small blind) folded before Flop




PokerStars Game #59941911298:  Hold'em No Limit ($0.10/$0.25) - 2009/07/01 1:50:06 ET
Table 'AJGgX1ZYM8d68SWMvaLttg' 6-max Seat #4 is the button
Seat 1: Q1uciOZPBR/WkAlqa6cL4A ($25 in chips) 
Seat 2: zHHLkD2sRljslKKeQv/ZQw ($25.50 in chips) 
Seat 3: 8ClCHtFXGNplITm+63KB+Q ($38.35 in chips) 
Seat 4: e30C3DfdG5TfPnR16/oMmA ($21.40 in chips) 
Seat 5: Hsvkc0/G2VV78oVmWYXecw ($5 in chips) 
Seat 6: UA5OsKS3VPaxa7uC8La/kA ($64 in chips) 
Hsvkc0/G2VV78oVmWYXecw: posts small blind $0.10
UA5OsKS3VPaxa7uC8La/kA: posts big blind $0.25
*** HOLE CARDS ***
Q1uciOZPBR/WkAlqa6cL4A: folds 
zHHLkD2sRljslKKeQv/ZQw: folds 
8ClCHtFXGNplITm+63KB+Q: folds 
e30C3DfdG5TfPnR16/oMmA: raises $0.50 to $0.75
Hsvkc0/G2VV78oVmWYXecw: folds 
UA5OsKS3VPaxa7uC8La/kA: folds 
Uncalled bet ($0.50) returned to e30C3DfdG5TfPnR16/oMmA
e30C3DfdG5TfPnR16/oMmA collected $0.60 from pot
*** SUMMARY ***
Total pot $0.60 | Rake $0 
Seat 1: Q1uciOZPBR/WkAlqa6cL4A folded before Flop (didn't bet)
Seat 2: zHHLkD2sRljslKKeQv/ZQw folded before Flop (didn't bet)
Seat 3: 8ClCHtFXGNplITm+63KB+Q folded before Flop (didn't bet)
Seat 4: e30C3DfdG5TfPnR16/oMmA (button) collected ($0.60)
Seat 5: Hsvkc0/G2VV78oVmWYXecw (small blind) folded before Flop
Seat 6: UA5OsKS3VPaxa7uC8La/kA (big blind) folded before Flop




PokerStars Game #59941911208:  Hold'em No Limit ($0.10/$0.25) - 2009/07/01 1:50:06 ET
Table '9lYs7ljXi6AgFAxYHlKLJw' 9-max Seat #2 is the button
Seat 1: K0b5wNInj6hUGRr6yzKFtw ($36.65 in chips) 
Seat 2: 0XACOSNrAWmqNv9k1nF8rw ($16.35 in chips) 
Seat 3: arxNSjreDRGFg13EAM2F1w ($37.20 in chips) 
Seat 4: UANt6y/SmDCY/jIxkBixcw ($33 in chips) 
Seat 5: dfNim92Z6XK1/h5SFW5vDg ($47.95 in chips) 
Seat 6: tYsOBqdU1+x+yFI7zHO7hQ ($25 in chips) 
Seat 7: ghNKXUBl/H+t83JF079ZBA ($28.75 in chips) 
Seat 8: 9YN2IkT2JYYKFErZtZvCtA ($18.60 in chips) 
Seat 9: cKlmpQMahVsmOaxFQDcoOg ($18.40 in chips) 
arxNSjreDRGFg13EAM2F1w: posts small blind $0.10
UANt6y/SmDCY/jIxkBixcw: posts big blind $0.25
*** HOLE CARDS ***
dfNim92Z6XK1/h5SFW5vDg: raises $0.75 to $1
tYsOBqdU1+x+yFI7zHO7hQ: folds 
ghNKXUBl/H+t83JF079ZBA: folds 
9YN2IkT2JYYKFErZtZvCtA: folds 
cKlmpQMahVsmOaxFQDcoOg: calls $1
K0b5wNInj6hUGRr6yzKFtw: folds 
0XACOSNrAWmqNv9k1nF8rw: calls $1
arxNSjreDRGFg13EAM2F1w: folds 
UANt6y/SmDCY/jIxkBixcw: folds 
*** FLOP *** [4s Qd 9h]
dfNim92Z6XK1/h5SFW5vDg: bets $2.25
cKlmpQMahVsmOaxFQDcoOg: calls $2.25
0XACOSNrAWmqNv9k1nF8rw: folds 
*** TURN *** [4s Qd 9h] [9d]
dfNim92Z6XK1/h5SFW5vDg: bets $3
cKlmpQMahVsmOaxFQDcoOg: calls $3
*** RIVER *** [4s Qd 9h 9d] [2d]
dfNim92Z6XK1/h5SFW5vDg: bets $4.75
cKlmpQMahVsmOaxFQDcoOg: calls $4.75
*** SHOW DOWN ***
dfNim92Z6XK1/h5SFW5vDg: shows [Kc Ks] (two pair, Kings and Nines)
cKlmpQMahVsmOaxFQDcoOg: mucks hand 
dfNim92Z6XK1/h5SFW5vDg collected $22.25 from pot
*** SUMMARY ***
Total pot $23.35 | Rake $1.10 
Board [4s Qd 9h 9d 2d]
Seat 1: K0b5wNInj6hUGRr6yzKFtw folded before Flop (didn't bet)
Seat 2: 0XACOSNrAWmqNv9k1nF8rw (button) folded on the Flop
Seat 3: arxNSjreDRGFg13EAM2F1w (small blind) folded before Flop
Seat 4: UANt6y/SmDCY/jIxkBixcw (big blind) folded before Flop
Seat 5: dfNim92Z6XK1/h5SFW5vDg showed [Kc Ks] and won ($22.25) with two pair, Kings and Nines
Seat 6: tYsOBqdU1+x+yFI7zHO7hQ folded before Flop (didn't bet)
Seat 7: ghNKXUBl/H+t83JF079ZBA folded before Flop (didn't bet)
Seat 8: 9YN2IkT2JYYKFErZtZvCtA folded before Flop (didn't bet)
Seat 9: cKlmpQMahVsmOaxFQDcoOg mucked




PokerStars Game #59941911156:  Hold'em No Limit ($0.10/$0.25) - 2009/07/01 1:50:06 ET
Table 'dZNBGqFYSwfOVZvDJ4VjIQ' 6-max Seat #3 is the button
Seat 1: v+QfkGiuj9bgtuNoVnDO8w ($38 in chips) 
Seat 2: 3zD3qLXT1bEffAoWGnc7wg ($27.95 in chips) 
Seat 3: kyRaCIljYA6l33lSKQfNsg ($29.35 in chips) 
Seat 5: +ZlnqPoP3Hg4BIUxDfKd/A ($29.20 in chips) 
Seat 6: ypmjhffk/YHGc51wgVXUTw ($29.05 in chips) 
+ZlnqPoP3Hg4BIUxDfKd/A: posts small blind $0.10
ypmjhffk/YHGc51wgVXUTw: posts big blind $0.25
*** HOLE CARDS ***
mFv3iBCtrw9XfCDRB0d46Q leaves the table
v+QfkGiuj9bgtuNoVnDO8w: folds 
GbCVUNssQ7mqsPWr7J4d3w joins the table at seat #4 
3zD3qLXT1bEffAoWGnc7wg: folds 
kyRaCIljYA6l33lSKQfNsg: folds 
+ZlnqPoP3Hg4BIUxDfKd/A: raises $0.75 to $1
ypmjhffk/YHGc51wgVXUTw: calls $0.75
*** FLOP *** [4c Js 6s]
+ZlnqPoP3Hg4BIUxDfKd/A: bets $1.50
ypmjhffk/YHGc51wgVXUTw: raises $4 to $5.50
+ZlnqPoP3Hg4BIUxDfKd/A: folds 
Uncalled bet ($4) returned to ypmjhffk/YHGc51wgVXUTw
ypmjhffk/YHGc51wgVXUTw collected $4.80 from pot
ypmjhffk/YHGc51wgVXUTw: doesn't show hand 
*** SUMMARY ***
Total pot $5 | Rake $0.20 
Board [4c Js 6s]
Seat 1: v+QfkGiuj9bgtuNoVnDO8w folded before Flop (didn't bet)
Seat 2: 3zD3qLXT1bEffAoWGnc7wg folded before Flop (didn't bet)
Seat 3: kyRaCIljYA6l33lSKQfNsg (button) folded before Flop (didn't bet)
Seat 5: +ZlnqPoP3Hg4BIUxDfKd/A (small blind) folded on the Flop
Seat 6: ypmjhffk/YHGc51wgVXUTw (big blind) collected ($4.80)




PokerStars Game #59941911552:  Hold'em No Limit ($0.10/$0.25) - 2009/07/01 1:50:06 ET
Table '9o8Yb3JpUqurD4pNVmOikQ' 6-max Seat #2 is the button
Seat 1: SFmT9ZsVopnukjvAzrxTRg ($28.05 in chips) 
Seat 2: /gJNBeCkWL4o85/jvlZ4BA ($26.50 in chips) 
Seat 3: JgRqo1/2phbf7pab7N3BIQ ($23 in chips) 
Seat 5: QqiZLFrN8iOUT/GHw7ztOA ($23.80 in chips) 
Seat 6: LyDHtw3/yniNHW+DvLXbog ($25.35 in chips) 
JgRqo1/2phbf7pab7N3BIQ: posts small blind $0.10
QqiZLFrN8iOUT/GHw7ztOA: posts big blind $0.25
*** HOLE CARDS ***
LyDHtw3/yniNHW+DvLXbog: folds 
SFmT9ZsVopnukjvAzrxTRg: folds 
/gJNBeCkWL4o85/jvlZ4BA: folds 
JgRqo1/2phbf7pab7N3BIQ: calls $0.15
QqiZLFrN8iOUT/GHw7ztOA: raises $0.75 to $1
JgRqo1/2phbf7pab7N3BIQ: folds 
Uncalled bet ($0.75) returned to QqiZLFrN8iOUT/GHw7ztOA
AyreonChen joins the table at seat #4 
QqiZLFrN8iOUT/GHw7ztOA collected $0.50 from pot
*** SUMMARY ***
Total pot $0.50 | Rake $0 
Seat 1: SFmT9ZsVopnukjvAzrxTRg folded before Flop (didn't bet)
Seat 2: /gJNBeCkWL4o85/jvlZ4BA (button) folded before Flop (didn't bet)
Seat 3: JgRqo1/2phbf7pab7N3BIQ (small blind) folded before Flop
Seat 5: QqiZLFrN8iOUT/GHw7ztOA (big blind) collected ($0.50)
Seat 6: LyDHtw3/yniNHW+DvLXbog folded before Flop (didn't bet)




PokerStars Game #59941911876:  Hold'em No Limit ($0.10/$0.25) - 2009/07/01 1:50:07 ET
Table 'wixGE3Zge1qBdnpWijIl/w' 9-max Seat #1 is the button
Seat 1: 4GJMmHGKzu+gVtalqRy7dA ($27.45 in chips) 
Seat 2: DnDcAdn9P0zGovMERigpFA ($77.35 in chips) 
Seat 3: Bb42QRQMhg5/Y0vHP8/2Xw ($25 in chips) 
Seat 5: H5Se03ZqSX7tbULXur2MAg ($23.05 in chips) 
Seat 6: AP/rNvbsacTb4XtaAgKPiQ ($15.20 in chips) 
Seat 7: mMd8CDS/but3UC+Zp7Up2w ($20.70 in chips) 
Seat 8: ShCS62CJp4MKfKLKvGKQbA ($14.80 in chips) 
Seat 9: r6hsffOo1iKmaPYKwAZmFw ($28.80 in chips) 
DnDcAdn9P0zGovMERigpFA: posts small blind $0.10
Bb42QRQMhg5/Y0vHP8/2Xw: posts big blind $0.25
X6+pSIPfovPcE87t+LmUKQ: sits out 
*** HOLE CARDS ***
H5Se03ZqSX7tbULXur2MAg: folds 
AP/rNvbsacTb4XtaAgKPiQ: calls $0.25
mMd8CDS/but3UC+Zp7Up2w: raises $0.75 to $1
ShCS62CJp4MKfKLKvGKQbA: folds 
r6hsffOo1iKmaPYKwAZmFw: folds 
4GJMmHGKzu+gVtalqRy7dA: folds 
DnDcAdn9P0zGovMERigpFA: folds 
Bb42QRQMhg5/Y0vHP8/2Xw: folds 
AP/rNvbsacTb4XtaAgKPiQ: calls $0.75
*** FLOP *** [Js Ad 3s]
AP/rNvbsacTb4XtaAgKPiQ: checks 
mMd8CDS/but3UC+Zp7Up2w: bets $1
AP/rNvbsacTb4XtaAgKPiQ: folds 
Uncalled bet ($1) returned to mMd8CDS/but3UC+Zp7Up2w
mMd8CDS/but3UC+Zp7Up2w collected $2.25 from pot
*** SUMMARY ***
Total pot $2.35 | Rake $0.10 
Board [Js Ad 3s]
Seat 1: 4GJMmHGKzu+gVtalqRy7dA (button) folded before Flop (didn't bet)
Seat 2: DnDcAdn9P0zGovMERigpFA (small blind) folded before Flop
Seat 3: Bb42QRQMhg5/Y0vHP8/2Xw (big blind) folded before Flop
Seat 5: H5Se03ZqSX7tbULXur2MAg folded before Flop (didn't bet)
Seat 6: AP/rNvbsacTb4XtaAgKPiQ folded on the Flop
Seat 7: mMd8CDS/but3UC+Zp7Up2w collected ($2.25)
Seat 8: ShCS62CJp4MKfKLKvGKQbA folded before Flop (didn't bet)
Seat 9: r6hsffOo1iKmaPYKwAZmFw folded before Flop (didn't bet)




PokerStars Game #59941912074:  Hold'em No Limit ($0.10/$0.25) - 2009/07/01 1:50:07 ET
Table 'gnrUwXkIPE0C8xl6cB4Hyw' 9-max Seat #8 is the button
Seat 1: EQXHDnIzAsORnIXRNtXRlA ($22.95 in chips) 
Seat 2: 7je+LC5Mfs6nL8YBVh4frQ ($5 in chips) 
Seat 3: PdIasPkzm2sqZnN41ZRXOg ($5 in chips) 
Seat 4: wGigCmBR/9XWkPpvYos3aQ ($25 in chips) 
Seat 5: gehe91e0IyVT0QU/XBkEyg ($31.55 in chips) 
Seat 6: dtZ84flFEi4Q+SGrHMJRDQ ($25.80 in chips) 
Seat 7: OXPkK84/qv92EMwXPiG5rQ ($18.40 in chips) 
Seat 8: 4awUyiDYTgylQKXZ9faBVA ($60.30 in chips) 
Seat 9: F7pnn6czNpHvRM55XcA2EA ($25 in chips) 
F7pnn6czNpHvRM55XcA2EA: posts small blind $0.10
EQXHDnIzAsORnIXRNtXRlA: posts big blind $0.25
*** HOLE CARDS ***
7je+LC5Mfs6nL8YBVh4frQ: folds 
PdIasPkzm2sqZnN41ZRXOg: calls $0.25
wGigCmBR/9XWkPpvYos3aQ: folds 
gehe91e0IyVT0QU/XBkEyg: calls $0.25
dtZ84flFEi4Q+SGrHMJRDQ: folds 
OXPkK84/qv92EMwXPiG5rQ: folds 
OXPkK84/qv92EMwXPiG5rQ leaves the table
4awUyiDYTgylQKXZ9faBVA: folds 
F7pnn6czNpHvRM55XcA2EA: calls $0.15
EQXHDnIzAsORnIXRNtXRlA: checks 
*** FLOP *** [Qd 3h 9c]
F7pnn6czNpHvRM55XcA2EA: checks 
EQXHDnIzAsORnIXRNtXRlA: checks 
PdIasPkzm2sqZnN41ZRXOg: bets $1.25
gehe91e0IyVT0QU/XBkEyg: folds 
F7pnn6czNpHvRM55XcA2EA: folds 
EQXHDnIzAsORnIXRNtXRlA: folds 
Uncalled bet ($1.25) returned to PdIasPkzm2sqZnN41ZRXOg
PdIasPkzm2sqZnN41ZRXOg collected $0.95 from pot
PdIasPkzm2sqZnN41ZRXOg: doesn't show hand 
*** SUMMARY ***
Total pot $1 | Rake $0.05 
Board [Qd 3h 9c]
Seat 1: EQXHDnIzAsORnIXRNtXRlA (big blind) folded on the Flop
Seat 2: 7je+LC5Mfs6nL8YBVh4frQ folded before Flop (didn't bet)
Seat 3: PdIasPkzm2sqZnN41ZRXOg collected ($0.95)
Seat 4: wGigCmBR/9XWkPpvYos3aQ folded before Flop (didn't bet)
Seat 5: gehe91e0IyVT0QU/XBkEyg folded on the Flop
Seat 6: dtZ84flFEi4Q+SGrHMJRDQ folded before Flop (didn't bet)
Seat 7: OXPkK84/qv92EMwXPiG5rQ folded before Flop (didn't bet)
Seat 8: 4awUyiDYTgylQKXZ9faBVA (button) folded before Flop (didn't bet)
Seat 9: F7pnn6czNpHvRM55XcA2EA (small blind) folded on the Flop




PokerStars Game #59941912030:  Hold'em No Limit ($0.10/$0.25) - 2009/07/01 1:50:07 ET
Table 'iMiAw/kTZXopgYX4HI7sHg' 9-max Seat #8 is the button
Seat 1: PdIasPkzm2sqZnN41ZRXOg ($5 in chips) 
Seat 2: qwr38jl5txoR36M7G5qi4A ($8.25 in chips) 
Seat 3: HPEB+AtKw1+C/cxU0o1ciw ($27.90 in chips) 
Seat 4: Z9W7+g1WMhhZDi7DwGbCFA ($7.15 in chips) 
Seat 5: 22dIObOuor/A+IKWkNoAlA ($5.45 in chips) 
Seat 6: Bb42QRQMhg5/Y0vHP8/2Xw ($29.05 in chips) 
Seat 7: ipLwYjdAXnvG54zETKPvbQ ($12.90 in chips) 
Seat 8: tLcDklc2rBORNfixyRfVfw ($29.90 in chips) 
Seat 9: fxHuzml2pBE+ABvr6emfng ($14.75 in chips) 
fxHuzml2pBE+ABvr6emfng: posts small blind $0.10
PdIasPkzm2sqZnN41ZRXOg: posts big blind $0.25
*** HOLE CARDS ***
qwr38jl5txoR36M7G5qi4A: folds 
HPEB+AtKw1+C/cxU0o1ciw: folds 
Z9W7+g1WMhhZDi7DwGbCFA: folds 
22dIObOuor/A+IKWkNoAlA: folds 
Bb42QRQMhg5/Y0vHP8/2Xw: calls $0.25
ipLwYjdAXnvG54zETKPvbQ: folds 
tLcDklc2rBORNfixyRfVfw: folds 
fxHuzml2pBE+ABvr6emfng: calls $0.15
PdIasPkzm2sqZnN41ZRXOg: checks 
*** FLOP *** [9c Td Jh]
fxHuzml2pBE+ABvr6emfng: checks 
PdIasPkzm2sqZnN41ZRXOg: checks 
Bb42QRQMhg5/Y0vHP8/2Xw: checks 
*** TURN *** [9c Td Jh] [Ad]
fxHuzml2pBE+ABvr6emfng: bets $0.50
PdIasPkzm2sqZnN41ZRXOg: folds 
Bb42QRQMhg5/Y0vHP8/2Xw: folds 
Uncalled bet ($0.50) returned to fxHuzml2pBE+ABvr6emfng
fxHuzml2pBE+ABvr6emfng collected $0.75 from pot
*** SUMMARY ***
Total pot $0.75 | Rake $0 
Board [9c Td Jh Ad]
Seat 1: PdIasPkzm2sqZnN41ZRXOg (big blind) folded on the Turn
Seat 2: qwr38jl5txoR36M7G5qi4A folded before Flop (didn't bet)
Seat 3: HPEB+AtKw1+C/cxU0o1ciw folded before Flop (didn't bet)
Seat 4: Z9W7+g1WMhhZDi7DwGbCFA folded before Flop (didn't bet)
Seat 5: 22dIObOuor/A+IKWkNoAlA folded before Flop (didn't bet)
Seat 6: Bb42QRQMhg5/Y0vHP8/2Xw folded on the Turn
Seat 7: ipLwYjdAXnvG54zETKPvbQ folded before Flop (didn't bet)
Seat 8: tLcDklc2rBORNfixyRfVfw (button) folded before Flop (didn't bet)
Seat 9: fxHuzml2pBE+ABvr6emfng (small blind) collected ($0.75)




PokerStars Game #59941912100:  Hold'em No Limit ($0.10/$0.25) - 2009/07/01 1:50:07 ET
Table 'eOXPe2c6mG7DOFKvMsZZfA' 6-max Seat #1 is the button
Seat 1: s21kVGMLPAoHdWR+muSonw ($25.90 in chips) 
Seat 2: gaPMxLGp9SOj4Lq6t+/0Ig ($8.95 in chips) 
Seat 3: kReyZ6g6Fu3tQ0nyjDf9kA ($25.10 in chips) 
Seat 4: zHHLkD2sRljslKKeQv/ZQw ($31.70 in chips) 
Seat 5: NhUN/JpAprdJeamFBgJH1w ($34.05 in chips) 
Seat 6: Qpv/hb5ak7LeaDig1L5L8w ($14.45 in chips) 
gaPMxLGp9SOj4Lq6t+/0Ig: posts small blind $0.10
kReyZ6g6Fu3tQ0nyjDf9kA: posts big blind $0.25
*** HOLE CARDS ***
zHHLkD2sRljslKKeQv/ZQw: raises $0.50 to $0.75
NhUN/JpAprdJeamFBgJH1w: folds 
Qpv/hb5ak7LeaDig1L5L8w: folds 
s21kVGMLPAoHdWR+muSonw: folds 
gaPMxLGp9SOj4Lq6t+/0Ig: folds 
kReyZ6g6Fu3tQ0nyjDf9kA: calls $0.50
*** FLOP *** [6c As 2h]
kReyZ6g6Fu3tQ0nyjDf9kA: checks 
zHHLkD2sRljslKKeQv/ZQw: checks 
*** TURN *** [6c As 2h] [4h]
kReyZ6g6Fu3tQ0nyjDf9kA: checks 
zHHLkD2sRljslKKeQv/ZQw: bets $0.75
kReyZ6g6Fu3tQ0nyjDf9kA: folds 
Uncalled bet ($0.75) returned to zHHLkD2sRljslKKeQv/ZQw
zHHLkD2sRljslKKeQv/ZQw collected $1.55 from pot
*** SUMMARY ***
Total pot $1.60 | Rake $0.05 
Board [6c As 2h 4h]
Seat 1: s21kVGMLPAoHdWR+muSonw (button) folded before Flop (didn't bet)
Seat 2: gaPMxLGp9SOj4Lq6t+/0Ig (small blind) folded before Flop
Seat 3: kReyZ6g6Fu3tQ0nyjDf9kA (big blind) folded on the Turn
Seat 4: zHHLkD2sRljslKKeQv/ZQw collected ($1.55)
Seat 5: NhUN/JpAprdJeamFBgJH1w folded before Flop (didn't bet)
Seat 6: Qpv/hb5ak7LeaDig1L5L8w folded before Flop (didn't bet)




PokerStars Game #59941912080:  Hold'em No Limit ($0.10/$0.25) - 2009/07/01 1:50:07 ET
Table 'T/iCKJXGphRN3xcdwfE/JQ' 6-max Seat #3 is the button
Seat 1: wAKC8C/zN0c8V5v13dm9mA ($26.15 in chips) 
Seat 2: EeUZtMU058v2ObUACOF4Og ($32.90 in chips) 
Seat 3: IWAjoCPXtc1XUaZdp+pCpA ($22.10 in chips) 
Seat 4: m2yWOKfAxqHoy5DDN87Ttw ($24.75 in chips) 
Seat 5: y85armT09GoP0OGsamp0jA ($15 in chips) 
Seat 6: Ey4Kn6PlnYb2srYYBJHvzg ($20.15 in chips) 
m2yWOKfAxqHoy5DDN87Ttw: posts small blind $0.10
y85armT09GoP0OGsamp0jA: posts big blind $0.25
*** HOLE CARDS ***
Ey4Kn6PlnYb2srYYBJHvzg: raises $0.50 to $0.75
wAKC8C/zN0c8V5v13dm9mA: folds 
EeUZtMU058v2ObUACOF4Og: folds 
IWAjoCPXtc1XUaZdp+pCpA: folds 
m2yWOKfAxqHoy5DDN87Ttw: folds 
y85armT09GoP0OGsamp0jA: calls $0.50
*** FLOP *** [9h 3h 8s]
y85armT09GoP0OGsamp0jA: checks 
Ey4Kn6PlnYb2srYYBJHvzg: bets $0.50
y85armT09GoP0OGsamp0jA: calls $0.50
*** TURN *** [9h 3h 8s] [6s]
y85armT09GoP0OGsamp0jA: checks 
Ey4Kn6PlnYb2srYYBJHvzg: bets $0.75
y85armT09GoP0OGsamp0jA: calls $0.75
*** RIVER *** [9h 3h 8s 6s] [Td]
y85armT09GoP0OGsamp0jA: checks 
Ey4Kn6PlnYb2srYYBJHvzg: bets $1.50
y85armT09GoP0OGsamp0jA: calls $1.50
*** SHOW DOWN ***
Ey4Kn6PlnYb2srYYBJHvzg: shows [9d Ah] (a pair of Nines)
y85armT09GoP0OGsamp0jA: shows [Ts 9s] (two pair, Tens and Nines)
y85armT09GoP0OGsamp0jA collected $6.80 from pot
*** SUMMARY ***
Total pot $7.10 | Rake $0.30 
Board [9h 3h 8s 6s Td]
Seat 1: wAKC8C/zN0c8V5v13dm9mA folded before Flop (didn't bet)
Seat 2: EeUZtMU058v2ObUACOF4Og folded before Flop (didn't bet)
Seat 3: IWAjoCPXtc1XUaZdp+pCpA (button) folded before Flop (didn't bet)
Seat 4: m2yWOKfAxqHoy5DDN87Ttw (small blind) folded before Flop
Seat 5: y85armT09GoP0OGsamp0jA (big blind) showed [Ts 9s] and won ($6.80) with two pair, Tens and Nines
Seat 6: Ey4Kn6PlnYb2srYYBJHvzg showed [9d Ah] and lost with a pair of Nines




PokerStars Game #59941912150:  Hold'em No Limit ($0.10/$0.25) - 2009/07/01 1:50:07 ET
Table 'nc6OeGk/wtaWV+6N+kgnZQgZetDqJh6q9A3mLO3ThCsASeat #6 is the button
Seat 1: DihMHaz4WNETH1bPDe13kA ($25 in chips) 
Seat 2: JFIAqU8lCZ0vWwEl4bdGsg ($35.20 in chips) 
Seat 3: jp34e617tIzV8tKIWmfAbA ($34.75 in chips) 
Seat 4: BV+K0Phf5VBHr7aZPKqbUQ ($29.60 in chips) 
Seat 5: SxIIgwXYLkwd6m3wLyPTCw ($25 in chips) 
Seat 6: Mhj3q7cxev+XjXZxEE6/Cw ($25 in chips) 
DihMHaz4WNETH1bPDe13kA: posts small blind $0.10
JFIAqU8lCZ0vWwEl4bdGsg: posts big blind $0.25
SxIIgwXYLkwd6m3wLyPTCw: posts big blind $0.25
*** HOLE CARDS ***
jp34e617tIzV8tKIWmfAbA: folds 
BV+K0Phf5VBHr7aZPKqbUQ: raises $1 to $1.25
SxIIgwXYLkwd6m3wLyPTCw: folds 
Mhj3q7cxev+XjXZxEE6/Cw: calls $1.25
DihMHaz4WNETH1bPDe13kA: folds 
JFIAqU8lCZ0vWwEl4bdGsg: folds 
*** FLOP *** [4d 7s 5h]
BV+K0Phf5VBHr7aZPKqbUQ: bets $1.75
Mhj3q7cxev+XjXZxEE6/Cw: calls $1.75
*** TURN *** [4d 7s 5h] [As]
BV+K0Phf5VBHr7aZPKqbUQ: checks 
Mhj3q7cxev+XjXZxEE6/Cw: checks 
*** RIVER *** [4d 7s 5h As] [Qc]
BV+K0Phf5VBHr7aZPKqbUQ: bets $3.50
Mhj3q7cxev+XjXZxEE6/Cw: folds 
Uncalled bet ($3.50) returned to BV+K0Phf5VBHr7aZPKqbUQ
BV+K0Phf5VBHr7aZPKqbUQ collected $6.30 from pot
BV+K0Phf5VBHr7aZPKqbUQ: doesn't show hand 
*** SUMMARY ***
Total pot $6.60 | Rake $0.30 
Board [4d 7s 5h As Qc]
Seat 1: DihMHaz4WNETH1bPDe13kA (small blind) folded before Flop
Seat 2: JFIAqU8lCZ0vWwEl4bdGsg (big blind) folded before Flop
Seat 3: jp34e617tIzV8tKIWmfAbA folded before Flop (didn't bet)
Seat 4: BV+K0Phf5VBHr7aZPKqbUQ collected ($6.30)
Seat 5: SxIIgwXYLkwd6m3wLyPTCw folded before Flop
Seat 6: Mhj3q7cxev+XjXZxEE6/Cw (button) folded on the River




PokerStars Game #59941912168:  Hold'em No Limit ($0.10/$0.25) - 2009/07/01 1:50:07 ET
Table '4XGDnEByOol5up4aB2KbJw' 6-max Seat #4 is the button
Seat 1: kyRaCIljYA6l33lSKQfNsg ($27.10 in chips) 
Seat 2: SFmT9ZsVopnukjvAzrxTRg ($46.10 in chips) 
Seat 3: LtASJ9OlkqGrrUKGQlpGAw ($18.55 in chips) 
Seat 4: BV+K0Phf5VBHr7aZPKqbUQ ($25 in chips) 
Seat 5: Dh01+rohD2p9pXLYeBlC5Q ($19.15 in chips) 
Seat 6: a7Ux7aERFGCbT/L3ojVfAg ($10.40 in chips) 
Dh01+rohD2p9pXLYeBlC5Q: posts small blind $0.10
a7Ux7aERFGCbT/L3ojVfAg: posts big blind $0.25
*** HOLE CARDS ***
kyRaCIljYA6l33lSKQfNsg: folds 
SFmT9ZsVopnukjvAzrxTRg: raises $0.75 to $1
LtASJ9OlkqGrrUKGQlpGAw: folds 
BV+K0Phf5VBHr7aZPKqbUQ: folds 
Dh01+rohD2p9pXLYeBlC5Q: folds 
a7Ux7aERFGCbT/L3ojVfAg: calls $0.75
*** FLOP *** [As 2d 2s]
a7Ux7aERFGCbT/L3ojVfAg: checks 
SFmT9ZsVopnukjvAzrxTRg: bets $1.25
a7Ux7aERFGCbT/L3ojVfAg: calls $1.25
*** TURN *** [As 2d 2s] [4d]
a7Ux7aERFGCbT/L3ojVfAg: checks 
SFmT9ZsVopnukjvAzrxTRg: checks 
*** RIVER *** [As 2d 2s 4d] [Kd]
a7Ux7aERFGCbT/L3ojVfAg: checks 
SFmT9ZsVopnukjvAzrxTRg: bets $2.75
a7Ux7aERFGCbT/L3ojVfAg: calls $2.75
*** SHOW DOWN ***
SFmT9ZsVopnukjvAzrxTRg: shows [Ah 7h] (two pair, Aces and Deuces)
a7Ux7aERFGCbT/L3ojVfAg: shows [Ad Js] (two pair, Aces and Deuces)
a7Ux7aERFGCbT/L3ojVfAg collected $4.85 from pot
SFmT9ZsVopnukjvAzrxTRg collected $4.80 from pot
*** SUMMARY ***
Total pot $10.10 | Rake $0.45 
Board [As 2d 2s 4d Kd]
Seat 1: kyRaCIljYA6l33lSKQfNsg folded before Flop (didn't bet)
Seat 2: SFmT9ZsVopnukjvAzrxTRg showed [Ah 7h] and won ($4.80) with two pair, Aces and Deuces
Seat 3: LtASJ9OlkqGrrUKGQlpGAw folded before Flop (didn't bet)
Seat 4: BV+K0Phf5VBHr7aZPKqbUQ (button) folded before Flop (didn't bet)
Seat 5: Dh01+rohD2p9pXLYeBlC5Q (small blind) folded before Flop
Seat 6: a7Ux7aERFGCbT/L3ojVfAg (big blind) showed [Ad Js] and won ($4.85) with two pair, Aces and Deuces




PokerStars Game #59941912462:  Hold'em No Limit ($0.10/$0.25) - 2009/07/01 1:50:08 ET
Table 'ZEXL6Wh4qA4Afx8NnoBBAA' 6-max Seat #1 is the button
Seat 1: v8m8XHovI5tqEA9mvplDSw ($26.95 in chips) 
Seat 2: 6DwBRH+xZ12AAZmeAg+aXw ($21.75 in chips) 
Seat 3: +ZlnqPoP3Hg4BIUxDfKd/A ($31.70 in chips) 
Seat 4: FpN4KbLjlyRRKiVaQcoLqA ($29.75 in chips) 
Seat 5: if4dh6jhJXeN3/qd3qCp9g ($38.80 in chips) 
Seat 6: Lh8SlCq3OSDKWLUgAI/Lxw ($1.75 in chips) 
6DwBRH+xZ12AAZmeAg+aXw: posts small blind $0.10
+ZlnqPoP3Hg4BIUxDfKd/A: posts big blind $0.25
*** HOLE CARDS ***
FpN4KbLjlyRRKiVaQcoLqA: folds 
if4dh6jhJXeN3/qd3qCp9g: folds 
Lh8SlCq3OSDKWLUgAI/Lxw: folds 
v8m8XHovI5tqEA9mvplDSw: folds 
6DwBRH+xZ12AAZmeAg+aXw: folds 
Uncalled bet ($0.15) returned to +ZlnqPoP3Hg4BIUxDfKd/A
+ZlnqPoP3Hg4BIUxDfKd/A collected $0.20 from pot
+ZlnqPoP3Hg4BIUxDfKd/A: doesn't show hand 
*** SUMMARY ***
Total pot $0.20 | Rake $0 
Seat 1: v8m8XHovI5tqEA9mvplDSw (button) folded before Flop (didn't bet)
Seat 2: 6DwBRH+xZ12AAZmeAg+aXw (small blind) folded before Flop
Seat 3: +ZlnqPoP3Hg4BIUxDfKd/A (big blind) collected ($0.20)
Seat 4: FpN4KbLjlyRRKiVaQcoLqA folded before Flop (didn't bet)
Seat 5: if4dh6jhJXeN3/qd3qCp9g folded before Flop (didn't bet)
Seat 6: Lh8SlCq3OSDKWLUgAI/Lxw folded before Flop (didn't bet)




PokerStars Game #59941912350:  Hold'em No Limit ($0.10/$0.25) - 2009/07/01 1:50:08 ET
Table 'C8mMnVmvkagwolEzTvh07A' 9-max Seat #4 is the button
Seat 1: PqvgxdSg9z5VmrWpbYuz+g ($26.15 in chips) 
Seat 2: Bb42QRQMhg5/Y0vHP8/2Xw ($25.35 in chips) 
Seat 3: Th3FldXKQW6hWVVPahaoOQ ($34.50 in chips) 
Seat 4: dfNim92Z6XK1/h5SFW5vDg ($25 in chips) 
Seat 5: iGMlK+EhUflPB6jKQd95Cg ($25.10 in chips) 
Seat 6: AiXn/9o1EwOPZUHujnh/bA ($18.50 in chips) 
Seat 9: 4awUyiDYTgylQKXZ9faBVA ($39.60 in chips) 
iGMlK+EhUflPB6jKQd95Cg: posts small blind $0.10
AiXn/9o1EwOPZUHujnh/bA: posts big blind $0.25
*** HOLE CARDS ***
4awUyiDYTgylQKXZ9faBVA: raises $0.75 to $1
PqvgxdSg9z5VmrWpbYuz+g: folds 
Bb42QRQMhg5/Y0vHP8/2Xw: folds 
Th3FldXKQW6hWVVPahaoOQ: folds 
dfNim92Z6XK1/h5SFW5vDg: folds 
iGMlK+EhUflPB6jKQd95Cg: folds 
AiXn/9o1EwOPZUHujnh/bA: folds 
Uncalled bet ($0.75) returned to 4awUyiDYTgylQKXZ9faBVA
4awUyiDYTgylQKXZ9faBVA collected $0.60 from pot
4awUyiDYTgylQKXZ9faBVA: doesn't show hand 
*** SUMMARY ***
Total pot $0.60 | Rake $0 
Seat 1: PqvgxdSg9z5VmrWpbYuz+g folded before Flop (didn't bet)
Seat 2: Bb42QRQMhg5/Y0vHP8/2Xw folded before Flop (didn't bet)
Seat 3: Th3FldXKQW6hWVVPahaoOQ folded before Flop (didn't bet)
Seat 4: dfNim92Z6XK1/h5SFW5vDg (button) folded before Flop (didn't bet)
Seat 5: iGMlK+EhUflPB6jKQd95Cg (small blind) folded before Flop
Seat 6: AiXn/9o1EwOPZUHujnh/bA (big blind) folded before Flop
Seat 9: 4awUyiDYTgylQKXZ9faBVA collected ($0.60)




PokerStars Game #59941912480:  Hold'em No Limit ($0.10/$0.25) - 2009/07/01 1:50:08 ET
Table 'O5NgMYt6EWbLBozZb3kseg' 6-max Seat #6 is the button
Seat 2: ZZm/rg8aThjE+A2LiItuzA ($12.05 in chips) 
Seat 3: 0bf6ZOD3FadOOzjtjXlcRQ ($5.60 in chips) 
Seat 4: ItRgvLhXTZHvtZowz+dbIw ($12.90 in chips) 
Seat 5: u3Ol7kv1LmvszuHNm9rc6w ($24.65 in chips) 
Seat 6: 3m6VfX7io8SA31qh1zCkgQ ($26.95 in chips) 
majicjordan will be allowed to play after the button
ZZm/rg8aThjE+A2LiItuzA: posts small blind $0.10
0bf6ZOD3FadOOzjtjXlcRQ: posts big blind $0.25
*** HOLE CARDS ***
ItRgvLhXTZHvtZowz+dbIw: folds 
u3Ol7kv1LmvszuHNm9rc6w: raises $0.50 to $0.75
3m6VfX7io8SA31qh1zCkgQ: folds 
ZZm/rg8aThjE+A2LiItuzA: folds 
0bf6ZOD3FadOOzjtjXlcRQ: calls $0.50
*** FLOP *** [7s 2h Qh]
0bf6ZOD3FadOOzjtjXlcRQ: checks 
u3Ol7kv1LmvszuHNm9rc6w: bets $1
0bf6ZOD3FadOOzjtjXlcRQ: folds 
Uncalled bet ($1) returned to u3Ol7kv1LmvszuHNm9rc6w
u3Ol7kv1LmvszuHNm9rc6w collected $1.55 from pot
u3Ol7kv1LmvszuHNm9rc6w: doesn't show hand 
*** SUMMARY ***
Total pot $1.60 | Rake $0.05 
Board [7s 2h Qh]
Seat 2: ZZm/rg8aThjE+A2LiItuzA (small blind) folded before Flop
Seat 3: 0bf6ZOD3FadOOzjtjXlcRQ (big blind) folded on the Flop
Seat 4: ItRgvLhXTZHvtZowz+dbIw folded before Flop (didn't bet)
Seat 5: u3Ol7kv1LmvszuHNm9rc6w collected ($1.55)
Seat 6: 3m6VfX7io8SA31qh1zCkgQ (button) folded before Flop (didn't bet)




PokerStars Game #59941912376:  Hold'em No Limit ($0.10/$0.25) - 2009/07/01 1:50:08 ET
Table 'JJzUs04lHpXg6nboT1/jeg' 6-max Seat #3 is the button
Seat 1: vEZ/HxVuyR6kaq0BtZoUgQ ($10 in chips) 
Seat 2: jxfR29d+dK/7h7s3SvCk+g ($8.70 in chips) 
Seat 3: 4zXbHDe39qNX46dAo81b4w ($10.75 in chips) 
Seat 4: 7cx44/slbeTw+Cy7QB8Trg ($24.75 in chips) 
7cx44/slbeTw+Cy7QB8Trg: posts small blind $0.10
vEZ/HxVuyR6kaq0BtZoUgQ: posts big blind $0.25
*** HOLE CARDS ***
jxfR29d+dK/7h7s3SvCk+g: folds 
4zXbHDe39qNX46dAo81b4w: folds 
7cx44/slbeTw+Cy7QB8Trg: folds 
Uncalled bet ($0.15) returned to vEZ/HxVuyR6kaq0BtZoUgQ
FDWzjQgBA5K04jOIY/j22w joins the table at seat #5 
hOaWAImn5/MZDAWAPlYHCw joins the table at seat #6 
vEZ/HxVuyR6kaq0BtZoUgQ collected $0.20 from pot
vEZ/HxVuyR6kaq0BtZoUgQ: doesn't show hand 
*** SUMMARY ***
Total pot $0.20 | Rake $0 
Seat 1: vEZ/HxVuyR6kaq0BtZoUgQ (big blind) collected ($0.20)
Seat 2: jxfR29d+dK/7h7s3SvCk+g folded before Flop (didn't bet)
Seat 3: 4zXbHDe39qNX46dAo81b4w (button) folded before Flop (didn't bet)
Seat 4: 7cx44/slbeTw+Cy7QB8Trg (small blind) folded before Flop




PokerStars Game #59941913070:  Hold'em No Limit ($0.10/$0.25) - 2009/07/01 1:50:09 ET
Table 'ykyWGjhNu7AvZXov27T4ew' 9-max Seat #3 is the button
Seat 1: skUI2T7o4P1rz460mMbAOg ($10.25 in chips) 
Seat 2: MG90wfSJZnOejs/KD3vlQQ ($38.85 in chips) 
Seat 3: NPI9ArW8kwrb6a2IAL6xMQ ($25.25 in chips) 
Seat 4: W6tExOcYX7qiy6Qdp+ZwFA ($14.10 in chips) 
Seat 5: CmngQmkKTp8tkl6GMRTl6w ($8.50 in chips) 
Seat 6: AiXn/9o1EwOPZUHujnh/bA ($20.15 in chips) 
Seat 8: tYsOBqdU1+x+yFI7zHO7hQ ($48.85 in chips) 
Seat 9: wk9M6R3w+aDHpr8WV87RmQ ($4.75 in chips) 
W6tExOcYX7qiy6Qdp+ZwFA: posts small blind $0.10
CmngQmkKTp8tkl6GMRTl6w: posts big blind $0.25
*** HOLE CARDS ***
AiXn/9o1EwOPZUHujnh/bA: folds 
tYsOBqdU1+x+yFI7zHO7hQ: folds 
wk9M6R3w+aDHpr8WV87RmQ: folds 
skUI2T7o4P1rz460mMbAOg: folds 
MG90wfSJZnOejs/KD3vlQQ: folds 
NPI9ArW8kwrb6a2IAL6xMQ: calls $0.25
wk9M6R3w+aDHpr8WV87RmQ leaves the table
W6tExOcYX7qiy6Qdp+ZwFA: calls $0.15
H5Se03ZqSX7tbULXur2MAg joins the table at seat #9 
CmngQmkKTp8tkl6GMRTl6w: checks 
*** FLOP *** [4s Js Kc]
W6tExOcYX7qiy6Qdp+ZwFA: bets $1
CmngQmkKTp8tkl6GMRTl6w: raises $1.25 to $2.25
NPI9ArW8kwrb6a2IAL6xMQ: folds 
W6tExOcYX7qiy6Qdp+ZwFA: calls $1.25
*** TURN *** [4s Js Kc] [3h]
W6tExOcYX7qiy6Qdp+ZwFA: bets $11.60 and is all-in
CmngQmkKTp8tkl6GMRTl6w: calls $6 and is all-in
Uncalled bet ($5.60) returned to W6tExOcYX7qiy6Qdp+ZwFA
*** RIVER *** [4s Js Kc 3h] [9s]
*** SHOW DOWN ***
W6tExOcYX7qiy6Qdp+ZwFA: shows [Kd Qh] (a pair of Kings)
CmngQmkKTp8tkl6GMRTl6w: shows [Ks 2s] (a flush, King high)
CmngQmkKTp8tkl6GMRTl6w collected $16.40 from pot
*** SUMMARY ***
Total pot $17.25 | Rake $0.85 
Board [4s Js Kc 3h 9s]
Seat 1: skUI2T7o4P1rz460mMbAOg folded before Flop (didn't bet)
Seat 2: MG90wfSJZnOejs/KD3vlQQ folded before Flop (didn't bet)
Seat 3: NPI9ArW8kwrb6a2IAL6xMQ (button) folded on the Flop
Seat 4: W6tExOcYX7qiy6Qdp+ZwFA (small blind) showed [Kd Qh] and lost with a pair of Kings
Seat 5: CmngQmkKTp8tkl6GMRTl6w (big blind) showed [Ks 2s] and won ($16.40) with a flush, King high
Seat 6: AiXn/9o1EwOPZUHujnh/bA folded before Flop (didn't bet)
Seat 8: tYsOBqdU1+x+yFI7zHO7hQ folded before Flop (didn't bet)
Seat 9: wk9M6R3w+aDHpr8WV87RmQ folded before Flop (didn't bet)




PokerStars Game #59941913218:  Hold'em No Limit ($0.10/$0.25) - 2009/07/01 1:50:09 ET
Table 'P1IJQ2p3ACFySC35W1qwQw' 9-max Seat #2 is the button
Seat 1: bXpVeaSTPBFSPJmeXxO7nw ($5.15 in chips) 
Seat 2: vO3QVRovWemcGMkm7ijAIA ($4.85 in chips) 
Seat 3: PVxvfRTRvkgZf9WtquEkwQ ($27.50 in chips) 
Seat 5: ghNKXUBl/H+t83JF079ZBA ($56.45 in chips) 
Seat 6: ljemhp25Zg+nlA9DLCIiUw ($64.45 in chips) 
Seat 7: 7je+LC5Mfs6nL8YBVh4frQ ($5.10 in chips) 
Seat 8: tLcDklc2rBORNfixyRfVfw ($26.25 in chips) 
Seat 9: GeMoapCKDLc4ajT0Uk9ZQw ($9.75 in chips) 
PVxvfRTRvkgZf9WtquEkwQ: posts small blind $0.10
c/9X4zftzphFxYtxp5kp9w: is sitting out 
ghNKXUBl/H+t83JF079ZBA: posts big blind $0.25
*** HOLE CARDS ***
ljemhp25Zg+nlA9DLCIiUw: folds 
c/9X4zftzphFxYtxp5kp9w leaves the table
7je+LC5Mfs6nL8YBVh4frQ: folds 
tLcDklc2rBORNfixyRfVfw: folds 
GeMoapCKDLc4ajT0Uk9ZQw: folds 
bXpVeaSTPBFSPJmeXxO7nw: folds 
vO3QVRovWemcGMkm7ijAIA: folds 
PVxvfRTRvkgZf9WtquEkwQ: folds 
Uncalled bet ($0.15) returned to ghNKXUBl/H+t83JF079ZBA
ghNKXUBl/H+t83JF079ZBA collected $0.20 from pot
ghNKXUBl/H+t83JF079ZBA: doesn't show hand 
*** SUMMARY ***
Total pot $0.20 | Rake $0 
Seat 1: bXpVeaSTPBFSPJmeXxO7nw folded before Flop (didn't bet)
Seat 2: vO3QVRovWemcGMkm7ijAIA (button) folded before Flop (didn't bet)
Seat 3: PVxvfRTRvkgZf9WtquEkwQ (small blind) folded before Flop
Seat 5: ghNKXUBl/H+t83JF079ZBA (big blind) collected ($0.20)
Seat 6: ljemhp25Zg+nlA9DLCIiUw folded before Flop (didn't bet)
Seat 7: 7je+LC5Mfs6nL8YBVh4frQ folded before Flop (didn't bet)
Seat 8: tLcDklc2rBORNfixyRfVfw folded before Flop (didn't bet)
Seat 9: GeMoapCKDLc4ajT0Uk9ZQw folded before Flop (didn't bet)




PokerStars Game #59941912804:  Hold'em No Limit ($0.10/$0.25) - 2009/07/01 1:50:09 ET
Table 'ggwTHpIC5qhhHJSYjK1XCw' 6-max Seat #5 is the button
Seat 2: /gJNBeCkWL4o85/jvlZ4BA ($25.20 in chips) 
Seat 3: 7cx44/slbeTw+Cy7QB8Trg ($24.50 in chips) 
Seat 4: JFIAqU8lCZ0vWwEl4bdGsg ($25 in chips) 
Seat 5: BvqhBa7W/To51LhEiIU/lw ($7.60 in chips) 
raf216 will be allowed to play after the button
BZG35 will be allowed to play after the button
/gJNBeCkWL4o85/jvlZ4BA: posts small blind $0.10
7cx44/slbeTw+Cy7QB8Trg: posts big blind $0.25
*** HOLE CARDS ***
JFIAqU8lCZ0vWwEl4bdGsg: folds 
BvqhBa7W/To51LhEiIU/lw: calls $0.25
/gJNBeCkWL4o85/jvlZ4BA: calls $0.15
7cx44/slbeTw+Cy7QB8Trg: checks 
*** FLOP *** [8c Ac As]
/gJNBeCkWL4o85/jvlZ4BA: checks 
7cx44/slbeTw+Cy7QB8Trg: checks 
BvqhBa7W/To51LhEiIU/lw: bets $0.25
/gJNBeCkWL4o85/jvlZ4BA: folds 
7cx44/slbeTw+Cy7QB8Trg: folds 
Uncalled bet ($0.25) returned to BvqhBa7W/To51LhEiIU/lw
BvqhBa7W/To51LhEiIU/lw collected $0.75 from pot
BvqhBa7W/To51LhEiIU/lw: doesn't show hand 
*** SUMMARY ***
Total pot $0.75 | Rake $0 
Board [8c Ac As]
Seat 2: /gJNBeCkWL4o85/jvlZ4BA (small blind) folded on the Flop
Seat 3: 7cx44/slbeTw+Cy7QB8Trg (big blind) folded on the Flop
Seat 4: JFIAqU8lCZ0vWwEl4bdGsg folded before Flop (didn't bet)
Seat 5: BvqhBa7W/To51LhEiIU/lw (button) collected ($0.75)




PokerStars Game #59941913012:  Hold'em No Limit ($0.10/$0.25) - 2009/07/01 1:50:09 ET
Table 'nlpa8xI95gAflovnFxB2yg' 6-max Seat #3 is the button
Seat 1: fZQg9veL7Dd/Z04ZTjC+wQ ($61.45 in chips) 
Seat 2: Yuyy/pDz3yAO3EbHYRYnKw ($23.80 in chips) 
Seat 3: DihMHaz4WNETH1bPDe13kA ($25.50 in chips) 
Seat 4: if4dh6jhJXeN3/qd3qCp9g ($52.10 in chips) 
Seat 6: ATNFxN8fYVfSZMQW8dvbvw ($5.25 in chips) 
if4dh6jhJXeN3/qd3qCp9g: posts small blind $0.10
ATNFxN8fYVfSZMQW8dvbvw: posts big blind $0.25
*** HOLE CARDS ***
fZQg9veL7Dd/Z04ZTjC+wQ: raises $0.50 to $0.75
Yuyy/pDz3yAO3EbHYRYnKw: folds 
DihMHaz4WNETH1bPDe13kA: folds 
if4dh6jhJXeN3/qd3qCp9g: folds 
JJGIV joins the table at seat #5 
ATNFxN8fYVfSZMQW8dvbvw: folds 
Uncalled bet ($0.50) returned to fZQg9veL7Dd/Z04ZTjC+wQ
fZQg9veL7Dd/Z04ZTjC+wQ collected $0.60 from pot
fZQg9veL7Dd/Z04ZTjC+wQ: doesn't show hand 
*** SUMMARY ***
Total pot $0.60 | Rake $0 
Seat 1: fZQg9veL7Dd/Z04ZTjC+wQ collected ($0.60)
Seat 2: Yuyy/pDz3yAO3EbHYRYnKw folded before Flop (didn't bet)
Seat 3: DihMHaz4WNETH1bPDe13kA (button) folded before Flop (didn't bet)
Seat 4: if4dh6jhJXeN3/qd3qCp9g (small blind) folded before Flop
Seat 6: ATNFxN8fYVfSZMQW8dvbvw (big blind) folded before Flop




PokerStars Game #59941912888:  Hold'em No Limit ($0.10/$0.25) - 2009/07/01 1:50:09 ET
Table 'n8mNkPYbe1AIQEkioNesZA' 9-max Seat #3 is the button
Seat 1: 9lvO/qyU+xrU95Teu1fv0g ($5.20 in chips) 
Seat 2: QEbIGci+itdw+re8RM5fZA ($29.30 in chips) 
Seat 3: zDrucyjVn5aeekNEc3cJrA ($18.65 in chips) 
Seat 4: zgi+EUykT/pZQpoUG6+oEg ($4.75 in chips) 
Seat 5: wGigCmBR/9XWkPpvYos3aQ ($28.40 in chips) 
Seat 6: HPEB+AtKw1+C/cxU0o1ciw ($46.55 in chips) 
Seat 7: vNfw/x/HNt0WgQC8SveThg ($5 in chips) 
Seat 8: aNpwfA31EREwO+ar4XzBCw ($32.20 in chips) 
Seat 9: gehe91e0IyVT0QU/XBkEyg ($28.25 in chips) 
zgi+EUykT/pZQpoUG6+oEg: posts small blind $0.10
wGigCmBR/9XWkPpvYos3aQ: posts big blind $0.25
*** HOLE CARDS ***
HPEB+AtKw1+C/cxU0o1ciw: folds 
vNfw/x/HNt0WgQC8SveThg: folds 
aNpwfA31EREwO+ar4XzBCw: folds 
gehe91e0IyVT0QU/XBkEyg: folds 
9lvO/qyU+xrU95Teu1fv0g: folds 
QEbIGci+itdw+re8RM5fZA: folds 
zDrucyjVn5aeekNEc3cJrA: calls $0.25
zgi+EUykT/pZQpoUG6+oEg: folds 
wGigCmBR/9XWkPpvYos3aQ: raises $1.25 to $1.50
zDrucyjVn5aeekNEc3cJrA: folds 
Uncalled bet ($1.25) returned to wGigCmBR/9XWkPpvYos3aQ
wGigCmBR/9XWkPpvYos3aQ collected $0.60 from pot
wGigCmBR/9XWkPpvYos3aQ: doesn't show hand 
*** SUMMARY ***
Total pot $0.60 | Rake $0 
Seat 1: 9lvO/qyU+xrU95Teu1fv0g folded before Flop (didn't bet)
Seat 2: QEbIGci+itdw+re8RM5fZA folded before Flop (didn't bet)
Seat 3: zDrucyjVn5aeekNEc3cJrA (button) folded before Flop
Seat 4: zgi+EUykT/pZQpoUG6+oEg (small blind) folded before Flop
Seat 5: wGigCmBR/9XWkPpvYos3aQ (big blind) collected ($0.60)
Seat 6: HPEB+AtKw1+C/cxU0o1ciw folded before Flop (didn't bet)
Seat 7: vNfw/x/HNt0WgQC8SveThg folded before Flop (didn't bet)
Seat 8: aNpwfA31EREwO+ar4XzBCw folded before Flop (didn't bet)
Seat 9: gehe91e0IyVT0QU/XBkEyg folded before Flop (didn't bet)




PokerStars Game #59941913210:  Hold'em No Limit ($0.10/$0.25) - 2009/07/01 1:50:09 ET
Table '1zj0+miaIL9cvwnT/50pOA' 9-max Seat #8 is the button
Seat 1: PVxvfRTRvkgZf9WtquEkwQ ($25 in chips) 
Seat 2: HPEB+AtKw1+C/cxU0o1ciw ($40.45 in chips) 
Seat 3: dtZ84flFEi4Q+SGrHMJRDQ ($29.35 in chips) 
Seat 4: PdIasPkzm2sqZnN41ZRXOg ($5.35 in chips) 
Seat 5: 57qrNGHDvf6GhB8zVLsAtQ ($8.05 in chips) 
Seat 6: YZaC69gFrepA6oCGtu7E0w ($28.95 in chips) 
Seat 7: 6RiVTYll/5D8zICp0MRpKw ($29 in chips) 
Seat 8: Ihhh49x48fayPIyvl2Rsmg ($37.60 in chips) 
Seat 9: AyqFvLFzJDE7yMbXP362BA ($19.05 in chips) 
AyqFvLFzJDE7yMbXP362BA: posts small blind $0.10
PVxvfRTRvkgZf9WtquEkwQ: posts big blind $0.25
*** HOLE CARDS ***
HPEB+AtKw1+C/cxU0o1ciw: calls $0.25
dtZ84flFEi4Q+SGrHMJRDQ: folds 
PdIasPkzm2sqZnN41ZRXOg: folds 
57qrNGHDvf6GhB8zVLsAtQ: folds 
YZaC69gFrepA6oCGtu7E0w: raises $0.25 to $0.50
6RiVTYll/5D8zICp0MRpKw: raises $1.75 to $2.25
Ihhh49x48fayPIyvl2Rsmg: calls $2.25
AyqFvLFzJDE7yMbXP362BA: folds 
PVxvfRTRvkgZf9WtquEkwQ: folds 
HPEB+AtKw1+C/cxU0o1ciw: folds 
YZaC69gFrepA6oCGtu7E0w: folds 
*** FLOP *** [As 3d 8s]
6RiVTYll/5D8zICp0MRpKw: bets $5
Ihhh49x48fayPIyvl2Rsmg: folds 
Uncalled bet ($5) returned to 6RiVTYll/5D8zICp0MRpKw
6RiVTYll/5D8zICp0MRpKw collected $5.35 from pot
6RiVTYll/5D8zICp0MRpKw: doesn't show hand 
*** SUMMARY ***
Total pot $5.60 | Rake $0.25 
Board [As 3d 8s]
Seat 1: PVxvfRTRvkgZf9WtquEkwQ (big blind) folded before Flop
Seat 2: HPEB+AtKw1+C/cxU0o1ciw folded before Flop
Seat 3: dtZ84flFEi4Q+SGrHMJRDQ folded before Flop (didn't bet)
Seat 4: PdIasPkzm2sqZnN41ZRXOg folded before Flop (didn't bet)
Seat 5: 57qrNGHDvf6GhB8zVLsAtQ folded before Flop (didn't bet)
Seat 6: YZaC69gFrepA6oCGtu7E0w folded before Flop
Seat 7: 6RiVTYll/5D8zICp0MRpKw collected ($5.35)
Seat 8: Ihhh49x48fayPIyvl2Rsmg (button) folded on the Flop
Seat 9: AyqFvLFzJDE7yMbXP362BA (small blind) folded before Flop




PokerStars Game #59941912820:  Hold'em No Limit ($0.10/$0.25) - 2009/07/01 1:50:09 ET
Table 'rjcb+nlE+0GuJ6lBhuCkkA' 6-max Seat #2 is the button
Seat 1: lBoEwOFgzcERLIRUkUoRTw ($12.90 in chips) 
Seat 2: lJphax9e7/+O/3YCKPJ0yQ ($6.45 in chips) 
Seat 3: 8ClCHtFXGNplITm+63KB+Q ($65.95 in chips) 
Seat 4: BV+K0Phf5VBHr7aZPKqbUQ ($35.50 in chips) 
Seat 5: GC/9yVD59DUCX7hUI7gcLw ($30.50 in chips) 
Seat 6: 32YL2ZEp8NT4JB2RVM9euQ ($15.70 in chips) 
8ClCHtFXGNplITm+63KB+Q: posts small blind $0.10
BV+K0Phf5VBHr7aZPKqbUQ: posts big blind $0.25
*** HOLE CARDS ***
GC/9yVD59DUCX7hUI7gcLw: folds 
32YL2ZEp8NT4JB2RVM9euQ: folds 
lBoEwOFgzcERLIRUkUoRTw: folds 
lJphax9e7/+O/3YCKPJ0yQ: raises $0.25 to $0.50
8ClCHtFXGNplITm+63KB+Q: folds 
BV+K0Phf5VBHr7aZPKqbUQ: folds 
Uncalled bet ($0.25) returned to lJphax9e7/+O/3YCKPJ0yQ
lJphax9e7/+O/3YCKPJ0yQ collected $0.60 from pot
*** SUMMARY ***
Total pot $0.60 | Rake $0 
Seat 1: lBoEwOFgzcERLIRUkUoRTw folded before Flop (didn't bet)
Seat 2: lJphax9e7/+O/3YCKPJ0yQ (button) collected ($0.60)
Seat 3: 8ClCHtFXGNplITm+63KB+Q (small blind) folded before Flop
Seat 4: BV+K0Phf5VBHr7aZPKqbUQ (big blind) folded before Flop
Seat 5: GC/9yVD59DUCX7hUI7gcLw folded before Flop (didn't bet)
Seat 6: 32YL2ZEp8NT4JB2RVM9euQ folded before Flop (didn't bet)




PokerStars Game #59941913118:  Hold'em No Limit ($0.10/$0.25) - 2009/07/01 1:50:09 ET
Table '3LMlz3V4AziGlU+ikmyU8w' 6-max Seat #2 is the button
Seat 1: Wxq4Qyj0DnDXj2+taEOJFQ ($30.15 in chips) 
Seat 2: uR3AbFJLoOX86DOTtTgGcg ($24.65 in chips) 
Seat 3: Hzy03WtPHMYwLYM7hTTxQw ($31.20 in chips) 
Seat 4: 6DwBRH+xZ12AAZmeAg+aXw ($23.30 in chips) 
Seat 5: tOAk1Og4mVObMBOfvdDYOw ($25 in chips) 
Seat 6: 7LpHJVeM6k1mQdC6HXYzww ($49.80 in chips) 
Hzy03WtPHMYwLYM7hTTxQw: posts small blind $0.10
6DwBRH+xZ12AAZmeAg+aXw: posts big blind $0.25
*** HOLE CARDS ***
tOAk1Og4mVObMBOfvdDYOw: raises $0.75 to $1
7LpHJVeM6k1mQdC6HXYzww: folds 
Wxq4Qyj0DnDXj2+taEOJFQ: calls $1
uR3AbFJLoOX86DOTtTgGcg: calls $1
Hzy03WtPHMYwLYM7hTTxQw: folds 
6DwBRH+xZ12AAZmeAg+aXw: folds 
*** FLOP *** [Ad 6d 2h]
tOAk1Og4mVObMBOfvdDYOw: checks 
Wxq4Qyj0DnDXj2+taEOJFQ: checks 
uR3AbFJLoOX86DOTtTgGcg: checks 
*** TURN *** [Ad 6d 2h] [Th]
tOAk1Og4mVObMBOfvdDYOw: checks 
Wxq4Qyj0DnDXj2+taEOJFQ: bets $1.50
uR3AbFJLoOX86DOTtTgGcg: calls $1.50
tOAk1Og4mVObMBOfvdDYOw: folds 
*** RIVER *** [Ad 6d 2h Th] [Ts]
Wxq4Qyj0DnDXj2+taEOJFQ: checks 
uR3AbFJLoOX86DOTtTgGcg: bets $2.25
Wxq4Qyj0DnDXj2+taEOJFQ: raises $4.75 to $7
uR3AbFJLoOX86DOTtTgGcg: calls $4.75
*** SHOW DOWN ***
Wxq4Qyj0DnDXj2+taEOJFQ: shows [Qd 9d] (a pair of Tens)
uR3AbFJLoOX86DOTtTgGcg: shows [Ah 5d] (two pair, Aces and Tens)
uR3AbFJLoOX86DOTtTgGcg collected $19.35 from pot
*** SUMMARY ***
Total pot $20.35 | Rake $1 
Board [Ad 6d 2h Th Ts]
Seat 1: Wxq4Qyj0DnDXj2+taEOJFQ showed [Qd 9d] and lost with a pair of Tens
Seat 2: uR3AbFJLoOX86DOTtTgGcg (button) showed [Ah 5d] and won ($19.35) with two pair, Aces and Tens
Seat 3: Hzy03WtPHMYwLYM7hTTxQw (small blind) folded before Flop
Seat 4: 6DwBRH+xZ12AAZmeAg+aXw (big blind) folded before Flop
Seat 5: tOAk1Og4mVObMBOfvdDYOw folded on the Turn
Seat 6: 7LpHJVeM6k1mQdC6HXYzww folded before Flop (didn't bet)




PokerStars Game #59941913510:  Hold'em No Limit ($0.10/$0.25) - 2009/07/01 1:50:10 ET
Table '+198VWQSWBhYQOcizzuBkw' 6-max Seat #1 is the button
Seat 1: 34ttqW62uIRrqINCCmLcsw ($19.50 in chips) 
Seat 2: iauW7L/+7qzAuHow7CD75Q ($12.65 in chips) 
Seat 3: vw7gefupgmOJJN8lUemdWg ($17.35 in chips) 
Seat 4: TgDsTeCdLQt8kWbL00ByRA ($14.65 in chips) 
Seat 5: LtASJ9OlkqGrrUKGQlpGAw ($25 in chips) 
Seat 6: leEQ84f6wJYu5SB/vj27wg ($2.80 in chips) 
iauW7L/+7qzAuHow7CD75Q: posts small blind $0.10
vw7gefupgmOJJN8lUemdWg: posts big blind $0.25
*** HOLE CARDS ***
TgDsTeCdLQt8kWbL00ByRA: folds 
LtASJ9OlkqGrrUKGQlpGAw: folds 
leEQ84f6wJYu5SB/vj27wg: calls $0.25
34ttqW62uIRrqINCCmLcsw: calls $0.25
iauW7L/+7qzAuHow7CD75Q: folds 
vw7gefupgmOJJN8lUemdWg: raises $1 to $1.25
leEQ84f6wJYu5SB/vj27wg: calls $1
34ttqW62uIRrqINCCmLcsw: calls $1
*** FLOP *** [4s Tc 6c]
vw7gefupgmOJJN8lUemdWg: bets $1.75
leEQ84f6wJYu5SB/vj27wg: calls $1.55 and is all-in
34ttqW62uIRrqINCCmLcsw: folds 
Uncalled bet ($0.20) returned to vw7gefupgmOJJN8lUemdWg
*** TURN *** [4s Tc 6c] [2c]
*** RIVER *** [4s Tc 6c 2c] [9h]
*** SHOW DOWN ***
vw7gefupgmOJJN8lUemdWg: shows [8h 7h] (a straight, Six to Ten)
leEQ84f6wJYu5SB/vj27wg: mucks hand 
vw7gefupgmOJJN8lUemdWg collected $6.65 from pot
*** SUMMARY ***
Total pot $6.95 | Rake $0.30 
Board [4s Tc 6c 2c 9h]
Seat 1: 34ttqW62uIRrqINCCmLcsw (button) folded on the Flop
Seat 2: iauW7L/+7qzAuHow7CD75Q (small blind) folded before Flop
Seat 3: vw7gefupgmOJJN8lUemdWg (big blind) showed [8h 7h] and won ($6.65) with a straight, Six to Ten
Seat 4: TgDsTeCdLQt8kWbL00ByRA folded before Flop (didn't bet)
Seat 5: LtASJ9OlkqGrrUKGQlpGAw folded before Flop (didn't bet)
Seat 6: leEQ84f6wJYu5SB/vj27wg mucked




PokerStars Game #59941913244:  Hold'em No Limit ($0.10/$0.25) - 2009/07/01 1:50:10 ET
Table 'l57rayEpPtZotP9nqgSWBg' 6-max Seat #5 is the button
Seat 1: DihMHaz4WNETH1bPDe13kA ($56.85 in chips) 
Seat 2: p6adJRMXMBLr+xtQzqazIQ ($15.05 in chips) 
Seat 3: xC0kaiDYM6YTlgODL83O5A ($24.75 in chips) 
Seat 4: OqkdGXy1SCzuN5Q0wNlFSg ($22.10 in chips) 
Seat 5: WKJHaZPUgrpTVyLOEjLYmg ($11.85 in chips) 
Seat 6: IGRfskE1v9H9Bn+fz8AgNQ ($15.30 in chips) 
IGRfskE1v9H9Bn+fz8AgNQ: posts small blind $0.10
DihMHaz4WNETH1bPDe13kA: posts big blind $0.25
*** HOLE CARDS ***
p6adJRMXMBLr+xtQzqazIQ: folds 
xC0kaiDYM6YTlgODL83O5A: folds 
OqkdGXy1SCzuN5Q0wNlFSg: folds 
WKJHaZPUgrpTVyLOEjLYmg: folds 
IGRfskE1v9H9Bn+fz8AgNQ: calls $0.15
DihMHaz4WNETH1bPDe13kA: checks 
*** FLOP *** [As Jd 3d]
IGRfskE1v9H9Bn+fz8AgNQ: checks 
DihMHaz4WNETH1bPDe13kA: checks 
*** TURN *** [As Jd 3d] [4h]
IGRfskE1v9H9Bn+fz8AgNQ: bets $0.50
DihMHaz4WNETH1bPDe13kA: folds 
Uncalled bet ($0.50) returned to IGRfskE1v9H9Bn+fz8AgNQ
IGRfskE1v9H9Bn+fz8AgNQ collected $0.50 from pot
IGRfskE1v9H9Bn+fz8AgNQ: doesn't show hand 
*** SUMMARY ***
Total pot $0.50 | Rake $0 
Board [As Jd 3d 4h]
Seat 1: DihMHaz4WNETH1bPDe13kA (big blind) folded on the Turn
Seat 2: p6adJRMXMBLr+xtQzqazIQ folded before Flop (didn't bet)
Seat 3: xC0kaiDYM6YTlgODL83O5A folded before Flop (didn't bet)
Seat 4: OqkdGXy1SCzuN5Q0wNlFSg folded before Flop (didn't bet)
Seat 5: WKJHaZPUgrpTVyLOEjLYmg (button) folded before Flop (didn't bet)
Seat 6: IGRfskE1v9H9Bn+fz8AgNQ (small blind) collected ($0.50)




PokerStars Game #59941913396:  Hold'em No Limit ($0.10/$0.25) - 2009/07/01 1:50:10 ET
Table 'isKy4XK8wJM0x735/D4hWA' 6-max Seat #6 is the button
Seat 1: kwsRmpZ1ZaLooISs+zfyKg ($25.20 in chips) 
Seat 2: 6elpmfyt4Zw0yvd8lePSMQ ($38.90 in chips) 
Seat 3: jp34e617tIzV8tKIWmfAbA ($26.05 in chips) 
Seat 4: DFi/Lzkjsfv8QswS80JX9Q ($31.45 in chips) 
Seat 5: lquriepNQBhDV5P1SWHhnA ($25.25 in chips) 
Seat 6: GbCVUNssQ7mqsPWr7J4d3w ($4.65 in chips) 
kwsRmpZ1ZaLooISs+zfyKg: posts small blind $0.10
6elpmfyt4Zw0yvd8lePSMQ: posts big blind $0.25
*** HOLE CARDS ***
jp34e617tIzV8tKIWmfAbA: folds 
DFi/Lzkjsfv8QswS80JX9Q: folds 
lquriepNQBhDV5P1SWHhnA: folds 
GbCVUNssQ7mqsPWr7J4d3w: folds 
kwsRmpZ1ZaLooISs+zfyKg: raises $0.50 to $0.75
6elpmfyt4Zw0yvd8lePSMQ: calls $0.50
*** FLOP *** [2d Ad 5h]
kwsRmpZ1ZaLooISs+zfyKg: checks 
lquriepNQBhDV5P1SWHhnA leaves the table
6elpmfyt4Zw0yvd8lePSMQ: checks 
*** TURN *** [2d Ad 5h] [3d]
kwsRmpZ1ZaLooISs+zfyKg: checks 
6elpmfyt4Zw0yvd8lePSMQ: checks 
*** RIVER *** [2d Ad 5h 3d] [9c]
kwsRmpZ1ZaLooISs+zfyKg: checks 
6elpmfyt4Zw0yvd8lePSMQ: checks 
*** SHOW DOWN ***
kwsRmpZ1ZaLooISs+zfyKg: shows [Ts Jc] (high card Ace)
6elpmfyt4Zw0yvd8lePSMQ: mucks hand 
kwsRmpZ1ZaLooISs+zfyKg collected $1.45 from pot
*** SUMMARY ***
Total pot $1.50 | Rake $0.05 
Board [2d Ad 5h 3d 9c]
Seat 1: kwsRmpZ1ZaLooISs+zfyKg (small blind) showed [Ts Jc] and won ($1.45) with high card Ace
Seat 2: 6elpmfyt4Zw0yvd8lePSMQ (big blind) mucked
Seat 3: jp34e617tIzV8tKIWmfAbA folded before Flop (didn't bet)
Seat 4: DFi/Lzkjsfv8QswS80JX9Q folded before Flop (didn't bet)
Seat 5: lquriepNQBhDV5P1SWHhnA folded before Flop (didn't bet)
Seat 6: GbCVUNssQ7mqsPWr7J4d3w (button) folded before Flop (didn't bet)




PokerStars Game #59941913330:  Hold'em No Limit ($0.10/$0.25) - 2009/07/01 1:50:10 ET
Table '3Ns9nuTkynfwbBfBXzg6ww' 6-max Seat #3 is the button
Seat 1: epAUIB7h2FJXzUPRIvSkRA ($26.05 in chips) 
Seat 2: zxeVQGaMKDsDzmSY+AInjA ($31.40 in chips) 
Seat 3: eL3+wCBjFGfQ5FMdIZihwA ($23.60 in chips) 
Seat 4: qGHGf/553gQnDoklMRe3tg ($30.60 in chips) 
Seat 5: wqphQtauX5Qn7WRJZS1flA ($24.05 in chips) 
Seat 6: DE9hRlt14g+JdsRQ4wT7hg ($39.10 in chips) 
qGHGf/553gQnDoklMRe3tg: posts small blind $0.10
wqphQtauX5Qn7WRJZS1flA: posts big blind $0.25
*** HOLE CARDS ***
DE9hRlt14g+JdsRQ4wT7hg: folds 
epAUIB7h2FJXzUPRIvSkRA: raises $0.75 to $1
zxeVQGaMKDsDzmSY+AInjA: calls $1
eL3+wCBjFGfQ5FMdIZihwA: folds 
qGHGf/553gQnDoklMRe3tg: folds 
wqphQtauX5Qn7WRJZS1flA: folds 
*** FLOP *** [Tc 3d Qh]
epAUIB7h2FJXzUPRIvSkRA: bets $1.50
zxeVQGaMKDsDzmSY+AInjA: raises $2.50 to $4
epAUIB7h2FJXzUPRIvSkRA: folds 
Uncalled bet ($2.50) returned to zxeVQGaMKDsDzmSY+AInjA
zxeVQGaMKDsDzmSY+AInjA collected $5.10 from pot
*** SUMMARY ***
Total pot $5.35 | Rake $0.25 
Board [Tc 3d Qh]
Seat 1: epAUIB7h2FJXzUPRIvSkRA folded on the Flop
Seat 2: zxeVQGaMKDsDzmSY+AInjA collected ($5.10)
Seat 3: eL3+wCBjFGfQ5FMdIZihwA (button) folded before Flop (didn't bet)
Seat 4: qGHGf/553gQnDoklMRe3tg (small blind) folded before Flop
Seat 5: wqphQtauX5Qn7WRJZS1flA (big blind) folded before Flop
Seat 6: DE9hRlt14g+JdsRQ4wT7hg folded before Flop (didn't bet)




PokerStars Game #59941913588:  Hold'em No Limit ($0.10/$0.25) - 2009/07/01 1:50:10 ET
Table 'wRXcD9iXgBbdvKhWmfnBnw' 6-max Seat #3 is the button
Seat 1: Mhj3q7cxev+XjXZxEE6/Cw ($25 in chips) 
Seat 2: vUr8qM1UsCElsCI9B/McdQ ($20.75 in chips) 
Seat 3: SxIIgwXYLkwd6m3wLyPTCw ($26.15 in chips) 
Seat 4: mnuJq+Q1IXKm/pCy+OzxmQ ($19.35 in chips) 
Seat 5: EE16Ua5b1HSsYej5zeXOlA ($48.95 in chips) 
Seat 6: JFIAqU8lCZ0vWwEl4bdGsg ($34 in chips) 
mnuJq+Q1IXKm/pCy+OzxmQ: posts small blind $0.10
EE16Ua5b1HSsYej5zeXOlA: posts big blind $0.25
*** HOLE CARDS ***
JFIAqU8lCZ0vWwEl4bdGsg: folds 
Mhj3q7cxev+XjXZxEE6/Cw: folds 
vUr8qM1UsCElsCI9B/McdQ: raises $0.25 to $0.50
SxIIgwXYLkwd6m3wLyPTCw: folds 
mnuJq+Q1IXKm/pCy+OzxmQ: folds 
EE16Ua5b1HSsYej5zeXOlA: calls $0.25
*** FLOP *** [2s 7d Jd]
EE16Ua5b1HSsYej5zeXOlA: checks 
vUr8qM1UsCElsCI9B/McdQ: bets $0.75
EE16Ua5b1HSsYej5zeXOlA: folds 
Uncalled bet ($0.75) returned to vUr8qM1UsCElsCI9B/McdQ
vUr8qM1UsCElsCI9B/McdQ collected $1.05 from pot
vUr8qM1UsCElsCI9B/McdQ: doesn't show hand 
*** SUMMARY ***
Total pot $1.10 | Rake $0.05 
Board [2s 7d Jd]
Seat 1: Mhj3q7cxev+XjXZxEE6/Cw folded before Flop (didn't bet)
Seat 2: vUr8qM1UsCElsCI9B/McdQ collected ($1.05)
Seat 3: SxIIgwXYLkwd6m3wLyPTCw (button) folded before Flop (didn't bet)
Seat 4: mnuJq+Q1IXKm/pCy+OzxmQ (small blind) folded before Flop
Seat 5: EE16Ua5b1HSsYej5zeXOlA (big blind) folded on the Flop
Seat 6: JFIAqU8lCZ0vWwEl4bdGsg folded before Flop (didn't bet)




PokerStars Game #59941913350:  Hold'em No Limit ($0.10/$0.25) - 2009/07/01 1:50:10 ET
Table 'fIMYcWwN4/aXFJvH5Z8Ymg' 6-max Seat #6 is the button
Seat 1: DihMHaz4WNETH1bPDe13kA ($25.45 in chips) 
Seat 2: Mhj3q7cxev+XjXZxEE6/Cw ($26.30 in chips) 
Seat 3: 9bpVv1/Qh9IYtXuCtl5VtQ ($24.65 in chips) 
Seat 4: 7cx44/slbeTw+Cy7QB8Trg ($24.65 in chips) 
Seat 5: lquriepNQBhDV5P1SWHhnA ($25 in chips) 
Seat 6: jp34e617tIzV8tKIWmfAbA ($28.35 in chips) 
DihMHaz4WNETH1bPDe13kA: posts small blind $0.10
Mhj3q7cxev+XjXZxEE6/Cw: posts big blind $0.25
*** HOLE CARDS ***
9bpVv1/Qh9IYtXuCtl5VtQ: folds 
7cx44/slbeTw+Cy7QB8Trg: raises $0.50 to $0.75
lquriepNQBhDV5P1SWHhnA: folds 
jp34e617tIzV8tKIWmfAbA: folds 
lquriepNQBhDV5P1SWHhnA leaves the table
DihMHaz4WNETH1bPDe13kA: folds 
Mhj3q7cxev+XjXZxEE6/Cw: folds 
Uncalled bet ($0.50) returned to 7cx44/slbeTw+Cy7QB8Trg
7cx44/slbeTw+Cy7QB8Trg collected $0.60 from pot
7cx44/slbeTw+Cy7QB8Trg: doesn't show hand 
*** SUMMARY ***
Total pot $0.60 | Rake $0 
Seat 1: DihMHaz4WNETH1bPDe13kA (small blind) folded before Flop
Seat 2: Mhj3q7cxev+XjXZxEE6/Cw (big blind) folded before Flop
Seat 3: 9bpVv1/Qh9IYtXuCtl5VtQ folded before Flop (didn't bet)
Seat 4: 7cx44/slbeTw+Cy7QB8Trg collected ($0.60)
Seat 5: lquriepNQBhDV5P1SWHhnA folded before Flop (didn't bet)
Seat 6: jp34e617tIzV8tKIWmfAbA (button) folded before Flop (didn't bet)




PokerStars Game #59941913500:  Hold'em No Limit ($0.10/$0.25) - 2009/07/01 1:50:10 ET
Table 'jItkp2PNTbH9Cf7gqsAF7g' 9-max Seat #1 is the button
Seat 1: wGigCmBR/9XWkPpvYos3aQ ($26.50 in chips) 
Seat 2: qwr38jl5txoR36M7G5qi4A ($7.70 in chips) 
Seat 3: 0YaJElQVLqWThIZnqq3w1g ($12.20 in chips) 
Seat 4: oJOvZw/Iayou0f0k6dkBhg ($5.55 in chips) 
Seat 5: NO6qGDOw12lhu3zh1xW3Bg ($19.40 in chips) 
Seat 6: cZ99hugmLBj9KhTlc8nCSw ($54 in chips) 
Seat 8: cq6LACCDFivk2+PeoiB2sw ($8.05 in chips) 
Seat 9: dtZ84flFEi4Q+SGrHMJRDQ ($25 in chips) 
qwr38jl5txoR36M7G5qi4A: posts small blind $0.10
0YaJElQVLqWThIZnqq3w1g: posts big blind $0.25
*** HOLE CARDS ***
oJOvZw/Iayou0f0k6dkBhg: calls $0.25
NO6qGDOw12lhu3zh1xW3Bg: folds 
cZ99hugmLBj9KhTlc8nCSw: raises $0.75 to $1
cq6LACCDFivk2+PeoiB2sw: calls $1
dtZ84flFEi4Q+SGrHMJRDQ: folds 
wGigCmBR/9XWkPpvYos3aQ: folds 
qwr38jl5txoR36M7G5qi4A: folds 
0YaJElQVLqWThIZnqq3w1g: folds 
oJOvZw/Iayou0f0k6dkBhg: folds 
*** FLOP *** [5d 7c 4d]
cZ99hugmLBj9KhTlc8nCSw: bets $1.75
z5GxcHlYz/GSz6W2uFiTtg has returned
cq6LACCDFivk2+PeoiB2sw: raises $2.50 to $4.25
cZ99hugmLBj9KhTlc8nCSw: folds 
Uncalled bet ($2.50) returned to cq6LACCDFivk2+PeoiB2sw
cq6LACCDFivk2+PeoiB2sw collected $5.80 from pot
*** SUMMARY ***
Total pot $6.10 | Rake $0.30 
Board [5d 7c 4d]
Seat 1: wGigCmBR/9XWkPpvYos3aQ (button) folded before Flop (didn't bet)
Seat 2: qwr38jl5txoR36M7G5qi4A (small blind) folded before Flop
Seat 3: 0YaJElQVLqWThIZnqq3w1g (big blind) folded before Flop
Seat 4: oJOvZw/Iayou0f0k6dkBhg folded before Flop
Seat 5: NO6qGDOw12lhu3zh1xW3Bg folded before Flop (didn't bet)
Seat 6: cZ99hugmLBj9KhTlc8nCSw folded on the Flop
Seat 8: cq6LACCDFivk2+PeoiB2sw collected ($5.80)
Seat 9: dtZ84flFEi4Q+SGrHMJRDQ folded before Flop (didn't bet)




PokerStars Game #59941913716:  Hold'em No Limit ($0.10/$0.25) - 2009/07/01 1:50:10 ET
Table 'ktio12Pyq06LsrFhIorSqA' 9-max Seat #5 is the button
Seat 1: OneeONzF0MoH0pEdcBndwA ($37.80 in chips) 
Seat 2: tGsFgUKjSctVaAXabrlZxw ($4.70 in chips) 
Seat 3: Z9W7+g1WMhhZDi7DwGbCFA ($5 in chips) 
Seat 4: 0QdZrkFD7aGKeBXPGbIomA ($11.15 in chips) 
Seat 5: e0pV1oisCAilWiG0FCxY6A ($14 in chips) 
Seat 6: jQL6XIewylQ8MmZhhq2YFg ($39.15 in chips) 
Seat 7: XGCfQsxa6PfAg3kJtzUmww ($22.10 in chips) 
Seat 9: H5Se03ZqSX7tbULXur2MAg ($25.55 in chips) 
jQL6XIewylQ8MmZhhq2YFg: posts small blind $0.10
XGCfQsxa6PfAg3kJtzUmww: posts big blind $0.25
Z5y2J55JmfLYR6/DPAGHwQ: sits out 
*** HOLE CARDS ***
0QdZrkFD7aGKeBXPGbIomA said, "u no see double 8 in table??"
H5Se03ZqSX7tbULXur2MAg: folds 
OneeONzF0MoH0pEdcBndwA: folds 
tGsFgUKjSctVaAXabrlZxw: folds 
Z9W7+g1WMhhZDi7DwGbCFA: folds 
0QdZrkFD7aGKeBXPGbIomA: folds 
0QdZrkFD7aGKeBXPGbIomA said, "u make all in ..... lol"
e0pV1oisCAilWiG0FCxY6A: raises $0.50 to $0.75
0QdZrkFD7aGKeBXPGbIomA said, "u are a adivine"
jQL6XIewylQ8MmZhhq2YFg said, "did uu not see it u dumbass,"
jQL6XIewylQ8MmZhhq2YFg: folds 
XGCfQsxa6PfAg3kJtzUmww: folds 
Uncalled bet ($0.50) returned to e0pV1oisCAilWiG0FCxY6A
e0pV1oisCAilWiG0FCxY6A collected $0.60 from pot
*** SUMMARY ***
Total pot $0.60 | Rake $0 
Seat 1: OneeONzF0MoH0pEdcBndwA folded before Flop (didn't bet)
Seat 2: tGsFgUKjSctVaAXabrlZxw folded before Flop (didn't bet)
Seat 3: Z9W7+g1WMhhZDi7DwGbCFA folded before Flop (didn't bet)
Seat 4: 0QdZrkFD7aGKeBXPGbIomA folded before Flop (didn't bet)
Seat 5: e0pV1oisCAilWiG0FCxY6A (button) collected ($0.60)
Seat 6: jQL6XIewylQ8MmZhhq2YFg (small blind) folded before Flop
Seat 7: XGCfQsxa6PfAg3kJtzUmww (big blind) folded before Flop
Seat 9: H5Se03ZqSX7tbULXur2MAg folded before Flop (didn't bet)




PokerStars Game #59941913398:  Hold'em No Limit ($0.10/$0.25) - 2009/07/01 1:50:10 ET
Table '52Meibn9NOL4XtVi1p2Upw' 9-max Seat #8 is the button
Seat 1: W6tExOcYX7qiy6Qdp+ZwFA ($6.55 in chips) 
Seat 3: Bb42QRQMhg5/Y0vHP8/2Xw ($26 in chips) 
Seat 4: oLa/tXLfSLLB28mcLGrxcg ($31.65 in chips) 
Seat 5: MXCztnYJ58KLHMztZvKrxA ($7.45 in chips) 
Seat 6: N5sUK8M0br9djLrW97V9pQ ($29.50 in chips) 
Seat 7: Qduu7ikeizo6q6Ei9YvcJA ($24.75 in chips) 
Seat 8: w7VrLGwaVQzOQXfRqJitMQ ($21.50 in chips) 
Seat 9: RCqMONFrSPSArZh2Jsar/w ($16.05 in chips) 
RCqMONFrSPSArZh2Jsar/w: posts small blind $0.10
W6tExOcYX7qiy6Qdp+ZwFA: posts big blind $0.25
CGjLyv/AvljZy2g76nYkzQ: sits out 
*** HOLE CARDS ***
Bb42QRQMhg5/Y0vHP8/2Xw: folds 
oLa/tXLfSLLB28mcLGrxcg: folds 
MXCztnYJ58KLHMztZvKrxA: raises $0.75 to $1
N5sUK8M0br9djLrW97V9pQ: calls $1
Qduu7ikeizo6q6Ei9YvcJA: raises $3 to $4
w7VrLGwaVQzOQXfRqJitMQ: folds 
RCqMONFrSPSArZh2Jsar/w: folds 
W6tExOcYX7qiy6Qdp+ZwFA: folds 
MXCztnYJ58KLHMztZvKrxA: raises $3.45 to $7.45 and is all-in
N5sUK8M0br9djLrW97V9pQ: folds 
Qduu7ikeizo6q6Ei9YvcJA: calls $3.45
*** FLOP *** [7c 9h 6s]
*** TURN *** [7c 9h 6s] [6d]
*** RIVER *** [7c 9h 6s 6d] [Jd]
*** SHOW DOWN ***
MXCztnYJ58KLHMztZvKrxA: shows [Qd Qh] (two pair, Queens and Sixes)
Qduu7ikeizo6q6Ei9YvcJA: shows [Js Jc] (a full house, Jacks full of Sixes)
Qduu7ikeizo6q6Ei9YvcJA collected $15.45 from pot
*** SUMMARY ***
Total pot $16.25 | Rake $0.80 
Board [7c 9h 6s 6d Jd]
Seat 1: W6tExOcYX7qiy6Qdp+ZwFA (big blind) folded before Flop
Seat 3: Bb42QRQMhg5/Y0vHP8/2Xw folded before Flop (didn't bet)
Seat 4: oLa/tXLfSLLB28mcLGrxcg folded before Flop (didn't bet)
Seat 5: MXCztnYJ58KLHMztZvKrxA showed [Qd Qh] and lost with two pair, Queens and Sixes
Seat 6: N5sUK8M0br9djLrW97V9pQ folded before Flop
Seat 7: Qduu7ikeizo6q6Ei9YvcJA showed [Js Jc] and won ($15.45) with a full house, Jacks full of Sixes
Seat 8: w7VrLGwaVQzOQXfRqJitMQ (button) folded before Flop (didn't bet)
Seat 9: RCqMONFrSPSArZh2Jsar/w (small blind) folded before Flop




PokerStars Game #59941913668:  Hold'em No Limit ($0.10/$0.25) - 2009/07/01 1:50:10 ET
Table 'CBnRhp0d6E2+/NtM7Vbruw' 9-max Seat #5 is the button
Seat 1: 18G4P1XstjNvItdGUITxgw ($25 in chips) 
Seat 2: cZ99hugmLBj9KhTlc8nCSw ($26.50 in chips) 
Seat 3: Y3DZ6qQlLeBhixDj4M9vmg ($6 in chips) 
Seat 5: CT7Xj/V/O5rBlhtt+RZeFQ ($25.35 in chips) 
Seat 6: CvL9Ch1HYCVbTsfpNucitg ($4.05 in chips) 
Seat 7: j4q3p0lesp63b1gZDwLBZw ($5 in chips) 
Seat 8: MG90wfSJZnOejs/KD3vlQQ ($25.35 in chips) 
Seat 9: xHZZRLAaFUIC8WWI8ljOJA ($29.55 in chips) 
CvL9Ch1HYCVbTsfpNucitg: posts small blind $0.10
j4q3p0lesp63b1gZDwLBZw: posts big blind $0.25
Y3DZ6qQlLeBhixDj4M9vmg: posts big blind $0.25
*** HOLE CARDS ***
MG90wfSJZnOejs/KD3vlQQ: folds 
xHZZRLAaFUIC8WWI8ljOJA: folds 
18G4P1XstjNvItdGUITxgw: folds 
cZ99hugmLBj9KhTlc8nCSw: folds 
Y3DZ6qQlLeBhixDj4M9vmg: checks 
CT7Xj/V/O5rBlhtt+RZeFQ: folds 
CvL9Ch1HYCVbTsfpNucitg: folds 
j4q3p0lesp63b1gZDwLBZw: checks 
*** FLOP *** [Qs Jd 9s]
j4q3p0lesp63b1gZDwLBZw: checks 
Y3DZ6qQlLeBhixDj4M9vmg: bets $0.50
j4q3p0lesp63b1gZDwLBZw: folds 
Uncalled bet ($0.50) returned to Y3DZ6qQlLeBhixDj4M9vmg
Y3DZ6qQlLeBhixDj4M9vmg collected $0.60 from pot
*** SUMMARY ***
Total pot $0.60 | Rake $0 
Board [Qs Jd 9s]
Seat 1: 18G4P1XstjNvItdGUITxgw folded before Flop (didn't bet)
Seat 2: cZ99hugmLBj9KhTlc8nCSw folded before Flop (didn't bet)
Seat 3: Y3DZ6qQlLeBhixDj4M9vmg collected ($0.60)
Seat 5: CT7Xj/V/O5rBlhtt+RZeFQ (button) folded before Flop (didn't bet)
Seat 6: CvL9Ch1HYCVbTsfpNucitg (small blind) folded before Flop
Seat 7: j4q3p0lesp63b1gZDwLBZw (big blind) folded on the Flop
Seat 8: MG90wfSJZnOejs/KD3vlQQ folded before Flop (didn't bet)
Seat 9: xHZZRLAaFUIC8WWI8ljOJA folded before Flop (didn't bet)




PokerStars Game #59941913652:  Hold'em No Limit ($0.10/$0.25) - 2009/07/01 1:50:10 ET
Table '63h13e5p7cWe02rClZ1CHw' 6-max Seat #1 is the button
Seat 1: pokjbbEcXXPlADXdSGHtZw ($21.35 in chips) 
Seat 2: k9nHZTHt8hYhYRcW8NTb4g ($24.70 in chips) 
Seat 4: xrf8tAXKQHG99HixCot1Iw ($28.35 in chips) 
Seat 5: iyZxqznXjv3vtvOJymkoLQ ($44.45 in chips) 
Seat 6: mfrkWA3PTeYPkbO6hi98Aw ($38.70 in chips) 
k9nHZTHt8hYhYRcW8NTb4g: posts small blind $0.10
mFv3iBCtrw9XfCDRB0d46Q: is sitting out 
xrf8tAXKQHG99HixCot1Iw: posts big blind $0.25
*** HOLE CARDS ***
mFv3iBCtrw9XfCDRB0d46Q leaves the table
iyZxqznXjv3vtvOJymkoLQ: folds 
mfrkWA3PTeYPkbO6hi98Aw: folds 
pokjbbEcXXPlADXdSGHtZw: folds 
hOaWAImn5/MZDAWAPlYHCw joins the table at seat #3 
k9nHZTHt8hYhYRcW8NTb4g: raises $0.75 to $1
xrf8tAXKQHG99HixCot1Iw: folds 
Uncalled bet ($0.75) returned to k9nHZTHt8hYhYRcW8NTb4g
k9nHZTHt8hYhYRcW8NTb4g collected $0.50 from pot
k9nHZTHt8hYhYRcW8NTb4g: doesn't show hand 
*** SUMMARY ***
Total pot $0.50 | Rake $0 
Seat 1: pokjbbEcXXPlADXdSGHtZw (button) folded before Flop (didn't bet)
Seat 2: k9nHZTHt8hYhYRcW8NTb4g (small blind) collected ($0.50)
Seat 4: xrf8tAXKQHG99HixCot1Iw (big blind) folded before Flop
Seat 5: iyZxqznXjv3vtvOJymkoLQ folded before Flop (didn't bet)
Seat 6: mfrkWA3PTeYPkbO6hi98Aw folded before Flop (didn't bet)




PokerStars Game #59941913898:  Hold'em No Limit ($0.10/$0.25) - 2009/07/01 1:50:11 ET
Table 'nyTW9cVtYentc5V7xU/0jA' 6-max Seat #4 is the button
Seat 1: HI20pVxSHPZ29u9IDkmICg ($6.80 in chips) 
Seat 3: kG34n23qFQA3nzdOJTQ1dA ($35.50 in chips) 
Seat 4: NkB3D4eVHHXvB9Edaugc1Q ($35.20 in chips) 
Seat 5: zZAcuQ0EvirdEuiIbeaocQ ($6.95 in chips) 
Seat 6: Cwf8Ho8JHNvwzsv9ah8uRQ ($19.15 in chips) 
zZAcuQ0EvirdEuiIbeaocQ: posts small blind $0.10
Cwf8Ho8JHNvwzsv9ah8uRQ: posts big blind $0.25
glad1kkk: sits out 
*** HOLE CARDS ***
HI20pVxSHPZ29u9IDkmICg: raises $0.50 to $0.75
kG34n23qFQA3nzdOJTQ1dA: folds 
NkB3D4eVHHXvB9Edaugc1Q: folds 
zZAcuQ0EvirdEuiIbeaocQ: folds 
Cwf8Ho8JHNvwzsv9ah8uRQ: folds 
Uncalled bet ($0.50) returned to HI20pVxSHPZ29u9IDkmICg
HI20pVxSHPZ29u9IDkmICg collected $0.60 from pot
*** SUMMARY ***
Total pot $0.60 | Rake $0 
Seat 1: HI20pVxSHPZ29u9IDkmICg collected ($0.60)
Seat 3: kG34n23qFQA3nzdOJTQ1dA folded before Flop (didn't bet)
Seat 4: NkB3D4eVHHXvB9Edaugc1Q (button) folded before Flop (didn't bet)
Seat 5: zZAcuQ0EvirdEuiIbeaocQ (small blind) folded before Flop
Seat 6: Cwf8Ho8JHNvwzsv9ah8uRQ (big blind) folded before Flop




PokerStars Game #59941913934:  Hold'em No Limit ($0.10/$0.25) - 2009/07/01 1:50:11 ET
Table '2clPgY3+dETPD/8zjXZdFw' 6-max Seat #3 is the button
Seat 1: 7cx44/slbeTw+Cy7QB8Trg ($25.45 in chips) 
Seat 2: cWc85bEzdRzpUMhRKm8pwQ ($25 in chips) 
Seat 3: FL1UWpN6oReBdznWDOy9Gg ($16.35 in chips) 
Seat 4: ljjhtb6FVPTx9AT9HNdtqg ($23.85 in chips) 
Seat 5: LJI7A1YgDM7hgh7o56+ReQ ($29.55 in chips) 
ljjhtb6FVPTx9AT9HNdtqg: posts small blind $0.10
LJI7A1YgDM7hgh7o56+ReQ: posts big blind $0.25
c3J/KYZ4cNsUEuz8v57I5A: sits out 
*** HOLE CARDS ***
7cx44/slbeTw+Cy7QB8Trg: folds 
cWc85bEzdRzpUMhRKm8pwQ: folds 
FL1UWpN6oReBdznWDOy9Gg: calls $0.25
ljjhtb6FVPTx9AT9HNdtqg: raises $0.50 to $0.75
LJI7A1YgDM7hgh7o56+ReQ: raises $2.25 to $3
FL1UWpN6oReBdznWDOy9Gg: folds 
ljjhtb6FVPTx9AT9HNdtqg: folds 
Uncalled bet ($2.25) returned to LJI7A1YgDM7hgh7o56+ReQ
LJI7A1YgDM7hgh7o56+ReQ collected $1.75 from pot
LJI7A1YgDM7hgh7o56+ReQ: doesn't show hand 
*** SUMMARY ***
Total pot $1.75 | Rake $0 
Seat 1: 7cx44/slbeTw+Cy7QB8Trg folded before Flop (didn't bet)
Seat 2: cWc85bEzdRzpUMhRKm8pwQ folded before Flop (didn't bet)
Seat 3: FL1UWpN6oReBdznWDOy9Gg (button) folded before Flop
Seat 4: ljjhtb6FVPTx9AT9HNdtqg (small blind) folded before Flop
Seat 5: LJI7A1YgDM7hgh7o56+ReQ (big blind) collected ($1.75)




PokerStars Game #59941913880:  Hold'em No Limit ($0.10/$0.25) - 2009/07/01 1:50:11 ET
Table 'G+4ZdyRoPjgaJY/jxSlZzQ' 9-max Seat #7 is the button
Seat 1: ghNKXUBl/H+t83JF079ZBA ($23.75 in chips) 
Seat 2: CT7Xj/V/O5rBlhtt+RZeFQ ($25 in chips) 
Seat 3: FaGtAm5QUVcixGhAKIvbLg ($7.40 in chips) 
Seat 4: 3PmVnC/15cl4oyI1TKIt4g ($4.65 in chips) 
Seat 5: BT6Oal0iO4P6kDuT7HFQDw ($23.50 in chips) 
Seat 6: oFwaTjy3ok/+qFghsrcGvg ($21.55 in chips) 
Seat 7: qwr38jl5txoR36M7G5qi4A ($10.65 in chips) 
Seat 8: bXpVeaSTPBFSPJmeXxO7nw ($4.40 in chips) 
Seat 9: tLcDklc2rBORNfixyRfVfw ($26.50 in chips) 
bXpVeaSTPBFSPJmeXxO7nw: posts small blind $0.10
tLcDklc2rBORNfixyRfVfw: posts big blind $0.25
*** HOLE CARDS ***
ghNKXUBl/H+t83JF079ZBA: folds 
CT7Xj/V/O5rBlhtt+RZeFQ: folds 
FaGtAm5QUVcixGhAKIvbLg: folds 
3PmVnC/15cl4oyI1TKIt4g: folds 
BT6Oal0iO4P6kDuT7HFQDw: folds 
oFwaTjy3ok/+qFghsrcGvg: folds 
qwr38jl5txoR36M7G5qi4A: folds 
bXpVeaSTPBFSPJmeXxO7nw: folds 
Uncalled bet ($0.15) returned to tLcDklc2rBORNfixyRfVfw
tLcDklc2rBORNfixyRfVfw collected $0.20 from pot
tLcDklc2rBORNfixyRfVfw: doesn't show hand 
*** SUMMARY ***
Total pot $0.20 | Rake $0 
Seat 1: ghNKXUBl/H+t83JF079ZBA folded before Flop (didn't bet)
Seat 2: CT7Xj/V/O5rBlhtt+RZeFQ folded before Flop (didn't bet)
Seat 3: FaGtAm5QUVcixGhAKIvbLg folded before Flop (didn't bet)
Seat 4: 3PmVnC/15cl4oyI1TKIt4g folded before Flop (didn't bet)
Seat 5: BT6Oal0iO4P6kDuT7HFQDw folded before Flop (didn't bet)
Seat 6: oFwaTjy3ok/+qFghsrcGvg folded before Flop (didn't bet)
Seat 7: qwr38jl5txoR36M7G5qi4A (button) folded before Flop (didn't bet)
Seat 8: bXpVeaSTPBFSPJmeXxO7nw (small blind) folded before Flop
Seat 9: tLcDklc2rBORNfixyRfVfw (big blind) collected ($0.20)




PokerStars Game #59941913864:  Hold'em No Limit ($0.10/$0.25) - 2009/07/01 1:50:11 ET
Table '2VkNDXXsBj4bSZw/uK5atw' 6-max Seat #6 is the button
Seat 1: xrf8tAXKQHG99HixCot1Iw ($25 in chips) 
Seat 2: GbCVUNssQ7mqsPWr7J4d3w ($5 in chips) 
Seat 3: P+6Z5+8H5/Wyt/jHMovNvQ ($24.75 in chips) 
Seat 4: 4kIRqWKE/N0yUAcWVhLSoQ ($13.65 in chips) 
Seat 5: 7f0OkhFEOf3T+rVOFHRLnw ($21.25 in chips) 
Seat 6: n6UPMnVR4v8LFP0rWP73Fg ($12.10 in chips) 
xrf8tAXKQHG99HixCot1Iw: posts small blind $0.10
GbCVUNssQ7mqsPWr7J4d3w: posts big blind $0.25
*** HOLE CARDS ***
P+6Z5+8H5/Wyt/jHMovNvQ: raises $0.50 to $0.75
4kIRqWKE/N0yUAcWVhLSoQ: folds 
7f0OkhFEOf3T+rVOFHRLnw: folds 
n6UPMnVR4v8LFP0rWP73Fg: folds 
xrf8tAXKQHG99HixCot1Iw: folds 
GbCVUNssQ7mqsPWr7J4d3w: folds 
Uncalled bet ($0.50) returned to P+6Z5+8H5/Wyt/jHMovNvQ
P+6Z5+8H5/Wyt/jHMovNvQ collected $0.60 from pot
P+6Z5+8H5/Wyt/jHMovNvQ: doesn't show hand 
*** SUMMARY ***
Total pot $0.60 | Rake $0 
Seat 1: xrf8tAXKQHG99HixCot1Iw (small blind) folded before Flop
Seat 2: GbCVUNssQ7mqsPWr7J4d3w (big blind) folded before Flop
Seat 3: P+6Z5+8H5/Wyt/jHMovNvQ collected ($0.60)
Seat 4: 4kIRqWKE/N0yUAcWVhLSoQ folded before Flop (didn't bet)
Seat 5: 7f0OkhFEOf3T+rVOFHRLnw folded before Flop (didn't bet)
Seat 6: n6UPMnVR4v8LFP0rWP73Fg (button) folded before Flop (didn't bet)




PokerStars Game #59941914144:  Hold'em No Limit ($0.10/$0.25) - 2009/07/01 1:50:11 ET
Table 'vFZR6Kf2Th5xBXT9brGW6A' 6-max Seat #4 is the button
Seat 1: Q1uciOZPBR/WkAlqa6cL4A ($25 in chips) 
Seat 2: QiL+lEgEWwy21jk/ltaRLg ($20.80 in chips) 
Seat 3: SH1WjKVUjPiyXySjWSdazw ($41.65 in chips) 
Seat 4: 79ID/ub1Pt/mDpCprVmOoA ($34.85 in chips) 
Seat 5: SS/yfeArhULzIcOPe8MdPg ($27.10 in chips) 
Seat 6: 4x9jCqgSw4272dnaIqnanw ($10.55 in chips) 
SS/yfeArhULzIcOPe8MdPg: posts small blind $0.10
4x9jCqgSw4272dnaIqnanw: posts big blind $0.25
*** HOLE CARDS ***
Q1uciOZPBR/WkAlqa6cL4A: folds 
QiL+lEgEWwy21jk/ltaRLg: folds 
SH1WjKVUjPiyXySjWSdazw: calls $0.25
79ID/ub1Pt/mDpCprVmOoA: folds 
SS/yfeArhULzIcOPe8MdPg: calls $0.15
4x9jCqgSw4272dnaIqnanw: checks 
*** FLOP *** [4h 4s 3h]
SS/yfeArhULzIcOPe8MdPg: bets $0.50
4x9jCqgSw4272dnaIqnanw: folds 
SH1WjKVUjPiyXySjWSdazw: folds 
Uncalled bet ($0.50) returned to SS/yfeArhULzIcOPe8MdPg
SS/yfeArhULzIcOPe8MdPg collected $0.75 from pot
*** SUMMARY ***
Total pot $0.75 | Rake $0 
Board [4h 4s 3h]
Seat 1: Q1uciOZPBR/WkAlqa6cL4A folded before Flop (didn't bet)
Seat 2: QiL+lEgEWwy21jk/ltaRLg folded before Flop (didn't bet)
Seat 3: SH1WjKVUjPiyXySjWSdazw folded on the Flop
Seat 4: 79ID/ub1Pt/mDpCprVmOoA (button) folded before Flop (didn't bet)
Seat 5: SS/yfeArhULzIcOPe8MdPg (small blind) collected ($0.75)
Seat 6: 4x9jCqgSw4272dnaIqnanw (big blind) folded on the Flop




PokerStars Game #59941914348:  Hold'em No Limit ($0.10/$0.25) - 2009/07/01 1:50:12 ET
Table 'L5GvbdQO5aCZJSE6pyQ8OA' 6-max Seat #2 is the button
Seat 1: eFj4lr1nuXLyCWNTShr1bg ($11.10 in chips) 
Seat 2: DihMHaz4WNETH1bPDe13kA ($30.55 in chips) 
Seat 3: JFIAqU8lCZ0vWwEl4bdGsg ($25 in chips) 
Seat 4: trN/oHqTTbPw5MNuKrOpLw ($27.50 in chips) 
Seat 5: LyDHtw3/yniNHW+DvLXbog ($29.25 in chips) 
Seat 6: v+QfkGiuj9bgtuNoVnDO8w ($38.70 in chips) 
JFIAqU8lCZ0vWwEl4bdGsg: posts small blind $0.10
trN/oHqTTbPw5MNuKrOpLw: posts big blind $0.25
eFj4lr1nuXLyCWNTShr1bg: posts small & big blinds $0.35
*** HOLE CARDS ***
LyDHtw3/yniNHW+DvLXbog: folds 
v+QfkGiuj9bgtuNoVnDO8w: folds 
eFj4lr1nuXLyCWNTShr1bg: raises $0.50 to $0.75
DihMHaz4WNETH1bPDe13kA: folds 
JFIAqU8lCZ0vWwEl4bdGsg: folds 
trN/oHqTTbPw5MNuKrOpLw: folds 
Uncalled bet ($0.50) returned to eFj4lr1nuXLyCWNTShr1bg
eFj4lr1nuXLyCWNTShr1bg collected $0.70 from pot
eFj4lr1nuXLyCWNTShr1bg: doesn't show hand 
*** SUMMARY ***
Total pot $0.70 | Rake $0 
Seat 1: eFj4lr1nuXLyCWNTShr1bg collected ($0.70)
Seat 2: DihMHaz4WNETH1bPDe13kA (button) folded before Flop (didn't bet)
Seat 3: JFIAqU8lCZ0vWwEl4bdGsg (small blind) folded before Flop
Seat 4: trN/oHqTTbPw5MNuKrOpLw (big blind) folded before Flop
Seat 5: LyDHtw3/yniNHW+DvLXbog folded before Flop (didn't bet)
Seat 6: v+QfkGiuj9bgtuNoVnDO8w folded before Flop (didn't bet)




PokerStars Game #59941914746:  Hold'em No Limit ($0.10/$0.25) - 2009/07/01 1:50:12 ET
Table '5VWnrlxdjwVfMWkVS2WE7A' 6-max Seat #3 is the button
Seat 1: 82p+w3EmUaFFHuwpSeGY1w ($13.10 in chips) 
Seat 2: LJI7A1YgDM7hgh7o56+ReQ ($44.10 in chips) 
Seat 3: SFmT9ZsVopnukjvAzrxTRg ($37 in chips) 
Seat 4: Pb/gJ3OxOZx57fFp0MDgkg ($34.95 in chips) 
Seat 5: 32YL2ZEp8NT4JB2RVM9euQ ($16 in chips) 
Seat 6: LtASJ9OlkqGrrUKGQlpGAw ($25 in chips) 
Pb/gJ3OxOZx57fFp0MDgkg: posts small blind $0.10
32YL2ZEp8NT4JB2RVM9euQ: posts big blind $0.25
*** HOLE CARDS ***
LtASJ9OlkqGrrUKGQlpGAw: folds 
82p+w3EmUaFFHuwpSeGY1w: folds 
LJI7A1YgDM7hgh7o56+ReQ: folds 
SFmT9ZsVopnukjvAzrxTRg: raises $0.75 to $1
Pb/gJ3OxOZx57fFp0MDgkg: folds 
32YL2ZEp8NT4JB2RVM9euQ: folds 
Uncalled bet ($0.75) returned to SFmT9ZsVopnukjvAzrxTRg
SFmT9ZsVopnukjvAzrxTRg collected $0.60 from pot
SFmT9ZsVopnukjvAzrxTRg: doesn't show hand 
*** SUMMARY ***
Total pot $0.60 | Rake $0 
Seat 1: 82p+w3EmUaFFHuwpSeGY1w folded before Flop (didn't bet)
Seat 2: LJI7A1YgDM7hgh7o56+ReQ folded before Flop (didn't bet)
Seat 3: SFmT9ZsVopnukjvAzrxTRg (button) collected ($0.60)
Seat 4: Pb/gJ3OxOZx57fFp0MDgkg (small blind) folded before Flop
Seat 5: 32YL2ZEp8NT4JB2RVM9euQ (big blind) folded before Flop
Seat 6: LtASJ9OlkqGrrUKGQlpGAw folded before Flop (didn't bet)




PokerStars Game #59941914292:  Hold'em No Limit ($0.10/$0.25) - 2009/07/01 1:50:12 ET
Table 'zKwHJD0cmKNUure9qQTfFg' 6-max Seat #3 is the button
Seat 1: Hzrn9DZJegEZICufTNYkrg ($17.50 in chips) 
Seat 2: xrf8tAXKQHG99HixCot1Iw ($31.55 in chips) 
Seat 3: m9aw7LBAB5YX2ZqMtMkhqA ($13.90 in chips) 
Seat 4: v+QfkGiuj9bgtuNoVnDO8w ($25 in chips) 
Seat 5: E4AqQ1egsnu0oH2RqsbCmQ ($4.65 in chips) 
Seat 6: edio/rLJ06xeZOfLhoL3UA ($5.85 in chips) 
v+QfkGiuj9bgtuNoVnDO8w: posts small blind $0.10
E4AqQ1egsnu0oH2RqsbCmQ: posts big blind $0.25
*** HOLE CARDS ***
edio/rLJ06xeZOfLhoL3UA: folds 
Hzrn9DZJegEZICufTNYkrg: folds 
xrf8tAXKQHG99HixCot1Iw: folds 
m9aw7LBAB5YX2ZqMtMkhqA: calls $0.25
v+QfkGiuj9bgtuNoVnDO8w: folds 
E4AqQ1egsnu0oH2RqsbCmQ: checks 
*** FLOP *** [Jh 2h 5s]
E4AqQ1egsnu0oH2RqsbCmQ: bets $1
m9aw7LBAB5YX2ZqMtMkhqA: calls $1
*** TURN *** [Jh 2h 5s] [3c]
E4AqQ1egsnu0oH2RqsbCmQ: bets $2.50
m9aw7LBAB5YX2ZqMtMkhqA: calls $2.50
*** RIVER *** [Jh 2h 5s 3c] [Qs]
E4AqQ1egsnu0oH2RqsbCmQ: bets $0.90 and is all-in
m9aw7LBAB5YX2ZqMtMkhqA: calls $0.90
*** SHOW DOWN ***
E4AqQ1egsnu0oH2RqsbCmQ: shows [5h 2c] (two pair, Fives and Deuces)
m9aw7LBAB5YX2ZqMtMkhqA: shows [Qd Js] (two pair, Queens and Jacks)
m9aw7LBAB5YX2ZqMtMkhqA collected $8.95 from pot
*** SUMMARY ***
Total pot $9.40 | Rake $0.45 
Board [Jh 2h 5s 3c Qs]
Seat 1: Hzrn9DZJegEZICufTNYkrg folded before Flop (didn't bet)
Seat 2: xrf8tAXKQHG99HixCot1Iw folded before Flop (didn't bet)
Seat 3: m9aw7LBAB5YX2ZqMtMkhqA (button) showed [Qd Js] and won ($8.95) with two pair, Queens and Jacks
Seat 4: v+QfkGiuj9bgtuNoVnDO8w (small blind) folded before Flop
Seat 5: E4AqQ1egsnu0oH2RqsbCmQ (big blind) showed [5h 2c] and lost with two pair, Fives and Deuces
Seat 6: edio/rLJ06xeZOfLhoL3UA folded before Flop (didn't bet)




PokerStars Game #59941914590:  Hold'em No Limit ($0.10/$0.25) - 2009/07/01 1:50:12 ET
Table 'KKk6y4pAXeymxYcd0uZLqg' 9-max Seat #8 is the button
Seat 1: HPEB+AtKw1+C/cxU0o1ciw ($24.90 in chips) 
Seat 3: tLcDklc2rBORNfixyRfVfw ($25 in chips) 
Seat 5: wGigCmBR/9XWkPpvYos3aQ ($40.70 in chips) 
Seat 6: QEbIGci+itdw+re8RM5fZA ($25 in chips) 
Seat 7: JjOuv8Vf56aiQjWi/rTPFA ($22.90 in chips) 
Seat 8: +2kMBNpY4nF1qNCRd8SJLA ($36.05 in chips) 
Seat 9: oLa/tXLfSLLB28mcLGrxcg ($25.20 in chips) 
oLa/tXLfSLLB28mcLGrxcg: posts small blind $0.10
HPEB+AtKw1+C/cxU0o1ciw: posts big blind $0.25
jeffro7474: sits out 
18G4P1XstjNvItdGUITxgw: sits out 
*** HOLE CARDS ***
tLcDklc2rBORNfixyRfVfw: folds 
wGigCmBR/9XWkPpvYos3aQ: folds 
QEbIGci+itdw+re8RM5fZA: folds 
JjOuv8Vf56aiQjWi/rTPFA: folds 
+2kMBNpY4nF1qNCRd8SJLA: folds 
oLa/tXLfSLLB28mcLGrxcg: folds 
Uncalled bet ($0.15) returned to HPEB+AtKw1+C/cxU0o1ciw
HPEB+AtKw1+C/cxU0o1ciw collected $0.20 from pot
HPEB+AtKw1+C/cxU0o1ciw: doesn't show hand 
*** SUMMARY ***
Total pot $0.20 | Rake $0 
Seat 1: HPEB+AtKw1+C/cxU0o1ciw (big blind) collected ($0.20)
Seat 3: tLcDklc2rBORNfixyRfVfw folded before Flop (didn't bet)
Seat 5: wGigCmBR/9XWkPpvYos3aQ folded before Flop (didn't bet)
Seat 6: QEbIGci+itdw+re8RM5fZA folded before Flop (didn't bet)
Seat 7: JjOuv8Vf56aiQjWi/rTPFA folded before Flop (didn't bet)
Seat 8: +2kMBNpY4nF1qNCRd8SJLA (button) folded before Flop (didn't bet)
Seat 9: oLa/tXLfSLLB28mcLGrxcg (small blind) folded before Flop




PokerStars Game #59941914382:  Hold'em No Limit ($0.10/$0.25) - 2009/07/01 1:50:12 ET
Table '1HT8bEDpLPhOXxmqMtzF8w' 9-max Seat #7 is the button
Seat 1: YkkKQUDI0iWatY4h0WWaAQ ($12.65 in chips) 
Seat 2: r6hsffOo1iKmaPYKwAZmFw ($29 in chips) 
Seat 3: oLa/tXLfSLLB28mcLGrxcg ($23.50 in chips) 
Seat 6: bXpVeaSTPBFSPJmeXxO7nw ($5.90 in chips) 
Seat 7: PMhmqYBPHOAXjH25lRz69g ($16.40 in chips) 
Seat 8: ghNKXUBl/H+t83JF079ZBA ($33.40 in chips) 
Seat 9: Z9W7+g1WMhhZDi7DwGbCFA ($5 in chips) 
ghNKXUBl/H+t83JF079ZBA: posts small blind $0.10
Z9W7+g1WMhhZDi7DwGbCFA: posts big blind $0.25
*** HOLE CARDS ***
YkkKQUDI0iWatY4h0WWaAQ: folds 
r6hsffOo1iKmaPYKwAZmFw: folds 
oLa/tXLfSLLB28mcLGrxcg: folds 
bXpVeaSTPBFSPJmeXxO7nw: folds 
PMhmqYBPHOAXjH25lRz69g: raises $0.25 to $0.50
ghNKXUBl/H+t83JF079ZBA: folds 
Z9W7+g1WMhhZDi7DwGbCFA: folds 
Uncalled bet ($0.25) returned to PMhmqYBPHOAXjH25lRz69g
aNpwfA31EREwO+ar4XzBCw leaves the table
PMhmqYBPHOAXjH25lRz69g collected $0.60 from pot
PMhmqYBPHOAXjH25lRz69g: doesn't show hand 
*** SUMMARY ***
Total pot $0.60 | Rake $0 
Seat 1: YkkKQUDI0iWatY4h0WWaAQ folded before Flop (didn't bet)
Seat 2: r6hsffOo1iKmaPYKwAZmFw folded before Flop (didn't bet)
Seat 3: oLa/tXLfSLLB28mcLGrxcg folded before Flop (didn't bet)
Seat 6: bXpVeaSTPBFSPJmeXxO7nw folded before Flop (didn't bet)
Seat 7: PMhmqYBPHOAXjH25lRz69g (button) collected ($0.60)
Seat 8: ghNKXUBl/H+t83JF079ZBA (small blind) folded before Flop
Seat 9: Z9W7+g1WMhhZDi7DwGbCFA (big blind) folded before Flop




PokerStars Game #59941914442:  Hold'em No Limit ($0.10/$0.25) - 2009/07/01 1:50:12 ET
Table 'vud0GB/ZlDCvUFhBFIaTlg' 9-max Seat #6 is the button
Seat 1: DiSvPC2iudwL5j9u6Huyww ($29.50 in chips) 
Seat 2: tLcDklc2rBORNfixyRfVfw ($25 in chips) 
Seat 3: W2YYHvqjaEpRrO7stZkClQ ($5.05 in chips) 
Seat 5: eK8qa6EPcH2zhtbmWSvc9g ($25.50 in chips) 
Seat 6: gehe91e0IyVT0QU/XBkEyg ($24.90 in chips) 
Seat 7: iG7VeTyBWf6wYNvZpbTcbw ($21.40 in chips) 
Seat 8: E0iYnEVO2ho7dH3QcCjw7g ($19.75 in chips) 
Seat 9: PdIasPkzm2sqZnN41ZRXOg ($5.20 in chips) 
iG7VeTyBWf6wYNvZpbTcbw: posts small blind $0.10
E0iYnEVO2ho7dH3QcCjw7g: posts big blind $0.25
aintblinkin: sits out 
*** HOLE CARDS ***
PdIasPkzm2sqZnN41ZRXOg: folds 
DiSvPC2iudwL5j9u6Huyww: folds 
tLcDklc2rBORNfixyRfVfw: folds 
W2YYHvqjaEpRrO7stZkClQ: folds 
eK8qa6EPcH2zhtbmWSvc9g: folds 
gehe91e0IyVT0QU/XBkEyg: folds 
iG7VeTyBWf6wYNvZpbTcbw: calls $0.15
eK8qa6EPcH2zhtbmWSvc9g leaves the table
E0iYnEVO2ho7dH3QcCjw7g: checks 
*** FLOP *** [Qc Jd Qd]
iG7VeTyBWf6wYNvZpbTcbw: checks 
E0iYnEVO2ho7dH3QcCjw7g: checks 
*** TURN *** [Qc Jd Qd] [As]
iG7VeTyBWf6wYNvZpbTcbw: bets $0.25
E0iYnEVO2ho7dH3QcCjw7g: folds 
Uncalled bet ($0.25) returned to iG7VeTyBWf6wYNvZpbTcbw
iG7VeTyBWf6wYNvZpbTcbw collected $0.50 from pot
*** SUMMARY ***
Total pot $0.50 | Rake $0 
Board [Qc Jd Qd As]
Seat 1: DiSvPC2iudwL5j9u6Huyww folded before Flop (didn't bet)
Seat 2: tLcDklc2rBORNfixyRfVfw folded before Flop (didn't bet)
Seat 3: W2YYHvqjaEpRrO7stZkClQ folded before Flop (didn't bet)
Seat 5: eK8qa6EPcH2zhtbmWSvc9g folded before Flop (didn't bet)
Seat 6: gehe91e0IyVT0QU/XBkEyg (button) folded before Flop (didn't bet)
Seat 7: iG7VeTyBWf6wYNvZpbTcbw (small blind) collected ($0.50)
Seat 8: E0iYnEVO2ho7dH3QcCjw7g (big blind) folded on the Turn
Seat 9: PdIasPkzm2sqZnN41ZRXOg folded before Flop (didn't bet)




PokerStars Game #59941914316:  Hold'em No Limit ($0.10/$0.25) - 2009/07/01 1:50:12 ET
Table 'edvgY2YQ1I34euq4EVqGnA' 6-max Seat #6 is the button
Seat 1: mvFHK3pE7tCxJEqLjKC70Q ($30.45 in chips) 
Seat 2: Hsvkc0/G2VV78oVmWYXecw ($5.25 in chips) 
Seat 4: TI/C5Q+DEl4fLR3AofwYdg ($23.60 in chips) 
Seat 5: EE16Ua5b1HSsYej5zeXOlA ($56 in chips) 
Seat 6: kG34n23qFQA3nzdOJTQ1dA ($70.40 in chips) 
mvFHK3pE7tCxJEqLjKC70Q: posts small blind $0.10
Hsvkc0/G2VV78oVmWYXecw: posts big blind $0.25
*** HOLE CARDS ***
TI/C5Q+DEl4fLR3AofwYdg: raises $0.75 to $1
EE16Ua5b1HSsYej5zeXOlA: calls $1
kG34n23qFQA3nzdOJTQ1dA: folds 
mvFHK3pE7tCxJEqLjKC70Q: folds 
Hsvkc0/G2VV78oVmWYXecw: folds 
*** FLOP *** [Jh 9s Td]
TI/C5Q+DEl4fLR3AofwYdg: checks 
EE16Ua5b1HSsYej5zeXOlA: bets $1.25
maggierusty joins the table at seat #3 
TI/C5Q+DEl4fLR3AofwYdg: folds 
Uncalled bet ($1.25) returned to EE16Ua5b1HSsYej5zeXOlA
EE16Ua5b1HSsYej5zeXOlA collected $2.25 from pot
EE16Ua5b1HSsYej5zeXOlA: doesn't show hand 
*** SUMMARY ***
Total pot $2.35 | Rake $0.10 
Board [Jh 9s Td]
Seat 1: mvFHK3pE7tCxJEqLjKC70Q (small blind) folded before Flop
Seat 2: Hsvkc0/G2VV78oVmWYXecw (big blind) folded before Flop
Seat 4: TI/C5Q+DEl4fLR3AofwYdg folded on the Flop
Seat 5: EE16Ua5b1HSsYej5zeXOlA collected ($2.25)
Seat 6: kG34n23qFQA3nzdOJTQ1dA (button) folded before Flop (didn't bet)




PokerStars Game #59941915210:  Hold'em No Limit ($0.10/$0.25) - 2009/07/01 1:50:13 ET
Table 'Yb2CyZosw7N3yRRVLhKnKg' 9-max Seat #7 is the button
Seat 1: c/9X4zftzphFxYtxp5kp9w ($11.55 in chips) 
Seat 2: dtZ84flFEi4Q+SGrHMJRDQ ($26.15 in chips) 
Seat 3: wUanlt/hhheMA+jOrJk2Tg ($9.15 in chips) 
Seat 4: FG10kumpruEJ3PQJ7oGglQ ($16.90 in chips) 
Seat 6: CgIo2ItZqi4o3ayVG6HanQ ($43.75 in chips) 
Seat 7: ljemhp25Zg+nlA9DLCIiUw ($24.75 in chips) 
Seat 8: HxDF4QSxC4z39D7teZpprQ ($13.30 in chips) 
Seat 9: 6DVf3fwEGECnjQ4Yp9AsFw ($16.55 in chips) 
HxDF4QSxC4z39D7teZpprQ: posts small blind $0.10
6DVf3fwEGECnjQ4Yp9AsFw: posts big blind $0.25
ydoFOVgzvZv9ZhuWu9rXAw: sits out 
*** HOLE CARDS ***
c/9X4zftzphFxYtxp5kp9w: folds 
c/9X4zftzphFxYtxp5kp9w leaves the table
dtZ84flFEi4Q+SGrHMJRDQ: folds 
wUanlt/hhheMA+jOrJk2Tg: folds 
FG10kumpruEJ3PQJ7oGglQ: raises $0.50 to $0.75
CgIo2ItZqi4o3ayVG6HanQ: folds 
fie963 joins the table at seat #1 
ljemhp25Zg+nlA9DLCIiUw: folds 
HxDF4QSxC4z39D7teZpprQ: folds 
6DVf3fwEGECnjQ4Yp9AsFw: folds 
Uncalled bet ($0.50) returned to FG10kumpruEJ3PQJ7oGglQ
FG10kumpruEJ3PQJ7oGglQ collected $0.60 from pot
*** SUMMARY ***
Total pot $0.60 | Rake $0 
Seat 1: c/9X4zftzphFxYtxp5kp9w folded before Flop (didn't bet)
Seat 2: dtZ84flFEi4Q+SGrHMJRDQ folded before Flop (didn't bet)
Seat 3: wUanlt/hhheMA+jOrJk2Tg folded before Flop (didn't bet)
Seat 4: FG10kumpruEJ3PQJ7oGglQ collected ($0.60)
Seat 6: CgIo2ItZqi4o3ayVG6HanQ folded before Flop (didn't bet)
Seat 7: ljemhp25Zg+nlA9DLCIiUw (button) folded before Flop (didn't bet)
Seat 8: HxDF4QSxC4z39D7teZpprQ (small blind) folded before Flop
Seat 9: 6DVf3fwEGECnjQ4Yp9AsFw (big blind) folded before Flop




PokerStars Game #59941915008:  Hold'em No Limit ($0.10/$0.25) - 2009/07/01 1:50:13 ET
Table 'by7aHYEDnDd144EXOXa/jA' 9-max Seat #7 is the button
Seat 1: j4q3p0lesp63b1gZDwLBZw ($7.65 in chips) 
Seat 2: vSkQm2EelzwRGDDQQk0Fqw ($8.90 in chips) 
Seat 3: HOEaXncFu2ij+D5/CANAZA ($11.90 in chips) 
Seat 4: 2Xwi447v1rBHM+92U0CduA ($4.40 in chips) 
Seat 5: yyG4svzOpC1A+sUP/scg6w ($3.85 in chips) 
Seat 6: sC4BsflLWW26Qm9m+1AwJQ ($10.15 in chips) 
Seat 7: Z9W7+g1WMhhZDi7DwGbCFA ($5.35 in chips) 
Seat 8: 7je+LC5Mfs6nL8YBVh4frQ ($3.60 in chips) 
Seat 9: K0b5wNInj6hUGRr6yzKFtw ($25.05 in chips) 
7je+LC5Mfs6nL8YBVh4frQ: posts small blind $0.10
K0b5wNInj6hUGRr6yzKFtw: posts big blind $0.25
*** HOLE CARDS ***
j4q3p0lesp63b1gZDwLBZw: folds 
vSkQm2EelzwRGDDQQk0Fqw: folds 
HOEaXncFu2ij+D5/CANAZA: calls $0.25
2Xwi447v1rBHM+92U0CduA: folds 
yyG4svzOpC1A+sUP/scg6w: folds 
sC4BsflLWW26Qm9m+1AwJQ: calls $0.25
Z9W7+g1WMhhZDi7DwGbCFA: folds 
7je+LC5Mfs6nL8YBVh4frQ: calls $0.15
K0b5wNInj6hUGRr6yzKFtw: checks 
*** FLOP *** [8h Ks 7h]
7je+LC5Mfs6nL8YBVh4frQ: checks 
K0b5wNInj6hUGRr6yzKFtw: checks 
HOEaXncFu2ij+D5/CANAZA: checks 
sC4BsflLWW26Qm9m+1AwJQ: checks 
*** TURN *** [8h Ks 7h] [3c]
7je+LC5Mfs6nL8YBVh4frQ: checks 
K0b5wNInj6hUGRr6yzKFtw: checks 
HOEaXncFu2ij+D5/CANAZA: bets $0.25
sC4BsflLWW26Qm9m+1AwJQ: calls $0.25
7je+LC5Mfs6nL8YBVh4frQ: folds 
K0b5wNInj6hUGRr6yzKFtw: folds 
*** RIVER *** [8h Ks 7h 3c] [7d]
HOEaXncFu2ij+D5/CANAZA: bets $0.25
sC4BsflLWW26Qm9m+1AwJQ: folds 
Uncalled bet ($0.25) returned to HOEaXncFu2ij+D5/CANAZA
HOEaXncFu2ij+D5/CANAZA collected $1.45 from pot
HOEaXncFu2ij+D5/CANAZA: doesn't show hand 
*** SUMMARY ***
Total pot $1.50 | Rake $0.05 
Board [8h Ks 7h 3c 7d]
Seat 1: j4q3p0lesp63b1gZDwLBZw folded before Flop (didn't bet)
Seat 2: vSkQm2EelzwRGDDQQk0Fqw folded before Flop (didn't bet)
Seat 3: HOEaXncFu2ij+D5/CANAZA collected ($1.45)
Seat 4: 2Xwi447v1rBHM+92U0CduA folded before Flop (didn't bet)
Seat 5: yyG4svzOpC1A+sUP/scg6w folded before Flop (didn't bet)
Seat 6: sC4BsflLWW26Qm9m+1AwJQ folded on the River
Seat 7: Z9W7+g1WMhhZDi7DwGbCFA (button) folded before Flop (didn't bet)
Seat 8: 7je+LC5Mfs6nL8YBVh4frQ (small blind) folded on the Turn
Seat 9: K0b5wNInj6hUGRr6yzKFtw (big blind) folded on the Turn




PokerStars Game #59941915084:  Hold'em No Limit ($0.10/$0.25) - 2009/07/01 1:50:13 ET
Table 'NgexmgEDEzICBeSO7YCrKQ' 6-max Seat #3 is the button
Seat 1: cezpHJ8FB07dj0xG+LhOvw ($28.55 in chips) 
Seat 2: 32YL2ZEp8NT4JB2RVM9euQ ($23.55 in chips) 
Seat 3: JFIAqU8lCZ0vWwEl4bdGsg ($27.20 in chips) 
Seat 4: xx+iYCDJhHJmNzrfeloyEg ($21.80 in chips) 
Seat 5: /MXkdT8TTs8Qp2LVTQNw6w ($41.95 in chips) 
Seat 6: k9nHZTHt8hYhYRcW8NTb4g ($11.30 in chips) 
xx+iYCDJhHJmNzrfeloyEg: posts small blind $0.10
/MXkdT8TTs8Qp2LVTQNw6w: posts big blind $0.25
*** HOLE CARDS ***
xx+iYCDJhHJmNzrfeloyEg said, "  I think 32YL2ZEp8NT4JB2RVM9euQ might be a subversive."
k9nHZTHt8hYhYRcW8NTb4g: raises $0.50 to $0.75
cezpHJ8FB07dj0xG+LhOvw: folds 
32YL2ZEp8NT4JB2RVM9euQ: folds 
JFIAqU8lCZ0vWwEl4bdGsg: folds 
/MXkdT8TTs8Qp2LVTQNw6w said, "sorry mate, too big a word for me. whats a subversive"
xx+iYCDJhHJmNzrfeloyEg: folds 
/MXkdT8TTs8Qp2LVTQNw6w: folds 
Uncalled bet ($0.50) returned to k9nHZTHt8hYhYRcW8NTb4g
k9nHZTHt8hYhYRcW8NTb4g collected $0.60 from pot
k9nHZTHt8hYhYRcW8NTb4g: doesn't show hand 
*** SUMMARY ***
Total pot $0.60 | Rake $0 
Seat 1: cezpHJ8FB07dj0xG+LhOvw folded before Flop (didn't bet)
Seat 2: 32YL2ZEp8NT4JB2RVM9euQ folded before Flop (didn't bet)
Seat 3: JFIAqU8lCZ0vWwEl4bdGsg (button) folded before Flop (didn't bet)
Seat 4: xx+iYCDJhHJmNzrfeloyEg (small blind) folded before Flop
Seat 5: /MXkdT8TTs8Qp2LVTQNw6w (big blind) folded before Flop
Seat 6: k9nHZTHt8hYhYRcW8NTb4g collected ($0.60)




PokerStars Game #59941914854:  Hold'em No Limit ($0.10/$0.25) - 2009/07/01 1:50:13 ET
Table 'MiquQrQZJJq9ZtgRIp9HFQ' 6-max Seat #5 is the button
Seat 1: c3J/KYZ4cNsUEuz8v57I5A ($24.65 in chips) 
Seat 2: 2+6voGl1T1DO63JePptI3g ($25.45 in chips) 
Seat 3: 9h7TNZ1TDGRUJXA6rI+ZTw ($9.75 in chips) 
Seat 4: wAKC8C/zN0c8V5v13dm9mA ($51.55 in chips) 
Seat 5: iyZxqznXjv3vtvOJymkoLQ ($26.40 in chips) 
Seat 6: GbCVUNssQ7mqsPWr7J4d3w ($4.75 in chips) 
GbCVUNssQ7mqsPWr7J4d3w: posts small blind $0.10
c3J/KYZ4cNsUEuz8v57I5A: posts big blind $0.25
*** HOLE CARDS ***
2+6voGl1T1DO63JePptI3g: calls $0.25
9h7TNZ1TDGRUJXA6rI+ZTw: folds 
wAKC8C/zN0c8V5v13dm9mA: folds 
iyZxqznXjv3vtvOJymkoLQ: folds 
GbCVUNssQ7mqsPWr7J4d3w: calls $0.15
c3J/KYZ4cNsUEuz8v57I5A: checks 
*** FLOP *** [Jc 3d 2h]
GbCVUNssQ7mqsPWr7J4d3w: checks 
c3J/KYZ4cNsUEuz8v57I5A: checks 
2+6voGl1T1DO63JePptI3g: checks 
*** TURN *** [Jc 3d 2h] [9h]
GbCVUNssQ7mqsPWr7J4d3w: checks 
c3J/KYZ4cNsUEuz8v57I5A: checks 
2+6voGl1T1DO63JePptI3g: checks 
*** RIVER *** [Jc 3d 2h 9h] [Ad]
GbCVUNssQ7mqsPWr7J4d3w: checks 
c3J/KYZ4cNsUEuz8v57I5A: checks 
2+6voGl1T1DO63JePptI3g: checks 
*** SHOW DOWN ***
GbCVUNssQ7mqsPWr7J4d3w: shows [Ks Qh] (high card Ace)
c3J/KYZ4cNsUEuz8v57I5A: shows [4d 2c] (a pair of Deuces)
2+6voGl1T1DO63JePptI3g: mucks hand 
c3J/KYZ4cNsUEuz8v57I5A collected $0.75 from pot
*** SUMMARY ***
Total pot $0.75 | Rake $0 
Board [Jc 3d 2h 9h Ad]
Seat 1: c3J/KYZ4cNsUEuz8v57I5A (big blind) showed [4d 2c] and won ($0.75) with a pair of Deuces
Seat 2: 2+6voGl1T1DO63JePptI3g mucked
Seat 3: 9h7TNZ1TDGRUJXA6rI+ZTw folded before Flop (didn't bet)
Seat 4: wAKC8C/zN0c8V5v13dm9mA folded before Flop (didn't bet)
Seat 5: iyZxqznXjv3vtvOJymkoLQ (button) folded before Flop (didn't bet)
Seat 6: GbCVUNssQ7mqsPWr7J4d3w (small blind) showed [Ks Qh] and lost with high card Ace




PokerStars Game #59941915300:  Hold'em No Limit ($0.10/$0.25) - 2009/07/01 1:50:14 ET
Table '2AUmC2Rslg+QUbLfdgNdfg' 6-max Seat #5 is the button
Seat 1: YDXAegrCnzc0l6TSDNboXQ ($23.60 in chips) 
Seat 2: PLksyNlTVRVZwxJVC2/1eA ($25 in chips) 
Seat 3: JFIAqU8lCZ0vWwEl4bdGsg ($31.20 in chips) 
Seat 4: lquriepNQBhDV5P1SWHhnA ($25.90 in chips) 
Seat 5: AMc4cCwUJhokdGRYIaVPhQ ($31.10 in chips) 
Seat 6: xBWc54v+UTSJOiKpbAbJWg ($10.55 in chips) 
xBWc54v+UTSJOiKpbAbJWg: posts small blind $0.10
YDXAegrCnzc0l6TSDNboXQ: posts big blind $0.25
*** HOLE CARDS ***
PLksyNlTVRVZwxJVC2/1eA: calls $0.25
JFIAqU8lCZ0vWwEl4bdGsg: folds 
lquriepNQBhDV5P1SWHhnA: folds 
AMc4cCwUJhokdGRYIaVPhQ: folds 
xBWc54v+UTSJOiKpbAbJWg: folds 
YDXAegrCnzc0l6TSDNboXQ: checks 
*** FLOP *** [Jh 5s Ks]
lquriepNQBhDV5P1SWHhnA leaves the table
YDXAegrCnzc0l6TSDNboXQ: checks 
PLksyNlTVRVZwxJVC2/1eA: checks 
*** TURN *** [Jh 5s Ks] [3s]
YDXAegrCnzc0l6TSDNboXQ: bets $0.50
PLksyNlTVRVZwxJVC2/1eA: folds 
Uncalled bet ($0.50) returned to YDXAegrCnzc0l6TSDNboXQ
NickAces12 joins the table at seat #4 
YDXAegrCnzc0l6TSDNboXQ collected $0.60 from pot
*** SUMMARY ***
Total pot $0.60 | Rake $0 
Board [Jh 5s Ks 3s]
Seat 1: YDXAegrCnzc0l6TSDNboXQ (big blind) collected ($0.60)
Seat 2: PLksyNlTVRVZwxJVC2/1eA folded on the Turn
Seat 3: JFIAqU8lCZ0vWwEl4bdGsg folded before Flop (didn't bet)
Seat 4: lquriepNQBhDV5P1SWHhnA folded before Flop (didn't bet)
Seat 5: AMc4cCwUJhokdGRYIaVPhQ (button) folded before Flop (didn't bet)
Seat 6: xBWc54v+UTSJOiKpbAbJWg (small blind) folded before Flop




PokerStars Game #59941915416:  Hold'em No Limit ($0.10/$0.25) - 2009/07/01 1:50:14 ET
Table 'nFlmVztKq1HJEWfxmdl15w' 9-max Seat #7 is the button
Seat 1: cZ99hugmLBj9KhTlc8nCSw ($25 in chips) 
Seat 2: Th3FldXKQW6hWVVPahaoOQ ($38.40 in chips) 
Seat 3: DdPXdieucQ+n99u1n3A+rQ ($5.70 in chips) 
Seat 4: +5dSUwD+/k2ktlnutSMivw ($10.50 in chips) 
Seat 5: Tx6zQdk5Ozt9ObEBlU7jeg ($45.30 in chips) 
Seat 6: 4awUyiDYTgylQKXZ9faBVA ($36.15 in chips) 
Seat 7: dfNim92Z6XK1/h5SFW5vDg ($34.95 in chips) 
Seat 8: +2kMBNpY4nF1qNCRd8SJLA ($33.40 in chips) 
Seat 9: DnDcAdn9P0zGovMERigpFA ($25 in chips) 
+2kMBNpY4nF1qNCRd8SJLA: posts small blind $0.10
DnDcAdn9P0zGovMERigpFA: posts big blind $0.25
*** HOLE CARDS ***
cZ99hugmLBj9KhTlc8nCSw: folds 
Th3FldXKQW6hWVVPahaoOQ: folds 
DdPXdieucQ+n99u1n3A+rQ: folds 
+5dSUwD+/k2ktlnutSMivw: folds 
Tx6zQdk5Ozt9ObEBlU7jeg: calls $0.25
4awUyiDYTgylQKXZ9faBVA: folds 
dfNim92Z6XK1/h5SFW5vDg: folds 
+2kMBNpY4nF1qNCRd8SJLA: calls $0.15
DnDcAdn9P0zGovMERigpFA: raises $1.25 to $1.50
Tx6zQdk5Ozt9ObEBlU7jeg: folds 
+2kMBNpY4nF1qNCRd8SJLA: folds 
Uncalled bet ($1.25) returned to DnDcAdn9P0zGovMERigpFA
DnDcAdn9P0zGovMERigpFA collected $0.75 from pot
DnDcAdn9P0zGovMERigpFA: doesn't show hand 
*** SUMMARY ***
Total pot $0.75 | Rake $0 
Seat 1: cZ99hugmLBj9KhTlc8nCSw folded before Flop (didn't bet)
Seat 2: Th3FldXKQW6hWVVPahaoOQ folded before Flop (didn't bet)
Seat 3: DdPXdieucQ+n99u1n3A+rQ folded before Flop (didn't bet)
Seat 4: +5dSUwD+/k2ktlnutSMivw folded before Flop (didn't bet)
Seat 5: Tx6zQdk5Ozt9ObEBlU7jeg folded before Flop
Seat 6: 4awUyiDYTgylQKXZ9faBVA folded before Flop (didn't bet)
Seat 7: dfNim92Z6XK1/h5SFW5vDg (button) folded before Flop (didn't bet)
Seat 8: +2kMBNpY4nF1qNCRd8SJLA (small blind) folded before Flop
Seat 9: DnDcAdn9P0zGovMERigpFA (big blind) collected ($0.75)




PokerStars Game #59941915690:  Hold'em No Limit ($0.10/$0.25) - 2009/07/01 1:50:14 ET
Table 'hOE09W281uSob0XeJmUcRg' 6-max Seat #6 is the button
Seat 1: mfrkWA3PTeYPkbO6hi98Aw ($26.70 in chips) 
Seat 2: lRKJ8o/CnOPFwfHHm6ioMw ($11.80 in chips) 
Seat 3: y+a/yGW/Jy4bPJFnaeTz5w ($12.10 in chips) 
Seat 5: JFIAqU8lCZ0vWwEl4bdGsg ($26.55 in chips) 
Seat 6: x4ZJ8E/TUrtoB7WiHcv8WA ($18.05 in chips) 
mfrkWA3PTeYPkbO6hi98Aw: posts small blind $0.10
lRKJ8o/CnOPFwfHHm6ioMw: posts big blind $0.25
*** HOLE CARDS ***
y+a/yGW/Jy4bPJFnaeTz5w: folds 
JFIAqU8lCZ0vWwEl4bdGsg: folds 
x4ZJ8E/TUrtoB7WiHcv8WA: folds 
mfrkWA3PTeYPkbO6hi98Aw: folds 
Uncalled bet ($0.15) returned to lRKJ8o/CnOPFwfHHm6ioMw
lRKJ8o/CnOPFwfHHm6ioMw collected $0.20 from pot
lRKJ8o/CnOPFwfHHm6ioMw: doesn't show hand 
*** SUMMARY ***
Total pot $0.20 | Rake $0 
Seat 1: mfrkWA3PTeYPkbO6hi98Aw (small blind) folded before Flop
Seat 2: lRKJ8o/CnOPFwfHHm6ioMw (big blind) collected ($0.20)
Seat 3: y+a/yGW/Jy4bPJFnaeTz5w folded before Flop (didn't bet)
Seat 5: JFIAqU8lCZ0vWwEl4bdGsg folded before Flop (didn't bet)
Seat 6: x4ZJ8E/TUrtoB7WiHcv8WA (button) folded before Flop (didn't bet)




PokerStars Game #59941915554:  Hold'em No Limit ($0.10/$0.25) - 2009/07/01 1:50:14 ET
Table 'biAgO3TKQBU8XcrVAoU5TA' 6-max Seat #1 is the button
Seat 1: jhDPlkir8wBYAddboBuF7Q ($11.80 in chips) 
Seat 3: mfrkWA3PTeYPkbO6hi98Aw ($20.15 in chips) 
Seat 4: Hsvkc0/G2VV78oVmWYXecw ($5 in chips) 
Seat 5: n6UPMnVR4v8LFP0rWP73Fg ($15.35 in chips) 
Seat 6: wMiE3yTbDJGOLOF9th7KPA ($19.75 in chips) 
tayolor1made will be allowed to play after the button
mfrkWA3PTeYPkbO6hi98Aw: posts small blind $0.10
Hsvkc0/G2VV78oVmWYXecw: posts big blind $0.25
*** HOLE CARDS ***
n6UPMnVR4v8LFP0rWP73Fg: folds 
wMiE3yTbDJGOLOF9th7KPA: calls $0.25
jhDPlkir8wBYAddboBuF7Q: raises $0.50 to $0.75
mfrkWA3PTeYPkbO6hi98Aw: folds 
Hsvkc0/G2VV78oVmWYXecw: folds 
wMiE3yTbDJGOLOF9th7KPA: calls $0.50
*** FLOP *** [Jd Tc 3d]
wMiE3yTbDJGOLOF9th7KPA: bets $0.50
jhDPlkir8wBYAddboBuF7Q: raises $0.50 to $1
wMiE3yTbDJGOLOF9th7KPA: calls $0.50
*** TURN *** [Jd Tc 3d] [9s]
wMiE3yTbDJGOLOF9th7KPA: bets $0.50
jhDPlkir8wBYAddboBuF7Q: raises $1 to $1.50
wMiE3yTbDJGOLOF9th7KPA: calls $1
*** RIVER *** [Jd Tc 3d 9s] [8d]
wMiE3yTbDJGOLOF9th7KPA: bets $0.50
jhDPlkir8wBYAddboBuF7Q: calls $0.50
*** SHOW DOWN ***
wMiE3yTbDJGOLOF9th7KPA: shows [9d Qh] (a straight, Eight to Queen)
jhDPlkir8wBYAddboBuF7Q: mucks hand 
wMiE3yTbDJGOLOF9th7KPA collected $7.50 from pot
*** SUMMARY ***
Total pot $7.85 | Rake $0.35 
Board [Jd Tc 3d 9s 8d]
Seat 1: jhDPlkir8wBYAddboBuF7Q (button) mucked
Seat 3: mfrkWA3PTeYPkbO6hi98Aw (small blind) folded before Flop
Seat 4: Hsvkc0/G2VV78oVmWYXecw (big blind) folded before Flop
Seat 5: n6UPMnVR4v8LFP0rWP73Fg folded before Flop (didn't bet)
Seat 6: wMiE3yTbDJGOLOF9th7KPA showed [9d Qh] and won ($7.50) with a straight, Eight to Queen




PokerStars Game #59941915736:  Hold'em No Limit ($0.10/$0.25) - 2009/07/01 1:50:14 ET
Table '0M5QEJGOThqZwQ/sjbjXYw' 6-max Seat #6 is the button
Seat 2: /gJNBeCkWL4o85/jvlZ4BA ($34.35 in chips) 
Seat 3: 3zD3qLXT1bEffAoWGnc7wg ($25 in chips) 
Seat 5: cWc85bEzdRzpUMhRKm8pwQ ($53.40 in chips) 
Seat 6: bb63I02U6p9a5MNFa1gCiw ($21.35 in chips) 
/gJNBeCkWL4o85/jvlZ4BA: posts small blind $0.10
3zD3qLXT1bEffAoWGnc7wg: posts big blind $0.25
*** HOLE CARDS ***
cWc85bEzdRzpUMhRKm8pwQ: folds 
oBUDUfeUyCbZBsjxHZgSiw has returned
bb63I02U6p9a5MNFa1gCiw: folds 
/gJNBeCkWL4o85/jvlZ4BA: folds 
Uncalled bet ($0.15) returned to 3zD3qLXT1bEffAoWGnc7wg
oBUDUfeUyCbZBsjxHZgSiw leaves the table
3zD3qLXT1bEffAoWGnc7wg collected $0.20 from pot
3zD3qLXT1bEffAoWGnc7wg: doesn't show hand 
*** SUMMARY ***
Total pot $0.20 | Rake $0 
Seat 2: /gJNBeCkWL4o85/jvlZ4BA (small blind) folded before Flop
Seat 3: 3zD3qLXT1bEffAoWGnc7wg (big blind) collected ($0.20)
Seat 5: cWc85bEzdRzpUMhRKm8pwQ folded before Flop (didn't bet)
Seat 6: bb63I02U6p9a5MNFa1gCiw (button) folded before Flop (didn't bet)




PokerStars Game #59941916170:  Hold'em No Limit ($0.10/$0.25) - 2009/07/01 1:50:15 ET
Table 'sm5gqEvXgLbkkE4dryW/5g' 6-max Seat #4 is the button
Seat 1: v8m8XHovI5tqEA9mvplDSw ($39.85 in chips) 
Seat 2: 5xs5/u2z1CO9zkRvH72MQg ($18 in chips) 
Seat 3: UT5XpwOH1ipkOF7n1MqDJA ($21.35 in chips) 
Seat 4: cWc85bEzdRzpUMhRKm8pwQ ($25.80 in chips) 
Seat 6: aogAb4Eienxztk8p2v9VVw ($22.25 in chips) 
AnnaskyII was removed from the table for failing to post
aogAb4Eienxztk8p2v9VVw: posts small blind $0.10
v8m8XHovI5tqEA9mvplDSw: posts big blind $0.25
*** HOLE CARDS ***
5xs5/u2z1CO9zkRvH72MQg: calls $0.25
UT5XpwOH1ipkOF7n1MqDJA: folds 
cWc85bEzdRzpUMhRKm8pwQ: folds 
aogAb4Eienxztk8p2v9VVw: folds 
v8m8XHovI5tqEA9mvplDSw: checks 
*** FLOP *** [Kh 7h 6d]
v8m8XHovI5tqEA9mvplDSw: checks 
5xs5/u2z1CO9zkRvH72MQg: bets $0.85
v8m8XHovI5tqEA9mvplDSw: folds 
Uncalled bet ($0.85) returned to 5xs5/u2z1CO9zkRvH72MQg
5xs5/u2z1CO9zkRvH72MQg collected $0.60 from pot
5xs5/u2z1CO9zkRvH72MQg: doesn't show hand 
*** SUMMARY ***
Total pot $0.60 | Rake $0 
Board [Kh 7h 6d]
Seat 1: v8m8XHovI5tqEA9mvplDSw (big blind) folded on the Flop
Seat 2: 5xs5/u2z1CO9zkRvH72MQg collected ($0.60)
Seat 3: UT5XpwOH1ipkOF7n1MqDJA folded before Flop (didn't bet)
Seat 4: cWc85bEzdRzpUMhRKm8pwQ (button) folded before Flop (didn't bet)
Seat 6: aogAb4Eienxztk8p2v9VVw (small blind) folded before Flop




PokerStars Game #59941915980:  Hold'em No Limit ($0.10/$0.25) - 2009/07/01 1:50:15 ET
Table '5NipxzzFB2DffzDpddyQoQ' 6-max Seat #6 is the button
Seat 2: iauW7L/+7qzAuHow7CD75Q ($4.70 in chips) 
Seat 3: QvTX2yGq3uKJiKPmns4TKQ ($14.20 in chips) 
Seat 4: NTamLAiMZ86c5yM04t96LA ($6.95 in chips) 
Seat 5: faP2NVl/cFTZ1nE4pXzg8Q ($20.95 in chips) 
Seat 6: 7JqTFMyeNSVWsmp/yW35Tw ($54.05 in chips) 
iauW7L/+7qzAuHow7CD75Q said, "wow"
iauW7L/+7qzAuHow7CD75Q: posts small blind $0.10
QvTX2yGq3uKJiKPmns4TKQ: posts big blind $0.25
*** HOLE CARDS ***
NTamLAiMZ86c5yM04t96LA said, "3 ks"
7JqTFMyeNSVWsmp/yW35Tw said, "ooopsies"
iauW7L/+7qzAuHow7CD75Q said, "nh"
NTamLAiMZ86c5yM04t96LA: raises $6.70 to $6.95 and is all-in
iauW7L/+7qzAuHow7CD75Q said, "ouch"
7JqTFMyeNSVWsmp/yW35Tw said, "damn"
faP2NVl/cFTZ1nE4pXzg8Q: folds 
7JqTFMyeNSVWsmp/yW35Tw: folds 
iauW7L/+7qzAuHow7CD75Q: calls $4.60 and is all-in
QvTX2yGq3uKJiKPmns4TKQ: calls $6.70
*** FLOP *** [4c 6c 6h]
*** TURN *** [4c 6c 6h] [9h]
NTamLAiMZ86c5yM04t96LA said, "dik"
*** RIVER *** [4c 6c 6h 9h] [2h]
7JqTFMyeNSVWsmp/yW35Tw said, "what were u messing around with kk like that for?"
*** SHOW DOWN ***
QvTX2yGq3uKJiKPmns4TKQ: shows [8s As] (a pair of Sixes)
NTamLAiMZ86c5yM04t96LA: mucks hand 
QvTX2yGq3uKJiKPmns4TKQ collected $4.30 from side pot
iauW7L/+7qzAuHow7CD75Q: mucks hand 
QvTX2yGq3uKJiKPmns4TKQ collected $13.40 from main pot
*** SUMMARY ***
Total pot $18.60 Main pot $13.40. Side pot $4.30. | Rake $0.90 
Board [4c 6c 6h 9h 2h]
Seat 2: iauW7L/+7qzAuHow7CD75Q (small blind) mucked
Seat 3: QvTX2yGq3uKJiKPmns4TKQ (big blind) showed [8s As] and won ($17.70) with a pair of Sixes
Seat 4: NTamLAiMZ86c5yM04t96LA mucked
Seat 5: faP2NVl/cFTZ1nE4pXzg8Q folded before Flop (didn't bet)
Seat 6: 7JqTFMyeNSVWsmp/yW35Tw (button) folded before Flop (didn't bet)




PokerStars Game #59941915902:  Hold'em No Limit ($0.10/$0.25) - 2009/07/01 1:50:15 ET
Table 'Mef6A0EMopL6WaFO5/KO9g' 6-max Seat #6 is the button
Seat 1: GbCVUNssQ7mqsPWr7J4d3w ($4.75 in chips) 
Seat 2: 8ClCHtFXGNplITm+63KB+Q ($29.70 in chips) 
Seat 4: lquriepNQBhDV5P1SWHhnA ($25 in chips) 
Seat 5: DihMHaz4WNETH1bPDe13kA ($41.40 in chips) 
Seat 6: jp34e617tIzV8tKIWmfAbA ($37.55 in chips) 
GbCVUNssQ7mqsPWr7J4d3w: posts small blind $0.10
8ClCHtFXGNplITm+63KB+Q: posts big blind $0.25
*** HOLE CARDS ***
lquriepNQBhDV5P1SWHhnA: raises $0.50 to $0.75
DihMHaz4WNETH1bPDe13kA: folds 
jp34e617tIzV8tKIWmfAbA: folds 
GbCVUNssQ7mqsPWr7J4d3w: folds 
8ClCHtFXGNplITm+63KB+Q: folds 
Uncalled bet ($0.50) returned to lquriepNQBhDV5P1SWHhnA
lquriepNQBhDV5P1SWHhnA collected $0.60 from pot
lquriepNQBhDV5P1SWHhnA: doesn't show hand 
*** SUMMARY ***
Total pot $0.60 | Rake $0 
Seat 1: GbCVUNssQ7mqsPWr7J4d3w (small blind) folded before Flop
Seat 2: 8ClCHtFXGNplITm+63KB+Q (big blind) folded before Flop
Seat 4: lquriepNQBhDV5P1SWHhnA collected ($0.60)
Seat 5: DihMHaz4WNETH1bPDe13kA folded before Flop (didn't bet)
Seat 6: jp34e617tIzV8tKIWmfAbA (button) folded before Flop (didn't bet)




PokerStars Game #59941916112:  Hold'em No Limit ($0.10/$0.25) - 2009/07/01 1:50:15 ET
Table 'Ok3oDLIsTc2+KxPcI0bAOA' 6-max Seat #5 is the button
Seat 1: agQm3ugZ3qSVYNgNu1ddeA ($39.85 in chips) 
Seat 2: wPSNSp4HYtytRMXTu3oPSQ ($28 in chips) 
Seat 3: lquriepNQBhDV5P1SWHhnA ($36.90 in chips) 
Seat 4: LJI7A1YgDM7hgh7o56+ReQ ($34.05 in chips) 
Seat 5: DFi/Lzkjsfv8QswS80JX9Q ($29.75 in chips) 
Seat 6: Hsvkc0/G2VV78oVmWYXecw ($5.55 in chips) 
Hsvkc0/G2VV78oVmWYXecw: posts small blind $0.10
agQm3ugZ3qSVYNgNu1ddeA: posts big blind $0.25
*** HOLE CARDS ***
wPSNSp4HYtytRMXTu3oPSQ: calls $0.25
lquriepNQBhDV5P1SWHhnA: folds 
LJI7A1YgDM7hgh7o56+ReQ: folds 
lquriepNQBhDV5P1SWHhnA leaves the table
DFi/Lzkjsfv8QswS80JX9Q: folds 
Hsvkc0/G2VV78oVmWYXecw: folds 
agQm3ugZ3qSVYNgNu1ddeA: checks 
*** FLOP *** [Kh 7c 6h]
agQm3ugZ3qSVYNgNu1ddeA: bets $0.75
wPSNSp4HYtytRMXTu3oPSQ: folds 
Uncalled bet ($0.75) returned to agQm3ugZ3qSVYNgNu1ddeA
agQm3ugZ3qSVYNgNu1ddeA collected $0.60 from pot
*** SUMMARY ***
Total pot $0.60 | Rake $0 
Board [Kh 7c 6h]
Seat 1: agQm3ugZ3qSVYNgNu1ddeA (big blind) collected ($0.60)
Seat 2: wPSNSp4HYtytRMXTu3oPSQ folded on the Flop
Seat 3: lquriepNQBhDV5P1SWHhnA folded before Flop (didn't bet)
Seat 4: LJI7A1YgDM7hgh7o56+ReQ folded before Flop (didn't bet)
Seat 5: DFi/Lzkjsfv8QswS80JX9Q (button) folded before Flop (didn't bet)
Seat 6: Hsvkc0/G2VV78oVmWYXecw (small blind) folded before Flop




PokerStars Game #59941915814:  Hold'em No Limit ($0.10/$0.25) - 2009/07/01 1:50:15 ET
Table 'vZfV/Uj0q8joA1du9sRJSg' 6-max Seat #2 is the button
Seat 1: Hsvkc0/G2VV78oVmWYXecw ($5 in chips) 
Seat 2: wMiE3yTbDJGOLOF9th7KPA ($11.05 in chips) 
Seat 3: cWc85bEzdRzpUMhRKm8pwQ ($25 in chips) 
Seat 4: v+QfkGiuj9bgtuNoVnDO8w ($43.50 in chips) 
Seat 5: kyRaCIljYA6l33lSKQfNsg ($29.30 in chips) 
Seat 6: 8ClCHtFXGNplITm+63KB+Q ($48.70 in chips) 
cWc85bEzdRzpUMhRKm8pwQ: posts small blind $0.10
v+QfkGiuj9bgtuNoVnDO8w: posts big blind $0.25
*** HOLE CARDS ***
kyRaCIljYA6l33lSKQfNsg: folds 
8ClCHtFXGNplITm+63KB+Q: folds 
Hsvkc0/G2VV78oVmWYXecw: folds 
wMiE3yTbDJGOLOF9th7KPA: calls $0.25
cWc85bEzdRzpUMhRKm8pwQ: folds 
v+QfkGiuj9bgtuNoVnDO8w: checks 
*** FLOP *** [Qh Ts 5c]
v+QfkGiuj9bgtuNoVnDO8w: checks 
wMiE3yTbDJGOLOF9th7KPA: bets $0.25
v+QfkGiuj9bgtuNoVnDO8w: folds 
Uncalled bet ($0.25) returned to wMiE3yTbDJGOLOF9th7KPA
wMiE3yTbDJGOLOF9th7KPA collected $0.60 from pot
*** SUMMARY ***
Total pot $0.60 | Rake $0 
Board [Qh Ts 5c]
Seat 1: Hsvkc0/G2VV78oVmWYXecw folded before Flop (didn't bet)
Seat 2: wMiE3yTbDJGOLOF9th7KPA (button) collected ($0.60)
Seat 3: cWc85bEzdRzpUMhRKm8pwQ (small blind) folded before Flop
Seat 4: v+QfkGiuj9bgtuNoVnDO8w (big blind) folded on the Flop
Seat 5: kyRaCIljYA6l33lSKQfNsg folded before Flop (didn't bet)
Seat 6: 8ClCHtFXGNplITm+63KB+Q folded before Flop (didn't bet)




PokerStars Game #59941915830:  Hold'em No Limit ($0.10/$0.25) - 2009/07/01 1:50:15 ET
Table 'R5qKG21jwFDYRcOht9qwqQ' 9-max Seat #2 is the button
Seat 1: N5sUK8M0br9djLrW97V9pQ ($24.15 in chips) 
Seat 2: N6foVRyErHqcNmshkqextQ ($13.45 in chips) 
Seat 3: M2QO2DxB5Wawg2h8HSpnYA ($10 in chips) 
Seat 6: EP17SQz/iWcuYdNOGeBgkw ($15.90 in chips) 
Seat 7: zgi+EUykT/pZQpoUG6+oEg ($4.65 in chips) 
Seat 8: hYvTc4PYNrAaNAIVoM94Hw ($4.65 in chips) 
Seat 9: MG90wfSJZnOejs/KD3vlQQ ($38.30 in chips) 
M2QO2DxB5Wawg2h8HSpnYA: posts small blind $0.10
zUXhymECc2C9W9ZNw6qppA is disconnected 
zUXhymECc2C9W9ZNw6qppA has timed out while disconnected
zUXhymECc2C9W9ZNw6qppA: is sitting out 
EP17SQz/iWcuYdNOGeBgkw: posts big blind $0.25
*** HOLE CARDS ***
zgi+EUykT/pZQpoUG6+oEg: folds 
hYvTc4PYNrAaNAIVoM94Hw: calls $0.25
z5GxcHlYz/GSz6W2uFiTtg has returned
MG90wfSJZnOejs/KD3vlQQ: folds 
N5sUK8M0br9djLrW97V9pQ: folds 
N6foVRyErHqcNmshkqextQ: folds 
M2QO2DxB5Wawg2h8HSpnYA: calls $0.15
EP17SQz/iWcuYdNOGeBgkw: checks 
*** FLOP *** [Ad 9d 4c]
M2QO2DxB5Wawg2h8HSpnYA: checks 
EP17SQz/iWcuYdNOGeBgkw: checks 
hYvTc4PYNrAaNAIVoM94Hw: checks 
*** TURN *** [Ad 9d 4c] [3d]
M2QO2DxB5Wawg2h8HSpnYA: checks 
EP17SQz/iWcuYdNOGeBgkw: checks 
hYvTc4PYNrAaNAIVoM94Hw: checks 
*** RIVER *** [Ad 9d 4c 3d] [2s]
M2QO2DxB5Wawg2h8HSpnYA: bets $0.50
EP17SQz/iWcuYdNOGeBgkw: folds 
hYvTc4PYNrAaNAIVoM94Hw: folds 
Uncalled bet ($0.50) returned to M2QO2DxB5Wawg2h8HSpnYA
M2QO2DxB5Wawg2h8HSpnYA collected $0.75 from pot
M2QO2DxB5Wawg2h8HSpnYA: doesn't show hand 
*** SUMMARY ***
Total pot $0.75 | Rake $0 
Board [Ad 9d 4c 3d 2s]
Seat 1: N5sUK8M0br9djLrW97V9pQ folded before Flop (didn't bet)
Seat 2: N6foVRyErHqcNmshkqextQ (button) folded before Flop (didn't bet)
Seat 3: M2QO2DxB5Wawg2h8HSpnYA (small blind) collected ($0.75)
Seat 6: EP17SQz/iWcuYdNOGeBgkw (big blind) folded on the River
Seat 7: zgi+EUykT/pZQpoUG6+oEg folded before Flop (didn't bet)
Seat 8: hYvTc4PYNrAaNAIVoM94Hw folded on the River
Seat 9: MG90wfSJZnOejs/KD3vlQQ folded before Flop (didn't bet)




PokerStars Game #59941916028:  Hold'em No Limit ($0.10/$0.25) - 2009/07/01 1:50:15 ET
Table 'IdXp6nyeW4FYaEK4qKCnwQ' 9-max Seat #2 is the button
Seat 1: tLcDklc2rBORNfixyRfVfw ($25 in chips) 
Seat 2: HPEB+AtKw1+C/cxU0o1ciw ($30.50 in chips) 
Seat 4: j4q3p0lesp63b1gZDwLBZw ($5.10 in chips) 
Seat 6: arxNSjreDRGFg13EAM2F1w ($30.50 in chips) 
Seat 7: w1ukf8uPa4+WH561TtVRxA ($37.25 in chips) 
Seat 8: dtZ84flFEi4Q+SGrHMJRDQ ($29.75 in chips) 
Seat 9: s2xLPOl/vhl/26apJ3vsOQ ($29.60 in chips) 
aintblinkin will be allowed to play after the button
j4q3p0lesp63b1gZDwLBZw: posts small blind $0.10
arxNSjreDRGFg13EAM2F1w: posts big blind $0.25
*** HOLE CARDS ***
w1ukf8uPa4+WH561TtVRxA: folds 
dtZ84flFEi4Q+SGrHMJRDQ: folds 
s2xLPOl/vhl/26apJ3vsOQ: folds 
nAWaA+gDUSWOad+I9mKUEg joins the table at seat #5 
tLcDklc2rBORNfixyRfVfw: folds 
HPEB+AtKw1+C/cxU0o1ciw: folds 
j4q3p0lesp63b1gZDwLBZw: folds 
Uncalled bet ($0.15) returned to arxNSjreDRGFg13EAM2F1w
arxNSjreDRGFg13EAM2F1w collected $0.20 from pot
arxNSjreDRGFg13EAM2F1w: doesn't show hand 
*** SUMMARY ***
Total pot $0.20 | Rake $0 
Seat 1: tLcDklc2rBORNfixyRfVfw folded before Flop (didn't bet)
Seat 2: HPEB+AtKw1+C/cxU0o1ciw (button) folded before Flop (didn't bet)
Seat 4: j4q3p0lesp63b1gZDwLBZw (small blind) folded before Flop
Seat 6: arxNSjreDRGFg13EAM2F1w (big blind) collected ($0.20)
Seat 7: w1ukf8uPa4+WH561TtVRxA folded before Flop (didn't bet)
Seat 8: dtZ84flFEi4Q+SGrHMJRDQ folded before Flop (didn't bet)
Seat 9: s2xLPOl/vhl/26apJ3vsOQ folded before Flop (didn't bet)




PokerStars Game #59941916522:  Hold'em No Limit ($0.10/$0.25) - 2009/07/01 1:50:16 ET
Table 'fHv1Mk7ZbLjprZTGWKPiEQ' 6-max Seat #5 is the button
Seat 1: OIjOiBfQstWrK/RuXx7zcw ($3.70 in chips) 
Seat 2: 9U3ZKjCsarN0DjR6mSE8Ug ($14.05 in chips) 
Seat 3: /gJNBeCkWL4o85/jvlZ4BA ($25 in chips) 
Seat 4: TSmua8tGK3sTbwi0ynrW9Q ($60 in chips) 
Seat 5: LJI7A1YgDM7hgh7o56+ReQ ($25.95 in chips) 
Seat 6: AjG0X+rNtc2W08eph8oqpw ($52.50 in chips) 
AjG0X+rNtc2W08eph8oqpw: posts small blind $0.10
OIjOiBfQstWrK/RuXx7zcw: posts big blind $0.25
*** HOLE CARDS ***
9U3ZKjCsarN0DjR6mSE8Ug: folds 
/gJNBeCkWL4o85/jvlZ4BA: folds 
TSmua8tGK3sTbwi0ynrW9Q: folds 
LJI7A1YgDM7hgh7o56+ReQ: folds 
AjG0X+rNtc2W08eph8oqpw: folds 
Uncalled bet ($0.15) returned to OIjOiBfQstWrK/RuXx7zcw
OIjOiBfQstWrK/RuXx7zcw collected $0.20 from pot
OIjOiBfQstWrK/RuXx7zcw: doesn't show hand 
*** SUMMARY ***
Total pot $0.20 | Rake $0 
Seat 1: OIjOiBfQstWrK/RuXx7zcw (big blind) collected ($0.20)
Seat 2: 9U3ZKjCsarN0DjR6mSE8Ug folded before Flop (didn't bet)
Seat 3: /gJNBeCkWL4o85/jvlZ4BA folded before Flop (didn't bet)
Seat 4: TSmua8tGK3sTbwi0ynrW9Q folded before Flop (didn't bet)
Seat 5: LJI7A1YgDM7hgh7o56+ReQ (button) folded before Flop (didn't bet)
Seat 6: AjG0X+rNtc2W08eph8oqpw (small blind) folded before Flop




PokerStars Game #59941916682:  Hold'em No Limit ($0.10/$0.25) - 2009/07/01 1:50:16 ET
Table 'oZuNsbNJuUyQLGKzQ/4JFg' 6-max Seat #6 is the button
Seat 1: vqWjZmdQu/Hxw96/IJTWdQ ($25 in chips) 
Seat 2: UA5OsKS3VPaxa7uC8La/kA ($35.40 in chips) 
Seat 3: 8ClCHtFXGNplITm+63KB+Q ($50.65 in chips) 
Seat 4: 9bpVv1/Qh9IYtXuCtl5VtQ ($31.20 in chips) 
Seat 5: oBUDUfeUyCbZBsjxHZgSiw ($22.70 in chips) 
Seat 6: fwg6dK1+r4jy/y+JqenYYQ ($12.45 in chips) 
vqWjZmdQu/Hxw96/IJTWdQ: posts small blind $0.10
UA5OsKS3VPaxa7uC8La/kA: posts big blind $0.25
*** HOLE CARDS ***
8ClCHtFXGNplITm+63KB+Q: folds 
9bpVv1/Qh9IYtXuCtl5VtQ: folds 
oBUDUfeUyCbZBsjxHZgSiw: raises $0.75 to $1
fwg6dK1+r4jy/y+JqenYYQ: folds 
vqWjZmdQu/Hxw96/IJTWdQ: calls $0.90
UA5OsKS3VPaxa7uC8La/kA: folds 
*** FLOP *** [6c 5d Kh]
vqWjZmdQu/Hxw96/IJTWdQ: checks 
oBUDUfeUyCbZBsjxHZgSiw: bets $1
vqWjZmdQu/Hxw96/IJTWdQ: folds 
Uncalled bet ($1) returned to oBUDUfeUyCbZBsjxHZgSiw
oBUDUfeUyCbZBsjxHZgSiw collected $2.15 from pot
*** SUMMARY ***
Total pot $2.25 | Rake $0.10 
Board [6c 5d Kh]
Seat 1: vqWjZmdQu/Hxw96/IJTWdQ (small blind) folded on the Flop
Seat 2: UA5OsKS3VPaxa7uC8La/kA (big blind) folded before Flop
Seat 3: 8ClCHtFXGNplITm+63KB+Q folded before Flop (didn't bet)
Seat 4: 9bpVv1/Qh9IYtXuCtl5VtQ folded before Flop (didn't bet)
Seat 5: oBUDUfeUyCbZBsjxHZgSiw collected ($2.15)
Seat 6: fwg6dK1+r4jy/y+JqenYYQ (button) folded before Flop (didn't bet)




PokerStars Game #59941916336:  Hold'em No Limit ($0.10/$0.25) - 2009/07/01 1:50:16 ET
Table 'qryc9C/ELyQ3lubOaELNAQ' 6-max Seat #3 is the button
Seat 1: OZc6kkoTwtITj1ZfreJK1A ($66.50 in chips) 
Seat 2: LtASJ9OlkqGrrUKGQlpGAw ($29.95 in chips) 
Seat 3: wvIIdlbCgePONQwXjx9xzQ ($3.35 in chips) 
Seat 4: v+QfkGiuj9bgtuNoVnDO8w ($25.10 in chips) 
Seat 5: 9StOHp+Y1T0K13JdgS2oQQ ($38.55 in chips) 
Seat 6: xmdItDBraeGrrs3wzz1J3w ($18.85 in chips) 
v+QfkGiuj9bgtuNoVnDO8w: posts small blind $0.10
9StOHp+Y1T0K13JdgS2oQQ: posts big blind $0.25
*** HOLE CARDS ***
xmdItDBraeGrrs3wzz1J3w: raises $0.25 to $0.50
OZc6kkoTwtITj1ZfreJK1A: calls $0.50
LtASJ9OlkqGrrUKGQlpGAw: calls $0.50
wvIIdlbCgePONQwXjx9xzQ: folds 
v+QfkGiuj9bgtuNoVnDO8w: folds 
9StOHp+Y1T0K13JdgS2oQQ: folds 
*** FLOP *** [9d Tc 8d]
xmdItDBraeGrrs3wzz1J3w: bets $0.75
OZc6kkoTwtITj1ZfreJK1A: raises $0.75 to $1.50
LtASJ9OlkqGrrUKGQlpGAw: folds 
xmdItDBraeGrrs3wzz1J3w: raises $0.75 to $2.25
OZc6kkoTwtITj1ZfreJK1A: calls $0.75
*** TURN *** [9d Tc 8d] [Kd]
xmdItDBraeGrrs3wzz1J3w: checks 
OZc6kkoTwtITj1ZfreJK1A: checks 
*** RIVER *** [9d Tc 8d Kd] [Jd]
xmdItDBraeGrrs3wzz1J3w: bets $3
OZc6kkoTwtITj1ZfreJK1A: raises $14 to $17
xmdItDBraeGrrs3wzz1J3w: calls $13.10 and is all-in
Uncalled bet ($0.90) returned to OZc6kkoTwtITj1ZfreJK1A
*** SHOW DOWN ***
OZc6kkoTwtITj1ZfreJK1A: shows [Qs Qd] (a flush, King high)
xmdItDBraeGrrs3wzz1J3w: mucks hand 
OZc6kkoTwtITj1ZfreJK1A collected $36.65 from pot
*** SUMMARY ***
Total pot $38.55 | Rake $1.90 
Board [9d Tc 8d Kd Jd]
Seat 1: OZc6kkoTwtITj1ZfreJK1A showed [Qs Qd] and won ($36.65) with a flush, King high
Seat 2: LtASJ9OlkqGrrUKGQlpGAw folded on the Flop
Seat 3: wvIIdlbCgePONQwXjx9xzQ (button) folded before Flop (didn't bet)
Seat 4: v+QfkGiuj9bgtuNoVnDO8w (small blind) folded before Flop
Seat 5: 9StOHp+Y1T0K13JdgS2oQQ (big blind) folded before Flop
Seat 6: xmdItDBraeGrrs3wzz1J3w mucked




PokerStars Game #59941916588:  Hold'em No Limit ($0.10/$0.25) - 2009/07/01 1:50:16 ET
Table 'JPFXJXa5xBkjZ/W15BKqeQ' 9-max Seat #2 is the button
Seat 1: zgi+EUykT/pZQpoUG6+oEg ($5 in chips) 
Seat 2: XMSS6mD5B42I8wasdOMipQ ($12.75 in chips) 
Seat 3: 56S3mA6Zs3pGR+0p0vUCtg ($19.30 in chips) 
Seat 4: wGigCmBR/9XWkPpvYos3aQ ($32.30 in chips) 
Seat 5: cZ99hugmLBj9KhTlc8nCSw ($25.60 in chips) 
Seat 6: tLcDklc2rBORNfixyRfVfw ($25 in chips) 
Seat 7: PdIasPkzm2sqZnN41ZRXOg ($5 in chips) 
Seat 9: V6p0jQ/RhUsqpHLmXvEX4Q ($12.25 in chips) 
56S3mA6Zs3pGR+0p0vUCtg: posts small blind $0.10
wGigCmBR/9XWkPpvYos3aQ: posts big blind $0.25
zgi+EUykT/pZQpoUG6+oEg: posts big blind $0.25
*** HOLE CARDS ***
cZ99hugmLBj9KhTlc8nCSw: folds 
tLcDklc2rBORNfixyRfVfw: folds 
PdIasPkzm2sqZnN41ZRXOg: folds 
V6p0jQ/RhUsqpHLmXvEX4Q: folds 
zgi+EUykT/pZQpoUG6+oEg: checks 
XMSS6mD5B42I8wasdOMipQ: folds 
56S3mA6Zs3pGR+0p0vUCtg: folds 
wGigCmBR/9XWkPpvYos3aQ: checks 
*** FLOP *** [8d 2c Qd]
wGigCmBR/9XWkPpvYos3aQ: checks 
zgi+EUykT/pZQpoUG6+oEg: checks 
*** TURN *** [8d 2c Qd] [Ah]
wGigCmBR/9XWkPpvYos3aQ: checks 
zgi+EUykT/pZQpoUG6+oEg: checks 
*** RIVER *** [8d 2c Qd Ah] [Jd]
wGigCmBR/9XWkPpvYos3aQ: bets $0.40
zgi+EUykT/pZQpoUG6+oEg: folds 
Uncalled bet ($0.40) returned to wGigCmBR/9XWkPpvYos3aQ
wGigCmBR/9XWkPpvYos3aQ collected $0.60 from pot
wGigCmBR/9XWkPpvYos3aQ: doesn't show hand 
*** SUMMARY ***
Total pot $0.60 | Rake $0 
Board [8d 2c Qd Ah Jd]
Seat 1: zgi+EUykT/pZQpoUG6+oEg folded on the River
Seat 2: XMSS6mD5B42I8wasdOMipQ (button) folded before Flop (didn't bet)
Seat 3: 56S3mA6Zs3pGR+0p0vUCtg (small blind) folded before Flop
Seat 4: wGigCmBR/9XWkPpvYos3aQ (big blind) collected ($0.60)
Seat 5: cZ99hugmLBj9KhTlc8nCSw folded before Flop (didn't bet)
Seat 6: tLcDklc2rBORNfixyRfVfw folded before Flop (didn't bet)
Seat 7: PdIasPkzm2sqZnN41ZRXOg folded before Flop (didn't bet)
Seat 9: V6p0jQ/RhUsqpHLmXvEX4Q folded before Flop (didn't bet)




PokerStars Game #59941916614:  Hold'em No Limit ($0.10/$0.25) - 2009/07/01 1:50:16 ET
Table 'ouLhepGYovxB2x0QxH7cVg' 9-max Seat #6 is the button
Seat 1: ghNKXUBl/H+t83JF079ZBA ($25 in chips) 
Seat 2: r1Z5m4PwSI5ANp7qCE1OJw ($23.35 in chips) 
Seat 3: bXpVeaSTPBFSPJmeXxO7nw ($4.90 in chips) 
Seat 4: a0Sx6GHY7ln2Ns2C97eXeA ($59.40 in chips) 
Seat 5: v60REj6f8jzMYT0VsZvaPQ ($10.90 in chips) 
Seat 6: hYvTc4PYNrAaNAIVoM94Hw ($4.65 in chips) 
Seat 8: tLcDklc2rBORNfixyRfVfw ($25.35 in chips) 
Seat 9: ljemhp25Zg+nlA9DLCIiUw ($25.30 in chips) 
tLcDklc2rBORNfixyRfVfw: posts small blind $0.10
ljemhp25Zg+nlA9DLCIiUw: posts big blind $0.25
*** HOLE CARDS ***
ghNKXUBl/H+t83JF079ZBA: folds 
r1Z5m4PwSI5ANp7qCE1OJw: folds 
bXpVeaSTPBFSPJmeXxO7nw: folds 
a0Sx6GHY7ln2Ns2C97eXeA: folds 
v60REj6f8jzMYT0VsZvaPQ: raises $0.50 to $0.75
hYvTc4PYNrAaNAIVoM94Hw: folds 
tLcDklc2rBORNfixyRfVfw: folds 
ljemhp25Zg+nlA9DLCIiUw: folds 
Uncalled bet ($0.50) returned to v60REj6f8jzMYT0VsZvaPQ
v60REj6f8jzMYT0VsZvaPQ collected $0.60 from pot
*** SUMMARY ***
Total pot $0.60 | Rake $0 
Seat 1: ghNKXUBl/H+t83JF079ZBA folded before Flop (didn't bet)
Seat 2: r1Z5m4PwSI5ANp7qCE1OJw folded before Flop (didn't bet)
Seat 3: bXpVeaSTPBFSPJmeXxO7nw folded before Flop (didn't bet)
Seat 4: a0Sx6GHY7ln2Ns2C97eXeA folded before Flop (didn't bet)
Seat 5: v60REj6f8jzMYT0VsZvaPQ collected ($0.60)
Seat 6: hYvTc4PYNrAaNAIVoM94Hw (button) folded before Flop (didn't bet)
Seat 8: tLcDklc2rBORNfixyRfVfw (small blind) folded before Flop
Seat 9: ljemhp25Zg+nlA9DLCIiUw (big blind) folded before Flop




PokerStars Game #59941916652:  Hold'em No Limit ($0.10/$0.25) - 2009/07/01 1:50:16 ET
Table 'a6FCGVBMPcT7J7BDN9q1zQ' 9-max Seat #1 is the button
Seat 1: bXpVeaSTPBFSPJmeXxO7nw ($4.65 in chips) 
Seat 2: M2QO2DxB5Wawg2h8HSpnYA ($13.20 in chips) 
Seat 3: tLcDklc2rBORNfixyRfVfw ($25 in chips) 
Seat 5: dtZ84flFEi4Q+SGrHMJRDQ ($25.80 in chips) 
Seat 6: dfNim92Z6XK1/h5SFW5vDg ($25 in chips) 
Seat 7: V0Yo5zRBVM8DYspLKafebg ($7.55 in chips) 
Seat 8: r6hsffOo1iKmaPYKwAZmFw ($64.35 in chips) 
Seat 9: wGigCmBR/9XWkPpvYos3aQ ($29.85 in chips) 
M2QO2DxB5Wawg2h8HSpnYA: posts small blind $0.10
tLcDklc2rBORNfixyRfVfw: posts big blind $0.25
8EbrQ/EvFWt2cr0GaU82gQ: sits out 
*** HOLE CARDS ***
dtZ84flFEi4Q+SGrHMJRDQ: calls $0.25
dfNim92Z6XK1/h5SFW5vDg: folds 
V0Yo5zRBVM8DYspLKafebg: raises $1.50 to $1.75
r6hsffOo1iKmaPYKwAZmFw: folds 
wGigCmBR/9XWkPpvYos3aQ: folds 
bXpVeaSTPBFSPJmeXxO7nw: folds 
M2QO2DxB5Wawg2h8HSpnYA: folds 
tLcDklc2rBORNfixyRfVfw: folds 
dtZ84flFEi4Q+SGrHMJRDQ: folds 
Uncalled bet ($1.50) returned to V0Yo5zRBVM8DYspLKafebg
V0Yo5zRBVM8DYspLKafebg collected $0.85 from pot
*** SUMMARY ***
Total pot $0.85 | Rake $0 
Seat 1: bXpVeaSTPBFSPJmeXxO7nw (button) folded before Flop (didn't bet)
Seat 2: M2QO2DxB5Wawg2h8HSpnYA (small blind) folded before Flop
Seat 3: tLcDklc2rBORNfixyRfVfw (big blind) folded before Flop
Seat 5: dtZ84flFEi4Q+SGrHMJRDQ folded before Flop
Seat 6: dfNim92Z6XK1/h5SFW5vDg folded before Flop (didn't bet)
Seat 7: V0Yo5zRBVM8DYspLKafebg collected ($0.85)
Seat 8: r6hsffOo1iKmaPYKwAZmFw folded before Flop (didn't bet)
Seat 9: wGigCmBR/9XWkPpvYos3aQ folded before Flop (didn't bet)




PokerStars Game #59941916726:  Hold'em No Limit ($0.10/$0.25) - 2009/07/01 1:50:16 ET
Table '9L7XfAwuM7XsXE8LIg2o5Q' 6-max Seat #1 is the button
Seat 1: dOIoLBxmpLHSXBN9LZnf0Q ($27.30 in chips) 
Seat 2: LJI7A1YgDM7hgh7o56+ReQ ($27.40 in chips) 
Seat 4: jp34e617tIzV8tKIWmfAbA ($38.45 in chips) 
Seat 6: k9nHZTHt8hYhYRcW8NTb4g ($18.85 in chips) 
LJI7A1YgDM7hgh7o56+ReQ: posts small blind $0.10
mFv3iBCtrw9XfCDRB0d46Q: is sitting out 
jp34e617tIzV8tKIWmfAbA: posts big blind $0.25
Beethoven87: sits out 
*** HOLE CARDS ***
mFv3iBCtrw9XfCDRB0d46Q leaves the table
k9nHZTHt8hYhYRcW8NTb4g: folds 
dOIoLBxmpLHSXBN9LZnf0Q: folds 
LJI7A1YgDM7hgh7o56+ReQ: folds 
Uncalled bet ($0.15) returned to jp34e617tIzV8tKIWmfAbA
jp34e617tIzV8tKIWmfAbA collected $0.20 from pot
*** SUMMARY ***
Total pot $0.20 | Rake $0 
Seat 1: dOIoLBxmpLHSXBN9LZnf0Q (button) folded before Flop (didn't bet)
Seat 2: LJI7A1YgDM7hgh7o56+ReQ (small blind) folded before Flop
Seat 4: jp34e617tIzV8tKIWmfAbA (big blind) collected ($0.20)
Seat 6: k9nHZTHt8hYhYRcW8NTb4g folded before Flop (didn't bet)




PokerStars Game #59941916976:  Hold'em No Limit ($0.10/$0.25) - 2009/07/01 1:50:17 ET
Table 'JJzUs04lHpXg6nboT1/jeg' 6-max Seat #4 is the button
Seat 1: vEZ/HxVuyR6kaq0BtZoUgQ ($10.10 in chips) 
Seat 2: jxfR29d+dK/7h7s3SvCk+g ($8.70 in chips) 
Seat 3: 4zXbHDe39qNX46dAo81b4w ($10.75 in chips) 
Seat 4: 7cx44/slbeTw+Cy7QB8Trg ($24.65 in chips) 
FDWzjQgBA5K04jOIY/j22w will be allowed to play after the button
hOaWAImn5/MZDAWAPlYHCw will be allowed to play after the button
vEZ/HxVuyR6kaq0BtZoUgQ: posts small blind $0.10
jxfR29d+dK/7h7s3SvCk+g: posts big blind $0.25
*** HOLE CARDS ***
4zXbHDe39qNX46dAo81b4w: folds 
hOaWAImn5/MZDAWAPlYHCw leaves the table
7cx44/slbeTw+Cy7QB8Trg: folds 
vEZ/HxVuyR6kaq0BtZoUgQ: folds 
Uncalled bet ($0.15) returned to jxfR29d+dK/7h7s3SvCk+g
jxfR29d+dK/7h7s3SvCk+g collected $0.20 from pot
*** SUMMARY ***
Total pot $0.20 | Rake $0 
Seat 1: vEZ/HxVuyR6kaq0BtZoUgQ (small blind) folded before Flop
Seat 2: jxfR29d+dK/7h7s3SvCk+g (big blind) collected ($0.20)
Seat 3: 4zXbHDe39qNX46dAo81b4w folded before Flop (didn't bet)
Seat 4: 7cx44/slbeTw+Cy7QB8Trg (button) folded before Flop (didn't bet)




PokerStars Game #59941917210:  Hold'em No Limit ($0.10/$0.25) - 2009/07/01 1:50:17 ET
Table 'Xi38lWH8L2JHRAsKYVX8Qg' 6-max Seat #3 is the button
Seat 1: shP7DFAtX7gXcgMJX/OmRQ ($23.95 in chips) 
Seat 2: VOmI0x4dDPnTESZd5B4d1Q ($8.75 in chips) 
Seat 3: 6DwBRH+xZ12AAZmeAg+aXw ($31.20 in chips) 
Seat 4: kG34n23qFQA3nzdOJTQ1dA ($24.15 in chips) 
Seat 5: 79ID/ub1Pt/mDpCprVmOoA ($76.50 in chips) 
Seat 6: kyRaCIljYA6l33lSKQfNsg ($30.10 in chips) 
kG34n23qFQA3nzdOJTQ1dA: posts small blind $0.10
79ID/ub1Pt/mDpCprVmOoA: posts big blind $0.25
VOmI0x4dDPnTESZd5B4d1Q: posts small & big blinds $0.35
*** HOLE CARDS ***
kyRaCIljYA6l33lSKQfNsg: folds 
shP7DFAtX7gXcgMJX/OmRQ: calls $0.25
VOmI0x4dDPnTESZd5B4d1Q: checks 
6DwBRH+xZ12AAZmeAg+aXw: folds 
kG34n23qFQA3nzdOJTQ1dA: folds 
79ID/ub1Pt/mDpCprVmOoA: checks 
*** FLOP *** [7c Ad Jc]
79ID/ub1Pt/mDpCprVmOoA: checks 
shP7DFAtX7gXcgMJX/OmRQ: bets $0.75
VOmI0x4dDPnTESZd5B4d1Q: folds 
79ID/ub1Pt/mDpCprVmOoA: folds 
Uncalled bet ($0.75) returned to shP7DFAtX7gXcgMJX/OmRQ
shP7DFAtX7gXcgMJX/OmRQ collected $0.95 from pot
shP7DFAtX7gXcgMJX/OmRQ: doesn't show hand 
*** SUMMARY ***
Total pot $0.95 | Rake $0 
Board [7c Ad Jc]
Seat 1: shP7DFAtX7gXcgMJX/OmRQ collected ($0.95)
Seat 2: VOmI0x4dDPnTESZd5B4d1Q folded on the Flop
Seat 3: 6DwBRH+xZ12AAZmeAg+aXw (button) folded before Flop (didn't bet)
Seat 4: kG34n23qFQA3nzdOJTQ1dA (small blind) folded before Flop
Seat 5: 79ID/ub1Pt/mDpCprVmOoA (big blind) folded on the Flop
Seat 6: kyRaCIljYA6l33lSKQfNsg folded before Flop (didn't bet)




PokerStars Game #59941917166:  Hold'em No Limit ($0.10/$0.25) - 2009/07/01 1:50:17 ET
Table 'sgdCtiuCu2BDZhyDi6RzTA' 6-max Seat #4 is the button
Seat 1: 3zD3qLXT1bEffAoWGnc7wg ($35.40 in chips) 
Seat 2: XD1i5m5PvBDnRzJaG/vINw ($23.50 in chips) 
Seat 3: eL3+wCBjFGfQ5FMdIZihwA ($27.55 in chips) 
Seat 4: rVKEgilmMX+EkKzDVvhmxA ($6.25 in chips) 
Seat 5: 0tQitW75xfmVWKldYHjmOQ ($1.80 in chips) 
Seat 6: KODslGU8ikCYS0/29dUkhg ($35 in chips) 
0tQitW75xfmVWKldYHjmOQ: posts small blind $0.10
KODslGU8ikCYS0/29dUkhg: posts big blind $0.25
*** HOLE CARDS ***
3zD3qLXT1bEffAoWGnc7wg: folds 
XD1i5m5PvBDnRzJaG/vINw: folds 
eL3+wCBjFGfQ5FMdIZihwA: folds 
rVKEgilmMX+EkKzDVvhmxA: calls $0.25
0tQitW75xfmVWKldYHjmOQ: raises $0.50 to $0.75
KODslGU8ikCYS0/29dUkhg: calls $0.50
rVKEgilmMX+EkKzDVvhmxA: folds 
*** FLOP *** [7d Th 9c]
0tQitW75xfmVWKldYHjmOQ: bets $1.05 and is all-in
KODslGU8ikCYS0/29dUkhg: calls $1.05
*** TURN *** [7d Th 9c] [Qs]
*** RIVER *** [7d Th 9c Qs] [3h]
*** SHOW DOWN ***
0tQitW75xfmVWKldYHjmOQ: shows [Kc Kd] (a pair of Kings)
XD1i5m5PvBDnRzJaG/vINw leaves the table
KODslGU8ikCYS0/29dUkhg: mucks hand 
0tQitW75xfmVWKldYHjmOQ collected $3.70 from pot
*** SUMMARY ***
Total pot $3.85 | Rake $0.15 
Board [7d Th 9c Qs 3h]
Seat 1: 3zD3qLXT1bEffAoWGnc7wg folded before Flop (didn't bet)
Seat 2: XD1i5m5PvBDnRzJaG/vINw folded before Flop (didn't bet)
Seat 3: eL3+wCBjFGfQ5FMdIZihwA folded before Flop (didn't bet)
Seat 4: rVKEgilmMX+EkKzDVvhmxA (button) folded before Flop
Seat 5: 0tQitW75xfmVWKldYHjmOQ (small blind) showed [Kc Kd] and won ($3.70) with a pair of Kings
Seat 6: KODslGU8ikCYS0/29dUkhg (big blind) mucked




PokerStars Game #59941917494:  Hold'em No Limit ($0.10/$0.25) - 2009/07/01 1:50:18 ET
Table 'HzFR0rxmDAPu5GzYR0AlYg' 6-max Seat #4 is the button
Seat 1: v+QfkGiuj9bgtuNoVnDO8w ($34.90 in chips) 
Seat 2: UA5OsKS3VPaxa7uC8La/kA ($51.60 in chips) 
Seat 3: kG34n23qFQA3nzdOJTQ1dA ($24.55 in chips) 
Seat 4: Mhj3q7cxev+XjXZxEE6/Cw ($25 in chips) 
Seat 5: lquriepNQBhDV5P1SWHhnA ($26.85 in chips) 
Seat 6: jp34e617tIzV8tKIWmfAbA ($35.55 in chips) 
lquriepNQBhDV5P1SWHhnA: posts small blind $0.10
jp34e617tIzV8tKIWmfAbA: posts big blind $0.25
*** HOLE CARDS ***
v+QfkGiuj9bgtuNoVnDO8w: folds 
UA5OsKS3VPaxa7uC8La/kA: folds 
kG34n23qFQA3nzdOJTQ1dA: folds 
Mhj3q7cxev+XjXZxEE6/Cw: raises $0.50 to $0.75
lquriepNQBhDV5P1SWHhnA: folds 
jp34e617tIzV8tKIWmfAbA: folds 
Uncalled bet ($0.50) returned to Mhj3q7cxev+XjXZxEE6/Cw
lquriepNQBhDV5P1SWHhnA leaves the table
Mhj3q7cxev+XjXZxEE6/Cw collected $0.60 from pot
Mhj3q7cxev+XjXZxEE6/Cw: doesn't show hand 
*** SUMMARY ***
Total pot $0.60 | Rake $0 
Seat 1: v+QfkGiuj9bgtuNoVnDO8w folded before Flop (didn't bet)
Seat 2: UA5OsKS3VPaxa7uC8La/kA folded before Flop (didn't bet)
Seat 3: kG34n23qFQA3nzdOJTQ1dA folded before Flop (didn't bet)
Seat 4: Mhj3q7cxev+XjXZxEE6/Cw (button) collected ($0.60)
Seat 5: lquriepNQBhDV5P1SWHhnA (small blind) folded before Flop
Seat 6: jp34e617tIzV8tKIWmfAbA (big blind) folded before Flop




PokerStars Game #59941917698:  Hold'em No Limit ($0.10/$0.25) - 2009/07/01 1:50:18 ET
Table 'tq5CvS0RUqGkuBK0XTzqqg' 6-max Seat #5 is the button
Seat 1: +ZlnqPoP3Hg4BIUxDfKd/A ($29.95 in chips) 
Seat 2: 2m6ZFAdj01UZd4WtEySXXQ ($4.90 in chips) 
Seat 4: UT5XpwOH1ipkOF7n1MqDJA ($34.40 in chips) 
Seat 5: qGHGf/553gQnDoklMRe3tg ($37.90 in chips) 
Seat 6: QqiZLFrN8iOUT/GHw7ztOA ($24.40 in chips) 
QqiZLFrN8iOUT/GHw7ztOA: posts small blind $0.10
+ZlnqPoP3Hg4BIUxDfKd/A: posts big blind $0.25
VXTONriS+Ohik+r0FeicIw: sits out 
*** HOLE CARDS ***
2m6ZFAdj01UZd4WtEySXXQ: calls $0.25
UT5XpwOH1ipkOF7n1MqDJA: raises $0.75 to $1
qGHGf/553gQnDoklMRe3tg: folds 
QqiZLFrN8iOUT/GHw7ztOA: folds 
+ZlnqPoP3Hg4BIUxDfKd/A: folds 
2m6ZFAdj01UZd4WtEySXXQ: calls $0.75
*** FLOP *** [Ad 3s Ah]
2m6ZFAdj01UZd4WtEySXXQ: checks 
UT5XpwOH1ipkOF7n1MqDJA: checks 
*** TURN *** [Ad 3s Ah] [Ac]
2m6ZFAdj01UZd4WtEySXXQ: bets $0.50
UT5XpwOH1ipkOF7n1MqDJA: calls $0.50
*** RIVER *** [Ad 3s Ah Ac] [8h]
2m6ZFAdj01UZd4WtEySXXQ: bets $1.50
UT5XpwOH1ipkOF7n1MqDJA: raises $2 to $3.50
2m6ZFAdj01UZd4WtEySXXQ: folds 
Uncalled bet ($2) returned to UT5XpwOH1ipkOF7n1MqDJA
2m6ZFAdj01UZd4WtEySXXQ leaves the table
UT5XpwOH1ipkOF7n1MqDJA collected $6.05 from pot
*** SUMMARY ***
Total pot $6.35 | Rake $0.30 
Board [Ad 3s Ah Ac 8h]
Seat 1: +ZlnqPoP3Hg4BIUxDfKd/A (big blind) folded before Flop
Seat 2: 2m6ZFAdj01UZd4WtEySXXQ folded on the River
Seat 4: UT5XpwOH1ipkOF7n1MqDJA collected ($6.05)
Seat 5: qGHGf/553gQnDoklMRe3tg (button) folded before Flop (didn't bet)
Seat 6: QqiZLFrN8iOUT/GHw7ztOA (small blind) folded before Flop




PokerStars Game #59941917582:  Hold'em No Limit ($0.10/$0.25) - 2009/07/01 1:50:18 ET
Table 'fRxOyfaHXkWUDLv4eSxFew' 9-max Seat #6 is the button
Seat 1: 6RiVTYll/5D8zICp0MRpKw ($29.40 in chips) 
Seat 2: M2QO2DxB5Wawg2h8HSpnYA ($10 in chips) 
Seat 3: E0iYnEVO2ho7dH3QcCjw7g ($29.70 in chips) 
Seat 4: MtVtHDqIJTyUcXkRBBDIVA ($27.60 in chips) 
Seat 5: dmYlc+1cjwZMJ7wV+Z0rRg ($22.40 in chips) 
Seat 6: arxNSjreDRGFg13EAM2F1w ($27.05 in chips) 
Seat 7: 1/DuWziR8CXhWB71aPQd9Q ($11.30 in chips) 
Seat 8: 5n7e7I+px7c6CQmLpPbtsg ($5.90 in chips) 
Seat 9: H5Se03ZqSX7tbULXur2MAg ($32.65 in chips) 
1/DuWziR8CXhWB71aPQd9Q: posts small blind $0.10
5n7e7I+px7c6CQmLpPbtsg: posts big blind $0.25
*** HOLE CARDS ***
H5Se03ZqSX7tbULXur2MAg: folds 
6RiVTYll/5D8zICp0MRpKw: folds 
M2QO2DxB5Wawg2h8HSpnYA: folds 
E0iYnEVO2ho7dH3QcCjw7g: folds 
MtVtHDqIJTyUcXkRBBDIVA: folds 
dmYlc+1cjwZMJ7wV+Z0rRg: raises $0.50 to $0.75
arxNSjreDRGFg13EAM2F1w: folds 
1/DuWziR8CXhWB71aPQd9Q: folds 
5n7e7I+px7c6CQmLpPbtsg: raises $5.15 to $5.90 and is all-in
dmYlc+1cjwZMJ7wV+Z0rRg: folds 
Uncalled bet ($5.15) returned to 5n7e7I+px7c6CQmLpPbtsg
5n7e7I+px7c6CQmLpPbtsg collected $1.60 from pot
5n7e7I+px7c6CQmLpPbtsg: doesn't show hand 
*** SUMMARY ***
Total pot $1.60 | Rake $0 
Seat 1: 6RiVTYll/5D8zICp0MRpKw folded before Flop (didn't bet)
Seat 2: M2QO2DxB5Wawg2h8HSpnYA folded before Flop (didn't bet)
Seat 3: E0iYnEVO2ho7dH3QcCjw7g folded before Flop (didn't bet)
Seat 4: MtVtHDqIJTyUcXkRBBDIVA folded before Flop (didn't bet)
Seat 5: dmYlc+1cjwZMJ7wV+Z0rRg folded before Flop
Seat 6: arxNSjreDRGFg13EAM2F1w (button) folded before Flop (didn't bet)
Seat 7: 1/DuWziR8CXhWB71aPQd9Q (small blind) folded before Flop
Seat 8: 5n7e7I+px7c6CQmLpPbtsg (big blind) collected ($1.60)
Seat 9: H5Se03ZqSX7tbULXur2MAg folded before Flop (didn't bet)




PokerStars Game #59941918328:  Hold'em No Limit ($0.10/$0.25) - 2009/07/01 1:50:19 ET
Table 'AUM6O+mgQAaLDZKMQ/5/gA' 9-max Seat #7 is the button
Seat 1: EIObtVVE4WXRXvLGJA6NHw ($10 in chips) 
Seat 2: z5GxcHlYz/GSz6W2uFiTtg ($24.75 in chips) 
Seat 3: CvL9Ch1HYCVbTsfpNucitg ($5 in chips) 
Seat 4: 4awUyiDYTgylQKXZ9faBVA ($27.70 in chips) 
Seat 5: +2kMBNpY4nF1qNCRd8SJLA ($25.30 in chips) 
Seat 6: v5jnQ1gfh9nLla3kMXG7Yg ($11 in chips) 
Seat 7: Bb42QRQMhg5/Y0vHP8/2Xw ($28.50 in chips) 
Seat 8: zDrucyjVn5aeekNEc3cJrA ($17.15 in chips) 
Seat 9: eK8qa6EPcH2zhtbmWSvc9g ($29.70 in chips) 
zDrucyjVn5aeekNEc3cJrA: posts small blind $0.10
eK8qa6EPcH2zhtbmWSvc9g: posts big blind $0.25
*** HOLE CARDS ***
EIObtVVE4WXRXvLGJA6NHw: calls $0.25
z5GxcHlYz/GSz6W2uFiTtg: calls $0.25
CvL9Ch1HYCVbTsfpNucitg: folds 
4awUyiDYTgylQKXZ9faBVA: raises $1 to $1.25
+2kMBNpY4nF1qNCRd8SJLA: folds 
v5jnQ1gfh9nLla3kMXG7Yg: folds 
Bb42QRQMhg5/Y0vHP8/2Xw: folds 
zDrucyjVn5aeekNEc3cJrA: folds 
eK8qa6EPcH2zhtbmWSvc9g: folds 
EIObtVVE4WXRXvLGJA6NHw: folds 
z5GxcHlYz/GSz6W2uFiTtg: folds 
Uncalled bet ($1) returned to 4awUyiDYTgylQKXZ9faBVA
EIObtVVE4WXRXvLGJA6NHw leaves the table
4awUyiDYTgylQKXZ9faBVA collected $1.10 from pot
4awUyiDYTgylQKXZ9faBVA: doesn't show hand 
*** SUMMARY ***
Total pot $1.10 | Rake $0 
Seat 1: EIObtVVE4WXRXvLGJA6NHw folded before Flop
Seat 2: z5GxcHlYz/GSz6W2uFiTtg folded before Flop
Seat 3: CvL9Ch1HYCVbTsfpNucitg folded before Flop (didn't bet)
Seat 4: 4awUyiDYTgylQKXZ9faBVA collected ($1.10)
Seat 5: +2kMBNpY4nF1qNCRd8SJLA folded before Flop (didn't bet)
Seat 6: v5jnQ1gfh9nLla3kMXG7Yg folded before Flop (didn't bet)
Seat 7: Bb42QRQMhg5/Y0vHP8/2Xw (button) folded before Flop (didn't bet)
Seat 8: zDrucyjVn5aeekNEc3cJrA (small blind) folded before Flop
Seat 9: eK8qa6EPcH2zhtbmWSvc9g (big blind) folded before Flop




PokerStars Game #59941918218:  Hold'em No Limit ($0.10/$0.25) - 2009/07/01 1:50:19 ET
Table 'WjNvuuSgTjm8jh0j9vcCgQ' 9-max Seat #4 is the button
Seat 1: q+Qdg0Hoir+SyL7haBrUnw ($7.70 in chips) 
Seat 2: ghNKXUBl/H+t83JF079ZBA ($24.90 in chips) 
Seat 3: pSKReiGBNW9NsF2jAZnlwg ($21.05 in chips) 
Seat 4: X78b5v/uhqeXXoAijbw/yg ($31 in chips) 
Seat 5: ziFpkH3wCzqB/qXeq/Hy7g ($26.70 in chips) 
Seat 6: ubsjZomMWSV0hAiBLa7K1A ($20.60 in chips) 
Seat 7: NSX8YOj+RznxoL+rO1YU4w ($18.40 in chips) 
Seat 9: CT7Xj/V/O5rBlhtt+RZeFQ ($25.25 in chips) 
ziFpkH3wCzqB/qXeq/Hy7g: posts small blind $0.10
ubsjZomMWSV0hAiBLa7K1A: posts big blind $0.25
clJsV3v77RS07bDKY+705w: sits out 
*** HOLE CARDS ***
NSX8YOj+RznxoL+rO1YU4w: folds 
CT7Xj/V/O5rBlhtt+RZeFQ: folds 
q+Qdg0Hoir+SyL7haBrUnw: folds 
ghNKXUBl/H+t83JF079ZBA: folds 
pSKReiGBNW9NsF2jAZnlwg: calls $0.25
X78b5v/uhqeXXoAijbw/yg: folds 
ziFpkH3wCzqB/qXeq/Hy7g: folds 
ubsjZomMWSV0hAiBLa7K1A: checks 
*** FLOP *** [4d 3c 7c]
ubsjZomMWSV0hAiBLa7K1A: bets $0.25
pSKReiGBNW9NsF2jAZnlwg: raises $0.25 to $0.50
ubsjZomMWSV0hAiBLa7K1A: raises $0.75 to $1.25
pSKReiGBNW9NsF2jAZnlwg: calls $0.75
*** TURN *** [4d 3c 7c] [3d]
ubsjZomMWSV0hAiBLa7K1A: checks 
pSKReiGBNW9NsF2jAZnlwg: checks 
*** RIVER *** [4d 3c 7c 3d] [Jh]
ubsjZomMWSV0hAiBLa7K1A: checks 
pSKReiGBNW9NsF2jAZnlwg: checks 
*** SHOW DOWN ***
ubsjZomMWSV0hAiBLa7K1A: shows [2c Ac] (a pair of Threes)
pSKReiGBNW9NsF2jAZnlwg: mucks hand 
ubsjZomMWSV0hAiBLa7K1A collected $2.95 from pot
*** SUMMARY ***
Total pot $3.10 | Rake $0.15 
Board [4d 3c 7c 3d Jh]
Seat 1: q+Qdg0Hoir+SyL7haBrUnw folded before Flop (didn't bet)
Seat 2: ghNKXUBl/H+t83JF079ZBA folded before Flop (didn't bet)
Seat 3: pSKReiGBNW9NsF2jAZnlwg mucked
Seat 4: X78b5v/uhqeXXoAijbw/yg (button) folded before Flop (didn't bet)
Seat 5: ziFpkH3wCzqB/qXeq/Hy7g (small blind) folded before Flop
Seat 6: ubsjZomMWSV0hAiBLa7K1A (big blind) showed [2c Ac] and won ($2.95) with a pair of Threes
Seat 7: NSX8YOj+RznxoL+rO1YU4w folded before Flop (didn't bet)
Seat 9: CT7Xj/V/O5rBlhtt+RZeFQ folded before Flop (didn't bet)




PokerStars Game #59941918382:  Hold'em No Limit ($0.10/$0.25) - 2009/07/01 1:50:19 ET
Table 'FE/j6VqBY4j9Uq+VHURQCQ' 6-max Seat #1 is the button
Seat 1: ypmjhffk/YHGc51wgVXUTw ($39.30 in chips) 
Seat 2: 3zD3qLXT1bEffAoWGnc7wg ($37.20 in chips) 
Seat 3: lBoEwOFgzcERLIRUkUoRTw ($27.50 in chips) 
Seat 4: 7JyPCA0J2grhXQYxe1h3+A ($7.10 in chips) 
Seat 5: bJFzs6QmEEnz4miMfSDtcg ($16.90 in chips) 
Seat 6: Q1uciOZPBR/WkAlqa6cL4A ($25 in chips) 
3zD3qLXT1bEffAoWGnc7wg: posts small blind $0.10
lBoEwOFgzcERLIRUkUoRTw: posts big blind $0.25
*** HOLE CARDS ***
7JyPCA0J2grhXQYxe1h3+A: folds 
bJFzs6QmEEnz4miMfSDtcg: folds 
Q1uciOZPBR/WkAlqa6cL4A: raises $0.75 to $1
ypmjhffk/YHGc51wgVXUTw: folds 
3zD3qLXT1bEffAoWGnc7wg: folds 
lBoEwOFgzcERLIRUkUoRTw: folds 
Uncalled bet ($0.75) returned to Q1uciOZPBR/WkAlqa6cL4A
Q1uciOZPBR/WkAlqa6cL4A collected $0.60 from pot
Q1uciOZPBR/WkAlqa6cL4A: doesn't show hand 
*** SUMMARY ***
Total pot $0.60 | Rake $0 
Seat 1: ypmjhffk/YHGc51wgVXUTw (button) folded before Flop (didn't bet)
Seat 2: 3zD3qLXT1bEffAoWGnc7wg (small blind) folded before Flop
Seat 3: lBoEwOFgzcERLIRUkUoRTw (big blind) folded before Flop
Seat 4: 7JyPCA0J2grhXQYxe1h3+A folded before Flop (didn't bet)
Seat 5: bJFzs6QmEEnz4miMfSDtcg folded before Flop (didn't bet)
Seat 6: Q1uciOZPBR/WkAlqa6cL4A collected ($0.60)




PokerStars Game #59941918312:  Hold'em No Limit ($0.10/$0.25) - 2009/07/01 1:50:19 ET
Table 'oJpFwZj9+FUGHX90Un8s9Q' 6-max Seat #6 is the button
Seat 1: 6DwBRH+xZ12AAZmeAg+aXw ($25.60 in chips) 
Seat 2: NtrVQ9UIql0rDCnKDKZ5FQ ($19.20 in chips) 
Seat 3: kyRaCIljYA6l33lSKQfNsg ($24.65 in chips) 
Seat 4: 6elpmfyt4Zw0yvd8lePSMQ ($19.80 in chips) 
Seat 5: kG34n23qFQA3nzdOJTQ1dA ($55.10 in chips) 
Seat 6: 7LpHJVeM6k1mQdC6HXYzww ($25 in chips) 
6DwBRH+xZ12AAZmeAg+aXw: posts small blind $0.10
NtrVQ9UIql0rDCnKDKZ5FQ: posts big blind $0.25
*** HOLE CARDS ***
kyRaCIljYA6l33lSKQfNsg: folds 
6elpmfyt4Zw0yvd8lePSMQ: calls $0.25
kG34n23qFQA3nzdOJTQ1dA: calls $0.25
7LpHJVeM6k1mQdC6HXYzww: folds 
6DwBRH+xZ12AAZmeAg+aXw: folds 
NtrVQ9UIql0rDCnKDKZ5FQ: checks 
*** FLOP *** [Th Tc 4d]
NtrVQ9UIql0rDCnKDKZ5FQ: checks 
6elpmfyt4Zw0yvd8lePSMQ: checks 
kG34n23qFQA3nzdOJTQ1dA: bets $0.75
NtrVQ9UIql0rDCnKDKZ5FQ: folds 
6elpmfyt4Zw0yvd8lePSMQ: calls $0.75
*** TURN *** [Th Tc 4d] [4c]
6elpmfyt4Zw0yvd8lePSMQ: checks 
kG34n23qFQA3nzdOJTQ1dA: bets $1.50
6elpmfyt4Zw0yvd8lePSMQ: calls $1.50
*** RIVER *** [Th Tc 4d 4c] [9d]
6elpmfyt4Zw0yvd8lePSMQ: bets $2.75
kG34n23qFQA3nzdOJTQ1dA: folds 
Uncalled bet ($2.75) returned to 6elpmfyt4Zw0yvd8lePSMQ
6elpmfyt4Zw0yvd8lePSMQ collected $5.10 from pot
6elpmfyt4Zw0yvd8lePSMQ: doesn't show hand 
*** SUMMARY ***
Total pot $5.35 | Rake $0.25 
Board [Th Tc 4d 4c 9d]
Seat 1: 6DwBRH+xZ12AAZmeAg+aXw (small blind) folded before Flop
Seat 2: NtrVQ9UIql0rDCnKDKZ5FQ (big blind) folded on the Flop
Seat 3: kyRaCIljYA6l33lSKQfNsg folded before Flop (didn't bet)
Seat 4: 6elpmfyt4Zw0yvd8lePSMQ collected ($5.10)
Seat 5: kG34n23qFQA3nzdOJTQ1dA folded on the River
Seat 6: 7LpHJVeM6k1mQdC6HXYzww (button) folded before Flop (didn't bet)




PokerStars Game #59941918622:  Hold'em No Limit ($0.10/$0.25) - 2009/07/01 1:50:20 ET
Table '0XPo7K54oZIfG0xlNAcDRwnQC9LRg01NEuKFHF1nrDEw-max Seat #6 is the button
Seat 1: qf+LMbROj8/qY878wkFHbQ ($18.25 in chips) 
Seat 2: ZhV6dUX9NQhT4zf7t+ZLJg ($23.70 in chips) 
Seat 3: 6+g0Lb6vfRDZkElV8ieHyQ ($26.10 in chips) 
Seat 4: u3Ol7kv1LmvszuHNm9rc6w ($24.65 in chips) 
Seat 5: kG34n23qFQA3nzdOJTQ1dA ($27.95 in chips) 
Seat 6: xQVFeVUDopz+akuEo2wXpQ ($52.40 in chips) 
qf+LMbROj8/qY878wkFHbQ: posts small blind $0.10
ZhV6dUX9NQhT4zf7t+ZLJg: posts big blind $0.25
*** HOLE CARDS ***
6+g0Lb6vfRDZkElV8ieHyQ: folds 
u3Ol7kv1LmvszuHNm9rc6w: folds 
kG34n23qFQA3nzdOJTQ1dA: folds 
xQVFeVUDopz+akuEo2wXpQ: folds 
qf+LMbROj8/qY878wkFHbQ: calls $0.15
ZhV6dUX9NQhT4zf7t+ZLJg: checks 
*** FLOP *** [6s 8s Ts]
qf+LMbROj8/qY878wkFHbQ: bets $0.50
ZhV6dUX9NQhT4zf7t+ZLJg: folds 
Uncalled bet ($0.50) returned to qf+LMbROj8/qY878wkFHbQ
qf+LMbROj8/qY878wkFHbQ collected $0.50 from pot
*** SUMMARY ***
Total pot $0.50 | Rake $0 
Board [6s 8s Ts]
Seat 1: qf+LMbROj8/qY878wkFHbQ (small blind) collected ($0.50)
Seat 2: ZhV6dUX9NQhT4zf7t+ZLJg (big blind) folded on the Flop
Seat 3: 6+g0Lb6vfRDZkElV8ieHyQ folded before Flop (didn't bet)
Seat 4: u3Ol7kv1LmvszuHNm9rc6w folded before Flop (didn't bet)
Seat 5: kG34n23qFQA3nzdOJTQ1dA folded before Flop (didn't bet)
Seat 6: xQVFeVUDopz+akuEo2wXpQ (button) folded before Flop (didn't bet)




PokerStars Game #59941918484:  Hold'em No Limit ($0.10/$0.25) - 2009/07/01 1:50:20 ET
Table '7/qMNloI0nSXWiX5Y1watA' 9-max Seat #2 is the button
Seat 1: /LyhaB3V6jkgOfXORidqRQ ($10.40 in chips) 
Seat 2: wGigCmBR/9XWkPpvYos3aQ ($25.25 in chips) 
Seat 3: W2YYHvqjaEpRrO7stZkClQ ($4.75 in chips) 
Seat 4: K0LdhPeU31rviEPo6Sv3TA ($9.35 in chips) 
Seat 8: ljemhp25Zg+nlA9DLCIiUw ($26.05 in chips) 
Seat 9: dmYlc+1cjwZMJ7wV+Z0rRg ($27.40 in chips) 
W2YYHvqjaEpRrO7stZkClQ: posts small blind $0.10
K0LdhPeU31rviEPo6Sv3TA: posts big blind $0.25
GeMoapCKDLc4ajT0Uk9ZQw: sits out 
*** HOLE CARDS ***
ljemhp25Zg+nlA9DLCIiUw: folds 
z5GxcHlYz/GSz6W2uFiTtg has returned
aintblinkin joins the table at seat #6 
dmYlc+1cjwZMJ7wV+Z0rRg: folds 
/LyhaB3V6jkgOfXORidqRQ: folds 
wGigCmBR/9XWkPpvYos3aQ: raises $0.65 to $0.90
W2YYHvqjaEpRrO7stZkClQ: raises $0.65 to $1.55
K0LdhPeU31rviEPo6Sv3TA: folds 
wGigCmBR/9XWkPpvYos3aQ: calls $0.65
*** FLOP *** [8c Tc Ts]
W2YYHvqjaEpRrO7stZkClQ: bets $1.25
wGigCmBR/9XWkPpvYos3aQ: calls $1.25
*** TURN *** [8c Tc Ts] [Js]
W2YYHvqjaEpRrO7stZkClQ: bets $1.95 and is all-in
wGigCmBR/9XWkPpvYos3aQ: calls $1.95
*** RIVER *** [8c Tc Ts Js] [Qd]
*** SHOW DOWN ***
W2YYHvqjaEpRrO7stZkClQ: shows [Ah Ac] (two pair, Aces and Tens)
wGigCmBR/9XWkPpvYos3aQ: shows [Td 8s] (a full house, Tens full of Eights)
wGigCmBR/9XWkPpvYos3aQ collected $9.30 from pot
*** SUMMARY ***
Total pot $9.75 | Rake $0.45 
Board [8c Tc Ts Js Qd]
Seat 1: /LyhaB3V6jkgOfXORidqRQ folded before Flop (didn't bet)
Seat 2: wGigCmBR/9XWkPpvYos3aQ (button) showed [Td 8s] and won ($9.30) with a full house, Tens full of Eights
Seat 3: W2YYHvqjaEpRrO7stZkClQ (small blind) showed [Ah Ac] and lost with two pair, Aces and Tens
Seat 4: K0LdhPeU31rviEPo6Sv3TA (big blind) folded before Flop
Seat 8: ljemhp25Zg+nlA9DLCIiUw folded before Flop (didn't bet)
Seat 9: dmYlc+1cjwZMJ7wV+Z0rRg folded before Flop (didn't bet)




PokerStars Game #59941918658:  Hold'em No Limit ($0.10/$0.25) - 2009/07/01 1:50:20 ET
Table 'jxoHy9yJy0bbH/Qx73FoPA' 9-max Seat #8 is the button
Seat 1: j4q3p0lesp63b1gZDwLBZw ($6.95 in chips) 
Seat 2: F7pnn6czNpHvRM55XcA2EA ($45.50 in chips) 
Seat 3: CVqCt93Mk0MhKMaZ4LZDSQ ($9.30 in chips) 
Seat 4: bXpVeaSTPBFSPJmeXxO7nw ($4.65 in chips) 
Seat 6: Z9AeOQX3yzuSvKAm/xyovg ($10 in chips) 
Seat 7: wGigCmBR/9XWkPpvYos3aQ ($26.40 in chips) 
Seat 8: Z9W7+g1WMhhZDi7DwGbCFA ($5 in chips) 
Seat 9: CvL9Ch1HYCVbTsfpNucitg ($4.65 in chips) 
CvL9Ch1HYCVbTsfpNucitg: posts small blind $0.10
j4q3p0lesp63b1gZDwLBZw: posts big blind $0.25
maracudja: sits out 
Z9AeOQX3yzuSvKAm/xyovg: posts big blind $0.25
*** HOLE CARDS ***
F7pnn6czNpHvRM55XcA2EA: folds 
CVqCt93Mk0MhKMaZ4LZDSQ: raises $0.50 to $0.75
bXpVeaSTPBFSPJmeXxO7nw: folds 
Z9AeOQX3yzuSvKAm/xyovg: folds 
wGigCmBR/9XWkPpvYos3aQ: folds 
Z9W7+g1WMhhZDi7DwGbCFA: folds 
CvL9Ch1HYCVbTsfpNucitg: folds 
j4q3p0lesp63b1gZDwLBZw: raises $1.50 to $2.25
CVqCt93Mk0MhKMaZ4LZDSQ: calls $1.50
*** FLOP *** [Ah Th 9d]
j4q3p0lesp63b1gZDwLBZw: bets $4.70 and is all-in
CVqCt93Mk0MhKMaZ4LZDSQ: calls $4.70
*** TURN *** [Ah Th 9d] [6h]
*** RIVER *** [Ah Th 9d 6h] [7s]
*** SHOW DOWN ***
j4q3p0lesp63b1gZDwLBZw: shows [Ts Td] (three of a kind, Tens)
CVqCt93Mk0MhKMaZ4LZDSQ: mucks hand 
j4q3p0lesp63b1gZDwLBZw collected $13.55 from pot
*** SUMMARY ***
Total pot $14.25 | Rake $0.70 
Board [Ah Th 9d 6h 7s]
Seat 1: j4q3p0lesp63b1gZDwLBZw (big blind) showed [Ts Td] and won ($13.55) with three of a kind, Tens
Seat 2: F7pnn6czNpHvRM55XcA2EA folded before Flop (didn't bet)
Seat 3: CVqCt93Mk0MhKMaZ4LZDSQ mucked
Seat 4: bXpVeaSTPBFSPJmeXxO7nw folded before Flop (didn't bet)
Seat 6: Z9AeOQX3yzuSvKAm/xyovg folded before Flop
Seat 7: wGigCmBR/9XWkPpvYos3aQ folded before Flop (didn't bet)
Seat 8: Z9W7+g1WMhhZDi7DwGbCFA (button) folded before Flop (didn't bet)
Seat 9: CvL9Ch1HYCVbTsfpNucitg (small blind) folded before Flop




PokerStars Game #59941918466:  Hold'em No Limit ($0.10/$0.25) - 2009/07/01 1:50:20 ET
Table 'KU/HrxqxwDz8HKEhYTZ6uw' 6-max Seat #5 is the button
Seat 1: 7LKoiQHXpTQXJvWQrw907g ($36.70 in chips) 
Seat 2: kG34n23qFQA3nzdOJTQ1dA ($24.30 in chips) 
Seat 3: SFmT9ZsVopnukjvAzrxTRg ($26.10 in chips) 
Seat 5: iyZxqznXjv3vtvOJymkoLQ ($52.35 in chips) 
Seat 6: qWxkCeqApAWdAA0evrfDvQ ($10.25 in chips) 
qWxkCeqApAWdAA0evrfDvQ: posts small blind $0.10
7LKoiQHXpTQXJvWQrw907g: posts big blind $0.25
*** HOLE CARDS ***
kG34n23qFQA3nzdOJTQ1dA: folds 
SFmT9ZsVopnukjvAzrxTRg: folds 
iyZxqznXjv3vtvOJymkoLQ: folds 
qWxkCeqApAWdAA0evrfDvQ: calls $0.15
7LKoiQHXpTQXJvWQrw907g: checks 
*** FLOP *** [Qc 4h Th]
qWxkCeqApAWdAA0evrfDvQ: checks 
7LKoiQHXpTQXJvWQrw907g: checks 
*** TURN *** [Qc 4h Th] [2s]
qWxkCeqApAWdAA0evrfDvQ: checks 
7LKoiQHXpTQXJvWQrw907g: bets $0.50
qWxkCeqApAWdAA0evrfDvQ: calls $0.50
*** RIVER *** [Qc 4h Th 2s] [2c]
qWxkCeqApAWdAA0evrfDvQ: checks 
7LKoiQHXpTQXJvWQrw907g: bets $1
qWxkCeqApAWdAA0evrfDvQ: calls $1
*** SHOW DOWN ***
7LKoiQHXpTQXJvWQrw907g: shows [2h 9h] (three of a kind, Deuces)
qWxkCeqApAWdAA0evrfDvQ: mucks hand 
7LKoiQHXpTQXJvWQrw907g collected $3.35 from pot
*** SUMMARY ***
Total pot $3.50 | Rake $0.15 
Board [Qc 4h Th 2s 2c]
Seat 1: 7LKoiQHXpTQXJvWQrw907g (big blind) showed [2h 9h] and won ($3.35) with three of a kind, Deuces
Seat 2: kG34n23qFQA3nzdOJTQ1dA folded before Flop (didn't bet)
Seat 3: SFmT9ZsVopnukjvAzrxTRg folded before Flop (didn't bet)
Seat 5: iyZxqznXjv3vtvOJymkoLQ (button) folded before Flop (didn't bet)
Seat 6: qWxkCeqApAWdAA0evrfDvQ (small blind) mucked




PokerStars Game #59941918454:  Hold'em No Limit ($0.10/$0.25) - 2009/07/01 1:50:20 ET
Table 'Pz8SfAzhP5nvWTsJRAxoDg' 6-max Seat #3 is the button
Seat 1: QiL+lEgEWwy21jk/ltaRLg ($46.80 in chips) 
Seat 2: k021eD5in2AjaloW5PalMg ($18.45 in chips) 
Seat 3: mfrkWA3PTeYPkbO6hi98Aw ($31.45 in chips) 
Seat 4: 4lJto+Qj0K4JrFKvHaPTLw ($63.10 in chips) 
Seat 6: QvTX2yGq3uKJiKPmns4TKQ ($17.70 in chips) 
4lJto+Qj0K4JrFKvHaPTLw: posts small blind $0.10
FYepjhAvF8ZdVCmqHIy+eQ: is sitting out 
QvTX2yGq3uKJiKPmns4TKQ: posts big blind $0.25
*** HOLE CARDS ***
FYepjhAvF8ZdVCmqHIy+eQ leaves the table
QiL+lEgEWwy21jk/ltaRLg: calls $0.25
k021eD5in2AjaloW5PalMg: folds 
mfrkWA3PTeYPkbO6hi98Aw: folds 
4lJto+Qj0K4JrFKvHaPTLw: calls $0.15
QvTX2yGq3uKJiKPmns4TKQ: checks 
*** FLOP *** [9c 6h Th]
4lJto+Qj0K4JrFKvHaPTLw: checks 
QvTX2yGq3uKJiKPmns4TKQ: checks 
QiL+lEgEWwy21jk/ltaRLg: bets $0.50
4lJto+Qj0K4JrFKvHaPTLw: raises $1.25 to $1.75
QvTX2yGq3uKJiKPmns4TKQ: folds 
QiL+lEgEWwy21jk/ltaRLg: folds 
Uncalled bet ($1.25) returned to 4lJto+Qj0K4JrFKvHaPTLw
4lJto+Qj0K4JrFKvHaPTLw collected $1.70 from pot
4lJto+Qj0K4JrFKvHaPTLw: doesn't show hand 
*** SUMMARY ***
Total pot $1.75 | Rake $0.05 
Board [9c 6h Th]
Seat 1: QiL+lEgEWwy21jk/ltaRLg folded on the Flop
Seat 2: k021eD5in2AjaloW5PalMg folded before Flop (didn't bet)
Seat 3: mfrkWA3PTeYPkbO6hi98Aw (button) folded before Flop (didn't bet)
Seat 4: 4lJto+Qj0K4JrFKvHaPTLw (small blind) collected ($1.70)
Seat 6: QvTX2yGq3uKJiKPmns4TKQ (big blind) folded on the Flop




PokerStars Game #59941918896:  Hold'em No Limit ($0.10/$0.25) - 2009/07/01 1:50:20 ET
Table 'zW+7jPbOLCvlPu+dUGY5WQ' 6-max Seat #4 is the button
Seat 1: eL3+wCBjFGfQ5FMdIZihwA ($31.55 in chips) 
Seat 2: cEMJmfAUQZmMChZe6aacKw ($5.85 in chips) 
Seat 4: i48129QFpEQQ+UN4aNtmww ($15.55 in chips) 
Seat 6: qGHGf/553gQnDoklMRe3tg ($24.25 in chips) 
Jax781 will be allowed to play after the button
qGHGf/553gQnDoklMRe3tg: posts small blind $0.10
eL3+wCBjFGfQ5FMdIZihwA: posts big blind $0.25
*** HOLE CARDS ***
cEMJmfAUQZmMChZe6aacKw: folds 
i48129QFpEQQ+UN4aNtmww: folds 
qGHGf/553gQnDoklMRe3tg: raises $0.75 to $1
eL3+wCBjFGfQ5FMdIZihwA: folds 
Uncalled bet ($0.75) returned to qGHGf/553gQnDoklMRe3tg
cEMJmfAUQZmMChZe6aacKw leaves the table
qGHGf/553gQnDoklMRe3tg collected $0.50 from pot
*** SUMMARY ***
Total pot $0.50 | Rake $0 
Seat 1: eL3+wCBjFGfQ5FMdIZihwA (big blind) folded before Flop
Seat 2: cEMJmfAUQZmMChZe6aacKw folded before Flop (didn't bet)
Seat 4: i48129QFpEQQ+UN4aNtmww (button) folded before Flop (didn't bet)
Seat 6: qGHGf/553gQnDoklMRe3tg (small blind) collected ($0.50)




PokerStars Game #59941918874:  Hold'em No Limit ($0.10/$0.25) - 2009/07/01 1:50:20 ET
Table '+giHa6FUL6U5/AZnCJEGvQ' 9-max Seat #5 is the button
Seat 5: zDrucyjVn5aeekNEc3cJrA ($44.65 in chips) 
Seat 6: GTMnTen6sQSoCpS9sggLbg ($24.75 in chips) 
zDrucyjVn5aeekNEc3cJrA: posts small blind $0.10
GTMnTen6sQSoCpS9sggLbg: posts big blind $0.25
*** HOLE CARDS ***
zDrucyjVn5aeekNEc3cJrA: calls $0.15
GTMnTen6sQSoCpS9sggLbg: checks 
*** FLOP *** [7h 4s 7s]
GTMnTen6sQSoCpS9sggLbg: checks 
zDrucyjVn5aeekNEc3cJrA: checks 
*** TURN *** [7h 4s 7s] [Jd]
GTMnTen6sQSoCpS9sggLbg: checks 
zDrucyjVn5aeekNEc3cJrA: checks 
*** RIVER *** [7h 4s 7s Jd] [Qd]
GTMnTen6sQSoCpS9sggLbg: checks 
zDrucyjVn5aeekNEc3cJrA: checks 
*** SHOW DOWN ***
GTMnTen6sQSoCpS9sggLbg: shows [Ad 6c] (a pair of Sevens)
zDrucyjVn5aeekNEc3cJrA: shows [Th Ac] (a pair of Sevens)
GTMnTen6sQSoCpS9sggLbg collected $0.25 from pot
zDrucyjVn5aeekNEc3cJrA collected $0.25 from pot
*** SUMMARY ***
Total pot $0.50 | Rake $0 
Board [7h 4s 7s Jd Qd]
Seat 5: zDrucyjVn5aeekNEc3cJrA (button) (small blind) showed [Th Ac] and won ($0.25) with a pair of Sevens
Seat 6: GTMnTen6sQSoCpS9sggLbg (big blind) showed [Ad 6c] and won ($0.25) with a pair of Sevens




PokerStars Game #59941919280:  Hold'em No Limit ($0.10/$0.25) - 2009/07/01 1:50:21 ET
Table 'Of/T60zpXg1GcjrZ7Lm//Q' 9-max Seat #2 is the button
Seat 1: Lro4e37x4FUa5P3yzDjskw ($20 in chips) 
Seat 2: qwr38jl5txoR36M7G5qi4A ($9.55 in chips) 
Seat 3: 6RiVTYll/5D8zICp0MRpKw ($22.75 in chips) 
Seat 4: Czut6V7acIqUJrrobjKAZg ($5.40 in chips) 
Seat 5: 6mStmDUknIn/RyBEoiIyoQ ($10 in chips) 
Seat 6: tYsOBqdU1+x+yFI7zHO7hQ ($31.45 in chips) 
Seat 7: PVxvfRTRvkgZf9WtquEkwQ ($25 in chips) 
Seat 8: ghNKXUBl/H+t83JF079ZBA ($26.50 in chips) 
Seat 9: egvg3mTBBVzMHnJPIQiKcA ($15.05 in chips) 
6RiVTYll/5D8zICp0MRpKw: posts small blind $0.10
Czut6V7acIqUJrrobjKAZg: posts big blind $0.25
6mStmDUknIn/RyBEoiIyoQ: posts big blind $0.25
*** HOLE CARDS ***
6mStmDUknIn/RyBEoiIyoQ: checks 
tYsOBqdU1+x+yFI7zHO7hQ: folds 
PVxvfRTRvkgZf9WtquEkwQ: folds 
ghNKXUBl/H+t83JF079ZBA: folds 
egvg3mTBBVzMHnJPIQiKcA: folds 
Lro4e37x4FUa5P3yzDjskw: folds 
qwr38jl5txoR36M7G5qi4A: folds 
6RiVTYll/5D8zICp0MRpKw: calls $0.15
Czut6V7acIqUJrrobjKAZg: raises $0.75 to $1
6mStmDUknIn/RyBEoiIyoQ: calls $0.75
6RiVTYll/5D8zICp0MRpKw: folds 
*** FLOP *** [2c Ad Th]
Czut6V7acIqUJrrobjKAZg: bets $4.40 and is all-in
6mStmDUknIn/RyBEoiIyoQ: folds 
Uncalled bet ($4.40) returned to Czut6V7acIqUJrrobjKAZg
Czut6V7acIqUJrrobjKAZg collected $2.15 from pot
*** SUMMARY ***
Total pot $2.25 | Rake $0.10 
Board [2c Ad Th]
Seat 1: Lro4e37x4FUa5P3yzDjskw folded before Flop (didn't bet)
Seat 2: qwr38jl5txoR36M7G5qi4A (button) folded before Flop (didn't bet)
Seat 3: 6RiVTYll/5D8zICp0MRpKw (small blind) folded before Flop
Seat 4: Czut6V7acIqUJrrobjKAZg (big blind) collected ($2.15)
Seat 5: 6mStmDUknIn/RyBEoiIyoQ folded on the Flop
Seat 6: tYsOBqdU1+x+yFI7zHO7hQ folded before Flop (didn't bet)
Seat 7: PVxvfRTRvkgZf9WtquEkwQ folded before Flop (didn't bet)
Seat 8: ghNKXUBl/H+t83JF079ZBA folded before Flop (didn't bet)
Seat 9: egvg3mTBBVzMHnJPIQiKcA folded before Flop (didn't bet)




PokerStars Game #59941919366:  Hold'em No Limit ($0.10/$0.25) - 2009/07/01 1:50:21 ET
Table 'NfXsh0UQA+o/kO9acV3WxA' 9-max Seat #2 is the button
Seat 1: pN3IHvAKm2fz+sTRARTcrg ($21.80 in chips) 
Seat 2: mhpFs2SZupy4zLRb62FLFA ($24.65 in chips) 
Seat 3: wCUaomJ6Nq5zomVGdUHP+w ($20 in chips) 
Seat 4: r6hsffOo1iKmaPYKwAZmFw ($30.05 in chips) 
Seat 5: zgi+EUykT/pZQpoUG6+oEg ($4.65 in chips) 
Seat 7: yqkowiRWZ6NvRN9UUkYIlA ($5 in chips) 
Seat 8: +sbyWwIcFp9kP0bDtMegfQ ($40.60 in chips) 
Seat 9: uhrboV251dcgYniYTdFIcA ($28.85 in chips) 
wCUaomJ6Nq5zomVGdUHP+w: posts small blind $0.10
r6hsffOo1iKmaPYKwAZmFw: posts big blind $0.25
qwr38jl5txoR36M7G5qi4A: sits out 
*** HOLE CARDS ***
zgi+EUykT/pZQpoUG6+oEg: folds 
yqkowiRWZ6NvRN9UUkYIlA: folds 
+sbyWwIcFp9kP0bDtMegfQ: folds 
uhrboV251dcgYniYTdFIcA: folds 
pN3IHvAKm2fz+sTRARTcrg: folds 
mhpFs2SZupy4zLRb62FLFA: folds 
wCUaomJ6Nq5zomVGdUHP+w: folds 
Uncalled bet ($0.15) returned to r6hsffOo1iKmaPYKwAZmFw
r6hsffOo1iKmaPYKwAZmFw collected $0.20 from pot
r6hsffOo1iKmaPYKwAZmFw: doesn't show hand 
*** SUMMARY ***
Total pot $0.20 | Rake $0 
Seat 1: pN3IHvAKm2fz+sTRARTcrg folded before Flop (didn't bet)
Seat 2: mhpFs2SZupy4zLRb62FLFA (button) folded before Flop (didn't bet)
Seat 3: wCUaomJ6Nq5zomVGdUHP+w (small blind) folded before Flop
Seat 4: r6hsffOo1iKmaPYKwAZmFw (big blind) collected ($0.20)
Seat 5: zgi+EUykT/pZQpoUG6+oEg folded before Flop (didn't bet)
Seat 7: yqkowiRWZ6NvRN9UUkYIlA folded before Flop (didn't bet)
Seat 8: +sbyWwIcFp9kP0bDtMegfQ folded before Flop (didn't bet)
Seat 9: uhrboV251dcgYniYTdFIcA folded before Flop (didn't bet)




PokerStars Game #59941919146:  Hold'em No Limit ($0.10/$0.25) - 2009/07/01 1:50:21 ET
Table 'Y9EhDWuqWWQFM9SelXAj5g' 9-max Seat #9 is the button
Seat 1: zDrucyjVn5aeekNEc3cJrA ($32.05 in chips) 
Seat 2: W+njF1UnarGN2q2zP+R+cg ($11.95 in chips) 
Seat 3: XBq1lBzax7LjRqdJP2TqWg ($10 in chips) 
Seat 4: V6p0jQ/RhUsqpHLmXvEX4Q ($13 in chips) 
Seat 5: CvL9Ch1HYCVbTsfpNucitg ($6.20 in chips) 
Seat 6: egvg3mTBBVzMHnJPIQiKcA ($13.65 in chips) 
Seat 8: XDxyajtqmdag0QPvwcOG7Q ($14.60 in chips) 
Seat 9: bOrfviVhRBpaOfMqUc74Tw ($16.80 in chips) 
zDrucyjVn5aeekNEc3cJrA: posts small blind $0.10
W+njF1UnarGN2q2zP+R+cg: posts big blind $0.25
*** HOLE CARDS ***
XBq1lBzax7LjRqdJP2TqWg: calls $0.25
V6p0jQ/RhUsqpHLmXvEX4Q: folds 
CvL9Ch1HYCVbTsfpNucitg: folds 
egvg3mTBBVzMHnJPIQiKcA: folds 
XDxyajtqmdag0QPvwcOG7Q: folds 
bOrfviVhRBpaOfMqUc74Tw: folds 
zDrucyjVn5aeekNEc3cJrA: calls $0.15
W+njF1UnarGN2q2zP+R+cg: raises $0.25 to $0.50
XBq1lBzax7LjRqdJP2TqWg: calls $0.25
zDrucyjVn5aeekNEc3cJrA: calls $0.25
*** FLOP *** [Jc 6d 4d]
aNpwfA31EREwO+ar4XzBCw leaves the table
zDrucyjVn5aeekNEc3cJrA: checks 
W+njF1UnarGN2q2zP+R+cg: bets $0.75
XBq1lBzax7LjRqdJP2TqWg: folds 
zDrucyjVn5aeekNEc3cJrA: calls $0.75
*** TURN *** [Jc 6d 4d] [9d]
zDrucyjVn5aeekNEc3cJrA: checks 
W+njF1UnarGN2q2zP+R+cg: bets $1
SpiiQQAzy4MUgV3I5W8giw joins the table at seat #7 
zDrucyjVn5aeekNEc3cJrA: folds 
Uncalled bet ($1) returned to W+njF1UnarGN2q2zP+R+cg
W+njF1UnarGN2q2zP+R+cg collected $2.90 from pot
W+njF1UnarGN2q2zP+R+cg: doesn't show hand 
*** SUMMARY ***
Total pot $3 | Rake $0.10 
Board [Jc 6d 4d 9d]
Seat 1: zDrucyjVn5aeekNEc3cJrA (small blind) folded on the Turn
Seat 2: W+njF1UnarGN2q2zP+R+cg (big blind) collected ($2.90)
Seat 3: XBq1lBzax7LjRqdJP2TqWg folded on the Flop
Seat 4: V6p0jQ/RhUsqpHLmXvEX4Q folded before Flop (didn't bet)
Seat 5: CvL9Ch1HYCVbTsfpNucitg folded before Flop (didn't bet)
Seat 6: egvg3mTBBVzMHnJPIQiKcA folded before Flop (didn't bet)
Seat 8: XDxyajtqmdag0QPvwcOG7Q folded before Flop (didn't bet)
Seat 9: bOrfviVhRBpaOfMqUc74Tw (button) folded before Flop (didn't bet)




PokerStars Game #59941919126:  Hold'em No Limit ($0.10/$0.25) - 2009/07/01 1:50:21 ET
Table 'Loy/olZ5qoDOSvX4UTujGg' 6-max Seat #3 is the button
Seat 1: HipgaJhkN4ie/tTw4dK3Ug ($10.40 in chips) 
Seat 2: 4z7mPbMLNp4TezHXin63Vw ($14.45 in chips) 
Seat 3: 32YL2ZEp8NT4JB2RVM9euQ ($15 in chips) 
Seat 4: /gJNBeCkWL4o85/jvlZ4BA ($30.25 in chips) 
Seat 5: Ar4vsUIUfJ7gbYh1c1m59g ($19.25 in chips) 
Seat 6: qGHGf/553gQnDoklMRe3tg ($25.15 in chips) 
/gJNBeCkWL4o85/jvlZ4BA: posts small blind $0.10
Ar4vsUIUfJ7gbYh1c1m59g: posts big blind $0.25
*** HOLE CARDS ***
qGHGf/553gQnDoklMRe3tg: folds 
HipgaJhkN4ie/tTw4dK3Ug: raises $0.50 to $0.75
4z7mPbMLNp4TezHXin63Vw: folds 
32YL2ZEp8NT4JB2RVM9euQ: folds 
/gJNBeCkWL4o85/jvlZ4BA: folds 
Ar4vsUIUfJ7gbYh1c1m59g: folds 
Uncalled bet ($0.50) returned to HipgaJhkN4ie/tTw4dK3Ug
HipgaJhkN4ie/tTw4dK3Ug collected $0.60 from pot
HipgaJhkN4ie/tTw4dK3Ug: shows [Kd Ad] (high card Ace)
*** SUMMARY ***
Total pot $0.60 | Rake $0 
Seat 1: HipgaJhkN4ie/tTw4dK3Ug collected ($0.60)
Seat 2: 4z7mPbMLNp4TezHXin63Vw folded before Flop (didn't bet)
Seat 3: 32YL2ZEp8NT4JB2RVM9euQ (button) folded before Flop (didn't bet)
Seat 4: /gJNBeCkWL4o85/jvlZ4BA (small blind) folded before Flop
Seat 5: Ar4vsUIUfJ7gbYh1c1m59g (big blind) folded before Flop
Seat 6: qGHGf/553gQnDoklMRe3tg folded before Flop (didn't bet)




PokerStars Game #59941919098:  Hold'em No Limit ($0.10/$0.25) - 2009/07/01 1:50:21 ET
Table 'VQNfcI8vTBCTvRfd3veTLQ' 6-max Seat #4 is the button
Seat 1: QiL+lEgEWwy21jk/ltaRLg ($13.50 in chips) 
Seat 2: 79ID/ub1Pt/mDpCprVmOoA ($31.25 in chips) 
Seat 3: LtASJ9OlkqGrrUKGQlpGAw ($11.25 in chips) 
Seat 4: QIWnfLSqfMcoFfdDe5LZPg ($39.75 in chips) 
Seat 5: gX2vbKwS/8zZPENAWB7hxQ ($26 in chips) 
Seat 6: LJI7A1YgDM7hgh7o56+ReQ ($27.70 in chips) 
gX2vbKwS/8zZPENAWB7hxQ: posts small blind $0.10
LJI7A1YgDM7hgh7o56+ReQ: posts big blind $0.25
*** HOLE CARDS ***
QiL+lEgEWwy21jk/ltaRLg: folds 
79ID/ub1Pt/mDpCprVmOoA: folds 
LtASJ9OlkqGrrUKGQlpGAw: folds 
QIWnfLSqfMcoFfdDe5LZPg: raises $0.50 to $0.75
gX2vbKwS/8zZPENAWB7hxQ: calls $0.65
LJI7A1YgDM7hgh7o56+ReQ: folds 
*** FLOP *** [8h Qh Jh]
gX2vbKwS/8zZPENAWB7hxQ: checks 
QIWnfLSqfMcoFfdDe5LZPg: bets $0.75
gX2vbKwS/8zZPENAWB7hxQ: folds 
Uncalled bet ($0.75) returned to QIWnfLSqfMcoFfdDe5LZPg
QIWnfLSqfMcoFfdDe5LZPg collected $1.70 from pot
*** SUMMARY ***
Total pot $1.75 | Rake $0.05 
Board [8h Qh Jh]
Seat 1: QiL+lEgEWwy21jk/ltaRLg folded before Flop (didn't bet)
Seat 2: 79ID/ub1Pt/mDpCprVmOoA folded before Flop (didn't bet)
Seat 3: LtASJ9OlkqGrrUKGQlpGAw folded before Flop (didn't bet)
Seat 4: QIWnfLSqfMcoFfdDe5LZPg (button) collected ($1.70)
Seat 5: gX2vbKwS/8zZPENAWB7hxQ (small blind) folded on the Flop
Seat 6: LJI7A1YgDM7hgh7o56+ReQ (big blind) folded before Flop




PokerStars Game #59941919156:  Hold'em No Limit ($0.10/$0.25) - 2009/07/01 1:50:21 ET
Table 'Zi9/NqNs3XoL1eWhMCyZyg' 9-max Seat #4 is the button
Seat 1: X6+pSIPfovPcE87t+LmUKQ ($4.50 in chips) 
Seat 2: 1wKfgJ8xXIiuc8C6qjkxhg ($5.10 in chips) 
Seat 3: ETC7YyRJTa2Ovhln64Ni5Q ($27.80 in chips) 
Seat 4: dmYlc+1cjwZMJ7wV+Z0rRg ($23.40 in chips) 
Seat 6: YQhfmYhgnDDlWCAFmBb36Q ($17.55 in chips) 
Seat 7: 0QdZrkFD7aGKeBXPGbIomA ($2.20 in chips) 
Seat 8: nm4Dj/f+jJEwKVsUnKh73g ($34.65 in chips) 
LuckyPounce will be allowed to play after the button
YQhfmYhgnDDlWCAFmBb36Q: posts small blind $0.10
0QdZrkFD7aGKeBXPGbIomA: posts big blind $0.25
3l+i+xMeyDndSXMF2A5CDA: sits out 
*** HOLE CARDS ***
nm4Dj/f+jJEwKVsUnKh73g: folds 
X6+pSIPfovPcE87t+LmUKQ: folds 
1wKfgJ8xXIiuc8C6qjkxhg: calls $0.25
ETC7YyRJTa2Ovhln64Ni5Q: folds 
dmYlc+1cjwZMJ7wV+Z0rRg: folds 
YQhfmYhgnDDlWCAFmBb36Q: raises $0.25 to $0.50
0QdZrkFD7aGKeBXPGbIomA: folds 
1wKfgJ8xXIiuc8C6qjkxhg: calls $0.25
*** FLOP *** [8h Tc Kh]
YQhfmYhgnDDlWCAFmBb36Q: bets $0.50
1wKfgJ8xXIiuc8C6qjkxhg: folds 
Uncalled bet ($0.50) returned to YQhfmYhgnDDlWCAFmBb36Q
YQhfmYhgnDDlWCAFmBb36Q collected $1.20 from pot
YQhfmYhgnDDlWCAFmBb36Q: doesn't show hand 
*** SUMMARY ***
Total pot $1.25 | Rake $0.05 
Board [8h Tc Kh]
Seat 1: X6+pSIPfovPcE87t+LmUKQ folded before Flop (didn't bet)
Seat 2: 1wKfgJ8xXIiuc8C6qjkxhg folded on the Flop
Seat 3: ETC7YyRJTa2Ovhln64Ni5Q folded before Flop (didn't bet)
Seat 4: dmYlc+1cjwZMJ7wV+Z0rRg (button) folded before Flop (didn't bet)
Seat 6: YQhfmYhgnDDlWCAFmBb36Q (small blind) collected ($1.20)
Seat 7: 0QdZrkFD7aGKeBXPGbIomA (big blind) folded before Flop
Seat 8: nm4Dj/f+jJEwKVsUnKh73g folded before Flop (didn't bet)




PokerStars Game #59941919544:  Hold'em No Limit ($0.10/$0.25) - 2009/07/01 1:50:22 ET
Table 'nB7Q7zfNfy6ig6DB+rsgWQ' 6-max Seat #5 is the button
Seat 1: Hzy03WtPHMYwLYM7hTTxQw ($25 in chips) 
Seat 2: 4BHo0wlX9INjkj2727qE0w ($26.50 in chips) 
Seat 3: p3NYOxYhkL7txPRSeXHDeg ($31.50 in chips) 
Seat 4: DihMHaz4WNETH1bPDe13kA ($80.70 in chips) 
Seat 5: xC0kaiDYM6YTlgODL83O5A ($16.30 in chips) 
Seat 6: MEGIwX0eHRUj63lwYaNhVg ($7.70 in chips) 
MEGIwX0eHRUj63lwYaNhVg: posts small blind $0.10
Hzy03WtPHMYwLYM7hTTxQw: posts big blind $0.25
*** HOLE CARDS ***
4BHo0wlX9INjkj2727qE0w: calls $0.25
p3NYOxYhkL7txPRSeXHDeg: folds 
DihMHaz4WNETH1bPDe13kA: folds 
xC0kaiDYM6YTlgODL83O5A: raises $1 to $1.25
MEGIwX0eHRUj63lwYaNhVg: folds 
Hzy03WtPHMYwLYM7hTTxQw: folds 
4BHo0wlX9INjkj2727qE0w: calls $1
*** FLOP *** [6h 2c Ks]
4BHo0wlX9INjkj2727qE0w: bets $1
xC0kaiDYM6YTlgODL83O5A: calls $1
*** TURN *** [6h 2c Ks] [9h]
4BHo0wlX9INjkj2727qE0w: bets $0.75
xC0kaiDYM6YTlgODL83O5A: calls $0.75
*** RIVER *** [6h 2c Ks 9h] [3c]
4BHo0wlX9INjkj2727qE0w: bets $1
xC0kaiDYM6YTlgODL83O5A: calls $1
*** SHOW DOWN ***
4BHo0wlX9INjkj2727qE0w: shows [8d Kc] (a pair of Kings)
xC0kaiDYM6YTlgODL83O5A: mucks hand 
4BHo0wlX9INjkj2727qE0w collected $7.95 from pot
*** SUMMARY ***
Total pot $8.35 | Rake $0.40 
Board [6h 2c Ks 9h 3c]
Seat 1: Hzy03WtPHMYwLYM7hTTxQw (big blind) folded before Flop
Seat 2: 4BHo0wlX9INjkj2727qE0w showed [8d Kc] and won ($7.95) with a pair of Kings
Seat 3: p3NYOxYhkL7txPRSeXHDeg folded before Flop (didn't bet)
Seat 4: DihMHaz4WNETH1bPDe13kA folded before Flop (didn't bet)
Seat 5: xC0kaiDYM6YTlgODL83O5A (button) mucked
Seat 6: MEGIwX0eHRUj63lwYaNhVg (small blind) folded before Flop




PokerStars Game #59941919506:  Hold'em No Limit ($0.10/$0.25) - 2009/07/01 1:50:22 ET
Table 'AHkg4ChqzcMauBx6Qvz8Nw' 6-max Seat #4 is the button
Seat 1: +RDf7SmUjY2kK0PzdBEYqg ($2.05 in chips) 
Seat 2: Vi0JMrTI2BGrPL7UIulJtA ($3.30 in chips) 
Seat 3: 9dToMv2GJLfi00HcpfMnIw ($30.10 in chips) 
Seat 4: Eznneya0vB6S+eXJdVleHA ($21.90 in chips) 
Seat 5: Bada343Si4xKu3fNXY99AA ($3.95 in chips) 
Seat 6: Hsvkc0/G2VV78oVmWYXecw ($5 in chips) 
Bada343Si4xKu3fNXY99AA: posts small blind $0.10
Hsvkc0/G2VV78oVmWYXecw: posts big blind $0.25
*** HOLE CARDS ***
+RDf7SmUjY2kK0PzdBEYqg has timed out
+RDf7SmUjY2kK0PzdBEYqg: folds 
+RDf7SmUjY2kK0PzdBEYqg is sitting out
Vi0JMrTI2BGrPL7UIulJtA: raises $0.25 to $0.50
9dToMv2GJLfi00HcpfMnIw: folds 
Eznneya0vB6S+eXJdVleHA: folds 
Bada343Si4xKu3fNXY99AA: calls $0.40
Hsvkc0/G2VV78oVmWYXecw: folds 
*** FLOP *** [Kd 7c Th]
Bada343Si4xKu3fNXY99AA: checks 
Vi0JMrTI2BGrPL7UIulJtA: bets $0.75
Bada343Si4xKu3fNXY99AA: folds 
Uncalled bet ($0.75) returned to Vi0JMrTI2BGrPL7UIulJtA
Vi0JMrTI2BGrPL7UIulJtA collected $1.20 from pot
*** SUMMARY ***
Total pot $1.25 | Rake $0.05 
Board [Kd 7c Th]
Seat 1: +RDf7SmUjY2kK0PzdBEYqg folded before Flop (didn't bet)
Seat 2: Vi0JMrTI2BGrPL7UIulJtA collected ($1.20)
Seat 3: 9dToMv2GJLfi00HcpfMnIw folded before Flop (didn't bet)
Seat 4: Eznneya0vB6S+eXJdVleHA (button) folded before Flop (didn't bet)
Seat 5: Bada343Si4xKu3fNXY99AA (small blind) folded on the Flop
Seat 6: Hsvkc0/G2VV78oVmWYXecw (big blind) folded before Flop




PokerStars Game #59941919528:  Hold'em No Limit ($0.10/$0.25) - 2009/07/01 1:50:22 ET
Table 'APEHQjIcZHDZUA4iOjju2g' 6-max Seat #6 is the button
Seat 1: DE9hRlt14g+JdsRQ4wT7hg ($25.10 in chips) 
Seat 2: 3zD3qLXT1bEffAoWGnc7wg ($33.40 in chips) 
Seat 3: 3e/idKqDuPE10t6Zvr//SQ ($20.10 in chips) 
Seat 4: w2mQ4VsGljGwWXydz8tw2A ($34.60 in chips) 
Seat 5: /xN6gc9+8Hew0HxaB6VIVg ($45.65 in chips) 
Seat 6: KXtdqb+rIMkjc0RvHDksGQ ($42 in chips) 
DE9hRlt14g+JdsRQ4wT7hg: posts small blind $0.10
3zD3qLXT1bEffAoWGnc7wg: posts big blind $0.25
*** HOLE CARDS ***
3e/idKqDuPE10t6Zvr//SQ: raises $0.75 to $1
w2mQ4VsGljGwWXydz8tw2A: folds 
/xN6gc9+8Hew0HxaB6VIVg: folds 
KXtdqb+rIMkjc0RvHDksGQ: folds 
DE9hRlt14g+JdsRQ4wT7hg: folds 
3zD3qLXT1bEffAoWGnc7wg: calls $0.75
*** FLOP *** [Tc Kc Qc]
3zD3qLXT1bEffAoWGnc7wg: checks 
3e/idKqDuPE10t6Zvr//SQ: checks 
*** TURN *** [Tc Kc Qc] [6h]
3zD3qLXT1bEffAoWGnc7wg: checks 
3e/idKqDuPE10t6Zvr//SQ: checks 
*** RIVER *** [Tc Kc Qc 6h] [Jh]
3zD3qLXT1bEffAoWGnc7wg: bets $1
3e/idKqDuPE10t6Zvr//SQ: raises $1 to $2
3zD3qLXT1bEffAoWGnc7wg: calls $1
*** SHOW DOWN ***
3e/idKqDuPE10t6Zvr//SQ: shows [Ac Jd] (a straight, Ten to Ace)
3zD3qLXT1bEffAoWGnc7wg: shows [Kh Ah] (a straight, Ten to Ace)
3zD3qLXT1bEffAoWGnc7wg collected $2.90 from pot
3e/idKqDuPE10t6Zvr//SQ collected $2.90 from pot
*** SUMMARY ***
Total pot $6.10 | Rake $0.30 
Board [Tc Kc Qc 6h Jh]
Seat 1: DE9hRlt14g+JdsRQ4wT7hg (small blind) folded before Flop
Seat 2: 3zD3qLXT1bEffAoWGnc7wg (big blind) showed [Kh Ah] and won ($2.90) with a straight, Ten to Ace
Seat 3: 3e/idKqDuPE10t6Zvr//SQ showed [Ac Jd] and won ($2.90) with a straight, Ten to Ace
Seat 4: w2mQ4VsGljGwWXydz8tw2A folded before Flop (didn't bet)
Seat 5: /xN6gc9+8Hew0HxaB6VIVg folded before Flop (didn't bet)
Seat 6: KXtdqb+rIMkjc0RvHDksGQ (button) folded before Flop (didn't bet)




PokerStars Game #59941919590:  Hold'em No Limit ($0.10/$0.25) - 2009/07/01 1:50:22 ET
Table 'tANpk8z1C5o0Pq/hpYShHw' 9-max Seat #9 is the button
Seat 1: rQhYIYXSyH/IivYM1dlV5A ($17.25 in chips) 
Seat 2: og4yH4sZUZdC8jjgW8zPJQ ($2.60 in chips) 
Seat 3: zDrucyjVn5aeekNEc3cJrA ($18.55 in chips) 
Seat 4: j4q3p0lesp63b1gZDwLBZw ($5 in chips) 
Seat 5: X6+pSIPfovPcE87t+LmUKQ ($6.80 in chips) 
Seat 6: kN0AWJG6biW8tHtuF+wTjA ($10.30 in chips) 
Seat 7: aNpwfA31EREwO+ar4XzBCw ($26.95 in chips) 
Seat 9: gE5rN2TDY1aXcZn/TOPeZw ($10 in chips) 
rQhYIYXSyH/IivYM1dlV5A: posts small blind $0.10
X6+pSIPfovPcE87t+LmUKQ said, "lol"
X6+pSIPfovPcE87t+LmUKQ said, "nh"
og4yH4sZUZdC8jjgW8zPJQ: posts big blind $0.25
V6p0jQ/RhUsqpHLmXvEX4Q: sits out 
*** HOLE CARDS ***
zDrucyjVn5aeekNEc3cJrA: folds 
j4q3p0lesp63b1gZDwLBZw: folds 
X6+pSIPfovPcE87t+LmUKQ: folds 
kN0AWJG6biW8tHtuF+wTjA: raises $0.25 to $0.50
aNpwfA31EREwO+ar4XzBCw: folds 
gE5rN2TDY1aXcZn/TOPeZw: calls $0.50
rQhYIYXSyH/IivYM1dlV5A: calls $0.40
og4yH4sZUZdC8jjgW8zPJQ: calls $0.25
*** FLOP *** [9d 3s 4s]
rQhYIYXSyH/IivYM1dlV5A: checks 
og4yH4sZUZdC8jjgW8zPJQ: checks 
kN0AWJG6biW8tHtuF+wTjA: checks 
gE5rN2TDY1aXcZn/TOPeZw: checks 
*** TURN *** [9d 3s 4s] [As]
rQhYIYXSyH/IivYM1dlV5A: checks 
og4yH4sZUZdC8jjgW8zPJQ: checks 
kN0AWJG6biW8tHtuF+wTjA: bets $0.25
gE5rN2TDY1aXcZn/TOPeZw: folds 
rQhYIYXSyH/IivYM1dlV5A: folds 
og4yH4sZUZdC8jjgW8zPJQ: calls $0.25
*** RIVER *** [9d 3s 4s As] [Td]
og4yH4sZUZdC8jjgW8zPJQ: checks 
kN0AWJG6biW8tHtuF+wTjA: checks 
*** SHOW DOWN ***
og4yH4sZUZdC8jjgW8zPJQ: shows [Qs 7c] (high card Ace)
kN0AWJG6biW8tHtuF+wTjA: shows [9s 9h] (three of a kind, Nines)
kN0AWJG6biW8tHtuF+wTjA collected $2.40 from pot
*** SUMMARY ***
Total pot $2.50 | Rake $0.10 
Board [9d 3s 4s As Td]
Seat 1: rQhYIYXSyH/IivYM1dlV5A (small blind) folded on the Turn
Seat 2: og4yH4sZUZdC8jjgW8zPJQ (big blind) showed [Qs 7c] and lost with high card Ace
Seat 3: zDrucyjVn5aeekNEc3cJrA folded before Flop (didn't bet)
Seat 4: j4q3p0lesp63b1gZDwLBZw folded before Flop (didn't bet)
Seat 5: X6+pSIPfovPcE87t+LmUKQ folded before Flop (didn't bet)
Seat 6: kN0AWJG6biW8tHtuF+wTjA showed [9s 9h] and won ($2.40) with three of a kind, Nines
Seat 7: aNpwfA31EREwO+ar4XzBCw folded before Flop (didn't bet)
Seat 9: gE5rN2TDY1aXcZn/TOPeZw (button) folded on the Turn




PokerStars Game #59941919876:  Hold'em No Limit ($0.10/$0.25) - 2009/07/01 1:50:22 ET
Table 'PCxB2W9H6ma8SwsZlImuOw' 9-max Seat #4 is the button
Seat 1: SqibpGx+lf+brY0fJVvD0w ($32.70 in chips) 
Seat 2: bXpVeaSTPBFSPJmeXxO7nw ($4.65 in chips) 
Seat 3: J2a/QHAWUgo6beDRoEyg2g ($5.85 in chips) 
Seat 4: RsPwA2DnzOke3hD/Of/DUg ($2.20 in chips) 
Seat 5: GZO7tOXatVoX17M2DqPcUQ ($15.25 in chips) 
Seat 6: 5/6dWEBUHldD7iGXa2LwsQ ($15.45 in chips) 
Seat 7: c/9X4zftzphFxYtxp5kp9w ($27 in chips) 
Seat 8: Pt637jKksB5MzP0UNJAAkw ($25.60 in chips) 
Seat 9: COwSH15MvHaRF7en6/TRZQ ($6.70 in chips) 
GZO7tOXatVoX17M2DqPcUQ: posts small blind $0.10
5/6dWEBUHldD7iGXa2LwsQ: posts big blind $0.25
*** HOLE CARDS ***
c/9X4zftzphFxYtxp5kp9w: folds 
Pt637jKksB5MzP0UNJAAkw: folds 
COwSH15MvHaRF7en6/TRZQ: folds 
SqibpGx+lf+brY0fJVvD0w: folds 
c/9X4zftzphFxYtxp5kp9w leaves the table
bXpVeaSTPBFSPJmeXxO7nw: folds 
J2a/QHAWUgo6beDRoEyg2g: folds 
RsPwA2DnzOke3hD/Of/DUg: folds 
GZO7tOXatVoX17M2DqPcUQ: folds 
Uncalled bet ($0.15) returned to 5/6dWEBUHldD7iGXa2LwsQ
5/6dWEBUHldD7iGXa2LwsQ collected $0.20 from pot
*** SUMMARY ***
Total pot $0.20 | Rake $0 
Seat 1: SqibpGx+lf+brY0fJVvD0w folded before Flop (didn't bet)
Seat 2: bXpVeaSTPBFSPJmeXxO7nw folded before Flop (didn't bet)
Seat 3: J2a/QHAWUgo6beDRoEyg2g folded before Flop (didn't bet)
Seat 4: RsPwA2DnzOke3hD/Of/DUg (button) folded before Flop (didn't bet)
Seat 5: GZO7tOXatVoX17M2DqPcUQ (small blind) folded before Flop
Seat 6: 5/6dWEBUHldD7iGXa2LwsQ (big blind) collected ($0.20)
Seat 7: c/9X4zftzphFxYtxp5kp9w folded before Flop (didn't bet)
Seat 8: Pt637jKksB5MzP0UNJAAkw folded before Flop (didn't bet)
Seat 9: COwSH15MvHaRF7en6/TRZQ folded before Flop (didn't bet)




PokerStars Game #59941920254:  Hold'em No Limit ($0.10/$0.25) - 2009/07/01 1:50:23 ET
Table 'b64Z+5XI1xkQzNfq4QHr3A' 6-max Seat #2 is the button
Seat 2: A6SjYLoKeIpFjPq0BK/2WA ($14 in chips) 
Seat 3: 7cx44/slbeTw+Cy7QB8Trg ($25 in chips) 
Seat 4: 564zqq2DUHXR3tdsOJU6JA ($16.90 in chips) 
Seat 5: JFIAqU8lCZ0vWwEl4bdGsg ($57.75 in chips) 
Seat 6: 8ClCHtFXGNplITm+63KB+Q ($31.50 in chips) 
7cx44/slbeTw+Cy7QB8Trg: posts small blind $0.10
564zqq2DUHXR3tdsOJU6JA: posts big blind $0.25
*** HOLE CARDS ***
JFIAqU8lCZ0vWwEl4bdGsg: raises $0.60 to $0.85
8ClCHtFXGNplITm+63KB+Q: folds 
A6SjYLoKeIpFjPq0BK/2WA: folds 
7cx44/slbeTw+Cy7QB8Trg: folds 
564zqq2DUHXR3tdsOJU6JA: calls $0.60
*** FLOP *** [Td Jc 6d]
564zqq2DUHXR3tdsOJU6JA: checks 
JFIAqU8lCZ0vWwEl4bdGsg: bets $1.25
564zqq2DUHXR3tdsOJU6JA: folds 
Uncalled bet ($1.25) returned to JFIAqU8lCZ0vWwEl4bdGsg
JFIAqU8lCZ0vWwEl4bdGsg collected $1.75 from pot
JFIAqU8lCZ0vWwEl4bdGsg: doesn't show hand 
*** SUMMARY ***
Total pot $1.80 | Rake $0.05 
Board [Td Jc 6d]
Seat 2: A6SjYLoKeIpFjPq0BK/2WA (button) folded before Flop (didn't bet)
Seat 3: 7cx44/slbeTw+Cy7QB8Trg (small blind) folded before Flop
Seat 4: 564zqq2DUHXR3tdsOJU6JA (big blind) folded on the Flop
Seat 5: JFIAqU8lCZ0vWwEl4bdGsg collected ($1.75)
Seat 6: 8ClCHtFXGNplITm+63KB+Q folded before Flop (didn't bet)




PokerStars Game #59941920320:  Hold'em No Limit ($0.10/$0.25) - 2009/07/01 1:50:23 ET
Table 'ukli1Y7ieC5JQMTEFxM2Nw' 6-max Seat #6 is the button
Seat 1: N162H80ZIQevUf2EzGahCA ($6.55 in chips) 
Seat 3: ExeoJ1G/rSmWa3tRz7TlCA ($23.10 in chips) 
Seat 4: if4dh6jhJXeN3/qd3qCp9g ($26.75 in chips) 
Seat 5: Se+H4Z4PDr6+eIUDJX1rpg ($18.15 in chips) 
Seat 6: 32YL2ZEp8NT4JB2RVM9euQ ($32 in chips) 
N162H80ZIQevUf2EzGahCA: posts small blind $0.10
ExeoJ1G/rSmWa3tRz7TlCA: posts big blind $0.25
*** HOLE CARDS ***
if4dh6jhJXeN3/qd3qCp9g: folds 
Se+H4Z4PDr6+eIUDJX1rpg: folds 
32YL2ZEp8NT4JB2RVM9euQ: folds 
N162H80ZIQevUf2EzGahCA: calls $0.15
ExeoJ1G/rSmWa3tRz7TlCA: checks 
*** FLOP *** [2h 9c 9s]
N162H80ZIQevUf2EzGahCA: checks 
ExeoJ1G/rSmWa3tRz7TlCA: bets $0.50
N162H80ZIQevUf2EzGahCA: folds 
Uncalled bet ($0.50) returned to ExeoJ1G/rSmWa3tRz7TlCA
ExeoJ1G/rSmWa3tRz7TlCA collected $0.50 from pot
*** SUMMARY ***
Total pot $0.50 | Rake $0 
Board [2h 9c 9s]
Seat 1: N162H80ZIQevUf2EzGahCA (small blind) folded on the Flop
Seat 3: ExeoJ1G/rSmWa3tRz7TlCA (big blind) collected ($0.50)
Seat 4: if4dh6jhJXeN3/qd3qCp9g folded before Flop (didn't bet)
Seat 5: Se+H4Z4PDr6+eIUDJX1rpg folded before Flop (didn't bet)
Seat 6: 32YL2ZEp8NT4JB2RVM9euQ (button) folded before Flop (didn't bet)




PokerStars Game #59941920444:  Hold'em No Limit ($0.10/$0.25) - 2009/07/01 1:50:24 ET
Table '0XPo7K54oZIfG0xlNAcDRw' 9-max Seat #3 is the button
Seat 2: Prl9QvWQw/mISF4dSnnQUQ ($10.10 in chips) 
Seat 3: RHqgdFvufLCYe54+qd2gcA ($4.90 in chips) 
Seat 4: RubYqfvGrz2z+5ReNIj9QQ ($30.85 in chips) 
Seat 5: iOmwbUN7u4JFkV6VCA49aA ($16.60 in chips) 
Seat 6: M1nKET7WOTLbVPuAbJa3EA ($14.40 in chips) 
Seat 7: tYsOBqdU1+x+yFI7zHO7hQ ($28.45 in chips) 
Seat 8: v5jnQ1gfh9nLla3kMXG7Yg ($15.95 in chips) 
Seat 9: CmngQmkKTp8tkl6GMRTl6w ($13.25 in chips) 
RubYqfvGrz2z+5ReNIj9QQ: posts small blind $0.10
iOmwbUN7u4JFkV6VCA49aA: posts big blind $0.25
4awUyiDYTgylQKXZ9faBVA: sits out 
*** HOLE CARDS ***
M1nKET7WOTLbVPuAbJa3EA: folds 
tYsOBqdU1+x+yFI7zHO7hQ: folds 
v5jnQ1gfh9nLla3kMXG7Yg: calls $0.25
CmngQmkKTp8tkl6GMRTl6w: folds 
Prl9QvWQw/mISF4dSnnQUQ: folds 
RHqgdFvufLCYe54+qd2gcA: folds 
RubYqfvGrz2z+5ReNIj9QQ: folds 
iOmwbUN7u4JFkV6VCA49aA: checks 
*** FLOP *** [As 2s Qh]
iOmwbUN7u4JFkV6VCA49aA: checks 
v5jnQ1gfh9nLla3kMXG7Yg: checks 
*** TURN *** [As 2s Qh] [7h]
iOmwbUN7u4JFkV6VCA49aA: checks 
v5jnQ1gfh9nLla3kMXG7Yg: checks 
*** RIVER *** [As 2s Qh 7h] [Kh]
iOmwbUN7u4JFkV6VCA49aA: checks 
v5jnQ1gfh9nLla3kMXG7Yg: checks 
*** SHOW DOWN ***
iOmwbUN7u4JFkV6VCA49aA: shows [Tc Qs] (a pair of Queens)
v5jnQ1gfh9nLla3kMXG7Yg: shows [9s Ah] (a pair of Aces)
v5jnQ1gfh9nLla3kMXG7Yg collected $0.60 from pot
*** SUMMARY ***
Total pot $0.60 | Rake $0 
Board [As 2s Qh 7h Kh]
Seat 2: Prl9QvWQw/mISF4dSnnQUQ folded before Flop (didn't bet)
Seat 3: RHqgdFvufLCYe54+qd2gcA (button) folded before Flop (didn't bet)
Seat 4: RubYqfvGrz2z+5ReNIj9QQ (small blind) folded before Flop
Seat 5: iOmwbUN7u4JFkV6VCA49aA (big blind) showed [Tc Qs] and lost with a pair of Queens
Seat 6: M1nKET7WOTLbVPuAbJa3EA folded before Flop (didn't bet)
Seat 7: tYsOBqdU1+x+yFI7zHO7hQ folded before Flop (didn't bet)
Seat 8: v5jnQ1gfh9nLla3kMXG7Yg showed [9s Ah] and won ($0.60) with a pair of Aces
Seat 9: CmngQmkKTp8tkl6GMRTl6w folded before Flop (didn't bet)




PokerStars Game #59941920870:  Hold'em No Limit ($0.10/$0.25) - 2009/07/01 1:50:24 ET
Table 'KAnP7XvDtlku47YfJwdOVw' 9-max Seat #3 is the button
Seat 1: cH3q40adP+kFogl+2MtbkQ ($15 in chips) 
Seat 2: E0iYnEVO2ho7dH3QcCjw7g ($19 in chips) 
Seat 3: W6tExOcYX7qiy6Qdp+ZwFA ($7.25 in chips) 
Seat 4: 18G4P1XstjNvItdGUITxgw ($25 in chips) 
Seat 5: MG90wfSJZnOejs/KD3vlQQ ($34 in chips) 
Seat 7: Lro4e37x4FUa5P3yzDjskw ($9.15 in chips) 
Seat 8: OneeONzF0MoH0pEdcBndwA ($22.45 in chips) 
Seat 9: HDDm1BkZtdsRyw2DJdqq6A ($21.30 in chips) 
18G4P1XstjNvItdGUITxgw: posts small blind $0.10
MG90wfSJZnOejs/KD3vlQQ: posts big blind $0.25
z5GxcHlYz/GSz6W2uFiTtg: sits out 
*** HOLE CARDS ***
Lro4e37x4FUa5P3yzDjskw: folds 
OneeONzF0MoH0pEdcBndwA: folds 
HDDm1BkZtdsRyw2DJdqq6A: folds 
cH3q40adP+kFogl+2MtbkQ: folds 
E0iYnEVO2ho7dH3QcCjw7g: raises $0.75 to $1
W6tExOcYX7qiy6Qdp+ZwFA: folds 
18G4P1XstjNvItdGUITxgw: folds 
MG90wfSJZnOejs/KD3vlQQ: folds 
Uncalled bet ($0.75) returned to E0iYnEVO2ho7dH3QcCjw7g
E0iYnEVO2ho7dH3QcCjw7g collected $0.60 from pot
*** SUMMARY ***
Total pot $0.60 | Rake $0 
Seat 1: cH3q40adP+kFogl+2MtbkQ folded before Flop (didn't bet)
Seat 2: E0iYnEVO2ho7dH3QcCjw7g collected ($0.60)
Seat 3: W6tExOcYX7qiy6Qdp+ZwFA (button) folded before Flop (didn't bet)
Seat 4: 18G4P1XstjNvItdGUITxgw (small blind) folded before Flop
Seat 5: MG90wfSJZnOejs/KD3vlQQ (big blind) folded before Flop
Seat 7: Lro4e37x4FUa5P3yzDjskw folded before Flop (didn't bet)
Seat 8: OneeONzF0MoH0pEdcBndwA folded before Flop (didn't bet)
Seat 9: HDDm1BkZtdsRyw2DJdqq6A folded before Flop (didn't bet)




PokerStars Game #59941920920:  Hold'em No Limit ($0.10/$0.25) - 2009/07/01 1:50:24 ET
Table 'TJS4XvvOjO3k7mH74HJw5g' 9-max Seat #3 is the button
Seat 1: K8I2mpRME07ZlOsT2x75Lg ($7.95 in chips) 
Seat 2: yqkowiRWZ6NvRN9UUkYIlA ($10.10 in chips) 
Seat 3: 8EbrQ/EvFWt2cr0GaU82gQ ($4.65 in chips) 
Seat 4: clJsV3v77RS07bDKY+705w ($5 in chips) 
Seat 5: UlMB386Cfzy3EwurQoBjcA ($9.70 in chips) 
Seat 7: B9u+i1s5aZZkmLTLUopTBg ($14.75 in chips) 
Seat 8: Qv4VzEkN09uD11sjKv02Ig ($17.95 in chips) 
Seat 9: +sbyWwIcFp9kP0bDtMegfQ ($42.30 in chips) 
clJsV3v77RS07bDKY+705w: posts small blind $0.10
UlMB386Cfzy3EwurQoBjcA: posts big blind $0.25
3PmVnC/15cl4oyI1TKIt4g: sits out 
*** HOLE CARDS ***
B9u+i1s5aZZkmLTLUopTBg: folds 
Qv4VzEkN09uD11sjKv02Ig: folds 
+sbyWwIcFp9kP0bDtMegfQ: raises $0.75 to $1
K8I2mpRME07ZlOsT2x75Lg: folds 
yqkowiRWZ6NvRN9UUkYIlA: folds 
8EbrQ/EvFWt2cr0GaU82gQ: folds 
clJsV3v77RS07bDKY+705w: folds 
UlMB386Cfzy3EwurQoBjcA: calls $0.75
*** FLOP *** [3d 9s Ac]
UlMB386Cfzy3EwurQoBjcA: bets $1.25
+sbyWwIcFp9kP0bDtMegfQ: raises $3 to $4.25
UlMB386Cfzy3EwurQoBjcA: folds 
Uncalled bet ($3) returned to +sbyWwIcFp9kP0bDtMegfQ
+sbyWwIcFp9kP0bDtMegfQ collected $4.40 from pot
*** SUMMARY ***
Total pot $4.60 | Rake $0.20 
Board [3d 9s Ac]
Seat 1: K8I2mpRME07ZlOsT2x75Lg folded before Flop (didn't bet)
Seat 2: yqkowiRWZ6NvRN9UUkYIlA folded before Flop (didn't bet)
Seat 3: 8EbrQ/EvFWt2cr0GaU82gQ (button) folded before Flop (didn't bet)
Seat 4: clJsV3v77RS07bDKY+705w (small blind) folded before Flop
Seat 5: UlMB386Cfzy3EwurQoBjcA (big blind) folded on the Flop
Seat 7: B9u+i1s5aZZkmLTLUopTBg folded before Flop (didn't bet)
Seat 8: Qv4VzEkN09uD11sjKv02Ig folded before Flop (didn't bet)
Seat 9: +sbyWwIcFp9kP0bDtMegfQ collected ($4.40)




PokerStars Game #59941920828:  Hold'em No Limit ($0.10/$0.25) - 2009/07/01 1:50:24 ET
Table '+fuYjvJy9okLr23QyZtanA' 9-max Seat #8 is the button
Seat 2: tLcDklc2rBORNfixyRfVfw ($25 in chips) 
Seat 3: eK8qa6EPcH2zhtbmWSvc9g ($52.30 in chips) 
Seat 4: Bb42QRQMhg5/Y0vHP8/2Xw ($32.25 in chips) 
Seat 5: bXpVeaSTPBFSPJmeXxO7nw ($4.30 in chips) 
Seat 6: wGigCmBR/9XWkPpvYos3aQ ($29.80 in chips) 
Seat 7: dfNim92Z6XK1/h5SFW5vDg ($36.50 in chips) 
Seat 8: KqS/lY/fNB9qUxokm9QfeA ($8.70 in chips) 
Seat 9: OMhlmt2waO3z43ZSFNMmog ($29.70 in chips) 
OMhlmt2waO3z43ZSFNMmog: posts small blind $0.10
tLcDklc2rBORNfixyRfVfw: posts big blind $0.25
*** HOLE CARDS ***
eK8qa6EPcH2zhtbmWSvc9g: folds 
Bb42QRQMhg5/Y0vHP8/2Xw: folds 
bXpVeaSTPBFSPJmeXxO7nw: folds 
wGigCmBR/9XWkPpvYos3aQ: folds 
dfNim92Z6XK1/h5SFW5vDg: folds 
KqS/lY/fNB9qUxokm9QfeA: calls $0.25
OMhlmt2waO3z43ZSFNMmog: calls $0.15
tLcDklc2rBORNfixyRfVfw: checks 
*** FLOP *** [Kh Tc Ts]
OMhlmt2waO3z43ZSFNMmog: checks 
tLcDklc2rBORNfixyRfVfw: checks 
KqS/lY/fNB9qUxokm9QfeA: checks 
*** TURN *** [Kh Tc Ts] [7c]
OMhlmt2waO3z43ZSFNMmog: checks 
tLcDklc2rBORNfixyRfVfw: checks 
KqS/lY/fNB9qUxokm9QfeA: checks 
*** RIVER *** [Kh Tc Ts 7c] [Qc]
OMhlmt2waO3z43ZSFNMmog: checks 
tLcDklc2rBORNfixyRfVfw: checks 
KqS/lY/fNB9qUxokm9QfeA: folds 
*** SHOW DOWN ***
OMhlmt2waO3z43ZSFNMmog: shows [3h As] (a pair of Tens)
tLcDklc2rBORNfixyRfVfw: shows [Jd 7d] (two pair, Tens and Sevens)
tLcDklc2rBORNfixyRfVfw collected $0.75 from pot
*** SUMMARY ***
Total pot $0.75 | Rake $0 
Board [Kh Tc Ts 7c Qc]
Seat 2: tLcDklc2rBORNfixyRfVfw (big blind) showed [Jd 7d] and won ($0.75) with two pair, Tens and Sevens
Seat 3: eK8qa6EPcH2zhtbmWSvc9g folded before Flop (didn't bet)
Seat 4: Bb42QRQMhg5/Y0vHP8/2Xw folded before Flop (didn't bet)
Seat 5: bXpVeaSTPBFSPJmeXxO7nw folded before Flop (didn't bet)
Seat 6: wGigCmBR/9XWkPpvYos3aQ folded before Flop (didn't bet)
Seat 7: dfNim92Z6XK1/h5SFW5vDg folded before Flop (didn't bet)
Seat 8: KqS/lY/fNB9qUxokm9QfeA (button) folded on the River
Seat 9: OMhlmt2waO3z43ZSFNMmog (small blind) showed [3h As] and lost with a pair of Tens




PokerStars Game #59941920724:  Hold'em No Limit ($0.10/$0.25) - 2009/07/01 1:50:24 ET
Table 'P1IJQ2p3ACFySC35W1qwQw' 9-max Seat #3 is the button
Seat 1: bXpVeaSTPBFSPJmeXxO7nw ($5.15 in chips) 
Seat 2: vO3QVRovWemcGMkm7ijAIA ($4.85 in chips) 
Seat 3: PVxvfRTRvkgZf9WtquEkwQ ($27.40 in chips) 
Seat 5: ghNKXUBl/H+t83JF079ZBA ($56.55 in chips) 
Seat 6: ljemhp25Zg+nlA9DLCIiUw ($64.45 in chips) 
Seat 7: 7je+LC5Mfs6nL8YBVh4frQ ($5.10 in chips) 
Seat 8: tLcDklc2rBORNfixyRfVfw ($26.25 in chips) 
Seat 9: GeMoapCKDLc4ajT0Uk9ZQw ($9.75 in chips) 
ghNKXUBl/H+t83JF079ZBA: posts small blind $0.10
ljemhp25Zg+nlA9DLCIiUw: posts big blind $0.25
*** HOLE CARDS ***
7je+LC5Mfs6nL8YBVh4frQ: folds 
tLcDklc2rBORNfixyRfVfw: folds 
GeMoapCKDLc4ajT0Uk9ZQw: folds 
bXpVeaSTPBFSPJmeXxO7nw: raises $0.75 to $1
vO3QVRovWemcGMkm7ijAIA: folds 
PVxvfRTRvkgZf9WtquEkwQ: folds 
ghNKXUBl/H+t83JF079ZBA: folds 
ljemhp25Zg+nlA9DLCIiUw: folds 
Uncalled bet ($0.75) returned to bXpVeaSTPBFSPJmeXxO7nw
bXpVeaSTPBFSPJmeXxO7nw collected $0.60 from pot
bXpVeaSTPBFSPJmeXxO7nw: doesn't show hand 
*** SUMMARY ***
Total pot $0.60 | Rake $0 
Seat 1: bXpVeaSTPBFSPJmeXxO7nw collected ($0.60)
Seat 2: vO3QVRovWemcGMkm7ijAIA folded before Flop (didn't bet)
Seat 3: PVxvfRTRvkgZf9WtquEkwQ (button) folded before Flop (didn't bet)
Seat 5: ghNKXUBl/H+t83JF079ZBA (small blind) folded before Flop
Seat 6: ljemhp25Zg+nlA9DLCIiUw (big blind) folded before Flop
Seat 7: 7je+LC5Mfs6nL8YBVh4frQ folded before Flop (didn't bet)
Seat 8: tLcDklc2rBORNfixyRfVfw folded before Flop (didn't bet)
Seat 9: GeMoapCKDLc4ajT0Uk9ZQw folded before Flop (didn't bet)




PokerStars Game #59941920520:  Hold'em No Limit ($0.10/$0.25) - 2009/07/01 1:50:24 ET
Table 'C47I7CmrmFr8Oo7wOovVwQ' 6-max Seat #4 is the button
Seat 2: 8JTm/CXBn3+kuQgcUOgPkw ($24.75 in chips) 
Seat 3: H+8eOP3XJHXjACRDTiIHTQ ($21.95 in chips) 
Seat 4: yY5JuFtDfXWRaZlVby4LLw ($4.15 in chips) 
Seat 5: or309yYY9Y9bfFWtrB0yUg ($9.70 in chips) 
Seat 6: pD7ri5wL3vsa6S1ulMYQmQ ($26.95 in chips) 
or309yYY9Y9bfFWtrB0yUg: posts small blind $0.10
pD7ri5wL3vsa6S1ulMYQmQ: posts big blind $0.25
jxarturo: sits out 
*** HOLE CARDS ***
8JTm/CXBn3+kuQgcUOgPkw: folds 
H+8eOP3XJHXjACRDTiIHTQ: folds 
yY5JuFtDfXWRaZlVby4LLw: raises $3.90 to $4.15 and is all-in
or309yYY9Y9bfFWtrB0yUg: folds 
pD7ri5wL3vsa6S1ulMYQmQ: folds 
Uncalled bet ($3.90) returned to yY5JuFtDfXWRaZlVby4LLw
yY5JuFtDfXWRaZlVby4LLw collected $0.60 from pot
*** SUMMARY ***
Total pot $0.60 | Rake $0 
Seat 2: 8JTm/CXBn3+kuQgcUOgPkw folded before Flop (didn't bet)
Seat 3: H+8eOP3XJHXjACRDTiIHTQ folded before Flop (didn't bet)
Seat 4: yY5JuFtDfXWRaZlVby4LLw (button) collected ($0.60)
Seat 5: or309yYY9Y9bfFWtrB0yUg (small blind) folded before Flop
Seat 6: pD7ri5wL3vsa6S1ulMYQmQ (big blind) folded before Flop




PokerStars Game #59941920866:  Hold'em No Limit ($0.10/$0.25) - 2009/07/01 1:50:24 ET
Table '4hfTdIVT/qPsJNfWXLsVIw' 9-max Seat #4 is the button
Seat 1: GbHFBbLqLGz0Pwn6CJeAuw ($38.20 in chips) 
Seat 2: Pt637jKksB5MzP0UNJAAkw ($39.85 in chips) 
Seat 3: xnVwSkROfRtOw4eSoDANtw ($2.10 in chips) 
Seat 4: 3PmVnC/15cl4oyI1TKIt4g ($5.50 in chips) 
Seat 5: dtZ84flFEi4Q+SGrHMJRDQ ($26.10 in chips) 
Seat 6: VWUWpMLMj/Q1jRVpF7Aohw ($12.15 in chips) 
Seat 7: d7YasxuGLPiL7pj8IcGThw ($7.45 in chips) 
Seat 8: 7cv+9Zc9HIQHNvYsMfV3uA ($32.55 in chips) 
Seat 9: 9njEKzpOKC62MllUFUBWrA ($23 in chips) 
dtZ84flFEi4Q+SGrHMJRDQ: posts small blind $0.10
VWUWpMLMj/Q1jRVpF7Aohw: posts big blind $0.25
*** HOLE CARDS ***
d7YasxuGLPiL7pj8IcGThw: folds 
7cv+9Zc9HIQHNvYsMfV3uA: folds 
9njEKzpOKC62MllUFUBWrA: calls $0.25
GbHFBbLqLGz0Pwn6CJeAuw: folds 
Pt637jKksB5MzP0UNJAAkw: folds 
xnVwSkROfRtOw4eSoDANtw: folds 
3PmVnC/15cl4oyI1TKIt4g: calls $0.25
dtZ84flFEi4Q+SGrHMJRDQ: folds 
VWUWpMLMj/Q1jRVpF7Aohw: checks 
*** FLOP *** [8d 3c 7d]
VWUWpMLMj/Q1jRVpF7Aohw: checks 
9njEKzpOKC62MllUFUBWrA: checks 
3PmVnC/15cl4oyI1TKIt4g: bets $0.25
VWUWpMLMj/Q1jRVpF7Aohw: folds 
9njEKzpOKC62MllUFUBWrA: calls $0.25
*** TURN *** [8d 3c 7d] [5c]
9njEKzpOKC62MllUFUBWrA: checks 
3PmVnC/15cl4oyI1TKIt4g: bets $0.25
9njEKzpOKC62MllUFUBWrA: calls $0.25
*** RIVER *** [8d 3c 7d 5c] [8c]
9njEKzpOKC62MllUFUBWrA: checks 
3PmVnC/15cl4oyI1TKIt4g: bets $0.50
9njEKzpOKC62MllUFUBWrA: folds 
Uncalled bet ($0.50) returned to 3PmVnC/15cl4oyI1TKIt4g
3PmVnC/15cl4oyI1TKIt4g collected $1.80 from pot
3PmVnC/15cl4oyI1TKIt4g: doesn't show hand 
*** SUMMARY ***
Total pot $1.85 | Rake $0.05 
Board [8d 3c 7d 5c 8c]
Seat 1: GbHFBbLqLGz0Pwn6CJeAuw folded before Flop (didn't bet)
Seat 2: Pt637jKksB5MzP0UNJAAkw folded before Flop (didn't bet)
Seat 3: xnVwSkROfRtOw4eSoDANtw folded before Flop (didn't bet)
Seat 4: 3PmVnC/15cl4oyI1TKIt4g (button) collected ($1.80)
Seat 5: dtZ84flFEi4Q+SGrHMJRDQ (small blind) folded before Flop
Seat 6: VWUWpMLMj/Q1jRVpF7Aohw (big blind) folded on the Flop
Seat 7: d7YasxuGLPiL7pj8IcGThw folded before Flop (didn't bet)
Seat 8: 7cv+9Zc9HIQHNvYsMfV3uA folded before Flop (didn't bet)
Seat 9: 9njEKzpOKC62MllUFUBWrA folded on the River




PokerStars Game #59941920716:  Hold'em No Limit ($0.10/$0.25) - 2009/07/01 1:50:24 ET
Table '9SExUHslNkrPJ4XsrePaVw' 9-max Seat #1 is the button
Seat 1: RHqgdFvufLCYe54+qd2gcA ($4.15 in chips) 
Seat 2: cZ99hugmLBj9KhTlc8nCSw ($43.85 in chips) 
Seat 3: EP17SQz/iWcuYdNOGeBgkw ($13.80 in chips) 
Seat 4: 4awUyiDYTgylQKXZ9faBVA ($25 in chips) 
Seat 5: L+eJnUyhY8bMNYw755K8XQ ($15.40 in chips) 
Seat 6: YPJ90cgNXDABdYJcqmwB0A ($20.60 in chips) 
Seat 7: sx0lGrkT9fd4yFR+3cXUQg ($11.75 in chips) 
Seat 8: tLcDklc2rBORNfixyRfVfw ($26.35 in chips) 
Seat 9: /THNzAxdv2lBxcf4XTj/0g ($12.80 in chips) 
cZ99hugmLBj9KhTlc8nCSw: posts small blind $0.10
EP17SQz/iWcuYdNOGeBgkw: posts big blind $0.25
*** HOLE CARDS ***
4awUyiDYTgylQKXZ9faBVA: folds 
L+eJnUyhY8bMNYw755K8XQ: calls $0.25
YPJ90cgNXDABdYJcqmwB0A: calls $0.25
sx0lGrkT9fd4yFR+3cXUQg: folds 
tLcDklc2rBORNfixyRfVfw: folds 
/THNzAxdv2lBxcf4XTj/0g: folds 
RHqgdFvufLCYe54+qd2gcA: folds 
cZ99hugmLBj9KhTlc8nCSw: folds 
EP17SQz/iWcuYdNOGeBgkw: checks 
*** FLOP *** [As Kc 5d]
EP17SQz/iWcuYdNOGeBgkw: bets $0.75
L+eJnUyhY8bMNYw755K8XQ: calls $0.75
YPJ90cgNXDABdYJcqmwB0A: folds 
*** TURN *** [As Kc 5d] [Ks]
EP17SQz/iWcuYdNOGeBgkw: checks 
L+eJnUyhY8bMNYw755K8XQ: bets $1
EP17SQz/iWcuYdNOGeBgkw: calls $1
*** RIVER *** [As Kc 5d Ks] [Qh]
EP17SQz/iWcuYdNOGeBgkw: checks 
sx0lGrkT9fd4yFR+3cXUQg is disconnected 
L+eJnUyhY8bMNYw755K8XQ: bets $2
sx0lGrkT9fd4yFR+3cXUQg is connected 
EP17SQz/iWcuYdNOGeBgkw: folds 
Uncalled bet ($2) returned to L+eJnUyhY8bMNYw755K8XQ
L+eJnUyhY8bMNYw755K8XQ collected $4.15 from pot
*** SUMMARY ***
Total pot $4.35 | Rake $0.20 
Board [As Kc 5d Ks Qh]
Seat 1: RHqgdFvufLCYe54+qd2gcA (button) folded before Flop (didn't bet)
Seat 2: cZ99hugmLBj9KhTlc8nCSw (small blind) folded before Flop
Seat 3: EP17SQz/iWcuYdNOGeBgkw (big blind) folded on the River
Seat 4: 4awUyiDYTgylQKXZ9faBVA folded before Flop (didn't bet)
Seat 5: L+eJnUyhY8bMNYw755K8XQ collected ($4.15)
Seat 6: YPJ90cgNXDABdYJcqmwB0A folded on the Flop
Seat 7: sx0lGrkT9fd4yFR+3cXUQg folded before Flop (didn't bet)
Seat 8: tLcDklc2rBORNfixyRfVfw folded before Flop (didn't bet)
Seat 9: /THNzAxdv2lBxcf4XTj/0g folded before Flop (didn't bet)




PokerStars Game #59941920452:  Hold'em No Limit ($0.10/$0.25) - 2009/07/01 1:50:24 ET
Table 'mk323gviqdkOY5Aek/1EWg' 6-max Seat #5 is the button
Seat 1: 7cx44/slbeTw+Cy7QB8Trg ($25 in chips) 
Seat 2: GC/9yVD59DUCX7hUI7gcLw ($54.05 in chips) 
Seat 3: NuqYPwTLZYQhxOoVK3Yqlw ($27.30 in chips) 
Seat 4: +baiVgI/ETnBARLe5mARCw ($11.20 in chips) 
Seat 5: kjYRzIfvZNNflYMYRkkSVA ($36.30 in chips) 
Seat 6: KkXSr5xFjxLSD3wtAvT+WQ ($7.85 in chips) 
KkXSr5xFjxLSD3wtAvT+WQ: posts small blind $0.10
7cx44/slbeTw+Cy7QB8Trg: posts big blind $0.25
*** HOLE CARDS ***
GC/9yVD59DUCX7hUI7gcLw: raises $0.75 to $1
NuqYPwTLZYQhxOoVK3Yqlw: folds 
+baiVgI/ETnBARLe5mARCw: folds 
kjYRzIfvZNNflYMYRkkSVA: folds 
KkXSr5xFjxLSD3wtAvT+WQ: folds 
7cx44/slbeTw+Cy7QB8Trg: folds 
Uncalled bet ($0.75) returned to GC/9yVD59DUCX7hUI7gcLw
GC/9yVD59DUCX7hUI7gcLw collected $0.60 from pot
*** SUMMARY ***
Total pot $0.60 | Rake $0 
Seat 1: 7cx44/slbeTw+Cy7QB8Trg (big blind) folded before Flop
Seat 2: GC/9yVD59DUCX7hUI7gcLw collected ($0.60)
Seat 3: NuqYPwTLZYQhxOoVK3Yqlw folded before Flop (didn't bet)
Seat 4: +baiVgI/ETnBARLe5mARCw folded before Flop (didn't bet)
Seat 5: kjYRzIfvZNNflYMYRkkSVA (button) folded before Flop (didn't bet)
Seat 6: KkXSr5xFjxLSD3wtAvT+WQ (small blind) folded before Flop




PokerStars Game #59941921102:  Hold'em No Limit ($0.10/$0.25) - 2009/07/01 1:50:25 ET
Table 'FuFyQHmlO/QqQp//rDRrPg' 6-max Seat #4 is the button
Seat 1: jp34e617tIzV8tKIWmfAbA ($28.15 in chips) 
Seat 2: G3h3THGB1j3qdHDVHpnJWg ($37.20 in chips) 
Seat 3: EeUZtMU058v2ObUACOF4Og ($29.25 in chips) 
Seat 4: Ahsa9Yk5NPmCqQstq1EoQA ($14.40 in chips) 
Seat 5: xrf8tAXKQHG99HixCot1Iw ($26.65 in chips) 
Seat 6: 6DwBRH+xZ12AAZmeAg+aXw ($50.35 in chips) 
xrf8tAXKQHG99HixCot1Iw: posts small blind $0.10
6DwBRH+xZ12AAZmeAg+aXw: posts big blind $0.25
*** HOLE CARDS ***
jp34e617tIzV8tKIWmfAbA: folds 
G3h3THGB1j3qdHDVHpnJWg: folds 
EeUZtMU058v2ObUACOF4Og: raises $1 to $1.25
Ahsa9Yk5NPmCqQstq1EoQA: folds 
xrf8tAXKQHG99HixCot1Iw: folds 
6DwBRH+xZ12AAZmeAg+aXw: folds 
Uncalled bet ($1) returned to EeUZtMU058v2ObUACOF4Og
EeUZtMU058v2ObUACOF4Og collected $0.60 from pot
EeUZtMU058v2ObUACOF4Og: doesn't show hand 
*** SUMMARY ***
Total pot $0.60 | Rake $0 
Seat 1: jp34e617tIzV8tKIWmfAbA folded before Flop (didn't bet)
Seat 2: G3h3THGB1j3qdHDVHpnJWg folded before Flop (didn't bet)
Seat 3: EeUZtMU058v2ObUACOF4Og collected ($0.60)
Seat 4: Ahsa9Yk5NPmCqQstq1EoQA (button) folded before Flop (didn't bet)
Seat 5: xrf8tAXKQHG99HixCot1Iw (small blind) folded before Flop
Seat 6: 6DwBRH+xZ12AAZmeAg+aXw (big blind) folded before Flop




PokerStars Game #59941921414:  Hold'em No Limit ($0.10/$0.25) - 2009/07/01 1:50:25 ET
Table 'QzXakDK7ZHNjgIpoUFGSKQ' 9-max Seat #6 is the button
Seat 1: w1ukf8uPa4+WH561TtVRxA ($25 in chips) 
Seat 2: QEbIGci+itdw+re8RM5fZA ($25 in chips) 
Seat 3: eK8qa6EPcH2zhtbmWSvc9g ($25.30 in chips) 
Seat 4: 12pxJGeALcKLTBryE6kFxA ($14.15 in chips) 
Seat 5: MtVtHDqIJTyUcXkRBBDIVA ($31.20 in chips) 
Seat 6: gehe91e0IyVT0QU/XBkEyg ($25.75 in chips) 
Seat 7: wGigCmBR/9XWkPpvYos3aQ ($28.05 in chips) 
Seat 8: Z9W7+g1WMhhZDi7DwGbCFA ($5 in chips) 
Seat 9: lwrOE80tuooHfIBx/4LUSw ($25.70 in chips) 
wGigCmBR/9XWkPpvYos3aQ: posts small blind $0.10
Z9W7+g1WMhhZDi7DwGbCFA: posts big blind $0.25
*** HOLE CARDS ***
lwrOE80tuooHfIBx/4LUSw: folds 
w1ukf8uPa4+WH561TtVRxA: folds 
QEbIGci+itdw+re8RM5fZA: folds 
eK8qa6EPcH2zhtbmWSvc9g: folds 
12pxJGeALcKLTBryE6kFxA: raises $0.25 to $0.50
MtVtHDqIJTyUcXkRBBDIVA: folds 
gehe91e0IyVT0QU/XBkEyg: folds 
wGigCmBR/9XWkPpvYos3aQ: folds 
Z9W7+g1WMhhZDi7DwGbCFA: folds 
Uncalled bet ($0.25) returned to 12pxJGeALcKLTBryE6kFxA
12pxJGeALcKLTBryE6kFxA collected $0.60 from pot
12pxJGeALcKLTBryE6kFxA: doesn't show hand 
*** SUMMARY ***
Total pot $0.60 | Rake $0 
Seat 1: w1ukf8uPa4+WH561TtVRxA folded before Flop (didn't bet)
Seat 2: QEbIGci+itdw+re8RM5fZA folded before Flop (didn't bet)
Seat 3: eK8qa6EPcH2zhtbmWSvc9g folded before Flop (didn't bet)
Seat 4: 12pxJGeALcKLTBryE6kFxA collected ($0.60)
Seat 5: MtVtHDqIJTyUcXkRBBDIVA folded before Flop (didn't bet)
Seat 6: gehe91e0IyVT0QU/XBkEyg (button) folded before Flop (didn't bet)
Seat 7: wGigCmBR/9XWkPpvYos3aQ (small blind) folded before Flop
Seat 8: Z9W7+g1WMhhZDi7DwGbCFA (big blind) folded before Flop
Seat 9: lwrOE80tuooHfIBx/4LUSw folded before Flop (didn't bet)




PokerStars Game #59941921368:  Hold'em No Limit ($0.10/$0.25) - 2009/07/01 1:50:25 ET
Table '3KDMdm1sfxFsNKkjc/PnBg' 9-max Seat #4 is the button
Seat 1: RN77cWdo2Yfi3gUEKq3PdA ($14.75 in chips) 
Seat 2: 5WLo/V8l3QfpUdK9JPp99w ($31.10 in chips) 
Seat 3: OXPkK84/qv92EMwXPiG5rQ ($9.25 in chips) 
Seat 4: F7pnn6czNpHvRM55XcA2EA ($37.60 in chips) 
Seat 5: +2kMBNpY4nF1qNCRd8SJLA ($30.20 in chips) 
Seat 6: yq2rcghljWKV3+gbDEsK+g ($15 in chips) 
Seat 7: gehe91e0IyVT0QU/XBkEyg ($32.15 in chips) 
Seat 9: K0b5wNInj6hUGRr6yzKFtw ($32.35 in chips) 
+2kMBNpY4nF1qNCRd8SJLA: posts small blind $0.10
yq2rcghljWKV3+gbDEsK+g: posts big blind $0.25
CGjLyv/AvljZy2g76nYkzQ: sits out 
*** HOLE CARDS ***
gehe91e0IyVT0QU/XBkEyg: folds 
K0b5wNInj6hUGRr6yzKFtw: folds 
RN77cWdo2Yfi3gUEKq3PdA: folds 
5WLo/V8l3QfpUdK9JPp99w: raises $0.25 to $0.50
OXPkK84/qv92EMwXPiG5rQ: calls $0.50
F7pnn6czNpHvRM55XcA2EA: calls $0.50
+2kMBNpY4nF1qNCRd8SJLA: calls $0.40
yq2rcghljWKV3+gbDEsK+g: calls $0.25
*** FLOP *** [6d Qh 2h]
+2kMBNpY4nF1qNCRd8SJLA: checks 
yq2rcghljWKV3+gbDEsK+g: checks 
5WLo/V8l3QfpUdK9JPp99w: bets $1
OXPkK84/qv92EMwXPiG5rQ: calls $1
F7pnn6czNpHvRM55XcA2EA: folds 
+2kMBNpY4nF1qNCRd8SJLA: calls $1
yq2rcghljWKV3+gbDEsK+g: folds 
*** TURN *** [6d Qh 2h] [3s]
+2kMBNpY4nF1qNCRd8SJLA: checks 
5WLo/V8l3QfpUdK9JPp99w: bets $2
OXPkK84/qv92EMwXPiG5rQ: calls $2
+2kMBNpY4nF1qNCRd8SJLA: calls $2
*** RIVER *** [6d Qh 2h 3s] [8c]
+2kMBNpY4nF1qNCRd8SJLA: checks 
5WLo/V8l3QfpUdK9JPp99w: bets $3
OXPkK84/qv92EMwXPiG5rQ: folds 
+2kMBNpY4nF1qNCRd8SJLA: folds 
Uncalled bet ($3) returned to 5WLo/V8l3QfpUdK9JPp99w
5WLo/V8l3QfpUdK9JPp99w collected $10.95 from pot
*** SUMMARY ***
Total pot $11.50 | Rake $0.55 
Board [6d Qh 2h 3s 8c]
Seat 1: RN77cWdo2Yfi3gUEKq3PdA folded before Flop (didn't bet)
Seat 2: 5WLo/V8l3QfpUdK9JPp99w collected ($10.95)
Seat 3: OXPkK84/qv92EMwXPiG5rQ folded on the River
Seat 4: F7pnn6czNpHvRM55XcA2EA (button) folded on the Flop
Seat 5: +2kMBNpY4nF1qNCRd8SJLA (small blind) folded on the River
Seat 6: yq2rcghljWKV3+gbDEsK+g (big blind) folded on the Flop
Seat 7: gehe91e0IyVT0QU/XBkEyg folded before Flop (didn't bet)
Seat 9: K0b5wNInj6hUGRr6yzKFtw folded before Flop (didn't bet)




PokerStars Game #59941921434:  Hold'em No Limit ($0.10/$0.25) - 2009/07/01 1:50:25 ET
Table 'aisAlB9GIV21BwfUW3+Nbg' 9-max Seat #8 is the button
Seat 1: SqibpGx+lf+brY0fJVvD0w ($24.85 in chips) 
Seat 3: CvL9Ch1HYCVbTsfpNucitg ($4.55 in chips) 
Seat 4: sD+TKtt36XiiN6jqHiLwDA ($26.50 in chips) 
Seat 5: ghNKXUBl/H+t83JF079ZBA ($27.40 in chips) 
Seat 6: 9gmYYQesalMrUjaF7nKfrQ ($15.85 in chips) 
Seat 7: jGjM+5lCSe6f2MEwxQGOAg ($21.25 in chips) 
Seat 8: VWUWpMLMj/Q1jRVpF7Aohw ($25.95 in chips) 
Seat 9: N0hGpTAEAj9k5msS6LPLAw ($20.35 in chips) 
N0hGpTAEAj9k5msS6LPLAw: posts small blind $0.10
SqibpGx+lf+brY0fJVvD0w: posts big blind $0.25
zgi+EUykT/pZQpoUG6+oEg: sits out 
*** HOLE CARDS ***
CvL9Ch1HYCVbTsfpNucitg: folds 
sD+TKtt36XiiN6jqHiLwDA: folds 
ghNKXUBl/H+t83JF079ZBA: folds 
9gmYYQesalMrUjaF7nKfrQ: folds 
jGjM+5lCSe6f2MEwxQGOAg: folds 
jGjM+5lCSe6f2MEwxQGOAg leaves the table
VWUWpMLMj/Q1jRVpF7Aohw: folds 
N0hGpTAEAj9k5msS6LPLAw: calls $0.15
SqibpGx+lf+brY0fJVvD0w: checks 
*** FLOP *** [7c Th 3h]
N0hGpTAEAj9k5msS6LPLAw: bets $0.25
SqibpGx+lf+brY0fJVvD0w: folds 
Uncalled bet ($0.25) returned to N0hGpTAEAj9k5msS6LPLAw
N0hGpTAEAj9k5msS6LPLAw collected $0.50 from pot
*** SUMMARY ***
Total pot $0.50 | Rake $0 
Board [7c Th 3h]
Seat 1: SqibpGx+lf+brY0fJVvD0w (big blind) folded on the Flop
Seat 3: CvL9Ch1HYCVbTsfpNucitg folded before Flop (didn't bet)
Seat 4: sD+TKtt36XiiN6jqHiLwDA folded before Flop (didn't bet)
Seat 5: ghNKXUBl/H+t83JF079ZBA folded before Flop (didn't bet)
Seat 6: 9gmYYQesalMrUjaF7nKfrQ folded before Flop (didn't bet)
Seat 7: jGjM+5lCSe6f2MEwxQGOAg folded before Flop (didn't bet)
Seat 8: VWUWpMLMj/Q1jRVpF7Aohw (button) folded before Flop (didn't bet)
Seat 9: N0hGpTAEAj9k5msS6LPLAw (small blind) collected ($0.50)




PokerStars Game #59941920996:  Hold'em No Limit ($0.10/$0.25) - 2009/07/01 1:50:25 ET
Table 'M7d9IrgQUUFFy/SZ3ksLYg' 6-max Seat #3 is the button
Seat 1: ypmjhffk/YHGc51wgVXUTw ($50.85 in chips) 
Seat 2: 8CPg15X6IHYR1pWm9ha1Sw ($26.50 in chips) 
Seat 3: epAUIB7h2FJXzUPRIvSkRA ($25.90 in chips) 
Seat 4: 8ClCHtFXGNplITm+63KB+Q ($22.60 in chips) 
Seat 5: kMa8BltUcBQVxnHfqdCfXg ($6 in chips) 
8ClCHtFXGNplITm+63KB+Q: posts small blind $0.10
spirit76oem has returned
kMa8BltUcBQVxnHfqdCfXg: posts big blind $0.25
*** HOLE CARDS ***
ypmjhffk/YHGc51wgVXUTw: raises $0.50 to $0.75
8CPg15X6IHYR1pWm9ha1Sw: calls $0.75
epAUIB7h2FJXzUPRIvSkRA: folds 
8ClCHtFXGNplITm+63KB+Q: folds 
kMa8BltUcBQVxnHfqdCfXg: folds 
*** FLOP *** [6h 8s 3h]
ypmjhffk/YHGc51wgVXUTw: checks 
8CPg15X6IHYR1pWm9ha1Sw: checks 
*** TURN *** [6h 8s 3h] [2c]
ypmjhffk/YHGc51wgVXUTw: checks 
8CPg15X6IHYR1pWm9ha1Sw: bets $0.75
ypmjhffk/YHGc51wgVXUTw: folds 
Uncalled bet ($0.75) returned to 8CPg15X6IHYR1pWm9ha1Sw
8CPg15X6IHYR1pWm9ha1Sw collected $1.80 from pot
*** SUMMARY ***
Total pot $1.85 | Rake $0.05 
Board [6h 8s 3h 2c]
Seat 1: ypmjhffk/YHGc51wgVXUTw folded on the Turn
Seat 2: 8CPg15X6IHYR1pWm9ha1Sw collected ($1.80)
Seat 3: epAUIB7h2FJXzUPRIvSkRA (button) folded before Flop (didn't bet)
Seat 4: 8ClCHtFXGNplITm+63KB+Q (small blind) folded before Flop
Seat 5: kMa8BltUcBQVxnHfqdCfXg (big blind) folded before Flop




PokerStars Game #59941921306:  Hold'em No Limit ($0.10/$0.25) - 2009/07/01 1:50:25 ET
Table 'KEoOIegxPF91KooL2AelUA' 6-max Seat #2 is the button
Seat 1: 32YL2ZEp8NT4JB2RVM9euQ ($16.65 in chips) 
Seat 2: 0Bg59Tnte1Tc7C4i9Jd9cQ ($5.05 in chips) 
Seat 3: zxeVQGaMKDsDzmSY+AInjA ($12.10 in chips) 
Seat 4: Wo60l2GQnSEc3bxPVyvIUw ($9 in chips) 
Seat 6: AMrBn4Vx9aAo/vv6WHLk6w ($3.50 in chips) 
zxeVQGaMKDsDzmSY+AInjA: posts small blind $0.10
Wo60l2GQnSEc3bxPVyvIUw: posts big blind $0.25
VXTONriS+Ohik+r0FeicIw: sits out 
*** HOLE CARDS ***
AMrBn4Vx9aAo/vv6WHLk6w: folds 
32YL2ZEp8NT4JB2RVM9euQ: folds 
0Bg59Tnte1Tc7C4i9Jd9cQ: raises $0.50 to $0.75
zxeVQGaMKDsDzmSY+AInjA: folds 
Wo60l2GQnSEc3bxPVyvIUw: calls $0.50
*** FLOP *** [Qh 3s Tc]
Wo60l2GQnSEc3bxPVyvIUw: checks 
0Bg59Tnte1Tc7C4i9Jd9cQ is connected 
0Bg59Tnte1Tc7C4i9Jd9cQ: bets $0.75
Wo60l2GQnSEc3bxPVyvIUw: folds 
Uncalled bet ($0.75) returned to 0Bg59Tnte1Tc7C4i9Jd9cQ
0Bg59Tnte1Tc7C4i9Jd9cQ collected $1.55 from pot
*** SUMMARY ***
Total pot $1.60 | Rake $0.05 
Board [Qh 3s Tc]
Seat 1: 32YL2ZEp8NT4JB2RVM9euQ folded before Flop (didn't bet)
Seat 2: 0Bg59Tnte1Tc7C4i9Jd9cQ (button) collected ($1.55)
Seat 3: zxeVQGaMKDsDzmSY+AInjA (small blind) folded before Flop
Seat 4: Wo60l2GQnSEc3bxPVyvIUw (big blind) folded on the Flop
Seat 6: AMrBn4Vx9aAo/vv6WHLk6w folded before Flop (didn't bet)




PokerStars Game #59941921644:  Hold'em No Limit ($0.10/$0.25) - 2009/07/01 1:50:26 ET
Table 'nyTW9cVtYentc5V7xU/0jA' 6-max Seat #5 is the button
Seat 1: HI20pVxSHPZ29u9IDkmICg ($7.15 in chips) 
Seat 3: kG34n23qFQA3nzdOJTQ1dA ($35.50 in chips) 
Seat 4: NkB3D4eVHHXvB9Edaugc1Q ($35.20 in chips) 
Seat 5: zZAcuQ0EvirdEuiIbeaocQ ($6.85 in chips) 
Seat 6: Cwf8Ho8JHNvwzsv9ah8uRQ ($18.90 in chips) 
Cwf8Ho8JHNvwzsv9ah8uRQ: posts small blind $0.10
HI20pVxSHPZ29u9IDkmICg: posts big blind $0.25
glad1kkk: sits out 
*** HOLE CARDS ***
kG34n23qFQA3nzdOJTQ1dA: folds 
NkB3D4eVHHXvB9Edaugc1Q: raises $0.25 to $0.50
zZAcuQ0EvirdEuiIbeaocQ: folds 
Cwf8Ho8JHNvwzsv9ah8uRQ: calls $0.40
HI20pVxSHPZ29u9IDkmICg: folds 
*** FLOP *** [2c Ad 8d]
Cwf8Ho8JHNvwzsv9ah8uRQ: checks 
NkB3D4eVHHXvB9Edaugc1Q: bets $1
Cwf8Ho8JHNvwzsv9ah8uRQ: folds 
Uncalled bet ($1) returned to NkB3D4eVHHXvB9Edaugc1Q
NkB3D4eVHHXvB9Edaugc1Q collected $1.20 from pot
NkB3D4eVHHXvB9Edaugc1Q: doesn't show hand 
*** SUMMARY ***
Total pot $1.25 | Rake $0.05 
Board [2c Ad 8d]
Seat 1: HI20pVxSHPZ29u9IDkmICg (big blind) folded before Flop
Seat 3: kG34n23qFQA3nzdOJTQ1dA folded before Flop (didn't bet)
Seat 4: NkB3D4eVHHXvB9Edaugc1Q collected ($1.20)
Seat 5: zZAcuQ0EvirdEuiIbeaocQ (button) folded before Flop (didn't bet)
Seat 6: Cwf8Ho8JHNvwzsv9ah8uRQ (small blind) folded on the Flop




PokerStars Game #59941921928:  Hold'em No Limit ($0.10/$0.25) - 2009/07/01 1:50:26 ET
Table '2vH5RcmkT0F4XNS/EmmyMA' 6-max Seat #5 is the button
Seat 2: W6Y6au0wf7gRAlqJYgOezw ($11.10 in chips) 
Seat 3: t8P79jKZYh/Wpx2V73pSqg ($24.60 in chips) 
Seat 4: FC6tJ9EOiutXO8hnpR4VgQ ($12.95 in chips) 
Seat 5: Hsvkc0/G2VV78oVmWYXecw ($5 in chips) 
Seat 6: if4dh6jhJXeN3/qd3qCp9g ($25.10 in chips) 
if4dh6jhJXeN3/qd3qCp9g: posts small blind $0.10
W6Y6au0wf7gRAlqJYgOezw: posts big blind $0.25
*** HOLE CARDS ***
t8P79jKZYh/Wpx2V73pSqg: folds 
FC6tJ9EOiutXO8hnpR4VgQ: calls $0.25
Hsvkc0/G2VV78oVmWYXecw: folds 
if4dh6jhJXeN3/qd3qCp9g: calls $0.15
W6Y6au0wf7gRAlqJYgOezw: checks 
*** FLOP *** [Js 4d Qs]
if4dh6jhJXeN3/qd3qCp9g: checks 
W6Y6au0wf7gRAlqJYgOezw: bets $0.50
FC6tJ9EOiutXO8hnpR4VgQ: calls $0.50
if4dh6jhJXeN3/qd3qCp9g: folds 
*** TURN *** [Js 4d Qs] [7s]
Hsvkc0/G2VV78oVmWYXecw leaves the table
W6Y6au0wf7gRAlqJYgOezw: checks 
FC6tJ9EOiutXO8hnpR4VgQ: bets $0.75
JFIAqU8lCZ0vWwEl4bdGsg joins the table at seat #1 
W6Y6au0wf7gRAlqJYgOezw: raises $0.75 to $1.50
FC6tJ9EOiutXO8hnpR4VgQ: calls $0.75
*** RIVER *** [Js 4d Qs 7s] [5c]
minitutu joins the table at seat #5 
W6Y6au0wf7gRAlqJYgOezw: bets $5
FC6tJ9EOiutXO8hnpR4VgQ: folds 
Uncalled bet ($5) returned to W6Y6au0wf7gRAlqJYgOezw
W6Y6au0wf7gRAlqJYgOezw collected $4.55 from pot
*** SUMMARY ***
Total pot $4.75 | Rake $0.20 
Board [Js 4d Qs 7s 5c]
Seat 2: W6Y6au0wf7gRAlqJYgOezw (big blind) collected ($4.55)
Seat 3: t8P79jKZYh/Wpx2V73pSqg folded before Flop (didn't bet)
Seat 4: FC6tJ9EOiutXO8hnpR4VgQ folded on the River
Seat 5: Hsvkc0/G2VV78oVmWYXecw (button) folded before Flop (didn't bet)
Seat 6: if4dh6jhJXeN3/qd3qCp9g (small blind) folded on the Flop




PokerStars Game #59941921726:  Hold'em No Limit ($0.10/$0.25) - 2009/07/01 1:50:26 ET
Table 'BabJGL6tfXQp3leBGbYe8A' 9-max Seat #9 is the button
Seat 1: qwr38jl5txoR36M7G5qi4A ($10.45 in chips) 
Seat 2: dtZ84flFEi4Q+SGrHMJRDQ ($40.50 in chips) 
Seat 3: sD+TKtt36XiiN6jqHiLwDA ($28.80 in chips) 
Seat 4: gehe91e0IyVT0QU/XBkEyg ($27.85 in chips) 
Seat 5: GrNTWMdwy+jC6Lred1eDng ($10 in chips) 
Seat 6: egvg3mTBBVzMHnJPIQiKcA ($13.90 in chips) 
Seat 7: eK8qa6EPcH2zhtbmWSvc9g ($28.20 in chips) 
Seat 8: OXPkK84/qv92EMwXPiG5rQ ($9.25 in chips) 
Seat 9: P+9ymZQ3ktpQu1bn7HIjew ($9.15 in chips) 
qwr38jl5txoR36M7G5qi4A: posts small blind $0.10
dtZ84flFEi4Q+SGrHMJRDQ: posts big blind $0.25
*** HOLE CARDS ***
sD+TKtt36XiiN6jqHiLwDA: folds 
gehe91e0IyVT0QU/XBkEyg: folds 
GrNTWMdwy+jC6Lred1eDng: calls $0.25
egvg3mTBBVzMHnJPIQiKcA: folds 
eK8qa6EPcH2zhtbmWSvc9g: folds 
OXPkK84/qv92EMwXPiG5rQ: folds 
P+9ymZQ3ktpQu1bn7HIjew: folds 
qwr38jl5txoR36M7G5qi4A: folds 
dtZ84flFEi4Q+SGrHMJRDQ: checks 
*** FLOP *** [Th 6s 7c]
dtZ84flFEi4Q+SGrHMJRDQ: checks 
GrNTWMdwy+jC6Lred1eDng: bets $0.25
dtZ84flFEi4Q+SGrHMJRDQ: folds 
Uncalled bet ($0.25) returned to GrNTWMdwy+jC6Lred1eDng
GrNTWMdwy+jC6Lred1eDng collected $0.60 from pot
*** SUMMARY ***
Total pot $0.60 | Rake $0 
Board [Th 6s 7c]
Seat 1: qwr38jl5txoR36M7G5qi4A (small blind) folded before Flop
Seat 2: dtZ84flFEi4Q+SGrHMJRDQ (big blind) folded on the Flop
Seat 3: sD+TKtt36XiiN6jqHiLwDA folded before Flop (didn't bet)
Seat 4: gehe91e0IyVT0QU/XBkEyg folded before Flop (didn't bet)
Seat 5: GrNTWMdwy+jC6Lred1eDng collected ($0.60)
Seat 6: egvg3mTBBVzMHnJPIQiKcA folded before Flop (didn't bet)
Seat 7: eK8qa6EPcH2zhtbmWSvc9g folded before Flop (didn't bet)
Seat 8: OXPkK84/qv92EMwXPiG5rQ folded before Flop (didn't bet)
Seat 9: P+9ymZQ3ktpQu1bn7HIjew (button) folded before Flop (didn't bet)




PokerStars Game #59941921686:  Hold'em No Limit ($0.10/$0.25) - 2009/07/01 1:50:26 ET
Table 'G26g8jde1eR+mmabeFeSlw' 9-max Seat #3 is the button
Seat 1: wnerYvSRWT9Sm4X3ip/c8w ($24.65 in chips) 
Seat 2: BFYwQ0J4xWUQvouudojivA ($15.70 in chips) 
Seat 3: WKL8nUFr7TumC4EjLyqYzw ($5 in chips) 
Seat 4: 8EbrQ/EvFWt2cr0GaU82gQ ($5.50 in chips) 
Seat 5: hJ4uYjNmSZdjrKA8cjZqCA ($34.50 in chips) 
Seat 6: AHGkesF/mi4sDMpqrxBUoA ($8.55 in chips) 
Seat 7: nm4Dj/f+jJEwKVsUnKh73g ($38.55 in chips) 
Seat 8: CvL9Ch1HYCVbTsfpNucitg ($3.50 in chips) 
Seat 9: VWUWpMLMj/Q1jRVpF7Aohw ($13.30 in chips) 
8EbrQ/EvFWt2cr0GaU82gQ: posts small blind $0.10
hJ4uYjNmSZdjrKA8cjZqCA: posts big blind $0.25
*** HOLE CARDS ***
AHGkesF/mi4sDMpqrxBUoA: folds 
nm4Dj/f+jJEwKVsUnKh73g: folds 
CvL9Ch1HYCVbTsfpNucitg: folds 
VWUWpMLMj/Q1jRVpF7Aohw: folds 
wnerYvSRWT9Sm4X3ip/c8w: folds 
BFYwQ0J4xWUQvouudojivA: calls $0.25
WKL8nUFr7TumC4EjLyqYzw: calls $0.25
8EbrQ/EvFWt2cr0GaU82gQ: folds 
hJ4uYjNmSZdjrKA8cjZqCA: checks 
*** FLOP *** [Qh 6c 9s]
hJ4uYjNmSZdjrKA8cjZqCA: checks 
BFYwQ0J4xWUQvouudojivA: checks 
WKL8nUFr7TumC4EjLyqYzw: checks 
*** TURN *** [Qh 6c 9s] [Tc]
hJ4uYjNmSZdjrKA8cjZqCA: bets $0.50
BFYwQ0J4xWUQvouudojivA: folds 
WKL8nUFr7TumC4EjLyqYzw: raises $4.25 to $4.75 and is all-in
hJ4uYjNmSZdjrKA8cjZqCA: calls $4.25
*** RIVER *** [Qh 6c 9s Tc] [Qc]
*** SHOW DOWN ***
hJ4uYjNmSZdjrKA8cjZqCA: shows [Kd Js] (a straight, Nine to King)
WKL8nUFr7TumC4EjLyqYzw: mucks hand 
hJ4uYjNmSZdjrKA8cjZqCA collected $9.85 from pot
*** SUMMARY ***
Total pot $10.35 | Rake $0.50 
Board [Qh 6c 9s Tc Qc]
Seat 1: wnerYvSRWT9Sm4X3ip/c8w folded before Flop (didn't bet)
Seat 2: BFYwQ0J4xWUQvouudojivA folded on the Turn
Seat 3: WKL8nUFr7TumC4EjLyqYzw (button) mucked
Seat 4: 8EbrQ/EvFWt2cr0GaU82gQ (small blind) folded before Flop
Seat 5: hJ4uYjNmSZdjrKA8cjZqCA (big blind) showed [Kd Js] and won ($9.85) with a straight, Nine to King
Seat 6: AHGkesF/mi4sDMpqrxBUoA folded before Flop (didn't bet)
Seat 7: nm4Dj/f+jJEwKVsUnKh73g folded before Flop (didn't bet)
Seat 8: CvL9Ch1HYCVbTsfpNucitg folded before Flop (didn't bet)
Seat 9: VWUWpMLMj/Q1jRVpF7Aohw folded before Flop (didn't bet)




PokerStars Game #59941921684:  Hold'em No Limit ($0.10/$0.25) - 2009/07/01 1:50:26 ET
Table 'IUwZ/e0bDHZPgsIWx0RnNg' 6-max Seat #4 is the button
Seat 1: V66QiVCQPofyl3a+dpPHQQ ($4.70 in chips) 
Seat 2: mvFHK3pE7tCxJEqLjKC70Q ($55.60 in chips) 
Seat 3: dOX4wnYV2sEqvDbF+8KSCw ($25.75 in chips) 
Seat 4: OIjOiBfQstWrK/RuXx7zcw ($4.80 in chips) 
Seat 5: 9bpVv1/Qh9IYtXuCtl5VtQ ($26.05 in chips) 
Seat 6: NhUN/JpAprdJeamFBgJH1w ($38.90 in chips) 
9bpVv1/Qh9IYtXuCtl5VtQ: posts small blind $0.10
NhUN/JpAprdJeamFBgJH1w: posts big blind $0.25
*** HOLE CARDS ***
V66QiVCQPofyl3a+dpPHQQ: folds 
mvFHK3pE7tCxJEqLjKC70Q: folds 
dOX4wnYV2sEqvDbF+8KSCw: raises $0.75 to $1
OIjOiBfQstWrK/RuXx7zcw: calls $1
9bpVv1/Qh9IYtXuCtl5VtQ: folds 
NhUN/JpAprdJeamFBgJH1w: folds 
*** FLOP *** [Ts 3h Qs]
dOX4wnYV2sEqvDbF+8KSCw: bets $1.50
OIjOiBfQstWrK/RuXx7zcw: folds 
Uncalled bet ($1.50) returned to dOX4wnYV2sEqvDbF+8KSCw
dOX4wnYV2sEqvDbF+8KSCw collected $2.25 from pot
dOX4wnYV2sEqvDbF+8KSCw: doesn't show hand 
*** SUMMARY ***
Total pot $2.35 | Rake $0.10 
Board [Ts 3h Qs]
Seat 1: V66QiVCQPofyl3a+dpPHQQ folded before Flop (didn't bet)
Seat 2: mvFHK3pE7tCxJEqLjKC70Q folded before Flop (didn't bet)
Seat 3: dOX4wnYV2sEqvDbF+8KSCw collected ($2.25)
Seat 4: OIjOiBfQstWrK/RuXx7zcw (button) folded on the Flop
Seat 5: 9bpVv1/Qh9IYtXuCtl5VtQ (small blind) folded before Flop
Seat 6: NhUN/JpAprdJeamFBgJH1w (big blind) folded before Flop




PokerStars Game #59941921846:  Hold'em No Limit ($0.10/$0.25) - 2009/07/01 1:50:26 ET
Table 'ZEXL6Wh4qA4Afx8NnoBBAA' 6-max Seat #2 is the button
Seat 1: v8m8XHovI5tqEA9mvplDSw ($26.95 in chips) 
Seat 2: 6DwBRH+xZ12AAZmeAg+aXw ($21.65 in chips) 
Seat 3: +ZlnqPoP3Hg4BIUxDfKd/A ($31.80 in chips) 
Seat 4: FpN4KbLjlyRRKiVaQcoLqA ($29.75 in chips) 
Seat 5: if4dh6jhJXeN3/qd3qCp9g ($38.80 in chips) 
Seat 6: Lh8SlCq3OSDKWLUgAI/Lxw ($1.75 in chips) 
+ZlnqPoP3Hg4BIUxDfKd/A: posts small blind $0.10
FpN4KbLjlyRRKiVaQcoLqA: posts big blind $0.25
*** HOLE CARDS ***
if4dh6jhJXeN3/qd3qCp9g: folds 
Lh8SlCq3OSDKWLUgAI/Lxw: folds 
v8m8XHovI5tqEA9mvplDSw: folds 
6DwBRH+xZ12AAZmeAg+aXw: folds 
+ZlnqPoP3Hg4BIUxDfKd/A: raises $0.75 to $1
FpN4KbLjlyRRKiVaQcoLqA: folds 
Uncalled bet ($0.75) returned to +ZlnqPoP3Hg4BIUxDfKd/A
+ZlnqPoP3Hg4BIUxDfKd/A collected $0.50 from pot
+ZlnqPoP3Hg4BIUxDfKd/A: doesn't show hand 
*** SUMMARY ***
Total pot $0.50 | Rake $0 
Seat 1: v8m8XHovI5tqEA9mvplDSw folded before Flop (didn't bet)
Seat 2: 6DwBRH+xZ12AAZmeAg+aXw (button) folded before Flop (didn't bet)
Seat 3: +ZlnqPoP3Hg4BIUxDfKd/A (small blind) collected ($0.50)
Seat 4: FpN4KbLjlyRRKiVaQcoLqA (big blind) folded before Flop
Seat 5: if4dh6jhJXeN3/qd3qCp9g folded before Flop (didn't bet)
Seat 6: Lh8SlCq3OSDKWLUgAI/Lxw folded before Flop (didn't bet)




PokerStars Game #59941921850:  Hold'em No Limit ($0.10/$0.25) - 2009/07/01 1:50:26 ET
Table 'g6ryG70feTw9nNm+XJLuXw' 6-max Seat #3 is the button
Seat 1: v+QfkGiuj9bgtuNoVnDO8w ($35.10 in chips) 
Seat 2: SxIIgwXYLkwd6m3wLyPTCw ($33.90 in chips) 
Seat 3: cezpHJ8FB07dj0xG+LhOvw ($25 in chips) 
Seat 4: GC/9yVD59DUCX7hUI7gcLw ($44.75 in chips) 
Seat 5: EE16Ua5b1HSsYej5zeXOlA ($25 in chips) 
Seat 6: Mhj3q7cxev+XjXZxEE6/Cw ($25.70 in chips) 
GC/9yVD59DUCX7hUI7gcLw: posts small blind $0.10
EE16Ua5b1HSsYej5zeXOlA: posts big blind $0.25
*** HOLE CARDS ***
Mhj3q7cxev+XjXZxEE6/Cw: folds 
v+QfkGiuj9bgtuNoVnDO8w: folds 
SxIIgwXYLkwd6m3wLyPTCw: folds 
cezpHJ8FB07dj0xG+LhOvw: folds 
GC/9yVD59DUCX7hUI7gcLw: folds 
Uncalled bet ($0.15) returned to EE16Ua5b1HSsYej5zeXOlA
EE16Ua5b1HSsYej5zeXOlA collected $0.20 from pot
EE16Ua5b1HSsYej5zeXOlA: doesn't show hand 
*** SUMMARY ***
Total pot $0.20 | Rake $0 
Seat 1: v+QfkGiuj9bgtuNoVnDO8w folded before Flop (didn't bet)
Seat 2: SxIIgwXYLkwd6m3wLyPTCw folded before Flop (didn't bet)
Seat 3: cezpHJ8FB07dj0xG+LhOvw (button) folded before Flop (didn't bet)
Seat 4: GC/9yVD59DUCX7hUI7gcLw (small blind) folded before Flop
Seat 5: EE16Ua5b1HSsYej5zeXOlA (big blind) collected ($0.20)
Seat 6: Mhj3q7cxev+XjXZxEE6/Cw folded before Flop (didn't bet)




PokerStars Game #59941921662:  Hold'em No Limit ($0.10/$0.25) - 2009/07/01 1:50:26 ET
Table 'YONIZZNvg4uZ4xNUO1deeA' 6-max Seat #6 is the button
Seat 1: GbCVUNssQ7mqsPWr7J4d3w ($4.40 in chips) 
Seat 2: evMMX/0gSDH791KdSAOaSg ($18.80 in chips) 
Seat 3: Eksrep3hySi2jeDHuaWiOQ ($8.75 in chips) 
Seat 4: w43JQj2oYPpKQVG4Yzlq1w ($25 in chips) 
Seat 5: if4dh6jhJXeN3/qd3qCp9g ($24.65 in chips) 
Seat 6: eL3+wCBjFGfQ5FMdIZihwA ($28.15 in chips) 
GbCVUNssQ7mqsPWr7J4d3w: posts small blind $0.10
evMMX/0gSDH791KdSAOaSg: posts big blind $0.25
*** HOLE CARDS ***
Eksrep3hySi2jeDHuaWiOQ: calls $0.25
w43JQj2oYPpKQVG4Yzlq1w: folds 
if4dh6jhJXeN3/qd3qCp9g: folds 
eL3+wCBjFGfQ5FMdIZihwA: raises $0.75 to $1
GbCVUNssQ7mqsPWr7J4d3w: folds 
evMMX/0gSDH791KdSAOaSg: folds 
Eksrep3hySi2jeDHuaWiOQ: folds 
Uncalled bet ($0.75) returned to eL3+wCBjFGfQ5FMdIZihwA
eL3+wCBjFGfQ5FMdIZihwA collected $0.85 from pot
*** SUMMARY ***
Total pot $0.85 | Rake $0 
Seat 1: GbCVUNssQ7mqsPWr7J4d3w (small blind) folded before Flop
Seat 2: evMMX/0gSDH791KdSAOaSg (big blind) folded before Flop
Seat 3: Eksrep3hySi2jeDHuaWiOQ folded before Flop
Seat 4: w43JQj2oYPpKQVG4Yzlq1w folded before Flop (didn't bet)
Seat 5: if4dh6jhJXeN3/qd3qCp9g folded before Flop (didn't bet)
Seat 6: eL3+wCBjFGfQ5FMdIZihwA (button) collected ($0.85)




PokerStars Game #59941921632:  Hold'em No Limit ($0.10/$0.25) - 2009/07/01 1:50:26 ET
Table 'SHi8+hK6i7E2dJ/3Agbyig' 6-max Seat #1 is the button
Seat 1: gPEN9Zp33YTm/mu9/SYP1w ($28.05 in chips) 
Seat 2: LJI7A1YgDM7hgh7o56+ReQ ($25.35 in chips) 
Seat 3: VXTONriS+Ohik+r0FeicIw ($25 in chips) 
Seat 4: u0ikXOhAPSCLmg+l17oGRw ($22.15 in chips) 
Seat 5: v8m8XHovI5tqEA9mvplDSw ($48.95 in chips) 
Seat 6: cWc85bEzdRzpUMhRKm8pwQ ($31.95 in chips) 
LJI7A1YgDM7hgh7o56+ReQ: posts small blind $0.10
VXTONriS+Ohik+r0FeicIw: posts big blind $0.25
*** HOLE CARDS ***
u0ikXOhAPSCLmg+l17oGRw: folds 
v8m8XHovI5tqEA9mvplDSw: folds 
cWc85bEzdRzpUMhRKm8pwQ: folds 
gPEN9Zp33YTm/mu9/SYP1w: folds 
LJI7A1YgDM7hgh7o56+ReQ: folds 
Uncalled bet ($0.15) returned to VXTONriS+Ohik+r0FeicIw
VXTONriS+Ohik+r0FeicIw collected $0.20 from pot
VXTONriS+Ohik+r0FeicIw: doesn't show hand 
*** SUMMARY ***
Total pot $0.20 | Rake $0 
Seat 1: gPEN9Zp33YTm/mu9/SYP1w (button) folded before Flop (didn't bet)
Seat 2: LJI7A1YgDM7hgh7o56+ReQ (small blind) folded before Flop
Seat 3: VXTONriS+Ohik+r0FeicIw (big blind) collected ($0.20)
Seat 4: u0ikXOhAPSCLmg+l17oGRw folded before Flop (didn't bet)
Seat 5: v8m8XHovI5tqEA9mvplDSw folded before Flop (didn't bet)
Seat 6: cWc85bEzdRzpUMhRKm8pwQ folded before Flop (didn't bet)




PokerStars Game #59941921548:  Hold'em No Limit ($0.10/$0.25) - 2009/07/01 1:50:26 ET
Table 'sCop8wmj9zlSS2KJqk1QKQ' 9-max Seat #2 is the button
Seat 1: dtZ84flFEi4Q+SGrHMJRDQ ($39.85 in chips) 
Seat 2: YZaC69gFrepA6oCGtu7E0w ($41.10 in chips) 
Seat 3: M/9j4wkHH9i1JM51vgi1VA ($25.30 in chips) 
Seat 4: msUzkZl2RntUnTl6E8WaNA ($15.65 in chips) 
Seat 5: RHqgdFvufLCYe54+qd2gcA ($8.70 in chips) 
Seat 8: xnVwSkROfRtOw4eSoDANtw ($19.55 in chips) 
Seat 9: tLcDklc2rBORNfixyRfVfw ($25 in chips) 
M/9j4wkHH9i1JM51vgi1VA: posts small blind $0.10
msUzkZl2RntUnTl6E8WaNA: posts big blind $0.25
6RiVTYll/5D8zICp0MRpKw: sits out 
18G4P1XstjNvItdGUITxgw: sits out 
*** HOLE CARDS ***
RHqgdFvufLCYe54+qd2gcA: folds 
xnVwSkROfRtOw4eSoDANtw: folds 
RHqgdFvufLCYe54+qd2gcA leaves the table
tLcDklc2rBORNfixyRfVfw: folds 
dtZ84flFEi4Q+SGrHMJRDQ: folds 
YZaC69gFrepA6oCGtu7E0w: folds 
M/9j4wkHH9i1JM51vgi1VA: calls $0.15
msUzkZl2RntUnTl6E8WaNA: checks 
*** FLOP *** [Td Jd Qh]
M/9j4wkHH9i1JM51vgi1VA: checks 
msUzkZl2RntUnTl6E8WaNA: checks 
*** TURN *** [Td Jd Qh] [4d]
M/9j4wkHH9i1JM51vgi1VA: checks 
msUzkZl2RntUnTl6E8WaNA: checks 
*** RIVER *** [Td Jd Qh 4d] [Jc]
M/9j4wkHH9i1JM51vgi1VA: checks 
msUzkZl2RntUnTl6E8WaNA: checks 
*** SHOW DOWN ***
M/9j4wkHH9i1JM51vgi1VA: shows [9d 9c] (two pair, Jacks and Nines)
msUzkZl2RntUnTl6E8WaNA: mucks hand 
M/9j4wkHH9i1JM51vgi1VA collected $0.50 from pot
*** SUMMARY ***
Total pot $0.50 | Rake $0 
Board [Td Jd Qh 4d Jc]
Seat 1: dtZ84flFEi4Q+SGrHMJRDQ folded before Flop (didn't bet)
Seat 2: YZaC69gFrepA6oCGtu7E0w (button) folded before Flop (didn't bet)
Seat 3: M/9j4wkHH9i1JM51vgi1VA (small blind) showed [9d 9c] and won ($0.50) with two pair, Jacks and Nines
Seat 4: msUzkZl2RntUnTl6E8WaNA (big blind) mucked
Seat 5: RHqgdFvufLCYe54+qd2gcA folded before Flop (didn't bet)
Seat 8: xnVwSkROfRtOw4eSoDANtw folded before Flop (didn't bet)
Seat 9: tLcDklc2rBORNfixyRfVfw folded before Flop (didn't bet)




PokerStars Game #59941921794:  Hold'em No Limit ($0.10/$0.25) - 2009/07/01 1:50:26 ET
Table 'aT31tt16YvQM/Ue69HPLpA' 9-max Seat #5 is the button
Seat 1: wxmepRUXfX1jdQfUD5uENQ ($5 in chips) 
Seat 2: PdIasPkzm2sqZnN41ZRXOg ($4.65 in chips) 
Seat 3: swK30YlQuxRQO7QFr4ZxCA ($25.35 in chips) 
Seat 4: wGigCmBR/9XWkPpvYos3aQ ($26.25 in chips) 
Seat 5: s2xLPOl/vhl/26apJ3vsOQ ($33.55 in chips) 
Seat 6: ghG12/paEL5VoDN85sW6RA ($14.75 in chips) 
Seat 9: TvIuLx9zUCE+9Li58iImOQ ($13.95 in chips) 
ghG12/paEL5VoDN85sW6RA: posts small blind $0.10
W8cIfrCR+zA8pCNyIuHu8g: is sitting out 
W6tExOcYX7qiy6Qdp+ZwFA: is sitting out 
TvIuLx9zUCE+9Li58iImOQ: posts big blind $0.25
wxmepRUXfX1jdQfUD5uENQ: posts big blind $0.25
*** HOLE CARDS ***
W6tExOcYX7qiy6Qdp+ZwFA leaves the table
wxmepRUXfX1jdQfUD5uENQ: checks 
W8cIfrCR+zA8pCNyIuHu8g leaves the table
PdIasPkzm2sqZnN41ZRXOg: folds 
swK30YlQuxRQO7QFr4ZxCA: folds 
wGigCmBR/9XWkPpvYos3aQ: raises $1 to $1.25
s2xLPOl/vhl/26apJ3vsOQ: folds 
ghG12/paEL5VoDN85sW6RA: folds 
TvIuLx9zUCE+9Li58iImOQ: folds 
wxmepRUXfX1jdQfUD5uENQ: folds 
Uncalled bet ($1) returned to wGigCmBR/9XWkPpvYos3aQ
wGigCmBR/9XWkPpvYos3aQ collected $0.85 from pot
wGigCmBR/9XWkPpvYos3aQ: doesn't show hand 
*** SUMMARY ***
Total pot $0.85 | Rake $0 
Seat 1: wxmepRUXfX1jdQfUD5uENQ folded before Flop
Seat 2: PdIasPkzm2sqZnN41ZRXOg folded before Flop (didn't bet)
Seat 3: swK30YlQuxRQO7QFr4ZxCA folded before Flop (didn't bet)
Seat 4: wGigCmBR/9XWkPpvYos3aQ collected ($0.85)
Seat 5: s2xLPOl/vhl/26apJ3vsOQ (button) folded before Flop (didn't bet)
Seat 6: ghG12/paEL5VoDN85sW6RA (small blind) folded before Flop
Seat 9: TvIuLx9zUCE+9Li58iImOQ (big blind) folded before Flop




PokerStars Game #59941921962:  Hold'em No Limit ($0.10/$0.25) - 2009/07/01 1:50:27 ET
Table 'wPWRBZPJl1HAnysw7qRR0A' 6-max Seat #2 is the button
Seat 1: m7ne1MOFTQXlsXT7/R/rug ($12.15 in chips) 
Seat 2: xC0kaiDYM6YTlgODL83O5A ($22.65 in chips) 
Seat 3: 1ZpoLWO2nm2w1Nd1v9Sr3g ($6.95 in chips) 
Seat 4: epAUIB7h2FJXzUPRIvSkRA ($49.20 in chips) 
Seat 5: y0B+UpYpOUJz3JWtlJQBSA ($15.40 in chips) 
Seat 6: VXTONriS+Ohik+r0FeicIw ($25.60 in chips) 
1ZpoLWO2nm2w1Nd1v9Sr3g: posts small blind $0.10
epAUIB7h2FJXzUPRIvSkRA: posts big blind $0.25
*** HOLE CARDS ***
y0B+UpYpOUJz3JWtlJQBSA: folds 
VXTONriS+Ohik+r0FeicIw: raises $0.75 to $1
m7ne1MOFTQXlsXT7/R/rug: folds 
xC0kaiDYM6YTlgODL83O5A: folds 
1ZpoLWO2nm2w1Nd1v9Sr3g: folds 
epAUIB7h2FJXzUPRIvSkRA: folds 
Uncalled bet ($0.75) returned to VXTONriS+Ohik+r0FeicIw
VXTONriS+Ohik+r0FeicIw collected $0.60 from pot
VXTONriS+Ohik+r0FeicIw: doesn't show hand 
*** SUMMARY ***
Total pot $0.60 | Rake $0 
Seat 1: m7ne1MOFTQXlsXT7/R/rug folded before Flop (didn't bet)
Seat 2: xC0kaiDYM6YTlgODL83O5A (button) folded before Flop (didn't bet)
Seat 3: 1ZpoLWO2nm2w1Nd1v9Sr3g (small blind) folded before Flop
Seat 4: epAUIB7h2FJXzUPRIvSkRA (big blind) folded before Flop
Seat 5: y0B+UpYpOUJz3JWtlJQBSA folded before Flop (didn't bet)
Seat 6: VXTONriS+Ohik+r0FeicIw collected ($0.60)




PokerStars Game #59941922234:  Hold'em No Limit ($0.10/$0.25) - 2009/07/01 1:50:27 ET
Table '50f2Xa1b1jp6cfdTAgXFIg' 9-max Seat #4 is the button
Seat 1: E0iYnEVO2ho7dH3QcCjw7g ($19.65 in chips) 
Seat 3: RSojRXQHk0IRANbJYopT9g ($24.45 in chips) 
Seat 4: ghNKXUBl/H+t83JF079ZBA ($27 in chips) 
Seat 5: C1w4aCCgQVVSgNijoEahAg ($15.25 in chips) 
Seat 6: tLcDklc2rBORNfixyRfVfw ($27.50 in chips) 
Seat 7: w1ukf8uPa4+WH561TtVRxA ($25 in chips) 
Seat 8: x+W5+3qsdY4Iszf0hoH+Aw ($13.80 in chips) 
Seat 9: gehe91e0IyVT0QU/XBkEyg ($25.75 in chips) 
C1w4aCCgQVVSgNijoEahAg: posts small blind $0.10
tLcDklc2rBORNfixyRfVfw: posts big blind $0.25
*** HOLE CARDS ***
w1ukf8uPa4+WH561TtVRxA: folds 
x+W5+3qsdY4Iszf0hoH+Aw: folds 
gehe91e0IyVT0QU/XBkEyg: folds 
E0iYnEVO2ho7dH3QcCjw7g: folds 
RSojRXQHk0IRANbJYopT9g has timed out
RSojRXQHk0IRANbJYopT9g: folds 
RSojRXQHk0IRANbJYopT9g is sitting out
RSojRXQHk0IRANbJYopT9g has returned
ghNKXUBl/H+t83JF079ZBA: folds 
C1w4aCCgQVVSgNijoEahAg: calls $0.15
tLcDklc2rBORNfixyRfVfw: checks 
*** FLOP *** [2d 9d 4d]
C1w4aCCgQVVSgNijoEahAg: bets $0.25
tLcDklc2rBORNfixyRfVfw: folds 
Uncalled bet ($0.25) returned to C1w4aCCgQVVSgNijoEahAg
C1w4aCCgQVVSgNijoEahAg collected $0.50 from pot
*** SUMMARY ***
Total pot $0.50 | Rake $0 
Board [2d 9d 4d]
Seat 1: E0iYnEVO2ho7dH3QcCjw7g folded before Flop (didn't bet)
Seat 3: RSojRXQHk0IRANbJYopT9g folded before Flop (didn't bet)
Seat 4: ghNKXUBl/H+t83JF079ZBA (button) folded before Flop (didn't bet)
Seat 5: C1w4aCCgQVVSgNijoEahAg (small blind) collected ($0.50)
Seat 6: tLcDklc2rBORNfixyRfVfw (big blind) folded on the Flop
Seat 7: w1ukf8uPa4+WH561TtVRxA folded before Flop (didn't bet)
Seat 8: x+W5+3qsdY4Iszf0hoH+Aw folded before Flop (didn't bet)
Seat 9: gehe91e0IyVT0QU/XBkEyg folded before Flop (didn't bet)




PokerStars Game #59941922272:  Hold'em No Limit ($0.10/$0.25) - 2009/07/01 1:50:27 ET
Table 'xro+BVoe2Zuw1TYmz/McJQ' 9-max Seat #8 is the button
Seat 3: xUw+6BIJCkgxBKESwlj9Hg ($3.75 in chips) 
Seat 4: N2LVj3iImgnOoHVf8g0rIw ($43.05 in chips) 
Seat 5: H7ijH+qgNcEQW9eBvivIYg ($15.35 in chips) 
Seat 6: HPEB+AtKw1+C/cxU0o1ciw ($26.15 in chips) 
Seat 8: ljemhp25Zg+nlA9DLCIiUw ($24.65 in chips) 
xUw+6BIJCkgxBKESwlj9Hg: posts small blind $0.10
idahocowboy6 joins the table at seat #9 
N2LVj3iImgnOoHVf8g0rIw: posts big blind $0.25
*** HOLE CARDS ***
H7ijH+qgNcEQW9eBvivIYg: folds 
HPEB+AtKw1+C/cxU0o1ciw: raises $1 to $1.25
ljemhp25Zg+nlA9DLCIiUw: folds 
xUw+6BIJCkgxBKESwlj9Hg: folds 
N2LVj3iImgnOoHVf8g0rIw: calls $1
*** FLOP *** [Qs Kc Jd]
N2LVj3iImgnOoHVf8g0rIw: checks 
HPEB+AtKw1+C/cxU0o1ciw: bets $1.25
N2LVj3iImgnOoHVf8g0rIw: raises $1.25 to $2.50
HPEB+AtKw1+C/cxU0o1ciw: calls $1.25
*** TURN *** [Qs Kc Jd] [Qc]
N2LVj3iImgnOoHVf8g0rIw: bets $2
HPEB+AtKw1+C/cxU0o1ciw: calls $2
*** RIVER *** [Qs Kc Jd Qc] [As]
N2LVj3iImgnOoHVf8g0rIw: bets $5.25
HPEB+AtKw1+C/cxU0o1ciw: calls $5.25
*** SHOW DOWN ***
N2LVj3iImgnOoHVf8g0rIw: shows [Qd Js] (a full house, Queens full of Jacks)
HPEB+AtKw1+C/cxU0o1ciw: shows [Ad Ks] (two pair, Aces and Kings)
N2LVj3iImgnOoHVf8g0rIw collected $21.05 from pot
*** SUMMARY ***
Total pot $22.10 | Rake $1.05 
Board [Qs Kc Jd Qc As]
Seat 3: xUw+6BIJCkgxBKESwlj9Hg (small blind) folded before Flop
Seat 4: N2LVj3iImgnOoHVf8g0rIw (big blind) showed [Qd Js] and won ($21.05) with a full house, Queens full of Jacks
Seat 5: H7ijH+qgNcEQW9eBvivIYg folded before Flop (didn't bet)
Seat 6: HPEB+AtKw1+C/cxU0o1ciw showed [Ad Ks] and lost with two pair, Aces and Kings
Seat 8: ljemhp25Zg+nlA9DLCIiUw (button) folded before Flop (didn't bet)




PokerStars Game #59941922792:  Hold'em No Limit ($0.10/$0.25) - 2009/07/01 1:50:28 ET
Table '9o8Yb3JpUqurD4pNVmOikQ' 6-max Seat #3 is the button
Seat 1: SFmT9ZsVopnukjvAzrxTRg ($28.05 in chips) 
Seat 2: /gJNBeCkWL4o85/jvlZ4BA ($26.50 in chips) 
Seat 3: JgRqo1/2phbf7pab7N3BIQ ($22.75 in chips) 
Seat 5: QqiZLFrN8iOUT/GHw7ztOA ($24.05 in chips) 
Seat 6: LyDHtw3/yniNHW+DvLXbog ($25.35 in chips) 
AyreonChen will be allowed to play after the button
QqiZLFrN8iOUT/GHw7ztOA: posts small blind $0.10
LyDHtw3/yniNHW+DvLXbog: posts big blind $0.25
*** HOLE CARDS ***
SFmT9ZsVopnukjvAzrxTRg: raises $0.75 to $1
/gJNBeCkWL4o85/jvlZ4BA: folds 
JgRqo1/2phbf7pab7N3BIQ: calls $1
QqiZLFrN8iOUT/GHw7ztOA: folds 
LyDHtw3/yniNHW+DvLXbog: calls $0.75
*** FLOP *** [Qd Qh 2h]
LyDHtw3/yniNHW+DvLXbog: checks 
SFmT9ZsVopnukjvAzrxTRg: bets $1.75
JgRqo1/2phbf7pab7N3BIQ: folds 
LyDHtw3/yniNHW+DvLXbog: calls $1.75
*** TURN *** [Qd Qh 2h] [2d]
LyDHtw3/yniNHW+DvLXbog: checks 
SFmT9ZsVopnukjvAzrxTRg: checks 
*** RIVER *** [Qd Qh 2h 2d] [Ts]
LyDHtw3/yniNHW+DvLXbog: bets $5
SFmT9ZsVopnukjvAzrxTRg: folds 
Uncalled bet ($5) returned to LyDHtw3/yniNHW+DvLXbog
LyDHtw3/yniNHW+DvLXbog collected $6.30 from pot
LyDHtw3/yniNHW+DvLXbog: doesn't show hand 
*** SUMMARY ***
Total pot $6.60 | Rake $0.30 
Board [Qd Qh 2h 2d Ts]
Seat 1: SFmT9ZsVopnukjvAzrxTRg folded on the River
Seat 2: /gJNBeCkWL4o85/jvlZ4BA folded before Flop (didn't bet)
Seat 3: JgRqo1/2phbf7pab7N3BIQ (button) folded on the Flop
Seat 5: QqiZLFrN8iOUT/GHw7ztOA (small blind) folded before Flop
Seat 6: LyDHtw3/yniNHW+DvLXbog (big blind) collected ($6.30)




PokerStars Game #59941922780:  Hold'em No Limit ($0.10/$0.25) - 2009/07/01 1:50:28 ET
Table '6wawJ+MkkvuC3coG6r+Yhg' 6-max Seat #1 is the button
Seat 1: JQZew0FjzS19kTjeNtrE+A ($15.60 in chips) 
Seat 2: LtASJ9OlkqGrrUKGQlpGAw ($36.45 in chips) 
Seat 3: 3zD3qLXT1bEffAoWGnc7wg ($59.75 in chips) 
Seat 6: B3X187C0tXFUfQpCu8pe8A ($24.80 in chips) 
LtASJ9OlkqGrrUKGQlpGAw: posts small blind $0.10
3zD3qLXT1bEffAoWGnc7wg: posts big blind $0.25
9U3ZKjCsarN0DjR6mSE8Ug: sits out 
GbCVUNssQ7mqsPWr7J4d3w: sits out 
*** HOLE CARDS ***
B3X187C0tXFUfQpCu8pe8A: calls $0.25
JQZew0FjzS19kTjeNtrE+A: calls $0.25
LtASJ9OlkqGrrUKGQlpGAw: calls $0.15
3zD3qLXT1bEffAoWGnc7wg: checks 
*** FLOP *** [Qc 4h 6c]
LtASJ9OlkqGrrUKGQlpGAw: checks 
3zD3qLXT1bEffAoWGnc7wg: checks 
B3X187C0tXFUfQpCu8pe8A: checks 
JQZew0FjzS19kTjeNtrE+A: bets $0.75
LtASJ9OlkqGrrUKGQlpGAw: raises $2 to $2.75
3zD3qLXT1bEffAoWGnc7wg: folds 
B3X187C0tXFUfQpCu8pe8A: folds 
JQZew0FjzS19kTjeNtrE+A: raises $12.60 to $15.35 and is all-in
LtASJ9OlkqGrrUKGQlpGAw: calls $12.60
*** TURN *** [Qc 4h 6c] [5s]
*** RIVER *** [Qc 4h 6c 5s] [6s]
*** SHOW DOWN ***
LtASJ9OlkqGrrUKGQlpGAw: shows [Kc 4c] (two pair, Sixes and Fours)
JQZew0FjzS19kTjeNtrE+A: shows [Jc 5c] (two pair, Sixes and Fives)
JQZew0FjzS19kTjeNtrE+A collected $30.15 from pot
*** SUMMARY ***
Total pot $31.70 | Rake $1.55 
Board [Qc 4h 6c 5s 6s]
Seat 1: JQZew0FjzS19kTjeNtrE+A (button) showed [Jc 5c] and won ($30.15) with two pair, Sixes and Fives
Seat 2: LtASJ9OlkqGrrUKGQlpGAw (small blind) showed [Kc 4c] and lost with two pair, Sixes and Fours
Seat 3: 3zD3qLXT1bEffAoWGnc7wg (big blind) folded on the Flop
Seat 6: B3X187C0tXFUfQpCu8pe8A folded on the Flop




PokerStars Game #59941922926:  Hold'em No Limit ($0.10/$0.25) - 2009/07/01 1:50:28 ET
Table '+UzantPJ4smVdrh+4GTu1w' 6-max Seat #4 is the button
Seat 1: TSmua8tGK3sTbwi0ynrW9Q ($39.50 in chips) 
Seat 2: tcbEu7VzyHQ+0lh+skbQhQ ($31.50 in chips) 
Seat 3: SS/yfeArhULzIcOPe8MdPg ($31.85 in chips) 
Seat 4: UmcUp27+PbgBItv3ZNlAWQ ($26.45 in chips) 
Seat 5: cj4VBQya7HtVL2zCGd5jLQ ($55.45 in chips) 
Seat 6: fZQg9veL7Dd/Z04ZTjC+wQ ($25 in chips) 
cj4VBQya7HtVL2zCGd5jLQ: posts small blind $0.10
fZQg9veL7Dd/Z04ZTjC+wQ: posts big blind $0.25
*** HOLE CARDS ***
TSmua8tGK3sTbwi0ynrW9Q: folds 
tcbEu7VzyHQ+0lh+skbQhQ: raises $0.25 to $0.50
SS/yfeArhULzIcOPe8MdPg: calls $0.50
UmcUp27+PbgBItv3ZNlAWQ: folds 
cj4VBQya7HtVL2zCGd5jLQ: folds 
fZQg9veL7Dd/Z04ZTjC+wQ: folds 
*** FLOP *** [7c As 2c]
tcbEu7VzyHQ+0lh+skbQhQ said, "tough lay down"
tcbEu7VzyHQ+0lh+skbQhQ: checks 
SS/yfeArhULzIcOPe8MdPg: checks 
*** TURN *** [7c As 2c] [Th]
tcbEu7VzyHQ+0lh+skbQhQ: checks 
SS/yfeArhULzIcOPe8MdPg: checks 
*** RIVER *** [7c As 2c Th] [4d]
tcbEu7VzyHQ+0lh+skbQhQ: checks 
SS/yfeArhULzIcOPe8MdPg: bets $0.75
tcbEu7VzyHQ+0lh+skbQhQ: folds 
Uncalled bet ($0.75) returned to SS/yfeArhULzIcOPe8MdPg
SS/yfeArhULzIcOPe8MdPg collected $1.30 from pot
*** SUMMARY ***
Total pot $1.35 | Rake $0.05 
Board [7c As 2c Th 4d]
Seat 1: TSmua8tGK3sTbwi0ynrW9Q folded before Flop (didn't bet)
Seat 2: tcbEu7VzyHQ+0lh+skbQhQ folded on the River
Seat 3: SS/yfeArhULzIcOPe8MdPg collected ($1.30)
Seat 4: UmcUp27+PbgBItv3ZNlAWQ (button) folded before Flop (didn't bet)
Seat 5: cj4VBQya7HtVL2zCGd5jLQ (small blind) folded before Flop
Seat 6: fZQg9veL7Dd/Z04ZTjC+wQ (big blind) folded before Flop




PokerStars Game #59941923022:  Hold'em No Limit ($0.10/$0.25) - 2009/07/01 1:50:29 ET
Table 'rjcb+nlE+0GuJ6lBhuCkkA' 6-max Seat #3 is the button
Seat 1: lBoEwOFgzcERLIRUkUoRTw ($12.90 in chips) 
Seat 2: lJphax9e7/+O/3YCKPJ0yQ ($6.80 in chips) 
Seat 3: 8ClCHtFXGNplITm+63KB+Q ($65.85 in chips) 
Seat 4: BV+K0Phf5VBHr7aZPKqbUQ ($35.25 in chips) 
Seat 5: GC/9yVD59DUCX7hUI7gcLw ($30.50 in chips) 
Seat 6: 32YL2ZEp8NT4JB2RVM9euQ ($15.70 in chips) 
BV+K0Phf5VBHr7aZPKqbUQ: posts small blind $0.10
GC/9yVD59DUCX7hUI7gcLw: posts big blind $0.25
*** HOLE CARDS ***
32YL2ZEp8NT4JB2RVM9euQ: raises $0.75 to $1
lBoEwOFgzcERLIRUkUoRTw: folds 
lJphax9e7/+O/3YCKPJ0yQ: folds 
8ClCHtFXGNplITm+63KB+Q: folds 
BV+K0Phf5VBHr7aZPKqbUQ: folds 
GC/9yVD59DUCX7hUI7gcLw: folds 
Uncalled bet ($0.75) returned to 32YL2ZEp8NT4JB2RVM9euQ
32YL2ZEp8NT4JB2RVM9euQ collected $0.60 from pot
32YL2ZEp8NT4JB2RVM9euQ: doesn't show hand 
*** SUMMARY ***
Total pot $0.60 | Rake $0 
Seat 1: lBoEwOFgzcERLIRUkUoRTw folded before Flop (didn't bet)
Seat 2: lJphax9e7/+O/3YCKPJ0yQ folded before Flop (didn't bet)
Seat 3: 8ClCHtFXGNplITm+63KB+Q (button) folded before Flop (didn't bet)
Seat 4: BV+K0Phf5VBHr7aZPKqbUQ (small blind) folded before Flop
Seat 5: GC/9yVD59DUCX7hUI7gcLw (big blind) folded before Flop
Seat 6: 32YL2ZEp8NT4JB2RVM9euQ collected ($0.60)




PokerStars Game #59941923170:  Hold'em No Limit ($0.10/$0.25) - 2009/07/01 1:50:29 ET
Table '/JJyyIstHfkT7t/bW+WXgg' 6-max Seat #1 is the button
Seat 1: xC0kaiDYM6YTlgODL83O5A ($14.50 in chips) 
Seat 2: obJgSnVgWWWaAUtVILo77Q ($27.95 in chips) 
Seat 3: DR0nVIhVP77oEBlO9J8vlg ($26.10 in chips) 
Seat 4: JFIAqU8lCZ0vWwEl4bdGsg ($36.40 in chips) 
Seat 5: +ZlnqPoP3Hg4BIUxDfKd/A ($45.70 in chips) 
Seat 6: UmcUp27+PbgBItv3ZNlAWQ ($25.15 in chips) 
obJgSnVgWWWaAUtVILo77Q: posts small blind $0.10
DR0nVIhVP77oEBlO9J8vlg: posts big blind $0.25
*** HOLE CARDS ***
JFIAqU8lCZ0vWwEl4bdGsg: folds 
+ZlnqPoP3Hg4BIUxDfKd/A: folds 
UmcUp27+PbgBItv3ZNlAWQ: folds 
xC0kaiDYM6YTlgODL83O5A: folds 
obJgSnVgWWWaAUtVILo77Q: calls $0.15
DR0nVIhVP77oEBlO9J8vlg: checks 
*** FLOP *** [Ks Ac 6h]
obJgSnVgWWWaAUtVILo77Q: checks 
DR0nVIhVP77oEBlO9J8vlg: checks 
*** TURN *** [Ks Ac 6h] [Kc]
obJgSnVgWWWaAUtVILo77Q: checks 
DR0nVIhVP77oEBlO9J8vlg: checks 
*** RIVER *** [Ks Ac 6h Kc] [Kd]
obJgSnVgWWWaAUtVILo77Q: checks 
DR0nVIhVP77oEBlO9J8vlg: checks 
*** SHOW DOWN ***
obJgSnVgWWWaAUtVILo77Q: shows [2s Qc] (three of a kind, Kings)
DR0nVIhVP77oEBlO9J8vlg: mucks hand 
obJgSnVgWWWaAUtVILo77Q collected $0.50 from pot
*** SUMMARY ***
Total pot $0.50 | Rake $0 
Board [Ks Ac 6h Kc Kd]
Seat 1: xC0kaiDYM6YTlgODL83O5A (button) folded before Flop (didn't bet)
Seat 2: obJgSnVgWWWaAUtVILo77Q (small blind) showed [2s Qc] and won ($0.50) with three of a kind, Kings
Seat 3: DR0nVIhVP77oEBlO9J8vlg (big blind) mucked
Seat 4: JFIAqU8lCZ0vWwEl4bdGsg folded before Flop (didn't bet)
Seat 5: +ZlnqPoP3Hg4BIUxDfKd/A folded before Flop (didn't bet)
Seat 6: UmcUp27+PbgBItv3ZNlAWQ folded before Flop (didn't bet)




PokerStars Game #59941923304:  Hold'em No Limit ($0.10/$0.25) - 2009/07/01 1:50:29 ET
Table 'rhQuIjJo0UQ7RRUlF9umHg' 6-max Seat #6 is the button
Seat 1: 5O3Hj9Qg0SqOyKEXoLpjPg ($177.15 in chips) 
Seat 2: Ew/TYPQIsbQ2X8nm5iAJBg ($26.70 in chips) 
Seat 3: if4dh6jhJXeN3/qd3qCp9g ($27.05 in chips) 
Seat 5: dOX4wnYV2sEqvDbF+8KSCw ($67.55 in chips) 
Seat 6: /gJNBeCkWL4o85/jvlZ4BA ($48.70 in chips) 
5O3Hj9Qg0SqOyKEXoLpjPg: posts small blind $0.10
Ew/TYPQIsbQ2X8nm5iAJBg: posts big blind $0.25
aogAb4Eienxztk8p2v9VVw: sits out 
*** HOLE CARDS ***
if4dh6jhJXeN3/qd3qCp9g: folds 
dOX4wnYV2sEqvDbF+8KSCw: raises $0.75 to $1
/gJNBeCkWL4o85/jvlZ4BA: calls $1
5O3Hj9Qg0SqOyKEXoLpjPg: calls $0.90
Ew/TYPQIsbQ2X8nm5iAJBg: calls $0.75
*** FLOP *** [Jc 3s 2d]
5O3Hj9Qg0SqOyKEXoLpjPg: bets $2
Ew/TYPQIsbQ2X8nm5iAJBg: folds 
dOX4wnYV2sEqvDbF+8KSCw: folds 
/gJNBeCkWL4o85/jvlZ4BA: folds 
Uncalled bet ($2) returned to 5O3Hj9Qg0SqOyKEXoLpjPg
5O3Hj9Qg0SqOyKEXoLpjPg collected $3.80 from pot
5O3Hj9Qg0SqOyKEXoLpjPg: doesn't show hand 
*** SUMMARY ***
Total pot $4 | Rake $0.20 
Board [Jc 3s 2d]
Seat 1: 5O3Hj9Qg0SqOyKEXoLpjPg (small blind) collected ($3.80)
Seat 2: Ew/TYPQIsbQ2X8nm5iAJBg (big blind) folded on the Flop
Seat 3: if4dh6jhJXeN3/qd3qCp9g folded before Flop (didn't bet)
Seat 5: dOX4wnYV2sEqvDbF+8KSCw folded on the Flop
Seat 6: /gJNBeCkWL4o85/jvlZ4BA (button) folded on the Flop




PokerStars Game #59941923112:  Hold'em No Limit ($0.10/$0.25) - 2009/07/01 1:50:29 ET
Table '+VTTYgQLH1awDHk+IAxqGg' 9-max Seat #9 is the button
Seat 1: arxNSjreDRGFg13EAM2F1w ($26.65 in chips) 
Seat 2: 2wcFsZsqEP5w1StUTVzJCg ($6.90 in chips) 
Seat 3: AiXn/9o1EwOPZUHujnh/bA ($11.40 in chips) 
Seat 4: gE5rN2TDY1aXcZn/TOPeZw ($8.90 in chips) 
Seat 5: sD+TKtt36XiiN6jqHiLwDA ($24.80 in chips) 
Seat 6: clJsV3v77RS07bDKY+705w ($6.05 in chips) 
Seat 7: ljemhp25Zg+nlA9DLCIiUw ($23.65 in chips) 
Seat 8: 10vzP4r6ldwGLbYHKd9www ($18.65 in chips) 
Seat 9: S7Ki0P+0AIGPuIfGJjW0gg ($61.15 in chips) 
arxNSjreDRGFg13EAM2F1w: posts small blind $0.10
2wcFsZsqEP5w1StUTVzJCg: posts big blind $0.25
*** HOLE CARDS ***
AiXn/9o1EwOPZUHujnh/bA: folds 
gE5rN2TDY1aXcZn/TOPeZw: folds 
sD+TKtt36XiiN6jqHiLwDA: folds 
clJsV3v77RS07bDKY+705w: folds 
ljemhp25Zg+nlA9DLCIiUw: raises $0.50 to $0.75
10vzP4r6ldwGLbYHKd9www: folds 
S7Ki0P+0AIGPuIfGJjW0gg: folds 
arxNSjreDRGFg13EAM2F1w: folds 
2wcFsZsqEP5w1StUTVzJCg: calls $0.50
*** FLOP *** [Js 2h 4h]
2wcFsZsqEP5w1StUTVzJCg: checks 
ljemhp25Zg+nlA9DLCIiUw: bets $1.25
2wcFsZsqEP5w1StUTVzJCg: folds 
Uncalled bet ($1.25) returned to ljemhp25Zg+nlA9DLCIiUw
ljemhp25Zg+nlA9DLCIiUw collected $1.55 from pot
ljemhp25Zg+nlA9DLCIiUw: doesn't show hand 
*** SUMMARY ***
Total pot $1.60 | Rake $0.05 
Board [Js 2h 4h]
Seat 1: arxNSjreDRGFg13EAM2F1w (small blind) folded before Flop
Seat 2: 2wcFsZsqEP5w1StUTVzJCg (big blind) folded on the Flop
Seat 3: AiXn/9o1EwOPZUHujnh/bA folded before Flop (didn't bet)
Seat 4: gE5rN2TDY1aXcZn/TOPeZw folded before Flop (didn't bet)
Seat 5: sD+TKtt36XiiN6jqHiLwDA folded before Flop (didn't bet)
Seat 6: clJsV3v77RS07bDKY+705w folded before Flop (didn't bet)
Seat 7: ljemhp25Zg+nlA9DLCIiUw collected ($1.55)
Seat 8: 10vzP4r6ldwGLbYHKd9www folded before Flop (didn't bet)
Seat 9: S7Ki0P+0AIGPuIfGJjW0gg (button) folded before Flop (didn't bet)




PokerStars Game #59941923894:  Hold'em No Limit ($0.10/$0.25) - 2009/07/01 1:50:30 ET
Table 'LwnjzXstPtSrqrV/oDpnXQ' 9-max Seat #1 is the button
Seat 1: 9YN2IkT2JYYKFErZtZvCtA ($21.55 in chips) 
Seat 2: uLP/lYn7oKq9xCChBXsXxw ($26.40 in chips) 
Seat 3: 7je+LC5Mfs6nL8YBVh4frQ ($3.80 in chips) 
Seat 4: CmngQmkKTp8tkl6GMRTl6w ($8.75 in chips) 
Seat 5: Th3FldXKQW6hWVVPahaoOQ ($26.25 in chips) 
Seat 6: ljemhp25Zg+nlA9DLCIiUw ($39.50 in chips) 
Seat 7: c/Dw/6HyqldTzIRodAIZmg ($13.40 in chips) 
Seat 8: ShXPHWfjhfmAwLgDdm6bRQ ($11.30 in chips) 
Seat 9: q6WfTUAD9mowIP63ASq2Dgz/khFDKGihQjwgoiKKPOeg15 in chips) 
uLP/lYn7oKq9xCChBXsXxw: posts small blind $0.10
7je+LC5Mfs6nL8YBVh4frQ: posts big blind $0.25
*** HOLE CARDS ***
CmngQmkKTp8tkl6GMRTl6w: folds 
Th3FldXKQW6hWVVPahaoOQ: folds 
ljemhp25Zg+nlA9DLCIiUw: calls $0.25
c/Dw/6HyqldTzIRodAIZmg: folds 
ShXPHWfjhfmAwLgDdm6bRQ: folds 
q6WfTUAD9mowIP63ASq2Dgz/khFDKGihQjwgoiKKPOegs 
9YN2IkT2JYYKFErZtZvCtA: folds 
uLP/lYn7oKq9xCChBXsXxw: calls $0.15
7je+LC5Mfs6nL8YBVh4frQ: checks 
*** FLOP *** [Td 2h 3h]
uLP/lYn7oKq9xCChBXsXxw: checks 
7je+LC5Mfs6nL8YBVh4frQ: checks 
ljemhp25Zg+nlA9DLCIiUw: bets $0.60
uLP/lYn7oKq9xCChBXsXxw: folds 
7je+LC5Mfs6nL8YBVh4frQ: folds 
Uncalled bet ($0.60) returned to ljemhp25Zg+nlA9DLCIiUw
ljemhp25Zg+nlA9DLCIiUw collected $0.75 from pot
ljemhp25Zg+nlA9DLCIiUw: doesn't show hand 
*** SUMMARY ***
Total pot $0.75 | Rake $0 
Board [Td 2h 3h]
Seat 1: 9YN2IkT2JYYKFErZtZvCtA (button) folded before Flop (didn't bet)
Seat 2: uLP/lYn7oKq9xCChBXsXxw (small blind) folded on the Flop
Seat 3: 7je+LC5Mfs6nL8YBVh4frQ (big blind) folded on the Flop
Seat 4: CmngQmkKTp8tkl6GMRTl6w folded before Flop (didn't bet)
Seat 5: Th3FldXKQW6hWVVPahaoOQ folded before Flop (didn't bet)
Seat 6: ljemhp25Zg+nlA9DLCIiUw collected ($0.75)
Seat 7: c/Dw/6HyqldTzIRodAIZmg folded before Flop (didn't bet)
Seat 8: ShXPHWfjhfmAwLgDdm6bRQ folded before Flop (didn't bet)
Seat 9: q6WfTUAD9mowIP63ASq2Dgz/khFDKGihQjwgoiKKPOegd before Flop (didn't bet)




PokerStars Game #59941923690:  Hold'em No Limit ($0.10/$0.25) - 2009/07/01 1:50:30 ET
Table 'JUMeG5SzDyo9HufhgemQeA' 9-max Seat #3 is the button
Seat 1: oLa/tXLfSLLB28mcLGrxcg ($24.05 in chips) 
Seat 2: Jve2LRs9vtGL7NdiNeXY/A ($15.15 in chips) 
Seat 3: IEvLSTIxhlti3EjZDarYnA ($31.15 in chips) 
Seat 4: 9+Um1wMtYNWnmPLUEU4viQ ($17.75 in chips) 
Seat 5: Ne5zBB6oEKrbigKRh6d6Xg ($11.30 in chips) 
Seat 6: wFCwdYKUXoQHhz8qeZuuAw ($24.65 in chips) 
Seat 7: aNpwfA31EREwO+ar4XzBCw ($32.15 in chips) 
Seat 8: zDrucyjVn5aeekNEc3cJrA ($37.35 in chips) 
Seat 9: V6p0jQ/RhUsqpHLmXvEX4Q ($14.70 in chips) 
9+Um1wMtYNWnmPLUEU4viQ: posts small blind $0.10
Ne5zBB6oEKrbigKRh6d6Xg: posts big blind $0.25
*** HOLE CARDS ***
wFCwdYKUXoQHhz8qeZuuAw: calls $0.25
aNpwfA31EREwO+ar4XzBCw: folds 
zDrucyjVn5aeekNEc3cJrA: folds 
V6p0jQ/RhUsqpHLmXvEX4Q: folds 
oLa/tXLfSLLB28mcLGrxcg: folds 
Jve2LRs9vtGL7NdiNeXY/A: folds 
IEvLSTIxhlti3EjZDarYnA: calls $0.25
9+Um1wMtYNWnmPLUEU4viQ: folds 
Ne5zBB6oEKrbigKRh6d6Xg: checks 
*** FLOP *** [2c Jc 9s]
Ne5zBB6oEKrbigKRh6d6Xg: bets $0.50
wFCwdYKUXoQHhz8qeZuuAw: calls $0.50
IEvLSTIxhlti3EjZDarYnA: folds 
*** TURN *** [2c Jc 9s] [9d]
Ne5zBB6oEKrbigKRh6d6Xg: bets $0.25
wFCwdYKUXoQHhz8qeZuuAw: calls $0.25
*** RIVER *** [2c Jc 9s 9d] [7d]
Ne5zBB6oEKrbigKRh6d6Xg: bets $0.75
wFCwdYKUXoQHhz8qeZuuAw: folds 
Uncalled bet ($0.75) returned to Ne5zBB6oEKrbigKRh6d6Xg
Ne5zBB6oEKrbigKRh6d6Xg collected $2.25 from pot
*** SUMMARY ***
Total pot $2.35 | Rake $0.10 
Board [2c Jc 9s 9d 7d]
Seat 1: oLa/tXLfSLLB28mcLGrxcg folded before Flop (didn't bet)
Seat 2: Jve2LRs9vtGL7NdiNeXY/A folded before Flop (didn't bet)
Seat 3: IEvLSTIxhlti3EjZDarYnA (button) folded on the Flop
Seat 4: 9+Um1wMtYNWnmPLUEU4viQ (small blind) folded before Flop
Seat 5: Ne5zBB6oEKrbigKRh6d6Xg (big blind) collected ($2.25)
Seat 6: wFCwdYKUXoQHhz8qeZuuAw folded on the River
Seat 7: aNpwfA31EREwO+ar4XzBCw folded before Flop (didn't bet)
Seat 8: zDrucyjVn5aeekNEc3cJrA folded before Flop (didn't bet)
Seat 9: V6p0jQ/RhUsqpHLmXvEX4Q folded before Flop (didn't bet)




PokerStars Game #59941923550:  Hold'em No Limit ($0.10/$0.25) - 2009/07/01 1:50:30 ET
Table '3eK1r4Q4BSYFvsKkuTLpIA' 9-max Seat #8 is the button
Seat 1: vSkQm2EelzwRGDDQQk0Fqw ($4.30 in chips) 
Seat 2: aNpwfA31EREwO+ar4XzBCw ($28.10 in chips) 
Seat 3: 56S3mA6Zs3pGR+0p0vUCtg ($35.85 in chips) 
Seat 4: +2kMBNpY4nF1qNCRd8SJLA ($25 in chips) 
Seat 5: 775TiRJajPtN/ucpTmHrXA ($21.05 in chips) 
Seat 6: +HvCCmsGSQeatf+GZ9zk8Q ($29.50 in chips) 
Seat 7: ljemhp25Zg+nlA9DLCIiUw ($24.65 in chips) 
Seat 8: /29aHLC+Q6KCDcNv2bPfAg ($10.30 in chips) 
Seat 9: +sbyWwIcFp9kP0bDtMegfQ ($60.15 in chips) 
+sbyWwIcFp9kP0bDtMegfQ: posts small blind $0.10
vSkQm2EelzwRGDDQQk0Fqw: posts big blind $0.25
*** HOLE CARDS ***
aNpwfA31EREwO+ar4XzBCw: folds 
56S3mA6Zs3pGR+0p0vUCtg: folds 
+2kMBNpY4nF1qNCRd8SJLA: calls $0.25
aNpwfA31EREwO+ar4XzBCw leaves the table
775TiRJajPtN/ucpTmHrXA: folds 
5n7e7I+px7c6CQmLpPbtsg joins the table at seat #2 
+HvCCmsGSQeatf+GZ9zk8Q: folds 
ljemhp25Zg+nlA9DLCIiUw: raises $0.75 to $1
/29aHLC+Q6KCDcNv2bPfAg: calls $1
+sbyWwIcFp9kP0bDtMegfQ: folds 
vSkQm2EelzwRGDDQQk0Fqw: folds 
+2kMBNpY4nF1qNCRd8SJLA: calls $0.75
*** FLOP *** [Ts 5d Kc]
+2kMBNpY4nF1qNCRd8SJLA: checks 
ljemhp25Zg+nlA9DLCIiUw: checks 
/29aHLC+Q6KCDcNv2bPfAg: checks 
*** TURN *** [Ts 5d Kc] [9s]
+2kMBNpY4nF1qNCRd8SJLA: checks 
ljemhp25Zg+nlA9DLCIiUw: bets $2
/29aHLC+Q6KCDcNv2bPfAg: calls $2
+2kMBNpY4nF1qNCRd8SJLA: folds 
*** RIVER *** [Ts 5d Kc 9s] [6h]
ljemhp25Zg+nlA9DLCIiUw: checks 
/29aHLC+Q6KCDcNv2bPfAg: checks 
*** SHOW DOWN ***
ljemhp25Zg+nlA9DLCIiUw: shows [Qs Tc] (a pair of Tens)
/29aHLC+Q6KCDcNv2bPfAg: mucks hand 
ljemhp25Zg+nlA9DLCIiUw collected $7 from pot
*** SUMMARY ***
Total pot $7.35 | Rake $0.35 
Board [Ts 5d Kc 9s 6h]
Seat 1: vSkQm2EelzwRGDDQQk0Fqw (big blind) folded before Flop
Seat 2: aNpwfA31EREwO+ar4XzBCw folded before Flop (didn't bet)
Seat 3: 56S3mA6Zs3pGR+0p0vUCtg folded before Flop (didn't bet)
Seat 4: +2kMBNpY4nF1qNCRd8SJLA folded on the Turn
Seat 5: 775TiRJajPtN/ucpTmHrXA folded before Flop (didn't bet)
Seat 6: +HvCCmsGSQeatf+GZ9zk8Q folded before Flop (didn't bet)
Seat 7: ljemhp25Zg+nlA9DLCIiUw showed [Qs Tc] and won ($7) with a pair of Tens
Seat 8: /29aHLC+Q6KCDcNv2bPfAg (button) mucked
Seat 9: +sbyWwIcFp9kP0bDtMegfQ (small blind) folded before Flop




PokerStars Game #59941923512:  Hold'em No Limit ($0.10/$0.25) - 2009/07/01 1:50:30 ET
Table 'sDHjMRwfSiz7+NDdZLUiyA' 9-max Seat #1 is the button
Seat 1: VGwr1eqhvdUtMfBFCvBnmg ($12.05 in chips) 
Seat 2: ljemhp25Zg+nlA9DLCIiUw ($24.95 in chips) 
Seat 3: SGA1WpAnQxFdFAYyt362gQ ($18.05 in chips) 
Seat 4: eK8qa6EPcH2zhtbmWSvc9g ($25.80 in chips) 
Seat 5: IGRfskE1v9H9Bn+fz8AgNQ ($36.10 in chips) 
Seat 6: 1qa0qHOCKZM3Uipx9DxYtQ ($16.35 in chips) 
Seat 7: K0b5wNInj6hUGRr6yzKFtw ($37.30 in chips) 
Seat 9: 3PmVnC/15cl4oyI1TKIt4g ($4.50 in chips) 
ljemhp25Zg+nlA9DLCIiUw: posts small blind $0.10
SGA1WpAnQxFdFAYyt362gQ: posts big blind $0.25
*** HOLE CARDS ***
eK8qa6EPcH2zhtbmWSvc9g: folds 
IGRfskE1v9H9Bn+fz8AgNQ: folds 
1qa0qHOCKZM3Uipx9DxYtQ: folds 
K0b5wNInj6hUGRr6yzKFtw: raises $0.75 to $1
3PmVnC/15cl4oyI1TKIt4g: folds 
VGwr1eqhvdUtMfBFCvBnmg: folds 
ljemhp25Zg+nlA9DLCIiUw: folds 
SGA1WpAnQxFdFAYyt362gQ: folds 
Uncalled bet ($0.75) returned to K0b5wNInj6hUGRr6yzKFtw
K0b5wNInj6hUGRr6yzKFtw collected $0.60 from pot
K0b5wNInj6hUGRr6yzKFtw: doesn't show hand 
*** SUMMARY ***
Total pot $0.60 | Rake $0 
Seat 1: VGwr1eqhvdUtMfBFCvBnmg (button) folded before Flop (didn't bet)
Seat 2: ljemhp25Zg+nlA9DLCIiUw (small blind) folded before Flop
Seat 3: SGA1WpAnQxFdFAYyt362gQ (big blind) folded before Flop
Seat 4: eK8qa6EPcH2zhtbmWSvc9g folded before Flop (didn't bet)
Seat 5: IGRfskE1v9H9Bn+fz8AgNQ folded before Flop (didn't bet)
Seat 6: 1qa0qHOCKZM3Uipx9DxYtQ folded before Flop (didn't bet)
Seat 7: K0b5wNInj6hUGRr6yzKFtw collected ($0.60)
Seat 9: 3PmVnC/15cl4oyI1TKIt4g folded before Flop (didn't bet)




PokerStars Game #59941923746:  Hold'em No Limit ($0.10/$0.25) - 2009/07/01 1:50:30 ET
Table '/VaaaFnlEJoYVomG9uxHkA' 9-max Seat #8 is the button
Seat 1: Th3FldXKQW6hWVVPahaoOQ ($26.65 in chips) 
Seat 2: DIkeSkosO/tsUp9d2JVyTA ($54.75 in chips) 
Seat 3: MtVtHDqIJTyUcXkRBBDIVA ($26.50 in chips) 
Seat 4: j4q3p0lesp63b1gZDwLBZw ($5.35 in chips) 
Seat 5: cZ99hugmLBj9KhTlc8nCSw ($25 in chips) 
Seat 7: F7pnn6czNpHvRM55XcA2EA ($31.25 in chips) 
Seat 8: dfNim92Z6XK1/h5SFW5vDg ($50.50 in chips) 
Seat 9: DdPXdieucQ+n99u1n3A+rQ ($4.75 in chips) 
DdPXdieucQ+n99u1n3A+rQ: posts small blind $0.10
Th3FldXKQW6hWVVPahaoOQ: posts big blind $0.25
*** HOLE CARDS ***
DIkeSkosO/tsUp9d2JVyTA: calls $0.25
MtVtHDqIJTyUcXkRBBDIVA: folds 
j4q3p0lesp63b1gZDwLBZw: folds 
cZ99hugmLBj9KhTlc8nCSw: folds 
F7pnn6czNpHvRM55XcA2EA: folds 
dfNim92Z6XK1/h5SFW5vDg: folds 
DdPXdieucQ+n99u1n3A+rQ: folds 
Th3FldXKQW6hWVVPahaoOQ: checks 
*** FLOP *** [4c 4s 7c]
Th3FldXKQW6hWVVPahaoOQ: bets $0.50
DIkeSkosO/tsUp9d2JVyTA: calls $0.50
*** TURN *** [4c 4s 7c] [Kd]
Th3FldXKQW6hWVVPahaoOQ: bets $1
DIkeSkosO/tsUp9d2JVyTA: raises $2 to $3
Th3FldXKQW6hWVVPahaoOQ: folds 
Uncalled bet ($2) returned to DIkeSkosO/tsUp9d2JVyTA
DIkeSkosO/tsUp9d2JVyTA collected $3.45 from pot
DIkeSkosO/tsUp9d2JVyTA: doesn't show hand 
*** SUMMARY ***
Total pot $3.60 | Rake $0.15 
Board [4c 4s 7c Kd]
Seat 1: Th3FldXKQW6hWVVPahaoOQ (big blind) folded on the Turn
Seat 2: DIkeSkosO/tsUp9d2JVyTA collected ($3.45)
Seat 3: MtVtHDqIJTyUcXkRBBDIVA folded before Flop (didn't bet)
Seat 4: j4q3p0lesp63b1gZDwLBZw folded before Flop (didn't bet)
Seat 5: cZ99hugmLBj9KhTlc8nCSw folded before Flop (didn't bet)
Seat 7: F7pnn6czNpHvRM55XcA2EA folded before Flop (didn't bet)
Seat 8: dfNim92Z6XK1/h5SFW5vDg (button) folded before Flop (didn't bet)
Seat 9: DdPXdieucQ+n99u1n3A+rQ (small blind) folded before Flop




PokerStars Game #59941923782:  Hold'em No Limit ($0.10/$0.25) - 2009/07/01 1:50:30 ET
Table '0M5QEJGOThqZwQ/sjbjXYw' 6-max Seat #2 is the button
Seat 2: /gJNBeCkWL4o85/jvlZ4BA ($34.25 in chips) 
Seat 3: 3zD3qLXT1bEffAoWGnc7wg ($25.10 in chips) 
Seat 5: cWc85bEzdRzpUMhRKm8pwQ ($53.40 in chips) 
Seat 6: bb63I02U6p9a5MNFa1gCiw ($21.35 in chips) 
3zD3qLXT1bEffAoWGnc7wg: posts small blind $0.10
cWc85bEzdRzpUMhRKm8pwQ: posts big blind $0.25
*** HOLE CARDS ***
bb63I02U6p9a5MNFa1gCiw: folds 
/gJNBeCkWL4o85/jvlZ4BA: raises $0.75 to $1
3zD3qLXT1bEffAoWGnc7wg: folds 
cWc85bEzdRzpUMhRKm8pwQ: folds 
Uncalled bet ($0.75) returned to /gJNBeCkWL4o85/jvlZ4BA
/gJNBeCkWL4o85/jvlZ4BA collected $0.60 from pot
*** SUMMARY ***
Total pot $0.60 | Rake $0 
Seat 2: /gJNBeCkWL4o85/jvlZ4BA (button) collected ($0.60)
Seat 3: 3zD3qLXT1bEffAoWGnc7wg (small blind) folded before Flop
Seat 5: cWc85bEzdRzpUMhRKm8pwQ (big blind) folded before Flop
Seat 6: bb63I02U6p9a5MNFa1gCiw folded before Flop (didn't bet)




PokerStars Game #59941923964:  Hold'em No Limit ($0.10/$0.25) - 2009/07/01 1:50:30 ET
Table '2VkNDXXsBj4bSZw/uK5atw' 6-max Seat #1 is the button
Seat 1: xrf8tAXKQHG99HixCot1Iw ($24.90 in chips) 
Seat 2: GbCVUNssQ7mqsPWr7J4d3w ($4.75 in chips) 
Seat 3: P+6Z5+8H5/Wyt/jHMovNvQ ($25.10 in chips) 
Seat 4: 4kIRqWKE/N0yUAcWVhLSoQ ($13.65 in chips) 
Seat 5: 7f0OkhFEOf3T+rVOFHRLnw ($21.25 in chips) 
Seat 6: n6UPMnVR4v8LFP0rWP73Fg ($12.10 in chips) 
GbCVUNssQ7mqsPWr7J4d3w: posts small blind $0.10
P+6Z5+8H5/Wyt/jHMovNvQ: posts big blind $0.25
*** HOLE CARDS ***
4kIRqWKE/N0yUAcWVhLSoQ: calls $0.25
7f0OkhFEOf3T+rVOFHRLnw: folds 
n6UPMnVR4v8LFP0rWP73Fg: calls $0.25
xrf8tAXKQHG99HixCot1Iw: raises $1 to $1.25
GbCVUNssQ7mqsPWr7J4d3w: folds 
P+6Z5+8H5/Wyt/jHMovNvQ: folds 
4kIRqWKE/N0yUAcWVhLSoQ: calls $1
n6UPMnVR4v8LFP0rWP73Fg: folds 
*** FLOP *** [6h 9d Ad]
4kIRqWKE/N0yUAcWVhLSoQ: bets $1.75
xrf8tAXKQHG99HixCot1Iw: folds 
Uncalled bet ($1.75) returned to 4kIRqWKE/N0yUAcWVhLSoQ
4kIRqWKE/N0yUAcWVhLSoQ collected $2.95 from pot
4kIRqWKE/N0yUAcWVhLSoQ: doesn't show hand 
*** SUMMARY ***
Total pot $3.10 | Rake $0.15 
Board [6h 9d Ad]
Seat 1: xrf8tAXKQHG99HixCot1Iw (button) folded on the Flop
Seat 2: GbCVUNssQ7mqsPWr7J4d3w (small blind) folded before Flop
Seat 3: P+6Z5+8H5/Wyt/jHMovNvQ (big blind) folded before Flop
Seat 4: 4kIRqWKE/N0yUAcWVhLSoQ collected ($2.95)
Seat 5: 7f0OkhFEOf3T+rVOFHRLnw folded before Flop (didn't bet)
Seat 6: n6UPMnVR4v8LFP0rWP73Fg folded before Flop




PokerStars Game #59941923714:  Hold'em No Limit ($0.10/$0.25) - 2009/07/01 1:50:30 ET
Table 'QegsWX65l3n/K0A8XB78yg' 6-max Seat #1 is the button
Seat 1: p6adJRMXMBLr+xtQzqazIQ ($12 in chips) 
Seat 2: GC/9yVD59DUCX7hUI7gcLw ($55.60 in chips) 
Seat 3: iIgNoBh+3/Ix1/fLsg+HuA ($6 in chips) 
Seat 4: epAUIB7h2FJXzUPRIvSkRA ($25 in chips) 
Seat 5: QqiZLFrN8iOUT/GHw7ztOA ($28.95 in chips) 
Seat 6: 5PWs02z65jSO5pr/M6wx/w ($11.70 in chips) 
GC/9yVD59DUCX7hUI7gcLw: posts small blind $0.10
iIgNoBh+3/Ix1/fLsg+HuA: posts big blind $0.25
*** HOLE CARDS ***
epAUIB7h2FJXzUPRIvSkRA has timed out
epAUIB7h2FJXzUPRIvSkRA: folds 
epAUIB7h2FJXzUPRIvSkRA is sitting out
QqiZLFrN8iOUT/GHw7ztOA: folds 
5PWs02z65jSO5pr/M6wx/w: folds 
p6adJRMXMBLr+xtQzqazIQ: raises $0.75 to $1
GC/9yVD59DUCX7hUI7gcLw: folds 
epAUIB7h2FJXzUPRIvSkRA has returned
iIgNoBh+3/Ix1/fLsg+HuA: raises $5 to $6 and is all-in
p6adJRMXMBLr+xtQzqazIQ: calls $5
*** FLOP *** [Ad 9h Jh]
*** TURN *** [Ad 9h Jh] [Js]
*** RIVER *** [Ad 9h Jh Js] [9s]
*** SHOW DOWN ***
iIgNoBh+3/Ix1/fLsg+HuA: shows [Tc 3s] (two pair, Jacks and Nines)
p6adJRMXMBLr+xtQzqazIQ: shows [2s Ks] (two pair, Jacks and Nines)
iIgNoBh+3/Ix1/fLsg+HuA collected $5.75 from pot
p6adJRMXMBLr+xtQzqazIQ collected $5.75 from pot
*** SUMMARY ***
Total pot $12.10 | Rake $0.60 
Board [Ad 9h Jh Js 9s]
Seat 1: p6adJRMXMBLr+xtQzqazIQ (button) showed [2s Ks] and won ($5.75) with two pair, Jacks and Nines
Seat 2: GC/9yVD59DUCX7hUI7gcLw (small blind) folded before Flop
Seat 3: iIgNoBh+3/Ix1/fLsg+HuA (big blind) showed [Tc 3s] and won ($5.75) with two pair, Jacks and Nines
Seat 4: epAUIB7h2FJXzUPRIvSkRA folded before Flop (didn't bet)
Seat 5: QqiZLFrN8iOUT/GHw7ztOA folded before Flop (didn't bet)
Seat 6: 5PWs02z65jSO5pr/M6wx/w folded before Flop (didn't bet)




PokerStars Game #59941924002:  Hold'em No Limit ($0.10/$0.25) - 2009/07/01 1:50:31 ET
Table '29D3eoQzK5kOAT0OIDS2uQ' 6-max Seat #2 is the button
Seat 1: kG34n23qFQA3nzdOJTQ1dA ($43.15 in chips) 
Seat 2: FyE+TQ5JcCqI/tCCHf0jGA ($16.70 in chips) 
Seat 3: z3tQwy28dp5FykDJC/wzQw ($15.70 in chips) 
Seat 4: MqMK8OWPSY1V4stf1Hy5Jw ($64.70 in chips) 
Seat 5: Q3EMN7b0ie81AFWkDrhCjw ($26.45 in chips) 
Seat 6: bWbV4MVB/vVpiES1Ut4hew ($25 in chips) 
z3tQwy28dp5FykDJC/wzQw: posts small blind $0.10
MqMK8OWPSY1V4stf1Hy5Jw: posts big blind $0.25
*** HOLE CARDS ***
Q3EMN7b0ie81AFWkDrhCjw: calls $0.25
bWbV4MVB/vVpiES1Ut4hew: folds 
kG34n23qFQA3nzdOJTQ1dA: folds 
FyE+TQ5JcCqI/tCCHf0jGA: folds 
z3tQwy28dp5FykDJC/wzQw: calls $0.15
bWbV4MVB/vVpiES1Ut4hew leaves the table
MqMK8OWPSY1V4stf1Hy5Jw: checks 
*** FLOP *** [5d 5c 6c]
if4dh6jhJXeN3/qd3qCp9g joins the table at seat #6 
MqMK8OWPSY1V4stf1Hy5Jw said, "tyty"
z3tQwy28dp5FykDJC/wzQw: checks 
MqMK8OWPSY1V4stf1Hy5Jw said, "pretty touugh call"
MqMK8OWPSY1V4stf1Hy5Jw said, "no hands made sense"
MqMK8OWPSY1V4stf1Hy5Jw: checks 
Q3EMN7b0ie81AFWkDrhCjw: bets $0.50
z3tQwy28dp5FykDJC/wzQw: folds 
MqMK8OWPSY1V4stf1Hy5Jw: folds 
Uncalled bet ($0.50) returned to Q3EMN7b0ie81AFWkDrhCjw
Q3EMN7b0ie81AFWkDrhCjw collected $0.75 from pot
*** SUMMARY ***
Total pot $0.75 | Rake $0 
Board [5d 5c 6c]
Seat 1: kG34n23qFQA3nzdOJTQ1dA folded before Flop (didn't bet)
Seat 2: FyE+TQ5JcCqI/tCCHf0jGA (button) folded before Flop (didn't bet)
Seat 3: z3tQwy28dp5FykDJC/wzQw (small blind) folded on the Flop
Seat 4: MqMK8OWPSY1V4stf1Hy5Jw (big blind) folded on the Flop
Seat 5: Q3EMN7b0ie81AFWkDrhCjw collected ($0.75)
Seat 6: bWbV4MVB/vVpiES1Ut4hew folded before Flop (didn't bet)




PokerStars Game #59941925028:  Hold'em No Limit ($0.10/$0.25) - 2009/07/01 1:50:31 ET
Table 'ohAuixfiLOYDylNUG5mNUw' 9-max Seat #3 is the button
Seat 1: qwr38jl5txoR36M7G5qi4A ($10 in chips) 
Seat 2: Th3FldXKQW6hWVVPahaoOQ ($26.15 in chips) 
Seat 3: gSakoFAgDDzXSb2eNBWKcg ($14.50 in chips) 
Seat 4: clJsV3v77RS07bDKY+705w ($5 in chips) 
Seat 7: y6clPkgMYve3yX9UTvvFUw ($20 in chips) 
Seat 8: ppMlNkhYgErlt4fuJO7ADA ($4.95 in chips) 
Seat 9: CT7Xj/V/O5rBlhtt+RZeFQ ($25.25 in chips) 
clJsV3v77RS07bDKY+705w: posts small blind $0.10
MtVtHDqIJTyUcXkRBBDIVA: is sitting out 
y6clPkgMYve3yX9UTvvFUw: posts big blind $0.25
*** HOLE CARDS ***
ppMlNkhYgErlt4fuJO7ADA: folds 
CT7Xj/V/O5rBlhtt+RZeFQ: raises $0.75 to $1
MtVtHDqIJTyUcXkRBBDIVA has returned
MtVtHDqIJTyUcXkRBBDIVA leaves the table
qwr38jl5txoR36M7G5qi4A: folds 
18G4P1XstjNvItdGUITxgw joins the table at seat #6 
Th3FldXKQW6hWVVPahaoOQ: folds 
gSakoFAgDDzXSb2eNBWKcg: calls $1
clJsV3v77RS07bDKY+705w: folds 
z5GxcHlYz/GSz6W2uFiTtg has returned
y6clPkgMYve3yX9UTvvFUw is disconnected 
y6clPkgMYve3yX9UTvvFUw is connected 
y6clPkgMYve3yX9UTvvFUw: calls $0.75
*** FLOP *** [Tc 4d 2h]
y6clPkgMYve3yX9UTvvFUw: checks 
CT7Xj/V/O5rBlhtt+RZeFQ: checks 
gSakoFAgDDzXSb2eNBWKcg: bets $1
y6clPkgMYve3yX9UTvvFUw: folds 
CT7Xj/V/O5rBlhtt+RZeFQ: folds 
Uncalled bet ($1) returned to gSakoFAgDDzXSb2eNBWKcg
gSakoFAgDDzXSb2eNBWKcg collected $2.95 from pot
*** SUMMARY ***
Total pot $3.10 | Rake $0.15 
Board [Tc 4d 2h]
Seat 1: qwr38jl5txoR36M7G5qi4A folded before Flop (didn't bet)
Seat 2: Th3FldXKQW6hWVVPahaoOQ folded before Flop (didn't bet)
Seat 3: gSakoFAgDDzXSb2eNBWKcg (button) collected ($2.95)
Seat 4: clJsV3v77RS07bDKY+705w (small blind) folded before Flop
Seat 7: y6clPkgMYve3yX9UTvvFUw (big blind) folded on the Flop
Seat 8: ppMlNkhYgErlt4fuJO7ADA folded before Flop (didn't bet)
Seat 9: CT7Xj/V/O5rBlhtt+RZeFQ folded on the Flop




PokerStars Game #59941924280:  Hold'em No Limit ($0.10/$0.25) - 2009/07/01 1:50:31 ET
Table 'Qk/910N2Yhg8u5vqTJk50Q' 9-max Seat #9 is the button
Seat 2: Th3FldXKQW6hWVVPahaoOQ ($44.80 in chips) 
Seat 3: ghNKXUBl/H+t83JF079ZBA ($25.65 in chips) 
Seat 4: hYvTc4PYNrAaNAIVoM94Hw ($4.75 in chips) 
Seat 5: zReBEigsxqZnag0RZAgpgA ($14.10 in chips) 
Seat 6: U41wNf6XauAiBOQaKu2ZIA ($9.75 in chips) 
Seat 7: aNpwfA31EREwO+ar4XzBCw ($26.85 in chips) 
Seat 8: 5pDhXQ+RVy0BGcwfJAJfbg ($25 in chips) 
Seat 9: M2QO2DxB5Wawg2h8HSpnYA ($17.35 in chips) 
zDrucyjVn5aeekNEc3cJrA will be allowed to play after the button
Th3FldXKQW6hWVVPahaoOQ: posts small blind $0.10
ghNKXUBl/H+t83JF079ZBA: posts big blind $0.25
5pDhXQ+RVy0BGcwfJAJfbg: posts big blind $0.25
*** HOLE CARDS ***
hYvTc4PYNrAaNAIVoM94Hw: folds 
zReBEigsxqZnag0RZAgpgA: folds 
U41wNf6XauAiBOQaKu2ZIA: folds 
aNpwfA31EREwO+ar4XzBCw: folds 
5pDhXQ+RVy0BGcwfJAJfbg: checks 
M2QO2DxB5Wawg2h8HSpnYA: folds 
Th3FldXKQW6hWVVPahaoOQ: folds 
ghNKXUBl/H+t83JF079ZBA: checks 
*** FLOP *** [Ah Ad 4s]
ghNKXUBl/H+t83JF079ZBA: checks 
5pDhXQ+RVy0BGcwfJAJfbg: checks 
*** TURN *** [Ah Ad 4s] [6c]
ghNKXUBl/H+t83JF079ZBA: bets $0.50
5pDhXQ+RVy0BGcwfJAJfbg: folds 
Uncalled bet ($0.50) returned to ghNKXUBl/H+t83JF079ZBA
ghNKXUBl/H+t83JF079ZBA collected $0.60 from pot
ghNKXUBl/H+t83JF079ZBA: doesn't show hand 
*** SUMMARY ***
Total pot $0.60 | Rake $0 
Board [Ah Ad 4s 6c]
Seat 2: Th3FldXKQW6hWVVPahaoOQ (small blind) folded before Flop
Seat 3: ghNKXUBl/H+t83JF079ZBA (big blind) collected ($0.60)
Seat 4: hYvTc4PYNrAaNAIVoM94Hw folded before Flop (didn't bet)
Seat 5: zReBEigsxqZnag0RZAgpgA folded before Flop (didn't bet)
Seat 6: U41wNf6XauAiBOQaKu2ZIA folded before Flop (didn't bet)
Seat 7: aNpwfA31EREwO+ar4XzBCw folded before Flop (didn't bet)
Seat 8: 5pDhXQ+RVy0BGcwfJAJfbg folded on the Turn
Seat 9: M2QO2DxB5Wawg2h8HSpnYA (button) folded before Flop (didn't bet)




PokerStars Game #59941924172:  Hold'em No Limit ($0.10/$0.25) - 2009/07/01 1:50:31 ET
Table 'GrYi0DZOHD1EvB+qiLExNw' 9-max Seat #1 is the button
Seat 1: 7je+LC5Mfs6nL8YBVh4frQ ($4.65 in chips) 
Seat 2: Th3FldXKQW6hWVVPahaoOQ ($46.80 in chips) 
Seat 3: RHqgdFvufLCYe54+qd2gcA ($4.75 in chips) 
Seat 4: 8x95tVlB4uFBVHp71KihMA ($35.75 in chips) 
Seat 5: cZ99hugmLBj9KhTlc8nCSw ($25 in chips) 
Seat 6: arxNSjreDRGFg13EAM2F1w ($25 in chips) 
Seat 7: 9lvO/qyU+xrU95Teu1fv0g ($23.20 in chips) 
Seat 9: 5hAPbqNrvJb8PtLiceXtlg ($14.45 in chips) 
Th3FldXKQW6hWVVPahaoOQ: posts small blind $0.10
RHqgdFvufLCYe54+qd2gcA: posts big blind $0.25
*** HOLE CARDS ***
8x95tVlB4uFBVHp71KihMA: folds 
cZ99hugmLBj9KhTlc8nCSw: folds 
arxNSjreDRGFg13EAM2F1w: folds 
9lvO/qyU+xrU95Teu1fv0g: folds 
5hAPbqNrvJb8PtLiceXtlg: folds 
7je+LC5Mfs6nL8YBVh4frQ: raises $0.50 to $0.75
Th3FldXKQW6hWVVPahaoOQ: folds 
RHqgdFvufLCYe54+qd2gcA: folds 
Uncalled bet ($0.50) returned to 7je+LC5Mfs6nL8YBVh4frQ
7je+LC5Mfs6nL8YBVh4frQ collected $0.60 from pot
7je+LC5Mfs6nL8YBVh4frQ: doesn't show hand 
*** SUMMARY ***
Total pot $0.60 | Rake $0 
Seat 1: 7je+LC5Mfs6nL8YBVh4frQ (button) collected ($0.60)
Seat 2: Th3FldXKQW6hWVVPahaoOQ (small blind) folded before Flop
Seat 3: RHqgdFvufLCYe54+qd2gcA (big blind) folded before Flop
Seat 4: 8x95tVlB4uFBVHp71KihMA folded before Flop (didn't bet)
Seat 5: cZ99hugmLBj9KhTlc8nCSw folded before Flop (didn't bet)
Seat 6: arxNSjreDRGFg13EAM2F1w folded before Flop (didn't bet)
Seat 7: 9lvO/qyU+xrU95Teu1fv0g folded before Flop (didn't bet)
Seat 9: 5hAPbqNrvJb8PtLiceXtlg folded before Flop (didn't bet)




PokerStars Game #59941924208:  Hold'em No Limit ($0.10/$0.25) - 2009/07/01 1:50:31 ET
Table 'P2yJ+jwfNsBdF12fLKA6DQ' 9-max Seat #3 is the button
Seat 1: zDrucyjVn5aeekNEc3cJrA ($22.20 in chips) 
Seat 2: uQwmfH5LEVA5eyghJdyPUg ($14.90 in chips) 
Seat 3: 8EbrQ/EvFWt2cr0GaU82gQ ($4.65 in chips) 
Seat 4: 6NLAWFPZZfqlVkY8n9RULA ($13.50 in chips) 
Seat 5: B7VAFAMs/PYlYABlV+EkSA ($7.80 in chips) 
Seat 6: mUoFJKqCzIUABvOFbiINlQ ($14 in chips) 
Seat 7: yQc5nLaNmByxI15Jegu61w ($17.65 in chips) 
Seat 8: LMd3gq2uNfbWTfXTnSeQRw ($10.10 in chips) 
Seat 9: dN5zq7QdZCUe7NZFM6cECg ($19.15 in chips) 
6NLAWFPZZfqlVkY8n9RULA: posts small blind $0.10
B7VAFAMs/PYlYABlV+EkSA: posts big blind $0.25
*** HOLE CARDS ***
dN5zq7QdZCUe7NZFM6cECg said, "B7VAFAMs/PYlYABlV+EkSA...maybe next time"
mUoFJKqCzIUABvOFbiINlQ: folds 
yQc5nLaNmByxI15Jegu61w: calls $0.25
LMd3gq2uNfbWTfXTnSeQRw: calls $0.25
dN5zq7QdZCUe7NZFM6cECg: raises $1.25 to $1.50
zDrucyjVn5aeekNEc3cJrA: folds 
uQwmfH5LEVA5eyghJdyPUg: folds 
8EbrQ/EvFWt2cr0GaU82gQ: folds 
6NLAWFPZZfqlVkY8n9RULA: folds 
B7VAFAMs/PYlYABlV+EkSA: folds 
yQc5nLaNmByxI15Jegu61w: folds 
LMd3gq2uNfbWTfXTnSeQRw: folds 
Uncalled bet ($1.25) returned to dN5zq7QdZCUe7NZFM6cECg
dN5zq7QdZCUe7NZFM6cECg collected $1.10 from pot
dN5zq7QdZCUe7NZFM6cECg: doesn't show hand 
*** SUMMARY ***
Total pot $1.10 | Rake $0 
Seat 1: zDrucyjVn5aeekNEc3cJrA folded before Flop (didn't bet)
Seat 2: uQwmfH5LEVA5eyghJdyPUg folded before Flop (didn't bet)
Seat 3: 8EbrQ/EvFWt2cr0GaU82gQ (button) folded before Flop (didn't bet)
Seat 4: 6NLAWFPZZfqlVkY8n9RULA (small blind) folded before Flop
Seat 5: B7VAFAMs/PYlYABlV+EkSA (big blind) folded before Flop
Seat 6: mUoFJKqCzIUABvOFbiINlQ folded before Flop (didn't bet)
Seat 7: yQc5nLaNmByxI15Jegu61w folded before Flop
Seat 8: LMd3gq2uNfbWTfXTnSeQRw folded before Flop
Seat 9: dN5zq7QdZCUe7NZFM6cECg collected ($1.10)




PokerStars Game #59941924200:  Hold'em No Limit ($0.10/$0.25) - 2009/07/01 1:50:31 ET
Table 'axb9RsG8Zj1A0LEukTeFrQ' 9-max Seat #8 is the button
Seat 1: qwr38jl5txoR36M7G5qi4A ($8.50 in chips) 
Seat 2: zDrucyjVn5aeekNEc3cJrA ($21.40 in chips) 
Seat 3: H5Se03ZqSX7tbULXur2MAg ($25.05 in chips) 
Seat 4: tLcDklc2rBORNfixyRfVfw ($25.35 in chips) 
Seat 5: rLSSHKOHnb6yzVfDoQM/RA ($16.60 in chips) 
Seat 6: Iu9xjReQYvxYiqQm8n6MXQ ($4.25 in chips) 
Seat 7: PdIasPkzm2sqZnN41ZRXOg ($5 in chips) 
Seat 8: VBHxUExRAMrbxUq/cVx9Gw ($5 in chips) 
Seat 9: qbQE8CifKB4+OEvNF/61Rw ($57.45 in chips) 
qbQE8CifKB4+OEvNF/61Rw: posts small blind $0.10
qwr38jl5txoR36M7G5qi4A: posts big blind $0.25
*** HOLE CARDS ***
zDrucyjVn5aeekNEc3cJrA: folds 
H5Se03ZqSX7tbULXur2MAg: folds 
tLcDklc2rBORNfixyRfVfw: folds 
rLSSHKOHnb6yzVfDoQM/RA: calls $0.25
Iu9xjReQYvxYiqQm8n6MXQ: raises $0.75 to $1
PdIasPkzm2sqZnN41ZRXOg: folds 
VBHxUExRAMrbxUq/cVx9Gw: folds 
qbQE8CifKB4+OEvNF/61Rw: folds 
qwr38jl5txoR36M7G5qi4A: folds 
rLSSHKOHnb6yzVfDoQM/RA: folds 
Uncalled bet ($0.75) returned to Iu9xjReQYvxYiqQm8n6MXQ
Iu9xjReQYvxYiqQm8n6MXQ collected $0.85 from pot
Iu9xjReQYvxYiqQm8n6MXQ: doesn't show hand 
*** SUMMARY ***
Total pot $0.85 | Rake $0 
Seat 1: qwr38jl5txoR36M7G5qi4A (big blind) folded before Flop
Seat 2: zDrucyjVn5aeekNEc3cJrA folded before Flop (didn't bet)
Seat 3: H5Se03ZqSX7tbULXur2MAg folded before Flop (didn't bet)
Seat 4: tLcDklc2rBORNfixyRfVfw folded before Flop (didn't bet)
Seat 5: rLSSHKOHnb6yzVfDoQM/RA folded before Flop
Seat 6: Iu9xjReQYvxYiqQm8n6MXQ collected ($0.85)
Seat 7: PdIasPkzm2sqZnN41ZRXOg folded before Flop (didn't bet)
Seat 8: VBHxUExRAMrbxUq/cVx9Gw (button) folded before Flop (didn't bet)
Seat 9: qbQE8CifKB4+OEvNF/61Rw (small blind) folded before Flop




PokerStars Game #59941925316:  Hold'em No Limit ($0.10/$0.25) - 2009/07/01 1:50:32 ET
Table 'zhqgUUprOJ14VxKxPHcT/Q' 9-max Seat #1 is the button
Seat 1: 22dIObOuor/A+IKWkNoAlA ($5.50 in chips) 
Seat 2: GY095KWhBevJ1Ttvl8WseA ($14.35 in chips) 
Seat 3: 4XHsdGnQ76EBdBvsrSs8bA ($20.90 in chips) 
Seat 4: wGigCmBR/9XWkPpvYos3aQ ($33.45 in chips) 
Seat 5: +sbyWwIcFp9kP0bDtMegfQ ($33.25 in chips) 
Seat 6: PdIasPkzm2sqZnN41ZRXOg ($5 in chips) 
Seat 8: EQXHDnIzAsORnIXRNtXRlA ($29.50 in chips) 
Seat 9: CGjLyv/AvljZy2g76nYkzQ ($25 in chips) 
GY095KWhBevJ1Ttvl8WseA: posts small blind $0.10
4XHsdGnQ76EBdBvsrSs8bA: posts big blind $0.25
bXpVeaSTPBFSPJmeXxO7nw: sits out 
CGjLyv/AvljZy2g76nYkzQ: posts big blind $0.25
*** HOLE CARDS ***
wGigCmBR/9XWkPpvYos3aQ: folds 
+sbyWwIcFp9kP0bDtMegfQ: folds 
PdIasPkzm2sqZnN41ZRXOg: folds 
EQXHDnIzAsORnIXRNtXRlA: folds 
CGjLyv/AvljZy2g76nYkzQ: checks 
22dIObOuor/A+IKWkNoAlA: folds 
GY095KWhBevJ1Ttvl8WseA: calls $0.15
4XHsdGnQ76EBdBvsrSs8bA: checks 
*** FLOP *** [5d Qh Th]
GY095KWhBevJ1Ttvl8WseA: checks 
4XHsdGnQ76EBdBvsrSs8bA: checks 
CGjLyv/AvljZy2g76nYkzQ: bets $0.75
GY095KWhBevJ1Ttvl8WseA: folds 
4XHsdGnQ76EBdBvsrSs8bA: folds 
Uncalled bet ($0.75) returned to CGjLyv/AvljZy2g76nYkzQ
CGjLyv/AvljZy2g76nYkzQ collected $0.75 from pot
CGjLyv/AvljZy2g76nYkzQ: doesn't show hand 
*** SUMMARY ***
Total pot $0.75 | Rake $0 
Board [5d Qh Th]
Seat 1: 22dIObOuor/A+IKWkNoAlA (button) folded before Flop (didn't bet)
Seat 2: GY095KWhBevJ1Ttvl8WseA (small blind) folded on the Flop
Seat 3: 4XHsdGnQ76EBdBvsrSs8bA (big blind) folded on the Flop
Seat 4: wGigCmBR/9XWkPpvYos3aQ folded before Flop (didn't bet)
Seat 5: +sbyWwIcFp9kP0bDtMegfQ folded before Flop (didn't bet)
Seat 6: PdIasPkzm2sqZnN41ZRXOg folded before Flop (didn't bet)
Seat 8: EQXHDnIzAsORnIXRNtXRlA folded before Flop (didn't bet)
Seat 9: CGjLyv/AvljZy2g76nYkzQ collected ($0.75)




PokerStars Game #59941925304:  Hold'em No Limit ($0.10/$0.25) - 2009/07/01 1:50:32 ET
Table 'pAhiNHs/spaABQia+7gWNQ' 9-max Seat #9 is the button
Seat 1: ipgcO7Pa6LC8XWpVttZfnA ($4.75 in chips) 
Seat 2: dfNim92Z6XK1/h5SFW5vDg ($25.25 in chips) 
Seat 4: Qduu7ikeizo6q6Ei9YvcJA ($47.75 in chips) 
Seat 5: OlPJsgR4xypSg/w1z7Gyvw ($33.60 in chips) 
Seat 6: oLa/tXLfSLLB28mcLGrxcg ($24.25 in chips) 
Seat 7: +WTkVY3GeLxqGQBbMZQiWQ ($10.30 in chips) 
Seat 8: PskTLlFIRHSp61inskRzVg ($9.35 in chips) 
Seat 9: zgi+EUykT/pZQpoUG6+oEg ($5.80 in chips) 
ipgcO7Pa6LC8XWpVttZfnA: posts small blind $0.10
dfNim92Z6XK1/h5SFW5vDg: posts big blind $0.25
bXpVeaSTPBFSPJmeXxO7nw: sits out 
*** HOLE CARDS ***
Qduu7ikeizo6q6Ei9YvcJA: calls $0.25
OlPJsgR4xypSg/w1z7Gyvw: folds 
oLa/tXLfSLLB28mcLGrxcg: folds 
+WTkVY3GeLxqGQBbMZQiWQ: folds 
PskTLlFIRHSp61inskRzVg: folds 
zgi+EUykT/pZQpoUG6+oEg: folds 
ipgcO7Pa6LC8XWpVttZfnA: folds 
dfNim92Z6XK1/h5SFW5vDg: checks 
*** FLOP *** [6s 9h 9s]
dfNim92Z6XK1/h5SFW5vDg: checks 
Qduu7ikeizo6q6Ei9YvcJA: checks 
*** TURN *** [6s 9h 9s] [5h]
dfNim92Z6XK1/h5SFW5vDg: checks 
Qduu7ikeizo6q6Ei9YvcJA: checks 
*** RIVER *** [6s 9h 9s 5h] [Ks]
dfNim92Z6XK1/h5SFW5vDg: checks 
Qduu7ikeizo6q6Ei9YvcJA: bets $0.75
dfNim92Z6XK1/h5SFW5vDg: folds 
Uncalled bet ($0.75) returned to Qduu7ikeizo6q6Ei9YvcJA
Qduu7ikeizo6q6Ei9YvcJA collected $0.60 from pot
Qduu7ikeizo6q6Ei9YvcJA: doesn't show hand 
*** SUMMARY ***
Total pot $0.60 | Rake $0 
Board [6s 9h 9s 5h Ks]
Seat 1: ipgcO7Pa6LC8XWpVttZfnA (small blind) folded before Flop
Seat 2: dfNim92Z6XK1/h5SFW5vDg (big blind) folded on the River
Seat 4: Qduu7ikeizo6q6Ei9YvcJA collected ($0.60)
Seat 5: OlPJsgR4xypSg/w1z7Gyvw folded before Flop (didn't bet)
Seat 6: oLa/tXLfSLLB28mcLGrxcg folded before Flop (didn't bet)
Seat 7: +WTkVY3GeLxqGQBbMZQiWQ folded before Flop (didn't bet)
Seat 8: PskTLlFIRHSp61inskRzVg folded before Flop (didn't bet)
Seat 9: zgi+EUykT/pZQpoUG6+oEg (button) folded before Flop (didn't bet)




PokerStars Game #59941925232:  Hold'em No Limit ($0.10/$0.25) - 2009/07/01 1:50:32 ET
Table 'AJGgX1ZYM8d68SWMvaLttg' 6-max Seat #5 is the button
Seat 1: Q1uciOZPBR/WkAlqa6cL4A ($25 in chips) 
Seat 2: zHHLkD2sRljslKKeQv/ZQw ($25.50 in chips) 
Seat 3: 8ClCHtFXGNplITm+63KB+Q ($38.35 in chips) 
Seat 4: e30C3DfdG5TfPnR16/oMmA ($21.75 in chips) 
Seat 5: Hsvkc0/G2VV78oVmWYXecw ($5 in chips) 
Seat 6: UA5OsKS3VPaxa7uC8La/kA ($63.75 in chips) 
UA5OsKS3VPaxa7uC8La/kA: posts small blind $0.10
Q1uciOZPBR/WkAlqa6cL4A: posts big blind $0.25
*** HOLE CARDS ***
zHHLkD2sRljslKKeQv/ZQw: calls $0.25
8ClCHtFXGNplITm+63KB+Q: raises $1 to $1.25
e30C3DfdG5TfPnR16/oMmA: folds 
Hsvkc0/G2VV78oVmWYXecw: folds 
UA5OsKS3VPaxa7uC8La/kA: folds 
Q1uciOZPBR/WkAlqa6cL4A: folds 
zHHLkD2sRljslKKeQv/ZQw: folds 
Uncalled bet ($1) returned to 8ClCHtFXGNplITm+63KB+Q
8ClCHtFXGNplITm+63KB+Q collected $0.85 from pot
8ClCHtFXGNplITm+63KB+Q: doesn't show hand 
*** SUMMARY ***
Total pot $0.85 | Rake $0 
Seat 1: Q1uciOZPBR/WkAlqa6cL4A (big blind) folded before Flop
Seat 2: zHHLkD2sRljslKKeQv/ZQw folded before Flop
Seat 3: 8ClCHtFXGNplITm+63KB+Q collected ($0.85)
Seat 4: e30C3DfdG5TfPnR16/oMmA folded before Flop (didn't bet)
Seat 5: Hsvkc0/G2VV78oVmWYXecw (button) folded before Flop (didn't bet)
Seat 6: UA5OsKS3VPaxa7uC8La/kA (small blind) folded before Flop




PokerStars Game #59941925646:  Hold'em No Limit ($0.10/$0.25) - 2009/07/01 1:50:33 ET
Table '5SUMWYuPsGiOD0FY0QbgOw' 6-max Seat #1 is the button
Seat 1: SFmT9ZsVopnukjvAzrxTRg ($25 in chips) 
Seat 2: xrf8tAXKQHG99HixCot1Iw ($38.75 in chips) 
Seat 3: i9LqF5rD3bvtbEE7HWgr3Q ($25 in chips) 
Seat 4: BV+K0Phf5VBHr7aZPKqbUQ ($26.10 in chips) 
Seat 5: v+QfkGiuj9bgtuNoVnDO8w ($40.45 in chips) 
Seat 6: jA7YMtfNUnAaebB7Lj74EA ($23.15 in chips) 
xrf8tAXKQHG99HixCot1Iw: posts small blind $0.10
i9LqF5rD3bvtbEE7HWgr3Q: posts big blind $0.25
*** HOLE CARDS ***
BV+K0Phf5VBHr7aZPKqbUQ: folds 
v+QfkGiuj9bgtuNoVnDO8w: folds 
jA7YMtfNUnAaebB7Lj74EA: folds 
SFmT9ZsVopnukjvAzrxTRg: raises $0.75 to $1
xrf8tAXKQHG99HixCot1Iw: calls $0.90
i9LqF5rD3bvtbEE7HWgr3Q: folds 
*** FLOP *** [6c Ac 2d]
xrf8tAXKQHG99HixCot1Iw: checks 
SFmT9ZsVopnukjvAzrxTRg: bets $1.50
xrf8tAXKQHG99HixCot1Iw: calls $1.50
*** TURN *** [6c Ac 2d] [6s]
xrf8tAXKQHG99HixCot1Iw: checks 
SFmT9ZsVopnukjvAzrxTRg: checks 
*** RIVER *** [6c Ac 2d 6s] [9d]
xrf8tAXKQHG99HixCot1Iw: bets $3
SFmT9ZsVopnukjvAzrxTRg: folds 
Uncalled bet ($3) returned to xrf8tAXKQHG99HixCot1Iw
xrf8tAXKQHG99HixCot1Iw collected $5 from pot
xrf8tAXKQHG99HixCot1Iw: doesn't show hand 
*** SUMMARY ***
Total pot $5.25 | Rake $0.25 
Board [6c Ac 2d 6s 9d]
Seat 1: SFmT9ZsVopnukjvAzrxTRg (button) folded on the River
Seat 2: xrf8tAXKQHG99HixCot1Iw (small blind) collected ($5)
Seat 3: i9LqF5rD3bvtbEE7HWgr3Q (big blind) folded before Flop
Seat 4: BV+K0Phf5VBHr7aZPKqbUQ folded before Flop (didn't bet)
Seat 5: v+QfkGiuj9bgtuNoVnDO8w folded before Flop (didn't bet)
Seat 6: jA7YMtfNUnAaebB7Lj74EA folded before Flop (didn't bet)




PokerStars Game #59941925978:  Hold'em No Limit ($0.10/$0.25) - 2009/07/01 1:50:33 ET
Table '63uh7ZsO7Tnt+E8b/2bu3A' 6-max Seat #4 is the button
Seat 1: 0av6tRNdi0Ui4f15L7gsVg ($37.45 in chips) 
Seat 2: SFmT9ZsVopnukjvAzrxTRg ($25 in chips) 
Seat 3: yVP7GLZBzx47OPi6jzUxMw ($3.60 in chips) 
Seat 4: rnpAao581IcvQglpkpnkoQ ($12.25 in chips) 
Seat 5: Hsvkc0/G2VV78oVmWYXecw ($5 in chips) 
Seat 6: qGHGf/553gQnDoklMRe3tg ($26.90 in chips) 
Hsvkc0/G2VV78oVmWYXecw: posts small blind $0.10
qGHGf/553gQnDoklMRe3tg: posts big blind $0.25
*** HOLE CARDS ***
0av6tRNdi0Ui4f15L7gsVg: raises $0.50 to $0.75
SFmT9ZsVopnukjvAzrxTRg: folds 
yVP7GLZBzx47OPi6jzUxMw: folds 
rnpAao581IcvQglpkpnkoQ: folds 
Hsvkc0/G2VV78oVmWYXecw: folds 
qGHGf/553gQnDoklMRe3tg: folds 
Uncalled bet ($0.50) returned to 0av6tRNdi0Ui4f15L7gsVg
0av6tRNdi0Ui4f15L7gsVg collected $0.60 from pot
0av6tRNdi0Ui4f15L7gsVg: doesn't show hand 
*** SUMMARY ***
Total pot $0.60 | Rake $0 
Seat 1: 0av6tRNdi0Ui4f15L7gsVg collected ($0.60)
Seat 2: SFmT9ZsVopnukjvAzrxTRg folded before Flop (didn't bet)
Seat 3: yVP7GLZBzx47OPi6jzUxMw folded before Flop (didn't bet)
Seat 4: rnpAao581IcvQglpkpnkoQ (button) folded before Flop (didn't bet)
Seat 5: Hsvkc0/G2VV78oVmWYXecw (small blind) folded before Flop
Seat 6: qGHGf/553gQnDoklMRe3tg (big blind) folded before Flop




PokerStars Game #59941925942:  Hold'em No Limit ($0.10/$0.25) - 2009/07/01 1:50:33 ET
Table '3lS+sU5k6mwJCS2nFMmQ6Q' 9-max Seat #4 is the button
Seat 1: VWUWpMLMj/Q1jRVpF7Aohw ($13.55 in chips) 
Seat 2: PdIasPkzm2sqZnN41ZRXOg ($5.75 in chips) 
Seat 3: 1DXccE2UUK5DIRVGlOKnTA ($13.80 in chips) 
Seat 4: GeMoapCKDLc4ajT0Uk9ZQw ($9.65 in chips) 
Seat 6: hJ4uYjNmSZdjrKA8cjZqCA ($35.25 in chips) 
Seat 7: Th3FldXKQW6hWVVPahaoOQ ($31.55 in chips) 
Seat 8: 9lvO/qyU+xrU95Teu1fv0g ($5 in chips) 
Seat 9: 4awUyiDYTgylQKXZ9faBVA ($47.85 in chips) 
hJ4uYjNmSZdjrKA8cjZqCA: posts small blind $0.10
Th3FldXKQW6hWVVPahaoOQ: posts big blind $0.25
*** HOLE CARDS ***
9lvO/qyU+xrU95Teu1fv0g: folds 
4awUyiDYTgylQKXZ9faBVA: raises $0.75 to $1
VWUWpMLMj/Q1jRVpF7Aohw: folds 
PdIasPkzm2sqZnN41ZRXOg: folds 
1DXccE2UUK5DIRVGlOKnTA: folds 
GeMoapCKDLc4ajT0Uk9ZQw: folds 
hJ4uYjNmSZdjrKA8cjZqCA: folds 
Th3FldXKQW6hWVVPahaoOQ: folds 
Uncalled bet ($0.75) returned to 4awUyiDYTgylQKXZ9faBVA
4awUyiDYTgylQKXZ9faBVA collected $0.60 from pot
4awUyiDYTgylQKXZ9faBVA: doesn't show hand 
*** SUMMARY ***
Total pot $0.60 | Rake $0 
Seat 1: VWUWpMLMj/Q1jRVpF7Aohw folded before Flop (didn't bet)
Seat 2: PdIasPkzm2sqZnN41ZRXOg folded before Flop (didn't bet)
Seat 3: 1DXccE2UUK5DIRVGlOKnTA folded before Flop (didn't bet)
Seat 4: GeMoapCKDLc4ajT0Uk9ZQw (button) folded before Flop (didn't bet)
Seat 6: hJ4uYjNmSZdjrKA8cjZqCA (small blind) folded before Flop
Seat 7: Th3FldXKQW6hWVVPahaoOQ (big blind) folded before Flop
Seat 8: 9lvO/qyU+xrU95Teu1fv0g folded before Flop (didn't bet)
Seat 9: 4awUyiDYTgylQKXZ9faBVA collected ($0.60)




PokerStars Game #59941925910:  Hold'em No Limit ($0.10/$0.25) - 2009/07/01 1:50:33 ET
Table 'K/f0NNaoGuhSz5DrzgVw7Q' 9-max Seat #5 is the button
Seat 1: sD+TKtt36XiiN6jqHiLwDA ($26.05 in chips) 
Seat 2: zgi+EUykT/pZQpoUG6+oEg ($4.65 in chips) 
Seat 4: 9bCz0uv2nUmznwuI0OjVGw ($11.80 in chips) 
Seat 5: DnDcAdn9P0zGovMERigpFA ($40.60 in chips) 
Seat 6: 3PVK0IdMlq2fElkVzzr4bg ($7.35 in chips) 
Seat 7: egvg3mTBBVzMHnJPIQiKcA ($14.65 in chips) 
Seat 8: RCqMONFrSPSArZh2Jsar/w ($24.65 in chips) 
Seat 9: tLcDklc2rBORNfixyRfVfw ($25 in chips) 
3PVK0IdMlq2fElkVzzr4bg: posts small blind $0.10
egvg3mTBBVzMHnJPIQiKcA: posts big blind $0.25
*** HOLE CARDS ***
RCqMONFrSPSArZh2Jsar/w: raises $0.25 to $0.50
z5GxcHlYz/GSz6W2uFiTtg has returned
tLcDklc2rBORNfixyRfVfw: folds 
sD+TKtt36XiiN6jqHiLwDA: folds 
zgi+EUykT/pZQpoUG6+oEg: folds 
9bCz0uv2nUmznwuI0OjVGw: calls $0.50
DnDcAdn9P0zGovMERigpFA: folds 
3PVK0IdMlq2fElkVzzr4bg: folds 
egvg3mTBBVzMHnJPIQiKcA: calls $0.25
*** FLOP *** [Ah Ac 2d]
egvg3mTBBVzMHnJPIQiKcA: checks 
RCqMONFrSPSArZh2Jsar/w: bets $0.50
9bCz0uv2nUmznwuI0OjVGw: folds 
egvg3mTBBVzMHnJPIQiKcA: folds 
Uncalled bet ($0.50) returned to RCqMONFrSPSArZh2Jsar/w
RCqMONFrSPSArZh2Jsar/w collected $1.55 from pot
RCqMONFrSPSArZh2Jsar/w: doesn't show hand 
*** SUMMARY ***
Total pot $1.60 | Rake $0.05 
Board [Ah Ac 2d]
Seat 1: sD+TKtt36XiiN6jqHiLwDA folded before Flop (didn't bet)
Seat 2: zgi+EUykT/pZQpoUG6+oEg folded before Flop (didn't bet)
Seat 4: 9bCz0uv2nUmznwuI0OjVGw folded on the Flop
Seat 5: DnDcAdn9P0zGovMERigpFA (button) folded before Flop (didn't bet)
Seat 6: 3PVK0IdMlq2fElkVzzr4bg (small blind) folded before Flop
Seat 7: egvg3mTBBVzMHnJPIQiKcA (big blind) folded on the Flop
Seat 8: RCqMONFrSPSArZh2Jsar/w collected ($1.55)
Seat 9: tLcDklc2rBORNfixyRfVfw folded before Flop (didn't bet)




PokerStars Game #59941926088:  Hold'em No Limit ($0.10/$0.25) - 2009/07/01 1:50:33 ET
Table 'Ez9TB43XM4QgMDQkIW9DYw' 9-max Seat #6 is the button
Seat 1: ShCS62CJp4MKfKLKvGKQbA ($11.55 in chips) 
Seat 2: PFNLAvMkr8qKc7xCiH0wTA ($17 in chips) 
Seat 3: PdIasPkzm2sqZnN41ZRXOg ($5 in chips) 
Seat 4: ubsjZomMWSV0hAiBLa7K1A ($20.45 in chips) 
Seat 6: 76o85YBHJ9veRYp2LPuluQ ($17.55 in chips) 
Seat 7: Bb42QRQMhg5/Y0vHP8/2Xw ($55.70 in chips) 
Seat 8: +2kMBNpY4nF1qNCRd8SJLA ($28.75 in chips) 
Seat 9: QEbIGci+itdw+re8RM5fZA ($25 in chips) 
Bb42QRQMhg5/Y0vHP8/2Xw: posts small blind $0.10
+2kMBNpY4nF1qNCRd8SJLA: posts big blind $0.25
18G4P1XstjNvItdGUITxgw: sits out 
*** HOLE CARDS ***
QEbIGci+itdw+re8RM5fZA: folds 
ShCS62CJp4MKfKLKvGKQbA: folds 
PFNLAvMkr8qKc7xCiH0wTA: folds 
PdIasPkzm2sqZnN41ZRXOg: raises $0.75 to $1
ubsjZomMWSV0hAiBLa7K1A: folds 
76o85YBHJ9veRYp2LPuluQ: calls $1
Bb42QRQMhg5/Y0vHP8/2Xw: folds 
+2kMBNpY4nF1qNCRd8SJLA: folds 
*** FLOP *** [4s 6d 4d]
PdIasPkzm2sqZnN41ZRXOg: bets $1.25
76o85YBHJ9veRYp2LPuluQ: folds 
Uncalled bet ($1.25) returned to PdIasPkzm2sqZnN41ZRXOg
PdIasPkzm2sqZnN41ZRXOg collected $2.25 from pot
PdIasPkzm2sqZnN41ZRXOg: doesn't show hand 
*** SUMMARY ***
Total pot $2.35 | Rake $0.10 
Board [4s 6d 4d]
Seat 1: ShCS62CJp4MKfKLKvGKQbA folded before Flop (didn't bet)
Seat 2: PFNLAvMkr8qKc7xCiH0wTA folded before Flop (didn't bet)
Seat 3: PdIasPkzm2sqZnN41ZRXOg collected ($2.25)
Seat 4: ubsjZomMWSV0hAiBLa7K1A folded before Flop (didn't bet)
Seat 6: 76o85YBHJ9veRYp2LPuluQ (button) folded on the Flop
Seat 7: Bb42QRQMhg5/Y0vHP8/2Xw (small blind) folded before Flop
Seat 8: +2kMBNpY4nF1qNCRd8SJLA (big blind) folded before Flop
Seat 9: QEbIGci+itdw+re8RM5fZA folded before Flop (didn't bet)




PokerStars Game #59941925668:  Hold'em No Limit ($0.10/$0.25) - 2009/07/01 1:50:33 ET
Table 'hOE09W281uSob0XeJmUcRg' 6-max Seat #1 is the button
Seat 1: mfrkWA3PTeYPkbO6hi98Aw ($26.60 in chips) 
Seat 2: lRKJ8o/CnOPFwfHHm6ioMw ($11.90 in chips) 
Seat 3: y+a/yGW/Jy4bPJFnaeTz5w ($12.10 in chips) 
Seat 5: JFIAqU8lCZ0vWwEl4bdGsg ($26.55 in chips) 
Seat 6: x4ZJ8E/TUrtoB7WiHcv8WA ($18.05 in chips) 
lRKJ8o/CnOPFwfHHm6ioMw: posts small blind $0.10
y+a/yGW/Jy4bPJFnaeTz5w: posts big blind $0.25
*** HOLE CARDS ***
JFIAqU8lCZ0vWwEl4bdGsg: folds 
x4ZJ8E/TUrtoB7WiHcv8WA: folds 
mfrkWA3PTeYPkbO6hi98Aw: folds 
lRKJ8o/CnOPFwfHHm6ioMw: folds 
Uncalled bet ($0.15) returned to y+a/yGW/Jy4bPJFnaeTz5w
y+a/yGW/Jy4bPJFnaeTz5w collected $0.20 from pot
y+a/yGW/Jy4bPJFnaeTz5w: doesn't show hand 
*** SUMMARY ***
Total pot $0.20 | Rake $0 
Seat 1: mfrkWA3PTeYPkbO6hi98Aw (button) folded before Flop (didn't bet)
Seat 2: lRKJ8o/CnOPFwfHHm6ioMw (small blind) folded before Flop
Seat 3: y+a/yGW/Jy4bPJFnaeTz5w (big blind) collected ($0.20)
Seat 5: JFIAqU8lCZ0vWwEl4bdGsg folded before Flop (didn't bet)
Seat 6: x4ZJ8E/TUrtoB7WiHcv8WA folded before Flop (didn't bet)




