PokerStars Game #59941546984:  Hold'em No Limit ($0.10/$0.25) - 2009/07/01 1:38:46 ET
Table '0mmHveGuaIfIMQlNE1eqMg' 9-max Seat #6 is the button
Seat 1: ydoFOVgzvZv9ZhuWu9rXAw ($4.90 in chips) 
Seat 2: rQhYIYXSyH/IivYM1dlV5A ($68.50 in chips) 
Seat 3: ghNKXUBl/H+t83JF079ZBA ($25 in chips) 
Seat 4: DnDcAdn9P0zGovMERigpFA ($36.35 in chips) 
Seat 6: 6RiVTYll/5D8zICp0MRpKw ($26.70 in chips) 
Seat 9: UNw/UrAelsQeSS17Rro/BA ($9.65 in chips) 
5n7e7I+px7c6CQmLpPbtsg will be allowed to play after the button
UNw/UrAelsQeSS17Rro/BA: posts small blind $0.10
ydoFOVgzvZv9ZhuWu9rXAw: posts big blind $0.25
*** HOLE CARDS ***
rQhYIYXSyH/IivYM1dlV5A: folds 
LuckyShot



PokerStars Game #59941546978:  Hold'em No Limit ($0.10/$0.25) - 2009/07/01 1:38:46 ET
Table 'sCop8wmj9zlSS2KJqk1QKQ' 9-max Seat #7 is the button
Seat 1: dtZ84flFEi4Q+SGrHMJRDQ ($29.80 in chips) 
Seat 2: YZaC69gFrepA6oCGtu7E0w ($22.95 in chips) 
Seat 3: OwQek9i+x54ZA6dn6e8qhg ($12.20 in chips) 
Seat 4: msUzkZl2RntUnTl6E8WaNA ($10.65 in chips) 
Seat 5: sD+TKtt36XiiN6jqHiLwDA ($24 in chips) 
Seat 6: hZuGwtYmFKPmQ+v1wlmdfA ($43.30 in chips) 
Seat 7: sx0lGrkT9fd4yFR+3cXUQg ($11.50 in chips) 
Seat 8: xnVwSkROfRtOw4eSoDANtw ($20.65 in chips) 
Seat 9: tLcDklc2rBORNfixyRfVfw ($25 in chips) 
xnVwSkROfRtOw4eSoDANtw: posts small blind $0.10
tLcDklc2rBORNfixyRfVfw: posts big blind $0.25
*** HOLE CARDS ***
dtZ84flFEi4Q+SGrHMJRDQ: folds 
YZaC69gFrepA6oCGtu7E0w: folds 
OwQek9i+x54ZA6dn6e8qhg: folds 
msUzkZl2RntUnTl6E8WaNA: folds 
sD+TKtt36XiiN6jqHiLwDA: folds 
hZuGwtYmFKPmQ+v1wlmdfA: folds 
sx0lGrkT9fd4yFR+3cXUQg: raises $0.50 to $0.75
xnVwSkROfRtOw4eSoDANtw: folds 
tLcDklc2rBORNfixyRfVfw: folds 
Uncalled bet ($0.50) returned to sx0lGrkT9fd4yFR+3cXUQg
sx0lGrkT9fd4yFR+3cXUQg collected $0.60 from pot
sx0lGrkT9fd4yFR+3cXUQg: doesn't show hand 
*** SUMMARY ***
Total pot $0.60 | Rake $0 
Seat 1: dtZ84flFEi4Q+SGrHMJRDQ folded before Flop (didn't bet)
Seat 2: YZaC69gFrepA6oCGtu7E0w folded before Flop (didn't bet)
Seat 3: OwQek9i+x54ZA6dn6e8qhg folded before Flop (didn't bet)
Seat 4: msUzkZl2RntUnTl6E8WaNA folded before Flop (didn't bet)
Seat 5: sD+TKtt36XiiN6jqHiLwDA folded before Flop (didn't bet)
Seat 6: hZuGwtYmFKPmQ+v1wlmdfA folded before Flop (didn't bet)
Seat 7: sx0lGrkT9fd4yFR+3cXUQg (button) collected ($0.60)
Seat 8: xnVwSkROfRtOw4eSoDANtw (small blind) folded before Flop
Seat 9: tLcDklc2rBORNfixyRfVfw (big blind) folded before Flop




PokerStars Game #59941547218:  Hold'em No Limit ($0.10/$0.25) - 2009/07/01 1:38:46 ET
Table 'aisAlB9GIV21BwfUW3+Nbg' 9-max Seat #2 is the button
Seat 1: SqibpGx+lf+brY0fJVvD0w ($24.65 in chips) 
Seat 2: +7GnIVpCmyuij3NJfOgsTw ($12.40 in chips) 
Seat 3: CvL9Ch1HYCVbTsfpNucitg ($4.05 in chips) 
Seat 4: sD+TKtt36XiiN6jqHiLwDA ($26.55 in chips) 
Seat 5: ghNKXUBl/H+t83JF079ZBA ($27.75 in chips) 
Seat 6: 9gmYYQesalMrUjaF7nKfrQ ($16.55 in chips) 
Seat 7: jGjM+5lCSe6f2MEwxQGOAg ($38.55 in chips) 
Seat 8: VWUWpMLMj/Q1jRVpF7Aohw ($12.50 in chips) 
Seat 9: N0hGpTAEAj9k5msS6LPLAw ($10.75 in chips) 
CvL9Ch1HYCVbTsfpNucitg: posts small blind $0.10
sD+TKtt36XiiN6jqHiLwDA: posts big blind $0.25
*** HOLE CARDS ***
ghNKXUBl/H+t83JF079ZBA: folds 
9gmYYQesalMrUjaF7nKfrQ: folds 
jGjM+5lCSe6f2MEwxQGOAg: raises $0.25 to $0.50
VWUWpMLMj/Q1jRVpF7Aohw: folds 
N0hGpTAEAj9k5msS6LPLAw: folds 
SqibpGx+lf+brY0fJVvD0w: folds 
+7GnIVpCmyuij3NJfOgsTw: folds 
CvL9Ch1HYCVbTsfpNucitg: raises $1.50 to $2
sD+TKtt36XiiN6jqHiLwDA: folds 
jGjM+5lCSe6f2MEwxQGOAg: folds 
Uncalled bet ($1.50) returned to CvL9Ch1HYCVbTsfpNucitg
CvL9Ch1HYCVbTsfpNucitg collected $1.25 from pot
CvL9Ch1HYCVbTsfpNucitg: doesn't show hand 
*** SUMMARY ***
Total pot $1.25 | Rake $0 
Seat 1: SqibpGx+lf+brY0fJVvD0w folded before Flop (didn't bet)
Seat 2: +7GnIVpCmyuij3NJfOgsTw (button) folded before Flop (didn't bet)
Seat 3: CvL9Ch1HYCVbTsfpNucitg (small blind) collected ($1.25)
Seat 4: sD+TKtt36XiiN6jqHiLwDA (big blind) folded before Flop
Seat 5: ghNKXUBl/H+t83JF079ZBA folded before Flop (didn't bet)
Seat 6: 9gmYYQesalMrUjaF7nKfrQ folded before Flop (didn't bet)
Seat 7: jGjM+5lCSe6f2MEwxQGOAg folded before Flop
Seat 8: VWUWpMLMj/Q1jRVpF7Aohw folded before Flop (didn't bet)
Seat 9: N0hGpTAEAj9k5msS6LPLAw folded before Flop (didn't bet)




PokerStars Game #59941547178:  Hold'em No Limit ($0.10/$0.25) - 2009/07/01 1:38:46 ET
Table 'fIMYcWwN4/aXFJvH5Z8Ymg' 6-max Seat #4 is the button
Seat 1: DihMHaz4WNETH1bPDe13kA ($25.35 in chips) 
Seat 2: vu2kzHaDtgr6NM7rdq0chA ($26.45 in chips) 
Seat 4: 32YL2ZEp8NT4JB2RVM9euQ ($42.75 in chips) 
Seat 5: lquriepNQBhDV5P1SWHhnA ($25 in chips) 
Seat 6: jp34e617tIzV8tKIWmfAbA ($27.90 in chips) 
lquriepNQBhDV5P1SWHhnA: posts small blind $0.10
jp34e617tIzV8tKIWmfAbA: posts big blind $0.25
*** HOLE CARDS ***
DihMHaz4WNETH1bPDe13kA: folds 
vu2kzHaDtgr6NM7rdq0chA: raises $1 to $1.25
32YL2ZEp8NT4JB2RVM9euQ: folds 
lquriepNQBhDV5P1SWHhnA: folds 
jp34e617tIzV8tKIWmfAbA: folds 
Uncalled bet ($1) returned to vu2kzHaDtgr6NM7rdq0chA
vu2kzHaDtgr6NM7rdq0chA collected $0.60 from pot
bWbV4MVB/vVpiES1Ut4hew has returned
*** SUMMARY ***
Total pot $0.60 | Rake $0 
Seat 1: DihMHaz4WNETH1bPDe13kA folded before Flop (didn't bet)
Seat 2: vu2kzHaDtgr6NM7rdq0chA collected ($0.60)
Seat 4: 32YL2ZEp8NT4JB2RVM9euQ (button) folded before Flop (didn't bet)
Seat 5: lquriepNQBhDV5P1SWHhnA (small blind) folded before Flop
Seat 6: jp34e617tIzV8tKIWmfAbA (big blind) folded before Flop




PokerStars Game #59941547812:  Hold'em No Limit ($0.10/$0.25) - 2009/07/01 1:38:47 ET
Table '+VTTYgQLH1awDHk+IAxqGg' 9-max Seat #3 is the button
Seat 1: arxNSjreDRGFg13EAM2F1w ($25.75 in chips) 
Seat 2: 2wcFsZsqEP5w1StUTVzJCg ($5.40 in chips) 
Seat 3: AiXn/9o1EwOPZUHujnh/bA ($18.65 in chips) 
Seat 4: gE5rN2TDY1aXcZn/TOPeZw ($8.90 in chips) 
Seat 5: sD+TKtt36XiiN6jqHiLwDA ($24.15 in chips) 
Seat 7: ljemhp25Zg+nlA9DLCIiUw ($24.90 in chips) 
Seat 8: 10vzP4r6ldwGLbYHKd9www ($18.25 in chips) 
Seat 9: S7Ki0P+0AIGPuIfGJjW0gg ($56.15 in chips) 
gE5rN2TDY1aXcZn/TOPeZw: posts small blind $0.10
sD+TKtt36XiiN6jqHiLwDA: posts big blind $0.25
*** HOLE CARDS ***
ljemhp25Zg+nlA9DLCIiUw: calls $0.25
10vzP4r6ldwGLbYHKd9www: calls $0.25
S7Ki0P+0AIGPuIfGJjW0gg: folds 
arxNSjreDRGFg13EAM2F1w: folds 
2wcFsZsqEP5w1StUTVzJCg: folds 
AiXn/9o1EwOPZUHujnh/bA: folds 
gE5rN2TDY1aXcZn/TOPeZw: folds 
sD+TKtt36XiiN6jqHiLwDA: checks 
*** FLOP *** [8s Qc Qd]
sD+TKtt36XiiN6jqHiLwDA: checks 
ljemhp25Zg+nlA9DLCIiUw: checks 
10vzP4r6ldwGLbYHKd9www: checks 
*** TURN *** [8s Qc Qd] [As]
sD+TKtt36XiiN6jqHiLwDA: checks 
ljemhp25Zg+nlA9DLCIiUw: checks 
10vzP4r6ldwGLbYHKd9www: checks 
*** RIVER *** [8s Qc Qd As] [Jc]
sD+TKtt36XiiN6jqHiLwDA: checks 
ljemhp25Zg+nlA9DLCIiUw: bets $0.75
10vzP4r6ldwGLbYHKd9www: folds 
sD+TKtt36XiiN6jqHiLwDA: calls $0.75
*** SHOW DOWN ***
ljemhp25Zg+nlA9DLCIiUw: shows [Kc Jh] (two pair, Queens and Jacks)
sD+TKtt36XiiN6jqHiLwDA: shows [5c Ac] (two pair, Aces and Queens)
sD+TKtt36XiiN6jqHiLwDA collected $2.25 from pot
*** SUMMARY ***
Total pot $2.35 | Rake $0.10 
Board [8s Qc Qd As Jc]
Seat 1: arxNSjreDRGFg13EAM2F1w folded before Flop (didn't bet)
Seat 2: 2wcFsZsqEP5w1StUTVzJCg folded before Flop (didn't bet)
Seat 3: AiXn/9o1EwOPZUHujnh/bA (button) folded before Flop (didn't bet)
Seat 4: gE5rN2TDY1aXcZn/TOPeZw (small blind) folded before Flop
Seat 5: sD+TKtt36XiiN6jqHiLwDA (big blind) showed [5c Ac] and won ($2.25) with two pair, Aces and Queens
Seat 7: ljemhp25Zg+nlA9DLCIiUw showed [Kc Jh] and lost with two pair, Queens and Jacks
Seat 8: 10vzP4r6ldwGLbYHKd9www folded on the River
Seat 9: S7Ki0P+0AIGPuIfGJjW0gg folded before Flop (didn't bet)




PokerStars Game #59941547484:  Hold'em No Limit ($0.10/$0.25) - 2009/07/01 1:38:47 ET
Table 'AUM6O+mgQAaLDZKMQ/5/gA' 9-max Seat #7 is the button
Seat 1: EIObtVVE4WXRXvLGJA6NHw ($18.55 in chips) 
Seat 2: OXPkK84/qv92EMwXPiG5rQ ($9.50 in chips) 
Seat 3: CvL9Ch1HYCVbTsfpNucitg ($3.75 in chips) 
Seat 4: 4awUyiDYTgylQKXZ9faBVA ($28.05 in chips) 
Seat 5: +2kMBNpY4nF1qNCRd8SJLA ($25.65 in chips) 
Seat 6: v5jnQ1gfh9nLla3kMXG7Yg ($7.95 in chips) 
Seat 7: Bb42QRQMhg5/Y0vHP8/2Xw ($30.60 in chips) 
Seat 8: zDrucyjVn5aeekNEc3cJrA ($17.50 in chips) 
Seat 9: eK8qa6EPcH2zhtbmWSvc9g ($25 in chips) 
zDrucyjVn5aeekNEc3cJrA: posts small blind $0.10
eK8qa6EPcH2zhtbmWSvc9g: posts big blind $0.25
*** HOLE CARDS ***
zDrucyjVn5aeekNEc3cJrA said, "nh"
EIObtVVE4WXRXvLGJA6NHw: raises $0.50 to $0.75
OXPkK84/qv92EMwXPiG5rQ: folds 
CvL9Ch1HYCVbTsfpNucitg: folds 
4awUyiDYTgylQKXZ9faBVA: folds 
+2kMBNpY4nF1qNCRd8SJLA: folds 
v5jnQ1gfh9nLla3kMXG7Yg: folds 
Bb42QRQMhg5/Y0vHP8/2Xw: folds 
zDrucyjVn5aeekNEc3cJrA: folds 
eK8qa6EPcH2zhtbmWSvc9g: calls $0.50
*** FLOP *** [7h 6d 3s]
eK8qa6EPcH2zhtbmWSvc9g: checks 
EIObtVVE4WXRXvLGJA6NHw: checks 
*** TURN *** [7h 6d 3s] [2h]
eK8qa6EPcH2zhtbmWSvc9g: checks 
EIObtVVE4WXRXvLGJA6NHw: checks 
*** RIVER *** [7h 6d 3s 2h] [Jc]
eK8qa6EPcH2zhtbmWSvc9g: bets $0.75
EIObtVVE4WXRXvLGJA6NHw: folds 
Uncalled bet ($0.75) returned to eK8qa6EPcH2zhtbmWSvc9g
eK8qa6EPcH2zhtbmWSvc9g collected $1.55 from pot
eK8qa6EPcH2zhtbmWSvc9g: doesn't show hand 
*** SUMMARY ***
Total pot $1.60 | Rake $0.05 
Board [7h 6d 3s 2h Jc]
Seat 1: EIObtVVE4WXRXvLGJA6NHw folded on the River
Seat 2: OXPkK84/qv92EMwXPiG5rQ folded before Flop (didn't bet)
Seat 3: CvL9Ch1HYCVbTsfpNucitg folded before Flop (didn't bet)
Seat 4: 4awUyiDYTgylQKXZ9faBVA folded before Flop (didn't bet)
Seat 5: +2kMBNpY4nF1qNCRd8SJLA folded before Flop (didn't bet)
Seat 6: v5jnQ1gfh9nLla3kMXG7Yg folded before Flop (didn't bet)
Seat 7: Bb42QRQMhg5/Y0vHP8/2Xw (button) folded before Flop (didn't bet)
Seat 8: zDrucyjVn5aeekNEc3cJrA (small blind) folded before Flop
Seat 9: eK8qa6EPcH2zhtbmWSvc9g (big blind) collected ($1.55)




PokerStars Game #59941547542:  Hold'em No Limit ($0.10/$0.25) - 2009/07/01 1:38:47 ET
Table '6wawJ+MkkvuC3coG6r+Yhg' 6-max Seat #6 is the button
Seat 1: JQZew0FjzS19kTjeNtrE+A ($25 in chips) 
Seat 2: LtASJ9OlkqGrrUKGQlpGAw ($33.95 in chips) 
Seat 3: 3zD3qLXT1bEffAoWGnc7wg ($60.70 in chips) 
Seat 4: yxmjNFGiKI3b+XQGJzJVIg ($29.05 in chips) 
Seat 5: FZrgDbxAanC1xwZxXHJKVA ($4.10 in chips) 
Seat 6: B3X187C0tXFUfQpCu8pe8A ($27.10 in chips) 
JQZew0FjzS19kTjeNtrE+A: posts small blind $0.10
LtASJ9OlkqGrrUKGQlpGAw: posts big blind $0.25
*** HOLE CARDS ***
3zD3qLXT1bEffAoWGnc7wg: folds 
yxmjNFGiKI3b+XQGJzJVIg: folds 
FZrgDbxAanC1xwZxXHJKVA: calls $0.25
B3X187C0tXFUfQpCu8pe8A: calls $0.25
JQZew0FjzS19kTjeNtrE+A: folds 
LtASJ9OlkqGrrUKGQlpGAw: checks 
*** FLOP *** [As 7h 5s]
LtASJ9OlkqGrrUKGQlpGAw: checks 
FZrgDbxAanC1xwZxXHJKVA: bets $0.25
B3X187C0tXFUfQpCu8pe8A: calls $0.25
LtASJ9OlkqGrrUKGQlpGAw: folds 
*** TURN *** [As 7h 5s] [4c]
FZrgDbxAanC1xwZxXHJKVA: bets $0.50
B3X187C0tXFUfQpCu8pe8A: calls $0.50
*** RIVER *** [As 7h 5s 4c] [5c]
FZrgDbxAanC1xwZxXHJKVA: checks 
B3X187C0tXFUfQpCu8pe8A: bets $1
FZrgDbxAanC1xwZxXHJKVA: folds 
Uncalled bet ($1) returned to B3X187C0tXFUfQpCu8pe8A
B3X187C0tXFUfQpCu8pe8A collected $2.25 from pot
*** SUMMARY ***
Total pot $2.35 | Rake $0.10 
Board [As 7h 5s 4c 5c]
Seat 1: JQZew0FjzS19kTjeNtrE+A (small blind) folded before Flop
Seat 2: LtASJ9OlkqGrrUKGQlpGAw (big blind) folded on the Flop
Seat 3: 3zD3qLXT1bEffAoWGnc7wg folded before Flop (didn't bet)
Seat 4: yxmjNFGiKI3b+XQGJzJVIg folded before Flop (didn't bet)
Seat 5: FZrgDbxAanC1xwZxXHJKVA folded on the River
Seat 6: B3X187C0tXFUfQpCu8pe8A (button) collected ($2.25)




PokerStars Game #59941547604:  Hold'em No Limit ($0.10/$0.25) - 2009/07/01 1:38:47 ET
Table 'ukli1Y7ieC5JQMTEFxM2Nw' 6-max Seat #4 is the button
Seat 1: N162H80ZIQevUf2EzGahCA ($10.70 in chips) 
Seat 2: u/yN5P9f3KlATg6WLWNkBQ ($43.40 in chips) 
Seat 3: ExeoJ1G/rSmWa3tRz7TlCA ($22.45 in chips) 
Seat 4: if4dh6jhJXeN3/qd3qCp9g ($29.85 in chips) 
Seat 5: Se+H4Z4PDr6+eIUDJX1rpg ($13.75 in chips) 
Seat 6: 32YL2ZEp8NT4JB2RVM9euQ ($29.90 in chips) 
Se+H4Z4PDr6+eIUDJX1rpg: posts small blind $0.10
32YL2ZEp8NT4JB2RVM9euQ: posts big blind $0.25
*** HOLE CARDS ***
N162H80ZIQevUf2EzGahCA: folds 
u/yN5P9f3KlATg6WLWNkBQ: folds 
ExeoJ1G/rSmWa3tRz7TlCA: folds 
if4dh6jhJXeN3/qd3qCp9g: folds 
Se+H4Z4PDr6+eIUDJX1rpg: calls $0.15
32YL2ZEp8NT4JB2RVM9euQ: checks 
*** FLOP *** [Ac 8h 4h]
Se+H4Z4PDr6+eIUDJX1rpg: checks 
32YL2ZEp8NT4JB2RVM9euQ: checks 
*** TURN *** [Ac 8h 4h] [9c]
Se+H4Z4PDr6+eIUDJX1rpg: bets $0.25
32YL2ZEp8NT4JB2RVM9euQ: folds 
Uncalled bet ($0.25) returned to Se+H4Z4PDr6+eIUDJX1rpg
Se+H4Z4PDr6+eIUDJX1rpg collected $0.50 from pot
*** SUMMARY ***
Total pot $0.50 | Rake $0 
Board [Ac 8h 4h 9c]
Seat 1: N162H80ZIQevUf2EzGahCA folded before Flop (didn't bet)
Seat 2: u/yN5P9f3KlATg6WLWNkBQ folded before Flop (didn't bet)
Seat 3: ExeoJ1G/rSmWa3tRz7TlCA folded before Flop (didn't bet)
Seat 4: if4dh6jhJXeN3/qd3qCp9g (button) folded before Flop (didn't bet)
Seat 5: Se+H4Z4PDr6+eIUDJX1rpg (small blind) collected ($0.50)
Seat 6: 32YL2ZEp8NT4JB2RVM9euQ (big blind) folded on the Turn




PokerStars Game #59941547896:  Hold'em No Limit ($0.10/$0.25) - 2009/07/01 1:38:47 ET
Table 'biAgO3TKQBU8XcrVAoU5TA' 6-max Seat #3 is the button
Seat 1: jhDPlkir8wBYAddboBuF7Q ($16.25 in chips) 
Seat 2: GbCVUNssQ7mqsPWr7J4d3w ($4.65 in chips) 
Seat 3: mfrkWA3PTeYPkbO6hi98Aw ($30.65 in chips) 
Seat 4: Hsvkc0/G2VV78oVmWYXecw ($5 in chips) 
Seat 5: n6UPMnVR4v8LFP0rWP73Fg ($13.05 in chips) 
Seat 6: wMiE3yTbDJGOLOF9th7KPA ($10 in chips) 
Hsvkc0/G2VV78oVmWYXecw: posts small blind $0.10
n6UPMnVR4v8LFP0rWP73Fg: posts big blind $0.25
wMiE3yTbDJGOLOF9th7KPA: posts big blind $0.25
*** HOLE CARDS ***
wMiE3yTbDJGOLOF9th7KPA: checks 
jhDPlkir8wBYAddboBuF7Q: folds 
GbCVUNssQ7mqsPWr7J4d3w: folds 
mfrkWA3PTeYPkbO6hi98Aw: folds 
Hsvkc0/G2VV78oVmWYXecw: folds 
n6UPMnVR4v8LFP0rWP73Fg: checks 
*** FLOP *** [4h 6d Qd]
n6UPMnVR4v8LFP0rWP73Fg: checks 
wMiE3yTbDJGOLOF9th7KPA: bets $0.50
n6UPMnVR4v8LFP0rWP73Fg: folds 
Uncalled bet ($0.50) returned to wMiE3yTbDJGOLOF9th7KPA
wMiE3yTbDJGOLOF9th7KPA collected $0.60 from pot
*** SUMMARY ***
Total pot $0.60 | Rake $0 
Board [4h 6d Qd]
Seat 1: jhDPlkir8wBYAddboBuF7Q folded before Flop (didn't bet)
Seat 2: GbCVUNssQ7mqsPWr7J4d3w folded before Flop (didn't bet)
Seat 3: mfrkWA3PTeYPkbO6hi98Aw (button) folded before Flop (didn't bet)
Seat 4: Hsvkc0/G2VV78oVmWYXecw (small blind) folded before Flop
Seat 5: n6UPMnVR4v8LFP0rWP73Fg (big blind) folded on the Flop
Seat 6: wMiE3yTbDJGOLOF9th7KPA collected ($0.60)




PokerStars Game #59941547574:  Hold'em No Limit ($0.10/$0.25) - 2009/07/01 1:38:47 ET
Table 'mk323gviqdkOY5Aek/1EWg' 6-max Seat #5 is the button
Seat 1: L3/N/gliETan8N5Gim5h4Q ($25 in chips) 
Seat 2: GC/9yVD59DUCX7hUI7gcLw ($56.05 in chips) 
Seat 3: NuqYPwTLZYQhxOoVK3Yqlw ($24.65 in chips) 
Seat 4: +baiVgI/ETnBARLe5mARCw ($13.40 in chips) 
Seat 5: kjYRzIfvZNNflYMYRkkSVA ($26.15 in chips) 
Seat 6: KkXSr5xFjxLSD3wtAvT+WQ ($9.05 in chips) 
KkXSr5xFjxLSD3wtAvT+WQ: posts small blind $0.10
L3/N/gliETan8N5Gim5h4Q: posts big blind $0.25
*** HOLE CARDS ***
GC/9yVD59DUCX7hUI7gcLw: folds 
NuqYPwTLZYQhxOoVK3Yqlw: folds 
+baiVgI/ETnBARLe5mARCw: calls $0.25
kjYRzIfvZNNflYMYRkkSVA: folds 
KkXSr5xFjxLSD3wtAvT+WQ: calls $0.15
L3/N/gliETan8N5Gim5h4Q: checks 
*** FLOP *** [5s 9d Jd]
KkXSr5xFjxLSD3wtAvT+WQ: checks 
L3/N/gliETan8N5Gim5h4Q: checks 
+baiVgI/ETnBARLe5mARCw: checks 
*** TURN *** [5s 9d Jd] [Qh]
KkXSr5xFjxLSD3wtAvT+WQ: checks 
L3/N/gliETan8N5Gim5h4Q: bets $0.50
+baiVgI/ETnBARLe5mARCw: folds 
KkXSr5xFjxLSD3wtAvT+WQ: folds 
Uncalled bet ($0.50) returned to L3/N/gliETan8N5Gim5h4Q
L3/N/gliETan8N5Gim5h4Q collected $0.75 from pot
L3/N/gliETan8N5Gim5h4Q: doesn't show hand 
*** SUMMARY ***
Total pot $0.75 | Rake $0 
Board [5s 9d Jd Qh]
Seat 1: L3/N/gliETan8N5Gim5h4Q (big blind) collected ($0.75)
Seat 2: GC/9yVD59DUCX7hUI7gcLw folded before Flop (didn't bet)
Seat 3: NuqYPwTLZYQhxOoVK3Yqlw folded before Flop (didn't bet)
Seat 4: +baiVgI/ETnBARLe5mARCw folded on the Turn
Seat 5: kjYRzIfvZNNflYMYRkkSVA (button) folded before Flop (didn't bet)
Seat 6: KkXSr5xFjxLSD3wtAvT+WQ (small blind) folded on the Turn




PokerStars Game #59941548534:  Hold'em No Limit ($0.10/$0.25) - 2009/07/01 1:38:48 ET
Table 'GxdLtCpYxqT4aAbYqkEEpw' 6-max Seat #6 is the button
Seat 1: 2d/PU00mMdO9azAaXqcSbw ($14.35 in chips) 
Seat 2: 3iomNWHjIokoWh6JNWCUJQ ($4 in chips) 
Seat 3: LpmZGzLpOmfZUF7EV4ZlrQ ($15.70 in chips) 
Seat 4: 6wzJiRvp8HY6t+MQGnSIzA ($5.35 in chips) 
Seat 5: q6WfTUAD9mowIP63ASq2Dg ($35.10 in chips) 
Seat 6: DFi/Lzkjsfv8QswS80JX9Q ($25 in chips) 
2d/PU00mMdO9azAaXqcSbw: posts small blind $0.10
3iomNWHjIokoWh6JNWCUJQ: posts big blind $0.25
*** HOLE CARDS ***
LpmZGzLpOmfZUF7EV4ZlrQ: calls $0.25
6wzJiRvp8HY6t+MQGnSIzA: folds 
q6WfTUAD9mowIP63ASq2Dg: folds 
DFi/Lzkjsfv8QswS80JX9Q: folds 
2d/PU00mMdO9azAaXqcSbw: folds 
3iomNWHjIokoWh6JNWCUJQ: checks 
*** FLOP *** [9s Td 5h]
3iomNWHjIokoWh6JNWCUJQ: checks 
LpmZGzLpOmfZUF7EV4ZlrQ: checks 
*** TURN *** [9s Td 5h] [3d]
3iomNWHjIokoWh6JNWCUJQ: checks 
LpmZGzLpOmfZUF7EV4ZlrQ: checks 
*** RIVER *** [9s Td 5h 3d] [6s]
3iomNWHjIokoWh6JNWCUJQ: checks 
LpmZGzLpOmfZUF7EV4ZlrQ: checks 
*** SHOW DOWN ***
3iomNWHjIokoWh6JNWCUJQ: shows [Qc 8d] (high card Queen)
LpmZGzLpOmfZUF7EV4ZlrQ: shows [Js Ks] (high card King)
LpmZGzLpOmfZUF7EV4ZlrQ collected $0.60 from pot
*** SUMMARY ***
Total pot $0.60 | Rake $0 
Board [9s Td 5h 3d 6s]
Seat 1: 2d/PU00mMdO9azAaXqcSbw (small blind) folded before Flop
Seat 2: 3iomNWHjIokoWh6JNWCUJQ (big blind) showed [Qc 8d] and lost with high card Queen
Seat 3: LpmZGzLpOmfZUF7EV4ZlrQ showed [Js Ks] and won ($0.60) with high card King
Seat 4: 6wzJiRvp8HY6t+MQGnSIzA folded before Flop (didn't bet)
Seat 5: q6WfTUAD9mowIP63ASq2Dg folded before Flop (didn't bet)
Seat 6: DFi/Lzkjsfv8QswS80JX9Q (button) folded before Flop (didn't bet)




PokerStars Game #59941548466:  Hold'em No Limit ($0.10/$0.25) - 2009/07/01 1:38:48 ET
Table '9o8Yb3JpUqurD4pNVmOikQ' 6-max Seat #5 is the button
Seat 1: SFmT9ZsVopnukjvAzrxTRg ($25.35 in chips) 
Seat 2: /gJNBeCkWL4o85/jvlZ4BA ($25 in chips) 
Seat 3: JgRqo1/2phbf7pab7N3BIQ ($21.75 in chips) 
Seat 4: j5NZbEJHsERuXjPHWqc1Nw ($8.75 in chips) 
Seat 5: L/ayP3FdbcybmfF6diPHaA ($19.05 in chips) 
Seat 6: LyDHtw3/yniNHW+DvLXbog ($26.15 in chips) 
LyDHtw3/yniNHW+DvLXbog: posts small blind $0.10
SFmT9ZsVopnukjvAzrxTRg: posts big blind $0.25
*** HOLE CARDS ***
/gJNBeCkWL4o85/jvlZ4BA: folds 
JgRqo1/2phbf7pab7N3BIQ: calls $0.25
j5NZbEJHsERuXjPHWqc1Nw: folds 
L/ayP3FdbcybmfF6diPHaA: calls $0.25
LyDHtw3/yniNHW+DvLXbog: folds 
SFmT9ZsVopnukjvAzrxTRg: checks 
*** FLOP *** [7d 6h 2h]
SFmT9ZsVopnukjvAzrxTRg: checks 
JgRqo1/2phbf7pab7N3BIQ: checks 
L/ayP3FdbcybmfF6diPHaA: checks 
*** TURN *** [7d 6h 2h] [5s]
SFmT9ZsVopnukjvAzrxTRg: checks 
JgRqo1/2phbf7pab7N3BIQ: checks 
L/ayP3FdbcybmfF6diPHaA: checks 
*** RIVER *** [7d 6h 2h 5s] [Td]
SFmT9ZsVopnukjvAzrxTRg: checks 
JgRqo1/2phbf7pab7N3BIQ: checks 
L/ayP3FdbcybmfF6diPHaA: checks 
*** SHOW DOWN ***
SFmT9ZsVopnukjvAzrxTRg: shows [Tc 8c] (a pair of Tens)
JgRqo1/2phbf7pab7N3BIQ: mucks hand 
L/ayP3FdbcybmfF6diPHaA: mucks hand 
SFmT9ZsVopnukjvAzrxTRg collected $0.85 from pot
*** SUMMARY ***
Total pot $0.85 | Rake $0 
Board [7d 6h 2h 5s Td]
Seat 1: SFmT9ZsVopnukjvAzrxTRg (big blind) showed [Tc 8c] and won ($0.85) with a pair of Tens
Seat 2: /gJNBeCkWL4o85/jvlZ4BA folded before Flop (didn't bet)
Seat 3: JgRqo1/2phbf7pab7N3BIQ mucked
Seat 4: j5NZbEJHsERuXjPHWqc1Nw folded before Flop (didn't bet)
Seat 5: L/ayP3FdbcybmfF6diPHaA (button) mucked
Seat 6: LyDHtw3/yniNHW+DvLXbog (small blind) folded before Flop




PokerStars Game #59941548390:  Hold'em No Limit ($0.10/$0.25) - 2009/07/01 1:38:48 ET
Table 'Jz+kWRxWNGk9w24fdQEveA' 9-max Seat #9 is the button
Seat 2: ljemhp25Zg+nlA9DLCIiUw ($38.95 in chips) 
Seat 3: sGFnnRCa1YAHAUmWgsW6Qg ($8.55 in chips) 
Seat 4: HPEB+AtKw1+C/cxU0o1ciw ($28.75 in chips) 
Seat 5: d6eSA7wOH5mRaSyVDVRBLw ($10 in chips) 
Seat 6: c/6hFCyfLNRn3VFvCeQ1ng ($4.70 in chips) 
Seat 7: wGigCmBR/9XWkPpvYos3aQ ($27 in chips) 
Seat 8: j4q3p0lesp63b1gZDwLBZw ($5 in chips) 
Seat 9: V6p0jQ/RhUsqpHLmXvEX4Q ($17 in chips) 
ljemhp25Zg+nlA9DLCIiUw: posts small blind $0.10
sGFnnRCa1YAHAUmWgsW6Qg: posts big blind $0.25
d6eSA7wOH5mRaSyVDVRBLw: posts big blind $0.25
*** HOLE CARDS ***
HPEB+AtKw1+C/cxU0o1ciw: folds 
d6eSA7wOH5mRaSyVDVRBLw: checks 
c/6hFCyfLNRn3VFvCeQ1ng: calls $0.25
wGigCmBR/9XWkPpvYos3aQ: folds 
j4q3p0lesp63b1gZDwLBZw: folds 
V6p0jQ/RhUsqpHLmXvEX4Q: folds 
ljemhp25Zg+nlA9DLCIiUw: folds 
sGFnnRCa1YAHAUmWgsW6Qg: checks 
*** FLOP *** [2d Th 7c]
sGFnnRCa1YAHAUmWgsW6Qg: checks 
d6eSA7wOH5mRaSyVDVRBLw: checks 
c/6hFCyfLNRn3VFvCeQ1ng: checks 
*** TURN *** [2d Th 7c] [Ks]
sGFnnRCa1YAHAUmWgsW6Qg: checks 
d6eSA7wOH5mRaSyVDVRBLw: bets $0.50
c/6hFCyfLNRn3VFvCeQ1ng: folds 
c/6hFCyfLNRn3VFvCeQ1ng is sitting out
sGFnnRCa1YAHAUmWgsW6Qg: folds 
Uncalled bet ($0.50) returned to d6eSA7wOH5mRaSyVDVRBLw
d6eSA7wOH5mRaSyVDVRBLw collected $0.85 from pot
d6eSA7wOH5mRaSyVDVRBLw: doesn't show hand 
DigiSlarks joins the table at seat #1 
*** SUMMARY ***
Total pot $0.85 | Rake $0 
Board [2d Th 7c Ks]
Seat 2: ljemhp25Zg+nlA9DLCIiUw (small blind) folded before Flop
Seat 3: sGFnnRCa1YAHAUmWgsW6Qg (big blind) folded on the Turn
Seat 4: HPEB+AtKw1+C/cxU0o1ciw folded before Flop (didn't bet)
Seat 5: d6eSA7wOH5mRaSyVDVRBLw collected ($0.85)
Seat 6: c/6hFCyfLNRn3VFvCeQ1ng folded on the Turn
Seat 7: wGigCmBR/9XWkPpvYos3aQ folded before Flop (didn't bet)
Seat 8: j4q3p0lesp63b1gZDwLBZw folded before Flop (didn't bet)
Seat 9: V6p0jQ/RhUsqpHLmXvEX4Q (button) folded before Flop (didn't bet)




PokerStars Game #59941548764:  Hold'em No Limit ($0.10/$0.25) - 2009/07/01 1:38:49 ET
Table 'rpIHGyt2QpgQc5bvptAvDQ' 9-max Seat #6 is the button
Seat 4: 6OWBjDlgUYW33/gXaOLrMQ ($4.75 in chips) 
Seat 5: z2SmIaQ3+5n/eY1BN5HgPg ($10.70 in chips) 
Seat 6: Mq1ESwxx3LEsA4HjKKjU3Q ($15.85 in chips) 
6OWBjDlgUYW33/gXaOLrMQ: posts small blind $0.10
z2SmIaQ3+5n/eY1BN5HgPg: posts big blind $0.25
*** HOLE CARDS ***
Mq1ESwxx3LEsA4HjKKjU3Q: folds 
6OWBjDlgUYW33/gXaOLrMQ: calls $0.15
z2SmIaQ3+5n/eY1BN5HgPg: raises $0.50 to $0.75
6OWBjDlgUYW33/gXaOLrMQ: calls $0.50
*** FLOP *** [7s 4c As]
6OWBjDlgUYW33/gXaOLrMQ: bets $0.25
OzXv12vW3/jO5rPU5mJHQg joins the table at seat #3 
z2SmIaQ3+5n/eY1BN5HgPg: raises $2.75 to $3
6OWBjDlgUYW33/gXaOLrMQ: raises $1 to $4 and is all-in
z2SmIaQ3+5n/eY1BN5HgPg: calls $1
*** TURN *** [7s 4c As] [2h]
*** RIVER *** [7s 4c As 2h] [Kh]
*** SHOW DOWN ***
6OWBjDlgUYW33/gXaOLrMQ: shows [7h 6d] (a pair of Sevens)
z2SmIaQ3+5n/eY1BN5HgPg: shows [Jc Kd] (a pair of Kings)
z2SmIaQ3+5n/eY1BN5HgPg collected $9.05 from pot
*** SUMMARY ***
Total pot $9.50 | Rake $0.45 
Board [7s 4c As 2h Kh]
Seat 4: 6OWBjDlgUYW33/gXaOLrMQ (small blind) showed [7h 6d] and lost with a pair of Sevens
Seat 5: z2SmIaQ3+5n/eY1BN5HgPg (big blind) showed [Jc Kd] and won ($9.05) with a pair of Kings
Seat 6: Mq1ESwxx3LEsA4HjKKjU3Q (button) folded before Flop (didn't bet)




PokerStars Game #59941549420:  Hold'em No Limit ($0.10/$0.25) - 2009/07/01 1:38:50 ET
Table 'SbSV5tlgLp0+/Z+13PW3Hg' 9-max Seat #9 is the button
Seat 1: x+W5+3qsdY4Iszf0hoH+Aw ($14.35 in chips) 
Seat 2: zDrucyjVn5aeekNEc3cJrA ($14.15 in chips) 
Seat 3: CT7Xj/V/O5rBlhtt+RZeFQ ($25 in chips) 
Seat 4: puj3K/wrNjEj86ZL/MyfLA ($10.75 in chips) 
Seat 7: ruosoLPCzPyA3nfXoPVY3Q ($1.35 in chips) 
Seat 8: qBdqLaJhO+1itcMk70bsfA ($8.90 in chips) 
Seat 9: X78b5v/uhqeXXoAijbw/yg ($25 in chips) 
x+W5+3qsdY4Iszf0hoH+Aw: posts small blind $0.10
zDrucyjVn5aeekNEc3cJrA: posts big blind $0.25
aNpwfA31EREwO+ar4XzBCw: sits out 
pN3IHvAKm2fz+sTRARTcrg: sits out 
*** HOLE CARDS ***
CT7Xj/V/O5rBlhtt+RZeFQ: folds 
puj3K/wrNjEj86ZL/MyfLA: calls $0.25
ruosoLPCzPyA3nfXoPVY3Q: folds 
qBdqLaJhO+1itcMk70bsfA: folds 
X78b5v/uhqeXXoAijbw/yg: folds 
x+W5+3qsdY4Iszf0hoH+Aw: calls $0.15
zDrucyjVn5aeekNEc3cJrA: checks 
*** FLOP *** [2d 3d 9h]
x+W5+3qsdY4Iszf0hoH+Aw: checks 
zDrucyjVn5aeekNEc3cJrA: checks 
puj3K/wrNjEj86ZL/MyfLA: checks 
*** TURN *** [2d 3d 9h] [As]
x+W5+3qsdY4Iszf0hoH+Aw: bets $0.50
zDrucyjVn5aeekNEc3cJrA: folds 
puj3K/wrNjEj86ZL/MyfLA: folds 
Uncalled bet ($0.50) returned to x+W5+3qsdY4Iszf0hoH+Aw
x+W5+3qsdY4Iszf0hoH+Aw collected $0.75 from pot
x+W5+3qsdY4Iszf0hoH+Aw: doesn't show hand 
*** SUMMARY ***
Total pot $0.75 | Rake $0 
Board [2d 3d 9h As]
Seat 1: x+W5+3qsdY4Iszf0hoH+Aw (small blind) collected ($0.75)
Seat 2: zDrucyjVn5aeekNEc3cJrA (big blind) folded on the Turn
Seat 3: CT7Xj/V/O5rBlhtt+RZeFQ folded before Flop (didn't bet)
Seat 4: puj3K/wrNjEj86ZL/MyfLA folded on the Turn
Seat 7: ruosoLPCzPyA3nfXoPVY3Q folded before Flop (didn't bet)
Seat 8: qBdqLaJhO+1itcMk70bsfA folded before Flop (didn't bet)
Seat 9: X78b5v/uhqeXXoAijbw/yg (button) folded before Flop (didn't bet)




PokerStars Game #59941549388:  Hold'em No Limit ($0.10/$0.25) - 2009/07/01 1:38:50 ET
Table 'oG007Tb0LYbfANo6QWd16wWEMI3Mtn7dGARDbgNrKibgx Seat #5 is the button
Seat 1: DiSvPC2iudwL5j9u6Huyww ($25 in chips) 
Seat 2: zDrucyjVn5aeekNEc3cJrA ($14.50 in chips) 
Seat 4: zgi+EUykT/pZQpoUG6+oEg ($4.40 in chips) 
Seat 5: 8f0dtuUGqDbgE6up1lQAlg ($6.60 in chips) 
Seat 6: 66x/U2lStcsdcsOvKlLBlg ($32.60 in chips) 
Seat 8: q4cNXFZGNhLfrTyVrIy6Mg ($9.85 in chips) 
Seat 9: EVqHvqty1ZsuvDFiSXlSqQ ($20.20 in chips) 
66x/U2lStcsdcsOvKlLBlg: posts small blind $0.10
8GJHzzxiotOqC5gdtgpLoA: is sitting out 
q4cNXFZGNhLfrTyVrIy6Mg: posts big blind $0.25
pN3IHvAKm2fz+sTRARTcrg: sits out 
*** HOLE CARDS ***
8GJHzzxiotOqC5gdtgpLoA leaves the table
EVqHvqty1ZsuvDFiSXlSqQ: folds 
DiSvPC2iudwL5j9u6Huyww: raises $0.50 to $0.75
zDrucyjVn5aeekNEc3cJrA: folds 
zgi+EUykT/pZQpoUG6+oEg: folds 
Mh2r9hTeTEDnh19sRZtW3g joins the table at seat #7 
8f0dtuUGqDbgE6up1lQAlg: folds 
66x/U2lStcsdcsOvKlLBlg: calls $0.65
q4cNXFZGNhLfrTyVrIy6Mg: calls $0.50
*** FLOP *** [8d 5s 8s]
66x/U2lStcsdcsOvKlLBlg: checks 
q4cNXFZGNhLfrTyVrIy6Mg: checks 
DiSvPC2iudwL5j9u6Huyww: checks 
*** TURN *** [8d 5s 8s] [7h]
66x/U2lStcsdcsOvKlLBlg: bets $0.75
q4cNXFZGNhLfrTyVrIy6Mg: folds 
DiSvPC2iudwL5j9u6Huyww: calls $0.75
*** RIVER *** [8d 5s 8s 7h] [Kd]
66x/U2lStcsdcsOvKlLBlg: checks 
DiSvPC2iudwL5j9u6Huyww: bets $3
66x/U2lStcsdcsOvKlLBlg: raises $3 to $6
DiSvPC2iudwL5j9u6Huyww: raises $12 to $18
66x/U2lStcsdcsOvKlLBlg: raises $13.10 to $31.10 and is all-in
DiSvPC2iudwL5j9u6Huyww: calls $5.50 and is all-in
Uncalled bet ($7.60) returned to 66x/U2lStcsdcsOvKlLBlg
*** SHOW DOWN ***
66x/U2lStcsdcsOvKlLBlg: shows [Js 8c] (three of a kind, Eights)
DiSvPC2iudwL5j9u6Huyww: shows [7d 7s] (a full house, Sevens full of Eights)
66x/U2lStcsdcsOvKlLBlg is sitting out
DiSvPC2iudwL5j9u6Huyww collected $48.25 from pot
*** SUMMARY ***
Total pot $50.75 | Rake $2.50 
Board [8d 5s 8s 7h Kd]
Seat 1: DiSvPC2iudwL5j9u6Huyww showed [7d 7s] and won ($48.25) with a full house, Sevens full of Eights
Seat 2: zDrucyjVn5aeekNEc3cJrA folded before Flop (didn't bet)
Seat 4: zgi+EUykT/pZQpoUG6+oEg folded before Flop (didn't bet)
Seat 5: 8f0dtuUGqDbgE6up1lQAlg (button) folded before Flop (didn't bet)
Seat 6: 66x/U2lStcsdcsOvKlLBlg (small blind) showed [Js 8c] and lost with three of a kind, Eights
Seat 8: q4cNXFZGNhLfrTyVrIy6Mg (big blind) folded on the Turn
Seat 9: EVqHvqty1ZsuvDFiSXlSqQ folded before Flop (didn't bet)




PokerStars Game #59941549670:  Hold'em No Limit ($0.10/$0.25) - 2009/07/01 1:38:50 ET
Table 'IuqVbFI+pwnJjvwBCGSGAw' 6-max Seat #4 is the button
Seat 1: LyDHtw3/yniNHW+DvLXbog ($25 in chips) 
Seat 2: wsP46AGpqDjHZQmlRHKa9g ($25.45 in chips) 
Seat 3: QiL+lEgEWwy21jk/ltaRLg ($20 in chips) 
Seat 4: PyCrZReM7eeeXYMDUF//PA ($2.50 in chips) 
Seat 5: if4dh6jhJXeN3/qd3qCp9g ($29.60 in chips) 
Seat 6: SJ5z7oeRzpbFT7jU55Mbag ($27.90 in chips) 
if4dh6jhJXeN3/qd3qCp9g: posts small blind $0.10
SJ5z7oeRzpbFT7jU55Mbag: posts big blind $0.25
PyCrZReM7eeeXYMDUF//PA said, "fkin flop it when i have kk"
PyCrZReM7eeeXYMDUF//PA said, "diamond"
SJ5z7oeRzpbFT7jU55Mbag said, "lol"
QiL+lEgEWwy21jk/ltaRLg: posts big blind $0.25
*** HOLE CARDS ***
LyDHtw3/yniNHW+DvLXbog: folds 
wsP46AGpqDjHZQmlRHKa9g: folds 
QiL+lEgEWwy21jk/ltaRLg: checks 
PyCrZReM7eeeXYMDUF//PA: raises $2.25 to $2.50 and is all-in
if4dh6jhJXeN3/qd3qCp9g: folds 
SJ5z7oeRzpbFT7jU55Mbag: folds 
QiL+lEgEWwy21jk/ltaRLg: calls $2.25
*** FLOP *** [5c 2s 2c]
*** TURN *** [5c 2s 2c] [Ah]
*** RIVER *** [5c 2s 2c Ah] [6c]
*** SHOW DOWN ***
QiL+lEgEWwy21jk/ltaRLg: shows [8c 8s] (two pair, Eights and Deuces)
PyCrZReM7eeeXYMDUF//PA: mucks hand 
QiL+lEgEWwy21jk/ltaRLg collected $5.10 from pot
PyCrZReM7eeeXYMDUF//PA leaves the table
*** SUMMARY ***
Total pot $5.35 | Rake $0.25 
Board [5c 2s 2c Ah 6c]
Seat 1: LyDHtw3/yniNHW+DvLXbog folded before Flop (didn't bet)
Seat 2: wsP46AGpqDjHZQmlRHKa9g folded before Flop (didn't bet)
Seat 3: QiL+lEgEWwy21jk/ltaRLg showed [8c 8s] and won ($5.10) with two pair, Eights and Deuces
Seat 4: PyCrZReM7eeeXYMDUF//PA (button) mucked
Seat 5: if4dh6jhJXeN3/qd3qCp9g (small blind) folded before Flop
Seat 6: SJ5z7oeRzpbFT7jU55Mbag (big blind) folded before Flop




PokerStars Game #59941549516:  Hold'em No Limit ($0.10/$0.25) - 2009/07/01 1:38:50 ET
Table '2clPgY3+dETPD/8zjXZdFw' 6-max Seat #4 is the button
Seat 1: 4WFKzsjLSGnvHbVxKabsvQ ($25 in chips) 
Seat 2: cWc85bEzdRzpUMhRKm8pwQ ($25 in chips) 
Seat 3: SFmT9ZsVopnukjvAzrxTRg ($25 in chips) 
Seat 4: ljjhtb6FVPTx9AT9HNdtqg ($21.65 in chips) 
Seat 5: LJI7A1YgDM7hgh7o56+ReQ ($25 in chips) 
Seat 6: 2G0C7dp4wlPpE21FHjjElQ ($26.90 in chips) 
LJI7A1YgDM7hgh7o56+ReQ: posts small blind $0.10
2G0C7dp4wlPpE21FHjjElQ: posts big blind $0.25
*** HOLE CARDS ***
4WFKzsjLSGnvHbVxKabsvQ: folds 
cWc85bEzdRzpUMhRKm8pwQ: folds 
SFmT9ZsVopnukjvAzrxTRg: folds 
ljjhtb6FVPTx9AT9HNdtqg: folds 
LJI7A1YgDM7hgh7o56+ReQ: folds 
Uncalled bet ($0.15) returned to 2G0C7dp4wlPpE21FHjjElQ
2G0C7dp4wlPpE21FHjjElQ collected $0.20 from pot
2G0C7dp4wlPpE21FHjjElQ: doesn't show hand 
*** SUMMARY ***
Total pot $0.20 | Rake $0 
Seat 1: 4WFKzsjLSGnvHbVxKabsvQ folded before Flop (didn't bet)
Seat 2: cWc85bEzdRzpUMhRKm8pwQ folded before Flop (didn't bet)
Seat 3: SFmT9ZsVopnukjvAzrxTRg folded before Flop (didn't bet)
Seat 4: ljjhtb6FVPTx9AT9HNdtqg (button) folded before Flop (didn't bet)
Seat 5: LJI7A1YgDM7hgh7o56+ReQ (small blind) folded before Flop
Seat 6: 2G0C7dp4wlPpE21FHjjElQ (big blind) collected ($0.20)




PokerStars Game #59941549382:  Hold'em No Limit ($0.10/$0.25) - 2009/07/01 1:38:50 ET
Table '1HT8bEDpLPhOXxmqMtzF8w' 9-max Seat #9 is the button
Seat 1: YkkKQUDI0iWatY4h0WWaAQ ($9.80 in chips) 
Seat 2: r6hsffOo1iKmaPYKwAZmFw ($29.35 in chips) 
Seat 3: oLa/tXLfSLLB28mcLGrxcg ($25.10 in chips) 
Seat 4: aNpwfA31EREwO+ar4XzBCw ($25.35 in chips) 
Seat 5: CT2YIt3dXaE9eOIkS7FwNw ($24.65 in chips) 
Seat 7: PMhmqYBPHOAXjH25lRz69g ($20.45 in chips) 
Seat 8: ghNKXUBl/H+t83JF079ZBA ($25 in chips) 
Seat 9: a2TmTivbjy207qYNGTay8g ($5.85 in chips) 
YkkKQUDI0iWatY4h0WWaAQ: posts small blind $0.10
r6hsffOo1iKmaPYKwAZmFw: posts big blind $0.25
bXpVeaSTPBFSPJmeXxO7nw: sits out 
*** HOLE CARDS ***
oLa/tXLfSLLB28mcLGrxcg: folds 
aNpwfA31EREwO+ar4XzBCw: folds 
CT2YIt3dXaE9eOIkS7FwNw: folds 
PMhmqYBPHOAXjH25lRz69g: folds 
ghNKXUBl/H+t83JF079ZBA: folds 
a2TmTivbjy207qYNGTay8g: raises $0.25 to $0.50
YkkKQUDI0iWatY4h0WWaAQ: calls $0.40
r6hsffOo1iKmaPYKwAZmFw: folds 
*** FLOP *** [Jh Ts 7s]
YkkKQUDI0iWatY4h0WWaAQ: checks 
a2TmTivbjy207qYNGTay8g: checks 
*** TURN *** [Jh Ts 7s] [Ad]
YkkKQUDI0iWatY4h0WWaAQ: bets $0.75
a2TmTivbjy207qYNGTay8g: calls $0.75
*** RIVER *** [Jh Ts 7s Ad] [7h]
YkkKQUDI0iWatY4h0WWaAQ: bets $1.25
a2TmTivbjy207qYNGTay8g: folds 
Uncalled bet ($1.25) returned to YkkKQUDI0iWatY4h0WWaAQ
YkkKQUDI0iWatY4h0WWaAQ collected $2.65 from pot
*** SUMMARY ***
Total pot $2.75 | Rake $0.10 
Board [Jh Ts 7s Ad 7h]
Seat 1: YkkKQUDI0iWatY4h0WWaAQ (small blind) collected ($2.65)
Seat 2: r6hsffOo1iKmaPYKwAZmFw (big blind) folded before Flop
Seat 3: oLa/tXLfSLLB28mcLGrxcg folded before Flop (didn't bet)
Seat 4: aNpwfA31EREwO+ar4XzBCw folded before Flop (didn't bet)
Seat 5: CT2YIt3dXaE9eOIkS7FwNw folded before Flop (didn't bet)
Seat 7: PMhmqYBPHOAXjH25lRz69g folded before Flop (didn't bet)
Seat 8: ghNKXUBl/H+t83JF079ZBA folded before Flop (didn't bet)
Seat 9: a2TmTivbjy207qYNGTay8g (button) folded on the River




PokerStars Game #59941549234:  Hold'em No Limit ($0.10/$0.25) - 2009/07/01 1:38:50 ET
Table 'nlpa8xI95gAflovnFxB2yg' 6-max Seat #5 is the button
Seat 1: fZQg9veL7Dd/Z04ZTjC+wQ ($64.20 in chips) 
Seat 2: Yuyy/pDz3yAO3EbHYRYnKw ($25.30 in chips) 
Seat 3: DihMHaz4WNETH1bPDe13kA ($25.80 in chips) 
Seat 5: FDWzjQgBA5K04jOIY/j22w ($9.20 in chips) 
Seat 6: ATNFxN8fYVfSZMQW8dvbvw ($5.50 in chips) 
ATNFxN8fYVfSZMQW8dvbvw: posts small blind $0.10
fZQg9veL7Dd/Z04ZTjC+wQ: posts big blind $0.25
if4dh6jhJXeN3/qd3qCp9g: sits out 
*** HOLE CARDS ***
Yuyy/pDz3yAO3EbHYRYnKw: folds 
DihMHaz4WNETH1bPDe13kA: folds 
FDWzjQgBA5K04jOIY/j22w: folds 
ATNFxN8fYVfSZMQW8dvbvw: raises $0.50 to $0.75
fZQg9veL7Dd/Z04ZTjC+wQ: calls $0.50
*** FLOP *** [5h 5d 8s]
ATNFxN8fYVfSZMQW8dvbvw: bets $0.25
fZQg9veL7Dd/Z04ZTjC+wQ: calls $0.25
*** TURN *** [5h 5d 8s] [Qs]
ATNFxN8fYVfSZMQW8dvbvw: bets $0.25
fZQg9veL7Dd/Z04ZTjC+wQ: calls $0.25
*** RIVER *** [5h 5d 8s Qs] [Ks]
ATNFxN8fYVfSZMQW8dvbvw: checks 
fZQg9veL7Dd/Z04ZTjC+wQ: checks 
*** SHOW DOWN ***
ATNFxN8fYVfSZMQW8dvbvw: shows [Ac Ts] (a pair of Fives)
fZQg9veL7Dd/Z04ZTjC+wQ: mucks hand 
ATNFxN8fYVfSZMQW8dvbvw collected $2.40 from pot
*** SUMMARY ***
Total pot $2.50 | Rake $0.10 
Board [5h 5d 8s Qs Ks]
Seat 1: fZQg9veL7Dd/Z04ZTjC+wQ (big blind) mucked
Seat 2: Yuyy/pDz3yAO3EbHYRYnKw folded before Flop (didn't bet)
Seat 3: DihMHaz4WNETH1bPDe13kA folded before Flop (didn't bet)
Seat 5: FDWzjQgBA5K04jOIY/j22w (button) folded before Flop (didn't bet)
Seat 6: ATNFxN8fYVfSZMQW8dvbvw (small blind) showed [Ac Ts] and won ($2.40) with a pair of Fives




PokerStars Game #59941549222:  Hold'em No Limit ($0.10/$0.25) - 2009/07/01 1:38:50 ET
Table 'a6FCGVBMPcT7J7BDN9q1zQ' 9-max Seat #4 is the button
Seat 1: zgi+EUykT/pZQpoUG6+oEg ($5.15 in chips) 
Seat 2: M2QO2DxB5Wawg2h8HSpnYA ($10 in chips) 
Seat 3: tLcDklc2rBORNfixyRfVfw ($26.15 in chips) 
Seat 4: 8CoKLhwk8Ja6X+O9fxTEDg ($11.30 in chips) 
Seat 5: dtZ84flFEi4Q+SGrHMJRDQ ($27.30 in chips) 
Seat 6: dfNim92Z6XK1/h5SFW5vDg ($25.50 in chips) 
Seat 7: V0Yo5zRBVM8DYspLKafebg ($4.95 in chips) 
Seat 8: r6hsffOo1iKmaPYKwAZmFw ($69.40 in chips) 
Seat 9: wGigCmBR/9XWkPpvYos3aQ ($28.70 in chips) 
dtZ84flFEi4Q+SGrHMJRDQ: posts small blind $0.10
dfNim92Z6XK1/h5SFW5vDg: posts big blind $0.25
*** HOLE CARDS ***
V0Yo5zRBVM8DYspLKafebg: calls $0.25
r6hsffOo1iKmaPYKwAZmFw: folds 
wGigCmBR/9XWkPpvYos3aQ: folds 
zgi+EUykT/pZQpoUG6+oEg: folds 
M2QO2DxB5Wawg2h8HSpnYA: folds 
tLcDklc2rBORNfixyRfVfw: folds 
8CoKLhwk8Ja6X+O9fxTEDg: folds 
dtZ84flFEi4Q+SGrHMJRDQ: calls $0.15
dfNim92Z6XK1/h5SFW5vDg: checks 
*** FLOP *** [5c Ah 8d]
dtZ84flFEi4Q+SGrHMJRDQ: checks 
dfNim92Z6XK1/h5SFW5vDg: checks 
V0Yo5zRBVM8DYspLKafebg: checks 
*** TURN *** [5c Ah 8d] [Qd]
dtZ84flFEi4Q+SGrHMJRDQ: checks 
dfNim92Z6XK1/h5SFW5vDg: checks 
V0Yo5zRBVM8DYspLKafebg: checks 
*** RIVER *** [5c Ah 8d Qd] [Qs]
dtZ84flFEi4Q+SGrHMJRDQ: checks 
dfNim92Z6XK1/h5SFW5vDg: checks 
V0Yo5zRBVM8DYspLKafebg: checks 
*** SHOW DOWN ***
dtZ84flFEi4Q+SGrHMJRDQ: shows [9s 4s] (a pair of Queens)
dfNim92Z6XK1/h5SFW5vDg: shows [Kd Ts] (a pair of Queens - Ace+King kicker)
V0Yo5zRBVM8DYspLKafebg: mucks hand 
dfNim92Z6XK1/h5SFW5vDg collected $0.75 from pot
*** SUMMARY ***
Total pot $0.75 | Rake $0 
Board [5c Ah 8d Qd Qs]
Seat 1: zgi+EUykT/pZQpoUG6+oEg folded before Flop (didn't bet)
Seat 2: M2QO2DxB5Wawg2h8HSpnYA folded before Flop (didn't bet)
Seat 3: tLcDklc2rBORNfixyRfVfw folded before Flop (didn't bet)
Seat 4: 8CoKLhwk8Ja6X+O9fxTEDg (button) folded before Flop (didn't bet)
Seat 5: dtZ84flFEi4Q+SGrHMJRDQ (small blind) showed [9s 4s] and lost with a pair of Queens
Seat 6: dfNim92Z6XK1/h5SFW5vDg (big blind) showed [Kd Ts] and won ($0.75) with a pair of Queens
Seat 7: V0Yo5zRBVM8DYspLKafebg mucked
Seat 8: r6hsffOo1iKmaPYKwAZmFw folded before Flop (didn't bet)
Seat 9: wGigCmBR/9XWkPpvYos3aQ folded before Flop (didn't bet)




PokerStars Game #59941549994:  Hold'em No Limit ($0.10/$0.25) - 2009/07/01 1:38:51 ET
Table 'z2yOdY2zyGWG1gh9WV9XtQ' 9-max Seat #5 is the button
Seat 1: 7je+LC5Mfs6nL8YBVh4frQ ($5 in chips) 
Seat 2: bXpVeaSTPBFSPJmeXxO7nw ($5 in chips) 
Seat 3: X78b5v/uhqeXXoAijbw/yg ($27.40 in chips) 
Seat 4: 4awUyiDYTgylQKXZ9faBVA ($39.45 in chips) 
Seat 5: W6tExOcYX7qiy6Qdp+ZwFA ($10.55 in chips) 
Seat 6: NBYmTySMtIicyMj5Vjzqhw ($21.90 in chips) 
Seat 7: zDrucyjVn5aeekNEc3cJrA ($23.70 in chips) 
Seat 8: Mh2r9hTeTEDnh19sRZtW3g ($3.75 in chips) 
Seat 9: wGigCmBR/9XWkPpvYos3aQ ($37.80 in chips) 
NBYmTySMtIicyMj5Vjzqhw: posts small blind $0.10
zDrucyjVn5aeekNEc3cJrA: posts big blind $0.25
*** HOLE CARDS ***
Mh2r9hTeTEDnh19sRZtW3g: raises $0.75 to $1
wGigCmBR/9XWkPpvYos3aQ: calls $1
7je+LC5Mfs6nL8YBVh4frQ: folds 
bXpVeaSTPBFSPJmeXxO7nw: folds 
X78b5v/uhqeXXoAijbw/yg: folds 
4awUyiDYTgylQKXZ9faBVA: folds 
W6tExOcYX7qiy6Qdp+ZwFA: folds 
NBYmTySMtIicyMj5Vjzqhw: folds 
zDrucyjVn5aeekNEc3cJrA: folds 
*** FLOP *** [Qd 3d Qs]
Mh2r9hTeTEDnh19sRZtW3g: bets $2.75 and is all-in
wGigCmBR/9XWkPpvYos3aQ: calls $2.75
*** TURN *** [Qd 3d Qs] [Kh]
*** RIVER *** [Qd 3d Qs Kh] [Jc]
*** SHOW DOWN ***
Mh2r9hTeTEDnh19sRZtW3g: shows [Qh Ah] (three of a kind, Queens)
wGigCmBR/9XWkPpvYos3aQ: mucks hand 
Mh2r9hTeTEDnh19sRZtW3g collected $7.50 from pot
*** SUMMARY ***
Total pot $7.85 | Rake $0.35 
Board [Qd 3d Qs Kh Jc]
Seat 1: 7je+LC5Mfs6nL8YBVh4frQ folded before Flop (didn't bet)
Seat 2: bXpVeaSTPBFSPJmeXxO7nw folded before Flop (didn't bet)
Seat 3: X78b5v/uhqeXXoAijbw/yg folded before Flop (didn't bet)
Seat 4: 4awUyiDYTgylQKXZ9faBVA folded before Flop (didn't bet)
Seat 5: W6tExOcYX7qiy6Qdp+ZwFA (button) folded before Flop (didn't bet)
Seat 6: NBYmTySMtIicyMj5Vjzqhw (small blind) folded before Flop
Seat 7: zDrucyjVn5aeekNEc3cJrA (big blind) folded before Flop
Seat 8: Mh2r9hTeTEDnh19sRZtW3g showed [Qh Ah] and won ($7.50) with three of a kind, Queens
Seat 9: wGigCmBR/9XWkPpvYos3aQ mucked




PokerStars Game #59941549822:  Hold'em No Limit ($0.10/$0.25) - 2009/07/01 1:38:51 ET
Table 'dNYnr4D4id1jwnEU66Yowg' 9-max Seat #8 is the button
Seat 1: 9lvO/qyU+xrU95Teu1fv0g ($5 in chips) 
Seat 2: KBBTLXGhPdPj+4X0QKMkcg ($2.30 in chips) 
Seat 3: cq6LACCDFivk2+PeoiB2sw ($10.85 in chips) 
Seat 4: VBHxUExRAMrbxUq/cVx9Gw ($5.05 in chips) 
Seat 5: 7cv+9Zc9HIQHNvYsMfV3uA ($25.70 in chips) 
Seat 7: DiSvPC2iudwL5j9u6Huyww ($25.80 in chips) 
Seat 8: RCqMONFrSPSArZh2Jsar/w ($19.65 in chips) 
Seat 9: K0dyGSZP/cgeQjH6o6u9Rw ($16.05 in chips) 
K0dyGSZP/cgeQjH6o6u9Rw: posts small blind $0.10
9lvO/qyU+xrU95Teu1fv0g: posts big blind $0.25
8EbrQ/EvFWt2cr0GaU82gQ: sits out 
*** HOLE CARDS ***
KBBTLXGhPdPj+4X0QKMkcg: folds 
cq6LACCDFivk2+PeoiB2sw: folds 
VBHxUExRAMrbxUq/cVx9Gw: folds 
7cv+9Zc9HIQHNvYsMfV3uA: folds 
DiSvPC2iudwL5j9u6Huyww: folds 
RCqMONFrSPSArZh2Jsar/w: raises $0.50 to $0.75
K0dyGSZP/cgeQjH6o6u9Rw: folds 
9lvO/qyU+xrU95Teu1fv0g: folds 
Uncalled bet ($0.50) returned to RCqMONFrSPSArZh2Jsar/w
RCqMONFrSPSArZh2Jsar/w collected $0.60 from pot
RCqMONFrSPSArZh2Jsar/w: doesn't show hand 
*** SUMMARY ***
Total pot $0.60 | Rake $0 
Seat 1: 9lvO/qyU+xrU95Teu1fv0g (big blind) folded before Flop
Seat 2: KBBTLXGhPdPj+4X0QKMkcg folded before Flop (didn't bet)
Seat 3: cq6LACCDFivk2+PeoiB2sw folded before Flop (didn't bet)
Seat 4: VBHxUExRAMrbxUq/cVx9Gw folded before Flop (didn't bet)
Seat 5: 7cv+9Zc9HIQHNvYsMfV3uA folded before Flop (didn't bet)
Seat 7: DiSvPC2iudwL5j9u6Huyww folded before Flop (didn't bet)
Seat 8: RCqMONFrSPSArZh2Jsar/w (button) collected ($0.60)
Seat 9: K0dyGSZP/cgeQjH6o6u9Rw (small blind) folded before Flop




PokerStars Game #59941550130:  Hold'em No Limit ($0.10/$0.25) - 2009/07/01 1:38:51 ET
Table 'FuFyQHmlO/QqQp//rDRrPg' 6-max Seat #4 is the button
Seat 1: jp34e617tIzV8tKIWmfAbA ($26.55 in chips) 
Seat 3: EeUZtMU058v2ObUACOF4Og ($30.60 in chips) 
Seat 4: OMGl+YMGogf2JWIRfT2/Yg ($4.25 in chips) 
Seat 5: xrf8tAXKQHG99HixCot1Iw ($20.50 in chips) 
Seat 6: 6DwBRH+xZ12AAZmeAg+aXw ($60 in chips) 
xrf8tAXKQHG99HixCot1Iw: posts small blind $0.10
6DwBRH+xZ12AAZmeAg+aXw: posts big blind $0.25
G3h3THGB1j3qdHDVHpnJWg: sits out 
*** HOLE CARDS ***
jp34e617tIzV8tKIWmfAbA: folds 
EeUZtMU058v2ObUACOF4Og: folds 
OMGl+YMGogf2JWIRfT2/Yg: calls $0.25
xrf8tAXKQHG99HixCot1Iw: calls $0.15
6DwBRH+xZ12AAZmeAg+aXw: checks 
*** FLOP *** [Qd 2s 7d]
xrf8tAXKQHG99HixCot1Iw: checks 
6DwBRH+xZ12AAZmeAg+aXw: checks 
OMGl+YMGogf2JWIRfT2/Yg: bets $0.75
xrf8tAXKQHG99HixCot1Iw: folds 
6DwBRH+xZ12AAZmeAg+aXw: folds 
Uncalled bet ($0.75) returned to OMGl+YMGogf2JWIRfT2/Yg
OMGl+YMGogf2JWIRfT2/Yg collected $0.75 from pot
OMGl+YMGogf2JWIRfT2/Yg: doesn't show hand 
*** SUMMARY ***
Total pot $0.75 | Rake $0 
Board [Qd 2s 7d]
Seat 1: jp34e617tIzV8tKIWmfAbA folded before Flop (didn't bet)
Seat 3: EeUZtMU058v2ObUACOF4Og folded before Flop (didn't bet)
Seat 4: OMGl+YMGogf2JWIRfT2/Yg (button) collected ($0.75)
Seat 5: xrf8tAXKQHG99HixCot1Iw (small blind) folded on the Flop
Seat 6: 6DwBRH+xZ12AAZmeAg+aXw (big blind) folded on the Flop




PokerStars Game #59941550046:  Hold'em No Limit ($0.10/$0.25) - 2009/07/01 1:38:51 ET
Table '0M5QEJGOThqZwQ/sjbjXYw' 6-max Seat #2 is the button
Seat 1: 2G0C7dp4wlPpE21FHjjElQ ($25.60 in chips) 
Seat 2: /gJNBeCkWL4o85/jvlZ4BA ($37.70 in chips) 
Seat 3: 3zD3qLXT1bEffAoWGnc7wg ($25 in chips) 
Seat 4: oBUDUfeUyCbZBsjxHZgSiw ($23.65 in chips) 
Seat 5: cWc85bEzdRzpUMhRKm8pwQ ($27.35 in chips) 
Seat 6: mYz11CHiw5KsDCRD5T7/jg ($42.15 in chips) 
3zD3qLXT1bEffAoWGnc7wg: posts small blind $0.10
oBUDUfeUyCbZBsjxHZgSiw: posts big blind $0.25
*** HOLE CARDS ***
cWc85bEzdRzpUMhRKm8pwQ: folds 
mYz11CHiw5KsDCRD5T7/jg: folds 
2G0C7dp4wlPpE21FHjjElQ: folds 
/gJNBeCkWL4o85/jvlZ4BA: raises $0.75 to $1
3zD3qLXT1bEffAoWGnc7wg: folds 
oBUDUfeUyCbZBsjxHZgSiw: raises $2 to $3
/gJNBeCkWL4o85/jvlZ4BA: folds 
Uncalled bet ($2) returned to oBUDUfeUyCbZBsjxHZgSiw
oBUDUfeUyCbZBsjxHZgSiw collected $2.10 from pot
*** SUMMARY ***
Total pot $2.10 | Rake $0 
Seat 1: 2G0C7dp4wlPpE21FHjjElQ folded before Flop (didn't bet)
Seat 2: /gJNBeCkWL4o85/jvlZ4BA (button) folded before Flop
Seat 3: 3zD3qLXT1bEffAoWGnc7wg (small blind) folded before Flop
Seat 4: oBUDUfeUyCbZBsjxHZgSiw (big blind) collected ($2.10)
Seat 5: cWc85bEzdRzpUMhRKm8pwQ folded before Flop (didn't bet)
Seat 6: mYz11CHiw5KsDCRD5T7/jg folded before Flop (didn't bet)




PokerStars Game #59941550492:  Hold'em No Limit ($0.10/$0.25) - 2009/07/01 1:38:52 ET
Table 'IRgQPZVA4+IaZZIQshgwyg' 6-max Seat #5 is the button
Seat 1: cezpHJ8FB07dj0xG+LhOvw ($28.25 in chips) 
Seat 2: lquriepNQBhDV5P1SWHhnA ($25.35 in chips) 
Seat 3: DihMHaz4WNETH1bPDe13kA ($28.80 in chips) 
Seat 4: DE9hRlt14g+JdsRQ4wT7hg ($27.50 in chips) 
Seat 5: PbMzPZIePKifKQZfKDkbIw ($28.80 in chips) 
Seat 6: XbIIdTtuN1xO7zurECHBTg ($10.30 in chips) 
XbIIdTtuN1xO7zurECHBTg: posts small blind $0.10
cezpHJ8FB07dj0xG+LhOvw: posts big blind $0.25
*** HOLE CARDS ***
lquriepNQBhDV5P1SWHhnA: folds 
DihMHaz4WNETH1bPDe13kA: folds 
DE9hRlt14g+JdsRQ4wT7hg: folds 
PbMzPZIePKifKQZfKDkbIw: folds 
XbIIdTtuN1xO7zurECHBTg: calls $0.15
cezpHJ8FB07dj0xG+LhOvw: checks 
*** FLOP *** [Ts Td Ah]
XbIIdTtuN1xO7zurECHBTg: checks 
cezpHJ8FB07dj0xG+LhOvw: checks 
*** TURN *** [Ts Td Ah] [Tc]
XbIIdTtuN1xO7zurECHBTg: bets $0.75
cezpHJ8FB07dj0xG+LhOvw: folds 
Uncalled bet ($0.75) returned to XbIIdTtuN1xO7zurECHBTg
XbIIdTtuN1xO7zurECHBTg collected $0.50 from pot
XbIIdTtuN1xO7zurECHBTg: doesn't show hand 
*** SUMMARY ***
Total pot $0.50 | Rake $0 
Board [Ts Td Ah Tc]
Seat 1: cezpHJ8FB07dj0xG+LhOvw (big blind) folded on the Turn
Seat 2: lquriepNQBhDV5P1SWHhnA folded before Flop (didn't bet)
Seat 3: DihMHaz4WNETH1bPDe13kA folded before Flop (didn't bet)
Seat 4: DE9hRlt14g+JdsRQ4wT7hg folded before Flop (didn't bet)
Seat 5: PbMzPZIePKifKQZfKDkbIw (button) folded before Flop (didn't bet)
Seat 6: XbIIdTtuN1xO7zurECHBTg (small blind) collected ($0.50)




PokerStars Game #59941550454:  Hold'em No Limit ($0.10/$0.25) - 2009/07/01 1:38:52 ET
Table 'by7aHYEDnDd144EXOXa/jA' 9-max Seat #2 is the button
Seat 1: j4q3p0lesp63b1gZDwLBZw ($6.60 in chips) 
Seat 2: vSkQm2EelzwRGDDQQk0Fqw ($5 in chips) 
Seat 3: HOEaXncFu2ij+D5/CANAZA ($12.90 in chips) 
Seat 5: yyG4svzOpC1A+sUP/scg6w ($4.35 in chips) 
Seat 6: sC4BsflLWW26Qm9m+1AwJQ ($12.15 in chips) 
Seat 7: V6p0jQ/RhUsqpHLmXvEX4Q ($22.55 in chips) 
Seat 8: 7je+LC5Mfs6nL8YBVh4frQ ($4 in chips) 
Seat 9: K0b5wNInj6hUGRr6yzKFtw ($26.65 in chips) 
HOEaXncFu2ij+D5/CANAZA: posts small blind $0.10
yyG4svzOpC1A+sUP/scg6w: posts big blind $0.25
*** HOLE CARDS ***
sC4BsflLWW26Qm9m+1AwJQ: folds 
V6p0jQ/RhUsqpHLmXvEX4Q: folds 
7je+LC5Mfs6nL8YBVh4frQ: folds 
K0b5wNInj6hUGRr6yzKFtw: folds 
j4q3p0lesp63b1gZDwLBZw: folds 
vSkQm2EelzwRGDDQQk0Fqw: folds 
HOEaXncFu2ij+D5/CANAZA: calls $0.15
yyG4svzOpC1A+sUP/scg6w: checks 
*** FLOP *** [Qs Ts 2c]
HOEaXncFu2ij+D5/CANAZA: checks 
yyG4svzOpC1A+sUP/scg6w: checks 
*** TURN *** [Qs Ts 2c] [4d]
HOEaXncFu2ij+D5/CANAZA: bets $0.25
yyG4svzOpC1A+sUP/scg6w: folds 
Uncalled bet ($0.25) returned to HOEaXncFu2ij+D5/CANAZA
HOEaXncFu2ij+D5/CANAZA collected $0.50 from pot
HOEaXncFu2ij+D5/CANAZA: doesn't show hand 
*** SUMMARY ***
Total pot $0.50 | Rake $0 
Board [Qs Ts 2c 4d]
Seat 1: j4q3p0lesp63b1gZDwLBZw folded before Flop (didn't bet)
Seat 2: vSkQm2EelzwRGDDQQk0Fqw (button) folded before Flop (didn't bet)
Seat 3: HOEaXncFu2ij+D5/CANAZA (small blind) collected ($0.50)
Seat 5: yyG4svzOpC1A+sUP/scg6w (big blind) folded on the Turn
Seat 6: sC4BsflLWW26Qm9m+1AwJQ folded before Flop (didn't bet)
Seat 7: V6p0jQ/RhUsqpHLmXvEX4Q folded before Flop (didn't bet)
Seat 8: 7je+LC5Mfs6nL8YBVh4frQ folded before Flop (didn't bet)
Seat 9: K0b5wNInj6hUGRr6yzKFtw folded before Flop (didn't bet)




PokerStars Game #59941550228:  Hold'em No Limit ($0.10/$0.25) - 2009/07/01 1:38:52 ET
Table 'Qk/910N2Yhg8u5vqTJk50Q' 9-max Seat #9 is the button
Seat 1: zDrucyjVn5aeekNEc3cJrA ($22.65 in chips) 
Seat 2: Th3FldXKQW6hWVVPahaoOQ ($46.30 in chips) 
Seat 3: ghNKXUBl/H+t83JF079ZBA ($25.35 in chips) 
Seat 5: 4oA316mXLIui1QY63GXBUg ($25.75 in chips) 
Seat 6: 8GJHzzxiotOqC5gdtgpLoA ($6.30 in chips) 
Seat 7: aNpwfA31EREwO+ar4XzBCw ($25.35 in chips) 
Seat 8: H5Se03ZqSX7tbULXur2MAg ($25.50 in chips) 
Seat 9: M2QO2DxB5Wawg2h8HSpnYA ($18.70 in chips) 
zDrucyjVn5aeekNEc3cJrA: posts small blind $0.10
Th3FldXKQW6hWVVPahaoOQ: posts big blind $0.25
*** HOLE CARDS ***
ghNKXUBl/H+t83JF079ZBA: folds 
4oA316mXLIui1QY63GXBUg: folds 
8GJHzzxiotOqC5gdtgpLoA: folds 
aNpwfA31EREwO+ar4XzBCw: folds 
H5Se03ZqSX7tbULXur2MAg: folds 
M2QO2DxB5Wawg2h8HSpnYA: folds 
zDrucyjVn5aeekNEc3cJrA: folds 
Uncalled bet ($0.15) returned to Th3FldXKQW6hWVVPahaoOQ
Th3FldXKQW6hWVVPahaoOQ collected $0.20 from pot
Th3FldXKQW6hWVVPahaoOQ: doesn't show hand 
*** SUMMARY ***
Total pot $0.20 | Rake $0 
Seat 1: zDrucyjVn5aeekNEc3cJrA (small blind) folded before Flop
Seat 2: Th3FldXKQW6hWVVPahaoOQ (big blind) collected ($0.20)
Seat 3: ghNKXUBl/H+t83JF079ZBA folded before Flop (didn't bet)
Seat 5: 4oA316mXLIui1QY63GXBUg folded before Flop (didn't bet)
Seat 6: 8GJHzzxiotOqC5gdtgpLoA folded before Flop (didn't bet)
Seat 7: aNpwfA31EREwO+ar4XzBCw folded before Flop (didn't bet)
Seat 8: H5Se03ZqSX7tbULXur2MAg folded before Flop (didn't bet)
Seat 9: M2QO2DxB5Wawg2h8HSpnYA (button) folded before Flop (didn't bet)




PokerStars Game #59941550510:  Hold'em No Limit ($0.10/$0.25) - 2009/07/01 1:38:52 ET
Table '4hfTdIVT/qPsJNfWXLsVIw' 9-max Seat #5 is the button
Seat 1: GbHFBbLqLGz0Pwn6CJeAuw ($34.45 in chips) 
Seat 2: Pt637jKksB5MzP0UNJAAkw ($37.35 in chips) 
Seat 3: xnVwSkROfRtOw4eSoDANtw ($8.10 in chips) 
Seat 4: 3PmVnC/15cl4oyI1TKIt4g ($6.10 in chips) 
Seat 5: dtZ84flFEi4Q+SGrHMJRDQ ($26.20 in chips) 
Seat 6: VWUWpMLMj/Q1jRVpF7Aohw ($13.40 in chips) 
Seat 8: 7cv+9Zc9HIQHNvYsMfV3uA ($25.35 in chips) 
Seat 9: 9njEKzpOKC62MllUFUBWrA ($9.35 in chips) 
VWUWpMLMj/Q1jRVpF7Aohw: posts small blind $0.10
7cv+9Zc9HIQHNvYsMfV3uA: posts big blind $0.25
*** HOLE CARDS ***
9njEKzpOKC62MllUFUBWrA: folds 
GbHFBbLqLGz0Pwn6CJeAuw: calls $0.25
Pt637jKksB5MzP0UNJAAkw: folds 
xnVwSkROfRtOw4eSoDANtw: folds 
3PmVnC/15cl4oyI1TKIt4g: folds 
dtZ84flFEi4Q+SGrHMJRDQ: folds 
VWUWpMLMj/Q1jRVpF7Aohw: calls $0.15
7cv+9Zc9HIQHNvYsMfV3uA: raises $1.25 to $1.50
GbHFBbLqLGz0Pwn6CJeAuw: calls $1.25
VWUWpMLMj/Q1jRVpF7Aohw: folds 
*** FLOP *** [3d Ts 9d]
7cv+9Zc9HIQHNvYsMfV3uA: bets $2.25
GbHFBbLqLGz0Pwn6CJeAuw: calls $2.25
*** TURN *** [3d Ts 9d] [9s]
7cv+9Zc9HIQHNvYsMfV3uA: checks 
GbHFBbLqLGz0Pwn6CJeAuw: checks 
*** RIVER *** [3d Ts 9d 9s] [2c]
7cv+9Zc9HIQHNvYsMfV3uA: checks 
GbHFBbLqLGz0Pwn6CJeAuw: checks 
*** SHOW DOWN ***
7cv+9Zc9HIQHNvYsMfV3uA: shows [Ad Qh] (a pair of Nines)
GbHFBbLqLGz0Pwn6CJeAuw: mucks hand 
7cv+9Zc9HIQHNvYsMfV3uA collected $7.40 from pot
*** SUMMARY ***
Total pot $7.75 | Rake $0.35 
Board [3d Ts 9d 9s 2c]
Seat 1: GbHFBbLqLGz0Pwn6CJeAuw mucked
Seat 2: Pt637jKksB5MzP0UNJAAkw folded before Flop (didn't bet)
Seat 3: xnVwSkROfRtOw4eSoDANtw folded before Flop (didn't bet)
Seat 4: 3PmVnC/15cl4oyI1TKIt4g folded before Flop (didn't bet)
Seat 5: dtZ84flFEi4Q+SGrHMJRDQ (button) folded before Flop (didn't bet)
Seat 6: VWUWpMLMj/Q1jRVpF7Aohw (small blind) folded before Flop
Seat 8: 7cv+9Zc9HIQHNvYsMfV3uA (big blind) showed [Ad Qh] and won ($7.40) with a pair of Nines
Seat 9: 9njEKzpOKC62MllUFUBWrA folded before Flop (didn't bet)




PokerStars Game #59941550578:  Hold'em No Limit ($0.10/$0.25) - 2009/07/01 1:38:52 ET
Table '/AhP8uWRzEEhOATYIdmn0A' 9-max Seat #1 is the button
Seat 1: +sbyWwIcFp9kP0bDtMegfQ ($36.15 in chips) 
Seat 2: nx5EoCNZFR03YUOXyT22wQ ($17.40 in chips) 
Seat 3: jx6dnobNHstDG0tabsbKHQ ($5.65 in chips) 
Seat 9: uvfXVx90QtCYG4geTioN+A ($62 in chips) 
nx5EoCNZFR03YUOXyT22wQ: posts small blind $0.10
jx6dnobNHstDG0tabsbKHQ: posts big blind $0.25
bXpVeaSTPBFSPJmeXxO7nw: sits out 
8EbrQ/EvFWt2cr0GaU82gQ: sits out 
cZ99hugmLBj9KhTlc8nCSw: sits out 
*** HOLE CARDS ***
uvfXVx90QtCYG4geTioN+A: folds 
K86cg2ifCMFAlmzsfTDjig has returned
+sbyWwIcFp9kP0bDtMegfQ: raises $0.75 to $1
nx5EoCNZFR03YUOXyT22wQ: folds 
jx6dnobNHstDG0tabsbKHQ: calls $0.75
*** FLOP *** [8c 9s Jd]
jx6dnobNHstDG0tabsbKHQ: checks 
+sbyWwIcFp9kP0bDtMegfQ: bets $1.25
jx6dnobNHstDG0tabsbKHQ: calls $1.25
*** TURN *** [8c 9s Jd] [Tc]
jx6dnobNHstDG0tabsbKHQ: checks 
+sbyWwIcFp9kP0bDtMegfQ: bets $1.75
jx6dnobNHstDG0tabsbKHQ: folds 
Uncalled bet ($1.75) returned to +sbyWwIcFp9kP0bDtMegfQ
+sbyWwIcFp9kP0bDtMegfQ collected $4.40 from pot
+sbyWwIcFp9kP0bDtMegfQ: doesn't show hand 
*** SUMMARY ***
Total pot $4.60 | Rake $0.20 
Board [8c 9s Jd Tc]
Seat 1: +sbyWwIcFp9kP0bDtMegfQ (button) collected ($4.40)
Seat 2: nx5EoCNZFR03YUOXyT22wQ (small blind) folded before Flop
Seat 3: jx6dnobNHstDG0tabsbKHQ (big blind) folded on the Turn
Seat 9: uvfXVx90QtCYG4geTioN+A folded before Flop (didn't bet)




PokerStars Game #59941550586:  Hold'em No Limit ($0.10/$0.25) - 2009/07/01 1:38:52 ET
Table 'PCxB2W9H6ma8SwsZlImuOw' 9-max Seat #9 is the button
Seat 1: SqibpGx+lf+brY0fJVvD0w ($24.25 in chips) 
Seat 2: wjH6l1gQaEfv+C45sAOwIQ ($38.80 in chips) 
Seat 3: J2a/QHAWUgo6beDRoEyg2g ($11.10 in chips) 
Seat 4: RsPwA2DnzOke3hD/Of/DUg ($4.40 in chips) 
Seat 5: GZO7tOXatVoX17M2DqPcUQ ($18.65 in chips) 
Seat 6: 5/6dWEBUHldD7iGXa2LwsQ ($16.45 in chips) 
Seat 7: c/9X4zftzphFxYtxp5kp9w ($26.80 in chips) 
Seat 8: Pt637jKksB5MzP0UNJAAkw ($25 in chips) 
Seat 9: COwSH15MvHaRF7en6/TRZQ ($4.65 in chips) 
SqibpGx+lf+brY0fJVvD0w: posts small blind $0.10
wjH6l1gQaEfv+C45sAOwIQ: posts big blind $0.25
*** HOLE CARDS ***
J2a/QHAWUgo6beDRoEyg2g: folds 
RsPwA2DnzOke3hD/Of/DUg: calls $0.25
GZO7tOXatVoX17M2DqPcUQ: raises $0.25 to $0.50
5/6dWEBUHldD7iGXa2LwsQ: folds 
c/9X4zftzphFxYtxp5kp9w: folds 
Pt637jKksB5MzP0UNJAAkw: folds 
COwSH15MvHaRF7en6/TRZQ: folds 
SqibpGx+lf+brY0fJVvD0w: folds 
wjH6l1gQaEfv+C45sAOwIQ: calls $0.25
RsPwA2DnzOke3hD/Of/DUg: calls $0.25
*** FLOP *** [Qs Ts Kh]
wjH6l1gQaEfv+C45sAOwIQ: checks 
RsPwA2DnzOke3hD/Of/DUg: checks 
GZO7tOXatVoX17M2DqPcUQ: bets $1
wjH6l1gQaEfv+C45sAOwIQ: folds 
RsPwA2DnzOke3hD/Of/DUg: calls $1
*** TURN *** [Qs Ts Kh] [8h]
RsPwA2DnzOke3hD/Of/DUg: checks 
GZO7tOXatVoX17M2DqPcUQ: checks 
*** RIVER *** [Qs Ts Kh 8h] [2s]
RsPwA2DnzOke3hD/Of/DUg: checks 
GZO7tOXatVoX17M2DqPcUQ: bets $1.50
RsPwA2DnzOke3hD/Of/DUg: folds 
Uncalled bet ($1.50) returned to GZO7tOXatVoX17M2DqPcUQ
GZO7tOXatVoX17M2DqPcUQ collected $3.45 from pot
*** SUMMARY ***
Total pot $3.60 | Rake $0.15 
Board [Qs Ts Kh 8h 2s]
Seat 1: SqibpGx+lf+brY0fJVvD0w (small blind) folded before Flop
Seat 2: wjH6l1gQaEfv+C45sAOwIQ (big blind) folded on the Flop
Seat 3: J2a/QHAWUgo6beDRoEyg2g folded before Flop (didn't bet)
Seat 4: RsPwA2DnzOke3hD/Of/DUg folded on the River
Seat 5: GZO7tOXatVoX17M2DqPcUQ collected ($3.45)
Seat 6: 5/6dWEBUHldD7iGXa2LwsQ folded before Flop (didn't bet)
Seat 7: c/9X4zftzphFxYtxp5kp9w folded before Flop (didn't bet)
Seat 8: Pt637jKksB5MzP0UNJAAkw folded before Flop (didn't bet)
Seat 9: COwSH15MvHaRF7en6/TRZQ (button) folded before Flop (didn't bet)




PokerStars Game #59941551290:  Hold'em No Limit ($0.10/$0.25) - 2009/07/01 1:38:53 ET
Table 'IfRHUn9gQQA9I/Z4tn+BoA' 9-max Seat #7 is the button
Seat 1: vSkQm2EelzwRGDDQQk0Fqw ($7.65 in chips) 
Seat 2: VWUWpMLMj/Q1jRVpF7Aohw ($17.45 in chips) 
Seat 3: ModuIAhh03puxW6XFxQ3Nw ($11.70 in chips) 
Seat 4: QEbIGci+itdw+re8RM5fZA ($30.65 in chips) 
Seat 5: DdPXdieucQ+n99u1n3A+rQ ($4.65 in chips) 
Seat 6: UOjoGGQ58/uDS7V0xkjOrQ ($23.70 in chips) 
Seat 7: YzqSxP03XxZPbgPifgt69g ($24.85 in chips) 
Seat 8: cZ99hugmLBj9KhTlc8nCSw ($27.85 in chips) 
Seat 9: 7cv+9Zc9HIQHNvYsMfV3uA ($48.10 in chips) 
cZ99hugmLBj9KhTlc8nCSw: posts small blind $0.10
7cv+9Zc9HIQHNvYsMfV3uA: posts big blind $0.25
*** HOLE CARDS ***
vSkQm2EelzwRGDDQQk0Fqw: folds 
VWUWpMLMj/Q1jRVpF7Aohw: folds 
ModuIAhh03puxW6XFxQ3Nw: folds 
QEbIGci+itdw+re8RM5fZA: folds 
DdPXdieucQ+n99u1n3A+rQ: folds 
UOjoGGQ58/uDS7V0xkjOrQ: calls $0.25
YzqSxP03XxZPbgPifgt69g: raises $0.75 to $1
cZ99hugmLBj9KhTlc8nCSw: folds 
7cv+9Zc9HIQHNvYsMfV3uA: folds 
UOjoGGQ58/uDS7V0xkjOrQ: calls $0.75
*** FLOP *** [Ah Ad Qd]
UOjoGGQ58/uDS7V0xkjOrQ: bets $2.25
YzqSxP03XxZPbgPifgt69g: raises $4.75 to $7
UOjoGGQ58/uDS7V0xkjOrQ: folds 
Uncalled bet ($4.75) returned to YzqSxP03XxZPbgPifgt69g
YzqSxP03XxZPbgPifgt69g collected $6.55 from pot
YzqSxP03XxZPbgPifgt69g: doesn't show hand 
*** SUMMARY ***
Total pot $6.85 | Rake $0.30 
Board [Ah Ad Qd]
Seat 1: vSkQm2EelzwRGDDQQk0Fqw folded before Flop (didn't bet)
Seat 2: VWUWpMLMj/Q1jRVpF7Aohw folded before Flop (didn't bet)
Seat 3: ModuIAhh03puxW6XFxQ3Nw folded before Flop (didn't bet)
Seat 4: QEbIGci+itdw+re8RM5fZA folded before Flop (didn't bet)
Seat 5: DdPXdieucQ+n99u1n3A+rQ folded before Flop (didn't bet)
Seat 6: UOjoGGQ58/uDS7V0xkjOrQ folded on the Flop
Seat 7: YzqSxP03XxZPbgPifgt69g (button) collected ($6.55)
Seat 8: cZ99hugmLBj9KhTlc8nCSw (small blind) folded before Flop
Seat 9: 7cv+9Zc9HIQHNvYsMfV3uA (big blind) folded before Flop




PokerStars Game #59941550974:  Hold'em No Limit ($0.10/$0.25) - 2009/07/01 1:38:53 ET
Table 'K/f0NNaoGuhSz5DrzgVw7Q' 9-max Seat #9 is the button
Seat 1: sD+TKtt36XiiN6jqHiLwDA ($25.30 in chips) 
Seat 2: N7idMbhmEVNGZavVF2tgKg ($26.40 in chips) 
Seat 3: z5GxcHlYz/GSz6W2uFiTtg ($24.60 in chips) 
Seat 4: 9bCz0uv2nUmznwuI0OjVGw ($16.90 in chips) 
Seat 5: DnDcAdn9P0zGovMERigpFA ($38.30 in chips) 
Seat 6: 3PVK0IdMlq2fElkVzzr4bg ($2.60 in chips) 
Seat 7: egvg3mTBBVzMHnJPIQiKcA ($14.65 in chips) 
Seat 8: RCqMONFrSPSArZh2Jsar/w ($19.65 in chips) 
Seat 9: tLcDklc2rBORNfixyRfVfw ($25 in chips) 
sD+TKtt36XiiN6jqHiLwDA: posts small blind $0.10
N7idMbhmEVNGZavVF2tgKg: posts big blind $0.25
*** HOLE CARDS ***
z5GxcHlYz/GSz6W2uFiTtg: folds 
9bCz0uv2nUmznwuI0OjVGw: calls $0.25
DnDcAdn9P0zGovMERigpFA: calls $0.25
3PVK0IdMlq2fElkVzzr4bg: folds 
egvg3mTBBVzMHnJPIQiKcA: folds 
RCqMONFrSPSArZh2Jsar/w: folds 
tLcDklc2rBORNfixyRfVfw: folds 
sD+TKtt36XiiN6jqHiLwDA: calls $0.15
N7idMbhmEVNGZavVF2tgKg: checks 
*** FLOP *** [Ad Kh Ks]
sD+TKtt36XiiN6jqHiLwDA: checks 
N7idMbhmEVNGZavVF2tgKg: checks 
9bCz0uv2nUmznwuI0OjVGw: checks 
DnDcAdn9P0zGovMERigpFA: bets $0.25
sD+TKtt36XiiN6jqHiLwDA: folds 
N7idMbhmEVNGZavVF2tgKg: folds 
9bCz0uv2nUmznwuI0OjVGw: calls $0.25
*** TURN *** [Ad Kh Ks] [9c]
9bCz0uv2nUmznwuI0OjVGw: checks 
DnDcAdn9P0zGovMERigpFA: checks 
*** RIVER *** [Ad Kh Ks 9c] [Ac]
9bCz0uv2nUmznwuI0OjVGw: checks 
DnDcAdn9P0zGovMERigpFA: checks 
*** SHOW DOWN ***
9bCz0uv2nUmznwuI0OjVGw: shows [6s Js] (two pair, Aces and Kings)
DnDcAdn9P0zGovMERigpFA: mucks hand 
9bCz0uv2nUmznwuI0OjVGw collected $1.45 from pot
*** SUMMARY ***
Total pot $1.50 | Rake $0.05 
Board [Ad Kh Ks 9c Ac]
Seat 1: sD+TKtt36XiiN6jqHiLwDA (small blind) folded on the Flop
Seat 2: N7idMbhmEVNGZavVF2tgKg (big blind) folded on the Flop
Seat 3: z5GxcHlYz/GSz6W2uFiTtg folded before Flop (didn't bet)
Seat 4: 9bCz0uv2nUmznwuI0OjVGw showed [6s Js] and won ($1.45) with two pair, Aces and Kings
Seat 5: DnDcAdn9P0zGovMERigpFA mucked
Seat 6: 3PVK0IdMlq2fElkVzzr4bg folded before Flop (didn't bet)
Seat 7: egvg3mTBBVzMHnJPIQiKcA folded before Flop (didn't bet)
Seat 8: RCqMONFrSPSArZh2Jsar/w folded before Flop (didn't bet)
Seat 9: tLcDklc2rBORNfixyRfVfw (button) folded before Flop (didn't bet)




PokerStars Game #59941550908:  Hold'em No Limit ($0.10/$0.25) - 2009/07/01 1:38:53 ET
Table 'KAnP7XvDtlku47YfJwdOVw' 9-max Seat #9 is the button
Seat 1: cH3q40adP+kFogl+2MtbkQ ($12.75 in chips) 
Seat 2: VFTQG1/RfAKeMXRBv1ewsg ($29.10 in chips) 
Seat 4: OiV1PWZ3IkN29JlmCcnTwQ ($5 in chips) 
Seat 5: MG90wfSJZnOejs/KD3vlQQ ($33.40 in chips) 
Seat 6: z5GxcHlYz/GSz6W2uFiTtg ($21.55 in chips) 
Seat 7: Lro4e37x4FUa5P3yzDjskw ($8.80 in chips) 
Seat 8: OneeONzF0MoH0pEdcBndwA ($23.05 in chips) 
Seat 9: HDDm1BkZtdsRyw2DJdqq6A ($24.80 in chips) 
cH3q40adP+kFogl+2MtbkQ: posts small blind $0.10
VFTQG1/RfAKeMXRBv1ewsg: posts big blind $0.25
W6tExOcYX7qiy6Qdp+ZwFA: sits out 
*** HOLE CARDS ***
OiV1PWZ3IkN29JlmCcnTwQ: folds 
MG90wfSJZnOejs/KD3vlQQ: folds 
z5GxcHlYz/GSz6W2uFiTtg: folds 
Lro4e37x4FUa5P3yzDjskw: calls $0.25
OneeONzF0MoH0pEdcBndwA: calls $0.25
HDDm1BkZtdsRyw2DJdqq6A: folds 
cH3q40adP+kFogl+2MtbkQ: calls $0.15
VFTQG1/RfAKeMXRBv1ewsg: checks 
*** FLOP *** [Ah 8c 6h]
cH3q40adP+kFogl+2MtbkQ: checks 
VFTQG1/RfAKeMXRBv1ewsg: bets $0.75
Lro4e37x4FUa5P3yzDjskw: folds 
OneeONzF0MoH0pEdcBndwA: folds 
cH3q40adP+kFogl+2MtbkQ: calls $0.75
*** TURN *** [Ah 8c 6h] [5h]
cH3q40adP+kFogl+2MtbkQ: checks 
VFTQG1/RfAKeMXRBv1ewsg: checks 
*** RIVER *** [Ah 8c 6h 5h] [Jh]
cH3q40adP+kFogl+2MtbkQ: bets $1
VFTQG1/RfAKeMXRBv1ewsg: folds 
Uncalled bet ($1) returned to cH3q40adP+kFogl+2MtbkQ
cH3q40adP+kFogl+2MtbkQ collected $2.40 from pot
*** SUMMARY ***
Total pot $2.50 | Rake $0.10 
Board [Ah 8c 6h 5h Jh]
Seat 1: cH3q40adP+kFogl+2MtbkQ (small blind) collected ($2.40)
Seat 2: VFTQG1/RfAKeMXRBv1ewsg (big blind) folded on the River
Seat 4: OiV1PWZ3IkN29JlmCcnTwQ folded before Flop (didn't bet)
Seat 5: MG90wfSJZnOejs/KD3vlQQ folded before Flop (didn't bet)
Seat 6: z5GxcHlYz/GSz6W2uFiTtg folded before Flop (didn't bet)
Seat 7: Lro4e37x4FUa5P3yzDjskw folded on the Flop
Seat 8: OneeONzF0MoH0pEdcBndwA folded on the Flop
Seat 9: HDDm1BkZtdsRyw2DJdqq6A (button) folded before Flop (didn't bet)




PokerStars Game #59941550976:  Hold'em No Limit ($0.10/$0.25) - 2009/07/01 1:38:53 ET
Table 'l8hUTjBTXBorNUR/tyvSLw' 9-max Seat #7 is the button
Seat 1: cZ99hugmLBj9KhTlc8nCSw ($27.85 in chips) 
Seat 2: B6xHiX1SJkS0CUNCKDVwuQ ($16.60 in chips) 
Seat 3: 6TWO15+WfJ5HfI8CbJ4a0w ($9.50 in chips) 
Seat 4: vPtFvcPtn/Afz0sucO1cmQ ($36.10 in chips) 
Seat 6: EVqHvqty1ZsuvDFiSXlSqQ ($23.85 in chips) 
Seat 7: F7pnn6czNpHvRM55XcA2EA ($33.40 in chips) 
Seat 8: Mh2r9hTeTEDnh19sRZtW3g ($4.50 in chips) 
Seat 9: zDrucyjVn5aeekNEc3cJrA ($33.05 in chips) 
Mh2r9hTeTEDnh19sRZtW3g: posts small blind $0.10
zDrucyjVn5aeekNEc3cJrA: posts big blind $0.25
yyG4svzOpC1A+sUP/scg6w: sits out 
*** HOLE CARDS ***
cZ99hugmLBj9KhTlc8nCSw: folds 
B6xHiX1SJkS0CUNCKDVwuQ: folds 
6TWO15+WfJ5HfI8CbJ4a0w: calls $0.25
vPtFvcPtn/Afz0sucO1cmQ: folds 
EVqHvqty1ZsuvDFiSXlSqQ: folds 
F7pnn6czNpHvRM55XcA2EA: folds 
Mh2r9hTeTEDnh19sRZtW3g: folds 
zDrucyjVn5aeekNEc3cJrA: checks 
*** FLOP *** [3s 9d 5d]
zDrucyjVn5aeekNEc3cJrA: checks 
6TWO15+WfJ5HfI8CbJ4a0w: bets $0.50
zDrucyjVn5aeekNEc3cJrA: folds 
Uncalled bet ($0.50) returned to 6TWO15+WfJ5HfI8CbJ4a0w
6TWO15+WfJ5HfI8CbJ4a0w collected $0.60 from pot
6TWO15+WfJ5HfI8CbJ4a0w: doesn't show hand 
*** SUMMARY ***
Total pot $0.60 | Rake $0 
Board [3s 9d 5d]
Seat 1: cZ99hugmLBj9KhTlc8nCSw folded before Flop (didn't bet)
Seat 2: B6xHiX1SJkS0CUNCKDVwuQ folded before Flop (didn't bet)
Seat 3: 6TWO15+WfJ5HfI8CbJ4a0w collected ($0.60)
Seat 4: vPtFvcPtn/Afz0sucO1cmQ folded before Flop (didn't bet)
Seat 6: EVqHvqty1ZsuvDFiSXlSqQ folded before Flop (didn't bet)
Seat 7: F7pnn6czNpHvRM55XcA2EA (button) folded before Flop (didn't bet)
Seat 8: Mh2r9hTeTEDnh19sRZtW3g (small blind) folded before Flop
Seat 9: zDrucyjVn5aeekNEc3cJrA (big blind) folded on the Flop




PokerStars Game #59941551262:  Hold'em No Limit ($0.10/$0.25) - 2009/07/01 1:38:53 ET
Table 'xro+BVoe2Zuw1TYmz/McJQ' 9-max Seat #1 is the button
Seat 1: xEQxarad8/T4jJdpZy5LGw ($10.30 in chips) 
Seat 2: vSkQm2EelzwRGDDQQk0Fqw ($4.75 in chips) 
Seat 4: N2LVj3iImgnOoHVf8g0rIw ($45.10 in chips) 
Seat 5: w48D7DZIjuBit2n4FRDJ5Q ($13.30 in chips) 
Seat 6: HPEB+AtKw1+C/cxU0o1ciw ($26.85 in chips) 
Seat 7: QEbIGci+itdw+re8RM5fZA ($31.15 in chips) 
Seat 8: ljemhp25Zg+nlA9DLCIiUw ($23 in chips) 
Seat 9: H5Se03ZqSX7tbULXur2MAg ($14.40 in chips) 
vSkQm2EelzwRGDDQQk0Fqw: posts small blind $0.10
DdPXdieucQ+n99u1n3A+rQ: is sitting out 
DdPXdieucQ+n99u1n3A+rQ leaves the table
N2LVj3iImgnOoHVf8g0rIw: posts big blind $0.25
*** HOLE CARDS ***
w48D7DZIjuBit2n4FRDJ5Q: folds 
PdIasPkzm2sqZnN41ZRXOg joins the table at seat #3 
HPEB+AtKw1+C/cxU0o1ciw: folds 
QEbIGci+itdw+re8RM5fZA: folds 
ljemhp25Zg+nlA9DLCIiUw: folds 
H5Se03ZqSX7tbULXur2MAg: raises $0.50 to $0.75
xEQxarad8/T4jJdpZy5LGw: folds 
vSkQm2EelzwRGDDQQk0Fqw: folds 
N2LVj3iImgnOoHVf8g0rIw: calls $0.50
*** FLOP *** [8h 6c Jh]
N2LVj3iImgnOoHVf8g0rIw: bets $1
H5Se03ZqSX7tbULXur2MAg: folds 
Uncalled bet ($1) returned to N2LVj3iImgnOoHVf8g0rIw
N2LVj3iImgnOoHVf8g0rIw collected $1.55 from pot
*** SUMMARY ***
Total pot $1.60 | Rake $0.05 
Board [8h 6c Jh]
Seat 1: xEQxarad8/T4jJdpZy5LGw (button) folded before Flop (didn't bet)
Seat 2: vSkQm2EelzwRGDDQQk0Fqw (small blind) folded before Flop
Seat 4: N2LVj3iImgnOoHVf8g0rIw (big blind) collected ($1.55)
Seat 5: w48D7DZIjuBit2n4FRDJ5Q folded before Flop (didn't bet)
Seat 6: HPEB+AtKw1+C/cxU0o1ciw folded before Flop (didn't bet)
Seat 7: QEbIGci+itdw+re8RM5fZA folded before Flop (didn't bet)
Seat 8: ljemhp25Zg+nlA9DLCIiUw folded before Flop (didn't bet)
Seat 9: H5Se03ZqSX7tbULXur2MAg folded on the Flop




PokerStars Game #59941551074:  Hold'em No Limit ($0.10/$0.25) - 2009/07/01 1:38:53 ET
Table 'MRfAiS/4JSfnUDlCcZo0wAhfHe8uKeSJMyWAjSdM7ROQx Seat #4 is the button
Seat 1: 48oT5xFI+5CHUJlfoGrE4w ($31.95 in chips) 
Seat 2: /gJNBeCkWL4o85/jvlZ4BA ($30.70 in chips) 
Seat 3: FYepjhAvF8ZdVCmqHIy+eQ ($38.80 in chips) 
Seat 4: b4wRQV3APH8irVk6bUFe2Q ($26.90 in chips) 
Anaspain will be allowed to play after the button
48oT5xFI+5CHUJlfoGrE4w: posts small blind $0.10
/gJNBeCkWL4o85/jvlZ4BA: posts big blind $0.25
*** HOLE CARDS ***
FYepjhAvF8ZdVCmqHIy+eQ: folds 
Anaspain leaves the table
L3/N/gliETan8N5Gim5h4Q joins the table at seat #6 
b4wRQV3APH8irVk6bUFe2Q has timed out
b4wRQV3APH8irVk6bUFe2Q: folds 
b4wRQV3APH8irVk6bUFe2Q is sitting out
48oT5xFI+5CHUJlfoGrE4w: folds 
Uncalled bet ($0.15) returned to /gJNBeCkWL4o85/jvlZ4BA
/gJNBeCkWL4o85/jvlZ4BA collected $0.20 from pot
*** SUMMARY ***
Total pot $0.20 | Rake $0 
Seat 1: 48oT5xFI+5CHUJlfoGrE4w (small blind) folded before Flop
Seat 2: /gJNBeCkWL4o85/jvlZ4BA (big blind) collected ($0.20)
Seat 3: FYepjhAvF8ZdVCmqHIy+eQ folded before Flop (didn't bet)
Seat 4: b4wRQV3APH8irVk6bUFe2Q (button) folded before Flop (didn't bet)




PokerStars Game #59941550914:  Hold'em No Limit ($0.10/$0.25) - 2009/07/01 1:38:53 ET
Table 'IIO2q2znuuAXmiZ2qFTcmg' 6-max Seat #6 is the button
Seat 1: 2G0C7dp4wlPpE21FHjjElQ ($25.10 in chips) 
Seat 2: cS21pIxRHx5Gt42o7hPZzw ($13.30 in chips) 
Seat 4: tSR4329m40dZsN7YOpI9Kw ($59.25 in chips) 
Seat 5: GJsS3gwVwlbyroaWrnjqJg ($35.25 in chips) 
Seat 6: aogAb4Eienxztk8p2v9VVw ($35.65 in chips) 
2G0C7dp4wlPpE21FHjjElQ: posts small blind $0.10
cS21pIxRHx5Gt42o7hPZzw: posts big blind $0.25
L3/N/gliETan8N5Gim5h4Q: sits out 
*** HOLE CARDS ***
tSR4329m40dZsN7YOpI9Kw: raises $0.60 to $0.85
GJsS3gwVwlbyroaWrnjqJg: folds 
aogAb4Eienxztk8p2v9VVw: folds 
2G0C7dp4wlPpE21FHjjElQ: folds 
cS21pIxRHx5Gt42o7hPZzw: folds 
Uncalled bet ($0.60) returned to tSR4329m40dZsN7YOpI9Kw
tSR4329m40dZsN7YOpI9Kw collected $0.60 from pot
*** SUMMARY ***
Total pot $0.60 | Rake $0 
Seat 1: 2G0C7dp4wlPpE21FHjjElQ (small blind) folded before Flop
Seat 2: cS21pIxRHx5Gt42o7hPZzw (big blind) folded before Flop
Seat 4: tSR4329m40dZsN7YOpI9Kw collected ($0.60)
Seat 5: GJsS3gwVwlbyroaWrnjqJg folded before Flop (didn't bet)
Seat 6: aogAb4Eienxztk8p2v9VVw (button) folded before Flop (didn't bet)




PokerStars Game #59941551182:  Hold'em No Limit ($0.10/$0.25) - 2009/07/01 1:38:53 ET
Table '8PD/MTROSMd6Y8mZeykbpg' 6-max Seat #2 is the button
Seat 1: 32YL2ZEp8NT4JB2RVM9euQ ($16 in chips) 
Seat 2: +C3eP/ysyROWbEXJFPswVA ($24.60 in chips) 
Seat 3: vqWjZmdQu/Hxw96/IJTWdQ ($25 in chips) 
Seat 4: DFi/Lzkjsfv8QswS80JX9Q ($54.05 in chips) 
Seat 5: z3tQwy28dp5FykDJC/wzQw ($26.45 in chips) 
vqWjZmdQu/Hxw96/IJTWdQ: posts small blind $0.10
DFi/Lzkjsfv8QswS80JX9Q: posts big blind $0.25
*** HOLE CARDS ***
z3tQwy28dp5FykDJC/wzQw: folds 
32YL2ZEp8NT4JB2RVM9euQ: raises $0.75 to $1
+C3eP/ysyROWbEXJFPswVA: folds 
vqWjZmdQu/Hxw96/IJTWdQ: folds 
DFi/Lzkjsfv8QswS80JX9Q: folds 
Uncalled bet ($0.75) returned to 32YL2ZEp8NT4JB2RVM9euQ
32YL2ZEp8NT4JB2RVM9euQ collected $0.60 from pot
32YL2ZEp8NT4JB2RVM9euQ: doesn't show hand 
*** SUMMARY ***
Total pot $0.60 | Rake $0 
Seat 1: 32YL2ZEp8NT4JB2RVM9euQ collected ($0.60)
Seat 2: +C3eP/ysyROWbEXJFPswVA (button) folded before Flop (didn't bet)
Seat 3: vqWjZmdQu/Hxw96/IJTWdQ (small blind) folded before Flop
Seat 4: DFi/Lzkjsfv8QswS80JX9Q (big blind) folded before Flop
Seat 5: z3tQwy28dp5FykDJC/wzQw folded before Flop (didn't bet)




PokerStars Game #59941551004:  Hold'em No Limit ($0.10/$0.25) - 2009/07/01 1:38:53 ET
Table 'srBTB98reCdD1TffxE6o7g' 6-max Seat #4 is the button
Seat 1: SFmT9ZsVopnukjvAzrxTRg ($33.95 in chips) 
Seat 3: VOmI0x4dDPnTESZd5B4d1Q ($48.20 in chips) 
Seat 4: 6DwBRH+xZ12AAZmeAg+aXw ($19.90 in chips) 
Seat 5: 8zUCJvLYLFM8AG6K5zjIvg ($13.05 in chips) 
Seat 6: BV+K0Phf5VBHr7aZPKqbUQ ($31.70 in chips) 
8zUCJvLYLFM8AG6K5zjIvg: posts small blind $0.10
BV+K0Phf5VBHr7aZPKqbUQ: posts big blind $0.25
*** HOLE CARDS ***
SFmT9ZsVopnukjvAzrxTRg: folds 
VOmI0x4dDPnTESZd5B4d1Q: folds 
6DwBRH+xZ12AAZmeAg+aXw: raises $0.50 to $0.75
8zUCJvLYLFM8AG6K5zjIvg: calls $0.65
BV+K0Phf5VBHr7aZPKqbUQ: calls $0.50
*** FLOP *** [Ac 8s 4h]
8zUCJvLYLFM8AG6K5zjIvg: checks 
BV+K0Phf5VBHr7aZPKqbUQ: checks 
6DwBRH+xZ12AAZmeAg+aXw: bets $1.50
mfrkWA3PTeYPkbO6hi98Aw joins the table at seat #2 
8zUCJvLYLFM8AG6K5zjIvg: folds 
BV+K0Phf5VBHr7aZPKqbUQ: folds 
Uncalled bet ($1.50) returned to 6DwBRH+xZ12AAZmeAg+aXw
6DwBRH+xZ12AAZmeAg+aXw collected $2.15 from pot
6DwBRH+xZ12AAZmeAg+aXw: doesn't show hand 
*** SUMMARY ***
Total pot $2.25 | Rake $0.10 
Board [Ac 8s 4h]
Seat 1: SFmT9ZsVopnukjvAzrxTRg folded before Flop (didn't bet)
Seat 3: VOmI0x4dDPnTESZd5B4d1Q folded before Flop (didn't bet)
Seat 4: 6DwBRH+xZ12AAZmeAg+aXw (button) collected ($2.15)
Seat 5: 8zUCJvLYLFM8AG6K5zjIvg (small blind) folded on the Flop
Seat 6: BV+K0Phf5VBHr7aZPKqbUQ (big blind) folded on the Flop




PokerStars Game #59941550852:  Hold'em No Limit ($0.10/$0.25) - 2009/07/01 1:38:53 ET
Table 'FE/j6VqBY4j9Uq+VHURQCQ' 6-max Seat #6 is the button
Seat 1: ypmjhffk/YHGc51wgVXUTw ($40.95 in chips) 
Seat 2: 3zD3qLXT1bEffAoWGnc7wg ($40.85 in chips) 
Seat 3: lBoEwOFgzcERLIRUkUoRTw ($27.75 in chips) 
Seat 4: 7JyPCA0J2grhXQYxe1h3+A ($21.95 in chips) 
Seat 5: 4x9jCqgSw4272dnaIqnanw ($8.05 in chips) 
Seat 6: rpJ2ie+vculq8yrHlngRHQ ($18.10 in chips) 
ypmjhffk/YHGc51wgVXUTw: posts small blind $0.10
3zD3qLXT1bEffAoWGnc7wg: posts big blind $0.25
*** HOLE CARDS ***
lBoEwOFgzcERLIRUkUoRTw: folds 
7JyPCA0J2grhXQYxe1h3+A: folds 
4x9jCqgSw4272dnaIqnanw: folds 
rpJ2ie+vculq8yrHlngRHQ: raises $3 to $3.25
ypmjhffk/YHGc51wgVXUTw: folds 
3zD3qLXT1bEffAoWGnc7wg: folds 
Uncalled bet ($3) returned to rpJ2ie+vculq8yrHlngRHQ
rpJ2ie+vculq8yrHlngRHQ collected $0.60 from pot
*** SUMMARY ***
Total pot $0.60 | Rake $0 
Seat 1: ypmjhffk/YHGc51wgVXUTw (small blind) folded before Flop
Seat 2: 3zD3qLXT1bEffAoWGnc7wg (big blind) folded before Flop
Seat 3: lBoEwOFgzcERLIRUkUoRTw folded before Flop (didn't bet)
Seat 4: 7JyPCA0J2grhXQYxe1h3+A folded before Flop (didn't bet)
Seat 5: 4x9jCqgSw4272dnaIqnanw folded before Flop (didn't bet)
Seat 6: rpJ2ie+vculq8yrHlngRHQ (button) collected ($0.60)




PokerStars Game #59941550960:  Hold'em No Limit ($0.10/$0.25) - 2009/07/01 1:38:53 ET
Table 'edvgY2YQ1I34euq4EVqGnA' 6-max Seat #4 is the button
Seat 1: mvFHK3pE7tCxJEqLjKC70Q ($24.85 in chips) 
Seat 2: SxIIgwXYLkwd6m3wLyPTCw ($16.25 in chips) 
Seat 3: mFv3iBCtrw9XfCDRB0d46Q ($3.90 in chips) 
Seat 4: TI/C5Q+DEl4fLR3AofwYdg ($20.55 in chips) 
Seat 5: EE16Ua5b1HSsYej5zeXOlA ($54.85 in chips) 
Seat 6: kG34n23qFQA3nzdOJTQ1dA ($72.50 in chips) 
EE16Ua5b1HSsYej5zeXOlA: posts small blind $0.10
kG34n23qFQA3nzdOJTQ1dA: posts big blind $0.25
*** HOLE CARDS ***
mvFHK3pE7tCxJEqLjKC70Q: folds 
SxIIgwXYLkwd6m3wLyPTCw: folds 
mFv3iBCtrw9XfCDRB0d46Q: folds 
TI/C5Q+DEl4fLR3AofwYdg: folds 
EE16Ua5b1HSsYej5zeXOlA: folds 
Uncalled bet ($0.15) returned to kG34n23qFQA3nzdOJTQ1dA
kG34n23qFQA3nzdOJTQ1dA collected $0.20 from pot
*** SUMMARY ***
Total pot $0.20 | Rake $0 
Seat 1: mvFHK3pE7tCxJEqLjKC70Q folded before Flop (didn't bet)
Seat 2: SxIIgwXYLkwd6m3wLyPTCw folded before Flop (didn't bet)
Seat 3: mFv3iBCtrw9XfCDRB0d46Q folded before Flop (didn't bet)
Seat 4: TI/C5Q+DEl4fLR3AofwYdg (button) folded before Flop (didn't bet)
Seat 5: EE16Ua5b1HSsYej5zeXOlA (small blind) folded before Flop
Seat 6: kG34n23qFQA3nzdOJTQ1dA (big blind) collected ($0.20)




PokerStars Game #59941551400:  Hold'em No Limit ($0.10/$0.25) - 2009/07/01 1:38:54 ET
Table 'M7d9IrgQUUFFy/SZ3ksLYg' 6-max Seat #3 is the button
Seat 1: ypmjhffk/YHGc51wgVXUTw ($32.20 in chips) 
Seat 2: gqrr7lSWrQ1N8zKx8zZzvA ($11.05 in chips) 
Seat 3: 8JTm/CXBn3+kuQgcUOgPkw ($24.30 in chips) 
Seat 4: 8ClCHtFXGNplITm+63KB+Q ($25 in chips) 
Seat 5: kMa8BltUcBQVxnHfqdCfXg ($5 in chips) 
Seat 6: 7S16WhQHiAVLWwRuqPrpnw ($21.95 in chips) 
8ClCHtFXGNplITm+63KB+Q: posts small blind $0.10
kMa8BltUcBQVxnHfqdCfXg: posts big blind $0.25
*** HOLE CARDS ***
7S16WhQHiAVLWwRuqPrpnw: calls $0.25
ypmjhffk/YHGc51wgVXUTw: raises $0.75 to $1
gqrr7lSWrQ1N8zKx8zZzvA: folds 
8JTm/CXBn3+kuQgcUOgPkw: folds 
8ClCHtFXGNplITm+63KB+Q: folds 
kMa8BltUcBQVxnHfqdCfXg: calls $0.75
7S16WhQHiAVLWwRuqPrpnw: calls $0.75
*** FLOP *** [9c Jd 4h]
kMa8BltUcBQVxnHfqdCfXg: checks 
7S16WhQHiAVLWwRuqPrpnw: checks 
ypmjhffk/YHGc51wgVXUTw: bets $2.75
kMa8BltUcBQVxnHfqdCfXg: calls $2.75
7S16WhQHiAVLWwRuqPrpnw: calls $2.75
*** TURN *** [9c Jd 4h] [Kc]
kMa8BltUcBQVxnHfqdCfXg: bets $1.25 and is all-in
7S16WhQHiAVLWwRuqPrpnw: raises $1.25 to $2.50
ypmjhffk/YHGc51wgVXUTw: calls $2.50
*** RIVER *** [9c Jd 4h Kc] [Th]
7S16WhQHiAVLWwRuqPrpnw: checks 
ypmjhffk/YHGc51wgVXUTw: bets $8
7S16WhQHiAVLWwRuqPrpnw: calls $8
*** SHOW DOWN ***
ypmjhffk/YHGc51wgVXUTw: shows [Qd Ac] (a straight, Ten to Ace)
7S16WhQHiAVLWwRuqPrpnw: mucks hand 
ypmjhffk/YHGc51wgVXUTw collected $17.60 from side pot
kMa8BltUcBQVxnHfqdCfXg: mucks hand 
ypmjhffk/YHGc51wgVXUTw collected $14.40 from main pot
*** SUMMARY ***
Total pot $33.60 Main pot $14.40. Side pot $17.60. | Rake $1.60 
Board [9c Jd 4h Kc Th]
Seat 1: ypmjhffk/YHGc51wgVXUTw showed [Qd Ac] and won ($32) with a straight, Ten to Ace
Seat 2: gqrr7lSWrQ1N8zKx8zZzvA folded before Flop (didn't bet)
Seat 3: 8JTm/CXBn3+kuQgcUOgPkw (button) folded before Flop (didn't bet)
Seat 4: 8ClCHtFXGNplITm+63KB+Q (small blind) folded before Flop
Seat 5: kMa8BltUcBQVxnHfqdCfXg (big blind) mucked
Seat 6: 7S16WhQHiAVLWwRuqPrpnw mucked




PokerStars Game #59941551370:  Hold'em No Limit ($0.10/$0.25) - 2009/07/01 1:38:54 ET
Table '4ZbiE0ZYjzqmgu6+sO1prg' 9-max Seat #4 is the button
Seat 1: eXiRSFoUjkV5taBc4N8rMQ ($8.75 in chips) 
Seat 2: 9lvO/qyU+xrU95Teu1fv0g ($5.55 in chips) 
Seat 3: HPEB+AtKw1+C/cxU0o1ciw ($25.55 in chips) 
Seat 4: w1ukf8uPa4+WH561TtVRxA ($25 in chips) 
Seat 5: +2kMBNpY4nF1qNCRd8SJLA ($44.05 in chips) 
Seat 6: UmzixCpC0bAc1lDEjgB3NQ ($10.65 in chips) 
Seat 7: aNpwfA31EREwO+ar4XzBCw ($25 in chips) 
Seat 8: cZ99hugmLBj9KhTlc8nCSw ($29.95 in chips) 
+2kMBNpY4nF1qNCRd8SJLA: posts small blind $0.10
UmzixCpC0bAc1lDEjgB3NQ: posts big blind $0.25
RCqMONFrSPSArZh2Jsar/w: sits out 
*** HOLE CARDS ***
aNpwfA31EREwO+ar4XzBCw: folds 
cZ99hugmLBj9KhTlc8nCSw: folds 
eXiRSFoUjkV5taBc4N8rMQ: folds 
9lvO/qyU+xrU95Teu1fv0g: folds 
HPEB+AtKw1+C/cxU0o1ciw: folds 
w1ukf8uPa4+WH561TtVRxA: folds 
+2kMBNpY4nF1qNCRd8SJLA: folds 
Uncalled bet ($0.15) returned to UmzixCpC0bAc1lDEjgB3NQ
UmzixCpC0bAc1lDEjgB3NQ collected $0.20 from pot
*** SUMMARY ***
Total pot $0.20 | Rake $0 
Seat 1: eXiRSFoUjkV5taBc4N8rMQ folded before Flop (didn't bet)
Seat 2: 9lvO/qyU+xrU95Teu1fv0g folded before Flop (didn't bet)
Seat 3: HPEB+AtKw1+C/cxU0o1ciw folded before Flop (didn't bet)
Seat 4: w1ukf8uPa4+WH561TtVRxA (button) folded before Flop (didn't bet)
Seat 5: +2kMBNpY4nF1qNCRd8SJLA (small blind) folded before Flop
Seat 6: UmzixCpC0bAc1lDEjgB3NQ (big blind) collected ($0.20)
Seat 7: aNpwfA31EREwO+ar4XzBCw folded before Flop (didn't bet)
Seat 8: cZ99hugmLBj9KhTlc8nCSw folded before Flop (didn't bet)




PokerStars Game #59941551798:  Hold'em No Limit ($0.10/$0.25) - 2009/07/01 1:38:54 ET
Table 'fHv1Mk7ZbLjprZTGWKPiEQ' 6-max Seat #3 is the button
Seat 3: /gJNBeCkWL4o85/jvlZ4BA ($25 in chips) 
Seat 4: TSmua8tGK3sTbwi0ynrW9Q ($53.35 in chips) 
Seat 5: LJI7A1YgDM7hgh7o56+ReQ ($27.15 in chips) 
Seat 6: AjG0X+rNtc2W08eph8oqpw ($35.15 in chips) 
TSmua8tGK3sTbwi0ynrW9Q: posts small blind $0.10
LJI7A1YgDM7hgh7o56+ReQ: posts big blind $0.25
*** HOLE CARDS ***
AjG0X+rNtc2W08eph8oqpw: folds 
/gJNBeCkWL4o85/jvlZ4BA: raises $0.75 to $1
TSmua8tGK3sTbwi0ynrW9Q: folds 
LJI7A1YgDM7hgh7o56+ReQ: folds 
Uncalled bet ($0.75) returned to /gJNBeCkWL4o85/jvlZ4BA
/gJNBeCkWL4o85/jvlZ4BA collected $0.60 from pot
*** SUMMARY ***
Total pot $0.60 | Rake $0 
Seat 3: /gJNBeCkWL4o85/jvlZ4BA (button) collected ($0.60)
Seat 4: TSmua8tGK3sTbwi0ynrW9Q (small blind) folded before Flop
Seat 5: LJI7A1YgDM7hgh7o56+ReQ (big blind) folded before Flop
Seat 6: AjG0X+rNtc2W08eph8oqpw folded before Flop (didn't bet)




PokerStars Game #59941552128:  Hold'em No Limit ($0.10/$0.25) - 2009/07/01 1:38:55 ET
Table '7/qMNloI0nSXWiX5Y1watA' 9-max Seat #8 is the button
Seat 1: /LyhaB3V6jkgOfXORidqRQ ($11 in chips) 
Seat 2: wGigCmBR/9XWkPpvYos3aQ ($33.15 in chips) 
Seat 3: W2YYHvqjaEpRrO7stZkClQ ($5.45 in chips) 
Seat 4: K0LdhPeU31rviEPo6Sv3TA ($9 in chips) 
Seat 6: Y3DZ6qQlLeBhixDj4M9vmg ($3.15 in chips) 
Seat 7: z5GxcHlYz/GSz6W2uFiTtg ($23.55 in chips) 
Seat 8: ljemhp25Zg+nlA9DLCIiUw ($24 in chips) 
Seat 9: dmYlc+1cjwZMJ7wV+Z0rRg ($26.60 in chips) 
dmYlc+1cjwZMJ7wV+Z0rRg: posts small blind $0.10
/LyhaB3V6jkgOfXORidqRQ: posts big blind $0.25
*** HOLE CARDS ***
wGigCmBR/9XWkPpvYos3aQ: folds 
W2YYHvqjaEpRrO7stZkClQ: folds 
K0LdhPeU31rviEPo6Sv3TA: folds 
Y3DZ6qQlLeBhixDj4M9vmg: raises $0.25 to $0.50
z5GxcHlYz/GSz6W2uFiTtg: folds 
ljemhp25Zg+nlA9DLCIiUw: folds 
dmYlc+1cjwZMJ7wV+Z0rRg: folds 
/LyhaB3V6jkgOfXORidqRQ: raises $0.25 to $0.75
Y3DZ6qQlLeBhixDj4M9vmg: calls $0.25
*** FLOP *** [Qc Ts 9s]
/LyhaB3V6jkgOfXORidqRQ: checks 
Y3DZ6qQlLeBhixDj4M9vmg: bets $0.25
/LyhaB3V6jkgOfXORidqRQ: calls $0.25
*** TURN *** [Qc Ts 9s] [Ad]
/LyhaB3V6jkgOfXORidqRQ: checks 
Y3DZ6qQlLeBhixDj4M9vmg: bets $1.75
/LyhaB3V6jkgOfXORidqRQ: calls $1.75
*** RIVER *** [Qc Ts 9s Ad] [5s]
/LyhaB3V6jkgOfXORidqRQ: checks 
Y3DZ6qQlLeBhixDj4M9vmg: bets $0.40 and is all-in
/LyhaB3V6jkgOfXORidqRQ: calls $0.40
*** SHOW DOWN ***
Y3DZ6qQlLeBhixDj4M9vmg: shows [Qh 9c] (two pair, Queens and Nines)
/LyhaB3V6jkgOfXORidqRQ: mucks hand 
Y3DZ6qQlLeBhixDj4M9vmg collected $6.10 from pot
*** SUMMARY ***
Total pot $6.40 | Rake $0.30 
Board [Qc Ts 9s Ad 5s]
Seat 1: /LyhaB3V6jkgOfXORidqRQ (big blind) mucked
Seat 2: wGigCmBR/9XWkPpvYos3aQ folded before Flop (didn't bet)
Seat 3: W2YYHvqjaEpRrO7stZkClQ folded before Flop (didn't bet)
Seat 4: K0LdhPeU31rviEPo6Sv3TA folded before Flop (didn't bet)
Seat 6: Y3DZ6qQlLeBhixDj4M9vmg showed [Qh 9c] and won ($6.10) with two pair, Queens and Nines
Seat 7: z5GxcHlYz/GSz6W2uFiTtg folded before Flop (didn't bet)
Seat 8: ljemhp25Zg+nlA9DLCIiUw (button) folded before Flop (didn't bet)
Seat 9: dmYlc+1cjwZMJ7wV+Z0rRg (small blind) folded before Flop




PokerStars Game #59941552462:  Hold'em No Limit ($0.10/$0.25) - 2009/07/01 1:38:55 ET
Table 'gnrUwXkIPE0C8xl6cB4Hyw' 9-max Seat #9 is the button
Seat 1: EQXHDnIzAsORnIXRNtXRlA ($22.70 in chips) 
Seat 2: 7je+LC5Mfs6nL8YBVh4frQ ($5 in chips) 
Seat 3: PdIasPkzm2sqZnN41ZRXOg ($5 in chips) 
Seat 4: wGigCmBR/9XWkPpvYos3aQ ($25.35 in chips) 
Seat 5: gehe91e0IyVT0QU/XBkEyg ($27.50 in chips) 
Seat 6: dtZ84flFEi4Q+SGrHMJRDQ ($26.15 in chips) 
Seat 7: OXPkK84/qv92EMwXPiG5rQ ($9.75 in chips) 
Seat 8: 4awUyiDYTgylQKXZ9faBVA ($56.20 in chips) 
Seat 9: F7pnn6czNpHvRM55XcA2EA ($28.10 in chips) 
EQXHDnIzAsORnIXRNtXRlA: posts small blind $0.10
7je+LC5Mfs6nL8YBVh4frQ: posts big blind $0.25
*** HOLE CARDS ***
PdIasPkzm2sqZnN41ZRXOg: folds 
wGigCmBR/9XWkPpvYos3aQ: folds 
gehe91e0IyVT0QU/XBkEyg: folds 
dtZ84flFEi4Q+SGrHMJRDQ: folds 
OXPkK84/qv92EMwXPiG5rQ: folds 
4awUyiDYTgylQKXZ9faBVA: folds 
F7pnn6czNpHvRM55XcA2EA: folds 
EQXHDnIzAsORnIXRNtXRlA: folds 
Uncalled bet ($0.15) returned to 7je+LC5Mfs6nL8YBVh4frQ
7je+LC5Mfs6nL8YBVh4frQ collected $0.20 from pot
7je+LC5Mfs6nL8YBVh4frQ: doesn't show hand 
*** SUMMARY ***
Total pot $0.20 | Rake $0 
Seat 1: EQXHDnIzAsORnIXRNtXRlA (small blind) folded before Flop
Seat 2: 7je+LC5Mfs6nL8YBVh4frQ (big blind) collected ($0.20)
Seat 3: PdIasPkzm2sqZnN41ZRXOg folded before Flop (didn't bet)
Seat 4: wGigCmBR/9XWkPpvYos3aQ folded before Flop (didn't bet)
Seat 5: gehe91e0IyVT0QU/XBkEyg folded before Flop (didn't bet)
Seat 6: dtZ84flFEi4Q+SGrHMJRDQ folded before Flop (didn't bet)
Seat 7: OXPkK84/qv92EMwXPiG5rQ folded before Flop (didn't bet)
Seat 8: 4awUyiDYTgylQKXZ9faBVA folded before Flop (didn't bet)
Seat 9: F7pnn6czNpHvRM55XcA2EA (button) folded before Flop (didn't bet)




PokerStars Game #59941552066:  Hold'em No Limit ($0.10/$0.25) - 2009/07/01 1:38:55 ET
Table 'wPWRBZPJl1HAnysw7qRR0A' 6-max Seat #3 is the button
Seat 1: m7ne1MOFTQXlsXT7/R/rug ($6.75 in chips) 
Seat 2: uUXdcVMNa05rfbntdvplfw ($15.15 in chips) 
Seat 3: 1ZpoLWO2nm2w1Nd1v9Sr3g ($8.90 in chips) 
Seat 4: g9++7w2tsgKmQ4gr54+0hA ($16.75 in chips) 
Seat 5: y0B+UpYpOUJz3JWtlJQBSA ($21.80 in chips) 
Seat 6: Hsvkc0/G2VV78oVmWYXecw ($5 in chips) 
g9++7w2tsgKmQ4gr54+0hA: posts small blind $0.10
y0B+UpYpOUJz3JWtlJQBSA: posts big blind $0.25
*** HOLE CARDS ***
Hsvkc0/G2VV78oVmWYXecw: folds 
m7ne1MOFTQXlsXT7/R/rug: calls $0.25
uUXdcVMNa05rfbntdvplfw: folds 
1ZpoLWO2nm2w1Nd1v9Sr3g: raises $0.50 to $0.75
g9++7w2tsgKmQ4gr54+0hA: folds 
y0B+UpYpOUJz3JWtlJQBSA: folds 
m7ne1MOFTQXlsXT7/R/rug: calls $0.50
*** FLOP *** [4d Tc 7h]
m7ne1MOFTQXlsXT7/R/rug: checks 
1ZpoLWO2nm2w1Nd1v9Sr3g: bets $1.50
m7ne1MOFTQXlsXT7/R/rug: calls $1.50
*** TURN *** [4d Tc 7h] [8c]
m7ne1MOFTQXlsXT7/R/rug: checks 
1ZpoLWO2nm2w1Nd1v9Sr3g: checks 
*** RIVER *** [4d Tc 7h 8c] [3h]
m7ne1MOFTQXlsXT7/R/rug: bets $4.50 and is all-in
1ZpoLWO2nm2w1Nd1v9Sr3g: folds 
Uncalled bet ($4.50) returned to m7ne1MOFTQXlsXT7/R/rug
m7ne1MOFTQXlsXT7/R/rug collected $4.65 from pot
m7ne1MOFTQXlsXT7/R/rug: doesn't show hand 
*** SUMMARY ***
Total pot $4.85 | Rake $0.20 
Board [4d Tc 7h 8c 3h]
Seat 1: m7ne1MOFTQXlsXT7/R/rug collected ($4.65)
Seat 2: uUXdcVMNa05rfbntdvplfw folded before Flop (didn't bet)
Seat 3: 1ZpoLWO2nm2w1Nd1v9Sr3g (button) folded on the River
Seat 4: g9++7w2tsgKmQ4gr54+0hA (small blind) folded before Flop
Seat 5: y0B+UpYpOUJz3JWtlJQBSA (big blind) folded before Flop
Seat 6: Hsvkc0/G2VV78oVmWYXecw folded before Flop (didn't bet)




PokerStars Game #59941552360:  Hold'em No Limit ($0.10/$0.25) - 2009/07/01 1:38:55 ET
Table 'Ok3oDLIsTc2+KxPcI0bAOA' 6-max Seat #3 is the button
Seat 1: agQm3ugZ3qSVYNgNu1ddeA ($42.35 in chips) 
Seat 2: DE9hRlt14g+JdsRQ4wT7hg ($41.20 in chips) 
Seat 3: lquriepNQBhDV5P1SWHhnA ($25.25 in chips) 
Seat 4: LJI7A1YgDM7hgh7o56+ReQ ($38.60 in chips) 
Seat 5: DFi/Lzkjsfv8QswS80JX9Q ($28.60 in chips) 
Seat 6: Hsvkc0/G2VV78oVmWYXecw ($5.30 in chips) 
LJI7A1YgDM7hgh7o56+ReQ: posts small blind $0.10
DFi/Lzkjsfv8QswS80JX9Q: posts big blind $0.25
*** HOLE CARDS ***
Hsvkc0/G2VV78oVmWYXecw: folds 
agQm3ugZ3qSVYNgNu1ddeA: calls $0.25
DE9hRlt14g+JdsRQ4wT7hg: raises $1 to $1.25
lquriepNQBhDV5P1SWHhnA: folds 
LJI7A1YgDM7hgh7o56+ReQ: folds 
DFi/Lzkjsfv8QswS80JX9Q: folds 
agQm3ugZ3qSVYNgNu1ddeA: folds 
Uncalled bet ($1) returned to DE9hRlt14g+JdsRQ4wT7hg
DE9hRlt14g+JdsRQ4wT7hg collected $0.85 from pot
DE9hRlt14g+JdsRQ4wT7hg: doesn't show hand 
*** SUMMARY ***
Total pot $0.85 | Rake $0 
Seat 1: agQm3ugZ3qSVYNgNu1ddeA folded before Flop
Seat 2: DE9hRlt14g+JdsRQ4wT7hg collected ($0.85)
Seat 3: lquriepNQBhDV5P1SWHhnA (button) folded before Flop (didn't bet)
Seat 4: LJI7A1YgDM7hgh7o56+ReQ (small blind) folded before Flop
Seat 5: DFi/Lzkjsfv8QswS80JX9Q (big blind) folded before Flop
Seat 6: Hsvkc0/G2VV78oVmWYXecw folded before Flop (didn't bet)




PokerStars Game #59941552944:  Hold'em No Limit ($0.10/$0.25) - 2009/07/01 1:38:56 ET
Table 'xPn6TS/y/OWkX7Qa+MUuKA' 6-max Seat #3 is the button
Seat 1: JFIAqU8lCZ0vWwEl4bdGsg ($42.15 in chips) 
Seat 2: buyjetgNT1McXtdaP4zynA ($32.50 in chips) 
Seat 3: q6WfTUAD9mowIP63ASq2Dg ($25.90 in chips) 
Seat 4: SS/yfeArhULzIcOPe8MdPg ($26 in chips) 
Seat 5: lquriepNQBhDV5P1SWHhnA ($25.45 in chips) 
Seat 6: DihMHaz4WNETH1bPDe13kA ($25 in chips) 
SS/yfeArhULzIcOPe8MdPg: posts small blind $0.10
lquriepNQBhDV5P1SWHhnA: posts big blind $0.25
*** HOLE CARDS ***
DihMHaz4WNETH1bPDe13kA: folds 
JFIAqU8lCZ0vWwEl4bdGsg: folds 
buyjetgNT1McXtdaP4zynA: folds 
q6WfTUAD9mowIP63ASq2Dg: folds 
SS/yfeArhULzIcOPe8MdPg: folds 
Uncalled bet ($0.15) returned to lquriepNQBhDV5P1SWHhnA
lquriepNQBhDV5P1SWHhnA collected $0.20 from pot
lquriepNQBhDV5P1SWHhnA: doesn't show hand 
*** SUMMARY ***
Total pot $0.20 | Rake $0 
Seat 1: JFIAqU8lCZ0vWwEl4bdGsg folded before Flop (didn't bet)
Seat 2: buyjetgNT1McXtdaP4zynA folded before Flop (didn't bet)
Seat 3: q6WfTUAD9mowIP63ASq2Dg (button) folded before Flop (didn't bet)
Seat 4: SS/yfeArhULzIcOPe8MdPg (small blind) folded before Flop
Seat 5: lquriepNQBhDV5P1SWHhnA (big blind) collected ($0.20)
Seat 6: DihMHaz4WNETH1bPDe13kA folded before Flop (didn't bet)




PokerStars Game #59941552746:  Hold'em No Limit ($0.10/$0.25) - 2009/07/01 1:38:56 ET
Table '63uh7ZsO7Tnt+E8b/2bu3A' 6-max Seat #3 is the button
Seat 1: 0av6tRNdi0Ui4f15L7gsVg ($26.15 in chips) 
Seat 2: SFmT9ZsVopnukjvAzrxTRg ($30.25 in chips) 
Seat 3: yVP7GLZBzx47OPi6jzUxMw ($17 in chips) 
Seat 4: 2tYgzzRRW/D2GWb2A7f1jw ($5.75 in chips) 
Seat 5: GbCVUNssQ7mqsPWr7J4d3w ($5.35 in chips) 
Seat 6: qGHGf/553gQnDoklMRe3tg ($32.35 in chips) 
2tYgzzRRW/D2GWb2A7f1jw: posts small blind $0.10
GbCVUNssQ7mqsPWr7J4d3w: posts big blind $0.25
*** HOLE CARDS ***
qGHGf/553gQnDoklMRe3tg: folds 
0av6tRNdi0Ui4f15L7gsVg: folds 
SFmT9ZsVopnukjvAzrxTRg: folds 
yVP7GLZBzx47OPi6jzUxMw: raises $0.50 to $0.75
2tYgzzRRW/D2GWb2A7f1jw: calls $0.65
GbCVUNssQ7mqsPWr7J4d3w: folds 
*** FLOP *** [8c Js 5s]
2tYgzzRRW/D2GWb2A7f1jw: bets $0.50
yVP7GLZBzx47OPi6jzUxMw: calls $0.50
*** TURN *** [8c Js 5s] [5h]
2tYgzzRRW/D2GWb2A7f1jw: bets $0.25
yVP7GLZBzx47OPi6jzUxMw: calls $0.25
*** RIVER *** [8c Js 5s 5h] [8s]
2tYgzzRRW/D2GWb2A7f1jw: bets $1.25
yVP7GLZBzx47OPi6jzUxMw: folds 
Uncalled bet ($1.25) returned to 2tYgzzRRW/D2GWb2A7f1jw
2tYgzzRRW/D2GWb2A7f1jw collected $3.10 from pot
*** SUMMARY ***
Total pot $3.25 | Rake $0.15 
Board [8c Js 5s 5h 8s]
Seat 1: 0av6tRNdi0Ui4f15L7gsVg folded before Flop (didn't bet)
Seat 2: SFmT9ZsVopnukjvAzrxTRg folded before Flop (didn't bet)
Seat 3: yVP7GLZBzx47OPi6jzUxMw (button) folded on the River
Seat 4: 2tYgzzRRW/D2GWb2A7f1jw (small blind) collected ($3.10)
Seat 5: GbCVUNssQ7mqsPWr7J4d3w (big blind) folded before Flop
Seat 6: qGHGf/553gQnDoklMRe3tg folded before Flop (didn't bet)




PokerStars Game #59941552710:  Hold'em No Limit ($0.10/$0.25) - 2009/07/01 1:38:56 ET
Table 'Xi38lWH8L2JHRAsKYVX8Qg' 6-max Seat #5 is the button
Seat 1: shP7DFAtX7gXcgMJX/OmRQ ($18.45 in chips) 
Seat 2: VOmI0x4dDPnTESZd5B4d1Q ($10.10 in chips) 
Seat 3: 6DwBRH+xZ12AAZmeAg+aXw ($30.60 in chips) 
Seat 4: kG34n23qFQA3nzdOJTQ1dA ($26.75 in chips) 
Seat 5: 79ID/ub1Pt/mDpCprVmOoA ($66.90 in chips) 
Seat 6: kyRaCIljYA6l33lSKQfNsg ($44.25 in chips) 
kyRaCIljYA6l33lSKQfNsg: posts small blind $0.10
shP7DFAtX7gXcgMJX/OmRQ: posts big blind $0.25
*** HOLE CARDS ***
VOmI0x4dDPnTESZd5B4d1Q: folds 
6DwBRH+xZ12AAZmeAg+aXw: folds 
kG34n23qFQA3nzdOJTQ1dA: folds 
79ID/ub1Pt/mDpCprVmOoA: raises $0.50 to $0.75
kyRaCIljYA6l33lSKQfNsg: folds 
shP7DFAtX7gXcgMJX/OmRQ: calls $0.50
*** FLOP *** [3h 3s 3d]
shP7DFAtX7gXcgMJX/OmRQ: checks 
79ID/ub1Pt/mDpCprVmOoA: bets $1
shP7DFAtX7gXcgMJX/OmRQ: calls $1
*** TURN *** [3h 3s 3d] [Ts]
shP7DFAtX7gXcgMJX/OmRQ: checks 
79ID/ub1Pt/mDpCprVmOoA: checks 
*** RIVER *** [3h 3s 3d Ts] [5d]
shP7DFAtX7gXcgMJX/OmRQ: bets $3
79ID/ub1Pt/mDpCprVmOoA: folds 
Uncalled bet ($3) returned to shP7DFAtX7gXcgMJX/OmRQ
shP7DFAtX7gXcgMJX/OmRQ collected $3.45 from pot
shP7DFAtX7gXcgMJX/OmRQ: doesn't show hand 
*** SUMMARY ***
Total pot $3.60 | Rake $0.15 
Board [3h 3s 3d Ts 5d]
Seat 1: shP7DFAtX7gXcgMJX/OmRQ (big blind) collected ($3.45)
Seat 2: VOmI0x4dDPnTESZd5B4d1Q folded before Flop (didn't bet)
Seat 3: 6DwBRH+xZ12AAZmeAg+aXw folded before Flop (didn't bet)
Seat 4: kG34n23qFQA3nzdOJTQ1dA folded before Flop (didn't bet)
Seat 5: 79ID/ub1Pt/mDpCprVmOoA (button) folded on the River
Seat 6: kyRaCIljYA6l33lSKQfNsg (small blind) folded before Flop




PokerStars Game #59941552562:  Hold'em No Limit ($0.10/$0.25) - 2009/07/01 1:38:56 ET
Table 'S6s+TmTlAjLHclBRvN5/fw' 9-max Seat #7 is the button
Seat 1: /XMgGtJ7mcWfe5s7McY9kw ($22.05 in chips) 
Seat 2: OfGfQFPcghysTDljS9GQSQ ($9.15 in chips) 
Seat 3: imHPFFqvfHGzsBBWeGuy4w ($17.70 in chips) 
Seat 4: M/9j4wkHH9i1JM51vgi1VA ($25.35 in chips) 
Seat 5: z5GxcHlYz/GSz6W2uFiTtg ($39.70 in chips) 
Seat 6: aNpwfA31EREwO+ar4XzBCw ($29.40 in chips) 
Seat 7: vSkQm2EelzwRGDDQQk0Fqw ($4.80 in chips) 
Seat 8: OlPJsgR4xypSg/w1z7Gyvw ($21.50 in chips) 
Seat 9: H5Se03ZqSX7tbULXur2MAg ($23.10 in chips) 
OlPJsgR4xypSg/w1z7Gyvw: posts small blind $0.10
H5Se03ZqSX7tbULXur2MAg: posts big blind $0.25
*** HOLE CARDS ***
/XMgGtJ7mcWfe5s7McY9kw: raises $0.75 to $1
OfGfQFPcghysTDljS9GQSQ: folds 
imHPFFqvfHGzsBBWeGuy4w: folds 
M/9j4wkHH9i1JM51vgi1VA: folds 
z5GxcHlYz/GSz6W2uFiTtg: folds 
aNpwfA31EREwO+ar4XzBCw: folds 
vSkQm2EelzwRGDDQQk0Fqw: folds 
OlPJsgR4xypSg/w1z7Gyvw: folds 
H5Se03ZqSX7tbULXur2MAg: folds 
Uncalled bet ($0.75) returned to /XMgGtJ7mcWfe5s7McY9kw
/XMgGtJ7mcWfe5s7McY9kw collected $0.60 from pot
/XMgGtJ7mcWfe5s7McY9kw: doesn't show hand 
*** SUMMARY ***
Total pot $0.60 | Rake $0 
Seat 1: /XMgGtJ7mcWfe5s7McY9kw collected ($0.60)
Seat 2: OfGfQFPcghysTDljS9GQSQ folded before Flop (didn't bet)
Seat 3: imHPFFqvfHGzsBBWeGuy4w folded before Flop (didn't bet)
Seat 4: M/9j4wkHH9i1JM51vgi1VA folded before Flop (didn't bet)
Seat 5: z5GxcHlYz/GSz6W2uFiTtg folded before Flop (didn't bet)
Seat 6: aNpwfA31EREwO+ar4XzBCw folded before Flop (didn't bet)
Seat 7: vSkQm2EelzwRGDDQQk0Fqw (button) folded before Flop (didn't bet)
Seat 8: OlPJsgR4xypSg/w1z7Gyvw (small blind) folded before Flop
Seat 9: H5Se03ZqSX7tbULXur2MAg (big blind) folded before Flop




PokerStars Game #59941552666:  Hold'em No Limit ($0.10/$0.25) - 2009/07/01 1:38:56 ET
Table 'ykyWGjhNu7AvZXov27T4ew' 9-max Seat #6 is the button
Seat 1: W8cIfrCR+zA8pCNyIuHu8g ($13.75 in chips) 
Seat 2: MG90wfSJZnOejs/KD3vlQQ ($40.10 in chips) 
Seat 3: NPI9ArW8kwrb6a2IAL6xMQ ($14.40 in chips) 
Seat 4: W6tExOcYX7qiy6Qdp+ZwFA ($4.90 in chips) 
Seat 5: CmngQmkKTp8tkl6GMRTl6w ($8.50 in chips) 
Seat 6: AiXn/9o1EwOPZUHujnh/bA ($20.40 in chips) 
Seat 7: npAYqa85pqnzfOK5ukX+BQ ($20.75 in chips) 
Seat 8: tYsOBqdU1+x+yFI7zHO7hQ ($49.70 in chips) 
Seat 9: wk9M6R3w+aDHpr8WV87RmQ ($11.60 in chips) 
npAYqa85pqnzfOK5ukX+BQ: posts small blind $0.10
tYsOBqdU1+x+yFI7zHO7hQ: posts big blind $0.25
*** HOLE CARDS ***
wk9M6R3w+aDHpr8WV87RmQ: folds 
W8cIfrCR+zA8pCNyIuHu8g: raises $0.25 to $0.50
MG90wfSJZnOejs/KD3vlQQ: folds 
NPI9ArW8kwrb6a2IAL6xMQ: folds 
W6tExOcYX7qiy6Qdp+ZwFA: folds 
CmngQmkKTp8tkl6GMRTl6w: folds 
AiXn/9o1EwOPZUHujnh/bA: folds 
npAYqa85pqnzfOK5ukX+BQ: folds 
tYsOBqdU1+x+yFI7zHO7hQ: folds 
Uncalled bet ($0.25) returned to W8cIfrCR+zA8pCNyIuHu8g
W8cIfrCR+zA8pCNyIuHu8g collected $0.60 from pot
*** SUMMARY ***
Total pot $0.60 | Rake $0 
Seat 1: W8cIfrCR+zA8pCNyIuHu8g collected ($0.60)
Seat 2: MG90wfSJZnOejs/KD3vlQQ folded before Flop (didn't bet)
Seat 3: NPI9ArW8kwrb6a2IAL6xMQ folded before Flop (didn't bet)
Seat 4: W6tExOcYX7qiy6Qdp+ZwFA folded before Flop (didn't bet)
Seat 5: CmngQmkKTp8tkl6GMRTl6w folded before Flop (didn't bet)
Seat 6: AiXn/9o1EwOPZUHujnh/bA (button) folded before Flop (didn't bet)
Seat 7: npAYqa85pqnzfOK5ukX+BQ (small blind) folded before Flop
Seat 8: tYsOBqdU1+x+yFI7zHO7hQ (big blind) folded before Flop
Seat 9: wk9M6R3w+aDHpr8WV87RmQ folded before Flop (didn't bet)




PokerStars Game #59941552630:  Hold'em No Limit ($0.10/$0.25) - 2009/07/01 1:38:56 ET
Table 'GgmUtmhrYPRnhkqEEjD/Kw' 9-max Seat #7 is the button
Seat 1: sGFnnRCa1YAHAUmWgsW6Qg ($10 in chips) 
Seat 2: ghNKXUBl/H+t83JF079ZBA ($25.25 in chips) 
Seat 3: dYvYZ723QlKIPiDa0pkedQ ($7.05 in chips) 
Seat 4: dfNim92Z6XK1/h5SFW5vDg ($25 in chips) 
Seat 5: ljemhp25Zg+nlA9DLCIiUw ($27.75 in chips) 
Seat 6: 4Ax0vobe1rLVIGZmkFINGA ($19.45 in chips) 
Seat 7: YwDw9cMqkbMznFK77rru4A ($5.05 in chips) 
Seat 8: DdPXdieucQ+n99u1n3A+rQ ($4.75 in chips) 
Seat 9: V6p0jQ/RhUsqpHLmXvEX4Q ($14.30 in chips) 
DdPXdieucQ+n99u1n3A+rQ: posts small blind $0.10
V6p0jQ/RhUsqpHLmXvEX4Q: posts big blind $0.25
*** HOLE CARDS ***
sGFnnRCa1YAHAUmWgsW6Qg: folds 
ghNKXUBl/H+t83JF079ZBA: folds 
dYvYZ723QlKIPiDa0pkedQ: folds 
dfNim92Z6XK1/h5SFW5vDg: folds 
ljemhp25Zg+nlA9DLCIiUw: folds 
4Ax0vobe1rLVIGZmkFINGA: folds 
YwDw9cMqkbMznFK77rru4A: calls $0.25
DdPXdieucQ+n99u1n3A+rQ: folds 
V6p0jQ/RhUsqpHLmXvEX4Q: checks 
*** FLOP *** [Ad 4c 8h]
V6p0jQ/RhUsqpHLmXvEX4Q: checks 
YwDw9cMqkbMznFK77rru4A: bets $0.50
V6p0jQ/RhUsqpHLmXvEX4Q: folds 
Uncalled bet ($0.50) returned to YwDw9cMqkbMznFK77rru4A
YwDw9cMqkbMznFK77rru4A collected $0.60 from pot
*** SUMMARY ***
Total pot $0.60 | Rake $0 
Board [Ad 4c 8h]
Seat 1: sGFnnRCa1YAHAUmWgsW6Qg folded before Flop (didn't bet)
Seat 2: ghNKXUBl/H+t83JF079ZBA folded before Flop (didn't bet)
Seat 3: dYvYZ723QlKIPiDa0pkedQ folded before Flop (didn't bet)
Seat 4: dfNim92Z6XK1/h5SFW5vDg folded before Flop (didn't bet)
Seat 5: ljemhp25Zg+nlA9DLCIiUw folded before Flop (didn't bet)
Seat 6: 4Ax0vobe1rLVIGZmkFINGA folded before Flop (didn't bet)
Seat 7: YwDw9cMqkbMznFK77rru4A (button) collected ($0.60)
Seat 8: DdPXdieucQ+n99u1n3A+rQ (small blind) folded before Flop
Seat 9: V6p0jQ/RhUsqpHLmXvEX4Q (big blind) folded on the Flop




PokerStars Game #59941552794:  Hold'em No Limit ($0.10/$0.25) - 2009/07/01 1:38:56 ET
Table 'ouLhepGYovxB2x0QxH7cVg' 9-max Seat #5 is the button
Seat 1: ghNKXUBl/H+t83JF079ZBA ($25.35 in chips) 
Seat 2: r1Z5m4PwSI5ANp7qCE1OJw ($19 in chips) 
Seat 3: bXpVeaSTPBFSPJmeXxO7nw ($5.60 in chips) 
Seat 4: a0Sx6GHY7ln2Ns2C97eXeA ($38.30 in chips) 
Seat 5: LxRIJ6NkqjCD5zmzlF+y4w ($14.25 in chips) 
Seat 6: lSeLm4BdnSMLtIli62qjAQ ($7.60 in chips) 
Seat 7: JRV2PblFtPFz51l0Fwyz8g ($23.20 in chips) 
Seat 8: tLcDklc2rBORNfixyRfVfw ($25 in chips) 
Seat 9: ljemhp25Zg+nlA9DLCIiUw ($25 in chips) 
lSeLm4BdnSMLtIli62qjAQ: posts small blind $0.10
JRV2PblFtPFz51l0Fwyz8g: posts big blind $0.25
*** HOLE CARDS ***
tLcDklc2rBORNfixyRfVfw: folds 
ljemhp25Zg+nlA9DLCIiUw: folds 
ghNKXUBl/H+t83JF079ZBA: folds 
r1Z5m4PwSI5ANp7qCE1OJw: folds 
bXpVeaSTPBFSPJmeXxO7nw: folds 
a0Sx6GHY7ln2Ns2C97eXeA has timed out
a0Sx6GHY7ln2Ns2C97eXeA: folds 
a0Sx6GHY7ln2Ns2C97eXeA is sitting out
LxRIJ6NkqjCD5zmzlF+y4w: raises $0.50 to $0.75
lSeLm4BdnSMLtIli62qjAQ: folds 
JRV2PblFtPFz51l0Fwyz8g: folds 
Uncalled bet ($0.50) returned to LxRIJ6NkqjCD5zmzlF+y4w
LxRIJ6NkqjCD5zmzlF+y4w collected $0.60 from pot
*** SUMMARY ***
Total pot $0.60 | Rake $0 
Seat 1: ghNKXUBl/H+t83JF079ZBA folded before Flop (didn't bet)
Seat 2: r1Z5m4PwSI5ANp7qCE1OJw folded before Flop (didn't bet)
Seat 3: bXpVeaSTPBFSPJmeXxO7nw folded before Flop (didn't bet)
Seat 4: a0Sx6GHY7ln2Ns2C97eXeA folded before Flop (didn't bet)
Seat 5: LxRIJ6NkqjCD5zmzlF+y4w (button) collected ($0.60)
Seat 6: lSeLm4BdnSMLtIli62qjAQ (small blind) folded before Flop
Seat 7: JRV2PblFtPFz51l0Fwyz8g (big blind) folded before Flop
Seat 8: tLcDklc2rBORNfixyRfVfw folded before Flop (didn't bet)
Seat 9: ljemhp25Zg+nlA9DLCIiUw folded before Flop (didn't bet)




PokerStars Game #59941552622:  Hold'em No Limit ($0.10/$0.25) - 2009/07/01 1:38:56 ET
Table 'jz4TpuH+ag+0iNe2ZcxckQ' 9-max Seat #8 is the button
Seat 1: +C3eP/ysyROWbEXJFPswVA ($16.05 in chips) 
Seat 2: OXPkK84/qv92EMwXPiG5rQ ($10 in chips) 
Seat 4: k+2r6di6GXjNpAdrRkW9bA ($63 in chips) 
Seat 5: v1BVHNGLbP/nx7QO6K7+Jw ($25.45 in chips) 
Seat 6: gO1uiTGTzn5Cd3PECuws1g ($15 in chips) 
Seat 7: tLcDklc2rBORNfixyRfVfw ($29.35 in chips) 
Seat 8: uhrboV251dcgYniYTdFIcA ($25 in chips) 
Seat 9: W2YYHvqjaEpRrO7stZkClQ ($5.90 in chips) 
W2YYHvqjaEpRrO7stZkClQ: posts small blind $0.10
+C3eP/ysyROWbEXJFPswVA: posts big blind $0.25
OXPkK84/qv92EMwXPiG5rQ: posts big blind $0.25
egvg3mTBBVzMHnJPIQiKcA: sits out 
gO1uiTGTzn5Cd3PECuws1g: posts big blind $0.25
*** HOLE CARDS ***
OXPkK84/qv92EMwXPiG5rQ: checks 
k+2r6di6GXjNpAdrRkW9bA: folds 
v1BVHNGLbP/nx7QO6K7+Jw: folds 
gO1uiTGTzn5Cd3PECuws1g: checks 
tLcDklc2rBORNfixyRfVfw: raises $1.25 to $1.50
uhrboV251dcgYniYTdFIcA: folds 
W2YYHvqjaEpRrO7stZkClQ: folds 
+C3eP/ysyROWbEXJFPswVA: folds 
OXPkK84/qv92EMwXPiG5rQ: folds 
gO1uiTGTzn5Cd3PECuws1g: folds 
Uncalled bet ($1.25) returned to tLcDklc2rBORNfixyRfVfw
tLcDklc2rBORNfixyRfVfw collected $1.10 from pot
tLcDklc2rBORNfixyRfVfw: doesn't show hand 
*** SUMMARY ***
Total pot $1.10 | Rake $0 
Seat 1: +C3eP/ysyROWbEXJFPswVA (big blind) folded before Flop
Seat 2: OXPkK84/qv92EMwXPiG5rQ folded before Flop
Seat 4: k+2r6di6GXjNpAdrRkW9bA folded before Flop (didn't bet)
Seat 5: v1BVHNGLbP/nx7QO6K7+Jw folded before Flop (didn't bet)
Seat 6: gO1uiTGTzn5Cd3PECuws1g folded before Flop
Seat 7: tLcDklc2rBORNfixyRfVfw collected ($1.10)
Seat 8: uhrboV251dcgYniYTdFIcA (button) folded before Flop (didn't bet)
Seat 9: W2YYHvqjaEpRrO7stZkClQ (small blind) folded before Flop




PokerStars Game #59941553190:  Hold'em No Limit ($0.10/$0.25) - 2009/07/01 1:38:57 ET
Table 'aaXqTKUnxrX9DYXtxhWXxA' 6-max Seat #6 is the button
Seat 1: rnpAao581IcvQglpkpnkoQ ($7.20 in chips) 
Seat 2: DE9hRlt14g+JdsRQ4wT7hg ($34.40 in chips) 
Seat 4: 48oT5xFI+5CHUJlfoGrE4w ($10.80 in chips) 
Seat 5: kyRaCIljYA6l33lSKQfNsg ($27 in chips) 
Seat 6: buyjetgNT1McXtdaP4zynA ($13.65 in chips) 
rnpAao581IcvQglpkpnkoQ: posts small blind $0.10
DE9hRlt14g+JdsRQ4wT7hg: posts big blind $0.25
N6vygzX+airCyzOAF2w+HQ: sits out 
*** HOLE CARDS ***
48oT5xFI+5CHUJlfoGrE4w: folds 
kyRaCIljYA6l33lSKQfNsg: folds 
buyjetgNT1McXtdaP4zynA: raises $0.75 to $1
rnpAao581IcvQglpkpnkoQ: calls $0.90
DE9hRlt14g+JdsRQ4wT7hg: folds 
*** FLOP *** [6s Ac Ah]
rnpAao581IcvQglpkpnkoQ: checks 
buyjetgNT1McXtdaP4zynA: checks 
*** TURN *** [6s Ac Ah] [2s]
rnpAao581IcvQglpkpnkoQ: checks 
buyjetgNT1McXtdaP4zynA: checks 
*** RIVER *** [6s Ac Ah 2s] [Tc]
rnpAao581IcvQglpkpnkoQ: checks 
buyjetgNT1McXtdaP4zynA: checks 
*** SHOW DOWN ***
rnpAao581IcvQglpkpnkoQ: shows [8d 8s] (two pair, Aces and Eights)
buyjetgNT1McXtdaP4zynA: mucks hand 
rnpAao581IcvQglpkpnkoQ collected $2.15 from pot
*** SUMMARY ***
Total pot $2.25 | Rake $0.10 
Board [6s Ac Ah 2s Tc]
Seat 1: rnpAao581IcvQglpkpnkoQ (small blind) showed [8d 8s] and won ($2.15) with two pair, Aces and Eights
Seat 2: DE9hRlt14g+JdsRQ4wT7hg (big blind) folded before Flop
Seat 4: 48oT5xFI+5CHUJlfoGrE4w folded before Flop (didn't bet)
Seat 5: kyRaCIljYA6l33lSKQfNsg folded before Flop (didn't bet)
Seat 6: buyjetgNT1McXtdaP4zynA (button) mucked




PokerStars Game #59941553038:  Hold'em No Limit ($0.10/$0.25) - 2009/07/01 1:38:57 ET
Table 'P1IJQ2p3ACFySC35W1qwQw' 9-max Seat #3 is the button
Seat 1: bXpVeaSTPBFSPJmeXxO7nw ($4.65 in chips) 
Seat 2: vO3QVRovWemcGMkm7ijAIA ($5 in chips) 
Seat 3: PVxvfRTRvkgZf9WtquEkwQ ($25 in chips) 
Seat 4: c/9X4zftzphFxYtxp5kp9w ($28.25 in chips) 
Seat 5: ghNKXUBl/H+t83JF079ZBA ($56.80 in chips) 
Seat 6: ljemhp25Zg+nlA9DLCIiUw ($64.80 in chips) 
Seat 7: 7je+LC5Mfs6nL8YBVh4frQ ($4.65 in chips) 
Seat 8: tLcDklc2rBORNfixyRfVfw ($26.25 in chips) 
Seat 9: XXajyXkgbSGJKxQP3mal/Q ($15.40 in chips) 
c/9X4zftzphFxYtxp5kp9w: posts small blind $0.10
ghNKXUBl/H+t83JF079ZBA: posts big blind $0.25
*** HOLE CARDS ***
ljemhp25Zg+nlA9DLCIiUw: folds 
7je+LC5Mfs6nL8YBVh4frQ: folds 
tLcDklc2rBORNfixyRfVfw: folds 
XXajyXkgbSGJKxQP3mal/Q: folds 
bXpVeaSTPBFSPJmeXxO7nw: folds 
vO3QVRovWemcGMkm7ijAIA: raises $0.50 to $0.75
PVxvfRTRvkgZf9WtquEkwQ: folds 
c/9X4zftzphFxYtxp5kp9w: folds 
ghNKXUBl/H+t83JF079ZBA: folds 
Uncalled bet ($0.50) returned to vO3QVRovWemcGMkm7ijAIA
vO3QVRovWemcGMkm7ijAIA collected $0.60 from pot
*** SUMMARY ***
Total pot $0.60 | Rake $0 
Seat 1: bXpVeaSTPBFSPJmeXxO7nw folded before Flop (didn't bet)
Seat 2: vO3QVRovWemcGMkm7ijAIA collected ($0.60)
Seat 3: PVxvfRTRvkgZf9WtquEkwQ (button) folded before Flop (didn't bet)
Seat 4: c/9X4zftzphFxYtxp5kp9w (small blind) folded before Flop
Seat 5: ghNKXUBl/H+t83JF079ZBA (big blind) folded before Flop
Seat 6: ljemhp25Zg+nlA9DLCIiUw folded before Flop (didn't bet)
Seat 7: 7je+LC5Mfs6nL8YBVh4frQ folded before Flop (didn't bet)
Seat 8: tLcDklc2rBORNfixyRfVfw folded before Flop (didn't bet)
Seat 9: XXajyXkgbSGJKxQP3mal/Q folded before Flop (didn't bet)




PokerStars Game #59941553392:  Hold'em No Limit ($0.10/$0.25) - 2009/07/01 1:38:57 ET
Table '5VWnrlxdjwVfMWkVS2WE7A' 6-max Seat #5 is the button
Seat 1: 82p+w3EmUaFFHuwpSeGY1w ($14.25 in chips) 
Seat 2: LJI7A1YgDM7hgh7o56+ReQ ($27.35 in chips) 
Seat 3: SFmT9ZsVopnukjvAzrxTRg ($36.30 in chips) 
Seat 4: Pb/gJ3OxOZx57fFp0MDgkg ($26.40 in chips) 
Seat 5: SgMFmwYtNvq9Y+2ZxPSiWQ ($21.85 in chips) 
Seat 6: LtASJ9OlkqGrrUKGQlpGAw ($11.95 in chips) 
LtASJ9OlkqGrrUKGQlpGAw: posts small blind $0.10
82p+w3EmUaFFHuwpSeGY1w: posts big blind $0.25
*** HOLE CARDS ***
LJI7A1YgDM7hgh7o56+ReQ: raises $0.75 to $1
SFmT9ZsVopnukjvAzrxTRg: folds 
Pb/gJ3OxOZx57fFp0MDgkg: calls $1
SgMFmwYtNvq9Y+2ZxPSiWQ: folds 
LtASJ9OlkqGrrUKGQlpGAw: folds 
82p+w3EmUaFFHuwpSeGY1w: calls $0.75
*** FLOP *** [3h 2h Jc]
82p+w3EmUaFFHuwpSeGY1w: checks 
LJI7A1YgDM7hgh7o56+ReQ: checks 
Pb/gJ3OxOZx57fFp0MDgkg: bets $2
82p+w3EmUaFFHuwpSeGY1w: calls $2
LJI7A1YgDM7hgh7o56+ReQ: folds 
*** TURN *** [3h 2h Jc] [Jh]
82p+w3EmUaFFHuwpSeGY1w: checks 
Pb/gJ3OxOZx57fFp0MDgkg: bets $6
82p+w3EmUaFFHuwpSeGY1w: calls $6
*** RIVER *** [3h 2h Jc Jh] [Ts]
82p+w3EmUaFFHuwpSeGY1w: checks 
Pb/gJ3OxOZx57fFp0MDgkg: checks 
*** SHOW DOWN ***
82p+w3EmUaFFHuwpSeGY1w: shows [3c Ah] (two pair, Jacks and Threes)
Pb/gJ3OxOZx57fFp0MDgkg: shows [Ks Kc] (two pair, Kings and Jacks)
Pb/gJ3OxOZx57fFp0MDgkg collected $18.20 from pot
*** SUMMARY ***
Total pot $19.10 | Rake $0.90 
Board [3h 2h Jc Jh Ts]
Seat 1: 82p+w3EmUaFFHuwpSeGY1w (big blind) showed [3c Ah] and lost with two pair, Jacks and Threes
Seat 2: LJI7A1YgDM7hgh7o56+ReQ folded on the Flop
Seat 3: SFmT9ZsVopnukjvAzrxTRg folded before Flop (didn't bet)
Seat 4: Pb/gJ3OxOZx57fFp0MDgkg showed [Ks Kc] and won ($18.20) with two pair, Kings and Jacks
Seat 5: SgMFmwYtNvq9Y+2ZxPSiWQ (button) folded before Flop (didn't bet)
Seat 6: LtASJ9OlkqGrrUKGQlpGAw (small blind) folded before Flop




PokerStars Game #59941553362:  Hold'em No Limit ($0.10/$0.25) - 2009/07/01 1:38:57 ET
Table '/JJyyIstHfkT7t/bW+WXgg' 6-max Seat #5 is the button
Seat 1: wsP46AGpqDjHZQmlRHKa9g ($25 in chips) 
Seat 2: obJgSnVgWWWaAUtVILo77Q ($8.85 in chips) 
Seat 3: DR0nVIhVP77oEBlO9J8vlg ($30.80 in chips) 
Seat 4: JFIAqU8lCZ0vWwEl4bdGsg ($35.75 in chips) 
Seat 5: +ZlnqPoP3Hg4BIUxDfKd/A ($48.50 in chips) 
Seat 6: d338A2rm6NtA1ECEZi4d2g ($15.70 in chips) 
d338A2rm6NtA1ECEZi4d2g: posts small blind $0.10
wsP46AGpqDjHZQmlRHKa9g: posts big blind $0.25
*** HOLE CARDS ***
obJgSnVgWWWaAUtVILo77Q: calls $0.25
DR0nVIhVP77oEBlO9J8vlg: calls $0.25
JFIAqU8lCZ0vWwEl4bdGsg: folds 
+ZlnqPoP3Hg4BIUxDfKd/A: folds 
d338A2rm6NtA1ECEZi4d2g: raises $0.75 to $1
wsP46AGpqDjHZQmlRHKa9g: folds 
obJgSnVgWWWaAUtVILo77Q: calls $0.75
DR0nVIhVP77oEBlO9J8vlg: calls $0.75
*** FLOP *** [Jd 8d Ah]
d338A2rm6NtA1ECEZi4d2g: bets $2.50
obJgSnVgWWWaAUtVILo77Q: folds 
DR0nVIhVP77oEBlO9J8vlg: calls $2.50
*** TURN *** [Jd 8d Ah] [7s]
d338A2rm6NtA1ECEZi4d2g: bets $5
DR0nVIhVP77oEBlO9J8vlg: raises $5 to $10
d338A2rm6NtA1ECEZi4d2g: raises $2.20 to $12.20 and is all-in
DR0nVIhVP77oEBlO9J8vlg: calls $2.20
*** RIVER *** [Jd 8d Ah 7s] [2s]
*** SHOW DOWN ***
d338A2rm6NtA1ECEZi4d2g: shows [Ac 8s] (two pair, Aces and Eights)
DR0nVIhVP77oEBlO9J8vlg: shows [Td 9h] (a straight, Seven to Jack)
DR0nVIhVP77oEBlO9J8vlg collected $31.05 from pot
*** SUMMARY ***
Total pot $32.65 | Rake $1.60 
Board [Jd 8d Ah 7s 2s]
Seat 1: wsP46AGpqDjHZQmlRHKa9g (big blind) folded before Flop
Seat 2: obJgSnVgWWWaAUtVILo77Q folded on the Flop
Seat 3: DR0nVIhVP77oEBlO9J8vlg showed [Td 9h] and won ($31.05) with a straight, Seven to Jack
Seat 4: JFIAqU8lCZ0vWwEl4bdGsg folded before Flop (didn't bet)
Seat 5: +ZlnqPoP3Hg4BIUxDfKd/A (button) folded before Flop (didn't bet)
Seat 6: d338A2rm6NtA1ECEZi4d2g (small blind) showed [Ac 8s] and lost with two pair, Aces and Eights




PokerStars Game #59941554048:  Hold'em No Limit ($0.10/$0.25) - 2009/07/01 1:38:58 ET
Table 'g+mPuNJBCHKE9ents7ZGtg' 6-max Seat #4 is the button
Seat 1: cezpHJ8FB07dj0xG+LhOvw ($59.80 in chips) 
Seat 2: fZQg9veL7Dd/Z04ZTjC+wQ ($66.05 in chips) 
Seat 3: FYepjhAvF8ZdVCmqHIy+eQ ($25.60 in chips) 
Seat 4: yVrjRIW0SMxgpvqSIPSe/w ($13.35 in chips) 
Seat 5: D3ikCR8c/o9jB5irZ3uGlw ($14.25 in chips) 
Seat 6: Mn2V28t5aGq2d09z+/o6Fw ($6.45 in chips) 
D3ikCR8c/o9jB5irZ3uGlw: posts small blind $0.10
Mn2V28t5aGq2d09z+/o6Fw: posts big blind $0.25
*** HOLE CARDS ***
cezpHJ8FB07dj0xG+LhOvw: folds 
fZQg9veL7Dd/Z04ZTjC+wQ: folds 
FYepjhAvF8ZdVCmqHIy+eQ: folds 
yVrjRIW0SMxgpvqSIPSe/w: raises $1 to $1.25
D3ikCR8c/o9jB5irZ3uGlw: folds 
Mn2V28t5aGq2d09z+/o6Fw: calls $1
*** FLOP *** [2d 9c Js]
Mn2V28t5aGq2d09z+/o6Fw: bets $1.50
yVrjRIW0SMxgpvqSIPSe/w: folds 
Uncalled bet ($1.50) returned to Mn2V28t5aGq2d09z+/o6Fw
Mn2V28t5aGq2d09z+/o6Fw collected $2.50 from pot
Mn2V28t5aGq2d09z+/o6Fw: doesn't show hand 
*** SUMMARY ***
Total pot $2.60 | Rake $0.10 
Board [2d 9c Js]
Seat 1: cezpHJ8FB07dj0xG+LhOvw folded before Flop (didn't bet)
Seat 2: fZQg9veL7Dd/Z04ZTjC+wQ folded before Flop (didn't bet)
Seat 3: FYepjhAvF8ZdVCmqHIy+eQ folded before Flop (didn't bet)
Seat 4: yVrjRIW0SMxgpvqSIPSe/w (button) folded on the Flop
Seat 5: D3ikCR8c/o9jB5irZ3uGlw (small blind) folded before Flop
Seat 6: Mn2V28t5aGq2d09z+/o6Fw (big blind) collected ($2.50)




PokerStars Game #59941553620:  Hold'em No Limit ($0.10/$0.25) - 2009/07/01 1:38:58 ET
Table '3Ns9nuTkynfwbBfBXzg6ww' 6-max Seat #1 is the button
Seat 1: KDYsHh8K2SUXXDvLsAhbJQ ($6.95 in chips) 
Seat 2: zxeVQGaMKDsDzmSY+AInjA ($33.60 in chips) 
Seat 3: eL3+wCBjFGfQ5FMdIZihwA ($25 in chips) 
Seat 4: qGHGf/553gQnDoklMRe3tg ($23.85 in chips) 
Seat 5: wqphQtauX5Qn7WRJZS1flA ($24.65 in chips) 
Seat 6: DE9hRlt14g+JdsRQ4wT7hg ($37.05 in chips) 
zxeVQGaMKDsDzmSY+AInjA: posts small blind $0.10
eL3+wCBjFGfQ5FMdIZihwA: posts big blind $0.25
*** HOLE CARDS ***
qGHGf/553gQnDoklMRe3tg: raises $0.75 to $1
wqphQtauX5Qn7WRJZS1flA: folds 
DE9hRlt14g+JdsRQ4wT7hg: calls $1
KDYsHh8K2SUXXDvLsAhbJQ: calls $1
zxeVQGaMKDsDzmSY+AInjA: folds 
eL3+wCBjFGfQ5FMdIZihwA: folds 
*** FLOP *** [9c 2h 5d]
qGHGf/553gQnDoklMRe3tg: bets $2
DE9hRlt14g+JdsRQ4wT7hg: folds 
KDYsHh8K2SUXXDvLsAhbJQ: calls $2
*** TURN *** [9c 2h 5d] [9d]
qGHGf/553gQnDoklMRe3tg: checks 
KDYsHh8K2SUXXDvLsAhbJQ: checks 
*** RIVER *** [9c 2h 5d 9d] [3h]
qGHGf/553gQnDoklMRe3tg: bets $4
KDYsHh8K2SUXXDvLsAhbJQ: calls $3.95 and is all-in
Uncalled bet ($0.05) returned to qGHGf/553gQnDoklMRe3tg
*** SHOW DOWN ***
qGHGf/553gQnDoklMRe3tg: shows [As Ah] (two pair, Aces and Nines)
KDYsHh8K2SUXXDvLsAhbJQ: mucks hand 
qGHGf/553gQnDoklMRe3tg collected $14.55 from pot
*** SUMMARY ***
Total pot $15.25 | Rake $0.70 
Board [9c 2h 5d 9d 3h]
Seat 1: KDYsHh8K2SUXXDvLsAhbJQ (button) mucked
Seat 2: zxeVQGaMKDsDzmSY+AInjA (small blind) folded before Flop
Seat 3: eL3+wCBjFGfQ5FMdIZihwA (big blind) folded before Flop
Seat 4: qGHGf/553gQnDoklMRe3tg showed [As Ah] and won ($14.55) with two pair, Aces and Nines
Seat 5: wqphQtauX5Qn7WRJZS1flA folded before Flop (didn't bet)
Seat 6: DE9hRlt14g+JdsRQ4wT7hg folded on the Flop




PokerStars Game #59941554656:  Hold'em No Limit ($0.10/$0.25) - 2009/07/01 1:38:59 ET
Table 'NgexmgEDEzICBeSO7YCrKQ' 6-max Seat #6 is the button
Seat 1: cezpHJ8FB07dj0xG+LhOvw ($29.30 in chips) 
Seat 2: 32YL2ZEp8NT4JB2RVM9euQ ($21.10 in chips) 
Seat 3: JFIAqU8lCZ0vWwEl4bdGsg ($27.20 in chips) 
Seat 4: xx+iYCDJhHJmNzrfeloyEg ($26.20 in chips) 
Seat 5: /MXkdT8TTs8Qp2LVTQNw6w ($38.55 in chips) 
Seat 6: k9nHZTHt8hYhYRcW8NTb4g ($12.70 in chips) 
cezpHJ8FB07dj0xG+LhOvw: posts small blind $0.10
32YL2ZEp8NT4JB2RVM9euQ: posts big blind $0.25
*** HOLE CARDS ***
JFIAqU8lCZ0vWwEl4bdGsg: folds 
xx+iYCDJhHJmNzrfeloyEg: folds 
/MXkdT8TTs8Qp2LVTQNw6w: calls $0.25
k9nHZTHt8hYhYRcW8NTb4g: folds 
cezpHJ8FB07dj0xG+LhOvw: calls $0.15
32YL2ZEp8NT4JB2RVM9euQ: checks 
*** FLOP *** [Jh 3c Ah]
cezpHJ8FB07dj0xG+LhOvw: checks 
32YL2ZEp8NT4JB2RVM9euQ: checks 
/MXkdT8TTs8Qp2LVTQNw6w: checks 
*** TURN *** [Jh 3c Ah] [Ts]
cezpHJ8FB07dj0xG+LhOvw: checks 
32YL2ZEp8NT4JB2RVM9euQ: checks 
/MXkdT8TTs8Qp2LVTQNw6w: checks 
*** RIVER *** [Jh 3c Ah Ts] [Jd]
cezpHJ8FB07dj0xG+LhOvw: bets $0.60
32YL2ZEp8NT4JB2RVM9euQ: folds 
/MXkdT8TTs8Qp2LVTQNw6w: folds 
Uncalled bet ($0.60) returned to cezpHJ8FB07dj0xG+LhOvw
cezpHJ8FB07dj0xG+LhOvw collected $0.75 from pot
*** SUMMARY ***
Total pot $0.75 | Rake $0 
Board [Jh 3c Ah Ts Jd]
Seat 1: cezpHJ8FB07dj0xG+LhOvw (small blind) collected ($0.75)
Seat 2: 32YL2ZEp8NT4JB2RVM9euQ (big blind) folded on the River
Seat 3: JFIAqU8lCZ0vWwEl4bdGsg folded before Flop (didn't bet)
Seat 4: xx+iYCDJhHJmNzrfeloyEg folded before Flop (didn't bet)
Seat 5: /MXkdT8TTs8Qp2LVTQNw6w folded on the River
Seat 6: k9nHZTHt8hYhYRcW8NTb4g (button) folded before Flop (didn't bet)




PokerStars Game #59941554592:  Hold'em No Limit ($0.10/$0.25) - 2009/07/01 1:38:59 ET
Table 'ER5H84HUgJx7HyDLnELLeA' 6-max Seat #1 is the button
Seat 1: LJI7A1YgDM7hgh7o56+ReQ ($25.65 in chips) 
Seat 2: buyjetgNT1McXtdaP4zynA ($20.35 in chips) 
Seat 3: memV5jkoAdGrnRy3Q9PM7w ($20.80 in chips) 
Seat 4: vqWjZmdQu/Hxw96/IJTWdQ ($25 in chips) 
Seat 5: mfrkWA3PTeYPkbO6hi98Aw ($24.65 in chips) 
Seat 6: 3zD3qLXT1bEffAoWGnc7wg ($51.65 in chips) 
buyjetgNT1McXtdaP4zynA: posts small blind $0.10
memV5jkoAdGrnRy3Q9PM7w: posts big blind $0.25
*** HOLE CARDS ***
vqWjZmdQu/Hxw96/IJTWdQ: folds 
mfrkWA3PTeYPkbO6hi98Aw: raises $0.75 to $1
3zD3qLXT1bEffAoWGnc7wg: calls $1
LJI7A1YgDM7hgh7o56+ReQ: folds 
buyjetgNT1McXtdaP4zynA: folds 
memV5jkoAdGrnRy3Q9PM7w: folds 
*** FLOP *** [5h 9d 7c]
mfrkWA3PTeYPkbO6hi98Aw: bets $1.75
3zD3qLXT1bEffAoWGnc7wg: folds 
Uncalled bet ($1.75) returned to mfrkWA3PTeYPkbO6hi98Aw
mfrkWA3PTeYPkbO6hi98Aw collected $2.25 from pot
mfrkWA3PTeYPkbO6hi98Aw: doesn't show hand 
*** SUMMARY ***
Total pot $2.35 | Rake $0.10 
Board [5h 9d 7c]
Seat 1: LJI7A1YgDM7hgh7o56+ReQ (button) folded before Flop (didn't bet)
Seat 2: buyjetgNT1McXtdaP4zynA (small blind) folded before Flop
Seat 3: memV5jkoAdGrnRy3Q9PM7w (big blind) folded before Flop
Seat 4: vqWjZmdQu/Hxw96/IJTWdQ folded before Flop (didn't bet)
Seat 5: mfrkWA3PTeYPkbO6hi98Aw collected ($2.25)
Seat 6: 3zD3qLXT1bEffAoWGnc7wg folded on the Flop




PokerStars Game #59941554390:  Hold'em No Limit ($0.10/$0.25) - 2009/07/01 1:38:59 ET
Table 'MiquQrQZJJq9ZtgRIp9HFQ' 6-max Seat #3 is the button
Seat 1: c3J/KYZ4cNsUEuz8v57I5A ($26.25 in chips) 
Seat 2: XaIzillDPjW0HcNtCRrgsQ ($19.20 in chips) 
Seat 3: Hsvkc0/G2VV78oVmWYXecw ($5 in chips) 
Seat 4: wAKC8C/zN0c8V5v13dm9mA ($43.90 in chips) 
Seat 5: iyZxqznXjv3vtvOJymkoLQ ($25.20 in chips) 
Seat 6: GbCVUNssQ7mqsPWr7J4d3w ($4.30 in chips) 
wAKC8C/zN0c8V5v13dm9mA: posts small blind $0.10
iyZxqznXjv3vtvOJymkoLQ: posts big blind $0.25
*** HOLE CARDS ***
GbCVUNssQ7mqsPWr7J4d3w: folds 
c3J/KYZ4cNsUEuz8v57I5A: folds 
XaIzillDPjW0HcNtCRrgsQ: raises $0.75 to $1
Hsvkc0/G2VV78oVmWYXecw: folds 
wAKC8C/zN0c8V5v13dm9mA: calls $0.90
iyZxqznXjv3vtvOJymkoLQ: raises $2.25 to $3.25
XaIzillDPjW0HcNtCRrgsQ: calls $2.25
wAKC8C/zN0c8V5v13dm9mA: calls $2.25
*** FLOP *** [Jd 3d Ah]
wAKC8C/zN0c8V5v13dm9mA: checks 
iyZxqznXjv3vtvOJymkoLQ: checks 
XaIzillDPjW0HcNtCRrgsQ: bets $2.75
wAKC8C/zN0c8V5v13dm9mA: calls $2.75
iyZxqznXjv3vtvOJymkoLQ: folds 
*** TURN *** [Jd 3d Ah] [8s]
wAKC8C/zN0c8V5v13dm9mA: checks 
XaIzillDPjW0HcNtCRrgsQ: checks 
*** RIVER *** [Jd 3d Ah 8s] [6s]
wAKC8C/zN0c8V5v13dm9mA: bets $7
XaIzillDPjW0HcNtCRrgsQ: calls $7
*** SHOW DOWN ***
wAKC8C/zN0c8V5v13dm9mA: shows [Jh Ac] (two pair, Aces and Jacks)
XaIzillDPjW0HcNtCRrgsQ: mucks hand 
wAKC8C/zN0c8V5v13dm9mA collected $27.85 from pot
*** SUMMARY ***
Total pot $29.25 | Rake $1.40 
Board [Jd 3d Ah 8s 6s]
Seat 1: c3J/KYZ4cNsUEuz8v57I5A folded before Flop (didn't bet)
Seat 2: XaIzillDPjW0HcNtCRrgsQ mucked
Seat 3: Hsvkc0/G2VV78oVmWYXecw (button) folded before Flop (didn't bet)
Seat 4: wAKC8C/zN0c8V5v13dm9mA (small blind) showed [Jh Ac] and won ($27.85) with two pair, Aces and Jacks
Seat 5: iyZxqznXjv3vtvOJymkoLQ (big blind) folded on the Flop
Seat 6: GbCVUNssQ7mqsPWr7J4d3w folded before Flop (didn't bet)




PokerStars Game #59941554272:  Hold'em No Limit ($0.10/$0.25) - 2009/07/01 1:38:59 ET
Table 'pAhiNHs/spaABQia+7gWNQ' 9-max Seat #6 is the button
Seat 1: ipgcO7Pa6LC8XWpVttZfnA ($5 in chips) 
Seat 2: dfNim92Z6XK1/h5SFW5vDg ($25 in chips) 
Seat 3: xEQxarad8/T4jJdpZy5LGw ($34.90 in chips) 
Seat 5: OlPJsgR4xypSg/w1z7Gyvw ($33.15 in chips) 
Seat 6: oLa/tXLfSLLB28mcLGrxcg ($24.25 in chips) 
Seat 7: +WTkVY3GeLxqGQBbMZQiWQ ($5.80 in chips) 
Seat 9: zgi+EUykT/pZQpoUG6+oEg ($5 in chips) 
+WTkVY3GeLxqGQBbMZQiWQ: posts small blind $0.10
PdIasPkzm2sqZnN41ZRXOg: is sitting out 
PdIasPkzm2sqZnN41ZRXOg leaves the table
zgi+EUykT/pZQpoUG6+oEg: posts big blind $0.25
Dr.Hibbert55: sits out 
*** HOLE CARDS ***
ipgcO7Pa6LC8XWpVttZfnA: folds 
dfNim92Z6XK1/h5SFW5vDg: folds 
xEQxarad8/T4jJdpZy5LGw: calls $0.25
OlPJsgR4xypSg/w1z7Gyvw: folds 
oLa/tXLfSLLB28mcLGrxcg: folds 
+WTkVY3GeLxqGQBbMZQiWQ: calls $0.15
zgi+EUykT/pZQpoUG6+oEg: checks 
*** FLOP *** [5s 2d 7c]
+WTkVY3GeLxqGQBbMZQiWQ: checks 
zgi+EUykT/pZQpoUG6+oEg: checks 
xEQxarad8/T4jJdpZy5LGw: bets $0.50
+WTkVY3GeLxqGQBbMZQiWQ: folds 
zgi+EUykT/pZQpoUG6+oEg: folds 
Uncalled bet ($0.50) returned to xEQxarad8/T4jJdpZy5LGw
xEQxarad8/T4jJdpZy5LGw collected $0.75 from pot
*** SUMMARY ***
Total pot $0.75 | Rake $0 
Board [5s 2d 7c]
Seat 1: ipgcO7Pa6LC8XWpVttZfnA folded before Flop (didn't bet)
Seat 2: dfNim92Z6XK1/h5SFW5vDg folded before Flop (didn't bet)
Seat 3: xEQxarad8/T4jJdpZy5LGw collected ($0.75)
Seat 5: OlPJsgR4xypSg/w1z7Gyvw folded before Flop (didn't bet)
Seat 6: oLa/tXLfSLLB28mcLGrxcg (button) folded before Flop (didn't bet)
Seat 7: +WTkVY3GeLxqGQBbMZQiWQ (small blind) folded on the Flop
Seat 9: zgi+EUykT/pZQpoUG6+oEg (big blind) folded on the Flop




PokerStars Game #59941554434:  Hold'em No Limit ($0.10/$0.25) - 2009/07/01 1:38:59 ET
Table 'i93c3z9RLowvuJTKA2F4Jg' 6-max Seat #5 is the button
Seat 1: tbSZq5LHglyHk61mH9eDBw ($35 in chips) 
Seat 2: TSmua8tGK3sTbwi0ynrW9Q ($30.30 in chips) 
Seat 3: v8m8XHovI5tqEA9mvplDSw ($31.65 in chips) 
Seat 4: o86X2Q5GEDU3uP9oj1iFZA ($23.30 in chips) 
Seat 5: lYjWCpfCxX2kgcHY3v4Yow ($35.65 in chips) 
FpN4KbLjlyRRKiVaQcoLqA will be allowed to play after the button
tbSZq5LHglyHk61mH9eDBw: posts small blind $0.10
TSmua8tGK3sTbwi0ynrW9Q: posts big blind $0.25
*** HOLE CARDS ***
v8m8XHovI5tqEA9mvplDSw: folds 
o86X2Q5GEDU3uP9oj1iFZA: folds 
lYjWCpfCxX2kgcHY3v4Yow: raises $0.60 to $0.85
tbSZq5LHglyHk61mH9eDBw: folds 
TSmua8tGK3sTbwi0ynrW9Q: folds 
Uncalled bet ($0.60) returned to lYjWCpfCxX2kgcHY3v4Yow
lYjWCpfCxX2kgcHY3v4Yow collected $0.60 from pot
lYjWCpfCxX2kgcHY3v4Yow: doesn't show hand 
*** SUMMARY ***
Total pot $0.60 | Rake $0 
Seat 1: tbSZq5LHglyHk61mH9eDBw (small blind) folded before Flop
Seat 2: TSmua8tGK3sTbwi0ynrW9Q (big blind) folded before Flop
Seat 3: v8m8XHovI5tqEA9mvplDSw folded before Flop (didn't bet)
Seat 4: o86X2Q5GEDU3uP9oj1iFZA folded before Flop (didn't bet)
Seat 5: lYjWCpfCxX2kgcHY3v4Yow (button) collected ($0.60)




PokerStars Game #59941554488:  Hold'em No Limit ($0.10/$0.25) - 2009/07/01 1:38:59 ET
Table 'zW+7jPbOLCvlPu+dUGY5WQ' 6-max Seat #2 is the button
Seat 1: eL3+wCBjFGfQ5FMdIZihwA ($25 in chips) 
Seat 2: cEMJmfAUQZmMChZe6aacKw ($8 in chips) 
Seat 3: 2G0C7dp4wlPpE21FHjjElQ ($32.95 in chips) 
Seat 4: i48129QFpEQQ+UN4aNtmww ($10.85 in chips) 
Seat 6: qGHGf/553gQnDoklMRe3tg ($27.05 in chips) 
2G0C7dp4wlPpE21FHjjElQ: posts small blind $0.10
i48129QFpEQQ+UN4aNtmww: posts big blind $0.25
5nwDw10uIM0XEyLhla0oGA: sits out 
*** HOLE CARDS ***
qGHGf/553gQnDoklMRe3tg: folds 
eL3+wCBjFGfQ5FMdIZihwA: folds 
cEMJmfAUQZmMChZe6aacKw: folds 
2G0C7dp4wlPpE21FHjjElQ: folds 
Uncalled bet ($0.15) returned to i48129QFpEQQ+UN4aNtmww
i48129QFpEQQ+UN4aNtmww collected $0.20 from pot
*** SUMMARY ***
Total pot $0.20 | Rake $0 
Seat 1: eL3+wCBjFGfQ5FMdIZihwA folded before Flop (didn't bet)
Seat 2: cEMJmfAUQZmMChZe6aacKw (button) folded before Flop (didn't bet)
Seat 3: 2G0C7dp4wlPpE21FHjjElQ (small blind) folded before Flop
Seat 4: i48129QFpEQQ+UN4aNtmww (big blind) collected ($0.20)
Seat 6: qGHGf/553gQnDoklMRe3tg folded before Flop (didn't bet)




PokerStars Game #59941554394:  Hold'em No Limit ($0.10/$0.25) - 2009/07/01 1:38:59 ET
Table 'I0ZcuiUTeLuGYv26Nah7YA' 9-max Seat #4 is the button
Seat 2: ljemhp25Zg+nlA9DLCIiUw ($34.40 in chips) 
Seat 4: Ot/HS/XJmW5Fd3PR/vuSiA ($14.50 in chips) 
Seat 5: y7tkvDmwKjURBkr73SZPXw ($6.55 in chips) 
Seat 8: ShCS62CJp4MKfKLKvGKQbA ($7.75 in chips) 
Seat 9: 6RiVTYll/5D8zICp0MRpKw ($43.30 in chips) 
y7tkvDmwKjURBkr73SZPXw: posts small blind $0.10
PdIasPkzm2sqZnN41ZRXOg: is sitting out 
ShCS62CJp4MKfKLKvGKQbA: posts big blind $0.25
*** HOLE CARDS ***
6RiVTYll/5D8zICp0MRpKw: folds 
6RiVTYll/5D8zICp0MRpKw leaves the table
ljemhp25Zg+nlA9DLCIiUw: folds 
Ot/HS/XJmW5Fd3PR/vuSiA: folds 
Ot/HS/XJmW5Fd3PR/vuSiA leaves the table
PdIasPkzm2sqZnN41ZRXOg leaves the table
y7tkvDmwKjURBkr73SZPXw: folds 
Uncalled bet ($0.15) returned to ShCS62CJp4MKfKLKvGKQbA
ShCS62CJp4MKfKLKvGKQbA collected $0.20 from pot
*** SUMMARY ***
Total pot $0.20 | Rake $0 
Seat 2: ljemhp25Zg+nlA9DLCIiUw folded before Flop (didn't bet)
Seat 4: Ot/HS/XJmW5Fd3PR/vuSiA (button) folded before Flop (didn't bet)
Seat 5: y7tkvDmwKjURBkr73SZPXw (small blind) folded before Flop
Seat 8: ShCS62CJp4MKfKLKvGKQbA (big blind) collected ($0.20)
Seat 9: 6RiVTYll/5D8zICp0MRpKw folded before Flop (didn't bet)




PokerStars Game #59941555030:  Hold'em No Limit ($0.10/$0.25) - 2009/07/01 1:39:00 ET
Table 'AJGgX1ZYM8d68SWMvaLttg' 6-max Seat #6 is the button
Seat 2: zHHLkD2sRljslKKeQv/ZQw ($28.05 in chips) 
Seat 3: 8ClCHtFXGNplITm+63KB+Q ($38.05 in chips) 
Seat 4: Lz/GjRDgmgepqTR7qmS86w ($23 in chips) 
Seat 5: Hsvkc0/G2VV78oVmWYXecw ($6.05 in chips) 
Seat 6: UA5OsKS3VPaxa7uC8La/kA ($65.50 in chips) 
zHHLkD2sRljslKKeQv/ZQw: posts small blind $0.10
8ClCHtFXGNplITm+63KB+Q: posts big blind $0.25
*** HOLE CARDS ***
Lz/GjRDgmgepqTR7qmS86w: calls $0.25
Hsvkc0/G2VV78oVmWYXecw: raises $0.50 to $0.75
UA5OsKS3VPaxa7uC8La/kA: calls $0.75
zHHLkD2sRljslKKeQv/ZQw: calls $0.65
8ClCHtFXGNplITm+63KB+Q: folds 
Lz/GjRDgmgepqTR7qmS86w: calls $0.50
*** FLOP *** [Qd 2h 6s]
zHHLkD2sRljslKKeQv/ZQw: checks 
Lz/GjRDgmgepqTR7qmS86w: checks 
Hsvkc0/G2VV78oVmWYXecw: checks 
UA5OsKS3VPaxa7uC8La/kA: checks 
*** TURN *** [Qd 2h 6s] [6d]
zHHLkD2sRljslKKeQv/ZQw: bets $0.75
Lz/GjRDgmgepqTR7qmS86w: calls $0.75
Hsvkc0/G2VV78oVmWYXecw: folds 
UA5OsKS3VPaxa7uC8La/kA: folds 
*** RIVER *** [Qd 2h 6s 6d] [4c]
zHHLkD2sRljslKKeQv/ZQw: checks 
Lz/GjRDgmgepqTR7qmS86w: bets $4
zHHLkD2sRljslKKeQv/ZQw: folds 
Uncalled bet ($4) returned to Lz/GjRDgmgepqTR7qmS86w
Lz/GjRDgmgepqTR7qmS86w collected $4.55 from pot
Lz/GjRDgmgepqTR7qmS86w: doesn't show hand 
*** SUMMARY ***
Total pot $4.75 | Rake $0.20 
Board [Qd 2h 6s 6d 4c]
Seat 2: zHHLkD2sRljslKKeQv/ZQw (small blind) folded on the River
Seat 3: 8ClCHtFXGNplITm+63KB+Q (big blind) folded before Flop
Seat 4: Lz/GjRDgmgepqTR7qmS86w collected ($4.55)
Seat 5: Hsvkc0/G2VV78oVmWYXecw folded on the Turn
Seat 6: UA5OsKS3VPaxa7uC8La/kA (button) folded on the Turn




PokerStars Game #59941554792:  Hold'em No Limit ($0.10/$0.25) - 2009/07/01 1:39:00 ET
Table 'wRXcD9iXgBbdvKhWmfnBnw' 6-max Seat #3 is the button
Seat 1: 8tR2s7yV/Fr0ePp1w5XnJw ($12.95 in chips) 
Seat 2: vUr8qM1UsCElsCI9B/McdQ ($27.90 in chips) 
Seat 3: l4ToKwb3EVcEuva7hPqMCQ ($3.85 in chips) 
Seat 5: EE16Ua5b1HSsYej5zeXOlA ($46.85 in chips) 
Seat 6: JFIAqU8lCZ0vWwEl4bdGsg ($25.60 in chips) 
7NY6Es0O5qlPDxirJ9iU4g will be allowed to play after the button
EE16Ua5b1HSsYej5zeXOlA: posts small blind $0.10
JFIAqU8lCZ0vWwEl4bdGsg: posts big blind $0.25
*** HOLE CARDS ***
8tR2s7yV/Fr0ePp1w5XnJw: raises $0.25 to $0.50
vUr8qM1UsCElsCI9B/McdQ: calls $0.50
l4ToKwb3EVcEuva7hPqMCQ: folds 
EE16Ua5b1HSsYej5zeXOlA: folds 
JFIAqU8lCZ0vWwEl4bdGsg: calls $0.25
*** FLOP *** [Ts 4h Ac]
JFIAqU8lCZ0vWwEl4bdGsg: checks 
8tR2s7yV/Fr0ePp1w5XnJw: checks 
vUr8qM1UsCElsCI9B/McdQ: bets $1
JFIAqU8lCZ0vWwEl4bdGsg: folds 
8tR2s7yV/Fr0ePp1w5XnJw: folds 
Uncalled bet ($1) returned to vUr8qM1UsCElsCI9B/McdQ
vUr8qM1UsCElsCI9B/McdQ collected $1.55 from pot
vUr8qM1UsCElsCI9B/McdQ: doesn't show hand 
*** SUMMARY ***
Total pot $1.60 | Rake $0.05 
Board [Ts 4h Ac]
Seat 1: 8tR2s7yV/Fr0ePp1w5XnJw folded on the Flop
Seat 2: vUr8qM1UsCElsCI9B/McdQ collected ($1.55)
Seat 3: l4ToKwb3EVcEuva7hPqMCQ (button) folded before Flop (didn't bet)
Seat 5: EE16Ua5b1HSsYej5zeXOlA (small blind) folded before Flop
Seat 6: JFIAqU8lCZ0vWwEl4bdGsg (big blind) folded on the Flop




PokerStars Game #59941555118:  Hold'em No Limit ($0.10/$0.25) - 2009/07/01 1:39:00 ET
Table 'bIGKmJgZehWJ+FAo8b85iw' 9-max Seat #5 is the button
Seat 1: yyG4svzOpC1A+sUP/scg6w ($14.70 in chips) 
Seat 2: cCjRCvseA9rZn7Xr+GCCHg ($21.70 in chips) 
Seat 3: /FyMUX+W/tpNFcRWbUTJxQ ($9.30 in chips) 
Seat 4: LGxBRjCRn6KlQ/6B4eoXbA ($11.95 in chips) 
Seat 5: uLP/lYn7oKq9xCChBXsXxw ($25.25 in chips) 
Seat 6: PFNLAvMkr8qKc7xCiH0wTA ($18.95 in chips) 
Seat 7: HDDm1BkZtdsRyw2DJdqq6A ($4.20 in chips) 
Seat 8: +2kMBNpY4nF1qNCRd8SJLA ($56.55 in chips) 
Seat 9: aNpwfA31EREwO+ar4XzBCw ($32.10 in chips) 
PFNLAvMkr8qKc7xCiH0wTA: posts small blind $0.10
HDDm1BkZtdsRyw2DJdqq6A: posts big blind $0.25
*** HOLE CARDS ***
LGxBRjCRn6KlQ/6B4eoXbA said, "22"
+2kMBNpY4nF1qNCRd8SJLA: calls $0.25
aNpwfA31EREwO+ar4XzBCw: folds 
yyG4svzOpC1A+sUP/scg6w: folds 
cCjRCvseA9rZn7Xr+GCCHg: folds 
uLP/lYn7oKq9xCChBXsXxw said, "as well as AA?"
/FyMUX+W/tpNFcRWbUTJxQ: raises $1 to $1.25
uLP/lYn7oKq9xCChBXsXxw said, "very clever"
LGxBRjCRn6KlQ/6B4eoXbA: folds 
uLP/lYn7oKq9xCChBXsXxw: folds 
PFNLAvMkr8qKc7xCiH0wTA: folds 
HDDm1BkZtdsRyw2DJdqq6A: folds 
+2kMBNpY4nF1qNCRd8SJLA: calls $1
*** FLOP *** [5c 3c Jh]
+2kMBNpY4nF1qNCRd8SJLA: checks 
/FyMUX+W/tpNFcRWbUTJxQ: checks 
*** TURN *** [5c 3c Jh] [Th]
+2kMBNpY4nF1qNCRd8SJLA: checks 
/FyMUX+W/tpNFcRWbUTJxQ: checks 
*** RIVER *** [5c 3c Jh Th] [4h]
+2kMBNpY4nF1qNCRd8SJLA: checks 
/FyMUX+W/tpNFcRWbUTJxQ: bets $0.75
+2kMBNpY4nF1qNCRd8SJLA: folds 
Uncalled bet ($0.75) returned to /FyMUX+W/tpNFcRWbUTJxQ
/FyMUX+W/tpNFcRWbUTJxQ collected $2.75 from pot
/FyMUX+W/tpNFcRWbUTJxQ: doesn't show hand 
*** SUMMARY ***
Total pot $2.85 | Rake $0.10 
Board [5c 3c Jh Th 4h]
Seat 1: yyG4svzOpC1A+sUP/scg6w folded before Flop (didn't bet)
Seat 2: cCjRCvseA9rZn7Xr+GCCHg folded before Flop (didn't bet)
Seat 3: /FyMUX+W/tpNFcRWbUTJxQ collected ($2.75)
Seat 4: LGxBRjCRn6KlQ/6B4eoXbA folded before Flop (didn't bet)
Seat 5: uLP/lYn7oKq9xCChBXsXxw (button) folded before Flop (didn't bet)
Seat 6: PFNLAvMkr8qKc7xCiH0wTA (small blind) folded before Flop
Seat 7: HDDm1BkZtdsRyw2DJdqq6A (big blind) folded before Flop
Seat 8: +2kMBNpY4nF1qNCRd8SJLA folded on the River
Seat 9: aNpwfA31EREwO+ar4XzBCw folded before Flop (didn't bet)




PokerStars Game #59941554920:  Hold'em No Limit ($0.10/$0.25) - 2009/07/01 1:39:00 ET
Table 'T/iCKJXGphRN3xcdwfE/JQ' 6-max Seat #4 is the button
Seat 1: wAKC8C/zN0c8V5v13dm9mA ($25 in chips) 
Seat 2: EeUZtMU058v2ObUACOF4Og ($34.10 in chips) 
Seat 3: IWAjoCPXtc1XUaZdp+pCpA ($22.35 in chips) 
Seat 4: tSR4329m40dZsN7YOpI9Kw ($54.25 in chips) 
Seat 5: gaPMxLGp9SOj4Lq6t+/0Ig ($3.20 in chips) 
Seat 6: Ey4Kn6PlnYb2srYYBJHvzg ($15.85 in chips) 
gaPMxLGp9SOj4Lq6t+/0Ig: posts small blind $0.10
Ey4Kn6PlnYb2srYYBJHvzg: posts big blind $0.25
*** HOLE CARDS ***
wAKC8C/zN0c8V5v13dm9mA: folds 
EeUZtMU058v2ObUACOF4Og: folds 
IWAjoCPXtc1XUaZdp+pCpA: folds 
tSR4329m40dZsN7YOpI9Kw: raises $0.50 to $0.75
gaPMxLGp9SOj4Lq6t+/0Ig: raises $2.45 to $3.20 and is all-in
Ey4Kn6PlnYb2srYYBJHvzg: folds 
tSR4329m40dZsN7YOpI9Kw: folds 
Uncalled bet ($2.45) returned to gaPMxLGp9SOj4Lq6t+/0Ig
gaPMxLGp9SOj4Lq6t+/0Ig collected $1.75 from pot
gaPMxLGp9SOj4Lq6t+/0Ig: doesn't show hand 
*** SUMMARY ***
Total pot $1.75 | Rake $0 
Seat 1: wAKC8C/zN0c8V5v13dm9mA folded before Flop (didn't bet)
Seat 2: EeUZtMU058v2ObUACOF4Og folded before Flop (didn't bet)
Seat 3: IWAjoCPXtc1XUaZdp+pCpA folded before Flop (didn't bet)
Seat 4: tSR4329m40dZsN7YOpI9Kw (button) folded before Flop
Seat 5: gaPMxLGp9SOj4Lq6t+/0Ig (small blind) collected ($1.75)
Seat 6: Ey4Kn6PlnYb2srYYBJHvzg (big blind) folded before Flop




PokerStars Game #59941555024:  Hold'em No Limit ($0.10/$0.25) - 2009/07/01 1:39:00 ET
Table '4UJB/UOZ5aepyF2v+hIoUg' 6-max Seat #2 is the button
Seat 1: 08V++DOqzaNrRNsHIwi25w ($27.10 in chips) 
Seat 2: mFv3iBCtrw9XfCDRB0d46Q ($3.60 in chips) 
Seat 3: zlYHXTtJ5tcx9kwK2h5n9A ($38.40 in chips) 
Seat 4: R6AGToFJQOYVZAjC2jXEKw ($22.95 in chips) 
Seat 5: 3zD3qLXT1bEffAoWGnc7wg ($26.25 in chips) 
Seat 6: 2aphcinkTZT0B0Uoah6cvQ ($18.35 in chips) 
zlYHXTtJ5tcx9kwK2h5n9A: posts small blind $0.10
R6AGToFJQOYVZAjC2jXEKw: posts big blind $0.25
*** HOLE CARDS ***
3zD3qLXT1bEffAoWGnc7wg: folds 
2aphcinkTZT0B0Uoah6cvQ: calls $0.25
08V++DOqzaNrRNsHIwi25w: folds 
mFv3iBCtrw9XfCDRB0d46Q: folds 
zlYHXTtJ5tcx9kwK2h5n9A: calls $0.15
R6AGToFJQOYVZAjC2jXEKw: checks 
*** FLOP *** [9c Qc Kd]
zlYHXTtJ5tcx9kwK2h5n9A: checks 
R6AGToFJQOYVZAjC2jXEKw: checks 
2aphcinkTZT0B0Uoah6cvQ: checks 
*** TURN *** [9c Qc Kd] [4h]
zlYHXTtJ5tcx9kwK2h5n9A: bets $0.25
R6AGToFJQOYVZAjC2jXEKw: folds 
2aphcinkTZT0B0Uoah6cvQ: folds 
Uncalled bet ($0.25) returned to zlYHXTtJ5tcx9kwK2h5n9A
zlYHXTtJ5tcx9kwK2h5n9A collected $0.75 from pot
*** SUMMARY ***
Total pot $0.75 | Rake $0 
Board [9c Qc Kd 4h]
Seat 1: 08V++DOqzaNrRNsHIwi25w folded before Flop (didn't bet)
Seat 2: mFv3iBCtrw9XfCDRB0d46Q (button) folded before Flop (didn't bet)
Seat 3: zlYHXTtJ5tcx9kwK2h5n9A (small blind) collected ($0.75)
Seat 4: R6AGToFJQOYVZAjC2jXEKw (big blind) folded on the Turn
Seat 5: 3zD3qLXT1bEffAoWGnc7wg folded before Flop (didn't bet)
Seat 6: 2aphcinkTZT0B0Uoah6cvQ folded on the Turn




PokerStars Game #59941554898:  Hold'em No Limit ($0.10/$0.25) - 2009/07/01 1:39:00 ET
Table 'O6cwjhrMn9pfzx1Ngn5zkQ' 6-max Seat #2 is the button
Seat 1: LJI7A1YgDM7hgh7o56+ReQ ($28.30 in chips) 
Seat 2: tSR4329m40dZsN7YOpI9Kw ($29.10 in chips) 
Seat 3: EE16Ua5b1HSsYej5zeXOlA ($25.90 in chips) 
Seat 4: mfrkWA3PTeYPkbO6hi98Aw ($24.65 in chips) 
Seat 5: niLn0xUVlqh8If80xRjzCA ($26.95 in chips) 
Seat 6: 4TM16KVgEiQpLi4bVVWbVQ ($33.05 in chips) 
EE16Ua5b1HSsYej5zeXOlA: posts small blind $0.10
mfrkWA3PTeYPkbO6hi98Aw: posts big blind $0.25
*** HOLE CARDS ***
niLn0xUVlqh8If80xRjzCA: calls $0.25
4TM16KVgEiQpLi4bVVWbVQ: folds 
LJI7A1YgDM7hgh7o56+ReQ: folds 
tSR4329m40dZsN7YOpI9Kw: raises $1.25 to $1.50
EE16Ua5b1HSsYej5zeXOlA: folds 
mfrkWA3PTeYPkbO6hi98Aw: folds 
niLn0xUVlqh8If80xRjzCA: folds 
Uncalled bet ($1.25) returned to tSR4329m40dZsN7YOpI9Kw
tSR4329m40dZsN7YOpI9Kw collected $0.85 from pot
tSR4329m40dZsN7YOpI9Kw: doesn't show hand 
*** SUMMARY ***
Total pot $0.85 | Rake $0 
Seat 1: LJI7A1YgDM7hgh7o56+ReQ folded before Flop (didn't bet)
Seat 2: tSR4329m40dZsN7YOpI9Kw (button) collected ($0.85)
Seat 3: EE16Ua5b1HSsYej5zeXOlA (small blind) folded before Flop
Seat 4: mfrkWA3PTeYPkbO6hi98Aw (big blind) folded before Flop
Seat 5: niLn0xUVlqh8If80xRjzCA folded before Flop
Seat 6: 4TM16KVgEiQpLi4bVVWbVQ folded before Flop (didn't bet)




PokerStars Game #59941554726:  Hold'em No Limit ($0.10/$0.25) - 2009/07/01 1:39:00 ET
Table 'Pz8SfAzhP5nvWTsJRAxoDg' 6-max Seat #4 is the button
Seat 1: QiL+lEgEWwy21jk/ltaRLg ($27.35 in chips) 
Seat 2: xrf8tAXKQHG99HixCot1Iw ($25.15 in chips) 
Seat 3: mfrkWA3PTeYPkbO6hi98Aw ($28.20 in chips) 
Seat 4: 4lJto+Qj0K4JrFKvHaPTLw ($35.70 in chips) 
Seat 5: FYepjhAvF8ZdVCmqHIy+eQ ($62.90 in chips) 
Seat 6: QvTX2yGq3uKJiKPmns4TKQ ($25 in chips) 
FYepjhAvF8ZdVCmqHIy+eQ: posts small blind $0.10
QvTX2yGq3uKJiKPmns4TKQ: posts big blind $0.25
*** HOLE CARDS ***
QiL+lEgEWwy21jk/ltaRLg: folds 
xrf8tAXKQHG99HixCot1Iw: folds 
mfrkWA3PTeYPkbO6hi98Aw: folds 
4lJto+Qj0K4JrFKvHaPTLw: folds 
FYepjhAvF8ZdVCmqHIy+eQ: raises $0.75 to $1
QvTX2yGq3uKJiKPmns4TKQ: folds 
Uncalled bet ($0.75) returned to FYepjhAvF8ZdVCmqHIy+eQ
FYepjhAvF8ZdVCmqHIy+eQ collected $0.50 from pot
FYepjhAvF8ZdVCmqHIy+eQ: doesn't show hand 
*** SUMMARY ***
Total pot $0.50 | Rake $0 
Seat 1: QiL+lEgEWwy21jk/ltaRLg folded before Flop (didn't bet)
Seat 2: xrf8tAXKQHG99HixCot1Iw folded before Flop (didn't bet)
Seat 3: mfrkWA3PTeYPkbO6hi98Aw folded before Flop (didn't bet)
Seat 4: 4lJto+Qj0K4JrFKvHaPTLw (button) folded before Flop (didn't bet)
Seat 5: FYepjhAvF8ZdVCmqHIy+eQ (small blind) collected ($0.50)
Seat 6: QvTX2yGq3uKJiKPmns4TKQ (big blind) folded before Flop




PokerStars Game #59941555300:  Hold'em No Limit ($0.10/$0.25) - 2009/07/01 1:39:01 ET
Table 'KU/HrxqxwDz8HKEhYTZ6uw' 6-max Seat #2 is the button
Seat 1: 7LKoiQHXpTQXJvWQrw907g ($27.35 in chips) 
Seat 2: kG34n23qFQA3nzdOJTQ1dA ($22.10 in chips) 
Seat 3: SFmT9ZsVopnukjvAzrxTRg ($25.90 in chips) 
Seat 4: AGwMM0FUhYZf81+oXvYQMg ($25.90 in chips) 
Seat 5: iyZxqznXjv3vtvOJymkoLQ ($52 in chips) 
Seat 6: qWxkCeqApAWdAA0evrfDvQ ($18.70 in chips) 
SFmT9ZsVopnukjvAzrxTRg: posts small blind $0.10
AGwMM0FUhYZf81+oXvYQMg: posts big blind $0.25
*** HOLE CARDS ***
iyZxqznXjv3vtvOJymkoLQ: folds 
qWxkCeqApAWdAA0evrfDvQ: calls $0.25
7LKoiQHXpTQXJvWQrw907g: raises $0.50 to $0.75
kG34n23qFQA3nzdOJTQ1dA: folds 
SFmT9ZsVopnukjvAzrxTRg: folds 
AGwMM0FUhYZf81+oXvYQMg: calls $0.50
qWxkCeqApAWdAA0evrfDvQ: calls $0.50
*** FLOP *** [Qc 4d Td]
AGwMM0FUhYZf81+oXvYQMg: checks 
qWxkCeqApAWdAA0evrfDvQ: checks 
7LKoiQHXpTQXJvWQrw907g: checks 
*** TURN *** [Qc 4d Td] [2d]
AGwMM0FUhYZf81+oXvYQMg: checks 
qWxkCeqApAWdAA0evrfDvQ: checks 
7LKoiQHXpTQXJvWQrw907g: bets $1.75
AGwMM0FUhYZf81+oXvYQMg: folds 
qWxkCeqApAWdAA0evrfDvQ: folds 
Uncalled bet ($1.75) returned to 7LKoiQHXpTQXJvWQrw907g
7LKoiQHXpTQXJvWQrw907g collected $2.25 from pot
*** SUMMARY ***
Total pot $2.35 | Rake $0.10 
Board [Qc 4d Td 2d]
Seat 1: 7LKoiQHXpTQXJvWQrw907g collected ($2.25)
Seat 2: kG34n23qFQA3nzdOJTQ1dA (button) folded before Flop (didn't bet)
Seat 3: SFmT9ZsVopnukjvAzrxTRg (small blind) folded before Flop
Seat 4: AGwMM0FUhYZf81+oXvYQMg (big blind) folded on the Turn
Seat 5: iyZxqznXjv3vtvOJymkoLQ folded before Flop (didn't bet)
Seat 6: qWxkCeqApAWdAA0evrfDvQ folded on the Turn




PokerStars Game #59941555254:  Hold'em No Limit ($0.10/$0.25) - 2009/07/01 1:39:01 ET
Table 'emoxgHTxg9Uqeu06oLzLyg' 6-max Seat #1 is the button
Seat 1: QuJ87sC/OOZv/rYCnQDgUw ($24.05 in chips) 
Seat 2: wIFhgE1PVdX6Xf6aVlSTPg ($15.45 in chips) 
Seat 3: uD5epdBxuyc30pF1dO958Q ($11.15 in chips) 
Seat 4: 3VAbqAWh8ncE2SJOYIx2ZQ ($10.55 in chips) 
Seat 5: ZmsNNfGxipD8dY5iwrlOXQ ($8.90 in chips) 
Seat 6: iHZrkhpIO/3+tKuAoPx8HQ ($15.20 in chips) 
wIFhgE1PVdX6Xf6aVlSTPg: posts small blind $0.10
uD5epdBxuyc30pF1dO958Q: posts big blind $0.25
*** HOLE CARDS ***
3VAbqAWh8ncE2SJOYIx2ZQ: calls $0.25
ZmsNNfGxipD8dY5iwrlOXQ: folds 
iHZrkhpIO/3+tKuAoPx8HQ: raises $0.75 to $1
QuJ87sC/OOZv/rYCnQDgUw: folds 
wIFhgE1PVdX6Xf6aVlSTPg: folds 
uD5epdBxuyc30pF1dO958Q: folds 
3VAbqAWh8ncE2SJOYIx2ZQ: calls $0.75
*** FLOP *** [Ts 6h 5c]
3VAbqAWh8ncE2SJOYIx2ZQ: bets $0.75
iHZrkhpIO/3+tKuAoPx8HQ: calls $0.75
*** TURN *** [Ts 6h 5c] [2h]
3VAbqAWh8ncE2SJOYIx2ZQ: bets $0.75
iHZrkhpIO/3+tKuAoPx8HQ: calls $0.75
*** RIVER *** [Ts 6h 5c 2h] [3s]
3VAbqAWh8ncE2SJOYIx2ZQ: checks 
iHZrkhpIO/3+tKuAoPx8HQ: checks 
*** SHOW DOWN ***
3VAbqAWh8ncE2SJOYIx2ZQ: shows [Tc 7c] (a pair of Tens)
iHZrkhpIO/3+tKuAoPx8HQ: mucks hand 
3VAbqAWh8ncE2SJOYIx2ZQ collected $5.10 from pot
*** SUMMARY ***
Total pot $5.35 | Rake $0.25 
Board [Ts 6h 5c 2h 3s]
Seat 1: QuJ87sC/OOZv/rYCnQDgUw (button) folded before Flop (didn't bet)
Seat 2: wIFhgE1PVdX6Xf6aVlSTPg (small blind) folded before Flop
Seat 3: uD5epdBxuyc30pF1dO958Q (big blind) folded before Flop
Seat 4: 3VAbqAWh8ncE2SJOYIx2ZQ showed [Tc 7c] and won ($5.10) with a pair of Tens
Seat 5: ZmsNNfGxipD8dY5iwrlOXQ folded before Flop (didn't bet)
Seat 6: iHZrkhpIO/3+tKuAoPx8HQ mucked




PokerStars Game #59941555724:  Hold'em No Limit ($0.10/$0.25) - 2009/07/01 1:39:01 ET
Table 'O5NgMYt6EWbLBozZb3kseg' 6-max Seat #1 is the button
Seat 1: MCCWc70bl051s/EF6nHRcA ($27.05 in chips) 
Seat 2: /gJNBeCkWL4o85/jvlZ4BA ($33.75 in chips) 
Seat 3: tLM9aw7T3kBEIhQEh1roOg ($6.85 in chips) 
Seat 4: txiWmlZ/sfM8Td16RHH/cA ($4.20 in chips) 
Seat 5: vu2kzHaDtgr6NM7rdq0chA ($85.55 in chips) 
Seat 6: k9vn40MOqqb+xF+7GZ6v2g ($117.55 in chips) 
/gJNBeCkWL4o85/jvlZ4BA: posts small blind $0.10
tLM9aw7T3kBEIhQEh1roOg: posts big blind $0.25
*** HOLE CARDS ***
txiWmlZ/sfM8Td16RHH/cA: folds 
vu2kzHaDtgr6NM7rdq0chA: folds 
k9vn40MOqqb+xF+7GZ6v2g: calls $0.25
MCCWc70bl051s/EF6nHRcA: calls $0.25
/gJNBeCkWL4o85/jvlZ4BA: calls $0.15
tLM9aw7T3kBEIhQEh1roOg: checks 
*** FLOP *** [5d 7s Kd]
/gJNBeCkWL4o85/jvlZ4BA: checks 
tLM9aw7T3kBEIhQEh1roOg: checks 
k9vn40MOqqb+xF+7GZ6v2g: bets $1
MCCWc70bl051s/EF6nHRcA: folds 
/gJNBeCkWL4o85/jvlZ4BA: folds 
tLM9aw7T3kBEIhQEh1roOg: folds 
Uncalled bet ($1) returned to k9vn40MOqqb+xF+7GZ6v2g
k9vn40MOqqb+xF+7GZ6v2g collected $0.95 from pot
*** SUMMARY ***
Total pot $1 | Rake $0.05 
Board [5d 7s Kd]
Seat 1: MCCWc70bl051s/EF6nHRcA (button) folded on the Flop
Seat 2: /gJNBeCkWL4o85/jvlZ4BA (small blind) folded on the Flop
Seat 3: tLM9aw7T3kBEIhQEh1roOg (big blind) folded on the Flop
Seat 4: txiWmlZ/sfM8Td16RHH/cA folded before Flop (didn't bet)
Seat 5: vu2kzHaDtgr6NM7rdq0chA folded before Flop (didn't bet)
Seat 6: k9vn40MOqqb+xF+7GZ6v2g collected ($0.95)




PokerStars Game #59941555414:  Hold'em No Limit ($0.10/$0.25) - 2009/07/01 1:39:01 ET
Table 'jdhJTJjFq2KTttwJcd+7nQ' 6-max Seat #1 is the button
Seat 1: LtASJ9OlkqGrrUKGQlpGAw ($23.05 in chips) 
Seat 2: Hsvkc0/G2VV78oVmWYXecw ($5 in chips) 
Seat 3: vqWjZmdQu/Hxw96/IJTWdQ ($25 in chips) 
Seat 4: vx7FwRcelVSsvNYAdp/z0A ($3.50 in chips) 
Seat 5: BV+K0Phf5VBHr7aZPKqbUQ ($25 in chips) 
Seat 6: yb6rnd48JuBccThV68VHAQ ($24.15 in chips) 
Hsvkc0/G2VV78oVmWYXecw: posts small blind $0.10
vqWjZmdQu/Hxw96/IJTWdQ: posts big blind $0.25
*** HOLE CARDS ***
vx7FwRcelVSsvNYAdp/z0A: calls $0.25
BV+K0Phf5VBHr7aZPKqbUQ: calls $0.25
yb6rnd48JuBccThV68VHAQ: calls $0.25
LtASJ9OlkqGrrUKGQlpGAw: raises $1.25 to $1.50
Hsvkc0/G2VV78oVmWYXecw: folds 
vqWjZmdQu/Hxw96/IJTWdQ: folds 
vx7FwRcelVSsvNYAdp/z0A: folds 
BV+K0Phf5VBHr7aZPKqbUQ: folds 
yb6rnd48JuBccThV68VHAQ: calls $1.25
*** FLOP *** [Js Ts Td]
yb6rnd48JuBccThV68VHAQ: bets $1
LtASJ9OlkqGrrUKGQlpGAw: raises $1 to $2
yb6rnd48JuBccThV68VHAQ: calls $1
*** TURN *** [Js Ts Td] [4h]
yb6rnd48JuBccThV68VHAQ: checks 
LtASJ9OlkqGrrUKGQlpGAw: bets $5
yb6rnd48JuBccThV68VHAQ: folds 
Uncalled bet ($5) returned to LtASJ9OlkqGrrUKGQlpGAw
LtASJ9OlkqGrrUKGQlpGAw collected $7.50 from pot
LtASJ9OlkqGrrUKGQlpGAw: doesn't show hand 
*** SUMMARY ***
Total pot $7.85 | Rake $0.35 
Board [Js Ts Td 4h]
Seat 1: LtASJ9OlkqGrrUKGQlpGAw (button) collected ($7.50)
Seat 2: Hsvkc0/G2VV78oVmWYXecw (small blind) folded before Flop
Seat 3: vqWjZmdQu/Hxw96/IJTWdQ (big blind) folded before Flop
Seat 4: vx7FwRcelVSsvNYAdp/z0A folded before Flop
Seat 5: BV+K0Phf5VBHr7aZPKqbUQ folded before Flop
Seat 6: yb6rnd48JuBccThV68VHAQ folded on the Turn




PokerStars Game #59941555480:  Hold'em No Limit ($0.10/$0.25) - 2009/07/01 1:39:01 ET
Table 'YYMg5qzxK1m9eGRo4SbxtQ' 9-max Seat #9 is the button
Seat 2: f/H6PsHRl4W1JyNsEDvPtg ($8.20 in chips) 
Seat 4: H8sSXb2KLK0U38tU9YITDw ($6.40 in chips) 
Seat 6: S5VeQLgBIiHrfs9AB2vBwA ($3.55 in chips) 
Seat 7: otsTcnOEjDA+oFV8U+ITZw ($17.25 in chips) 
Seat 8: xoBFd/5k+L/pFn9VW1VyWg ($13.75 in chips) 
Seat 9: +sbyWwIcFp9kP0bDtMegfQ ($32.25 in chips) 
f/H6PsHRl4W1JyNsEDvPtg: posts small blind $0.10
H8sSXb2KLK0U38tU9YITDw: posts big blind $0.25
*** HOLE CARDS ***
S5VeQLgBIiHrfs9AB2vBwA: folds 
otsTcnOEjDA+oFV8U+ITZw: raises $0.75 to $1
xoBFd/5k+L/pFn9VW1VyWg: calls $1
+sbyWwIcFp9kP0bDtMegfQ: folds 
f/H6PsHRl4W1JyNsEDvPtg: folds 
H8sSXb2KLK0U38tU9YITDw: calls $0.75
*** FLOP *** [3c 9c 7h]
H8sSXb2KLK0U38tU9YITDw: checks 
otsTcnOEjDA+oFV8U+ITZw: bets $2
xoBFd/5k+L/pFn9VW1VyWg: folds 
H8sSXb2KLK0U38tU9YITDw: folds 
Uncalled bet ($2) returned to otsTcnOEjDA+oFV8U+ITZw
otsTcnOEjDA+oFV8U+ITZw collected $2.95 from pot
otsTcnOEjDA+oFV8U+ITZw: doesn't show hand 
*** SUMMARY ***
Total pot $3.10 | Rake $0.15 
Board [3c 9c 7h]
Seat 2: f/H6PsHRl4W1JyNsEDvPtg (small blind) folded before Flop
Seat 4: H8sSXb2KLK0U38tU9YITDw (big blind) folded on the Flop
Seat 6: S5VeQLgBIiHrfs9AB2vBwA folded before Flop (didn't bet)
Seat 7: otsTcnOEjDA+oFV8U+ITZw collected ($2.95)
Seat 8: xoBFd/5k+L/pFn9VW1VyWg folded on the Flop
Seat 9: +sbyWwIcFp9kP0bDtMegfQ (button) folded before Flop (didn't bet)




PokerStars Game #59941555416:  Hold'em No Limit ($0.10/$0.25) - 2009/07/01 1:39:01 ET
Table 'sDHjMRwfSiz7+NDdZLUiyA' 9-max Seat #8 is the button
Seat 1: VGwr1eqhvdUtMfBFCvBnmg ($9.75 in chips) 
Seat 2: ljemhp25Zg+nlA9DLCIiUw ($25.95 in chips) 
Seat 3: SGA1WpAnQxFdFAYyt362gQ ($17.15 in chips) 
Seat 4: eK8qa6EPcH2zhtbmWSvc9g ($25.45 in chips) 
Seat 5: IGRfskE1v9H9Bn+fz8AgNQ ($32.75 in chips) 
Seat 6: 1qa0qHOCKZM3Uipx9DxYtQ ($4.75 in chips) 
Seat 7: K0b5wNInj6hUGRr6yzKFtw ($37.65 in chips) 
Seat 8: 3hMkm4U5yTRrkGJkxfijaQ ($5.15 in chips) 
Seat 9: 3PmVnC/15cl4oyI1TKIt4g ($4.40 in chips) 
3PmVnC/15cl4oyI1TKIt4g: posts small blind $0.10
VGwr1eqhvdUtMfBFCvBnmg: posts big blind $0.25
*** HOLE CARDS ***
ljemhp25Zg+nlA9DLCIiUw: folds 
SGA1WpAnQxFdFAYyt362gQ: folds 
eK8qa6EPcH2zhtbmWSvc9g: folds 
IGRfskE1v9H9Bn+fz8AgNQ: raises $0.75 to $1
1qa0qHOCKZM3Uipx9DxYtQ: calls $1
K0b5wNInj6hUGRr6yzKFtw: folds 
3hMkm4U5yTRrkGJkxfijaQ: folds 
3PmVnC/15cl4oyI1TKIt4g: folds 
VGwr1eqhvdUtMfBFCvBnmg: folds 
*** FLOP *** [5s 9d 8s]
IGRfskE1v9H9Bn+fz8AgNQ: bets $3.75
1qa0qHOCKZM3Uipx9DxYtQ: calls $3.75 and is all-in
*** TURN *** [5s 9d 8s] [Jh]
*** RIVER *** [5s 9d 8s Jh] [Jd]
*** SHOW DOWN ***
IGRfskE1v9H9Bn+fz8AgNQ: shows [Qd Ac] (a pair of Jacks)
1qa0qHOCKZM3Uipx9DxYtQ: shows [Ts Ad] (a pair of Jacks - lower kicker)
IGRfskE1v9H9Bn+fz8AgNQ collected $9.40 from pot
*** SUMMARY ***
Total pot $9.85 | Rake $0.45 
Board [5s 9d 8s Jh Jd]
Seat 1: VGwr1eqhvdUtMfBFCvBnmg (big blind) folded before Flop
Seat 2: ljemhp25Zg+nlA9DLCIiUw folded before Flop (didn't bet)
Seat 3: SGA1WpAnQxFdFAYyt362gQ folded before Flop (didn't bet)
Seat 4: eK8qa6EPcH2zhtbmWSvc9g folded before Flop (didn't bet)
Seat 5: IGRfskE1v9H9Bn+fz8AgNQ showed [Qd Ac] and won ($9.40) with a pair of Jacks
Seat 6: 1qa0qHOCKZM3Uipx9DxYtQ showed [Ts Ad] and lost with a pair of Jacks
Seat 7: K0b5wNInj6hUGRr6yzKFtw folded before Flop (didn't bet)
Seat 8: 3hMkm4U5yTRrkGJkxfijaQ (button) folded before Flop (didn't bet)
Seat 9: 3PmVnC/15cl4oyI1TKIt4g (small blind) folded before Flop




PokerStars Game #59941555688:  Hold'em No Limit ($0.10/$0.25) - 2009/07/01 1:39:01 ET
Table 'dVzscin98UhGisTmV9BDcw' 9-max Seat #9 is the button
Seat 1: sBAwXpkpgyhyWbHIQcIJKA ($18 in chips) 
Seat 2: dfNim92Z6XK1/h5SFW5vDg ($28.60 in chips) 
Seat 3: JKOHWhyNSj5IT6PzR/yHDg ($8.10 in chips) 
Seat 4: aNpwfA31EREwO+ar4XzBCw ($41.65 in chips) 
Seat 5: 22dIObOuor/A+IKWkNoAlA ($10.10 in chips) 
Seat 6: bXpVeaSTPBFSPJmeXxO7nw ($4.65 in chips) 
Seat 7: cKlmpQMahVsmOaxFQDcoOg ($24.65 in chips) 
Seat 8: /vn2Qu2dvc9AMMq46Ae0jA ($40.70 in chips) 
Seat 9: arxNSjreDRGFg13EAM2F1w ($25 in chips) 
sBAwXpkpgyhyWbHIQcIJKA: posts small blind $0.10
dfNim92Z6XK1/h5SFW5vDg: posts big blind $0.25
*** HOLE CARDS ***
JKOHWhyNSj5IT6PzR/yHDg: folds 
aNpwfA31EREwO+ar4XzBCw: folds 
22dIObOuor/A+IKWkNoAlA: folds 
bXpVeaSTPBFSPJmeXxO7nw: folds 
cKlmpQMahVsmOaxFQDcoOg: raises $0.50 to $0.75
/vn2Qu2dvc9AMMq46Ae0jA: folds 
arxNSjreDRGFg13EAM2F1w: folds 
sBAwXpkpgyhyWbHIQcIJKA: folds 
dfNim92Z6XK1/h5SFW5vDg: folds 
Uncalled bet ($0.50) returned to cKlmpQMahVsmOaxFQDcoOg
cKlmpQMahVsmOaxFQDcoOg collected $0.60 from pot
*** SUMMARY ***
Total pot $0.60 | Rake $0 
Seat 1: sBAwXpkpgyhyWbHIQcIJKA (small blind) folded before Flop
Seat 2: dfNim92Z6XK1/h5SFW5vDg (big blind) folded before Flop
Seat 3: JKOHWhyNSj5IT6PzR/yHDg folded before Flop (didn't bet)
Seat 4: aNpwfA31EREwO+ar4XzBCw folded before Flop (didn't bet)
Seat 5: 22dIObOuor/A+IKWkNoAlA folded before Flop (didn't bet)
Seat 6: bXpVeaSTPBFSPJmeXxO7nw folded before Flop (didn't bet)
Seat 7: cKlmpQMahVsmOaxFQDcoOg collected ($0.60)
Seat 8: /vn2Qu2dvc9AMMq46Ae0jA folded before Flop (didn't bet)
Seat 9: arxNSjreDRGFg13EAM2F1w (button) folded before Flop (didn't bet)




PokerStars Game #59941555868:  Hold'em No Limit ($0.10/$0.25) - 2009/07/01 1:39:01 ET
Table '6wawJ+MkkvuC3coG6r+YhgZiwAqg4o02gNro+JOAaFNgSeat #3 is the button
Seat 1: 6RiVTYll/5D8zICp0MRpKw ($25.20 in chips) 
Seat 2: tYsOBqdU1+x+yFI7zHO7hQ ($31.40 in chips) 
Seat 3: aNpwfA31EREwO+ar4XzBCw ($31.75 in chips) 
Seat 4: j4q3p0lesp63b1gZDwLBZw ($5.75 in chips) 
Seat 5: 6HoFYfVGBefsR5Vrz62qIw5hAPbqNrvJb8PtLiceXtlg.35 in chips) 
Seat 7: yyG4svzOpC1A+sUP/scg6w ($7.05 in chips) 
Seat 8: VLIsy+xjx3olLSYO3JLS6g ($18.35 in chips) 
Seat 9: ljemhp25Zg+nlA9DLCIiUw ($23.65 in chips) 
j4q3p0lesp63b1gZDwLBZw: posts small blind $0.10
6HoFYfVGBefsR5Vrz62qIw5hAPbqNrvJb8PtLiceXtlgsts big blind $0.25
5n7e7I+px7c6CQmLpPbtsg: sits out 
*** HOLE CARDS ***
yyG4svzOpC1A+sUP/scg6w: folds 
VLIsy+xjx3olLSYO3JLS6g: folds 
ljemhp25Zg+nlA9DLCIiUw: calls $0.25
6RiVTYll/5D8zICp0MRpKw: folds 
tYsOBqdU1+x+yFI7zHO7hQ: folds 
aNpwfA31EREwO+ar4XzBCw: calls $0.25
j4q3p0lesp63b1gZDwLBZw: folds 
6HoFYfVGBefsR5Vrz62qIw5hAPbqNrvJb8PtLiceXtlgecks 
*** FLOP *** [7s 8c 8d]
6HoFYfVGBefsR5Vrz62qIw5hAPbqNrvJb8PtLiceXtlgecks 
ljemhp25Zg+nlA9DLCIiUw: checks 
aNpwfA31EREwO+ar4XzBCw: checks 
*** TURN *** [7s 8c 8d] [Ks]
6HoFYfVGBefsR5Vrz62qIw5hAPbqNrvJb8PtLiceXtlgts $0.50
ljemhp25Zg+nlA9DLCIiUw: folds 
aNpwfA31EREwO+ar4XzBCw: calls $0.50
*** RIVER *** [7s 8c 8d Ks] [Ah]
6HoFYfVGBefsR5Vrz62qIw5hAPbqNrvJb8PtLiceXtlgecks 
aNpwfA31EREwO+ar4XzBCw: bets $1
6HoFYfVGBefsR5Vrz62qIw5hAPbqNrvJb8PtLiceXtlgises $1 to $2
aNpwfA31EREwO+ar4XzBCw: calls $1
*** SHOW DOWN ***
6HoFYfVGBefsR5Vrz62qIw5hAPbqNrvJb8PtLiceXtlgows [3d 8h] (three of a kind, Eights)
aNpwfA31EREwO+ar4XzBCw: mucks hand 
6HoFYfVGBefsR5Vrz62qIw5hAPbqNrvJb8PtLiceXtlglected $5.60 from pot
*** SUMMARY ***
Total pot $5.85 | Rake $0.25 
Board [7s 8c 8d Ks Ah]
Seat 1: 6RiVTYll/5D8zICp0MRpKw folded before Flop (didn't bet)
Seat 2: tYsOBqdU1+x+yFI7zHO7hQ folded before Flop (didn't bet)
Seat 3: aNpwfA31EREwO+ar4XzBCw (button) mucked
Seat 4: j4q3p0lesp63b1gZDwLBZw (small blind) folded before Flop
Seat 5: 6HoFYfVGBefsR5Vrz62qIw5hAPbqNrvJb8PtLiceXtlgg blind) showed [3d 8h] and won ($5.60) with three of a kind, Eights
Seat 7: yyG4svzOpC1A+sUP/scg6w folded before Flop (didn't bet)
Seat 8: VLIsy+xjx3olLSYO3JLS6g folded before Flop (didn't bet)
Seat 9: ljemhp25Zg+nlA9DLCIiUw folded on the Turn




PokerStars Game #59941556866:  Hold'em No Limit ($0.10/$0.25) - 2009/07/01 1:39:03 ET
Table 'sm5gqEvXgLbkkE4dryW/5g' 6-max Seat #3 is the button
Seat 1: v8m8XHovI5tqEA9mvplDSw ($38.60 in chips) 
Seat 2: 5xs5/u2z1CO9zkRvH72MQg ($17.05 in chips) 
Seat 3: UT5XpwOH1ipkOF7n1MqDJA ($26.15 in chips) 
Seat 4: cWc85bEzdRzpUMhRKm8pwQ ($25.35 in chips) 
Seat 6: aogAb4Eienxztk8p2v9VVw ($21.40 in chips) 
cWc85bEzdRzpUMhRKm8pwQ: posts small blind $0.10
2G0C7dp4wlPpE21FHjjElQ: is sitting out 
aogAb4Eienxztk8p2v9VVw: posts big blind $0.25
*** HOLE CARDS ***
v8m8XHovI5tqEA9mvplDSw: folds 
5xs5/u2z1CO9zkRvH72MQg: folds 
UT5XpwOH1ipkOF7n1MqDJA: raises $0.75 to $1
cWc85bEzdRzpUMhRKm8pwQ: folds 
aogAb4Eienxztk8p2v9VVw: folds 
Uncalled bet ($0.75) returned to UT5XpwOH1ipkOF7n1MqDJA
UT5XpwOH1ipkOF7n1MqDJA collected $0.60 from pot
*** SUMMARY ***
Total pot $0.60 | Rake $0 
Seat 1: v8m8XHovI5tqEA9mvplDSw folded before Flop (didn't bet)
Seat 2: 5xs5/u2z1CO9zkRvH72MQg folded before Flop (didn't bet)
Seat 3: UT5XpwOH1ipkOF7n1MqDJA (button) collected ($0.60)
Seat 4: cWc85bEzdRzpUMhRKm8pwQ (small blind) folded before Flop
Seat 6: aogAb4Eienxztk8p2v9VVw (big blind) folded before Flop




PokerStars Game #59941556464:  Hold'em No Limit ($0.10/$0.25) - 2009/07/01 1:39:03 ET
Table 'wGizWOswEL6P5QrvVkno/g' 6-max Seat #1 is the button
Seat 1: qioYBj/+5TF7Cag2Um4eAw ($6.35 in chips) 
Seat 2: mfrkWA3PTeYPkbO6hi98Aw ($25 in chips) 
Seat 4: 32YL2ZEp8NT4JB2RVM9euQ ($15.60 in chips) 
Seat 5: wsP46AGpqDjHZQmlRHKa9g ($39.75 in chips) 
Seat 6: rfSnsAuAfXTb8w/obc9OVQ ($5 in chips) 
mfrkWA3PTeYPkbO6hi98Aw: posts small blind $0.10
32YL2ZEp8NT4JB2RVM9euQ: posts big blind $0.25
rfSnsAuAfXTb8w/obc9OVQ: posts big blind $0.25
*** HOLE CARDS ***
wsP46AGpqDjHZQmlRHKa9g: folds 
bJFzs6QmEEnz4miMfSDtcg joins the table at seat #3 
rfSnsAuAfXTb8w/obc9OVQ: checks 
qioYBj/+5TF7Cag2Um4eAw: folds 
mfrkWA3PTeYPkbO6hi98Aw: folds 
32YL2ZEp8NT4JB2RVM9euQ: checks 
*** FLOP *** [3c 9c Kc]
32YL2ZEp8NT4JB2RVM9euQ: checks 
rfSnsAuAfXTb8w/obc9OVQ: bets $0.50
32YL2ZEp8NT4JB2RVM9euQ: calls $0.50
*** TURN *** [3c 9c Kc] [Qd]
32YL2ZEp8NT4JB2RVM9euQ: checks 
rfSnsAuAfXTb8w/obc9OVQ: checks 
*** RIVER *** [3c 9c Kc Qd] [3h]
32YL2ZEp8NT4JB2RVM9euQ: checks 
rfSnsAuAfXTb8w/obc9OVQ: checks 
*** SHOW DOWN ***
32YL2ZEp8NT4JB2RVM9euQ: shows [Ks Jc] (two pair, Kings and Threes)
rfSnsAuAfXTb8w/obc9OVQ: mucks hand 
32YL2ZEp8NT4JB2RVM9euQ collected $1.55 from pot
qioYBj/+5TF7Cag2Um4eAw leaves the table
*** SUMMARY ***
Total pot $1.60 | Rake $0.05 
Board [3c 9c Kc Qd 3h]
Seat 1: qioYBj/+5TF7Cag2Um4eAw (button) folded before Flop (didn't bet)
Seat 2: mfrkWA3PTeYPkbO6hi98Aw (small blind) folded before Flop
Seat 4: 32YL2ZEp8NT4JB2RVM9euQ (big blind) showed [Ks Jc] and won ($1.55) with two pair, Kings and Threes
Seat 5: wsP46AGpqDjHZQmlRHKa9g folded before Flop (didn't bet)
Seat 6: rfSnsAuAfXTb8w/obc9OVQ mucked




PokerStars Game #59941556790:  Hold'em No Limit ($0.10/$0.25) - 2009/07/01 1:39:03 ET
Table '+UzantPJ4smVdrh+4GTu1w' 6-max Seat #5 is the button
Seat 1: TSmua8tGK3sTbwi0ynrW9Q ($27.70 in chips) 
Seat 3: SS/yfeArhULzIcOPe8MdPg ($29.60 in chips) 
Seat 4: UmcUp27+PbgBItv3ZNlAWQ ($25.25 in chips) 
Seat 5: cj4VBQya7HtVL2zCGd5jLQ ($60.45 in chips) 
Seat 6: fZQg9veL7Dd/Z04ZTjC+wQ ($25 in chips) 
fZQg9veL7Dd/Z04ZTjC+wQ: posts small blind $0.10
TSmua8tGK3sTbwi0ynrW9Q: posts big blind $0.25
*** HOLE CARDS ***
SS/yfeArhULzIcOPe8MdPg: folds 
UmcUp27+PbgBItv3ZNlAWQ: folds 
cj4VBQya7HtVL2zCGd5jLQ: folds 
fZQg9veL7Dd/Z04ZTjC+wQ: folds 
Uncalled bet ($0.15) returned to TSmua8tGK3sTbwi0ynrW9Q
TSmua8tGK3sTbwi0ynrW9Q collected $0.20 from pot
*** SUMMARY ***
Total pot $0.20 | Rake $0 
Seat 1: TSmua8tGK3sTbwi0ynrW9Q (big blind) collected ($0.20)
Seat 3: SS/yfeArhULzIcOPe8MdPg folded before Flop (didn't bet)
Seat 4: UmcUp27+PbgBItv3ZNlAWQ folded before Flop (didn't bet)
Seat 5: cj4VBQya7HtVL2zCGd5jLQ (button) folded before Flop (didn't bet)
Seat 6: fZQg9veL7Dd/Z04ZTjC+wQ (small blind) folded before Flop




PokerStars Game #59941556400:  Hold'em No Limit ($0.10/$0.25) - 2009/07/01 1:39:03 ET
Table 'sJ4KpS2GE5Qrsu1/cFjJUw' 9-max Seat #8 is the button
Seat 1: 7mHNIz+BCOKfVsh+EQ/4Wg ($4.90 in chips) 
Seat 2: tYsOBqdU1+x+yFI7zHO7hQ ($31.50 in chips) 
Seat 3: eK8qa6EPcH2zhtbmWSvc9g ($25.90 in chips) 
Seat 4: npAYqa85pqnzfOK5ukX+BQ ($23.15 in chips) 
Seat 5: Q/gZC63lfOMr7YhWKPCxoQ ($9.60 in chips) 
Seat 6: OefE+Csvj5KR7ClGf3Hc2g ($3.10 in chips) 
Seat 7: Wi8djHgewBlVhpKWfp7isQ ($7.40 in chips) 
Seat 8: S7Ki0P+0AIGPuIfGJjW0gg ($31.20 in chips) 
Seat 9: 3PmVnC/15cl4oyI1TKIt4g ($5.10 in chips) 
3PmVnC/15cl4oyI1TKIt4g: posts small blind $0.10
7mHNIz+BCOKfVsh+EQ/4Wg: posts big blind $0.25
*** HOLE CARDS ***
tYsOBqdU1+x+yFI7zHO7hQ: folds 
eK8qa6EPcH2zhtbmWSvc9g: folds 
npAYqa85pqnzfOK5ukX+BQ has timed out
npAYqa85pqnzfOK5ukX+BQ: folds 
npAYqa85pqnzfOK5ukX+BQ is sitting out
Q/gZC63lfOMr7YhWKPCxoQ: folds 
OefE+Csvj5KR7ClGf3Hc2g: folds 
npAYqa85pqnzfOK5ukX+BQ has returned
Wi8djHgewBlVhpKWfp7isQ: folds 
S7Ki0P+0AIGPuIfGJjW0gg: calls $0.25
3PmVnC/15cl4oyI1TKIt4g: raises $1.25 to $1.50
7mHNIz+BCOKfVsh+EQ/4Wg: calls $1.25
S7Ki0P+0AIGPuIfGJjW0gg: calls $1.25
*** FLOP *** [Tc 2d 5s]
3PmVnC/15cl4oyI1TKIt4g: checks 
7mHNIz+BCOKfVsh+EQ/4Wg: bets $2.75
S7Ki0P+0AIGPuIfGJjW0gg: folds 
3PmVnC/15cl4oyI1TKIt4g: raises $0.85 to $3.60 and is all-in
7mHNIz+BCOKfVsh+EQ/4Wg: calls $0.65 and is all-in
Uncalled bet ($0.20) returned to 3PmVnC/15cl4oyI1TKIt4g
*** TURN *** [Tc 2d 5s] [5d]
*** RIVER *** [Tc 2d 5s 5d] [9h]
*** SHOW DOWN ***
3PmVnC/15cl4oyI1TKIt4g: shows [Qc Ac] (a pair of Fives)
7mHNIz+BCOKfVsh+EQ/4Wg: shows [Jh Jd] (two pair, Jacks and Fives)
7mHNIz+BCOKfVsh+EQ/4Wg collected $10.75 from pot
*** SUMMARY ***
Total pot $11.30 | Rake $0.55 
Board [Tc 2d 5s 5d 9h]
Seat 1: 7mHNIz+BCOKfVsh+EQ/4Wg (big blind) showed [Jh Jd] and won ($10.75) with two pair, Jacks and Fives
Seat 2: tYsOBqdU1+x+yFI7zHO7hQ folded before Flop (didn't bet)
Seat 3: eK8qa6EPcH2zhtbmWSvc9g folded before Flop (didn't bet)
Seat 4: npAYqa85pqnzfOK5ukX+BQ folded before Flop (didn't bet)
Seat 5: Q/gZC63lfOMr7YhWKPCxoQ folded before Flop (didn't bet)
Seat 6: OefE+Csvj5KR7ClGf3Hc2g folded before Flop (didn't bet)
Seat 7: Wi8djHgewBlVhpKWfp7isQ folded before Flop (didn't bet)
Seat 8: S7Ki0P+0AIGPuIfGJjW0gg (button) folded on the Flop
Seat 9: 3PmVnC/15cl4oyI1TKIt4g (small blind) showed [Qc Ac] and lost with a pair of Fives




PokerStars Game #59941556506:  Hold'em No Limit ($0.10/$0.25) - 2009/07/01 1:39:03 ET
Table 'nc6OeGk/wtaWV+6N+kgnZQ' 6-max Seat #1 is the button
Seat 1: tSR4329m40dZsN7YOpI9Kw ($39.15 in chips) 
Seat 2: 8ClCHtFXGNplITm+63KB+Q ($34.85 in chips) 
Seat 3: y8wpMWGSX2zHZijurx21mg ($6.65 in chips) 
Seat 4: 3zD3qLXT1bEffAoWGnc7wg ($30.30 in chips) 
Seat 5: HCS0lMAAPmZE2Tl8J/SuKw ($11.35 in chips) 
Seat 6: mFv3iBCtrw9XfCDRB0d46Q ($2.95 in chips) 
8ClCHtFXGNplITm+63KB+Q: posts small blind $0.10
y8wpMWGSX2zHZijurx21mg: posts big blind $0.25
*** HOLE CARDS ***
3zD3qLXT1bEffAoWGnc7wg: folds 
HCS0lMAAPmZE2Tl8J/SuKw: calls $0.25
mFv3iBCtrw9XfCDRB0d46Q: folds 
tSR4329m40dZsN7YOpI9Kw: folds 
8ClCHtFXGNplITm+63KB+Q: folds 
y8wpMWGSX2zHZijurx21mg: checks 
*** FLOP *** [Tc 7h Qc]
y8wpMWGSX2zHZijurx21mg: checks 
HCS0lMAAPmZE2Tl8J/SuKw: bets $0.75
y8wpMWGSX2zHZijurx21mg: folds 
Uncalled bet ($0.75) returned to HCS0lMAAPmZE2Tl8J/SuKw
HCS0lMAAPmZE2Tl8J/SuKw collected $0.60 from pot
*** SUMMARY ***
Total pot $0.60 | Rake $0 
Board [Tc 7h Qc]
Seat 1: tSR4329m40dZsN7YOpI9Kw (button) folded before Flop (didn't bet)
Seat 2: 8ClCHtFXGNplITm+63KB+Q (small blind) folded before Flop
Seat 3: y8wpMWGSX2zHZijurx21mg (big blind) folded on the Flop
Seat 4: 3zD3qLXT1bEffAoWGnc7wg folded before Flop (didn't bet)
Seat 5: HCS0lMAAPmZE2Tl8J/SuKw collected ($0.60)
Seat 6: mFv3iBCtrw9XfCDRB0d46Q folded before Flop (didn't bet)




PokerStars Game #59941556796:  Hold'em No Limit ($0.10/$0.25) - 2009/07/01 1:39:03 ET
Table 'JUMeG5SzDyo9HufhgemQeA' 9-max Seat #1 is the button
Seat 1: oLa/tXLfSLLB28mcLGrxcg ($23.85 in chips) 
Seat 3: IEvLSTIxhlti3EjZDarYnA ($32.60 in chips) 
Seat 5: Ne5zBB6oEKrbigKRh6d6Xg ($12.65 in chips) 
Seat 6: wFCwdYKUXoQHhz8qeZuuAw ($25.45 in chips) 
Seat 7: aNpwfA31EREwO+ar4XzBCw ($32.75 in chips) 
Seat 8: zDrucyjVn5aeekNEc3cJrA ($37.70 in chips) 
Seat 9: V6p0jQ/RhUsqpHLmXvEX4Q ($13.80 in chips) 
IEvLSTIxhlti3EjZDarYnA: posts small blind $0.10
Ne5zBB6oEKrbigKRh6d6Xg: posts big blind $0.25
*** HOLE CARDS ***
wFCwdYKUXoQHhz8qeZuuAw: folds 
aNpwfA31EREwO+ar4XzBCw: folds 
zDrucyjVn5aeekNEc3cJrA: folds 
V6p0jQ/RhUsqpHLmXvEX4Q: folds 
oLa/tXLfSLLB28mcLGrxcg: folds 
IEvLSTIxhlti3EjZDarYnA: folds 
Uncalled bet ($0.15) returned to Ne5zBB6oEKrbigKRh6d6Xg
Ne5zBB6oEKrbigKRh6d6Xg collected $0.20 from pot
*** SUMMARY ***
Total pot $0.20 | Rake $0 
Seat 1: oLa/tXLfSLLB28mcLGrxcg (button) folded before Flop (didn't bet)
Seat 3: IEvLSTIxhlti3EjZDarYnA (small blind) folded before Flop
Seat 5: Ne5zBB6oEKrbigKRh6d6Xg (big blind) collected ($0.20)
Seat 6: wFCwdYKUXoQHhz8qeZuuAw folded before Flop (didn't bet)
Seat 7: aNpwfA31EREwO+ar4XzBCw folded before Flop (didn't bet)
Seat 8: zDrucyjVn5aeekNEc3cJrA folded before Flop (didn't bet)
Seat 9: V6p0jQ/RhUsqpHLmXvEX4Q folded before Flop (didn't bet)




PokerStars Game #59941557466:  Hold'em No Limit ($0.10/$0.25) - 2009/07/01 1:39:04 ET
Table 'Loy/olZ5qoDOSvX4UTujGg' 6-max Seat #4 is the button
Seat 1: HipgaJhkN4ie/tTw4dK3Ug ($12.65 in chips) 
Seat 2: 4z7mPbMLNp4TezHXin63Vw ($18.90 in chips) 
Seat 3: 32YL2ZEp8NT4JB2RVM9euQ ($15.70 in chips) 
Seat 4: /gJNBeCkWL4o85/jvlZ4BA ($28.60 in chips) 
Seat 5: tSR4329m40dZsN7YOpI9Kw ($29.55 in chips) 
Seat 6: qGHGf/553gQnDoklMRe3tg ($23.55 in chips) 
tSR4329m40dZsN7YOpI9Kw: posts small blind $0.10
qGHGf/553gQnDoklMRe3tg: posts big blind $0.25
*** HOLE CARDS ***
HipgaJhkN4ie/tTw4dK3Ug: folds 
4z7mPbMLNp4TezHXin63Vw: folds 
32YL2ZEp8NT4JB2RVM9euQ: folds 
/gJNBeCkWL4o85/jvlZ4BA: folds 
/gJNBeCkWL4o85/jvlZ4BA is sitting out
tSR4329m40dZsN7YOpI9Kw: folds 
Uncalled bet ($0.15) returned to qGHGf/553gQnDoklMRe3tg
/gJNBeCkWL4o85/jvlZ4BA has returned
qGHGf/553gQnDoklMRe3tg collected $0.20 from pot
qGHGf/553gQnDoklMRe3tg: doesn't show hand 
*** SUMMARY ***
Total pot $0.20 | Rake $0 
Seat 1: HipgaJhkN4ie/tTw4dK3Ug folded before Flop (didn't bet)
Seat 2: 4z7mPbMLNp4TezHXin63Vw folded before Flop (didn't bet)
Seat 3: 32YL2ZEp8NT4JB2RVM9euQ folded before Flop (didn't bet)
Seat 4: /gJNBeCkWL4o85/jvlZ4BA (button) folded before Flop (didn't bet)
Seat 5: tSR4329m40dZsN7YOpI9Kw (small blind) folded before Flop
Seat 6: qGHGf/553gQnDoklMRe3tg (big blind) collected ($0.20)




PokerStars Game #59941557000:  Hold'em No Limit ($0.10/$0.25) - 2009/07/01 1:39:04 ET
Table 'HzFR0rxmDAPu5GzYR0AlYg' 6-max Seat #3 is the button
Seat 1: v+QfkGiuj9bgtuNoVnDO8w ($29.60 in chips) 
Seat 2: UA5OsKS3VPaxa7uC8La/kA ($52.65 in chips) 
Seat 3: kG34n23qFQA3nzdOJTQ1dA ($24.65 in chips) 
Seat 4: 8tR2s7yV/Fr0ePp1w5XnJw ($10.10 in chips) 
Seat 5: lquriepNQBhDV5P1SWHhnA ($26.60 in chips) 
Seat 6: jp34e617tIzV8tKIWmfAbA ($38.85 in chips) 
8tR2s7yV/Fr0ePp1w5XnJw: posts small blind $0.10
lquriepNQBhDV5P1SWHhnA: posts big blind $0.25
*** HOLE CARDS ***
jp34e617tIzV8tKIWmfAbA: folds 
v+QfkGiuj9bgtuNoVnDO8w: folds 
UA5OsKS3VPaxa7uC8La/kA: raises $0.50 to $0.75
kG34n23qFQA3nzdOJTQ1dA: folds 
8tR2s7yV/Fr0ePp1w5XnJw: folds 
lquriepNQBhDV5P1SWHhnA: folds 
Uncalled bet ($0.50) returned to UA5OsKS3VPaxa7uC8La/kA
UA5OsKS3VPaxa7uC8La/kA collected $0.60 from pot
*** SUMMARY ***
Total pot $0.60 | Rake $0 
Seat 1: v+QfkGiuj9bgtuNoVnDO8w folded before Flop (didn't bet)
Seat 2: UA5OsKS3VPaxa7uC8La/kA collected ($0.60)
Seat 3: kG34n23qFQA3nzdOJTQ1dA (button) folded before Flop (didn't bet)
Seat 4: 8tR2s7yV/Fr0ePp1w5XnJw (small blind) folded before Flop
Seat 5: lquriepNQBhDV5P1SWHhnA (big blind) folded before Flop
Seat 6: jp34e617tIzV8tKIWmfAbA folded before Flop (didn't bet)




PokerStars Game #59941557058:  Hold'em No Limit ($0.10/$0.25) - 2009/07/01 1:39:04 ET
Table 'Mef6A0EMopL6WaFO5/KO9g' 6-max Seat #5 is the button
Seat 1: GbCVUNssQ7mqsPWr7J4d3w ($4.65 in chips) 
Seat 2: 8ClCHtFXGNplITm+63KB+Q ($32.65 in chips) 
Seat 3: Wq26opBLDGJe91GRJn2epg ($11.35 in chips) 
Seat 4: lquriepNQBhDV5P1SWHhnA ($25.45 in chips) 
Seat 5: DihMHaz4WNETH1bPDe13kA ($25 in chips) 
Seat 6: jp34e617tIzV8tKIWmfAbA ($33.75 in chips) 
jp34e617tIzV8tKIWmfAbA: posts small blind $0.10
GbCVUNssQ7mqsPWr7J4d3w: posts big blind $0.25
*** HOLE CARDS ***
8ClCHtFXGNplITm+63KB+Q: folds 
Wq26opBLDGJe91GRJn2epg: folds 
lquriepNQBhDV5P1SWHhnA: folds 
DihMHaz4WNETH1bPDe13kA: folds 
jp34e617tIzV8tKIWmfAbA: folds 
Uncalled bet ($0.15) returned to GbCVUNssQ7mqsPWr7J4d3w
GbCVUNssQ7mqsPWr7J4d3w collected $0.20 from pot
GbCVUNssQ7mqsPWr7J4d3w: doesn't show hand 
*** SUMMARY ***
Total pot $0.20 | Rake $0 
Seat 1: GbCVUNssQ7mqsPWr7J4d3w (big blind) collected ($0.20)
Seat 2: 8ClCHtFXGNplITm+63KB+Q folded before Flop (didn't bet)
Seat 3: Wq26opBLDGJe91GRJn2epg folded before Flop (didn't bet)
Seat 4: lquriepNQBhDV5P1SWHhnA folded before Flop (didn't bet)
Seat 5: DihMHaz4WNETH1bPDe13kA (button) folded before Flop (didn't bet)
Seat 6: jp34e617tIzV8tKIWmfAbA (small blind) folded before Flop




PokerStars Game #59941557318:  Hold'em No Limit ($0.10/$0.25) - 2009/07/01 1:39:04 ET
Table 'D1Yq70l0nNCyMV6DA42p+Q' 9-max Seat #2 is the button
Seat 1: z5GxcHlYz/GSz6W2uFiTtg ($19.05 in chips) 
Seat 2: zgi+EUykT/pZQpoUG6+oEg ($4.30 in chips) 
Seat 3: 9lvO/qyU+xrU95Teu1fv0g ($5.60 in chips) 
Seat 4: VWUWpMLMj/Q1jRVpF7Aohw ($18 in chips) 
Seat 5: gehe91e0IyVT0QU/XBkEyg ($25 in chips) 
Seat 6: wGigCmBR/9XWkPpvYos3aQ ($30.05 in chips) 
Seat 7: Lqytncc1Dsgt654eEBp/uw ($24.85 in chips) 
Seat 8: zDrucyjVn5aeekNEc3cJrA ($24.35 in chips) 
Seat 9: h5wEs8qXrBqfLa9GjaSBzg ($23.90 in chips) 
9lvO/qyU+xrU95Teu1fv0g: posts small blind $0.10
VWUWpMLMj/Q1jRVpF7Aohw: posts big blind $0.25
*** HOLE CARDS ***
gehe91e0IyVT0QU/XBkEyg: folds 
wGigCmBR/9XWkPpvYos3aQ: folds 
Lqytncc1Dsgt654eEBp/uw: raises $0.75 to $1
zDrucyjVn5aeekNEc3cJrA: folds 
h5wEs8qXrBqfLa9GjaSBzg: folds 
z5GxcHlYz/GSz6W2uFiTtg: folds 
zgi+EUykT/pZQpoUG6+oEg: folds 
9lvO/qyU+xrU95Teu1fv0g: folds 
VWUWpMLMj/Q1jRVpF7Aohw: calls $0.75
*** FLOP *** [Tc 9c 5d]
VWUWpMLMj/Q1jRVpF7Aohw: checks 
Lqytncc1Dsgt654eEBp/uw: bets $2
VWUWpMLMj/Q1jRVpF7Aohw: calls $2
*** TURN *** [Tc 9c 5d] [Ad]
VWUWpMLMj/Q1jRVpF7Aohw: checks 
Lqytncc1Dsgt654eEBp/uw: bets $3.75
VWUWpMLMj/Q1jRVpF7Aohw: calls $3.75
*** RIVER *** [Tc 9c 5d Ad] [Jh]
VWUWpMLMj/Q1jRVpF7Aohw: checks 
Lqytncc1Dsgt654eEBp/uw: checks 
*** SHOW DOWN ***
VWUWpMLMj/Q1jRVpF7Aohw: shows [8d 9d] (a pair of Nines)
Lqytncc1Dsgt654eEBp/uw: shows [Qh Qd] (a pair of Queens)
Lqytncc1Dsgt654eEBp/uw collected $12.95 from pot
*** SUMMARY ***
Total pot $13.60 | Rake $0.65 
Board [Tc 9c 5d Ad Jh]
Seat 1: z5GxcHlYz/GSz6W2uFiTtg folded before Flop (didn't bet)
Seat 2: zgi+EUykT/pZQpoUG6+oEg (button) folded before Flop (didn't bet)
Seat 3: 9lvO/qyU+xrU95Teu1fv0g (small blind) folded before Flop
Seat 4: VWUWpMLMj/Q1jRVpF7Aohw (big blind) showed [8d 9d] and lost with a pair of Nines
Seat 5: gehe91e0IyVT0QU/XBkEyg folded before Flop (didn't bet)
Seat 6: wGigCmBR/9XWkPpvYos3aQ folded before Flop (didn't bet)
Seat 7: Lqytncc1Dsgt654eEBp/uw showed [Qh Qd] and won ($12.95) with a pair of Queens
Seat 8: zDrucyjVn5aeekNEc3cJrA folded before Flop (didn't bet)
Seat 9: h5wEs8qXrBqfLa9GjaSBzg folded before Flop (didn't bet)




PokerStars Game #59941557694:  Hold'em No Limit ($0.10/$0.25) - 2009/07/01 1:39:05 ET
Table 'tErGGDyESv/0llKumVeZuQ' 9-max Seat #2 is the button
Seat 1: +S77koBCWg95nPIfEOrkUw ($15.75 in chips) 
Seat 2: pN3IHvAKm2fz+sTRARTcrg ($24.65 in chips) 
Seat 3: cFmpjvcjNoVAEAIQIxWkYg ($25 in chips) 
Seat 4: g7MXhRmNZxv1lIkKkUKa4w ($12.75 in chips) 
Seat 5: 6RQUxA3jk+ePxB/+Hc0IKw ($13.75 in chips) 
Seat 6: zDrucyjVn5aeekNEc3cJrA ($31.35 in chips) 
Seat 7: uhrboV251dcgYniYTdFIcA ($26.95 in chips) 
Seat 8: UD63hhjq5lMoGqYLFTcH1A ($32.25 in chips) 
Seat 9: d6n762oPkegG086ZJyV5MA ($18 in chips) 
cFmpjvcjNoVAEAIQIxWkYg: posts small blind $0.10
g7MXhRmNZxv1lIkKkUKa4w: posts big blind $0.25
*** HOLE CARDS ***
6RQUxA3jk+ePxB/+Hc0IKw: folds 
zDrucyjVn5aeekNEc3cJrA: folds 
uhrboV251dcgYniYTdFIcA: folds 
UD63hhjq5lMoGqYLFTcH1A: raises $0.50 to $0.75
d6n762oPkegG086ZJyV5MA: folds 
+S77koBCWg95nPIfEOrkUw: calls $0.75
pN3IHvAKm2fz+sTRARTcrg: folds 
cFmpjvcjNoVAEAIQIxWkYg: folds 
g7MXhRmNZxv1lIkKkUKa4w: calls $0.50
*** FLOP *** [3c Qd Qs]
g7MXhRmNZxv1lIkKkUKa4w: checks 
UD63hhjq5lMoGqYLFTcH1A: bets $2.50
+S77koBCWg95nPIfEOrkUw: folds 
g7MXhRmNZxv1lIkKkUKa4w: folds 
Uncalled bet ($2.50) returned to UD63hhjq5lMoGqYLFTcH1A
+S77koBCWg95nPIfEOrkUw leaves the table
UD63hhjq5lMoGqYLFTcH1A collected $2.25 from pot
UD63hhjq5lMoGqYLFTcH1A: doesn't show hand 
*** SUMMARY ***
Total pot $2.35 | Rake $0.10 
Board [3c Qd Qs]
Seat 1: +S77koBCWg95nPIfEOrkUw folded on the Flop
Seat 2: pN3IHvAKm2fz+sTRARTcrg (button) folded before Flop (didn't bet)
Seat 3: cFmpjvcjNoVAEAIQIxWkYg (small blind) folded before Flop
Seat 4: g7MXhRmNZxv1lIkKkUKa4w (big blind) folded on the Flop
Seat 5: 6RQUxA3jk+ePxB/+Hc0IKw folded before Flop (didn't bet)
Seat 6: zDrucyjVn5aeekNEc3cJrA folded before Flop (didn't bet)
Seat 7: uhrboV251dcgYniYTdFIcA folded before Flop (didn't bet)
Seat 8: UD63hhjq5lMoGqYLFTcH1A collected ($2.25)
Seat 9: d6n762oPkegG086ZJyV5MA folded before Flop (didn't bet)




PokerStars Game #59941557630:  Hold'em No Limit ($0.10/$0.25) - 2009/07/01 1:39:05 ET
Table 'pyZQRcpxhWj2y2cT/ydvww52Meibn9NOL4XtVi1p2Upwx Seat #8 is the button
Seat 1: egvg3mTBBVzMHnJPIQiKcA ($16.65 in chips) 
Seat 2: Th3FldXKQW6hWVVPahaoOQ ($98.45 in chips) 
Seat 3: zgi+EUykT/pZQpoUG6+oEg ($4.65 in chips) 
Seat 4: NjesyqE7PJi4nEOa0oOq9w ($15.40 in chips) 
Seat 5: 5n7e7I+px7c6CQmLpPbtsg ($4.75 in chips) 
Seat 6: 4awUyiDYTgylQKXZ9faBVA ($31.45 in chips) 
Seat 7: sGFnnRCa1YAHAUmWgsW6Qg ($9.75 in chips) 
Seat 8: ipgcO7Pa6LC8XWpVttZfnA ($5 in chips) 
Seat 9: bC+Wg1ntzw3N48OwuR1eag ($8 in chips) 
bC+Wg1ntzw3N48OwuR1eag is disconnected 
bC+Wg1ntzw3N48OwuR1eag is connected 
bC+Wg1ntzw3N48OwuR1eag: posts small blind $0.10
egvg3mTBBVzMHnJPIQiKcA: posts big blind $0.25
*** HOLE CARDS ***
Th3FldXKQW6hWVVPahaoOQ: folds 
zgi+EUykT/pZQpoUG6+oEg: folds 
NjesyqE7PJi4nEOa0oOq9w: calls $0.25
5n7e7I+px7c6CQmLpPbtsg: folds 
4awUyiDYTgylQKXZ9faBVA: folds 
sGFnnRCa1YAHAUmWgsW6Qg: calls $0.25
ipgcO7Pa6LC8XWpVttZfnA: folds 
bC+Wg1ntzw3N48OwuR1eag: calls $0.15
egvg3mTBBVzMHnJPIQiKcA: checks 
*** FLOP *** [6s 2s 8d]
bC+Wg1ntzw3N48OwuR1eag: checks 
egvg3mTBBVzMHnJPIQiKcA: checks 
NjesyqE7PJi4nEOa0oOq9w: bets $0.50
sGFnnRCa1YAHAUmWgsW6Qg: folds 
bC+Wg1ntzw3N48OwuR1eag: folds 
egvg3mTBBVzMHnJPIQiKcA: folds 
Uncalled bet ($0.50) returned to NjesyqE7PJi4nEOa0oOq9w
NjesyqE7PJi4nEOa0oOq9w collected $0.95 from pot
*** SUMMARY ***
Total pot $1 | Rake $0.05 
Board [6s 2s 8d]
Seat 1: egvg3mTBBVzMHnJPIQiKcA (big blind) folded on the Flop
Seat 2: Th3FldXKQW6hWVVPahaoOQ folded before Flop (didn't bet)
Seat 3: zgi+EUykT/pZQpoUG6+oEg folded before Flop (didn't bet)
Seat 4: NjesyqE7PJi4nEOa0oOq9w collected ($0.95)
Seat 5: 5n7e7I+px7c6CQmLpPbtsg folded before Flop (didn't bet)
Seat 6: 4awUyiDYTgylQKXZ9faBVA folded before Flop (didn't bet)
Seat 7: sGFnnRCa1YAHAUmWgsW6Qg folded on the Flop
Seat 8: ipgcO7Pa6LC8XWpVttZfnA (button) folded before Flop (didn't bet)
Seat 9: bC+Wg1ntzw3N48OwuR1eag (small blind) folded on the Flop




PokerStars Game #59941558014:  Hold'em No Limit ($0.10/$0.25) - 2009/07/01 1:39:05 ET
Table '+2VxGVfkEqJ1AYfQy/JH2w' 6-max Seat #2 is the button
Seat 2: qllppsCmUqovlriIWCeM/g ($1.95 in chips) 
Seat 3: NndRCAk4vU5JGDhTyy5LZg ($14.40 in chips) 
Seat 4: y+a/yGW/Jy4bPJFnaeTz5w ($17.45 in chips) 
Seat 5: XD1i5m5PvBDnRzJaG/vINw ($23.15 in chips) 
NndRCAk4vU5JGDhTyy5LZg: posts small blind $0.10
y+a/yGW/Jy4bPJFnaeTz5w: posts big blind $0.25
L3/N/gliETan8N5Gim5h4Q: sits out 
if4dh6jhJXeN3/qd3qCp9g: sits out 
*** HOLE CARDS ***
XD1i5m5PvBDnRzJaG/vINw: folds 
qllppsCmUqovlriIWCeM/g: folds 
NndRCAk4vU5JGDhTyy5LZg: calls $0.15
y+a/yGW/Jy4bPJFnaeTz5w: checks 
*** FLOP *** [4c Jc 6s]
NndRCAk4vU5JGDhTyy5LZg: bets $0.75
y+a/yGW/Jy4bPJFnaeTz5w: folds 
Uncalled bet ($0.75) returned to NndRCAk4vU5JGDhTyy5LZg
NndRCAk4vU5JGDhTyy5LZg collected $0.50 from pot
*** SUMMARY ***
Total pot $0.50 | Rake $0 
Board [4c Jc 6s]
Seat 2: qllppsCmUqovlriIWCeM/g (button) folded before Flop (didn't bet)
Seat 3: NndRCAk4vU5JGDhTyy5LZg (small blind) collected ($0.50)
Seat 4: y+a/yGW/Jy4bPJFnaeTz5w (big blind) folded on the Flop
Seat 5: XD1i5m5PvBDnRzJaG/vINw folded before Flop (didn't bet)




PokerStars Game #59941557582:  Hold'em No Limit ($0.10/$0.25) - 2009/07/01 1:39:05 ET
Table '3LMlz3V4AziGlU+ikmyU8w' 6-max Seat #4 is the button
Seat 1: Wxq4Qyj0DnDXj2+taEOJFQ ($19.75 in chips) 
Seat 2: uR3AbFJLoOX86DOTtTgGcg ($28.40 in chips) 
Seat 3: Hzy03WtPHMYwLYM7hTTxQw ($25.40 in chips) 
Seat 4: 6DwBRH+xZ12AAZmeAg+aXw ($24.55 in chips) 
Seat 5: tOAk1Og4mVObMBOfvdDYOw ($25.10 in chips) 
Seat 6: ZZm/rg8aThjE+A2LiItuzA ($1.45 in chips) 
tOAk1Og4mVObMBOfvdDYOw: posts small blind $0.10
ZZm/rg8aThjE+A2LiItuzA: posts big blind $0.25
*** HOLE CARDS ***
Wxq4Qyj0DnDXj2+taEOJFQ: calls $0.25
uR3AbFJLoOX86DOTtTgGcg: calls $0.25
Hzy03WtPHMYwLYM7hTTxQw: calls $0.25
6DwBRH+xZ12AAZmeAg+aXw: raises $1.25 to $1.50
tOAk1Og4mVObMBOfvdDYOw: folds 
ZZm/rg8aThjE+A2LiItuzA: folds 
Wxq4Qyj0DnDXj2+taEOJFQ: calls $1.25
uR3AbFJLoOX86DOTtTgGcg: calls $1.25
Hzy03WtPHMYwLYM7hTTxQw: calls $1.25
*** FLOP *** [7d 8c Ac]
Wxq4Qyj0DnDXj2+taEOJFQ: bets $1
uR3AbFJLoOX86DOTtTgGcg: calls $1
Hzy03WtPHMYwLYM7hTTxQw: folds 
6DwBRH+xZ12AAZmeAg+aXw: calls $1
*** TURN *** [7d 8c Ac] [Qs]
Wxq4Qyj0DnDXj2+taEOJFQ: bets $2
uR3AbFJLoOX86DOTtTgGcg: calls $2
6DwBRH+xZ12AAZmeAg+aXw: calls $2
*** RIVER *** [7d 8c Ac Qs] [Td]
Wxq4Qyj0DnDXj2+taEOJFQ: checks 
uR3AbFJLoOX86DOTtTgGcg: checks 
6DwBRH+xZ12AAZmeAg+aXw: checks 
*** SHOW DOWN ***
Wxq4Qyj0DnDXj2+taEOJFQ: shows [Qc Qh] (three of a kind, Queens)
uR3AbFJLoOX86DOTtTgGcg: mucks hand 
6DwBRH+xZ12AAZmeAg+aXw: mucks hand 
Wxq4Qyj0DnDXj2+taEOJFQ collected $14.65 from pot
*** SUMMARY ***
Total pot $15.35 | Rake $0.70 
Board [7d 8c Ac Qs Td]
Seat 1: Wxq4Qyj0DnDXj2+taEOJFQ showed [Qc Qh] and won ($14.65) with three of a kind, Queens
Seat 2: uR3AbFJLoOX86DOTtTgGcg mucked
Seat 3: Hzy03WtPHMYwLYM7hTTxQw folded on the Flop
Seat 4: 6DwBRH+xZ12AAZmeAg+aXw (button) mucked
Seat 5: tOAk1Og4mVObMBOfvdDYOw (small blind) folded before Flop
Seat 6: ZZm/rg8aThjE+A2LiItuzA (big blind) folded before Flop




PokerStars Game #59941558096:  Hold'em No Limit ($0.10/$0.25) - 2009/07/01 1:39:06 ET
Table 'VQNfcI8vTBCTvRfd3veTLQ' 6-max Seat #2 is the button
Seat 1: ymz+a8dgHSUFPooYplw7Ow ($13.45 in chips) 
Seat 2: 79ID/ub1Pt/mDpCprVmOoA ($26.95 in chips) 
Seat 3: LtASJ9OlkqGrrUKGQlpGAw ($13.10 in chips) 
Seat 4: QIWnfLSqfMcoFfdDe5LZPg ($41.05 in chips) 
Seat 5: gX2vbKwS/8zZPENAWB7hxQ ($24.90 in chips) 
Seat 6: LJI7A1YgDM7hgh7o56+ReQ ($27.35 in chips) 
LtASJ9OlkqGrrUKGQlpGAw: posts small blind $0.10
QIWnfLSqfMcoFfdDe5LZPg: posts big blind $0.25
*** HOLE CARDS ***
gX2vbKwS/8zZPENAWB7hxQ: calls $0.25
LJI7A1YgDM7hgh7o56+ReQ: folds 
ymz+a8dgHSUFPooYplw7Ow: folds 
ymz+a8dgHSUFPooYplw7Ow leaves the table
79ID/ub1Pt/mDpCprVmOoA: raises $0.75 to $1
LtASJ9OlkqGrrUKGQlpGAw: calls $0.90
QIWnfLSqfMcoFfdDe5LZPg: folds 
gX2vbKwS/8zZPENAWB7hxQ: calls $0.75
*** FLOP *** [4c 2s Kc]
LtASJ9OlkqGrrUKGQlpGAw: checks 
gX2vbKwS/8zZPENAWB7hxQ: checks 
79ID/ub1Pt/mDpCprVmOoA: checks 
*** TURN *** [4c 2s Kc] [As]
LtASJ9OlkqGrrUKGQlpGAw: checks 
gX2vbKwS/8zZPENAWB7hxQ: bets $1.25
79ID/ub1Pt/mDpCprVmOoA: calls $1.25
LtASJ9OlkqGrrUKGQlpGAw: folds 
*** RIVER *** [4c 2s Kc As] [7s]
gX2vbKwS/8zZPENAWB7hxQ: checks 
79ID/ub1Pt/mDpCprVmOoA: bets $3.50
gX2vbKwS/8zZPENAWB7hxQ: folds 
Uncalled bet ($3.50) returned to 79ID/ub1Pt/mDpCprVmOoA
79ID/ub1Pt/mDpCprVmOoA collected $5.50 from pot
79ID/ub1Pt/mDpCprVmOoA: doesn't show hand 
*** SUMMARY ***
Total pot $5.75 | Rake $0.25 
Board [4c 2s Kc As 7s]
Seat 1: ymz+a8dgHSUFPooYplw7Ow folded before Flop (didn't bet)
Seat 2: 79ID/ub1Pt/mDpCprVmOoA (button) collected ($5.50)
Seat 3: LtASJ9OlkqGrrUKGQlpGAw (small blind) folded on the Turn
Seat 4: QIWnfLSqfMcoFfdDe5LZPg (big blind) folded before Flop
Seat 5: gX2vbKwS/8zZPENAWB7hxQ folded on the River
Seat 6: LJI7A1YgDM7hgh7o56+ReQ folded before Flop (didn't bet)




PokerStars Game #59941558562:  Hold'em No Limit ($0.10/$0.25) - 2009/07/01 1:39:06 ET
Table 'Is9eNmJA1KnBOw0lcVkxUQ' 9-max Seat #2 is the button
Seat 1: 56S3mA6Zs3pGR+0p0vUCtg ($32 in chips) 
Seat 2: VllYilcih0t+gMD4GTRlgQ ($38.35 in chips) 
Seat 4: cZ99hugmLBj9KhTlc8nCSw ($25 in chips) 
Seat 6: HapyJHxV6lc3eqoT7yWL2A ($29.50 in chips) 
Seat 7: aNpwfA31EREwO+ar4XzBCw ($28.65 in chips) 
Seat 8: Th3FldXKQW6hWVVPahaoOQ ($25 in chips) 
Seat 9: DdPXdieucQ+n99u1n3A+rQ ($4.90 in chips) 
ubsjZomMWSV0hAiBLa7K1A will be allowed to play after the button
cZ99hugmLBj9KhTlc8nCSw: posts small blind $0.10
HapyJHxV6lc3eqoT7yWL2A: posts big blind $0.25
*** HOLE CARDS ***
aNpwfA31EREwO+ar4XzBCw: folds 
Th3FldXKQW6hWVVPahaoOQ: folds 
DdPXdieucQ+n99u1n3A+rQ: folds 
Dr.Hibbert55 joins the table at seat #5 
56S3mA6Zs3pGR+0p0vUCtg: folds 
VllYilcih0t+gMD4GTRlgQ: folds 
cZ99hugmLBj9KhTlc8nCSw: folds 
Uncalled bet ($0.15) returned to HapyJHxV6lc3eqoT7yWL2A
HapyJHxV6lc3eqoT7yWL2A collected $0.20 from pot
HapyJHxV6lc3eqoT7yWL2A: doesn't show hand 
*** SUMMARY ***
Total pot $0.20 | Rake $0 
Seat 1: 56S3mA6Zs3pGR+0p0vUCtg folded before Flop (didn't bet)
Seat 2: VllYilcih0t+gMD4GTRlgQ (button) folded before Flop (didn't bet)
Seat 4: cZ99hugmLBj9KhTlc8nCSw (small blind) folded before Flop
Seat 6: HapyJHxV6lc3eqoT7yWL2A (big blind) collected ($0.20)
Seat 7: aNpwfA31EREwO+ar4XzBCw folded before Flop (didn't bet)
Seat 8: Th3FldXKQW6hWVVPahaoOQ folded before Flop (didn't bet)
Seat 9: DdPXdieucQ+n99u1n3A+rQ folded before Flop (didn't bet)




PokerStars Game #59941558476:  Hold'em No Limit ($0.10/$0.25) - 2009/07/01 1:39:06 ET
Table 'rhQuIjJo0UQ7RRUlF9umHg' 6-max Seat #5 is the button
Seat 1: 5O3Hj9Qg0SqOyKEXoLpjPg ($94.10 in chips) 
Seat 2: Ew/TYPQIsbQ2X8nm5iAJBg ($49.20 in chips) 
Seat 3: if4dh6jhJXeN3/qd3qCp9g ($27.75 in chips) 
Seat 5: dOX4wnYV2sEqvDbF+8KSCw ($52 in chips) 
Seat 6: /gJNBeCkWL4o85/jvlZ4BA ($52.50 in chips) 
/gJNBeCkWL4o85/jvlZ4BA: posts small blind $0.10
5O3Hj9Qg0SqOyKEXoLpjPg: posts big blind $0.25
*** HOLE CARDS ***
Ew/TYPQIsbQ2X8nm5iAJBg: raises $0.50 to $0.75
if4dh6jhJXeN3/qd3qCp9g: folds 
buyjetgNT1McXtdaP4zynA has returned
dOX4wnYV2sEqvDbF+8KSCw: folds 
/gJNBeCkWL4o85/jvlZ4BA: folds 
5O3Hj9Qg0SqOyKEXoLpjPg: raises $0.50 to $1.25
Ew/TYPQIsbQ2X8nm5iAJBg: calls $0.50
*** FLOP *** [3s 9d 6h]
5O3Hj9Qg0SqOyKEXoLpjPg: bets $1
Ew/TYPQIsbQ2X8nm5iAJBg: calls $1
*** TURN *** [3s 9d 6h] [Ad]
5O3Hj9Qg0SqOyKEXoLpjPg: bets $1
Ew/TYPQIsbQ2X8nm5iAJBg: raises $2.25 to $3.25
5O3Hj9Qg0SqOyKEXoLpjPg: calls $2.25
*** RIVER *** [3s 9d 6h Ad] [7c]
5O3Hj9Qg0SqOyKEXoLpjPg: bets $0.50
Ew/TYPQIsbQ2X8nm5iAJBg: raises $6.25 to $6.75
5O3Hj9Qg0SqOyKEXoLpjPg: calls $6.25
*** SHOW DOWN ***
Ew/TYPQIsbQ2X8nm5iAJBg: shows [Jh Qh] (high card Ace)
5O3Hj9Qg0SqOyKEXoLpjPg: shows [Qd Kd] (high card Ace - King kicker)
5O3Hj9Qg0SqOyKEXoLpjPg collected $23.40 from pot
*** SUMMARY ***
Total pot $24.60 | Rake $1.20 
Board [3s 9d 6h Ad 7c]
Seat 1: 5O3Hj9Qg0SqOyKEXoLpjPg (big blind) showed [Qd Kd] and won ($23.40) with high card Ace
Seat 2: Ew/TYPQIsbQ2X8nm5iAJBg showed [Jh Qh] and lost with high card Ace
Seat 3: if4dh6jhJXeN3/qd3qCp9g folded before Flop (didn't bet)
Seat 5: dOX4wnYV2sEqvDbF+8KSCw (button) folded before Flop (didn't bet)
Seat 6: /gJNBeCkWL4o85/jvlZ4BA (small blind) folded before Flop




PokerStars Game #59941558312:  Hold'em No Limit ($0.10/$0.25) - 2009/07/01 1:39:06 ET
Table 'isKy4XK8wJM0x735/D4hWA' 6-max Seat #3 is the button
Seat 1: kwsRmpZ1ZaLooISs+zfyKg ($26.05 in chips) 
Seat 2: 6elpmfyt4Zw0yvd8lePSMQ ($20.55 in chips) 
Seat 3: jp34e617tIzV8tKIWmfAbA ($44.40 in chips) 
Seat 4: DFi/Lzkjsfv8QswS80JX9Q ($30.85 in chips) 
Seat 5: lquriepNQBhDV5P1SWHhnA ($25.95 in chips) 
DFi/Lzkjsfv8QswS80JX9Q: posts small blind $0.10
lquriepNQBhDV5P1SWHhnA: posts big blind $0.25
GbCVUNssQ7mqsPWr7J4d3w: sits out 
*** HOLE CARDS ***
kwsRmpZ1ZaLooISs+zfyKg: calls $0.25
6elpmfyt4Zw0yvd8lePSMQ: folds 
jp34e617tIzV8tKIWmfAbA: calls $0.25
DFi/Lzkjsfv8QswS80JX9Q: folds 
lquriepNQBhDV5P1SWHhnA: checks 
*** FLOP *** [Kd Ah 2s]
lquriepNQBhDV5P1SWHhnA: checks 
kwsRmpZ1ZaLooISs+zfyKg: checks 
jp34e617tIzV8tKIWmfAbA: bets $0.50
lquriepNQBhDV5P1SWHhnA: folds 
kwsRmpZ1ZaLooISs+zfyKg: folds 
Uncalled bet ($0.50) returned to jp34e617tIzV8tKIWmfAbA
jp34e617tIzV8tKIWmfAbA collected $0.85 from pot
*** SUMMARY ***
Total pot $0.85 | Rake $0 
Board [Kd Ah 2s]
Seat 1: kwsRmpZ1ZaLooISs+zfyKg folded on the Flop
Seat 2: 6elpmfyt4Zw0yvd8lePSMQ folded before Flop (didn't bet)
Seat 3: jp34e617tIzV8tKIWmfAbA (button) collected ($0.85)
Seat 4: DFi/Lzkjsfv8QswS80JX9Q (small blind) folded before Flop
Seat 5: lquriepNQBhDV5P1SWHhnA (big blind) folded on the Flop




PokerStars Game #59941558294:  Hold'em No Limit ($0.10/$0.25) - 2009/07/01 1:39:06 ET
Table 'n8mNkPYbe1AIQEkioNesZA' 9-max Seat #9 is the button
Seat 1: 9lvO/qyU+xrU95Teu1fv0g ($5.65 in chips) 
Seat 2: QEbIGci+itdw+re8RM5fZA ($30.40 in chips) 
Seat 3: zDrucyjVn5aeekNEc3cJrA ($19.35 in chips) 
Seat 4: zgi+EUykT/pZQpoUG6+oEg ($5.35 in chips) 
Seat 5: wGigCmBR/9XWkPpvYos3aQ ($29.15 in chips) 
Seat 6: HPEB+AtKw1+C/cxU0o1ciw ($46.55 in chips) 
Seat 7: sGFnnRCa1YAHAUmWgsW6Qg ($10 in chips) 
Seat 8: aNpwfA31EREwO+ar4XzBCw ($25 in chips) 
Seat 9: gehe91e0IyVT0QU/XBkEyg ($27.55 in chips) 
9lvO/qyU+xrU95Teu1fv0g: posts small blind $0.10
QEbIGci+itdw+re8RM5fZA: posts big blind $0.25
*** HOLE CARDS ***
zDrucyjVn5aeekNEc3cJrA: folds 
zgi+EUykT/pZQpoUG6+oEg: folds 
wGigCmBR/9XWkPpvYos3aQ: folds 
HPEB+AtKw1+C/cxU0o1ciw: folds 
sGFnnRCa1YAHAUmWgsW6Qg: folds 
aNpwfA31EREwO+ar4XzBCw: raises $0.75 to $1
gehe91e0IyVT0QU/XBkEyg: folds 
9lvO/qyU+xrU95Teu1fv0g: folds 
QEbIGci+itdw+re8RM5fZA: folds 
Uncalled bet ($0.75) returned to aNpwfA31EREwO+ar4XzBCw
aNpwfA31EREwO+ar4XzBCw collected $0.60 from pot
aNpwfA31EREwO+ar4XzBCw: doesn't show hand 
*** SUMMARY ***
Total pot $0.60 | Rake $0 
Seat 1: 9lvO/qyU+xrU95Teu1fv0g (small blind) folded before Flop
Seat 2: QEbIGci+itdw+re8RM5fZA (big blind) folded before Flop
Seat 3: zDrucyjVn5aeekNEc3cJrA folded before Flop (didn't bet)
Seat 4: zgi+EUykT/pZQpoUG6+oEg folded before Flop (didn't bet)
Seat 5: wGigCmBR/9XWkPpvYos3aQ folded before Flop (didn't bet)
Seat 6: HPEB+AtKw1+C/cxU0o1ciw folded before Flop (didn't bet)
Seat 7: sGFnnRCa1YAHAUmWgsW6Qg folded before Flop (didn't bet)
Seat 8: aNpwfA31EREwO+ar4XzBCw collected ($0.60)
Seat 9: gehe91e0IyVT0QU/XBkEyg (button) folded before Flop (didn't bet)




PokerStars Game #59941559050:  Hold'em No Limit ($0.10/$0.25) - 2009/07/01 1:39:07 ET
Table '8Z6T3ssCpo3VV849U4RgBw' 9-max Seat #5 is the button
Seat 1: 8dNQBtNvCvzVgSnmDgi/LA ($15.70 in chips) 
Seat 2: SpiiQQAzy4MUgV3I5W8giw ($25.35 in chips) 
Seat 3: tLcDklc2rBORNfixyRfVfw ($41.50 in chips) 
Seat 4: RCqMONFrSPSArZh2Jsar/w ($18.90 in chips) 
Seat 5: zDrucyjVn5aeekNEc3cJrA ($16 in chips) 
Seat 6: sGFnnRCa1YAHAUmWgsW6Qg ($9.25 in chips) 
Seat 7: oLa/tXLfSLLB28mcLGrxcg ($24.40 in chips) 
Seat 8: PdIasPkzm2sqZnN41ZRXOg ($5 in chips) 
Seat 9: HDDm1BkZtdsRyw2DJdqq6A ($21.70 in chips) 
sGFnnRCa1YAHAUmWgsW6Qg: posts small blind $0.10
oLa/tXLfSLLB28mcLGrxcg: posts big blind $0.25
*** HOLE CARDS ***
PdIasPkzm2sqZnN41ZRXOg: folds 
HDDm1BkZtdsRyw2DJdqq6A: folds 
8dNQBtNvCvzVgSnmDgi/LA: raises $0.50 to $0.75
SpiiQQAzy4MUgV3I5W8giw: folds 
tLcDklc2rBORNfixyRfVfw: folds 
RCqMONFrSPSArZh2Jsar/w: folds 
zDrucyjVn5aeekNEc3cJrA: folds 
sGFnnRCa1YAHAUmWgsW6Qg: folds 
oLa/tXLfSLLB28mcLGrxcg: folds 
Uncalled bet ($0.50) returned to 8dNQBtNvCvzVgSnmDgi/LA
8dNQBtNvCvzVgSnmDgi/LA collected $0.60 from pot
*** SUMMARY ***
Total pot $0.60 | Rake $0 
Seat 1: 8dNQBtNvCvzVgSnmDgi/LA collected ($0.60)
Seat 2: SpiiQQAzy4MUgV3I5W8giw folded before Flop (didn't bet)
Seat 3: tLcDklc2rBORNfixyRfVfw folded before Flop (didn't bet)
Seat 4: RCqMONFrSPSArZh2Jsar/w folded before Flop (didn't bet)
Seat 5: zDrucyjVn5aeekNEc3cJrA (button) folded before Flop (didn't bet)
Seat 6: sGFnnRCa1YAHAUmWgsW6Qg (small blind) folded before Flop
Seat 7: oLa/tXLfSLLB28mcLGrxcg (big blind) folded before Flop
Seat 8: PdIasPkzm2sqZnN41ZRXOg folded before Flop (didn't bet)
Seat 9: HDDm1BkZtdsRyw2DJdqq6A folded before Flop (didn't bet)




PokerStars Game #59941558700:  Hold'em No Limit ($0.10/$0.25) - 2009/07/01 1:39:07 ET
Table '4mnXP0EWt9mMZYzTIVDQ0w' 9-max Seat #4 is the button
Seat 1: Z5y2J55JmfLYR6/DPAGHwQ ($24 in chips) 
Seat 2: BLEU2x2bnGRovIelAY6slA ($24.80 in chips) 
Seat 4: 9lvO/qyU+xrU95Teu1fv0g ($3.80 in chips) 
Seat 5: sSN8Y0AlsBeidZXPKmwXSw ($26.20 in chips) 
Seat 6: 5yjzPss7Y4kAWNDat3e0yQ ($29.45 in chips) 
Seat 7: OiV1PWZ3IkN29JlmCcnTwQ ($5.85 in chips) 
Seat 8: 9YN2IkT2JYYKFErZtZvCtA ($21.85 in chips) 
Seat 9: QcmMXyv063LEIFA6k/PHBQ ($2.75 in chips) 
sSN8Y0AlsBeidZXPKmwXSw: posts small blind $0.10
5yjzPss7Y4kAWNDat3e0yQ: posts big blind $0.25
*** HOLE CARDS ***
OiV1PWZ3IkN29JlmCcnTwQ: folds 
9YN2IkT2JYYKFErZtZvCtA: folds 
QcmMXyv063LEIFA6k/PHBQ: calls $0.25
Z5y2J55JmfLYR6/DPAGHwQ: folds 
BLEU2x2bnGRovIelAY6slA: calls $0.25
9lvO/qyU+xrU95Teu1fv0g: calls $0.25
sSN8Y0AlsBeidZXPKmwXSw: calls $0.15
5yjzPss7Y4kAWNDat3e0yQ: checks 
*** FLOP *** [2h Tc 9s]
sSN8Y0AlsBeidZXPKmwXSw: checks 
9YN2IkT2JYYKFErZtZvCtA said, "should have seen the hand i flopped on the other table =P"
9YN2IkT2JYYKFErZtZvCtA said, "ace high full boat"
5yjzPss7Y4kAWNDat3e0yQ: checks 
QcmMXyv063LEIFA6k/PHBQ: bets $0.50
BLEU2x2bnGRovIelAY6slA: folds 
9lvO/qyU+xrU95Teu1fv0g: raises $0.75 to $1.25
sSN8Y0AlsBeidZXPKmwXSw: folds 
5yjzPss7Y4kAWNDat3e0yQ: folds 
QcmMXyv063LEIFA6k/PHBQ: calls $0.75
*** TURN *** [2h Tc 9s] [7h]
QcmMXyv063LEIFA6k/PHBQ: bets $1.25 and is all-in
9lvO/qyU+xrU95Teu1fv0g: calls $1.25
*** RIVER *** [2h Tc 9s 7h] [5c]
*** SHOW DOWN ***
QcmMXyv063LEIFA6k/PHBQ: shows [8c Qh] (high card Queen)
9lvO/qyU+xrU95Teu1fv0g: shows [Jh Td] (a pair of Tens)
9lvO/qyU+xrU95Teu1fv0g collected $5.95 from pot
*** SUMMARY ***
Total pot $6.25 | Rake $0.30 
Board [2h Tc 9s 7h 5c]
Seat 1: Z5y2J55JmfLYR6/DPAGHwQ folded before Flop (didn't bet)
Seat 2: BLEU2x2bnGRovIelAY6slA folded on the Flop
Seat 4: 9lvO/qyU+xrU95Teu1fv0g (button) showed [Jh Td] and won ($5.95) with a pair of Tens
Seat 5: sSN8Y0AlsBeidZXPKmwXSw (small blind) folded on the Flop
Seat 6: 5yjzPss7Y4kAWNDat3e0yQ (big blind) folded on the Flop
Seat 7: OiV1PWZ3IkN29JlmCcnTwQ folded before Flop (didn't bet)
Seat 8: 9YN2IkT2JYYKFErZtZvCtA folded before Flop (didn't bet)
Seat 9: QcmMXyv063LEIFA6k/PHBQ showed [8c Qh] and lost with high card Queen




PokerStars Game #59941558974:  Hold'em No Limit ($0.10/$0.25) - 2009/07/01 1:39:07 ET
Table 'mF3KHGMaTpaBZbtBoyfTeg' 6-max Seat #6 is the button
Seat 1: 0HAB2GdCAM7p7V00xueAVQ ($25.40 in chips) 
Seat 2: 6qsh9pnysDKJNhfFhFmKRQ ($9.75 in chips) 
Seat 3: 9kUKGKkblnIx3m8rlVol6Q ($13.50 in chips) 
Seat 4: FYepjhAvF8ZdVCmqHIy+eQ ($25 in chips) 
Seat 5: 8ClCHtFXGNplITm+63KB+Q ($43.75 in chips) 
Seat 6: kG34n23qFQA3nzdOJTQ1dA ($27.75 in chips) 
0HAB2GdCAM7p7V00xueAVQ: posts small blind $0.10
6qsh9pnysDKJNhfFhFmKRQ: posts big blind $0.25
*** HOLE CARDS ***
9kUKGKkblnIx3m8rlVol6Q: raises $0.50 to $0.75
FYepjhAvF8ZdVCmqHIy+eQ: folds 
8ClCHtFXGNplITm+63KB+Q: calls $0.75
kG34n23qFQA3nzdOJTQ1dA: folds 
0HAB2GdCAM7p7V00xueAVQ: folds 
6qsh9pnysDKJNhfFhFmKRQ: folds 
*** FLOP *** [Kd Qd 9d]
9kUKGKkblnIx3m8rlVol6Q: checks 
8ClCHtFXGNplITm+63KB+Q: checks 
*** TURN *** [Kd Qd 9d] [2d]
9kUKGKkblnIx3m8rlVol6Q: bets $0.50
8ClCHtFXGNplITm+63KB+Q: calls $0.50
*** RIVER *** [Kd Qd 9d 2d] [9s]
9kUKGKkblnIx3m8rlVol6Q: checks 
8ClCHtFXGNplITm+63KB+Q: checks 
*** SHOW DOWN ***
9kUKGKkblnIx3m8rlVol6Q: shows [Tc Ad] (a flush, Ace high)
8ClCHtFXGNplITm+63KB+Q: mucks hand 
9kUKGKkblnIx3m8rlVol6Q collected $2.75 from pot
*** SUMMARY ***
Total pot $2.85 | Rake $0.10 
Board [Kd Qd 9d 2d 9s]
Seat 1: 0HAB2GdCAM7p7V00xueAVQ (small blind) folded before Flop
Seat 2: 6qsh9pnysDKJNhfFhFmKRQ (big blind) folded before Flop
Seat 3: 9kUKGKkblnIx3m8rlVol6Q showed [Tc Ad] and won ($2.75) with a flush, Ace high
Seat 4: FYepjhAvF8ZdVCmqHIy+eQ folded before Flop (didn't bet)
Seat 5: 8ClCHtFXGNplITm+63KB+Q mucked
Seat 6: kG34n23qFQA3nzdOJTQ1dA (button) folded before Flop (didn't bet)




PokerStars Game #59941558928:  Hold'em No Limit ($0.10/$0.25) - 2009/07/01 1:39:07 ET
Table 'fIMYcWwN4/aXFJvH5Z8Ymg' 6-max Seat #5 is the button
Seat 1: DihMHaz4WNETH1bPDe13kA ($25.35 in chips) 
Seat 2: vu2kzHaDtgr6NM7rdq0chA ($26.80 in chips) 
Seat 3: bWbV4MVB/vVpiES1Ut4hew ($107.10 in chips) 
Seat 4: 32YL2ZEp8NT4JB2RVM9euQ ($42.75 in chips) 
Seat 5: lquriepNQBhDV5P1SWHhnA ($25 in chips) 
Seat 6: jp34e617tIzV8tKIWmfAbA ($27.65 in chips) 
jp34e617tIzV8tKIWmfAbA: posts small blind $0.10
DihMHaz4WNETH1bPDe13kA: posts big blind $0.25
bWbV4MVB/vVpiES1Ut4hew: posts small blind $0.10
*** HOLE CARDS ***
vu2kzHaDtgr6NM7rdq0chA: folds 
bWbV4MVB/vVpiES1Ut4hew: folds 
32YL2ZEp8NT4JB2RVM9euQ: folds 
lquriepNQBhDV5P1SWHhnA: folds 
jp34e617tIzV8tKIWmfAbA: raises $0.50 to $0.75
DihMHaz4WNETH1bPDe13kA: folds 
Uncalled bet ($0.50) returned to jp34e617tIzV8tKIWmfAbA
jp34e617tIzV8tKIWmfAbA collected $0.60 from pot
jp34e617tIzV8tKIWmfAbA: doesn't show hand 
*** SUMMARY ***
Total pot $0.60 | Rake $0 
Seat 1: DihMHaz4WNETH1bPDe13kA (big blind) folded before Flop
Seat 2: vu2kzHaDtgr6NM7rdq0chA folded before Flop (didn't bet)
Seat 3: bWbV4MVB/vVpiES1Ut4hew folded before Flop
Seat 4: 32YL2ZEp8NT4JB2RVM9euQ folded before Flop (didn't bet)
Seat 5: lquriepNQBhDV5P1SWHhnA (button) folded before Flop (didn't bet)
Seat 6: jp34e617tIzV8tKIWmfAbA (small blind) collected ($0.60)




PokerStars Game #59941559274:  Hold'em No Limit ($0.10/$0.25) - 2009/07/01 1:39:08 ET
Table 'HIOfhT0zga/KonFhIl6O3w' 9-max Seat #2 is the button
Seat 1: oLa/tXLfSLLB28mcLGrxcg ($24.90 in chips) 
Seat 2: er86weqXTpTB6/w2dKlYgA ($17.10 in chips) 
Seat 4: qwr38jl5txoR36M7G5qi4A ($8.90 in chips) 
Seat 5: K1MDeapSEyKyGPNZGOKfEg ($37.85 in chips) 
Seat 6: cZ99hugmLBj9KhTlc8nCSw ($25.85 in chips) 
Seat 7: wvlPJBB0PtYkfeeSRDaIvQ ($13.80 in chips) 
Seat 8: V6p0jQ/RhUsqpHLmXvEX4Q ($12.25 in chips) 
Seat 9: dfNim92Z6XK1/h5SFW5vDg ($28.35 in chips) 
qwr38jl5txoR36M7G5qi4A: posts small blind $0.10
K1MDeapSEyKyGPNZGOKfEg: posts big blind $0.25
*** HOLE CARDS ***
cZ99hugmLBj9KhTlc8nCSw: folds 
cZ99hugmLBj9KhTlc8nCSw leaves the table
wvlPJBB0PtYkfeeSRDaIvQ: folds 
V6p0jQ/RhUsqpHLmXvEX4Q: folds 
dfNim92Z6XK1/h5SFW5vDg: folds 
oLa/tXLfSLLB28mcLGrxcg: folds 
er86weqXTpTB6/w2dKlYgA: folds 
qwr38jl5txoR36M7G5qi4A: calls $0.15
K1MDeapSEyKyGPNZGOKfEg: checks 
*** FLOP *** [2h Kc 8c]
qwr38jl5txoR36M7G5qi4A: checks 
K1MDeapSEyKyGPNZGOKfEg: checks 
*** TURN *** [2h Kc 8c] [5c]
qwr38jl5txoR36M7G5qi4A: checks 
K1MDeapSEyKyGPNZGOKfEg: checks 
*** RIVER *** [2h Kc 8c 5c] [Js]
qwr38jl5txoR36M7G5qi4A: checks 
K1MDeapSEyKyGPNZGOKfEg: checks 
*** SHOW DOWN ***
qwr38jl5txoR36M7G5qi4A: shows [5s 4s] (a pair of Fives)
K1MDeapSEyKyGPNZGOKfEg: shows [8s 9s] (a pair of Eights)
K1MDeapSEyKyGPNZGOKfEg collected $0.50 from pot
MThMMgdB293VOucmN9sliQ joins the table at seat #6 
*** SUMMARY ***
Total pot $0.50 | Rake $0 
Board [2h Kc 8c 5c Js]
Seat 1: oLa/tXLfSLLB28mcLGrxcg folded before Flop (didn't bet)
Seat 2: er86weqXTpTB6/w2dKlYgA (button) folded before Flop (didn't bet)
Seat 4: qwr38jl5txoR36M7G5qi4A (small blind) showed [5s 4s] and lost with a pair of Fives
Seat 5: K1MDeapSEyKyGPNZGOKfEg (big blind) showed [8s 9s] and won ($0.50) with a pair of Eights
Seat 6: cZ99hugmLBj9KhTlc8nCSw folded before Flop (didn't bet)
Seat 7: wvlPJBB0PtYkfeeSRDaIvQ folded before Flop (didn't bet)
Seat 8: V6p0jQ/RhUsqpHLmXvEX4Q folded before Flop (didn't bet)
Seat 9: dfNim92Z6XK1/h5SFW5vDg folded before Flop (didn't bet)




PokerStars Game #59941559560:  Hold'em No Limit ($0.10/$0.25) - 2009/07/01 1:39:08 ET
Table 'nXVbUw6/HYwA6x21+IZ3XQ' 9-max Seat #9 is the button
Seat 1: zDrucyjVn5aeekNEc3cJrA ($17.35 in chips) 
Seat 2: 9lvO/qyU+xrU95Teu1fv0g ($5 in chips) 
Seat 3: 7je+LC5Mfs6nL8YBVh4frQ ($5.60 in chips) 
Seat 4: H5Se03ZqSX7tbULXur2MAg ($24.70 in chips) 
Seat 5: M/9j4wkHH9i1JM51vgi1VA ($28.70 in chips) 
Seat 6: ljemhp25Zg+nlA9DLCIiUw ($26.75 in chips) 
Seat 7: ShCS62CJp4MKfKLKvGKQbA ($12.50 in chips) 
Seat 8: dfNim92Z6XK1/h5SFW5vDg ($27.15 in chips) 
Seat 9: OTCjTlu92MEBtX/i9Gm7yA ($12.30 in chips) 
zDrucyjVn5aeekNEc3cJrA: posts small blind $0.10
9lvO/qyU+xrU95Teu1fv0g: posts big blind $0.25
*** HOLE CARDS ***
7je+LC5Mfs6nL8YBVh4frQ: folds 
H5Se03ZqSX7tbULXur2MAg: folds 
M/9j4wkHH9i1JM51vgi1VA: folds 
ljemhp25Zg+nlA9DLCIiUw: folds 
ShCS62CJp4MKfKLKvGKQbA: folds 
dfNim92Z6XK1/h5SFW5vDg: folds 
OTCjTlu92MEBtX/i9Gm7yA: calls $0.25
zDrucyjVn5aeekNEc3cJrA: calls $0.15
9lvO/qyU+xrU95Teu1fv0g: checks 
*** FLOP *** [Qd 2d Kh]
zDrucyjVn5aeekNEc3cJrA: checks 
9lvO/qyU+xrU95Teu1fv0g: checks 
OTCjTlu92MEBtX/i9Gm7yA: bets $0.50
zDrucyjVn5aeekNEc3cJrA: folds 
9lvO/qyU+xrU95Teu1fv0g: folds 
Uncalled bet ($0.50) returned to OTCjTlu92MEBtX/i9Gm7yA
OTCjTlu92MEBtX/i9Gm7yA collected $0.75 from pot
OTCjTlu92MEBtX/i9Gm7yA: doesn't show hand 
*** SUMMARY ***
Total pot $0.75 | Rake $0 
Board [Qd 2d Kh]
Seat 1: zDrucyjVn5aeekNEc3cJrA (small blind) folded on the Flop
Seat 2: 9lvO/qyU+xrU95Teu1fv0g (big blind) folded on the Flop
Seat 3: 7je+LC5Mfs6nL8YBVh4frQ folded before Flop (didn't bet)
Seat 4: H5Se03ZqSX7tbULXur2MAg folded before Flop (didn't bet)
Seat 5: M/9j4wkHH9i1JM51vgi1VA folded before Flop (didn't bet)
Seat 6: ljemhp25Zg+nlA9DLCIiUw folded before Flop (didn't bet)
Seat 7: ShCS62CJp4MKfKLKvGKQbA folded before Flop (didn't bet)
Seat 8: dfNim92Z6XK1/h5SFW5vDg folded before Flop (didn't bet)
Seat 9: OTCjTlu92MEBtX/i9Gm7yA (button) collected ($0.75)




PokerStars Game #59941559246:  Hold'em No Limit ($0.10/$0.25) - 2009/07/01 1:39:08 ET
Table 'KTZXQ4LREPjpS54R3DFTsw' 9-max Seat #6 is the button
Seat 1: dSjkBIV7Bv+ZCIWNBguf7w ($40.75 in chips) 
Seat 2: 6LFELL8V3NTpb0xg7AOyEg ($11.55 in chips) 
Seat 3: H5Se03ZqSX7tbULXur2MAg ($23.65 in chips) 
Seat 4: K0b5wNInj6hUGRr6yzKFtw ($64 in chips) 
Seat 5: HPEB+AtKw1+C/cxU0o1ciw ($30.45 in chips) 
Seat 6: Mh2r9hTeTEDnh19sRZtW3g ($5.70 in chips) 
Seat 7: yyG4svzOpC1A+sUP/scg6w ($11.05 in chips) 
Seat 8: X1ucS3BHyBPongKl1Q+eEQ ($14.45 in chips) 
Seat 9: V6p0jQ/RhUsqpHLmXvEX4Q ($12.35 in chips) 
yyG4svzOpC1A+sUP/scg6w: posts small blind $0.10
X1ucS3BHyBPongKl1Q+eEQ: posts big blind $0.25
*** HOLE CARDS ***
V6p0jQ/RhUsqpHLmXvEX4Q: folds 
dSjkBIV7Bv+ZCIWNBguf7w: calls $0.25
6LFELL8V3NTpb0xg7AOyEg: calls $0.25
H5Se03ZqSX7tbULXur2MAg: folds 
K0b5wNInj6hUGRr6yzKFtw: folds 
HPEB+AtKw1+C/cxU0o1ciw: calls $0.25
Mh2r9hTeTEDnh19sRZtW3g: folds 
yyG4svzOpC1A+sUP/scg6w: folds 
X1ucS3BHyBPongKl1Q+eEQ: checks 
*** FLOP *** [4s 6d Th]
X1ucS3BHyBPongKl1Q+eEQ: checks 
dSjkBIV7Bv+ZCIWNBguf7w: checks 
6LFELL8V3NTpb0xg7AOyEg: checks 
HPEB+AtKw1+C/cxU0o1ciw: checks 
*** TURN *** [4s 6d Th] [Td]
X1ucS3BHyBPongKl1Q+eEQ: checks 
dSjkBIV7Bv+ZCIWNBguf7w: checks 
6LFELL8V3NTpb0xg7AOyEg: checks 
HPEB+AtKw1+C/cxU0o1ciw: checks 
*** RIVER *** [4s 6d Th Td] [2h]
X1ucS3BHyBPongKl1Q+eEQ: bets $0.50
dSjkBIV7Bv+ZCIWNBguf7w: folds 
6LFELL8V3NTpb0xg7AOyEg: folds 
HPEB+AtKw1+C/cxU0o1ciw: folds 
Uncalled bet ($0.50) returned to X1ucS3BHyBPongKl1Q+eEQ
X1ucS3BHyBPongKl1Q+eEQ collected $1.05 from pot
X1ucS3BHyBPongKl1Q+eEQ: doesn't show hand 
*** SUMMARY ***
Total pot $1.10 | Rake $0.05 
Board [4s 6d Th Td 2h]
Seat 1: dSjkBIV7Bv+ZCIWNBguf7w folded on the River
Seat 2: 6LFELL8V3NTpb0xg7AOyEg folded on the River
Seat 3: H5Se03ZqSX7tbULXur2MAg folded before Flop (didn't bet)
Seat 4: K0b5wNInj6hUGRr6yzKFtw folded before Flop (didn't bet)
Seat 5: HPEB+AtKw1+C/cxU0o1ciw folded on the River
Seat 6: Mh2r9hTeTEDnh19sRZtW3g (button) folded before Flop (didn't bet)
Seat 7: yyG4svzOpC1A+sUP/scg6w (small blind) folded before Flop
Seat 8: X1ucS3BHyBPongKl1Q+eEQ (big blind) collected ($1.05)
Seat 9: V6p0jQ/RhUsqpHLmXvEX4Q folded before Flop (didn't bet)




PokerStars Game #59941559336:  Hold'em No Limit ($0.10/$0.25) - 2009/07/01 1:39:08 ET
Table '1zj0+miaIL9cvwnT/50pOA' 9-max Seat #6 is the button
Seat 1: PVxvfRTRvkgZf9WtquEkwQ ($25.70 in chips) 
Seat 2: HPEB+AtKw1+C/cxU0o1ciw ($43.30 in chips) 
Seat 3: dtZ84flFEi4Q+SGrHMJRDQ ($28.60 in chips) 
Seat 4: PdIasPkzm2sqZnN41ZRXOg ($5 in chips) 
Seat 5: 57qrNGHDvf6GhB8zVLsAtQ ($4.35 in chips) 
Seat 6: YZaC69gFrepA6oCGtu7E0w ($28.80 in chips) 
Seat 7: 6RiVTYll/5D8zICp0MRpKw ($24.75 in chips) 
Seat 8: Ihhh49x48fayPIyvl2Rsmg ($30.40 in chips) 
Seat 9: AyqFvLFzJDE7yMbXP362BA ($31.25 in chips) 
6RiVTYll/5D8zICp0MRpKw: posts small blind $0.10
Ihhh49x48fayPIyvl2Rsmg: posts big blind $0.25
*** HOLE CARDS ***
AyqFvLFzJDE7yMbXP362BA: folds 
PVxvfRTRvkgZf9WtquEkwQ: folds 
HPEB+AtKw1+C/cxU0o1ciw: folds 
dtZ84flFEi4Q+SGrHMJRDQ: folds 
PdIasPkzm2sqZnN41ZRXOg: folds 
57qrNGHDvf6GhB8zVLsAtQ: folds 
YZaC69gFrepA6oCGtu7E0w: raises $0.25 to $0.50
6RiVTYll/5D8zICp0MRpKw: folds 
Ihhh49x48fayPIyvl2Rsmg: calls $0.25
*** FLOP *** [Ts Ac 7d]
Ihhh49x48fayPIyvl2Rsmg: checks 
YZaC69gFrepA6oCGtu7E0w: checks 
*** TURN *** [Ts Ac 7d] [4d]
Ihhh49x48fayPIyvl2Rsmg: checks 
YZaC69gFrepA6oCGtu7E0w: bets $0.50
Ihhh49x48fayPIyvl2Rsmg: calls $0.50
*** RIVER *** [Ts Ac 7d 4d] [8c]
Ihhh49x48fayPIyvl2Rsmg: checks 
YZaC69gFrepA6oCGtu7E0w: bets $1
Ihhh49x48fayPIyvl2Rsmg: calls $1
*** SHOW DOWN ***
YZaC69gFrepA6oCGtu7E0w: shows [Ad 7h] (two pair, Aces and Sevens)
Ihhh49x48fayPIyvl2Rsmg: mucks hand 
YZaC69gFrepA6oCGtu7E0w collected $3.90 from pot
*** SUMMARY ***
Total pot $4.10 | Rake $0.20 
Board [Ts Ac 7d 4d 8c]
Seat 1: PVxvfRTRvkgZf9WtquEkwQ folded before Flop (didn't bet)
Seat 2: HPEB+AtKw1+C/cxU0o1ciw folded before Flop (didn't bet)
Seat 3: dtZ84flFEi4Q+SGrHMJRDQ folded before Flop (didn't bet)
Seat 4: PdIasPkzm2sqZnN41ZRXOg folded before Flop (didn't bet)
Seat 5: 57qrNGHDvf6GhB8zVLsAtQ folded before Flop (didn't bet)
Seat 6: YZaC69gFrepA6oCGtu7E0w (button) showed [Ad 7h] and won ($3.90) with two pair, Aces and Sevens
Seat 7: 6RiVTYll/5D8zICp0MRpKw (small blind) folded before Flop
Seat 8: Ihhh49x48fayPIyvl2Rsmg (big blind) mucked
Seat 9: AyqFvLFzJDE7yMbXP362BA folded before Flop (didn't bet)




PokerStars Game #59941559820:  Hold'em No Limit ($0.10/$0.25) - 2009/07/01 1:39:09 ET
Table '/VaaaFnlEJoYVomG9uxHkA' 9-max Seat #4 is the button
Seat 1: Th3FldXKQW6hWVVPahaoOQ ($26 in chips) 
Seat 2: DIkeSkosO/tsUp9d2JVyTA ($57.40 in chips) 
Seat 3: MtVtHDqIJTyUcXkRBBDIVA ($25.90 in chips) 
Seat 4: j4q3p0lesp63b1gZDwLBZw ($5 in chips) 
Seat 5: cZ99hugmLBj9KhTlc8nCSw ($25.60 in chips) 
Seat 6: qxWFg3MZuVyidB0SJh5ywg ($34.85 in chips) 
Seat 7: F7pnn6czNpHvRM55XcA2EA ($25.85 in chips) 
Seat 8: dfNim92Z6XK1/h5SFW5vDg ($46.25 in chips) 
Seat 9: qpG9m8I+cPw8VhB0mnGjYw ($25.35 in chips) 
cZ99hugmLBj9KhTlc8nCSw: posts small blind $0.10
qxWFg3MZuVyidB0SJh5ywg: posts big blind $0.25
*** HOLE CARDS ***
F7pnn6czNpHvRM55XcA2EA: folds 
dfNim92Z6XK1/h5SFW5vDg: folds 
qpG9m8I+cPw8VhB0mnGjYw: calls $0.25
Th3FldXKQW6hWVVPahaoOQ: folds 
DIkeSkosO/tsUp9d2JVyTA: folds 
MtVtHDqIJTyUcXkRBBDIVA: calls $0.25
j4q3p0lesp63b1gZDwLBZw: folds 
cZ99hugmLBj9KhTlc8nCSw: folds 
qxWFg3MZuVyidB0SJh5ywg: checks 
*** FLOP *** [3d Jc 6d]
qxWFg3MZuVyidB0SJh5ywg: checks 
qpG9m8I+cPw8VhB0mnGjYw: checks 
MtVtHDqIJTyUcXkRBBDIVA: bets $0.75
qxWFg3MZuVyidB0SJh5ywg: folds 
qpG9m8I+cPw8VhB0mnGjYw: folds 
Uncalled bet ($0.75) returned to MtVtHDqIJTyUcXkRBBDIVA
MtVtHDqIJTyUcXkRBBDIVA collected $0.85 from pot
MtVtHDqIJTyUcXkRBBDIVA: doesn't show hand 
*** SUMMARY ***
Total pot $0.85 | Rake $0 
Board [3d Jc 6d]
Seat 1: Th3FldXKQW6hWVVPahaoOQ folded before Flop (didn't bet)
Seat 2: DIkeSkosO/tsUp9d2JVyTA folded before Flop (didn't bet)
Seat 3: MtVtHDqIJTyUcXkRBBDIVA collected ($0.85)
Seat 4: j4q3p0lesp63b1gZDwLBZw (button) folded before Flop (didn't bet)
Seat 5: cZ99hugmLBj9KhTlc8nCSw (small blind) folded before Flop
Seat 6: qxWFg3MZuVyidB0SJh5ywg (big blind) folded on the Flop
Seat 7: F7pnn6czNpHvRM55XcA2EA folded before Flop (didn't bet)
Seat 8: dfNim92Z6XK1/h5SFW5vDg folded before Flop (didn't bet)
Seat 9: qpG9m8I+cPw8VhB0mnGjYw folded on the Flop




PokerStars Game #59941559914:  Hold'em No Limit ($0.10/$0.25) - 2009/07/01 1:39:09 ET
Table '+fuYjvJy9okLr23QyZtanA' 9-max Seat #3 is the button
Seat 1: l9hUFnOCgg4TPYga9bvxhw ($10.70 in chips) 
Seat 2: tLcDklc2rBORNfixyRfVfw ($25.10 in chips) 
Seat 3: eK8qa6EPcH2zhtbmWSvc9g ($52.30 in chips) 
Seat 4: Bb42QRQMhg5/Y0vHP8/2Xw ($30.60 in chips) 
Seat 5: bXpVeaSTPBFSPJmeXxO7nw ($5 in chips) 
Seat 6: wGigCmBR/9XWkPpvYos3aQ ($25 in chips) 
Seat 7: dfNim92Z6XK1/h5SFW5vDg ($27.45 in chips) 
Seat 8: qpG9m8I+cPw8VhB0mnGjYw ($17.75 in chips) 
Seat 9: OMhlmt2waO3z43ZSFNMmog ($29.15 in chips) 
Bb42QRQMhg5/Y0vHP8/2Xw: posts small blind $0.10
bXpVeaSTPBFSPJmeXxO7nw: posts big blind $0.25
*** HOLE CARDS ***
wGigCmBR/9XWkPpvYos3aQ: raises $0.65 to $0.90
dfNim92Z6XK1/h5SFW5vDg: calls $0.90
qpG9m8I+cPw8VhB0mnGjYw: folds 
OMhlmt2waO3z43ZSFNMmog: folds 
l9hUFnOCgg4TPYga9bvxhw: folds 
tLcDklc2rBORNfixyRfVfw: folds 
eK8qa6EPcH2zhtbmWSvc9g: folds 
Bb42QRQMhg5/Y0vHP8/2Xw: folds 
bXpVeaSTPBFSPJmeXxO7nw: folds 
*** FLOP *** [4s 3s 7s]
wGigCmBR/9XWkPpvYos3aQ: bets $1.50
dfNim92Z6XK1/h5SFW5vDg: folds 
Uncalled bet ($1.50) returned to wGigCmBR/9XWkPpvYos3aQ
wGigCmBR/9XWkPpvYos3aQ collected $2.05 from pot
wGigCmBR/9XWkPpvYos3aQ: doesn't show hand 
*** SUMMARY ***
Total pot $2.15 | Rake $0.10 
Board [4s 3s 7s]
Seat 1: l9hUFnOCgg4TPYga9bvxhw folded before Flop (didn't bet)
Seat 2: tLcDklc2rBORNfixyRfVfw folded before Flop (didn't bet)
Seat 3: eK8qa6EPcH2zhtbmWSvc9g (button) folded before Flop (didn't bet)
Seat 4: Bb42QRQMhg5/Y0vHP8/2Xw (small blind) folded before Flop
Seat 5: bXpVeaSTPBFSPJmeXxO7nw (big blind) folded before Flop
Seat 6: wGigCmBR/9XWkPpvYos3aQ collected ($2.05)
Seat 7: dfNim92Z6XK1/h5SFW5vDg folded on the Flop
Seat 8: qpG9m8I+cPw8VhB0mnGjYw folded before Flop (didn't bet)
Seat 9: OMhlmt2waO3z43ZSFNMmog folded before Flop (didn't bet)




PokerStars Game #59941559682:  Hold'em No Limit ($0.10/$0.25) - 2009/07/01 1:39:09 ET
Table 'pPgW4R3kdH26lLi1MnE92w' 9-max Seat #4 is the button
Seat 1: F4P6SxCNY4vxdb318G9RwA ($20.60 in chips) 
Seat 2: cZ99hugmLBj9KhTlc8nCSw ($27.50 in chips) 
Seat 3: WaS7+xnv4bIVHoru6nxczA ($13.05 in chips) 
Seat 4: 68iMVGMbYGvnpcCiPOVbbw ($4.65 in chips) 
Seat 5: HPEB+AtKw1+C/cxU0o1ciw ($21.80 in chips) 
Seat 6: VllYilcih0t+gMD4GTRlgQ ($26.40 in chips) 
Seat 7: sD+TKtt36XiiN6jqHiLwDA ($27.05 in chips) 
Seat 8: aCVg6cCxQcqClhB9nq/p1w ($31.20 in chips) 
HPEB+AtKw1+C/cxU0o1ciw: posts small blind $0.10
VllYilcih0t+gMD4GTRlgQ: posts big blind $0.25
*** HOLE CARDS ***
sD+TKtt36XiiN6jqHiLwDA: calls $0.25
aCVg6cCxQcqClhB9nq/p1w: folds 
F4P6SxCNY4vxdb318G9RwA: folds 
cZ99hugmLBj9KhTlc8nCSw: folds 
WaS7+xnv4bIVHoru6nxczA: calls $0.25
68iMVGMbYGvnpcCiPOVbbw: folds 
HPEB+AtKw1+C/cxU0o1ciw: calls $0.15
VllYilcih0t+gMD4GTRlgQ: checks 
*** FLOP *** [7h Kc 8h]
HPEB+AtKw1+C/cxU0o1ciw: checks 
VllYilcih0t+gMD4GTRlgQ: checks 
sD+TKtt36XiiN6jqHiLwDA: checks 
WaS7+xnv4bIVHoru6nxczA: bets $0.50
HPEB+AtKw1+C/cxU0o1ciw: folds 
VllYilcih0t+gMD4GTRlgQ: folds 
sD+TKtt36XiiN6jqHiLwDA: folds 
Uncalled bet ($0.50) returned to WaS7+xnv4bIVHoru6nxczA
WaS7+xnv4bIVHoru6nxczA collected $0.95 from pot
*** SUMMARY ***
Total pot $1 | Rake $0.05 
Board [7h Kc 8h]
Seat 1: F4P6SxCNY4vxdb318G9RwA folded before Flop (didn't bet)
Seat 2: cZ99hugmLBj9KhTlc8nCSw folded before Flop (didn't bet)
Seat 3: WaS7+xnv4bIVHoru6nxczA collected ($0.95)
Seat 4: 68iMVGMbYGvnpcCiPOVbbw (button) folded before Flop (didn't bet)
Seat 5: HPEB+AtKw1+C/cxU0o1ciw (small blind) folded on the Flop
Seat 6: VllYilcih0t+gMD4GTRlgQ (big blind) folded on the Flop
Seat 7: sD+TKtt36XiiN6jqHiLwDA folded on the Flop
Seat 8: aCVg6cCxQcqClhB9nq/p1w folded before Flop (didn't bet)




PokerStars Game #59941559932:  Hold'em No Limit ($0.10/$0.25) - 2009/07/01 1:39:09 ET
Table 'axb9RsG8Zj1A0LEukTeFrQ' 9-max Seat #4 is the button
Seat 1: qwr38jl5txoR36M7G5qi4A ($8.85 in chips) 
Seat 2: zDrucyjVn5aeekNEc3cJrA ($19.75 in chips) 
Seat 3: H5Se03ZqSX7tbULXur2MAg ($24.75 in chips) 
Seat 4: tLcDklc2rBORNfixyRfVfw ($27.45 in chips) 
Seat 5: rLSSHKOHnb6yzVfDoQM/RA ($15.20 in chips) 
Seat 7: PdIasPkzm2sqZnN41ZRXOg ($5 in chips) 
Seat 8: VBHxUExRAMrbxUq/cVx9Gw ($4.65 in chips) 
Seat 9: qbQE8CifKB4+OEvNF/61Rw ($55.50 in chips) 
rLSSHKOHnb6yzVfDoQM/RA: posts small blind $0.10
DdPXdieucQ+n99u1n3A+rQ: is sitting out 
DdPXdieucQ+n99u1n3A+rQ leaves the table
PdIasPkzm2sqZnN41ZRXOg: posts big blind $0.25
*** HOLE CARDS ***
VBHxUExRAMrbxUq/cVx9Gw: folds 
qbQE8CifKB4+OEvNF/61Rw: folds 
qwr38jl5txoR36M7G5qi4A: folds 
zDrucyjVn5aeekNEc3cJrA: folds 
H5Se03ZqSX7tbULXur2MAg: raises $0.75 to $1
tLcDklc2rBORNfixyRfVfw: folds 
rLSSHKOHnb6yzVfDoQM/RA: folds 
PdIasPkzm2sqZnN41ZRXOg: folds 
Uncalled bet ($0.75) returned to H5Se03ZqSX7tbULXur2MAg
H5Se03ZqSX7tbULXur2MAg collected $0.60 from pot
zDrucyjVn5aeekNEc3cJrA is sitting out
*** SUMMARY ***
Total pot $0.60 | Rake $0 
Seat 1: qwr38jl5txoR36M7G5qi4A folded before Flop (didn't bet)
Seat 2: zDrucyjVn5aeekNEc3cJrA folded before Flop (didn't bet)
Seat 3: H5Se03ZqSX7tbULXur2MAg collected ($0.60)
Seat 4: tLcDklc2rBORNfixyRfVfw (button) folded before Flop (didn't bet)
Seat 5: rLSSHKOHnb6yzVfDoQM/RA (small blind) folded before Flop
Seat 7: PdIasPkzm2sqZnN41ZRXOg (big blind) folded before Flop
Seat 8: VBHxUExRAMrbxUq/cVx9Gw folded before Flop (didn't bet)
Seat 9: qbQE8CifKB4+OEvNF/61Rw folded before Flop (didn't bet)




PokerStars Game #59941560132:  Hold'em No Limit ($0.10/$0.25) - 2009/07/01 1:39:09 ET
Table '2vH5RcmkT0F4XNS/EmmyMA' 6-max Seat #3 is the button
Seat 1: hOaWAImn5/MZDAWAPlYHCw ($5.80 in chips) 
Seat 2: W6Y6au0wf7gRAlqJYgOezw ($12.75 in chips) 
Seat 3: t8P79jKZYh/Wpx2V73pSqg ($26.50 in chips) 
Seat 4: FC6tJ9EOiutXO8hnpR4VgQ ($5.85 in chips) 
Seat 5: Hsvkc0/G2VV78oVmWYXecw ($5 in chips) 
FC6tJ9EOiutXO8hnpR4VgQ: posts small blind $0.10
Hsvkc0/G2VV78oVmWYXecw: posts big blind $0.25
if4dh6jhJXeN3/qd3qCp9g: sits out 
*** HOLE CARDS ***
hOaWAImn5/MZDAWAPlYHCw: folds 
W6Y6au0wf7gRAlqJYgOezw: raises $0.50 to $0.75
t8P79jKZYh/Wpx2V73pSqg: folds 
FC6tJ9EOiutXO8hnpR4VgQ: folds 
Hsvkc0/G2VV78oVmWYXecw: folds 
Uncalled bet ($0.50) returned to W6Y6au0wf7gRAlqJYgOezw
W6Y6au0wf7gRAlqJYgOezw collected $0.60 from pot
W6Y6au0wf7gRAlqJYgOezw: doesn't show hand 
*** SUMMARY ***
Total pot $0.60 | Rake $0 
Seat 1: hOaWAImn5/MZDAWAPlYHCw folded before Flop (didn't bet)
Seat 2: W6Y6au0wf7gRAlqJYgOezw collected ($0.60)
Seat 3: t8P79jKZYh/Wpx2V73pSqg (button) folded before Flop (didn't bet)
Seat 4: FC6tJ9EOiutXO8hnpR4VgQ (small blind) folded before Flop
Seat 5: Hsvkc0/G2VV78oVmWYXecw (big blind) folded before Flop




PokerStars Game #59941559882:  Hold'em No Limit ($0.10/$0.25) - 2009/07/01 1:39:09 ET
Table 'SHi8+hK6i7E2dJ/3Agbyig' 6-max Seat #5 is the button
Seat 1: gPEN9Zp33YTm/mu9/SYP1w ($30.70 in chips) 
Seat 2: LJI7A1YgDM7hgh7o56+ReQ ($29.15 in chips) 
Seat 3: P1Z7LWu+VU+WmJsI4mr0wA ($24.75 in chips) 
Seat 5: v8m8XHovI5tqEA9mvplDSw ($53.80 in chips) 
Seat 6: cWc85bEzdRzpUMhRKm8pwQ ($25 in chips) 
cWc85bEzdRzpUMhRKm8pwQ: posts small blind $0.10
gPEN9Zp33YTm/mu9/SYP1w: posts big blind $0.25
*** HOLE CARDS ***
v8m8XHovI5tqEA9mvplDSw said, "idiot"
LJI7A1YgDM7hgh7o56+ReQ: folds 
jesovijo leaves the table
P1Z7LWu+VU+WmJsI4mr0wA: folds 
v8m8XHovI5tqEA9mvplDSw: folds 
cWc85bEzdRzpUMhRKm8pwQ: folds 
Uncalled bet ($0.15) returned to gPEN9Zp33YTm/mu9/SYP1w
gPEN9Zp33YTm/mu9/SYP1w collected $0.20 from pot
*** SUMMARY ***
Total pot $0.20 | Rake $0 
Seat 1: gPEN9Zp33YTm/mu9/SYP1w (big blind) collected ($0.20)
Seat 2: LJI7A1YgDM7hgh7o56+ReQ folded before Flop (didn't bet)
Seat 3: P1Z7LWu+VU+WmJsI4mr0wA folded before Flop (didn't bet)
Seat 5: v8m8XHovI5tqEA9mvplDSw (button) folded before Flop (didn't bet)
Seat 6: cWc85bEzdRzpUMhRKm8pwQ (small blind) folded before Flop




PokerStars Game #59941559718:  Hold'em No Limit ($0.10/$0.25) - 2009/07/01 1:39:09 ET
Table 'FE/j6VqBY4j9Uq+VHURQCQ' 6-max Seat #1 is the button
Seat 1: ypmjhffk/YHGc51wgVXUTw ($40.85 in chips) 
Seat 2: 3zD3qLXT1bEffAoWGnc7wg ($40.60 in chips) 
Seat 3: lBoEwOFgzcERLIRUkUoRTw ($27.75 in chips) 
Seat 4: 7JyPCA0J2grhXQYxe1h3+A ($21.95 in chips) 
Seat 5: 4x9jCqgSw4272dnaIqnanw ($8.05 in chips) 
Seat 6: rpJ2ie+vculq8yrHlngRHQ ($18.45 in chips) 
3zD3qLXT1bEffAoWGnc7wg: posts small blind $0.10
lBoEwOFgzcERLIRUkUoRTw: posts big blind $0.25
*** HOLE CARDS ***
7JyPCA0J2grhXQYxe1h3+A: folds 
4x9jCqgSw4272dnaIqnanw: calls $0.25
rpJ2ie+vculq8yrHlngRHQ: raises $0.75 to $1
ypmjhffk/YHGc51wgVXUTw: folds 
3zD3qLXT1bEffAoWGnc7wg: folds 
lBoEwOFgzcERLIRUkUoRTw: calls $0.75
4x9jCqgSw4272dnaIqnanw: folds 
*** FLOP *** [9d 6c 4h]
lBoEwOFgzcERLIRUkUoRTw: checks 
rpJ2ie+vculq8yrHlngRHQ: bets $2.25
lBoEwOFgzcERLIRUkUoRTw: folds 
Uncalled bet ($2.25) returned to rpJ2ie+vculq8yrHlngRHQ
rpJ2ie+vculq8yrHlngRHQ collected $2.25 from pot
rpJ2ie+vculq8yrHlngRHQ: doesn't show hand 
*** SUMMARY ***
Total pot $2.35 | Rake $0.10 
Board [9d 6c 4h]
Seat 1: ypmjhffk/YHGc51wgVXUTw (button) folded before Flop (didn't bet)
Seat 2: 3zD3qLXT1bEffAoWGnc7wg (small blind) folded before Flop
Seat 3: lBoEwOFgzcERLIRUkUoRTw (big blind) folded on the Flop
Seat 4: 7JyPCA0J2grhXQYxe1h3+A folded before Flop (didn't bet)
Seat 5: 4x9jCqgSw4272dnaIqnanw folded before Flop
Seat 6: rpJ2ie+vculq8yrHlngRHQ collected ($2.25)




PokerStars Game #59941559912:  Hold'em No Limit ($0.10/$0.25) - 2009/07/01 1:39:09 ET
Table 'zW+7jPbOLCvlPu+dUGY5WQ' 6-max Seat #3 is the button
Seat 1: eL3+wCBjFGfQ5FMdIZihwA ($25 in chips) 
Seat 2: cEMJmfAUQZmMChZe6aacKw ($8 in chips) 
Seat 3: 2G0C7dp4wlPpE21FHjjElQ ($32.85 in chips) 
Seat 4: i48129QFpEQQ+UN4aNtmww ($10.95 in chips) 
Seat 5: 5nwDw10uIM0XEyLhla0oGA ($35.10 in chips) 
Seat 6: qGHGf/553gQnDoklMRe3tg ($27.05 in chips) 
i48129QFpEQQ+UN4aNtmww: posts small blind $0.10
5nwDw10uIM0XEyLhla0oGA: posts big blind $0.25
*** HOLE CARDS ***
qGHGf/553gQnDoklMRe3tg: raises $0.75 to $1
eL3+wCBjFGfQ5FMdIZihwA: folds 
cEMJmfAUQZmMChZe6aacKw: folds 
2G0C7dp4wlPpE21FHjjElQ: folds 
i48129QFpEQQ+UN4aNtmww: folds 
5nwDw10uIM0XEyLhla0oGA: calls $0.75
*** FLOP *** [3d 7h 9s]
5nwDw10uIM0XEyLhla0oGA: checks 
qGHGf/553gQnDoklMRe3tg: checks 
*** TURN *** [3d 7h 9s] [Ah]
5nwDw10uIM0XEyLhla0oGA: checks 
qGHGf/553gQnDoklMRe3tg: bets $1.50
5nwDw10uIM0XEyLhla0oGA: calls $1.50
*** RIVER *** [3d 7h 9s Ah] [4h]
5nwDw10uIM0XEyLhla0oGA: bets $4.50
qGHGf/553gQnDoklMRe3tg: calls $4.50
*** SHOW DOWN ***
5nwDw10uIM0XEyLhla0oGA: shows [Qh 5h] (a flush, Ace high)
qGHGf/553gQnDoklMRe3tg: mucks hand 
5nwDw10uIM0XEyLhla0oGA collected $13.45 from pot
*** SUMMARY ***
Total pot $14.10 | Rake $0.65 
Board [3d 7h 9s Ah 4h]
Seat 1: eL3+wCBjFGfQ5FMdIZihwA folded before Flop (didn't bet)
Seat 2: cEMJmfAUQZmMChZe6aacKw folded before Flop (didn't bet)
Seat 3: 2G0C7dp4wlPpE21FHjjElQ (button) folded before Flop (didn't bet)
Seat 4: i48129QFpEQQ+UN4aNtmww (small blind) folded before Flop
Seat 5: 5nwDw10uIM0XEyLhla0oGA (big blind) showed [Qh 5h] and won ($13.45) with a flush, Ace high
Seat 6: qGHGf/553gQnDoklMRe3tg mucked




PokerStars Game #59941560446:  Hold'em No Limit ($0.10/$0.25) - 2009/07/01 1:39:10 ET
Table '5SUMWYuPsGiOD0FY0QbgOw' 6-max Seat #5 is the button
Seat 1: SFmT9ZsVopnukjvAzrxTRg ($25 in chips) 
Seat 2: xrf8tAXKQHG99HixCot1Iw ($37.70 in chips) 
Seat 3: MqMK8OWPSY1V4stf1Hy5Jw ($32.25 in chips) 
Seat 4: BV+K0Phf5VBHr7aZPKqbUQ ($25.35 in chips) 
Seat 5: v+QfkGiuj9bgtuNoVnDO8w ($40.75 in chips) 
Seat 6: jA7YMtfNUnAaebB7Lj74EA ($24.55 in chips) 
jA7YMtfNUnAaebB7Lj74EA: posts small blind $0.10
SFmT9ZsVopnukjvAzrxTRg: posts big blind $0.25
*** HOLE CARDS ***
xrf8tAXKQHG99HixCot1Iw: raises $0.50 to $0.75
MqMK8OWPSY1V4stf1Hy5Jw: folds 
BV+K0Phf5VBHr7aZPKqbUQ: folds 
v+QfkGiuj9bgtuNoVnDO8w: folds 
jA7YMtfNUnAaebB7Lj74EA: folds 
SFmT9ZsVopnukjvAzrxTRg: folds 
Uncalled bet ($0.50) returned to xrf8tAXKQHG99HixCot1Iw
xrf8tAXKQHG99HixCot1Iw collected $0.60 from pot
xrf8tAXKQHG99HixCot1Iw: doesn't show hand 
*** SUMMARY ***
Total pot $0.60 | Rake $0 
Seat 1: SFmT9ZsVopnukjvAzrxTRg (big blind) folded before Flop
Seat 2: xrf8tAXKQHG99HixCot1Iw collected ($0.60)
Seat 3: MqMK8OWPSY1V4stf1Hy5Jw folded before Flop (didn't bet)
Seat 4: BV+K0Phf5VBHr7aZPKqbUQ folded before Flop (didn't bet)
Seat 5: v+QfkGiuj9bgtuNoVnDO8w (button) folded before Flop (didn't bet)
Seat 6: jA7YMtfNUnAaebB7Lj74EA (small blind) folded before Flop




PokerStars Game #59941560712:  Hold'em No Limit ($0.10/$0.25) - 2009/07/01 1:39:10 ET
Table '60nA7av6bws9VnNmVwculA' 6-max Seat #2 is the button
Seat 1: if4dh6jhJXeN3/qd3qCp9g ($26.75 in chips) 
Seat 2: Bada343Si4xKu3fNXY99AA ($4.15 in chips) 
Seat 3: OUv909q/YxsJgxpSlZxLJQ ($30.60 in chips) 
Seat 4: +baiVgI/ETnBARLe5mARCw ($15 in chips) 
Seat 5: zXh+lOT41Q2iWgCNj+OcRw ($11.65 in chips) 
Seat 6: mfrkWA3PTeYPkbO6hi98Aw ($24.65 in chips) 
OUv909q/YxsJgxpSlZxLJQ: posts small blind $0.10
+baiVgI/ETnBARLe5mARCw: posts big blind $0.25
*** HOLE CARDS ***
zXh+lOT41Q2iWgCNj+OcRw: folds 
mfrkWA3PTeYPkbO6hi98Aw: folds 
if4dh6jhJXeN3/qd3qCp9g: raises $0.50 to $0.75
Bada343Si4xKu3fNXY99AA: folds 
OUv909q/YxsJgxpSlZxLJQ: folds 
+baiVgI/ETnBARLe5mARCw: folds 
Uncalled bet ($0.50) returned to if4dh6jhJXeN3/qd3qCp9g
if4dh6jhJXeN3/qd3qCp9g collected $0.60 from pot
if4dh6jhJXeN3/qd3qCp9g: doesn't show hand 
*** SUMMARY ***
Total pot $0.60 | Rake $0 
Seat 1: if4dh6jhJXeN3/qd3qCp9g collected ($0.60)
Seat 2: Bada343Si4xKu3fNXY99AA (button) folded before Flop (didn't bet)
Seat 3: OUv909q/YxsJgxpSlZxLJQ (small blind) folded before Flop
Seat 4: +baiVgI/ETnBARLe5mARCw (big blind) folded before Flop
Seat 5: zXh+lOT41Q2iWgCNj+OcRw folded before Flop (didn't bet)
Seat 6: mfrkWA3PTeYPkbO6hi98Aw folded before Flop (didn't bet)




PokerStars Game #59941560794:  Hold'em No Limit ($0.10/$0.25) - 2009/07/01 1:39:11 ET
Table 'IIO2q2znuuAXmiZ2qFTcmg' 6-max Seat #1 is the button
Seat 1: 2G0C7dp4wlPpE21FHjjElQ ($25 in chips) 
Seat 2: cS21pIxRHx5Gt42o7hPZzw ($13.05 in chips) 
Seat 3: L3/N/gliETan8N5Gim5h4Q ($25 in chips) 
Seat 4: tSR4329m40dZsN7YOpI9Kw ($59.60 in chips) 
Seat 5: GJsS3gwVwlbyroaWrnjqJg ($35.25 in chips) 
Seat 6: aogAb4Eienxztk8p2v9VVw ($35.65 in chips) 
cS21pIxRHx5Gt42o7hPZzw: posts small blind $0.10
L3/N/gliETan8N5Gim5h4Q: posts big blind $0.25
*** HOLE CARDS ***
tSR4329m40dZsN7YOpI9Kw: folds 
GJsS3gwVwlbyroaWrnjqJg: folds 
aogAb4Eienxztk8p2v9VVw has timed out while being disconnected
aogAb4Eienxztk8p2v9VVw: folds 
aogAb4Eienxztk8p2v9VVw is sitting out
aogAb4Eienxztk8p2v9VVw is disconnected 
2G0C7dp4wlPpE21FHjjElQ: folds 
cS21pIxRHx5Gt42o7hPZzw: folds 
Uncalled bet ($0.15) returned to L3/N/gliETan8N5Gim5h4Q
L3/N/gliETan8N5Gim5h4Q collected $0.20 from pot
L3/N/gliETan8N5Gim5h4Q: doesn't show hand 
*** SUMMARY ***
Total pot $0.20 | Rake $0 
Seat 1: 2G0C7dp4wlPpE21FHjjElQ (button) folded before Flop (didn't bet)
Seat 2: cS21pIxRHx5Gt42o7hPZzw (small blind) folded before Flop
Seat 3: L3/N/gliETan8N5Gim5h4Q (big blind) collected ($0.20)
Seat 4: tSR4329m40dZsN7YOpI9Kw folded before Flop (didn't bet)
Seat 5: GJsS3gwVwlbyroaWrnjqJg folded before Flop (didn't bet)
Seat 6: aogAb4Eienxztk8p2v9VVw folded before Flop (didn't bet)




PokerStars Game #59941560830:  Hold'em No Limit ($0.10/$0.25) - 2009/07/01 1:39:11 ET
Table 'APEHQjIcZHDZUA4iOjju2g' 6-max Seat #1 is the button
Seat 1: DE9hRlt14g+JdsRQ4wT7hg ($29.85 in chips) 
Seat 2: 3zD3qLXT1bEffAoWGnc7wg ($44.45 in chips) 
Seat 3: 3e/idKqDuPE10t6Zvr//SQ ($25 in chips) 
Seat 4: w2mQ4VsGljGwWXydz8tw2A ($18.50 in chips) 
Seat 5: /xN6gc9+8Hew0HxaB6VIVg ($43.90 in chips) 
Seat 6: KXtdqb+rIMkjc0RvHDksGQ ($22.60 in chips) 
3zD3qLXT1bEffAoWGnc7wg: posts small blind $0.10
3e/idKqDuPE10t6Zvr//SQ: posts big blind $0.25
*** HOLE CARDS ***
w2mQ4VsGljGwWXydz8tw2A: folds 
/xN6gc9+8Hew0HxaB6VIVg: folds 
KXtdqb+rIMkjc0RvHDksGQ: raises $0.75 to $1
DE9hRlt14g+JdsRQ4wT7hg: raises $2 to $3
3zD3qLXT1bEffAoWGnc7wg: folds 
3e/idKqDuPE10t6Zvr//SQ: folds 
KXtdqb+rIMkjc0RvHDksGQ: raises $4 to $7
DE9hRlt14g+JdsRQ4wT7hg: folds 
Uncalled bet ($4) returned to KXtdqb+rIMkjc0RvHDksGQ
KXtdqb+rIMkjc0RvHDksGQ collected $6.35 from pot
KXtdqb+rIMkjc0RvHDksGQ: doesn't show hand 
*** SUMMARY ***
Total pot $6.35 | Rake $0 
Seat 1: DE9hRlt14g+JdsRQ4wT7hg (button) folded before Flop
Seat 2: 3zD3qLXT1bEffAoWGnc7wg (small blind) folded before Flop
Seat 3: 3e/idKqDuPE10t6Zvr//SQ (big blind) folded before Flop
Seat 4: w2mQ4VsGljGwWXydz8tw2A folded before Flop (didn't bet)
Seat 5: /xN6gc9+8Hew0HxaB6VIVg folded before Flop (didn't bet)
Seat 6: KXtdqb+rIMkjc0RvHDksGQ collected ($6.35)




PokerStars Game #59941561664:  Hold'em No Limit ($0.10/$0.25) - 2009/07/01 1:39:12 ET
Table 'CM/C/FZf3VHIp50RjmBucQ' 9-max Seat #3 is the button
Seat 3: HPEB+AtKw1+C/cxU0o1ciw ($51.40 in chips) 
Seat 4: FYIiLXWy4mKC5ZGa/fnS0g ($9.95 in chips) 
Seat 5: oLa/tXLfSLLB28mcLGrxcg ($24.40 in chips) 
Seat 6: Bb42QRQMhg5/Y0vHP8/2Xw ($25.35 in chips) 
Seat 7: j4q3p0lesp63b1gZDwLBZw ($5 in chips) 
Seat 8: cZ99hugmLBj9KhTlc8nCSw ($25 in chips) 
Seat 9: HrQz1sQcyfbz6TvbEEzHWQ ($21.85 in chips) 
FYIiLXWy4mKC5ZGa/fnS0g: posts small blind $0.10
oLa/tXLfSLLB28mcLGrxcg: posts big blind $0.25
*** HOLE CARDS ***
Bb42QRQMhg5/Y0vHP8/2Xw: folds 
j4q3p0lesp63b1gZDwLBZw: folds 
cZ99hugmLBj9KhTlc8nCSw: folds 
HrQz1sQcyfbz6TvbEEzHWQ: folds 
HPEB+AtKw1+C/cxU0o1ciw: folds 
FYIiLXWy4mKC5ZGa/fnS0g: calls $0.15
oLa/tXLfSLLB28mcLGrxcg: checks 
*** FLOP *** [3s 5h 9d]
FYIiLXWy4mKC5ZGa/fnS0g: checks 
oLa/tXLfSLLB28mcLGrxcg: checks 
*** TURN *** [3s 5h 9d] [As]
FYIiLXWy4mKC5ZGa/fnS0g: checks 
oLa/tXLfSLLB28mcLGrxcg: bets $0.50
FYIiLXWy4mKC5ZGa/fnS0g: folds 
Uncalled bet ($0.50) returned to oLa/tXLfSLLB28mcLGrxcg
oLa/tXLfSLLB28mcLGrxcg collected $0.50 from pot
oLa/tXLfSLLB28mcLGrxcg: doesn't show hand 
*** SUMMARY ***
Total pot $0.50 | Rake $0 
Board [3s 5h 9d As]
Seat 3: HPEB+AtKw1+C/cxU0o1ciw (button) folded before Flop (didn't bet)
Seat 4: FYIiLXWy4mKC5ZGa/fnS0g (small blind) folded on the Turn
Seat 5: oLa/tXLfSLLB28mcLGrxcg (big blind) collected ($0.50)
Seat 6: Bb42QRQMhg5/Y0vHP8/2Xw folded before Flop (didn't bet)
Seat 7: j4q3p0lesp63b1gZDwLBZw folded before Flop (didn't bet)
Seat 8: cZ99hugmLBj9KhTlc8nCSw folded before Flop (didn't bet)
Seat 9: HrQz1sQcyfbz6TvbEEzHWQ folded before Flop (didn't bet)




PokerStars Game #59941561552:  Hold'em No Limit ($0.10/$0.25) - 2009/07/01 1:39:12 ET
Table 'o0CDOvKO/bn1WjeymDrXfA' 6-max Seat #2 is the button
Seat 2: uAJL+E2git8iAiFyAvVOnw ($16.40 in chips) 
Seat 3: OtVWmpxX2/9L8bb1GSKTuA ($18.85 in chips) 
Seat 5: dOIoLBxmpLHSXBN9LZnf0Q ($29.10 in chips) 
OtVWmpxX2/9L8bb1GSKTuA: posts small blind $0.10
dOIoLBxmpLHSXBN9LZnf0Q: posts big blind $0.25
SS/yfeArhULzIcOPe8MdPg: sits out 
if4dh6jhJXeN3/qd3qCp9g: sits out 
*** HOLE CARDS ***
L3/N/gliETan8N5Gim5h4Q joins the table at seat #4 
uAJL+E2git8iAiFyAvVOnw: raises $0.75 to $1
OtVWmpxX2/9L8bb1GSKTuA: folds 
dOIoLBxmpLHSXBN9LZnf0Q: folds 
Uncalled bet ($0.75) returned to uAJL+E2git8iAiFyAvVOnw
uAJL+E2git8iAiFyAvVOnw collected $0.60 from pot
*** SUMMARY ***
Total pot $0.60 | Rake $0 
Seat 2: uAJL+E2git8iAiFyAvVOnw (button) collected ($0.60)
Seat 3: OtVWmpxX2/9L8bb1GSKTuA (small blind) folded before Flop
Seat 5: dOIoLBxmpLHSXBN9LZnf0Q (big blind) folded before Flop




PokerStars Game #59941561802:  Hold'em No Limit ($0.10/$0.25) - 2009/07/01 1:39:12 ET
Table 'dNYnr4D4id1jwnEU66Yowg' 9-max Seat #9 is the button
Seat 1: 9lvO/qyU+xrU95Teu1fv0g ($4.75 in chips) 
Seat 2: KBBTLXGhPdPj+4X0QKMkcg ($2.30 in chips) 
Seat 3: cq6LACCDFivk2+PeoiB2sw ($10.85 in chips) 
Seat 4: VBHxUExRAMrbxUq/cVx9Gw ($5.05 in chips) 
Seat 5: 7cv+9Zc9HIQHNvYsMfV3uA ($25.70 in chips) 
Seat 7: DiSvPC2iudwL5j9u6Huyww ($25.80 in chips) 
Seat 8: RCqMONFrSPSArZh2Jsar/w ($20 in chips) 
Seat 9: K0dyGSZP/cgeQjH6o6u9Rw ($15.95 in chips) 
9lvO/qyU+xrU95Teu1fv0g: posts small blind $0.10
KBBTLXGhPdPj+4X0QKMkcg: posts big blind $0.25
8EbrQ/EvFWt2cr0GaU82gQ: sits out 
*** HOLE CARDS ***
cq6LACCDFivk2+PeoiB2sw: calls $0.25
VBHxUExRAMrbxUq/cVx9Gw: folds 
7cv+9Zc9HIQHNvYsMfV3uA: folds 
DiSvPC2iudwL5j9u6Huyww: folds 
RCqMONFrSPSArZh2Jsar/w: raises $1 to $1.25
K0dyGSZP/cgeQjH6o6u9Rw: folds 
9lvO/qyU+xrU95Teu1fv0g: folds 
KBBTLXGhPdPj+4X0QKMkcg: raises $1.05 to $2.30 and is all-in
cq6LACCDFivk2+PeoiB2sw: folds 
RCqMONFrSPSArZh2Jsar/w: calls $1.05
*** FLOP *** [9d 4h Qc]
*** TURN *** [9d 4h Qc] [Qd]
cq6LACCDFivk2+PeoiB2sw leaves the table
*** RIVER *** [9d 4h Qc Qd] [8h]
*** SHOW DOWN ***
KBBTLXGhPdPj+4X0QKMkcg: shows [6c 6d] (two pair, Queens and Sixes)
RCqMONFrSPSArZh2Jsar/w: shows [Tc Td] (two pair, Queens and Tens)
RCqMONFrSPSArZh2Jsar/w collected $4.75 from pot
*** SUMMARY ***
Total pot $4.95 | Rake $0.20 
Board [9d 4h Qc Qd 8h]
Seat 1: 9lvO/qyU+xrU95Teu1fv0g (small blind) folded before Flop
Seat 2: KBBTLXGhPdPj+4X0QKMkcg (big blind) showed [6c 6d] and lost with two pair, Queens and Sixes
Seat 3: cq6LACCDFivk2+PeoiB2sw folded before Flop
Seat 4: VBHxUExRAMrbxUq/cVx9Gw folded before Flop (didn't bet)
Seat 5: 7cv+9Zc9HIQHNvYsMfV3uA folded before Flop (didn't bet)
Seat 7: DiSvPC2iudwL5j9u6Huyww folded before Flop (didn't bet)
Seat 8: RCqMONFrSPSArZh2Jsar/w showed [Tc Td] and won ($4.75) with two pair, Queens and Tens
Seat 9: K0dyGSZP/cgeQjH6o6u9Rw (button) folded before Flop (didn't bet)




PokerStars Game #59941561650:  Hold'em No Limit ($0.10/$0.25) - 2009/07/01 1:39:12 ET
Table '8PD/MTROSMd6Y8mZeykbpg' 6-max Seat #3 is the button
Seat 1: 32YL2ZEp8NT4JB2RVM9euQ ($16.35 in chips) 
Seat 2: +C3eP/ysyROWbEXJFPswVA ($24.60 in chips) 
Seat 3: vqWjZmdQu/Hxw96/IJTWdQ ($25 in chips) 
Seat 4: DFi/Lzkjsfv8QswS80JX9Q ($53.80 in chips) 
Seat 5: z3tQwy28dp5FykDJC/wzQw ($26.45 in chips) 
DFi/Lzkjsfv8QswS80JX9Q: posts small blind $0.10
z3tQwy28dp5FykDJC/wzQw: posts big blind $0.25
*** HOLE CARDS ***
32YL2ZEp8NT4JB2RVM9euQ: folds 
32YL2ZEp8NT4JB2RVM9euQ leaves the table
+C3eP/ysyROWbEXJFPswVA: raises $0.50 to $0.75
vqWjZmdQu/Hxw96/IJTWdQ: folds 
DFi/Lzkjsfv8QswS80JX9Q: folds 
z3tQwy28dp5FykDJC/wzQw: folds 
Uncalled bet ($0.50) returned to +C3eP/ysyROWbEXJFPswVA
+C3eP/ysyROWbEXJFPswVA collected $0.60 from pot
+C3eP/ysyROWbEXJFPswVA: doesn't show hand 
*** SUMMARY ***
Total pot $0.60 | Rake $0 
Seat 1: 32YL2ZEp8NT4JB2RVM9euQ folded before Flop (didn't bet)
Seat 2: +C3eP/ysyROWbEXJFPswVA collected ($0.60)
Seat 3: vqWjZmdQu/Hxw96/IJTWdQ (button) folded before Flop (didn't bet)
Seat 4: DFi/Lzkjsfv8QswS80JX9Q (small blind) folded before Flop
Seat 5: z3tQwy28dp5FykDJC/wzQw (big blind) folded before Flop




PokerStars Game #59941561352:  Hold'em No Limit ($0.10/$0.25) - 2009/07/01 1:39:12 ET
Table '+68ihX5Br1xgGorX6zsCBg' 9-max Seat #5 is the button
Seat 1: IFB2mhulUVYIbb+KWwDC9w ($5.45 in chips) 
Seat 2: TeAfhXG1R60d8yPEHN3JiA ($27.30 in chips) 
Seat 3: PdIasPkzm2sqZnN41ZRXOg ($5 in chips) 
Seat 4: Oi0EiPIjriUb/6zT65YeWA ($27.70 in chips) 
Seat 5: ghNKXUBl/H+t83JF079ZBA ($25.45 in chips) 
Seat 6: X78b5v/uhqeXXoAijbw/yg ($26.50 in chips) 
Seat 7: V6p0jQ/RhUsqpHLmXvEX4Q ($13.85 in chips) 
Seat 8: Ut3g/kEEdCCbe/gbWrHnDg ($13.80 in chips) 
Seat 9: DiSvPC2iudwL5j9u6Huyww ($29.80 in chips) 
X78b5v/uhqeXXoAijbw/yg: posts small blind $0.10
V6p0jQ/RhUsqpHLmXvEX4Q: posts big blind $0.25
*** HOLE CARDS ***
Ut3g/kEEdCCbe/gbWrHnDg: calls $0.25
DiSvPC2iudwL5j9u6Huyww: folds 
IFB2mhulUVYIbb+KWwDC9w: calls $0.25
TeAfhXG1R60d8yPEHN3JiA: folds 
PdIasPkzm2sqZnN41ZRXOg: folds 
Oi0EiPIjriUb/6zT65YeWA: folds 
ghNKXUBl/H+t83JF079ZBA: folds 
X78b5v/uhqeXXoAijbw/yg: folds 
V6p0jQ/RhUsqpHLmXvEX4Q: checks 
*** FLOP *** [8h Tc 6d]
V6p0jQ/RhUsqpHLmXvEX4Q: bets $1
Ut3g/kEEdCCbe/gbWrHnDg: folds 
IFB2mhulUVYIbb+KWwDC9w: folds 
Uncalled bet ($1) returned to V6p0jQ/RhUsqpHLmXvEX4Q
V6p0jQ/RhUsqpHLmXvEX4Q collected $0.85 from pot
*** SUMMARY ***
Total pot $0.85 | Rake $0 
Board [8h Tc 6d]
Seat 1: IFB2mhulUVYIbb+KWwDC9w folded on the Flop
Seat 2: TeAfhXG1R60d8yPEHN3JiA folded before Flop (didn't bet)
Seat 3: PdIasPkzm2sqZnN41ZRXOg folded before Flop (didn't bet)
Seat 4: Oi0EiPIjriUb/6zT65YeWA folded before Flop (didn't bet)
Seat 5: ghNKXUBl/H+t83JF079ZBA (button) folded before Flop (didn't bet)
Seat 6: X78b5v/uhqeXXoAijbw/yg (small blind) folded before Flop
Seat 7: V6p0jQ/RhUsqpHLmXvEX4Q (big blind) collected ($0.85)
Seat 8: Ut3g/kEEdCCbe/gbWrHnDg folded on the Flop
Seat 9: DiSvPC2iudwL5j9u6Huyww folded before Flop (didn't bet)




PokerStars Game #59941562070:  Hold'em No Limit ($0.10/$0.25) - 2009/07/01 1:39:13 ET
Table 'i8VqsSY3xDtJ63IHleN8+A' 9-max Seat #2 is the button
Seat 1: Mh2r9hTeTEDnh19sRZtW3g ($4.25 in chips) 
Seat 2: CT7Xj/V/O5rBlhtt+RZeFQ ($25 in chips) 
Seat 3: 4awUyiDYTgylQKXZ9faBVA ($29.25 in chips) 
Seat 4: X78b5v/uhqeXXoAijbw/yg ($26.75 in chips) 
Seat 5: st9jtdNbm1W5GfBwRaCVqQ ($23.70 in chips) 
Seat 6: 3PmVnC/15cl4oyI1TKIt4g ($5.15 in chips) 
Seat 8: CvL9Ch1HYCVbTsfpNucitg ($5.35 in chips) 
Seat 9: tLcDklc2rBORNfixyRfVfw ($25 in chips) 
4awUyiDYTgylQKXZ9faBVA: posts small blind $0.10
X78b5v/uhqeXXoAijbw/yg: posts big blind $0.25
bXpVeaSTPBFSPJmeXxO7nw: sits out 
*** HOLE CARDS ***
st9jtdNbm1W5GfBwRaCVqQ: folds 
3PmVnC/15cl4oyI1TKIt4g: folds 
CvL9Ch1HYCVbTsfpNucitg: folds 
tLcDklc2rBORNfixyRfVfw: folds 
Mh2r9hTeTEDnh19sRZtW3g: folds 
CT7Xj/V/O5rBlhtt+RZeFQ: folds 
4awUyiDYTgylQKXZ9faBVA: folds 
Uncalled bet ($0.15) returned to X78b5v/uhqeXXoAijbw/yg
X78b5v/uhqeXXoAijbw/yg collected $0.20 from pot
*** SUMMARY ***
Total pot $0.20 | Rake $0 
Seat 1: Mh2r9hTeTEDnh19sRZtW3g folded before Flop (didn't bet)
Seat 2: CT7Xj/V/O5rBlhtt+RZeFQ (button) folded before Flop (didn't bet)
Seat 3: 4awUyiDYTgylQKXZ9faBVA (small blind) folded before Flop
Seat 4: X78b5v/uhqeXXoAijbw/yg (big blind) collected ($0.20)
Seat 5: st9jtdNbm1W5GfBwRaCVqQ folded before Flop (didn't bet)
Seat 6: 3PmVnC/15cl4oyI1TKIt4g folded before Flop (didn't bet)
Seat 8: CvL9Ch1HYCVbTsfpNucitg folded before Flop (didn't bet)
Seat 9: tLcDklc2rBORNfixyRfVfw folded before Flop (didn't bet)




PokerStars Game #59941561884:  Hold'em No Limit ($0.10/$0.25) - 2009/07/01 1:39:13 ET
Table 'G+4ZdyRoPjgaJY/jxSlZzQ' 9-max Seat #2 is the button
Seat 1: ghNKXUBl/H+t83JF079ZBA ($27.70 in chips) 
Seat 2: CT7Xj/V/O5rBlhtt+RZeFQ ($25 in chips) 
Seat 3: FaGtAm5QUVcixGhAKIvbLg ($15.75 in chips) 
Seat 4: lSeLm4BdnSMLtIli62qjAQ ($5.40 in chips) 
Seat 5: BT6Oal0iO4P6kDuT7HFQDw ($14.45 in chips) 
Seat 6: oFwaTjy3ok/+qFghsrcGvg ($17.80 in chips) 
Seat 7: IK3/w7XV7rd8mVIsuasjYA ($7.75 in chips) 
Seat 9: tLcDklc2rBORNfixyRfVfw ($25.95 in chips) 
FaGtAm5QUVcixGhAKIvbLg: posts small blind $0.10
lSeLm4BdnSMLtIli62qjAQ: posts big blind $0.25
bXpVeaSTPBFSPJmeXxO7nw: sits out 
*** HOLE CARDS ***
BT6Oal0iO4P6kDuT7HFQDw: folds 
oFwaTjy3ok/+qFghsrcGvg: folds 
IK3/w7XV7rd8mVIsuasjYA: calls $0.25
tLcDklc2rBORNfixyRfVfw: folds 
ghNKXUBl/H+t83JF079ZBA: folds 
CT7Xj/V/O5rBlhtt+RZeFQ: folds 
FaGtAm5QUVcixGhAKIvbLg: calls $0.15
lSeLm4BdnSMLtIli62qjAQ: raises $0.25 to $0.50
IK3/w7XV7rd8mVIsuasjYA: calls $0.25
FaGtAm5QUVcixGhAKIvbLg: calls $0.25
*** FLOP *** [Jc 6c Qs]
FaGtAm5QUVcixGhAKIvbLg: checks 
lSeLm4BdnSMLtIli62qjAQ: bets $1
IK3/w7XV7rd8mVIsuasjYA: raises $6.25 to $7.25 and is all-in
FaGtAm5QUVcixGhAKIvbLg: folds 
lSeLm4BdnSMLtIli62qjAQ: calls $3.90 and is all-in
Uncalled bet ($2.35) returned to IK3/w7XV7rd8mVIsuasjYA
*** TURN *** [Jc 6c Qs] [9c]
*** RIVER *** [Jc 6c Qs 9c] [Ac]
*** SHOW DOWN ***
lSeLm4BdnSMLtIli62qjAQ: shows [Ks Kd] (a pair of Kings)
IK3/w7XV7rd8mVIsuasjYA: mucks hand 
lSeLm4BdnSMLtIli62qjAQ collected $10.75 from pot
*** SUMMARY ***
Total pot $11.30 | Rake $0.55 
Board [Jc 6c Qs 9c Ac]
Seat 1: ghNKXUBl/H+t83JF079ZBA folded before Flop (didn't bet)
Seat 2: CT7Xj/V/O5rBlhtt+RZeFQ (button) folded before Flop (didn't bet)
Seat 3: FaGtAm5QUVcixGhAKIvbLg (small blind) folded on the Flop
Seat 4: lSeLm4BdnSMLtIli62qjAQ (big blind) showed [Ks Kd] and won ($10.75) with a pair of Kings
Seat 5: BT6Oal0iO4P6kDuT7HFQDw folded before Flop (didn't bet)
Seat 6: oFwaTjy3ok/+qFghsrcGvg folded before Flop (didn't bet)
Seat 7: IK3/w7XV7rd8mVIsuasjYA mucked
Seat 9: tLcDklc2rBORNfixyRfVfw folded before Flop (didn't bet)




PokerStars Game #59941562246:  Hold'em No Limit ($0.10/$0.25) - 2009/07/01 1:39:13 ET
Table 'eOXPe2c6mG7DOFKvMsZZfA' 6-max Seat #3 is the button
Seat 2: gaPMxLGp9SOj4Lq6t+/0Ig ($7.10 in chips) 
Seat 3: kReyZ6g6Fu3tQ0nyjDf9kA ($20.70 in chips) 
Seat 4: zHHLkD2sRljslKKeQv/ZQw ($40.85 in chips) 
Seat 5: NhUN/JpAprdJeamFBgJH1w ($32.50 in chips) 
Seat 6: Qpv/hb5ak7LeaDig1L5L8w ($15 in chips) 
zHHLkD2sRljslKKeQv/ZQw: posts small blind $0.10
NhUN/JpAprdJeamFBgJH1w: posts big blind $0.25
*** HOLE CARDS ***
Qpv/hb5ak7LeaDig1L5L8w: folds 
gaPMxLGp9SOj4Lq6t+/0Ig: raises $6.85 to $7.10 and is all-in
kReyZ6g6Fu3tQ0nyjDf9kA: folds 
s21kVGMLPAoHdWR+muSonw joins the table at seat #1 
zHHLkD2sRljslKKeQv/ZQw: folds 
NhUN/JpAprdJeamFBgJH1w: folds 
Uncalled bet ($6.85) returned to gaPMxLGp9SOj4Lq6t+/0Ig
gaPMxLGp9SOj4Lq6t+/0Ig collected $0.60 from pot
gaPMxLGp9SOj4Lq6t+/0Ig: doesn't show hand 
*** SUMMARY ***
Total pot $0.60 | Rake $0 
Seat 2: gaPMxLGp9SOj4Lq6t+/0Ig collected ($0.60)
Seat 3: kReyZ6g6Fu3tQ0nyjDf9kA (button) folded before Flop (didn't bet)
Seat 4: zHHLkD2sRljslKKeQv/ZQw (small blind) folded before Flop
Seat 5: NhUN/JpAprdJeamFBgJH1w (big blind) folded before Flop
Seat 6: Qpv/hb5ak7LeaDig1L5L8w folded before Flop (didn't bet)




PokerStars Game #59941562132:  Hold'em No Limit ($0.10/$0.25) - 2009/07/01 1:39:13 ET
Table 'oJpFwZj9+FUGHX90Un8s9Q' 6-max Seat #5 is the button
Seat 1: 6DwBRH+xZ12AAZmeAg+aXw ($22.45 in chips) 
Seat 2: NtrVQ9UIql0rDCnKDKZ5FQ ($8.25 in chips) 
Seat 4: 6elpmfyt4Zw0yvd8lePSMQ ($23.40 in chips) 
Seat 5: kG34n23qFQA3nzdOJTQ1dA ($56.45 in chips) 
Seat 6: edio/rLJ06xeZOfLhoL3UA ($8.75 in chips) 
edio/rLJ06xeZOfLhoL3UA: posts small blind $0.10
6DwBRH+xZ12AAZmeAg+aXw: posts big blind $0.25
*** HOLE CARDS ***
NtrVQ9UIql0rDCnKDKZ5FQ: folds 
6elpmfyt4Zw0yvd8lePSMQ: folds 
kG34n23qFQA3nzdOJTQ1dA: folds 
kyRaCIljYA6l33lSKQfNsg has returned
edio/rLJ06xeZOfLhoL3UA: raises $1 to $1.25
6DwBRH+xZ12AAZmeAg+aXw: folds 
Uncalled bet ($1) returned to edio/rLJ06xeZOfLhoL3UA
NtrVQ9UIql0rDCnKDKZ5FQ said, "wy wy do that never happen to me...nh"
edio/rLJ06xeZOfLhoL3UA collected $0.50 from pot
edio/rLJ06xeZOfLhoL3UA: doesn't show hand 
*** SUMMARY ***
Total pot $0.50 | Rake $0 
Seat 1: 6DwBRH+xZ12AAZmeAg+aXw (big blind) folded before Flop
Seat 2: NtrVQ9UIql0rDCnKDKZ5FQ folded before Flop (didn't bet)
Seat 4: 6elpmfyt4Zw0yvd8lePSMQ folded before Flop (didn't bet)
Seat 5: kG34n23qFQA3nzdOJTQ1dA (button) folded before Flop (didn't bet)
Seat 6: edio/rLJ06xeZOfLhoL3UA (small blind) collected ($0.50)




PokerStars Game #59941562854:  Hold'em No Limit ($0.10/$0.25) - 2009/07/01 1:39:14 ET
Table '9lYs7ljXi6AgFAxYHlKLJw' 9-max Seat #5 is the button
Seat 1: K0b5wNInj6hUGRr6yzKFtw ($33.90 in chips) 
Seat 3: arxNSjreDRGFg13EAM2F1w ($31.30 in chips) 
Seat 4: UANt6y/SmDCY/jIxkBixcw ($34.10 in chips) 
Seat 5: dfNim92Z6XK1/h5SFW5vDg ($52.70 in chips) 
Seat 6: tYsOBqdU1+x+yFI7zHO7hQ ($26.05 in chips) 
Seat 7: ghNKXUBl/H+t83JF079ZBA ($27.05 in chips) 
Seat 8: 9YN2IkT2JYYKFErZtZvCtA ($22.60 in chips) 
Seat 9: cKlmpQMahVsmOaxFQDcoOg ($20 in chips) 
tYsOBqdU1+x+yFI7zHO7hQ: posts small blind $0.10
ghNKXUBl/H+t83JF079ZBA: posts big blind $0.25
0XACOSNrAWmqNv9k1nF8rw: sits out 
*** HOLE CARDS ***
9YN2IkT2JYYKFErZtZvCtA: folds 
cKlmpQMahVsmOaxFQDcoOg: folds 
K0b5wNInj6hUGRr6yzKFtw: folds 
arxNSjreDRGFg13EAM2F1w: folds 
UANt6y/SmDCY/jIxkBixcw: folds 
dfNim92Z6XK1/h5SFW5vDg: folds 
tYsOBqdU1+x+yFI7zHO7hQ: folds 
Uncalled bet ($0.15) returned to ghNKXUBl/H+t83JF079ZBA
ghNKXUBl/H+t83JF079ZBA collected $0.20 from pot
ghNKXUBl/H+t83JF079ZBA: doesn't show hand 
*** SUMMARY ***
Total pot $0.20 | Rake $0 
Seat 1: K0b5wNInj6hUGRr6yzKFtw folded before Flop (didn't bet)
Seat 3: arxNSjreDRGFg13EAM2F1w folded before Flop (didn't bet)
Seat 4: UANt6y/SmDCY/jIxkBixcw folded before Flop (didn't bet)
Seat 5: dfNim92Z6XK1/h5SFW5vDg (button) folded before Flop (didn't bet)
Seat 6: tYsOBqdU1+x+yFI7zHO7hQ (small blind) folded before Flop
Seat 7: ghNKXUBl/H+t83JF079ZBA (big blind) collected ($0.20)
Seat 8: 9YN2IkT2JYYKFErZtZvCtA folded before Flop (didn't bet)
Seat 9: cKlmpQMahVsmOaxFQDcoOg folded before Flop (didn't bet)




PokerStars Game #59941562518:  Hold'em No Limit ($0.10/$0.25) - 2009/07/01 1:39:14 ET
Table '972HGIb0tQN/zRIK4TABEw' 9-max Seat #8 is the button
Seat 1: fHr2+mGa0RFK3qrpZcVUAQ ($5.90 in chips) 
Seat 2: lc6GpYOW7MM4G+/65wMxXA ($16.75 in chips) 
Seat 4: Bb42QRQMhg5/Y0vHP8/2Xw ($25 in chips) 
Seat 5: swK30YlQuxRQO7QFr4ZxCA ($19.30 in chips) 
Seat 6: aLYacoAY3e5d/M5ToF8Ujw ($12.65 in chips) 
Seat 7: qS+jfnNoG75bT+uQ8CKhQA ($14.75 in chips) 
Seat 8: sGFnnRCa1YAHAUmWgsW6Qg ($8.80 in chips) 
Seat 9: 3PmVnC/15cl4oyI1TKIt4g ($4.05 in chips) 
3PmVnC/15cl4oyI1TKIt4g: posts small blind $0.10
fHr2+mGa0RFK3qrpZcVUAQ: posts big blind $0.25
aNpwfA31EREwO+ar4XzBCw: sits out 
*** HOLE CARDS ***
lc6GpYOW7MM4G+/65wMxXA: folds 
Bb42QRQMhg5/Y0vHP8/2Xw: folds 
swK30YlQuxRQO7QFr4ZxCA: folds 
aLYacoAY3e5d/M5ToF8Ujw: calls $0.25
qS+jfnNoG75bT+uQ8CKhQA: folds 
sGFnnRCa1YAHAUmWgsW6Qg: folds 
3PmVnC/15cl4oyI1TKIt4g: folds 
fHr2+mGa0RFK3qrpZcVUAQ: raises $0.75 to $1
aLYacoAY3e5d/M5ToF8Ujw: folds 
Uncalled bet ($0.75) returned to fHr2+mGa0RFK3qrpZcVUAQ
fHr2+mGa0RFK3qrpZcVUAQ collected $0.60 from pot
*** SUMMARY ***
Total pot $0.60 | Rake $0 
Seat 1: fHr2+mGa0RFK3qrpZcVUAQ (big blind) collected ($0.60)
Seat 2: lc6GpYOW7MM4G+/65wMxXA folded before Flop (didn't bet)
Seat 4: Bb42QRQMhg5/Y0vHP8/2Xw folded before Flop (didn't bet)
Seat 5: swK30YlQuxRQO7QFr4ZxCA folded before Flop (didn't bet)
Seat 6: aLYacoAY3e5d/M5ToF8Ujw folded before Flop
Seat 7: qS+jfnNoG75bT+uQ8CKhQA folded before Flop (didn't bet)
Seat 8: sGFnnRCa1YAHAUmWgsW6Qg (button) folded before Flop (didn't bet)
Seat 9: 3PmVnC/15cl4oyI1TKIt4g (small blind) folded before Flop




PokerStars Game #59941562566:  Hold'em No Limit ($0.10/$0.25) - 2009/07/01 1:39:14 ET
Table '/asc7VQ/OpF/oVJ3erB80w' 9-max Seat #3 is the button
Seat 1: 8WPqTOlC7HvWuhmvZhP82g ($4.65 in chips) 
Seat 2: +LseQ4csMghI3KY4cLSGMQ ($24.75 in chips) 
Seat 3: WEb58GPxGJGcxGh34AFZRQ ($2.70 in chips) 
Seat 4: Rjy74A2wdEiDWplMcUbA+w ($20.20 in chips) 
Seat 5: QB9VESHry/CRTDKMGwKwsQ ($43.20 in chips) 
Seat 6: XwQK8xvCADxp0bUmji+Zyg ($12.45 in chips) 
Seat 7: 7Qlge5BZqMQvXxiy4HU3Hw ($7 in chips) 
Seat 8: jB7U2KxE3pjvDhvZHXK2Ag ($12.50 in chips) 
Seat 9: zUXhymECc2C9W9ZNw6qppA ($9.65 in chips) 
Rjy74A2wdEiDWplMcUbA+w: posts small blind $0.10
QB9VESHry/CRTDKMGwKwsQ: posts big blind $0.25
*** HOLE CARDS ***
XwQK8xvCADxp0bUmji+Zyg: folds 
7Qlge5BZqMQvXxiy4HU3Hw: calls $0.25
jB7U2KxE3pjvDhvZHXK2Ag: raises $1 to $1.25
zUXhymECc2C9W9ZNw6qppA: folds 
8WPqTOlC7HvWuhmvZhP82g: raises $3.40 to $4.65 and is all-in
+LseQ4csMghI3KY4cLSGMQ: folds 
WEb58GPxGJGcxGh34AFZRQ: folds 
Rjy74A2wdEiDWplMcUbA+w: folds 
QB9VESHry/CRTDKMGwKwsQ: folds 
7Qlge5BZqMQvXxiy4HU3Hw: folds 
jB7U2KxE3pjvDhvZHXK2Ag: calls $3.40
*** FLOP *** [5d Qd 3c]
*** TURN *** [5d Qd 3c] [3d]
*** RIVER *** [5d Qd 3c 3d] [Ad]
*** SHOW DOWN ***
jB7U2KxE3pjvDhvZHXK2Ag: shows [7d 7h] (a flush, Ace high)
8WPqTOlC7HvWuhmvZhP82g: mucks hand 
jB7U2KxE3pjvDhvZHXK2Ag collected $9.45 from pot
*** SUMMARY ***
Total pot $9.90 | Rake $0.45 
Board [5d Qd 3c 3d Ad]
Seat 1: 8WPqTOlC7HvWuhmvZhP82g mucked
Seat 2: +LseQ4csMghI3KY4cLSGMQ folded before Flop (didn't bet)
Seat 3: WEb58GPxGJGcxGh34AFZRQ (button) folded before Flop (didn't bet)
Seat 4: Rjy74A2wdEiDWplMcUbA+w (small blind) folded before Flop
Seat 5: QB9VESHry/CRTDKMGwKwsQ (big blind) folded before Flop
Seat 6: XwQK8xvCADxp0bUmji+Zyg folded before Flop (didn't bet)
Seat 7: 7Qlge5BZqMQvXxiy4HU3Hw folded before Flop
Seat 8: jB7U2KxE3pjvDhvZHXK2Ag showed [7d 7h] and won ($9.45) with a flush, Ace high
Seat 9: zUXhymECc2C9W9ZNw6qppA folded before Flop (didn't bet)




PokerStars Game #59941562464:  Hold'em No Limit ($0.10/$0.25) - 2009/07/01 1:39:14 ET
Table 'x7YStLKc8hpt/pTgSetPKA' 9-max Seat #5 is the button
Seat 1: tYsOBqdU1+x+yFI7zHO7hQ ($26.25 in chips) 
Seat 2: z5GxcHlYz/GSz6W2uFiTtg ($23.70 in chips) 
Seat 3: S7Ki0P+0AIGPuIfGJjW0gg ($12 in chips) 
Seat 4: ydoFOVgzvZv9ZhuWu9rXAw ($5.25 in chips) 
Seat 5: OiV1PWZ3IkN29JlmCcnTwQ ($4.90 in chips) 
Seat 6: 9YN2IkT2JYYKFErZtZvCtA ($47.45 in chips) 
Seat 7: dtZ84flFEi4Q+SGrHMJRDQ ($26.70 in chips) 
Seat 8: j4q3p0lesp63b1gZDwLBZw ($5 in chips) 
Seat 9: nm4Dj/f+jJEwKVsUnKh73g ($22.65 in chips) 
9YN2IkT2JYYKFErZtZvCtA: posts small blind $0.10
dtZ84flFEi4Q+SGrHMJRDQ: posts big blind $0.25
*** HOLE CARDS ***
j4q3p0lesp63b1gZDwLBZw: folds 
nm4Dj/f+jJEwKVsUnKh73g: folds 
tYsOBqdU1+x+yFI7zHO7hQ: folds 
z5GxcHlYz/GSz6W2uFiTtg: folds 
S7Ki0P+0AIGPuIfGJjW0gg: folds 
ydoFOVgzvZv9ZhuWu9rXAw: folds 
OiV1PWZ3IkN29JlmCcnTwQ: folds 
9YN2IkT2JYYKFErZtZvCtA: raises $0.50 to $0.75
dtZ84flFEi4Q+SGrHMJRDQ: folds 
Uncalled bet ($0.50) returned to 9YN2IkT2JYYKFErZtZvCtA
9YN2IkT2JYYKFErZtZvCtA collected $0.50 from pot
9YN2IkT2JYYKFErZtZvCtA: doesn't show hand 
*** SUMMARY ***
Total pot $0.50 | Rake $0 
Seat 1: tYsOBqdU1+x+yFI7zHO7hQ folded before Flop (didn't bet)
Seat 2: z5GxcHlYz/GSz6W2uFiTtg folded before Flop (didn't bet)
Seat 3: S7Ki0P+0AIGPuIfGJjW0gg folded before Flop (didn't bet)
Seat 4: ydoFOVgzvZv9ZhuWu9rXAw folded before Flop (didn't bet)
Seat 5: OiV1PWZ3IkN29JlmCcnTwQ (button) folded before Flop (didn't bet)
Seat 6: 9YN2IkT2JYYKFErZtZvCtA (small blind) collected ($0.50)
Seat 7: dtZ84flFEi4Q+SGrHMJRDQ (big blind) folded before Flop
Seat 8: j4q3p0lesp63b1gZDwLBZw folded before Flop (didn't bet)
Seat 9: nm4Dj/f+jJEwKVsUnKh73g folded before Flop (didn't bet)




PokerStars Game #59941562838:  Hold'em No Limit ($0.10/$0.25) - 2009/07/01 1:39:14 ET
Table 'pgrBYaOEx/BuqK5iAtlFzw' 9-max Seat #5 is the button
Seat 1: 6O+8t5ikoK+pNiFXnN/Fyw ($16.15 in chips) 
Seat 2: 2Xwi447v1rBHM+92U0CduA ($4.75 in chips) 
Seat 3: Bb42QRQMhg5/Y0vHP8/2Xw ($25.60 in chips) 
Seat 4: oLa/tXLfSLLB28mcLGrxcg ($24.40 in chips) 
Seat 5: BWzInv8o0kN1pJybv/VjpQ ($26.65 in chips) 
Seat 6: eubS00Znk+qsx0B0+7/Zow ($21.95 in chips) 
Seat 7: eK8qa6EPcH2zhtbmWSvc9g ($25 in chips) 
Seat 8: tLcDklc2rBORNfixyRfVfw ($25 in chips) 
Seat 9: 1S/fpm+f42V/6MNZre+ccg ($32.20 in chips) 
eubS00Znk+qsx0B0+7/Zow: posts small blind $0.10
eK8qa6EPcH2zhtbmWSvc9g: posts big blind $0.25
*** HOLE CARDS ***
tLcDklc2rBORNfixyRfVfw: folds 
1S/fpm+f42V/6MNZre+ccg: folds 
6O+8t5ikoK+pNiFXnN/Fyw: folds 
2Xwi447v1rBHM+92U0CduA: folds 
Bb42QRQMhg5/Y0vHP8/2Xw: raises $0.75 to $1
oLa/tXLfSLLB28mcLGrxcg: folds 
BWzInv8o0kN1pJybv/VjpQ: calls $1
eubS00Znk+qsx0B0+7/Zow: folds 
eK8qa6EPcH2zhtbmWSvc9g: folds 
*** FLOP *** [Ks Ts 3h]
Bb42QRQMhg5/Y0vHP8/2Xw: checks 
BWzInv8o0kN1pJybv/VjpQ: checks 
*** TURN *** [Ks Ts 3h] [7h]
Bb42QRQMhg5/Y0vHP8/2Xw: bets $2
BWzInv8o0kN1pJybv/VjpQ: folds 
Uncalled bet ($2) returned to Bb42QRQMhg5/Y0vHP8/2Xw
Bb42QRQMhg5/Y0vHP8/2Xw collected $2.25 from pot
*** SUMMARY ***
Total pot $2.35 | Rake $0.10 
Board [Ks Ts 3h 7h]
Seat 1: 6O+8t5ikoK+pNiFXnN/Fyw folded before Flop (didn't bet)
Seat 2: 2Xwi447v1rBHM+92U0CduA folded before Flop (didn't bet)
Seat 3: Bb42QRQMhg5/Y0vHP8/2Xw collected ($2.25)
Seat 4: oLa/tXLfSLLB28mcLGrxcg folded before Flop (didn't bet)
Seat 5: BWzInv8o0kN1pJybv/VjpQ (button) folded on the Turn
Seat 6: eubS00Znk+qsx0B0+7/Zow (small blind) folded before Flop
Seat 7: eK8qa6EPcH2zhtbmWSvc9g (big blind) folded before Flop
Seat 8: tLcDklc2rBORNfixyRfVfw folded before Flop (didn't bet)
Seat 9: 1S/fpm+f42V/6MNZre+ccg folded before Flop (didn't bet)




PokerStars Game #59941562792:  Hold'em No Limit ($0.10/$0.25) - 2009/07/01 1:39:14 ET
Table '3EebBlzq5yHSY2444L4zlg' 9-max Seat #8 is the button
Seat 1: XMSS6mD5B42I8wasdOMipQ ($29.65 in chips) 
Seat 2: b9UnopCOpq2MWP1DwqSO3Q ($18.30 in chips) 
Seat 3: IGbD5vKNhHe60dkdbjg/mw ($44.25 in chips) 
Seat 4: 1S/fpm+f42V/6MNZre+ccg ($25 in chips) 
Seat 5: PFNLAvMkr8qKc7xCiH0wTA ($26.30 in chips) 
Seat 6: QEbIGci+itdw+re8RM5fZA ($50.35 in chips) 
Seat 7: DiSvPC2iudwL5j9u6Huyww ($49.10 in chips) 
Seat 8: dtZ84flFEi4Q+SGrHMJRDQ ($25.50 in chips) 
Seat 9: iZmSlSzYu5fJ67tDdQzymQ ($25 in chips) 
iZmSlSzYu5fJ67tDdQzymQ: posts small blind $0.10
XMSS6mD5B42I8wasdOMipQ: posts big blind $0.25
*** HOLE CARDS ***
b9UnopCOpq2MWP1DwqSO3Q: folds 
IGbD5vKNhHe60dkdbjg/mw: calls $0.25
1S/fpm+f42V/6MNZre+ccg: folds 
PFNLAvMkr8qKc7xCiH0wTA: folds 
QEbIGci+itdw+re8RM5fZA: folds 
DiSvPC2iudwL5j9u6Huyww: folds 
dtZ84flFEi4Q+SGrHMJRDQ: calls $0.25
iZmSlSzYu5fJ67tDdQzymQ: calls $0.15
XMSS6mD5B42I8wasdOMipQ: checks 
*** FLOP *** [9d 4c Qc]
iZmSlSzYu5fJ67tDdQzymQ: checks 
XMSS6mD5B42I8wasdOMipQ: checks 
IGbD5vKNhHe60dkdbjg/mw: bets $0.75
dtZ84flFEi4Q+SGrHMJRDQ: raises $2 to $2.75
iZmSlSzYu5fJ67tDdQzymQ: folds 
XMSS6mD5B42I8wasdOMipQ: folds 
IGbD5vKNhHe60dkdbjg/mw: folds 
Uncalled bet ($2) returned to dtZ84flFEi4Q+SGrHMJRDQ
dtZ84flFEi4Q+SGrHMJRDQ collected $2.40 from pot
dtZ84flFEi4Q+SGrHMJRDQ: doesn't show hand 
*** SUMMARY ***
Total pot $2.50 | Rake $0.10 
Board [9d 4c Qc]
Seat 1: XMSS6mD5B42I8wasdOMipQ (big blind) folded on the Flop
Seat 2: b9UnopCOpq2MWP1DwqSO3Q folded before Flop (didn't bet)
Seat 3: IGbD5vKNhHe60dkdbjg/mw folded on the Flop
Seat 4: 1S/fpm+f42V/6MNZre+ccg folded before Flop (didn't bet)
Seat 5: PFNLAvMkr8qKc7xCiH0wTA folded before Flop (didn't bet)
Seat 6: QEbIGci+itdw+re8RM5fZA folded before Flop (didn't bet)
Seat 7: DiSvPC2iudwL5j9u6Huyww folded before Flop (didn't bet)
Seat 8: dtZ84flFEi4Q+SGrHMJRDQ (button) collected ($2.40)
Seat 9: iZmSlSzYu5fJ67tDdQzymQ (small blind) folded on the Flop




PokerStars Game #59941562836:  Hold'em No Limit ($0.10/$0.25) - 2009/07/01 1:39:14 ET
Table 'sgdCtiuCu2BDZhyDi6RzTA' 6-max Seat #3 is the button
Seat 1: 3zD3qLXT1bEffAoWGnc7wg ($31.55 in chips) 
Seat 2: XD1i5m5PvBDnRzJaG/vINw ($24.65 in chips) 
Seat 3: eL3+wCBjFGfQ5FMdIZihwA ($24.65 in chips) 
Seat 4: rVKEgilmMX+EkKzDVvhmxA ($10.05 in chips) 
Seat 5: 0tQitW75xfmVWKldYHjmOQ ($7.40 in chips) 
Seat 6: KODslGU8ikCYS0/29dUkhg ($32.70 in chips) 
rVKEgilmMX+EkKzDVvhmxA: posts small blind $0.10
0tQitW75xfmVWKldYHjmOQ: posts big blind $0.25
*** HOLE CARDS ***
KODslGU8ikCYS0/29dUkhg: calls $0.25
3zD3qLXT1bEffAoWGnc7wg: folds 
XD1i5m5PvBDnRzJaG/vINw: calls $0.25
eL3+wCBjFGfQ5FMdIZihwA: raises $1 to $1.25
rVKEgilmMX+EkKzDVvhmxA: folds 
0tQitW75xfmVWKldYHjmOQ: folds 
KODslGU8ikCYS0/29dUkhg: calls $1
XD1i5m5PvBDnRzJaG/vINw: folds 
*** FLOP *** [4c Qd 9h]
KODslGU8ikCYS0/29dUkhg: checks 
eL3+wCBjFGfQ5FMdIZihwA: bets $2.25
KODslGU8ikCYS0/29dUkhg: folds 
Uncalled bet ($2.25) returned to eL3+wCBjFGfQ5FMdIZihwA
eL3+wCBjFGfQ5FMdIZihwA collected $2.95 from pot
*** SUMMARY ***
Total pot $3.10 | Rake $0.15 
Board [4c Qd 9h]
Seat 1: 3zD3qLXT1bEffAoWGnc7wg folded before Flop (didn't bet)
Seat 2: XD1i5m5PvBDnRzJaG/vINw folded before Flop
Seat 3: eL3+wCBjFGfQ5FMdIZihwA (button) collected ($2.95)
Seat 4: rVKEgilmMX+EkKzDVvhmxA (small blind) folded before Flop
Seat 5: 0tQitW75xfmVWKldYHjmOQ (big blind) folded before Flop
Seat 6: KODslGU8ikCYS0/29dUkhg folded on the Flop




PokerStars Game #59941562466:  Hold'em No Limit ($0.10/$0.25) - 2009/07/01 1:39:14 ET
Table '2clPgY3+dETPD/8zjXZdFw' 6-max Seat #5 is the button
Seat 1: 4WFKzsjLSGnvHbVxKabsvQ ($25 in chips) 
Seat 2: cWc85bEzdRzpUMhRKm8pwQ ($25 in chips) 
Seat 3: SFmT9ZsVopnukjvAzrxTRg ($25 in chips) 
Seat 4: ljjhtb6FVPTx9AT9HNdtqg ($21.65 in chips) 
Seat 5: LJI7A1YgDM7hgh7o56+ReQ ($25 in chips) 
Seat 6: 2G0C7dp4wlPpE21FHjjElQ ($27 in chips) 
2G0C7dp4wlPpE21FHjjElQ: posts small blind $0.10
4WFKzsjLSGnvHbVxKabsvQ: posts big blind $0.25
*** HOLE CARDS ***
cWc85bEzdRzpUMhRKm8pwQ: folds 
SFmT9ZsVopnukjvAzrxTRg: folds 
ljjhtb6FVPTx9AT9HNdtqg: raises $0.50 to $0.75
LJI7A1YgDM7hgh7o56+ReQ: calls $0.75
2G0C7dp4wlPpE21FHjjElQ: folds 
4WFKzsjLSGnvHbVxKabsvQ: calls $0.50
*** FLOP *** [6h Ks Jh]
4WFKzsjLSGnvHbVxKabsvQ: checks 
ljjhtb6FVPTx9AT9HNdtqg: bets $1
LJI7A1YgDM7hgh7o56+ReQ: folds 
4WFKzsjLSGnvHbVxKabsvQ: calls $1
*** TURN *** [6h Ks Jh] [9c]
4WFKzsjLSGnvHbVxKabsvQ: checks 
ljjhtb6FVPTx9AT9HNdtqg: checks 
*** RIVER *** [6h Ks Jh 9c] [5s]
4WFKzsjLSGnvHbVxKabsvQ: bets $1.25
ljjhtb6FVPTx9AT9HNdtqg: calls $1.25
*** SHOW DOWN ***
4WFKzsjLSGnvHbVxKabsvQ: shows [Kh 3c] (a pair of Kings)
ljjhtb6FVPTx9AT9HNdtqg: mucks hand 
4WFKzsjLSGnvHbVxKabsvQ collected $6.55 from pot
*** SUMMARY ***
Total pot $6.85 | Rake $0.30 
Board [6h Ks Jh 9c 5s]
Seat 1: 4WFKzsjLSGnvHbVxKabsvQ (big blind) showed [Kh 3c] and won ($6.55) with a pair of Kings
Seat 2: cWc85bEzdRzpUMhRKm8pwQ folded before Flop (didn't bet)
Seat 3: SFmT9ZsVopnukjvAzrxTRg folded before Flop (didn't bet)
Seat 4: ljjhtb6FVPTx9AT9HNdtqg mucked
Seat 5: LJI7A1YgDM7hgh7o56+ReQ (button) folded on the Flop
Seat 6: 2G0C7dp4wlPpE21FHjjElQ (small blind) folded before Flop




PokerStars Game #59941563384:  Hold'em No Limit ($0.10/$0.25) - 2009/07/01 1:39:15 ET
Table '2O5CgfSkSwrr4PDrlZ1RLQ' 6-max Seat #3 is the button
Seat 1: 3skmHD9EOATKdUzzyHh1KA ($29.40 in chips) 
Seat 2: wqphQtauX5Qn7WRJZS1flA ($25.70 in chips) 
Seat 3: oBUDUfeUyCbZBsjxHZgSiw ($30 in chips) 
Seat 4: 2Ga+TibtZsUCp1MLaueYVA ($25 in chips) 
Seat 5: 0av6tRNdi0Ui4f15L7gsVg ($23.65 in chips) 
Seat 6: tj9xqoqQaDaFw7u1oyZrtA ($40.80 in chips) 
2Ga+TibtZsUCp1MLaueYVA: posts small blind $0.10
0av6tRNdi0Ui4f15L7gsVg: posts big blind $0.25
*** HOLE CARDS ***
tj9xqoqQaDaFw7u1oyZrtA: calls $0.25
3skmHD9EOATKdUzzyHh1KA: folds 
wqphQtauX5Qn7WRJZS1flA: folds 
oBUDUfeUyCbZBsjxHZgSiw: folds 
2Ga+TibtZsUCp1MLaueYVA: folds 
0av6tRNdi0Ui4f15L7gsVg: checks 
*** FLOP *** [3c 6c Ts]
0av6tRNdi0Ui4f15L7gsVg: checks 
tj9xqoqQaDaFw7u1oyZrtA: bets $0.50
0av6tRNdi0Ui4f15L7gsVg: folds 
Uncalled bet ($0.50) returned to tj9xqoqQaDaFw7u1oyZrtA
tj9xqoqQaDaFw7u1oyZrtA collected $0.60 from pot
tj9xqoqQaDaFw7u1oyZrtA: doesn't show hand 
*** SUMMARY ***
Total pot $0.60 | Rake $0 
Board [3c 6c Ts]
Seat 1: 3skmHD9EOATKdUzzyHh1KA folded before Flop (didn't bet)
Seat 2: wqphQtauX5Qn7WRJZS1flA folded before Flop (didn't bet)
Seat 3: oBUDUfeUyCbZBsjxHZgSiw (button) folded before Flop (didn't bet)
Seat 4: 2Ga+TibtZsUCp1MLaueYVA (small blind) folded before Flop
Seat 5: 0av6tRNdi0Ui4f15L7gsVg (big blind) folded on the Flop
Seat 6: tj9xqoqQaDaFw7u1oyZrtA collected ($0.60)




PokerStars Game #59941563442:  Hold'em No Limit ($0.10/$0.25) - 2009/07/01 1:39:15 ET
Table 'g6ryG70feTw9nNm+XJLuXw' 6-max Seat #3 is the button
Seat 1: v+QfkGiuj9bgtuNoVnDO8w ($35.95 in chips) 
Seat 2: SxIIgwXYLkwd6m3wLyPTCw ($29.15 in chips) 
Seat 3: cezpHJ8FB07dj0xG+LhOvw ($25 in chips) 
Seat 4: GC/9yVD59DUCX7hUI7gcLw ($44.45 in chips) 
Seat 5: EE16Ua5b1HSsYej5zeXOlA ($26.05 in chips) 
Seat 6: tSR4329m40dZsN7YOpI9Kw ($35.85 in chips) 
GC/9yVD59DUCX7hUI7gcLw: posts small blind $0.10
EE16Ua5b1HSsYej5zeXOlA: posts big blind $0.25
*** HOLE CARDS ***
tSR4329m40dZsN7YOpI9Kw: folds 
v+QfkGiuj9bgtuNoVnDO8w: folds 
SxIIgwXYLkwd6m3wLyPTCw: raises $0.50 to $0.75
cezpHJ8FB07dj0xG+LhOvw: folds 
GC/9yVD59DUCX7hUI7gcLw: folds 
EE16Ua5b1HSsYej5zeXOlA: calls $0.50
*** FLOP *** [5s Qc As]
EE16Ua5b1HSsYej5zeXOlA: checks 
SxIIgwXYLkwd6m3wLyPTCw: bets $1.25
EE16Ua5b1HSsYej5zeXOlA: raises $2.25 to $3.50
SxIIgwXYLkwd6m3wLyPTCw: calls $2.25
*** TURN *** [5s Qc As] [3s]
EE16Ua5b1HSsYej5zeXOlA: checks 
SxIIgwXYLkwd6m3wLyPTCw: checks 
*** RIVER *** [5s Qc As 3s] [Qd]
EE16Ua5b1HSsYej5zeXOlA: checks 
SxIIgwXYLkwd6m3wLyPTCw: checks 
*** SHOW DOWN ***
EE16Ua5b1HSsYej5zeXOlA: shows [9s Td] (a pair of Queens)
SxIIgwXYLkwd6m3wLyPTCw: shows [6c Ac] (two pair, Aces and Queens)
SxIIgwXYLkwd6m3wLyPTCw collected $8.20 from pot
*** SUMMARY ***
Total pot $8.60 | Rake $0.40 
Board [5s Qc As 3s Qd]
Seat 1: v+QfkGiuj9bgtuNoVnDO8w folded before Flop (didn't bet)
Seat 2: SxIIgwXYLkwd6m3wLyPTCw showed [6c Ac] and won ($8.20) with two pair, Aces and Queens
Seat 3: cezpHJ8FB07dj0xG+LhOvw (button) folded before Flop (didn't bet)
Seat 4: GC/9yVD59DUCX7hUI7gcLw (small blind) folded before Flop
Seat 5: EE16Ua5b1HSsYej5zeXOlA (big blind) showed [9s Td] and lost with a pair of Queens
Seat 6: tSR4329m40dZsN7YOpI9Kw folded before Flop (didn't bet)




PokerStars Game #59941563128:  Hold'em No Limit ($0.10/$0.25) - 2009/07/01 1:39:15 ET
Table '5NipxzzFB2DffzDpddyQoQ' 6-max Seat #2 is the button
Seat 1: W87HPwOk1KtWaYyshBe1gA ($23.10 in chips) 
Seat 2: iauW7L/+7qzAuHow7CD75Q ($5 in chips) 
Seat 3: QvTX2yGq3uKJiKPmns4TKQ ($23.75 in chips) 
Seat 4: NTamLAiMZ86c5yM04t96LA ($13.50 in chips) 
Seat 5: faP2NVl/cFTZ1nE4pXzg8Q ($26.90 in chips) 
Seat 6: 7JqTFMyeNSVWsmp/yW35Tw ($25 in chips) 
QvTX2yGq3uKJiKPmns4TKQ: posts small blind $0.10
NTamLAiMZ86c5yM04t96LA: posts big blind $0.25
*** HOLE CARDS ***
faP2NVl/cFTZ1nE4pXzg8Q said, "yep"
7JqTFMyeNSVWsmp/yW35Tw said, "every hand?"
faP2NVl/cFTZ1nE4pXzg8Q: calls $0.25
7JqTFMyeNSVWsmp/yW35Tw said, "wow"
7JqTFMyeNSVWsmp/yW35Tw said, "poker is hard"
7JqTFMyeNSVWsmp/yW35Tw: folds 
W87HPwOk1KtWaYyshBe1gA: calls $0.25
7JqTFMyeNSVWsmp/yW35Tw said, "lol"
iauW7L/+7qzAuHow7CD75Q: raises $1.75 to $2
QvTX2yGq3uKJiKPmns4TKQ: folds 
NTamLAiMZ86c5yM04t96LA: folds 
faP2NVl/cFTZ1nE4pXzg8Q: calls $1.75
W87HPwOk1KtWaYyshBe1gA: folds 
*** FLOP *** [2d 9d Qh]
iauW7L/+7qzAuHow7CD75Q said, "tell me about it"
faP2NVl/cFTZ1nE4pXzg8Q: bets $1.25
iauW7L/+7qzAuHow7CD75Q: raises $1.25 to $2.50
faP2NVl/cFTZ1nE4pXzg8Q: raises $1.25 to $3.75
iauW7L/+7qzAuHow7CD75Q: calls $0.50 and is all-in
Uncalled bet ($0.75) returned to faP2NVl/cFTZ1nE4pXzg8Q
*** TURN *** [2d 9d Qh] [Ah]
*** RIVER *** [2d 9d Qh Ah] [2s]
*** SHOW DOWN ***
faP2NVl/cFTZ1nE4pXzg8Q: shows [9h Tc] (two pair, Nines and Deuces)
iauW7L/+7qzAuHow7CD75Q: shows [Ac As] (a full house, Aces full of Deuces)
iauW7L/+7qzAuHow7CD75Q collected $10.10 from pot
*** SUMMARY ***
Total pot $10.60 | Rake $0.50 
Board [2d 9d Qh Ah 2s]
Seat 1: W87HPwOk1KtWaYyshBe1gA folded before Flop
Seat 2: iauW7L/+7qzAuHow7CD75Q (button) showed [Ac As] and won ($10.10) with a full house, Aces full of Deuces
Seat 3: QvTX2yGq3uKJiKPmns4TKQ (small blind) folded before Flop
Seat 4: NTamLAiMZ86c5yM04t96LA (big blind) folded before Flop
Seat 5: faP2NVl/cFTZ1nE4pXzg8Q showed [9h Tc] and lost with two pair, Nines and Deuces
Seat 6: 7JqTFMyeNSVWsmp/yW35Tw folded before Flop (didn't bet)




PokerStars Game #59941563098:  Hold'em No Limit ($0.10/$0.25) - 2009/07/01 1:39:15 ET
Table 'vFZR6Kf2Th5xBXT9brGW6A' 6-max Seat #1 is the button
Seat 1: Q3EMN7b0ie81AFWkDrhCjw ($21.70 in chips) 
Seat 2: QiL+lEgEWwy21jk/ltaRLg ($23.65 in chips) 
Seat 3: SH1WjKVUjPiyXySjWSdazw ($22.20 in chips) 
Seat 4: 79ID/ub1Pt/mDpCprVmOoA ($35.90 in chips) 
Seat 5: SS/yfeArhULzIcOPe8MdPg ($26 in chips) 
Seat 6: 4x9jCqgSw4272dnaIqnanw ($4.10 in chips) 
QiL+lEgEWwy21jk/ltaRLg: posts small blind $0.10
SH1WjKVUjPiyXySjWSdazw: posts big blind $0.25
*** HOLE CARDS ***
79ID/ub1Pt/mDpCprVmOoA: folds 
SS/yfeArhULzIcOPe8MdPg: folds 
4x9jCqgSw4272dnaIqnanw: folds 
Q3EMN7b0ie81AFWkDrhCjw: calls $0.25
QiL+lEgEWwy21jk/ltaRLg: calls $0.15
SH1WjKVUjPiyXySjWSdazw: checks 
*** FLOP *** [4h 4d 3h]
QiL+lEgEWwy21jk/ltaRLg: checks 
SH1WjKVUjPiyXySjWSdazw: checks 
Q3EMN7b0ie81AFWkDrhCjw: bets $0.50
QiL+lEgEWwy21jk/ltaRLg: folds 
SH1WjKVUjPiyXySjWSdazw: calls $0.50
*** TURN *** [4h 4d 3h] [7h]
SH1WjKVUjPiyXySjWSdazw: checks 
Q3EMN7b0ie81AFWkDrhCjw: checks 
*** RIVER *** [4h 4d 3h 7h] [Tc]
SH1WjKVUjPiyXySjWSdazw: checks 
Q3EMN7b0ie81AFWkDrhCjw: checks 
*** SHOW DOWN ***
SH1WjKVUjPiyXySjWSdazw: shows [9c Kh] (a pair of Fours)
Q3EMN7b0ie81AFWkDrhCjw: mucks hand 
SH1WjKVUjPiyXySjWSdazw collected $1.70 from pot
*** SUMMARY ***
Total pot $1.75 | Rake $0.05 
Board [4h 4d 3h 7h Tc]
Seat 1: Q3EMN7b0ie81AFWkDrhCjw (button) mucked
Seat 2: QiL+lEgEWwy21jk/ltaRLg (small blind) folded on the Flop
Seat 3: SH1WjKVUjPiyXySjWSdazw (big blind) showed [9c Kh] and won ($1.70) with a pair of Fours
Seat 4: 79ID/ub1Pt/mDpCprVmOoA folded before Flop (didn't bet)
Seat 5: SS/yfeArhULzIcOPe8MdPg folded before Flop (didn't bet)
Seat 6: 4x9jCqgSw4272dnaIqnanw folded before Flop (didn't bet)




PokerStars Game #59941563360:  Hold'em No Limit ($0.10/$0.25) - 2009/07/01 1:39:15 ET
Table 'biAgO3TKQBU8XcrVAoU5TA' 6-max Seat #4 is the button
Seat 1: jhDPlkir8wBYAddboBuF7Q ($16.25 in chips) 
Seat 2: GbCVUNssQ7mqsPWr7J4d3w ($4.65 in chips) 
Seat 3: mfrkWA3PTeYPkbO6hi98Aw ($30.65 in chips) 
Seat 4: Hsvkc0/G2VV78oVmWYXecw ($5 in chips) 
Seat 5: n6UPMnVR4v8LFP0rWP73Fg ($12.80 in chips) 
Seat 6: wMiE3yTbDJGOLOF9th7KPA ($10.35 in chips) 
n6UPMnVR4v8LFP0rWP73Fg: posts small blind $0.10
wMiE3yTbDJGOLOF9th7KPA: posts big blind $0.25
*** HOLE CARDS ***
jhDPlkir8wBYAddboBuF7Q: folds 
GbCVUNssQ7mqsPWr7J4d3w: raises $0.50 to $0.75
mfrkWA3PTeYPkbO6hi98Aw: folds 
Hsvkc0/G2VV78oVmWYXecw: folds 
n6UPMnVR4v8LFP0rWP73Fg: folds 
wMiE3yTbDJGOLOF9th7KPA: calls $0.50
*** FLOP *** [6c Kc 7c]
wMiE3yTbDJGOLOF9th7KPA: bets $0.25
GbCVUNssQ7mqsPWr7J4d3w: raises $1.25 to $1.50
wMiE3yTbDJGOLOF9th7KPA: folds 
Uncalled bet ($1.25) returned to GbCVUNssQ7mqsPWr7J4d3w
GbCVUNssQ7mqsPWr7J4d3w collected $2 from pot
GbCVUNssQ7mqsPWr7J4d3w: doesn't show hand 
*** SUMMARY ***
Total pot $2.10 | Rake $0.10 
Board [6c Kc 7c]
Seat 1: jhDPlkir8wBYAddboBuF7Q folded before Flop (didn't bet)
Seat 2: GbCVUNssQ7mqsPWr7J4d3w collected ($2)
Seat 3: mfrkWA3PTeYPkbO6hi98Aw folded before Flop (didn't bet)
Seat 4: Hsvkc0/G2VV78oVmWYXecw (button) folded before Flop (didn't bet)
Seat 5: n6UPMnVR4v8LFP0rWP73Fg (small blind) folded before Flop
Seat 6: wMiE3yTbDJGOLOF9th7KPA (big blind) folded on the Flop




PokerStars Game #59941563218:  Hold'em No Limit ($0.10/$0.25) - 2009/07/01 1:39:15 ET
Table 'ROYvQOMwUrvL3SOiHYcrWg' 9-max Seat #9 is the button
Seat 1: 22dIObOuor/A+IKWkNoAlA ($5 in chips) 
Seat 2: gehe91e0IyVT0QU/XBkEyg ($24.90 in chips) 
Seat 4: SHegmCn8B0InbWE/zFlvOw ($35.80 in chips) 
Seat 7: tYsOBqdU1+x+yFI7zHO7hQ ($26.15 in chips) 
Seat 8: biJWLZ27fafNeBI2oT1KJw ($22.65 in chips) 
Seat 9: uhrboV251dcgYniYTdFIcA ($25 in chips) 
22dIObOuor/A+IKWkNoAlA: posts small blind $0.10
gehe91e0IyVT0QU/XBkEyg: posts big blind $0.25
8EbrQ/EvFWt2cr0GaU82gQ: sits out 
7je+LC5Mfs6nL8YBVh4frQ: sits out 
P+9ymZQ3ktpQu1bn7HIjew: sits out 
*** HOLE CARDS ***
SHegmCn8B0InbWE/zFlvOw: folds 
tYsOBqdU1+x+yFI7zHO7hQ: folds 
biJWLZ27fafNeBI2oT1KJw: calls $0.25
uhrboV251dcgYniYTdFIcA: folds 
22dIObOuor/A+IKWkNoAlA: folds 
gehe91e0IyVT0QU/XBkEyg: checks 
*** FLOP *** [6h 7d 4h]
gehe91e0IyVT0QU/XBkEyg: checks 
biJWLZ27fafNeBI2oT1KJw: bets $0.50
gehe91e0IyVT0QU/XBkEyg: folds 
Uncalled bet ($0.50) returned to biJWLZ27fafNeBI2oT1KJw
biJWLZ27fafNeBI2oT1KJw collected $0.60 from pot
biJWLZ27fafNeBI2oT1KJw: doesn't show hand 
*** SUMMARY ***
Total pot $0.60 | Rake $0 
Board [6h 7d 4h]
Seat 1: 22dIObOuor/A+IKWkNoAlA (small blind) folded before Flop
Seat 2: gehe91e0IyVT0QU/XBkEyg (big blind) folded on the Flop
Seat 4: SHegmCn8B0InbWE/zFlvOw folded before Flop (didn't bet)
Seat 7: tYsOBqdU1+x+yFI7zHO7hQ folded before Flop (didn't bet)
Seat 8: biJWLZ27fafNeBI2oT1KJw collected ($0.60)
Seat 9: uhrboV251dcgYniYTdFIcA (button) folded before Flop (didn't bet)




PokerStars Game #59941563398:  Hold'em No Limit ($0.10/$0.25) - 2009/07/01 1:39:15 ET
Table 'IdXp6nyeW4FYaEK4qKCnwQ' 9-max Seat #4 is the button
Seat 1: tLcDklc2rBORNfixyRfVfw ($25 in chips) 
Seat 2: HPEB+AtKw1+C/cxU0o1ciw ($32.50 in chips) 
Seat 3: eK8qa6EPcH2zhtbmWSvc9g ($33.05 in chips) 
Seat 4: j4q3p0lesp63b1gZDwLBZw ($5 in chips) 
Seat 5: U41wNf6XauAiBOQaKu2ZIA ($27 in chips) 
Seat 6: arxNSjreDRGFg13EAM2F1w ($26.20 in chips) 
Seat 7: w1ukf8uPa4+WH561TtVRxA ($37.35 in chips) 
Seat 8: dtZ84flFEi4Q+SGrHMJRDQ ($29.85 in chips) 
Seat 9: s2xLPOl/vhl/26apJ3vsOQ ($28.65 in chips) 
U41wNf6XauAiBOQaKu2ZIA: posts small blind $0.10
arxNSjreDRGFg13EAM2F1w: posts big blind $0.25
*** HOLE CARDS ***
w1ukf8uPa4+WH561TtVRxA: folds 
dtZ84flFEi4Q+SGrHMJRDQ: folds 
s2xLPOl/vhl/26apJ3vsOQ: folds 
tLcDklc2rBORNfixyRfVfw: folds 
HPEB+AtKw1+C/cxU0o1ciw: folds 
eK8qa6EPcH2zhtbmWSvc9g: folds 
j4q3p0lesp63b1gZDwLBZw: raises $0.75 to $1
U41wNf6XauAiBOQaKu2ZIA: folds 
arxNSjreDRGFg13EAM2F1w: folds 
Uncalled bet ($0.75) returned to j4q3p0lesp63b1gZDwLBZw
j4q3p0lesp63b1gZDwLBZw collected $0.60 from pot
*** SUMMARY ***
Total pot $0.60 | Rake $0 
Seat 1: tLcDklc2rBORNfixyRfVfw folded before Flop (didn't bet)
Seat 2: HPEB+AtKw1+C/cxU0o1ciw folded before Flop (didn't bet)
Seat 3: eK8qa6EPcH2zhtbmWSvc9g folded before Flop (didn't bet)
Seat 4: j4q3p0lesp63b1gZDwLBZw (button) collected ($0.60)
Seat 5: U41wNf6XauAiBOQaKu2ZIA (small blind) folded before Flop
Seat 6: arxNSjreDRGFg13EAM2F1w (big blind) folded before Flop
Seat 7: w1ukf8uPa4+WH561TtVRxA folded before Flop (didn't bet)
Seat 8: dtZ84flFEi4Q+SGrHMJRDQ folded before Flop (didn't bet)
Seat 9: s2xLPOl/vhl/26apJ3vsOQ folded before Flop (didn't bet)




PokerStars Game #59941563260:  Hold'em No Limit ($0.10/$0.25) - 2009/07/01 1:39:15 ET
Table 'R5qKG21jwFDYRcOht9qwqQ' 9-max Seat #5 is the button
Seat 1: 3wjccGPzilKjAvTdTrc78g ($4.75 in chips) 
Seat 3: M2QO2DxB5Wawg2h8HSpnYA ($11.25 in chips) 
Seat 4: z5GxcHlYz/GSz6W2uFiTtg ($35.95 in chips) 
Seat 5: zUXhymECc2C9W9ZNw6qppA ($9.65 in chips) 
Seat 6: EP17SQz/iWcuYdNOGeBgkw ($15.90 in chips) 
Seat 7: Rv5cr9H+7nb4qG531vNiJA ($6 in chips) 
Seat 8: tYsOBqdU1+x+yFI7zHO7hQ ($35.30 in chips) 
Seat 9: MG90wfSJZnOejs/KD3vlQQ ($31.85 in chips) 
EP17SQz/iWcuYdNOGeBgkw: posts small blind $0.10
Rv5cr9H+7nb4qG531vNiJA: posts big blind $0.25
tptommy: sits out 
*** HOLE CARDS ***
tYsOBqdU1+x+yFI7zHO7hQ: folds 
MG90wfSJZnOejs/KD3vlQQ: folds 
3wjccGPzilKjAvTdTrc78g: calls $0.25
M2QO2DxB5Wawg2h8HSpnYA: calls $0.25
z5GxcHlYz/GSz6W2uFiTtg: calls $0.25
zUXhymECc2C9W9ZNw6qppA: folds 
EP17SQz/iWcuYdNOGeBgkw: calls $0.15
Rv5cr9H+7nb4qG531vNiJA: checks 
*** FLOP *** [7c Qh Kc]
EP17SQz/iWcuYdNOGeBgkw: checks 
Rv5cr9H+7nb4qG531vNiJA: checks 
3wjccGPzilKjAvTdTrc78g: checks 
M2QO2DxB5Wawg2h8HSpnYA: bets $1
z5GxcHlYz/GSz6W2uFiTtg: calls $1
EP17SQz/iWcuYdNOGeBgkw: folds 
Rv5cr9H+7nb4qG531vNiJA: folds 
3wjccGPzilKjAvTdTrc78g: folds 
*** TURN *** [7c Qh Kc] [8d]
M2QO2DxB5Wawg2h8HSpnYA: checks 
z5GxcHlYz/GSz6W2uFiTtg: checks 
*** RIVER *** [7c Qh Kc 8d] [5d]
M2QO2DxB5Wawg2h8HSpnYA: checks 
z5GxcHlYz/GSz6W2uFiTtg: checks 
*** SHOW DOWN ***
M2QO2DxB5Wawg2h8HSpnYA: shows [Js Ks] (a pair of Kings)
z5GxcHlYz/GSz6W2uFiTtg: mucks hand 
M2QO2DxB5Wawg2h8HSpnYA collected $3.10 from pot
*** SUMMARY ***
Total pot $3.25 | Rake $0.15 
Board [7c Qh Kc 8d 5d]
Seat 1: 3wjccGPzilKjAvTdTrc78g folded on the Flop
Seat 3: M2QO2DxB5Wawg2h8HSpnYA showed [Js Ks] and won ($3.10) with a pair of Kings
Seat 4: z5GxcHlYz/GSz6W2uFiTtg mucked
Seat 5: zUXhymECc2C9W9ZNw6qppA (button) folded before Flop (didn't bet)
Seat 6: EP17SQz/iWcuYdNOGeBgkw (small blind) folded on the Flop
Seat 7: Rv5cr9H+7nb4qG531vNiJA (big blind) folded on the Flop
Seat 8: tYsOBqdU1+x+yFI7zHO7hQ folded before Flop (didn't bet)
Seat 9: MG90wfSJZnOejs/KD3vlQQ folded before Flop (didn't bet)




PokerStars Game #59941563520:  Hold'em No Limit ($0.10/$0.25) - 2009/07/01 1:39:15 ET
Table 'yAHDCs33TIgw3ra63xuU2Q' 9-max Seat #1 is the button
Seat 1: ydoFOVgzvZv9ZhuWu9rXAw ($4.90 in chips) 
Seat 3: g6UPjSyxNLffCi+EqqIlEg ($18.45 in chips) 
Seat 4: j5spkbnOCRiLGiH6iqBaqw ($10.50 in chips) 
Seat 5: 4awUyiDYTgylQKXZ9faBVA ($37.95 in chips) 
Seat 6: DnDcAdn9P0zGovMERigpFA ($25 in chips) 
Seat 7: qxWFg3MZuVyidB0SJh5ywg ($27.40 in chips) 
Seat 8: tYsOBqdU1+x+yFI7zHO7hQ ($25.35 in chips) 
Seat 9: MtVtHDqIJTyUcXkRBBDIVA ($25.80 in chips) 
g6UPjSyxNLffCi+EqqIlEg: posts small blind $0.10
j5spkbnOCRiLGiH6iqBaqw: posts big blind $0.25
*** HOLE CARDS ***
4awUyiDYTgylQKXZ9faBVA: folds 
DnDcAdn9P0zGovMERigpFA: folds 
qxWFg3MZuVyidB0SJh5ywg: folds 
tYsOBqdU1+x+yFI7zHO7hQ: raises $0.75 to $1
MtVtHDqIJTyUcXkRBBDIVA: folds 
ydoFOVgzvZv9ZhuWu9rXAw: folds 
g6UPjSyxNLffCi+EqqIlEg: folds 
j5spkbnOCRiLGiH6iqBaqw: folds 
Uncalled bet ($0.75) returned to tYsOBqdU1+x+yFI7zHO7hQ
tYsOBqdU1+x+yFI7zHO7hQ collected $0.60 from pot
tYsOBqdU1+x+yFI7zHO7hQ: doesn't show hand 
*** SUMMARY ***
Total pot $0.60 | Rake $0 
Seat 1: ydoFOVgzvZv9ZhuWu9rXAw (button) folded before Flop (didn't bet)
Seat 3: g6UPjSyxNLffCi+EqqIlEg (small blind) folded before Flop
Seat 4: j5spkbnOCRiLGiH6iqBaqw (big blind) folded before Flop
Seat 5: 4awUyiDYTgylQKXZ9faBVA folded before Flop (didn't bet)
Seat 6: DnDcAdn9P0zGovMERigpFA folded before Flop (didn't bet)
Seat 7: qxWFg3MZuVyidB0SJh5ywg folded before Flop (didn't bet)
Seat 8: tYsOBqdU1+x+yFI7zHO7hQ collected ($0.60)
Seat 9: MtVtHDqIJTyUcXkRBBDIVA folded before Flop (didn't bet)




PokerStars Game #59941563434:  Hold'em No Limit ($0.10/$0.25) - 2009/07/01 1:39:15 ET
Table 'iMiAw/kTZXopgYX4HI7sHg' 9-max Seat #4 is the button
Seat 1: PdIasPkzm2sqZnN41ZRXOg ($4.90 in chips) 
Seat 2: qwr38jl5txoR36M7G5qi4A ($8.65 in chips) 
Seat 3: HPEB+AtKw1+C/cxU0o1ciw ($28.25 in chips) 
Seat 4: eK8qa6EPcH2zhtbmWSvc9g ($32.40 in chips) 
Seat 5: 22dIObOuor/A+IKWkNoAlA ($5.20 in chips) 
Seat 6: Bb42QRQMhg5/Y0vHP8/2Xw ($26.15 in chips) 
Seat 8: tLcDklc2rBORNfixyRfVfw ($25 in chips) 
Seat 9: K36tHfxDQBx3OFpy0baDPA ($29.50 in chips) 
22dIObOuor/A+IKWkNoAlA: posts small blind $0.10
Bb42QRQMhg5/Y0vHP8/2Xw: posts big blind $0.25
*** HOLE CARDS ***
tLcDklc2rBORNfixyRfVfw: folds 
ljkBp5cvgbHARUIwY5vUuA joins the table at seat #7 
K36tHfxDQBx3OFpy0baDPA: calls $0.25
PdIasPkzm2sqZnN41ZRXOg: folds 
qwr38jl5txoR36M7G5qi4A: raises $0.50 to $0.75
HPEB+AtKw1+C/cxU0o1ciw: folds 
eK8qa6EPcH2zhtbmWSvc9g: folds 
22dIObOuor/A+IKWkNoAlA: folds 
Bb42QRQMhg5/Y0vHP8/2Xw: raises $1.25 to $2
K36tHfxDQBx3OFpy0baDPA: calls $1.75
qwr38jl5txoR36M7G5qi4A: folds 
*** FLOP *** [2d Qd As]
Bb42QRQMhg5/Y0vHP8/2Xw: bets $1.50
K36tHfxDQBx3OFpy0baDPA: folds 
Uncalled bet ($1.50) returned to Bb42QRQMhg5/Y0vHP8/2Xw
Bb42QRQMhg5/Y0vHP8/2Xw collected $4.65 from pot
*** SUMMARY ***
Total pot $4.85 | Rake $0.20 
Board [2d Qd As]
Seat 1: PdIasPkzm2sqZnN41ZRXOg folded before Flop (didn't bet)
Seat 2: qwr38jl5txoR36M7G5qi4A folded before Flop
Seat 3: HPEB+AtKw1+C/cxU0o1ciw folded before Flop (didn't bet)
Seat 4: eK8qa6EPcH2zhtbmWSvc9g (button) folded before Flop (didn't bet)
Seat 5: 22dIObOuor/A+IKWkNoAlA (small blind) folded before Flop
Seat 6: Bb42QRQMhg5/Y0vHP8/2Xw (big blind) collected ($4.65)
Seat 8: tLcDklc2rBORNfixyRfVfw folded before Flop (didn't bet)
Seat 9: K36tHfxDQBx3OFpy0baDPA folded on the Flop




PokerStars Game #59941563358:  Hold'em No Limit ($0.10/$0.25) - 2009/07/01 1:39:15 ET
Table 'm+FQg/QP0VP1ZA3V62WtOg' 9-max Seat #3 is the button
Seat 3: CaqT0VOqu9mwT73mnpvfoA ($8.95 in chips) 
Seat 4: qB12xUq3ftb2y8oTnNQzsg ($3.50 in chips) 
Seat 5: mWm7RBYWw02boCWy2a7aDQ ($4.35 in chips) 
Seat 7: TPAF9YkMsjQFq978RNWZEQ ($10.30 in chips) 
Seat 9: zUXhymECc2C9W9ZNw6qppA ($10.90 in chips) 
qB12xUq3ftb2y8oTnNQzsg: posts small blind $0.10
mWm7RBYWw02boCWy2a7aDQ: posts big blind $0.25
*** HOLE CARDS ***
TPAF9YkMsjQFq978RNWZEQ: calls $0.25
zUXhymECc2C9W9ZNw6qppA: folds 
CaqT0VOqu9mwT73mnpvfoA: folds 
CaqT0VOqu9mwT73mnpvfoA leaves the table
qB12xUq3ftb2y8oTnNQzsg: calls $0.15
mWm7RBYWw02boCWy2a7aDQ: checks 
*** FLOP *** [Qc 6s 9s]
qB12xUq3ftb2y8oTnNQzsg: bets $0.25
mWm7RBYWw02boCWy2a7aDQ: calls $0.25
TPAF9YkMsjQFq978RNWZEQ: calls $0.25
*** TURN *** [Qc 6s 9s] [Kd]
qB12xUq3ftb2y8oTnNQzsg: checks 
mWm7RBYWw02boCWy2a7aDQ: bets $0.50
TPAF9YkMsjQFq978RNWZEQ: raises $0.50 to $1
qB12xUq3ftb2y8oTnNQzsg: folds 
mWm7RBYWw02boCWy2a7aDQ: calls $0.50
*** RIVER *** [Qc 6s 9s Kd] [As]
mWm7RBYWw02boCWy2a7aDQ: checks 
TPAF9YkMsjQFq978RNWZEQ: bets $2.75
mWm7RBYWw02boCWy2a7aDQ: calls $2.75
*** SHOW DOWN ***
TPAF9YkMsjQFq978RNWZEQ: shows [Ac Qs] (two pair, Aces and Queens)
mWm7RBYWw02boCWy2a7aDQ: mucks hand 
TPAF9YkMsjQFq978RNWZEQ collected $8.60 from pot
*** SUMMARY ***
Total pot $9 | Rake $0.40 
Board [Qc 6s 9s Kd As]
Seat 3: CaqT0VOqu9mwT73mnpvfoA (button) folded before Flop (didn't bet)
Seat 4: qB12xUq3ftb2y8oTnNQzsg (small blind) folded on the Turn
Seat 5: mWm7RBYWw02boCWy2a7aDQ (big blind) mucked
Seat 7: TPAF9YkMsjQFq978RNWZEQ showed [Ac Qs] and won ($8.60) with two pair, Aces and Queens
Seat 9: zUXhymECc2C9W9ZNw6qppA folded before Flop (didn't bet)




PokerStars Game #59941563038:  Hold'em No Limit ($0.10/$0.25) - 2009/07/01 1:39:15 ET
Table 'fHv1Mk7ZbLjprZTGWKPiEQ' 6-max Seat #4 is the button
Seat 3: /gJNBeCkWL4o85/jvlZ4BA ($25.35 in chips) 
Seat 4: TSmua8tGK3sTbwi0ynrW9Q ($53.25 in chips) 
Seat 5: LJI7A1YgDM7hgh7o56+ReQ ($26.90 in chips) 
Seat 6: AjG0X+rNtc2W08eph8oqpw ($35.15 in chips) 
LJI7A1YgDM7hgh7o56+ReQ: posts small blind $0.10
AjG0X+rNtc2W08eph8oqpw: posts big blind $0.25
*** HOLE CARDS ***
/gJNBeCkWL4o85/jvlZ4BA: folds 
nollet leaves the table
TSmua8tGK3sTbwi0ynrW9Q: folds 
LJI7A1YgDM7hgh7o56+ReQ: folds 
Uncalled bet ($0.15) returned to AjG0X+rNtc2W08eph8oqpw
AjG0X+rNtc2W08eph8oqpw collected $0.20 from pot
AjG0X+rNtc2W08eph8oqpw: doesn't show hand 
*** SUMMARY ***
Total pot $0.20 | Rake $0 
Seat 3: /gJNBeCkWL4o85/jvlZ4BA folded before Flop (didn't bet)
Seat 4: TSmua8tGK3sTbwi0ynrW9Q (button) folded before Flop (didn't bet)
Seat 5: LJI7A1YgDM7hgh7o56+ReQ (small blind) folded before Flop
Seat 6: AjG0X+rNtc2W08eph8oqpw (big blind) collected ($0.20)




PokerStars Game #59941563774:  Hold'em No Limit ($0.10/$0.25) - 2009/07/01 1:39:16 ET
Table 'Y9EhDWuqWWQFM9SelXAj5g' 9-max Seat #4 is the button
Seat 1: zDrucyjVn5aeekNEc3cJrA ($28.40 in chips) 
Seat 3: zgi+EUykT/pZQpoUG6+oEg ($4.40 in chips) 
Seat 4: V6p0jQ/RhUsqpHLmXvEX4Q ($14.60 in chips) 
Seat 5: CvL9Ch1HYCVbTsfpNucitg ($5.55 in chips) 
Seat 6: egvg3mTBBVzMHnJPIQiKcA ($14.35 in chips) 
Seat 7: aNpwfA31EREwO+ar4XzBCw ($26.95 in chips) 
Seat 8: XDxyajtqmdag0QPvwcOG7Q ($14.10 in chips) 
Seat 9: bOrfviVhRBpaOfMqUc74Tw ($19.15 in chips) 
CvL9Ch1HYCVbTsfpNucitg: posts small blind $0.10
egvg3mTBBVzMHnJPIQiKcA: posts big blind $0.25
*** HOLE CARDS ***
aNpwfA31EREwO+ar4XzBCw: folds 
XDxyajtqmdag0QPvwcOG7Q: folds 
bOrfviVhRBpaOfMqUc74Tw: folds 
zDrucyjVn5aeekNEc3cJrA: folds 
zgi+EUykT/pZQpoUG6+oEg: raises $0.50 to $0.75
V6p0jQ/RhUsqpHLmXvEX4Q: folds 
CvL9Ch1HYCVbTsfpNucitg: folds 
egvg3mTBBVzMHnJPIQiKcA: folds 
Uncalled bet ($0.50) returned to zgi+EUykT/pZQpoUG6+oEg
zgi+EUykT/pZQpoUG6+oEg collected $0.60 from pot
zgi+EUykT/pZQpoUG6+oEg: doesn't show hand 
*** SUMMARY ***
Total pot $0.60 | Rake $0 
Seat 1: zDrucyjVn5aeekNEc3cJrA folded before Flop (didn't bet)
Seat 3: zgi+EUykT/pZQpoUG6+oEg collected ($0.60)
Seat 4: V6p0jQ/RhUsqpHLmXvEX4Q (button) folded before Flop (didn't bet)
Seat 5: CvL9Ch1HYCVbTsfpNucitg (small blind) folded before Flop
Seat 6: egvg3mTBBVzMHnJPIQiKcA (big blind) folded before Flop
Seat 7: aNpwfA31EREwO+ar4XzBCw folded before Flop (didn't bet)
Seat 8: XDxyajtqmdag0QPvwcOG7Q folded before Flop (didn't bet)
Seat 9: bOrfviVhRBpaOfMqUc74Tw folded before Flop (didn't bet)




PokerStars Game #59941564008:  Hold'em No Limit ($0.10/$0.25) - 2009/07/01 1:39:16 ET
Table 'nc6OeGk/wtaWV+6N+kgnZQgZetDqJh6q9A3mLO3ThCsASeat #3 is the button
Seat 1: DihMHaz4WNETH1bPDe13kA ($26.65 in chips) 
Seat 2: JFIAqU8lCZ0vWwEl4bdGsg ($33.05 in chips) 
Seat 3: jp34e617tIzV8tKIWmfAbA ($33.15 in chips) 
Seat 4: BV+K0Phf5VBHr7aZPKqbUQ ($28.40 in chips) 
Seat 6: 8tR2s7yV/Fr0ePp1w5XnJw ($10 in chips) 
BV+K0Phf5VBHr7aZPKqbUQ: posts small blind $0.10
mfrkWA3PTeYPkbO6hi98Aw: is sitting out 
8tR2s7yV/Fr0ePp1w5XnJw: posts big blind $0.25
*** HOLE CARDS ***
mfrkWA3PTeYPkbO6hi98Aw leaves the table
DihMHaz4WNETH1bPDe13kA: folds 
JFIAqU8lCZ0vWwEl4bdGsg: folds 
jp34e617tIzV8tKIWmfAbA: folds 
BV+K0Phf5VBHr7aZPKqbUQ: raises $0.50 to $0.75
8tR2s7yV/Fr0ePp1w5XnJw: folds 
Uncalled bet ($0.50) returned to BV+K0Phf5VBHr7aZPKqbUQ
BV+K0Phf5VBHr7aZPKqbUQ collected $0.50 from pot
BV+K0Phf5VBHr7aZPKqbUQ: doesn't show hand 
*** SUMMARY ***
Total pot $0.50 | Rake $0 
Seat 1: DihMHaz4WNETH1bPDe13kA folded before Flop (didn't bet)
Seat 2: JFIAqU8lCZ0vWwEl4bdGsg folded before Flop (didn't bet)
Seat 3: jp34e617tIzV8tKIWmfAbA (button) folded before Flop (didn't bet)
Seat 4: BV+K0Phf5VBHr7aZPKqbUQ (small blind) collected ($0.50)
Seat 6: 8tR2s7yV/Fr0ePp1w5XnJw (big blind) folded before Flop




PokerStars Game #59941563894:  Hold'em No Limit ($0.10/$0.25) - 2009/07/01 1:39:16 ET
Table 'C47I7CmrmFr8Oo7wOovVwQ' 6-max Seat #2 is the button
Seat 2: hOaWAImn5/MZDAWAPlYHCw ($5 in chips) 
Seat 4: yY5JuFtDfXWRaZlVby4LLw ($17.50 in chips) 
hOaWAImn5/MZDAWAPlYHCw: posts small blind $0.10
yY5JuFtDfXWRaZlVby4LLw: posts big blind $0.25
*** HOLE CARDS ***
hOaWAImn5/MZDAWAPlYHCw: raises $0.25 to $0.50
H+8eOP3XJHXjACRDTiIHTQ joins the table at seat #3 
yY5JuFtDfXWRaZlVby4LLw: calls $0.25
*** FLOP *** [8d Qs 8c]
yY5JuFtDfXWRaZlVby4LLw: checks 
pD7ri5wL3vsa6S1ulMYQmQ joins the table at seat #6 
hOaWAImn5/MZDAWAPlYHCw: bets $0.75
yY5JuFtDfXWRaZlVby4LLw: folds 
Uncalled bet ($0.75) returned to hOaWAImn5/MZDAWAPlYHCw
hOaWAImn5/MZDAWAPlYHCw collected $0.95 from pot
*** SUMMARY ***
Total pot $1 | Rake $0.05 
Board [8d Qs 8c]
Seat 2: hOaWAImn5/MZDAWAPlYHCw (button) (small blind) collected ($0.95)
Seat 4: yY5JuFtDfXWRaZlVby4LLw (big blind) folded on the Flop




PokerStars Game #59941563636:  Hold'em No Limit ($0.10/$0.25) - 2009/07/01 1:39:16 ET
Table 'RUOqTfzbAVGS5x+J9aZMHA' 9-max Seat #5 is the button
Seat 1: DnDcAdn9P0zGovMERigpFA ($25 in chips) 
Seat 2: Z5ZtGOON8kmSdSCll9Z3XA ($8.35 in chips) 
Seat 3: Th3FldXKQW6hWVVPahaoOQ ($25 in chips) 
Seat 4: K9Az8li/CO2TicltVWKamA ($41.20 in chips) 
Seat 5: MtVtHDqIJTyUcXkRBBDIVA ($31.30 in chips) 
Seat 6: ljemhp25Zg+nlA9DLCIiUw ($37.80 in chips) 
Seat 7: zgi+EUykT/pZQpoUG6+oEg ($4.65 in chips) 
Seat 8: dfNim92Z6XK1/h5SFW5vDg ($25 in chips) 
Seat 9: cZ99hugmLBj9KhTlc8nCSw ($25 in chips) 
ljemhp25Zg+nlA9DLCIiUw: posts small blind $0.10
zgi+EUykT/pZQpoUG6+oEg: posts big blind $0.25
*** HOLE CARDS ***
dfNim92Z6XK1/h5SFW5vDg: folds 
cZ99hugmLBj9KhTlc8nCSw: folds 
DnDcAdn9P0zGovMERigpFA: folds 
Z5ZtGOON8kmSdSCll9Z3XA: folds 
Th3FldXKQW6hWVVPahaoOQ: folds 
K9Az8li/CO2TicltVWKamA: folds 
MtVtHDqIJTyUcXkRBBDIVA: raises $0.50 to $0.75
ljemhp25Zg+nlA9DLCIiUw: raises $1.75 to $2.50
zgi+EUykT/pZQpoUG6+oEg: folds 
MtVtHDqIJTyUcXkRBBDIVA: folds 
Uncalled bet ($1.75) returned to ljemhp25Zg+nlA9DLCIiUw
ljemhp25Zg+nlA9DLCIiUw collected $1.75 from pot
ljemhp25Zg+nlA9DLCIiUw: doesn't show hand 
*** SUMMARY ***
Total pot $1.75 | Rake $0 
Seat 1: DnDcAdn9P0zGovMERigpFA folded before Flop (didn't bet)
Seat 2: Z5ZtGOON8kmSdSCll9Z3XA folded before Flop (didn't bet)
Seat 3: Th3FldXKQW6hWVVPahaoOQ folded before Flop (didn't bet)
Seat 4: K9Az8li/CO2TicltVWKamA folded before Flop (didn't bet)
Seat 5: MtVtHDqIJTyUcXkRBBDIVA (button) folded before Flop
Seat 6: ljemhp25Zg+nlA9DLCIiUw (small blind) collected ($1.75)
Seat 7: zgi+EUykT/pZQpoUG6+oEg (big blind) folded before Flop
Seat 8: dfNim92Z6XK1/h5SFW5vDg folded before Flop (didn't bet)
Seat 9: cZ99hugmLBj9KhTlc8nCSw folded before Flop (didn't bet)




PokerStars Game #59941564456:  Hold'em No Limit ($0.10/$0.25) - 2009/07/01 1:39:17 ET
Table 'BabJGL6tfXQp3leBGbYe8A' 9-max Seat #4 is the button
Seat 1: qwr38jl5txoR36M7G5qi4A ($7.50 in chips) 
Seat 2: dtZ84flFEi4Q+SGrHMJRDQ ($36 in chips) 
Seat 3: sD+TKtt36XiiN6jqHiLwDA ($25.45 in chips) 
Seat 4: gehe91e0IyVT0QU/XBkEyg ($28.45 in chips) 
Seat 5: GrNTWMdwy+jC6Lred1eDng ($14.50 in chips) 
Seat 6: egvg3mTBBVzMHnJPIQiKcA ($14.30 in chips) 
Seat 7: eK8qa6EPcH2zhtbmWSvc9g ($27.85 in chips) 
Seat 8: OgISYvc5hA85YuDnsXCH+Q ($22.25 in chips) 
GrNTWMdwy+jC6Lred1eDng: posts small blind $0.10
egvg3mTBBVzMHnJPIQiKcA: posts big blind $0.25
P+9ymZQ3ktpQu1bn7HIjew: sits out 
*** HOLE CARDS ***
eK8qa6EPcH2zhtbmWSvc9g: folds 
OgISYvc5hA85YuDnsXCH+Q: folds 
qwr38jl5txoR36M7G5qi4A: folds 
dtZ84flFEi4Q+SGrHMJRDQ: folds 
sD+TKtt36XiiN6jqHiLwDA: folds 
gehe91e0IyVT0QU/XBkEyg: folds 
GrNTWMdwy+jC6Lred1eDng: folds 
Uncalled bet ($0.15) returned to egvg3mTBBVzMHnJPIQiKcA
egvg3mTBBVzMHnJPIQiKcA collected $0.20 from pot
egvg3mTBBVzMHnJPIQiKcA: doesn't show hand 
*** SUMMARY ***
Total pot $0.20 | Rake $0 
Seat 1: qwr38jl5txoR36M7G5qi4A folded before Flop (didn't bet)
Seat 2: dtZ84flFEi4Q+SGrHMJRDQ folded before Flop (didn't bet)
Seat 3: sD+TKtt36XiiN6jqHiLwDA folded before Flop (didn't bet)
Seat 4: gehe91e0IyVT0QU/XBkEyg (button) folded before Flop (didn't bet)
Seat 5: GrNTWMdwy+jC6Lred1eDng (small blind) folded before Flop
Seat 6: egvg3mTBBVzMHnJPIQiKcA (big blind) collected ($0.20)
Seat 7: eK8qa6EPcH2zhtbmWSvc9g folded before Flop (didn't bet)
Seat 8: OgISYvc5hA85YuDnsXCH+Q folded before Flop (didn't bet)




PokerStars Game #59941564384:  Hold'em No Limit ($0.10/$0.25) - 2009/07/01 1:39:17 ET
Table '2AUmC2Rslg+QUbLfdgNdfg' 6-max Seat #1 is the button
Seat 1: YDXAegrCnzc0l6TSDNboXQ ($24.60 in chips) 
Seat 2: PLksyNlTVRVZwxJVC2/1eA ($23.95 in chips) 
Seat 3: JFIAqU8lCZ0vWwEl4bdGsg ($25.35 in chips) 
Seat 4: lquriepNQBhDV5P1SWHhnA ($26.35 in chips) 
Seat 5: AMc4cCwUJhokdGRYIaVPhQ ($21.90 in chips) 
Seat 6: xBWc54v+UTSJOiKpbAbJWg ($12.20 in chips) 
PLksyNlTVRVZwxJVC2/1eA: posts small blind $0.10
JFIAqU8lCZ0vWwEl4bdGsg: posts big blind $0.25
*** HOLE CARDS ***
lquriepNQBhDV5P1SWHhnA: folds 
AMc4cCwUJhokdGRYIaVPhQ: folds 
xBWc54v+UTSJOiKpbAbJWg: folds 
YDXAegrCnzc0l6TSDNboXQ: folds 
PLksyNlTVRVZwxJVC2/1eA: folds 
Uncalled bet ($0.15) returned to JFIAqU8lCZ0vWwEl4bdGsg
JFIAqU8lCZ0vWwEl4bdGsg collected $0.20 from pot
JFIAqU8lCZ0vWwEl4bdGsg: doesn't show hand 
*** SUMMARY ***
Total pot $0.20 | Rake $0 
Seat 1: YDXAegrCnzc0l6TSDNboXQ (button) folded before Flop (didn't bet)
Seat 2: PLksyNlTVRVZwxJVC2/1eA (small blind) folded before Flop
Seat 3: JFIAqU8lCZ0vWwEl4bdGsg (big blind) collected ($0.20)
Seat 4: lquriepNQBhDV5P1SWHhnA folded before Flop (didn't bet)
Seat 5: AMc4cCwUJhokdGRYIaVPhQ folded before Flop (didn't bet)
Seat 6: xBWc54v+UTSJOiKpbAbJWg folded before Flop (didn't bet)




PokerStars Game #59941564246:  Hold'em No Limit ($0.10/$0.25) - 2009/07/01 1:39:17 ET
Table 'b64Z+5XI1xkQzNfq4QHr3A' 6-max Seat #3 is the button
Seat 1: qccGLncfUaN00Few5HsgYg ($71.20 in chips) 
Seat 2: SS/yfeArhULzIcOPe8MdPg ($31.35 in chips) 
Seat 3: u/yN5P9f3KlATg6WLWNkBQ ($32.90 in chips) 
Seat 4: SxIIgwXYLkwd6m3wLyPTCw ($20.15 in chips) 
Seat 5: JFIAqU8lCZ0vWwEl4bdGsg ($29.85 in chips) 
Seat 6: 8ClCHtFXGNplITm+63KB+Q ($35.50 in chips) 
SxIIgwXYLkwd6m3wLyPTCw: posts small blind $0.10
JFIAqU8lCZ0vWwEl4bdGsg: posts big blind $0.25
*** HOLE CARDS ***
8ClCHtFXGNplITm+63KB+Q: folds 
qccGLncfUaN00Few5HsgYg: folds 
SS/yfeArhULzIcOPe8MdPg: raises $0.75 to $1
u/yN5P9f3KlATg6WLWNkBQ: calls $1
SxIIgwXYLkwd6m3wLyPTCw: calls $0.90
JFIAqU8lCZ0vWwEl4bdGsg: calls $0.75
*** FLOP *** [As 6s 6c]
SxIIgwXYLkwd6m3wLyPTCw: checks 
JFIAqU8lCZ0vWwEl4bdGsg: bets $2.50
SS/yfeArhULzIcOPe8MdPg: calls $2.50
u/yN5P9f3KlATg6WLWNkBQ: folds 
SxIIgwXYLkwd6m3wLyPTCw: folds 
*** TURN *** [As 6s 6c] [7d]
JFIAqU8lCZ0vWwEl4bdGsg: bets $4
SS/yfeArhULzIcOPe8MdPg: calls $4
*** RIVER *** [As 6s 6c 7d] [3c]
JFIAqU8lCZ0vWwEl4bdGsg: bets $22.35 and is all-in
SS/yfeArhULzIcOPe8MdPg: calls $22.35
*** SHOW DOWN ***
JFIAqU8lCZ0vWwEl4bdGsg: shows [6h 7h] (a full house, Sixes full of Sevens)
SS/yfeArhULzIcOPe8MdPg: mucks hand 
SS/yfeArhULzIcOPe8MdPg said, "nh"
JFIAqU8lCZ0vWwEl4bdGsg collected $58.70 from pot
*** SUMMARY ***
Total pot $61.70 | Rake $3 
Board [As 6s 6c 7d 3c]
Seat 1: qccGLncfUaN00Few5HsgYg folded before Flop (didn't bet)
Seat 2: SS/yfeArhULzIcOPe8MdPg mucked
Seat 3: u/yN5P9f3KlATg6WLWNkBQ (button) folded on the Flop
Seat 4: SxIIgwXYLkwd6m3wLyPTCw (small blind) folded on the Flop
Seat 5: JFIAqU8lCZ0vWwEl4bdGsg (big blind) showed [6h 7h] and won ($58.70) with a full house, Sixes full of Sevens
Seat 6: 8ClCHtFXGNplITm+63KB+Q folded before Flop (didn't bet)




PokerStars Game #59941564120:  Hold'em No Limit ($0.10/$0.25) - 2009/07/01 1:39:17 ET
Table 'AHkg4ChqzcMauBx6Qvz8Nw' 6-max Seat #1 is the button
Seat 1: +RDf7SmUjY2kK0PzdBEYqg ($4.85 in chips) 
Seat 2: Vi0JMrTI2BGrPL7UIulJtA ($4.95 in chips) 
Seat 3: 9dToMv2GJLfi00HcpfMnIw ($25 in chips) 
Seat 4: Eznneya0vB6S+eXJdVleHA ($20.05 in chips) 
Seat 5: Bada343Si4xKu3fNXY99AA ($5.50 in chips) 
Seat 6: Hsvkc0/G2VV78oVmWYXecw ($5.10 in chips) 
Vi0JMrTI2BGrPL7UIulJtA: posts small blind $0.10
9dToMv2GJLfi00HcpfMnIw: posts big blind $0.25
*** HOLE CARDS ***
Eznneya0vB6S+eXJdVleHA: calls $0.25
Bada343Si4xKu3fNXY99AA: calls $0.25
Hsvkc0/G2VV78oVmWYXecw: folds 
+RDf7SmUjY2kK0PzdBEYqg: calls $0.25
Vi0JMrTI2BGrPL7UIulJtA: calls $0.15
9dToMv2GJLfi00HcpfMnIw: checks 
*** FLOP *** [8s 8c 4s]
Eznneya0vB6S+eXJdVleHA said, " lol that always happens"
Vi0JMrTI2BGrPL7UIulJtA: bets $0.25
9dToMv2GJLfi00HcpfMnIw: folds 
Eznneya0vB6S+eXJdVleHA: folds 
Bada343Si4xKu3fNXY99AA: folds 
+RDf7SmUjY2kK0PzdBEYqg: folds 
Uncalled bet ($0.25) returned to Vi0JMrTI2BGrPL7UIulJtA
Vi0JMrTI2BGrPL7UIulJtA collected $1.20 from pot
*** SUMMARY ***
Total pot $1.25 | Rake $0.05 
Board [8s 8c 4s]
Seat 1: +RDf7SmUjY2kK0PzdBEYqg (button) folded on the Flop
Seat 2: Vi0JMrTI2BGrPL7UIulJtA (small blind) collected ($1.20)
Seat 3: 9dToMv2GJLfi00HcpfMnIw (big blind) folded on the Flop
Seat 4: Eznneya0vB6S+eXJdVleHA folded on the Flop
Seat 5: Bada343Si4xKu3fNXY99AA folded on the Flop
Seat 6: Hsvkc0/G2VV78oVmWYXecw folded before Flop (didn't bet)




PokerStars Game #59941564118:  Hold'em No Limit ($0.10/$0.25) - 2009/07/01 1:39:17 ET
Table 'Qr+t8WGovMECkBv+cV1lrg' 6-max Seat #1 is the button
Seat 1: EeUZtMU058v2ObUACOF4Og ($47.95 in chips) 
Seat 2: GJsS3gwVwlbyroaWrnjqJg ($41.50 in chips) 
Seat 3: uZKkrGByYgd4/ZBX2d4z+w ($18.65 in chips) 
Seat 4: 1NNFfYMd5Hsphl/FYz9fNA ($65.30 in chips) 
Seat 5: 9q7YGTKe9k5fYb4fmZc3Ww ($35 in chips) 
Seat 6: xRkU4+naLuz7dEZFbOn9cw ($25 in chips) 
GJsS3gwVwlbyroaWrnjqJg: posts small blind $0.10
uZKkrGByYgd4/ZBX2d4z+w: posts big blind $0.25
*** HOLE CARDS ***
1NNFfYMd5Hsphl/FYz9fNA: raises $0.50 to $0.75
9q7YGTKe9k5fYb4fmZc3Ww: folds 
xRkU4+naLuz7dEZFbOn9cw: folds 
EeUZtMU058v2ObUACOF4Og: raises $1 to $1.75
GJsS3gwVwlbyroaWrnjqJg: folds 
uZKkrGByYgd4/ZBX2d4z+w: folds 
1NNFfYMd5Hsphl/FYz9fNA: calls $1
*** FLOP *** [Kh Qh 8c]
1NNFfYMd5Hsphl/FYz9fNA: checks 
EeUZtMU058v2ObUACOF4Og: bets $2.75
1NNFfYMd5Hsphl/FYz9fNA: calls $2.75
*** TURN *** [Kh Qh 8c] [2c]
1NNFfYMd5Hsphl/FYz9fNA: checks 
EeUZtMU058v2ObUACOF4Og: checks 
*** RIVER *** [Kh Qh 8c 2c] [3s]
1NNFfYMd5Hsphl/FYz9fNA: checks 
EeUZtMU058v2ObUACOF4Og: checks 
*** SHOW DOWN ***
1NNFfYMd5Hsphl/FYz9fNA: shows [Th 9h] (high card King)
EeUZtMU058v2ObUACOF4Og: shows [Ad Qd] (a pair of Queens)
EeUZtMU058v2ObUACOF4Og collected $8.90 from pot
*** SUMMARY ***
Total pot $9.35 | Rake $0.45 
Board [Kh Qh 8c 2c 3s]
Seat 1: EeUZtMU058v2ObUACOF4Og (button) showed [Ad Qd] and won ($8.90) with a pair of Queens
Seat 2: GJsS3gwVwlbyroaWrnjqJg (small blind) folded before Flop
Seat 3: uZKkrGByYgd4/ZBX2d4z+w (big blind) folded before Flop
Seat 4: 1NNFfYMd5Hsphl/FYz9fNA showed [Th 9h] and lost with high card King
Seat 5: 9q7YGTKe9k5fYb4fmZc3Ww folded before Flop (didn't bet)
Seat 6: xRkU4+naLuz7dEZFbOn9cw folded before Flop (didn't bet)




PokerStars Game #59941564842:  Hold'em No Limit ($0.10/$0.25) - 2009/07/01 1:39:18 ET
Table 'vZfV/Uj0q8joA1du9sRJSg' 6-max Seat #6 is the button
Seat 1: Hsvkc0/G2VV78oVmWYXecw ($5 in chips) 
Seat 2: wMiE3yTbDJGOLOF9th7KPA ($11.55 in chips) 
Seat 3: cWc85bEzdRzpUMhRKm8pwQ ($25.25 in chips) 
Seat 4: v+QfkGiuj9bgtuNoVnDO8w ($40.50 in chips) 
Seat 5: kyRaCIljYA6l33lSKQfNsg ($24.95 in chips) 
Seat 6: 8ClCHtFXGNplITm+63KB+Q ($51.15 in chips) 
Hsvkc0/G2VV78oVmWYXecw: posts small blind $0.10
wMiE3yTbDJGOLOF9th7KPA: posts big blind $0.25
*** HOLE CARDS ***
cWc85bEzdRzpUMhRKm8pwQ: folds 
v+QfkGiuj9bgtuNoVnDO8w: folds 
kyRaCIljYA6l33lSKQfNsg: folds 
8ClCHtFXGNplITm+63KB+Q: raises $0.75 to $1
Hsvkc0/G2VV78oVmWYXecw: folds 
wMiE3yTbDJGOLOF9th7KPA: calls $0.75
*** FLOP *** [6s 3c 4c]
wMiE3yTbDJGOLOF9th7KPA: bets $0.50
8ClCHtFXGNplITm+63KB+Q: raises $1.50 to $2
wMiE3yTbDJGOLOF9th7KPA: calls $1.50
*** TURN *** [6s 3c 4c] [5s]
wMiE3yTbDJGOLOF9th7KPA: bets $2
8ClCHtFXGNplITm+63KB+Q: folds 
Uncalled bet ($2) returned to wMiE3yTbDJGOLOF9th7KPA
wMiE3yTbDJGOLOF9th7KPA collected $5.80 from pot
*** SUMMARY ***
Total pot $6.10 | Rake $0.30 
Board [6s 3c 4c 5s]
Seat 1: Hsvkc0/G2VV78oVmWYXecw (small blind) folded before Flop
Seat 2: wMiE3yTbDJGOLOF9th7KPA (big blind) collected ($5.80)
Seat 3: cWc85bEzdRzpUMhRKm8pwQ folded before Flop (didn't bet)
Seat 4: v+QfkGiuj9bgtuNoVnDO8w folded before Flop (didn't bet)
Seat 5: kyRaCIljYA6l33lSKQfNsg folded before Flop (didn't bet)
Seat 6: 8ClCHtFXGNplITm+63KB+Q (button) folded on the Turn




PokerStars Game #59941564856:  Hold'em No Limit ($0.10/$0.25) - 2009/07/01 1:39:18 ET
Table 'YONIZZNvg4uZ4xNUO1deeA' 6-max Seat #3 is the button
Seat 2: evMMX/0gSDH791KdSAOaSg ($5.35 in chips) 
Seat 3: Eksrep3hySi2jeDHuaWiOQ ($8.55 in chips) 
Seat 4: oNAHfBJOUelvVhf0IDMJUA ($27.25 in chips) 
Seat 5: if4dh6jhJXeN3/qd3qCp9g ($25 in chips) 
Seat 6: eL3+wCBjFGfQ5FMdIZihwA ($24.65 in chips) 
oNAHfBJOUelvVhf0IDMJUA: posts small blind $0.10
if4dh6jhJXeN3/qd3qCp9g: posts big blind $0.25
GbCVUNssQ7mqsPWr7J4d3w: sits out 
*** HOLE CARDS ***
eL3+wCBjFGfQ5FMdIZihwA: folds 
evMMX/0gSDH791KdSAOaSg: folds 
Eksrep3hySi2jeDHuaWiOQ: folds 
oNAHfBJOUelvVhf0IDMJUA: folds 
Uncalled bet ($0.15) returned to if4dh6jhJXeN3/qd3qCp9g
if4dh6jhJXeN3/qd3qCp9g collected $0.20 from pot
if4dh6jhJXeN3/qd3qCp9g: doesn't show hand 
*** SUMMARY ***
Total pot $0.20 | Rake $0 
Seat 2: evMMX/0gSDH791KdSAOaSg folded before Flop (didn't bet)
Seat 3: Eksrep3hySi2jeDHuaWiOQ (button) folded before Flop (didn't bet)
Seat 4: oNAHfBJOUelvVhf0IDMJUA (small blind) folded before Flop
Seat 5: if4dh6jhJXeN3/qd3qCp9g (big blind) collected ($0.20)
Seat 6: eL3+wCBjFGfQ5FMdIZihwA folded before Flop (didn't bet)




PokerStars Game #59941565602:  Hold'em No Limit ($0.10/$0.25) - 2009/07/01 1:39:19 ET
Table 'Ez9TB43XM4QgMDQkIW9DYw' 9-max Seat #5 is the button
Seat 1: ShCS62CJp4MKfKLKvGKQbA ($5.05 in chips) 
Seat 2: PFNLAvMkr8qKc7xCiH0wTA ($14.85 in chips) 
Seat 4: JDdN8256cGDC+SqlWOx98Q ($3.40 in chips) 
Seat 5: qpG9m8I+cPw8VhB0mnGjYw ($32.80 in chips) 
Seat 6: 76o85YBHJ9veRYp2LPuluQ ($33 in chips) 
Seat 7: Bb42QRQMhg5/Y0vHP8/2Xw ($30.45 in chips) 
Seat 8: +2kMBNpY4nF1qNCRd8SJLA ($29.50 in chips) 
Seat 9: QEbIGci+itdw+re8RM5fZA ($25 in chips) 
76o85YBHJ9veRYp2LPuluQ: posts small blind $0.10
Bb42QRQMhg5/Y0vHP8/2Xw: posts big blind $0.25
PdIasPkzm2sqZnN41ZRXOg: sits out 
*** HOLE CARDS ***
+2kMBNpY4nF1qNCRd8SJLA: folds 
QEbIGci+itdw+re8RM5fZA: folds 
ShCS62CJp4MKfKLKvGKQbA: folds 
PFNLAvMkr8qKc7xCiH0wTA: folds 
JDdN8256cGDC+SqlWOx98Q: folds 
qpG9m8I+cPw8VhB0mnGjYw: folds 
76o85YBHJ9veRYp2LPuluQ: raises $0.25 to $0.50
Bb42QRQMhg5/Y0vHP8/2Xw: folds 
Uncalled bet ($0.25) returned to 76o85YBHJ9veRYp2LPuluQ
76o85YBHJ9veRYp2LPuluQ collected $0.50 from pot
76o85YBHJ9veRYp2LPuluQ: doesn't show hand 
*** SUMMARY ***
Total pot $0.50 | Rake $0 
Seat 1: ShCS62CJp4MKfKLKvGKQbA folded before Flop (didn't bet)
Seat 2: PFNLAvMkr8qKc7xCiH0wTA folded before Flop (didn't bet)
Seat 4: JDdN8256cGDC+SqlWOx98Q folded before Flop (didn't bet)
Seat 5: qpG9m8I+cPw8VhB0mnGjYw (button) folded before Flop (didn't bet)
Seat 6: 76o85YBHJ9veRYp2LPuluQ (small blind) collected ($0.50)
Seat 7: Bb42QRQMhg5/Y0vHP8/2Xw (big blind) folded before Flop
Seat 8: +2kMBNpY4nF1qNCRd8SJLA folded before Flop (didn't bet)
Seat 9: QEbIGci+itdw+re8RM5fZA folded before Flop (didn't bet)




PokerStars Game #59941565626:  Hold'em No Limit ($0.10/$0.25) - 2009/07/01 1:39:19 ET
Table 'hfHe8uKeSJMyWAjSdM7ROQ' 6-max Seat #5 is the button
Seat 1: eHsmIvAb2JREg4O6hNPnXg ($25 in chips) 
Seat 2: QvTX2yGq3uKJiKPmns4TKQ ($27.20 in chips) 
Seat 3: oAzQdB2jFOH1NxFUPjYUGg ($17.65 in chips) 
Seat 5: euswrBD1XG0Q5hB1iGJBKQ ($68.60 in chips) 
Seat 6: MTQON5nWq0PsufZ7u/4rMA ($19.75 in chips) 
MTQON5nWq0PsufZ7u/4rMA: posts small blind $0.10
eHsmIvAb2JREg4O6hNPnXg: posts big blind $0.25
b4wRQV3APH8irVk6bUFe2Q: sits out 
*** HOLE CARDS ***
QvTX2yGq3uKJiKPmns4TKQ: folds 
oAzQdB2jFOH1NxFUPjYUGg: calls $0.25
euswrBD1XG0Q5hB1iGJBKQ: calls $0.25
MTQON5nWq0PsufZ7u/4rMA: calls $0.15
eHsmIvAb2JREg4O6hNPnXg: checks 
*** FLOP *** [6c Jc Qs]
MTQON5nWq0PsufZ7u/4rMA: checks 
eHsmIvAb2JREg4O6hNPnXg: checks 
oAzQdB2jFOH1NxFUPjYUGg: checks 
euswrBD1XG0Q5hB1iGJBKQ: bets $1
MTQON5nWq0PsufZ7u/4rMA: folds 
eHsmIvAb2JREg4O6hNPnXg: folds 
oAzQdB2jFOH1NxFUPjYUGg: calls $1
*** TURN *** [6c Jc Qs] [5h]
oAzQdB2jFOH1NxFUPjYUGg: bets $1
euswrBD1XG0Q5hB1iGJBKQ: calls $1
*** RIVER *** [6c Jc Qs 5h] [Th]
oAzQdB2jFOH1NxFUPjYUGg: checks 
euswrBD1XG0Q5hB1iGJBKQ: checks 
*** SHOW DOWN ***
oAzQdB2jFOH1NxFUPjYUGg: shows [Jd 6d] (two pair, Jacks and Sixes)
euswrBD1XG0Q5hB1iGJBKQ: mucks hand 
oAzQdB2jFOH1NxFUPjYUGg collected $4.80 from pot
*** SUMMARY ***
Total pot $5 | Rake $0.20 
Board [6c Jc Qs 5h Th]
Seat 1: eHsmIvAb2JREg4O6hNPnXg (big blind) folded on the Flop
Seat 2: QvTX2yGq3uKJiKPmns4TKQ folded before Flop (didn't bet)
Seat 3: oAzQdB2jFOH1NxFUPjYUGg showed [Jd 6d] and won ($4.80) with two pair, Jacks and Sixes
Seat 5: euswrBD1XG0Q5hB1iGJBKQ (button) mucked
Seat 6: MTQON5nWq0PsufZ7u/4rMA (small blind) folded on the Flop




PokerStars Game #59941565670:  Hold'em No Limit ($0.10/$0.25) - 2009/07/01 1:39:19 ET
Table 'TJS4XvvOjO3k7mH74HJw5g' 9-max Seat #8 is the button
Seat 1: K8I2mpRME07ZlOsT2x75Lg ($4.65 in chips) 
Seat 5: UlMB386Cfzy3EwurQoBjcA ($13.70 in chips) 
Seat 6: SRik8xyC/rVIBoX7VaOoMA ($14.65 in chips) 
Seat 8: Qv4VzEkN09uD11sjKv02Ig ($17.65 in chips) 
Seat 9: +sbyWwIcFp9kP0bDtMegfQ ($36.80 in chips) 
+sbyWwIcFp9kP0bDtMegfQ: posts small blind $0.10
K8I2mpRME07ZlOsT2x75Lg: posts big blind $0.25
*** HOLE CARDS ***
UlMB386Cfzy3EwurQoBjcA: calls $0.25
SRik8xyC/rVIBoX7VaOoMA: calls $0.25
f/e5w8nN3RjdX9H1eRlDdA joins the table at seat #4 
Qv4VzEkN09uD11sjKv02Ig: folds 
+sbyWwIcFp9kP0bDtMegfQ: calls $0.15
K8I2mpRME07ZlOsT2x75Lg: checks 
*** FLOP *** [3h 2d 7d]
+sbyWwIcFp9kP0bDtMegfQ: checks 
K8I2mpRME07ZlOsT2x75Lg: bets $0.25
UlMB386Cfzy3EwurQoBjcA: calls $0.25
SRik8xyC/rVIBoX7VaOoMA: folds 
+sbyWwIcFp9kP0bDtMegfQ: folds 
*** TURN *** [3h 2d 7d] [Qd]
K8I2mpRME07ZlOsT2x75Lg: checks 
UlMB386Cfzy3EwurQoBjcA: checks 
*** RIVER *** [3h 2d 7d Qd] [4c]
K8I2mpRME07ZlOsT2x75Lg: bets $0.50
UlMB386Cfzy3EwurQoBjcA: calls $0.50
*** SHOW DOWN ***
K8I2mpRME07ZlOsT2x75Lg: shows [Js 7c] (a pair of Sevens)
UlMB386Cfzy3EwurQoBjcA: mucks hand 
K8I2mpRME07ZlOsT2x75Lg collected $2.40 from pot
*** SUMMARY ***
Total pot $2.50 | Rake $0.10 
Board [3h 2d 7d Qd 4c]
Seat 1: K8I2mpRME07ZlOsT2x75Lg (big blind) showed [Js 7c] and won ($2.40) with a pair of Sevens
Seat 5: UlMB386Cfzy3EwurQoBjcA mucked
Seat 6: SRik8xyC/rVIBoX7VaOoMA folded on the Flop
Seat 8: Qv4VzEkN09uD11sjKv02Ig (button) folded before Flop (didn't bet)
Seat 9: +sbyWwIcFp9kP0bDtMegfQ (small blind) folded on the Flop




PokerStars Game #59941565366:  Hold'em No Limit ($0.10/$0.25) - 2009/07/01 1:39:19 ET
Table 'Zi9/NqNs3XoL1eWhMCyZyg' 9-max Seat #2 is the button
Seat 2: Th3FldXKQW6hWVVPahaoOQ ($34.30 in chips) 
Seat 4: dmYlc+1cjwZMJ7wV+Z0rRg ($24.60 in chips) 
Seat 5: OiV1PWZ3IkN29JlmCcnTwQ ($4.55 in chips) 
Seat 7: 0QdZrkFD7aGKeBXPGbIomA ($4.35 in chips) 
Seat 8: nm4Dj/f+jJEwKVsUnKh73g ($38.65 in chips) 
Seat 9: tYsOBqdU1+x+yFI7zHO7hQ ($31.30 in chips) 
dmYlc+1cjwZMJ7wV+Z0rRg: posts small blind $0.10
OiV1PWZ3IkN29JlmCcnTwQ: posts big blind $0.25
*** HOLE CARDS ***
0QdZrkFD7aGKeBXPGbIomA: folds 
nm4Dj/f+jJEwKVsUnKh73g: folds 
tYsOBqdU1+x+yFI7zHO7hQ: raises $0.75 to $1
Th3FldXKQW6hWVVPahaoOQ: folds 
dmYlc+1cjwZMJ7wV+Z0rRg: folds 
OiV1PWZ3IkN29JlmCcnTwQ: folds 
Uncalled bet ($0.75) returned to tYsOBqdU1+x+yFI7zHO7hQ
tYsOBqdU1+x+yFI7zHO7hQ collected $0.60 from pot
tYsOBqdU1+x+yFI7zHO7hQ: doesn't show hand 
*** SUMMARY ***
Total pot $0.60 | Rake $0 
Seat 2: Th3FldXKQW6hWVVPahaoOQ (button) folded before Flop (didn't bet)
Seat 4: dmYlc+1cjwZMJ7wV+Z0rRg (small blind) folded before Flop
Seat 5: OiV1PWZ3IkN29JlmCcnTwQ (big blind) folded before Flop
Seat 7: 0QdZrkFD7aGKeBXPGbIomA folded before Flop (didn't bet)
Seat 8: nm4Dj/f+jJEwKVsUnKh73g folded before Flop (didn't bet)
Seat 9: tYsOBqdU1+x+yFI7zHO7hQ collected ($0.60)




PokerStars Game #59941565300:  Hold'em No Limit ($0.10/$0.25) - 2009/07/01 1:39:19 ET
Table 'I0ZcuiUTeLuGYv26Nah7YA' 9-max Seat #5 is the button
Seat 2: ljemhp25Zg+nlA9DLCIiUw ($34.40 in chips) 
Seat 5: y7tkvDmwKjURBkr73SZPXw ($6.45 in chips) 
Seat 8: ShCS62CJp4MKfKLKvGKQbA ($7.85 in chips) 
ShCS62CJp4MKfKLKvGKQbA: posts small blind $0.10
ljemhp25Zg+nlA9DLCIiUw: posts big blind $0.25
*** HOLE CARDS ***
y7tkvDmwKjURBkr73SZPXw: calls $0.25
ShCS62CJp4MKfKLKvGKQbA: calls $0.15
ljemhp25Zg+nlA9DLCIiUw: checks 
*** FLOP *** [7h Kh 6d]
ShCS62CJp4MKfKLKvGKQbA: checks 
ljemhp25Zg+nlA9DLCIiUw: checks 
y7tkvDmwKjURBkr73SZPXw: checks 
*** TURN *** [7h Kh 6d] [Jc]
ShCS62CJp4MKfKLKvGKQbA: checks 
ljemhp25Zg+nlA9DLCIiUw: checks 
y7tkvDmwKjURBkr73SZPXw: checks 
*** RIVER *** [7h Kh 6d Jc] [2d]
ShCS62CJp4MKfKLKvGKQbA: checks 
ljemhp25Zg+nlA9DLCIiUw: checks 
y7tkvDmwKjURBkr73SZPXw: checks 
*** SHOW DOWN ***
ShCS62CJp4MKfKLKvGKQbA: shows [3c 6c] (a pair of Sixes)
ljemhp25Zg+nlA9DLCIiUw: mucks hand 
y7tkvDmwKjURBkr73SZPXw: shows [8h 7s] (a pair of Sevens)
y7tkvDmwKjURBkr73SZPXw collected $0.75 from pot
*** SUMMARY ***
Total pot $0.75 | Rake $0 
Board [7h Kh 6d Jc 2d]
Seat 2: ljemhp25Zg+nlA9DLCIiUw (big blind) mucked
Seat 5: y7tkvDmwKjURBkr73SZPXw (button) showed [8h 7s] and won ($0.75) with a pair of Sevens
Seat 8: ShCS62CJp4MKfKLKvGKQbA (small blind) showed [3c 6c] and lost with a pair of Sixes




PokerStars Game #59941566160:  Hold'em No Limit ($0.10/$0.25) - 2009/07/01 1:39:20 ET
Table 'NfXsh0UQA+o/kO9acV3WxA' 9-max Seat #6 is the button
Seat 3: wCUaomJ6Nq5zomVGdUHP+w ($21.10 in chips) 
Seat 4: r6hsffOo1iKmaPYKwAZmFw ($26.10 in chips) 
Seat 5: V/6KhUyefeL34u/m51HnmQ ($17.45 in chips) 
Seat 6: cFmpjvcjNoVAEAIQIxWkYg ($25 in chips) 
Seat 7: yqkowiRWZ6NvRN9UUkYIlA ($5 in chips) 
Seat 8: +sbyWwIcFp9kP0bDtMegfQ ($42.10 in chips) 
Seat 9: uhrboV251dcgYniYTdFIcA ($25 in chips) 
yqkowiRWZ6NvRN9UUkYIlA: posts small blind $0.10
+sbyWwIcFp9kP0bDtMegfQ: posts big blind $0.25
pN3IHvAKm2fz+sTRARTcrg: sits out 
SchoolATC: sits out 
*** HOLE CARDS ***
uhrboV251dcgYniYTdFIcA: folds 
wCUaomJ6Nq5zomVGdUHP+w: folds 
r6hsffOo1iKmaPYKwAZmFw: raises $0.50 to $0.75
V/6KhUyefeL34u/m51HnmQ: raises $0.50 to $1.25
cFmpjvcjNoVAEAIQIxWkYg: folds 
yqkowiRWZ6NvRN9UUkYIlA: folds 
+sbyWwIcFp9kP0bDtMegfQ: folds 
r6hsffOo1iKmaPYKwAZmFw: calls $0.50
*** FLOP *** [5h Jh 2s]
r6hsffOo1iKmaPYKwAZmFw: bets $1.75
V/6KhUyefeL34u/m51HnmQ: folds 
Uncalled bet ($1.75) returned to r6hsffOo1iKmaPYKwAZmFw
r6hsffOo1iKmaPYKwAZmFw collected $2.75 from pot
r6hsffOo1iKmaPYKwAZmFw: doesn't show hand 
*** SUMMARY ***
Total pot $2.85 | Rake $0.10 
Board [5h Jh 2s]
Seat 3: wCUaomJ6Nq5zomVGdUHP+w folded before Flop (didn't bet)
Seat 4: r6hsffOo1iKmaPYKwAZmFw collected ($2.75)
Seat 5: V/6KhUyefeL34u/m51HnmQ folded on the Flop
Seat 6: cFmpjvcjNoVAEAIQIxWkYg (button) folded before Flop (didn't bet)
Seat 7: yqkowiRWZ6NvRN9UUkYIlA (small blind) folded before Flop
Seat 8: +sbyWwIcFp9kP0bDtMegfQ (big blind) folded before Flop
Seat 9: uhrboV251dcgYniYTdFIcA folded before Flop (didn't bet)




PokerStars Game #59941566228:  Hold'em No Limit ($0.10/$0.25) - 2009/07/01 1:39:20 ET
Table 'rO1I30HnuCPB0M8qEX1TCQ' 9-max Seat #1 is the button
Seat 1: dfsOFy2nKDeSF9SjtdIyVA ($12.50 in chips) 
Seat 2: z1hPotrGOZjUjyoopZ7Ulg ($17.30 in chips) 
Seat 3: 2wcFsZsqEP5w1StUTVzJCg ($13.65 in chips) 
Seat 4: yyG4svzOpC1A+sUP/scg6w ($12 in chips) 
Seat 5: W6tExOcYX7qiy6Qdp+ZwFA ($5.70 in chips) 
Seat 8: 6mStmDUknIn/RyBEoiIyoQ ($3.95 in chips) 
Seat 9: AiXn/9o1EwOPZUHujnh/bA ($22.15 in chips) 
z1hPotrGOZjUjyoopZ7Ulg: posts small blind $0.10
2wcFsZsqEP5w1StUTVzJCg: posts big blind $0.25
5n7e7I+px7c6CQmLpPbtsg: sits out 
bXpVeaSTPBFSPJmeXxO7nw: sits out 
*** HOLE CARDS ***
yyG4svzOpC1A+sUP/scg6w: folds 
W6tExOcYX7qiy6Qdp+ZwFA: calls $0.25
6mStmDUknIn/RyBEoiIyoQ: calls $0.25
AiXn/9o1EwOPZUHujnh/bA: calls $0.25
dfsOFy2nKDeSF9SjtdIyVA: folds 
z1hPotrGOZjUjyoopZ7Ulg: calls $0.15
2wcFsZsqEP5w1StUTVzJCg: checks 
*** FLOP *** [8c Ad 6h]
z1hPotrGOZjUjyoopZ7Ulg: bets $0.50
2wcFsZsqEP5w1StUTVzJCg: folds 
W6tExOcYX7qiy6Qdp+ZwFA: folds 
6mStmDUknIn/RyBEoiIyoQ: calls $0.50
AiXn/9o1EwOPZUHujnh/bA: folds 
*** TURN *** [8c Ad 6h] [Ac]
z1hPotrGOZjUjyoopZ7Ulg: bets $0.75
6mStmDUknIn/RyBEoiIyoQ: folds 
Uncalled bet ($0.75) returned to z1hPotrGOZjUjyoopZ7Ulg
z1hPotrGOZjUjyoopZ7Ulg collected $2.15 from pot
z1hPotrGOZjUjyoopZ7Ulg: doesn't show hand 
*** SUMMARY ***
Total pot $2.25 | Rake $0.10 
Board [8c Ad 6h Ac]
Seat 1: dfsOFy2nKDeSF9SjtdIyVA (button) folded before Flop (didn't bet)
Seat 2: z1hPotrGOZjUjyoopZ7Ulg (small blind) collected ($2.15)
Seat 3: 2wcFsZsqEP5w1StUTVzJCg (big blind) folded on the Flop
Seat 4: yyG4svzOpC1A+sUP/scg6w folded before Flop (didn't bet)
Seat 5: W6tExOcYX7qiy6Qdp+ZwFA folded on the Flop
Seat 8: 6mStmDUknIn/RyBEoiIyoQ folded on the Turn
Seat 9: AiXn/9o1EwOPZUHujnh/bA folded on the Flop




PokerStars Game #59941565944:  Hold'em No Limit ($0.10/$0.25) - 2009/07/01 1:39:20 ET
Table '84TjTrgbsYZladOc4PWf4Q' 6-max Seat #3 is the button
Seat 1: /kW0t5kKllzd8HO2uEapHQ ($24.95 in chips) 
Seat 2: RpaEX9P7BCvyfPRLiRNg0A ($39.25 in chips) 
Seat 3: Ar4vsUIUfJ7gbYh1c1m59g ($12.35 in chips) 
Seat 4: SxIIgwXYLkwd6m3wLyPTCw ($22.05 in chips) 
Seat 5: cezpHJ8FB07dj0xG+LhOvw ($25 in chips) 
Seat 6: wCUaomJ6Nq5zomVGdUHP+w ($19.50 in chips) 
SxIIgwXYLkwd6m3wLyPTCw: posts small blind $0.10
cezpHJ8FB07dj0xG+LhOvw: posts big blind $0.25
*** HOLE CARDS ***
wCUaomJ6Nq5zomVGdUHP+w: folds 
/kW0t5kKllzd8HO2uEapHQ: folds 
RpaEX9P7BCvyfPRLiRNg0A: raises $0.75 to $1
Ar4vsUIUfJ7gbYh1c1m59g: folds 
SxIIgwXYLkwd6m3wLyPTCw: folds 
cezpHJ8FB07dj0xG+LhOvw: folds 
Uncalled bet ($0.75) returned to RpaEX9P7BCvyfPRLiRNg0A
RpaEX9P7BCvyfPRLiRNg0A collected $0.60 from pot
*** SUMMARY ***
Total pot $0.60 | Rake $0 
Seat 1: /kW0t5kKllzd8HO2uEapHQ folded before Flop (didn't bet)
Seat 2: RpaEX9P7BCvyfPRLiRNg0A collected ($0.60)
Seat 3: Ar4vsUIUfJ7gbYh1c1m59g (button) folded before Flop (didn't bet)
Seat 4: SxIIgwXYLkwd6m3wLyPTCw (small blind) folded before Flop
Seat 5: cezpHJ8FB07dj0xG+LhOvw (big blind) folded before Flop
Seat 6: wCUaomJ6Nq5zomVGdUHP+w folded before Flop (didn't bet)




PokerStars Game #59941565782:  Hold'em No Limit ($0.10/$0.25) - 2009/07/01 1:39:20 ET
Table 'DhkrdW2UOy2PfjSW28Kq8w' 6-max Seat #6 is the button
Seat 1: vu2kzHaDtgr6NM7rdq0chA ($25.65 in chips) 
Seat 2: v+QfkGiuj9bgtuNoVnDO8w ($25 in chips) 
Seat 3: B3X187C0tXFUfQpCu8pe8A ($22.90 in chips) 
Seat 4: 59HJSCM1X37BkMpI9N0mEw ($26.40 in chips) 
Seat 5: SxIIgwXYLkwd6m3wLyPTCw ($49.95 in chips) 
Seat 6: DihMHaz4WNETH1bPDe13kA ($25.40 in chips) 
vu2kzHaDtgr6NM7rdq0chA: posts small blind $0.10
v+QfkGiuj9bgtuNoVnDO8w: posts big blind $0.25
*** HOLE CARDS ***
B3X187C0tXFUfQpCu8pe8A: folds 
59HJSCM1X37BkMpI9N0mEw: folds 
SxIIgwXYLkwd6m3wLyPTCw: raises $0.50 to $0.75
DihMHaz4WNETH1bPDe13kA: folds 
vu2kzHaDtgr6NM7rdq0chA: raises $1.50 to $2.25
v+QfkGiuj9bgtuNoVnDO8w: folds 
SxIIgwXYLkwd6m3wLyPTCw: folds 
Uncalled bet ($1.50) returned to vu2kzHaDtgr6NM7rdq0chA
vu2kzHaDtgr6NM7rdq0chA collected $1.75 from pot
vu2kzHaDtgr6NM7rdq0chA: doesn't show hand 
*** SUMMARY ***
Total pot $1.75 | Rake $0 
Seat 1: vu2kzHaDtgr6NM7rdq0chA (small blind) collected ($1.75)
Seat 2: v+QfkGiuj9bgtuNoVnDO8w (big blind) folded before Flop
Seat 3: B3X187C0tXFUfQpCu8pe8A folded before Flop (didn't bet)
Seat 4: 59HJSCM1X37BkMpI9N0mEw folded before Flop (didn't bet)
Seat 5: SxIIgwXYLkwd6m3wLyPTCw folded before Flop
Seat 6: DihMHaz4WNETH1bPDe13kA (button) folded before Flop (didn't bet)




PokerStars Game #59941566234:  Hold'em No Limit ($0.10/$0.25) - 2009/07/01 1:39:20 ET
Table 'xmJKTGBeWCwutccj3YfupQ' 6-max Seat #3 is the button
Seat 1: sVbkVl4OznxBCfi66UB9vw ($25.10 in chips) 
Seat 2: AxhCSFlGEh+FAc+VUD31JQ ($23.30 in chips) 
Seat 3: T5wrp/d5jarm+SxNy8OQAg ($23.55 in chips) 
Seat 4: uWjhTVMpuIroxXcmD3Okug ($9.95 in chips) 
Seat 5: DE9hRlt14g+JdsRQ4wT7hg ($25 in chips) 
Seat 6: Mo72EzWqYLVNBUGxtzSsUQ ($31 in chips) 
uWjhTVMpuIroxXcmD3Okug: posts small blind $0.10
DE9hRlt14g+JdsRQ4wT7hg: posts big blind $0.25
*** HOLE CARDS ***
Mo72EzWqYLVNBUGxtzSsUQ: raises $0.50 to $0.75
sVbkVl4OznxBCfi66UB9vw: folds 
AxhCSFlGEh+FAc+VUD31JQ: folds 
T5wrp/d5jarm+SxNy8OQAg: folds 
uWjhTVMpuIroxXcmD3Okug: folds 
DE9hRlt14g+JdsRQ4wT7hg: folds 
Uncalled bet ($0.50) returned to Mo72EzWqYLVNBUGxtzSsUQ
Mo72EzWqYLVNBUGxtzSsUQ collected $0.60 from pot
*** SUMMARY ***
Total pot $0.60 | Rake $0 
Seat 1: sVbkVl4OznxBCfi66UB9vw folded before Flop (didn't bet)
Seat 2: AxhCSFlGEh+FAc+VUD31JQ folded before Flop (didn't bet)
Seat 3: T5wrp/d5jarm+SxNy8OQAg (button) folded before Flop (didn't bet)
Seat 4: uWjhTVMpuIroxXcmD3Okug (small blind) folded before Flop
Seat 5: DE9hRlt14g+JdsRQ4wT7hg (big blind) folded before Flop
Seat 6: Mo72EzWqYLVNBUGxtzSsUQ collected ($0.60)




PokerStars Game #59941566258:  Hold'em No Limit ($0.10/$0.25) - 2009/07/01 1:39:20 ET
Table 'Qk/910N2Yhg8u5vqTJk50Q' 9-max Seat #1 is the button
Seat 1: zDrucyjVn5aeekNEc3cJrA ($22.55 in chips) 
Seat 2: Th3FldXKQW6hWVVPahaoOQ ($46.40 in chips) 
Seat 3: ghNKXUBl/H+t83JF079ZBA ($25.35 in chips) 
Seat 5: 4oA316mXLIui1QY63GXBUg ($25.75 in chips) 
Seat 6: 8GJHzzxiotOqC5gdtgpLoA ($6.30 in chips) 
Seat 7: aNpwfA31EREwO+ar4XzBCw ($25.35 in chips) 
Seat 8: H5Se03ZqSX7tbULXur2MAg ($25.50 in chips) 
Seat 9: M2QO2DxB5Wawg2h8HSpnYA ($18.70 in chips) 
Th3FldXKQW6hWVVPahaoOQ: posts small blind $0.10
ghNKXUBl/H+t83JF079ZBA: posts big blind $0.25
*** HOLE CARDS ***
4oA316mXLIui1QY63GXBUg: folds 
8GJHzzxiotOqC5gdtgpLoA: folds 
aNpwfA31EREwO+ar4XzBCw: folds 
H5Se03ZqSX7tbULXur2MAg: folds 
M2QO2DxB5Wawg2h8HSpnYA: folds 
zDrucyjVn5aeekNEc3cJrA: folds 
Th3FldXKQW6hWVVPahaoOQ: raises $0.50 to $0.75
ghNKXUBl/H+t83JF079ZBA: raises $2 to $2.75
Th3FldXKQW6hWVVPahaoOQ: folds 
Uncalled bet ($2) returned to ghNKXUBl/H+t83JF079ZBA
ghNKXUBl/H+t83JF079ZBA collected $1.50 from pot
ghNKXUBl/H+t83JF079ZBA: doesn't show hand 
*** SUMMARY ***
Total pot $1.50 | Rake $0 
Seat 1: zDrucyjVn5aeekNEc3cJrA (button) folded before Flop (didn't bet)
Seat 2: Th3FldXKQW6hWVVPahaoOQ (small blind) folded before Flop
Seat 3: ghNKXUBl/H+t83JF079ZBA (big blind) collected ($1.50)
Seat 5: 4oA316mXLIui1QY63GXBUg folded before Flop (didn't bet)
Seat 6: 8GJHzzxiotOqC5gdtgpLoA folded before Flop (didn't bet)
Seat 7: aNpwfA31EREwO+ar4XzBCw folded before Flop (didn't bet)
Seat 8: H5Se03ZqSX7tbULXur2MAg folded before Flop (didn't bet)
Seat 9: M2QO2DxB5Wawg2h8HSpnYA folded before Flop (didn't bet)




PokerStars Game #59941566008:  Hold'em No Limit ($0.10/$0.25) - 2009/07/01 1:39:20 ET
Table '50f2Xa1b1jp6cfdTAgXFIg' 9-max Seat #9 is the button
Seat 2: qxWFg3MZuVyidB0SJh5ywg ($28.20 in chips) 
Seat 3: RSojRXQHk0IRANbJYopT9g ($27.25 in chips) 
Seat 4: ghNKXUBl/H+t83JF079ZBA ($28.45 in chips) 
Seat 5: C1w4aCCgQVVSgNijoEahAg ($10.50 in chips) 
Seat 6: tLcDklc2rBORNfixyRfVfw ($25 in chips) 
Seat 7: w1ukf8uPa4+WH561TtVRxA ($25 in chips) 
Seat 8: x+W5+3qsdY4Iszf0hoH+Aw ($14.90 in chips) 
Seat 9: gehe91e0IyVT0QU/XBkEyg ($25.15 in chips) 
pplNliE3WonjkPRf+GZq2A will be allowed to play after the button
qxWFg3MZuVyidB0SJh5ywg: posts small blind $0.10
RSojRXQHk0IRANbJYopT9g: posts big blind $0.25
*** HOLE CARDS ***
ghNKXUBl/H+t83JF079ZBA: folds 
C1w4aCCgQVVSgNijoEahAg: folds 
tLcDklc2rBORNfixyRfVfw: folds 
w1ukf8uPa4+WH561TtVRxA: folds 
x+W5+3qsdY4Iszf0hoH+Aw: folds 
gehe91e0IyVT0QU/XBkEyg: folds 
qxWFg3MZuVyidB0SJh5ywg: raises $0.75 to $1
RSojRXQHk0IRANbJYopT9g: folds 
Uncalled bet ($0.75) returned to qxWFg3MZuVyidB0SJh5ywg
qxWFg3MZuVyidB0SJh5ywg collected $0.50 from pot
*** SUMMARY ***
Total pot $0.50 | Rake $0 
Seat 2: qxWFg3MZuVyidB0SJh5ywg (small blind) collected ($0.50)
Seat 3: RSojRXQHk0IRANbJYopT9g (big blind) folded before Flop
Seat 4: ghNKXUBl/H+t83JF079ZBA folded before Flop (didn't bet)
Seat 5: C1w4aCCgQVVSgNijoEahAg folded before Flop (didn't bet)
Seat 6: tLcDklc2rBORNfixyRfVfw folded before Flop (didn't bet)
Seat 7: w1ukf8uPa4+WH561TtVRxA folded before Flop (didn't bet)
Seat 8: x+W5+3qsdY4Iszf0hoH+Aw folded before Flop (didn't bet)
Seat 9: gehe91e0IyVT0QU/XBkEyg (button) folded before Flop (didn't bet)




PokerStars Game #59941565996:  Hold'em No Limit ($0.10/$0.25) - 2009/07/01 1:39:20 ET
Table '9iHhO6FyZVM8XpSc23TIgg' 6-max Seat #1 is the button
Seat 1: NhUN/JpAprdJeamFBgJH1w ($44.25 in chips) 
Seat 2: bJFzs6QmEEnz4miMfSDtcg ($39.90 in chips) 
Seat 3: TSmua8tGK3sTbwi0ynrW9Q ($25 in chips) 
Seat 5: xrf8tAXKQHG99HixCot1Iw ($22.15 in chips) 
Seat 6: iyZxqznXjv3vtvOJymkoLQ ($34.45 in chips) 
bJFzs6QmEEnz4miMfSDtcg: posts small blind $0.10
TSmua8tGK3sTbwi0ynrW9Q: posts big blind $0.25
*** HOLE CARDS ***
xrf8tAXKQHG99HixCot1Iw: folds 
iyZxqznXjv3vtvOJymkoLQ: folds 
NhUN/JpAprdJeamFBgJH1w: folds 
bJFzs6QmEEnz4miMfSDtcg: folds 
Uncalled bet ($0.15) returned to TSmua8tGK3sTbwi0ynrW9Q
TSmua8tGK3sTbwi0ynrW9Q collected $0.20 from pot
*** SUMMARY ***
Total pot $0.20 | Rake $0 
Seat 1: NhUN/JpAprdJeamFBgJH1w (button) folded before Flop (didn't bet)
Seat 2: bJFzs6QmEEnz4miMfSDtcg (small blind) folded before Flop
Seat 3: TSmua8tGK3sTbwi0ynrW9Q (big blind) collected ($0.20)
Seat 5: xrf8tAXKQHG99HixCot1Iw folded before Flop (didn't bet)
Seat 6: iyZxqznXjv3vtvOJymkoLQ folded before Flop (didn't bet)




PokerStars Game #59941565840:  Hold'em No Limit ($0.10/$0.25) - 2009/07/01 1:39:20 ET
Table 'BpNkESDX1ip9c0K1hb5h7A' 6-max Seat #4 is the button
Seat 2: g+5jEA4Xq9vcMOfdFYNuFA ($10.95 in chips) 
Seat 3: fZQg9veL7Dd/Z04ZTjC+wQ ($25 in chips) 
Seat 4: kG34n23qFQA3nzdOJTQ1dA ($24.05 in chips) 
Seat 5: L3/N/gliETan8N5Gim5h4Q ($25.60 in chips) 
Seat 6: 8EEqTTh7T1q48sYDqbI2Xg ($23.25 in chips) 
L3/N/gliETan8N5Gim5h4Q: posts small blind $0.10
8EEqTTh7T1q48sYDqbI2Xg: posts big blind $0.25
*** HOLE CARDS ***
g+5jEA4Xq9vcMOfdFYNuFA: calls $0.25
fZQg9veL7Dd/Z04ZTjC+wQ: folds 
kG34n23qFQA3nzdOJTQ1dA: calls $0.25
L3/N/gliETan8N5Gim5h4Q: folds 
8EEqTTh7T1q48sYDqbI2Xg: checks 
*** FLOP *** [Th Td 6d]
8EEqTTh7T1q48sYDqbI2Xg: checks 
g+5jEA4Xq9vcMOfdFYNuFA: checks 
kG34n23qFQA3nzdOJTQ1dA: bets $0.50
8EEqTTh7T1q48sYDqbI2Xg: calls $0.50
g+5jEA4Xq9vcMOfdFYNuFA: folds 
*** TURN *** [Th Td 6d] [Ad]
8EEqTTh7T1q48sYDqbI2Xg: checks 
kG34n23qFQA3nzdOJTQ1dA: checks 
*** RIVER *** [Th Td 6d Ad] [Ts]
8EEqTTh7T1q48sYDqbI2Xg: bets $0.50
kG34n23qFQA3nzdOJTQ1dA: calls $0.50
*** SHOW DOWN ***
8EEqTTh7T1q48sYDqbI2Xg: shows [8d 8s] (a full house, Tens full of Eights)
kG34n23qFQA3nzdOJTQ1dA: shows [Qh Qs] (a full house, Tens full of Queens)
kG34n23qFQA3nzdOJTQ1dA collected $2.75 from pot
*** SUMMARY ***
Total pot $2.85 | Rake $0.10 
Board [Th Td 6d Ad Ts]
Seat 2: g+5jEA4Xq9vcMOfdFYNuFA folded on the Flop
Seat 3: fZQg9veL7Dd/Z04ZTjC+wQ folded before Flop (didn't bet)
Seat 4: kG34n23qFQA3nzdOJTQ1dA (button) showed [Qh Qs] and won ($2.75) with a full house, Tens full of Queens
Seat 5: L3/N/gliETan8N5Gim5h4Q (small blind) folded before Flop
Seat 6: 8EEqTTh7T1q48sYDqbI2Xg (big blind) showed [8d 8s] and lost with a full house, Tens full of Eights




PokerStars Game #59941566668:  Hold'em No Limit ($0.10/$0.25) - 2009/07/01 1:39:21 ET
Table '8QBBaev+cI2i/r2H6ml/lg' 9-max Seat #5 is the button
Seat 1: s2xLPOl/vhl/26apJ3vsOQ ($34.45 in chips) 
Seat 2: 1S/fpm+f42V/6MNZre+ccg ($25.40 in chips) 
Seat 3: zgi+EUykT/pZQpoUG6+oEg ($4.65 in chips) 
Seat 4: ytpGB2nr/CLVHnyKMRiEFQ ($15 in chips) 
Seat 5: 0QdZrkFD7aGKeBXPGbIomA ($11.70 in chips) 
Seat 7: eK8qa6EPcH2zhtbmWSvc9g ($31.15 in chips) 
Seat 8: vr1IK/Q4HXm8s8V0/dePzQ ($12.45 in chips) 
Seat 9: EUMLvzDkECHBit+xa+uGjg ($23.50 in chips) 
mikeritr will be allowed to play after the button
eK8qa6EPcH2zhtbmWSvc9g: posts small blind $0.10
vr1IK/Q4HXm8s8V0/dePzQ: posts big blind $0.25
*** HOLE CARDS ***
EUMLvzDkECHBit+xa+uGjg: folds 
s2xLPOl/vhl/26apJ3vsOQ: folds 
1S/fpm+f42V/6MNZre+ccg: folds 
zgi+EUykT/pZQpoUG6+oEg: folds 
ytpGB2nr/CLVHnyKMRiEFQ: folds 
0QdZrkFD7aGKeBXPGbIomA: folds 
eK8qa6EPcH2zhtbmWSvc9g: folds 
Uncalled bet ($0.15) returned to vr1IK/Q4HXm8s8V0/dePzQ
mikeritr leaves the table
vr1IK/Q4HXm8s8V0/dePzQ collected $0.20 from pot
*** SUMMARY ***
Total pot $0.20 | Rake $0 
Seat 1: s2xLPOl/vhl/26apJ3vsOQ folded before Flop (didn't bet)
Seat 2: 1S/fpm+f42V/6MNZre+ccg folded before Flop (didn't bet)
Seat 3: zgi+EUykT/pZQpoUG6+oEg folded before Flop (didn't bet)
Seat 4: ytpGB2nr/CLVHnyKMRiEFQ folded before Flop (didn't bet)
Seat 5: 0QdZrkFD7aGKeBXPGbIomA (button) folded before Flop (didn't bet)
Seat 7: eK8qa6EPcH2zhtbmWSvc9g (small blind) folded before Flop
Seat 8: vr1IK/Q4HXm8s8V0/dePzQ (big blind) collected ($0.20)
Seat 9: EUMLvzDkECHBit+xa+uGjg folded before Flop (didn't bet)




PokerStars Game #59941566304:  Hold'em No Limit ($0.10/$0.25) - 2009/07/01 1:39:21 ET
Table 'G26g8jde1eR+mmabeFeSlw' 9-max Seat #1 is the button
Seat 1: qpG9m8I+cPw8VhB0mnGjYw ($29.40 in chips) 
Seat 2: BFYwQ0J4xWUQvouudojivA ($15.95 in chips) 
Seat 3: WKL8nUFr7TumC4EjLyqYzw ($6.85 in chips) 
Seat 5: hJ4uYjNmSZdjrKA8cjZqCA ($28.65 in chips) 
Seat 6: AHGkesF/mi4sDMpqrxBUoA ($9.05 in chips) 
Seat 7: nm4Dj/f+jJEwKVsUnKh73g ($34.60 in chips) 
Seat 8: bXpVeaSTPBFSPJmeXxO7nw ($5 in chips) 
Seat 9: VWUWpMLMj/Q1jRVpF7Aohw ($10.40 in chips) 
BFYwQ0J4xWUQvouudojivA: posts small blind $0.10
WKL8nUFr7TumC4EjLyqYzw: posts big blind $0.25
8EbrQ/EvFWt2cr0GaU82gQ: sits out 
*** HOLE CARDS ***
hJ4uYjNmSZdjrKA8cjZqCA: folds 
AHGkesF/mi4sDMpqrxBUoA: folds 
nm4Dj/f+jJEwKVsUnKh73g: raises $0.75 to $1
bXpVeaSTPBFSPJmeXxO7nw: folds 
VWUWpMLMj/Q1jRVpF7Aohw: calls $1
qpG9m8I+cPw8VhB0mnGjYw: folds 
BFYwQ0J4xWUQvouudojivA: folds 
WKL8nUFr7TumC4EjLyqYzw: folds 
*** FLOP *** [6s 4h 4d]
nm4Dj/f+jJEwKVsUnKh73g: bets $1
VWUWpMLMj/Q1jRVpF7Aohw: raises $2.25 to $3.25
nm4Dj/f+jJEwKVsUnKh73g: raises $2.25 to $5.50
VWUWpMLMj/Q1jRVpF7Aohw: folds 
Uncalled bet ($2.25) returned to nm4Dj/f+jJEwKVsUnKh73g
nm4Dj/f+jJEwKVsUnKh73g collected $8.45 from pot
nm4Dj/f+jJEwKVsUnKh73g: doesn't show hand 
*** SUMMARY ***
Total pot $8.85 | Rake $0.40 
Board [6s 4h 4d]
Seat 1: qpG9m8I+cPw8VhB0mnGjYw (button) folded before Flop (didn't bet)
Seat 2: BFYwQ0J4xWUQvouudojivA (small blind) folded before Flop
Seat 3: WKL8nUFr7TumC4EjLyqYzw (big blind) folded before Flop
Seat 5: hJ4uYjNmSZdjrKA8cjZqCA folded before Flop (didn't bet)
Seat 6: AHGkesF/mi4sDMpqrxBUoA folded before Flop (didn't bet)
Seat 7: nm4Dj/f+jJEwKVsUnKh73g collected ($8.45)
Seat 8: bXpVeaSTPBFSPJmeXxO7nw folded before Flop (didn't bet)
Seat 9: VWUWpMLMj/Q1jRVpF7Aohw folded on the Flop




PokerStars Game #59941566372:  Hold'em No Limit ($0.10/$0.25) - 2009/07/01 1:39:21 ET
Table 'nB7Q7zfNfy6ig6DB+rsgWQ' 6-max Seat #3 is the button
Seat 1: Hzy03WtPHMYwLYM7hTTxQw ($25.15 in chips) 
Seat 2: 4BHo0wlX9INjkj2727qE0w ($31.90 in chips) 
Seat 3: p3NYOxYhkL7txPRSeXHDeg ($31.30 in chips) 
Seat 4: DihMHaz4WNETH1bPDe13kA ($25 in chips) 
Seat 5: D2qb0DD9hycFaE/pJ6JNng ($5.15 in chips) 
Seat 6: MEGIwX0eHRUj63lwYaNhVg ($10.45 in chips) 
DihMHaz4WNETH1bPDe13kA: posts small blind $0.10
D2qb0DD9hycFaE/pJ6JNng: posts big blind $0.25
*** HOLE CARDS ***
MEGIwX0eHRUj63lwYaNhVg: folds 
Hzy03WtPHMYwLYM7hTTxQw: folds 
4BHo0wlX9INjkj2727qE0w: raises $0.50 to $0.75
p3NYOxYhkL7txPRSeXHDeg: folds 
DihMHaz4WNETH1bPDe13kA: folds 
D2qb0DD9hycFaE/pJ6JNng: folds 
Uncalled bet ($0.50) returned to 4BHo0wlX9INjkj2727qE0w
4BHo0wlX9INjkj2727qE0w collected $0.60 from pot
*** SUMMARY ***
Total pot $0.60 | Rake $0 
Seat 1: Hzy03WtPHMYwLYM7hTTxQw folded before Flop (didn't bet)
Seat 2: 4BHo0wlX9INjkj2727qE0w collected ($0.60)
Seat 3: p3NYOxYhkL7txPRSeXHDeg (button) folded before Flop (didn't bet)
Seat 4: DihMHaz4WNETH1bPDe13kA (small blind) folded before Flop
Seat 5: D2qb0DD9hycFaE/pJ6JNng (big blind) folded before Flop
Seat 6: MEGIwX0eHRUj63lwYaNhVg folded before Flop (didn't bet)




PokerStars Game #59941566282:  Hold'em No Limit ($0.10/$0.25) - 2009/07/01 1:39:21 ET
Table '0XPo7K54oZIfG0xlNAcDRw' 9-max Seat #5 is the button
Seat 1: 7cv+9Zc9HIQHNvYsMfV3uA ($28.65 in chips) 
Seat 3: 6qsItdeWZoOL5be2e1RFng ($7.95 in chips) 
Seat 4: RubYqfvGrz2z+5ReNIj9QQ ($28.35 in chips) 
Seat 5: iOmwbUN7u4JFkV6VCA49aA ($25.15 in chips) 
Seat 6: 9gmYYQesalMrUjaF7nKfrQ ($12.15 in chips) 
Seat 7: tYsOBqdU1+x+yFI7zHO7hQ ($29.15 in chips) 
Seat 8: v5jnQ1gfh9nLla3kMXG7Yg ($8.85 in chips) 
9gmYYQesalMrUjaF7nKfrQ: posts small blind $0.10
tYsOBqdU1+x+yFI7zHO7hQ: posts big blind $0.25
CmngQmkKTp8tkl6GMRTl6w: sits out 
knif3: sits out 
*** HOLE CARDS ***
v5jnQ1gfh9nLla3kMXG7Yg: calls $0.25
7cv+9Zc9HIQHNvYsMfV3uA: folds 
6qsItdeWZoOL5be2e1RFng: raises $0.25 to $0.50
RubYqfvGrz2z+5ReNIj9QQ: folds 
iOmwbUN7u4JFkV6VCA49aA: folds 
9gmYYQesalMrUjaF7nKfrQ: folds 
tYsOBqdU1+x+yFI7zHO7hQ: folds 
v5jnQ1gfh9nLla3kMXG7Yg: calls $0.25
*** FLOP *** [6c Ac 3c]
v5jnQ1gfh9nLla3kMXG7Yg: folds 
6qsItdeWZoOL5be2e1RFng collected $1.30 from pot
*** SUMMARY ***
Total pot $1.35 | Rake $0.05 
Board [6c Ac 3c]
Seat 1: 7cv+9Zc9HIQHNvYsMfV3uA folded before Flop (didn't bet)
Seat 3: 6qsItdeWZoOL5be2e1RFng collected ($1.30)
Seat 4: RubYqfvGrz2z+5ReNIj9QQ folded before Flop (didn't bet)
Seat 5: iOmwbUN7u4JFkV6VCA49aA (button) folded before Flop (didn't bet)
Seat 6: 9gmYYQesalMrUjaF7nKfrQ (small blind) folded before Flop
Seat 7: tYsOBqdU1+x+yFI7zHO7hQ (big blind) folded before Flop
Seat 8: v5jnQ1gfh9nLla3kMXG7Yg folded on the Flop




PokerStars Game #59941566710:  Hold'em No Limit ($0.10/$0.25) - 2009/07/01 1:39:21 ET
Table 'QzXakDK7ZHNjgIpoUFGSKQ' 9-max Seat #4 is the button
Seat 1: w1ukf8uPa4+WH561TtVRxA ($28.70 in chips) 
Seat 3: eK8qa6EPcH2zhtbmWSvc9g ($25.65 in chips) 
Seat 4: 12pxJGeALcKLTBryE6kFxA ($12.25 in chips) 
Seat 5: MtVtHDqIJTyUcXkRBBDIVA ($25 in chips) 
Seat 7: wGigCmBR/9XWkPpvYos3aQ ($31.05 in chips) 
Seat 8: 3PmVnC/15cl4oyI1TKIt4g ($10 in chips) 
Seat 9: lwrOE80tuooHfIBx/4LUSw ($25.30 in chips) 
MtVtHDqIJTyUcXkRBBDIVA: posts small blind $0.10
wGigCmBR/9XWkPpvYos3aQ: posts big blind $0.25
QEbIGci+itdw+re8RM5fZA: sits out 
*** HOLE CARDS ***
3PmVnC/15cl4oyI1TKIt4g: folds 
lwrOE80tuooHfIBx/4LUSw: folds 
w1ukf8uPa4+WH561TtVRxA: raises $0.50 to $0.75
eK8qa6EPcH2zhtbmWSvc9g: folds 
12pxJGeALcKLTBryE6kFxA: folds 
MtVtHDqIJTyUcXkRBBDIVA: folds 
wGigCmBR/9XWkPpvYos3aQ: folds 
Uncalled bet ($0.50) returned to w1ukf8uPa4+WH561TtVRxA
gehe91e0IyVT0QU/XBkEyg joins the table at seat #6 
w1ukf8uPa4+WH561TtVRxA collected $0.60 from pot
w1ukf8uPa4+WH561TtVRxA: doesn't show hand 
*** SUMMARY ***
Total pot $0.60 | Rake $0 
Seat 1: w1ukf8uPa4+WH561TtVRxA collected ($0.60)
Seat 3: eK8qa6EPcH2zhtbmWSvc9g folded before Flop (didn't bet)
Seat 4: 12pxJGeALcKLTBryE6kFxA (button) folded before Flop (didn't bet)
Seat 5: MtVtHDqIJTyUcXkRBBDIVA (small blind) folded before Flop
Seat 7: wGigCmBR/9XWkPpvYos3aQ (big blind) folded before Flop
Seat 8: 3PmVnC/15cl4oyI1TKIt4g folded before Flop (didn't bet)
Seat 9: lwrOE80tuooHfIBx/4LUSw folded before Flop (didn't bet)




PokerStars Game #59941567136:  Hold'em No Limit ($0.10/$0.25) - 2009/07/01 1:39:22 ET
Table 'rpIHGyt2QpgQc5bvptAvDQ' 9-max Seat #5 is the button
Seat 3: OzXv12vW3/jO5rPU5mJHQg ($5.25 in chips) 
Seat 5: z2SmIaQ3+5n/eY1BN5HgPg ($15 in chips) 
Seat 6: Mq1ESwxx3LEsA4HjKKjU3Q ($15.85 in chips) 
Mq1ESwxx3LEsA4HjKKjU3Q: posts small blind $0.10
OzXv12vW3/jO5rPU5mJHQg: posts big blind $0.25
*** HOLE CARDS ***
z2SmIaQ3+5n/eY1BN5HgPg: folds 
Mq1ESwxx3LEsA4HjKKjU3Q: folds 
Uncalled bet ($0.15) returned to OzXv12vW3/jO5rPU5mJHQg
OzXv12vW3/jO5rPU5mJHQg collected $0.20 from pot
*** SUMMARY ***
Total pot $0.20 | Rake $0 
Seat 3: OzXv12vW3/jO5rPU5mJHQg (big blind) collected ($0.20)
Seat 5: z2SmIaQ3+5n/eY1BN5HgPg (button) folded before Flop (didn't bet)
Seat 6: Mq1ESwxx3LEsA4HjKKjU3Q (small blind) folded before Flop




PokerStars Game #59941566822:  Hold'em No Limit ($0.10/$0.25) - 2009/07/01 1:39:22 ET
Table '0M5QEJGOThqZwQ/sjbjXYw' 6-max Seat #3 is the button
Seat 1: 2G0C7dp4wlPpE21FHjjElQ ($25.60 in chips) 
Seat 2: /gJNBeCkWL4o85/jvlZ4BA ($36.70 in chips) 
Seat 3: 3zD3qLXT1bEffAoWGnc7wg ($25 in chips) 
Seat 4: oBUDUfeUyCbZBsjxHZgSiw ($24.75 in chips) 
Seat 5: cWc85bEzdRzpUMhRKm8pwQ ($27.35 in chips) 
Seat 6: mYz11CHiw5KsDCRD5T7/jg ($42.15 in chips) 
oBUDUfeUyCbZBsjxHZgSiw: posts small blind $0.10
cWc85bEzdRzpUMhRKm8pwQ: posts big blind $0.25
*** HOLE CARDS ***
mYz11CHiw5KsDCRD5T7/jg: calls $0.25
2G0C7dp4wlPpE21FHjjElQ: folds 
/gJNBeCkWL4o85/jvlZ4BA: folds 
3zD3qLXT1bEffAoWGnc7wg: folds 
oBUDUfeUyCbZBsjxHZgSiw: folds 
cWc85bEzdRzpUMhRKm8pwQ: checks 
*** FLOP *** [8c 5s As]
cWc85bEzdRzpUMhRKm8pwQ: bets $0.50
mYz11CHiw5KsDCRD5T7/jg: calls $0.50
*** TURN *** [8c 5s As] [7s]
cWc85bEzdRzpUMhRKm8pwQ: checks 
mYz11CHiw5KsDCRD5T7/jg: checks 
*** RIVER *** [8c 5s As 7s] [4c]
cWc85bEzdRzpUMhRKm8pwQ: checks 
mYz11CHiw5KsDCRD5T7/jg: checks 
*** SHOW DOWN ***
cWc85bEzdRzpUMhRKm8pwQ: shows [8h Ts] (a pair of Eights)
mYz11CHiw5KsDCRD5T7/jg: mucks hand 
cWc85bEzdRzpUMhRKm8pwQ collected $1.55 from pot
*** SUMMARY ***
Total pot $1.60 | Rake $0.05 
Board [8c 5s As 7s 4c]
Seat 1: 2G0C7dp4wlPpE21FHjjElQ folded before Flop (didn't bet)
Seat 2: /gJNBeCkWL4o85/jvlZ4BA folded before Flop (didn't bet)
Seat 3: 3zD3qLXT1bEffAoWGnc7wg (button) folded before Flop (didn't bet)
Seat 4: oBUDUfeUyCbZBsjxHZgSiw (small blind) folded before Flop
Seat 5: cWc85bEzdRzpUMhRKm8pwQ (big blind) showed [8h Ts] and won ($1.55) with a pair of Eights
Seat 6: mYz11CHiw5KsDCRD5T7/jg mucked




PokerStars Game #59941567270:  Hold'em No Limit ($0.10/$0.25) - 2009/07/01 1:39:22 ET
Table 'gYBWJG3hEuJg6kphY0yhMg' 9-max Seat #4 is the button
Seat 1: AcL/hxc9eT0dCr2TYk/0Dg ($16.80 in chips) 
Seat 3: wGigCmBR/9XWkPpvYos3aQ ($25 in chips) 
Seat 4: V6p0jQ/RhUsqpHLmXvEX4Q ($13 in chips) 
Seat 5: +sbyWwIcFp9kP0bDtMegfQ ($24.30 in chips) 
Seat 6: fI5jtRq/8R6QjoWU5AnUOQ ($11.95 in chips) 
Seat 7: EQXHDnIzAsORnIXRNtXRlA ($19.65 in chips) 
Seat 8: VCKtuATyvAq9H2JSAQxPbA ($14.95 in chips) 
Seat 9: Bb42QRQMhg5/Y0vHP8/2Xw ($25.60 in chips) 
+sbyWwIcFp9kP0bDtMegfQ: posts small blind $0.10
fI5jtRq/8R6QjoWU5AnUOQ: posts big blind $0.25
RCqMONFrSPSArZh2Jsar/w: sits out 
*** HOLE CARDS ***
EQXHDnIzAsORnIXRNtXRlA: folds 
VCKtuATyvAq9H2JSAQxPbA: folds 
Bb42QRQMhg5/Y0vHP8/2Xw: folds 
AcL/hxc9eT0dCr2TYk/0Dg: folds 
wGigCmBR/9XWkPpvYos3aQ: folds 
V6p0jQ/RhUsqpHLmXvEX4Q: folds 
+sbyWwIcFp9kP0bDtMegfQ: raises $0.75 to $1
fI5jtRq/8R6QjoWU5AnUOQ: calls $0.75
*** FLOP *** [3c 3s 7h]
+sbyWwIcFp9kP0bDtMegfQ: checks 
fI5jtRq/8R6QjoWU5AnUOQ: bets $1
+sbyWwIcFp9kP0bDtMegfQ: calls $1
*** TURN *** [3c 3s 7h] [2h]
+sbyWwIcFp9kP0bDtMegfQ: checks 
fI5jtRq/8R6QjoWU5AnUOQ: bets $1.50
+sbyWwIcFp9kP0bDtMegfQ: calls $1.50
*** RIVER *** [3c 3s 7h 2h] [Kd]
+sbyWwIcFp9kP0bDtMegfQ: bets $0.50
fI5jtRq/8R6QjoWU5AnUOQ: calls $0.50
*** SHOW DOWN ***
+sbyWwIcFp9kP0bDtMegfQ: shows [Jh As] (a pair of Threes)
fI5jtRq/8R6QjoWU5AnUOQ: mucks hand 
+sbyWwIcFp9kP0bDtMegfQ collected $7.65 from pot
*** SUMMARY ***
Total pot $8 | Rake $0.35 
Board [3c 3s 7h 2h Kd]
Seat 1: AcL/hxc9eT0dCr2TYk/0Dg folded before Flop (didn't bet)
Seat 3: wGigCmBR/9XWkPpvYos3aQ folded before Flop (didn't bet)
Seat 4: V6p0jQ/RhUsqpHLmXvEX4Q (button) folded before Flop (didn't bet)
Seat 5: +sbyWwIcFp9kP0bDtMegfQ (small blind) showed [Jh As] and won ($7.65) with a pair of Threes
Seat 6: fI5jtRq/8R6QjoWU5AnUOQ (big blind) mucked
Seat 7: EQXHDnIzAsORnIXRNtXRlA folded before Flop (didn't bet)
Seat 8: VCKtuATyvAq9H2JSAQxPbA folded before Flop (didn't bet)
Seat 9: Bb42QRQMhg5/Y0vHP8/2Xw folded before Flop (didn't bet)




PokerStars Game #59941566986:  Hold'em No Limit ($0.10/$0.25) - 2009/07/01 1:39:22 ET
Table '+UzantPJ4smVdrh+4GTu1w' 6-max Seat #6 is the button
Seat 1: TSmua8tGK3sTbwi0ynrW9Q ($27.80 in chips) 
Seat 3: SS/yfeArhULzIcOPe8MdPg ($29.60 in chips) 
Seat 4: UmcUp27+PbgBItv3ZNlAWQ ($25.25 in chips) 
Seat 5: cj4VBQya7HtVL2zCGd5jLQ ($60.45 in chips) 
Seat 6: fZQg9veL7Dd/Z04ZTjC+wQ ($25 in chips) 
TSmua8tGK3sTbwi0ynrW9Q: posts small blind $0.10
SS/yfeArhULzIcOPe8MdPg: posts big blind $0.25
*** HOLE CARDS ***
UmcUp27+PbgBItv3ZNlAWQ: folds 
cj4VBQya7HtVL2zCGd5jLQ: folds 
fZQg9veL7Dd/Z04ZTjC+wQ: folds 
TSmua8tGK3sTbwi0ynrW9Q: folds 
Uncalled bet ($0.15) returned to SS/yfeArhULzIcOPe8MdPg
SS/yfeArhULzIcOPe8MdPg collected $0.20 from pot
*** SUMMARY ***
Total pot $0.20 | Rake $0 
Seat 1: TSmua8tGK3sTbwi0ynrW9Q (small blind) folded before Flop
Seat 3: SS/yfeArhULzIcOPe8MdPg (big blind) collected ($0.20)
Seat 4: UmcUp27+PbgBItv3ZNlAWQ folded before Flop (didn't bet)
Seat 5: cj4VBQya7HtVL2zCGd5jLQ folded before Flop (didn't bet)
Seat 6: fZQg9veL7Dd/Z04ZTjC+wQ (button) folded before Flop (didn't bet)




PokerStars Game #59941567200:  Hold'em No Limit ($0.10/$0.25) - 2009/07/01 1:39:22 ET
Table 'nyTW9cVtYentc5V7xU/0jA' 6-max Seat #1 is the button
Seat 1: HI20pVxSHPZ29u9IDkmICg ($9.15 in chips) 
Seat 3: kG34n23qFQA3nzdOJTQ1dA ($36.55 in chips) 
Seat 4: NkB3D4eVHHXvB9Edaugc1Q ($20.15 in chips) 
Seat 5: zZAcuQ0EvirdEuiIbeaocQ ($15.45 in chips) 
kG34n23qFQA3nzdOJTQ1dA: posts small blind $0.10
NkB3D4eVHHXvB9Edaugc1Q: posts big blind $0.25
*** HOLE CARDS ***
zZAcuQ0EvirdEuiIbeaocQ: folds 
HI20pVxSHPZ29u9IDkmICg: raises $0.50 to $0.75
kG34n23qFQA3nzdOJTQ1dA: folds 
NkB3D4eVHHXvB9Edaugc1Q: calls $0.50
*** FLOP *** [Kd 6c 2d]
NkB3D4eVHHXvB9Edaugc1Q: bets $0.25
HI20pVxSHPZ29u9IDkmICg: raises $0.75 to $1
NkB3D4eVHHXvB9Edaugc1Q: folds 
Uncalled bet ($0.75) returned to HI20pVxSHPZ29u9IDkmICg
HI20pVxSHPZ29u9IDkmICg collected $2 from pot
*** SUMMARY ***
Total pot $2.10 | Rake $0.10 
Board [Kd 6c 2d]
Seat 1: HI20pVxSHPZ29u9IDkmICg (button) collected ($2)
Seat 3: kG34n23qFQA3nzdOJTQ1dA (small blind) folded before Flop
Seat 4: NkB3D4eVHHXvB9Edaugc1Q (big blind) folded on the Flop
Seat 5: zZAcuQ0EvirdEuiIbeaocQ folded before Flop (didn't bet)




PokerStars Game #59941566864:  Hold'em No Limit ($0.10/$0.25) - 2009/07/01 1:39:22 ET
Table 'U0hCzoS0KCJL+eoE054K4Q' 9-max Seat #3 is the button
Seat 1: XVEauYThJRhSTUAMxB/2ow ($38.45 in chips) 
Seat 2: MG90wfSJZnOejs/KD3vlQQ ($25 in chips) 
Seat 3: 8Cp1H3sSs8+jTTwLfeYKcw ($28.10 in chips) 
Seat 4: Bb42QRQMhg5/Y0vHP8/2Xw ($25.20 in chips) 
Seat 5: zgi+EUykT/pZQpoUG6+oEg ($6.35 in chips) 
Seat 6: V6p0jQ/RhUsqpHLmXvEX4Q ($12.25 in chips) 
Seat 7: uetHVityNsFnyX2bBnKe2A ($17 in chips) 
Seat 8: K0b5wNInj6hUGRr6yzKFtw ($25 in chips) 
Seat 9: wGigCmBR/9XWkPpvYos3aQ ($31.95 in chips) 
Bb42QRQMhg5/Y0vHP8/2Xw: posts small blind $0.10
zgi+EUykT/pZQpoUG6+oEg: posts big blind $0.25
*** HOLE CARDS ***
V6p0jQ/RhUsqpHLmXvEX4Q: folds 
uetHVityNsFnyX2bBnKe2A: folds 
K0b5wNInj6hUGRr6yzKFtw: folds 
wGigCmBR/9XWkPpvYos3aQ: raises $0.65 to $0.90
XVEauYThJRhSTUAMxB/2ow: folds 
MG90wfSJZnOejs/KD3vlQQ: folds 
8Cp1H3sSs8+jTTwLfeYKcw: calls $0.90
Bb42QRQMhg5/Y0vHP8/2Xw: folds 
zgi+EUykT/pZQpoUG6+oEg: folds 
*** FLOP *** [2h 3c 6s]
wGigCmBR/9XWkPpvYos3aQ: bets $1.60
8Cp1H3sSs8+jTTwLfeYKcw: folds 
Uncalled bet ($1.60) returned to wGigCmBR/9XWkPpvYos3aQ
wGigCmBR/9XWkPpvYos3aQ collected $2.05 from pot
wGigCmBR/9XWkPpvYos3aQ: doesn't show hand 
*** SUMMARY ***
Total pot $2.15 | Rake $0.10 
Board [2h 3c 6s]
Seat 1: XVEauYThJRhSTUAMxB/2ow folded before Flop (didn't bet)
Seat 2: MG90wfSJZnOejs/KD3vlQQ folded before Flop (didn't bet)
Seat 3: 8Cp1H3sSs8+jTTwLfeYKcw (button) folded on the Flop
Seat 4: Bb42QRQMhg5/Y0vHP8/2Xw (small blind) folded before Flop
Seat 5: zgi+EUykT/pZQpoUG6+oEg (big blind) folded before Flop
Seat 6: V6p0jQ/RhUsqpHLmXvEX4Q folded before Flop (didn't bet)
Seat 7: uetHVityNsFnyX2bBnKe2A folded before Flop (didn't bet)
Seat 8: K0b5wNInj6hUGRr6yzKFtw folded before Flop (didn't bet)
Seat 9: wGigCmBR/9XWkPpvYos3aQ collected ($2.05)




PokerStars Game #59941567206:  Hold'em No Limit ($0.10/$0.25) - 2009/07/01 1:39:22 ET
Table 'SgI2Cobdjtkh0Fd0/eTTDg' 9-max Seat #7 is the button
Seat 1: NcPAt5YjVvDFEJTTgAVj8g ($3.90 in chips) 
Seat 2: uUc5QTI8+ZdC95UnznCsqg ($13.10 in chips) 
Seat 3: OiV1PWZ3IkN29JlmCcnTwQ ($4.90 in chips) 
Seat 4: s1y+qfkBnhgc67+X3ThjeA ($11 in chips) 
Seat 5: w/RUHfVzKTf7Bc19nucLpQ ($23.70 in chips) 
Seat 6: 6RiVTYll/5D8zICp0MRpKw ($24.40 in chips) 
Seat 7: lOuxRXNpa9V2VxLMNpxUOg ($23.60 in chips) 
Seat 8: 8GJHzzxiotOqC5gdtgpLoA ($9.75 in chips) 
Seat 9: cZ99hugmLBj9KhTlc8nCSw ($31.30 in chips) 
8GJHzzxiotOqC5gdtgpLoA: posts small blind $0.10
cZ99hugmLBj9KhTlc8nCSw: posts big blind $0.25
*** HOLE CARDS ***
NcPAt5YjVvDFEJTTgAVj8g: calls $0.25
uUc5QTI8+ZdC95UnznCsqg: folds 
OiV1PWZ3IkN29JlmCcnTwQ: folds 
s1y+qfkBnhgc67+X3ThjeA: folds 
w/RUHfVzKTf7Bc19nucLpQ: folds 
6RiVTYll/5D8zICp0MRpKw: raises $1 to $1.25
lOuxRXNpa9V2VxLMNpxUOg: folds 
8GJHzzxiotOqC5gdtgpLoA: folds 
cZ99hugmLBj9KhTlc8nCSw: folds 
NcPAt5YjVvDFEJTTgAVj8g: calls $1
*** FLOP *** [8c 2c Ks]
NcPAt5YjVvDFEJTTgAVj8g: checks 
6RiVTYll/5D8zICp0MRpKw: bets $2.25
NcPAt5YjVvDFEJTTgAVj8g: folds 
Uncalled bet ($2.25) returned to 6RiVTYll/5D8zICp0MRpKw
6RiVTYll/5D8zICp0MRpKw collected $2.75 from pot
*** SUMMARY ***
Total pot $2.85 | Rake $0.10 
Board [8c 2c Ks]
Seat 1: NcPAt5YjVvDFEJTTgAVj8g folded on the Flop
Seat 2: uUc5QTI8+ZdC95UnznCsqg folded before Flop (didn't bet)
Seat 3: OiV1PWZ3IkN29JlmCcnTwQ folded before Flop (didn't bet)
Seat 4: s1y+qfkBnhgc67+X3ThjeA folded before Flop (didn't bet)
Seat 5: w/RUHfVzKTf7Bc19nucLpQ folded before Flop (didn't bet)
Seat 6: 6RiVTYll/5D8zICp0MRpKw collected ($2.75)
Seat 7: lOuxRXNpa9V2VxLMNpxUOg (button) folded before Flop (didn't bet)
Seat 8: 8GJHzzxiotOqC5gdtgpLoA (small blind) folded before Flop
Seat 9: cZ99hugmLBj9KhTlc8nCSw (big blind) folded before Flop




PokerStars Game #59941567944:  Hold'em No Limit ($0.10/$0.25) - 2009/07/01 1:39:23 ET
Table 'h02LhQ7B/Zk4ETRxxHhGYA' 9-max Seat #1 is the button
Seat 1: sD+TKtt36XiiN6jqHiLwDA ($25.25 in chips) 
Seat 2: 9lvO/qyU+xrU95Teu1fv0g ($5.80 in chips) 
Seat 3: arxNSjreDRGFg13EAM2F1w ($25 in chips) 
Seat 4: tYsOBqdU1+x+yFI7zHO7hQ ($38.45 in chips) 
Seat 5: cUxk0Jk4lrUQv9CJl0LPlg ($27.55 in chips) 
Seat 6: UvM6sxFT7el5hVDehvWvTA ($33.90 in chips) 
Seat 7: y7w8+Oqq4SkI1dkRDCx2Zg ($3.25 in chips) 
Seat 8: mUoFJKqCzIUABvOFbiINlQ ($15 in chips) 
Seat 9: MgzS9dEPzsGYQW57RteFhw ($7.05 in chips) 
9lvO/qyU+xrU95Teu1fv0g: posts small blind $0.10
arxNSjreDRGFg13EAM2F1w: posts big blind $0.25
*** HOLE CARDS ***
tYsOBqdU1+x+yFI7zHO7hQ: folds 
cUxk0Jk4lrUQv9CJl0LPlg: folds 
UvM6sxFT7el5hVDehvWvTA: folds 
y7w8+Oqq4SkI1dkRDCx2Zg: folds 
mUoFJKqCzIUABvOFbiINlQ: folds 
MgzS9dEPzsGYQW57RteFhw: raises $0.25 to $0.50
sD+TKtt36XiiN6jqHiLwDA: folds 
9lvO/qyU+xrU95Teu1fv0g: folds 
arxNSjreDRGFg13EAM2F1w: folds 
Uncalled bet ($0.25) returned to MgzS9dEPzsGYQW57RteFhw
MgzS9dEPzsGYQW57RteFhw collected $0.60 from pot
*** SUMMARY ***
Total pot $0.60 | Rake $0 
Seat 1: sD+TKtt36XiiN6jqHiLwDA (button) folded before Flop (didn't bet)
Seat 2: 9lvO/qyU+xrU95Teu1fv0g (small blind) folded before Flop
Seat 3: arxNSjreDRGFg13EAM2F1w (big blind) folded before Flop
Seat 4: tYsOBqdU1+x+yFI7zHO7hQ folded before Flop (didn't bet)
Seat 5: cUxk0Jk4lrUQv9CJl0LPlg folded before Flop (didn't bet)
Seat 6: UvM6sxFT7el5hVDehvWvTA folded before Flop (didn't bet)
Seat 7: y7w8+Oqq4SkI1dkRDCx2Zg folded before Flop (didn't bet)
Seat 8: mUoFJKqCzIUABvOFbiINlQ folded before Flop (didn't bet)
Seat 9: MgzS9dEPzsGYQW57RteFhw collected ($0.60)




PokerStars Game #59941567962:  Hold'em No Limit ($0.10/$0.25) - 2009/07/01 1:39:23 ET
Table 'jxoHy9yJy0bbH/Qx73FoPA' 9-max Seat #6 is the button
Seat 1: j4q3p0lesp63b1gZDwLBZw ($6.25 in chips) 
Seat 2: F7pnn6czNpHvRM55XcA2EA ($38.75 in chips) 
Seat 3: CVqCt93Mk0MhKMaZ4LZDSQ ($6.55 in chips) 
Seat 4: A1M0JIGHzqMXp7L2MdcxXw ($26.65 in chips) 
Seat 5: cZ99hugmLBj9KhTlc8nCSw ($25.10 in chips) 
Seat 6: tYsOBqdU1+x+yFI7zHO7hQ ($46.35 in chips) 
Seat 7: wGigCmBR/9XWkPpvYos3aQ ($26.50 in chips) 
Seat 9: CvL9Ch1HYCVbTsfpNucitg ($5 in chips) 
wGigCmBR/9XWkPpvYos3aQ: posts small blind $0.10
CvL9Ch1HYCVbTsfpNucitg: posts big blind $0.25
*** HOLE CARDS ***
j4q3p0lesp63b1gZDwLBZw: folds 
F7pnn6czNpHvRM55XcA2EA: folds 
CVqCt93Mk0MhKMaZ4LZDSQ: calls $0.25
A1M0JIGHzqMXp7L2MdcxXw: folds 
cZ99hugmLBj9KhTlc8nCSw: folds 
tYsOBqdU1+x+yFI7zHO7hQ: folds 
wGigCmBR/9XWkPpvYos3aQ: folds 
CvL9Ch1HYCVbTsfpNucitg: raises $0.75 to $1
CVqCt93Mk0MhKMaZ4LZDSQ: calls $0.75
*** FLOP *** [7s 3h Qs]
CvL9Ch1HYCVbTsfpNucitg: bets $1
CVqCt93Mk0MhKMaZ4LZDSQ: calls $1
*** TURN *** [7s 3h Qs] [9s]
CvL9Ch1HYCVbTsfpNucitg: bets $3 and is all-in
CVqCt93Mk0MhKMaZ4LZDSQ: calls $3
*** RIVER *** [7s 3h Qs 9s] [Jc]
*** SHOW DOWN ***
CvL9Ch1HYCVbTsfpNucitg: shows [Ts Th] (a pair of Tens)
CVqCt93Mk0MhKMaZ4LZDSQ: shows [Qc 4c] (a pair of Queens)
CVqCt93Mk0MhKMaZ4LZDSQ collected $9.65 from pot
*** SUMMARY ***
Total pot $10.10 | Rake $0.45 
Board [7s 3h Qs 9s Jc]
Seat 1: j4q3p0lesp63b1gZDwLBZw folded before Flop (didn't bet)
Seat 2: F7pnn6czNpHvRM55XcA2EA folded before Flop (didn't bet)
Seat 3: CVqCt93Mk0MhKMaZ4LZDSQ showed [Qc 4c] and won ($9.65) with a pair of Queens
Seat 4: A1M0JIGHzqMXp7L2MdcxXw folded before Flop (didn't bet)
Seat 5: cZ99hugmLBj9KhTlc8nCSw folded before Flop (didn't bet)
Seat 6: tYsOBqdU1+x+yFI7zHO7hQ (button) folded before Flop (didn't bet)
Seat 7: wGigCmBR/9XWkPpvYos3aQ (small blind) folded before Flop
Seat 9: CvL9Ch1HYCVbTsfpNucitg (big blind) showed [Ts Th] and lost with a pair of Tens




PokerStars Game #59941567838:  Hold'em No Limit ($0.10/$0.25) - 2009/07/01 1:39:23 ET
Table '63h13e5p7cWe02rClZ1CHw' 6-max Seat #4 is the button
Seat 1: pokjbbEcXXPlADXdSGHtZw ($21.90 in chips) 
Seat 2: k9nHZTHt8hYhYRcW8NTb4g ($26.80 in chips) 
Seat 3: mFv3iBCtrw9XfCDRB0d46Q ($5.75 in chips) 
Seat 4: xrf8tAXKQHG99HixCot1Iw ($23 in chips) 
Seat 5: iyZxqznXjv3vtvOJymkoLQ ($45.25 in chips) 
Seat 6: mfrkWA3PTeYPkbO6hi98Aw ($38.45 in chips) 
iyZxqznXjv3vtvOJymkoLQ: posts small blind $0.10
mfrkWA3PTeYPkbO6hi98Aw: posts big blind $0.25
*** HOLE CARDS ***
pokjbbEcXXPlADXdSGHtZw: folds 
k9nHZTHt8hYhYRcW8NTb4g: folds 
mFv3iBCtrw9XfCDRB0d46Q: folds 
xrf8tAXKQHG99HixCot1Iw: folds 
iyZxqznXjv3vtvOJymkoLQ: folds 
Uncalled bet ($0.15) returned to mfrkWA3PTeYPkbO6hi98Aw
mfrkWA3PTeYPkbO6hi98Aw collected $0.20 from pot
mfrkWA3PTeYPkbO6hi98Aw: doesn't show hand 
*** SUMMARY ***
Total pot $0.20 | Rake $0 
Seat 1: pokjbbEcXXPlADXdSGHtZw folded before Flop (didn't bet)
Seat 2: k9nHZTHt8hYhYRcW8NTb4g folded before Flop (didn't bet)
Seat 3: mFv3iBCtrw9XfCDRB0d46Q folded before Flop (didn't bet)
Seat 4: xrf8tAXKQHG99HixCot1Iw (button) folded before Flop (didn't bet)
Seat 5: iyZxqznXjv3vtvOJymkoLQ (small blind) folded before Flop
Seat 6: mfrkWA3PTeYPkbO6hi98Aw (big blind) collected ($0.20)




PokerStars Game #59941567488:  Hold'em No Limit ($0.10/$0.25) - 2009/07/01 1:39:23 ET
Table 'M8kYidAX3ib7pLKW7edFLw' 6-max Seat #1 is the button
Seat 1: jp34e617tIzV8tKIWmfAbA ($25.35 in chips) 
Seat 2: ypmjhffk/YHGc51wgVXUTw ($28.55 in chips) 
Seat 3: cezpHJ8FB07dj0xG+LhOvw ($27.80 in chips) 
Seat 4: Hsvkc0/G2VV78oVmWYXecw ($5.35 in chips) 
Seat 5: bDKopKTvPi3W+PEnYUX3tg ($44.15 in chips) 
Seat 6: NqFoyDgzLwu4dOmSRXnFBA ($20 in chips) 
ypmjhffk/YHGc51wgVXUTw: posts small blind $0.10
cezpHJ8FB07dj0xG+LhOvw: posts big blind $0.25
*** HOLE CARDS ***
Hsvkc0/G2VV78oVmWYXecw: folds 
bDKopKTvPi3W+PEnYUX3tg: folds 
NqFoyDgzLwu4dOmSRXnFBA: folds 
jp34e617tIzV8tKIWmfAbA: raises $0.50 to $0.75
ypmjhffk/YHGc51wgVXUTw: folds 
cezpHJ8FB07dj0xG+LhOvw: folds 
Uncalled bet ($0.50) returned to jp34e617tIzV8tKIWmfAbA
jp34e617tIzV8tKIWmfAbA collected $0.60 from pot
*** SUMMARY ***
Total pot $0.60 | Rake $0 
Seat 1: jp34e617tIzV8tKIWmfAbA (button) collected ($0.60)
Seat 2: ypmjhffk/YHGc51wgVXUTw (small blind) folded before Flop
Seat 3: cezpHJ8FB07dj0xG+LhOvw (big blind) folded before Flop
Seat 4: Hsvkc0/G2VV78oVmWYXecw folded before Flop (didn't bet)
Seat 5: bDKopKTvPi3W+PEnYUX3tg folded before Flop (didn't bet)
Seat 6: NqFoyDgzLwu4dOmSRXnFBA folded before Flop (didn't bet)




PokerStars Game #59941568292:  Hold'em No Limit ($0.10/$0.25) - 2009/07/01 1:39:24 ET
Table 'xPn6TS/y/OWkX7Qa+MUuKA' 6-max Seat #4 is the button
Seat 1: JFIAqU8lCZ0vWwEl4bdGsg ($42.15 in chips) 
Seat 2: buyjetgNT1McXtdaP4zynA ($32.50 in chips) 
Seat 3: q6WfTUAD9mowIP63ASq2Dg ($25.90 in chips) 
Seat 4: SS/yfeArhULzIcOPe8MdPg ($25.90 in chips) 
Seat 5: lquriepNQBhDV5P1SWHhnA ($25.55 in chips) 
Seat 6: DihMHaz4WNETH1bPDe13kA ($25 in chips) 
lquriepNQBhDV5P1SWHhnA: posts small blind $0.10
DihMHaz4WNETH1bPDe13kA: posts big blind $0.25
*** HOLE CARDS ***
JFIAqU8lCZ0vWwEl4bdGsg: folds 
buyjetgNT1McXtdaP4zynA: raises $0.75 to $1
q6WfTUAD9mowIP63ASq2Dg: folds 
SS/yfeArhULzIcOPe8MdPg: folds 
lquriepNQBhDV5P1SWHhnA: folds 
DihMHaz4WNETH1bPDe13kA: folds 
Uncalled bet ($0.75) returned to buyjetgNT1McXtdaP4zynA
buyjetgNT1McXtdaP4zynA collected $0.60 from pot
*** SUMMARY ***
Total pot $0.60 | Rake $0 
Seat 1: JFIAqU8lCZ0vWwEl4bdGsg folded before Flop (didn't bet)
Seat 2: buyjetgNT1McXtdaP4zynA collected ($0.60)
Seat 3: q6WfTUAD9mowIP63ASq2Dg folded before Flop (didn't bet)
Seat 4: SS/yfeArhULzIcOPe8MdPg (button) folded before Flop (didn't bet)
Seat 5: lquriepNQBhDV5P1SWHhnA (small blind) folded before Flop
Seat 6: DihMHaz4WNETH1bPDe13kA (big blind) folded before Flop




PokerStars Game #59941568438:  Hold'em No Limit ($0.10/$0.25) - 2009/07/01 1:39:24 ET
Table 'GxdLtCpYxqT4aAbYqkEEpw' 6-max Seat #1 is the button
Seat 1: 2d/PU00mMdO9azAaXqcSbw ($14.25 in chips) 
Seat 2: 3iomNWHjIokoWh6JNWCUJQ ($3.75 in chips) 
Seat 3: LpmZGzLpOmfZUF7EV4ZlrQ ($16.05 in chips) 
Seat 4: 6wzJiRvp8HY6t+MQGnSIzA ($5.35 in chips) 
Seat 5: q6WfTUAD9mowIP63ASq2Dg ($35.10 in chips) 
Seat 6: DFi/Lzkjsfv8QswS80JX9Q ($25 in chips) 
3iomNWHjIokoWh6JNWCUJQ: posts small blind $0.10
LpmZGzLpOmfZUF7EV4ZlrQ: posts big blind $0.25
*** HOLE CARDS ***
6wzJiRvp8HY6t+MQGnSIzA: raises $5.10 to $5.35 and is all-in
q6WfTUAD9mowIP63ASq2Dg: folds 
DFi/Lzkjsfv8QswS80JX9Q: folds 
2d/PU00mMdO9azAaXqcSbw: folds 
3iomNWHjIokoWh6JNWCUJQ: folds 
LpmZGzLpOmfZUF7EV4ZlrQ: folds 
Uncalled bet ($5.10) returned to 6wzJiRvp8HY6t+MQGnSIzA
6wzJiRvp8HY6t+MQGnSIzA collected $0.60 from pot
6wzJiRvp8HY6t+MQGnSIzA: doesn't show hand 
*** SUMMARY ***
Total pot $0.60 | Rake $0 
Seat 1: 2d/PU00mMdO9azAaXqcSbw (button) folded before Flop (didn't bet)
Seat 2: 3iomNWHjIokoWh6JNWCUJQ (small blind) folded before Flop
Seat 3: LpmZGzLpOmfZUF7EV4ZlrQ (big blind) folded before Flop
Seat 4: 6wzJiRvp8HY6t+MQGnSIzA collected ($0.60)
Seat 5: q6WfTUAD9mowIP63ASq2Dg folded before Flop (didn't bet)
Seat 6: DFi/Lzkjsfv8QswS80JX9Q folded before Flop (didn't bet)




PokerStars Game #59941568226:  Hold'em No Limit ($0.10/$0.25) - 2009/07/01 1:39:24 ET
Table 'ZEXL6Wh4qA4Afx8NnoBBAA' 6-max Seat #5 is the button
Seat 1: v8m8XHovI5tqEA9mvplDSw ($27.60 in chips) 
Seat 2: 6DwBRH+xZ12AAZmeAg+aXw ($33.05 in chips) 
Seat 3: +ZlnqPoP3Hg4BIUxDfKd/A ($31.75 in chips) 
Seat 4: FpN4KbLjlyRRKiVaQcoLqA ($31.55 in chips) 
Seat 5: if4dh6jhJXeN3/qd3qCp9g ($27 in chips) 
Seat 6: Lh8SlCq3OSDKWLUgAI/Lxw ($1.55 in chips) 
Lh8SlCq3OSDKWLUgAI/Lxw: posts small blind $0.10
v8m8XHovI5tqEA9mvplDSw: posts big blind $0.25
*** HOLE CARDS ***
6DwBRH+xZ12AAZmeAg+aXw: folds 
+ZlnqPoP3Hg4BIUxDfKd/A: folds 
FpN4KbLjlyRRKiVaQcoLqA: folds 
if4dh6jhJXeN3/qd3qCp9g: folds 
Lh8SlCq3OSDKWLUgAI/Lxw: calls $0.15
v8m8XHovI5tqEA9mvplDSw: checks 
*** FLOP *** [Kh Ks 3d]
Lh8SlCq3OSDKWLUgAI/Lxw: checks 
v8m8XHovI5tqEA9mvplDSw: checks 
*** TURN *** [Kh Ks 3d] [Tc]
Lh8SlCq3OSDKWLUgAI/Lxw: checks 
v8m8XHovI5tqEA9mvplDSw: checks 
*** RIVER *** [Kh Ks 3d Tc] [Qh]
Lh8SlCq3OSDKWLUgAI/Lxw: checks 
v8m8XHovI5tqEA9mvplDSw: checks 
*** SHOW DOWN ***
Lh8SlCq3OSDKWLUgAI/Lxw: shows [5d 7c] (a pair of Kings)
v8m8XHovI5tqEA9mvplDSw: shows [8d 9d] (a pair of Kings - Queen+Ten+Nine kicker)
v8m8XHovI5tqEA9mvplDSw collected $0.50 from pot
*** SUMMARY ***
Total pot $0.50 | Rake $0 
Board [Kh Ks 3d Tc Qh]
Seat 1: v8m8XHovI5tqEA9mvplDSw (big blind) showed [8d 9d] and won ($0.50) with a pair of Kings
Seat 2: 6DwBRH+xZ12AAZmeAg+aXw folded before Flop (didn't bet)
Seat 3: +ZlnqPoP3Hg4BIUxDfKd/A folded before Flop (didn't bet)
Seat 4: FpN4KbLjlyRRKiVaQcoLqA folded before Flop (didn't bet)
Seat 5: if4dh6jhJXeN3/qd3qCp9g (button) folded before Flop (didn't bet)
Seat 6: Lh8SlCq3OSDKWLUgAI/Lxw (small blind) showed [5d 7c] and lost with a pair of Kings




PokerStars Game #59941568494:  Hold'em No Limit ($0.10/$0.25) - 2009/07/01 1:39:24 ET
Table '29D3eoQzK5kOAT0OIDS2uQ' 6-max Seat #4 is the button
Seat 1: kG34n23qFQA3nzdOJTQ1dA ($46.50 in chips) 
Seat 2: FyE+TQ5JcCqI/tCCHf0jGA ($16.65 in chips) 
Seat 3: z3tQwy28dp5FykDJC/wzQw ($18.15 in chips) 
Seat 4: MqMK8OWPSY1V4stf1Hy5Jw ($32.30 in chips) 
Seat 5: Q3EMN7b0ie81AFWkDrhCjw ($21.30 in chips) 
Seat 6: bWbV4MVB/vVpiES1Ut4hew ($36.65 in chips) 
Q3EMN7b0ie81AFWkDrhCjw: posts small blind $0.10
bWbV4MVB/vVpiES1Ut4hew: posts big blind $0.25
*** HOLE CARDS ***
kG34n23qFQA3nzdOJTQ1dA: folds 
FyE+TQ5JcCqI/tCCHf0jGA: folds 
z3tQwy28dp5FykDJC/wzQw: folds 
MqMK8OWPSY1V4stf1Hy5Jw: folds 
Q3EMN7b0ie81AFWkDrhCjw: calls $0.15
bWbV4MVB/vVpiES1Ut4hew: raises $1 to $1.25
Q3EMN7b0ie81AFWkDrhCjw: calls $1
*** FLOP *** [Qd 5h Ks]
Q3EMN7b0ie81AFWkDrhCjw: checks 
bWbV4MVB/vVpiES1Ut4hew: bets $1.50
Q3EMN7b0ie81AFWkDrhCjw: folds 
Uncalled bet ($1.50) returned to bWbV4MVB/vVpiES1Ut4hew
bWbV4MVB/vVpiES1Ut4hew collected $2.40 from pot
*** SUMMARY ***
Total pot $2.50 | Rake $0.10 
Board [Qd 5h Ks]
Seat 1: kG34n23qFQA3nzdOJTQ1dA folded before Flop (didn't bet)
Seat 2: FyE+TQ5JcCqI/tCCHf0jGA folded before Flop (didn't bet)
Seat 3: z3tQwy28dp5FykDJC/wzQw folded before Flop (didn't bet)
Seat 4: MqMK8OWPSY1V4stf1Hy5Jw (button) folded before Flop (didn't bet)
Seat 5: Q3EMN7b0ie81AFWkDrhCjw (small blind) folded on the Flop
Seat 6: bWbV4MVB/vVpiES1Ut4hew (big blind) collected ($2.40)




PokerStars Game #59941568306:  Hold'em No Limit ($0.10/$0.25) - 2009/07/01 1:39:24 ET
Table 'NtEQAxCeIK2io1CGtW658g' 6-max Seat #1 is the button
Seat 1: X437kMQ7AujoaDgjguhU9w ($10.30 in chips) 
Seat 3: m2yWOKfAxqHoy5DDN87Ttw ($37.75 in chips) 
Seat 4: 8296 ($12.50 in chips) 
Seat 5: Hsvkc0/G2VV78oVmWYXecw ($5.70 in chips) 
Seat 6: /gJNBeCkWL4o85/jvlZ4BA ($64.15 in chips) 
m2yWOKfAxqHoy5DDN87Ttw: posts small blind $0.10
8296: posts big blind $0.25
*** HOLE CARDS ***
Hsvkc0/G2VV78oVmWYXecw: raises $0.50 to $0.75
/gJNBeCkWL4o85/jvlZ4BA: folds 
X437kMQ7AujoaDgjguhU9w: raises $0.50 to $1.25
m2yWOKfAxqHoy5DDN87Ttw: folds 
8296: folds 
Hsvkc0/G2VV78oVmWYXecw: calls $0.50
*** FLOP *** [5d 6s 4d]
Hsvkc0/G2VV78oVmWYXecw: checks 
X437kMQ7AujoaDgjguhU9w: bets $9.05 and is all-in
Hsvkc0/G2VV78oVmWYXecw: folds 
Uncalled bet ($9.05) returned to X437kMQ7AujoaDgjguhU9w
X437kMQ7AujoaDgjguhU9w collected $2.75 from pot
X437kMQ7AujoaDgjguhU9w: doesn't show hand 
*** SUMMARY ***
Total pot $2.85 | Rake $0.10 
Board [5d 6s 4d]
Seat 1: X437kMQ7AujoaDgjguhU9w (button) collected ($2.75)
Seat 3: m2yWOKfAxqHoy5DDN87Ttw (small blind) folded before Flop
Seat 4: 8296 (big blind) folded before Flop
Seat 5: Hsvkc0/G2VV78oVmWYXecw folded on the Flop
Seat 6: /gJNBeCkWL4o85/jvlZ4BA folded before Flop (didn't bet)




PokerStars Game #59941568418:  Hold'em No Limit ($0.10/$0.25) - 2009/07/01 1:39:24 ET
Table 'wixGE3Zge1qBdnpWijIl/w' 9-max Seat #9 is the button
Seat 1: 4GJMmHGKzu+gVtalqRy7dA ($18.40 in chips) 
Seat 2: DnDcAdn9P0zGovMERigpFA ($41.70 in chips) 
Seat 3: Bb42QRQMhg5/Y0vHP8/2Xw ($25 in chips) 
Seat 4: 4oA316mXLIui1QY63GXBUg ($33.05 in chips) 
Seat 5: H5Se03ZqSX7tbULXur2MAg ($24.45 in chips) 
Seat 6: AP/rNvbsacTb4XtaAgKPiQ ($21.30 in chips) 
Seat 7: qIaaweMCAGmy9HZFT4r/6A ($39.90 in chips) 
Seat 8: ShCS62CJp4MKfKLKvGKQbA ($15.40 in chips) 
Seat 9: r6hsffOo1iKmaPYKwAZmFw ($28.80 in chips) 
4GJMmHGKzu+gVtalqRy7dA: posts small blind $0.10
DnDcAdn9P0zGovMERigpFA: posts big blind $0.25
*** HOLE CARDS ***
Bb42QRQMhg5/Y0vHP8/2Xw: folds 
4oA316mXLIui1QY63GXBUg: folds 
H5Se03ZqSX7tbULXur2MAg: folds 
AP/rNvbsacTb4XtaAgKPiQ: calls $0.25
qIaaweMCAGmy9HZFT4r/6A: folds 
ShCS62CJp4MKfKLKvGKQbA: calls $0.25
r6hsffOo1iKmaPYKwAZmFw: folds 
4GJMmHGKzu+gVtalqRy7dA: calls $0.15
DnDcAdn9P0zGovMERigpFA: checks 
*** FLOP *** [4s Kd Kh]
4GJMmHGKzu+gVtalqRy7dA: checks 
DnDcAdn9P0zGovMERigpFA: checks 
AP/rNvbsacTb4XtaAgKPiQ: checks 
ShCS62CJp4MKfKLKvGKQbA: checks 
*** TURN *** [4s Kd Kh] [2c]
4GJMmHGKzu+gVtalqRy7dA: bets $0.25
DnDcAdn9P0zGovMERigpFA: folds 
AP/rNvbsacTb4XtaAgKPiQ: folds 
ShCS62CJp4MKfKLKvGKQbA: folds 
Uncalled bet ($0.25) returned to 4GJMmHGKzu+gVtalqRy7dA
4GJMmHGKzu+gVtalqRy7dA collected $0.95 from pot
4GJMmHGKzu+gVtalqRy7dA: doesn't show hand 
*** SUMMARY ***
Total pot $1 | Rake $0.05 
Board [4s Kd Kh 2c]
Seat 1: 4GJMmHGKzu+gVtalqRy7dA (small blind) collected ($0.95)
Seat 2: DnDcAdn9P0zGovMERigpFA (big blind) folded on the Turn
Seat 3: Bb42QRQMhg5/Y0vHP8/2Xw folded before Flop (didn't bet)
Seat 4: 4oA316mXLIui1QY63GXBUg folded before Flop (didn't bet)
Seat 5: H5Se03ZqSX7tbULXur2MAg folded before Flop (didn't bet)
Seat 6: AP/rNvbsacTb4XtaAgKPiQ folded on the Turn
Seat 7: qIaaweMCAGmy9HZFT4r/6A folded before Flop (didn't bet)
Seat 8: ShCS62CJp4MKfKLKvGKQbA folded on the Turn
Seat 9: r6hsffOo1iKmaPYKwAZmFw (button) folded before Flop (didn't bet)




PokerStars Game #59941569122:  Hold'em No Limit ($0.10/$0.25) - 2009/07/01 1:39:25 ET
Table 'mVdLgAdN9rGe6mMwSrDdGQ' 6-max Seat #1 is the button
Seat 1: Edjy4jVygh/0sKxmjJiCdw ($33.60 in chips) 
Seat 3: +baiVgI/ETnBARLe5mARCw ($11.70 in chips) 
Seat 4: scNSjC6yyKvvfklSkuzLrw ($18.70 in chips) 
Seat 5: +TMG/MBWpiEnc9t7i07eTA ($17.90 in chips) 
Seat 6: DihMHaz4WNETH1bPDe13kA ($47.55 in chips) 
crazyconflit will be allowed to play after the button
+baiVgI/ETnBARLe5mARCw: posts small blind $0.10
scNSjC6yyKvvfklSkuzLrw: posts big blind $0.25
*** HOLE CARDS ***
+TMG/MBWpiEnc9t7i07eTA: calls $0.25
DihMHaz4WNETH1bPDe13kA: folds 
Edjy4jVygh/0sKxmjJiCdw: folds 
+baiVgI/ETnBARLe5mARCw: folds 
scNSjC6yyKvvfklSkuzLrw: checks 
*** FLOP *** [6s 8c Td]
Edjy4jVygh/0sKxmjJiCdw leaves the table
scNSjC6yyKvvfklSkuzLrw: checks 
+TMG/MBWpiEnc9t7i07eTA: checks 
*** TURN *** [6s 8c Td] [Ad]
scNSjC6yyKvvfklSkuzLrw: checks 
+TMG/MBWpiEnc9t7i07eTA: bets $0.50
scNSjC6yyKvvfklSkuzLrw: folds 
Uncalled bet ($0.50) returned to +TMG/MBWpiEnc9t7i07eTA
+TMG/MBWpiEnc9t7i07eTA collected $0.60 from pot
+TMG/MBWpiEnc9t7i07eTA: doesn't show hand 
*** SUMMARY ***
Total pot $0.60 | Rake $0 
Board [6s 8c Td Ad]
Seat 1: Edjy4jVygh/0sKxmjJiCdw (button) folded before Flop (didn't bet)
Seat 3: +baiVgI/ETnBARLe5mARCw (small blind) folded before Flop
Seat 4: scNSjC6yyKvvfklSkuzLrw (big blind) folded on the Turn
Seat 5: +TMG/MBWpiEnc9t7i07eTA collected ($0.60)
Seat 6: DihMHaz4WNETH1bPDe13kA folded before Flop (didn't bet)




PokerStars Game #59941568936:  Hold'em No Limit ($0.10/$0.25) - 2009/07/01 1:39:25 ET
Table 'SHi8+hK6i7E2dJ/3Agbyig' 6-max Seat #6 is the button
Seat 1: gPEN9Zp33YTm/mu9/SYP1w ($30.80 in chips) 
Seat 2: LJI7A1YgDM7hgh7o56+ReQ ($29.15 in chips) 
Seat 3: P1Z7LWu+VU+WmJsI4mr0wA ($24.75 in chips) 
Seat 5: v8m8XHovI5tqEA9mvplDSw ($53.80 in chips) 
Seat 6: cWc85bEzdRzpUMhRKm8pwQ ($25 in chips) 
gPEN9Zp33YTm/mu9/SYP1w: posts small blind $0.10
LJI7A1YgDM7hgh7o56+ReQ: posts big blind $0.25
*** HOLE CARDS ***
u0ikXOhAPSCLmg+l17oGRw joins the table at seat #4 
P1Z7LWu+VU+WmJsI4mr0wA: folds 
v8m8XHovI5tqEA9mvplDSw: folds 
cWc85bEzdRzpUMhRKm8pwQ: raises $0.75 to $1
gPEN9Zp33YTm/mu9/SYP1w: folds 
LJI7A1YgDM7hgh7o56+ReQ: folds 
Uncalled bet ($0.75) returned to cWc85bEzdRzpUMhRKm8pwQ
cWc85bEzdRzpUMhRKm8pwQ collected $0.60 from pot
*** SUMMARY ***
Total pot $0.60 | Rake $0 
Seat 1: gPEN9Zp33YTm/mu9/SYP1w (small blind) folded before Flop
Seat 2: LJI7A1YgDM7hgh7o56+ReQ (big blind) folded before Flop
Seat 3: P1Z7LWu+VU+WmJsI4mr0wA folded before Flop (didn't bet)
Seat 5: v8m8XHovI5tqEA9mvplDSw folded before Flop (didn't bet)
Seat 6: cWc85bEzdRzpUMhRKm8pwQ (button) collected ($0.60)




PokerStars Game #59941568964:  Hold'em No Limit ($0.10/$0.25) - 2009/07/01 1:39:25 ET
Table 'L5GvbdQO5aCZJSE6pyQ8OA' 6-max Seat #6 is the button
Seat 1: eFj4lr1nuXLyCWNTShr1bg ($11.45 in chips) 
Seat 2: DihMHaz4WNETH1bPDe13kA ($29.40 in chips) 
Seat 3: JFIAqU8lCZ0vWwEl4bdGsg ($27 in chips) 
Seat 4: trN/oHqTTbPw5MNuKrOpLw ($28.65 in chips) 
Seat 5: LyDHtw3/yniNHW+DvLXbog ($26.30 in chips) 
Seat 6: v+QfkGiuj9bgtuNoVnDO8w ($39.75 in chips) 
eFj4lr1nuXLyCWNTShr1bg: posts small blind $0.10
DihMHaz4WNETH1bPDe13kA: posts big blind $0.25
*** HOLE CARDS ***
JFIAqU8lCZ0vWwEl4bdGsg: raises $0.60 to $0.85
trN/oHqTTbPw5MNuKrOpLw: folds 
trN/oHqTTbPw5MNuKrOpLw is sitting out
LyDHtw3/yniNHW+DvLXbog: folds 
v+QfkGiuj9bgtuNoVnDO8w: folds 
eFj4lr1nuXLyCWNTShr1bg: folds 
DihMHaz4WNETH1bPDe13kA: folds 
Uncalled bet ($0.60) returned to JFIAqU8lCZ0vWwEl4bdGsg
JFIAqU8lCZ0vWwEl4bdGsg collected $0.60 from pot
JFIAqU8lCZ0vWwEl4bdGsg: doesn't show hand 
*** SUMMARY ***
Total pot $0.60 | Rake $0 
Seat 1: eFj4lr1nuXLyCWNTShr1bg (small blind) folded before Flop
Seat 2: DihMHaz4WNETH1bPDe13kA (big blind) folded before Flop
Seat 3: JFIAqU8lCZ0vWwEl4bdGsg collected ($0.60)
Seat 4: trN/oHqTTbPw5MNuKrOpLw folded before Flop (didn't bet)
Seat 5: LyDHtw3/yniNHW+DvLXbog folded before Flop (didn't bet)
Seat 6: v+QfkGiuj9bgtuNoVnDO8w (button) folded before Flop (didn't bet)




PokerStars Game #59941569328:  Hold'em No Limit ($0.10/$0.25) - 2009/07/01 1:39:26 ET
Table 'sm5gqEvXgLbkkE4dryW/5g' 6-max Seat #4 is the button
Seat 1: v8m8XHovI5tqEA9mvplDSw ($38.60 in chips) 
Seat 2: 5xs5/u2z1CO9zkRvH72MQg ($17.05 in chips) 
Seat 3: UT5XpwOH1ipkOF7n1MqDJA ($26.50 in chips) 
Seat 4: cWc85bEzdRzpUMhRKm8pwQ ($25.25 in chips) 
Seat 6: aogAb4Eienxztk8p2v9VVw ($21.15 in chips) 
aogAb4Eienxztk8p2v9VVw: posts small blind $0.10
v8m8XHovI5tqEA9mvplDSw: posts big blind $0.25
*** HOLE CARDS ***
5xs5/u2z1CO9zkRvH72MQg: calls $0.25
UT5XpwOH1ipkOF7n1MqDJA said, "didnt know that i win"
UT5XpwOH1ipkOF7n1MqDJA: calls $0.25
cWc85bEzdRzpUMhRKm8pwQ: folds 
aogAb4Eienxztk8p2v9VVw is disconnected 
aogAb4Eienxztk8p2v9VVw has timed out while disconnected
aogAb4Eienxztk8p2v9VVw: folds 
aogAb4Eienxztk8p2v9VVw is sitting out
v8m8XHovI5tqEA9mvplDSw: checks 
*** FLOP *** [8d Ts Td]
v8m8XHovI5tqEA9mvplDSw: checks 
5xs5/u2z1CO9zkRvH72MQg: bets $1.25
UT5XpwOH1ipkOF7n1MqDJA: folds 
v8m8XHovI5tqEA9mvplDSw: folds 
Uncalled bet ($1.25) returned to 5xs5/u2z1CO9zkRvH72MQg
5xs5/u2z1CO9zkRvH72MQg collected $0.85 from pot
5xs5/u2z1CO9zkRvH72MQg: doesn't show hand 
*** SUMMARY ***
Total pot $0.85 | Rake $0 
Board [8d Ts Td]
Seat 1: v8m8XHovI5tqEA9mvplDSw (big blind) folded on the Flop
Seat 2: 5xs5/u2z1CO9zkRvH72MQg collected ($0.85)
Seat 3: UT5XpwOH1ipkOF7n1MqDJA folded on the Flop
Seat 4: cWc85bEzdRzpUMhRKm8pwQ (button) folded before Flop (didn't bet)
Seat 6: aogAb4Eienxztk8p2v9VVw (small blind) folded before Flop




PokerStars Game #59941569460:  Hold'em No Limit ($0.10/$0.25) - 2009/07/01 1:39:26 ET
Table 'WjNvuuSgTjm8jh0j9vcCgQ' 9-max Seat #3 is the button
Seat 1: q+Qdg0Hoir+SyL7haBrUnw ($8.05 in chips) 
Seat 2: ghNKXUBl/H+t83JF079ZBA ($23.40 in chips) 
Seat 3: pSKReiGBNW9NsF2jAZnlwg ($19.70 in chips) 
Seat 4: X78b5v/uhqeXXoAijbw/yg ($31.45 in chips) 
Seat 5: ziFpkH3wCzqB/qXeq/Hy7g ($25 in chips) 
Seat 6: ubsjZomMWSV0hAiBLa7K1A ($20.55 in chips) 
Seat 7: NSX8YOj+RznxoL+rO1YU4w ($14.50 in chips) 
Seat 8: hZuGwtYmFKPmQ+v1wlmdfA ($17.75 in chips) 
Seat 9: CT7Xj/V/O5rBlhtt+RZeFQ ($25.60 in chips) 
X78b5v/uhqeXXoAijbw/yg: posts small blind $0.10
ziFpkH3wCzqB/qXeq/Hy7g: posts big blind $0.25
*** HOLE CARDS ***
ubsjZomMWSV0hAiBLa7K1A: folds 
NSX8YOj+RznxoL+rO1YU4w: calls $0.25
hZuGwtYmFKPmQ+v1wlmdfA: folds 
CT7Xj/V/O5rBlhtt+RZeFQ: folds 
q+Qdg0Hoir+SyL7haBrUnw: folds 
ghNKXUBl/H+t83JF079ZBA: folds 
pSKReiGBNW9NsF2jAZnlwg: raises $1 to $1.25
X78b5v/uhqeXXoAijbw/yg: folds 
ziFpkH3wCzqB/qXeq/Hy7g: calls $1
NSX8YOj+RznxoL+rO1YU4w: calls $1
*** FLOP *** [9d 2c Kh]
ziFpkH3wCzqB/qXeq/Hy7g: checks 
NSX8YOj+RznxoL+rO1YU4w: checks 
pSKReiGBNW9NsF2jAZnlwg: bets $1.25
ziFpkH3wCzqB/qXeq/Hy7g: folds 
NSX8YOj+RznxoL+rO1YU4w: folds 
Uncalled bet ($1.25) returned to pSKReiGBNW9NsF2jAZnlwg
pSKReiGBNW9NsF2jAZnlwg collected $3.70 from pot
*** SUMMARY ***
Total pot $3.85 | Rake $0.15 
Board [9d 2c Kh]
Seat 1: q+Qdg0Hoir+SyL7haBrUnw folded before Flop (didn't bet)
Seat 2: ghNKXUBl/H+t83JF079ZBA folded before Flop (didn't bet)
Seat 3: pSKReiGBNW9NsF2jAZnlwg (button) collected ($3.70)
Seat 4: X78b5v/uhqeXXoAijbw/yg (small blind) folded before Flop
Seat 5: ziFpkH3wCzqB/qXeq/Hy7g (big blind) folded on the Flop
Seat 6: ubsjZomMWSV0hAiBLa7K1A folded before Flop (didn't bet)
Seat 7: NSX8YOj+RznxoL+rO1YU4w folded on the Flop
Seat 8: hZuGwtYmFKPmQ+v1wlmdfA folded before Flop (didn't bet)
Seat 9: CT7Xj/V/O5rBlhtt+RZeFQ folded before Flop (didn't bet)




PokerStars Game #59941569540:  Hold'em No Limit ($0.10/$0.25) - 2009/07/01 1:39:26 ET
Table 'gnrUwXkIPE0C8xl6cB4Hyw' 9-max Seat #1 is the button
Seat 1: EQXHDnIzAsORnIXRNtXRlA ($22.60 in chips) 
Seat 2: 7je+LC5Mfs6nL8YBVh4frQ ($5.10 in chips) 
Seat 3: PdIasPkzm2sqZnN41ZRXOg ($5 in chips) 
Seat 4: wGigCmBR/9XWkPpvYos3aQ ($25.35 in chips) 
Seat 5: gehe91e0IyVT0QU/XBkEyg ($27.50 in chips) 
Seat 6: dtZ84flFEi4Q+SGrHMJRDQ ($26.15 in chips) 
Seat 7: OXPkK84/qv92EMwXPiG5rQ ($9.75 in chips) 
Seat 8: 4awUyiDYTgylQKXZ9faBVA ($56.20 in chips) 
Seat 9: F7pnn6czNpHvRM55XcA2EA ($28.10 in chips) 
7je+LC5Mfs6nL8YBVh4frQ: posts small blind $0.10
PdIasPkzm2sqZnN41ZRXOg: posts big blind $0.25
*** HOLE CARDS ***
wGigCmBR/9XWkPpvYos3aQ: folds 
gehe91e0IyVT0QU/XBkEyg: folds 
dtZ84flFEi4Q+SGrHMJRDQ: folds 
OXPkK84/qv92EMwXPiG5rQ: folds 
4awUyiDYTgylQKXZ9faBVA: folds 
F7pnn6czNpHvRM55XcA2EA: folds 
EQXHDnIzAsORnIXRNtXRlA: folds 
7je+LC5Mfs6nL8YBVh4frQ: folds 
Uncalled bet ($0.15) returned to PdIasPkzm2sqZnN41ZRXOg
PdIasPkzm2sqZnN41ZRXOg collected $0.20 from pot
PdIasPkzm2sqZnN41ZRXOg: doesn't show hand 
*** SUMMARY ***
Total pot $0.20 | Rake $0 
Seat 1: EQXHDnIzAsORnIXRNtXRlA (button) folded before Flop (didn't bet)
Seat 2: 7je+LC5Mfs6nL8YBVh4frQ (small blind) folded before Flop
Seat 3: PdIasPkzm2sqZnN41ZRXOg (big blind) collected ($0.20)
Seat 4: wGigCmBR/9XWkPpvYos3aQ folded before Flop (didn't bet)
Seat 5: gehe91e0IyVT0QU/XBkEyg folded before Flop (didn't bet)
Seat 6: dtZ84flFEi4Q+SGrHMJRDQ folded before Flop (didn't bet)
Seat 7: OXPkK84/qv92EMwXPiG5rQ folded before Flop (didn't bet)
Seat 8: 4awUyiDYTgylQKXZ9faBVA folded before Flop (didn't bet)
Seat 9: F7pnn6czNpHvRM55XcA2EA folded before Flop (didn't bet)




PokerStars Game #59941570086:  Hold'em No Limit ($0.10/$0.25) - 2009/07/01 1:39:27 ET
Table 'sCop8wmj9zlSS2KJqk1QKQ' 9-max Seat #8 is the button
Seat 1: dtZ84flFEi4Q+SGrHMJRDQ ($29.80 in chips) 
Seat 2: YZaC69gFrepA6oCGtu7E0w ($22.95 in chips) 
Seat 3: OwQek9i+x54ZA6dn6e8qhg ($12.20 in chips) 
Seat 4: msUzkZl2RntUnTl6E8WaNA ($10.65 in chips) 
Seat 5: sD+TKtt36XiiN6jqHiLwDA ($24 in chips) 
Seat 6: hZuGwtYmFKPmQ+v1wlmdfA ($43.30 in chips) 
Seat 7: sx0lGrkT9fd4yFR+3cXUQg ($11.85 in chips) 
Seat 8: xnVwSkROfRtOw4eSoDANtw ($20.55 in chips) 
Seat 9: tLcDklc2rBORNfixyRfVfw ($25 in chips) 
tLcDklc2rBORNfixyRfVfw: posts small blind $0.10
dtZ84flFEi4Q+SGrHMJRDQ: posts big blind $0.25
*** HOLE CARDS ***
YZaC69gFrepA6oCGtu7E0w: calls $0.25
OwQek9i+x54ZA6dn6e8qhg: folds 
msUzkZl2RntUnTl6E8WaNA: folds 
sD+TKtt36XiiN6jqHiLwDA: calls $0.25
hZuGwtYmFKPmQ+v1wlmdfA: calls $0.25
sx0lGrkT9fd4yFR+3cXUQg: folds 
xnVwSkROfRtOw4eSoDANtw: calls $0.25
tLcDklc2rBORNfixyRfVfw: folds 
dtZ84flFEi4Q+SGrHMJRDQ: checks 
*** FLOP *** [Kh 4h 9c]
dtZ84flFEi4Q+SGrHMJRDQ: checks 
YZaC69gFrepA6oCGtu7E0w: checks 
sD+TKtt36XiiN6jqHiLwDA: bets $1
hZuGwtYmFKPmQ+v1wlmdfA: folds 
xnVwSkROfRtOw4eSoDANtw: folds 
dtZ84flFEi4Q+SGrHMJRDQ: folds 
YZaC69gFrepA6oCGtu7E0w: calls $1
*** TURN *** [Kh 4h 9c] [7c]
YZaC69gFrepA6oCGtu7E0w: checks 
sD+TKtt36XiiN6jqHiLwDA: bets $3
YZaC69gFrepA6oCGtu7E0w: raises $3 to $6
sD+TKtt36XiiN6jqHiLwDA: calls $3
*** RIVER *** [Kh 4h 9c 7c] [7d]
YZaC69gFrepA6oCGtu7E0w: bets $10
sD+TKtt36XiiN6jqHiLwDA: calls $10
*** SHOW DOWN ***
YZaC69gFrepA6oCGtu7E0w: shows [7s Ks] (a full house, Sevens full of Kings)
sD+TKtt36XiiN6jqHiLwDA: mucks hand 
YZaC69gFrepA6oCGtu7E0w collected $33.65 from pot
*** SUMMARY ***
Total pot $35.35 | Rake $1.70 
Board [Kh 4h 9c 7c 7d]
Seat 1: dtZ84flFEi4Q+SGrHMJRDQ (big blind) folded on the Flop
Seat 2: YZaC69gFrepA6oCGtu7E0w showed [7s Ks] and won ($33.65) with a full house, Sevens full of Kings
Seat 3: OwQek9i+x54ZA6dn6e8qhg folded before Flop (didn't bet)
Seat 4: msUzkZl2RntUnTl6E8WaNA folded before Flop (didn't bet)
Seat 5: sD+TKtt36XiiN6jqHiLwDA mucked
Seat 6: hZuGwtYmFKPmQ+v1wlmdfA folded on the Flop
Seat 7: sx0lGrkT9fd4yFR+3cXUQg folded before Flop (didn't bet)
Seat 8: xnVwSkROfRtOw4eSoDANtw (button) folded on the Flop
Seat 9: tLcDklc2rBORNfixyRfVfw (small blind) folded before Flop




PokerStars Game #59941570118:  Hold'em No Limit ($0.10/$0.25) - 2009/07/01 1:39:27 ET
Table '3lL16FBjWXTx3AjK5lMRww' 9-max Seat #5 is the button
Seat 1: fDGyaQz0cs2s4FOYxkbIHA ($16.55 in chips) 
Seat 2: c/9X4zftzphFxYtxp5kp9w ($19.90 in chips) 
Seat 3: QEbIGci+itdw+re8RM5fZA ($27.95 in chips) 
Seat 4: Z3a37Ry74FVl+CBZtAONiA ($6.55 in chips) 
Seat 5: M/9j4wkHH9i1JM51vgi1VA ($36.70 in chips) 
Seat 6: zUXhymECc2C9W9ZNw6qppA ($9.75 in chips) 
Seat 7: 6RiVTYll/5D8zICp0MRpKw ($26.05 in chips) 
Seat 8: ljemhp25Zg+nlA9DLCIiUw ($24.25 in chips) 
Seat 9: 00Ybni1cxfHtqmdWwh31Xg ($10.35 in chips) 
zUXhymECc2C9W9ZNw6qppA: posts small blind $0.10
6RiVTYll/5D8zICp0MRpKw: posts big blind $0.25
*** HOLE CARDS ***
ljemhp25Zg+nlA9DLCIiUw: calls $0.25
00Ybni1cxfHtqmdWwh31Xg: folds 
fDGyaQz0cs2s4FOYxkbIHA: folds 
c/9X4zftzphFxYtxp5kp9w: folds 
QEbIGci+itdw+re8RM5fZA: folds 
Z3a37Ry74FVl+CBZtAONiA: folds 
M/9j4wkHH9i1JM51vgi1VA: calls $0.25
zUXhymECc2C9W9ZNw6qppA: folds 
6RiVTYll/5D8zICp0MRpKw: checks 
*** FLOP *** [2d 2c Ah]
6RiVTYll/5D8zICp0MRpKw: checks 
ljemhp25Zg+nlA9DLCIiUw: checks 
M/9j4wkHH9i1JM51vgi1VA: checks 
*** TURN *** [2d 2c Ah] [Td]
6RiVTYll/5D8zICp0MRpKw: checks 
ljemhp25Zg+nlA9DLCIiUw: checks 
M/9j4wkHH9i1JM51vgi1VA: checks 
*** RIVER *** [2d 2c Ah Td] [7h]
6RiVTYll/5D8zICp0MRpKw: checks 
ljemhp25Zg+nlA9DLCIiUw: checks 
M/9j4wkHH9i1JM51vgi1VA: checks 
*** SHOW DOWN ***
6RiVTYll/5D8zICp0MRpKw: shows [3h 9s] (a pair of Deuces)
ljemhp25Zg+nlA9DLCIiUw: shows [5d 5h] (two pair, Fives and Deuces)
M/9j4wkHH9i1JM51vgi1VA: shows [Ts Jc] (two pair, Tens and Deuces)
M/9j4wkHH9i1JM51vgi1VA collected $0.85 from pot
*** SUMMARY ***
Total pot $0.85 | Rake $0 
Board [2d 2c Ah Td 7h]
Seat 1: fDGyaQz0cs2s4FOYxkbIHA folded before Flop (didn't bet)
Seat 2: c/9X4zftzphFxYtxp5kp9w folded before Flop (didn't bet)
Seat 3: QEbIGci+itdw+re8RM5fZA folded before Flop (didn't bet)
Seat 4: Z3a37Ry74FVl+CBZtAONiA folded before Flop (didn't bet)
Seat 5: M/9j4wkHH9i1JM51vgi1VA (button) showed [Ts Jc] and won ($0.85) with two pair, Tens and Deuces
Seat 6: zUXhymECc2C9W9ZNw6qppA (small blind) folded before Flop
Seat 7: 6RiVTYll/5D8zICp0MRpKw (big blind) showed [3h 9s] and lost with a pair of Deuces
Seat 8: ljemhp25Zg+nlA9DLCIiUw showed [5d 5h] and lost with two pair, Fives and Deuces
Seat 9: 00Ybni1cxfHtqmdWwh31Xg folded before Flop (didn't bet)




PokerStars Game #59941569994:  Hold'em No Limit ($0.10/$0.25) - 2009/07/01 1:39:27 ET
Table 'T/iCKJXGphRN3xcdwfE/JQ' 6-max Seat #5 is the button
Seat 1: wAKC8C/zN0c8V5v13dm9mA ($25 in chips) 
Seat 2: EeUZtMU058v2ObUACOF4Og ($34.10 in chips) 
Seat 3: IWAjoCPXtc1XUaZdp+pCpA ($22.35 in chips) 
Seat 4: tSR4329m40dZsN7YOpI9Kw ($53.50 in chips) 
Seat 5: gaPMxLGp9SOj4Lq6t+/0Ig ($4.20 in chips) 
Seat 6: Ey4Kn6PlnYb2srYYBJHvzg ($15.60 in chips) 
Ey4Kn6PlnYb2srYYBJHvzg: posts small blind $0.10
wAKC8C/zN0c8V5v13dm9mA: posts big blind $0.25
*** HOLE CARDS ***
EeUZtMU058v2ObUACOF4Og: folds 
IWAjoCPXtc1XUaZdp+pCpA: folds 
tSR4329m40dZsN7YOpI9Kw: folds 
gaPMxLGp9SOj4Lq6t+/0Ig: folds 
Ey4Kn6PlnYb2srYYBJHvzg: calls $0.15
wAKC8C/zN0c8V5v13dm9mA: checks 
*** FLOP *** [7s Qs 6d]
Ey4Kn6PlnYb2srYYBJHvzg: checks 
wAKC8C/zN0c8V5v13dm9mA: checks 
*** TURN *** [7s Qs 6d] [5d]
Ey4Kn6PlnYb2srYYBJHvzg: bets $0.50
wAKC8C/zN0c8V5v13dm9mA: folds 
Uncalled bet ($0.50) returned to Ey4Kn6PlnYb2srYYBJHvzg
Ey4Kn6PlnYb2srYYBJHvzg collected $0.50 from pot
Ey4Kn6PlnYb2srYYBJHvzg: doesn't show hand 
*** SUMMARY ***
Total pot $0.50 | Rake $0 
Board [7s Qs 6d 5d]
Seat 1: wAKC8C/zN0c8V5v13dm9mA (big blind) folded on the Turn
Seat 2: EeUZtMU058v2ObUACOF4Og folded before Flop (didn't bet)
Seat 3: IWAjoCPXtc1XUaZdp+pCpA folded before Flop (didn't bet)
Seat 4: tSR4329m40dZsN7YOpI9Kw folded before Flop (didn't bet)
Seat 5: gaPMxLGp9SOj4Lq6t+/0Ig (button) folded before Flop (didn't bet)
Seat 6: Ey4Kn6PlnYb2srYYBJHvzg (small blind) collected ($0.50)




PokerStars Game #59941569758:  Hold'em No Limit ($0.10/$0.25) - 2009/07/01 1:39:27 ET
Table 'HzFR0rxmDAPu5GzYR0AlYg' 6-max Seat #4 is the button
Seat 1: v+QfkGiuj9bgtuNoVnDO8w ($29.60 in chips) 
Seat 2: UA5OsKS3VPaxa7uC8La/kA ($53 in chips) 
Seat 3: kG34n23qFQA3nzdOJTQ1dA ($24.65 in chips) 
Seat 4: 8tR2s7yV/Fr0ePp1w5XnJw ($10 in chips) 
Seat 5: lquriepNQBhDV5P1SWHhnA ($26.35 in chips) 
Seat 6: jp34e617tIzV8tKIWmfAbA ($38.85 in chips) 
lquriepNQBhDV5P1SWHhnA: posts small blind $0.10
jp34e617tIzV8tKIWmfAbA: posts big blind $0.25
*** HOLE CARDS ***
v+QfkGiuj9bgtuNoVnDO8w: folds 
UA5OsKS3VPaxa7uC8La/kA: raises $0.75 to $1
kG34n23qFQA3nzdOJTQ1dA: folds 
8tR2s7yV/Fr0ePp1w5XnJw: folds 
lquriepNQBhDV5P1SWHhnA: folds 
jp34e617tIzV8tKIWmfAbA: folds 
Uncalled bet ($0.75) returned to UA5OsKS3VPaxa7uC8La/kA
UA5OsKS3VPaxa7uC8La/kA collected $0.60 from pot
*** SUMMARY ***
Total pot $0.60 | Rake $0 
Seat 1: v+QfkGiuj9bgtuNoVnDO8w folded before Flop (didn't bet)
Seat 2: UA5OsKS3VPaxa7uC8La/kA collected ($0.60)
Seat 3: kG34n23qFQA3nzdOJTQ1dA folded before Flop (didn't bet)
Seat 4: 8tR2s7yV/Fr0ePp1w5XnJw (button) folded before Flop (didn't bet)
Seat 5: lquriepNQBhDV5P1SWHhnA (small blind) folded before Flop
Seat 6: jp34e617tIzV8tKIWmfAbA (big blind) folded before Flop




PokerStars Game #59941570126:  Hold'em No Limit ($0.10/$0.25) - 2009/07/01 1:39:27 ET
Table 'Mef6A0EMopL6WaFO5/KO9g' 6-max Seat #6 is the button
Seat 1: GbCVUNssQ7mqsPWr7J4d3w ($4.75 in chips) 
Seat 2: 8ClCHtFXGNplITm+63KB+Q ($32.65 in chips) 
Seat 3: Wq26opBLDGJe91GRJn2epg ($11.35 in chips) 
Seat 4: lquriepNQBhDV5P1SWHhnA ($25.45 in chips) 
Seat 5: DihMHaz4WNETH1bPDe13kA ($25 in chips) 
Seat 6: jp34e617tIzV8tKIWmfAbA ($33.65 in chips) 
GbCVUNssQ7mqsPWr7J4d3w: posts small blind $0.10
8ClCHtFXGNplITm+63KB+Q: posts big blind $0.25
*** HOLE CARDS ***
Wq26opBLDGJe91GRJn2epg: folds 
lquriepNQBhDV5P1SWHhnA: folds 
DihMHaz4WNETH1bPDe13kA: folds 
jp34e617tIzV8tKIWmfAbA: folds 
GbCVUNssQ7mqsPWr7J4d3w: folds 
Uncalled bet ($0.15) returned to 8ClCHtFXGNplITm+63KB+Q
8ClCHtFXGNplITm+63KB+Q collected $0.20 from pot
8ClCHtFXGNplITm+63KB+Q: doesn't show hand 
*** SUMMARY ***
Total pot $0.20 | Rake $0 
Seat 1: GbCVUNssQ7mqsPWr7J4d3w (small blind) folded before Flop
Seat 2: 8ClCHtFXGNplITm+63KB+Q (big blind) collected ($0.20)
Seat 3: Wq26opBLDGJe91GRJn2epg folded before Flop (didn't bet)
Seat 4: lquriepNQBhDV5P1SWHhnA folded before Flop (didn't bet)
Seat 5: DihMHaz4WNETH1bPDe13kA folded before Flop (didn't bet)
Seat 6: jp34e617tIzV8tKIWmfAbA (button) folded before Flop (didn't bet)




PokerStars Game #59941569666:  Hold'em No Limit ($0.10/$0.25) - 2009/07/01 1:39:27 ET
Table 'zhqgUUprOJ14VxKxPHcT/Q' 9-max Seat #5 is the button
Seat 1: 22dIObOuor/A+IKWkNoAlA ($5 in chips) 
Seat 2: GY095KWhBevJ1Ttvl8WseA ($7.75 in chips) 
Seat 4: wGigCmBR/9XWkPpvYos3aQ ($33.45 in chips) 
Seat 5: +sbyWwIcFp9kP0bDtMegfQ ($33.60 in chips) 
Seat 7: sGFnnRCa1YAHAUmWgsW6Qg ($11.10 in chips) 
Seat 8: EQXHDnIzAsORnIXRNtXRlA ($24.70 in chips) 
Seat 9: 4awUyiDYTgylQKXZ9faBVA ($32.95 in chips) 
PdIasPkzm2sqZnN41ZRXOg will be allowed to play after the button
sGFnnRCa1YAHAUmWgsW6Qg: posts small blind $0.10
EQXHDnIzAsORnIXRNtXRlA: posts big blind $0.25
*** HOLE CARDS ***
4awUyiDYTgylQKXZ9faBVA: folds 
22dIObOuor/A+IKWkNoAlA: folds 
GY095KWhBevJ1Ttvl8WseA: calls $0.25
wGigCmBR/9XWkPpvYos3aQ: folds 
+sbyWwIcFp9kP0bDtMegfQ: folds 
sGFnnRCa1YAHAUmWgsW6Qg: folds 
EQXHDnIzAsORnIXRNtXRlA: checks 
*** FLOP *** [6h 5c Th]
EQXHDnIzAsORnIXRNtXRlA: checks 
GY095KWhBevJ1Ttvl8WseA: bets $0.75
EQXHDnIzAsORnIXRNtXRlA: folds 
Uncalled bet ($0.75) returned to GY095KWhBevJ1Ttvl8WseA
GY095KWhBevJ1Ttvl8WseA collected $0.60 from pot
GY095KWhBevJ1Ttvl8WseA: doesn't show hand 
*** SUMMARY ***
Total pot $0.60 | Rake $0 
Board [6h 5c Th]
Seat 1: 22dIObOuor/A+IKWkNoAlA folded before Flop (didn't bet)
Seat 2: GY095KWhBevJ1Ttvl8WseA collected ($0.60)
Seat 4: wGigCmBR/9XWkPpvYos3aQ folded before Flop (didn't bet)
Seat 5: +sbyWwIcFp9kP0bDtMegfQ (button) folded before Flop (didn't bet)
Seat 7: sGFnnRCa1YAHAUmWgsW6Qg (small blind) folded before Flop
Seat 8: EQXHDnIzAsORnIXRNtXRlA (big blind) folded on the Flop
Seat 9: 4awUyiDYTgylQKXZ9faBVA folded before Flop (didn't bet)




PokerStars Game #59941570466:  Hold'em No Limit ($0.10/$0.25) - 2009/07/01 1:39:28 ET
Table 'UVjmXTtsmlX1HxwwZ59akg' 9-max Seat #6 is the button
Seat 1: zDrucyjVn5aeekNEc3cJrA ($47.85 in chips) 
Seat 4: X78b5v/uhqeXXoAijbw/yg ($25 in chips) 
Seat 5: Bb42QRQMhg5/Y0vHP8/2Xw ($39.60 in chips) 
Seat 6: st9jtdNbm1W5GfBwRaCVqQ ($24.30 in chips) 
Seat 7: pB8IyCfDFZaVpov3NHEVJg ($25 in chips) 
Seat 8: aqxuKnMZWHy08QjWq1+MrQ ($2.40 in chips) 
Seat 9: RHUxTtZkMrryUUwjBqyF4Q ($33.15 in chips) 
pB8IyCfDFZaVpov3NHEVJg: posts small blind $0.10
aqxuKnMZWHy08QjWq1+MrQ: posts big blind $0.25
GmzfAfxcxu1kGbPC+9LkVg: sits out 
*** HOLE CARDS ***
q+Qdg0Hoir+SyL7haBrUnw joins the table at seat #2 
RHUxTtZkMrryUUwjBqyF4Q is disconnected 
RHUxTtZkMrryUUwjBqyF4Q has timed out while disconnected
RHUxTtZkMrryUUwjBqyF4Q: folds 
RHUxTtZkMrryUUwjBqyF4Q is sitting out
zDrucyjVn5aeekNEc3cJrA: folds 
X78b5v/uhqeXXoAijbw/yg: folds 
Bb42QRQMhg5/Y0vHP8/2Xw: folds 
st9jtdNbm1W5GfBwRaCVqQ: folds 
pB8IyCfDFZaVpov3NHEVJg: folds 
Uncalled bet ($0.15) returned to aqxuKnMZWHy08QjWq1+MrQ
RHUxTtZkMrryUUwjBqyF4Q is connected 
aqxuKnMZWHy08QjWq1+MrQ collected $0.20 from pot
RHUxTtZkMrryUUwjBqyF4Q has returned
*** SUMMARY ***
Total pot $0.20 | Rake $0 
Seat 1: zDrucyjVn5aeekNEc3cJrA folded before Flop (didn't bet)
Seat 4: X78b5v/uhqeXXoAijbw/yg folded before Flop (didn't bet)
Seat 5: Bb42QRQMhg5/Y0vHP8/2Xw folded before Flop (didn't bet)
Seat 6: st9jtdNbm1W5GfBwRaCVqQ (button) folded before Flop (didn't bet)
Seat 7: pB8IyCfDFZaVpov3NHEVJg (small blind) folded before Flop
Seat 8: aqxuKnMZWHy08QjWq1+MrQ (big blind) collected ($0.20)
Seat 9: RHUxTtZkMrryUUwjBqyF4Q folded before Flop (didn't bet)




PokerStars Game #59941570734:  Hold'em No Limit ($0.10/$0.25) - 2009/07/01 1:39:28 ET
Table 'QegsWX65l3n/K0A8XB78yg' 6-max Seat #3 is the button
Seat 1: p6adJRMXMBLr+xtQzqazIQ ($15.20 in chips) 
Seat 2: GC/9yVD59DUCX7hUI7gcLw ($47.55 in chips) 
Seat 3: 1lxYIAoJdZwAbzIkzWmSkw ($2.75 in chips) 
Seat 4: mFv3iBCtrw9XfCDRB0d46Q ($4.40 in chips) 
Seat 5: OMGl+YMGogf2JWIRfT2/Yg ($13 in chips) 
Seat 6: 5PWs02z65jSO5pr/M6wx/w ($5.10 in chips) 
mFv3iBCtrw9XfCDRB0d46Q: posts small blind $0.10
OMGl+YMGogf2JWIRfT2/Yg: posts big blind $0.25
*** HOLE CARDS ***
5PWs02z65jSO5pr/M6wx/w: calls $0.25
p6adJRMXMBLr+xtQzqazIQ: folds 
GC/9yVD59DUCX7hUI7gcLw: raises $1 to $1.25
1lxYIAoJdZwAbzIkzWmSkw: folds 
mFv3iBCtrw9XfCDRB0d46Q: folds 
OMGl+YMGogf2JWIRfT2/Yg: folds 
5PWs02z65jSO5pr/M6wx/w: folds 
Uncalled bet ($1) returned to GC/9yVD59DUCX7hUI7gcLw
GC/9yVD59DUCX7hUI7gcLw collected $0.85 from pot
*** SUMMARY ***
Total pot $0.85 | Rake $0 
Seat 1: p6adJRMXMBLr+xtQzqazIQ folded before Flop (didn't bet)
Seat 2: GC/9yVD59DUCX7hUI7gcLw collected ($0.85)
Seat 3: 1lxYIAoJdZwAbzIkzWmSkw (button) folded before Flop (didn't bet)
Seat 4: mFv3iBCtrw9XfCDRB0d46Q (small blind) folded before Flop
Seat 5: OMGl+YMGogf2JWIRfT2/Yg (big blind) folded before Flop
Seat 6: 5PWs02z65jSO5pr/M6wx/w folded before Flop




PokerStars Game #59941570234:  Hold'em No Limit ($0.10/$0.25) - 2009/07/01 1:39:28 ET
Table 'Ok3oDLIsTc2+KxPcI0bAOA' 6-max Seat #4 is the button
Seat 1: agQm3ugZ3qSVYNgNu1ddeA ($42.10 in chips) 
Seat 2: DE9hRlt14g+JdsRQ4wT7hg ($41.80 in chips) 
Seat 3: lquriepNQBhDV5P1SWHhnA ($25.25 in chips) 
Seat 4: LJI7A1YgDM7hgh7o56+ReQ ($38.50 in chips) 
Seat 5: DFi/Lzkjsfv8QswS80JX9Q ($28.35 in chips) 
Seat 6: Hsvkc0/G2VV78oVmWYXecw ($5.30 in chips) 
DFi/Lzkjsfv8QswS80JX9Q: posts small blind $0.10
Hsvkc0/G2VV78oVmWYXecw: posts big blind $0.25
*** HOLE CARDS ***
agQm3ugZ3qSVYNgNu1ddeA: folds 
DE9hRlt14g+JdsRQ4wT7hg: raises $0.75 to $1
lquriepNQBhDV5P1SWHhnA: raises $2.50 to $3.50
LJI7A1YgDM7hgh7o56+ReQ: folds 
DFi/Lzkjsfv8QswS80JX9Q: folds 
Hsvkc0/G2VV78oVmWYXecw: folds 
DE9hRlt14g+JdsRQ4wT7hg: folds 
Uncalled bet ($2.50) returned to lquriepNQBhDV5P1SWHhnA
lquriepNQBhDV5P1SWHhnA collected $2.35 from pot
lquriepNQBhDV5P1SWHhnA: doesn't show hand 
*** SUMMARY ***
Total pot $2.35 | Rake $0 
Seat 1: agQm3ugZ3qSVYNgNu1ddeA folded before Flop (didn't bet)
Seat 2: DE9hRlt14g+JdsRQ4wT7hg folded before Flop
Seat 3: lquriepNQBhDV5P1SWHhnA collected ($2.35)
Seat 4: LJI7A1YgDM7hgh7o56+ReQ (button) folded before Flop (didn't bet)
Seat 5: DFi/Lzkjsfv8QswS80JX9Q (small blind) folded before Flop
Seat 6: Hsvkc0/G2VV78oVmWYXecw (big blind) folded before Flop




PokerStars Game #59941570698:  Hold'em No Limit ($0.10/$0.25) - 2009/07/01 1:39:28 ET
Table 'fRxOyfaHXkWUDLv4eSxFew' 9-max Seat #1 is the button
Seat 1: 6RiVTYll/5D8zICp0MRpKw ($30.05 in chips) 
Seat 2: M2QO2DxB5Wawg2h8HSpnYA ($10 in chips) 
Seat 3: j4q3p0lesp63b1gZDwLBZw ($5 in chips) 
Seat 4: MtVtHDqIJTyUcXkRBBDIVA ($25.50 in chips) 
Seat 5: dmYlc+1cjwZMJ7wV+Z0rRg ($23.10 in chips) 
Seat 6: arxNSjreDRGFg13EAM2F1w ($27.40 in chips) 
Seat 7: 1/DuWziR8CXhWB71aPQd9Q ($18.40 in chips) 
Seat 8: 5n7e7I+px7c6CQmLpPbtsg ($4.65 in chips) 
Seat 9: H5Se03ZqSX7tbULXur2MAg ($33 in chips) 
M2QO2DxB5Wawg2h8HSpnYA: posts small blind $0.10
j4q3p0lesp63b1gZDwLBZw: posts big blind $0.25
*** HOLE CARDS ***
MtVtHDqIJTyUcXkRBBDIVA: folds 
dmYlc+1cjwZMJ7wV+Z0rRg: folds 
arxNSjreDRGFg13EAM2F1w: folds 
1/DuWziR8CXhWB71aPQd9Q: folds 
5n7e7I+px7c6CQmLpPbtsg: folds 
H5Se03ZqSX7tbULXur2MAg: folds 
6RiVTYll/5D8zICp0MRpKw: raises $0.50 to $0.75
M2QO2DxB5Wawg2h8HSpnYA: folds 
j4q3p0lesp63b1gZDwLBZw: folds 
Uncalled bet ($0.50) returned to 6RiVTYll/5D8zICp0MRpKw
6RiVTYll/5D8zICp0MRpKw collected $0.60 from pot
*** SUMMARY ***
Total pot $0.60 | Rake $0 
Seat 1: 6RiVTYll/5D8zICp0MRpKw (button) collected ($0.60)
Seat 2: M2QO2DxB5Wawg2h8HSpnYA (small blind) folded before Flop
Seat 3: j4q3p0lesp63b1gZDwLBZw (big blind) folded before Flop
Seat 4: MtVtHDqIJTyUcXkRBBDIVA folded before Flop (didn't bet)
Seat 5: dmYlc+1cjwZMJ7wV+Z0rRg folded before Flop (didn't bet)
Seat 6: arxNSjreDRGFg13EAM2F1w folded before Flop (didn't bet)
Seat 7: 1/DuWziR8CXhWB71aPQd9Q folded before Flop (didn't bet)
Seat 8: 5n7e7I+px7c6CQmLpPbtsg folded before Flop (didn't bet)
Seat 9: H5Se03ZqSX7tbULXur2MAg folded before Flop (didn't bet)




PokerStars Game #59941570232:  Hold'em No Limit ($0.10/$0.25) - 2009/07/01 1:39:28 ET
Table 'Utmw+yX+E/wdhNDIim90lQ' 9-max Seat #8 is the button
Seat 1: cZ99hugmLBj9KhTlc8nCSw ($32.05 in chips) 
Seat 2: iGMlK+EhUflPB6jKQd95Cg ($25 in chips) 
Seat 3: dfNim92Z6XK1/h5SFW5vDg ($25.30 in chips) 
Seat 4: ifYGvZDHQQ0aam4awTtHwA ($29.10 in chips) 
Seat 5: ghNKXUBl/H+t83JF079ZBA ($25 in chips) 
Seat 6: OlPJsgR4xypSg/w1z7Gyvw ($22.15 in chips) 
Seat 7: CImUHesK+ZER4v/VCA9IUg ($57.60 in chips) 
Seat 8: Mh2r9hTeTEDnh19sRZtW3g ($4.65 in chips) 
Seat 9: Th3FldXKQW6hWVVPahaoOQ ($25 in chips) 
Th3FldXKQW6hWVVPahaoOQ: posts small blind $0.10
cZ99hugmLBj9KhTlc8nCSw: posts big blind $0.25
*** HOLE CARDS ***
iGMlK+EhUflPB6jKQd95Cg: raises $0.50 to $0.75
dfNim92Z6XK1/h5SFW5vDg: folds 
ifYGvZDHQQ0aam4awTtHwA: raises $1 to $1.75
ghNKXUBl/H+t83JF079ZBA: folds 
OlPJsgR4xypSg/w1z7Gyvw: folds 
CImUHesK+ZER4v/VCA9IUg: folds 
Mh2r9hTeTEDnh19sRZtW3g: folds 
Th3FldXKQW6hWVVPahaoOQ: calls $1.65
cZ99hugmLBj9KhTlc8nCSw: folds 
iGMlK+EhUflPB6jKQd95Cg: calls $1
*** FLOP *** [5d Jd Jc]
Th3FldXKQW6hWVVPahaoOQ: bets $23.25 and is all-in
iGMlK+EhUflPB6jKQd95Cg: folds 
ifYGvZDHQQ0aam4awTtHwA: folds 
Uncalled bet ($23.25) returned to Th3FldXKQW6hWVVPahaoOQ
Th3FldXKQW6hWVVPahaoOQ collected $5.25 from pot
Th3FldXKQW6hWVVPahaoOQ: doesn't show hand 
*** SUMMARY ***
Total pot $5.50 | Rake $0.25 
Board [5d Jd Jc]
Seat 1: cZ99hugmLBj9KhTlc8nCSw (big blind) folded before Flop
Seat 2: iGMlK+EhUflPB6jKQd95Cg folded on the Flop
Seat 3: dfNim92Z6XK1/h5SFW5vDg folded before Flop (didn't bet)
Seat 4: ifYGvZDHQQ0aam4awTtHwA folded on the Flop
Seat 5: ghNKXUBl/H+t83JF079ZBA folded before Flop (didn't bet)
Seat 6: OlPJsgR4xypSg/w1z7Gyvw folded before Flop (didn't bet)
Seat 7: CImUHesK+ZER4v/VCA9IUg folded before Flop (didn't bet)
Seat 8: Mh2r9hTeTEDnh19sRZtW3g (button) folded before Flop (didn't bet)
Seat 9: Th3FldXKQW6hWVVPahaoOQ (small blind) collected ($5.25)




PokerStars Game #59941570402:  Hold'em No Limit ($0.10/$0.25) - 2009/07/01 1:39:28 ET
Table 'mdub7rJf3Z5tCT9s/+1+Wg' 9-max Seat #1 is the button
Seat 1: cZ99hugmLBj9KhTlc8nCSw ($25.75 in chips) 
Seat 2: 539MC3AwKLWVFwzABc644Q ($9.70 in chips) 
Seat 3: PdIasPkzm2sqZnN41ZRXOg ($5 in chips) 
Seat 4: fDGyaQz0cs2s4FOYxkbIHA ($15.20 in chips) 
Seat 5: dfNim92Z6XK1/h5SFW5vDg ($25.60 in chips) 
Seat 6: T/CCwAWe2yhO0c4oHNwicw ($22.45 in chips) 
Seat 7: woe+9KKk+L3pZgMTuHcmog ($19.60 in chips) 
Seat 8: Z9AeOQX3yzuSvKAm/xyovg ($6.75 in chips) 
Seat 9: tYsOBqdU1+x+yFI7zHO7hQ ($36.80 in chips) 
539MC3AwKLWVFwzABc644Q: posts small blind $0.10
PdIasPkzm2sqZnN41ZRXOg: posts big blind $0.25
*** HOLE CARDS ***
fDGyaQz0cs2s4FOYxkbIHA: folds 
dfNim92Z6XK1/h5SFW5vDg: folds 
T/CCwAWe2yhO0c4oHNwicw: folds 
woe+9KKk+L3pZgMTuHcmog: raises $1 to $1.25
Z9AeOQX3yzuSvKAm/xyovg: folds 
tYsOBqdU1+x+yFI7zHO7hQ: folds 
cZ99hugmLBj9KhTlc8nCSw: calls $1.25
539MC3AwKLWVFwzABc644Q: folds 
PdIasPkzm2sqZnN41ZRXOg: folds 
*** FLOP *** [7c 5s 4s]
woe+9KKk+L3pZgMTuHcmog: checks 
cZ99hugmLBj9KhTlc8nCSw: bets $2.25
woe+9KKk+L3pZgMTuHcmog: calls $2.25
*** TURN *** [7c 5s 4s] [5h]
woe+9KKk+L3pZgMTuHcmog: checks 
cZ99hugmLBj9KhTlc8nCSw: checks 
*** RIVER *** [7c 5s 4s 5h] [Jc]
woe+9KKk+L3pZgMTuHcmog: checks 
cZ99hugmLBj9KhTlc8nCSw: checks 
*** SHOW DOWN ***
woe+9KKk+L3pZgMTuHcmog: shows [6h Ah] (a pair of Fives)
cZ99hugmLBj9KhTlc8nCSw: shows [2h 2s] (two pair, Fives and Deuces)
cZ99hugmLBj9KhTlc8nCSw collected $7 from pot
*** SUMMARY ***
Total pot $7.35 | Rake $0.35 
Board [7c 5s 4s 5h Jc]
Seat 1: cZ99hugmLBj9KhTlc8nCSw (button) showed [2h 2s] and won ($7) with two pair, Fives and Deuces
Seat 2: 539MC3AwKLWVFwzABc644Q (small blind) folded before Flop
Seat 3: PdIasPkzm2sqZnN41ZRXOg (big blind) folded before Flop
Seat 4: fDGyaQz0cs2s4FOYxkbIHA folded before Flop (didn't bet)
Seat 5: dfNim92Z6XK1/h5SFW5vDg folded before Flop (didn't bet)
Seat 6: T/CCwAWe2yhO0c4oHNwicw folded before Flop (didn't bet)
Seat 7: woe+9KKk+L3pZgMTuHcmog showed [6h Ah] and lost with a pair of Fives
Seat 8: Z9AeOQX3yzuSvKAm/xyovg folded before Flop (didn't bet)
Seat 9: tYsOBqdU1+x+yFI7zHO7hQ folded before Flop (didn't bet)




PokerStars Game #59941570516:  Hold'em No Limit ($0.10/$0.25) - 2009/07/01 1:39:28 ET
Table '6aL2C8IFwHHr6SG6RgXaow' 9-max Seat #2 is the button
Seat 1: AKrlhR3s97+cfTtZj3tKjw ($3.65 in chips) 
Seat 2: UmzixCpC0bAc1lDEjgB3NQ ($14.70 in chips) 
Seat 3: aCVg6cCxQcqClhB9nq/p1w ($12.45 in chips) 
Seat 4: BT6Oal0iO4P6kDuT7HFQDw ($17.15 in chips) 
Seat 5: wre31HfyzQGpIvID1istxw ($21.20 in chips) 
Seat 6: gehe91e0IyVT0QU/XBkEyg ($27.45 in chips) 
Seat 7: QJxYAPJ6uPZZcpdN+RvWcQ ($25 in chips) 
Seat 8: rQhYIYXSyH/IivYM1dlV5A ($23.15 in chips) 
Seat 9: CgIo2ItZqi4o3ayVG6HanQ ($24.25 in chips) 
aCVg6cCxQcqClhB9nq/p1w: posts small blind $0.10
BT6Oal0iO4P6kDuT7HFQDw: posts big blind $0.25
*** HOLE CARDS ***
wre31HfyzQGpIvID1istxw: folds 
gehe91e0IyVT0QU/XBkEyg: folds 
QJxYAPJ6uPZZcpdN+RvWcQ: folds 
rQhYIYXSyH/IivYM1dlV5A: folds 
CgIo2ItZqi4o3ayVG6HanQ: raises $0.25 to $0.50
AKrlhR3s97+cfTtZj3tKjw: folds 
UmzixCpC0bAc1lDEjgB3NQ: folds 
aCVg6cCxQcqClhB9nq/p1w: folds 
UmzixCpC0bAc1lDEjgB3NQ is sitting out
BT6Oal0iO4P6kDuT7HFQDw: raises $4.50 to $5
CgIo2ItZqi4o3ayVG6HanQ: folds 
Uncalled bet ($4.50) returned to BT6Oal0iO4P6kDuT7HFQDw
BT6Oal0iO4P6kDuT7HFQDw collected $1.10 from pot
BT6Oal0iO4P6kDuT7HFQDw: doesn't show hand 
*** SUMMARY ***
Total pot $1.10 | Rake $0 
Seat 1: AKrlhR3s97+cfTtZj3tKjw folded before Flop (didn't bet)
Seat 2: UmzixCpC0bAc1lDEjgB3NQ (button) folded before Flop (didn't bet)
Seat 3: aCVg6cCxQcqClhB9nq/p1w (small blind) folded before Flop
Seat 4: BT6Oal0iO4P6kDuT7HFQDw (big blind) collected ($1.10)
Seat 5: wre31HfyzQGpIvID1istxw folded before Flop (didn't bet)
Seat 6: gehe91e0IyVT0QU/XBkEyg folded before Flop (didn't bet)
Seat 7: QJxYAPJ6uPZZcpdN+RvWcQ folded before Flop (didn't bet)
Seat 8: rQhYIYXSyH/IivYM1dlV5A folded before Flop (didn't bet)
Seat 9: CgIo2ItZqi4o3ayVG6HanQ folded before Flop




PokerStars Game #59941570506:  Hold'em No Limit ($0.10/$0.25) - 2009/07/01 1:39:28 ET
Table '4ZbiE0ZYjzqmgu6+sO1prg' 9-max Seat #5 is the button
Seat 1: eXiRSFoUjkV5taBc4N8rMQ ($8.75 in chips) 
Seat 2: 9lvO/qyU+xrU95Teu1fv0g ($5.55 in chips) 
Seat 3: HPEB+AtKw1+C/cxU0o1ciw ($25.55 in chips) 
Seat 4: w1ukf8uPa4+WH561TtVRxA ($25 in chips) 
Seat 5: +2kMBNpY4nF1qNCRd8SJLA ($43.95 in chips) 
Seat 6: UmzixCpC0bAc1lDEjgB3NQ ($10.75 in chips) 
Seat 7: aNpwfA31EREwO+ar4XzBCw ($25 in chips) 
Seat 8: cZ99hugmLBj9KhTlc8nCSw ($29.95 in chips) 
UmzixCpC0bAc1lDEjgB3NQ: posts small blind $0.10
aNpwfA31EREwO+ar4XzBCw: posts big blind $0.25
RCqMONFrSPSArZh2Jsar/w: sits out 
*** HOLE CARDS ***
cZ99hugmLBj9KhTlc8nCSw: folds 
eXiRSFoUjkV5taBc4N8rMQ: folds 
9lvO/qyU+xrU95Teu1fv0g: folds 
HPEB+AtKw1+C/cxU0o1ciw: folds 
w1ukf8uPa4+WH561TtVRxA: folds 
+2kMBNpY4nF1qNCRd8SJLA: folds 
UmzixCpC0bAc1lDEjgB3NQ: calls $0.15
aNpwfA31EREwO+ar4XzBCw: checks 
*** FLOP *** [8h 6s 2h]
UmzixCpC0bAc1lDEjgB3NQ: bets $0.25
aNpwfA31EREwO+ar4XzBCw: raises $0.75 to $1
UmzixCpC0bAc1lDEjgB3NQ: folds 
Uncalled bet ($0.75) returned to aNpwfA31EREwO+ar4XzBCw
aNpwfA31EREwO+ar4XzBCw collected $0.95 from pot
aNpwfA31EREwO+ar4XzBCw: doesn't show hand 
*** SUMMARY ***
Total pot $1 | Rake $0.05 
Board [8h 6s 2h]
Seat 1: eXiRSFoUjkV5taBc4N8rMQ folded before Flop (didn't bet)
Seat 2: 9lvO/qyU+xrU95Teu1fv0g folded before Flop (didn't bet)
Seat 3: HPEB+AtKw1+C/cxU0o1ciw folded before Flop (didn't bet)
Seat 4: w1ukf8uPa4+WH561TtVRxA folded before Flop (didn't bet)
Seat 5: +2kMBNpY4nF1qNCRd8SJLA (button) folded before Flop (didn't bet)
Seat 6: UmzixCpC0bAc1lDEjgB3NQ (small blind) folded on the Flop
Seat 7: aNpwfA31EREwO+ar4XzBCw (big blind) collected ($0.95)
Seat 8: cZ99hugmLBj9KhTlc8nCSw folded before Flop (didn't bet)




PokerStars Game #59941570330:  Hold'em No Limit ($0.10/$0.25) - 2009/07/01 1:39:28 ET
Table 'FBhJjLqab11/gKu8nyB/tw' 9-max Seat #1 is the button
Seat 1: +sbyWwIcFp9kP0bDtMegfQ ($18.10 in chips) 
Seat 2: 1pwQJV/Xr0GWPRefx/78VQ ($17.40 in chips) 
Seat 3: V6p0jQ/RhUsqpHLmXvEX4Q ($12.35 in chips) 
Seat 4: CvL9Ch1HYCVbTsfpNucitg ($5.50 in chips) 
Seat 5: IwVTJd8fvOC1W0/rJy0nRw ($14 in chips) 
Seat 6: cZ99hugmLBj9KhTlc8nCSw ($25 in chips) 
Seat 7: CT7Xj/V/O5rBlhtt+RZeFQ ($25 in chips) 
Seat 8: Th3FldXKQW6hWVVPahaoOQ ($27.40 in chips) 
1pwQJV/Xr0GWPRefx/78VQ: posts small blind $0.10
V6p0jQ/RhUsqpHLmXvEX4Q: posts big blind $0.25
*** HOLE CARDS ***
CvL9Ch1HYCVbTsfpNucitg: raises $0.75 to $1
IwVTJd8fvOC1W0/rJy0nRw: folds 
cZ99hugmLBj9KhTlc8nCSw: folds 
IwVTJd8fvOC1W0/rJy0nRw leaves the table
CT7Xj/V/O5rBlhtt+RZeFQ: folds 
Th3FldXKQW6hWVVPahaoOQ: folds 
+sbyWwIcFp9kP0bDtMegfQ: folds 
1pwQJV/Xr0GWPRefx/78VQ: folds 
Mh2r9hTeTEDnh19sRZtW3g joins the table at seat #5 
V6p0jQ/RhUsqpHLmXvEX4Q: folds 
Uncalled bet ($0.75) returned to CvL9Ch1HYCVbTsfpNucitg
CvL9Ch1HYCVbTsfpNucitg collected $0.60 from pot
CvL9Ch1HYCVbTsfpNucitg: doesn't show hand 
*** SUMMARY ***
Total pot $0.60 | Rake $0 
Seat 1: +sbyWwIcFp9kP0bDtMegfQ (button) folded before Flop (didn't bet)
Seat 2: 1pwQJV/Xr0GWPRefx/78VQ (small blind) folded before Flop
Seat 3: V6p0jQ/RhUsqpHLmXvEX4Q (big blind) folded before Flop
Seat 4: CvL9Ch1HYCVbTsfpNucitg collected ($0.60)
Seat 5: IwVTJd8fvOC1W0/rJy0nRw folded before Flop (didn't bet)
Seat 6: cZ99hugmLBj9KhTlc8nCSw folded before Flop (didn't bet)
Seat 7: CT7Xj/V/O5rBlhtt+RZeFQ folded before Flop (didn't bet)
Seat 8: Th3FldXKQW6hWVVPahaoOQ folded before Flop (didn't bet)




PokerStars Game #59941570348:  Hold'em No Limit ($0.10/$0.25) - 2009/07/01 1:39:28 ET
Table 'ThBZ355rqvsb8UGb6ajbig' 9-max Seat #4 is the button
Seat 1: cZ99hugmLBj9KhTlc8nCSw ($38.15 in chips) 
Seat 2: 4awUyiDYTgylQKXZ9faBVA ($25.60 in chips) 
Seat 3: H5Se03ZqSX7tbULXur2MAg ($27.90 in chips) 
Seat 4: zgi+EUykT/pZQpoUG6+oEg ($4.65 in chips) 
Seat 5: cKlmpQMahVsmOaxFQDcoOg ($25.45 in chips) 
Seat 6: qwr38jl5txoR36M7G5qi4A ($10.15 in chips) 
Seat 7: zUXhymECc2C9W9ZNw6qppA ($16.70 in chips) 
Seat 9: sD+TKtt36XiiN6jqHiLwDA ($23.85 in chips) 
cKlmpQMahVsmOaxFQDcoOg: posts small blind $0.10
qwr38jl5txoR36M7G5qi4A: posts big blind $0.25
PdIasPkzm2sqZnN41ZRXOg: sits out 
*** HOLE CARDS ***
zUXhymECc2C9W9ZNw6qppA: folds 
sD+TKtt36XiiN6jqHiLwDA: folds 
cZ99hugmLBj9KhTlc8nCSw: folds 
4awUyiDYTgylQKXZ9faBVA: raises $0.75 to $1
H5Se03ZqSX7tbULXur2MAg: folds 
zgi+EUykT/pZQpoUG6+oEg: folds 
cKlmpQMahVsmOaxFQDcoOg: folds 
qwr38jl5txoR36M7G5qi4A: folds 
Uncalled bet ($0.75) returned to 4awUyiDYTgylQKXZ9faBVA
4awUyiDYTgylQKXZ9faBVA collected $0.60 from pot
4awUyiDYTgylQKXZ9faBVA: doesn't show hand 
*** SUMMARY ***
Total pot $0.60 | Rake $0 
Seat 1: cZ99hugmLBj9KhTlc8nCSw folded before Flop (didn't bet)
Seat 2: 4awUyiDYTgylQKXZ9faBVA collected ($0.60)
Seat 3: H5Se03ZqSX7tbULXur2MAg folded before Flop (didn't bet)
Seat 4: zgi+EUykT/pZQpoUG6+oEg (button) folded before Flop (didn't bet)
Seat 5: cKlmpQMahVsmOaxFQDcoOg (small blind) folded before Flop
Seat 6: qwr38jl5txoR36M7G5qi4A (big blind) folded before Flop
Seat 7: zUXhymECc2C9W9ZNw6qppA folded before Flop (didn't bet)
Seat 9: sD+TKtt36XiiN6jqHiLwDA folded before Flop (didn't bet)




PokerStars Game #59941570578:  Hold'em No Limit ($0.10/$0.25) - 2009/07/01 1:39:28 ET
Table 'rjcb+nlE+0GuJ6lBhuCkkA' 6-max Seat #5 is the button
Seat 1: lBoEwOFgzcERLIRUkUoRTw ($14.05 in chips) 
Seat 2: lJphax9e7/+O/3YCKPJ0yQ ($5 in chips) 
Seat 4: BV+K0Phf5VBHr7aZPKqbUQ ($25 in chips) 
Seat 5: GC/9yVD59DUCX7hUI7gcLw ($39.80 in chips) 
lBoEwOFgzcERLIRUkUoRTw: posts small blind $0.10
lJphax9e7/+O/3YCKPJ0yQ: posts big blind $0.25
8ClCHtFXGNplITm+63KB+Q: sits out 
*** HOLE CARDS ***
BV+K0Phf5VBHr7aZPKqbUQ: raises $0.50 to $0.75
GC/9yVD59DUCX7hUI7gcLw: calls $0.75
lBoEwOFgzcERLIRUkUoRTw: folds 
32YL2ZEp8NT4JB2RVM9euQ joins the table at seat #6 
lJphax9e7/+O/3YCKPJ0yQ: folds 
*** FLOP *** [6c Td 4h]
BV+K0Phf5VBHr7aZPKqbUQ: bets $1
GC/9yVD59DUCX7hUI7gcLw: raises $2.50 to $3.50
BV+K0Phf5VBHr7aZPKqbUQ: folds 
Uncalled bet ($2.50) returned to GC/9yVD59DUCX7hUI7gcLw
GC/9yVD59DUCX7hUI7gcLw collected $3.70 from pot
*** SUMMARY ***
Total pot $3.85 | Rake $0.15 
Board [6c Td 4h]
Seat 1: lBoEwOFgzcERLIRUkUoRTw (small blind) folded before Flop
Seat 2: lJphax9e7/+O/3YCKPJ0yQ (big blind) folded before Flop
Seat 4: BV+K0Phf5VBHr7aZPKqbUQ folded on the Flop
Seat 5: GC/9yVD59DUCX7hUI7gcLw (button) collected ($3.70)




PokerStars Game #59941570834:  Hold'em No Limit ($0.10/$0.25) - 2009/07/01 1:39:29 ET
Table '2VkNDXXsBj4bSZw/uK5atw' 6-max Seat #5 is the button
Seat 1: xrf8tAXKQHG99HixCot1Iw ($15.65 in chips) 
Seat 2: MgAtgQuaEEshtfbhCfs+bA ($18.45 in chips) 
Seat 3: 8D0jr3B4e++Q/cTSnpHdzg ($37.30 in chips) 
Seat 5: 7f0OkhFEOf3T+rVOFHRLnw ($23.15 in chips) 
Seat 6: n6UPMnVR4v8LFP0rWP73Fg ($13.65 in chips) 
n6UPMnVR4v8LFP0rWP73Fg: posts small blind $0.10
xrf8tAXKQHG99HixCot1Iw: posts big blind $0.25
*** HOLE CARDS ***
MgAtgQuaEEshtfbhCfs+bA: folds 
8D0jr3B4e++Q/cTSnpHdzg: folds 
7f0OkhFEOf3T+rVOFHRLnw: folds 
n6UPMnVR4v8LFP0rWP73Fg: raises $0.25 to $0.50
MgAtgQuaEEshtfbhCfs+bA leaves the table
xrf8tAXKQHG99HixCot1Iw: calls $0.25
*** FLOP *** [8h 9d 6h]
n6UPMnVR4v8LFP0rWP73Fg: bets $1
xrf8tAXKQHG99HixCot1Iw: raises $1.75 to $2.75
n6UPMnVR4v8LFP0rWP73Fg: calls $1.75
*** TURN *** [8h 9d 6h] [7d]
n6UPMnVR4v8LFP0rWP73Fg: checks 
xrf8tAXKQHG99HixCot1Iw: bets $4.50
n6UPMnVR4v8LFP0rWP73Fg: folds 
Uncalled bet ($4.50) returned to xrf8tAXKQHG99HixCot1Iw
xrf8tAXKQHG99HixCot1Iw collected $6.20 from pot
xrf8tAXKQHG99HixCot1Iw: doesn't show hand 
*** SUMMARY ***
Total pot $6.50 | Rake $0.30 
Board [8h 9d 6h 7d]
Seat 1: xrf8tAXKQHG99HixCot1Iw (big blind) collected ($6.20)
Seat 2: MgAtgQuaEEshtfbhCfs+bA folded before Flop (didn't bet)
Seat 3: 8D0jr3B4e++Q/cTSnpHdzg folded before Flop (didn't bet)
Seat 5: 7f0OkhFEOf3T+rVOFHRLnw (button) folded before Flop (didn't bet)
Seat 6: n6UPMnVR4v8LFP0rWP73Fg (small blind) folded on the Turn




PokerStars Game #59941571236:  Hold'em No Limit ($0.10/$0.25) - 2009/07/01 1:39:29 ET
Table 'VuY5ej47Cy8nOI3Wogmhzw' 6-max Seat #4 is the button
Seat 1: EeUZtMU058v2ObUACOF4Og ($25.95 in chips) 
Seat 2: AM6Yl+3esmhhMBlSnQhWbg ($15.65 in chips) 
Seat 3: v+QfkGiuj9bgtuNoVnDO8w ($31.85 in chips) 
Seat 4: aXzjpue4eAQBqMdp87D3ZA ($13.95 in chips) 
Seat 5: iK/41//HmnLiIn0CVNNfyA ($12.05 in chips) 
iK/41//HmnLiIn0CVNNfyA: posts small blind $0.10
EeUZtMU058v2ObUACOF4Og: posts big blind $0.25
*** HOLE CARDS ***
AM6Yl+3esmhhMBlSnQhWbg: folds 
v+QfkGiuj9bgtuNoVnDO8w: folds 
aXzjpue4eAQBqMdp87D3ZA: folds 
iK/41//HmnLiIn0CVNNfyA: folds 
Uncalled bet ($0.15) returned to EeUZtMU058v2ObUACOF4Og
EeUZtMU058v2ObUACOF4Og collected $0.20 from pot
EeUZtMU058v2ObUACOF4Og: doesn't show hand 
*** SUMMARY ***
Total pot $0.20 | Rake $0 
Seat 1: EeUZtMU058v2ObUACOF4Og (big blind) collected ($0.20)
Seat 2: AM6Yl+3esmhhMBlSnQhWbg folded before Flop (didn't bet)
Seat 3: v+QfkGiuj9bgtuNoVnDO8w folded before Flop (didn't bet)
Seat 4: aXzjpue4eAQBqMdp87D3ZA (button) folded before Flop (didn't bet)
Seat 5: iK/41//HmnLiIn0CVNNfyA (small blind) folded before Flop




PokerStars Game #59941570812:  Hold'em No Limit ($0.10/$0.25) - 2009/07/01 1:39:29 ET
Table '3eK1r4Q4BSYFvsKkuTLpIA' 9-max Seat #6 is the button
Seat 1: vSkQm2EelzwRGDDQQk0Fqw ($4.65 in chips) 
Seat 2: aNpwfA31EREwO+ar4XzBCw ($26.50 in chips) 
Seat 3: 56S3mA6Zs3pGR+0p0vUCtg ($31.05 in chips) 
Seat 4: +2kMBNpY4nF1qNCRd8SJLA ($25 in chips) 
Seat 5: 775TiRJajPtN/ucpTmHrXA ($15 in chips) 
Seat 6: +HvCCmsGSQeatf+GZ9zk8Q ($39.20 in chips) 
Seat 7: ljemhp25Zg+nlA9DLCIiUw ($24.75 in chips) 
Seat 8: /29aHLC+Q6KCDcNv2bPfAg ($14.15 in chips) 
Seat 9: +sbyWwIcFp9kP0bDtMegfQ ($60.75 in chips) 
ljemhp25Zg+nlA9DLCIiUw: posts small blind $0.10
/29aHLC+Q6KCDcNv2bPfAg: posts big blind $0.25
775TiRJajPtN/ucpTmHrXA: posts big blind $0.25
*** HOLE CARDS ***
+sbyWwIcFp9kP0bDtMegfQ: folds 
vSkQm2EelzwRGDDQQk0Fqw: folds 
aNpwfA31EREwO+ar4XzBCw: folds 
56S3mA6Zs3pGR+0p0vUCtg: raises $1 to $1.25
+2kMBNpY4nF1qNCRd8SJLA: folds 
775TiRJajPtN/ucpTmHrXA: folds 
+HvCCmsGSQeatf+GZ9zk8Q: folds 
ljemhp25Zg+nlA9DLCIiUw: folds 
/29aHLC+Q6KCDcNv2bPfAg: calls $1
*** FLOP *** [Jc 2d 6h]
/29aHLC+Q6KCDcNv2bPfAg: checks 
56S3mA6Zs3pGR+0p0vUCtg: bets $1.25
/29aHLC+Q6KCDcNv2bPfAg: folds 
Uncalled bet ($1.25) returned to 56S3mA6Zs3pGR+0p0vUCtg
56S3mA6Zs3pGR+0p0vUCtg collected $2.75 from pot
56S3mA6Zs3pGR+0p0vUCtg: doesn't show hand 
*** SUMMARY ***
Total pot $2.85 | Rake $0.10 
Board [Jc 2d 6h]
Seat 1: vSkQm2EelzwRGDDQQk0Fqw folded before Flop (didn't bet)
Seat 2: aNpwfA31EREwO+ar4XzBCw folded before Flop (didn't bet)
Seat 3: 56S3mA6Zs3pGR+0p0vUCtg collected ($2.75)
Seat 4: +2kMBNpY4nF1qNCRd8SJLA folded before Flop (didn't bet)
Seat 5: 775TiRJajPtN/ucpTmHrXA folded before Flop
Seat 6: +HvCCmsGSQeatf+GZ9zk8Q (button) folded before Flop (didn't bet)
Seat 7: ljemhp25Zg+nlA9DLCIiUw (small blind) folded before Flop
Seat 8: /29aHLC+Q6KCDcNv2bPfAg (big blind) folded on the Flop
Seat 9: +sbyWwIcFp9kP0bDtMegfQ folded before Flop (didn't bet)




PokerStars Game #59941571664:  Hold'em No Limit ($0.10/$0.25) - 2009/07/01 1:39:30 ET
Table 'aT31tt16YvQM/Ue69HPLpA' 9-max Seat #2 is the button
Seat 1: fIgGw0jPUR7labvJPaPbeg ($11.15 in chips) 
Seat 2: PdIasPkzm2sqZnN41ZRXOg ($4.90 in chips) 
Seat 3: tYsOBqdU1+x+yFI7zHO7hQ ($26.25 in chips) 
Seat 4: wGigCmBR/9XWkPpvYos3aQ ($28.35 in chips) 
Seat 5: s2xLPOl/vhl/26apJ3vsOQ ($33.50 in chips) 
Seat 6: 7cv+9Zc9HIQHNvYsMfV3uA ($58.80 in chips) 
Seat 7: W8cIfrCR+zA8pCNyIuHu8g ($32.30 in chips) 
Seat 8: bjd1tZ9iYeC6jiDZ7/ipZw ($13.95 in chips) 
Seat 9: TvIuLx9zUCE+9Li58iImOQ ($17.95 in chips) 
tYsOBqdU1+x+yFI7zHO7hQ: posts small blind $0.10
wGigCmBR/9XWkPpvYos3aQ: posts big blind $0.25
*** HOLE CARDS ***
s2xLPOl/vhl/26apJ3vsOQ: folds 
7cv+9Zc9HIQHNvYsMfV3uA: folds 
W8cIfrCR+zA8pCNyIuHu8g: folds 
bjd1tZ9iYeC6jiDZ7/ipZw: folds 
bjd1tZ9iYeC6jiDZ7/ipZw is sitting out
TvIuLx9zUCE+9Li58iImOQ: folds 
fIgGw0jPUR7labvJPaPbeg: calls $0.25
PdIasPkzm2sqZnN41ZRXOg: folds 
tYsOBqdU1+x+yFI7zHO7hQ: folds 
wGigCmBR/9XWkPpvYos3aQ: checks 
*** FLOP *** [9c Qs Ad]
wGigCmBR/9XWkPpvYos3aQ: checks 
fIgGw0jPUR7labvJPaPbeg: bets $0.50
wGigCmBR/9XWkPpvYos3aQ: folds 
Uncalled bet ($0.50) returned to fIgGw0jPUR7labvJPaPbeg
bjd1tZ9iYeC6jiDZ7/ipZw leaves the table
fIgGw0jPUR7labvJPaPbeg collected $0.60 from pot
*** SUMMARY ***
Total pot $0.60 | Rake $0 
Board [9c Qs Ad]
Seat 1: fIgGw0jPUR7labvJPaPbeg collected ($0.60)
Seat 2: PdIasPkzm2sqZnN41ZRXOg (button) folded before Flop (didn't bet)
Seat 3: tYsOBqdU1+x+yFI7zHO7hQ (small blind) folded before Flop
Seat 4: wGigCmBR/9XWkPpvYos3aQ (big blind) folded on the Flop
Seat 5: s2xLPOl/vhl/26apJ3vsOQ folded before Flop (didn't bet)
Seat 6: 7cv+9Zc9HIQHNvYsMfV3uA folded before Flop (didn't bet)
Seat 7: W8cIfrCR+zA8pCNyIuHu8g folded before Flop (didn't bet)
Seat 8: bjd1tZ9iYeC6jiDZ7/ipZw folded before Flop (didn't bet)
Seat 9: TvIuLx9zUCE+9Li58iImOQ folded before Flop (didn't bet)




PokerStars Game #59941571738:  Hold'em No Limit ($0.10/$0.25) - 2009/07/01 1:39:30 ET
Table 'hg+KpirwreMnBAFQr/SEUA' 9-max Seat #2 is the button
Seat 1: H5Se03ZqSX7tbULXur2MAg ($33.80 in chips) 
Seat 2: cpnBzHjFACn5zAY56UIvNA ($19.45 in chips) 
Seat 3: DdyXKuBx0HAOC7dWZmGxWg ($22.15 in chips) 
Seat 5: +2kMBNpY4nF1qNCRd8SJLA ($25 in chips) 
Seat 6: Bb42QRQMhg5/Y0vHP8/2Xw ($25 in chips) 
Seat 7: 5LSuZS4qvcUri/Byfkln7w ($10 in chips) 
Seat 8: HPEB+AtKw1+C/cxU0o1ciw ($23.75 in chips) 
Seat 9: xbecloQJYmBOSkzT9lZ+rg ($20.50 in chips) 
DdyXKuBx0HAOC7dWZmGxWg: posts small blind $0.10
+2kMBNpY4nF1qNCRd8SJLA: posts big blind $0.25
5LSuZS4qvcUri/Byfkln7w: posts big blind $0.25
*** HOLE CARDS ***
Bb42QRQMhg5/Y0vHP8/2Xw: folds 
5LSuZS4qvcUri/Byfkln7w: checks 
HPEB+AtKw1+C/cxU0o1ciw: folds 
xbecloQJYmBOSkzT9lZ+rg: folds 
H5Se03ZqSX7tbULXur2MAg: folds 
cpnBzHjFACn5zAY56UIvNA: folds 
DdyXKuBx0HAOC7dWZmGxWg: calls $0.15
+2kMBNpY4nF1qNCRd8SJLA: checks 
*** FLOP *** [9c 5d Th]
DdyXKuBx0HAOC7dWZmGxWg: checks 
+2kMBNpY4nF1qNCRd8SJLA: checks 
5LSuZS4qvcUri/Byfkln7w: checks 
*** TURN *** [9c 5d Th] [9h]
DdyXKuBx0HAOC7dWZmGxWg: bets $0.25
+2kMBNpY4nF1qNCRd8SJLA: folds 
5LSuZS4qvcUri/Byfkln7w: folds 
Uncalled bet ($0.25) returned to DdyXKuBx0HAOC7dWZmGxWg
DdyXKuBx0HAOC7dWZmGxWg collected $0.75 from pot
DdyXKuBx0HAOC7dWZmGxWg: doesn't show hand 
*** SUMMARY ***
Total pot $0.75 | Rake $0 
Board [9c 5d Th 9h]
Seat 1: H5Se03ZqSX7tbULXur2MAg folded before Flop (didn't bet)
Seat 2: cpnBzHjFACn5zAY56UIvNA (button) folded before Flop (didn't bet)
Seat 3: DdyXKuBx0HAOC7dWZmGxWg (small blind) collected ($0.75)
Seat 5: +2kMBNpY4nF1qNCRd8SJLA (big blind) folded on the Turn
Seat 6: Bb42QRQMhg5/Y0vHP8/2Xw folded before Flop (didn't bet)
Seat 7: 5LSuZS4qvcUri/Byfkln7w folded on the Turn
Seat 8: HPEB+AtKw1+C/cxU0o1ciw folded before Flop (didn't bet)
Seat 9: xbecloQJYmBOSkzT9lZ+rg folded before Flop (didn't bet)




PokerStars Game #59941571842:  Hold'em No Limit ($0.10/$0.25) - 2009/07/01 1:39:30 ET
Table 'NtCSSONEf1zaJo3042tQug' 6-max Seat #5 is the button
Seat 1: KXtdqb+rIMkjc0RvHDksGQ ($32.30 in chips) 
Seat 2: vqWjZmdQu/Hxw96/IJTWdQ ($26.70 in chips) 
Seat 3: 9kUKGKkblnIx3m8rlVol6Q ($14.15 in chips) 
Seat 4: HxD1kB8zCmalQSdWAkKmlg ($29.20 in chips) 
Seat 5: tOAk1Og4mVObMBOfvdDYOw ($31.65 in chips) 
Seat 6: LxehwDpTQ19ph4Qmc78+Pw ($33.10 in chips) 
LxehwDpTQ19ph4Qmc78+Pw: posts small blind $0.10
KXtdqb+rIMkjc0RvHDksGQ: posts big blind $0.25
*** HOLE CARDS ***
vqWjZmdQu/Hxw96/IJTWdQ: folds 
9kUKGKkblnIx3m8rlVol6Q: folds 
HxD1kB8zCmalQSdWAkKmlg: folds 
tOAk1Og4mVObMBOfvdDYOw: raises $0.75 to $1
LxehwDpTQ19ph4Qmc78+Pw: folds 
KXtdqb+rIMkjc0RvHDksGQ: raises $2.50 to $3.50
tOAk1Og4mVObMBOfvdDYOw: calls $2.50
*** FLOP *** [3h 5d Ts]
KXtdqb+rIMkjc0RvHDksGQ: bets $4
tOAk1Og4mVObMBOfvdDYOw: folds 
Uncalled bet ($4) returned to KXtdqb+rIMkjc0RvHDksGQ
KXtdqb+rIMkjc0RvHDksGQ collected $6.75 from pot
KXtdqb+rIMkjc0RvHDksGQ: doesn't show hand 
*** SUMMARY ***
Total pot $7.10 | Rake $0.35 
Board [3h 5d Ts]
Seat 1: KXtdqb+rIMkjc0RvHDksGQ (big blind) collected ($6.75)
Seat 2: vqWjZmdQu/Hxw96/IJTWdQ folded before Flop (didn't bet)
Seat 3: 9kUKGKkblnIx3m8rlVol6Q folded before Flop (didn't bet)
Seat 4: HxD1kB8zCmalQSdWAkKmlg folded before Flop (didn't bet)
Seat 5: tOAk1Og4mVObMBOfvdDYOw (button) folded on the Flop
Seat 6: LxehwDpTQ19ph4Qmc78+Pw (small blind) folded before Flop




PokerStars Game #59941571520:  Hold'em No Limit ($0.10/$0.25) - 2009/07/01 1:39:30 ET
Table '5SUMWYuPsGiOD0FY0QbgOw' 6-max Seat #6 is the button
Seat 1: SFmT9ZsVopnukjvAzrxTRg ($25 in chips) 
Seat 2: xrf8tAXKQHG99HixCot1Iw ($38.05 in chips) 
Seat 3: MqMK8OWPSY1V4stf1Hy5Jw ($32.25 in chips) 
Seat 4: BV+K0Phf5VBHr7aZPKqbUQ ($25.35 in chips) 
Seat 5: v+QfkGiuj9bgtuNoVnDO8w ($40.75 in chips) 
Seat 6: jA7YMtfNUnAaebB7Lj74EA ($24.45 in chips) 
SFmT9ZsVopnukjvAzrxTRg: posts small blind $0.10
xrf8tAXKQHG99HixCot1Iw: posts big blind $0.25
*** HOLE CARDS ***
MqMK8OWPSY1V4stf1Hy5Jw: folds 
BV+K0Phf5VBHr7aZPKqbUQ: folds 
v+QfkGiuj9bgtuNoVnDO8w: folds 
jA7YMtfNUnAaebB7Lj74EA: calls $0.25
SFmT9ZsVopnukjvAzrxTRg: folds 
xrf8tAXKQHG99HixCot1Iw: checks 
*** FLOP *** [8c 7d 6h]
xrf8tAXKQHG99HixCot1Iw: checks 
jA7YMtfNUnAaebB7Lj74EA: checks 
*** TURN *** [8c 7d 6h] [9d]
xrf8tAXKQHG99HixCot1Iw: checks 
jA7YMtfNUnAaebB7Lj74EA: checks 
*** RIVER *** [8c 7d 6h 9d] [2s]
xrf8tAXKQHG99HixCot1Iw: checks 
jA7YMtfNUnAaebB7Lj74EA: bets $0.50
xrf8tAXKQHG99HixCot1Iw: folds 
Uncalled bet ($0.50) returned to jA7YMtfNUnAaebB7Lj74EA
jA7YMtfNUnAaebB7Lj74EA collected $0.60 from pot
*** SUMMARY ***
Total pot $0.60 | Rake $0 
Board [8c 7d 6h 9d 2s]
Seat 1: SFmT9ZsVopnukjvAzrxTRg (small blind) folded before Flop
Seat 2: xrf8tAXKQHG99HixCot1Iw (big blind) folded on the River
Seat 3: MqMK8OWPSY1V4stf1Hy5Jw folded before Flop (didn't bet)
Seat 4: BV+K0Phf5VBHr7aZPKqbUQ folded before Flop (didn't bet)
Seat 5: v+QfkGiuj9bgtuNoVnDO8w folded before Flop (didn't bet)
Seat 6: jA7YMtfNUnAaebB7Lj74EA (button) collected ($0.60)




PokerStars Game #59941571380:  Hold'em No Limit ($0.10/$0.25) - 2009/07/01 1:39:30 ET
Table '63uh7ZsO7Tnt+E8b/2bu3A' 6-max Seat #4 is the button
Seat 1: 0av6tRNdi0Ui4f15L7gsVg ($26.15 in chips) 
Seat 2: SFmT9ZsVopnukjvAzrxTRg ($30.25 in chips) 
Seat 3: yVP7GLZBzx47OPi6jzUxMw ($15.50 in chips) 
Seat 4: 2tYgzzRRW/D2GWb2A7f1jw ($7.35 in chips) 
Seat 5: GbCVUNssQ7mqsPWr7J4d3w ($5.10 in chips) 
Seat 6: qGHGf/553gQnDoklMRe3tg ($32.35 in chips) 
GbCVUNssQ7mqsPWr7J4d3w: posts small blind $0.10
qGHGf/553gQnDoklMRe3tg: posts big blind $0.25
*** HOLE CARDS ***
0av6tRNdi0Ui4f15L7gsVg: folds 
SFmT9ZsVopnukjvAzrxTRg: folds 
yVP7GLZBzx47OPi6jzUxMw: raises $0.50 to $0.75
2tYgzzRRW/D2GWb2A7f1jw: folds 
GbCVUNssQ7mqsPWr7J4d3w: folds 
qGHGf/553gQnDoklMRe3tg: folds 
Uncalled bet ($0.50) returned to yVP7GLZBzx47OPi6jzUxMw
yVP7GLZBzx47OPi6jzUxMw collected $0.60 from pot
yVP7GLZBzx47OPi6jzUxMw: doesn't show hand 
*** SUMMARY ***
Total pot $0.60 | Rake $0 
Seat 1: 0av6tRNdi0Ui4f15L7gsVg folded before Flop (didn't bet)
Seat 2: SFmT9ZsVopnukjvAzrxTRg folded before Flop (didn't bet)
Seat 3: yVP7GLZBzx47OPi6jzUxMw collected ($0.60)
Seat 4: 2tYgzzRRW/D2GWb2A7f1jw (button) folded before Flop (didn't bet)
Seat 5: GbCVUNssQ7mqsPWr7J4d3w (small blind) folded before Flop
Seat 6: qGHGf/553gQnDoklMRe3tg (big blind) folded before Flop




PokerStars Game #59941572082:  Hold'em No Limit ($0.10/$0.25) - 2009/07/01 1:39:31 ET
Table 'zKwHJD0cmKNUure9qQTfFg' 6-max Seat #3 is the button
Seat 1: RXYRBsbRgZxcivyqSdOo3A ($3.90 in chips) 
Seat 2: xrf8tAXKQHG99HixCot1Iw ($26.55 in chips) 
Seat 3: 60PLIlpucQhA08L3YbNmag ($5.60 in chips) 
Seat 4: v+QfkGiuj9bgtuNoVnDO8w ($25.90 in chips) 
Seat 5: E4AqQ1egsnu0oH2RqsbCmQ ($4.80 in chips) 
Seat 6: edio/rLJ06xeZOfLhoL3UA ($11.20 in chips) 
v+QfkGiuj9bgtuNoVnDO8w: posts small blind $0.10
E4AqQ1egsnu0oH2RqsbCmQ: posts big blind $0.25
*** HOLE CARDS ***
edio/rLJ06xeZOfLhoL3UA: raises $0.75 to $1
RXYRBsbRgZxcivyqSdOo3A: folds 
xrf8tAXKQHG99HixCot1Iw: folds 
60PLIlpucQhA08L3YbNmag: folds 
v+QfkGiuj9bgtuNoVnDO8w: folds 
E4AqQ1egsnu0oH2RqsbCmQ: folds 
Uncalled bet ($0.75) returned to edio/rLJ06xeZOfLhoL3UA
edio/rLJ06xeZOfLhoL3UA collected $0.60 from pot
edio/rLJ06xeZOfLhoL3UA: doesn't show hand 
*** SUMMARY ***
Total pot $0.60 | Rake $0 
Seat 1: RXYRBsbRgZxcivyqSdOo3A folded before Flop (didn't bet)
Seat 2: xrf8tAXKQHG99HixCot1Iw folded before Flop (didn't bet)
Seat 3: 60PLIlpucQhA08L3YbNmag (button) folded before Flop (didn't bet)
Seat 4: v+QfkGiuj9bgtuNoVnDO8w (small blind) folded before Flop
Seat 5: E4AqQ1egsnu0oH2RqsbCmQ (big blind) folded before Flop
Seat 6: edio/rLJ06xeZOfLhoL3UA collected ($0.60)




PokerStars Game #59941572148:  Hold'em No Limit ($0.10/$0.25) - 2009/07/01 1:39:31 ET
Table 'fIMYcWwN4/aXFJvH5Z8Ymg' 6-max Seat #6 is the button
Seat 1: DihMHaz4WNETH1bPDe13kA ($25.10 in chips) 
Seat 2: vu2kzHaDtgr6NM7rdq0chA ($26.80 in chips) 
Seat 3: bWbV4MVB/vVpiES1Ut4hew ($107 in chips) 
Seat 4: 32YL2ZEp8NT4JB2RVM9euQ ($42.75 in chips) 
Seat 5: lquriepNQBhDV5P1SWHhnA ($25 in chips) 
Seat 6: jp34e617tIzV8tKIWmfAbA ($28 in chips) 
DihMHaz4WNETH1bPDe13kA: posts small blind $0.10
vu2kzHaDtgr6NM7rdq0chA: posts big blind $0.25
*** HOLE CARDS ***
bWbV4MVB/vVpiES1Ut4hew: raises $0.75 to $1
32YL2ZEp8NT4JB2RVM9euQ: folds 
lquriepNQBhDV5P1SWHhnA: raises $2.50 to $3.50
jp34e617tIzV8tKIWmfAbA: folds 
DihMHaz4WNETH1bPDe13kA: folds 
vu2kzHaDtgr6NM7rdq0chA: folds 
bWbV4MVB/vVpiES1Ut4hew: calls $2.50
*** FLOP *** [5s Jd 4h]
bWbV4MVB/vVpiES1Ut4hew: checks 
lquriepNQBhDV5P1SWHhnA: bets $5
bWbV4MVB/vVpiES1Ut4hew: raises $12.25 to $17.25
lquriepNQBhDV5P1SWHhnA: folds 
Uncalled bet ($12.25) returned to bWbV4MVB/vVpiES1Ut4hew
bWbV4MVB/vVpiES1Ut4hew collected $16.50 from pot
bWbV4MVB/vVpiES1Ut4hew: doesn't show hand 
*** SUMMARY ***
Total pot $17.35 | Rake $0.85 
Board [5s Jd 4h]
Seat 1: DihMHaz4WNETH1bPDe13kA (small blind) folded before Flop
Seat 2: vu2kzHaDtgr6NM7rdq0chA (big blind) folded before Flop
Seat 3: bWbV4MVB/vVpiES1Ut4hew collected ($16.50)
Seat 4: 32YL2ZEp8NT4JB2RVM9euQ folded before Flop (didn't bet)
Seat 5: lquriepNQBhDV5P1SWHhnA folded on the Flop
Seat 6: jp34e617tIzV8tKIWmfAbA (button) folded before Flop (didn't bet)




PokerStars Game #59941572360:  Hold'em No Limit ($0.10/$0.25) - 2009/07/01 1:39:31 ET
Table '+2VxGVfkEqJ1AYfQy/JH2w' 6-max Seat #3 is the button
Seat 2: qllppsCmUqovlriIWCeM/g ($1.95 in chips) 
Seat 3: NndRCAk4vU5JGDhTyy5LZg ($14.65 in chips) 
Seat 4: y+a/yGW/Jy4bPJFnaeTz5w ($17.20 in chips) 
Seat 5: XD1i5m5PvBDnRzJaG/vINw ($23.15 in chips) 
y+a/yGW/Jy4bPJFnaeTz5w: posts small blind $0.10
XD1i5m5PvBDnRzJaG/vINw: posts big blind $0.25
L3/N/gliETan8N5Gim5h4Q: sits out 
if4dh6jhJXeN3/qd3qCp9g: sits out 
*** HOLE CARDS ***
qllppsCmUqovlriIWCeM/g: folds 
NndRCAk4vU5JGDhTyy5LZg: calls $0.25
y+a/yGW/Jy4bPJFnaeTz5w: calls $0.15
XD1i5m5PvBDnRzJaG/vINw: checks 
*** FLOP *** [3h Ks 9h]
y+a/yGW/Jy4bPJFnaeTz5w: checks 
XD1i5m5PvBDnRzJaG/vINw: checks 
NndRCAk4vU5JGDhTyy5LZg: bets $0.75
y+a/yGW/Jy4bPJFnaeTz5w: folds 
XD1i5m5PvBDnRzJaG/vINw: folds 
Uncalled bet ($0.75) returned to NndRCAk4vU5JGDhTyy5LZg
NndRCAk4vU5JGDhTyy5LZg collected $0.75 from pot
*** SUMMARY ***
Total pot $0.75 | Rake $0 
Board [3h Ks 9h]
Seat 2: qllppsCmUqovlriIWCeM/g folded before Flop (didn't bet)
Seat 3: NndRCAk4vU5JGDhTyy5LZg (button) collected ($0.75)
Seat 4: y+a/yGW/Jy4bPJFnaeTz5w (small blind) folded on the Flop
Seat 5: XD1i5m5PvBDnRzJaG/vINw (big blind) folded on the Flop




PokerStars Game #59941572884:  Hold'em No Limit ($0.10/$0.25) - 2009/07/01 1:39:32 ET
Table 'Yb2CyZosw7N3yRRVLhKnKg' 9-max Seat #5 is the button
Seat 1: c/9X4zftzphFxYtxp5kp9w ($23.90 in chips) 
Seat 2: dtZ84flFEi4Q+SGrHMJRDQ ($26.65 in chips) 
Seat 3: I8/fpJ2v6LsVf0kxqaVdMQ ($16.50 in chips) 
Seat 4: FG10kumpruEJ3PQJ7oGglQ ($11.35 in chips) 
Seat 5: T5Hk9oiIr+JDDMnEqwFCrw ($3.50 in chips) 
Seat 6: CgIo2ItZqi4o3ayVG6HanQ ($35.80 in chips) 
Seat 7: ljemhp25Zg+nlA9DLCIiUw ($26.25 in chips) 
Seat 8: HxDF4QSxC4z39D7teZpprQ ($11.10 in chips) 
Seat 9: 6DVf3fwEGECnjQ4Yp9AsFw ($15.85 in chips) 
CgIo2ItZqi4o3ayVG6HanQ: posts small blind $0.10
ljemhp25Zg+nlA9DLCIiUw: posts big blind $0.25
*** HOLE CARDS ***
HxDF4QSxC4z39D7teZpprQ: folds 
6DVf3fwEGECnjQ4Yp9AsFw: folds 
c/9X4zftzphFxYtxp5kp9w: calls $0.25
dtZ84flFEi4Q+SGrHMJRDQ: folds 
I8/fpJ2v6LsVf0kxqaVdMQ: folds 
FG10kumpruEJ3PQJ7oGglQ: folds 
T5Hk9oiIr+JDDMnEqwFCrw: calls $0.25
CgIo2ItZqi4o3ayVG6HanQ: calls $0.15
ljemhp25Zg+nlA9DLCIiUw: checks 
*** FLOP *** [8c Tc Ts]
CgIo2ItZqi4o3ayVG6HanQ: checks 
ljemhp25Zg+nlA9DLCIiUw: checks 
c/9X4zftzphFxYtxp5kp9w: checks 
T5Hk9oiIr+JDDMnEqwFCrw: checks 
*** TURN *** [8c Tc Ts] [Jd]
CgIo2ItZqi4o3ayVG6HanQ: checks 
ljemhp25Zg+nlA9DLCIiUw: bets $0.75
c/9X4zftzphFxYtxp5kp9w: folds 
T5Hk9oiIr+JDDMnEqwFCrw: folds 
CgIo2ItZqi4o3ayVG6HanQ: folds 
Uncalled bet ($0.75) returned to ljemhp25Zg+nlA9DLCIiUw
ljemhp25Zg+nlA9DLCIiUw collected $0.95 from pot
ljemhp25Zg+nlA9DLCIiUw: doesn't show hand 
*** SUMMARY ***
Total pot $1 | Rake $0.05 
Board [8c Tc Ts Jd]
Seat 1: c/9X4zftzphFxYtxp5kp9w folded on the Turn
Seat 2: dtZ84flFEi4Q+SGrHMJRDQ folded before Flop (didn't bet)
Seat 3: I8/fpJ2v6LsVf0kxqaVdMQ folded before Flop (didn't bet)
Seat 4: FG10kumpruEJ3PQJ7oGglQ folded before Flop (didn't bet)
Seat 5: T5Hk9oiIr+JDDMnEqwFCrw (button) folded on the Turn
Seat 6: CgIo2ItZqi4o3ayVG6HanQ (small blind) folded on the Turn
Seat 7: ljemhp25Zg+nlA9DLCIiUw (big blind) collected ($0.95)
Seat 8: HxDF4QSxC4z39D7teZpprQ folded before Flop (didn't bet)
Seat 9: 6DVf3fwEGECnjQ4Yp9AsFw folded before Flop (didn't bet)




PokerStars Game #59941572626:  Hold'em No Limit ($0.10/$0.25) - 2009/07/01 1:39:32 ET
Table 'GrYi0DZOHD1EvB+qiLExNw' 9-max Seat #7 is the button
Seat 1: sk7OEPqYdQE7GJKyQHkssg ($14.75 in chips) 
Seat 2: Th3FldXKQW6hWVVPahaoOQ ($47.05 in chips) 
Seat 3: 4oA316mXLIui1QY63GXBUg ($25 in chips) 
Seat 4: 8x95tVlB4uFBVHp71KihMA ($24.10 in chips) 
Seat 5: cZ99hugmLBj9KhTlc8nCSw ($25.30 in chips) 
Seat 6: arxNSjreDRGFg13EAM2F1w ($25.25 in chips) 
Seat 7: 9lvO/qyU+xrU95Teu1fv0g ($18.10 in chips) 
Seat 8: MtVtHDqIJTyUcXkRBBDIVA ($25 in chips) 
Seat 9: 5hAPbqNrvJb8PtLiceXtlg ($13.75 in chips) 
MtVtHDqIJTyUcXkRBBDIVA: posts small blind $0.10
5hAPbqNrvJb8PtLiceXtlg: posts big blind $0.25
*** HOLE CARDS ***
sk7OEPqYdQE7GJKyQHkssg: calls $0.25
Th3FldXKQW6hWVVPahaoOQ: folds 
4oA316mXLIui1QY63GXBUg: folds 
8x95tVlB4uFBVHp71KihMA: calls $0.25
cZ99hugmLBj9KhTlc8nCSw: folds 
arxNSjreDRGFg13EAM2F1w: folds 
9lvO/qyU+xrU95Teu1fv0g: folds 
MtVtHDqIJTyUcXkRBBDIVA: folds 
5hAPbqNrvJb8PtLiceXtlg: checks 
*** FLOP *** [8c 2c Jd]
5hAPbqNrvJb8PtLiceXtlg: checks 
sk7OEPqYdQE7GJKyQHkssg: checks 
8x95tVlB4uFBVHp71KihMA: bets $0.50
5hAPbqNrvJb8PtLiceXtlg: folds 
sk7OEPqYdQE7GJKyQHkssg: folds 
Uncalled bet ($0.50) returned to 8x95tVlB4uFBVHp71KihMA
8x95tVlB4uFBVHp71KihMA collected $0.85 from pot
*** SUMMARY ***
Total pot $0.85 | Rake $0 
Board [8c 2c Jd]
Seat 1: sk7OEPqYdQE7GJKyQHkssg folded on the Flop
Seat 2: Th3FldXKQW6hWVVPahaoOQ folded before Flop (didn't bet)
Seat 3: 4oA316mXLIui1QY63GXBUg folded before Flop (didn't bet)
Seat 4: 8x95tVlB4uFBVHp71KihMA collected ($0.85)
Seat 5: cZ99hugmLBj9KhTlc8nCSw folded before Flop (didn't bet)
Seat 6: arxNSjreDRGFg13EAM2F1w folded before Flop (didn't bet)
Seat 7: 9lvO/qyU+xrU95Teu1fv0g (button) folded before Flop (didn't bet)
Seat 8: MtVtHDqIJTyUcXkRBBDIVA (small blind) folded before Flop
Seat 9: 5hAPbqNrvJb8PtLiceXtlg (big blind) folded on the Flop




PokerStars Game #59941572492:  Hold'em No Limit ($0.10/$0.25) - 2009/07/01 1:39:32 ET
Table 'WEMI3Mtn7dGARDbgNrKibg' 9-max Seat #4 is the button
Seat 1: Th3FldXKQW6hWVVPahaoOQ ($30.50 in chips) 
Seat 2: tYsOBqdU1+x+yFI7zHO7hQ ($49.20 in chips) 
Seat 3: qwr38jl5txoR36M7G5qi4A ($7.75 in chips) 
Seat 4: Z5NNIVvnhb2IJbLcI79WYQ ($5.25 in chips) 
Seat 5: yzPZQFeaQTNf1YK3a0zRIw ($15.55 in chips) 
Seat 6: arxNSjreDRGFg13EAM2F1w ($25.70 in chips) 
Seat 7: DnDcAdn9P0zGovMERigpFA ($55.25 in chips) 
Seat 8: ghNKXUBl/H+t83JF079ZBA ($28.65 in chips) 
Seat 9: 2wcFsZsqEP5w1StUTVzJCg ($4 in chips) 
yzPZQFeaQTNf1YK3a0zRIw: posts small blind $0.10
arxNSjreDRGFg13EAM2F1w: posts big blind $0.25
*** HOLE CARDS ***
DnDcAdn9P0zGovMERigpFA: folds 
ghNKXUBl/H+t83JF079ZBA: raises $0.75 to $1
2wcFsZsqEP5w1StUTVzJCg: folds 
Th3FldXKQW6hWVVPahaoOQ: folds 
tYsOBqdU1+x+yFI7zHO7hQ: folds 
qwr38jl5txoR36M7G5qi4A: folds 
Z5NNIVvnhb2IJbLcI79WYQ: folds 
yzPZQFeaQTNf1YK3a0zRIw: folds 
arxNSjreDRGFg13EAM2F1w: folds 
Uncalled bet ($0.75) returned to ghNKXUBl/H+t83JF079ZBA
ghNKXUBl/H+t83JF079ZBA collected $0.60 from pot
ghNKXUBl/H+t83JF079ZBA: doesn't show hand 
*** SUMMARY ***
Total pot $0.60 | Rake $0 
Seat 1: Th3FldXKQW6hWVVPahaoOQ folded before Flop (didn't bet)
Seat 2: tYsOBqdU1+x+yFI7zHO7hQ folded before Flop (didn't bet)
Seat 3: qwr38jl5txoR36M7G5qi4A folded before Flop (didn't bet)
Seat 4: Z5NNIVvnhb2IJbLcI79WYQ (button) folded before Flop (didn't bet)
Seat 5: yzPZQFeaQTNf1YK3a0zRIw (small blind) folded before Flop
Seat 6: arxNSjreDRGFg13EAM2F1w (big blind) folded before Flop
Seat 7: DnDcAdn9P0zGovMERigpFA folded before Flop (didn't bet)
Seat 8: ghNKXUBl/H+t83JF079ZBA collected ($0.60)
Seat 9: 2wcFsZsqEP5w1StUTVzJCg folded before Flop (didn't bet)




PokerStars Game #59941572746:  Hold'em No Limit ($0.10/$0.25) - 2009/07/01 1:39:32 ET
Table 'P1IJQ2p3ACFySC35W1qwQw' 9-max Seat #4 is the button
Seat 1: bXpVeaSTPBFSPJmeXxO7nw ($4.65 in chips) 
Seat 2: vO3QVRovWemcGMkm7ijAIA ($5.35 in chips) 
Seat 3: PVxvfRTRvkgZf9WtquEkwQ ($25 in chips) 
Seat 4: c/9X4zftzphFxYtxp5kp9w ($28.15 in chips) 
Seat 5: ghNKXUBl/H+t83JF079ZBA ($56.55 in chips) 
Seat 6: ljemhp25Zg+nlA9DLCIiUw ($64.80 in chips) 
Seat 7: 7je+LC5Mfs6nL8YBVh4frQ ($4.65 in chips) 
Seat 8: tLcDklc2rBORNfixyRfVfw ($26.25 in chips) 
Seat 9: XXajyXkgbSGJKxQP3mal/Q ($15.40 in chips) 
ghNKXUBl/H+t83JF079ZBA: posts small blind $0.10
ljemhp25Zg+nlA9DLCIiUw: posts big blind $0.25
*** HOLE CARDS ***
7je+LC5Mfs6nL8YBVh4frQ: folds 
tLcDklc2rBORNfixyRfVfw: folds 
XXajyXkgbSGJKxQP3mal/Q: folds 
bXpVeaSTPBFSPJmeXxO7nw: folds 
vO3QVRovWemcGMkm7ijAIA: folds 
PVxvfRTRvkgZf9WtquEkwQ: raises $0.75 to $1
c/9X4zftzphFxYtxp5kp9w: folds 
ghNKXUBl/H+t83JF079ZBA: folds 
ljemhp25Zg+nlA9DLCIiUw: folds 
Uncalled bet ($0.75) returned to PVxvfRTRvkgZf9WtquEkwQ
PVxvfRTRvkgZf9WtquEkwQ collected $0.60 from pot
PVxvfRTRvkgZf9WtquEkwQ: doesn't show hand 
*** SUMMARY ***
Total pot $0.60 | Rake $0 
Seat 1: bXpVeaSTPBFSPJmeXxO7nw folded before Flop (didn't bet)
Seat 2: vO3QVRovWemcGMkm7ijAIA folded before Flop (didn't bet)
Seat 3: PVxvfRTRvkgZf9WtquEkwQ collected ($0.60)
Seat 4: c/9X4zftzphFxYtxp5kp9w (button) folded before Flop (didn't bet)
Seat 5: ghNKXUBl/H+t83JF079ZBA (small blind) folded before Flop
Seat 6: ljemhp25Zg+nlA9DLCIiUw (big blind) folded before Flop
Seat 7: 7je+LC5Mfs6nL8YBVh4frQ folded before Flop (didn't bet)
Seat 8: tLcDklc2rBORNfixyRfVfw folded before Flop (didn't bet)
Seat 9: XXajyXkgbSGJKxQP3mal/Q folded before Flop (didn't bet)




PokerStars Game #59941572624:  Hold'em No Limit ($0.10/$0.25) - 2009/07/01 1:39:32 ET
Table 'dVzscin98UhGisTmV9BDcw' 9-max Seat #1 is the button
Seat 1: sBAwXpkpgyhyWbHIQcIJKA ($17.90 in chips) 
Seat 2: dfNim92Z6XK1/h5SFW5vDg ($28.35 in chips) 
Seat 3: JKOHWhyNSj5IT6PzR/yHDg ($8.10 in chips) 
Seat 4: aNpwfA31EREwO+ar4XzBCw ($41.65 in chips) 
Seat 5: 22dIObOuor/A+IKWkNoAlA ($10.10 in chips) 
Seat 6: bXpVeaSTPBFSPJmeXxO7nw ($4.65 in chips) 
Seat 7: cKlmpQMahVsmOaxFQDcoOg ($25 in chips) 
Seat 8: /vn2Qu2dvc9AMMq46Ae0jA ($40.70 in chips) 
Seat 9: arxNSjreDRGFg13EAM2F1w ($25 in chips) 
dfNim92Z6XK1/h5SFW5vDg: posts small blind $0.10
JKOHWhyNSj5IT6PzR/yHDg: posts big blind $0.25
*** HOLE CARDS ***
aNpwfA31EREwO+ar4XzBCw: folds 
22dIObOuor/A+IKWkNoAlA: folds 
bXpVeaSTPBFSPJmeXxO7nw: folds 
cKlmpQMahVsmOaxFQDcoOg: folds 
/vn2Qu2dvc9AMMq46Ae0jA: raises $0.50 to $0.75
arxNSjreDRGFg13EAM2F1w: folds 
sBAwXpkpgyhyWbHIQcIJKA: folds 
dfNim92Z6XK1/h5SFW5vDg: folds 
JKOHWhyNSj5IT6PzR/yHDg: calls $0.50
*** FLOP *** [7s 2s 5d]
JKOHWhyNSj5IT6PzR/yHDg: bets $2
/vn2Qu2dvc9AMMq46Ae0jA: raises $4.75 to $6.75
JKOHWhyNSj5IT6PzR/yHDg: raises $0.60 to $7.35 and is all-in
/vn2Qu2dvc9AMMq46Ae0jA: calls $0.60
*** TURN *** [7s 2s 5d] [Kd]
*** RIVER *** [7s 2s 5d Kd] [5s]
*** SHOW DOWN ***
JKOHWhyNSj5IT6PzR/yHDg: shows [Tc 5h] (three of a kind, Fives)
/vn2Qu2dvc9AMMq46Ae0jA: shows [7c 5c] (a full house, Fives full of Sevens)
/vn2Qu2dvc9AMMq46Ae0jA collected $15.50 from pot
*** SUMMARY ***
Total pot $16.30 | Rake $0.80 
Board [7s 2s 5d Kd 5s]
Seat 1: sBAwXpkpgyhyWbHIQcIJKA (button) folded before Flop (didn't bet)
Seat 2: dfNim92Z6XK1/h5SFW5vDg (small blind) folded before Flop
Seat 3: JKOHWhyNSj5IT6PzR/yHDg (big blind) showed [Tc 5h] and lost with three of a kind, Fives
Seat 4: aNpwfA31EREwO+ar4XzBCw folded before Flop (didn't bet)
Seat 5: 22dIObOuor/A+IKWkNoAlA folded before Flop (didn't bet)
Seat 6: bXpVeaSTPBFSPJmeXxO7nw folded before Flop (didn't bet)
Seat 7: cKlmpQMahVsmOaxFQDcoOg folded before Flop (didn't bet)
Seat 8: /vn2Qu2dvc9AMMq46Ae0jA showed [7c 5c] and won ($15.50) with a full house, Fives full of Sevens
Seat 9: arxNSjreDRGFg13EAM2F1w folded before Flop (didn't bet)




PokerStars Game #59941572476:  Hold'em No Limit ($0.10/$0.25) - 2009/07/01 1:39:32 ET
Table 'g+mPuNJBCHKE9ents7ZGtg' 6-max Seat #5 is the button
Seat 1: cezpHJ8FB07dj0xG+LhOvw ($59.80 in chips) 
Seat 2: fZQg9veL7Dd/Z04ZTjC+wQ ($66.05 in chips) 
Seat 3: FYepjhAvF8ZdVCmqHIy+eQ ($25.60 in chips) 
Seat 4: yVrjRIW0SMxgpvqSIPSe/w ($12.10 in chips) 
Seat 5: D3ikCR8c/o9jB5irZ3uGlw ($14.15 in chips) 
Seat 6: Mn2V28t5aGq2d09z+/o6Fw ($7.70 in chips) 
Mn2V28t5aGq2d09z+/o6Fw: posts small blind $0.10
cezpHJ8FB07dj0xG+LhOvw: posts big blind $0.25
*** HOLE CARDS ***
fZQg9veL7Dd/Z04ZTjC+wQ: folds 
FYepjhAvF8ZdVCmqHIy+eQ: folds 
yVrjRIW0SMxgpvqSIPSe/w: raises $0.50 to $0.75
D3ikCR8c/o9jB5irZ3uGlw: folds 
Mn2V28t5aGq2d09z+/o6Fw: calls $0.65
cezpHJ8FB07dj0xG+LhOvw: folds 
*** FLOP *** [2d 3h 8c]
Mn2V28t5aGq2d09z+/o6Fw: checks 
yVrjRIW0SMxgpvqSIPSe/w: bets $1
Mn2V28t5aGq2d09z+/o6Fw: calls $1
*** TURN *** [2d 3h 8c] [9d]
Mn2V28t5aGq2d09z+/o6Fw: checks 
yVrjRIW0SMxgpvqSIPSe/w: bets $10.35 and is all-in
Mn2V28t5aGq2d09z+/o6Fw: folds 
Uncalled bet ($10.35) returned to yVrjRIW0SMxgpvqSIPSe/w
yVrjRIW0SMxgpvqSIPSe/w collected $3.60 from pot
*** SUMMARY ***
Total pot $3.75 | Rake $0.15 
Board [2d 3h 8c 9d]
Seat 1: cezpHJ8FB07dj0xG+LhOvw (big blind) folded before Flop
Seat 2: fZQg9veL7Dd/Z04ZTjC+wQ folded before Flop (didn't bet)
Seat 3: FYepjhAvF8ZdVCmqHIy+eQ folded before Flop (didn't bet)
Seat 4: yVrjRIW0SMxgpvqSIPSe/w collected ($3.60)
Seat 5: D3ikCR8c/o9jB5irZ3uGlw (button) folded before Flop (didn't bet)
Seat 6: Mn2V28t5aGq2d09z+/o6Fw (small blind) folded on the Turn




PokerStars Game #59941572724:  Hold'em No Limit ($0.10/$0.25) - 2009/07/01 1:39:32 ET
Table 'oJpFwZj9+FUGHX90Un8s9Q' 6-max Seat #6 is the button
Seat 1: 6DwBRH+xZ12AAZmeAg+aXw ($22.20 in chips) 
Seat 2: NtrVQ9UIql0rDCnKDKZ5FQ ($8.25 in chips) 
Seat 3: kyRaCIljYA6l33lSKQfNsg ($25 in chips) 
Seat 4: 6elpmfyt4Zw0yvd8lePSMQ ($23.40 in chips) 
Seat 5: kG34n23qFQA3nzdOJTQ1dA ($56.45 in chips) 
Seat 6: edio/rLJ06xeZOfLhoL3UA ($9 in chips) 
6DwBRH+xZ12AAZmeAg+aXw: posts small blind $0.10
NtrVQ9UIql0rDCnKDKZ5FQ: posts big blind $0.25
*** HOLE CARDS ***
kyRaCIljYA6l33lSKQfNsg: folds 
6elpmfyt4Zw0yvd8lePSMQ: calls $0.25
kG34n23qFQA3nzdOJTQ1dA: folds 
edio/rLJ06xeZOfLhoL3UA: folds 
6DwBRH+xZ12AAZmeAg+aXw: raises $0.75 to $1
NtrVQ9UIql0rDCnKDKZ5FQ: calls $0.75
6elpmfyt4Zw0yvd8lePSMQ: folds 
*** FLOP *** [7s Js 8c]
6DwBRH+xZ12AAZmeAg+aXw: bets $1.50
NtrVQ9UIql0rDCnKDKZ5FQ: calls $1.50
*** TURN *** [7s Js 8c] [4s]
6DwBRH+xZ12AAZmeAg+aXw: checks 
NtrVQ9UIql0rDCnKDKZ5FQ: checks 
*** RIVER *** [7s Js 8c 4s] [4h]
6DwBRH+xZ12AAZmeAg+aXw: checks 
NtrVQ9UIql0rDCnKDKZ5FQ: checks 
*** SHOW DOWN ***
6DwBRH+xZ12AAZmeAg+aXw: shows [Ac Kh] (a pair of Fours)
NtrVQ9UIql0rDCnKDKZ5FQ: mucks hand 
6DwBRH+xZ12AAZmeAg+aXw collected $5 from pot
*** SUMMARY ***
Total pot $5.25 | Rake $0.25 
Board [7s Js 8c 4s 4h]
Seat 1: 6DwBRH+xZ12AAZmeAg+aXw (small blind) showed [Ac Kh] and won ($5) with a pair of Fours
Seat 2: NtrVQ9UIql0rDCnKDKZ5FQ (big blind) mucked
Seat 3: kyRaCIljYA6l33lSKQfNsg folded before Flop (didn't bet)
Seat 4: 6elpmfyt4Zw0yvd8lePSMQ folded before Flop
Seat 5: kG34n23qFQA3nzdOJTQ1dA folded before Flop (didn't bet)
Seat 6: edio/rLJ06xeZOfLhoL3UA (button) folded before Flop (didn't bet)




PokerStars Game #59941572426:  Hold'em No Limit ($0.10/$0.25) - 2009/07/01 1:39:32 ET
Table 'qryc9C/ELyQ3lubOaELNAQ' 6-max Seat #5 is the button
Seat 1: OZc6kkoTwtITj1ZfreJK1A ($64.80 in chips) 
Seat 2: LtASJ9OlkqGrrUKGQlpGAw ($30.65 in chips) 
Seat 3: 2Ga+TibtZsUCp1MLaueYVA ($25.55 in chips) 
Seat 4: v+QfkGiuj9bgtuNoVnDO8w ($26.40 in chips) 
Seat 5: 9StOHp+Y1T0K13JdgS2oQQ ($32.50 in chips) 
Seat 6: u+J1MTXS2qhNVMbsBemNLg ($4.15 in chips) 
u+J1MTXS2qhNVMbsBemNLg: posts small blind $0.10
OZc6kkoTwtITj1ZfreJK1A: posts big blind $0.25
*** HOLE CARDS ***
LtASJ9OlkqGrrUKGQlpGAw: folds 
2Ga+TibtZsUCp1MLaueYVA: folds 
v+QfkGiuj9bgtuNoVnDO8w: raises $0.75 to $1
9StOHp+Y1T0K13JdgS2oQQ: folds 
u+J1MTXS2qhNVMbsBemNLg: folds 
OZc6kkoTwtITj1ZfreJK1A: calls $0.75
*** FLOP *** [7s Th 5h]
OZc6kkoTwtITj1ZfreJK1A: checks 
v+QfkGiuj9bgtuNoVnDO8w: checks 
*** TURN *** [7s Th 5h] [Jd]
OZc6kkoTwtITj1ZfreJK1A: checks 
v+QfkGiuj9bgtuNoVnDO8w: checks 
*** RIVER *** [7s Th 5h Jd] [6s]
OZc6kkoTwtITj1ZfreJK1A: checks 
v+QfkGiuj9bgtuNoVnDO8w: checks 
*** SHOW DOWN ***
OZc6kkoTwtITj1ZfreJK1A: shows [9h 5c] (a pair of Fives)
v+QfkGiuj9bgtuNoVnDO8w: mucks hand 
OZc6kkoTwtITj1ZfreJK1A collected $2 from pot
*** SUMMARY ***
Total pot $2.10 | Rake $0.10 
Board [7s Th 5h Jd 6s]
Seat 1: OZc6kkoTwtITj1ZfreJK1A (big blind) showed [9h 5c] and won ($2) with a pair of Fives
Seat 2: LtASJ9OlkqGrrUKGQlpGAw folded before Flop (didn't bet)
Seat 3: 2Ga+TibtZsUCp1MLaueYVA folded before Flop (didn't bet)
Seat 4: v+QfkGiuj9bgtuNoVnDO8w mucked
Seat 5: 9StOHp+Y1T0K13JdgS2oQQ (button) folded before Flop (didn't bet)
Seat 6: u+J1MTXS2qhNVMbsBemNLg (small blind) folded before Flop




PokerStars Game #59941572756:  Hold'em No Limit ($0.10/$0.25) - 2009/07/01 1:39:32 ET
Table 'rpIHGyt2QpgQc5bvptAvDQ' 9-max Seat #6 is the button
Seat 3: OzXv12vW3/jO5rPU5mJHQg ($5.35 in chips) 
Seat 5: z2SmIaQ3+5n/eY1BN5HgPg ($15 in chips) 
Seat 6: Mq1ESwxx3LEsA4HjKKjU3Q ($15.75 in chips) 
OzXv12vW3/jO5rPU5mJHQg: posts small blind $0.10
6OWBjDlgUYW33/gXaOLrMQ leaves the table
z2SmIaQ3+5n/eY1BN5HgPg: posts big blind $0.25
*** HOLE CARDS ***
Mq1ESwxx3LEsA4HjKKjU3Q: folds 
OzXv12vW3/jO5rPU5mJHQg: calls $0.15
z2SmIaQ3+5n/eY1BN5HgPg: checks 
*** FLOP *** [4d 6c 5c]
OzXv12vW3/jO5rPU5mJHQg: checks 
z2SmIaQ3+5n/eY1BN5HgPg: bets $0.50
OzXv12vW3/jO5rPU5mJHQg: folds 
Uncalled bet ($0.50) returned to z2SmIaQ3+5n/eY1BN5HgPg
z2SmIaQ3+5n/eY1BN5HgPg collected $0.50 from pot
z2SmIaQ3+5n/eY1BN5HgPg: doesn't show hand 
*** SUMMARY ***
Total pot $0.50 | Rake $0 
Board [4d 6c 5c]
Seat 3: OzXv12vW3/jO5rPU5mJHQg (small blind) folded on the Flop
Seat 5: z2SmIaQ3+5n/eY1BN5HgPg (big blind) collected ($0.50)
Seat 6: Mq1ESwxx3LEsA4HjKKjU3Q (button) folded before Flop (didn't bet)




PokerStars Game #59941573028:  Hold'em No Limit ($0.10/$0.25) - 2009/07/01 1:39:33 ET
Table 'O6cwjhrMn9pfzx1Ngn5zkQ' 6-max Seat #3 is the button
Seat 1: LJI7A1YgDM7hgh7o56+ReQ ($28.30 in chips) 
Seat 2: tSR4329m40dZsN7YOpI9Kw ($29.70 in chips) 
Seat 3: EE16Ua5b1HSsYej5zeXOlA ($25.80 in chips) 
Seat 4: mfrkWA3PTeYPkbO6hi98Aw ($24.40 in chips) 
Seat 5: niLn0xUVlqh8If80xRjzCA ($26.70 in chips) 
Seat 6: 4TM16KVgEiQpLi4bVVWbVQ ($33.05 in chips) 
mfrkWA3PTeYPkbO6hi98Aw: posts small blind $0.10
niLn0xUVlqh8If80xRjzCA: posts big blind $0.25
*** HOLE CARDS ***
4TM16KVgEiQpLi4bVVWbVQ: raises $0.50 to $0.75
LJI7A1YgDM7hgh7o56+ReQ: folds 
tSR4329m40dZsN7YOpI9Kw: folds 
EE16Ua5b1HSsYej5zeXOlA: folds 
mfrkWA3PTeYPkbO6hi98Aw: folds 
niLn0xUVlqh8If80xRjzCA: folds 
Uncalled bet ($0.50) returned to 4TM16KVgEiQpLi4bVVWbVQ
4TM16KVgEiQpLi4bVVWbVQ collected $0.60 from pot
*** SUMMARY ***
Total pot $0.60 | Rake $0 
Seat 1: LJI7A1YgDM7hgh7o56+ReQ folded before Flop (didn't bet)
Seat 2: tSR4329m40dZsN7YOpI9Kw folded before Flop (didn't bet)
Seat 3: EE16Ua5b1HSsYej5zeXOlA (button) folded before Flop (didn't bet)
Seat 4: mfrkWA3PTeYPkbO6hi98Aw (small blind) folded before Flop
Seat 5: niLn0xUVlqh8If80xRjzCA (big blind) folded before Flop
Seat 6: 4TM16KVgEiQpLi4bVVWbVQ collected ($0.60)




PokerStars Game #59941573448:  Hold'em No Limit ($0.10/$0.25) - 2009/07/01 1:39:33 ET
Table '6wawJ+MkkvuC3coG6r+Yhg' 6-max Seat #1 is the button
Seat 1: JQZew0FjzS19kTjeNtrE+A ($25 in chips) 
Seat 2: LtASJ9OlkqGrrUKGQlpGAw ($33.70 in chips) 
Seat 3: 3zD3qLXT1bEffAoWGnc7wg ($60.70 in chips) 
Seat 4: yxmjNFGiKI3b+XQGJzJVIg ($29.05 in chips) 
Seat 5: FZrgDbxAanC1xwZxXHJKVA ($3.10 in chips) 
Seat 6: B3X187C0tXFUfQpCu8pe8A ($28.35 in chips) 
LtASJ9OlkqGrrUKGQlpGAw: posts small blind $0.10
3zD3qLXT1bEffAoWGnc7wg: posts big blind $0.25
*** HOLE CARDS ***
yxmjNFGiKI3b+XQGJzJVIg: raises $0.50 to $0.75
FZrgDbxAanC1xwZxXHJKVA: folds 
B3X187C0tXFUfQpCu8pe8A: folds 
JQZew0FjzS19kTjeNtrE+A: calls $0.75
LtASJ9OlkqGrrUKGQlpGAw: folds 
3zD3qLXT1bEffAoWGnc7wg: calls $0.50
*** FLOP *** [8c Td As]
3zD3qLXT1bEffAoWGnc7wg: checks 
yxmjNFGiKI3b+XQGJzJVIg: checks 
JQZew0FjzS19kTjeNtrE+A: bets $1
3zD3qLXT1bEffAoWGnc7wg: folds 
yxmjNFGiKI3b+XQGJzJVIg: folds 
Uncalled bet ($1) returned to JQZew0FjzS19kTjeNtrE+A
JQZew0FjzS19kTjeNtrE+A collected $2.25 from pot
*** SUMMARY ***
Total pot $2.35 | Rake $0.10 
Board [8c Td As]
Seat 1: JQZew0FjzS19kTjeNtrE+A (button) collected ($2.25)
Seat 2: LtASJ9OlkqGrrUKGQlpGAw (small blind) folded before Flop
Seat 3: 3zD3qLXT1bEffAoWGnc7wg (big blind) folded on the Flop
Seat 4: yxmjNFGiKI3b+XQGJzJVIg folded on the Flop
Seat 5: FZrgDbxAanC1xwZxXHJKVA folded before Flop (didn't bet)
Seat 6: B3X187C0tXFUfQpCu8pe8A folded before Flop (didn't bet)




PokerStars Game #59941573124:  Hold'em No Limit ($0.10/$0.25) - 2009/07/01 1:39:33 ET
Table 'ykyWGjhNu7AvZXov27T4ew' 9-max Seat #7 is the button
Seat 1: W8cIfrCR+zA8pCNyIuHu8g ($14.10 in chips) 
Seat 2: MG90wfSJZnOejs/KD3vlQQ ($40.10 in chips) 
Seat 3: NPI9ArW8kwrb6a2IAL6xMQ ($14.40 in chips) 
Seat 4: W6tExOcYX7qiy6Qdp+ZwFA ($4.90 in chips) 
Seat 5: CmngQmkKTp8tkl6GMRTl6w ($8.50 in chips) 
Seat 6: AiXn/9o1EwOPZUHujnh/bA ($20.40 in chips) 
Seat 7: npAYqa85pqnzfOK5ukX+BQ ($20.65 in chips) 
Seat 8: tYsOBqdU1+x+yFI7zHO7hQ ($49.45 in chips) 
Seat 9: wk9M6R3w+aDHpr8WV87RmQ ($11.60 in chips) 
tYsOBqdU1+x+yFI7zHO7hQ: posts small blind $0.10
wk9M6R3w+aDHpr8WV87RmQ: posts big blind $0.25
*** HOLE CARDS ***
W8cIfrCR+zA8pCNyIuHu8g: raises $0.75 to $1
MG90wfSJZnOejs/KD3vlQQ: folds 
NPI9ArW8kwrb6a2IAL6xMQ: raises $0.75 to $1.75
W6tExOcYX7qiy6Qdp+ZwFA: folds 
CmngQmkKTp8tkl6GMRTl6w: folds 
AiXn/9o1EwOPZUHujnh/bA: folds 
npAYqa85pqnzfOK5ukX+BQ: folds 
tYsOBqdU1+x+yFI7zHO7hQ: folds 
wk9M6R3w+aDHpr8WV87RmQ: folds 
W8cIfrCR+zA8pCNyIuHu8g: calls $0.75
*** FLOP *** [Tc 6c Ts]
W8cIfrCR+zA8pCNyIuHu8g: bets $2.50
NPI9ArW8kwrb6a2IAL6xMQ: calls $2.50
*** TURN *** [Tc 6c Ts] [9h]
W8cIfrCR+zA8pCNyIuHu8g: bets $2.25
NPI9ArW8kwrb6a2IAL6xMQ: raises $2.25 to $4.50
W8cIfrCR+zA8pCNyIuHu8g: raises $5.35 to $9.85 and is all-in
NPI9ArW8kwrb6a2IAL6xMQ: calls $5.35
*** RIVER *** [Tc 6c Ts 9h] [3h]
*** SHOW DOWN ***
W8cIfrCR+zA8pCNyIuHu8g: shows [Js Jd] (two pair, Jacks and Tens)
NPI9ArW8kwrb6a2IAL6xMQ: shows [9d 9s] (a full house, Nines full of Tens)
NPI9ArW8kwrb6a2IAL6xMQ collected $27.15 from pot
*** SUMMARY ***
Total pot $28.55 | Rake $1.40 
Board [Tc 6c Ts 9h 3h]
Seat 1: W8cIfrCR+zA8pCNyIuHu8g showed [Js Jd] and lost with two pair, Jacks and Tens
Seat 2: MG90wfSJZnOejs/KD3vlQQ folded before Flop (didn't bet)
Seat 3: NPI9ArW8kwrb6a2IAL6xMQ showed [9d 9s] and won ($27.15) with a full house, Nines full of Tens
Seat 4: W6tExOcYX7qiy6Qdp+ZwFA folded before Flop (didn't bet)
Seat 5: CmngQmkKTp8tkl6GMRTl6w folded before Flop (didn't bet)
Seat 6: AiXn/9o1EwOPZUHujnh/bA folded before Flop (didn't bet)
Seat 7: npAYqa85pqnzfOK5ukX+BQ (button) folded before Flop (didn't bet)
Seat 8: tYsOBqdU1+x+yFI7zHO7hQ (small blind) folded before Flop
Seat 9: wk9M6R3w+aDHpr8WV87RmQ (big blind) folded before Flop




PokerStars Game #59941573444:  Hold'em No Limit ($0.10/$0.25) - 2009/07/01 1:39:33 ET
Table 'KKk6y4pAXeymxYcd0uZLqg' 9-max Seat #4 is the button
Seat 1: HPEB+AtKw1+C/cxU0o1ciw ($24.90 in chips) 
Seat 2: k55YB7uP2TAZEba6pnHYiA ($20.45 in chips) 
Seat 4: YciNm3fUXAQaJeXG1rhrbw ($15.20 in chips) 
Seat 5: wGigCmBR/9XWkPpvYos3aQ ($32.40 in chips) 
Seat 6: QEbIGci+itdw+re8RM5fZA ($25 in chips) 
Seat 7: R3KkgiqTvuhazyCqaD9cZg ($11.30 in chips) 
Seat 8: +2kMBNpY4nF1qNCRd8SJLA ($33.60 in chips) 
Seat 9: oLa/tXLfSLLB28mcLGrxcg ($25 in chips) 
wGigCmBR/9XWkPpvYos3aQ: posts small blind $0.10
QEbIGci+itdw+re8RM5fZA: posts big blind $0.25
tLcDklc2rBORNfixyRfVfw: sits out 
*** HOLE CARDS ***
R3KkgiqTvuhazyCqaD9cZg: folds 
+2kMBNpY4nF1qNCRd8SJLA: folds 
R3KkgiqTvuhazyCqaD9cZg leaves the table
oLa/tXLfSLLB28mcLGrxcg: folds 
JjOuv8Vf56aiQjWi/rTPFA joins the table at seat #7 
HPEB+AtKw1+C/cxU0o1ciw: folds 
k55YB7uP2TAZEba6pnHYiA: folds 
YciNm3fUXAQaJeXG1rhrbw: raises $0.50 to $0.75
wGigCmBR/9XWkPpvYos3aQ: folds 
QEbIGci+itdw+re8RM5fZA: folds 
Uncalled bet ($0.50) returned to YciNm3fUXAQaJeXG1rhrbw
YciNm3fUXAQaJeXG1rhrbw collected $0.60 from pot
YciNm3fUXAQaJeXG1rhrbw: doesn't show hand 
*** SUMMARY ***
Total pot $0.60 | Rake $0 
Seat 1: HPEB+AtKw1+C/cxU0o1ciw folded before Flop (didn't bet)
Seat 2: k55YB7uP2TAZEba6pnHYiA folded before Flop (didn't bet)
Seat 4: YciNm3fUXAQaJeXG1rhrbw (button) collected ($0.60)
Seat 5: wGigCmBR/9XWkPpvYos3aQ (small blind) folded before Flop
Seat 6: QEbIGci+itdw+re8RM5fZA (big blind) folded before Flop
Seat 7: R3KkgiqTvuhazyCqaD9cZg folded before Flop (didn't bet)
Seat 8: +2kMBNpY4nF1qNCRd8SJLA folded before Flop (didn't bet)
Seat 9: oLa/tXLfSLLB28mcLGrxcg folded before Flop (didn't bet)




PokerStars Game #59941573268:  Hold'em No Limit ($0.10/$0.25) - 2009/07/01 1:39:33 ET
Table 'o0CDOvKO/bn1WjeymDrXfA' 6-max Seat #3 is the button
Seat 2: uAJL+E2git8iAiFyAvVOnw ($16.75 in chips) 
Seat 3: OtVWmpxX2/9L8bb1GSKTuA ($18.75 in chips) 
Seat 5: dOIoLBxmpLHSXBN9LZnf0Q ($28.85 in chips) 
Seat 6: SS/yfeArhULzIcOPe8MdPg ($25 in chips) 
L3/N/gliETan8N5Gim5h4Q will be allowed to play after the button
dOIoLBxmpLHSXBN9LZnf0Q: posts small blind $0.10
SS/yfeArhULzIcOPe8MdPg: posts big blind $0.25
if4dh6jhJXeN3/qd3qCp9g: sits out 
*** HOLE CARDS ***
uAJL+E2git8iAiFyAvVOnw: calls $0.25
OtVWmpxX2/9L8bb1GSKTuA: raises $0.50 to $0.75
dOIoLBxmpLHSXBN9LZnf0Q: calls $0.65
SS/yfeArhULzIcOPe8MdPg: calls $0.50
uAJL+E2git8iAiFyAvVOnw: calls $0.50
*** FLOP *** [7s Tc 7c]
dOIoLBxmpLHSXBN9LZnf0Q: checks 
SS/yfeArhULzIcOPe8MdPg: checks 
uAJL+E2git8iAiFyAvVOnw: bets $2
OtVWmpxX2/9L8bb1GSKTuA: folds 
dOIoLBxmpLHSXBN9LZnf0Q: folds 
SS/yfeArhULzIcOPe8MdPg: folds 
Uncalled bet ($2) returned to uAJL+E2git8iAiFyAvVOnw
uAJL+E2git8iAiFyAvVOnw collected $2.85 from pot
*** SUMMARY ***
Total pot $3 | Rake $0.15 
Board [7s Tc 7c]
Seat 2: uAJL+E2git8iAiFyAvVOnw collected ($2.85)
Seat 3: OtVWmpxX2/9L8bb1GSKTuA (button) folded on the Flop
Seat 5: dOIoLBxmpLHSXBN9LZnf0Q (small blind) folded on the Flop
Seat 6: SS/yfeArhULzIcOPe8MdPg (big blind) folded on the Flop




PokerStars Game #59941573816:  Hold'em No Limit ($0.10/$0.25) - 2009/07/01 1:39:34 ET
Table 'P2yJ+jwfNsBdF12fLKA6DQ' 9-max Seat #9 is the button
Seat 1: zDrucyjVn5aeekNEc3cJrA ($22.45 in chips) 
Seat 2: uQwmfH5LEVA5eyghJdyPUg ($12.90 in chips) 
Seat 4: 6NLAWFPZZfqlVkY8n9RULA ($11.90 in chips) 
Seat 5: B7VAFAMs/PYlYABlV+EkSA ($19.75 in chips) 
Seat 6: mUoFJKqCzIUABvOFbiINlQ ($9.20 in chips) 
Seat 7: yQc5nLaNmByxI15Jegu61w ($9 in chips) 
Seat 8: LMd3gq2uNfbWTfXTnSeQRw ($10.15 in chips) 
Seat 9: dN5zq7QdZCUe7NZFM6cECg ($21.25 in chips) 
zDrucyjVn5aeekNEc3cJrA: posts small blind $0.10
uQwmfH5LEVA5eyghJdyPUg: posts big blind $0.25
8EbrQ/EvFWt2cr0GaU82gQ: sits out 
*** HOLE CARDS ***
6NLAWFPZZfqlVkY8n9RULA: folds 
B7VAFAMs/PYlYABlV+EkSA said, "u know where is geneve ?"
B7VAFAMs/PYlYABlV+EkSA: calls $0.25
mUoFJKqCzIUABvOFbiINlQ: raises $0.25 to $0.50
yQc5nLaNmByxI15Jegu61w: folds 
LMd3gq2uNfbWTfXTnSeQRw: folds 
dN5zq7QdZCUe7NZFM6cECg said, "i pinky's space from the butt"
dN5zq7QdZCUe7NZFM6cECg: calls $0.50
zDrucyjVn5aeekNEc3cJrA: folds 
zDrucyjVn5aeekNEc3cJrA is sitting out
uQwmfH5LEVA5eyghJdyPUg: calls $0.25
B7VAFAMs/PYlYABlV+EkSA: calls $0.25
*** FLOP *** [4h Qh 7h]
uQwmfH5LEVA5eyghJdyPUg: checks 
B7VAFAMs/PYlYABlV+EkSA: checks 
mUoFJKqCzIUABvOFbiINlQ: checks 
dN5zq7QdZCUe7NZFM6cECg: bets $1
uQwmfH5LEVA5eyghJdyPUg: folds 
B7VAFAMs/PYlYABlV+EkSA: calls $1
mUoFJKqCzIUABvOFbiINlQ: calls $1
*** TURN *** [4h Qh 7h] [3s]
B7VAFAMs/PYlYABlV+EkSA: checks 
mUoFJKqCzIUABvOFbiINlQ: checks 
dN5zq7QdZCUe7NZFM6cECg: checks 
*** RIVER *** [4h Qh 7h 3s] [9h]
B7VAFAMs/PYlYABlV+EkSA: bets $0.75
mUoFJKqCzIUABvOFbiINlQ: raises $2.50 to $3.25
dN5zq7QdZCUe7NZFM6cECg: folds 
B7VAFAMs/PYlYABlV+EkSA: folds 
Uncalled bet ($2.50) returned to mUoFJKqCzIUABvOFbiINlQ
mUoFJKqCzIUABvOFbiINlQ collected $6.30 from pot
mUoFJKqCzIUABvOFbiINlQ: doesn't show hand 
dN5zq7QdZCUe7NZFM6cECg said, "wait, that's the chode"
*** SUMMARY ***
Total pot $6.60 | Rake $0.30 
Board [4h Qh 7h 3s 9h]
Seat 1: zDrucyjVn5aeekNEc3cJrA (small blind) folded before Flop
Seat 2: uQwmfH5LEVA5eyghJdyPUg (big blind) folded on the Flop
Seat 4: 6NLAWFPZZfqlVkY8n9RULA folded before Flop (didn't bet)
Seat 5: B7VAFAMs/PYlYABlV+EkSA folded on the River
Seat 6: mUoFJKqCzIUABvOFbiINlQ collected ($6.30)
Seat 7: yQc5nLaNmByxI15Jegu61w folded before Flop (didn't bet)
Seat 8: LMd3gq2uNfbWTfXTnSeQRw folded before Flop (didn't bet)
Seat 9: dN5zq7QdZCUe7NZFM6cECg (button) folded on the River




PokerStars Game #59941573906:  Hold'em No Limit ($0.10/$0.25) - 2009/07/01 1:39:34 ET
Table '+198VWQSWBhYQOcizzuBkw' 6-max Seat #3 is the button
Seat 1: km+BMHGYsf4bBkGpoEQhFg ($25.25 in chips) 
Seat 2: mFv3iBCtrw9XfCDRB0d46Q ($9.85 in chips) 
Seat 3: vw7gefupgmOJJN8lUemdWg ($24.40 in chips) 
Seat 4: TgDsTeCdLQt8kWbL00ByRA ($16.70 in chips) 
Seat 5: LtASJ9OlkqGrrUKGQlpGAw ($26.60 in chips) 
Seat 6: leEQ84f6wJYu5SB/vj27wg ($11.55 in chips) 
TgDsTeCdLQt8kWbL00ByRA: posts small blind $0.10
LtASJ9OlkqGrrUKGQlpGAw: posts big blind $0.25
*** HOLE CARDS ***
leEQ84f6wJYu5SB/vj27wg: folds 
km+BMHGYsf4bBkGpoEQhFg: folds 
km+BMHGYsf4bBkGpoEQhFg leaves the table
mFv3iBCtrw9XfCDRB0d46Q: folds 
vw7gefupgmOJJN8lUemdWg: folds 
TgDsTeCdLQt8kWbL00ByRA: folds 
Uncalled bet ($0.15) returned to LtASJ9OlkqGrrUKGQlpGAw
LtASJ9OlkqGrrUKGQlpGAw collected $0.20 from pot
LtASJ9OlkqGrrUKGQlpGAw: doesn't show hand 
*** SUMMARY ***
Total pot $0.20 | Rake $0 
Seat 1: km+BMHGYsf4bBkGpoEQhFg folded before Flop (didn't bet)
Seat 2: mFv3iBCtrw9XfCDRB0d46Q folded before Flop (didn't bet)
Seat 3: vw7gefupgmOJJN8lUemdWg (button) folded before Flop (didn't bet)
Seat 4: TgDsTeCdLQt8kWbL00ByRA (small blind) folded before Flop
Seat 5: LtASJ9OlkqGrrUKGQlpGAw (big blind) collected ($0.20)
Seat 6: leEQ84f6wJYu5SB/vj27wg folded before Flop (didn't bet)




PokerStars Game #59941573632:  Hold'em No Limit ($0.10/$0.25) - 2009/07/01 1:39:34 ET
Table 'tq5CvS0RUqGkuBK0XTzqqg' 6-max Seat #4 is the button
Seat 1: +ZlnqPoP3Hg4BIUxDfKd/A ($31.55 in chips) 
Seat 2: 2m6ZFAdj01UZd4WtEySXXQ ($6.10 in chips) 
Seat 3: PbMzPZIePKifKQZfKDkbIw ($49.50 in chips) 
Seat 4: UT5XpwOH1ipkOF7n1MqDJA ($11.50 in chips) 
Seat 5: qGHGf/553gQnDoklMRe3tg ($29.80 in chips) 
Seat 6: L3/N/gliETan8N5Gim5h4Q ($25 in chips) 
qGHGf/553gQnDoklMRe3tg: posts small blind $0.10
L3/N/gliETan8N5Gim5h4Q: posts big blind $0.25
*** HOLE CARDS ***
+ZlnqPoP3Hg4BIUxDfKd/A: folds 
2m6ZFAdj01UZd4WtEySXXQ: raises $0.50 to $0.75
PbMzPZIePKifKQZfKDkbIw: folds 
UT5XpwOH1ipkOF7n1MqDJA: calls $0.75
qGHGf/553gQnDoklMRe3tg: folds 
L3/N/gliETan8N5Gim5h4Q: folds 
*** FLOP *** [Ac 3c Kc]
2m6ZFAdj01UZd4WtEySXXQ: bets $1
UT5XpwOH1ipkOF7n1MqDJA: folds 
Uncalled bet ($1) returned to 2m6ZFAdj01UZd4WtEySXXQ
2m6ZFAdj01UZd4WtEySXXQ collected $1.80 from pot
2m6ZFAdj01UZd4WtEySXXQ: doesn't show hand 
*** SUMMARY ***
Total pot $1.85 | Rake $0.05 
Board [Ac 3c Kc]
Seat 1: +ZlnqPoP3Hg4BIUxDfKd/A folded before Flop (didn't bet)
Seat 2: 2m6ZFAdj01UZd4WtEySXXQ collected ($1.80)
Seat 3: PbMzPZIePKifKQZfKDkbIw folded before Flop (didn't bet)
Seat 4: UT5XpwOH1ipkOF7n1MqDJA (button) folded on the Flop
Seat 5: qGHGf/553gQnDoklMRe3tg (small blind) folded before Flop
Seat 6: L3/N/gliETan8N5Gim5h4Q (big blind) folded before Flop




PokerStars Game #59941574548:  Hold'em No Limit ($0.10/$0.25) - 2009/07/01 1:39:35 ET
Table 'ukli1Y7ieC5JQMTEFxM2Nw' 6-max Seat #5 is the button
Seat 1: N162H80ZIQevUf2EzGahCA ($10.70 in chips) 
Seat 2: u/yN5P9f3KlATg6WLWNkBQ ($43.40 in chips) 
Seat 3: ExeoJ1G/rSmWa3tRz7TlCA ($22.45 in chips) 
Seat 4: if4dh6jhJXeN3/qd3qCp9g ($29.85 in chips) 
Seat 5: Se+H4Z4PDr6+eIUDJX1rpg ($14 in chips) 
Seat 6: 32YL2ZEp8NT4JB2RVM9euQ ($29.65 in chips) 
32YL2ZEp8NT4JB2RVM9euQ: posts small blind $0.10
N162H80ZIQevUf2EzGahCA: posts big blind $0.25
*** HOLE CARDS ***
u/yN5P9f3KlATg6WLWNkBQ: folds 
ExeoJ1G/rSmWa3tRz7TlCA: raises $0.75 to $1
if4dh6jhJXeN3/qd3qCp9g: folds 
Se+H4Z4PDr6+eIUDJX1rpg: calls $1
32YL2ZEp8NT4JB2RVM9euQ: folds 
N162H80ZIQevUf2EzGahCA: calls $0.75
*** FLOP *** [Jc 6d 2s]
N162H80ZIQevUf2EzGahCA: checks 
ExeoJ1G/rSmWa3tRz7TlCA: checks 
Se+H4Z4PDr6+eIUDJX1rpg: bets $2.50
N162H80ZIQevUf2EzGahCA: folds 
ExeoJ1G/rSmWa3tRz7TlCA: folds 
Uncalled bet ($2.50) returned to Se+H4Z4PDr6+eIUDJX1rpg
Se+H4Z4PDr6+eIUDJX1rpg collected $2.95 from pot
*** SUMMARY ***
Total pot $3.10 | Rake $0.15 
Board [Jc 6d 2s]
Seat 1: N162H80ZIQevUf2EzGahCA (big blind) folded on the Flop
Seat 2: u/yN5P9f3KlATg6WLWNkBQ folded before Flop (didn't bet)
Seat 3: ExeoJ1G/rSmWa3tRz7TlCA folded on the Flop
Seat 4: if4dh6jhJXeN3/qd3qCp9g folded before Flop (didn't bet)
Seat 5: Se+H4Z4PDr6+eIUDJX1rpg (button) collected ($2.95)
Seat 6: 32YL2ZEp8NT4JB2RVM9euQ (small blind) folded before Flop




PokerStars Game #59941574050:  Hold'em No Limit ($0.10/$0.25) - 2009/07/01 1:39:35 ET
Table 'eOXPe2c6mG7DOFKvMsZZfA' 6-max Seat #4 is the button
Seat 2: gaPMxLGp9SOj4Lq6t+/0Ig ($7.45 in chips) 
Seat 3: kReyZ6g6Fu3tQ0nyjDf9kA ($20.70 in chips) 
Seat 4: zHHLkD2sRljslKKeQv/ZQw ($40.75 in chips) 
Seat 5: NhUN/JpAprdJeamFBgJH1w ($32.25 in chips) 
Seat 6: Qpv/hb5ak7LeaDig1L5L8w ($15 in chips) 
NhUN/JpAprdJeamFBgJH1w: posts small blind $0.10
Qpv/hb5ak7LeaDig1L5L8w: posts big blind $0.25
s21kVGMLPAoHdWR+muSonw: sits out 
*** HOLE CARDS ***
gaPMxLGp9SOj4Lq6t+/0Ig: folds 
kReyZ6g6Fu3tQ0nyjDf9kA: folds 
zHHLkD2sRljslKKeQv/ZQw: calls $0.25
NhUN/JpAprdJeamFBgJH1w: folds 
Qpv/hb5ak7LeaDig1L5L8w: checks 
*** FLOP *** [Kh 8s 7h]
Qpv/hb5ak7LeaDig1L5L8w: checks 
zHHLkD2sRljslKKeQv/ZQw: checks 
*** TURN *** [Kh 8s 7h] [As]
Qpv/hb5ak7LeaDig1L5L8w: checks 
zHHLkD2sRljslKKeQv/ZQw: checks 
*** RIVER *** [Kh 8s 7h As] [9h]
Qpv/hb5ak7LeaDig1L5L8w: checks 
zHHLkD2sRljslKKeQv/ZQw: checks 
*** SHOW DOWN ***
Qpv/hb5ak7LeaDig1L5L8w: shows [Kc 4s] (a pair of Kings)
zHHLkD2sRljslKKeQv/ZQw: mucks hand 
Qpv/hb5ak7LeaDig1L5L8w collected $0.60 from pot
*** SUMMARY ***
Total pot $0.60 | Rake $0 
Board [Kh 8s 7h As 9h]
Seat 2: gaPMxLGp9SOj4Lq6t+/0Ig folded before Flop (didn't bet)
Seat 3: kReyZ6g6Fu3tQ0nyjDf9kA folded before Flop (didn't bet)
Seat 4: zHHLkD2sRljslKKeQv/ZQw (button) mucked
Seat 5: NhUN/JpAprdJeamFBgJH1w (small blind) folded before Flop
Seat 6: Qpv/hb5ak7LeaDig1L5L8w (big blind) showed [Kc 4s] and won ($0.60) with a pair of Kings




PokerStars Game #59941574222:  Hold'em No Limit ($0.10/$0.25) - 2009/07/01 1:39:35 ET
Table 'xkqAWQFDrFt4p81M8UsoNw' 9-max Seat #1 is the button
Seat 1: tLcDklc2rBORNfixyRfVfw ($26.75 in chips) 
Seat 2: z5GxcHlYz/GSz6W2uFiTtg ($37.90 in chips) 
Seat 3: xHZZRLAaFUIC8WWI8ljOJA ($24.50 in chips) 
Seat 4: wGigCmBR/9XWkPpvYos3aQ ($25.95 in chips) 
Seat 5: OiV1PWZ3IkN29JlmCcnTwQ ($4.95 in chips) 
Seat 6: 6RiVTYll/5D8zICp0MRpKw ($25 in chips) 
Seat 7: MG90wfSJZnOejs/KD3vlQQ ($43.05 in chips) 
Seat 8: MaqsqnOOkbNuPf4oWvOtnA ($44.10 in chips) 
Seat 9: Z9AeOQX3yzuSvKAm/xyovg ($9.65 in chips) 
z5GxcHlYz/GSz6W2uFiTtg: posts small blind $0.10
xHZZRLAaFUIC8WWI8ljOJA: posts big blind $0.25
*** HOLE CARDS ***
wGigCmBR/9XWkPpvYos3aQ: folds 
OiV1PWZ3IkN29JlmCcnTwQ: folds 
6RiVTYll/5D8zICp0MRpKw has timed out
6RiVTYll/5D8zICp0MRpKw: folds 
6RiVTYll/5D8zICp0MRpKw is sitting out
6RiVTYll/5D8zICp0MRpKw has returned
MG90wfSJZnOejs/KD3vlQQ: folds 
MaqsqnOOkbNuPf4oWvOtnA: raises $0.75 to $1
Z9AeOQX3yzuSvKAm/xyovg: folds 
tLcDklc2rBORNfixyRfVfw: folds 
z5GxcHlYz/GSz6W2uFiTtg: folds 
xHZZRLAaFUIC8WWI8ljOJA: folds 
Uncalled bet ($0.75) returned to MaqsqnOOkbNuPf4oWvOtnA
MaqsqnOOkbNuPf4oWvOtnA collected $0.60 from pot
*** SUMMARY ***
Total pot $0.60 | Rake $0 
Seat 1: tLcDklc2rBORNfixyRfVfw (button) folded before Flop (didn't bet)
Seat 2: z5GxcHlYz/GSz6W2uFiTtg (small blind) folded before Flop
Seat 3: xHZZRLAaFUIC8WWI8ljOJA (big blind) folded before Flop
Seat 4: wGigCmBR/9XWkPpvYos3aQ folded before Flop (didn't bet)
Seat 5: OiV1PWZ3IkN29JlmCcnTwQ folded before Flop (didn't bet)
Seat 6: 6RiVTYll/5D8zICp0MRpKw folded before Flop (didn't bet)
Seat 7: MG90wfSJZnOejs/KD3vlQQ folded before Flop (didn't bet)
Seat 8: MaqsqnOOkbNuPf4oWvOtnA collected ($0.60)
Seat 9: Z9AeOQX3yzuSvKAm/xyovg folded before Flop (didn't bet)




PokerStars Game #59941574792:  Hold'em No Limit ($0.10/$0.25) - 2009/07/01 1:39:36 ET
Table 'by7aHYEDnDd144EXOXa/jA' 9-max Seat #3 is the button
Seat 1: j4q3p0lesp63b1gZDwLBZw ($6.60 in chips) 
Seat 2: vSkQm2EelzwRGDDQQk0Fqw ($5 in chips) 
Seat 3: HOEaXncFu2ij+D5/CANAZA ($13.15 in chips) 
Seat 5: yyG4svzOpC1A+sUP/scg6w ($4.10 in chips) 
Seat 6: sC4BsflLWW26Qm9m+1AwJQ ($12.15 in chips) 
Seat 7: V6p0jQ/RhUsqpHLmXvEX4Q ($22.55 in chips) 
Seat 8: 7je+LC5Mfs6nL8YBVh4frQ ($4 in chips) 
Seat 9: K0b5wNInj6hUGRr6yzKFtw ($26.65 in chips) 
yyG4svzOpC1A+sUP/scg6w: posts small blind $0.10
sC4BsflLWW26Qm9m+1AwJQ: posts big blind $0.25
*** HOLE CARDS ***
V6p0jQ/RhUsqpHLmXvEX4Q: folds 
7je+LC5Mfs6nL8YBVh4frQ: folds 
K0b5wNInj6hUGRr6yzKFtw: folds 
j4q3p0lesp63b1gZDwLBZw: folds 
vSkQm2EelzwRGDDQQk0Fqw: folds 
HOEaXncFu2ij+D5/CANAZA: calls $0.25
yyG4svzOpC1A+sUP/scg6w: calls $0.15
2Xwi447v1rBHM+92U0CduA joins the table at seat #4 
sC4BsflLWW26Qm9m+1AwJQ: checks 
*** FLOP *** [Kd 4h 3h]
yyG4svzOpC1A+sUP/scg6w: checks 
sC4BsflLWW26Qm9m+1AwJQ: checks 
HOEaXncFu2ij+D5/CANAZA: checks 
*** TURN *** [Kd 4h 3h] [Jh]
yyG4svzOpC1A+sUP/scg6w: checks 
sC4BsflLWW26Qm9m+1AwJQ: bets $0.25
HOEaXncFu2ij+D5/CANAZA: calls $0.25
yyG4svzOpC1A+sUP/scg6w: calls $0.25
*** RIVER *** [Kd 4h 3h Jh] [3d]
yyG4svzOpC1A+sUP/scg6w: checks 
sC4BsflLWW26Qm9m+1AwJQ: bets $1.50
HOEaXncFu2ij+D5/CANAZA: calls $1.50
yyG4svzOpC1A+sUP/scg6w: folds 
*** SHOW DOWN ***
sC4BsflLWW26Qm9m+1AwJQ: shows [Jd 3s] (a full house, Threes full of Jacks)
HOEaXncFu2ij+D5/CANAZA: mucks hand 
sC4BsflLWW26Qm9m+1AwJQ collected $4.30 from pot
*** SUMMARY ***
Total pot $4.50 | Rake $0.20 
Board [Kd 4h 3h Jh 3d]
Seat 1: j4q3p0lesp63b1gZDwLBZw folded before Flop (didn't bet)
Seat 2: vSkQm2EelzwRGDDQQk0Fqw folded before Flop (didn't bet)
Seat 3: HOEaXncFu2ij+D5/CANAZA (button) mucked
Seat 5: yyG4svzOpC1A+sUP/scg6w (small blind) folded on the River
Seat 6: sC4BsflLWW26Qm9m+1AwJQ (big blind) showed [Jd 3s] and won ($4.30) with a full house, Threes full of Jacks
Seat 7: V6p0jQ/RhUsqpHLmXvEX4Q folded before Flop (didn't bet)
Seat 8: 7je+LC5Mfs6nL8YBVh4frQ folded before Flop (didn't bet)
Seat 9: K0b5wNInj6hUGRr6yzKFtw folded before Flop (didn't bet)




PokerStars Game #59941575256:  Hold'em No Limit ($0.10/$0.25) - 2009/07/01 1:39:37 ET
Table '+UzantPJ4smVdrh+4GTu1w' 6-max Seat #1 is the button
Seat 1: TSmua8tGK3sTbwi0ynrW9Q ($27.70 in chips) 
Seat 3: SS/yfeArhULzIcOPe8MdPg ($29.70 in chips) 
Seat 4: UmcUp27+PbgBItv3ZNlAWQ ($25.25 in chips) 
Seat 5: cj4VBQya7HtVL2zCGd5jLQ ($60.45 in chips) 
Seat 6: fZQg9veL7Dd/Z04ZTjC+wQ ($25 in chips) 
SS/yfeArhULzIcOPe8MdPg: posts small blind $0.10
UmcUp27+PbgBItv3ZNlAWQ: posts big blind $0.25
*** HOLE CARDS ***
cj4VBQya7HtVL2zCGd5jLQ: calls $0.25
fZQg9veL7Dd/Z04ZTjC+wQ: folds 
TSmua8tGK3sTbwi0ynrW9Q: folds 
SS/yfeArhULzIcOPe8MdPg: calls $0.15
UmcUp27+PbgBItv3ZNlAWQ: checks 
*** FLOP *** [As Ah 5h]
SS/yfeArhULzIcOPe8MdPg: checks 
UmcUp27+PbgBItv3ZNlAWQ: checks 
cj4VBQya7HtVL2zCGd5jLQ: checks 
*** TURN *** [As Ah 5h] [9d]
SS/yfeArhULzIcOPe8MdPg: checks 
UmcUp27+PbgBItv3ZNlAWQ: checks 
tcbEu7VzyHQ+0lh+skbQhQ has returned
cj4VBQya7HtVL2zCGd5jLQ: checks 
*** RIVER *** [As Ah 5h 9d] [6h]
SS/yfeArhULzIcOPe8MdPg: checks 
UmcUp27+PbgBItv3ZNlAWQ: checks 
cj4VBQya7HtVL2zCGd5jLQ: checks 
*** SHOW DOWN ***
SS/yfeArhULzIcOPe8MdPg: shows [Jc Tc] (a pair of Aces)
UmcUp27+PbgBItv3ZNlAWQ: shows [6d 3s] (two pair, Aces and Sixes)
cj4VBQya7HtVL2zCGd5jLQ: shows [Jd Js] (two pair, Aces and Jacks)
cj4VBQya7HtVL2zCGd5jLQ collected $0.75 from pot
*** SUMMARY ***
Total pot $0.75 | Rake $0 
Board [As Ah 5h 9d 6h]
Seat 1: TSmua8tGK3sTbwi0ynrW9Q (button) folded before Flop (didn't bet)
Seat 3: SS/yfeArhULzIcOPe8MdPg (small blind) showed [Jc Tc] and lost with a pair of Aces
Seat 4: UmcUp27+PbgBItv3ZNlAWQ (big blind) showed [6d 3s] and lost with two pair, Aces and Sixes
Seat 5: cj4VBQya7HtVL2zCGd5jLQ showed [Jd Js] and won ($0.75) with two pair, Aces and Jacks
Seat 6: fZQg9veL7Dd/Z04ZTjC+wQ folded before Flop (didn't bet)




PokerStars Game #59941575630:  Hold'em No Limit ($0.10/$0.25) - 2009/07/01 1:39:37 ET
Table 'wGizWOswEL6P5QrvVkno/g' 6-max Seat #2 is the button
Seat 2: mfrkWA3PTeYPkbO6hi98Aw ($24.90 in chips) 
Seat 4: 32YL2ZEp8NT4JB2RVM9euQ ($16.40 in chips) 
Seat 5: wsP46AGpqDjHZQmlRHKa9g ($39.75 in chips) 
Seat 6: rfSnsAuAfXTb8w/obc9OVQ ($4.25 in chips) 
bJFzs6QmEEnz4miMfSDtcg will be allowed to play after the button
32YL2ZEp8NT4JB2RVM9euQ: posts small blind $0.10
wsP46AGpqDjHZQmlRHKa9g: posts big blind $0.25
*** HOLE CARDS ***
rfSnsAuAfXTb8w/obc9OVQ: folds 
mfrkWA3PTeYPkbO6hi98Aw: folds 
32YL2ZEp8NT4JB2RVM9euQ: raises $0.75 to $1
wsP46AGpqDjHZQmlRHKa9g: folds 
Uncalled bet ($0.75) returned to 32YL2ZEp8NT4JB2RVM9euQ
32YL2ZEp8NT4JB2RVM9euQ collected $0.50 from pot
32YL2ZEp8NT4JB2RVM9euQ: doesn't show hand 
*** SUMMARY ***
Total pot $0.50 | Rake $0 
Seat 2: mfrkWA3PTeYPkbO6hi98Aw (button) folded before Flop (didn't bet)
Seat 4: 32YL2ZEp8NT4JB2RVM9euQ (small blind) collected ($0.50)
Seat 5: wsP46AGpqDjHZQmlRHKa9g (big blind) folded before Flop
Seat 6: rfSnsAuAfXTb8w/obc9OVQ folded before Flop (didn't bet)




PokerStars Game #59941575340:  Hold'em No Limit ($0.10/$0.25) - 2009/07/01 1:39:37 ET
Table 'Loy/olZ5qoDOSvX4UTujGg' 6-max Seat #5 is the button
Seat 1: HipgaJhkN4ie/tTw4dK3Ug ($12.65 in chips) 
Seat 2: 4z7mPbMLNp4TezHXin63Vw ($18.90 in chips) 
Seat 3: 32YL2ZEp8NT4JB2RVM9euQ ($15.70 in chips) 
Seat 4: /gJNBeCkWL4o85/jvlZ4BA ($28.60 in chips) 
Seat 5: tSR4329m40dZsN7YOpI9Kw ($29.45 in chips) 
Seat 6: qGHGf/553gQnDoklMRe3tg ($23.65 in chips) 
qGHGf/553gQnDoklMRe3tg: posts small blind $0.10
HipgaJhkN4ie/tTw4dK3Ug: posts big blind $0.25
*** HOLE CARDS ***
4z7mPbMLNp4TezHXin63Vw: calls $0.25
32YL2ZEp8NT4JB2RVM9euQ: folds 
/gJNBeCkWL4o85/jvlZ4BA: raises $0.50 to $0.75
tSR4329m40dZsN7YOpI9Kw: folds 
qGHGf/553gQnDoklMRe3tg: folds 
HipgaJhkN4ie/tTw4dK3Ug: folds 
4z7mPbMLNp4TezHXin63Vw: calls $0.50
*** FLOP *** [8s 4s 7h]
4z7mPbMLNp4TezHXin63Vw: checks 
/gJNBeCkWL4o85/jvlZ4BA: bets $1.25
4z7mPbMLNp4TezHXin63Vw: folds 
Uncalled bet ($1.25) returned to /gJNBeCkWL4o85/jvlZ4BA
/gJNBeCkWL4o85/jvlZ4BA collected $1.80 from pot
*** SUMMARY ***
Total pot $1.85 | Rake $0.05 
Board [8s 4s 7h]
Seat 1: HipgaJhkN4ie/tTw4dK3Ug (big blind) folded before Flop
Seat 2: 4z7mPbMLNp4TezHXin63Vw folded on the Flop
Seat 3: 32YL2ZEp8NT4JB2RVM9euQ folded before Flop (didn't bet)
Seat 4: /gJNBeCkWL4o85/jvlZ4BA collected ($1.80)
Seat 5: tSR4329m40dZsN7YOpI9Kw (button) folded before Flop (didn't bet)
Seat 6: qGHGf/553gQnDoklMRe3tg (small blind) folded before Flop




PokerStars Game #59941575422:  Hold'em No Limit ($0.10/$0.25) - 2009/07/01 1:39:37 ET
Table 'l57rayEpPtZotP9nqgSWBg' 6-max Seat #3 is the button
Seat 1: DihMHaz4WNETH1bPDe13kA ($55.75 in chips) 
Seat 2: p6adJRMXMBLr+xtQzqazIQ ($12 in chips) 
Seat 3: L3/N/gliETan8N5Gim5h4Q ($25 in chips) 
Seat 4: OqkdGXy1SCzuN5Q0wNlFSg ($18.30 in chips) 
Seat 5: WKJHaZPUgrpTVyLOEjLYmg ($4.75 in chips) 
Seat 6: IGRfskE1v9H9Bn+fz8AgNQ ($17.40 in chips) 
OqkdGXy1SCzuN5Q0wNlFSg: posts small blind $0.10
WKJHaZPUgrpTVyLOEjLYmg: posts big blind $0.25
*** HOLE CARDS ***
IGRfskE1v9H9Bn+fz8AgNQ: folds 
DihMHaz4WNETH1bPDe13kA: folds 
p6adJRMXMBLr+xtQzqazIQ: raises $0.50 to $0.75
L3/N/gliETan8N5Gim5h4Q: folds 
OqkdGXy1SCzuN5Q0wNlFSg: folds 
WKJHaZPUgrpTVyLOEjLYmg: calls $0.50
*** FLOP *** [2c 4c Js]
WKJHaZPUgrpTVyLOEjLYmg: bets $1.50
p6adJRMXMBLr+xtQzqazIQ: raises $3.75 to $5.25
WKJHaZPUgrpTVyLOEjLYmg: calls $2.50 and is all-in
Uncalled bet ($1.25) returned to p6adJRMXMBLr+xtQzqazIQ
*** TURN *** [2c 4c Js] [3c]
*** RIVER *** [2c 4c Js 3c] [5d]
*** SHOW DOWN ***
WKJHaZPUgrpTVyLOEjLYmg: shows [7d 9h] (high card Jack)
p6adJRMXMBLr+xtQzqazIQ: shows [As Ac] (a straight, Ace to Five)
p6adJRMXMBLr+xtQzqazIQ collected $9.15 from pot
*** SUMMARY ***
Total pot $9.60 | Rake $0.45 
Board [2c 4c Js 3c 5d]
Seat 1: DihMHaz4WNETH1bPDe13kA folded before Flop (didn't bet)
Seat 2: p6adJRMXMBLr+xtQzqazIQ showed [As Ac] and won ($9.15) with a straight, Ace to Five
Seat 3: L3/N/gliETan8N5Gim5h4Q (button) folded before Flop (didn't bet)
Seat 4: OqkdGXy1SCzuN5Q0wNlFSg (small blind) folded before Flop
Seat 5: WKJHaZPUgrpTVyLOEjLYmg (big blind) showed [7d 9h] and lost with high card Jack
Seat 6: IGRfskE1v9H9Bn+fz8AgNQ folded before Flop (didn't bet)




PokerStars Game #59941575488:  Hold'em No Limit ($0.10/$0.25) - 2009/07/01 1:39:37 ET
Table '9L7XfAwuM7XsXE8LIg2o5Q' 6-max Seat #3 is the button
Seat 1: dOIoLBxmpLHSXBN9LZnf0Q ($26.35 in chips) 
Seat 2: LJI7A1YgDM7hgh7o56+ReQ ($25.10 in chips) 
Seat 3: kv2o5BKCLOrJIw4oc083jQ ($27.45 in chips) 
Seat 4: jp34e617tIzV8tKIWmfAbA ($40.05 in chips) 
Seat 5: OUv909q/YxsJgxpSlZxLJQ ($33.40 in chips) 
Seat 6: k9nHZTHt8hYhYRcW8NTb4g ($37.35 in chips) 
jp34e617tIzV8tKIWmfAbA: posts small blind $0.10
OUv909q/YxsJgxpSlZxLJQ: posts big blind $0.25
*** HOLE CARDS ***
k9nHZTHt8hYhYRcW8NTb4g: folds 
dOIoLBxmpLHSXBN9LZnf0Q: calls $0.25
LJI7A1YgDM7hgh7o56+ReQ: raises $1 to $1.25
kv2o5BKCLOrJIw4oc083jQ: folds 
jp34e617tIzV8tKIWmfAbA: folds 
OUv909q/YxsJgxpSlZxLJQ: folds 
dOIoLBxmpLHSXBN9LZnf0Q: calls $1
*** FLOP *** [3h Qd Jd]
dOIoLBxmpLHSXBN9LZnf0Q: checks 
LJI7A1YgDM7hgh7o56+ReQ: bets $2.25
dOIoLBxmpLHSXBN9LZnf0Q: folds 
Uncalled bet ($2.25) returned to LJI7A1YgDM7hgh7o56+ReQ
LJI7A1YgDM7hgh7o56+ReQ collected $2.75 from pot
LJI7A1YgDM7hgh7o56+ReQ: doesn't show hand 
*** SUMMARY ***
Total pot $2.85 | Rake $0.10 
Board [3h Qd Jd]
Seat 1: dOIoLBxmpLHSXBN9LZnf0Q folded on the Flop
Seat 2: LJI7A1YgDM7hgh7o56+ReQ collected ($2.75)
Seat 3: kv2o5BKCLOrJIw4oc083jQ (button) folded before Flop (didn't bet)
Seat 4: jp34e617tIzV8tKIWmfAbA (small blind) folded before Flop
Seat 5: OUv909q/YxsJgxpSlZxLJQ (big blind) folded before Flop
Seat 6: k9nHZTHt8hYhYRcW8NTb4g folded before Flop (didn't bet)




PokerStars Game #59941575394:  Hold'em No Limit ($0.10/$0.25) - 2009/07/01 1:39:37 ET
Table 'APEHQjIcZHDZUA4iOjju2g' 6-max Seat #2 is the button
Seat 1: DE9hRlt14g+JdsRQ4wT7hg ($26.85 in chips) 
Seat 2: 3zD3qLXT1bEffAoWGnc7wg ($44.35 in chips) 
Seat 3: 3e/idKqDuPE10t6Zvr//SQ ($24.75 in chips) 
Seat 4: w2mQ4VsGljGwWXydz8tw2A ($18.50 in chips) 
Seat 5: /xN6gc9+8Hew0HxaB6VIVg ($43.90 in chips) 
Seat 6: KXtdqb+rIMkjc0RvHDksGQ ($25.95 in chips) 
3e/idKqDuPE10t6Zvr//SQ: posts small blind $0.10
w2mQ4VsGljGwWXydz8tw2A: posts big blind $0.25
*** HOLE CARDS ***
/xN6gc9+8Hew0HxaB6VIVg: folds 
KXtdqb+rIMkjc0RvHDksGQ: folds 
DE9hRlt14g+JdsRQ4wT7hg: raises $0.75 to $1
3zD3qLXT1bEffAoWGnc7wg: calls $1
3e/idKqDuPE10t6Zvr//SQ: folds 
w2mQ4VsGljGwWXydz8tw2A: calls $0.75
*** FLOP *** [Td 8d 5s]
w2mQ4VsGljGwWXydz8tw2A: bets $2
DE9hRlt14g+JdsRQ4wT7hg: calls $2
3zD3qLXT1bEffAoWGnc7wg: raises $4.75 to $6.75
w2mQ4VsGljGwWXydz8tw2A: calls $4.75
DE9hRlt14g+JdsRQ4wT7hg: calls $4.75
*** TURN *** [Td 8d 5s] [Qd]
w2mQ4VsGljGwWXydz8tw2A: checks 
DE9hRlt14g+JdsRQ4wT7hg: checks 
3zD3qLXT1bEffAoWGnc7wg: checks 
*** RIVER *** [Td 8d 5s Qd] [6h]
w2mQ4VsGljGwWXydz8tw2A: bets $5
DE9hRlt14g+JdsRQ4wT7hg: calls $5
3zD3qLXT1bEffAoWGnc7wg: folds 
*** SHOW DOWN ***
w2mQ4VsGljGwWXydz8tw2A: shows [2d Jd] (a flush, Queen high)
DE9hRlt14g+JdsRQ4wT7hg: mucks hand 
w2mQ4VsGljGwWXydz8tw2A collected $31.75 from pot
*** SUMMARY ***
Total pot $33.35 | Rake $1.60 
Board [Td 8d 5s Qd 6h]
Seat 1: DE9hRlt14g+JdsRQ4wT7hg mucked
Seat 2: 3zD3qLXT1bEffAoWGnc7wg (button) folded on the River
Seat 3: 3e/idKqDuPE10t6Zvr//SQ (small blind) folded before Flop
Seat 4: w2mQ4VsGljGwWXydz8tw2A (big blind) showed [2d Jd] and won ($31.75) with a flush, Queen high
Seat 5: /xN6gc9+8Hew0HxaB6VIVg folded before Flop (didn't bet)
Seat 6: KXtdqb+rIMkjc0RvHDksGQ folded before Flop (didn't bet)




PokerStars Game #59941575602:  Hold'em No Limit ($0.10/$0.25) - 2009/07/01 1:39:37 ET
Table 'mk323gviqdkOY5Aek/1EWg' 6-max Seat #6 is the button
Seat 1: L3/N/gliETan8N5Gim5h4Q ($25.50 in chips) 
Seat 2: GC/9yVD59DUCX7hUI7gcLw ($56.05 in chips) 
Seat 3: NuqYPwTLZYQhxOoVK3Yqlw ($24.65 in chips) 
Seat 4: +baiVgI/ETnBARLe5mARCw ($13.15 in chips) 
Seat 5: kjYRzIfvZNNflYMYRkkSVA ($26.15 in chips) 
Seat 6: KkXSr5xFjxLSD3wtAvT+WQ ($8.80 in chips) 
L3/N/gliETan8N5Gim5h4Q: posts small blind $0.10
GC/9yVD59DUCX7hUI7gcLw: posts big blind $0.25
*** HOLE CARDS ***
NuqYPwTLZYQhxOoVK3Yqlw: folds 
+baiVgI/ETnBARLe5mARCw: folds 
kjYRzIfvZNNflYMYRkkSVA: folds 
KkXSr5xFjxLSD3wtAvT+WQ: folds 
L3/N/gliETan8N5Gim5h4Q: folds 
Uncalled bet ($0.15) returned to GC/9yVD59DUCX7hUI7gcLw
GC/9yVD59DUCX7hUI7gcLw collected $0.20 from pot
*** SUMMARY ***
Total pot $0.20 | Rake $0 
Seat 1: L3/N/gliETan8N5Gim5h4Q (small blind) folded before Flop
Seat 2: GC/9yVD59DUCX7hUI7gcLw (big blind) collected ($0.20)
Seat 3: NuqYPwTLZYQhxOoVK3Yqlw folded before Flop (didn't bet)
Seat 4: +baiVgI/ETnBARLe5mARCw folded before Flop (didn't bet)
Seat 5: kjYRzIfvZNNflYMYRkkSVA folded before Flop (didn't bet)
Seat 6: KkXSr5xFjxLSD3wtAvT+WQ (button) folded before Flop (didn't bet)




PokerStars Game #59941576280:  Hold'em No Limit ($0.10/$0.25) - 2009/07/01 1:39:38 ET
Table '2AUmC2Rslg+QUbLfdgNdfg' 6-max Seat #2 is the button
Seat 1: YDXAegrCnzc0l6TSDNboXQ ($24.60 in chips) 
Seat 2: PLksyNlTVRVZwxJVC2/1eA ($23.85 in chips) 
Seat 3: JFIAqU8lCZ0vWwEl4bdGsg ($25.45 in chips) 
Seat 4: lquriepNQBhDV5P1SWHhnA ($26.35 in chips) 
Seat 5: AMc4cCwUJhokdGRYIaVPhQ ($21.90 in chips) 
Seat 6: xBWc54v+UTSJOiKpbAbJWg ($12.20 in chips) 
JFIAqU8lCZ0vWwEl4bdGsg: posts small blind $0.10
lquriepNQBhDV5P1SWHhnA: posts big blind $0.25
*** HOLE CARDS ***
AMc4cCwUJhokdGRYIaVPhQ: raises $0.25 to $0.50
xBWc54v+UTSJOiKpbAbJWg: folds 
YDXAegrCnzc0l6TSDNboXQ: folds 
PLksyNlTVRVZwxJVC2/1eA: folds 
JFIAqU8lCZ0vWwEl4bdGsg: folds 
lquriepNQBhDV5P1SWHhnA: folds 
Uncalled bet ($0.25) returned to AMc4cCwUJhokdGRYIaVPhQ
AMc4cCwUJhokdGRYIaVPhQ collected $0.60 from pot
AMc4cCwUJhokdGRYIaVPhQ: doesn't show hand 
*** SUMMARY ***
Total pot $0.60 | Rake $0 
Seat 1: YDXAegrCnzc0l6TSDNboXQ folded before Flop (didn't bet)
Seat 2: PLksyNlTVRVZwxJVC2/1eA (button) folded before Flop (didn't bet)
Seat 3: JFIAqU8lCZ0vWwEl4bdGsg (small blind) folded before Flop
Seat 4: lquriepNQBhDV5P1SWHhnA (big blind) folded before Flop
Seat 5: AMc4cCwUJhokdGRYIaVPhQ collected ($0.60)
Seat 6: xBWc54v+UTSJOiKpbAbJWg folded before Flop (didn't bet)




PokerStars Game #59941576198:  Hold'em No Limit ($0.10/$0.25) - 2009/07/01 1:39:38 ET
Table '63h13e5p7cWe02rClZ1CHw' 6-max Seat #5 is the button
Seat 1: pokjbbEcXXPlADXdSGHtZw ($21.90 in chips) 
Seat 2: k9nHZTHt8hYhYRcW8NTb4g ($26.80 in chips) 
Seat 3: mFv3iBCtrw9XfCDRB0d46Q ($5.75 in chips) 
Seat 4: xrf8tAXKQHG99HixCot1Iw ($23 in chips) 
Seat 5: iyZxqznXjv3vtvOJymkoLQ ($45.15 in chips) 
Seat 6: mfrkWA3PTeYPkbO6hi98Aw ($38.55 in chips) 
mfrkWA3PTeYPkbO6hi98Aw: posts small blind $0.10
pokjbbEcXXPlADXdSGHtZw: posts big blind $0.25
*** HOLE CARDS ***
k9nHZTHt8hYhYRcW8NTb4g: folds 
mFv3iBCtrw9XfCDRB0d46Q: folds 
xrf8tAXKQHG99HixCot1Iw: folds 
iyZxqznXjv3vtvOJymkoLQ: folds 
mfrkWA3PTeYPkbO6hi98Aw: folds 
Uncalled bet ($0.15) returned to pokjbbEcXXPlADXdSGHtZw
pokjbbEcXXPlADXdSGHtZw collected $0.20 from pot
pokjbbEcXXPlADXdSGHtZw: doesn't show hand 
*** SUMMARY ***
Total pot $0.20 | Rake $0 
Seat 1: pokjbbEcXXPlADXdSGHtZw (big blind) collected ($0.20)
Seat 2: k9nHZTHt8hYhYRcW8NTb4g folded before Flop (didn't bet)
Seat 3: mFv3iBCtrw9XfCDRB0d46Q folded before Flop (didn't bet)
Seat 4: xrf8tAXKQHG99HixCot1Iw folded before Flop (didn't bet)
Seat 5: iyZxqznXjv3vtvOJymkoLQ (button) folded before Flop (didn't bet)
Seat 6: mfrkWA3PTeYPkbO6hi98Aw (small blind) folded before Flop




PokerStars Game #59941576348:  Hold'em No Limit ($0.10/$0.25) - 2009/07/01 1:39:38 ET
Table 'wPWRBZPJl1HAnysw7qRR0A' 6-max Seat #4 is the button
Seat 1: m7ne1MOFTQXlsXT7/R/rug ($9.15 in chips) 
Seat 2: uUXdcVMNa05rfbntdvplfw ($15.15 in chips) 
Seat 3: 1ZpoLWO2nm2w1Nd1v9Sr3g ($6.65 in chips) 
Seat 4: g9++7w2tsgKmQ4gr54+0hA ($16.65 in chips) 
Seat 5: y0B+UpYpOUJz3JWtlJQBSA ($21.55 in chips) 
Seat 6: Hsvkc0/G2VV78oVmWYXecw ($5 in chips) 
y0B+UpYpOUJz3JWtlJQBSA: posts small blind $0.10
Hsvkc0/G2VV78oVmWYXecw: posts big blind $0.25
*** HOLE CARDS ***
m7ne1MOFTQXlsXT7/R/rug: folds 
uUXdcVMNa05rfbntdvplfw: calls $0.25
1ZpoLWO2nm2w1Nd1v9Sr3g: folds 
g9++7w2tsgKmQ4gr54+0hA: folds 
g9++7w2tsgKmQ4gr54+0hA leaves the table
epAUIB7h2FJXzUPRIvSkRA joins the table at seat #4 
y0B+UpYpOUJz3JWtlJQBSA: folds 
Hsvkc0/G2VV78oVmWYXecw: checks 
*** FLOP *** [4c 3d 9h]
Hsvkc0/G2VV78oVmWYXecw: checks 
uUXdcVMNa05rfbntdvplfw: bets $0.25
Hsvkc0/G2VV78oVmWYXecw: folds 
Uncalled bet ($0.25) returned to uUXdcVMNa05rfbntdvplfw
uUXdcVMNa05rfbntdvplfw collected $0.60 from pot
*** SUMMARY ***
Total pot $0.60 | Rake $0 
Board [4c 3d 9h]
Seat 1: m7ne1MOFTQXlsXT7/R/rug folded before Flop (didn't bet)
Seat 2: uUXdcVMNa05rfbntdvplfw collected ($0.60)
Seat 3: 1ZpoLWO2nm2w1Nd1v9Sr3g folded before Flop (didn't bet)
Seat 4: g9++7w2tsgKmQ4gr54+0hA (button) folded before Flop (didn't bet)
Seat 5: y0B+UpYpOUJz3JWtlJQBSA (small blind) folded before Flop
Seat 6: Hsvkc0/G2VV78oVmWYXecw (big blind) folded on the Flop




PokerStars Game #59941575886:  Hold'em No Limit ($0.10/$0.25) - 2009/07/01 1:39:38 ET
Table '2vH5RcmkT0F4XNS/EmmyMA' 6-max Seat #4 is the button
Seat 1: hOaWAImn5/MZDAWAPlYHCw ($5.80 in chips) 
Seat 2: W6Y6au0wf7gRAlqJYgOezw ($13.10 in chips) 
Seat 3: t8P79jKZYh/Wpx2V73pSqg ($26.50 in chips) 
Seat 4: FC6tJ9EOiutXO8hnpR4VgQ ($5.75 in chips) 
Seat 5: Hsvkc0/G2VV78oVmWYXecw ($5 in chips) 
Seat 6: if4dh6jhJXeN3/qd3qCp9g ($25 in chips) 
Hsvkc0/G2VV78oVmWYXecw: posts small blind $0.10
if4dh6jhJXeN3/qd3qCp9g: posts big blind $0.25
*** HOLE CARDS ***
hOaWAImn5/MZDAWAPlYHCw: folds 
W6Y6au0wf7gRAlqJYgOezw: folds 
t8P79jKZYh/Wpx2V73pSqg: raises $0.25 to $0.50
FC6tJ9EOiutXO8hnpR4VgQ: folds 
Hsvkc0/G2VV78oVmWYXecw: folds 
if4dh6jhJXeN3/qd3qCp9g: calls $0.25
*** FLOP *** [9s Th Qc]
if4dh6jhJXeN3/qd3qCp9g: checks 
t8P79jKZYh/Wpx2V73pSqg: bets $1
if4dh6jhJXeN3/qd3qCp9g: folds 
Uncalled bet ($1) returned to t8P79jKZYh/Wpx2V73pSqg
t8P79jKZYh/Wpx2V73pSqg collected $1.05 from pot
*** SUMMARY ***
Total pot $1.10 | Rake $0.05 
Board [9s Th Qc]
Seat 1: hOaWAImn5/MZDAWAPlYHCw folded before Flop (didn't bet)
Seat 2: W6Y6au0wf7gRAlqJYgOezw folded before Flop (didn't bet)
Seat 3: t8P79jKZYh/Wpx2V73pSqg collected ($1.05)
Seat 4: FC6tJ9EOiutXO8hnpR4VgQ (button) folded before Flop (didn't bet)
Seat 5: Hsvkc0/G2VV78oVmWYXecw (small blind) folded before Flop
Seat 6: if4dh6jhJXeN3/qd3qCp9g (big blind) folded on the Flop




PokerStars Game #59941575884:  Hold'em No Limit ($0.10/$0.25) - 2009/07/01 1:39:38 ET
Table 'xmJKTGBeWCwutccj3YfupQ' 6-max Seat #4 is the button
Seat 1: sVbkVl4OznxBCfi66UB9vw ($25.10 in chips) 
Seat 2: AxhCSFlGEh+FAc+VUD31JQ ($23.30 in chips) 
Seat 3: T5wrp/d5jarm+SxNy8OQAg ($23.55 in chips) 
Seat 4: uWjhTVMpuIroxXcmD3Okug ($9.85 in chips) 
Seat 5: DE9hRlt14g+JdsRQ4wT7hg ($25 in chips) 
Seat 6: Mo72EzWqYLVNBUGxtzSsUQ ($31.35 in chips) 
DE9hRlt14g+JdsRQ4wT7hg: posts small blind $0.10
Mo72EzWqYLVNBUGxtzSsUQ: posts big blind $0.25
*** HOLE CARDS ***
sVbkVl4OznxBCfi66UB9vw: calls $0.25
AxhCSFlGEh+FAc+VUD31JQ: folds 
T5wrp/d5jarm+SxNy8OQAg: calls $0.25
uWjhTVMpuIroxXcmD3Okug: calls $0.25
DE9hRlt14g+JdsRQ4wT7hg: folds 
Mo72EzWqYLVNBUGxtzSsUQ: checks 
*** FLOP *** [9d 4d Ad]
Mo72EzWqYLVNBUGxtzSsUQ: checks 
sVbkVl4OznxBCfi66UB9vw: bets $0.25
T5wrp/d5jarm+SxNy8OQAg: folds 
uWjhTVMpuIroxXcmD3Okug: calls $0.25
Mo72EzWqYLVNBUGxtzSsUQ: folds 
*** TURN *** [9d 4d Ad] [7s]
sVbkVl4OznxBCfi66UB9vw: bets $0.50
uWjhTVMpuIroxXcmD3Okug: calls $0.50
*** RIVER *** [9d 4d Ad 7s] [9s]
sVbkVl4OznxBCfi66UB9vw: checks 
uWjhTVMpuIroxXcmD3Okug: bets $1.75
sVbkVl4OznxBCfi66UB9vw: folds 
Uncalled bet ($1.75) returned to uWjhTVMpuIroxXcmD3Okug
uWjhTVMpuIroxXcmD3Okug collected $2.50 from pot
*** SUMMARY ***
Total pot $2.60 | Rake $0.10 
Board [9d 4d Ad 7s 9s]
Seat 1: sVbkVl4OznxBCfi66UB9vw folded on the River
Seat 2: AxhCSFlGEh+FAc+VUD31JQ folded before Flop (didn't bet)
Seat 3: T5wrp/d5jarm+SxNy8OQAg folded on the Flop
Seat 4: uWjhTVMpuIroxXcmD3Okug (button) collected ($2.50)
Seat 5: DE9hRlt14g+JdsRQ4wT7hg (small blind) folded before Flop
Seat 6: Mo72EzWqYLVNBUGxtzSsUQ (big blind) folded on the Flop




PokerStars Game #59941576118:  Hold'em No Limit ($0.10/$0.25) - 2009/07/01 1:39:38 ET
Table 'ktio12Pyq06LsrFhIorSqA' 9-max Seat #1 is the button
Seat 1: OneeONzF0MoH0pEdcBndwA ($33.85 in chips) 
Seat 2: tGsFgUKjSctVaAXabrlZxw ($4.65 in chips) 
Seat 4: 0QdZrkFD7aGKeBXPGbIomA ($4.90 in chips) 
Seat 5: e0pV1oisCAilWiG0FCxY6A ($18 in chips) 
Seat 6: jQL6XIewylQ8MmZhhq2YFg ($49.75 in chips) 
Seat 7: XGCfQsxa6PfAg3kJtzUmww ($23.95 in chips) 
Seat 8: Z5y2J55JmfLYR6/DPAGHwQ ($2.45 in chips) 
Seat 9: H5Se03ZqSX7tbULXur2MAg ($26.65 in chips) 
tGsFgUKjSctVaAXabrlZxw: posts small blind $0.10
0QdZrkFD7aGKeBXPGbIomA: posts big blind $0.25
*** HOLE CARDS ***
tGsFgUKjSctVaAXabrlZxw said, "lol"
OneeONzF0MoH0pEdcBndwA said, "lol"
e0pV1oisCAilWiG0FCxY6A: folds 
jQL6XIewylQ8MmZhhq2YFg: folds 
XGCfQsxa6PfAg3kJtzUmww: folds 
Z5y2J55JmfLYR6/DPAGHwQ: folds 
0QdZrkFD7aGKeBXPGbIomA said, "unreal"
H5Se03ZqSX7tbULXur2MAg: folds 
OneeONzF0MoH0pEdcBndwA: calls $0.25
tGsFgUKjSctVaAXabrlZxw: calls $0.15
0QdZrkFD7aGKeBXPGbIomA: checks 
*** FLOP *** [4h Ah 7h]
tGsFgUKjSctVaAXabrlZxw: checks 
0QdZrkFD7aGKeBXPGbIomA: checks 
OneeONzF0MoH0pEdcBndwA: checks 
*** TURN *** [4h Ah 7h] [5s]
tGsFgUKjSctVaAXabrlZxw: checks 
0QdZrkFD7aGKeBXPGbIomA: bets $0.75
OneeONzF0MoH0pEdcBndwA: folds 
tGsFgUKjSctVaAXabrlZxw: folds 
Uncalled bet ($0.75) returned to 0QdZrkFD7aGKeBXPGbIomA
DigiSlarks joins the table at seat #3 
0QdZrkFD7aGKeBXPGbIomA collected $0.75 from pot
0QdZrkFD7aGKeBXPGbIomA: doesn't show hand 
*** SUMMARY ***
Total pot $0.75 | Rake $0 
Board [4h Ah 7h 5s]
Seat 1: OneeONzF0MoH0pEdcBndwA (button) folded on the Turn
Seat 2: tGsFgUKjSctVaAXabrlZxw (small blind) folded on the Turn
Seat 4: 0QdZrkFD7aGKeBXPGbIomA (big blind) collected ($0.75)
Seat 5: e0pV1oisCAilWiG0FCxY6A folded before Flop (didn't bet)
Seat 6: jQL6XIewylQ8MmZhhq2YFg folded before Flop (didn't bet)
Seat 7: XGCfQsxa6PfAg3kJtzUmww folded before Flop (didn't bet)
Seat 8: Z5y2J55JmfLYR6/DPAGHwQ folded before Flop (didn't bet)
Seat 9: H5Se03ZqSX7tbULXur2MAg folded before Flop (didn't bet)




PokerStars Game #59941576196:  Hold'em No Limit ($0.10/$0.25) - 2009/07/01 1:39:38 ET
Table 'yAHDCs33TIgw3ra63xuU2Q' 9-max Seat #3 is the button
Seat 1: ydoFOVgzvZv9ZhuWu9rXAw ($4.90 in chips) 
Seat 3: g6UPjSyxNLffCi+EqqIlEg ($18.35 in chips) 
Seat 4: j5spkbnOCRiLGiH6iqBaqw ($10.25 in chips) 
Seat 5: 4awUyiDYTgylQKXZ9faBVA ($37.95 in chips) 
Seat 6: DnDcAdn9P0zGovMERigpFA ($25 in chips) 
Seat 7: qxWFg3MZuVyidB0SJh5ywg ($27.40 in chips) 
Seat 8: tYsOBqdU1+x+yFI7zHO7hQ ($25.70 in chips) 
Seat 9: MtVtHDqIJTyUcXkRBBDIVA ($25.80 in chips) 
j5spkbnOCRiLGiH6iqBaqw: posts small blind $0.10
4awUyiDYTgylQKXZ9faBVA: posts big blind $0.25
*** HOLE CARDS ***
DnDcAdn9P0zGovMERigpFA: raises $0.50 to $0.75
qxWFg3MZuVyidB0SJh5ywg: folds 
tYsOBqdU1+x+yFI7zHO7hQ: folds 
MtVtHDqIJTyUcXkRBBDIVA: calls $0.75
ydoFOVgzvZv9ZhuWu9rXAw: folds 
g6UPjSyxNLffCi+EqqIlEg: folds 
j5spkbnOCRiLGiH6iqBaqw: calls $0.65
4awUyiDYTgylQKXZ9faBVA: folds 
*** FLOP *** [Qh 8h 7h]
j5spkbnOCRiLGiH6iqBaqw: checks 
DnDcAdn9P0zGovMERigpFA: checks 
MtVtHDqIJTyUcXkRBBDIVA: checks 
*** TURN *** [Qh 8h 7h] [5c]
j5spkbnOCRiLGiH6iqBaqw: checks 
DnDcAdn9P0zGovMERigpFA: checks 
MtVtHDqIJTyUcXkRBBDIVA: checks 
*** RIVER *** [Qh 8h 7h 5c] [Jd]
j5spkbnOCRiLGiH6iqBaqw: checks 
DnDcAdn9P0zGovMERigpFA: checks 
MtVtHDqIJTyUcXkRBBDIVA: checks 
*** SHOW DOWN ***
j5spkbnOCRiLGiH6iqBaqw: shows [Ad 9s] (high card Ace)
DnDcAdn9P0zGovMERigpFA: shows [6h 6s] (a pair of Sixes)
MtVtHDqIJTyUcXkRBBDIVA: mucks hand 
DnDcAdn9P0zGovMERigpFA collected $2.40 from pot
*** SUMMARY ***
Total pot $2.50 | Rake $0.10 
Board [Qh 8h 7h 5c Jd]
Seat 1: ydoFOVgzvZv9ZhuWu9rXAw folded before Flop (didn't bet)
Seat 3: g6UPjSyxNLffCi+EqqIlEg (button) folded before Flop (didn't bet)
Seat 4: j5spkbnOCRiLGiH6iqBaqw (small blind) showed [Ad 9s] and lost with high card Ace
Seat 5: 4awUyiDYTgylQKXZ9faBVA (big blind) folded before Flop
Seat 6: DnDcAdn9P0zGovMERigpFA showed [6h 6s] and won ($2.40) with a pair of Sixes
Seat 7: qxWFg3MZuVyidB0SJh5ywg folded before Flop (didn't bet)
Seat 8: tYsOBqdU1+x+yFI7zHO7hQ folded before Flop (didn't bet)
Seat 9: MtVtHDqIJTyUcXkRBBDIVA mucked




PokerStars Game #59941576098:  Hold'em No Limit ($0.10/$0.25) - 2009/07/01 1:39:38 ET
Table 'FuFyQHmlO/QqQp//rDRrPg' 6-max Seat #5 is the button
Seat 1: jp34e617tIzV8tKIWmfAbA ($26.55 in chips) 
Seat 3: EeUZtMU058v2ObUACOF4Og ($30.60 in chips) 
Seat 4: OMGl+YMGogf2JWIRfT2/Yg ($4.75 in chips) 
Seat 5: xrf8tAXKQHG99HixCot1Iw ($20.25 in chips) 
Seat 6: 6DwBRH+xZ12AAZmeAg+aXw ($59.75 in chips) 
6DwBRH+xZ12AAZmeAg+aXw: posts small blind $0.10
jp34e617tIzV8tKIWmfAbA: posts big blind $0.25
G3h3THGB1j3qdHDVHpnJWg: sits out 
*** HOLE CARDS ***
EeUZtMU058v2ObUACOF4Og: folds 
OMGl+YMGogf2JWIRfT2/Yg: folds 
xrf8tAXKQHG99HixCot1Iw: raises $0.50 to $0.75
6DwBRH+xZ12AAZmeAg+aXw: folds 
jp34e617tIzV8tKIWmfAbA: folds 
Uncalled bet ($0.50) returned to xrf8tAXKQHG99HixCot1Iw
xrf8tAXKQHG99HixCot1Iw collected $0.60 from pot
xrf8tAXKQHG99HixCot1Iw: doesn't show hand 
*** SUMMARY ***
Total pot $0.60 | Rake $0 
Seat 1: jp34e617tIzV8tKIWmfAbA (big blind) folded before Flop
Seat 3: EeUZtMU058v2ObUACOF4Og folded before Flop (didn't bet)
Seat 4: OMGl+YMGogf2JWIRfT2/Yg folded before Flop (didn't bet)
Seat 5: xrf8tAXKQHG99HixCot1Iw (button) collected ($0.60)
Seat 6: 6DwBRH+xZ12AAZmeAg+aXw (small blind) folded before Flop




PokerStars Game #59941576140:  Hold'em No Limit ($0.10/$0.25) - 2009/07/01 1:39:38 ET
Table 'ohAuixfiLOYDylNUG5mNUw' 9-max Seat #5 is the button
Seat 1: W6tExOcYX7qiy6Qdp+ZwFA ($10 in chips) 
Seat 2: Th3FldXKQW6hWVVPahaoOQ ($27.15 in chips) 
Seat 3: gSakoFAgDDzXSb2eNBWKcg ($14.65 in chips) 
Seat 4: AiXn/9o1EwOPZUHujnh/bA ($18.65 in chips) 
Seat 5: wub1jsnHlpWmOX4uczVADA ($7.05 in chips) 
Seat 6: MtVtHDqIJTyUcXkRBBDIVA ($25 in chips) 
Seat 7: +qc/EYCgLC65SpGvr35eNg ($25 in chips) 
Seat 8: ppMlNkhYgErlt4fuJO7ADA ($2.85 in chips) 
Seat 9: CT7Xj/V/O5rBlhtt+RZeFQ ($25 in chips) 
MtVtHDqIJTyUcXkRBBDIVA: posts small blind $0.10
+qc/EYCgLC65SpGvr35eNg: posts big blind $0.25
*** HOLE CARDS ***
ppMlNkhYgErlt4fuJO7ADA: folds 
CT7Xj/V/O5rBlhtt+RZeFQ: folds 
W6tExOcYX7qiy6Qdp+ZwFA: folds 
Th3FldXKQW6hWVVPahaoOQ: folds 
gSakoFAgDDzXSb2eNBWKcg: folds 
AiXn/9o1EwOPZUHujnh/bA: folds 
wub1jsnHlpWmOX4uczVADA: raises $0.50 to $0.75
MtVtHDqIJTyUcXkRBBDIVA: folds 
+qc/EYCgLC65SpGvr35eNg: folds 
Uncalled bet ($0.50) returned to wub1jsnHlpWmOX4uczVADA
wub1jsnHlpWmOX4uczVADA collected $0.60 from pot
*** SUMMARY ***
Total pot $0.60 | Rake $0 
Seat 1: W6tExOcYX7qiy6Qdp+ZwFA folded before Flop (didn't bet)
Seat 2: Th3FldXKQW6hWVVPahaoOQ folded before Flop (didn't bet)
Seat 3: gSakoFAgDDzXSb2eNBWKcg folded before Flop (didn't bet)
Seat 4: AiXn/9o1EwOPZUHujnh/bA folded before Flop (didn't bet)
Seat 5: wub1jsnHlpWmOX4uczVADA (button) collected ($0.60)
Seat 6: MtVtHDqIJTyUcXkRBBDIVA (small blind) folded before Flop
Seat 7: +qc/EYCgLC65SpGvr35eNg (big blind) folded before Flop
Seat 8: ppMlNkhYgErlt4fuJO7ADA folded before Flop (didn't bet)
Seat 9: CT7Xj/V/O5rBlhtt+RZeFQ folded before Flop (didn't bet)




PokerStars Game #59941576808:  Hold'em No Limit ($0.10/$0.25) - 2009/07/01 1:39:39 ET
Table 'MJ1SB76A4qJrlEa+C5e/8w' 6-max Seat #4 is the button
Seat 1: 0KDZiuXQg6UI9cqBR/AUnQ ($29.35 in chips) 
Seat 2: UA5OsKS3VPaxa7uC8La/kA ($36.35 in chips) 
Seat 3: DihMHaz4WNETH1bPDe13kA ($33.25 in chips) 
Seat 4: SFmT9ZsVopnukjvAzrxTRg ($25.65 in chips) 
Seat 6: JFIAqU8lCZ0vWwEl4bdGsg ($29.50 in chips) 
Hsvkc0/G2VV78oVmWYXecw will be allowed to play after the button
JFIAqU8lCZ0vWwEl4bdGsg: posts small blind $0.10
0KDZiuXQg6UI9cqBR/AUnQ: posts big blind $0.25
*** HOLE CARDS ***
UA5OsKS3VPaxa7uC8La/kA: folds 
DihMHaz4WNETH1bPDe13kA: folds 
SFmT9ZsVopnukjvAzrxTRg: folds 
JFIAqU8lCZ0vWwEl4bdGsg: raises $0.60 to $0.85
0KDZiuXQg6UI9cqBR/AUnQ: calls $0.60
*** FLOP *** [7h Kc 4h]
JFIAqU8lCZ0vWwEl4bdGsg: bets $1.25
0KDZiuXQg6UI9cqBR/AUnQ: folds 
Uncalled bet ($1.25) returned to JFIAqU8lCZ0vWwEl4bdGsg
JFIAqU8lCZ0vWwEl4bdGsg collected $1.65 from pot
JFIAqU8lCZ0vWwEl4bdGsg: doesn't show hand 
*** SUMMARY ***
Total pot $1.70 | Rake $0.05 
Board [7h Kc 4h]
Seat 1: 0KDZiuXQg6UI9cqBR/AUnQ (big blind) folded on the Flop
Seat 2: UA5OsKS3VPaxa7uC8La/kA folded before Flop (didn't bet)
Seat 3: DihMHaz4WNETH1bPDe13kA folded before Flop (didn't bet)
Seat 4: SFmT9ZsVopnukjvAzrxTRg (button) folded before Flop (didn't bet)
Seat 6: JFIAqU8lCZ0vWwEl4bdGsg (small blind) collected ($1.65)




PokerStars Game #59941576574:  Hold'em No Limit ($0.10/$0.25) - 2009/07/01 1:39:39 ET
Table '4XGDnEByOol5up4aB2KbJw' 6-max Seat #1 is the button
Seat 1: kyRaCIljYA6l33lSKQfNsg ($26.85 in chips) 
Seat 2: SFmT9ZsVopnukjvAzrxTRg ($43 in chips) 
Seat 3: LtASJ9OlkqGrrUKGQlpGAw ($20.90 in chips) 
Seat 4: BV+K0Phf5VBHr7aZPKqbUQ ($26.05 in chips) 
Seat 5: Dh01+rohD2p9pXLYeBlC5Q ($17.55 in chips) 
Seat 6: a7Ux7aERFGCbT/L3ojVfAg ($9.35 in chips) 
SFmT9ZsVopnukjvAzrxTRg: posts small blind $0.10
LtASJ9OlkqGrrUKGQlpGAw: posts big blind $0.25
*** HOLE CARDS ***
BV+K0Phf5VBHr7aZPKqbUQ: folds 
Dh01+rohD2p9pXLYeBlC5Q: calls $0.25
a7Ux7aERFGCbT/L3ojVfAg: folds 
kyRaCIljYA6l33lSKQfNsg: folds 
SFmT9ZsVopnukjvAzrxTRg: folds 
LtASJ9OlkqGrrUKGQlpGAw: checks 
*** FLOP *** [2c 8h 6h]
LtASJ9OlkqGrrUKGQlpGAw: checks 
Dh01+rohD2p9pXLYeBlC5Q: checks 
*** TURN *** [2c 8h 6h] [Kd]
LtASJ9OlkqGrrUKGQlpGAw: checks 
Dh01+rohD2p9pXLYeBlC5Q: bets $0.75
LtASJ9OlkqGrrUKGQlpGAw: folds 
Uncalled bet ($0.75) returned to Dh01+rohD2p9pXLYeBlC5Q
Dh01+rohD2p9pXLYeBlC5Q collected $0.60 from pot
*** SUMMARY ***
Total pot $0.60 | Rake $0 
Board [2c 8h 6h Kd]
Seat 1: kyRaCIljYA6l33lSKQfNsg (button) folded before Flop (didn't bet)
Seat 2: SFmT9ZsVopnukjvAzrxTRg (small blind) folded before Flop
Seat 3: LtASJ9OlkqGrrUKGQlpGAw (big blind) folded on the Turn
Seat 4: BV+K0Phf5VBHr7aZPKqbUQ folded before Flop (didn't bet)
Seat 5: Dh01+rohD2p9pXLYeBlC5Q collected ($0.60)
Seat 6: a7Ux7aERFGCbT/L3ojVfAg folded before Flop (didn't bet)




PokerStars Game #59941577414:  Hold'em No Limit ($0.10/$0.25) - 2009/07/01 1:39:40 ET
Table '9iHhO6FyZVM8XpSc23TIgg' 6-max Seat #2 is the button
Seat 1: NhUN/JpAprdJeamFBgJH1w ($44.25 in chips) 
Seat 2: bJFzs6QmEEnz4miMfSDtcg ($39.80 in chips) 
Seat 3: TSmua8tGK3sTbwi0ynrW9Q ($25.10 in chips) 
Seat 5: xrf8tAXKQHG99HixCot1Iw ($22.15 in chips) 
Seat 6: iyZxqznXjv3vtvOJymkoLQ ($34.45 in chips) 
TSmua8tGK3sTbwi0ynrW9Q: posts small blind $0.10
xrf8tAXKQHG99HixCot1Iw: posts big blind $0.25
*** HOLE CARDS ***
cfJccEfyn6IkquPN08hFsA has returned
iyZxqznXjv3vtvOJymkoLQ: folds 
NhUN/JpAprdJeamFBgJH1w: folds 
bJFzs6QmEEnz4miMfSDtcg: calls $0.25
TSmua8tGK3sTbwi0ynrW9Q: raises $1 to $1.25
xrf8tAXKQHG99HixCot1Iw: folds 
bJFzs6QmEEnz4miMfSDtcg: calls $1
*** FLOP *** [9c Jh 5h]
TSmua8tGK3sTbwi0ynrW9Q: bets $1.75
bJFzs6QmEEnz4miMfSDtcg: folds 
Uncalled bet ($1.75) returned to TSmua8tGK3sTbwi0ynrW9Q
TSmua8tGK3sTbwi0ynrW9Q collected $2.65 from pot
*** SUMMARY ***
Total pot $2.75 | Rake $0.10 
Board [9c Jh 5h]
Seat 1: NhUN/JpAprdJeamFBgJH1w folded before Flop (didn't bet)
Seat 2: bJFzs6QmEEnz4miMfSDtcg (button) folded on the Flop
Seat 3: TSmua8tGK3sTbwi0ynrW9Q (small blind) collected ($2.65)
Seat 5: xrf8tAXKQHG99HixCot1Iw (big blind) folded before Flop
Seat 6: iyZxqznXjv3vtvOJymkoLQ folded before Flop (didn't bet)




PokerStars Game #59941576964:  Hold'em No Limit ($0.10/$0.25) - 2009/07/01 1:39:40 ET
Table 'nc6OeGk/wtaWV+6N+kgnZQgZetDqJh6q9A3mLO3ThCsASeat #4 is the button
Seat 1: DihMHaz4WNETH1bPDe13kA ($26.65 in chips) 
Seat 2: JFIAqU8lCZ0vWwEl4bdGsg ($33.05 in chips) 
Seat 3: jp34e617tIzV8tKIWmfAbA ($33.15 in chips) 
Seat 4: BV+K0Phf5VBHr7aZPKqbUQ ($28.65 in chips) 
Seat 6: 8tR2s7yV/Fr0ePp1w5XnJw ($9.75 in chips) 
8tR2s7yV/Fr0ePp1w5XnJw: posts small blind $0.10
DihMHaz4WNETH1bPDe13kA: posts big blind $0.25
*** HOLE CARDS ***
JFIAqU8lCZ0vWwEl4bdGsg: folds 
jp34e617tIzV8tKIWmfAbA: folds 
BV+K0Phf5VBHr7aZPKqbUQ: raises $0.50 to $0.75
8tR2s7yV/Fr0ePp1w5XnJw: folds 
DihMHaz4WNETH1bPDe13kA: folds 
Uncalled bet ($0.50) returned to BV+K0Phf5VBHr7aZPKqbUQ
BV+K0Phf5VBHr7aZPKqbUQ collected $0.60 from pot
BV+K0Phf5VBHr7aZPKqbUQ: doesn't show hand 
*** SUMMARY ***
Total pot $0.60 | Rake $0 
Seat 1: DihMHaz4WNETH1bPDe13kA (big blind) folded before Flop
Seat 2: JFIAqU8lCZ0vWwEl4bdGsg folded before Flop (didn't bet)
Seat 3: jp34e617tIzV8tKIWmfAbA folded before Flop (didn't bet)
Seat 4: BV+K0Phf5VBHr7aZPKqbUQ (button) collected ($0.60)
Seat 6: 8tR2s7yV/Fr0ePp1w5XnJw (small blind) folded before Flop




PokerStars Game #59941576910:  Hold'em No Limit ($0.10/$0.25) - 2009/07/01 1:39:40 ET
Table 'luMgmRPIo47e7iXDlheIwA' 6-max Seat #4 is the button
Seat 1: EQ3WxdGe/KZrM6Lx4T02sg ($14.70 in chips) 
Seat 3: W6Y6au0wf7gRAlqJYgOezw ($16 in chips) 
Seat 4: xrf8tAXKQHG99HixCot1Iw ($24 in chips) 
Seat 5: cWc85bEzdRzpUMhRKm8pwQ ($45.25 in chips) 
Seat 6: qGHGf/553gQnDoklMRe3tg ($27.40 in chips) 
cWc85bEzdRzpUMhRKm8pwQ: posts small blind $0.10
qGHGf/553gQnDoklMRe3tg: posts big blind $0.25
NhUN/JpAprdJeamFBgJH1w: sits out 
*** HOLE CARDS ***
EQ3WxdGe/KZrM6Lx4T02sg: calls $0.25
W6Y6au0wf7gRAlqJYgOezw: calls $0.25
xrf8tAXKQHG99HixCot1Iw: folds 
cWc85bEzdRzpUMhRKm8pwQ: calls $0.15
qGHGf/553gQnDoklMRe3tg: raises $1.25 to $1.50
EQ3WxdGe/KZrM6Lx4T02sg: calls $1.25
W6Y6au0wf7gRAlqJYgOezw: calls $1.25
cWc85bEzdRzpUMhRKm8pwQ: calls $1.25
*** FLOP *** [Ac 7h Qd]
cWc85bEzdRzpUMhRKm8pwQ: checks 
qGHGf/553gQnDoklMRe3tg: bets $4
EQ3WxdGe/KZrM6Lx4T02sg: folds 
W6Y6au0wf7gRAlqJYgOezw: raises $10.50 to $14.50 and is all-in
cWc85bEzdRzpUMhRKm8pwQ: folds 
qGHGf/553gQnDoklMRe3tg: folds 
Uncalled bet ($10.50) returned to W6Y6au0wf7gRAlqJYgOezw
W6Y6au0wf7gRAlqJYgOezw collected $13.35 from pot
*** SUMMARY ***
Total pot $14 | Rake $0.65 
Board [Ac 7h Qd]
Seat 1: EQ3WxdGe/KZrM6Lx4T02sg folded on the Flop
Seat 3: W6Y6au0wf7gRAlqJYgOezw collected ($13.35)
Seat 4: xrf8tAXKQHG99HixCot1Iw (button) folded before Flop (didn't bet)
Seat 5: cWc85bEzdRzpUMhRKm8pwQ (small blind) folded on the Flop
Seat 6: qGHGf/553gQnDoklMRe3tg (big blind) folded on the Flop




PokerStars Game #59941577198:  Hold'em No Limit ($0.10/$0.25) - 2009/07/01 1:39:40 ET
Table 'VuY5ej47Cy8nOI3Wogmhzw' 6-max Seat #5 is the button
Seat 1: EeUZtMU058v2ObUACOF4Og ($26.05 in chips) 
Seat 2: AM6Yl+3esmhhMBlSnQhWbg ($15.65 in chips) 
Seat 3: v+QfkGiuj9bgtuNoVnDO8w ($31.85 in chips) 
Seat 4: aXzjpue4eAQBqMdp87D3ZA ($13.95 in chips) 
Seat 5: iK/41//HmnLiIn0CVNNfyA ($11.95 in chips) 
EeUZtMU058v2ObUACOF4Og: posts small blind $0.10
AM6Yl+3esmhhMBlSnQhWbg: posts big blind $0.25
*** HOLE CARDS ***
v+QfkGiuj9bgtuNoVnDO8w: folds 
aXzjpue4eAQBqMdp87D3ZA: folds 
iK/41//HmnLiIn0CVNNfyA: folds 
EeUZtMU058v2ObUACOF4Og: folds 
Uncalled bet ($0.15) returned to AM6Yl+3esmhhMBlSnQhWbg
AM6Yl+3esmhhMBlSnQhWbg collected $0.20 from pot
AM6Yl+3esmhhMBlSnQhWbg: doesn't show hand 
*** SUMMARY ***
Total pot $0.20 | Rake $0 
Seat 1: EeUZtMU058v2ObUACOF4Og (small blind) folded before Flop
Seat 2: AM6Yl+3esmhhMBlSnQhWbg (big blind) collected ($0.20)
Seat 3: v+QfkGiuj9bgtuNoVnDO8w folded before Flop (didn't bet)
Seat 4: aXzjpue4eAQBqMdp87D3ZA folded before Flop (didn't bet)
Seat 5: iK/41//HmnLiIn0CVNNfyA (button) folded before Flop (didn't bet)




PokerStars Game #59941577540:  Hold'em No Limit ($0.10/$0.25) - 2009/07/01 1:39:41 ET
Table 'oxYpQNT8OHNCvpMIFi7UoA' 9-max Seat #4 is the button
Seat 1: EVqHvqty1ZsuvDFiSXlSqQ ($29.80 in chips) 
Seat 2: 8+iP8mvFyeAviW/yUH1CJg ($29.85 in chips) 
Seat 3: ubsjZomMWSV0hAiBLa7K1A ($19.65 in chips) 
Seat 4: eK8qa6EPcH2zhtbmWSvc9g ($25 in chips) 
Seat 5: ZoqLw33zTU6EsjOkfv/cGw ($20.05 in chips) 
Seat 6: VBHxUExRAMrbxUq/cVx9Gw ($5 in chips) 
ZoqLw33zTU6EsjOkfv/cGw: posts small blind $0.10
VBHxUExRAMrbxUq/cVx9Gw: posts big blind $0.25
X78b5v/uhqeXXoAijbw/yg: sits out 
pN3IHvAKm2fz+sTRARTcrg: sits out 
*** HOLE CARDS ***
EVqHvqty1ZsuvDFiSXlSqQ: folds 
8+iP8mvFyeAviW/yUH1CJg: calls $0.25
ubsjZomMWSV0hAiBLa7K1A: folds 
eK8qa6EPcH2zhtbmWSvc9g: folds 
ZoqLw33zTU6EsjOkfv/cGw: calls $0.15
VBHxUExRAMrbxUq/cVx9Gw: checks 
*** FLOP *** [9h 8h Ad]
ZoqLw33zTU6EsjOkfv/cGw: checks 
VBHxUExRAMrbxUq/cVx9Gw: checks 
8+iP8mvFyeAviW/yUH1CJg: checks 
*** TURN *** [9h 8h Ad] [Td]
ZoqLw33zTU6EsjOkfv/cGw: checks 
VBHxUExRAMrbxUq/cVx9Gw: checks 
8+iP8mvFyeAviW/yUH1CJg: checks 
*** RIVER *** [9h 8h Ad Td] [2h]
ZoqLw33zTU6EsjOkfv/cGw: checks 
VBHxUExRAMrbxUq/cVx9Gw: checks 
8+iP8mvFyeAviW/yUH1CJg: checks 
*** SHOW DOWN ***
ZoqLw33zTU6EsjOkfv/cGw: shows [4d 7h] (high card Ace)
VBHxUExRAMrbxUq/cVx9Gw: shows [Jc Ks] (high card Ace - King kicker)
8+iP8mvFyeAviW/yUH1CJg: mucks hand 
VBHxUExRAMrbxUq/cVx9Gw collected $0.75 from pot
*** SUMMARY ***
Total pot $0.75 | Rake $0 
Board [9h 8h Ad Td 2h]
Seat 1: EVqHvqty1ZsuvDFiSXlSqQ folded before Flop (didn't bet)
Seat 2: 8+iP8mvFyeAviW/yUH1CJg mucked
Seat 3: ubsjZomMWSV0hAiBLa7K1A folded before Flop (didn't bet)
Seat 4: eK8qa6EPcH2zhtbmWSvc9g (button) folded before Flop (didn't bet)
Seat 5: ZoqLw33zTU6EsjOkfv/cGw (small blind) showed [4d 7h] and lost with high card Ace
Seat 6: VBHxUExRAMrbxUq/cVx9Gw (big blind) showed [Jc Ks] and won ($0.75) with high card Ace




PokerStars Game #59941578234:  Hold'em No Limit ($0.10/$0.25) - 2009/07/01 1:39:42 ET
Table 'ER5H84HUgJx7HyDLnELLeA' 6-max Seat #2 is the button
Seat 1: LJI7A1YgDM7hgh7o56+ReQ ($25.65 in chips) 
Seat 2: buyjetgNT1McXtdaP4zynA ($20.25 in chips) 
Seat 3: memV5jkoAdGrnRy3Q9PM7w ($20.55 in chips) 
Seat 4: vqWjZmdQu/Hxw96/IJTWdQ ($25 in chips) 
Seat 5: mfrkWA3PTeYPkbO6hi98Aw ($25.90 in chips) 
Seat 6: 3zD3qLXT1bEffAoWGnc7wg ($50.65 in chips) 
memV5jkoAdGrnRy3Q9PM7w: posts small blind $0.10
vqWjZmdQu/Hxw96/IJTWdQ: posts big blind $0.25
*** HOLE CARDS ***
mfrkWA3PTeYPkbO6hi98Aw: folds 
3zD3qLXT1bEffAoWGnc7wg: folds 
LJI7A1YgDM7hgh7o56+ReQ: raises $0.75 to $1
buyjetgNT1McXtdaP4zynA: folds 
memV5jkoAdGrnRy3Q9PM7w: calls $0.90
vqWjZmdQu/Hxw96/IJTWdQ: calls $0.75
*** FLOP *** [6d Ks 7s]
memV5jkoAdGrnRy3Q9PM7w: checks 
vqWjZmdQu/Hxw96/IJTWdQ: checks 
LJI7A1YgDM7hgh7o56+ReQ: bets $2.25
memV5jkoAdGrnRy3Q9PM7w: folds 
vqWjZmdQu/Hxw96/IJTWdQ: folds 
Uncalled bet ($2.25) returned to LJI7A1YgDM7hgh7o56+ReQ
LJI7A1YgDM7hgh7o56+ReQ collected $2.85 from pot
LJI7A1YgDM7hgh7o56+ReQ: doesn't show hand 
*** SUMMARY ***
Total pot $3 | Rake $0.15 
Board [6d Ks 7s]
Seat 1: LJI7A1YgDM7hgh7o56+ReQ collected ($2.85)
Seat 2: buyjetgNT1McXtdaP4zynA (button) folded before Flop (didn't bet)
Seat 3: memV5jkoAdGrnRy3Q9PM7w (small blind) folded on the Flop
Seat 4: vqWjZmdQu/Hxw96/IJTWdQ (big blind) folded on the Flop
Seat 5: mfrkWA3PTeYPkbO6hi98Aw folded before Flop (didn't bet)
Seat 6: 3zD3qLXT1bEffAoWGnc7wg folded before Flop (didn't bet)




PokerStars Game #59941578204:  Hold'em No Limit ($0.10/$0.25) - 2009/07/01 1:39:42 ET
Table 'C47I7CmrmFr8Oo7wOovVwQ' 6-max Seat #2 is the button
Seat 2: hOaWAImn5/MZDAWAPlYHCw ($5.45 in chips) 
Seat 4: yY5JuFtDfXWRaZlVby4LLw ($17 in chips) 
Seat 6: pD7ri5wL3vsa6S1ulMYQmQ ($25 in chips) 
H+8eOP3XJHXjACRDTiIHTQ will be allowed to play after the button
yY5JuFtDfXWRaZlVby4LLw: posts small blind $0.10
pD7ri5wL3vsa6S1ulMYQmQ: posts big blind $0.25
*** HOLE CARDS ***
hOaWAImn5/MZDAWAPlYHCw: folds 
yY5JuFtDfXWRaZlVby4LLw: raises $0.25 to $0.50
pD7ri5wL3vsa6S1ulMYQmQ: calls $0.25
*** FLOP *** [4h 9c 4d]
yY5JuFtDfXWRaZlVby4LLw: checks 
pD7ri5wL3vsa6S1ulMYQmQ: checks 
*** TURN *** [4h 9c 4d] [9s]
yY5JuFtDfXWRaZlVby4LLw: checks 
pD7ri5wL3vsa6S1ulMYQmQ: checks 
*** RIVER *** [4h 9c 4d 9s] [Qs]
yY5JuFtDfXWRaZlVby4LLw: checks 
pD7ri5wL3vsa6S1ulMYQmQ: bets $1.50
yY5JuFtDfXWRaZlVby4LLw: folds 
Uncalled bet ($1.50) returned to pD7ri5wL3vsa6S1ulMYQmQ
pD7ri5wL3vsa6S1ulMYQmQ collected $0.95 from pot
*** SUMMARY ***
Total pot $1 | Rake $0.05 
Board [4h 9c 4d 9s Qs]
Seat 2: hOaWAImn5/MZDAWAPlYHCw (button) folded before Flop (didn't bet)
Seat 4: yY5JuFtDfXWRaZlVby4LLw (small blind) folded on the River
Seat 6: pD7ri5wL3vsa6S1ulMYQmQ (big blind) collected ($0.95)




PokerStars Game #59941578188:  Hold'em No Limit ($0.10/$0.25) - 2009/07/01 1:39:42 ET
Table 'YlRA05h9BJ1EhOUSNUjJdg' 9-max Seat #6 is the button
Seat 1: dtZ84flFEi4Q+SGrHMJRDQ ($25 in chips) 
Seat 2: Y2GFAe+PT7xnUUtgqCNDFw ($11.10 in chips) 
Seat 3: Z5ZtGOON8kmSdSCll9Z3XA ($12.10 in chips) 
Seat 5: sx0lGrkT9fd4yFR+3cXUQg ($11.30 in chips) 
Seat 6: QEbIGci+itdw+re8RM5fZA ($44 in chips) 
Seat 7: dfNim92Z6XK1/h5SFW5vDg ($25 in chips) 
Seat 8: dmYlc+1cjwZMJ7wV+Z0rRg ($32.45 in chips) 
Seat 9: Z9AeOQX3yzuSvKAm/xyovg ($9.75 in chips) 
dfNim92Z6XK1/h5SFW5vDg: posts small blind $0.10
dmYlc+1cjwZMJ7wV+Z0rRg: posts big blind $0.25
*** HOLE CARDS ***
Z9AeOQX3yzuSvKAm/xyovg: folds 
dtZ84flFEi4Q+SGrHMJRDQ: folds 
Y2GFAe+PT7xnUUtgqCNDFw: folds 
Z5ZtGOON8kmSdSCll9Z3XA: folds 
sx0lGrkT9fd4yFR+3cXUQg: folds 
QEbIGci+itdw+re8RM5fZA: raises $0.50 to $0.75
dfNim92Z6XK1/h5SFW5vDg: folds 
dmYlc+1cjwZMJ7wV+Z0rRg: folds 
Uncalled bet ($0.50) returned to QEbIGci+itdw+re8RM5fZA
QEbIGci+itdw+re8RM5fZA collected $0.60 from pot
QEbIGci+itdw+re8RM5fZA: doesn't show hand 
*** SUMMARY ***
Total pot $0.60 | Rake $0 
Seat 1: dtZ84flFEi4Q+SGrHMJRDQ folded before Flop (didn't bet)
Seat 2: Y2GFAe+PT7xnUUtgqCNDFw folded before Flop (didn't bet)
Seat 3: Z5ZtGOON8kmSdSCll9Z3XA folded before Flop (didn't bet)
Seat 5: sx0lGrkT9fd4yFR+3cXUQg folded before Flop (didn't bet)
Seat 6: QEbIGci+itdw+re8RM5fZA (button) collected ($0.60)
Seat 7: dfNim92Z6XK1/h5SFW5vDg (small blind) folded before Flop
Seat 8: dmYlc+1cjwZMJ7wV+Z0rRg (big blind) folded before Flop
Seat 9: Z9AeOQX3yzuSvKAm/xyovg folded before Flop (didn't bet)




PokerStars Game #59941578176:  Hold'em No Limit ($0.10/$0.25) - 2009/07/01 1:39:42 ET
Table 'ouLhepGYovxB2x0QxH7cVg' 9-max Seat #6 is the button
Seat 1: ghNKXUBl/H+t83JF079ZBA ($25.35 in chips) 
Seat 2: r1Z5m4PwSI5ANp7qCE1OJw ($19 in chips) 
Seat 3: bXpVeaSTPBFSPJmeXxO7nw ($5.60 in chips) 
Seat 5: LxRIJ6NkqjCD5zmzlF+y4w ($14.60 in chips) 
Seat 6: lSeLm4BdnSMLtIli62qjAQ ($7.50 in chips) 
Seat 7: JRV2PblFtPFz51l0Fwyz8g ($22.95 in chips) 
Seat 8: tLcDklc2rBORNfixyRfVfw ($25 in chips) 
Seat 9: ljemhp25Zg+nlA9DLCIiUw ($25 in chips) 
JRV2PblFtPFz51l0Fwyz8g: posts small blind $0.10
tLcDklc2rBORNfixyRfVfw: posts big blind $0.25
*** HOLE CARDS ***
ljemhp25Zg+nlA9DLCIiUw: folds 
ghNKXUBl/H+t83JF079ZBA: folds 
r1Z5m4PwSI5ANp7qCE1OJw: folds 
bXpVeaSTPBFSPJmeXxO7nw: folds 
LxRIJ6NkqjCD5zmzlF+y4w: raises $0.25 to $0.50
lSeLm4BdnSMLtIli62qjAQ: folds 
JRV2PblFtPFz51l0Fwyz8g: folds 
tLcDklc2rBORNfixyRfVfw: folds 
Uncalled bet ($0.25) returned to LxRIJ6NkqjCD5zmzlF+y4w
LxRIJ6NkqjCD5zmzlF+y4w collected $0.60 from pot
*** SUMMARY ***
Total pot $0.60 | Rake $0 
Seat 1: ghNKXUBl/H+t83JF079ZBA folded before Flop (didn't bet)
Seat 2: r1Z5m4PwSI5ANp7qCE1OJw folded before Flop (didn't bet)
Seat 3: bXpVeaSTPBFSPJmeXxO7nw folded before Flop (didn't bet)
Seat 5: LxRIJ6NkqjCD5zmzlF+y4w collected ($0.60)
Seat 6: lSeLm4BdnSMLtIli62qjAQ (button) folded before Flop (didn't bet)
Seat 7: JRV2PblFtPFz51l0Fwyz8g (small blind) folded before Flop
Seat 8: tLcDklc2rBORNfixyRfVfw (big blind) folded before Flop
Seat 9: ljemhp25Zg+nlA9DLCIiUw folded before Flop (didn't bet)




PokerStars Game #59941579122:  Hold'em No Limit ($0.10/$0.25) - 2009/07/01 1:39:43 ET
Table '1HT8bEDpLPhOXxmqMtzF8w' 9-max Seat #1 is the button
Seat 1: YkkKQUDI0iWatY4h0WWaAQ ($11.20 in chips) 
Seat 2: r6hsffOo1iKmaPYKwAZmFw ($29.10 in chips) 
Seat 3: oLa/tXLfSLLB28mcLGrxcg ($25.10 in chips) 
Seat 4: aNpwfA31EREwO+ar4XzBCw ($25.35 in chips) 
Seat 5: CT2YIt3dXaE9eOIkS7FwNw ($24.65 in chips) 
Seat 7: PMhmqYBPHOAXjH25lRz69g ($20.45 in chips) 
Seat 8: ghNKXUBl/H+t83JF079ZBA ($25 in chips) 
Seat 9: a2TmTivbjy207qYNGTay8g ($4.60 in chips) 
r6hsffOo1iKmaPYKwAZmFw: posts small blind $0.10
oLa/tXLfSLLB28mcLGrxcg: posts big blind $0.25
bXpVeaSTPBFSPJmeXxO7nw: sits out 
*** HOLE CARDS ***
aNpwfA31EREwO+ar4XzBCw: folds 
CT2YIt3dXaE9eOIkS7FwNw: folds 
PMhmqYBPHOAXjH25lRz69g: calls $0.25
ghNKXUBl/H+t83JF079ZBA: folds 
a2TmTivbjy207qYNGTay8g: calls $0.25
YkkKQUDI0iWatY4h0WWaAQ: folds 
r6hsffOo1iKmaPYKwAZmFw: folds 
oLa/tXLfSLLB28mcLGrxcg: checks 
*** FLOP *** [3h 4d 6h]
oLa/tXLfSLLB28mcLGrxcg: checks 
PMhmqYBPHOAXjH25lRz69g: bets $0.50
a2TmTivbjy207qYNGTay8g: folds 
oLa/tXLfSLLB28mcLGrxcg: folds 
Uncalled bet ($0.50) returned to PMhmqYBPHOAXjH25lRz69g
PMhmqYBPHOAXjH25lRz69g collected $0.85 from pot
PMhmqYBPHOAXjH25lRz69g: doesn't show hand 
*** SUMMARY ***
Total pot $0.85 | Rake $0 
Board [3h 4d 6h]
Seat 1: YkkKQUDI0iWatY4h0WWaAQ (button) folded before Flop (didn't bet)
Seat 2: r6hsffOo1iKmaPYKwAZmFw (small blind) folded before Flop
Seat 3: oLa/tXLfSLLB28mcLGrxcg (big blind) folded on the Flop
Seat 4: aNpwfA31EREwO+ar4XzBCw folded before Flop (didn't bet)
Seat 5: CT2YIt3dXaE9eOIkS7FwNw folded before Flop (didn't bet)
Seat 7: PMhmqYBPHOAXjH25lRz69g collected ($0.85)
Seat 8: ghNKXUBl/H+t83JF079ZBA folded before Flop (didn't bet)
Seat 9: a2TmTivbjy207qYNGTay8g folded on the Flop




PokerStars Game #59941579058:  Hold'em No Limit ($0.10/$0.25) - 2009/07/01 1:39:43 ET
Table 'YONIZZNvg4uZ4xNUO1deeA' 6-max Seat #4 is the button
Seat 2: evMMX/0gSDH791KdSAOaSg ($5.35 in chips) 
Seat 3: Eksrep3hySi2jeDHuaWiOQ ($8.55 in chips) 
Seat 4: oNAHfBJOUelvVhf0IDMJUA ($27.15 in chips) 
Seat 5: if4dh6jhJXeN3/qd3qCp9g ($25.10 in chips) 
Seat 6: eL3+wCBjFGfQ5FMdIZihwA ($24.65 in chips) 
if4dh6jhJXeN3/qd3qCp9g: posts small blind $0.10
eL3+wCBjFGfQ5FMdIZihwA: posts big blind $0.25
GbCVUNssQ7mqsPWr7J4d3w: sits out 
*** HOLE CARDS ***
evMMX/0gSDH791KdSAOaSg: folds 
Eksrep3hySi2jeDHuaWiOQ: folds 
oNAHfBJOUelvVhf0IDMJUA: calls $0.25
if4dh6jhJXeN3/qd3qCp9g: folds 
eL3+wCBjFGfQ5FMdIZihwA: checks 
*** FLOP *** [Qh Qd Tc]
eL3+wCBjFGfQ5FMdIZihwA: checks 
oNAHfBJOUelvVhf0IDMJUA: checks 
*** TURN *** [Qh Qd Tc] [8s]
eL3+wCBjFGfQ5FMdIZihwA: checks 
oNAHfBJOUelvVhf0IDMJUA: checks 
*** RIVER *** [Qh Qd Tc 8s] [Ad]
eL3+wCBjFGfQ5FMdIZihwA: bets $0.50
oNAHfBJOUelvVhf0IDMJUA: folds 
Uncalled bet ($0.50) returned to eL3+wCBjFGfQ5FMdIZihwA
eL3+wCBjFGfQ5FMdIZihwA collected $0.60 from pot
*** SUMMARY ***
Total pot $0.60 | Rake $0 
Board [Qh Qd Tc 8s Ad]
Seat 2: evMMX/0gSDH791KdSAOaSg folded before Flop (didn't bet)
Seat 3: Eksrep3hySi2jeDHuaWiOQ folded before Flop (didn't bet)
Seat 4: oNAHfBJOUelvVhf0IDMJUA (button) folded on the River
Seat 5: if4dh6jhJXeN3/qd3qCp9g (small blind) folded before Flop
Seat 6: eL3+wCBjFGfQ5FMdIZihwA (big blind) collected ($0.60)




PokerStars Game #59941578984:  Hold'em No Limit ($0.10/$0.25) - 2009/07/01 1:39:43 ET
Table '0w9m+UkNlGMNoPyQqzWk6A' 9-max Seat #2 is the button
Seat 1: yoL2UPRJrmSO7wXIS4Ak4g ($27.85 in chips) 
Seat 2: tYsOBqdU1+x+yFI7zHO7hQ ($53.05 in chips) 
Seat 3: VWwtMkIjXloiX/RKh7RGWQ ($10.40 in chips) 
Seat 4: z5GxcHlYz/GSz6W2uFiTtg ($23.50 in chips) 
Seat 5: HPEB+AtKw1+C/cxU0o1ciw ($49.05 in chips) 
Seat 6: CgIo2ItZqi4o3ayVG6HanQ ($24.15 in chips) 
Seat 7: 57qrNGHDvf6GhB8zVLsAtQ ($4.80 in chips) 
Seat 8: I+ARcuQBEroNUEjIZ2pprg ($14 in chips) 
Seat 9: KqS/lY/fNB9qUxokm9QfeA ($16.75 in chips) 
VWwtMkIjXloiX/RKh7RGWQ: posts small blind $0.10
z5GxcHlYz/GSz6W2uFiTtg: posts big blind $0.25
*** HOLE CARDS ***
HPEB+AtKw1+C/cxU0o1ciw: folds 
CgIo2ItZqi4o3ayVG6HanQ: raises $0.50 to $0.75
57qrNGHDvf6GhB8zVLsAtQ: folds 
I+ARcuQBEroNUEjIZ2pprg: folds 
KqS/lY/fNB9qUxokm9QfeA: calls $0.75
yoL2UPRJrmSO7wXIS4Ak4g: folds 
tYsOBqdU1+x+yFI7zHO7hQ: raises $2.25 to $3
VWwtMkIjXloiX/RKh7RGWQ: calls $2.90
z5GxcHlYz/GSz6W2uFiTtg: folds 
CgIo2ItZqi4o3ayVG6HanQ: calls $2.25
KqS/lY/fNB9qUxokm9QfeA: folds 
*** FLOP *** [4h 8h 4d]
VWwtMkIjXloiX/RKh7RGWQ: checks 
CgIo2ItZqi4o3ayVG6HanQ: bets $2.50
tYsOBqdU1+x+yFI7zHO7hQ: folds 
VWwtMkIjXloiX/RKh7RGWQ: folds 
Uncalled bet ($2.50) returned to CgIo2ItZqi4o3ayVG6HanQ
CgIo2ItZqi4o3ayVG6HanQ collected $9.50 from pot
*** SUMMARY ***
Total pot $10 | Rake $0.50 
Board [4h 8h 4d]
Seat 1: yoL2UPRJrmSO7wXIS4Ak4g folded before Flop (didn't bet)
Seat 2: tYsOBqdU1+x+yFI7zHO7hQ (button) folded on the Flop
Seat 3: VWwtMkIjXloiX/RKh7RGWQ (small blind) folded on the Flop
Seat 4: z5GxcHlYz/GSz6W2uFiTtg (big blind) folded before Flop
Seat 5: HPEB+AtKw1+C/cxU0o1ciw folded before Flop (didn't bet)
Seat 6: CgIo2ItZqi4o3ayVG6HanQ collected ($9.50)
Seat 7: 57qrNGHDvf6GhB8zVLsAtQ folded before Flop (didn't bet)
Seat 8: I+ARcuQBEroNUEjIZ2pprg folded before Flop (didn't bet)
Seat 9: KqS/lY/fNB9qUxokm9QfeA folded before Flop




PokerStars Game #59941578934:  Hold'em No Limit ($0.10/$0.25) - 2009/07/01 1:39:43 ET
Table 'ORSZkZqq+7Ja2PdeCFAytA' 9-max Seat #6 is the button
Seat 1: 3FkcXBaxKqxYVagfYUZlmw ($14.75 in chips) 
Seat 2: FzknuThd6oNi5WfR7ciTfA ($21.35 in chips) 
Seat 3: s9a4d23HFxaL70yUWQ0/tQ ($17.90 in chips) 
Seat 4: tbgfV2Egwn85xEt865GWQQ ($15.15 in chips) 
Seat 5: +lWbsq4dTcA70SX/+hnmpg ($4.65 in chips) 
Seat 6: gMF+EMhmwpnaM5TFQquf2A ($13.75 in chips) 
Seat 7: L4arauLTM5DsCc2Y3lI8Yw ($1.25 in chips) 
Seat 8: npAYqa85pqnzfOK5ukX+BQ ($20.25 in chips) 
Seat 9: cMTFs4oCtNInkpDIecxT/w ($11.65 in chips) 
L4arauLTM5DsCc2Y3lI8Yw: posts small blind $0.10
npAYqa85pqnzfOK5ukX+BQ: posts big blind $0.25
*** HOLE CARDS ***
cMTFs4oCtNInkpDIecxT/w: calls $0.25
3FkcXBaxKqxYVagfYUZlmw: calls $0.25
FzknuThd6oNi5WfR7ciTfA: calls $0.25
s9a4d23HFxaL70yUWQ0/tQ: calls $0.25
tbgfV2Egwn85xEt865GWQQ: folds 
+lWbsq4dTcA70SX/+hnmpg: calls $0.25
gMF+EMhmwpnaM5TFQquf2A: folds 
L4arauLTM5DsCc2Y3lI8Yw: raises $1 to $1.25 and is all-in
npAYqa85pqnzfOK5ukX+BQ: folds 
cMTFs4oCtNInkpDIecxT/w: calls $1
3FkcXBaxKqxYVagfYUZlmw: calls $1
FzknuThd6oNi5WfR7ciTfA: calls $1
s9a4d23HFxaL70yUWQ0/tQ: folds 
+lWbsq4dTcA70SX/+hnmpg: folds 
*** FLOP *** [4c Kc Kh]
cMTFs4oCtNInkpDIecxT/w: bets $0.25
3FkcXBaxKqxYVagfYUZlmw: folds 
FzknuThd6oNi5WfR7ciTfA: raises $1.25 to $1.50
cMTFs4oCtNInkpDIecxT/w: folds 
Uncalled bet ($1.25) returned to FzknuThd6oNi5WfR7ciTfA
*** TURN *** [4c Kc Kh] [6h]
*** RIVER *** [4c Kc Kh 6h] [9h]
*** SHOW DOWN ***
FzknuThd6oNi5WfR7ciTfA: shows [As 4s] (two pair, Kings and Fours)
FzknuThd6oNi5WfR7ciTfA collected $0.45 from side pot
L4arauLTM5DsCc2Y3lI8Yw: shows [Ts Th] (two pair, Kings and Tens)
L4arauLTM5DsCc2Y3lI8Yw collected $5.50 from main pot
*** SUMMARY ***
Total pot $6.25 Main pot $5.50. Side pot $0.45. | Rake $0.30 
Board [4c Kc Kh 6h 9h]
Seat 1: 3FkcXBaxKqxYVagfYUZlmw folded on the Flop
Seat 2: FzknuThd6oNi5WfR7ciTfA showed [As 4s] and won ($0.45) with two pair, Kings and Fours
Seat 3: s9a4d23HFxaL70yUWQ0/tQ folded before Flop
Seat 4: tbgfV2Egwn85xEt865GWQQ folded before Flop (didn't bet)
Seat 5: +lWbsq4dTcA70SX/+hnmpg folded before Flop
Seat 6: gMF+EMhmwpnaM5TFQquf2A (button) folded before Flop (didn't bet)
Seat 7: L4arauLTM5DsCc2Y3lI8Yw (small blind) showed [Ts Th] and won ($5.50) with two pair, Kings and Tens
Seat 8: npAYqa85pqnzfOK5ukX+BQ (big blind) folded before Flop
Seat 9: cMTFs4oCtNInkpDIecxT/w folded on the Flop




PokerStars Game #59941578878:  Hold'em No Limit ($0.10/$0.25) - 2009/07/01 1:39:43 ET
Table 'a6FCGVBMPcT7J7BDN9q1zQ' 9-max Seat #5 is the button
Seat 1: zgi+EUykT/pZQpoUG6+oEg ($5.15 in chips) 
Seat 2: M2QO2DxB5Wawg2h8HSpnYA ($10 in chips) 
Seat 3: tLcDklc2rBORNfixyRfVfw ($26.15 in chips) 
Seat 4: 8CoKLhwk8Ja6X+O9fxTEDg ($11.30 in chips) 
Seat 5: dtZ84flFEi4Q+SGrHMJRDQ ($27.05 in chips) 
Seat 6: dfNim92Z6XK1/h5SFW5vDg ($26 in chips) 
Seat 7: V0Yo5zRBVM8DYspLKafebg ($4.70 in chips) 
Seat 8: r6hsffOo1iKmaPYKwAZmFw ($69.40 in chips) 
Seat 9: wGigCmBR/9XWkPpvYos3aQ ($28.70 in chips) 
dfNim92Z6XK1/h5SFW5vDg: posts small blind $0.10
V0Yo5zRBVM8DYspLKafebg: posts big blind $0.25
*** HOLE CARDS ***
r6hsffOo1iKmaPYKwAZmFw: raises $4.45 to $4.70
wGigCmBR/9XWkPpvYos3aQ: folds 
zgi+EUykT/pZQpoUG6+oEg: folds 
M2QO2DxB5Wawg2h8HSpnYA: folds 
tLcDklc2rBORNfixyRfVfw: folds 
8CoKLhwk8Ja6X+O9fxTEDg: folds 
dtZ84flFEi4Q+SGrHMJRDQ: folds 
dfNim92Z6XK1/h5SFW5vDg: folds 
V0Yo5zRBVM8DYspLKafebg: folds 
Uncalled bet ($4.45) returned to r6hsffOo1iKmaPYKwAZmFw
r6hsffOo1iKmaPYKwAZmFw collected $0.60 from pot
r6hsffOo1iKmaPYKwAZmFw: doesn't show hand 
*** SUMMARY ***
Total pot $0.60 | Rake $0 
Seat 1: zgi+EUykT/pZQpoUG6+oEg folded before Flop (didn't bet)
Seat 2: M2QO2DxB5Wawg2h8HSpnYA folded before Flop (didn't bet)
Seat 3: tLcDklc2rBORNfixyRfVfw folded before Flop (didn't bet)
Seat 4: 8CoKLhwk8Ja6X+O9fxTEDg folded before Flop (didn't bet)
Seat 5: dtZ84flFEi4Q+SGrHMJRDQ (button) folded before Flop (didn't bet)
Seat 6: dfNim92Z6XK1/h5SFW5vDg (small blind) folded before Flop
Seat 7: V0Yo5zRBVM8DYspLKafebg (big blind) folded before Flop
Seat 8: r6hsffOo1iKmaPYKwAZmFw collected ($0.60)
Seat 9: wGigCmBR/9XWkPpvYos3aQ folded before Flop (didn't bet)




PokerStars Game #59941579154:  Hold'em No Limit ($0.10/$0.25) - 2009/07/01 1:39:43 ET
Table '2O5CgfSkSwrr4PDrlZ1RLQ' 6-max Seat #4 is the button
Seat 1: 3skmHD9EOATKdUzzyHh1KA ($29.40 in chips) 
Seat 2: wqphQtauX5Qn7WRJZS1flA ($25.70 in chips) 
Seat 3: oBUDUfeUyCbZBsjxHZgSiw ($30 in chips) 
Seat 4: 2Ga+TibtZsUCp1MLaueYVA ($25 in chips) 
Seat 5: 0av6tRNdi0Ui4f15L7gsVg ($23.40 in chips) 
Seat 6: tj9xqoqQaDaFw7u1oyZrtA ($41.15 in chips) 
0av6tRNdi0Ui4f15L7gsVg: posts small blind $0.10
tj9xqoqQaDaFw7u1oyZrtA: posts big blind $0.25
*** HOLE CARDS ***
3skmHD9EOATKdUzzyHh1KA: folds 
wqphQtauX5Qn7WRJZS1flA: folds 
oBUDUfeUyCbZBsjxHZgSiw: folds 
2Ga+TibtZsUCp1MLaueYVA: raises $0.60 to $0.85
0av6tRNdi0Ui4f15L7gsVg: calls $0.75
tj9xqoqQaDaFw7u1oyZrtA: raises $0.65 to $1.50
2Ga+TibtZsUCp1MLaueYVA: calls $0.65
0av6tRNdi0Ui4f15L7gsVg: calls $0.65
*** FLOP *** [Qc 4h 6h]
0av6tRNdi0Ui4f15L7gsVg: checks 
tj9xqoqQaDaFw7u1oyZrtA: bets $4.75
2Ga+TibtZsUCp1MLaueYVA: folds 
0av6tRNdi0Ui4f15L7gsVg: folds 
Uncalled bet ($4.75) returned to tj9xqoqQaDaFw7u1oyZrtA
tj9xqoqQaDaFw7u1oyZrtA collected $4.30 from pot
tj9xqoqQaDaFw7u1oyZrtA: doesn't show hand 
*** SUMMARY ***
Total pot $4.50 | Rake $0.20 
Board [Qc 4h 6h]
Seat 1: 3skmHD9EOATKdUzzyHh1KA folded before Flop (didn't bet)
Seat 2: wqphQtauX5Qn7WRJZS1flA folded before Flop (didn't bet)
Seat 3: oBUDUfeUyCbZBsjxHZgSiw folded before Flop (didn't bet)
Seat 4: 2Ga+TibtZsUCp1MLaueYVA (button) folded on the Flop
Seat 5: 0av6tRNdi0Ui4f15L7gsVg (small blind) folded on the Flop
Seat 6: tj9xqoqQaDaFw7u1oyZrtA (big blind) collected ($4.30)




PokerStars Game #59941579022:  Hold'em No Limit ($0.10/$0.25) - 2009/07/01 1:39:43 ET
Table 'KU/HrxqxwDz8HKEhYTZ6uw' 6-max Seat #3 is the button
Seat 1: 7LKoiQHXpTQXJvWQrw907g ($28.85 in chips) 
Seat 2: kG34n23qFQA3nzdOJTQ1dA ($22.10 in chips) 
Seat 3: SFmT9ZsVopnukjvAzrxTRg ($25.80 in chips) 
Seat 4: AGwMM0FUhYZf81+oXvYQMg ($25.15 in chips) 
Seat 5: iyZxqznXjv3vtvOJymkoLQ ($52 in chips) 
Seat 6: qWxkCeqApAWdAA0evrfDvQ ($17.95 in chips) 
AGwMM0FUhYZf81+oXvYQMg: posts small blind $0.10
iyZxqznXjv3vtvOJymkoLQ: posts big blind $0.25
*** HOLE CARDS ***
qWxkCeqApAWdAA0evrfDvQ: calls $0.25
7LKoiQHXpTQXJvWQrw907g: calls $0.25
kG34n23qFQA3nzdOJTQ1dA: folds 
SFmT9ZsVopnukjvAzrxTRg: folds 
AGwMM0FUhYZf81+oXvYQMg: calls $0.15
iyZxqznXjv3vtvOJymkoLQ: checks 
*** FLOP *** [3s Tc 5s]
AGwMM0FUhYZf81+oXvYQMg: checks 
iyZxqznXjv3vtvOJymkoLQ: checks 
qWxkCeqApAWdAA0evrfDvQ: checks 
7LKoiQHXpTQXJvWQrw907g: checks 
*** TURN *** [3s Tc 5s] [Qh]
AGwMM0FUhYZf81+oXvYQMg: checks 
iyZxqznXjv3vtvOJymkoLQ: checks 
qWxkCeqApAWdAA0evrfDvQ: checks 
7LKoiQHXpTQXJvWQrw907g: bets $0.75
AGwMM0FUhYZf81+oXvYQMg: folds 
iyZxqznXjv3vtvOJymkoLQ: calls $0.75
qWxkCeqApAWdAA0evrfDvQ: folds 
*** RIVER *** [3s Tc 5s Qh] [Qd]
iyZxqznXjv3vtvOJymkoLQ: checks 
7LKoiQHXpTQXJvWQrw907g: bets $1.50
iyZxqznXjv3vtvOJymkoLQ: folds 
Uncalled bet ($1.50) returned to 7LKoiQHXpTQXJvWQrw907g
7LKoiQHXpTQXJvWQrw907g collected $2.40 from pot
*** SUMMARY ***
Total pot $2.50 | Rake $0.10 
Board [3s Tc 5s Qh Qd]
Seat 1: 7LKoiQHXpTQXJvWQrw907g collected ($2.40)
Seat 2: kG34n23qFQA3nzdOJTQ1dA folded before Flop (didn't bet)
Seat 3: SFmT9ZsVopnukjvAzrxTRg (button) folded before Flop (didn't bet)
Seat 4: AGwMM0FUhYZf81+oXvYQMg (small blind) folded on the Turn
Seat 5: iyZxqznXjv3vtvOJymkoLQ (big blind) folded on the River
Seat 6: qWxkCeqApAWdAA0evrfDvQ folded on the Turn




PokerStars Game #59941578716:  Hold'em No Limit ($0.10/$0.25) - 2009/07/01 1:39:43 ET
Table 'mF3KHGMaTpaBZbtBoyfTeg' 6-max Seat #1 is the button
Seat 1: 0HAB2GdCAM7p7V00xueAVQ ($25.30 in chips) 
Seat 2: 6qsh9pnysDKJNhfFhFmKRQ ($9.50 in chips) 
Seat 3: 9kUKGKkblnIx3m8rlVol6Q ($15 in chips) 
Seat 4: FYepjhAvF8ZdVCmqHIy+eQ ($25 in chips) 
Seat 5: 8ClCHtFXGNplITm+63KB+Q ($42.50 in chips) 
Seat 6: kG34n23qFQA3nzdOJTQ1dA ($27.75 in chips) 
6qsh9pnysDKJNhfFhFmKRQ: posts small blind $0.10
9kUKGKkblnIx3m8rlVol6Q: posts big blind $0.25
*** HOLE CARDS ***
FYepjhAvF8ZdVCmqHIy+eQ: folds 
8ClCHtFXGNplITm+63KB+Q: folds 
kG34n23qFQA3nzdOJTQ1dA: calls $0.25
0HAB2GdCAM7p7V00xueAVQ: calls $0.25
6qsh9pnysDKJNhfFhFmKRQ: folds 
9kUKGKkblnIx3m8rlVol6Q: checks 
*** FLOP *** [4h Jd 6d]
9kUKGKkblnIx3m8rlVol6Q: checks 
kG34n23qFQA3nzdOJTQ1dA: checks 
0HAB2GdCAM7p7V00xueAVQ: bets $1.25
9kUKGKkblnIx3m8rlVol6Q: folds 
kG34n23qFQA3nzdOJTQ1dA: folds 
Uncalled bet ($1.25) returned to 0HAB2GdCAM7p7V00xueAVQ
0HAB2GdCAM7p7V00xueAVQ collected $0.85 from pot
0HAB2GdCAM7p7V00xueAVQ: doesn't show hand 
*** SUMMARY ***
Total pot $0.85 | Rake $0 
Board [4h Jd 6d]
Seat 1: 0HAB2GdCAM7p7V00xueAVQ (button) collected ($0.85)
Seat 2: 6qsh9pnysDKJNhfFhFmKRQ (small blind) folded before Flop
Seat 3: 9kUKGKkblnIx3m8rlVol6Q (big blind) folded on the Flop
Seat 4: FYepjhAvF8ZdVCmqHIy+eQ folded before Flop (didn't bet)
Seat 5: 8ClCHtFXGNplITm+63KB+Q folded before Flop (didn't bet)
Seat 6: kG34n23qFQA3nzdOJTQ1dA folded on the Flop




PokerStars Game #59941578680:  Hold'em No Limit ($0.10/$0.25) - 2009/07/01 1:39:43 ET
Table '60nA7av6bws9VnNmVwculA' 6-max Seat #3 is the button
Seat 1: if4dh6jhJXeN3/qd3qCp9g ($27.10 in chips) 
Seat 2: Bada343Si4xKu3fNXY99AA ($4.15 in chips) 
Seat 3: OUv909q/YxsJgxpSlZxLJQ ($30.50 in chips) 
Seat 4: +baiVgI/ETnBARLe5mARCw ($14.75 in chips) 
Seat 5: zXh+lOT41Q2iWgCNj+OcRw ($11.65 in chips) 
Seat 6: mfrkWA3PTeYPkbO6hi98Aw ($24.65 in chips) 
+baiVgI/ETnBARLe5mARCw: posts small blind $0.10
zXh+lOT41Q2iWgCNj+OcRw: posts big blind $0.25
*** HOLE CARDS ***
mfrkWA3PTeYPkbO6hi98Aw: folds 
if4dh6jhJXeN3/qd3qCp9g: folds 
Bada343Si4xKu3fNXY99AA: raises $0.50 to $0.75
OUv909q/YxsJgxpSlZxLJQ: folds 
+baiVgI/ETnBARLe5mARCw: calls $0.65
zXh+lOT41Q2iWgCNj+OcRw: folds 
*** FLOP *** [3d 8h Ac]
+baiVgI/ETnBARLe5mARCw: checks 
Bada343Si4xKu3fNXY99AA: bets $1
+baiVgI/ETnBARLe5mARCw: folds 
Uncalled bet ($1) returned to Bada343Si4xKu3fNXY99AA
Bada343Si4xKu3fNXY99AA collected $1.70 from pot
*** SUMMARY ***
Total pot $1.75 | Rake $0.05 
Board [3d 8h Ac]
Seat 1: if4dh6jhJXeN3/qd3qCp9g folded before Flop (didn't bet)
Seat 2: Bada343Si4xKu3fNXY99AA collected ($1.70)
Seat 3: OUv909q/YxsJgxpSlZxLJQ (button) folded before Flop (didn't bet)
Seat 4: +baiVgI/ETnBARLe5mARCw (small blind) folded on the Flop
Seat 5: zXh+lOT41Q2iWgCNj+OcRw (big blind) folded before Flop
Seat 6: mfrkWA3PTeYPkbO6hi98Aw folded before Flop (didn't bet)




PokerStars Game #59941578840:  Hold'em No Limit ($0.10/$0.25) - 2009/07/01 1:39:43 ET
Table 'Pz8SfAzhP5nvWTsJRAxoDg' 6-max Seat #5 is the button
Seat 1: QiL+lEgEWwy21jk/ltaRLg ($27.35 in chips) 
Seat 2: xrf8tAXKQHG99HixCot1Iw ($25.15 in chips) 
Seat 3: mfrkWA3PTeYPkbO6hi98Aw ($28.20 in chips) 
Seat 4: 4lJto+Qj0K4JrFKvHaPTLw ($35.70 in chips) 
Seat 5: FYepjhAvF8ZdVCmqHIy+eQ ($63.15 in chips) 
Seat 6: QvTX2yGq3uKJiKPmns4TKQ ($24.75 in chips) 
QvTX2yGq3uKJiKPmns4TKQ: posts small blind $0.10
QiL+lEgEWwy21jk/ltaRLg: posts big blind $0.25
*** HOLE CARDS ***
xrf8tAXKQHG99HixCot1Iw: folds 
mfrkWA3PTeYPkbO6hi98Aw: folds 
4lJto+Qj0K4JrFKvHaPTLw: raises $0.75 to $1
FYepjhAvF8ZdVCmqHIy+eQ: folds 
QvTX2yGq3uKJiKPmns4TKQ: folds 
QiL+lEgEWwy21jk/ltaRLg: calls $0.75
*** FLOP *** [Ts Qc Ad]
QiL+lEgEWwy21jk/ltaRLg: checks 
4lJto+Qj0K4JrFKvHaPTLw: bets $1
QiL+lEgEWwy21jk/ltaRLg: calls $1
*** TURN *** [Ts Qc Ad] [5s]
QiL+lEgEWwy21jk/ltaRLg: checks 
4lJto+Qj0K4JrFKvHaPTLw: bets $1.50
QiL+lEgEWwy21jk/ltaRLg: calls $1.50
*** RIVER *** [Ts Qc Ad 5s] [Jh]
QiL+lEgEWwy21jk/ltaRLg: bets $4
4lJto+Qj0K4JrFKvHaPTLw: raises $28.20 to $32.20 and is all-in
QiL+lEgEWwy21jk/ltaRLg: calls $19.85 and is all-in
Uncalled bet ($8.35) returned to 4lJto+Qj0K4JrFKvHaPTLw
*** SHOW DOWN ***
4lJto+Qj0K4JrFKvHaPTLw: shows [Kc Qh] (a straight, Ten to Ace)
QiL+lEgEWwy21jk/ltaRLg: shows [Th Kh] (a straight, Ten to Ace)
QiL+lEgEWwy21jk/ltaRLg collected $26.05 from pot
4lJto+Qj0K4JrFKvHaPTLw collected $26.05 from pot
*** SUMMARY ***
Total pot $54.80 | Rake $2.70 
Board [Ts Qc Ad 5s Jh]
Seat 1: QiL+lEgEWwy21jk/ltaRLg (big blind) showed [Th Kh] and won ($26.05) with a straight, Ten to Ace
Seat 2: xrf8tAXKQHG99HixCot1Iw folded before Flop (didn't bet)
Seat 3: mfrkWA3PTeYPkbO6hi98Aw folded before Flop (didn't bet)
Seat 4: 4lJto+Qj0K4JrFKvHaPTLw showed [Kc Qh] and won ($26.05) with a straight, Ten to Ace
Seat 5: FYepjhAvF8ZdVCmqHIy+eQ (button) folded before Flop (didn't bet)
Seat 6: QvTX2yGq3uKJiKPmns4TKQ (small blind) folded before Flop




PokerStars Game #59941579382:  Hold'em No Limit ($0.10/$0.25) - 2009/07/01 1:39:44 ET
Table 'IRgQPZVA4+IaZZIQshgwyg' 6-max Seat #6 is the button
Seat 1: cezpHJ8FB07dj0xG+LhOvw ($28 in chips) 
Seat 2: lquriepNQBhDV5P1SWHhnA ($25.35 in chips) 
Seat 3: DihMHaz4WNETH1bPDe13kA ($28.80 in chips) 
Seat 4: DE9hRlt14g+JdsRQ4wT7hg ($27.50 in chips) 
Seat 5: PbMzPZIePKifKQZfKDkbIw ($28.80 in chips) 
Seat 6: XbIIdTtuN1xO7zurECHBTg ($10.55 in chips) 
cezpHJ8FB07dj0xG+LhOvw: posts small blind $0.10
lquriepNQBhDV5P1SWHhnA: posts big blind $0.25
*** HOLE CARDS ***
DihMHaz4WNETH1bPDe13kA: folds 
DE9hRlt14g+JdsRQ4wT7hg: folds 
PbMzPZIePKifKQZfKDkbIw: raises $0.50 to $0.75
XbIIdTtuN1xO7zurECHBTg: calls $0.75
cezpHJ8FB07dj0xG+LhOvw: folds 
lquriepNQBhDV5P1SWHhnA: folds 
*** FLOP *** [Qh 8d 9c]
PbMzPZIePKifKQZfKDkbIw: checks 
XbIIdTtuN1xO7zurECHBTg: checks 
*** TURN *** [Qh 8d 9c] [2c]
PbMzPZIePKifKQZfKDkbIw: checks 
XbIIdTtuN1xO7zurECHBTg: checks 
*** RIVER *** [Qh 8d 9c 2c] [2d]
PbMzPZIePKifKQZfKDkbIw: checks 
XbIIdTtuN1xO7zurECHBTg: bets $0.50
PbMzPZIePKifKQZfKDkbIw: folds 
Uncalled bet ($0.50) returned to XbIIdTtuN1xO7zurECHBTg
XbIIdTtuN1xO7zurECHBTg collected $1.80 from pot
XbIIdTtuN1xO7zurECHBTg: doesn't show hand 
*** SUMMARY ***
Total pot $1.85 | Rake $0.05 
Board [Qh 8d 9c 2c 2d]
Seat 1: cezpHJ8FB07dj0xG+LhOvw (small blind) folded before Flop
Seat 2: lquriepNQBhDV5P1SWHhnA (big blind) folded before Flop
Seat 3: DihMHaz4WNETH1bPDe13kA folded before Flop (didn't bet)
Seat 4: DE9hRlt14g+JdsRQ4wT7hg folded before Flop (didn't bet)
Seat 5: PbMzPZIePKifKQZfKDkbIw folded on the River
Seat 6: XbIIdTtuN1xO7zurECHBTg (button) collected ($1.80)




PokerStars Game #59941579350:  Hold'em No Limit ($0.10/$0.25) - 2009/07/01 1:39:44 ET
Table '9o8Yb3JpUqurD4pNVmOikQ' 6-max Seat #6 is the button
Seat 1: SFmT9ZsVopnukjvAzrxTRg ($25.95 in chips) 
Seat 2: /gJNBeCkWL4o85/jvlZ4BA ($25 in chips) 
Seat 3: JgRqo1/2phbf7pab7N3BIQ ($21.50 in chips) 
Seat 4: j5NZbEJHsERuXjPHWqc1Nw ($8.75 in chips) 
Seat 5: L/ayP3FdbcybmfF6diPHaA ($18.80 in chips) 
Seat 6: LyDHtw3/yniNHW+DvLXbog ($26.05 in chips) 
SFmT9ZsVopnukjvAzrxTRg: posts small blind $0.10
/gJNBeCkWL4o85/jvlZ4BA: posts big blind $0.25
*** HOLE CARDS ***
JgRqo1/2phbf7pab7N3BIQ: calls $0.25
j5NZbEJHsERuXjPHWqc1Nw: folds 
L/ayP3FdbcybmfF6diPHaA: raises $0.75 to $1
LyDHtw3/yniNHW+DvLXbog: folds 
SFmT9ZsVopnukjvAzrxTRg: folds 
/gJNBeCkWL4o85/jvlZ4BA: folds 
JgRqo1/2phbf7pab7N3BIQ: calls $0.75
*** FLOP *** [6s 8s 9d]
JgRqo1/2phbf7pab7N3BIQ: checks 
L/ayP3FdbcybmfF6diPHaA: bets $1
JgRqo1/2phbf7pab7N3BIQ: raises $1 to $2
L/ayP3FdbcybmfF6diPHaA: calls $1
*** TURN *** [6s 8s 9d] [9h]
JgRqo1/2phbf7pab7N3BIQ: checks 
L/ayP3FdbcybmfF6diPHaA: checks 
*** RIVER *** [6s 8s 9d 9h] [8h]
JgRqo1/2phbf7pab7N3BIQ: checks 
L/ayP3FdbcybmfF6diPHaA: checks 
*** SHOW DOWN ***
JgRqo1/2phbf7pab7N3BIQ: shows [Qc Qh] (two pair, Queens and Nines)
L/ayP3FdbcybmfF6diPHaA: mucks hand 
JgRqo1/2phbf7pab7N3BIQ collected $6.05 from pot
*** SUMMARY ***
Total pot $6.35 | Rake $0.30 
Board [6s 8s 9d 9h 8h]
Seat 1: SFmT9ZsVopnukjvAzrxTRg (small blind) folded before Flop
Seat 2: /gJNBeCkWL4o85/jvlZ4BA (big blind) folded before Flop
Seat 3: JgRqo1/2phbf7pab7N3BIQ showed [Qc Qh] and won ($6.05) with two pair, Queens and Nines
Seat 4: j5NZbEJHsERuXjPHWqc1Nw folded before Flop (didn't bet)
Seat 5: L/ayP3FdbcybmfF6diPHaA mucked
Seat 6: LyDHtw3/yniNHW+DvLXbog (button) folded before Flop (didn't bet)




PokerStars Game #59941579522:  Hold'em No Limit ($0.10/$0.25) - 2009/07/01 1:39:44 ET
Table 'S6s+TmTlAjLHclBRvN5/fw' 9-max Seat #8 is the button
Seat 4: M/9j4wkHH9i1JM51vgi1VA ($25.35 in chips) 
Seat 5: z5GxcHlYz/GSz6W2uFiTtg ($39.70 in chips) 
Seat 6: aNpwfA31EREwO+ar4XzBCw ($29.40 in chips) 
Seat 7: vSkQm2EelzwRGDDQQk0Fqw ($4.80 in chips) 
Seat 8: OlPJsgR4xypSg/w1z7Gyvw ($21.40 in chips) 
Seat 9: H5Se03ZqSX7tbULXur2MAg ($22.85 in chips) 
H5Se03ZqSX7tbULXur2MAg: posts small blind $0.10
/XMgGtJ7mcWfe5s7McY9kw: is sitting out 
OfGfQFPcghysTDljS9GQSQ: is sitting out 
OfGfQFPcghysTDljS9GQSQ leaves the table
imHPFFqvfHGzsBBWeGuy4w: is sitting out 
M/9j4wkHH9i1JM51vgi1VA: posts big blind $0.25
*** HOLE CARDS ***
z5GxcHlYz/GSz6W2uFiTtg: folds 
imHPFFqvfHGzsBBWeGuy4w leaves the table
aNpwfA31EREwO+ar4XzBCw: raises $0.75 to $1
vSkQm2EelzwRGDDQQk0Fqw: folds 
OlPJsgR4xypSg/w1z7Gyvw: calls $1
/XMgGtJ7mcWfe5s7McY9kw leaves the table
H5Se03ZqSX7tbULXur2MAg: folds 
M/9j4wkHH9i1JM51vgi1VA: folds 
*** FLOP *** [7d 6d Kd]
aNpwfA31EREwO+ar4XzBCw: checks 
OlPJsgR4xypSg/w1z7Gyvw: checks 
*** TURN *** [7d 6d Kd] [8c]
aNpwfA31EREwO+ar4XzBCw: checks 
OlPJsgR4xypSg/w1z7Gyvw: bets $2
aNpwfA31EREwO+ar4XzBCw: folds 
Uncalled bet ($2) returned to OlPJsgR4xypSg/w1z7Gyvw
OlPJsgR4xypSg/w1z7Gyvw collected $2.25 from pot
*** SUMMARY ***
Total pot $2.35 | Rake $0.10 
Board [7d 6d Kd 8c]
Seat 4: M/9j4wkHH9i1JM51vgi1VA (big blind) folded before Flop
Seat 5: z5GxcHlYz/GSz6W2uFiTtg folded before Flop (didn't bet)
Seat 6: aNpwfA31EREwO+ar4XzBCw folded on the Turn
Seat 7: vSkQm2EelzwRGDDQQk0Fqw folded before Flop (didn't bet)
Seat 8: OlPJsgR4xypSg/w1z7Gyvw (button) collected ($2.25)
Seat 9: H5Se03ZqSX7tbULXur2MAg (small blind) folded before Flop




PokerStars Game #59941579450:  Hold'em No Limit ($0.10/$0.25) - 2009/07/01 1:39:44 ET
Table 'rtxA1Y01Nrq5VoyzTAuusQ' 9-max Seat #4 is the button
Seat 1: w1ukf8uPa4+WH561TtVRxA ($31.80 in chips) 
Seat 3: K9fS1IUr5GpiJG7VkJ7IbA ($5.90 in chips) 
Seat 4: lTfGgdGMRH+DZcKby2m9Nw ($14.20 in chips) 
Seat 5: MtVtHDqIJTyUcXkRBBDIVA ($26.40 in chips) 
Seat 7: 3PmVnC/15cl4oyI1TKIt4g ($4.65 in chips) 
Seat 8: DnDcAdn9P0zGovMERigpFA ($25 in chips) 
Seat 9: HPEB+AtKw1+C/cxU0o1ciw ($22.95 in chips) 
MtVtHDqIJTyUcXkRBBDIVA: posts small blind $0.10
qccGLncfUaN00Few5HsgYg: is sitting out 
3PmVnC/15cl4oyI1TKIt4g: posts big blind $0.25
Th3FldXKQW6hWVVPahaoOQ: sits out 
*** HOLE CARDS ***
DnDcAdn9P0zGovMERigpFA: folds 
HPEB+AtKw1+C/cxU0o1ciw: folds 
w1ukf8uPa4+WH561TtVRxA: folds 
K9fS1IUr5GpiJG7VkJ7IbA: raises $0.25 to $0.50
lTfGgdGMRH+DZcKby2m9Nw: folds 
MtVtHDqIJTyUcXkRBBDIVA: calls $0.40
3PmVnC/15cl4oyI1TKIt4g: folds 
*** FLOP *** [5h 3c Qh]
MtVtHDqIJTyUcXkRBBDIVA: checks 
K9fS1IUr5GpiJG7VkJ7IbA: checks 
*** TURN *** [5h 3c Qh] [Td]
MtVtHDqIJTyUcXkRBBDIVA: bets $0.50
K9fS1IUr5GpiJG7VkJ7IbA: calls $0.50
*** RIVER *** [5h 3c Qh Td] [Ah]
MtVtHDqIJTyUcXkRBBDIVA: bets $6.50
K9fS1IUr5GpiJG7VkJ7IbA: folds 
Uncalled bet ($6.50) returned to MtVtHDqIJTyUcXkRBBDIVA
MtVtHDqIJTyUcXkRBBDIVA collected $2.15 from pot
MtVtHDqIJTyUcXkRBBDIVA: doesn't show hand 
*** SUMMARY ***
Total pot $2.25 | Rake $0.10 
Board [5h 3c Qh Td Ah]
Seat 1: w1ukf8uPa4+WH561TtVRxA folded before Flop (didn't bet)
Seat 3: K9fS1IUr5GpiJG7VkJ7IbA folded on the River
Seat 4: lTfGgdGMRH+DZcKby2m9Nw (button) folded before Flop (didn't bet)
Seat 5: MtVtHDqIJTyUcXkRBBDIVA (small blind) collected ($2.15)
Seat 7: 3PmVnC/15cl4oyI1TKIt4g (big blind) folded before Flop
Seat 8: DnDcAdn9P0zGovMERigpFA folded before Flop (didn't bet)
Seat 9: HPEB+AtKw1+C/cxU0o1ciw folded before Flop (didn't bet)




PokerStars Game #59941579376:  Hold'em No Limit ($0.10/$0.25) - 2009/07/01 1:39:44 ET
Table 'n8mNkPYbe1AIQEkioNesZA' 9-max Seat #1 is the button
Seat 1: 9lvO/qyU+xrU95Teu1fv0g ($5.55 in chips) 
Seat 2: QEbIGci+itdw+re8RM5fZA ($30.15 in chips) 
Seat 3: zDrucyjVn5aeekNEc3cJrA ($19.35 in chips) 
Seat 4: zgi+EUykT/pZQpoUG6+oEg ($5.35 in chips) 
Seat 5: wGigCmBR/9XWkPpvYos3aQ ($29.15 in chips) 
Seat 6: HPEB+AtKw1+C/cxU0o1ciw ($46.55 in chips) 
Seat 7: sGFnnRCa1YAHAUmWgsW6Qg ($10 in chips) 
Seat 8: aNpwfA31EREwO+ar4XzBCw ($25.35 in chips) 
Seat 9: gehe91e0IyVT0QU/XBkEyg ($27.55 in chips) 
QEbIGci+itdw+re8RM5fZA: posts small blind $0.10
zDrucyjVn5aeekNEc3cJrA: posts big blind $0.25
*** HOLE CARDS ***
zgi+EUykT/pZQpoUG6+oEg: folds 
wGigCmBR/9XWkPpvYos3aQ: folds 
HPEB+AtKw1+C/cxU0o1ciw: raises $0.75 to $1
sGFnnRCa1YAHAUmWgsW6Qg: folds 
aNpwfA31EREwO+ar4XzBCw: folds 
gehe91e0IyVT0QU/XBkEyg: folds 
9lvO/qyU+xrU95Teu1fv0g: folds 
QEbIGci+itdw+re8RM5fZA: folds 
zDrucyjVn5aeekNEc3cJrA: folds 
Uncalled bet ($0.75) returned to HPEB+AtKw1+C/cxU0o1ciw
HPEB+AtKw1+C/cxU0o1ciw collected $0.60 from pot
HPEB+AtKw1+C/cxU0o1ciw: doesn't show hand 
*** SUMMARY ***
Total pot $0.60 | Rake $0 
Seat 1: 9lvO/qyU+xrU95Teu1fv0g (button) folded before Flop (didn't bet)
Seat 2: QEbIGci+itdw+re8RM5fZA (small blind) folded before Flop
Seat 3: zDrucyjVn5aeekNEc3cJrA (big blind) folded before Flop
Seat 4: zgi+EUykT/pZQpoUG6+oEg folded before Flop (didn't bet)
Seat 5: wGigCmBR/9XWkPpvYos3aQ folded before Flop (didn't bet)
Seat 6: HPEB+AtKw1+C/cxU0o1ciw collected ($0.60)
Seat 7: sGFnnRCa1YAHAUmWgsW6Qg folded before Flop (didn't bet)
Seat 8: aNpwfA31EREwO+ar4XzBCw folded before Flop (didn't bet)
Seat 9: gehe91e0IyVT0QU/XBkEyg folded before Flop (didn't bet)




PokerStars Game #59941579686:  Hold'em No Limit ($0.10/$0.25) - 2009/07/01 1:39:44 ET
Table '9lYs7ljXi6AgFAxYHlKLJw' 9-max Seat #6 is the button
Seat 1: K0b5wNInj6hUGRr6yzKFtw ($33.90 in chips) 
Seat 3: arxNSjreDRGFg13EAM2F1w ($31.30 in chips) 
Seat 4: UANt6y/SmDCY/jIxkBixcw ($34.10 in chips) 
Seat 5: dfNim92Z6XK1/h5SFW5vDg ($52.70 in chips) 
Seat 6: tYsOBqdU1+x+yFI7zHO7hQ ($25.95 in chips) 
Seat 7: ghNKXUBl/H+t83JF079ZBA ($27.15 in chips) 
Seat 8: 9YN2IkT2JYYKFErZtZvCtA ($22.60 in chips) 
Seat 9: cKlmpQMahVsmOaxFQDcoOg ($20 in chips) 
ghNKXUBl/H+t83JF079ZBA: posts small blind $0.10
9YN2IkT2JYYKFErZtZvCtA: posts big blind $0.25
0XACOSNrAWmqNv9k1nF8rw: sits out 
*** HOLE CARDS ***
cKlmpQMahVsmOaxFQDcoOg: folds 
K0b5wNInj6hUGRr6yzKFtw: folds 
arxNSjreDRGFg13EAM2F1w: folds 
UANt6y/SmDCY/jIxkBixcw: folds 
dfNim92Z6XK1/h5SFW5vDg: folds 
tYsOBqdU1+x+yFI7zHO7hQ: folds 
ghNKXUBl/H+t83JF079ZBA: folds 
Uncalled bet ($0.15) returned to 9YN2IkT2JYYKFErZtZvCtA
9YN2IkT2JYYKFErZtZvCtA collected $0.20 from pot
9YN2IkT2JYYKFErZtZvCtA: doesn't show hand 
*** SUMMARY ***
Total pot $0.20 | Rake $0 
Seat 1: K0b5wNInj6hUGRr6yzKFtw folded before Flop (didn't bet)
Seat 3: arxNSjreDRGFg13EAM2F1w folded before Flop (didn't bet)
Seat 4: UANt6y/SmDCY/jIxkBixcw folded before Flop (didn't bet)
Seat 5: dfNim92Z6XK1/h5SFW5vDg folded before Flop (didn't bet)
Seat 6: tYsOBqdU1+x+yFI7zHO7hQ (button) folded before Flop (didn't bet)
Seat 7: ghNKXUBl/H+t83JF079ZBA (small blind) folded before Flop
Seat 8: 9YN2IkT2JYYKFErZtZvCtA (big blind) collected ($0.20)
Seat 9: cKlmpQMahVsmOaxFQDcoOg folded before Flop (didn't bet)




PokerStars Game #59941579384:  Hold'em No Limit ($0.10/$0.25) - 2009/07/01 1:39:44 ET
Table 'IUwZ/e0bDHZPgsIWx0RnNg' 6-max Seat #4 is the button
Seat 2: mvFHK3pE7tCxJEqLjKC70Q ($55.40 in chips) 
Seat 3: dOX4wnYV2sEqvDbF+8KSCw ($25 in chips) 
Seat 4: IyZ9SVxKy7TJvRGFneWTMg ($24.20 in chips) 
Seat 5: kv2o5BKCLOrJIw4oc083jQ ($29.50 in chips) 
Seat 6: NhUN/JpAprdJeamFBgJH1w ($40.10 in chips) 
kv2o5BKCLOrJIw4oc083jQ: posts small blind $0.10
NhUN/JpAprdJeamFBgJH1w: posts big blind $0.25
*** HOLE CARDS ***
mvFHK3pE7tCxJEqLjKC70Q: folds 
dOX4wnYV2sEqvDbF+8KSCw: folds 
IyZ9SVxKy7TJvRGFneWTMg: folds 
kv2o5BKCLOrJIw4oc083jQ: calls $0.15
NhUN/JpAprdJeamFBgJH1w: raises $1 to $1.25
kv2o5BKCLOrJIw4oc083jQ: folds 
Uncalled bet ($1) returned to NhUN/JpAprdJeamFBgJH1w
NhUN/JpAprdJeamFBgJH1w collected $0.50 from pot
NhUN/JpAprdJeamFBgJH1w: doesn't show hand 
*** SUMMARY ***
Total pot $0.50 | Rake $0 
Seat 2: mvFHK3pE7tCxJEqLjKC70Q folded before Flop (didn't bet)
Seat 3: dOX4wnYV2sEqvDbF+8KSCw folded before Flop (didn't bet)
Seat 4: IyZ9SVxKy7TJvRGFneWTMg (button) folded before Flop (didn't bet)
Seat 5: kv2o5BKCLOrJIw4oc083jQ (small blind) folded before Flop
Seat 6: NhUN/JpAprdJeamFBgJH1w (big blind) collected ($0.50)




PokerStars Game #59941579208:  Hold'em No Limit ($0.10/$0.25) - 2009/07/01 1:39:44 ET
Table 'fHv1Mk7ZbLjprZTGWKPiEQ' 6-max Seat #5 is the button
Seat 3: /gJNBeCkWL4o85/jvlZ4BA ($25.35 in chips) 
Seat 4: TSmua8tGK3sTbwi0ynrW9Q ($53.25 in chips) 
Seat 5: LJI7A1YgDM7hgh7o56+ReQ ($26.80 in chips) 
Seat 6: AjG0X+rNtc2W08eph8oqpw ($35.25 in chips) 
AjG0X+rNtc2W08eph8oqpw: posts small blind $0.10
/gJNBeCkWL4o85/jvlZ4BA: posts big blind $0.25
*** HOLE CARDS ***
TSmua8tGK3sTbwi0ynrW9Q: raises $0.75 to $1
LJI7A1YgDM7hgh7o56+ReQ: raises $2.50 to $3.50
AjG0X+rNtc2W08eph8oqpw: folds 
/gJNBeCkWL4o85/jvlZ4BA: folds 
arewedunces joins the table at seat #2 
TSmua8tGK3sTbwi0ynrW9Q: folds 
Uncalled bet ($2.50) returned to LJI7A1YgDM7hgh7o56+ReQ
LJI7A1YgDM7hgh7o56+ReQ collected $2.35 from pot
LJI7A1YgDM7hgh7o56+ReQ: doesn't show hand 
*** SUMMARY ***
Total pot $2.35 | Rake $0 
Seat 3: /gJNBeCkWL4o85/jvlZ4BA (big blind) folded before Flop
Seat 4: TSmua8tGK3sTbwi0ynrW9Q folded before Flop
Seat 5: LJI7A1YgDM7hgh7o56+ReQ (button) collected ($2.35)
Seat 6: AjG0X+rNtc2W08eph8oqpw (small blind) folded before Flop




PokerStars Game #59941579790:  Hold'em No Limit ($0.10/$0.25) - 2009/07/01 1:39:45 ET
Table 'sDHjMRwfSiz7+NDdZLUiyA' 9-max Seat #9 is the button
Seat 1: VGwr1eqhvdUtMfBFCvBnmg ($9.50 in chips) 
Seat 2: ljemhp25Zg+nlA9DLCIiUw ($25.95 in chips) 
Seat 3: SGA1WpAnQxFdFAYyt362gQ ($17.15 in chips) 
Seat 4: eK8qa6EPcH2zhtbmWSvc9g ($25.45 in chips) 
Seat 5: IGRfskE1v9H9Bn+fz8AgNQ ($37.40 in chips) 
Seat 7: K0b5wNInj6hUGRr6yzKFtw ($37.65 in chips) 
Seat 8: 3hMkm4U5yTRrkGJkxfijaQ ($5.15 in chips) 
Seat 9: 3PmVnC/15cl4oyI1TKIt4g ($4.30 in chips) 
VGwr1eqhvdUtMfBFCvBnmg: posts small blind $0.10
ljemhp25Zg+nlA9DLCIiUw: posts big blind $0.25
*** HOLE CARDS ***
1qa0qHOCKZM3Uipx9DxYtQ has returned
SGA1WpAnQxFdFAYyt362gQ: folds 
eK8qa6EPcH2zhtbmWSvc9g: folds 
IGRfskE1v9H9Bn+fz8AgNQ: folds 
K0b5wNInj6hUGRr6yzKFtw: folds 
3hMkm4U5yTRrkGJkxfijaQ: folds 
3PmVnC/15cl4oyI1TKIt4g: folds 
VGwr1eqhvdUtMfBFCvBnmg: calls $0.15
ljemhp25Zg+nlA9DLCIiUw: raises $0.75 to $1
VGwr1eqhvdUtMfBFCvBnmg: calls $0.75
*** FLOP *** [3c 5c 8d]
VGwr1eqhvdUtMfBFCvBnmg: checks 
ljemhp25Zg+nlA9DLCIiUw: bets $1.25
VGwr1eqhvdUtMfBFCvBnmg: folds 
Uncalled bet ($1.25) returned to ljemhp25Zg+nlA9DLCIiUw
ljemhp25Zg+nlA9DLCIiUw collected $1.90 from pot
ljemhp25Zg+nlA9DLCIiUw: doesn't show hand 
*** SUMMARY ***
Total pot $2 | Rake $0.10 
Board [3c 5c 8d]
Seat 1: VGwr1eqhvdUtMfBFCvBnmg (small blind) folded on the Flop
Seat 2: ljemhp25Zg+nlA9DLCIiUw (big blind) collected ($1.90)
Seat 3: SGA1WpAnQxFdFAYyt362gQ folded before Flop (didn't bet)
Seat 4: eK8qa6EPcH2zhtbmWSvc9g folded before Flop (didn't bet)
Seat 5: IGRfskE1v9H9Bn+fz8AgNQ folded before Flop (didn't bet)
Seat 7: K0b5wNInj6hUGRr6yzKFtw folded before Flop (didn't bet)
Seat 8: 3hMkm4U5yTRrkGJkxfijaQ folded before Flop (didn't bet)
Seat 9: 3PmVnC/15cl4oyI1TKIt4g (button) folded before Flop (didn't bet)




PokerStars Game #59941579826:  Hold'em No Limit ($0.10/$0.25) - 2009/07/01 1:39:45 ET
Table 'srBTB98reCdD1TffxE6o7g' 6-max Seat #5 is the button
Seat 1: SFmT9ZsVopnukjvAzrxTRg ($33.95 in chips) 
Seat 3: VOmI0x4dDPnTESZd5B4d1Q ($48.20 in chips) 
Seat 4: 6DwBRH+xZ12AAZmeAg+aXw ($21.30 in chips) 
Seat 5: 8zUCJvLYLFM8AG6K5zjIvg ($12.30 in chips) 
Seat 6: BV+K0Phf5VBHr7aZPKqbUQ ($30.95 in chips) 
BV+K0Phf5VBHr7aZPKqbUQ: posts small blind $0.10
SFmT9ZsVopnukjvAzrxTRg: posts big blind $0.25
mfrkWA3PTeYPkbO6hi98Aw: sits out 
*** HOLE CARDS ***
VOmI0x4dDPnTESZd5B4d1Q: folds 
6DwBRH+xZ12AAZmeAg+aXw: folds 
8zUCJvLYLFM8AG6K5zjIvg: folds 
BV+K0Phf5VBHr7aZPKqbUQ: raises $0.75 to $1
SFmT9ZsVopnukjvAzrxTRg: folds 
Uncalled bet ($0.75) returned to BV+K0Phf5VBHr7aZPKqbUQ
BV+K0Phf5VBHr7aZPKqbUQ collected $0.50 from pot
BV+K0Phf5VBHr7aZPKqbUQ: doesn't show hand 
*** SUMMARY ***
Total pot $0.50 | Rake $0 
Seat 1: SFmT9ZsVopnukjvAzrxTRg (big blind) folded before Flop
Seat 3: VOmI0x4dDPnTESZd5B4d1Q folded before Flop (didn't bet)
Seat 4: 6DwBRH+xZ12AAZmeAg+aXw folded before Flop (didn't bet)
Seat 5: 8zUCJvLYLFM8AG6K5zjIvg (button) folded before Flop (didn't bet)
Seat 6: BV+K0Phf5VBHr7aZPKqbUQ (small blind) collected ($0.50)




PokerStars Game #59941580092:  Hold'em No Limit ($0.10/$0.25) - 2009/07/01 1:39:45 ET
Table 'KEoOIegxPF91KooL2AelUA' 6-max Seat #1 is the button
Seat 1: wsP46AGpqDjHZQmlRHKa9g ($40.30 in chips) 
Seat 3: zxeVQGaMKDsDzmSY+AInjA ($12.90 in chips) 
Seat 4: Wo60l2GQnSEc3bxPVyvIUw ($22.35 in chips) 
Seat 5: 08V++DOqzaNrRNsHIwi25w ($41.40 in chips) 
Seat 6: AMrBn4Vx9aAo/vv6WHLk6w ($3.65 in chips) 
0Bg59Tnte1Tc7C4i9Jd9cQ will be allowed to play after the button
zxeVQGaMKDsDzmSY+AInjA: posts small blind $0.10
Wo60l2GQnSEc3bxPVyvIUw: posts big blind $0.25
*** HOLE CARDS ***
08V++DOqzaNrRNsHIwi25w: raises $0.75 to $1
AMrBn4Vx9aAo/vv6WHLk6w: folds 
wsP46AGpqDjHZQmlRHKa9g: folds 
zxeVQGaMKDsDzmSY+AInjA: folds 
Wo60l2GQnSEc3bxPVyvIUw: calls $0.75
*** FLOP *** [Ac 6d Td]
Wo60l2GQnSEc3bxPVyvIUw: checks 
08V++DOqzaNrRNsHIwi25w: bets $2
Wo60l2GQnSEc3bxPVyvIUw: calls $2
*** TURN *** [Ac 6d Td] [Kc]
Wo60l2GQnSEc3bxPVyvIUw: checks 
08V++DOqzaNrRNsHIwi25w: bets $4.50
Wo60l2GQnSEc3bxPVyvIUw: folds 
Uncalled bet ($4.50) returned to 08V++DOqzaNrRNsHIwi25w
08V++DOqzaNrRNsHIwi25w collected $5.80 from pot
08V++DOqzaNrRNsHIwi25w: doesn't show hand 
*** SUMMARY ***
Total pot $6.10 | Rake $0.30 
Board [Ac 6d Td Kc]
Seat 1: wsP46AGpqDjHZQmlRHKa9g (button) folded before Flop (didn't bet)
Seat 3: zxeVQGaMKDsDzmSY+AInjA (small blind) folded before Flop
Seat 4: Wo60l2GQnSEc3bxPVyvIUw (big blind) folded on the Turn
Seat 5: 08V++DOqzaNrRNsHIwi25w collected ($5.80)
Seat 6: AMrBn4Vx9aAo/vv6WHLk6w folded before Flop (didn't bet)




PokerStars Game #59941579994:  Hold'em No Limit ($0.10/$0.25) - 2009/07/01 1:39:45 ET
Table 'aisAlB9GIV21BwfUW3+Nbg' 9-max Seat #3 is the button
Seat 1: SqibpGx+lf+brY0fJVvD0w ($24.65 in chips) 
Seat 2: +7GnIVpCmyuij3NJfOgsTw ($12.40 in chips) 
Seat 3: CvL9Ch1HYCVbTsfpNucitg ($4.80 in chips) 
Seat 4: sD+TKtt36XiiN6jqHiLwDA ($26.30 in chips) 
Seat 5: ghNKXUBl/H+t83JF079ZBA ($27.75 in chips) 
Seat 6: 9gmYYQesalMrUjaF7nKfrQ ($16.55 in chips) 
Seat 7: jGjM+5lCSe6f2MEwxQGOAg ($38.05 in chips) 
Seat 8: VWUWpMLMj/Q1jRVpF7Aohw ($12.50 in chips) 
Seat 9: N0hGpTAEAj9k5msS6LPLAw ($10.75 in chips) 
sD+TKtt36XiiN6jqHiLwDA: posts small blind $0.10
ghNKXUBl/H+t83JF079ZBA: posts big blind $0.25
*** HOLE CARDS ***
9gmYYQesalMrUjaF7nKfrQ: folds 
jGjM+5lCSe6f2MEwxQGOAg: raises $0.25 to $0.50
VWUWpMLMj/Q1jRVpF7Aohw: folds 
N0hGpTAEAj9k5msS6LPLAw: folds 
SqibpGx+lf+brY0fJVvD0w: folds 
+7GnIVpCmyuij3NJfOgsTw: calls $0.50
CvL9Ch1HYCVbTsfpNucitg: folds 
sD+TKtt36XiiN6jqHiLwDA: folds 
ghNKXUBl/H+t83JF079ZBA: folds 
*** FLOP *** [5s 6c 6s]
jGjM+5lCSe6f2MEwxQGOAg: bets $0.75
+7GnIVpCmyuij3NJfOgsTw: raises $1.25 to $2
jGjM+5lCSe6f2MEwxQGOAg: folds 
Uncalled bet ($1.25) returned to +7GnIVpCmyuij3NJfOgsTw
+7GnIVpCmyuij3NJfOgsTw collected $2.75 from pot
+7GnIVpCmyuij3NJfOgsTw: doesn't show hand 
*** SUMMARY ***
Total pot $2.85 | Rake $0.10 
Board [5s 6c 6s]
Seat 1: SqibpGx+lf+brY0fJVvD0w folded before Flop (didn't bet)
Seat 2: +7GnIVpCmyuij3NJfOgsTw collected ($2.75)
Seat 3: CvL9Ch1HYCVbTsfpNucitg (button) folded before Flop (didn't bet)
Seat 4: sD+TKtt36XiiN6jqHiLwDA (small blind) folded before Flop
Seat 5: ghNKXUBl/H+t83JF079ZBA (big blind) folded before Flop
Seat 6: 9gmYYQesalMrUjaF7nKfrQ folded before Flop (didn't bet)
Seat 7: jGjM+5lCSe6f2MEwxQGOAg folded on the Flop
Seat 8: VWUWpMLMj/Q1jRVpF7Aohw folded before Flop (didn't bet)
Seat 9: N0hGpTAEAj9k5msS6LPLAw folded before Flop (didn't bet)




PokerStars Game #59941579778:  Hold'em No Limit ($0.10/$0.25) - 2009/07/01 1:39:45 ET
Table 'z2yOdY2zyGWG1gh9WV9XtQ' 9-max Seat #6 is the button
Seat 1: 7je+LC5Mfs6nL8YBVh4frQ ($5 in chips) 
Seat 2: bXpVeaSTPBFSPJmeXxO7nw ($5 in chips) 
Seat 3: X78b5v/uhqeXXoAijbw/yg ($27.40 in chips) 
Seat 4: 4awUyiDYTgylQKXZ9faBVA ($39.45 in chips) 
Seat 5: W6tExOcYX7qiy6Qdp+ZwFA ($10.55 in chips) 
Seat 6: NBYmTySMtIicyMj5Vjzqhw ($21.80 in chips) 
Seat 7: zDrucyjVn5aeekNEc3cJrA ($23.45 in chips) 
Seat 8: Mh2r9hTeTEDnh19sRZtW3g ($7.50 in chips) 
Seat 9: wGigCmBR/9XWkPpvYos3aQ ($34.05 in chips) 
zDrucyjVn5aeekNEc3cJrA: posts small blind $0.10
Mh2r9hTeTEDnh19sRZtW3g: posts big blind $0.25
*** HOLE CARDS ***
wGigCmBR/9XWkPpvYos3aQ: folds 
7je+LC5Mfs6nL8YBVh4frQ: folds 
bXpVeaSTPBFSPJmeXxO7nw: folds 
X78b5v/uhqeXXoAijbw/yg: raises $0.75 to $1
4awUyiDYTgylQKXZ9faBVA: folds 
W6tExOcYX7qiy6Qdp+ZwFA: folds 
NBYmTySMtIicyMj5Vjzqhw: folds 
zDrucyjVn5aeekNEc3cJrA: folds 
Mh2r9hTeTEDnh19sRZtW3g: folds 
Uncalled bet ($0.75) returned to X78b5v/uhqeXXoAijbw/yg
X78b5v/uhqeXXoAijbw/yg collected $0.60 from pot
*** SUMMARY ***
Total pot $0.60 | Rake $0 
Seat 1: 7je+LC5Mfs6nL8YBVh4frQ folded before Flop (didn't bet)
Seat 2: bXpVeaSTPBFSPJmeXxO7nw folded before Flop (didn't bet)
Seat 3: X78b5v/uhqeXXoAijbw/yg collected ($0.60)
Seat 4: 4awUyiDYTgylQKXZ9faBVA folded before Flop (didn't bet)
Seat 5: W6tExOcYX7qiy6Qdp+ZwFA folded before Flop (didn't bet)
Seat 6: NBYmTySMtIicyMj5Vjzqhw (button) folded before Flop (didn't bet)
Seat 7: zDrucyjVn5aeekNEc3cJrA (small blind) folded before Flop
Seat 8: Mh2r9hTeTEDnh19sRZtW3g (big blind) folded before Flop
Seat 9: wGigCmBR/9XWkPpvYos3aQ folded before Flop (didn't bet)




PokerStars Game #59941580224:  Hold'em No Limit ($0.10/$0.25) - 2009/07/01 1:39:45 ET
Table 'nB7Q7zfNfy6ig6DB+rsgWQ' 6-max Seat #4 is the button
Seat 1: Hzy03WtPHMYwLYM7hTTxQw ($25.15 in chips) 
Seat 2: 4BHo0wlX9INjkj2727qE0w ($32.25 in chips) 
Seat 3: p3NYOxYhkL7txPRSeXHDeg ($31.30 in chips) 
Seat 4: DihMHaz4WNETH1bPDe13kA ($25 in chips) 
Seat 5: D2qb0DD9hycFaE/pJ6JNng ($4.90 in chips) 
Seat 6: MEGIwX0eHRUj63lwYaNhVg ($10.45 in chips) 
D2qb0DD9hycFaE/pJ6JNng: posts small blind $0.10
MEGIwX0eHRUj63lwYaNhVg: posts big blind $0.25
*** HOLE CARDS ***
Hzy03WtPHMYwLYM7hTTxQw: raises $0.50 to $0.75
4BHo0wlX9INjkj2727qE0w: calls $0.75
p3NYOxYhkL7txPRSeXHDeg: folds 
DihMHaz4WNETH1bPDe13kA: calls $0.75
D2qb0DD9hycFaE/pJ6JNng: calls $0.65
MEGIwX0eHRUj63lwYaNhVg: calls $0.50
*** FLOP *** [5s 7s 8s]
D2qb0DD9hycFaE/pJ6JNng: checks 
MEGIwX0eHRUj63lwYaNhVg: checks 
Hzy03WtPHMYwLYM7hTTxQw: bets $2.75
4BHo0wlX9INjkj2727qE0w: raises $25.75 to $28.50
DihMHaz4WNETH1bPDe13kA: calls $24.25 and is all-in
D2qb0DD9hycFaE/pJ6JNng: calls $4.15 and is all-in
MEGIwX0eHRUj63lwYaNhVg: folds 
Hzy03WtPHMYwLYM7hTTxQw: calls $21.65 and is all-in
Uncalled bet ($4.10) returned to 4BHo0wlX9INjkj2727qE0w
*** TURN *** [5s 7s 8s] [Ah]
*** RIVER *** [5s 7s 8s Ah] [Jh]
*** SHOW DOWN ***
Hzy03WtPHMYwLYM7hTTxQw: shows [8c 8h] (three of a kind, Eights)
4BHo0wlX9INjkj2727qE0w: mucks hand 
Hzy03WtPHMYwLYM7hTTxQw collected $0.30 from side pot-2 
DihMHaz4WNETH1bPDe13kA: shows [Ks Ts] (a flush, King high)
DihMHaz4WNETH1bPDe13kA collected $58.30 from side pot-1 
D2qb0DD9hycFaE/pJ6JNng: shows [Js 6s] (a flush, Jack high)
DihMHaz4WNETH1bPDe13kA collected $19.35 from main pot
*** SUMMARY ***
Total pot $80.95 Main pot $19.35. Side pot-1 $58.30. Side pot-2 $0.30. | Rake $3 
Board [5s 7s 8s Ah Jh]
Seat 1: Hzy03WtPHMYwLYM7hTTxQw showed [8c 8h] and won ($0.30) with three of a kind, Eights
Seat 2: 4BHo0wlX9INjkj2727qE0w mucked
Seat 3: p3NYOxYhkL7txPRSeXHDeg folded before Flop (didn't bet)
Seat 4: DihMHaz4WNETH1bPDe13kA (button) showed [Ks Ts] and won ($77.65) with a flush, King high
Seat 5: D2qb0DD9hycFaE/pJ6JNng (small blind) showed [Js 6s] and lost with a flush, Jack high
Seat 6: MEGIwX0eHRUj63lwYaNhVg (big blind) folded on the Flop




PokerStars Game #59941579926:  Hold'em No Limit ($0.10/$0.25) - 2009/07/01 1:39:45 ET
Table 'QegsWX65l3n/K0A8XB78yg' 6-max Seat #4 is the button
Seat 1: p6adJRMXMBLr+xtQzqazIQ ($15.20 in chips) 
Seat 2: GC/9yVD59DUCX7hUI7gcLw ($48.15 in chips) 
Seat 3: 1lxYIAoJdZwAbzIkzWmSkw ($2.75 in chips) 
Seat 4: mFv3iBCtrw9XfCDRB0d46Q ($4.30 in chips) 
Seat 5: OMGl+YMGogf2JWIRfT2/Yg ($12.75 in chips) 
Seat 6: 5PWs02z65jSO5pr/M6wx/w ($4.85 in chips) 
OMGl+YMGogf2JWIRfT2/Yg: posts small blind $0.10
5PWs02z65jSO5pr/M6wx/w: posts big blind $0.25
*** HOLE CARDS ***
p6adJRMXMBLr+xtQzqazIQ: raises $0.75 to $1
GC/9yVD59DUCX7hUI7gcLw: folds 
1lxYIAoJdZwAbzIkzWmSkw: folds 
mFv3iBCtrw9XfCDRB0d46Q: raises $3.30 to $4.30 and is all-in
OMGl+YMGogf2JWIRfT2/Yg: folds 
5PWs02z65jSO5pr/M6wx/w: folds 
p6adJRMXMBLr+xtQzqazIQ: calls $3.30
*** FLOP *** [2c Ks 9s]
*** TURN *** [2c Ks 9s] [8d]
*** RIVER *** [2c Ks 9s 8d] [Tc]
*** SHOW DOWN ***
p6adJRMXMBLr+xtQzqazIQ: shows [7h 7s] (a pair of Sevens)
mFv3iBCtrw9XfCDRB0d46Q: shows [Qc Qd] (a pair of Queens)
mFv3iBCtrw9XfCDRB0d46Q collected $8.55 from pot
*** SUMMARY ***
Total pot $8.95 | Rake $0.40 
Board [2c Ks 9s 8d Tc]
Seat 1: p6adJRMXMBLr+xtQzqazIQ showed [7h 7s] and lost with a pair of Sevens
Seat 2: GC/9yVD59DUCX7hUI7gcLw folded before Flop (didn't bet)
Seat 3: 1lxYIAoJdZwAbzIkzWmSkw folded before Flop (didn't bet)
Seat 4: mFv3iBCtrw9XfCDRB0d46Q (button) showed [Qc Qd] and won ($8.55) with a pair of Queens
Seat 5: OMGl+YMGogf2JWIRfT2/Yg (small blind) folded before Flop
Seat 6: 5PWs02z65jSO5pr/M6wx/w (big blind) folded before Flop




PokerStars Game #59941579836:  Hold'em No Limit ($0.10/$0.25) - 2009/07/01 1:39:45 ET
Table '/AhP8uWRzEEhOATYIdmn0A' 9-max Seat #2 is the button
Seat 1: +sbyWwIcFp9kP0bDtMegfQ ($38.30 in chips) 
Seat 2: nx5EoCNZFR03YUOXyT22wQ ($17.30 in chips) 
Seat 3: jx6dnobNHstDG0tabsbKHQ ($3.40 in chips) 
Seat 4: bXpVeaSTPBFSPJmeXxO7nw ($5 in chips) 
Seat 8: K86cg2ifCMFAlmzsfTDjig ($25 in chips) 
Seat 9: uvfXVx90QtCYG4geTioN+A ($62 in chips) 
jx6dnobNHstDG0tabsbKHQ: posts small blind $0.10
bXpVeaSTPBFSPJmeXxO7nw: posts big blind $0.25
8EbrQ/EvFWt2cr0GaU82gQ: sits out 
cZ99hugmLBj9KhTlc8nCSw: sits out 
*** HOLE CARDS ***
K86cg2ifCMFAlmzsfTDjig has timed out
K86cg2ifCMFAlmzsfTDjig: folds 
K86cg2ifCMFAlmzsfTDjig is sitting out
uvfXVx90QtCYG4geTioN+A: raises $0.25 to $0.50
+sbyWwIcFp9kP0bDtMegfQ: calls $0.50
K86cg2ifCMFAlmzsfTDjig has returned
nx5EoCNZFR03YUOXyT22wQ: folds 
jx6dnobNHstDG0tabsbKHQ: folds 
bXpVeaSTPBFSPJmeXxO7nw: raises $4.50 to $5 and is all-in
uvfXVx90QtCYG4geTioN+A: folds 
+sbyWwIcFp9kP0bDtMegfQ: folds 
Uncalled bet ($4.50) returned to bXpVeaSTPBFSPJmeXxO7nw
uvfXVx90QtCYG4geTioN+A leaves the table
bXpVeaSTPBFSPJmeXxO7nw collected $1.60 from pot
bXpVeaSTPBFSPJmeXxO7nw: doesn't show hand 
*** SUMMARY ***
Total pot $1.60 | Rake $0 
Seat 1: +sbyWwIcFp9kP0bDtMegfQ folded before Flop
Seat 2: nx5EoCNZFR03YUOXyT22wQ (button) folded before Flop (didn't bet)
Seat 3: jx6dnobNHstDG0tabsbKHQ (small blind) folded before Flop
Seat 4: bXpVeaSTPBFSPJmeXxO7nw (big blind) collected ($1.60)
Seat 8: K86cg2ifCMFAlmzsfTDjig folded before Flop (didn't bet)
Seat 9: uvfXVx90QtCYG4geTioN+A folded before Flop




PokerStars Game #59941580774:  Hold'em No Limit ($0.10/$0.25) - 2009/07/01 1:39:46 ET
Table 'emoxgHTxg9Uqeu06oLzLyg' 6-max Seat #2 is the button
Seat 1: QuJ87sC/OOZv/rYCnQDgUw ($24.05 in chips) 
Seat 2: wIFhgE1PVdX6Xf6aVlSTPg ($15.35 in chips) 
Seat 3: uD5epdBxuyc30pF1dO958Q ($10.90 in chips) 
Seat 4: 3VAbqAWh8ncE2SJOYIx2ZQ ($13.15 in chips) 
Seat 5: ZmsNNfGxipD8dY5iwrlOXQ ($8.90 in chips) 
Seat 6: iHZrkhpIO/3+tKuAoPx8HQ ($12.70 in chips) 
uD5epdBxuyc30pF1dO958Q: posts small blind $0.10
3VAbqAWh8ncE2SJOYIx2ZQ: posts big blind $0.25
*** HOLE CARDS ***
ZmsNNfGxipD8dY5iwrlOXQ: folds 
iHZrkhpIO/3+tKuAoPx8HQ: calls $0.25
QuJ87sC/OOZv/rYCnQDgUw: folds 
wIFhgE1PVdX6Xf6aVlSTPg: raises $0.35 to $0.60
uD5epdBxuyc30pF1dO958Q: folds 
3VAbqAWh8ncE2SJOYIx2ZQ: calls $0.35
iHZrkhpIO/3+tKuAoPx8HQ: calls $0.35
*** FLOP *** [8s 5c 2h]
3VAbqAWh8ncE2SJOYIx2ZQ: bets $0.50
iHZrkhpIO/3+tKuAoPx8HQ: raises $0.50 to $1
wIFhgE1PVdX6Xf6aVlSTPg: calls $1
3VAbqAWh8ncE2SJOYIx2ZQ: calls $0.50
*** TURN *** [8s 5c 2h] [Kh]
3VAbqAWh8ncE2SJOYIx2ZQ: checks 
iHZrkhpIO/3+tKuAoPx8HQ: bets $2
wIFhgE1PVdX6Xf6aVlSTPg: calls $2
3VAbqAWh8ncE2SJOYIx2ZQ: folds 
*** RIVER *** [8s 5c 2h Kh] [Js]
iHZrkhpIO/3+tKuAoPx8HQ: checks 
wIFhgE1PVdX6Xf6aVlSTPg: bets $5.95
iHZrkhpIO/3+tKuAoPx8HQ: calls $5.95
*** SHOW DOWN ***
wIFhgE1PVdX6Xf6aVlSTPg: shows [Ks Kd] (three of a kind, Kings)
iHZrkhpIO/3+tKuAoPx8HQ: mucks hand 
wIFhgE1PVdX6Xf6aVlSTPg collected $19.80 from pot
*** SUMMARY ***
Total pot $20.80 | Rake $1 
Board [8s 5c 2h Kh Js]
Seat 1: QuJ87sC/OOZv/rYCnQDgUw folded before Flop (didn't bet)
Seat 2: wIFhgE1PVdX6Xf6aVlSTPg (button) showed [Ks Kd] and won ($19.80) with three of a kind, Kings
Seat 3: uD5epdBxuyc30pF1dO958Q (small blind) folded before Flop
Seat 4: 3VAbqAWh8ncE2SJOYIx2ZQ (big blind) folded on the Turn
Seat 5: ZmsNNfGxipD8dY5iwrlOXQ folded before Flop (didn't bet)
Seat 6: iHZrkhpIO/3+tKuAoPx8HQ mucked




PokerStars Game #59941580806:  Hold'em No Limit ($0.10/$0.25) - 2009/07/01 1:39:46 ET
Table 'AchTjdLS1zBUbH3ZIx6f0w' 6-max Seat #3 is the button
Seat 1: rZ0bUtoerhFGDUSRQMnFog ($29.10 in chips) 
Seat 2: kG34n23qFQA3nzdOJTQ1dA ($66.25 in chips) 
Seat 3: k9vn40MOqqb+xF+7GZ6v2g ($29.20 in chips) 
Seat 4: q6WfTUAD9mowIP63ASq2Dg ($26.45 in chips) 
Seat 5: 0av6tRNdi0Ui4f15L7gsVg ($24.85 in chips) 
Seat 6: mFv3iBCtrw9XfCDRB0d46Q ($4.65 in chips) 
q6WfTUAD9mowIP63ASq2Dg: posts small blind $0.10
0av6tRNdi0Ui4f15L7gsVg: posts big blind $0.25
*** HOLE CARDS ***
mFv3iBCtrw9XfCDRB0d46Q: folds 
rZ0bUtoerhFGDUSRQMnFog: calls $0.25
kG34n23qFQA3nzdOJTQ1dA: folds 
k9vn40MOqqb+xF+7GZ6v2g: calls $0.25
q6WfTUAD9mowIP63ASq2Dg: folds 
0av6tRNdi0Ui4f15L7gsVg: checks 
*** FLOP *** [Th Qh 9d]
0av6tRNdi0Ui4f15L7gsVg: checks 
rZ0bUtoerhFGDUSRQMnFog: checks 
k9vn40MOqqb+xF+7GZ6v2g: checks 
*** TURN *** [Th Qh 9d] [8d]
0av6tRNdi0Ui4f15L7gsVg: bets $0.75
rZ0bUtoerhFGDUSRQMnFog: folds 
k9vn40MOqqb+xF+7GZ6v2g: calls $0.75
*** RIVER *** [Th Qh 9d 8d] [Kd]
0av6tRNdi0Ui4f15L7gsVg: checks 
k9vn40MOqqb+xF+7GZ6v2g: checks 
*** SHOW DOWN ***
0av6tRNdi0Ui4f15L7gsVg: shows [As Qc] (a pair of Queens)
k9vn40MOqqb+xF+7GZ6v2g: mucks hand 
0av6tRNdi0Ui4f15L7gsVg collected $2.25 from pot
*** SUMMARY ***
Total pot $2.35 | Rake $0.10 
Board [Th Qh 9d 8d Kd]
Seat 1: rZ0bUtoerhFGDUSRQMnFog folded on the Turn
Seat 2: kG34n23qFQA3nzdOJTQ1dA folded before Flop (didn't bet)
Seat 3: k9vn40MOqqb+xF+7GZ6v2g (button) mucked
Seat 4: q6WfTUAD9mowIP63ASq2Dg (small blind) folded before Flop
Seat 5: 0av6tRNdi0Ui4f15L7gsVg (big blind) showed [As Qc] and won ($2.25) with a pair of Queens
Seat 6: mFv3iBCtrw9XfCDRB0d46Q folded before Flop (didn't bet)




PokerStars Game #59941580540:  Hold'em No Limit ($0.10/$0.25) - 2009/07/01 1:39:46 ET
Table '+198VWQSWBhYQOcizzuBkw' 6-max Seat #4 is the button
Seat 2: mFv3iBCtrw9XfCDRB0d46Q ($9.85 in chips) 
Seat 3: vw7gefupgmOJJN8lUemdWg ($24.40 in chips) 
Seat 4: TgDsTeCdLQt8kWbL00ByRA ($16.60 in chips) 
Seat 5: LtASJ9OlkqGrrUKGQlpGAw ($26.70 in chips) 
Seat 6: leEQ84f6wJYu5SB/vj27wg ($11.55 in chips) 
LtASJ9OlkqGrrUKGQlpGAw: posts small blind $0.10
leEQ84f6wJYu5SB/vj27wg: posts big blind $0.25
*** HOLE CARDS ***
mFv3iBCtrw9XfCDRB0d46Q: folds 
vw7gefupgmOJJN8lUemdWg: folds 
TgDsTeCdLQt8kWbL00ByRA: folds 
LtASJ9OlkqGrrUKGQlpGAw: folds 
Uncalled bet ($0.15) returned to leEQ84f6wJYu5SB/vj27wg
leEQ84f6wJYu5SB/vj27wg collected $0.20 from pot
*** SUMMARY ***
Total pot $0.20 | Rake $0 
Seat 2: mFv3iBCtrw9XfCDRB0d46Q folded before Flop (didn't bet)
Seat 3: vw7gefupgmOJJN8lUemdWg folded before Flop (didn't bet)
Seat 4: TgDsTeCdLQt8kWbL00ByRA (button) folded before Flop (didn't bet)
Seat 5: LtASJ9OlkqGrrUKGQlpGAw (small blind) folded before Flop
Seat 6: leEQ84f6wJYu5SB/vj27wg (big blind) collected ($0.20)




PokerStars Game #59941580820:  Hold'em No Limit ($0.10/$0.25) - 2009/07/01 1:39:46 ET
Table 'MRfAiS/4JSfnUDlCcZo0wAhfHe8uKeSJMyWAjSdM7ROQx Seat #2 is the button
Seat 1: 48oT5xFI+5CHUJlfoGrE4w ($31.60 in chips) 
Seat 2: /gJNBeCkWL4o85/jvlZ4BA ($30.70 in chips) 
Seat 3: FYepjhAvF8ZdVCmqHIy+eQ ($39.15 in chips) 
Seat 6: L3/N/gliETan8N5Gim5h4Q ($25 in chips) 
FYepjhAvF8ZdVCmqHIy+eQ: posts small blind $0.10
L3/N/gliETan8N5Gim5h4Q: posts big blind $0.25
*** HOLE CARDS ***
48oT5xFI+5CHUJlfoGrE4w: folds 
/gJNBeCkWL4o85/jvlZ4BA: folds 
FYepjhAvF8ZdVCmqHIy+eQ: folds 
Uncalled bet ($0.15) returned to L3/N/gliETan8N5Gim5h4Q
L3/N/gliETan8N5Gim5h4Q collected $0.20 from pot
L3/N/gliETan8N5Gim5h4Q: doesn't show hand 
*** SUMMARY ***
Total pot $0.20 | Rake $0 
Seat 1: 48oT5xFI+5CHUJlfoGrE4w folded before Flop (didn't bet)
Seat 2: /gJNBeCkWL4o85/jvlZ4BA (button) folded before Flop (didn't bet)
Seat 3: FYepjhAvF8ZdVCmqHIy+eQ (small blind) folded before Flop
Seat 6: L3/N/gliETan8N5Gim5h4Q (big blind) collected ($0.20)




PokerStars Game #59941580990:  Hold'em No Limit ($0.10/$0.25) - 2009/07/01 1:39:47 ET
Table 'jz4TpuH+ag+0iNe2ZcxckQ' 9-max Seat #9 is the button
Seat 1: +C3eP/ysyROWbEXJFPswVA ($15.80 in chips) 
Seat 2: OXPkK84/qv92EMwXPiG5rQ ($9.75 in chips) 
Seat 4: k+2r6di6GXjNpAdrRkW9bA ($63 in chips) 
Seat 5: v1BVHNGLbP/nx7QO6K7+Jw ($25.45 in chips) 
Seat 6: gO1uiTGTzn5Cd3PECuws1g ($14.75 in chips) 
Seat 7: tLcDklc2rBORNfixyRfVfw ($30.20 in chips) 
Seat 8: uhrboV251dcgYniYTdFIcA ($25 in chips) 
Seat 9: W2YYHvqjaEpRrO7stZkClQ ($5.80 in chips) 
+C3eP/ysyROWbEXJFPswVA: posts small blind $0.10
OXPkK84/qv92EMwXPiG5rQ: posts big blind $0.25
egvg3mTBBVzMHnJPIQiKcA: sits out 
*** HOLE CARDS ***
k+2r6di6GXjNpAdrRkW9bA: folds 
v1BVHNGLbP/nx7QO6K7+Jw: raises $0.25 to $0.50
gO1uiTGTzn5Cd3PECuws1g: calls $0.50
tLcDklc2rBORNfixyRfVfw: folds 
uhrboV251dcgYniYTdFIcA: folds 
W2YYHvqjaEpRrO7stZkClQ: folds 
+C3eP/ysyROWbEXJFPswVA: folds 
OXPkK84/qv92EMwXPiG5rQ: calls $0.25
*** FLOP *** [3c 8d 9d]
OXPkK84/qv92EMwXPiG5rQ: checks 
v1BVHNGLbP/nx7QO6K7+Jw: bets $1.25
gO1uiTGTzn5Cd3PECuws1g: folds 
OXPkK84/qv92EMwXPiG5rQ: folds 
Uncalled bet ($1.25) returned to v1BVHNGLbP/nx7QO6K7+Jw
v1BVHNGLbP/nx7QO6K7+Jw collected $1.55 from pot
v1BVHNGLbP/nx7QO6K7+Jw: doesn't show hand 
*** SUMMARY ***
Total pot $1.60 | Rake $0.05 
Board [3c 8d 9d]
Seat 1: +C3eP/ysyROWbEXJFPswVA (small blind) folded before Flop
Seat 2: OXPkK84/qv92EMwXPiG5rQ (big blind) folded on the Flop
Seat 4: k+2r6di6GXjNpAdrRkW9bA folded before Flop (didn't bet)
Seat 5: v1BVHNGLbP/nx7QO6K7+Jw collected ($1.55)
Seat 6: gO1uiTGTzn5Cd3PECuws1g folded on the Flop
Seat 7: tLcDklc2rBORNfixyRfVfw folded before Flop (didn't bet)
Seat 8: uhrboV251dcgYniYTdFIcA folded before Flop (didn't bet)
Seat 9: W2YYHvqjaEpRrO7stZkClQ (button) folded before Flop (didn't bet)




PokerStars Game #59941581204:  Hold'em No Limit ($0.10/$0.25) - 2009/07/01 1:39:47 ET
Table 'nlpa8xI95gAflovnFxB2yg' 6-max Seat #6 is the button
Seat 1: fZQg9veL7Dd/Z04ZTjC+wQ ($62.95 in chips) 
Seat 2: Yuyy/pDz3yAO3EbHYRYnKw ($25.30 in chips) 
Seat 3: DihMHaz4WNETH1bPDe13kA ($25.80 in chips) 
Seat 5: FDWzjQgBA5K04jOIY/j22w ($9.20 in chips) 
Seat 6: ATNFxN8fYVfSZMQW8dvbvw ($6.65 in chips) 
fZQg9veL7Dd/Z04ZTjC+wQ: posts small blind $0.10
Yuyy/pDz3yAO3EbHYRYnKw: posts big blind $0.25
if4dh6jhJXeN3/qd3qCp9g: sits out 
*** HOLE CARDS ***
DihMHaz4WNETH1bPDe13kA: folds 
FDWzjQgBA5K04jOIY/j22w: folds 
ATNFxN8fYVfSZMQW8dvbvw: folds 
fZQg9veL7Dd/Z04ZTjC+wQ: folds 
Uncalled bet ($0.15) returned to Yuyy/pDz3yAO3EbHYRYnKw
Yuyy/pDz3yAO3EbHYRYnKw collected $0.20 from pot
Yuyy/pDz3yAO3EbHYRYnKw: doesn't show hand 
*** SUMMARY ***
Total pot $0.20 | Rake $0 
Seat 1: fZQg9veL7Dd/Z04ZTjC+wQ (small blind) folded before Flop
Seat 2: Yuyy/pDz3yAO3EbHYRYnKw (big blind) collected ($0.20)
Seat 3: DihMHaz4WNETH1bPDe13kA folded before Flop (didn't bet)
Seat 5: FDWzjQgBA5K04jOIY/j22w folded before Flop (didn't bet)
Seat 6: ATNFxN8fYVfSZMQW8dvbvw (button) folded before Flop (didn't bet)




PokerStars Game #59941581336:  Hold'em No Limit ($0.10/$0.25) - 2009/07/01 1:39:47 ET
Table 'LwnjzXstPtSrqrV/oDpnXQ' 9-max Seat #4 is the button
Seat 1: 9YN2IkT2JYYKFErZtZvCtA ($26.30 in chips) 
Seat 2: uLP/lYn7oKq9xCChBXsXxw ($27 in chips) 
Seat 3: 7je+LC5Mfs6nL8YBVh4frQ ($4.30 in chips) 
Seat 4: CmngQmkKTp8tkl6GMRTl6w ($9.60 in chips) 
Seat 5: Th3FldXKQW6hWVVPahaoOQ ($25 in chips) 
Seat 6: ljemhp25Zg+nlA9DLCIiUw ($42.70 in chips) 
Seat 7: c/Dw/6HyqldTzIRodAIZmg ($12.80 in chips) 
Seat 8: V1v2fpa7s4yQT0k82IergA ($19.85 in chips) 
Seat 9: q6WfTUAD9mowIP63ASq2Dgz/khFDKGihQjwgoiKKPOegin chips) 
Th3FldXKQW6hWVVPahaoOQ: posts small blind $0.10
ljemhp25Zg+nlA9DLCIiUw: posts big blind $0.25
*** HOLE CARDS ***
c/Dw/6HyqldTzIRodAIZmg: folds 
V1v2fpa7s4yQT0k82IergA: folds 
q6WfTUAD9mowIP63ASq2Dgz/khFDKGihQjwgoiKKPOegs $0.25
9YN2IkT2JYYKFErZtZvCtA: folds 
uLP/lYn7oKq9xCChBXsXxw: folds 
7je+LC5Mfs6nL8YBVh4frQ: folds 
CmngQmkKTp8tkl6GMRTl6w: folds 
Th3FldXKQW6hWVVPahaoOQ: folds 
ljemhp25Zg+nlA9DLCIiUw: checks 
*** FLOP *** [9h Qs 5s]
ljemhp25Zg+nlA9DLCIiUw: bets $0.50
q6WfTUAD9mowIP63ASq2Dgz/khFDKGihQjwgoiKKPOegs $0.50
*** TURN *** [9h Qs 5s] [3h]
ljemhp25Zg+nlA9DLCIiUw: bets $0.75
q6WfTUAD9mowIP63ASq2Dgz/khFDKGihQjwgoiKKPOegs $0.75
*** RIVER *** [9h Qs 5s 3h] [2c]
V1v2fpa7s4yQT0k82IergA leaves the table
ljemhp25Zg+nlA9DLCIiUw: checks 
q6WfTUAD9mowIP63ASq2Dgz/khFDKGihQjwgoiKKPOeg $1.50
ljemhp25Zg+nlA9DLCIiUw: folds 
Uncalled bet ($1.50) returned to q6WfTUAD9mowIP63ASq2Dgz/khFDKGihQjwgoiKKPOegq6WfTUAD9mowIP63ASq2Dgt collected $2.95 from pot
q6WfTUAD9mowIP63ASq2Dgz/khFDKGihQjwgoiKKPOegn't show hand 
*** SUMMARY ***
Total pot $3.10 | Rake $0.15 
Board [9h Qs 5s 3h 2c]
Seat 1: 9YN2IkT2JYYKFErZtZvCtA folded before Flop (didn't bet)
Seat 2: uLP/lYn7oKq9xCChBXsXxw folded before Flop (didn't bet)
Seat 3: 7je+LC5Mfs6nL8YBVh4frQ folded before Flop (didn't bet)
Seat 4: CmngQmkKTp8tkl6GMRTl6w (button) folded before Flop (didn't bet)
Seat 5: Th3FldXKQW6hWVVPahaoOQ (small blind) folded before Flop
Seat 6: ljemhp25Zg+nlA9DLCIiUw (big blind) folded on the River
Seat 7: c/Dw/6HyqldTzIRodAIZmg folded before Flop (didn't bet)
Seat 8: V1v2fpa7s4yQT0k82IergA folded before Flop (didn't bet)
Seat 9: q6WfTUAD9mowIP63ASq2Dgz/khFDKGihQjwgoiKKPOegcted ($2.95)




PokerStars Game #59941580914:  Hold'em No Limit ($0.10/$0.25) - 2009/07/01 1:39:47 ET
Table 'oZuNsbNJuUyQLGKzQ/4JFg' 6-max Seat #6 is the button
Seat 1: vqWjZmdQu/Hxw96/IJTWdQ ($25 in chips) 
Seat 2: UA5OsKS3VPaxa7uC8La/kA ($33 in chips) 
Seat 3: 8ClCHtFXGNplITm+63KB+Q ($52.10 in chips) 
Seat 4: df01R5ThvHspD8FgKmaDvQ ($47.75 in chips) 
Seat 5: oBUDUfeUyCbZBsjxHZgSiw ($27.15 in chips) 
Seat 6: fwg6dK1+r4jy/y+JqenYYQ ($14.65 in chips) 
vqWjZmdQu/Hxw96/IJTWdQ: posts small blind $0.10
UA5OsKS3VPaxa7uC8La/kA: posts big blind $0.25
*** HOLE CARDS ***
8ClCHtFXGNplITm+63KB+Q: folds 
df01R5ThvHspD8FgKmaDvQ: folds 
oBUDUfeUyCbZBsjxHZgSiw: folds 
fwg6dK1+r4jy/y+JqenYYQ: folds 
vqWjZmdQu/Hxw96/IJTWdQ: folds 
Uncalled bet ($0.15) returned to UA5OsKS3VPaxa7uC8La/kA
UA5OsKS3VPaxa7uC8La/kA collected $0.20 from pot
*** SUMMARY ***
Total pot $0.20 | Rake $0 
Seat 1: vqWjZmdQu/Hxw96/IJTWdQ (small blind) folded before Flop
Seat 2: UA5OsKS3VPaxa7uC8La/kA (big blind) collected ($0.20)
Seat 3: 8ClCHtFXGNplITm+63KB+Q folded before Flop (didn't bet)
Seat 4: df01R5ThvHspD8FgKmaDvQ folded before Flop (didn't bet)
Seat 5: oBUDUfeUyCbZBsjxHZgSiw folded before Flop (didn't bet)
Seat 6: fwg6dK1+r4jy/y+JqenYYQ (button) folded before Flop (didn't bet)




PokerStars Game #59941580888:  Hold'em No Limit ($0.10/$0.25) - 2009/07/01 1:39:47 ET
Table 'AHkg4ChqzcMauBx6Qvz8Nw' 6-max Seat #2 is the button
Seat 1: +RDf7SmUjY2kK0PzdBEYqg ($4.60 in chips) 
Seat 2: Vi0JMrTI2BGrPL7UIulJtA ($5.90 in chips) 
Seat 3: 9dToMv2GJLfi00HcpfMnIw ($24.75 in chips) 
Seat 4: Eznneya0vB6S+eXJdVleHA ($19.80 in chips) 
Seat 5: Bada343Si4xKu3fNXY99AA ($5.25 in chips) 
Seat 6: Hsvkc0/G2VV78oVmWYXecw ($5.10 in chips) 
9dToMv2GJLfi00HcpfMnIw: posts small blind $0.10
Eznneya0vB6S+eXJdVleHA: posts big blind $0.25
*** HOLE CARDS ***
Bada343Si4xKu3fNXY99AA: folds 
Hsvkc0/G2VV78oVmWYXecw: folds 
+RDf7SmUjY2kK0PzdBEYqg: folds 
Vi0JMrTI2BGrPL7UIulJtA: folds 
9dToMv2GJLfi00HcpfMnIw: folds 
Uncalled bet ($0.15) returned to Eznneya0vB6S+eXJdVleHA
Eznneya0vB6S+eXJdVleHA collected $0.20 from pot
Eznneya0vB6S+eXJdVleHA: shows [Kc Kd] (a pair of Kings)
*** SUMMARY ***
Total pot $0.20 | Rake $0 
Seat 1: +RDf7SmUjY2kK0PzdBEYqg folded before Flop (didn't bet)
Seat 2: Vi0JMrTI2BGrPL7UIulJtA (button) folded before Flop (didn't bet)
Seat 3: 9dToMv2GJLfi00HcpfMnIw (small blind) folded before Flop
Seat 4: Eznneya0vB6S+eXJdVleHA (big blind) collected ($0.20)
Seat 5: Bada343Si4xKu3fNXY99AA folded before Flop (didn't bet)
Seat 6: Hsvkc0/G2VV78oVmWYXecw folded before Flop (didn't bet)




PokerStars Game #59941581306:  Hold'em No Limit ($0.10/$0.25) - 2009/07/01 1:39:47 ET
Table 'biAgO3TKQBU8XcrVAoU5TA' 6-max Seat #5 is the button
Seat 1: jhDPlkir8wBYAddboBuF7Q ($16.25 in chips) 
Seat 2: GbCVUNssQ7mqsPWr7J4d3w ($5.65 in chips) 
Seat 3: mfrkWA3PTeYPkbO6hi98Aw ($30.65 in chips) 
Seat 4: Hsvkc0/G2VV78oVmWYXecw ($5 in chips) 
Seat 5: n6UPMnVR4v8LFP0rWP73Fg ($12.70 in chips) 
Seat 6: wMiE3yTbDJGOLOF9th7KPA ($9.35 in chips) 
wMiE3yTbDJGOLOF9th7KPA: posts small blind $0.10
jhDPlkir8wBYAddboBuF7Q: posts big blind $0.25
*** HOLE CARDS ***
GbCVUNssQ7mqsPWr7J4d3w: folds 
mfrkWA3PTeYPkbO6hi98Aw: folds 
Hsvkc0/G2VV78oVmWYXecw: folds 
n6UPMnVR4v8LFP0rWP73Fg: calls $0.25
wMiE3yTbDJGOLOF9th7KPA: calls $0.15
jhDPlkir8wBYAddboBuF7Q: checks 
*** FLOP *** [8s 8h Td]
wMiE3yTbDJGOLOF9th7KPA: checks 
jhDPlkir8wBYAddboBuF7Q: checks 
n6UPMnVR4v8LFP0rWP73Fg: checks 
*** TURN *** [8s 8h Td] [Kc]
wMiE3yTbDJGOLOF9th7KPA: checks 
jhDPlkir8wBYAddboBuF7Q: checks 
n6UPMnVR4v8LFP0rWP73Fg: checks 
*** RIVER *** [8s 8h Td Kc] [5c]
wMiE3yTbDJGOLOF9th7KPA: bets $4.25
jhDPlkir8wBYAddboBuF7Q: folds 
n6UPMnVR4v8LFP0rWP73Fg: folds 
Uncalled bet ($4.25) returned to wMiE3yTbDJGOLOF9th7KPA
wMiE3yTbDJGOLOF9th7KPA collected $0.75 from pot
*** SUMMARY ***
Total pot $0.75 | Rake $0 
Board [8s 8h Td Kc 5c]
Seat 1: jhDPlkir8wBYAddboBuF7Q (big blind) folded on the River
Seat 2: GbCVUNssQ7mqsPWr7J4d3w folded before Flop (didn't bet)
Seat 3: mfrkWA3PTeYPkbO6hi98Aw folded before Flop (didn't bet)
Seat 4: Hsvkc0/G2VV78oVmWYXecw folded before Flop (didn't bet)
Seat 5: n6UPMnVR4v8LFP0rWP73Fg (button) folded on the River
Seat 6: wMiE3yTbDJGOLOF9th7KPA (small blind) collected ($0.75)




PokerStars Game #59941580978:  Hold'em No Limit ($0.10/$0.25) - 2009/07/01 1:39:47 ET
Table 'isKy4XK8wJM0x735/D4hWA' 6-max Seat #4 is the button
Seat 1: kwsRmpZ1ZaLooISs+zfyKg ($25.80 in chips) 
Seat 2: 6elpmfyt4Zw0yvd8lePSMQ ($20.55 in chips) 
Seat 3: jp34e617tIzV8tKIWmfAbA ($45 in chips) 
Seat 4: DFi/Lzkjsfv8QswS80JX9Q ($30.75 in chips) 
Seat 5: lquriepNQBhDV5P1SWHhnA ($25.70 in chips) 
Seat 6: GbCVUNssQ7mqsPWr7J4d3w ($5 in chips) 
lquriepNQBhDV5P1SWHhnA: posts small blind $0.10
GbCVUNssQ7mqsPWr7J4d3w: posts big blind $0.25
*** HOLE CARDS ***
kwsRmpZ1ZaLooISs+zfyKg: calls $0.25
6elpmfyt4Zw0yvd8lePSMQ: folds 
jp34e617tIzV8tKIWmfAbA: folds 
DFi/Lzkjsfv8QswS80JX9Q: folds 
lquriepNQBhDV5P1SWHhnA: folds 
GbCVUNssQ7mqsPWr7J4d3w: checks 
*** FLOP *** [Ts 5d 2d]
GbCVUNssQ7mqsPWr7J4d3w: checks 
kwsRmpZ1ZaLooISs+zfyKg: checks 
*** TURN *** [Ts 5d 2d] [4h]
GbCVUNssQ7mqsPWr7J4d3w: checks 
kwsRmpZ1ZaLooISs+zfyKg: checks 
*** RIVER *** [Ts 5d 2d 4h] [9d]
GbCVUNssQ7mqsPWr7J4d3w: checks 
kwsRmpZ1ZaLooISs+zfyKg: bets $0.75
GbCVUNssQ7mqsPWr7J4d3w: folds 
Uncalled bet ($0.75) returned to kwsRmpZ1ZaLooISs+zfyKg
kwsRmpZ1ZaLooISs+zfyKg collected $0.60 from pot
*** SUMMARY ***
Total pot $0.60 | Rake $0 
Board [Ts 5d 2d 4h 9d]
Seat 1: kwsRmpZ1ZaLooISs+zfyKg collected ($0.60)
Seat 2: 6elpmfyt4Zw0yvd8lePSMQ folded before Flop (didn't bet)
Seat 3: jp34e617tIzV8tKIWmfAbA folded before Flop (didn't bet)
Seat 4: DFi/Lzkjsfv8QswS80JX9Q (button) folded before Flop (didn't bet)
Seat 5: lquriepNQBhDV5P1SWHhnA (small blind) folded before Flop
Seat 6: GbCVUNssQ7mqsPWr7J4d3w (big blind) folded on the River




PokerStars Game #59941581924:  Hold'em No Limit ($0.10/$0.25) - 2009/07/01 1:39:48 ET
Table 'nc6OeGk/wtaWV+6N+kgnZQ' 6-max Seat #2 is the button
Seat 1: tSR4329m40dZsN7YOpI9Kw ($39.15 in chips) 
Seat 2: 8ClCHtFXGNplITm+63KB+Q ($34.75 in chips) 
Seat 3: y8wpMWGSX2zHZijurx21mg ($6.40 in chips) 
Seat 4: 3zD3qLXT1bEffAoWGnc7wg ($30.30 in chips) 
Seat 5: HCS0lMAAPmZE2Tl8J/SuKw ($11.70 in chips) 
Seat 6: mFv3iBCtrw9XfCDRB0d46Q ($2.95 in chips) 
y8wpMWGSX2zHZijurx21mg: posts small blind $0.10
3zD3qLXT1bEffAoWGnc7wg: posts big blind $0.25
*** HOLE CARDS ***
HCS0lMAAPmZE2Tl8J/SuKw: folds 
mFv3iBCtrw9XfCDRB0d46Q: folds 
tSR4329m40dZsN7YOpI9Kw: folds 
8ClCHtFXGNplITm+63KB+Q: raises $1 to $1.25
y8wpMWGSX2zHZijurx21mg: folds 
3zD3qLXT1bEffAoWGnc7wg: folds 
Uncalled bet ($1) returned to 8ClCHtFXGNplITm+63KB+Q
8ClCHtFXGNplITm+63KB+Q collected $0.60 from pot
8ClCHtFXGNplITm+63KB+Q: doesn't show hand 
*** SUMMARY ***
Total pot $0.60 | Rake $0 
Seat 1: tSR4329m40dZsN7YOpI9Kw folded before Flop (didn't bet)
Seat 2: 8ClCHtFXGNplITm+63KB+Q (button) collected ($0.60)
Seat 3: y8wpMWGSX2zHZijurx21mg (small blind) folded before Flop
Seat 4: 3zD3qLXT1bEffAoWGnc7wg (big blind) folded before Flop
Seat 5: HCS0lMAAPmZE2Tl8J/SuKw folded before Flop (didn't bet)
Seat 6: mFv3iBCtrw9XfCDRB0d46Q folded before Flop (didn't bet)




PokerStars Game #59941581718:  Hold'em No Limit ($0.10/$0.25) - 2009/07/01 1:39:48 ET
Table 'edvgY2YQ1I34euq4EVqGnA' 6-max Seat #5 is the button
Seat 1: mvFHK3pE7tCxJEqLjKC70Q ($24.85 in chips) 
Seat 2: SxIIgwXYLkwd6m3wLyPTCw ($16.25 in chips) 
Seat 3: mFv3iBCtrw9XfCDRB0d46Q ($3.90 in chips) 
Seat 4: TI/C5Q+DEl4fLR3AofwYdg ($20.55 in chips) 
Seat 5: EE16Ua5b1HSsYej5zeXOlA ($54.75 in chips) 
Seat 6: kG34n23qFQA3nzdOJTQ1dA ($72.60 in chips) 
kG34n23qFQA3nzdOJTQ1dA: posts small blind $0.10
mvFHK3pE7tCxJEqLjKC70Q: posts big blind $0.25
*** HOLE CARDS ***
SxIIgwXYLkwd6m3wLyPTCw: folds 
mFv3iBCtrw9XfCDRB0d46Q: folds 
TI/C5Q+DEl4fLR3AofwYdg: calls $0.25
EE16Ua5b1HSsYej5zeXOlA: folds 
kG34n23qFQA3nzdOJTQ1dA: calls $0.15
mvFHK3pE7tCxJEqLjKC70Q: checks 
*** FLOP *** [4d 4c Qh]
kG34n23qFQA3nzdOJTQ1dA: checks 
mvFHK3pE7tCxJEqLjKC70Q: bets $0.25
TI/C5Q+DEl4fLR3AofwYdg: folds 
kG34n23qFQA3nzdOJTQ1dA: folds 
Uncalled bet ($0.25) returned to mvFHK3pE7tCxJEqLjKC70Q
mvFHK3pE7tCxJEqLjKC70Q collected $0.75 from pot
mvFHK3pE7tCxJEqLjKC70Q: doesn't show hand 
*** SUMMARY ***
Total pot $0.75 | Rake $0 
Board [4d 4c Qh]
Seat 1: mvFHK3pE7tCxJEqLjKC70Q (big blind) collected ($0.75)
Seat 2: SxIIgwXYLkwd6m3wLyPTCw folded before Flop (didn't bet)
Seat 3: mFv3iBCtrw9XfCDRB0d46Q folded before Flop (didn't bet)
Seat 4: TI/C5Q+DEl4fLR3AofwYdg folded on the Flop
Seat 5: EE16Ua5b1HSsYej5zeXOlA (button) folded before Flop (didn't bet)
Seat 6: kG34n23qFQA3nzdOJTQ1dA (small blind) folded on the Flop




PokerStars Game #59941581856:  Hold'em No Limit ($0.10/$0.25) - 2009/07/01 1:39:48 ET
Table 'Of/T60zpXg1GcjrZ7Lm//Q' 9-max Seat #9 is the button
Seat 1: Lro4e37x4FUa5P3yzDjskw ($15.65 in chips) 
Seat 2: qwr38jl5txoR36M7G5qi4A ($7.50 in chips) 
Seat 3: 6RiVTYll/5D8zICp0MRpKw ($24.15 in chips) 
Seat 4: Czut6V7acIqUJrrobjKAZg ($18.75 in chips) 
Seat 5: IiLkthQMEje9LS79rCFQ1Q ($9.45 in chips) 
Seat 6: tYsOBqdU1+x+yFI7zHO7hQ ($32.05 in chips) 
Seat 7: PVxvfRTRvkgZf9WtquEkwQ ($25 in chips) 
Seat 8: ghNKXUBl/H+t83JF079ZBA ($25 in chips) 
Seat 9: egvg3mTBBVzMHnJPIQiKcA ($14 in chips) 
Lro4e37x4FUa5P3yzDjskw: posts small blind $0.10
qwr38jl5txoR36M7G5qi4A: posts big blind $0.25
*** HOLE CARDS ***
6RiVTYll/5D8zICp0MRpKw: folds 
Czut6V7acIqUJrrobjKAZg: calls $0.25
IiLkthQMEje9LS79rCFQ1Q: folds 
tYsOBqdU1+x+yFI7zHO7hQ: folds 
PVxvfRTRvkgZf9WtquEkwQ: folds 
ghNKXUBl/H+t83JF079ZBA: raises $1 to $1.25
egvg3mTBBVzMHnJPIQiKcA: folds 
Lro4e37x4FUa5P3yzDjskw: folds 
qwr38jl5txoR36M7G5qi4A: folds 
Czut6V7acIqUJrrobjKAZg: calls $1
*** FLOP *** [6c Ah Qd]
Czut6V7acIqUJrrobjKAZg: checks 
ghNKXUBl/H+t83JF079ZBA: bets $1.75
Czut6V7acIqUJrrobjKAZg: folds 
Uncalled bet ($1.75) returned to ghNKXUBl/H+t83JF079ZBA
ghNKXUBl/H+t83JF079ZBA collected $2.75 from pot
ghNKXUBl/H+t83JF079ZBA: doesn't show hand 
*** SUMMARY ***
Total pot $2.85 | Rake $0.10 
Board [6c Ah Qd]
Seat 1: Lro4e37x4FUa5P3yzDjskw (small blind) folded before Flop
Seat 2: qwr38jl5txoR36M7G5qi4A (big blind) folded before Flop
Seat 3: 6RiVTYll/5D8zICp0MRpKw folded before Flop (didn't bet)
Seat 4: Czut6V7acIqUJrrobjKAZg folded on the Flop
Seat 5: IiLkthQMEje9LS79rCFQ1Q folded before Flop (didn't bet)
Seat 6: tYsOBqdU1+x+yFI7zHO7hQ folded before Flop (didn't bet)
Seat 7: PVxvfRTRvkgZf9WtquEkwQ folded before Flop (didn't bet)
Seat 8: ghNKXUBl/H+t83JF079ZBA collected ($2.75)
Seat 9: egvg3mTBBVzMHnJPIQiKcA (button) folded before Flop (didn't bet)




PokerStars Game #59941581422:  Hold'em No Limit ($0.10/$0.25) - 2009/07/01 1:39:48 ET
Table 'uFgIyfWPagvEVGEb86da7A' 9-max Seat #6 is the button
Seat 1: CT7Xj/V/O5rBlhtt+RZeFQ ($26.25 in chips) 
Seat 2: o3zvoO+PsqGti+1NZGNRrQ ($1.10 in chips) 
Seat 3: eGAnPT3w+iltM7HF59dzIg ($6.25 in chips) 
Seat 4: IGRfskE1v9H9Bn+fz8AgNQ ($26.90 in chips) 
Seat 5: X78b5v/uhqeXXoAijbw/yg ($28.30 in chips) 
Seat 6: zDrucyjVn5aeekNEc3cJrA ($28.75 in chips) 
Seat 7: 9zx7Mlww974uHUqoiq2eXA ($12.10 in chips) 
Seat 8: uLP/lYn7oKq9xCChBXsXxw ($24.15 in chips) 
Seat 9: sL5EaDXc90Iyxlm8ERXRQw ($17.20 in chips) 
9zx7Mlww974uHUqoiq2eXA: posts small blind $0.10
uLP/lYn7oKq9xCChBXsXxw: posts big blind $0.25
*** HOLE CARDS ***
sL5EaDXc90Iyxlm8ERXRQw: calls $0.25
CT7Xj/V/O5rBlhtt+RZeFQ: folds 
o3zvoO+PsqGti+1NZGNRrQ: folds 
eGAnPT3w+iltM7HF59dzIg: folds 
IGRfskE1v9H9Bn+fz8AgNQ: folds 
X78b5v/uhqeXXoAijbw/yg: folds 
zDrucyjVn5aeekNEc3cJrA: folds 
9zx7Mlww974uHUqoiq2eXA: calls $0.15
uLP/lYn7oKq9xCChBXsXxw: checks 
*** FLOP *** [Kd 7c Ts]
9zx7Mlww974uHUqoiq2eXA: checks 
uLP/lYn7oKq9xCChBXsXxw: checks 
sL5EaDXc90Iyxlm8ERXRQw: bets $0.75
9zx7Mlww974uHUqoiq2eXA: folds 
uLP/lYn7oKq9xCChBXsXxw: folds 
Uncalled bet ($0.75) returned to sL5EaDXc90Iyxlm8ERXRQw
sL5EaDXc90Iyxlm8ERXRQw collected $0.75 from pot
sL5EaDXc90Iyxlm8ERXRQw: doesn't show hand 
*** SUMMARY ***
Total pot $0.75 | Rake $0 
Board [Kd 7c Ts]
Seat 1: CT7Xj/V/O5rBlhtt+RZeFQ folded before Flop (didn't bet)
Seat 2: o3zvoO+PsqGti+1NZGNRrQ folded before Flop (didn't bet)
Seat 3: eGAnPT3w+iltM7HF59dzIg folded before Flop (didn't bet)
Seat 4: IGRfskE1v9H9Bn+fz8AgNQ folded before Flop (didn't bet)
Seat 5: X78b5v/uhqeXXoAijbw/yg folded before Flop (didn't bet)
Seat 6: zDrucyjVn5aeekNEc3cJrA (button) folded before Flop (didn't bet)
Seat 7: 9zx7Mlww974uHUqoiq2eXA (small blind) folded on the Flop
Seat 8: uLP/lYn7oKq9xCChBXsXxw (big blind) folded on the Flop
Seat 9: sL5EaDXc90Iyxlm8ERXRQw collected ($0.75)




PokerStars Game #59941582508:  Hold'em No Limit ($0.10/$0.25) - 2009/07/01 1:39:49 ET
Table 'h02LhQ7B/Zk4ETRxxHhGYA' 9-max Seat #2 is the button
Seat 1: sD+TKtt36XiiN6jqHiLwDA ($25.25 in chips) 
Seat 2: 9lvO/qyU+xrU95Teu1fv0g ($5.70 in chips) 
Seat 3: arxNSjreDRGFg13EAM2F1w ($25 in chips) 
Seat 4: tYsOBqdU1+x+yFI7zHO7hQ ($38.45 in chips) 
Seat 5: cUxk0Jk4lrUQv9CJl0LPlg ($27.55 in chips) 
Seat 6: UvM6sxFT7el5hVDehvWvTA ($33.90 in chips) 
Seat 7: y7w8+Oqq4SkI1dkRDCx2Zg ($3.25 in chips) 
Seat 8: mUoFJKqCzIUABvOFbiINlQ ($15 in chips) 
Seat 9: MgzS9dEPzsGYQW57RteFhw ($7.40 in chips) 
arxNSjreDRGFg13EAM2F1w: posts small blind $0.10
tYsOBqdU1+x+yFI7zHO7hQ: posts big blind $0.25
*** HOLE CARDS ***
cUxk0Jk4lrUQv9CJl0LPlg: calls $0.25
UvM6sxFT7el5hVDehvWvTA: folds 
y7w8+Oqq4SkI1dkRDCx2Zg: raises $1 to $1.25
mUoFJKqCzIUABvOFbiINlQ: folds 
MgzS9dEPzsGYQW57RteFhw: folds 
sD+TKtt36XiiN6jqHiLwDA: folds 
9lvO/qyU+xrU95Teu1fv0g: folds 
arxNSjreDRGFg13EAM2F1w: folds 
tYsOBqdU1+x+yFI7zHO7hQ: folds 
cUxk0Jk4lrUQv9CJl0LPlg: folds 
Uncalled bet ($1) returned to y7w8+Oqq4SkI1dkRDCx2Zg
y7w8+Oqq4SkI1dkRDCx2Zg collected $0.85 from pot
y7w8+Oqq4SkI1dkRDCx2Zg: doesn't show hand 
*** SUMMARY ***
Total pot $0.85 | Rake $0 
Seat 1: sD+TKtt36XiiN6jqHiLwDA folded before Flop (didn't bet)
Seat 2: 9lvO/qyU+xrU95Teu1fv0g (button) folded before Flop (didn't bet)
Seat 3: arxNSjreDRGFg13EAM2F1w (small blind) folded before Flop
Seat 4: tYsOBqdU1+x+yFI7zHO7hQ (big blind) folded before Flop
Seat 5: cUxk0Jk4lrUQv9CJl0LPlg folded before Flop
Seat 6: UvM6sxFT7el5hVDehvWvTA folded before Flop (didn't bet)
Seat 7: y7w8+Oqq4SkI1dkRDCx2Zg collected ($0.85)
Seat 8: mUoFJKqCzIUABvOFbiINlQ folded before Flop (didn't bet)
Seat 9: MgzS9dEPzsGYQW57RteFhw folded before Flop (didn't bet)




PokerStars Game #59941582100:  Hold'em No Limit ($0.10/$0.25) - 2009/07/01 1:39:49 ET
Table 'Ez9TB43XM4QgMDQkIW9DYw' 9-max Seat #6 is the button
Seat 1: ShCS62CJp4MKfKLKvGKQbA ($5.05 in chips) 
Seat 2: PFNLAvMkr8qKc7xCiH0wTA ($14.85 in chips) 
Seat 4: JDdN8256cGDC+SqlWOx98Q ($3.40 in chips) 
Seat 5: qpG9m8I+cPw8VhB0mnGjYw ($32.80 in chips) 
Seat 6: 76o85YBHJ9veRYp2LPuluQ ($33.25 in chips) 
Seat 7: Bb42QRQMhg5/Y0vHP8/2Xw ($30.20 in chips) 
Seat 8: +2kMBNpY4nF1qNCRd8SJLA ($29.50 in chips) 
Seat 9: QEbIGci+itdw+re8RM5fZA ($25 in chips) 
Bb42QRQMhg5/Y0vHP8/2Xw: posts small blind $0.10
+2kMBNpY4nF1qNCRd8SJLA: posts big blind $0.25
PdIasPkzm2sqZnN41ZRXOg: sits out 
*** HOLE CARDS ***
QEbIGci+itdw+re8RM5fZA: folds 
ShCS62CJp4MKfKLKvGKQbA: folds 
PFNLAvMkr8qKc7xCiH0wTA: folds 
JDdN8256cGDC+SqlWOx98Q: folds 
qpG9m8I+cPw8VhB0mnGjYw: folds 
76o85YBHJ9veRYp2LPuluQ: raises $0.25 to $0.50
Bb42QRQMhg5/Y0vHP8/2Xw: folds 
+2kMBNpY4nF1qNCRd8SJLA: folds 
Uncalled bet ($0.25) returned to 76o85YBHJ9veRYp2LPuluQ
76o85YBHJ9veRYp2LPuluQ collected $0.60 from pot
76o85YBHJ9veRYp2LPuluQ: doesn't show hand 
*** SUMMARY ***
Total pot $0.60 | Rake $0 
Seat 1: ShCS62CJp4MKfKLKvGKQbA folded before Flop (didn't bet)
Seat 2: PFNLAvMkr8qKc7xCiH0wTA folded before Flop (didn't bet)
Seat 4: JDdN8256cGDC+SqlWOx98Q folded before Flop (didn't bet)
Seat 5: qpG9m8I+cPw8VhB0mnGjYw folded before Flop (didn't bet)
Seat 6: 76o85YBHJ9veRYp2LPuluQ (button) collected ($0.60)
Seat 7: Bb42QRQMhg5/Y0vHP8/2Xw (small blind) folded before Flop
Seat 8: +2kMBNpY4nF1qNCRd8SJLA (big blind) folded before Flop
Seat 9: QEbIGci+itdw+re8RM5fZA folded before Flop (didn't bet)




PokerStars Game #59941582298:  Hold'em No Limit ($0.10/$0.25) - 2009/07/01 1:39:49 ET
Table 'C8mMnVmvkagwolEzTvh07A' 9-max Seat #9 is the button
Seat 1: PqvgxdSg9z5VmrWpbYuz+g ($24.10 in chips) 
Seat 2: Bb42QRQMhg5/Y0vHP8/2Xw ($25 in chips) 
Seat 3: Th3FldXKQW6hWVVPahaoOQ ($35.70 in chips) 
Seat 4: dfNim92Z6XK1/h5SFW5vDg ($25 in chips) 
Seat 5: iGMlK+EhUflPB6jKQd95Cg ($27.85 in chips) 
Seat 7: qmEgnPhQt24xdw/ZRVPLbA ($48.10 in chips) 
Seat 9: 4awUyiDYTgylQKXZ9faBVA ($25 in chips) 
PqvgxdSg9z5VmrWpbYuz+g: posts small blind $0.10
Bb42QRQMhg5/Y0vHP8/2Xw: posts big blind $0.25
AiXn/9o1EwOPZUHujnh/bA: sits out 
*** HOLE CARDS ***
Th3FldXKQW6hWVVPahaoOQ: folds 
dfNim92Z6XK1/h5SFW5vDg: folds 
iGMlK+EhUflPB6jKQd95Cg: folds 
qmEgnPhQt24xdw/ZRVPLbA: raises $0.75 to $1
4awUyiDYTgylQKXZ9faBVA: folds 
PqvgxdSg9z5VmrWpbYuz+g: folds 
Bb42QRQMhg5/Y0vHP8/2Xw: folds 
Uncalled bet ($0.75) returned to qmEgnPhQt24xdw/ZRVPLbA
qmEgnPhQt24xdw/ZRVPLbA collected $0.60 from pot
qmEgnPhQt24xdw/ZRVPLbA: doesn't show hand 
*** SUMMARY ***
Total pot $0.60 | Rake $0 
Seat 1: PqvgxdSg9z5VmrWpbYuz+g (small blind) folded before Flop
Seat 2: Bb42QRQMhg5/Y0vHP8/2Xw (big blind) folded before Flop
Seat 3: Th3FldXKQW6hWVVPahaoOQ folded before Flop (didn't bet)
Seat 4: dfNim92Z6XK1/h5SFW5vDg folded before Flop (didn't bet)
Seat 5: iGMlK+EhUflPB6jKQd95Cg folded before Flop (didn't bet)
Seat 7: qmEgnPhQt24xdw/ZRVPLbA collected ($0.60)
Seat 9: 4awUyiDYTgylQKXZ9faBVA (button) folded before Flop (didn't bet)




PokerStars Game #59941582118:  Hold'em No Limit ($0.10/$0.25) - 2009/07/01 1:39:49 ET
Table '0XPo7K54oZIfG0xlNAcDRw' 9-max Seat #6 is the button
Seat 1: 7cv+9Zc9HIQHNvYsMfV3uA ($28.65 in chips) 
Seat 3: 6qsItdeWZoOL5be2e1RFng ($8.75 in chips) 
Seat 4: RubYqfvGrz2z+5ReNIj9QQ ($28.35 in chips) 
Seat 5: iOmwbUN7u4JFkV6VCA49aA ($25.15 in chips) 
Seat 6: 9gmYYQesalMrUjaF7nKfrQ ($12.05 in chips) 
Seat 7: tYsOBqdU1+x+yFI7zHO7hQ ($28.90 in chips) 
Seat 8: v5jnQ1gfh9nLla3kMXG7Yg ($8.35 in chips) 
tYsOBqdU1+x+yFI7zHO7hQ: posts small blind $0.10
v5jnQ1gfh9nLla3kMXG7Yg: posts big blind $0.25
CmngQmkKTp8tkl6GMRTl6w: sits out 
knif3: sits out 
*** HOLE CARDS ***
7cv+9Zc9HIQHNvYsMfV3uA: folds 
6qsItdeWZoOL5be2e1RFng: calls $0.25
RubYqfvGrz2z+5ReNIj9QQ: raises $0.75 to $1
iOmwbUN7u4JFkV6VCA49aA said, "do u read ur oppenets right taxi"
iOmwbUN7u4JFkV6VCA49aA: folds 
9gmYYQesalMrUjaF7nKfrQ: folds 
tYsOBqdU1+x+yFI7zHO7hQ: folds 
v5jnQ1gfh9nLla3kMXG7Yg: folds 
6qsItdeWZoOL5be2e1RFng: calls $0.75
*** FLOP *** [2h 6h 7h]
6qsItdeWZoOL5be2e1RFng: checks 
RubYqfvGrz2z+5ReNIj9QQ: bets $1.25
6qsItdeWZoOL5be2e1RFng: calls $1.25
*** TURN *** [2h 6h 7h] [4s]
6qsItdeWZoOL5be2e1RFng: checks 
RubYqfvGrz2z+5ReNIj9QQ: bets $2
6qsItdeWZoOL5be2e1RFng: calls $2
*** RIVER *** [2h 6h 7h 4s] [2d]
6qsItdeWZoOL5be2e1RFng: checks 
RubYqfvGrz2z+5ReNIj9QQ: checks 
*** SHOW DOWN ***
6qsItdeWZoOL5be2e1RFng: shows [9h Ts] (a pair of Deuces)
RubYqfvGrz2z+5ReNIj9QQ: shows [6d Ac] (two pair, Sixes and Deuces)
RubYqfvGrz2z+5ReNIj9QQ collected $8.45 from pot
*** SUMMARY ***
Total pot $8.85 | Rake $0.40 
Board [2h 6h 7h 4s 2d]
Seat 1: 7cv+9Zc9HIQHNvYsMfV3uA folded before Flop (didn't bet)
Seat 3: 6qsItdeWZoOL5be2e1RFng showed [9h Ts] and lost with a pair of Deuces
Seat 4: RubYqfvGrz2z+5ReNIj9QQ showed [6d Ac] and won ($8.45) with two pair, Sixes and Deuces
Seat 5: iOmwbUN7u4JFkV6VCA49aA folded before Flop (didn't bet)
Seat 6: 9gmYYQesalMrUjaF7nKfrQ (button) folded before Flop (didn't bet)
Seat 7: tYsOBqdU1+x+yFI7zHO7hQ (small blind) folded before Flop
Seat 8: v5jnQ1gfh9nLla3kMXG7Yg (big blind) folded before Flop




PokerStars Game #59941582270:  Hold'em No Limit ($0.10/$0.25) - 2009/07/01 1:39:49 ET
Table 'WEMI3Mtn7dGARDbgNrKibgQvLFJzpzymuOsaaRYi+8fgx Seat #9 is the button
Seat 2: PdIasPkzm2sqZnN41ZRXOg ($4.50 in chips) 
Seat 4: tLcDklc2rBORNfixyRfVfw ($25 in chips) 
Seat 5: MG90wfSJZnOejs/KD3vlQQ ($37.10 in chips) 
Seat 6: 1S/fpm+f42V/6MNZre+ccg ($25 in chips) 
Seat 7: rQhYIYXSyH/IivYM1dlV5A ($11.95 in chips) 
Seat 8: gehe91e0IyVT0QU/XBkEyg ($24.90 in chips) 
Seat 9: BWzInv8o0kN1pJybv/VjpQ ($44.60 in chips) 
cZ99hugmLBj9KhTlc8nCSw will be allowed to play after the button
PdIasPkzm2sqZnN41ZRXOg: posts small blind $0.10
DdPXdieucQ+n99u1n3A+rQ: is sitting out 
tLcDklc2rBORNfixyRfVfw: posts big blind $0.25
*** HOLE CARDS ***
DdPXdieucQ+n99u1n3A+rQ leaves the table
MG90wfSJZnOejs/KD3vlQQ: folds 
1S/fpm+f42V/6MNZre+ccg: folds 
rQhYIYXSyH/IivYM1dlV5A: folds 
gehe91e0IyVT0QU/XBkEyg: raises $0.75 to $1
BWzInv8o0kN1pJybv/VjpQ: folds 
PdIasPkzm2sqZnN41ZRXOg: folds 
tLcDklc2rBORNfixyRfVfw: folds 
Uncalled bet ($0.75) returned to gehe91e0IyVT0QU/XBkEyg
gehe91e0IyVT0QU/XBkEyg collected $0.60 from pot
Dr.Hibbert55 joins the table at seat #3 
*** SUMMARY ***
Total pot $0.60 | Rake $0 
Seat 2: PdIasPkzm2sqZnN41ZRXOg (small blind) folded before Flop
Seat 4: tLcDklc2rBORNfixyRfVfw (big blind) folded before Flop
Seat 5: MG90wfSJZnOejs/KD3vlQQ folded before Flop (didn't bet)
Seat 6: 1S/fpm+f42V/6MNZre+ccg folded before Flop (didn't bet)
Seat 7: rQhYIYXSyH/IivYM1dlV5A folded before Flop (didn't bet)
Seat 8: gehe91e0IyVT0QU/XBkEyg collected ($0.60)
Seat 9: BWzInv8o0kN1pJybv/VjpQ (button) folded before Flop (didn't bet)




PokerStars Game #59941583006:  Hold'em No Limit ($0.10/$0.25) - 2009/07/01 1:39:50 ET
Table '63uh7ZsO7Tnt+E8b/2bu3A' 6-max Seat #5 is the button
Seat 1: 0av6tRNdi0Ui4f15L7gsVg ($26.15 in chips) 
Seat 2: SFmT9ZsVopnukjvAzrxTRg ($30.25 in chips) 
Seat 3: yVP7GLZBzx47OPi6jzUxMw ($15.85 in chips) 
Seat 4: 2tYgzzRRW/D2GWb2A7f1jw ($7.35 in chips) 
Seat 5: GbCVUNssQ7mqsPWr7J4d3w ($5 in chips) 
Seat 6: qGHGf/553gQnDoklMRe3tg ($32.10 in chips) 
qGHGf/553gQnDoklMRe3tg: posts small blind $0.10
0av6tRNdi0Ui4f15L7gsVg: posts big blind $0.25
*** HOLE CARDS ***
SFmT9ZsVopnukjvAzrxTRg: folds 
yVP7GLZBzx47OPi6jzUxMw: folds 
2tYgzzRRW/D2GWb2A7f1jw: folds 
GbCVUNssQ7mqsPWr7J4d3w: folds 
qGHGf/553gQnDoklMRe3tg: folds 
Uncalled bet ($0.15) returned to 0av6tRNdi0Ui4f15L7gsVg
0av6tRNdi0Ui4f15L7gsVg collected $0.20 from pot
0av6tRNdi0Ui4f15L7gsVg: doesn't show hand 
*** SUMMARY ***
Total pot $0.20 | Rake $0 
Seat 1: 0av6tRNdi0Ui4f15L7gsVg (big blind) collected ($0.20)
Seat 2: SFmT9ZsVopnukjvAzrxTRg folded before Flop (didn't bet)
Seat 3: yVP7GLZBzx47OPi6jzUxMw folded before Flop (didn't bet)
Seat 4: 2tYgzzRRW/D2GWb2A7f1jw folded before Flop (didn't bet)
Seat 5: GbCVUNssQ7mqsPWr7J4d3w (button) folded before Flop (didn't bet)
Seat 6: qGHGf/553gQnDoklMRe3tg (small blind) folded before Flop




PokerStars Game #59941582888:  Hold'em No Limit ($0.10/$0.25) - 2009/07/01 1:39:50 ET
Table 'jdhJTJjFq2KTttwJcd+7nQ' 6-max Seat #2 is the button
Seat 1: LtASJ9OlkqGrrUKGQlpGAw ($27.05 in chips) 
Seat 2: Hsvkc0/G2VV78oVmWYXecw ($5 in chips) 
Seat 3: vqWjZmdQu/Hxw96/IJTWdQ ($25 in chips) 
Seat 4: vx7FwRcelVSsvNYAdp/z0A ($3.25 in chips) 
Seat 5: BV+K0Phf5VBHr7aZPKqbUQ ($25 in chips) 
Seat 6: yb6rnd48JuBccThV68VHAQ ($20.65 in chips) 
vqWjZmdQu/Hxw96/IJTWdQ: posts small blind $0.10
vx7FwRcelVSsvNYAdp/z0A: posts big blind $0.25
*** HOLE CARDS ***
BV+K0Phf5VBHr7aZPKqbUQ: folds 
yb6rnd48JuBccThV68VHAQ: calls $0.25
LtASJ9OlkqGrrUKGQlpGAw: folds 
Hsvkc0/G2VV78oVmWYXecw: folds 
vqWjZmdQu/Hxw96/IJTWdQ: folds 
vx7FwRcelVSsvNYAdp/z0A: raises $0.75 to $1
yb6rnd48JuBccThV68VHAQ: folds 
Uncalled bet ($0.75) returned to vx7FwRcelVSsvNYAdp/z0A
vx7FwRcelVSsvNYAdp/z0A collected $0.60 from pot
*** SUMMARY ***
Total pot $0.60 | Rake $0 
Seat 1: LtASJ9OlkqGrrUKGQlpGAw folded before Flop (didn't bet)
Seat 2: Hsvkc0/G2VV78oVmWYXecw (button) folded before Flop (didn't bet)
Seat 3: vqWjZmdQu/Hxw96/IJTWdQ (small blind) folded before Flop
Seat 4: vx7FwRcelVSsvNYAdp/z0A (big blind) collected ($0.60)
Seat 5: BV+K0Phf5VBHr7aZPKqbUQ folded before Flop (didn't bet)
Seat 6: yb6rnd48JuBccThV68VHAQ folded before Flop




PokerStars Game #59941582590:  Hold'em No Limit ($0.10/$0.25) - 2009/07/01 1:39:50 ET
Table 'nFlmVztKq1HJEWfxmdl15w' 9-max Seat #7 is the button
Seat 1: cZ99hugmLBj9KhTlc8nCSw ($25 in chips) 
Seat 2: Th3FldXKQW6hWVVPahaoOQ ($36.65 in chips) 
Seat 4: +5dSUwD+/k2ktlnutSMivw ($10.05 in chips) 
Seat 5: Tx6zQdk5Ozt9ObEBlU7jeg ($32.45 in chips) 
Seat 6: 4awUyiDYTgylQKXZ9faBVA ($36 in chips) 
Seat 7: dfNim92Z6XK1/h5SFW5vDg ($26.50 in chips) 
Seat 8: +2kMBNpY4nF1qNCRd8SJLA ($34.90 in chips) 
Seat 9: DnDcAdn9P0zGovMERigpFA ($25 in chips) 
+2kMBNpY4nF1qNCRd8SJLA: posts small blind $0.10
DnDcAdn9P0zGovMERigpFA: posts big blind $0.25
DdPXdieucQ+n99u1n3A+rQ: sits out 
*** HOLE CARDS ***
cZ99hugmLBj9KhTlc8nCSw: folds 
Th3FldXKQW6hWVVPahaoOQ: raises $0.75 to $1
+5dSUwD+/k2ktlnutSMivw: calls $1
Tx6zQdk5Ozt9ObEBlU7jeg: folds 
4awUyiDYTgylQKXZ9faBVA: folds 
dfNim92Z6XK1/h5SFW5vDg: folds 
+2kMBNpY4nF1qNCRd8SJLA: calls $0.90
DnDcAdn9P0zGovMERigpFA: folds 
*** FLOP *** [5d 3c 4s]
+2kMBNpY4nF1qNCRd8SJLA: checks 
Th3FldXKQW6hWVVPahaoOQ: checks 
+5dSUwD+/k2ktlnutSMivw: checks 
*** TURN *** [5d 3c 4s] [4d]
+2kMBNpY4nF1qNCRd8SJLA: checks 
Th3FldXKQW6hWVVPahaoOQ: checks 
+5dSUwD+/k2ktlnutSMivw: checks 
*** RIVER *** [5d 3c 4s 4d] [4c]
+2kMBNpY4nF1qNCRd8SJLA: checks 
Th3FldXKQW6hWVVPahaoOQ: checks 
+5dSUwD+/k2ktlnutSMivw: checks 
*** SHOW DOWN ***
+2kMBNpY4nF1qNCRd8SJLA: shows [Ks 7s] (three of a kind, Fours)
Th3FldXKQW6hWVVPahaoOQ: shows [Ac Kd] (three of a kind, Fours - Ace kicker)
+5dSUwD+/k2ktlnutSMivw: shows [Ah 8d] (three of a kind, Fours - lower kicker)
Th3FldXKQW6hWVVPahaoOQ collected $3.10 from pot
*** SUMMARY ***
Total pot $3.25 | Rake $0.15 
Board [5d 3c 4s 4d 4c]
Seat 1: cZ99hugmLBj9KhTlc8nCSw folded before Flop (didn't bet)
Seat 2: Th3FldXKQW6hWVVPahaoOQ showed [Ac Kd] and won ($3.10) with three of a kind, Fours
Seat 4: +5dSUwD+/k2ktlnutSMivw showed [Ah 8d] and lost with three of a kind, Fours
Seat 5: Tx6zQdk5Ozt9ObEBlU7jeg folded before Flop (didn't bet)
Seat 6: 4awUyiDYTgylQKXZ9faBVA folded before Flop (didn't bet)
Seat 7: dfNim92Z6XK1/h5SFW5vDg (button) folded before Flop (didn't bet)
Seat 8: +2kMBNpY4nF1qNCRd8SJLA (small blind) showed [Ks 7s] and lost with three of a kind, Fours
Seat 9: DnDcAdn9P0zGovMERigpFA (big blind) folded before Flop




PokerStars Game #59941582554:  Hold'em No Limit ($0.10/$0.25) - 2009/07/01 1:39:50 ET
Table 'NtEQAxCeIK2io1CGtW658g' 6-max Seat #3 is the button
Seat 1: X437kMQ7AujoaDgjguhU9w ($11.80 in chips) 
Seat 3: m2yWOKfAxqHoy5DDN87Ttw ($37.65 in chips) 
Seat 4: 8296 ($12.25 in chips) 
Seat 5: Hsvkc0/G2VV78oVmWYXecw ($5 in chips) 
Seat 6: /gJNBeCkWL4o85/jvlZ4BA ($64.15 in chips) 
8296: posts small blind $0.10
Hsvkc0/G2VV78oVmWYXecw: posts big blind $0.25
*** HOLE CARDS ***
/gJNBeCkWL4o85/jvlZ4BA: calls $0.25
X437kMQ7AujoaDgjguhU9w: folds 
m2yWOKfAxqHoy5DDN87Ttw: folds 
8296: folds 
Hsvkc0/G2VV78oVmWYXecw: checks 
*** FLOP *** [4d Kc 9d]
Hsvkc0/G2VV78oVmWYXecw: checks 
/gJNBeCkWL4o85/jvlZ4BA: checks 
*** TURN *** [4d Kc 9d] [Ah]
Hsvkc0/G2VV78oVmWYXecw: checks 
/gJNBeCkWL4o85/jvlZ4BA: checks 
*** RIVER *** [4d Kc 9d Ah] [Jh]
Hsvkc0/G2VV78oVmWYXecw: checks 
/gJNBeCkWL4o85/jvlZ4BA: checks 
*** SHOW DOWN ***
Hsvkc0/G2VV78oVmWYXecw: shows [4c 5d] (a pair of Fours)
/gJNBeCkWL4o85/jvlZ4BA: shows [5c 5h] (a pair of Fives)
/gJNBeCkWL4o85/jvlZ4BA collected $0.60 from pot
*** SUMMARY ***
Total pot $0.60 | Rake $0 
Board [4d Kc 9d Ah Jh]
Seat 1: X437kMQ7AujoaDgjguhU9w folded before Flop (didn't bet)
Seat 3: m2yWOKfAxqHoy5DDN87Ttw (button) folded before Flop (didn't bet)
Seat 4: 8296 (small blind) folded before Flop
Seat 5: Hsvkc0/G2VV78oVmWYXecw (big blind) showed [4c 5d] and lost with a pair of Fours
Seat 6: /gJNBeCkWL4o85/jvlZ4BA showed [5c 5h] and won ($0.60) with a pair of Fives




PokerStars Game #59941582798:  Hold'em No Limit ($0.10/$0.25) - 2009/07/01 1:39:50 ET
Table '8PD/MTROSMd6Y8mZeykbpg' 6-max Seat #4 is the button
Seat 2: +C3eP/ysyROWbEXJFPswVA ($24.95 in chips) 
Seat 3: vqWjZmdQu/Hxw96/IJTWdQ ($25 in chips) 
Seat 4: DFi/Lzkjsfv8QswS80JX9Q ($53.70 in chips) 
Seat 5: z3tQwy28dp5FykDJC/wzQw ($26.20 in chips) 
z3tQwy28dp5FykDJC/wzQw: posts small blind $0.10
+C3eP/ysyROWbEXJFPswVA: posts big blind $0.25
*** HOLE CARDS ***
vqWjZmdQu/Hxw96/IJTWdQ: folds 
DFi/Lzkjsfv8QswS80JX9Q: folds 
fxNpaToxECtD2Goelmg9vA joins the table at seat #1 
z3tQwy28dp5FykDJC/wzQw: calls $0.15
+C3eP/ysyROWbEXJFPswVA: checks 
*** FLOP *** [6c 4h 4d]
z3tQwy28dp5FykDJC/wzQw: checks 
+C3eP/ysyROWbEXJFPswVA: bets $0.25
z3tQwy28dp5FykDJC/wzQw: folds 
Uncalled bet ($0.25) returned to +C3eP/ysyROWbEXJFPswVA
+C3eP/ysyROWbEXJFPswVA collected $0.50 from pot
+C3eP/ysyROWbEXJFPswVA: doesn't show hand 
*** SUMMARY ***
Total pot $0.50 | Rake $0 
Board [6c 4h 4d]
Seat 2: +C3eP/ysyROWbEXJFPswVA (big blind) collected ($0.50)
Seat 3: vqWjZmdQu/Hxw96/IJTWdQ folded before Flop (didn't bet)
Seat 4: DFi/Lzkjsfv8QswS80JX9Q (button) folded before Flop (didn't bet)
Seat 5: z3tQwy28dp5FykDJC/wzQw (small blind) folded on the Flop




PokerStars Game #59941582740:  Hold'em No Limit ($0.10/$0.25) - 2009/07/01 1:39:50 ET
Table 'BmUMTVcNATeov2rAGYU0Qg' 9-max Seat #5 is the button
Seat 1: QEbIGci+itdw+re8RM5fZA ($36.20 in chips) 
Seat 2: jJnMGXoBXye+afMd0k0rUw ($9.95 in chips) 
Seat 3: ir5Jy8ck6DrdqgJ/3chcWw ($7.15 in chips) 
Seat 4: aNpwfA31EREwO+ar4XzBCw ($37.50 in chips) 
Seat 5: QBNcj9fHxkh/+s/oVw+JmQ ($23.25 in chips) 
Seat 6: w1ukf8uPa4+WH561TtVRxA ($25 in chips) 
Seat 7: CmngQmkKTp8tkl6GMRTl6w ($8.50 in chips) 
Seat 8: f/H6PsHRl4W1JyNsEDvPtg ($33.90 in chips) 
Seat 9: /artgaAtyUtUtD8FZo6puA ($12.10 in chips) 
w1ukf8uPa4+WH561TtVRxA: posts small blind $0.10
CmngQmkKTp8tkl6GMRTl6w: posts big blind $0.25
*** HOLE CARDS ***
f/H6PsHRl4W1JyNsEDvPtg: folds 
/artgaAtyUtUtD8FZo6puA: folds 
QEbIGci+itdw+re8RM5fZA: folds 
jJnMGXoBXye+afMd0k0rUw: folds 
ir5Jy8ck6DrdqgJ/3chcWw: folds 
aNpwfA31EREwO+ar4XzBCw: raises $0.75 to $1
QBNcj9fHxkh/+s/oVw+JmQ: folds 
w1ukf8uPa4+WH561TtVRxA: folds 
CmngQmkKTp8tkl6GMRTl6w: folds 
Uncalled bet ($0.75) returned to aNpwfA31EREwO+ar4XzBCw
aNpwfA31EREwO+ar4XzBCw collected $0.60 from pot
aNpwfA31EREwO+ar4XzBCw: doesn't show hand 
*** SUMMARY ***
Total pot $0.60 | Rake $0 
Seat 1: QEbIGci+itdw+re8RM5fZA folded before Flop (didn't bet)
Seat 2: jJnMGXoBXye+afMd0k0rUw folded before Flop (didn't bet)
Seat 3: ir5Jy8ck6DrdqgJ/3chcWw folded before Flop (didn't bet)
Seat 4: aNpwfA31EREwO+ar4XzBCw collected ($0.60)
Seat 5: QBNcj9fHxkh/+s/oVw+JmQ (button) folded before Flop (didn't bet)
Seat 6: w1ukf8uPa4+WH561TtVRxA (small blind) folded before Flop
Seat 7: CmngQmkKTp8tkl6GMRTl6w (big blind) folded before Flop
Seat 8: f/H6PsHRl4W1JyNsEDvPtg folded before Flop (didn't bet)
Seat 9: /artgaAtyUtUtD8FZo6puA folded before Flop (didn't bet)




PokerStars Game #59941583586:  Hold'em No Limit ($0.10/$0.25) - 2009/07/01 1:39:51 ET
Table 'gnrUwXkIPE0C8xl6cB4Hyw' 9-max Seat #2 is the button
Seat 1: EQXHDnIzAsORnIXRNtXRlA ($22.60 in chips) 
Seat 2: 7je+LC5Mfs6nL8YBVh4frQ ($5 in chips) 
Seat 3: PdIasPkzm2sqZnN41ZRXOg ($5.10 in chips) 
Seat 4: wGigCmBR/9XWkPpvYos3aQ ($25.35 in chips) 
Seat 5: gehe91e0IyVT0QU/XBkEyg ($27.50 in chips) 
Seat 6: dtZ84flFEi4Q+SGrHMJRDQ ($26.15 in chips) 
Seat 7: OXPkK84/qv92EMwXPiG5rQ ($9.75 in chips) 
Seat 8: 4awUyiDYTgylQKXZ9faBVA ($56.20 in chips) 
Seat 9: F7pnn6czNpHvRM55XcA2EA ($28.10 in chips) 
PdIasPkzm2sqZnN41ZRXOg: posts small blind $0.10
wGigCmBR/9XWkPpvYos3aQ: posts big blind $0.25
*** HOLE CARDS ***
gehe91e0IyVT0QU/XBkEyg: folds 
dtZ84flFEi4Q+SGrHMJRDQ: folds 
OXPkK84/qv92EMwXPiG5rQ: raises $0.75 to $1
4awUyiDYTgylQKXZ9faBVA: folds 
F7pnn6czNpHvRM55XcA2EA: folds 
EQXHDnIzAsORnIXRNtXRlA: folds 
7je+LC5Mfs6nL8YBVh4frQ: folds 
PdIasPkzm2sqZnN41ZRXOg: folds 
wGigCmBR/9XWkPpvYos3aQ: folds 
Uncalled bet ($0.75) returned to OXPkK84/qv92EMwXPiG5rQ
OXPkK84/qv92EMwXPiG5rQ collected $0.60 from pot
OXPkK84/qv92EMwXPiG5rQ: doesn't show hand 
*** SUMMARY ***
Total pot $0.60 | Rake $0 
Seat 1: EQXHDnIzAsORnIXRNtXRlA folded before Flop (didn't bet)
Seat 2: 7je+LC5Mfs6nL8YBVh4frQ (button) folded before Flop (didn't bet)
Seat 3: PdIasPkzm2sqZnN41ZRXOg (small blind) folded before Flop
Seat 4: wGigCmBR/9XWkPpvYos3aQ (big blind) folded before Flop
Seat 5: gehe91e0IyVT0QU/XBkEyg folded before Flop (didn't bet)
Seat 6: dtZ84flFEi4Q+SGrHMJRDQ folded before Flop (didn't bet)
Seat 7: OXPkK84/qv92EMwXPiG5rQ collected ($0.60)
Seat 8: 4awUyiDYTgylQKXZ9faBVA folded before Flop (didn't bet)
Seat 9: F7pnn6czNpHvRM55XcA2EA folded before Flop (didn't bet)




PokerStars Game #59941583620:  Hold'em No Limit ($0.10/$0.25) - 2009/07/01 1:39:51 ET
Table '/asc7VQ/OpF/oVJ3erB80w' 9-max Seat #4 is the button
Seat 2: +LseQ4csMghI3KY4cLSGMQ ($24.75 in chips) 
Seat 3: WEb58GPxGJGcxGh34AFZRQ ($2.70 in chips) 
Seat 4: Rjy74A2wdEiDWplMcUbA+w ($20.10 in chips) 
Seat 5: QB9VESHry/CRTDKMGwKwsQ ($42.95 in chips) 
Seat 6: XwQK8xvCADxp0bUmji+Zyg ($12.45 in chips) 
Seat 7: 7Qlge5BZqMQvXxiy4HU3Hw ($6.75 in chips) 
Seat 8: jB7U2KxE3pjvDhvZHXK2Ag ($17.30 in chips) 
Seat 9: zUXhymECc2C9W9ZNw6qppA ($9.65 in chips) 
QB9VESHry/CRTDKMGwKwsQ: posts small blind $0.10
XwQK8xvCADxp0bUmji+Zyg: posts big blind $0.25
*** HOLE CARDS ***
8WPqTOlC7HvWuhmvZhP82g is disconnected 
7Qlge5BZqMQvXxiy4HU3Hw: folds 
jB7U2KxE3pjvDhvZHXK2Ag: calls $0.25
zUXhymECc2C9W9ZNw6qppA: folds 
+LseQ4csMghI3KY4cLSGMQ: calls $0.25
WEb58GPxGJGcxGh34AFZRQ: folds 
Rjy74A2wdEiDWplMcUbA+w: calls $0.25
QB9VESHry/CRTDKMGwKwsQ: calls $0.15
7Qlge5BZqMQvXxiy4HU3Hw said, "HEY PARROT U FROM ALABAMA"
XwQK8xvCADxp0bUmji+Zyg: checks 
*** FLOP *** [9s Ad 8h]
QB9VESHry/CRTDKMGwKwsQ: checks 
XwQK8xvCADxp0bUmji+Zyg: checks 
jB7U2KxE3pjvDhvZHXK2Ag: checks 
+LseQ4csMghI3KY4cLSGMQ: checks 
Rjy74A2wdEiDWplMcUbA+w: bets $0.25
QB9VESHry/CRTDKMGwKwsQ: calls $0.25
XwQK8xvCADxp0bUmji+Zyg: folds 
jB7U2KxE3pjvDhvZHXK2Ag: raises $0.75 to $1
+LseQ4csMghI3KY4cLSGMQ: folds 
Rjy74A2wdEiDWplMcUbA+w: folds 
QB9VESHry/CRTDKMGwKwsQ: folds 
Uncalled bet ($0.75) returned to jB7U2KxE3pjvDhvZHXK2Ag
jB7U2KxE3pjvDhvZHXK2Ag collected $1.95 from pot
*** SUMMARY ***
Total pot $2 | Rake $0.05 
Board [9s Ad 8h]
Seat 2: +LseQ4csMghI3KY4cLSGMQ folded on the Flop
Seat 3: WEb58GPxGJGcxGh34AFZRQ folded before Flop (didn't bet)
Seat 4: Rjy74A2wdEiDWplMcUbA+w (button) folded on the Flop
Seat 5: QB9VESHry/CRTDKMGwKwsQ (small blind) folded on the Flop
Seat 6: XwQK8xvCADxp0bUmji+Zyg (big blind) folded on the Flop
Seat 7: 7Qlge5BZqMQvXxiy4HU3Hw folded before Flop (didn't bet)
Seat 8: jB7U2KxE3pjvDhvZHXK2Ag collected ($1.95)
Seat 9: zUXhymECc2C9W9ZNw6qppA folded before Flop (didn't bet)




PokerStars Game #59941583602:  Hold'em No Limit ($0.10/$0.25) - 2009/07/01 1:39:51 ET
Table '8QBBaev+cI2i/r2H6ml/lg' 9-max Seat #7 is the button
Seat 1: s2xLPOl/vhl/26apJ3vsOQ ($34.45 in chips) 
Seat 2: 1S/fpm+f42V/6MNZre+ccg ($25.40 in chips) 
Seat 3: zgi+EUykT/pZQpoUG6+oEg ($4.65 in chips) 
Seat 4: ytpGB2nr/CLVHnyKMRiEFQ ($15 in chips) 
Seat 5: 0QdZrkFD7aGKeBXPGbIomA ($11.70 in chips) 
Seat 7: eK8qa6EPcH2zhtbmWSvc9g ($31.05 in chips) 
Seat 8: vr1IK/Q4HXm8s8V0/dePzQ ($12.55 in chips) 
Seat 9: EUMLvzDkECHBit+xa+uGjg ($23.50 in chips) 
vr1IK/Q4HXm8s8V0/dePzQ: posts small blind $0.10
EUMLvzDkECHBit+xa+uGjg: posts big blind $0.25
*** HOLE CARDS ***
s2xLPOl/vhl/26apJ3vsOQ: folds 
1S/fpm+f42V/6MNZre+ccg: folds 
zgi+EUykT/pZQpoUG6+oEg: folds 
ytpGB2nr/CLVHnyKMRiEFQ: folds 
0QdZrkFD7aGKeBXPGbIomA: folds 
eK8qa6EPcH2zhtbmWSvc9g: folds 
vr1IK/Q4HXm8s8V0/dePzQ: calls $0.15
EUMLvzDkECHBit+xa+uGjg: checks 
*** FLOP *** [As Td 5d]
vr1IK/Q4HXm8s8V0/dePzQ: bets $0.50
EUMLvzDkECHBit+xa+uGjg: folds 
Uncalled bet ($0.50) returned to vr1IK/Q4HXm8s8V0/dePzQ
vr1IK/Q4HXm8s8V0/dePzQ collected $0.50 from pot
vr1IK/Q4HXm8s8V0/dePzQ: doesn't show hand 
*** SUMMARY ***
Total pot $0.50 | Rake $0 
Board [As Td 5d]
Seat 1: s2xLPOl/vhl/26apJ3vsOQ folded before Flop (didn't bet)
Seat 2: 1S/fpm+f42V/6MNZre+ccg folded before Flop (didn't bet)
Seat 3: zgi+EUykT/pZQpoUG6+oEg folded before Flop (didn't bet)
Seat 4: ytpGB2nr/CLVHnyKMRiEFQ folded before Flop (didn't bet)
Seat 5: 0QdZrkFD7aGKeBXPGbIomA folded before Flop (didn't bet)
Seat 7: eK8qa6EPcH2zhtbmWSvc9g (button) folded before Flop (didn't bet)
Seat 8: vr1IK/Q4HXm8s8V0/dePzQ (small blind) collected ($0.50)
Seat 9: EUMLvzDkECHBit+xa+uGjg (big blind) folded on the Flop




PokerStars Game #59941583524:  Hold'em No Limit ($0.10/$0.25) - 2009/07/01 1:39:51 ET
Table 'Do4nrTNDYpK3sQjwFxX+Og' 6-max Seat #1 is the button
Seat 1: 7JrQNOR9wRBxq9ijFhWieg ($39.10 in chips) 
Seat 2: tzMoGl9F0PUr5NibYueeSw ($64.05 in chips) 
Seat 3: TSmua8tGK3sTbwi0ynrW9Q ($25.90 in chips) 
Seat 4: cWc85bEzdRzpUMhRKm8pwQ ($34.40 in chips) 
Seat 5: Ew/TYPQIsbQ2X8nm5iAJBg ($35.70 in chips) 
Seat 6: lBoEwOFgzcERLIRUkUoRTw ($23.90 in chips) 
tzMoGl9F0PUr5NibYueeSw: posts small blind $0.10
TSmua8tGK3sTbwi0ynrW9Q: posts big blind $0.25
*** HOLE CARDS ***
cWc85bEzdRzpUMhRKm8pwQ: raises $0.75 to $1
Ew/TYPQIsbQ2X8nm5iAJBg: folds 
lBoEwOFgzcERLIRUkUoRTw: folds 
7JrQNOR9wRBxq9ijFhWieg: calls $1
tzMoGl9F0PUr5NibYueeSw: calls $0.90
TSmua8tGK3sTbwi0ynrW9Q: calls $0.75
*** FLOP *** [Jc Kh Ad]
tzMoGl9F0PUr5NibYueeSw: checks 
TSmua8tGK3sTbwi0ynrW9Q: checks 
cWc85bEzdRzpUMhRKm8pwQ: checks 
7JrQNOR9wRBxq9ijFhWieg said, "might have done it"
7JrQNOR9wRBxq9ijFhWieg: checks 
*** TURN *** [Jc Kh Ad] [2d]
tzMoGl9F0PUr5NibYueeSw: bets $1.75
TSmua8tGK3sTbwi0ynrW9Q: calls $1.75
cWc85bEzdRzpUMhRKm8pwQ: folds 
7JrQNOR9wRBxq9ijFhWieg: folds 
*** RIVER *** [Jc Kh Ad 2d] [3s]
tzMoGl9F0PUr5NibYueeSw: bets $2.25
TSmua8tGK3sTbwi0ynrW9Q: folds 
Uncalled bet ($2.25) returned to tzMoGl9F0PUr5NibYueeSw
tzMoGl9F0PUr5NibYueeSw collected $7.15 from pot
tzMoGl9F0PUr5NibYueeSw: doesn't show hand 
*** SUMMARY ***
Total pot $7.50 | Rake $0.35 
Board [Jc Kh Ad 2d 3s]
Seat 1: 7JrQNOR9wRBxq9ijFhWieg (button) folded on the Turn
Seat 2: tzMoGl9F0PUr5NibYueeSw (small blind) collected ($7.15)
Seat 3: TSmua8tGK3sTbwi0ynrW9Q (big blind) folded on the River
Seat 4: cWc85bEzdRzpUMhRKm8pwQ folded on the Turn
Seat 5: Ew/TYPQIsbQ2X8nm5iAJBg folded before Flop (didn't bet)
Seat 6: lBoEwOFgzcERLIRUkUoRTw folded before Flop (didn't bet)




PokerStars Game #59941583200:  Hold'em No Limit ($0.10/$0.25) - 2009/07/01 1:39:51 ET
Table 'O5NgMYt6EWbLBozZb3kseg' 6-max Seat #2 is the button
Seat 1: MCCWc70bl051s/EF6nHRcA ($26.80 in chips) 
Seat 2: /gJNBeCkWL4o85/jvlZ4BA ($33.50 in chips) 
Seat 3: tLM9aw7T3kBEIhQEh1roOg ($6.60 in chips) 
Seat 4: txiWmlZ/sfM8Td16RHH/cA ($4.20 in chips) 
Seat 5: vu2kzHaDtgr6NM7rdq0chA ($85.55 in chips) 
Seat 6: k9vn40MOqqb+xF+7GZ6v2g ($118.25 in chips) 
tLM9aw7T3kBEIhQEh1roOg: posts small blind $0.10
txiWmlZ/sfM8Td16RHH/cA: posts big blind $0.25
*** HOLE CARDS ***
vu2kzHaDtgr6NM7rdq0chA: folds 
k9vn40MOqqb+xF+7GZ6v2g: folds 
MCCWc70bl051s/EF6nHRcA: folds 
/gJNBeCkWL4o85/jvlZ4BA: raises $0.75 to $1
tLM9aw7T3kBEIhQEh1roOg: folds 
txiWmlZ/sfM8Td16RHH/cA: calls $0.75
*** FLOP *** [Ad 9h 2s]
txiWmlZ/sfM8Td16RHH/cA: checks 
/gJNBeCkWL4o85/jvlZ4BA: bets $1.25
txiWmlZ/sfM8Td16RHH/cA: folds 
Uncalled bet ($1.25) returned to /gJNBeCkWL4o85/jvlZ4BA
/gJNBeCkWL4o85/jvlZ4BA collected $2 from pot
*** SUMMARY ***
Total pot $2.10 | Rake $0.10 
Board [Ad 9h 2s]
Seat 1: MCCWc70bl051s/EF6nHRcA folded before Flop (didn't bet)
Seat 2: /gJNBeCkWL4o85/jvlZ4BA (button) collected ($2)
Seat 3: tLM9aw7T3kBEIhQEh1roOg (small blind) folded before Flop
Seat 4: txiWmlZ/sfM8Td16RHH/cA (big blind) folded on the Flop
Seat 5: vu2kzHaDtgr6NM7rdq0chA folded before Flop (didn't bet)
Seat 6: k9vn40MOqqb+xF+7GZ6v2g folded before Flop (didn't bet)




PokerStars Game #59941583546:  Hold'em No Limit ($0.10/$0.25) - 2009/07/01 1:39:51 ET
Table 'Mef6A0EMopL6WaFO5/KO9g' 6-max Seat #1 is the button
Seat 1: GbCVUNssQ7mqsPWr7J4d3w ($4.65 in chips) 
Seat 2: 8ClCHtFXGNplITm+63KB+Q ($32.75 in chips) 
Seat 3: Wq26opBLDGJe91GRJn2epg ($11.35 in chips) 
Seat 4: lquriepNQBhDV5P1SWHhnA ($25.45 in chips) 
Seat 5: DihMHaz4WNETH1bPDe13kA ($25 in chips) 
Seat 6: jp34e617tIzV8tKIWmfAbA ($33.65 in chips) 
8ClCHtFXGNplITm+63KB+Q: posts small blind $0.10
Wq26opBLDGJe91GRJn2epg: posts big blind $0.25
*** HOLE CARDS ***
lquriepNQBhDV5P1SWHhnA: folds 
DihMHaz4WNETH1bPDe13kA: folds 
jp34e617tIzV8tKIWmfAbA: folds 
GbCVUNssQ7mqsPWr7J4d3w: folds 
8ClCHtFXGNplITm+63KB+Q: folds 
Uncalled bet ($0.15) returned to Wq26opBLDGJe91GRJn2epg
Wq26opBLDGJe91GRJn2epg collected $0.20 from pot
*** SUMMARY ***
Total pot $0.20 | Rake $0 
Seat 1: GbCVUNssQ7mqsPWr7J4d3w (button) folded before Flop (didn't bet)
Seat 2: 8ClCHtFXGNplITm+63KB+Q (small blind) folded before Flop
Seat 3: Wq26opBLDGJe91GRJn2epg (big blind) collected ($0.20)
Seat 4: lquriepNQBhDV5P1SWHhnA folded before Flop (didn't bet)
Seat 5: DihMHaz4WNETH1bPDe13kA folded before Flop (didn't bet)
Seat 6: jp34e617tIzV8tKIWmfAbA folded before Flop (didn't bet)




PokerStars Game #59941583110:  Hold'em No Limit ($0.10/$0.25) - 2009/07/01 1:39:51 ET
Table 'jItkp2PNTbH9Cf7gqsAF7g' 9-max Seat #7 is the button
Seat 1: wGigCmBR/9XWkPpvYos3aQ ($25 in chips) 
Seat 2: qwr38jl5txoR36M7G5qi4A ($8.45 in chips) 
Seat 5: NO6qGDOw12lhu3zh1xW3Bg ($16.95 in chips) 
Seat 6: cZ99hugmLBj9KhTlc8nCSw ($53 in chips) 
Seat 7: z5GxcHlYz/GSz6W2uFiTtg ($20.70 in chips) 
Seat 9: dtZ84flFEi4Q+SGrHMJRDQ ($25.50 in chips) 
dtZ84flFEi4Q+SGrHMJRDQ: posts small blind $0.10
wGigCmBR/9XWkPpvYos3aQ: posts big blind $0.25
hitrac: sits out 
jdmak2009: sits out 
*** HOLE CARDS ***
qwr38jl5txoR36M7G5qi4A: folds 
NO6qGDOw12lhu3zh1xW3Bg: calls $0.25
cZ99hugmLBj9KhTlc8nCSw: folds 
z5GxcHlYz/GSz6W2uFiTtg: calls $0.25
dtZ84flFEi4Q+SGrHMJRDQ: folds 
wGigCmBR/9XWkPpvYos3aQ: checks 
*** FLOP *** [Qd Tc 3d]
wGigCmBR/9XWkPpvYos3aQ: checks 
NO6qGDOw12lhu3zh1xW3Bg: bets $0.25
cq6LACCDFivk2+PeoiB2sw joins the table at seat #8 
z5GxcHlYz/GSz6W2uFiTtg: raises $0.75 to $1
wGigCmBR/9XWkPpvYos3aQ: folds 
NO6qGDOw12lhu3zh1xW3Bg: calls $0.75
*** TURN *** [Qd Tc 3d] [6d]
NO6qGDOw12lhu3zh1xW3Bg: checks 
z5GxcHlYz/GSz6W2uFiTtg: checks 
*** RIVER *** [Qd Tc 3d 6d] [3h]
NO6qGDOw12lhu3zh1xW3Bg: bets $1.50
z5GxcHlYz/GSz6W2uFiTtg: calls $1.50
*** SHOW DOWN ***
NO6qGDOw12lhu3zh1xW3Bg: shows [Kd 3c] (three of a kind, Threes)
z5GxcHlYz/GSz6W2uFiTtg: mucks hand 
NO6qGDOw12lhu3zh1xW3Bg collected $5.60 from pot
*** SUMMARY ***
Total pot $5.85 | Rake $0.25 
Board [Qd Tc 3d 6d 3h]
Seat 1: wGigCmBR/9XWkPpvYos3aQ (big blind) folded on the Flop
Seat 2: qwr38jl5txoR36M7G5qi4A folded before Flop (didn't bet)
Seat 5: NO6qGDOw12lhu3zh1xW3Bg showed [Kd 3c] and won ($5.60) with three of a kind, Threes
Seat 6: cZ99hugmLBj9KhTlc8nCSw folded before Flop (didn't bet)
Seat 7: z5GxcHlYz/GSz6W2uFiTtg (button) mucked
Seat 9: dtZ84flFEi4Q+SGrHMJRDQ (small blind) folded before Flop




PokerStars Game #59941583454:  Hold'em No Limit ($0.10/$0.25) - 2009/07/01 1:39:51 ET
Table 'Zi9/NqNs3XoL1eWhMCyZyg' 9-max Seat #4 is the button
Seat 2: Th3FldXKQW6hWVVPahaoOQ ($34.30 in chips) 
Seat 4: dmYlc+1cjwZMJ7wV+Z0rRg ($24.50 in chips) 
Seat 5: OiV1PWZ3IkN29JlmCcnTwQ ($5 in chips) 
Seat 7: 0QdZrkFD7aGKeBXPGbIomA ($4.35 in chips) 
Seat 8: nm4Dj/f+jJEwKVsUnKh73g ($38.65 in chips) 
Seat 9: tYsOBqdU1+x+yFI7zHO7hQ ($31.65 in chips) 
OiV1PWZ3IkN29JlmCcnTwQ: posts small blind $0.10
0QdZrkFD7aGKeBXPGbIomA: posts big blind $0.25
*** HOLE CARDS ***
nm4Dj/f+jJEwKVsUnKh73g: folds 
tYsOBqdU1+x+yFI7zHO7hQ: folds 
Th3FldXKQW6hWVVPahaoOQ: folds 
dmYlc+1cjwZMJ7wV+Z0rRg: raises $0.50 to $0.75
OiV1PWZ3IkN29JlmCcnTwQ: folds 
0QdZrkFD7aGKeBXPGbIomA: calls $0.50
*** FLOP *** [9h 8c Th]
0QdZrkFD7aGKeBXPGbIomA: checks 
dmYlc+1cjwZMJ7wV+Z0rRg: checks 
*** TURN *** [9h 8c Th] [7s]
0QdZrkFD7aGKeBXPGbIomA: bets $0.50
dmYlc+1cjwZMJ7wV+Z0rRg: calls $0.50
*** RIVER *** [9h 8c Th 7s] [5h]
0QdZrkFD7aGKeBXPGbIomA: bets $1.25
dmYlc+1cjwZMJ7wV+Z0rRg: calls $1.25
*** SHOW DOWN ***
0QdZrkFD7aGKeBXPGbIomA: shows [Qc Jc] (a straight, Eight to Queen)
dmYlc+1cjwZMJ7wV+Z0rRg: mucks hand 
0QdZrkFD7aGKeBXPGbIomA collected $4.85 from pot
*** SUMMARY ***
Total pot $5.10 | Rake $0.25 
Board [9h 8c Th 7s 5h]
Seat 2: Th3FldXKQW6hWVVPahaoOQ folded before Flop (didn't bet)
Seat 4: dmYlc+1cjwZMJ7wV+Z0rRg (button) mucked
Seat 5: OiV1PWZ3IkN29JlmCcnTwQ (small blind) folded before Flop
Seat 7: 0QdZrkFD7aGKeBXPGbIomA (big blind) showed [Qc Jc] and won ($4.85) with a straight, Eight to Queen
Seat 8: nm4Dj/f+jJEwKVsUnKh73g folded before Flop (didn't bet)
Seat 9: tYsOBqdU1+x+yFI7zHO7hQ folded before Flop (didn't bet)




PokerStars Game #59941583688:  Hold'em No Limit ($0.10/$0.25) - 2009/07/01 1:39:52 ET
Table 'FuFyQHmlO/QqQp//rDRrPg' 6-max Seat #6 is the button
Seat 1: jp34e617tIzV8tKIWmfAbA ($26.30 in chips) 
Seat 2: G3h3THGB1j3qdHDVHpnJWg ($22.80 in chips) 
Seat 3: EeUZtMU058v2ObUACOF4Og ($30.60 in chips) 
Seat 4: OMGl+YMGogf2JWIRfT2/Yg ($4.75 in chips) 
Seat 5: xrf8tAXKQHG99HixCot1Iw ($20.60 in chips) 
Seat 6: 6DwBRH+xZ12AAZmeAg+aXw ($59.65 in chips) 
jp34e617tIzV8tKIWmfAbA: posts small blind $0.10
G3h3THGB1j3qdHDVHpnJWg: posts big blind $0.25
*** HOLE CARDS ***
EeUZtMU058v2ObUACOF4Og: folds 
OMGl+YMGogf2JWIRfT2/Yg: folds 
xrf8tAXKQHG99HixCot1Iw: folds 
6DwBRH+xZ12AAZmeAg+aXw: folds 
jp34e617tIzV8tKIWmfAbA: folds 
Uncalled bet ($0.15) returned to G3h3THGB1j3qdHDVHpnJWg
G3h3THGB1j3qdHDVHpnJWg collected $0.20 from pot
*** SUMMARY ***
Total pot $0.20 | Rake $0 
Seat 1: jp34e617tIzV8tKIWmfAbA (small blind) folded before Flop
Seat 2: G3h3THGB1j3qdHDVHpnJWg (big blind) collected ($0.20)
Seat 3: EeUZtMU058v2ObUACOF4Og folded before Flop (didn't bet)
Seat 4: OMGl+YMGogf2JWIRfT2/Yg folded before Flop (didn't bet)
Seat 5: xrf8tAXKQHG99HixCot1Iw folded before Flop (didn't bet)
Seat 6: 6DwBRH+xZ12AAZmeAg+aXw (button) folded before Flop (didn't bet)




PokerStars Game #59941583870:  Hold'em No Limit ($0.10/$0.25) - 2009/07/01 1:39:52 ET
Table 'zKwHJD0cmKNUure9qQTfFg' 6-max Seat #4 is the button
Seat 1: RXYRBsbRgZxcivyqSdOo3A ($3.90 in chips) 
Seat 2: xrf8tAXKQHG99HixCot1Iw ($26.55 in chips) 
Seat 3: 60PLIlpucQhA08L3YbNmag ($5.60 in chips) 
Seat 4: v+QfkGiuj9bgtuNoVnDO8w ($25.80 in chips) 
Seat 5: E4AqQ1egsnu0oH2RqsbCmQ ($4.55 in chips) 
Seat 6: edio/rLJ06xeZOfLhoL3UA ($11.55 in chips) 
E4AqQ1egsnu0oH2RqsbCmQ: posts small blind $0.10
edio/rLJ06xeZOfLhoL3UA: posts big blind $0.25
*** HOLE CARDS ***
RXYRBsbRgZxcivyqSdOo3A: folds 
xrf8tAXKQHG99HixCot1Iw: raises $0.50 to $0.75
60PLIlpucQhA08L3YbNmag: folds 
v+QfkGiuj9bgtuNoVnDO8w: folds 
E4AqQ1egsnu0oH2RqsbCmQ: folds 
edio/rLJ06xeZOfLhoL3UA: folds 
Uncalled bet ($0.50) returned to xrf8tAXKQHG99HixCot1Iw
xrf8tAXKQHG99HixCot1Iw collected $0.60 from pot
xrf8tAXKQHG99HixCot1Iw: doesn't show hand 
*** SUMMARY ***
Total pot $0.60 | Rake $0 
Seat 1: RXYRBsbRgZxcivyqSdOo3A folded before Flop (didn't bet)
Seat 2: xrf8tAXKQHG99HixCot1Iw collected ($0.60)
Seat 3: 60PLIlpucQhA08L3YbNmag folded before Flop (didn't bet)
Seat 4: v+QfkGiuj9bgtuNoVnDO8w (button) folded before Flop (didn't bet)
Seat 5: E4AqQ1egsnu0oH2RqsbCmQ (small blind) folded before Flop
Seat 6: edio/rLJ06xeZOfLhoL3UA (big blind) folded before Flop




PokerStars Game #59941583754:  Hold'em No Limit ($0.10/$0.25) - 2009/07/01 1:39:52 ET
Table 'wRXcD9iXgBbdvKhWmfnBnw' 6-max Seat #5 is the button
Seat 1: 8tR2s7yV/Fr0ePp1w5XnJw ($12.45 in chips) 
Seat 2: vUr8qM1UsCElsCI9B/McdQ ($28.95 in chips) 
Seat 3: l4ToKwb3EVcEuva7hPqMCQ ($3.85 in chips) 
Seat 4: 7NY6Es0O5qlPDxirJ9iU4g ($5 in chips) 
Seat 5: EE16Ua5b1HSsYej5zeXOlA ($46.75 in chips) 
Seat 6: JFIAqU8lCZ0vWwEl4bdGsg ($25.10 in chips) 
JFIAqU8lCZ0vWwEl4bdGsg: posts small blind $0.10
8tR2s7yV/Fr0ePp1w5XnJw: posts big blind $0.25
7NY6Es0O5qlPDxirJ9iU4g: posts big blind $0.25
*** HOLE CARDS ***
vUr8qM1UsCElsCI9B/McdQ: calls $0.25
l4ToKwb3EVcEuva7hPqMCQ: raises $0.75 to $1
7NY6Es0O5qlPDxirJ9iU4g: folds 
EE16Ua5b1HSsYej5zeXOlA: calls $1
JFIAqU8lCZ0vWwEl4bdGsg: folds 
8tR2s7yV/Fr0ePp1w5XnJw: folds 
vUr8qM1UsCElsCI9B/McdQ: calls $0.75
*** FLOP *** [6c 9s Qd]
vUr8qM1UsCElsCI9B/McdQ: checks 
l4ToKwb3EVcEuva7hPqMCQ: checks 
EE16Ua5b1HSsYej5zeXOlA: checks 
*** TURN *** [6c 9s Qd] [Ts]
vUr8qM1UsCElsCI9B/McdQ: checks 
l4ToKwb3EVcEuva7hPqMCQ: checks 
EE16Ua5b1HSsYej5zeXOlA: checks 
*** RIVER *** [6c 9s Qd Ts] [3h]
vUr8qM1UsCElsCI9B/McdQ: bets $0.25
l4ToKwb3EVcEuva7hPqMCQ: raises $0.25 to $0.50
EE16Ua5b1HSsYej5zeXOlA: folds 
vUr8qM1UsCElsCI9B/McdQ: calls $0.25
*** SHOW DOWN ***
l4ToKwb3EVcEuva7hPqMCQ: shows [9h 9c] (three of a kind, Nines)
vUr8qM1UsCElsCI9B/McdQ: mucks hand 
l4ToKwb3EVcEuva7hPqMCQ collected $4.40 from pot
*** SUMMARY ***
Total pot $4.60 | Rake $0.20 
Board [6c 9s Qd Ts 3h]
Seat 1: 8tR2s7yV/Fr0ePp1w5XnJw (big blind) folded before Flop
Seat 2: vUr8qM1UsCElsCI9B/McdQ mucked
Seat 3: l4ToKwb3EVcEuva7hPqMCQ showed [9h 9c] and won ($4.40) with three of a kind, Nines
Seat 4: 7NY6Es0O5qlPDxirJ9iU4g folded before Flop
Seat 5: EE16Ua5b1HSsYej5zeXOlA (button) folded on the River
Seat 6: JFIAqU8lCZ0vWwEl4bdGsg (small blind) folded before Flop




PokerStars Game #59941583672:  Hold'em No Limit ($0.10/$0.25) - 2009/07/01 1:39:52 ET
Table '4hfTdIVT/qPsJNfWXLsVIw' 9-max Seat #6 is the button
Seat 1: GbHFBbLqLGz0Pwn6CJeAuw ($30.70 in chips) 
Seat 2: Pt637jKksB5MzP0UNJAAkw ($37.35 in chips) 
Seat 3: xnVwSkROfRtOw4eSoDANtw ($8.10 in chips) 
Seat 4: 3PmVnC/15cl4oyI1TKIt4g ($6.10 in chips) 
Seat 5: dtZ84flFEi4Q+SGrHMJRDQ ($26.20 in chips) 
Seat 6: VWUWpMLMj/Q1jRVpF7Aohw ($13.15 in chips) 
Seat 8: 7cv+9Zc9HIQHNvYsMfV3uA ($29 in chips) 
Seat 9: 9njEKzpOKC62MllUFUBWrA ($9.35 in chips) 
7cv+9Zc9HIQHNvYsMfV3uA: posts small blind $0.10
9njEKzpOKC62MllUFUBWrA: posts big blind $0.25
*** HOLE CARDS ***
GbHFBbLqLGz0Pwn6CJeAuw: folds 
Pt637jKksB5MzP0UNJAAkw: folds 
xnVwSkROfRtOw4eSoDANtw: folds 
3PmVnC/15cl4oyI1TKIt4g: folds 
dtZ84flFEi4Q+SGrHMJRDQ: calls $0.25
VWUWpMLMj/Q1jRVpF7Aohw: folds 
7cv+9Zc9HIQHNvYsMfV3uA: folds 
9njEKzpOKC62MllUFUBWrA: checks 
*** FLOP *** [3h 7d 2c]
9njEKzpOKC62MllUFUBWrA: checks 
dtZ84flFEi4Q+SGrHMJRDQ: bets $0.50
9njEKzpOKC62MllUFUBWrA: calls $0.50
*** TURN *** [3h 7d 2c] [2h]
9njEKzpOKC62MllUFUBWrA: bets $0.50
dtZ84flFEi4Q+SGrHMJRDQ: folds 
Uncalled bet ($0.50) returned to 9njEKzpOKC62MllUFUBWrA
9njEKzpOKC62MllUFUBWrA collected $1.55 from pot
9njEKzpOKC62MllUFUBWrA: doesn't show hand 
*** SUMMARY ***
Total pot $1.60 | Rake $0.05 
Board [3h 7d 2c 2h]
Seat 1: GbHFBbLqLGz0Pwn6CJeAuw folded before Flop (didn't bet)
Seat 2: Pt637jKksB5MzP0UNJAAkw folded before Flop (didn't bet)
Seat 3: xnVwSkROfRtOw4eSoDANtw folded before Flop (didn't bet)
Seat 4: 3PmVnC/15cl4oyI1TKIt4g folded before Flop (didn't bet)
Seat 5: dtZ84flFEi4Q+SGrHMJRDQ folded on the Turn
Seat 6: VWUWpMLMj/Q1jRVpF7Aohw (button) folded before Flop (didn't bet)
Seat 8: 7cv+9Zc9HIQHNvYsMfV3uA (small blind) folded before Flop
Seat 9: 9njEKzpOKC62MllUFUBWrA (big blind) collected ($1.55)




PokerStars Game #59941583846:  Hold'em No Limit ($0.10/$0.25) - 2009/07/01 1:39:52 ET
Table 'djcjiEGabFQO0MNG6jEeJQ' 9-max Seat #5 is the button
Seat 1: Bb42QRQMhg5/Y0vHP8/2Xw ($25 in chips) 
Seat 2: WKL8nUFr7TumC4EjLyqYzw ($4.75 in chips) 
Seat 3: zgi+EUykT/pZQpoUG6+oEg ($5 in chips) 
Seat 4: 2wcFsZsqEP5w1StUTVzJCg ($9.45 in chips) 
Seat 5: cZ99hugmLBj9KhTlc8nCSw ($36.20 in chips) 
Seat 6: aNpwfA31EREwO+ar4XzBCw ($74.10 in chips) 
Seat 7: 56S3mA6Zs3pGR+0p0vUCtg ($40.80 in chips) 
Seat 8: +sbyWwIcFp9kP0bDtMegfQ ($51.75 in chips) 
Seat 9: HPEB+AtKw1+C/cxU0o1ciw ($47.45 in chips) 
aNpwfA31EREwO+ar4XzBCw: posts small blind $0.10
56S3mA6Zs3pGR+0p0vUCtg: posts big blind $0.25
*** HOLE CARDS ***
+sbyWwIcFp9kP0bDtMegfQ: folds 
HPEB+AtKw1+C/cxU0o1ciw: calls $0.25
Bb42QRQMhg5/Y0vHP8/2Xw: folds 
WKL8nUFr7TumC4EjLyqYzw: folds 
zgi+EUykT/pZQpoUG6+oEg: folds 
2wcFsZsqEP5w1StUTVzJCg: calls $0.25
cZ99hugmLBj9KhTlc8nCSw: raises $1 to $1.25
aNpwfA31EREwO+ar4XzBCw: folds 
56S3mA6Zs3pGR+0p0vUCtg: raises $1.75 to $3
HPEB+AtKw1+C/cxU0o1ciw: folds 
2wcFsZsqEP5w1StUTVzJCg: folds 
cZ99hugmLBj9KhTlc8nCSw: calls $1.75
*** FLOP *** [3s 9d Td]
56S3mA6Zs3pGR+0p0vUCtg: bets $2.75
cZ99hugmLBj9KhTlc8nCSw: raises $4 to $6.75
56S3mA6Zs3pGR+0p0vUCtg: folds 
Uncalled bet ($4) returned to cZ99hugmLBj9KhTlc8nCSw
cZ99hugmLBj9KhTlc8nCSw collected $11.55 from pot
*** SUMMARY ***
Total pot $12.10 | Rake $0.55 
Board [3s 9d Td]
Seat 1: Bb42QRQMhg5/Y0vHP8/2Xw folded before Flop (didn't bet)
Seat 2: WKL8nUFr7TumC4EjLyqYzw folded before Flop (didn't bet)
Seat 3: zgi+EUykT/pZQpoUG6+oEg folded before Flop (didn't bet)
Seat 4: 2wcFsZsqEP5w1StUTVzJCg folded before Flop
Seat 5: cZ99hugmLBj9KhTlc8nCSw (button) collected ($11.55)
Seat 6: aNpwfA31EREwO+ar4XzBCw (small blind) folded before Flop
Seat 7: 56S3mA6Zs3pGR+0p0vUCtg (big blind) folded on the Flop
Seat 8: +sbyWwIcFp9kP0bDtMegfQ folded before Flop (didn't bet)
Seat 9: HPEB+AtKw1+C/cxU0o1ciw folded before Flop




PokerStars Game #59941584410:  Hold'em No Limit ($0.10/$0.25) - 2009/07/01 1:39:53 ET
Table 'RUOqTfzbAVGS5x+J9aZMHA' 9-max Seat #6 is the button
Seat 1: DnDcAdn9P0zGovMERigpFA ($25 in chips) 
Seat 2: Z5ZtGOON8kmSdSCll9Z3XA ($8.35 in chips) 
Seat 3: Th3FldXKQW6hWVVPahaoOQ ($25 in chips) 
Seat 4: K9Az8li/CO2TicltVWKamA ($41.20 in chips) 
Seat 5: MtVtHDqIJTyUcXkRBBDIVA ($30.55 in chips) 
Seat 6: ljemhp25Zg+nlA9DLCIiUw ($38.80 in chips) 
Seat 7: zgi+EUykT/pZQpoUG6+oEg ($4.40 in chips) 
Seat 8: dfNim92Z6XK1/h5SFW5vDg ($25 in chips) 
Seat 9: cZ99hugmLBj9KhTlc8nCSw ($25 in chips) 
zgi+EUykT/pZQpoUG6+oEg: posts small blind $0.10
dfNim92Z6XK1/h5SFW5vDg: posts big blind $0.25
*** HOLE CARDS ***
cZ99hugmLBj9KhTlc8nCSw: folds 
DnDcAdn9P0zGovMERigpFA: folds 
Z5ZtGOON8kmSdSCll9Z3XA: folds 
Th3FldXKQW6hWVVPahaoOQ: folds 
K9Az8li/CO2TicltVWKamA: calls $0.25
MtVtHDqIJTyUcXkRBBDIVA: folds 
ljemhp25Zg+nlA9DLCIiUw: raises $0.75 to $1
zgi+EUykT/pZQpoUG6+oEg: folds 
dfNim92Z6XK1/h5SFW5vDg: folds 
K9Az8li/CO2TicltVWKamA: calls $0.75
*** FLOP *** [8s Qc 6s]
K9Az8li/CO2TicltVWKamA: checks 
ljemhp25Zg+nlA9DLCIiUw: bets $1.25
K9Az8li/CO2TicltVWKamA: folds 
Uncalled bet ($1.25) returned to ljemhp25Zg+nlA9DLCIiUw
ljemhp25Zg+nlA9DLCIiUw collected $2.25 from pot
ljemhp25Zg+nlA9DLCIiUw: doesn't show hand 
*** SUMMARY ***
Total pot $2.35 | Rake $0.10 
Board [8s Qc 6s]
Seat 1: DnDcAdn9P0zGovMERigpFA folded before Flop (didn't bet)
Seat 2: Z5ZtGOON8kmSdSCll9Z3XA folded before Flop (didn't bet)
Seat 3: Th3FldXKQW6hWVVPahaoOQ folded before Flop (didn't bet)
Seat 4: K9Az8li/CO2TicltVWKamA folded on the Flop
Seat 5: MtVtHDqIJTyUcXkRBBDIVA folded before Flop (didn't bet)
Seat 6: ljemhp25Zg+nlA9DLCIiUw (button) collected ($2.25)
Seat 7: zgi+EUykT/pZQpoUG6+oEg (small blind) folded before Flop
Seat 8: dfNim92Z6XK1/h5SFW5vDg (big blind) folded before Flop
Seat 9: cZ99hugmLBj9KhTlc8nCSw folded before Flop (didn't bet)




PokerStars Game #59941584352:  Hold'em No Limit ($0.10/$0.25) - 2009/07/01 1:39:53 ET
Table 'aaXqTKUnxrX9DYXtxhWXxA' 6-max Seat #1 is the button
Seat 1: rnpAao581IcvQglpkpnkoQ ($8.35 in chips) 
Seat 2: DE9hRlt14g+JdsRQ4wT7hg ($34.15 in chips) 
Seat 3: N6vygzX+airCyzOAF2w+HQ ($17.85 in chips) 
Seat 4: 48oT5xFI+5CHUJlfoGrE4w ($10.80 in chips) 
Seat 5: kyRaCIljYA6l33lSKQfNsg ($27 in chips) 
Seat 6: buyjetgNT1McXtdaP4zynA ($12.65 in chips) 
DE9hRlt14g+JdsRQ4wT7hg: posts small blind $0.10
N6vygzX+airCyzOAF2w+HQ: posts big blind $0.25
*** HOLE CARDS ***
48oT5xFI+5CHUJlfoGrE4w: folds 
kyRaCIljYA6l33lSKQfNsg: raises $0.50 to $0.75
buyjetgNT1McXtdaP4zynA: folds 
rnpAao581IcvQglpkpnkoQ: folds 
DE9hRlt14g+JdsRQ4wT7hg: folds 
N6vygzX+airCyzOAF2w+HQ: calls $0.50
*** FLOP *** [3c Ks 8s]
N6vygzX+airCyzOAF2w+HQ: bets $1.25
kyRaCIljYA6l33lSKQfNsg: folds 
Uncalled bet ($1.25) returned to N6vygzX+airCyzOAF2w+HQ
N6vygzX+airCyzOAF2w+HQ collected $1.55 from pot
*** SUMMARY ***
Total pot $1.60 | Rake $0.05 
Board [3c Ks 8s]
Seat 1: rnpAao581IcvQglpkpnkoQ (button) folded before Flop (didn't bet)
Seat 2: DE9hRlt14g+JdsRQ4wT7hg (small blind) folded before Flop
Seat 3: N6vygzX+airCyzOAF2w+HQ (big blind) collected ($1.55)
Seat 4: 48oT5xFI+5CHUJlfoGrE4w folded before Flop (didn't bet)
Seat 5: kyRaCIljYA6l33lSKQfNsg folded on the Flop
Seat 6: buyjetgNT1McXtdaP4zynA folded before Flop (didn't bet)




PokerStars Game #59941584554:  Hold'em No Limit ($0.10/$0.25) - 2009/07/01 1:39:53 ET
Table 'sSe6q4YTb/iS19t2eCFdsA' 9-max Seat #4 is the button
Seat 1: hJ4uYjNmSZdjrKA8cjZqCA ($18.10 in chips) 
Seat 3: bXpVeaSTPBFSPJmeXxO7nw ($5.65 in chips) 
Seat 4: 22dIObOuor/A+IKWkNoAlA ($8.85 in chips) 
Seat 5: qS+jfnNoG75bT+uQ8CKhQA ($13.30 in chips) 
Seat 6: tYsOBqdU1+x+yFI7zHO7hQ ($25.80 in chips) 
Seat 7: t70KGeRtR3naHSqKDixsUg ($4.40 in chips) 
Seat 8: hvXZ0zFPZFP8Hf6dS36YEw ($14.40 in chips) 
qS+jfnNoG75bT+uQ8CKhQA: posts small blind $0.10
tYsOBqdU1+x+yFI7zHO7hQ: posts big blind $0.25
*** HOLE CARDS ***
t70KGeRtR3naHSqKDixsUg: calls $0.25
hvXZ0zFPZFP8Hf6dS36YEw: folds 
hJ4uYjNmSZdjrKA8cjZqCA: folds 
bXpVeaSTPBFSPJmeXxO7nw: folds 
22dIObOuor/A+IKWkNoAlA: folds 
qS+jfnNoG75bT+uQ8CKhQA: calls $0.15
tYsOBqdU1+x+yFI7zHO7hQ: checks 
*** FLOP *** [Ks Ac Qd]
qS+jfnNoG75bT+uQ8CKhQA: checks 
tYsOBqdU1+x+yFI7zHO7hQ: checks 
t70KGeRtR3naHSqKDixsUg: checks 
*** TURN *** [Ks Ac Qd] [7d]
qS+jfnNoG75bT+uQ8CKhQA: checks 
tYsOBqdU1+x+yFI7zHO7hQ: checks 
t70KGeRtR3naHSqKDixsUg: checks 
*** RIVER *** [Ks Ac Qd 7d] [4d]
qS+jfnNoG75bT+uQ8CKhQA: bets $0.50
tYsOBqdU1+x+yFI7zHO7hQ: raises $1.50 to $2
t70KGeRtR3naHSqKDixsUg: folds 
qS+jfnNoG75bT+uQ8CKhQA: calls $1.50
*** SHOW DOWN ***
tYsOBqdU1+x+yFI7zHO7hQ: shows [8d 2d] (a flush, Queen high)
qS+jfnNoG75bT+uQ8CKhQA: mucks hand 
tYsOBqdU1+x+yFI7zHO7hQ collected $4.55 from pot
*** SUMMARY ***
Total pot $4.75 | Rake $0.20 
Board [Ks Ac Qd 7d 4d]
Seat 1: hJ4uYjNmSZdjrKA8cjZqCA folded before Flop (didn't bet)
Seat 3: bXpVeaSTPBFSPJmeXxO7nw folded before Flop (didn't bet)
Seat 4: 22dIObOuor/A+IKWkNoAlA (button) folded before Flop (didn't bet)
Seat 5: qS+jfnNoG75bT+uQ8CKhQA (small blind) mucked
Seat 6: tYsOBqdU1+x+yFI7zHO7hQ (big blind) showed [8d 2d] and won ($4.55) with a flush, Queen high
Seat 7: t70KGeRtR3naHSqKDixsUg folded on the River
Seat 8: hvXZ0zFPZFP8Hf6dS36YEw folded before Flop (didn't bet)




PokerStars Game #59941585172:  Hold'em No Limit ($0.10/$0.25) - 2009/07/01 1:39:54 ET
Table 'rhQuIjJo0UQ7RRUlF9umHg' 6-max Seat #6 is the button
Seat 1: 5O3Hj9Qg0SqOyKEXoLpjPg ($105.25 in chips) 
Seat 2: Ew/TYPQIsbQ2X8nm5iAJBg ($36.95 in chips) 
Seat 3: if4dh6jhJXeN3/qd3qCp9g ($27.75 in chips) 
Seat 4: buyjetgNT1McXtdaP4zynA ($25 in chips) 
Seat 5: dOX4wnYV2sEqvDbF+8KSCw ($52 in chips) 
Seat 6: /gJNBeCkWL4o85/jvlZ4BA ($52.40 in chips) 
5O3Hj9Qg0SqOyKEXoLpjPg: posts small blind $0.10
Ew/TYPQIsbQ2X8nm5iAJBg: posts big blind $0.25
*** HOLE CARDS ***
if4dh6jhJXeN3/qd3qCp9g: folds 
buyjetgNT1McXtdaP4zynA: folds 
dOX4wnYV2sEqvDbF+8KSCw: folds 
/gJNBeCkWL4o85/jvlZ4BA: folds 
5O3Hj9Qg0SqOyKEXoLpjPg: calls $0.15
Ew/TYPQIsbQ2X8nm5iAJBg: raises $0.75 to $1
5O3Hj9Qg0SqOyKEXoLpjPg: calls $0.75
*** FLOP *** [4h 7s Js]
5O3Hj9Qg0SqOyKEXoLpjPg: checks 
Ew/TYPQIsbQ2X8nm5iAJBg: bets $1.50
5O3Hj9Qg0SqOyKEXoLpjPg: calls $1.50
*** TURN *** [4h 7s Js] [7d]
5O3Hj9Qg0SqOyKEXoLpjPg: checks 
Ew/TYPQIsbQ2X8nm5iAJBg: bets $2.75
5O3Hj9Qg0SqOyKEXoLpjPg: calls $2.75
*** RIVER *** [4h 7s Js 7d] [7h]
5O3Hj9Qg0SqOyKEXoLpjPg: checks 
Ew/TYPQIsbQ2X8nm5iAJBg: bets $11.50
5O3Hj9Qg0SqOyKEXoLpjPg: calls $11.50
*** SHOW DOWN ***
Ew/TYPQIsbQ2X8nm5iAJBg: shows [8d 9c] (three of a kind, Sevens)
5O3Hj9Qg0SqOyKEXoLpjPg: shows [9h 9s] (a full house, Sevens full of Nines)
5O3Hj9Qg0SqOyKEXoLpjPg collected $31.85 from pot
*** SUMMARY ***
Total pot $33.50 | Rake $1.65 
Board [4h 7s Js 7d 7h]
Seat 1: 5O3Hj9Qg0SqOyKEXoLpjPg (small blind) showed [9h 9s] and won ($31.85) with a full house, Sevens full of Nines
Seat 2: Ew/TYPQIsbQ2X8nm5iAJBg (big blind) showed [8d 9c] and lost with three of a kind, Sevens
Seat 3: if4dh6jhJXeN3/qd3qCp9g folded before Flop (didn't bet)
Seat 4: buyjetgNT1McXtdaP4zynA folded before Flop (didn't bet)
Seat 5: dOX4wnYV2sEqvDbF+8KSCw folded before Flop (didn't bet)
Seat 6: /gJNBeCkWL4o85/jvlZ4BA (button) folded before Flop (didn't bet)




PokerStars Game #59941585274:  Hold'em No Limit ($0.10/$0.25) - 2009/07/01 1:39:54 ET
Table 'SHi8+hK6i7E2dJ/3Agbyig' 6-max Seat #1 is the button
Seat 1: gPEN9Zp33YTm/mu9/SYP1w ($30.70 in chips) 
Seat 2: LJI7A1YgDM7hgh7o56+ReQ ($28.90 in chips) 
Seat 3: P1Z7LWu+VU+WmJsI4mr0wA ($24.75 in chips) 
Seat 4: u0ikXOhAPSCLmg+l17oGRw ($9.60 in chips) 
Seat 5: v8m8XHovI5tqEA9mvplDSw ($53.80 in chips) 
Seat 6: cWc85bEzdRzpUMhRKm8pwQ ($25.35 in chips) 
LJI7A1YgDM7hgh7o56+ReQ: posts small blind $0.10
P1Z7LWu+VU+WmJsI4mr0wA: posts big blind $0.25
u0ikXOhAPSCLmg+l17oGRw: posts big blind $0.25
*** HOLE CARDS ***
u0ikXOhAPSCLmg+l17oGRw: checks 
v8m8XHovI5tqEA9mvplDSw: folds 
cWc85bEzdRzpUMhRKm8pwQ: folds 
gPEN9Zp33YTm/mu9/SYP1w: folds 
LJI7A1YgDM7hgh7o56+ReQ: folds 
P1Z7LWu+VU+WmJsI4mr0wA: checks 
*** FLOP *** [4s Js 8s]
P1Z7LWu+VU+WmJsI4mr0wA: checks 
u0ikXOhAPSCLmg+l17oGRw: checks 
*** TURN *** [4s Js 8s] [6s]
P1Z7LWu+VU+WmJsI4mr0wA: checks 
u0ikXOhAPSCLmg+l17oGRw: checks 
*** RIVER *** [4s Js 8s 6s] [6c]
P1Z7LWu+VU+WmJsI4mr0wA: bets $2
u0ikXOhAPSCLmg+l17oGRw: folds 
Uncalled bet ($2) returned to P1Z7LWu+VU+WmJsI4mr0wA
P1Z7LWu+VU+WmJsI4mr0wA collected $0.60 from pot
P1Z7LWu+VU+WmJsI4mr0wA: doesn't show hand 
*** SUMMARY ***
Total pot $0.60 | Rake $0 
Board [4s Js 8s 6s 6c]
Seat 1: gPEN9Zp33YTm/mu9/SYP1w (button) folded before Flop (didn't bet)
Seat 2: LJI7A1YgDM7hgh7o56+ReQ (small blind) folded before Flop
Seat 3: P1Z7LWu+VU+WmJsI4mr0wA (big blind) collected ($0.60)
Seat 4: u0ikXOhAPSCLmg+l17oGRw folded on the River
Seat 5: v8m8XHovI5tqEA9mvplDSw folded before Flop (didn't bet)
Seat 6: cWc85bEzdRzpUMhRKm8pwQ folded before Flop (didn't bet)




PokerStars Game #59941585134:  Hold'em No Limit ($0.10/$0.25) - 2009/07/01 1:39:54 ET
Table 'yZgGBnUGXVCcEJdcqes8tw' 9-max Seat #2 is the button
Seat 1: 6RiVTYll/5D8zICp0MRpKw ($28.85 in chips) 
Seat 2: MG90wfSJZnOejs/KD3vlQQ ($25 in chips) 
Seat 3: z5GxcHlYz/GSz6W2uFiTtg ($23.80 in chips) 
Seat 4: M2QO2DxB5Wawg2h8HSpnYA ($10 in chips) 
Seat 5: dfNim92Z6XK1/h5SFW5vDg ($25.40 in chips) 
Seat 6: pRZytPRoJmxE0dmcJwYvfw ($5.95 in chips) 
Seat 7: eC8Pn1D6Y2pct8o62nQfvQ ($25.15 in chips) 
Seat 8: dtZ84flFEi4Q+SGrHMJRDQ ($31.65 in chips) 
Seat 9: M/9j4wkHH9i1JM51vgi1VA ($22.80 in chips) 
z5GxcHlYz/GSz6W2uFiTtg: posts small blind $0.10
M2QO2DxB5Wawg2h8HSpnYA: posts big blind $0.25
*** HOLE CARDS ***
dfNim92Z6XK1/h5SFW5vDg: folds 
pRZytPRoJmxE0dmcJwYvfw: folds 
eC8Pn1D6Y2pct8o62nQfvQ: folds 
dtZ84flFEi4Q+SGrHMJRDQ: folds 
M/9j4wkHH9i1JM51vgi1VA: calls $0.25
6RiVTYll/5D8zICp0MRpKw: folds 
MG90wfSJZnOejs/KD3vlQQ: folds 
z5GxcHlYz/GSz6W2uFiTtg: calls $0.15
M2QO2DxB5Wawg2h8HSpnYA: checks 
*** FLOP *** [Qh 2d 6h]
z5GxcHlYz/GSz6W2uFiTtg: bets $0.25
M2QO2DxB5Wawg2h8HSpnYA: calls $0.25
M/9j4wkHH9i1JM51vgi1VA: calls $0.25
*** TURN *** [Qh 2d 6h] [8d]
z5GxcHlYz/GSz6W2uFiTtg: checks 
M2QO2DxB5Wawg2h8HSpnYA: checks 
M/9j4wkHH9i1JM51vgi1VA: bets $0.75
z5GxcHlYz/GSz6W2uFiTtg: folds 
M2QO2DxB5Wawg2h8HSpnYA: folds 
Uncalled bet ($0.75) returned to M/9j4wkHH9i1JM51vgi1VA
M/9j4wkHH9i1JM51vgi1VA collected $1.45 from pot
M/9j4wkHH9i1JM51vgi1VA: doesn't show hand 
*** SUMMARY ***
Total pot $1.50 | Rake $0.05 
Board [Qh 2d 6h 8d]
Seat 1: 6RiVTYll/5D8zICp0MRpKw folded before Flop (didn't bet)
Seat 2: MG90wfSJZnOejs/KD3vlQQ (button) folded before Flop (didn't bet)
Seat 3: z5GxcHlYz/GSz6W2uFiTtg (small blind) folded on the Turn
Seat 4: M2QO2DxB5Wawg2h8HSpnYA (big blind) folded on the Turn
Seat 5: dfNim92Z6XK1/h5SFW5vDg folded before Flop (didn't bet)
Seat 6: pRZytPRoJmxE0dmcJwYvfw folded before Flop (didn't bet)
Seat 7: eC8Pn1D6Y2pct8o62nQfvQ folded before Flop (didn't bet)
Seat 8: dtZ84flFEi4Q+SGrHMJRDQ folded before Flop (didn't bet)
Seat 9: M/9j4wkHH9i1JM51vgi1VA collected ($1.45)




PokerStars Game #59941584982:  Hold'em No Limit ($0.10/$0.25) - 2009/07/01 1:39:54 ET
Table 'BabJGL6tfXQp3leBGbYe8A' 9-max Seat #5 is the button
Seat 1: qwr38jl5txoR36M7G5qi4A ($7.50 in chips) 
Seat 2: dtZ84flFEi4Q+SGrHMJRDQ ($36 in chips) 
Seat 3: sD+TKtt36XiiN6jqHiLwDA ($25.45 in chips) 
Seat 4: gehe91e0IyVT0QU/XBkEyg ($28.45 in chips) 
Seat 5: GrNTWMdwy+jC6Lred1eDng ($14.40 in chips) 
Seat 6: egvg3mTBBVzMHnJPIQiKcA ($14.40 in chips) 
Seat 7: eK8qa6EPcH2zhtbmWSvc9g ($27.85 in chips) 
Seat 8: OgISYvc5hA85YuDnsXCH+Q ($22.25 in chips) 
egvg3mTBBVzMHnJPIQiKcA: posts small blind $0.10
eK8qa6EPcH2zhtbmWSvc9g: posts big blind $0.25
P+9ymZQ3ktpQu1bn7HIjew: sits out 
*** HOLE CARDS ***
OgISYvc5hA85YuDnsXCH+Q: folds 
qwr38jl5txoR36M7G5qi4A: calls $0.25
dtZ84flFEi4Q+SGrHMJRDQ: folds 
sD+TKtt36XiiN6jqHiLwDA: folds 
gehe91e0IyVT0QU/XBkEyg: folds 
GrNTWMdwy+jC6Lred1eDng: folds 
egvg3mTBBVzMHnJPIQiKcA: calls $0.15
eK8qa6EPcH2zhtbmWSvc9g: checks 
*** FLOP *** [4c Th Js]
egvg3mTBBVzMHnJPIQiKcA: checks 
eK8qa6EPcH2zhtbmWSvc9g: checks 
qwr38jl5txoR36M7G5qi4A: bets $0.75
egvg3mTBBVzMHnJPIQiKcA: folds 
eK8qa6EPcH2zhtbmWSvc9g: folds 
Uncalled bet ($0.75) returned to qwr38jl5txoR36M7G5qi4A
qwr38jl5txoR36M7G5qi4A collected $0.75 from pot
qwr38jl5txoR36M7G5qi4A: doesn't show hand 
*** SUMMARY ***
Total pot $0.75 | Rake $0 
Board [4c Th Js]
Seat 1: qwr38jl5txoR36M7G5qi4A collected ($0.75)
Seat 2: dtZ84flFEi4Q+SGrHMJRDQ folded before Flop (didn't bet)
Seat 3: sD+TKtt36XiiN6jqHiLwDA folded before Flop (didn't bet)
Seat 4: gehe91e0IyVT0QU/XBkEyg folded before Flop (didn't bet)
Seat 5: GrNTWMdwy+jC6Lred1eDng (button) folded before Flop (didn't bet)
Seat 6: egvg3mTBBVzMHnJPIQiKcA (small blind) folded on the Flop
Seat 7: eK8qa6EPcH2zhtbmWSvc9g (big blind) folded on the Flop
Seat 8: OgISYvc5hA85YuDnsXCH+Q folded before Flop (didn't bet)




PokerStars Game #59941584968:  Hold'em No Limit ($0.10/$0.25) - 2009/07/01 1:39:54 ET
Table 'l8hUTjBTXBorNUR/tyvSLw' 9-max Seat #8 is the button
Seat 1: cZ99hugmLBj9KhTlc8nCSw ($27.85 in chips) 
Seat 2: B6xHiX1SJkS0CUNCKDVwuQ ($16.60 in chips) 
Seat 3: 6TWO15+WfJ5HfI8CbJ4a0w ($9.85 in chips) 
Seat 4: vPtFvcPtn/Afz0sucO1cmQ ($36.10 in chips) 
Seat 6: EVqHvqty1ZsuvDFiSXlSqQ ($23.85 in chips) 
Seat 7: F7pnn6czNpHvRM55XcA2EA ($33.40 in chips) 
Seat 8: Mh2r9hTeTEDnh19sRZtW3g ($4.40 in chips) 
Seat 9: zDrucyjVn5aeekNEc3cJrA ($32.80 in chips) 
zDrucyjVn5aeekNEc3cJrA: posts small blind $0.10
cZ99hugmLBj9KhTlc8nCSw: posts big blind $0.25
yyG4svzOpC1A+sUP/scg6w: sits out 
*** HOLE CARDS ***
B6xHiX1SJkS0CUNCKDVwuQ: calls $0.25
6TWO15+WfJ5HfI8CbJ4a0w: folds 
vPtFvcPtn/Afz0sucO1cmQ: folds 
EVqHvqty1ZsuvDFiSXlSqQ: folds 
F7pnn6czNpHvRM55XcA2EA: folds 
6TWO15+WfJ5HfI8CbJ4a0w leaves the table
Mh2r9hTeTEDnh19sRZtW3g: raises $0.75 to $1
zDrucyjVn5aeekNEc3cJrA: folds 
cZ99hugmLBj9KhTlc8nCSw: folds 
ShCS62CJp4MKfKLKvGKQbA joins the table at seat #3 
B6xHiX1SJkS0CUNCKDVwuQ: calls $0.75
*** FLOP *** [7s Qs 6h]
B6xHiX1SJkS0CUNCKDVwuQ: bets $1
Mh2r9hTeTEDnh19sRZtW3g: raises $2.40 to $3.40 and is all-in
B6xHiX1SJkS0CUNCKDVwuQ: calls $2.40
*** TURN *** [7s Qs 6h] [8h]
*** RIVER *** [7s Qs 6h 8h] [9h]
*** SHOW DOWN ***
B6xHiX1SJkS0CUNCKDVwuQ: shows [5d 8d] (a straight, Five to Nine)
Mh2r9hTeTEDnh19sRZtW3g: mucks hand 
B6xHiX1SJkS0CUNCKDVwuQ collected $8.70 from pot
*** SUMMARY ***
Total pot $9.15 | Rake $0.45 
Board [7s Qs 6h 8h 9h]
Seat 1: cZ99hugmLBj9KhTlc8nCSw (big blind) folded before Flop
Seat 2: B6xHiX1SJkS0CUNCKDVwuQ showed [5d 8d] and won ($8.70) with a straight, Five to Nine
Seat 3: 6TWO15+WfJ5HfI8CbJ4a0w folded before Flop (didn't bet)
Seat 4: vPtFvcPtn/Afz0sucO1cmQ folded before Flop (didn't bet)
Seat 6: EVqHvqty1ZsuvDFiSXlSqQ folded before Flop (didn't bet)
Seat 7: F7pnn6czNpHvRM55XcA2EA folded before Flop (didn't bet)
Seat 8: Mh2r9hTeTEDnh19sRZtW3g (button) mucked
Seat 9: zDrucyjVn5aeekNEc3cJrA (small blind) folded before Flop




PokerStars Game #59941585524:  Hold'em No Limit ($0.10/$0.25) - 2009/07/01 1:39:55 ET
Table '3Ns9nuTkynfwbBfBXzg6ww' 6-max Seat #2 is the button
Seat 2: zxeVQGaMKDsDzmSY+AInjA ($33.50 in chips) 
Seat 3: eL3+wCBjFGfQ5FMdIZihwA ($24.75 in chips) 
Seat 4: qGHGf/553gQnDoklMRe3tg ($31.45 in chips) 
Seat 5: wqphQtauX5Qn7WRJZS1flA ($24.65 in chips) 
Seat 6: DE9hRlt14g+JdsRQ4wT7hg ($36.05 in chips) 
eL3+wCBjFGfQ5FMdIZihwA: posts small blind $0.10
qGHGf/553gQnDoklMRe3tg: posts big blind $0.25
*** HOLE CARDS ***
KDYsHh8K2SUXXDvLsAhbJQ leaves the table
wqphQtauX5Qn7WRJZS1flA: folds 
DE9hRlt14g+JdsRQ4wT7hg: folds 
epAUIB7h2FJXzUPRIvSkRA joins the table at seat #1 
zxeVQGaMKDsDzmSY+AInjA: raises $0.50 to $0.75
eL3+wCBjFGfQ5FMdIZihwA: folds 
qGHGf/553gQnDoklMRe3tg: folds 
Uncalled bet ($0.50) returned to zxeVQGaMKDsDzmSY+AInjA
zxeVQGaMKDsDzmSY+AInjA collected $0.60 from pot
zxeVQGaMKDsDzmSY+AInjA: doesn't show hand 
*** SUMMARY ***
Total pot $0.60 | Rake $0 
Seat 2: zxeVQGaMKDsDzmSY+AInjA (button) collected ($0.60)
Seat 3: eL3+wCBjFGfQ5FMdIZihwA (small blind) folded before Flop
Seat 4: qGHGf/553gQnDoklMRe3tg (big blind) folded before Flop
Seat 5: wqphQtauX5Qn7WRJZS1flA folded before Flop (didn't bet)
Seat 6: DE9hRlt14g+JdsRQ4wT7hg folded before Flop (didn't bet)




PokerStars Game #59941585766:  Hold'em No Limit ($0.10/$0.25) - 2009/07/01 1:39:55 ET
Table 'vud0GB/ZlDCvUFhBFIaTlg' 9-max Seat #7 is the button
Seat 1: DiSvPC2iudwL5j9u6Huyww ($28.85 in chips) 
Seat 2: tLcDklc2rBORNfixyRfVfw ($25 in chips) 
Seat 3: W2YYHvqjaEpRrO7stZkClQ ($4.65 in chips) 
Seat 4: dWgEDExmVO0d+rRmUYCU5w ($15.95 in chips) 
Seat 5: eK8qa6EPcH2zhtbmWSvc9g ($25 in chips) 
Seat 6: gehe91e0IyVT0QU/XBkEyg ($24.90 in chips) 
Seat 7: iG7VeTyBWf6wYNvZpbTcbw ($16.75 in chips) 
Seat 8: Am29qRe4OYkVWs70NjNDBw ($16.20 in chips) 
Seat 9: PdIasPkzm2sqZnN41ZRXOg ($5 in chips) 
Am29qRe4OYkVWs70NjNDBw: posts small blind $0.10
PdIasPkzm2sqZnN41ZRXOg: posts big blind $0.25
*** HOLE CARDS ***
DiSvPC2iudwL5j9u6Huyww: folds 
tLcDklc2rBORNfixyRfVfw: folds 
W2YYHvqjaEpRrO7stZkClQ: folds 
dWgEDExmVO0d+rRmUYCU5w: folds 
eK8qa6EPcH2zhtbmWSvc9g: folds 
gehe91e0IyVT0QU/XBkEyg: folds 
iG7VeTyBWf6wYNvZpbTcbw: folds 
Am29qRe4OYkVWs70NjNDBw: folds 
Uncalled bet ($0.15) returned to PdIasPkzm2sqZnN41ZRXOg
PdIasPkzm2sqZnN41ZRXOg collected $0.20 from pot
PdIasPkzm2sqZnN41ZRXOg: doesn't show hand 
*** SUMMARY ***
Total pot $0.20 | Rake $0 
Seat 1: DiSvPC2iudwL5j9u6Huyww folded before Flop (didn't bet)
Seat 2: tLcDklc2rBORNfixyRfVfw folded before Flop (didn't bet)
Seat 3: W2YYHvqjaEpRrO7stZkClQ folded before Flop (didn't bet)
Seat 4: dWgEDExmVO0d+rRmUYCU5w folded before Flop (didn't bet)
Seat 5: eK8qa6EPcH2zhtbmWSvc9g folded before Flop (didn't bet)
Seat 6: gehe91e0IyVT0QU/XBkEyg folded before Flop (didn't bet)
Seat 7: iG7VeTyBWf6wYNvZpbTcbw (button) folded before Flop (didn't bet)
Seat 8: Am29qRe4OYkVWs70NjNDBw (small blind) folded before Flop
Seat 9: PdIasPkzm2sqZnN41ZRXOg (big blind) collected ($0.20)




PokerStars Game #59941585430:  Hold'em No Limit ($0.10/$0.25) - 2009/07/01 1:39:55 ET
Table 'FE/j6VqBY4j9Uq+VHURQCQ' 6-max Seat #2 is the button
Seat 1: ypmjhffk/YHGc51wgVXUTw ($40.85 in chips) 
Seat 2: 3zD3qLXT1bEffAoWGnc7wg ($40.50 in chips) 
Seat 3: lBoEwOFgzcERLIRUkUoRTw ($26.75 in chips) 
Seat 4: 7JyPCA0J2grhXQYxe1h3+A ($21.95 in chips) 
Seat 5: 4x9jCqgSw4272dnaIqnanw ($7.80 in chips) 
Seat 6: rpJ2ie+vculq8yrHlngRHQ ($19.70 in chips) 
lBoEwOFgzcERLIRUkUoRTw: posts small blind $0.10
7JyPCA0J2grhXQYxe1h3+A: posts big blind $0.25
*** HOLE CARDS ***
4x9jCqgSw4272dnaIqnanw: folds 
rpJ2ie+vculq8yrHlngRHQ: calls $0.25
ypmjhffk/YHGc51wgVXUTw has timed out
ypmjhffk/YHGc51wgVXUTw: folds 
ypmjhffk/YHGc51wgVXUTw is sitting out
ypmjhffk/YHGc51wgVXUTw has returned
3zD3qLXT1bEffAoWGnc7wg: folds 
lBoEwOFgzcERLIRUkUoRTw: calls $0.15
7JyPCA0J2grhXQYxe1h3+A: checks 
*** FLOP *** [Kh 5c 7d]
lBoEwOFgzcERLIRUkUoRTw: checks 
7JyPCA0J2grhXQYxe1h3+A: checks 
rpJ2ie+vculq8yrHlngRHQ: bets $0.50
lBoEwOFgzcERLIRUkUoRTw: calls $0.50
7JyPCA0J2grhXQYxe1h3+A: folds 
*** TURN *** [Kh 5c 7d] [Qh]
lBoEwOFgzcERLIRUkUoRTw: checks 
rpJ2ie+vculq8yrHlngRHQ: checks 
*** RIVER *** [Kh 5c 7d Qh] [Tc]
lBoEwOFgzcERLIRUkUoRTw: checks 
rpJ2ie+vculq8yrHlngRHQ: checks 
*** SHOW DOWN ***
lBoEwOFgzcERLIRUkUoRTw: shows [5h Jh] (a pair of Fives)
rpJ2ie+vculq8yrHlngRHQ: mucks hand 
lBoEwOFgzcERLIRUkUoRTw collected $1.70 from pot
*** SUMMARY ***
Total pot $1.75 | Rake $0.05 
Board [Kh 5c 7d Qh Tc]
Seat 1: ypmjhffk/YHGc51wgVXUTw folded before Flop (didn't bet)
Seat 2: 3zD3qLXT1bEffAoWGnc7wg (button) folded before Flop (didn't bet)
Seat 3: lBoEwOFgzcERLIRUkUoRTw (small blind) showed [5h Jh] and won ($1.70) with a pair of Fives
Seat 4: 7JyPCA0J2grhXQYxe1h3+A (big blind) folded on the Flop
Seat 5: 4x9jCqgSw4272dnaIqnanw folded before Flop (didn't bet)
Seat 6: rpJ2ie+vculq8yrHlngRHQ mucked




PokerStars Game #59941585360:  Hold'em No Limit ($0.10/$0.25) - 2009/07/01 1:39:55 ET
Table 'M8kYidAX3ib7pLKW7edFLw' 6-max Seat #2 is the button
Seat 1: jp34e617tIzV8tKIWmfAbA ($25.70 in chips) 
Seat 2: ypmjhffk/YHGc51wgVXUTw ($28.45 in chips) 
Seat 3: cezpHJ8FB07dj0xG+LhOvw ($27.55 in chips) 
Seat 4: Hsvkc0/G2VV78oVmWYXecw ($5.35 in chips) 
Seat 5: bDKopKTvPi3W+PEnYUX3tg ($44.15 in chips) 
Seat 6: NqFoyDgzLwu4dOmSRXnFBA ($20 in chips) 
cezpHJ8FB07dj0xG+LhOvw: posts small blind $0.10
Hsvkc0/G2VV78oVmWYXecw: posts big blind $0.25
*** HOLE CARDS ***
bDKopKTvPi3W+PEnYUX3tg: folds 
NqFoyDgzLwu4dOmSRXnFBA: folds 
jp34e617tIzV8tKIWmfAbA: folds 
ypmjhffk/YHGc51wgVXUTw: folds 
cezpHJ8FB07dj0xG+LhOvw: folds 
Uncalled bet ($0.15) returned to Hsvkc0/G2VV78oVmWYXecw
Hsvkc0/G2VV78oVmWYXecw collected $0.20 from pot
Hsvkc0/G2VV78oVmWYXecw: doesn't show hand 
*** SUMMARY ***
Total pot $0.20 | Rake $0 
Seat 1: jp34e617tIzV8tKIWmfAbA folded before Flop (didn't bet)
Seat 2: ypmjhffk/YHGc51wgVXUTw (button) folded before Flop (didn't bet)
Seat 3: cezpHJ8FB07dj0xG+LhOvw (small blind) folded before Flop
Seat 4: Hsvkc0/G2VV78oVmWYXecw (big blind) collected ($0.20)
Seat 5: bDKopKTvPi3W+PEnYUX3tg folded before Flop (didn't bet)
Seat 6: NqFoyDgzLwu4dOmSRXnFBA folded before Flop (didn't bet)




PokerStars Game #59941585762:  Hold'em No Limit ($0.10/$0.25) - 2009/07/01 1:39:55 ET
Table '5NipxzzFB2DffzDpddyQoQ' 6-max Seat #3 is the button
Seat 1: W87HPwOk1KtWaYyshBe1gA ($22.85 in chips) 
Seat 2: iauW7L/+7qzAuHow7CD75Q ($10.10 in chips) 
Seat 3: QvTX2yGq3uKJiKPmns4TKQ ($23.65 in chips) 
Seat 4: NTamLAiMZ86c5yM04t96LA ($13.25 in chips) 
Seat 5: faP2NVl/cFTZ1nE4pXzg8Q ($21.90 in chips) 
Seat 6: 7JqTFMyeNSVWsmp/yW35Tw ($25 in chips) 
NTamLAiMZ86c5yM04t96LA: posts small blind $0.10
faP2NVl/cFTZ1nE4pXzg8Q: posts big blind $0.25
*** HOLE CARDS ***
7JqTFMyeNSVWsmp/yW35Tw: folds 
W87HPwOk1KtWaYyshBe1gA said, "^^"
NTamLAiMZ86c5yM04t96LA said, "good"
W87HPwOk1KtWaYyshBe1gA: folds 
iauW7L/+7qzAuHow7CD75Q: folds 
QvTX2yGq3uKJiKPmns4TKQ: raises $0.50 to $0.75
NTamLAiMZ86c5yM04t96LA: folds 
7JqTFMyeNSVWsmp/yW35Tw said, "this may be the best table ever"
faP2NVl/cFTZ1nE4pXzg8Q: calls $0.50
*** FLOP *** [Kd Qc Th]
iauW7L/+7qzAuHow7CD75Q said, "lol"
faP2NVl/cFTZ1nE4pXzg8Q: checks 
QvTX2yGq3uKJiKPmns4TKQ: bets $1
faP2NVl/cFTZ1nE4pXzg8Q: calls $1
*** TURN *** [Kd Qc Th] [9d]
iauW7L/+7qzAuHow7CD75Q said, "i concur"
faP2NVl/cFTZ1nE4pXzg8Q: bets $1.50
QvTX2yGq3uKJiKPmns4TKQ: calls $1.50
*** RIVER *** [Kd Qc Th 9d] [Kc]
faP2NVl/cFTZ1nE4pXzg8Q: bets $1.50
7JqTFMyeNSVWsmp/yW35Tw said, "time for stars to deal me 72os for the next 48234 hands in a row"
QvTX2yGq3uKJiKPmns4TKQ: calls $1.50
*** SHOW DOWN ***
faP2NVl/cFTZ1nE4pXzg8Q: shows [4d Qs] (two pair, Kings and Queens)
QvTX2yGq3uKJiKPmns4TKQ: mucks hand 
faP2NVl/cFTZ1nE4pXzg8Q collected $9.15 from pot
*** SUMMARY ***
Total pot $9.60 | Rake $0.45 
Board [Kd Qc Th 9d Kc]
Seat 1: W87HPwOk1KtWaYyshBe1gA folded before Flop (didn't bet)
Seat 2: iauW7L/+7qzAuHow7CD75Q folded before Flop (didn't bet)
Seat 3: QvTX2yGq3uKJiKPmns4TKQ (button) mucked
Seat 4: NTamLAiMZ86c5yM04t96LA (small blind) folded before Flop
Seat 5: faP2NVl/cFTZ1nE4pXzg8Q (big blind) showed [4d Qs] and won ($9.15) with two pair, Kings and Queens
Seat 6: 7JqTFMyeNSVWsmp/yW35Tw folded before Flop (didn't bet)




PokerStars Game #59941585978:  Hold'em No Limit ($0.10/$0.25) - 2009/07/01 1:39:56 ET
Table 'vFZR6Kf2Th5xBXT9brGW6A' 6-max Seat #2 is the button
Seat 1: Q3EMN7b0ie81AFWkDrhCjw ($20.95 in chips) 
Seat 2: QiL+lEgEWwy21jk/ltaRLg ($23.40 in chips) 
Seat 3: SH1WjKVUjPiyXySjWSdazw ($23.15 in chips) 
Seat 4: 79ID/ub1Pt/mDpCprVmOoA ($35.90 in chips) 
Seat 5: SS/yfeArhULzIcOPe8MdPg ($26 in chips) 
Seat 6: 4x9jCqgSw4272dnaIqnanw ($4.10 in chips) 
SH1WjKVUjPiyXySjWSdazw: posts small blind $0.10
79ID/ub1Pt/mDpCprVmOoA: posts big blind $0.25
*** HOLE CARDS ***
SS/yfeArhULzIcOPe8MdPg: folds 
4x9jCqgSw4272dnaIqnanw: folds 
Q3EMN7b0ie81AFWkDrhCjw: raises $0.50 to $0.75
QiL+lEgEWwy21jk/ltaRLg: folds 
SH1WjKVUjPiyXySjWSdazw: folds 
79ID/ub1Pt/mDpCprVmOoA: folds 
Uncalled bet ($0.50) returned to Q3EMN7b0ie81AFWkDrhCjw
Q3EMN7b0ie81AFWkDrhCjw collected $0.60 from pot
*** SUMMARY ***
Total pot $0.60 | Rake $0 
Seat 1: Q3EMN7b0ie81AFWkDrhCjw collected ($0.60)
Seat 2: QiL+lEgEWwy21jk/ltaRLg (button) folded before Flop (didn't bet)
Seat 3: SH1WjKVUjPiyXySjWSdazw (small blind) folded before Flop
Seat 4: 79ID/ub1Pt/mDpCprVmOoA (big blind) folded before Flop
Seat 5: SS/yfeArhULzIcOPe8MdPg folded before Flop (didn't bet)
Seat 6: 4x9jCqgSw4272dnaIqnanw folded before Flop (didn't bet)




PokerStars Game #59941586162:  Hold'em No Limit ($0.10/$0.25) - 2009/07/01 1:39:56 ET
Table 'YYMg5qzxK1m9eGRo4SbxtQ' 9-max Seat #2 is the button
Seat 2: f/H6PsHRl4W1JyNsEDvPtg ($8.10 in chips) 
Seat 4: H8sSXb2KLK0U38tU9YITDw ($5.40 in chips) 
Seat 6: S5VeQLgBIiHrfs9AB2vBwA ($3.55 in chips) 
Seat 7: otsTcnOEjDA+oFV8U+ITZw ($19.20 in chips) 
Seat 8: xoBFd/5k+L/pFn9VW1VyWg ($12.75 in chips) 
Seat 9: +sbyWwIcFp9kP0bDtMegfQ ($32.25 in chips) 
H8sSXb2KLK0U38tU9YITDw: posts small blind $0.10
S5VeQLgBIiHrfs9AB2vBwA: posts big blind $0.25
*** HOLE CARDS ***
otsTcnOEjDA+oFV8U+ITZw: folds 
xoBFd/5k+L/pFn9VW1VyWg: raises $0.75 to $1
+sbyWwIcFp9kP0bDtMegfQ: folds 
f/H6PsHRl4W1JyNsEDvPtg: folds 
H8sSXb2KLK0U38tU9YITDw: folds 
H8sSXb2KLK0U38tU9YITDw is sitting out
S5VeQLgBIiHrfs9AB2vBwA: folds 
Uncalled bet ($0.75) returned to xoBFd/5k+L/pFn9VW1VyWg
xoBFd/5k+L/pFn9VW1VyWg collected $0.60 from pot
H8sSXb2KLK0U38tU9YITDw leaves the table
*** SUMMARY ***
Total pot $0.60 | Rake $0 
Seat 2: f/H6PsHRl4W1JyNsEDvPtg (button) folded before Flop (didn't bet)
Seat 4: H8sSXb2KLK0U38tU9YITDw (small blind) folded before Flop
Seat 6: S5VeQLgBIiHrfs9AB2vBwA (big blind) folded before Flop
Seat 7: otsTcnOEjDA+oFV8U+ITZw folded before Flop (didn't bet)
Seat 8: xoBFd/5k+L/pFn9VW1VyWg collected ($0.60)
Seat 9: +sbyWwIcFp9kP0bDtMegfQ folded before Flop (didn't bet)




PokerStars Game #59941585962:  Hold'em No Limit ($0.10/$0.25) - 2009/07/01 1:39:56 ET
Table 'SbSV5tlgLp0+/Z+13PW3Hg' 9-max Seat #1 is the button
Seat 1: x+W5+3qsdY4Iszf0hoH+Aw ($14.85 in chips) 
Seat 2: zDrucyjVn5aeekNEc3cJrA ($13.90 in chips) 
Seat 3: CT7Xj/V/O5rBlhtt+RZeFQ ($25 in chips) 
Seat 4: puj3K/wrNjEj86ZL/MyfLA ($10.50 in chips) 
Seat 7: ruosoLPCzPyA3nfXoPVY3Q ($1.35 in chips) 
Seat 8: qBdqLaJhO+1itcMk70bsfA ($8.90 in chips) 
Seat 9: X78b5v/uhqeXXoAijbw/yg ($25 in chips) 
zDrucyjVn5aeekNEc3cJrA: posts small blind $0.10
CT7Xj/V/O5rBlhtt+RZeFQ: posts big blind $0.25
aNpwfA31EREwO+ar4XzBCw: sits out 
pN3IHvAKm2fz+sTRARTcrg: sits out 
*** HOLE CARDS ***
puj3K/wrNjEj86ZL/MyfLA: raises $0.25 to $0.50
ruosoLPCzPyA3nfXoPVY3Q: folds 
qBdqLaJhO+1itcMk70bsfA: folds 
X78b5v/uhqeXXoAijbw/yg: folds 
x+W5+3qsdY4Iszf0hoH+Aw: folds 
zDrucyjVn5aeekNEc3cJrA: folds 
CT7Xj/V/O5rBlhtt+RZeFQ: folds 
Uncalled bet ($0.25) returned to puj3K/wrNjEj86ZL/MyfLA
puj3K/wrNjEj86ZL/MyfLA collected $0.60 from pot
puj3K/wrNjEj86ZL/MyfLA: doesn't show hand 
*** SUMMARY ***
Total pot $0.60 | Rake $0 
Seat 1: x+W5+3qsdY4Iszf0hoH+Aw (button) folded before Flop (didn't bet)
Seat 2: zDrucyjVn5aeekNEc3cJrA (small blind) folded before Flop
Seat 3: CT7Xj/V/O5rBlhtt+RZeFQ (big blind) folded before Flop
Seat 4: puj3K/wrNjEj86ZL/MyfLA collected ($0.60)
Seat 7: ruosoLPCzPyA3nfXoPVY3Q folded before Flop (didn't bet)
Seat 8: qBdqLaJhO+1itcMk70bsfA folded before Flop (didn't bet)
Seat 9: X78b5v/uhqeXXoAijbw/yg folded before Flop (didn't bet)




PokerStars Game #59941586148:  Hold'em No Limit ($0.10/$0.25) - 2009/07/01 1:39:56 ET
Table 'VuY5ej47Cy8nOI3Wogmhzw' 6-max Seat #1 is the button
Seat 1: EeUZtMU058v2ObUACOF4Og ($25.95 in chips) 
Seat 2: AM6Yl+3esmhhMBlSnQhWbg ($15.75 in chips) 
Seat 3: v+QfkGiuj9bgtuNoVnDO8w ($31.85 in chips) 
Seat 4: aXzjpue4eAQBqMdp87D3ZA ($13.95 in chips) 
Seat 5: iK/41//HmnLiIn0CVNNfyA ($11.95 in chips) 
AM6Yl+3esmhhMBlSnQhWbg: posts small blind $0.10
v+QfkGiuj9bgtuNoVnDO8w: posts big blind $0.25
*** HOLE CARDS ***
aXzjpue4eAQBqMdp87D3ZA: folds 
iK/41//HmnLiIn0CVNNfyA: folds 
EeUZtMU058v2ObUACOF4Og: folds 
AM6Yl+3esmhhMBlSnQhWbg: calls $0.15
v+QfkGiuj9bgtuNoVnDO8w: checks 
*** FLOP *** [6s 9h 5s]
AM6Yl+3esmhhMBlSnQhWbg: bets $0.50
v+QfkGiuj9bgtuNoVnDO8w: folds 
Uncalled bet ($0.50) returned to AM6Yl+3esmhhMBlSnQhWbg
AM6Yl+3esmhhMBlSnQhWbg collected $0.50 from pot
AM6Yl+3esmhhMBlSnQhWbg: doesn't show hand 
*** SUMMARY ***
Total pot $0.50 | Rake $0 
Board [6s 9h 5s]
Seat 1: EeUZtMU058v2ObUACOF4Og (button) folded before Flop (didn't bet)
Seat 2: AM6Yl+3esmhhMBlSnQhWbg (small blind) collected ($0.50)
Seat 3: v+QfkGiuj9bgtuNoVnDO8w (big blind) folded on the Flop
Seat 4: aXzjpue4eAQBqMdp87D3ZA folded before Flop (didn't bet)
Seat 5: iK/41//HmnLiIn0CVNNfyA folded before Flop (didn't bet)




PokerStars Game #59941586118:  Hold'em No Limit ($0.10/$0.25) - 2009/07/01 1:39:56 ET
Table 'MRfAiS/4JSfnUDlCcZo0wAhfHe8uKeSJMyWAjSdM7ROQx Seat #3 is the button
Seat 1: 48oT5xFI+5CHUJlfoGrE4w ($31.60 in chips) 
Seat 2: /gJNBeCkWL4o85/jvlZ4BA ($30.70 in chips) 
Seat 3: FYepjhAvF8ZdVCmqHIy+eQ ($39.05 in chips) 
Seat 6: L3/N/gliETan8N5Gim5h4Q ($25.10 in chips) 
L3/N/gliETan8N5Gim5h4Q: posts small blind $0.10
48oT5xFI+5CHUJlfoGrE4w: posts big blind $0.25
*** HOLE CARDS ***
b4wRQV3APH8irVk6bUFe2Q has returned
/gJNBeCkWL4o85/jvlZ4BA: folds 
FYepjhAvF8ZdVCmqHIy+eQ: folds 
L3/N/gliETan8N5Gim5h4Q: raises $0.50 to $0.75
48oT5xFI+5CHUJlfoGrE4w: folds 
Uncalled bet ($0.50) returned to L3/N/gliETan8N5Gim5h4Q
L3/N/gliETan8N5Gim5h4Q collected $0.50 from pot
L3/N/gliETan8N5Gim5h4Q: doesn't show hand 
*** SUMMARY ***
Total pot $0.50 | Rake $0 
Seat 1: 48oT5xFI+5CHUJlfoGrE4w (big blind) folded before Flop
Seat 2: /gJNBeCkWL4o85/jvlZ4BA folded before Flop (didn't bet)
Seat 3: FYepjhAvF8ZdVCmqHIy+eQ (button) folded before Flop (didn't bet)
Seat 6: L3/N/gliETan8N5Gim5h4Q (small blind) collected ($0.50)




PokerStars Game #59941587000:  Hold'em No Limit ($0.10/$0.25) - 2009/07/01 1:39:57 ET
Table '+VTTYgQLH1awDHk+IAxqGg' 9-max Seat #4 is the button
Seat 1: arxNSjreDRGFg13EAM2F1w ($25.75 in chips) 
Seat 2: 2wcFsZsqEP5w1StUTVzJCg ($5.40 in chips) 
Seat 3: AiXn/9o1EwOPZUHujnh/bA ($18.65 in chips) 
Seat 4: gE5rN2TDY1aXcZn/TOPeZw ($8.80 in chips) 
Seat 5: sD+TKtt36XiiN6jqHiLwDA ($25.40 in chips) 
Seat 7: ljemhp25Zg+nlA9DLCIiUw ($23.90 in chips) 
Seat 8: 10vzP4r6ldwGLbYHKd9www ($18 in chips) 
Seat 9: S7Ki0P+0AIGPuIfGJjW0gg ($56.15 in chips) 
sD+TKtt36XiiN6jqHiLwDA: posts small blind $0.10
ljemhp25Zg+nlA9DLCIiUw: posts big blind $0.25
*** HOLE CARDS ***
10vzP4r6ldwGLbYHKd9www: calls $0.25
S7Ki0P+0AIGPuIfGJjW0gg: folds 
arxNSjreDRGFg13EAM2F1w: folds 
2wcFsZsqEP5w1StUTVzJCg: folds 
AiXn/9o1EwOPZUHujnh/bA: folds 
gE5rN2TDY1aXcZn/TOPeZw: calls $0.25
sD+TKtt36XiiN6jqHiLwDA: calls $0.15
ljemhp25Zg+nlA9DLCIiUw: checks 
*** FLOP *** [3d 6h 7d]
sD+TKtt36XiiN6jqHiLwDA: checks 
ljemhp25Zg+nlA9DLCIiUw: checks 
10vzP4r6ldwGLbYHKd9www: bets $0.50
gE5rN2TDY1aXcZn/TOPeZw: calls $0.50
sD+TKtt36XiiN6jqHiLwDA: folds 
ljemhp25Zg+nlA9DLCIiUw: folds 
*** TURN *** [3d 6h 7d] [Kh]
10vzP4r6ldwGLbYHKd9www: bets $0.50
gE5rN2TDY1aXcZn/TOPeZw: raises $0.50 to $1
10vzP4r6ldwGLbYHKd9www: calls $0.50
*** RIVER *** [3d 6h 7d Kh] [2s]
10vzP4r6ldwGLbYHKd9www: checks 
gE5rN2TDY1aXcZn/TOPeZw: checks 
*** SHOW DOWN ***
10vzP4r6ldwGLbYHKd9www: shows [7s Td] (a pair of Sevens)
gE5rN2TDY1aXcZn/TOPeZw: shows [Kd 9d] (a pair of Kings)
gE5rN2TDY1aXcZn/TOPeZw collected $3.85 from pot
*** SUMMARY ***
Total pot $4 | Rake $0.15 
Board [3d 6h 7d Kh 2s]
Seat 1: arxNSjreDRGFg13EAM2F1w folded before Flop (didn't bet)
Seat 2: 2wcFsZsqEP5w1StUTVzJCg folded before Flop (didn't bet)
Seat 3: AiXn/9o1EwOPZUHujnh/bA folded before Flop (didn't bet)
Seat 4: gE5rN2TDY1aXcZn/TOPeZw (button) showed [Kd 9d] and won ($3.85) with a pair of Kings
Seat 5: sD+TKtt36XiiN6jqHiLwDA (small blind) folded on the Flop
Seat 7: ljemhp25Zg+nlA9DLCIiUw (big blind) folded on the Flop
Seat 8: 10vzP4r6ldwGLbYHKd9www showed [7s Td] and lost with a pair of Sevens
Seat 9: S7Ki0P+0AIGPuIfGJjW0gg folded before Flop (didn't bet)




PokerStars Game #59941586470:  Hold'em No Limit ($0.10/$0.25) - 2009/07/01 1:39:57 ET
Table 'YlRA05h9BJ1EhOUSNUjJdg' 9-max Seat #7 is the button
Seat 1: dtZ84flFEi4Q+SGrHMJRDQ ($25 in chips) 
Seat 2: Y2GFAe+PT7xnUUtgqCNDFw ($11.10 in chips) 
Seat 3: Z5ZtGOON8kmSdSCll9Z3XA ($12.10 in chips) 
Seat 5: sx0lGrkT9fd4yFR+3cXUQg ($11.30 in chips) 
Seat 6: QEbIGci+itdw+re8RM5fZA ($44.35 in chips) 
Seat 7: dfNim92Z6XK1/h5SFW5vDg ($25 in chips) 
Seat 8: dmYlc+1cjwZMJ7wV+Z0rRg ($32.20 in chips) 
Seat 9: Z9AeOQX3yzuSvKAm/xyovg ($9.75 in chips) 
dmYlc+1cjwZMJ7wV+Z0rRg: posts small blind $0.10
Z9AeOQX3yzuSvKAm/xyovg: posts big blind $0.25
*** HOLE CARDS ***
dtZ84flFEi4Q+SGrHMJRDQ: folds 
Y2GFAe+PT7xnUUtgqCNDFw: calls $0.25
Z5ZtGOON8kmSdSCll9Z3XA: folds 
sx0lGrkT9fd4yFR+3cXUQg: calls $0.25
QEbIGci+itdw+re8RM5fZA: folds 
dfNim92Z6XK1/h5SFW5vDg: calls $0.25
dmYlc+1cjwZMJ7wV+Z0rRg: folds 
Z9AeOQX3yzuSvKAm/xyovg: checks 
*** FLOP *** [Jh 5c Qs]
Z9AeOQX3yzuSvKAm/xyovg: checks 
Y2GFAe+PT7xnUUtgqCNDFw: bets $0.25
HPEB+AtKw1+C/cxU0o1ciw has returned
sx0lGrkT9fd4yFR+3cXUQg: folds 
dfNim92Z6XK1/h5SFW5vDg: folds 
Z9AeOQX3yzuSvKAm/xyovg: folds 
Uncalled bet ($0.25) returned to Y2GFAe+PT7xnUUtgqCNDFw
Y2GFAe+PT7xnUUtgqCNDFw collected $1.05 from pot
Y2GFAe+PT7xnUUtgqCNDFw: doesn't show hand 
*** SUMMARY ***
Total pot $1.10 | Rake $0.05 
Board [Jh 5c Qs]
Seat 1: dtZ84flFEi4Q+SGrHMJRDQ folded before Flop (didn't bet)
Seat 2: Y2GFAe+PT7xnUUtgqCNDFw collected ($1.05)
Seat 3: Z5ZtGOON8kmSdSCll9Z3XA folded before Flop (didn't bet)
Seat 5: sx0lGrkT9fd4yFR+3cXUQg folded on the Flop
Seat 6: QEbIGci+itdw+re8RM5fZA folded before Flop (didn't bet)
Seat 7: dfNim92Z6XK1/h5SFW5vDg (button) folded on the Flop
Seat 8: dmYlc+1cjwZMJ7wV+Z0rRg (small blind) folded before Flop
Seat 9: Z9AeOQX3yzuSvKAm/xyovg (big blind) folded on the Flop




PokerStars Game #59941586388:  Hold'em No Limit ($0.10/$0.25) - 2009/07/01 1:39:57 ET
Table '3lS+sU5k6mwJCS2nFMmQ6Q' 9-max Seat #8 is the button
Seat 1: VWUWpMLMj/Q1jRVpF7Aohw ($13.20 in chips) 
Seat 3: 1DXccE2UUK5DIRVGlOKnTA ($18.30 in chips) 
Seat 4: ydoFOVgzvZv9ZhuWu9rXAw ($5.35 in chips) 
Seat 5: NcPAt5YjVvDFEJTTgAVj8g ($5.30 in chips) 
Seat 6: hJ4uYjNmSZdjrKA8cjZqCA ($36.75 in chips) 
Seat 7: Th3FldXKQW6hWVVPahaoOQ ($30.85 in chips) 
Seat 8: 9lvO/qyU+xrU95Teu1fv0g ($4.05 in chips) 
Seat 9: 4awUyiDYTgylQKXZ9faBVA ($45.30 in chips) 
4awUyiDYTgylQKXZ9faBVA: posts small blind $0.10
VWUWpMLMj/Q1jRVpF7Aohw: posts big blind $0.25
*** HOLE CARDS ***
1DXccE2UUK5DIRVGlOKnTA: folds 
ydoFOVgzvZv9ZhuWu9rXAw: folds 
NcPAt5YjVvDFEJTTgAVj8g: calls $0.25
hJ4uYjNmSZdjrKA8cjZqCA: folds 
Th3FldXKQW6hWVVPahaoOQ: folds 
9lvO/qyU+xrU95Teu1fv0g: folds 
4awUyiDYTgylQKXZ9faBVA: folds 
VWUWpMLMj/Q1jRVpF7Aohw: checks 
*** FLOP *** [3s As 3d]
VWUWpMLMj/Q1jRVpF7Aohw: bets $0.50
NcPAt5YjVvDFEJTTgAVj8g: folds 
Uncalled bet ($0.50) returned to VWUWpMLMj/Q1jRVpF7Aohw
VWUWpMLMj/Q1jRVpF7Aohw collected $0.60 from pot
*** SUMMARY ***
Total pot $0.60 | Rake $0 
Board [3s As 3d]
Seat 1: VWUWpMLMj/Q1jRVpF7Aohw (big blind) collected ($0.60)
Seat 3: 1DXccE2UUK5DIRVGlOKnTA folded before Flop (didn't bet)
Seat 4: ydoFOVgzvZv9ZhuWu9rXAw folded before Flop (didn't bet)
Seat 5: NcPAt5YjVvDFEJTTgAVj8g folded on the Flop
Seat 6: hJ4uYjNmSZdjrKA8cjZqCA folded before Flop (didn't bet)
Seat 7: Th3FldXKQW6hWVVPahaoOQ folded before Flop (didn't bet)
Seat 8: 9lvO/qyU+xrU95Teu1fv0g (button) folded before Flop (didn't bet)
Seat 9: 4awUyiDYTgylQKXZ9faBVA (small blind) folded before Flop




PokerStars Game #59941586906:  Hold'em No Limit ($0.10/$0.25) - 2009/07/01 1:39:57 ET
Table 'wGizWOswEL6P5QrvVkno/g' 6-max Seat #4 is the button
Seat 2: mfrkWA3PTeYPkbO6hi98Aw ($24.90 in chips) 
Seat 3: bJFzs6QmEEnz4miMfSDtcg ($15 in chips) 
Seat 4: 32YL2ZEp8NT4JB2RVM9euQ ($16.65 in chips) 
Seat 5: wsP46AGpqDjHZQmlRHKa9g ($39.50 in chips) 
Seat 6: rfSnsAuAfXTb8w/obc9OVQ ($4.25 in chips) 
wsP46AGpqDjHZQmlRHKa9g: posts small blind $0.10
rfSnsAuAfXTb8w/obc9OVQ: posts big blind $0.25
bJFzs6QmEEnz4miMfSDtcg: posts big blind $0.25
*** HOLE CARDS ***
Qbfkn+ucISvbd1Xh32zAGA joins the table at seat #1 
mfrkWA3PTeYPkbO6hi98Aw: raises $1 to $1.25
bJFzs6QmEEnz4miMfSDtcg: folds 
32YL2ZEp8NT4JB2RVM9euQ: folds 
wsP46AGpqDjHZQmlRHKa9g: folds 
rfSnsAuAfXTb8w/obc9OVQ: raises $1 to $2.25
mfrkWA3PTeYPkbO6hi98Aw: calls $1
*** FLOP *** [4h Qh 8h]
rfSnsAuAfXTb8w/obc9OVQ: checks 
mfrkWA3PTeYPkbO6hi98Aw: checks 
*** TURN *** [4h Qh 8h] [4d]
rfSnsAuAfXTb8w/obc9OVQ: bets $0.75
mfrkWA3PTeYPkbO6hi98Aw: calls $0.75
*** RIVER *** [4h Qh 8h 4d] [5d]
rfSnsAuAfXTb8w/obc9OVQ: bets $1
mfrkWA3PTeYPkbO6hi98Aw: folds 
Uncalled bet ($1) returned to rfSnsAuAfXTb8w/obc9OVQ
rfSnsAuAfXTb8w/obc9OVQ collected $6.05 from pot
rfSnsAuAfXTb8w/obc9OVQ: doesn't show hand 
*** SUMMARY ***
Total pot $6.35 | Rake $0.30 
Board [4h Qh 8h 4d 5d]
Seat 2: mfrkWA3PTeYPkbO6hi98Aw folded on the River
Seat 3: bJFzs6QmEEnz4miMfSDtcg folded before Flop
Seat 4: 32YL2ZEp8NT4JB2RVM9euQ (button) folded before Flop (didn't bet)
Seat 5: wsP46AGpqDjHZQmlRHKa9g (small blind) folded before Flop
Seat 6: rfSnsAuAfXTb8w/obc9OVQ (big blind) collected ($6.05)




PokerStars Game #59941586542:  Hold'em No Limit ($0.10/$0.25) - 2009/07/01 1:39:57 ET
Table '+68ihX5Br1xgGorX6zsCBg' 9-max Seat #6 is the button
Seat 1: IFB2mhulUVYIbb+KWwDC9w ($5.20 in chips) 
Seat 2: TeAfhXG1R60d8yPEHN3JiA ($27.30 in chips) 
Seat 3: PdIasPkzm2sqZnN41ZRXOg ($5 in chips) 
Seat 4: Oi0EiPIjriUb/6zT65YeWA ($27.70 in chips) 
Seat 5: ghNKXUBl/H+t83JF079ZBA ($25.45 in chips) 
Seat 6: X78b5v/uhqeXXoAijbw/yg ($26.40 in chips) 
Seat 7: V6p0jQ/RhUsqpHLmXvEX4Q ($14.45 in chips) 
Seat 8: Ut3g/kEEdCCbe/gbWrHnDg ($13.55 in chips) 
Seat 9: DiSvPC2iudwL5j9u6Huyww ($29.80 in chips) 
V6p0jQ/RhUsqpHLmXvEX4Q: posts small blind $0.10
Ut3g/kEEdCCbe/gbWrHnDg: posts big blind $0.25
*** HOLE CARDS ***
DiSvPC2iudwL5j9u6Huyww: folds 
IFB2mhulUVYIbb+KWwDC9w: folds 
TeAfhXG1R60d8yPEHN3JiA: raises $0.25 to $0.50
PdIasPkzm2sqZnN41ZRXOg: folds 
Oi0EiPIjriUb/6zT65YeWA: folds 
ghNKXUBl/H+t83JF079ZBA: folds 
X78b5v/uhqeXXoAijbw/yg: folds 
V6p0jQ/RhUsqpHLmXvEX4Q: folds 
Ut3g/kEEdCCbe/gbWrHnDg: calls $0.25
*** FLOP *** [5d 5h 7h]
Ut3g/kEEdCCbe/gbWrHnDg: checks 
TeAfhXG1R60d8yPEHN3JiA: bets $0.25
Ut3g/kEEdCCbe/gbWrHnDg: calls $0.25
*** TURN *** [5d 5h 7h] [4c]
Ut3g/kEEdCCbe/gbWrHnDg: checks 
TeAfhXG1R60d8yPEHN3JiA: bets $0.25
Ut3g/kEEdCCbe/gbWrHnDg: calls $0.25
*** RIVER *** [5d 5h 7h 4c] [Ah]
Ut3g/kEEdCCbe/gbWrHnDg: checks 
TeAfhXG1R60d8yPEHN3JiA: bets $2.25
Ut3g/kEEdCCbe/gbWrHnDg: folds 
Uncalled bet ($2.25) returned to TeAfhXG1R60d8yPEHN3JiA
TeAfhXG1R60d8yPEHN3JiA collected $2 from pot
TeAfhXG1R60d8yPEHN3JiA: doesn't show hand 
*** SUMMARY ***
Total pot $2.10 | Rake $0.10 
Board [5d 5h 7h 4c Ah]
Seat 1: IFB2mhulUVYIbb+KWwDC9w folded before Flop (didn't bet)
Seat 2: TeAfhXG1R60d8yPEHN3JiA collected ($2)
Seat 3: PdIasPkzm2sqZnN41ZRXOg folded before Flop (didn't bet)
Seat 4: Oi0EiPIjriUb/6zT65YeWA folded before Flop (didn't bet)
Seat 5: ghNKXUBl/H+t83JF079ZBA folded before Flop (didn't bet)
Seat 6: X78b5v/uhqeXXoAijbw/yg (button) folded before Flop (didn't bet)
Seat 7: V6p0jQ/RhUsqpHLmXvEX4Q (small blind) folded before Flop
Seat 8: Ut3g/kEEdCCbe/gbWrHnDg (big blind) folded on the River
Seat 9: DiSvPC2iudwL5j9u6Huyww folded before Flop (didn't bet)




PokerStars Game #59941586604:  Hold'em No Limit ($0.10/$0.25) - 2009/07/01 1:39:57 ET
Table '4mnXP0EWt9mMZYzTIVDQ0w' 9-max Seat #5 is the button
Seat 1: Z5y2J55JmfLYR6/DPAGHwQ ($24 in chips) 
Seat 2: BLEU2x2bnGRovIelAY6slA ($24.55 in chips) 
Seat 4: 9lvO/qyU+xrU95Teu1fv0g ($7 in chips) 
Seat 5: sSN8Y0AlsBeidZXPKmwXSw ($25.95 in chips) 
Seat 6: 5yjzPss7Y4kAWNDat3e0yQ ($29.20 in chips) 
Seat 7: OiV1PWZ3IkN29JlmCcnTwQ ($5.85 in chips) 
Seat 8: 9YN2IkT2JYYKFErZtZvCtA ($21.85 in chips) 
5yjzPss7Y4kAWNDat3e0yQ: posts small blind $0.10
OiV1PWZ3IkN29JlmCcnTwQ: posts big blind $0.25
*** HOLE CARDS ***
QcmMXyv063LEIFA6k/PHBQ leaves the table
9YN2IkT2JYYKFErZtZvCtA: folds 
Z5y2J55JmfLYR6/DPAGHwQ: folds 
BLEU2x2bnGRovIelAY6slA: folds 
9lvO/qyU+xrU95Teu1fv0g: folds 
sSN8Y0AlsBeidZXPKmwXSw: folds 
5yjzPss7Y4kAWNDat3e0yQ: folds 
Uncalled bet ($0.15) returned to OiV1PWZ3IkN29JlmCcnTwQ
OiV1PWZ3IkN29JlmCcnTwQ collected $0.20 from pot
OiV1PWZ3IkN29JlmCcnTwQ: doesn't show hand 
*** SUMMARY ***
Total pot $0.20 | Rake $0 
Seat 1: Z5y2J55JmfLYR6/DPAGHwQ folded before Flop (didn't bet)
Seat 2: BLEU2x2bnGRovIelAY6slA folded before Flop (didn't bet)
Seat 4: 9lvO/qyU+xrU95Teu1fv0g folded before Flop (didn't bet)
Seat 5: sSN8Y0AlsBeidZXPKmwXSw (button) folded before Flop (didn't bet)
Seat 6: 5yjzPss7Y4kAWNDat3e0yQ (small blind) folded before Flop
Seat 7: OiV1PWZ3IkN29JlmCcnTwQ (big blind) collected ($0.20)
Seat 8: 9YN2IkT2JYYKFErZtZvCtA folded before Flop (didn't bet)




PokerStars Game #59941586748:  Hold'em No Limit ($0.10/$0.25) - 2009/07/01 1:39:57 ET
Table 'JUMeG5SzDyo9HufhgemQeA' 9-max Seat #3 is the button
Seat 1: oLa/tXLfSLLB28mcLGrxcg ($23.85 in chips) 
Seat 3: IEvLSTIxhlti3EjZDarYnA ($32.50 in chips) 
Seat 5: Ne5zBB6oEKrbigKRh6d6Xg ($12.75 in chips) 
Seat 6: wFCwdYKUXoQHhz8qeZuuAw ($25.45 in chips) 
Seat 7: aNpwfA31EREwO+ar4XzBCw ($32.75 in chips) 
Seat 8: zDrucyjVn5aeekNEc3cJrA ($37.70 in chips) 
Seat 9: V6p0jQ/RhUsqpHLmXvEX4Q ($13.80 in chips) 
Ne5zBB6oEKrbigKRh6d6Xg: posts small blind $0.10
wFCwdYKUXoQHhz8qeZuuAw: posts big blind $0.25
*** HOLE CARDS ***
aNpwfA31EREwO+ar4XzBCw: calls $0.25
zDrucyjVn5aeekNEc3cJrA: folds 
V6p0jQ/RhUsqpHLmXvEX4Q: folds 
9+Um1wMtYNWnmPLUEU4viQ joins the table at seat #4 
oLa/tXLfSLLB28mcLGrxcg: calls $0.25
IEvLSTIxhlti3EjZDarYnA: folds 
Ne5zBB6oEKrbigKRh6d6Xg: calls $0.15
wFCwdYKUXoQHhz8qeZuuAw: checks 
*** FLOP *** [Qd Kd 6s]
Ne5zBB6oEKrbigKRh6d6Xg: checks 
wFCwdYKUXoQHhz8qeZuuAw: checks 
aNpwfA31EREwO+ar4XzBCw: checks 
oLa/tXLfSLLB28mcLGrxcg: checks 
*** TURN *** [Qd Kd 6s] [9s]
Jve2LRs9vtGL7NdiNeXY/A joins the table at seat #2 
Ne5zBB6oEKrbigKRh6d6Xg: checks 
wFCwdYKUXoQHhz8qeZuuAw: checks 
aNpwfA31EREwO+ar4XzBCw: checks 
oLa/tXLfSLLB28mcLGrxcg: bets $0.50
Ne5zBB6oEKrbigKRh6d6Xg: folds 
wFCwdYKUXoQHhz8qeZuuAw: folds 
aNpwfA31EREwO+ar4XzBCw: folds 
Uncalled bet ($0.50) returned to oLa/tXLfSLLB28mcLGrxcg
oLa/tXLfSLLB28mcLGrxcg collected $0.95 from pot
oLa/tXLfSLLB28mcLGrxcg: doesn't show hand 
*** SUMMARY ***
Total pot $1 | Rake $0.05 
Board [Qd Kd 6s 9s]
Seat 1: oLa/tXLfSLLB28mcLGrxcg collected ($0.95)
Seat 3: IEvLSTIxhlti3EjZDarYnA (button) folded before Flop (didn't bet)
Seat 5: Ne5zBB6oEKrbigKRh6d6Xg (small blind) folded on the Turn
Seat 6: wFCwdYKUXoQHhz8qeZuuAw (big blind) folded on the Turn
Seat 7: aNpwfA31EREwO+ar4XzBCw folded on the Turn
Seat 8: zDrucyjVn5aeekNEc3cJrA folded before Flop (didn't bet)
Seat 9: V6p0jQ/RhUsqpHLmXvEX4Q folded before Flop (didn't bet)




PokerStars Game #59941586700:  Hold'em No Limit ($0.10/$0.25) - 2009/07/01 1:39:57 ET
Table 'JPFXJXa5xBkjZ/W15BKqeQ' 9-max Seat #6 is the button
Seat 2: XMSS6mD5B42I8wasdOMipQ ($10.95 in chips) 
Seat 3: 56S3mA6Zs3pGR+0p0vUCtg ($21.70 in chips) 
Seat 4: wGigCmBR/9XWkPpvYos3aQ ($26.75 in chips) 
Seat 5: cZ99hugmLBj9KhTlc8nCSw ($25 in chips) 
Seat 6: tLcDklc2rBORNfixyRfVfw ($25 in chips) 
Seat 8: zDrucyjVn5aeekNEc3cJrA ($24.30 in chips) 
Seat 9: PVqNFEFMoGtpTPGnpm4LTQ ($25.90 in chips) 
PdIasPkzm2sqZnN41ZRXOg will be allowed to play after the button
zDrucyjVn5aeekNEc3cJrA: posts small blind $0.10
PVqNFEFMoGtpTPGnpm4LTQ: posts big blind $0.25
*** HOLE CARDS ***
XMSS6mD5B42I8wasdOMipQ: folds 
56S3mA6Zs3pGR+0p0vUCtg: folds 
wGigCmBR/9XWkPpvYos3aQ: folds 
cZ99hugmLBj9KhTlc8nCSw: folds 
tLcDklc2rBORNfixyRfVfw: raises $0.75 to $1
zDrucyjVn5aeekNEc3cJrA: folds 
PVqNFEFMoGtpTPGnpm4LTQ: folds 
Uncalled bet ($0.75) returned to tLcDklc2rBORNfixyRfVfw
mNQH7Afv3tbDKl2tAb9BOg has returned
tLcDklc2rBORNfixyRfVfw collected $0.60 from pot
tLcDklc2rBORNfixyRfVfw: doesn't show hand 
*** SUMMARY ***
Total pot $0.60 | Rake $0 
Seat 2: XMSS6mD5B42I8wasdOMipQ folded before Flop (didn't bet)
Seat 3: 56S3mA6Zs3pGR+0p0vUCtg folded before Flop (didn't bet)
Seat 4: wGigCmBR/9XWkPpvYos3aQ folded before Flop (didn't bet)
Seat 5: cZ99hugmLBj9KhTlc8nCSw folded before Flop (didn't bet)
Seat 6: tLcDklc2rBORNfixyRfVfw (button) collected ($0.60)
Seat 8: zDrucyjVn5aeekNEc3cJrA (small blind) folded before Flop
Seat 9: PVqNFEFMoGtpTPGnpm4LTQ (big blind) folded before Flop




PokerStars Game #59941586808:  Hold'em No Limit ($0.10/$0.25) - 2009/07/01 1:39:57 ET
Table 'I0ZcuiUTeLuGYv26Nah7YA' 9-max Seat #8 is the button
Seat 2: ljemhp25Zg+nlA9DLCIiUw ($34.15 in chips) 
Seat 5: y7tkvDmwKjURBkr73SZPXw ($6.95 in chips) 
Seat 8: ShCS62CJp4MKfKLKvGKQbA ($7.60 in chips) 
ljemhp25Zg+nlA9DLCIiUw: posts small blind $0.10
y7tkvDmwKjURBkr73SZPXw: posts big blind $0.25
*** HOLE CARDS ***
ShCS62CJp4MKfKLKvGKQbA: folds 
ljemhp25Zg+nlA9DLCIiUw: folds 
Uncalled bet ($0.15) returned to y7tkvDmwKjURBkr73SZPXw
y7tkvDmwKjURBkr73SZPXw collected $0.20 from pot
ShCS62CJp4MKfKLKvGKQbA leaves the table
*** SUMMARY ***
Total pot $0.20 | Rake $0 
Seat 2: ljemhp25Zg+nlA9DLCIiUw (small blind) folded before Flop
Seat 5: y7tkvDmwKjURBkr73SZPXw (big blind) collected ($0.20)
Seat 8: ShCS62CJp4MKfKLKvGKQbA (button) folded before Flop (didn't bet)




PokerStars Game #59941586868:  Hold'em No Limit ($0.10/$0.25) - 2009/07/01 1:39:57 ET
Table 'xPn6TS/y/OWkX7Qa+MUuKA' 6-max Seat #5 is the button
Seat 1: JFIAqU8lCZ0vWwEl4bdGsg ($42.15 in chips) 
Seat 2: buyjetgNT1McXtdaP4zynA ($32.85 in chips) 
Seat 3: q6WfTUAD9mowIP63ASq2Dg ($25.90 in chips) 
Seat 4: SS/yfeArhULzIcOPe8MdPg ($25.90 in chips) 
Seat 5: lquriepNQBhDV5P1SWHhnA ($25.45 in chips) 
Seat 6: DihMHaz4WNETH1bPDe13kA ($25 in chips) 
DihMHaz4WNETH1bPDe13kA: posts small blind $0.10
JFIAqU8lCZ0vWwEl4bdGsg: posts big blind $0.25
*** HOLE CARDS ***
buyjetgNT1McXtdaP4zynA: raises $0.75 to $1
q6WfTUAD9mowIP63ASq2Dg: folds 
SS/yfeArhULzIcOPe8MdPg: folds 
lquriepNQBhDV5P1SWHhnA: folds 
DihMHaz4WNETH1bPDe13kA: folds 
JFIAqU8lCZ0vWwEl4bdGsg: calls $0.75
*** FLOP *** [Ah 2c 3c]
JFIAqU8lCZ0vWwEl4bdGsg: bets $2
buyjetgNT1McXtdaP4zynA: folds 
Uncalled bet ($2) returned to JFIAqU8lCZ0vWwEl4bdGsg
JFIAqU8lCZ0vWwEl4bdGsg collected $2 from pot
JFIAqU8lCZ0vWwEl4bdGsg: doesn't show hand 
*** SUMMARY ***
Total pot $2.10 | Rake $0.10 
Board [Ah 2c 3c]
Seat 1: JFIAqU8lCZ0vWwEl4bdGsg (big blind) collected ($2)
Seat 2: buyjetgNT1McXtdaP4zynA folded on the Flop
Seat 3: q6WfTUAD9mowIP63ASq2Dg folded before Flop (didn't bet)
Seat 4: SS/yfeArhULzIcOPe8MdPg folded before Flop (didn't bet)
Seat 5: lquriepNQBhDV5P1SWHhnA (button) folded before Flop (didn't bet)
Seat 6: DihMHaz4WNETH1bPDe13kA (small blind) folded before Flop




PokerStars Game #59941586834:  Hold'em No Limit ($0.10/$0.25) - 2009/07/01 1:39:57 ET
Table 'LG9H161ZAHDkOww+ih3Ptg' 6-max Seat #2 is the button
Seat 1: avl8CO/tc0F6eVSiB/KNRA ($25.60 in chips) 
Seat 2: kwsRmpZ1ZaLooISs+zfyKg ($25.45 in chips) 
Seat 3: 5Evvx7UYqXTBuvIc/9s/hA ($16.80 in chips) 
Seat 4: 0C28L4/59aRNtHoBhqTcLg ($59.05 in chips) 
Seat 5: lYjWCpfCxX2kgcHY3v4Yow ($29.65 in chips) 
Seat 6: v8m8XHovI5tqEA9mvplDSw ($26.80 in chips) 
5Evvx7UYqXTBuvIc/9s/hA: posts small blind $0.10
0C28L4/59aRNtHoBhqTcLg: posts big blind $0.25
*** HOLE CARDS ***
lYjWCpfCxX2kgcHY3v4Yow: folds 
v8m8XHovI5tqEA9mvplDSw: raises $0.75 to $1
avl8CO/tc0F6eVSiB/KNRA: folds 
kwsRmpZ1ZaLooISs+zfyKg: folds 
5Evvx7UYqXTBuvIc/9s/hA said, "no problem sorry"
5Evvx7UYqXTBuvIc/9s/hA: folds 
0C28L4/59aRNtHoBhqTcLg: folds 
Uncalled bet ($0.75) returned to v8m8XHovI5tqEA9mvplDSw
v8m8XHovI5tqEA9mvplDSw collected $0.60 from pot
v8m8XHovI5tqEA9mvplDSw: doesn't show hand 
*** SUMMARY ***
Total pot $0.60 | Rake $0 
Seat 1: avl8CO/tc0F6eVSiB/KNRA folded before Flop (didn't bet)
Seat 2: kwsRmpZ1ZaLooISs+zfyKg (button) folded before Flop (didn't bet)
Seat 3: 5Evvx7UYqXTBuvIc/9s/hA (small blind) folded before Flop
Seat 4: 0C28L4/59aRNtHoBhqTcLg (big blind) folded before Flop
Seat 5: lYjWCpfCxX2kgcHY3v4Yow folded before Flop (didn't bet)
Seat 6: v8m8XHovI5tqEA9mvplDSw collected ($0.60)




PokerStars Game #59941586750:  Hold'em No Limit ($0.10/$0.25) - 2009/07/01 1:39:57 ET
Table 'sgdCtiuCu2BDZhyDi6RzTA' 6-max Seat #4 is the button
Seat 1: 3zD3qLXT1bEffAoWGnc7wg ($31.55 in chips) 
Seat 2: XD1i5m5PvBDnRzJaG/vINw ($24.40 in chips) 
Seat 3: eL3+wCBjFGfQ5FMdIZihwA ($26.35 in chips) 
Seat 4: rVKEgilmMX+EkKzDVvhmxA ($9.95 in chips) 
Seat 5: 0tQitW75xfmVWKldYHjmOQ ($7.15 in chips) 
Seat 6: KODslGU8ikCYS0/29dUkhg ($31.45 in chips) 
0tQitW75xfmVWKldYHjmOQ: posts small blind $0.10
KODslGU8ikCYS0/29dUkhg: posts big blind $0.25
*** HOLE CARDS ***
3zD3qLXT1bEffAoWGnc7wg: folds 
XD1i5m5PvBDnRzJaG/vINw: folds 
eL3+wCBjFGfQ5FMdIZihwA: folds 
rVKEgilmMX+EkKzDVvhmxA: calls $0.25
0tQitW75xfmVWKldYHjmOQ: calls $0.15
KODslGU8ikCYS0/29dUkhg: checks 
*** FLOP *** [8c Kc Jc]
0tQitW75xfmVWKldYHjmOQ: checks 
KODslGU8ikCYS0/29dUkhg: checks 
rVKEgilmMX+EkKzDVvhmxA: checks 
*** TURN *** [8c Kc Jc] [3s]
0tQitW75xfmVWKldYHjmOQ: bets $0.75
KODslGU8ikCYS0/29dUkhg: raises $0.75 to $1.50
rVKEgilmMX+EkKzDVvhmxA: folds 
0tQitW75xfmVWKldYHjmOQ: folds 
Uncalled bet ($0.75) returned to KODslGU8ikCYS0/29dUkhg
KODslGU8ikCYS0/29dUkhg collected $2.15 from pot
KODslGU8ikCYS0/29dUkhg: doesn't show hand 
*** SUMMARY ***
Total pot $2.25 | Rake $0.10 
Board [8c Kc Jc 3s]
Seat 1: 3zD3qLXT1bEffAoWGnc7wg folded before Flop (didn't bet)
Seat 2: XD1i5m5PvBDnRzJaG/vINw folded before Flop (didn't bet)
Seat 3: eL3+wCBjFGfQ5FMdIZihwA folded before Flop (didn't bet)
Seat 4: rVKEgilmMX+EkKzDVvhmxA (button) folded on the Turn
Seat 5: 0tQitW75xfmVWKldYHjmOQ (small blind) folded on the Turn
Seat 6: KODslGU8ikCYS0/29dUkhg (big blind) collected ($2.15)




PokerStars Game #59941586498:  Hold'em No Limit ($0.10/$0.25) - 2009/07/01 1:39:57 ET
Table 'QzXakDK7ZHNjgIpoUFGSKQ' 9-max Seat #5 is the button
Seat 1: w1ukf8uPa4+WH561TtVRxA ($29.05 in chips) 
Seat 3: eK8qa6EPcH2zhtbmWSvc9g ($25.65 in chips) 
Seat 4: 12pxJGeALcKLTBryE6kFxA ($12.25 in chips) 
Seat 5: MtVtHDqIJTyUcXkRBBDIVA ($25 in chips) 
Seat 7: wGigCmBR/9XWkPpvYos3aQ ($30.80 in chips) 
Seat 9: lwrOE80tuooHfIBx/4LUSw ($25.30 in chips) 
gehe91e0IyVT0QU/XBkEyg will be allowed to play after the button
wGigCmBR/9XWkPpvYos3aQ: posts small blind $0.10
3PmVnC/15cl4oyI1TKIt4g: is sitting out 
lwrOE80tuooHfIBx/4LUSw: posts big blind $0.25
QEbIGci+itdw+re8RM5fZA: sits out 
*** HOLE CARDS ***
3PmVnC/15cl4oyI1TKIt4g leaves the table
w1ukf8uPa4+WH561TtVRxA: folds 
eK8qa6EPcH2zhtbmWSvc9g: folds 
12pxJGeALcKLTBryE6kFxA: folds 
MtVtHDqIJTyUcXkRBBDIVA: folds 
wGigCmBR/9XWkPpvYos3aQ: raises $0.65 to $0.90
lwrOE80tuooHfIBx/4LUSw: calls $0.65
*** FLOP *** [9d Jc Ac]
wGigCmBR/9XWkPpvYos3aQ: checks 
lwrOE80tuooHfIBx/4LUSw: checks 
*** TURN *** [9d Jc Ac] [Kd]
wGigCmBR/9XWkPpvYos3aQ: checks 
lwrOE80tuooHfIBx/4LUSw: bets $1
wGigCmBR/9XWkPpvYos3aQ: folds 
Uncalled bet ($1) returned to lwrOE80tuooHfIBx/4LUSw
lwrOE80tuooHfIBx/4LUSw collected $1.75 from pot
lwrOE80tuooHfIBx/4LUSw: doesn't show hand 
*** SUMMARY ***
Total pot $1.80 | Rake $0.05 
Board [9d Jc Ac Kd]
Seat 1: w1ukf8uPa4+WH561TtVRxA folded before Flop (didn't bet)
Seat 3: eK8qa6EPcH2zhtbmWSvc9g folded before Flop (didn't bet)
Seat 4: 12pxJGeALcKLTBryE6kFxA folded before Flop (didn't bet)
Seat 5: MtVtHDqIJTyUcXkRBBDIVA (button) folded before Flop (didn't bet)
Seat 7: wGigCmBR/9XWkPpvYos3aQ (small blind) folded on the Turn
Seat 9: lwrOE80tuooHfIBx/4LUSw (big blind) collected ($1.75)




PokerStars Game #59941587288:  Hold'em No Limit ($0.10/$0.25) - 2009/07/01 1:39:58 ET
Table 'Ok3oDLIsTc2+KxPcI0bAOA' 6-max Seat #5 is the button
Seat 1: agQm3ugZ3qSVYNgNu1ddeA ($42.10 in chips) 
Seat 2: DE9hRlt14g+JdsRQ4wT7hg ($40.80 in chips) 
Seat 3: lquriepNQBhDV5P1SWHhnA ($26.60 in chips) 
Seat 4: LJI7A1YgDM7hgh7o56+ReQ ($38.50 in chips) 
Seat 5: DFi/Lzkjsfv8QswS80JX9Q ($28.25 in chips) 
Seat 6: Hsvkc0/G2VV78oVmWYXecw ($5.05 in chips) 
Hsvkc0/G2VV78oVmWYXecw: posts small blind $0.10
agQm3ugZ3qSVYNgNu1ddeA: posts big blind $0.25
*** HOLE CARDS ***
DE9hRlt14g+JdsRQ4wT7hg: folds 
DE9hRlt14g+JdsRQ4wT7hg leaves the table
lquriepNQBhDV5P1SWHhnA: folds 
LJI7A1YgDM7hgh7o56+ReQ: folds 
DFi/Lzkjsfv8QswS80JX9Q: folds 
Hsvkc0/G2VV78oVmWYXecw: raises $0.50 to $0.75
agQm3ugZ3qSVYNgNu1ddeA: folds 
Uncalled bet ($0.50) returned to Hsvkc0/G2VV78oVmWYXecw
Hsvkc0/G2VV78oVmWYXecw collected $0.50 from pot
Hsvkc0/G2VV78oVmWYXecw: doesn't show hand 
*** SUMMARY ***
Total pot $0.50 | Rake $0 
Seat 1: agQm3ugZ3qSVYNgNu1ddeA (big blind) folded before Flop
Seat 2: DE9hRlt14g+JdsRQ4wT7hg folded before Flop (didn't bet)
Seat 3: lquriepNQBhDV5P1SWHhnA folded before Flop (didn't bet)
Seat 4: LJI7A1YgDM7hgh7o56+ReQ folded before Flop (didn't bet)
Seat 5: DFi/Lzkjsfv8QswS80JX9Q (button) folded before Flop (didn't bet)
Seat 6: Hsvkc0/G2VV78oVmWYXecw (small blind) collected ($0.50)




PokerStars Game #59941587442:  Hold'em No Limit ($0.10/$0.25) - 2009/07/01 1:39:58 ET
Table 'rpIHGyt2QpgQc5bvptAvDQ' 9-max Seat #3 is the button
Seat 3: OzXv12vW3/jO5rPU5mJHQg ($5.10 in chips) 
Seat 5: z2SmIaQ3+5n/eY1BN5HgPg ($15.25 in chips) 
Seat 6: Mq1ESwxx3LEsA4HjKKjU3Q ($15.75 in chips) 
z2SmIaQ3+5n/eY1BN5HgPg: posts small blind $0.10
Mq1ESwxx3LEsA4HjKKjU3Q: posts big blind $0.25
*** HOLE CARDS ***
OzXv12vW3/jO5rPU5mJHQg: calls $0.25
z2SmIaQ3+5n/eY1BN5HgPg: folds 
ASXDkj9tmvF/T2AsNuxg7g joins the table at seat #4 
Mq1ESwxx3LEsA4HjKKjU3Q: checks 
*** FLOP *** [3h 4h 8h]
Mq1ESwxx3LEsA4HjKKjU3Q: checks 
OzXv12vW3/jO5rPU5mJHQg: checks 
*** TURN *** [3h 4h 8h] [Ts]
Mq1ESwxx3LEsA4HjKKjU3Q: bets $0.25
OzXv12vW3/jO5rPU5mJHQg: calls $0.25
*** RIVER *** [3h 4h 8h Ts] [Qh]
Mq1ESwxx3LEsA4HjKKjU3Q: checks 
OzXv12vW3/jO5rPU5mJHQg: bets $1
Mq1ESwxx3LEsA4HjKKjU3Q: folds 
Uncalled bet ($1) returned to OzXv12vW3/jO5rPU5mJHQg
OzXv12vW3/jO5rPU5mJHQg collected $1.05 from pot
*** SUMMARY ***
Total pot $1.10 | Rake $0.05 
Board [3h 4h 8h Ts Qh]
Seat 3: OzXv12vW3/jO5rPU5mJHQg (button) collected ($1.05)
Seat 5: z2SmIaQ3+5n/eY1BN5HgPg (small blind) folded before Flop
Seat 6: Mq1ESwxx3LEsA4HjKKjU3Q (big blind) folded on the River




PokerStars Game #59941587816:  Hold'em No Limit ($0.10/$0.25) - 2009/07/01 1:39:59 ET
Table 'HbNAGS1OJWQKyfk7UfrYyw' 9-max Seat #2 is the button
Seat 1: 7cv+9Zc9HIQHNvYsMfV3uA ($25 in chips) 
Seat 2: fjwM06E3HzjUrynPRQi31Q ($5 in chips) 
Seat 7: n+stbTneifqFNME+tpoGrw ($25 in chips) 
n+stbTneifqFNME+tpoGrw: posts small blind $0.10
7cv+9Zc9HIQHNvYsMfV3uA: posts big blind $0.25
*** HOLE CARDS ***
fjwM06E3HzjUrynPRQi31Q: calls $0.25
n+stbTneifqFNME+tpoGrw: calls $0.15
7cv+9Zc9HIQHNvYsMfV3uA: checks 
*** FLOP *** [Js 3d 7h]
n+stbTneifqFNME+tpoGrw: checks 
7cv+9Zc9HIQHNvYsMfV3uA: checks 
fjwM06E3HzjUrynPRQi31Q: checks 
*** TURN *** [Js 3d 7h] [Kc]
n+stbTneifqFNME+tpoGrw: checks 
7cv+9Zc9HIQHNvYsMfV3uA: checks 
fjwM06E3HzjUrynPRQi31Q: checks 
*** RIVER *** [Js 3d 7h Kc] [7c]
n+stbTneifqFNME+tpoGrw: bets $0.25
7cv+9Zc9HIQHNvYsMfV3uA: folds 
fjwM06E3HzjUrynPRQi31Q: folds 
Uncalled bet ($0.25) returned to n+stbTneifqFNME+tpoGrw
n+stbTneifqFNME+tpoGrw collected $0.75 from pot
n+stbTneifqFNME+tpoGrw: shows [3c 5s] (two pair, Sevens and Threes)
*** SUMMARY ***
Total pot $0.75 | Rake $0 
Board [Js 3d 7h Kc 7c]
Seat 1: 7cv+9Zc9HIQHNvYsMfV3uA (big blind) folded on the River
Seat 2: fjwM06E3HzjUrynPRQi31Q (button) folded on the River
Seat 7: n+stbTneifqFNME+tpoGrw (small blind) collected ($0.75)




PokerStars Game #59941587882:  Hold'em No Limit ($0.10/$0.25) - 2009/07/01 1:39:59 ET
Table 'pAhiNHs/spaABQia+7gWNQ' 9-max Seat #7 is the button
Seat 1: ipgcO7Pa6LC8XWpVttZfnA ($5 in chips) 
Seat 2: dfNim92Z6XK1/h5SFW5vDg ($25 in chips) 
Seat 3: xEQxarad8/T4jJdpZy5LGw ($35.40 in chips) 
Seat 5: OlPJsgR4xypSg/w1z7Gyvw ($33.15 in chips) 
Seat 6: oLa/tXLfSLLB28mcLGrxcg ($24.25 in chips) 
Seat 7: +WTkVY3GeLxqGQBbMZQiWQ ($5.55 in chips) 
Seat 9: zgi+EUykT/pZQpoUG6+oEg ($4.75 in chips) 
zgi+EUykT/pZQpoUG6+oEg: posts small blind $0.10
ipgcO7Pa6LC8XWpVttZfnA: posts big blind $0.25
Dr.Hibbert55: sits out 
*** HOLE CARDS ***
dfNim92Z6XK1/h5SFW5vDg: folds 
xEQxarad8/T4jJdpZy5LGw: folds 
OlPJsgR4xypSg/w1z7Gyvw: folds 
oLa/tXLfSLLB28mcLGrxcg: folds 
+WTkVY3GeLxqGQBbMZQiWQ: raises $0.75 to $1
zgi+EUykT/pZQpoUG6+oEg: folds 
ipgcO7Pa6LC8XWpVttZfnA: folds 
Uncalled bet ($0.75) returned to +WTkVY3GeLxqGQBbMZQiWQ
+WTkVY3GeLxqGQBbMZQiWQ collected $0.60 from pot
+WTkVY3GeLxqGQBbMZQiWQ: doesn't show hand 
*** SUMMARY ***
Total pot $0.60 | Rake $0 
Seat 1: ipgcO7Pa6LC8XWpVttZfnA (big blind) folded before Flop
Seat 2: dfNim92Z6XK1/h5SFW5vDg folded before Flop (didn't bet)
Seat 3: xEQxarad8/T4jJdpZy5LGw folded before Flop (didn't bet)
Seat 5: OlPJsgR4xypSg/w1z7Gyvw folded before Flop (didn't bet)
Seat 6: oLa/tXLfSLLB28mcLGrxcg folded before Flop (didn't bet)
Seat 7: +WTkVY3GeLxqGQBbMZQiWQ (button) collected ($0.60)
Seat 9: zgi+EUykT/pZQpoUG6+oEg (small blind) folded before Flop




PokerStars Game #59941587818:  Hold'em No Limit ($0.10/$0.25) - 2009/07/01 1:39:59 ET
Table 'i8VqsSY3xDtJ63IHleN8+A' 9-max Seat #3 is the button
Seat 1: Mh2r9hTeTEDnh19sRZtW3g ($4.25 in chips) 
Seat 2: CT7Xj/V/O5rBlhtt+RZeFQ ($25 in chips) 
Seat 3: 4awUyiDYTgylQKXZ9faBVA ($29.15 in chips) 
Seat 4: X78b5v/uhqeXXoAijbw/yg ($26.85 in chips) 
Seat 6: 3PmVnC/15cl4oyI1TKIt4g ($5.15 in chips) 
Seat 8: CvL9Ch1HYCVbTsfpNucitg ($5.35 in chips) 
Seat 9: tLcDklc2rBORNfixyRfVfw ($25 in chips) 
X78b5v/uhqeXXoAijbw/yg: posts small blind $0.10
st9jtdNbm1W5GfBwRaCVqQ: is sitting out 
st9jtdNbm1W5GfBwRaCVqQ leaves the table
3PmVnC/15cl4oyI1TKIt4g: posts big blind $0.25
bXpVeaSTPBFSPJmeXxO7nw: sits out 
*** HOLE CARDS ***
CvL9Ch1HYCVbTsfpNucitg: folds 
tLcDklc2rBORNfixyRfVfw: folds 
Mh2r9hTeTEDnh19sRZtW3g: folds 
CT7Xj/V/O5rBlhtt+RZeFQ: folds 
CT7Xj/V/O5rBlhtt+RZeFQ leaves the table
4awUyiDYTgylQKXZ9faBVA: folds 
X78b5v/uhqeXXoAijbw/yg: folds 
Uncalled bet ($0.15) returned to 3PmVnC/15cl4oyI1TKIt4g
3PmVnC/15cl4oyI1TKIt4g collected $0.20 from pot
3PmVnC/15cl4oyI1TKIt4g: doesn't show hand 
*** SUMMARY ***
Total pot $0.20 | Rake $0 
Seat 1: Mh2r9hTeTEDnh19sRZtW3g folded before Flop (didn't bet)
Seat 2: CT7Xj/V/O5rBlhtt+RZeFQ folded before Flop (didn't bet)
Seat 3: 4awUyiDYTgylQKXZ9faBVA (button) folded before Flop (didn't bet)
Seat 4: X78b5v/uhqeXXoAijbw/yg (small blind) folded before Flop
Seat 6: 3PmVnC/15cl4oyI1TKIt4g (big blind) collected ($0.20)
Seat 8: CvL9Ch1HYCVbTsfpNucitg folded before Flop (didn't bet)
Seat 9: tLcDklc2rBORNfixyRfVfw folded before Flop (didn't bet)




PokerStars Game #59941587880:  Hold'em No Limit ($0.10/$0.25) - 2009/07/01 1:39:59 ET
Table '63h13e5p7cWe02rClZ1CHw' 6-max Seat #6 is the button
Seat 1: pokjbbEcXXPlADXdSGHtZw ($22 in chips) 
Seat 2: k9nHZTHt8hYhYRcW8NTb4g ($26.80 in chips) 
Seat 3: mFv3iBCtrw9XfCDRB0d46Q ($5.75 in chips) 
Seat 4: xrf8tAXKQHG99HixCot1Iw ($23 in chips) 
Seat 5: iyZxqznXjv3vtvOJymkoLQ ($45.15 in chips) 
Seat 6: mfrkWA3PTeYPkbO6hi98Aw ($38.45 in chips) 
pokjbbEcXXPlADXdSGHtZw: posts small blind $0.10
k9nHZTHt8hYhYRcW8NTb4g: posts big blind $0.25
*** HOLE CARDS ***
mFv3iBCtrw9XfCDRB0d46Q: folds 
xrf8tAXKQHG99HixCot1Iw: folds 
iyZxqznXjv3vtvOJymkoLQ: folds 
mfrkWA3PTeYPkbO6hi98Aw: folds 
pokjbbEcXXPlADXdSGHtZw: calls $0.15
k9nHZTHt8hYhYRcW8NTb4g: checks 
*** FLOP *** [Kd Qs 9h]
pokjbbEcXXPlADXdSGHtZw: checks 
k9nHZTHt8hYhYRcW8NTb4g: bets $0.25
pokjbbEcXXPlADXdSGHtZw: calls $0.25
*** TURN *** [Kd Qs 9h] [7d]
pokjbbEcXXPlADXdSGHtZw: checks 
k9nHZTHt8hYhYRcW8NTb4g: bets $0.50
pokjbbEcXXPlADXdSGHtZw: calls $0.50
*** RIVER *** [Kd Qs 9h 7d] [4d]
pokjbbEcXXPlADXdSGHtZw: checks 
k9nHZTHt8hYhYRcW8NTb4g: bets $1
pokjbbEcXXPlADXdSGHtZw: folds 
Uncalled bet ($1) returned to k9nHZTHt8hYhYRcW8NTb4g
k9nHZTHt8hYhYRcW8NTb4g collected $1.95 from pot
k9nHZTHt8hYhYRcW8NTb4g: doesn't show hand 
*** SUMMARY ***
Total pot $2 | Rake $0.05 
Board [Kd Qs 9h 7d 4d]
Seat 1: pokjbbEcXXPlADXdSGHtZw (small blind) folded on the River
Seat 2: k9nHZTHt8hYhYRcW8NTb4g (big blind) collected ($1.95)
Seat 3: mFv3iBCtrw9XfCDRB0d46Q folded before Flop (didn't bet)
Seat 4: xrf8tAXKQHG99HixCot1Iw folded before Flop (didn't bet)
Seat 5: iyZxqznXjv3vtvOJymkoLQ folded before Flop (didn't bet)
Seat 6: mfrkWA3PTeYPkbO6hi98Aw (button) folded before Flop (didn't bet)




PokerStars Game #59941588048:  Hold'em No Limit ($0.10/$0.25) - 2009/07/01 1:39:59 ET
Table 'mk323gviqdkOY5Aek/1EWg' 6-max Seat #1 is the button
Seat 1: L3/N/gliETan8N5Gim5h4Q ($25.40 in chips) 
Seat 2: GC/9yVD59DUCX7hUI7gcLw ($56.15 in chips) 
Seat 3: NuqYPwTLZYQhxOoVK3Yqlw ($24.65 in chips) 
Seat 4: +baiVgI/ETnBARLe5mARCw ($13.15 in chips) 
Seat 5: kjYRzIfvZNNflYMYRkkSVA ($26.15 in chips) 
Seat 6: KkXSr5xFjxLSD3wtAvT+WQ ($8.80 in chips) 
GC/9yVD59DUCX7hUI7gcLw: posts small blind $0.10
NuqYPwTLZYQhxOoVK3Yqlw: posts big blind $0.25
*** HOLE CARDS ***
+baiVgI/ETnBARLe5mARCw: folds 
kjYRzIfvZNNflYMYRkkSVA: folds 
KkXSr5xFjxLSD3wtAvT+WQ: folds 
L3/N/gliETan8N5Gim5h4Q: raises $0.50 to $0.75
GC/9yVD59DUCX7hUI7gcLw: folds 
NuqYPwTLZYQhxOoVK3Yqlw: folds 
Uncalled bet ($0.50) returned to L3/N/gliETan8N5Gim5h4Q
L3/N/gliETan8N5Gim5h4Q collected $0.60 from pot
L3/N/gliETan8N5Gim5h4Q: doesn't show hand 
*** SUMMARY ***
Total pot $0.60 | Rake $0 
Seat 1: L3/N/gliETan8N5Gim5h4Q (button) collected ($0.60)
Seat 2: GC/9yVD59DUCX7hUI7gcLw (small blind) folded before Flop
Seat 3: NuqYPwTLZYQhxOoVK3Yqlw (big blind) folded before Flop
Seat 4: +baiVgI/ETnBARLe5mARCw folded before Flop (didn't bet)
Seat 5: kjYRzIfvZNNflYMYRkkSVA folded before Flop (didn't bet)
Seat 6: KkXSr5xFjxLSD3wtAvT+WQ folded before Flop (didn't bet)




PokerStars Game #59941587998:  Hold'em No Limit ($0.10/$0.25) - 2009/07/01 1:39:59 ET
Table 'Jj2eLzVCUVAGBmM+Og79iQ' 9-max Seat #7 is the button
Seat 1: /XMgGtJ7mcWfe5s7McY9kw ($58.35 in chips) 
Seat 2: oMxwMC7+uAsJudeUN6aP0A ($14.30 in chips) 
Seat 3: HPEB+AtKw1+C/cxU0o1ciw ($25 in chips) 
Seat 4: aNpwfA31EREwO+ar4XzBCw ($45.25 in chips) 
Seat 5: UOx+/JnFB2Or6ZU9oasIlQ ($22.25 in chips) 
Seat 6: jZURAM/dgGCX+5lATlZugw ($14.55 in chips) 
Seat 7: K0b5wNInj6hUGRr6yzKFtw ($31.20 in chips) 
Seat 8: H5Se03ZqSX7tbULXur2MAg ($20.70 in chips) 
Seat 9: wU1LtrccnZo6PYKhlJ6ElQ ($34.25 in chips) 
H5Se03ZqSX7tbULXur2MAg: posts small blind $0.10
wU1LtrccnZo6PYKhlJ6ElQ: posts big blind $0.25
*** HOLE CARDS ***
/XMgGtJ7mcWfe5s7McY9kw: folds 
oMxwMC7+uAsJudeUN6aP0A: folds 
HPEB+AtKw1+C/cxU0o1ciw: folds 
aNpwfA31EREwO+ar4XzBCw: folds 
UOx+/JnFB2Or6ZU9oasIlQ: folds 
jZURAM/dgGCX+5lATlZugw: folds 
K0b5wNInj6hUGRr6yzKFtw: raises $0.75 to $1
H5Se03ZqSX7tbULXur2MAg: folds 
wU1LtrccnZo6PYKhlJ6ElQ: calls $0.75
*** FLOP *** [Js Qs 9d]
wU1LtrccnZo6PYKhlJ6ElQ: checks 
oMxwMC7+uAsJudeUN6aP0A is disconnected 
K0b5wNInj6hUGRr6yzKFtw: bets $2
wU1LtrccnZo6PYKhlJ6ElQ: calls $2
*** TURN *** [Js Qs 9d] [4c]
oMxwMC7+uAsJudeUN6aP0A is connected 
wU1LtrccnZo6PYKhlJ6ElQ: checks 
K0b5wNInj6hUGRr6yzKFtw: bets $5
wU1LtrccnZo6PYKhlJ6ElQ: calls $5
*** RIVER *** [Js Qs 9d 4c] [3d]
wU1LtrccnZo6PYKhlJ6ElQ: checks 
K0b5wNInj6hUGRr6yzKFtw: bets $23.20 and is all-in
oMxwMC7+uAsJudeUN6aP0A is disconnected 
oMxwMC7+uAsJudeUN6aP0A is connected 
wU1LtrccnZo6PYKhlJ6ElQ: calls $23.20
*** SHOW DOWN ***
K0b5wNInj6hUGRr6yzKFtw: shows [8h Tc] (a straight, Eight to Queen)
wU1LtrccnZo6PYKhlJ6ElQ: mucks hand 
K0b5wNInj6hUGRr6yzKFtw collected $59.50 from pot
*** SUMMARY ***
Total pot $62.50 | Rake $3 
Board [Js Qs 9d 4c 3d]
Seat 1: /XMgGtJ7mcWfe5s7McY9kw folded before Flop (didn't bet)
Seat 2: oMxwMC7+uAsJudeUN6aP0A folded before Flop (didn't bet)
Seat 3: HPEB+AtKw1+C/cxU0o1ciw folded before Flop (didn't bet)
Seat 4: aNpwfA31EREwO+ar4XzBCw folded before Flop (didn't bet)
Seat 5: UOx+/JnFB2Or6ZU9oasIlQ folded before Flop (didn't bet)
Seat 6: jZURAM/dgGCX+5lATlZugw folded before Flop (didn't bet)
Seat 7: K0b5wNInj6hUGRr6yzKFtw (button) showed [8h Tc] and won ($59.50) with a straight, Eight to Queen
Seat 8: H5Se03ZqSX7tbULXur2MAg (small blind) folded before Flop
Seat 9: wU1LtrccnZo6PYKhlJ6ElQ (big blind) mucked




PokerStars Game #59941587820:  Hold'em No Limit ($0.10/$0.25) - 2009/07/01 1:39:59 ET
Table '+2VxGVfkEqJ1AYfQy/JH2w' 6-max Seat #4 is the button
Seat 2: qllppsCmUqovlriIWCeM/g ($1.95 in chips) 
Seat 3: NndRCAk4vU5JGDhTyy5LZg ($15.15 in chips) 
Seat 4: y+a/yGW/Jy4bPJFnaeTz5w ($16.95 in chips) 
Seat 5: XD1i5m5PvBDnRzJaG/vINw ($22.90 in chips) 
Seat 6: L3/N/gliETan8N5Gim5h4Q ($25 in chips) 
XD1i5m5PvBDnRzJaG/vINw: posts small blind $0.10
L3/N/gliETan8N5Gim5h4Q: posts big blind $0.25
if4dh6jhJXeN3/qd3qCp9g: sits out 
*** HOLE CARDS ***
qllppsCmUqovlriIWCeM/g: raises $1.70 to $1.95 and is all-in
NndRCAk4vU5JGDhTyy5LZg: calls $1.95
y+a/yGW/Jy4bPJFnaeTz5w: folds 
XD1i5m5PvBDnRzJaG/vINw: folds 
L3/N/gliETan8N5Gim5h4Q: folds 
*** FLOP *** [7s Kh 9s]
*** TURN *** [7s Kh 9s] [9c]
*** RIVER *** [7s Kh 9s 9c] [As]
*** SHOW DOWN ***
qllppsCmUqovlriIWCeM/g: shows [Qs Ac] (two pair, Aces and Nines)
NndRCAk4vU5JGDhTyy5LZg: mucks hand 
qllppsCmUqovlriIWCeM/g collected $4.05 from pot
*** SUMMARY ***
Total pot $4.25 | Rake $0.20 
Board [7s Kh 9s 9c As]
Seat 2: qllppsCmUqovlriIWCeM/g showed [Qs Ac] and won ($4.05) with two pair, Aces and Nines
Seat 3: NndRCAk4vU5JGDhTyy5LZg mucked
Seat 4: y+a/yGW/Jy4bPJFnaeTz5w (button) folded before Flop (didn't bet)
Seat 5: XD1i5m5PvBDnRzJaG/vINw (small blind) folded before Flop
Seat 6: L3/N/gliETan8N5Gim5h4Q (big blind) folded before Flop




PokerStars Game #59941587630:  Hold'em No Limit ($0.10/$0.25) - 2009/07/01 1:39:59 ET
Table 'BpNkESDX1ip9c0K1hb5h7A' 6-max Seat #5 is the button
Seat 2: g+5jEA4Xq9vcMOfdFYNuFA ($10.70 in chips) 
Seat 3: fZQg9veL7Dd/Z04ZTjC+wQ ($25 in chips) 
Seat 4: kG34n23qFQA3nzdOJTQ1dA ($25.55 in chips) 
Seat 5: L3/N/gliETan8N5Gim5h4Q ($25.50 in chips) 
Seat 6: 8EEqTTh7T1q48sYDqbI2Xg ($22 in chips) 
8EEqTTh7T1q48sYDqbI2Xg: posts small blind $0.10
g+5jEA4Xq9vcMOfdFYNuFA: posts big blind $0.25
*** HOLE CARDS ***
fZQg9veL7Dd/Z04ZTjC+wQ: raises $0.50 to $0.75
kG34n23qFQA3nzdOJTQ1dA: folds 
L3/N/gliETan8N5Gim5h4Q: folds 
8EEqTTh7T1q48sYDqbI2Xg: folds 
g+5jEA4Xq9vcMOfdFYNuFA: folds 
Uncalled bet ($0.50) returned to fZQg9veL7Dd/Z04ZTjC+wQ
fZQg9veL7Dd/Z04ZTjC+wQ collected $0.60 from pot
fZQg9veL7Dd/Z04ZTjC+wQ: doesn't show hand 
*** SUMMARY ***
Total pot $0.60 | Rake $0 
Seat 2: g+5jEA4Xq9vcMOfdFYNuFA (big blind) folded before Flop
Seat 3: fZQg9veL7Dd/Z04ZTjC+wQ collected ($0.60)
Seat 4: kG34n23qFQA3nzdOJTQ1dA folded before Flop (didn't bet)
Seat 5: L3/N/gliETan8N5Gim5h4Q (button) folded before Flop (didn't bet)
Seat 6: 8EEqTTh7T1q48sYDqbI2Xg (small blind) folded before Flop




PokerStars Game #59941588062:  Hold'em No Limit ($0.10/$0.25) - 2009/07/01 1:39:59 ET
Table 'mVdLgAdN9rGe6mMwSrDdGQ' 6-max Seat #3 is the button
Seat 3: +baiVgI/ETnBARLe5mARCw ($11.60 in chips) 
Seat 4: scNSjC6yyKvvfklSkuzLrw ($18.45 in chips) 
Seat 5: +TMG/MBWpiEnc9t7i07eTA ($18.25 in chips) 
Seat 6: DihMHaz4WNETH1bPDe13kA ($47.55 in chips) 
scNSjC6yyKvvfklSkuzLrw: posts small blind $0.10
+TMG/MBWpiEnc9t7i07eTA: posts big blind $0.25
OyJ0KTHA5cwh0/yCo1/rdA joins the table at seat #1 
crazyconflit: sits out 
*** HOLE CARDS ***
DihMHaz4WNETH1bPDe13kA: folds 
+baiVgI/ETnBARLe5mARCw: calls $0.25
scNSjC6yyKvvfklSkuzLrw: raises $0.50 to $0.75
+TMG/MBWpiEnc9t7i07eTA: calls $0.50
+baiVgI/ETnBARLe5mARCw: folds 
*** FLOP *** [4d Ad 9h]
scNSjC6yyKvvfklSkuzLrw: checks 
+TMG/MBWpiEnc9t7i07eTA: checks 
*** TURN *** [4d Ad 9h] [Ts]
scNSjC6yyKvvfklSkuzLrw: checks 
+TMG/MBWpiEnc9t7i07eTA: checks 
*** RIVER *** [4d Ad 9h Ts] [2s]
scNSjC6yyKvvfklSkuzLrw: bets $0.50
+TMG/MBWpiEnc9t7i07eTA: raises $0.50 to $1
scNSjC6yyKvvfklSkuzLrw: folds 
Uncalled bet ($0.50) returned to +TMG/MBWpiEnc9t7i07eTA
+TMG/MBWpiEnc9t7i07eTA collected $2.65 from pot
+TMG/MBWpiEnc9t7i07eTA: doesn't show hand 
*** SUMMARY ***
Total pot $2.75 | Rake $0.10 
Board [4d Ad 9h Ts 2s]
Seat 3: +baiVgI/ETnBARLe5mARCw (button) folded before Flop
Seat 4: scNSjC6yyKvvfklSkuzLrw (small blind) folded on the River
Seat 5: +TMG/MBWpiEnc9t7i07eTA (big blind) collected ($2.65)
Seat 6: DihMHaz4WNETH1bPDe13kA folded before Flop (didn't bet)




PokerStars Game #59941588632:  Hold'em No Limit ($0.10/$0.25) - 2009/07/01 1:40:00 ET
Table 'tErGGDyESv/0llKumVeZuQ' 9-max Seat #3 is the button
Seat 2: pN3IHvAKm2fz+sTRARTcrg ($24.65 in chips) 
Seat 3: cFmpjvcjNoVAEAIQIxWkYg ($25 in chips) 
Seat 4: g7MXhRmNZxv1lIkKkUKa4w ($12 in chips) 
Seat 5: 6RQUxA3jk+ePxB/+Hc0IKw ($13.75 in chips) 
Seat 6: zDrucyjVn5aeekNEc3cJrA ($31.35 in chips) 
Seat 7: uhrboV251dcgYniYTdFIcA ($26.95 in chips) 
Seat 8: UD63hhjq5lMoGqYLFTcH1A ($33.75 in chips) 
Seat 9: d6n762oPkegG086ZJyV5MA ($18 in chips) 
g7MXhRmNZxv1lIkKkUKa4w: posts small blind $0.10
3PmVnC/15cl4oyI1TKIt4g joins the table at seat #1 
6RQUxA3jk+ePxB/+Hc0IKw: posts big blind $0.25
*** HOLE CARDS ***
zDrucyjVn5aeekNEc3cJrA: folds 
uhrboV251dcgYniYTdFIcA: folds 
UD63hhjq5lMoGqYLFTcH1A: folds 
d6n762oPkegG086ZJyV5MA: folds 
pN3IHvAKm2fz+sTRARTcrg: folds 
cFmpjvcjNoVAEAIQIxWkYg: folds 
g7MXhRmNZxv1lIkKkUKa4w: folds 
Uncalled bet ($0.15) returned to 6RQUxA3jk+ePxB/+Hc0IKw
g7MXhRmNZxv1lIkKkUKa4w leaves the table
6RQUxA3jk+ePxB/+Hc0IKw collected $0.20 from pot
6RQUxA3jk+ePxB/+Hc0IKw: doesn't show hand 
yqkowiRWZ6NvRN9UUkYIlA joins the table at seat #4 
*** SUMMARY ***
Total pot $0.20 | Rake $0 
Seat 2: pN3IHvAKm2fz+sTRARTcrg folded before Flop (didn't bet)
Seat 3: cFmpjvcjNoVAEAIQIxWkYg (button) folded before Flop (didn't bet)
Seat 4: g7MXhRmNZxv1lIkKkUKa4w (small blind) folded before Flop
Seat 5: 6RQUxA3jk+ePxB/+Hc0IKw (big blind) collected ($0.20)
Seat 6: zDrucyjVn5aeekNEc3cJrA folded before Flop (didn't bet)
Seat 7: uhrboV251dcgYniYTdFIcA folded before Flop (didn't bet)
Seat 8: UD63hhjq5lMoGqYLFTcH1A folded before Flop (didn't bet)
Seat 9: d6n762oPkegG086ZJyV5MA folded before Flop (didn't bet)




PokerStars Game #59941588516:  Hold'em No Limit ($0.10/$0.25) - 2009/07/01 1:40:00 ET
Table '+198VWQSWBhYQOcizzuBkw' 6-max Seat #5 is the button
Seat 3: vw7gefupgmOJJN8lUemdWg ($24.40 in chips) 
Seat 4: TgDsTeCdLQt8kWbL00ByRA ($16.60 in chips) 
Seat 5: LtASJ9OlkqGrrUKGQlpGAw ($26.60 in chips) 
Seat 6: leEQ84f6wJYu5SB/vj27wg ($11.65 in chips) 
leEQ84f6wJYu5SB/vj27wg: posts small blind $0.10
mFv3iBCtrw9XfCDRB0d46Q: is sitting out 
vw7gefupgmOJJN8lUemdWg: posts big blind $0.25
*** HOLE CARDS ***
TgDsTeCdLQt8kWbL00ByRA: folds 
LtASJ9OlkqGrrUKGQlpGAw: raises $0.50 to $0.75
leEQ84f6wJYu5SB/vj27wg: folds 
vw7gefupgmOJJN8lUemdWg: folds 
Uncalled bet ($0.50) returned to LtASJ9OlkqGrrUKGQlpGAw
LtASJ9OlkqGrrUKGQlpGAw collected $0.60 from pot
LtASJ9OlkqGrrUKGQlpGAw: doesn't show hand 
*** SUMMARY ***
Total pot $0.60 | Rake $0 
Seat 3: vw7gefupgmOJJN8lUemdWg (big blind) folded before Flop
Seat 4: TgDsTeCdLQt8kWbL00ByRA folded before Flop (didn't bet)
Seat 5: LtASJ9OlkqGrrUKGQlpGAw (button) collected ($0.60)
Seat 6: leEQ84f6wJYu5SB/vj27wg (small blind) folded before Flop




PokerStars Game #59941588078:  Hold'em No Limit ($0.10/$0.25) - 2009/07/01 1:40:00 ET
Table 'IuqVbFI+pwnJjvwBCGSGAw' 6-max Seat #5 is the button
Seat 1: LyDHtw3/yniNHW+DvLXbog ($25 in chips) 
Seat 2: wsP46AGpqDjHZQmlRHKa9g ($25.45 in chips) 
Seat 3: QiL+lEgEWwy21jk/ltaRLg ($22.60 in chips) 
Seat 5: if4dh6jhJXeN3/qd3qCp9g ($29.50 in chips) 
Seat 6: SJ5z7oeRzpbFT7jU55Mbag ($27.65 in chips) 
SJ5z7oeRzpbFT7jU55Mbag: posts small blind $0.10
LyDHtw3/yniNHW+DvLXbog: posts big blind $0.25
*** HOLE CARDS ***
wsP46AGpqDjHZQmlRHKa9g: folds 
QiL+lEgEWwy21jk/ltaRLg: folds 
if4dh6jhJXeN3/qd3qCp9g: raises $0.50 to $0.75
SJ5z7oeRzpbFT7jU55Mbag: calls $0.65
LyDHtw3/yniNHW+DvLXbog: folds 
*** FLOP *** [Ks 2s 8s]
SJ5z7oeRzpbFT7jU55Mbag: checks 
DE9hRlt14g+JdsRQ4wT7hg joins the table at seat #4 
if4dh6jhJXeN3/qd3qCp9g: bets $1
SJ5z7oeRzpbFT7jU55Mbag: raises $2.25 to $3.25
if4dh6jhJXeN3/qd3qCp9g: calls $2.25
*** TURN *** [Ks 2s 8s] [6h]
SJ5z7oeRzpbFT7jU55Mbag: bets $6.50
if4dh6jhJXeN3/qd3qCp9g: calls $6.50
*** RIVER *** [Ks 2s 8s 6h] [9s]
SJ5z7oeRzpbFT7jU55Mbag: bets $17.15 and is all-in
if4dh6jhJXeN3/qd3qCp9g: folds 
Uncalled bet ($17.15) returned to SJ5z7oeRzpbFT7jU55Mbag
SJ5z7oeRzpbFT7jU55Mbag collected $20.25 from pot
*** SUMMARY ***
Total pot $21.25 | Rake $1 
Board [Ks 2s 8s 6h 9s]
Seat 1: LyDHtw3/yniNHW+DvLXbog (big blind) folded before Flop
Seat 2: wsP46AGpqDjHZQmlRHKa9g folded before Flop (didn't bet)
Seat 3: QiL+lEgEWwy21jk/ltaRLg folded before Flop (didn't bet)
Seat 5: if4dh6jhJXeN3/qd3qCp9g (button) folded on the River
Seat 6: SJ5z7oeRzpbFT7jU55Mbag (small blind) collected ($20.25)




PokerStars Game #59941588680:  Hold'em No Limit ($0.10/$0.25) - 2009/07/01 1:40:00 ET
Table 'WY+lMaAoIdBZmwk27/RJCA' 6-max Seat #5 is the button
Seat 1: zHHLkD2sRljslKKeQv/ZQw ($26.20 in chips) 
Seat 3: 79Q62AM0VB++TQYiBlOYsA ($79.40 in chips) 
Seat 4: 0av6tRNdi0Ui4f15L7gsVg ($22.40 in chips) 
Seat 5: vqWjZmdQu/Hxw96/IJTWdQ ($30.45 in chips) 
Seat 6: cWc85bEzdRzpUMhRKm8pwQ ($25.95 in chips) 
cWc85bEzdRzpUMhRKm8pwQ: posts small blind $0.10
zHHLkD2sRljslKKeQv/ZQw: posts big blind $0.25
NhUN/JpAprdJeamFBgJH1w: sits out 
*** HOLE CARDS ***
79Q62AM0VB++TQYiBlOYsA: calls $0.25
0av6tRNdi0Ui4f15L7gsVg: calls $0.25
vqWjZmdQu/Hxw96/IJTWdQ: folds 
cWc85bEzdRzpUMhRKm8pwQ: folds 
zHHLkD2sRljslKKeQv/ZQw: checks 
*** FLOP *** [9h Qh 7c]
zHHLkD2sRljslKKeQv/ZQw: checks 
79Q62AM0VB++TQYiBlOYsA: checks 
0av6tRNdi0Ui4f15L7gsVg: checks 
*** TURN *** [9h Qh 7c] [3d]
zHHLkD2sRljslKKeQv/ZQw: bets $0.50
79Q62AM0VB++TQYiBlOYsA: calls $0.50
0av6tRNdi0Ui4f15L7gsVg: folds 
*** RIVER *** [9h Qh 7c 3d] [6s]
zHHLkD2sRljslKKeQv/ZQw: bets $0.50
79Q62AM0VB++TQYiBlOYsA: calls $0.50
*** SHOW DOWN ***
zHHLkD2sRljslKKeQv/ZQw: shows [9d 4c] (a pair of Nines)
79Q62AM0VB++TQYiBlOYsA: shows [9s Ac] (a pair of Nines - Ace kicker)
79Q62AM0VB++TQYiBlOYsA collected $2.75 from pot
*** SUMMARY ***
Total pot $2.85 | Rake $0.10 
Board [9h Qh 7c 3d 6s]
Seat 1: zHHLkD2sRljslKKeQv/ZQw (big blind) showed [9d 4c] and lost with a pair of Nines
Seat 3: 79Q62AM0VB++TQYiBlOYsA showed [9s Ac] and won ($2.75) with a pair of Nines
Seat 4: 0av6tRNdi0Ui4f15L7gsVg folded on the Turn
Seat 5: vqWjZmdQu/Hxw96/IJTWdQ (button) folded before Flop (didn't bet)
Seat 6: cWc85bEzdRzpUMhRKm8pwQ (small blind) folded before Flop




PokerStars Game #59941588152:  Hold'em No Limit ($0.10/$0.25) - 2009/07/01 1:40:00 ET
Table 'sJ4KpS2GE5Qrsu1/cFjJUw' 9-max Seat #9 is the button
Seat 1: 7mHNIz+BCOKfVsh+EQ/4Wg ($10.75 in chips) 
Seat 2: tYsOBqdU1+x+yFI7zHO7hQ ($31.50 in chips) 
Seat 3: eK8qa6EPcH2zhtbmWSvc9g ($25.90 in chips) 
Seat 4: npAYqa85pqnzfOK5ukX+BQ ($23.15 in chips) 
Seat 5: Q/gZC63lfOMr7YhWKPCxoQ ($9.60 in chips) 
Seat 6: OefE+Csvj5KR7ClGf3Hc2g ($3.10 in chips) 
Seat 7: Wi8djHgewBlVhpKWfp7isQ ($7.40 in chips) 
Seat 8: S7Ki0P+0AIGPuIfGJjW0gg ($29.70 in chips) 
Seat 9: 3PmVnC/15cl4oyI1TKIt4g ($5 in chips) 
7mHNIz+BCOKfVsh+EQ/4Wg: posts small blind $0.10
tYsOBqdU1+x+yFI7zHO7hQ: posts big blind $0.25
*** HOLE CARDS ***
eK8qa6EPcH2zhtbmWSvc9g: folds 
npAYqa85pqnzfOK5ukX+BQ: folds 
Q/gZC63lfOMr7YhWKPCxoQ: folds 
OefE+Csvj5KR7ClGf3Hc2g: calls $0.25
Wi8djHgewBlVhpKWfp7isQ: folds 
S7Ki0P+0AIGPuIfGJjW0gg: folds 
3PmVnC/15cl4oyI1TKIt4g: folds 
7mHNIz+BCOKfVsh+EQ/4Wg: folds 
tYsOBqdU1+x+yFI7zHO7hQ: checks 
*** FLOP *** [2s 4c 7s]
tYsOBqdU1+x+yFI7zHO7hQ: checks 
OefE+Csvj5KR7ClGf3Hc2g: checks 
*** TURN *** [2s 4c 7s] [Kc]
tYsOBqdU1+x+yFI7zHO7hQ: checks 
OefE+Csvj5KR7ClGf3Hc2g: checks 
*** RIVER *** [2s 4c 7s Kc] [4d]
tYsOBqdU1+x+yFI7zHO7hQ: checks 
OefE+Csvj5KR7ClGf3Hc2g: checks 
*** SHOW DOWN ***
tYsOBqdU1+x+yFI7zHO7hQ: shows [2d 9c] (two pair, Fours and Deuces)
OefE+Csvj5KR7ClGf3Hc2g: mucks hand 
tYsOBqdU1+x+yFI7zHO7hQ collected $0.60 from pot
*** SUMMARY ***
Total pot $0.60 | Rake $0 
Board [2s 4c 7s Kc 4d]
Seat 1: 7mHNIz+BCOKfVsh+EQ/4Wg (small blind) folded before Flop
Seat 2: tYsOBqdU1+x+yFI7zHO7hQ (big blind) showed [2d 9c] and won ($0.60) with two pair, Fours and Deuces
Seat 3: eK8qa6EPcH2zhtbmWSvc9g folded before Flop (didn't bet)
Seat 4: npAYqa85pqnzfOK5ukX+BQ folded before Flop (didn't bet)
Seat 5: Q/gZC63lfOMr7YhWKPCxoQ folded before Flop (didn't bet)
Seat 6: OefE+Csvj5KR7ClGf3Hc2g mucked
Seat 7: Wi8djHgewBlVhpKWfp7isQ folded before Flop (didn't bet)
Seat 8: S7Ki0P+0AIGPuIfGJjW0gg folded before Flop (didn't bet)
Seat 9: 3PmVnC/15cl4oyI1TKIt4g (button) folded before Flop (didn't bet)




PokerStars Game #59941588258:  Hold'em No Limit ($0.10/$0.25) - 2009/07/01 1:40:00 ET
Table 'fRxOyfaHXkWUDLv4eSxFew' 9-max Seat #2 is the button
Seat 1: 6RiVTYll/5D8zICp0MRpKw ($30.40 in chips) 
Seat 2: M2QO2DxB5Wawg2h8HSpnYA ($10 in chips) 
Seat 3: j4q3p0lesp63b1gZDwLBZw ($5 in chips) 
Seat 4: MtVtHDqIJTyUcXkRBBDIVA ($25.50 in chips) 
Seat 5: dmYlc+1cjwZMJ7wV+Z0rRg ($23.10 in chips) 
Seat 6: arxNSjreDRGFg13EAM2F1w ($27.40 in chips) 
Seat 7: 1/DuWziR8CXhWB71aPQd9Q ($18.40 in chips) 
Seat 8: 5n7e7I+px7c6CQmLpPbtsg ($4.65 in chips) 
Seat 9: H5Se03ZqSX7tbULXur2MAg ($33 in chips) 
j4q3p0lesp63b1gZDwLBZw: posts small blind $0.10
MtVtHDqIJTyUcXkRBBDIVA: posts big blind $0.25
*** HOLE CARDS ***
dmYlc+1cjwZMJ7wV+Z0rRg: folds 
arxNSjreDRGFg13EAM2F1w: folds 
1/DuWziR8CXhWB71aPQd9Q: folds 
5n7e7I+px7c6CQmLpPbtsg: folds 
H5Se03ZqSX7tbULXur2MAg has timed out
H5Se03ZqSX7tbULXur2MAg: folds 
H5Se03ZqSX7tbULXur2MAg is sitting out
H5Se03ZqSX7tbULXur2MAg has returned
6RiVTYll/5D8zICp0MRpKw: raises $0.75 to $1
M2QO2DxB5Wawg2h8HSpnYA: folds 
j4q3p0lesp63b1gZDwLBZw: folds 
MtVtHDqIJTyUcXkRBBDIVA: calls $0.75
*** FLOP *** [8d 9s Tc]
MtVtHDqIJTyUcXkRBBDIVA: checks 
6RiVTYll/5D8zICp0MRpKw: checks 
*** TURN *** [8d 9s Tc] [9h]
MtVtHDqIJTyUcXkRBBDIVA: bets $1.50
6RiVTYll/5D8zICp0MRpKw: folds 
Uncalled bet ($1.50) returned to MtVtHDqIJTyUcXkRBBDIVA
MtVtHDqIJTyUcXkRBBDIVA collected $2 from pot
MtVtHDqIJTyUcXkRBBDIVA: doesn't show hand 
*** SUMMARY ***
Total pot $2.10 | Rake $0.10 
Board [8d 9s Tc 9h]
Seat 1: 6RiVTYll/5D8zICp0MRpKw folded on the Turn
Seat 2: M2QO2DxB5Wawg2h8HSpnYA (button) folded before Flop (didn't bet)
Seat 3: j4q3p0lesp63b1gZDwLBZw (small blind) folded before Flop
Seat 4: MtVtHDqIJTyUcXkRBBDIVA (big blind) collected ($2)
Seat 5: dmYlc+1cjwZMJ7wV+Z0rRg folded before Flop (didn't bet)
Seat 6: arxNSjreDRGFg13EAM2F1w folded before Flop (didn't bet)
Seat 7: 1/DuWziR8CXhWB71aPQd9Q folded before Flop (didn't bet)
Seat 8: 5n7e7I+px7c6CQmLpPbtsg folded before Flop (didn't bet)
Seat 9: H5Se03ZqSX7tbULXur2MAg folded before Flop (didn't bet)




PokerStars Game #59941588102:  Hold'em No Limit ($0.10/$0.25) - 2009/07/01 1:40:00 ET
Table 'WEMI3Mtn7dGARDbgNrKibg' 9-max Seat #5 is the button
Seat 1: Th3FldXKQW6hWVVPahaoOQ ($30.50 in chips) 
Seat 2: tYsOBqdU1+x+yFI7zHO7hQ ($49.20 in chips) 
Seat 3: qwr38jl5txoR36M7G5qi4A ($7.75 in chips) 
Seat 4: Z5NNIVvnhb2IJbLcI79WYQ ($5.25 in chips) 
Seat 5: yzPZQFeaQTNf1YK3a0zRIw ($15.45 in chips) 
Seat 6: arxNSjreDRGFg13EAM2F1w ($25.45 in chips) 
Seat 7: DnDcAdn9P0zGovMERigpFA ($55.25 in chips) 
Seat 8: ghNKXUBl/H+t83JF079ZBA ($29 in chips) 
Seat 9: 2wcFsZsqEP5w1StUTVzJCg ($4 in chips) 
arxNSjreDRGFg13EAM2F1w: posts small blind $0.10
DnDcAdn9P0zGovMERigpFA: posts big blind $0.25
*** HOLE CARDS ***
ghNKXUBl/H+t83JF079ZBA: folds 
2wcFsZsqEP5w1StUTVzJCg: folds 
Th3FldXKQW6hWVVPahaoOQ: folds 
tYsOBqdU1+x+yFI7zHO7hQ: raises $0.75 to $1
qwr38jl5txoR36M7G5qi4A: folds 
Z5NNIVvnhb2IJbLcI79WYQ: folds 
yzPZQFeaQTNf1YK3a0zRIw: folds 
arxNSjreDRGFg13EAM2F1w: folds 
DnDcAdn9P0zGovMERigpFA: folds 
Uncalled bet ($0.75) returned to tYsOBqdU1+x+yFI7zHO7hQ
tYsOBqdU1+x+yFI7zHO7hQ collected $0.60 from pot
tYsOBqdU1+x+yFI7zHO7hQ: doesn't show hand 
*** SUMMARY ***
Total pot $0.60 | Rake $0 
Seat 1: Th3FldXKQW6hWVVPahaoOQ folded before Flop (didn't bet)
Seat 2: tYsOBqdU1+x+yFI7zHO7hQ collected ($0.60)
Seat 3: qwr38jl5txoR36M7G5qi4A folded before Flop (didn't bet)
Seat 4: Z5NNIVvnhb2IJbLcI79WYQ folded before Flop (didn't bet)
Seat 5: yzPZQFeaQTNf1YK3a0zRIw (button) folded before Flop (didn't bet)
Seat 6: arxNSjreDRGFg13EAM2F1w (small blind) folded before Flop
Seat 7: DnDcAdn9P0zGovMERigpFA (big blind) folded before Flop
Seat 8: ghNKXUBl/H+t83JF079ZBA folded before Flop (didn't bet)
Seat 9: 2wcFsZsqEP5w1StUTVzJCg folded before Flop (didn't bet)




PokerStars Game #59941588620:  Hold'em No Limit ($0.10/$0.25) - 2009/07/01 1:40:00 ET
Table 'O6cwjhrMn9pfzx1Ngn5zkQ' 6-max Seat #4 is the button
Seat 1: LJI7A1YgDM7hgh7o56+ReQ ($28.30 in chips) 
Seat 2: tSR4329m40dZsN7YOpI9Kw ($29.70 in chips) 
Seat 3: EE16Ua5b1HSsYej5zeXOlA ($25.80 in chips) 
Seat 4: mfrkWA3PTeYPkbO6hi98Aw ($24.30 in chips) 
Seat 5: niLn0xUVlqh8If80xRjzCA ($26.45 in chips) 
Seat 6: 4TM16KVgEiQpLi4bVVWbVQ ($33.40 in chips) 
niLn0xUVlqh8If80xRjzCA: posts small blind $0.10
4TM16KVgEiQpLi4bVVWbVQ: posts big blind $0.25
*** HOLE CARDS ***
LJI7A1YgDM7hgh7o56+ReQ: folds 
tSR4329m40dZsN7YOpI9Kw: folds 
EE16Ua5b1HSsYej5zeXOlA: folds 
mfrkWA3PTeYPkbO6hi98Aw: folds 
niLn0xUVlqh8If80xRjzCA: calls $0.15
4TM16KVgEiQpLi4bVVWbVQ: checks 
*** FLOP *** [Qs Ts 7c]
niLn0xUVlqh8If80xRjzCA: checks 
4TM16KVgEiQpLi4bVVWbVQ: bets $0.25
niLn0xUVlqh8If80xRjzCA: raises $0.25 to $0.50
4TM16KVgEiQpLi4bVVWbVQ: folds 
Uncalled bet ($0.25) returned to niLn0xUVlqh8If80xRjzCA
niLn0xUVlqh8If80xRjzCA collected $0.95 from pot
niLn0xUVlqh8If80xRjzCA: doesn't show hand 
*** SUMMARY ***
Total pot $1 | Rake $0.05 
Board [Qs Ts 7c]
Seat 1: LJI7A1YgDM7hgh7o56+ReQ folded before Flop (didn't bet)
Seat 2: tSR4329m40dZsN7YOpI9Kw folded before Flop (didn't bet)
Seat 3: EE16Ua5b1HSsYej5zeXOlA folded before Flop (didn't bet)
Seat 4: mfrkWA3PTeYPkbO6hi98Aw (button) folded before Flop (didn't bet)
Seat 5: niLn0xUVlqh8If80xRjzCA (small blind) collected ($0.95)
Seat 6: 4TM16KVgEiQpLi4bVVWbVQ (big blind) folded on the Flop




PokerStars Game #59941588678:  Hold'em No Limit ($0.10/$0.25) - 2009/07/01 1:40:00 ET
Table '6wawJ+MkkvuC3coG6r+Yhg' 6-max Seat #2 is the button
Seat 1: JQZew0FjzS19kTjeNtrE+A ($26.50 in chips) 
Seat 2: LtASJ9OlkqGrrUKGQlpGAw ($33.60 in chips) 
Seat 3: 3zD3qLXT1bEffAoWGnc7wg ($59.95 in chips) 
Seat 4: yxmjNFGiKI3b+XQGJzJVIg ($28.30 in chips) 
Seat 5: FZrgDbxAanC1xwZxXHJKVA ($3.10 in chips) 
Seat 6: B3X187C0tXFUfQpCu8pe8A ($28.35 in chips) 
3zD3qLXT1bEffAoWGnc7wg: posts small blind $0.10
yxmjNFGiKI3b+XQGJzJVIg: posts big blind $0.25
*** HOLE CARDS ***
FZrgDbxAanC1xwZxXHJKVA: calls $0.25
B3X187C0tXFUfQpCu8pe8A: folds 
JQZew0FjzS19kTjeNtrE+A: raises $0.75 to $1
LtASJ9OlkqGrrUKGQlpGAw: folds 
3zD3qLXT1bEffAoWGnc7wg: folds 
yxmjNFGiKI3b+XQGJzJVIg: folds 
FZrgDbxAanC1xwZxXHJKVA: folds 
Uncalled bet ($0.75) returned to JQZew0FjzS19kTjeNtrE+A
JQZew0FjzS19kTjeNtrE+A collected $0.85 from pot
*** SUMMARY ***
Total pot $0.85 | Rake $0 
Seat 1: JQZew0FjzS19kTjeNtrE+A collected ($0.85)
Seat 2: LtASJ9OlkqGrrUKGQlpGAw (button) folded before Flop (didn't bet)
Seat 3: 3zD3qLXT1bEffAoWGnc7wg (small blind) folded before Flop
Seat 4: yxmjNFGiKI3b+XQGJzJVIg (big blind) folded before Flop
Seat 5: FZrgDbxAanC1xwZxXHJKVA folded before Flop
Seat 6: B3X187C0tXFUfQpCu8pe8A folded before Flop (didn't bet)




PokerStars Game #59941588596:  Hold'em No Limit ($0.10/$0.25) - 2009/07/01 1:40:00 ET
Table 'HzFR0rxmDAPu5GzYR0AlYg' 6-max Seat #5 is the button
Seat 1: v+QfkGiuj9bgtuNoVnDO8w ($29.60 in chips) 
Seat 2: UA5OsKS3VPaxa7uC8La/kA ($53.35 in chips) 
Seat 3: kG34n23qFQA3nzdOJTQ1dA ($24.65 in chips) 
Seat 4: 8tR2s7yV/Fr0ePp1w5XnJw ($10 in chips) 
Seat 5: lquriepNQBhDV5P1SWHhnA ($26.25 in chips) 
Seat 6: jp34e617tIzV8tKIWmfAbA ($38.60 in chips) 
jp34e617tIzV8tKIWmfAbA: posts small blind $0.10
v+QfkGiuj9bgtuNoVnDO8w: posts big blind $0.25
*** HOLE CARDS ***
UA5OsKS3VPaxa7uC8La/kA: folds 
kG34n23qFQA3nzdOJTQ1dA: folds 
8tR2s7yV/Fr0ePp1w5XnJw: calls $0.25
lquriepNQBhDV5P1SWHhnA: folds 
jp34e617tIzV8tKIWmfAbA: folds 
v+QfkGiuj9bgtuNoVnDO8w: checks 
*** FLOP *** [8s Ts 5c]
v+QfkGiuj9bgtuNoVnDO8w: checks 
8tR2s7yV/Fr0ePp1w5XnJw: bets $0.50
v+QfkGiuj9bgtuNoVnDO8w: raises $1.50 to $2
8tR2s7yV/Fr0ePp1w5XnJw: folds 
Uncalled bet ($1.50) returned to v+QfkGiuj9bgtuNoVnDO8w
v+QfkGiuj9bgtuNoVnDO8w collected $1.55 from pot
v+QfkGiuj9bgtuNoVnDO8w: doesn't show hand 
*** SUMMARY ***
Total pot $1.60 | Rake $0.05 
Board [8s Ts 5c]
Seat 1: v+QfkGiuj9bgtuNoVnDO8w (big blind) collected ($1.55)
Seat 2: UA5OsKS3VPaxa7uC8La/kA folded before Flop (didn't bet)
Seat 3: kG34n23qFQA3nzdOJTQ1dA folded before Flop (didn't bet)
Seat 4: 8tR2s7yV/Fr0ePp1w5XnJw folded on the Flop
Seat 5: lquriepNQBhDV5P1SWHhnA (button) folded before Flop (didn't bet)
Seat 6: jp34e617tIzV8tKIWmfAbA (small blind) folded before Flop




PokerStars Game #59941588132:  Hold'em No Limit ($0.10/$0.25) - 2009/07/01 1:40:00 ET
Table '52Meibn9NOL4XtVi1p2Upw' 9-max Seat #6 is the button
Seat 1: W6tExOcYX7qiy6Qdp+ZwFA ($5 in chips) 
Seat 3: Bb42QRQMhg5/Y0vHP8/2Xw ($25 in chips) 
Seat 4: oLa/tXLfSLLB28mcLGrxcg ($31.90 in chips) 
Seat 5: MXCztnYJ58KLHMztZvKrxA ($5 in chips) 
Seat 6: 1wKfgJ8xXIiuc8C6qjkxhg ($13.45 in chips) 
Seat 8: PFv56Q1PTkDC084eXIAYmw ($12.10 in chips) 
Seat 9: RCqMONFrSPSArZh2Jsar/w ($20 in chips) 
Dr.Hibbert55 will be allowed to play after the button
PFv56Q1PTkDC084eXIAYmw: posts small blind $0.10
RCqMONFrSPSArZh2Jsar/w: posts big blind $0.25
MXCztnYJ58KLHMztZvKrxA: posts big blind $0.25
*** HOLE CARDS ***
W6tExOcYX7qiy6Qdp+ZwFA: folds 
Bb42QRQMhg5/Y0vHP8/2Xw: folds 
oLa/tXLfSLLB28mcLGrxcg: calls $0.25
MXCztnYJ58KLHMztZvKrxA: checks 
1wKfgJ8xXIiuc8C6qjkxhg: raises $1.25 to $1.50
PFv56Q1PTkDC084eXIAYmw: calls $1.40
RCqMONFrSPSArZh2Jsar/w: folds 
oLa/tXLfSLLB28mcLGrxcg: folds 
MXCztnYJ58KLHMztZvKrxA: folds 
*** FLOP *** [7c Jh 4c]
PFv56Q1PTkDC084eXIAYmw: bets $1.50
1wKfgJ8xXIiuc8C6qjkxhg: calls $1.50
*** TURN *** [7c Jh 4c] [Js]
PFv56Q1PTkDC084eXIAYmw: bets $3
1wKfgJ8xXIiuc8C6qjkxhg: raises $5.50 to $8.50
PFv56Q1PTkDC084eXIAYmw: raises $0.60 to $9.10 and is all-in
1wKfgJ8xXIiuc8C6qjkxhg: calls $0.60
*** RIVER *** [7c Jh 4c Js] [9s]
*** SHOW DOWN ***
PFv56Q1PTkDC084eXIAYmw: shows [Jd Ac] (three of a kind, Jacks)
1wKfgJ8xXIiuc8C6qjkxhg: mucks hand 
PFv56Q1PTkDC084eXIAYmw collected $23.75 from pot
*** SUMMARY ***
Total pot $24.95 | Rake $1.20 
Board [7c Jh 4c Js 9s]
Seat 1: W6tExOcYX7qiy6Qdp+ZwFA folded before Flop (didn't bet)
Seat 3: Bb42QRQMhg5/Y0vHP8/2Xw folded before Flop (didn't bet)
Seat 4: oLa/tXLfSLLB28mcLGrxcg folded before Flop
Seat 5: MXCztnYJ58KLHMztZvKrxA folded before Flop
Seat 6: 1wKfgJ8xXIiuc8C6qjkxhg (button) mucked
Seat 8: PFv56Q1PTkDC084eXIAYmw (small blind) showed [Jd Ac] and won ($23.75) with three of a kind, Jacks
Seat 9: RCqMONFrSPSArZh2Jsar/w (big blind) folded before Flop




PokerStars Game #59941588108:  Hold'em No Limit ($0.10/$0.25) - 2009/07/01 1:40:00 ET
Table 'm+FQg/QP0VP1ZA3V62WtOg' 9-max Seat #4 is the button
Seat 4: qB12xUq3ftb2y8oTnNQzsg ($3 in chips) 
Seat 7: TPAF9YkMsjQFq978RNWZEQ ($14.65 in chips) 
Seat 9: zUXhymECc2C9W9ZNw6qppA ($10.90 in chips) 
TPAF9YkMsjQFq978RNWZEQ: posts small blind $0.10
zUXhymECc2C9W9ZNw6qppA: posts big blind $0.25
*** HOLE CARDS ***
qB12xUq3ftb2y8oTnNQzsg: raises $0.25 to $0.50
TPAF9YkMsjQFq978RNWZEQ: folds 
zUXhymECc2C9W9ZNw6qppA: folds 
Uncalled bet ($0.25) returned to qB12xUq3ftb2y8oTnNQzsg
qB12xUq3ftb2y8oTnNQzsg collected $0.60 from pot
qB12xUq3ftb2y8oTnNQzsg: doesn't show hand 
*** SUMMARY ***
Total pot $0.60 | Rake $0 
Seat 4: qB12xUq3ftb2y8oTnNQzsg (button) collected ($0.60)
Seat 7: TPAF9YkMsjQFq978RNWZEQ (small blind) folded before Flop
Seat 9: zUXhymECc2C9W9ZNw6qppA (big blind) folded before Flop




PokerStars Game #59941588804:  Hold'em No Limit ($0.10/$0.25) - 2009/07/01 1:40:01 ET
Table 'ROYvQOMwUrvL3SOiHYcrWg' 9-max Seat #1 is the button
Seat 1: 22dIObOuor/A+IKWkNoAlA ($5 in chips) 
Seat 2: gehe91e0IyVT0QU/XBkEyg ($25 in chips) 
Seat 3: 8EbrQ/EvFWt2cr0GaU82gQ ($5 in chips) 
Seat 4: SHegmCn8B0InbWE/zFlvOw ($35.80 in chips) 
Seat 7: tYsOBqdU1+x+yFI7zHO7hQ ($26.15 in chips) 
Seat 8: biJWLZ27fafNeBI2oT1KJw ($23 in chips) 
Seat 9: uhrboV251dcgYniYTdFIcA ($25 in chips) 
gehe91e0IyVT0QU/XBkEyg: posts small blind $0.10
8EbrQ/EvFWt2cr0GaU82gQ: posts big blind $0.25
7je+LC5Mfs6nL8YBVh4frQ: sits out 
P+9ymZQ3ktpQu1bn7HIjew: sits out 
*** HOLE CARDS ***
SHegmCn8B0InbWE/zFlvOw: folds 
tYsOBqdU1+x+yFI7zHO7hQ: folds 
biJWLZ27fafNeBI2oT1KJw: raises $0.50 to $0.75
uhrboV251dcgYniYTdFIcA: folds 
22dIObOuor/A+IKWkNoAlA: folds 
gehe91e0IyVT0QU/XBkEyg: folds 
8EbrQ/EvFWt2cr0GaU82gQ: folds 
Uncalled bet ($0.50) returned to biJWLZ27fafNeBI2oT1KJw
biJWLZ27fafNeBI2oT1KJw collected $0.60 from pot
biJWLZ27fafNeBI2oT1KJw: doesn't show hand 
*** SUMMARY ***
Total pot $0.60 | Rake $0 
Seat 1: 22dIObOuor/A+IKWkNoAlA (button) folded before Flop (didn't bet)
Seat 2: gehe91e0IyVT0QU/XBkEyg (small blind) folded before Flop
Seat 3: 8EbrQ/EvFWt2cr0GaU82gQ (big blind) folded before Flop
Seat 4: SHegmCn8B0InbWE/zFlvOw folded before Flop (didn't bet)
Seat 7: tYsOBqdU1+x+yFI7zHO7hQ folded before Flop (didn't bet)
Seat 8: biJWLZ27fafNeBI2oT1KJw collected ($0.60)
Seat 9: uhrboV251dcgYniYTdFIcA folded before Flop (didn't bet)




PokerStars Game #59941588946:  Hold'em No Limit ($0.10/$0.25) - 2009/07/01 1:40:01 ET
Table 'T/iCKJXGphRN3xcdwfE/JQ' 6-max Seat #6 is the button
Seat 1: wAKC8C/zN0c8V5v13dm9mA ($25 in chips) 
Seat 2: EeUZtMU058v2ObUACOF4Og ($34.10 in chips) 
Seat 3: IWAjoCPXtc1XUaZdp+pCpA ($22.35 in chips) 
Seat 4: tSR4329m40dZsN7YOpI9Kw ($53.50 in chips) 
Seat 5: gaPMxLGp9SOj4Lq6t+/0Ig ($4.20 in chips) 
Seat 6: Ey4Kn6PlnYb2srYYBJHvzg ($15.85 in chips) 
wAKC8C/zN0c8V5v13dm9mA: posts small blind $0.10
EeUZtMU058v2ObUACOF4Og: posts big blind $0.25
*** HOLE CARDS ***
IWAjoCPXtc1XUaZdp+pCpA: folds 
tSR4329m40dZsN7YOpI9Kw: raises $0.50 to $0.75
gaPMxLGp9SOj4Lq6t+/0Ig: folds 
Ey4Kn6PlnYb2srYYBJHvzg: folds 
wAKC8C/zN0c8V5v13dm9mA: folds 
EeUZtMU058v2ObUACOF4Og: folds 
Uncalled bet ($0.50) returned to tSR4329m40dZsN7YOpI9Kw
tSR4329m40dZsN7YOpI9Kw collected $0.60 from pot
*** SUMMARY ***
Total pot $0.60 | Rake $0 
Seat 1: wAKC8C/zN0c8V5v13dm9mA (small blind) folded before Flop
Seat 2: EeUZtMU058v2ObUACOF4Og (big blind) folded before Flop
Seat 3: IWAjoCPXtc1XUaZdp+pCpA folded before Flop (didn't bet)
Seat 4: tSR4329m40dZsN7YOpI9Kw collected ($0.60)
Seat 5: gaPMxLGp9SOj4Lq6t+/0Ig folded before Flop (didn't bet)
Seat 6: Ey4Kn6PlnYb2srYYBJHvzg (button) folded before Flop (didn't bet)




PokerStars Game #59941589104:  Hold'em No Limit ($0.10/$0.25) - 2009/07/01 1:40:01 ET
Table 'Qr+t8WGovMECkBv+cV1lrg' 6-max Seat #2 is the button
Seat 1: EeUZtMU058v2ObUACOF4Og ($52.35 in chips) 
Seat 2: GJsS3gwVwlbyroaWrnjqJg ($41.40 in chips) 
Seat 3: uZKkrGByYgd4/ZBX2d4z+w ($18.40 in chips) 
Seat 4: 1NNFfYMd5Hsphl/FYz9fNA ($60.80 in chips) 
Seat 5: 9q7YGTKe9k5fYb4fmZc3Ww ($35 in chips) 
Seat 6: xRkU4+naLuz7dEZFbOn9cw ($25 in chips) 
uZKkrGByYgd4/ZBX2d4z+w: posts small blind $0.10
1NNFfYMd5Hsphl/FYz9fNA: posts big blind $0.25
*** HOLE CARDS ***
9q7YGTKe9k5fYb4fmZc3Ww: raises $0.50 to $0.75
xRkU4+naLuz7dEZFbOn9cw: folds 
EeUZtMU058v2ObUACOF4Og: calls $0.75
GJsS3gwVwlbyroaWrnjqJg: folds 
uZKkrGByYgd4/ZBX2d4z+w: calls $0.65
1NNFfYMd5Hsphl/FYz9fNA: folds 
*** FLOP *** [Jd 5d 9c]
uZKkrGByYgd4/ZBX2d4z+w: checks 
9q7YGTKe9k5fYb4fmZc3Ww: checks 
EeUZtMU058v2ObUACOF4Og: checks 
*** TURN *** [Jd 5d 9c] [6s]
uZKkrGByYgd4/ZBX2d4z+w: bets $1
9q7YGTKe9k5fYb4fmZc3Ww: folds 
EeUZtMU058v2ObUACOF4Og: folds 
Uncalled bet ($1) returned to uZKkrGByYgd4/ZBX2d4z+w
uZKkrGByYgd4/ZBX2d4z+w collected $2.40 from pot
*** SUMMARY ***
Total pot $2.50 | Rake $0.10 
Board [Jd 5d 9c 6s]
Seat 1: EeUZtMU058v2ObUACOF4Og folded on the Turn
Seat 2: GJsS3gwVwlbyroaWrnjqJg (button) folded before Flop (didn't bet)
Seat 3: uZKkrGByYgd4/ZBX2d4z+w (small blind) collected ($2.40)
Seat 4: 1NNFfYMd5Hsphl/FYz9fNA (big blind) folded before Flop
Seat 5: 9q7YGTKe9k5fYb4fmZc3Ww folded on the Turn
Seat 6: xRkU4+naLuz7dEZFbOn9cw folded before Flop (didn't bet)




PokerStars Game #59941588872:  Hold'em No Limit ($0.10/$0.25) - 2009/07/01 1:40:01 ET
Table 'LXz5SsUCyWcm+4JDJh466A' 9-max Seat #6 is the button
Seat 1: MG90wfSJZnOejs/KD3vlQQ ($25 in chips) 
Seat 2: H5Se03ZqSX7tbULXur2MAg ($23.70 in chips) 
Seat 3: dfNim92Z6XK1/h5SFW5vDg ($25.50 in chips) 
Seat 4: K0b5wNInj6hUGRr6yzKFtw ($28.60 in chips) 
Seat 5: O02ScVDnDZwH6KjZNJZMzA ($4.40 in chips) 
Seat 6: 6RiVTYll/5D8zICp0MRpKw ($26.75 in chips) 
Seat 7: J2a/QHAWUgo6beDRoEyg2g ($14 in chips) 
Seat 8: zOHElTcFiTsexeDCkAPYkQ ($24.85 in chips) 
Seat 9: dtZ84flFEi4Q+SGrHMJRDQ ($25 in chips) 
J2a/QHAWUgo6beDRoEyg2g: posts small blind $0.10
zOHElTcFiTsexeDCkAPYkQ: posts big blind $0.25
*** HOLE CARDS ***
dtZ84flFEi4Q+SGrHMJRDQ: folds 
MG90wfSJZnOejs/KD3vlQQ: folds 
H5Se03ZqSX7tbULXur2MAg: folds 
dfNim92Z6XK1/h5SFW5vDg: folds 
K0b5wNInj6hUGRr6yzKFtw: folds 
O02ScVDnDZwH6KjZNJZMzA: folds 
6RiVTYll/5D8zICp0MRpKw: folds 
J2a/QHAWUgo6beDRoEyg2g: calls $0.15
zOHElTcFiTsexeDCkAPYkQ: raises $1 to $1.25
J2a/QHAWUgo6beDRoEyg2g: folds 
Uncalled bet ($1) returned to zOHElTcFiTsexeDCkAPYkQ
zOHElTcFiTsexeDCkAPYkQ collected $0.50 from pot
zOHElTcFiTsexeDCkAPYkQ: doesn't show hand 
*** SUMMARY ***
Total pot $0.50 | Rake $0 
Seat 1: MG90wfSJZnOejs/KD3vlQQ folded before Flop (didn't bet)
Seat 2: H5Se03ZqSX7tbULXur2MAg folded before Flop (didn't bet)
Seat 3: dfNim92Z6XK1/h5SFW5vDg folded before Flop (didn't bet)
Seat 4: K0b5wNInj6hUGRr6yzKFtw folded before Flop (didn't bet)
Seat 5: O02ScVDnDZwH6KjZNJZMzA folded before Flop (didn't bet)
Seat 6: 6RiVTYll/5D8zICp0MRpKw (button) folded before Flop (didn't bet)
Seat 7: J2a/QHAWUgo6beDRoEyg2g (small blind) folded before Flop
Seat 8: zOHElTcFiTsexeDCkAPYkQ (big blind) collected ($0.50)
Seat 9: dtZ84flFEi4Q+SGrHMJRDQ folded before Flop (didn't bet)




PokerStars Game #59941589096:  Hold'em No Limit ($0.10/$0.25) - 2009/07/01 1:40:01 ET
Table 'Y9EhDWuqWWQFM9SelXAj5g' 9-max Seat #5 is the button
Seat 1: zDrucyjVn5aeekNEc3cJrA ($28.40 in chips) 
Seat 3: zgi+EUykT/pZQpoUG6+oEg ($4.75 in chips) 
Seat 4: V6p0jQ/RhUsqpHLmXvEX4Q ($14.60 in chips) 
Seat 5: CvL9Ch1HYCVbTsfpNucitg ($5.45 in chips) 
Seat 6: egvg3mTBBVzMHnJPIQiKcA ($14.10 in chips) 
Seat 7: aNpwfA31EREwO+ar4XzBCw ($26.95 in chips) 
Seat 8: XDxyajtqmdag0QPvwcOG7Q ($14.10 in chips) 
Seat 9: bOrfviVhRBpaOfMqUc74Tw ($19.15 in chips) 
egvg3mTBBVzMHnJPIQiKcA: posts small blind $0.10
aNpwfA31EREwO+ar4XzBCw: posts big blind $0.25
*** HOLE CARDS ***
XDxyajtqmdag0QPvwcOG7Q: folds 
bOrfviVhRBpaOfMqUc74Tw: calls $0.25
zDrucyjVn5aeekNEc3cJrA: folds 
zgi+EUykT/pZQpoUG6+oEg: raises $1 to $1.25
V6p0jQ/RhUsqpHLmXvEX4Q: calls $1.25
CvL9Ch1HYCVbTsfpNucitg: folds 
egvg3mTBBVzMHnJPIQiKcA: folds 
aNpwfA31EREwO+ar4XzBCw: folds 
bOrfviVhRBpaOfMqUc74Tw: calls $1
*** FLOP *** [Qd 5s Qh]
bOrfviVhRBpaOfMqUc74Tw: checks 
zgi+EUykT/pZQpoUG6+oEg: bets $3.50 and is all-in
V6p0jQ/RhUsqpHLmXvEX4Q: folds 
bOrfviVhRBpaOfMqUc74Tw: folds 
Uncalled bet ($3.50) returned to zgi+EUykT/pZQpoUG6+oEg
zgi+EUykT/pZQpoUG6+oEg collected $3.90 from pot
zgi+EUykT/pZQpoUG6+oEg: doesn't show hand 
*** SUMMARY ***
Total pot $4.10 | Rake $0.20 
Board [Qd 5s Qh]
Seat 1: zDrucyjVn5aeekNEc3cJrA folded before Flop (didn't bet)
Seat 3: zgi+EUykT/pZQpoUG6+oEg collected ($3.90)
Seat 4: V6p0jQ/RhUsqpHLmXvEX4Q folded on the Flop
Seat 5: CvL9Ch1HYCVbTsfpNucitg (button) folded before Flop (didn't bet)
Seat 6: egvg3mTBBVzMHnJPIQiKcA (small blind) folded before Flop
Seat 7: aNpwfA31EREwO+ar4XzBCw (big blind) folded before Flop
Seat 8: XDxyajtqmdag0QPvwcOG7Q folded before Flop (didn't bet)
Seat 9: bOrfviVhRBpaOfMqUc74Tw folded on the Flop




PokerStars Game #59941589174:  Hold'em No Limit ($0.10/$0.25) - 2009/07/01 1:40:01 ET
Table 'xro+BVoe2Zuw1TYmz/McJQ' 9-max Seat #2 is the button
Seat 1: xEQxarad8/T4jJdpZy5LGw ($10.30 in chips) 
Seat 2: vSkQm2EelzwRGDDQQk0Fqw ($4.65 in chips) 
Seat 4: N2LVj3iImgnOoHVf8g0rIw ($45.90 in chips) 
Seat 5: w48D7DZIjuBit2n4FRDJ5Q ($13.30 in chips) 
Seat 6: HPEB+AtKw1+C/cxU0o1ciw ($26.85 in chips) 
Seat 7: QEbIGci+itdw+re8RM5fZA ($31.15 in chips) 
Seat 8: ljemhp25Zg+nlA9DLCIiUw ($23 in chips) 
Seat 9: H5Se03ZqSX7tbULXur2MAg ($13.65 in chips) 
PdIasPkzm2sqZnN41ZRXOg will be allowed to play after the button
N2LVj3iImgnOoHVf8g0rIw: posts small blind $0.10
w48D7DZIjuBit2n4FRDJ5Q: posts big blind $0.25
*** HOLE CARDS ***
HPEB+AtKw1+C/cxU0o1ciw: folds 
QEbIGci+itdw+re8RM5fZA: folds 
ljemhp25Zg+nlA9DLCIiUw: folds 
H5Se03ZqSX7tbULXur2MAg: folds 
xEQxarad8/T4jJdpZy5LGw: calls $0.25
vSkQm2EelzwRGDDQQk0Fqw: folds 
N2LVj3iImgnOoHVf8g0rIw: calls $0.15
w48D7DZIjuBit2n4FRDJ5Q: checks 
*** FLOP *** [Qh 9s Qc]
N2LVj3iImgnOoHVf8g0rIw: checks 
w48D7DZIjuBit2n4FRDJ5Q: checks 
xEQxarad8/T4jJdpZy5LGw: checks 
*** TURN *** [Qh 9s Qc] [4d]
N2LVj3iImgnOoHVf8g0rIw: bets $0.50
w48D7DZIjuBit2n4FRDJ5Q: folds 
xEQxarad8/T4jJdpZy5LGw: folds 
Uncalled bet ($0.50) returned to N2LVj3iImgnOoHVf8g0rIw
N2LVj3iImgnOoHVf8g0rIw collected $0.75 from pot
*** SUMMARY ***
Total pot $0.75 | Rake $0 
Board [Qh 9s Qc 4d]
Seat 1: xEQxarad8/T4jJdpZy5LGw folded on the Turn
Seat 2: vSkQm2EelzwRGDDQQk0Fqw (button) folded before Flop (didn't bet)
Seat 4: N2LVj3iImgnOoHVf8g0rIw (small blind) collected ($0.75)
Seat 5: w48D7DZIjuBit2n4FRDJ5Q (big blind) folded on the Turn
Seat 6: HPEB+AtKw1+C/cxU0o1ciw folded before Flop (didn't bet)
Seat 7: QEbIGci+itdw+re8RM5fZA folded before Flop (didn't bet)
Seat 8: ljemhp25Zg+nlA9DLCIiUw folded before Flop (didn't bet)
Seat 9: H5Se03ZqSX7tbULXur2MAg folded before Flop (didn't bet)




PokerStars Game #59941589454:  Hold'em No Limit ($0.10/$0.25) - 2009/07/01 1:40:02 ET
Table 'Is9eNmJA1KnBOw0lcVkxUQ' 9-max Seat #4 is the button
Seat 1: 56S3mA6Zs3pGR+0p0vUCtg ($32 in chips) 
Seat 2: VllYilcih0t+gMD4GTRlgQ ($38.35 in chips) 
Seat 3: ubsjZomMWSV0hAiBLa7K1A ($20 in chips) 
Seat 4: cZ99hugmLBj9KhTlc8nCSw ($25 in chips) 
Seat 6: HapyJHxV6lc3eqoT7yWL2A ($29.60 in chips) 
Seat 7: aNpwfA31EREwO+ar4XzBCw ($28.65 in chips) 
Seat 8: Th3FldXKQW6hWVVPahaoOQ ($25 in chips) 
Seat 9: DdPXdieucQ+n99u1n3A+rQ ($4.90 in chips) 
Dr.Hibbert55 will be allowed to play after the button
HapyJHxV6lc3eqoT7yWL2A: posts small blind $0.10
aNpwfA31EREwO+ar4XzBCw: posts big blind $0.25
ubsjZomMWSV0hAiBLa7K1A: posts big blind $0.25
*** HOLE CARDS ***
Th3FldXKQW6hWVVPahaoOQ: folds 
DdPXdieucQ+n99u1n3A+rQ: folds 
56S3mA6Zs3pGR+0p0vUCtg: folds 
VllYilcih0t+gMD4GTRlgQ: folds 
ubsjZomMWSV0hAiBLa7K1A: checks 
cZ99hugmLBj9KhTlc8nCSw: folds 
HapyJHxV6lc3eqoT7yWL2A: calls $0.15
aNpwfA31EREwO+ar4XzBCw: checks 
*** FLOP *** [2s 5c 9s]
HapyJHxV6lc3eqoT7yWL2A: checks 
aNpwfA31EREwO+ar4XzBCw: bets $0.50
ubsjZomMWSV0hAiBLa7K1A: folds 
HapyJHxV6lc3eqoT7yWL2A: folds 
Uncalled bet ($0.50) returned to aNpwfA31EREwO+ar4XzBCw
aNpwfA31EREwO+ar4XzBCw collected $0.75 from pot
aNpwfA31EREwO+ar4XzBCw: doesn't show hand 
*** SUMMARY ***
Total pot $0.75 | Rake $0 
Board [2s 5c 9s]
Seat 1: 56S3mA6Zs3pGR+0p0vUCtg folded before Flop (didn't bet)
Seat 2: VllYilcih0t+gMD4GTRlgQ folded before Flop (didn't bet)
Seat 3: ubsjZomMWSV0hAiBLa7K1A folded on the Flop
Seat 4: cZ99hugmLBj9KhTlc8nCSw (button) folded before Flop (didn't bet)
Seat 6: HapyJHxV6lc3eqoT7yWL2A (small blind) folded on the Flop
Seat 7: aNpwfA31EREwO+ar4XzBCw (big blind) collected ($0.75)
Seat 8: Th3FldXKQW6hWVVPahaoOQ folded before Flop (didn't bet)
Seat 9: DdPXdieucQ+n99u1n3A+rQ folded before Flop (didn't bet)




PokerStars Game #59941589556:  Hold'em No Limit ($0.10/$0.25) - 2009/07/01 1:40:02 ET
Table '9SExUHslNkrPJ4XsrePaVw' 9-max Seat #5 is the button
Seat 2: cZ99hugmLBj9KhTlc8nCSw ($47.35 in chips) 
Seat 3: EP17SQz/iWcuYdNOGeBgkw ($14.40 in chips) 
Seat 4: 4awUyiDYTgylQKXZ9faBVA ($26.50 in chips) 
Seat 5: L+eJnUyhY8bMNYw755K8XQ ($9.50 in chips) 
Seat 6: YPJ90cgNXDABdYJcqmwB0A ($17.40 in chips) 
Seat 7: 7cv+9Zc9HIQHNvYsMfV3uA ($30.05 in chips) 
Seat 8: tLcDklc2rBORNfixyRfVfw ($25 in chips) 
Seat 9: /THNzAxdv2lBxcf4XTj/0g ($10.85 in chips) 
YPJ90cgNXDABdYJcqmwB0A: posts small blind $0.10
7cv+9Zc9HIQHNvYsMfV3uA: posts big blind $0.25
*** HOLE CARDS ***
tLcDklc2rBORNfixyRfVfw: folds 
/THNzAxdv2lBxcf4XTj/0g: folds 
cZ99hugmLBj9KhTlc8nCSw: folds 
EP17SQz/iWcuYdNOGeBgkw: folds 
4awUyiDYTgylQKXZ9faBVA: raises $0.75 to $1
L+eJnUyhY8bMNYw755K8XQ: folds 
YPJ90cgNXDABdYJcqmwB0A: calls $0.90
7cv+9Zc9HIQHNvYsMfV3uA: folds 
*** FLOP *** [5d Jc 7d]
YPJ90cgNXDABdYJcqmwB0A: checks 
4awUyiDYTgylQKXZ9faBVA: bets $1.25
YPJ90cgNXDABdYJcqmwB0A: calls $1.25
*** TURN *** [5d Jc 7d] [4d]
YPJ90cgNXDABdYJcqmwB0A: checks 
4awUyiDYTgylQKXZ9faBVA: checks 
*** RIVER *** [5d Jc 7d 4d] [5h]
YPJ90cgNXDABdYJcqmwB0A: checks 
4awUyiDYTgylQKXZ9faBVA: checks 
*** SHOW DOWN ***
YPJ90cgNXDABdYJcqmwB0A: shows [9h 9d] (two pair, Nines and Fives)
4awUyiDYTgylQKXZ9faBVA: mucks hand 
YPJ90cgNXDABdYJcqmwB0A collected $4.55 from pot
*** SUMMARY ***
Total pot $4.75 | Rake $0.20 
Board [5d Jc 7d 4d 5h]
Seat 2: cZ99hugmLBj9KhTlc8nCSw folded before Flop (didn't bet)
Seat 3: EP17SQz/iWcuYdNOGeBgkw folded before Flop (didn't bet)
Seat 4: 4awUyiDYTgylQKXZ9faBVA mucked
Seat 5: L+eJnUyhY8bMNYw755K8XQ (button) folded before Flop (didn't bet)
Seat 6: YPJ90cgNXDABdYJcqmwB0A (small blind) showed [9h 9d] and won ($4.55) with two pair, Nines and Fives
Seat 7: 7cv+9Zc9HIQHNvYsMfV3uA (big blind) folded before Flop
Seat 8: tLcDklc2rBORNfixyRfVfw folded before Flop (didn't bet)
Seat 9: /THNzAxdv2lBxcf4XTj/0g folded before Flop (didn't bet)




PokerStars Game #59941589298:  Hold'em No Limit ($0.10/$0.25) - 2009/07/01 1:40:02 ET
Table 'XX2OuOsa8/8AC+/mR/Az6g' 9-max Seat #9 is the button
Seat 1: 56S3mA6Zs3pGR+0p0vUCtg ($26.40 in chips) 
Seat 2: Bb42QRQMhg5/Y0vHP8/2Xw ($26.50 in chips) 
Seat 3: oLa/tXLfSLLB28mcLGrxcg ($25 in chips) 
Seat 4: 52uIvr1a/mxEYD1W0ESvdQ ($25.95 in chips) 
Seat 5: SpiiQQAzy4MUgV3I5W8giw ($20.80 in chips) 
Seat 7: zDrucyjVn5aeekNEc3cJrA ($16.25 in chips) 
Seat 8: qwr38jl5txoR36M7G5qi4A ($10 in chips) 
Seat 9: V6p0jQ/RhUsqpHLmXvEX4Q ($11.15 in chips) 
56S3mA6Zs3pGR+0p0vUCtg: posts small blind $0.10
Bb42QRQMhg5/Y0vHP8/2Xw: posts big blind $0.25
RCqMONFrSPSArZh2Jsar/w: sits out 
*** HOLE CARDS ***
oLa/tXLfSLLB28mcLGrxcg: folds 
52uIvr1a/mxEYD1W0ESvdQ: calls $0.25
SpiiQQAzy4MUgV3I5W8giw: calls $0.25
zDrucyjVn5aeekNEc3cJrA: folds 
qwr38jl5txoR36M7G5qi4A: folds 
V6p0jQ/RhUsqpHLmXvEX4Q: folds 
56S3mA6Zs3pGR+0p0vUCtg: calls $0.15
Bb42QRQMhg5/Y0vHP8/2Xw: checks 
*** FLOP *** [5h Ac As]
56S3mA6Zs3pGR+0p0vUCtg: checks 
Bb42QRQMhg5/Y0vHP8/2Xw: checks 
52uIvr1a/mxEYD1W0ESvdQ: checks 
SpiiQQAzy4MUgV3I5W8giw: bets $0.25
56S3mA6Zs3pGR+0p0vUCtg: folds 
Bb42QRQMhg5/Y0vHP8/2Xw: folds 
52uIvr1a/mxEYD1W0ESvdQ: folds 
Uncalled bet ($0.25) returned to SpiiQQAzy4MUgV3I5W8giw
SpiiQQAzy4MUgV3I5W8giw collected $0.95 from pot
SpiiQQAzy4MUgV3I5W8giw: doesn't show hand 
*** SUMMARY ***
Total pot $1 | Rake $0.05 
Board [5h Ac As]
Seat 1: 56S3mA6Zs3pGR+0p0vUCtg (small blind) folded on the Flop
Seat 2: Bb42QRQMhg5/Y0vHP8/2Xw (big blind) folded on the Flop
Seat 3: oLa/tXLfSLLB28mcLGrxcg folded before Flop (didn't bet)
Seat 4: 52uIvr1a/mxEYD1W0ESvdQ folded on the Flop
Seat 5: SpiiQQAzy4MUgV3I5W8giw collected ($0.95)
Seat 7: zDrucyjVn5aeekNEc3cJrA folded before Flop (didn't bet)
Seat 8: qwr38jl5txoR36M7G5qi4A folded before Flop (didn't bet)
Seat 9: V6p0jQ/RhUsqpHLmXvEX4Q (button) folded before Flop (didn't bet)




PokerStars Game #59941589362:  Hold'em No Limit ($0.10/$0.25) - 2009/07/01 1:40:02 ET
Table 'x7YStLKc8hpt/pTgSetPKA' 9-max Seat #6 is the button
Seat 1: tYsOBqdU1+x+yFI7zHO7hQ ($26.25 in chips) 
Seat 2: z5GxcHlYz/GSz6W2uFiTtg ($23.70 in chips) 
Seat 3: S7Ki0P+0AIGPuIfGJjW0gg ($12 in chips) 
Seat 4: ydoFOVgzvZv9ZhuWu9rXAw ($5.25 in chips) 
Seat 5: OiV1PWZ3IkN29JlmCcnTwQ ($4.90 in chips) 
Seat 6: 9YN2IkT2JYYKFErZtZvCtA ($47.70 in chips) 
Seat 7: dtZ84flFEi4Q+SGrHMJRDQ ($26.45 in chips) 
Seat 8: j4q3p0lesp63b1gZDwLBZw ($5 in chips) 
Seat 9: nm4Dj/f+jJEwKVsUnKh73g ($22.65 in chips) 
dtZ84flFEi4Q+SGrHMJRDQ: posts small blind $0.10
j4q3p0lesp63b1gZDwLBZw: posts big blind $0.25
*** HOLE CARDS ***
nm4Dj/f+jJEwKVsUnKh73g: folds 
tYsOBqdU1+x+yFI7zHO7hQ: raises $0.75 to $1
z5GxcHlYz/GSz6W2uFiTtg: folds 
S7Ki0P+0AIGPuIfGJjW0gg: folds 
ydoFOVgzvZv9ZhuWu9rXAw: folds 
OiV1PWZ3IkN29JlmCcnTwQ: folds 
9YN2IkT2JYYKFErZtZvCtA: folds 
dtZ84flFEi4Q+SGrHMJRDQ: folds 
j4q3p0lesp63b1gZDwLBZw: folds 
Uncalled bet ($0.75) returned to tYsOBqdU1+x+yFI7zHO7hQ
tYsOBqdU1+x+yFI7zHO7hQ collected $0.60 from pot
tYsOBqdU1+x+yFI7zHO7hQ: doesn't show hand 
*** SUMMARY ***
Total pot $0.60 | Rake $0 
Seat 1: tYsOBqdU1+x+yFI7zHO7hQ collected ($0.60)
Seat 2: z5GxcHlYz/GSz6W2uFiTtg folded before Flop (didn't bet)
Seat 3: S7Ki0P+0AIGPuIfGJjW0gg folded before Flop (didn't bet)
Seat 4: ydoFOVgzvZv9ZhuWu9rXAw folded before Flop (didn't bet)
Seat 5: OiV1PWZ3IkN29JlmCcnTwQ folded before Flop (didn't bet)
Seat 6: 9YN2IkT2JYYKFErZtZvCtA (button) folded before Flop (didn't bet)
Seat 7: dtZ84flFEi4Q+SGrHMJRDQ (small blind) folded before Flop
Seat 8: j4q3p0lesp63b1gZDwLBZw (big blind) folded before Flop
Seat 9: nm4Dj/f+jJEwKVsUnKh73g folded before Flop (didn't bet)




PokerStars Game #59941589776:  Hold'em No Limit ($0.10/$0.25) - 2009/07/01 1:40:02 ET
Table '/VaaaFnlEJoYVomG9uxHkA' 9-max Seat #5 is the button
Seat 1: Th3FldXKQW6hWVVPahaoOQ ($26 in chips) 
Seat 2: DIkeSkosO/tsUp9d2JVyTA ($57.40 in chips) 
Seat 3: MtVtHDqIJTyUcXkRBBDIVA ($26.50 in chips) 
Seat 4: j4q3p0lesp63b1gZDwLBZw ($5 in chips) 
Seat 5: cZ99hugmLBj9KhTlc8nCSw ($25.50 in chips) 
Seat 6: qxWFg3MZuVyidB0SJh5ywg ($34.60 in chips) 
Seat 7: F7pnn6czNpHvRM55XcA2EA ($25.85 in chips) 
Seat 8: dfNim92Z6XK1/h5SFW5vDg ($46.25 in chips) 
Seat 9: qpG9m8I+cPw8VhB0mnGjYw ($25.10 in chips) 
qxWFg3MZuVyidB0SJh5ywg: posts small blind $0.10
F7pnn6czNpHvRM55XcA2EA: posts big blind $0.25
*** HOLE CARDS ***
dfNim92Z6XK1/h5SFW5vDg: folds 
qpG9m8I+cPw8VhB0mnGjYw: folds 
Th3FldXKQW6hWVVPahaoOQ: folds 
DIkeSkosO/tsUp9d2JVyTA: calls $0.25
MtVtHDqIJTyUcXkRBBDIVA: folds 
j4q3p0lesp63b1gZDwLBZw: folds 
cZ99hugmLBj9KhTlc8nCSw: folds 
qxWFg3MZuVyidB0SJh5ywg: raises $0.75 to $1
F7pnn6czNpHvRM55XcA2EA: folds 
DIkeSkosO/tsUp9d2JVyTA: calls $0.75
*** FLOP *** [2s Qd 7s]
qxWFg3MZuVyidB0SJh5ywg: checks 
DIkeSkosO/tsUp9d2JVyTA: checks 
*** TURN *** [2s Qd 7s] [7c]
qxWFg3MZuVyidB0SJh5ywg: checks 
DIkeSkosO/tsUp9d2JVyTA: bets $1
qxWFg3MZuVyidB0SJh5ywg: folds 
Uncalled bet ($1) returned to DIkeSkosO/tsUp9d2JVyTA
DIkeSkosO/tsUp9d2JVyTA collected $2.15 from pot
DIkeSkosO/tsUp9d2JVyTA: doesn't show hand 
*** SUMMARY ***
Total pot $2.25 | Rake $0.10 
Board [2s Qd 7s 7c]
Seat 1: Th3FldXKQW6hWVVPahaoOQ folded before Flop (didn't bet)
Seat 2: DIkeSkosO/tsUp9d2JVyTA collected ($2.15)
Seat 3: MtVtHDqIJTyUcXkRBBDIVA folded before Flop (didn't bet)
Seat 4: j4q3p0lesp63b1gZDwLBZw folded before Flop (didn't bet)
Seat 5: cZ99hugmLBj9KhTlc8nCSw (button) folded before Flop (didn't bet)
Seat 6: qxWFg3MZuVyidB0SJh5ywg (small blind) folded on the Turn
Seat 7: F7pnn6czNpHvRM55XcA2EA (big blind) folded before Flop
Seat 8: dfNim92Z6XK1/h5SFW5vDg folded before Flop (didn't bet)
Seat 9: qpG9m8I+cPw8VhB0mnGjYw folded before Flop (didn't bet)




PokerStars Game #59941589606:  Hold'em No Limit ($0.10/$0.25) - 2009/07/01 1:40:02 ET
Table 'PCxB2W9H6ma8SwsZlImuOw' 9-max Seat #1 is the button
Seat 1: SqibpGx+lf+brY0fJVvD0w ($24.15 in chips) 
Seat 2: wjH6l1gQaEfv+C45sAOwIQ ($38.30 in chips) 
Seat 3: J2a/QHAWUgo6beDRoEyg2g ($11.10 in chips) 
Seat 4: RsPwA2DnzOke3hD/Of/DUg ($2.90 in chips) 
Seat 5: GZO7tOXatVoX17M2DqPcUQ ($20.60 in chips) 
Seat 6: 5/6dWEBUHldD7iGXa2LwsQ ($16.45 in chips) 
Seat 7: c/9X4zftzphFxYtxp5kp9w ($26.80 in chips) 
Seat 8: Pt637jKksB5MzP0UNJAAkw ($25 in chips) 
Seat 9: COwSH15MvHaRF7en6/TRZQ ($4.65 in chips) 
wjH6l1gQaEfv+C45sAOwIQ: posts small blind $0.10
J2a/QHAWUgo6beDRoEyg2g: posts big blind $0.25
*** HOLE CARDS ***
RsPwA2DnzOke3hD/Of/DUg: folds 
GZO7tOXatVoX17M2DqPcUQ: folds 
5/6dWEBUHldD7iGXa2LwsQ: raises $0.50 to $0.75
c/9X4zftzphFxYtxp5kp9w: folds 
Pt637jKksB5MzP0UNJAAkw: folds 
COwSH15MvHaRF7en6/TRZQ: folds 
SqibpGx+lf+brY0fJVvD0w: folds 
wjH6l1gQaEfv+C45sAOwIQ: folds 
J2a/QHAWUgo6beDRoEyg2g: calls $0.50
*** FLOP *** [Qh Qd Ac]
J2a/QHAWUgo6beDRoEyg2g: checks 
5/6dWEBUHldD7iGXa2LwsQ: bets $1
J2a/QHAWUgo6beDRoEyg2g: folds 
Uncalled bet ($1) returned to 5/6dWEBUHldD7iGXa2LwsQ
5/6dWEBUHldD7iGXa2LwsQ collected $1.55 from pot
*** SUMMARY ***
Total pot $1.60 | Rake $0.05 
Board [Qh Qd Ac]
Seat 1: SqibpGx+lf+brY0fJVvD0w (button) folded before Flop (didn't bet)
Seat 2: wjH6l1gQaEfv+C45sAOwIQ (small blind) folded before Flop
Seat 3: J2a/QHAWUgo6beDRoEyg2g (big blind) folded on the Flop
Seat 4: RsPwA2DnzOke3hD/Of/DUg folded before Flop (didn't bet)
Seat 5: GZO7tOXatVoX17M2DqPcUQ folded before Flop (didn't bet)
Seat 6: 5/6dWEBUHldD7iGXa2LwsQ collected ($1.55)
Seat 7: c/9X4zftzphFxYtxp5kp9w folded before Flop (didn't bet)
Seat 8: Pt637jKksB5MzP0UNJAAkw folded before Flop (didn't bet)
Seat 9: COwSH15MvHaRF7en6/TRZQ folded before Flop (didn't bet)




PokerStars Game #59941589508:  Hold'em No Limit ($0.10/$0.25) - 2009/07/01 1:40:02 ET
Table 'ggwTHpIC5qhhHJSYjK1XCw' 6-max Seat #2 is the button
Seat 1: MqMK8OWPSY1V4stf1Hy5Jw ($79.20 in chips) 
Seat 2: /gJNBeCkWL4o85/jvlZ4BA ($26.85 in chips) 
Seat 3: SxIIgwXYLkwd6m3wLyPTCw ($66.25 in chips) 
Seat 4: JFIAqU8lCZ0vWwEl4bdGsg ($25 in chips) 
Seat 5: kfg2xIfDuWaPiWF3HjiKCw ($25 in chips) 
Seat 6: 732E3Iz0geWMK40ej+U9HA ($5 in chips) 
SxIIgwXYLkwd6m3wLyPTCw: posts small blind $0.10
JFIAqU8lCZ0vWwEl4bdGsg: posts big blind $0.25
*** HOLE CARDS ***
kfg2xIfDuWaPiWF3HjiKCw: folds 
kfg2xIfDuWaPiWF3HjiKCw leaves the table
732E3Iz0geWMK40ej+U9HA: folds 
MqMK8OWPSY1V4stf1Hy5Jw: folds 
/gJNBeCkWL4o85/jvlZ4BA: folds 
732E3Iz0geWMK40ej+U9HA said, "what a suckout"
BvqhBa7W/To51LhEiIU/lw joins the table at seat #5 
SxIIgwXYLkwd6m3wLyPTCw: folds 
Uncalled bet ($0.15) returned to JFIAqU8lCZ0vWwEl4bdGsg
JFIAqU8lCZ0vWwEl4bdGsg collected $0.20 from pot
JFIAqU8lCZ0vWwEl4bdGsg: doesn't show hand 
*** SUMMARY ***
Total pot $0.20 | Rake $0 
Seat 1: MqMK8OWPSY1V4stf1Hy5Jw folded before Flop (didn't bet)
Seat 2: /gJNBeCkWL4o85/jvlZ4BA (button) folded before Flop (didn't bet)
Seat 3: SxIIgwXYLkwd6m3wLyPTCw (small blind) folded before Flop
Seat 4: JFIAqU8lCZ0vWwEl4bdGsg (big blind) collected ($0.20)
Seat 5: kfg2xIfDuWaPiWF3HjiKCw folded before Flop (didn't bet)
Seat 6: 732E3Iz0geWMK40ej+U9HA folded before Flop (didn't bet)




PokerStars Game #59941589762:  Hold'em No Limit ($0.10/$0.25) - 2009/07/01 1:40:02 ET
Table '4UJB/UOZ5aepyF2v+hIoUg' 6-max Seat #3 is the button
Seat 1: 08V++DOqzaNrRNsHIwi25w ($27.10 in chips) 
Seat 2: mFv3iBCtrw9XfCDRB0d46Q ($3.60 in chips) 
Seat 3: zlYHXTtJ5tcx9kwK2h5n9A ($38.90 in chips) 
Seat 4: R6AGToFJQOYVZAjC2jXEKw ($22.70 in chips) 
Seat 5: 3zD3qLXT1bEffAoWGnc7wg ($26.25 in chips) 
Seat 6: 2aphcinkTZT0B0Uoah6cvQ ($18.10 in chips) 
R6AGToFJQOYVZAjC2jXEKw: posts small blind $0.10
3zD3qLXT1bEffAoWGnc7wg: posts big blind $0.25
*** HOLE CARDS ***
2aphcinkTZT0B0Uoah6cvQ: folds 
08V++DOqzaNrRNsHIwi25w: folds 
mFv3iBCtrw9XfCDRB0d46Q: raises $3.35 to $3.60 and is all-in
zlYHXTtJ5tcx9kwK2h5n9A: folds 
R6AGToFJQOYVZAjC2jXEKw: folds 
3zD3qLXT1bEffAoWGnc7wg: folds 
Uncalled bet ($3.35) returned to mFv3iBCtrw9XfCDRB0d46Q
mFv3iBCtrw9XfCDRB0d46Q collected $0.60 from pot
mFv3iBCtrw9XfCDRB0d46Q: doesn't show hand 
*** SUMMARY ***
Total pot $0.60 | Rake $0 
Seat 1: 08V++DOqzaNrRNsHIwi25w folded before Flop (didn't bet)
Seat 2: mFv3iBCtrw9XfCDRB0d46Q collected ($0.60)
Seat 3: zlYHXTtJ5tcx9kwK2h5n9A (button) folded before Flop (didn't bet)
Seat 4: R6AGToFJQOYVZAjC2jXEKw (small blind) folded before Flop
Seat 5: 3zD3qLXT1bEffAoWGnc7wg (big blind) folded before Flop
Seat 6: 2aphcinkTZT0B0Uoah6cvQ folded before Flop (didn't bet)




PokerStars Game #59941590162:  Hold'em No Limit ($0.10/$0.25) - 2009/07/01 1:40:03 ET
Table '63uh7ZsO7Tnt+E8b/2bu3A' 6-max Seat #6 is the button
Seat 1: 0av6tRNdi0Ui4f15L7gsVg ($26.25 in chips) 
Seat 2: SFmT9ZsVopnukjvAzrxTRg ($30.25 in chips) 
Seat 3: yVP7GLZBzx47OPi6jzUxMw ($15.85 in chips) 
Seat 4: 2tYgzzRRW/D2GWb2A7f1jw ($7.35 in chips) 
Seat 5: GbCVUNssQ7mqsPWr7J4d3w ($5 in chips) 
Seat 6: qGHGf/553gQnDoklMRe3tg ($32 in chips) 
0av6tRNdi0Ui4f15L7gsVg: posts small blind $0.10
SFmT9ZsVopnukjvAzrxTRg: posts big blind $0.25
*** HOLE CARDS ***
yVP7GLZBzx47OPi6jzUxMw: calls $0.25
2tYgzzRRW/D2GWb2A7f1jw: folds 
GbCVUNssQ7mqsPWr7J4d3w: calls $0.25
qGHGf/553gQnDoklMRe3tg: raises $1.25 to $1.50
0av6tRNdi0Ui4f15L7gsVg: calls $1.40
SFmT9ZsVopnukjvAzrxTRg: folds 
yVP7GLZBzx47OPi6jzUxMw: calls $1.25
GbCVUNssQ7mqsPWr7J4d3w: folds 
*** FLOP *** [Js 9c Kd]
0av6tRNdi0Ui4f15L7gsVg: bets $1.50
yVP7GLZBzx47OPi6jzUxMw: folds 
qGHGf/553gQnDoklMRe3tg: calls $1.50
*** TURN *** [Js 9c Kd] [6h]
0av6tRNdi0Ui4f15L7gsVg: bets $4.75
qGHGf/553gQnDoklMRe3tg: folds 
Uncalled bet ($4.75) returned to 0av6tRNdi0Ui4f15L7gsVg
0av6tRNdi0Ui4f15L7gsVg collected $7.65 from pot
0av6tRNdi0Ui4f15L7gsVg: doesn't show hand 
*** SUMMARY ***
Total pot $8 | Rake $0.35 
Board [Js 9c Kd 6h]
Seat 1: 0av6tRNdi0Ui4f15L7gsVg (small blind) collected ($7.65)
Seat 2: SFmT9ZsVopnukjvAzrxTRg (big blind) folded before Flop
Seat 3: yVP7GLZBzx47OPi6jzUxMw folded on the Flop
Seat 4: 2tYgzzRRW/D2GWb2A7f1jw folded before Flop (didn't bet)
Seat 5: GbCVUNssQ7mqsPWr7J4d3w folded before Flop
Seat 6: qGHGf/553gQnDoklMRe3tg (button) folded on the Turn




PokerStars Game #59941589910:  Hold'em No Limit ($0.10/$0.25) - 2009/07/01 1:40:03 ET
Table 'tq5CvS0RUqGkuBK0XTzqqg' 6-max Seat #5 is the button
Seat 1: +ZlnqPoP3Hg4BIUxDfKd/A ($31.55 in chips) 
Seat 2: 2m6ZFAdj01UZd4WtEySXXQ ($7.15 in chips) 
Seat 3: PbMzPZIePKifKQZfKDkbIw ($49.50 in chips) 
Seat 4: UT5XpwOH1ipkOF7n1MqDJA ($25 in chips) 
Seat 5: qGHGf/553gQnDoklMRe3tg ($29.70 in chips) 
Seat 6: L3/N/gliETan8N5Gim5h4Q ($25 in chips) 
L3/N/gliETan8N5Gim5h4Q: posts small blind $0.10
+ZlnqPoP3Hg4BIUxDfKd/A: posts big blind $0.25
*** HOLE CARDS ***
2m6ZFAdj01UZd4WtEySXXQ: folds 
PbMzPZIePKifKQZfKDkbIw: raises $0.75 to $1
UT5XpwOH1ipkOF7n1MqDJA: folds 
qGHGf/553gQnDoklMRe3tg: calls $1
L3/N/gliETan8N5Gim5h4Q: folds 
+ZlnqPoP3Hg4BIUxDfKd/A: folds 
*** FLOP *** [7h 3d Jd]
PbMzPZIePKifKQZfKDkbIw: bets $1.50
qGHGf/553gQnDoklMRe3tg: calls $1.50
*** TURN *** [7h 3d Jd] [5d]
PbMzPZIePKifKQZfKDkbIw: checks 
qGHGf/553gQnDoklMRe3tg: bets $4
PbMzPZIePKifKQZfKDkbIw: folds 
Uncalled bet ($4) returned to qGHGf/553gQnDoklMRe3tg
qGHGf/553gQnDoklMRe3tg collected $5.10 from pot
*** SUMMARY ***
Total pot $5.35 | Rake $0.25 
Board [7h 3d Jd 5d]
Seat 1: +ZlnqPoP3Hg4BIUxDfKd/A (big blind) folded before Flop
Seat 2: 2m6ZFAdj01UZd4WtEySXXQ folded before Flop (didn't bet)
Seat 3: PbMzPZIePKifKQZfKDkbIw folded on the Turn
Seat 4: UT5XpwOH1ipkOF7n1MqDJA folded before Flop (didn't bet)
Seat 5: qGHGf/553gQnDoklMRe3tg (button) collected ($5.10)
Seat 6: L3/N/gliETan8N5Gim5h4Q (small blind) folded before Flop




PokerStars Game #59941590074:  Hold'em No Limit ($0.10/$0.25) - 2009/07/01 1:40:03 ET
Table 'tANpk8z1C5o0Pq/hpYShHw' 9-max Seat #2 is the button
Seat 1: rQhYIYXSyH/IivYM1dlV5A ($17.05 in chips) 
Seat 2: og4yH4sZUZdC8jjgW8zPJQ ($8.10 in chips) 
Seat 3: zDrucyjVn5aeekNEc3cJrA ($18.30 in chips) 
Seat 6: kN0AWJG6biW8tHtuF+wTjA ($14.70 in chips) 
Seat 7: aNpwfA31EREwO+ar4XzBCw ($27.40 in chips) 
Seat 8: 5s3p6yoJBNW438dsyKTP8g ($21.80 in chips) 
Seat 9: gE5rN2TDY1aXcZn/TOPeZw ($7.80 in chips) 
zDrucyjVn5aeekNEc3cJrA: posts small blind $0.10
1S/fpm+f42V/6MNZre+ccg: is sitting out 
1S/fpm+f42V/6MNZre+ccg leaves the table
DdPXdieucQ+n99u1n3A+rQ: is sitting out 
kN0AWJG6biW8tHtuF+wTjA: posts big blind $0.25
*** HOLE CARDS ***
DdPXdieucQ+n99u1n3A+rQ leaves the table
aNpwfA31EREwO+ar4XzBCw: folds 
5s3p6yoJBNW438dsyKTP8g: folds 
gE5rN2TDY1aXcZn/TOPeZw: folds 
rQhYIYXSyH/IivYM1dlV5A: folds 
og4yH4sZUZdC8jjgW8zPJQ: calls $0.25
zDrucyjVn5aeekNEc3cJrA: calls $0.15
kN0AWJG6biW8tHtuF+wTjA: checks 
*** FLOP *** [Kh 5c Kc]
zDrucyjVn5aeekNEc3cJrA: checks 
kN0AWJG6biW8tHtuF+wTjA: checks 
og4yH4sZUZdC8jjgW8zPJQ: checks 
*** TURN *** [Kh 5c Kc] [4h]
zDrucyjVn5aeekNEc3cJrA: checks 
kN0AWJG6biW8tHtuF+wTjA: checks 
og4yH4sZUZdC8jjgW8zPJQ: checks 
*** RIVER *** [Kh 5c Kc 4h] [Kd]
zDrucyjVn5aeekNEc3cJrA: checks 
kN0AWJG6biW8tHtuF+wTjA: checks 
og4yH4sZUZdC8jjgW8zPJQ: bets $0.25
zDrucyjVn5aeekNEc3cJrA: folds 
kN0AWJG6biW8tHtuF+wTjA: folds 
Uncalled bet ($0.25) returned to og4yH4sZUZdC8jjgW8zPJQ
og4yH4sZUZdC8jjgW8zPJQ collected $0.75 from pot
zDrucyjVn5aeekNEc3cJrA is sitting out
*** SUMMARY ***
Total pot $0.75 | Rake $0 
Board [Kh 5c Kc 4h Kd]
Seat 1: rQhYIYXSyH/IivYM1dlV5A folded before Flop (didn't bet)
Seat 2: og4yH4sZUZdC8jjgW8zPJQ (button) collected ($0.75)
Seat 3: zDrucyjVn5aeekNEc3cJrA (small blind) folded on the River
Seat 6: kN0AWJG6biW8tHtuF+wTjA (big blind) folded on the River
Seat 7: aNpwfA31EREwO+ar4XzBCw folded before Flop (didn't bet)
Seat 8: 5s3p6yoJBNW438dsyKTP8g folded before Flop (didn't bet)
Seat 9: gE5rN2TDY1aXcZn/TOPeZw folded before Flop (didn't bet)




PokerStars Game #59941590278:  Hold'em No Limit ($0.10/$0.25) - 2009/07/01 1:40:03 ET
Table '9lYs7ljXi6AgFAxYHlKLJw' 9-max Seat #7 is the button
Seat 1: K0b5wNInj6hUGRr6yzKFtw ($33.90 in chips) 
Seat 3: arxNSjreDRGFg13EAM2F1w ($31.30 in chips) 
Seat 4: UANt6y/SmDCY/jIxkBixcw ($34.10 in chips) 
Seat 5: dfNim92Z6XK1/h5SFW5vDg ($52.70 in chips) 
Seat 6: tYsOBqdU1+x+yFI7zHO7hQ ($25.95 in chips) 
Seat 7: ghNKXUBl/H+t83JF079ZBA ($27.05 in chips) 
Seat 8: 9YN2IkT2JYYKFErZtZvCtA ($22.70 in chips) 
Seat 9: cKlmpQMahVsmOaxFQDcoOg ($20 in chips) 
9YN2IkT2JYYKFErZtZvCtA: posts small blind $0.10
cKlmpQMahVsmOaxFQDcoOg: posts big blind $0.25
0XACOSNrAWmqNv9k1nF8rw: sits out 
*** HOLE CARDS ***
K0b5wNInj6hUGRr6yzKFtw: folds 
arxNSjreDRGFg13EAM2F1w: folds 
UANt6y/SmDCY/jIxkBixcw: folds 
dfNim92Z6XK1/h5SFW5vDg: folds 
tYsOBqdU1+x+yFI7zHO7hQ: folds 
ghNKXUBl/H+t83JF079ZBA: folds 
9YN2IkT2JYYKFErZtZvCtA: folds 
Uncalled bet ($0.15) returned to cKlmpQMahVsmOaxFQDcoOg
cKlmpQMahVsmOaxFQDcoOg collected $0.20 from pot
*** SUMMARY ***
Total pot $0.20 | Rake $0 
Seat 1: K0b5wNInj6hUGRr6yzKFtw folded before Flop (didn't bet)
Seat 3: arxNSjreDRGFg13EAM2F1w folded before Flop (didn't bet)
Seat 4: UANt6y/SmDCY/jIxkBixcw folded before Flop (didn't bet)
Seat 5: dfNim92Z6XK1/h5SFW5vDg folded before Flop (didn't bet)
Seat 6: tYsOBqdU1+x+yFI7zHO7hQ folded before Flop (didn't bet)
Seat 7: ghNKXUBl/H+t83JF079ZBA (button) folded before Flop (didn't bet)
Seat 8: 9YN2IkT2JYYKFErZtZvCtA (small blind) folded before Flop
Seat 9: cKlmpQMahVsmOaxFQDcoOg (big blind) collected ($0.20)




PokerStars Game #59941589984:  Hold'em No Limit ($0.10/$0.25) - 2009/07/01 1:40:03 ET
Table 'pPgW4R3kdH26lLi1MnE92w' 9-max Seat #5 is the button
Seat 1: F4P6SxCNY4vxdb318G9RwA ($20.60 in chips) 
Seat 2: cZ99hugmLBj9KhTlc8nCSw ($27.50 in chips) 
Seat 3: WaS7+xnv4bIVHoru6nxczA ($13.75 in chips) 
Seat 4: 68iMVGMbYGvnpcCiPOVbbw ($4.65 in chips) 
Seat 5: HPEB+AtKw1+C/cxU0o1ciw ($21.55 in chips) 
Seat 6: VllYilcih0t+gMD4GTRlgQ ($26.15 in chips) 
Seat 7: sD+TKtt36XiiN6jqHiLwDA ($26.80 in chips) 
Seat 8: aCVg6cCxQcqClhB9nq/p1w ($31.20 in chips) 
VllYilcih0t+gMD4GTRlgQ: posts small blind $0.10
sD+TKtt36XiiN6jqHiLwDA: posts big blind $0.25
*** HOLE CARDS ***
aCVg6cCxQcqClhB9nq/p1w: folds 
tcbEu7VzyHQ+0lh+skbQhQ has returned
F4P6SxCNY4vxdb318G9RwA: calls $0.25
cZ99hugmLBj9KhTlc8nCSw: folds 
WaS7+xnv4bIVHoru6nxczA: folds 
68iMVGMbYGvnpcCiPOVbbw: folds 
HPEB+AtKw1+C/cxU0o1ciw: folds 
VllYilcih0t+gMD4GTRlgQ: calls $0.15
sD+TKtt36XiiN6jqHiLwDA: checks 
*** FLOP *** [8c Qh Tc]
VllYilcih0t+gMD4GTRlgQ: checks 
sD+TKtt36XiiN6jqHiLwDA: checks 
F4P6SxCNY4vxdb318G9RwA: bets $0.75
VllYilcih0t+gMD4GTRlgQ: folds 
sD+TKtt36XiiN6jqHiLwDA: calls $0.75
*** TURN *** [8c Qh Tc] [5d]
sD+TKtt36XiiN6jqHiLwDA: checks 
F4P6SxCNY4vxdb318G9RwA: checks 
*** RIVER *** [8c Qh Tc 5d] [6d]
sD+TKtt36XiiN6jqHiLwDA: checks 
F4P6SxCNY4vxdb318G9RwA: checks 
*** SHOW DOWN ***
sD+TKtt36XiiN6jqHiLwDA: shows [Ah Td] (a pair of Tens)
F4P6SxCNY4vxdb318G9RwA: mucks hand 
sD+TKtt36XiiN6jqHiLwDA collected $2.15 from pot
*** SUMMARY ***
Total pot $2.25 | Rake $0.10 
Board [8c Qh Tc 5d 6d]
Seat 1: F4P6SxCNY4vxdb318G9RwA mucked
Seat 2: cZ99hugmLBj9KhTlc8nCSw folded before Flop (didn't bet)
Seat 3: WaS7+xnv4bIVHoru6nxczA folded before Flop (didn't bet)
Seat 4: 68iMVGMbYGvnpcCiPOVbbw folded before Flop (didn't bet)
Seat 5: HPEB+AtKw1+C/cxU0o1ciw (button) folded before Flop (didn't bet)
Seat 6: VllYilcih0t+gMD4GTRlgQ (small blind) folded on the Flop
Seat 7: sD+TKtt36XiiN6jqHiLwDA (big blind) showed [Ah Td] and won ($2.15) with a pair of Tens
Seat 8: aCVg6cCxQcqClhB9nq/p1w folded before Flop (didn't bet)




PokerStars Game #59941589906:  Hold'em No Limit ($0.10/$0.25) - 2009/07/01 1:40:03 ET
Table 'hOE09W281uSob0XeJmUcRg' 6-max Seat #4 is the button
Seat 1: mfrkWA3PTeYPkbO6hi98Aw ($27.65 in chips) 
Seat 2: lYjWCpfCxX2kgcHY3v4Yow ($28.85 in chips) 
Seat 3: y+a/yGW/Jy4bPJFnaeTz5w ($13.40 in chips) 
Seat 4: TslQs7AQSLbVtr4X8JOOOQ ($16.65 in chips) 
Seat 5: JFIAqU8lCZ0vWwEl4bdGsg ($25.10 in chips) 
JFIAqU8lCZ0vWwEl4bdGsg: posts small blind $0.10
mfrkWA3PTeYPkbO6hi98Aw: posts big blind $0.25
*** HOLE CARDS ***
lYjWCpfCxX2kgcHY3v4Yow: folds 
y+a/yGW/Jy4bPJFnaeTz5w: folds 
TslQs7AQSLbVtr4X8JOOOQ: folds 
x4ZJ8E/TUrtoB7WiHcv8WA has returned
JFIAqU8lCZ0vWwEl4bdGsg: folds 
Uncalled bet ($0.15) returned to mfrkWA3PTeYPkbO6hi98Aw
mfrkWA3PTeYPkbO6hi98Aw collected $0.20 from pot
mfrkWA3PTeYPkbO6hi98Aw: doesn't show hand 
*** SUMMARY ***
Total pot $0.20 | Rake $0 
Seat 1: mfrkWA3PTeYPkbO6hi98Aw (big blind) collected ($0.20)
Seat 2: lYjWCpfCxX2kgcHY3v4Yow folded before Flop (didn't bet)
Seat 3: y+a/yGW/Jy4bPJFnaeTz5w folded before Flop (didn't bet)
Seat 4: TslQs7AQSLbVtr4X8JOOOQ (button) folded before Flop (didn't bet)
Seat 5: JFIAqU8lCZ0vWwEl4bdGsg (small blind) folded before Flop




PokerStars Game #59941589966:  Hold'em No Limit ($0.10/$0.25) - 2009/07/01 1:40:03 ET
Table 'nlpa8xI95gAflovnFxB2yg' 6-max Seat #1 is the button
Seat 1: fZQg9veL7Dd/Z04ZTjC+wQ ($62.85 in chips) 
Seat 2: Yuyy/pDz3yAO3EbHYRYnKw ($25.40 in chips) 
Seat 3: DihMHaz4WNETH1bPDe13kA ($25.80 in chips) 
Seat 5: FDWzjQgBA5K04jOIY/j22w ($9.20 in chips) 
Seat 6: ATNFxN8fYVfSZMQW8dvbvw ($6.65 in chips) 
Yuyy/pDz3yAO3EbHYRYnKw: posts small blind $0.10
DihMHaz4WNETH1bPDe13kA: posts big blind $0.25
if4dh6jhJXeN3/qd3qCp9g: sits out 
*** HOLE CARDS ***
FDWzjQgBA5K04jOIY/j22w: calls $0.25
ATNFxN8fYVfSZMQW8dvbvw: calls $0.25
fZQg9veL7Dd/Z04ZTjC+wQ: calls $0.25
Yuyy/pDz3yAO3EbHYRYnKw: calls $0.15
DihMHaz4WNETH1bPDe13kA: checks 
*** FLOP *** [Ad Td 6d]
Yuyy/pDz3yAO3EbHYRYnKw: checks 
DihMHaz4WNETH1bPDe13kA: checks 
FDWzjQgBA5K04jOIY/j22w: checks 
ATNFxN8fYVfSZMQW8dvbvw: bets $0.25
fZQg9veL7Dd/Z04ZTjC+wQ: raises $0.50 to $0.75
Yuyy/pDz3yAO3EbHYRYnKw: folds 
DihMHaz4WNETH1bPDe13kA: folds 
FDWzjQgBA5K04jOIY/j22w: folds 
ATNFxN8fYVfSZMQW8dvbvw: folds 
Uncalled bet ($0.50) returned to fZQg9veL7Dd/Z04ZTjC+wQ
fZQg9veL7Dd/Z04ZTjC+wQ collected $1.70 from pot
fZQg9veL7Dd/Z04ZTjC+wQ: doesn't show hand 
*** SUMMARY ***
Total pot $1.75 | Rake $0.05 
Board [Ad Td 6d]
Seat 1: fZQg9veL7Dd/Z04ZTjC+wQ (button) collected ($1.70)
Seat 2: Yuyy/pDz3yAO3EbHYRYnKw (small blind) folded on the Flop
Seat 3: DihMHaz4WNETH1bPDe13kA (big blind) folded on the Flop
Seat 5: FDWzjQgBA5K04jOIY/j22w folded on the Flop
Seat 6: ATNFxN8fYVfSZMQW8dvbvw folded on the Flop




PokerStars Game #59941590552:  Hold'em No Limit ($0.10/$0.25) - 2009/07/01 1:40:04 ET
Table 'CBnRhp0d6E2+/NtM7Vbruw' 9-max Seat #9 is the button
Seat 1: WQe4GbiYBiPsb5WKFKkijQ ($11.80 in chips) 
Seat 2: cZ99hugmLBj9KhTlc8nCSw ($25 in chips) 
Seat 3: aNpwfA31EREwO+ar4XzBCw ($34.05 in chips) 
Seat 4: EBI5F+kilCiSAA25omTumQ ($20.55 in chips) 
Seat 5: CT7Xj/V/O5rBlhtt+RZeFQ ($25 in chips) 
Seat 6: CvL9Ch1HYCVbTsfpNucitg ($4.65 in chips) 
Seat 7: j4q3p0lesp63b1gZDwLBZw ($5 in chips) 
Seat 8: MG90wfSJZnOejs/KD3vlQQ ($25 in chips) 
Seat 9: xHZZRLAaFUIC8WWI8ljOJA ($29.90 in chips) 
WQe4GbiYBiPsb5WKFKkijQ: posts small blind $0.10
cZ99hugmLBj9KhTlc8nCSw: posts big blind $0.25
*** HOLE CARDS ***
aNpwfA31EREwO+ar4XzBCw: folds 
EBI5F+kilCiSAA25omTumQ: folds 
CT7Xj/V/O5rBlhtt+RZeFQ: folds 
CvL9Ch1HYCVbTsfpNucitg: folds 
xHZZRLAaFUIC8WWI8ljOJA said, "maybe slow down a little bit in that button captain :)"
j4q3p0lesp63b1gZDwLBZw: folds 
MG90wfSJZnOejs/KD3vlQQ: folds 
xHZZRLAaFUIC8WWI8ljOJA: folds 
WQe4GbiYBiPsb5WKFKkijQ: calls $0.15
cZ99hugmLBj9KhTlc8nCSw: checks 
*** FLOP *** [2h 7c 7h]
WQe4GbiYBiPsb5WKFKkijQ: checks 
cZ99hugmLBj9KhTlc8nCSw: checks 
*** TURN *** [2h 7c 7h] [4c]
WQe4GbiYBiPsb5WKFKkijQ: checks 
cZ99hugmLBj9KhTlc8nCSw: bets $0.50
WQe4GbiYBiPsb5WKFKkijQ: folds 
Uncalled bet ($0.50) returned to cZ99hugmLBj9KhTlc8nCSw
cZ99hugmLBj9KhTlc8nCSw collected $0.50 from pot
*** SUMMARY ***
Total pot $0.50 | Rake $0 
Board [2h 7c 7h 4c]
Seat 1: WQe4GbiYBiPsb5WKFKkijQ (small blind) folded on the Turn
Seat 2: cZ99hugmLBj9KhTlc8nCSw (big blind) collected ($0.50)
Seat 3: aNpwfA31EREwO+ar4XzBCw folded before Flop (didn't bet)
Seat 4: EBI5F+kilCiSAA25omTumQ folded before Flop (didn't bet)
Seat 5: CT7Xj/V/O5rBlhtt+RZeFQ folded before Flop (didn't bet)
Seat 6: CvL9Ch1HYCVbTsfpNucitg folded before Flop (didn't bet)
Seat 7: j4q3p0lesp63b1gZDwLBZw folded before Flop (didn't bet)
Seat 8: MG90wfSJZnOejs/KD3vlQQ folded before Flop (didn't bet)
Seat 9: xHZZRLAaFUIC8WWI8ljOJA (button) folded before Flop (didn't bet)




PokerStars Game #59941590808:  Hold'em No Limit ($0.10/$0.25) - 2009/07/01 1:40:04 ET
Table '50f2Xa1b1jp6cfdTAgXFIg' 9-max Seat #2 is the button
Seat 1: pplNliE3WonjkPRf+GZq2A ($25 in chips) 
Seat 2: qxWFg3MZuVyidB0SJh5ywg ($28.45 in chips) 
Seat 3: RSojRXQHk0IRANbJYopT9g ($27 in chips) 
Seat 4: ghNKXUBl/H+t83JF079ZBA ($28.45 in chips) 
Seat 5: C1w4aCCgQVVSgNijoEahAg ($10.50 in chips) 
Seat 6: tLcDklc2rBORNfixyRfVfw ($25 in chips) 
Seat 7: w1ukf8uPa4+WH561TtVRxA ($25 in chips) 
Seat 8: x+W5+3qsdY4Iszf0hoH+Aw ($14.90 in chips) 
Seat 9: gehe91e0IyVT0QU/XBkEyg ($25.15 in chips) 
RSojRXQHk0IRANbJYopT9g: posts small blind $0.10
ghNKXUBl/H+t83JF079ZBA: posts big blind $0.25
pplNliE3WonjkPRf+GZq2A: posts big blind $0.25
*** HOLE CARDS ***
C1w4aCCgQVVSgNijoEahAg: folds 
tLcDklc2rBORNfixyRfVfw: calls $0.25
w1ukf8uPa4+WH561TtVRxA: folds 
x+W5+3qsdY4Iszf0hoH+Aw: folds 
gehe91e0IyVT0QU/XBkEyg: folds 
pplNliE3WonjkPRf+GZq2A: checks 
qxWFg3MZuVyidB0SJh5ywg: raises $0.75 to $1
RSojRXQHk0IRANbJYopT9g: folds 
ghNKXUBl/H+t83JF079ZBA: folds 
tLcDklc2rBORNfixyRfVfw: calls $0.75
pplNliE3WonjkPRf+GZq2A: folds 
*** FLOP *** [5d Kh Js]
tLcDklc2rBORNfixyRfVfw: checks 
qxWFg3MZuVyidB0SJh5ywg: bets $2
tLcDklc2rBORNfixyRfVfw: folds 
Uncalled bet ($2) returned to qxWFg3MZuVyidB0SJh5ywg
qxWFg3MZuVyidB0SJh5ywg collected $2.50 from pot
*** SUMMARY ***
Total pot $2.60 | Rake $0.10 
Board [5d Kh Js]
Seat 1: pplNliE3WonjkPRf+GZq2A folded before Flop
Seat 2: qxWFg3MZuVyidB0SJh5ywg (button) collected ($2.50)
Seat 3: RSojRXQHk0IRANbJYopT9g (small blind) folded before Flop
Seat 4: ghNKXUBl/H+t83JF079ZBA (big blind) folded before Flop
Seat 5: C1w4aCCgQVVSgNijoEahAg folded before Flop (didn't bet)
Seat 6: tLcDklc2rBORNfixyRfVfw folded on the Flop
Seat 7: w1ukf8uPa4+WH561TtVRxA folded before Flop (didn't bet)
Seat 8: x+W5+3qsdY4Iszf0hoH+Aw folded before Flop (didn't bet)
Seat 9: gehe91e0IyVT0QU/XBkEyg folded before Flop (didn't bet)




PokerStars Game #59941590778:  Hold'em No Limit ($0.10/$0.25) - 2009/07/01 1:40:04 ET
Table '84TjTrgbsYZladOc4PWf4Q' 6-max Seat #4 is the button
Seat 1: /kW0t5kKllzd8HO2uEapHQ ($24.95 in chips) 
Seat 2: RpaEX9P7BCvyfPRLiRNg0A ($39.60 in chips) 
Seat 3: Ar4vsUIUfJ7gbYh1c1m59g ($12.35 in chips) 
Seat 4: SxIIgwXYLkwd6m3wLyPTCw ($21.95 in chips) 
Seat 5: cezpHJ8FB07dj0xG+LhOvw ($25 in chips) 
Seat 6: wCUaomJ6Nq5zomVGdUHP+w ($19.50 in chips) 
cezpHJ8FB07dj0xG+LhOvw: posts small blind $0.10
wCUaomJ6Nq5zomVGdUHP+w: posts big blind $0.25
*** HOLE CARDS ***
/kW0t5kKllzd8HO2uEapHQ: folds 
RpaEX9P7BCvyfPRLiRNg0A: calls $0.25
Ar4vsUIUfJ7gbYh1c1m59g: folds 
SxIIgwXYLkwd6m3wLyPTCw has timed out
SxIIgwXYLkwd6m3wLyPTCw: folds 
SxIIgwXYLkwd6m3wLyPTCw is sitting out
SxIIgwXYLkwd6m3wLyPTCw has returned
cezpHJ8FB07dj0xG+LhOvw: folds 
wCUaomJ6Nq5zomVGdUHP+w: checks 
*** FLOP *** [5d Kh 9s]
wCUaomJ6Nq5zomVGdUHP+w: checks 
RpaEX9P7BCvyfPRLiRNg0A: checks 
*** TURN *** [5d Kh 9s] [9c]
wCUaomJ6Nq5zomVGdUHP+w: checks 
RpaEX9P7BCvyfPRLiRNg0A: bets $0.75
wCUaomJ6Nq5zomVGdUHP+w: folds 
Uncalled bet ($0.75) returned to RpaEX9P7BCvyfPRLiRNg0A
RpaEX9P7BCvyfPRLiRNg0A collected $0.60 from pot
*** SUMMARY ***
Total pot $0.60 | Rake $0 
Board [5d Kh 9s 9c]
Seat 1: /kW0t5kKllzd8HO2uEapHQ folded before Flop (didn't bet)
Seat 2: RpaEX9P7BCvyfPRLiRNg0A collected ($0.60)
Seat 3: Ar4vsUIUfJ7gbYh1c1m59g folded before Flop (didn't bet)
Seat 4: SxIIgwXYLkwd6m3wLyPTCw (button) folded before Flop (didn't bet)
Seat 5: cezpHJ8FB07dj0xG+LhOvw (small blind) folded before Flop
Seat 6: wCUaomJ6Nq5zomVGdUHP+w (big blind) folded on the Turn




PokerStars Game #59941590514:  Hold'em No Limit ($0.10/$0.25) - 2009/07/01 1:40:04 ET
Table 'AHkg4ChqzcMauBx6Qvz8Nw' 6-max Seat #3 is the button
Seat 1: +RDf7SmUjY2kK0PzdBEYqg ($4.60 in chips) 
Seat 2: Vi0JMrTI2BGrPL7UIulJtA ($5.90 in chips) 
Seat 3: 9dToMv2GJLfi00HcpfMnIw ($24.65 in chips) 
Seat 4: Eznneya0vB6S+eXJdVleHA ($19.90 in chips) 
Seat 5: Bada343Si4xKu3fNXY99AA ($5.25 in chips) 
Seat 6: Hsvkc0/G2VV78oVmWYXecw ($5.10 in chips) 
Eznneya0vB6S+eXJdVleHA: posts small blind $0.10
Bada343Si4xKu3fNXY99AA: posts big blind $0.25
*** HOLE CARDS ***
Hsvkc0/G2VV78oVmWYXecw: folds 
+RDf7SmUjY2kK0PzdBEYqg: calls $0.25
Vi0JMrTI2BGrPL7UIulJtA: folds 
9dToMv2GJLfi00HcpfMnIw: folds 
Eznneya0vB6S+eXJdVleHA: calls $0.15
Bada343Si4xKu3fNXY99AA: checks 
*** FLOP *** [8s 3h 5h]
Eznneya0vB6S+eXJdVleHA: checks 
Bada343Si4xKu3fNXY99AA: checks 
+RDf7SmUjY2kK0PzdBEYqg: checks 
*** TURN *** [8s 3h 5h] [Qd]
Eznneya0vB6S+eXJdVleHA: checks 
Bada343Si4xKu3fNXY99AA: bets $0.25
+RDf7SmUjY2kK0PzdBEYqg: calls $0.25
Eznneya0vB6S+eXJdVleHA: folds 
*** RIVER *** [8s 3h 5h Qd] [8h]
Bada343Si4xKu3fNXY99AA: checks 
+RDf7SmUjY2kK0PzdBEYqg: checks 
*** SHOW DOWN ***
Bada343Si4xKu3fNXY99AA: shows [5d Kc] (two pair, Eights and Fives)
+RDf7SmUjY2kK0PzdBEYqg: mucks hand 
Bada343Si4xKu3fNXY99AA collected $1.20 from pot
*** SUMMARY ***
Total pot $1.25 | Rake $0.05 
Board [8s 3h 5h Qd 8h]
Seat 1: +RDf7SmUjY2kK0PzdBEYqg mucked
Seat 2: Vi0JMrTI2BGrPL7UIulJtA folded before Flop (didn't bet)
Seat 3: 9dToMv2GJLfi00HcpfMnIw (button) folded before Flop (didn't bet)
Seat 4: Eznneya0vB6S+eXJdVleHA (small blind) folded on the Turn
Seat 5: Bada343Si4xKu3fNXY99AA (big blind) showed [5d Kc] and won ($1.20) with two pair, Eights and Fives
Seat 6: Hsvkc0/G2VV78oVmWYXecw folded before Flop (didn't bet)




PokerStars Game #59941590464:  Hold'em No Limit ($0.10/$0.25) - 2009/07/01 1:40:04 ET
Table '29D3eoQzK5kOAT0OIDS2uQ' 6-max Seat #5 is the button
Seat 1: kG34n23qFQA3nzdOJTQ1dA ($46.50 in chips) 
Seat 2: FyE+TQ5JcCqI/tCCHf0jGA ($16.65 in chips) 
Seat 3: z3tQwy28dp5FykDJC/wzQw ($18.15 in chips) 
Seat 4: MqMK8OWPSY1V4stf1Hy5Jw ($32.30 in chips) 
Seat 5: Q3EMN7b0ie81AFWkDrhCjw ($20.05 in chips) 
Seat 6: bWbV4MVB/vVpiES1Ut4hew ($37.80 in chips) 
bWbV4MVB/vVpiES1Ut4hew: posts small blind $0.10
kG34n23qFQA3nzdOJTQ1dA: posts big blind $0.25
*** HOLE CARDS ***
FyE+TQ5JcCqI/tCCHf0jGA: folds 
z3tQwy28dp5FykDJC/wzQw: folds 
MqMK8OWPSY1V4stf1Hy5Jw: folds 
Q3EMN7b0ie81AFWkDrhCjw: calls $0.25
bWbV4MVB/vVpiES1Ut4hew: folds 
kG34n23qFQA3nzdOJTQ1dA: checks 
*** FLOP *** [2h 7c 6c]
kG34n23qFQA3nzdOJTQ1dA: checks 
Q3EMN7b0ie81AFWkDrhCjw: bets $0.50
kG34n23qFQA3nzdOJTQ1dA: folds 
Uncalled bet ($0.50) returned to Q3EMN7b0ie81AFWkDrhCjw
FyE+TQ5JcCqI/tCCHf0jGA is sitting out
Q3EMN7b0ie81AFWkDrhCjw collected $0.60 from pot
*** SUMMARY ***
Total pot $0.60 | Rake $0 
Board [2h 7c 6c]
Seat 1: kG34n23qFQA3nzdOJTQ1dA (big blind) folded on the Flop
Seat 2: FyE+TQ5JcCqI/tCCHf0jGA folded before Flop (didn't bet)
Seat 3: z3tQwy28dp5FykDJC/wzQw folded before Flop (didn't bet)
Seat 4: MqMK8OWPSY1V4stf1Hy5Jw folded before Flop (didn't bet)
Seat 5: Q3EMN7b0ie81AFWkDrhCjw (button) collected ($0.60)
Seat 6: bWbV4MVB/vVpiES1Ut4hew (small blind) folded before Flop




PokerStars Game #59941591200:  Hold'em No Limit ($0.10/$0.25) - 2009/07/01 1:40:05 ET
Table 'i93c3z9RLowvuJTKA2F4Jg' 6-max Seat #1 is the button
Seat 1: tbSZq5LHglyHk61mH9eDBw ($34.90 in chips) 
Seat 2: TSmua8tGK3sTbwi0ynrW9Q ($30.05 in chips) 
Seat 3: v8m8XHovI5tqEA9mvplDSw ($31.65 in chips) 
Seat 4: o86X2Q5GEDU3uP9oj1iFZA ($23.30 in chips) 
Seat 5: lYjWCpfCxX2kgcHY3v4Yow ($36 in chips) 
Seat 6: FpN4KbLjlyRRKiVaQcoLqA ($20 in chips) 
TSmua8tGK3sTbwi0ynrW9Q: posts small blind $0.10
v8m8XHovI5tqEA9mvplDSw: posts big blind $0.25
FpN4KbLjlyRRKiVaQcoLqA: posts big blind $0.25
*** HOLE CARDS ***
o86X2Q5GEDU3uP9oj1iFZA: raises $0.75 to $1
lYjWCpfCxX2kgcHY3v4Yow: folds 
FpN4KbLjlyRRKiVaQcoLqA: calls $0.75
tbSZq5LHglyHk61mH9eDBw: calls $1
TSmua8tGK3sTbwi0ynrW9Q: folds 
v8m8XHovI5tqEA9mvplDSw: folds 
*** FLOP *** [As 2s Qh]
o86X2Q5GEDU3uP9oj1iFZA: bets $2.50
FpN4KbLjlyRRKiVaQcoLqA: folds 
tbSZq5LHglyHk61mH9eDBw: calls $2.50
*** TURN *** [As 2s Qh] [7h]
o86X2Q5GEDU3uP9oj1iFZA: checks 
tbSZq5LHglyHk61mH9eDBw: checks 
*** RIVER *** [As 2s Qh 7h] [7c]
o86X2Q5GEDU3uP9oj1iFZA: checks 
tbSZq5LHglyHk61mH9eDBw: bets $5
o86X2Q5GEDU3uP9oj1iFZA: calls $5
*** SHOW DOWN ***
tbSZq5LHglyHk61mH9eDBw: shows [Ks 6s] (a pair of Sevens)
o86X2Q5GEDU3uP9oj1iFZA: shows [3d 3s] (two pair, Sevens and Threes)
o86X2Q5GEDU3uP9oj1iFZA collected $17.50 from pot
*** SUMMARY ***
Total pot $18.35 | Rake $0.85 
Board [As 2s Qh 7h 7c]
Seat 1: tbSZq5LHglyHk61mH9eDBw (button) showed [Ks 6s] and lost with a pair of Sevens
Seat 2: TSmua8tGK3sTbwi0ynrW9Q (small blind) folded before Flop
Seat 3: v8m8XHovI5tqEA9mvplDSw (big blind) folded before Flop
Seat 4: o86X2Q5GEDU3uP9oj1iFZA showed [3d 3s] and won ($17.50) with two pair, Sevens and Threes
Seat 5: lYjWCpfCxX2kgcHY3v4Yow folded before Flop (didn't bet)
Seat 6: FpN4KbLjlyRRKiVaQcoLqA folded on the Flop




PokerStars Game #59941590910:  Hold'em No Limit ($0.10/$0.25) - 2009/07/01 1:40:05 ET
Table 'Xi38lWH8L2JHRAsKYVX8Qg' 6-max Seat #6 is the button
Seat 1: shP7DFAtX7gXcgMJX/OmRQ ($20.15 in chips) 
Seat 2: VOmI0x4dDPnTESZd5B4d1Q ($10.10 in chips) 
Seat 3: 6DwBRH+xZ12AAZmeAg+aXw ($30.60 in chips) 
Seat 4: kG34n23qFQA3nzdOJTQ1dA ($26.75 in chips) 
Seat 5: 79ID/ub1Pt/mDpCprVmOoA ($65.15 in chips) 
Seat 6: kyRaCIljYA6l33lSKQfNsg ($44.15 in chips) 
shP7DFAtX7gXcgMJX/OmRQ: posts small blind $0.10
VOmI0x4dDPnTESZd5B4d1Q: posts big blind $0.25
*** HOLE CARDS ***
6DwBRH+xZ12AAZmeAg+aXw: folds 
kG34n23qFQA3nzdOJTQ1dA: folds 
79ID/ub1Pt/mDpCprVmOoA: raises $0.50 to $0.75
kyRaCIljYA6l33lSKQfNsg: calls $0.75
shP7DFAtX7gXcgMJX/OmRQ: folds 
VOmI0x4dDPnTESZd5B4d1Q: folds 
*** FLOP *** [2h Tc Kd]
79ID/ub1Pt/mDpCprVmOoA: bets $1.50
kyRaCIljYA6l33lSKQfNsg: calls $1.50
*** TURN *** [2h Tc Kd] [Th]
79ID/ub1Pt/mDpCprVmOoA: bets $3.50
kyRaCIljYA6l33lSKQfNsg: calls $3.50
*** RIVER *** [2h Tc Kd Th] [3d]
79ID/ub1Pt/mDpCprVmOoA: bets $9
kyRaCIljYA6l33lSKQfNsg: calls $9
*** SHOW DOWN ***
79ID/ub1Pt/mDpCprVmOoA: shows [Td Jd] (three of a kind, Tens)
kyRaCIljYA6l33lSKQfNsg: mucks hand 
79ID/ub1Pt/mDpCprVmOoA collected $28.40 from pot
*** SUMMARY ***
Total pot $29.85 | Rake $1.45 
Board [2h Tc Kd Th 3d]
Seat 1: shP7DFAtX7gXcgMJX/OmRQ (small blind) folded before Flop
Seat 2: VOmI0x4dDPnTESZd5B4d1Q (big blind) folded before Flop
Seat 3: 6DwBRH+xZ12AAZmeAg+aXw folded before Flop (didn't bet)
Seat 4: kG34n23qFQA3nzdOJTQ1dA folded before Flop (didn't bet)
Seat 5: 79ID/ub1Pt/mDpCprVmOoA showed [Td Jd] and won ($28.40) with three of a kind, Tens
Seat 6: kyRaCIljYA6l33lSKQfNsg (button) mucked




PokerStars Game #59941591376:  Hold'em No Limit ($0.10/$0.25) - 2009/07/01 1:40:05 ET
Table '+fuYjvJy9okLr23QyZtanA' 9-max Seat #4 is the button
Seat 1: l9hUFnOCgg4TPYga9bvxhw ($10.70 in chips) 
Seat 2: tLcDklc2rBORNfixyRfVfw ($25.10 in chips) 
Seat 3: eK8qa6EPcH2zhtbmWSvc9g ($52.30 in chips) 
Seat 4: Bb42QRQMhg5/Y0vHP8/2Xw ($30.50 in chips) 
Seat 5: bXpVeaSTPBFSPJmeXxO7nw ($4.75 in chips) 
Seat 6: wGigCmBR/9XWkPpvYos3aQ ($26.15 in chips) 
Seat 7: dfNim92Z6XK1/h5SFW5vDg ($26.55 in chips) 
Seat 8: qpG9m8I+cPw8VhB0mnGjYw ($17.75 in chips) 
Seat 9: OMhlmt2waO3z43ZSFNMmog ($29.15 in chips) 
bXpVeaSTPBFSPJmeXxO7nw: posts small blind $0.10
wGigCmBR/9XWkPpvYos3aQ: posts big blind $0.25
*** HOLE CARDS ***
dfNim92Z6XK1/h5SFW5vDg: folds 
qpG9m8I+cPw8VhB0mnGjYw: folds 
OMhlmt2waO3z43ZSFNMmog: folds 
l9hUFnOCgg4TPYga9bvxhw: folds 
tLcDklc2rBORNfixyRfVfw: folds 
eK8qa6EPcH2zhtbmWSvc9g: calls $0.25
Bb42QRQMhg5/Y0vHP8/2Xw: folds 
bXpVeaSTPBFSPJmeXxO7nw: folds 
wGigCmBR/9XWkPpvYos3aQ: checks 
*** FLOP *** [Kh 6c As]
wGigCmBR/9XWkPpvYos3aQ: checks 
eK8qa6EPcH2zhtbmWSvc9g: bets $0.35
wGigCmBR/9XWkPpvYos3aQ: folds 
Uncalled bet ($0.35) returned to eK8qa6EPcH2zhtbmWSvc9g
eK8qa6EPcH2zhtbmWSvc9g collected $0.60 from pot
eK8qa6EPcH2zhtbmWSvc9g: doesn't show hand 
*** SUMMARY ***
Total pot $0.60 | Rake $0 
Board [Kh 6c As]
Seat 1: l9hUFnOCgg4TPYga9bvxhw folded before Flop (didn't bet)
Seat 2: tLcDklc2rBORNfixyRfVfw folded before Flop (didn't bet)
Seat 3: eK8qa6EPcH2zhtbmWSvc9g collected ($0.60)
Seat 4: Bb42QRQMhg5/Y0vHP8/2Xw (button) folded before Flop (didn't bet)
Seat 5: bXpVeaSTPBFSPJmeXxO7nw (small blind) folded before Flop
Seat 6: wGigCmBR/9XWkPpvYos3aQ (big blind) folded on the Flop
Seat 7: dfNim92Z6XK1/h5SFW5vDg folded before Flop (didn't bet)
Seat 8: qpG9m8I+cPw8VhB0mnGjYw folded before Flop (didn't bet)
Seat 9: OMhlmt2waO3z43ZSFNMmog folded before Flop (didn't bet)




PokerStars Game #59941591290:  Hold'em No Limit ($0.10/$0.25) - 2009/07/01 1:40:05 ET
Table 'IIO2q2znuuAXmiZ2qFTcmg' 6-max Seat #2 is the button
Seat 1: 2G0C7dp4wlPpE21FHjjElQ ($25 in chips) 
Seat 2: cS21pIxRHx5Gt42o7hPZzw ($12.95 in chips) 
Seat 3: L3/N/gliETan8N5Gim5h4Q ($25.10 in chips) 
Seat 4: tSR4329m40dZsN7YOpI9Kw ($59.60 in chips) 
Seat 5: GJsS3gwVwlbyroaWrnjqJg ($35.25 in chips) 
L3/N/gliETan8N5Gim5h4Q: posts small blind $0.10
tSR4329m40dZsN7YOpI9Kw: posts big blind $0.25
*** HOLE CARDS ***
GJsS3gwVwlbyroaWrnjqJg: folds 
2G0C7dp4wlPpE21FHjjElQ: folds 
cS21pIxRHx5Gt42o7hPZzw: folds 
L3/N/gliETan8N5Gim5h4Q: folds 
Uncalled bet ($0.15) returned to tSR4329m40dZsN7YOpI9Kw
GJsS3gwVwlbyroaWrnjqJg is sitting out
tSR4329m40dZsN7YOpI9Kw collected $0.20 from pot
*** SUMMARY ***
Total pot $0.20 | Rake $0 
Seat 1: 2G0C7dp4wlPpE21FHjjElQ folded before Flop (didn't bet)
Seat 2: cS21pIxRHx5Gt42o7hPZzw (button) folded before Flop (didn't bet)
Seat 3: L3/N/gliETan8N5Gim5h4Q (small blind) folded before Flop
Seat 4: tSR4329m40dZsN7YOpI9Kw (big blind) collected ($0.20)
Seat 5: GJsS3gwVwlbyroaWrnjqJg folded before Flop (didn't bet)




PokerStars Game #59941591264:  Hold'em No Limit ($0.10/$0.25) - 2009/07/01 1:40:05 ET
Table 'VQNfcI8vTBCTvRfd3veTLQ' 6-max Seat #3 is the button
Seat 2: 79ID/ub1Pt/mDpCprVmOoA ($30.20 in chips) 
Seat 3: LtASJ9OlkqGrrUKGQlpGAw ($12.10 in chips) 
Seat 4: QIWnfLSqfMcoFfdDe5LZPg ($40.80 in chips) 
Seat 5: gX2vbKwS/8zZPENAWB7hxQ ($22.65 in chips) 
Seat 6: LJI7A1YgDM7hgh7o56+ReQ ($27.35 in chips) 
QIWnfLSqfMcoFfdDe5LZPg: posts small blind $0.10
gX2vbKwS/8zZPENAWB7hxQ: posts big blind $0.25
*** HOLE CARDS ***
LJI7A1YgDM7hgh7o56+ReQ: raises $0.75 to $1
79ID/ub1Pt/mDpCprVmOoA: folds 
LtASJ9OlkqGrrUKGQlpGAw: folds 
QIWnfLSqfMcoFfdDe5LZPg: folds 
gX2vbKwS/8zZPENAWB7hxQ: folds 
Uncalled bet ($0.75) returned to LJI7A1YgDM7hgh7o56+ReQ
LJI7A1YgDM7hgh7o56+ReQ collected $0.60 from pot
LJI7A1YgDM7hgh7o56+ReQ: doesn't show hand 
*** SUMMARY ***
Total pot $0.60 | Rake $0 
Seat 2: 79ID/ub1Pt/mDpCprVmOoA folded before Flop (didn't bet)
Seat 3: LtASJ9OlkqGrrUKGQlpGAw (button) folded before Flop (didn't bet)
Seat 4: QIWnfLSqfMcoFfdDe5LZPg (small blind) folded before Flop
Seat 5: gX2vbKwS/8zZPENAWB7hxQ (big blind) folded before Flop
Seat 6: LJI7A1YgDM7hgh7o56+ReQ collected ($0.60)




PokerStars Game #59941591316:  Hold'em No Limit ($0.10/$0.25) - 2009/07/01 1:40:05 ET
Table 'rjcb+nlE+0GuJ6lBhuCkkA' 6-max Seat #1 is the button
Seat 1: lBoEwOFgzcERLIRUkUoRTw ($13.95 in chips) 
Seat 2: lJphax9e7/+O/3YCKPJ0yQ ($4.75 in chips) 
Seat 3: 8ClCHtFXGNplITm+63KB+Q ($66.85 in chips) 
Seat 4: BV+K0Phf5VBHr7aZPKqbUQ ($25 in chips) 
Seat 5: GC/9yVD59DUCX7hUI7gcLw ($41.75 in chips) 
lJphax9e7/+O/3YCKPJ0yQ: posts small blind $0.10
8ClCHtFXGNplITm+63KB+Q: posts big blind $0.25
32YL2ZEp8NT4JB2RVM9euQ: sits out 
*** HOLE CARDS ***
BV+K0Phf5VBHr7aZPKqbUQ: folds 
GC/9yVD59DUCX7hUI7gcLw: raises $0.75 to $1
lBoEwOFgzcERLIRUkUoRTw: folds 
lJphax9e7/+O/3YCKPJ0yQ: folds 
8ClCHtFXGNplITm+63KB+Q: folds 
Uncalled bet ($0.75) returned to GC/9yVD59DUCX7hUI7gcLw
GC/9yVD59DUCX7hUI7gcLw collected $0.60 from pot
*** SUMMARY ***
Total pot $0.60 | Rake $0 
Seat 1: lBoEwOFgzcERLIRUkUoRTw (button) folded before Flop (didn't bet)
Seat 2: lJphax9e7/+O/3YCKPJ0yQ (small blind) folded before Flop
Seat 3: 8ClCHtFXGNplITm+63KB+Q (big blind) folded before Flop
Seat 4: BV+K0Phf5VBHr7aZPKqbUQ folded before Flop (didn't bet)
Seat 5: GC/9yVD59DUCX7hUI7gcLw collected ($0.60)




PokerStars Game #59941591874:  Hold'em No Limit ($0.10/$0.25) - 2009/07/01 1:40:06 ET
Table 'HIOfhT0zga/KonFhIl6O3w' 9-max Seat #4 is the button
Seat 1: oLa/tXLfSLLB28mcLGrxcg ($24.90 in chips) 
Seat 2: er86weqXTpTB6/w2dKlYgA ($17.10 in chips) 
Seat 4: qwr38jl5txoR36M7G5qi4A ($8.65 in chips) 
Seat 5: K1MDeapSEyKyGPNZGOKfEg ($38.10 in chips) 
Seat 6: MThMMgdB293VOucmN9sliQ ($25 in chips) 
Seat 7: wvlPJBB0PtYkfeeSRDaIvQ ($13.80 in chips) 
Seat 8: V6p0jQ/RhUsqpHLmXvEX4Q ($12.25 in chips) 
Seat 9: dfNim92Z6XK1/h5SFW5vDg ($28.35 in chips) 
K1MDeapSEyKyGPNZGOKfEg: posts small blind $0.10
MThMMgdB293VOucmN9sliQ: posts big blind $0.25
*** HOLE CARDS ***
wvlPJBB0PtYkfeeSRDaIvQ: folds 
V6p0jQ/RhUsqpHLmXvEX4Q: folds 
dfNim92Z6XK1/h5SFW5vDg: raises $0.75 to $1
oLa/tXLfSLLB28mcLGrxcg: folds 
er86weqXTpTB6/w2dKlYgA: folds 
qwr38jl5txoR36M7G5qi4A: folds 
K1MDeapSEyKyGPNZGOKfEg: folds 
MThMMgdB293VOucmN9sliQ: folds 
Uncalled bet ($0.75) returned to dfNim92Z6XK1/h5SFW5vDg
dfNim92Z6XK1/h5SFW5vDg collected $0.60 from pot
dfNim92Z6XK1/h5SFW5vDg: doesn't show hand 
*** SUMMARY ***
Total pot $0.60 | Rake $0 
Seat 1: oLa/tXLfSLLB28mcLGrxcg folded before Flop (didn't bet)
Seat 2: er86weqXTpTB6/w2dKlYgA folded before Flop (didn't bet)
Seat 4: qwr38jl5txoR36M7G5qi4A (button) folded before Flop (didn't bet)
Seat 5: K1MDeapSEyKyGPNZGOKfEg (small blind) folded before Flop
Seat 6: MThMMgdB293VOucmN9sliQ (big blind) folded before Flop
Seat 7: wvlPJBB0PtYkfeeSRDaIvQ folded before Flop (didn't bet)
Seat 8: V6p0jQ/RhUsqpHLmXvEX4Q folded before Flop (didn't bet)
Seat 9: dfNim92Z6XK1/h5SFW5vDg collected ($0.60)




PokerStars Game #59941591790:  Hold'em No Limit ($0.10/$0.25) - 2009/07/01 1:40:06 ET
Table 'AJGgX1ZYM8d68SWMvaLttg' 6-max Seat #2 is the button
Seat 2: zHHLkD2sRljslKKeQv/ZQw ($26.55 in chips) 
Seat 3: 8ClCHtFXGNplITm+63KB+Q ($37.80 in chips) 
Seat 4: Lz/GjRDgmgepqTR7qmS86w ($26.05 in chips) 
Seat 5: Hsvkc0/G2VV78oVmWYXecw ($5.30 in chips) 
Seat 6: UA5OsKS3VPaxa7uC8La/kA ($64.75 in chips) 
8ClCHtFXGNplITm+63KB+Q: posts small blind $0.10
Lz/GjRDgmgepqTR7qmS86w: posts big blind $0.25
*** HOLE CARDS ***
Hsvkc0/G2VV78oVmWYXecw: folds 
UA5OsKS3VPaxa7uC8La/kA: folds 
zHHLkD2sRljslKKeQv/ZQw: calls $0.25
8ClCHtFXGNplITm+63KB+Q: folds 
Lz/GjRDgmgepqTR7qmS86w: checks 
*** FLOP *** [3c 9c 4c]
Lz/GjRDgmgepqTR7qmS86w: checks 
zHHLkD2sRljslKKeQv/ZQw: bets $0.50
Lz/GjRDgmgepqTR7qmS86w: folds 
Uncalled bet ($0.50) returned to zHHLkD2sRljslKKeQv/ZQw
zHHLkD2sRljslKKeQv/ZQw collected $0.60 from pot
*** SUMMARY ***
Total pot $0.60 | Rake $0 
Board [3c 9c 4c]
Seat 2: zHHLkD2sRljslKKeQv/ZQw (button) collected ($0.60)
Seat 3: 8ClCHtFXGNplITm+63KB+Q (small blind) folded before Flop
Seat 4: Lz/GjRDgmgepqTR7qmS86w (big blind) folded on the Flop
Seat 5: Hsvkc0/G2VV78oVmWYXecw folded before Flop (didn't bet)
Seat 6: UA5OsKS3VPaxa7uC8La/kA folded before Flop (didn't bet)




PokerStars Game #59941591508:  Hold'em No Limit ($0.10/$0.25) - 2009/07/01 1:40:06 ET
Table 'I0ZcuiUTeLuGYv26Nah7YA' 9-max Seat #5 is the button
Seat 2: ljemhp25Zg+nlA9DLCIiUw ($34.05 in chips) 
Seat 5: y7tkvDmwKjURBkr73SZPXw ($7.05 in chips) 
y7tkvDmwKjURBkr73SZPXw: posts small blind $0.10
ljemhp25Zg+nlA9DLCIiUw: posts big blind $0.25
*** HOLE CARDS ***
y7tkvDmwKjURBkr73SZPXw: calls $0.15
ljemhp25Zg+nlA9DLCIiUw: checks 
*** FLOP *** [5d Kc 9h]
ljemhp25Zg+nlA9DLCIiUw: checks 
y7tkvDmwKjURBkr73SZPXw: checks 
*** TURN *** [5d Kc 9h] [9d]
hO0e1+SO2lX0hqBn3Z/9KQ joins the table at seat #4 
ljemhp25Zg+nlA9DLCIiUw: checks 
y7tkvDmwKjURBkr73SZPXw: bets $0.25
ljemhp25Zg+nlA9DLCIiUw: folds 
Uncalled bet ($0.25) returned to y7tkvDmwKjURBkr73SZPXw
y7tkvDmwKjURBkr73SZPXw collected $0.50 from pot
*** SUMMARY ***
Total pot $0.50 | Rake $0 
Board [5d Kc 9h 9d]
Seat 2: ljemhp25Zg+nlA9DLCIiUw (big blind) folded on the Turn
Seat 5: y7tkvDmwKjURBkr73SZPXw (button) (small blind) collected ($0.50)




PokerStars Game #59941591816:  Hold'em No Limit ($0.10/$0.25) - 2009/07/01 1:40:06 ET
Table 'P1IJQ2p3ACFySC35W1qwQw' 9-max Seat #5 is the button
Seat 1: bXpVeaSTPBFSPJmeXxO7nw ($4.65 in chips) 
Seat 2: vO3QVRovWemcGMkm7ijAIA ($5.35 in chips) 
Seat 3: PVxvfRTRvkgZf9WtquEkwQ ($25.35 in chips) 
Seat 4: c/9X4zftzphFxYtxp5kp9w ($28.15 in chips) 
Seat 5: ghNKXUBl/H+t83JF079ZBA ($56.45 in chips) 
Seat 6: ljemhp25Zg+nlA9DLCIiUw ($64.55 in chips) 
Seat 7: 7je+LC5Mfs6nL8YBVh4frQ ($4.65 in chips) 
Seat 8: tLcDklc2rBORNfixyRfVfw ($26.25 in chips) 
Seat 9: XXajyXkgbSGJKxQP3mal/Q ($15.40 in chips) 
ljemhp25Zg+nlA9DLCIiUw: posts small blind $0.10
7je+LC5Mfs6nL8YBVh4frQ: posts big blind $0.25
*** HOLE CARDS ***
tLcDklc2rBORNfixyRfVfw: folds 
XXajyXkgbSGJKxQP3mal/Q: folds 
bXpVeaSTPBFSPJmeXxO7nw: folds 
vO3QVRovWemcGMkm7ijAIA: raises $0.50 to $0.75
PVxvfRTRvkgZf9WtquEkwQ: folds 
c/9X4zftzphFxYtxp5kp9w: folds 
ghNKXUBl/H+t83JF079ZBA: folds 
ljemhp25Zg+nlA9DLCIiUw: folds 
7je+LC5Mfs6nL8YBVh4frQ: folds 
Uncalled bet ($0.50) returned to vO3QVRovWemcGMkm7ijAIA
vO3QVRovWemcGMkm7ijAIA collected $0.60 from pot
*** SUMMARY ***
Total pot $0.60 | Rake $0 
Seat 1: bXpVeaSTPBFSPJmeXxO7nw folded before Flop (didn't bet)
Seat 2: vO3QVRovWemcGMkm7ijAIA collected ($0.60)
Seat 3: PVxvfRTRvkgZf9WtquEkwQ folded before Flop (didn't bet)
Seat 4: c/9X4zftzphFxYtxp5kp9w folded before Flop (didn't bet)
Seat 5: ghNKXUBl/H+t83JF079ZBA (button) folded before Flop (didn't bet)
Seat 6: ljemhp25Zg+nlA9DLCIiUw (small blind) folded before Flop
Seat 7: 7je+LC5Mfs6nL8YBVh4frQ (big blind) folded before Flop
Seat 8: tLcDklc2rBORNfixyRfVfw folded before Flop (didn't bet)
Seat 9: XXajyXkgbSGJKxQP3mal/Q folded before Flop (didn't bet)




PokerStars Game #59941591558:  Hold'em No Limit ($0.10/$0.25) - 2009/07/01 1:40:06 ET
Table '2AUmC2Rslg+QUbLfdgNdfg' 6-max Seat #3 is the button
Seat 1: YDXAegrCnzc0l6TSDNboXQ ($24.60 in chips) 
Seat 2: PLksyNlTVRVZwxJVC2/1eA ($23.85 in chips) 
Seat 3: JFIAqU8lCZ0vWwEl4bdGsg ($25.35 in chips) 
Seat 4: lquriepNQBhDV5P1SWHhnA ($26.10 in chips) 
Seat 5: AMc4cCwUJhokdGRYIaVPhQ ($22.25 in chips) 
Seat 6: xBWc54v+UTSJOiKpbAbJWg ($12.20 in chips) 
lquriepNQBhDV5P1SWHhnA: posts small blind $0.10
AMc4cCwUJhokdGRYIaVPhQ: posts big blind $0.25
*** HOLE CARDS ***
xBWc54v+UTSJOiKpbAbJWg: folds 
YDXAegrCnzc0l6TSDNboXQ: folds 
PLksyNlTVRVZwxJVC2/1eA: folds 
JFIAqU8lCZ0vWwEl4bdGsg: folds 
lquriepNQBhDV5P1SWHhnA: folds 
Uncalled bet ($0.15) returned to AMc4cCwUJhokdGRYIaVPhQ
AMc4cCwUJhokdGRYIaVPhQ collected $0.20 from pot
AMc4cCwUJhokdGRYIaVPhQ: doesn't show hand 
*** SUMMARY ***
Total pot $0.20 | Rake $0 
Seat 1: YDXAegrCnzc0l6TSDNboXQ folded before Flop (didn't bet)
Seat 2: PLksyNlTVRVZwxJVC2/1eA folded before Flop (didn't bet)
Seat 3: JFIAqU8lCZ0vWwEl4bdGsg (button) folded before Flop (didn't bet)
Seat 4: lquriepNQBhDV5P1SWHhnA (small blind) folded before Flop
Seat 5: AMc4cCwUJhokdGRYIaVPhQ (big blind) collected ($0.20)
Seat 6: xBWc54v+UTSJOiKpbAbJWg folded before Flop (didn't bet)




PokerStars Game #59941591536:  Hold'em No Limit ($0.10/$0.25) - 2009/07/01 1:40:06 ET
Table 'oJpFwZj9+FUGHX90Un8s9Q' 6-max Seat #1 is the button
Seat 1: 6DwBRH+xZ12AAZmeAg+aXw ($24.70 in chips) 
Seat 2: NtrVQ9UIql0rDCnKDKZ5FQ ($5.75 in chips) 
Seat 3: kyRaCIljYA6l33lSKQfNsg ($25 in chips) 
Seat 4: 6elpmfyt4Zw0yvd8lePSMQ ($23.15 in chips) 
Seat 5: kG34n23qFQA3nzdOJTQ1dA ($56.45 in chips) 
Seat 6: edio/rLJ06xeZOfLhoL3UA ($9 in chips) 
NtrVQ9UIql0rDCnKDKZ5FQ: posts small blind $0.10
kyRaCIljYA6l33lSKQfNsg: posts big blind $0.25
*** HOLE CARDS ***
6elpmfyt4Zw0yvd8lePSMQ: folds 
kG34n23qFQA3nzdOJTQ1dA: folds 
edio/rLJ06xeZOfLhoL3UA: folds 
6DwBRH+xZ12AAZmeAg+aXw: raises $0.50 to $0.75
NtrVQ9UIql0rDCnKDKZ5FQ: calls $0.65
kyRaCIljYA6l33lSKQfNsg: folds 
*** FLOP *** [4s 8d 8h]
NtrVQ9UIql0rDCnKDKZ5FQ: checks 
6DwBRH+xZ12AAZmeAg+aXw: bets $1
NtrVQ9UIql0rDCnKDKZ5FQ: calls $1
*** TURN *** [4s 8d 8h] [2s]
NtrVQ9UIql0rDCnKDKZ5FQ: checks 
6DwBRH+xZ12AAZmeAg+aXw: checks 
*** RIVER *** [4s 8d 8h 2s] [7c]
NtrVQ9UIql0rDCnKDKZ5FQ: bets $4 and is all-in
6DwBRH+xZ12AAZmeAg+aXw: folds 
Uncalled bet ($4) returned to NtrVQ9UIql0rDCnKDKZ5FQ
NtrVQ9UIql0rDCnKDKZ5FQ collected $3.60 from pot
*** SUMMARY ***
Total pot $3.75 | Rake $0.15 
Board [4s 8d 8h 2s 7c]
Seat 1: 6DwBRH+xZ12AAZmeAg+aXw (button) folded on the River
Seat 2: NtrVQ9UIql0rDCnKDKZ5FQ (small blind) collected ($3.60)
Seat 3: kyRaCIljYA6l33lSKQfNsg (big blind) folded before Flop
Seat 4: 6elpmfyt4Zw0yvd8lePSMQ folded before Flop (didn't bet)
Seat 5: kG34n23qFQA3nzdOJTQ1dA folded before Flop (didn't bet)
Seat 6: edio/rLJ06xeZOfLhoL3UA folded before Flop (didn't bet)




PokerStars Game #59941591602:  Hold'em No Limit ($0.10/$0.25) - 2009/07/01 1:40:06 ET
Table 'dNYnr4D4id1jwnEU66Yowg' 9-max Seat #1 is the button
Seat 1: 9lvO/qyU+xrU95Teu1fv0g ($4.65 in chips) 
Seat 4: VBHxUExRAMrbxUq/cVx9Gw ($5.05 in chips) 
Seat 5: 7cv+9Zc9HIQHNvYsMfV3uA ($25.70 in chips) 
Seat 7: DiSvPC2iudwL5j9u6Huyww ($25.80 in chips) 
Seat 8: RCqMONFrSPSArZh2Jsar/w ($22.45 in chips) 
Seat 9: K0dyGSZP/cgeQjH6o6u9Rw ($15.95 in chips) 
VBHxUExRAMrbxUq/cVx9Gw: posts small blind $0.10
7cv+9Zc9HIQHNvYsMfV3uA: posts big blind $0.25
8EbrQ/EvFWt2cr0GaU82gQ: sits out 
*** HOLE CARDS ***
DiSvPC2iudwL5j9u6Huyww: folds 
RCqMONFrSPSArZh2Jsar/w: folds 
KBBTLXGhPdPj+4X0QKMkcg leaves the table
K0dyGSZP/cgeQjH6o6u9Rw: raises $0.50 to $0.75
9lvO/qyU+xrU95Teu1fv0g: folds 
VBHxUExRAMrbxUq/cVx9Gw: folds 
7cv+9Zc9HIQHNvYsMfV3uA: folds 
Uncalled bet ($0.50) returned to K0dyGSZP/cgeQjH6o6u9Rw
K0dyGSZP/cgeQjH6o6u9Rw collected $0.60 from pot
*** SUMMARY ***
Total pot $0.60 | Rake $0 
Seat 1: 9lvO/qyU+xrU95Teu1fv0g (button) folded before Flop (didn't bet)
Seat 4: VBHxUExRAMrbxUq/cVx9Gw (small blind) folded before Flop
Seat 5: 7cv+9Zc9HIQHNvYsMfV3uA (big blind) folded before Flop
Seat 7: DiSvPC2iudwL5j9u6Huyww folded before Flop (didn't bet)
Seat 8: RCqMONFrSPSArZh2Jsar/w folded before Flop (didn't bet)
Seat 9: K0dyGSZP/cgeQjH6o6u9Rw collected ($0.60)




PokerStars Game #59941592322:  Hold'em No Limit ($0.10/$0.25) - 2009/07/01 1:40:07 ET
Table 'oZuNsbNJuUyQLGKzQ/4JFg' 6-max Seat #1 is the button
Seat 1: vqWjZmdQu/Hxw96/IJTWdQ ($25 in chips) 
Seat 2: UA5OsKS3VPaxa7uC8La/kA ($33.10 in chips) 
Seat 3: 8ClCHtFXGNplITm+63KB+Q ($52.10 in chips) 
Seat 4: df01R5ThvHspD8FgKmaDvQ ($47.75 in chips) 
Seat 5: oBUDUfeUyCbZBsjxHZgSiw ($27.15 in chips) 
Seat 6: fwg6dK1+r4jy/y+JqenYYQ ($14.65 in chips) 
UA5OsKS3VPaxa7uC8La/kA: posts small blind $0.10
8ClCHtFXGNplITm+63KB+Q: posts big blind $0.25
*** HOLE CARDS ***
df01R5ThvHspD8FgKmaDvQ: raises $0.25 to $0.50
oBUDUfeUyCbZBsjxHZgSiw: folds 
fwg6dK1+r4jy/y+JqenYYQ: folds 
vqWjZmdQu/Hxw96/IJTWdQ: calls $0.50
UA5OsKS3VPaxa7uC8La/kA: folds 
8ClCHtFXGNplITm+63KB+Q: folds 
*** FLOP *** [7c 5d Jc]
df01R5ThvHspD8FgKmaDvQ: checks 
vqWjZmdQu/Hxw96/IJTWdQ: checks 
*** TURN *** [7c 5d Jc] [4c]
df01R5ThvHspD8FgKmaDvQ: checks 
vqWjZmdQu/Hxw96/IJTWdQ: checks 
*** RIVER *** [7c 5d Jc 4c] [Kc]
df01R5ThvHspD8FgKmaDvQ: checks 
vqWjZmdQu/Hxw96/IJTWdQ: checks 
*** SHOW DOWN ***
df01R5ThvHspD8FgKmaDvQ: shows [Ad 9d] (high card Ace)
vqWjZmdQu/Hxw96/IJTWdQ: mucks hand 
df01R5ThvHspD8FgKmaDvQ collected $1.30 from pot
df01R5ThvHspD8FgKmaDvQ is sitting out
*** SUMMARY ***
Total pot $1.35 | Rake $0.05 
Board [7c 5d Jc 4c Kc]
Seat 1: vqWjZmdQu/Hxw96/IJTWdQ (button) mucked
Seat 2: UA5OsKS3VPaxa7uC8La/kA (small blind) folded before Flop
Seat 3: 8ClCHtFXGNplITm+63KB+Q (big blind) folded before Flop
Seat 4: df01R5ThvHspD8FgKmaDvQ showed [Ad 9d] and won ($1.30) with high card Ace
Seat 5: oBUDUfeUyCbZBsjxHZgSiw folded before Flop (didn't bet)
Seat 6: fwg6dK1+r4jy/y+JqenYYQ folded before Flop (didn't bet)




PokerStars Game #59941592044:  Hold'em No Limit ($0.10/$0.25) - 2009/07/01 1:40:07 ET
Table '4XGDnEByOol5up4aB2KbJw' 6-max Seat #2 is the button
Seat 1: kyRaCIljYA6l33lSKQfNsg ($26.85 in chips) 
Seat 2: SFmT9ZsVopnukjvAzrxTRg ($42.90 in chips) 
Seat 3: LtASJ9OlkqGrrUKGQlpGAw ($20.65 in chips) 
Seat 4: BV+K0Phf5VBHr7aZPKqbUQ ($26.05 in chips) 
Seat 5: Dh01+rohD2p9pXLYeBlC5Q ($17.90 in chips) 
Seat 6: a7Ux7aERFGCbT/L3ojVfAg ($9.35 in chips) 
LtASJ9OlkqGrrUKGQlpGAw: posts small blind $0.10
BV+K0Phf5VBHr7aZPKqbUQ: posts big blind $0.25
*** HOLE CARDS ***
Dh01+rohD2p9pXLYeBlC5Q: calls $0.25
a7Ux7aERFGCbT/L3ojVfAg: folds 
kyRaCIljYA6l33lSKQfNsg: folds 
SFmT9ZsVopnukjvAzrxTRg: raises $0.75 to $1
LtASJ9OlkqGrrUKGQlpGAw: folds 
BV+K0Phf5VBHr7aZPKqbUQ: folds 
Dh01+rohD2p9pXLYeBlC5Q: calls $0.75
*** FLOP *** [2h 6c Ad]
Dh01+rohD2p9pXLYeBlC5Q: checks 
SFmT9ZsVopnukjvAzrxTRg: checks 
*** TURN *** [2h 6c Ad] [5s]
Dh01+rohD2p9pXLYeBlC5Q: checks 
SFmT9ZsVopnukjvAzrxTRg: bets $1.50
Dh01+rohD2p9pXLYeBlC5Q: folds 
Uncalled bet ($1.50) returned to SFmT9ZsVopnukjvAzrxTRg
SFmT9ZsVopnukjvAzrxTRg collected $2.25 from pot
SFmT9ZsVopnukjvAzrxTRg: doesn't show hand 
*** SUMMARY ***
Total pot $2.35 | Rake $0.10 
Board [2h 6c Ad 5s]
Seat 1: kyRaCIljYA6l33lSKQfNsg folded before Flop (didn't bet)
Seat 2: SFmT9ZsVopnukjvAzrxTRg (button) collected ($2.25)
Seat 3: LtASJ9OlkqGrrUKGQlpGAw (small blind) folded before Flop
Seat 4: BV+K0Phf5VBHr7aZPKqbUQ (big blind) folded before Flop
Seat 5: Dh01+rohD2p9pXLYeBlC5Q folded on the Turn
Seat 6: a7Ux7aERFGCbT/L3ojVfAg folded before Flop (didn't bet)




PokerStars Game #59941592120:  Hold'em No Limit ($0.10/$0.25) - 2009/07/01 1:40:07 ET
Table 'FBhJjLqab11/gKu8nyB/tw' 9-max Seat #2 is the button
Seat 1: +sbyWwIcFp9kP0bDtMegfQ ($18.10 in chips) 
Seat 2: 1pwQJV/Xr0GWPRefx/78VQ ($17.30 in chips) 
Seat 3: V6p0jQ/RhUsqpHLmXvEX4Q ($12.10 in chips) 
Seat 4: CvL9Ch1HYCVbTsfpNucitg ($5.85 in chips) 
Seat 6: cZ99hugmLBj9KhTlc8nCSw ($25 in chips) 
Seat 7: CT7Xj/V/O5rBlhtt+RZeFQ ($25 in chips) 
Seat 8: Th3FldXKQW6hWVVPahaoOQ ($27.40 in chips) 
V6p0jQ/RhUsqpHLmXvEX4Q: posts small blind $0.10
CvL9Ch1HYCVbTsfpNucitg: posts big blind $0.25
Mh2r9hTeTEDnh19sRZtW3g: sits out 
*** HOLE CARDS ***
cZ99hugmLBj9KhTlc8nCSw: folds 
CT7Xj/V/O5rBlhtt+RZeFQ: folds 
Th3FldXKQW6hWVVPahaoOQ: folds 
+sbyWwIcFp9kP0bDtMegfQ: folds 
1pwQJV/Xr0GWPRefx/78VQ: calls $0.25
V6p0jQ/RhUsqpHLmXvEX4Q: raises $1 to $1.25
CvL9Ch1HYCVbTsfpNucitg: folds 
1pwQJV/Xr0GWPRefx/78VQ: folds 
Uncalled bet ($1) returned to V6p0jQ/RhUsqpHLmXvEX4Q
V6p0jQ/RhUsqpHLmXvEX4Q collected $0.75 from pot
*** SUMMARY ***
Total pot $0.75 | Rake $0 
Seat 1: +sbyWwIcFp9kP0bDtMegfQ folded before Flop (didn't bet)
Seat 2: 1pwQJV/Xr0GWPRefx/78VQ (button) folded before Flop
Seat 3: V6p0jQ/RhUsqpHLmXvEX4Q (small blind) collected ($0.75)
Seat 4: CvL9Ch1HYCVbTsfpNucitg (big blind) folded before Flop
Seat 6: cZ99hugmLBj9KhTlc8nCSw folded before Flop (didn't bet)
Seat 7: CT7Xj/V/O5rBlhtt+RZeFQ folded before Flop (didn't bet)
Seat 8: Th3FldXKQW6hWVVPahaoOQ folded before Flop (didn't bet)




PokerStars Game #59941592402:  Hold'em No Limit ($0.10/$0.25) - 2009/07/01 1:40:07 ET
Table '0mmHveGuaIfIMQlNE1eqMg' 9-max Seat #9 is the button
Seat 1: ydoFOVgzvZv9ZhuWu9rXAw ($4.65 in chips) 
Seat 2: rQhYIYXSyH/IivYM1dlV5A ($68.50 in chips) 
Seat 3: ghNKXUBl/H+t83JF079ZBA ($25 in chips) 
Seat 4: DnDcAdn9P0zGovMERigpFA ($36.35 in chips) 
Seat 5: Pt637jKksB5MzP0UNJAAkw ($7 in chips) 
Seat 6: 6RiVTYll/5D8zICp0MRpKw ($24.20 in chips) 
Seat 9: UNw/UrAelsQeSS17Rro/BA ($12.15 in chips) 
ydoFOVgzvZv9ZhuWu9rXAw: posts small blind $0.10
rQhYIYXSyH/IivYM1dlV5A: posts big blind $0.25
Pt637jKksB5MzP0UNJAAkw: posts big blind $0.25
5n7e7I+px7c6CQmLpPbtsg: sits out 
0XACOSNrAWmqNv9k1nF8rw: sits out 
*** HOLE CARDS ***
ghNKXUBl/H+t83JF079ZBA: folds 
DnDcAdn9P0zGovMERigpFA: raises $0.75 to $1
Pt637jKksB5MzP0UNJAAkw: calls $0.75
6RiVTYll/5D8zICp0MRpKw: folds 
UNw/UrAelsQeSS17Rro/BA: calls $1
ydoFOVgzvZv9ZhuWu9rXAw: folds 
rQhYIYXSyH/IivYM1dlV5A: folds 
*** FLOP *** [Ad 5h 6c]
DnDcAdn9P0zGovMERigpFA: checks 
Pt637jKksB5MzP0UNJAAkw: checks 
UNw/UrAelsQeSS17Rro/BA: checks 
*** TURN *** [Ad 5h 6c] [6h]
DnDcAdn9P0zGovMERigpFA: checks 
Pt637jKksB5MzP0UNJAAkw: checks 
UNw/UrAelsQeSS17Rro/BA: checks 
*** RIVER *** [Ad 5h 6c 6h] [6s]
DnDcAdn9P0zGovMERigpFA: checks 
Pt637jKksB5MzP0UNJAAkw: checks 
UNw/UrAelsQeSS17Rro/BA: checks 
*** SHOW DOWN ***
DnDcAdn9P0zGovMERigpFA: shows [2h 2s] (a full house, Sixes full of Deuces)
Pt637jKksB5MzP0UNJAAkw: shows [8d 8h] (a full house, Sixes full of Eights)
UNw/UrAelsQeSS17Rro/BA: mucks hand 
Pt637jKksB5MzP0UNJAAkw collected $3.20 from pot
*** SUMMARY ***
Total pot $3.35 | Rake $0.15 
Board [Ad 5h 6c 6h 6s]
Seat 1: ydoFOVgzvZv9ZhuWu9rXAw (small blind) folded before Flop
Seat 2: rQhYIYXSyH/IivYM1dlV5A (big blind) folded before Flop
Seat 3: ghNKXUBl/H+t83JF079ZBA folded before Flop (didn't bet)
Seat 4: DnDcAdn9P0zGovMERigpFA showed [2h 2s] and lost with a full house, Sixes full of Deuces
Seat 5: Pt637jKksB5MzP0UNJAAkw showed [8d 8h] and won ($3.20) with a full house, Sixes full of Eights
Seat 6: 6RiVTYll/5D8zICp0MRpKw folded before Flop (didn't bet)
Seat 9: UNw/UrAelsQeSS17Rro/BA (button) mucked




PokerStars Game #59941592078:  Hold'em No Limit ($0.10/$0.25) - 2009/07/01 1:40:07 ET
Table 'axb9RsG8Zj1A0LEukTeFrQ' 9-max Seat #5 is the button
Seat 1: qwr38jl5txoR36M7G5qi4A ($8.85 in chips) 
Seat 3: H5Se03ZqSX7tbULXur2MAg ($25.10 in chips) 
Seat 4: tLcDklc2rBORNfixyRfVfw ($27.45 in chips) 
Seat 5: rLSSHKOHnb6yzVfDoQM/RA ($15.10 in chips) 
Seat 7: PdIasPkzm2sqZnN41ZRXOg ($4.75 in chips) 
Seat 8: VBHxUExRAMrbxUq/cVx9Gw ($4.65 in chips) 
Seat 9: qbQE8CifKB4+OEvNF/61Rw ($55.50 in chips) 
PdIasPkzm2sqZnN41ZRXOg: posts small blind $0.10
VBHxUExRAMrbxUq/cVx9Gw: posts big blind $0.25
*** HOLE CARDS ***
qbQE8CifKB4+OEvNF/61Rw: raises $0.75 to $1
qwr38jl5txoR36M7G5qi4A: folds 
H5Se03ZqSX7tbULXur2MAg: folds 
tLcDklc2rBORNfixyRfVfw: folds 
rLSSHKOHnb6yzVfDoQM/RA: folds 
PdIasPkzm2sqZnN41ZRXOg: folds 
VBHxUExRAMrbxUq/cVx9Gw: folds 
Uncalled bet ($0.75) returned to qbQE8CifKB4+OEvNF/61Rw
qbQE8CifKB4+OEvNF/61Rw collected $0.60 from pot
qbQE8CifKB4+OEvNF/61Rw: doesn't show hand 
*** SUMMARY ***
Total pot $0.60 | Rake $0 
Seat 1: qwr38jl5txoR36M7G5qi4A folded before Flop (didn't bet)
Seat 3: H5Se03ZqSX7tbULXur2MAg folded before Flop (didn't bet)
Seat 4: tLcDklc2rBORNfixyRfVfw folded before Flop (didn't bet)
Seat 5: rLSSHKOHnb6yzVfDoQM/RA (button) folded before Flop (didn't bet)
Seat 7: PdIasPkzm2sqZnN41ZRXOg (small blind) folded before Flop
Seat 8: VBHxUExRAMrbxUq/cVx9Gw (big blind) folded before Flop
Seat 9: qbQE8CifKB4+OEvNF/61Rw collected ($0.60)




PokerStars Game #59941592396:  Hold'em No Limit ($0.10/$0.25) - 2009/07/01 1:40:07 ET
Table 'G+4ZdyRoPjgaJY/jxSlZzQ' 9-max Seat #3 is the button
Seat 1: ghNKXUBl/H+t83JF079ZBA ($27.70 in chips) 
Seat 2: CT7Xj/V/O5rBlhtt+RZeFQ ($25 in chips) 
Seat 3: FaGtAm5QUVcixGhAKIvbLg ($15.25 in chips) 
Seat 4: lSeLm4BdnSMLtIli62qjAQ ($10.75 in chips) 
Seat 5: BT6Oal0iO4P6kDuT7HFQDw ($14.45 in chips) 
Seat 6: oFwaTjy3ok/+qFghsrcGvg ($17.80 in chips) 
Seat 7: IK3/w7XV7rd8mVIsuasjYA ($2.35 in chips) 
Seat 9: tLcDklc2rBORNfixyRfVfw ($25.95 in chips) 
lSeLm4BdnSMLtIli62qjAQ: posts small blind $0.10
BT6Oal0iO4P6kDuT7HFQDw: posts big blind $0.25
bXpVeaSTPBFSPJmeXxO7nw: sits out 
*** HOLE CARDS ***
oFwaTjy3ok/+qFghsrcGvg: calls $0.25
IK3/w7XV7rd8mVIsuasjYA: folds 
tLcDklc2rBORNfixyRfVfw: calls $0.25
ghNKXUBl/H+t83JF079ZBA: raises $1.25 to $1.50
CT7Xj/V/O5rBlhtt+RZeFQ: folds 
FaGtAm5QUVcixGhAKIvbLg: folds 
lSeLm4BdnSMLtIli62qjAQ: folds 
BT6Oal0iO4P6kDuT7HFQDw: folds 
oFwaTjy3ok/+qFghsrcGvg: calls $1.25
tLcDklc2rBORNfixyRfVfw: calls $1.25
*** FLOP *** [8h 7s Js]
oFwaTjy3ok/+qFghsrcGvg: checks 
tLcDklc2rBORNfixyRfVfw: checks 
ghNKXUBl/H+t83JF079ZBA: bets $3
oFwaTjy3ok/+qFghsrcGvg: calls $3
tLcDklc2rBORNfixyRfVfw: folds 
*** TURN *** [8h 7s Js] [6s]
oFwaTjy3ok/+qFghsrcGvg: bets $3
ghNKXUBl/H+t83JF079ZBA: folds 
Uncalled bet ($3) returned to oFwaTjy3ok/+qFghsrcGvg
oFwaTjy3ok/+qFghsrcGvg collected $10.35 from pot
oFwaTjy3ok/+qFghsrcGvg: doesn't show hand 
*** SUMMARY ***
Total pot $10.85 | Rake $0.50 
Board [8h 7s Js 6s]
Seat 1: ghNKXUBl/H+t83JF079ZBA folded on the Turn
Seat 2: CT7Xj/V/O5rBlhtt+RZeFQ folded before Flop (didn't bet)
Seat 3: FaGtAm5QUVcixGhAKIvbLg (button) folded before Flop (didn't bet)
Seat 4: lSeLm4BdnSMLtIli62qjAQ (small blind) folded before Flop
Seat 5: BT6Oal0iO4P6kDuT7HFQDw (big blind) folded before Flop
Seat 6: oFwaTjy3ok/+qFghsrcGvg collected ($10.35)
Seat 7: IK3/w7XV7rd8mVIsuasjYA folded before Flop (didn't bet)
Seat 9: tLcDklc2rBORNfixyRfVfw folded on the Flop




PokerStars Game #59941592712:  Hold'em No Limit ($0.10/$0.25) - 2009/07/01 1:40:08 ET
Table 'L5GvbdQO5aCZJSE6pyQ8OA' 6-max Seat #1 is the button
Seat 1: eFj4lr1nuXLyCWNTShr1bg ($11.35 in chips) 
Seat 2: DihMHaz4WNETH1bPDe13kA ($29.15 in chips) 
Seat 3: JFIAqU8lCZ0vWwEl4bdGsg ($27.35 in chips) 
Seat 5: LyDHtw3/yniNHW+DvLXbog ($26.30 in chips) 
Seat 6: v+QfkGiuj9bgtuNoVnDO8w ($39.75 in chips) 
DihMHaz4WNETH1bPDe13kA: posts small blind $0.10
JFIAqU8lCZ0vWwEl4bdGsg: posts big blind $0.25
*** HOLE CARDS ***
LyDHtw3/yniNHW+DvLXbog: folds 
v+QfkGiuj9bgtuNoVnDO8w: folds 
eFj4lr1nuXLyCWNTShr1bg: calls $0.25
DihMHaz4WNETH1bPDe13kA: folds 
JFIAqU8lCZ0vWwEl4bdGsg: checks 
*** FLOP *** [Kd 5d Qd]
JFIAqU8lCZ0vWwEl4bdGsg: checks 
eFj4lr1nuXLyCWNTShr1bg: checks 
*** TURN *** [Kd 5d Qd] [5h]
JFIAqU8lCZ0vWwEl4bdGsg: checks 
eFj4lr1nuXLyCWNTShr1bg: checks 
*** RIVER *** [Kd 5d Qd 5h] [7d]
JFIAqU8lCZ0vWwEl4bdGsg: checks 
eFj4lr1nuXLyCWNTShr1bg: checks 
*** SHOW DOWN ***
JFIAqU8lCZ0vWwEl4bdGsg: shows [4h 4c] (two pair, Fives and Fours)
eFj4lr1nuXLyCWNTShr1bg: mucks hand 
JFIAqU8lCZ0vWwEl4bdGsg collected $0.60 from pot
*** SUMMARY ***
Total pot $0.60 | Rake $0 
Board [Kd 5d Qd 5h 7d]
Seat 1: eFj4lr1nuXLyCWNTShr1bg (button) mucked
Seat 2: DihMHaz4WNETH1bPDe13kA (small blind) folded before Flop
Seat 3: JFIAqU8lCZ0vWwEl4bdGsg (big blind) showed [4h 4c] and won ($0.60) with two pair, Fives and Fours
Seat 5: LyDHtw3/yniNHW+DvLXbog folded before Flop (didn't bet)
Seat 6: v+QfkGiuj9bgtuNoVnDO8w folded before Flop (didn't bet)




PokerStars Game #59941592856:  Hold'em No Limit ($0.10/$0.25) - 2009/07/01 1:40:08 ET
Table 'IUwZ/e0bDHZPgsIWx0RnNg' 6-max Seat #5 is the button
Seat 2: mvFHK3pE7tCxJEqLjKC70Q ($55.40 in chips) 
Seat 3: dOX4wnYV2sEqvDbF+8KSCw ($25 in chips) 
Seat 4: IyZ9SVxKy7TJvRGFneWTMg ($24.20 in chips) 
Seat 5: kv2o5BKCLOrJIw4oc083jQ ($29.25 in chips) 
Seat 6: NhUN/JpAprdJeamFBgJH1w ($40.35 in chips) 
NhUN/JpAprdJeamFBgJH1w: posts small blind $0.10
V66QiVCQPofyl3a+dpPHQQ joins the table at seat #1 
mvFHK3pE7tCxJEqLjKC70Q: posts big blind $0.25
*** HOLE CARDS ***
dOX4wnYV2sEqvDbF+8KSCw: folds 
IyZ9SVxKy7TJvRGFneWTMg: folds 
kv2o5BKCLOrJIw4oc083jQ: folds 
IyZ9SVxKy7TJvRGFneWTMg leaves the table
NhUN/JpAprdJeamFBgJH1w: raises $0.50 to $0.75
mvFHK3pE7tCxJEqLjKC70Q: folds 
Uncalled bet ($0.50) returned to NhUN/JpAprdJeamFBgJH1w
NhUN/JpAprdJeamFBgJH1w collected $0.50 from pot
NhUN/JpAprdJeamFBgJH1w: doesn't show hand 
*** SUMMARY ***
Total pot $0.50 | Rake $0 
Seat 2: mvFHK3pE7tCxJEqLjKC70Q (big blind) folded before Flop
Seat 3: dOX4wnYV2sEqvDbF+8KSCw folded before Flop (didn't bet)
Seat 4: IyZ9SVxKy7TJvRGFneWTMg folded before Flop (didn't bet)
Seat 5: kv2o5BKCLOrJIw4oc083jQ (button) folded before Flop (didn't bet)
Seat 6: NhUN/JpAprdJeamFBgJH1w (small blind) collected ($0.50)




PokerStars Game #59941592796:  Hold'em No Limit ($0.10/$0.25) - 2009/07/01 1:40:08 ET
Table 'MJ1SB76A4qJrlEa+C5e/8w' 6-max Seat #6 is the button
Seat 1: 0KDZiuXQg6UI9cqBR/AUnQ ($28.50 in chips) 
Seat 2: UA5OsKS3VPaxa7uC8La/kA ($36.35 in chips) 
Seat 3: DihMHaz4WNETH1bPDe13kA ($33.25 in chips) 
Seat 4: SFmT9ZsVopnukjvAzrxTRg ($25.65 in chips) 
Seat 6: JFIAqU8lCZ0vWwEl4bdGsg ($30.30 in chips) 
0KDZiuXQg6UI9cqBR/AUnQ: posts small blind $0.10
UA5OsKS3VPaxa7uC8La/kA: posts big blind $0.25
Hsvkc0/G2VV78oVmWYXecw: sits out 
*** HOLE CARDS ***
DihMHaz4WNETH1bPDe13kA: folds 
SFmT9ZsVopnukjvAzrxTRg: raises $0.75 to $1
JFIAqU8lCZ0vWwEl4bdGsg: folds 
0KDZiuXQg6UI9cqBR/AUnQ: calls $0.90
UA5OsKS3VPaxa7uC8La/kA: folds 
*** FLOP *** [Ts Kc 3h]
0KDZiuXQg6UI9cqBR/AUnQ: checks 
SFmT9ZsVopnukjvAzrxTRg: bets $1.50
0KDZiuXQg6UI9cqBR/AUnQ: calls $1.50
*** TURN *** [Ts Kc 3h] [7c]
0KDZiuXQg6UI9cqBR/AUnQ: checks 
SFmT9ZsVopnukjvAzrxTRg: checks 
*** RIVER *** [Ts Kc 3h 7c] [9s]
0KDZiuXQg6UI9cqBR/AUnQ: checks 
SFmT9ZsVopnukjvAzrxTRg: checks 
*** SHOW DOWN ***
0KDZiuXQg6UI9cqBR/AUnQ: shows [4s 4d] (a pair of Fours)
SFmT9ZsVopnukjvAzrxTRg: shows [Jd Td] (a pair of Tens)
SFmT9ZsVopnukjvAzrxTRg collected $5 from pot
*** SUMMARY ***
Total pot $5.25 | Rake $0.25 
Board [Ts Kc 3h 7c 9s]
Seat 1: 0KDZiuXQg6UI9cqBR/AUnQ (small blind) showed [4s 4d] and lost with a pair of Fours
Seat 2: UA5OsKS3VPaxa7uC8La/kA (big blind) folded before Flop
Seat 3: DihMHaz4WNETH1bPDe13kA folded before Flop (didn't bet)
Seat 4: SFmT9ZsVopnukjvAzrxTRg showed [Jd Td] and won ($5) with a pair of Tens
Seat 6: JFIAqU8lCZ0vWwEl4bdGsg (button) folded before Flop (didn't bet)




PokerStars Game #59941592524:  Hold'em No Limit ($0.10/$0.25) - 2009/07/01 1:40:08 ET
Table 'C47I7CmrmFr8Oo7wOovVwQ' 6-max Seat #4 is the button
Seat 2: hOaWAImn5/MZDAWAPlYHCw ($5.45 in chips) 
Seat 3: H+8eOP3XJHXjACRDTiIHTQ ($15 in chips) 
Seat 4: yY5JuFtDfXWRaZlVby4LLw ($16.50 in chips) 
Seat 6: pD7ri5wL3vsa6S1ulMYQmQ ($25.45 in chips) 
pD7ri5wL3vsa6S1ulMYQmQ: posts small blind $0.10
hOaWAImn5/MZDAWAPlYHCw: posts big blind $0.25
H+8eOP3XJHXjACRDTiIHTQ: posts big blind $0.25
*** HOLE CARDS ***
H+8eOP3XJHXjACRDTiIHTQ: checks 
yY5JuFtDfXWRaZlVby4LLw: raises $0.50 to $0.75
pD7ri5wL3vsa6S1ulMYQmQ: calls $0.65
hOaWAImn5/MZDAWAPlYHCw: folds 
or309yYY9Y9bfFWtrB0yUg joins the table at seat #5 
H+8eOP3XJHXjACRDTiIHTQ: calls $0.50
*** FLOP *** [7d 8h 5c]
v6mkGzCBCCXcgWQNSYVtKg joins the table at seat #1 
pD7ri5wL3vsa6S1ulMYQmQ: checks 
H+8eOP3XJHXjACRDTiIHTQ: bets $1.75
yY5JuFtDfXWRaZlVby4LLw: folds 
pD7ri5wL3vsa6S1ulMYQmQ: folds 
Uncalled bet ($1.75) returned to H+8eOP3XJHXjACRDTiIHTQ
H+8eOP3XJHXjACRDTiIHTQ collected $2.40 from pot
H+8eOP3XJHXjACRDTiIHTQ: doesn't show hand 
*** SUMMARY ***
Total pot $2.50 | Rake $0.10 
Board [7d 8h 5c]
Seat 2: hOaWAImn5/MZDAWAPlYHCw (big blind) folded before Flop
Seat 3: H+8eOP3XJHXjACRDTiIHTQ collected ($2.40)
Seat 4: yY5JuFtDfXWRaZlVby4LLw (button) folded on the Flop
Seat 6: pD7ri5wL3vsa6S1ulMYQmQ (small blind) folded on the Flop




PokerStars Game #59941592598:  Hold'em No Limit ($0.10/$0.25) - 2009/07/01 1:40:08 ET
Table 'KAnP7XvDtlku47YfJwdOVw' 9-max Seat #1 is the button
Seat 1: cH3q40adP+kFogl+2MtbkQ ($14.15 in chips) 
Seat 2: VFTQG1/RfAKeMXRBv1ewsg ($28.10 in chips) 
Seat 3: W6tExOcYX7qiy6Qdp+ZwFA ($5 in chips) 
Seat 4: OiV1PWZ3IkN29JlmCcnTwQ ($5 in chips) 
Seat 5: MG90wfSJZnOejs/KD3vlQQ ($33.40 in chips) 
Seat 6: z5GxcHlYz/GSz6W2uFiTtg ($21.55 in chips) 
Seat 7: Lro4e37x4FUa5P3yzDjskw ($8.55 in chips) 
Seat 8: OneeONzF0MoH0pEdcBndwA ($22.80 in chips) 
Seat 9: HDDm1BkZtdsRyw2DJdqq6A ($24.80 in chips) 
VFTQG1/RfAKeMXRBv1ewsg: posts small blind $0.10
W6tExOcYX7qiy6Qdp+ZwFA: posts big blind $0.25
*** HOLE CARDS ***
OiV1PWZ3IkN29JlmCcnTwQ: folds 
MG90wfSJZnOejs/KD3vlQQ: folds 
z5GxcHlYz/GSz6W2uFiTtg: folds 
Lro4e37x4FUa5P3yzDjskw: calls $0.25
OneeONzF0MoH0pEdcBndwA: folds 
HDDm1BkZtdsRyw2DJdqq6A: raises $0.25 to $0.50
cH3q40adP+kFogl+2MtbkQ: folds 
VFTQG1/RfAKeMXRBv1ewsg: folds 
W6tExOcYX7qiy6Qdp+ZwFA: calls $0.25
Lro4e37x4FUa5P3yzDjskw: calls $0.25
*** FLOP *** [Kc 6h 9h]
W6tExOcYX7qiy6Qdp+ZwFA: bets $1.50
Lro4e37x4FUa5P3yzDjskw: folds 
HDDm1BkZtdsRyw2DJdqq6A: folds 
Uncalled bet ($1.50) returned to W6tExOcYX7qiy6Qdp+ZwFA
W6tExOcYX7qiy6Qdp+ZwFA collected $1.55 from pot
W6tExOcYX7qiy6Qdp+ZwFA: doesn't show hand 
*** SUMMARY ***
Total pot $1.60 | Rake $0.05 
Board [Kc 6h 9h]
Seat 1: cH3q40adP+kFogl+2MtbkQ (button) folded before Flop (didn't bet)
Seat 2: VFTQG1/RfAKeMXRBv1ewsg (small blind) folded before Flop
Seat 3: W6tExOcYX7qiy6Qdp+ZwFA (big blind) collected ($1.55)
Seat 4: OiV1PWZ3IkN29JlmCcnTwQ folded before Flop (didn't bet)
Seat 5: MG90wfSJZnOejs/KD3vlQQ folded before Flop (didn't bet)
Seat 6: z5GxcHlYz/GSz6W2uFiTtg folded before Flop (didn't bet)
Seat 7: Lro4e37x4FUa5P3yzDjskw folded on the Flop
Seat 8: OneeONzF0MoH0pEdcBndwA folded before Flop (didn't bet)
Seat 9: HDDm1BkZtdsRyw2DJdqq6A folded on the Flop




PokerStars Game #59941592588:  Hold'em No Limit ($0.10/$0.25) - 2009/07/01 1:40:08 ET
Table 'mF3KHGMaTpaBZbtBoyfTeg' 6-max Seat #2 is the button
Seat 1: 0HAB2GdCAM7p7V00xueAVQ ($25.90 in chips) 
Seat 2: 6qsh9pnysDKJNhfFhFmKRQ ($9.40 in chips) 
Seat 3: 9kUKGKkblnIx3m8rlVol6Q ($14.75 in chips) 
Seat 4: FYepjhAvF8ZdVCmqHIy+eQ ($25 in chips) 
Seat 5: 8ClCHtFXGNplITm+63KB+Q ($42.50 in chips) 
Seat 6: kG34n23qFQA3nzdOJTQ1dA ($27.50 in chips) 
9kUKGKkblnIx3m8rlVol6Q: posts small blind $0.10
FYepjhAvF8ZdVCmqHIy+eQ: posts big blind $0.25
*** HOLE CARDS ***
8ClCHtFXGNplITm+63KB+Q: raises $0.75 to $1
kG34n23qFQA3nzdOJTQ1dA: folds 
0HAB2GdCAM7p7V00xueAVQ: calls $1
6qsh9pnysDKJNhfFhFmKRQ: folds 
9kUKGKkblnIx3m8rlVol6Q: folds 
FYepjhAvF8ZdVCmqHIy+eQ: folds 
*** FLOP *** [Jc 2h Qh]
8ClCHtFXGNplITm+63KB+Q: bets $1.50
0HAB2GdCAM7p7V00xueAVQ: folds 
Uncalled bet ($1.50) returned to 8ClCHtFXGNplITm+63KB+Q
8ClCHtFXGNplITm+63KB+Q collected $2.25 from pot
8ClCHtFXGNplITm+63KB+Q: doesn't show hand 
*** SUMMARY ***
Total pot $2.35 | Rake $0.10 
Board [Jc 2h Qh]
Seat 1: 0HAB2GdCAM7p7V00xueAVQ folded on the Flop
Seat 2: 6qsh9pnysDKJNhfFhFmKRQ (button) folded before Flop (didn't bet)
Seat 3: 9kUKGKkblnIx3m8rlVol6Q (small blind) folded before Flop
Seat 4: FYepjhAvF8ZdVCmqHIy+eQ (big blind) folded before Flop
Seat 5: 8ClCHtFXGNplITm+63KB+Q collected ($2.25)
Seat 6: kG34n23qFQA3nzdOJTQ1dA folded before Flop (didn't bet)




PokerStars Game #59941592552:  Hold'em No Limit ($0.10/$0.25) - 2009/07/01 1:40:08 ET
Table 'srBTB98reCdD1TffxE6o7g' 6-max Seat #6 is the button
Seat 1: SFmT9ZsVopnukjvAzrxTRg ($33.70 in chips) 
Seat 2: mfrkWA3PTeYPkbO6hi98Aw ($25 in chips) 
Seat 3: VOmI0x4dDPnTESZd5B4d1Q ($48.20 in chips) 
Seat 4: 6DwBRH+xZ12AAZmeAg+aXw ($21.30 in chips) 
Seat 5: 8zUCJvLYLFM8AG6K5zjIvg ($12.30 in chips) 
Seat 6: BV+K0Phf5VBHr7aZPKqbUQ ($31.20 in chips) 
SFmT9ZsVopnukjvAzrxTRg: posts small blind $0.10
mfrkWA3PTeYPkbO6hi98Aw: posts big blind $0.25
*** HOLE CARDS ***
VOmI0x4dDPnTESZd5B4d1Q: folds 
6DwBRH+xZ12AAZmeAg+aXw: folds 
8zUCJvLYLFM8AG6K5zjIvg: folds 
BV+K0Phf5VBHr7aZPKqbUQ: raises $0.50 to $0.75
SFmT9ZsVopnukjvAzrxTRg: folds 
mfrkWA3PTeYPkbO6hi98Aw: calls $0.50
*** FLOP *** [Tc 4c 5s]
mfrkWA3PTeYPkbO6hi98Aw: checks 
BV+K0Phf5VBHr7aZPKqbUQ: bets $1
mfrkWA3PTeYPkbO6hi98Aw: calls $1
*** TURN *** [Tc 4c 5s] [3d]
mfrkWA3PTeYPkbO6hi98Aw: checks 
BV+K0Phf5VBHr7aZPKqbUQ: bets $2.25
mfrkWA3PTeYPkbO6hi98Aw: calls $2.25
*** RIVER *** [Tc 4c 5s 3d] [9d]
mfrkWA3PTeYPkbO6hi98Aw: checks 
BV+K0Phf5VBHr7aZPKqbUQ: checks 
*** SHOW DOWN ***
mfrkWA3PTeYPkbO6hi98Aw: shows [2h 2s] (a pair of Deuces)
BV+K0Phf5VBHr7aZPKqbUQ: shows [Th Qc] (a pair of Tens)
BV+K0Phf5VBHr7aZPKqbUQ collected $7.75 from pot
*** SUMMARY ***
Total pot $8.10 | Rake $0.35 
Board [Tc 4c 5s 3d 9d]
Seat 1: SFmT9ZsVopnukjvAzrxTRg (small blind) folded before Flop
Seat 2: mfrkWA3PTeYPkbO6hi98Aw (big blind) showed [2h 2s] and lost with a pair of Deuces
Seat 3: VOmI0x4dDPnTESZd5B4d1Q folded before Flop (didn't bet)
Seat 4: 6DwBRH+xZ12AAZmeAg+aXw folded before Flop (didn't bet)
Seat 5: 8zUCJvLYLFM8AG6K5zjIvg folded before Flop (didn't bet)
Seat 6: BV+K0Phf5VBHr7aZPKqbUQ (button) showed [Th Qc] and won ($7.75) with a pair of Tens




PokerStars Game #59941592802:  Hold'em No Limit ($0.10/$0.25) - 2009/07/01 1:40:08 ET
Table 'zKwHJD0cmKNUure9qQTfFg' 6-max Seat #5 is the button
Seat 1: RXYRBsbRgZxcivyqSdOo3A ($3.90 in chips) 
Seat 2: xrf8tAXKQHG99HixCot1Iw ($26.90 in chips) 
Seat 3: 60PLIlpucQhA08L3YbNmag ($5.60 in chips) 
Seat 4: v+QfkGiuj9bgtuNoVnDO8w ($25.80 in chips) 
Seat 5: E4AqQ1egsnu0oH2RqsbCmQ ($4.45 in chips) 
Seat 6: edio/rLJ06xeZOfLhoL3UA ($11.30 in chips) 
edio/rLJ06xeZOfLhoL3UA: posts small blind $0.10
RXYRBsbRgZxcivyqSdOo3A: posts big blind $0.25
*** HOLE CARDS ***
xrf8tAXKQHG99HixCot1Iw: folds 
60PLIlpucQhA08L3YbNmag: folds 
v+QfkGiuj9bgtuNoVnDO8w: raises $0.75 to $1
E4AqQ1egsnu0oH2RqsbCmQ: folds 
edio/rLJ06xeZOfLhoL3UA: folds 
RXYRBsbRgZxcivyqSdOo3A: folds 
Uncalled bet ($0.75) returned to v+QfkGiuj9bgtuNoVnDO8w
v+QfkGiuj9bgtuNoVnDO8w collected $0.60 from pot
v+QfkGiuj9bgtuNoVnDO8w: doesn't show hand 
*** SUMMARY ***
Total pot $0.60 | Rake $0 
Seat 1: RXYRBsbRgZxcivyqSdOo3A (big blind) folded before Flop
Seat 2: xrf8tAXKQHG99HixCot1Iw folded before Flop (didn't bet)
Seat 3: 60PLIlpucQhA08L3YbNmag folded before Flop (didn't bet)
Seat 4: v+QfkGiuj9bgtuNoVnDO8w collected ($0.60)
Seat 5: E4AqQ1egsnu0oH2RqsbCmQ (button) folded before Flop (didn't bet)
Seat 6: edio/rLJ06xeZOfLhoL3UA (small blind) folded before Flop




PokerStars Game #59941592522:  Hold'em No Limit ($0.10/$0.25) - 2009/07/01 1:40:08 ET
Table '2clPgY3+dETPD/8zjXZdFw' 6-max Seat #6 is the button
Seat 1: 4WFKzsjLSGnvHbVxKabsvQ ($28.55 in chips) 
Seat 2: cWc85bEzdRzpUMhRKm8pwQ ($25 in chips) 
Seat 3: SFmT9ZsVopnukjvAzrxTRg ($25 in chips) 
Seat 4: ljjhtb6FVPTx9AT9HNdtqg ($18.65 in chips) 
Seat 5: LJI7A1YgDM7hgh7o56+ReQ ($25 in chips) 
Seat 6: 2G0C7dp4wlPpE21FHjjElQ ($26.90 in chips) 
4WFKzsjLSGnvHbVxKabsvQ: posts small blind $0.10
cWc85bEzdRzpUMhRKm8pwQ: posts big blind $0.25
*** HOLE CARDS ***
SFmT9ZsVopnukjvAzrxTRg: folds 
ljjhtb6FVPTx9AT9HNdtqg: folds 
LJI7A1YgDM7hgh7o56+ReQ: folds 
2G0C7dp4wlPpE21FHjjElQ: folds 
4WFKzsjLSGnvHbVxKabsvQ: calls $0.15
cWc85bEzdRzpUMhRKm8pwQ: raises $0.75 to $1
4WFKzsjLSGnvHbVxKabsvQ: calls $0.75
*** FLOP *** [Qc 6d 3c]
4WFKzsjLSGnvHbVxKabsvQ: checks 
cWc85bEzdRzpUMhRKm8pwQ: checks 
*** TURN *** [Qc 6d 3c] [Tc]
4WFKzsjLSGnvHbVxKabsvQ: checks 
cWc85bEzdRzpUMhRKm8pwQ: checks 
*** RIVER *** [Qc 6d 3c Tc] [5c]
4WFKzsjLSGnvHbVxKabsvQ: bets $3.50
cWc85bEzdRzpUMhRKm8pwQ: folds 
Uncalled bet ($3.50) returned to 4WFKzsjLSGnvHbVxKabsvQ
4WFKzsjLSGnvHbVxKabsvQ collected $1.90 from pot
*** SUMMARY ***
Total pot $2 | Rake $0.10 
Board [Qc 6d 3c Tc 5c]
Seat 1: 4WFKzsjLSGnvHbVxKabsvQ (small blind) collected ($1.90)
Seat 2: cWc85bEzdRzpUMhRKm8pwQ (big blind) folded on the River
Seat 3: SFmT9ZsVopnukjvAzrxTRg folded before Flop (didn't bet)
Seat 4: ljjhtb6FVPTx9AT9HNdtqg folded before Flop (didn't bet)
Seat 5: LJI7A1YgDM7hgh7o56+ReQ folded before Flop (didn't bet)
Seat 6: 2G0C7dp4wlPpE21FHjjElQ (button) folded before Flop (didn't bet)




PokerStars Game #59941592670:  Hold'em No Limit ($0.10/$0.25) - 2009/07/01 1:40:08 ET
Table 'Qk/910N2Yhg8u5vqTJk50Q' 9-max Seat #2 is the button
Seat 1: zDrucyjVn5aeekNEc3cJrA ($22.55 in chips) 
Seat 2: Th3FldXKQW6hWVVPahaoOQ ($45.65 in chips) 
Seat 3: ghNKXUBl/H+t83JF079ZBA ($26.10 in chips) 
Seat 7: aNpwfA31EREwO+ar4XzBCw ($25.35 in chips) 
Seat 8: H5Se03ZqSX7tbULXur2MAg ($25.50 in chips) 
Seat 9: M2QO2DxB5Wawg2h8HSpnYA ($18.70 in chips) 
ghNKXUBl/H+t83JF079ZBA: posts small blind $0.10
4oA316mXLIui1QY63GXBUg: is sitting out 
4oA316mXLIui1QY63GXBUg leaves the table
8GJHzzxiotOqC5gdtgpLoA: is sitting out 
aNpwfA31EREwO+ar4XzBCw: posts big blind $0.25
*** HOLE CARDS ***
8GJHzzxiotOqC5gdtgpLoA leaves the table
zReBEigsxqZnag0RZAgpgA joins the table at seat #5 
H5Se03ZqSX7tbULXur2MAg: folds 
H5Se03ZqSX7tbULXur2MAg leaves the table
M2QO2DxB5Wawg2h8HSpnYA: folds 
zDrucyjVn5aeekNEc3cJrA: folds 
Th3FldXKQW6hWVVPahaoOQ: folds 
9PMD136+PrUsTwnP6fczyA joins the table at seat #8 
ghNKXUBl/H+t83JF079ZBA: folds 
Uncalled bet ($0.15) returned to aNpwfA31EREwO+ar4XzBCw
aNpwfA31EREwO+ar4XzBCw collected $0.20 from pot
aNpwfA31EREwO+ar4XzBCw: doesn't show hand 
*** SUMMARY ***
Total pot $0.20 | Rake $0 
Seat 1: zDrucyjVn5aeekNEc3cJrA folded before Flop (didn't bet)
Seat 2: Th3FldXKQW6hWVVPahaoOQ (button) folded before Flop (didn't bet)
Seat 3: ghNKXUBl/H+t83JF079ZBA (small blind) folded before Flop
Seat 7: aNpwfA31EREwO+ar4XzBCw (big blind) collected ($0.20)
Seat 8: H5Se03ZqSX7tbULXur2MAg folded before Flop (didn't bet)
Seat 9: M2QO2DxB5Wawg2h8HSpnYA folded before Flop (didn't bet)




PokerStars Game #59941593514:  Hold'em No Limit ($0.10/$0.25) - 2009/07/01 1:40:09 ET
Table 'jdhJTJjFq2KTttwJcd+7nQ' 6-max Seat #3 is the button
Seat 1: LtASJ9OlkqGrrUKGQlpGAw ($27.05 in chips) 
Seat 2: Hsvkc0/G2VV78oVmWYXecw ($5 in chips) 
Seat 3: vqWjZmdQu/Hxw96/IJTWdQ ($25 in chips) 
Seat 4: vx7FwRcelVSsvNYAdp/z0A ($3.60 in chips) 
Seat 5: BV+K0Phf5VBHr7aZPKqbUQ ($25 in chips) 
Seat 6: yb6rnd48JuBccThV68VHAQ ($20.40 in chips) 
vx7FwRcelVSsvNYAdp/z0A: posts small blind $0.10
BV+K0Phf5VBHr7aZPKqbUQ: posts big blind $0.25
*** HOLE CARDS ***
yb6rnd48JuBccThV68VHAQ: folds 
LtASJ9OlkqGrrUKGQlpGAw: folds 
Hsvkc0/G2VV78oVmWYXecw: folds 
vqWjZmdQu/Hxw96/IJTWdQ: raises $0.75 to $1
vx7FwRcelVSsvNYAdp/z0A: folds 
BV+K0Phf5VBHr7aZPKqbUQ: raises $2.50 to $3.50
vqWjZmdQu/Hxw96/IJTWdQ: folds 
Uncalled bet ($2.50) returned to BV+K0Phf5VBHr7aZPKqbUQ
BV+K0Phf5VBHr7aZPKqbUQ collected $2.10 from pot
BV+K0Phf5VBHr7aZPKqbUQ: doesn't show hand 
*** SUMMARY ***
Total pot $2.10 | Rake $0 
Seat 1: LtASJ9OlkqGrrUKGQlpGAw folded before Flop (didn't bet)
Seat 2: Hsvkc0/G2VV78oVmWYXecw folded before Flop (didn't bet)
Seat 3: vqWjZmdQu/Hxw96/IJTWdQ (button) folded before Flop
Seat 4: vx7FwRcelVSsvNYAdp/z0A (small blind) folded before Flop
Seat 5: BV+K0Phf5VBHr7aZPKqbUQ (big blind) collected ($2.10)
Seat 6: yb6rnd48JuBccThV68VHAQ folded before Flop (didn't bet)




PokerStars Game #59941593300:  Hold'em No Limit ($0.10/$0.25) - 2009/07/01 1:40:09 ET
Table '7/qMNloI0nSXWiX5Y1watA' 9-max Seat #9 is the button
Seat 1: /LyhaB3V6jkgOfXORidqRQ ($7.85 in chips) 
Seat 2: wGigCmBR/9XWkPpvYos3aQ ($33.15 in chips) 
Seat 3: W2YYHvqjaEpRrO7stZkClQ ($5.45 in chips) 
Seat 4: K0LdhPeU31rviEPo6Sv3TA ($9 in chips) 
Seat 6: Y3DZ6qQlLeBhixDj4M9vmg ($6.10 in chips) 
Seat 7: z5GxcHlYz/GSz6W2uFiTtg ($23.55 in chips) 
Seat 8: ljemhp25Zg+nlA9DLCIiUw ($24 in chips) 
Seat 9: dmYlc+1cjwZMJ7wV+Z0rRg ($26.50 in chips) 
/LyhaB3V6jkgOfXORidqRQ: posts small blind $0.10
wGigCmBR/9XWkPpvYos3aQ: posts big blind $0.25
*** HOLE CARDS ***
W2YYHvqjaEpRrO7stZkClQ: raises $0.25 to $0.50
K0LdhPeU31rviEPo6Sv3TA: folds 
K0LdhPeU31rviEPo6Sv3TA is sitting out
Y3DZ6qQlLeBhixDj4M9vmg: calls $0.50
z5GxcHlYz/GSz6W2uFiTtg: folds 
ljemhp25Zg+nlA9DLCIiUw: folds 
dmYlc+1cjwZMJ7wV+Z0rRg: folds 
/LyhaB3V6jkgOfXORidqRQ: raises $0.25 to $0.75
wGigCmBR/9XWkPpvYos3aQ: folds 
W2YYHvqjaEpRrO7stZkClQ: calls $0.25
Y3DZ6qQlLeBhixDj4M9vmg: calls $0.25
*** FLOP *** [5d 8c Jh]
/LyhaB3V6jkgOfXORidqRQ: checks 
W2YYHvqjaEpRrO7stZkClQ: checks 
Y3DZ6qQlLeBhixDj4M9vmg: bets $1
/LyhaB3V6jkgOfXORidqRQ: folds 
W2YYHvqjaEpRrO7stZkClQ: folds 
Uncalled bet ($1) returned to Y3DZ6qQlLeBhixDj4M9vmg
Y3DZ6qQlLeBhixDj4M9vmg collected $2.40 from pot
*** SUMMARY ***
Total pot $2.50 | Rake $0.10 
Board [5d 8c Jh]
Seat 1: /LyhaB3V6jkgOfXORidqRQ (small blind) folded on the Flop
Seat 2: wGigCmBR/9XWkPpvYos3aQ (big blind) folded before Flop
Seat 3: W2YYHvqjaEpRrO7stZkClQ folded on the Flop
Seat 4: K0LdhPeU31rviEPo6Sv3TA folded before Flop (didn't bet)
Seat 6: Y3DZ6qQlLeBhixDj4M9vmg collected ($2.40)
Seat 7: z5GxcHlYz/GSz6W2uFiTtg folded before Flop (didn't bet)
Seat 8: ljemhp25Zg+nlA9DLCIiUw folded before Flop (didn't bet)
Seat 9: dmYlc+1cjwZMJ7wV+Z0rRg (button) folded before Flop (didn't bet)




PokerStars Game #59941593426:  Hold'em No Limit ($0.10/$0.25) - 2009/07/01 1:40:09 ET
Table '/JJyyIstHfkT7t/bW+WXgg' 6-max Seat #1 is the button
Seat 1: wsP46AGpqDjHZQmlRHKa9g ($25 in chips) 
Seat 2: obJgSnVgWWWaAUtVILo77Q ($7.85 in chips) 
Seat 3: DR0nVIhVP77oEBlO9J8vlg ($46.15 in chips) 
Seat 4: JFIAqU8lCZ0vWwEl4bdGsg ($35.75 in chips) 
Seat 5: +ZlnqPoP3Hg4BIUxDfKd/A ($48.50 in chips) 
obJgSnVgWWWaAUtVILo77Q: posts small blind $0.10
DR0nVIhVP77oEBlO9J8vlg: posts big blind $0.25
*** HOLE CARDS ***
JFIAqU8lCZ0vWwEl4bdGsg: folds 
+ZlnqPoP3Hg4BIUxDfKd/A: folds 
wsP46AGpqDjHZQmlRHKa9g: raises $0.50 to $0.75
obJgSnVgWWWaAUtVILo77Q: folds 
DR0nVIhVP77oEBlO9J8vlg: folds 
Uncalled bet ($0.50) returned to wsP46AGpqDjHZQmlRHKa9g
wsP46AGpqDjHZQmlRHKa9g collected $0.60 from pot
*** SUMMARY ***
Total pot $0.60 | Rake $0 
Seat 1: wsP46AGpqDjHZQmlRHKa9g (button) collected ($0.60)
Seat 2: obJgSnVgWWWaAUtVILo77Q (small blind) folded before Flop
Seat 3: DR0nVIhVP77oEBlO9J8vlg (big blind) folded before Flop
Seat 4: JFIAqU8lCZ0vWwEl4bdGsg folded before Flop (didn't bet)
Seat 5: +ZlnqPoP3Hg4BIUxDfKd/A folded before Flop (didn't bet)




PokerStars Game #59941593700:  Hold'em No Limit ($0.10/$0.25) - 2009/07/01 1:40:10 ET
Table 'aT31tt16YvQM/Ue69HPLpA' 9-max Seat #3 is the button
Seat 1: fIgGw0jPUR7labvJPaPbeg ($11.50 in chips) 
Seat 2: PdIasPkzm2sqZnN41ZRXOg ($4.90 in chips) 
Seat 3: tYsOBqdU1+x+yFI7zHO7hQ ($26.15 in chips) 
Seat 4: wGigCmBR/9XWkPpvYos3aQ ($28.10 in chips) 
Seat 5: s2xLPOl/vhl/26apJ3vsOQ ($33.50 in chips) 
Seat 6: 7cv+9Zc9HIQHNvYsMfV3uA ($58.80 in chips) 
Seat 7: W8cIfrCR+zA8pCNyIuHu8g ($32.30 in chips) 
Seat 9: TvIuLx9zUCE+9Li58iImOQ ($17.95 in chips) 
wGigCmBR/9XWkPpvYos3aQ: posts small blind $0.10
s2xLPOl/vhl/26apJ3vsOQ: posts big blind $0.25
*** HOLE CARDS ***
7cv+9Zc9HIQHNvYsMfV3uA: folds 
W8cIfrCR+zA8pCNyIuHu8g: folds 
TvIuLx9zUCE+9Li58iImOQ: raises $0.75 to $1
W6tExOcYX7qiy6Qdp+ZwFA joins the table at seat #8 
fIgGw0jPUR7labvJPaPbeg: calls $1
PdIasPkzm2sqZnN41ZRXOg: folds 
tYsOBqdU1+x+yFI7zHO7hQ: folds 
wGigCmBR/9XWkPpvYos3aQ: folds 
s2xLPOl/vhl/26apJ3vsOQ: calls $0.75
*** FLOP *** [2c Jc 6d]
s2xLPOl/vhl/26apJ3vsOQ: checks 
TvIuLx9zUCE+9Li58iImOQ: checks 
fIgGw0jPUR7labvJPaPbeg: bets $1.50
s2xLPOl/vhl/26apJ3vsOQ: calls $1.50
TvIuLx9zUCE+9Li58iImOQ: folds 
*** TURN *** [2c Jc 6d] [Ad]
s2xLPOl/vhl/26apJ3vsOQ: checks 
fIgGw0jPUR7labvJPaPbeg: bets $1
s2xLPOl/vhl/26apJ3vsOQ: calls $1
*** RIVER *** [2c Jc 6d Ad] [Js]
s2xLPOl/vhl/26apJ3vsOQ: bets $5
fIgGw0jPUR7labvJPaPbeg: folds 
Uncalled bet ($5) returned to s2xLPOl/vhl/26apJ3vsOQ
s2xLPOl/vhl/26apJ3vsOQ collected $7.75 from pot
*** SUMMARY ***
Total pot $8.10 | Rake $0.35 
Board [2c Jc 6d Ad Js]
Seat 1: fIgGw0jPUR7labvJPaPbeg folded on the River
Seat 2: PdIasPkzm2sqZnN41ZRXOg folded before Flop (didn't bet)
Seat 3: tYsOBqdU1+x+yFI7zHO7hQ (button) folded before Flop (didn't bet)
Seat 4: wGigCmBR/9XWkPpvYos3aQ (small blind) folded before Flop
Seat 5: s2xLPOl/vhl/26apJ3vsOQ (big blind) collected ($7.75)
Seat 6: 7cv+9Zc9HIQHNvYsMfV3uA folded before Flop (didn't bet)
Seat 7: W8cIfrCR+zA8pCNyIuHu8g folded before Flop (didn't bet)
Seat 9: TvIuLx9zUCE+9Li58iImOQ folded on the Flop




PokerStars Game #59941594012:  Hold'em No Limit ($0.10/$0.25) - 2009/07/01 1:40:10 ET
Table '3Ns9nuTkynfwbBfBXzg6ww' 6-max Seat #3 is the button
Seat 2: zxeVQGaMKDsDzmSY+AInjA ($33.85 in chips) 
Seat 3: eL3+wCBjFGfQ5FMdIZihwA ($24.65 in chips) 
Seat 4: qGHGf/553gQnDoklMRe3tg ($31.20 in chips) 
Seat 5: wqphQtauX5Qn7WRJZS1flA ($24.65 in chips) 
Seat 6: DE9hRlt14g+JdsRQ4wT7hg ($36.05 in chips) 
qGHGf/553gQnDoklMRe3tg: posts small blind $0.10
wqphQtauX5Qn7WRJZS1flA: posts big blind $0.25
epAUIB7h2FJXzUPRIvSkRA: sits out 
*** HOLE CARDS ***
DE9hRlt14g+JdsRQ4wT7hg: folds 
zxeVQGaMKDsDzmSY+AInjA: calls $0.25
eL3+wCBjFGfQ5FMdIZihwA: folds 
qGHGf/553gQnDoklMRe3tg: calls $0.15
wqphQtauX5Qn7WRJZS1flA: checks 
*** FLOP *** [4h Jh 7s]
qGHGf/553gQnDoklMRe3tg: checks 
wqphQtauX5Qn7WRJZS1flA: checks 
zxeVQGaMKDsDzmSY+AInjA: checks 
*** TURN *** [4h Jh 7s] [2c]
qGHGf/553gQnDoklMRe3tg: checks 
wqphQtauX5Qn7WRJZS1flA: checks 
zxeVQGaMKDsDzmSY+AInjA: checks 
*** RIVER *** [4h Jh 7s 2c] [9h]
qGHGf/553gQnDoklMRe3tg: checks 
wqphQtauX5Qn7WRJZS1flA: checks 
zxeVQGaMKDsDzmSY+AInjA: checks 
*** SHOW DOWN ***
qGHGf/553gQnDoklMRe3tg: shows [8s Qd] (high card Queen)
wqphQtauX5Qn7WRJZS1flA: shows [3d As] (high card Ace)
zxeVQGaMKDsDzmSY+AInjA: mucks hand 
wqphQtauX5Qn7WRJZS1flA collected $0.75 from pot
*** SUMMARY ***
Total pot $0.75 | Rake $0 
Board [4h Jh 7s 2c 9h]
Seat 2: zxeVQGaMKDsDzmSY+AInjA mucked
Seat 3: eL3+wCBjFGfQ5FMdIZihwA (button) folded before Flop (didn't bet)
Seat 4: qGHGf/553gQnDoklMRe3tg (small blind) showed [8s Qd] and lost with high card Queen
Seat 5: wqphQtauX5Qn7WRJZS1flA (big blind) showed [3d As] and won ($0.75) with high card Ace
Seat 6: DE9hRlt14g+JdsRQ4wT7hg folded before Flop (didn't bet)




PokerStars Game #59941594698:  Hold'em No Limit ($0.10/$0.25) - 2009/07/01 1:40:11 ET
Table '9iHhO6FyZVM8XpSc23TIgg' 6-max Seat #3 is the button
Seat 1: NhUN/JpAprdJeamFBgJH1w ($44.25 in chips) 
Seat 2: bJFzs6QmEEnz4miMfSDtcg ($38.55 in chips) 
Seat 3: TSmua8tGK3sTbwi0ynrW9Q ($26.50 in chips) 
Seat 5: xrf8tAXKQHG99HixCot1Iw ($21.90 in chips) 
Seat 6: iyZxqznXjv3vtvOJymkoLQ ($34.45 in chips) 
cfJccEfyn6IkquPN08hFsA will be allowed to play after the button
xrf8tAXKQHG99HixCot1Iw: posts small blind $0.10
iyZxqznXjv3vtvOJymkoLQ: posts big blind $0.25
*** HOLE CARDS ***
NhUN/JpAprdJeamFBgJH1w: folds 
bJFzs6QmEEnz4miMfSDtcg: folds 
TSmua8tGK3sTbwi0ynrW9Q: raises $0.50 to $0.75
xrf8tAXKQHG99HixCot1Iw: folds 
iyZxqznXjv3vtvOJymkoLQ: folds 
Uncalled bet ($0.50) returned to TSmua8tGK3sTbwi0ynrW9Q
TSmua8tGK3sTbwi0ynrW9Q collected $0.60 from pot
*** SUMMARY ***
Total pot $0.60 | Rake $0 
Seat 1: NhUN/JpAprdJeamFBgJH1w folded before Flop (didn't bet)
Seat 2: bJFzs6QmEEnz4miMfSDtcg folded before Flop (didn't bet)
Seat 3: TSmua8tGK3sTbwi0ynrW9Q (button) collected ($0.60)
Seat 5: xrf8tAXKQHG99HixCot1Iw (small blind) folded before Flop
Seat 6: iyZxqznXjv3vtvOJymkoLQ (big blind) folded before Flop




PokerStars Game #59941594394:  Hold'em No Limit ($0.10/$0.25) - 2009/07/01 1:40:11 ET
Table 'eOXPe2c6mG7DOFKvMsZZfA' 6-max Seat #5 is the button
Seat 1: s21kVGMLPAoHdWR+muSonw ($25 in chips) 
Seat 2: gaPMxLGp9SOj4Lq6t+/0Ig ($7.45 in chips) 
Seat 3: kReyZ6g6Fu3tQ0nyjDf9kA ($20.70 in chips) 
Seat 4: zHHLkD2sRljslKKeQv/ZQw ($40.50 in chips) 
Seat 5: NhUN/JpAprdJeamFBgJH1w ($32.15 in chips) 
Seat 6: Qpv/hb5ak7LeaDig1L5L8w ($15.35 in chips) 
Qpv/hb5ak7LeaDig1L5L8w: posts small blind $0.10
s21kVGMLPAoHdWR+muSonw: posts big blind $0.25
*** HOLE CARDS ***
gaPMxLGp9SOj4Lq6t+/0Ig: folds 
kReyZ6g6Fu3tQ0nyjDf9kA: folds 
zHHLkD2sRljslKKeQv/ZQw: calls $0.25
NhUN/JpAprdJeamFBgJH1w: folds 
Qpv/hb5ak7LeaDig1L5L8w: calls $0.15
s21kVGMLPAoHdWR+muSonw: checks 
*** FLOP *** [8c 3d 2d]
Qpv/hb5ak7LeaDig1L5L8w: checks 
s21kVGMLPAoHdWR+muSonw: checks 
zHHLkD2sRljslKKeQv/ZQw: checks 
*** TURN *** [8c 3d 2d] [Qd]
Qpv/hb5ak7LeaDig1L5L8w: checks 
s21kVGMLPAoHdWR+muSonw: checks 
zHHLkD2sRljslKKeQv/ZQw: checks 
*** RIVER *** [8c 3d 2d Qd] [7d]
Qpv/hb5ak7LeaDig1L5L8w: checks 
s21kVGMLPAoHdWR+muSonw: checks 
zHHLkD2sRljslKKeQv/ZQw: checks 
*** SHOW DOWN ***
Qpv/hb5ak7LeaDig1L5L8w: shows [Jc 9s] (high card Queen)
s21kVGMLPAoHdWR+muSonw: shows [5d 3c] (a flush, Queen high)
zHHLkD2sRljslKKeQv/ZQw: mucks hand 
s21kVGMLPAoHdWR+muSonw collected $0.75 from pot
*** SUMMARY ***
Total pot $0.75 | Rake $0 
Board [8c 3d 2d Qd 7d]
Seat 1: s21kVGMLPAoHdWR+muSonw (big blind) showed [5d 3c] and won ($0.75) with a flush, Queen high
Seat 2: gaPMxLGp9SOj4Lq6t+/0Ig folded before Flop (didn't bet)
Seat 3: kReyZ6g6Fu3tQ0nyjDf9kA folded before Flop (didn't bet)
Seat 4: zHHLkD2sRljslKKeQv/ZQw mucked
Seat 5: NhUN/JpAprdJeamFBgJH1w (button) folded before Flop (didn't bet)
Seat 6: Qpv/hb5ak7LeaDig1L5L8w (small blind) showed [Jc 9s] and lost with high card Queen




PokerStars Game #59941594374:  Hold'em No Limit ($0.10/$0.25) - 2009/07/01 1:40:11 ET
Table 'JJzUs04lHpXg6nboT1/jeg' 6-max Seat #2 is the button
Seat 1: MqMK8OWPSY1V4stf1Hy5Jw ($38.95 in chips) 
Seat 2: jxfR29d+dK/7h7s3SvCk+g ($4.85 in chips) 
Seat 3: 4zXbHDe39qNX46dAo81b4w ($7.05 in chips) 
Seat 4: 7VfhiFY533nbUKvyEthASw ($30.20 in chips) 
Seat 5: QvTX2yGq3uKJiKPmns4TKQ ($23 in chips) 
Seat 6: wqphQtauX5Qn7WRJZS1flA ($28.95 in chips) 
4zXbHDe39qNX46dAo81b4w: posts small blind $0.10
7VfhiFY533nbUKvyEthASw: posts big blind $0.25
*** HOLE CARDS ***
QvTX2yGq3uKJiKPmns4TKQ: folds 
wqphQtauX5Qn7WRJZS1flA: raises $0.50 to $0.75
MqMK8OWPSY1V4stf1Hy5Jw: folds 
jxfR29d+dK/7h7s3SvCk+g: folds 
4zXbHDe39qNX46dAo81b4w: folds 
7VfhiFY533nbUKvyEthASw: folds 
Uncalled bet ($0.50) returned to wqphQtauX5Qn7WRJZS1flA
wqphQtauX5Qn7WRJZS1flA collected $0.60 from pot
wqphQtauX5Qn7WRJZS1flA: doesn't show hand 
*** SUMMARY ***
Total pot $0.60 | Rake $0 
Seat 1: MqMK8OWPSY1V4stf1Hy5Jw folded before Flop (didn't bet)
Seat 2: jxfR29d+dK/7h7s3SvCk+g (button) folded before Flop (didn't bet)
Seat 3: 4zXbHDe39qNX46dAo81b4w (small blind) folded before Flop
Seat 4: 7VfhiFY533nbUKvyEthASw (big blind) folded before Flop
Seat 5: QvTX2yGq3uKJiKPmns4TKQ folded before Flop (didn't bet)
Seat 6: wqphQtauX5Qn7WRJZS1flA collected ($0.60)




PokerStars Game #59941594378:  Hold'em No Limit ($0.10/$0.25) - 2009/07/01 1:40:11 ET
Table '3LMlz3V4AziGlU+ikmyU8w' 6-max Seat #5 is the button
Seat 1: Wxq4Qyj0DnDXj2+taEOJFQ ($29.90 in chips) 
Seat 2: uR3AbFJLoOX86DOTtTgGcg ($23.90 in chips) 
Seat 3: Hzy03WtPHMYwLYM7hTTxQw ($25 in chips) 
Seat 4: 6DwBRH+xZ12AAZmeAg+aXw ($20.05 in chips) 
Seat 5: tOAk1Og4mVObMBOfvdDYOw ($25 in chips) 
Seat 6: ZZm/rg8aThjE+A2LiItuzA ($1.20 in chips) 
ZZm/rg8aThjE+A2LiItuzA: posts small blind $0.10
Wxq4Qyj0DnDXj2+taEOJFQ: posts big blind $0.25
*** HOLE CARDS ***
uR3AbFJLoOX86DOTtTgGcg: folds 
Hzy03WtPHMYwLYM7hTTxQw: folds 
6DwBRH+xZ12AAZmeAg+aXw: raises $0.50 to $0.75
tOAk1Og4mVObMBOfvdDYOw: raises $2.25 to $3
ZZm/rg8aThjE+A2LiItuzA: folds 
Wxq4Qyj0DnDXj2+taEOJFQ: folds 
6DwBRH+xZ12AAZmeAg+aXw: folds 
Uncalled bet ($2.25) returned to tOAk1Og4mVObMBOfvdDYOw
tOAk1Og4mVObMBOfvdDYOw collected $1.85 from pot
tOAk1Og4mVObMBOfvdDYOw: doesn't show hand 
*** SUMMARY ***
Total pot $1.85 | Rake $0 
Seat 1: Wxq4Qyj0DnDXj2+taEOJFQ (big blind) folded before Flop
Seat 2: uR3AbFJLoOX86DOTtTgGcg folded before Flop (didn't bet)
Seat 3: Hzy03WtPHMYwLYM7hTTxQw folded before Flop (didn't bet)
Seat 4: 6DwBRH+xZ12AAZmeAg+aXw folded before Flop
Seat 5: tOAk1Og4mVObMBOfvdDYOw (button) collected ($1.85)
Seat 6: ZZm/rg8aThjE+A2LiItuzA (small blind) folded before Flop




PokerStars Game #59941595164:  Hold'em No Limit ($0.10/$0.25) - 2009/07/01 1:40:12 ET
Table 'nc6OeGk/wtaWV+6N+kgnZQ' 6-max Seat #3 is the button
Seat 1: tSR4329m40dZsN7YOpI9Kw ($39.15 in chips) 
Seat 2: 8ClCHtFXGNplITm+63KB+Q ($35.10 in chips) 
Seat 3: y8wpMWGSX2zHZijurx21mg ($6.30 in chips) 
Seat 4: 3zD3qLXT1bEffAoWGnc7wg ($30.05 in chips) 
Seat 5: HCS0lMAAPmZE2Tl8J/SuKw ($11.70 in chips) 
Seat 6: mFv3iBCtrw9XfCDRB0d46Q ($2.95 in chips) 
3zD3qLXT1bEffAoWGnc7wg: posts small blind $0.10
HCS0lMAAPmZE2Tl8J/SuKw: posts big blind $0.25
*** HOLE CARDS ***
mFv3iBCtrw9XfCDRB0d46Q: folds 
tSR4329m40dZsN7YOpI9Kw: folds 
8ClCHtFXGNplITm+63KB+Q: folds 
y8wpMWGSX2zHZijurx21mg: calls $0.25
3zD3qLXT1bEffAoWGnc7wg: folds 
HCS0lMAAPmZE2Tl8J/SuKw: checks 
*** FLOP *** [Ks Qh Tc]
HCS0lMAAPmZE2Tl8J/SuKw: checks 
y8wpMWGSX2zHZijurx21mg: bets $0.25
HCS0lMAAPmZE2Tl8J/SuKw: calls $0.25
*** TURN *** [Ks Qh Tc] [5h]
HCS0lMAAPmZE2Tl8J/SuKw: checks 
y8wpMWGSX2zHZijurx21mg: bets $0.25
HCS0lMAAPmZE2Tl8J/SuKw: folds 
Uncalled bet ($0.25) returned to y8wpMWGSX2zHZijurx21mg
y8wpMWGSX2zHZijurx21mg collected $1.05 from pot
y8wpMWGSX2zHZijurx21mg: doesn't show hand 
*** SUMMARY ***
Total pot $1.10 | Rake $0.05 
Board [Ks Qh Tc 5h]
Seat 1: tSR4329m40dZsN7YOpI9Kw folded before Flop (didn't bet)
Seat 2: 8ClCHtFXGNplITm+63KB+Q folded before Flop (didn't bet)
Seat 3: y8wpMWGSX2zHZijurx21mg (button) collected ($1.05)
Seat 4: 3zD3qLXT1bEffAoWGnc7wg (small blind) folded before Flop
Seat 5: HCS0lMAAPmZE2Tl8J/SuKw (big blind) folded on the Turn
Seat 6: mFv3iBCtrw9XfCDRB0d46Q folded before Flop (didn't bet)




PokerStars Game #59941594888:  Hold'em No Limit ($0.10/$0.25) - 2009/07/01 1:40:12 ET
Table '0M5QEJGOThqZwQ/sjbjXYw' 6-max Seat #4 is the button
Seat 1: 2G0C7dp4wlPpE21FHjjElQ ($25.60 in chips) 
Seat 2: /gJNBeCkWL4o85/jvlZ4BA ($36.70 in chips) 
Seat 3: 3zD3qLXT1bEffAoWGnc7wg ($25 in chips) 
Seat 4: oBUDUfeUyCbZBsjxHZgSiw ($25 in chips) 
Seat 5: cWc85bEzdRzpUMhRKm8pwQ ($28.15 in chips) 
Seat 6: mYz11CHiw5KsDCRD5T7/jg ($41.40 in chips) 
cWc85bEzdRzpUMhRKm8pwQ: posts small blind $0.10
mYz11CHiw5KsDCRD5T7/jg: posts big blind $0.25
*** HOLE CARDS ***
2G0C7dp4wlPpE21FHjjElQ: folds 
/gJNBeCkWL4o85/jvlZ4BA: folds 
3zD3qLXT1bEffAoWGnc7wg: raises $0.50 to $0.75
oBUDUfeUyCbZBsjxHZgSiw: folds 
cWc85bEzdRzpUMhRKm8pwQ: folds 
mYz11CHiw5KsDCRD5T7/jg: calls $0.50
*** FLOP *** [Qc Kd Jc]
mYz11CHiw5KsDCRD5T7/jg: checks 
3zD3qLXT1bEffAoWGnc7wg: checks 
*** TURN *** [Qc Kd Jc] [Qs]
mYz11CHiw5KsDCRD5T7/jg: checks 
3zD3qLXT1bEffAoWGnc7wg: checks 
*** RIVER *** [Qc Kd Jc Qs] [Ks]
mYz11CHiw5KsDCRD5T7/jg: checks 
3zD3qLXT1bEffAoWGnc7wg: checks 
*** SHOW DOWN ***
mYz11CHiw5KsDCRD5T7/jg: shows [7h 6d] (two pair, Kings and Queens)
3zD3qLXT1bEffAoWGnc7wg: shows [2s 2d] (two pair, Kings and Queens)
mYz11CHiw5KsDCRD5T7/jg collected $0.80 from pot
3zD3qLXT1bEffAoWGnc7wg collected $0.75 from pot
*** SUMMARY ***
Total pot $1.60 | Rake $0.05 
Board [Qc Kd Jc Qs Ks]
Seat 1: 2G0C7dp4wlPpE21FHjjElQ folded before Flop (didn't bet)
Seat 2: /gJNBeCkWL4o85/jvlZ4BA folded before Flop (didn't bet)
Seat 3: 3zD3qLXT1bEffAoWGnc7wg showed [2s 2d] and won ($0.75) with two pair, Kings and Queens
Seat 4: oBUDUfeUyCbZBsjxHZgSiw (button) folded before Flop (didn't bet)
Seat 5: cWc85bEzdRzpUMhRKm8pwQ (small blind) folded before Flop
Seat 6: mYz11CHiw5KsDCRD5T7/jg (big blind) showed [7h 6d] and won ($0.80) with two pair, Kings and Queens




PokerStars Game #59941594850:  Hold'em No Limit ($0.10/$0.25) - 2009/07/01 1:40:12 ET
Table 'BpNkESDX1ip9c0K1hb5h7A' 6-max Seat #6 is the button
Seat 2: g+5jEA4Xq9vcMOfdFYNuFA ($10.45 in chips) 
Seat 3: fZQg9veL7Dd/Z04ZTjC+wQ ($25.35 in chips) 
Seat 4: kG34n23qFQA3nzdOJTQ1dA ($25.55 in chips) 
Seat 5: L3/N/gliETan8N5Gim5h4Q ($25.50 in chips) 
Seat 6: 8EEqTTh7T1q48sYDqbI2Xg ($21.90 in chips) 
g+5jEA4Xq9vcMOfdFYNuFA: posts small blind $0.10
fZQg9veL7Dd/Z04ZTjC+wQ: posts big blind $0.25
*** HOLE CARDS ***
kG34n23qFQA3nzdOJTQ1dA: folds 
L3/N/gliETan8N5Gim5h4Q: folds 
8EEqTTh7T1q48sYDqbI2Xg: folds 
g+5jEA4Xq9vcMOfdFYNuFA: calls $0.15
fZQg9veL7Dd/Z04ZTjC+wQ: checks 
*** FLOP *** [Jc Ks Tc]
g+5jEA4Xq9vcMOfdFYNuFA: checks 
fZQg9veL7Dd/Z04ZTjC+wQ: checks 
*** TURN *** [Jc Ks Tc] [9c]
g+5jEA4Xq9vcMOfdFYNuFA: bets $0.75
fZQg9veL7Dd/Z04ZTjC+wQ: folds 
Uncalled bet ($0.75) returned to g+5jEA4Xq9vcMOfdFYNuFA
g+5jEA4Xq9vcMOfdFYNuFA collected $0.50 from pot
*** SUMMARY ***
Total pot $0.50 | Rake $0 
Board [Jc Ks Tc 9c]
Seat 2: g+5jEA4Xq9vcMOfdFYNuFA (small blind) collected ($0.50)
Seat 3: fZQg9veL7Dd/Z04ZTjC+wQ (big blind) folded on the Turn
Seat 4: kG34n23qFQA3nzdOJTQ1dA folded before Flop (didn't bet)
Seat 5: L3/N/gliETan8N5Gim5h4Q folded before Flop (didn't bet)
Seat 6: 8EEqTTh7T1q48sYDqbI2Xg (button) folded before Flop (didn't bet)




PokerStars Game #59941595108:  Hold'em No Limit ($0.10/$0.25) - 2009/07/01 1:40:12 ET
Table '8Z6T3ssCpo3VV849U4RgBw' 9-max Seat #6 is the button
Seat 1: 8dNQBtNvCvzVgSnmDgi/LA ($16.05 in chips) 
Seat 2: SpiiQQAzy4MUgV3I5W8giw ($25.35 in chips) 
Seat 3: tLcDklc2rBORNfixyRfVfw ($41.50 in chips) 
Seat 4: RCqMONFrSPSArZh2Jsar/w ($18.90 in chips) 
Seat 5: zDrucyjVn5aeekNEc3cJrA ($16 in chips) 
Seat 6: sGFnnRCa1YAHAUmWgsW6Qg ($9.15 in chips) 
Seat 7: oLa/tXLfSLLB28mcLGrxcg ($24.15 in chips) 
Seat 8: PdIasPkzm2sqZnN41ZRXOg ($5 in chips) 
Seat 9: HDDm1BkZtdsRyw2DJdqq6A ($21.70 in chips) 
oLa/tXLfSLLB28mcLGrxcg: posts small blind $0.10
PdIasPkzm2sqZnN41ZRXOg: posts big blind $0.25
*** HOLE CARDS ***
HDDm1BkZtdsRyw2DJdqq6A: calls $0.25
8dNQBtNvCvzVgSnmDgi/LA: folds 
SpiiQQAzy4MUgV3I5W8giw: folds 
tLcDklc2rBORNfixyRfVfw: folds 
RCqMONFrSPSArZh2Jsar/w: folds 
zDrucyjVn5aeekNEc3cJrA: folds 
sGFnnRCa1YAHAUmWgsW6Qg: folds 
oLa/tXLfSLLB28mcLGrxcg: folds 
PdIasPkzm2sqZnN41ZRXOg: checks 
*** FLOP *** [7s 6d 8s]
PdIasPkzm2sqZnN41ZRXOg: checks 
HDDm1BkZtdsRyw2DJdqq6A: checks 
*** TURN *** [7s 6d 8s] [6c]
PdIasPkzm2sqZnN41ZRXOg: checks 
HDDm1BkZtdsRyw2DJdqq6A: checks 
*** RIVER *** [7s 6d 8s 6c] [Qh]
PdIasPkzm2sqZnN41ZRXOg: checks 
HDDm1BkZtdsRyw2DJdqq6A: checks 
*** SHOW DOWN ***
PdIasPkzm2sqZnN41ZRXOg: shows [Tc 3h] (a pair of Sixes)
HDDm1BkZtdsRyw2DJdqq6A: mucks hand 
PdIasPkzm2sqZnN41ZRXOg collected $0.60 from pot
*** SUMMARY ***
Total pot $0.60 | Rake $0 
Board [7s 6d 8s 6c Qh]
Seat 1: 8dNQBtNvCvzVgSnmDgi/LA folded before Flop (didn't bet)
Seat 2: SpiiQQAzy4MUgV3I5W8giw folded before Flop (didn't bet)
Seat 3: tLcDklc2rBORNfixyRfVfw folded before Flop (didn't bet)
Seat 4: RCqMONFrSPSArZh2Jsar/w folded before Flop (didn't bet)
Seat 5: zDrucyjVn5aeekNEc3cJrA folded before Flop (didn't bet)
Seat 6: sGFnnRCa1YAHAUmWgsW6Qg (button) folded before Flop (didn't bet)
Seat 7: oLa/tXLfSLLB28mcLGrxcg (small blind) folded before Flop
Seat 8: PdIasPkzm2sqZnN41ZRXOg (big blind) showed [Tc 3h] and won ($0.60) with a pair of Sixes
Seat 9: HDDm1BkZtdsRyw2DJdqq6A mucked




PokerStars Game #59941595282:  Hold'em No Limit ($0.10/$0.25) - 2009/07/01 1:40:13 ET
Table '6wawJ+MkkvuC3coG6r+YhgZiwAqg4o02gNro+JOAaFNgSeat #4 is the button
Seat 1: 6RiVTYll/5D8zICp0MRpKw ($25.20 in chips) 
Seat 2: tYsOBqdU1+x+yFI7zHO7hQ ($31.40 in chips) 
Seat 3: aNpwfA31EREwO+ar4XzBCw ($29 in chips) 
Seat 4: j4q3p0lesp63b1gZDwLBZw ($5.65 in chips) 
Seat 5: 6HoFYfVGBefsR5Vrz62qIw5hAPbqNrvJb8PtLiceXtlg1.20 in chips) 
Seat 6: 5n7e7I+px7c6CQmLpPbtsg ($5 in chips) 
Seat 7: yyG4svzOpC1A+sUP/scg6w ($7.05 in chips) 
Seat 8: VLIsy+xjx3olLSYO3JLS6g ($18.35 in chips) 
Seat 9: ljemhp25Zg+nlA9DLCIiUw ($23.40 in chips) 
6HoFYfVGBefsR5Vrz62qIw5hAPbqNrvJb8PtLiceXtlgsts small blind $0.10
5n7e7I+px7c6CQmLpPbtsg: posts big blind $0.25
*** HOLE CARDS ***
yyG4svzOpC1A+sUP/scg6w: folds 
VLIsy+xjx3olLSYO3JLS6g: folds 
ljemhp25Zg+nlA9DLCIiUw: folds 
6RiVTYll/5D8zICp0MRpKw: folds 
tYsOBqdU1+x+yFI7zHO7hQ: folds 
aNpwfA31EREwO+ar4XzBCw: folds 
j4q3p0lesp63b1gZDwLBZw: folds 
6HoFYfVGBefsR5Vrz62qIw5hAPbqNrvJb8PtLiceXtlglds 
Uncalled bet ($0.15) returned to 5n7e7I+px7c6CQmLpPbtsg
5n7e7I+px7c6CQmLpPbtsg collected $0.20 from pot
5n7e7I+px7c6CQmLpPbtsg: doesn't show hand 
*** SUMMARY ***
Total pot $0.20 | Rake $0 
Seat 1: 6RiVTYll/5D8zICp0MRpKw folded before Flop (didn't bet)
Seat 2: tYsOBqdU1+x+yFI7zHO7hQ folded before Flop (didn't bet)
Seat 3: aNpwfA31EREwO+ar4XzBCw folded before Flop (didn't bet)
Seat 4: j4q3p0lesp63b1gZDwLBZw (button) folded before Flop (didn't bet)
Seat 5: 6HoFYfVGBefsR5Vrz62qIw5hAPbqNrvJb8PtLiceXtlgall blind) folded before Flop
Seat 6: 5n7e7I+px7c6CQmLpPbtsg (big blind) collected ($0.20)
Seat 7: yyG4svzOpC1A+sUP/scg6w folded before Flop (didn't bet)
Seat 8: VLIsy+xjx3olLSYO3JLS6g folded before Flop (didn't bet)
Seat 9: ljemhp25Zg+nlA9DLCIiUw folded before Flop (didn't bet)




PokerStars Game #59941595328:  Hold'em No Limit ($0.10/$0.25) - 2009/07/01 1:40:13 ET
Table 'r562aMIMs5kgo28FEU6lkA' 9-max Seat #9 is the button
Seat 1: H5Se03ZqSX7tbULXur2MAg ($17.65 in chips) 
Seat 2: N8muFAHrFHW6elSMGuyVLQ ($23.55 in chips) 
Seat 3: xoBFd/5k+L/pFn9VW1VyWg ($10.10 in chips) 
Seat 4: V6p0jQ/RhUsqpHLmXvEX4Q ($17.25 in chips) 
Seat 5: zDrucyjVn5aeekNEc3cJrA ($35.85 in chips) 
Seat 7: Bb42QRQMhg5/Y0vHP8/2Xw ($25 in chips) 
Seat 8: B6xHiX1SJkS0CUNCKDVwuQ ($21.70 in chips) 
Seat 9: yyG4svzOpC1A+sUP/scg6w ($7.50 in chips) 
H5Se03ZqSX7tbULXur2MAg: posts small blind $0.10
N8muFAHrFHW6elSMGuyVLQ: posts big blind $0.25
RCqMONFrSPSArZh2Jsar/w: sits out 
*** HOLE CARDS ***
xoBFd/5k+L/pFn9VW1VyWg: raises $0.75 to $1
V6p0jQ/RhUsqpHLmXvEX4Q: folds 
zDrucyjVn5aeekNEc3cJrA: folds 
Bb42QRQMhg5/Y0vHP8/2Xw: folds 
B6xHiX1SJkS0CUNCKDVwuQ: folds 
yyG4svzOpC1A+sUP/scg6w: folds 
H5Se03ZqSX7tbULXur2MAg: folds 
N8muFAHrFHW6elSMGuyVLQ: calls $0.75
*** FLOP *** [2s 6d 9d]
N8muFAHrFHW6elSMGuyVLQ: checks 
xoBFd/5k+L/pFn9VW1VyWg: bets $2.25
N8muFAHrFHW6elSMGuyVLQ: folds 
Uncalled bet ($2.25) returned to xoBFd/5k+L/pFn9VW1VyWg
xoBFd/5k+L/pFn9VW1VyWg collected $2 from pot
*** SUMMARY ***
Total pot $2.10 | Rake $0.10 
Board [2s 6d 9d]
Seat 1: H5Se03ZqSX7tbULXur2MAg (small blind) folded before Flop
Seat 2: N8muFAHrFHW6elSMGuyVLQ (big blind) folded on the Flop
Seat 3: xoBFd/5k+L/pFn9VW1VyWg collected ($2)
Seat 4: V6p0jQ/RhUsqpHLmXvEX4Q folded before Flop (didn't bet)
Seat 5: zDrucyjVn5aeekNEc3cJrA folded before Flop (didn't bet)
Seat 7: Bb42QRQMhg5/Y0vHP8/2Xw folded before Flop (didn't bet)
Seat 8: B6xHiX1SJkS0CUNCKDVwuQ folded before Flop (didn't bet)
Seat 9: yyG4svzOpC1A+sUP/scg6w (button) folded before Flop (didn't bet)




PokerStars Game #59941595664:  Hold'em No Limit ($0.10/$0.25) - 2009/07/01 1:40:13 ET
Table 'nyTW9cVtYentc5V7xU/0jA' 6-max Seat #3 is the button
Seat 1: HI20pVxSHPZ29u9IDkmICg ($10.15 in chips) 
Seat 3: kG34n23qFQA3nzdOJTQ1dA ($36.45 in chips) 
Seat 4: NkB3D4eVHHXvB9Edaugc1Q ($19.15 in chips) 
Seat 5: zZAcuQ0EvirdEuiIbeaocQ ($15.45 in chips) 
NkB3D4eVHHXvB9Edaugc1Q: posts small blind $0.10
zZAcuQ0EvirdEuiIbeaocQ: posts big blind $0.25
*** HOLE CARDS ***
HI20pVxSHPZ29u9IDkmICg: folds 
kG34n23qFQA3nzdOJTQ1dA: folds 
NkB3D4eVHHXvB9Edaugc1Q: calls $0.15
zZAcuQ0EvirdEuiIbeaocQ: checks 
*** FLOP *** [6s Kc Ac]
NkB3D4eVHHXvB9Edaugc1Q: checks 
v6mkGzCBCCXcgWQNSYVtKg joins the table at seat #2 
zZAcuQ0EvirdEuiIbeaocQ: bets $0.50
NkB3D4eVHHXvB9Edaugc1Q: raises $0.50 to $1
zZAcuQ0EvirdEuiIbeaocQ: folds 
Uncalled bet ($0.50) returned to NkB3D4eVHHXvB9Edaugc1Q
NkB3D4eVHHXvB9Edaugc1Q collected $1.45 from pot
NkB3D4eVHHXvB9Edaugc1Q: doesn't show hand 
*** SUMMARY ***
Total pot $1.50 | Rake $0.05 
Board [6s Kc Ac]
Seat 1: HI20pVxSHPZ29u9IDkmICg folded before Flop (didn't bet)
Seat 3: kG34n23qFQA3nzdOJTQ1dA (button) folded before Flop (didn't bet)
Seat 4: NkB3D4eVHHXvB9Edaugc1Q (small blind) collected ($1.45)
Seat 5: zZAcuQ0EvirdEuiIbeaocQ (big blind) folded on the Flop




PokerStars Game #59941595612:  Hold'em No Limit ($0.10/$0.25) - 2009/07/01 1:40:13 ET
Table 'g+mPuNJBCHKE9ents7ZGtg' 6-max Seat #6 is the button
Seat 1: cezpHJ8FB07dj0xG+LhOvw ($59.55 in chips) 
Seat 2: fZQg9veL7Dd/Z04ZTjC+wQ ($66.05 in chips) 
Seat 3: FYepjhAvF8ZdVCmqHIy+eQ ($25.60 in chips) 
Seat 4: yVrjRIW0SMxgpvqSIPSe/w ($13.95 in chips) 
Seat 5: D3ikCR8c/o9jB5irZ3uGlw ($14.15 in chips) 
Seat 6: Mn2V28t5aGq2d09z+/o6Fw ($5.95 in chips) 
cezpHJ8FB07dj0xG+LhOvw: posts small blind $0.10
fZQg9veL7Dd/Z04ZTjC+wQ: posts big blind $0.25
*** HOLE CARDS ***
FYepjhAvF8ZdVCmqHIy+eQ: folds 
yVrjRIW0SMxgpvqSIPSe/w: folds 
D3ikCR8c/o9jB5irZ3uGlw: folds 
Mn2V28t5aGq2d09z+/o6Fw: calls $0.25
cezpHJ8FB07dj0xG+LhOvw: folds 
fZQg9veL7Dd/Z04ZTjC+wQ: checks 
*** FLOP *** [Th Ad 8h]
fZQg9veL7Dd/Z04ZTjC+wQ: checks 
Mn2V28t5aGq2d09z+/o6Fw: bets $0.50
fZQg9veL7Dd/Z04ZTjC+wQ: folds 
Uncalled bet ($0.50) returned to Mn2V28t5aGq2d09z+/o6Fw
Mn2V28t5aGq2d09z+/o6Fw collected $0.60 from pot
Mn2V28t5aGq2d09z+/o6Fw: doesn't show hand 
*** SUMMARY ***
Total pot $0.60 | Rake $0 
Board [Th Ad 8h]
Seat 1: cezpHJ8FB07dj0xG+LhOvw (small blind) folded before Flop
Seat 2: fZQg9veL7Dd/Z04ZTjC+wQ (big blind) folded on the Flop
Seat 3: FYepjhAvF8ZdVCmqHIy+eQ folded before Flop (didn't bet)
Seat 4: yVrjRIW0SMxgpvqSIPSe/w folded before Flop (didn't bet)
Seat 5: D3ikCR8c/o9jB5irZ3uGlw folded before Flop (didn't bet)
Seat 6: Mn2V28t5aGq2d09z+/o6Fw (button) collected ($0.60)




PokerStars Game #59941595460:  Hold'em No Limit ($0.10/$0.25) - 2009/07/01 1:40:13 ET
Table 'vFZR6Kf2Th5xBXT9brGW6A' 6-max Seat #3 is the button
Seat 1: Q3EMN7b0ie81AFWkDrhCjw ($21.30 in chips) 
Seat 2: QiL+lEgEWwy21jk/ltaRLg ($23.40 in chips) 
Seat 3: SH1WjKVUjPiyXySjWSdazw ($23.05 in chips) 
Seat 4: 79ID/ub1Pt/mDpCprVmOoA ($35.65 in chips) 
Seat 5: SS/yfeArhULzIcOPe8MdPg ($26 in chips) 
Seat 6: 4x9jCqgSw4272dnaIqnanw ($4.10 in chips) 
79ID/ub1Pt/mDpCprVmOoA: posts small blind $0.10
SS/yfeArhULzIcOPe8MdPg: posts big blind $0.25
*** HOLE CARDS ***
4x9jCqgSw4272dnaIqnanw: folds 
Q3EMN7b0ie81AFWkDrhCjw: calls $0.25
QiL+lEgEWwy21jk/ltaRLg: folds 
SH1WjKVUjPiyXySjWSdazw: raises $0.50 to $0.75
79ID/ub1Pt/mDpCprVmOoA: folds 
SS/yfeArhULzIcOPe8MdPg: folds 
Q3EMN7b0ie81AFWkDrhCjw: calls $0.50
*** FLOP *** [6h 9d 3h]
Q3EMN7b0ie81AFWkDrhCjw: checks 
SH1WjKVUjPiyXySjWSdazw: bets $1
Q3EMN7b0ie81AFWkDrhCjw: folds 
Uncalled bet ($1) returned to SH1WjKVUjPiyXySjWSdazw
SH1WjKVUjPiyXySjWSdazw collected $1.80 from pot
SH1WjKVUjPiyXySjWSdazw: doesn't show hand 
*** SUMMARY ***
Total pot $1.85 | Rake $0.05 
Board [6h 9d 3h]
Seat 1: Q3EMN7b0ie81AFWkDrhCjw folded on the Flop
Seat 2: QiL+lEgEWwy21jk/ltaRLg folded before Flop (didn't bet)
Seat 3: SH1WjKVUjPiyXySjWSdazw (button) collected ($1.80)
Seat 4: 79ID/ub1Pt/mDpCprVmOoA (small blind) folded before Flop
Seat 5: SS/yfeArhULzIcOPe8MdPg (big blind) folded before Flop
Seat 6: 4x9jCqgSw4272dnaIqnanw folded before Flop (didn't bet)




PokerStars Game #59941595644:  Hold'em No Limit ($0.10/$0.25) - 2009/07/01 1:40:13 ET
Table 'rO1I30HnuCPB0M8qEX1TCQ' 9-max Seat #2 is the button
Seat 1: dfsOFy2nKDeSF9SjtdIyVA ($12.50 in chips) 
Seat 2: z1hPotrGOZjUjyoopZ7Ulg ($18.70 in chips) 
Seat 3: 2wcFsZsqEP5w1StUTVzJCg ($13.40 in chips) 
Seat 4: yyG4svzOpC1A+sUP/scg6w ($12 in chips) 
Seat 5: W6tExOcYX7qiy6Qdp+ZwFA ($5.45 in chips) 
Seat 8: 6mStmDUknIn/RyBEoiIyoQ ($3.20 in chips) 
Seat 9: AiXn/9o1EwOPZUHujnh/bA ($21.90 in chips) 
2wcFsZsqEP5w1StUTVzJCg: posts small blind $0.10
yyG4svzOpC1A+sUP/scg6w: posts big blind $0.25
5n7e7I+px7c6CQmLpPbtsg: sits out 
bXpVeaSTPBFSPJmeXxO7nw: sits out 
*** HOLE CARDS ***
W6tExOcYX7qiy6Qdp+ZwFA: folds 
6mStmDUknIn/RyBEoiIyoQ: folds 
AiXn/9o1EwOPZUHujnh/bA: folds 
dfsOFy2nKDeSF9SjtdIyVA: folds 
z1hPotrGOZjUjyoopZ7Ulg: calls $0.25
2wcFsZsqEP5w1StUTVzJCg: calls $0.15
yyG4svzOpC1A+sUP/scg6w: checks 
*** FLOP *** [5c 7h 3c]
2wcFsZsqEP5w1StUTVzJCg: checks 
yyG4svzOpC1A+sUP/scg6w: checks 
z1hPotrGOZjUjyoopZ7Ulg: bets $0.50
2wcFsZsqEP5w1StUTVzJCg: folds 
yyG4svzOpC1A+sUP/scg6w: calls $0.50
*** TURN *** [5c 7h 3c] [7s]
yyG4svzOpC1A+sUP/scg6w: checks 
AiXn/9o1EwOPZUHujnh/bA is disconnected 
z1hPotrGOZjUjyoopZ7Ulg: bets $0.75
yyG4svzOpC1A+sUP/scg6w: calls $0.75
*** RIVER *** [5c 7h 3c 7s] [2h]
AiXn/9o1EwOPZUHujnh/bA is connected 
yyG4svzOpC1A+sUP/scg6w: checks 
z1hPotrGOZjUjyoopZ7Ulg: bets $1
yyG4svzOpC1A+sUP/scg6w: folds 
Uncalled bet ($1) returned to z1hPotrGOZjUjyoopZ7Ulg
z1hPotrGOZjUjyoopZ7Ulg collected $3.10 from pot
*** SUMMARY ***
Total pot $3.25 | Rake $0.15 
Board [5c 7h 3c 7s 2h]
Seat 1: dfsOFy2nKDeSF9SjtdIyVA folded before Flop (didn't bet)
Seat 2: z1hPotrGOZjUjyoopZ7Ulg (button) collected ($3.10)
Seat 3: 2wcFsZsqEP5w1StUTVzJCg (small blind) folded on the Flop
Seat 4: yyG4svzOpC1A+sUP/scg6w (big blind) folded on the River
Seat 5: W6tExOcYX7qiy6Qdp+ZwFA folded before Flop (didn't bet)
Seat 8: 6mStmDUknIn/RyBEoiIyoQ folded before Flop (didn't bet)
Seat 9: AiXn/9o1EwOPZUHujnh/bA folded before Flop (didn't bet)




PokerStars Game #59941596156:  Hold'em No Limit ($0.10/$0.25) - 2009/07/01 1:40:14 ET
Table 'QegsWX65l3n/K0A8XB78yg' 6-max Seat #5 is the button
Seat 1: p6adJRMXMBLr+xtQzqazIQ ($12 in chips) 
Seat 2: GC/9yVD59DUCX7hUI7gcLw ($48.15 in chips) 
Seat 3: 1lxYIAoJdZwAbzIkzWmSkw ($2.75 in chips) 
Seat 4: mFv3iBCtrw9XfCDRB0d46Q ($8.55 in chips) 
Seat 5: OMGl+YMGogf2JWIRfT2/Yg ($12.65 in chips) 
Seat 6: 5PWs02z65jSO5pr/M6wx/w ($4.60 in chips) 
5PWs02z65jSO5pr/M6wx/w: posts small blind $0.10
p6adJRMXMBLr+xtQzqazIQ: posts big blind $0.25
*** HOLE CARDS ***
GC/9yVD59DUCX7hUI7gcLw: folds 
1lxYIAoJdZwAbzIkzWmSkw: folds 
mFv3iBCtrw9XfCDRB0d46Q: folds 
OMGl+YMGogf2JWIRfT2/Yg: folds 
5PWs02z65jSO5pr/M6wx/w: calls $0.15
p6adJRMXMBLr+xtQzqazIQ: checks 
*** FLOP *** [7h 5h 3s]
5PWs02z65jSO5pr/M6wx/w: bets $0.25
p6adJRMXMBLr+xtQzqazIQ: folds 
Uncalled bet ($0.25) returned to 5PWs02z65jSO5pr/M6wx/w
5PWs02z65jSO5pr/M6wx/w collected $0.50 from pot
*** SUMMARY ***
Total pot $0.50 | Rake $0 
Board [7h 5h 3s]
Seat 1: p6adJRMXMBLr+xtQzqazIQ (big blind) folded on the Flop
Seat 2: GC/9yVD59DUCX7hUI7gcLw folded before Flop (didn't bet)
Seat 3: 1lxYIAoJdZwAbzIkzWmSkw folded before Flop (didn't bet)
Seat 4: mFv3iBCtrw9XfCDRB0d46Q folded before Flop (didn't bet)
Seat 5: OMGl+YMGogf2JWIRfT2/Yg (button) folded before Flop (didn't bet)
Seat 6: 5PWs02z65jSO5pr/M6wx/w (small blind) collected ($0.50)




PokerStars Game #59941596126:  Hold'em No Limit ($0.10/$0.25) - 2009/07/01 1:40:14 ET
Table '+198VWQSWBhYQOcizzuBkw' 6-max Seat #6 is the button
Seat 3: vw7gefupgmOJJN8lUemdWg ($24.15 in chips) 
Seat 4: TgDsTeCdLQt8kWbL00ByRA ($16.60 in chips) 
Seat 5: LtASJ9OlkqGrrUKGQlpGAw ($26.95 in chips) 
Seat 6: leEQ84f6wJYu5SB/vj27wg ($11.55 in chips) 
vw7gefupgmOJJN8lUemdWg: posts small blind $0.10
TgDsTeCdLQt8kWbL00ByRA: posts big blind $0.25
*** HOLE CARDS ***
mFv3iBCtrw9XfCDRB0d46Q leaves the table
LtASJ9OlkqGrrUKGQlpGAw: folds 
leEQ84f6wJYu5SB/vj27wg: folds 
vw7gefupgmOJJN8lUemdWg: calls $0.15
TgDsTeCdLQt8kWbL00ByRA: checks 
*** FLOP *** [3d 2s Tc]
vw7gefupgmOJJN8lUemdWg: checks 
TgDsTeCdLQt8kWbL00ByRA: checks 
*** TURN *** [3d 2s Tc] [Kd]
vw7gefupgmOJJN8lUemdWg: bets $0.25
TgDsTeCdLQt8kWbL00ByRA: folds 
Uncalled bet ($0.25) returned to vw7gefupgmOJJN8lUemdWg
34ttqW62uIRrqINCCmLcsw joins the table at seat #1 
vw7gefupgmOJJN8lUemdWg collected $0.50 from pot
vw7gefupgmOJJN8lUemdWg: shows [Ks 4s] (a pair of Kings)
*** SUMMARY ***
Total pot $0.50 | Rake $0 
Board [3d 2s Tc Kd]
Seat 3: vw7gefupgmOJJN8lUemdWg (small blind) collected ($0.50)
Seat 4: TgDsTeCdLQt8kWbL00ByRA (big blind) folded on the Turn
Seat 5: LtASJ9OlkqGrrUKGQlpGAw folded before Flop (didn't bet)
Seat 6: leEQ84f6wJYu5SB/vj27wg (button) folded before Flop (didn't bet)




PokerStars Game #59941595852:  Hold'em No Limit ($0.10/$0.25) - 2009/07/01 1:40:14 ET
Table 'MRfAiS/4JSfnUDlCcZo0wAhfHe8uKeSJMyWAjSdM7ROQx Seat #6 is the button
Seat 1: 48oT5xFI+5CHUJlfoGrE4w ($31.35 in chips) 
Seat 2: /gJNBeCkWL4o85/jvlZ4BA ($30.70 in chips) 
Seat 3: FYepjhAvF8ZdVCmqHIy+eQ ($39.05 in chips) 
Seat 4: b4wRQV3APH8irVk6bUFe2Q ($26.90 in chips) 
Seat 6: L3/N/gliETan8N5Gim5h4Q ($25.35 in chips) 
48oT5xFI+5CHUJlfoGrE4w: posts small blind $0.10
/gJNBeCkWL4o85/jvlZ4BA: posts big blind $0.25
b4wRQV3APH8irVk6bUFe2Q: posts small & big blinds $0.35
*** HOLE CARDS ***
FYepjhAvF8ZdVCmqHIy+eQ: folds 
b4wRQV3APH8irVk6bUFe2Q: raises $0.50 to $0.75
L3/N/gliETan8N5Gim5h4Q: folds 
48oT5xFI+5CHUJlfoGrE4w: folds 
/gJNBeCkWL4o85/jvlZ4BA: calls $0.50
*** FLOP *** [3d 6h Jd]
/gJNBeCkWL4o85/jvlZ4BA: checks 
b4wRQV3APH8irVk6bUFe2Q: bets $0.50
/gJNBeCkWL4o85/jvlZ4BA: calls $0.50
*** TURN *** [3d 6h Jd] [Jc]
/gJNBeCkWL4o85/jvlZ4BA: checks 
b4wRQV3APH8irVk6bUFe2Q: bets $2
/gJNBeCkWL4o85/jvlZ4BA: folds 
Uncalled bet ($2) returned to b4wRQV3APH8irVk6bUFe2Q
b4wRQV3APH8irVk6bUFe2Q collected $2.60 from pot
*** SUMMARY ***
Total pot $2.70 | Rake $0.10 
Board [3d 6h Jd Jc]
Seat 1: 48oT5xFI+5CHUJlfoGrE4w (small blind) folded before Flop
Seat 2: /gJNBeCkWL4o85/jvlZ4BA (big blind) folded on the Turn
Seat 3: FYepjhAvF8ZdVCmqHIy+eQ folded before Flop (didn't bet)
Seat 4: b4wRQV3APH8irVk6bUFe2Q collected ($2.60)
Seat 6: L3/N/gliETan8N5Gim5h4Q (button) folded before Flop (didn't bet)




PokerStars Game #59941596248:  Hold'em No Limit ($0.10/$0.25) - 2009/07/01 1:40:14 ET
Table 'z2yOdY2zyGWG1gh9WV9XtQdYNvO8G5kw5SRxb1Dljhog Seat #6 is the button
Seat 1: vSkQm2EelzwRGDDQQk0Fqw ($4.90 in chips) 
Seat 2: PkBmevN3LdXkPj1LHOoTnQ ($14.05 in chips) 
Seat 3: 1Cs1GyQcoM1omwY7XZ3uRg ($13.50 in chips) 
Seat 4: sD+TKtt36XiiN6jqHiLwDA ($24.65 in chips) 
Seat 5: W7XGvw6ngGVq2hFwXk8Myg ($25.85 in chips) 
Seat 6: 22dIObOuor/A+IKWkNoAlA ($7.20 in chips) 
Seat 7: DiSvPC2iudwL5j9u6Huyww ($43.25 in chips) 
Seat 8: 6HoFYfVGBefsR5Vrz62qIw5hAPbqNrvJb8PtLiceXtlg0.35 in chips) 
Seat 9: PdIasPkzm2sqZnN41ZRXOg ($5 in chips) 
DiSvPC2iudwL5j9u6Huyww: posts small blind $0.10
6HoFYfVGBefsR5Vrz62qIw5hAPbqNrvJb8PtLiceXtlgsts big blind $0.25
*** HOLE CARDS ***
PdIasPkzm2sqZnN41ZRXOg: folds 
vSkQm2EelzwRGDDQQk0Fqw: folds 
PkBmevN3LdXkPj1LHOoTnQ: folds 
1Cs1GyQcoM1omwY7XZ3uRg: calls $0.25
sD+TKtt36XiiN6jqHiLwDA: calls $0.25
W7XGvw6ngGVq2hFwXk8Myg: folds 
22dIObOuor/A+IKWkNoAlA: folds 
DiSvPC2iudwL5j9u6Huyww: calls $0.15
6HoFYfVGBefsR5Vrz62qIw5hAPbqNrvJb8PtLiceXtlgecks 
*** FLOP *** [2h Jh 4d]
DiSvPC2iudwL5j9u6Huyww: checks 
6HoFYfVGBefsR5Vrz62qIw5hAPbqNrvJb8PtLiceXtlgecks 
1Cs1GyQcoM1omwY7XZ3uRg: checks 
sD+TKtt36XiiN6jqHiLwDA: checks 
*** TURN *** [2h Jh 4d] [Kd]
DiSvPC2iudwL5j9u6Huyww: bets $0.75
6HoFYfVGBefsR5Vrz62qIw5hAPbqNrvJb8PtLiceXtlglds 
1Cs1GyQcoM1omwY7XZ3uRg has timed out
1Cs1GyQcoM1omwY7XZ3uRg: folds 
1Cs1GyQcoM1omwY7XZ3uRg is sitting out
1Cs1GyQcoM1omwY7XZ3uRg has returned
sD+TKtt36XiiN6jqHiLwDA: raises $2.25 to $3
DiSvPC2iudwL5j9u6Huyww: calls $2.25
*** RIVER *** [2h Jh 4d Kd] [Jc]
DiSvPC2iudwL5j9u6Huyww: checks 
sD+TKtt36XiiN6jqHiLwDA: bets $4
DiSvPC2iudwL5j9u6Huyww: folds 
Uncalled bet ($4) returned to sD+TKtt36XiiN6jqHiLwDA
sD+TKtt36XiiN6jqHiLwDA collected $6.70 from pot
sD+TKtt36XiiN6jqHiLwDA: doesn't show hand 
*** SUMMARY ***
Total pot $7 | Rake $0.30 
Board [2h Jh 4d Kd Jc]
Seat 1: vSkQm2EelzwRGDDQQk0Fqw folded before Flop (didn't bet)
Seat 2: PkBmevN3LdXkPj1LHOoTnQ folded before Flop (didn't bet)
Seat 3: 1Cs1GyQcoM1omwY7XZ3uRg folded on the Turn
Seat 4: sD+TKtt36XiiN6jqHiLwDA collected ($6.70)
Seat 5: W7XGvw6ngGVq2hFwXk8Myg folded before Flop (didn't bet)
Seat 6: 22dIObOuor/A+IKWkNoAlA (button) folded before Flop (didn't bet)
Seat 7: DiSvPC2iudwL5j9u6Huyww (small blind) folded on the River
Seat 8: 6HoFYfVGBefsR5Vrz62qIw5hAPbqNrvJb8PtLiceXtlgg blind) folded on the Turn
Seat 9: PdIasPkzm2sqZnN41ZRXOg folded before Flop (didn't bet)




PokerStars Game #59941596392:  Hold'em No Limit ($0.10/$0.25) - 2009/07/01 1:40:15 ET
Table '3760QYRYyCWeXf0rLZ5S2g' 9-max Seat #9 is the button
Seat 1: CT7Xj/V/O5rBlhtt+RZeFQ ($28.15 in chips) 
Seat 2: zDrucyjVn5aeekNEc3cJrA ($27.80 in chips) 
Seat 3: X78b5v/uhqeXXoAijbw/yg ($25.35 in chips) 
Seat 5: Bb42QRQMhg5/Y0vHP8/2Xw ($28.70 in chips) 
Seat 6: q+Qdg0Hoir+SyL7haBrUnw ($13.40 in chips) 
Seat 7: 6C2DoQ+GZHBOpb+qyrSnqA ($6 in chips) 
Seat 8: pB8IyCfDFZaVpov3NHEVJg ($24.30 in chips) 
Seat 9: sGFnnRCa1YAHAUmWgsW6Qg ($5.25 in chips) 
CT7Xj/V/O5rBlhtt+RZeFQ: posts small blind $0.10
zDrucyjVn5aeekNEc3cJrA: posts big blind $0.25
ziFpkH3wCzqB/qXeq/Hy7g: sits out 
*** HOLE CARDS ***
X78b5v/uhqeXXoAijbw/yg: folds 
Bb42QRQMhg5/Y0vHP8/2Xw: folds 
q+Qdg0Hoir+SyL7haBrUnw: folds 
6C2DoQ+GZHBOpb+qyrSnqA: calls $0.25
pB8IyCfDFZaVpov3NHEVJg: folds 
sGFnnRCa1YAHAUmWgsW6Qg: calls $0.25
CT7Xj/V/O5rBlhtt+RZeFQ: calls $0.15
zDrucyjVn5aeekNEc3cJrA: checks 
*** FLOP *** [8c 5d 9h]
CT7Xj/V/O5rBlhtt+RZeFQ: checks 
zDrucyjVn5aeekNEc3cJrA: checks 
6C2DoQ+GZHBOpb+qyrSnqA: checks 
sGFnnRCa1YAHAUmWgsW6Qg: bets $0.50
CT7Xj/V/O5rBlhtt+RZeFQ: folds 
zDrucyjVn5aeekNEc3cJrA: folds 
zDrucyjVn5aeekNEc3cJrA is sitting out
6C2DoQ+GZHBOpb+qyrSnqA: folds 
Uncalled bet ($0.50) returned to sGFnnRCa1YAHAUmWgsW6Qg
sGFnnRCa1YAHAUmWgsW6Qg collected $0.95 from pot
*** SUMMARY ***
Total pot $1 | Rake $0.05 
Board [8c 5d 9h]
Seat 1: CT7Xj/V/O5rBlhtt+RZeFQ (small blind) folded on the Flop
Seat 2: zDrucyjVn5aeekNEc3cJrA (big blind) folded on the Flop
Seat 3: X78b5v/uhqeXXoAijbw/yg folded before Flop (didn't bet)
Seat 5: Bb42QRQMhg5/Y0vHP8/2Xw folded before Flop (didn't bet)
Seat 6: q+Qdg0Hoir+SyL7haBrUnw folded before Flop (didn't bet)
Seat 7: 6C2DoQ+GZHBOpb+qyrSnqA folded on the Flop
Seat 8: pB8IyCfDFZaVpov3NHEVJg folded before Flop (didn't bet)
Seat 9: sGFnnRCa1YAHAUmWgsW6Qg (button) collected ($0.95)




PokerStars Game #59941596366:  Hold'em No Limit ($0.10/$0.25) - 2009/07/01 1:40:15 ET
Table 'wPWRBZPJl1HAnysw7qRR0A' 6-max Seat #5 is the button
Seat 1: m7ne1MOFTQXlsXT7/R/rug ($9.15 in chips) 
Seat 2: uUXdcVMNa05rfbntdvplfw ($15.50 in chips) 
Seat 3: 1ZpoLWO2nm2w1Nd1v9Sr3g ($6.65 in chips) 
Seat 5: y0B+UpYpOUJz3JWtlJQBSA ($21.45 in chips) 
Seat 6: Hsvkc0/G2VV78oVmWYXecw ($5 in chips) 
Hsvkc0/G2VV78oVmWYXecw: posts small blind $0.10
m7ne1MOFTQXlsXT7/R/rug: posts big blind $0.25
epAUIB7h2FJXzUPRIvSkRA: sits out 
*** HOLE CARDS ***
m7ne1MOFTQXlsXT7/R/rug said, "69"
uUXdcVMNa05rfbntdvplfw: calls $0.25
1ZpoLWO2nm2w1Nd1v9Sr3g: folds 
y0B+UpYpOUJz3JWtlJQBSA: folds 
Hsvkc0/G2VV78oVmWYXecw: folds 
m7ne1MOFTQXlsXT7/R/rug: checks 
*** FLOP *** [6d Qs Th]
m7ne1MOFTQXlsXT7/R/rug: checks 
uUXdcVMNa05rfbntdvplfw: bets $0.25
m7ne1MOFTQXlsXT7/R/rug: folds 
Uncalled bet ($0.25) returned to uUXdcVMNa05rfbntdvplfw
uUXdcVMNa05rfbntdvplfw collected $0.60 from pot
uUXdcVMNa05rfbntdvplfw leaves the table
*** SUMMARY ***
Total pot $0.60 | Rake $0 
Board [6d Qs Th]
Seat 1: m7ne1MOFTQXlsXT7/R/rug (big blind) folded on the Flop
Seat 2: uUXdcVMNa05rfbntdvplfw collected ($0.60)
Seat 3: 1ZpoLWO2nm2w1Nd1v9Sr3g folded before Flop (didn't bet)
Seat 5: y0B+UpYpOUJz3JWtlJQBSA (button) folded before Flop (didn't bet)
Seat 6: Hsvkc0/G2VV78oVmWYXecw (small blind) folded before Flop




PokerStars Game #59941596536:  Hold'em No Limit ($0.10/$0.25) - 2009/07/01 1:40:15 ET
Table 'NtEQAxCeIK2io1CGtW658g' 6-max Seat #4 is the button
Seat 1: X437kMQ7AujoaDgjguhU9w ($11.80 in chips) 
Seat 3: m2yWOKfAxqHoy5DDN87Ttw ($37.65 in chips) 
Seat 4: 8296 ($12.15 in chips) 
Seat 5: Hsvkc0/G2VV78oVmWYXecw ($5 in chips) 
Seat 6: /gJNBeCkWL4o85/jvlZ4BA ($64.50 in chips) 
Hsvkc0/G2VV78oVmWYXecw: posts small blind $0.10
/gJNBeCkWL4o85/jvlZ4BA: posts big blind $0.25
*** HOLE CARDS ***
X437kMQ7AujoaDgjguhU9w: folds 
m2yWOKfAxqHoy5DDN87Ttw: folds 
8296: folds 
Hsvkc0/G2VV78oVmWYXecw: folds 
Uncalled bet ($0.15) returned to /gJNBeCkWL4o85/jvlZ4BA
/gJNBeCkWL4o85/jvlZ4BA collected $0.20 from pot
*** SUMMARY ***
Total pot $0.20 | Rake $0 
Seat 1: X437kMQ7AujoaDgjguhU9w folded before Flop (didn't bet)
Seat 3: m2yWOKfAxqHoy5DDN87Ttw folded before Flop (didn't bet)
Seat 4: 8296 (button) folded before Flop (didn't bet)
Seat 5: Hsvkc0/G2VV78oVmWYXecw (small blind) folded before Flop
Seat 6: /gJNBeCkWL4o85/jvlZ4BA (big blind) collected ($0.20)




PokerStars Game #59941596774:  Hold'em No Limit ($0.10/$0.25) - 2009/07/01 1:40:15 ET
Table '4mnXP0EWt9mMZYzTIVDQ0w' 9-max Seat #6 is the button
Seat 1: Z5y2J55JmfLYR6/DPAGHwQ ($24 in chips) 
Seat 2: BLEU2x2bnGRovIelAY6slA ($24.55 in chips) 
Seat 4: 9lvO/qyU+xrU95Teu1fv0g ($7 in chips) 
Seat 5: sSN8Y0AlsBeidZXPKmwXSw ($25.95 in chips) 
Seat 6: 5yjzPss7Y4kAWNDat3e0yQ ($29.10 in chips) 
Seat 7: OiV1PWZ3IkN29JlmCcnTwQ ($5.95 in chips) 
Seat 8: 9YN2IkT2JYYKFErZtZvCtA ($21.85 in chips) 
OiV1PWZ3IkN29JlmCcnTwQ: posts small blind $0.10
9YN2IkT2JYYKFErZtZvCtA: posts big blind $0.25
*** HOLE CARDS ***
Z5y2J55JmfLYR6/DPAGHwQ: folds 
BLEU2x2bnGRovIelAY6slA: calls $0.25
9lvO/qyU+xrU95Teu1fv0g: folds 
N/O9ADKpmqB2ASZuqgodlw joins the table at seat #9 
sSN8Y0AlsBeidZXPKmwXSw: folds 
5yjzPss7Y4kAWNDat3e0yQ: folds 
OiV1PWZ3IkN29JlmCcnTwQ: folds 
9YN2IkT2JYYKFErZtZvCtA: checks 
*** FLOP *** [3s 4c Jc]
9YN2IkT2JYYKFErZtZvCtA: bets $0.50
BLEU2x2bnGRovIelAY6slA: calls $0.50
*** TURN *** [3s 4c Jc] [Tc]
9YN2IkT2JYYKFErZtZvCtA: bets $1
BLEU2x2bnGRovIelAY6slA: calls $1
*** RIVER *** [3s 4c Jc Tc] [Ts]
9YN2IkT2JYYKFErZtZvCtA: checks 
BLEU2x2bnGRovIelAY6slA: bets $1
9YN2IkT2JYYKFErZtZvCtA: folds 
Uncalled bet ($1) returned to BLEU2x2bnGRovIelAY6slA
BLEU2x2bnGRovIelAY6slA collected $3.45 from pot
*** SUMMARY ***
Total pot $3.60 | Rake $0.15 
Board [3s 4c Jc Tc Ts]
Seat 1: Z5y2J55JmfLYR6/DPAGHwQ folded before Flop (didn't bet)
Seat 2: BLEU2x2bnGRovIelAY6slA collected ($3.45)
Seat 4: 9lvO/qyU+xrU95Teu1fv0g folded before Flop (didn't bet)
Seat 5: sSN8Y0AlsBeidZXPKmwXSw folded before Flop (didn't bet)
Seat 6: 5yjzPss7Y4kAWNDat3e0yQ (button) folded before Flop (didn't bet)
Seat 7: OiV1PWZ3IkN29JlmCcnTwQ (small blind) folded before Flop
Seat 8: 9YN2IkT2JYYKFErZtZvCtA (big blind) folded on the River




PokerStars Game #59941596682:  Hold'em No Limit ($0.10/$0.25) - 2009/07/01 1:40:15 ET
Table 'zhqgUUprOJ14VxKxPHcT/Q' 9-max Seat #7 is the button
Seat 1: 22dIObOuor/A+IKWkNoAlA ($5 in chips) 
Seat 2: GY095KWhBevJ1Ttvl8WseA ($8.10 in chips) 
Seat 4: wGigCmBR/9XWkPpvYos3aQ ($33.45 in chips) 
Seat 5: +sbyWwIcFp9kP0bDtMegfQ ($33.60 in chips) 
Seat 7: sGFnnRCa1YAHAUmWgsW6Qg ($11 in chips) 
Seat 8: EQXHDnIzAsORnIXRNtXRlA ($24.45 in chips) 
Seat 9: 4awUyiDYTgylQKXZ9faBVA ($32.95 in chips) 
EQXHDnIzAsORnIXRNtXRlA: posts small blind $0.10
4awUyiDYTgylQKXZ9faBVA: posts big blind $0.25
PdIasPkzm2sqZnN41ZRXOg: sits out 
*** HOLE CARDS ***
4XHsdGnQ76EBdBvsrSs8bA joins the table at seat #3 
22dIObOuor/A+IKWkNoAlA: folds 
GY095KWhBevJ1Ttvl8WseA: folds 
wGigCmBR/9XWkPpvYos3aQ: folds 
+sbyWwIcFp9kP0bDtMegfQ: folds 
sGFnnRCa1YAHAUmWgsW6Qg: folds 
EQXHDnIzAsORnIXRNtXRlA: folds 
Uncalled bet ($0.15) returned to 4awUyiDYTgylQKXZ9faBVA
4awUyiDYTgylQKXZ9faBVA collected $0.20 from pot
4awUyiDYTgylQKXZ9faBVA: doesn't show hand 
*** SUMMARY ***
Total pot $0.20 | Rake $0 
Seat 1: 22dIObOuor/A+IKWkNoAlA folded before Flop (didn't bet)
Seat 2: GY095KWhBevJ1Ttvl8WseA folded before Flop (didn't bet)
Seat 4: wGigCmBR/9XWkPpvYos3aQ folded before Flop (didn't bet)
Seat 5: +sbyWwIcFp9kP0bDtMegfQ folded before Flop (didn't bet)
Seat 7: sGFnnRCa1YAHAUmWgsW6Qg (button) folded before Flop (didn't bet)
Seat 8: EQXHDnIzAsORnIXRNtXRlA (small blind) folded before Flop
Seat 9: 4awUyiDYTgylQKXZ9faBVA (big blind) collected ($0.20)




PokerStars Game #59941596360:  Hold'em No Limit ($0.10/$0.25) - 2009/07/01 1:40:15 ET
Table 'm+FQg/QP0VP1ZA3V62WtOg' 9-max Seat #7 is the button
Seat 4: qB12xUq3ftb2y8oTnNQzsg ($3.35 in chips) 
Seat 7: TPAF9YkMsjQFq978RNWZEQ ($14.55 in chips) 
Seat 9: zUXhymECc2C9W9ZNw6qppA ($10.65 in chips) 
zUXhymECc2C9W9ZNw6qppA: posts small blind $0.10
qB12xUq3ftb2y8oTnNQzsg: posts big blind $0.25
*** HOLE CARDS ***
mWm7RBYWw02boCWy2a7aDQ leaves the table
TPAF9YkMsjQFq978RNWZEQ: raises $0.25 to $0.50
zUXhymECc2C9W9ZNw6qppA: folds 
qB12xUq3ftb2y8oTnNQzsg: folds 
Uncalled bet ($0.25) returned to TPAF9YkMsjQFq978RNWZEQ
TPAF9YkMsjQFq978RNWZEQ collected $0.60 from pot
*** SUMMARY ***
Total pot $0.60 | Rake $0 
Seat 4: qB12xUq3ftb2y8oTnNQzsg (big blind) folded before Flop
Seat 7: TPAF9YkMsjQFq978RNWZEQ (button) collected ($0.60)
Seat 9: zUXhymECc2C9W9ZNw6qppA (small blind) folded before Flop




PokerStars Game #59941596960:  Hold'em No Limit ($0.10/$0.25) - 2009/07/01 1:40:16 ET
Table 'NtCSSONEf1zaJo3042tQug' 6-max Seat #6 is the button
Seat 1: KXtdqb+rIMkjc0RvHDksGQ ($35.55 in chips) 
Seat 2: vqWjZmdQu/Hxw96/IJTWdQ ($26.70 in chips) 
Seat 3: 9kUKGKkblnIx3m8rlVol6Q ($14.15 in chips) 
Seat 4: HxD1kB8zCmalQSdWAkKmlg ($29.20 in chips) 
Seat 5: tOAk1Og4mVObMBOfvdDYOw ($28.15 in chips) 
Seat 6: LxehwDpTQ19ph4Qmc78+Pw ($33 in chips) 
KXtdqb+rIMkjc0RvHDksGQ: posts small blind $0.10
vqWjZmdQu/Hxw96/IJTWdQ: posts big blind $0.25
*** HOLE CARDS ***
9kUKGKkblnIx3m8rlVol6Q: calls $0.25
HxD1kB8zCmalQSdWAkKmlg: folds 
tOAk1Og4mVObMBOfvdDYOw: folds 
LxehwDpTQ19ph4Qmc78+Pw: folds 
KXtdqb+rIMkjc0RvHDksGQ: folds 
vqWjZmdQu/Hxw96/IJTWdQ: checks 
*** FLOP *** [4d 6d Jd]
vqWjZmdQu/Hxw96/IJTWdQ: checks 
9kUKGKkblnIx3m8rlVol6Q: checks 
*** TURN *** [4d 6d Jd] [5c]
vqWjZmdQu/Hxw96/IJTWdQ: checks 
9kUKGKkblnIx3m8rlVol6Q: bets $0.50
vqWjZmdQu/Hxw96/IJTWdQ: folds 
Uncalled bet ($0.50) returned to 9kUKGKkblnIx3m8rlVol6Q
9kUKGKkblnIx3m8rlVol6Q collected $0.60 from pot
9kUKGKkblnIx3m8rlVol6Q: doesn't show hand 
*** SUMMARY ***
Total pot $0.60 | Rake $0 
Board [4d 6d Jd 5c]
Seat 1: KXtdqb+rIMkjc0RvHDksGQ (small blind) folded before Flop
Seat 2: vqWjZmdQu/Hxw96/IJTWdQ (big blind) folded on the Turn
Seat 3: 9kUKGKkblnIx3m8rlVol6Q collected ($0.60)
Seat 4: HxD1kB8zCmalQSdWAkKmlg folded before Flop (didn't bet)
Seat 5: tOAk1Og4mVObMBOfvdDYOw folded before Flop (didn't bet)
Seat 6: LxehwDpTQ19ph4Qmc78+Pw (button) folded before Flop (didn't bet)




PokerStars Game #59941597212:  Hold'em No Limit ($0.10/$0.25) - 2009/07/01 1:40:16 ET
Table '6wawJ+MkkvuC3coG6r+Yhg' 6-max Seat #3 is the button
Seat 1: JQZew0FjzS19kTjeNtrE+A ($27.10 in chips) 
Seat 2: LtASJ9OlkqGrrUKGQlpGAw ($33.60 in chips) 
Seat 3: 3zD3qLXT1bEffAoWGnc7wg ($59.85 in chips) 
Seat 4: yxmjNFGiKI3b+XQGJzJVIg ($28.05 in chips) 
Seat 5: FZrgDbxAanC1xwZxXHJKVA ($2.85 in chips) 
Seat 6: B3X187C0tXFUfQpCu8pe8A ($28.35 in chips) 
yxmjNFGiKI3b+XQGJzJVIg: posts small blind $0.10
FZrgDbxAanC1xwZxXHJKVA: posts big blind $0.25
*** HOLE CARDS ***
B3X187C0tXFUfQpCu8pe8A: folds 
JQZew0FjzS19kTjeNtrE+A: folds 
LtASJ9OlkqGrrUKGQlpGAw: folds 
3zD3qLXT1bEffAoWGnc7wg: folds 
yxmjNFGiKI3b+XQGJzJVIg: folds 
Uncalled bet ($0.15) returned to FZrgDbxAanC1xwZxXHJKVA
FZrgDbxAanC1xwZxXHJKVA collected $0.20 from pot
*** SUMMARY ***
Total pot $0.20 | Rake $0 
Seat 1: JQZew0FjzS19kTjeNtrE+A folded before Flop (didn't bet)
Seat 2: LtASJ9OlkqGrrUKGQlpGAw folded before Flop (didn't bet)
Seat 3: 3zD3qLXT1bEffAoWGnc7wg (button) folded before Flop (didn't bet)
Seat 4: yxmjNFGiKI3b+XQGJzJVIg (small blind) folded before Flop
Seat 5: FZrgDbxAanC1xwZxXHJKVA (big blind) collected ($0.20)
Seat 6: B3X187C0tXFUfQpCu8pe8A folded before Flop (didn't bet)




PokerStars Game #59941596852:  Hold'em No Limit ($0.10/$0.25) - 2009/07/01 1:40:16 ET
Table 'YONIZZNvg4uZ4xNUO1deeA' 6-max Seat #5 is the button
Seat 1: GbCVUNssQ7mqsPWr7J4d3w ($5 in chips) 
Seat 2: evMMX/0gSDH791KdSAOaSg ($5.35 in chips) 
Seat 3: Eksrep3hySi2jeDHuaWiOQ ($8.55 in chips) 
Seat 4: oNAHfBJOUelvVhf0IDMJUA ($26.90 in chips) 
Seat 5: if4dh6jhJXeN3/qd3qCp9g ($25 in chips) 
Seat 6: eL3+wCBjFGfQ5FMdIZihwA ($25 in chips) 
eL3+wCBjFGfQ5FMdIZihwA: posts small blind $0.10
GbCVUNssQ7mqsPWr7J4d3w: posts big blind $0.25
*** HOLE CARDS ***
evMMX/0gSDH791KdSAOaSg: folds 
Eksrep3hySi2jeDHuaWiOQ: folds 
oNAHfBJOUelvVhf0IDMJUA: folds 
if4dh6jhJXeN3/qd3qCp9g: raises $0.50 to $0.75
eL3+wCBjFGfQ5FMdIZihwA: folds 
GbCVUNssQ7mqsPWr7J4d3w: folds 
Uncalled bet ($0.50) returned to if4dh6jhJXeN3/qd3qCp9g
if4dh6jhJXeN3/qd3qCp9g collected $0.60 from pot
if4dh6jhJXeN3/qd3qCp9g: doesn't show hand 
*** SUMMARY ***
Total pot $0.60 | Rake $0 
Seat 1: GbCVUNssQ7mqsPWr7J4d3w (big blind) folded before Flop
Seat 2: evMMX/0gSDH791KdSAOaSg folded before Flop (didn't bet)
Seat 3: Eksrep3hySi2jeDHuaWiOQ folded before Flop (didn't bet)
Seat 4: oNAHfBJOUelvVhf0IDMJUA folded before Flop (didn't bet)
Seat 5: if4dh6jhJXeN3/qd3qCp9g (button) collected ($0.60)
Seat 6: eL3+wCBjFGfQ5FMdIZihwA (small blind) folded before Flop




PokerStars Game #59941597184:  Hold'em No Limit ($0.10/$0.25) - 2009/07/01 1:40:16 ET
Table 'IIO2q2znuuAXmiZ2qFTcmg' 6-max Seat #3 is the button
Seat 1: 2G0C7dp4wlPpE21FHjjElQ ($25 in chips) 
Seat 2: cS21pIxRHx5Gt42o7hPZzw ($12.95 in chips) 
Seat 3: L3/N/gliETan8N5Gim5h4Q ($25 in chips) 
Seat 4: tSR4329m40dZsN7YOpI9Kw ($59.70 in chips) 
tSR4329m40dZsN7YOpI9Kw: posts small blind $0.10
2G0C7dp4wlPpE21FHjjElQ: posts big blind $0.25
*** HOLE CARDS ***
cS21pIxRHx5Gt42o7hPZzw: calls $0.25
L3/N/gliETan8N5Gim5h4Q: raises $0.75 to $1
GJsS3gwVwlbyroaWrnjqJg leaves the table
tSR4329m40dZsN7YOpI9Kw: folds 
2G0C7dp4wlPpE21FHjjElQ: folds 
cS21pIxRHx5Gt42o7hPZzw: calls $0.75
*** FLOP *** [3d 9c Ks]
cS21pIxRHx5Gt42o7hPZzw: checks 
L3/N/gliETan8N5Gim5h4Q: bets $1.50
cS21pIxRHx5Gt42o7hPZzw: calls $1.50
*** TURN *** [3d 9c Ks] [9d]
cS21pIxRHx5Gt42o7hPZzw: checks 
arewedunces joins the table at seat #5 
L3/N/gliETan8N5Gim5h4Q: checks 
*** RIVER *** [3d 9c Ks 9d] [Jh]
cS21pIxRHx5Gt42o7hPZzw: checks 
L3/N/gliETan8N5Gim5h4Q: checks 
*** SHOW DOWN ***
cS21pIxRHx5Gt42o7hPZzw: shows [Jd Qs] (two pair, Jacks and Nines)
L3/N/gliETan8N5Gim5h4Q: mucks hand 
cS21pIxRHx5Gt42o7hPZzw collected $5.10 from pot
*** SUMMARY ***
Total pot $5.35 | Rake $0.25 
Board [3d 9c Ks 9d Jh]
Seat 1: 2G0C7dp4wlPpE21FHjjElQ (big blind) folded before Flop
Seat 2: cS21pIxRHx5Gt42o7hPZzw showed [Jd Qs] and won ($5.10) with two pair, Jacks and Nines
Seat 3: L3/N/gliETan8N5Gim5h4Q (button) mucked
Seat 4: tSR4329m40dZsN7YOpI9Kw (small blind) folded before Flop




PokerStars Game #59941596850:  Hold'em No Limit ($0.10/$0.25) - 2009/07/01 1:40:16 ET
Table 'AUM6O+mgQAaLDZKMQ/5/gA' 9-max Seat #8 is the button
Seat 1: EIObtVVE4WXRXvLGJA6NHw ($17.80 in chips) 
Seat 2: OXPkK84/qv92EMwXPiG5rQ ($9.50 in chips) 
Seat 3: CvL9Ch1HYCVbTsfpNucitg ($3.75 in chips) 
Seat 4: 4awUyiDYTgylQKXZ9faBVA ($28.05 in chips) 
Seat 5: +2kMBNpY4nF1qNCRd8SJLA ($25.65 in chips) 
Seat 6: v5jnQ1gfh9nLla3kMXG7Yg ($7.95 in chips) 
Seat 7: Bb42QRQMhg5/Y0vHP8/2Xw ($30.60 in chips) 
Seat 8: zDrucyjVn5aeekNEc3cJrA ($17.40 in chips) 
Seat 9: eK8qa6EPcH2zhtbmWSvc9g ($25.80 in chips) 
eK8qa6EPcH2zhtbmWSvc9g: posts small blind $0.10
EIObtVVE4WXRXvLGJA6NHw: posts big blind $0.25
*** HOLE CARDS ***
OXPkK84/qv92EMwXPiG5rQ: folds 
CvL9Ch1HYCVbTsfpNucitg: folds 
4awUyiDYTgylQKXZ9faBVA: folds 
+2kMBNpY4nF1qNCRd8SJLA: folds 
v5jnQ1gfh9nLla3kMXG7Yg: calls $0.25
Bb42QRQMhg5/Y0vHP8/2Xw: folds 
zDrucyjVn5aeekNEc3cJrA: folds 
eK8qa6EPcH2zhtbmWSvc9g: folds 
EIObtVVE4WXRXvLGJA6NHw: checks 
*** FLOP *** [Qs 3c Ks]
EIObtVVE4WXRXvLGJA6NHw: checks 
v5jnQ1gfh9nLla3kMXG7Yg: checks 
*** TURN *** [Qs 3c Ks] [7h]
EIObtVVE4WXRXvLGJA6NHw: bets $0.75
v5jnQ1gfh9nLla3kMXG7Yg: folds 
Uncalled bet ($0.75) returned to EIObtVVE4WXRXvLGJA6NHw
EIObtVVE4WXRXvLGJA6NHw collected $0.60 from pot
EIObtVVE4WXRXvLGJA6NHw: doesn't show hand 
*** SUMMARY ***
Total pot $0.60 | Rake $0 
Board [Qs 3c Ks 7h]
Seat 1: EIObtVVE4WXRXvLGJA6NHw (big blind) collected ($0.60)
Seat 2: OXPkK84/qv92EMwXPiG5rQ folded before Flop (didn't bet)
Seat 3: CvL9Ch1HYCVbTsfpNucitg folded before Flop (didn't bet)
Seat 4: 4awUyiDYTgylQKXZ9faBVA folded before Flop (didn't bet)
Seat 5: +2kMBNpY4nF1qNCRd8SJLA folded before Flop (didn't bet)
Seat 6: v5jnQ1gfh9nLla3kMXG7Yg folded on the Turn
Seat 7: Bb42QRQMhg5/Y0vHP8/2Xw folded before Flop (didn't bet)
Seat 8: zDrucyjVn5aeekNEc3cJrA (button) folded before Flop (didn't bet)
Seat 9: eK8qa6EPcH2zhtbmWSvc9g (small blind) folded before Flop




PokerStars Game #59941597630:  Hold'em No Limit ($0.10/$0.25) - 2009/07/01 1:40:17 ET
Table '972HGIb0tQN/zRIK4TABEw' 9-max Seat #9 is the button
Seat 2: lc6GpYOW7MM4G+/65wMxXA ($16.75 in chips) 
Seat 3: aNpwfA31EREwO+ar4XzBCw ($25 in chips) 
Seat 4: Bb42QRQMhg5/Y0vHP8/2Xw ($25 in chips) 
Seat 5: swK30YlQuxRQO7QFr4ZxCA ($19.30 in chips) 
Seat 6: aLYacoAY3e5d/M5ToF8Ujw ($12.40 in chips) 
Seat 7: qS+jfnNoG75bT+uQ8CKhQA ($14.75 in chips) 
Seat 8: sGFnnRCa1YAHAUmWgsW6Qg ($8.80 in chips) 
Seat 9: 3PmVnC/15cl4oyI1TKIt4g ($3.95 in chips) 
fHr2+mGa0RFK3qrpZcVUAQ has timed out
fHr2+mGa0RFK3qrpZcVUAQ: is sitting out 
lc6GpYOW7MM4G+/65wMxXA: posts small blind $0.10
aNpwfA31EREwO+ar4XzBCw: posts big blind $0.25
*** HOLE CARDS ***
Bb42QRQMhg5/Y0vHP8/2Xw: folds 
swK30YlQuxRQO7QFr4ZxCA: folds 
aLYacoAY3e5d/M5ToF8Ujw: calls $0.25
qS+jfnNoG75bT+uQ8CKhQA: folds 
sGFnnRCa1YAHAUmWgsW6Qg: folds 
3PmVnC/15cl4oyI1TKIt4g: folds 
fHr2+mGa0RFK3qrpZcVUAQ has returned
lc6GpYOW7MM4G+/65wMxXA: raises $1.50 to $1.75
aNpwfA31EREwO+ar4XzBCw: folds 
aLYacoAY3e5d/M5ToF8Ujw: calls $1.50
*** FLOP *** [4h 9c Th]
lc6GpYOW7MM4G+/65wMxXA: bets $3.25
aLYacoAY3e5d/M5ToF8Ujw: raises $7.40 to $10.65 and is all-in
lc6GpYOW7MM4G+/65wMxXA has timed out
lc6GpYOW7MM4G+/65wMxXA: folds 
Uncalled bet ($7.40) returned to aLYacoAY3e5d/M5ToF8Ujw
lc6GpYOW7MM4G+/65wMxXA is sitting out
lc6GpYOW7MM4G+/65wMxXA has returned
aLYacoAY3e5d/M5ToF8Ujw collected $9.75 from pot
*** SUMMARY ***
Total pot $10.25 | Rake $0.50 
Board [4h 9c Th]
Seat 2: lc6GpYOW7MM4G+/65wMxXA (small blind) folded on the Flop
Seat 3: aNpwfA31EREwO+ar4XzBCw (big blind) folded before Flop
Seat 4: Bb42QRQMhg5/Y0vHP8/2Xw folded before Flop (didn't bet)
Seat 5: swK30YlQuxRQO7QFr4ZxCA folded before Flop (didn't bet)
Seat 6: aLYacoAY3e5d/M5ToF8Ujw collected ($9.75)
Seat 7: qS+jfnNoG75bT+uQ8CKhQA folded before Flop (didn't bet)
Seat 8: sGFnnRCa1YAHAUmWgsW6Qg folded before Flop (didn't bet)
Seat 9: 3PmVnC/15cl4oyI1TKIt4g (button) folded before Flop (didn't bet)




PokerStars Game #59941597668:  Hold'em No Limit ($0.10/$0.25) - 2009/07/01 1:40:17 ET
Table 'KKk6y4pAXeymxYcd0uZLqg' 9-max Seat #5 is the button
Seat 1: HPEB+AtKw1+C/cxU0o1ciw ($24.90 in chips) 
Seat 2: k55YB7uP2TAZEba6pnHYiA ($20.45 in chips) 
Seat 4: YciNm3fUXAQaJeXG1rhrbw ($15.55 in chips) 
Seat 5: wGigCmBR/9XWkPpvYos3aQ ($32.30 in chips) 
Seat 6: QEbIGci+itdw+re8RM5fZA ($25 in chips) 
Seat 7: JjOuv8Vf56aiQjWi/rTPFA ($25 in chips) 
Seat 8: +2kMBNpY4nF1qNCRd8SJLA ($33.60 in chips) 
Seat 9: oLa/tXLfSLLB28mcLGrxcg ($25 in chips) 
QEbIGci+itdw+re8RM5fZA: posts small blind $0.10
JjOuv8Vf56aiQjWi/rTPFA: posts big blind $0.25
tLcDklc2rBORNfixyRfVfw: sits out 
*** HOLE CARDS ***
+2kMBNpY4nF1qNCRd8SJLA: folds 
oLa/tXLfSLLB28mcLGrxcg: folds 
HPEB+AtKw1+C/cxU0o1ciw: folds 
k55YB7uP2TAZEba6pnHYiA: folds 
YciNm3fUXAQaJeXG1rhrbw: calls $0.25
wGigCmBR/9XWkPpvYos3aQ: folds 
QEbIGci+itdw+re8RM5fZA: folds 
JjOuv8Vf56aiQjWi/rTPFA: checks 
*** FLOP *** [6s As 4s]
JjOuv8Vf56aiQjWi/rTPFA: checks 
YciNm3fUXAQaJeXG1rhrbw: bets $0.75
JjOuv8Vf56aiQjWi/rTPFA: calls $0.75
*** TURN *** [6s As 4s] [8c]
JjOuv8Vf56aiQjWi/rTPFA: checks 
YciNm3fUXAQaJeXG1rhrbw: bets $1.25
JjOuv8Vf56aiQjWi/rTPFA: calls $1.25
*** RIVER *** [6s As 4s 8c] [9c]
JjOuv8Vf56aiQjWi/rTPFA: checks 
YciNm3fUXAQaJeXG1rhrbw: checks 
*** SHOW DOWN ***
JjOuv8Vf56aiQjWi/rTPFA: shows [Ks 3d] (high card Ace)
YciNm3fUXAQaJeXG1rhrbw: shows [6d 4h] (two pair, Sixes and Fours)
YciNm3fUXAQaJeXG1rhrbw collected $4.40 from pot
*** SUMMARY ***
Total pot $4.60 | Rake $0.20 
Board [6s As 4s 8c 9c]
Seat 1: HPEB+AtKw1+C/cxU0o1ciw folded before Flop (didn't bet)
Seat 2: k55YB7uP2TAZEba6pnHYiA folded before Flop (didn't bet)
Seat 4: YciNm3fUXAQaJeXG1rhrbw showed [6d 4h] and won ($4.40) with two pair, Sixes and Fours
Seat 5: wGigCmBR/9XWkPpvYos3aQ (button) folded before Flop (didn't bet)
Seat 6: QEbIGci+itdw+re8RM5fZA (small blind) folded before Flop
Seat 7: JjOuv8Vf56aiQjWi/rTPFA (big blind) showed [Ks 3d] and lost with high card Ace
Seat 8: +2kMBNpY4nF1qNCRd8SJLA folded before Flop (didn't bet)
Seat 9: oLa/tXLfSLLB28mcLGrxcg folded before Flop (didn't bet)




PokerStars Game #59941597710:  Hold'em No Limit ($0.10/$0.25) - 2009/07/01 1:40:17 ET
Table 'ThBZ355rqvsb8UGb6ajbig' 9-max Seat #5 is the button
Seat 1: cZ99hugmLBj9KhTlc8nCSw ($38.15 in chips) 
Seat 2: 4awUyiDYTgylQKXZ9faBVA ($25.95 in chips) 
Seat 3: H5Se03ZqSX7tbULXur2MAg ($27.90 in chips) 
Seat 4: zgi+EUykT/pZQpoUG6+oEg ($4.65 in chips) 
Seat 5: cKlmpQMahVsmOaxFQDcoOg ($25.35 in chips) 
Seat 6: qwr38jl5txoR36M7G5qi4A ($9.90 in chips) 
Seat 7: zUXhymECc2C9W9ZNw6qppA ($16.70 in chips) 
Seat 9: sD+TKtt36XiiN6jqHiLwDA ($23.85 in chips) 
qwr38jl5txoR36M7G5qi4A: posts small blind $0.10
zUXhymECc2C9W9ZNw6qppA: posts big blind $0.25
PdIasPkzm2sqZnN41ZRXOg: sits out 
*** HOLE CARDS ***
sD+TKtt36XiiN6jqHiLwDA: folds 
cZ99hugmLBj9KhTlc8nCSw: folds 
4awUyiDYTgylQKXZ9faBVA: folds 
H5Se03ZqSX7tbULXur2MAg: folds 
zgi+EUykT/pZQpoUG6+oEg: folds 
cKlmpQMahVsmOaxFQDcoOg: folds 
qwr38jl5txoR36M7G5qi4A: calls $0.15
zUXhymECc2C9W9ZNw6qppA: raises $0.75 to $1
qwr38jl5txoR36M7G5qi4A: folds 
Uncalled bet ($0.75) returned to zUXhymECc2C9W9ZNw6qppA
zUXhymECc2C9W9ZNw6qppA collected $0.50 from pot
*** SUMMARY ***
Total pot $0.50 | Rake $0 
Seat 1: cZ99hugmLBj9KhTlc8nCSw folded before Flop (didn't bet)
Seat 2: 4awUyiDYTgylQKXZ9faBVA folded before Flop (didn't bet)
Seat 3: H5Se03ZqSX7tbULXur2MAg folded before Flop (didn't bet)
Seat 4: zgi+EUykT/pZQpoUG6+oEg folded before Flop (didn't bet)
Seat 5: cKlmpQMahVsmOaxFQDcoOg (button) folded before Flop (didn't bet)
Seat 6: qwr38jl5txoR36M7G5qi4A (small blind) folded before Flop
Seat 7: zUXhymECc2C9W9ZNw6qppA (big blind) collected ($0.50)
Seat 9: sD+TKtt36XiiN6jqHiLwDA folded before Flop (didn't bet)




PokerStars Game #59941597674:  Hold'em No Limit ($0.10/$0.25) - 2009/07/01 1:40:17 ET
Table 'fHv1Mk7ZbLjprZTGWKPiEQ' 6-max Seat #6 is the button
Seat 3: /gJNBeCkWL4o85/jvlZ4BA ($25.10 in chips) 
Seat 4: TSmua8tGK3sTbwi0ynrW9Q ($52.25 in chips) 
Seat 5: LJI7A1YgDM7hgh7o56+ReQ ($28.15 in chips) 
Seat 6: AjG0X+rNtc2W08eph8oqpw ($35.15 in chips) 
arewedunces will be allowed to play after the button
/gJNBeCkWL4o85/jvlZ4BA: posts small blind $0.10
TSmua8tGK3sTbwi0ynrW9Q: posts big blind $0.25
*** HOLE CARDS ***
LJI7A1YgDM7hgh7o56+ReQ: raises $0.50 to $0.75
AjG0X+rNtc2W08eph8oqpw: calls $0.75
/gJNBeCkWL4o85/jvlZ4BA: folds 
TSmua8tGK3sTbwi0ynrW9Q: folds 
*** FLOP *** [Ts Kd Qs]
LJI7A1YgDM7hgh7o56+ReQ: checks 
AjG0X+rNtc2W08eph8oqpw: bets $0.50
LJI7A1YgDM7hgh7o56+ReQ: folds 
Uncalled bet ($0.50) returned to AjG0X+rNtc2W08eph8oqpw
AjG0X+rNtc2W08eph8oqpw collected $1.80 from pot
AjG0X+rNtc2W08eph8oqpw: doesn't show hand 
*** SUMMARY ***
Total pot $1.85 | Rake $0.05 
Board [Ts Kd Qs]
Seat 3: /gJNBeCkWL4o85/jvlZ4BA (small blind) folded before Flop
Seat 4: TSmua8tGK3sTbwi0ynrW9Q (big blind) folded before Flop
Seat 5: LJI7A1YgDM7hgh7o56+ReQ folded on the Flop
Seat 6: AjG0X+rNtc2W08eph8oqpw (button) collected ($1.80)




PokerStars Game #59941597552:  Hold'em No Limit ($0.10/$0.25) - 2009/07/01 1:40:17 ET
Table '8PD/MTROSMd6Y8mZeykbpg' 6-max Seat #5 is the button
Seat 2: +C3eP/ysyROWbEXJFPswVA ($25.20 in chips) 
Seat 3: vqWjZmdQu/Hxw96/IJTWdQ ($25 in chips) 
Seat 4: DFi/Lzkjsfv8QswS80JX9Q ($53.70 in chips) 
Seat 5: z3tQwy28dp5FykDJC/wzQw ($25.95 in chips) 
fxNpaToxECtD2Goelmg9vA will be allowed to play after the button
+C3eP/ysyROWbEXJFPswVA: posts small blind $0.10
vqWjZmdQu/Hxw96/IJTWdQ: posts big blind $0.25
*** HOLE CARDS ***
DFi/Lzkjsfv8QswS80JX9Q: folds 
z3tQwy28dp5FykDJC/wzQw: folds 
+C3eP/ysyROWbEXJFPswVA: folds 
Uncalled bet ($0.15) returned to vqWjZmdQu/Hxw96/IJTWdQ
vqWjZmdQu/Hxw96/IJTWdQ collected $0.20 from pot
vqWjZmdQu/Hxw96/IJTWdQ: doesn't show hand 
*** SUMMARY ***
Total pot $0.20 | Rake $0 
Seat 2: +C3eP/ysyROWbEXJFPswVA (small blind) folded before Flop
Seat 3: vqWjZmdQu/Hxw96/IJTWdQ (big blind) collected ($0.20)
Seat 4: DFi/Lzkjsfv8QswS80JX9Q folded before Flop (didn't bet)
Seat 5: z3tQwy28dp5FykDJC/wzQw (button) folded before Flop (didn't bet)




PokerStars Game #59941597898:  Hold'em No Limit ($0.10/$0.25) - 2009/07/01 1:40:17 ET
Table 'FuFyQHmlO/QqQp//rDRrPg' 6-max Seat #1 is the button
Seat 1: jp34e617tIzV8tKIWmfAbA ($26.20 in chips) 
Seat 2: G3h3THGB1j3qdHDVHpnJWg ($22.90 in chips) 
Seat 3: EeUZtMU058v2ObUACOF4Og ($30.60 in chips) 
Seat 4: OMGl+YMGogf2JWIRfT2/Yg ($4.75 in chips) 
Seat 5: xrf8tAXKQHG99HixCot1Iw ($20.60 in chips) 
Seat 6: 6DwBRH+xZ12AAZmeAg+aXw ($59.65 in chips) 
G3h3THGB1j3qdHDVHpnJWg: posts small blind $0.10
EeUZtMU058v2ObUACOF4Og: posts big blind $0.25
*** HOLE CARDS ***
OMGl+YMGogf2JWIRfT2/Yg: folds 
xrf8tAXKQHG99HixCot1Iw: folds 
6DwBRH+xZ12AAZmeAg+aXw: raises $0.50 to $0.75
jp34e617tIzV8tKIWmfAbA: calls $0.75
G3h3THGB1j3qdHDVHpnJWg: folds 
EeUZtMU058v2ObUACOF4Og: folds 
*** FLOP *** [Kd 7s 6h]
6DwBRH+xZ12AAZmeAg+aXw: bets $1
jp34e617tIzV8tKIWmfAbA: raises $1.50 to $2.50
6DwBRH+xZ12AAZmeAg+aXw: folds 
Uncalled bet ($1.50) returned to jp34e617tIzV8tKIWmfAbA
jp34e617tIzV8tKIWmfAbA collected $3.70 from pot
*** SUMMARY ***
Total pot $3.85 | Rake $0.15 
Board [Kd 7s 6h]
Seat 1: jp34e617tIzV8tKIWmfAbA (button) collected ($3.70)
Seat 2: G3h3THGB1j3qdHDVHpnJWg (small blind) folded before Flop
Seat 3: EeUZtMU058v2ObUACOF4Og (big blind) folded before Flop
Seat 4: OMGl+YMGogf2JWIRfT2/Yg folded before Flop (didn't bet)
Seat 5: xrf8tAXKQHG99HixCot1Iw folded before Flop (didn't bet)
Seat 6: 6DwBRH+xZ12AAZmeAg+aXw folded on the Flop




PokerStars Game #59941597922:  Hold'em No Limit ($0.10/$0.25) - 2009/07/01 1:40:17 ET
Table '5SUMWYuPsGiOD0FY0QbgOw' 6-max Seat #1 is the button
Seat 1: SFmT9ZsVopnukjvAzrxTRg ($25 in chips) 
Seat 2: xrf8tAXKQHG99HixCot1Iw ($37.80 in chips) 
Seat 3: MqMK8OWPSY1V4stf1Hy5Jw ($32.25 in chips) 
Seat 4: BV+K0Phf5VBHr7aZPKqbUQ ($25.35 in chips) 
Seat 5: v+QfkGiuj9bgtuNoVnDO8w ($40.75 in chips) 
Seat 6: jA7YMtfNUnAaebB7Lj74EA ($24.80 in chips) 
xrf8tAXKQHG99HixCot1Iw: posts small blind $0.10
MqMK8OWPSY1V4stf1Hy5Jw: posts big blind $0.25
*** HOLE CARDS ***
BV+K0Phf5VBHr7aZPKqbUQ: folds 
v+QfkGiuj9bgtuNoVnDO8w: folds 
jA7YMtfNUnAaebB7Lj74EA: calls $0.25
SFmT9ZsVopnukjvAzrxTRg: folds 
xrf8tAXKQHG99HixCot1Iw: calls $0.15
MqMK8OWPSY1V4stf1Hy5Jw: checks 
*** FLOP *** [Td 5d 9s]
xrf8tAXKQHG99HixCot1Iw: checks 
MqMK8OWPSY1V4stf1Hy5Jw: checks 
jA7YMtfNUnAaebB7Lj74EA: bets $1
xrf8tAXKQHG99HixCot1Iw: calls $1
MqMK8OWPSY1V4stf1Hy5Jw: folds 
*** TURN *** [Td 5d 9s] [6s]
xrf8tAXKQHG99HixCot1Iw: checks 
jA7YMtfNUnAaebB7Lj74EA: bets $2
xrf8tAXKQHG99HixCot1Iw: folds 
Uncalled bet ($2) returned to jA7YMtfNUnAaebB7Lj74EA
jA7YMtfNUnAaebB7Lj74EA collected $2.65 from pot
jA7YMtfNUnAaebB7Lj74EA: doesn't show hand 
*** SUMMARY ***
Total pot $2.75 | Rake $0.10 
Board [Td 5d 9s 6s]
Seat 1: SFmT9ZsVopnukjvAzrxTRg (button) folded before Flop (didn't bet)
Seat 2: xrf8tAXKQHG99HixCot1Iw (small blind) folded on the Turn
Seat 3: MqMK8OWPSY1V4stf1Hy5Jw (big blind) folded on the Flop
Seat 4: BV+K0Phf5VBHr7aZPKqbUQ folded before Flop (didn't bet)
Seat 5: v+QfkGiuj9bgtuNoVnDO8w folded before Flop (didn't bet)
Seat 6: jA7YMtfNUnAaebB7Lj74EA collected ($2.65)




PokerStars Game #59941598020:  Hold'em No Limit ($0.10/$0.25) - 2009/07/01 1:40:18 ET
Table '2vH5RcmkT0F4XNS/EmmyMA' 6-max Seat #5 is the button
Seat 1: hOaWAImn5/MZDAWAPlYHCw ($5.80 in chips) 
Seat 2: W6Y6au0wf7gRAlqJYgOezw ($13.10 in chips) 
Seat 3: t8P79jKZYh/Wpx2V73pSqg ($27.05 in chips) 
Seat 4: FC6tJ9EOiutXO8hnpR4VgQ ($5.75 in chips) 
Seat 5: Hsvkc0/G2VV78oVmWYXecw ($5 in chips) 
Seat 6: if4dh6jhJXeN3/qd3qCp9g ($25 in chips) 
if4dh6jhJXeN3/qd3qCp9g: posts small blind $0.10
hOaWAImn5/MZDAWAPlYHCw: posts big blind $0.25
*** HOLE CARDS ***
W6Y6au0wf7gRAlqJYgOezw: folds 
t8P79jKZYh/Wpx2V73pSqg: calls $0.25
FC6tJ9EOiutXO8hnpR4VgQ: folds 
Hsvkc0/G2VV78oVmWYXecw: folds 
if4dh6jhJXeN3/qd3qCp9g: raises $1 to $1.25
hOaWAImn5/MZDAWAPlYHCw: folds 
t8P79jKZYh/Wpx2V73pSqg: calls $1
*** FLOP *** [6d Tc As]
if4dh6jhJXeN3/qd3qCp9g: bets $2
t8P79jKZYh/Wpx2V73pSqg: calls $2
*** TURN *** [6d Tc As] [7d]
if4dh6jhJXeN3/qd3qCp9g: checks 
t8P79jKZYh/Wpx2V73pSqg: bets $1
if4dh6jhJXeN3/qd3qCp9g: folds 
Uncalled bet ($1) returned to t8P79jKZYh/Wpx2V73pSqg
t8P79jKZYh/Wpx2V73pSqg collected $6.45 from pot
*** SUMMARY ***
Total pot $6.75 | Rake $0.30 
Board [6d Tc As 7d]
Seat 1: hOaWAImn5/MZDAWAPlYHCw (big blind) folded before Flop
Seat 2: W6Y6au0wf7gRAlqJYgOezw folded before Flop (didn't bet)
Seat 3: t8P79jKZYh/Wpx2V73pSqg collected ($6.45)
Seat 4: FC6tJ9EOiutXO8hnpR4VgQ folded before Flop (didn't bet)
Seat 5: Hsvkc0/G2VV78oVmWYXecw (button) folded before Flop (didn't bet)
Seat 6: if4dh6jhJXeN3/qd3qCp9g (small blind) folded on the Turn




PokerStars Game #59941598118:  Hold'em No Limit ($0.10/$0.25) - 2009/07/01 1:40:18 ET
Table '6aL2C8IFwHHr6SG6RgXaow' 9-max Seat #3 is the button
Seat 1: AKrlhR3s97+cfTtZj3tKjw ($3.65 in chips) 
Seat 3: aCVg6cCxQcqClhB9nq/p1w ($12.35 in chips) 
Seat 4: BT6Oal0iO4P6kDuT7HFQDw ($17.75 in chips) 
Seat 5: wre31HfyzQGpIvID1istxw ($21.20 in chips) 
Seat 6: gehe91e0IyVT0QU/XBkEyg ($27.45 in chips) 
Seat 7: QJxYAPJ6uPZZcpdN+RvWcQ ($25 in chips) 
Seat 8: rQhYIYXSyH/IivYM1dlV5A ($23.15 in chips) 
Seat 9: CgIo2ItZqi4o3ayVG6HanQ ($23.75 in chips) 
BT6Oal0iO4P6kDuT7HFQDw: posts small blind $0.10
wre31HfyzQGpIvID1istxw: posts big blind $0.25
*** HOLE CARDS ***
gehe91e0IyVT0QU/XBkEyg: folds 
QJxYAPJ6uPZZcpdN+RvWcQ: folds 
rQhYIYXSyH/IivYM1dlV5A: raises $0.50 to $0.75
CgIo2ItZqi4o3ayVG6HanQ: folds 
AKrlhR3s97+cfTtZj3tKjw: folds 
aCVg6cCxQcqClhB9nq/p1w: folds 
BT6Oal0iO4P6kDuT7HFQDw: calls $0.65
wre31HfyzQGpIvID1istxw: folds 
*** FLOP *** [7c 2c As]
BT6Oal0iO4P6kDuT7HFQDw: checks 
rQhYIYXSyH/IivYM1dlV5A: bets $0.75
BT6Oal0iO4P6kDuT7HFQDw: calls $0.75
*** TURN *** [7c 2c As] [5d]
BT6Oal0iO4P6kDuT7HFQDw: checks 
rQhYIYXSyH/IivYM1dlV5A: checks 
*** RIVER *** [7c 2c As 5d] [6s]
BT6Oal0iO4P6kDuT7HFQDw: checks 
rQhYIYXSyH/IivYM1dlV5A: checks 
*** SHOW DOWN ***
BT6Oal0iO4P6kDuT7HFQDw: shows [3s 5s] (a pair of Fives)
rQhYIYXSyH/IivYM1dlV5A: mucks hand 
BT6Oal0iO4P6kDuT7HFQDw collected $3.10 from pot
*** SUMMARY ***
Total pot $3.25 | Rake $0.15 
Board [7c 2c As 5d 6s]
Seat 1: AKrlhR3s97+cfTtZj3tKjw folded before Flop (didn't bet)
Seat 3: aCVg6cCxQcqClhB9nq/p1w (button) folded before Flop (didn't bet)
Seat 4: BT6Oal0iO4P6kDuT7HFQDw (small blind) showed [3s 5s] and won ($3.10) with a pair of Fives
Seat 5: wre31HfyzQGpIvID1istxw (big blind) folded before Flop
Seat 6: gehe91e0IyVT0QU/XBkEyg folded before Flop (didn't bet)
Seat 7: QJxYAPJ6uPZZcpdN+RvWcQ folded before Flop (didn't bet)
Seat 8: rQhYIYXSyH/IivYM1dlV5A mucked
Seat 9: CgIo2ItZqi4o3ayVG6HanQ folded before Flop (didn't bet)




PokerStars Game #59941598202:  Hold'em No Limit ($0.10/$0.25) - 2009/07/01 1:40:18 ET
Table 'hOE09W281uSob0XeJmUcRg' 6-max Seat #5 is the button
Seat 1: mfrkWA3PTeYPkbO6hi98Aw ($27.75 in chips) 
Seat 2: lYjWCpfCxX2kgcHY3v4Yow ($28.85 in chips) 
Seat 3: y+a/yGW/Jy4bPJFnaeTz5w ($13.40 in chips) 
Seat 4: TslQs7AQSLbVtr4X8JOOOQ ($16.65 in chips) 
Seat 5: JFIAqU8lCZ0vWwEl4bdGsg ($25 in chips) 
x4ZJ8E/TUrtoB7WiHcv8WA will be allowed to play after the button
mfrkWA3PTeYPkbO6hi98Aw: posts small blind $0.10
lYjWCpfCxX2kgcHY3v4Yow: posts big blind $0.25
*** HOLE CARDS ***
y+a/yGW/Jy4bPJFnaeTz5w: folds 
TslQs7AQSLbVtr4X8JOOOQ: raises $0.50 to $0.75
JFIAqU8lCZ0vWwEl4bdGsg: folds 
mfrkWA3PTeYPkbO6hi98Aw: folds 
lYjWCpfCxX2kgcHY3v4Yow: folds 
Uncalled bet ($0.50) returned to TslQs7AQSLbVtr4X8JOOOQ
TslQs7AQSLbVtr4X8JOOOQ collected $0.60 from pot
TslQs7AQSLbVtr4X8JOOOQ: doesn't show hand 
*** SUMMARY ***
Total pot $0.60 | Rake $0 
Seat 1: mfrkWA3PTeYPkbO6hi98Aw (small blind) folded before Flop
Seat 2: lYjWCpfCxX2kgcHY3v4Yow (big blind) folded before Flop
Seat 3: y+a/yGW/Jy4bPJFnaeTz5w folded before Flop (didn't bet)
Seat 4: TslQs7AQSLbVtr4X8JOOOQ collected ($0.60)
Seat 5: JFIAqU8lCZ0vWwEl4bdGsg (button) folded before Flop (didn't bet)




PokerStars Game #59941598180:  Hold'em No Limit ($0.10/$0.25) - 2009/07/01 1:40:18 ET
Table 'h02LhQ7B/Zk4ETRxxHhGYA' 9-max Seat #3 is the button
Seat 1: sD+TKtt36XiiN6jqHiLwDA ($25.25 in chips) 
Seat 2: 9lvO/qyU+xrU95Teu1fv0g ($5.70 in chips) 
Seat 3: arxNSjreDRGFg13EAM2F1w ($25 in chips) 
Seat 4: tYsOBqdU1+x+yFI7zHO7hQ ($38.20 in chips) 
Seat 5: cUxk0Jk4lrUQv9CJl0LPlg ($27.30 in chips) 
Seat 6: UvM6sxFT7el5hVDehvWvTA ($33.90 in chips) 
Seat 7: y7w8+Oqq4SkI1dkRDCx2Zg ($3.85 in chips) 
Seat 8: mUoFJKqCzIUABvOFbiINlQ ($15 in chips) 
Seat 9: MgzS9dEPzsGYQW57RteFhw ($7.40 in chips) 
tYsOBqdU1+x+yFI7zHO7hQ: posts small blind $0.10
cUxk0Jk4lrUQv9CJl0LPlg: posts big blind $0.25
*** HOLE CARDS ***
UvM6sxFT7el5hVDehvWvTA: folds 
y7w8+Oqq4SkI1dkRDCx2Zg: folds 
mUoFJKqCzIUABvOFbiINlQ: calls $0.25
MgzS9dEPzsGYQW57RteFhw: folds 
sD+TKtt36XiiN6jqHiLwDA: folds 
9lvO/qyU+xrU95Teu1fv0g: raises $1 to $1.25
arxNSjreDRGFg13EAM2F1w: folds 
tYsOBqdU1+x+yFI7zHO7hQ: folds 
cUxk0Jk4lrUQv9CJl0LPlg: folds 
mUoFJKqCzIUABvOFbiINlQ: folds 
Uncalled bet ($1) returned to 9lvO/qyU+xrU95Teu1fv0g
9lvO/qyU+xrU95Teu1fv0g collected $0.85 from pot
*** SUMMARY ***
Total pot $0.85 | Rake $0 
Seat 1: sD+TKtt36XiiN6jqHiLwDA folded before Flop (didn't bet)
Seat 2: 9lvO/qyU+xrU95Teu1fv0g collected ($0.85)
Seat 3: arxNSjreDRGFg13EAM2F1w (button) folded before Flop (didn't bet)
Seat 4: tYsOBqdU1+x+yFI7zHO7hQ (small blind) folded before Flop
Seat 5: cUxk0Jk4lrUQv9CJl0LPlg (big blind) folded before Flop
Seat 6: UvM6sxFT7el5hVDehvWvTA folded before Flop (didn't bet)
Seat 7: y7w8+Oqq4SkI1dkRDCx2Zg folded before Flop (didn't bet)
Seat 8: mUoFJKqCzIUABvOFbiINlQ folded before Flop
Seat 9: MgzS9dEPzsGYQW57RteFhw folded before Flop (didn't bet)




PokerStars Game #59941598222:  Hold'em No Limit ($0.10/$0.25) - 2009/07/01 1:40:18 ET
Table 'qInMnOOn7vKcj4bU7zju7g' 9-max Seat #2 is the button
Seat 1: CT7Xj/V/O5rBlhtt+RZeFQ ($25 in chips) 
Seat 2: HgIyqrvSG8TRRZl5mlzfHA ($70.80 in chips) 
Seat 3: zDrucyjVn5aeekNEc3cJrA ($26.15 in chips) 
Seat 4: ScCuCTbi71/EWsLKZXaZeg ($26.15 in chips) 
Seat 5: KlccfkOygm1GJZoSZYEgBw ($14.50 in chips) 
Seat 6: 4awUyiDYTgylQKXZ9faBVA ($25 in chips) 
Seat 7: DdPXdieucQ+n99u1n3A+rQ ($7.10 in chips) 
Seat 8: Mh2r9hTeTEDnh19sRZtW3g ($5.70 in chips) 
Seat 9: sbArFaUiGjfmf5dg1O4ffg ($5.70 in chips) 
zDrucyjVn5aeekNEc3cJrA: posts small blind $0.10
ScCuCTbi71/EWsLKZXaZeg: posts big blind $0.25
*** HOLE CARDS ***
KlccfkOygm1GJZoSZYEgBw: folds 
4awUyiDYTgylQKXZ9faBVA: folds 
DdPXdieucQ+n99u1n3A+rQ: folds 
Mh2r9hTeTEDnh19sRZtW3g: folds 
sbArFaUiGjfmf5dg1O4ffg: calls $0.25
CT7Xj/V/O5rBlhtt+RZeFQ: folds 
HgIyqrvSG8TRRZl5mlzfHA: calls $0.25
zDrucyjVn5aeekNEc3cJrA: folds 
ScCuCTbi71/EWsLKZXaZeg: raises $0.25 to $0.50
sbArFaUiGjfmf5dg1O4ffg: calls $0.25
HgIyqrvSG8TRRZl5mlzfHA: calls $0.25
*** FLOP *** [Jh 9h Kh]
ScCuCTbi71/EWsLKZXaZeg: bets $2
sbArFaUiGjfmf5dg1O4ffg: folds 
HgIyqrvSG8TRRZl5mlzfHA: calls $2
*** TURN *** [Jh 9h Kh] [4h]
ScCuCTbi71/EWsLKZXaZeg: checks 
HgIyqrvSG8TRRZl5mlzfHA: checks 
*** RIVER *** [Jh 9h Kh 4h] [Kd]
ScCuCTbi71/EWsLKZXaZeg: bets $3
HgIyqrvSG8TRRZl5mlzfHA: calls $3
*** SHOW DOWN ***
ScCuCTbi71/EWsLKZXaZeg: shows [Js 5h] (a flush, King high)
HgIyqrvSG8TRRZl5mlzfHA: shows [Ks 7h] (a flush, King high - Seven higher)
HgIyqrvSG8TRRZl5mlzfHA collected $11.05 from pot
*** SUMMARY ***
Total pot $11.60 | Rake $0.55 
Board [Jh 9h Kh 4h Kd]
Seat 1: CT7Xj/V/O5rBlhtt+RZeFQ folded before Flop (didn't bet)
Seat 2: HgIyqrvSG8TRRZl5mlzfHA (button) showed [Ks 7h] and won ($11.05) with a flush, King high
Seat 3: zDrucyjVn5aeekNEc3cJrA (small blind) folded before Flop
Seat 4: ScCuCTbi71/EWsLKZXaZeg (big blind) showed [Js 5h] and lost with a flush, King high
Seat 5: KlccfkOygm1GJZoSZYEgBw folded before Flop (didn't bet)
Seat 6: 4awUyiDYTgylQKXZ9faBVA folded before Flop (didn't bet)
Seat 7: DdPXdieucQ+n99u1n3A+rQ folded before Flop (didn't bet)
Seat 8: Mh2r9hTeTEDnh19sRZtW3g folded before Flop (didn't bet)
Seat 9: sbArFaUiGjfmf5dg1O4ffg folded on the Flop




PokerStars Game #59941597970:  Hold'em No Limit ($0.10/$0.25) - 2009/07/01 1:40:18 ET
Table 'SgI2Cobdjtkh0Fd0/eTTDg' 9-max Seat #8 is the button
Seat 1: NcPAt5YjVvDFEJTTgAVj8g ($2.65 in chips) 
Seat 2: uUc5QTI8+ZdC95UnznCsqg ($13.10 in chips) 
Seat 3: OiV1PWZ3IkN29JlmCcnTwQ ($4.90 in chips) 
Seat 4: s1y+qfkBnhgc67+X3ThjeA ($11 in chips) 
Seat 5: w/RUHfVzKTf7Bc19nucLpQ ($23.70 in chips) 
Seat 6: 6RiVTYll/5D8zICp0MRpKw ($25.90 in chips) 
Seat 7: lOuxRXNpa9V2VxLMNpxUOg ($23.60 in chips) 
Seat 8: 8GJHzzxiotOqC5gdtgpLoA ($9.65 in chips) 
Seat 9: cZ99hugmLBj9KhTlc8nCSw ($31.05 in chips) 
cZ99hugmLBj9KhTlc8nCSw: posts small blind $0.10
NcPAt5YjVvDFEJTTgAVj8g: posts big blind $0.25
*** HOLE CARDS ***
uUc5QTI8+ZdC95UnznCsqg: folds 
OiV1PWZ3IkN29JlmCcnTwQ: folds 
s1y+qfkBnhgc67+X3ThjeA: calls $0.25
w/RUHfVzKTf7Bc19nucLpQ: folds 
6RiVTYll/5D8zICp0MRpKw: folds 
lOuxRXNpa9V2VxLMNpxUOg: raises $0.50 to $0.75
8GJHzzxiotOqC5gdtgpLoA: folds 
cZ99hugmLBj9KhTlc8nCSw: folds 
NcPAt5YjVvDFEJTTgAVj8g: calls $0.50
s1y+qfkBnhgc67+X3ThjeA: calls $0.50
*** FLOP *** [8d 6s 3d]
NcPAt5YjVvDFEJTTgAVj8g: bets $1
s1y+qfkBnhgc67+X3ThjeA: folds 
lOuxRXNpa9V2VxLMNpxUOg: raises $1 to $2
NcPAt5YjVvDFEJTTgAVj8g: calls $0.90 and is all-in
Uncalled bet ($0.10) returned to lOuxRXNpa9V2VxLMNpxUOg
*** TURN *** [8d 6s 3d] [3c]
*** RIVER *** [8d 6s 3d 3c] [5d]
*** SHOW DOWN ***
NcPAt5YjVvDFEJTTgAVj8g: shows [Js 8s] (two pair, Eights and Threes)
lOuxRXNpa9V2VxLMNpxUOg: mucks hand 
NcPAt5YjVvDFEJTTgAVj8g collected $5.85 from pot
*** SUMMARY ***
Total pot $6.15 | Rake $0.30 
Board [8d 6s 3d 3c 5d]
Seat 1: NcPAt5YjVvDFEJTTgAVj8g (big blind) showed [Js 8s] and won ($5.85) with two pair, Eights and Threes
Seat 2: uUc5QTI8+ZdC95UnznCsqg folded before Flop (didn't bet)
Seat 3: OiV1PWZ3IkN29JlmCcnTwQ folded before Flop (didn't bet)
Seat 4: s1y+qfkBnhgc67+X3ThjeA folded on the Flop
Seat 5: w/RUHfVzKTf7Bc19nucLpQ folded before Flop (didn't bet)
Seat 6: 6RiVTYll/5D8zICp0MRpKw folded before Flop (didn't bet)
Seat 7: lOuxRXNpa9V2VxLMNpxUOg mucked
Seat 8: 8GJHzzxiotOqC5gdtgpLoA (button) folded before Flop (didn't bet)
Seat 9: cZ99hugmLBj9KhTlc8nCSw (small blind) folded before Flop




PokerStars Game #59941598690:  Hold'em No Limit ($0.10/$0.25) - 2009/07/01 1:40:19 ET
Table 'IdXp6nyeW4FYaEK4qKCnwQ' 9-max Seat #5 is the button
Seat 1: tLcDklc2rBORNfixyRfVfw ($25 in chips) 
Seat 2: HPEB+AtKw1+C/cxU0o1ciw ($32.50 in chips) 
Seat 3: eK8qa6EPcH2zhtbmWSvc9g ($33.05 in chips) 
Seat 4: j4q3p0lesp63b1gZDwLBZw ($5.35 in chips) 
Seat 5: U41wNf6XauAiBOQaKu2ZIA ($26.90 in chips) 
Seat 6: arxNSjreDRGFg13EAM2F1w ($25.95 in chips) 
Seat 7: w1ukf8uPa4+WH561TtVRxA ($37.35 in chips) 
Seat 8: dtZ84flFEi4Q+SGrHMJRDQ ($29.85 in chips) 
Seat 9: s2xLPOl/vhl/26apJ3vsOQ ($28.65 in chips) 
arxNSjreDRGFg13EAM2F1w: posts small blind $0.10
w1ukf8uPa4+WH561TtVRxA: posts big blind $0.25
*** HOLE CARDS ***
dtZ84flFEi4Q+SGrHMJRDQ: raises $0.75 to $1
s2xLPOl/vhl/26apJ3vsOQ: folds 
tLcDklc2rBORNfixyRfVfw: folds 
HPEB+AtKw1+C/cxU0o1ciw: folds 
eK8qa6EPcH2zhtbmWSvc9g: folds 
j4q3p0lesp63b1gZDwLBZw: folds 
U41wNf6XauAiBOQaKu2ZIA: calls $1
arxNSjreDRGFg13EAM2F1w: folds 
w1ukf8uPa4+WH561TtVRxA: folds 
*** FLOP *** [Jd 9h 5s]
dtZ84flFEi4Q+SGrHMJRDQ: bets $1
U41wNf6XauAiBOQaKu2ZIA: folds 
Uncalled bet ($1) returned to dtZ84flFEi4Q+SGrHMJRDQ
dtZ84flFEi4Q+SGrHMJRDQ collected $2.25 from pot
dtZ84flFEi4Q+SGrHMJRDQ: doesn't show hand 
*** SUMMARY ***
Total pot $2.35 | Rake $0.10 
Board [Jd 9h 5s]
Seat 1: tLcDklc2rBORNfixyRfVfw folded before Flop (didn't bet)
Seat 2: HPEB+AtKw1+C/cxU0o1ciw folded before Flop (didn't bet)
Seat 3: eK8qa6EPcH2zhtbmWSvc9g folded before Flop (didn't bet)
Seat 4: j4q3p0lesp63b1gZDwLBZw folded before Flop (didn't bet)
Seat 5: U41wNf6XauAiBOQaKu2ZIA (button) folded on the Flop
Seat 6: arxNSjreDRGFg13EAM2F1w (small blind) folded before Flop
Seat 7: w1ukf8uPa4+WH561TtVRxA (big blind) folded before Flop
Seat 8: dtZ84flFEi4Q+SGrHMJRDQ collected ($2.25)
Seat 9: s2xLPOl/vhl/26apJ3vsOQ folded before Flop (didn't bet)




PokerStars Game #59941598658:  Hold'em No Limit ($0.10/$0.25) - 2009/07/01 1:40:19 ET
Table 'vud0GB/ZlDCvUFhBFIaTlg' 9-max Seat #8 is the button
Seat 1: DiSvPC2iudwL5j9u6Huyww ($28.85 in chips) 
Seat 2: tLcDklc2rBORNfixyRfVfw ($25 in chips) 
Seat 3: W2YYHvqjaEpRrO7stZkClQ ($4.65 in chips) 
Seat 4: dWgEDExmVO0d+rRmUYCU5w ($15.95 in chips) 
Seat 5: eK8qa6EPcH2zhtbmWSvc9g ($25 in chips) 
Seat 6: gehe91e0IyVT0QU/XBkEyg ($24.90 in chips) 
Seat 7: iG7VeTyBWf6wYNvZpbTcbw ($16.75 in chips) 
Seat 8: Am29qRe4OYkVWs70NjNDBw ($16.10 in chips) 
Seat 9: PdIasPkzm2sqZnN41ZRXOg ($5.10 in chips) 
PdIasPkzm2sqZnN41ZRXOg: posts small blind $0.10
DiSvPC2iudwL5j9u6Huyww: posts big blind $0.25
*** HOLE CARDS ***
tLcDklc2rBORNfixyRfVfw: folds 
W2YYHvqjaEpRrO7stZkClQ: folds 
dWgEDExmVO0d+rRmUYCU5w: folds 
eK8qa6EPcH2zhtbmWSvc9g: folds 
gehe91e0IyVT0QU/XBkEyg: folds 
iG7VeTyBWf6wYNvZpbTcbw: raises $0.75 to $1
Am29qRe4OYkVWs70NjNDBw: folds 
PdIasPkzm2sqZnN41ZRXOg: folds 
DiSvPC2iudwL5j9u6Huyww: folds 
Uncalled bet ($0.75) returned to iG7VeTyBWf6wYNvZpbTcbw
iG7VeTyBWf6wYNvZpbTcbw collected $0.60 from pot
*** SUMMARY ***
Total pot $0.60 | Rake $0 
Seat 1: DiSvPC2iudwL5j9u6Huyww (big blind) folded before Flop
Seat 2: tLcDklc2rBORNfixyRfVfw folded before Flop (didn't bet)
Seat 3: W2YYHvqjaEpRrO7stZkClQ folded before Flop (didn't bet)
Seat 4: dWgEDExmVO0d+rRmUYCU5w folded before Flop (didn't bet)
Seat 5: eK8qa6EPcH2zhtbmWSvc9g folded before Flop (didn't bet)
Seat 6: gehe91e0IyVT0QU/XBkEyg folded before Flop (didn't bet)
Seat 7: iG7VeTyBWf6wYNvZpbTcbw collected ($0.60)
Seat 8: Am29qRe4OYkVWs70NjNDBw (button) folded before Flop (didn't bet)
Seat 9: PdIasPkzm2sqZnN41ZRXOg (small blind) folded before Flop




PokerStars Game #59941598896:  Hold'em No Limit ($0.10/$0.25) - 2009/07/01 1:40:19 ET
Table '0XPo7K54oZIfG0xlNAcDRwnQC9LRg01NEuKFHF1nrDEw-max Seat #2 is the button
Seat 1: qf+LMbROj8/qY878wkFHbQ ($10.90 in chips) 
Seat 2: lYjWCpfCxX2kgcHY3v4Yow ($31.10 in chips) 
Seat 3: 6+g0Lb6vfRDZkElV8ieHyQ ($19.75 in chips) 
Seat 5: kG34n23qFQA3nzdOJTQ1dA ($29.40 in chips) 
Seat 6: xQVFeVUDopz+akuEo2wXpQ ($58.30 in chips) 
6+g0Lb6vfRDZkElV8ieHyQ: posts small blind $0.10
kG34n23qFQA3nzdOJTQ1dA: posts big blind $0.25
*** HOLE CARDS ***
xQVFeVUDopz+akuEo2wXpQ: folds 
qf+LMbROj8/qY878wkFHbQ: raises $0.25 to $0.50
lYjWCpfCxX2kgcHY3v4Yow: calls $0.50
6+g0Lb6vfRDZkElV8ieHyQ: folds 
kG34n23qFQA3nzdOJTQ1dA: folds 
*** FLOP *** [Jh Ad 7h]
qf+LMbROj8/qY878wkFHbQ: bets $0.75
lYjWCpfCxX2kgcHY3v4Yow: raises $1.75 to $2.50
qf+LMbROj8/qY878wkFHbQ: raises $7.90 to $10.40 and is all-in
lYjWCpfCxX2kgcHY3v4Yow: calls $7.90
*** TURN *** [Jh Ad 7h] [6s]
*** RIVER *** [Jh Ad 7h 6s] [As]
*** SHOW DOWN ***
qf+LMbROj8/qY878wkFHbQ: shows [Ah 9d] (three of a kind, Aces)
lYjWCpfCxX2kgcHY3v4Yow: shows [Ac Qs] (three of a kind, Aces - Queen kicker)
lYjWCpfCxX2kgcHY3v4Yow collected $21.05 from pot
*** SUMMARY ***
Total pot $22.15 | Rake $1.10 
Board [Jh Ad 7h 6s As]
Seat 1: qf+LMbROj8/qY878wkFHbQ showed [Ah 9d] and lost with three of a kind, Aces
Seat 2: lYjWCpfCxX2kgcHY3v4Yow (button) showed [Ac Qs] and won ($21.05) with three of a kind, Aces
Seat 3: 6+g0Lb6vfRDZkElV8ieHyQ (small blind) folded before Flop
Seat 5: kG34n23qFQA3nzdOJTQ1dA (big blind) folded before Flop
Seat 6: xQVFeVUDopz+akuEo2wXpQ folded before Flop (didn't bet)




PokerStars Game #59941598920:  Hold'em No Limit ($0.10/$0.25) - 2009/07/01 1:40:19 ET
Table '2VkNDXXsBj4bSZw/uK5atw' 6-max Seat #6 is the button
Seat 1: xrf8tAXKQHG99HixCot1Iw ($18.60 in chips) 
Seat 3: 8D0jr3B4e++Q/cTSnpHdzg ($37.30 in chips) 
Seat 5: 7f0OkhFEOf3T+rVOFHRLnw ($23.15 in chips) 
Seat 6: n6UPMnVR4v8LFP0rWP73Fg ($10.40 in chips) 
xrf8tAXKQHG99HixCot1Iw: posts small blind $0.10
8D0jr3B4e++Q/cTSnpHdzg: posts big blind $0.25
*** HOLE CARDS ***
7f0OkhFEOf3T+rVOFHRLnw: folds 
n6UPMnVR4v8LFP0rWP73Fg: folds 
xrf8tAXKQHG99HixCot1Iw: folds 
Uncalled bet ($0.15) returned to 8D0jr3B4e++Q/cTSnpHdzg
8D0jr3B4e++Q/cTSnpHdzg collected $0.20 from pot
*** SUMMARY ***
Total pot $0.20 | Rake $0 
Seat 1: xrf8tAXKQHG99HixCot1Iw (small blind) folded before Flop
Seat 3: 8D0jr3B4e++Q/cTSnpHdzg (big blind) collected ($0.20)
Seat 5: 7f0OkhFEOf3T+rVOFHRLnw folded before Flop (didn't bet)
Seat 6: n6UPMnVR4v8LFP0rWP73Fg (button) folded before Flop (didn't bet)




PokerStars Game #59941598666:  Hold'em No Limit ($0.10/$0.25) - 2009/07/01 1:40:19 ET
Table 'GxdLtCpYxqT4aAbYqkEEpw' 6-max Seat #2 is the button
Seat 1: 2d/PU00mMdO9azAaXqcSbw ($14.25 in chips) 
Seat 2: 3iomNWHjIokoWh6JNWCUJQ ($3.65 in chips) 
Seat 3: LpmZGzLpOmfZUF7EV4ZlrQ ($15.80 in chips) 
Seat 4: 6wzJiRvp8HY6t+MQGnSIzA ($5.70 in chips) 
Seat 5: q6WfTUAD9mowIP63ASq2Dg ($35.10 in chips) 
Seat 6: DFi/Lzkjsfv8QswS80JX9Q ($25 in chips) 
LpmZGzLpOmfZUF7EV4ZlrQ: posts small blind $0.10
6wzJiRvp8HY6t+MQGnSIzA: posts big blind $0.25
*** HOLE CARDS ***
q6WfTUAD9mowIP63ASq2Dg: folds 
DFi/Lzkjsfv8QswS80JX9Q: folds 
2d/PU00mMdO9azAaXqcSbw: folds 
3iomNWHjIokoWh6JNWCUJQ: folds 
LpmZGzLpOmfZUF7EV4ZlrQ: calls $0.15
6wzJiRvp8HY6t+MQGnSIzA: raises $0.50 to $0.75
LpmZGzLpOmfZUF7EV4ZlrQ: calls $0.50
*** FLOP *** [Qd 3s 4d]
LpmZGzLpOmfZUF7EV4ZlrQ: bets $0.75
6wzJiRvp8HY6t+MQGnSIzA: folds 
Uncalled bet ($0.75) returned to LpmZGzLpOmfZUF7EV4ZlrQ
LpmZGzLpOmfZUF7EV4ZlrQ collected $1.45 from pot
*** SUMMARY ***
Total pot $1.50 | Rake $0.05 
Board [Qd 3s 4d]
Seat 1: 2d/PU00mMdO9azAaXqcSbw folded before Flop (didn't bet)
Seat 2: 3iomNWHjIokoWh6JNWCUJQ (button) folded before Flop (didn't bet)
Seat 3: LpmZGzLpOmfZUF7EV4ZlrQ (small blind) collected ($1.45)
Seat 4: 6wzJiRvp8HY6t+MQGnSIzA (big blind) folded on the Flop
Seat 5: q6WfTUAD9mowIP63ASq2Dg folded before Flop (didn't bet)
Seat 6: DFi/Lzkjsfv8QswS80JX9Q folded before Flop (didn't bet)




PokerStars Game #59941598836:  Hold'em No Limit ($0.10/$0.25) - 2009/07/01 1:40:19 ET
Table 'ZEXL6Wh4qA4Afx8NnoBBAA' 6-max Seat #6 is the button
Seat 1: v8m8XHovI5tqEA9mvplDSw ($27.85 in chips) 
Seat 2: 6DwBRH+xZ12AAZmeAg+aXw ($33.05 in chips) 
Seat 3: +ZlnqPoP3Hg4BIUxDfKd/A ($31.75 in chips) 
Seat 4: FpN4KbLjlyRRKiVaQcoLqA ($31.55 in chips) 
Seat 5: if4dh6jhJXeN3/qd3qCp9g ($27 in chips) 
Seat 6: Lh8SlCq3OSDKWLUgAI/Lxw ($1.30 in chips) 
v8m8XHovI5tqEA9mvplDSw: posts small blind $0.10
6DwBRH+xZ12AAZmeAg+aXw: posts big blind $0.25
*** HOLE CARDS ***
+ZlnqPoP3Hg4BIUxDfKd/A: folds 
FpN4KbLjlyRRKiVaQcoLqA: calls $0.25
if4dh6jhJXeN3/qd3qCp9g: folds 
Lh8SlCq3OSDKWLUgAI/Lxw: calls $0.25
v8m8XHovI5tqEA9mvplDSw: calls $0.15
6DwBRH+xZ12AAZmeAg+aXw: checks 
*** FLOP *** [5c 6d 6h]
v8m8XHovI5tqEA9mvplDSw: checks 
6DwBRH+xZ12AAZmeAg+aXw: checks 
FpN4KbLjlyRRKiVaQcoLqA: checks 
Lh8SlCq3OSDKWLUgAI/Lxw: checks 
*** TURN *** [5c 6d 6h] [8s]
v8m8XHovI5tqEA9mvplDSw: checks 
6DwBRH+xZ12AAZmeAg+aXw: bets $0.50
FpN4KbLjlyRRKiVaQcoLqA: calls $0.50
Lh8SlCq3OSDKWLUgAI/Lxw: folds 
v8m8XHovI5tqEA9mvplDSw: folds 
*** RIVER *** [5c 6d 6h 8s] [5d]
6DwBRH+xZ12AAZmeAg+aXw: checks 
FpN4KbLjlyRRKiVaQcoLqA: bets $0.75
6DwBRH+xZ12AAZmeAg+aXw: raises $9.75 to $10.50
FpN4KbLjlyRRKiVaQcoLqA: folds 
Uncalled bet ($9.75) returned to 6DwBRH+xZ12AAZmeAg+aXw
6DwBRH+xZ12AAZmeAg+aXw collected $3.35 from pot
6DwBRH+xZ12AAZmeAg+aXw: doesn't show hand 
*** SUMMARY ***
Total pot $3.50 | Rake $0.15 
Board [5c 6d 6h 8s 5d]
Seat 1: v8m8XHovI5tqEA9mvplDSw (small blind) folded on the Turn
Seat 2: 6DwBRH+xZ12AAZmeAg+aXw (big blind) collected ($3.35)
Seat 3: +ZlnqPoP3Hg4BIUxDfKd/A folded before Flop (didn't bet)
Seat 4: FpN4KbLjlyRRKiVaQcoLqA folded on the River
Seat 5: if4dh6jhJXeN3/qd3qCp9g folded before Flop (didn't bet)
Seat 6: Lh8SlCq3OSDKWLUgAI/Lxw (button) folded on the Turn




PokerStars Game #59941599174:  Hold'em No Limit ($0.10/$0.25) - 2009/07/01 1:40:20 ET
Table 'Loy/olZ5qoDOSvX4UTujGg' 6-max Seat #6 is the button
Seat 1: HipgaJhkN4ie/tTw4dK3Ug ($12.40 in chips) 
Seat 2: 4z7mPbMLNp4TezHXin63Vw ($18.15 in chips) 
Seat 3: 32YL2ZEp8NT4JB2RVM9euQ ($15.70 in chips) 
Seat 4: /gJNBeCkWL4o85/jvlZ4BA ($29.65 in chips) 
Seat 5: tSR4329m40dZsN7YOpI9Kw ($29.45 in chips) 
Seat 6: qGHGf/553gQnDoklMRe3tg ($23.55 in chips) 
HipgaJhkN4ie/tTw4dK3Ug: posts small blind $0.10
4z7mPbMLNp4TezHXin63Vw: posts big blind $0.25
*** HOLE CARDS ***
32YL2ZEp8NT4JB2RVM9euQ: folds 
/gJNBeCkWL4o85/jvlZ4BA: folds 
tSR4329m40dZsN7YOpI9Kw: raises $0.50 to $0.75
qGHGf/553gQnDoklMRe3tg: calls $0.75
HipgaJhkN4ie/tTw4dK3Ug: folds 
4z7mPbMLNp4TezHXin63Vw: folds 
*** FLOP *** [Qh Ad 4d]
tSR4329m40dZsN7YOpI9Kw: checks 
qGHGf/553gQnDoklMRe3tg: bets $1.50
tSR4329m40dZsN7YOpI9Kw: folds 
Uncalled bet ($1.50) returned to qGHGf/553gQnDoklMRe3tg
qGHGf/553gQnDoklMRe3tg collected $1.80 from pot
qGHGf/553gQnDoklMRe3tg: doesn't show hand 
*** SUMMARY ***
Total pot $1.85 | Rake $0.05 
Board [Qh Ad 4d]
Seat 1: HipgaJhkN4ie/tTw4dK3Ug (small blind) folded before Flop
Seat 2: 4z7mPbMLNp4TezHXin63Vw (big blind) folded before Flop
Seat 3: 32YL2ZEp8NT4JB2RVM9euQ folded before Flop (didn't bet)
Seat 4: /gJNBeCkWL4o85/jvlZ4BA folded before Flop (didn't bet)
Seat 5: tSR4329m40dZsN7YOpI9Kw folded on the Flop
Seat 6: qGHGf/553gQnDoklMRe3tg (button) collected ($1.80)




PokerStars Game #59941599170:  Hold'em No Limit ($0.10/$0.25) - 2009/07/01 1:40:20 ET
Table 'ukli1Y7ieC5JQMTEFxM2Nw' 6-max Seat #6 is the button
Seat 1: N162H80ZIQevUf2EzGahCA ($9.70 in chips) 
Seat 2: u/yN5P9f3KlATg6WLWNkBQ ($43.40 in chips) 
Seat 3: ExeoJ1G/rSmWa3tRz7TlCA ($21.45 in chips) 
Seat 4: if4dh6jhJXeN3/qd3qCp9g ($29.85 in chips) 
Seat 5: Se+H4Z4PDr6+eIUDJX1rpg ($15.95 in chips) 
Seat 6: 32YL2ZEp8NT4JB2RVM9euQ ($29.55 in chips) 
N162H80ZIQevUf2EzGahCA: posts small blind $0.10
u/yN5P9f3KlATg6WLWNkBQ: posts big blind $0.25
*** HOLE CARDS ***
ExeoJ1G/rSmWa3tRz7TlCA: folds 
if4dh6jhJXeN3/qd3qCp9g: folds 
Se+H4Z4PDr6+eIUDJX1rpg: folds 
32YL2ZEp8NT4JB2RVM9euQ: folds 
N162H80ZIQevUf2EzGahCA: calls $0.15
u/yN5P9f3KlATg6WLWNkBQ: checks 
*** FLOP *** [5c 9h Qc]
N162H80ZIQevUf2EzGahCA: checks 
u/yN5P9f3KlATg6WLWNkBQ: bets $0.50
N162H80ZIQevUf2EzGahCA: folds 
Uncalled bet ($0.50) returned to u/yN5P9f3KlATg6WLWNkBQ
u/yN5P9f3KlATg6WLWNkBQ collected $0.50 from pot
u/yN5P9f3KlATg6WLWNkBQ: doesn't show hand 
*** SUMMARY ***
Total pot $0.50 | Rake $0 
Board [5c 9h Qc]
Seat 1: N162H80ZIQevUf2EzGahCA (small blind) folded on the Flop
Seat 2: u/yN5P9f3KlATg6WLWNkBQ (big blind) collected ($0.50)
Seat 3: ExeoJ1G/rSmWa3tRz7TlCA folded before Flop (didn't bet)
Seat 4: if4dh6jhJXeN3/qd3qCp9g folded before Flop (didn't bet)
Seat 5: Se+H4Z4PDr6+eIUDJX1rpg folded before Flop (didn't bet)
Seat 6: 32YL2ZEp8NT4JB2RVM9euQ (button) folded before Flop (didn't bet)




PokerStars Game #59941599104:  Hold'em No Limit ($0.10/$0.25) - 2009/07/01 1:40:20 ET
Table 'qryc9C/ELyQ3lubOaELNAQ' 6-max Seat #6 is the button
Seat 1: OZc6kkoTwtITj1ZfreJK1A ($65.80 in chips) 
Seat 2: LtASJ9OlkqGrrUKGQlpGAw ($30.65 in chips) 
Seat 3: 2Ga+TibtZsUCp1MLaueYVA ($25.55 in chips) 
Seat 4: v+QfkGiuj9bgtuNoVnDO8w ($25.40 in chips) 
Seat 5: 9StOHp+Y1T0K13JdgS2oQQ ($32.50 in chips) 
Seat 6: u+J1MTXS2qhNVMbsBemNLg ($4.05 in chips) 
OZc6kkoTwtITj1ZfreJK1A: posts small blind $0.10
LtASJ9OlkqGrrUKGQlpGAw: posts big blind $0.25
*** HOLE CARDS ***
2Ga+TibtZsUCp1MLaueYVA: folds 
v+QfkGiuj9bgtuNoVnDO8w: folds 
9StOHp+Y1T0K13JdgS2oQQ: folds 
u+J1MTXS2qhNVMbsBemNLg: folds 
OZc6kkoTwtITj1ZfreJK1A: calls $0.15
LtASJ9OlkqGrrUKGQlpGAw: checks 
*** FLOP *** [Ac Th Qs]
OZc6kkoTwtITj1ZfreJK1A: folds 
LtASJ9OlkqGrrUKGQlpGAw collected $0.50 from pot
LtASJ9OlkqGrrUKGQlpGAw: doesn't show hand 
*** SUMMARY ***
Total pot $0.50 | Rake $0 
Board [Ac Th Qs]
Seat 1: OZc6kkoTwtITj1ZfreJK1A (small blind) folded on the Flop
Seat 2: LtASJ9OlkqGrrUKGQlpGAw (big blind) collected ($0.50)
Seat 3: 2Ga+TibtZsUCp1MLaueYVA folded before Flop (didn't bet)
Seat 4: v+QfkGiuj9bgtuNoVnDO8w folded before Flop (didn't bet)
Seat 5: 9StOHp+Y1T0K13JdgS2oQQ folded before Flop (didn't bet)
Seat 6: u+J1MTXS2qhNVMbsBemNLg (button) folded before Flop (didn't bet)




PokerStars Game #59941599502:  Hold'em No Limit ($0.10/$0.25) - 2009/07/01 1:40:20 ET
Table 'vZfV/Uj0q8joA1du9sRJSg' 6-max Seat #1 is the button
Seat 1: Hsvkc0/G2VV78oVmWYXecw ($5 in chips) 
Seat 2: wMiE3yTbDJGOLOF9th7KPA ($14.35 in chips) 
Seat 3: cWc85bEzdRzpUMhRKm8pwQ ($25.25 in chips) 
Seat 4: v+QfkGiuj9bgtuNoVnDO8w ($40.50 in chips) 
Seat 5: kyRaCIljYA6l33lSKQfNsg ($24.95 in chips) 
Seat 6: 8ClCHtFXGNplITm+63KB+Q ($48.15 in chips) 
wMiE3yTbDJGOLOF9th7KPA: posts small blind $0.10
cWc85bEzdRzpUMhRKm8pwQ: posts big blind $0.25
*** HOLE CARDS ***
v+QfkGiuj9bgtuNoVnDO8w: folds 
kyRaCIljYA6l33lSKQfNsg: folds 
8ClCHtFXGNplITm+63KB+Q: folds 
Hsvkc0/G2VV78oVmWYXecw: raises $0.50 to $0.75
wMiE3yTbDJGOLOF9th7KPA: calls $0.65
cWc85bEzdRzpUMhRKm8pwQ: folds 
*** FLOP *** [Qh 5c Kh]
wMiE3yTbDJGOLOF9th7KPA: bets $0.25
Hsvkc0/G2VV78oVmWYXecw: calls $0.25
*** TURN *** [Qh 5c Kh] [2c]
wMiE3yTbDJGOLOF9th7KPA: bets $0.25
Hsvkc0/G2VV78oVmWYXecw: calls $0.25
*** RIVER *** [Qh 5c Kh 2c] [Jh]
wMiE3yTbDJGOLOF9th7KPA: checks 
Hsvkc0/G2VV78oVmWYXecw: checks 
*** SHOW DOWN ***
wMiE3yTbDJGOLOF9th7KPA: shows [5s 3s] (a pair of Fives)
Hsvkc0/G2VV78oVmWYXecw: shows [Qd Tc] (a pair of Queens)
Hsvkc0/G2VV78oVmWYXecw collected $2.65 from pot
*** SUMMARY ***
Total pot $2.75 | Rake $0.10 
Board [Qh 5c Kh 2c Jh]
Seat 1: Hsvkc0/G2VV78oVmWYXecw (button) showed [Qd Tc] and won ($2.65) with a pair of Queens
Seat 2: wMiE3yTbDJGOLOF9th7KPA (small blind) showed [5s 3s] and lost with a pair of Fives
Seat 3: cWc85bEzdRzpUMhRKm8pwQ (big blind) folded before Flop
Seat 4: v+QfkGiuj9bgtuNoVnDO8w folded before Flop (didn't bet)
Seat 5: kyRaCIljYA6l33lSKQfNsg folded before Flop (didn't bet)
Seat 6: 8ClCHtFXGNplITm+63KB+Q folded before Flop (didn't bet)




PokerStars Game #59941599620:  Hold'em No Limit ($0.10/$0.25) - 2009/07/01 1:40:20 ET
Table 'ohAuixfiLOYDylNUG5mNUw' 9-max Seat #6 is the button
Seat 1: W6tExOcYX7qiy6Qdp+ZwFA ($10 in chips) 
Seat 2: Th3FldXKQW6hWVVPahaoOQ ($27.15 in chips) 
Seat 3: gSakoFAgDDzXSb2eNBWKcg ($14.65 in chips) 
Seat 4: AiXn/9o1EwOPZUHujnh/bA ($18.65 in chips) 
Seat 5: wub1jsnHlpWmOX4uczVADA ($7.40 in chips) 
Seat 6: MtVtHDqIJTyUcXkRBBDIVA ($25 in chips) 
Seat 7: +qc/EYCgLC65SpGvr35eNg ($24.75 in chips) 
Seat 8: ppMlNkhYgErlt4fuJO7ADA ($2.85 in chips) 
Seat 9: CT7Xj/V/O5rBlhtt+RZeFQ ($25 in chips) 
+qc/EYCgLC65SpGvr35eNg: posts small blind $0.10
ppMlNkhYgErlt4fuJO7ADA: posts big blind $0.25
*** HOLE CARDS ***
CT7Xj/V/O5rBlhtt+RZeFQ: calls $0.25
W6tExOcYX7qiy6Qdp+ZwFA: folds 
Th3FldXKQW6hWVVPahaoOQ: folds 
gSakoFAgDDzXSb2eNBWKcg: folds 
AiXn/9o1EwOPZUHujnh/bA has timed out while being disconnected
AiXn/9o1EwOPZUHujnh/bA: folds 
AiXn/9o1EwOPZUHujnh/bA is sitting out
wub1jsnHlpWmOX4uczVADA: folds 
AiXn/9o1EwOPZUHujnh/bA is disconnected 
MtVtHDqIJTyUcXkRBBDIVA: folds 
AiXn/9o1EwOPZUHujnh/bA is connected 
+qc/EYCgLC65SpGvr35eNg: folds 
AiXn/9o1EwOPZUHujnh/bA has returned
ppMlNkhYgErlt4fuJO7ADA: checks 
*** FLOP *** [9c 2s Ac]
ppMlNkhYgErlt4fuJO7ADA: checks 
CT7Xj/V/O5rBlhtt+RZeFQ: checks 
*** TURN *** [9c 2s Ac] [Ks]
ppMlNkhYgErlt4fuJO7ADA: checks 
CT7Xj/V/O5rBlhtt+RZeFQ: checks 
*** RIVER *** [9c 2s Ac Ks] [As]
ppMlNkhYgErlt4fuJO7ADA: checks 
CT7Xj/V/O5rBlhtt+RZeFQ: checks 
*** SHOW DOWN ***
ppMlNkhYgErlt4fuJO7ADA: shows [Th 5c] (a pair of Aces)
CT7Xj/V/O5rBlhtt+RZeFQ: shows [3c 3s] (two pair, Aces and Threes)
CT7Xj/V/O5rBlhtt+RZeFQ collected $0.60 from pot
*** SUMMARY ***
Total pot $0.60 | Rake $0 
Board [9c 2s Ac Ks As]
Seat 1: W6tExOcYX7qiy6Qdp+ZwFA folded before Flop (didn't bet)
Seat 2: Th3FldXKQW6hWVVPahaoOQ folded before Flop (didn't bet)
Seat 3: gSakoFAgDDzXSb2eNBWKcg folded before Flop (didn't bet)
Seat 4: AiXn/9o1EwOPZUHujnh/bA folded before Flop (didn't bet)
Seat 5: wub1jsnHlpWmOX4uczVADA folded before Flop (didn't bet)
Seat 6: MtVtHDqIJTyUcXkRBBDIVA (button) folded before Flop (didn't bet)
Seat 7: +qc/EYCgLC65SpGvr35eNg (small blind) folded before Flop
Seat 8: ppMlNkhYgErlt4fuJO7ADA (big blind) showed [Th 5c] and lost with a pair of Aces
Seat 9: CT7Xj/V/O5rBlhtt+RZeFQ showed [3c 3s] and won ($0.60) with two pair, Aces and Threes




PokerStars Game #59941599224:  Hold'em No Limit ($0.10/$0.25) - 2009/07/01 1:40:20 ET
Table 'K/f0NNaoGuhSz5DrzgVw7Q' 9-max Seat #1 is the button
Seat 1: sD+TKtt36XiiN6jqHiLwDA ($25.05 in chips) 
Seat 2: N7idMbhmEVNGZavVF2tgKg ($26.15 in chips) 
Seat 3: z5GxcHlYz/GSz6W2uFiTtg ($24.60 in chips) 
Seat 4: 9bCz0uv2nUmznwuI0OjVGw ($17.85 in chips) 
Seat 5: DnDcAdn9P0zGovMERigpFA ($37.80 in chips) 
Seat 6: 3PVK0IdMlq2fElkVzzr4bg ($2.60 in chips) 
Seat 7: egvg3mTBBVzMHnJPIQiKcA ($14.65 in chips) 
Seat 8: RCqMONFrSPSArZh2Jsar/w ($19.65 in chips) 
Seat 9: tLcDklc2rBORNfixyRfVfw ($25 in chips) 
N7idMbhmEVNGZavVF2tgKg: posts small blind $0.10
z5GxcHlYz/GSz6W2uFiTtg: posts big blind $0.25
*** HOLE CARDS ***
9bCz0uv2nUmznwuI0OjVGw: calls $0.25
DnDcAdn9P0zGovMERigpFA: folds 
3PVK0IdMlq2fElkVzzr4bg: folds 
egvg3mTBBVzMHnJPIQiKcA: folds 
RCqMONFrSPSArZh2Jsar/w: folds 
tLcDklc2rBORNfixyRfVfw: folds 
sD+TKtt36XiiN6jqHiLwDA has timed out
sD+TKtt36XiiN6jqHiLwDA: folds 
sD+TKtt36XiiN6jqHiLwDA is sitting out
N7idMbhmEVNGZavVF2tgKg: calls $0.15
sD+TKtt36XiiN6jqHiLwDA has returned
z5GxcHlYz/GSz6W2uFiTtg: checks 
*** FLOP *** [9h 3h Qh]
N7idMbhmEVNGZavVF2tgKg: bets $0.50
z5GxcHlYz/GSz6W2uFiTtg: folds 
9bCz0uv2nUmznwuI0OjVGw: folds 
Uncalled bet ($0.50) returned to N7idMbhmEVNGZavVF2tgKg
N7idMbhmEVNGZavVF2tgKg collected $0.75 from pot
N7idMbhmEVNGZavVF2tgKg: doesn't show hand 
*** SUMMARY ***
Total pot $0.75 | Rake $0 
Board [9h 3h Qh]
Seat 1: sD+TKtt36XiiN6jqHiLwDA (button) folded before Flop (didn't bet)
Seat 2: N7idMbhmEVNGZavVF2tgKg (small blind) collected ($0.75)
Seat 3: z5GxcHlYz/GSz6W2uFiTtg (big blind) folded on the Flop
Seat 4: 9bCz0uv2nUmznwuI0OjVGw folded on the Flop
Seat 5: DnDcAdn9P0zGovMERigpFA folded before Flop (didn't bet)
Seat 6: 3PVK0IdMlq2fElkVzzr4bg folded before Flop (didn't bet)
Seat 7: egvg3mTBBVzMHnJPIQiKcA folded before Flop (didn't bet)
Seat 8: RCqMONFrSPSArZh2Jsar/w folded before Flop (didn't bet)
Seat 9: tLcDklc2rBORNfixyRfVfw folded before Flop (didn't bet)




PokerStars Game #59941599750:  Hold'em No Limit ($0.10/$0.25) - 2009/07/01 1:40:21 ET
Table '1zj0+miaIL9cvwnT/50pOA' 9-max Seat #7 is the button
Seat 1: PVxvfRTRvkgZf9WtquEkwQ ($25.70 in chips) 
Seat 2: HPEB+AtKw1+C/cxU0o1ciw ($43.30 in chips) 
Seat 3: dtZ84flFEi4Q+SGrHMJRDQ ($28.60 in chips) 
Seat 4: PdIasPkzm2sqZnN41ZRXOg ($5 in chips) 
Seat 5: 57qrNGHDvf6GhB8zVLsAtQ ($4.35 in chips) 
Seat 6: YZaC69gFrepA6oCGtu7E0w ($30.70 in chips) 
Seat 7: 6RiVTYll/5D8zICp0MRpKw ($24.65 in chips) 
Seat 8: Ihhh49x48fayPIyvl2Rsmg ($28.40 in chips) 
Seat 9: AyqFvLFzJDE7yMbXP362BA ($31.25 in chips) 
Ihhh49x48fayPIyvl2Rsmg: posts small blind $0.10
AyqFvLFzJDE7yMbXP362BA: posts big blind $0.25
*** HOLE CARDS ***
PVxvfRTRvkgZf9WtquEkwQ: folds 
HPEB+AtKw1+C/cxU0o1ciw: folds 
dtZ84flFEi4Q+SGrHMJRDQ: folds 
PdIasPkzm2sqZnN41ZRXOg: folds 
57qrNGHDvf6GhB8zVLsAtQ: folds 
YZaC69gFrepA6oCGtu7E0w: folds 
6RiVTYll/5D8zICp0MRpKw: raises $0.50 to $0.75
Ihhh49x48fayPIyvl2Rsmg: folds 
AyqFvLFzJDE7yMbXP362BA: calls $0.50
*** FLOP *** [6s 8c 2c]
AyqFvLFzJDE7yMbXP362BA: bets $1.25
6RiVTYll/5D8zICp0MRpKw: folds 
Uncalled bet ($1.25) returned to AyqFvLFzJDE7yMbXP362BA
AyqFvLFzJDE7yMbXP362BA collected $1.55 from pot
*** SUMMARY ***
Total pot $1.60 | Rake $0.05 
Board [6s 8c 2c]
Seat 1: PVxvfRTRvkgZf9WtquEkwQ folded before Flop (didn't bet)
Seat 2: HPEB+AtKw1+C/cxU0o1ciw folded before Flop (didn't bet)
Seat 3: dtZ84flFEi4Q+SGrHMJRDQ folded before Flop (didn't bet)
Seat 4: PdIasPkzm2sqZnN41ZRXOg folded before Flop (didn't bet)
Seat 5: 57qrNGHDvf6GhB8zVLsAtQ folded before Flop (didn't bet)
Seat 6: YZaC69gFrepA6oCGtu7E0w folded before Flop (didn't bet)
Seat 7: 6RiVTYll/5D8zICp0MRpKw (button) folded on the Flop
Seat 8: Ihhh49x48fayPIyvl2Rsmg (small blind) folded before Flop
Seat 9: AyqFvLFzJDE7yMbXP362BA (big blind) collected ($1.55)




PokerStars Game #59941600142:  Hold'em No Limit ($0.10/$0.25) - 2009/07/01 1:40:21 ET
Table 'v+LTGPWbrLum+Ggd4ef6lg' 9-max Seat #3 is the button
Seat 1: zUXhymECc2C9W9ZNw6qppA ($9.65 in chips) 
Seat 2: r/xYbgD9yVdKFWRgSQD/+Q ($20.70 in chips) 
Seat 3: 7ovWM9c1nQLTFritEGRG/A ($2.90 in chips) 
Seat 4: bXpVeaSTPBFSPJmeXxO7nw ($4.75 in chips) 
Seat 5: +8OkYWUhGfkDbAtQl/ovYQ ($34.90 in chips) 
Seat 6: T+MjFnaPZsOyKbE9LYG2Qg ($14.25 in chips) 
Seat 7: kUxTO3D2eQcx4oJIpJAK4Q ($8.95 in chips) 
Seat 8: +sbyWwIcFp9kP0bDtMegfQ ($32.60 in chips) 
bXpVeaSTPBFSPJmeXxO7nw: posts small blind $0.10
7ovWM9c1nQLTFritEGRG/A said, "its jokerstars"
+8OkYWUhGfkDbAtQl/ovYQ: posts big blind $0.25
cZ99hugmLBj9KhTlc8nCSw: sits out 
*** HOLE CARDS ***
T+MjFnaPZsOyKbE9LYG2Qg: folds 
kUxTO3D2eQcx4oJIpJAK4Q: folds 
+sbyWwIcFp9kP0bDtMegfQ: folds 
zUXhymECc2C9W9ZNw6qppA: folds 
r/xYbgD9yVdKFWRgSQD/+Q: folds 
7ovWM9c1nQLTFritEGRG/A: folds 
bXpVeaSTPBFSPJmeXxO7nw: raises $4.50 to $4.75 and is all-in
+8OkYWUhGfkDbAtQl/ovYQ: calls $4.50
*** FLOP *** [Jd Ad 2c]
*** TURN *** [Jd Ad 2c] [Qs]
*** RIVER *** [Jd Ad 2c Qs] [3c]
*** SHOW DOWN ***
bXpVeaSTPBFSPJmeXxO7nw: shows [6h As] (a pair of Aces)
+8OkYWUhGfkDbAtQl/ovYQ: mucks hand 
bXpVeaSTPBFSPJmeXxO7nw collected $9.05 from pot
*** SUMMARY ***
Total pot $9.50 | Rake $0.45 
Board [Jd Ad 2c Qs 3c]
Seat 1: zUXhymECc2C9W9ZNw6qppA folded before Flop (didn't bet)
Seat 2: r/xYbgD9yVdKFWRgSQD/+Q folded before Flop (didn't bet)
Seat 3: 7ovWM9c1nQLTFritEGRG/A (button) folded before Flop (didn't bet)
Seat 4: bXpVeaSTPBFSPJmeXxO7nw (small blind) showed [6h As] and won ($9.05) with a pair of Aces
Seat 5: +8OkYWUhGfkDbAtQl/ovYQ (big blind) mucked
Seat 6: T+MjFnaPZsOyKbE9LYG2Qg folded before Flop (didn't bet)
Seat 7: kUxTO3D2eQcx4oJIpJAK4Q folded before Flop (didn't bet)
Seat 8: +sbyWwIcFp9kP0bDtMegfQ folded before Flop (didn't bet)




PokerStars Game #59941600086:  Hold'em No Limit ($0.10/$0.25) - 2009/07/01 1:40:21 ET
Table 'VuY5ej47Cy8nOI3Wogmhzw' 6-max Seat #2 is the button
Seat 1: EeUZtMU058v2ObUACOF4Og ($25.95 in chips) 
Seat 2: AM6Yl+3esmhhMBlSnQhWbg ($16 in chips) 
Seat 3: v+QfkGiuj9bgtuNoVnDO8w ($31.60 in chips) 
Seat 4: aXzjpue4eAQBqMdp87D3ZA ($13.95 in chips) 
Seat 5: iK/41//HmnLiIn0CVNNfyA ($11.95 in chips) 
v+QfkGiuj9bgtuNoVnDO8w: posts small blind $0.10
aXzjpue4eAQBqMdp87D3ZA: posts big blind $0.25
*** HOLE CARDS ***
iK/41//HmnLiIn0CVNNfyA: raises $0.75 to $1
EeUZtMU058v2ObUACOF4Og: folds 
AM6Yl+3esmhhMBlSnQhWbg: folds 
v+QfkGiuj9bgtuNoVnDO8w: folds 
aXzjpue4eAQBqMdp87D3ZA: folds 
Uncalled bet ($0.75) returned to iK/41//HmnLiIn0CVNNfyA
iK/41//HmnLiIn0CVNNfyA collected $0.60 from pot
*** SUMMARY ***
Total pot $0.60 | Rake $0 
Seat 1: EeUZtMU058v2ObUACOF4Og folded before Flop (didn't bet)
Seat 2: AM6Yl+3esmhhMBlSnQhWbg (button) folded before Flop (didn't bet)
Seat 3: v+QfkGiuj9bgtuNoVnDO8w (small blind) folded before Flop
Seat 4: aXzjpue4eAQBqMdp87D3ZA (big blind) folded before Flop
Seat 5: iK/41//HmnLiIn0CVNNfyA collected ($0.60)




PokerStars Game #59941599832:  Hold'em No Limit ($0.10/$0.25) - 2009/07/01 1:40:21 ET
Table 'Mef6A0EMopL6WaFO5/KO9g' 6-max Seat #2 is the button
Seat 1: GbCVUNssQ7mqsPWr7J4d3w ($4.65 in chips) 
Seat 2: 8ClCHtFXGNplITm+63KB+Q ($32.65 in chips) 
Seat 3: Wq26opBLDGJe91GRJn2epg ($11.45 in chips) 
Seat 4: lquriepNQBhDV5P1SWHhnA ($25.45 in chips) 
Seat 5: DihMHaz4WNETH1bPDe13kA ($25 in chips) 
Seat 6: jp34e617tIzV8tKIWmfAbA ($33.65 in chips) 
Wq26opBLDGJe91GRJn2epg: posts small blind $0.10
lquriepNQBhDV5P1SWHhnA: posts big blind $0.25
*** HOLE CARDS ***
DihMHaz4WNETH1bPDe13kA: folds 
jp34e617tIzV8tKIWmfAbA: folds 
GbCVUNssQ7mqsPWr7J4d3w: folds 
8ClCHtFXGNplITm+63KB+Q: folds 
Wq26opBLDGJe91GRJn2epg: folds 
Uncalled bet ($0.15) returned to lquriepNQBhDV5P1SWHhnA
lquriepNQBhDV5P1SWHhnA collected $0.20 from pot
lquriepNQBhDV5P1SWHhnA: doesn't show hand 
*** SUMMARY ***
Total pot $0.20 | Rake $0 
Seat 1: GbCVUNssQ7mqsPWr7J4d3w folded before Flop (didn't bet)
Seat 2: 8ClCHtFXGNplITm+63KB+Q (button) folded before Flop (didn't bet)
Seat 3: Wq26opBLDGJe91GRJn2epg (small blind) folded before Flop
Seat 4: lquriepNQBhDV5P1SWHhnA (big blind) collected ($0.20)
Seat 5: DihMHaz4WNETH1bPDe13kA folded before Flop (didn't bet)
Seat 6: jp34e617tIzV8tKIWmfAbA folded before Flop (didn't bet)




PokerStars Game #59941600662:  Hold'em No Limit ($0.10/$0.25) - 2009/07/01 1:40:22 ET
Table 'DhkrdW2UOy2PfjSW28Kq8w' 6-max Seat #1 is the button
Seat 1: vu2kzHaDtgr6NM7rdq0chA ($26.65 in chips) 
Seat 2: v+QfkGiuj9bgtuNoVnDO8w ($25 in chips) 
Seat 3: B3X187C0tXFUfQpCu8pe8A ($22.90 in chips) 
Seat 4: 59HJSCM1X37BkMpI9N0mEw ($26.40 in chips) 
Seat 5: SxIIgwXYLkwd6m3wLyPTCw ($49.20 in chips) 
Seat 6: DihMHaz4WNETH1bPDe13kA ($25.40 in chips) 
v+QfkGiuj9bgtuNoVnDO8w: posts small blind $0.10
B3X187C0tXFUfQpCu8pe8A: posts big blind $0.25
*** HOLE CARDS ***
59HJSCM1X37BkMpI9N0mEw: folds 
SxIIgwXYLkwd6m3wLyPTCw: folds 
DihMHaz4WNETH1bPDe13kA: folds 
vu2kzHaDtgr6NM7rdq0chA: folds 
v+QfkGiuj9bgtuNoVnDO8w: folds 
Uncalled bet ($0.15) returned to B3X187C0tXFUfQpCu8pe8A
B3X187C0tXFUfQpCu8pe8A collected $0.20 from pot
*** SUMMARY ***
Total pot $0.20 | Rake $0 
Seat 1: vu2kzHaDtgr6NM7rdq0chA (button) folded before Flop (didn't bet)
Seat 2: v+QfkGiuj9bgtuNoVnDO8w (small blind) folded before Flop
Seat 3: B3X187C0tXFUfQpCu8pe8A (big blind) collected ($0.20)
Seat 4: 59HJSCM1X37BkMpI9N0mEw folded before Flop (didn't bet)
Seat 5: SxIIgwXYLkwd6m3wLyPTCw folded before Flop (didn't bet)
Seat 6: DihMHaz4WNETH1bPDe13kA folded before Flop (didn't bet)




PokerStars Game #59941600468:  Hold'em No Limit ($0.10/$0.25) - 2009/07/01 1:40:22 ET
Table 'mk323gviqdkOY5Aek/1EWg' 6-max Seat #2 is the button
Seat 1: L3/N/gliETan8N5Gim5h4Q ($25.75 in chips) 
Seat 2: GC/9yVD59DUCX7hUI7gcLw ($56.05 in chips) 
Seat 3: NuqYPwTLZYQhxOoVK3Yqlw ($24.40 in chips) 
Seat 4: +baiVgI/ETnBARLe5mARCw ($13.15 in chips) 
Seat 5: kjYRzIfvZNNflYMYRkkSVA ($26.15 in chips) 
Seat 6: KkXSr5xFjxLSD3wtAvT+WQ ($8.80 in chips) 
NuqYPwTLZYQhxOoVK3Yqlw: posts small blind $0.10
+baiVgI/ETnBARLe5mARCw: posts big blind $0.25
*** HOLE CARDS ***
kjYRzIfvZNNflYMYRkkSVA: folds 
KkXSr5xFjxLSD3wtAvT+WQ: folds 
L3/N/gliETan8N5Gim5h4Q: folds 
GC/9yVD59DUCX7hUI7gcLw: raises $0.75 to $1
NuqYPwTLZYQhxOoVK3Yqlw: folds 
+baiVgI/ETnBARLe5mARCw: folds 
Uncalled bet ($0.75) returned to GC/9yVD59DUCX7hUI7gcLw
GC/9yVD59DUCX7hUI7gcLw collected $0.60 from pot
*** SUMMARY ***
Total pot $0.60 | Rake $0 
Seat 1: L3/N/gliETan8N5Gim5h4Q folded before Flop (didn't bet)
Seat 2: GC/9yVD59DUCX7hUI7gcLw (button) collected ($0.60)
Seat 3: NuqYPwTLZYQhxOoVK3Yqlw (small blind) folded before Flop
Seat 4: +baiVgI/ETnBARLe5mARCw (big blind) folded before Flop
Seat 5: kjYRzIfvZNNflYMYRkkSVA folded before Flop (didn't bet)
Seat 6: KkXSr5xFjxLSD3wtAvT+WQ folded before Flop (didn't bet)




PokerStars Game #59941600708:  Hold'em No Limit ($0.10/$0.25) - 2009/07/01 1:40:22 ET
Table 'ouLhepGYovxB2x0QxH7cVg' 9-max Seat #7 is the button
Seat 1: ghNKXUBl/H+t83JF079ZBA ($25.35 in chips) 
Seat 2: r1Z5m4PwSI5ANp7qCE1OJw ($19 in chips) 
Seat 3: bXpVeaSTPBFSPJmeXxO7nw ($5.60 in chips) 
Seat 5: LxRIJ6NkqjCD5zmzlF+y4w ($14.95 in chips) 
Seat 6: lSeLm4BdnSMLtIli62qjAQ ($7.50 in chips) 
Seat 7: JRV2PblFtPFz51l0Fwyz8g ($22.85 in chips) 
Seat 8: tLcDklc2rBORNfixyRfVfw ($25 in chips) 
Seat 9: ljemhp25Zg+nlA9DLCIiUw ($25 in chips) 
tLcDklc2rBORNfixyRfVfw: posts small blind $0.10
ljemhp25Zg+nlA9DLCIiUw: posts big blind $0.25
*** HOLE CARDS ***
ghNKXUBl/H+t83JF079ZBA: folds 
r1Z5m4PwSI5ANp7qCE1OJw: folds 
bXpVeaSTPBFSPJmeXxO7nw: folds 
LxRIJ6NkqjCD5zmzlF+y4w: calls $0.25
lSeLm4BdnSMLtIli62qjAQ: folds 
JRV2PblFtPFz51l0Fwyz8g: calls $0.25
tLcDklc2rBORNfixyRfVfw: folds 
ljemhp25Zg+nlA9DLCIiUw: checks 
*** FLOP *** [7h 3h 8s]
ljemhp25Zg+nlA9DLCIiUw: checks 
LxRIJ6NkqjCD5zmzlF+y4w: bets $0.25
JRV2PblFtPFz51l0Fwyz8g: raises $0.75 to $1
a0Sx6GHY7ln2Ns2C97eXeA has returned
ljemhp25Zg+nlA9DLCIiUw: folds 
LxRIJ6NkqjCD5zmzlF+y4w: folds 
Uncalled bet ($0.75) returned to JRV2PblFtPFz51l0Fwyz8g
JRV2PblFtPFz51l0Fwyz8g collected $1.30 from pot
*** SUMMARY ***
Total pot $1.35 | Rake $0.05 
Board [7h 3h 8s]
Seat 1: ghNKXUBl/H+t83JF079ZBA folded before Flop (didn't bet)
Seat 2: r1Z5m4PwSI5ANp7qCE1OJw folded before Flop (didn't bet)
Seat 3: bXpVeaSTPBFSPJmeXxO7nw folded before Flop (didn't bet)
Seat 5: LxRIJ6NkqjCD5zmzlF+y4w folded on the Flop
Seat 6: lSeLm4BdnSMLtIli62qjAQ folded before Flop (didn't bet)
Seat 7: JRV2PblFtPFz51l0Fwyz8g (button) collected ($1.30)
Seat 8: tLcDklc2rBORNfixyRfVfw (small blind) folded before Flop
Seat 9: ljemhp25Zg+nlA9DLCIiUw (big blind) folded on the Flop




PokerStars Game #59941600592:  Hold'em No Limit ($0.10/$0.25) - 2009/07/01 1:40:22 ET
Table 'hfHe8uKeSJMyWAjSdM7ROQ' 6-max Seat #6 is the button
Seat 1: eHsmIvAb2JREg4O6hNPnXg ($24.75 in chips) 
Seat 2: QvTX2yGq3uKJiKPmns4TKQ ($27.20 in chips) 
Seat 3: oAzQdB2jFOH1NxFUPjYUGg ($20.20 in chips) 
Seat 5: euswrBD1XG0Q5hB1iGJBKQ ($66.35 in chips) 
Seat 6: MTQON5nWq0PsufZ7u/4rMA ($19.50 in chips) 
eHsmIvAb2JREg4O6hNPnXg: posts small blind $0.10
QvTX2yGq3uKJiKPmns4TKQ: posts big blind $0.25
b4wRQV3APH8irVk6bUFe2Q: sits out 
*** HOLE CARDS ***
oAzQdB2jFOH1NxFUPjYUGg: calls $0.25
euswrBD1XG0Q5hB1iGJBKQ: raises $0.50 to $0.75
MTQON5nWq0PsufZ7u/4rMA: calls $0.75
eHsmIvAb2JREg4O6hNPnXg: calls $0.65
QvTX2yGq3uKJiKPmns4TKQ: folds 
oAzQdB2jFOH1NxFUPjYUGg: calls $0.50
*** FLOP *** [5d 5s 3d]
eHsmIvAb2JREg4O6hNPnXg: bets $1.50
oAzQdB2jFOH1NxFUPjYUGg: calls $1.50
euswrBD1XG0Q5hB1iGJBKQ: calls $1.50
MTQON5nWq0PsufZ7u/4rMA: calls $1.50
*** TURN *** [5d 5s 3d] [Kh]
eHsmIvAb2JREg4O6hNPnXg: bets $1.50
oAzQdB2jFOH1NxFUPjYUGg: raises $2.50 to $4
euswrBD1XG0Q5hB1iGJBKQ: folds 
MTQON5nWq0PsufZ7u/4rMA: folds 
eHsmIvAb2JREg4O6hNPnXg: folds 
Uncalled bet ($2.50) returned to oAzQdB2jFOH1NxFUPjYUGg
oAzQdB2jFOH1NxFUPjYUGg collected $11.70 from pot
oAzQdB2jFOH1NxFUPjYUGg: doesn't show hand 
*** SUMMARY ***
Total pot $12.25 | Rake $0.55 
Board [5d 5s 3d Kh]
Seat 1: eHsmIvAb2JREg4O6hNPnXg (small blind) folded on the Turn
Seat 2: QvTX2yGq3uKJiKPmns4TKQ (big blind) folded before Flop
Seat 3: oAzQdB2jFOH1NxFUPjYUGg collected ($11.70)
Seat 5: euswrBD1XG0Q5hB1iGJBKQ folded on the Turn
Seat 6: MTQON5nWq0PsufZ7u/4rMA (button) folded on the Turn




PokerStars Game #59941600510:  Hold'em No Limit ($0.10/$0.25) - 2009/07/01 1:40:22 ET
Table '+UzantPJ4smVdrh+4GTu1w' 6-max Seat #3 is the button
Seat 1: TSmua8tGK3sTbwi0ynrW9Q ($27.70 in chips) 
Seat 3: SS/yfeArhULzIcOPe8MdPg ($29.45 in chips) 
Seat 4: UmcUp27+PbgBItv3ZNlAWQ ($25 in chips) 
Seat 5: cj4VBQya7HtVL2zCGd5jLQ ($60.95 in chips) 
Seat 6: fZQg9veL7Dd/Z04ZTjC+wQ ($25 in chips) 
UmcUp27+PbgBItv3ZNlAWQ: posts small blind $0.10
cj4VBQya7HtVL2zCGd5jLQ: posts big blind $0.25
tcbEu7VzyHQ+0lh+skbQhQ: sits out 
*** HOLE CARDS ***
fZQg9veL7Dd/Z04ZTjC+wQ: folds 
TSmua8tGK3sTbwi0ynrW9Q: folds 
SS/yfeArhULzIcOPe8MdPg: raises $0.75 to $1
UmcUp27+PbgBItv3ZNlAWQ: folds 
cj4VBQya7HtVL2zCGd5jLQ: calls $0.75
*** FLOP *** [Jc 4h Ah]
cj4VBQya7HtVL2zCGd5jLQ: checks 
SS/yfeArhULzIcOPe8MdPg: bets $1.50
cj4VBQya7HtVL2zCGd5jLQ: calls $1.50
*** TURN *** [Jc 4h Ah] [2c]
cj4VBQya7HtVL2zCGd5jLQ: checks 
SS/yfeArhULzIcOPe8MdPg: bets $3
cj4VBQya7HtVL2zCGd5jLQ: calls $3
*** RIVER *** [Jc 4h Ah 2c] [8h]
cj4VBQya7HtVL2zCGd5jLQ: checks 
SS/yfeArhULzIcOPe8MdPg: checks 
*** SHOW DOWN ***
cj4VBQya7HtVL2zCGd5jLQ: shows [6h Ad] (a pair of Aces)
SS/yfeArhULzIcOPe8MdPg: shows [Ac Kc] (a pair of Aces - King kicker)
SS/yfeArhULzIcOPe8MdPg collected $10.60 from pot
*** SUMMARY ***
Total pot $11.10 | Rake $0.50 
Board [Jc 4h Ah 2c 8h]
Seat 1: TSmua8tGK3sTbwi0ynrW9Q folded before Flop (didn't bet)
Seat 3: SS/yfeArhULzIcOPe8MdPg (button) showed [Ac Kc] and won ($10.60) with a pair of Aces
Seat 4: UmcUp27+PbgBItv3ZNlAWQ (small blind) folded before Flop
Seat 5: cj4VBQya7HtVL2zCGd5jLQ (big blind) showed [6h Ad] and lost with a pair of Aces
Seat 6: fZQg9veL7Dd/Z04ZTjC+wQ folded before Flop (didn't bet)




PokerStars Game #59941600486:  Hold'em No Limit ($0.10/$0.25) - 2009/07/01 1:40:22 ET
Table 'nXVbUw6/HYwA6x21+IZ3XQ' 9-max Seat #1 is the button
Seat 1: zDrucyjVn5aeekNEc3cJrA ($17.10 in chips) 
Seat 2: 9lvO/qyU+xrU95Teu1fv0g ($4.75 in chips) 
Seat 3: 7je+LC5Mfs6nL8YBVh4frQ ($5.60 in chips) 
Seat 4: H5Se03ZqSX7tbULXur2MAg ($24.70 in chips) 
Seat 5: M/9j4wkHH9i1JM51vgi1VA ($28.70 in chips) 
Seat 6: ljemhp25Zg+nlA9DLCIiUw ($26.75 in chips) 
Seat 7: ShCS62CJp4MKfKLKvGKQbA ($12.50 in chips) 
Seat 8: dfNim92Z6XK1/h5SFW5vDg ($27.15 in chips) 
Seat 9: OTCjTlu92MEBtX/i9Gm7yA ($12.80 in chips) 
9lvO/qyU+xrU95Teu1fv0g: posts small blind $0.10
7je+LC5Mfs6nL8YBVh4frQ: posts big blind $0.25
*** HOLE CARDS ***
H5Se03ZqSX7tbULXur2MAg: folds 
M/9j4wkHH9i1JM51vgi1VA: folds 
ljemhp25Zg+nlA9DLCIiUw: folds 
ShCS62CJp4MKfKLKvGKQbA: folds 
dfNim92Z6XK1/h5SFW5vDg: folds 
OTCjTlu92MEBtX/i9Gm7yA: folds 
zDrucyjVn5aeekNEc3cJrA: folds 
zDrucyjVn5aeekNEc3cJrA is sitting out
9lvO/qyU+xrU95Teu1fv0g: folds 
Uncalled bet ($0.15) returned to 7je+LC5Mfs6nL8YBVh4frQ
7je+LC5Mfs6nL8YBVh4frQ collected $0.20 from pot
7je+LC5Mfs6nL8YBVh4frQ: doesn't show hand 
*** SUMMARY ***
Total pot $0.20 | Rake $0 
Seat 1: zDrucyjVn5aeekNEc3cJrA (button) folded before Flop (didn't bet)
Seat 2: 9lvO/qyU+xrU95Teu1fv0g (small blind) folded before Flop
Seat 3: 7je+LC5Mfs6nL8YBVh4frQ (big blind) collected ($0.20)
Seat 4: H5Se03ZqSX7tbULXur2MAg folded before Flop (didn't bet)
Seat 5: M/9j4wkHH9i1JM51vgi1VA folded before Flop (didn't bet)
Seat 6: ljemhp25Zg+nlA9DLCIiUw folded before Flop (didn't bet)
Seat 7: ShCS62CJp4MKfKLKvGKQbA folded before Flop (didn't bet)
Seat 8: dfNim92Z6XK1/h5SFW5vDg folded before Flop (didn't bet)
Seat 9: OTCjTlu92MEBtX/i9Gm7yA folded before Flop (didn't bet)




PokerStars Game #59941600874:  Hold'em No Limit ($0.10/$0.25) - 2009/07/01 1:40:23 ET
Table 'BmUMTVcNATeov2rAGYU0Qg' 9-max Seat #6 is the button
Seat 1: QEbIGci+itdw+re8RM5fZA ($36.20 in chips) 
Seat 2: jJnMGXoBXye+afMd0k0rUw ($9.95 in chips) 
Seat 3: ir5Jy8ck6DrdqgJ/3chcWw ($7.15 in chips) 
Seat 4: aNpwfA31EREwO+ar4XzBCw ($37.85 in chips) 
Seat 5: QBNcj9fHxkh/+s/oVw+JmQ ($23.25 in chips) 
Seat 6: w1ukf8uPa4+WH561TtVRxA ($25 in chips) 
Seat 7: CmngQmkKTp8tkl6GMRTl6w ($8.50 in chips) 
Seat 8: f/H6PsHRl4W1JyNsEDvPtg ($33.90 in chips) 
Seat 9: /artgaAtyUtUtD8FZo6puA ($12.10 in chips) 
CmngQmkKTp8tkl6GMRTl6w: posts small blind $0.10
f/H6PsHRl4W1JyNsEDvPtg: posts big blind $0.25
*** HOLE CARDS ***
/artgaAtyUtUtD8FZo6puA: folds 
QEbIGci+itdw+re8RM5fZA: folds 
jJnMGXoBXye+afMd0k0rUw: folds 
ir5Jy8ck6DrdqgJ/3chcWw: folds 
aNpwfA31EREwO+ar4XzBCw: folds 
QBNcj9fHxkh/+s/oVw+JmQ: raises $0.75 to $1
w1ukf8uPa4+WH561TtVRxA: folds 
CmngQmkKTp8tkl6GMRTl6w: folds 
f/H6PsHRl4W1JyNsEDvPtg: folds 
Uncalled bet ($0.75) returned to QBNcj9fHxkh/+s/oVw+JmQ
QBNcj9fHxkh/+s/oVw+JmQ collected $0.60 from pot
*** SUMMARY ***
Total pot $0.60 | Rake $0 
Seat 1: QEbIGci+itdw+re8RM5fZA folded before Flop (didn't bet)
Seat 2: jJnMGXoBXye+afMd0k0rUw folded before Flop (didn't bet)
Seat 3: ir5Jy8ck6DrdqgJ/3chcWw folded before Flop (didn't bet)
Seat 4: aNpwfA31EREwO+ar4XzBCw folded before Flop (didn't bet)
Seat 5: QBNcj9fHxkh/+s/oVw+JmQ collected ($0.60)
Seat 6: w1ukf8uPa4+WH561TtVRxA (button) folded before Flop (didn't bet)
Seat 7: CmngQmkKTp8tkl6GMRTl6w (small blind) folded before Flop
Seat 8: f/H6PsHRl4W1JyNsEDvPtg (big blind) folded before Flop
Seat 9: /artgaAtyUtUtD8FZo6puA folded before Flop (didn't bet)




PokerStars Game #59941600878:  Hold'em No Limit ($0.10/$0.25) - 2009/07/01 1:40:23 ET
Table 'IfRHUn9gQQA9I/Z4tn+BoA' 9-max Seat #8 is the button
Seat 2: VWUWpMLMj/Q1jRVpF7Aohw ($17.45 in chips) 
Seat 3: ModuIAhh03puxW6XFxQ3Nw ($11.70 in chips) 
Seat 4: QEbIGci+itdw+re8RM5fZA ($30.65 in chips) 
Seat 5: DdPXdieucQ+n99u1n3A+rQ ($4.65 in chips) 
Seat 6: UOjoGGQ58/uDS7V0xkjOrQ ($20.45 in chips) 
Seat 7: YzqSxP03XxZPbgPifgt69g ($28.15 in chips) 
Seat 8: cZ99hugmLBj9KhTlc8nCSw ($27.75 in chips) 
Seat 9: 7cv+9Zc9HIQHNvYsMfV3uA ($47.85 in chips) 
7cv+9Zc9HIQHNvYsMfV3uA: posts small blind $0.10
vSkQm2EelzwRGDDQQk0Fqw: is sitting out 
VWUWpMLMj/Q1jRVpF7Aohw: posts big blind $0.25
*** HOLE CARDS ***
vSkQm2EelzwRGDDQQk0Fqw leaves the table
ModuIAhh03puxW6XFxQ3Nw: raises $0.50 to $0.75
QEbIGci+itdw+re8RM5fZA: folds 
DdPXdieucQ+n99u1n3A+rQ: raises $1.25 to $2
UOjoGGQ58/uDS7V0xkjOrQ: calls $2
YzqSxP03XxZPbgPifgt69g: folds 
cZ99hugmLBj9KhTlc8nCSw: folds 
imHPFFqvfHGzsBBWeGuy4w joins the table at seat #1 
7cv+9Zc9HIQHNvYsMfV3uA: folds 
VWUWpMLMj/Q1jRVpF7Aohw: folds 
ModuIAhh03puxW6XFxQ3Nw: calls $1.25
*** FLOP *** [Qc 8c 3d]
ModuIAhh03puxW6XFxQ3Nw: bets $0.25
DdPXdieucQ+n99u1n3A+rQ: raises $2.40 to $2.65 and is all-in
UOjoGGQ58/uDS7V0xkjOrQ: folds 
ModuIAhh03puxW6XFxQ3Nw: calls $2.40
*** TURN *** [Qc 8c 3d] [Qd]
*** RIVER *** [Qc 8c 3d Qd] [9d]
*** SHOW DOWN ***
ModuIAhh03puxW6XFxQ3Nw: shows [4h 4c] (two pair, Queens and Fours)
DdPXdieucQ+n99u1n3A+rQ: mucks hand 
ModuIAhh03puxW6XFxQ3Nw collected $11.10 from pot
*** SUMMARY ***
Total pot $11.65 | Rake $0.55 
Board [Qc 8c 3d Qd 9d]
Seat 2: VWUWpMLMj/Q1jRVpF7Aohw (big blind) folded before Flop
Seat 3: ModuIAhh03puxW6XFxQ3Nw showed [4h 4c] and won ($11.10) with two pair, Queens and Fours
Seat 4: QEbIGci+itdw+re8RM5fZA folded before Flop (didn't bet)
Seat 5: DdPXdieucQ+n99u1n3A+rQ mucked
Seat 6: UOjoGGQ58/uDS7V0xkjOrQ folded on the Flop
Seat 7: YzqSxP03XxZPbgPifgt69g folded before Flop (didn't bet)
Seat 8: cZ99hugmLBj9KhTlc8nCSw (button) folded before Flop (didn't bet)
Seat 9: 7cv+9Zc9HIQHNvYsMfV3uA (small blind) folded before Flop




PokerStars Game #59941600886:  Hold'em No Limit ($0.10/$0.25) - 2009/07/01 1:40:23 ET
Table 'dVzscin98UhGisTmV9BDcw' 9-max Seat #2 is the button
Seat 1: sBAwXpkpgyhyWbHIQcIJKA ($17.90 in chips) 
Seat 2: dfNim92Z6XK1/h5SFW5vDg ($28.25 in chips) 
Seat 4: aNpwfA31EREwO+ar4XzBCw ($41.65 in chips) 
Seat 5: 22dIObOuor/A+IKWkNoAlA ($10.10 in chips) 
Seat 6: bXpVeaSTPBFSPJmeXxO7nw ($4.65 in chips) 
Seat 7: cKlmpQMahVsmOaxFQDcoOg ($25 in chips) 
Seat 8: /vn2Qu2dvc9AMMq46Ae0jA ($48.10 in chips) 
Seat 9: arxNSjreDRGFg13EAM2F1w ($25 in chips) 
aNpwfA31EREwO+ar4XzBCw: posts small blind $0.10
22dIObOuor/A+IKWkNoAlA: posts big blind $0.25
*** HOLE CARDS ***
bXpVeaSTPBFSPJmeXxO7nw: folds 
cKlmpQMahVsmOaxFQDcoOg: folds 
/vn2Qu2dvc9AMMq46Ae0jA: folds 
arxNSjreDRGFg13EAM2F1w: folds 
sBAwXpkpgyhyWbHIQcIJKA: folds 
dfNim92Z6XK1/h5SFW5vDg: folds 
aNpwfA31EREwO+ar4XzBCw: folds 
Uncalled bet ($0.15) returned to 22dIObOuor/A+IKWkNoAlA
22dIObOuor/A+IKWkNoAlA collected $0.20 from pot
22dIObOuor/A+IKWkNoAlA: doesn't show hand 
*** SUMMARY ***
Total pot $0.20 | Rake $0 
Seat 1: sBAwXpkpgyhyWbHIQcIJKA folded before Flop (didn't bet)
Seat 2: dfNim92Z6XK1/h5SFW5vDg (button) folded before Flop (didn't bet)
Seat 4: aNpwfA31EREwO+ar4XzBCw (small blind) folded before Flop
Seat 5: 22dIObOuor/A+IKWkNoAlA (big blind) collected ($0.20)
Seat 6: bXpVeaSTPBFSPJmeXxO7nw folded before Flop (didn't bet)
Seat 7: cKlmpQMahVsmOaxFQDcoOg folded before Flop (didn't bet)
Seat 8: /vn2Qu2dvc9AMMq46Ae0jA folded before Flop (didn't bet)
Seat 9: arxNSjreDRGFg13EAM2F1w folded before Flop (didn't bet)




PokerStars Game #59941600884:  Hold'em No Limit ($0.10/$0.25) - 2009/07/01 1:40:23 ET
Table 'M7d9IrgQUUFFy/SZ3ksLYg' 6-max Seat #4 is the button
Seat 1: ypmjhffk/YHGc51wgVXUTw ($49.95 in chips) 
Seat 2: gqrr7lSWrQ1N8zKx8zZzvA ($11.05 in chips) 
Seat 3: 8JTm/CXBn3+kuQgcUOgPkw ($24.30 in chips) 
Seat 4: 8ClCHtFXGNplITm+63KB+Q ($24.90 in chips) 
Seat 6: 7S16WhQHiAVLWwRuqPrpnw ($7.70 in chips) 
7S16WhQHiAVLWwRuqPrpnw: posts small blind $0.10
ypmjhffk/YHGc51wgVXUTw: posts big blind $0.25
*** HOLE CARDS ***
gqrr7lSWrQ1N8zKx8zZzvA: folds 
kMa8BltUcBQVxnHfqdCfXg has returned
8JTm/CXBn3+kuQgcUOgPkw: raises $0.75 to $1
7S16WhQHiAVLWwRuqPrpnw said, "nice river ****"
8ClCHtFXGNplITm+63KB+Q: folds 
7S16WhQHiAVLWwRuqPrpnw: calls $0.90
ypmjhffk/YHGc51wgVXUTw: folds 
*** FLOP *** [7h Ad Qd]
7S16WhQHiAVLWwRuqPrpnw: checks 
8JTm/CXBn3+kuQgcUOgPkw: checks 
*** TURN *** [7h Ad Qd] [7s]
7S16WhQHiAVLWwRuqPrpnw: checks 
8JTm/CXBn3+kuQgcUOgPkw: checks 
*** RIVER *** [7h Ad Qd 7s] [3s]
7S16WhQHiAVLWwRuqPrpnw said, "stickin around for the ten ???"
7S16WhQHiAVLWwRuqPrpnw: checks 
8JTm/CXBn3+kuQgcUOgPkw: checks 
*** SHOW DOWN ***
7S16WhQHiAVLWwRuqPrpnw: shows [Jh 8d] (a pair of Sevens)
8JTm/CXBn3+kuQgcUOgPkw: mucks hand 
7S16WhQHiAVLWwRuqPrpnw collected $2.15 from pot
*** SUMMARY ***
Total pot $2.25 | Rake $0.10 
Board [7h Ad Qd 7s 3s]
Seat 1: ypmjhffk/YHGc51wgVXUTw (big blind) folded before Flop
Seat 2: gqrr7lSWrQ1N8zKx8zZzvA folded before Flop (didn't bet)
Seat 3: 8JTm/CXBn3+kuQgcUOgPkw mucked
Seat 4: 8ClCHtFXGNplITm+63KB+Q (button) folded before Flop (didn't bet)
Seat 6: 7S16WhQHiAVLWwRuqPrpnw (small blind) showed [Jh 8d] and won ($2.15) with a pair of Sevens




PokerStars Game #59941601044:  Hold'em No Limit ($0.10/$0.25) - 2009/07/01 1:40:23 ET
Table 'YYMg5qzxK1m9eGRo4SbxtQ' 9-max Seat #6 is the button
Seat 2: f/H6PsHRl4W1JyNsEDvPtg ($8.10 in chips) 
Seat 6: S5VeQLgBIiHrfs9AB2vBwA ($3.30 in chips) 
Seat 8: xoBFd/5k+L/pFn9VW1VyWg ($13.10 in chips) 
Seat 9: +sbyWwIcFp9kP0bDtMegfQ ($32.25 in chips) 
otsTcnOEjDA+oFV8U+ITZw: is sitting out 
xoBFd/5k+L/pFn9VW1VyWg: posts small blind $0.10
+sbyWwIcFp9kP0bDtMegfQ: posts big blind $0.25
*** HOLE CARDS ***
otsTcnOEjDA+oFV8U+ITZw leaves the table
f/H6PsHRl4W1JyNsEDvPtg: calls $0.25
S5VeQLgBIiHrfs9AB2vBwA: folds 
xoBFd/5k+L/pFn9VW1VyWg: folds 
S5VeQLgBIiHrfs9AB2vBwA is sitting out
+sbyWwIcFp9kP0bDtMegfQ: checks 
*** FLOP *** [7d Kc 7h]
cFmpjvcjNoVAEAIQIxWkYg joins the table at seat #3 
+sbyWwIcFp9kP0bDtMegfQ: checks 
f/H6PsHRl4W1JyNsEDvPtg: bets $0.50
+sbyWwIcFp9kP0bDtMegfQ: folds 
Uncalled bet ($0.50) returned to f/H6PsHRl4W1JyNsEDvPtg
f/H6PsHRl4W1JyNsEDvPtg collected $0.60 from pot
*** SUMMARY ***
Total pot $0.60 | Rake $0 
Board [7d Kc 7h]
Seat 2: f/H6PsHRl4W1JyNsEDvPtg collected ($0.60)
Seat 6: S5VeQLgBIiHrfs9AB2vBwA (button) folded before Flop (didn't bet)
Seat 8: xoBFd/5k+L/pFn9VW1VyWg (small blind) folded before Flop
Seat 9: +sbyWwIcFp9kP0bDtMegfQ (big blind) folded on the Flop




PokerStars Game #59941601288:  Hold'em No Limit ($0.10/$0.25) - 2009/07/01 1:40:23 ET
Table 'aaXqTKUnxrX9DYXtxhWXxA' 6-max Seat #2 is the button
Seat 1: rnpAao581IcvQglpkpnkoQ ($8.35 in chips) 
Seat 2: DE9hRlt14g+JdsRQ4wT7hg ($34.05 in chips) 
Seat 3: N6vygzX+airCyzOAF2w+HQ ($18.65 in chips) 
Seat 4: 48oT5xFI+5CHUJlfoGrE4w ($10.80 in chips) 
Seat 5: kyRaCIljYA6l33lSKQfNsg ($26.25 in chips) 
Seat 6: buyjetgNT1McXtdaP4zynA ($25 in chips) 
N6vygzX+airCyzOAF2w+HQ: posts small blind $0.10
48oT5xFI+5CHUJlfoGrE4w: posts big blind $0.25
*** HOLE CARDS ***
kyRaCIljYA6l33lSKQfNsg: raises $0.50 to $0.75
buyjetgNT1McXtdaP4zynA: raises $1.25 to $2
rnpAao581IcvQglpkpnkoQ: folds 
DE9hRlt14g+JdsRQ4wT7hg: folds 
N6vygzX+airCyzOAF2w+HQ: folds 
48oT5xFI+5CHUJlfoGrE4w: folds 
kyRaCIljYA6l33lSKQfNsg: calls $1.25
*** FLOP *** [Qd 5d Qh]
N6vygzX+airCyzOAF2w+HQ leaves the table
kyRaCIljYA6l33lSKQfNsg: checks 
buyjetgNT1McXtdaP4zynA: bets $2
uUXdcVMNa05rfbntdvplfw joins the table at seat #3 
kyRaCIljYA6l33lSKQfNsg: raises $3.75 to $5.75
buyjetgNT1McXtdaP4zynA: raises $3.75 to $9.50
kyRaCIljYA6l33lSKQfNsg: raises $14.75 to $24.25 and is all-in
buyjetgNT1McXtdaP4zynA: calls $13.50 and is all-in
Uncalled bet ($1.25) returned to kyRaCIljYA6l33lSKQfNsg
*** TURN *** [Qd 5d Qh] [9c]
*** RIVER *** [Qd 5d Qh 9c] [Ks]
*** SHOW DOWN ***
kyRaCIljYA6l33lSKQfNsg: shows [8c 8s] (two pair, Queens and Eights)
buyjetgNT1McXtdaP4zynA: shows [Qs 9s] (a full house, Queens full of Nines)
buyjetgNT1McXtdaP4zynA collected $47.85 from pot
*** SUMMARY ***
Total pot $50.35 | Rake $2.50 
Board [Qd 5d Qh 9c Ks]
Seat 1: rnpAao581IcvQglpkpnkoQ folded before Flop (didn't bet)
Seat 2: DE9hRlt14g+JdsRQ4wT7hg (button) folded before Flop (didn't bet)
Seat 3: N6vygzX+airCyzOAF2w+HQ (small blind) folded before Flop
Seat 4: 48oT5xFI+5CHUJlfoGrE4w (big blind) folded before Flop
Seat 5: kyRaCIljYA6l33lSKQfNsg showed [8c 8s] and lost with two pair, Queens and Eights
Seat 6: buyjetgNT1McXtdaP4zynA showed [Qs 9s] and won ($47.85) with a full house, Queens full of Nines




PokerStars Game #59941601406:  Hold'em No Limit ($0.10/$0.25) - 2009/07/01 1:40:24 ET
Table 'M8kYidAX3ib7pLKW7edFLw' 6-max Seat #3 is the button
Seat 1: jp34e617tIzV8tKIWmfAbA ($25.70 in chips) 
Seat 2: ypmjhffk/YHGc51wgVXUTw ($28.45 in chips) 
Seat 3: cezpHJ8FB07dj0xG+LhOvw ($27.45 in chips) 
Seat 4: Hsvkc0/G2VV78oVmWYXecw ($5.45 in chips) 
Seat 5: bDKopKTvPi3W+PEnYUX3tg ($44.15 in chips) 
Seat 6: NqFoyDgzLwu4dOmSRXnFBA ($20 in chips) 
Hsvkc0/G2VV78oVmWYXecw: posts small blind $0.10
bDKopKTvPi3W+PEnYUX3tg: posts big blind $0.25
*** HOLE CARDS ***
NqFoyDgzLwu4dOmSRXnFBA: folds 
jp34e617tIzV8tKIWmfAbA: folds 
ypmjhffk/YHGc51wgVXUTw: folds 
cezpHJ8FB07dj0xG+LhOvw: folds 
Hsvkc0/G2VV78oVmWYXecw: folds 
Uncalled bet ($0.15) returned to bDKopKTvPi3W+PEnYUX3tg
bDKopKTvPi3W+PEnYUX3tg collected $0.20 from pot
bDKopKTvPi3W+PEnYUX3tg: doesn't show hand 
*** SUMMARY ***
Total pot $0.20 | Rake $0 
Seat 1: jp34e617tIzV8tKIWmfAbA folded before Flop (didn't bet)
Seat 2: ypmjhffk/YHGc51wgVXUTw folded before Flop (didn't bet)
Seat 3: cezpHJ8FB07dj0xG+LhOvw (button) folded before Flop (didn't bet)
Seat 4: Hsvkc0/G2VV78oVmWYXecw (small blind) folded before Flop
Seat 5: bDKopKTvPi3W+PEnYUX3tg (big blind) collected ($0.20)
Seat 6: NqFoyDgzLwu4dOmSRXnFBA folded before Flop (didn't bet)




PokerStars Game #59941601622:  Hold'em No Limit ($0.10/$0.25) - 2009/07/01 1:40:24 ET
Table 'xmJKTGBeWCwutccj3YfupQ' 6-max Seat #5 is the button
Seat 1: sVbkVl4OznxBCfi66UB9vw ($24.10 in chips) 
Seat 2: AxhCSFlGEh+FAc+VUD31JQ ($23.30 in chips) 
Seat 3: T5wrp/d5jarm+SxNy8OQAg ($23.30 in chips) 
Seat 4: uWjhTVMpuIroxXcmD3Okug ($11.35 in chips) 
Seat 5: DE9hRlt14g+JdsRQ4wT7hg ($25 in chips) 
Seat 6: Mo72EzWqYLVNBUGxtzSsUQ ($31.10 in chips) 
Mo72EzWqYLVNBUGxtzSsUQ: posts small blind $0.10
sVbkVl4OznxBCfi66UB9vw: posts big blind $0.25
*** HOLE CARDS ***
AxhCSFlGEh+FAc+VUD31JQ: folds 
T5wrp/d5jarm+SxNy8OQAg: calls $0.25
uWjhTVMpuIroxXcmD3Okug: calls $0.25
DE9hRlt14g+JdsRQ4wT7hg: folds 
Mo72EzWqYLVNBUGxtzSsUQ: calls $0.15
sVbkVl4OznxBCfi66UB9vw: checks 
*** FLOP *** [Jc Qd 3d]
Mo72EzWqYLVNBUGxtzSsUQ: folds 
Mo72EzWqYLVNBUGxtzSsUQ leaves the table
sVbkVl4OznxBCfi66UB9vw: bets $0.90
T5wrp/d5jarm+SxNy8OQAg: calls $0.90
uWjhTVMpuIroxXcmD3Okug: folds 
*** TURN *** [Jc Qd 3d] [Js]
geomdnb joins the table at seat #6 
sVbkVl4OznxBCfi66UB9vw: checks 
T5wrp/d5jarm+SxNy8OQAg: checks 
*** RIVER *** [Jc Qd 3d Js] [Th]
sVbkVl4OznxBCfi66UB9vw: bets $3
T5wrp/d5jarm+SxNy8OQAg: folds 
Uncalled bet ($3) returned to sVbkVl4OznxBCfi66UB9vw
sVbkVl4OznxBCfi66UB9vw collected $2.70 from pot
sVbkVl4OznxBCfi66UB9vw: doesn't show hand 
*** SUMMARY ***
Total pot $2.80 | Rake $0.10 
Board [Jc Qd 3d Js Th]
Seat 1: sVbkVl4OznxBCfi66UB9vw (big blind) collected ($2.70)
Seat 2: AxhCSFlGEh+FAc+VUD31JQ folded before Flop (didn't bet)
Seat 3: T5wrp/d5jarm+SxNy8OQAg folded on the River
Seat 4: uWjhTVMpuIroxXcmD3Okug folded on the Flop
Seat 5: DE9hRlt14g+JdsRQ4wT7hg (button) folded before Flop (didn't bet)
Seat 6: Mo72EzWqYLVNBUGxtzSsUQ (small blind) folded on the Flop




PokerStars Game #59941601840:  Hold'em No Limit ($0.10/$0.25) - 2009/07/01 1:40:24 ET
Table 'R5qKG21jwFDYRcOht9qwqQ' 9-max Seat #6 is the button
Seat 1: 3wjccGPzilKjAvTdTrc78g ($4.50 in chips) 
Seat 3: M2QO2DxB5Wawg2h8HSpnYA ($13.10 in chips) 
Seat 4: z5GxcHlYz/GSz6W2uFiTtg ($34.70 in chips) 
Seat 5: zUXhymECc2C9W9ZNw6qppA ($9.65 in chips) 
Seat 6: EP17SQz/iWcuYdNOGeBgkw ($15.65 in chips) 
Seat 7: Rv5cr9H+7nb4qG531vNiJA ($5.75 in chips) 
Seat 8: tYsOBqdU1+x+yFI7zHO7hQ ($35.30 in chips) 
Seat 9: MG90wfSJZnOejs/KD3vlQQ ($31.85 in chips) 
Rv5cr9H+7nb4qG531vNiJA: posts small blind $0.10
tYsOBqdU1+x+yFI7zHO7hQ: posts big blind $0.25
tptommy: sits out 
*** HOLE CARDS ***
MG90wfSJZnOejs/KD3vlQQ: raises $0.50 to $0.75
3wjccGPzilKjAvTdTrc78g: folds 
M2QO2DxB5Wawg2h8HSpnYA: folds 
z5GxcHlYz/GSz6W2uFiTtg: calls $0.75
zUXhymECc2C9W9ZNw6qppA: folds 
EP17SQz/iWcuYdNOGeBgkw: folds 
Rv5cr9H+7nb4qG531vNiJA: calls $0.65
tYsOBqdU1+x+yFI7zHO7hQ: folds 
*** FLOP *** [2d 5s 6s]
Rv5cr9H+7nb4qG531vNiJA: checks 
MG90wfSJZnOejs/KD3vlQQ: checks 
z5GxcHlYz/GSz6W2uFiTtg: checks 
*** TURN *** [2d 5s 6s] [4h]
Rv5cr9H+7nb4qG531vNiJA: bets $1
MG90wfSJZnOejs/KD3vlQQ: folds 
z5GxcHlYz/GSz6W2uFiTtg: calls $1
*** RIVER *** [2d 5s 6s 4h] [5c]
Rv5cr9H+7nb4qG531vNiJA: bets $2
z5GxcHlYz/GSz6W2uFiTtg: raises $2 to $4
Rv5cr9H+7nb4qG531vNiJA: calls $2 and is all-in
*** SHOW DOWN ***
z5GxcHlYz/GSz6W2uFiTtg: shows [4c 4s] (a full house, Fours full of Fives)
Rv5cr9H+7nb4qG531vNiJA: mucks hand 
z5GxcHlYz/GSz6W2uFiTtg collected $11.90 from pot
*** SUMMARY ***
Total pot $12.50 | Rake $0.60 
Board [2d 5s 6s 4h 5c]
Seat 1: 3wjccGPzilKjAvTdTrc78g folded before Flop (didn't bet)
Seat 3: M2QO2DxB5Wawg2h8HSpnYA folded before Flop (didn't bet)
Seat 4: z5GxcHlYz/GSz6W2uFiTtg showed [4c 4s] and won ($11.90) with a full house, Fours full of Fives
Seat 5: zUXhymECc2C9W9ZNw6qppA folded before Flop (didn't bet)
Seat 6: EP17SQz/iWcuYdNOGeBgkw (button) folded before Flop (didn't bet)
Seat 7: Rv5cr9H+7nb4qG531vNiJA (small blind) mucked
Seat 8: tYsOBqdU1+x+yFI7zHO7hQ (big blind) folded before Flop
Seat 9: MG90wfSJZnOejs/KD3vlQQ folded on the Turn




PokerStars Game #59941601412:  Hold'em No Limit ($0.10/$0.25) - 2009/07/01 1:40:24 ET
Table 'Ez9TB43XM4QgMDQkIW9DYw' 9-max Seat #7 is the button
Seat 1: ShCS62CJp4MKfKLKvGKQbA ($5.05 in chips) 
Seat 2: PFNLAvMkr8qKc7xCiH0wTA ($14.85 in chips) 
Seat 4: JDdN8256cGDC+SqlWOx98Q ($3.40 in chips) 
Seat 5: qpG9m8I+cPw8VhB0mnGjYw ($32.80 in chips) 
Seat 6: 76o85YBHJ9veRYp2LPuluQ ($33.60 in chips) 
Seat 7: Bb42QRQMhg5/Y0vHP8/2Xw ($30.10 in chips) 
Seat 8: +2kMBNpY4nF1qNCRd8SJLA ($29.25 in chips) 
Seat 9: QEbIGci+itdw+re8RM5fZA ($25 in chips) 
+2kMBNpY4nF1qNCRd8SJLA: posts small blind $0.10
QEbIGci+itdw+re8RM5fZA: posts big blind $0.25
PdIasPkzm2sqZnN41ZRXOg: sits out 
*** HOLE CARDS ***
ShCS62CJp4MKfKLKvGKQbA: folds 
PFNLAvMkr8qKc7xCiH0wTA: folds 
JDdN8256cGDC+SqlWOx98Q: calls $0.25
qpG9m8I+cPw8VhB0mnGjYw: folds 
76o85YBHJ9veRYp2LPuluQ: raises $0.25 to $0.50
Bb42QRQMhg5/Y0vHP8/2Xw: calls $0.50
+2kMBNpY4nF1qNCRd8SJLA: calls $0.40
QEbIGci+itdw+re8RM5fZA: folds 
JDdN8256cGDC+SqlWOx98Q: calls $0.25
*** FLOP *** [4s 7d 6h]
+2kMBNpY4nF1qNCRd8SJLA: checks 
JDdN8256cGDC+SqlWOx98Q: checks 
76o85YBHJ9veRYp2LPuluQ: bets $0.50
Bb42QRQMhg5/Y0vHP8/2Xw: calls $0.50
+2kMBNpY4nF1qNCRd8SJLA: folds 
JDdN8256cGDC+SqlWOx98Q: folds 
*** TURN *** [4s 7d 6h] [9d]
JDdN8256cGDC+SqlWOx98Q leaves the table
76o85YBHJ9veRYp2LPuluQ: bets $0.50
ubsjZomMWSV0hAiBLa7K1A joins the table at seat #4 
Bb42QRQMhg5/Y0vHP8/2Xw: calls $0.50
*** RIVER *** [4s 7d 6h 9d] [5d]
76o85YBHJ9veRYp2LPuluQ: bets $2
Bb42QRQMhg5/Y0vHP8/2Xw: raises $6 to $8
76o85YBHJ9veRYp2LPuluQ: raises $6 to $14
Bb42QRQMhg5/Y0vHP8/2Xw: raises $14.60 to $28.60 and is all-in
76o85YBHJ9veRYp2LPuluQ: calls $14.60
*** SHOW DOWN ***
Bb42QRQMhg5/Y0vHP8/2Xw: shows [6d Ad] (a flush, Ace high)
76o85YBHJ9veRYp2LPuluQ: mucks hand 
Bb42QRQMhg5/Y0vHP8/2Xw collected $58.45 from pot
*** SUMMARY ***
Total pot $61.45 | Rake $3 
Board [4s 7d 6h 9d 5d]
Seat 1: ShCS62CJp4MKfKLKvGKQbA folded before Flop (didn't bet)
Seat 2: PFNLAvMkr8qKc7xCiH0wTA folded before Flop (didn't bet)
Seat 4: JDdN8256cGDC+SqlWOx98Q folded on the Flop
Seat 5: qpG9m8I+cPw8VhB0mnGjYw folded before Flop (didn't bet)
Seat 6: 76o85YBHJ9veRYp2LPuluQ mucked
Seat 7: Bb42QRQMhg5/Y0vHP8/2Xw (button) showed [6d Ad] and won ($58.45) with a flush, Ace high
Seat 8: +2kMBNpY4nF1qNCRd8SJLA (small blind) folded on the Flop
Seat 9: QEbIGci+itdw+re8RM5fZA (big blind) folded before Flop




PokerStars Game #59941601778:  Hold'em No Limit ($0.10/$0.25) - 2009/07/01 1:40:24 ET
Table 'pgrBYaOEx/BuqK5iAtlFzw' 9-max Seat #6 is the button
Seat 1: 6O+8t5ikoK+pNiFXnN/Fyw ($16.15 in chips) 
Seat 2: 2Xwi447v1rBHM+92U0CduA ($4.75 in chips) 
Seat 3: Bb42QRQMhg5/Y0vHP8/2Xw ($26.85 in chips) 
Seat 4: oLa/tXLfSLLB28mcLGrxcg ($24.40 in chips) 
Seat 5: BWzInv8o0kN1pJybv/VjpQ ($25.65 in chips) 
Seat 6: eubS00Znk+qsx0B0+7/Zow ($21.85 in chips) 
Seat 7: eK8qa6EPcH2zhtbmWSvc9g ($25 in chips) 
Seat 8: tLcDklc2rBORNfixyRfVfw ($25 in chips) 
Seat 9: 1S/fpm+f42V/6MNZre+ccg ($32.20 in chips) 
eK8qa6EPcH2zhtbmWSvc9g: posts small blind $0.10
tLcDklc2rBORNfixyRfVfw: posts big blind $0.25
*** HOLE CARDS ***
1S/fpm+f42V/6MNZre+ccg: folds 
6O+8t5ikoK+pNiFXnN/Fyw: folds 
2Xwi447v1rBHM+92U0CduA: folds 
Bb42QRQMhg5/Y0vHP8/2Xw: folds 
oLa/tXLfSLLB28mcLGrxcg: folds 
BWzInv8o0kN1pJybv/VjpQ: folds 
eubS00Znk+qsx0B0+7/Zow: folds 
eK8qa6EPcH2zhtbmWSvc9g: folds 
Uncalled bet ($0.15) returned to tLcDklc2rBORNfixyRfVfw
tLcDklc2rBORNfixyRfVfw collected $0.20 from pot
tLcDklc2rBORNfixyRfVfw: doesn't show hand 
*** SUMMARY ***
Total pot $0.20 | Rake $0 
Seat 1: 6O+8t5ikoK+pNiFXnN/Fyw folded before Flop (didn't bet)
Seat 2: 2Xwi447v1rBHM+92U0CduA folded before Flop (didn't bet)
Seat 3: Bb42QRQMhg5/Y0vHP8/2Xw folded before Flop (didn't bet)
Seat 4: oLa/tXLfSLLB28mcLGrxcg folded before Flop (didn't bet)
Seat 5: BWzInv8o0kN1pJybv/VjpQ folded before Flop (didn't bet)
Seat 6: eubS00Znk+qsx0B0+7/Zow (button) folded before Flop (didn't bet)
Seat 7: eK8qa6EPcH2zhtbmWSvc9g (small blind) folded before Flop
Seat 8: tLcDklc2rBORNfixyRfVfw (big blind) collected ($0.20)
Seat 9: 1S/fpm+f42V/6MNZre+ccg folded before Flop (didn't bet)




PokerStars Game #59941601376:  Hold'em No Limit ($0.10/$0.25) - 2009/07/01 1:40:24 ET
Table 'GgmUtmhrYPRnhkqEEjD/Kw' 9-max Seat #8 is the button
Seat 1: sGFnnRCa1YAHAUmWgsW6Qg ($10 in chips) 
Seat 2: ghNKXUBl/H+t83JF079ZBA ($25.25 in chips) 
Seat 3: dYvYZ723QlKIPiDa0pkedQ ($7.05 in chips) 
Seat 4: dfNim92Z6XK1/h5SFW5vDg ($25 in chips) 
Seat 5: ljemhp25Zg+nlA9DLCIiUw ($27.75 in chips) 
Seat 6: 4Ax0vobe1rLVIGZmkFINGA ($19.45 in chips) 
Seat 7: YwDw9cMqkbMznFK77rru4A ($5.40 in chips) 
Seat 8: DdPXdieucQ+n99u1n3A+rQ ($4.65 in chips) 
Seat 9: V6p0jQ/RhUsqpHLmXvEX4Q ($14.05 in chips) 
V6p0jQ/RhUsqpHLmXvEX4Q: posts small blind $0.10
sGFnnRCa1YAHAUmWgsW6Qg: posts big blind $0.25
*** HOLE CARDS ***
ghNKXUBl/H+t83JF079ZBA: folds 
dYvYZ723QlKIPiDa0pkedQ: folds 
dfNim92Z6XK1/h5SFW5vDg: folds 
ljemhp25Zg+nlA9DLCIiUw: raises $0.50 to $0.75
4Ax0vobe1rLVIGZmkFINGA: calls $0.75
YwDw9cMqkbMznFK77rru4A: folds 
DdPXdieucQ+n99u1n3A+rQ: folds 
V6p0jQ/RhUsqpHLmXvEX4Q: folds 
sGFnnRCa1YAHAUmWgsW6Qg: folds 
*** FLOP *** [Kc 5s 2d]
ljemhp25Zg+nlA9DLCIiUw: checks 
4Ax0vobe1rLVIGZmkFINGA: checks 
*** TURN *** [Kc 5s 2d] [Kh]
ljemhp25Zg+nlA9DLCIiUw: checks 
4Ax0vobe1rLVIGZmkFINGA: checks 
*** RIVER *** [Kc 5s 2d Kh] [3c]
ljemhp25Zg+nlA9DLCIiUw: checks 
4Ax0vobe1rLVIGZmkFINGA: bets $1.50
ljemhp25Zg+nlA9DLCIiUw: folds 
Uncalled bet ($1.50) returned to 4Ax0vobe1rLVIGZmkFINGA
4Ax0vobe1rLVIGZmkFINGA collected $1.80 from pot
4Ax0vobe1rLVIGZmkFINGA: doesn't show hand 
*** SUMMARY ***
Total pot $1.85 | Rake $0.05 
Board [Kc 5s 2d Kh 3c]
Seat 1: sGFnnRCa1YAHAUmWgsW6Qg (big blind) folded before Flop
Seat 2: ghNKXUBl/H+t83JF079ZBA folded before Flop (didn't bet)
Seat 3: dYvYZ723QlKIPiDa0pkedQ folded before Flop (didn't bet)
Seat 4: dfNim92Z6XK1/h5SFW5vDg folded before Flop (didn't bet)
Seat 5: ljemhp25Zg+nlA9DLCIiUw folded on the River
Seat 6: 4Ax0vobe1rLVIGZmkFINGA collected ($1.80)
Seat 7: YwDw9cMqkbMznFK77rru4A folded before Flop (didn't bet)
Seat 8: DdPXdieucQ+n99u1n3A+rQ (button) folded before Flop (didn't bet)
Seat 9: V6p0jQ/RhUsqpHLmXvEX4Q (small blind) folded before Flop




PokerStars Game #59941602124:  Hold'em No Limit ($0.10/$0.25) - 2009/07/01 1:40:25 ET
Table '3eK1r4Q4BSYFvsKkuTLpIA' 9-max Seat #7 is the button
Seat 1: vSkQm2EelzwRGDDQQk0Fqw ($4.65 in chips) 
Seat 2: aNpwfA31EREwO+ar4XzBCw ($26.50 in chips) 
Seat 3: 56S3mA6Zs3pGR+0p0vUCtg ($32.55 in chips) 
Seat 4: +2kMBNpY4nF1qNCRd8SJLA ($25 in chips) 
Seat 5: 775TiRJajPtN/ucpTmHrXA ($14.75 in chips) 
Seat 6: +HvCCmsGSQeatf+GZ9zk8Q ($39.20 in chips) 
Seat 7: ljemhp25Zg+nlA9DLCIiUw ($24.65 in chips) 
Seat 8: /29aHLC+Q6KCDcNv2bPfAg ($12.90 in chips) 
Seat 9: +sbyWwIcFp9kP0bDtMegfQ ($60.75 in chips) 
/29aHLC+Q6KCDcNv2bPfAg: posts small blind $0.10
+sbyWwIcFp9kP0bDtMegfQ: posts big blind $0.25
*** HOLE CARDS ***
vSkQm2EelzwRGDDQQk0Fqw: folds 
aNpwfA31EREwO+ar4XzBCw: raises $0.75 to $1
56S3mA6Zs3pGR+0p0vUCtg: calls $1
+2kMBNpY4nF1qNCRd8SJLA: folds 
775TiRJajPtN/ucpTmHrXA: folds 
+HvCCmsGSQeatf+GZ9zk8Q: folds 
ljemhp25Zg+nlA9DLCIiUw: folds 
/29aHLC+Q6KCDcNv2bPfAg: folds 
+sbyWwIcFp9kP0bDtMegfQ: folds 
*** FLOP *** [Ks Kd 6h]
aNpwfA31EREwO+ar4XzBCw: bets $1.50
56S3mA6Zs3pGR+0p0vUCtg: folds 
Uncalled bet ($1.50) returned to aNpwfA31EREwO+ar4XzBCw
aNpwfA31EREwO+ar4XzBCw collected $2.25 from pot
aNpwfA31EREwO+ar4XzBCw: doesn't show hand 
*** SUMMARY ***
Total pot $2.35 | Rake $0.10 
Board [Ks Kd 6h]
Seat 1: vSkQm2EelzwRGDDQQk0Fqw folded before Flop (didn't bet)
Seat 2: aNpwfA31EREwO+ar4XzBCw collected ($2.25)
Seat 3: 56S3mA6Zs3pGR+0p0vUCtg folded on the Flop
Seat 4: +2kMBNpY4nF1qNCRd8SJLA folded before Flop (didn't bet)
Seat 5: 775TiRJajPtN/ucpTmHrXA folded before Flop (didn't bet)
Seat 6: +HvCCmsGSQeatf+GZ9zk8Q folded before Flop (didn't bet)
Seat 7: ljemhp25Zg+nlA9DLCIiUw (button) folded before Flop (didn't bet)
Seat 8: /29aHLC+Q6KCDcNv2bPfAg (small blind) folded before Flop
Seat 9: +sbyWwIcFp9kP0bDtMegfQ (big blind) folded before Flop




PokerStars Game #59941601950:  Hold'em No Limit ($0.10/$0.25) - 2009/07/01 1:40:25 ET
Table 'NtEQAxCeIK2io1CGtW658g' 6-max Seat #5 is the button
Seat 1: X437kMQ7AujoaDgjguhU9w ($11.80 in chips) 
Seat 3: m2yWOKfAxqHoy5DDN87Ttw ($37.65 in chips) 
Seat 4: 8296 ($12.15 in chips) 
Seat 5: Hsvkc0/G2VV78oVmWYXecw ($5 in chips) 
Seat 6: /gJNBeCkWL4o85/jvlZ4BA ($64.60 in chips) 
/gJNBeCkWL4o85/jvlZ4BA: posts small blind $0.10
X437kMQ7AujoaDgjguhU9w: posts big blind $0.25
*** HOLE CARDS ***
m2yWOKfAxqHoy5DDN87Ttw: folds 
8296: folds 
Hsvkc0/G2VV78oVmWYXecw: folds 
/gJNBeCkWL4o85/jvlZ4BA: folds 
Uncalled bet ($0.15) returned to X437kMQ7AujoaDgjguhU9w
X437kMQ7AujoaDgjguhU9w collected $0.20 from pot
X437kMQ7AujoaDgjguhU9w: doesn't show hand 
*** SUMMARY ***
Total pot $0.20 | Rake $0 
Seat 1: X437kMQ7AujoaDgjguhU9w (big blind) collected ($0.20)
Seat 3: m2yWOKfAxqHoy5DDN87Ttw folded before Flop (didn't bet)
Seat 4: 8296 folded before Flop (didn't bet)
Seat 5: Hsvkc0/G2VV78oVmWYXecw (button) folded before Flop (didn't bet)
Seat 6: /gJNBeCkWL4o85/jvlZ4BA (small blind) folded before Flop




PokerStars Game #59941602228:  Hold'em No Limit ($0.10/$0.25) - 2009/07/01 1:40:25 ET
Table 'O5NgMYt6EWbLBozZb3kseg' 6-max Seat #3 is the button
Seat 1: MCCWc70bl051s/EF6nHRcA ($26.80 in chips) 
Seat 2: /gJNBeCkWL4o85/jvlZ4BA ($34.50 in chips) 
Seat 3: tLM9aw7T3kBEIhQEh1roOg ($6.50 in chips) 
Seat 4: txiWmlZ/sfM8Td16RHH/cA ($3.20 in chips) 
Seat 5: vu2kzHaDtgr6NM7rdq0chA ($85.55 in chips) 
Seat 6: k9vn40MOqqb+xF+7GZ6v2g ($118.25 in chips) 
txiWmlZ/sfM8Td16RHH/cA: posts small blind $0.10
vu2kzHaDtgr6NM7rdq0chA: posts big blind $0.25
*** HOLE CARDS ***
k9vn40MOqqb+xF+7GZ6v2g: folds 
MCCWc70bl051s/EF6nHRcA: raises $0.25 to $0.50
/gJNBeCkWL4o85/jvlZ4BA: folds 
tLM9aw7T3kBEIhQEh1roOg: folds 
txiWmlZ/sfM8Td16RHH/cA: folds 
vu2kzHaDtgr6NM7rdq0chA: folds 
Uncalled bet ($0.25) returned to MCCWc70bl051s/EF6nHRcA
MCCWc70bl051s/EF6nHRcA collected $0.60 from pot
MCCWc70bl051s/EF6nHRcA: shows [As Ad] (a pair of Aces)
*** SUMMARY ***
Total pot $0.60 | Rake $0 
Seat 1: MCCWc70bl051s/EF6nHRcA collected ($0.60)
Seat 2: /gJNBeCkWL4o85/jvlZ4BA folded before Flop (didn't bet)
Seat 3: tLM9aw7T3kBEIhQEh1roOg (button) folded before Flop (didn't bet)
Seat 4: txiWmlZ/sfM8Td16RHH/cA (small blind) folded before Flop
Seat 5: vu2kzHaDtgr6NM7rdq0chA (big blind) folded before Flop
Seat 6: k9vn40MOqqb+xF+7GZ6v2g folded before Flop (didn't bet)




PokerStars Game #59941601932:  Hold'em No Limit ($0.10/$0.25) - 2009/07/01 1:40:25 ET
Table '60nA7av6bws9VnNmVwculA' 6-max Seat #4 is the button
Seat 1: if4dh6jhJXeN3/qd3qCp9g ($27.10 in chips) 
Seat 2: Bada343Si4xKu3fNXY99AA ($5.10 in chips) 
Seat 3: OUv909q/YxsJgxpSlZxLJQ ($30.50 in chips) 
Seat 4: +baiVgI/ETnBARLe5mARCw ($14 in chips) 
Seat 5: zXh+lOT41Q2iWgCNj+OcRw ($11.40 in chips) 
Seat 6: mfrkWA3PTeYPkbO6hi98Aw ($24.65 in chips) 
zXh+lOT41Q2iWgCNj+OcRw: posts small blind $0.10
mfrkWA3PTeYPkbO6hi98Aw: posts big blind $0.25
*** HOLE CARDS ***
if4dh6jhJXeN3/qd3qCp9g: raises $0.75 to $1
Bada343Si4xKu3fNXY99AA: folds 
OUv909q/YxsJgxpSlZxLJQ: folds 
+baiVgI/ETnBARLe5mARCw: calls $1
zXh+lOT41Q2iWgCNj+OcRw: folds 
mfrkWA3PTeYPkbO6hi98Aw: folds 
*** FLOP *** [5h 5s 6s]
if4dh6jhJXeN3/qd3qCp9g: bets $1.50
+baiVgI/ETnBARLe5mARCw: calls $1.50
*** TURN *** [5h 5s 6s] [4d]
if4dh6jhJXeN3/qd3qCp9g: checks 
+baiVgI/ETnBARLe5mARCw: bets $2.50
if4dh6jhJXeN3/qd3qCp9g: calls $2.50
*** RIVER *** [5h 5s 6s 4d] [Qh]
if4dh6jhJXeN3/qd3qCp9g: checks 
+baiVgI/ETnBARLe5mARCw: bets $9 and is all-in
if4dh6jhJXeN3/qd3qCp9g: folds 
Uncalled bet ($9) returned to +baiVgI/ETnBARLe5mARCw
+baiVgI/ETnBARLe5mARCw collected $9.85 from pot
+baiVgI/ETnBARLe5mARCw: doesn't show hand 
*** SUMMARY ***
Total pot $10.35 | Rake $0.50 
Board [5h 5s 6s 4d Qh]
Seat 1: if4dh6jhJXeN3/qd3qCp9g folded on the River
Seat 2: Bada343Si4xKu3fNXY99AA folded before Flop (didn't bet)
Seat 3: OUv909q/YxsJgxpSlZxLJQ folded before Flop (didn't bet)
Seat 4: +baiVgI/ETnBARLe5mARCw (button) collected ($9.85)
Seat 5: zXh+lOT41Q2iWgCNj+OcRw (small blind) folded before Flop
Seat 6: mfrkWA3PTeYPkbO6hi98Aw (big blind) folded before Flop




PokerStars Game #59941602392:  Hold'em No Limit ($0.10/$0.25) - 2009/07/01 1:40:25 ET
Table 'KEoOIegxPF91KooL2AelUA' 6-max Seat #3 is the button
Seat 1: wsP46AGpqDjHZQmlRHKa9g ($40.30 in chips) 
Seat 2: 0Bg59Tnte1Tc7C4i9Jd9cQ ($5.55 in chips) 
Seat 3: zxeVQGaMKDsDzmSY+AInjA ($12.80 in chips) 
Seat 4: Wo60l2GQnSEc3bxPVyvIUw ($19.35 in chips) 
Seat 5: 08V++DOqzaNrRNsHIwi25w ($44.20 in chips) 
Seat 6: AMrBn4Vx9aAo/vv6WHLk6w ($3.65 in chips) 
Wo60l2GQnSEc3bxPVyvIUw: posts small blind $0.10
08V++DOqzaNrRNsHIwi25w: posts big blind $0.25
0Bg59Tnte1Tc7C4i9Jd9cQ: posts small & big blinds $0.35
*** HOLE CARDS ***
AMrBn4Vx9aAo/vv6WHLk6w: folds 
wsP46AGpqDjHZQmlRHKa9g: folds 
0Bg59Tnte1Tc7C4i9Jd9cQ: checks 
zxeVQGaMKDsDzmSY+AInjA: folds 
Wo60l2GQnSEc3bxPVyvIUw: calls $0.15
08V++DOqzaNrRNsHIwi25w: checks 
*** FLOP *** [7c 6c 3s]
Wo60l2GQnSEc3bxPVyvIUw: checks 
08V++DOqzaNrRNsHIwi25w: bets $0.75
0Bg59Tnte1Tc7C4i9Jd9cQ: folds 
Wo60l2GQnSEc3bxPVyvIUw: folds 
Uncalled bet ($0.75) returned to 08V++DOqzaNrRNsHIwi25w
08V++DOqzaNrRNsHIwi25w collected $0.85 from pot
08V++DOqzaNrRNsHIwi25w: doesn't show hand 
*** SUMMARY ***
Total pot $0.85 | Rake $0 
Board [7c 6c 3s]
Seat 1: wsP46AGpqDjHZQmlRHKa9g folded before Flop (didn't bet)
Seat 2: 0Bg59Tnte1Tc7C4i9Jd9cQ folded on the Flop
Seat 3: zxeVQGaMKDsDzmSY+AInjA (button) folded before Flop (didn't bet)
Seat 4: Wo60l2GQnSEc3bxPVyvIUw (small blind) folded on the Flop
Seat 5: 08V++DOqzaNrRNsHIwi25w (big blind) collected ($0.85)
Seat 6: AMrBn4Vx9aAo/vv6WHLk6w folded before Flop (didn't bet)




PokerStars Game #59941601876:  Hold'em No Limit ($0.10/$0.25) - 2009/07/01 1:40:25 ET
Table 'oG007Tb0LYbfANo6QWd16wWEMI3Mtn7dGARDbgNrKibgx Seat #8 is the button
Seat 1: DiSvPC2iudwL5j9u6Huyww ($48.25 in chips) 
Seat 2: zDrucyjVn5aeekNEc3cJrA ($14.50 in chips) 
Seat 4: zgi+EUykT/pZQpoUG6+oEg ($4.40 in chips) 
Seat 5: 8f0dtuUGqDbgE6up1lQAlg ($6.60 in chips) 
Seat 7: Mh2r9hTeTEDnh19sRZtW3g ($5 in chips) 
Seat 8: q4cNXFZGNhLfrTyVrIy6Mg ($9.10 in chips) 
Seat 9: EVqHvqty1ZsuvDFiSXlSqQ ($20.20 in chips) 
EVqHvqty1ZsuvDFiSXlSqQ: posts small blind $0.10
DiSvPC2iudwL5j9u6Huyww: posts big blind $0.25
pN3IHvAKm2fz+sTRARTcrg: sits out 
Mh2r9hTeTEDnh19sRZtW3g: posts big blind $0.25
*** HOLE CARDS ***
zDrucyjVn5aeekNEc3cJrA: folds 
zgi+EUykT/pZQpoUG6+oEg: folds 
8f0dtuUGqDbgE6up1lQAlg: calls $0.25
Mh2r9hTeTEDnh19sRZtW3g: checks 
q4cNXFZGNhLfrTyVrIy6Mg: calls $0.25
EVqHvqty1ZsuvDFiSXlSqQ: folds 
DiSvPC2iudwL5j9u6Huyww: raises $1.25 to $1.50
8f0dtuUGqDbgE6up1lQAlg: folds 
Mh2r9hTeTEDnh19sRZtW3g: folds 
q4cNXFZGNhLfrTyVrIy6Mg: calls $1.25
*** FLOP *** [9d 9s 8s]
DiSvPC2iudwL5j9u6Huyww: checks 
q4cNXFZGNhLfrTyVrIy6Mg: checks 
*** TURN *** [9d 9s 8s] [3h]
DiSvPC2iudwL5j9u6Huyww: checks 
q4cNXFZGNhLfrTyVrIy6Mg: checks 
*** RIVER *** [9d 9s 8s 3h] [Jd]
DiSvPC2iudwL5j9u6Huyww: checks 
q4cNXFZGNhLfrTyVrIy6Mg: checks 
*** SHOW DOWN ***
DiSvPC2iudwL5j9u6Huyww: shows [Ks As] (a pair of Nines)
q4cNXFZGNhLfrTyVrIy6Mg: shows [4d 4h] (two pair, Nines and Fours)
q4cNXFZGNhLfrTyVrIy6Mg collected $3.45 from pot
*** SUMMARY ***
Total pot $3.60 | Rake $0.15 
Board [9d 9s 8s 3h Jd]
Seat 1: DiSvPC2iudwL5j9u6Huyww (big blind) showed [Ks As] and lost with a pair of Nines
Seat 2: zDrucyjVn5aeekNEc3cJrA folded before Flop (didn't bet)
Seat 4: zgi+EUykT/pZQpoUG6+oEg folded before Flop (didn't bet)
Seat 5: 8f0dtuUGqDbgE6up1lQAlg folded before Flop
Seat 7: Mh2r9hTeTEDnh19sRZtW3g folded before Flop
Seat 8: q4cNXFZGNhLfrTyVrIy6Mg (button) showed [4d 4h] and won ($3.45) with two pair, Nines and Fours
Seat 9: EVqHvqty1ZsuvDFiSXlSqQ (small blind) folded before Flop




PokerStars Game #59941602544:  Hold'em No Limit ($0.10/$0.25) - 2009/07/01 1:40:26 ET
Table '9iHhO6FyZVM8XpSc23TIgg' 6-max Seat #5 is the button
Seat 1: NhUN/JpAprdJeamFBgJH1w ($44.25 in chips) 
Seat 2: bJFzs6QmEEnz4miMfSDtcg ($38.55 in chips) 
Seat 3: TSmua8tGK3sTbwi0ynrW9Q ($26.85 in chips) 
Seat 4: cfJccEfyn6IkquPN08hFsA ($57.40 in chips) 
Seat 5: xrf8tAXKQHG99HixCot1Iw ($21.80 in chips) 
Seat 6: iyZxqznXjv3vtvOJymkoLQ ($34.20 in chips) 
iyZxqznXjv3vtvOJymkoLQ: posts small blind $0.10
NhUN/JpAprdJeamFBgJH1w: posts big blind $0.25
cfJccEfyn6IkquPN08hFsA: posts small & big blinds $0.35
*** HOLE CARDS ***
bJFzs6QmEEnz4miMfSDtcg: calls $0.25
TSmua8tGK3sTbwi0ynrW9Q: folds 
cfJccEfyn6IkquPN08hFsA: checks 
xrf8tAXKQHG99HixCot1Iw: folds 
iyZxqznXjv3vtvOJymkoLQ: folds 
NhUN/JpAprdJeamFBgJH1w: checks 
*** FLOP *** [5h Tc Kh]
NhUN/JpAprdJeamFBgJH1w: bets $0.75
bJFzs6QmEEnz4miMfSDtcg: folds 
cfJccEfyn6IkquPN08hFsA: calls $0.75
*** TURN *** [5h Tc Kh] [9c]
NhUN/JpAprdJeamFBgJH1w: bets $2.50
cfJccEfyn6IkquPN08hFsA: raises $3.25 to $5.75
NhUN/JpAprdJeamFBgJH1w: calls $3.25
*** RIVER *** [5h Tc Kh 9c] [8h]
NhUN/JpAprdJeamFBgJH1w: checks 
cfJccEfyn6IkquPN08hFsA: checks 
*** SHOW DOWN ***
NhUN/JpAprdJeamFBgJH1w: shows [Qs Kc] (a pair of Kings)
cfJccEfyn6IkquPN08hFsA: shows [9s Ts] (two pair, Tens and Nines)
cfJccEfyn6IkquPN08hFsA collected $13.30 from pot
*** SUMMARY ***
Total pot $13.95 | Rake $0.65 
Board [5h Tc Kh 9c 8h]
Seat 1: NhUN/JpAprdJeamFBgJH1w (big blind) showed [Qs Kc] and lost with a pair of Kings
Seat 2: bJFzs6QmEEnz4miMfSDtcg folded on the Flop
Seat 3: TSmua8tGK3sTbwi0ynrW9Q folded before Flop (didn't bet)
Seat 4: cfJccEfyn6IkquPN08hFsA showed [9s Ts] and won ($13.30) with two pair, Tens and Nines
Seat 5: xrf8tAXKQHG99HixCot1Iw (button) folded before Flop (didn't bet)
Seat 6: iyZxqznXjv3vtvOJymkoLQ (small blind) folded before Flop




PokerStars Game #59941602490:  Hold'em No Limit ($0.10/$0.25) - 2009/07/01 1:40:26 ET
Table 'isKy4XK8wJM0x735/D4hWA' 6-max Seat #5 is the button
Seat 1: kwsRmpZ1ZaLooISs+zfyKg ($26.15 in chips) 
Seat 2: 6elpmfyt4Zw0yvd8lePSMQ ($20.55 in chips) 
Seat 3: jp34e617tIzV8tKIWmfAbA ($45 in chips) 
Seat 4: DFi/Lzkjsfv8QswS80JX9Q ($30.75 in chips) 
Seat 5: lquriepNQBhDV5P1SWHhnA ($25.60 in chips) 
Seat 6: GbCVUNssQ7mqsPWr7J4d3w ($4.75 in chips) 
GbCVUNssQ7mqsPWr7J4d3w: posts small blind $0.10
kwsRmpZ1ZaLooISs+zfyKg: posts big blind $0.25
*** HOLE CARDS ***
6elpmfyt4Zw0yvd8lePSMQ: calls $0.25
jp34e617tIzV8tKIWmfAbA: folds 
DFi/Lzkjsfv8QswS80JX9Q: folds 
lquriepNQBhDV5P1SWHhnA: folds 
GbCVUNssQ7mqsPWr7J4d3w: folds 
kwsRmpZ1ZaLooISs+zfyKg: raises $0.75 to $1
6elpmfyt4Zw0yvd8lePSMQ: calls $0.75
*** FLOP *** [9h Qh 5s]
kwsRmpZ1ZaLooISs+zfyKg: bets $1
6elpmfyt4Zw0yvd8lePSMQ: raises $1.50 to $2.50
kwsRmpZ1ZaLooISs+zfyKg: folds 
Uncalled bet ($1.50) returned to 6elpmfyt4Zw0yvd8lePSMQ
6elpmfyt4Zw0yvd8lePSMQ collected $3.90 from pot
6elpmfyt4Zw0yvd8lePSMQ: doesn't show hand 
*** SUMMARY ***
Total pot $4.10 | Rake $0.20 
Board [9h Qh 5s]
Seat 1: kwsRmpZ1ZaLooISs+zfyKg (big blind) folded on the Flop
Seat 2: 6elpmfyt4Zw0yvd8lePSMQ collected ($3.90)
Seat 3: jp34e617tIzV8tKIWmfAbA folded before Flop (didn't bet)
Seat 4: DFi/Lzkjsfv8QswS80JX9Q folded before Flop (didn't bet)
Seat 5: lquriepNQBhDV5P1SWHhnA (button) folded before Flop (didn't bet)
Seat 6: GbCVUNssQ7mqsPWr7J4d3w (small blind) folded before Flop




PokerStars Game #59941602478:  Hold'em No Limit ($0.10/$0.25) - 2009/07/01 1:40:26 ET
Table 'gnrUwXkIPE0C8xl6cB4Hyw' 9-max Seat #3 is the button
Seat 1: EQXHDnIzAsORnIXRNtXRlA ($22.60 in chips) 
Seat 2: 7je+LC5Mfs6nL8YBVh4frQ ($5 in chips) 
Seat 3: PdIasPkzm2sqZnN41ZRXOg ($5 in chips) 
Seat 4: wGigCmBR/9XWkPpvYos3aQ ($25.10 in chips) 
Seat 5: gehe91e0IyVT0QU/XBkEyg ($27.50 in chips) 
Seat 6: dtZ84flFEi4Q+SGrHMJRDQ ($26.15 in chips) 
Seat 7: OXPkK84/qv92EMwXPiG5rQ ($10.10 in chips) 
Seat 8: 4awUyiDYTgylQKXZ9faBVA ($56.20 in chips) 
Seat 9: F7pnn6czNpHvRM55XcA2EA ($28.10 in chips) 
wGigCmBR/9XWkPpvYos3aQ: posts small blind $0.10
gehe91e0IyVT0QU/XBkEyg: posts big blind $0.25
*** HOLE CARDS ***
dtZ84flFEi4Q+SGrHMJRDQ: folds 
OXPkK84/qv92EMwXPiG5rQ: folds 
4awUyiDYTgylQKXZ9faBVA: folds 
F7pnn6czNpHvRM55XcA2EA: folds 
EQXHDnIzAsORnIXRNtXRlA: folds 
7je+LC5Mfs6nL8YBVh4frQ: folds 
PdIasPkzm2sqZnN41ZRXOg: folds 
wGigCmBR/9XWkPpvYos3aQ: raises $0.65 to $0.90
gehe91e0IyVT0QU/XBkEyg: folds 
Uncalled bet ($0.65) returned to wGigCmBR/9XWkPpvYos3aQ
wGigCmBR/9XWkPpvYos3aQ collected $0.50 from pot
wGigCmBR/9XWkPpvYos3aQ: doesn't show hand 
*** SUMMARY ***
Total pot $0.50 | Rake $0 
Seat 1: EQXHDnIzAsORnIXRNtXRlA folded before Flop (didn't bet)
Seat 2: 7je+LC5Mfs6nL8YBVh4frQ folded before Flop (didn't bet)
Seat 3: PdIasPkzm2sqZnN41ZRXOg (button) folded before Flop (didn't bet)
Seat 4: wGigCmBR/9XWkPpvYos3aQ (small blind) collected ($0.50)
Seat 5: gehe91e0IyVT0QU/XBkEyg (big blind) folded before Flop
Seat 6: dtZ84flFEi4Q+SGrHMJRDQ folded before Flop (didn't bet)
Seat 7: OXPkK84/qv92EMwXPiG5rQ folded before Flop (didn't bet)
Seat 8: 4awUyiDYTgylQKXZ9faBVA folded before Flop (didn't bet)
Seat 9: F7pnn6czNpHvRM55XcA2EA folded before Flop (didn't bet)




PokerStars Game #59941602994:  Hold'em No Limit ($0.10/$0.25) - 2009/07/01 1:40:26 ET
Table 'G26g8jde1eR+mmabeFeSlw' 9-max Seat #2 is the button
Seat 1: qpG9m8I+cPw8VhB0mnGjYw ($29.40 in chips) 
Seat 2: BFYwQ0J4xWUQvouudojivA ($15.85 in chips) 
Seat 3: WKL8nUFr7TumC4EjLyqYzw ($6.60 in chips) 
Seat 4: 8EbrQ/EvFWt2cr0GaU82gQ ($5 in chips) 
Seat 5: hJ4uYjNmSZdjrKA8cjZqCA ($28.65 in chips) 
Seat 6: AHGkesF/mi4sDMpqrxBUoA ($9.05 in chips) 
Seat 7: nm4Dj/f+jJEwKVsUnKh73g ($38.80 in chips) 
Seat 8: bXpVeaSTPBFSPJmeXxO7nw ($5 in chips) 
Seat 9: VWUWpMLMj/Q1jRVpF7Aohw ($6.15 in chips) 
WKL8nUFr7TumC4EjLyqYzw: posts small blind $0.10
8EbrQ/EvFWt2cr0GaU82gQ: posts big blind $0.25
*** HOLE CARDS ***
hJ4uYjNmSZdjrKA8cjZqCA: folds 
AHGkesF/mi4sDMpqrxBUoA: folds 
nm4Dj/f+jJEwKVsUnKh73g: folds 
bXpVeaSTPBFSPJmeXxO7nw: raises $4.75 to $5 and is all-in
VWUWpMLMj/Q1jRVpF7Aohw: folds 
qpG9m8I+cPw8VhB0mnGjYw: folds 
BFYwQ0J4xWUQvouudojivA: folds 
WKL8nUFr7TumC4EjLyqYzw: folds 
8EbrQ/EvFWt2cr0GaU82gQ: folds 
Uncalled bet ($4.75) returned to bXpVeaSTPBFSPJmeXxO7nw
bXpVeaSTPBFSPJmeXxO7nw collected $0.60 from pot
bXpVeaSTPBFSPJmeXxO7nw: doesn't show hand 
*** SUMMARY ***
Total pot $0.60 | Rake $0 
Seat 1: qpG9m8I+cPw8VhB0mnGjYw folded before Flop (didn't bet)
Seat 2: BFYwQ0J4xWUQvouudojivA (button) folded before Flop (didn't bet)
Seat 3: WKL8nUFr7TumC4EjLyqYzw (small blind) folded before Flop
Seat 4: 8EbrQ/EvFWt2cr0GaU82gQ (big blind) folded before Flop
Seat 5: hJ4uYjNmSZdjrKA8cjZqCA folded before Flop (didn't bet)
Seat 6: AHGkesF/mi4sDMpqrxBUoA folded before Flop (didn't bet)
Seat 7: nm4Dj/f+jJEwKVsUnKh73g folded before Flop (didn't bet)
Seat 8: bXpVeaSTPBFSPJmeXxO7nw collected ($0.60)
Seat 9: VWUWpMLMj/Q1jRVpF7Aohw folded before Flop (didn't bet)




PokerStars Game #59941602568:  Hold'em No Limit ($0.10/$0.25) - 2009/07/01 1:40:26 ET
Table 'z2yOdY2zyGWG1gh9WV9XtQ' 9-max Seat #7 is the button
Seat 1: 7je+LC5Mfs6nL8YBVh4frQ ($5 in chips) 
Seat 2: bXpVeaSTPBFSPJmeXxO7nw ($5 in chips) 
Seat 3: X78b5v/uhqeXXoAijbw/yg ($27.75 in chips) 
Seat 4: 4awUyiDYTgylQKXZ9faBVA ($39.45 in chips) 
Seat 5: W6tExOcYX7qiy6Qdp+ZwFA ($10.55 in chips) 
Seat 6: NBYmTySMtIicyMj5Vjzqhw ($21.80 in chips) 
Seat 7: zDrucyjVn5aeekNEc3cJrA ($23.35 in chips) 
Seat 8: Mh2r9hTeTEDnh19sRZtW3g ($7.25 in chips) 
Seat 9: wGigCmBR/9XWkPpvYos3aQ ($34.05 in chips) 
Mh2r9hTeTEDnh19sRZtW3g: posts small blind $0.10
wGigCmBR/9XWkPpvYos3aQ: posts big blind $0.25
*** HOLE CARDS ***
7je+LC5Mfs6nL8YBVh4frQ: folds 
bXpVeaSTPBFSPJmeXxO7nw: folds 
X78b5v/uhqeXXoAijbw/yg: folds 
4awUyiDYTgylQKXZ9faBVA: folds 
W6tExOcYX7qiy6Qdp+ZwFA: folds 
NBYmTySMtIicyMj5Vjzqhw: folds 
zDrucyjVn5aeekNEc3cJrA: folds 
zDrucyjVn5aeekNEc3cJrA is sitting out
Mh2r9hTeTEDnh19sRZtW3g: folds 
Uncalled bet ($0.15) returned to wGigCmBR/9XWkPpvYos3aQ
wGigCmBR/9XWkPpvYos3aQ collected $0.20 from pot
wGigCmBR/9XWkPpvYos3aQ: doesn't show hand 
*** SUMMARY ***
Total pot $0.20 | Rake $0 
Seat 1: 7je+LC5Mfs6nL8YBVh4frQ folded before Flop (didn't bet)
Seat 2: bXpVeaSTPBFSPJmeXxO7nw folded before Flop (didn't bet)
Seat 3: X78b5v/uhqeXXoAijbw/yg folded before Flop (didn't bet)
Seat 4: 4awUyiDYTgylQKXZ9faBVA folded before Flop (didn't bet)
Seat 5: W6tExOcYX7qiy6Qdp+ZwFA folded before Flop (didn't bet)
Seat 6: NBYmTySMtIicyMj5Vjzqhw folded before Flop (didn't bet)
Seat 7: zDrucyjVn5aeekNEc3cJrA (button) folded before Flop (didn't bet)
Seat 8: Mh2r9hTeTEDnh19sRZtW3g (small blind) folded before Flop
Seat 9: wGigCmBR/9XWkPpvYos3aQ (big blind) collected ($0.20)




PokerStars Game #59941603016:  Hold'em No Limit ($0.10/$0.25) - 2009/07/01 1:40:27 ET
Table 'a6FCGVBMPcT7J7BDN9q1zQ' 9-max Seat #6 is the button
Seat 1: zgi+EUykT/pZQpoUG6+oEg ($5.15 in chips) 
Seat 2: M2QO2DxB5Wawg2h8HSpnYA ($10 in chips) 
Seat 3: tLcDklc2rBORNfixyRfVfw ($26.15 in chips) 
Seat 4: 8CoKLhwk8Ja6X+O9fxTEDg ($11.30 in chips) 
Seat 5: dtZ84flFEi4Q+SGrHMJRDQ ($27.05 in chips) 
Seat 6: dfNim92Z6XK1/h5SFW5vDg ($25.90 in chips) 
Seat 7: V0Yo5zRBVM8DYspLKafebg ($4.45 in chips) 
Seat 8: r6hsffOo1iKmaPYKwAZmFw ($69.75 in chips) 
Seat 9: wGigCmBR/9XWkPpvYos3aQ ($28.70 in chips) 
V0Yo5zRBVM8DYspLKafebg: posts small blind $0.10
r6hsffOo1iKmaPYKwAZmFw: posts big blind $0.25
*** HOLE CARDS ***
wGigCmBR/9XWkPpvYos3aQ: folds 
zgi+EUykT/pZQpoUG6+oEg: folds 
M2QO2DxB5Wawg2h8HSpnYA: folds 
tLcDklc2rBORNfixyRfVfw: folds 
8CoKLhwk8Ja6X+O9fxTEDg: calls $0.25
dtZ84flFEi4Q+SGrHMJRDQ: folds 
dfNim92Z6XK1/h5SFW5vDg: folds 
V0Yo5zRBVM8DYspLKafebg: calls $0.15
r6hsffOo1iKmaPYKwAZmFw: checks 
*** FLOP *** [4d 5s 2c]
V0Yo5zRBVM8DYspLKafebg: checks 
r6hsffOo1iKmaPYKwAZmFw: checks 
8CoKLhwk8Ja6X+O9fxTEDg: checks 
*** TURN *** [4d 5s 2c] [Jh]
V0Yo5zRBVM8DYspLKafebg: checks 
r6hsffOo1iKmaPYKwAZmFw: checks 
8CoKLhwk8Ja6X+O9fxTEDg: checks 
*** RIVER *** [4d 5s 2c Jh] [Jc]
V0Yo5zRBVM8DYspLKafebg: checks 
r6hsffOo1iKmaPYKwAZmFw: checks 
8CoKLhwk8Ja6X+O9fxTEDg: checks 
*** SHOW DOWN ***
V0Yo5zRBVM8DYspLKafebg: shows [9d 8c] (a pair of Jacks)
r6hsffOo1iKmaPYKwAZmFw: shows [Ks 8h] (a pair of Jacks - King kicker)
8CoKLhwk8Ja6X+O9fxTEDg: shows [Ts Kh] (a pair of Jacks - King+Ten kicker)
8CoKLhwk8Ja6X+O9fxTEDg collected $0.75 from pot
*** SUMMARY ***
Total pot $0.75 | Rake $0 
Board [4d 5s 2c Jh Jc]
Seat 1: zgi+EUykT/pZQpoUG6+oEg folded before Flop (didn't bet)
Seat 2: M2QO2DxB5Wawg2h8HSpnYA folded before Flop (didn't bet)
Seat 3: tLcDklc2rBORNfixyRfVfw folded before Flop (didn't bet)
Seat 4: 8CoKLhwk8Ja6X+O9fxTEDg showed [Ts Kh] and won ($0.75) with a pair of Jacks
Seat 5: dtZ84flFEi4Q+SGrHMJRDQ folded before Flop (didn't bet)
Seat 6: dfNim92Z6XK1/h5SFW5vDg (button) folded before Flop (didn't bet)
Seat 7: V0Yo5zRBVM8DYspLKafebg (small blind) showed [9d 8c] and lost with a pair of Jacks
Seat 8: r6hsffOo1iKmaPYKwAZmFw (big blind) showed [Ks 8h] and lost with a pair of Jacks
Seat 9: wGigCmBR/9XWkPpvYos3aQ folded before Flop (didn't bet)




PokerStars Game #59941603422:  Hold'em No Limit ($0.10/$0.25) - 2009/07/01 1:40:27 ET
Table 'Ok3oDLIsTc2+KxPcI0bAOA' 6-max Seat #6 is the button
Seat 1: agQm3ugZ3qSVYNgNu1ddeA ($41.85 in chips) 
Seat 3: lquriepNQBhDV5P1SWHhnA ($26.60 in chips) 
Seat 4: LJI7A1YgDM7hgh7o56+ReQ ($38.50 in chips) 
Seat 5: DFi/Lzkjsfv8QswS80JX9Q ($28.25 in chips) 
Seat 6: Hsvkc0/G2VV78oVmWYXecw ($5.30 in chips) 
agQm3ugZ3qSVYNgNu1ddeA: posts small blind $0.10
lquriepNQBhDV5P1SWHhnA: posts big blind $0.25
*** HOLE CARDS ***
LJI7A1YgDM7hgh7o56+ReQ: folds 
DFi/Lzkjsfv8QswS80JX9Q: folds 
Hsvkc0/G2VV78oVmWYXecw: folds 
agQm3ugZ3qSVYNgNu1ddeA: raises $0.50 to $0.75
lquriepNQBhDV5P1SWHhnA: folds 
Uncalled bet ($0.50) returned to agQm3ugZ3qSVYNgNu1ddeA
agQm3ugZ3qSVYNgNu1ddeA collected $0.50 from pot
agQm3ugZ3qSVYNgNu1ddeA: doesn't show hand 
*** SUMMARY ***
Total pot $0.50 | Rake $0 
Seat 1: agQm3ugZ3qSVYNgNu1ddeA (small blind) collected ($0.50)
Seat 3: lquriepNQBhDV5P1SWHhnA (big blind) folded before Flop
Seat 4: LJI7A1YgDM7hgh7o56+ReQ folded before Flop (didn't bet)
Seat 5: DFi/Lzkjsfv8QswS80JX9Q folded before Flop (didn't bet)
Seat 6: Hsvkc0/G2VV78oVmWYXecw (button) folded before Flop (didn't bet)




PokerStars Game #59941603532:  Hold'em No Limit ($0.10/$0.25) - 2009/07/01 1:40:27 ET
Table '/JJyyIstHfkT7t/bW+WXgg' 6-max Seat #2 is the button
Seat 1: wsP46AGpqDjHZQmlRHKa9g ($25.35 in chips) 
Seat 2: obJgSnVgWWWaAUtVILo77Q ($7.75 in chips) 
Seat 3: DR0nVIhVP77oEBlO9J8vlg ($45.90 in chips) 
Seat 4: JFIAqU8lCZ0vWwEl4bdGsg ($35.75 in chips) 
Seat 5: +ZlnqPoP3Hg4BIUxDfKd/A ($48.50 in chips) 
DR0nVIhVP77oEBlO9J8vlg: posts small blind $0.10
JFIAqU8lCZ0vWwEl4bdGsg: posts big blind $0.25
*** HOLE CARDS ***
+ZlnqPoP3Hg4BIUxDfKd/A: folds 
wsP46AGpqDjHZQmlRHKa9g: calls $0.25
obJgSnVgWWWaAUtVILo77Q: folds 
DR0nVIhVP77oEBlO9J8vlg: calls $0.15
JFIAqU8lCZ0vWwEl4bdGsg: checks 
*** FLOP *** [Jh 2d 4h]
DR0nVIhVP77oEBlO9J8vlg: checks 
JFIAqU8lCZ0vWwEl4bdGsg: checks 
wsP46AGpqDjHZQmlRHKa9g: checks 
*** TURN *** [Jh 2d 4h] [5d]
d338A2rm6NtA1ECEZi4d2g leaves the table
DR0nVIhVP77oEBlO9J8vlg: checks 
UmcUp27+PbgBItv3ZNlAWQ joins the table at seat #6 
JFIAqU8lCZ0vWwEl4bdGsg: checks 
wsP46AGpqDjHZQmlRHKa9g: bets $0.75
DR0nVIhVP77oEBlO9J8vlg: folds 
JFIAqU8lCZ0vWwEl4bdGsg: folds 
Uncalled bet ($0.75) returned to wsP46AGpqDjHZQmlRHKa9g
wsP46AGpqDjHZQmlRHKa9g collected $0.75 from pot
*** SUMMARY ***
Total pot $0.75 | Rake $0 
Board [Jh 2d 4h 5d]
Seat 1: wsP46AGpqDjHZQmlRHKa9g collected ($0.75)
Seat 2: obJgSnVgWWWaAUtVILo77Q (button) folded before Flop (didn't bet)
Seat 3: DR0nVIhVP77oEBlO9J8vlg (small blind) folded on the Turn
Seat 4: JFIAqU8lCZ0vWwEl4bdGsg (big blind) folded on the Turn
Seat 5: +ZlnqPoP3Hg4BIUxDfKd/A folded before Flop (didn't bet)




PokerStars Game #59941603154:  Hold'em No Limit ($0.10/$0.25) - 2009/07/01 1:40:27 ET
Table '5VWnrlxdjwVfMWkVS2WE7A' 6-max Seat #6 is the button
Seat 1: 82p+w3EmUaFFHuwpSeGY1w ($5.25 in chips) 
Seat 2: LJI7A1YgDM7hgh7o56+ReQ ($26.35 in chips) 
Seat 3: SFmT9ZsVopnukjvAzrxTRg ($36.30 in chips) 
Seat 4: Pb/gJ3OxOZx57fFp0MDgkg ($35.60 in chips) 
Seat 5: SgMFmwYtNvq9Y+2ZxPSiWQ ($21.85 in chips) 
Seat 6: LtASJ9OlkqGrrUKGQlpGAw ($11.85 in chips) 
82p+w3EmUaFFHuwpSeGY1w: posts small blind $0.10
LJI7A1YgDM7hgh7o56+ReQ: posts big blind $0.25
*** HOLE CARDS ***
SFmT9ZsVopnukjvAzrxTRg: folds 
Pb/gJ3OxOZx57fFp0MDgkg: calls $0.25
SgMFmwYtNvq9Y+2ZxPSiWQ: raises $0.50 to $0.75
LtASJ9OlkqGrrUKGQlpGAw: calls $0.75
82p+w3EmUaFFHuwpSeGY1w: raises $4.50 to $5.25 and is all-in
LJI7A1YgDM7hgh7o56+ReQ: folds 
Pb/gJ3OxOZx57fFp0MDgkg: folds 
SgMFmwYtNvq9Y+2ZxPSiWQ: folds 
LtASJ9OlkqGrrUKGQlpGAw: calls $4.50
*** FLOP *** [Qd 2h 9h]
*** TURN *** [Qd 2h 9h] [3h]
*** RIVER *** [Qd 2h 9h 3h] [Ac]
*** SHOW DOWN ***
82p+w3EmUaFFHuwpSeGY1w: shows [Qh Qs] (three of a kind, Queens)
LtASJ9OlkqGrrUKGQlpGAw: mucks hand 
82p+w3EmUaFFHuwpSeGY1w collected $11.20 from pot
*** SUMMARY ***
Total pot $11.75 | Rake $0.55 
Board [Qd 2h 9h 3h Ac]
Seat 1: 82p+w3EmUaFFHuwpSeGY1w (small blind) showed [Qh Qs] and won ($11.20) with three of a kind, Queens
Seat 2: LJI7A1YgDM7hgh7o56+ReQ (big blind) folded before Flop
Seat 3: SFmT9ZsVopnukjvAzrxTRg folded before Flop (didn't bet)
Seat 4: Pb/gJ3OxOZx57fFp0MDgkg folded before Flop
Seat 5: SgMFmwYtNvq9Y+2ZxPSiWQ folded before Flop
Seat 6: LtASJ9OlkqGrrUKGQlpGAw (button) mucked




PokerStars Game #59941603356:  Hold'em No Limit ($0.10/$0.25) - 2009/07/01 1:40:27 ET
Table 'zKwHJD0cmKNUure9qQTfFg' 6-max Seat #6 is the button
Seat 1: RXYRBsbRgZxcivyqSdOo3A ($3.65 in chips) 
Seat 2: xrf8tAXKQHG99HixCot1Iw ($26.90 in chips) 
Seat 3: 60PLIlpucQhA08L3YbNmag ($5.60 in chips) 
Seat 4: v+QfkGiuj9bgtuNoVnDO8w ($26.15 in chips) 
Seat 5: E4AqQ1egsnu0oH2RqsbCmQ ($4.45 in chips) 
Seat 6: edio/rLJ06xeZOfLhoL3UA ($11.20 in chips) 
RXYRBsbRgZxcivyqSdOo3A: posts small blind $0.10
xrf8tAXKQHG99HixCot1Iw: posts big blind $0.25
*** HOLE CARDS ***
60PLIlpucQhA08L3YbNmag: folds 
v+QfkGiuj9bgtuNoVnDO8w: folds 
E4AqQ1egsnu0oH2RqsbCmQ: folds 
edio/rLJ06xeZOfLhoL3UA: folds 
RXYRBsbRgZxcivyqSdOo3A: calls $0.15
xrf8tAXKQHG99HixCot1Iw: checks 
*** FLOP *** [8h Ts 5h]
RXYRBsbRgZxcivyqSdOo3A: checks 
xrf8tAXKQHG99HixCot1Iw: checks 
*** TURN *** [8h Ts 5h] [6d]
RXYRBsbRgZxcivyqSdOo3A: checks 
xrf8tAXKQHG99HixCot1Iw: checks 
*** RIVER *** [8h Ts 5h 6d] [7d]
RXYRBsbRgZxcivyqSdOo3A: checks 
xrf8tAXKQHG99HixCot1Iw: checks 
*** SHOW DOWN ***
RXYRBsbRgZxcivyqSdOo3A: shows [6c 9c] (a straight, Six to Ten)
xrf8tAXKQHG99HixCot1Iw: mucks hand 
RXYRBsbRgZxcivyqSdOo3A collected $0.50 from pot
*** SUMMARY ***
Total pot $0.50 | Rake $0 
Board [8h Ts 5h 6d 7d]
Seat 1: RXYRBsbRgZxcivyqSdOo3A (small blind) showed [6c 9c] and won ($0.50) with a straight, Six to Ten
Seat 2: xrf8tAXKQHG99HixCot1Iw (big blind) mucked
Seat 3: 60PLIlpucQhA08L3YbNmag folded before Flop (didn't bet)
Seat 4: v+QfkGiuj9bgtuNoVnDO8w folded before Flop (didn't bet)
Seat 5: E4AqQ1egsnu0oH2RqsbCmQ folded before Flop (didn't bet)
Seat 6: edio/rLJ06xeZOfLhoL3UA (button) folded before Flop (didn't bet)




PokerStars Game #59941603380:  Hold'em No Limit ($0.10/$0.25) - 2009/07/01 1:40:27 ET
Table 'WEMI3Mtn7dGARDbgNrKibgQvLFJzpzymuOsaaRYi+8fgx Seat #2 is the button
Seat 2: PdIasPkzm2sqZnN41ZRXOg ($5 in chips) 
Seat 4: tLcDklc2rBORNfixyRfVfw ($25 in chips) 
Seat 5: MG90wfSJZnOejs/KD3vlQQ ($37.10 in chips) 
Seat 6: 1S/fpm+f42V/6MNZre+ccg ($25 in chips) 
Seat 7: rQhYIYXSyH/IivYM1dlV5A ($11.95 in chips) 
Seat 8: gehe91e0IyVT0QU/XBkEyg ($25.25 in chips) 
Seat 9: BWzInv8o0kN1pJybv/VjpQ ($44.60 in chips) 
Dr.Hibbert55 will be allowed to play after the button
tLcDklc2rBORNfixyRfVfw: posts small blind $0.10
MG90wfSJZnOejs/KD3vlQQ: posts big blind $0.25
cZ99hugmLBj9KhTlc8nCSw: sits out 
*** HOLE CARDS ***
1S/fpm+f42V/6MNZre+ccg: folds 
rQhYIYXSyH/IivYM1dlV5A: folds 
gehe91e0IyVT0QU/XBkEyg: folds 
BWzInv8o0kN1pJybv/VjpQ: folds 
PdIasPkzm2sqZnN41ZRXOg: folds 
tLcDklc2rBORNfixyRfVfw: raises $0.75 to $1
MG90wfSJZnOejs/KD3vlQQ: folds 
Uncalled bet ($0.75) returned to tLcDklc2rBORNfixyRfVfw
tLcDklc2rBORNfixyRfVfw collected $0.50 from pot
tLcDklc2rBORNfixyRfVfw: doesn't show hand 
*** SUMMARY ***
Total pot $0.50 | Rake $0 
Seat 2: PdIasPkzm2sqZnN41ZRXOg (button) folded before Flop (didn't bet)
Seat 4: tLcDklc2rBORNfixyRfVfw (small blind) collected ($0.50)
Seat 5: MG90wfSJZnOejs/KD3vlQQ (big blind) folded before Flop
Seat 6: 1S/fpm+f42V/6MNZre+ccg folded before Flop (didn't bet)
Seat 7: rQhYIYXSyH/IivYM1dlV5A folded before Flop (didn't bet)
Seat 8: gehe91e0IyVT0QU/XBkEyg folded before Flop (didn't bet)
Seat 9: BWzInv8o0kN1pJybv/VjpQ folded before Flop (didn't bet)




PokerStars Game #59941603018:  Hold'em No Limit ($0.10/$0.25) - 2009/07/01 1:40:27 ET
Table 'ROYvQOMwUrvL3SOiHYcrWg' 9-max Seat #2 is the button
Seat 1: 22dIObOuor/A+IKWkNoAlA ($5 in chips) 
Seat 2: gehe91e0IyVT0QU/XBkEyg ($24.90 in chips) 
Seat 3: 8EbrQ/EvFWt2cr0GaU82gQ ($4.75 in chips) 
Seat 4: SHegmCn8B0InbWE/zFlvOw ($35.80 in chips) 
Seat 7: tYsOBqdU1+x+yFI7zHO7hQ ($26.15 in chips) 
Seat 8: biJWLZ27fafNeBI2oT1KJw ($23.35 in chips) 
Seat 9: uhrboV251dcgYniYTdFIcA ($25 in chips) 
8EbrQ/EvFWt2cr0GaU82gQ: posts small blind $0.10
SHegmCn8B0InbWE/zFlvOw: posts big blind $0.25
7je+LC5Mfs6nL8YBVh4frQ: sits out 
P+9ymZQ3ktpQu1bn7HIjew: sits out 
*** HOLE CARDS ***
tYsOBqdU1+x+yFI7zHO7hQ: folds 
biJWLZ27fafNeBI2oT1KJw: raises $0.50 to $0.75
uhrboV251dcgYniYTdFIcA: calls $0.75
22dIObOuor/A+IKWkNoAlA: folds 
gehe91e0IyVT0QU/XBkEyg: folds 
8EbrQ/EvFWt2cr0GaU82gQ: folds 
SHegmCn8B0InbWE/zFlvOw: calls $0.50
*** FLOP *** [7h Qc 8d]
SHegmCn8B0InbWE/zFlvOw: checks 
biJWLZ27fafNeBI2oT1KJw: bets $1
uhrboV251dcgYniYTdFIcA: folds 
SHegmCn8B0InbWE/zFlvOw: calls $1
*** TURN *** [7h Qc 8d] [9d]
SHegmCn8B0InbWE/zFlvOw: checks 
biJWLZ27fafNeBI2oT1KJw: bets $2.25
SHegmCn8B0InbWE/zFlvOw: calls $2.25
*** RIVER *** [7h Qc 8d 9d] [Ts]
SHegmCn8B0InbWE/zFlvOw: checks 
biJWLZ27fafNeBI2oT1KJw: checks 
*** SHOW DOWN ***
SHegmCn8B0InbWE/zFlvOw: shows [Qd 4h] (a pair of Queens)
biJWLZ27fafNeBI2oT1KJw: shows [Kh Qh] (a pair of Queens - King kicker)
biJWLZ27fafNeBI2oT1KJw collected $8.45 from pot
*** SUMMARY ***
Total pot $8.85 | Rake $0.40 
Board [7h Qc 8d 9d Ts]
Seat 1: 22dIObOuor/A+IKWkNoAlA folded before Flop (didn't bet)
Seat 2: gehe91e0IyVT0QU/XBkEyg (button) folded before Flop (didn't bet)
Seat 3: 8EbrQ/EvFWt2cr0GaU82gQ (small blind) folded before Flop
Seat 4: SHegmCn8B0InbWE/zFlvOw (big blind) showed [Qd 4h] and lost with a pair of Queens
Seat 7: tYsOBqdU1+x+yFI7zHO7hQ folded before Flop (didn't bet)
Seat 8: biJWLZ27fafNeBI2oT1KJw showed [Kh Qh] and won ($8.45) with a pair of Queens
Seat 9: uhrboV251dcgYniYTdFIcA folded on the Flop




PokerStars Game #59941603456:  Hold'em No Limit ($0.10/$0.25) - 2009/07/01 1:40:27 ET
Table 'm+FQg/QP0VP1ZA3V62WtOg' 9-max Seat #9 is the button
Seat 4: qB12xUq3ftb2y8oTnNQzsg ($3.10 in chips) 
Seat 7: TPAF9YkMsjQFq978RNWZEQ ($14.90 in chips) 
Seat 9: zUXhymECc2C9W9ZNw6qppA ($10.55 in chips) 
qB12xUq3ftb2y8oTnNQzsg: posts small blind $0.10
CT7Xj/V/O5rBlhtt+RZeFQ joins the table at seat #6 
TPAF9YkMsjQFq978RNWZEQ: posts big blind $0.25
*** HOLE CARDS ***
zUXhymECc2C9W9ZNw6qppA: folds 
qB12xUq3ftb2y8oTnNQzsg: calls $0.15
TPAF9YkMsjQFq978RNWZEQ: checks 
*** FLOP *** [5h 5s 3c]
qB12xUq3ftb2y8oTnNQzsg: checks 
TPAF9YkMsjQFq978RNWZEQ: bets $0.25
qB12xUq3ftb2y8oTnNQzsg: folds 
Uncalled bet ($0.25) returned to TPAF9YkMsjQFq978RNWZEQ
TPAF9YkMsjQFq978RNWZEQ collected $0.50 from pot
*** SUMMARY ***
Total pot $0.50 | Rake $0 
Board [5h 5s 3c]
Seat 4: qB12xUq3ftb2y8oTnNQzsg (small blind) folded on the Flop
Seat 7: TPAF9YkMsjQFq978RNWZEQ (big blind) collected ($0.50)
Seat 9: zUXhymECc2C9W9ZNw6qppA (button) folded before Flop (didn't bet)




PokerStars Game #59941603860:  Hold'em No Limit ($0.10/$0.25) - 2009/07/01 1:40:28 ET
Table 'dNYnr4D4id1jwnEU66Yowg' 9-max Seat #4 is the button
Seat 1: 9lvO/qyU+xrU95Teu1fv0g ($4.65 in chips) 
Seat 4: VBHxUExRAMrbxUq/cVx9Gw ($4.95 in chips) 
Seat 5: 7cv+9Zc9HIQHNvYsMfV3uA ($25.45 in chips) 
Seat 6: 8EbrQ/EvFWt2cr0GaU82gQ ($5 in chips) 
Seat 7: DiSvPC2iudwL5j9u6Huyww ($25.80 in chips) 
Seat 8: RCqMONFrSPSArZh2Jsar/w ($22.45 in chips) 
Seat 9: K0dyGSZP/cgeQjH6o6u9Rw ($16.30 in chips) 
7cv+9Zc9HIQHNvYsMfV3uA: posts small blind $0.10
8EbrQ/EvFWt2cr0GaU82gQ: posts big blind $0.25
*** HOLE CARDS ***
DiSvPC2iudwL5j9u6Huyww: folds 
RCqMONFrSPSArZh2Jsar/w: folds 
K0dyGSZP/cgeQjH6o6u9Rw: folds 
9lvO/qyU+xrU95Teu1fv0g: folds 
VBHxUExRAMrbxUq/cVx9Gw: folds 
7cv+9Zc9HIQHNvYsMfV3uA: raises $0.75 to $1
8EbrQ/EvFWt2cr0GaU82gQ: folds 
Uncalled bet ($0.75) returned to 7cv+9Zc9HIQHNvYsMfV3uA
7cv+9Zc9HIQHNvYsMfV3uA collected $0.50 from pot
7cv+9Zc9HIQHNvYsMfV3uA: doesn't show hand 
*** SUMMARY ***
Total pot $0.50 | Rake $0 
Seat 1: 9lvO/qyU+xrU95Teu1fv0g folded before Flop (didn't bet)
Seat 4: VBHxUExRAMrbxUq/cVx9Gw (button) folded before Flop (didn't bet)
Seat 5: 7cv+9Zc9HIQHNvYsMfV3uA (small blind) collected ($0.50)
Seat 6: 8EbrQ/EvFWt2cr0GaU82gQ (big blind) folded before Flop
Seat 7: DiSvPC2iudwL5j9u6Huyww folded before Flop (didn't bet)
Seat 8: RCqMONFrSPSArZh2Jsar/w folded before Flop (didn't bet)
Seat 9: K0dyGSZP/cgeQjH6o6u9Rw folded before Flop (didn't bet)




PokerStars Game #59941603888:  Hold'em No Limit ($0.10/$0.25) - 2009/07/01 1:40:28 ET
Table '4UJB/UOZ5aepyF2v+hIoUg' 6-max Seat #4 is the button
Seat 1: 08V++DOqzaNrRNsHIwi25w ($27.10 in chips) 
Seat 2: mFv3iBCtrw9XfCDRB0d46Q ($3.95 in chips) 
Seat 3: zlYHXTtJ5tcx9kwK2h5n9A ($38.90 in chips) 
Seat 4: R6AGToFJQOYVZAjC2jXEKw ($22.60 in chips) 
Seat 5: 3zD3qLXT1bEffAoWGnc7wg ($26 in chips) 
Seat 6: 2aphcinkTZT0B0Uoah6cvQ ($18.10 in chips) 
3zD3qLXT1bEffAoWGnc7wg: posts small blind $0.10
2aphcinkTZT0B0Uoah6cvQ: posts big blind $0.25
*** HOLE CARDS ***
08V++DOqzaNrRNsHIwi25w: folds 
mFv3iBCtrw9XfCDRB0d46Q: folds 
zlYHXTtJ5tcx9kwK2h5n9A: folds 
R6AGToFJQOYVZAjC2jXEKw: raises $0.50 to $0.75
3zD3qLXT1bEffAoWGnc7wg: folds 
2aphcinkTZT0B0Uoah6cvQ: calls $0.50
*** FLOP *** [4s Ah 6s]
2aphcinkTZT0B0Uoah6cvQ: checks 
R6AGToFJQOYVZAjC2jXEKw: bets $1.25
2aphcinkTZT0B0Uoah6cvQ: folds 
Uncalled bet ($1.25) returned to R6AGToFJQOYVZAjC2jXEKw
R6AGToFJQOYVZAjC2jXEKw collected $1.55 from pot
R6AGToFJQOYVZAjC2jXEKw: doesn't show hand 
*** SUMMARY ***
Total pot $1.60 | Rake $0.05 
Board [4s Ah 6s]
Seat 1: 08V++DOqzaNrRNsHIwi25w folded before Flop (didn't bet)
Seat 2: mFv3iBCtrw9XfCDRB0d46Q folded before Flop (didn't bet)
Seat 3: zlYHXTtJ5tcx9kwK2h5n9A folded before Flop (didn't bet)
Seat 4: R6AGToFJQOYVZAjC2jXEKw (button) collected ($1.55)
Seat 5: 3zD3qLXT1bEffAoWGnc7wg (small blind) folded before Flop
Seat 6: 2aphcinkTZT0B0Uoah6cvQ (big blind) folded on the Flop




PokerStars Game #59941603660:  Hold'em No Limit ($0.10/$0.25) - 2009/07/01 1:40:28 ET
Table 'Pz8SfAzhP5nvWTsJRAxoDg' 6-max Seat #6 is the button
Seat 1: QiL+lEgEWwy21jk/ltaRLg ($26.05 in chips) 
Seat 2: xrf8tAXKQHG99HixCot1Iw ($25.15 in chips) 
Seat 3: mfrkWA3PTeYPkbO6hi98Aw ($28.20 in chips) 
Seat 4: 4lJto+Qj0K4JrFKvHaPTLw ($34.40 in chips) 
Seat 5: FYepjhAvF8ZdVCmqHIy+eQ ($63.15 in chips) 
Seat 6: QvTX2yGq3uKJiKPmns4TKQ ($24.65 in chips) 
QiL+lEgEWwy21jk/ltaRLg: posts small blind $0.10
xrf8tAXKQHG99HixCot1Iw: posts big blind $0.25
*** HOLE CARDS ***
mfrkWA3PTeYPkbO6hi98Aw: folds 
4lJto+Qj0K4JrFKvHaPTLw: folds 
FYepjhAvF8ZdVCmqHIy+eQ: folds 
QvTX2yGq3uKJiKPmns4TKQ: folds 
QiL+lEgEWwy21jk/ltaRLg: folds 
Uncalled bet ($0.15) returned to xrf8tAXKQHG99HixCot1Iw
xrf8tAXKQHG99HixCot1Iw collected $0.20 from pot
xrf8tAXKQHG99HixCot1Iw: doesn't show hand 
*** SUMMARY ***
Total pot $0.20 | Rake $0 
Seat 1: QiL+lEgEWwy21jk/ltaRLg (small blind) folded before Flop
Seat 2: xrf8tAXKQHG99HixCot1Iw (big blind) collected ($0.20)
Seat 3: mfrkWA3PTeYPkbO6hi98Aw folded before Flop (didn't bet)
Seat 4: 4lJto+Qj0K4JrFKvHaPTLw folded before Flop (didn't bet)
Seat 5: FYepjhAvF8ZdVCmqHIy+eQ folded before Flop (didn't bet)
Seat 6: QvTX2yGq3uKJiKPmns4TKQ (button) folded before Flop (didn't bet)




PokerStars Game #59941603758:  Hold'em No Limit ($0.10/$0.25) - 2009/07/01 1:40:28 ET
Table 'TJS4XvvOjO3k7mH74HJw5g' 9-max Seat #9 is the button
Seat 1: K8I2mpRME07ZlOsT2x75Lg ($6.05 in chips) 
Seat 4: f/e5w8nN3RjdX9H1eRlDdA ($5.15 in chips) 
Seat 5: UlMB386Cfzy3EwurQoBjcA ($12.70 in chips) 
Seat 6: SRik8xyC/rVIBoX7VaOoMA ($14.40 in chips) 
Seat 8: Qv4VzEkN09uD11sjKv02Ig ($17.65 in chips) 
Seat 9: +sbyWwIcFp9kP0bDtMegfQ ($36.55 in chips) 
K8I2mpRME07ZlOsT2x75Lg: posts small blind $0.10
f/e5w8nN3RjdX9H1eRlDdA: posts big blind $0.25
*** HOLE CARDS ***
UlMB386Cfzy3EwurQoBjcA: raises $0.50 to $0.75
SRik8xyC/rVIBoX7VaOoMA: folds 
Qv4VzEkN09uD11sjKv02Ig: folds 
+sbyWwIcFp9kP0bDtMegfQ: calls $0.75
K8I2mpRME07ZlOsT2x75Lg: folds 
f/e5w8nN3RjdX9H1eRlDdA: calls $0.50
*** FLOP *** [5h Ah 5s]
f/e5w8nN3RjdX9H1eRlDdA: checks 
UlMB386Cfzy3EwurQoBjcA: bets $1.50
+sbyWwIcFp9kP0bDtMegfQ: calls $1.50
f/e5w8nN3RjdX9H1eRlDdA: calls $1.50
*** TURN *** [5h Ah 5s] [Qh]
f/e5w8nN3RjdX9H1eRlDdA: checks 
UlMB386Cfzy3EwurQoBjcA: checks 
+sbyWwIcFp9kP0bDtMegfQ: bets $2
f/e5w8nN3RjdX9H1eRlDdA: calls $2
UlMB386Cfzy3EwurQoBjcA: folds 
*** RIVER *** [5h Ah 5s Qh] [Th]
f/e5w8nN3RjdX9H1eRlDdA: checks 
+sbyWwIcFp9kP0bDtMegfQ: checks 
*** SHOW DOWN ***
f/e5w8nN3RjdX9H1eRlDdA: shows [Js Ad] (two pair, Aces and Fives)
+sbyWwIcFp9kP0bDtMegfQ: shows [6d 5d] (three of a kind, Fives)
+sbyWwIcFp9kP0bDtMegfQ collected $10.35 from pot
B9u+i1s5aZZkmLTLUopTBg joins the table at seat #7 
*** SUMMARY ***
Total pot $10.85 | Rake $0.50 
Board [5h Ah 5s Qh Th]
Seat 1: K8I2mpRME07ZlOsT2x75Lg (small blind) folded before Flop
Seat 4: f/e5w8nN3RjdX9H1eRlDdA (big blind) showed [Js Ad] and lost with two pair, Aces and Fives
Seat 5: UlMB386Cfzy3EwurQoBjcA folded on the Turn
Seat 6: SRik8xyC/rVIBoX7VaOoMA folded before Flop (didn't bet)
Seat 8: Qv4VzEkN09uD11sjKv02Ig folded before Flop (didn't bet)
Seat 9: +sbyWwIcFp9kP0bDtMegfQ (button) showed [6d 5d] and won ($10.35) with three of a kind, Fives




PokerStars Game #59941604114:  Hold'em No Limit ($0.10/$0.25) - 2009/07/01 1:40:28 ET
Table '9lYs7ljXi6AgFAxYHlKLJw' 9-max Seat #8 is the button
Seat 1: K0b5wNInj6hUGRr6yzKFtw ($33.90 in chips) 
Seat 3: arxNSjreDRGFg13EAM2F1w ($31.30 in chips) 
Seat 4: UANt6y/SmDCY/jIxkBixcw ($34.10 in chips) 
Seat 5: dfNim92Z6XK1/h5SFW5vDg ($52.70 in chips) 
Seat 6: tYsOBqdU1+x+yFI7zHO7hQ ($25.95 in chips) 
Seat 7: ghNKXUBl/H+t83JF079ZBA ($27.05 in chips) 
Seat 8: 9YN2IkT2JYYKFErZtZvCtA ($22.60 in chips) 
Seat 9: cKlmpQMahVsmOaxFQDcoOg ($20.10 in chips) 
cKlmpQMahVsmOaxFQDcoOg: posts small blind $0.10
K0b5wNInj6hUGRr6yzKFtw: posts big blind $0.25
0XACOSNrAWmqNv9k1nF8rw: sits out 
*** HOLE CARDS ***
arxNSjreDRGFg13EAM2F1w: folds 
UANt6y/SmDCY/jIxkBixcw: calls $0.25
dfNim92Z6XK1/h5SFW5vDg: folds 
tYsOBqdU1+x+yFI7zHO7hQ: folds 
ghNKXUBl/H+t83JF079ZBA: folds 
9YN2IkT2JYYKFErZtZvCtA: folds 
cKlmpQMahVsmOaxFQDcoOg: folds 
K0b5wNInj6hUGRr6yzKFtw: checks 
*** FLOP *** [As 4d 2s]
K0b5wNInj6hUGRr6yzKFtw: bets $0.50
UANt6y/SmDCY/jIxkBixcw: folds 
Uncalled bet ($0.50) returned to K0b5wNInj6hUGRr6yzKFtw
K0b5wNInj6hUGRr6yzKFtw collected $0.60 from pot
K0b5wNInj6hUGRr6yzKFtw: doesn't show hand 
*** SUMMARY ***
Total pot $0.60 | Rake $0 
Board [As 4d 2s]
Seat 1: K0b5wNInj6hUGRr6yzKFtw (big blind) collected ($0.60)
Seat 3: arxNSjreDRGFg13EAM2F1w folded before Flop (didn't bet)
Seat 4: UANt6y/SmDCY/jIxkBixcw folded on the Flop
Seat 5: dfNim92Z6XK1/h5SFW5vDg folded before Flop (didn't bet)
Seat 6: tYsOBqdU1+x+yFI7zHO7hQ folded before Flop (didn't bet)
Seat 7: ghNKXUBl/H+t83JF079ZBA folded before Flop (didn't bet)
Seat 8: 9YN2IkT2JYYKFErZtZvCtA (button) folded before Flop (didn't bet)
Seat 9: cKlmpQMahVsmOaxFQDcoOg (small blind) folded before Flop




PokerStars Game #59941603666:  Hold'em No Limit ($0.10/$0.25) - 2009/07/01 1:40:28 ET
Table '8QBBaev+cI2i/r2H6ml/lg' 9-max Seat #8 is the button
Seat 1: s2xLPOl/vhl/26apJ3vsOQ ($34.45 in chips) 
Seat 2: 1S/fpm+f42V/6MNZre+ccg ($25.40 in chips) 
Seat 3: zgi+EUykT/pZQpoUG6+oEg ($4.65 in chips) 
Seat 4: ytpGB2nr/CLVHnyKMRiEFQ ($15 in chips) 
Seat 5: 0QdZrkFD7aGKeBXPGbIomA ($11.70 in chips) 
Seat 7: eK8qa6EPcH2zhtbmWSvc9g ($31.05 in chips) 
Seat 8: vr1IK/Q4HXm8s8V0/dePzQ ($12.80 in chips) 
Seat 9: EUMLvzDkECHBit+xa+uGjg ($23.25 in chips) 
EUMLvzDkECHBit+xa+uGjg: posts small blind $0.10
s2xLPOl/vhl/26apJ3vsOQ: posts big blind $0.25
*** HOLE CARDS ***
1S/fpm+f42V/6MNZre+ccg: raises $0.50 to $0.75
zgi+EUykT/pZQpoUG6+oEg: folds 
ytpGB2nr/CLVHnyKMRiEFQ: folds 
0QdZrkFD7aGKeBXPGbIomA: folds 
eK8qa6EPcH2zhtbmWSvc9g: folds 
vr1IK/Q4HXm8s8V0/dePzQ: folds 
EUMLvzDkECHBit+xa+uGjg: folds 
s2xLPOl/vhl/26apJ3vsOQ: folds 
Uncalled bet ($0.50) returned to 1S/fpm+f42V/6MNZre+ccg
1S/fpm+f42V/6MNZre+ccg collected $0.60 from pot
1S/fpm+f42V/6MNZre+ccg: doesn't show hand 
*** SUMMARY ***
Total pot $0.60 | Rake $0 
Seat 1: s2xLPOl/vhl/26apJ3vsOQ (big blind) folded before Flop
Seat 2: 1S/fpm+f42V/6MNZre+ccg collected ($0.60)
Seat 3: zgi+EUykT/pZQpoUG6+oEg folded before Flop (didn't bet)
Seat 4: ytpGB2nr/CLVHnyKMRiEFQ folded before Flop (didn't bet)
Seat 5: 0QdZrkFD7aGKeBXPGbIomA folded before Flop (didn't bet)
Seat 7: eK8qa6EPcH2zhtbmWSvc9g folded before Flop (didn't bet)
Seat 8: vr1IK/Q4HXm8s8V0/dePzQ (button) folded before Flop (didn't bet)
Seat 9: EUMLvzDkECHBit+xa+uGjg (small blind) folded before Flop




PokerStars Game #59941604170:  Hold'em No Limit ($0.10/$0.25) - 2009/07/01 1:40:28 ET
Table '2VkNDXXsBj4bSZw/uK5atw' 6-max Seat #1 is the button
Seat 1: xrf8tAXKQHG99HixCot1Iw ($18.50 in chips) 
Seat 3: 8D0jr3B4e++Q/cTSnpHdzg ($37.40 in chips) 
Seat 5: 7f0OkhFEOf3T+rVOFHRLnw ($23.15 in chips) 
Seat 6: n6UPMnVR4v8LFP0rWP73Fg ($10.40 in chips) 
8D0jr3B4e++Q/cTSnpHdzg: posts small blind $0.10
7f0OkhFEOf3T+rVOFHRLnw: posts big blind $0.25
*** HOLE CARDS ***
n6UPMnVR4v8LFP0rWP73Fg: calls $0.25
xrf8tAXKQHG99HixCot1Iw: raises $0.75 to $1
8D0jr3B4e++Q/cTSnpHdzg: calls $0.90
v6mkGzCBCCXcgWQNSYVtKg joins the table at seat #2 
7f0OkhFEOf3T+rVOFHRLnw: calls $0.75
n6UPMnVR4v8LFP0rWP73Fg: folds 
*** FLOP *** [Ah 3c 6c]
8D0jr3B4e++Q/cTSnpHdzg: checks 
7f0OkhFEOf3T+rVOFHRLnw: checks 
xrf8tAXKQHG99HixCot1Iw: bets $1.75
8D0jr3B4e++Q/cTSnpHdzg: folds 
7f0OkhFEOf3T+rVOFHRLnw: folds 
Uncalled bet ($1.75) returned to xrf8tAXKQHG99HixCot1Iw
xrf8tAXKQHG99HixCot1Iw collected $3.10 from pot
xrf8tAXKQHG99HixCot1Iw: doesn't show hand 
*** SUMMARY ***
Total pot $3.25 | Rake $0.15 
Board [Ah 3c 6c]
Seat 1: xrf8tAXKQHG99HixCot1Iw (button) collected ($3.10)
Seat 3: 8D0jr3B4e++Q/cTSnpHdzg (small blind) folded on the Flop
Seat 5: 7f0OkhFEOf3T+rVOFHRLnw (big blind) folded on the Flop
Seat 6: n6UPMnVR4v8LFP0rWP73Fg folded before Flop




PokerStars Game #59941603928:  Hold'em No Limit ($0.10/$0.25) - 2009/07/01 1:40:28 ET
Table 'U0hCzoS0KCJL+eoE054K4Q' 9-max Seat #4 is the button
Seat 1: XVEauYThJRhSTUAMxB/2ow ($38.45 in chips) 
Seat 2: MG90wfSJZnOejs/KD3vlQQ ($25 in chips) 
Seat 3: 8Cp1H3sSs8+jTTwLfeYKcw ($27.20 in chips) 
Seat 4: Bb42QRQMhg5/Y0vHP8/2Xw ($25.10 in chips) 
Seat 5: zgi+EUykT/pZQpoUG6+oEg ($6.10 in chips) 
Seat 6: V6p0jQ/RhUsqpHLmXvEX4Q ($12.25 in chips) 
Seat 7: uetHVityNsFnyX2bBnKe2A ($17 in chips) 
Seat 8: K0b5wNInj6hUGRr6yzKFtw ($25 in chips) 
Seat 9: wGigCmBR/9XWkPpvYos3aQ ($33.10 in chips) 
zgi+EUykT/pZQpoUG6+oEg: posts small blind $0.10
V6p0jQ/RhUsqpHLmXvEX4Q: posts big blind $0.25
*** HOLE CARDS ***
uetHVityNsFnyX2bBnKe2A: folds 
K0b5wNInj6hUGRr6yzKFtw: folds 
wGigCmBR/9XWkPpvYos3aQ: folds 
XVEauYThJRhSTUAMxB/2ow: folds 
MG90wfSJZnOejs/KD3vlQQ: raises $0.50 to $0.75
8Cp1H3sSs8+jTTwLfeYKcw: folds 
Bb42QRQMhg5/Y0vHP8/2Xw: folds 
zgi+EUykT/pZQpoUG6+oEg: folds 
V6p0jQ/RhUsqpHLmXvEX4Q: folds 
Uncalled bet ($0.50) returned to MG90wfSJZnOejs/KD3vlQQ
MG90wfSJZnOejs/KD3vlQQ collected $0.60 from pot
MG90wfSJZnOejs/KD3vlQQ: doesn't show hand 
*** SUMMARY ***
Total pot $0.60 | Rake $0 
Seat 1: XVEauYThJRhSTUAMxB/2ow folded before Flop (didn't bet)
Seat 2: MG90wfSJZnOejs/KD3vlQQ collected ($0.60)
Seat 3: 8Cp1H3sSs8+jTTwLfeYKcw folded before Flop (didn't bet)
Seat 4: Bb42QRQMhg5/Y0vHP8/2Xw (button) folded before Flop (didn't bet)
Seat 5: zgi+EUykT/pZQpoUG6+oEg (small blind) folded before Flop
Seat 6: V6p0jQ/RhUsqpHLmXvEX4Q (big blind) folded before Flop
Seat 7: uetHVityNsFnyX2bBnKe2A folded before Flop (didn't bet)
Seat 8: K0b5wNInj6hUGRr6yzKFtw folded before Flop (didn't bet)
Seat 9: wGigCmBR/9XWkPpvYos3aQ folded before Flop (didn't bet)




PokerStars Game #59941603560:  Hold'em No Limit ($0.10/$0.25) - 2009/07/01 1:40:28 ET
Table 'YlRA05h9BJ1EhOUSNUjJdg' 9-max Seat #8 is the button
Seat 1: dtZ84flFEi4Q+SGrHMJRDQ ($25 in chips) 
Seat 2: Y2GFAe+PT7xnUUtgqCNDFw ($11.90 in chips) 
Seat 3: Z5ZtGOON8kmSdSCll9Z3XA ($12.10 in chips) 
Seat 4: HPEB+AtKw1+C/cxU0o1ciw ($31.60 in chips) 
Seat 5: sx0lGrkT9fd4yFR+3cXUQg ($11.05 in chips) 
Seat 6: QEbIGci+itdw+re8RM5fZA ($44.35 in chips) 
Seat 7: dfNim92Z6XK1/h5SFW5vDg ($25 in chips) 
Seat 8: dmYlc+1cjwZMJ7wV+Z0rRg ($32.10 in chips) 
Seat 9: Z9AeOQX3yzuSvKAm/xyovg ($9.50 in chips) 
Z9AeOQX3yzuSvKAm/xyovg: posts small blind $0.10
dtZ84flFEi4Q+SGrHMJRDQ: posts big blind $0.25
*** HOLE CARDS ***
Y2GFAe+PT7xnUUtgqCNDFw: folds 
Z5ZtGOON8kmSdSCll9Z3XA: folds 
HPEB+AtKw1+C/cxU0o1ciw: folds 
sx0lGrkT9fd4yFR+3cXUQg: folds 
QEbIGci+itdw+re8RM5fZA: folds 
dfNim92Z6XK1/h5SFW5vDg: folds 
dmYlc+1cjwZMJ7wV+Z0rRg: folds 
Z9AeOQX3yzuSvKAm/xyovg: raises $0.75 to $1
dtZ84flFEi4Q+SGrHMJRDQ: folds 
Uncalled bet ($0.75) returned to Z9AeOQX3yzuSvKAm/xyovg
Z9AeOQX3yzuSvKAm/xyovg collected $0.50 from pot
*** SUMMARY ***
Total pot $0.50 | Rake $0 
Seat 1: dtZ84flFEi4Q+SGrHMJRDQ (big blind) folded before Flop
Seat 2: Y2GFAe+PT7xnUUtgqCNDFw folded before Flop (didn't bet)
Seat 3: Z5ZtGOON8kmSdSCll9Z3XA folded before Flop (didn't bet)
Seat 4: HPEB+AtKw1+C/cxU0o1ciw folded before Flop (didn't bet)
Seat 5: sx0lGrkT9fd4yFR+3cXUQg folded before Flop (didn't bet)
Seat 6: QEbIGci+itdw+re8RM5fZA folded before Flop (didn't bet)
Seat 7: dfNim92Z6XK1/h5SFW5vDg folded before Flop (didn't bet)
Seat 8: dmYlc+1cjwZMJ7wV+Z0rRg (button) folded before Flop (didn't bet)
Seat 9: Z9AeOQX3yzuSvKAm/xyovg (small blind) collected ($0.50)




PokerStars Game #59941603558:  Hold'em No Limit ($0.10/$0.25) - 2009/07/01 1:40:28 ET
Table 'aisAlB9GIV21BwfUW3+Nbg' 9-max Seat #4 is the button
Seat 1: SqibpGx+lf+brY0fJVvD0w ($24.65 in chips) 
Seat 2: +7GnIVpCmyuij3NJfOgsTw ($13.90 in chips) 
Seat 3: CvL9Ch1HYCVbTsfpNucitg ($4.80 in chips) 
Seat 4: sD+TKtt36XiiN6jqHiLwDA ($26.20 in chips) 
Seat 5: ghNKXUBl/H+t83JF079ZBA ($27.50 in chips) 
Seat 6: 9gmYYQesalMrUjaF7nKfrQ ($16.55 in chips) 
Seat 7: jGjM+5lCSe6f2MEwxQGOAg ($36.80 in chips) 
Seat 8: VWUWpMLMj/Q1jRVpF7Aohw ($12.50 in chips) 
Seat 9: N0hGpTAEAj9k5msS6LPLAw ($10.75 in chips) 
ghNKXUBl/H+t83JF079ZBA: posts small blind $0.10
9gmYYQesalMrUjaF7nKfrQ: posts big blind $0.25
*** HOLE CARDS ***
jGjM+5lCSe6f2MEwxQGOAg: raises $0.25 to $0.50
VWUWpMLMj/Q1jRVpF7Aohw: folds 
N0hGpTAEAj9k5msS6LPLAw: folds 
SqibpGx+lf+brY0fJVvD0w: folds 
+7GnIVpCmyuij3NJfOgsTw: calls $0.50
CvL9Ch1HYCVbTsfpNucitg: folds 
sD+TKtt36XiiN6jqHiLwDA has timed out
sD+TKtt36XiiN6jqHiLwDA: folds 
sD+TKtt36XiiN6jqHiLwDA is sitting out
sD+TKtt36XiiN6jqHiLwDA has returned
ghNKXUBl/H+t83JF079ZBA: folds 
9gmYYQesalMrUjaF7nKfrQ: folds 
*** FLOP *** [Td 4c 9d]
jGjM+5lCSe6f2MEwxQGOAg: bets $0.75
+7GnIVpCmyuij3NJfOgsTw: folds 
Uncalled bet ($0.75) returned to jGjM+5lCSe6f2MEwxQGOAg
jGjM+5lCSe6f2MEwxQGOAg collected $1.30 from pot
*** SUMMARY ***
Total pot $1.35 | Rake $0.05 
Board [Td 4c 9d]
Seat 1: SqibpGx+lf+brY0fJVvD0w folded before Flop (didn't bet)
Seat 2: +7GnIVpCmyuij3NJfOgsTw folded on the Flop
Seat 3: CvL9Ch1HYCVbTsfpNucitg folded before Flop (didn't bet)
Seat 4: sD+TKtt36XiiN6jqHiLwDA (button) folded before Flop (didn't bet)
Seat 5: ghNKXUBl/H+t83JF079ZBA (small blind) folded before Flop
Seat 6: 9gmYYQesalMrUjaF7nKfrQ (big blind) folded before Flop
Seat 7: jGjM+5lCSe6f2MEwxQGOAg collected ($1.30)
Seat 8: VWUWpMLMj/Q1jRVpF7Aohw folded before Flop (didn't bet)
Seat 9: N0hGpTAEAj9k5msS6LPLAw folded before Flop (didn't bet)




PokerStars Game #59941604404:  Hold'em No Limit ($0.10/$0.25) - 2009/07/01 1:40:29 ET
Table 'xkqAWQFDrFt4p81M8UsoNw' 9-max Seat #2 is the button
Seat 1: tLcDklc2rBORNfixyRfVfw ($26.75 in chips) 
Seat 2: z5GxcHlYz/GSz6W2uFiTtg ($37.80 in chips) 
Seat 3: xHZZRLAaFUIC8WWI8ljOJA ($24.25 in chips) 
Seat 4: wGigCmBR/9XWkPpvYos3aQ ($25.95 in chips) 
Seat 5: OiV1PWZ3IkN29JlmCcnTwQ ($4.95 in chips) 
Seat 6: 6RiVTYll/5D8zICp0MRpKw ($25 in chips) 
Seat 7: MG90wfSJZnOejs/KD3vlQQ ($43.05 in chips) 
Seat 8: MaqsqnOOkbNuPf4oWvOtnA ($44.45 in chips) 
Seat 9: Z9AeOQX3yzuSvKAm/xyovg ($9.65 in chips) 
xHZZRLAaFUIC8WWI8ljOJA: posts small blind $0.10
wGigCmBR/9XWkPpvYos3aQ: posts big blind $0.25
*** HOLE CARDS ***
OiV1PWZ3IkN29JlmCcnTwQ: folds 
6RiVTYll/5D8zICp0MRpKw: folds 
MG90wfSJZnOejs/KD3vlQQ: folds 
MaqsqnOOkbNuPf4oWvOtnA: calls $0.25
Z9AeOQX3yzuSvKAm/xyovg: folds 
tLcDklc2rBORNfixyRfVfw: folds 
z5GxcHlYz/GSz6W2uFiTtg: calls $0.25
xHZZRLAaFUIC8WWI8ljOJA: calls $0.15
wGigCmBR/9XWkPpvYos3aQ: checks 
*** FLOP *** [Ad Tc Ks]
xHZZRLAaFUIC8WWI8ljOJA: checks 
wGigCmBR/9XWkPpvYos3aQ: checks 
MaqsqnOOkbNuPf4oWvOtnA: bets $0.25
z5GxcHlYz/GSz6W2uFiTtg: calls $0.25
xHZZRLAaFUIC8WWI8ljOJA: folds 
wGigCmBR/9XWkPpvYos3aQ: calls $0.25
*** TURN *** [Ad Tc Ks] [5h]
wGigCmBR/9XWkPpvYos3aQ: checks 
MaqsqnOOkbNuPf4oWvOtnA: checks 
z5GxcHlYz/GSz6W2uFiTtg: bets $0.25
wGigCmBR/9XWkPpvYos3aQ: calls $0.25
MaqsqnOOkbNuPf4oWvOtnA: calls $0.25
*** RIVER *** [Ad Tc Ks 5h] [8s]
wGigCmBR/9XWkPpvYos3aQ: checks 
MaqsqnOOkbNuPf4oWvOtnA: bets $0.75
z5GxcHlYz/GSz6W2uFiTtg: raises $1.50 to $2.25
wGigCmBR/9XWkPpvYos3aQ: folds 
MaqsqnOOkbNuPf4oWvOtnA: folds 
Uncalled bet ($1.50) returned to z5GxcHlYz/GSz6W2uFiTtg
z5GxcHlYz/GSz6W2uFiTtg collected $3.85 from pot
*** SUMMARY ***
Total pot $4 | Rake $0.15 
Board [Ad Tc Ks 5h 8s]
Seat 1: tLcDklc2rBORNfixyRfVfw folded before Flop (didn't bet)
Seat 2: z5GxcHlYz/GSz6W2uFiTtg (button) collected ($3.85)
Seat 3: xHZZRLAaFUIC8WWI8ljOJA (small blind) folded on the Flop
Seat 4: wGigCmBR/9XWkPpvYos3aQ (big blind) folded on the River
Seat 5: OiV1PWZ3IkN29JlmCcnTwQ folded before Flop (didn't bet)
Seat 6: 6RiVTYll/5D8zICp0MRpKw folded before Flop (didn't bet)
Seat 7: MG90wfSJZnOejs/KD3vlQQ folded before Flop (didn't bet)
Seat 8: MaqsqnOOkbNuPf4oWvOtnA folded on the River
Seat 9: Z9AeOQX3yzuSvKAm/xyovg folded before Flop (didn't bet)




PokerStars Game #59941604426:  Hold'em No Limit ($0.10/$0.25) - 2009/07/01 1:40:29 ET
Table 'bIGKmJgZehWJ+FAo8b85iw' 9-max Seat #6 is the button
Seat 1: yyG4svzOpC1A+sUP/scg6w ($14.70 in chips) 
Seat 2: cCjRCvseA9rZn7Xr+GCCHg ($21.70 in chips) 
Seat 3: /FyMUX+W/tpNFcRWbUTJxQ ($10.80 in chips) 
Seat 4: LGxBRjCRn6KlQ/6B4eoXbA ($11.95 in chips) 
Seat 5: uLP/lYn7oKq9xCChBXsXxw ($25.25 in chips) 
Seat 6: PFNLAvMkr8qKc7xCiH0wTA ($18.85 in chips) 
Seat 7: HDDm1BkZtdsRyw2DJdqq6A ($20.45 in chips) 
Seat 8: +2kMBNpY4nF1qNCRd8SJLA ($55.30 in chips) 
Seat 9: aNpwfA31EREwO+ar4XzBCw ($32.10 in chips) 
HDDm1BkZtdsRyw2DJdqq6A: posts small blind $0.10
+2kMBNpY4nF1qNCRd8SJLA: posts big blind $0.25
*** HOLE CARDS ***
aNpwfA31EREwO+ar4XzBCw: folds 
yyG4svzOpC1A+sUP/scg6w: folds 
cCjRCvseA9rZn7Xr+GCCHg: folds 
/FyMUX+W/tpNFcRWbUTJxQ: folds 
LGxBRjCRn6KlQ/6B4eoXbA: raises $0.75 to $1
uLP/lYn7oKq9xCChBXsXxw: folds 
PFNLAvMkr8qKc7xCiH0wTA: folds 
HDDm1BkZtdsRyw2DJdqq6A: calls $0.90
+2kMBNpY4nF1qNCRd8SJLA: folds 
*** FLOP *** [8s 7h Ts]
HDDm1BkZtdsRyw2DJdqq6A: checks 
LGxBRjCRn6KlQ/6B4eoXbA: bets $2.50
HDDm1BkZtdsRyw2DJdqq6A: raises $2.50 to $5
LGxBRjCRn6KlQ/6B4eoXbA: calls $2.50
*** TURN *** [8s 7h Ts] [Kd]
HDDm1BkZtdsRyw2DJdqq6A: checks 
LGxBRjCRn6KlQ/6B4eoXbA: bets $5.75
HDDm1BkZtdsRyw2DJdqq6A: calls $5.75
*** RIVER *** [8s 7h Ts Kd] [Ks]
HDDm1BkZtdsRyw2DJdqq6A: checks 
LGxBRjCRn6KlQ/6B4eoXbA: bets $0.20 and is all-in
HDDm1BkZtdsRyw2DJdqq6A: calls $0.20
*** SHOW DOWN ***
LGxBRjCRn6KlQ/6B4eoXbA: shows [6h 2h] (a pair of Kings)
HDDm1BkZtdsRyw2DJdqq6A: shows [Ah Th] (two pair, Kings and Tens)
HDDm1BkZtdsRyw2DJdqq6A collected $23 from pot
*** SUMMARY ***
Total pot $24.15 | Rake $1.15 
Board [8s 7h Ts Kd Ks]
Seat 1: yyG4svzOpC1A+sUP/scg6w folded before Flop (didn't bet)
Seat 2: cCjRCvseA9rZn7Xr+GCCHg folded before Flop (didn't bet)
Seat 3: /FyMUX+W/tpNFcRWbUTJxQ folded before Flop (didn't bet)
Seat 4: LGxBRjCRn6KlQ/6B4eoXbA showed [6h 2h] and lost with a pair of Kings
Seat 5: uLP/lYn7oKq9xCChBXsXxw folded before Flop (didn't bet)
Seat 6: PFNLAvMkr8qKc7xCiH0wTA (button) folded before Flop (didn't bet)
Seat 7: HDDm1BkZtdsRyw2DJdqq6A (small blind) showed [Ah Th] and won ($23) with two pair, Kings and Tens
Seat 8: +2kMBNpY4nF1qNCRd8SJLA (big blind) folded before Flop
Seat 9: aNpwfA31EREwO+ar4XzBCw folded before Flop (didn't bet)




PokerStars Game #59941604358:  Hold'em No Limit ($0.10/$0.25) - 2009/07/01 1:40:29 ET
Table 'gYBWJG3hEuJg6kphY0yhMg' 9-max Seat #5 is the button
Seat 1: AcL/hxc9eT0dCr2TYk/0Dg ($16.80 in chips) 
Seat 3: wGigCmBR/9XWkPpvYos3aQ ($25 in chips) 
Seat 4: V6p0jQ/RhUsqpHLmXvEX4Q ($13 in chips) 
Seat 5: +sbyWwIcFp9kP0bDtMegfQ ($27.95 in chips) 
Seat 6: fI5jtRq/8R6QjoWU5AnUOQ ($7.95 in chips) 
Seat 7: EQXHDnIzAsORnIXRNtXRlA ($19.65 in chips) 
Seat 8: VCKtuATyvAq9H2JSAQxPbA ($14.95 in chips) 
Seat 9: Bb42QRQMhg5/Y0vHP8/2Xw ($25.60 in chips) 
fI5jtRq/8R6QjoWU5AnUOQ: posts small blind $0.10
EQXHDnIzAsORnIXRNtXRlA: posts big blind $0.25
RCqMONFrSPSArZh2Jsar/w: sits out 
*** HOLE CARDS ***
VCKtuATyvAq9H2JSAQxPbA: folds 
Bb42QRQMhg5/Y0vHP8/2Xw: folds 
AcL/hxc9eT0dCr2TYk/0Dg: folds 
wGigCmBR/9XWkPpvYos3aQ: raises $0.65 to $0.90
V6p0jQ/RhUsqpHLmXvEX4Q: folds 
+sbyWwIcFp9kP0bDtMegfQ: folds 
fI5jtRq/8R6QjoWU5AnUOQ: folds 
EQXHDnIzAsORnIXRNtXRlA: folds 
Uncalled bet ($0.65) returned to wGigCmBR/9XWkPpvYos3aQ
wGigCmBR/9XWkPpvYos3aQ collected $0.60 from pot
wGigCmBR/9XWkPpvYos3aQ: doesn't show hand 
*** SUMMARY ***
Total pot $0.60 | Rake $0 
Seat 1: AcL/hxc9eT0dCr2TYk/0Dg folded before Flop (didn't bet)
Seat 3: wGigCmBR/9XWkPpvYos3aQ collected ($0.60)
Seat 4: V6p0jQ/RhUsqpHLmXvEX4Q folded before Flop (didn't bet)
Seat 5: +sbyWwIcFp9kP0bDtMegfQ (button) folded before Flop (didn't bet)
Seat 6: fI5jtRq/8R6QjoWU5AnUOQ (small blind) folded before Flop
Seat 7: EQXHDnIzAsORnIXRNtXRlA (big blind) folded before Flop
Seat 8: VCKtuATyvAq9H2JSAQxPbA folded before Flop (didn't bet)
Seat 9: Bb42QRQMhg5/Y0vHP8/2Xw folded before Flop (didn't bet)




PokerStars Game #59941604548:  Hold'em No Limit ($0.10/$0.25) - 2009/07/01 1:40:29 ET
Table 'UVjmXTtsmlX1HxwwZ59akg' 9-max Seat #7 is the button
Seat 1: zDrucyjVn5aeekNEc3cJrA ($47.85 in chips) 
Seat 4: X78b5v/uhqeXXoAijbw/yg ($25 in chips) 
Seat 5: Bb42QRQMhg5/Y0vHP8/2Xw ($39.60 in chips) 
Seat 6: st9jtdNbm1W5GfBwRaCVqQ ($24.30 in chips) 
Seat 7: pB8IyCfDFZaVpov3NHEVJg ($24.90 in chips) 
Seat 8: aqxuKnMZWHy08QjWq1+MrQ ($2.50 in chips) 
aqxuKnMZWHy08QjWq1+MrQ: posts small blind $0.10
RHUxTtZkMrryUUwjBqyF4Q: is sitting out 
zDrucyjVn5aeekNEc3cJrA: posts big blind $0.25
q+Qdg0Hoir+SyL7haBrUnw: sits out 
GmzfAfxcxu1kGbPC+9LkVg: sits out 
*** HOLE CARDS ***
RHUxTtZkMrryUUwjBqyF4Q leaves the table
X78b5v/uhqeXXoAijbw/yg: folds 
Bb42QRQMhg5/Y0vHP8/2Xw: folds 
st9jtdNbm1W5GfBwRaCVqQ: folds 
pB8IyCfDFZaVpov3NHEVJg: folds 
aqxuKnMZWHy08QjWq1+MrQ: folds 
Uncalled bet ($0.15) returned to zDrucyjVn5aeekNEc3cJrA
ljemhp25Zg+nlA9DLCIiUw joins the table at seat #9 
zDrucyjVn5aeekNEc3cJrA collected $0.20 from pot
*** SUMMARY ***
Total pot $0.20 | Rake $0 
Seat 1: zDrucyjVn5aeekNEc3cJrA (big blind) collected ($0.20)
Seat 4: X78b5v/uhqeXXoAijbw/yg folded before Flop (didn't bet)
Seat 5: Bb42QRQMhg5/Y0vHP8/2Xw folded before Flop (didn't bet)
Seat 6: st9jtdNbm1W5GfBwRaCVqQ folded before Flop (didn't bet)
Seat 7: pB8IyCfDFZaVpov3NHEVJg (button) folded before Flop (didn't bet)
Seat 8: aqxuKnMZWHy08QjWq1+MrQ (small blind) folded before Flop




PokerStars Game #59941604538:  Hold'em No Limit ($0.10/$0.25) - 2009/07/01 1:40:29 ET
Table 'CM/C/FZf3VHIp50RjmBucQ' 9-max Seat #4 is the button
Seat 3: HPEB+AtKw1+C/cxU0o1ciw ($51.40 in chips) 
Seat 4: FYIiLXWy4mKC5ZGa/fnS0g ($9.70 in chips) 
Seat 5: oLa/tXLfSLLB28mcLGrxcg ($24.65 in chips) 
Seat 6: Bb42QRQMhg5/Y0vHP8/2Xw ($25.35 in chips) 
Seat 7: j4q3p0lesp63b1gZDwLBZw ($5 in chips) 
Seat 8: cZ99hugmLBj9KhTlc8nCSw ($25 in chips) 
Seat 9: HrQz1sQcyfbz6TvbEEzHWQ ($21.85 in chips) 
oLa/tXLfSLLB28mcLGrxcg: posts small blind $0.10
Bb42QRQMhg5/Y0vHP8/2Xw: posts big blind $0.25
*** HOLE CARDS ***
j4q3p0lesp63b1gZDwLBZw: folds 
cZ99hugmLBj9KhTlc8nCSw: folds 
HrQz1sQcyfbz6TvbEEzHWQ: folds 
HPEB+AtKw1+C/cxU0o1ciw: folds 
FYIiLXWy4mKC5ZGa/fnS0g: raises $0.75 to $1
oLa/tXLfSLLB28mcLGrxcg: folds 
Bb42QRQMhg5/Y0vHP8/2Xw: folds 
Uncalled bet ($0.75) returned to FYIiLXWy4mKC5ZGa/fnS0g
FYIiLXWy4mKC5ZGa/fnS0g collected $0.60 from pot
FYIiLXWy4mKC5ZGa/fnS0g: doesn't show hand 
*** SUMMARY ***
Total pot $0.60 | Rake $0 
Seat 3: HPEB+AtKw1+C/cxU0o1ciw folded before Flop (didn't bet)
Seat 4: FYIiLXWy4mKC5ZGa/fnS0g (button) collected ($0.60)
Seat 5: oLa/tXLfSLLB28mcLGrxcg (small blind) folded before Flop
Seat 6: Bb42QRQMhg5/Y0vHP8/2Xw (big blind) folded before Flop
Seat 7: j4q3p0lesp63b1gZDwLBZw folded before Flop (didn't bet)
Seat 8: cZ99hugmLBj9KhTlc8nCSw folded before Flop (didn't bet)
Seat 9: HrQz1sQcyfbz6TvbEEzHWQ folded before Flop (didn't bet)




PokerStars Game #59941605140:  Hold'em No Limit ($0.10/$0.25) - 2009/07/01 1:40:30 ET
Table 'NfXsh0UQA+o/kO9acV3WxA' 9-max Seat #7 is the button
Seat 3: wCUaomJ6Nq5zomVGdUHP+w ($21.10 in chips) 
Seat 4: r6hsffOo1iKmaPYKwAZmFw ($27.60 in chips) 
Seat 5: V/6KhUyefeL34u/m51HnmQ ($16.20 in chips) 
Seat 6: cFmpjvcjNoVAEAIQIxWkYg ($25 in chips) 
Seat 7: yqkowiRWZ6NvRN9UUkYIlA ($5 in chips) 
Seat 8: +sbyWwIcFp9kP0bDtMegfQ ($41.85 in chips) 
Seat 9: uhrboV251dcgYniYTdFIcA ($25 in chips) 
+sbyWwIcFp9kP0bDtMegfQ: posts small blind $0.10
uhrboV251dcgYniYTdFIcA: posts big blind $0.25
pN3IHvAKm2fz+sTRARTcrg: sits out 
SchoolATC: sits out 
*** HOLE CARDS ***
wCUaomJ6Nq5zomVGdUHP+w: calls $0.25
r6hsffOo1iKmaPYKwAZmFw: raises $1 to $1.25
V/6KhUyefeL34u/m51HnmQ: folds 
cFmpjvcjNoVAEAIQIxWkYg: folds 
V/6KhUyefeL34u/m51HnmQ leaves the table
yqkowiRWZ6NvRN9UUkYIlA: folds 
+sbyWwIcFp9kP0bDtMegfQ: folds 
uhrboV251dcgYniYTdFIcA: calls $1
wCUaomJ6Nq5zomVGdUHP+w: calls $1
*** FLOP *** [4s Kd 5h]
zgi+EUykT/pZQpoUG6+oEg joins the table at seat #5 
uhrboV251dcgYniYTdFIcA: checks 
wCUaomJ6Nq5zomVGdUHP+w: checks 
r6hsffOo1iKmaPYKwAZmFw: bets $2.75
uhrboV251dcgYniYTdFIcA: folds 
wCUaomJ6Nq5zomVGdUHP+w: folds 
Uncalled bet ($2.75) returned to r6hsffOo1iKmaPYKwAZmFw
r6hsffOo1iKmaPYKwAZmFw collected $3.70 from pot
r6hsffOo1iKmaPYKwAZmFw: doesn't show hand 
*** SUMMARY ***
Total pot $3.85 | Rake $0.15 
Board [4s Kd 5h]
Seat 3: wCUaomJ6Nq5zomVGdUHP+w folded on the Flop
Seat 4: r6hsffOo1iKmaPYKwAZmFw collected ($3.70)
Seat 5: V/6KhUyefeL34u/m51HnmQ folded before Flop (didn't bet)
Seat 6: cFmpjvcjNoVAEAIQIxWkYg folded before Flop (didn't bet)
Seat 7: yqkowiRWZ6NvRN9UUkYIlA (button) folded before Flop (didn't bet)
Seat 8: +sbyWwIcFp9kP0bDtMegfQ (small blind) folded before Flop
Seat 9: uhrboV251dcgYniYTdFIcA (big blind) folded on the Flop




PokerStars Game #59941605084:  Hold'em No Limit ($0.10/$0.25) - 2009/07/01 1:40:30 ET
Table 'l57rayEpPtZotP9nqgSWBg' 6-max Seat #4 is the button
Seat 1: DihMHaz4WNETH1bPDe13kA ($55.75 in chips) 
Seat 2: p6adJRMXMBLr+xtQzqazIQ ($16.40 in chips) 
Seat 3: L3/N/gliETan8N5Gim5h4Q ($25 in chips) 
Seat 4: OqkdGXy1SCzuN5Q0wNlFSg ($18.20 in chips) 
Seat 6: IGRfskE1v9H9Bn+fz8AgNQ ($17.40 in chips) 
IGRfskE1v9H9Bn+fz8AgNQ: posts small blind $0.10
DihMHaz4WNETH1bPDe13kA: posts big blind $0.25
*** HOLE CARDS ***
p6adJRMXMBLr+xtQzqazIQ: folds 
L3/N/gliETan8N5Gim5h4Q: folds 
WKJHaZPUgrpTVyLOEjLYmg has returned
OqkdGXy1SCzuN5Q0wNlFSg: folds 
IGRfskE1v9H9Bn+fz8AgNQ: folds 
Uncalled bet ($0.15) returned to DihMHaz4WNETH1bPDe13kA
DihMHaz4WNETH1bPDe13kA collected $0.20 from pot
*** SUMMARY ***
Total pot $0.20 | Rake $0 
Seat 1: DihMHaz4WNETH1bPDe13kA (big blind) collected ($0.20)
Seat 2: p6adJRMXMBLr+xtQzqazIQ folded before Flop (didn't bet)
Seat 3: L3/N/gliETan8N5Gim5h4Q folded before Flop (didn't bet)
Seat 4: OqkdGXy1SCzuN5Q0wNlFSg (button) folded before Flop (didn't bet)
Seat 6: IGRfskE1v9H9Bn+fz8AgNQ (small blind) folded before Flop




PokerStars Game #59941605172:  Hold'em No Limit ($0.10/$0.25) - 2009/07/01 1:40:30 ET
Table 'VQNfcI8vTBCTvRfd3veTLQ' 6-max Seat #4 is the button
Seat 2: 79ID/ub1Pt/mDpCprVmOoA ($30.20 in chips) 
Seat 3: LtASJ9OlkqGrrUKGQlpGAw ($12.10 in chips) 
Seat 4: QIWnfLSqfMcoFfdDe5LZPg ($40.70 in chips) 
Seat 5: gX2vbKwS/8zZPENAWB7hxQ ($22.40 in chips) 
Seat 6: LJI7A1YgDM7hgh7o56+ReQ ($27.70 in chips) 
gX2vbKwS/8zZPENAWB7hxQ: posts small blind $0.10
LJI7A1YgDM7hgh7o56+ReQ: posts big blind $0.25
*** HOLE CARDS ***
79ID/ub1Pt/mDpCprVmOoA: raises $0.50 to $0.75
LtASJ9OlkqGrrUKGQlpGAw: folds 
QIWnfLSqfMcoFfdDe5LZPg: folds 
gX2vbKwS/8zZPENAWB7hxQ: calls $0.65
LJI7A1YgDM7hgh7o56+ReQ: folds 
*** FLOP *** [6d 3c Ks]
gX2vbKwS/8zZPENAWB7hxQ: checks 
79ID/ub1Pt/mDpCprVmOoA: bets $1.25
gX2vbKwS/8zZPENAWB7hxQ: calls $1.25
*** TURN *** [6d 3c Ks] [5c]
gX2vbKwS/8zZPENAWB7hxQ: checks 
79ID/ub1Pt/mDpCprVmOoA: bets $3
gX2vbKwS/8zZPENAWB7hxQ: folds 
Uncalled bet ($3) returned to 79ID/ub1Pt/mDpCprVmOoA
79ID/ub1Pt/mDpCprVmOoA collected $4.05 from pot
79ID/ub1Pt/mDpCprVmOoA: doesn't show hand 
*** SUMMARY ***
Total pot $4.25 | Rake $0.20 
Board [6d 3c Ks 5c]
Seat 2: 79ID/ub1Pt/mDpCprVmOoA collected ($4.05)
Seat 3: LtASJ9OlkqGrrUKGQlpGAw folded before Flop (didn't bet)
Seat 4: QIWnfLSqfMcoFfdDe5LZPg (button) folded before Flop (didn't bet)
Seat 5: gX2vbKwS/8zZPENAWB7hxQ (small blind) folded on the Turn
Seat 6: LJI7A1YgDM7hgh7o56+ReQ (big blind) folded before Flop




PokerStars Game #59941604932:  Hold'em No Limit ($0.10/$0.25) - 2009/07/01 1:40:30 ET
Table 'mdub7rJf3Z5tCT9s/+1+Wg' 9-max Seat #2 is the button
Seat 1: cZ99hugmLBj9KhTlc8nCSw ($29.25 in chips) 
Seat 2: 539MC3AwKLWVFwzABc644Q ($9.60 in chips) 
Seat 3: PdIasPkzm2sqZnN41ZRXOg ($4.75 in chips) 
Seat 4: fDGyaQz0cs2s4FOYxkbIHA ($15.20 in chips) 
Seat 5: dfNim92Z6XK1/h5SFW5vDg ($25.60 in chips) 
Seat 6: T/CCwAWe2yhO0c4oHNwicw ($22.45 in chips) 
Seat 7: woe+9KKk+L3pZgMTuHcmog ($16.10 in chips) 
Seat 8: Z9AeOQX3yzuSvKAm/xyovg ($6.75 in chips) 
Seat 9: tYsOBqdU1+x+yFI7zHO7hQ ($36.80 in chips) 
PdIasPkzm2sqZnN41ZRXOg: posts small blind $0.10
fDGyaQz0cs2s4FOYxkbIHA: posts big blind $0.25
*** HOLE CARDS ***
dfNim92Z6XK1/h5SFW5vDg: folds 
T/CCwAWe2yhO0c4oHNwicw: folds 
woe+9KKk+L3pZgMTuHcmog: raises $0.75 to $1
Z9AeOQX3yzuSvKAm/xyovg: folds 
tYsOBqdU1+x+yFI7zHO7hQ: folds 
cZ99hugmLBj9KhTlc8nCSw: folds 
539MC3AwKLWVFwzABc644Q: folds 
PdIasPkzm2sqZnN41ZRXOg: folds 
fDGyaQz0cs2s4FOYxkbIHA: folds 
Uncalled bet ($0.75) returned to woe+9KKk+L3pZgMTuHcmog
woe+9KKk+L3pZgMTuHcmog collected $0.60 from pot
*** SUMMARY ***
Total pot $0.60 | Rake $0 
Seat 1: cZ99hugmLBj9KhTlc8nCSw folded before Flop (didn't bet)
Seat 2: 539MC3AwKLWVFwzABc644Q (button) folded before Flop (didn't bet)
Seat 3: PdIasPkzm2sqZnN41ZRXOg (small blind) folded before Flop
Seat 4: fDGyaQz0cs2s4FOYxkbIHA (big blind) folded before Flop
Seat 5: dfNim92Z6XK1/h5SFW5vDg folded before Flop (didn't bet)
Seat 6: T/CCwAWe2yhO0c4oHNwicw folded before Flop (didn't bet)
Seat 7: woe+9KKk+L3pZgMTuHcmog collected ($0.60)
Seat 8: Z9AeOQX3yzuSvKAm/xyovg folded before Flop (didn't bet)
Seat 9: tYsOBqdU1+x+yFI7zHO7hQ folded before Flop (didn't bet)




PokerStars Game #59941605860:  Hold'em No Limit ($0.10/$0.25) - 2009/07/01 1:40:31 ET
Table 'WjNvuuSgTjm8jh0j9vcCgQ' 9-max Seat #4 is the button
Seat 1: q+Qdg0Hoir+SyL7haBrUnw ($8.05 in chips) 
Seat 2: ghNKXUBl/H+t83JF079ZBA ($23.40 in chips) 
Seat 3: pSKReiGBNW9NsF2jAZnlwg ($22.15 in chips) 
Seat 4: X78b5v/uhqeXXoAijbw/yg ($31.35 in chips) 
Seat 5: ziFpkH3wCzqB/qXeq/Hy7g ($25 in chips) 
Seat 6: ubsjZomMWSV0hAiBLa7K1A ($20.55 in chips) 
Seat 7: NSX8YOj+RznxoL+rO1YU4w ($13.25 in chips) 
Seat 8: hZuGwtYmFKPmQ+v1wlmdfA ($17.75 in chips) 
Seat 9: CT7Xj/V/O5rBlhtt+RZeFQ ($25.60 in chips) 
ziFpkH3wCzqB/qXeq/Hy7g: posts small blind $0.10
ubsjZomMWSV0hAiBLa7K1A: posts big blind $0.25
*** HOLE CARDS ***
NSX8YOj+RznxoL+rO1YU4w: folds 
hZuGwtYmFKPmQ+v1wlmdfA: folds 
CT7Xj/V/O5rBlhtt+RZeFQ: folds 
q+Qdg0Hoir+SyL7haBrUnw: folds 
ghNKXUBl/H+t83JF079ZBA: folds 
pSKReiGBNW9NsF2jAZnlwg: calls $0.25
X78b5v/uhqeXXoAijbw/yg: folds 
ziFpkH3wCzqB/qXeq/Hy7g: folds 
ubsjZomMWSV0hAiBLa7K1A: checks 
*** FLOP *** [8c 4d 7d]
ubsjZomMWSV0hAiBLa7K1A: checks 
pSKReiGBNW9NsF2jAZnlwg: bets $0.50
ubsjZomMWSV0hAiBLa7K1A: calls $0.50
*** TURN *** [8c 4d 7d] [4c]
ubsjZomMWSV0hAiBLa7K1A: checks 
pSKReiGBNW9NsF2jAZnlwg: checks 
*** RIVER *** [8c 4d 7d 4c] [5h]
ubsjZomMWSV0hAiBLa7K1A: bets $1.25
pSKReiGBNW9NsF2jAZnlwg: folds 
Uncalled bet ($1.25) returned to ubsjZomMWSV0hAiBLa7K1A
ubsjZomMWSV0hAiBLa7K1A collected $1.55 from pot
*** SUMMARY ***
Total pot $1.60 | Rake $0.05 
Board [8c 4d 7d 4c 5h]
Seat 1: q+Qdg0Hoir+SyL7haBrUnw folded before Flop (didn't bet)
Seat 2: ghNKXUBl/H+t83JF079ZBA folded before Flop (didn't bet)
Seat 3: pSKReiGBNW9NsF2jAZnlwg folded on the River
Seat 4: X78b5v/uhqeXXoAijbw/yg (button) folded before Flop (didn't bet)
Seat 5: ziFpkH3wCzqB/qXeq/Hy7g (small blind) folded before Flop
Seat 6: ubsjZomMWSV0hAiBLa7K1A (big blind) collected ($1.55)
Seat 7: NSX8YOj+RznxoL+rO1YU4w folded before Flop (didn't bet)
Seat 8: hZuGwtYmFKPmQ+v1wlmdfA folded before Flop (didn't bet)
Seat 9: CT7Xj/V/O5rBlhtt+RZeFQ folded before Flop (didn't bet)




PokerStars Game #59941605790:  Hold'em No Limit ($0.10/$0.25) - 2009/07/01 1:40:31 ET
Table 'D1Yq70l0nNCyMV6DA42p+Q' 9-max Seat #3 is the button
Seat 1: z5GxcHlYz/GSz6W2uFiTtg ($19.05 in chips) 
Seat 2: zgi+EUykT/pZQpoUG6+oEg ($4.30 in chips) 
Seat 3: 9lvO/qyU+xrU95Teu1fv0g ($5.50 in chips) 
Seat 4: VWUWpMLMj/Q1jRVpF7Aohw ($11.25 in chips) 
Seat 5: gehe91e0IyVT0QU/XBkEyg ($25 in chips) 
Seat 6: wGigCmBR/9XWkPpvYos3aQ ($30.05 in chips) 
Seat 7: Lqytncc1Dsgt654eEBp/uw ($31.05 in chips) 
Seat 8: zDrucyjVn5aeekNEc3cJrA ($24.35 in chips) 
Seat 9: h5wEs8qXrBqfLa9GjaSBzg ($23.90 in chips) 
VWUWpMLMj/Q1jRVpF7Aohw: posts small blind $0.10
gehe91e0IyVT0QU/XBkEyg: posts big blind $0.25
*** HOLE CARDS ***
wGigCmBR/9XWkPpvYos3aQ: folds 
Lqytncc1Dsgt654eEBp/uw: folds 
zDrucyjVn5aeekNEc3cJrA: folds 
h5wEs8qXrBqfLa9GjaSBzg: raises $0.50 to $0.75
z5GxcHlYz/GSz6W2uFiTtg: folds 
zgi+EUykT/pZQpoUG6+oEg: folds 
9lvO/qyU+xrU95Teu1fv0g: folds 
VWUWpMLMj/Q1jRVpF7Aohw: folds 
gehe91e0IyVT0QU/XBkEyg: folds 
Uncalled bet ($0.50) returned to h5wEs8qXrBqfLa9GjaSBzg
h5wEs8qXrBqfLa9GjaSBzg collected $0.60 from pot
h5wEs8qXrBqfLa9GjaSBzg: doesn't show hand 
*** SUMMARY ***
Total pot $0.60 | Rake $0 
Seat 1: z5GxcHlYz/GSz6W2uFiTtg folded before Flop (didn't bet)
Seat 2: zgi+EUykT/pZQpoUG6+oEg folded before Flop (didn't bet)
Seat 3: 9lvO/qyU+xrU95Teu1fv0g (button) folded before Flop (didn't bet)
Seat 4: VWUWpMLMj/Q1jRVpF7Aohw (small blind) folded before Flop
Seat 5: gehe91e0IyVT0QU/XBkEyg (big blind) folded before Flop
Seat 6: wGigCmBR/9XWkPpvYos3aQ folded before Flop (didn't bet)
Seat 7: Lqytncc1Dsgt654eEBp/uw folded before Flop (didn't bet)
Seat 8: zDrucyjVn5aeekNEc3cJrA folded before Flop (didn't bet)
Seat 9: h5wEs8qXrBqfLa9GjaSBzg collected ($0.60)




PokerStars Game #59941605636:  Hold'em No Limit ($0.10/$0.25) - 2009/07/01 1:40:31 ET
Table 'nc6OeGk/wtaWV+6N+kgnZQgZetDqJh6q9A3mLO3ThCsASeat #6 is the button
Seat 1: DihMHaz4WNETH1bPDe13kA ($26.40 in chips) 
Seat 2: JFIAqU8lCZ0vWwEl4bdGsg ($33.05 in chips) 
Seat 3: jp34e617tIzV8tKIWmfAbA ($33.15 in chips) 
Seat 4: BV+K0Phf5VBHr7aZPKqbUQ ($29 in chips) 
Seat 6: 8tR2s7yV/Fr0ePp1w5XnJw ($9.65 in chips) 
DihMHaz4WNETH1bPDe13kA: posts small blind $0.10
JFIAqU8lCZ0vWwEl4bdGsg: posts big blind $0.25
*** HOLE CARDS ***
jp34e617tIzV8tKIWmfAbA: folds 
BV+K0Phf5VBHr7aZPKqbUQ: folds 
8tR2s7yV/Fr0ePp1w5XnJw: folds 
DihMHaz4WNETH1bPDe13kA: folds 
Uncalled bet ($0.15) returned to JFIAqU8lCZ0vWwEl4bdGsg
JFIAqU8lCZ0vWwEl4bdGsg collected $0.20 from pot
JFIAqU8lCZ0vWwEl4bdGsg: doesn't show hand 
*** SUMMARY ***
Total pot $0.20 | Rake $0 
Seat 1: DihMHaz4WNETH1bPDe13kA (small blind) folded before Flop
Seat 2: JFIAqU8lCZ0vWwEl4bdGsg (big blind) collected ($0.20)
Seat 3: jp34e617tIzV8tKIWmfAbA folded before Flop (didn't bet)
Seat 4: BV+K0Phf5VBHr7aZPKqbUQ folded before Flop (didn't bet)
Seat 6: 8tR2s7yV/Fr0ePp1w5XnJw (button) folded before Flop (didn't bet)




PokerStars Game #59941605726:  Hold'em No Limit ($0.10/$0.25) - 2009/07/01 1:40:31 ET
Table '2AUmC2Rslg+QUbLfdgNdfg' 6-max Seat #4 is the button
Seat 1: YDXAegrCnzc0l6TSDNboXQ ($24.60 in chips) 
Seat 2: PLksyNlTVRVZwxJVC2/1eA ($23.85 in chips) 
Seat 3: JFIAqU8lCZ0vWwEl4bdGsg ($25.35 in chips) 
Seat 4: lquriepNQBhDV5P1SWHhnA ($26 in chips) 
Seat 5: AMc4cCwUJhokdGRYIaVPhQ ($22.35 in chips) 
Seat 6: xBWc54v+UTSJOiKpbAbJWg ($12.20 in chips) 
AMc4cCwUJhokdGRYIaVPhQ: posts small blind $0.10
xBWc54v+UTSJOiKpbAbJWg: posts big blind $0.25
*** HOLE CARDS ***
YDXAegrCnzc0l6TSDNboXQ: calls $0.25
PLksyNlTVRVZwxJVC2/1eA: folds 
JFIAqU8lCZ0vWwEl4bdGsg: folds 
lquriepNQBhDV5P1SWHhnA: raises $1 to $1.25
AMc4cCwUJhokdGRYIaVPhQ: folds 
xBWc54v+UTSJOiKpbAbJWg: folds 
YDXAegrCnzc0l6TSDNboXQ: folds 
Uncalled bet ($1) returned to lquriepNQBhDV5P1SWHhnA
lquriepNQBhDV5P1SWHhnA collected $0.85 from pot
lquriepNQBhDV5P1SWHhnA: doesn't show hand 
*** SUMMARY ***
Total pot $0.85 | Rake $0 
Seat 1: YDXAegrCnzc0l6TSDNboXQ folded before Flop
Seat 2: PLksyNlTVRVZwxJVC2/1eA folded before Flop (didn't bet)
Seat 3: JFIAqU8lCZ0vWwEl4bdGsg folded before Flop (didn't bet)
Seat 4: lquriepNQBhDV5P1SWHhnA (button) collected ($0.85)
Seat 5: AMc4cCwUJhokdGRYIaVPhQ (small blind) folded before Flop
Seat 6: xBWc54v+UTSJOiKpbAbJWg (big blind) folded before Flop




PokerStars Game #59941605472:  Hold'em No Limit ($0.10/$0.25) - 2009/07/01 1:40:31 ET
Table 'T/iCKJXGphRN3xcdwfE/JQ' 6-max Seat #1 is the button
Seat 1: wAKC8C/zN0c8V5v13dm9mA ($25 in chips) 
Seat 2: EeUZtMU058v2ObUACOF4Og ($33.85 in chips) 
Seat 3: IWAjoCPXtc1XUaZdp+pCpA ($22.35 in chips) 
Seat 4: tSR4329m40dZsN7YOpI9Kw ($53.85 in chips) 
Seat 5: gaPMxLGp9SOj4Lq6t+/0Ig ($4.20 in chips) 
Seat 6: Ey4Kn6PlnYb2srYYBJHvzg ($15.85 in chips) 
EeUZtMU058v2ObUACOF4Og: posts small blind $0.10
IWAjoCPXtc1XUaZdp+pCpA: posts big blind $0.25
*** HOLE CARDS ***
tSR4329m40dZsN7YOpI9Kw: raises $0.50 to $0.75
gaPMxLGp9SOj4Lq6t+/0Ig: folds 
Ey4Kn6PlnYb2srYYBJHvzg: folds 
wAKC8C/zN0c8V5v13dm9mA: folds 
EeUZtMU058v2ObUACOF4Og: folds 
IWAjoCPXtc1XUaZdp+pCpA: folds 
Uncalled bet ($0.50) returned to tSR4329m40dZsN7YOpI9Kw
tSR4329m40dZsN7YOpI9Kw collected $0.60 from pot
*** SUMMARY ***
Total pot $0.60 | Rake $0 
Seat 1: wAKC8C/zN0c8V5v13dm9mA (button) folded before Flop (didn't bet)
Seat 2: EeUZtMU058v2ObUACOF4Og (small blind) folded before Flop
Seat 3: IWAjoCPXtc1XUaZdp+pCpA (big blind) folded before Flop
Seat 4: tSR4329m40dZsN7YOpI9Kw collected ($0.60)
Seat 5: gaPMxLGp9SOj4Lq6t+/0Ig folded before Flop (didn't bet)
Seat 6: Ey4Kn6PlnYb2srYYBJHvzg folded before Flop (didn't bet)




PokerStars Game #59941605410:  Hold'em No Limit ($0.10/$0.25) - 2009/07/01 1:40:31 ET
Table 'JJzUs04lHpXg6nboT1/jeg' 6-max Seat #3 is the button
Seat 1: MqMK8OWPSY1V4stf1Hy5Jw ($38.95 in chips) 
Seat 2: jxfR29d+dK/7h7s3SvCk+g ($4.85 in chips) 
Seat 3: 4zXbHDe39qNX46dAo81b4w ($6.95 in chips) 
Seat 4: 7VfhiFY533nbUKvyEthASw ($29.95 in chips) 
Seat 5: QvTX2yGq3uKJiKPmns4TKQ ($23 in chips) 
Seat 6: wqphQtauX5Qn7WRJZS1flA ($29.30 in chips) 
7VfhiFY533nbUKvyEthASw: posts small blind $0.10
QvTX2yGq3uKJiKPmns4TKQ: posts big blind $0.25
*** HOLE CARDS ***
wqphQtauX5Qn7WRJZS1flA: folds 
MqMK8OWPSY1V4stf1Hy5Jw: folds 
jxfR29d+dK/7h7s3SvCk+g: raises $0.75 to $1
4zXbHDe39qNX46dAo81b4w: folds 
7VfhiFY533nbUKvyEthASw: folds 
QvTX2yGq3uKJiKPmns4TKQ: folds 
Uncalled bet ($0.75) returned to jxfR29d+dK/7h7s3SvCk+g
jxfR29d+dK/7h7s3SvCk+g collected $0.60 from pot
*** SUMMARY ***
Total pot $0.60 | Rake $0 
Seat 1: MqMK8OWPSY1V4stf1Hy5Jw folded before Flop (didn't bet)
Seat 2: jxfR29d+dK/7h7s3SvCk+g collected ($0.60)
Seat 3: 4zXbHDe39qNX46dAo81b4w (button) folded before Flop (didn't bet)
Seat 4: 7VfhiFY533nbUKvyEthASw (small blind) folded before Flop
Seat 5: QvTX2yGq3uKJiKPmns4TKQ (big blind) folded before Flop
Seat 6: wqphQtauX5Qn7WRJZS1flA folded before Flop (didn't bet)




PokerStars Game #59941606244:  Hold'em No Limit ($0.10/$0.25) - 2009/07/01 1:40:32 ET
Table '9L7XfAwuM7XsXE8LIg2o5Q' 6-max Seat #4 is the button
Seat 1: dOIoLBxmpLHSXBN9LZnf0Q ($25.10 in chips) 
Seat 2: LJI7A1YgDM7hgh7o56+ReQ ($26.60 in chips) 
Seat 3: kv2o5BKCLOrJIw4oc083jQ ($27.45 in chips) 
Seat 4: jp34e617tIzV8tKIWmfAbA ($39.95 in chips) 
Seat 5: OUv909q/YxsJgxpSlZxLJQ ($33.15 in chips) 
Seat 6: k9nHZTHt8hYhYRcW8NTb4g ($37.35 in chips) 
OUv909q/YxsJgxpSlZxLJQ: posts small blind $0.10
k9nHZTHt8hYhYRcW8NTb4g: posts big blind $0.25
*** HOLE CARDS ***
dOIoLBxmpLHSXBN9LZnf0Q: calls $0.25
LJI7A1YgDM7hgh7o56+ReQ: folds 
kv2o5BKCLOrJIw4oc083jQ: calls $0.25
jp34e617tIzV8tKIWmfAbA: folds 
OUv909q/YxsJgxpSlZxLJQ: calls $0.15
k9nHZTHt8hYhYRcW8NTb4g: checks 
*** FLOP *** [Ac 9c 7c]
OUv909q/YxsJgxpSlZxLJQ: bets $0.75
k9nHZTHt8hYhYRcW8NTb4g: folds 
dOIoLBxmpLHSXBN9LZnf0Q: folds 
kv2o5BKCLOrJIw4oc083jQ: folds 
Uncalled bet ($0.75) returned to OUv909q/YxsJgxpSlZxLJQ
OUv909q/YxsJgxpSlZxLJQ collected $0.95 from pot
OUv909q/YxsJgxpSlZxLJQ: doesn't show hand 
*** SUMMARY ***
Total pot $1 | Rake $0.05 
Board [Ac 9c 7c]
Seat 1: dOIoLBxmpLHSXBN9LZnf0Q folded on the Flop
Seat 2: LJI7A1YgDM7hgh7o56+ReQ folded before Flop (didn't bet)
Seat 3: kv2o5BKCLOrJIw4oc083jQ folded on the Flop
Seat 4: jp34e617tIzV8tKIWmfAbA (button) folded before Flop (didn't bet)
Seat 5: OUv909q/YxsJgxpSlZxLJQ (small blind) collected ($0.95)
Seat 6: k9nHZTHt8hYhYRcW8NTb4g (big blind) folded on the Flop




PokerStars Game #59941605984:  Hold'em No Limit ($0.10/$0.25) - 2009/07/01 1:40:32 ET
Table 'ykyWGjhNu7AvZXov27T4ew' 9-max Seat #8 is the button
Seat 2: MG90wfSJZnOejs/KD3vlQQ ($40.10 in chips) 
Seat 3: NPI9ArW8kwrb6a2IAL6xMQ ($27.45 in chips) 
Seat 4: W6tExOcYX7qiy6Qdp+ZwFA ($4.90 in chips) 
Seat 5: CmngQmkKTp8tkl6GMRTl6w ($8.50 in chips) 
Seat 6: AiXn/9o1EwOPZUHujnh/bA ($20.40 in chips) 
Seat 7: npAYqa85pqnzfOK5ukX+BQ ($20.65 in chips) 
Seat 8: tYsOBqdU1+x+yFI7zHO7hQ ($49.35 in chips) 
Seat 9: wk9M6R3w+aDHpr8WV87RmQ ($11.35 in chips) 
wk9M6R3w+aDHpr8WV87RmQ: posts small blind $0.10
MG90wfSJZnOejs/KD3vlQQ: posts big blind $0.25
*** HOLE CARDS ***
NPI9ArW8kwrb6a2IAL6xMQ: calls $0.25
W6tExOcYX7qiy6Qdp+ZwFA: folds 
CmngQmkKTp8tkl6GMRTl6w: folds 
AiXn/9o1EwOPZUHujnh/bA: folds 
W8cIfrCR+zA8pCNyIuHu8g leaves the table
npAYqa85pqnzfOK5ukX+BQ: raises $0.75 to $1
tYsOBqdU1+x+yFI7zHO7hQ: folds 
wk9M6R3w+aDHpr8WV87RmQ: folds 
MG90wfSJZnOejs/KD3vlQQ: folds 
NPI9ArW8kwrb6a2IAL6xMQ: calls $0.75
*** FLOP *** [Kd 4h 8c]
NPI9ArW8kwrb6a2IAL6xMQ: checks 
npAYqa85pqnzfOK5ukX+BQ: checks 
*** TURN *** [Kd 4h 8c] [5h]
AiXn/9o1EwOPZUHujnh/bA is disconnected 
NPI9ArW8kwrb6a2IAL6xMQ: checks 
AiXn/9o1EwOPZUHujnh/bA is connected 
npAYqa85pqnzfOK5ukX+BQ: checks 
*** RIVER *** [Kd 4h 8c 5h] [Js]
NPI9ArW8kwrb6a2IAL6xMQ: checks 
npAYqa85pqnzfOK5ukX+BQ: checks 
*** SHOW DOWN ***
NPI9ArW8kwrb6a2IAL6xMQ: shows [Qh 9c] (high card King)
npAYqa85pqnzfOK5ukX+BQ: shows [Qs Ts] (high card King - Queen+Jack+Ten kicker)
npAYqa85pqnzfOK5ukX+BQ collected $2.25 from pot
*** SUMMARY ***
Total pot $2.35 | Rake $0.10 
Board [Kd 4h 8c 5h Js]
Seat 2: MG90wfSJZnOejs/KD3vlQQ (big blind) folded before Flop
Seat 3: NPI9ArW8kwrb6a2IAL6xMQ showed [Qh 9c] and lost with high card King
Seat 4: W6tExOcYX7qiy6Qdp+ZwFA folded before Flop (didn't bet)
Seat 5: CmngQmkKTp8tkl6GMRTl6w folded before Flop (didn't bet)
Seat 6: AiXn/9o1EwOPZUHujnh/bA folded before Flop (didn't bet)
Seat 7: npAYqa85pqnzfOK5ukX+BQ showed [Qs Ts] and won ($2.25) with high card King
Seat 8: tYsOBqdU1+x+yFI7zHO7hQ (button) folded before Flop (didn't bet)
Seat 9: wk9M6R3w+aDHpr8WV87RmQ (small blind) folded before Flop




PokerStars Game #59941606054:  Hold'em No Limit ($0.10/$0.25) - 2009/07/01 1:40:32 ET
Table 'wPWRBZPJl1HAnysw7qRR0A' 6-max Seat #6 is the button
Seat 1: m7ne1MOFTQXlsXT7/R/rug ($8.90 in chips) 
Seat 3: 1ZpoLWO2nm2w1Nd1v9Sr3g ($6.65 in chips) 
Seat 5: y0B+UpYpOUJz3JWtlJQBSA ($21.45 in chips) 
Seat 6: Hsvkc0/G2VV78oVmWYXecw ($5 in chips) 
m7ne1MOFTQXlsXT7/R/rug: posts small blind $0.10
1ZpoLWO2nm2w1Nd1v9Sr3g: posts big blind $0.25
epAUIB7h2FJXzUPRIvSkRA: sits out 
*** HOLE CARDS ***
y0B+UpYpOUJz3JWtlJQBSA: folds 
Hsvkc0/G2VV78oVmWYXecw: folds 
m7ne1MOFTQXlsXT7/R/rug: calls $0.15
1ZpoLWO2nm2w1Nd1v9Sr3g: checks 
*** FLOP *** [2c Js 2d]
m7ne1MOFTQXlsXT7/R/rug: bets $0.50
1ZpoLWO2nm2w1Nd1v9Sr3g: folds 
Uncalled bet ($0.50) returned to m7ne1MOFTQXlsXT7/R/rug
m7ne1MOFTQXlsXT7/R/rug collected $0.50 from pot
m7ne1MOFTQXlsXT7/R/rug: shows [4s Jh] (two pair, Jacks and Deuces)
*** SUMMARY ***
Total pot $0.50 | Rake $0 
Board [2c Js 2d]
Seat 1: m7ne1MOFTQXlsXT7/R/rug (small blind) collected ($0.50)
Seat 3: 1ZpoLWO2nm2w1Nd1v9Sr3g (big blind) folded on the Flop
Seat 5: y0B+UpYpOUJz3JWtlJQBSA folded before Flop (didn't bet)
Seat 6: Hsvkc0/G2VV78oVmWYXecw (button) folded before Flop (didn't bet)




PokerStars Game #59941606834:  Hold'em No Limit ($0.10/$0.25) - 2009/07/01 1:40:33 ET
Table '8PD/MTROSMd6Y8mZeykbpg' 6-max Seat #2 is the button
Seat 1: fxNpaToxECtD2Goelmg9vA ($25 in chips) 
Seat 2: +C3eP/ysyROWbEXJFPswVA ($25.10 in chips) 
Seat 3: vqWjZmdQu/Hxw96/IJTWdQ ($25.10 in chips) 
Seat 4: DFi/Lzkjsfv8QswS80JX9Q ($53.70 in chips) 
Seat 5: z3tQwy28dp5FykDJC/wzQw ($25.95 in chips) 
vqWjZmdQu/Hxw96/IJTWdQ: posts small blind $0.10
DFi/Lzkjsfv8QswS80JX9Q: posts big blind $0.25
fxNpaToxECtD2Goelmg9vA: posts big blind $0.25
*** HOLE CARDS ***
z3tQwy28dp5FykDJC/wzQw: folds 
fxNpaToxECtD2Goelmg9vA: checks 
+C3eP/ysyROWbEXJFPswVA: folds 
vqWjZmdQu/Hxw96/IJTWdQ: raises $1 to $1.25
DFi/Lzkjsfv8QswS80JX9Q: folds 
fxNpaToxECtD2Goelmg9vA: folds 
Uncalled bet ($1) returned to vqWjZmdQu/Hxw96/IJTWdQ
vqWjZmdQu/Hxw96/IJTWdQ collected $0.75 from pot
vqWjZmdQu/Hxw96/IJTWdQ: doesn't show hand 
*** SUMMARY ***
Total pot $0.75 | Rake $0 
Seat 1: fxNpaToxECtD2Goelmg9vA folded before Flop
Seat 2: +C3eP/ysyROWbEXJFPswVA (button) folded before Flop (didn't bet)
Seat 3: vqWjZmdQu/Hxw96/IJTWdQ (small blind) collected ($0.75)
Seat 4: DFi/Lzkjsfv8QswS80JX9Q (big blind) folded before Flop
Seat 5: z3tQwy28dp5FykDJC/wzQw folded before Flop (didn't bet)




PokerStars Game #59941606696:  Hold'em No Limit ($0.10/$0.25) - 2009/07/01 1:40:33 ET
Table 'Of/T60zpXg1GcjrZ7Lm//Q' 9-max Seat #1 is the button
Seat 1: Lro4e37x4FUa5P3yzDjskw ($15.55 in chips) 
Seat 2: qwr38jl5txoR36M7G5qi4A ($10 in chips) 
Seat 3: 6RiVTYll/5D8zICp0MRpKw ($24.15 in chips) 
Seat 4: Czut6V7acIqUJrrobjKAZg ($17.50 in chips) 
Seat 5: IiLkthQMEje9LS79rCFQ1Q ($9.45 in chips) 
Seat 6: tYsOBqdU1+x+yFI7zHO7hQ ($32.05 in chips) 
Seat 7: PVxvfRTRvkgZf9WtquEkwQ ($25 in chips) 
Seat 8: ghNKXUBl/H+t83JF079ZBA ($26.50 in chips) 
Seat 9: egvg3mTBBVzMHnJPIQiKcA ($14 in chips) 
qwr38jl5txoR36M7G5qi4A: posts small blind $0.10
6RiVTYll/5D8zICp0MRpKw: posts big blind $0.25
*** HOLE CARDS ***
Czut6V7acIqUJrrobjKAZg: folds 
IiLkthQMEje9LS79rCFQ1Q: folds 
tYsOBqdU1+x+yFI7zHO7hQ: raises $0.75 to $1
PVxvfRTRvkgZf9WtquEkwQ: folds 
ghNKXUBl/H+t83JF079ZBA: folds 
egvg3mTBBVzMHnJPIQiKcA: folds 
Lro4e37x4FUa5P3yzDjskw: calls $1
qwr38jl5txoR36M7G5qi4A: folds 
6RiVTYll/5D8zICp0MRpKw: folds 
*** FLOP *** [3s 8h 3d]
tYsOBqdU1+x+yFI7zHO7hQ: checks 
Lro4e37x4FUa5P3yzDjskw: bets $2
tYsOBqdU1+x+yFI7zHO7hQ: folds 
Uncalled bet ($2) returned to Lro4e37x4FUa5P3yzDjskw
Lro4e37x4FUa5P3yzDjskw collected $2.25 from pot
*** SUMMARY ***
Total pot $2.35 | Rake $0.10 
Board [3s 8h 3d]
Seat 1: Lro4e37x4FUa5P3yzDjskw (button) collected ($2.25)
Seat 2: qwr38jl5txoR36M7G5qi4A (small blind) folded before Flop
Seat 3: 6RiVTYll/5D8zICp0MRpKw (big blind) folded before Flop
Seat 4: Czut6V7acIqUJrrobjKAZg folded before Flop (didn't bet)
Seat 5: IiLkthQMEje9LS79rCFQ1Q folded before Flop (didn't bet)
Seat 6: tYsOBqdU1+x+yFI7zHO7hQ folded on the Flop
Seat 7: PVxvfRTRvkgZf9WtquEkwQ folded before Flop (didn't bet)
Seat 8: ghNKXUBl/H+t83JF079ZBA folded before Flop (didn't bet)
Seat 9: egvg3mTBBVzMHnJPIQiKcA folded before Flop (didn't bet)




PokerStars Game #59941606680:  Hold'em No Limit ($0.10/$0.25) - 2009/07/01 1:40:33 ET
Table 'GrYi0DZOHD1EvB+qiLExNw' 9-max Seat #8 is the button
Seat 1: sk7OEPqYdQE7GJKyQHkssg ($14.50 in chips) 
Seat 2: Th3FldXKQW6hWVVPahaoOQ ($47.05 in chips) 
Seat 3: 4oA316mXLIui1QY63GXBUg ($25 in chips) 
Seat 4: 8x95tVlB4uFBVHp71KihMA ($24.70 in chips) 
Seat 5: cZ99hugmLBj9KhTlc8nCSw ($25.30 in chips) 
Seat 6: arxNSjreDRGFg13EAM2F1w ($25.25 in chips) 
Seat 7: 9lvO/qyU+xrU95Teu1fv0g ($18.10 in chips) 
Seat 8: MtVtHDqIJTyUcXkRBBDIVA ($25 in chips) 
Seat 9: 5hAPbqNrvJb8PtLiceXtlg ($13.50 in chips) 
5hAPbqNrvJb8PtLiceXtlg: posts small blind $0.10
sk7OEPqYdQE7GJKyQHkssg: posts big blind $0.25
*** HOLE CARDS ***
Th3FldXKQW6hWVVPahaoOQ: folds 
4oA316mXLIui1QY63GXBUg: folds 
8x95tVlB4uFBVHp71KihMA: folds 
cZ99hugmLBj9KhTlc8nCSw: folds 
arxNSjreDRGFg13EAM2F1w: folds 
9lvO/qyU+xrU95Teu1fv0g: calls $0.25
MtVtHDqIJTyUcXkRBBDIVA: calls $0.25
5hAPbqNrvJb8PtLiceXtlg: folds 
sk7OEPqYdQE7GJKyQHkssg: checks 
*** FLOP *** [3s 8s Qc]
sk7OEPqYdQE7GJKyQHkssg: checks 
9lvO/qyU+xrU95Teu1fv0g: bets $0.75
MtVtHDqIJTyUcXkRBBDIVA: folds 
sk7OEPqYdQE7GJKyQHkssg: calls $0.75
*** TURN *** [3s 8s Qc] [2c]
sk7OEPqYdQE7GJKyQHkssg: checks 
9lvO/qyU+xrU95Teu1fv0g: bets $1.50
sk7OEPqYdQE7GJKyQHkssg: folds 
Uncalled bet ($1.50) returned to 9lvO/qyU+xrU95Teu1fv0g
9lvO/qyU+xrU95Teu1fv0g collected $2.25 from pot
*** SUMMARY ***
Total pot $2.35 | Rake $0.10 
Board [3s 8s Qc 2c]
Seat 1: sk7OEPqYdQE7GJKyQHkssg (big blind) folded on the Turn
Seat 2: Th3FldXKQW6hWVVPahaoOQ folded before Flop (didn't bet)
Seat 3: 4oA316mXLIui1QY63GXBUg folded before Flop (didn't bet)
Seat 4: 8x95tVlB4uFBVHp71KihMA folded before Flop (didn't bet)
Seat 5: cZ99hugmLBj9KhTlc8nCSw folded before Flop (didn't bet)
Seat 6: arxNSjreDRGFg13EAM2F1w folded before Flop (didn't bet)
Seat 7: 9lvO/qyU+xrU95Teu1fv0g collected ($2.25)
Seat 8: MtVtHDqIJTyUcXkRBBDIVA (button) folded on the Flop
Seat 9: 5hAPbqNrvJb8PtLiceXtlg (small blind) folded before Flop




PokerStars Game #59941607048:  Hold'em No Limit ($0.10/$0.25) - 2009/07/01 1:40:33 ET
Table '2O5CgfSkSwrr4PDrlZ1RLQ' 6-max Seat #5 is the button
Seat 1: 3skmHD9EOATKdUzzyHh1KA ($29.40 in chips) 
Seat 2: wqphQtauX5Qn7WRJZS1flA ($25.70 in chips) 
Seat 3: oBUDUfeUyCbZBsjxHZgSiw ($30 in chips) 
Seat 4: 2Ga+TibtZsUCp1MLaueYVA ($25 in chips) 
Seat 5: 0av6tRNdi0Ui4f15L7gsVg ($21.90 in chips) 
Seat 6: tj9xqoqQaDaFw7u1oyZrtA ($43.95 in chips) 
tj9xqoqQaDaFw7u1oyZrtA: posts small blind $0.10
3skmHD9EOATKdUzzyHh1KA: posts big blind $0.25
*** HOLE CARDS ***
wqphQtauX5Qn7WRJZS1flA: folds 
oBUDUfeUyCbZBsjxHZgSiw: folds 
2Ga+TibtZsUCp1MLaueYVA: folds 
0av6tRNdi0Ui4f15L7gsVg: folds 
tj9xqoqQaDaFw7u1oyZrtA: folds 
Uncalled bet ($0.15) returned to 3skmHD9EOATKdUzzyHh1KA
3skmHD9EOATKdUzzyHh1KA collected $0.20 from pot
3skmHD9EOATKdUzzyHh1KA: doesn't show hand 
*** SUMMARY ***
Total pot $0.20 | Rake $0 
Seat 1: 3skmHD9EOATKdUzzyHh1KA (big blind) collected ($0.20)
Seat 2: wqphQtauX5Qn7WRJZS1flA folded before Flop (didn't bet)
Seat 3: oBUDUfeUyCbZBsjxHZgSiw folded before Flop (didn't bet)
Seat 4: 2Ga+TibtZsUCp1MLaueYVA folded before Flop (didn't bet)
Seat 5: 0av6tRNdi0Ui4f15L7gsVg (button) folded before Flop (didn't bet)
Seat 6: tj9xqoqQaDaFw7u1oyZrtA (small blind) folded before Flop




PokerStars Game #59941607020:  Hold'em No Limit ($0.10/$0.25) - 2009/07/01 1:40:33 ET
Table 'LG9H161ZAHDkOww+ih3Ptg' 6-max Seat #3 is the button
Seat 1: avl8CO/tc0F6eVSiB/KNRA ($25.60 in chips) 
Seat 2: kwsRmpZ1ZaLooISs+zfyKg ($25.45 in chips) 
Seat 3: 5Evvx7UYqXTBuvIc/9s/hA ($16.70 in chips) 
Seat 4: 0C28L4/59aRNtHoBhqTcLg ($58.80 in chips) 
Seat 5: lYjWCpfCxX2kgcHY3v4Yow ($29.65 in chips) 
Seat 6: v8m8XHovI5tqEA9mvplDSw ($27.15 in chips) 
0C28L4/59aRNtHoBhqTcLg: posts small blind $0.10
lYjWCpfCxX2kgcHY3v4Yow: posts big blind $0.25
*** HOLE CARDS ***
v8m8XHovI5tqEA9mvplDSw: folds 
avl8CO/tc0F6eVSiB/KNRA: folds 
kwsRmpZ1ZaLooISs+zfyKg: folds 
5Evvx7UYqXTBuvIc/9s/hA has timed out
5Evvx7UYqXTBuvIc/9s/hA: folds 
5Evvx7UYqXTBuvIc/9s/hA is sitting out
0C28L4/59aRNtHoBhqTcLg: calls $0.15
lYjWCpfCxX2kgcHY3v4Yow: checks 
*** FLOP *** [Ks 6s Qh]
0C28L4/59aRNtHoBhqTcLg: checks 
lYjWCpfCxX2kgcHY3v4Yow: checks 
*** TURN *** [Ks 6s Qh] [Kh]
0C28L4/59aRNtHoBhqTcLg: bets $0.25
lYjWCpfCxX2kgcHY3v4Yow: folds 
Uncalled bet ($0.25) returned to 0C28L4/59aRNtHoBhqTcLg
0C28L4/59aRNtHoBhqTcLg collected $0.50 from pot
5Evvx7UYqXTBuvIc/9s/hA has returned
*** SUMMARY ***
Total pot $0.50 | Rake $0 
Board [Ks 6s Qh Kh]
Seat 1: avl8CO/tc0F6eVSiB/KNRA folded before Flop (didn't bet)
Seat 2: kwsRmpZ1ZaLooISs+zfyKg folded before Flop (didn't bet)
Seat 3: 5Evvx7UYqXTBuvIc/9s/hA (button) folded before Flop (didn't bet)
Seat 4: 0C28L4/59aRNtHoBhqTcLg (small blind) collected ($0.50)
Seat 5: lYjWCpfCxX2kgcHY3v4Yow (big blind) folded on the Turn
Seat 6: v8m8XHovI5tqEA9mvplDSw folded before Flop (didn't bet)




PokerStars Game #59941607338:  Hold'em No Limit ($0.10/$0.25) - 2009/07/01 1:40:34 ET
Table 'IRgQPZVA4+IaZZIQshgwyg' 6-max Seat #1 is the button
Seat 1: cezpHJ8FB07dj0xG+LhOvw ($27.90 in chips) 
Seat 2: lquriepNQBhDV5P1SWHhnA ($25.10 in chips) 
Seat 3: DihMHaz4WNETH1bPDe13kA ($28.80 in chips) 
Seat 4: DE9hRlt14g+JdsRQ4wT7hg ($27.50 in chips) 
Seat 5: PbMzPZIePKifKQZfKDkbIw ($28.05 in chips) 
Seat 6: XbIIdTtuN1xO7zurECHBTg ($11.60 in chips) 
lquriepNQBhDV5P1SWHhnA: posts small blind $0.10
DihMHaz4WNETH1bPDe13kA: posts big blind $0.25
*** HOLE CARDS ***
DE9hRlt14g+JdsRQ4wT7hg: folds 
PbMzPZIePKifKQZfKDkbIw: raises $0.75 to $1
XbIIdTtuN1xO7zurECHBTg: folds 
cezpHJ8FB07dj0xG+LhOvw: folds 
lquriepNQBhDV5P1SWHhnA: calls $0.90
DihMHaz4WNETH1bPDe13kA: folds 
*** FLOP *** [Qd Js 2s]
lquriepNQBhDV5P1SWHhnA: checks 
PbMzPZIePKifKQZfKDkbIw: checks 
*** TURN *** [Qd Js 2s] [Kc]
lquriepNQBhDV5P1SWHhnA: checks 
PbMzPZIePKifKQZfKDkbIw: bets $1.50
lquriepNQBhDV5P1SWHhnA: folds 
Uncalled bet ($1.50) returned to PbMzPZIePKifKQZfKDkbIw
PbMzPZIePKifKQZfKDkbIw collected $2.15 from pot
*** SUMMARY ***
Total pot $2.25 | Rake $0.10 
Board [Qd Js 2s Kc]
Seat 1: cezpHJ8FB07dj0xG+LhOvw (button) folded before Flop (didn't bet)
Seat 2: lquriepNQBhDV5P1SWHhnA (small blind) folded on the Turn
Seat 3: DihMHaz4WNETH1bPDe13kA (big blind) folded before Flop
Seat 4: DE9hRlt14g+JdsRQ4wT7hg folded before Flop (didn't bet)
Seat 5: PbMzPZIePKifKQZfKDkbIw collected ($2.15)
Seat 6: XbIIdTtuN1xO7zurECHBTg folded before Flop (didn't bet)




PokerStars Game #59941607512:  Hold'em No Limit ($0.10/$0.25) - 2009/07/01 1:40:34 ET
Table 'sJ4KpS2GE5Qrsu1/cFjJUw' 9-max Seat #1 is the button
Seat 1: 7mHNIz+BCOKfVsh+EQ/4Wg ($10.65 in chips) 
Seat 2: tYsOBqdU1+x+yFI7zHO7hQ ($31.85 in chips) 
Seat 3: eK8qa6EPcH2zhtbmWSvc9g ($25.90 in chips) 
Seat 4: npAYqa85pqnzfOK5ukX+BQ ($23.15 in chips) 
Seat 5: Q/gZC63lfOMr7YhWKPCxoQ ($9.60 in chips) 
Seat 6: OefE+Csvj5KR7ClGf3Hc2g ($2.85 in chips) 
Seat 7: Wi8djHgewBlVhpKWfp7isQ ($7.40 in chips) 
Seat 8: S7Ki0P+0AIGPuIfGJjW0gg ($29.70 in chips) 
Seat 9: 3PmVnC/15cl4oyI1TKIt4g ($5 in chips) 
tYsOBqdU1+x+yFI7zHO7hQ: posts small blind $0.10
eK8qa6EPcH2zhtbmWSvc9g: posts big blind $0.25
*** HOLE CARDS ***
npAYqa85pqnzfOK5ukX+BQ: folds 
Q/gZC63lfOMr7YhWKPCxoQ: folds 
OefE+Csvj5KR7ClGf3Hc2g: folds 
Wi8djHgewBlVhpKWfp7isQ: calls $0.25
S7Ki0P+0AIGPuIfGJjW0gg: folds 
3PmVnC/15cl4oyI1TKIt4g: folds 
7mHNIz+BCOKfVsh+EQ/4Wg: folds 
7mHNIz+BCOKfVsh+EQ/4Wg leaves the table
tYsOBqdU1+x+yFI7zHO7hQ: folds 
eK8qa6EPcH2zhtbmWSvc9g: checks 
*** FLOP *** [Qh Th 2s]
eK8qa6EPcH2zhtbmWSvc9g: bets $0.35
Wi8djHgewBlVhpKWfp7isQ: calls $0.35
*** TURN *** [Qh Th 2s] [3d]
eK8qa6EPcH2zhtbmWSvc9g: bets $0.75
Wi8djHgewBlVhpKWfp7isQ: calls $0.75
*** RIVER *** [Qh Th 2s 3d] [6s]
eK8qa6EPcH2zhtbmWSvc9g: checks 
Wi8djHgewBlVhpKWfp7isQ: bets $1.75
eK8qa6EPcH2zhtbmWSvc9g: folds 
Uncalled bet ($1.75) returned to Wi8djHgewBlVhpKWfp7isQ
Wi8djHgewBlVhpKWfp7isQ collected $2.70 from pot
Wi8djHgewBlVhpKWfp7isQ: doesn't show hand 
*** SUMMARY ***
Total pot $2.80 | Rake $0.10 
Board [Qh Th 2s 3d 6s]
Seat 1: 7mHNIz+BCOKfVsh+EQ/4Wg (button) folded before Flop (didn't bet)
Seat 2: tYsOBqdU1+x+yFI7zHO7hQ (small blind) folded before Flop
Seat 3: eK8qa6EPcH2zhtbmWSvc9g (big blind) folded on the River
Seat 4: npAYqa85pqnzfOK5ukX+BQ folded before Flop (didn't bet)
Seat 5: Q/gZC63lfOMr7YhWKPCxoQ folded before Flop (didn't bet)
Seat 6: OefE+Csvj5KR7ClGf3Hc2g folded before Flop (didn't bet)
Seat 7: Wi8djHgewBlVhpKWfp7isQ collected ($2.70)
Seat 8: S7Ki0P+0AIGPuIfGJjW0gg folded before Flop (didn't bet)
Seat 9: 3PmVnC/15cl4oyI1TKIt4g folded before Flop (didn't bet)




PokerStars Game #59941607336:  Hold'em No Limit ($0.10/$0.25) - 2009/07/01 1:40:34 ET
Table 'jz4TpuH+ag+0iNe2ZcxckQ' 9-max Seat #1 is the button
Seat 1: +C3eP/ysyROWbEXJFPswVA ($15.70 in chips) 
Seat 2: OXPkK84/qv92EMwXPiG5rQ ($9.25 in chips) 
Seat 3: egvg3mTBBVzMHnJPIQiKcA ($15 in chips) 
Seat 4: k+2r6di6GXjNpAdrRkW9bA ($63 in chips) 
Seat 5: v1BVHNGLbP/nx7QO6K7+Jw ($26.50 in chips) 
Seat 6: gO1uiTGTzn5Cd3PECuws1g ($14.25 in chips) 
Seat 7: tLcDklc2rBORNfixyRfVfw ($30.20 in chips) 
Seat 8: uhrboV251dcgYniYTdFIcA ($25 in chips) 
Seat 9: W2YYHvqjaEpRrO7stZkClQ ($5.80 in chips) 
OXPkK84/qv92EMwXPiG5rQ: posts small blind $0.10
egvg3mTBBVzMHnJPIQiKcA: posts big blind $0.25
*** HOLE CARDS ***
k+2r6di6GXjNpAdrRkW9bA: calls $0.25
v1BVHNGLbP/nx7QO6K7+Jw: folds 
gO1uiTGTzn5Cd3PECuws1g: calls $0.25
tLcDklc2rBORNfixyRfVfw: calls $0.25
uhrboV251dcgYniYTdFIcA: calls $0.25
W2YYHvqjaEpRrO7stZkClQ: folds 
+C3eP/ysyROWbEXJFPswVA: folds 
OXPkK84/qv92EMwXPiG5rQ: calls $0.15
egvg3mTBBVzMHnJPIQiKcA: checks 
*** FLOP *** [5d 2h 3d]
OXPkK84/qv92EMwXPiG5rQ: checks 
egvg3mTBBVzMHnJPIQiKcA: bets $0.75
k+2r6di6GXjNpAdrRkW9bA: calls $0.75
gO1uiTGTzn5Cd3PECuws1g: folds 
tLcDklc2rBORNfixyRfVfw: calls $0.75
uhrboV251dcgYniYTdFIcA: folds 
OXPkK84/qv92EMwXPiG5rQ: calls $0.75
*** TURN *** [5d 2h 3d] [Ts]
OXPkK84/qv92EMwXPiG5rQ: checks 
egvg3mTBBVzMHnJPIQiKcA: checks 
k+2r6di6GXjNpAdrRkW9bA: bets $0.50
tLcDklc2rBORNfixyRfVfw: calls $0.50
OXPkK84/qv92EMwXPiG5rQ: calls $0.50
egvg3mTBBVzMHnJPIQiKcA: calls $0.50
*** RIVER *** [5d 2h 3d Ts] [6h]
OXPkK84/qv92EMwXPiG5rQ: checks 
egvg3mTBBVzMHnJPIQiKcA: checks 
k+2r6di6GXjNpAdrRkW9bA: bets $1.25
tLcDklc2rBORNfixyRfVfw: calls $1.25
OXPkK84/qv92EMwXPiG5rQ: raises $6.50 to $7.75 and is all-in
egvg3mTBBVzMHnJPIQiKcA: folds 
k+2r6di6GXjNpAdrRkW9bA: folds 
tLcDklc2rBORNfixyRfVfw: calls $6.50
*** SHOW DOWN ***
OXPkK84/qv92EMwXPiG5rQ: shows [4c 8c] (a straight, Deuce to Six)
tLcDklc2rBORNfixyRfVfw: shows [4h 3h] (a straight, Deuce to Six)
OXPkK84/qv92EMwXPiG5rQ collected $11.10 from pot
tLcDklc2rBORNfixyRfVfw collected $11.05 from pot
*** SUMMARY ***
Total pot $23.25 | Rake $1.10 
Board [5d 2h 3d Ts 6h]
Seat 1: +C3eP/ysyROWbEXJFPswVA (button) folded before Flop (didn't bet)
Seat 2: OXPkK84/qv92EMwXPiG5rQ (small blind) showed [4c 8c] and won ($11.10) with a straight, Deuce to Six
Seat 3: egvg3mTBBVzMHnJPIQiKcA (big blind) folded on the River
Seat 4: k+2r6di6GXjNpAdrRkW9bA folded on the River
Seat 5: v1BVHNGLbP/nx7QO6K7+Jw folded before Flop (didn't bet)
Seat 6: gO1uiTGTzn5Cd3PECuws1g folded on the Flop
Seat 7: tLcDklc2rBORNfixyRfVfw showed [4h 3h] and won ($11.05) with a straight, Deuce to Six
Seat 8: uhrboV251dcgYniYTdFIcA folded on the Flop
Seat 9: W2YYHvqjaEpRrO7stZkClQ folded before Flop (didn't bet)




PokerStars Game #59941607234:  Hold'em No Limit ($0.10/$0.25) - 2009/07/01 1:40:34 ET
Table '0XPo7K54oZIfG0xlNAcDRw' 9-max Seat #7 is the button
Seat 1: 7cv+9Zc9HIQHNvYsMfV3uA ($28.65 in chips) 
Seat 3: 6qsItdeWZoOL5be2e1RFng ($4.50 in chips) 
Seat 4: RubYqfvGrz2z+5ReNIj9QQ ($32.55 in chips) 
Seat 5: iOmwbUN7u4JFkV6VCA49aA ($25.15 in chips) 
Seat 6: 9gmYYQesalMrUjaF7nKfrQ ($12.05 in chips) 
Seat 7: tYsOBqdU1+x+yFI7zHO7hQ ($28.80 in chips) 
Seat 8: v5jnQ1gfh9nLla3kMXG7Yg ($8.10 in chips) 
Seat 9: CmngQmkKTp8tkl6GMRTl6w ($8.50 in chips) 
v5jnQ1gfh9nLla3kMXG7Yg: posts small blind $0.10
CmngQmkKTp8tkl6GMRTl6w: posts big blind $0.25
knif3: sits out 
*** HOLE CARDS ***
7cv+9Zc9HIQHNvYsMfV3uA has timed out
7cv+9Zc9HIQHNvYsMfV3uA: folds 
7cv+9Zc9HIQHNvYsMfV3uA is sitting out
7cv+9Zc9HIQHNvYsMfV3uA has returned
6qsItdeWZoOL5be2e1RFng: raises $0.25 to $0.50
RubYqfvGrz2z+5ReNIj9QQ: folds 
iOmwbUN7u4JFkV6VCA49aA: folds 
9gmYYQesalMrUjaF7nKfrQ: folds 
iOmwbUN7u4JFkV6VCA49aA said, "how did u know i hat jq"
tYsOBqdU1+x+yFI7zHO7hQ: folds 
v5jnQ1gfh9nLla3kMXG7Yg: folds 
CmngQmkKTp8tkl6GMRTl6w: folds 
Uncalled bet ($0.25) returned to 6qsItdeWZoOL5be2e1RFng
6qsItdeWZoOL5be2e1RFng collected $0.60 from pot
*** SUMMARY ***
Total pot $0.60 | Rake $0 
Seat 1: 7cv+9Zc9HIQHNvYsMfV3uA folded before Flop (didn't bet)
Seat 3: 6qsItdeWZoOL5be2e1RFng collected ($0.60)
Seat 4: RubYqfvGrz2z+5ReNIj9QQ folded before Flop (didn't bet)
Seat 5: iOmwbUN7u4JFkV6VCA49aA folded before Flop (didn't bet)
Seat 6: 9gmYYQesalMrUjaF7nKfrQ folded before Flop (didn't bet)
Seat 7: tYsOBqdU1+x+yFI7zHO7hQ (button) folded before Flop (didn't bet)
Seat 8: v5jnQ1gfh9nLla3kMXG7Yg (small blind) folded before Flop
Seat 9: CmngQmkKTp8tkl6GMRTl6w (big blind) folded before Flop




PokerStars Game #59941608000:  Hold'em No Limit ($0.10/$0.25) - 2009/07/01 1:40:35 ET
Table 'jxoHy9yJy0bbH/Qx73FoPA' 9-max Seat #7 is the button
Seat 1: j4q3p0lesp63b1gZDwLBZw ($6.25 in chips) 
Seat 2: F7pnn6czNpHvRM55XcA2EA ($38.75 in chips) 
Seat 3: CVqCt93Mk0MhKMaZ4LZDSQ ($11.20 in chips) 
Seat 4: A1M0JIGHzqMXp7L2MdcxXw ($26.65 in chips) 
Seat 5: cZ99hugmLBj9KhTlc8nCSw ($25.10 in chips) 
Seat 6: tYsOBqdU1+x+yFI7zHO7hQ ($46.35 in chips) 
Seat 7: wGigCmBR/9XWkPpvYos3aQ ($26.40 in chips) 
Seat 9: CvL9Ch1HYCVbTsfpNucitg ($5 in chips) 
CvL9Ch1HYCVbTsfpNucitg: posts small blind $0.10
j4q3p0lesp63b1gZDwLBZw: posts big blind $0.25
*** HOLE CARDS ***
F7pnn6czNpHvRM55XcA2EA: folds 
CVqCt93Mk0MhKMaZ4LZDSQ: folds 
A1M0JIGHzqMXp7L2MdcxXw: folds 
cZ99hugmLBj9KhTlc8nCSw: folds 
tYsOBqdU1+x+yFI7zHO7hQ: folds 
wGigCmBR/9XWkPpvYos3aQ: folds 
CvL9Ch1HYCVbTsfpNucitg: folds 
Uncalled bet ($0.15) returned to j4q3p0lesp63b1gZDwLBZw
j4q3p0lesp63b1gZDwLBZw collected $0.20 from pot
j4q3p0lesp63b1gZDwLBZw: doesn't show hand 
*** SUMMARY ***
Total pot $0.20 | Rake $0 
Seat 1: j4q3p0lesp63b1gZDwLBZw (big blind) collected ($0.20)
Seat 2: F7pnn6czNpHvRM55XcA2EA folded before Flop (didn't bet)
Seat 3: CVqCt93Mk0MhKMaZ4LZDSQ folded before Flop (didn't bet)
Seat 4: A1M0JIGHzqMXp7L2MdcxXw folded before Flop (didn't bet)
Seat 5: cZ99hugmLBj9KhTlc8nCSw folded before Flop (didn't bet)
Seat 6: tYsOBqdU1+x+yFI7zHO7hQ folded before Flop (didn't bet)
Seat 7: wGigCmBR/9XWkPpvYos3aQ (button) folded before Flop (didn't bet)
Seat 9: CvL9Ch1HYCVbTsfpNucitg (small blind) folded before Flop




PokerStars Game #59941607906:  Hold'em No Limit ($0.10/$0.25) - 2009/07/01 1:40:35 ET
Table '3lS+sU5k6mwJCS2nFMmQ6Q' 9-max Seat #9 is the button
Seat 1: VWUWpMLMj/Q1jRVpF7Aohw ($13.55 in chips) 
Seat 3: 1DXccE2UUK5DIRVGlOKnTA ($18.30 in chips) 
Seat 4: ydoFOVgzvZv9ZhuWu9rXAw ($5.35 in chips) 
Seat 5: NcPAt5YjVvDFEJTTgAVj8g ($5.05 in chips) 
Seat 6: hJ4uYjNmSZdjrKA8cjZqCA ($36.75 in chips) 
Seat 7: Th3FldXKQW6hWVVPahaoOQ ($30.85 in chips) 
Seat 8: 9lvO/qyU+xrU95Teu1fv0g ($4.05 in chips) 
Seat 9: 4awUyiDYTgylQKXZ9faBVA ($45.20 in chips) 
VWUWpMLMj/Q1jRVpF7Aohw: posts small blind $0.10
1DXccE2UUK5DIRVGlOKnTA: posts big blind $0.25
*** HOLE CARDS ***
ydoFOVgzvZv9ZhuWu9rXAw: folds 
NcPAt5YjVvDFEJTTgAVj8g has timed out
NcPAt5YjVvDFEJTTgAVj8g: folds 
NcPAt5YjVvDFEJTTgAVj8g is sitting out
hJ4uYjNmSZdjrKA8cjZqCA: folds 
NcPAt5YjVvDFEJTTgAVj8g has returned
Th3FldXKQW6hWVVPahaoOQ: folds 
9lvO/qyU+xrU95Teu1fv0g: raises $1 to $1.25
4awUyiDYTgylQKXZ9faBVA: raises $3 to $4.25
VWUWpMLMj/Q1jRVpF7Aohw: folds 
1DXccE2UUK5DIRVGlOKnTA: folds 
9lvO/qyU+xrU95Teu1fv0g: calls $2.80 and is all-in
Uncalled bet ($0.20) returned to 4awUyiDYTgylQKXZ9faBVA
*** FLOP *** [Ts 4s Qs]
*** TURN *** [Ts 4s Qs] [8c]
*** RIVER *** [Ts 4s Qs 8c] [Tc]
*** SHOW DOWN ***
9lvO/qyU+xrU95Teu1fv0g: shows [Js Jd] (two pair, Jacks and Tens)
4awUyiDYTgylQKXZ9faBVA: shows [Qh Ad] (two pair, Queens and Tens)
4awUyiDYTgylQKXZ9faBVA collected $8.05 from pot
*** SUMMARY ***
Total pot $8.45 | Rake $0.40 
Board [Ts 4s Qs 8c Tc]
Seat 1: VWUWpMLMj/Q1jRVpF7Aohw (small blind) folded before Flop
Seat 3: 1DXccE2UUK5DIRVGlOKnTA (big blind) folded before Flop
Seat 4: ydoFOVgzvZv9ZhuWu9rXAw folded before Flop (didn't bet)
Seat 5: NcPAt5YjVvDFEJTTgAVj8g folded before Flop (didn't bet)
Seat 6: hJ4uYjNmSZdjrKA8cjZqCA folded before Flop (didn't bet)
Seat 7: Th3FldXKQW6hWVVPahaoOQ folded before Flop (didn't bet)
Seat 8: 9lvO/qyU+xrU95Teu1fv0g showed [Js Jd] and lost with two pair, Jacks and Tens
Seat 9: 4awUyiDYTgylQKXZ9faBVA (button) showed [Qh Ad] and won ($8.05) with two pair, Queens and Tens




PokerStars Game #59941608036:  Hold'em No Limit ($0.10/$0.25) - 2009/07/01 1:40:35 ET
Table 'IrJPyZ3JW2iIa+krdoSbJQ' 9-max Seat #1 is the button
Seat 1: Bb42QRQMhg5/Y0vHP8/2Xw ($26.25 in chips) 
Seat 2: X78b5v/uhqeXXoAijbw/yg ($28.45 in chips) 
Seat 3: CT7Xj/V/O5rBlhtt+RZeFQ ($25 in chips) 
Seat 5: tLcDklc2rBORNfixyRfVfw ($28.40 in chips) 
Seat 6: +sbyWwIcFp9kP0bDtMegfQ ($24.95 in chips) 
Seat 7: k7BTUnQVz23IhJmLKrwx8A ($16.90 in chips) 
Seat 8: zZqOSFjPK4R4cwx0dONetw ($19.40 in chips) 
Seat 9: Mh2r9hTeTEDnh19sRZtW3g ($5.80 in chips) 
X78b5v/uhqeXXoAijbw/yg: posts small blind $0.10
CT7Xj/V/O5rBlhtt+RZeFQ: posts big blind $0.25
*** HOLE CARDS ***
tLcDklc2rBORNfixyRfVfw: folds 
+sbyWwIcFp9kP0bDtMegfQ: folds 
k7BTUnQVz23IhJmLKrwx8A: raises $0.50 to $0.75
zZqOSFjPK4R4cwx0dONetw: folds 
Mh2r9hTeTEDnh19sRZtW3g: folds 
Bb42QRQMhg5/Y0vHP8/2Xw: folds 
X78b5v/uhqeXXoAijbw/yg: calls $0.65
CT7Xj/V/O5rBlhtt+RZeFQ: folds 
*** FLOP *** [9d Kh 7s]
X78b5v/uhqeXXoAijbw/yg: checks 
k7BTUnQVz23IhJmLKrwx8A: checks 
*** TURN *** [9d Kh 7s] [5s]
X78b5v/uhqeXXoAijbw/yg: checks 
videomama#1 leaves the table
k7BTUnQVz23IhJmLKrwx8A: checks 
*** RIVER *** [9d Kh 7s 5s] [Ac]
bXpVeaSTPBFSPJmeXxO7nw joins the table at seat #4 
X78b5v/uhqeXXoAijbw/yg: checks 
k7BTUnQVz23IhJmLKrwx8A: bets $1.50
X78b5v/uhqeXXoAijbw/yg: calls $1.50
*** SHOW DOWN ***
k7BTUnQVz23IhJmLKrwx8A: shows [As 9c] (two pair, Aces and Nines)
X78b5v/uhqeXXoAijbw/yg: mucks hand 
k7BTUnQVz23IhJmLKrwx8A collected $4.55 from pot
*** SUMMARY ***
Total pot $4.75 | Rake $0.20 
Board [9d Kh 7s 5s Ac]
Seat 1: Bb42QRQMhg5/Y0vHP8/2Xw (button) folded before Flop (didn't bet)
Seat 2: X78b5v/uhqeXXoAijbw/yg (small blind) mucked
Seat 3: CT7Xj/V/O5rBlhtt+RZeFQ (big blind) folded before Flop
Seat 5: tLcDklc2rBORNfixyRfVfw folded before Flop (didn't bet)
Seat 6: +sbyWwIcFp9kP0bDtMegfQ folded before Flop (didn't bet)
Seat 7: k7BTUnQVz23IhJmLKrwx8A showed [As 9c] and won ($4.55) with two pair, Aces and Nines
Seat 8: zZqOSFjPK4R4cwx0dONetw folded before Flop (didn't bet)
Seat 9: Mh2r9hTeTEDnh19sRZtW3g folded before Flop (didn't bet)




PokerStars Game #59941607732:  Hold'em No Limit ($0.10/$0.25) - 2009/07/01 1:40:35 ET
Table 'AJGgX1ZYM8d68SWMvaLttg' 6-max Seat #3 is the button
Seat 2: zHHLkD2sRljslKKeQv/ZQw ($26.90 in chips) 
Seat 3: 8ClCHtFXGNplITm+63KB+Q ($37.70 in chips) 
Seat 4: Lz/GjRDgmgepqTR7qmS86w ($25.80 in chips) 
Seat 5: Hsvkc0/G2VV78oVmWYXecw ($5.30 in chips) 
Seat 6: UA5OsKS3VPaxa7uC8La/kA ($64.75 in chips) 
Lz/GjRDgmgepqTR7qmS86w: posts small blind $0.10
Hsvkc0/G2VV78oVmWYXecw: posts big blind $0.25
*** HOLE CARDS ***
UA5OsKS3VPaxa7uC8La/kA: folds 
zHHLkD2sRljslKKeQv/ZQw: raises $0.75 to $1
8ClCHtFXGNplITm+63KB+Q: calls $1
Lz/GjRDgmgepqTR7qmS86w: calls $0.90
Hsvkc0/G2VV78oVmWYXecw: folds 
*** FLOP *** [7s 4d Kc]
Lz/GjRDgmgepqTR7qmS86w: checks 
zHHLkD2sRljslKKeQv/ZQw: bets $1.50
8ClCHtFXGNplITm+63KB+Q: folds 
Lz/GjRDgmgepqTR7qmS86w: folds 
Uncalled bet ($1.50) returned to zHHLkD2sRljslKKeQv/ZQw
zHHLkD2sRljslKKeQv/ZQw collected $3.10 from pot
*** SUMMARY ***
Total pot $3.25 | Rake $0.15 
Board [7s 4d Kc]
Seat 2: zHHLkD2sRljslKKeQv/ZQw collected ($3.10)
Seat 3: 8ClCHtFXGNplITm+63KB+Q (button) folded on the Flop
Seat 4: Lz/GjRDgmgepqTR7qmS86w (small blind) folded on the Flop
Seat 5: Hsvkc0/G2VV78oVmWYXecw (big blind) folded before Flop
Seat 6: UA5OsKS3VPaxa7uC8La/kA folded before Flop (didn't bet)




PokerStars Game #59941607632:  Hold'em No Limit ($0.10/$0.25) - 2009/07/01 1:40:35 ET
Table 'IUwZ/e0bDHZPgsIWx0RnNg' 6-max Seat #6 is the button
Seat 2: mvFHK3pE7tCxJEqLjKC70Q ($55.15 in chips) 
Seat 3: dOX4wnYV2sEqvDbF+8KSCw ($25 in chips) 
Seat 5: kv2o5BKCLOrJIw4oc083jQ ($29.25 in chips) 
Seat 6: NhUN/JpAprdJeamFBgJH1w ($40.60 in chips) 
V66QiVCQPofyl3a+dpPHQQ will be allowed to play after the button
mvFHK3pE7tCxJEqLjKC70Q: posts small blind $0.10
dOX4wnYV2sEqvDbF+8KSCw: posts big blind $0.25
*** HOLE CARDS ***
kv2o5BKCLOrJIw4oc083jQ: folds 
NhUN/JpAprdJeamFBgJH1w: folds 
mvFHK3pE7tCxJEqLjKC70Q: raises $0.25 to $0.50
kv2o5BKCLOrJIw4oc083jQ leaves the table
dOX4wnYV2sEqvDbF+8KSCw: calls $0.25
*** FLOP *** [3s Th 9h]
mvFHK3pE7tCxJEqLjKC70Q: checks 
dOX4wnYV2sEqvDbF+8KSCw: bets $0.75
mvFHK3pE7tCxJEqLjKC70Q: folds 
Uncalled bet ($0.75) returned to dOX4wnYV2sEqvDbF+8KSCw
dOX4wnYV2sEqvDbF+8KSCw collected $0.95 from pot
dOX4wnYV2sEqvDbF+8KSCw: doesn't show hand 
*** SUMMARY ***
Total pot $1 | Rake $0.05 
Board [3s Th 9h]
Seat 2: mvFHK3pE7tCxJEqLjKC70Q (small blind) folded on the Flop
Seat 3: dOX4wnYV2sEqvDbF+8KSCw (big blind) collected ($0.95)
Seat 5: kv2o5BKCLOrJIw4oc083jQ folded before Flop (didn't bet)
Seat 6: NhUN/JpAprdJeamFBgJH1w (button) folded before Flop (didn't bet)




PokerStars Game #59941607778:  Hold'em No Limit ($0.10/$0.25) - 2009/07/01 1:40:35 ET
Table '+2VxGVfkEqJ1AYfQy/JH2w' 6-max Seat #5 is the button
Seat 1: if4dh6jhJXeN3/qd3qCp9g ($25 in chips) 
Seat 2: qllppsCmUqovlriIWCeM/g ($4.05 in chips) 
Seat 3: NndRCAk4vU5JGDhTyy5LZg ($13.20 in chips) 
Seat 4: y+a/yGW/Jy4bPJFnaeTz5w ($16.95 in chips) 
Seat 5: XD1i5m5PvBDnRzJaG/vINw ($22.80 in chips) 
Seat 6: L3/N/gliETan8N5Gim5h4Q ($25 in chips) 
L3/N/gliETan8N5Gim5h4Q: posts small blind $0.10
if4dh6jhJXeN3/qd3qCp9g: posts big blind $0.25
*** HOLE CARDS ***
qllppsCmUqovlriIWCeM/g: folds 
NndRCAk4vU5JGDhTyy5LZg: calls $0.25
y+a/yGW/Jy4bPJFnaeTz5w: folds 
XD1i5m5PvBDnRzJaG/vINw: raises $0.50 to $0.75
L3/N/gliETan8N5Gim5h4Q: folds 
if4dh6jhJXeN3/qd3qCp9g: folds 
NndRCAk4vU5JGDhTyy5LZg: calls $0.50
*** FLOP *** [7c 4h 6s]
NndRCAk4vU5JGDhTyy5LZg: checks 
XD1i5m5PvBDnRzJaG/vINw: checks 
*** TURN *** [7c 4h 6s] [7s]
NndRCAk4vU5JGDhTyy5LZg: checks 
XD1i5m5PvBDnRzJaG/vINw: checks 
*** RIVER *** [7c 4h 6s 7s] [Qh]
NndRCAk4vU5JGDhTyy5LZg: checks 
XD1i5m5PvBDnRzJaG/vINw: bets $0.75
NndRCAk4vU5JGDhTyy5LZg: folds 
Uncalled bet ($0.75) returned to XD1i5m5PvBDnRzJaG/vINw
XD1i5m5PvBDnRzJaG/vINw collected $1.80 from pot
XD1i5m5PvBDnRzJaG/vINw: doesn't show hand 
*** SUMMARY ***
Total pot $1.85 | Rake $0.05 
Board [7c 4h 6s 7s Qh]
Seat 1: if4dh6jhJXeN3/qd3qCp9g (big blind) folded before Flop
Seat 2: qllppsCmUqovlriIWCeM/g folded before Flop (didn't bet)
Seat 3: NndRCAk4vU5JGDhTyy5LZg folded on the River
Seat 4: y+a/yGW/Jy4bPJFnaeTz5w folded before Flop (didn't bet)
Seat 5: XD1i5m5PvBDnRzJaG/vINw (button) collected ($1.80)
Seat 6: L3/N/gliETan8N5Gim5h4Q (small blind) folded before Flop




PokerStars Game #59941607668:  Hold'em No Limit ($0.10/$0.25) - 2009/07/01 1:40:35 ET
Table '6wawJ+MkkvuC3coG6r+Yhg' 6-max Seat #4 is the button
Seat 1: JQZew0FjzS19kTjeNtrE+A ($27.10 in chips) 
Seat 2: LtASJ9OlkqGrrUKGQlpGAw ($33.60 in chips) 
Seat 3: 3zD3qLXT1bEffAoWGnc7wg ($59.85 in chips) 
Seat 4: yxmjNFGiKI3b+XQGJzJVIg ($27.95 in chips) 
Seat 5: FZrgDbxAanC1xwZxXHJKVA ($2.95 in chips) 
Seat 6: B3X187C0tXFUfQpCu8pe8A ($28.35 in chips) 
FZrgDbxAanC1xwZxXHJKVA: posts small blind $0.10
B3X187C0tXFUfQpCu8pe8A: posts big blind $0.25
*** HOLE CARDS ***
JQZew0FjzS19kTjeNtrE+A: folds 
LtASJ9OlkqGrrUKGQlpGAw: folds 
3zD3qLXT1bEffAoWGnc7wg: folds 
yxmjNFGiKI3b+XQGJzJVIg: raises $0.50 to $0.75
FZrgDbxAanC1xwZxXHJKVA: folds 
B3X187C0tXFUfQpCu8pe8A: folds 
Uncalled bet ($0.50) returned to yxmjNFGiKI3b+XQGJzJVIg
yxmjNFGiKI3b+XQGJzJVIg collected $0.60 from pot
*** SUMMARY ***
Total pot $0.60 | Rake $0 
Seat 1: JQZew0FjzS19kTjeNtrE+A folded before Flop (didn't bet)
Seat 2: LtASJ9OlkqGrrUKGQlpGAw folded before Flop (didn't bet)
Seat 3: 3zD3qLXT1bEffAoWGnc7wg folded before Flop (didn't bet)
Seat 4: yxmjNFGiKI3b+XQGJzJVIg (button) collected ($0.60)
Seat 5: FZrgDbxAanC1xwZxXHJKVA (small blind) folded before Flop
Seat 6: B3X187C0tXFUfQpCu8pe8A (big blind) folded before Flop




PokerStars Game #59941607826:  Hold'em No Limit ($0.10/$0.25) - 2009/07/01 1:40:35 ET
Table 'jdhJTJjFq2KTttwJcd+7nQ' 6-max Seat #4 is the button
Seat 1: LtASJ9OlkqGrrUKGQlpGAw ($27.05 in chips) 
Seat 2: Hsvkc0/G2VV78oVmWYXecw ($5 in chips) 
Seat 3: vqWjZmdQu/Hxw96/IJTWdQ ($25 in chips) 
Seat 4: vx7FwRcelVSsvNYAdp/z0A ($3.50 in chips) 
Seat 5: BV+K0Phf5VBHr7aZPKqbUQ ($26.10 in chips) 
Seat 6: yb6rnd48JuBccThV68VHAQ ($20.40 in chips) 
BV+K0Phf5VBHr7aZPKqbUQ: posts small blind $0.10
yb6rnd48JuBccThV68VHAQ: posts big blind $0.25
*** HOLE CARDS ***
LtASJ9OlkqGrrUKGQlpGAw: folds 
Hsvkc0/G2VV78oVmWYXecw: folds 
vqWjZmdQu/Hxw96/IJTWdQ: raises $0.75 to $1
vx7FwRcelVSsvNYAdp/z0A: folds 
BV+K0Phf5VBHr7aZPKqbUQ: folds 
yb6rnd48JuBccThV68VHAQ: folds 
Uncalled bet ($0.75) returned to vqWjZmdQu/Hxw96/IJTWdQ
vqWjZmdQu/Hxw96/IJTWdQ collected $0.60 from pot
vqWjZmdQu/Hxw96/IJTWdQ: doesn't show hand 
*** SUMMARY ***
Total pot $0.60 | Rake $0 
Seat 1: LtASJ9OlkqGrrUKGQlpGAw folded before Flop (didn't bet)
Seat 2: Hsvkc0/G2VV78oVmWYXecw folded before Flop (didn't bet)
Seat 3: vqWjZmdQu/Hxw96/IJTWdQ collected ($0.60)
Seat 4: vx7FwRcelVSsvNYAdp/z0A (button) folded before Flop (didn't bet)
Seat 5: BV+K0Phf5VBHr7aZPKqbUQ (small blind) folded before Flop
Seat 6: yb6rnd48JuBccThV68VHAQ (big blind) folded before Flop




PokerStars Game #59941607960:  Hold'em No Limit ($0.10/$0.25) - 2009/07/01 1:40:35 ET
Table 'C8mMnVmvkagwolEzTvh07A' 9-max Seat #1 is the button
Seat 1: PqvgxdSg9z5VmrWpbYuz+g ($24 in chips) 
Seat 2: Bb42QRQMhg5/Y0vHP8/2Xw ($25 in chips) 
Seat 3: Th3FldXKQW6hWVVPahaoOQ ($35.70 in chips) 
Seat 4: dfNim92Z6XK1/h5SFW5vDg ($25 in chips) 
Seat 5: iGMlK+EhUflPB6jKQd95Cg ($27.85 in chips) 
Seat 7: qmEgnPhQt24xdw/ZRVPLbA ($48.45 in chips) 
Seat 9: 4awUyiDYTgylQKXZ9faBVA ($25 in chips) 
Bb42QRQMhg5/Y0vHP8/2Xw: posts small blind $0.10
Th3FldXKQW6hWVVPahaoOQ: posts big blind $0.25
AiXn/9o1EwOPZUHujnh/bA: sits out 
*** HOLE CARDS ***
dfNim92Z6XK1/h5SFW5vDg: folds 
iGMlK+EhUflPB6jKQd95Cg: folds 
qmEgnPhQt24xdw/ZRVPLbA: raises $0.50 to $0.75
4awUyiDYTgylQKXZ9faBVA: folds 
PqvgxdSg9z5VmrWpbYuz+g: raises $0.75 to $1.50
Bb42QRQMhg5/Y0vHP8/2Xw: folds 
Th3FldXKQW6hWVVPahaoOQ: folds 
qmEgnPhQt24xdw/ZRVPLbA: calls $0.75
*** FLOP *** [As Kc Qh]
qmEgnPhQt24xdw/ZRVPLbA: checks 
PqvgxdSg9z5VmrWpbYuz+g: checks 
*** TURN *** [As Kc Qh] [2d]
AiXn/9o1EwOPZUHujnh/bA is disconnected 
AiXn/9o1EwOPZUHujnh/bA is connected 
qmEgnPhQt24xdw/ZRVPLbA: checks 
PqvgxdSg9z5VmrWpbYuz+g: bets $2
qmEgnPhQt24xdw/ZRVPLbA: folds 
Uncalled bet ($2) returned to PqvgxdSg9z5VmrWpbYuz+g
PqvgxdSg9z5VmrWpbYuz+g collected $3.20 from pot
PqvgxdSg9z5VmrWpbYuz+g: doesn't show hand 
*** SUMMARY ***
Total pot $3.35 | Rake $0.15 
Board [As Kc Qh 2d]
Seat 1: PqvgxdSg9z5VmrWpbYuz+g (button) collected ($3.20)
Seat 2: Bb42QRQMhg5/Y0vHP8/2Xw (small blind) folded before Flop
Seat 3: Th3FldXKQW6hWVVPahaoOQ (big blind) folded before Flop
Seat 4: dfNim92Z6XK1/h5SFW5vDg folded before Flop (didn't bet)
Seat 5: iGMlK+EhUflPB6jKQd95Cg folded before Flop (didn't bet)
Seat 7: qmEgnPhQt24xdw/ZRVPLbA folded on the Turn
Seat 9: 4awUyiDYTgylQKXZ9faBVA folded before Flop (didn't bet)




PokerStars Game #59941608544:  Hold'em No Limit ($0.10/$0.25) - 2009/07/01 1:40:36 ET
Table 'oxYpQNT8OHNCvpMIFi7UoA' 9-max Seat #5 is the button
Seat 1: EVqHvqty1ZsuvDFiSXlSqQ ($29.80 in chips) 
Seat 2: 8+iP8mvFyeAviW/yUH1CJg ($29.60 in chips) 
Seat 3: ubsjZomMWSV0hAiBLa7K1A ($19.65 in chips) 
Seat 4: eK8qa6EPcH2zhtbmWSvc9g ($25 in chips) 
Seat 5: ZoqLw33zTU6EsjOkfv/cGw ($19.80 in chips) 
Seat 6: VBHxUExRAMrbxUq/cVx9Gw ($5.50 in chips) 
Seat 7: X78b5v/uhqeXXoAijbw/yg ($25 in chips) 
VBHxUExRAMrbxUq/cVx9Gw: posts small blind $0.10
X78b5v/uhqeXXoAijbw/yg: posts big blind $0.25
pN3IHvAKm2fz+sTRARTcrg: sits out 
*** HOLE CARDS ***
EVqHvqty1ZsuvDFiSXlSqQ: folds 
8+iP8mvFyeAviW/yUH1CJg: folds 
ubsjZomMWSV0hAiBLa7K1A: folds 
eK8qa6EPcH2zhtbmWSvc9g: folds 
ZoqLw33zTU6EsjOkfv/cGw: raises $1 to $1.25
VBHxUExRAMrbxUq/cVx9Gw: folds 
X78b5v/uhqeXXoAijbw/yg: folds 
Uncalled bet ($1) returned to ZoqLw33zTU6EsjOkfv/cGw
ZoqLw33zTU6EsjOkfv/cGw collected $0.60 from pot
ZoqLw33zTU6EsjOkfv/cGw: doesn't show hand 
*** SUMMARY ***
Total pot $0.60 | Rake $0 
Seat 1: EVqHvqty1ZsuvDFiSXlSqQ folded before Flop (didn't bet)
Seat 2: 8+iP8mvFyeAviW/yUH1CJg folded before Flop (didn't bet)
Seat 3: ubsjZomMWSV0hAiBLa7K1A folded before Flop (didn't bet)
Seat 4: eK8qa6EPcH2zhtbmWSvc9g folded before Flop (didn't bet)
Seat 5: ZoqLw33zTU6EsjOkfv/cGw (button) collected ($0.60)
Seat 6: VBHxUExRAMrbxUq/cVx9Gw (small blind) folded before Flop
Seat 7: X78b5v/uhqeXXoAijbw/yg (big blind) folded before Flop




PokerStars Game #59941608402:  Hold'em No Limit ($0.10/$0.25) - 2009/07/01 1:40:36 ET
Table 'ER5H84HUgJx7HyDLnELLeA' 6-max Seat #3 is the button
Seat 1: LJI7A1YgDM7hgh7o56+ReQ ($27.50 in chips) 
Seat 2: buyjetgNT1McXtdaP4zynA ($20.25 in chips) 
Seat 3: memV5jkoAdGrnRy3Q9PM7w ($19.55 in chips) 
Seat 4: vqWjZmdQu/Hxw96/IJTWdQ ($25 in chips) 
Seat 5: mfrkWA3PTeYPkbO6hi98Aw ($25.90 in chips) 
Seat 6: 3zD3qLXT1bEffAoWGnc7wg ($50.65 in chips) 
vqWjZmdQu/Hxw96/IJTWdQ: posts small blind $0.10
mfrkWA3PTeYPkbO6hi98Aw: posts big blind $0.25
*** HOLE CARDS ***
3zD3qLXT1bEffAoWGnc7wg: raises $0.50 to $0.75
LJI7A1YgDM7hgh7o56+ReQ: folds 
buyjetgNT1McXtdaP4zynA: folds 
memV5jkoAdGrnRy3Q9PM7w: folds 
vqWjZmdQu/Hxw96/IJTWdQ: folds 
mfrkWA3PTeYPkbO6hi98Aw: folds 
Uncalled bet ($0.50) returned to 3zD3qLXT1bEffAoWGnc7wg
3zD3qLXT1bEffAoWGnc7wg collected $0.60 from pot
3zD3qLXT1bEffAoWGnc7wg: doesn't show hand 
*** SUMMARY ***
Total pot $0.60 | Rake $0 
Seat 1: LJI7A1YgDM7hgh7o56+ReQ folded before Flop (didn't bet)
Seat 2: buyjetgNT1McXtdaP4zynA folded before Flop (didn't bet)
Seat 3: memV5jkoAdGrnRy3Q9PM7w (button) folded before Flop (didn't bet)
Seat 4: vqWjZmdQu/Hxw96/IJTWdQ (small blind) folded before Flop
Seat 5: mfrkWA3PTeYPkbO6hi98Aw (big blind) folded before Flop
Seat 6: 3zD3qLXT1bEffAoWGnc7wg collected ($0.60)




PokerStars Game #59941608316:  Hold'em No Limit ($0.10/$0.25) - 2009/07/01 1:40:36 ET
Table 'Zi9/NqNs3XoL1eWhMCyZyg' 9-max Seat #5 is the button
Seat 2: Th3FldXKQW6hWVVPahaoOQ ($34.30 in chips) 
Seat 4: dmYlc+1cjwZMJ7wV+Z0rRg ($22 in chips) 
Seat 5: OiV1PWZ3IkN29JlmCcnTwQ ($4.90 in chips) 
Seat 7: 0QdZrkFD7aGKeBXPGbIomA ($6.70 in chips) 
Seat 8: nm4Dj/f+jJEwKVsUnKh73g ($38.65 in chips) 
Seat 9: tYsOBqdU1+x+yFI7zHO7hQ ($31.65 in chips) 
0QdZrkFD7aGKeBXPGbIomA: posts small blind $0.10
nm4Dj/f+jJEwKVsUnKh73g: posts big blind $0.25
*** HOLE CARDS ***
tYsOBqdU1+x+yFI7zHO7hQ: folds 
Th3FldXKQW6hWVVPahaoOQ: folds 
dmYlc+1cjwZMJ7wV+Z0rRg: raises $0.50 to $0.75
OiV1PWZ3IkN29JlmCcnTwQ: folds 
0QdZrkFD7aGKeBXPGbIomA: folds 
nm4Dj/f+jJEwKVsUnKh73g: calls $0.50
*** FLOP *** [9h 2s 5c]
nm4Dj/f+jJEwKVsUnKh73g: checks 
dmYlc+1cjwZMJ7wV+Z0rRg: checks 
*** TURN *** [9h 2s 5c] [3s]
nm4Dj/f+jJEwKVsUnKh73g: checks 
dmYlc+1cjwZMJ7wV+Z0rRg: checks 
*** RIVER *** [9h 2s 5c 3s] [7d]
nm4Dj/f+jJEwKVsUnKh73g: checks 
dmYlc+1cjwZMJ7wV+Z0rRg: checks 
*** SHOW DOWN ***
nm4Dj/f+jJEwKVsUnKh73g: shows [Kh Jh] (high card King)
dmYlc+1cjwZMJ7wV+Z0rRg: shows [Tc Ac] (high card Ace)
ETC7YyRJTa2Ovhln64Ni5Q joins the table at seat #3 
dmYlc+1cjwZMJ7wV+Z0rRg collected $1.55 from pot
*** SUMMARY ***
Total pot $1.60 | Rake $0.05 
Board [9h 2s 5c 3s 7d]
Seat 2: Th3FldXKQW6hWVVPahaoOQ folded before Flop (didn't bet)
Seat 4: dmYlc+1cjwZMJ7wV+Z0rRg showed [Tc Ac] and won ($1.55) with high card Ace
Seat 5: OiV1PWZ3IkN29JlmCcnTwQ (button) folded before Flop (didn't bet)
Seat 7: 0QdZrkFD7aGKeBXPGbIomA (small blind) folded before Flop
Seat 8: nm4Dj/f+jJEwKVsUnKh73g (big blind) showed [Kh Jh] and lost with high card King
Seat 9: tYsOBqdU1+x+yFI7zHO7hQ folded before Flop (didn't bet)




PokerStars Game #59941608382:  Hold'em No Limit ($0.10/$0.25) - 2009/07/01 1:40:36 ET
Table 'sDHjMRwfSiz7+NDdZLUiyA' 9-max Seat #1 is the button
Seat 1: VGwr1eqhvdUtMfBFCvBnmg ($8.50 in chips) 
Seat 2: ljemhp25Zg+nlA9DLCIiUw ($26.85 in chips) 
Seat 3: SGA1WpAnQxFdFAYyt362gQ ($17.15 in chips) 
Seat 4: eK8qa6EPcH2zhtbmWSvc9g ($25.45 in chips) 
Seat 5: IGRfskE1v9H9Bn+fz8AgNQ ($37.40 in chips) 
Seat 6: 1qa0qHOCKZM3Uipx9DxYtQ ($15 in chips) 
Seat 7: K0b5wNInj6hUGRr6yzKFtw ($37.65 in chips) 
Seat 8: 3hMkm4U5yTRrkGJkxfijaQ ($5.15 in chips) 
Seat 9: 3PmVnC/15cl4oyI1TKIt4g ($4.30 in chips) 
ljemhp25Zg+nlA9DLCIiUw: posts small blind $0.10
SGA1WpAnQxFdFAYyt362gQ: posts big blind $0.25
*** HOLE CARDS ***
eK8qa6EPcH2zhtbmWSvc9g: folds 
IGRfskE1v9H9Bn+fz8AgNQ: folds 
1qa0qHOCKZM3Uipx9DxYtQ: calls $0.25
K0b5wNInj6hUGRr6yzKFtw: folds 
3hMkm4U5yTRrkGJkxfijaQ: folds 
3PmVnC/15cl4oyI1TKIt4g: folds 
VGwr1eqhvdUtMfBFCvBnmg: folds 
ljemhp25Zg+nlA9DLCIiUw: folds 
SGA1WpAnQxFdFAYyt362gQ: checks 
*** FLOP *** [2c 3s 9c]
SGA1WpAnQxFdFAYyt362gQ: checks 
1qa0qHOCKZM3Uipx9DxYtQ: checks 
*** TURN *** [2c 3s 9c] [6h]
SGA1WpAnQxFdFAYyt362gQ: checks 
1qa0qHOCKZM3Uipx9DxYtQ: checks 
*** RIVER *** [2c 3s 9c 6h] [Ac]
SGA1WpAnQxFdFAYyt362gQ: bets $0.75
1qa0qHOCKZM3Uipx9DxYtQ: calls $0.75
*** SHOW DOWN ***
SGA1WpAnQxFdFAYyt362gQ: shows [9s As] (two pair, Aces and Nines)
1qa0qHOCKZM3Uipx9DxYtQ: shows [8c Ah] (a pair of Aces)
SGA1WpAnQxFdFAYyt362gQ collected $2 from pot
*** SUMMARY ***
Total pot $2.10 | Rake $0.10 
Board [2c 3s 9c 6h Ac]
Seat 1: VGwr1eqhvdUtMfBFCvBnmg (button) folded before Flop (didn't bet)
Seat 2: ljemhp25Zg+nlA9DLCIiUw (small blind) folded before Flop
Seat 3: SGA1WpAnQxFdFAYyt362gQ (big blind) showed [9s As] and won ($2) with two pair, Aces and Nines
Seat 4: eK8qa6EPcH2zhtbmWSvc9g folded before Flop (didn't bet)
Seat 5: IGRfskE1v9H9Bn+fz8AgNQ folded before Flop (didn't bet)
Seat 6: 1qa0qHOCKZM3Uipx9DxYtQ showed [8c Ah] and lost with a pair of Aces
Seat 7: K0b5wNInj6hUGRr6yzKFtw folded before Flop (didn't bet)
Seat 8: 3hMkm4U5yTRrkGJkxfijaQ folded before Flop (didn't bet)
Seat 9: 3PmVnC/15cl4oyI1TKIt4g folded before Flop (didn't bet)




PokerStars Game #59941608740:  Hold'em No Limit ($0.10/$0.25) - 2009/07/01 1:40:37 ET
Table 'x7YStLKc8hpt/pTgSetPKA' 9-max Seat #7 is the button
Seat 1: tYsOBqdU1+x+yFI7zHO7hQ ($26.60 in chips) 
Seat 2: z5GxcHlYz/GSz6W2uFiTtg ($23.70 in chips) 
Seat 3: S7Ki0P+0AIGPuIfGJjW0gg ($12 in chips) 
Seat 4: ydoFOVgzvZv9ZhuWu9rXAw ($5.25 in chips) 
Seat 5: OiV1PWZ3IkN29JlmCcnTwQ ($4.90 in chips) 
Seat 6: 9YN2IkT2JYYKFErZtZvCtA ($47.70 in chips) 
Seat 7: dtZ84flFEi4Q+SGrHMJRDQ ($26.35 in chips) 
Seat 8: j4q3p0lesp63b1gZDwLBZw ($5 in chips) 
Seat 9: nm4Dj/f+jJEwKVsUnKh73g ($22.65 in chips) 
j4q3p0lesp63b1gZDwLBZw: posts small blind $0.10
nm4Dj/f+jJEwKVsUnKh73g: posts big blind $0.25
*** HOLE CARDS ***
tYsOBqdU1+x+yFI7zHO7hQ: folds 
z5GxcHlYz/GSz6W2uFiTtg: folds 
S7Ki0P+0AIGPuIfGJjW0gg: folds 
ydoFOVgzvZv9ZhuWu9rXAw: folds 
OiV1PWZ3IkN29JlmCcnTwQ: raises $0.75 to $1
9YN2IkT2JYYKFErZtZvCtA: folds 
dtZ84flFEi4Q+SGrHMJRDQ: folds 
j4q3p0lesp63b1gZDwLBZw: folds 
nm4Dj/f+jJEwKVsUnKh73g: calls $0.75
*** FLOP *** [Kh 7h Kc]
nm4Dj/f+jJEwKVsUnKh73g: checks 
OiV1PWZ3IkN29JlmCcnTwQ: checks 
*** TURN *** [Kh 7h Kc] [4c]
nm4Dj/f+jJEwKVsUnKh73g: checks 
OiV1PWZ3IkN29JlmCcnTwQ: checks 
*** RIVER *** [Kh 7h Kc 4c] [3d]
nm4Dj/f+jJEwKVsUnKh73g: checks 
OiV1PWZ3IkN29JlmCcnTwQ: bets $0.75
nm4Dj/f+jJEwKVsUnKh73g: folds 
Uncalled bet ($0.75) returned to OiV1PWZ3IkN29JlmCcnTwQ
OiV1PWZ3IkN29JlmCcnTwQ collected $2 from pot
OiV1PWZ3IkN29JlmCcnTwQ: doesn't show hand 
*** SUMMARY ***
Total pot $2.10 | Rake $0.10 
Board [Kh 7h Kc 4c 3d]
Seat 1: tYsOBqdU1+x+yFI7zHO7hQ folded before Flop (didn't bet)
Seat 2: z5GxcHlYz/GSz6W2uFiTtg folded before Flop (didn't bet)
Seat 3: S7Ki0P+0AIGPuIfGJjW0gg folded before Flop (didn't bet)
Seat 4: ydoFOVgzvZv9ZhuWu9rXAw folded before Flop (didn't bet)
Seat 5: OiV1PWZ3IkN29JlmCcnTwQ collected ($2)
Seat 6: 9YN2IkT2JYYKFErZtZvCtA folded before Flop (didn't bet)
Seat 7: dtZ84flFEi4Q+SGrHMJRDQ (button) folded before Flop (didn't bet)
Seat 8: j4q3p0lesp63b1gZDwLBZw (small blind) folded before Flop
Seat 9: nm4Dj/f+jJEwKVsUnKh73g (big blind) folded on the River




PokerStars Game #59941608744:  Hold'em No Limit ($0.10/$0.25) - 2009/07/01 1:40:37 ET
Table 'PCxB2W9H6ma8SwsZlImuOw' 9-max Seat #2 is the button
Seat 1: SqibpGx+lf+brY0fJVvD0w ($24.15 in chips) 
Seat 2: wjH6l1gQaEfv+C45sAOwIQ ($38.20 in chips) 
Seat 3: J2a/QHAWUgo6beDRoEyg2g ($10.35 in chips) 
Seat 4: RsPwA2DnzOke3hD/Of/DUg ($2.90 in chips) 
Seat 5: GZO7tOXatVoX17M2DqPcUQ ($20.60 in chips) 
Seat 6: 5/6dWEBUHldD7iGXa2LwsQ ($17.25 in chips) 
Seat 7: c/9X4zftzphFxYtxp5kp9w ($26.80 in chips) 
Seat 8: Pt637jKksB5MzP0UNJAAkw ($25 in chips) 
Seat 9: COwSH15MvHaRF7en6/TRZQ ($4.65 in chips) 
J2a/QHAWUgo6beDRoEyg2g: posts small blind $0.10
RsPwA2DnzOke3hD/Of/DUg: posts big blind $0.25
*** HOLE CARDS ***
GZO7tOXatVoX17M2DqPcUQ: folds 
5/6dWEBUHldD7iGXa2LwsQ: folds 
c/9X4zftzphFxYtxp5kp9w: folds 
Pt637jKksB5MzP0UNJAAkw: folds 
COwSH15MvHaRF7en6/TRZQ: folds 
SqibpGx+lf+brY0fJVvD0w: raises $0.50 to $0.75
wjH6l1gQaEfv+C45sAOwIQ: folds 
J2a/QHAWUgo6beDRoEyg2g: calls $0.65
RsPwA2DnzOke3hD/Of/DUg: folds 
*** FLOP *** [2d 4c 9c]
J2a/QHAWUgo6beDRoEyg2g: checks 
SqibpGx+lf+brY0fJVvD0w: bets $1
J2a/QHAWUgo6beDRoEyg2g: folds 
Uncalled bet ($1) returned to SqibpGx+lf+brY0fJVvD0w
SqibpGx+lf+brY0fJVvD0w collected $1.70 from pot
*** SUMMARY ***
Total pot $1.75 | Rake $0.05 
Board [2d 4c 9c]
Seat 1: SqibpGx+lf+brY0fJVvD0w collected ($1.70)
Seat 2: wjH6l1gQaEfv+C45sAOwIQ (button) folded before Flop (didn't bet)
Seat 3: J2a/QHAWUgo6beDRoEyg2g (small blind) folded on the Flop
Seat 4: RsPwA2DnzOke3hD/Of/DUg (big blind) folded before Flop
Seat 5: GZO7tOXatVoX17M2DqPcUQ folded before Flop (didn't bet)
Seat 6: 5/6dWEBUHldD7iGXa2LwsQ folded before Flop (didn't bet)
Seat 7: c/9X4zftzphFxYtxp5kp9w folded before Flop (didn't bet)
Seat 8: Pt637jKksB5MzP0UNJAAkw folded before Flop (didn't bet)
Seat 9: COwSH15MvHaRF7en6/TRZQ folded before Flop (didn't bet)




PokerStars Game #59941608816:  Hold'em No Limit ($0.10/$0.25) - 2009/07/01 1:40:37 ET
Table 'rjcb+nlE+0GuJ6lBhuCkkA' 6-max Seat #2 is the button
Seat 1: lBoEwOFgzcERLIRUkUoRTw ($13.95 in chips) 
Seat 2: lJphax9e7/+O/3YCKPJ0yQ ($4.65 in chips) 
Seat 3: 8ClCHtFXGNplITm+63KB+Q ($66.60 in chips) 
Seat 4: BV+K0Phf5VBHr7aZPKqbUQ ($25 in chips) 
Seat 5: GC/9yVD59DUCX7hUI7gcLw ($42.10 in chips) 
8ClCHtFXGNplITm+63KB+Q: posts small blind $0.10
BV+K0Phf5VBHr7aZPKqbUQ: posts big blind $0.25
32YL2ZEp8NT4JB2RVM9euQ: sits out 
*** HOLE CARDS ***
GC/9yVD59DUCX7hUI7gcLw: folds 
lBoEwOFgzcERLIRUkUoRTw: folds 
lJphax9e7/+O/3YCKPJ0yQ: calls $0.25
8ClCHtFXGNplITm+63KB+Q: folds 
BV+K0Phf5VBHr7aZPKqbUQ: raises $1 to $1.25
lJphax9e7/+O/3YCKPJ0yQ: folds 
Uncalled bet ($1) returned to BV+K0Phf5VBHr7aZPKqbUQ
BV+K0Phf5VBHr7aZPKqbUQ collected $0.60 from pot
BV+K0Phf5VBHr7aZPKqbUQ: doesn't show hand 
*** SUMMARY ***
Total pot $0.60 | Rake $0 
Seat 1: lBoEwOFgzcERLIRUkUoRTw folded before Flop (didn't bet)
Seat 2: lJphax9e7/+O/3YCKPJ0yQ (button) folded before Flop
Seat 3: 8ClCHtFXGNplITm+63KB+Q (small blind) folded before Flop
Seat 4: BV+K0Phf5VBHr7aZPKqbUQ (big blind) collected ($0.60)
Seat 5: GC/9yVD59DUCX7hUI7gcLw folded before Flop (didn't bet)




PokerStars Game #59941609152:  Hold'em No Limit ($0.10/$0.25) - 2009/07/01 1:40:37 ET
Table 'NtEQAxCeIK2io1CGtW658g' 6-max Seat #6 is the button
Seat 1: X437kMQ7AujoaDgjguhU9w ($11.90 in chips) 
Seat 3: m2yWOKfAxqHoy5DDN87Ttw ($37.65 in chips) 
Seat 4: 8296 ($12.15 in chips) 
Seat 5: Hsvkc0/G2VV78oVmWYXecw ($5 in chips) 
Seat 6: /gJNBeCkWL4o85/jvlZ4BA ($64.50 in chips) 
X437kMQ7AujoaDgjguhU9w: posts small blind $0.10
m2yWOKfAxqHoy5DDN87Ttw: posts big blind $0.25
*** HOLE CARDS ***
8296: calls $0.25
Hsvkc0/G2VV78oVmWYXecw: folds 
/gJNBeCkWL4o85/jvlZ4BA: calls $0.25
X437kMQ7AujoaDgjguhU9w: folds 
m2yWOKfAxqHoy5DDN87Ttw: checks 
*** FLOP *** [Kc Ac 7s]
m2yWOKfAxqHoy5DDN87Ttw: checks 
8296: checks 
/gJNBeCkWL4o85/jvlZ4BA: bets $0.75
m2yWOKfAxqHoy5DDN87Ttw: folds 
8296: folds 
Uncalled bet ($0.75) returned to /gJNBeCkWL4o85/jvlZ4BA
/gJNBeCkWL4o85/jvlZ4BA collected $0.85 from pot
*** SUMMARY ***
Total pot $0.85 | Rake $0 
Board [Kc Ac 7s]
Seat 1: X437kMQ7AujoaDgjguhU9w (small blind) folded before Flop
Seat 3: m2yWOKfAxqHoy5DDN87Ttw (big blind) folded on the Flop
Seat 4: 8296 folded on the Flop
Seat 5: Hsvkc0/G2VV78oVmWYXecw folded before Flop (didn't bet)
Seat 6: /gJNBeCkWL4o85/jvlZ4BA (button) collected ($0.85)




PokerStars Game #59941608998:  Hold'em No Limit ($0.10/$0.25) - 2009/07/01 1:40:37 ET
Table 'mF3KHGMaTpaBZbtBoyfTeg' 6-max Seat #3 is the button
Seat 1: 0HAB2GdCAM7p7V00xueAVQ ($24.90 in chips) 
Seat 2: 6qsh9pnysDKJNhfFhFmKRQ ($9.40 in chips) 
Seat 3: 9kUKGKkblnIx3m8rlVol6Q ($14.65 in chips) 
Seat 4: FYepjhAvF8ZdVCmqHIy+eQ ($25 in chips) 
Seat 5: 8ClCHtFXGNplITm+63KB+Q ($43.75 in chips) 
Seat 6: kG34n23qFQA3nzdOJTQ1dA ($27.50 in chips) 
FYepjhAvF8ZdVCmqHIy+eQ: posts small blind $0.10
8ClCHtFXGNplITm+63KB+Q: posts big blind $0.25
*** HOLE CARDS ***
kG34n23qFQA3nzdOJTQ1dA: folds 
0HAB2GdCAM7p7V00xueAVQ: raises $0.75 to $1
6qsh9pnysDKJNhfFhFmKRQ: folds 
9kUKGKkblnIx3m8rlVol6Q: folds 
FYepjhAvF8ZdVCmqHIy+eQ: folds 
8ClCHtFXGNplITm+63KB+Q: folds 
Uncalled bet ($0.75) returned to 0HAB2GdCAM7p7V00xueAVQ
0HAB2GdCAM7p7V00xueAVQ collected $0.60 from pot
0HAB2GdCAM7p7V00xueAVQ: doesn't show hand 
*** SUMMARY ***
Total pot $0.60 | Rake $0 
Seat 1: 0HAB2GdCAM7p7V00xueAVQ collected ($0.60)
Seat 2: 6qsh9pnysDKJNhfFhFmKRQ folded before Flop (didn't bet)
Seat 3: 9kUKGKkblnIx3m8rlVol6Q (button) folded before Flop (didn't bet)
Seat 4: FYepjhAvF8ZdVCmqHIy+eQ (small blind) folded before Flop
Seat 5: 8ClCHtFXGNplITm+63KB+Q (big blind) folded before Flop
Seat 6: kG34n23qFQA3nzdOJTQ1dA folded before Flop (didn't bet)




PokerStars Game #59941609290:  Hold'em No Limit ($0.10/$0.25) - 2009/07/01 1:40:38 ET
Table 'M8kYidAX3ib7pLKW7edFLw' 6-max Seat #4 is the button
Seat 1: jp34e617tIzV8tKIWmfAbA ($25.70 in chips) 
Seat 2: ypmjhffk/YHGc51wgVXUTw ($28.45 in chips) 
Seat 3: cezpHJ8FB07dj0xG+LhOvw ($27.45 in chips) 
Seat 4: Hsvkc0/G2VV78oVmWYXecw ($5.35 in chips) 
Seat 5: bDKopKTvPi3W+PEnYUX3tg ($44.25 in chips) 
Seat 6: NqFoyDgzLwu4dOmSRXnFBA ($20 in chips) 
bDKopKTvPi3W+PEnYUX3tg: posts small blind $0.10
NqFoyDgzLwu4dOmSRXnFBA: posts big blind $0.25
*** HOLE CARDS ***
jp34e617tIzV8tKIWmfAbA: folds 
ypmjhffk/YHGc51wgVXUTw: folds 
cezpHJ8FB07dj0xG+LhOvw: folds 
Hsvkc0/G2VV78oVmWYXecw: folds 
bDKopKTvPi3W+PEnYUX3tg: raises $0.75 to $1
NqFoyDgzLwu4dOmSRXnFBA: folds 
Uncalled bet ($0.75) returned to bDKopKTvPi3W+PEnYUX3tg
bDKopKTvPi3W+PEnYUX3tg collected $0.50 from pot
bDKopKTvPi3W+PEnYUX3tg: doesn't show hand 
*** SUMMARY ***
Total pot $0.50 | Rake $0 
Seat 1: jp34e617tIzV8tKIWmfAbA folded before Flop (didn't bet)
Seat 2: ypmjhffk/YHGc51wgVXUTw folded before Flop (didn't bet)
Seat 3: cezpHJ8FB07dj0xG+LhOvw folded before Flop (didn't bet)
Seat 4: Hsvkc0/G2VV78oVmWYXecw (button) folded before Flop (didn't bet)
Seat 5: bDKopKTvPi3W+PEnYUX3tg (small blind) collected ($0.50)
Seat 6: NqFoyDgzLwu4dOmSRXnFBA (big blind) folded before Flop




PokerStars Game #59941609556:  Hold'em No Limit ($0.10/$0.25) - 2009/07/01 1:40:38 ET
Table '+198VWQSWBhYQOcizzuBkw' 6-max Seat #3 is the button
Seat 1: 34ttqW62uIRrqINCCmLcsw ($10 in chips) 
Seat 3: vw7gefupgmOJJN8lUemdWg ($24.40 in chips) 
Seat 4: TgDsTeCdLQt8kWbL00ByRA ($16.35 in chips) 
Seat 5: LtASJ9OlkqGrrUKGQlpGAw ($26.95 in chips) 
Seat 6: leEQ84f6wJYu5SB/vj27wg ($11.55 in chips) 
TgDsTeCdLQt8kWbL00ByRA: posts small blind $0.10
LtASJ9OlkqGrrUKGQlpGAw: posts big blind $0.25
34ttqW62uIRrqINCCmLcsw: posts big blind $0.25
*** HOLE CARDS ***
leEQ84f6wJYu5SB/vj27wg: calls $0.25
34ttqW62uIRrqINCCmLcsw: checks 
vw7gefupgmOJJN8lUemdWg: raises $0.25 to $0.50
TgDsTeCdLQt8kWbL00ByRA: folds 
iauW7L/+7qzAuHow7CD75Q joins the table at seat #2 
LtASJ9OlkqGrrUKGQlpGAw: folds 
leEQ84f6wJYu5SB/vj27wg: calls $0.25
34ttqW62uIRrqINCCmLcsw: calls $0.25
*** FLOP *** [8h Ts Kd]
leEQ84f6wJYu5SB/vj27wg: checks 
34ttqW62uIRrqINCCmLcsw: bets $1
vw7gefupgmOJJN8lUemdWg: folds 
leEQ84f6wJYu5SB/vj27wg: folds 
Uncalled bet ($1) returned to 34ttqW62uIRrqINCCmLcsw
34ttqW62uIRrqINCCmLcsw collected $1.80 from pot
34ttqW62uIRrqINCCmLcsw: doesn't show hand 
*** SUMMARY ***
Total pot $1.85 | Rake $0.05 
Board [8h Ts Kd]
Seat 1: 34ttqW62uIRrqINCCmLcsw collected ($1.80)
Seat 3: vw7gefupgmOJJN8lUemdWg (button) folded on the Flop
Seat 4: TgDsTeCdLQt8kWbL00ByRA (small blind) folded before Flop
Seat 5: LtASJ9OlkqGrrUKGQlpGAw (big blind) folded before Flop
Seat 6: leEQ84f6wJYu5SB/vj27wg folded on the Flop




PokerStars Game #59941609438:  Hold'em No Limit ($0.10/$0.25) - 2009/07/01 1:40:38 ET
Table 'C47I7CmrmFr8Oo7wOovVwQ' 6-max Seat #6 is the button
Seat 2: hOaWAImn5/MZDAWAPlYHCw ($5.20 in chips) 
Seat 3: H+8eOP3XJHXjACRDTiIHTQ ($16.65 in chips) 
Seat 4: yY5JuFtDfXWRaZlVby4LLw ($15.75 in chips) 
Seat 5: or309yYY9Y9bfFWtrB0yUg ($5 in chips) 
Seat 6: pD7ri5wL3vsa6S1ulMYQmQ ($24.70 in chips) 
v6mkGzCBCCXcgWQNSYVtKg will be allowed to play after the button
hOaWAImn5/MZDAWAPlYHCw: posts small blind $0.10
H+8eOP3XJHXjACRDTiIHTQ: posts big blind $0.25
or309yYY9Y9bfFWtrB0yUg: posts big blind $0.25
*** HOLE CARDS ***
yY5JuFtDfXWRaZlVby4LLw: calls $0.25
or309yYY9Y9bfFWtrB0yUg: raises $0.25 to $0.50
pD7ri5wL3vsa6S1ulMYQmQ: calls $0.50
hOaWAImn5/MZDAWAPlYHCw: calls $0.40
H+8eOP3XJHXjACRDTiIHTQ: calls $0.25
yY5JuFtDfXWRaZlVby4LLw: calls $0.25
*** FLOP *** [4h Js 3h]
hOaWAImn5/MZDAWAPlYHCw: checks 
H+8eOP3XJHXjACRDTiIHTQ: checks 
yY5JuFtDfXWRaZlVby4LLw: checks 
or309yYY9Y9bfFWtrB0yUg: bets $0.75
pD7ri5wL3vsa6S1ulMYQmQ: calls $0.75
hOaWAImn5/MZDAWAPlYHCw: calls $0.75
H+8eOP3XJHXjACRDTiIHTQ: folds 
yY5JuFtDfXWRaZlVby4LLw: raises $3.50 to $4.25
or309yYY9Y9bfFWtrB0yUg: raises $0.25 to $4.50 and is all-in
pD7ri5wL3vsa6S1ulMYQmQ: folds 
hOaWAImn5/MZDAWAPlYHCw: folds 
yY5JuFtDfXWRaZlVby4LLw: calls $0.25
*** TURN *** [4h Js 3h] [2d]
*** RIVER *** [4h Js 3h 2d] [9d]
*** SHOW DOWN ***
yY5JuFtDfXWRaZlVby4LLw: shows [Kd Jh] (a pair of Jacks)
or309yYY9Y9bfFWtrB0yUg: shows [9c 9h] (three of a kind, Nines)
or309yYY9Y9bfFWtrB0yUg collected $12.40 from pot
*** SUMMARY ***
Total pot $13 | Rake $0.60 
Board [4h Js 3h 2d 9d]
Seat 2: hOaWAImn5/MZDAWAPlYHCw (small blind) folded on the Flop
Seat 3: H+8eOP3XJHXjACRDTiIHTQ (big blind) folded on the Flop
Seat 4: yY5JuFtDfXWRaZlVby4LLw showed [Kd Jh] and lost with a pair of Jacks
Seat 5: or309yYY9Y9bfFWtrB0yUg showed [9c 9h] and won ($12.40) with three of a kind, Nines
Seat 6: pD7ri5wL3vsa6S1ulMYQmQ (button) folded on the Flop




PokerStars Game #59941609946:  Hold'em No Limit ($0.10/$0.25) - 2009/07/01 1:40:39 ET
Table 'sm5gqEvXgLbkkE4dryW/5g' 6-max Seat #1 is the button
Seat 1: v8m8XHovI5tqEA9mvplDSw ($38.35 in chips) 
Seat 2: 5xs5/u2z1CO9zkRvH72MQg ($17.65 in chips) 
Seat 3: UT5XpwOH1ipkOF7n1MqDJA ($26.25 in chips) 
Seat 4: cWc85bEzdRzpUMhRKm8pwQ ($25.25 in chips) 
5xs5/u2z1CO9zkRvH72MQg: posts small blind $0.10
UT5XpwOH1ipkOF7n1MqDJA: posts big blind $0.25
*** HOLE CARDS ***
cWc85bEzdRzpUMhRKm8pwQ: folds 
v8m8XHovI5tqEA9mvplDSw: raises $0.75 to $1
5xs5/u2z1CO9zkRvH72MQg: folds 
aogAb4Eienxztk8p2v9VVw is connected 
aogAb4Eienxztk8p2v9VVw has returned
UT5XpwOH1ipkOF7n1MqDJA: folds 
Uncalled bet ($0.75) returned to v8m8XHovI5tqEA9mvplDSw
v8m8XHovI5tqEA9mvplDSw collected $0.60 from pot
v8m8XHovI5tqEA9mvplDSw: doesn't show hand 
*** SUMMARY ***
Total pot $0.60 | Rake $0 
Seat 1: v8m8XHovI5tqEA9mvplDSw (button) collected ($0.60)
Seat 2: 5xs5/u2z1CO9zkRvH72MQg (small blind) folded before Flop
Seat 3: UT5XpwOH1ipkOF7n1MqDJA (big blind) folded before Flop
Seat 4: cWc85bEzdRzpUMhRKm8pwQ folded before Flop (didn't bet)




PokerStars Game #59941610222:  Hold'em No Limit ($0.10/$0.25) - 2009/07/01 1:40:39 ET
Table 'Utmw+yX+E/wdhNDIim90lQ' 9-max Seat #9 is the button
Seat 1: cZ99hugmLBj9KhTlc8nCSw ($31.80 in chips) 
Seat 2: iGMlK+EhUflPB6jKQd95Cg ($25 in chips) 
Seat 3: dfNim92Z6XK1/h5SFW5vDg ($25.30 in chips) 
Seat 4: ifYGvZDHQQ0aam4awTtHwA ($27.35 in chips) 
Seat 5: ghNKXUBl/H+t83JF079ZBA ($25 in chips) 
Seat 6: OlPJsgR4xypSg/w1z7Gyvw ($22.15 in chips) 
Seat 7: CImUHesK+ZER4v/VCA9IUg ($57.60 in chips) 
Seat 8: Mh2r9hTeTEDnh19sRZtW3g ($4.65 in chips) 
Seat 9: Th3FldXKQW6hWVVPahaoOQ ($28.50 in chips) 
cZ99hugmLBj9KhTlc8nCSw: posts small blind $0.10
iGMlK+EhUflPB6jKQd95Cg: posts big blind $0.25
*** HOLE CARDS ***
dfNim92Z6XK1/h5SFW5vDg: folds 
ifYGvZDHQQ0aam4awTtHwA: raises $0.25 to $0.50
ghNKXUBl/H+t83JF079ZBA: folds 
OlPJsgR4xypSg/w1z7Gyvw: raises $1 to $1.50
CImUHesK+ZER4v/VCA9IUg: calls $1.50
Mh2r9hTeTEDnh19sRZtW3g: raises $3.15 to $4.65 and is all-in
Th3FldXKQW6hWVVPahaoOQ: folds 
cZ99hugmLBj9KhTlc8nCSw: folds 
iGMlK+EhUflPB6jKQd95Cg: folds 
ifYGvZDHQQ0aam4awTtHwA: folds 
OlPJsgR4xypSg/w1z7Gyvw: raises $3.15 to $7.80
CImUHesK+ZER4v/VCA9IUg: calls $6.30
*** FLOP *** [Kd 9d 2h]
OlPJsgR4xypSg/w1z7Gyvw: bets $6
CImUHesK+ZER4v/VCA9IUg: folds 
Uncalled bet ($6) returned to OlPJsgR4xypSg/w1z7Gyvw
*** TURN *** [Kd 9d 2h] [Ac]
*** RIVER *** [Kd 9d 2h Ac] [2d]
*** SHOW DOWN ***
OlPJsgR4xypSg/w1z7Gyvw: shows [As Kh] (two pair, Aces and Kings)
OlPJsgR4xypSg/w1z7Gyvw collected $5.95 from side pot
Mh2r9hTeTEDnh19sRZtW3g: mucks hand 
OlPJsgR4xypSg/w1z7Gyvw collected $14.10 from main pot
*** SUMMARY ***
Total pot $21.10 Main pot $14.10. Side pot $5.95. | Rake $1.05 
Board [Kd 9d 2h Ac 2d]
Seat 1: cZ99hugmLBj9KhTlc8nCSw (small blind) folded before Flop
Seat 2: iGMlK+EhUflPB6jKQd95Cg (big blind) folded before Flop
Seat 3: dfNim92Z6XK1/h5SFW5vDg folded before Flop (didn't bet)
Seat 4: ifYGvZDHQQ0aam4awTtHwA folded before Flop
Seat 5: ghNKXUBl/H+t83JF079ZBA folded before Flop (didn't bet)
Seat 6: OlPJsgR4xypSg/w1z7Gyvw showed [As Kh] and won ($20.05) with two pair, Aces and Kings
Seat 7: CImUHesK+ZER4v/VCA9IUg folded on the Flop
Seat 8: Mh2r9hTeTEDnh19sRZtW3g mucked
Seat 9: Th3FldXKQW6hWVVPahaoOQ (button) folded before Flop (didn't bet)




PokerStars Game #59941610068:  Hold'em No Limit ($0.10/$0.25) - 2009/07/01 1:40:39 ET
Table 'NgexmgEDEzICBeSO7YCrKQ' 6-max Seat #1 is the button
Seat 1: cezpHJ8FB07dj0xG+LhOvw ($29.80 in chips) 
Seat 2: 32YL2ZEp8NT4JB2RVM9euQ ($20.85 in chips) 
Seat 3: JFIAqU8lCZ0vWwEl4bdGsg ($27.20 in chips) 
Seat 4: xx+iYCDJhHJmNzrfeloyEg ($26.20 in chips) 
Seat 5: /MXkdT8TTs8Qp2LVTQNw6w ($38.30 in chips) 
Seat 6: k9nHZTHt8hYhYRcW8NTb4g ($12.70 in chips) 
32YL2ZEp8NT4JB2RVM9euQ: posts small blind $0.10
JFIAqU8lCZ0vWwEl4bdGsg: posts big blind $0.25
*** HOLE CARDS ***
xx+iYCDJhHJmNzrfeloyEg: folds 
/MXkdT8TTs8Qp2LVTQNw6w: calls $0.25
k9nHZTHt8hYhYRcW8NTb4g: folds 
cezpHJ8FB07dj0xG+LhOvw: folds 
32YL2ZEp8NT4JB2RVM9euQ: raises $0.25 to $0.50
JFIAqU8lCZ0vWwEl4bdGsg: folds 
/MXkdT8TTs8Qp2LVTQNw6w: calls $0.25
*** FLOP *** [5s 2s 8s]
32YL2ZEp8NT4JB2RVM9euQ: bets $1
/MXkdT8TTs8Qp2LVTQNw6w: folds 
Uncalled bet ($1) returned to 32YL2ZEp8NT4JB2RVM9euQ
32YL2ZEp8NT4JB2RVM9euQ collected $1.20 from pot
32YL2ZEp8NT4JB2RVM9euQ: doesn't show hand 
*** SUMMARY ***
Total pot $1.25 | Rake $0.05 
Board [5s 2s 8s]
Seat 1: cezpHJ8FB07dj0xG+LhOvw (button) folded before Flop (didn't bet)
Seat 2: 32YL2ZEp8NT4JB2RVM9euQ (small blind) collected ($1.20)
Seat 3: JFIAqU8lCZ0vWwEl4bdGsg (big blind) folded before Flop
Seat 4: xx+iYCDJhHJmNzrfeloyEg folded before Flop (didn't bet)
Seat 5: /MXkdT8TTs8Qp2LVTQNw6w folded on the Flop
Seat 6: k9nHZTHt8hYhYRcW8NTb4g folded before Flop (didn't bet)




PokerStars Game #59941610016:  Hold'em No Limit ($0.10/$0.25) - 2009/07/01 1:40:39 ET
Table 'i8VqsSY3xDtJ63IHleN8+A' 9-max Seat #4 is the button
Seat 1: Mh2r9hTeTEDnh19sRZtW3g ($4.25 in chips) 
Seat 3: 4awUyiDYTgylQKXZ9faBVA ($29.15 in chips) 
Seat 4: X78b5v/uhqeXXoAijbw/yg ($26.75 in chips) 
Seat 6: 3PmVnC/15cl4oyI1TKIt4g ($5.25 in chips) 
Seat 8: CvL9Ch1HYCVbTsfpNucitg ($5.35 in chips) 
Seat 9: tLcDklc2rBORNfixyRfVfw ($25 in chips) 
3PmVnC/15cl4oyI1TKIt4g: posts small blind $0.10
bXpVeaSTPBFSPJmeXxO7nw: is sitting out 
bXpVeaSTPBFSPJmeXxO7nw leaves the table
CvL9Ch1HYCVbTsfpNucitg: posts big blind $0.25
*** HOLE CARDS ***
tLcDklc2rBORNfixyRfVfw: folds 
Mh2r9hTeTEDnh19sRZtW3g: folds 
4awUyiDYTgylQKXZ9faBVA: folds 
X78b5v/uhqeXXoAijbw/yg: folds 
3PmVnC/15cl4oyI1TKIt4g: calls $0.15
CvL9Ch1HYCVbTsfpNucitg: checks 
*** FLOP *** [Qd 5s Kh]
3PmVnC/15cl4oyI1TKIt4g: checks 
CvL9Ch1HYCVbTsfpNucitg: checks 
*** TURN *** [Qd 5s Kh] [9c]
3PmVnC/15cl4oyI1TKIt4g: bets $0.25
CvL9Ch1HYCVbTsfpNucitg: folds 
Uncalled bet ($0.25) returned to 3PmVnC/15cl4oyI1TKIt4g
3PmVnC/15cl4oyI1TKIt4g collected $0.50 from pot
3PmVnC/15cl4oyI1TKIt4g: doesn't show hand 
*** SUMMARY ***
Total pot $0.50 | Rake $0 
Board [Qd 5s Kh 9c]
Seat 1: Mh2r9hTeTEDnh19sRZtW3g folded before Flop (didn't bet)
Seat 3: 4awUyiDYTgylQKXZ9faBVA folded before Flop (didn't bet)
Seat 4: X78b5v/uhqeXXoAijbw/yg (button) folded before Flop (didn't bet)
Seat 6: 3PmVnC/15cl4oyI1TKIt4g (small blind) collected ($0.50)
Seat 8: CvL9Ch1HYCVbTsfpNucitg (big blind) folded on the Turn
Seat 9: tLcDklc2rBORNfixyRfVfw folded before Flop (didn't bet)




PokerStars Game #59941610770:  Hold'em No Limit ($0.10/$0.25) - 2009/07/01 1:40:40 ET
Table 'LXz5SsUCyWcm+4JDJh466A' 9-max Seat #7 is the button
Seat 1: MG90wfSJZnOejs/KD3vlQQ ($25 in chips) 
Seat 2: H5Se03ZqSX7tbULXur2MAg ($23.70 in chips) 
Seat 3: dfNim92Z6XK1/h5SFW5vDg ($25.50 in chips) 
Seat 4: K0b5wNInj6hUGRr6yzKFtw ($28.60 in chips) 
Seat 5: O02ScVDnDZwH6KjZNJZMzA ($4.40 in chips) 
Seat 6: 6RiVTYll/5D8zICp0MRpKw ($26.75 in chips) 
Seat 7: J2a/QHAWUgo6beDRoEyg2g ($13.75 in chips) 
Seat 8: zOHElTcFiTsexeDCkAPYkQ ($25.10 in chips) 
Seat 9: dtZ84flFEi4Q+SGrHMJRDQ ($25 in chips) 
zOHElTcFiTsexeDCkAPYkQ: posts small blind $0.10
dtZ84flFEi4Q+SGrHMJRDQ: posts big blind $0.25
*** HOLE CARDS ***
MG90wfSJZnOejs/KD3vlQQ: folds 
H5Se03ZqSX7tbULXur2MAg: folds 
dfNim92Z6XK1/h5SFW5vDg: folds 
K0b5wNInj6hUGRr6yzKFtw: folds 
O02ScVDnDZwH6KjZNJZMzA: folds 
6RiVTYll/5D8zICp0MRpKw: raises $0.50 to $0.75
J2a/QHAWUgo6beDRoEyg2g: calls $0.75
zOHElTcFiTsexeDCkAPYkQ: raises $1.25 to $2
dtZ84flFEi4Q+SGrHMJRDQ: folds 
6RiVTYll/5D8zICp0MRpKw: calls $1.25
J2a/QHAWUgo6beDRoEyg2g: calls $1.25
*** FLOP *** [2d 3s Qd]
zOHElTcFiTsexeDCkAPYkQ: checks 
6RiVTYll/5D8zICp0MRpKw: checks 
J2a/QHAWUgo6beDRoEyg2g: bets $1.50
zOHElTcFiTsexeDCkAPYkQ: calls $1.50
6RiVTYll/5D8zICp0MRpKw: folds 
*** TURN *** [2d 3s Qd] [Js]
zOHElTcFiTsexeDCkAPYkQ: bets $2.75
J2a/QHAWUgo6beDRoEyg2g: folds 
Uncalled bet ($2.75) returned to zOHElTcFiTsexeDCkAPYkQ
zOHElTcFiTsexeDCkAPYkQ collected $8.85 from pot
zOHElTcFiTsexeDCkAPYkQ: doesn't show hand 
*** SUMMARY ***
Total pot $9.25 | Rake $0.40 
Board [2d 3s Qd Js]
Seat 1: MG90wfSJZnOejs/KD3vlQQ folded before Flop (didn't bet)
Seat 2: H5Se03ZqSX7tbULXur2MAg folded before Flop (didn't bet)
Seat 3: dfNim92Z6XK1/h5SFW5vDg folded before Flop (didn't bet)
Seat 4: K0b5wNInj6hUGRr6yzKFtw folded before Flop (didn't bet)
Seat 5: O02ScVDnDZwH6KjZNJZMzA folded before Flop (didn't bet)
Seat 6: 6RiVTYll/5D8zICp0MRpKw folded on the Flop
Seat 7: J2a/QHAWUgo6beDRoEyg2g (button) folded on the Turn
Seat 8: zOHElTcFiTsexeDCkAPYkQ (small blind) collected ($8.85)
Seat 9: dtZ84flFEi4Q+SGrHMJRDQ (big blind) folded before Flop




PokerStars Game #59941610400:  Hold'em No Limit ($0.10/$0.25) - 2009/07/01 1:40:40 ET
Table 'P1IJQ2p3ACFySC35W1qwQw' 9-max Seat #6 is the button
Seat 1: bXpVeaSTPBFSPJmeXxO7nw ($4.65 in chips) 
Seat 2: vO3QVRovWemcGMkm7ijAIA ($5.70 in chips) 
Seat 3: PVxvfRTRvkgZf9WtquEkwQ ($25.35 in chips) 
Seat 4: c/9X4zftzphFxYtxp5kp9w ($28.15 in chips) 
Seat 5: ghNKXUBl/H+t83JF079ZBA ($56.45 in chips) 
Seat 6: ljemhp25Zg+nlA9DLCIiUw ($64.45 in chips) 
Seat 7: 7je+LC5Mfs6nL8YBVh4frQ ($4.40 in chips) 
Seat 8: tLcDklc2rBORNfixyRfVfw ($26.25 in chips) 
Seat 9: XXajyXkgbSGJKxQP3mal/Q ($15.40 in chips) 
7je+LC5Mfs6nL8YBVh4frQ: posts small blind $0.10
tLcDklc2rBORNfixyRfVfw: posts big blind $0.25
*** HOLE CARDS ***
XXajyXkgbSGJKxQP3mal/Q: calls $0.25
bXpVeaSTPBFSPJmeXxO7nw: folds 
vO3QVRovWemcGMkm7ijAIA: folds 
PVxvfRTRvkgZf9WtquEkwQ: folds 
c/9X4zftzphFxYtxp5kp9w: folds 
ghNKXUBl/H+t83JF079ZBA: folds 
ljemhp25Zg+nlA9DLCIiUw: folds 
7je+LC5Mfs6nL8YBVh4frQ: folds 
tLcDklc2rBORNfixyRfVfw: checks 
*** FLOP *** [Ts Kh 6d]
tLcDklc2rBORNfixyRfVfw: checks 
XXajyXkgbSGJKxQP3mal/Q: bets $0.25
tLcDklc2rBORNfixyRfVfw: folds 
Uncalled bet ($0.25) returned to XXajyXkgbSGJKxQP3mal/Q
XXajyXkgbSGJKxQP3mal/Q collected $0.60 from pot
*** SUMMARY ***
Total pot $0.60 | Rake $0 
Board [Ts Kh 6d]
Seat 1: bXpVeaSTPBFSPJmeXxO7nw folded before Flop (didn't bet)
Seat 2: vO3QVRovWemcGMkm7ijAIA folded before Flop (didn't bet)
Seat 3: PVxvfRTRvkgZf9WtquEkwQ folded before Flop (didn't bet)
Seat 4: c/9X4zftzphFxYtxp5kp9w folded before Flop (didn't bet)
Seat 5: ghNKXUBl/H+t83JF079ZBA folded before Flop (didn't bet)
Seat 6: ljemhp25Zg+nlA9DLCIiUw (button) folded before Flop (didn't bet)
Seat 7: 7je+LC5Mfs6nL8YBVh4frQ (small blind) folded before Flop
Seat 8: tLcDklc2rBORNfixyRfVfw (big blind) folded on the Flop
Seat 9: XXajyXkgbSGJKxQP3mal/Q collected ($0.60)




PokerStars Game #59941610540:  Hold'em No Limit ($0.10/$0.25) - 2009/07/01 1:40:40 ET
Table 'LwnjzXstPtSrqrV/oDpnXQ' 9-max Seat #5 is the button
Seat 1: 9YN2IkT2JYYKFErZtZvCtA ($26.30 in chips) 
Seat 2: uLP/lYn7oKq9xCChBXsXxw ($27 in chips) 
Seat 3: 7je+LC5Mfs6nL8YBVh4frQ ($4.30 in chips) 
Seat 4: CmngQmkKTp8tkl6GMRTl6w ($9.60 in chips) 
Seat 5: Th3FldXKQW6hWVVPahaoOQ ($25 in chips) 
Seat 6: ljemhp25Zg+nlA9DLCIiUw ($41.20 in chips) 
Seat 7: c/Dw/6HyqldTzIRodAIZmg ($12.80 in chips) 
Seat 9: q6WfTUAD9mowIP63ASq2Dgz/khFDKGihQjwgoiKKPOeg45 in chips) 
ljemhp25Zg+nlA9DLCIiUw: posts small blind $0.10
c/Dw/6HyqldTzIRodAIZmg: posts big blind $0.25
*** HOLE CARDS ***
q6WfTUAD9mowIP63ASq2Dgz/khFDKGihQjwgoiKKPOegs 
9YN2IkT2JYYKFErZtZvCtA: folds 
uLP/lYn7oKq9xCChBXsXxw: folds 
7je+LC5Mfs6nL8YBVh4frQ: folds 
CmngQmkKTp8tkl6GMRTl6w: folds 
Th3FldXKQW6hWVVPahaoOQ: folds 
ljemhp25Zg+nlA9DLCIiUw: folds 
Uncalled bet ($0.15) returned to c/Dw/6HyqldTzIRodAIZmg
c/Dw/6HyqldTzIRodAIZmg collected $0.20 from pot
ShXPHWfjhfmAwLgDdm6bRQ joins the table at seat #8 
c/Dw/6HyqldTzIRodAIZmg: doesn't show hand 
*** SUMMARY ***
Total pot $0.20 | Rake $0 
Seat 1: 9YN2IkT2JYYKFErZtZvCtA folded before Flop (didn't bet)
Seat 2: uLP/lYn7oKq9xCChBXsXxw folded before Flop (didn't bet)
Seat 3: 7je+LC5Mfs6nL8YBVh4frQ folded before Flop (didn't bet)
Seat 4: CmngQmkKTp8tkl6GMRTl6w folded before Flop (didn't bet)
Seat 5: Th3FldXKQW6hWVVPahaoOQ (button) folded before Flop (didn't bet)
Seat 6: ljemhp25Zg+nlA9DLCIiUw (small blind) folded before Flop
Seat 7: c/Dw/6HyqldTzIRodAIZmg (big blind) collected ($0.20)
Seat 9: q6WfTUAD9mowIP63ASq2Dgz/khFDKGihQjwgoiKKPOegd before Flop (didn't bet)




PokerStars Game #59941610546:  Hold'em No Limit ($0.10/$0.25) - 2009/07/01 1:40:40 ET
Table 'VuY5ej47Cy8nOI3Wogmhzw' 6-max Seat #3 is the button
Seat 1: EeUZtMU058v2ObUACOF4Og ($25.95 in chips) 
Seat 2: AM6Yl+3esmhhMBlSnQhWbg ($16 in chips) 
Seat 3: v+QfkGiuj9bgtuNoVnDO8w ($31.50 in chips) 
Seat 4: aXzjpue4eAQBqMdp87D3ZA ($13.70 in chips) 
Seat 5: iK/41//HmnLiIn0CVNNfyA ($12.30 in chips) 
aXzjpue4eAQBqMdp87D3ZA: posts small blind $0.10
iK/41//HmnLiIn0CVNNfyA: posts big blind $0.25
*** HOLE CARDS ***
EeUZtMU058v2ObUACOF4Og: raises $0.50 to $0.75
AM6Yl+3esmhhMBlSnQhWbg: folds 
v+QfkGiuj9bgtuNoVnDO8w: folds 
aXzjpue4eAQBqMdp87D3ZA: calls $0.65
iK/41//HmnLiIn0CVNNfyA: folds 
*** FLOP *** [5d 2h 7d]
aXzjpue4eAQBqMdp87D3ZA: checks 
EeUZtMU058v2ObUACOF4Og: bets $1.75
aXzjpue4eAQBqMdp87D3ZA: calls $1.75
*** TURN *** [5d 2h 7d] [Jh]
aXzjpue4eAQBqMdp87D3ZA: checks 
EeUZtMU058v2ObUACOF4Og: bets $6
aXzjpue4eAQBqMdp87D3ZA: calls $6
*** RIVER *** [5d 2h 7d Jh] [Ac]
aXzjpue4eAQBqMdp87D3ZA: bets $1
EeUZtMU058v2ObUACOF4Og: raises $5 to $6
aXzjpue4eAQBqMdp87D3ZA: calls $4.20 and is all-in
Uncalled bet ($0.80) returned to EeUZtMU058v2ObUACOF4Og
*** SHOW DOWN ***
EeUZtMU058v2ObUACOF4Og: shows [8c 7c] (a pair of Sevens)
aXzjpue4eAQBqMdp87D3ZA: mucks hand 
EeUZtMU058v2ObUACOF4Og collected $26.35 from pot
*** SUMMARY ***
Total pot $27.65 | Rake $1.30 
Board [5d 2h 7d Jh Ac]
Seat 1: EeUZtMU058v2ObUACOF4Og showed [8c 7c] and won ($26.35) with a pair of Sevens
Seat 2: AM6Yl+3esmhhMBlSnQhWbg folded before Flop (didn't bet)
Seat 3: v+QfkGiuj9bgtuNoVnDO8w (button) folded before Flop (didn't bet)
Seat 4: aXzjpue4eAQBqMdp87D3ZA (small blind) mucked
Seat 5: iK/41//HmnLiIn0CVNNfyA (big blind) folded before Flop




PokerStars Game #59941611412:  Hold'em No Limit ($0.10/$0.25) - 2009/07/01 1:40:41 ET
Table 'dVzscin98UhGisTmV9BDcw' 9-max Seat #4 is the button
Seat 1: sBAwXpkpgyhyWbHIQcIJKA ($17.90 in chips) 
Seat 2: dfNim92Z6XK1/h5SFW5vDg ($28.25 in chips) 
Seat 4: aNpwfA31EREwO+ar4XzBCw ($41.55 in chips) 
Seat 5: 22dIObOuor/A+IKWkNoAlA ($10.20 in chips) 
Seat 6: bXpVeaSTPBFSPJmeXxO7nw ($4.65 in chips) 
Seat 7: cKlmpQMahVsmOaxFQDcoOg ($25 in chips) 
Seat 8: /vn2Qu2dvc9AMMq46Ae0jA ($48.10 in chips) 
Seat 9: arxNSjreDRGFg13EAM2F1w ($25 in chips) 
22dIObOuor/A+IKWkNoAlA: posts small blind $0.10
bXpVeaSTPBFSPJmeXxO7nw: posts big blind $0.25
*** HOLE CARDS ***
cKlmpQMahVsmOaxFQDcoOg: folds 
/vn2Qu2dvc9AMMq46Ae0jA: folds 
arxNSjreDRGFg13EAM2F1w: folds 
sBAwXpkpgyhyWbHIQcIJKA: folds 
dfNim92Z6XK1/h5SFW5vDg: folds 
aNpwfA31EREwO+ar4XzBCw: raises $0.75 to $1
22dIObOuor/A+IKWkNoAlA: folds 
bXpVeaSTPBFSPJmeXxO7nw: folds 
Uncalled bet ($0.75) returned to aNpwfA31EREwO+ar4XzBCw
aNpwfA31EREwO+ar4XzBCw collected $0.60 from pot
aNpwfA31EREwO+ar4XzBCw: doesn't show hand 
*** SUMMARY ***
Total pot $0.60 | Rake $0 
Seat 1: sBAwXpkpgyhyWbHIQcIJKA folded before Flop (didn't bet)
Seat 2: dfNim92Z6XK1/h5SFW5vDg folded before Flop (didn't bet)
Seat 4: aNpwfA31EREwO+ar4XzBCw (button) collected ($0.60)
Seat 5: 22dIObOuor/A+IKWkNoAlA (small blind) folded before Flop
Seat 6: bXpVeaSTPBFSPJmeXxO7nw (big blind) folded before Flop
Seat 7: cKlmpQMahVsmOaxFQDcoOg folded before Flop (didn't bet)
Seat 8: /vn2Qu2dvc9AMMq46Ae0jA folded before Flop (didn't bet)
Seat 9: arxNSjreDRGFg13EAM2F1w folded before Flop (didn't bet)




PokerStars Game #59941610822:  Hold'em No Limit ($0.10/$0.25) - 2009/07/01 1:40:41 ET
Table 'KU/HrxqxwDz8HKEhYTZ6uw' 6-max Seat #4 is the button
Seat 1: 7LKoiQHXpTQXJvWQrw907g ($30.25 in chips) 
Seat 2: kG34n23qFQA3nzdOJTQ1dA ($22.10 in chips) 
Seat 3: SFmT9ZsVopnukjvAzrxTRg ($25.80 in chips) 
Seat 4: AGwMM0FUhYZf81+oXvYQMg ($24.90 in chips) 
Seat 5: iyZxqznXjv3vtvOJymkoLQ ($51 in chips) 
Seat 6: qWxkCeqApAWdAA0evrfDvQ ($17.70 in chips) 
iyZxqznXjv3vtvOJymkoLQ: posts small blind $0.10
qWxkCeqApAWdAA0evrfDvQ: posts big blind $0.25
*** HOLE CARDS ***
7LKoiQHXpTQXJvWQrw907g: calls $0.25
kG34n23qFQA3nzdOJTQ1dA: folds 
SFmT9ZsVopnukjvAzrxTRg: folds 
AGwMM0FUhYZf81+oXvYQMg: folds 
iyZxqznXjv3vtvOJymkoLQ: folds 
qWxkCeqApAWdAA0evrfDvQ: raises $0.75 to $1
7LKoiQHXpTQXJvWQrw907g: folds 
Uncalled bet ($0.75) returned to qWxkCeqApAWdAA0evrfDvQ
qWxkCeqApAWdAA0evrfDvQ collected $0.60 from pot
*** SUMMARY ***
Total pot $0.60 | Rake $0 
Seat 1: 7LKoiQHXpTQXJvWQrw907g folded before Flop
Seat 2: kG34n23qFQA3nzdOJTQ1dA folded before Flop (didn't bet)
Seat 3: SFmT9ZsVopnukjvAzrxTRg folded before Flop (didn't bet)
Seat 4: AGwMM0FUhYZf81+oXvYQMg (button) folded before Flop (didn't bet)
Seat 5: iyZxqznXjv3vtvOJymkoLQ (small blind) folded before Flop
Seat 6: qWxkCeqApAWdAA0evrfDvQ (big blind) collected ($0.60)




PokerStars Game #59941611316:  Hold'em No Limit ($0.10/$0.25) - 2009/07/01 1:40:41 ET
Table 'edvgY2YQ1I34euq4EVqGnA' 6-max Seat #6 is the button
Seat 1: mvFHK3pE7tCxJEqLjKC70Q ($25.35 in chips) 
Seat 2: SxIIgwXYLkwd6m3wLyPTCw ($16.25 in chips) 
Seat 3: mFv3iBCtrw9XfCDRB0d46Q ($3.90 in chips) 
Seat 4: TI/C5Q+DEl4fLR3AofwYdg ($20.30 in chips) 
Seat 5: EE16Ua5b1HSsYej5zeXOlA ($54.75 in chips) 
Seat 6: kG34n23qFQA3nzdOJTQ1dA ($72.35 in chips) 
mvFHK3pE7tCxJEqLjKC70Q: posts small blind $0.10
SxIIgwXYLkwd6m3wLyPTCw: posts big blind $0.25
*** HOLE CARDS ***
mFv3iBCtrw9XfCDRB0d46Q: folds 
TI/C5Q+DEl4fLR3AofwYdg: raises $0.50 to $0.75
EE16Ua5b1HSsYej5zeXOlA: folds 
kG34n23qFQA3nzdOJTQ1dA: folds 
mvFHK3pE7tCxJEqLjKC70Q: folds 
SxIIgwXYLkwd6m3wLyPTCw: folds 
Uncalled bet ($0.50) returned to TI/C5Q+DEl4fLR3AofwYdg
TI/C5Q+DEl4fLR3AofwYdg collected $0.60 from pot
TI/C5Q+DEl4fLR3AofwYdg: doesn't show hand 
*** SUMMARY ***
Total pot $0.60 | Rake $0 
Seat 1: mvFHK3pE7tCxJEqLjKC70Q (small blind) folded before Flop
Seat 2: SxIIgwXYLkwd6m3wLyPTCw (big blind) folded before Flop
Seat 3: mFv3iBCtrw9XfCDRB0d46Q folded before Flop (didn't bet)
Seat 4: TI/C5Q+DEl4fLR3AofwYdg collected ($0.60)
Seat 5: EE16Ua5b1HSsYej5zeXOlA folded before Flop (didn't bet)
Seat 6: kG34n23qFQA3nzdOJTQ1dA (button) folded before Flop (didn't bet)




PokerStars Game #59941611992:  Hold'em No Limit ($0.10/$0.25) - 2009/07/01 1:40:42 ET
Table 'zW+7jPbOLCvlPu+dUGY5WQ' 6-max Seat #4 is the button
Seat 1: eL3+wCBjFGfQ5FMdIZihwA ($25 in chips) 
Seat 2: cEMJmfAUQZmMChZe6aacKw ($8 in chips) 
Seat 3: 2G0C7dp4wlPpE21FHjjElQ ($32.85 in chips) 
Seat 4: i48129QFpEQQ+UN4aNtmww ($10.85 in chips) 
Seat 5: 5nwDw10uIM0XEyLhla0oGA ($41.55 in chips) 
Seat 6: qGHGf/553gQnDoklMRe3tg ($25 in chips) 
5nwDw10uIM0XEyLhla0oGA: posts small blind $0.10
qGHGf/553gQnDoklMRe3tg: posts big blind $0.25
*** HOLE CARDS ***
eL3+wCBjFGfQ5FMdIZihwA: folds 
cEMJmfAUQZmMChZe6aacKw: raises $0.50 to $0.75
2G0C7dp4wlPpE21FHjjElQ: folds 
i48129QFpEQQ+UN4aNtmww: folds 
5nwDw10uIM0XEyLhla0oGA: calls $0.65
qGHGf/553gQnDoklMRe3tg: folds 
*** FLOP *** [5d 4s Jc]
5nwDw10uIM0XEyLhla0oGA: checks 
cEMJmfAUQZmMChZe6aacKw: bets $1
5nwDw10uIM0XEyLhla0oGA: folds 
Uncalled bet ($1) returned to cEMJmfAUQZmMChZe6aacKw
cEMJmfAUQZmMChZe6aacKw collected $1.70 from pot
*** SUMMARY ***
Total pot $1.75 | Rake $0.05 
Board [5d 4s Jc]
Seat 1: eL3+wCBjFGfQ5FMdIZihwA folded before Flop (didn't bet)
Seat 2: cEMJmfAUQZmMChZe6aacKw collected ($1.70)
Seat 3: 2G0C7dp4wlPpE21FHjjElQ folded before Flop (didn't bet)
Seat 4: i48129QFpEQQ+UN4aNtmww (button) folded before Flop (didn't bet)
Seat 5: 5nwDw10uIM0XEyLhla0oGA (small blind) folded on the Flop
Seat 6: qGHGf/553gQnDoklMRe3tg (big blind) folded before Flop




PokerStars Game #59941611736:  Hold'em No Limit ($0.10/$0.25) - 2009/07/01 1:40:42 ET
Table 'YONIZZNvg4uZ4xNUO1deeA' 6-max Seat #6 is the button
Seat 1: GbCVUNssQ7mqsPWr7J4d3w ($4.75 in chips) 
Seat 2: evMMX/0gSDH791KdSAOaSg ($5.35 in chips) 
Seat 3: Eksrep3hySi2jeDHuaWiOQ ($8.55 in chips) 
Seat 4: oNAHfBJOUelvVhf0IDMJUA ($26.90 in chips) 
Seat 5: if4dh6jhJXeN3/qd3qCp9g ($25.35 in chips) 
Seat 6: eL3+wCBjFGfQ5FMdIZihwA ($24.90 in chips) 
GbCVUNssQ7mqsPWr7J4d3w: posts small blind $0.10
evMMX/0gSDH791KdSAOaSg: posts big blind $0.25
*** HOLE CARDS ***
Eksrep3hySi2jeDHuaWiOQ: raises $0.25 to $0.50
oNAHfBJOUelvVhf0IDMJUA: calls $0.50
if4dh6jhJXeN3/qd3qCp9g: folds 
eL3+wCBjFGfQ5FMdIZihwA: calls $0.50
GbCVUNssQ7mqsPWr7J4d3w: folds 
evMMX/0gSDH791KdSAOaSg: calls $0.25
*** FLOP *** [7h Kh 5c]
evMMX/0gSDH791KdSAOaSg: checks 
Eksrep3hySi2jeDHuaWiOQ: checks 
oNAHfBJOUelvVhf0IDMJUA: checks 
eL3+wCBjFGfQ5FMdIZihwA: checks 
*** TURN *** [7h Kh 5c] [8d]
evMMX/0gSDH791KdSAOaSg: checks 
Eksrep3hySi2jeDHuaWiOQ: checks 
oNAHfBJOUelvVhf0IDMJUA: bets $0.50
eL3+wCBjFGfQ5FMdIZihwA: calls $0.50
evMMX/0gSDH791KdSAOaSg: folds 
Eksrep3hySi2jeDHuaWiOQ: calls $0.50
*** RIVER *** [7h Kh 5c 8d] [3d]
Eksrep3hySi2jeDHuaWiOQ: checks 
oNAHfBJOUelvVhf0IDMJUA: checks 
eL3+wCBjFGfQ5FMdIZihwA: checks 
*** SHOW DOWN ***
Eksrep3hySi2jeDHuaWiOQ: shows [8c Ah] (a pair of Eights)
oNAHfBJOUelvVhf0IDMJUA: mucks hand 
eL3+wCBjFGfQ5FMdIZihwA: mucks hand 
Eksrep3hySi2jeDHuaWiOQ collected $3.45 from pot
*** SUMMARY ***
Total pot $3.60 | Rake $0.15 
Board [7h Kh 5c 8d 3d]
Seat 1: GbCVUNssQ7mqsPWr7J4d3w (small blind) folded before Flop
Seat 2: evMMX/0gSDH791KdSAOaSg (big blind) folded on the Turn
Seat 3: Eksrep3hySi2jeDHuaWiOQ showed [8c Ah] and won ($3.45) with a pair of Eights
Seat 4: oNAHfBJOUelvVhf0IDMJUA mucked
Seat 5: if4dh6jhJXeN3/qd3qCp9g folded before Flop (didn't bet)
Seat 6: eL3+wCBjFGfQ5FMdIZihwA (button) mucked




PokerStars Game #59941611470:  Hold'em No Limit ($0.10/$0.25) - 2009/07/01 1:40:42 ET
Table 'Pz8SfAzhP5nvWTsJRAxoDg' 6-max Seat #1 is the button
Seat 1: QiL+lEgEWwy21jk/ltaRLg ($25.95 in chips) 
Seat 2: xrf8tAXKQHG99HixCot1Iw ($25.25 in chips) 
Seat 3: mfrkWA3PTeYPkbO6hi98Aw ($28.20 in chips) 
Seat 4: 4lJto+Qj0K4JrFKvHaPTLw ($34.40 in chips) 
Seat 5: FYepjhAvF8ZdVCmqHIy+eQ ($63.15 in chips) 
Seat 6: QvTX2yGq3uKJiKPmns4TKQ ($24.65 in chips) 
xrf8tAXKQHG99HixCot1Iw: posts small blind $0.10
mfrkWA3PTeYPkbO6hi98Aw: posts big blind $0.25
*** HOLE CARDS ***
4lJto+Qj0K4JrFKvHaPTLw: raises $0.75 to $1
FYepjhAvF8ZdVCmqHIy+eQ: raises $2 to $3
QvTX2yGq3uKJiKPmns4TKQ: folds 
QiL+lEgEWwy21jk/ltaRLg: folds 
xrf8tAXKQHG99HixCot1Iw: folds 
mfrkWA3PTeYPkbO6hi98Aw: folds 
4lJto+Qj0K4JrFKvHaPTLw: calls $2
*** FLOP *** [2s 3s 5c]
4lJto+Qj0K4JrFKvHaPTLw: checks 
FYepjhAvF8ZdVCmqHIy+eQ: bets $4
4lJto+Qj0K4JrFKvHaPTLw: calls $4
*** TURN *** [2s 3s 5c] [6h]
4lJto+Qj0K4JrFKvHaPTLw: bets $6
FYepjhAvF8ZdVCmqHIy+eQ: calls $6
*** RIVER *** [2s 3s 5c 6h] [3h]
4lJto+Qj0K4JrFKvHaPTLw: bets $21.40 and is all-in
FYepjhAvF8ZdVCmqHIy+eQ: calls $21.40
*** SHOW DOWN ***
4lJto+Qj0K4JrFKvHaPTLw: shows [4s 4c] (a straight, Deuce to Six)
FYepjhAvF8ZdVCmqHIy+eQ: mucks hand 
4lJto+Qj0K4JrFKvHaPTLw collected $66.15 from pot
*** SUMMARY ***
Total pot $69.15 | Rake $3 
Board [2s 3s 5c 6h 3h]
Seat 1: QiL+lEgEWwy21jk/ltaRLg (button) folded before Flop (didn't bet)
Seat 2: xrf8tAXKQHG99HixCot1Iw (small blind) folded before Flop
Seat 3: mfrkWA3PTeYPkbO6hi98Aw (big blind) folded before Flop
Seat 4: 4lJto+Qj0K4JrFKvHaPTLw showed [4s 4c] and won ($66.15) with a straight, Deuce to Six
Seat 5: FYepjhAvF8ZdVCmqHIy+eQ mucked
Seat 6: QvTX2yGq3uKJiKPmns4TKQ folded before Flop (didn't bet)




PokerStars Game #59941611822:  Hold'em No Limit ($0.10/$0.25) - 2009/07/01 1:40:42 ET
Table 'sgdCtiuCu2BDZhyDi6RzTA' 6-max Seat #5 is the button
Seat 1: 3zD3qLXT1bEffAoWGnc7wg ($31.55 in chips) 
Seat 2: XD1i5m5PvBDnRzJaG/vINw ($24.40 in chips) 
Seat 3: eL3+wCBjFGfQ5FMdIZihwA ($26.35 in chips) 
Seat 4: rVKEgilmMX+EkKzDVvhmxA ($9.70 in chips) 
Seat 5: 0tQitW75xfmVWKldYHjmOQ ($6.15 in chips) 
Seat 6: KODslGU8ikCYS0/29dUkhg ($32.60 in chips) 
KODslGU8ikCYS0/29dUkhg: posts small blind $0.10
3zD3qLXT1bEffAoWGnc7wg: posts big blind $0.25
*** HOLE CARDS ***
XD1i5m5PvBDnRzJaG/vINw: folds 
eL3+wCBjFGfQ5FMdIZihwA: folds 
rVKEgilmMX+EkKzDVvhmxA: calls $0.25
0tQitW75xfmVWKldYHjmOQ: calls $0.25
KODslGU8ikCYS0/29dUkhg: calls $0.15
3zD3qLXT1bEffAoWGnc7wg: checks 
*** FLOP *** [5s 7c 4s]
KODslGU8ikCYS0/29dUkhg: checks 
3zD3qLXT1bEffAoWGnc7wg: checks 
rVKEgilmMX+EkKzDVvhmxA: checks 
0tQitW75xfmVWKldYHjmOQ: bets $0.75
KODslGU8ikCYS0/29dUkhg: calls $0.75
3zD3qLXT1bEffAoWGnc7wg: folds 
rVKEgilmMX+EkKzDVvhmxA: folds 
*** TURN *** [5s 7c 4s] [Kh]
KODslGU8ikCYS0/29dUkhg: checks 
0tQitW75xfmVWKldYHjmOQ: bets $1.50
KODslGU8ikCYS0/29dUkhg: raises $1.50 to $3
0tQitW75xfmVWKldYHjmOQ: folds 
Uncalled bet ($1.50) returned to KODslGU8ikCYS0/29dUkhg
KODslGU8ikCYS0/29dUkhg collected $5.25 from pot
*** SUMMARY ***
Total pot $5.50 | Rake $0.25 
Board [5s 7c 4s Kh]
Seat 1: 3zD3qLXT1bEffAoWGnc7wg (big blind) folded on the Flop
Seat 2: XD1i5m5PvBDnRzJaG/vINw folded before Flop (didn't bet)
Seat 3: eL3+wCBjFGfQ5FMdIZihwA folded before Flop (didn't bet)
Seat 4: rVKEgilmMX+EkKzDVvhmxA folded on the Flop
Seat 5: 0tQitW75xfmVWKldYHjmOQ (button) folded on the Turn
Seat 6: KODslGU8ikCYS0/29dUkhg (small blind) collected ($5.25)




PokerStars Game #59941611880:  Hold'em No Limit ($0.10/$0.25) - 2009/07/01 1:40:42 ET
Table 'Mef6A0EMopL6WaFO5/KO9g' 6-max Seat #3 is the button
Seat 1: GbCVUNssQ7mqsPWr7J4d3w ($4.65 in chips) 
Seat 2: 8ClCHtFXGNplITm+63KB+Q ($32.65 in chips) 
Seat 3: Wq26opBLDGJe91GRJn2epg ($11.35 in chips) 
Seat 4: lquriepNQBhDV5P1SWHhnA ($25.55 in chips) 
Seat 5: DihMHaz4WNETH1bPDe13kA ($25 in chips) 
Seat 6: jp34e617tIzV8tKIWmfAbA ($33.65 in chips) 
lquriepNQBhDV5P1SWHhnA: posts small blind $0.10
DihMHaz4WNETH1bPDe13kA: posts big blind $0.25
*** HOLE CARDS ***
jp34e617tIzV8tKIWmfAbA: folds 
GbCVUNssQ7mqsPWr7J4d3w: folds 
8ClCHtFXGNplITm+63KB+Q: folds 
Wq26opBLDGJe91GRJn2epg: raises $0.50 to $0.75
lquriepNQBhDV5P1SWHhnA: calls $0.65
DihMHaz4WNETH1bPDe13kA: folds 
*** FLOP *** [2h 2c Ts]
lquriepNQBhDV5P1SWHhnA: checks 
Wq26opBLDGJe91GRJn2epg: bets $1
lquriepNQBhDV5P1SWHhnA: folds 
Uncalled bet ($1) returned to Wq26opBLDGJe91GRJn2epg
Wq26opBLDGJe91GRJn2epg collected $1.70 from pot
Wq26opBLDGJe91GRJn2epg: doesn't show hand 
*** SUMMARY ***
Total pot $1.75 | Rake $0.05 
Board [2h 2c Ts]
Seat 1: GbCVUNssQ7mqsPWr7J4d3w folded before Flop (didn't bet)
Seat 2: 8ClCHtFXGNplITm+63KB+Q folded before Flop (didn't bet)
Seat 3: Wq26opBLDGJe91GRJn2epg (button) collected ($1.70)
Seat 4: lquriepNQBhDV5P1SWHhnA (small blind) folded on the Flop
Seat 5: DihMHaz4WNETH1bPDe13kA (big blind) folded before Flop
Seat 6: jp34e617tIzV8tKIWmfAbA folded before Flop (didn't bet)




PokerStars Game #59941611936:  Hold'em No Limit ($0.10/$0.25) - 2009/07/01 1:40:42 ET
Table 'SbSV5tlgLp0+/Z+13PW3Hg' 9-max Seat #2 is the button
Seat 1: x+W5+3qsdY4Iszf0hoH+Aw ($14.85 in chips) 
Seat 2: zDrucyjVn5aeekNEc3cJrA ($13.80 in chips) 
Seat 3: CT7Xj/V/O5rBlhtt+RZeFQ ($25 in chips) 
Seat 4: puj3K/wrNjEj86ZL/MyfLA ($10.85 in chips) 
Seat 7: ruosoLPCzPyA3nfXoPVY3Q ($1.35 in chips) 
Seat 8: qBdqLaJhO+1itcMk70bsfA ($8.90 in chips) 
Seat 9: X78b5v/uhqeXXoAijbw/yg ($25 in chips) 
CT7Xj/V/O5rBlhtt+RZeFQ: posts small blind $0.10
puj3K/wrNjEj86ZL/MyfLA: posts big blind $0.25
aNpwfA31EREwO+ar4XzBCw: sits out 
pN3IHvAKm2fz+sTRARTcrg: sits out 
*** HOLE CARDS ***
ruosoLPCzPyA3nfXoPVY3Q: folds 
qBdqLaJhO+1itcMk70bsfA: folds 
X78b5v/uhqeXXoAijbw/yg: folds 
x+W5+3qsdY4Iszf0hoH+Aw: folds 
zDrucyjVn5aeekNEc3cJrA: folds 
zDrucyjVn5aeekNEc3cJrA is sitting out
CT7Xj/V/O5rBlhtt+RZeFQ: folds 
Uncalled bet ($0.15) returned to puj3K/wrNjEj86ZL/MyfLA
puj3K/wrNjEj86ZL/MyfLA collected $0.20 from pot
puj3K/wrNjEj86ZL/MyfLA: doesn't show hand 
*** SUMMARY ***
Total pot $0.20 | Rake $0 
Seat 1: x+W5+3qsdY4Iszf0hoH+Aw folded before Flop (didn't bet)
Seat 2: zDrucyjVn5aeekNEc3cJrA (button) folded before Flop (didn't bet)
Seat 3: CT7Xj/V/O5rBlhtt+RZeFQ (small blind) folded before Flop
Seat 4: puj3K/wrNjEj86ZL/MyfLA (big blind) collected ($0.20)
Seat 7: ruosoLPCzPyA3nfXoPVY3Q folded before Flop (didn't bet)
Seat 8: qBdqLaJhO+1itcMk70bsfA folded before Flop (didn't bet)
Seat 9: X78b5v/uhqeXXoAijbw/yg folded before Flop (didn't bet)




PokerStars Game #59941611420:  Hold'em No Limit ($0.10/$0.25) - 2009/07/01 1:40:42 ET
Table '4ZbiE0ZYjzqmgu6+sO1prg' 9-max Seat #6 is the button
Seat 1: eXiRSFoUjkV5taBc4N8rMQ ($8.75 in chips) 
Seat 2: 9lvO/qyU+xrU95Teu1fv0g ($5.55 in chips) 
Seat 3: HPEB+AtKw1+C/cxU0o1ciw ($25.55 in chips) 
Seat 4: w1ukf8uPa4+WH561TtVRxA ($25 in chips) 
Seat 5: +2kMBNpY4nF1qNCRd8SJLA ($43.95 in chips) 
Seat 6: UmzixCpC0bAc1lDEjgB3NQ ($10.25 in chips) 
Seat 7: aNpwfA31EREwO+ar4XzBCw ($25.45 in chips) 
Seat 8: cZ99hugmLBj9KhTlc8nCSw ($29.95 in chips) 
aNpwfA31EREwO+ar4XzBCw: posts small blind $0.10
cZ99hugmLBj9KhTlc8nCSw: posts big blind $0.25
RCqMONFrSPSArZh2Jsar/w: sits out 
*** HOLE CARDS ***
eXiRSFoUjkV5taBc4N8rMQ: folds 
9lvO/qyU+xrU95Teu1fv0g: folds 
HPEB+AtKw1+C/cxU0o1ciw: folds 
w1ukf8uPa4+WH561TtVRxA: folds 
+2kMBNpY4nF1qNCRd8SJLA: folds 
UmzixCpC0bAc1lDEjgB3NQ: calls $0.25
aNpwfA31EREwO+ar4XzBCw: calls $0.15
cZ99hugmLBj9KhTlc8nCSw: checks 
*** FLOP *** [Kd 9h Js]
aNpwfA31EREwO+ar4XzBCw: checks 
cZ99hugmLBj9KhTlc8nCSw: checks 
UmzixCpC0bAc1lDEjgB3NQ: folds 
*** TURN *** [Kd 9h Js] [8s]
UmzixCpC0bAc1lDEjgB3NQ is sitting out
aNpwfA31EREwO+ar4XzBCw: checks 
cZ99hugmLBj9KhTlc8nCSw: checks 
*** RIVER *** [Kd 9h Js 8s] [7c]
aNpwfA31EREwO+ar4XzBCw: bets $0.50
cZ99hugmLBj9KhTlc8nCSw: folds 
Uncalled bet ($0.50) returned to aNpwfA31EREwO+ar4XzBCw
aNpwfA31EREwO+ar4XzBCw collected $0.75 from pot
aNpwfA31EREwO+ar4XzBCw: doesn't show hand 
*** SUMMARY ***
Total pot $0.75 | Rake $0 
Board [Kd 9h Js 8s 7c]
Seat 1: eXiRSFoUjkV5taBc4N8rMQ folded before Flop (didn't bet)
Seat 2: 9lvO/qyU+xrU95Teu1fv0g folded before Flop (didn't bet)
Seat 3: HPEB+AtKw1+C/cxU0o1ciw folded before Flop (didn't bet)
Seat 4: w1ukf8uPa4+WH561TtVRxA folded before Flop (didn't bet)
Seat 5: +2kMBNpY4nF1qNCRd8SJLA folded before Flop (didn't bet)
Seat 6: UmzixCpC0bAc1lDEjgB3NQ (button) folded on the Flop
Seat 7: aNpwfA31EREwO+ar4XzBCw (small blind) collected ($0.75)
Seat 8: cZ99hugmLBj9KhTlc8nCSw (big blind) folded on the River




PokerStars Game #59941611518:  Hold'em No Limit ($0.10/$0.25) - 2009/07/01 1:40:42 ET
Table '1HT8bEDpLPhOXxmqMtzF8w' 9-max Seat #2 is the button
Seat 1: YkkKQUDI0iWatY4h0WWaAQ ($11.20 in chips) 
Seat 2: r6hsffOo1iKmaPYKwAZmFw ($29 in chips) 
Seat 3: oLa/tXLfSLLB28mcLGrxcg ($24.85 in chips) 
Seat 4: aNpwfA31EREwO+ar4XzBCw ($25.35 in chips) 
Seat 5: CT2YIt3dXaE9eOIkS7FwNw ($24.65 in chips) 
Seat 7: PMhmqYBPHOAXjH25lRz69g ($21.05 in chips) 
Seat 8: ghNKXUBl/H+t83JF079ZBA ($25 in chips) 
Seat 9: a2TmTivbjy207qYNGTay8g ($4.35 in chips) 
oLa/tXLfSLLB28mcLGrxcg: posts small blind $0.10
aNpwfA31EREwO+ar4XzBCw: posts big blind $0.25
bXpVeaSTPBFSPJmeXxO7nw: sits out 
*** HOLE CARDS ***
CT2YIt3dXaE9eOIkS7FwNw: folds 
PMhmqYBPHOAXjH25lRz69g: folds 
ghNKXUBl/H+t83JF079ZBA: raises $0.75 to $1
a2TmTivbjy207qYNGTay8g: raises $3.35 to $4.35 and is all-in
YkkKQUDI0iWatY4h0WWaAQ: folds 
r6hsffOo1iKmaPYKwAZmFw: folds 
oLa/tXLfSLLB28mcLGrxcg: folds 
aNpwfA31EREwO+ar4XzBCw: folds 
ghNKXUBl/H+t83JF079ZBA: calls $3.35
*** FLOP *** [3c Qd 4c]
*** TURN *** [3c Qd 4c] [6d]
*** RIVER *** [3c Qd 4c 6d] [Ad]
*** SHOW DOWN ***
ghNKXUBl/H+t83JF079ZBA: shows [Kc Ah] (a pair of Aces)
a2TmTivbjy207qYNGTay8g: mucks hand 
ghNKXUBl/H+t83JF079ZBA collected $8.60 from pot
a2TmTivbjy207qYNGTay8g leaves the table
*** SUMMARY ***
Total pot $9.05 | Rake $0.45 
Board [3c Qd 4c 6d Ad]
Seat 1: YkkKQUDI0iWatY4h0WWaAQ folded before Flop (didn't bet)
Seat 2: r6hsffOo1iKmaPYKwAZmFw (button) folded before Flop (didn't bet)
Seat 3: oLa/tXLfSLLB28mcLGrxcg (small blind) folded before Flop
Seat 4: aNpwfA31EREwO+ar4XzBCw (big blind) folded before Flop
Seat 5: CT2YIt3dXaE9eOIkS7FwNw folded before Flop (didn't bet)
Seat 7: PMhmqYBPHOAXjH25lRz69g folded before Flop (didn't bet)
Seat 8: ghNKXUBl/H+t83JF079ZBA showed [Kc Ah] and won ($8.60) with a pair of Aces
Seat 9: a2TmTivbjy207qYNGTay8g mucked




PokerStars Game #59941611594:  Hold'em No Limit ($0.10/$0.25) - 2009/07/01 1:40:42 ET
Table 'pyZQRcpxhWj2y2cT/ydvww52Meibn9NOL4XtVi1p2Upwx Seat #9 is the button
Seat 1: egvg3mTBBVzMHnJPIQiKcA ($16.40 in chips) 
Seat 2: Th3FldXKQW6hWVVPahaoOQ ($98.45 in chips) 
Seat 3: zgi+EUykT/pZQpoUG6+oEg ($4.65 in chips) 
Seat 4: NjesyqE7PJi4nEOa0oOq9w ($16.10 in chips) 
Seat 5: 5n7e7I+px7c6CQmLpPbtsg ($4.75 in chips) 
Seat 6: 4awUyiDYTgylQKXZ9faBVA ($31.45 in chips) 
Seat 7: sGFnnRCa1YAHAUmWgsW6Qg ($9.50 in chips) 
Seat 8: ipgcO7Pa6LC8XWpVttZfnA ($5 in chips) 
Seat 9: bC+Wg1ntzw3N48OwuR1eag ($7.75 in chips) 
egvg3mTBBVzMHnJPIQiKcA: posts small blind $0.10
Th3FldXKQW6hWVVPahaoOQ: posts big blind $0.25
*** HOLE CARDS ***
zgi+EUykT/pZQpoUG6+oEg: folds 
NjesyqE7PJi4nEOa0oOq9w: folds 
5n7e7I+px7c6CQmLpPbtsg: raises $0.75 to $1
4awUyiDYTgylQKXZ9faBVA: folds 
sGFnnRCa1YAHAUmWgsW6Qg: folds 
ipgcO7Pa6LC8XWpVttZfnA: folds 
bC+Wg1ntzw3N48OwuR1eag: calls $1
egvg3mTBBVzMHnJPIQiKcA: folds 
Th3FldXKQW6hWVVPahaoOQ: folds 
*** FLOP *** [5c 7s 7h]
5n7e7I+px7c6CQmLpPbtsg: bets $1.90
bC+Wg1ntzw3N48OwuR1eag: calls $1.90
*** TURN *** [5c 7s 7h] [5h]
5n7e7I+px7c6CQmLpPbtsg: checks 
bC+Wg1ntzw3N48OwuR1eag: checks 
*** RIVER *** [5c 7s 7h 5h] [7d]
5n7e7I+px7c6CQmLpPbtsg: bets $1.85 and is all-in
bC+Wg1ntzw3N48OwuR1eag: calls $1.85
*** SHOW DOWN ***
5n7e7I+px7c6CQmLpPbtsg: shows [Qs Ac] (a full house, Sevens full of Fives)
bC+Wg1ntzw3N48OwuR1eag: shows [3c Tc] (a full house, Sevens full of Fives)
5n7e7I+px7c6CQmLpPbtsg collected $4.70 from pot
bC+Wg1ntzw3N48OwuR1eag collected $4.70 from pot
*** SUMMARY ***
Total pot $9.85 | Rake $0.45 
Board [5c 7s 7h 5h 7d]
Seat 1: egvg3mTBBVzMHnJPIQiKcA (small blind) folded before Flop
Seat 2: Th3FldXKQW6hWVVPahaoOQ (big blind) folded before Flop
Seat 3: zgi+EUykT/pZQpoUG6+oEg folded before Flop (didn't bet)
Seat 4: NjesyqE7PJi4nEOa0oOq9w folded before Flop (didn't bet)
Seat 5: 5n7e7I+px7c6CQmLpPbtsg showed [Qs Ac] and won ($4.70) with a full house, Sevens full of Fives
Seat 6: 4awUyiDYTgylQKXZ9faBVA folded before Flop (didn't bet)
Seat 7: sGFnnRCa1YAHAUmWgsW6Qg folded before Flop (didn't bet)
Seat 8: ipgcO7Pa6LC8XWpVttZfnA folded before Flop (didn't bet)
Seat 9: bC+Wg1ntzw3N48OwuR1eag (button) showed [3c Tc] and won ($4.70) with a full house, Sevens full of Fives




PokerStars Game #59941611462:  Hold'em No Limit ($0.10/$0.25) - 2009/07/01 1:40:42 ET
Table 'uFgIyfWPagvEVGEb86da7A' 9-max Seat #7 is the button
Seat 1: CT7Xj/V/O5rBlhtt+RZeFQ ($26.25 in chips) 
Seat 2: o3zvoO+PsqGti+1NZGNRrQ ($1.10 in chips) 
Seat 3: eGAnPT3w+iltM7HF59dzIg ($6.25 in chips) 
Seat 4: IGRfskE1v9H9Bn+fz8AgNQ ($26.90 in chips) 
Seat 5: X78b5v/uhqeXXoAijbw/yg ($28.30 in chips) 
Seat 6: zDrucyjVn5aeekNEc3cJrA ($28.75 in chips) 
Seat 7: 9zx7Mlww974uHUqoiq2eXA ($11.85 in chips) 
Seat 8: uLP/lYn7oKq9xCChBXsXxw ($23.90 in chips) 
Seat 9: sL5EaDXc90Iyxlm8ERXRQw ($17.70 in chips) 
uLP/lYn7oKq9xCChBXsXxw: posts small blind $0.10
sL5EaDXc90Iyxlm8ERXRQw: posts big blind $0.25
*** HOLE CARDS ***
CT7Xj/V/O5rBlhtt+RZeFQ: folds 
o3zvoO+PsqGti+1NZGNRrQ: folds 
eGAnPT3w+iltM7HF59dzIg: folds 
IGRfskE1v9H9Bn+fz8AgNQ: folds 
X78b5v/uhqeXXoAijbw/yg: folds 
zDrucyjVn5aeekNEc3cJrA: calls $0.25
9zx7Mlww974uHUqoiq2eXA: folds 
uLP/lYn7oKq9xCChBXsXxw: folds 
sL5EaDXc90Iyxlm8ERXRQw: checks 
*** FLOP *** [6c Qh Qs]
sL5EaDXc90Iyxlm8ERXRQw: checks 
zDrucyjVn5aeekNEc3cJrA: checks 
*** TURN *** [6c Qh Qs] [7s]
sL5EaDXc90Iyxlm8ERXRQw: bets $0.25
zDrucyjVn5aeekNEc3cJrA: calls $0.25
*** RIVER *** [6c Qh Qs 7s] [Ah]
sL5EaDXc90Iyxlm8ERXRQw: bets $1
zDrucyjVn5aeekNEc3cJrA: folds 
Uncalled bet ($1) returned to sL5EaDXc90Iyxlm8ERXRQw
zDrucyjVn5aeekNEc3cJrA is sitting out
sL5EaDXc90Iyxlm8ERXRQw collected $1.05 from pot
sL5EaDXc90Iyxlm8ERXRQw: doesn't show hand 
*** SUMMARY ***
Total pot $1.10 | Rake $0.05 
Board [6c Qh Qs 7s Ah]
Seat 1: CT7Xj/V/O5rBlhtt+RZeFQ folded before Flop (didn't bet)
Seat 2: o3zvoO+PsqGti+1NZGNRrQ folded before Flop (didn't bet)
Seat 3: eGAnPT3w+iltM7HF59dzIg folded before Flop (didn't bet)
Seat 4: IGRfskE1v9H9Bn+fz8AgNQ folded before Flop (didn't bet)
Seat 5: X78b5v/uhqeXXoAijbw/yg folded before Flop (didn't bet)
Seat 6: zDrucyjVn5aeekNEc3cJrA folded on the River
Seat 7: 9zx7Mlww974uHUqoiq2eXA (button) folded before Flop (didn't bet)
Seat 8: uLP/lYn7oKq9xCChBXsXxw (small blind) folded before Flop
Seat 9: sL5EaDXc90Iyxlm8ERXRQw (big blind) collected ($1.05)




PokerStars Game #59941612486:  Hold'em No Limit ($0.10/$0.25) - 2009/07/01 1:40:43 ET
Table 'RUOqTfzbAVGS5x+J9aZMHA' 9-max Seat #7 is the button
Seat 1: DnDcAdn9P0zGovMERigpFA ($25 in chips) 
Seat 2: Z5ZtGOON8kmSdSCll9Z3XA ($8.35 in chips) 
Seat 3: Th3FldXKQW6hWVVPahaoOQ ($25 in chips) 
Seat 4: K9Az8li/CO2TicltVWKamA ($40.20 in chips) 
Seat 5: MtVtHDqIJTyUcXkRBBDIVA ($30.55 in chips) 
Seat 6: ljemhp25Zg+nlA9DLCIiUw ($40.05 in chips) 
Seat 7: zgi+EUykT/pZQpoUG6+oEg ($4.30 in chips) 
Seat 8: dfNim92Z6XK1/h5SFW5vDg ($25 in chips) 
Seat 9: cZ99hugmLBj9KhTlc8nCSw ($25 in chips) 
dfNim92Z6XK1/h5SFW5vDg: posts small blind $0.10
cZ99hugmLBj9KhTlc8nCSw: posts big blind $0.25
*** HOLE CARDS ***
DnDcAdn9P0zGovMERigpFA: folds 
Z5ZtGOON8kmSdSCll9Z3XA: folds 
Th3FldXKQW6hWVVPahaoOQ: folds 
K9Az8li/CO2TicltVWKamA: folds 
MtVtHDqIJTyUcXkRBBDIVA: calls $0.25
ljemhp25Zg+nlA9DLCIiUw: folds 
zgi+EUykT/pZQpoUG6+oEg: folds 
dfNim92Z6XK1/h5SFW5vDg: folds 
cZ99hugmLBj9KhTlc8nCSw: checks 
*** FLOP *** [2s Ks Td]
cZ99hugmLBj9KhTlc8nCSw: checks 
MtVtHDqIJTyUcXkRBBDIVA: bets $0.50
cZ99hugmLBj9KhTlc8nCSw: folds 
Uncalled bet ($0.50) returned to MtVtHDqIJTyUcXkRBBDIVA
MtVtHDqIJTyUcXkRBBDIVA collected $0.60 from pot
MtVtHDqIJTyUcXkRBBDIVA: doesn't show hand 
*** SUMMARY ***
Total pot $0.60 | Rake $0 
Board [2s Ks Td]
Seat 1: DnDcAdn9P0zGovMERigpFA folded before Flop (didn't bet)
Seat 2: Z5ZtGOON8kmSdSCll9Z3XA folded before Flop (didn't bet)
Seat 3: Th3FldXKQW6hWVVPahaoOQ folded before Flop (didn't bet)
Seat 4: K9Az8li/CO2TicltVWKamA folded before Flop (didn't bet)
Seat 5: MtVtHDqIJTyUcXkRBBDIVA collected ($0.60)
Seat 6: ljemhp25Zg+nlA9DLCIiUw folded before Flop (didn't bet)
Seat 7: zgi+EUykT/pZQpoUG6+oEg (button) folded before Flop (didn't bet)
Seat 8: dfNim92Z6XK1/h5SFW5vDg (small blind) folded before Flop
Seat 9: cZ99hugmLBj9KhTlc8nCSw (big blind) folded on the Flop




PokerStars Game #59941612310:  Hold'em No Limit ($0.10/$0.25) - 2009/07/01 1:40:43 ET
Table '3EebBlzq5yHSY2444L4zlg' 9-max Seat #9 is the button
Seat 1: XMSS6mD5B42I8wasdOMipQ ($29.40 in chips) 
Seat 2: b9UnopCOpq2MWP1DwqSO3Q ($18.30 in chips) 
Seat 3: IGbD5vKNhHe60dkdbjg/mw ($43.25 in chips) 
Seat 4: 1S/fpm+f42V/6MNZre+ccg ($25 in chips) 
Seat 5: PFNLAvMkr8qKc7xCiH0wTA ($26.30 in chips) 
Seat 6: QEbIGci+itdw+re8RM5fZA ($50.35 in chips) 
Seat 7: DiSvPC2iudwL5j9u6Huyww ($49.10 in chips) 
Seat 8: dtZ84flFEi4Q+SGrHMJRDQ ($26.90 in chips) 
Seat 9: iZmSlSzYu5fJ67tDdQzymQ ($24.75 in chips) 
XMSS6mD5B42I8wasdOMipQ: posts small blind $0.10
b9UnopCOpq2MWP1DwqSO3Q: posts big blind $0.25
*** HOLE CARDS ***
IGbD5vKNhHe60dkdbjg/mw: calls $0.25
1S/fpm+f42V/6MNZre+ccg: folds 
PFNLAvMkr8qKc7xCiH0wTA: folds 
QEbIGci+itdw+re8RM5fZA: folds 
DiSvPC2iudwL5j9u6Huyww: folds 
dtZ84flFEi4Q+SGrHMJRDQ: folds 
iZmSlSzYu5fJ67tDdQzymQ: calls $0.25
XMSS6mD5B42I8wasdOMipQ: calls $0.15
b9UnopCOpq2MWP1DwqSO3Q: checks 
*** FLOP *** [Js 5d Ad]
XMSS6mD5B42I8wasdOMipQ: checks 
b9UnopCOpq2MWP1DwqSO3Q: checks 
IGbD5vKNhHe60dkdbjg/mw: bets $1.25
iZmSlSzYu5fJ67tDdQzymQ: folds 
XMSS6mD5B42I8wasdOMipQ: folds 
b9UnopCOpq2MWP1DwqSO3Q: folds 
Uncalled bet ($1.25) returned to IGbD5vKNhHe60dkdbjg/mw
IGbD5vKNhHe60dkdbjg/mw collected $0.95 from pot
*** SUMMARY ***
Total pot $1 | Rake $0.05 
Board [Js 5d Ad]
Seat 1: XMSS6mD5B42I8wasdOMipQ (small blind) folded on the Flop
Seat 2: b9UnopCOpq2MWP1DwqSO3Q (big blind) folded on the Flop
Seat 3: IGbD5vKNhHe60dkdbjg/mw collected ($0.95)
Seat 4: 1S/fpm+f42V/6MNZre+ccg folded before Flop (didn't bet)
Seat 5: PFNLAvMkr8qKc7xCiH0wTA folded before Flop (didn't bet)
Seat 6: QEbIGci+itdw+re8RM5fZA folded before Flop (didn't bet)
Seat 7: DiSvPC2iudwL5j9u6Huyww folded before Flop (didn't bet)
Seat 8: dtZ84flFEi4Q+SGrHMJRDQ folded before Flop (didn't bet)
Seat 9: iZmSlSzYu5fJ67tDdQzymQ (button) folded on the Flop




PokerStars Game #59941612176:  Hold'em No Limit ($0.10/$0.25) - 2009/07/01 1:40:43 ET
Table 'fHv1Mk7ZbLjprZTGWKPiEQ' 6-max Seat #3 is the button
Seat 3: /gJNBeCkWL4o85/jvlZ4BA ($25 in chips) 
Seat 4: TSmua8tGK3sTbwi0ynrW9Q ($52 in chips) 
Seat 5: LJI7A1YgDM7hgh7o56+ReQ ($27.40 in chips) 
Seat 6: AjG0X+rNtc2W08eph8oqpw ($36.20 in chips) 
TSmua8tGK3sTbwi0ynrW9Q: posts small blind $0.10
LJI7A1YgDM7hgh7o56+ReQ: posts big blind $0.25
arewedunces: sits out 
*** HOLE CARDS ***
AjG0X+rNtc2W08eph8oqpw: folds 
/gJNBeCkWL4o85/jvlZ4BA: folds 
TSmua8tGK3sTbwi0ynrW9Q: folds 
Uncalled bet ($0.15) returned to LJI7A1YgDM7hgh7o56+ReQ
LJI7A1YgDM7hgh7o56+ReQ collected $0.20 from pot
LJI7A1YgDM7hgh7o56+ReQ: doesn't show hand 
*** SUMMARY ***
Total pot $0.20 | Rake $0 
Seat 3: /gJNBeCkWL4o85/jvlZ4BA (button) folded before Flop (didn't bet)
Seat 4: TSmua8tGK3sTbwi0ynrW9Q (small blind) folded before Flop
Seat 5: LJI7A1YgDM7hgh7o56+ReQ (big blind) collected ($0.20)
Seat 6: AjG0X+rNtc2W08eph8oqpw folded before Flop (didn't bet)




PokerStars Game #59941612362:  Hold'em No Limit ($0.10/$0.25) - 2009/07/01 1:40:43 ET
Table 'T/iCKJXGphRN3xcdwfE/JQ' 6-max Seat #2 is the button
Seat 1: wAKC8C/zN0c8V5v13dm9mA ($25 in chips) 
Seat 2: EeUZtMU058v2ObUACOF4Og ($33.75 in chips) 
Seat 3: IWAjoCPXtc1XUaZdp+pCpA ($22.10 in chips) 
Seat 4: tSR4329m40dZsN7YOpI9Kw ($54.20 in chips) 
Seat 5: gaPMxLGp9SOj4Lq6t+/0Ig ($4.20 in chips) 
Seat 6: Ey4Kn6PlnYb2srYYBJHvzg ($15.85 in chips) 
IWAjoCPXtc1XUaZdp+pCpA: posts small blind $0.10
tSR4329m40dZsN7YOpI9Kw: posts big blind $0.25
*** HOLE CARDS ***
gaPMxLGp9SOj4Lq6t+/0Ig: raises $3.95 to $4.20 and is all-in
Ey4Kn6PlnYb2srYYBJHvzg: folds 
wAKC8C/zN0c8V5v13dm9mA: folds 
EeUZtMU058v2ObUACOF4Og: folds 
IWAjoCPXtc1XUaZdp+pCpA: folds 
tSR4329m40dZsN7YOpI9Kw: folds 
Uncalled bet ($3.95) returned to gaPMxLGp9SOj4Lq6t+/0Ig
gaPMxLGp9SOj4Lq6t+/0Ig collected $0.60 from pot
gaPMxLGp9SOj4Lq6t+/0Ig: doesn't show hand 
*** SUMMARY ***
Total pot $0.60 | Rake $0 
Seat 1: wAKC8C/zN0c8V5v13dm9mA folded before Flop (didn't bet)
Seat 2: EeUZtMU058v2ObUACOF4Og (button) folded before Flop (didn't bet)
Seat 3: IWAjoCPXtc1XUaZdp+pCpA (small blind) folded before Flop
Seat 4: tSR4329m40dZsN7YOpI9Kw (big blind) folded before Flop
Seat 5: gaPMxLGp9SOj4Lq6t+/0Ig collected ($0.60)
Seat 6: Ey4Kn6PlnYb2srYYBJHvzg folded before Flop (didn't bet)




PokerStars Game #59941612450:  Hold'em No Limit ($0.10/$0.25) - 2009/07/01 1:40:43 ET
Table 'QegsWX65l3n/K0A8XB78yg' 6-max Seat #6 is the button
Seat 1: p6adJRMXMBLr+xtQzqazIQ ($12 in chips) 
Seat 2: GC/9yVD59DUCX7hUI7gcLw ($48.15 in chips) 
Seat 3: 1lxYIAoJdZwAbzIkzWmSkw ($2.75 in chips) 
Seat 4: mFv3iBCtrw9XfCDRB0d46Q ($8.55 in chips) 
Seat 5: OMGl+YMGogf2JWIRfT2/Yg ($12.65 in chips) 
Seat 6: 5PWs02z65jSO5pr/M6wx/w ($4.85 in chips) 
p6adJRMXMBLr+xtQzqazIQ: posts small blind $0.10
GC/9yVD59DUCX7hUI7gcLw: posts big blind $0.25
*** HOLE CARDS ***
1lxYIAoJdZwAbzIkzWmSkw: calls $0.25
mFv3iBCtrw9XfCDRB0d46Q: folds 
OMGl+YMGogf2JWIRfT2/Yg: folds 
5PWs02z65jSO5pr/M6wx/w: folds 
p6adJRMXMBLr+xtQzqazIQ: folds 
GC/9yVD59DUCX7hUI7gcLw: checks 
*** FLOP *** [Qc 5c 3h]
GC/9yVD59DUCX7hUI7gcLw: bets $0.50
1lxYIAoJdZwAbzIkzWmSkw: calls $0.50
*** TURN *** [Qc 5c 3h] [6d]
GC/9yVD59DUCX7hUI7gcLw: bets $2
1lxYIAoJdZwAbzIkzWmSkw: folds 
Uncalled bet ($2) returned to GC/9yVD59DUCX7hUI7gcLw
GC/9yVD59DUCX7hUI7gcLw collected $1.55 from pot
*** SUMMARY ***
Total pot $1.60 | Rake $0.05 
Board [Qc 5c 3h 6d]
Seat 1: p6adJRMXMBLr+xtQzqazIQ (small blind) folded before Flop
Seat 2: GC/9yVD59DUCX7hUI7gcLw (big blind) collected ($1.55)
Seat 3: 1lxYIAoJdZwAbzIkzWmSkw folded on the Turn
Seat 4: mFv3iBCtrw9XfCDRB0d46Q folded before Flop (didn't bet)
Seat 5: OMGl+YMGogf2JWIRfT2/Yg folded before Flop (didn't bet)
Seat 6: 5PWs02z65jSO5pr/M6wx/w (button) folded before Flop (didn't bet)




PokerStars Game #59941612048:  Hold'em No Limit ($0.10/$0.25) - 2009/07/01 1:40:43 ET
Table 'biAgO3TKQBU8XcrVAoU5TA' 6-max Seat #6 is the button
Seat 1: jhDPlkir8wBYAddboBuF7Q ($16 in chips) 
Seat 2: GbCVUNssQ7mqsPWr7J4d3w ($5.65 in chips) 
Seat 3: mfrkWA3PTeYPkbO6hi98Aw ($30.65 in chips) 
Seat 4: Hsvkc0/G2VV78oVmWYXecw ($5 in chips) 
Seat 5: n6UPMnVR4v8LFP0rWP73Fg ($12.45 in chips) 
Seat 6: wMiE3yTbDJGOLOF9th7KPA ($9.85 in chips) 
jhDPlkir8wBYAddboBuF7Q: posts small blind $0.10
GbCVUNssQ7mqsPWr7J4d3w: posts big blind $0.25
*** HOLE CARDS ***
mfrkWA3PTeYPkbO6hi98Aw: folds 
Hsvkc0/G2VV78oVmWYXecw: folds 
n6UPMnVR4v8LFP0rWP73Fg: calls $0.25
wMiE3yTbDJGOLOF9th7KPA: calls $0.25
jhDPlkir8wBYAddboBuF7Q: calls $0.15
GbCVUNssQ7mqsPWr7J4d3w: checks 
*** FLOP *** [3h 9d Ks]
jhDPlkir8wBYAddboBuF7Q: checks 
GbCVUNssQ7mqsPWr7J4d3w: checks 
n6UPMnVR4v8LFP0rWP73Fg: checks 
wMiE3yTbDJGOLOF9th7KPA: checks 
*** TURN *** [3h 9d Ks] [5h]
jhDPlkir8wBYAddboBuF7Q: checks 
GbCVUNssQ7mqsPWr7J4d3w: checks 
n6UPMnVR4v8LFP0rWP73Fg: checks 
wMiE3yTbDJGOLOF9th7KPA: checks 
*** RIVER *** [3h 9d Ks 5h] [8d]
jhDPlkir8wBYAddboBuF7Q: checks 
GbCVUNssQ7mqsPWr7J4d3w: checks 
n6UPMnVR4v8LFP0rWP73Fg: checks 
wMiE3yTbDJGOLOF9th7KPA: checks 
*** SHOW DOWN ***
jhDPlkir8wBYAddboBuF7Q: shows [Ad 7s] (high card Ace)
GbCVUNssQ7mqsPWr7J4d3w: mucks hand 
n6UPMnVR4v8LFP0rWP73Fg: mucks hand 
wMiE3yTbDJGOLOF9th7KPA: mucks hand 
jhDPlkir8wBYAddboBuF7Q collected $0.95 from pot
*** SUMMARY ***
Total pot $1 | Rake $0.05 
Board [3h 9d Ks 5h 8d]
Seat 1: jhDPlkir8wBYAddboBuF7Q (small blind) showed [Ad 7s] and won ($0.95) with high card Ace
Seat 2: GbCVUNssQ7mqsPWr7J4d3w (big blind) mucked
Seat 3: mfrkWA3PTeYPkbO6hi98Aw folded before Flop (didn't bet)
Seat 4: Hsvkc0/G2VV78oVmWYXecw folded before Flop (didn't bet)
Seat 5: n6UPMnVR4v8LFP0rWP73Fg mucked
Seat 6: wMiE3yTbDJGOLOF9th7KPA (button) mucked




PokerStars Game #59941612040:  Hold'em No Limit ($0.10/$0.25) - 2009/07/01 1:40:43 ET
Table 'AchTjdLS1zBUbH3ZIx6f0w' 6-max Seat #4 is the button
Seat 1: rZ0bUtoerhFGDUSRQMnFog ($28.85 in chips) 
Seat 2: kG34n23qFQA3nzdOJTQ1dA ($66.25 in chips) 
Seat 3: k9vn40MOqqb+xF+7GZ6v2g ($28.20 in chips) 
Seat 4: q6WfTUAD9mowIP63ASq2Dg ($26.35 in chips) 
Seat 5: 0av6tRNdi0Ui4f15L7gsVg ($26.10 in chips) 
Seat 6: mFv3iBCtrw9XfCDRB0d46Q ($4.65 in chips) 
0av6tRNdi0Ui4f15L7gsVg: posts small blind $0.10
mFv3iBCtrw9XfCDRB0d46Q: posts big blind $0.25
*** HOLE CARDS ***
rZ0bUtoerhFGDUSRQMnFog: calls $0.25
kG34n23qFQA3nzdOJTQ1dA: folds 
k9vn40MOqqb+xF+7GZ6v2g: folds 
q6WfTUAD9mowIP63ASq2Dg: raises $0.75 to $1
0av6tRNdi0Ui4f15L7gsVg: folds 
mFv3iBCtrw9XfCDRB0d46Q: raises $3.65 to $4.65 and is all-in
rZ0bUtoerhFGDUSRQMnFog: folds 
q6WfTUAD9mowIP63ASq2Dg: calls $3.65
*** FLOP *** [6c 2d 4d]
*** TURN *** [6c 2d 4d] [3c]
*** RIVER *** [6c 2d 4d 3c] [Kd]
*** SHOW DOWN ***
mFv3iBCtrw9XfCDRB0d46Q: shows [7s 7c] (a pair of Sevens)
q6WfTUAD9mowIP63ASq2Dg: shows [Kh Ks] (three of a kind, Kings)
q6WfTUAD9mowIP63ASq2Dg collected $9.20 from pot
*** SUMMARY ***
Total pot $9.65 | Rake $0.45 
Board [6c 2d 4d 3c Kd]
Seat 1: rZ0bUtoerhFGDUSRQMnFog folded before Flop
Seat 2: kG34n23qFQA3nzdOJTQ1dA folded before Flop (didn't bet)
Seat 3: k9vn40MOqqb+xF+7GZ6v2g folded before Flop (didn't bet)
Seat 4: q6WfTUAD9mowIP63ASq2Dg (button) showed [Kh Ks] and won ($9.20) with three of a kind, Kings
Seat 5: 0av6tRNdi0Ui4f15L7gsVg (small blind) folded before Flop
Seat 6: mFv3iBCtrw9XfCDRB0d46Q (big blind) showed [7s 7c] and lost with a pair of Sevens




PokerStars Game #59941612944:  Hold'em No Limit ($0.10/$0.25) - 2009/07/01 1:40:44 ET
Table '0M5QEJGOThqZwQ/sjbjXYw' 6-max Seat #5 is the button
Seat 1: 2G0C7dp4wlPpE21FHjjElQ ($25.60 in chips) 
Seat 2: /gJNBeCkWL4o85/jvlZ4BA ($36.70 in chips) 
Seat 3: 3zD3qLXT1bEffAoWGnc7wg ($25 in chips) 
Seat 4: oBUDUfeUyCbZBsjxHZgSiw ($25 in chips) 
Seat 5: cWc85bEzdRzpUMhRKm8pwQ ($28.05 in chips) 
Seat 6: mYz11CHiw5KsDCRD5T7/jg ($41.45 in chips) 
mYz11CHiw5KsDCRD5T7/jg: posts small blind $0.10
2G0C7dp4wlPpE21FHjjElQ: posts big blind $0.25
*** HOLE CARDS ***
/gJNBeCkWL4o85/jvlZ4BA: folds 
3zD3qLXT1bEffAoWGnc7wg: folds 
oBUDUfeUyCbZBsjxHZgSiw: raises $0.75 to $1
cWc85bEzdRzpUMhRKm8pwQ: folds 
mYz11CHiw5KsDCRD5T7/jg: raises $0.75 to $1.75
2G0C7dp4wlPpE21FHjjElQ: folds 
oBUDUfeUyCbZBsjxHZgSiw: calls $0.75
*** FLOP *** [6c Th 7h]
mYz11CHiw5KsDCRD5T7/jg: bets $0.75
oBUDUfeUyCbZBsjxHZgSiw: calls $0.75
*** TURN *** [6c Th 7h] [Qc]
mYz11CHiw5KsDCRD5T7/jg: bets $1.25
oBUDUfeUyCbZBsjxHZgSiw: raises $3.75 to $5
mYz11CHiw5KsDCRD5T7/jg: calls $3.75
*** RIVER *** [6c Th 7h Qc] [9c]
mYz11CHiw5KsDCRD5T7/jg: checks 
oBUDUfeUyCbZBsjxHZgSiw: checks 
*** SHOW DOWN ***
mYz11CHiw5KsDCRD5T7/jg: shows [As 9s] (a pair of Nines)
oBUDUfeUyCbZBsjxHZgSiw: mucks hand 
mYz11CHiw5KsDCRD5T7/jg collected $14.50 from pot
*** SUMMARY ***
Total pot $15.25 | Rake $0.75 
Board [6c Th 7h Qc 9c]
Seat 1: 2G0C7dp4wlPpE21FHjjElQ (big blind) folded before Flop
Seat 2: /gJNBeCkWL4o85/jvlZ4BA folded before Flop (didn't bet)
Seat 3: 3zD3qLXT1bEffAoWGnc7wg folded before Flop (didn't bet)
Seat 4: oBUDUfeUyCbZBsjxHZgSiw mucked
Seat 5: cWc85bEzdRzpUMhRKm8pwQ (button) folded before Flop (didn't bet)
Seat 6: mYz11CHiw5KsDCRD5T7/jg (small blind) showed [As 9s] and won ($14.50) with a pair of Nines




PokerStars Game #59941612684:  Hold'em No Limit ($0.10/$0.25) - 2009/07/01 1:40:44 ET
Table 'Qr+t8WGovMECkBv+cV1lrg' 6-max Seat #3 is the button
Seat 1: EeUZtMU058v2ObUACOF4Og ($51.60 in chips) 
Seat 2: GJsS3gwVwlbyroaWrnjqJg ($41.40 in chips) 
Seat 3: uZKkrGByYgd4/ZBX2d4z+w ($20.05 in chips) 
Seat 4: 1NNFfYMd5Hsphl/FYz9fNA ($60.55 in chips) 
Seat 5: 9q7YGTKe9k5fYb4fmZc3Ww ($34.25 in chips) 
Seat 6: xRkU4+naLuz7dEZFbOn9cw ($25 in chips) 
1NNFfYMd5Hsphl/FYz9fNA: posts small blind $0.10
9q7YGTKe9k5fYb4fmZc3Ww: posts big blind $0.25
*** HOLE CARDS ***
xRkU4+naLuz7dEZFbOn9cw: folds 
EeUZtMU058v2ObUACOF4Og: folds 
GJsS3gwVwlbyroaWrnjqJg: folds 
uZKkrGByYgd4/ZBX2d4z+w: folds 
1NNFfYMd5Hsphl/FYz9fNA: folds 
Uncalled bet ($0.15) returned to 9q7YGTKe9k5fYb4fmZc3Ww
9q7YGTKe9k5fYb4fmZc3Ww collected $0.20 from pot
*** SUMMARY ***
Total pot $0.20 | Rake $0 
Seat 1: EeUZtMU058v2ObUACOF4Og folded before Flop (didn't bet)
Seat 2: GJsS3gwVwlbyroaWrnjqJg folded before Flop (didn't bet)
Seat 3: uZKkrGByYgd4/ZBX2d4z+w (button) folded before Flop (didn't bet)
Seat 4: 1NNFfYMd5Hsphl/FYz9fNA (small blind) folded before Flop
Seat 5: 9q7YGTKe9k5fYb4fmZc3Ww (big blind) collected ($0.20)
Seat 6: xRkU4+naLuz7dEZFbOn9cw folded before Flop (didn't bet)




PokerStars Game #59941612624:  Hold'em No Limit ($0.10/$0.25) - 2009/07/01 1:40:44 ET
Table 'BabJGL6tfXQp3leBGbYe8A' 9-max Seat #6 is the button
Seat 1: qwr38jl5txoR36M7G5qi4A ($8 in chips) 
Seat 2: dtZ84flFEi4Q+SGrHMJRDQ ($36 in chips) 
Seat 3: sD+TKtt36XiiN6jqHiLwDA ($25.45 in chips) 
Seat 4: gehe91e0IyVT0QU/XBkEyg ($28.45 in chips) 
Seat 5: GrNTWMdwy+jC6Lred1eDng ($14.40 in chips) 
Seat 6: egvg3mTBBVzMHnJPIQiKcA ($14.15 in chips) 
Seat 7: eK8qa6EPcH2zhtbmWSvc9g ($27.60 in chips) 
Seat 8: OgISYvc5hA85YuDnsXCH+Q ($22.25 in chips) 
eK8qa6EPcH2zhtbmWSvc9g: posts small blind $0.10
OgISYvc5hA85YuDnsXCH+Q: posts big blind $0.25
P+9ymZQ3ktpQu1bn7HIjew: sits out 
*** HOLE CARDS ***
qwr38jl5txoR36M7G5qi4A: folds 
dtZ84flFEi4Q+SGrHMJRDQ: folds 
sD+TKtt36XiiN6jqHiLwDA: calls $0.25
gehe91e0IyVT0QU/XBkEyg: folds 
GrNTWMdwy+jC6Lred1eDng: calls $0.25
egvg3mTBBVzMHnJPIQiKcA: folds 
eK8qa6EPcH2zhtbmWSvc9g: folds 
OgISYvc5hA85YuDnsXCH+Q: checks 
*** FLOP *** [Kc Jh 7s]
OgISYvc5hA85YuDnsXCH+Q: checks 
sD+TKtt36XiiN6jqHiLwDA: checks 
GrNTWMdwy+jC6Lred1eDng: bets $0.50
OgISYvc5hA85YuDnsXCH+Q: folds 
sD+TKtt36XiiN6jqHiLwDA: folds 
Uncalled bet ($0.50) returned to GrNTWMdwy+jC6Lred1eDng
GrNTWMdwy+jC6Lred1eDng collected $0.85 from pot
*** SUMMARY ***
Total pot $0.85 | Rake $0 
Board [Kc Jh 7s]
Seat 1: qwr38jl5txoR36M7G5qi4A folded before Flop (didn't bet)
Seat 2: dtZ84flFEi4Q+SGrHMJRDQ folded before Flop (didn't bet)
Seat 3: sD+TKtt36XiiN6jqHiLwDA folded on the Flop
Seat 4: gehe91e0IyVT0QU/XBkEyg folded before Flop (didn't bet)
Seat 5: GrNTWMdwy+jC6Lred1eDng collected ($0.85)
Seat 6: egvg3mTBBVzMHnJPIQiKcA (button) folded before Flop (didn't bet)
Seat 7: eK8qa6EPcH2zhtbmWSvc9g (small blind) folded before Flop
Seat 8: OgISYvc5hA85YuDnsXCH+Q (big blind) folded on the Flop




PokerStars Game #59941613528:  Hold'em No Limit ($0.10/$0.25) - 2009/07/01 1:40:45 ET
Table 'by7aHYEDnDd144EXOXa/jA' 9-max Seat #5 is the button
Seat 1: j4q3p0lesp63b1gZDwLBZw ($6.60 in chips) 
Seat 2: vSkQm2EelzwRGDDQQk0Fqw ($5 in chips) 
Seat 3: HOEaXncFu2ij+D5/CANAZA ($11.15 in chips) 
Seat 4: 2Xwi447v1rBHM+92U0CduA ($5 in chips) 
Seat 5: yyG4svzOpC1A+sUP/scg6w ($3.60 in chips) 
Seat 6: sC4BsflLWW26Qm9m+1AwJQ ($14.45 in chips) 
Seat 8: 7je+LC5Mfs6nL8YBVh4frQ ($4 in chips) 
Seat 9: K0b5wNInj6hUGRr6yzKFtw ($26.65 in chips) 
sC4BsflLWW26Qm9m+1AwJQ: posts small blind $0.10
V6p0jQ/RhUsqpHLmXvEX4Q: is sitting out 
V6p0jQ/RhUsqpHLmXvEX4Q leaves the table
7je+LC5Mfs6nL8YBVh4frQ: posts big blind $0.25
2Xwi447v1rBHM+92U0CduA: posts big blind $0.25
*** HOLE CARDS ***
DigiSlarks joins the table at seat #7 
K0b5wNInj6hUGRr6yzKFtw: folds 
j4q3p0lesp63b1gZDwLBZw: folds 
vSkQm2EelzwRGDDQQk0Fqw: folds 
HOEaXncFu2ij+D5/CANAZA: calls $0.25
2Xwi447v1rBHM+92U0CduA: checks 
yyG4svzOpC1A+sUP/scg6w: folds 
sC4BsflLWW26Qm9m+1AwJQ: calls $0.15
7je+LC5Mfs6nL8YBVh4frQ: checks 
*** FLOP *** [4d Js Ad]
sC4BsflLWW26Qm9m+1AwJQ: bets $0.25
7je+LC5Mfs6nL8YBVh4frQ: folds 
HOEaXncFu2ij+D5/CANAZA: folds 
2Xwi447v1rBHM+92U0CduA: folds 
Uncalled bet ($0.25) returned to sC4BsflLWW26Qm9m+1AwJQ
sC4BsflLWW26Qm9m+1AwJQ collected $0.95 from pot
sC4BsflLWW26Qm9m+1AwJQ: doesn't show hand 
*** SUMMARY ***
Total pot $1 | Rake $0.05 
Board [4d Js Ad]
Seat 1: j4q3p0lesp63b1gZDwLBZw folded before Flop (didn't bet)
Seat 2: vSkQm2EelzwRGDDQQk0Fqw folded before Flop (didn't bet)
Seat 3: HOEaXncFu2ij+D5/CANAZA folded on the Flop
Seat 4: 2Xwi447v1rBHM+92U0CduA folded on the Flop
Seat 5: yyG4svzOpC1A+sUP/scg6w (button) folded before Flop (didn't bet)
Seat 6: sC4BsflLWW26Qm9m+1AwJQ (small blind) collected ($0.95)
Seat 8: 7je+LC5Mfs6nL8YBVh4frQ (big blind) folded on the Flop
Seat 9: K0b5wNInj6hUGRr6yzKFtw folded before Flop (didn't bet)




PokerStars Game #59941613604:  Hold'em No Limit ($0.10/$0.25) - 2009/07/01 1:40:45 ET
Table '9SExUHslNkrPJ4XsrePaVw' 9-max Seat #6 is the button
Seat 2: cZ99hugmLBj9KhTlc8nCSw ($47.35 in chips) 
Seat 3: EP17SQz/iWcuYdNOGeBgkw ($14.40 in chips) 
Seat 4: 4awUyiDYTgylQKXZ9faBVA ($25 in chips) 
Seat 5: L+eJnUyhY8bMNYw755K8XQ ($9.50 in chips) 
Seat 6: YPJ90cgNXDABdYJcqmwB0A ($19.70 in chips) 
Seat 7: 7cv+9Zc9HIQHNvYsMfV3uA ($29.80 in chips) 
Seat 8: tLcDklc2rBORNfixyRfVfw ($25 in chips) 
Seat 9: /THNzAxdv2lBxcf4XTj/0g ($10.85 in chips) 
7cv+9Zc9HIQHNvYsMfV3uA: posts small blind $0.10
tLcDklc2rBORNfixyRfVfw: posts big blind $0.25
*** HOLE CARDS ***
/THNzAxdv2lBxcf4XTj/0g: folds 
cZ99hugmLBj9KhTlc8nCSw: raises $0.50 to $0.75
EP17SQz/iWcuYdNOGeBgkw: folds 
4awUyiDYTgylQKXZ9faBVA: folds 
L+eJnUyhY8bMNYw755K8XQ: calls $0.75
AlezzzZ is disconnected 
AlezzzZ is connected 
AlezzzZ has returned
YPJ90cgNXDABdYJcqmwB0A: calls $0.75
7cv+9Zc9HIQHNvYsMfV3uA: folds 
tLcDklc2rBORNfixyRfVfw: folds 
*** FLOP *** [4h Ac 4s]
cZ99hugmLBj9KhTlc8nCSw: checks 
L+eJnUyhY8bMNYw755K8XQ: checks 
YPJ90cgNXDABdYJcqmwB0A: checks 
*** TURN *** [4h Ac 4s] [5h]
cZ99hugmLBj9KhTlc8nCSw: bets $1.75
L+eJnUyhY8bMNYw755K8XQ: calls $1.75
YPJ90cgNXDABdYJcqmwB0A: calls $1.75
*** RIVER *** [4h Ac 4s 5h] [Jc]
cZ99hugmLBj9KhTlc8nCSw: checks 
L+eJnUyhY8bMNYw755K8XQ: bets $3.75
YPJ90cgNXDABdYJcqmwB0A: folds 
cZ99hugmLBj9KhTlc8nCSw: folds 
Uncalled bet ($3.75) returned to L+eJnUyhY8bMNYw755K8XQ
AlezzzZ leaves the table
L+eJnUyhY8bMNYw755K8XQ collected $7.50 from pot
*** SUMMARY ***
Total pot $7.85 | Rake $0.35 
Board [4h Ac 4s 5h Jc]
Seat 2: cZ99hugmLBj9KhTlc8nCSw folded on the River
Seat 3: EP17SQz/iWcuYdNOGeBgkw folded before Flop (didn't bet)
Seat 4: 4awUyiDYTgylQKXZ9faBVA folded before Flop (didn't bet)
Seat 5: L+eJnUyhY8bMNYw755K8XQ collected ($7.50)
Seat 6: YPJ90cgNXDABdYJcqmwB0A (button) folded on the River
Seat 7: 7cv+9Zc9HIQHNvYsMfV3uA (small blind) folded before Flop
Seat 8: tLcDklc2rBORNfixyRfVfw (big blind) folded before Flop
Seat 9: /THNzAxdv2lBxcf4XTj/0g folded before Flop (didn't bet)




PokerStars Game #59941613416:  Hold'em No Limit ($0.10/$0.25) - 2009/07/01 1:40:45 ET
Table '29D3eoQzK5kOAT0OIDS2uQ' 6-max Seat #6 is the button
Seat 1: kG34n23qFQA3nzdOJTQ1dA ($46.25 in chips) 
Seat 3: z3tQwy28dp5FykDJC/wzQw ($18.15 in chips) 
Seat 4: MqMK8OWPSY1V4stf1Hy5Jw ($32.30 in chips) 
Seat 5: Q3EMN7b0ie81AFWkDrhCjw ($20.40 in chips) 
Seat 6: bWbV4MVB/vVpiES1Ut4hew ($37.70 in chips) 
kG34n23qFQA3nzdOJTQ1dA: posts small blind $0.10
z3tQwy28dp5FykDJC/wzQw: posts big blind $0.25
*** HOLE CARDS ***
MqMK8OWPSY1V4stf1Hy5Jw: folds 
Q3EMN7b0ie81AFWkDrhCjw: calls $0.25
bWbV4MVB/vVpiES1Ut4hew: raises $1 to $1.25
kG34n23qFQA3nzdOJTQ1dA: folds 
z3tQwy28dp5FykDJC/wzQw: folds 
Q3EMN7b0ie81AFWkDrhCjw: calls $1
*** FLOP *** [Kc Ah 7c]
Q3EMN7b0ie81AFWkDrhCjw: checks 
bWbV4MVB/vVpiES1Ut4hew: bets $2
Q3EMN7b0ie81AFWkDrhCjw: calls $2
*** TURN *** [Kc Ah 7c] [8h]
Q3EMN7b0ie81AFWkDrhCjw: checks 
bWbV4MVB/vVpiES1Ut4hew: bets $5.25
Q3EMN7b0ie81AFWkDrhCjw: calls $5.25
*** RIVER *** [Kc Ah 7c 8h] [Ks]
Q3EMN7b0ie81AFWkDrhCjw: bets $11.90 and is all-in
bWbV4MVB/vVpiES1Ut4hew: folds 
Uncalled bet ($11.90) returned to Q3EMN7b0ie81AFWkDrhCjw
Q3EMN7b0ie81AFWkDrhCjw collected $16.50 from pot
*** SUMMARY ***
Total pot $17.35 | Rake $0.85 
Board [Kc Ah 7c 8h Ks]
Seat 1: kG34n23qFQA3nzdOJTQ1dA (small blind) folded before Flop
Seat 3: z3tQwy28dp5FykDJC/wzQw (big blind) folded before Flop
Seat 4: MqMK8OWPSY1V4stf1Hy5Jw folded before Flop (didn't bet)
Seat 5: Q3EMN7b0ie81AFWkDrhCjw collected ($16.50)
Seat 6: bWbV4MVB/vVpiES1Ut4hew (button) folded on the River




PokerStars Game #59941613154:  Hold'em No Limit ($0.10/$0.25) - 2009/07/01 1:40:45 ET
Table 'qryc9C/ELyQ3lubOaELNAQ' 6-max Seat #1 is the button
Seat 1: OZc6kkoTwtITj1ZfreJK1A ($65.55 in chips) 
Seat 2: LtASJ9OlkqGrrUKGQlpGAw ($30.90 in chips) 
Seat 4: v+QfkGiuj9bgtuNoVnDO8w ($25.40 in chips) 
Seat 5: 9StOHp+Y1T0K13JdgS2oQQ ($32.50 in chips) 
Seat 6: u+J1MTXS2qhNVMbsBemNLg ($4.05 in chips) 
LtASJ9OlkqGrrUKGQlpGAw: posts small blind $0.10
2Ga+TibtZsUCp1MLaueYVA: is sitting out 
v+QfkGiuj9bgtuNoVnDO8w: posts big blind $0.25
*** HOLE CARDS ***
2Ga+TibtZsUCp1MLaueYVA leaves the table
9StOHp+Y1T0K13JdgS2oQQ: raises $0.50 to $0.75
u+J1MTXS2qhNVMbsBemNLg: folds 
OZc6kkoTwtITj1ZfreJK1A: calls $0.75
LtASJ9OlkqGrrUKGQlpGAw: folds 
v+QfkGiuj9bgtuNoVnDO8w: folds 
*** FLOP *** [9c 2h Ks]
9StOHp+Y1T0K13JdgS2oQQ: bets $1
OZc6kkoTwtITj1ZfreJK1A: folds 
Uncalled bet ($1) returned to 9StOHp+Y1T0K13JdgS2oQQ
9StOHp+Y1T0K13JdgS2oQQ collected $1.80 from pot
9StOHp+Y1T0K13JdgS2oQQ: doesn't show hand 
*** SUMMARY ***
Total pot $1.85 | Rake $0.05 
Board [9c 2h Ks]
Seat 1: OZc6kkoTwtITj1ZfreJK1A (button) folded on the Flop
Seat 2: LtASJ9OlkqGrrUKGQlpGAw (small blind) folded before Flop
Seat 4: v+QfkGiuj9bgtuNoVnDO8w (big blind) folded before Flop
Seat 5: 9StOHp+Y1T0K13JdgS2oQQ collected ($1.80)
Seat 6: u+J1MTXS2qhNVMbsBemNLg folded before Flop (didn't bet)




PokerStars Game #59941613598:  Hold'em No Limit ($0.10/$0.25) - 2009/07/01 1:40:45 ET
Table '3lL16FBjWXTx3AjK5lMRww' 9-max Seat #6 is the button
Seat 1: fDGyaQz0cs2s4FOYxkbIHA ($16.55 in chips) 
Seat 2: c/9X4zftzphFxYtxp5kp9w ($19.90 in chips) 
Seat 3: QEbIGci+itdw+re8RM5fZA ($27.95 in chips) 
Seat 4: Z3a37Ry74FVl+CBZtAONiA ($6.55 in chips) 
Seat 5: M/9j4wkHH9i1JM51vgi1VA ($37.30 in chips) 
Seat 6: zUXhymECc2C9W9ZNw6qppA ($9.65 in chips) 
Seat 7: 6RiVTYll/5D8zICp0MRpKw ($25.80 in chips) 
Seat 8: ljemhp25Zg+nlA9DLCIiUw ($24 in chips) 
Seat 9: 00Ybni1cxfHtqmdWwh31Xg ($10.35 in chips) 
6RiVTYll/5D8zICp0MRpKw: posts small blind $0.10
ljemhp25Zg+nlA9DLCIiUw: posts big blind $0.25
*** HOLE CARDS ***
00Ybni1cxfHtqmdWwh31Xg: raises $0.50 to $0.75
fDGyaQz0cs2s4FOYxkbIHA: folds 
c/9X4zftzphFxYtxp5kp9w: calls $0.75
QEbIGci+itdw+re8RM5fZA: folds 
Z3a37Ry74FVl+CBZtAONiA: folds 
M/9j4wkHH9i1JM51vgi1VA: folds 
zUXhymECc2C9W9ZNw6qppA: folds 
6RiVTYll/5D8zICp0MRpKw: folds 
ljemhp25Zg+nlA9DLCIiUw: folds 
*** FLOP *** [6c Ks 2d]
M/9j4wkHH9i1JM51vgi1VA is sitting out
00Ybni1cxfHtqmdWwh31Xg: checks 
c/9X4zftzphFxYtxp5kp9w: checks 
*** TURN *** [6c Ks 2d] [5c]
00Ybni1cxfHtqmdWwh31Xg: checks 
c/9X4zftzphFxYtxp5kp9w: checks 
*** RIVER *** [6c Ks 2d 5c] [Qs]
00Ybni1cxfHtqmdWwh31Xg: checks 
c/9X4zftzphFxYtxp5kp9w: checks 
*** SHOW DOWN ***
00Ybni1cxfHtqmdWwh31Xg: shows [Jd As] (high card Ace)
c/9X4zftzphFxYtxp5kp9w: mucks hand 
00Ybni1cxfHtqmdWwh31Xg collected $1.80 from pot
*** SUMMARY ***
Total pot $1.85 | Rake $0.05 
Board [6c Ks 2d 5c Qs]
Seat 1: fDGyaQz0cs2s4FOYxkbIHA folded before Flop (didn't bet)
Seat 2: c/9X4zftzphFxYtxp5kp9w mucked
Seat 3: QEbIGci+itdw+re8RM5fZA folded before Flop (didn't bet)
Seat 4: Z3a37Ry74FVl+CBZtAONiA folded before Flop (didn't bet)
Seat 5: M/9j4wkHH9i1JM51vgi1VA folded before Flop (didn't bet)
Seat 6: zUXhymECc2C9W9ZNw6qppA (button) folded before Flop (didn't bet)
Seat 7: 6RiVTYll/5D8zICp0MRpKw (small blind) folded before Flop
Seat 8: ljemhp25Zg+nlA9DLCIiUw (big blind) folded before Flop
Seat 9: 00Ybni1cxfHtqmdWwh31Xg showed [Jd As] and won ($1.80) with high card Ace




PokerStars Game #59941613602:  Hold'em No Limit ($0.10/$0.25) - 2009/07/01 1:40:45 ET
Table 'm+FQg/QP0VP1ZA3V62WtOg' 9-max Seat #4 is the button
Seat 4: qB12xUq3ftb2y8oTnNQzsg ($2.85 in chips) 
Seat 7: TPAF9YkMsjQFq978RNWZEQ ($15.15 in chips) 
Seat 9: zUXhymECc2C9W9ZNw6qppA ($10.55 in chips) 
CT7Xj/V/O5rBlhtt+RZeFQ will be allowed to play after the button
TPAF9YkMsjQFq978RNWZEQ: posts small blind $0.10
zUXhymECc2C9W9ZNw6qppA: posts big blind $0.25
*** HOLE CARDS ***
qB12xUq3ftb2y8oTnNQzsg: folds 
TPAF9YkMsjQFq978RNWZEQ: folds 
Uncalled bet ($0.15) returned to zUXhymECc2C9W9ZNw6qppA
zUXhymECc2C9W9ZNw6qppA collected $0.20 from pot
*** SUMMARY ***
Total pot $0.20 | Rake $0 
Seat 4: qB12xUq3ftb2y8oTnNQzsg (button) folded before Flop (didn't bet)
Seat 7: TPAF9YkMsjQFq978RNWZEQ (small blind) folded before Flop
Seat 9: zUXhymECc2C9W9ZNw6qppA (big blind) collected ($0.20)




PokerStars Game #59941613478:  Hold'em No Limit ($0.10/$0.25) - 2009/07/01 1:40:45 ET
Table 'rpIHGyt2QpgQc5bvptAvDQ' 9-max Seat #5 is the button
Seat 3: OzXv12vW3/jO5rPU5mJHQg ($5.65 in chips) 
Seat 5: z2SmIaQ3+5n/eY1BN5HgPg ($15.15 in chips) 
Seat 6: Mq1ESwxx3LEsA4HjKKjU3Q ($15.25 in chips) 
Mq1ESwxx3LEsA4HjKKjU3Q: posts small blind $0.10
OzXv12vW3/jO5rPU5mJHQg: posts big blind $0.25
ASXDkj9tmvF/T2AsNuxg7g: sits out 
*** HOLE CARDS ***
z2SmIaQ3+5n/eY1BN5HgPg: calls $0.25
Mq1ESwxx3LEsA4HjKKjU3Q: calls $0.15
OzXv12vW3/jO5rPU5mJHQg: checks 
*** FLOP *** [7d 9h 6s]
FX0yWp7Ul3dMebXB0cFjEw joins the table at seat #2 
Mq1ESwxx3LEsA4HjKKjU3Q: bets $0.50
OzXv12vW3/jO5rPU5mJHQg: folds 
z2SmIaQ3+5n/eY1BN5HgPg: calls $0.50
*** TURN *** [7d 9h 6s] [Td]
GHgIdzlzMAmRmmX7jgXtuQ joins the table at seat #7 
OzXv12vW3/jO5rPU5mJHQg leaves the table
Mq1ESwxx3LEsA4HjKKjU3Q: bets $1
z2SmIaQ3+5n/eY1BN5HgPg: calls $1
*** RIVER *** [7d 9h 6s Td] [3d]
Mq1ESwxx3LEsA4HjKKjU3Q: checks 
z2SmIaQ3+5n/eY1BN5HgPg: bets $3.50
Mq1ESwxx3LEsA4HjKKjU3Q: calls $3.50
*** SHOW DOWN ***
z2SmIaQ3+5n/eY1BN5HgPg: shows [Kd 3c] (a pair of Threes)
Mq1ESwxx3LEsA4HjKKjU3Q: shows [Th Jd] (a pair of Tens)
Mq1ESwxx3LEsA4HjKKjU3Q collected $10.25 from pot
z2SmIaQ3+5n/eY1BN5HgPg leaves the table
*** SUMMARY ***
Total pot $10.75 | Rake $0.50 
Board [7d 9h 6s Td 3d]
Seat 3: OzXv12vW3/jO5rPU5mJHQg (big blind) folded on the Flop
Seat 5: z2SmIaQ3+5n/eY1BN5HgPg (button) showed [Kd 3c] and lost with a pair of Threes
Seat 6: Mq1ESwxx3LEsA4HjKKjU3Q (small blind) showed [Th Jd] and won ($10.25) with a pair of Tens




PokerStars Game #59941614072:  Hold'em No Limit ($0.10/$0.25) - 2009/07/01 1:40:46 ET
Table 'ORSZkZqq+7Ja2PdeCFAytA' 9-max Seat #7 is the button
Seat 1: 3FkcXBaxKqxYVagfYUZlmw ($13.50 in chips) 
Seat 2: FzknuThd6oNi5WfR7ciTfA ($20.30 in chips) 
Seat 3: s9a4d23HFxaL70yUWQ0/tQ ($17.65 in chips) 
Seat 4: tbgfV2Egwn85xEt865GWQQ ($15.15 in chips) 
Seat 5: +lWbsq4dTcA70SX/+hnmpg ($4.40 in chips) 
Seat 6: gMF+EMhmwpnaM5TFQquf2A ($13.75 in chips) 
Seat 7: L4arauLTM5DsCc2Y3lI8Yw ($5.50 in chips) 
Seat 8: npAYqa85pqnzfOK5ukX+BQ ($20 in chips) 
Seat 9: cMTFs4oCtNInkpDIecxT/w ($10.15 in chips) 
npAYqa85pqnzfOK5ukX+BQ: posts small blind $0.10
cMTFs4oCtNInkpDIecxT/w: posts big blind $0.25
*** HOLE CARDS ***
3FkcXBaxKqxYVagfYUZlmw: calls $0.25
FzknuThd6oNi5WfR7ciTfA: raises $0.75 to $1
s9a4d23HFxaL70yUWQ0/tQ: folds 
tbgfV2Egwn85xEt865GWQQ: folds 
+lWbsq4dTcA70SX/+hnmpg: folds 
gMF+EMhmwpnaM5TFQquf2A: folds 
L4arauLTM5DsCc2Y3lI8Yw: calls $1
npAYqa85pqnzfOK5ukX+BQ: folds 
cMTFs4oCtNInkpDIecxT/w: folds 
3FkcXBaxKqxYVagfYUZlmw: calls $0.75
*** FLOP *** [3d 7h 8c]
3FkcXBaxKqxYVagfYUZlmw: checks 
FzknuThd6oNi5WfR7ciTfA: bets $1
L4arauLTM5DsCc2Y3lI8Yw: folds 
3FkcXBaxKqxYVagfYUZlmw: folds 
Uncalled bet ($1) returned to FzknuThd6oNi5WfR7ciTfA
FzknuThd6oNi5WfR7ciTfA collected $3.20 from pot
*** SUMMARY ***
Total pot $3.35 | Rake $0.15 
Board [3d 7h 8c]
Seat 1: 3FkcXBaxKqxYVagfYUZlmw folded on the Flop
Seat 2: FzknuThd6oNi5WfR7ciTfA collected ($3.20)
Seat 3: s9a4d23HFxaL70yUWQ0/tQ folded before Flop (didn't bet)
Seat 4: tbgfV2Egwn85xEt865GWQQ folded before Flop (didn't bet)
Seat 5: +lWbsq4dTcA70SX/+hnmpg folded before Flop (didn't bet)
Seat 6: gMF+EMhmwpnaM5TFQquf2A folded before Flop (didn't bet)
Seat 7: L4arauLTM5DsCc2Y3lI8Yw (button) folded on the Flop
Seat 8: npAYqa85pqnzfOK5ukX+BQ (small blind) folded before Flop
Seat 9: cMTFs4oCtNInkpDIecxT/w (big blind) folded before Flop




PokerStars Game #59941614808:  Hold'em No Limit ($0.10/$0.25) - 2009/07/01 1:40:47 ET
Table 'WEMI3Mtn7dGARDbgNrKibg' 9-max Seat #6 is the button
Seat 1: Th3FldXKQW6hWVVPahaoOQ ($30.50 in chips) 
Seat 2: tYsOBqdU1+x+yFI7zHO7hQ ($49.55 in chips) 
Seat 3: qwr38jl5txoR36M7G5qi4A ($7.75 in chips) 
Seat 4: Z5NNIVvnhb2IJbLcI79WYQ ($5.25 in chips) 
Seat 5: yzPZQFeaQTNf1YK3a0zRIw ($15.45 in chips) 
Seat 6: arxNSjreDRGFg13EAM2F1w ($25.35 in chips) 
Seat 7: DnDcAdn9P0zGovMERigpFA ($55 in chips) 
Seat 8: ghNKXUBl/H+t83JF079ZBA ($29 in chips) 
Seat 9: 2wcFsZsqEP5w1StUTVzJCg ($4 in chips) 
DnDcAdn9P0zGovMERigpFA: posts small blind $0.10
ghNKXUBl/H+t83JF079ZBA: posts big blind $0.25
*** HOLE CARDS ***
2wcFsZsqEP5w1StUTVzJCg: calls $0.25
Th3FldXKQW6hWVVPahaoOQ: folds 
tYsOBqdU1+x+yFI7zHO7hQ: folds 
qwr38jl5txoR36M7G5qi4A: folds 
Z5NNIVvnhb2IJbLcI79WYQ: folds 
yzPZQFeaQTNf1YK3a0zRIw: calls $0.25
arxNSjreDRGFg13EAM2F1w: folds 
DnDcAdn9P0zGovMERigpFA: folds 
ghNKXUBl/H+t83JF079ZBA: checks 
*** FLOP *** [8h Qc 6h]
ghNKXUBl/H+t83JF079ZBA: checks 
2wcFsZsqEP5w1StUTVzJCg: checks 
yzPZQFeaQTNf1YK3a0zRIw: bets $0.50
ghNKXUBl/H+t83JF079ZBA: folds 
2wcFsZsqEP5w1StUTVzJCg: calls $0.50
*** TURN *** [8h Qc 6h] [4c]
2wcFsZsqEP5w1StUTVzJCg: checks 
yzPZQFeaQTNf1YK3a0zRIw: bets $0.50
2wcFsZsqEP5w1StUTVzJCg: calls $0.50
*** RIVER *** [8h Qc 6h 4c] [Kh]
2wcFsZsqEP5w1StUTVzJCg: bets $1
yzPZQFeaQTNf1YK3a0zRIw: folds 
Uncalled bet ($1) returned to 2wcFsZsqEP5w1StUTVzJCg
2wcFsZsqEP5w1StUTVzJCg collected $2.75 from pot
*** SUMMARY ***
Total pot $2.85 | Rake $0.10 
Board [8h Qc 6h 4c Kh]
Seat 1: Th3FldXKQW6hWVVPahaoOQ folded before Flop (didn't bet)
Seat 2: tYsOBqdU1+x+yFI7zHO7hQ folded before Flop (didn't bet)
Seat 3: qwr38jl5txoR36M7G5qi4A folded before Flop (didn't bet)
Seat 4: Z5NNIVvnhb2IJbLcI79WYQ folded before Flop (didn't bet)
Seat 5: yzPZQFeaQTNf1YK3a0zRIw folded on the River
Seat 6: arxNSjreDRGFg13EAM2F1w (button) folded before Flop (didn't bet)
Seat 7: DnDcAdn9P0zGovMERigpFA (small blind) folded before Flop
Seat 8: ghNKXUBl/H+t83JF079ZBA (big blind) folded on the Flop
Seat 9: 2wcFsZsqEP5w1StUTVzJCg collected ($2.75)




PokerStars Game #59941614562:  Hold'em No Limit ($0.10/$0.25) - 2009/07/01 1:40:47 ET
Table '/asc7VQ/OpF/oVJ3erB80w' 9-max Seat #5 is the button
Seat 2: +LseQ4csMghI3KY4cLSGMQ ($24.50 in chips) 
Seat 3: WEb58GPxGJGcxGh34AFZRQ ($2.70 in chips) 
Seat 4: Rjy74A2wdEiDWplMcUbA+w ($19.60 in chips) 
Seat 5: QB9VESHry/CRTDKMGwKwsQ ($42.45 in chips) 
Seat 6: XwQK8xvCADxp0bUmji+Zyg ($12.20 in chips) 
Seat 7: 7Qlge5BZqMQvXxiy4HU3Hw ($6.75 in chips) 
Seat 8: jB7U2KxE3pjvDhvZHXK2Ag ($18.75 in chips) 
Seat 9: zUXhymECc2C9W9ZNw6qppA ($9.65 in chips) 
XwQK8xvCADxp0bUmji+Zyg: posts small blind $0.10
7Qlge5BZqMQvXxiy4HU3Hw: posts big blind $0.25
*** HOLE CARDS ***
jB7U2KxE3pjvDhvZHXK2Ag: calls $0.25
zUXhymECc2C9W9ZNw6qppA: folds 
+LseQ4csMghI3KY4cLSGMQ: calls $0.25
WEb58GPxGJGcxGh34AFZRQ: calls $0.25
Rjy74A2wdEiDWplMcUbA+w: folds 
QB9VESHry/CRTDKMGwKwsQ: folds 
XwQK8xvCADxp0bUmji+Zyg: calls $0.15
7Qlge5BZqMQvXxiy4HU3Hw: checks 
*** FLOP *** [2s As Th]
XwQK8xvCADxp0bUmji+Zyg: checks 
7Qlge5BZqMQvXxiy4HU3Hw: checks 
jB7U2KxE3pjvDhvZHXK2Ag: bets $0.50
+LseQ4csMghI3KY4cLSGMQ: folds 
WEb58GPxGJGcxGh34AFZRQ: folds 
XwQK8xvCADxp0bUmji+Zyg: folds 
7Qlge5BZqMQvXxiy4HU3Hw: folds 
Uncalled bet ($0.50) returned to jB7U2KxE3pjvDhvZHXK2Ag
jB7U2KxE3pjvDhvZHXK2Ag collected $1.20 from pot
*** SUMMARY ***
Total pot $1.25 | Rake $0.05 
Board [2s As Th]
Seat 2: +LseQ4csMghI3KY4cLSGMQ folded on the Flop
Seat 3: WEb58GPxGJGcxGh34AFZRQ folded on the Flop
Seat 4: Rjy74A2wdEiDWplMcUbA+w folded before Flop (didn't bet)
Seat 5: QB9VESHry/CRTDKMGwKwsQ (button) folded before Flop (didn't bet)
Seat 6: XwQK8xvCADxp0bUmji+Zyg (small blind) folded on the Flop
Seat 7: 7Qlge5BZqMQvXxiy4HU3Hw (big blind) folded on the Flop
Seat 8: jB7U2KxE3pjvDhvZHXK2Ag collected ($1.20)
Seat 9: zUXhymECc2C9W9ZNw6qppA folded before Flop (didn't bet)




PokerStars Game #59941614432:  Hold'em No Limit ($0.10/$0.25) - 2009/07/01 1:40:47 ET
Table 'JPFXJXa5xBkjZ/W15BKqeQ' 9-max Seat #8 is the button
Seat 1: mNQH7Afv3tbDKl2tAb9BOg ($19.60 in chips) 
Seat 2: XMSS6mD5B42I8wasdOMipQ ($10.95 in chips) 
Seat 3: 56S3mA6Zs3pGR+0p0vUCtg ($21.70 in chips) 
Seat 4: wGigCmBR/9XWkPpvYos3aQ ($26.75 in chips) 
Seat 5: cZ99hugmLBj9KhTlc8nCSw ($25 in chips) 
Seat 6: tLcDklc2rBORNfixyRfVfw ($25.35 in chips) 
Seat 8: zDrucyjVn5aeekNEc3cJrA ($24.20 in chips) 
Seat 9: PVqNFEFMoGtpTPGnpm4LTQ ($25.65 in chips) 
PVqNFEFMoGtpTPGnpm4LTQ: posts small blind $0.10
mNQH7Afv3tbDKl2tAb9BOg: posts big blind $0.25
PdIasPkzm2sqZnN41ZRXOg: sits out 
*** HOLE CARDS ***
XMSS6mD5B42I8wasdOMipQ: folds 
56S3mA6Zs3pGR+0p0vUCtg: folds 
wGigCmBR/9XWkPpvYos3aQ: folds 
cZ99hugmLBj9KhTlc8nCSw: folds 
tLcDklc2rBORNfixyRfVfw: folds 
zDrucyjVn5aeekNEc3cJrA: folds 
zDrucyjVn5aeekNEc3cJrA is sitting out
PVqNFEFMoGtpTPGnpm4LTQ: raises $0.25 to $0.50
mNQH7Afv3tbDKl2tAb9BOg: folds 
Uncalled bet ($0.25) returned to PVqNFEFMoGtpTPGnpm4LTQ
PVqNFEFMoGtpTPGnpm4LTQ collected $0.50 from pot
PVqNFEFMoGtpTPGnpm4LTQ: doesn't show hand 
*** SUMMARY ***
Total pot $0.50 | Rake $0 
Seat 1: mNQH7Afv3tbDKl2tAb9BOg (big blind) folded before Flop
Seat 2: XMSS6mD5B42I8wasdOMipQ folded before Flop (didn't bet)
Seat 3: 56S3mA6Zs3pGR+0p0vUCtg folded before Flop (didn't bet)
Seat 4: wGigCmBR/9XWkPpvYos3aQ folded before Flop (didn't bet)
Seat 5: cZ99hugmLBj9KhTlc8nCSw folded before Flop (didn't bet)
Seat 6: tLcDklc2rBORNfixyRfVfw folded before Flop (didn't bet)
Seat 8: zDrucyjVn5aeekNEc3cJrA (button) folded before Flop (didn't bet)
Seat 9: PVqNFEFMoGtpTPGnpm4LTQ (small blind) collected ($0.50)




PokerStars Game #59941614644:  Hold'em No Limit ($0.10/$0.25) - 2009/07/01 1:40:47 ET
Table 'QzXakDK7ZHNjgIpoUFGSKQ' 9-max Seat #7 is the button
Seat 1: w1ukf8uPa4+WH561TtVRxA ($29.05 in chips) 
Seat 3: eK8qa6EPcH2zhtbmWSvc9g ($25.65 in chips) 
Seat 4: 12pxJGeALcKLTBryE6kFxA ($12.25 in chips) 
Seat 5: MtVtHDqIJTyUcXkRBBDIVA ($25 in chips) 
Seat 6: gehe91e0IyVT0QU/XBkEyg ($24.90 in chips) 
Seat 7: wGigCmBR/9XWkPpvYos3aQ ($29.90 in chips) 
Seat 9: lwrOE80tuooHfIBx/4LUSw ($26.15 in chips) 
lwrOE80tuooHfIBx/4LUSw: posts small blind $0.10
w1ukf8uPa4+WH561TtVRxA: posts big blind $0.25
QEbIGci+itdw+re8RM5fZA: sits out 
gehe91e0IyVT0QU/XBkEyg: posts big blind $0.25
*** HOLE CARDS ***
DigiSlarks joins the table at seat #8 
eK8qa6EPcH2zhtbmWSvc9g: folds 
12pxJGeALcKLTBryE6kFxA: calls $0.25
MtVtHDqIJTyUcXkRBBDIVA: folds 
gehe91e0IyVT0QU/XBkEyg: checks 
wGigCmBR/9XWkPpvYos3aQ: folds 
lwrOE80tuooHfIBx/4LUSw: calls $0.15
w1ukf8uPa4+WH561TtVRxA: checks 
*** FLOP *** [Jc Kc 7d]
lwrOE80tuooHfIBx/4LUSw: checks 
w1ukf8uPa4+WH561TtVRxA: checks 
12pxJGeALcKLTBryE6kFxA: checks 
gehe91e0IyVT0QU/XBkEyg: checks 
*** TURN *** [Jc Kc 7d] [8s]
lwrOE80tuooHfIBx/4LUSw: checks 
w1ukf8uPa4+WH561TtVRxA: checks 
12pxJGeALcKLTBryE6kFxA: checks 
gehe91e0IyVT0QU/XBkEyg: checks 
*** RIVER *** [Jc Kc 7d 8s] [Js]
lwrOE80tuooHfIBx/4LUSw: checks 
w1ukf8uPa4+WH561TtVRxA: checks 
12pxJGeALcKLTBryE6kFxA: checks 
gehe91e0IyVT0QU/XBkEyg: checks 
*** SHOW DOWN ***
lwrOE80tuooHfIBx/4LUSw: shows [Ac 2s] (a pair of Jacks)
w1ukf8uPa4+WH561TtVRxA: mucks hand 
12pxJGeALcKLTBryE6kFxA: shows [7h Qd] (two pair, Jacks and Sevens)
gehe91e0IyVT0QU/XBkEyg: mucks hand 
12pxJGeALcKLTBryE6kFxA collected $0.95 from pot
*** SUMMARY ***
Total pot $1 | Rake $0.05 
Board [Jc Kc 7d 8s Js]
Seat 1: w1ukf8uPa4+WH561TtVRxA (big blind) mucked
Seat 3: eK8qa6EPcH2zhtbmWSvc9g folded before Flop (didn't bet)
Seat 4: 12pxJGeALcKLTBryE6kFxA showed [7h Qd] and won ($0.95) with two pair, Jacks and Sevens
Seat 5: MtVtHDqIJTyUcXkRBBDIVA folded before Flop (didn't bet)
Seat 6: gehe91e0IyVT0QU/XBkEyg mucked
Seat 7: wGigCmBR/9XWkPpvYos3aQ (button) folded before Flop (didn't bet)
Seat 9: lwrOE80tuooHfIBx/4LUSw (small blind) showed [Ac 2s] and lost with a pair of Jacks




PokerStars Game #59941614662:  Hold'em No Limit ($0.10/$0.25) - 2009/07/01 1:40:47 ET
Table '3LMlz3V4AziGlU+ikmyU8w' 6-max Seat #6 is the button
Seat 1: Wxq4Qyj0DnDXj2+taEOJFQ ($29.65 in chips) 
Seat 2: uR3AbFJLoOX86DOTtTgGcg ($25 in chips) 
Seat 3: Hzy03WtPHMYwLYM7hTTxQw ($25 in chips) 
Seat 4: 6DwBRH+xZ12AAZmeAg+aXw ($19.30 in chips) 
Seat 5: tOAk1Og4mVObMBOfvdDYOw ($26.10 in chips) 
Seat 6: ZZm/rg8aThjE+A2LiItuzA ($1.10 in chips) 
Wxq4Qyj0DnDXj2+taEOJFQ: posts small blind $0.10
uR3AbFJLoOX86DOTtTgGcg: posts big blind $0.25
*** HOLE CARDS ***
Hzy03WtPHMYwLYM7hTTxQw: folds 
6DwBRH+xZ12AAZmeAg+aXw: folds 
tOAk1Og4mVObMBOfvdDYOw: folds 
ZZm/rg8aThjE+A2LiItuzA: folds 
Wxq4Qyj0DnDXj2+taEOJFQ: raises $0.25 to $0.50
uR3AbFJLoOX86DOTtTgGcg: calls $0.25
*** FLOP *** [8h 7s 2d]
Wxq4Qyj0DnDXj2+taEOJFQ: checks 
uR3AbFJLoOX86DOTtTgGcg: bets $1.25
Wxq4Qyj0DnDXj2+taEOJFQ: folds 
Uncalled bet ($1.25) returned to uR3AbFJLoOX86DOTtTgGcg
uR3AbFJLoOX86DOTtTgGcg collected $0.95 from pot
*** SUMMARY ***
Total pot $1 | Rake $0.05 
Board [8h 7s 2d]
Seat 1: Wxq4Qyj0DnDXj2+taEOJFQ (small blind) folded on the Flop
Seat 2: uR3AbFJLoOX86DOTtTgGcg (big blind) collected ($0.95)
Seat 3: Hzy03WtPHMYwLYM7hTTxQw folded before Flop (didn't bet)
Seat 4: 6DwBRH+xZ12AAZmeAg+aXw folded before Flop (didn't bet)
Seat 5: tOAk1Og4mVObMBOfvdDYOw folded before Flop (didn't bet)
Seat 6: ZZm/rg8aThjE+A2LiItuzA (button) folded before Flop (didn't bet)




PokerStars Game #59941614668:  Hold'em No Limit ($0.10/$0.25) - 2009/07/01 1:40:47 ET
Table 'Jz+kWRxWNGk9w24fdQEveA' 9-max Seat #2 is the button
Seat 2: ljemhp25Zg+nlA9DLCIiUw ($38.85 in chips) 
Seat 4: HPEB+AtKw1+C/cxU0o1ciw ($28.75 in chips) 
Seat 5: d6eSA7wOH5mRaSyVDVRBLw ($10.60 in chips) 
Seat 7: wGigCmBR/9XWkPpvYos3aQ ($27 in chips) 
Seat 8: j4q3p0lesp63b1gZDwLBZw ($5 in chips) 
Seat 9: V6p0jQ/RhUsqpHLmXvEX4Q ($17 in chips) 
sGFnnRCa1YAHAUmWgsW6Qg: is sitting out 
sGFnnRCa1YAHAUmWgsW6Qg leaves the table
HPEB+AtKw1+C/cxU0o1ciw: posts small blind $0.10
d6eSA7wOH5mRaSyVDVRBLw: posts big blind $0.25
DigiSlarks: sits out 
*** HOLE CARDS ***
c/6hFCyfLNRn3VFvCeQ1ng has returned
wGigCmBR/9XWkPpvYos3aQ: folds 
j4q3p0lesp63b1gZDwLBZw: folds 
V6p0jQ/RhUsqpHLmXvEX4Q: raises $0.50 to $0.75
ljemhp25Zg+nlA9DLCIiUw: folds 
HPEB+AtKw1+C/cxU0o1ciw: folds 
d6eSA7wOH5mRaSyVDVRBLw: folds 
Uncalled bet ($0.50) returned to V6p0jQ/RhUsqpHLmXvEX4Q
V6p0jQ/RhUsqpHLmXvEX4Q collected $0.60 from pot
*** SUMMARY ***
Total pot $0.60 | Rake $0 
Seat 2: ljemhp25Zg+nlA9DLCIiUw (button) folded before Flop (didn't bet)
Seat 4: HPEB+AtKw1+C/cxU0o1ciw (small blind) folded before Flop
Seat 5: d6eSA7wOH5mRaSyVDVRBLw (big blind) folded before Flop
Seat 7: wGigCmBR/9XWkPpvYos3aQ folded before Flop (didn't bet)
Seat 8: j4q3p0lesp63b1gZDwLBZw folded before Flop (didn't bet)
Seat 9: V6p0jQ/RhUsqpHLmXvEX4Q collected ($0.60)




PokerStars Game #59941615318:  Hold'em No Limit ($0.10/$0.25) - 2009/07/01 1:40:48 ET
Table 'GxdLtCpYxqT4aAbYqkEEpw' 6-max Seat #3 is the button
Seat 1: 2d/PU00mMdO9azAaXqcSbw ($14.25 in chips) 
Seat 2: 3iomNWHjIokoWh6JNWCUJQ ($3.65 in chips) 
Seat 3: LpmZGzLpOmfZUF7EV4ZlrQ ($16.50 in chips) 
Seat 4: 6wzJiRvp8HY6t+MQGnSIzA ($4.95 in chips) 
Seat 5: q6WfTUAD9mowIP63ASq2Dg ($35.10 in chips) 
Seat 6: DFi/Lzkjsfv8QswS80JX9Q ($25 in chips) 
6wzJiRvp8HY6t+MQGnSIzA: posts small blind $0.10
q6WfTUAD9mowIP63ASq2Dg: posts big blind $0.25
*** HOLE CARDS ***
DFi/Lzkjsfv8QswS80JX9Q: folds 
2d/PU00mMdO9azAaXqcSbw: folds 
3iomNWHjIokoWh6JNWCUJQ: calls $0.25
LpmZGzLpOmfZUF7EV4ZlrQ: calls $0.25
6wzJiRvp8HY6t+MQGnSIzA: calls $0.15
q6WfTUAD9mowIP63ASq2Dg: raises $1.25 to $1.50
3iomNWHjIokoWh6JNWCUJQ: folds 
LpmZGzLpOmfZUF7EV4ZlrQ: folds 
6wzJiRvp8HY6t+MQGnSIzA: calls $1.25
*** FLOP *** [Td 5c 9d]
6wzJiRvp8HY6t+MQGnSIzA: checks 
q6WfTUAD9mowIP63ASq2Dg: bets $2.25
6wzJiRvp8HY6t+MQGnSIzA: folds 
Uncalled bet ($2.25) returned to q6WfTUAD9mowIP63ASq2Dg
q6WfTUAD9mowIP63ASq2Dg collected $3.35 from pot
*** SUMMARY ***
Total pot $3.50 | Rake $0.15 
Board [Td 5c 9d]
Seat 1: 2d/PU00mMdO9azAaXqcSbw folded before Flop (didn't bet)
Seat 2: 3iomNWHjIokoWh6JNWCUJQ folded before Flop
Seat 3: LpmZGzLpOmfZUF7EV4ZlrQ (button) folded before Flop
Seat 4: 6wzJiRvp8HY6t+MQGnSIzA (small blind) folded on the Flop
Seat 5: q6WfTUAD9mowIP63ASq2Dg (big blind) collected ($3.35)
Seat 6: DFi/Lzkjsfv8QswS80JX9Q folded before Flop (didn't bet)




PokerStars Game #59941615262:  Hold'em No Limit ($0.10/$0.25) - 2009/07/01 1:40:48 ET
Table 'Xi38lWH8L2JHRAsKYVX8Qg' 6-max Seat #1 is the button
Seat 1: shP7DFAtX7gXcgMJX/OmRQ ($20.05 in chips) 
Seat 2: VOmI0x4dDPnTESZd5B4d1Q ($9.85 in chips) 
Seat 3: 6DwBRH+xZ12AAZmeAg+aXw ($30.60 in chips) 
Seat 4: kG34n23qFQA3nzdOJTQ1dA ($26.75 in chips) 
Seat 5: 79ID/ub1Pt/mDpCprVmOoA ($78.80 in chips) 
Seat 6: kyRaCIljYA6l33lSKQfNsg ($29.40 in chips) 
VOmI0x4dDPnTESZd5B4d1Q: posts small blind $0.10
6DwBRH+xZ12AAZmeAg+aXw: posts big blind $0.25
*** HOLE CARDS ***
kG34n23qFQA3nzdOJTQ1dA: calls $0.25
79ID/ub1Pt/mDpCprVmOoA: folds 
kyRaCIljYA6l33lSKQfNsg: folds 
shP7DFAtX7gXcgMJX/OmRQ: calls $0.25
VOmI0x4dDPnTESZd5B4d1Q: calls $0.15
6DwBRH+xZ12AAZmeAg+aXw: checks 
*** FLOP *** [5d 4h 8c]
VOmI0x4dDPnTESZd5B4d1Q: checks 
6DwBRH+xZ12AAZmeAg+aXw: checks 
kG34n23qFQA3nzdOJTQ1dA: checks 
shP7DFAtX7gXcgMJX/OmRQ: checks 
*** TURN *** [5d 4h 8c] [8h]
VOmI0x4dDPnTESZd5B4d1Q: checks 
6DwBRH+xZ12AAZmeAg+aXw: checks 
kG34n23qFQA3nzdOJTQ1dA: checks 
shP7DFAtX7gXcgMJX/OmRQ: checks 
*** RIVER *** [5d 4h 8c 8h] [3c]
VOmI0x4dDPnTESZd5B4d1Q: checks 
6DwBRH+xZ12AAZmeAg+aXw: checks 
kG34n23qFQA3nzdOJTQ1dA: checks 
shP7DFAtX7gXcgMJX/OmRQ: checks 
*** SHOW DOWN ***
VOmI0x4dDPnTESZd5B4d1Q: shows [9c Ts] (a pair of Eights)
6DwBRH+xZ12AAZmeAg+aXw: shows [2d 3h] (two pair, Eights and Threes)
kG34n23qFQA3nzdOJTQ1dA: shows [6s 5s] (two pair, Eights and Fives)
shP7DFAtX7gXcgMJX/OmRQ: mucks hand 
kG34n23qFQA3nzdOJTQ1dA collected $0.95 from pot
*** SUMMARY ***
Total pot $1 | Rake $0.05 
Board [5d 4h 8c 8h 3c]
Seat 1: shP7DFAtX7gXcgMJX/OmRQ (button) mucked
Seat 2: VOmI0x4dDPnTESZd5B4d1Q (small blind) showed [9c Ts] and lost with a pair of Eights
Seat 3: 6DwBRH+xZ12AAZmeAg+aXw (big blind) showed [2d 3h] and lost with two pair, Eights and Threes
Seat 4: kG34n23qFQA3nzdOJTQ1dA showed [6s 5s] and won ($0.95) with two pair, Eights and Fives
Seat 5: 79ID/ub1Pt/mDpCprVmOoA folded before Flop (didn't bet)
Seat 6: kyRaCIljYA6l33lSKQfNsg folded before Flop (didn't bet)




PokerStars Game #59941614952:  Hold'em No Limit ($0.10/$0.25) - 2009/07/01 1:40:48 ET
Table 'pAhiNHs/spaABQia+7gWNQ' 9-max Seat #9 is the button
Seat 1: ipgcO7Pa6LC8XWpVttZfnA ($4.75 in chips) 
Seat 2: dfNim92Z6XK1/h5SFW5vDg ($25 in chips) 
Seat 3: xEQxarad8/T4jJdpZy5LGw ($35.40 in chips) 
Seat 5: OlPJsgR4xypSg/w1z7Gyvw ($33.15 in chips) 
Seat 6: oLa/tXLfSLLB28mcLGrxcg ($24.25 in chips) 
Seat 7: +WTkVY3GeLxqGQBbMZQiWQ ($5.90 in chips) 
Seat 9: zgi+EUykT/pZQpoUG6+oEg ($4.65 in chips) 
ipgcO7Pa6LC8XWpVttZfnA: posts small blind $0.10
dfNim92Z6XK1/h5SFW5vDg: posts big blind $0.25
Dr.Hibbert55: sits out 
*** HOLE CARDS ***
xEQxarad8/T4jJdpZy5LGw: folds 
OlPJsgR4xypSg/w1z7Gyvw: calls $0.25
oLa/tXLfSLLB28mcLGrxcg: folds 
+WTkVY3GeLxqGQBbMZQiWQ: folds 
zgi+EUykT/pZQpoUG6+oEg: folds 
ipgcO7Pa6LC8XWpVttZfnA: folds 
dfNim92Z6XK1/h5SFW5vDg: checks 
*** FLOP *** [6c 7h Qh]
dfNim92Z6XK1/h5SFW5vDg: checks 
OlPJsgR4xypSg/w1z7Gyvw: checks 
*** TURN *** [6c 7h Qh] [Ad]
humblepirate joins the table at seat #8 
dfNim92Z6XK1/h5SFW5vDg: checks 
OlPJsgR4xypSg/w1z7Gyvw: checks 
*** RIVER *** [6c 7h Qh Ad] [9s]
dfNim92Z6XK1/h5SFW5vDg: checks 
OlPJsgR4xypSg/w1z7Gyvw: checks 
*** SHOW DOWN ***
dfNim92Z6XK1/h5SFW5vDg: shows [Th 6s] (a pair of Sixes)
OlPJsgR4xypSg/w1z7Gyvw: mucks hand 
dfNim92Z6XK1/h5SFW5vDg collected $0.60 from pot
*** SUMMARY ***
Total pot $0.60 | Rake $0 
Board [6c 7h Qh Ad 9s]
Seat 1: ipgcO7Pa6LC8XWpVttZfnA (small blind) folded before Flop
Seat 2: dfNim92Z6XK1/h5SFW5vDg (big blind) showed [Th 6s] and won ($0.60) with a pair of Sixes
Seat 3: xEQxarad8/T4jJdpZy5LGw folded before Flop (didn't bet)
Seat 5: OlPJsgR4xypSg/w1z7Gyvw mucked
Seat 6: oLa/tXLfSLLB28mcLGrxcg folded before Flop (didn't bet)
Seat 7: +WTkVY3GeLxqGQBbMZQiWQ folded before Flop (didn't bet)
Seat 9: zgi+EUykT/pZQpoUG6+oEg (button) folded before Flop (didn't bet)




PokerStars Game #59941614830:  Hold'em No Limit ($0.10/$0.25) - 2009/07/01 1:40:48 ET
Table 'I0ZcuiUTeLuGYv26Nah7YA' 9-max Seat #4 is the button
Seat 4: hO0e1+SO2lX0hqBn3Z/9KQ ($5 in chips) 
Seat 5: y7tkvDmwKjURBkr73SZPXw ($7.30 in chips) 
hO0e1+SO2lX0hqBn3Z/9KQ: posts small blind $0.10
y7tkvDmwKjURBkr73SZPXw: posts big blind $0.25
*** HOLE CARDS ***
hO0e1+SO2lX0hqBn3Z/9KQ: raises $0.25 to $0.50
y7tkvDmwKjURBkr73SZPXw: calls $0.25
*** FLOP *** [4c 2h 3h]
y7tkvDmwKjURBkr73SZPXw: checks 
hO0e1+SO2lX0hqBn3Z/9KQ: bets $0.25
y7tkvDmwKjURBkr73SZPXw: calls $0.25
*** TURN *** [4c 2h 3h] [8h]
y7tkvDmwKjURBkr73SZPXw: checks 
hO0e1+SO2lX0hqBn3Z/9KQ: bets $0.25
y7tkvDmwKjURBkr73SZPXw: calls $0.25
*** RIVER *** [4c 2h 3h 8h] [Td]
y7tkvDmwKjURBkr73SZPXw: checks 
hO0e1+SO2lX0hqBn3Z/9KQ: bets $4 and is all-in
y7tkvDmwKjURBkr73SZPXw: folds 
Uncalled bet ($4) returned to hO0e1+SO2lX0hqBn3Z/9KQ
y7tkvDmwKjURBkr73SZPXw is sitting out
hO0e1+SO2lX0hqBn3Z/9KQ collected $1.95 from pot
hO0e1+SO2lX0hqBn3Z/9KQ: doesn't show hand 
*** SUMMARY ***
Total pot $2 | Rake $0.05 
Board [4c 2h 3h 8h Td]
Seat 4: hO0e1+SO2lX0hqBn3Z/9KQ (button) (small blind) collected ($1.95)
Seat 5: y7tkvDmwKjURBkr73SZPXw (big blind) folded on the River




PokerStars Game #59941615610:  Hold'em No Limit ($0.10/$0.25) - 2009/07/01 1:40:49 ET
Table '3KDMdm1sfxFsNKkjc/PnBg' 9-max Seat #6 is the button
Seat 1: JvrJoga8hK8pnB3KGQHl1g ($8.25 in chips) 
Seat 2: 5WLo/V8l3QfpUdK9JPp99w ($24.45 in chips) 
Seat 3: OXPkK84/qv92EMwXPiG5rQ ($9.25 in chips) 
Seat 4: F7pnn6czNpHvRM55XcA2EA ($37.85 in chips) 
Seat 5: +2kMBNpY4nF1qNCRd8SJLA ($29.55 in chips) 
Seat 6: sGFnnRCa1YAHAUmWgsW6Qg ($9.85 in chips) 
Seat 7: gehe91e0IyVT0QU/XBkEyg ($31.90 in chips) 
Seat 8: LFnLiiWho1pLiR1Xvp5d/w ($11.30 in chips) 
Seat 9: K0b5wNInj6hUGRr6yzKFtw ($31.75 in chips) 
gehe91e0IyVT0QU/XBkEyg: posts small blind $0.10
LFnLiiWho1pLiR1Xvp5d/w: posts big blind $0.25
*** HOLE CARDS ***
K0b5wNInj6hUGRr6yzKFtw: folds 
JvrJoga8hK8pnB3KGQHl1g: folds 
5WLo/V8l3QfpUdK9JPp99w: folds 
OXPkK84/qv92EMwXPiG5rQ: folds 
F7pnn6czNpHvRM55XcA2EA: folds 
+2kMBNpY4nF1qNCRd8SJLA: raises $0.75 to $1
sGFnnRCa1YAHAUmWgsW6Qg: folds 
gehe91e0IyVT0QU/XBkEyg: folds 
LFnLiiWho1pLiR1Xvp5d/w: calls $0.75
*** FLOP *** [7h Tc 9s]
LFnLiiWho1pLiR1Xvp5d/w: bets $1
+2kMBNpY4nF1qNCRd8SJLA: raises $2.25 to $3.25
LFnLiiWho1pLiR1Xvp5d/w: folds 
Uncalled bet ($2.25) returned to +2kMBNpY4nF1qNCRd8SJLA
+2kMBNpY4nF1qNCRd8SJLA collected $3.90 from pot
+2kMBNpY4nF1qNCRd8SJLA: doesn't show hand 
*** SUMMARY ***
Total pot $4.10 | Rake $0.20 
Board [7h Tc 9s]
Seat 1: JvrJoga8hK8pnB3KGQHl1g folded before Flop (didn't bet)
Seat 2: 5WLo/V8l3QfpUdK9JPp99w folded before Flop (didn't bet)
Seat 3: OXPkK84/qv92EMwXPiG5rQ folded before Flop (didn't bet)
Seat 4: F7pnn6czNpHvRM55XcA2EA folded before Flop (didn't bet)
Seat 5: +2kMBNpY4nF1qNCRd8SJLA collected ($3.90)
Seat 6: sGFnnRCa1YAHAUmWgsW6Qg (button) folded before Flop (didn't bet)
Seat 7: gehe91e0IyVT0QU/XBkEyg (small blind) folded before Flop
Seat 8: LFnLiiWho1pLiR1Xvp5d/w (big blind) folded on the Flop
Seat 9: K0b5wNInj6hUGRr6yzKFtw folded before Flop (didn't bet)




PokerStars Game #59941615384:  Hold'em No Limit ($0.10/$0.25) - 2009/07/01 1:40:49 ET
Table 'ktio12Pyq06LsrFhIorSqA' 9-max Seat #2 is the button
Seat 1: OneeONzF0MoH0pEdcBndwA ($33.60 in chips) 
Seat 2: tGsFgUKjSctVaAXabrlZxw ($4.40 in chips) 
Seat 4: 0QdZrkFD7aGKeBXPGbIomA ($5.40 in chips) 
Seat 5: e0pV1oisCAilWiG0FCxY6A ($18 in chips) 
Seat 6: jQL6XIewylQ8MmZhhq2YFg ($49.75 in chips) 
Seat 7: XGCfQsxa6PfAg3kJtzUmww ($23.95 in chips) 
Seat 8: Z5y2J55JmfLYR6/DPAGHwQ ($2.45 in chips) 
Seat 9: H5Se03ZqSX7tbULXur2MAg ($26.65 in chips) 
DigiSlarks will be allowed to play after the button
0QdZrkFD7aGKeBXPGbIomA: posts small blind $0.10
e0pV1oisCAilWiG0FCxY6A: posts big blind $0.25
*** HOLE CARDS ***
jQL6XIewylQ8MmZhhq2YFg: calls $0.25
XGCfQsxa6PfAg3kJtzUmww: folds 
Z5y2J55JmfLYR6/DPAGHwQ: raises $2.20 to $2.45 and is all-in
H5Se03ZqSX7tbULXur2MAg: folds 
OneeONzF0MoH0pEdcBndwA: folds 
tGsFgUKjSctVaAXabrlZxw: folds 
0QdZrkFD7aGKeBXPGbIomA: folds 
e0pV1oisCAilWiG0FCxY6A: folds 
jQL6XIewylQ8MmZhhq2YFg: calls $2.20
*** FLOP *** [6d 9c 8s]
*** TURN *** [6d 9c 8s] [9s]
*** RIVER *** [6d 9c 8s 9s] [2s]
*** SHOW DOWN ***
jQL6XIewylQ8MmZhhq2YFg: shows [Ah 9h] (three of a kind, Nines)
Z5y2J55JmfLYR6/DPAGHwQ: shows [Ks Qs] (a flush, King high)
Z5y2J55JmfLYR6/DPAGHwQ collected $5 from pot
*** SUMMARY ***
Total pot $5.25 | Rake $0.25 
Board [6d 9c 8s 9s 2s]
Seat 1: OneeONzF0MoH0pEdcBndwA folded before Flop (didn't bet)
Seat 2: tGsFgUKjSctVaAXabrlZxw (button) folded before Flop (didn't bet)
Seat 4: 0QdZrkFD7aGKeBXPGbIomA (small blind) folded before Flop
Seat 5: e0pV1oisCAilWiG0FCxY6A (big blind) folded before Flop
Seat 6: jQL6XIewylQ8MmZhhq2YFg showed [Ah 9h] and lost with three of a kind, Nines
Seat 7: XGCfQsxa6PfAg3kJtzUmww folded before Flop (didn't bet)
Seat 8: Z5y2J55JmfLYR6/DPAGHwQ showed [Ks Qs] and won ($5) with a flush, King high
Seat 9: H5Se03ZqSX7tbULXur2MAg folded before Flop (didn't bet)




PokerStars Game #59941615614:  Hold'em No Limit ($0.10/$0.25) - 2009/07/01 1:40:49 ET
Table 'wPWRBZPJl1HAnysw7qRR0A' 6-max Seat #1 is the button
Seat 1: m7ne1MOFTQXlsXT7/R/rug ($9.15 in chips) 
Seat 3: 1ZpoLWO2nm2w1Nd1v9Sr3g ($6.40 in chips) 
Seat 4: epAUIB7h2FJXzUPRIvSkRA ($25 in chips) 
Seat 5: y0B+UpYpOUJz3JWtlJQBSA ($21.45 in chips) 
Seat 6: Hsvkc0/G2VV78oVmWYXecw ($5 in chips) 
1ZpoLWO2nm2w1Nd1v9Sr3g: posts small blind $0.10
epAUIB7h2FJXzUPRIvSkRA: posts big blind $0.25
*** HOLE CARDS ***
y0B+UpYpOUJz3JWtlJQBSA: folds 
Hsvkc0/G2VV78oVmWYXecw: folds 
m7ne1MOFTQXlsXT7/R/rug: folds 
ripbrokeith joins the table at seat #2 
1ZpoLWO2nm2w1Nd1v9Sr3g: raises $0.50 to $0.75
epAUIB7h2FJXzUPRIvSkRA: calls $0.50
*** FLOP *** [9s Jh Ac]
1ZpoLWO2nm2w1Nd1v9Sr3g: checks 
epAUIB7h2FJXzUPRIvSkRA: bets $1
1ZpoLWO2nm2w1Nd1v9Sr3g: folds 
Uncalled bet ($1) returned to epAUIB7h2FJXzUPRIvSkRA
epAUIB7h2FJXzUPRIvSkRA collected $1.45 from pot
epAUIB7h2FJXzUPRIvSkRA: doesn't show hand 
*** SUMMARY ***
Total pot $1.50 | Rake $0.05 
Board [9s Jh Ac]
Seat 1: m7ne1MOFTQXlsXT7/R/rug (button) folded before Flop (didn't bet)
Seat 3: 1ZpoLWO2nm2w1Nd1v9Sr3g (small blind) folded on the Flop
Seat 4: epAUIB7h2FJXzUPRIvSkRA (big blind) collected ($1.45)
Seat 5: y0B+UpYpOUJz3JWtlJQBSA folded before Flop (didn't bet)
Seat 6: Hsvkc0/G2VV78oVmWYXecw folded before Flop (didn't bet)




PokerStars Game #59941615820:  Hold'em No Limit ($0.10/$0.25) - 2009/07/01 1:40:49 ET
Table 'fIMYcWwN4/aXFJvH5Z8Ymg' 6-max Seat #1 is the button
Seat 1: DihMHaz4WNETH1bPDe13kA ($25 in chips) 
Seat 2: vu2kzHaDtgr6NM7rdq0chA ($26.55 in chips) 
Seat 4: 32YL2ZEp8NT4JB2RVM9euQ ($42.75 in chips) 
Seat 5: lquriepNQBhDV5P1SWHhnA ($25 in chips) 
Seat 6: jp34e617tIzV8tKIWmfAbA ($28 in chips) 
vu2kzHaDtgr6NM7rdq0chA: posts small blind $0.10
bWbV4MVB/vVpiES1Ut4hew: is sitting out 
bWbV4MVB/vVpiES1Ut4hew leaves the table
32YL2ZEp8NT4JB2RVM9euQ: posts big blind $0.25
*** HOLE CARDS ***
lquriepNQBhDV5P1SWHhnA: folds 
jp34e617tIzV8tKIWmfAbA: raises $0.50 to $0.75
geomdnb joins the table at seat #3 
DihMHaz4WNETH1bPDe13kA: folds 
vu2kzHaDtgr6NM7rdq0chA: folds 
32YL2ZEp8NT4JB2RVM9euQ: folds 
Uncalled bet ($0.50) returned to jp34e617tIzV8tKIWmfAbA
jp34e617tIzV8tKIWmfAbA collected $0.60 from pot
jp34e617tIzV8tKIWmfAbA: doesn't show hand 
*** SUMMARY ***
Total pot $0.60 | Rake $0 
Seat 1: DihMHaz4WNETH1bPDe13kA (button) folded before Flop (didn't bet)
Seat 2: vu2kzHaDtgr6NM7rdq0chA (small blind) folded before Flop
Seat 4: 32YL2ZEp8NT4JB2RVM9euQ (big blind) folded before Flop
Seat 5: lquriepNQBhDV5P1SWHhnA folded before Flop (didn't bet)
Seat 6: jp34e617tIzV8tKIWmfAbA collected ($0.60)




PokerStars Game #59941615470:  Hold'em No Limit ($0.10/$0.25) - 2009/07/01 1:40:49 ET
Table 'tErGGDyESv/0llKumVeZuQ' 9-max Seat #5 is the button
Seat 2: pN3IHvAKm2fz+sTRARTcrg ($24.65 in chips) 
Seat 3: cFmpjvcjNoVAEAIQIxWkYg ($25 in chips) 
Seat 5: 6RQUxA3jk+ePxB/+Hc0IKw ($13.85 in chips) 
Seat 6: zDrucyjVn5aeekNEc3cJrA ($31.35 in chips) 
Seat 7: uhrboV251dcgYniYTdFIcA ($26.95 in chips) 
Seat 8: UD63hhjq5lMoGqYLFTcH1A ($33.75 in chips) 
Seat 9: d6n762oPkegG086ZJyV5MA ($18 in chips) 
zDrucyjVn5aeekNEc3cJrA: posts small blind $0.10
uhrboV251dcgYniYTdFIcA: posts big blind $0.25
3PmVnC/15cl4oyI1TKIt4g: sits out 
yqkowiRWZ6NvRN9UUkYIlA: sits out 
*** HOLE CARDS ***
UD63hhjq5lMoGqYLFTcH1A: raises $0.50 to $0.75
d6n762oPkegG086ZJyV5MA: folds 
pN3IHvAKm2fz+sTRARTcrg: folds 
cFmpjvcjNoVAEAIQIxWkYg: folds 
6RQUxA3jk+ePxB/+Hc0IKw: folds 
zDrucyjVn5aeekNEc3cJrA: calls $0.65
uhrboV251dcgYniYTdFIcA: folds 
*** FLOP *** [5s Kh 9c]
zDrucyjVn5aeekNEc3cJrA: bets $2.50
UD63hhjq5lMoGqYLFTcH1A: raises $2.50 to $5
zDrucyjVn5aeekNEc3cJrA: raises $25.60 to $30.60 and is all-in
UD63hhjq5lMoGqYLFTcH1A: calls $25.60
*** TURN *** [5s Kh 9c] [Qs]
*** RIVER *** [5s Kh 9c Qs] [Qd]
*** SHOW DOWN ***
zDrucyjVn5aeekNEc3cJrA: shows [9h 9s] (a full house, Nines full of Queens)
UD63hhjq5lMoGqYLFTcH1A: mucks hand 
zDrucyjVn5aeekNEc3cJrA collected $59.95 from pot
zDrucyjVn5aeekNEc3cJrA is sitting out
*** SUMMARY ***
Total pot $62.95 | Rake $3 
Board [5s Kh 9c Qs Qd]
Seat 2: pN3IHvAKm2fz+sTRARTcrg folded before Flop (didn't bet)
Seat 3: cFmpjvcjNoVAEAIQIxWkYg folded before Flop (didn't bet)
Seat 5: 6RQUxA3jk+ePxB/+Hc0IKw (button) folded before Flop (didn't bet)
Seat 6: zDrucyjVn5aeekNEc3cJrA (small blind) showed [9h 9s] and won ($59.95) with a full house, Nines full of Queens
Seat 7: uhrboV251dcgYniYTdFIcA (big blind) folded before Flop
Seat 8: UD63hhjq5lMoGqYLFTcH1A mucked
Seat 9: d6n762oPkegG086ZJyV5MA folded before Flop (didn't bet)




PokerStars Game #59941615750:  Hold'em No Limit ($0.10/$0.25) - 2009/07/01 1:40:49 ET
Table '2O5CgfSkSwrr4PDrlZ1RLQ' 6-max Seat #6 is the button
Seat 1: 3skmHD9EOATKdUzzyHh1KA ($29.50 in chips) 
Seat 2: wqphQtauX5Qn7WRJZS1flA ($25.70 in chips) 
Seat 3: oBUDUfeUyCbZBsjxHZgSiw ($30 in chips) 
Seat 4: 2Ga+TibtZsUCp1MLaueYVA ($25 in chips) 
Seat 5: 0av6tRNdi0Ui4f15L7gsVg ($21.90 in chips) 
Seat 6: tj9xqoqQaDaFw7u1oyZrtA ($43.85 in chips) 
3skmHD9EOATKdUzzyHh1KA: posts small blind $0.10
wqphQtauX5Qn7WRJZS1flA: posts big blind $0.25
*** HOLE CARDS ***
oBUDUfeUyCbZBsjxHZgSiw: folds 
2Ga+TibtZsUCp1MLaueYVA: folds 
0av6tRNdi0Ui4f15L7gsVg: folds 
tj9xqoqQaDaFw7u1oyZrtA: raises $0.25 to $0.50
3skmHD9EOATKdUzzyHh1KA: folds 
wqphQtauX5Qn7WRJZS1flA: folds 
Uncalled bet ($0.25) returned to tj9xqoqQaDaFw7u1oyZrtA
tj9xqoqQaDaFw7u1oyZrtA collected $0.60 from pot
tj9xqoqQaDaFw7u1oyZrtA: doesn't show hand 
*** SUMMARY ***
Total pot $0.60 | Rake $0 
Seat 1: 3skmHD9EOATKdUzzyHh1KA (small blind) folded before Flop
Seat 2: wqphQtauX5Qn7WRJZS1flA (big blind) folded before Flop
Seat 3: oBUDUfeUyCbZBsjxHZgSiw folded before Flop (didn't bet)
Seat 4: 2Ga+TibtZsUCp1MLaueYVA folded before Flop (didn't bet)
Seat 5: 0av6tRNdi0Ui4f15L7gsVg folded before Flop (didn't bet)
Seat 6: tj9xqoqQaDaFw7u1oyZrtA (button) collected ($0.60)




PokerStars Game #59941615648:  Hold'em No Limit ($0.10/$0.25) - 2009/07/01 1:40:49 ET
Table 'l57rayEpPtZotP9nqgSWBg' 6-max Seat #6 is the button
Seat 1: DihMHaz4WNETH1bPDe13kA ($55.85 in chips) 
Seat 2: p6adJRMXMBLr+xtQzqazIQ ($16.40 in chips) 
Seat 3: L3/N/gliETan8N5Gim5h4Q ($25 in chips) 
Seat 4: OqkdGXy1SCzuN5Q0wNlFSg ($18.20 in chips) 
Seat 5: WKJHaZPUgrpTVyLOEjLYmg ($15 in chips) 
Seat 6: IGRfskE1v9H9Bn+fz8AgNQ ($17.30 in chips) 
DihMHaz4WNETH1bPDe13kA: posts small blind $0.10
p6adJRMXMBLr+xtQzqazIQ: posts big blind $0.25
WKJHaZPUgrpTVyLOEjLYmg: posts small blind $0.10
*** HOLE CARDS ***
L3/N/gliETan8N5Gim5h4Q: folds 
OqkdGXy1SCzuN5Q0wNlFSg: raises $0.50 to $0.75
WKJHaZPUgrpTVyLOEjLYmg: calls $0.75
IGRfskE1v9H9Bn+fz8AgNQ: folds 
DihMHaz4WNETH1bPDe13kA: folds 
p6adJRMXMBLr+xtQzqazIQ: calls $0.50
*** FLOP *** [9c 6h Jd]
p6adJRMXMBLr+xtQzqazIQ: checks 
OqkdGXy1SCzuN5Q0wNlFSg: bets $1.25
WKJHaZPUgrpTVyLOEjLYmg: calls $1.25
p6adJRMXMBLr+xtQzqazIQ: folds 
*** TURN *** [9c 6h Jd] [3h]
OqkdGXy1SCzuN5Q0wNlFSg: checks 
WKJHaZPUgrpTVyLOEjLYmg: checks 
*** RIVER *** [9c 6h Jd 3h] [9d]
OqkdGXy1SCzuN5Q0wNlFSg: checks 
WKJHaZPUgrpTVyLOEjLYmg: bets $2.25
OqkdGXy1SCzuN5Q0wNlFSg: calls $2.25
*** SHOW DOWN ***
WKJHaZPUgrpTVyLOEjLYmg: shows [Ks Qc] (a pair of Nines)
OqkdGXy1SCzuN5Q0wNlFSg: shows [Jh Kd] (two pair, Jacks and Nines)
OqkdGXy1SCzuN5Q0wNlFSg collected $9 from pot
*** SUMMARY ***
Total pot $9.45 | Rake $0.45 
Board [9c 6h Jd 3h 9d]
Seat 1: DihMHaz4WNETH1bPDe13kA (small blind) folded before Flop
Seat 2: p6adJRMXMBLr+xtQzqazIQ (big blind) folded on the Flop
Seat 3: L3/N/gliETan8N5Gim5h4Q folded before Flop (didn't bet)
Seat 4: OqkdGXy1SCzuN5Q0wNlFSg showed [Jh Kd] and won ($9) with two pair, Jacks and Nines
Seat 5: WKJHaZPUgrpTVyLOEjLYmg showed [Ks Qc] and lost with a pair of Nines
Seat 6: IGRfskE1v9H9Bn+fz8AgNQ (button) folded before Flop (didn't bet)




PokerStars Game #59941615530:  Hold'em No Limit ($0.10/$0.25) - 2009/07/01 1:40:49 ET
Table 'AHkg4ChqzcMauBx6Qvz8Nw' 6-max Seat #4 is the button
Seat 1: +RDf7SmUjY2kK0PzdBEYqg ($4.10 in chips) 
Seat 2: Vi0JMrTI2BGrPL7UIulJtA ($5.90 in chips) 
Seat 3: 9dToMv2GJLfi00HcpfMnIw ($24.65 in chips) 
Seat 4: Eznneya0vB6S+eXJdVleHA ($19.65 in chips) 
Seat 5: Bada343Si4xKu3fNXY99AA ($5.95 in chips) 
Seat 6: Hsvkc0/G2VV78oVmWYXecw ($5.10 in chips) 
Bada343Si4xKu3fNXY99AA: posts small blind $0.10
Hsvkc0/G2VV78oVmWYXecw: posts big blind $0.25
*** HOLE CARDS ***
+RDf7SmUjY2kK0PzdBEYqg: calls $0.25
Vi0JMrTI2BGrPL7UIulJtA has timed out while being disconnected
Vi0JMrTI2BGrPL7UIulJtA: folds 
Vi0JMrTI2BGrPL7UIulJtA is sitting out
9dToMv2GJLfi00HcpfMnIw: folds 
Eznneya0vB6S+eXJdVleHA: calls $0.25
Bada343Si4xKu3fNXY99AA: calls $0.15
Vi0JMrTI2BGrPL7UIulJtA is disconnected 
Hsvkc0/G2VV78oVmWYXecw: checks 
*** FLOP *** [Kh 2c 4s]
Vi0JMrTI2BGrPL7UIulJtA is connected 
Bada343Si4xKu3fNXY99AA: checks 
Hsvkc0/G2VV78oVmWYXecw: checks 
+RDf7SmUjY2kK0PzdBEYqg: checks 
Eznneya0vB6S+eXJdVleHA: bets $0.25
Bada343Si4xKu3fNXY99AA: folds 
Hsvkc0/G2VV78oVmWYXecw: folds 
+RDf7SmUjY2kK0PzdBEYqg: calls $0.25
*** TURN *** [Kh 2c 4s] [Ah]
+RDf7SmUjY2kK0PzdBEYqg: checks 
Eznneya0vB6S+eXJdVleHA: bets $0.25
+RDf7SmUjY2kK0PzdBEYqg: raises $0.25 to $0.50
Vi0JMrTI2BGrPL7UIulJtA has returned
Eznneya0vB6S+eXJdVleHA: calls $0.25
*** RIVER *** [Kh 2c 4s Ah] [6d]
+RDf7SmUjY2kK0PzdBEYqg: bets $1
Eznneya0vB6S+eXJdVleHA: folds 
Uncalled bet ($1) returned to +RDf7SmUjY2kK0PzdBEYqg
+RDf7SmUjY2kK0PzdBEYqg collected $2.40 from pot
*** SUMMARY ***
Total pot $2.50 | Rake $0.10 
Board [Kh 2c 4s Ah 6d]
Seat 1: +RDf7SmUjY2kK0PzdBEYqg collected ($2.40)
Seat 2: Vi0JMrTI2BGrPL7UIulJtA folded before Flop (didn't bet)
Seat 3: 9dToMv2GJLfi00HcpfMnIw folded before Flop (didn't bet)
Seat 4: Eznneya0vB6S+eXJdVleHA (button) folded on the River
Seat 5: Bada343Si4xKu3fNXY99AA (small blind) folded on the Flop
Seat 6: Hsvkc0/G2VV78oVmWYXecw (big blind) folded on the Flop




PokerStars Game #59941615474:  Hold'em No Limit ($0.10/$0.25) - 2009/07/01 1:40:49 ET
Table 'oJpFwZj9+FUGHX90Un8s9Q' 6-max Seat #2 is the button
Seat 1: 6DwBRH+xZ12AAZmeAg+aXw ($22.95 in chips) 
Seat 2: NtrVQ9UIql0rDCnKDKZ5FQ ($7.60 in chips) 
Seat 3: kyRaCIljYA6l33lSKQfNsg ($24.75 in chips) 
Seat 4: 6elpmfyt4Zw0yvd8lePSMQ ($23.15 in chips) 
Seat 5: kG34n23qFQA3nzdOJTQ1dA ($56.45 in chips) 
Seat 6: edio/rLJ06xeZOfLhoL3UA ($9 in chips) 
kyRaCIljYA6l33lSKQfNsg: posts small blind $0.10
6elpmfyt4Zw0yvd8lePSMQ: posts big blind $0.25
*** HOLE CARDS ***
kG34n23qFQA3nzdOJTQ1dA: folds 
edio/rLJ06xeZOfLhoL3UA: folds 
6DwBRH+xZ12AAZmeAg+aXw: folds 
NtrVQ9UIql0rDCnKDKZ5FQ: folds 
kyRaCIljYA6l33lSKQfNsg: folds 
Uncalled bet ($0.15) returned to 6elpmfyt4Zw0yvd8lePSMQ
6elpmfyt4Zw0yvd8lePSMQ collected $0.20 from pot
6elpmfyt4Zw0yvd8lePSMQ: doesn't show hand 
*** SUMMARY ***
Total pot $0.20 | Rake $0 
Seat 1: 6DwBRH+xZ12AAZmeAg+aXw folded before Flop (didn't bet)
Seat 2: NtrVQ9UIql0rDCnKDKZ5FQ (button) folded before Flop (didn't bet)
Seat 3: kyRaCIljYA6l33lSKQfNsg (small blind) folded before Flop
Seat 4: 6elpmfyt4Zw0yvd8lePSMQ (big blind) collected ($0.20)
Seat 5: kG34n23qFQA3nzdOJTQ1dA folded before Flop (didn't bet)
Seat 6: edio/rLJ06xeZOfLhoL3UA folded before Flop (didn't bet)




PokerStars Game #59941616026:  Hold'em No Limit ($0.10/$0.25) - 2009/07/01 1:40:50 ET
Table 'xPn6TS/y/OWkX7Qa+MUuKA' 6-max Seat #6 is the button
Seat 1: JFIAqU8lCZ0vWwEl4bdGsg ($43.15 in chips) 
Seat 2: buyjetgNT1McXtdaP4zynA ($31.85 in chips) 
Seat 3: q6WfTUAD9mowIP63ASq2Dg ($25.90 in chips) 
Seat 4: SS/yfeArhULzIcOPe8MdPg ($25.90 in chips) 
Seat 5: lquriepNQBhDV5P1SWHhnA ($25.45 in chips) 
Seat 6: DihMHaz4WNETH1bPDe13kA ($25 in chips) 
JFIAqU8lCZ0vWwEl4bdGsg: posts small blind $0.10
buyjetgNT1McXtdaP4zynA: posts big blind $0.25
*** HOLE CARDS ***
q6WfTUAD9mowIP63ASq2Dg: folds 
SS/yfeArhULzIcOPe8MdPg: raises $0.75 to $1
lquriepNQBhDV5P1SWHhnA: folds 
DihMHaz4WNETH1bPDe13kA: folds 
JFIAqU8lCZ0vWwEl4bdGsg: folds 
buyjetgNT1McXtdaP4zynA: calls $0.75
*** FLOP *** [Ah Qh 5h]
buyjetgNT1McXtdaP4zynA: checks 
SS/yfeArhULzIcOPe8MdPg: bets $1.25
buyjetgNT1McXtdaP4zynA: folds 
Uncalled bet ($1.25) returned to SS/yfeArhULzIcOPe8MdPg
SS/yfeArhULzIcOPe8MdPg collected $2 from pot
*** SUMMARY ***
Total pot $2.10 | Rake $0.10 
Board [Ah Qh 5h]
Seat 1: JFIAqU8lCZ0vWwEl4bdGsg (small blind) folded before Flop
Seat 2: buyjetgNT1McXtdaP4zynA (big blind) folded on the Flop
Seat 3: q6WfTUAD9mowIP63ASq2Dg folded before Flop (didn't bet)
Seat 4: SS/yfeArhULzIcOPe8MdPg collected ($2)
Seat 5: lquriepNQBhDV5P1SWHhnA folded before Flop (didn't bet)
Seat 6: DihMHaz4WNETH1bPDe13kA (button) folded before Flop (didn't bet)




PokerStars Game #59941616320:  Hold'em No Limit ($0.10/$0.25) - 2009/07/01 1:40:50 ET
Table 'FE/j6VqBY4j9Uq+VHURQCQ' 6-max Seat #3 is the button
Seat 1: ypmjhffk/YHGc51wgVXUTw ($40.85 in chips) 
Seat 2: 3zD3qLXT1bEffAoWGnc7wg ($40.50 in chips) 
Seat 3: lBoEwOFgzcERLIRUkUoRTw ($27.70 in chips) 
Seat 4: 7JyPCA0J2grhXQYxe1h3+A ($21.70 in chips) 
Seat 5: 4x9jCqgSw4272dnaIqnanw ($7.80 in chips) 
Seat 6: rpJ2ie+vculq8yrHlngRHQ ($18.95 in chips) 
7JyPCA0J2grhXQYxe1h3+A: posts small blind $0.10
4x9jCqgSw4272dnaIqnanw: posts big blind $0.25
*** HOLE CARDS ***
rpJ2ie+vculq8yrHlngRHQ: folds 
ypmjhffk/YHGc51wgVXUTw: folds 
3zD3qLXT1bEffAoWGnc7wg: raises $0.50 to $0.75
lBoEwOFgzcERLIRUkUoRTw: folds 
7JyPCA0J2grhXQYxe1h3+A: calls $0.65
4x9jCqgSw4272dnaIqnanw: folds 
*** FLOP *** [9c Tc 5s]
7JyPCA0J2grhXQYxe1h3+A: checks 
3zD3qLXT1bEffAoWGnc7wg: checks 
*** TURN *** [9c Tc 5s] [5c]
7JyPCA0J2grhXQYxe1h3+A: checks 
3zD3qLXT1bEffAoWGnc7wg: checks 
*** RIVER *** [9c Tc 5s 5c] [2h]
7JyPCA0J2grhXQYxe1h3+A: checks 
3zD3qLXT1bEffAoWGnc7wg: checks 
*** SHOW DOWN ***
7JyPCA0J2grhXQYxe1h3+A: shows [9d Qd] (two pair, Nines and Fives)
3zD3qLXT1bEffAoWGnc7wg: mucks hand 
7JyPCA0J2grhXQYxe1h3+A collected $1.70 from pot
*** SUMMARY ***
Total pot $1.75 | Rake $0.05 
Board [9c Tc 5s 5c 2h]
Seat 1: ypmjhffk/YHGc51wgVXUTw folded before Flop (didn't bet)
Seat 2: 3zD3qLXT1bEffAoWGnc7wg mucked
Seat 3: lBoEwOFgzcERLIRUkUoRTw (button) folded before Flop (didn't bet)
Seat 4: 7JyPCA0J2grhXQYxe1h3+A (small blind) showed [9d Qd] and won ($1.70) with two pair, Nines and Fives
Seat 5: 4x9jCqgSw4272dnaIqnanw (big blind) folded before Flop
Seat 6: rpJ2ie+vculq8yrHlngRHQ folded before Flop (didn't bet)




PokerStars Game #59941616120:  Hold'em No Limit ($0.10/$0.25) - 2009/07/01 1:40:50 ET
Table '9o8Yb3JpUqurD4pNVmOikQ' 6-max Seat #1 is the button
Seat 1: SFmT9ZsVopnukjvAzrxTRg ($25.85 in chips) 
Seat 2: /gJNBeCkWL4o85/jvlZ4BA ($25 in chips) 
Seat 3: JgRqo1/2phbf7pab7N3BIQ ($24.55 in chips) 
Seat 4: j5NZbEJHsERuXjPHWqc1Nw ($8.75 in chips) 
Seat 5: L/ayP3FdbcybmfF6diPHaA ($15.80 in chips) 
Seat 6: LyDHtw3/yniNHW+DvLXbog ($26.05 in chips) 
/gJNBeCkWL4o85/jvlZ4BA: posts small blind $0.10
JgRqo1/2phbf7pab7N3BIQ: posts big blind $0.25
*** HOLE CARDS ***
j5NZbEJHsERuXjPHWqc1Nw: folds 
L/ayP3FdbcybmfF6diPHaA: calls $0.25
LyDHtw3/yniNHW+DvLXbog: folds 
SFmT9ZsVopnukjvAzrxTRg: raises $1 to $1.25
/gJNBeCkWL4o85/jvlZ4BA: folds 
JgRqo1/2phbf7pab7N3BIQ: folds 
L/ayP3FdbcybmfF6diPHaA: calls $1
*** FLOP *** [9s 9d As]
L/ayP3FdbcybmfF6diPHaA: bets $0.25
SFmT9ZsVopnukjvAzrxTRg: raises $1.25 to $1.50
L/ayP3FdbcybmfF6diPHaA: folds 
Uncalled bet ($1.25) returned to SFmT9ZsVopnukjvAzrxTRg
SFmT9ZsVopnukjvAzrxTRg collected $3.20 from pot
SFmT9ZsVopnukjvAzrxTRg: doesn't show hand 
*** SUMMARY ***
Total pot $3.35 | Rake $0.15 
Board [9s 9d As]
Seat 1: SFmT9ZsVopnukjvAzrxTRg (button) collected ($3.20)
Seat 2: /gJNBeCkWL4o85/jvlZ4BA (small blind) folded before Flop
Seat 3: JgRqo1/2phbf7pab7N3BIQ (big blind) folded before Flop
Seat 4: j5NZbEJHsERuXjPHWqc1Nw folded before Flop (didn't bet)
Seat 5: L/ayP3FdbcybmfF6diPHaA folded on the Flop
Seat 6: LyDHtw3/yniNHW+DvLXbog folded before Flop (didn't bet)




PokerStars Game #59941616144:  Hold'em No Limit ($0.10/$0.25) - 2009/07/01 1:40:50 ET
Table 'axb9RsG8Zj1A0LEukTeFrQ' 9-max Seat #7 is the button
Seat 1: qwr38jl5txoR36M7G5qi4A ($8.85 in chips) 
Seat 3: H5Se03ZqSX7tbULXur2MAg ($25.10 in chips) 
Seat 4: tLcDklc2rBORNfixyRfVfw ($27.45 in chips) 
Seat 5: rLSSHKOHnb6yzVfDoQM/RA ($15.10 in chips) 
Seat 7: PdIasPkzm2sqZnN41ZRXOg ($5 in chips) 
Seat 8: VBHxUExRAMrbxUq/cVx9Gw ($4.40 in chips) 
Seat 9: qbQE8CifKB4+OEvNF/61Rw ($55.85 in chips) 
VBHxUExRAMrbxUq/cVx9Gw: posts small blind $0.10
qbQE8CifKB4+OEvNF/61Rw: posts big blind $0.25
*** HOLE CARDS ***
qwr38jl5txoR36M7G5qi4A: folds 
H5Se03ZqSX7tbULXur2MAg: folds 
tLcDklc2rBORNfixyRfVfw: folds 
rLSSHKOHnb6yzVfDoQM/RA: folds 
PdIasPkzm2sqZnN41ZRXOg: folds 
VBHxUExRAMrbxUq/cVx9Gw: folds 
Uncalled bet ($0.15) returned to qbQE8CifKB4+OEvNF/61Rw
qbQE8CifKB4+OEvNF/61Rw collected $0.20 from pot
qbQE8CifKB4+OEvNF/61Rw: doesn't show hand 
*** SUMMARY ***
Total pot $0.20 | Rake $0 
Seat 1: qwr38jl5txoR36M7G5qi4A folded before Flop (didn't bet)
Seat 3: H5Se03ZqSX7tbULXur2MAg folded before Flop (didn't bet)
Seat 4: tLcDklc2rBORNfixyRfVfw folded before Flop (didn't bet)
Seat 5: rLSSHKOHnb6yzVfDoQM/RA folded before Flop (didn't bet)
Seat 7: PdIasPkzm2sqZnN41ZRXOg (button) folded before Flop (didn't bet)
Seat 8: VBHxUExRAMrbxUq/cVx9Gw (small blind) folded before Flop
Seat 9: qbQE8CifKB4+OEvNF/61Rw (big blind) collected ($0.20)




PokerStars Game #59941616462:  Hold'em No Limit ($0.10/$0.25) - 2009/07/01 1:40:50 ET
Table 'nc6OeGk/wtaWV+6N+kgnZQgZetDqJh6q9A3mLO3ThCsASeat #1 is the button
Seat 1: DihMHaz4WNETH1bPDe13kA ($26.30 in chips) 
Seat 2: JFIAqU8lCZ0vWwEl4bdGsg ($33.15 in chips) 
Seat 3: jp34e617tIzV8tKIWmfAbA ($33.15 in chips) 
Seat 4: BV+K0Phf5VBHr7aZPKqbUQ ($29 in chips) 
Seat 6: 8tR2s7yV/Fr0ePp1w5XnJw ($9.65 in chips) 
JFIAqU8lCZ0vWwEl4bdGsg: posts small blind $0.10
jp34e617tIzV8tKIWmfAbA: posts big blind $0.25
*** HOLE CARDS ***
BV+K0Phf5VBHr7aZPKqbUQ: folds 
8tR2s7yV/Fr0ePp1w5XnJw: folds 
DihMHaz4WNETH1bPDe13kA: raises $0.50 to $0.75
JFIAqU8lCZ0vWwEl4bdGsg: folds 
jp34e617tIzV8tKIWmfAbA: folds 
Uncalled bet ($0.50) returned to DihMHaz4WNETH1bPDe13kA
DihMHaz4WNETH1bPDe13kA collected $0.60 from pot
*** SUMMARY ***
Total pot $0.60 | Rake $0 
Seat 1: DihMHaz4WNETH1bPDe13kA (button) collected ($0.60)
Seat 2: JFIAqU8lCZ0vWwEl4bdGsg (small blind) folded before Flop
Seat 3: jp34e617tIzV8tKIWmfAbA (big blind) folded before Flop
Seat 4: BV+K0Phf5VBHr7aZPKqbUQ folded before Flop (didn't bet)
Seat 6: 8tR2s7yV/Fr0ePp1w5XnJw folded before Flop (didn't bet)




PokerStars Game #59941616478:  Hold'em No Limit ($0.10/$0.25) - 2009/07/01 1:40:50 ET
Table 'nyTW9cVtYentc5V7xU/0jA' 6-max Seat #4 is the button
Seat 1: HI20pVxSHPZ29u9IDkmICg ($10.15 in chips) 
Seat 2: v6mkGzCBCCXcgWQNSYVtKg ($7 in chips) 
Seat 3: kG34n23qFQA3nzdOJTQ1dA ($36.45 in chips) 
Seat 4: NkB3D4eVHHXvB9Edaugc1Q ($19.85 in chips) 
Seat 5: zZAcuQ0EvirdEuiIbeaocQ ($14.70 in chips) 
zZAcuQ0EvirdEuiIbeaocQ: posts small blind $0.10
HI20pVxSHPZ29u9IDkmICg: posts big blind $0.25
v6mkGzCBCCXcgWQNSYVtKg: posts big blind $0.25
*** HOLE CARDS ***
v6mkGzCBCCXcgWQNSYVtKg: checks 
kG34n23qFQA3nzdOJTQ1dA: folds 
NkB3D4eVHHXvB9Edaugc1Q: calls $0.25
zZAcuQ0EvirdEuiIbeaocQ: calls $0.15
HI20pVxSHPZ29u9IDkmICg: checks 
*** FLOP *** [Ts Js Qc]
zZAcuQ0EvirdEuiIbeaocQ: checks 
HI20pVxSHPZ29u9IDkmICg: checks 
v6mkGzCBCCXcgWQNSYVtKg: bets $0.25
NkB3D4eVHHXvB9Edaugc1Q: raises $0.75 to $1
zZAcuQ0EvirdEuiIbeaocQ: folds 
HI20pVxSHPZ29u9IDkmICg: folds 
v6mkGzCBCCXcgWQNSYVtKg: folds 
Uncalled bet ($0.75) returned to NkB3D4eVHHXvB9Edaugc1Q
NkB3D4eVHHXvB9Edaugc1Q collected $1.45 from pot
NkB3D4eVHHXvB9Edaugc1Q: doesn't show hand 
*** SUMMARY ***
Total pot $1.50 | Rake $0.05 
Board [Ts Js Qc]
Seat 1: HI20pVxSHPZ29u9IDkmICg (big blind) folded on the Flop
Seat 2: v6mkGzCBCCXcgWQNSYVtKg folded on the Flop
Seat 3: kG34n23qFQA3nzdOJTQ1dA folded before Flop (didn't bet)
Seat 4: NkB3D4eVHHXvB9Edaugc1Q (button) collected ($1.45)
Seat 5: zZAcuQ0EvirdEuiIbeaocQ (small blind) folded on the Flop




PokerStars Game #59941616376:  Hold'em No Limit ($0.10/$0.25) - 2009/07/01 1:40:50 ET
Table 'G26g8jde1eR+mmabeFeSlw' 9-max Seat #3 is the button
Seat 1: qpG9m8I+cPw8VhB0mnGjYw ($29.40 in chips) 
Seat 2: BFYwQ0J4xWUQvouudojivA ($15.85 in chips) 
Seat 3: WKL8nUFr7TumC4EjLyqYzw ($6.50 in chips) 
Seat 4: 8EbrQ/EvFWt2cr0GaU82gQ ($4.75 in chips) 
Seat 5: hJ4uYjNmSZdjrKA8cjZqCA ($28.65 in chips) 
Seat 6: AHGkesF/mi4sDMpqrxBUoA ($9.05 in chips) 
Seat 7: nm4Dj/f+jJEwKVsUnKh73g ($38.80 in chips) 
Seat 8: bXpVeaSTPBFSPJmeXxO7nw ($5.35 in chips) 
Seat 9: VWUWpMLMj/Q1jRVpF7Aohw ($6.15 in chips) 
8EbrQ/EvFWt2cr0GaU82gQ: posts small blind $0.10
hJ4uYjNmSZdjrKA8cjZqCA: posts big blind $0.25
*** HOLE CARDS ***
AHGkesF/mi4sDMpqrxBUoA: folds 
nm4Dj/f+jJEwKVsUnKh73g: folds 
bXpVeaSTPBFSPJmeXxO7nw: folds 
VWUWpMLMj/Q1jRVpF7Aohw: raises $0.75 to $1
qpG9m8I+cPw8VhB0mnGjYw: folds 
BFYwQ0J4xWUQvouudojivA: folds 
WKL8nUFr7TumC4EjLyqYzw: folds 
8EbrQ/EvFWt2cr0GaU82gQ: folds 
hJ4uYjNmSZdjrKA8cjZqCA: calls $0.75
*** FLOP *** [6h Th 8h]
hJ4uYjNmSZdjrKA8cjZqCA: checks 
VWUWpMLMj/Q1jRVpF7Aohw: bets $1.25
hJ4uYjNmSZdjrKA8cjZqCA: calls $1.25
*** TURN *** [6h Th 8h] [5c]
hJ4uYjNmSZdjrKA8cjZqCA: bets $8.25
VWUWpMLMj/Q1jRVpF7Aohw: folds 
Uncalled bet ($8.25) returned to hJ4uYjNmSZdjrKA8cjZqCA
hJ4uYjNmSZdjrKA8cjZqCA collected $4.40 from pot
*** SUMMARY ***
Total pot $4.60 | Rake $0.20 
Board [6h Th 8h 5c]
Seat 1: qpG9m8I+cPw8VhB0mnGjYw folded before Flop (didn't bet)
Seat 2: BFYwQ0J4xWUQvouudojivA folded before Flop (didn't bet)
Seat 3: WKL8nUFr7TumC4EjLyqYzw (button) folded before Flop (didn't bet)
Seat 4: 8EbrQ/EvFWt2cr0GaU82gQ (small blind) folded before Flop
Seat 5: hJ4uYjNmSZdjrKA8cjZqCA (big blind) collected ($4.40)
Seat 6: AHGkesF/mi4sDMpqrxBUoA folded before Flop (didn't bet)
Seat 7: nm4Dj/f+jJEwKVsUnKh73g folded before Flop (didn't bet)
Seat 8: bXpVeaSTPBFSPJmeXxO7nw folded before Flop (didn't bet)
Seat 9: VWUWpMLMj/Q1jRVpF7Aohw folded on the Turn




PokerStars Game #59941616648:  Hold'em No Limit ($0.10/$0.25) - 2009/07/01 1:40:51 ET
Table '+68ihX5Br1xgGorX6zsCBg' 9-max Seat #7 is the button
Seat 1: IFB2mhulUVYIbb+KWwDC9w ($5.20 in chips) 
Seat 2: TeAfhXG1R60d8yPEHN3JiA ($28.30 in chips) 
Seat 3: PdIasPkzm2sqZnN41ZRXOg ($5 in chips) 
Seat 4: Oi0EiPIjriUb/6zT65YeWA ($27.70 in chips) 
Seat 5: ghNKXUBl/H+t83JF079ZBA ($25.45 in chips) 
Seat 6: X78b5v/uhqeXXoAijbw/yg ($26.40 in chips) 
Seat 7: V6p0jQ/RhUsqpHLmXvEX4Q ($14.35 in chips) 
Seat 8: Ut3g/kEEdCCbe/gbWrHnDg ($12.55 in chips) 
Seat 9: DiSvPC2iudwL5j9u6Huyww ($29.80 in chips) 
Ut3g/kEEdCCbe/gbWrHnDg: posts small blind $0.10
DiSvPC2iudwL5j9u6Huyww: posts big blind $0.25
*** HOLE CARDS ***
IFB2mhulUVYIbb+KWwDC9w: calls $0.25
TeAfhXG1R60d8yPEHN3JiA: calls $0.25
PdIasPkzm2sqZnN41ZRXOg: folds 
Oi0EiPIjriUb/6zT65YeWA: folds 
ghNKXUBl/H+t83JF079ZBA: folds 
X78b5v/uhqeXXoAijbw/yg: folds 
V6p0jQ/RhUsqpHLmXvEX4Q: folds 
Ut3g/kEEdCCbe/gbWrHnDg: calls $0.15
DiSvPC2iudwL5j9u6Huyww: checks 
*** FLOP *** [Jc 9c Th]
Ut3g/kEEdCCbe/gbWrHnDg: checks 
DiSvPC2iudwL5j9u6Huyww: checks 
IFB2mhulUVYIbb+KWwDC9w: bets $0.25
TeAfhXG1R60d8yPEHN3JiA: raises $0.25 to $0.50
Ut3g/kEEdCCbe/gbWrHnDg: calls $0.50
DiSvPC2iudwL5j9u6Huyww: calls $0.50
IFB2mhulUVYIbb+KWwDC9w: calls $0.25
*** TURN *** [Jc 9c Th] [5d]
Ut3g/kEEdCCbe/gbWrHnDg: checks 
DiSvPC2iudwL5j9u6Huyww: checks 
IFB2mhulUVYIbb+KWwDC9w: checks 
TeAfhXG1R60d8yPEHN3JiA: bets $0.50
Ut3g/kEEdCCbe/gbWrHnDg: calls $0.50
DiSvPC2iudwL5j9u6Huyww: calls $0.50
IFB2mhulUVYIbb+KWwDC9w: folds 
*** RIVER *** [Jc 9c Th 5d] [9d]
Ut3g/kEEdCCbe/gbWrHnDg: checks 
DiSvPC2iudwL5j9u6Huyww: checks 
TeAfhXG1R60d8yPEHN3JiA: checks 
*** SHOW DOWN ***
Ut3g/kEEdCCbe/gbWrHnDg: shows [Ks 3c] (a pair of Nines)
DiSvPC2iudwL5j9u6Huyww: shows [Jh Kc] (two pair, Jacks and Nines)
TeAfhXG1R60d8yPEHN3JiA: mucks hand 
DiSvPC2iudwL5j9u6Huyww collected $4.30 from pot
*** SUMMARY ***
Total pot $4.50 | Rake $0.20 
Board [Jc 9c Th 5d 9d]
Seat 1: IFB2mhulUVYIbb+KWwDC9w folded on the Turn
Seat 2: TeAfhXG1R60d8yPEHN3JiA mucked
Seat 3: PdIasPkzm2sqZnN41ZRXOg folded before Flop (didn't bet)
Seat 4: Oi0EiPIjriUb/6zT65YeWA folded before Flop (didn't bet)
Seat 5: ghNKXUBl/H+t83JF079ZBA folded before Flop (didn't bet)
Seat 6: X78b5v/uhqeXXoAijbw/yg folded before Flop (didn't bet)
Seat 7: V6p0jQ/RhUsqpHLmXvEX4Q (button) folded before Flop (didn't bet)
Seat 8: Ut3g/kEEdCCbe/gbWrHnDg (small blind) showed [Ks 3c] and lost with a pair of Nines
Seat 9: DiSvPC2iudwL5j9u6Huyww (big blind) showed [Jh Kc] and won ($4.30) with two pair, Jacks and Nines




PokerStars Game #59941616690:  Hold'em No Limit ($0.10/$0.25) - 2009/07/01 1:40:51 ET
Table 'HIOfhT0zga/KonFhIl6O3w' 9-max Seat #5 is the button
Seat 1: oLa/tXLfSLLB28mcLGrxcg ($24.90 in chips) 
Seat 2: er86weqXTpTB6/w2dKlYgA ($17.10 in chips) 
Seat 4: qwr38jl5txoR36M7G5qi4A ($8.65 in chips) 
Seat 5: K1MDeapSEyKyGPNZGOKfEg ($38 in chips) 
Seat 6: MThMMgdB293VOucmN9sliQ ($24.75 in chips) 
Seat 7: wvlPJBB0PtYkfeeSRDaIvQ ($13.80 in chips) 
Seat 8: V6p0jQ/RhUsqpHLmXvEX4Q ($12.25 in chips) 
Seat 9: dfNim92Z6XK1/h5SFW5vDg ($28.70 in chips) 
MThMMgdB293VOucmN9sliQ: posts small blind $0.10
wvlPJBB0PtYkfeeSRDaIvQ: posts big blind $0.25
*** HOLE CARDS ***
V6p0jQ/RhUsqpHLmXvEX4Q: folds 
V6p0jQ/RhUsqpHLmXvEX4Q leaves the table
dfNim92Z6XK1/h5SFW5vDg: raises $0.75 to $1
oLa/tXLfSLLB28mcLGrxcg: folds 
er86weqXTpTB6/w2dKlYgA: folds 
qwr38jl5txoR36M7G5qi4A: folds 
K1MDeapSEyKyGPNZGOKfEg: folds 
MThMMgdB293VOucmN9sliQ: folds 
wvlPJBB0PtYkfeeSRDaIvQ: folds 
Uncalled bet ($0.75) returned to dfNim92Z6XK1/h5SFW5vDg
dfNim92Z6XK1/h5SFW5vDg collected $0.60 from pot
dfNim92Z6XK1/h5SFW5vDg: doesn't show hand 
*** SUMMARY ***
Total pot $0.60 | Rake $0 
Seat 1: oLa/tXLfSLLB28mcLGrxcg folded before Flop (didn't bet)
Seat 2: er86weqXTpTB6/w2dKlYgA folded before Flop (didn't bet)
Seat 4: qwr38jl5txoR36M7G5qi4A folded before Flop (didn't bet)
Seat 5: K1MDeapSEyKyGPNZGOKfEg (button) folded before Flop (didn't bet)
Seat 6: MThMMgdB293VOucmN9sliQ (small blind) folded before Flop
Seat 7: wvlPJBB0PtYkfeeSRDaIvQ (big blind) folded before Flop
Seat 8: V6p0jQ/RhUsqpHLmXvEX4Q folded before Flop (didn't bet)
Seat 9: dfNim92Z6XK1/h5SFW5vDg collected ($0.60)




PokerStars Game #59941616780:  Hold'em No Limit ($0.10/$0.25) - 2009/07/01 1:40:51 ET
Table 'sSe6q4YTb/iS19t2eCFdsA' 9-max Seat #5 is the button
Seat 1: hJ4uYjNmSZdjrKA8cjZqCA ($18.10 in chips) 
Seat 3: bXpVeaSTPBFSPJmeXxO7nw ($5.65 in chips) 
Seat 4: 22dIObOuor/A+IKWkNoAlA ($8.85 in chips) 
Seat 5: qS+jfnNoG75bT+uQ8CKhQA ($11.05 in chips) 
Seat 6: tYsOBqdU1+x+yFI7zHO7hQ ($28.10 in chips) 
Seat 7: t70KGeRtR3naHSqKDixsUg ($4.15 in chips) 
Seat 8: hvXZ0zFPZFP8Hf6dS36YEw ($14.40 in chips) 
tYsOBqdU1+x+yFI7zHO7hQ: posts small blind $0.10
t70KGeRtR3naHSqKDixsUg: posts big blind $0.25
*** HOLE CARDS ***
hvXZ0zFPZFP8Hf6dS36YEw: folds 
hJ4uYjNmSZdjrKA8cjZqCA: folds 
bXpVeaSTPBFSPJmeXxO7nw: folds 
22dIObOuor/A+IKWkNoAlA: folds 
DigiSlarks joins the table at seat #9 
qS+jfnNoG75bT+uQ8CKhQA: folds 
tYsOBqdU1+x+yFI7zHO7hQ: folds 
Uncalled bet ($0.15) returned to t70KGeRtR3naHSqKDixsUg
t70KGeRtR3naHSqKDixsUg collected $0.20 from pot
*** SUMMARY ***
Total pot $0.20 | Rake $0 
Seat 1: hJ4uYjNmSZdjrKA8cjZqCA folded before Flop (didn't bet)
Seat 3: bXpVeaSTPBFSPJmeXxO7nw folded before Flop (didn't bet)
Seat 4: 22dIObOuor/A+IKWkNoAlA folded before Flop (didn't bet)
Seat 5: qS+jfnNoG75bT+uQ8CKhQA (button) folded before Flop (didn't bet)
Seat 6: tYsOBqdU1+x+yFI7zHO7hQ (small blind) folded before Flop
Seat 7: t70KGeRtR3naHSqKDixsUg (big blind) collected ($0.20)
Seat 8: hvXZ0zFPZFP8Hf6dS36YEw folded before Flop (didn't bet)




PokerStars Game #59941616778:  Hold'em No Limit ($0.10/$0.25) - 2009/07/01 1:40:51 ET
Table 'hOE09W281uSob0XeJmUcRg' 6-max Seat #1 is the button
Seat 1: mfrkWA3PTeYPkbO6hi98Aw ($27.65 in chips) 
Seat 2: lYjWCpfCxX2kgcHY3v4Yow ($28.60 in chips) 
Seat 3: y+a/yGW/Jy4bPJFnaeTz5w ($13.40 in chips) 
Seat 4: TslQs7AQSLbVtr4X8JOOOQ ($17 in chips) 
Seat 5: JFIAqU8lCZ0vWwEl4bdGsg ($25 in chips) 
Seat 6: x4ZJ8E/TUrtoB7WiHcv8WA ($14.60 in chips) 
lYjWCpfCxX2kgcHY3v4Yow: posts small blind $0.10
y+a/yGW/Jy4bPJFnaeTz5w: posts big blind $0.25
x4ZJ8E/TUrtoB7WiHcv8WA: posts small & big blinds $0.35
*** HOLE CARDS ***
TslQs7AQSLbVtr4X8JOOOQ: folds 
TslQs7AQSLbVtr4X8JOOOQ is sitting out
JFIAqU8lCZ0vWwEl4bdGsg: folds 
x4ZJ8E/TUrtoB7WiHcv8WA: checks 
mfrkWA3PTeYPkbO6hi98Aw: folds 
lYjWCpfCxX2kgcHY3v4Yow: folds 
y+a/yGW/Jy4bPJFnaeTz5w: checks 
*** FLOP *** [7h Ts Td]
y+a/yGW/Jy4bPJFnaeTz5w: bets $0.25
x4ZJ8E/TUrtoB7WiHcv8WA: folds 
Uncalled bet ($0.25) returned to y+a/yGW/Jy4bPJFnaeTz5w
y+a/yGW/Jy4bPJFnaeTz5w collected $0.70 from pot
y+a/yGW/Jy4bPJFnaeTz5w: doesn't show hand 
*** SUMMARY ***
Total pot $0.70 | Rake $0 
Board [7h Ts Td]
Seat 1: mfrkWA3PTeYPkbO6hi98Aw (button) folded before Flop (didn't bet)
Seat 2: lYjWCpfCxX2kgcHY3v4Yow (small blind) folded before Flop
Seat 3: y+a/yGW/Jy4bPJFnaeTz5w (big blind) collected ($0.70)
Seat 4: TslQs7AQSLbVtr4X8JOOOQ folded before Flop (didn't bet)
Seat 5: JFIAqU8lCZ0vWwEl4bdGsg folded before Flop (didn't bet)
Seat 6: x4ZJ8E/TUrtoB7WiHcv8WA folded on the Flop




PokerStars Game #59941616608:  Hold'em No Limit ($0.10/$0.25) - 2009/07/01 1:40:51 ET
Table 'O6cwjhrMn9pfzx1Ngn5zkQ' 6-max Seat #5 is the button
Seat 1: LJI7A1YgDM7hgh7o56+ReQ ($28.30 in chips) 
Seat 2: tSR4329m40dZsN7YOpI9Kw ($29.70 in chips) 
Seat 3: EE16Ua5b1HSsYej5zeXOlA ($25.80 in chips) 
Seat 4: mfrkWA3PTeYPkbO6hi98Aw ($24.30 in chips) 
Seat 5: niLn0xUVlqh8If80xRjzCA ($26.90 in chips) 
Seat 6: 4TM16KVgEiQpLi4bVVWbVQ ($32.90 in chips) 
4TM16KVgEiQpLi4bVVWbVQ: posts small blind $0.10
LJI7A1YgDM7hgh7o56+ReQ: posts big blind $0.25
*** HOLE CARDS ***
tSR4329m40dZsN7YOpI9Kw: folds 
EE16Ua5b1HSsYej5zeXOlA: folds 
mfrkWA3PTeYPkbO6hi98Aw: folds 
niLn0xUVlqh8If80xRjzCA: calls $0.25
4TM16KVgEiQpLi4bVVWbVQ: calls $0.15
LJI7A1YgDM7hgh7o56+ReQ: raises $1 to $1.25
niLn0xUVlqh8If80xRjzCA: calls $1
4TM16KVgEiQpLi4bVVWbVQ: calls $1
*** FLOP *** [2s 3c 7h]
4TM16KVgEiQpLi4bVVWbVQ: checks 
LJI7A1YgDM7hgh7o56+ReQ: bets $3
niLn0xUVlqh8If80xRjzCA: folds 
4TM16KVgEiQpLi4bVVWbVQ: folds 
Uncalled bet ($3) returned to LJI7A1YgDM7hgh7o56+ReQ
LJI7A1YgDM7hgh7o56+ReQ collected $3.60 from pot
LJI7A1YgDM7hgh7o56+ReQ: doesn't show hand 
*** SUMMARY ***
Total pot $3.75 | Rake $0.15 
Board [2s 3c 7h]
Seat 1: LJI7A1YgDM7hgh7o56+ReQ (big blind) collected ($3.60)
Seat 2: tSR4329m40dZsN7YOpI9Kw folded before Flop (didn't bet)
Seat 3: EE16Ua5b1HSsYej5zeXOlA folded before Flop (didn't bet)
Seat 4: mfrkWA3PTeYPkbO6hi98Aw folded before Flop (didn't bet)
Seat 5: niLn0xUVlqh8If80xRjzCA (button) folded on the Flop
Seat 6: 4TM16KVgEiQpLi4bVVWbVQ (small blind) folded on the Flop




PokerStars Game #59941616726:  Hold'em No Limit ($0.10/$0.25) - 2009/07/01 1:40:51 ET
Table 'nlpa8xI95gAflovnFxB2yg' 6-max Seat #2 is the button
Seat 1: fZQg9veL7Dd/Z04ZTjC+wQ ($64.05 in chips) 
Seat 2: Yuyy/pDz3yAO3EbHYRYnKw ($25.15 in chips) 
Seat 3: DihMHaz4WNETH1bPDe13kA ($25.55 in chips) 
Seat 4: if4dh6jhJXeN3/qd3qCp9g ($25 in chips) 
Seat 5: FDWzjQgBA5K04jOIY/j22w ($8.95 in chips) 
Seat 6: ATNFxN8fYVfSZMQW8dvbvw ($6.15 in chips) 
DihMHaz4WNETH1bPDe13kA: posts small blind $0.10
if4dh6jhJXeN3/qd3qCp9g: posts big blind $0.25
*** HOLE CARDS ***
FDWzjQgBA5K04jOIY/j22w: calls $0.25
ATNFxN8fYVfSZMQW8dvbvw: folds 
fZQg9veL7Dd/Z04ZTjC+wQ: folds 
Yuyy/pDz3yAO3EbHYRYnKw: folds 
DihMHaz4WNETH1bPDe13kA: folds 
if4dh6jhJXeN3/qd3qCp9g: checks 
*** FLOP *** [Qc Ts 7d]
if4dh6jhJXeN3/qd3qCp9g: checks 
FDWzjQgBA5K04jOIY/j22w: bets $0.70
if4dh6jhJXeN3/qd3qCp9g: folds 
Uncalled bet ($0.70) returned to FDWzjQgBA5K04jOIY/j22w
FDWzjQgBA5K04jOIY/j22w collected $0.60 from pot
FDWzjQgBA5K04jOIY/j22w: doesn't show hand 
*** SUMMARY ***
Total pot $0.60 | Rake $0 
Board [Qc Ts 7d]
Seat 1: fZQg9veL7Dd/Z04ZTjC+wQ folded before Flop (didn't bet)
Seat 2: Yuyy/pDz3yAO3EbHYRYnKw (button) folded before Flop (didn't bet)
Seat 3: DihMHaz4WNETH1bPDe13kA (small blind) folded before Flop
Seat 4: if4dh6jhJXeN3/qd3qCp9g (big blind) folded on the Flop
Seat 5: FDWzjQgBA5K04jOIY/j22w collected ($0.60)
Seat 6: ATNFxN8fYVfSZMQW8dvbvw folded before Flop (didn't bet)




PokerStars Game #59941616550:  Hold'em No Limit ($0.10/$0.25) - 2009/07/01 1:40:51 ET
Table 'ukli1Y7ieC5JQMTEFxM2Nw' 6-max Seat #1 is the button
Seat 1: N162H80ZIQevUf2EzGahCA ($9.45 in chips) 
Seat 2: u/yN5P9f3KlATg6WLWNkBQ ($43.65 in chips) 
Seat 3: ExeoJ1G/rSmWa3tRz7TlCA ($21.45 in chips) 
Seat 4: if4dh6jhJXeN3/qd3qCp9g ($29.85 in chips) 
Seat 5: Se+H4Z4PDr6+eIUDJX1rpg ($15.95 in chips) 
Seat 6: 32YL2ZEp8NT4JB2RVM9euQ ($29.55 in chips) 
u/yN5P9f3KlATg6WLWNkBQ: posts small blind $0.10
ExeoJ1G/rSmWa3tRz7TlCA: posts big blind $0.25
*** HOLE CARDS ***
if4dh6jhJXeN3/qd3qCp9g: folds 
Se+H4Z4PDr6+eIUDJX1rpg: calls $0.25
32YL2ZEp8NT4JB2RVM9euQ: folds 
N162H80ZIQevUf2EzGahCA: calls $0.25
u/yN5P9f3KlATg6WLWNkBQ: folds 
ExeoJ1G/rSmWa3tRz7TlCA: checks 
*** FLOP *** [Qc 5c Tc]
ExeoJ1G/rSmWa3tRz7TlCA: checks 
Se+H4Z4PDr6+eIUDJX1rpg: checks 
N162H80ZIQevUf2EzGahCA: bets $0.25
ExeoJ1G/rSmWa3tRz7TlCA: folds 
Se+H4Z4PDr6+eIUDJX1rpg: folds 
Uncalled bet ($0.25) returned to N162H80ZIQevUf2EzGahCA
N162H80ZIQevUf2EzGahCA collected $0.85 from pot
N162H80ZIQevUf2EzGahCA: doesn't show hand 
*** SUMMARY ***
Total pot $0.85 | Rake $0 
Board [Qc 5c Tc]
Seat 1: N162H80ZIQevUf2EzGahCA (button) collected ($0.85)
Seat 2: u/yN5P9f3KlATg6WLWNkBQ (small blind) folded before Flop
Seat 3: ExeoJ1G/rSmWa3tRz7TlCA (big blind) folded on the Flop
Seat 4: if4dh6jhJXeN3/qd3qCp9g folded before Flop (didn't bet)
Seat 5: Se+H4Z4PDr6+eIUDJX1rpg folded on the Flop
Seat 6: 32YL2ZEp8NT4JB2RVM9euQ folded before Flop (didn't bet)




PokerStars Game #59941616966:  Hold'em No Limit ($0.10/$0.25) - 2009/07/01 1:40:51 ET
Table 'mk323gviqdkOY5Aek/1EWg' 6-max Seat #3 is the button
Seat 1: L3/N/gliETan8N5Gim5h4Q ($25.75 in chips) 
Seat 2: GC/9yVD59DUCX7hUI7gcLw ($56.40 in chips) 
Seat 3: NuqYPwTLZYQhxOoVK3Yqlw ($24.30 in chips) 
Seat 4: +baiVgI/ETnBARLe5mARCw ($12.90 in chips) 
Seat 5: kjYRzIfvZNNflYMYRkkSVA ($26.15 in chips) 
Seat 6: KkXSr5xFjxLSD3wtAvT+WQ ($8.80 in chips) 
+baiVgI/ETnBARLe5mARCw: posts small blind $0.10
kjYRzIfvZNNflYMYRkkSVA: posts big blind $0.25
*** HOLE CARDS ***
KkXSr5xFjxLSD3wtAvT+WQ: folds 
L3/N/gliETan8N5Gim5h4Q: folds 
GC/9yVD59DUCX7hUI7gcLw: folds 
NuqYPwTLZYQhxOoVK3Yqlw: raises $0.75 to $1
+baiVgI/ETnBARLe5mARCw: folds 
kjYRzIfvZNNflYMYRkkSVA: folds 
Uncalled bet ($0.75) returned to NuqYPwTLZYQhxOoVK3Yqlw
NuqYPwTLZYQhxOoVK3Yqlw collected $0.60 from pot
NuqYPwTLZYQhxOoVK3Yqlw: doesn't show hand 
*** SUMMARY ***
Total pot $0.60 | Rake $0 
Seat 1: L3/N/gliETan8N5Gim5h4Q folded before Flop (didn't bet)
Seat 2: GC/9yVD59DUCX7hUI7gcLw folded before Flop (didn't bet)
Seat 3: NuqYPwTLZYQhxOoVK3Yqlw (button) collected ($0.60)
Seat 4: +baiVgI/ETnBARLe5mARCw (small blind) folded before Flop
Seat 5: kjYRzIfvZNNflYMYRkkSVA (big blind) folded before Flop
Seat 6: KkXSr5xFjxLSD3wtAvT+WQ folded before Flop (didn't bet)




PokerStars Game #59941617498:  Hold'em No Limit ($0.10/$0.25) - 2009/07/01 1:40:52 ET
Table '5NipxzzFB2DffzDpddyQoQ' 6-max Seat #4 is the button
Seat 1: W87HPwOk1KtWaYyshBe1gA ($22.85 in chips) 
Seat 2: iauW7L/+7qzAuHow7CD75Q ($10.10 in chips) 
Seat 3: QvTX2yGq3uKJiKPmns4TKQ ($18.90 in chips) 
Seat 4: NTamLAiMZ86c5yM04t96LA ($13.15 in chips) 
Seat 5: faP2NVl/cFTZ1nE4pXzg8Q ($26.30 in chips) 
Seat 6: 7JqTFMyeNSVWsmp/yW35Tw ($25 in chips) 
faP2NVl/cFTZ1nE4pXzg8Q: posts small blind $0.10
7JqTFMyeNSVWsmp/yW35Tw: posts big blind $0.25
*** HOLE CARDS ***
W87HPwOk1KtWaYyshBe1gA: calls $0.25
iauW7L/+7qzAuHow7CD75Q: folds 
QvTX2yGq3uKJiKPmns4TKQ: folds 
NTamLAiMZ86c5yM04t96LA: calls $0.25
NTamLAiMZ86c5yM04t96LA said, "my hand"
faP2NVl/cFTZ1nE4pXzg8Q: calls $0.15
7JqTFMyeNSVWsmp/yW35Tw: checks 
*** FLOP *** [5c 8h 3c]
faP2NVl/cFTZ1nE4pXzg8Q: bets $1
7JqTFMyeNSVWsmp/yW35Tw: raises $4 to $5
W87HPwOk1KtWaYyshBe1gA: folds 
NTamLAiMZ86c5yM04t96LA: folds 
faP2NVl/cFTZ1nE4pXzg8Q: calls $4
*** TURN *** [5c 8h 3c] [6d]
faP2NVl/cFTZ1nE4pXzg8Q: checks 
iauW7L/+7qzAuHow7CD75Q said, "bdiddy is on fire"
7JqTFMyeNSVWsmp/yW35Tw: bets $8
iauW7L/+7qzAuHow7CD75Q said, "be careful"
faP2NVl/cFTZ1nE4pXzg8Q: calls $8
*** RIVER *** [5c 8h 3c 6d] [8c]
faP2NVl/cFTZ1nE4pXzg8Q: bets $13.05 and is all-in
7JqTFMyeNSVWsmp/yW35Tw said, "kik"
7JqTFMyeNSVWsmp/yW35Tw said, "lol"
7JqTFMyeNSVWsmp/yW35Tw said, "counterfitted"
iauW7L/+7qzAuHow7CD75Q said, "flush"
7JqTFMyeNSVWsmp/yW35Tw: folds 
Uncalled bet ($13.05) returned to faP2NVl/cFTZ1nE4pXzg8Q
faP2NVl/cFTZ1nE4pXzg8Q collected $25.70 from pot
*** SUMMARY ***
Total pot $27 | Rake $1.30 
Board [5c 8h 3c 6d 8c]
Seat 1: W87HPwOk1KtWaYyshBe1gA folded on the Flop
Seat 2: iauW7L/+7qzAuHow7CD75Q folded before Flop (didn't bet)
Seat 3: QvTX2yGq3uKJiKPmns4TKQ folded before Flop (didn't bet)
Seat 4: NTamLAiMZ86c5yM04t96LA (button) folded on the Flop
Seat 5: faP2NVl/cFTZ1nE4pXzg8Q (small blind) collected ($25.70)
Seat 6: 7JqTFMyeNSVWsmp/yW35Tw (big blind) folded on the River




PokerStars Game #59941617222:  Hold'em No Limit ($0.10/$0.25) - 2009/07/01 1:40:52 ET
Table 'Is9eNmJA1KnBOw0lcVkxUQ' 9-max Seat #6 is the button
Seat 1: 56S3mA6Zs3pGR+0p0vUCtg ($32 in chips) 
Seat 2: VllYilcih0t+gMD4GTRlgQ ($38.35 in chips) 
Seat 3: ubsjZomMWSV0hAiBLa7K1A ($19.75 in chips) 
Seat 4: cZ99hugmLBj9KhTlc8nCSw ($25 in chips) 
Seat 6: HapyJHxV6lc3eqoT7yWL2A ($29.35 in chips) 
Seat 7: aNpwfA31EREwO+ar4XzBCw ($29.15 in chips) 
Seat 8: Th3FldXKQW6hWVVPahaoOQ ($25 in chips) 
Seat 9: DdPXdieucQ+n99u1n3A+rQ ($4.90 in chips) 
aNpwfA31EREwO+ar4XzBCw: posts small blind $0.10
Th3FldXKQW6hWVVPahaoOQ: posts big blind $0.25
Dr.Hibbert55: sits out 
*** HOLE CARDS ***
DdPXdieucQ+n99u1n3A+rQ: folds 
56S3mA6Zs3pGR+0p0vUCtg: folds 
VllYilcih0t+gMD4GTRlgQ: calls $0.25
ubsjZomMWSV0hAiBLa7K1A: folds 
cZ99hugmLBj9KhTlc8nCSw: folds 
HapyJHxV6lc3eqoT7yWL2A: calls $0.25
aNpwfA31EREwO+ar4XzBCw: folds 
Th3FldXKQW6hWVVPahaoOQ: checks 
*** FLOP *** [2c Jh Qc]
Th3FldXKQW6hWVVPahaoOQ: bets $0.50
VllYilcih0t+gMD4GTRlgQ: folds 
HapyJHxV6lc3eqoT7yWL2A: folds 
Uncalled bet ($0.50) returned to Th3FldXKQW6hWVVPahaoOQ
Th3FldXKQW6hWVVPahaoOQ collected $0.85 from pot
Th3FldXKQW6hWVVPahaoOQ: doesn't show hand 
*** SUMMARY ***
Total pot $0.85 | Rake $0 
Board [2c Jh Qc]
Seat 1: 56S3mA6Zs3pGR+0p0vUCtg folded before Flop (didn't bet)
Seat 2: VllYilcih0t+gMD4GTRlgQ folded on the Flop
Seat 3: ubsjZomMWSV0hAiBLa7K1A folded before Flop (didn't bet)
Seat 4: cZ99hugmLBj9KhTlc8nCSw folded before Flop (didn't bet)
Seat 6: HapyJHxV6lc3eqoT7yWL2A (button) folded on the Flop
Seat 7: aNpwfA31EREwO+ar4XzBCw (small blind) folded before Flop
Seat 8: Th3FldXKQW6hWVVPahaoOQ (big blind) collected ($0.85)
Seat 9: DdPXdieucQ+n99u1n3A+rQ folded before Flop (didn't bet)




PokerStars Game #59941617442:  Hold'em No Limit ($0.10/$0.25) - 2009/07/01 1:40:52 ET
Table 'BpNkESDX1ip9c0K1hb5h7A' 6-max Seat #2 is the button
Seat 2: g+5jEA4Xq9vcMOfdFYNuFA ($10.70 in chips) 
Seat 3: fZQg9veL7Dd/Z04ZTjC+wQ ($25.10 in chips) 
Seat 4: kG34n23qFQA3nzdOJTQ1dA ($25.55 in chips) 
Seat 5: L3/N/gliETan8N5Gim5h4Q ($25.50 in chips) 
Seat 6: 8EEqTTh7T1q48sYDqbI2Xg ($21.90 in chips) 
fZQg9veL7Dd/Z04ZTjC+wQ: posts small blind $0.10
kG34n23qFQA3nzdOJTQ1dA: posts big blind $0.25
*** HOLE CARDS ***
L3/N/gliETan8N5Gim5h4Q: folds 
8EEqTTh7T1q48sYDqbI2Xg: folds 
g+5jEA4Xq9vcMOfdFYNuFA: folds 
fZQg9veL7Dd/Z04ZTjC+wQ: calls $0.15
kG34n23qFQA3nzdOJTQ1dA: checks 
*** FLOP *** [3s 2d 5d]
fZQg9veL7Dd/Z04ZTjC+wQ: checks 
kG34n23qFQA3nzdOJTQ1dA: checks 
*** TURN *** [3s 2d 5d] [4s]
fZQg9veL7Dd/Z04ZTjC+wQ: bets $0.50
kG34n23qFQA3nzdOJTQ1dA: calls $0.50
*** RIVER *** [3s 2d 5d 4s] [3c]
fZQg9veL7Dd/Z04ZTjC+wQ: checks 
kG34n23qFQA3nzdOJTQ1dA: bets $1
fZQg9veL7Dd/Z04ZTjC+wQ: folds 
Uncalled bet ($1) returned to kG34n23qFQA3nzdOJTQ1dA
kG34n23qFQA3nzdOJTQ1dA collected $1.45 from pot
*** SUMMARY ***
Total pot $1.50 | Rake $0.05 
Board [3s 2d 5d 4s 3c]
Seat 2: g+5jEA4Xq9vcMOfdFYNuFA (button) folded before Flop (didn't bet)
Seat 3: fZQg9veL7Dd/Z04ZTjC+wQ (small blind) folded on the River
Seat 4: kG34n23qFQA3nzdOJTQ1dA (big blind) collected ($1.45)
Seat 5: L3/N/gliETan8N5Gim5h4Q folded before Flop (didn't bet)
Seat 6: 8EEqTTh7T1q48sYDqbI2Xg folded before Flop (didn't bet)




PokerStars Game #59941617152:  Hold'em No Limit ($0.10/$0.25) - 2009/07/01 1:40:52 ET
Table 'Ok3oDLIsTc2+KxPcI0bAOA' 6-max Seat #1 is the button
Seat 1: agQm3ugZ3qSVYNgNu1ddeA ($42.10 in chips) 
Seat 3: lquriepNQBhDV5P1SWHhnA ($26.35 in chips) 
Seat 4: LJI7A1YgDM7hgh7o56+ReQ ($38.50 in chips) 
Seat 5: DFi/Lzkjsfv8QswS80JX9Q ($28.25 in chips) 
Seat 6: Hsvkc0/G2VV78oVmWYXecw ($5.30 in chips) 
lquriepNQBhDV5P1SWHhnA: posts small blind $0.10
LJI7A1YgDM7hgh7o56+ReQ: posts big blind $0.25
*** HOLE CARDS ***
DFi/Lzkjsfv8QswS80JX9Q: raises $0.75 to $1
Hsvkc0/G2VV78oVmWYXecw: folds 
agQm3ugZ3qSVYNgNu1ddeA: folds 
lquriepNQBhDV5P1SWHhnA: folds 
LJI7A1YgDM7hgh7o56+ReQ: folds 
Uncalled bet ($0.75) returned to DFi/Lzkjsfv8QswS80JX9Q
DFi/Lzkjsfv8QswS80JX9Q collected $0.60 from pot
DFi/Lzkjsfv8QswS80JX9Q: doesn't show hand 
*** SUMMARY ***
Total pot $0.60 | Rake $0 
Seat 1: agQm3ugZ3qSVYNgNu1ddeA (button) folded before Flop (didn't bet)
Seat 3: lquriepNQBhDV5P1SWHhnA (small blind) folded before Flop
Seat 4: LJI7A1YgDM7hgh7o56+ReQ (big blind) folded before Flop
Seat 5: DFi/Lzkjsfv8QswS80JX9Q collected ($0.60)
Seat 6: Hsvkc0/G2VV78oVmWYXecw folded before Flop (didn't bet)




PokerStars Game #59941617650:  Hold'em No Limit ($0.10/$0.25) - 2009/07/01 1:40:52 ET
Table 'IIO2q2znuuAXmiZ2qFTcmg' 6-max Seat #4 is the button
Seat 1: 2G0C7dp4wlPpE21FHjjElQ ($25 in chips) 
Seat 2: cS21pIxRHx5Gt42o7hPZzw ($15.55 in chips) 
Seat 3: L3/N/gliETan8N5Gim5h4Q ($25 in chips) 
Seat 4: tSR4329m40dZsN7YOpI9Kw ($59.60 in chips) 
arewedunces will be allowed to play after the button
2G0C7dp4wlPpE21FHjjElQ: posts small blind $0.10
cS21pIxRHx5Gt42o7hPZzw: posts big blind $0.25
*** HOLE CARDS ***
L3/N/gliETan8N5Gim5h4Q: raises $0.50 to $0.75
tSR4329m40dZsN7YOpI9Kw: folds 
2G0C7dp4wlPpE21FHjjElQ: folds 
cS21pIxRHx5Gt42o7hPZzw: folds 
Uncalled bet ($0.50) returned to L3/N/gliETan8N5Gim5h4Q
L3/N/gliETan8N5Gim5h4Q collected $0.60 from pot
L3/N/gliETan8N5Gim5h4Q: doesn't show hand 
*** SUMMARY ***
Total pot $0.60 | Rake $0 
Seat 1: 2G0C7dp4wlPpE21FHjjElQ (small blind) folded before Flop
Seat 2: cS21pIxRHx5Gt42o7hPZzw (big blind) folded before Flop
Seat 3: L3/N/gliETan8N5Gim5h4Q collected ($0.60)
Seat 4: tSR4329m40dZsN7YOpI9Kw (button) folded before Flop (didn't bet)




PokerStars Game #59941618174:  Hold'em No Limit ($0.10/$0.25) - 2009/07/01 1:40:53 ET
Table 'm+FQg/QP0VP1ZA3V62WtOg' 9-max Seat #7 is the button
Seat 4: qB12xUq3ftb2y8oTnNQzsg ($2.85 in chips) 
Seat 6: CT7Xj/V/O5rBlhtt+RZeFQ ($25 in chips) 
Seat 7: TPAF9YkMsjQFq978RNWZEQ ($15.05 in chips) 
Seat 9: zUXhymECc2C9W9ZNw6qppA ($10.65 in chips) 
zUXhymECc2C9W9ZNw6qppA: posts small blind $0.10
qB12xUq3ftb2y8oTnNQzsg: posts big blind $0.25
CT7Xj/V/O5rBlhtt+RZeFQ: posts big blind $0.25
*** HOLE CARDS ***
CT7Xj/V/O5rBlhtt+RZeFQ: checks 
TPAF9YkMsjQFq978RNWZEQ: calls $0.25
zUXhymECc2C9W9ZNw6qppA: folds 
qB12xUq3ftb2y8oTnNQzsg: checks 
*** FLOP *** [Th 2d Ts]
qB12xUq3ftb2y8oTnNQzsg: checks 
CT7Xj/V/O5rBlhtt+RZeFQ: checks 
TPAF9YkMsjQFq978RNWZEQ: checks 
*** TURN *** [Th 2d Ts] [7h]
qB12xUq3ftb2y8oTnNQzsg: checks 
CT7Xj/V/O5rBlhtt+RZeFQ: checks 
TPAF9YkMsjQFq978RNWZEQ: checks 
*** RIVER *** [Th 2d Ts 7h] [4d]
qB12xUq3ftb2y8oTnNQzsg: checks 
CT7Xj/V/O5rBlhtt+RZeFQ: checks 
TPAF9YkMsjQFq978RNWZEQ: checks 
*** SHOW DOWN ***
qB12xUq3ftb2y8oTnNQzsg: shows [2c 6c] (two pair, Tens and Deuces)
CT7Xj/V/O5rBlhtt+RZeFQ: shows [3c 4c] (two pair, Tens and Fours)
TPAF9YkMsjQFq978RNWZEQ: mucks hand 
CT7Xj/V/O5rBlhtt+RZeFQ collected $0.85 from pot
*** SUMMARY ***
Total pot $0.85 | Rake $0 
Board [Th 2d Ts 7h 4d]
Seat 4: qB12xUq3ftb2y8oTnNQzsg (big blind) showed [2c 6c] and lost with two pair, Tens and Deuces
Seat 6: CT7Xj/V/O5rBlhtt+RZeFQ showed [3c 4c] and won ($0.85) with two pair, Tens and Fours
Seat 7: TPAF9YkMsjQFq978RNWZEQ (button) mucked
Seat 9: zUXhymECc2C9W9ZNw6qppA (small blind) folded before Flop




PokerStars Game #59941617958:  Hold'em No Limit ($0.10/$0.25) - 2009/07/01 1:40:53 ET
Table 'h02LhQ7B/Zk4ETRxxHhGYA' 9-max Seat #4 is the button
Seat 1: sD+TKtt36XiiN6jqHiLwDA ($25.25 in chips) 
Seat 2: 9lvO/qyU+xrU95Teu1fv0g ($6.30 in chips) 
Seat 3: arxNSjreDRGFg13EAM2F1w ($25 in chips) 
Seat 4: tYsOBqdU1+x+yFI7zHO7hQ ($38.10 in chips) 
Seat 5: cUxk0Jk4lrUQv9CJl0LPlg ($27.05 in chips) 
Seat 6: UvM6sxFT7el5hVDehvWvTA ($33.90 in chips) 
Seat 7: y7w8+Oqq4SkI1dkRDCx2Zg ($3.85 in chips) 
Seat 8: mUoFJKqCzIUABvOFbiINlQ ($14.75 in chips) 
Seat 9: MgzS9dEPzsGYQW57RteFhw ($7.40 in chips) 
cUxk0Jk4lrUQv9CJl0LPlg: posts small blind $0.10
UvM6sxFT7el5hVDehvWvTA: posts big blind $0.25
*** HOLE CARDS ***
y7w8+Oqq4SkI1dkRDCx2Zg: folds 
mUoFJKqCzIUABvOFbiINlQ: calls $0.25
MgzS9dEPzsGYQW57RteFhw: folds 
sD+TKtt36XiiN6jqHiLwDA: folds 
9lvO/qyU+xrU95Teu1fv0g: folds 
arxNSjreDRGFg13EAM2F1w: folds 
tYsOBqdU1+x+yFI7zHO7hQ: folds 
cUxk0Jk4lrUQv9CJl0LPlg: calls $0.15
UvM6sxFT7el5hVDehvWvTA: checks 
*** FLOP *** [8d Th 5d]
cUxk0Jk4lrUQv9CJl0LPlg: bets $0.50
UvM6sxFT7el5hVDehvWvTA: calls $0.50
mUoFJKqCzIUABvOFbiINlQ: folds 
*** TURN *** [8d Th 5d] [4d]
cUxk0Jk4lrUQv9CJl0LPlg: bets $0.50
UvM6sxFT7el5hVDehvWvTA: folds 
Uncalled bet ($0.50) returned to cUxk0Jk4lrUQv9CJl0LPlg
cUxk0Jk4lrUQv9CJl0LPlg collected $1.70 from pot
*** SUMMARY ***
Total pot $1.75 | Rake $0.05 
Board [8d Th 5d 4d]
Seat 1: sD+TKtt36XiiN6jqHiLwDA folded before Flop (didn't bet)
Seat 2: 9lvO/qyU+xrU95Teu1fv0g folded before Flop (didn't bet)
Seat 3: arxNSjreDRGFg13EAM2F1w folded before Flop (didn't bet)
Seat 4: tYsOBqdU1+x+yFI7zHO7hQ (button) folded before Flop (didn't bet)
Seat 5: cUxk0Jk4lrUQv9CJl0LPlg (small blind) collected ($1.70)
Seat 6: UvM6sxFT7el5hVDehvWvTA (big blind) folded on the Turn
Seat 7: y7w8+Oqq4SkI1dkRDCx2Zg folded before Flop (didn't bet)
Seat 8: mUoFJKqCzIUABvOFbiINlQ folded on the Flop
Seat 9: MgzS9dEPzsGYQW57RteFhw folded before Flop (didn't bet)




PokerStars Game #59941617976:  Hold'em No Limit ($0.10/$0.25) - 2009/07/01 1:40:53 ET
Table 'Yb2CyZosw7N3yRRVLhKnKg' 9-max Seat #6 is the button
Seat 1: c/9X4zftzphFxYtxp5kp9w ($23.65 in chips) 
Seat 2: dtZ84flFEi4Q+SGrHMJRDQ ($26.65 in chips) 
Seat 3: I8/fpJ2v6LsVf0kxqaVdMQ ($16.50 in chips) 
Seat 4: FG10kumpruEJ3PQJ7oGglQ ($11.35 in chips) 
Seat 5: T5Hk9oiIr+JDDMnEqwFCrw ($3.25 in chips) 
Seat 6: CgIo2ItZqi4o3ayVG6HanQ ($35.55 in chips) 
Seat 7: ljemhp25Zg+nlA9DLCIiUw ($26.95 in chips) 
Seat 8: HxDF4QSxC4z39D7teZpprQ ($11.10 in chips) 
Seat 9: 6DVf3fwEGECnjQ4Yp9AsFw ($15.85 in chips) 
ljemhp25Zg+nlA9DLCIiUw: posts small blind $0.10
HxDF4QSxC4z39D7teZpprQ: posts big blind $0.25
*** HOLE CARDS ***
6DVf3fwEGECnjQ4Yp9AsFw: folds 
c/9X4zftzphFxYtxp5kp9w: calls $0.25
dtZ84flFEi4Q+SGrHMJRDQ: folds 
I8/fpJ2v6LsVf0kxqaVdMQ: folds 
FG10kumpruEJ3PQJ7oGglQ: folds 
T5Hk9oiIr+JDDMnEqwFCrw: folds 
CgIo2ItZqi4o3ayVG6HanQ: raises $0.50 to $0.75
ljemhp25Zg+nlA9DLCIiUw: folds 
HxDF4QSxC4z39D7teZpprQ: folds 
c/9X4zftzphFxYtxp5kp9w: calls $0.50
*** FLOP *** [4c Kc 6s]
c/9X4zftzphFxYtxp5kp9w: checks 
CgIo2ItZqi4o3ayVG6HanQ: bets $1
c/9X4zftzphFxYtxp5kp9w: calls $1
*** TURN *** [4c Kc 6s] [Js]
c/9X4zftzphFxYtxp5kp9w: checks 
CgIo2ItZqi4o3ayVG6HanQ: bets $3.25
c/9X4zftzphFxYtxp5kp9w: calls $3.25
*** RIVER *** [4c Kc 6s Js] [8h]
c/9X4zftzphFxYtxp5kp9w: checks 
CgIo2ItZqi4o3ayVG6HanQ: bets $5
c/9X4zftzphFxYtxp5kp9w: calls $5
*** SHOW DOWN ***
CgIo2ItZqi4o3ayVG6HanQ: shows [Kh Jc] (two pair, Kings and Jacks)
c/9X4zftzphFxYtxp5kp9w: mucks hand 
CgIo2ItZqi4o3ayVG6HanQ collected $19.40 from pot
*** SUMMARY ***
Total pot $20.35 | Rake $0.95 
Board [4c Kc 6s Js 8h]
Seat 1: c/9X4zftzphFxYtxp5kp9w mucked
Seat 2: dtZ84flFEi4Q+SGrHMJRDQ folded before Flop (didn't bet)
Seat 3: I8/fpJ2v6LsVf0kxqaVdMQ folded before Flop (didn't bet)
Seat 4: FG10kumpruEJ3PQJ7oGglQ folded before Flop (didn't bet)
Seat 5: T5Hk9oiIr+JDDMnEqwFCrw folded before Flop (didn't bet)
Seat 6: CgIo2ItZqi4o3ayVG6HanQ (button) showed [Kh Jc] and won ($19.40) with two pair, Kings and Jacks
Seat 7: ljemhp25Zg+nlA9DLCIiUw (small blind) folded before Flop
Seat 8: HxDF4QSxC4z39D7teZpprQ (big blind) folded before Flop
Seat 9: 6DVf3fwEGECnjQ4Yp9AsFw folded before Flop (didn't bet)




PokerStars Game #59941618020:  Hold'em No Limit ($0.10/$0.25) - 2009/07/01 1:40:53 ET
Table 'U0hCzoS0KCJL+eoE054K4Q' 9-max Seat #5 is the button
Seat 1: XVEauYThJRhSTUAMxB/2ow ($38.45 in chips) 
Seat 2: MG90wfSJZnOejs/KD3vlQQ ($25.35 in chips) 
Seat 3: 8Cp1H3sSs8+jTTwLfeYKcw ($27.20 in chips) 
Seat 4: Bb42QRQMhg5/Y0vHP8/2Xw ($25.10 in chips) 
Seat 5: zgi+EUykT/pZQpoUG6+oEg ($6 in chips) 
Seat 6: V6p0jQ/RhUsqpHLmXvEX4Q ($12 in chips) 
Seat 7: uetHVityNsFnyX2bBnKe2A ($17 in chips) 
Seat 8: K0b5wNInj6hUGRr6yzKFtw ($25 in chips) 
Seat 9: wGigCmBR/9XWkPpvYos3aQ ($33.10 in chips) 
V6p0jQ/RhUsqpHLmXvEX4Q: posts small blind $0.10
uetHVityNsFnyX2bBnKe2A: posts big blind $0.25
*** HOLE CARDS ***
K0b5wNInj6hUGRr6yzKFtw: folds 
wGigCmBR/9XWkPpvYos3aQ: folds 
XVEauYThJRhSTUAMxB/2ow: folds 
MG90wfSJZnOejs/KD3vlQQ: raises $0.50 to $0.75
8Cp1H3sSs8+jTTwLfeYKcw: folds 
Bb42QRQMhg5/Y0vHP8/2Xw: folds 
zgi+EUykT/pZQpoUG6+oEg: folds 
V6p0jQ/RhUsqpHLmXvEX4Q: folds 
uetHVityNsFnyX2bBnKe2A: raises $0.75 to $1.50
MG90wfSJZnOejs/KD3vlQQ: calls $0.75
*** FLOP *** [8d Kc Th]
uetHVityNsFnyX2bBnKe2A: bets $2
MG90wfSJZnOejs/KD3vlQQ: folds 
Uncalled bet ($2) returned to uetHVityNsFnyX2bBnKe2A
uetHVityNsFnyX2bBnKe2A collected $2.95 from pot
uetHVityNsFnyX2bBnKe2A: doesn't show hand 
*** SUMMARY ***
Total pot $3.10 | Rake $0.15 
Board [8d Kc Th]
Seat 1: XVEauYThJRhSTUAMxB/2ow folded before Flop (didn't bet)
Seat 2: MG90wfSJZnOejs/KD3vlQQ folded on the Flop
Seat 3: 8Cp1H3sSs8+jTTwLfeYKcw folded before Flop (didn't bet)
Seat 4: Bb42QRQMhg5/Y0vHP8/2Xw folded before Flop (didn't bet)
Seat 5: zgi+EUykT/pZQpoUG6+oEg (button) folded before Flop (didn't bet)
Seat 6: V6p0jQ/RhUsqpHLmXvEX4Q (small blind) folded before Flop
Seat 7: uetHVityNsFnyX2bBnKe2A (big blind) collected ($2.95)
Seat 8: K0b5wNInj6hUGRr6yzKFtw folded before Flop (didn't bet)
Seat 9: wGigCmBR/9XWkPpvYos3aQ folded before Flop (didn't bet)




PokerStars Game #59941617828:  Hold'em No Limit ($0.10/$0.25) - 2009/07/01 1:40:53 ET
Table 'YlRA05h9BJ1EhOUSNUjJdg' 9-max Seat #9 is the button
Seat 1: dtZ84flFEi4Q+SGrHMJRDQ ($25 in chips) 
Seat 2: Y2GFAe+PT7xnUUtgqCNDFw ($11.90 in chips) 
Seat 3: Z5ZtGOON8kmSdSCll9Z3XA ($12.10 in chips) 
Seat 4: HPEB+AtKw1+C/cxU0o1ciw ($31.60 in chips) 
Seat 5: sx0lGrkT9fd4yFR+3cXUQg ($11.05 in chips) 
Seat 6: QEbIGci+itdw+re8RM5fZA ($44.35 in chips) 
Seat 7: dfNim92Z6XK1/h5SFW5vDg ($25 in chips) 
Seat 8: dmYlc+1cjwZMJ7wV+Z0rRg ($32.10 in chips) 
Seat 9: Z9AeOQX3yzuSvKAm/xyovg ($9.75 in chips) 
dtZ84flFEi4Q+SGrHMJRDQ: posts small blind $0.10
Y2GFAe+PT7xnUUtgqCNDFw: posts big blind $0.25
*** HOLE CARDS ***
Z5ZtGOON8kmSdSCll9Z3XA: folds 
HPEB+AtKw1+C/cxU0o1ciw: calls $0.25
sx0lGrkT9fd4yFR+3cXUQg: folds 
QEbIGci+itdw+re8RM5fZA: folds 
dfNim92Z6XK1/h5SFW5vDg: folds 
dmYlc+1cjwZMJ7wV+Z0rRg: folds 
Z9AeOQX3yzuSvKAm/xyovg: folds 
dtZ84flFEi4Q+SGrHMJRDQ: calls $0.15
Y2GFAe+PT7xnUUtgqCNDFw: checks 
*** FLOP *** [2c 9h 6c]
dtZ84flFEi4Q+SGrHMJRDQ: checks 
Y2GFAe+PT7xnUUtgqCNDFw: checks 
HPEB+AtKw1+C/cxU0o1ciw: checks 
*** TURN *** [2c 9h 6c] [9c]
dtZ84flFEi4Q+SGrHMJRDQ: checks 
Y2GFAe+PT7xnUUtgqCNDFw: checks 
HPEB+AtKw1+C/cxU0o1ciw: checks 
*** RIVER *** [2c 9h 6c 9c] [7s]
dtZ84flFEi4Q+SGrHMJRDQ: checks 
Y2GFAe+PT7xnUUtgqCNDFw: checks 
HPEB+AtKw1+C/cxU0o1ciw: checks 
*** SHOW DOWN ***
dtZ84flFEi4Q+SGrHMJRDQ: shows [4d 5d] (a pair of Nines)
Y2GFAe+PT7xnUUtgqCNDFw: shows [6d Jd] (two pair, Nines and Sixes)
HPEB+AtKw1+C/cxU0o1ciw: mucks hand 
Y2GFAe+PT7xnUUtgqCNDFw collected $0.75 from pot
*** SUMMARY ***
Total pot $0.75 | Rake $0 
Board [2c 9h 6c 9c 7s]
Seat 1: dtZ84flFEi4Q+SGrHMJRDQ (small blind) showed [4d 5d] and lost with a pair of Nines
Seat 2: Y2GFAe+PT7xnUUtgqCNDFw (big blind) showed [6d Jd] and won ($0.75) with two pair, Nines and Sixes
Seat 3: Z5ZtGOON8kmSdSCll9Z3XA folded before Flop (didn't bet)
Seat 4: HPEB+AtKw1+C/cxU0o1ciw mucked
Seat 5: sx0lGrkT9fd4yFR+3cXUQg folded before Flop (didn't bet)
Seat 6: QEbIGci+itdw+re8RM5fZA folded before Flop (didn't bet)
Seat 7: dfNim92Z6XK1/h5SFW5vDg folded before Flop (didn't bet)
Seat 8: dmYlc+1cjwZMJ7wV+Z0rRg folded before Flop (didn't bet)
Seat 9: Z9AeOQX3yzuSvKAm/xyovg (button) folded before Flop (didn't bet)




PokerStars Game #59941617950:  Hold'em No Limit ($0.10/$0.25) - 2009/07/01 1:40:53 ET
Table 'jdhJTJjFq2KTttwJcd+7nQ' 6-max Seat #5 is the button
Seat 1: LtASJ9OlkqGrrUKGQlpGAw ($27.05 in chips) 
Seat 2: Hsvkc0/G2VV78oVmWYXecw ($5 in chips) 
Seat 3: vqWjZmdQu/Hxw96/IJTWdQ ($25.35 in chips) 
Seat 4: vx7FwRcelVSsvNYAdp/z0A ($3.50 in chips) 
Seat 5: BV+K0Phf5VBHr7aZPKqbUQ ($26 in chips) 
Seat 6: yb6rnd48JuBccThV68VHAQ ($20.15 in chips) 
yb6rnd48JuBccThV68VHAQ: posts small blind $0.10
LtASJ9OlkqGrrUKGQlpGAw: posts big blind $0.25
*** HOLE CARDS ***
Hsvkc0/G2VV78oVmWYXecw: folds 
vqWjZmdQu/Hxw96/IJTWdQ: folds 
vx7FwRcelVSsvNYAdp/z0A: folds 
BV+K0Phf5VBHr7aZPKqbUQ: folds 
yb6rnd48JuBccThV68VHAQ: calls $0.15
LtASJ9OlkqGrrUKGQlpGAw: checks 
*** FLOP *** [2s 8s 2c]
yb6rnd48JuBccThV68VHAQ: checks 
LtASJ9OlkqGrrUKGQlpGAw: checks 
*** TURN *** [2s 8s 2c] [Kh]
yb6rnd48JuBccThV68VHAQ: checks 
LtASJ9OlkqGrrUKGQlpGAw: bets $0.50
yb6rnd48JuBccThV68VHAQ: folds 
Uncalled bet ($0.50) returned to LtASJ9OlkqGrrUKGQlpGAw
LtASJ9OlkqGrrUKGQlpGAw collected $0.50 from pot
LtASJ9OlkqGrrUKGQlpGAw: doesn't show hand 
*** SUMMARY ***
Total pot $0.50 | Rake $0 
Board [2s 8s 2c Kh]
Seat 1: LtASJ9OlkqGrrUKGQlpGAw (big blind) collected ($0.50)
Seat 2: Hsvkc0/G2VV78oVmWYXecw folded before Flop (didn't bet)
Seat 3: vqWjZmdQu/Hxw96/IJTWdQ folded before Flop (didn't bet)
Seat 4: vx7FwRcelVSsvNYAdp/z0A folded before Flop (didn't bet)
Seat 5: BV+K0Phf5VBHr7aZPKqbUQ (button) folded before Flop (didn't bet)
Seat 6: yb6rnd48JuBccThV68VHAQ (small blind) folded on the Turn




PokerStars Game #59941618004:  Hold'em No Limit ($0.10/$0.25) - 2009/07/01 1:40:53 ET
Table '/AhP8uWRzEEhOATYIdmn0A' 9-max Seat #3 is the button
Seat 1: +sbyWwIcFp9kP0bDtMegfQ ($37.80 in chips) 
Seat 2: nx5EoCNZFR03YUOXyT22wQ ($17.30 in chips) 
Seat 3: jx6dnobNHstDG0tabsbKHQ ($3.30 in chips) 
Seat 4: bXpVeaSTPBFSPJmeXxO7nw ($6.10 in chips) 
Seat 6: 8EbrQ/EvFWt2cr0GaU82gQ ($5 in chips) 
Seat 8: K86cg2ifCMFAlmzsfTDjig ($25 in chips) 
bXpVeaSTPBFSPJmeXxO7nw: posts small blind $0.10
TidusNexus joins the table at seat #9 
8EbrQ/EvFWt2cr0GaU82gQ: posts big blind $0.25
cZ99hugmLBj9KhTlc8nCSw: sits out 
*** HOLE CARDS ***
K86cg2ifCMFAlmzsfTDjig has timed out
K86cg2ifCMFAlmzsfTDjig: folds 
K86cg2ifCMFAlmzsfTDjig is sitting out
K86cg2ifCMFAlmzsfTDjig has returned
+sbyWwIcFp9kP0bDtMegfQ: folds 
nx5EoCNZFR03YUOXyT22wQ: folds 
jx6dnobNHstDG0tabsbKHQ: folds 
bXpVeaSTPBFSPJmeXxO7nw: folds 
Uncalled bet ($0.15) returned to 8EbrQ/EvFWt2cr0GaU82gQ
8EbrQ/EvFWt2cr0GaU82gQ collected $0.20 from pot
8EbrQ/EvFWt2cr0GaU82gQ: doesn't show hand 
*** SUMMARY ***
Total pot $0.20 | Rake $0 
Seat 1: +sbyWwIcFp9kP0bDtMegfQ folded before Flop (didn't bet)
Seat 2: nx5EoCNZFR03YUOXyT22wQ folded before Flop (didn't bet)
Seat 3: jx6dnobNHstDG0tabsbKHQ (button) folded before Flop (didn't bet)
Seat 4: bXpVeaSTPBFSPJmeXxO7nw (small blind) folded before Flop
Seat 6: 8EbrQ/EvFWt2cr0GaU82gQ (big blind) collected ($0.20)
Seat 8: K86cg2ifCMFAlmzsfTDjig folded before Flop (didn't bet)




PokerStars Game #59941617980:  Hold'em No Limit ($0.10/$0.25) - 2009/07/01 1:40:53 ET
Table 'rtxA1Y01Nrq5VoyzTAuusQ' 9-max Seat #5 is the button
Seat 1: w1ukf8uPa4+WH561TtVRxA ($31.80 in chips) 
Seat 3: K9fS1IUr5GpiJG7VkJ7IbA ($4.90 in chips) 
Seat 4: lTfGgdGMRH+DZcKby2m9Nw ($14.20 in chips) 
Seat 5: MtVtHDqIJTyUcXkRBBDIVA ($27.55 in chips) 
Seat 7: 3PmVnC/15cl4oyI1TKIt4g ($4.40 in chips) 
Seat 8: DnDcAdn9P0zGovMERigpFA ($25 in chips) 
Seat 9: HPEB+AtKw1+C/cxU0o1ciw ($22.95 in chips) 
3PmVnC/15cl4oyI1TKIt4g: posts small blind $0.10
DnDcAdn9P0zGovMERigpFA: posts big blind $0.25
Th3FldXKQW6hWVVPahaoOQ: sits out 
*** HOLE CARDS ***
HPEB+AtKw1+C/cxU0o1ciw: folds 
w1ukf8uPa4+WH561TtVRxA: folds 
K9fS1IUr5GpiJG7VkJ7IbA: folds 
lTfGgdGMRH+DZcKby2m9Nw: calls $0.25
MtVtHDqIJTyUcXkRBBDIVA: folds 
3PmVnC/15cl4oyI1TKIt4g: raises $1 to $1.25
DnDcAdn9P0zGovMERigpFA: folds 
lTfGgdGMRH+DZcKby2m9Nw: folds 
Uncalled bet ($1) returned to 3PmVnC/15cl4oyI1TKIt4g
3PmVnC/15cl4oyI1TKIt4g collected $0.75 from pot
3PmVnC/15cl4oyI1TKIt4g: doesn't show hand 
*** SUMMARY ***
Total pot $0.75 | Rake $0 
Seat 1: w1ukf8uPa4+WH561TtVRxA folded before Flop (didn't bet)
Seat 3: K9fS1IUr5GpiJG7VkJ7IbA folded before Flop (didn't bet)
Seat 4: lTfGgdGMRH+DZcKby2m9Nw folded before Flop
Seat 5: MtVtHDqIJTyUcXkRBBDIVA (button) folded before Flop (didn't bet)
Seat 7: 3PmVnC/15cl4oyI1TKIt4g (small blind) collected ($0.75)
Seat 8: DnDcAdn9P0zGovMERigpFA (big blind) folded before Flop
Seat 9: HPEB+AtKw1+C/cxU0o1ciw folded before Flop (didn't bet)




PokerStars Game #59941618408:  Hold'em No Limit ($0.10/$0.25) - 2009/07/01 1:40:54 ET
Table '63h13e5p7cWe02rClZ1CHw' 6-max Seat #1 is the button
Seat 1: pokjbbEcXXPlADXdSGHtZw ($21 in chips) 
Seat 2: k9nHZTHt8hYhYRcW8NTb4g ($27.75 in chips) 
Seat 3: mFv3iBCtrw9XfCDRB0d46Q ($5.75 in chips) 
Seat 4: xrf8tAXKQHG99HixCot1Iw ($23 in chips) 
Seat 5: iyZxqznXjv3vtvOJymkoLQ ($45.15 in chips) 
Seat 6: mfrkWA3PTeYPkbO6hi98Aw ($38.45 in chips) 
k9nHZTHt8hYhYRcW8NTb4g: posts small blind $0.10
mFv3iBCtrw9XfCDRB0d46Q: posts big blind $0.25
*** HOLE CARDS ***
xrf8tAXKQHG99HixCot1Iw: raises $0.50 to $0.75
iyZxqznXjv3vtvOJymkoLQ: folds 
mfrkWA3PTeYPkbO6hi98Aw: folds 
pokjbbEcXXPlADXdSGHtZw: folds 
k9nHZTHt8hYhYRcW8NTb4g: folds 
mFv3iBCtrw9XfCDRB0d46Q: folds 
Uncalled bet ($0.50) returned to xrf8tAXKQHG99HixCot1Iw
xrf8tAXKQHG99HixCot1Iw collected $0.60 from pot
xrf8tAXKQHG99HixCot1Iw: doesn't show hand 
*** SUMMARY ***
Total pot $0.60 | Rake $0 
Seat 1: pokjbbEcXXPlADXdSGHtZw (button) folded before Flop (didn't bet)
Seat 2: k9nHZTHt8hYhYRcW8NTb4g (small blind) folded before Flop
Seat 3: mFv3iBCtrw9XfCDRB0d46Q (big blind) folded before Flop
Seat 4: xrf8tAXKQHG99HixCot1Iw collected ($0.60)
Seat 5: iyZxqznXjv3vtvOJymkoLQ folded before Flop (didn't bet)
Seat 6: mfrkWA3PTeYPkbO6hi98Aw folded before Flop (didn't bet)




PokerStars Game #59941618274:  Hold'em No Limit ($0.10/$0.25) - 2009/07/01 1:40:54 ET
Table 'NtCSSONEf1zaJo3042tQug' 6-max Seat #1 is the button
Seat 1: KXtdqb+rIMkjc0RvHDksGQ ($35.45 in chips) 
Seat 2: vqWjZmdQu/Hxw96/IJTWdQ ($26.45 in chips) 
Seat 3: 9kUKGKkblnIx3m8rlVol6Q ($14.50 in chips) 
Seat 4: HxD1kB8zCmalQSdWAkKmlg ($29.20 in chips) 
Seat 5: tOAk1Og4mVObMBOfvdDYOw ($28.15 in chips) 
Seat 6: LxehwDpTQ19ph4Qmc78+Pw ($33 in chips) 
vqWjZmdQu/Hxw96/IJTWdQ: posts small blind $0.10
9kUKGKkblnIx3m8rlVol6Q: posts big blind $0.25
*** HOLE CARDS ***
HxD1kB8zCmalQSdWAkKmlg: folds 
tOAk1Og4mVObMBOfvdDYOw: folds 
LxehwDpTQ19ph4Qmc78+Pw: calls $0.25
KXtdqb+rIMkjc0RvHDksGQ: folds 
vqWjZmdQu/Hxw96/IJTWdQ: folds 
9kUKGKkblnIx3m8rlVol6Q: checks 
*** FLOP *** [9c 5s Ah]
9kUKGKkblnIx3m8rlVol6Q: checks 
LxehwDpTQ19ph4Qmc78+Pw: bets $0.50
9kUKGKkblnIx3m8rlVol6Q: calls $0.50
*** TURN *** [9c 5s Ah] [2s]
9kUKGKkblnIx3m8rlVol6Q: checks 
LxehwDpTQ19ph4Qmc78+Pw: checks 
*** RIVER *** [9c 5s Ah 2s] [7s]
9kUKGKkblnIx3m8rlVol6Q: bets $0.50
LxehwDpTQ19ph4Qmc78+Pw: calls $0.50
*** SHOW DOWN ***
9kUKGKkblnIx3m8rlVol6Q: shows [4s 3s] (a flush, Seven high)
LxehwDpTQ19ph4Qmc78+Pw: mucks hand 
9kUKGKkblnIx3m8rlVol6Q collected $2.50 from pot
*** SUMMARY ***
Total pot $2.60 | Rake $0.10 
Board [9c 5s Ah 2s 7s]
Seat 1: KXtdqb+rIMkjc0RvHDksGQ (button) folded before Flop (didn't bet)
Seat 2: vqWjZmdQu/Hxw96/IJTWdQ (small blind) folded before Flop
Seat 3: 9kUKGKkblnIx3m8rlVol6Q (big blind) showed [4s 3s] and won ($2.50) with a flush, Seven high
Seat 4: HxD1kB8zCmalQSdWAkKmlg folded before Flop (didn't bet)
Seat 5: tOAk1Og4mVObMBOfvdDYOw folded before Flop (didn't bet)
Seat 6: LxehwDpTQ19ph4Qmc78+Pw mucked




PokerStars Game #59941618626:  Hold'em No Limit ($0.10/$0.25) - 2009/07/01 1:40:54 ET
Table 'Qk/910N2Yhg8u5vqTJk50Q' 9-max Seat #3 is the button
Seat 1: zDrucyjVn5aeekNEc3cJrA ($22.55 in chips) 
Seat 2: Th3FldXKQW6hWVVPahaoOQ ($45.65 in chips) 
Seat 3: ghNKXUBl/H+t83JF079ZBA ($26 in chips) 
Seat 7: aNpwfA31EREwO+ar4XzBCw ($25.45 in chips) 
Seat 8: 9PMD136+PrUsTwnP6fczyA ($15 in chips) 
Seat 9: M2QO2DxB5Wawg2h8HSpnYA ($18.70 in chips) 
zReBEigsxqZnag0RZAgpgA will be allowed to play after the button
aNpwfA31EREwO+ar4XzBCw: posts small blind $0.10
9PMD136+PrUsTwnP6fczyA: posts big blind $0.25
*** HOLE CARDS ***
M2QO2DxB5Wawg2h8HSpnYA: folds 
nAWaA+gDUSWOad+I9mKUEg joins the table at seat #6 
zDrucyjVn5aeekNEc3cJrA: folds 
Th3FldXKQW6hWVVPahaoOQ: folds 
ghNKXUBl/H+t83JF079ZBA: folds 
aNpwfA31EREwO+ar4XzBCw: raises $0.75 to $1
9PMD136+PrUsTwnP6fczyA: calls $0.75
*** FLOP *** [2s 9d Kh]
aNpwfA31EREwO+ar4XzBCw: bets $1.25
9PMD136+PrUsTwnP6fczyA: folds 
Uncalled bet ($1.25) returned to aNpwfA31EREwO+ar4XzBCw
aNpwfA31EREwO+ar4XzBCw collected $1.90 from pot
aNpwfA31EREwO+ar4XzBCw: doesn't show hand 
*** SUMMARY ***
Total pot $2 | Rake $0.10 
Board [2s 9d Kh]
Seat 1: zDrucyjVn5aeekNEc3cJrA folded before Flop (didn't bet)
Seat 2: Th3FldXKQW6hWVVPahaoOQ folded before Flop (didn't bet)
Seat 3: ghNKXUBl/H+t83JF079ZBA (button) folded before Flop (didn't bet)
Seat 7: aNpwfA31EREwO+ar4XzBCw (small blind) collected ($1.90)
Seat 8: 9PMD136+PrUsTwnP6fczyA (big blind) folded on the Flop
Seat 9: M2QO2DxB5Wawg2h8HSpnYA folded before Flop (didn't bet)




PokerStars Game #59941618268:  Hold'em No Limit ($0.10/$0.25) - 2009/07/01 1:40:54 ET
Table 'KAnP7XvDtlku47YfJwdOVw' 9-max Seat #2 is the button
Seat 1: cH3q40adP+kFogl+2MtbkQ ($14.15 in chips) 
Seat 2: VFTQG1/RfAKeMXRBv1ewsg ($28 in chips) 
Seat 3: W6tExOcYX7qiy6Qdp+ZwFA ($6.05 in chips) 
Seat 4: OiV1PWZ3IkN29JlmCcnTwQ ($5 in chips) 
Seat 5: MG90wfSJZnOejs/KD3vlQQ ($33.40 in chips) 
Seat 6: z5GxcHlYz/GSz6W2uFiTtg ($21.55 in chips) 
Seat 7: Lro4e37x4FUa5P3yzDjskw ($8.05 in chips) 
Seat 8: OneeONzF0MoH0pEdcBndwA ($22.80 in chips) 
Seat 9: HDDm1BkZtdsRyw2DJdqq6A ($24.30 in chips) 
W6tExOcYX7qiy6Qdp+ZwFA: posts small blind $0.10
OiV1PWZ3IkN29JlmCcnTwQ: posts big blind $0.25
*** HOLE CARDS ***
MG90wfSJZnOejs/KD3vlQQ: folds 
z5GxcHlYz/GSz6W2uFiTtg has timed out
z5GxcHlYz/GSz6W2uFiTtg: folds 
z5GxcHlYz/GSz6W2uFiTtg is sitting out
z5GxcHlYz/GSz6W2uFiTtg has returned
Lro4e37x4FUa5P3yzDjskw: folds 
OneeONzF0MoH0pEdcBndwA: folds 
HDDm1BkZtdsRyw2DJdqq6A: folds 
cH3q40adP+kFogl+2MtbkQ: calls $0.25
VFTQG1/RfAKeMXRBv1ewsg: folds 
W6tExOcYX7qiy6Qdp+ZwFA: folds 
OiV1PWZ3IkN29JlmCcnTwQ: checks 
*** FLOP *** [2s Td Qc]
OiV1PWZ3IkN29JlmCcnTwQ: checks 
cH3q40adP+kFogl+2MtbkQ: bets $0.50
OiV1PWZ3IkN29JlmCcnTwQ: folds 
Uncalled bet ($0.50) returned to cH3q40adP+kFogl+2MtbkQ
cH3q40adP+kFogl+2MtbkQ collected $0.60 from pot
cH3q40adP+kFogl+2MtbkQ: doesn't show hand 
*** SUMMARY ***
Total pot $0.60 | Rake $0 
Board [2s Td Qc]
Seat 1: cH3q40adP+kFogl+2MtbkQ collected ($0.60)
Seat 2: VFTQG1/RfAKeMXRBv1ewsg (button) folded before Flop (didn't bet)
Seat 3: W6tExOcYX7qiy6Qdp+ZwFA (small blind) folded before Flop
Seat 4: OiV1PWZ3IkN29JlmCcnTwQ (big blind) folded on the Flop
Seat 5: MG90wfSJZnOejs/KD3vlQQ folded before Flop (didn't bet)
Seat 6: z5GxcHlYz/GSz6W2uFiTtg folded before Flop (didn't bet)
Seat 7: Lro4e37x4FUa5P3yzDjskw folded before Flop (didn't bet)
Seat 8: OneeONzF0MoH0pEdcBndwA folded before Flop (didn't bet)
Seat 9: HDDm1BkZtdsRyw2DJdqq6A folded before Flop (didn't bet)




PokerStars Game #59941618230:  Hold'em No Limit ($0.10/$0.25) - 2009/07/01 1:40:54 ET
Table 'vud0GB/ZlDCvUFhBFIaTlg' 9-max Seat #9 is the button
Seat 1: DiSvPC2iudwL5j9u6Huyww ($28.60 in chips) 
Seat 2: tLcDklc2rBORNfixyRfVfw ($25 in chips) 
Seat 3: W2YYHvqjaEpRrO7stZkClQ ($4.65 in chips) 
Seat 4: dWgEDExmVO0d+rRmUYCU5w ($15.95 in chips) 
Seat 5: eK8qa6EPcH2zhtbmWSvc9g ($25 in chips) 
Seat 6: gehe91e0IyVT0QU/XBkEyg ($24.90 in chips) 
Seat 7: iG7VeTyBWf6wYNvZpbTcbw ($17.10 in chips) 
Seat 8: Am29qRe4OYkVWs70NjNDBw ($16.10 in chips) 
Seat 9: PdIasPkzm2sqZnN41ZRXOg ($5 in chips) 
DiSvPC2iudwL5j9u6Huyww: posts small blind $0.10
tLcDklc2rBORNfixyRfVfw: posts big blind $0.25
*** HOLE CARDS ***
W2YYHvqjaEpRrO7stZkClQ: folds 
dWgEDExmVO0d+rRmUYCU5w has timed out
dWgEDExmVO0d+rRmUYCU5w: folds 
dWgEDExmVO0d+rRmUYCU5w is sitting out
eK8qa6EPcH2zhtbmWSvc9g: folds 
gehe91e0IyVT0QU/XBkEyg: folds 
iG7VeTyBWf6wYNvZpbTcbw: folds 
Am29qRe4OYkVWs70NjNDBw: folds 
PdIasPkzm2sqZnN41ZRXOg: raises $1 to $1.25
DiSvPC2iudwL5j9u6Huyww: folds 
tLcDklc2rBORNfixyRfVfw: folds 
Uncalled bet ($1) returned to PdIasPkzm2sqZnN41ZRXOg
PdIasPkzm2sqZnN41ZRXOg collected $0.60 from pot
PdIasPkzm2sqZnN41ZRXOg: doesn't show hand 
*** SUMMARY ***
Total pot $0.60 | Rake $0 
Seat 1: DiSvPC2iudwL5j9u6Huyww (small blind) folded before Flop
Seat 2: tLcDklc2rBORNfixyRfVfw (big blind) folded before Flop
Seat 3: W2YYHvqjaEpRrO7stZkClQ folded before Flop (didn't bet)
Seat 4: dWgEDExmVO0d+rRmUYCU5w folded before Flop (didn't bet)
Seat 5: eK8qa6EPcH2zhtbmWSvc9g folded before Flop (didn't bet)
Seat 6: gehe91e0IyVT0QU/XBkEyg folded before Flop (didn't bet)
Seat 7: iG7VeTyBWf6wYNvZpbTcbw folded before Flop (didn't bet)
Seat 8: Am29qRe4OYkVWs70NjNDBw folded before Flop (didn't bet)
Seat 9: PdIasPkzm2sqZnN41ZRXOg (button) collected ($0.60)




PokerStars Game #59941618542:  Hold'em No Limit ($0.10/$0.25) - 2009/07/01 1:40:54 ET
Table 'MJ1SB76A4qJrlEa+C5e/8w' 6-max Seat #1 is the button
Seat 1: 0KDZiuXQg6UI9cqBR/AUnQ ($26 in chips) 
Seat 2: UA5OsKS3VPaxa7uC8La/kA ($36.10 in chips) 
Seat 3: DihMHaz4WNETH1bPDe13kA ($33.25 in chips) 
Seat 4: SFmT9ZsVopnukjvAzrxTRg ($28.15 in chips) 
Seat 6: JFIAqU8lCZ0vWwEl4bdGsg ($30.30 in chips) 
UA5OsKS3VPaxa7uC8La/kA: posts small blind $0.10
DihMHaz4WNETH1bPDe13kA: posts big blind $0.25
Hsvkc0/G2VV78oVmWYXecw: sits out 
*** HOLE CARDS ***
SFmT9ZsVopnukjvAzrxTRg: folds 
JFIAqU8lCZ0vWwEl4bdGsg: folds 
0KDZiuXQg6UI9cqBR/AUnQ: folds 
UA5OsKS3VPaxa7uC8La/kA: raises $0.75 to $1
DihMHaz4WNETH1bPDe13kA: folds 
Uncalled bet ($0.75) returned to UA5OsKS3VPaxa7uC8La/kA
UA5OsKS3VPaxa7uC8La/kA collected $0.50 from pot
UA5OsKS3VPaxa7uC8La/kA: doesn't show hand 
*** SUMMARY ***
Total pot $0.50 | Rake $0 
Seat 1: 0KDZiuXQg6UI9cqBR/AUnQ (button) folded before Flop (didn't bet)
Seat 2: UA5OsKS3VPaxa7uC8La/kA (small blind) collected ($0.50)
Seat 3: DihMHaz4WNETH1bPDe13kA (big blind) folded before Flop
Seat 4: SFmT9ZsVopnukjvAzrxTRg folded before Flop (didn't bet)
Seat 6: JFIAqU8lCZ0vWwEl4bdGsg folded before Flop (didn't bet)




PokerStars Game #59941619068:  Hold'em No Limit ($0.10/$0.25) - 2009/07/01 1:40:55 ET
Table 'pgrBYaOEx/BuqK5iAtlFzw' 9-max Seat #7 is the button
Seat 1: 6O+8t5ikoK+pNiFXnN/Fyw ($16.15 in chips) 
Seat 2: 2Xwi447v1rBHM+92U0CduA ($4.75 in chips) 
Seat 3: Bb42QRQMhg5/Y0vHP8/2Xw ($26.85 in chips) 
Seat 4: oLa/tXLfSLLB28mcLGrxcg ($24.40 in chips) 
Seat 5: BWzInv8o0kN1pJybv/VjpQ ($25.65 in chips) 
Seat 6: eubS00Znk+qsx0B0+7/Zow ($21.85 in chips) 
Seat 7: eK8qa6EPcH2zhtbmWSvc9g ($25 in chips) 
Seat 8: tLcDklc2rBORNfixyRfVfw ($25.10 in chips) 
tLcDklc2rBORNfixyRfVfw: posts small blind $0.10
1S/fpm+f42V/6MNZre+ccg: is sitting out 
1S/fpm+f42V/6MNZre+ccg leaves the table
DigiSlarks joins the table at seat #9 
6O+8t5ikoK+pNiFXnN/Fyw: posts big blind $0.25
*** HOLE CARDS ***
2Xwi447v1rBHM+92U0CduA: folds 
Bb42QRQMhg5/Y0vHP8/2Xw: calls $0.25
oLa/tXLfSLLB28mcLGrxcg: folds 
BWzInv8o0kN1pJybv/VjpQ: raises $1 to $1.25
eubS00Znk+qsx0B0+7/Zow: folds 
eK8qa6EPcH2zhtbmWSvc9g: folds 
tLcDklc2rBORNfixyRfVfw: folds 
6O+8t5ikoK+pNiFXnN/Fyw: folds 
Bb42QRQMhg5/Y0vHP8/2Xw: calls $1
*** FLOP *** [Th 4d As]
Bb42QRQMhg5/Y0vHP8/2Xw: checks 
BWzInv8o0kN1pJybv/VjpQ: bets $1.25
Bb42QRQMhg5/Y0vHP8/2Xw: folds 
Uncalled bet ($1.25) returned to BWzInv8o0kN1pJybv/VjpQ
BWzInv8o0kN1pJybv/VjpQ collected $2.75 from pot
*** SUMMARY ***
Total pot $2.85 | Rake $0.10 
Board [Th 4d As]
Seat 1: 6O+8t5ikoK+pNiFXnN/Fyw (big blind) folded before Flop
Seat 2: 2Xwi447v1rBHM+92U0CduA folded before Flop (didn't bet)
Seat 3: Bb42QRQMhg5/Y0vHP8/2Xw folded on the Flop
Seat 4: oLa/tXLfSLLB28mcLGrxcg folded before Flop (didn't bet)
Seat 5: BWzInv8o0kN1pJybv/VjpQ collected ($2.75)
Seat 6: eubS00Znk+qsx0B0+7/Zow folded before Flop (didn't bet)
Seat 7: eK8qa6EPcH2zhtbmWSvc9g (button) folded before Flop (didn't bet)
Seat 8: tLcDklc2rBORNfixyRfVfw (small blind) folded before Flop




PokerStars Game #59941618776:  Hold'em No Limit ($0.10/$0.25) - 2009/07/01 1:40:55 ET
Table '6wawJ+MkkvuC3coG6r+YhgZiwAqg4o02gNro+JOAaFNgSeat #5 is the button
Seat 1: 6RiVTYll/5D8zICp0MRpKw ($25.20 in chips) 
Seat 2: tYsOBqdU1+x+yFI7zHO7hQ ($31.40 in chips) 
Seat 3: aNpwfA31EREwO+ar4XzBCw ($29 in chips) 
Seat 4: j4q3p0lesp63b1gZDwLBZw ($5.65 in chips) 
Seat 5: 6HoFYfVGBefsR5Vrz62qIw5hAPbqNrvJb8PtLiceXtlg1.10 in chips) 
Seat 6: 5n7e7I+px7c6CQmLpPbtsg ($5.10 in chips) 
Seat 7: yyG4svzOpC1A+sUP/scg6w ($7.05 in chips) 
Seat 8: VLIsy+xjx3olLSYO3JLS6g ($18.35 in chips) 
Seat 9: ljemhp25Zg+nlA9DLCIiUw ($23.40 in chips) 
5n7e7I+px7c6CQmLpPbtsg: posts small blind $0.10
yyG4svzOpC1A+sUP/scg6w: posts big blind $0.25
*** HOLE CARDS ***
VLIsy+xjx3olLSYO3JLS6g: folds 
ljemhp25Zg+nlA9DLCIiUw: folds 
6RiVTYll/5D8zICp0MRpKw: folds 
tYsOBqdU1+x+yFI7zHO7hQ: folds 
aNpwfA31EREwO+ar4XzBCw: folds 
j4q3p0lesp63b1gZDwLBZw: folds 
6HoFYfVGBefsR5Vrz62qIw5hAPbqNrvJb8PtLiceXtlglls $0.25
5n7e7I+px7c6CQmLpPbtsg: folds 
yyG4svzOpC1A+sUP/scg6w: raises $0.75 to $1
6HoFYfVGBefsR5Vrz62qIw5hAPbqNrvJb8PtLiceXtlglls $0.75
*** FLOP *** [9c 9d 4c]
yyG4svzOpC1A+sUP/scg6w: bets $1.25
6HoFYfVGBefsR5Vrz62qIw5hAPbqNrvJb8PtLiceXtlglds 
Uncalled bet ($1.25) returned to yyG4svzOpC1A+sUP/scg6w
yyG4svzOpC1A+sUP/scg6w collected $2 from pot
*** SUMMARY ***
Total pot $2.10 | Rake $0.10 
Board [9c 9d 4c]
Seat 1: 6RiVTYll/5D8zICp0MRpKw folded before Flop (didn't bet)
Seat 2: tYsOBqdU1+x+yFI7zHO7hQ folded before Flop (didn't bet)
Seat 3: aNpwfA31EREwO+ar4XzBCw folded before Flop (didn't bet)
Seat 4: j4q3p0lesp63b1gZDwLBZw folded before Flop (didn't bet)
Seat 5: 6HoFYfVGBefsR5Vrz62qIw5hAPbqNrvJb8PtLiceXtlgtton) folded on the Flop
Seat 6: 5n7e7I+px7c6CQmLpPbtsg (small blind) folded before Flop
Seat 7: yyG4svzOpC1A+sUP/scg6w (big blind) collected ($2)
Seat 8: VLIsy+xjx3olLSYO3JLS6g folded before Flop (didn't bet)
Seat 9: ljemhp25Zg+nlA9DLCIiUw folded before Flop (didn't bet)




PokerStars Game #59941618774:  Hold'em No Limit ($0.10/$0.25) - 2009/07/01 1:40:55 ET
Table 'iMiAw/kTZXopgYX4HI7sHg' 9-max Seat #5 is the button
Seat 1: PdIasPkzm2sqZnN41ZRXOg ($4.90 in chips) 
Seat 2: qwr38jl5txoR36M7G5qi4A ($7.90 in chips) 
Seat 3: HPEB+AtKw1+C/cxU0o1ciw ($28.25 in chips) 
Seat 4: eK8qa6EPcH2zhtbmWSvc9g ($32.40 in chips) 
Seat 5: 22dIObOuor/A+IKWkNoAlA ($5.10 in chips) 
Seat 6: Bb42QRQMhg5/Y0vHP8/2Xw ($28.80 in chips) 
Seat 7: ljkBp5cvgbHARUIwY5vUuA ($5 in chips) 
Seat 8: tLcDklc2rBORNfixyRfVfw ($25 in chips) 
Seat 9: K36tHfxDQBx3OFpy0baDPA ($27.50 in chips) 
Bb42QRQMhg5/Y0vHP8/2Xw: posts small blind $0.10
ljkBp5cvgbHARUIwY5vUuA: posts big blind $0.25
*** HOLE CARDS ***
tLcDklc2rBORNfixyRfVfw: folds 
K36tHfxDQBx3OFpy0baDPA: folds 
PdIasPkzm2sqZnN41ZRXOg: folds 
qwr38jl5txoR36M7G5qi4A: raises $0.50 to $0.75
HPEB+AtKw1+C/cxU0o1ciw: folds 
eK8qa6EPcH2zhtbmWSvc9g: folds 
22dIObOuor/A+IKWkNoAlA: folds 
Bb42QRQMhg5/Y0vHP8/2Xw: folds 
ljkBp5cvgbHARUIwY5vUuA: folds 
Uncalled bet ($0.50) returned to qwr38jl5txoR36M7G5qi4A
qwr38jl5txoR36M7G5qi4A collected $0.60 from pot
qwr38jl5txoR36M7G5qi4A: doesn't show hand 
*** SUMMARY ***
Total pot $0.60 | Rake $0 
Seat 1: PdIasPkzm2sqZnN41ZRXOg folded before Flop (didn't bet)
Seat 2: qwr38jl5txoR36M7G5qi4A collected ($0.60)
Seat 3: HPEB+AtKw1+C/cxU0o1ciw folded before Flop (didn't bet)
Seat 4: eK8qa6EPcH2zhtbmWSvc9g folded before Flop (didn't bet)
Seat 5: 22dIObOuor/A+IKWkNoAlA (button) folded before Flop (didn't bet)
Seat 6: Bb42QRQMhg5/Y0vHP8/2Xw (small blind) folded before Flop
Seat 7: ljkBp5cvgbHARUIwY5vUuA (big blind) folded before Flop
Seat 8: tLcDklc2rBORNfixyRfVfw folded before Flop (didn't bet)
Seat 9: K36tHfxDQBx3OFpy0baDPA folded before Flop (didn't bet)




PokerStars Game #59941619258:  Hold'em No Limit ($0.10/$0.25) - 2009/07/01 1:40:55 ET
Table 'FuFyQHmlO/QqQp//rDRrPg' 6-max Seat #2 is the button
Seat 1: jp34e617tIzV8tKIWmfAbA ($28.15 in chips) 
Seat 2: G3h3THGB1j3qdHDVHpnJWg ($22.80 in chips) 
Seat 3: EeUZtMU058v2ObUACOF4Og ($30.35 in chips) 
Seat 4: OMGl+YMGogf2JWIRfT2/Yg ($4.75 in chips) 
Seat 5: xrf8tAXKQHG99HixCot1Iw ($20.60 in chips) 
Seat 6: 6DwBRH+xZ12AAZmeAg+aXw ($57.90 in chips) 
EeUZtMU058v2ObUACOF4Og: posts small blind $0.10
OMGl+YMGogf2JWIRfT2/Yg: posts big blind $0.25
*** HOLE CARDS ***
xrf8tAXKQHG99HixCot1Iw: raises $0.50 to $0.75
6DwBRH+xZ12AAZmeAg+aXw: folds 
jp34e617tIzV8tKIWmfAbA: calls $0.75
G3h3THGB1j3qdHDVHpnJWg has timed out
G3h3THGB1j3qdHDVHpnJWg: folds 
G3h3THGB1j3qdHDVHpnJWg is sitting out
EeUZtMU058v2ObUACOF4Og: folds 
OMGl+YMGogf2JWIRfT2/Yg: calls $0.50
*** FLOP *** [Qd 2c 5c]
OMGl+YMGogf2JWIRfT2/Yg: checks 
xrf8tAXKQHG99HixCot1Iw: bets $1.75
jp34e617tIzV8tKIWmfAbA: folds 
OMGl+YMGogf2JWIRfT2/Yg: calls $1.75
*** TURN *** [Qd 2c 5c] [4h]
OMGl+YMGogf2JWIRfT2/Yg: checks 
xrf8tAXKQHG99HixCot1Iw: bets $7
G3h3THGB1j3qdHDVHpnJWg has returned
OMGl+YMGogf2JWIRfT2/Yg: calls $2.25 and is all-in
Uncalled bet ($4.75) returned to xrf8tAXKQHG99HixCot1Iw
*** RIVER *** [Qd 2c 5c 4h] [Jh]
*** SHOW DOWN ***
OMGl+YMGogf2JWIRfT2/Yg: shows [Jc Tc] (a pair of Jacks)
xrf8tAXKQHG99HixCot1Iw: shows [Qs Kc] (a pair of Queens)
xrf8tAXKQHG99HixCot1Iw collected $9.85 from pot
*** SUMMARY ***
Total pot $10.35 | Rake $0.50 
Board [Qd 2c 5c 4h Jh]
Seat 1: jp34e617tIzV8tKIWmfAbA folded on the Flop
Seat 2: G3h3THGB1j3qdHDVHpnJWg (button) folded before Flop (didn't bet)
Seat 3: EeUZtMU058v2ObUACOF4Og (small blind) folded before Flop
Seat 4: OMGl+YMGogf2JWIRfT2/Yg (big blind) showed [Jc Tc] and lost with a pair of Jacks
Seat 5: xrf8tAXKQHG99HixCot1Iw showed [Qs Kc] and won ($9.85) with a pair of Queens
Seat 6: 6DwBRH+xZ12AAZmeAg+aXw folded before Flop (didn't bet)




PokerStars Game #59941619076:  Hold'em No Limit ($0.10/$0.25) - 2009/07/01 1:40:55 ET
Table '6wawJ+MkkvuC3coG6r+Yhg' 6-max Seat #5 is the button
Seat 1: JQZew0FjzS19kTjeNtrE+A ($27.10 in chips) 
Seat 2: LtASJ9OlkqGrrUKGQlpGAw ($33.60 in chips) 
Seat 3: 3zD3qLXT1bEffAoWGnc7wg ($59.85 in chips) 
Seat 4: yxmjNFGiKI3b+XQGJzJVIg ($28.30 in chips) 
Seat 5: FZrgDbxAanC1xwZxXHJKVA ($2.85 in chips) 
Seat 6: B3X187C0tXFUfQpCu8pe8A ($28.10 in chips) 
B3X187C0tXFUfQpCu8pe8A: posts small blind $0.10
JQZew0FjzS19kTjeNtrE+A: posts big blind $0.25
*** HOLE CARDS ***
LtASJ9OlkqGrrUKGQlpGAw: folds 
3zD3qLXT1bEffAoWGnc7wg: folds 
yxmjNFGiKI3b+XQGJzJVIg: folds 
FZrgDbxAanC1xwZxXHJKVA: folds 
B3X187C0tXFUfQpCu8pe8A: calls $0.15
JQZew0FjzS19kTjeNtrE+A: raises $0.75 to $1
B3X187C0tXFUfQpCu8pe8A: calls $0.75
*** FLOP *** [5h 2d 7h]
B3X187C0tXFUfQpCu8pe8A: checks 
JQZew0FjzS19kTjeNtrE+A: bets $1.50
B3X187C0tXFUfQpCu8pe8A: folds 
Uncalled bet ($1.50) returned to JQZew0FjzS19kTjeNtrE+A
JQZew0FjzS19kTjeNtrE+A collected $1.90 from pot
*** SUMMARY ***
Total pot $2 | Rake $0.10 
Board [5h 2d 7h]
Seat 1: JQZew0FjzS19kTjeNtrE+A (big blind) collected ($1.90)
Seat 2: LtASJ9OlkqGrrUKGQlpGAw folded before Flop (didn't bet)
Seat 3: 3zD3qLXT1bEffAoWGnc7wg folded before Flop (didn't bet)
Seat 4: yxmjNFGiKI3b+XQGJzJVIg folded before Flop (didn't bet)
Seat 5: FZrgDbxAanC1xwZxXHJKVA (button) folded before Flop (didn't bet)
Seat 6: B3X187C0tXFUfQpCu8pe8A (small blind) folded on the Flop




PokerStars Game #59941618784:  Hold'em No Limit ($0.10/$0.25) - 2009/07/01 1:40:55 ET
Table 'Qr+t8WGovMECkBv+cV1lrg' 6-max Seat #4 is the button
Seat 1: EeUZtMU058v2ObUACOF4Og ($51.60 in chips) 
Seat 2: GJsS3gwVwlbyroaWrnjqJg ($41.40 in chips) 
Seat 3: uZKkrGByYgd4/ZBX2d4z+w ($20.05 in chips) 
Seat 4: 1NNFfYMd5Hsphl/FYz9fNA ($60.45 in chips) 
Seat 5: 9q7YGTKe9k5fYb4fmZc3Ww ($34.35 in chips) 
Seat 6: xRkU4+naLuz7dEZFbOn9cw ($25 in chips) 
9q7YGTKe9k5fYb4fmZc3Ww: posts small blind $0.10
xRkU4+naLuz7dEZFbOn9cw: posts big blind $0.25
*** HOLE CARDS ***
EeUZtMU058v2ObUACOF4Og: folds 
GJsS3gwVwlbyroaWrnjqJg: folds 
uZKkrGByYgd4/ZBX2d4z+w: calls $0.25
1NNFfYMd5Hsphl/FYz9fNA: calls $0.25
9q7YGTKe9k5fYb4fmZc3Ww: raises $0.75 to $1
xRkU4+naLuz7dEZFbOn9cw: folds 
uZKkrGByYgd4/ZBX2d4z+w: calls $0.75
1NNFfYMd5Hsphl/FYz9fNA: folds 
*** FLOP *** [6d 8h Th]
9q7YGTKe9k5fYb4fmZc3Ww: bets $1
uZKkrGByYgd4/ZBX2d4z+w: raises $1.50 to $2.50
9q7YGTKe9k5fYb4fmZc3Ww: folds 
Uncalled bet ($1.50) returned to uZKkrGByYgd4/ZBX2d4z+w
uZKkrGByYgd4/ZBX2d4z+w collected $4.30 from pot
*** SUMMARY ***
Total pot $4.50 | Rake $0.20 
Board [6d 8h Th]
Seat 1: EeUZtMU058v2ObUACOF4Og folded before Flop (didn't bet)
Seat 2: GJsS3gwVwlbyroaWrnjqJg folded before Flop (didn't bet)
Seat 3: uZKkrGByYgd4/ZBX2d4z+w collected ($4.30)
Seat 4: 1NNFfYMd5Hsphl/FYz9fNA (button) folded before Flop
Seat 5: 9q7YGTKe9k5fYb4fmZc3Ww (small blind) folded on the Flop
Seat 6: xRkU4+naLuz7dEZFbOn9cw (big blind) folded before Flop




PokerStars Game #59941619272:  Hold'em No Limit ($0.10/$0.25) - 2009/07/01 1:40:55 ET
Table 'MiquQrQZJJq9ZtgRIp9HFQ' 6-max Seat #4 is the button
Seat 1: c3J/KYZ4cNsUEuz8v57I5A ($26.25 in chips) 
Seat 2: XaIzillDPjW0HcNtCRrgsQ ($6.20 in chips) 
Seat 3: Hsvkc0/G2VV78oVmWYXecw ($5 in chips) 
Seat 4: wAKC8C/zN0c8V5v13dm9mA ($58.75 in chips) 
Seat 5: iyZxqznXjv3vtvOJymkoLQ ($25 in chips) 
Seat 6: GbCVUNssQ7mqsPWr7J4d3w ($4.30 in chips) 
iyZxqznXjv3vtvOJymkoLQ: posts small blind $0.10
GbCVUNssQ7mqsPWr7J4d3w: posts big blind $0.25
*** HOLE CARDS ***
c3J/KYZ4cNsUEuz8v57I5A: folds 
XaIzillDPjW0HcNtCRrgsQ: raises $0.75 to $1
Hsvkc0/G2VV78oVmWYXecw: folds 
wAKC8C/zN0c8V5v13dm9mA: calls $1
iyZxqznXjv3vtvOJymkoLQ: calls $0.90
GbCVUNssQ7mqsPWr7J4d3w: folds 
*** FLOP *** [6h Kc 3s]
iyZxqznXjv3vtvOJymkoLQ: checks 
XaIzillDPjW0HcNtCRrgsQ: checks 
wAKC8C/zN0c8V5v13dm9mA: checks 
*** TURN *** [6h Kc 3s] [Td]
iyZxqznXjv3vtvOJymkoLQ: checks 
XaIzillDPjW0HcNtCRrgsQ: checks 
wAKC8C/zN0c8V5v13dm9mA: checks 
*** RIVER *** [6h Kc 3s Td] [2c]
iyZxqznXjv3vtvOJymkoLQ: checks 
XaIzillDPjW0HcNtCRrgsQ: checks 
wAKC8C/zN0c8V5v13dm9mA: checks 
*** SHOW DOWN ***
iyZxqznXjv3vtvOJymkoLQ: shows [Ah Jc] (high card Ace)
XaIzillDPjW0HcNtCRrgsQ: mucks hand 
wAKC8C/zN0c8V5v13dm9mA: mucks hand 
iyZxqznXjv3vtvOJymkoLQ collected $3.10 from pot
*** SUMMARY ***
Total pot $3.25 | Rake $0.15 
Board [6h Kc 3s Td 2c]
Seat 1: c3J/KYZ4cNsUEuz8v57I5A folded before Flop (didn't bet)
Seat 2: XaIzillDPjW0HcNtCRrgsQ mucked
Seat 3: Hsvkc0/G2VV78oVmWYXecw folded before Flop (didn't bet)
Seat 4: wAKC8C/zN0c8V5v13dm9mA (button) mucked
Seat 5: iyZxqznXjv3vtvOJymkoLQ (small blind) showed [Ah Jc] and won ($3.10) with high card Ace
Seat 6: GbCVUNssQ7mqsPWr7J4d3w (big blind) folded before Flop




PokerStars Game #59941618864:  Hold'em No Limit ($0.10/$0.25) - 2009/07/01 1:40:55 ET
Table 'SHi8+hK6i7E2dJ/3Agbyig' 6-max Seat #2 is the button
Seat 1: gPEN9Zp33YTm/mu9/SYP1w ($30.70 in chips) 
Seat 2: LJI7A1YgDM7hgh7o56+ReQ ($28.80 in chips) 
Seat 3: P1Z7LWu+VU+WmJsI4mr0wA ($25.10 in chips) 
Seat 4: u0ikXOhAPSCLmg+l17oGRw ($9.35 in chips) 
Seat 5: v8m8XHovI5tqEA9mvplDSw ($53.80 in chips) 
Seat 6: cWc85bEzdRzpUMhRKm8pwQ ($25.35 in chips) 
P1Z7LWu+VU+WmJsI4mr0wA: posts small blind $0.10
u0ikXOhAPSCLmg+l17oGRw: posts big blind $0.25
*** HOLE CARDS ***
v8m8XHovI5tqEA9mvplDSw: folds 
cWc85bEzdRzpUMhRKm8pwQ: folds 
gPEN9Zp33YTm/mu9/SYP1w: folds 
LJI7A1YgDM7hgh7o56+ReQ: folds 
P1Z7LWu+VU+WmJsI4mr0wA: folds 
Uncalled bet ($0.15) returned to u0ikXOhAPSCLmg+l17oGRw
u0ikXOhAPSCLmg+l17oGRw collected $0.20 from pot
*** SUMMARY ***
Total pot $0.20 | Rake $0 
Seat 1: gPEN9Zp33YTm/mu9/SYP1w folded before Flop (didn't bet)
Seat 2: LJI7A1YgDM7hgh7o56+ReQ (button) folded before Flop (didn't bet)
Seat 3: P1Z7LWu+VU+WmJsI4mr0wA (small blind) folded before Flop
Seat 4: u0ikXOhAPSCLmg+l17oGRw (big blind) collected ($0.20)
Seat 5: v8m8XHovI5tqEA9mvplDSw folded before Flop (didn't bet)
Seat 6: cWc85bEzdRzpUMhRKm8pwQ folded before Flop (didn't bet)




PokerStars Game #59941619162:  Hold'em No Limit ($0.10/$0.25) - 2009/07/01 1:40:55 ET
Table 'dNYnr4D4id1jwnEU66Yowg' 9-max Seat #5 is the button
Seat 1: 9lvO/qyU+xrU95Teu1fv0g ($4.65 in chips) 
Seat 4: VBHxUExRAMrbxUq/cVx9Gw ($4.95 in chips) 
Seat 5: 7cv+9Zc9HIQHNvYsMfV3uA ($25.70 in chips) 
Seat 6: 8EbrQ/EvFWt2cr0GaU82gQ ($4.75 in chips) 
Seat 7: DiSvPC2iudwL5j9u6Huyww ($25.80 in chips) 
Seat 8: RCqMONFrSPSArZh2Jsar/w ($22.45 in chips) 
Seat 9: K0dyGSZP/cgeQjH6o6u9Rw ($16.30 in chips) 
8EbrQ/EvFWt2cr0GaU82gQ: posts small blind $0.10
DiSvPC2iudwL5j9u6Huyww: posts big blind $0.25
*** HOLE CARDS ***
RCqMONFrSPSArZh2Jsar/w: folds 
K0dyGSZP/cgeQjH6o6u9Rw: folds 
9lvO/qyU+xrU95Teu1fv0g: folds 
VBHxUExRAMrbxUq/cVx9Gw: folds 
7cv+9Zc9HIQHNvYsMfV3uA: raises $0.75 to $1
8EbrQ/EvFWt2cr0GaU82gQ: folds 
Dr.Hibbert55 joins the table at seat #2 
DiSvPC2iudwL5j9u6Huyww: folds 
Uncalled bet ($0.75) returned to 7cv+9Zc9HIQHNvYsMfV3uA
7cv+9Zc9HIQHNvYsMfV3uA collected $0.60 from pot
7cv+9Zc9HIQHNvYsMfV3uA: doesn't show hand 
*** SUMMARY ***
Total pot $0.60 | Rake $0 
Seat 1: 9lvO/qyU+xrU95Teu1fv0g folded before Flop (didn't bet)
Seat 4: VBHxUExRAMrbxUq/cVx9Gw folded before Flop (didn't bet)
Seat 5: 7cv+9Zc9HIQHNvYsMfV3uA (button) collected ($0.60)
Seat 6: 8EbrQ/EvFWt2cr0GaU82gQ (small blind) folded before Flop
Seat 7: DiSvPC2iudwL5j9u6Huyww (big blind) folded before Flop
Seat 8: RCqMONFrSPSArZh2Jsar/w folded before Flop (didn't bet)
Seat 9: K0dyGSZP/cgeQjH6o6u9Rw folded before Flop (didn't bet)




PokerStars Game #59941619702:  Hold'em No Limit ($0.10/$0.25) - 2009/07/01 1:40:56 ET
Table 'YYMg5qzxK1m9eGRo4SbxtQ' 9-max Seat #8 is the button
Seat 2: f/H6PsHRl4W1JyNsEDvPtg ($8.45 in chips) 
Seat 8: xoBFd/5k+L/pFn9VW1VyWg ($13 in chips) 
Seat 9: +sbyWwIcFp9kP0bDtMegfQ ($32 in chips) 
+sbyWwIcFp9kP0bDtMegfQ: posts small blind $0.10
f/H6PsHRl4W1JyNsEDvPtg: posts big blind $0.25
cFmpjvcjNoVAEAIQIxWkYg: sits out 
*** HOLE CARDS ***
xoBFd/5k+L/pFn9VW1VyWg: folds 
+sbyWwIcFp9kP0bDtMegfQ: calls $0.15
f/H6PsHRl4W1JyNsEDvPtg: checks 
*** FLOP *** [7d 6d 5d]
+sbyWwIcFp9kP0bDtMegfQ: checks 
f/H6PsHRl4W1JyNsEDvPtg: bets $0.50
+sbyWwIcFp9kP0bDtMegfQ: folds 
Uncalled bet ($0.50) returned to f/H6PsHRl4W1JyNsEDvPtg
f/H6PsHRl4W1JyNsEDvPtg collected $0.50 from pot
*** SUMMARY ***
Total pot $0.50 | Rake $0 
Board [7d 6d 5d]
Seat 2: f/H6PsHRl4W1JyNsEDvPtg (big blind) collected ($0.50)
Seat 8: xoBFd/5k+L/pFn9VW1VyWg (button) folded before Flop (didn't bet)
Seat 9: +sbyWwIcFp9kP0bDtMegfQ (small blind) folded on the Flop




PokerStars Game #59941619518:  Hold'em No Limit ($0.10/$0.25) - 2009/07/01 1:40:56 ET
Table 'rhQuIjJo0UQ7RRUlF9umHg' 6-max Seat #1 is the button
Seat 1: 5O3Hj9Qg0SqOyKEXoLpjPg ($120.35 in chips) 
Seat 2: Ew/TYPQIsbQ2X8nm5iAJBg ($20.20 in chips) 
Seat 3: if4dh6jhJXeN3/qd3qCp9g ($27.75 in chips) 
Seat 4: buyjetgNT1McXtdaP4zynA ($25 in chips) 
Seat 5: dOX4wnYV2sEqvDbF+8KSCw ($52 in chips) 
Seat 6: /gJNBeCkWL4o85/jvlZ4BA ($52.40 in chips) 
Ew/TYPQIsbQ2X8nm5iAJBg: posts small blind $0.10
if4dh6jhJXeN3/qd3qCp9g: posts big blind $0.25
*** HOLE CARDS ***
buyjetgNT1McXtdaP4zynA: raises $1.25 to $1.50
dOX4wnYV2sEqvDbF+8KSCw: folds 
/gJNBeCkWL4o85/jvlZ4BA: folds 
5O3Hj9Qg0SqOyKEXoLpjPg said, "chalk dust torture"
5O3Hj9Qg0SqOyKEXoLpjPg: calls $1.50
Ew/TYPQIsbQ2X8nm5iAJBg: folds 
if4dh6jhJXeN3/qd3qCp9g: folds 
*** FLOP *** [4h Js 9s]
buyjetgNT1McXtdaP4zynA: checks 
5O3Hj9Qg0SqOyKEXoLpjPg: checks 
*** TURN *** [4h Js 9s] [Td]
buyjetgNT1McXtdaP4zynA: bets $2
5O3Hj9Qg0SqOyKEXoLpjPg: calls $2
*** RIVER *** [4h Js 9s Td] [7s]
buyjetgNT1McXtdaP4zynA: checks 
5O3Hj9Qg0SqOyKEXoLpjPg: checks 
*** SHOW DOWN ***
buyjetgNT1McXtdaP4zynA: shows [Ah Qd] (high card Ace)
5O3Hj9Qg0SqOyKEXoLpjPg: shows [4s 6c] (a pair of Fours)
5O3Hj9Qg0SqOyKEXoLpjPg collected $7 from pot
*** SUMMARY ***
Total pot $7.35 | Rake $0.35 
Board [4h Js 9s Td 7s]
Seat 1: 5O3Hj9Qg0SqOyKEXoLpjPg (button) showed [4s 6c] and won ($7) with a pair of Fours
Seat 2: Ew/TYPQIsbQ2X8nm5iAJBg (small blind) folded before Flop
Seat 3: if4dh6jhJXeN3/qd3qCp9g (big blind) folded before Flop
Seat 4: buyjetgNT1McXtdaP4zynA showed [Ah Qd] and lost with high card Ace
Seat 5: dOX4wnYV2sEqvDbF+8KSCw folded before Flop (didn't bet)
Seat 6: /gJNBeCkWL4o85/jvlZ4BA folded before Flop (didn't bet)




PokerStars Game #59941619858:  Hold'em No Limit ($0.10/$0.25) - 2009/07/01 1:40:56 ET
Table '63uh7ZsO7Tnt+E8b/2bu3A' 6-max Seat #1 is the button
Seat 1: 0av6tRNdi0Ui4f15L7gsVg ($30.90 in chips) 
Seat 2: SFmT9ZsVopnukjvAzrxTRg ($30 in chips) 
Seat 3: yVP7GLZBzx47OPi6jzUxMw ($14.35 in chips) 
Seat 4: 2tYgzzRRW/D2GWb2A7f1jw ($7.35 in chips) 
Seat 5: GbCVUNssQ7mqsPWr7J4d3w ($4.75 in chips) 
Seat 6: qGHGf/553gQnDoklMRe3tg ($29 in chips) 
SFmT9ZsVopnukjvAzrxTRg: posts small blind $0.10
yVP7GLZBzx47OPi6jzUxMw: posts big blind $0.25
*** HOLE CARDS ***
2tYgzzRRW/D2GWb2A7f1jw: calls $0.25
GbCVUNssQ7mqsPWr7J4d3w: folds 
qGHGf/553gQnDoklMRe3tg: folds 
0av6tRNdi0Ui4f15L7gsVg: folds 
SFmT9ZsVopnukjvAzrxTRg: calls $0.15
yVP7GLZBzx47OPi6jzUxMw: checks 
*** FLOP *** [Tc 3d 2d]
SFmT9ZsVopnukjvAzrxTRg: bets $0.50
yVP7GLZBzx47OPi6jzUxMw: folds 
2tYgzzRRW/D2GWb2A7f1jw: calls $0.50
*** TURN *** [Tc 3d 2d] [Ts]
SFmT9ZsVopnukjvAzrxTRg: bets $1.25
2tYgzzRRW/D2GWb2A7f1jw: folds 
Uncalled bet ($1.25) returned to SFmT9ZsVopnukjvAzrxTRg
SFmT9ZsVopnukjvAzrxTRg collected $1.70 from pot
SFmT9ZsVopnukjvAzrxTRg: doesn't show hand 
*** SUMMARY ***
Total pot $1.75 | Rake $0.05 
Board [Tc 3d 2d Ts]
Seat 1: 0av6tRNdi0Ui4f15L7gsVg (button) folded before Flop (didn't bet)
Seat 2: SFmT9ZsVopnukjvAzrxTRg (small blind) collected ($1.70)
Seat 3: yVP7GLZBzx47OPi6jzUxMw (big blind) folded on the Flop
Seat 4: 2tYgzzRRW/D2GWb2A7f1jw folded on the Turn
Seat 5: GbCVUNssQ7mqsPWr7J4d3w folded before Flop (didn't bet)
Seat 6: qGHGf/553gQnDoklMRe3tg folded before Flop (didn't bet)




PokerStars Game #59941619710:  Hold'em No Limit ($0.10/$0.25) - 2009/07/01 1:40:56 ET
Table 'g6ryG70feTw9nNm+XJLuXw' 6-max Seat #4 is the button
Seat 1: v+QfkGiuj9bgtuNoVnDO8w ($35.95 in chips) 
Seat 2: SxIIgwXYLkwd6m3wLyPTCw ($33.10 in chips) 
Seat 3: cezpHJ8FB07dj0xG+LhOvw ($25 in chips) 
Seat 4: GC/9yVD59DUCX7hUI7gcLw ($44.35 in chips) 
Seat 5: EE16Ua5b1HSsYej5zeXOlA ($25 in chips) 
Seat 6: tSR4329m40dZsN7YOpI9Kw ($35.85 in chips) 
EE16Ua5b1HSsYej5zeXOlA: posts small blind $0.10
tSR4329m40dZsN7YOpI9Kw: posts big blind $0.25
*** HOLE CARDS ***
v+QfkGiuj9bgtuNoVnDO8w: folds 
SxIIgwXYLkwd6m3wLyPTCw: raises $0.50 to $0.75
cezpHJ8FB07dj0xG+LhOvw: folds 
GC/9yVD59DUCX7hUI7gcLw: folds 
EE16Ua5b1HSsYej5zeXOlA: folds 
tSR4329m40dZsN7YOpI9Kw: folds 
Uncalled bet ($0.50) returned to SxIIgwXYLkwd6m3wLyPTCw
SxIIgwXYLkwd6m3wLyPTCw collected $0.60 from pot
SxIIgwXYLkwd6m3wLyPTCw: doesn't show hand 
*** SUMMARY ***
Total pot $0.60 | Rake $0 
Seat 1: v+QfkGiuj9bgtuNoVnDO8w folded before Flop (didn't bet)
Seat 2: SxIIgwXYLkwd6m3wLyPTCw collected ($0.60)
Seat 3: cezpHJ8FB07dj0xG+LhOvw folded before Flop (didn't bet)
Seat 4: GC/9yVD59DUCX7hUI7gcLw (button) folded before Flop (didn't bet)
Seat 5: EE16Ua5b1HSsYej5zeXOlA (small blind) folded before Flop
Seat 6: tSR4329m40dZsN7YOpI9Kw (big blind) folded before Flop




PokerStars Game #59941620338:  Hold'em No Limit ($0.10/$0.25) - 2009/07/01 1:40:57 ET
Table '4XGDnEByOol5up4aB2KbJw' 6-max Seat #3 is the button
Seat 1: kyRaCIljYA6l33lSKQfNsg ($26.85 in chips) 
Seat 2: SFmT9ZsVopnukjvAzrxTRg ($44.15 in chips) 
Seat 3: LtASJ9OlkqGrrUKGQlpGAw ($20.55 in chips) 
Seat 4: BV+K0Phf5VBHr7aZPKqbUQ ($25.80 in chips) 
Seat 5: Dh01+rohD2p9pXLYeBlC5Q ($16.90 in chips) 
Seat 6: a7Ux7aERFGCbT/L3ojVfAg ($9.35 in chips) 
BV+K0Phf5VBHr7aZPKqbUQ: posts small blind $0.10
Dh01+rohD2p9pXLYeBlC5Q: posts big blind $0.25
*** HOLE CARDS ***
a7Ux7aERFGCbT/L3ojVfAg: folds 
kyRaCIljYA6l33lSKQfNsg: folds 
SFmT9ZsVopnukjvAzrxTRg: folds 
LtASJ9OlkqGrrUKGQlpGAw: folds 
BV+K0Phf5VBHr7aZPKqbUQ: calls $0.15
Dh01+rohD2p9pXLYeBlC5Q: checks 
*** FLOP *** [Ac 5c 3c]
BV+K0Phf5VBHr7aZPKqbUQ: bets $0.50
Dh01+rohD2p9pXLYeBlC5Q: calls $0.50
*** TURN *** [Ac 5c 3c] [5s]
BV+K0Phf5VBHr7aZPKqbUQ: checks 
Dh01+rohD2p9pXLYeBlC5Q: checks 
*** RIVER *** [Ac 5c 3c 5s] [9s]
BV+K0Phf5VBHr7aZPKqbUQ: checks 
Dh01+rohD2p9pXLYeBlC5Q: checks 
*** SHOW DOWN ***
BV+K0Phf5VBHr7aZPKqbUQ: shows [Ts Ad] (two pair, Aces and Fives)
Dh01+rohD2p9pXLYeBlC5Q: mucks hand 
BV+K0Phf5VBHr7aZPKqbUQ collected $1.45 from pot
*** SUMMARY ***
Total pot $1.50 | Rake $0.05 
Board [Ac 5c 3c 5s 9s]
Seat 1: kyRaCIljYA6l33lSKQfNsg folded before Flop (didn't bet)
Seat 2: SFmT9ZsVopnukjvAzrxTRg folded before Flop (didn't bet)
Seat 3: LtASJ9OlkqGrrUKGQlpGAw (button) folded before Flop (didn't bet)
Seat 4: BV+K0Phf5VBHr7aZPKqbUQ (small blind) showed [Ts Ad] and won ($1.45) with two pair, Aces and Fives
Seat 5: Dh01+rohD2p9pXLYeBlC5Q (big blind) mucked
Seat 6: a7Ux7aERFGCbT/L3ojVfAg folded before Flop (didn't bet)




PokerStars Game #59941620124:  Hold'em No Limit ($0.10/$0.25) - 2009/07/01 1:40:57 ET
Table 'HzFR0rxmDAPu5GzYR0AlYg' 6-max Seat #6 is the button
Seat 1: v+QfkGiuj9bgtuNoVnDO8w ($30.40 in chips) 
Seat 2: UA5OsKS3VPaxa7uC8La/kA ($53.35 in chips) 
Seat 3: kG34n23qFQA3nzdOJTQ1dA ($24.65 in chips) 
Seat 4: 8tR2s7yV/Fr0ePp1w5XnJw ($9.25 in chips) 
Seat 5: lquriepNQBhDV5P1SWHhnA ($26.25 in chips) 
Seat 6: jp34e617tIzV8tKIWmfAbA ($38.50 in chips) 
v+QfkGiuj9bgtuNoVnDO8w: posts small blind $0.10
UA5OsKS3VPaxa7uC8La/kA: posts big blind $0.25
*** HOLE CARDS ***
kG34n23qFQA3nzdOJTQ1dA: folds 
8tR2s7yV/Fr0ePp1w5XnJw: folds 
lquriepNQBhDV5P1SWHhnA: raises $0.50 to $0.75
jp34e617tIzV8tKIWmfAbA: calls $0.75
v+QfkGiuj9bgtuNoVnDO8w: folds 
UA5OsKS3VPaxa7uC8La/kA: folds 
*** FLOP *** [5s Jh 3s]
lquriepNQBhDV5P1SWHhnA: bets $1
jp34e617tIzV8tKIWmfAbA: raises $2.25 to $3.25
lquriepNQBhDV5P1SWHhnA: raises $8.75 to $12
jp34e617tIzV8tKIWmfAbA: folds 
Uncalled bet ($8.75) returned to lquriepNQBhDV5P1SWHhnA
lquriepNQBhDV5P1SWHhnA collected $7.95 from pot
lquriepNQBhDV5P1SWHhnA: doesn't show hand 
*** SUMMARY ***
Total pot $8.35 | Rake $0.40 
Board [5s Jh 3s]
Seat 1: v+QfkGiuj9bgtuNoVnDO8w (small blind) folded before Flop
Seat 2: UA5OsKS3VPaxa7uC8La/kA (big blind) folded before Flop
Seat 3: kG34n23qFQA3nzdOJTQ1dA folded before Flop (didn't bet)
Seat 4: 8tR2s7yV/Fr0ePp1w5XnJw folded before Flop (didn't bet)
Seat 5: lquriepNQBhDV5P1SWHhnA collected ($7.95)
Seat 6: jp34e617tIzV8tKIWmfAbA (button) folded on the Flop




PokerStars Game #59941620136:  Hold'em No Limit ($0.10/$0.25) - 2009/07/01 1:40:57 ET
Table 'tq5CvS0RUqGkuBK0XTzqqg' 6-max Seat #6 is the button
Seat 1: +ZlnqPoP3Hg4BIUxDfKd/A ($31.30 in chips) 
Seat 2: 2m6ZFAdj01UZd4WtEySXXQ ($7.15 in chips) 
Seat 3: PbMzPZIePKifKQZfKDkbIw ($47 in chips) 
Seat 4: UT5XpwOH1ipkOF7n1MqDJA ($25 in chips) 
Seat 5: qGHGf/553gQnDoklMRe3tg ($32.30 in chips) 
Seat 6: L3/N/gliETan8N5Gim5h4Q ($25 in chips) 
+ZlnqPoP3Hg4BIUxDfKd/A: posts small blind $0.10
2m6ZFAdj01UZd4WtEySXXQ: posts big blind $0.25
*** HOLE CARDS ***
PbMzPZIePKifKQZfKDkbIw: folds 
UT5XpwOH1ipkOF7n1MqDJA: folds 
qGHGf/553gQnDoklMRe3tg: folds 
L3/N/gliETan8N5Gim5h4Q: folds 
+ZlnqPoP3Hg4BIUxDfKd/A: folds 
Uncalled bet ($0.15) returned to 2m6ZFAdj01UZd4WtEySXXQ
2m6ZFAdj01UZd4WtEySXXQ collected $0.20 from pot
*** SUMMARY ***
Total pot $0.20 | Rake $0 
Seat 1: +ZlnqPoP3Hg4BIUxDfKd/A (small blind) folded before Flop
Seat 2: 2m6ZFAdj01UZd4WtEySXXQ (big blind) collected ($0.20)
Seat 3: PbMzPZIePKifKQZfKDkbIw folded before Flop (didn't bet)
Seat 4: UT5XpwOH1ipkOF7n1MqDJA folded before Flop (didn't bet)
Seat 5: qGHGf/553gQnDoklMRe3tg folded before Flop (didn't bet)
Seat 6: L3/N/gliETan8N5Gim5h4Q (button) folded before Flop (didn't bet)




PokerStars Game #59941620172:  Hold'em No Limit ($0.10/$0.25) - 2009/07/01 1:40:57 ET
Table '1zj0+miaIL9cvwnT/50pOA' 9-max Seat #8 is the button
Seat 1: PVxvfRTRvkgZf9WtquEkwQ ($25.70 in chips) 
Seat 2: HPEB+AtKw1+C/cxU0o1ciw ($43.30 in chips) 
Seat 3: dtZ84flFEi4Q+SGrHMJRDQ ($28.60 in chips) 
Seat 4: PdIasPkzm2sqZnN41ZRXOg ($5 in chips) 
Seat 5: 57qrNGHDvf6GhB8zVLsAtQ ($4.35 in chips) 
Seat 6: YZaC69gFrepA6oCGtu7E0w ($30.70 in chips) 
Seat 7: 6RiVTYll/5D8zICp0MRpKw ($23.90 in chips) 
Seat 8: Ihhh49x48fayPIyvl2Rsmg ($28.30 in chips) 
Seat 9: AyqFvLFzJDE7yMbXP362BA ($32.05 in chips) 
AyqFvLFzJDE7yMbXP362BA: posts small blind $0.10
PVxvfRTRvkgZf9WtquEkwQ: posts big blind $0.25
*** HOLE CARDS ***
HPEB+AtKw1+C/cxU0o1ciw: folds 
dtZ84flFEi4Q+SGrHMJRDQ: folds 
PdIasPkzm2sqZnN41ZRXOg: folds 
57qrNGHDvf6GhB8zVLsAtQ: folds 
YZaC69gFrepA6oCGtu7E0w: calls $0.25
6RiVTYll/5D8zICp0MRpKw: folds 
Ihhh49x48fayPIyvl2Rsmg: folds 
AyqFvLFzJDE7yMbXP362BA: calls $0.15
PVxvfRTRvkgZf9WtquEkwQ: checks 
*** FLOP *** [3c Qc 8s]
AyqFvLFzJDE7yMbXP362BA: checks 
PVxvfRTRvkgZf9WtquEkwQ: checks 
YZaC69gFrepA6oCGtu7E0w: checks 
*** TURN *** [3c Qc 8s] [7d]
AyqFvLFzJDE7yMbXP362BA: bets $0.25
PVxvfRTRvkgZf9WtquEkwQ: folds 
YZaC69gFrepA6oCGtu7E0w: calls $0.25
*** RIVER *** [3c Qc 8s 7d] [8c]
AyqFvLFzJDE7yMbXP362BA: checks 
YZaC69gFrepA6oCGtu7E0w: bets $1
AyqFvLFzJDE7yMbXP362BA: calls $1
*** SHOW DOWN ***
YZaC69gFrepA6oCGtu7E0w: shows [5d 5s] (two pair, Eights and Fives)
AyqFvLFzJDE7yMbXP362BA: shows [Js 7c] (two pair, Eights and Sevens)
AyqFvLFzJDE7yMbXP362BA collected $3.10 from pot
*** SUMMARY ***
Total pot $3.25 | Rake $0.15 
Board [3c Qc 8s 7d 8c]
Seat 1: PVxvfRTRvkgZf9WtquEkwQ (big blind) folded on the Turn
Seat 2: HPEB+AtKw1+C/cxU0o1ciw folded before Flop (didn't bet)
Seat 3: dtZ84flFEi4Q+SGrHMJRDQ folded before Flop (didn't bet)
Seat 4: PdIasPkzm2sqZnN41ZRXOg folded before Flop (didn't bet)
Seat 5: 57qrNGHDvf6GhB8zVLsAtQ folded before Flop (didn't bet)
Seat 6: YZaC69gFrepA6oCGtu7E0w showed [5d 5s] and lost with two pair, Eights and Fives
Seat 7: 6RiVTYll/5D8zICp0MRpKw folded before Flop (didn't bet)
Seat 8: Ihhh49x48fayPIyvl2Rsmg (button) folded before Flop (didn't bet)
Seat 9: AyqFvLFzJDE7yMbXP362BA (small blind) showed [Js 7c] and won ($3.10) with two pair, Eights and Sevens




PokerStars Game #59941620256:  Hold'em No Limit ($0.10/$0.25) - 2009/07/01 1:40:57 ET
Table '+fuYjvJy9okLr23QyZtanA' 9-max Seat #5 is the button
Seat 1: l9hUFnOCgg4TPYga9bvxhw ($10.70 in chips) 
Seat 2: tLcDklc2rBORNfixyRfVfw ($25.10 in chips) 
Seat 3: eK8qa6EPcH2zhtbmWSvc9g ($52.65 in chips) 
Seat 4: Bb42QRQMhg5/Y0vHP8/2Xw ($30.50 in chips) 
Seat 5: bXpVeaSTPBFSPJmeXxO7nw ($4.65 in chips) 
Seat 6: wGigCmBR/9XWkPpvYos3aQ ($25.90 in chips) 
Seat 7: dfNim92Z6XK1/h5SFW5vDg ($26.55 in chips) 
Seat 8: qpG9m8I+cPw8VhB0mnGjYw ($17.75 in chips) 
Seat 9: OMhlmt2waO3z43ZSFNMmog ($29.15 in chips) 
wGigCmBR/9XWkPpvYos3aQ: posts small blind $0.10
dfNim92Z6XK1/h5SFW5vDg: posts big blind $0.25
*** HOLE CARDS ***
qpG9m8I+cPw8VhB0mnGjYw: folds 
OMhlmt2waO3z43ZSFNMmog: folds 
l9hUFnOCgg4TPYga9bvxhw: folds 
tLcDklc2rBORNfixyRfVfw: folds 
eK8qa6EPcH2zhtbmWSvc9g: folds 
Bb42QRQMhg5/Y0vHP8/2Xw: folds 
bXpVeaSTPBFSPJmeXxO7nw: folds 
wGigCmBR/9XWkPpvYos3aQ: folds 
Uncalled bet ($0.15) returned to dfNim92Z6XK1/h5SFW5vDg
dfNim92Z6XK1/h5SFW5vDg collected $0.20 from pot
dfNim92Z6XK1/h5SFW5vDg: doesn't show hand 
*** SUMMARY ***
Total pot $0.20 | Rake $0 
Seat 1: l9hUFnOCgg4TPYga9bvxhw folded before Flop (didn't bet)
Seat 2: tLcDklc2rBORNfixyRfVfw folded before Flop (didn't bet)
Seat 3: eK8qa6EPcH2zhtbmWSvc9g folded before Flop (didn't bet)
Seat 4: Bb42QRQMhg5/Y0vHP8/2Xw folded before Flop (didn't bet)
Seat 5: bXpVeaSTPBFSPJmeXxO7nw (button) folded before Flop (didn't bet)
Seat 6: wGigCmBR/9XWkPpvYos3aQ (small blind) folded before Flop
Seat 7: dfNim92Z6XK1/h5SFW5vDg (big blind) collected ($0.20)
Seat 8: qpG9m8I+cPw8VhB0mnGjYw folded before Flop (didn't bet)
Seat 9: OMhlmt2waO3z43ZSFNMmog folded before Flop (didn't bet)




PokerStars Game #59941620408:  Hold'em No Limit ($0.10/$0.25) - 2009/07/01 1:40:57 ET
Table 'zhqgUUprOJ14VxKxPHcT/Q' 9-max Seat #8 is the button
Seat 1: 22dIObOuor/A+IKWkNoAlA ($5 in chips) 
Seat 2: GY095KWhBevJ1Ttvl8WseA ($8.10 in chips) 
Seat 3: 4XHsdGnQ76EBdBvsrSs8bA ($25 in chips) 
Seat 4: wGigCmBR/9XWkPpvYos3aQ ($33.45 in chips) 
Seat 5: +sbyWwIcFp9kP0bDtMegfQ ($33.60 in chips) 
Seat 7: sGFnnRCa1YAHAUmWgsW6Qg ($11 in chips) 
Seat 8: EQXHDnIzAsORnIXRNtXRlA ($24.35 in chips) 
Seat 9: 4awUyiDYTgylQKXZ9faBVA ($33.05 in chips) 
4awUyiDYTgylQKXZ9faBVA: posts small blind $0.10
22dIObOuor/A+IKWkNoAlA: posts big blind $0.25
4XHsdGnQ76EBdBvsrSs8bA: posts big blind $0.25
PdIasPkzm2sqZnN41ZRXOg: sits out 
*** HOLE CARDS ***
GY095KWhBevJ1Ttvl8WseA: folds 
4XHsdGnQ76EBdBvsrSs8bA: checks 
wGigCmBR/9XWkPpvYos3aQ: folds 
+sbyWwIcFp9kP0bDtMegfQ: folds 
sGFnnRCa1YAHAUmWgsW6Qg: folds 
EQXHDnIzAsORnIXRNtXRlA: folds 
4awUyiDYTgylQKXZ9faBVA: raises $1 to $1.25
22dIObOuor/A+IKWkNoAlA: folds 
4XHsdGnQ76EBdBvsrSs8bA: calls $1
*** FLOP *** [3d 7d 5d]
4awUyiDYTgylQKXZ9faBVA: bets $1.50
4XHsdGnQ76EBdBvsrSs8bA: calls $1.50
*** TURN *** [3d 7d 5d] [Js]
4awUyiDYTgylQKXZ9faBVA: bets $3.50
4XHsdGnQ76EBdBvsrSs8bA: calls $3.50
*** RIVER *** [3d 7d 5d Js] [3c]
4awUyiDYTgylQKXZ9faBVA: checks 
4XHsdGnQ76EBdBvsrSs8bA: bets $3.75
4awUyiDYTgylQKXZ9faBVA: folds 
Uncalled bet ($3.75) returned to 4XHsdGnQ76EBdBvsrSs8bA
4XHsdGnQ76EBdBvsrSs8bA collected $12.15 from pot
4XHsdGnQ76EBdBvsrSs8bA: doesn't show hand 
*** SUMMARY ***
Total pot $12.75 | Rake $0.60 
Board [3d 7d 5d Js 3c]
Seat 1: 22dIObOuor/A+IKWkNoAlA (big blind) folded before Flop
Seat 2: GY095KWhBevJ1Ttvl8WseA folded before Flop (didn't bet)
Seat 3: 4XHsdGnQ76EBdBvsrSs8bA collected ($12.15)
Seat 4: wGigCmBR/9XWkPpvYos3aQ folded before Flop (didn't bet)
Seat 5: +sbyWwIcFp9kP0bDtMegfQ folded before Flop (didn't bet)
Seat 7: sGFnnRCa1YAHAUmWgsW6Qg folded before Flop (didn't bet)
Seat 8: EQXHDnIzAsORnIXRNtXRlA (button) folded before Flop (didn't bet)
Seat 9: 4awUyiDYTgylQKXZ9faBVA (small blind) folded on the River




PokerStars Game #59941620166:  Hold'em No Limit ($0.10/$0.25) - 2009/07/01 1:40:57 ET
Table 'mVdLgAdN9rGe6mMwSrDdGQ' 6-max Seat #4 is the button
Seat 1: OyJ0KTHA5cwh0/yCo1/rdA ($12 in chips) 
Seat 3: +baiVgI/ETnBARLe5mARCw ($11.35 in chips) 
Seat 4: scNSjC6yyKvvfklSkuzLrw ($17.20 in chips) 
Seat 5: +TMG/MBWpiEnc9t7i07eTA ($19.65 in chips) 
Seat 6: DihMHaz4WNETH1bPDe13kA ($47.55 in chips) 
+TMG/MBWpiEnc9t7i07eTA: posts small blind $0.10
DihMHaz4WNETH1bPDe13kA: posts big blind $0.25
OyJ0KTHA5cwh0/yCo1/rdA: posts big blind $0.25
crazyconflit: sits out 
*** HOLE CARDS ***
OyJ0KTHA5cwh0/yCo1/rdA: raises $0.50 to $0.75
+baiVgI/ETnBARLe5mARCw: folds 
scNSjC6yyKvvfklSkuzLrw: folds 
+TMG/MBWpiEnc9t7i07eTA: calls $0.65
DihMHaz4WNETH1bPDe13kA: folds 
*** FLOP *** [4h 6h 3s]
+TMG/MBWpiEnc9t7i07eTA: checks 
OyJ0KTHA5cwh0/yCo1/rdA: bets $1.50
+TMG/MBWpiEnc9t7i07eTA: raises $1.50 to $3
OyJ0KTHA5cwh0/yCo1/rdA: raises $2.25 to $5.25
+TMG/MBWpiEnc9t7i07eTA: raises $2.25 to $7.50
OyJ0KTHA5cwh0/yCo1/rdA: calls $2.25
*** TURN *** [4h 6h 3s] [Jd]
+TMG/MBWpiEnc9t7i07eTA: bets $2.25
OyJ0KTHA5cwh0/yCo1/rdA: raises $1.50 to $3.75 and is all-in
+TMG/MBWpiEnc9t7i07eTA: calls $1.50
*** RIVER *** [4h 6h 3s Jd] [9d]
*** SHOW DOWN ***
+TMG/MBWpiEnc9t7i07eTA: shows [6c 6d] (three of a kind, Sixes)
OyJ0KTHA5cwh0/yCo1/rdA: mucks hand 
+TMG/MBWpiEnc9t7i07eTA collected $23.10 from pot
*** SUMMARY ***
Total pot $24.25 | Rake $1.15 
Board [4h 6h 3s Jd 9d]
Seat 1: OyJ0KTHA5cwh0/yCo1/rdA mucked
Seat 3: +baiVgI/ETnBARLe5mARCw folded before Flop (didn't bet)
Seat 4: scNSjC6yyKvvfklSkuzLrw (button) folded before Flop (didn't bet)
Seat 5: +TMG/MBWpiEnc9t7i07eTA (small blind) showed [6c 6d] and won ($23.10) with three of a kind, Sixes
Seat 6: DihMHaz4WNETH1bPDe13kA (big blind) folded before Flop




PokerStars Game #59941620792:  Hold'em No Limit ($0.10/$0.25) - 2009/07/01 1:40:58 ET
Table 'oZuNsbNJuUyQLGKzQ/4JFg' 6-max Seat #2 is the button
Seat 1: vqWjZmdQu/Hxw96/IJTWdQ ($25 in chips) 
Seat 2: UA5OsKS3VPaxa7uC8La/kA ($33 in chips) 
Seat 3: 8ClCHtFXGNplITm+63KB+Q ($51.85 in chips) 
Seat 5: oBUDUfeUyCbZBsjxHZgSiw ($27.15 in chips) 
Seat 6: fwg6dK1+r4jy/y+JqenYYQ ($14.65 in chips) 
8ClCHtFXGNplITm+63KB+Q: posts small blind $0.10
oBUDUfeUyCbZBsjxHZgSiw: posts big blind $0.25
*** HOLE CARDS ***
df01R5ThvHspD8FgKmaDvQ leaves the table
fwg6dK1+r4jy/y+JqenYYQ: folds 
geomdnb joins the table at seat #4 
vqWjZmdQu/Hxw96/IJTWdQ: raises $0.75 to $1
UA5OsKS3VPaxa7uC8La/kA: folds 
8ClCHtFXGNplITm+63KB+Q: folds 
oBUDUfeUyCbZBsjxHZgSiw: folds 
Uncalled bet ($0.75) returned to vqWjZmdQu/Hxw96/IJTWdQ
vqWjZmdQu/Hxw96/IJTWdQ collected $0.60 from pot
vqWjZmdQu/Hxw96/IJTWdQ: doesn't show hand 
*** SUMMARY ***
Total pot $0.60 | Rake $0 
Seat 1: vqWjZmdQu/Hxw96/IJTWdQ collected ($0.60)
Seat 2: UA5OsKS3VPaxa7uC8La/kA (button) folded before Flop (didn't bet)
Seat 3: 8ClCHtFXGNplITm+63KB+Q (small blind) folded before Flop
Seat 5: oBUDUfeUyCbZBsjxHZgSiw (big blind) folded before Flop
Seat 6: fwg6dK1+r4jy/y+JqenYYQ folded before Flop (didn't bet)




PokerStars Game #59941621052:  Hold'em No Limit ($0.10/$0.25) - 2009/07/01 1:40:58 ET
Table 'fHv1Mk7ZbLjprZTGWKPiEQ' 6-max Seat #4 is the button
Seat 3: /gJNBeCkWL4o85/jvlZ4BA ($25 in chips) 
Seat 4: TSmua8tGK3sTbwi0ynrW9Q ($51.90 in chips) 
Seat 5: LJI7A1YgDM7hgh7o56+ReQ ($27.50 in chips) 
Seat 6: AjG0X+rNtc2W08eph8oqpw ($36.20 in chips) 
LJI7A1YgDM7hgh7o56+ReQ: posts small blind $0.10
AjG0X+rNtc2W08eph8oqpw: posts big blind $0.25
arewedunces: sits out 
*** HOLE CARDS ***
/gJNBeCkWL4o85/jvlZ4BA: raises $0.75 to $1
TSmua8tGK3sTbwi0ynrW9Q: calls $1
LJI7A1YgDM7hgh7o56+ReQ: folds 
AjG0X+rNtc2W08eph8oqpw: folds 
*** FLOP *** [6h 7d 8h]
/gJNBeCkWL4o85/jvlZ4BA: bets $2.25
TSmua8tGK3sTbwi0ynrW9Q: calls $2.25
*** TURN *** [6h 7d 8h] [6s]
/gJNBeCkWL4o85/jvlZ4BA: bets $4
TSmua8tGK3sTbwi0ynrW9Q: raises $7 to $11
/gJNBeCkWL4o85/jvlZ4BA: folds 
Uncalled bet ($7) returned to TSmua8tGK3sTbwi0ynrW9Q
TSmua8tGK3sTbwi0ynrW9Q collected $14.15 from pot
*** SUMMARY ***
Total pot $14.85 | Rake $0.70 
Board [6h 7d 8h 6s]
Seat 3: /gJNBeCkWL4o85/jvlZ4BA folded on the Turn
Seat 4: TSmua8tGK3sTbwi0ynrW9Q (button) collected ($14.15)
Seat 5: LJI7A1YgDM7hgh7o56+ReQ (small blind) folded before Flop
Seat 6: AjG0X+rNtc2W08eph8oqpw (big blind) folded before Flop




PokerStars Game #59941620542:  Hold'em No Limit ($0.10/$0.25) - 2009/07/01 1:40:58 ET
Table 'WY+lMaAoIdBZmwk27/RJCA' 6-max Seat #6 is the button
Seat 1: zHHLkD2sRljslKKeQv/ZQw ($24.95 in chips) 
Seat 2: NhUN/JpAprdJeamFBgJH1w ($26.90 in chips) 
Seat 3: 79Q62AM0VB++TQYiBlOYsA ($80.90 in chips) 
Seat 4: 0av6tRNdi0Ui4f15L7gsVg ($22.15 in chips) 
Seat 5: vqWjZmdQu/Hxw96/IJTWdQ ($30.45 in chips) 
Seat 6: cWc85bEzdRzpUMhRKm8pwQ ($25.85 in chips) 
zHHLkD2sRljslKKeQv/ZQw: posts small blind $0.10
NhUN/JpAprdJeamFBgJH1w: posts big blind $0.25
*** HOLE CARDS ***
79Q62AM0VB++TQYiBlOYsA: calls $0.25
0av6tRNdi0Ui4f15L7gsVg: folds 
vqWjZmdQu/Hxw96/IJTWdQ: raises $0.75 to $1
cWc85bEzdRzpUMhRKm8pwQ: folds 
zHHLkD2sRljslKKeQv/ZQw: folds 
NhUN/JpAprdJeamFBgJH1w: folds 
79Q62AM0VB++TQYiBlOYsA: calls $0.75
*** FLOP *** [5s 4d 2s]
79Q62AM0VB++TQYiBlOYsA: checks 
vqWjZmdQu/Hxw96/IJTWdQ: checks 
*** TURN *** [5s 4d 2s] [4c]
79Q62AM0VB++TQYiBlOYsA: checks 
vqWjZmdQu/Hxw96/IJTWdQ: checks 
*** RIVER *** [5s 4d 2s 4c] [7h]
79Q62AM0VB++TQYiBlOYsA: checks 
vqWjZmdQu/Hxw96/IJTWdQ: checks 
*** SHOW DOWN ***
79Q62AM0VB++TQYiBlOYsA: shows [Js Ad] (a pair of Fours)
vqWjZmdQu/Hxw96/IJTWdQ: mucks hand 
79Q62AM0VB++TQYiBlOYsA collected $2.25 from pot
*** SUMMARY ***
Total pot $2.35 | Rake $0.10 
Board [5s 4d 2s 4c 7h]
Seat 1: zHHLkD2sRljslKKeQv/ZQw (small blind) folded before Flop
Seat 2: NhUN/JpAprdJeamFBgJH1w (big blind) folded before Flop
Seat 3: 79Q62AM0VB++TQYiBlOYsA showed [Js Ad] and won ($2.25) with a pair of Fours
Seat 4: 0av6tRNdi0Ui4f15L7gsVg folded before Flop (didn't bet)
Seat 5: vqWjZmdQu/Hxw96/IJTWdQ mucked
Seat 6: cWc85bEzdRzpUMhRKm8pwQ (button) folded before Flop (didn't bet)




PokerStars Game #59941621102:  Hold'em No Limit ($0.10/$0.25) - 2009/07/01 1:40:58 ET
Table '8QBBaev+cI2i/r2H6ml/lg' 9-max Seat #9 is the button
Seat 1: s2xLPOl/vhl/26apJ3vsOQ ($34.20 in chips) 
Seat 3: zgi+EUykT/pZQpoUG6+oEg ($4.65 in chips) 
Seat 4: ytpGB2nr/CLVHnyKMRiEFQ ($15 in chips) 
Seat 5: 0QdZrkFD7aGKeBXPGbIomA ($11.70 in chips) 
Seat 7: eK8qa6EPcH2zhtbmWSvc9g ($31.05 in chips) 
Seat 8: vr1IK/Q4HXm8s8V0/dePzQ ($12.80 in chips) 
Seat 9: EUMLvzDkECHBit+xa+uGjg ($23.15 in chips) 
s2xLPOl/vhl/26apJ3vsOQ: posts small blind $0.10
1S/fpm+f42V/6MNZre+ccg: is sitting out 
zgi+EUykT/pZQpoUG6+oEg: posts big blind $0.25
*** HOLE CARDS ***
1S/fpm+f42V/6MNZre+ccg leaves the table
ytpGB2nr/CLVHnyKMRiEFQ: folds 
0QdZrkFD7aGKeBXPGbIomA: folds 
eK8qa6EPcH2zhtbmWSvc9g: folds 
vr1IK/Q4HXm8s8V0/dePzQ: folds 
EUMLvzDkECHBit+xa+uGjg: raises $0.50 to $0.75
s2xLPOl/vhl/26apJ3vsOQ: calls $0.65
zgi+EUykT/pZQpoUG6+oEg: folds 
*** FLOP *** [2d Qc Ts]
s2xLPOl/vhl/26apJ3vsOQ: checks 
EUMLvzDkECHBit+xa+uGjg: bets $0.75
s2xLPOl/vhl/26apJ3vsOQ: calls $0.75
*** TURN *** [2d Qc Ts] [5h]
s2xLPOl/vhl/26apJ3vsOQ: checks 
EUMLvzDkECHBit+xa+uGjg: bets $1.75
X6+pSIPfovPcE87t+LmUKQ joins the table at seat #6 
s2xLPOl/vhl/26apJ3vsOQ: folds 
Uncalled bet ($1.75) returned to EUMLvzDkECHBit+xa+uGjg
EUMLvzDkECHBit+xa+uGjg collected $3.10 from pot
*** SUMMARY ***
Total pot $3.25 | Rake $0.15 
Board [2d Qc Ts 5h]
Seat 1: s2xLPOl/vhl/26apJ3vsOQ (small blind) folded on the Turn
Seat 3: zgi+EUykT/pZQpoUG6+oEg (big blind) folded before Flop
Seat 4: ytpGB2nr/CLVHnyKMRiEFQ folded before Flop (didn't bet)
Seat 5: 0QdZrkFD7aGKeBXPGbIomA folded before Flop (didn't bet)
Seat 7: eK8qa6EPcH2zhtbmWSvc9g folded before Flop (didn't bet)
Seat 8: vr1IK/Q4HXm8s8V0/dePzQ folded before Flop (didn't bet)
Seat 9: EUMLvzDkECHBit+xa+uGjg (button) collected ($3.10)




PokerStars Game #59941621274:  Hold'em No Limit ($0.10/$0.25) - 2009/07/01 1:40:59 ET
Table 'KU/HrxqxwDz8HKEhYTZ6uw' 6-max Seat #5 is the button
Seat 1: 7LKoiQHXpTQXJvWQrw907g ($30 in chips) 
Seat 2: kG34n23qFQA3nzdOJTQ1dA ($22.10 in chips) 
Seat 3: SFmT9ZsVopnukjvAzrxTRg ($25.80 in chips) 
Seat 4: AGwMM0FUhYZf81+oXvYQMg ($24.90 in chips) 
Seat 5: iyZxqznXjv3vtvOJymkoLQ ($50.90 in chips) 
Seat 6: qWxkCeqApAWdAA0evrfDvQ ($18.05 in chips) 
qWxkCeqApAWdAA0evrfDvQ: posts small blind $0.10
7LKoiQHXpTQXJvWQrw907g: posts big blind $0.25
*** HOLE CARDS ***
kG34n23qFQA3nzdOJTQ1dA: folds 
SFmT9ZsVopnukjvAzrxTRg: folds 
AGwMM0FUhYZf81+oXvYQMg: folds 
iyZxqznXjv3vtvOJymkoLQ: raises $0.75 to $1
qWxkCeqApAWdAA0evrfDvQ: folds 
7LKoiQHXpTQXJvWQrw907g: folds 
Uncalled bet ($0.75) returned to iyZxqznXjv3vtvOJymkoLQ
iyZxqznXjv3vtvOJymkoLQ collected $0.60 from pot
iyZxqznXjv3vtvOJymkoLQ: doesn't show hand 
*** SUMMARY ***
Total pot $0.60 | Rake $0 
Seat 1: 7LKoiQHXpTQXJvWQrw907g (big blind) folded before Flop
Seat 2: kG34n23qFQA3nzdOJTQ1dA folded before Flop (didn't bet)
Seat 3: SFmT9ZsVopnukjvAzrxTRg folded before Flop (didn't bet)
Seat 4: AGwMM0FUhYZf81+oXvYQMg folded before Flop (didn't bet)
Seat 5: iyZxqznXjv3vtvOJymkoLQ (button) collected ($0.60)
Seat 6: qWxkCeqApAWdAA0evrfDvQ (small blind) folded before Flop




PokerStars Game #59941621344:  Hold'em No Limit ($0.10/$0.25) - 2009/07/01 1:40:59 ET
Table 'wGizWOswEL6P5QrvVkno/g' 6-max Seat #5 is the button
Seat 1: Qbfkn+ucISvbd1Xh32zAGA ($25 in chips) 
Seat 2: mfrkWA3PTeYPkbO6hi98Aw ($25 in chips) 
Seat 3: bJFzs6QmEEnz4miMfSDtcg ($14.75 in chips) 
Seat 4: 32YL2ZEp8NT4JB2RVM9euQ ($16.65 in chips) 
Seat 5: wsP46AGpqDjHZQmlRHKa9g ($39.40 in chips) 
Seat 6: rfSnsAuAfXTb8w/obc9OVQ ($7.30 in chips) 
rfSnsAuAfXTb8w/obc9OVQ: posts small blind $0.10
Qbfkn+ucISvbd1Xh32zAGA: posts big blind $0.25
*** HOLE CARDS ***
mfrkWA3PTeYPkbO6hi98Aw: folds 
bJFzs6QmEEnz4miMfSDtcg: folds 
32YL2ZEp8NT4JB2RVM9euQ: folds 
wsP46AGpqDjHZQmlRHKa9g: folds 
rfSnsAuAfXTb8w/obc9OVQ: raises $0.50 to $0.75
Qbfkn+ucISvbd1Xh32zAGA: folds 
Uncalled bet ($0.50) returned to rfSnsAuAfXTb8w/obc9OVQ
rfSnsAuAfXTb8w/obc9OVQ collected $0.50 from pot
rfSnsAuAfXTb8w/obc9OVQ: doesn't show hand 
*** SUMMARY ***
Total pot $0.50 | Rake $0 
Seat 1: Qbfkn+ucISvbd1Xh32zAGA (big blind) folded before Flop
Seat 2: mfrkWA3PTeYPkbO6hi98Aw folded before Flop (didn't bet)
Seat 3: bJFzs6QmEEnz4miMfSDtcg folded before Flop (didn't bet)
Seat 4: 32YL2ZEp8NT4JB2RVM9euQ folded before Flop (didn't bet)
Seat 5: wsP46AGpqDjHZQmlRHKa9g (button) folded before Flop (didn't bet)
Seat 6: rfSnsAuAfXTb8w/obc9OVQ (small blind) collected ($0.50)




PokerStars Game #59941621698:  Hold'em No Limit ($0.10/$0.25) - 2009/07/01 1:40:59 ET
Table 'vFZR6Kf2Th5xBXT9brGW6A' 6-max Seat #4 is the button
Seat 1: Q3EMN7b0ie81AFWkDrhCjw ($20.55 in chips) 
Seat 2: QiL+lEgEWwy21jk/ltaRLg ($23.40 in chips) 
Seat 3: SH1WjKVUjPiyXySjWSdazw ($24.10 in chips) 
Seat 4: 79ID/ub1Pt/mDpCprVmOoA ($35.55 in chips) 
Seat 5: SS/yfeArhULzIcOPe8MdPg ($25.75 in chips) 
Seat 6: 4x9jCqgSw4272dnaIqnanw ($4.10 in chips) 
SS/yfeArhULzIcOPe8MdPg: posts small blind $0.10
4x9jCqgSw4272dnaIqnanw: posts big blind $0.25
*** HOLE CARDS ***
Q3EMN7b0ie81AFWkDrhCjw: raises $0.50 to $0.75
QiL+lEgEWwy21jk/ltaRLg: folds 
SH1WjKVUjPiyXySjWSdazw: folds 
79ID/ub1Pt/mDpCprVmOoA: folds 
SS/yfeArhULzIcOPe8MdPg: folds 
4x9jCqgSw4272dnaIqnanw: calls $0.50
*** FLOP *** [6c Ts 2s]
4x9jCqgSw4272dnaIqnanw: checks 
Q3EMN7b0ie81AFWkDrhCjw: bets $0.75
4x9jCqgSw4272dnaIqnanw: folds 
Uncalled bet ($0.75) returned to Q3EMN7b0ie81AFWkDrhCjw
Q3EMN7b0ie81AFWkDrhCjw collected $1.55 from pot
*** SUMMARY ***
Total pot $1.60 | Rake $0.05 
Board [6c Ts 2s]
Seat 1: Q3EMN7b0ie81AFWkDrhCjw collected ($1.55)
Seat 2: QiL+lEgEWwy21jk/ltaRLg folded before Flop (didn't bet)
Seat 3: SH1WjKVUjPiyXySjWSdazw folded before Flop (didn't bet)
Seat 4: 79ID/ub1Pt/mDpCprVmOoA (button) folded before Flop (didn't bet)
Seat 5: SS/yfeArhULzIcOPe8MdPg (small blind) folded before Flop
Seat 6: 4x9jCqgSw4272dnaIqnanw (big blind) folded on the Flop




PokerStars Game #59941621426:  Hold'em No Limit ($0.10/$0.25) - 2009/07/01 1:40:59 ET
Table 'oJpFwZj9+FUGHX90Un8s9Q' 6-max Seat #3 is the button
Seat 1: 6DwBRH+xZ12AAZmeAg+aXw ($22.95 in chips) 
Seat 2: NtrVQ9UIql0rDCnKDKZ5FQ ($7.60 in chips) 
Seat 3: kyRaCIljYA6l33lSKQfNsg ($24.65 in chips) 
Seat 4: 6elpmfyt4Zw0yvd8lePSMQ ($23.25 in chips) 
Seat 5: kG34n23qFQA3nzdOJTQ1dA ($56.45 in chips) 
Seat 6: edio/rLJ06xeZOfLhoL3UA ($9 in chips) 
6elpmfyt4Zw0yvd8lePSMQ: posts small blind $0.10
kG34n23qFQA3nzdOJTQ1dA: posts big blind $0.25
*** HOLE CARDS ***
edio/rLJ06xeZOfLhoL3UA: folds 
6DwBRH+xZ12AAZmeAg+aXw: folds 
NtrVQ9UIql0rDCnKDKZ5FQ: calls $0.25
kyRaCIljYA6l33lSKQfNsg: folds 
6elpmfyt4Zw0yvd8lePSMQ: calls $0.15
kG34n23qFQA3nzdOJTQ1dA: checks 
*** FLOP *** [7s 9s 2h]
6elpmfyt4Zw0yvd8lePSMQ: checks 
kG34n23qFQA3nzdOJTQ1dA: checks 
NtrVQ9UIql0rDCnKDKZ5FQ: checks 
*** TURN *** [7s 9s 2h] [Kd]
6elpmfyt4Zw0yvd8lePSMQ: bets $0.25
kG34n23qFQA3nzdOJTQ1dA: folds 
NtrVQ9UIql0rDCnKDKZ5FQ: calls $0.25
*** RIVER *** [7s 9s 2h Kd] [4s]
6elpmfyt4Zw0yvd8lePSMQ: checks 
NtrVQ9UIql0rDCnKDKZ5FQ: checks 
*** SHOW DOWN ***
6elpmfyt4Zw0yvd8lePSMQ: shows [8h 6c] (high card King)
NtrVQ9UIql0rDCnKDKZ5FQ: shows [Jh Tc] (high card King - Jack kicker)
NtrVQ9UIql0rDCnKDKZ5FQ collected $1.20 from pot
*** SUMMARY ***
Total pot $1.25 | Rake $0.05 
Board [7s 9s 2h Kd 4s]
Seat 1: 6DwBRH+xZ12AAZmeAg+aXw folded before Flop (didn't bet)
Seat 2: NtrVQ9UIql0rDCnKDKZ5FQ showed [Jh Tc] and won ($1.20) with high card King
Seat 3: kyRaCIljYA6l33lSKQfNsg (button) folded before Flop (didn't bet)
Seat 4: 6elpmfyt4Zw0yvd8lePSMQ (small blind) showed [8h 6c] and lost with high card King
Seat 5: kG34n23qFQA3nzdOJTQ1dA (big blind) folded on the Turn
Seat 6: edio/rLJ06xeZOfLhoL3UA folded before Flop (didn't bet)




PokerStars Game #59941621170:  Hold'em No Limit ($0.10/$0.25) - 2009/07/01 1:40:59 ET
Table '0XPo7K54oZIfG0xlNAcDRwnQC9LRg01NEuKFHF1nrDEw-max Seat #3 is the button
Seat 2: lYjWCpfCxX2kgcHY3v4Yow ($41.25 in chips) 
Seat 3: 6+g0Lb6vfRDZkElV8ieHyQ ($19.65 in chips) 
Seat 5: kG34n23qFQA3nzdOJTQ1dA ($29.15 in chips) 
Seat 6: xQVFeVUDopz+akuEo2wXpQ ($58.30 in chips) 
kG34n23qFQA3nzdOJTQ1dA: posts small blind $0.10
xQVFeVUDopz+akuEo2wXpQ: posts big blind $0.25
*** HOLE CARDS ***
lYjWCpfCxX2kgcHY3v4Yow: folds 
6+g0Lb6vfRDZkElV8ieHyQ: calls $0.25
kG34n23qFQA3nzdOJTQ1dA: folds 
qf+LMbROj8/qY878wkFHbQ has returned
xQVFeVUDopz+akuEo2wXpQ: checks 
*** FLOP *** [Jh 9c Qh]
xQVFeVUDopz+akuEo2wXpQ: bets $2
6+g0Lb6vfRDZkElV8ieHyQ: folds 
Uncalled bet ($2) returned to xQVFeVUDopz+akuEo2wXpQ
xQVFeVUDopz+akuEo2wXpQ collected $0.60 from pot
*** SUMMARY ***
Total pot $0.60 | Rake $0 
Board [Jh 9c Qh]
Seat 2: lYjWCpfCxX2kgcHY3v4Yow folded before Flop (didn't bet)
Seat 3: 6+g0Lb6vfRDZkElV8ieHyQ (button) folded on the Flop
Seat 5: kG34n23qFQA3nzdOJTQ1dA (small blind) folded before Flop
Seat 6: xQVFeVUDopz+akuEo2wXpQ (big blind) collected ($0.60)




PokerStars Game #59941621604:  Hold'em No Limit ($0.10/$0.25) - 2009/07/01 1:40:59 ET
Table 'KTZXQ4LREPjpS54R3DFTsw' 9-max Seat #7 is the button
Seat 1: dSjkBIV7Bv+ZCIWNBguf7w ($40.50 in chips) 
Seat 2: 6LFELL8V3NTpb0xg7AOyEg ($11.30 in chips) 
Seat 3: H5Se03ZqSX7tbULXur2MAg ($23.65 in chips) 
Seat 4: K0b5wNInj6hUGRr6yzKFtw ($64 in chips) 
Seat 5: HPEB+AtKw1+C/cxU0o1ciw ($30.20 in chips) 
Seat 6: Mh2r9hTeTEDnh19sRZtW3g ($5.70 in chips) 
Seat 7: yyG4svzOpC1A+sUP/scg6w ($10.95 in chips) 
Seat 8: X1ucS3BHyBPongKl1Q+eEQ ($15.25 in chips) 
Seat 9: V6p0jQ/RhUsqpHLmXvEX4Q ($12.35 in chips) 
X1ucS3BHyBPongKl1Q+eEQ: posts small blind $0.10
V6p0jQ/RhUsqpHLmXvEX4Q: posts big blind $0.25
*** HOLE CARDS ***
dSjkBIV7Bv+ZCIWNBguf7w: folds 
6LFELL8V3NTpb0xg7AOyEg: folds 
H5Se03ZqSX7tbULXur2MAg: folds 
K0b5wNInj6hUGRr6yzKFtw: folds 
HPEB+AtKw1+C/cxU0o1ciw: folds 
Mh2r9hTeTEDnh19sRZtW3g: folds 
yyG4svzOpC1A+sUP/scg6w: folds 
X1ucS3BHyBPongKl1Q+eEQ: calls $0.15
V6p0jQ/RhUsqpHLmXvEX4Q: raises $0.75 to $1
X1ucS3BHyBPongKl1Q+eEQ: raises $0.75 to $1.75
V6p0jQ/RhUsqpHLmXvEX4Q: calls $0.75
*** FLOP *** [7c 2c Qc]
X1ucS3BHyBPongKl1Q+eEQ: checks 
V6p0jQ/RhUsqpHLmXvEX4Q: bets $2.50
X1ucS3BHyBPongKl1Q+eEQ: raises $11 to $13.50 and is all-in
V6p0jQ/RhUsqpHLmXvEX4Q: folds 
Uncalled bet ($11) returned to X1ucS3BHyBPongKl1Q+eEQ
X1ucS3BHyBPongKl1Q+eEQ collected $8.10 from pot
X1ucS3BHyBPongKl1Q+eEQ: shows [Ah Ac] (a pair of Aces)
*** SUMMARY ***
Total pot $8.50 | Rake $0.40 
Board [7c 2c Qc]
Seat 1: dSjkBIV7Bv+ZCIWNBguf7w folded before Flop (didn't bet)
Seat 2: 6LFELL8V3NTpb0xg7AOyEg folded before Flop (didn't bet)
Seat 3: H5Se03ZqSX7tbULXur2MAg folded before Flop (didn't bet)
Seat 4: K0b5wNInj6hUGRr6yzKFtw folded before Flop (didn't bet)
Seat 5: HPEB+AtKw1+C/cxU0o1ciw folded before Flop (didn't bet)
Seat 6: Mh2r9hTeTEDnh19sRZtW3g folded before Flop (didn't bet)
Seat 7: yyG4svzOpC1A+sUP/scg6w (button) folded before Flop (didn't bet)
Seat 8: X1ucS3BHyBPongKl1Q+eEQ (small blind) collected ($8.10)
Seat 9: V6p0jQ/RhUsqpHLmXvEX4Q (big blind) folded on the Flop




PokerStars Game #59941621320:  Hold'em No Limit ($0.10/$0.25) - 2009/07/01 1:40:59 ET
Table 'AUM6O+mgQAaLDZKMQ/5/gA' 9-max Seat #9 is the button
Seat 1: EIObtVVE4WXRXvLGJA6NHw ($18.15 in chips) 
Seat 2: OXPkK84/qv92EMwXPiG5rQ ($9.50 in chips) 
Seat 3: CvL9Ch1HYCVbTsfpNucitg ($3.75 in chips) 
Seat 4: 4awUyiDYTgylQKXZ9faBVA ($28.05 in chips) 
Seat 5: +2kMBNpY4nF1qNCRd8SJLA ($25.65 in chips) 
Seat 6: v5jnQ1gfh9nLla3kMXG7Yg ($7.70 in chips) 
Seat 7: Bb42QRQMhg5/Y0vHP8/2Xw ($30.60 in chips) 
Seat 8: zDrucyjVn5aeekNEc3cJrA ($17.40 in chips) 
Seat 9: eK8qa6EPcH2zhtbmWSvc9g ($25.70 in chips) 
EIObtVVE4WXRXvLGJA6NHw: posts small blind $0.10
OXPkK84/qv92EMwXPiG5rQ: posts big blind $0.25
*** HOLE CARDS ***
CvL9Ch1HYCVbTsfpNucitg: folds 
4awUyiDYTgylQKXZ9faBVA: folds 
+2kMBNpY4nF1qNCRd8SJLA: folds 
v5jnQ1gfh9nLla3kMXG7Yg: folds 
Bb42QRQMhg5/Y0vHP8/2Xw: folds 
zDrucyjVn5aeekNEc3cJrA: folds 
zDrucyjVn5aeekNEc3cJrA is sitting out
eK8qa6EPcH2zhtbmWSvc9g: raises $0.50 to $0.75
EIObtVVE4WXRXvLGJA6NHw: folds 
OXPkK84/qv92EMwXPiG5rQ: folds 
Uncalled bet ($0.50) returned to eK8qa6EPcH2zhtbmWSvc9g
eK8qa6EPcH2zhtbmWSvc9g collected $0.60 from pot
eK8qa6EPcH2zhtbmWSvc9g: doesn't show hand 
*** SUMMARY ***
Total pot $0.60 | Rake $0 
Seat 1: EIObtVVE4WXRXvLGJA6NHw (small blind) folded before Flop
Seat 2: OXPkK84/qv92EMwXPiG5rQ (big blind) folded before Flop
Seat 3: CvL9Ch1HYCVbTsfpNucitg folded before Flop (didn't bet)
Seat 4: 4awUyiDYTgylQKXZ9faBVA folded before Flop (didn't bet)
Seat 5: +2kMBNpY4nF1qNCRd8SJLA folded before Flop (didn't bet)
Seat 6: v5jnQ1gfh9nLla3kMXG7Yg folded before Flop (didn't bet)
Seat 7: Bb42QRQMhg5/Y0vHP8/2Xw folded before Flop (didn't bet)
Seat 8: zDrucyjVn5aeekNEc3cJrA folded before Flop (didn't bet)
Seat 9: eK8qa6EPcH2zhtbmWSvc9g (button) collected ($0.60)




PokerStars Game #59941622050:  Hold'em No Limit ($0.10/$0.25) - 2009/07/01 1:41:00 ET
Table 'FBhJjLqab11/gKu8nyB/tw' 9-max Seat #3 is the button
Seat 1: +sbyWwIcFp9kP0bDtMegfQ ($18.10 in chips) 
Seat 2: 1pwQJV/Xr0GWPRefx/78VQ ($17.05 in chips) 
Seat 3: V6p0jQ/RhUsqpHLmXvEX4Q ($12.60 in chips) 
Seat 4: CvL9Ch1HYCVbTsfpNucitg ($5.60 in chips) 
Seat 5: Mh2r9hTeTEDnh19sRZtW3g ($5 in chips) 
Seat 6: cZ99hugmLBj9KhTlc8nCSw ($25 in chips) 
Seat 7: CT7Xj/V/O5rBlhtt+RZeFQ ($25 in chips) 
Seat 8: Th3FldXKQW6hWVVPahaoOQ ($27.40 in chips) 
CvL9Ch1HYCVbTsfpNucitg: posts small blind $0.10
Mh2r9hTeTEDnh19sRZtW3g: posts big blind $0.25
*** HOLE CARDS ***
cZ99hugmLBj9KhTlc8nCSw: folds 
CT7Xj/V/O5rBlhtt+RZeFQ: folds 
Th3FldXKQW6hWVVPahaoOQ: raises $0.50 to $0.75
+sbyWwIcFp9kP0bDtMegfQ: folds 
1pwQJV/Xr0GWPRefx/78VQ: calls $0.75
V6p0jQ/RhUsqpHLmXvEX4Q: folds 
CvL9Ch1HYCVbTsfpNucitg: folds 
Mh2r9hTeTEDnh19sRZtW3g: folds 
*** FLOP *** [4s 7d 4c]
Th3FldXKQW6hWVVPahaoOQ: bets $1
1pwQJV/Xr0GWPRefx/78VQ: calls $1
*** TURN *** [4s 7d 4c] [4h]
Th3FldXKQW6hWVVPahaoOQ: bets $2
1pwQJV/Xr0GWPRefx/78VQ: calls $2
*** RIVER *** [4s 7d 4c 4h] [Ah]
Th3FldXKQW6hWVVPahaoOQ: bets $4
1pwQJV/Xr0GWPRefx/78VQ: raises $4 to $8
Th3FldXKQW6hWVVPahaoOQ: folds 
Uncalled bet ($4) returned to 1pwQJV/Xr0GWPRefx/78VQ
1pwQJV/Xr0GWPRefx/78VQ collected $15.10 from pot
1pwQJV/Xr0GWPRefx/78VQ: doesn't show hand 
*** SUMMARY ***
Total pot $15.85 | Rake $0.75 
Board [4s 7d 4c 4h Ah]
Seat 1: +sbyWwIcFp9kP0bDtMegfQ folded before Flop (didn't bet)
Seat 2: 1pwQJV/Xr0GWPRefx/78VQ collected ($15.10)
Seat 3: V6p0jQ/RhUsqpHLmXvEX4Q (button) folded before Flop (didn't bet)
Seat 4: CvL9Ch1HYCVbTsfpNucitg (small blind) folded before Flop
Seat 5: Mh2r9hTeTEDnh19sRZtW3g (big blind) folded before Flop
Seat 6: cZ99hugmLBj9KhTlc8nCSw folded before Flop (didn't bet)
Seat 7: CT7Xj/V/O5rBlhtt+RZeFQ folded before Flop (didn't bet)
Seat 8: Th3FldXKQW6hWVVPahaoOQ folded on the River




PokerStars Game #59941621846:  Hold'em No Limit ($0.10/$0.25) - 2009/07/01 1:41:00 ET
Table '2AUmC2Rslg+QUbLfdgNdfg' 6-max Seat #5 is the button
Seat 1: YDXAegrCnzc0l6TSDNboXQ ($24.35 in chips) 
Seat 2: PLksyNlTVRVZwxJVC2/1eA ($23.85 in chips) 
Seat 3: JFIAqU8lCZ0vWwEl4bdGsg ($25.35 in chips) 
Seat 4: lquriepNQBhDV5P1SWHhnA ($26.60 in chips) 
Seat 5: AMc4cCwUJhokdGRYIaVPhQ ($22.25 in chips) 
Seat 6: xBWc54v+UTSJOiKpbAbJWg ($11.95 in chips) 
xBWc54v+UTSJOiKpbAbJWg: posts small blind $0.10
YDXAegrCnzc0l6TSDNboXQ: posts big blind $0.25
*** HOLE CARDS ***
PLksyNlTVRVZwxJVC2/1eA: folds 
JFIAqU8lCZ0vWwEl4bdGsg: raises $0.60 to $0.85
lquriepNQBhDV5P1SWHhnA: folds 
AMc4cCwUJhokdGRYIaVPhQ: folds 
xBWc54v+UTSJOiKpbAbJWg: folds 
YDXAegrCnzc0l6TSDNboXQ: folds 
Uncalled bet ($0.60) returned to JFIAqU8lCZ0vWwEl4bdGsg
JFIAqU8lCZ0vWwEl4bdGsg collected $0.60 from pot
JFIAqU8lCZ0vWwEl4bdGsg: doesn't show hand 
*** SUMMARY ***
Total pot $0.60 | Rake $0 
Seat 1: YDXAegrCnzc0l6TSDNboXQ (big blind) folded before Flop
Seat 2: PLksyNlTVRVZwxJVC2/1eA folded before Flop (didn't bet)
Seat 3: JFIAqU8lCZ0vWwEl4bdGsg collected ($0.60)
Seat 4: lquriepNQBhDV5P1SWHhnA folded before Flop (didn't bet)
Seat 5: AMc4cCwUJhokdGRYIaVPhQ (button) folded before Flop (didn't bet)
Seat 6: xBWc54v+UTSJOiKpbAbJWg (small blind) folded before Flop




PokerStars Game #59941621746:  Hold'em No Limit ($0.10/$0.25) - 2009/07/01 1:41:00 ET
Table 'T/iCKJXGphRN3xcdwfE/JQ' 6-max Seat #3 is the button
Seat 1: wAKC8C/zN0c8V5v13dm9mA ($25 in chips) 
Seat 2: EeUZtMU058v2ObUACOF4Og ($33.75 in chips) 
Seat 3: IWAjoCPXtc1XUaZdp+pCpA ($22 in chips) 
Seat 4: tSR4329m40dZsN7YOpI9Kw ($53.95 in chips) 
Seat 5: gaPMxLGp9SOj4Lq6t+/0Ig ($4.55 in chips) 
Seat 6: Ey4Kn6PlnYb2srYYBJHvzg ($15.85 in chips) 
tSR4329m40dZsN7YOpI9Kw: posts small blind $0.10
gaPMxLGp9SOj4Lq6t+/0Ig: posts big blind $0.25
*** HOLE CARDS ***
Ey4Kn6PlnYb2srYYBJHvzg: calls $0.25
wAKC8C/zN0c8V5v13dm9mA: folds 
EeUZtMU058v2ObUACOF4Og: folds 
IWAjoCPXtc1XUaZdp+pCpA: calls $0.25
tSR4329m40dZsN7YOpI9Kw: folds 
gaPMxLGp9SOj4Lq6t+/0Ig: checks 
*** FLOP *** [Ts 2d Qc]
gaPMxLGp9SOj4Lq6t+/0Ig: checks 
Ey4Kn6PlnYb2srYYBJHvzg: bets $0.50
IWAjoCPXtc1XUaZdp+pCpA: folds 
gaPMxLGp9SOj4Lq6t+/0Ig: folds 
Uncalled bet ($0.50) returned to Ey4Kn6PlnYb2srYYBJHvzg
Ey4Kn6PlnYb2srYYBJHvzg collected $0.85 from pot
*** SUMMARY ***
Total pot $0.85 | Rake $0 
Board [Ts 2d Qc]
Seat 1: wAKC8C/zN0c8V5v13dm9mA folded before Flop (didn't bet)
Seat 2: EeUZtMU058v2ObUACOF4Og folded before Flop (didn't bet)
Seat 3: IWAjoCPXtc1XUaZdp+pCpA (button) folded on the Flop
Seat 4: tSR4329m40dZsN7YOpI9Kw (small blind) folded before Flop
Seat 5: gaPMxLGp9SOj4Lq6t+/0Ig (big blind) folded on the Flop
Seat 6: Ey4Kn6PlnYb2srYYBJHvzg collected ($0.85)




PokerStars Game #59941622380:  Hold'em No Limit ($0.10/$0.25) - 2009/07/01 1:41:01 ET
Table 'JJzUs04lHpXg6nboT1/jeg' 6-max Seat #4 is the button
Seat 1: MqMK8OWPSY1V4stf1Hy5Jw ($38.95 in chips) 
Seat 2: jxfR29d+dK/7h7s3SvCk+g ($5.20 in chips) 
Seat 3: 4zXbHDe39qNX46dAo81b4w ($6.95 in chips) 
Seat 4: 7VfhiFY533nbUKvyEthASw ($29.85 in chips) 
Seat 5: QvTX2yGq3uKJiKPmns4TKQ ($22.75 in chips) 
Seat 6: wqphQtauX5Qn7WRJZS1flA ($29.30 in chips) 
QvTX2yGq3uKJiKPmns4TKQ: posts small blind $0.10
wqphQtauX5Qn7WRJZS1flA: posts big blind $0.25
*** HOLE CARDS ***
MqMK8OWPSY1V4stf1Hy5Jw: folds 
jxfR29d+dK/7h7s3SvCk+g has timed out
jxfR29d+dK/7h7s3SvCk+g: folds 
jxfR29d+dK/7h7s3SvCk+g is sitting out
4zXbHDe39qNX46dAo81b4w: folds 
7VfhiFY533nbUKvyEthASw: folds 
QvTX2yGq3uKJiKPmns4TKQ: raises $0.75 to $1
wqphQtauX5Qn7WRJZS1flA: calls $0.75
*** FLOP *** [7h 5h 4c]
jxfR29d+dK/7h7s3SvCk+g has returned
QvTX2yGq3uKJiKPmns4TKQ: bets $1
wqphQtauX5Qn7WRJZS1flA: raises $2 to $3
QvTX2yGq3uKJiKPmns4TKQ: folds 
Uncalled bet ($2) returned to wqphQtauX5Qn7WRJZS1flA
wqphQtauX5Qn7WRJZS1flA collected $3.85 from pot
wqphQtauX5Qn7WRJZS1flA: doesn't show hand 
*** SUMMARY ***
Total pot $4 | Rake $0.15 
Board [7h 5h 4c]
Seat 1: MqMK8OWPSY1V4stf1Hy5Jw folded before Flop (didn't bet)
Seat 2: jxfR29d+dK/7h7s3SvCk+g folded before Flop (didn't bet)
Seat 3: 4zXbHDe39qNX46dAo81b4w folded before Flop (didn't bet)
Seat 4: 7VfhiFY533nbUKvyEthASw (button) folded before Flop (didn't bet)
Seat 5: QvTX2yGq3uKJiKPmns4TKQ (small blind) folded on the Flop
Seat 6: wqphQtauX5Qn7WRJZS1flA (big blind) collected ($3.85)




PokerStars Game #59941622790:  Hold'em No Limit ($0.10/$0.25) - 2009/07/01 1:41:01 ET
Table 'mF3KHGMaTpaBZbtBoyfTeg' 6-max Seat #4 is the button
Seat 1: 0HAB2GdCAM7p7V00xueAVQ ($25.25 in chips) 
Seat 2: 6qsh9pnysDKJNhfFhFmKRQ ($9.40 in chips) 
Seat 3: 9kUKGKkblnIx3m8rlVol6Q ($14.65 in chips) 
Seat 4: FYepjhAvF8ZdVCmqHIy+eQ ($25 in chips) 
Seat 5: 8ClCHtFXGNplITm+63KB+Q ($43.50 in chips) 
Seat 6: kG34n23qFQA3nzdOJTQ1dA ($27.50 in chips) 
8ClCHtFXGNplITm+63KB+Q: posts small blind $0.10
kG34n23qFQA3nzdOJTQ1dA: posts big blind $0.25
*** HOLE CARDS ***
0HAB2GdCAM7p7V00xueAVQ: calls $0.25
6qsh9pnysDKJNhfFhFmKRQ: folds 
9kUKGKkblnIx3m8rlVol6Q: folds 
FYepjhAvF8ZdVCmqHIy+eQ: folds 
8ClCHtFXGNplITm+63KB+Q: folds 
kG34n23qFQA3nzdOJTQ1dA: checks 
*** FLOP *** [Ks 3h 5d]
kG34n23qFQA3nzdOJTQ1dA: checks 
0HAB2GdCAM7p7V00xueAVQ: bets $0.75
kG34n23qFQA3nzdOJTQ1dA: folds 
Uncalled bet ($0.75) returned to 0HAB2GdCAM7p7V00xueAVQ
0HAB2GdCAM7p7V00xueAVQ collected $0.60 from pot
0HAB2GdCAM7p7V00xueAVQ: doesn't show hand 
*** SUMMARY ***
Total pot $0.60 | Rake $0 
Board [Ks 3h 5d]
Seat 1: 0HAB2GdCAM7p7V00xueAVQ collected ($0.60)
Seat 2: 6qsh9pnysDKJNhfFhFmKRQ folded before Flop (didn't bet)
Seat 3: 9kUKGKkblnIx3m8rlVol6Q folded before Flop (didn't bet)
Seat 4: FYepjhAvF8ZdVCmqHIy+eQ (button) folded before Flop (didn't bet)
Seat 5: 8ClCHtFXGNplITm+63KB+Q (small blind) folded before Flop
Seat 6: kG34n23qFQA3nzdOJTQ1dA (big blind) folded on the Flop




PokerStars Game #59941622490:  Hold'em No Limit ($0.10/$0.25) - 2009/07/01 1:41:01 ET
Table 'vZfV/Uj0q8joA1du9sRJSg' 6-max Seat #2 is the button
Seat 1: Hsvkc0/G2VV78oVmWYXecw ($6.40 in chips) 
Seat 2: wMiE3yTbDJGOLOF9th7KPA ($13.10 in chips) 
Seat 3: cWc85bEzdRzpUMhRKm8pwQ ($25 in chips) 
Seat 4: v+QfkGiuj9bgtuNoVnDO8w ($40.50 in chips) 
Seat 5: kyRaCIljYA6l33lSKQfNsg ($24.95 in chips) 
Seat 6: 8ClCHtFXGNplITm+63KB+Q ($48.15 in chips) 
cWc85bEzdRzpUMhRKm8pwQ: posts small blind $0.10
v+QfkGiuj9bgtuNoVnDO8w: posts big blind $0.25
*** HOLE CARDS ***
kyRaCIljYA6l33lSKQfNsg: raises $0.50 to $0.75
8ClCHtFXGNplITm+63KB+Q: folds 
Hsvkc0/G2VV78oVmWYXecw: folds 
wMiE3yTbDJGOLOF9th7KPA: calls $0.75
cWc85bEzdRzpUMhRKm8pwQ: folds 
v+QfkGiuj9bgtuNoVnDO8w: folds 
*** FLOP *** [4d Jd 7h]
kyRaCIljYA6l33lSKQfNsg: checks 
wMiE3yTbDJGOLOF9th7KPA: checks 
*** TURN *** [4d Jd 7h] [Td]
kyRaCIljYA6l33lSKQfNsg: checks 
wMiE3yTbDJGOLOF9th7KPA: bets $0.50
kyRaCIljYA6l33lSKQfNsg: folds 
Uncalled bet ($0.50) returned to wMiE3yTbDJGOLOF9th7KPA
wMiE3yTbDJGOLOF9th7KPA collected $1.80 from pot
*** SUMMARY ***
Total pot $1.85 | Rake $0.05 
Board [4d Jd 7h Td]
Seat 1: Hsvkc0/G2VV78oVmWYXecw folded before Flop (didn't bet)
Seat 2: wMiE3yTbDJGOLOF9th7KPA (button) collected ($1.80)
Seat 3: cWc85bEzdRzpUMhRKm8pwQ (small blind) folded before Flop
Seat 4: v+QfkGiuj9bgtuNoVnDO8w (big blind) folded before Flop
Seat 5: kyRaCIljYA6l33lSKQfNsg folded on the Turn
Seat 6: 8ClCHtFXGNplITm+63KB+Q folded before Flop (didn't bet)




PokerStars Game #59941622826:  Hold'em No Limit ($0.10/$0.25) - 2009/07/01 1:41:01 ET
Table 'S6s+TmTlAjLHclBRvN5/fw' 9-max Seat #9 is the button
Seat 4: M/9j4wkHH9i1JM51vgi1VA ($25.10 in chips) 
Seat 5: z5GxcHlYz/GSz6W2uFiTtg ($39.70 in chips) 
Seat 6: aNpwfA31EREwO+ar4XzBCw ($28.40 in chips) 
Seat 7: vSkQm2EelzwRGDDQQk0Fqw ($4.80 in chips) 
Seat 8: OlPJsgR4xypSg/w1z7Gyvw ($22.65 in chips) 
Seat 9: H5Se03ZqSX7tbULXur2MAg ($22.75 in chips) 
M/9j4wkHH9i1JM51vgi1VA: posts small blind $0.10
z5GxcHlYz/GSz6W2uFiTtg: posts big blind $0.25
*** HOLE CARDS ***
aNpwfA31EREwO+ar4XzBCw: folds 
vSkQm2EelzwRGDDQQk0Fqw: folds 
OlPJsgR4xypSg/w1z7Gyvw: folds 
H5Se03ZqSX7tbULXur2MAg: folds 
H5Se03ZqSX7tbULXur2MAg leaves the table
M/9j4wkHH9i1JM51vgi1VA: folds 
Uncalled bet ($0.15) returned to z5GxcHlYz/GSz6W2uFiTtg
M/9j4wkHH9i1JM51vgi1VA is sitting out
z5GxcHlYz/GSz6W2uFiTtg collected $0.20 from pot
M/9j4wkHH9i1JM51vgi1VA leaves the table
*** SUMMARY ***
Total pot $0.20 | Rake $0 
Seat 4: M/9j4wkHH9i1JM51vgi1VA (small blind) folded before Flop
Seat 5: z5GxcHlYz/GSz6W2uFiTtg (big blind) collected ($0.20)
Seat 6: aNpwfA31EREwO+ar4XzBCw folded before Flop (didn't bet)
Seat 7: vSkQm2EelzwRGDDQQk0Fqw folded before Flop (didn't bet)
Seat 8: OlPJsgR4xypSg/w1z7Gyvw folded before Flop (didn't bet)
Seat 9: H5Se03ZqSX7tbULXur2MAg (button) folded before Flop (didn't bet)




PokerStars Game #59941622640:  Hold'em No Limit ($0.10/$0.25) - 2009/07/01 1:41:01 ET
Table 'UVjmXTtsmlX1HxwwZ59akg' 9-max Seat #8 is the button
Seat 1: zDrucyjVn5aeekNEc3cJrA ($47.95 in chips) 
Seat 2: q+Qdg0Hoir+SyL7haBrUnw ($8.40 in chips) 
Seat 4: X78b5v/uhqeXXoAijbw/yg ($25 in chips) 
Seat 5: Bb42QRQMhg5/Y0vHP8/2Xw ($39.60 in chips) 
Seat 6: st9jtdNbm1W5GfBwRaCVqQ ($24.30 in chips) 
Seat 7: pB8IyCfDFZaVpov3NHEVJg ($24.90 in chips) 
Seat 8: aqxuKnMZWHy08QjWq1+MrQ ($2.40 in chips) 
ljemhp25Zg+nlA9DLCIiUw will be allowed to play after the button
zDrucyjVn5aeekNEc3cJrA: posts small blind $0.10
q+Qdg0Hoir+SyL7haBrUnw: posts big blind $0.25
GmzfAfxcxu1kGbPC+9LkVg: sits out 
*** HOLE CARDS ***
X78b5v/uhqeXXoAijbw/yg: folds 
Bb42QRQMhg5/Y0vHP8/2Xw: folds 
st9jtdNbm1W5GfBwRaCVqQ: folds 
pB8IyCfDFZaVpov3NHEVJg: raises $0.75 to $1
aqxuKnMZWHy08QjWq1+MrQ: folds 
zDrucyjVn5aeekNEc3cJrA: folds 
q+Qdg0Hoir+SyL7haBrUnw: folds 
Uncalled bet ($0.75) returned to pB8IyCfDFZaVpov3NHEVJg
pB8IyCfDFZaVpov3NHEVJg collected $0.60 from pot
pB8IyCfDFZaVpov3NHEVJg: doesn't show hand 
*** SUMMARY ***
Total pot $0.60 | Rake $0 
Seat 1: zDrucyjVn5aeekNEc3cJrA (small blind) folded before Flop
Seat 2: q+Qdg0Hoir+SyL7haBrUnw (big blind) folded before Flop
Seat 4: X78b5v/uhqeXXoAijbw/yg folded before Flop (didn't bet)
Seat 5: Bb42QRQMhg5/Y0vHP8/2Xw folded before Flop (didn't bet)
Seat 6: st9jtdNbm1W5GfBwRaCVqQ folded before Flop (didn't bet)
Seat 7: pB8IyCfDFZaVpov3NHEVJg collected ($0.60)
Seat 8: aqxuKnMZWHy08QjWq1+MrQ (button) folded before Flop (didn't bet)




PokerStars Game #59941622274:  Hold'em No Limit ($0.10/$0.25) - 2009/07/01 1:41:01 ET
Table '+VTTYgQLH1awDHk+IAxqGg' 9-max Seat #5 is the button
Seat 1: arxNSjreDRGFg13EAM2F1w ($25.75 in chips) 
Seat 2: 2wcFsZsqEP5w1StUTVzJCg ($5.40 in chips) 
Seat 3: AiXn/9o1EwOPZUHujnh/bA ($18.65 in chips) 
Seat 4: gE5rN2TDY1aXcZn/TOPeZw ($10.90 in chips) 
Seat 5: sD+TKtt36XiiN6jqHiLwDA ($25.15 in chips) 
Seat 7: ljemhp25Zg+nlA9DLCIiUw ($23.65 in chips) 
Seat 8: 10vzP4r6ldwGLbYHKd9www ($16.25 in chips) 
Seat 9: S7Ki0P+0AIGPuIfGJjW0gg ($56.15 in chips) 
ljemhp25Zg+nlA9DLCIiUw: posts small blind $0.10
10vzP4r6ldwGLbYHKd9www: posts big blind $0.25
*** HOLE CARDS ***
S7Ki0P+0AIGPuIfGJjW0gg: folds 
arxNSjreDRGFg13EAM2F1w: folds 
2wcFsZsqEP5w1StUTVzJCg: folds 
AiXn/9o1EwOPZUHujnh/bA is disconnected 
AiXn/9o1EwOPZUHujnh/bA has timed out while disconnected
AiXn/9o1EwOPZUHujnh/bA: folds 
AiXn/9o1EwOPZUHujnh/bA is sitting out
AiXn/9o1EwOPZUHujnh/bA is connected 
gE5rN2TDY1aXcZn/TOPeZw: folds 
AiXn/9o1EwOPZUHujnh/bA has returned
sD+TKtt36XiiN6jqHiLwDA: folds 
ljemhp25Zg+nlA9DLCIiUw: raises $0.50 to $0.75
10vzP4r6ldwGLbYHKd9www: calls $0.50
*** FLOP *** [3c Kh 7h]
ljemhp25Zg+nlA9DLCIiUw: checks 
10vzP4r6ldwGLbYHKd9www: bets $0.75
ljemhp25Zg+nlA9DLCIiUw: folds 
Uncalled bet ($0.75) returned to 10vzP4r6ldwGLbYHKd9www
10vzP4r6ldwGLbYHKd9www collected $1.45 from pot
*** SUMMARY ***
Total pot $1.50 | Rake $0.05 
Board [3c Kh 7h]
Seat 1: arxNSjreDRGFg13EAM2F1w folded before Flop (didn't bet)
Seat 2: 2wcFsZsqEP5w1StUTVzJCg folded before Flop (didn't bet)
Seat 3: AiXn/9o1EwOPZUHujnh/bA folded before Flop (didn't bet)
Seat 4: gE5rN2TDY1aXcZn/TOPeZw folded before Flop (didn't bet)
Seat 5: sD+TKtt36XiiN6jqHiLwDA (button) folded before Flop (didn't bet)
Seat 7: ljemhp25Zg+nlA9DLCIiUw (small blind) folded on the Flop
Seat 8: 10vzP4r6ldwGLbYHKd9www (big blind) collected ($1.45)
Seat 9: S7Ki0P+0AIGPuIfGJjW0gg folded before Flop (didn't bet)




PokerStars Game #59941622660:  Hold'em No Limit ($0.10/$0.25) - 2009/07/01 1:41:01 ET
Table 'luMgmRPIo47e7iXDlheIwA' 6-max Seat #5 is the button
Seat 1: EQ3WxdGe/KZrM6Lx4T02sg ($13.20 in chips) 
Seat 3: W6Y6au0wf7gRAlqJYgOezw ($23.85 in chips) 
Seat 4: xrf8tAXKQHG99HixCot1Iw ($24 in chips) 
Seat 5: cWc85bEzdRzpUMhRKm8pwQ ($43.75 in chips) 
Seat 6: qGHGf/553gQnDoklMRe3tg ($25 in chips) 
qGHGf/553gQnDoklMRe3tg: posts small blind $0.10
EQ3WxdGe/KZrM6Lx4T02sg: posts big blind $0.25
NhUN/JpAprdJeamFBgJH1w: sits out 
*** HOLE CARDS ***
W6Y6au0wf7gRAlqJYgOezw: raises $0.50 to $0.75
xrf8tAXKQHG99HixCot1Iw: folds 
EQ3WxdGe/KZrM6Lx4T02sg said, "dam blfr patcher"
cWc85bEzdRzpUMhRKm8pwQ: folds 
qGHGf/553gQnDoklMRe3tg: folds 
EQ3WxdGe/KZrM6Lx4T02sg: calls $0.50
*** FLOP *** [9c Jc Js]
EQ3WxdGe/KZrM6Lx4T02sg: checks 
W6Y6au0wf7gRAlqJYgOezw: bets $0.75
EQ3WxdGe/KZrM6Lx4T02sg: calls $0.75
*** TURN *** [9c Jc Js] [Kc]
EQ3WxdGe/KZrM6Lx4T02sg: bets $0.25
W6Y6au0wf7gRAlqJYgOezw: calls $0.25
*** RIVER *** [9c Jc Js Kc] [2h]
EQ3WxdGe/KZrM6Lx4T02sg: bets $1.25
W6Y6au0wf7gRAlqJYgOezw: calls $1.25
*** SHOW DOWN ***
EQ3WxdGe/KZrM6Lx4T02sg: shows [Jh 4h] (three of a kind, Jacks)
W6Y6au0wf7gRAlqJYgOezw: mucks hand 
EQ3WxdGe/KZrM6Lx4T02sg collected $5.85 from pot
*** SUMMARY ***
Total pot $6.10 | Rake $0.25 
Board [9c Jc Js Kc 2h]
Seat 1: EQ3WxdGe/KZrM6Lx4T02sg (big blind) showed [Jh 4h] and won ($5.85) with three of a kind, Jacks
Seat 3: W6Y6au0wf7gRAlqJYgOezw mucked
Seat 4: xrf8tAXKQHG99HixCot1Iw folded before Flop (didn't bet)
Seat 5: cWc85bEzdRzpUMhRKm8pwQ (button) folded before Flop (didn't bet)
Seat 6: qGHGf/553gQnDoklMRe3tg (small blind) folded before Flop




PokerStars Game #59941622314:  Hold'em No Limit ($0.10/$0.25) - 2009/07/01 1:41:01 ET
Table 'o0CDOvKO/bn1WjeymDrXfA' 6-max Seat #5 is the button
Seat 1: if4dh6jhJXeN3/qd3qCp9g ($25 in chips) 
Seat 2: uAJL+E2git8iAiFyAvVOnw ($18.85 in chips) 
Seat 3: OtVWmpxX2/9L8bb1GSKTuA ($18 in chips) 
Seat 5: dOIoLBxmpLHSXBN9LZnf0Q ($28.10 in chips) 
Seat 6: SS/yfeArhULzIcOPe8MdPg ($25 in chips) 
SS/yfeArhULzIcOPe8MdPg: posts small blind $0.10
if4dh6jhJXeN3/qd3qCp9g: posts big blind $0.25
L3/N/gliETan8N5Gim5h4Q: sits out 
*** HOLE CARDS ***
uAJL+E2git8iAiFyAvVOnw: folds 
OtVWmpxX2/9L8bb1GSKTuA: folds 
dOIoLBxmpLHSXBN9LZnf0Q: raises $1.50 to $1.75
SS/yfeArhULzIcOPe8MdPg: folds 
if4dh6jhJXeN3/qd3qCp9g: folds 
Uncalled bet ($1.50) returned to dOIoLBxmpLHSXBN9LZnf0Q
dOIoLBxmpLHSXBN9LZnf0Q collected $0.60 from pot
dOIoLBxmpLHSXBN9LZnf0Q: doesn't show hand 
*** SUMMARY ***
Total pot $0.60 | Rake $0 
Seat 1: if4dh6jhJXeN3/qd3qCp9g (big blind) folded before Flop
Seat 2: uAJL+E2git8iAiFyAvVOnw folded before Flop (didn't bet)
Seat 3: OtVWmpxX2/9L8bb1GSKTuA folded before Flop (didn't bet)
Seat 5: dOIoLBxmpLHSXBN9LZnf0Q (button) collected ($0.60)
Seat 6: SS/yfeArhULzIcOPe8MdPg (small blind) folded before Flop




PokerStars Game #59941622316:  Hold'em No Limit ($0.10/$0.25) - 2009/07/01 1:41:01 ET
Table 'wRXcD9iXgBbdvKhWmfnBnw' 6-max Seat #6 is the button
Seat 2: vUr8qM1UsCElsCI9B/McdQ ($27.45 in chips) 
Seat 3: l4ToKwb3EVcEuva7hPqMCQ ($6.75 in chips) 
Seat 4: 7NY6Es0O5qlPDxirJ9iU4g ($4.75 in chips) 
Seat 5: EE16Ua5b1HSsYej5zeXOlA ($45.75 in chips) 
Seat 6: JFIAqU8lCZ0vWwEl4bdGsg ($25 in chips) 
8tR2s7yV/Fr0ePp1w5XnJw: is sitting out 
vUr8qM1UsCElsCI9B/McdQ: posts small blind $0.10
l4ToKwb3EVcEuva7hPqMCQ: posts big blind $0.25
*** HOLE CARDS ***
8tR2s7yV/Fr0ePp1w5XnJw leaves the table
7NY6Es0O5qlPDxirJ9iU4g: folds 
EE16Ua5b1HSsYej5zeXOlA: raises $0.50 to $0.75
JFIAqU8lCZ0vWwEl4bdGsg: folds 
vUr8qM1UsCElsCI9B/McdQ: folds 
l4ToKwb3EVcEuva7hPqMCQ: calls $0.50
*** FLOP *** [Ts 4h Js]
l4ToKwb3EVcEuva7hPqMCQ: checks 
EE16Ua5b1HSsYej5zeXOlA: bets $1
l4ToKwb3EVcEuva7hPqMCQ: raises $5 to $6 and is all-in
EE16Ua5b1HSsYej5zeXOlA: folds 
Uncalled bet ($5) returned to l4ToKwb3EVcEuva7hPqMCQ
l4ToKwb3EVcEuva7hPqMCQ collected $3.45 from pot
l4ToKwb3EVcEuva7hPqMCQ: shows [Td Jh] (two pair, Jacks and Tens)
*** SUMMARY ***
Total pot $3.60 | Rake $0.15 
Board [Ts 4h Js]
Seat 2: vUr8qM1UsCElsCI9B/McdQ (small blind) folded before Flop
Seat 3: l4ToKwb3EVcEuva7hPqMCQ (big blind) collected ($3.45)
Seat 4: 7NY6Es0O5qlPDxirJ9iU4g folded before Flop (didn't bet)
Seat 5: EE16Ua5b1HSsYej5zeXOlA folded on the Flop
Seat 6: JFIAqU8lCZ0vWwEl4bdGsg (button) folded before Flop (didn't bet)




PokerStars Game #59941623160:  Hold'em No Limit ($0.10/$0.25) - 2009/07/01 1:41:02 ET
Table 'hg+KpirwreMnBAFQr/SEUA' 9-max Seat #3 is the button
Seat 1: H5Se03ZqSX7tbULXur2MAg ($33.80 in chips) 
Seat 2: cpnBzHjFACn5zAY56UIvNA ($19.45 in chips) 
Seat 3: DdyXKuBx0HAOC7dWZmGxWg ($22.65 in chips) 
Seat 5: +2kMBNpY4nF1qNCRd8SJLA ($25 in chips) 
Seat 6: Bb42QRQMhg5/Y0vHP8/2Xw ($25 in chips) 
Seat 7: 5LSuZS4qvcUri/Byfkln7w ($9.75 in chips) 
Seat 8: HPEB+AtKw1+C/cxU0o1ciw ($23.75 in chips) 
Seat 9: xbecloQJYmBOSkzT9lZ+rg ($20.50 in chips) 
+2kMBNpY4nF1qNCRd8SJLA: posts small blind $0.10
Bb42QRQMhg5/Y0vHP8/2Xw: posts big blind $0.25
*** HOLE CARDS ***
DigiSlarks joins the table at seat #4 
5LSuZS4qvcUri/Byfkln7w: calls $0.25
HPEB+AtKw1+C/cxU0o1ciw: folds 
xbecloQJYmBOSkzT9lZ+rg: folds 
H5Se03ZqSX7tbULXur2MAg: folds 
cpnBzHjFACn5zAY56UIvNA: folds 
DdyXKuBx0HAOC7dWZmGxWg: raises $0.25 to $0.50
+2kMBNpY4nF1qNCRd8SJLA: folds 
Bb42QRQMhg5/Y0vHP8/2Xw: folds 
5LSuZS4qvcUri/Byfkln7w: calls $0.25
*** FLOP *** [Qc Jc Td]
5LSuZS4qvcUri/Byfkln7w: checks 
DdyXKuBx0HAOC7dWZmGxWg: bets $0.50
5LSuZS4qvcUri/Byfkln7w: calls $0.50
*** TURN *** [Qc Jc Td] [5c]
5LSuZS4qvcUri/Byfkln7w: checks 
DdyXKuBx0HAOC7dWZmGxWg: bets $1.25
5LSuZS4qvcUri/Byfkln7w: folds 
Uncalled bet ($1.25) returned to DdyXKuBx0HAOC7dWZmGxWg
DdyXKuBx0HAOC7dWZmGxWg collected $2.25 from pot
DdyXKuBx0HAOC7dWZmGxWg: doesn't show hand 
*** SUMMARY ***
Total pot $2.35 | Rake $0.10 
Board [Qc Jc Td 5c]
Seat 1: H5Se03ZqSX7tbULXur2MAg folded before Flop (didn't bet)
Seat 2: cpnBzHjFACn5zAY56UIvNA folded before Flop (didn't bet)
Seat 3: DdyXKuBx0HAOC7dWZmGxWg (button) collected ($2.25)
Seat 5: +2kMBNpY4nF1qNCRd8SJLA (small blind) folded before Flop
Seat 6: Bb42QRQMhg5/Y0vHP8/2Xw (big blind) folded before Flop
Seat 7: 5LSuZS4qvcUri/Byfkln7w folded on the Turn
Seat 8: HPEB+AtKw1+C/cxU0o1ciw folded before Flop (didn't bet)
Seat 9: xbecloQJYmBOSkzT9lZ+rg folded before Flop (didn't bet)




PokerStars Game #59941623044:  Hold'em No Limit ($0.10/$0.25) - 2009/07/01 1:41:02 ET
Table 'Y9EhDWuqWWQFM9SelXAj5g' 9-max Seat #6 is the button
Seat 1: zDrucyjVn5aeekNEc3cJrA ($28.40 in chips) 
Seat 3: zgi+EUykT/pZQpoUG6+oEg ($7.40 in chips) 
Seat 4: V6p0jQ/RhUsqpHLmXvEX4Q ($13.35 in chips) 
Seat 5: CvL9Ch1HYCVbTsfpNucitg ($5.45 in chips) 
Seat 6: egvg3mTBBVzMHnJPIQiKcA ($14 in chips) 
Seat 7: aNpwfA31EREwO+ar4XzBCw ($26.70 in chips) 
Seat 8: XDxyajtqmdag0QPvwcOG7Q ($14.10 in chips) 
Seat 9: bOrfviVhRBpaOfMqUc74Tw ($17.90 in chips) 
aNpwfA31EREwO+ar4XzBCw: posts small blind $0.10
XDxyajtqmdag0QPvwcOG7Q: posts big blind $0.25
*** HOLE CARDS ***
bOrfviVhRBpaOfMqUc74Tw: calls $0.25
zDrucyjVn5aeekNEc3cJrA: folds 
zDrucyjVn5aeekNEc3cJrA is sitting out
zgi+EUykT/pZQpoUG6+oEg: folds 
V6p0jQ/RhUsqpHLmXvEX4Q: folds 
CvL9Ch1HYCVbTsfpNucitg: folds 
egvg3mTBBVzMHnJPIQiKcA: folds 
AJKidd1969 joins the table at seat #2 
aNpwfA31EREwO+ar4XzBCw: folds 
XDxyajtqmdag0QPvwcOG7Q: checks 
*** FLOP *** [Td Js 2c]
XDxyajtqmdag0QPvwcOG7Q: checks 
bOrfviVhRBpaOfMqUc74Tw: bets $0.25
XDxyajtqmdag0QPvwcOG7Q: calls $0.25
*** TURN *** [Td Js 2c] [2d]
XDxyajtqmdag0QPvwcOG7Q: checks 
bOrfviVhRBpaOfMqUc74Tw: bets $0.50
XDxyajtqmdag0QPvwcOG7Q: calls $0.50
*** RIVER *** [Td Js 2c 2d] [5c]
XDxyajtqmdag0QPvwcOG7Q: checks 
bOrfviVhRBpaOfMqUc74Tw: checks 
*** SHOW DOWN ***
XDxyajtqmdag0QPvwcOG7Q: shows [Qs Tc] (two pair, Tens and Deuces)
bOrfviVhRBpaOfMqUc74Tw: shows [As Th] (two pair, Tens and Deuces - Ace kicker)
bOrfviVhRBpaOfMqUc74Tw collected $2 from pot
*** SUMMARY ***
Total pot $2.10 | Rake $0.10 
Board [Td Js 2c 2d 5c]
Seat 1: zDrucyjVn5aeekNEc3cJrA folded before Flop (didn't bet)
Seat 3: zgi+EUykT/pZQpoUG6+oEg folded before Flop (didn't bet)
Seat 4: V6p0jQ/RhUsqpHLmXvEX4Q folded before Flop (didn't bet)
Seat 5: CvL9Ch1HYCVbTsfpNucitg folded before Flop (didn't bet)
Seat 6: egvg3mTBBVzMHnJPIQiKcA (button) folded before Flop (didn't bet)
Seat 7: aNpwfA31EREwO+ar4XzBCw (small blind) folded before Flop
Seat 8: XDxyajtqmdag0QPvwcOG7Q (big blind) showed [Qs Tc] and lost with two pair, Tens and Deuces
Seat 9: bOrfviVhRBpaOfMqUc74Tw showed [As Th] and won ($2) with two pair, Tens and Deuces




PokerStars Game #59941623078:  Hold'em No Limit ($0.10/$0.25) - 2009/07/01 1:41:02 ET
Table 'AJGgX1ZYM8d68SWMvaLttg' 6-max Seat #4 is the button
Seat 2: zHHLkD2sRljslKKeQv/ZQw ($29 in chips) 
Seat 3: 8ClCHtFXGNplITm+63KB+Q ($36.70 in chips) 
Seat 4: Lz/GjRDgmgepqTR7qmS86w ($24.80 in chips) 
Seat 5: Hsvkc0/G2VV78oVmWYXecw ($5.05 in chips) 
Seat 6: UA5OsKS3VPaxa7uC8La/kA ($64.75 in chips) 
Hsvkc0/G2VV78oVmWYXecw: posts small blind $0.10
UA5OsKS3VPaxa7uC8La/kA: posts big blind $0.25
*** HOLE CARDS ***
zHHLkD2sRljslKKeQv/ZQw: calls $0.25
8ClCHtFXGNplITm+63KB+Q: folds 
Lz/GjRDgmgepqTR7qmS86w: raises $1 to $1.25
Hsvkc0/G2VV78oVmWYXecw: folds 
UA5OsKS3VPaxa7uC8La/kA: folds 
zHHLkD2sRljslKKeQv/ZQw: folds 
Uncalled bet ($1) returned to Lz/GjRDgmgepqTR7qmS86w
Lz/GjRDgmgepqTR7qmS86w collected $0.85 from pot
Lz/GjRDgmgepqTR7qmS86w: doesn't show hand 
*** SUMMARY ***
Total pot $0.85 | Rake $0 
Seat 2: zHHLkD2sRljslKKeQv/ZQw folded before Flop
Seat 3: 8ClCHtFXGNplITm+63KB+Q folded before Flop (didn't bet)
Seat 4: Lz/GjRDgmgepqTR7qmS86w (button) collected ($0.85)
Seat 5: Hsvkc0/G2VV78oVmWYXecw (small blind) folded before Flop
Seat 6: UA5OsKS3VPaxa7uC8La/kA (big blind) folded before Flop




PokerStars Game #59941623314:  Hold'em No Limit ($0.10/$0.25) - 2009/07/01 1:41:02 ET
Table '2VkNDXXsBj4bSZw/uK5atw' 6-max Seat #3 is the button
Seat 1: xrf8tAXKQHG99HixCot1Iw ($20.60 in chips) 
Seat 2: v6mkGzCBCCXcgWQNSYVtKg ($7 in chips) 
Seat 3: 8D0jr3B4e++Q/cTSnpHdzg ($36.40 in chips) 
Seat 5: 7f0OkhFEOf3T+rVOFHRLnw ($22.15 in chips) 
Seat 6: n6UPMnVR4v8LFP0rWP73Fg ($10.15 in chips) 
7f0OkhFEOf3T+rVOFHRLnw: posts small blind $0.10
n6UPMnVR4v8LFP0rWP73Fg: posts big blind $0.25
v6mkGzCBCCXcgWQNSYVtKg: posts big blind $0.25
*** HOLE CARDS ***
xrf8tAXKQHG99HixCot1Iw: folds 
v6mkGzCBCCXcgWQNSYVtKg: checks 
8D0jr3B4e++Q/cTSnpHdzg: folds 
7f0OkhFEOf3T+rVOFHRLnw: folds 
n6UPMnVR4v8LFP0rWP73Fg: checks 
*** FLOP *** [9d 9c Ac]
n6UPMnVR4v8LFP0rWP73Fg: checks 
v6mkGzCBCCXcgWQNSYVtKg: bets $0.25
n6UPMnVR4v8LFP0rWP73Fg: calls $0.25
*** TURN *** [9d 9c Ac] [Tc]
n6UPMnVR4v8LFP0rWP73Fg: checks 
v6mkGzCBCCXcgWQNSYVtKg: checks 
*** RIVER *** [9d 9c Ac Tc] [Qd]
n6UPMnVR4v8LFP0rWP73Fg: checks 
v6mkGzCBCCXcgWQNSYVtKg: checks 
*** SHOW DOWN ***
n6UPMnVR4v8LFP0rWP73Fg: shows [9s 8s] (three of a kind, Nines)
v6mkGzCBCCXcgWQNSYVtKg: mucks hand 
n6UPMnVR4v8LFP0rWP73Fg collected $1.05 from pot
*** SUMMARY ***
Total pot $1.10 | Rake $0.05 
Board [9d 9c Ac Tc Qd]
Seat 1: xrf8tAXKQHG99HixCot1Iw folded before Flop (didn't bet)
Seat 2: v6mkGzCBCCXcgWQNSYVtKg mucked
Seat 3: 8D0jr3B4e++Q/cTSnpHdzg (button) folded before Flop (didn't bet)
Seat 5: 7f0OkhFEOf3T+rVOFHRLnw (small blind) folded before Flop
Seat 6: n6UPMnVR4v8LFP0rWP73Fg (big blind) showed [9s 8s] and won ($1.05) with three of a kind, Nines




PokerStars Game #59941623344:  Hold'em No Limit ($0.10/$0.25) - 2009/07/01 1:41:02 ET
Table 'tANpk8z1C5o0Pq/hpYShHw' 9-max Seat #6 is the button
Seat 1: rQhYIYXSyH/IivYM1dlV5A ($17.05 in chips) 
Seat 2: og4yH4sZUZdC8jjgW8zPJQ ($8.60 in chips) 
Seat 6: kN0AWJG6biW8tHtuF+wTjA ($14.45 in chips) 
Seat 7: aNpwfA31EREwO+ar4XzBCw ($27.40 in chips) 
Seat 9: gE5rN2TDY1aXcZn/TOPeZw ($7.80 in chips) 
aNpwfA31EREwO+ar4XzBCw: posts small blind $0.10
j4q3p0lesp63b1gZDwLBZw joins the table at seat #4 
5s3p6yoJBNW438dsyKTP8g: is sitting out 
gE5rN2TDY1aXcZn/TOPeZw: posts big blind $0.25
*** HOLE CARDS ***
5s3p6yoJBNW438dsyKTP8g leaves the table
rQhYIYXSyH/IivYM1dlV5A: folds 
og4yH4sZUZdC8jjgW8zPJQ: calls $0.25
kN0AWJG6biW8tHtuF+wTjA: raises $0.25 to $0.50
aNpwfA31EREwO+ar4XzBCw: folds 
gE5rN2TDY1aXcZn/TOPeZw: folds 
og4yH4sZUZdC8jjgW8zPJQ: calls $0.25
*** FLOP *** [2s Ah 9h]
og4yH4sZUZdC8jjgW8zPJQ: checks 
kN0AWJG6biW8tHtuF+wTjA: bets $0.50
og4yH4sZUZdC8jjgW8zPJQ: calls $0.50
*** TURN *** [2s Ah 9h] [Jd]
og4yH4sZUZdC8jjgW8zPJQ: checks 
kN0AWJG6biW8tHtuF+wTjA: bets $0.75
og4yH4sZUZdC8jjgW8zPJQ: calls $0.75
*** RIVER *** [2s Ah 9h Jd] [Th]
og4yH4sZUZdC8jjgW8zPJQ: checks 
X6+pSIPfovPcE87t+LmUKQ joins the table at seat #5 
kN0AWJG6biW8tHtuF+wTjA: bets $0.75
og4yH4sZUZdC8jjgW8zPJQ: calls $0.75
*** SHOW DOWN ***
kN0AWJG6biW8tHtuF+wTjA: shows [Ac 7d] (a pair of Aces)
og4yH4sZUZdC8jjgW8zPJQ: shows [Ad 4d] (a pair of Aces)
og4yH4sZUZdC8jjgW8zPJQ collected $2.55 from pot
kN0AWJG6biW8tHtuF+wTjA collected $2.55 from pot
DigiSlarks joins the table at seat #8 
*** SUMMARY ***
Total pot $5.35 | Rake $0.25 
Board [2s Ah 9h Jd Th]
Seat 1: rQhYIYXSyH/IivYM1dlV5A folded before Flop (didn't bet)
Seat 2: og4yH4sZUZdC8jjgW8zPJQ showed [Ad 4d] and won ($2.55) with a pair of Aces
Seat 6: kN0AWJG6biW8tHtuF+wTjA (button) showed [Ac 7d] and won ($2.55) with a pair of Aces
Seat 7: aNpwfA31EREwO+ar4XzBCw (small blind) folded before Flop
Seat 9: gE5rN2TDY1aXcZn/TOPeZw (big blind) folded before Flop




PokerStars Game #59941622898:  Hold'em No Limit ($0.10/$0.25) - 2009/07/01 1:41:02 ET
Table 'BmUMTVcNATeov2rAGYU0Qg' 9-max Seat #7 is the button
Seat 1: QEbIGci+itdw+re8RM5fZA ($36.20 in chips) 
Seat 2: jJnMGXoBXye+afMd0k0rUw ($9.95 in chips) 
Seat 3: ir5Jy8ck6DrdqgJ/3chcWw ($7.15 in chips) 
Seat 4: aNpwfA31EREwO+ar4XzBCw ($37.85 in chips) 
Seat 5: QBNcj9fHxkh/+s/oVw+JmQ ($23.60 in chips) 
Seat 6: w1ukf8uPa4+WH561TtVRxA ($25 in chips) 
Seat 7: CmngQmkKTp8tkl6GMRTl6w ($8.40 in chips) 
Seat 8: f/H6PsHRl4W1JyNsEDvPtg ($33.65 in chips) 
Seat 9: /artgaAtyUtUtD8FZo6puA ($12.10 in chips) 
f/H6PsHRl4W1JyNsEDvPtg: posts small blind $0.10
/artgaAtyUtUtD8FZo6puA: posts big blind $0.25
*** HOLE CARDS ***
QEbIGci+itdw+re8RM5fZA: folds 
jJnMGXoBXye+afMd0k0rUw: folds 
ir5Jy8ck6DrdqgJ/3chcWw: calls $0.25
aNpwfA31EREwO+ar4XzBCw: folds 
QBNcj9fHxkh/+s/oVw+JmQ: folds 
w1ukf8uPa4+WH561TtVRxA: folds 
CmngQmkKTp8tkl6GMRTl6w: folds 
f/H6PsHRl4W1JyNsEDvPtg: folds 
/artgaAtyUtUtD8FZo6puA: checks 
*** FLOP *** [3d 9d 7h]
/artgaAtyUtUtD8FZo6puA: bets $0.25
ir5Jy8ck6DrdqgJ/3chcWw: calls $0.25
*** TURN *** [3d 9d 7h] [3s]
/artgaAtyUtUtD8FZo6puA: bets $0.25
ir5Jy8ck6DrdqgJ/3chcWw: raises $0.75 to $1
/artgaAtyUtUtD8FZo6puA: folds 
Uncalled bet ($0.75) returned to ir5Jy8ck6DrdqgJ/3chcWw
ir5Jy8ck6DrdqgJ/3chcWw collected $1.55 from pot
*** SUMMARY ***
Total pot $1.60 | Rake $0.05 
Board [3d 9d 7h 3s]
Seat 1: QEbIGci+itdw+re8RM5fZA folded before Flop (didn't bet)
Seat 2: jJnMGXoBXye+afMd0k0rUw folded before Flop (didn't bet)
Seat 3: ir5Jy8ck6DrdqgJ/3chcWw collected ($1.55)
Seat 4: aNpwfA31EREwO+ar4XzBCw folded before Flop (didn't bet)
Seat 5: QBNcj9fHxkh/+s/oVw+JmQ folded before Flop (didn't bet)
Seat 6: w1ukf8uPa4+WH561TtVRxA folded before Flop (didn't bet)
Seat 7: CmngQmkKTp8tkl6GMRTl6w (button) folded before Flop (didn't bet)
Seat 8: f/H6PsHRl4W1JyNsEDvPtg (small blind) folded before Flop
Seat 9: /artgaAtyUtUtD8FZo6puA (big blind) folded on the Turn




PokerStars Game #59941622892:  Hold'em No Limit ($0.10/$0.25) - 2009/07/01 1:41:02 ET
Table 'jItkp2PNTbH9Cf7gqsAF7g' 9-max Seat #9 is the button
Seat 1: wGigCmBR/9XWkPpvYos3aQ ($25 in chips) 
Seat 2: qwr38jl5txoR36M7G5qi4A ($8.45 in chips) 
Seat 5: NO6qGDOw12lhu3zh1xW3Bg ($19.80 in chips) 
Seat 6: cZ99hugmLBj9KhTlc8nCSw ($53 in chips) 
Seat 7: z5GxcHlYz/GSz6W2uFiTtg ($17.95 in chips) 
Seat 8: cq6LACCDFivk2+PeoiB2sw ($6.90 in chips) 
Seat 9: dtZ84flFEi4Q+SGrHMJRDQ ($25.40 in chips) 
wGigCmBR/9XWkPpvYos3aQ: posts small blind $0.10
qwr38jl5txoR36M7G5qi4A: posts big blind $0.25
hitrac is connected 
hitrac: sits out 
jdmak2009: sits out 
cq6LACCDFivk2+PeoiB2sw: posts big blind $0.25
*** HOLE CARDS ***
NO6qGDOw12lhu3zh1xW3Bg: calls $0.25
cZ99hugmLBj9KhTlc8nCSw: folds 
z5GxcHlYz/GSz6W2uFiTtg has timed out
z5GxcHlYz/GSz6W2uFiTtg: folds 
z5GxcHlYz/GSz6W2uFiTtg is sitting out
z5GxcHlYz/GSz6W2uFiTtg has returned
cq6LACCDFivk2+PeoiB2sw: checks 
dtZ84flFEi4Q+SGrHMJRDQ: folds 
wGigCmBR/9XWkPpvYos3aQ: calls $0.15
qwr38jl5txoR36M7G5qi4A: checks 
*** FLOP *** [7d 2s Tc]
wGigCmBR/9XWkPpvYos3aQ: bets $0.80
qwr38jl5txoR36M7G5qi4A: folds 
NO6qGDOw12lhu3zh1xW3Bg: folds 
cq6LACCDFivk2+PeoiB2sw: folds 
Uncalled bet ($0.80) returned to wGigCmBR/9XWkPpvYos3aQ
wGigCmBR/9XWkPpvYos3aQ collected $0.95 from pot
wGigCmBR/9XWkPpvYos3aQ: doesn't show hand 
*** SUMMARY ***
Total pot $1 | Rake $0.05 
Board [7d 2s Tc]
Seat 1: wGigCmBR/9XWkPpvYos3aQ (small blind) collected ($0.95)
Seat 2: qwr38jl5txoR36M7G5qi4A (big blind) folded on the Flop
Seat 5: NO6qGDOw12lhu3zh1xW3Bg folded on the Flop
Seat 6: cZ99hugmLBj9KhTlc8nCSw folded before Flop (didn't bet)
Seat 7: z5GxcHlYz/GSz6W2uFiTtg folded before Flop (didn't bet)
Seat 8: cq6LACCDFivk2+PeoiB2sw folded on the Flop
Seat 9: dtZ84flFEi4Q+SGrHMJRDQ (button) folded before Flop (didn't bet)




PokerStars Game #59941622904:  Hold'em No Limit ($0.10/$0.25) - 2009/07/01 1:41:02 ET
Table '5SUMWYuPsGiOD0FY0QbgOw' 6-max Seat #2 is the button
Seat 1: SFmT9ZsVopnukjvAzrxTRg ($25 in chips) 
Seat 2: xrf8tAXKQHG99HixCot1Iw ($36.55 in chips) 
Seat 3: MqMK8OWPSY1V4stf1Hy5Jw ($32 in chips) 
Seat 4: BV+K0Phf5VBHr7aZPKqbUQ ($25.35 in chips) 
Seat 5: v+QfkGiuj9bgtuNoVnDO8w ($40.75 in chips) 
Seat 6: jA7YMtfNUnAaebB7Lj74EA ($26.20 in chips) 
MqMK8OWPSY1V4stf1Hy5Jw: posts small blind $0.10
BV+K0Phf5VBHr7aZPKqbUQ: posts big blind $0.25
*** HOLE CARDS ***
v+QfkGiuj9bgtuNoVnDO8w: folds 
jA7YMtfNUnAaebB7Lj74EA: calls $0.25
SFmT9ZsVopnukjvAzrxTRg: raises $1 to $1.25
xrf8tAXKQHG99HixCot1Iw: folds 
MqMK8OWPSY1V4stf1Hy5Jw: calls $1.15
BV+K0Phf5VBHr7aZPKqbUQ: folds 
jA7YMtfNUnAaebB7Lj74EA: folds 
*** FLOP *** [3h Jd Js]
MqMK8OWPSY1V4stf1Hy5Jw: checks 
SFmT9ZsVopnukjvAzrxTRg: bets $1.75
MqMK8OWPSY1V4stf1Hy5Jw: calls $1.75
*** TURN *** [3h Jd Js] [7d]
MqMK8OWPSY1V4stf1Hy5Jw: checks 
SFmT9ZsVopnukjvAzrxTRg: bets $4
MqMK8OWPSY1V4stf1Hy5Jw: calls $4
*** RIVER *** [3h Jd Js 7d] [2c]
MqMK8OWPSY1V4stf1Hy5Jw: checks 
SFmT9ZsVopnukjvAzrxTRg: checks 
*** SHOW DOWN ***
MqMK8OWPSY1V4stf1Hy5Jw: shows [4h 4c] (two pair, Jacks and Fours)
SFmT9ZsVopnukjvAzrxTRg: mucks hand 
MqMK8OWPSY1V4stf1Hy5Jw collected $13.80 from pot
*** SUMMARY ***
Total pot $14.50 | Rake $0.70 
Board [3h Jd Js 7d 2c]
Seat 1: SFmT9ZsVopnukjvAzrxTRg mucked
Seat 2: xrf8tAXKQHG99HixCot1Iw (button) folded before Flop (didn't bet)
Seat 3: MqMK8OWPSY1V4stf1Hy5Jw (small blind) showed [4h 4c] and won ($13.80) with two pair, Jacks and Fours
Seat 4: BV+K0Phf5VBHr7aZPKqbUQ (big blind) folded before Flop
Seat 5: v+QfkGiuj9bgtuNoVnDO8w folded before Flop (didn't bet)
Seat 6: jA7YMtfNUnAaebB7Lj74EA folded before Flop




PokerStars Game #59941623206:  Hold'em No Limit ($0.10/$0.25) - 2009/07/01 1:41:02 ET
Table 'M7d9IrgQUUFFy/SZ3ksLYg' 6-max Seat #6 is the button
Seat 1: ypmjhffk/YHGc51wgVXUTw ($49.70 in chips) 
Seat 2: gqrr7lSWrQ1N8zKx8zZzvA ($11.05 in chips) 
Seat 3: 8JTm/CXBn3+kuQgcUOgPkw ($23.30 in chips) 
Seat 4: 8ClCHtFXGNplITm+63KB+Q ($24.90 in chips) 
Seat 5: kMa8BltUcBQVxnHfqdCfXg ($5 in chips) 
Seat 6: 7S16WhQHiAVLWwRuqPrpnw ($8.85 in chips) 
ypmjhffk/YHGc51wgVXUTw: posts small blind $0.10
gqrr7lSWrQ1N8zKx8zZzvA: posts big blind $0.25
kMa8BltUcBQVxnHfqdCfXg: posts small blind $0.10
*** HOLE CARDS ***
8JTm/CXBn3+kuQgcUOgPkw: folds 
8ClCHtFXGNplITm+63KB+Q: folds 
kMa8BltUcBQVxnHfqdCfXg: calls $0.25
7S16WhQHiAVLWwRuqPrpnw: calls $0.25
ypmjhffk/YHGc51wgVXUTw: folds 
gqrr7lSWrQ1N8zKx8zZzvA: checks 
*** FLOP *** [4d 6c Kh]
7S16WhQHiAVLWwRuqPrpnw said, "dumb ****"
gqrr7lSWrQ1N8zKx8zZzvA: checks 
kMa8BltUcBQVxnHfqdCfXg: bets $1.25
7S16WhQHiAVLWwRuqPrpnw: folds 
gqrr7lSWrQ1N8zKx8zZzvA: folds 
Uncalled bet ($1.25) returned to kMa8BltUcBQVxnHfqdCfXg
kMa8BltUcBQVxnHfqdCfXg collected $0.95 from pot
*** SUMMARY ***
Total pot $0.95 | Rake $0 
Board [4d 6c Kh]
Seat 1: ypmjhffk/YHGc51wgVXUTw (small blind) folded before Flop
Seat 2: gqrr7lSWrQ1N8zKx8zZzvA (big blind) folded on the Flop
Seat 3: 8JTm/CXBn3+kuQgcUOgPkw folded before Flop (didn't bet)
Seat 4: 8ClCHtFXGNplITm+63KB+Q folded before Flop (didn't bet)
Seat 5: kMa8BltUcBQVxnHfqdCfXg collected ($0.95)
Seat 6: 7S16WhQHiAVLWwRuqPrpnw (button) folded on the Flop




PokerStars Game #59941623064:  Hold'em No Limit ($0.10/$0.25) - 2009/07/01 1:41:02 ET
Table 'dZNBGqFYSwfOVZvDJ4VjIQ' 6-max Seat #6 is the button
Seat 1: v+QfkGiuj9bgtuNoVnDO8w ($32.95 in chips) 
Seat 2: 3zD3qLXT1bEffAoWGnc7wg ($25 in chips) 
Seat 3: kyRaCIljYA6l33lSKQfNsg ($29.40 in chips) 
Seat 4: mFv3iBCtrw9XfCDRB0d46Q ($4.65 in chips) 
Seat 5: +ZlnqPoP3Hg4BIUxDfKd/A ($36.50 in chips) 
Seat 6: ypmjhffk/YHGc51wgVXUTw ($30.75 in chips) 
v+QfkGiuj9bgtuNoVnDO8w: posts small blind $0.10
3zD3qLXT1bEffAoWGnc7wg: posts big blind $0.25
*** HOLE CARDS ***
kyRaCIljYA6l33lSKQfNsg: raises $0.50 to $0.75
mFv3iBCtrw9XfCDRB0d46Q: calls $0.75
+ZlnqPoP3Hg4BIUxDfKd/A: folds 
ypmjhffk/YHGc51wgVXUTw: folds 
v+QfkGiuj9bgtuNoVnDO8w: folds 
3zD3qLXT1bEffAoWGnc7wg: calls $0.50
*** FLOP *** [9h 8c 7s]
3zD3qLXT1bEffAoWGnc7wg: checks 
kyRaCIljYA6l33lSKQfNsg: checks 
mFv3iBCtrw9XfCDRB0d46Q: bets $1
3zD3qLXT1bEffAoWGnc7wg: folds 
kyRaCIljYA6l33lSKQfNsg: folds 
Uncalled bet ($1) returned to mFv3iBCtrw9XfCDRB0d46Q
mFv3iBCtrw9XfCDRB0d46Q collected $2.25 from pot
mFv3iBCtrw9XfCDRB0d46Q: doesn't show hand 
*** SUMMARY ***
Total pot $2.35 | Rake $0.10 
Board [9h 8c 7s]
Seat 1: v+QfkGiuj9bgtuNoVnDO8w (small blind) folded before Flop
Seat 2: 3zD3qLXT1bEffAoWGnc7wg (big blind) folded on the Flop
Seat 3: kyRaCIljYA6l33lSKQfNsg folded on the Flop
Seat 4: mFv3iBCtrw9XfCDRB0d46Q collected ($2.25)
Seat 5: +ZlnqPoP3Hg4BIUxDfKd/A folded before Flop (didn't bet)
Seat 6: ypmjhffk/YHGc51wgVXUTw (button) folded before Flop (didn't bet)




PokerStars Game #59941623048:  Hold'em No Limit ($0.10/$0.25) - 2009/07/01 1:41:02 ET
Table 'ER5H84HUgJx7HyDLnELLeA' 6-max Seat #4 is the button
Seat 1: LJI7A1YgDM7hgh7o56+ReQ ($27.50 in chips) 
Seat 2: buyjetgNT1McXtdaP4zynA ($20.25 in chips) 
Seat 3: memV5jkoAdGrnRy3Q9PM7w ($19.55 in chips) 
Seat 4: vqWjZmdQu/Hxw96/IJTWdQ ($25 in chips) 
Seat 5: mfrkWA3PTeYPkbO6hi98Aw ($25.65 in chips) 
Seat 6: 3zD3qLXT1bEffAoWGnc7wg ($51 in chips) 
mfrkWA3PTeYPkbO6hi98Aw: posts small blind $0.10
3zD3qLXT1bEffAoWGnc7wg: posts big blind $0.25
*** HOLE CARDS ***
LJI7A1YgDM7hgh7o56+ReQ: folds 
buyjetgNT1McXtdaP4zynA: folds 
memV5jkoAdGrnRy3Q9PM7w: folds 
vqWjZmdQu/Hxw96/IJTWdQ: folds 
mfrkWA3PTeYPkbO6hi98Aw: folds 
Uncalled bet ($0.15) returned to 3zD3qLXT1bEffAoWGnc7wg
3zD3qLXT1bEffAoWGnc7wg collected $0.20 from pot
3zD3qLXT1bEffAoWGnc7wg: doesn't show hand 
*** SUMMARY ***
Total pot $0.20 | Rake $0 
Seat 1: LJI7A1YgDM7hgh7o56+ReQ folded before Flop (didn't bet)
Seat 2: buyjetgNT1McXtdaP4zynA folded before Flop (didn't bet)
Seat 3: memV5jkoAdGrnRy3Q9PM7w folded before Flop (didn't bet)
Seat 4: vqWjZmdQu/Hxw96/IJTWdQ (button) folded before Flop (didn't bet)
Seat 5: mfrkWA3PTeYPkbO6hi98Aw (small blind) folded before Flop
Seat 6: 3zD3qLXT1bEffAoWGnc7wg (big blind) collected ($0.20)




PokerStars Game #59941623236:  Hold'em No Limit ($0.10/$0.25) - 2009/07/01 1:41:02 ET
Table 'KEoOIegxPF91KooL2AelUA' 6-max Seat #4 is the button
Seat 1: wsP46AGpqDjHZQmlRHKa9g ($40.30 in chips) 
Seat 2: 0Bg59Tnte1Tc7C4i9Jd9cQ ($5.20 in chips) 
Seat 3: zxeVQGaMKDsDzmSY+AInjA ($12.80 in chips) 
Seat 4: Wo60l2GQnSEc3bxPVyvIUw ($19.10 in chips) 
Seat 5: 08V++DOqzaNrRNsHIwi25w ($44.80 in chips) 
Seat 6: AMrBn4Vx9aAo/vv6WHLk6w ($3.65 in chips) 
08V++DOqzaNrRNsHIwi25w: posts small blind $0.10
AMrBn4Vx9aAo/vv6WHLk6w: posts big blind $0.25
*** HOLE CARDS ***
wsP46AGpqDjHZQmlRHKa9g: folds 
0Bg59Tnte1Tc7C4i9Jd9cQ: folds 
zxeVQGaMKDsDzmSY+AInjA: raises $0.25 to $0.50
Wo60l2GQnSEc3bxPVyvIUw: raises $0.75 to $1.25
08V++DOqzaNrRNsHIwi25w: folds 
AMrBn4Vx9aAo/vv6WHLk6w: folds 
zxeVQGaMKDsDzmSY+AInjA: folds 
Uncalled bet ($0.75) returned to Wo60l2GQnSEc3bxPVyvIUw
Wo60l2GQnSEc3bxPVyvIUw collected $1.35 from pot
*** SUMMARY ***
Total pot $1.35 | Rake $0 
Seat 1: wsP46AGpqDjHZQmlRHKa9g folded before Flop (didn't bet)
Seat 2: 0Bg59Tnte1Tc7C4i9Jd9cQ folded before Flop (didn't bet)
Seat 3: zxeVQGaMKDsDzmSY+AInjA folded before Flop
Seat 4: Wo60l2GQnSEc3bxPVyvIUw (button) collected ($1.35)
Seat 5: 08V++DOqzaNrRNsHIwi25w (small blind) folded before Flop
Seat 6: AMrBn4Vx9aAo/vv6WHLk6w (big blind) folded before Flop




PokerStars Game #59941623568:  Hold'em No Limit ($0.10/$0.25) - 2009/07/01 1:41:03 ET
Table 'yAHDCs33TIgw3ra63xuU2Q' 9-max Seat #4 is the button
Seat 1: ydoFOVgzvZv9ZhuWu9rXAw ($4.90 in chips) 
Seat 3: g6UPjSyxNLffCi+EqqIlEg ($18.35 in chips) 
Seat 4: j5spkbnOCRiLGiH6iqBaqw ($9.50 in chips) 
Seat 5: 4awUyiDYTgylQKXZ9faBVA ($37.70 in chips) 
Seat 6: DnDcAdn9P0zGovMERigpFA ($26.65 in chips) 
Seat 7: qxWFg3MZuVyidB0SJh5ywg ($27.40 in chips) 
Seat 8: tYsOBqdU1+x+yFI7zHO7hQ ($25.70 in chips) 
Seat 9: MtVtHDqIJTyUcXkRBBDIVA ($25.05 in chips) 
4awUyiDYTgylQKXZ9faBVA: posts small blind $0.10
DnDcAdn9P0zGovMERigpFA: posts big blind $0.25
*** HOLE CARDS ***
qxWFg3MZuVyidB0SJh5ywg: folds 
tYsOBqdU1+x+yFI7zHO7hQ: raises $1 to $1.25
MtVtHDqIJTyUcXkRBBDIVA: folds 
ydoFOVgzvZv9ZhuWu9rXAw: folds 
g6UPjSyxNLffCi+EqqIlEg: calls $1.25
j5spkbnOCRiLGiH6iqBaqw: calls $1.25
4awUyiDYTgylQKXZ9faBVA: folds 
DnDcAdn9P0zGovMERigpFA: folds 
*** FLOP *** [5s 2d 6d]
tYsOBqdU1+x+yFI7zHO7hQ: checks 
g6UPjSyxNLffCi+EqqIlEg: bets $1.75
j5spkbnOCRiLGiH6iqBaqw: folds 
tYsOBqdU1+x+yFI7zHO7hQ: folds 
Uncalled bet ($1.75) returned to g6UPjSyxNLffCi+EqqIlEg
g6UPjSyxNLffCi+EqqIlEg collected $3.90 from pot
g6UPjSyxNLffCi+EqqIlEg: doesn't show hand 
*** SUMMARY ***
Total pot $4.10 | Rake $0.20 
Board [5s 2d 6d]
Seat 1: ydoFOVgzvZv9ZhuWu9rXAw folded before Flop (didn't bet)
Seat 3: g6UPjSyxNLffCi+EqqIlEg collected ($3.90)
Seat 4: j5spkbnOCRiLGiH6iqBaqw (button) folded on the Flop
Seat 5: 4awUyiDYTgylQKXZ9faBVA (small blind) folded before Flop
Seat 6: DnDcAdn9P0zGovMERigpFA (big blind) folded before Flop
Seat 7: qxWFg3MZuVyidB0SJh5ywg folded before Flop (didn't bet)
Seat 8: tYsOBqdU1+x+yFI7zHO7hQ folded on the Flop
Seat 9: MtVtHDqIJTyUcXkRBBDIVA folded before Flop (didn't bet)




PokerStars Game #59941623912:  Hold'em No Limit ($0.10/$0.25) - 2009/07/01 1:41:03 ET
Table 'v+LTGPWbrLum+Ggd4ef6lg' 9-max Seat #4 is the button
Seat 1: zUXhymECc2C9W9ZNw6qppA ($9.65 in chips) 
Seat 2: r/xYbgD9yVdKFWRgSQD/+Q ($20.70 in chips) 
Seat 3: 7ovWM9c1nQLTFritEGRG/A ($2.90 in chips) 
Seat 4: bXpVeaSTPBFSPJmeXxO7nw ($9.05 in chips) 
Seat 5: +8OkYWUhGfkDbAtQl/ovYQ ($30.15 in chips) 
Seat 6: T+MjFnaPZsOyKbE9LYG2Qg ($14.25 in chips) 
Seat 7: kUxTO3D2eQcx4oJIpJAK4Q ($8.95 in chips) 
Seat 8: +sbyWwIcFp9kP0bDtMegfQ ($32.60 in chips) 
+8OkYWUhGfkDbAtQl/ovYQ: posts small blind $0.10
T+MjFnaPZsOyKbE9LYG2Qg: posts big blind $0.25
cZ99hugmLBj9KhTlc8nCSw: sits out 
*** HOLE CARDS ***
T+MjFnaPZsOyKbE9LYG2Qg said, "lol lame comeback to loosing your money"
kUxTO3D2eQcx4oJIpJAK4Q: calls $0.25
+sbyWwIcFp9kP0bDtMegfQ: folds 
zUXhymECc2C9W9ZNw6qppA: folds 
r/xYbgD9yVdKFWRgSQD/+Q: folds 
7ovWM9c1nQLTFritEGRG/A: folds 
bXpVeaSTPBFSPJmeXxO7nw: folds 
+8OkYWUhGfkDbAtQl/ovYQ: calls $0.15
T+MjFnaPZsOyKbE9LYG2Qg: checks 
*** FLOP *** [Jd 8c 3d]
+8OkYWUhGfkDbAtQl/ovYQ: checks 
T+MjFnaPZsOyKbE9LYG2Qg: checks 
kUxTO3D2eQcx4oJIpJAK4Q: checks 
*** TURN *** [Jd 8c 3d] [6s]
+8OkYWUhGfkDbAtQl/ovYQ: checks 
T+MjFnaPZsOyKbE9LYG2Qg: checks 
kUxTO3D2eQcx4oJIpJAK4Q: bets $0.50
+8OkYWUhGfkDbAtQl/ovYQ: raises $0.50 to $1
T+MjFnaPZsOyKbE9LYG2Qg: folds 
kUxTO3D2eQcx4oJIpJAK4Q: calls $0.50
*** RIVER *** [Jd 8c 3d 6s] [9s]
+8OkYWUhGfkDbAtQl/ovYQ: bets $2.25
kUxTO3D2eQcx4oJIpJAK4Q: folds 
Uncalled bet ($2.25) returned to +8OkYWUhGfkDbAtQl/ovYQ
+8OkYWUhGfkDbAtQl/ovYQ collected $2.65 from pot
+8OkYWUhGfkDbAtQl/ovYQ: doesn't show hand 
*** SUMMARY ***
Total pot $2.75 | Rake $0.10 
Board [Jd 8c 3d 6s 9s]
Seat 1: zUXhymECc2C9W9ZNw6qppA folded before Flop (didn't bet)
Seat 2: r/xYbgD9yVdKFWRgSQD/+Q folded before Flop (didn't bet)
Seat 3: 7ovWM9c1nQLTFritEGRG/A folded before Flop (didn't bet)
Seat 4: bXpVeaSTPBFSPJmeXxO7nw (button) folded before Flop (didn't bet)
Seat 5: +8OkYWUhGfkDbAtQl/ovYQ (small blind) collected ($2.65)
Seat 6: T+MjFnaPZsOyKbE9LYG2Qg (big blind) folded on the Turn
Seat 7: kUxTO3D2eQcx4oJIpJAK4Q folded on the River
Seat 8: +sbyWwIcFp9kP0bDtMegfQ folded before Flop (didn't bet)




PokerStars Game #59941624328:  Hold'em No Limit ($0.10/$0.25) - 2009/07/01 1:41:04 ET
Table 'nXVbUw6/HYwA6x21+IZ3XQ' 9-max Seat #2 is the button
Seat 2: 9lvO/qyU+xrU95Teu1fv0g ($4.65 in chips) 
Seat 3: 7je+LC5Mfs6nL8YBVh4frQ ($5.70 in chips) 
Seat 4: H5Se03ZqSX7tbULXur2MAg ($24.70 in chips) 
Seat 5: M/9j4wkHH9i1JM51vgi1VA ($28.70 in chips) 
Seat 6: ljemhp25Zg+nlA9DLCIiUw ($26.75 in chips) 
Seat 7: ShCS62CJp4MKfKLKvGKQbA ($12.50 in chips) 
Seat 8: dfNim92Z6XK1/h5SFW5vDg ($27.15 in chips) 
Seat 9: OTCjTlu92MEBtX/i9Gm7yA ($12.80 in chips) 
7je+LC5Mfs6nL8YBVh4frQ: posts small blind $0.10
H5Se03ZqSX7tbULXur2MAg: posts big blind $0.25
*** HOLE CARDS ***
M/9j4wkHH9i1JM51vgi1VA: folds 
ljemhp25Zg+nlA9DLCIiUw: folds 
ShCS62CJp4MKfKLKvGKQbA: folds 
dfNim92Z6XK1/h5SFW5vDg: folds 
OTCjTlu92MEBtX/i9Gm7yA: folds 
9lvO/qyU+xrU95Teu1fv0g: folds 
7je+LC5Mfs6nL8YBVh4frQ: raises $0.50 to $0.75
H5Se03ZqSX7tbULXur2MAg: calls $0.50
*** FLOP *** [Kd 6s Qh]
7je+LC5Mfs6nL8YBVh4frQ: bets $1.25
M/9j4wkHH9i1JM51vgi1VA is sitting out
H5Se03ZqSX7tbULXur2MAg: folds 
Uncalled bet ($1.25) returned to 7je+LC5Mfs6nL8YBVh4frQ
7je+LC5Mfs6nL8YBVh4frQ collected $1.45 from pot
7je+LC5Mfs6nL8YBVh4frQ: doesn't show hand 
*** SUMMARY ***
Total pot $1.50 | Rake $0.05 
Board [Kd 6s Qh]
Seat 2: 9lvO/qyU+xrU95Teu1fv0g (button) folded before Flop (didn't bet)
Seat 3: 7je+LC5Mfs6nL8YBVh4frQ (small blind) collected ($1.45)
Seat 4: H5Se03ZqSX7tbULXur2MAg (big blind) folded on the Flop
Seat 5: M/9j4wkHH9i1JM51vgi1VA folded before Flop (didn't bet)
Seat 6: ljemhp25Zg+nlA9DLCIiUw folded before Flop (didn't bet)
Seat 7: ShCS62CJp4MKfKLKvGKQbA folded before Flop (didn't bet)
Seat 8: dfNim92Z6XK1/h5SFW5vDg folded before Flop (didn't bet)
Seat 9: OTCjTlu92MEBtX/i9Gm7yA folded before Flop (didn't bet)




PokerStars Game #59941624500:  Hold'em No Limit ($0.10/$0.25) - 2009/07/01 1:41:04 ET
Table '4hfTdIVT/qPsJNfWXLsVIw' 9-max Seat #8 is the button
Seat 1: GbHFBbLqLGz0Pwn6CJeAuw ($30.70 in chips) 
Seat 2: Pt637jKksB5MzP0UNJAAkw ($37.35 in chips) 
Seat 3: xnVwSkROfRtOw4eSoDANtw ($8.10 in chips) 
Seat 4: 3PmVnC/15cl4oyI1TKIt4g ($6.10 in chips) 
Seat 5: dtZ84flFEi4Q+SGrHMJRDQ ($25.45 in chips) 
Seat 6: VWUWpMLMj/Q1jRVpF7Aohw ($13.15 in chips) 
Seat 8: 7cv+9Zc9HIQHNvYsMfV3uA ($28.90 in chips) 
Seat 9: 9njEKzpOKC62MllUFUBWrA ($10.15 in chips) 
9njEKzpOKC62MllUFUBWrA: posts small blind $0.10
GbHFBbLqLGz0Pwn6CJeAuw: posts big blind $0.25
*** HOLE CARDS ***
Pt637jKksB5MzP0UNJAAkw: folds 
xnVwSkROfRtOw4eSoDANtw: folds 
3PmVnC/15cl4oyI1TKIt4g: folds 
dtZ84flFEi4Q+SGrHMJRDQ: folds 
VWUWpMLMj/Q1jRVpF7Aohw: folds 
7cv+9Zc9HIQHNvYsMfV3uA: raises $0.75 to $1
9njEKzpOKC62MllUFUBWrA: folds 
GbHFBbLqLGz0Pwn6CJeAuw: folds 
Uncalled bet ($0.75) returned to 7cv+9Zc9HIQHNvYsMfV3uA
7cv+9Zc9HIQHNvYsMfV3uA collected $0.60 from pot
7cv+9Zc9HIQHNvYsMfV3uA: doesn't show hand 
*** SUMMARY ***
Total pot $0.60 | Rake $0 
Seat 1: GbHFBbLqLGz0Pwn6CJeAuw (big blind) folded before Flop
Seat 2: Pt637jKksB5MzP0UNJAAkw folded before Flop (didn't bet)
Seat 3: xnVwSkROfRtOw4eSoDANtw folded before Flop (didn't bet)
Seat 4: 3PmVnC/15cl4oyI1TKIt4g folded before Flop (didn't bet)
Seat 5: dtZ84flFEi4Q+SGrHMJRDQ folded before Flop (didn't bet)
Seat 6: VWUWpMLMj/Q1jRVpF7Aohw folded before Flop (didn't bet)
Seat 8: 7cv+9Zc9HIQHNvYsMfV3uA (button) collected ($0.60)
Seat 9: 9njEKzpOKC62MllUFUBWrA (small blind) folded before Flop




PokerStars Game #59941624144:  Hold'em No Limit ($0.10/$0.25) - 2009/07/01 1:41:04 ET
Table 'L5GvbdQO5aCZJSE6pyQ8OA' 6-max Seat #2 is the button
Seat 1: eFj4lr1nuXLyCWNTShr1bg ($11.10 in chips) 
Seat 2: DihMHaz4WNETH1bPDe13kA ($29.05 in chips) 
Seat 3: JFIAqU8lCZ0vWwEl4bdGsg ($27.70 in chips) 
Seat 5: LyDHtw3/yniNHW+DvLXbog ($26.30 in chips) 
Seat 6: v+QfkGiuj9bgtuNoVnDO8w ($39.75 in chips) 
JFIAqU8lCZ0vWwEl4bdGsg: posts small blind $0.10
LyDHtw3/yniNHW+DvLXbog: posts big blind $0.25
*** HOLE CARDS ***
v+QfkGiuj9bgtuNoVnDO8w: folds 
eFj4lr1nuXLyCWNTShr1bg: folds 
DihMHaz4WNETH1bPDe13kA: folds 
JFIAqU8lCZ0vWwEl4bdGsg: raises $0.60 to $0.85
LyDHtw3/yniNHW+DvLXbog: folds 
Uncalled bet ($0.60) returned to JFIAqU8lCZ0vWwEl4bdGsg
JFIAqU8lCZ0vWwEl4bdGsg collected $0.50 from pot
JFIAqU8lCZ0vWwEl4bdGsg: doesn't show hand 
*** SUMMARY ***
Total pot $0.50 | Rake $0 
Seat 1: eFj4lr1nuXLyCWNTShr1bg folded before Flop (didn't bet)
Seat 2: DihMHaz4WNETH1bPDe13kA (button) folded before Flop (didn't bet)
Seat 3: JFIAqU8lCZ0vWwEl4bdGsg (small blind) collected ($0.50)
Seat 5: LyDHtw3/yniNHW+DvLXbog (big blind) folded before Flop
Seat 6: v+QfkGiuj9bgtuNoVnDO8w folded before Flop (didn't bet)




PokerStars Game #59941624486:  Hold'em No Limit ($0.10/$0.25) - 2009/07/01 1:41:04 ET
Table '8PD/MTROSMd6Y8mZeykbpg' 6-max Seat #3 is the button
Seat 1: fxNpaToxECtD2Goelmg9vA ($24.75 in chips) 
Seat 2: +C3eP/ysyROWbEXJFPswVA ($25.10 in chips) 
Seat 3: vqWjZmdQu/Hxw96/IJTWdQ ($25.60 in chips) 
Seat 4: DFi/Lzkjsfv8QswS80JX9Q ($53.45 in chips) 
Seat 5: z3tQwy28dp5FykDJC/wzQw ($25.95 in chips) 
DFi/Lzkjsfv8QswS80JX9Q: posts small blind $0.10
z3tQwy28dp5FykDJC/wzQw: posts big blind $0.25
*** HOLE CARDS ***
fxNpaToxECtD2Goelmg9vA: raises $0.50 to $0.75
+C3eP/ysyROWbEXJFPswVA: folds 
vqWjZmdQu/Hxw96/IJTWdQ: folds 
DFi/Lzkjsfv8QswS80JX9Q: folds 
z3tQwy28dp5FykDJC/wzQw: folds 
Uncalled bet ($0.50) returned to fxNpaToxECtD2Goelmg9vA
fxNpaToxECtD2Goelmg9vA collected $0.60 from pot
fxNpaToxECtD2Goelmg9vA: doesn't show hand 
*** SUMMARY ***
Total pot $0.60 | Rake $0 
Seat 1: fxNpaToxECtD2Goelmg9vA collected ($0.60)
Seat 2: +C3eP/ysyROWbEXJFPswVA folded before Flop (didn't bet)
Seat 3: vqWjZmdQu/Hxw96/IJTWdQ (button) folded before Flop (didn't bet)
Seat 4: DFi/Lzkjsfv8QswS80JX9Q (small blind) folded before Flop
Seat 5: z3tQwy28dp5FykDJC/wzQw (big blind) folded before Flop




PokerStars Game #59941624108:  Hold'em No Limit ($0.10/$0.25) - 2009/07/01 1:41:04 ET
Table 'NtEQAxCeIK2io1CGtW658g' 6-max Seat #1 is the button
Seat 1: X437kMQ7AujoaDgjguhU9w ($11.80 in chips) 
Seat 3: m2yWOKfAxqHoy5DDN87Ttw ($37.40 in chips) 
Seat 4: 8296 ($11.90 in chips) 
Seat 5: Hsvkc0/G2VV78oVmWYXecw ($5 in chips) 
Seat 6: /gJNBeCkWL4o85/jvlZ4BA ($65.10 in chips) 
m2yWOKfAxqHoy5DDN87Ttw: posts small blind $0.10
8296: posts big blind $0.25
*** HOLE CARDS ***
Hsvkc0/G2VV78oVmWYXecw: folds 
/gJNBeCkWL4o85/jvlZ4BA: folds 
X437kMQ7AujoaDgjguhU9w: folds 
m2yWOKfAxqHoy5DDN87Ttw: raises $0.75 to $1
8296: folds 
Uncalled bet ($0.75) returned to m2yWOKfAxqHoy5DDN87Ttw
m2yWOKfAxqHoy5DDN87Ttw collected $0.50 from pot
m2yWOKfAxqHoy5DDN87Ttw: doesn't show hand 
*** SUMMARY ***
Total pot $0.50 | Rake $0 
Seat 1: X437kMQ7AujoaDgjguhU9w (button) folded before Flop (didn't bet)
Seat 3: m2yWOKfAxqHoy5DDN87Ttw (small blind) collected ($0.50)
Seat 4: 8296 (big blind) folded before Flop
Seat 5: Hsvkc0/G2VV78oVmWYXecw folded before Flop (didn't bet)
Seat 6: /gJNBeCkWL4o85/jvlZ4BA folded before Flop (didn't bet)




PokerStars Game #59941624170:  Hold'em No Limit ($0.10/$0.25) - 2009/07/01 1:41:04 ET
Table 'IdXp6nyeW4FYaEK4qKCnwQ' 9-max Seat #6 is the button
Seat 1: tLcDklc2rBORNfixyRfVfw ($25 in chips) 
Seat 2: HPEB+AtKw1+C/cxU0o1ciw ($32.50 in chips) 
Seat 3: eK8qa6EPcH2zhtbmWSvc9g ($33.05 in chips) 
Seat 4: j4q3p0lesp63b1gZDwLBZw ($5.35 in chips) 
Seat 5: U41wNf6XauAiBOQaKu2ZIA ($25.90 in chips) 
Seat 6: arxNSjreDRGFg13EAM2F1w ($25.85 in chips) 
Seat 7: w1ukf8uPa4+WH561TtVRxA ($37.10 in chips) 
Seat 8: dtZ84flFEi4Q+SGrHMJRDQ ($31.10 in chips) 
Seat 9: s2xLPOl/vhl/26apJ3vsOQ ($28.65 in chips) 
w1ukf8uPa4+WH561TtVRxA: posts small blind $0.10
dtZ84flFEi4Q+SGrHMJRDQ: posts big blind $0.25
*** HOLE CARDS ***
s2xLPOl/vhl/26apJ3vsOQ: folds 
tLcDklc2rBORNfixyRfVfw: folds 
HPEB+AtKw1+C/cxU0o1ciw: folds 
eK8qa6EPcH2zhtbmWSvc9g: folds 
j4q3p0lesp63b1gZDwLBZw: folds 
U41wNf6XauAiBOQaKu2ZIA: folds 
arxNSjreDRGFg13EAM2F1w: folds 
w1ukf8uPa4+WH561TtVRxA: folds 
Uncalled bet ($0.15) returned to dtZ84flFEi4Q+SGrHMJRDQ
dtZ84flFEi4Q+SGrHMJRDQ collected $0.20 from pot
dtZ84flFEi4Q+SGrHMJRDQ: doesn't show hand 
*** SUMMARY ***
Total pot $0.20 | Rake $0 
Seat 1: tLcDklc2rBORNfixyRfVfw folded before Flop (didn't bet)
Seat 2: HPEB+AtKw1+C/cxU0o1ciw folded before Flop (didn't bet)
Seat 3: eK8qa6EPcH2zhtbmWSvc9g folded before Flop (didn't bet)
Seat 4: j4q3p0lesp63b1gZDwLBZw folded before Flop (didn't bet)
Seat 5: U41wNf6XauAiBOQaKu2ZIA folded before Flop (didn't bet)
Seat 6: arxNSjreDRGFg13EAM2F1w (button) folded before Flop (didn't bet)
Seat 7: w1ukf8uPa4+WH561TtVRxA (small blind) folded before Flop
Seat 8: dtZ84flFEi4Q+SGrHMJRDQ (big blind) collected ($0.20)
Seat 9: s2xLPOl/vhl/26apJ3vsOQ folded before Flop (didn't bet)




PokerStars Game #59941624456:  Hold'em No Limit ($0.10/$0.25) - 2009/07/01 1:41:04 ET
Table 'mdub7rJf3Z5tCT9s/+1+Wg' 9-max Seat #3 is the button
Seat 1: cZ99hugmLBj9KhTlc8nCSw ($29.25 in chips) 
Seat 2: 539MC3AwKLWVFwzABc644Q ($9.60 in chips) 
Seat 3: PdIasPkzm2sqZnN41ZRXOg ($5 in chips) 
Seat 4: fDGyaQz0cs2s4FOYxkbIHA ($14.95 in chips) 
Seat 5: dfNim92Z6XK1/h5SFW5vDg ($25.60 in chips) 
Seat 6: T/CCwAWe2yhO0c4oHNwicw ($22.45 in chips) 
Seat 7: woe+9KKk+L3pZgMTuHcmog ($16.45 in chips) 
Seat 8: Z9AeOQX3yzuSvKAm/xyovg ($6.75 in chips) 
Seat 9: tYsOBqdU1+x+yFI7zHO7hQ ($36.80 in chips) 
fDGyaQz0cs2s4FOYxkbIHA: posts small blind $0.10
dfNim92Z6XK1/h5SFW5vDg: posts big blind $0.25
*** HOLE CARDS ***
T/CCwAWe2yhO0c4oHNwicw: folds 
woe+9KKk+L3pZgMTuHcmog: folds 
Z9AeOQX3yzuSvKAm/xyovg: folds 
tYsOBqdU1+x+yFI7zHO7hQ: folds 
cZ99hugmLBj9KhTlc8nCSw: folds 
539MC3AwKLWVFwzABc644Q: folds 
PdIasPkzm2sqZnN41ZRXOg: raises $1 to $1.25
fDGyaQz0cs2s4FOYxkbIHA: folds 
dfNim92Z6XK1/h5SFW5vDg: folds 
Uncalled bet ($1) returned to PdIasPkzm2sqZnN41ZRXOg
PdIasPkzm2sqZnN41ZRXOg collected $0.60 from pot
PdIasPkzm2sqZnN41ZRXOg: doesn't show hand 
*** SUMMARY ***
Total pot $0.60 | Rake $0 
Seat 1: cZ99hugmLBj9KhTlc8nCSw folded before Flop (didn't bet)
Seat 2: 539MC3AwKLWVFwzABc644Q folded before Flop (didn't bet)
Seat 3: PdIasPkzm2sqZnN41ZRXOg (button) collected ($0.60)
Seat 4: fDGyaQz0cs2s4FOYxkbIHA (small blind) folded before Flop
Seat 5: dfNim92Z6XK1/h5SFW5vDg (big blind) folded before Flop
Seat 6: T/CCwAWe2yhO0c4oHNwicw folded before Flop (didn't bet)
Seat 7: woe+9KKk+L3pZgMTuHcmog folded before Flop (didn't bet)
Seat 8: Z9AeOQX3yzuSvKAm/xyovg folded before Flop (didn't bet)
Seat 9: tYsOBqdU1+x+yFI7zHO7hQ folded before Flop (didn't bet)




PokerStars Game #59941624078:  Hold'em No Limit ($0.10/$0.25) - 2009/07/01 1:41:04 ET
Table '4UJB/UOZ5aepyF2v+hIoUg' 6-max Seat #5 is the button
Seat 1: 08V++DOqzaNrRNsHIwi25w ($27.10 in chips) 
Seat 2: mFv3iBCtrw9XfCDRB0d46Q ($3.95 in chips) 
Seat 3: zlYHXTtJ5tcx9kwK2h5n9A ($38.90 in chips) 
Seat 4: R6AGToFJQOYVZAjC2jXEKw ($23.40 in chips) 
Seat 5: 3zD3qLXT1bEffAoWGnc7wg ($25.90 in chips) 
Seat 6: 2aphcinkTZT0B0Uoah6cvQ ($17.35 in chips) 
2aphcinkTZT0B0Uoah6cvQ: posts small blind $0.10
08V++DOqzaNrRNsHIwi25w: posts big blind $0.25
*** HOLE CARDS ***
mFv3iBCtrw9XfCDRB0d46Q: folds 
zlYHXTtJ5tcx9kwK2h5n9A: folds 
R6AGToFJQOYVZAjC2jXEKw: calls $0.25
3zD3qLXT1bEffAoWGnc7wg: folds 
2aphcinkTZT0B0Uoah6cvQ: calls $0.15
08V++DOqzaNrRNsHIwi25w: checks 
*** FLOP *** [Qc 3c 2c]
2aphcinkTZT0B0Uoah6cvQ: checks 
08V++DOqzaNrRNsHIwi25w: checks 
R6AGToFJQOYVZAjC2jXEKw: checks 
*** TURN *** [Qc 3c 2c] [9h]
2aphcinkTZT0B0Uoah6cvQ: checks 
08V++DOqzaNrRNsHIwi25w: checks 
R6AGToFJQOYVZAjC2jXEKw: checks 
*** RIVER *** [Qc 3c 2c 9h] [3h]
2aphcinkTZT0B0Uoah6cvQ: bets $0.25
08V++DOqzaNrRNsHIwi25w: folds 
R6AGToFJQOYVZAjC2jXEKw: folds 
Uncalled bet ($0.25) returned to 2aphcinkTZT0B0Uoah6cvQ
2aphcinkTZT0B0Uoah6cvQ collected $0.75 from pot
2aphcinkTZT0B0Uoah6cvQ: doesn't show hand 
*** SUMMARY ***
Total pot $0.75 | Rake $0 
Board [Qc 3c 2c 9h 3h]
Seat 1: 08V++DOqzaNrRNsHIwi25w (big blind) folded on the River
Seat 2: mFv3iBCtrw9XfCDRB0d46Q folded before Flop (didn't bet)
Seat 3: zlYHXTtJ5tcx9kwK2h5n9A folded before Flop (didn't bet)
Seat 4: R6AGToFJQOYVZAjC2jXEKw folded on the River
Seat 5: 3zD3qLXT1bEffAoWGnc7wg (button) folded before Flop (didn't bet)
Seat 6: 2aphcinkTZT0B0Uoah6cvQ (small blind) collected ($0.75)




PokerStars Game #59941624076:  Hold'em No Limit ($0.10/$0.25) - 2009/07/01 1:41:04 ET
Table 'g+mPuNJBCHKE9ents7ZGtg' 6-max Seat #1 is the button
Seat 1: cezpHJ8FB07dj0xG+LhOvw ($59.45 in chips) 
Seat 2: fZQg9veL7Dd/Z04ZTjC+wQ ($65.80 in chips) 
Seat 3: FYepjhAvF8ZdVCmqHIy+eQ ($25.60 in chips) 
Seat 4: yVrjRIW0SMxgpvqSIPSe/w ($13.95 in chips) 
Seat 5: D3ikCR8c/o9jB5irZ3uGlw ($14.15 in chips) 
Seat 6: Mn2V28t5aGq2d09z+/o6Fw ($6.30 in chips) 
fZQg9veL7Dd/Z04ZTjC+wQ: posts small blind $0.10
FYepjhAvF8ZdVCmqHIy+eQ: posts big blind $0.25
*** HOLE CARDS ***
yVrjRIW0SMxgpvqSIPSe/w: folds 
D3ikCR8c/o9jB5irZ3uGlw: raises $0.25 to $0.50
Mn2V28t5aGq2d09z+/o6Fw: calls $0.50
cezpHJ8FB07dj0xG+LhOvw: folds 
fZQg9veL7Dd/Z04ZTjC+wQ: folds 
FYepjhAvF8ZdVCmqHIy+eQ: folds 
*** FLOP *** [8c Qs Td]
D3ikCR8c/o9jB5irZ3uGlw: checks 
Mn2V28t5aGq2d09z+/o6Fw: bets $0.75
D3ikCR8c/o9jB5irZ3uGlw: calls $0.75
*** TURN *** [8c Qs Td] [Qd]
D3ikCR8c/o9jB5irZ3uGlw: checks 
Mn2V28t5aGq2d09z+/o6Fw: bets $1.50
D3ikCR8c/o9jB5irZ3uGlw: folds 
Uncalled bet ($1.50) returned to Mn2V28t5aGq2d09z+/o6Fw
Mn2V28t5aGq2d09z+/o6Fw collected $2.75 from pot
Mn2V28t5aGq2d09z+/o6Fw: doesn't show hand 
*** SUMMARY ***
Total pot $2.85 | Rake $0.10 
Board [8c Qs Td Qd]
Seat 1: cezpHJ8FB07dj0xG+LhOvw (button) folded before Flop (didn't bet)
Seat 2: fZQg9veL7Dd/Z04ZTjC+wQ (small blind) folded before Flop
Seat 3: FYepjhAvF8ZdVCmqHIy+eQ (big blind) folded before Flop
Seat 4: yVrjRIW0SMxgpvqSIPSe/w folded before Flop (didn't bet)
Seat 5: D3ikCR8c/o9jB5irZ3uGlw folded on the Turn
Seat 6: Mn2V28t5aGq2d09z+/o6Fw collected ($2.75)




PokerStars Game #59941624818:  Hold'em No Limit ($0.10/$0.25) - 2009/07/01 1:41:05 ET
Table 'nB7Q7zfNfy6ig6DB+rsgWQ' 6-max Seat #6 is the button
Seat 1: Hzy03WtPHMYwLYM7hTTxQw ($0.30 in chips) 
Seat 2: 4BHo0wlX9INjkj2727qE0w ($7.10 in chips) 
Seat 3: p3NYOxYhkL7txPRSeXHDeg ($31.30 in chips) 
Seat 4: DihMHaz4WNETH1bPDe13kA ($77.65 in chips) 
Seat 6: MEGIwX0eHRUj63lwYaNhVg ($9.70 in chips) 
Hzy03WtPHMYwLYM7hTTxQw: posts small blind $0.10
4BHo0wlX9INjkj2727qE0w: posts big blind $0.25
*** HOLE CARDS ***
D2qb0DD9hycFaE/pJ6JNng leaves the table
p3NYOxYhkL7txPRSeXHDeg: calls $0.25
ripbrokeith joins the table at seat #5 
DihMHaz4WNETH1bPDe13kA: folds 
MEGIwX0eHRUj63lwYaNhVg: folds 
Hzy03WtPHMYwLYM7hTTxQw: folds 
4BHo0wlX9INjkj2727qE0w: raises $0.25 to $0.50
p3NYOxYhkL7txPRSeXHDeg: calls $0.25
*** FLOP *** [4h Qs 2s]
4BHo0wlX9INjkj2727qE0w: bets $0.50
p3NYOxYhkL7txPRSeXHDeg: folds 
Uncalled bet ($0.50) returned to 4BHo0wlX9INjkj2727qE0w
4BHo0wlX9INjkj2727qE0w collected $1.05 from pot
*** SUMMARY ***
Total pot $1.10 | Rake $0.05 
Board [4h Qs 2s]
Seat 1: Hzy03WtPHMYwLYM7hTTxQw (small blind) folded before Flop
Seat 2: 4BHo0wlX9INjkj2727qE0w (big blind) collected ($1.05)
Seat 3: p3NYOxYhkL7txPRSeXHDeg folded on the Flop
Seat 4: DihMHaz4WNETH1bPDe13kA folded before Flop (didn't bet)
Seat 6: MEGIwX0eHRUj63lwYaNhVg (button) folded before Flop (didn't bet)




PokerStars Game #59941624914:  Hold'em No Limit ($0.10/$0.25) - 2009/07/01 1:41:05 ET
Table 'rjcb+nlE+0GuJ6lBhuCkkA' 6-max Seat #3 is the button
Seat 1: lBoEwOFgzcERLIRUkUoRTw ($13.95 in chips) 
Seat 2: lJphax9e7/+O/3YCKPJ0yQ ($4.40 in chips) 
Seat 3: 8ClCHtFXGNplITm+63KB+Q ($66.50 in chips) 
Seat 4: BV+K0Phf5VBHr7aZPKqbUQ ($25.35 in chips) 
Seat 5: GC/9yVD59DUCX7hUI7gcLw ($42.10 in chips) 
BV+K0Phf5VBHr7aZPKqbUQ: posts small blind $0.10
GC/9yVD59DUCX7hUI7gcLw: posts big blind $0.25
32YL2ZEp8NT4JB2RVM9euQ: sits out 
*** HOLE CARDS ***
lBoEwOFgzcERLIRUkUoRTw: folds 
lJphax9e7/+O/3YCKPJ0yQ: calls $0.25
8ClCHtFXGNplITm+63KB+Q: folds 
BV+K0Phf5VBHr7aZPKqbUQ: raises $1 to $1.25
GC/9yVD59DUCX7hUI7gcLw: folds 
lJphax9e7/+O/3YCKPJ0yQ: folds 
Uncalled bet ($1) returned to BV+K0Phf5VBHr7aZPKqbUQ
BV+K0Phf5VBHr7aZPKqbUQ collected $0.75 from pot
BV+K0Phf5VBHr7aZPKqbUQ: doesn't show hand 
*** SUMMARY ***
Total pot $0.75 | Rake $0 
Seat 1: lBoEwOFgzcERLIRUkUoRTw folded before Flop (didn't bet)
Seat 2: lJphax9e7/+O/3YCKPJ0yQ folded before Flop
Seat 3: 8ClCHtFXGNplITm+63KB+Q (button) folded before Flop (didn't bet)
Seat 4: BV+K0Phf5VBHr7aZPKqbUQ (small blind) collected ($0.75)
Seat 5: GC/9yVD59DUCX7hUI7gcLw (big blind) folded before Flop




PokerStars Game #59941625156:  Hold'em No Limit ($0.10/$0.25) - 2009/07/01 1:41:06 ET
Table 'jxoHy9yJy0bbH/Qx73FoPA' 9-max Seat #9 is the button
Seat 1: j4q3p0lesp63b1gZDwLBZw ($6.35 in chips) 
Seat 2: F7pnn6czNpHvRM55XcA2EA ($38.75 in chips) 
Seat 3: CVqCt93Mk0MhKMaZ4LZDSQ ($11.20 in chips) 
Seat 4: A1M0JIGHzqMXp7L2MdcxXw ($26.65 in chips) 
Seat 5: cZ99hugmLBj9KhTlc8nCSw ($25.10 in chips) 
Seat 6: tYsOBqdU1+x+yFI7zHO7hQ ($46.35 in chips) 
Seat 7: wGigCmBR/9XWkPpvYos3aQ ($26.40 in chips) 
Seat 9: CvL9Ch1HYCVbTsfpNucitg ($4.90 in chips) 
j4q3p0lesp63b1gZDwLBZw: posts small blind $0.10
F7pnn6czNpHvRM55XcA2EA: posts big blind $0.25
*** HOLE CARDS ***
CVqCt93Mk0MhKMaZ4LZDSQ: folds 
DigiSlarks joins the table at seat #8 
A1M0JIGHzqMXp7L2MdcxXw: folds 
cZ99hugmLBj9KhTlc8nCSw: folds 
tYsOBqdU1+x+yFI7zHO7hQ: folds 
wGigCmBR/9XWkPpvYos3aQ: folds 
CvL9Ch1HYCVbTsfpNucitg: folds 
j4q3p0lesp63b1gZDwLBZw: raises $0.75 to $1
F7pnn6czNpHvRM55XcA2EA: folds 
Uncalled bet ($0.75) returned to j4q3p0lesp63b1gZDwLBZw
j4q3p0lesp63b1gZDwLBZw collected $0.50 from pot
j4q3p0lesp63b1gZDwLBZw: doesn't show hand 
*** SUMMARY ***
Total pot $0.50 | Rake $0 
Seat 1: j4q3p0lesp63b1gZDwLBZw (small blind) collected ($0.50)
Seat 2: F7pnn6czNpHvRM55XcA2EA (big blind) folded before Flop
Seat 3: CVqCt93Mk0MhKMaZ4LZDSQ folded before Flop (didn't bet)
Seat 4: A1M0JIGHzqMXp7L2MdcxXw folded before Flop (didn't bet)
Seat 5: cZ99hugmLBj9KhTlc8nCSw folded before Flop (didn't bet)
Seat 6: tYsOBqdU1+x+yFI7zHO7hQ folded before Flop (didn't bet)
Seat 7: wGigCmBR/9XWkPpvYos3aQ folded before Flop (didn't bet)
Seat 9: CvL9Ch1HYCVbTsfpNucitg (button) folded before Flop (didn't bet)




PokerStars Game #59941625386:  Hold'em No Limit ($0.10/$0.25) - 2009/07/01 1:41:06 ET
Table 'r562aMIMs5kgo28FEU6lkA' 9-max Seat #1 is the button
Seat 1: H5Se03ZqSX7tbULXur2MAg ($17.55 in chips) 
Seat 2: N8muFAHrFHW6elSMGuyVLQ ($22.55 in chips) 
Seat 3: xoBFd/5k+L/pFn9VW1VyWg ($11.10 in chips) 
Seat 4: V6p0jQ/RhUsqpHLmXvEX4Q ($17.25 in chips) 
Seat 5: zDrucyjVn5aeekNEc3cJrA ($35.85 in chips) 
Seat 7: Bb42QRQMhg5/Y0vHP8/2Xw ($25 in chips) 
Seat 8: B6xHiX1SJkS0CUNCKDVwuQ ($21.70 in chips) 
Seat 9: yyG4svzOpC1A+sUP/scg6w ($7.50 in chips) 
N8muFAHrFHW6elSMGuyVLQ: posts small blind $0.10
xoBFd/5k+L/pFn9VW1VyWg: posts big blind $0.25
RCqMONFrSPSArZh2Jsar/w: sits out 
*** HOLE CARDS ***
V6p0jQ/RhUsqpHLmXvEX4Q: folds 
zDrucyjVn5aeekNEc3cJrA: calls $0.25
Bb42QRQMhg5/Y0vHP8/2Xw: folds 
B6xHiX1SJkS0CUNCKDVwuQ: raises $0.75 to $1
yyG4svzOpC1A+sUP/scg6w: folds 
H5Se03ZqSX7tbULXur2MAg: folds 
N8muFAHrFHW6elSMGuyVLQ: calls $0.90
xoBFd/5k+L/pFn9VW1VyWg: folds 
zDrucyjVn5aeekNEc3cJrA: calls $0.75
*** FLOP *** [Qc 4s 7s]
N8muFAHrFHW6elSMGuyVLQ: checks 
zDrucyjVn5aeekNEc3cJrA: checks 
B6xHiX1SJkS0CUNCKDVwuQ: checks 
*** TURN *** [Qc 4s 7s] [9d]
N8muFAHrFHW6elSMGuyVLQ: bets $0.75
zDrucyjVn5aeekNEc3cJrA: folds 
zDrucyjVn5aeekNEc3cJrA is sitting out
B6xHiX1SJkS0CUNCKDVwuQ: calls $0.75
*** RIVER *** [Qc 4s 7s 9d] [2h]
N8muFAHrFHW6elSMGuyVLQ: bets $4
B6xHiX1SJkS0CUNCKDVwuQ: folds 
Uncalled bet ($4) returned to N8muFAHrFHW6elSMGuyVLQ
N8muFAHrFHW6elSMGuyVLQ collected $4.55 from pot
N8muFAHrFHW6elSMGuyVLQ: doesn't show hand 
*** SUMMARY ***
Total pot $4.75 | Rake $0.20 
Board [Qc 4s 7s 9d 2h]
Seat 1: H5Se03ZqSX7tbULXur2MAg (button) folded before Flop (didn't bet)
Seat 2: N8muFAHrFHW6elSMGuyVLQ (small blind) collected ($4.55)
Seat 3: xoBFd/5k+L/pFn9VW1VyWg (big blind) folded before Flop
Seat 4: V6p0jQ/RhUsqpHLmXvEX4Q folded before Flop (didn't bet)
Seat 5: zDrucyjVn5aeekNEc3cJrA folded on the Turn
Seat 7: Bb42QRQMhg5/Y0vHP8/2Xw folded before Flop (didn't bet)
Seat 8: B6xHiX1SJkS0CUNCKDVwuQ folded on the River
Seat 9: yyG4svzOpC1A+sUP/scg6w folded before Flop (didn't bet)




PokerStars Game #59941625220:  Hold'em No Limit ($0.10/$0.25) - 2009/07/01 1:41:06 ET
Table 'IUwZ/e0bDHZPgsIWx0RnNg' 6-max Seat #2 is the button
Seat 1: V66QiVCQPofyl3a+dpPHQQ ($5 in chips) 
Seat 2: mvFHK3pE7tCxJEqLjKC70Q ($54.65 in chips) 
Seat 3: dOX4wnYV2sEqvDbF+8KSCw ($25.45 in chips) 
Seat 6: NhUN/JpAprdJeamFBgJH1w ($40.60 in chips) 
dOX4wnYV2sEqvDbF+8KSCw: posts small blind $0.10
NhUN/JpAprdJeamFBgJH1w: posts big blind $0.25
V66QiVCQPofyl3a+dpPHQQ: posts big blind $0.25
*** HOLE CARDS ***
V66QiVCQPofyl3a+dpPHQQ: raises $0.50 to $0.75
pistolp999 joins the table at seat #4 
mvFHK3pE7tCxJEqLjKC70Q: folds 
dOX4wnYV2sEqvDbF+8KSCw: folds 
geomdnb joins the table at seat #5 
NhUN/JpAprdJeamFBgJH1w: folds 
Uncalled bet ($0.50) returned to V66QiVCQPofyl3a+dpPHQQ
V66QiVCQPofyl3a+dpPHQQ collected $0.60 from pot
*** SUMMARY ***
Total pot $0.60 | Rake $0 
Seat 1: V66QiVCQPofyl3a+dpPHQQ collected ($0.60)
Seat 2: mvFHK3pE7tCxJEqLjKC70Q (button) folded before Flop (didn't bet)
Seat 3: dOX4wnYV2sEqvDbF+8KSCw (small blind) folded before Flop
Seat 6: NhUN/JpAprdJeamFBgJH1w (big blind) folded before Flop




PokerStars Game #59941625258:  Hold'em No Limit ($0.10/$0.25) - 2009/07/01 1:41:06 ET
Table 'SgI2Cobdjtkh0Fd0/eTTDg' 9-max Seat #9 is the button
Seat 1: NcPAt5YjVvDFEJTTgAVj8g ($5.85 in chips) 
Seat 2: uUc5QTI8+ZdC95UnznCsqg ($13.10 in chips) 
Seat 3: OiV1PWZ3IkN29JlmCcnTwQ ($4.90 in chips) 
Seat 4: s1y+qfkBnhgc67+X3ThjeA ($10.25 in chips) 
Seat 5: w/RUHfVzKTf7Bc19nucLpQ ($23.70 in chips) 
Seat 6: 6RiVTYll/5D8zICp0MRpKw ($25.90 in chips) 
Seat 7: lOuxRXNpa9V2VxLMNpxUOg ($20.95 in chips) 
Seat 8: 8GJHzzxiotOqC5gdtgpLoA ($9.65 in chips) 
Seat 9: cZ99hugmLBj9KhTlc8nCSw ($30.95 in chips) 
NcPAt5YjVvDFEJTTgAVj8g: posts small blind $0.10
uUc5QTI8+ZdC95UnznCsqg: posts big blind $0.25
*** HOLE CARDS ***
OiV1PWZ3IkN29JlmCcnTwQ: folds 
s1y+qfkBnhgc67+X3ThjeA: folds 
w/RUHfVzKTf7Bc19nucLpQ: folds 
6RiVTYll/5D8zICp0MRpKw: folds 
lOuxRXNpa9V2VxLMNpxUOg: calls $0.25
8GJHzzxiotOqC5gdtgpLoA: folds 
cZ99hugmLBj9KhTlc8nCSw: folds 
NcPAt5YjVvDFEJTTgAVj8g: calls $0.15
uUc5QTI8+ZdC95UnznCsqg: checks 
*** FLOP *** [7s Tc 9h]
NcPAt5YjVvDFEJTTgAVj8g: checks 
uUc5QTI8+ZdC95UnznCsqg: checks 
lOuxRXNpa9V2VxLMNpxUOg: checks 
*** TURN *** [7s Tc 9h] [Th]
NcPAt5YjVvDFEJTTgAVj8g: checks 
uUc5QTI8+ZdC95UnznCsqg: checks 
lOuxRXNpa9V2VxLMNpxUOg: checks 
*** RIVER *** [7s Tc 9h Th] [Jc]
NcPAt5YjVvDFEJTTgAVj8g: checks 
uUc5QTI8+ZdC95UnznCsqg: bets $0.50
lOuxRXNpa9V2VxLMNpxUOg: calls $0.50
NcPAt5YjVvDFEJTTgAVj8g: calls $0.50
*** SHOW DOWN ***
uUc5QTI8+ZdC95UnznCsqg: shows [5d Jh] (two pair, Jacks and Tens)
lOuxRXNpa9V2VxLMNpxUOg: mucks hand 
NcPAt5YjVvDFEJTTgAVj8g: shows [7c Js] (two pair, Jacks and Tens)
NcPAt5YjVvDFEJTTgAVj8g collected $1.10 from pot
uUc5QTI8+ZdC95UnznCsqg collected $1.05 from pot
*** SUMMARY ***
Total pot $2.25 | Rake $0.10 
Board [7s Tc 9h Th Jc]
Seat 1: NcPAt5YjVvDFEJTTgAVj8g (small blind) showed [7c Js] and won ($1.10) with two pair, Jacks and Tens
Seat 2: uUc5QTI8+ZdC95UnznCsqg (big blind) showed [5d Jh] and won ($1.05) with two pair, Jacks and Tens
Seat 3: OiV1PWZ3IkN29JlmCcnTwQ folded before Flop (didn't bet)
Seat 4: s1y+qfkBnhgc67+X3ThjeA folded before Flop (didn't bet)
Seat 5: w/RUHfVzKTf7Bc19nucLpQ folded before Flop (didn't bet)
Seat 6: 6RiVTYll/5D8zICp0MRpKw folded before Flop (didn't bet)
Seat 7: lOuxRXNpa9V2VxLMNpxUOg mucked
Seat 8: 8GJHzzxiotOqC5gdtgpLoA folded before Flop (didn't bet)
Seat 9: cZ99hugmLBj9KhTlc8nCSw (button) folded before Flop (didn't bet)




PokerStars Game #59941625360:  Hold'em No Limit ($0.10/$0.25) - 2009/07/01 1:41:06 ET
Table '2O5CgfSkSwrr4PDrlZ1RLQ' 6-max Seat #1 is the button
Seat 1: 3skmHD9EOATKdUzzyHh1KA ($29.40 in chips) 
Seat 2: wqphQtauX5Qn7WRJZS1flA ($25.45 in chips) 
Seat 3: oBUDUfeUyCbZBsjxHZgSiw ($30 in chips) 
Seat 4: 2Ga+TibtZsUCp1MLaueYVA ($25 in chips) 
Seat 5: 0av6tRNdi0Ui4f15L7gsVg ($21.90 in chips) 
Seat 6: tj9xqoqQaDaFw7u1oyZrtA ($44.20 in chips) 
wqphQtauX5Qn7WRJZS1flA: posts small blind $0.10
oBUDUfeUyCbZBsjxHZgSiw: posts big blind $0.25
*** HOLE CARDS ***
2Ga+TibtZsUCp1MLaueYVA: folds 
0av6tRNdi0Ui4f15L7gsVg: folds 
tj9xqoqQaDaFw7u1oyZrtA: calls $0.25
3skmHD9EOATKdUzzyHh1KA: folds 
wqphQtauX5Qn7WRJZS1flA: raises $0.75 to $1
oBUDUfeUyCbZBsjxHZgSiw: folds 
tj9xqoqQaDaFw7u1oyZrtA: calls $0.75
*** FLOP *** [3c Qs Qc]
wqphQtauX5Qn7WRJZS1flA: bets $1.50
tj9xqoqQaDaFw7u1oyZrtA: calls $1.50
*** TURN *** [3c Qs Qc] [Js]
wqphQtauX5Qn7WRJZS1flA: checks 
tj9xqoqQaDaFw7u1oyZrtA: bets $2
wqphQtauX5Qn7WRJZS1flA: calls $2
*** RIVER *** [3c Qs Qc Js] [2c]
wqphQtauX5Qn7WRJZS1flA: checks 
tj9xqoqQaDaFw7u1oyZrtA: bets $3
wqphQtauX5Qn7WRJZS1flA: folds 
Uncalled bet ($3) returned to tj9xqoqQaDaFw7u1oyZrtA
tj9xqoqQaDaFw7u1oyZrtA collected $8.80 from pot
tj9xqoqQaDaFw7u1oyZrtA: doesn't show hand 
*** SUMMARY ***
Total pot $9.25 | Rake $0.45 
Board [3c Qs Qc Js 2c]
Seat 1: 3skmHD9EOATKdUzzyHh1KA (button) folded before Flop (didn't bet)
Seat 2: wqphQtauX5Qn7WRJZS1flA (small blind) folded on the River
Seat 3: oBUDUfeUyCbZBsjxHZgSiw (big blind) folded before Flop
Seat 4: 2Ga+TibtZsUCp1MLaueYVA folded before Flop (didn't bet)
Seat 5: 0av6tRNdi0Ui4f15L7gsVg folded before Flop (didn't bet)
Seat 6: tj9xqoqQaDaFw7u1oyZrtA collected ($8.80)




PokerStars Game #59941625538:  Hold'em No Limit ($0.10/$0.25) - 2009/07/01 1:41:06 ET
Table 'nc6OeGk/wtaWV+6N+kgnZQ' 6-max Seat #4 is the button
Seat 1: tSR4329m40dZsN7YOpI9Kw ($39.15 in chips) 
Seat 2: 8ClCHtFXGNplITm+63KB+Q ($35.10 in chips) 
Seat 3: y8wpMWGSX2zHZijurx21mg ($6.85 in chips) 
Seat 4: 3zD3qLXT1bEffAoWGnc7wg ($29.95 in chips) 
Seat 5: HCS0lMAAPmZE2Tl8J/SuKw ($11.20 in chips) 
Seat 6: mFv3iBCtrw9XfCDRB0d46Q ($2.95 in chips) 
HCS0lMAAPmZE2Tl8J/SuKw: posts small blind $0.10
mFv3iBCtrw9XfCDRB0d46Q: posts big blind $0.25
*** HOLE CARDS ***
tSR4329m40dZsN7YOpI9Kw: folds 
8ClCHtFXGNplITm+63KB+Q: folds 
y8wpMWGSX2zHZijurx21mg: calls $0.25
3zD3qLXT1bEffAoWGnc7wg: folds 
HCS0lMAAPmZE2Tl8J/SuKw: calls $0.15
mFv3iBCtrw9XfCDRB0d46Q: checks 
*** FLOP *** [3c 5d 3d]
HCS0lMAAPmZE2Tl8J/SuKw: checks 
mFv3iBCtrw9XfCDRB0d46Q: checks 
y8wpMWGSX2zHZijurx21mg: checks 
*** TURN *** [3c 5d 3d] [8d]
HCS0lMAAPmZE2Tl8J/SuKw: checks 
mFv3iBCtrw9XfCDRB0d46Q: checks 
y8wpMWGSX2zHZijurx21mg: checks 
*** RIVER *** [3c 5d 3d 8d] [Qc]
HCS0lMAAPmZE2Tl8J/SuKw: bets $0.50
mFv3iBCtrw9XfCDRB0d46Q: folds 
y8wpMWGSX2zHZijurx21mg: folds 
Uncalled bet ($0.50) returned to HCS0lMAAPmZE2Tl8J/SuKw
HCS0lMAAPmZE2Tl8J/SuKw collected $0.75 from pot
*** SUMMARY ***
Total pot $0.75 | Rake $0 
Board [3c 5d 3d 8d Qc]
Seat 1: tSR4329m40dZsN7YOpI9Kw folded before Flop (didn't bet)
Seat 2: 8ClCHtFXGNplITm+63KB+Q folded before Flop (didn't bet)
Seat 3: y8wpMWGSX2zHZijurx21mg folded on the River
Seat 4: 3zD3qLXT1bEffAoWGnc7wg (button) folded before Flop (didn't bet)
Seat 5: HCS0lMAAPmZE2Tl8J/SuKw (small blind) collected ($0.75)
Seat 6: mFv3iBCtrw9XfCDRB0d46Q (big blind) folded on the River




PokerStars Game #59941625106:  Hold'em No Limit ($0.10/$0.25) - 2009/07/01 1:41:06 ET
Table 'edvgY2YQ1I34euq4EVqGnA' 6-max Seat #1 is the button
Seat 1: mvFHK3pE7tCxJEqLjKC70Q ($25.25 in chips) 
Seat 2: SxIIgwXYLkwd6m3wLyPTCw ($16 in chips) 
Seat 3: mFv3iBCtrw9XfCDRB0d46Q ($3.90 in chips) 
Seat 4: TI/C5Q+DEl4fLR3AofwYdg ($20.65 in chips) 
Seat 5: EE16Ua5b1HSsYej5zeXOlA ($54.75 in chips) 
Seat 6: kG34n23qFQA3nzdOJTQ1dA ($72.35 in chips) 
SxIIgwXYLkwd6m3wLyPTCw: posts small blind $0.10
mFv3iBCtrw9XfCDRB0d46Q: posts big blind $0.25
*** HOLE CARDS ***
TI/C5Q+DEl4fLR3AofwYdg: raises $0.25 to $0.50
EE16Ua5b1HSsYej5zeXOlA: calls $0.50
kG34n23qFQA3nzdOJTQ1dA: folds 
mvFHK3pE7tCxJEqLjKC70Q: folds 
SxIIgwXYLkwd6m3wLyPTCw: folds 
mFv3iBCtrw9XfCDRB0d46Q: folds 
*** FLOP *** [4c 7d 2h]
TI/C5Q+DEl4fLR3AofwYdg: bets $1
EE16Ua5b1HSsYej5zeXOlA: calls $1
*** TURN *** [4c 7d 2h] [Qd]
TI/C5Q+DEl4fLR3AofwYdg: checks 
EE16Ua5b1HSsYej5zeXOlA: bets $2.50
TI/C5Q+DEl4fLR3AofwYdg: folds 
Uncalled bet ($2.50) returned to EE16Ua5b1HSsYej5zeXOlA
EE16Ua5b1HSsYej5zeXOlA collected $3.20 from pot
EE16Ua5b1HSsYej5zeXOlA: doesn't show hand 
*** SUMMARY ***
Total pot $3.35 | Rake $0.15 
Board [4c 7d 2h Qd]
Seat 1: mvFHK3pE7tCxJEqLjKC70Q (button) folded before Flop (didn't bet)
Seat 2: SxIIgwXYLkwd6m3wLyPTCw (small blind) folded before Flop
Seat 3: mFv3iBCtrw9XfCDRB0d46Q (big blind) folded before Flop
Seat 4: TI/C5Q+DEl4fLR3AofwYdg folded on the Turn
Seat 5: EE16Ua5b1HSsYej5zeXOlA collected ($3.20)
Seat 6: kG34n23qFQA3nzdOJTQ1dA folded before Flop (didn't bet)




PokerStars Game #59941625192:  Hold'em No Limit ($0.10/$0.25) - 2009/07/01 1:41:06 ET
Table 'HbNAGS1OJWQKyfk7UfrYyw' 9-max Seat #7 is the button
Seat 1: 7cv+9Zc9HIQHNvYsMfV3uA ($25 in chips) 
Seat 2: fjwM06E3HzjUrynPRQi31Q ($4.75 in chips) 
Seat 7: n+stbTneifqFNME+tpoGrw ($25.50 in chips) 
7cv+9Zc9HIQHNvYsMfV3uA: posts small blind $0.10
fjwM06E3HzjUrynPRQi31Q: posts big blind $0.25
*** HOLE CARDS ***
n+stbTneifqFNME+tpoGrw: folds 
7cv+9Zc9HIQHNvYsMfV3uA: folds 
Uncalled bet ($0.15) returned to fjwM06E3HzjUrynPRQi31Q
fjwM06E3HzjUrynPRQi31Q collected $0.20 from pot
fjwM06E3HzjUrynPRQi31Q: doesn't show hand 
*** SUMMARY ***
Total pot $0.20 | Rake $0 
Seat 1: 7cv+9Zc9HIQHNvYsMfV3uA (small blind) folded before Flop
Seat 2: fjwM06E3HzjUrynPRQi31Q (big blind) collected ($0.20)
Seat 7: n+stbTneifqFNME+tpoGrw (button) folded before Flop (didn't bet)




PokerStars Game #59941626104:  Hold'em No Limit ($0.10/$0.25) - 2009/07/01 1:41:07 ET
Table 'M8kYidAX3ib7pLKW7edFLw' 6-max Seat #5 is the button
Seat 1: jp34e617tIzV8tKIWmfAbA ($25.70 in chips) 
Seat 2: ypmjhffk/YHGc51wgVXUTw ($28.45 in chips) 
Seat 3: cezpHJ8FB07dj0xG+LhOvw ($27.45 in chips) 
Seat 4: Hsvkc0/G2VV78oVmWYXecw ($5.35 in chips) 
Seat 5: bDKopKTvPi3W+PEnYUX3tg ($44.50 in chips) 
Seat 6: NqFoyDgzLwu4dOmSRXnFBA ($19.75 in chips) 
NqFoyDgzLwu4dOmSRXnFBA: posts small blind $0.10
jp34e617tIzV8tKIWmfAbA: posts big blind $0.25
*** HOLE CARDS ***
ypmjhffk/YHGc51wgVXUTw: folds 
cezpHJ8FB07dj0xG+LhOvw: folds 
Hsvkc0/G2VV78oVmWYXecw: folds 
bDKopKTvPi3W+PEnYUX3tg: calls $0.25
NqFoyDgzLwu4dOmSRXnFBA: folds 
jp34e617tIzV8tKIWmfAbA: checks 
*** FLOP *** [6d 3d Jh]
jp34e617tIzV8tKIWmfAbA: checks 
bDKopKTvPi3W+PEnYUX3tg: bets $0.50
jp34e617tIzV8tKIWmfAbA: folds 
Uncalled bet ($0.50) returned to bDKopKTvPi3W+PEnYUX3tg
bDKopKTvPi3W+PEnYUX3tg collected $0.60 from pot
bDKopKTvPi3W+PEnYUX3tg: doesn't show hand 
*** SUMMARY ***
Total pot $0.60 | Rake $0 
Board [6d 3d Jh]
Seat 1: jp34e617tIzV8tKIWmfAbA (big blind) folded on the Flop
Seat 2: ypmjhffk/YHGc51wgVXUTw folded before Flop (didn't bet)
Seat 3: cezpHJ8FB07dj0xG+LhOvw folded before Flop (didn't bet)
Seat 4: Hsvkc0/G2VV78oVmWYXecw folded before Flop (didn't bet)
Seat 5: bDKopKTvPi3W+PEnYUX3tg (button) collected ($0.60)
Seat 6: NqFoyDgzLwu4dOmSRXnFBA (small blind) folded before Flop




PokerStars Game #59941625954:  Hold'em No Limit ($0.10/$0.25) - 2009/07/01 1:41:07 ET
Table 'zKwHJD0cmKNUure9qQTfFg' 6-max Seat #1 is the button
Seat 1: RXYRBsbRgZxcivyqSdOo3A ($3.90 in chips) 
Seat 2: xrf8tAXKQHG99HixCot1Iw ($26.65 in chips) 
Seat 3: 60PLIlpucQhA08L3YbNmag ($5.60 in chips) 
Seat 4: v+QfkGiuj9bgtuNoVnDO8w ($26.15 in chips) 
Seat 5: E4AqQ1egsnu0oH2RqsbCmQ ($4.45 in chips) 
Seat 6: edio/rLJ06xeZOfLhoL3UA ($11.20 in chips) 
xrf8tAXKQHG99HixCot1Iw: posts small blind $0.10
60PLIlpucQhA08L3YbNmag: posts big blind $0.25
*** HOLE CARDS ***
v+QfkGiuj9bgtuNoVnDO8w: folds 
E4AqQ1egsnu0oH2RqsbCmQ has timed out
E4AqQ1egsnu0oH2RqsbCmQ: folds 
E4AqQ1egsnu0oH2RqsbCmQ is sitting out
edio/rLJ06xeZOfLhoL3UA: raises $1 to $1.25
RXYRBsbRgZxcivyqSdOo3A: folds 
xrf8tAXKQHG99HixCot1Iw: folds 
60PLIlpucQhA08L3YbNmag: folds 
Uncalled bet ($1) returned to edio/rLJ06xeZOfLhoL3UA
edio/rLJ06xeZOfLhoL3UA collected $0.60 from pot
edio/rLJ06xeZOfLhoL3UA: doesn't show hand 
*** SUMMARY ***
Total pot $0.60 | Rake $0 
Seat 1: RXYRBsbRgZxcivyqSdOo3A (button) folded before Flop (didn't bet)
Seat 2: xrf8tAXKQHG99HixCot1Iw (small blind) folded before Flop
Seat 3: 60PLIlpucQhA08L3YbNmag (big blind) folded before Flop
Seat 4: v+QfkGiuj9bgtuNoVnDO8w folded before Flop (didn't bet)
Seat 5: E4AqQ1egsnu0oH2RqsbCmQ folded before Flop (didn't bet)
Seat 6: edio/rLJ06xeZOfLhoL3UA collected ($0.60)




PokerStars Game #59941625830:  Hold'em No Limit ($0.10/$0.25) - 2009/07/01 1:41:07 ET
Table 'oxYpQNT8OHNCvpMIFi7UoA' 9-max Seat #6 is the button
Seat 1: EVqHvqty1ZsuvDFiSXlSqQ ($29.80 in chips) 
Seat 2: 8+iP8mvFyeAviW/yUH1CJg ($29.60 in chips) 
Seat 3: ubsjZomMWSV0hAiBLa7K1A ($19.65 in chips) 
Seat 4: eK8qa6EPcH2zhtbmWSvc9g ($25 in chips) 
Seat 5: ZoqLw33zTU6EsjOkfv/cGw ($20.15 in chips) 
Seat 6: VBHxUExRAMrbxUq/cVx9Gw ($5.40 in chips) 
Seat 7: X78b5v/uhqeXXoAijbw/yg ($25 in chips) 
Seat 9: pN3IHvAKm2fz+sTRARTcrg ($25 in chips) 
X78b5v/uhqeXXoAijbw/yg: posts small blind $0.10
pN3IHvAKm2fz+sTRARTcrg: posts big blind $0.25
*** HOLE CARDS ***
EVqHvqty1ZsuvDFiSXlSqQ: folds 
8+iP8mvFyeAviW/yUH1CJg: calls $0.25
ubsjZomMWSV0hAiBLa7K1A: folds 
eK8qa6EPcH2zhtbmWSvc9g: folds 
ZoqLw33zTU6EsjOkfv/cGw: calls $0.25
VBHxUExRAMrbxUq/cVx9Gw: folds 
X78b5v/uhqeXXoAijbw/yg: folds 
pN3IHvAKm2fz+sTRARTcrg: checks 
*** FLOP *** [Qh 2d Qc]
pN3IHvAKm2fz+sTRARTcrg: checks 
8+iP8mvFyeAviW/yUH1CJg: checks 
ZoqLw33zTU6EsjOkfv/cGw: checks 
*** TURN *** [Qh 2d Qc] [8s]
pN3IHvAKm2fz+sTRARTcrg: checks 
8+iP8mvFyeAviW/yUH1CJg: checks 
ZoqLw33zTU6EsjOkfv/cGw: checks 
*** RIVER *** [Qh 2d Qc 8s] [4d]
pN3IHvAKm2fz+sTRARTcrg: checks 
8+iP8mvFyeAviW/yUH1CJg: bets $1
ZoqLw33zTU6EsjOkfv/cGw: folds 
pN3IHvAKm2fz+sTRARTcrg: folds 
Uncalled bet ($1) returned to 8+iP8mvFyeAviW/yUH1CJg
8+iP8mvFyeAviW/yUH1CJg collected $0.85 from pot
*** SUMMARY ***
Total pot $0.85 | Rake $0 
Board [Qh 2d Qc 8s 4d]
Seat 1: EVqHvqty1ZsuvDFiSXlSqQ folded before Flop (didn't bet)
Seat 2: 8+iP8mvFyeAviW/yUH1CJg collected ($0.85)
Seat 3: ubsjZomMWSV0hAiBLa7K1A folded before Flop (didn't bet)
Seat 4: eK8qa6EPcH2zhtbmWSvc9g folded before Flop (didn't bet)
Seat 5: ZoqLw33zTU6EsjOkfv/cGw folded on the River
Seat 6: VBHxUExRAMrbxUq/cVx9Gw (button) folded before Flop (didn't bet)
Seat 7: X78b5v/uhqeXXoAijbw/yg (small blind) folded before Flop
Seat 9: pN3IHvAKm2fz+sTRARTcrg (big blind) folded on the River




PokerStars Game #59941626084:  Hold'em No Limit ($0.10/$0.25) - 2009/07/01 1:41:07 ET
Table 'XX2OuOsa8/8AC+/mR/Az6g' 9-max Seat #1 is the button
Seat 1: 56S3mA6Zs3pGR+0p0vUCtg ($26.15 in chips) 
Seat 2: Bb42QRQMhg5/Y0vHP8/2Xw ($26.25 in chips) 
Seat 3: oLa/tXLfSLLB28mcLGrxcg ($25 in chips) 
Seat 4: 52uIvr1a/mxEYD1W0ESvdQ ($25.70 in chips) 
Seat 5: SpiiQQAzy4MUgV3I5W8giw ($21.50 in chips) 
Seat 7: zDrucyjVn5aeekNEc3cJrA ($16.25 in chips) 
Seat 8: qwr38jl5txoR36M7G5qi4A ($10 in chips) 
Seat 9: V6p0jQ/RhUsqpHLmXvEX4Q ($11.15 in chips) 
Bb42QRQMhg5/Y0vHP8/2Xw: posts small blind $0.10
oLa/tXLfSLLB28mcLGrxcg: posts big blind $0.25
RCqMONFrSPSArZh2Jsar/w: sits out 
*** HOLE CARDS ***
52uIvr1a/mxEYD1W0ESvdQ: folds 
SpiiQQAzy4MUgV3I5W8giw: folds 
zDrucyjVn5aeekNEc3cJrA: folds 
zDrucyjVn5aeekNEc3cJrA is sitting out
qwr38jl5txoR36M7G5qi4A: raises $0.75 to $1
V6p0jQ/RhUsqpHLmXvEX4Q: folds 
56S3mA6Zs3pGR+0p0vUCtg: folds 
Bb42QRQMhg5/Y0vHP8/2Xw: folds 
oLa/tXLfSLLB28mcLGrxcg: folds 
Uncalled bet ($0.75) returned to qwr38jl5txoR36M7G5qi4A
qwr38jl5txoR36M7G5qi4A collected $0.60 from pot
qwr38jl5txoR36M7G5qi4A: doesn't show hand 
*** SUMMARY ***
Total pot $0.60 | Rake $0 
Seat 1: 56S3mA6Zs3pGR+0p0vUCtg (button) folded before Flop (didn't bet)
Seat 2: Bb42QRQMhg5/Y0vHP8/2Xw (small blind) folded before Flop
Seat 3: oLa/tXLfSLLB28mcLGrxcg (big blind) folded before Flop
Seat 4: 52uIvr1a/mxEYD1W0ESvdQ folded before Flop (didn't bet)
Seat 5: SpiiQQAzy4MUgV3I5W8giw folded before Flop (didn't bet)
Seat 7: zDrucyjVn5aeekNEc3cJrA folded before Flop (didn't bet)
Seat 8: qwr38jl5txoR36M7G5qi4A collected ($0.60)
Seat 9: V6p0jQ/RhUsqpHLmXvEX4Q folded before Flop (didn't bet)




PokerStars Game #59941625584:  Hold'em No Limit ($0.10/$0.25) - 2009/07/01 1:41:07 ET
Table 'dVzscin98UhGisTmV9BDcw' 9-max Seat #5 is the button
Seat 1: sBAwXpkpgyhyWbHIQcIJKA ($17.90 in chips) 
Seat 2: dfNim92Z6XK1/h5SFW5vDg ($28.25 in chips) 
Seat 4: aNpwfA31EREwO+ar4XzBCw ($41.90 in chips) 
Seat 5: 22dIObOuor/A+IKWkNoAlA ($10.10 in chips) 
Seat 6: bXpVeaSTPBFSPJmeXxO7nw ($4.40 in chips) 
Seat 7: cKlmpQMahVsmOaxFQDcoOg ($25 in chips) 
Seat 8: /vn2Qu2dvc9AMMq46Ae0jA ($48.10 in chips) 
Seat 9: arxNSjreDRGFg13EAM2F1w ($25 in chips) 
bXpVeaSTPBFSPJmeXxO7nw: posts small blind $0.10
cKlmpQMahVsmOaxFQDcoOg: posts big blind $0.25
*** HOLE CARDS ***
/vn2Qu2dvc9AMMq46Ae0jA: folds 
arxNSjreDRGFg13EAM2F1w: folds 
sBAwXpkpgyhyWbHIQcIJKA: folds 
dfNim92Z6XK1/h5SFW5vDg: folds 
JKOHWhyNSj5IT6PzR/yHDg has returned
aNpwfA31EREwO+ar4XzBCw: raises $0.75 to $1
22dIObOuor/A+IKWkNoAlA: folds 
bXpVeaSTPBFSPJmeXxO7nw: folds 
cKlmpQMahVsmOaxFQDcoOg: folds 
Uncalled bet ($0.75) returned to aNpwfA31EREwO+ar4XzBCw
aNpwfA31EREwO+ar4XzBCw collected $0.60 from pot
aNpwfA31EREwO+ar4XzBCw: doesn't show hand 
*** SUMMARY ***
Total pot $0.60 | Rake $0 
Seat 1: sBAwXpkpgyhyWbHIQcIJKA folded before Flop (didn't bet)
Seat 2: dfNim92Z6XK1/h5SFW5vDg folded before Flop (didn't bet)
Seat 4: aNpwfA31EREwO+ar4XzBCw collected ($0.60)
Seat 5: 22dIObOuor/A+IKWkNoAlA (button) folded before Flop (didn't bet)
Seat 6: bXpVeaSTPBFSPJmeXxO7nw (small blind) folded before Flop
Seat 7: cKlmpQMahVsmOaxFQDcoOg (big blind) folded before Flop
Seat 8: /vn2Qu2dvc9AMMq46Ae0jA folded before Flop (didn't bet)
Seat 9: arxNSjreDRGFg13EAM2F1w folded before Flop (didn't bet)




PokerStars Game #59941626034:  Hold'em No Limit ($0.10/$0.25) - 2009/07/01 1:41:07 ET
Table 'z2yOdY2zyGWG1gh9WV9XtQ' 9-max Seat #8 is the button
Seat 1: 7je+LC5Mfs6nL8YBVh4frQ ($5 in chips) 
Seat 2: bXpVeaSTPBFSPJmeXxO7nw ($5 in chips) 
Seat 3: X78b5v/uhqeXXoAijbw/yg ($27.75 in chips) 
Seat 4: 4awUyiDYTgylQKXZ9faBVA ($39.45 in chips) 
Seat 5: W6tExOcYX7qiy6Qdp+ZwFA ($10.55 in chips) 
Seat 6: NBYmTySMtIicyMj5Vjzqhw ($21.80 in chips) 
Seat 8: Mh2r9hTeTEDnh19sRZtW3g ($7.15 in chips) 
Seat 9: wGigCmBR/9XWkPpvYos3aQ ($34.15 in chips) 
wGigCmBR/9XWkPpvYos3aQ: posts small blind $0.10
7je+LC5Mfs6nL8YBVh4frQ: posts big blind $0.25
*** HOLE CARDS ***
bXpVeaSTPBFSPJmeXxO7nw: folds 
X78b5v/uhqeXXoAijbw/yg: folds 
4awUyiDYTgylQKXZ9faBVA: raises $0.75 to $1
W6tExOcYX7qiy6Qdp+ZwFA: folds 
NBYmTySMtIicyMj5Vjzqhw: folds 
Mh2r9hTeTEDnh19sRZtW3g: folds 
wGigCmBR/9XWkPpvYos3aQ: folds 
7je+LC5Mfs6nL8YBVh4frQ: folds 
Uncalled bet ($0.75) returned to 4awUyiDYTgylQKXZ9faBVA
4awUyiDYTgylQKXZ9faBVA collected $0.60 from pot
4awUyiDYTgylQKXZ9faBVA: doesn't show hand 
*** SUMMARY ***
Total pot $0.60 | Rake $0 
Seat 1: 7je+LC5Mfs6nL8YBVh4frQ (big blind) folded before Flop
Seat 2: bXpVeaSTPBFSPJmeXxO7nw folded before Flop (didn't bet)
Seat 3: X78b5v/uhqeXXoAijbw/yg folded before Flop (didn't bet)
Seat 4: 4awUyiDYTgylQKXZ9faBVA collected ($0.60)
Seat 5: W6tExOcYX7qiy6Qdp+ZwFA folded before Flop (didn't bet)
Seat 6: NBYmTySMtIicyMj5Vjzqhw folded before Flop (didn't bet)
Seat 8: Mh2r9hTeTEDnh19sRZtW3g (button) folded before Flop (didn't bet)
Seat 9: wGigCmBR/9XWkPpvYos3aQ (small blind) folded before Flop




PokerStars Game #59941625586:  Hold'em No Limit ($0.10/$0.25) - 2009/07/01 1:41:07 ET
Table 'IIO2q2znuuAXmiZ2qFTcmg' 6-max Seat #1 is the button
Seat 1: 2G0C7dp4wlPpE21FHjjElQ ($25 in chips) 
Seat 2: cS21pIxRHx5Gt42o7hPZzw ($15.30 in chips) 
Seat 3: L3/N/gliETan8N5Gim5h4Q ($25.35 in chips) 
Seat 4: tSR4329m40dZsN7YOpI9Kw ($59.60 in chips) 
cS21pIxRHx5Gt42o7hPZzw: posts small blind $0.10
L3/N/gliETan8N5Gim5h4Q: posts big blind $0.25
arewedunces: sits out 
*** HOLE CARDS ***
aogAb4Eienxztk8p2v9VVw is connected 
tSR4329m40dZsN7YOpI9Kw: folds 
aogAb4Eienxztk8p2v9VVw has returned
2G0C7dp4wlPpE21FHjjElQ: raises $0.50 to $0.75
cS21pIxRHx5Gt42o7hPZzw: calls $0.65
L3/N/gliETan8N5Gim5h4Q: calls $0.50
*** FLOP *** [Th 5d 7c]
cS21pIxRHx5Gt42o7hPZzw: checks 
L3/N/gliETan8N5Gim5h4Q: checks 
2G0C7dp4wlPpE21FHjjElQ: checks 
*** TURN *** [Th 5d 7c] [8h]
cS21pIxRHx5Gt42o7hPZzw: checks 
L3/N/gliETan8N5Gim5h4Q: bets $1.50
2G0C7dp4wlPpE21FHjjElQ: folds 
cS21pIxRHx5Gt42o7hPZzw: calls $1.50
*** RIVER *** [Th 5d 7c 8h] [2c]
cS21pIxRHx5Gt42o7hPZzw: checks 
L3/N/gliETan8N5Gim5h4Q: bets $3.75
cS21pIxRHx5Gt42o7hPZzw: raises $3.75 to $7.50
L3/N/gliETan8N5Gim5h4Q: calls $3.75
*** SHOW DOWN ***
cS21pIxRHx5Gt42o7hPZzw: shows [Td Ts] (three of a kind, Tens)
L3/N/gliETan8N5Gim5h4Q: mucks hand 
cS21pIxRHx5Gt42o7hPZzw collected $19.25 from pot
*** SUMMARY ***
Total pot $20.25 | Rake $1 
Board [Th 5d 7c 8h 2c]
Seat 1: 2G0C7dp4wlPpE21FHjjElQ (button) folded on the Turn
Seat 2: cS21pIxRHx5Gt42o7hPZzw (small blind) showed [Td Ts] and won ($19.25) with three of a kind, Tens
Seat 3: L3/N/gliETan8N5Gim5h4Q (big blind) mucked
Seat 4: tSR4329m40dZsN7YOpI9Kw folded before Flop (didn't bet)




PokerStars Game #59941626124:  Hold'em No Limit ($0.10/$0.25) - 2009/07/01 1:41:08 ET
Table 'wixGE3Zge1qBdnpWijIl/w' 9-max Seat #1 is the button
Seat 1: 4GJMmHGKzu+gVtalqRy7dA ($19.10 in chips) 
Seat 2: DnDcAdn9P0zGovMERigpFA ($41.45 in chips) 
Seat 3: Bb42QRQMhg5/Y0vHP8/2Xw ($25 in chips) 
Seat 4: 4oA316mXLIui1QY63GXBUg ($33.05 in chips) 
Seat 5: H5Se03ZqSX7tbULXur2MAg ($24.45 in chips) 
Seat 6: AP/rNvbsacTb4XtaAgKPiQ ($21.05 in chips) 
Seat 7: qIaaweMCAGmy9HZFT4r/6A ($39.90 in chips) 
Seat 8: ShCS62CJp4MKfKLKvGKQbA ($15.15 in chips) 
Seat 9: r6hsffOo1iKmaPYKwAZmFw ($28.80 in chips) 
DnDcAdn9P0zGovMERigpFA: posts small blind $0.10
Bb42QRQMhg5/Y0vHP8/2Xw: posts big blind $0.25
*** HOLE CARDS ***
4oA316mXLIui1QY63GXBUg: raises $0.75 to $1
H5Se03ZqSX7tbULXur2MAg: folds 
AP/rNvbsacTb4XtaAgKPiQ: folds 
qIaaweMCAGmy9HZFT4r/6A: calls $1
ShCS62CJp4MKfKLKvGKQbA: folds 
r6hsffOo1iKmaPYKwAZmFw: folds 
4GJMmHGKzu+gVtalqRy7dA: folds 
DnDcAdn9P0zGovMERigpFA: calls $0.90
Bb42QRQMhg5/Y0vHP8/2Xw: folds 
*** FLOP *** [Th 3s 4d]
DnDcAdn9P0zGovMERigpFA: bets $2.75
4oA316mXLIui1QY63GXBUg: folds 
qIaaweMCAGmy9HZFT4r/6A: calls $2.75
*** TURN *** [Th 3s 4d] [5h]
DnDcAdn9P0zGovMERigpFA: bets $5
qIaaweMCAGmy9HZFT4r/6A: calls $5
*** RIVER *** [Th 3s 4d 5h] [Jd]
DnDcAdn9P0zGovMERigpFA: bets $11
qIaaweMCAGmy9HZFT4r/6A: raises $11 to $22
DnDcAdn9P0zGovMERigpFA: raises $10.70 to $32.70 and is all-in
qIaaweMCAGmy9HZFT4r/6A: calls $9.15 and is all-in
Uncalled bet ($1.55) returned to DnDcAdn9P0zGovMERigpFA
*** SHOW DOWN ***
DnDcAdn9P0zGovMERigpFA: shows [Js Jh] (three of a kind, Jacks)
qIaaweMCAGmy9HZFT4r/6A: mucks hand 
DnDcAdn9P0zGovMERigpFA collected $78.05 from pot
*** SUMMARY ***
Total pot $81.05 | Rake $3 
Board [Th 3s 4d 5h Jd]
Seat 1: 4GJMmHGKzu+gVtalqRy7dA (button) folded before Flop (didn't bet)
Seat 2: DnDcAdn9P0zGovMERigpFA (small blind) showed [Js Jh] and won ($78.05) with three of a kind, Jacks
Seat 3: Bb42QRQMhg5/Y0vHP8/2Xw (big blind) folded before Flop
Seat 4: 4oA316mXLIui1QY63GXBUg folded on the Flop
Seat 5: H5Se03ZqSX7tbULXur2MAg folded before Flop (didn't bet)
Seat 6: AP/rNvbsacTb4XtaAgKPiQ folded before Flop (didn't bet)
Seat 7: qIaaweMCAGmy9HZFT4r/6A mucked
Seat 8: ShCS62CJp4MKfKLKvGKQbA folded before Flop (didn't bet)
Seat 9: r6hsffOo1iKmaPYKwAZmFw folded before Flop (didn't bet)




PokerStars Game #59941626590:  Hold'em No Limit ($0.10/$0.25) - 2009/07/01 1:41:08 ET
Table 'ThBZ355rqvsb8UGb6ajbig' 9-max Seat #6 is the button
Seat 1: cZ99hugmLBj9KhTlc8nCSw ($38.15 in chips) 
Seat 2: 4awUyiDYTgylQKXZ9faBVA ($25.95 in chips) 
Seat 3: H5Se03ZqSX7tbULXur2MAg ($27.90 in chips) 
Seat 4: zgi+EUykT/pZQpoUG6+oEg ($4.65 in chips) 
Seat 5: cKlmpQMahVsmOaxFQDcoOg ($25.35 in chips) 
Seat 6: qwr38jl5txoR36M7G5qi4A ($9.65 in chips) 
Seat 7: zUXhymECc2C9W9ZNw6qppA ($16.95 in chips) 
Seat 8: PdIasPkzm2sqZnN41ZRXOg ($5 in chips) 
Seat 9: sD+TKtt36XiiN6jqHiLwDA ($23.85 in chips) 
zUXhymECc2C9W9ZNw6qppA: posts small blind $0.10
PdIasPkzm2sqZnN41ZRXOg: posts big blind $0.25
*** HOLE CARDS ***
sD+TKtt36XiiN6jqHiLwDA: folds 
cZ99hugmLBj9KhTlc8nCSw: folds 
4awUyiDYTgylQKXZ9faBVA: folds 
H5Se03ZqSX7tbULXur2MAg: raises $0.50 to $0.75
zgi+EUykT/pZQpoUG6+oEg: folds 
cKlmpQMahVsmOaxFQDcoOg: calls $0.75
qwr38jl5txoR36M7G5qi4A: folds 
zUXhymECc2C9W9ZNw6qppA: folds 
PdIasPkzm2sqZnN41ZRXOg: calls $0.50
*** FLOP *** [4c Jh Qs]
PdIasPkzm2sqZnN41ZRXOg: checks 
H5Se03ZqSX7tbULXur2MAg: bets $1.25
cKlmpQMahVsmOaxFQDcoOg: folds 
PdIasPkzm2sqZnN41ZRXOg: folds 
Uncalled bet ($1.25) returned to H5Se03ZqSX7tbULXur2MAg
H5Se03ZqSX7tbULXur2MAg collected $2.25 from pot
*** SUMMARY ***
Total pot $2.35 | Rake $0.10 
Board [4c Jh Qs]
Seat 1: cZ99hugmLBj9KhTlc8nCSw folded before Flop (didn't bet)
Seat 2: 4awUyiDYTgylQKXZ9faBVA folded before Flop (didn't bet)
Seat 3: H5Se03ZqSX7tbULXur2MAg collected ($2.25)
Seat 4: zgi+EUykT/pZQpoUG6+oEg folded before Flop (didn't bet)
Seat 5: cKlmpQMahVsmOaxFQDcoOg folded on the Flop
Seat 6: qwr38jl5txoR36M7G5qi4A (button) folded before Flop (didn't bet)
Seat 7: zUXhymECc2C9W9ZNw6qppA (small blind) folded before Flop
Seat 8: PdIasPkzm2sqZnN41ZRXOg (big blind) folded on the Flop
Seat 9: sD+TKtt36XiiN6jqHiLwDA folded before Flop (didn't bet)




PokerStars Game #59941626212:  Hold'em No Limit ($0.10/$0.25) - 2009/07/01 1:41:08 ET
Table 'ggwTHpIC5qhhHJSYjK1XCw' 6-max Seat #3 is the button
Seat 1: MqMK8OWPSY1V4stf1Hy5Jw ($79.20 in chips) 
Seat 2: /gJNBeCkWL4o85/jvlZ4BA ($26.85 in chips) 
Seat 3: SxIIgwXYLkwd6m3wLyPTCw ($66.15 in chips) 
Seat 4: JFIAqU8lCZ0vWwEl4bdGsg ($25.10 in chips) 
Seat 5: BvqhBa7W/To51LhEiIU/lw ($5 in chips) 
Seat 6: 732E3Iz0geWMK40ej+U9HA ($15 in chips) 
JFIAqU8lCZ0vWwEl4bdGsg: posts small blind $0.10
BvqhBa7W/To51LhEiIU/lw: posts big blind $0.25
*** HOLE CARDS ***
732E3Iz0geWMK40ej+U9HA: calls $0.25
MqMK8OWPSY1V4stf1Hy5Jw: folds 
/gJNBeCkWL4o85/jvlZ4BA: folds 
SxIIgwXYLkwd6m3wLyPTCw: folds 
JFIAqU8lCZ0vWwEl4bdGsg: calls $0.15
BvqhBa7W/To51LhEiIU/lw: checks 
*** FLOP *** [2h 6h Jc]
JFIAqU8lCZ0vWwEl4bdGsg: checks 
BvqhBa7W/To51LhEiIU/lw: checks 
732E3Iz0geWMK40ej+U9HA: checks 
*** TURN *** [2h 6h Jc] [6d]
JFIAqU8lCZ0vWwEl4bdGsg: checks 
BvqhBa7W/To51LhEiIU/lw: checks 
732E3Iz0geWMK40ej+U9HA: checks 
*** RIVER *** [2h 6h Jc 6d] [2s]
JFIAqU8lCZ0vWwEl4bdGsg: checks 
BvqhBa7W/To51LhEiIU/lw: checks 
732E3Iz0geWMK40ej+U9HA: checks 
*** SHOW DOWN ***
JFIAqU8lCZ0vWwEl4bdGsg: shows [Ad 8d] (two pair, Sixes and Deuces)
BvqhBa7W/To51LhEiIU/lw: mucks hand 
732E3Iz0geWMK40ej+U9HA: mucks hand 
JFIAqU8lCZ0vWwEl4bdGsg collected $0.75 from pot
*** SUMMARY ***
Total pot $0.75 | Rake $0 
Board [2h 6h Jc 6d 2s]
Seat 1: MqMK8OWPSY1V4stf1Hy5Jw folded before Flop (didn't bet)
Seat 2: /gJNBeCkWL4o85/jvlZ4BA folded before Flop (didn't bet)
Seat 3: SxIIgwXYLkwd6m3wLyPTCw (button) folded before Flop (didn't bet)
Seat 4: JFIAqU8lCZ0vWwEl4bdGsg (small blind) showed [Ad 8d] and won ($0.75) with two pair, Sixes and Deuces
Seat 5: BvqhBa7W/To51LhEiIU/lw (big blind) mucked
Seat 6: 732E3Iz0geWMK40ej+U9HA mucked




PokerStars Game #59941626668:  Hold'em No Limit ($0.10/$0.25) - 2009/07/01 1:41:08 ET
Table 'srBTB98reCdD1TffxE6o7g' 6-max Seat #1 is the button
Seat 1: SFmT9ZsVopnukjvAzrxTRg ($33.60 in chips) 
Seat 2: mfrkWA3PTeYPkbO6hi98Aw ($21 in chips) 
Seat 3: VOmI0x4dDPnTESZd5B4d1Q ($48.20 in chips) 
Seat 4: 6DwBRH+xZ12AAZmeAg+aXw ($21.30 in chips) 
Seat 5: 8zUCJvLYLFM8AG6K5zjIvg ($12.30 in chips) 
Seat 6: BV+K0Phf5VBHr7aZPKqbUQ ($34.95 in chips) 
mfrkWA3PTeYPkbO6hi98Aw: posts small blind $0.10
VOmI0x4dDPnTESZd5B4d1Q: posts big blind $0.25
*** HOLE CARDS ***
6DwBRH+xZ12AAZmeAg+aXw: folds 
8zUCJvLYLFM8AG6K5zjIvg: folds 
BV+K0Phf5VBHr7aZPKqbUQ: folds 
SFmT9ZsVopnukjvAzrxTRg: raises $0.75 to $1
mfrkWA3PTeYPkbO6hi98Aw: folds 
VOmI0x4dDPnTESZd5B4d1Q: folds 
Uncalled bet ($0.75) returned to SFmT9ZsVopnukjvAzrxTRg
SFmT9ZsVopnukjvAzrxTRg collected $0.60 from pot
SFmT9ZsVopnukjvAzrxTRg: doesn't show hand 
*** SUMMARY ***
Total pot $0.60 | Rake $0 
Seat 1: SFmT9ZsVopnukjvAzrxTRg (button) collected ($0.60)
Seat 2: mfrkWA3PTeYPkbO6hi98Aw (small blind) folded before Flop
Seat 3: VOmI0x4dDPnTESZd5B4d1Q (big blind) folded before Flop
Seat 4: 6DwBRH+xZ12AAZmeAg+aXw folded before Flop (didn't bet)
Seat 5: 8zUCJvLYLFM8AG6K5zjIvg folded before Flop (didn't bet)
Seat 6: BV+K0Phf5VBHr7aZPKqbUQ folded before Flop (didn't bet)




PokerStars Game #59941626526:  Hold'em No Limit ($0.10/$0.25) - 2009/07/01 1:41:08 ET
Table '2clPgY3+dETPD/8zjXZdFw' 6-max Seat #1 is the button
Seat 1: 4WFKzsjLSGnvHbVxKabsvQ ($29.45 in chips) 
Seat 2: cWc85bEzdRzpUMhRKm8pwQ ($25 in chips) 
Seat 3: SFmT9ZsVopnukjvAzrxTRg ($25 in chips) 
Seat 4: ljjhtb6FVPTx9AT9HNdtqg ($18.65 in chips) 
Seat 5: LJI7A1YgDM7hgh7o56+ReQ ($25 in chips) 
Seat 6: 2G0C7dp4wlPpE21FHjjElQ ($26.90 in chips) 
cWc85bEzdRzpUMhRKm8pwQ: posts small blind $0.10
SFmT9ZsVopnukjvAzrxTRg: posts big blind $0.25
*** HOLE CARDS ***
ljjhtb6FVPTx9AT9HNdtqg: folds 
LJI7A1YgDM7hgh7o56+ReQ: folds 
2G0C7dp4wlPpE21FHjjElQ: raises $0.50 to $0.75
4WFKzsjLSGnvHbVxKabsvQ: folds 
cWc85bEzdRzpUMhRKm8pwQ: folds 
SFmT9ZsVopnukjvAzrxTRg: folds 
Uncalled bet ($0.50) returned to 2G0C7dp4wlPpE21FHjjElQ
2G0C7dp4wlPpE21FHjjElQ collected $0.60 from pot
2G0C7dp4wlPpE21FHjjElQ: doesn't show hand 
*** SUMMARY ***
Total pot $0.60 | Rake $0 
Seat 1: 4WFKzsjLSGnvHbVxKabsvQ (button) folded before Flop (didn't bet)
Seat 2: cWc85bEzdRzpUMhRKm8pwQ (small blind) folded before Flop
Seat 3: SFmT9ZsVopnukjvAzrxTRg (big blind) folded before Flop
Seat 4: ljjhtb6FVPTx9AT9HNdtqg folded before Flop (didn't bet)
Seat 5: LJI7A1YgDM7hgh7o56+ReQ folded before Flop (didn't bet)
Seat 6: 2G0C7dp4wlPpE21FHjjElQ collected ($0.60)




PokerStars Game #59941626888:  Hold'em No Limit ($0.10/$0.25) - 2009/07/01 1:41:09 ET
Table 'MRfAiS/4JSfnUDlCcZo0wAhfHe8uKeSJMyWAjSdM7ROQx Seat #1 is the button
Seat 1: 48oT5xFI+5CHUJlfoGrE4w ($31.25 in chips) 
Seat 2: /gJNBeCkWL4o85/jvlZ4BA ($29.45 in chips) 
Seat 3: FYepjhAvF8ZdVCmqHIy+eQ ($39.05 in chips) 
Seat 4: b4wRQV3APH8irVk6bUFe2Q ($28.15 in chips) 
Seat 6: L3/N/gliETan8N5Gim5h4Q ($25.35 in chips) 
/gJNBeCkWL4o85/jvlZ4BA: posts small blind $0.10
FYepjhAvF8ZdVCmqHIy+eQ: posts big blind $0.25
*** HOLE CARDS ***
b4wRQV3APH8irVk6bUFe2Q: folds 
L3/N/gliETan8N5Gim5h4Q: folds 
48oT5xFI+5CHUJlfoGrE4w: folds 
/gJNBeCkWL4o85/jvlZ4BA: folds 
Uncalled bet ($0.15) returned to FYepjhAvF8ZdVCmqHIy+eQ
FYepjhAvF8ZdVCmqHIy+eQ collected $0.20 from pot
FYepjhAvF8ZdVCmqHIy+eQ: doesn't show hand 
*** SUMMARY ***
Total pot $0.20 | Rake $0 
Seat 1: 48oT5xFI+5CHUJlfoGrE4w (button) folded before Flop (didn't bet)
Seat 2: /gJNBeCkWL4o85/jvlZ4BA (small blind) folded before Flop
Seat 3: FYepjhAvF8ZdVCmqHIy+eQ (big blind) collected ($0.20)
Seat 4: b4wRQV3APH8irVk6bUFe2Q folded before Flop (didn't bet)
Seat 6: L3/N/gliETan8N5Gim5h4Q folded before Flop (didn't bet)




PokerStars Game #59941627406:  Hold'em No Limit ($0.10/$0.25) - 2009/07/01 1:41:10 ET
Table '0XPo7K54oZIfG0xlNAcDRw' 9-max Seat #8 is the button
Seat 1: 7cv+9Zc9HIQHNvYsMfV3uA ($28.65 in chips) 
Seat 3: 6qsItdeWZoOL5be2e1RFng ($4.85 in chips) 
Seat 4: RubYqfvGrz2z+5ReNIj9QQ ($32.55 in chips) 
Seat 5: iOmwbUN7u4JFkV6VCA49aA ($25.15 in chips) 
Seat 6: 9gmYYQesalMrUjaF7nKfrQ ($12.05 in chips) 
Seat 7: tYsOBqdU1+x+yFI7zHO7hQ ($28.80 in chips) 
Seat 8: v5jnQ1gfh9nLla3kMXG7Yg ($8 in chips) 
Seat 9: CmngQmkKTp8tkl6GMRTl6w ($8.25 in chips) 
CmngQmkKTp8tkl6GMRTl6w: posts small blind $0.10
7cv+9Zc9HIQHNvYsMfV3uA: posts big blind $0.25
knif3: sits out 
*** HOLE CARDS ***
6qsItdeWZoOL5be2e1RFng: raises $0.25 to $0.50
RubYqfvGrz2z+5ReNIj9QQ: folds 
iOmwbUN7u4JFkV6VCA49aA: calls $0.50
9gmYYQesalMrUjaF7nKfrQ: folds 
tYsOBqdU1+x+yFI7zHO7hQ: folds 
v5jnQ1gfh9nLla3kMXG7Yg: folds 
CmngQmkKTp8tkl6GMRTl6w: calls $0.40
7cv+9Zc9HIQHNvYsMfV3uA: calls $0.25
*** FLOP *** [3h 5c 7h]
iOmwbUN7u4JFkV6VCA49aA said, "not talkin r u"
CmngQmkKTp8tkl6GMRTl6w: checks 
7cv+9Zc9HIQHNvYsMfV3uA: checks 
6qsItdeWZoOL5be2e1RFng: bets $1
iOmwbUN7u4JFkV6VCA49aA: folds 
CmngQmkKTp8tkl6GMRTl6w: raises $1.50 to $2.50
7cv+9Zc9HIQHNvYsMfV3uA: folds 
6qsItdeWZoOL5be2e1RFng: raises $1.85 to $4.35 and is all-in
CmngQmkKTp8tkl6GMRTl6w: calls $1.85
*** TURN *** [3h 5c 7h] [5h]
*** RIVER *** [3h 5c 7h 5h] [As]
*** SHOW DOWN ***
CmngQmkKTp8tkl6GMRTl6w: shows [7d 7s] (a full house, Sevens full of Fives)
6qsItdeWZoOL5be2e1RFng: mucks hand 
CmngQmkKTp8tkl6GMRTl6w collected $10.20 from pot
*** SUMMARY ***
Total pot $10.70 | Rake $0.50 
Board [3h 5c 7h 5h As]
Seat 1: 7cv+9Zc9HIQHNvYsMfV3uA (big blind) folded on the Flop
Seat 3: 6qsItdeWZoOL5be2e1RFng mucked
Seat 4: RubYqfvGrz2z+5ReNIj9QQ folded before Flop (didn't bet)
Seat 5: iOmwbUN7u4JFkV6VCA49aA folded on the Flop
Seat 6: 9gmYYQesalMrUjaF7nKfrQ folded before Flop (didn't bet)
Seat 7: tYsOBqdU1+x+yFI7zHO7hQ folded before Flop (didn't bet)
Seat 8: v5jnQ1gfh9nLla3kMXG7Yg (button) folded before Flop (didn't bet)
Seat 9: CmngQmkKTp8tkl6GMRTl6w (small blind) showed [7d 7s] and won ($10.20) with a full house, Sevens full of Fives




PokerStars Game #59941627562:  Hold'em No Limit ($0.10/$0.25) - 2009/07/01 1:41:10 ET
Table 'gYBWJG3hEuJg6kphY0yhMg' 9-max Seat #6 is the button
Seat 1: AcL/hxc9eT0dCr2TYk/0Dg ($16.80 in chips) 
Seat 3: wGigCmBR/9XWkPpvYos3aQ ($25.35 in chips) 
Seat 4: V6p0jQ/RhUsqpHLmXvEX4Q ($13 in chips) 
Seat 5: +sbyWwIcFp9kP0bDtMegfQ ($27.95 in chips) 
Seat 6: fI5jtRq/8R6QjoWU5AnUOQ ($7.85 in chips) 
Seat 7: EQXHDnIzAsORnIXRNtXRlA ($19.40 in chips) 
Seat 8: VCKtuATyvAq9H2JSAQxPbA ($14.95 in chips) 
Seat 9: Bb42QRQMhg5/Y0vHP8/2Xw ($25.60 in chips) 
EQXHDnIzAsORnIXRNtXRlA: posts small blind $0.10
VCKtuATyvAq9H2JSAQxPbA: posts big blind $0.25
RCqMONFrSPSArZh2Jsar/w: sits out 
*** HOLE CARDS ***
Bb42QRQMhg5/Y0vHP8/2Xw: folds 
AcL/hxc9eT0dCr2TYk/0Dg: raises $1 to $1.25
wGigCmBR/9XWkPpvYos3aQ: folds 
V6p0jQ/RhUsqpHLmXvEX4Q: folds 
+sbyWwIcFp9kP0bDtMegfQ: folds 
fI5jtRq/8R6QjoWU5AnUOQ: calls $1.25
EQXHDnIzAsORnIXRNtXRlA: folds 
VCKtuATyvAq9H2JSAQxPbA: calls $1
*** FLOP *** [Jd 3s 8c]
VCKtuATyvAq9H2JSAQxPbA: checks 
AcL/hxc9eT0dCr2TYk/0Dg: bets $2
fI5jtRq/8R6QjoWU5AnUOQ: raises $2 to $4
VCKtuATyvAq9H2JSAQxPbA: folds 
AcL/hxc9eT0dCr2TYk/0Dg: raises $2 to $6
fI5jtRq/8R6QjoWU5AnUOQ: raises $0.60 to $6.60 and is all-in
AcL/hxc9eT0dCr2TYk/0Dg: calls $0.60
*** TURN *** [Jd 3s 8c] [6c]
*** RIVER *** [Jd 3s 8c 6c] [Jh]
*** SHOW DOWN ***
AcL/hxc9eT0dCr2TYk/0Dg: shows [Ac Ks] (a pair of Jacks)
fI5jtRq/8R6QjoWU5AnUOQ: mucks hand 
AcL/hxc9eT0dCr2TYk/0Dg collected $16.25 from pot
fI5jtRq/8R6QjoWU5AnUOQ leaves the table
*** SUMMARY ***
Total pot $17.05 | Rake $0.80 
Board [Jd 3s 8c 6c Jh]
Seat 1: AcL/hxc9eT0dCr2TYk/0Dg showed [Ac Ks] and won ($16.25) with a pair of Jacks
Seat 3: wGigCmBR/9XWkPpvYos3aQ folded before Flop (didn't bet)
Seat 4: V6p0jQ/RhUsqpHLmXvEX4Q folded before Flop (didn't bet)
Seat 5: +sbyWwIcFp9kP0bDtMegfQ folded before Flop (didn't bet)
Seat 6: fI5jtRq/8R6QjoWU5AnUOQ (button) mucked
Seat 7: EQXHDnIzAsORnIXRNtXRlA (small blind) folded before Flop
Seat 8: VCKtuATyvAq9H2JSAQxPbA (big blind) folded on the Flop
Seat 9: Bb42QRQMhg5/Y0vHP8/2Xw folded before Flop (didn't bet)




PokerStars Game #59941627496:  Hold'em No Limit ($0.10/$0.25) - 2009/07/01 1:41:10 ET
Table 'VQNfcI8vTBCTvRfd3veTLQ' 6-max Seat #5 is the button
Seat 2: 79ID/ub1Pt/mDpCprVmOoA ($32.25 in chips) 
Seat 3: LtASJ9OlkqGrrUKGQlpGAw ($12.10 in chips) 
Seat 4: QIWnfLSqfMcoFfdDe5LZPg ($40.70 in chips) 
Seat 5: gX2vbKwS/8zZPENAWB7hxQ ($20.40 in chips) 
Seat 6: LJI7A1YgDM7hgh7o56+ReQ ($27.45 in chips) 
LJI7A1YgDM7hgh7o56+ReQ: posts small blind $0.10
79ID/ub1Pt/mDpCprVmOoA: posts big blind $0.25
*** HOLE CARDS ***
LtASJ9OlkqGrrUKGQlpGAw: folds 
QIWnfLSqfMcoFfdDe5LZPg: raises $0.45 to $0.70
gX2vbKwS/8zZPENAWB7hxQ: folds 
LJI7A1YgDM7hgh7o56+ReQ: folds 
79ID/ub1Pt/mDpCprVmOoA: folds 
Uncalled bet ($0.45) returned to QIWnfLSqfMcoFfdDe5LZPg
QiL+lEgEWwy21jk/ltaRLg joins the table at seat #1 
QIWnfLSqfMcoFfdDe5LZPg collected $0.60 from pot
*** SUMMARY ***
Total pot $0.60 | Rake $0 
Seat 2: 79ID/ub1Pt/mDpCprVmOoA (big blind) folded before Flop
Seat 3: LtASJ9OlkqGrrUKGQlpGAw folded before Flop (didn't bet)
Seat 4: QIWnfLSqfMcoFfdDe5LZPg collected ($0.60)
Seat 5: gX2vbKwS/8zZPENAWB7hxQ (button) folded before Flop (didn't bet)
Seat 6: LJI7A1YgDM7hgh7o56+ReQ (small blind) folded before Flop




PokerStars Game #59941627814:  Hold'em No Limit ($0.10/$0.25) - 2009/07/01 1:41:10 ET
Table 'QegsWX65l3n/K0A8XB78yg' 6-max Seat #1 is the button
Seat 1: p6adJRMXMBLr+xtQzqazIQ ($12 in chips) 
Seat 2: GC/9yVD59DUCX7hUI7gcLw ($48.95 in chips) 
Seat 3: 1lxYIAoJdZwAbzIkzWmSkw ($2 in chips) 
Seat 4: mFv3iBCtrw9XfCDRB0d46Q ($8.55 in chips) 
Seat 5: OMGl+YMGogf2JWIRfT2/Yg ($12.65 in chips) 
Seat 6: 5PWs02z65jSO5pr/M6wx/w ($4.85 in chips) 
GC/9yVD59DUCX7hUI7gcLw: posts small blind $0.10
1lxYIAoJdZwAbzIkzWmSkw: posts big blind $0.25
*** HOLE CARDS ***
mFv3iBCtrw9XfCDRB0d46Q: raises $0.25 to $0.50
OMGl+YMGogf2JWIRfT2/Yg: calls $0.50
5PWs02z65jSO5pr/M6wx/w: folds 
p6adJRMXMBLr+xtQzqazIQ: folds 
GC/9yVD59DUCX7hUI7gcLw: folds 
1lxYIAoJdZwAbzIkzWmSkw: calls $0.25
*** FLOP *** [5h 2s 7d]
1lxYIAoJdZwAbzIkzWmSkw: checks 
mFv3iBCtrw9XfCDRB0d46Q: bets $1
OMGl+YMGogf2JWIRfT2/Yg: folds 
1lxYIAoJdZwAbzIkzWmSkw: folds 
Uncalled bet ($1) returned to mFv3iBCtrw9XfCDRB0d46Q
mFv3iBCtrw9XfCDRB0d46Q collected $1.55 from pot
mFv3iBCtrw9XfCDRB0d46Q: doesn't show hand 
*** SUMMARY ***
Total pot $1.60 | Rake $0.05 
Board [5h 2s 7d]
Seat 1: p6adJRMXMBLr+xtQzqazIQ (button) folded before Flop (didn't bet)
Seat 2: GC/9yVD59DUCX7hUI7gcLw (small blind) folded before Flop
Seat 3: 1lxYIAoJdZwAbzIkzWmSkw (big blind) folded on the Flop
Seat 4: mFv3iBCtrw9XfCDRB0d46Q collected ($1.55)
Seat 5: OMGl+YMGogf2JWIRfT2/Yg folded on the Flop
Seat 6: 5PWs02z65jSO5pr/M6wx/w folded before Flop (didn't bet)




PokerStars Game #59941627410:  Hold'em No Limit ($0.10/$0.25) - 2009/07/01 1:41:10 ET
Table 'tq5CvS0RUqGkuBK0XTzqqg' 6-max Seat #1 is the button
Seat 1: +ZlnqPoP3Hg4BIUxDfKd/A ($31.20 in chips) 
Seat 2: 2m6ZFAdj01UZd4WtEySXXQ ($7.25 in chips) 
Seat 3: PbMzPZIePKifKQZfKDkbIw ($47 in chips) 
Seat 4: UT5XpwOH1ipkOF7n1MqDJA ($25 in chips) 
Seat 5: qGHGf/553gQnDoklMRe3tg ($32.30 in chips) 
Seat 6: L3/N/gliETan8N5Gim5h4Q ($25 in chips) 
2m6ZFAdj01UZd4WtEySXXQ: posts small blind $0.10
PbMzPZIePKifKQZfKDkbIw: posts big blind $0.25
*** HOLE CARDS ***
UT5XpwOH1ipkOF7n1MqDJA: folds 
qGHGf/553gQnDoklMRe3tg: folds 
L3/N/gliETan8N5Gim5h4Q: folds 
+ZlnqPoP3Hg4BIUxDfKd/A: folds 
2m6ZFAdj01UZd4WtEySXXQ: calls $0.15
PbMzPZIePKifKQZfKDkbIw: checks 
*** FLOP *** [7d 5s Ks]
2m6ZFAdj01UZd4WtEySXXQ: checks 
PbMzPZIePKifKQZfKDkbIw: checks 
*** TURN *** [7d 5s Ks] [Ah]
2m6ZFAdj01UZd4WtEySXXQ: bets $0.50
PbMzPZIePKifKQZfKDkbIw: calls $0.50
*** RIVER *** [7d 5s Ks Ah] [7h]
2m6ZFAdj01UZd4WtEySXXQ: bets $1
PbMzPZIePKifKQZfKDkbIw: calls $1
*** SHOW DOWN ***
2m6ZFAdj01UZd4WtEySXXQ: shows [Qc 4c] (a pair of Sevens)
PbMzPZIePKifKQZfKDkbIw: shows [Ac Td] (two pair, Aces and Sevens)
PbMzPZIePKifKQZfKDkbIw collected $3.35 from pot
*** SUMMARY ***
Total pot $3.50 | Rake $0.15 
Board [7d 5s Ks Ah 7h]
Seat 1: +ZlnqPoP3Hg4BIUxDfKd/A (button) folded before Flop (didn't bet)
Seat 2: 2m6ZFAdj01UZd4WtEySXXQ (small blind) showed [Qc 4c] and lost with a pair of Sevens
Seat 3: PbMzPZIePKifKQZfKDkbIw (big blind) showed [Ac Td] and won ($3.35) with two pair, Aces and Sevens
Seat 4: UT5XpwOH1ipkOF7n1MqDJA folded before Flop (didn't bet)
Seat 5: qGHGf/553gQnDoklMRe3tg folded before Flop (didn't bet)
Seat 6: L3/N/gliETan8N5Gim5h4Q folded before Flop (didn't bet)




PokerStars Game #59941627620:  Hold'em No Limit ($0.10/$0.25) - 2009/07/01 1:41:10 ET
Table 'SHi8+hK6i7E2dJ/3Agbyig' 6-max Seat #3 is the button
Seat 1: gPEN9Zp33YTm/mu9/SYP1w ($30.70 in chips) 
Seat 2: LJI7A1YgDM7hgh7o56+ReQ ($28.80 in chips) 
Seat 3: P1Z7LWu+VU+WmJsI4mr0wA ($25 in chips) 
Seat 4: u0ikXOhAPSCLmg+l17oGRw ($9.45 in chips) 
Seat 5: v8m8XHovI5tqEA9mvplDSw ($53.80 in chips) 
Seat 6: cWc85bEzdRzpUMhRKm8pwQ ($25.35 in chips) 
u0ikXOhAPSCLmg+l17oGRw: posts small blind $0.10
v8m8XHovI5tqEA9mvplDSw: posts big blind $0.25
*** HOLE CARDS ***
cWc85bEzdRzpUMhRKm8pwQ: raises $0.75 to $1
gPEN9Zp33YTm/mu9/SYP1w: folds 
LJI7A1YgDM7hgh7o56+ReQ: folds 
P1Z7LWu+VU+WmJsI4mr0wA: folds 
u0ikXOhAPSCLmg+l17oGRw: calls $0.90
v8m8XHovI5tqEA9mvplDSw: folds 
*** FLOP *** [Th Ad 5d]
u0ikXOhAPSCLmg+l17oGRw: bets $3.50
cWc85bEzdRzpUMhRKm8pwQ: folds 
Uncalled bet ($3.50) returned to u0ikXOhAPSCLmg+l17oGRw
u0ikXOhAPSCLmg+l17oGRw collected $2.15 from pot
*** SUMMARY ***
Total pot $2.25 | Rake $0.10 
Board [Th Ad 5d]
Seat 1: gPEN9Zp33YTm/mu9/SYP1w folded before Flop (didn't bet)
Seat 2: LJI7A1YgDM7hgh7o56+ReQ folded before Flop (didn't bet)
Seat 3: P1Z7LWu+VU+WmJsI4mr0wA (button) folded before Flop (didn't bet)
Seat 4: u0ikXOhAPSCLmg+l17oGRw (small blind) collected ($2.15)
Seat 5: v8m8XHovI5tqEA9mvplDSw (big blind) folded before Flop
Seat 6: cWc85bEzdRzpUMhRKm8pwQ folded on the Flop




PokerStars Game #59941627446:  Hold'em No Limit ($0.10/$0.25) - 2009/07/01 1:41:10 ET
Table 'sSe6q4YTb/iS19t2eCFdsA' 9-max Seat #6 is the button
Seat 1: hJ4uYjNmSZdjrKA8cjZqCA ($18.10 in chips) 
Seat 3: bXpVeaSTPBFSPJmeXxO7nw ($5.65 in chips) 
Seat 4: 22dIObOuor/A+IKWkNoAlA ($8.85 in chips) 
Seat 5: qS+jfnNoG75bT+uQ8CKhQA ($11.05 in chips) 
Seat 6: tYsOBqdU1+x+yFI7zHO7hQ ($28 in chips) 
Seat 7: t70KGeRtR3naHSqKDixsUg ($4.25 in chips) 
Seat 8: hvXZ0zFPZFP8Hf6dS36YEw ($14.40 in chips) 
t70KGeRtR3naHSqKDixsUg: posts small blind $0.10
hvXZ0zFPZFP8Hf6dS36YEw: posts big blind $0.25
DigiSlarks: sits out 
*** HOLE CARDS ***
hJ4uYjNmSZdjrKA8cjZqCA: calls $0.25
bXpVeaSTPBFSPJmeXxO7nw: folds 
22dIObOuor/A+IKWkNoAlA: folds 
qS+jfnNoG75bT+uQ8CKhQA: calls $0.25
tYsOBqdU1+x+yFI7zHO7hQ: folds 
t70KGeRtR3naHSqKDixsUg: calls $0.15
hvXZ0zFPZFP8Hf6dS36YEw: checks 
*** FLOP *** [3c As 6s]
t70KGeRtR3naHSqKDixsUg: checks 
hvXZ0zFPZFP8Hf6dS36YEw: checks 
hJ4uYjNmSZdjrKA8cjZqCA: checks 
Nyktophobie joins the table at seat #2 
qS+jfnNoG75bT+uQ8CKhQA: bets $0.75
t70KGeRtR3naHSqKDixsUg: folds 
hvXZ0zFPZFP8Hf6dS36YEw: folds 
hJ4uYjNmSZdjrKA8cjZqCA: calls $0.75
*** TURN *** [3c As 6s] [6d]
hJ4uYjNmSZdjrKA8cjZqCA: checks 
qS+jfnNoG75bT+uQ8CKhQA: checks 
*** RIVER *** [3c As 6s 6d] [7h]
hJ4uYjNmSZdjrKA8cjZqCA: bets $1.50
qS+jfnNoG75bT+uQ8CKhQA: folds 
Uncalled bet ($1.50) returned to hJ4uYjNmSZdjrKA8cjZqCA
hJ4uYjNmSZdjrKA8cjZqCA collected $2.40 from pot
*** SUMMARY ***
Total pot $2.50 | Rake $0.10 
Board [3c As 6s 6d 7h]
Seat 1: hJ4uYjNmSZdjrKA8cjZqCA collected ($2.40)
Seat 3: bXpVeaSTPBFSPJmeXxO7nw folded before Flop (didn't bet)
Seat 4: 22dIObOuor/A+IKWkNoAlA folded before Flop (didn't bet)
Seat 5: qS+jfnNoG75bT+uQ8CKhQA folded on the River
Seat 6: tYsOBqdU1+x+yFI7zHO7hQ (button) folded before Flop (didn't bet)
Seat 7: t70KGeRtR3naHSqKDixsUg (small blind) folded on the Flop
Seat 8: hvXZ0zFPZFP8Hf6dS36YEw (big blind) folded on the Flop




PokerStars Game #59941628156:  Hold'em No Limit ($0.10/$0.25) - 2009/07/01 1:41:11 ET
Table 'Loy/olZ5qoDOSvX4UTujGg' 6-max Seat #1 is the button
Seat 1: HipgaJhkN4ie/tTw4dK3Ug ($12.30 in chips) 
Seat 2: 4z7mPbMLNp4TezHXin63Vw ($17.90 in chips) 
Seat 3: 32YL2ZEp8NT4JB2RVM9euQ ($15.70 in chips) 
Seat 4: /gJNBeCkWL4o85/jvlZ4BA ($29.65 in chips) 
Seat 5: tSR4329m40dZsN7YOpI9Kw ($28.70 in chips) 
Seat 6: qGHGf/553gQnDoklMRe3tg ($24.60 in chips) 
4z7mPbMLNp4TezHXin63Vw: posts small blind $0.10
32YL2ZEp8NT4JB2RVM9euQ: posts big blind $0.25
*** HOLE CARDS ***
/gJNBeCkWL4o85/jvlZ4BA: folds 
tSR4329m40dZsN7YOpI9Kw: folds 
qGHGf/553gQnDoklMRe3tg: folds 
HipgaJhkN4ie/tTw4dK3Ug: folds 
4z7mPbMLNp4TezHXin63Vw: folds 
Uncalled bet ($0.15) returned to 32YL2ZEp8NT4JB2RVM9euQ
32YL2ZEp8NT4JB2RVM9euQ collected $0.20 from pot
32YL2ZEp8NT4JB2RVM9euQ: doesn't show hand 
*** SUMMARY ***
Total pot $0.20 | Rake $0 
Seat 1: HipgaJhkN4ie/tTw4dK3Ug (button) folded before Flop (didn't bet)
Seat 2: 4z7mPbMLNp4TezHXin63Vw (small blind) folded before Flop
Seat 3: 32YL2ZEp8NT4JB2RVM9euQ (big blind) collected ($0.20)
Seat 4: /gJNBeCkWL4o85/jvlZ4BA folded before Flop (didn't bet)
Seat 5: tSR4329m40dZsN7YOpI9Kw folded before Flop (didn't bet)
Seat 6: qGHGf/553gQnDoklMRe3tg folded before Flop (didn't bet)




PokerStars Game #59941628260:  Hold'em No Limit ($0.10/$0.25) - 2009/07/01 1:41:11 ET
Table 'WEMI3Mtn7dGARDbgNrKibgQvLFJzpzymuOsaaRYi+8fgx Seat #4 is the button
Seat 2: PdIasPkzm2sqZnN41ZRXOg ($5 in chips) 
Seat 4: tLcDklc2rBORNfixyRfVfw ($25.25 in chips) 
Seat 5: MG90wfSJZnOejs/KD3vlQQ ($36.85 in chips) 
Seat 7: rQhYIYXSyH/IivYM1dlV5A ($11.95 in chips) 
Seat 8: gehe91e0IyVT0QU/XBkEyg ($25.25 in chips) 
Seat 9: BWzInv8o0kN1pJybv/VjpQ ($44.60 in chips) 
MG90wfSJZnOejs/KD3vlQQ: posts small blind $0.10
1S/fpm+f42V/6MNZre+ccg: is sitting out 
rQhYIYXSyH/IivYM1dlV5A: posts big blind $0.25
cZ99hugmLBj9KhTlc8nCSw: sits out 
Dr.Hibbert55: sits out 
*** HOLE CARDS ***
gehe91e0IyVT0QU/XBkEyg: folds 
BWzInv8o0kN1pJybv/VjpQ: folds 
PdIasPkzm2sqZnN41ZRXOg: folds 
tLcDklc2rBORNfixyRfVfw: folds 
MG90wfSJZnOejs/KD3vlQQ: folds 
Uncalled bet ($0.15) returned to rQhYIYXSyH/IivYM1dlV5A
rQhYIYXSyH/IivYM1dlV5A collected $0.20 from pot
*** SUMMARY ***
Total pot $0.20 | Rake $0 
Seat 2: PdIasPkzm2sqZnN41ZRXOg folded before Flop (didn't bet)
Seat 4: tLcDklc2rBORNfixyRfVfw (button) folded before Flop (didn't bet)
Seat 5: MG90wfSJZnOejs/KD3vlQQ (small blind) folded before Flop
Seat 7: rQhYIYXSyH/IivYM1dlV5A (big blind) collected ($0.20)
Seat 8: gehe91e0IyVT0QU/XBkEyg folded before Flop (didn't bet)
Seat 9: BWzInv8o0kN1pJybv/VjpQ folded before Flop (didn't bet)




PokerStars Game #59941628022:  Hold'em No Limit ($0.10/$0.25) - 2009/07/01 1:41:11 ET
Table 'Ok3oDLIsTc2+KxPcI0bAOA' 6-max Seat #3 is the button
Seat 1: agQm3ugZ3qSVYNgNu1ddeA ($42.10 in chips) 
Seat 3: lquriepNQBhDV5P1SWHhnA ($26.25 in chips) 
Seat 4: LJI7A1YgDM7hgh7o56+ReQ ($38.25 in chips) 
Seat 5: DFi/Lzkjsfv8QswS80JX9Q ($28.60 in chips) 
Seat 6: Hsvkc0/G2VV78oVmWYXecw ($5.30 in chips) 
LJI7A1YgDM7hgh7o56+ReQ: posts small blind $0.10
DFi/Lzkjsfv8QswS80JX9Q: posts big blind $0.25
*** HOLE CARDS ***
Hsvkc0/G2VV78oVmWYXecw: folds 
agQm3ugZ3qSVYNgNu1ddeA: folds 
lquriepNQBhDV5P1SWHhnA: raises $0.50 to $0.75
wPSNSp4HYtytRMXTu3oPSQ joins the table at seat #2 
LJI7A1YgDM7hgh7o56+ReQ: folds 
DFi/Lzkjsfv8QswS80JX9Q: folds 
Uncalled bet ($0.50) returned to lquriepNQBhDV5P1SWHhnA
lquriepNQBhDV5P1SWHhnA collected $0.60 from pot
lquriepNQBhDV5P1SWHhnA: doesn't show hand 
*** SUMMARY ***
Total pot $0.60 | Rake $0 
Seat 1: agQm3ugZ3qSVYNgNu1ddeA folded before Flop (didn't bet)
Seat 3: lquriepNQBhDV5P1SWHhnA (button) collected ($0.60)
Seat 4: LJI7A1YgDM7hgh7o56+ReQ (small blind) folded before Flop
Seat 5: DFi/Lzkjsfv8QswS80JX9Q (big blind) folded before Flop
Seat 6: Hsvkc0/G2VV78oVmWYXecw folded before Flop (didn't bet)




PokerStars Game #59941628360:  Hold'em No Limit ($0.10/$0.25) - 2009/07/01 1:41:11 ET
Table 'hfHe8uKeSJMyWAjSdM7ROQ' 6-max Seat #1 is the button
Seat 1: eHsmIvAb2JREg4O6hNPnXg ($25 in chips) 
Seat 2: QvTX2yGq3uKJiKPmns4TKQ ($26.95 in chips) 
Seat 3: oAzQdB2jFOH1NxFUPjYUGg ($28.15 in chips) 
Seat 5: euswrBD1XG0Q5hB1iGJBKQ ($64.10 in chips) 
Seat 6: MTQON5nWq0PsufZ7u/4rMA ($17.25 in chips) 
QvTX2yGq3uKJiKPmns4TKQ: posts small blind $0.10
oAzQdB2jFOH1NxFUPjYUGg: posts big blind $0.25
b4wRQV3APH8irVk6bUFe2Q: sits out 
*** HOLE CARDS ***
euswrBD1XG0Q5hB1iGJBKQ: raises $0.50 to $0.75
MTQON5nWq0PsufZ7u/4rMA: folds 
eHsmIvAb2JREg4O6hNPnXg: folds 
QvTX2yGq3uKJiKPmns4TKQ: calls $0.65
oAzQdB2jFOH1NxFUPjYUGg: calls $0.50
*** FLOP *** [Qs 9c 7h]
QvTX2yGq3uKJiKPmns4TKQ: bets $0.75
oAzQdB2jFOH1NxFUPjYUGg: folds 
euswrBD1XG0Q5hB1iGJBKQ: calls $0.75
*** TURN *** [Qs 9c 7h] [2d]
QvTX2yGq3uKJiKPmns4TKQ: bets $0.75
euswrBD1XG0Q5hB1iGJBKQ: calls $0.75
*** RIVER *** [Qs 9c 7h 2d] [Ks]
QvTX2yGq3uKJiKPmns4TKQ: bets $0.75
euswrBD1XG0Q5hB1iGJBKQ: calls $0.75
*** SHOW DOWN ***
QvTX2yGq3uKJiKPmns4TKQ: shows [9h As] (a pair of Nines)
euswrBD1XG0Q5hB1iGJBKQ: mucks hand 
QvTX2yGq3uKJiKPmns4TKQ collected $6.45 from pot
*** SUMMARY ***
Total pot $6.75 | Rake $0.30 
Board [Qs 9c 7h 2d Ks]
Seat 1: eHsmIvAb2JREg4O6hNPnXg (button) folded before Flop (didn't bet)
Seat 2: QvTX2yGq3uKJiKPmns4TKQ (small blind) showed [9h As] and won ($6.45) with a pair of Nines
Seat 3: oAzQdB2jFOH1NxFUPjYUGg (big blind) folded on the Flop
Seat 5: euswrBD1XG0Q5hB1iGJBKQ mucked
Seat 6: MTQON5nWq0PsufZ7u/4rMA folded before Flop (didn't bet)




PokerStars Game #59941627972:  Hold'em No Limit ($0.10/$0.25) - 2009/07/01 1:41:11 ET
Table 'LwnjzXstPtSrqrV/oDpnXQ' 9-max Seat #6 is the button
Seat 1: 9YN2IkT2JYYKFErZtZvCtA ($26.30 in chips) 
Seat 2: uLP/lYn7oKq9xCChBXsXxw ($27 in chips) 
Seat 3: 7je+LC5Mfs6nL8YBVh4frQ ($4.30 in chips) 
Seat 4: CmngQmkKTp8tkl6GMRTl6w ($9.60 in chips) 
Seat 5: Th3FldXKQW6hWVVPahaoOQ ($25 in chips) 
Seat 6: ljemhp25Zg+nlA9DLCIiUw ($41.10 in chips) 
Seat 7: c/Dw/6HyqldTzIRodAIZmg ($12.90 in chips) 
Seat 8: ShXPHWfjhfmAwLgDdm6bRQ ($6 in chips) 
Seat 9: q6WfTUAD9mowIP63ASq2Dgz/khFDKGihQjwgoiKKPOeg45 in chips) 
c/Dw/6HyqldTzIRodAIZmg: posts small blind $0.10
ShXPHWfjhfmAwLgDdm6bRQ: posts big blind $0.25
*** HOLE CARDS ***
q6WfTUAD9mowIP63ASq2Dgz/khFDKGihQjwgoiKKPOeges $0.25 to $0.50
9YN2IkT2JYYKFErZtZvCtA: calls $0.50
uLP/lYn7oKq9xCChBXsXxw: folds 
7je+LC5Mfs6nL8YBVh4frQ: folds 
CmngQmkKTp8tkl6GMRTl6w: folds 
Th3FldXKQW6hWVVPahaoOQ: folds 
ljemhp25Zg+nlA9DLCIiUw: calls $0.50
c/Dw/6HyqldTzIRodAIZmg: folds 
ShXPHWfjhfmAwLgDdm6bRQ: calls $0.25
*** FLOP *** [Ac 5s 3h]
ShXPHWfjhfmAwLgDdm6bRQ: checks 
q6WfTUAD9mowIP63ASq2Dgz/khFDKGihQjwgoiKKPOegks 
9YN2IkT2JYYKFErZtZvCtA: bets $1
ljemhp25Zg+nlA9DLCIiUw: folds 
ShXPHWfjhfmAwLgDdm6bRQ: raises $4.50 to $5.50 and is all-in
q6WfTUAD9mowIP63ASq2Dgz/khFDKGihQjwgoiKKPOegs 
9YN2IkT2JYYKFErZtZvCtA: calls $4.50
*** TURN *** [Ac 5s 3h] [7h]
*** RIVER *** [Ac 5s 3h 7h] [8h]
*** SHOW DOWN ***
ShXPHWfjhfmAwLgDdm6bRQ: shows [8c Ah] (two pair, Aces and Eights)
9YN2IkT2JYYKFErZtZvCtA: mucks hand 
ShXPHWfjhfmAwLgDdm6bRQ collected $12.45 from pot
*** SUMMARY ***
Total pot $13.10 | Rake $0.65 
Board [Ac 5s 3h 7h 8h]
Seat 1: 9YN2IkT2JYYKFErZtZvCtA mucked
Seat 2: uLP/lYn7oKq9xCChBXsXxw folded before Flop (didn't bet)
Seat 3: 7je+LC5Mfs6nL8YBVh4frQ folded before Flop (didn't bet)
Seat 4: CmngQmkKTp8tkl6GMRTl6w folded before Flop (didn't bet)
Seat 5: Th3FldXKQW6hWVVPahaoOQ folded before Flop (didn't bet)
Seat 6: ljemhp25Zg+nlA9DLCIiUw (button) folded on the Flop
Seat 7: c/Dw/6HyqldTzIRodAIZmg (small blind) folded before Flop
Seat 8: ShXPHWfjhfmAwLgDdm6bRQ (big blind) showed [8c Ah] and won ($12.45) with two pair, Aces and Eights
Seat 9: q6WfTUAD9mowIP63ASq2Dgz/khFDKGihQjwgoiKKPOegd on the Flop




PokerStars Game #59941628368:  Hold'em No Limit ($0.10/$0.25) - 2009/07/01 1:41:11 ET
Table 'fRxOyfaHXkWUDLv4eSxFew' 9-max Seat #3 is the button
Seat 1: 6RiVTYll/5D8zICp0MRpKw ($29.40 in chips) 
Seat 2: M2QO2DxB5Wawg2h8HSpnYA ($10 in chips) 
Seat 3: j4q3p0lesp63b1gZDwLBZw ($5 in chips) 
Seat 4: MtVtHDqIJTyUcXkRBBDIVA ($26.50 in chips) 
Seat 5: dmYlc+1cjwZMJ7wV+Z0rRg ($23.10 in chips) 
Seat 6: arxNSjreDRGFg13EAM2F1w ($27.40 in chips) 
Seat 7: 1/DuWziR8CXhWB71aPQd9Q ($18.40 in chips) 
Seat 8: 5n7e7I+px7c6CQmLpPbtsg ($4.65 in chips) 
Seat 9: H5Se03ZqSX7tbULXur2MAg ($33 in chips) 
MtVtHDqIJTyUcXkRBBDIVA: posts small blind $0.10
dmYlc+1cjwZMJ7wV+Z0rRg: posts big blind $0.25
*** HOLE CARDS ***
arxNSjreDRGFg13EAM2F1w: folds 
1/DuWziR8CXhWB71aPQd9Q: calls $0.25
5n7e7I+px7c6CQmLpPbtsg: folds 
H5Se03ZqSX7tbULXur2MAg: folds 
6RiVTYll/5D8zICp0MRpKw: calls $0.25
M2QO2DxB5Wawg2h8HSpnYA: folds 
j4q3p0lesp63b1gZDwLBZw: folds 
MtVtHDqIJTyUcXkRBBDIVA: raises $2.50 to $2.75
dmYlc+1cjwZMJ7wV+Z0rRg: folds 
1/DuWziR8CXhWB71aPQd9Q: folds 
6RiVTYll/5D8zICp0MRpKw: folds 
Uncalled bet ($2.50) returned to MtVtHDqIJTyUcXkRBBDIVA
MtVtHDqIJTyUcXkRBBDIVA collected $1 from pot
MtVtHDqIJTyUcXkRBBDIVA: doesn't show hand 
*** SUMMARY ***
Total pot $1 | Rake $0 
Seat 1: 6RiVTYll/5D8zICp0MRpKw folded before Flop
Seat 2: M2QO2DxB5Wawg2h8HSpnYA folded before Flop (didn't bet)
Seat 3: j4q3p0lesp63b1gZDwLBZw (button) folded before Flop (didn't bet)
Seat 4: MtVtHDqIJTyUcXkRBBDIVA (small blind) collected ($1)
Seat 5: dmYlc+1cjwZMJ7wV+Z0rRg (big blind) folded before Flop
Seat 6: arxNSjreDRGFg13EAM2F1w folded before Flop (didn't bet)
Seat 7: 1/DuWziR8CXhWB71aPQd9Q folded before Flop
Seat 8: 5n7e7I+px7c6CQmLpPbtsg folded before Flop (didn't bet)
Seat 9: H5Se03ZqSX7tbULXur2MAg folded before Flop (didn't bet)




PokerStars Game #59941628728:  Hold'em No Limit ($0.10/$0.25) - 2009/07/01 1:41:12 ET
Table 'ouLhepGYovxB2x0QxH7cVg' 9-max Seat #8 is the button
Seat 1: ghNKXUBl/H+t83JF079ZBA ($25.35 in chips) 
Seat 2: r1Z5m4PwSI5ANp7qCE1OJw ($19 in chips) 
Seat 3: bXpVeaSTPBFSPJmeXxO7nw ($5.60 in chips) 
Seat 4: a0Sx6GHY7ln2Ns2C97eXeA ($38.30 in chips) 
Seat 5: LxRIJ6NkqjCD5zmzlF+y4w ($14.45 in chips) 
Seat 6: lSeLm4BdnSMLtIli62qjAQ ($7.50 in chips) 
Seat 7: JRV2PblFtPFz51l0Fwyz8g ($23.65 in chips) 
Seat 8: tLcDklc2rBORNfixyRfVfw ($25 in chips) 
Seat 9: ljemhp25Zg+nlA9DLCIiUw ($24.75 in chips) 
ljemhp25Zg+nlA9DLCIiUw: posts small blind $0.10
ghNKXUBl/H+t83JF079ZBA: posts big blind $0.25
*** HOLE CARDS ***
r1Z5m4PwSI5ANp7qCE1OJw: folds 
bXpVeaSTPBFSPJmeXxO7nw: folds 
a0Sx6GHY7ln2Ns2C97eXeA: folds 
LxRIJ6NkqjCD5zmzlF+y4w: folds 
lSeLm4BdnSMLtIli62qjAQ: folds 
JRV2PblFtPFz51l0Fwyz8g: folds 
tLcDklc2rBORNfixyRfVfw: folds 
ljemhp25Zg+nlA9DLCIiUw: raises $0.50 to $0.75
ghNKXUBl/H+t83JF079ZBA: folds 
Uncalled bet ($0.50) returned to ljemhp25Zg+nlA9DLCIiUw
ljemhp25Zg+nlA9DLCIiUw collected $0.50 from pot
ljemhp25Zg+nlA9DLCIiUw: doesn't show hand 
*** SUMMARY ***
Total pot $0.50 | Rake $0 
Seat 1: ghNKXUBl/H+t83JF079ZBA (big blind) folded before Flop
Seat 2: r1Z5m4PwSI5ANp7qCE1OJw folded before Flop (didn't bet)
Seat 3: bXpVeaSTPBFSPJmeXxO7nw folded before Flop (didn't bet)
Seat 4: a0Sx6GHY7ln2Ns2C97eXeA folded before Flop (didn't bet)
Seat 5: LxRIJ6NkqjCD5zmzlF+y4w folded before Flop (didn't bet)
Seat 6: lSeLm4BdnSMLtIli62qjAQ folded before Flop (didn't bet)
Seat 7: JRV2PblFtPFz51l0Fwyz8g folded before Flop (didn't bet)
Seat 8: tLcDklc2rBORNfixyRfVfw (button) folded before Flop (didn't bet)
Seat 9: ljemhp25Zg+nlA9DLCIiUw (small blind) collected ($0.50)




PokerStars Game #59941628542:  Hold'em No Limit ($0.10/$0.25) - 2009/07/01 1:41:12 ET
Table 'xro+BVoe2Zuw1TYmz/McJQ' 9-max Seat #4 is the button
Seat 1: xEQxarad8/T4jJdpZy5LGw ($10.05 in chips) 
Seat 2: vSkQm2EelzwRGDDQQk0Fqw ($4.65 in chips) 
Seat 4: N2LVj3iImgnOoHVf8g0rIw ($46.40 in chips) 
Seat 5: w48D7DZIjuBit2n4FRDJ5Q ($13.05 in chips) 
Seat 6: HPEB+AtKw1+C/cxU0o1ciw ($26.85 in chips) 
Seat 7: QEbIGci+itdw+re8RM5fZA ($31.15 in chips) 
Seat 8: ljemhp25Zg+nlA9DLCIiUw ($23 in chips) 
Seat 9: H5Se03ZqSX7tbULXur2MAg ($13.65 in chips) 
w48D7DZIjuBit2n4FRDJ5Q: posts small blind $0.10
HPEB+AtKw1+C/cxU0o1ciw: posts big blind $0.25
PdIasPkzm2sqZnN41ZRXOg: sits out 
*** HOLE CARDS ***
QEbIGci+itdw+re8RM5fZA: folds 
ljemhp25Zg+nlA9DLCIiUw: folds 
H5Se03ZqSX7tbULXur2MAg: folds 
xEQxarad8/T4jJdpZy5LGw: calls $0.25
vSkQm2EelzwRGDDQQk0Fqw: folds 
N2LVj3iImgnOoHVf8g0rIw: raises $1 to $1.25
w48D7DZIjuBit2n4FRDJ5Q: folds 
HPEB+AtKw1+C/cxU0o1ciw: folds 
xEQxarad8/T4jJdpZy5LGw: calls $1
*** FLOP *** [Kd Jc Td]
xEQxarad8/T4jJdpZy5LGw: checks 
N2LVj3iImgnOoHVf8g0rIw: bets $1.50
xEQxarad8/T4jJdpZy5LGw: folds 
Uncalled bet ($1.50) returned to N2LVj3iImgnOoHVf8g0rIw
N2LVj3iImgnOoHVf8g0rIw collected $2.75 from pot
*** SUMMARY ***
Total pot $2.85 | Rake $0.10 
Board [Kd Jc Td]
Seat 1: xEQxarad8/T4jJdpZy5LGw folded on the Flop
Seat 2: vSkQm2EelzwRGDDQQk0Fqw folded before Flop (didn't bet)
Seat 4: N2LVj3iImgnOoHVf8g0rIw (button) collected ($2.75)
Seat 5: w48D7DZIjuBit2n4FRDJ5Q (small blind) folded before Flop
Seat 6: HPEB+AtKw1+C/cxU0o1ciw (big blind) folded before Flop
Seat 7: QEbIGci+itdw+re8RM5fZA folded before Flop (didn't bet)
Seat 8: ljemhp25Zg+nlA9DLCIiUw folded before Flop (didn't bet)
Seat 9: H5Se03ZqSX7tbULXur2MAg folded before Flop (didn't bet)




PokerStars Game #59941628886:  Hold'em No Limit ($0.10/$0.25) - 2009/07/01 1:41:12 ET
Table 'O5NgMYt6EWbLBozZb3kseg' 6-max Seat #4 is the button
Seat 1: MCCWc70bl051s/EF6nHRcA ($27.15 in chips) 
Seat 2: /gJNBeCkWL4o85/jvlZ4BA ($34.50 in chips) 
Seat 3: tLM9aw7T3kBEIhQEh1roOg ($6.50 in chips) 
Seat 4: txiWmlZ/sfM8Td16RHH/cA ($3.10 in chips) 
Seat 5: vu2kzHaDtgr6NM7rdq0chA ($85.30 in chips) 
Seat 6: k9vn40MOqqb+xF+7GZ6v2g ($118.25 in chips) 
vu2kzHaDtgr6NM7rdq0chA: posts small blind $0.10
k9vn40MOqqb+xF+7GZ6v2g: posts big blind $0.25
*** HOLE CARDS ***
MCCWc70bl051s/EF6nHRcA: calls $0.25
/gJNBeCkWL4o85/jvlZ4BA: folds 
tLM9aw7T3kBEIhQEh1roOg: folds 
txiWmlZ/sfM8Td16RHH/cA: folds 
vu2kzHaDtgr6NM7rdq0chA: folds 
k9vn40MOqqb+xF+7GZ6v2g: raises $1 to $1.25
MCCWc70bl051s/EF6nHRcA: raises $1.75 to $3
k9vn40MOqqb+xF+7GZ6v2g: calls $1.75
*** FLOP *** [Jc 7d Td]
k9vn40MOqqb+xF+7GZ6v2g: checks 
MCCWc70bl051s/EF6nHRcA: bets $2.50
k9vn40MOqqb+xF+7GZ6v2g: calls $2.50
*** TURN *** [Jc 7d Td] [6h]
k9vn40MOqqb+xF+7GZ6v2g: checks 
MCCWc70bl051s/EF6nHRcA: checks 
*** RIVER *** [Jc 7d Td 6h] [6d]
k9vn40MOqqb+xF+7GZ6v2g: checks 
MCCWc70bl051s/EF6nHRcA: checks 
*** SHOW DOWN ***
k9vn40MOqqb+xF+7GZ6v2g: shows [Ac Qs] (a pair of Sixes)
MCCWc70bl051s/EF6nHRcA: shows [Tc Ad] (two pair, Tens and Sixes)
MCCWc70bl051s/EF6nHRcA collected $10.60 from pot
*** SUMMARY ***
Total pot $11.10 | Rake $0.50 
Board [Jc 7d Td 6h 6d]
Seat 1: MCCWc70bl051s/EF6nHRcA showed [Tc Ad] and won ($10.60) with two pair, Tens and Sixes
Seat 2: /gJNBeCkWL4o85/jvlZ4BA folded before Flop (didn't bet)
Seat 3: tLM9aw7T3kBEIhQEh1roOg folded before Flop (didn't bet)
Seat 4: txiWmlZ/sfM8Td16RHH/cA (button) folded before Flop (didn't bet)
Seat 5: vu2kzHaDtgr6NM7rdq0chA (small blind) folded before Flop
Seat 6: k9vn40MOqqb+xF+7GZ6v2g (big blind) showed [Ac Qs] and lost with a pair of Sixes




PokerStars Game #59941628610:  Hold'em No Limit ($0.10/$0.25) - 2009/07/01 1:41:12 ET
Table 'axb9RsG8Zj1A0LEukTeFrQ' 9-max Seat #8 is the button
Seat 1: qwr38jl5txoR36M7G5qi4A ($8.85 in chips) 
Seat 3: H5Se03ZqSX7tbULXur2MAg ($25.10 in chips) 
Seat 4: tLcDklc2rBORNfixyRfVfw ($27.45 in chips) 
Seat 5: rLSSHKOHnb6yzVfDoQM/RA ($15.10 in chips) 
Seat 7: PdIasPkzm2sqZnN41ZRXOg ($5 in chips) 
Seat 8: VBHxUExRAMrbxUq/cVx9Gw ($4.30 in chips) 
Seat 9: qbQE8CifKB4+OEvNF/61Rw ($55.95 in chips) 
qbQE8CifKB4+OEvNF/61Rw: posts small blind $0.10
qwr38jl5txoR36M7G5qi4A: posts big blind $0.25
*** HOLE CARDS ***
H5Se03ZqSX7tbULXur2MAg: raises $0.50 to $0.75
tLcDklc2rBORNfixyRfVfw: folds 
rLSSHKOHnb6yzVfDoQM/RA: folds 
PdIasPkzm2sqZnN41ZRXOg: folds 
VBHxUExRAMrbxUq/cVx9Gw: folds 
qbQE8CifKB4+OEvNF/61Rw: calls $0.65
qwr38jl5txoR36M7G5qi4A: folds 
*** FLOP *** [3s Kc Ad]
qbQE8CifKB4+OEvNF/61Rw: checks 
H5Se03ZqSX7tbULXur2MAg: checks 
*** TURN *** [3s Kc Ad] [Kh]
diablo4good joins the table at seat #6 
qbQE8CifKB4+OEvNF/61Rw: bets $0.75
H5Se03ZqSX7tbULXur2MAg: folds 
Uncalled bet ($0.75) returned to qbQE8CifKB4+OEvNF/61Rw
qbQE8CifKB4+OEvNF/61Rw collected $1.70 from pot
qbQE8CifKB4+OEvNF/61Rw: doesn't show hand 
*** SUMMARY ***
Total pot $1.75 | Rake $0.05 
Board [3s Kc Ad Kh]
Seat 1: qwr38jl5txoR36M7G5qi4A (big blind) folded before Flop
Seat 3: H5Se03ZqSX7tbULXur2MAg folded on the Turn
Seat 4: tLcDklc2rBORNfixyRfVfw folded before Flop (didn't bet)
Seat 5: rLSSHKOHnb6yzVfDoQM/RA folded before Flop (didn't bet)
Seat 7: PdIasPkzm2sqZnN41ZRXOg folded before Flop (didn't bet)
Seat 8: VBHxUExRAMrbxUq/cVx9Gw (button) folded before Flop (didn't bet)
Seat 9: qbQE8CifKB4+OEvNF/61Rw (small blind) collected ($1.70)




PokerStars Game #59941629016:  Hold'em No Limit ($0.10/$0.25) - 2009/07/01 1:41:13 ET
Table 'eOXPe2c6mG7DOFKvMsZZfA' 6-max Seat #6 is the button
Seat 1: s21kVGMLPAoHdWR+muSonw ($25.50 in chips) 
Seat 2: gaPMxLGp9SOj4Lq6t+/0Ig ($7.45 in chips) 
Seat 3: kReyZ6g6Fu3tQ0nyjDf9kA ($20.70 in chips) 
Seat 4: zHHLkD2sRljslKKeQv/ZQw ($40.25 in chips) 
Seat 5: NhUN/JpAprdJeamFBgJH1w ($32.15 in chips) 
Seat 6: Qpv/hb5ak7LeaDig1L5L8w ($15.10 in chips) 
s21kVGMLPAoHdWR+muSonw: posts small blind $0.10
gaPMxLGp9SOj4Lq6t+/0Ig: posts big blind $0.25
*** HOLE CARDS ***
kReyZ6g6Fu3tQ0nyjDf9kA: raises $0.75 to $1
zHHLkD2sRljslKKeQv/ZQw: folds 
NhUN/JpAprdJeamFBgJH1w: folds 
Qpv/hb5ak7LeaDig1L5L8w: folds 
s21kVGMLPAoHdWR+muSonw: folds 
gaPMxLGp9SOj4Lq6t+/0Ig: folds 
Uncalled bet ($0.75) returned to kReyZ6g6Fu3tQ0nyjDf9kA
kReyZ6g6Fu3tQ0nyjDf9kA collected $0.60 from pot
kReyZ6g6Fu3tQ0nyjDf9kA: doesn't show hand 
*** SUMMARY ***
Total pot $0.60 | Rake $0 
Seat 1: s21kVGMLPAoHdWR+muSonw (small blind) folded before Flop
Seat 2: gaPMxLGp9SOj4Lq6t+/0Ig (big blind) folded before Flop
Seat 3: kReyZ6g6Fu3tQ0nyjDf9kA collected ($0.60)
Seat 4: zHHLkD2sRljslKKeQv/ZQw folded before Flop (didn't bet)
Seat 5: NhUN/JpAprdJeamFBgJH1w folded before Flop (didn't bet)
Seat 6: Qpv/hb5ak7LeaDig1L5L8w (button) folded before Flop (didn't bet)




PokerStars Game #59941628942:  Hold'em No Limit ($0.10/$0.25) - 2009/07/01 1:41:13 ET
Table 'isKy4XK8wJM0x735/D4hWA' 6-max Seat #6 is the button
Seat 1: kwsRmpZ1ZaLooISs+zfyKg ($24.15 in chips) 
Seat 2: 6elpmfyt4Zw0yvd8lePSMQ ($22.45 in chips) 
Seat 3: jp34e617tIzV8tKIWmfAbA ($45 in chips) 
Seat 4: DFi/Lzkjsfv8QswS80JX9Q ($30.75 in chips) 
Seat 5: lquriepNQBhDV5P1SWHhnA ($25.60 in chips) 
Seat 6: GbCVUNssQ7mqsPWr7J4d3w ($4.65 in chips) 
kwsRmpZ1ZaLooISs+zfyKg: posts small blind $0.10
6elpmfyt4Zw0yvd8lePSMQ: posts big blind $0.25
*** HOLE CARDS ***
jp34e617tIzV8tKIWmfAbA: folds 
DFi/Lzkjsfv8QswS80JX9Q: folds 
lquriepNQBhDV5P1SWHhnA: folds 
GbCVUNssQ7mqsPWr7J4d3w: folds 
kwsRmpZ1ZaLooISs+zfyKg: raises $0.75 to $1
6elpmfyt4Zw0yvd8lePSMQ: folds 
Uncalled bet ($0.75) returned to kwsRmpZ1ZaLooISs+zfyKg
kwsRmpZ1ZaLooISs+zfyKg collected $0.50 from pot
*** SUMMARY ***
Total pot $0.50 | Rake $0 
Seat 1: kwsRmpZ1ZaLooISs+zfyKg (small blind) collected ($0.50)
Seat 2: 6elpmfyt4Zw0yvd8lePSMQ (big blind) folded before Flop
Seat 3: jp34e617tIzV8tKIWmfAbA folded before Flop (didn't bet)
Seat 4: DFi/Lzkjsfv8QswS80JX9Q folded before Flop (didn't bet)
Seat 5: lquriepNQBhDV5P1SWHhnA folded before Flop (didn't bet)
Seat 6: GbCVUNssQ7mqsPWr7J4d3w (button) folded before Flop (didn't bet)




PokerStars Game #59941629418:  Hold'em No Limit ($0.10/$0.25) - 2009/07/01 1:41:13 ET
Table 'Zi9/NqNs3XoL1eWhMCyZyg' 9-max Seat #7 is the button
Seat 2: Th3FldXKQW6hWVVPahaoOQ ($34.30 in chips) 
Seat 4: dmYlc+1cjwZMJ7wV+Z0rRg ($22.80 in chips) 
Seat 5: OiV1PWZ3IkN29JlmCcnTwQ ($4.90 in chips) 
Seat 7: 0QdZrkFD7aGKeBXPGbIomA ($6.60 in chips) 
Seat 8: nm4Dj/f+jJEwKVsUnKh73g ($37.90 in chips) 
Seat 9: tYsOBqdU1+x+yFI7zHO7hQ ($31.65 in chips) 
nm4Dj/f+jJEwKVsUnKh73g: posts small blind $0.10
tYsOBqdU1+x+yFI7zHO7hQ: posts big blind $0.25
ETC7YyRJTa2Ovhln64Ni5Q: sits out 
*** HOLE CARDS ***
Th3FldXKQW6hWVVPahaoOQ: folds 
Th3FldXKQW6hWVVPahaoOQ leaves the table
dmYlc+1cjwZMJ7wV+Z0rRg: raises $0.50 to $0.75
OiV1PWZ3IkN29JlmCcnTwQ: folds 
0QdZrkFD7aGKeBXPGbIomA: folds 
nm4Dj/f+jJEwKVsUnKh73g: folds 
tYsOBqdU1+x+yFI7zHO7hQ: folds 
Uncalled bet ($0.50) returned to dmYlc+1cjwZMJ7wV+Z0rRg
dmYlc+1cjwZMJ7wV+Z0rRg collected $0.60 from pot
dmYlc+1cjwZMJ7wV+Z0rRg: doesn't show hand 
*** SUMMARY ***
Total pot $0.60 | Rake $0 
Seat 2: Th3FldXKQW6hWVVPahaoOQ folded before Flop (didn't bet)
Seat 4: dmYlc+1cjwZMJ7wV+Z0rRg collected ($0.60)
Seat 5: OiV1PWZ3IkN29JlmCcnTwQ folded before Flop (didn't bet)
Seat 7: 0QdZrkFD7aGKeBXPGbIomA (button) folded before Flop (didn't bet)
Seat 8: nm4Dj/f+jJEwKVsUnKh73g (small blind) folded before Flop
Seat 9: tYsOBqdU1+x+yFI7zHO7hQ (big blind) folded before Flop




PokerStars Game #59941629276:  Hold'em No Limit ($0.10/$0.25) - 2009/07/01 1:41:13 ET
Table '9lYs7ljXi6AgFAxYHlKLJw' 9-max Seat #9 is the button
Seat 1: K0b5wNInj6hUGRr6yzKFtw ($34.25 in chips) 
Seat 2: 0XACOSNrAWmqNv9k1nF8rw ($15 in chips) 
Seat 3: arxNSjreDRGFg13EAM2F1w ($31.30 in chips) 
Seat 4: UANt6y/SmDCY/jIxkBixcw ($33.85 in chips) 
Seat 5: dfNim92Z6XK1/h5SFW5vDg ($52.70 in chips) 
Seat 6: tYsOBqdU1+x+yFI7zHO7hQ ($25.95 in chips) 
Seat 7: ghNKXUBl/H+t83JF079ZBA ($27.05 in chips) 
Seat 8: 9YN2IkT2JYYKFErZtZvCtA ($22.60 in chips) 
Seat 9: cKlmpQMahVsmOaxFQDcoOg ($20 in chips) 
K0b5wNInj6hUGRr6yzKFtw: posts small blind $0.10
0XACOSNrAWmqNv9k1nF8rw: posts big blind $0.25
*** HOLE CARDS ***
arxNSjreDRGFg13EAM2F1w: folds 
UANt6y/SmDCY/jIxkBixcw: folds 
dfNim92Z6XK1/h5SFW5vDg: folds 
tYsOBqdU1+x+yFI7zHO7hQ: folds 
ghNKXUBl/H+t83JF079ZBA: folds 
9YN2IkT2JYYKFErZtZvCtA: raises $0.75 to $1
cKlmpQMahVsmOaxFQDcoOg: folds 
K0b5wNInj6hUGRr6yzKFtw: folds 
0XACOSNrAWmqNv9k1nF8rw: calls $0.75
*** FLOP *** [8c Ac Jd]
0XACOSNrAWmqNv9k1nF8rw: bets $0.25
9YN2IkT2JYYKFErZtZvCtA: raises $1.25 to $1.50
0XACOSNrAWmqNv9k1nF8rw: calls $1.25
*** TURN *** [8c Ac Jd] [3s]
0XACOSNrAWmqNv9k1nF8rw: checks 
9YN2IkT2JYYKFErZtZvCtA: checks 
*** RIVER *** [8c Ac Jd 3s] [Jc]
0XACOSNrAWmqNv9k1nF8rw: bets $1
9YN2IkT2JYYKFErZtZvCtA: calls $1
*** SHOW DOWN ***
0XACOSNrAWmqNv9k1nF8rw: shows [Qs Jh] (three of a kind, Jacks)
9YN2IkT2JYYKFErZtZvCtA: mucks hand 
0XACOSNrAWmqNv9k1nF8rw collected $6.80 from pot
*** SUMMARY ***
Total pot $7.10 | Rake $0.30 
Board [8c Ac Jd 3s Jc]
Seat 1: K0b5wNInj6hUGRr6yzKFtw (small blind) folded before Flop
Seat 2: 0XACOSNrAWmqNv9k1nF8rw (big blind) showed [Qs Jh] and won ($6.80) with three of a kind, Jacks
Seat 3: arxNSjreDRGFg13EAM2F1w folded before Flop (didn't bet)
Seat 4: UANt6y/SmDCY/jIxkBixcw folded before Flop (didn't bet)
Seat 5: dfNim92Z6XK1/h5SFW5vDg folded before Flop (didn't bet)
Seat 6: tYsOBqdU1+x+yFI7zHO7hQ folded before Flop (didn't bet)
Seat 7: ghNKXUBl/H+t83JF079ZBA folded before Flop (didn't bet)
Seat 8: 9YN2IkT2JYYKFErZtZvCtA mucked
Seat 9: cKlmpQMahVsmOaxFQDcoOg (button) folded before Flop (didn't bet)




PokerStars Game #59941629452:  Hold'em No Limit ($0.10/$0.25) - 2009/07/01 1:41:14 ET
Table 'KU/HrxqxwDz8HKEhYTZ6uw' 6-max Seat #6 is the button
Seat 1: 7LKoiQHXpTQXJvWQrw907g ($29.75 in chips) 
Seat 2: kG34n23qFQA3nzdOJTQ1dA ($22.10 in chips) 
Seat 3: SFmT9ZsVopnukjvAzrxTRg ($25.80 in chips) 
Seat 4: AGwMM0FUhYZf81+oXvYQMg ($24.90 in chips) 
Seat 5: iyZxqznXjv3vtvOJymkoLQ ($51.25 in chips) 
Seat 6: qWxkCeqApAWdAA0evrfDvQ ($17.95 in chips) 
7LKoiQHXpTQXJvWQrw907g: posts small blind $0.10
kG34n23qFQA3nzdOJTQ1dA: posts big blind $0.25
*** HOLE CARDS ***
SFmT9ZsVopnukjvAzrxTRg: folds 
AGwMM0FUhYZf81+oXvYQMg: folds 
iyZxqznXjv3vtvOJymkoLQ: folds 
qWxkCeqApAWdAA0evrfDvQ: raises $0.75 to $1
7LKoiQHXpTQXJvWQrw907g: folds 
kG34n23qFQA3nzdOJTQ1dA: folds 
Uncalled bet ($0.75) returned to qWxkCeqApAWdAA0evrfDvQ
qWxkCeqApAWdAA0evrfDvQ collected $0.60 from pot
*** SUMMARY ***
Total pot $0.60 | Rake $0 
Seat 1: 7LKoiQHXpTQXJvWQrw907g (small blind) folded before Flop
Seat 2: kG34n23qFQA3nzdOJTQ1dA (big blind) folded before Flop
Seat 3: SFmT9ZsVopnukjvAzrxTRg folded before Flop (didn't bet)
Seat 4: AGwMM0FUhYZf81+oXvYQMg folded before Flop (didn't bet)
Seat 5: iyZxqznXjv3vtvOJymkoLQ folded before Flop (didn't bet)
Seat 6: qWxkCeqApAWdAA0evrfDvQ (button) collected ($0.60)




PokerStars Game #59941629514:  Hold'em No Limit ($0.10/$0.25) - 2009/07/01 1:41:14 ET
Table '7/qMNloI0nSXWiX5Y1watA' 9-max Seat #1 is the button
Seat 1: /LyhaB3V6jkgOfXORidqRQ ($7.10 in chips) 
Seat 2: wGigCmBR/9XWkPpvYos3aQ ($32.90 in chips) 
Seat 3: W2YYHvqjaEpRrO7stZkClQ ($4.70 in chips) 
Seat 6: Y3DZ6qQlLeBhixDj4M9vmg ($7.75 in chips) 
Seat 7: z5GxcHlYz/GSz6W2uFiTtg ($23.55 in chips) 
Seat 8: ljemhp25Zg+nlA9DLCIiUw ($24 in chips) 
Seat 9: dmYlc+1cjwZMJ7wV+Z0rRg ($26.50 in chips) 
wGigCmBR/9XWkPpvYos3aQ: posts small blind $0.10
W2YYHvqjaEpRrO7stZkClQ: posts big blind $0.25
*** HOLE CARDS ***
Y3DZ6qQlLeBhixDj4M9vmg: raises $0.25 to $0.50
z5GxcHlYz/GSz6W2uFiTtg: calls $0.50
ljemhp25Zg+nlA9DLCIiUw: folds 
dmYlc+1cjwZMJ7wV+Z0rRg: folds 
/LyhaB3V6jkgOfXORidqRQ: folds 
wGigCmBR/9XWkPpvYos3aQ: raises $2.50 to $3
W2YYHvqjaEpRrO7stZkClQ: folds 
Y3DZ6qQlLeBhixDj4M9vmg: calls $2.50
z5GxcHlYz/GSz6W2uFiTtg: calls $2.50
*** FLOP *** [5d 7c 6h]
wGigCmBR/9XWkPpvYos3aQ: bets $5
Y3DZ6qQlLeBhixDj4M9vmg: calls $4.75 and is all-in
z5GxcHlYz/GSz6W2uFiTtg: folds 
Uncalled bet ($0.25) returned to wGigCmBR/9XWkPpvYos3aQ
*** TURN *** [5d 7c 6h] [Jc]
*** RIVER *** [5d 7c 6h Jc] [8c]
*** SHOW DOWN ***
wGigCmBR/9XWkPpvYos3aQ: shows [Kh Ad] (high card Ace)
Y3DZ6qQlLeBhixDj4M9vmg: shows [3s 3c] (a pair of Threes)
Y3DZ6qQlLeBhixDj4M9vmg collected $17.85 from pot
*** SUMMARY ***
Total pot $18.75 | Rake $0.90 
Board [5d 7c 6h Jc 8c]
Seat 1: /LyhaB3V6jkgOfXORidqRQ (button) folded before Flop (didn't bet)
Seat 2: wGigCmBR/9XWkPpvYos3aQ (small blind) showed [Kh Ad] and lost with high card Ace
Seat 3: W2YYHvqjaEpRrO7stZkClQ (big blind) folded before Flop
Seat 6: Y3DZ6qQlLeBhixDj4M9vmg showed [3s 3c] and won ($17.85) with a pair of Threes
Seat 7: z5GxcHlYz/GSz6W2uFiTtg folded on the Flop
Seat 8: ljemhp25Zg+nlA9DLCIiUw folded before Flop (didn't bet)
Seat 9: dmYlc+1cjwZMJ7wV+Z0rRg folded before Flop (didn't bet)




PokerStars Game #59941630010:  Hold'em No Limit ($0.10/$0.25) - 2009/07/01 1:41:15 ET
Table 'l8hUTjBTXBorNUR/tyvSLw' 9-max Seat #9 is the button
Seat 1: cZ99hugmLBj9KhTlc8nCSw ($27.60 in chips) 
Seat 2: B6xHiX1SJkS0CUNCKDVwuQ ($20.90 in chips) 
Seat 4: vPtFvcPtn/Afz0sucO1cmQ ($36.10 in chips) 
Seat 6: EVqHvqty1ZsuvDFiSXlSqQ ($23.85 in chips) 
Seat 7: F7pnn6czNpHvRM55XcA2EA ($33.40 in chips) 
Seat 8: Mh2r9hTeTEDnh19sRZtW3g ($5 in chips) 
Seat 9: zDrucyjVn5aeekNEc3cJrA ($32.70 in chips) 
cZ99hugmLBj9KhTlc8nCSw: posts small blind $0.10
B6xHiX1SJkS0CUNCKDVwuQ: posts big blind $0.25
ShCS62CJp4MKfKLKvGKQbA: sits out 
yyG4svzOpC1A+sUP/scg6w: sits out 
*** HOLE CARDS ***
vPtFvcPtn/Afz0sucO1cmQ: folds 
EVqHvqty1ZsuvDFiSXlSqQ: folds 
F7pnn6czNpHvRM55XcA2EA: folds 
Mh2r9hTeTEDnh19sRZtW3g: folds 
zDrucyjVn5aeekNEc3cJrA: folds 
cZ99hugmLBj9KhTlc8nCSw: folds 
Uncalled bet ($0.15) returned to B6xHiX1SJkS0CUNCKDVwuQ
B6xHiX1SJkS0CUNCKDVwuQ collected $0.20 from pot
B6xHiX1SJkS0CUNCKDVwuQ: doesn't show hand 
*** SUMMARY ***
Total pot $0.20 | Rake $0 
Seat 1: cZ99hugmLBj9KhTlc8nCSw (small blind) folded before Flop
Seat 2: B6xHiX1SJkS0CUNCKDVwuQ (big blind) collected ($0.20)
Seat 4: vPtFvcPtn/Afz0sucO1cmQ folded before Flop (didn't bet)
Seat 6: EVqHvqty1ZsuvDFiSXlSqQ folded before Flop (didn't bet)
Seat 7: F7pnn6czNpHvRM55XcA2EA folded before Flop (didn't bet)
Seat 8: Mh2r9hTeTEDnh19sRZtW3g folded before Flop (didn't bet)
Seat 9: zDrucyjVn5aeekNEc3cJrA (button) folded before Flop (didn't bet)




PokerStars Game #59941630466:  Hold'em No Limit ($0.10/$0.25) - 2009/07/01 1:41:15 ET
Table '63h13e5p7cWe02rClZ1CHw' 6-max Seat #2 is the button
Seat 1: pokjbbEcXXPlADXdSGHtZw ($21 in chips) 
Seat 2: k9nHZTHt8hYhYRcW8NTb4g ($27.65 in chips) 
Seat 3: mFv3iBCtrw9XfCDRB0d46Q ($5.50 in chips) 
Seat 4: xrf8tAXKQHG99HixCot1Iw ($23.35 in chips) 
Seat 5: iyZxqznXjv3vtvOJymkoLQ ($45.15 in chips) 
Seat 6: mfrkWA3PTeYPkbO6hi98Aw ($38.45 in chips) 
mFv3iBCtrw9XfCDRB0d46Q: posts small blind $0.10
xrf8tAXKQHG99HixCot1Iw: posts big blind $0.25
*** HOLE CARDS ***
iyZxqznXjv3vtvOJymkoLQ: folds 
mfrkWA3PTeYPkbO6hi98Aw: folds 
pokjbbEcXXPlADXdSGHtZw: folds 
k9nHZTHt8hYhYRcW8NTb4g: folds 
mFv3iBCtrw9XfCDRB0d46Q: raises $0.25 to $0.50
xrf8tAXKQHG99HixCot1Iw: calls $0.25
*** FLOP *** [6d Kd 2h]
mFv3iBCtrw9XfCDRB0d46Q: checks 
xrf8tAXKQHG99HixCot1Iw: checks 
*** TURN *** [6d Kd 2h] [3h]
mFv3iBCtrw9XfCDRB0d46Q: checks 
xrf8tAXKQHG99HixCot1Iw: bets $0.75
mFv3iBCtrw9XfCDRB0d46Q: folds 
Uncalled bet ($0.75) returned to xrf8tAXKQHG99HixCot1Iw
xrf8tAXKQHG99HixCot1Iw collected $0.95 from pot
xrf8tAXKQHG99HixCot1Iw: doesn't show hand 
*** SUMMARY ***
Total pot $1 | Rake $0.05 
Board [6d Kd 2h 3h]
Seat 1: pokjbbEcXXPlADXdSGHtZw folded before Flop (didn't bet)
Seat 2: k9nHZTHt8hYhYRcW8NTb4g (button) folded before Flop (didn't bet)
Seat 3: mFv3iBCtrw9XfCDRB0d46Q (small blind) folded on the Turn
Seat 4: xrf8tAXKQHG99HixCot1Iw (big blind) collected ($0.95)
Seat 5: iyZxqznXjv3vtvOJymkoLQ folded before Flop (didn't bet)
Seat 6: mfrkWA3PTeYPkbO6hi98Aw folded before Flop (didn't bet)




PokerStars Game #59941630470:  Hold'em No Limit ($0.10/$0.25) - 2009/07/01 1:41:15 ET
Table 'KKk6y4pAXeymxYcd0uZLqg' 9-max Seat #6 is the button
Seat 1: HPEB+AtKw1+C/cxU0o1ciw ($24.90 in chips) 
Seat 2: k55YB7uP2TAZEba6pnHYiA ($20.45 in chips) 
Seat 4: YciNm3fUXAQaJeXG1rhrbw ($17.70 in chips) 
Seat 5: wGigCmBR/9XWkPpvYos3aQ ($32.30 in chips) 
Seat 6: QEbIGci+itdw+re8RM5fZA ($25 in chips) 
Seat 7: JjOuv8Vf56aiQjWi/rTPFA ($22.75 in chips) 
Seat 8: +2kMBNpY4nF1qNCRd8SJLA ($33.60 in chips) 
Seat 9: oLa/tXLfSLLB28mcLGrxcg ($25 in chips) 
JjOuv8Vf56aiQjWi/rTPFA: posts small blind $0.10
+2kMBNpY4nF1qNCRd8SJLA: posts big blind $0.25
tLcDklc2rBORNfixyRfVfw: sits out 
*** HOLE CARDS ***
oLa/tXLfSLLB28mcLGrxcg: folds 
HPEB+AtKw1+C/cxU0o1ciw: folds 
k55YB7uP2TAZEba6pnHYiA: folds 
YciNm3fUXAQaJeXG1rhrbw: calls $0.25
wGigCmBR/9XWkPpvYos3aQ: raises $1 to $1.25
QEbIGci+itdw+re8RM5fZA: folds 
JjOuv8Vf56aiQjWi/rTPFA: folds 
+2kMBNpY4nF1qNCRd8SJLA: folds 
YciNm3fUXAQaJeXG1rhrbw: folds 
Uncalled bet ($1) returned to wGigCmBR/9XWkPpvYos3aQ
wGigCmBR/9XWkPpvYos3aQ collected $0.85 from pot
wGigCmBR/9XWkPpvYos3aQ: doesn't show hand 
*** SUMMARY ***
Total pot $0.85 | Rake $0 
Seat 1: HPEB+AtKw1+C/cxU0o1ciw folded before Flop (didn't bet)
Seat 2: k55YB7uP2TAZEba6pnHYiA folded before Flop (didn't bet)
Seat 4: YciNm3fUXAQaJeXG1rhrbw folded before Flop
Seat 5: wGigCmBR/9XWkPpvYos3aQ collected ($0.85)
Seat 6: QEbIGci+itdw+re8RM5fZA (button) folded before Flop (didn't bet)
Seat 7: JjOuv8Vf56aiQjWi/rTPFA (small blind) folded before Flop
Seat 8: +2kMBNpY4nF1qNCRd8SJLA (big blind) folded before Flop
Seat 9: oLa/tXLfSLLB28mcLGrxcg folded before Flop (didn't bet)




PokerStars Game #59941630380:  Hold'em No Limit ($0.10/$0.25) - 2009/07/01 1:41:15 ET
Table 'NtEQAxCeIK2io1CGtW658g' 6-max Seat #3 is the button
Seat 1: X437kMQ7AujoaDgjguhU9w ($11.80 in chips) 
Seat 3: m2yWOKfAxqHoy5DDN87Ttw ($37.65 in chips) 
Seat 4: 8296 ($11.65 in chips) 
Seat 5: Hsvkc0/G2VV78oVmWYXecw ($5 in chips) 
Seat 6: /gJNBeCkWL4o85/jvlZ4BA ($65.10 in chips) 
8296: posts small blind $0.10
Hsvkc0/G2VV78oVmWYXecw: posts big blind $0.25
*** HOLE CARDS ***
/gJNBeCkWL4o85/jvlZ4BA: folds 
X437kMQ7AujoaDgjguhU9w: folds 
m2yWOKfAxqHoy5DDN87Ttw: raises $0.75 to $1
8296: folds 
Hsvkc0/G2VV78oVmWYXecw: folds 
Uncalled bet ($0.75) returned to m2yWOKfAxqHoy5DDN87Ttw
m2yWOKfAxqHoy5DDN87Ttw collected $0.60 from pot
m2yWOKfAxqHoy5DDN87Ttw: doesn't show hand 
*** SUMMARY ***
Total pot $0.60 | Rake $0 
Seat 1: X437kMQ7AujoaDgjguhU9w folded before Flop (didn't bet)
Seat 3: m2yWOKfAxqHoy5DDN87Ttw (button) collected ($0.60)
Seat 4: 8296 (small blind) folded before Flop
Seat 5: Hsvkc0/G2VV78oVmWYXecw (big blind) folded before Flop
Seat 6: /gJNBeCkWL4o85/jvlZ4BA folded before Flop (didn't bet)




PokerStars Game #59941631022:  Hold'em No Limit ($0.10/$0.25) - 2009/07/01 1:41:16 ET
Table 'G+4ZdyRoPjgaJY/jxSlZzQ' 9-max Seat #4 is the button
Seat 1: ghNKXUBl/H+t83JF079ZBA ($23.40 in chips) 
Seat 2: CT7Xj/V/O5rBlhtt+RZeFQ ($25 in chips) 
Seat 3: FaGtAm5QUVcixGhAKIvbLg ($15.25 in chips) 
Seat 4: lSeLm4BdnSMLtIli62qjAQ ($10.65 in chips) 
Seat 5: BT6Oal0iO4P6kDuT7HFQDw ($14.20 in chips) 
Seat 6: oFwaTjy3ok/+qFghsrcGvg ($23.65 in chips) 
Seat 7: IK3/w7XV7rd8mVIsuasjYA ($2.35 in chips) 
Seat 9: tLcDklc2rBORNfixyRfVfw ($25 in chips) 
BT6Oal0iO4P6kDuT7HFQDw: posts small blind $0.10
oFwaTjy3ok/+qFghsrcGvg: posts big blind $0.25
bXpVeaSTPBFSPJmeXxO7nw: sits out 
*** HOLE CARDS ***
IK3/w7XV7rd8mVIsuasjYA: folds 
tLcDklc2rBORNfixyRfVfw: folds 
ghNKXUBl/H+t83JF079ZBA: raises $0.75 to $1
CT7Xj/V/O5rBlhtt+RZeFQ: folds 
FaGtAm5QUVcixGhAKIvbLg: folds 
lSeLm4BdnSMLtIli62qjAQ: folds 
BT6Oal0iO4P6kDuT7HFQDw: calls $0.90
oFwaTjy3ok/+qFghsrcGvg: folds 
*** FLOP *** [4c Ks Td]
BT6Oal0iO4P6kDuT7HFQDw: checks 
ghNKXUBl/H+t83JF079ZBA: bets $1.25
BT6Oal0iO4P6kDuT7HFQDw: calls $1.25
*** TURN *** [4c Ks Td] [Qh]
BT6Oal0iO4P6kDuT7HFQDw: checks 
ghNKXUBl/H+t83JF079ZBA: checks 
*** RIVER *** [4c Ks Td Qh] [8s]
BT6Oal0iO4P6kDuT7HFQDw: checks 
ghNKXUBl/H+t83JF079ZBA: checks 
*** SHOW DOWN ***
BT6Oal0iO4P6kDuT7HFQDw: shows [9s Qs] (a pair of Queens)
ghNKXUBl/H+t83JF079ZBA: mucks hand 
BT6Oal0iO4P6kDuT7HFQDw collected $4.55 from pot
*** SUMMARY ***
Total pot $4.75 | Rake $0.20 
Board [4c Ks Td Qh 8s]
Seat 1: ghNKXUBl/H+t83JF079ZBA mucked
Seat 2: CT7Xj/V/O5rBlhtt+RZeFQ folded before Flop (didn't bet)
Seat 3: FaGtAm5QUVcixGhAKIvbLg folded before Flop (didn't bet)
Seat 4: lSeLm4BdnSMLtIli62qjAQ (button) folded before Flop (didn't bet)
Seat 5: BT6Oal0iO4P6kDuT7HFQDw (small blind) showed [9s Qs] and won ($4.55) with a pair of Queens
Seat 6: oFwaTjy3ok/+qFghsrcGvg (big blind) folded before Flop
Seat 7: IK3/w7XV7rd8mVIsuasjYA folded before Flop (didn't bet)
Seat 9: tLcDklc2rBORNfixyRfVfw folded before Flop (didn't bet)




PokerStars Game #59941630634:  Hold'em No Limit ($0.10/$0.25) - 2009/07/01 1:41:16 ET
Table 'xmJKTGBeWCwutccj3YfupQ' 6-max Seat #1 is the button
Seat 1: sVbkVl4OznxBCfi66UB9vw ($25.65 in chips) 
Seat 2: AxhCSFlGEh+FAc+VUD31JQ ($23.30 in chips) 
Seat 3: T5wrp/d5jarm+SxNy8OQAg ($22.15 in chips) 
Seat 4: uWjhTVMpuIroxXcmD3Okug ($11.10 in chips) 
Seat 5: DE9hRlt14g+JdsRQ4wT7hg ($25 in chips) 
AxhCSFlGEh+FAc+VUD31JQ: posts small blind $0.10
T5wrp/d5jarm+SxNy8OQAg: posts big blind $0.25
geomdnb: sits out 
*** HOLE CARDS ***
uWjhTVMpuIroxXcmD3Okug: folds 
DE9hRlt14g+JdsRQ4wT7hg: folds 
sVbkVl4OznxBCfi66UB9vw: raises $0.45 to $0.70
T5wrp/d5jarm+SxNy8OQAg said, "almost got me"
AxhCSFlGEh+FAc+VUD31JQ: folds 
T5wrp/d5jarm+SxNy8OQAg: calls $0.45
*** FLOP *** [Ad Qc 8h]
T5wrp/d5jarm+SxNy8OQAg: checks 
sVbkVl4OznxBCfi66UB9vw: checks 
*** TURN *** [Ad Qc 8h] [Qd]
T5wrp/d5jarm+SxNy8OQAg: bets $1.25
sVbkVl4OznxBCfi66UB9vw: calls $1.25
*** RIVER *** [Ad Qc 8h Qd] [2s]
T5wrp/d5jarm+SxNy8OQAg: checks 
sVbkVl4OznxBCfi66UB9vw: checks 
*** SHOW DOWN ***
T5wrp/d5jarm+SxNy8OQAg: shows [3h 9c] (a pair of Queens)
sVbkVl4OznxBCfi66UB9vw: shows [5s 8s] (two pair, Queens and Eights)
sVbkVl4OznxBCfi66UB9vw collected $3.85 from pot
*** SUMMARY ***
Total pot $4 | Rake $0.15 
Board [Ad Qc 8h Qd 2s]
Seat 1: sVbkVl4OznxBCfi66UB9vw (button) showed [5s 8s] and won ($3.85) with two pair, Queens and Eights
Seat 2: AxhCSFlGEh+FAc+VUD31JQ (small blind) folded before Flop
Seat 3: T5wrp/d5jarm+SxNy8OQAg (big blind) showed [3h 9c] and lost with a pair of Queens
Seat 4: uWjhTVMpuIroxXcmD3Okug folded before Flop (didn't bet)
Seat 5: DE9hRlt14g+JdsRQ4wT7hg folded before Flop (didn't bet)




PokerStars Game #59941630640:  Hold'em No Limit ($0.10/$0.25) - 2009/07/01 1:41:16 ET
Table 'D1Yq70l0nNCyMV6DA42p+Q' 9-max Seat #4 is the button
Seat 1: z5GxcHlYz/GSz6W2uFiTtg ($19.05 in chips) 
Seat 2: zgi+EUykT/pZQpoUG6+oEg ($4.30 in chips) 
Seat 3: 9lvO/qyU+xrU95Teu1fv0g ($5.50 in chips) 
Seat 4: VWUWpMLMj/Q1jRVpF7Aohw ($11.15 in chips) 
Seat 5: gehe91e0IyVT0QU/XBkEyg ($25 in chips) 
Seat 6: wGigCmBR/9XWkPpvYos3aQ ($30.05 in chips) 
Seat 7: Lqytncc1Dsgt654eEBp/uw ($31.05 in chips) 
Seat 8: zDrucyjVn5aeekNEc3cJrA ($24.35 in chips) 
Seat 9: h5wEs8qXrBqfLa9GjaSBzg ($24.25 in chips) 
gehe91e0IyVT0QU/XBkEyg: posts small blind $0.10
wGigCmBR/9XWkPpvYos3aQ: posts big blind $0.25
*** HOLE CARDS ***
Lqytncc1Dsgt654eEBp/uw: raises $0.75 to $1
zDrucyjVn5aeekNEc3cJrA: folds 
h5wEs8qXrBqfLa9GjaSBzg: folds 
z5GxcHlYz/GSz6W2uFiTtg: folds 
zgi+EUykT/pZQpoUG6+oEg: folds 
9lvO/qyU+xrU95Teu1fv0g: folds 
VWUWpMLMj/Q1jRVpF7Aohw: folds 
gehe91e0IyVT0QU/XBkEyg: folds 
wGigCmBR/9XWkPpvYos3aQ: raises $2.50 to $3.50
Lqytncc1Dsgt654eEBp/uw: calls $2.50
*** FLOP *** [8h 7s Qc]
wGigCmBR/9XWkPpvYos3aQ: bets $5.10
Lqytncc1Dsgt654eEBp/uw: folds 
Uncalled bet ($5.10) returned to wGigCmBR/9XWkPpvYos3aQ
wGigCmBR/9XWkPpvYos3aQ collected $6.75 from pot
wGigCmBR/9XWkPpvYos3aQ: doesn't show hand 
*** SUMMARY ***
Total pot $7.10 | Rake $0.35 
Board [8h 7s Qc]
Seat 1: z5GxcHlYz/GSz6W2uFiTtg folded before Flop (didn't bet)
Seat 2: zgi+EUykT/pZQpoUG6+oEg folded before Flop (didn't bet)
Seat 3: 9lvO/qyU+xrU95Teu1fv0g folded before Flop (didn't bet)
Seat 4: VWUWpMLMj/Q1jRVpF7Aohw (button) folded before Flop (didn't bet)
Seat 5: gehe91e0IyVT0QU/XBkEyg (small blind) folded before Flop
Seat 6: wGigCmBR/9XWkPpvYos3aQ (big blind) collected ($6.75)
Seat 7: Lqytncc1Dsgt654eEBp/uw folded on the Flop
Seat 8: zDrucyjVn5aeekNEc3cJrA folded before Flop (didn't bet)
Seat 9: h5wEs8qXrBqfLa9GjaSBzg folded before Flop (didn't bet)




PokerStars Game #59941630740:  Hold'em No Limit ($0.10/$0.25) - 2009/07/01 1:41:16 ET
Table 'DhkrdW2UOy2PfjSW28Kq8w' 6-max Seat #2 is the button
Seat 1: vu2kzHaDtgr6NM7rdq0chA ($26.65 in chips) 
Seat 2: v+QfkGiuj9bgtuNoVnDO8w ($25 in chips) 
Seat 3: B3X187C0tXFUfQpCu8pe8A ($23 in chips) 
Seat 4: 59HJSCM1X37BkMpI9N0mEw ($26.40 in chips) 
Seat 5: SxIIgwXYLkwd6m3wLyPTCw ($49.20 in chips) 
Seat 6: DihMHaz4WNETH1bPDe13kA ($25.40 in chips) 
B3X187C0tXFUfQpCu8pe8A: posts small blind $0.10
59HJSCM1X37BkMpI9N0mEw: posts big blind $0.25
*** HOLE CARDS ***
SxIIgwXYLkwd6m3wLyPTCw: folds 
DihMHaz4WNETH1bPDe13kA: folds 
vu2kzHaDtgr6NM7rdq0chA: folds 
v+QfkGiuj9bgtuNoVnDO8w: folds 
B3X187C0tXFUfQpCu8pe8A: folds 
Uncalled bet ($0.15) returned to 59HJSCM1X37BkMpI9N0mEw
59HJSCM1X37BkMpI9N0mEw collected $0.20 from pot
59HJSCM1X37BkMpI9N0mEw: doesn't show hand 
*** SUMMARY ***
Total pot $0.20 | Rake $0 
Seat 1: vu2kzHaDtgr6NM7rdq0chA folded before Flop (didn't bet)
Seat 2: v+QfkGiuj9bgtuNoVnDO8w (button) folded before Flop (didn't bet)
Seat 3: B3X187C0tXFUfQpCu8pe8A (small blind) folded before Flop
Seat 4: 59HJSCM1X37BkMpI9N0mEw (big blind) collected ($0.20)
Seat 5: SxIIgwXYLkwd6m3wLyPTCw folded before Flop (didn't bet)
Seat 6: DihMHaz4WNETH1bPDe13kA folded before Flop (didn't bet)




PokerStars Game #59941631258:  Hold'em No Limit ($0.10/$0.25) - 2009/07/01 1:41:17 ET
Table 'PCxB2W9H6ma8SwsZlImuOw' 9-max Seat #3 is the button
Seat 1: SqibpGx+lf+brY0fJVvD0w ($25.10 in chips) 
Seat 2: wjH6l1gQaEfv+C45sAOwIQ ($38.20 in chips) 
Seat 3: J2a/QHAWUgo6beDRoEyg2g ($9.60 in chips) 
Seat 4: RsPwA2DnzOke3hD/Of/DUg ($2.65 in chips) 
Seat 5: GZO7tOXatVoX17M2DqPcUQ ($20.60 in chips) 
Seat 6: 5/6dWEBUHldD7iGXa2LwsQ ($17.25 in chips) 
Seat 7: c/9X4zftzphFxYtxp5kp9w ($26.80 in chips) 
Seat 8: Pt637jKksB5MzP0UNJAAkw ($25 in chips) 
Seat 9: COwSH15MvHaRF7en6/TRZQ ($4.65 in chips) 
RsPwA2DnzOke3hD/Of/DUg: posts small blind $0.10
GZO7tOXatVoX17M2DqPcUQ: posts big blind $0.25
*** HOLE CARDS ***
5/6dWEBUHldD7iGXa2LwsQ: folds 
c/9X4zftzphFxYtxp5kp9w: folds 
Pt637jKksB5MzP0UNJAAkw: folds 
COwSH15MvHaRF7en6/TRZQ: folds 
SqibpGx+lf+brY0fJVvD0w: folds 
wjH6l1gQaEfv+C45sAOwIQ: folds 
J2a/QHAWUgo6beDRoEyg2g: calls $0.25
RsPwA2DnzOke3hD/Of/DUg: folds 
GZO7tOXatVoX17M2DqPcUQ: raises $0.25 to $0.50
J2a/QHAWUgo6beDRoEyg2g: calls $0.25
*** FLOP *** [8d 8h Td]
GZO7tOXatVoX17M2DqPcUQ: bets $1
J2a/QHAWUgo6beDRoEyg2g: folds 
Uncalled bet ($1) returned to GZO7tOXatVoX17M2DqPcUQ
GZO7tOXatVoX17M2DqPcUQ collected $1.05 from pot
*** SUMMARY ***
Total pot $1.10 | Rake $0.05 
Board [8d 8h Td]
Seat 1: SqibpGx+lf+brY0fJVvD0w folded before Flop (didn't bet)
Seat 2: wjH6l1gQaEfv+C45sAOwIQ folded before Flop (didn't bet)
Seat 3: J2a/QHAWUgo6beDRoEyg2g (button) folded on the Flop
Seat 4: RsPwA2DnzOke3hD/Of/DUg (small blind) folded before Flop
Seat 5: GZO7tOXatVoX17M2DqPcUQ (big blind) collected ($1.05)
Seat 6: 5/6dWEBUHldD7iGXa2LwsQ folded before Flop (didn't bet)
Seat 7: c/9X4zftzphFxYtxp5kp9w folded before Flop (didn't bet)
Seat 8: Pt637jKksB5MzP0UNJAAkw folded before Flop (didn't bet)
Seat 9: COwSH15MvHaRF7en6/TRZQ folded before Flop (didn't bet)




PokerStars Game #59941631166:  Hold'em No Limit ($0.10/$0.25) - 2009/07/01 1:41:17 ET
Table 'aaXqTKUnxrX9DYXtxhWXxA' 6-max Seat #4 is the button
Seat 1: rnpAao581IcvQglpkpnkoQ ($8.35 in chips) 
Seat 2: DE9hRlt14g+JdsRQ4wT7hg ($34.05 in chips) 
Seat 4: 48oT5xFI+5CHUJlfoGrE4w ($10.55 in chips) 
Seat 5: kyRaCIljYA6l33lSKQfNsg ($1.25 in chips) 
Seat 6: buyjetgNT1McXtdaP4zynA ($47.85 in chips) 
kyRaCIljYA6l33lSKQfNsg: posts small blind $0.10
buyjetgNT1McXtdaP4zynA: posts big blind $0.25
uUXdcVMNa05rfbntdvplfw: sits out 
*** HOLE CARDS ***
kyRaCIljYA6l33lSKQfNsg said, "???"
rnpAao581IcvQglpkpnkoQ: folds 
DE9hRlt14g+JdsRQ4wT7hg: folds 
48oT5xFI+5CHUJlfoGrE4w: folds 
kyRaCIljYA6l33lSKQfNsg: folds 
Uncalled bet ($0.15) returned to buyjetgNT1McXtdaP4zynA
buyjetgNT1McXtdaP4zynA collected $0.20 from pot
*** SUMMARY ***
Total pot $0.20 | Rake $0 
Seat 1: rnpAao581IcvQglpkpnkoQ folded before Flop (didn't bet)
Seat 2: DE9hRlt14g+JdsRQ4wT7hg folded before Flop (didn't bet)
Seat 4: 48oT5xFI+5CHUJlfoGrE4w (button) folded before Flop (didn't bet)
Seat 5: kyRaCIljYA6l33lSKQfNsg (small blind) folded before Flop
Seat 6: buyjetgNT1McXtdaP4zynA (big blind) collected ($0.20)




PokerStars Game #59941631426:  Hold'em No Limit ($0.10/$0.25) - 2009/07/01 1:41:17 ET
Table 'wPWRBZPJl1HAnysw7qRR0A' 6-max Seat #3 is the button
Seat 1: m7ne1MOFTQXlsXT7/R/rug ($9.15 in chips) 
Seat 3: 1ZpoLWO2nm2w1Nd1v9Sr3g ($5.65 in chips) 
Seat 4: epAUIB7h2FJXzUPRIvSkRA ($25.70 in chips) 
Seat 5: y0B+UpYpOUJz3JWtlJQBSA ($21.45 in chips) 
Seat 6: Hsvkc0/G2VV78oVmWYXecw ($5 in chips) 
epAUIB7h2FJXzUPRIvSkRA: posts small blind $0.10
y0B+UpYpOUJz3JWtlJQBSA: posts big blind $0.25
ripbrokeith: sits out 
*** HOLE CARDS ***
Hsvkc0/G2VV78oVmWYXecw: raises $0.50 to $0.75
m7ne1MOFTQXlsXT7/R/rug: folds 
1ZpoLWO2nm2w1Nd1v9Sr3g: folds 
epAUIB7h2FJXzUPRIvSkRA: folds 
y0B+UpYpOUJz3JWtlJQBSA: calls $0.50
*** FLOP *** [3s 3h 7h]
y0B+UpYpOUJz3JWtlJQBSA: checks 
Hsvkc0/G2VV78oVmWYXecw: bets $1
y0B+UpYpOUJz3JWtlJQBSA: calls $1
*** TURN *** [3s 3h 7h] [Ah]
y0B+UpYpOUJz3JWtlJQBSA: checks 
Hsvkc0/G2VV78oVmWYXecw: bets $1.50
y0B+UpYpOUJz3JWtlJQBSA: raises $1.50 to $3
Hsvkc0/G2VV78oVmWYXecw: raises $0.25 to $3.25 and is all-in
y0B+UpYpOUJz3JWtlJQBSA: calls $0.25
*** RIVER *** [3s 3h 7h Ah] [Qd]
*** SHOW DOWN ***
y0B+UpYpOUJz3JWtlJQBSA: shows [5s 5d] (two pair, Fives and Threes)
Hsvkc0/G2VV78oVmWYXecw: shows [As Qs] (two pair, Aces and Queens)
Hsvkc0/G2VV78oVmWYXecw collected $9.65 from pot
*** SUMMARY ***
Total pot $10.10 | Rake $0.45 
Board [3s 3h 7h Ah Qd]
Seat 1: m7ne1MOFTQXlsXT7/R/rug folded before Flop (didn't bet)
Seat 3: 1ZpoLWO2nm2w1Nd1v9Sr3g (button) folded before Flop (didn't bet)
Seat 4: epAUIB7h2FJXzUPRIvSkRA (small blind) folded before Flop
Seat 5: y0B+UpYpOUJz3JWtlJQBSA (big blind) showed [5s 5d] and lost with two pair, Fives and Threes
Seat 6: Hsvkc0/G2VV78oVmWYXecw showed [As Qs] and won ($9.65) with two pair, Aces and Queens




PokerStars Game #59941631124:  Hold'em No Limit ($0.10/$0.25) - 2009/07/01 1:41:17 ET
Table 'qryc9C/ELyQ3lubOaELNAQ' 6-max Seat #2 is the button
Seat 1: OZc6kkoTwtITj1ZfreJK1A ($64.80 in chips) 
Seat 2: LtASJ9OlkqGrrUKGQlpGAw ($30.80 in chips) 
Seat 4: v+QfkGiuj9bgtuNoVnDO8w ($25.15 in chips) 
Seat 5: 9StOHp+Y1T0K13JdgS2oQQ ($33.55 in chips) 
Seat 6: u+J1MTXS2qhNVMbsBemNLg ($4.05 in chips) 
v+QfkGiuj9bgtuNoVnDO8w: posts small blind $0.10
leaf64 joins the table at seat #3 
9StOHp+Y1T0K13JdgS2oQQ: posts big blind $0.25
*** HOLE CARDS ***
u+J1MTXS2qhNVMbsBemNLg: folds 
OZc6kkoTwtITj1ZfreJK1A: folds 
LtASJ9OlkqGrrUKGQlpGAw: folds 
v+QfkGiuj9bgtuNoVnDO8w: folds 
Uncalled bet ($0.15) returned to 9StOHp+Y1T0K13JdgS2oQQ
9StOHp+Y1T0K13JdgS2oQQ collected $0.20 from pot
9StOHp+Y1T0K13JdgS2oQQ: doesn't show hand 
*** SUMMARY ***
Total pot $0.20 | Rake $0 
Seat 1: OZc6kkoTwtITj1ZfreJK1A folded before Flop (didn't bet)
Seat 2: LtASJ9OlkqGrrUKGQlpGAw (button) folded before Flop (didn't bet)
Seat 4: v+QfkGiuj9bgtuNoVnDO8w (small blind) folded before Flop
Seat 5: 9StOHp+Y1T0K13JdgS2oQQ (big blind) collected ($0.20)
Seat 6: u+J1MTXS2qhNVMbsBemNLg folded before Flop (didn't bet)




PokerStars Game #59941631938:  Hold'em No Limit ($0.10/$0.25) - 2009/07/01 1:41:18 ET
Table '0XPo7K54oZIfG0xlNAcDRwnQC9LRg01NEuKFHF1nrDEw-max Seat #5 is the button
Seat 1: qf+LMbROj8/qY878wkFHbQ ($15 in chips) 
Seat 2: lYjWCpfCxX2kgcHY3v4Yow ($41.25 in chips) 
Seat 3: 6+g0Lb6vfRDZkElV8ieHyQ ($19.40 in chips) 
Seat 5: kG34n23qFQA3nzdOJTQ1dA ($29.05 in chips) 
Seat 6: xQVFeVUDopz+akuEo2wXpQ ($58.65 in chips) 
xQVFeVUDopz+akuEo2wXpQ: posts small blind $0.10
qf+LMbROj8/qY878wkFHbQ: posts big blind $0.25
*** HOLE CARDS ***
lYjWCpfCxX2kgcHY3v4Yow: folds 
6+g0Lb6vfRDZkElV8ieHyQ: calls $0.25
kG34n23qFQA3nzdOJTQ1dA: folds 
xQVFeVUDopz+akuEo2wXpQ: calls $0.15
qf+LMbROj8/qY878wkFHbQ: checks 
*** FLOP *** [Ac 7h Js]
xQVFeVUDopz+akuEo2wXpQ: checks 
qf+LMbROj8/qY878wkFHbQ: checks 
6+g0Lb6vfRDZkElV8ieHyQ: checks 
*** TURN *** [Ac 7h Js] [Qc]
xQVFeVUDopz+akuEo2wXpQ: bets $0.75
qf+LMbROj8/qY878wkFHbQ: folds 
6+g0Lb6vfRDZkElV8ieHyQ: raises $0.75 to $1.50
xQVFeVUDopz+akuEo2wXpQ: calls $0.75
*** RIVER *** [Ac 7h Js Qc] [Ad]
xQVFeVUDopz+akuEo2wXpQ: bets $0.75
6+g0Lb6vfRDZkElV8ieHyQ: raises $2 to $2.75
xQVFeVUDopz+akuEo2wXpQ: calls $2
*** SHOW DOWN ***
6+g0Lb6vfRDZkElV8ieHyQ: shows [As 8c] (three of a kind, Aces)
xQVFeVUDopz+akuEo2wXpQ: mucks hand 
6+g0Lb6vfRDZkElV8ieHyQ collected $8.80 from pot
*** SUMMARY ***
Total pot $9.25 | Rake $0.45 
Board [Ac 7h Js Qc Ad]
Seat 1: qf+LMbROj8/qY878wkFHbQ (big blind) folded on the Turn
Seat 2: lYjWCpfCxX2kgcHY3v4Yow folded before Flop (didn't bet)
Seat 3: 6+g0Lb6vfRDZkElV8ieHyQ showed [As 8c] and won ($8.80) with three of a kind, Aces
Seat 5: kG34n23qFQA3nzdOJTQ1dA (button) folded before Flop (didn't bet)
Seat 6: xQVFeVUDopz+akuEo2wXpQ (small blind) mucked




PokerStars Game #59941632118:  Hold'em No Limit ($0.10/$0.25) - 2009/07/01 1:41:18 ET
Table 'IuqVbFI+pwnJjvwBCGSGAw' 6-max Seat #6 is the button
Seat 1: LyDHtw3/yniNHW+DvLXbog ($25 in chips) 
Seat 2: wsP46AGpqDjHZQmlRHKa9g ($25.45 in chips) 
Seat 3: QiL+lEgEWwy21jk/ltaRLg ($22.60 in chips) 
Seat 5: if4dh6jhJXeN3/qd3qCp9g ($25 in chips) 
Seat 6: SJ5z7oeRzpbFT7jU55Mbag ($37.40 in chips) 
LyDHtw3/yniNHW+DvLXbog: posts small blind $0.10
wsP46AGpqDjHZQmlRHKa9g: posts big blind $0.25
DE9hRlt14g+JdsRQ4wT7hg: sits out 
*** HOLE CARDS ***
QiL+lEgEWwy21jk/ltaRLg: folds 
if4dh6jhJXeN3/qd3qCp9g: folds 
SJ5z7oeRzpbFT7jU55Mbag: folds 
LyDHtw3/yniNHW+DvLXbog: folds 
Uncalled bet ($0.15) returned to wsP46AGpqDjHZQmlRHKa9g
wsP46AGpqDjHZQmlRHKa9g collected $0.20 from pot
*** SUMMARY ***
Total pot $0.20 | Rake $0 
Seat 1: LyDHtw3/yniNHW+DvLXbog (small blind) folded before Flop
Seat 2: wsP46AGpqDjHZQmlRHKa9g (big blind) collected ($0.20)
Seat 3: QiL+lEgEWwy21jk/ltaRLg folded before Flop (didn't bet)
Seat 5: if4dh6jhJXeN3/qd3qCp9g folded before Flop (didn't bet)
Seat 6: SJ5z7oeRzpbFT7jU55Mbag (button) folded before Flop (didn't bet)




PokerStars Game #59941631834:  Hold'em No Limit ($0.10/$0.25) - 2009/07/01 1:41:18 ET
Table 'djcjiEGabFQO0MNG6jEeJQ' 9-max Seat #6 is the button
Seat 1: Bb42QRQMhg5/Y0vHP8/2Xw ($25 in chips) 
Seat 2: WKL8nUFr7TumC4EjLyqYzw ($4.75 in chips) 
Seat 3: zgi+EUykT/pZQpoUG6+oEg ($5 in chips) 
Seat 4: 2wcFsZsqEP5w1StUTVzJCg ($9.20 in chips) 
Seat 5: cZ99hugmLBj9KhTlc8nCSw ($42 in chips) 
Seat 6: aNpwfA31EREwO+ar4XzBCw ($74 in chips) 
Seat 7: 56S3mA6Zs3pGR+0p0vUCtg ($35.05 in chips) 
Seat 8: +sbyWwIcFp9kP0bDtMegfQ ($51.75 in chips) 
Seat 9: HPEB+AtKw1+C/cxU0o1ciw ($47.20 in chips) 
56S3mA6Zs3pGR+0p0vUCtg: posts small blind $0.10
+sbyWwIcFp9kP0bDtMegfQ: posts big blind $0.25
*** HOLE CARDS ***
HPEB+AtKw1+C/cxU0o1ciw: folds 
Bb42QRQMhg5/Y0vHP8/2Xw: folds 
WKL8nUFr7TumC4EjLyqYzw: folds 
zgi+EUykT/pZQpoUG6+oEg: folds 
2wcFsZsqEP5w1StUTVzJCg: raises $0.50 to $0.75
cZ99hugmLBj9KhTlc8nCSw: folds 
aNpwfA31EREwO+ar4XzBCw: folds 
56S3mA6Zs3pGR+0p0vUCtg: folds 
+sbyWwIcFp9kP0bDtMegfQ: folds 
Uncalled bet ($0.50) returned to 2wcFsZsqEP5w1StUTVzJCg
2wcFsZsqEP5w1StUTVzJCg collected $0.60 from pot
*** SUMMARY ***
Total pot $0.60 | Rake $0 
Seat 1: Bb42QRQMhg5/Y0vHP8/2Xw folded before Flop (didn't bet)
Seat 2: WKL8nUFr7TumC4EjLyqYzw folded before Flop (didn't bet)
Seat 3: zgi+EUykT/pZQpoUG6+oEg folded before Flop (didn't bet)
Seat 4: 2wcFsZsqEP5w1StUTVzJCg collected ($0.60)
Seat 5: cZ99hugmLBj9KhTlc8nCSw folded before Flop (didn't bet)
Seat 6: aNpwfA31EREwO+ar4XzBCw (button) folded before Flop (didn't bet)
Seat 7: 56S3mA6Zs3pGR+0p0vUCtg (small blind) folded before Flop
Seat 8: +sbyWwIcFp9kP0bDtMegfQ (big blind) folded before Flop
Seat 9: HPEB+AtKw1+C/cxU0o1ciw folded before Flop (didn't bet)




PokerStars Game #59941631704:  Hold'em No Limit ($0.10/$0.25) - 2009/07/01 1:41:18 ET
Table '0mmHveGuaIfIMQlNE1eqMg' 9-max Seat #1 is the button
Seat 1: ydoFOVgzvZv9ZhuWu9rXAw ($5 in chips) 
Seat 2: rQhYIYXSyH/IivYM1dlV5A ($68.25 in chips) 
Seat 3: ghNKXUBl/H+t83JF079ZBA ($25 in chips) 
Seat 4: DnDcAdn9P0zGovMERigpFA ($35.35 in chips) 
Seat 5: Pt637jKksB5MzP0UNJAAkw ($9.20 in chips) 
Seat 6: 6RiVTYll/5D8zICp0MRpKw ($24.20 in chips) 
Seat 9: UNw/UrAelsQeSS17Rro/BA ($11.15 in chips) 
rQhYIYXSyH/IivYM1dlV5A: posts small blind $0.10
ghNKXUBl/H+t83JF079ZBA: posts big blind $0.25
5n7e7I+px7c6CQmLpPbtsg: sits out 
0XACOSNrAWmqNv9k1nF8rw: sits out 
*** HOLE CARDS ***
DnDcAdn9P0zGovMERigpFA: folds 
Pt637jKksB5MzP0UNJAAkw: folds 
6RiVTYll/5D8zICp0MRpKw: folds 
UNw/UrAelsQeSS17Rro/BA: folds 
ydoFOVgzvZv9ZhuWu9rXAw: folds 
rQhYIYXSyH/IivYM1dlV5A: folds 
Uncalled bet ($0.15) returned to ghNKXUBl/H+t83JF079ZBA
ghNKXUBl/H+t83JF079ZBA collected $0.20 from pot
ghNKXUBl/H+t83JF079ZBA: doesn't show hand 
*** SUMMARY ***
Total pot $0.20 | Rake $0 
Seat 1: ydoFOVgzvZv9ZhuWu9rXAw (button) folded before Flop (didn't bet)
Seat 2: rQhYIYXSyH/IivYM1dlV5A (small blind) folded before Flop
Seat 3: ghNKXUBl/H+t83JF079ZBA (big blind) collected ($0.20)
Seat 4: DnDcAdn9P0zGovMERigpFA folded before Flop (didn't bet)
Seat 5: Pt637jKksB5MzP0UNJAAkw folded before Flop (didn't bet)
Seat 6: 6RiVTYll/5D8zICp0MRpKw folded before Flop (didn't bet)
Seat 9: UNw/UrAelsQeSS17Rro/BA folded before Flop (didn't bet)




PokerStars Game #59941632418:  Hold'em No Limit ($0.10/$0.25) - 2009/07/01 1:41:19 ET
Table 'CM/C/FZf3VHIp50RjmBucQ' 9-max Seat #5 is the button
Seat 3: HPEB+AtKw1+C/cxU0o1ciw ($51.40 in chips) 
Seat 4: FYIiLXWy4mKC5ZGa/fnS0g ($10.05 in chips) 
Seat 5: oLa/tXLfSLLB28mcLGrxcg ($24.55 in chips) 
Seat 6: Bb42QRQMhg5/Y0vHP8/2Xw ($25.10 in chips) 
Seat 7: j4q3p0lesp63b1gZDwLBZw ($5 in chips) 
Seat 8: cZ99hugmLBj9KhTlc8nCSw ($25 in chips) 
Seat 9: HrQz1sQcyfbz6TvbEEzHWQ ($21.85 in chips) 
Bb42QRQMhg5/Y0vHP8/2Xw: posts small blind $0.10
j4q3p0lesp63b1gZDwLBZw: posts big blind $0.25
*** HOLE CARDS ***
cZ99hugmLBj9KhTlc8nCSw: raises $0.50 to $0.75
HrQz1sQcyfbz6TvbEEzHWQ: folds 
HPEB+AtKw1+C/cxU0o1ciw: folds 
FYIiLXWy4mKC5ZGa/fnS0g: folds 
oLa/tXLfSLLB28mcLGrxcg: folds 
Bb42QRQMhg5/Y0vHP8/2Xw: folds 
j4q3p0lesp63b1gZDwLBZw: folds 
Uncalled bet ($0.50) returned to cZ99hugmLBj9KhTlc8nCSw
cZ99hugmLBj9KhTlc8nCSw collected $0.60 from pot
*** SUMMARY ***
Total pot $0.60 | Rake $0 
Seat 3: HPEB+AtKw1+C/cxU0o1ciw folded before Flop (didn't bet)
Seat 4: FYIiLXWy4mKC5ZGa/fnS0g folded before Flop (didn't bet)
Seat 5: oLa/tXLfSLLB28mcLGrxcg (button) folded before Flop (didn't bet)
Seat 6: Bb42QRQMhg5/Y0vHP8/2Xw (small blind) folded before Flop
Seat 7: j4q3p0lesp63b1gZDwLBZw (big blind) folded before Flop
Seat 8: cZ99hugmLBj9KhTlc8nCSw collected ($0.60)
Seat 9: HrQz1sQcyfbz6TvbEEzHWQ folded before Flop (didn't bet)




PokerStars Game #59941632466:  Hold'em No Limit ($0.10/$0.25) - 2009/07/01 1:41:19 ET
Table 'SbSV5tlgLp0+/Z+13PW3Hg' 9-max Seat #3 is the button
Seat 1: x+W5+3qsdY4Iszf0hoH+Aw ($14.85 in chips) 
Seat 3: CT7Xj/V/O5rBlhtt+RZeFQ ($25 in chips) 
Seat 4: puj3K/wrNjEj86ZL/MyfLA ($10.95 in chips) 
Seat 5: aNpwfA31EREwO+ar4XzBCw ($25 in chips) 
Seat 7: ruosoLPCzPyA3nfXoPVY3Q ($1.35 in chips) 
Seat 8: qBdqLaJhO+1itcMk70bsfA ($8.90 in chips) 
Seat 9: X78b5v/uhqeXXoAijbw/yg ($25 in chips) 
puj3K/wrNjEj86ZL/MyfLA: posts small blind $0.10
aNpwfA31EREwO+ar4XzBCw: posts big blind $0.25
pN3IHvAKm2fz+sTRARTcrg: sits out 
*** HOLE CARDS ***
ruosoLPCzPyA3nfXoPVY3Q: folds 
qBdqLaJhO+1itcMk70bsfA: folds 
X78b5v/uhqeXXoAijbw/yg: folds 
x+W5+3qsdY4Iszf0hoH+Aw: folds 
CT7Xj/V/O5rBlhtt+RZeFQ: raises $0.75 to $1
puj3K/wrNjEj86ZL/MyfLA: folds 
aNpwfA31EREwO+ar4XzBCw: folds 
Uncalled bet ($0.75) returned to CT7Xj/V/O5rBlhtt+RZeFQ
CT7Xj/V/O5rBlhtt+RZeFQ collected $0.60 from pot
CT7Xj/V/O5rBlhtt+RZeFQ: doesn't show hand 
*** SUMMARY ***
Total pot $0.60 | Rake $0 
Seat 1: x+W5+3qsdY4Iszf0hoH+Aw folded before Flop (didn't bet)
Seat 3: CT7Xj/V/O5rBlhtt+RZeFQ (button) collected ($0.60)
Seat 4: puj3K/wrNjEj86ZL/MyfLA (small blind) folded before Flop
Seat 5: aNpwfA31EREwO+ar4XzBCw (big blind) folded before Flop
Seat 7: ruosoLPCzPyA3nfXoPVY3Q folded before Flop (didn't bet)
Seat 8: qBdqLaJhO+1itcMk70bsfA folded before Flop (didn't bet)
Seat 9: X78b5v/uhqeXXoAijbw/yg folded before Flop (didn't bet)




PokerStars Game #59941632454:  Hold'em No Limit ($0.10/$0.25) - 2009/07/01 1:41:19 ET
Table 'P2yJ+jwfNsBdF12fLKA6DQ' 9-max Seat #2 is the button
Seat 2: uQwmfH5LEVA5eyghJdyPUg ($12.40 in chips) 
Seat 4: 6NLAWFPZZfqlVkY8n9RULA ($11.90 in chips) 
Seat 5: B7VAFAMs/PYlYABlV+EkSA ($17.50 in chips) 
Seat 6: mUoFJKqCzIUABvOFbiINlQ ($13.25 in chips) 
Seat 7: yQc5nLaNmByxI15Jegu61w ($9 in chips) 
Seat 8: LMd3gq2uNfbWTfXTnSeQRw ($10.15 in chips) 
Seat 9: dN5zq7QdZCUe7NZFM6cECg ($19.75 in chips) 
8EbrQ/EvFWt2cr0GaU82gQ will be allowed to play after the button
6NLAWFPZZfqlVkY8n9RULA: posts small blind $0.10
B7VAFAMs/PYlYABlV+EkSA: posts big blind $0.25
*** HOLE CARDS ***
mUoFJKqCzIUABvOFbiINlQ: folds 
yQc5nLaNmByxI15Jegu61w: folds 
dN5zq7QdZCUe7NZFM6cECg said, "but it's close"
LMd3gq2uNfbWTfXTnSeQRw: folds 
dN5zq7QdZCUe7NZFM6cECg: raises $0.75 to $1
uQwmfH5LEVA5eyghJdyPUg: calls $1
6NLAWFPZZfqlVkY8n9RULA: calls $0.90
B7VAFAMs/PYlYABlV+EkSA: folds 
*** FLOP *** [6h 8h Jc]
6NLAWFPZZfqlVkY8n9RULA: bets $0.75
dN5zq7QdZCUe7NZFM6cECg: folds 
uQwmfH5LEVA5eyghJdyPUg: folds 
Uncalled bet ($0.75) returned to 6NLAWFPZZfqlVkY8n9RULA
dN5zq7QdZCUe7NZFM6cECg said, "yes, jes?"
6NLAWFPZZfqlVkY8n9RULA collected $3.10 from pot
6NLAWFPZZfqlVkY8n9RULA: doesn't show hand 
*** SUMMARY ***
Total pot $3.25 | Rake $0.15 
Board [6h 8h Jc]
Seat 2: uQwmfH5LEVA5eyghJdyPUg (button) folded on the Flop
Seat 4: 6NLAWFPZZfqlVkY8n9RULA (small blind) collected ($3.10)
Seat 5: B7VAFAMs/PYlYABlV+EkSA (big blind) folded before Flop
Seat 6: mUoFJKqCzIUABvOFbiINlQ folded before Flop (didn't bet)
Seat 7: yQc5nLaNmByxI15Jegu61w folded before Flop (didn't bet)
Seat 8: LMd3gq2uNfbWTfXTnSeQRw folded before Flop (didn't bet)
Seat 9: dN5zq7QdZCUe7NZFM6cECg folded on the Flop




PokerStars Game #59941632190:  Hold'em No Limit ($0.10/$0.25) - 2009/07/01 1:41:19 ET
Table 'Do4nrTNDYpK3sQjwFxX+Og' 6-max Seat #2 is the button
Seat 1: 7JrQNOR9wRBxq9ijFhWieg ($38.10 in chips) 
Seat 2: tzMoGl9F0PUr5NibYueeSw ($68.45 in chips) 
Seat 3: TSmua8tGK3sTbwi0ynrW9Q ($25 in chips) 
Seat 4: cWc85bEzdRzpUMhRKm8pwQ ($33.40 in chips) 
Seat 5: Ew/TYPQIsbQ2X8nm5iAJBg ($35.70 in chips) 
Seat 6: lBoEwOFgzcERLIRUkUoRTw ($23.90 in chips) 
TSmua8tGK3sTbwi0ynrW9Q: posts small blind $0.10
cWc85bEzdRzpUMhRKm8pwQ: posts big blind $0.25
*** HOLE CARDS ***
Ew/TYPQIsbQ2X8nm5iAJBg: folds 
lBoEwOFgzcERLIRUkUoRTw: folds 
7JrQNOR9wRBxq9ijFhWieg: folds 
tzMoGl9F0PUr5NibYueeSw said, "at least I would have known I was ahead/behind"
tzMoGl9F0PUr5NibYueeSw: folds 
TSmua8tGK3sTbwi0ynrW9Q: folds 
Uncalled bet ($0.15) returned to cWc85bEzdRzpUMhRKm8pwQ
cWc85bEzdRzpUMhRKm8pwQ collected $0.20 from pot
tzMoGl9F0PUr5NibYueeSw said, "didn;'t want to make a crying call on the river there"
*** SUMMARY ***
Total pot $0.20 | Rake $0 
Seat 1: 7JrQNOR9wRBxq9ijFhWieg folded before Flop (didn't bet)
Seat 2: tzMoGl9F0PUr5NibYueeSw (button) folded before Flop (didn't bet)
Seat 3: TSmua8tGK3sTbwi0ynrW9Q (small blind) folded before Flop
Seat 4: cWc85bEzdRzpUMhRKm8pwQ (big blind) collected ($0.20)
Seat 5: Ew/TYPQIsbQ2X8nm5iAJBg folded before Flop (didn't bet)
Seat 6: lBoEwOFgzcERLIRUkUoRTw folded before Flop (didn't bet)




PokerStars Game #59941632184:  Hold'em No Limit ($0.10/$0.25) - 2009/07/01 1:41:19 ET
Table 'FE/j6VqBY4j9Uq+VHURQCQ' 6-max Seat #4 is the button
Seat 1: ypmjhffk/YHGc51wgVXUTw ($40.85 in chips) 
Seat 2: 3zD3qLXT1bEffAoWGnc7wg ($39.75 in chips) 
Seat 3: lBoEwOFgzcERLIRUkUoRTw ($27.70 in chips) 
Seat 4: 7JyPCA0J2grhXQYxe1h3+A ($22.65 in chips) 
Seat 5: 4x9jCqgSw4272dnaIqnanw ($7.55 in chips) 
Seat 6: rpJ2ie+vculq8yrHlngRHQ ($18.95 in chips) 
4x9jCqgSw4272dnaIqnanw: posts small blind $0.10
rpJ2ie+vculq8yrHlngRHQ: posts big blind $0.25
*** HOLE CARDS ***
ypmjhffk/YHGc51wgVXUTw: raises $0.50 to $0.75
3zD3qLXT1bEffAoWGnc7wg: folds 
lBoEwOFgzcERLIRUkUoRTw: folds 
7JyPCA0J2grhXQYxe1h3+A: folds 
4x9jCqgSw4272dnaIqnanw: folds 
rpJ2ie+vculq8yrHlngRHQ: folds 
Uncalled bet ($0.50) returned to ypmjhffk/YHGc51wgVXUTw
ypmjhffk/YHGc51wgVXUTw collected $0.60 from pot
ypmjhffk/YHGc51wgVXUTw: doesn't show hand 
*** SUMMARY ***
Total pot $0.60 | Rake $0 
Seat 1: ypmjhffk/YHGc51wgVXUTw collected ($0.60)
Seat 2: 3zD3qLXT1bEffAoWGnc7wg folded before Flop (didn't bet)
Seat 3: lBoEwOFgzcERLIRUkUoRTw folded before Flop (didn't bet)
Seat 4: 7JyPCA0J2grhXQYxe1h3+A (button) folded before Flop (didn't bet)
Seat 5: 4x9jCqgSw4272dnaIqnanw (small blind) folded before Flop
Seat 6: rpJ2ie+vculq8yrHlngRHQ (big blind) folded before Flop




PokerStars Game #59941632342:  Hold'em No Limit ($0.10/$0.25) - 2009/07/01 1:41:19 ET
Table 'a6FCGVBMPcT7J7BDN9q1zQ' 9-max Seat #7 is the button
Seat 1: zgi+EUykT/pZQpoUG6+oEg ($5.15 in chips) 
Seat 2: M2QO2DxB5Wawg2h8HSpnYA ($10 in chips) 
Seat 3: tLcDklc2rBORNfixyRfVfw ($26.15 in chips) 
Seat 4: 8CoKLhwk8Ja6X+O9fxTEDg ($11.80 in chips) 
Seat 5: dtZ84flFEi4Q+SGrHMJRDQ ($27.05 in chips) 
Seat 6: dfNim92Z6XK1/h5SFW5vDg ($25.90 in chips) 
Seat 7: V0Yo5zRBVM8DYspLKafebg ($4.20 in chips) 
Seat 8: r6hsffOo1iKmaPYKwAZmFw ($69.50 in chips) 
Seat 9: wGigCmBR/9XWkPpvYos3aQ ($28.70 in chips) 
r6hsffOo1iKmaPYKwAZmFw: posts small blind $0.10
wGigCmBR/9XWkPpvYos3aQ: posts big blind $0.25
*** HOLE CARDS ***
zgi+EUykT/pZQpoUG6+oEg: raises $0.75 to $1
M2QO2DxB5Wawg2h8HSpnYA: folds 
tLcDklc2rBORNfixyRfVfw: folds 
8CoKLhwk8Ja6X+O9fxTEDg: calls $1
dtZ84flFEi4Q+SGrHMJRDQ: folds 
dfNim92Z6XK1/h5SFW5vDg: calls $1
V0Yo5zRBVM8DYspLKafebg: folds 
r6hsffOo1iKmaPYKwAZmFw: folds 
wGigCmBR/9XWkPpvYos3aQ: folds 
*** FLOP *** [5d 4s 5h]
zgi+EUykT/pZQpoUG6+oEg: bets $4.15 and is all-in
8CoKLhwk8Ja6X+O9fxTEDg: folds 
dfNim92Z6XK1/h5SFW5vDg: folds 
Uncalled bet ($4.15) returned to zgi+EUykT/pZQpoUG6+oEg
zgi+EUykT/pZQpoUG6+oEg collected $3.20 from pot
zgi+EUykT/pZQpoUG6+oEg: doesn't show hand 
*** SUMMARY ***
Total pot $3.35 | Rake $0.15 
Board [5d 4s 5h]
Seat 1: zgi+EUykT/pZQpoUG6+oEg collected ($3.20)
Seat 2: M2QO2DxB5Wawg2h8HSpnYA folded before Flop (didn't bet)
Seat 3: tLcDklc2rBORNfixyRfVfw folded before Flop (didn't bet)
Seat 4: 8CoKLhwk8Ja6X+O9fxTEDg folded on the Flop
Seat 5: dtZ84flFEi4Q+SGrHMJRDQ folded before Flop (didn't bet)
Seat 6: dfNim92Z6XK1/h5SFW5vDg folded on the Flop
Seat 7: V0Yo5zRBVM8DYspLKafebg (button) folded before Flop (didn't bet)
Seat 8: r6hsffOo1iKmaPYKwAZmFw (small blind) folded before Flop
Seat 9: wGigCmBR/9XWkPpvYos3aQ (big blind) folded before Flop




PokerStars Game #59941632358:  Hold'em No Limit ($0.10/$0.25) - 2009/07/01 1:41:19 ET
Table '/asc7VQ/OpF/oVJ3erB80w' 9-max Seat #6 is the button
Seat 2: +LseQ4csMghI3KY4cLSGMQ ($24.25 in chips) 
Seat 3: WEb58GPxGJGcxGh34AFZRQ ($2.45 in chips) 
Seat 4: Rjy74A2wdEiDWplMcUbA+w ($19.60 in chips) 
Seat 5: QB9VESHry/CRTDKMGwKwsQ ($42.45 in chips) 
Seat 6: XwQK8xvCADxp0bUmji+Zyg ($11.95 in chips) 
Seat 7: 7Qlge5BZqMQvXxiy4HU3Hw ($6.50 in chips) 
Seat 8: jB7U2KxE3pjvDhvZHXK2Ag ($19.70 in chips) 
Seat 9: zUXhymECc2C9W9ZNw6qppA ($9.65 in chips) 
7Qlge5BZqMQvXxiy4HU3Hw: posts small blind $0.10
jB7U2KxE3pjvDhvZHXK2Ag: posts big blind $0.25
*** HOLE CARDS ***
zUXhymECc2C9W9ZNw6qppA: raises $0.75 to $1
+LseQ4csMghI3KY4cLSGMQ: calls $1
WEb58GPxGJGcxGh34AFZRQ: folds 
Rjy74A2wdEiDWplMcUbA+w: folds 
QB9VESHry/CRTDKMGwKwsQ: folds 
XwQK8xvCADxp0bUmji+Zyg: folds 
7Qlge5BZqMQvXxiy4HU3Hw: folds 
jB7U2KxE3pjvDhvZHXK2Ag: calls $0.75
*** FLOP *** [9h Qd Jd]
jB7U2KxE3pjvDhvZHXK2Ag: checks 
Rjy74A2wdEiDWplMcUbA+w said, "no, arkansas"
7Qlge5BZqMQvXxiy4HU3Hw said, "GUESS NOT"
zUXhymECc2C9W9ZNw6qppA: bets $8.65 and is all-in
+LseQ4csMghI3KY4cLSGMQ: folds 
jB7U2KxE3pjvDhvZHXK2Ag: calls $8.65
*** TURN *** [9h Qd Jd] [8h]
*** RIVER *** [9h Qd Jd 8h] [Jh]
*** SHOW DOWN ***
jB7U2KxE3pjvDhvZHXK2Ag: shows [Jc Td] (a straight, Eight to Queen)
zUXhymECc2C9W9ZNw6qppA: shows [Qc Qs] (a full house, Queens full of Jacks)
zUXhymECc2C9W9ZNw6qppA collected $19.40 from pot
*** SUMMARY ***
Total pot $20.40 | Rake $1 
Board [9h Qd Jd 8h Jh]
Seat 2: +LseQ4csMghI3KY4cLSGMQ folded on the Flop
Seat 3: WEb58GPxGJGcxGh34AFZRQ folded before Flop (didn't bet)
Seat 4: Rjy74A2wdEiDWplMcUbA+w folded before Flop (didn't bet)
Seat 5: QB9VESHry/CRTDKMGwKwsQ folded before Flop (didn't bet)
Seat 6: XwQK8xvCADxp0bUmji+Zyg (button) folded before Flop (didn't bet)
Seat 7: 7Qlge5BZqMQvXxiy4HU3Hw (small blind) folded before Flop
Seat 8: jB7U2KxE3pjvDhvZHXK2Ag (big blind) showed [Jc Td] and lost with a straight, Eight to Queen
Seat 9: zUXhymECc2C9W9ZNw6qppA showed [Qc Qs] and won ($19.40) with a full house, Queens full of Jacks




PokerStars Game #59941633166:  Hold'em No Limit ($0.10/$0.25) - 2009/07/01 1:41:20 ET
Table 'sCop8wmj9zlSS2KJqk1QKQ' 9-max Seat #9 is the button
Seat 1: dtZ84flFEi4Q+SGrHMJRDQ ($29.55 in chips) 
Seat 2: YZaC69gFrepA6oCGtu7E0w ($39.35 in chips) 
Seat 3: OwQek9i+x54ZA6dn6e8qhg ($12.20 in chips) 
Seat 4: msUzkZl2RntUnTl6E8WaNA ($10.65 in chips) 
Seat 5: sD+TKtt36XiiN6jqHiLwDA ($6.75 in chips) 
Seat 6: hZuGwtYmFKPmQ+v1wlmdfA ($43.05 in chips) 
Seat 7: sx0lGrkT9fd4yFR+3cXUQg ($11.85 in chips) 
Seat 8: xnVwSkROfRtOw4eSoDANtw ($20.30 in chips) 
Seat 9: tLcDklc2rBORNfixyRfVfw ($25 in chips) 
dtZ84flFEi4Q+SGrHMJRDQ: posts small blind $0.10
YZaC69gFrepA6oCGtu7E0w: posts big blind $0.25
*** HOLE CARDS ***
OwQek9i+x54ZA6dn6e8qhg: raises $0.75 to $1
msUzkZl2RntUnTl6E8WaNA: folds 
sD+TKtt36XiiN6jqHiLwDA: folds 
hZuGwtYmFKPmQ+v1wlmdfA: folds 
sx0lGrkT9fd4yFR+3cXUQg: folds 
xnVwSkROfRtOw4eSoDANtw: folds 
tLcDklc2rBORNfixyRfVfw: folds 
dtZ84flFEi4Q+SGrHMJRDQ: folds 
YZaC69gFrepA6oCGtu7E0w: folds 
Uncalled bet ($0.75) returned to OwQek9i+x54ZA6dn6e8qhg
OwQek9i+x54ZA6dn6e8qhg collected $0.60 from pot
OwQek9i+x54ZA6dn6e8qhg: doesn't show hand 
*** SUMMARY ***
Total pot $0.60 | Rake $0 
Seat 1: dtZ84flFEi4Q+SGrHMJRDQ (small blind) folded before Flop
Seat 2: YZaC69gFrepA6oCGtu7E0w (big blind) folded before Flop
Seat 3: OwQek9i+x54ZA6dn6e8qhg collected ($0.60)
Seat 4: msUzkZl2RntUnTl6E8WaNA folded before Flop (didn't bet)
Seat 5: sD+TKtt36XiiN6jqHiLwDA folded before Flop (didn't bet)
Seat 6: hZuGwtYmFKPmQ+v1wlmdfA folded before Flop (didn't bet)
Seat 7: sx0lGrkT9fd4yFR+3cXUQg folded before Flop (didn't bet)
Seat 8: xnVwSkROfRtOw4eSoDANtw folded before Flop (didn't bet)
Seat 9: tLcDklc2rBORNfixyRfVfw (button) folded before Flop (didn't bet)




PokerStars Game #59941633312:  Hold'em No Limit ($0.10/$0.25) - 2009/07/01 1:41:21 ET
Table '4mnXP0EWt9mMZYzTIVDQ0w' 9-max Seat #7 is the button
Seat 1: Z5y2J55JmfLYR6/DPAGHwQ ($24 in chips) 
Seat 2: BLEU2x2bnGRovIelAY6slA ($26.25 in chips) 
Seat 4: 9lvO/qyU+xrU95Teu1fv0g ($7 in chips) 
Seat 5: sSN8Y0AlsBeidZXPKmwXSw ($25.95 in chips) 
Seat 6: 5yjzPss7Y4kAWNDat3e0yQ ($29.10 in chips) 
Seat 7: OiV1PWZ3IkN29JlmCcnTwQ ($5.85 in chips) 
Seat 8: 9YN2IkT2JYYKFErZtZvCtA ($20.10 in chips) 
Seat 9: N/O9ADKpmqB2ASZuqgodlw ($5 in chips) 
9YN2IkT2JYYKFErZtZvCtA: posts small blind $0.10
N/O9ADKpmqB2ASZuqgodlw: posts big blind $0.25
*** HOLE CARDS ***
Z5y2J55JmfLYR6/DPAGHwQ: folds 
BLEU2x2bnGRovIelAY6slA: folds 
9lvO/qyU+xrU95Teu1fv0g: folds 
sSN8Y0AlsBeidZXPKmwXSw: folds 
5yjzPss7Y4kAWNDat3e0yQ: folds 
OiV1PWZ3IkN29JlmCcnTwQ: folds 
9YN2IkT2JYYKFErZtZvCtA: folds 
Uncalled bet ($0.15) returned to N/O9ADKpmqB2ASZuqgodlw
N/O9ADKpmqB2ASZuqgodlw collected $0.20 from pot
*** SUMMARY ***
Total pot $0.20 | Rake $0 
Seat 1: Z5y2J55JmfLYR6/DPAGHwQ folded before Flop (didn't bet)
Seat 2: BLEU2x2bnGRovIelAY6slA folded before Flop (didn't bet)
Seat 4: 9lvO/qyU+xrU95Teu1fv0g folded before Flop (didn't bet)
Seat 5: sSN8Y0AlsBeidZXPKmwXSw folded before Flop (didn't bet)
Seat 6: 5yjzPss7Y4kAWNDat3e0yQ folded before Flop (didn't bet)
Seat 7: OiV1PWZ3IkN29JlmCcnTwQ (button) folded before Flop (didn't bet)
Seat 8: 9YN2IkT2JYYKFErZtZvCtA (small blind) folded before Flop
Seat 9: N/O9ADKpmqB2ASZuqgodlw (big blind) collected ($0.20)




PokerStars Game #59941633600:  Hold'em No Limit ($0.10/$0.25) - 2009/07/01 1:41:21 ET
Table 'sJ4KpS2GE5Qrsu1/cFjJUw' 9-max Seat #2 is the button
Seat 2: tYsOBqdU1+x+yFI7zHO7hQ ($31.75 in chips) 
Seat 3: eK8qa6EPcH2zhtbmWSvc9g ($25 in chips) 
Seat 4: npAYqa85pqnzfOK5ukX+BQ ($23.15 in chips) 
Seat 5: Q/gZC63lfOMr7YhWKPCxoQ ($9.60 in chips) 
Seat 6: OefE+Csvj5KR7ClGf3Hc2g ($2.85 in chips) 
Seat 7: Wi8djHgewBlVhpKWfp7isQ ($8.75 in chips) 
Seat 8: S7Ki0P+0AIGPuIfGJjW0gg ($29.70 in chips) 
Seat 9: 3PmVnC/15cl4oyI1TKIt4g ($5 in chips) 
eK8qa6EPcH2zhtbmWSvc9g: posts small blind $0.10
npAYqa85pqnzfOK5ukX+BQ: posts big blind $0.25
*** HOLE CARDS ***
Q/gZC63lfOMr7YhWKPCxoQ: folds 
OefE+Csvj5KR7ClGf3Hc2g: folds 
Wi8djHgewBlVhpKWfp7isQ: calls $0.25
S7Ki0P+0AIGPuIfGJjW0gg: folds 
3PmVnC/15cl4oyI1TKIt4g: calls $0.25
tYsOBqdU1+x+yFI7zHO7hQ: folds 
eK8qa6EPcH2zhtbmWSvc9g: folds 
npAYqa85pqnzfOK5ukX+BQ: checks 
*** FLOP *** [2h 9d 3c]
npAYqa85pqnzfOK5ukX+BQ: checks 
diko01 joins the table at seat #1 
Wi8djHgewBlVhpKWfp7isQ: bets $0.50
3PmVnC/15cl4oyI1TKIt4g: folds 
npAYqa85pqnzfOK5ukX+BQ: calls $0.50
*** TURN *** [2h 9d 3c] [3d]
npAYqa85pqnzfOK5ukX+BQ: checks 
Wi8djHgewBlVhpKWfp7isQ: bets $0.50
npAYqa85pqnzfOK5ukX+BQ: raises $1.50 to $2
Wi8djHgewBlVhpKWfp7isQ: folds 
Uncalled bet ($1.50) returned to npAYqa85pqnzfOK5ukX+BQ
npAYqa85pqnzfOK5ukX+BQ collected $2.75 from pot
*** SUMMARY ***
Total pot $2.85 | Rake $0.10 
Board [2h 9d 3c 3d]
Seat 2: tYsOBqdU1+x+yFI7zHO7hQ (button) folded before Flop (didn't bet)
Seat 3: eK8qa6EPcH2zhtbmWSvc9g (small blind) folded before Flop
Seat 4: npAYqa85pqnzfOK5ukX+BQ (big blind) collected ($2.75)
Seat 5: Q/gZC63lfOMr7YhWKPCxoQ folded before Flop (didn't bet)
Seat 6: OefE+Csvj5KR7ClGf3Hc2g folded before Flop (didn't bet)
Seat 7: Wi8djHgewBlVhpKWfp7isQ folded on the Turn
Seat 8: S7Ki0P+0AIGPuIfGJjW0gg folded before Flop (didn't bet)
Seat 9: 3PmVnC/15cl4oyI1TKIt4g folded on the Flop




PokerStars Game #59941633602:  Hold'em No Limit ($0.10/$0.25) - 2009/07/01 1:41:21 ET
Table 'fIMYcWwN4/aXFJvH5Z8Ymg' 6-max Seat #2 is the button
Seat 1: DihMHaz4WNETH1bPDe13kA ($25 in chips) 
Seat 2: vu2kzHaDtgr6NM7rdq0chA ($26.45 in chips) 
Seat 4: 32YL2ZEp8NT4JB2RVM9euQ ($42.50 in chips) 
Seat 5: lquriepNQBhDV5P1SWHhnA ($25 in chips) 
Seat 6: jp34e617tIzV8tKIWmfAbA ($28.35 in chips) 
geomdnb will be allowed to play after the button
32YL2ZEp8NT4JB2RVM9euQ: posts small blind $0.10
lquriepNQBhDV5P1SWHhnA: posts big blind $0.25
*** HOLE CARDS ***
jp34e617tIzV8tKIWmfAbA: folds 
DihMHaz4WNETH1bPDe13kA: raises $0.50 to $0.75
vu2kzHaDtgr6NM7rdq0chA: folds 
32YL2ZEp8NT4JB2RVM9euQ: folds 
lquriepNQBhDV5P1SWHhnA: folds 
Uncalled bet ($0.50) returned to DihMHaz4WNETH1bPDe13kA
DihMHaz4WNETH1bPDe13kA collected $0.60 from pot
*** SUMMARY ***
Total pot $0.60 | Rake $0 
Seat 1: DihMHaz4WNETH1bPDe13kA collected ($0.60)
Seat 2: vu2kzHaDtgr6NM7rdq0chA (button) folded before Flop (didn't bet)
Seat 4: 32YL2ZEp8NT4JB2RVM9euQ (small blind) folded before Flop
Seat 5: lquriepNQBhDV5P1SWHhnA (big blind) folded before Flop
Seat 6: jp34e617tIzV8tKIWmfAbA folded before Flop (didn't bet)




PokerStars Game #59941633458:  Hold'em No Limit ($0.10/$0.25) - 2009/07/01 1:41:21 ET
Table 'VuY5ej47Cy8nOI3Wogmhzw' 6-max Seat #5 is the button
Seat 1: EeUZtMU058v2ObUACOF4Og ($38.60 in chips) 
Seat 2: AM6Yl+3esmhhMBlSnQhWbg ($16 in chips) 
Seat 3: v+QfkGiuj9bgtuNoVnDO8w ($31.50 in chips) 
Seat 5: iK/41//HmnLiIn0CVNNfyA ($12.05 in chips) 
EeUZtMU058v2ObUACOF4Og: posts small blind $0.10
AM6Yl+3esmhhMBlSnQhWbg: posts big blind $0.25
*** HOLE CARDS ***
v+QfkGiuj9bgtuNoVnDO8w: folds 
aXzjpue4eAQBqMdp87D3ZA leaves the table
iK/41//HmnLiIn0CVNNfyA: calls $0.25
Joe Santana joins the table at seat #4 
EeUZtMU058v2ObUACOF4Og: calls $0.15
AM6Yl+3esmhhMBlSnQhWbg: checks 
*** FLOP *** [8s 3d 7c]
EeUZtMU058v2ObUACOF4Og: bets $0.50
AM6Yl+3esmhhMBlSnQhWbg: calls $0.50
iK/41//HmnLiIn0CVNNfyA: calls $0.50
*** TURN *** [8s 3d 7c] [Kc]
EeUZtMU058v2ObUACOF4Og: checks 
AM6Yl+3esmhhMBlSnQhWbg: bets $1.75
iK/41//HmnLiIn0CVNNfyA: folds 
EeUZtMU058v2ObUACOF4Og: folds 
Uncalled bet ($1.75) returned to AM6Yl+3esmhhMBlSnQhWbg
AM6Yl+3esmhhMBlSnQhWbg collected $2.15 from pot
AM6Yl+3esmhhMBlSnQhWbg: doesn't show hand 
*** SUMMARY ***
Total pot $2.25 | Rake $0.10 
Board [8s 3d 7c Kc]
Seat 1: EeUZtMU058v2ObUACOF4Og (small blind) folded on the Turn
Seat 2: AM6Yl+3esmhhMBlSnQhWbg (big blind) collected ($2.15)
Seat 3: v+QfkGiuj9bgtuNoVnDO8w folded before Flop (didn't bet)
Seat 5: iK/41//HmnLiIn0CVNNfyA (button) folded on the Turn




PokerStars Game #59941633574:  Hold'em No Limit ($0.10/$0.25) - 2009/07/01 1:41:21 ET
Table '1HT8bEDpLPhOXxmqMtzF8w' 9-max Seat #3 is the button
Seat 1: YkkKQUDI0iWatY4h0WWaAQ ($11.20 in chips) 
Seat 2: r6hsffOo1iKmaPYKwAZmFw ($29 in chips) 
Seat 3: oLa/tXLfSLLB28mcLGrxcg ($24.75 in chips) 
Seat 4: aNpwfA31EREwO+ar4XzBCw ($25.10 in chips) 
Seat 5: CT2YIt3dXaE9eOIkS7FwNw ($24.65 in chips) 
Seat 7: PMhmqYBPHOAXjH25lRz69g ($21.05 in chips) 
Seat 8: ghNKXUBl/H+t83JF079ZBA ($29.25 in chips) 
aNpwfA31EREwO+ar4XzBCw: posts small blind $0.10
CT2YIt3dXaE9eOIkS7FwNw: posts big blind $0.25
bXpVeaSTPBFSPJmeXxO7nw: sits out 
*** HOLE CARDS ***
PMhmqYBPHOAXjH25lRz69g: raises $0.25 to $0.50
ghNKXUBl/H+t83JF079ZBA: raises $2.25 to $2.75
YkkKQUDI0iWatY4h0WWaAQ: folds 
DigiSlarks joins the table at seat #9 
r6hsffOo1iKmaPYKwAZmFw: folds 
oLa/tXLfSLLB28mcLGrxcg: folds 
aNpwfA31EREwO+ar4XzBCw: folds 
CT2YIt3dXaE9eOIkS7FwNw: folds 
PMhmqYBPHOAXjH25lRz69g: calls $2.25
*** FLOP *** [5s 3s 6d]
PMhmqYBPHOAXjH25lRz69g: checks 
ghNKXUBl/H+t83JF079ZBA: bets $4
PMhmqYBPHOAXjH25lRz69g: folds 
Uncalled bet ($4) returned to ghNKXUBl/H+t83JF079ZBA
ghNKXUBl/H+t83JF079ZBA collected $5.60 from pot
ghNKXUBl/H+t83JF079ZBA: doesn't show hand 
*** SUMMARY ***
Total pot $5.85 | Rake $0.25 
Board [5s 3s 6d]
Seat 1: YkkKQUDI0iWatY4h0WWaAQ folded before Flop (didn't bet)
Seat 2: r6hsffOo1iKmaPYKwAZmFw folded before Flop (didn't bet)
Seat 3: oLa/tXLfSLLB28mcLGrxcg (button) folded before Flop (didn't bet)
Seat 4: aNpwfA31EREwO+ar4XzBCw (small blind) folded before Flop
Seat 5: CT2YIt3dXaE9eOIkS7FwNw (big blind) folded before Flop
Seat 7: PMhmqYBPHOAXjH25lRz69g folded on the Flop
Seat 8: ghNKXUBl/H+t83JF079ZBA collected ($5.60)




PokerStars Game #59941633926:  Hold'em No Limit ($0.10/$0.25) - 2009/07/01 1:41:22 ET
Table '3LMlz3V4AziGlU+ikmyU8w' 6-max Seat #1 is the button
Seat 1: Wxq4Qyj0DnDXj2+taEOJFQ ($29.15 in chips) 
Seat 2: uR3AbFJLoOX86DOTtTgGcg ($25.45 in chips) 
Seat 3: Hzy03WtPHMYwLYM7hTTxQw ($25 in chips) 
Seat 4: 6DwBRH+xZ12AAZmeAg+aXw ($19.30 in chips) 
Seat 5: tOAk1Og4mVObMBOfvdDYOw ($26.10 in chips) 
Seat 6: ZZm/rg8aThjE+A2LiItuzA ($1.10 in chips) 
uR3AbFJLoOX86DOTtTgGcg: posts small blind $0.10
Hzy03WtPHMYwLYM7hTTxQw: posts big blind $0.25
*** HOLE CARDS ***
6DwBRH+xZ12AAZmeAg+aXw: raises $0.50 to $0.75
tOAk1Og4mVObMBOfvdDYOw: folds 
ZZm/rg8aThjE+A2LiItuzA: folds 
Wxq4Qyj0DnDXj2+taEOJFQ: folds 
uR3AbFJLoOX86DOTtTgGcg: calls $0.65
Hzy03WtPHMYwLYM7hTTxQw: folds 
*** FLOP *** [3d Qd 3c]
uR3AbFJLoOX86DOTtTgGcg: checks 
6DwBRH+xZ12AAZmeAg+aXw: checks 
*** TURN *** [3d Qd 3c] [7h]
uR3AbFJLoOX86DOTtTgGcg: checks 
6DwBRH+xZ12AAZmeAg+aXw: bets $1
uR3AbFJLoOX86DOTtTgGcg: folds 
Uncalled bet ($1) returned to 6DwBRH+xZ12AAZmeAg+aXw
6DwBRH+xZ12AAZmeAg+aXw collected $1.70 from pot
6DwBRH+xZ12AAZmeAg+aXw: doesn't show hand 
*** SUMMARY ***
Total pot $1.75 | Rake $0.05 
Board [3d Qd 3c 7h]
Seat 1: Wxq4Qyj0DnDXj2+taEOJFQ (button) folded before Flop (didn't bet)
Seat 2: uR3AbFJLoOX86DOTtTgGcg (small blind) folded on the Turn
Seat 3: Hzy03WtPHMYwLYM7hTTxQw (big blind) folded before Flop
Seat 4: 6DwBRH+xZ12AAZmeAg+aXw collected ($1.70)
Seat 5: tOAk1Og4mVObMBOfvdDYOw folded before Flop (didn't bet)
Seat 6: ZZm/rg8aThjE+A2LiItuzA folded before Flop (didn't bet)




PokerStars Game #59941634342:  Hold'em No Limit ($0.10/$0.25) - 2009/07/01 1:41:22 ET
Table '6aL2C8IFwHHr6SG6RgXaow' 9-max Seat #4 is the button
Seat 1: AKrlhR3s97+cfTtZj3tKjw ($3.65 in chips) 
Seat 3: aCVg6cCxQcqClhB9nq/p1w ($12.35 in chips) 
Seat 4: BT6Oal0iO4P6kDuT7HFQDw ($19.35 in chips) 
Seat 5: wre31HfyzQGpIvID1istxw ($20.95 in chips) 
Seat 6: gehe91e0IyVT0QU/XBkEyg ($27.45 in chips) 
Seat 7: QJxYAPJ6uPZZcpdN+RvWcQ ($25 in chips) 
Seat 8: rQhYIYXSyH/IivYM1dlV5A ($21.65 in chips) 
Seat 9: CgIo2ItZqi4o3ayVG6HanQ ($23.75 in chips) 
wre31HfyzQGpIvID1istxw: posts small blind $0.10
gehe91e0IyVT0QU/XBkEyg: posts big blind $0.25
*** HOLE CARDS ***
QJxYAPJ6uPZZcpdN+RvWcQ: folds 
rQhYIYXSyH/IivYM1dlV5A: folds 
CgIo2ItZqi4o3ayVG6HanQ: folds 
AKrlhR3s97+cfTtZj3tKjw: folds 
aCVg6cCxQcqClhB9nq/p1w: folds 
BT6Oal0iO4P6kDuT7HFQDw: folds 
wre31HfyzQGpIvID1istxw: calls $0.15
gehe91e0IyVT0QU/XBkEyg: checks 
*** FLOP *** [Qc 4c Ad]
wre31HfyzQGpIvID1istxw: checks 
gehe91e0IyVT0QU/XBkEyg: checks 
*** TURN *** [Qc 4c Ad] [5c]
wre31HfyzQGpIvID1istxw: bets $0.75
gehe91e0IyVT0QU/XBkEyg: folds 
Uncalled bet ($0.75) returned to wre31HfyzQGpIvID1istxw
wre31HfyzQGpIvID1istxw collected $0.50 from pot
wre31HfyzQGpIvID1istxw: doesn't show hand 
*** SUMMARY ***
Total pot $0.50 | Rake $0 
Board [Qc 4c Ad 5c]
Seat 1: AKrlhR3s97+cfTtZj3tKjw folded before Flop (didn't bet)
Seat 3: aCVg6cCxQcqClhB9nq/p1w folded before Flop (didn't bet)
Seat 4: BT6Oal0iO4P6kDuT7HFQDw (button) folded before Flop (didn't bet)
Seat 5: wre31HfyzQGpIvID1istxw (small blind) collected ($0.50)
Seat 6: gehe91e0IyVT0QU/XBkEyg (big blind) folded on the Turn
Seat 7: QJxYAPJ6uPZZcpdN+RvWcQ folded before Flop (didn't bet)
Seat 8: rQhYIYXSyH/IivYM1dlV5A folded before Flop (didn't bet)
Seat 9: CgIo2ItZqi4o3ayVG6HanQ folded before Flop (didn't bet)




PokerStars Game #59941634230:  Hold'em No Limit ($0.10/$0.25) - 2009/07/01 1:41:22 ET
Table 'nc6OeGk/wtaWV+6N+kgnZQgZetDqJh6q9A3mLO3ThCsASeat #2 is the button
Seat 1: DihMHaz4WNETH1bPDe13kA ($26.65 in chips) 
Seat 2: JFIAqU8lCZ0vWwEl4bdGsg ($33.05 in chips) 
Seat 3: jp34e617tIzV8tKIWmfAbA ($32.90 in chips) 
Seat 4: BV+K0Phf5VBHr7aZPKqbUQ ($29 in chips) 
Seat 6: 8tR2s7yV/Fr0ePp1w5XnJw ($9.65 in chips) 
jp34e617tIzV8tKIWmfAbA: posts small blind $0.10
BV+K0Phf5VBHr7aZPKqbUQ: posts big blind $0.25
*** HOLE CARDS ***
8tR2s7yV/Fr0ePp1w5XnJw: folds 
DihMHaz4WNETH1bPDe13kA: folds 
JFIAqU8lCZ0vWwEl4bdGsg: folds 
jp34e617tIzV8tKIWmfAbA: folds 
Uncalled bet ($0.15) returned to BV+K0Phf5VBHr7aZPKqbUQ
BV+K0Phf5VBHr7aZPKqbUQ collected $0.20 from pot
BV+K0Phf5VBHr7aZPKqbUQ: doesn't show hand 
*** SUMMARY ***
Total pot $0.20 | Rake $0 
Seat 1: DihMHaz4WNETH1bPDe13kA folded before Flop (didn't bet)
Seat 2: JFIAqU8lCZ0vWwEl4bdGsg (button) folded before Flop (didn't bet)
Seat 3: jp34e617tIzV8tKIWmfAbA (small blind) folded before Flop
Seat 4: BV+K0Phf5VBHr7aZPKqbUQ (big blind) collected ($0.20)
Seat 6: 8tR2s7yV/Fr0ePp1w5XnJw folded before Flop (didn't bet)




PokerStars Game #59941634186:  Hold'em No Limit ($0.10/$0.25) - 2009/07/01 1:41:22 ET
Table '+198VWQSWBhYQOcizzuBkw' 6-max Seat #4 is the button
Seat 1: 34ttqW62uIRrqINCCmLcsw ($11.30 in chips) 
Seat 3: vw7gefupgmOJJN8lUemdWg ($23.90 in chips) 
Seat 4: TgDsTeCdLQt8kWbL00ByRA ($16.25 in chips) 
Seat 5: LtASJ9OlkqGrrUKGQlpGAw ($26.70 in chips) 
Seat 6: leEQ84f6wJYu5SB/vj27wg ($11.05 in chips) 
LtASJ9OlkqGrrUKGQlpGAw: posts small blind $0.10
leEQ84f6wJYu5SB/vj27wg: posts big blind $0.25
iauW7L/+7qzAuHow7CD75Q: sits out 
*** HOLE CARDS ***
34ttqW62uIRrqINCCmLcsw: calls $0.25
vw7gefupgmOJJN8lUemdWg: folds 
TgDsTeCdLQt8kWbL00ByRA: folds 
LtASJ9OlkqGrrUKGQlpGAw: calls $0.15
leEQ84f6wJYu5SB/vj27wg: checks 
*** FLOP *** [8h 8s 3s]
LtASJ9OlkqGrrUKGQlpGAw: checks 
leEQ84f6wJYu5SB/vj27wg: bets $0.45
34ttqW62uIRrqINCCmLcsw: raises $0.55 to $1
LtASJ9OlkqGrrUKGQlpGAw: folds 
leEQ84f6wJYu5SB/vj27wg: folds 
Uncalled bet ($0.55) returned to 34ttqW62uIRrqINCCmLcsw
34ttqW62uIRrqINCCmLcsw collected $1.60 from pot
34ttqW62uIRrqINCCmLcsw: doesn't show hand 
*** SUMMARY ***
Total pot $1.65 | Rake $0.05 
Board [8h 8s 3s]
Seat 1: 34ttqW62uIRrqINCCmLcsw collected ($1.60)
Seat 3: vw7gefupgmOJJN8lUemdWg folded before Flop (didn't bet)
Seat 4: TgDsTeCdLQt8kWbL00ByRA (button) folded before Flop (didn't bet)
Seat 5: LtASJ9OlkqGrrUKGQlpGAw (small blind) folded on the Flop
Seat 6: leEQ84f6wJYu5SB/vj27wg (big blind) folded on the Flop




PokerStars Game #59941634072:  Hold'em No Limit ($0.10/$0.25) - 2009/07/01 1:41:22 ET
Table 'MJ1SB76A4qJrlEa+C5e/8w' 6-max Seat #2 is the button
Seat 1: 0KDZiuXQg6UI9cqBR/AUnQ ($26 in chips) 
Seat 2: UA5OsKS3VPaxa7uC8La/kA ($36.35 in chips) 
Seat 3: DihMHaz4WNETH1bPDe13kA ($33 in chips) 
Seat 4: SFmT9ZsVopnukjvAzrxTRg ($28.15 in chips) 
Seat 6: JFIAqU8lCZ0vWwEl4bdGsg ($30.30 in chips) 
DihMHaz4WNETH1bPDe13kA: posts small blind $0.10
SFmT9ZsVopnukjvAzrxTRg: posts big blind $0.25
Hsvkc0/G2VV78oVmWYXecw: sits out 
*** HOLE CARDS ***
JFIAqU8lCZ0vWwEl4bdGsg: folds 
0KDZiuXQg6UI9cqBR/AUnQ: folds 
UA5OsKS3VPaxa7uC8La/kA: raises $0.50 to $0.75
DihMHaz4WNETH1bPDe13kA: folds 
SFmT9ZsVopnukjvAzrxTRg: folds 
Uncalled bet ($0.50) returned to UA5OsKS3VPaxa7uC8La/kA
UA5OsKS3VPaxa7uC8La/kA collected $0.60 from pot
*** SUMMARY ***
Total pot $0.60 | Rake $0 
Seat 1: 0KDZiuXQg6UI9cqBR/AUnQ folded before Flop (didn't bet)
Seat 2: UA5OsKS3VPaxa7uC8La/kA (button) collected ($0.60)
Seat 3: DihMHaz4WNETH1bPDe13kA (small blind) folded before Flop
Seat 4: SFmT9ZsVopnukjvAzrxTRg (big blind) folded before Flop
Seat 6: JFIAqU8lCZ0vWwEl4bdGsg folded before Flop (didn't bet)




PokerStars Game #59941634718:  Hold'em No Limit ($0.10/$0.25) - 2009/07/01 1:41:23 ET
Table 'nFlmVztKq1HJEWfxmdl15w' 9-max Seat #8 is the button
Seat 1: cZ99hugmLBj9KhTlc8nCSw ($25 in chips) 
Seat 2: Th3FldXKQW6hWVVPahaoOQ ($38.75 in chips) 
Seat 4: +5dSUwD+/k2ktlnutSMivw ($9.05 in chips) 
Seat 5: Tx6zQdk5Ozt9ObEBlU7jeg ($32.45 in chips) 
Seat 6: 4awUyiDYTgylQKXZ9faBVA ($36 in chips) 
Seat 7: dfNim92Z6XK1/h5SFW5vDg ($26.50 in chips) 
Seat 8: +2kMBNpY4nF1qNCRd8SJLA ($33.90 in chips) 
Seat 9: DnDcAdn9P0zGovMERigpFA ($25 in chips) 
DnDcAdn9P0zGovMERigpFA: posts small blind $0.10
cZ99hugmLBj9KhTlc8nCSw: posts big blind $0.25
DdPXdieucQ+n99u1n3A+rQ: sits out 
*** HOLE CARDS ***
Th3FldXKQW6hWVVPahaoOQ: folds 
+5dSUwD+/k2ktlnutSMivw: calls $0.25
Tx6zQdk5Ozt9ObEBlU7jeg: folds 
4awUyiDYTgylQKXZ9faBVA: folds 
dfNim92Z6XK1/h5SFW5vDg: folds 
+2kMBNpY4nF1qNCRd8SJLA: folds 
DnDcAdn9P0zGovMERigpFA: folds 
cZ99hugmLBj9KhTlc8nCSw: checks 
*** FLOP *** [8h 2d 6s]
cZ99hugmLBj9KhTlc8nCSw: checks 
+5dSUwD+/k2ktlnutSMivw: bets $0.50
cZ99hugmLBj9KhTlc8nCSw: folds 
Uncalled bet ($0.50) returned to +5dSUwD+/k2ktlnutSMivw
+5dSUwD+/k2ktlnutSMivw collected $0.60 from pot
+5dSUwD+/k2ktlnutSMivw: doesn't show hand 
*** SUMMARY ***
Total pot $0.60 | Rake $0 
Board [8h 2d 6s]
Seat 1: cZ99hugmLBj9KhTlc8nCSw (big blind) folded on the Flop
Seat 2: Th3FldXKQW6hWVVPahaoOQ folded before Flop (didn't bet)
Seat 4: +5dSUwD+/k2ktlnutSMivw collected ($0.60)
Seat 5: Tx6zQdk5Ozt9ObEBlU7jeg folded before Flop (didn't bet)
Seat 6: 4awUyiDYTgylQKXZ9faBVA folded before Flop (didn't bet)
Seat 7: dfNim92Z6XK1/h5SFW5vDg folded before Flop (didn't bet)
Seat 8: +2kMBNpY4nF1qNCRd8SJLA (button) folded before Flop (didn't bet)
Seat 9: DnDcAdn9P0zGovMERigpFA (small blind) folded before Flop




PokerStars Game #59941634424:  Hold'em No Limit ($0.10/$0.25) - 2009/07/01 1:41:23 ET
Table 'sm5gqEvXgLbkkE4dryW/5g' 6-max Seat #2 is the button
Seat 1: v8m8XHovI5tqEA9mvplDSw ($38.70 in chips) 
Seat 2: 5xs5/u2z1CO9zkRvH72MQg ($17.55 in chips) 
Seat 3: UT5XpwOH1ipkOF7n1MqDJA ($26 in chips) 
Seat 4: cWc85bEzdRzpUMhRKm8pwQ ($25.25 in chips) 
Seat 6: aogAb4Eienxztk8p2v9VVw ($21.05 in chips) 
UT5XpwOH1ipkOF7n1MqDJA: posts small blind $0.10
cWc85bEzdRzpUMhRKm8pwQ: posts big blind $0.25
*** HOLE CARDS ***
aogAb4Eienxztk8p2v9VVw: calls $0.25
v8m8XHovI5tqEA9mvplDSw: folds 
5xs5/u2z1CO9zkRvH72MQg: calls $0.25
UT5XpwOH1ipkOF7n1MqDJA: calls $0.15
cWc85bEzdRzpUMhRKm8pwQ: raises $1.25 to $1.50
aogAb4Eienxztk8p2v9VVw: calls $1.25
5xs5/u2z1CO9zkRvH72MQg: folds 
UT5XpwOH1ipkOF7n1MqDJA: folds 
*** FLOP *** [Qs 8d 8h]
cWc85bEzdRzpUMhRKm8pwQ: bets $2.25
aogAb4Eienxztk8p2v9VVw: folds 
Uncalled bet ($2.25) returned to cWc85bEzdRzpUMhRKm8pwQ
cWc85bEzdRzpUMhRKm8pwQ collected $3.35 from pot
*** SUMMARY ***
Total pot $3.50 | Rake $0.15 
Board [Qs 8d 8h]
Seat 1: v8m8XHovI5tqEA9mvplDSw folded before Flop (didn't bet)
Seat 2: 5xs5/u2z1CO9zkRvH72MQg (button) folded before Flop
Seat 3: UT5XpwOH1ipkOF7n1MqDJA (small blind) folded before Flop
Seat 4: cWc85bEzdRzpUMhRKm8pwQ (big blind) collected ($3.35)
Seat 6: aogAb4Eienxztk8p2v9VVw folded on the Flop




PokerStars Game #59941634764:  Hold'em No Limit ($0.10/$0.25) - 2009/07/01 1:41:23 ET
Table '+UzantPJ4smVdrh+4GTu1w' 6-max Seat #4 is the button
Seat 1: TSmua8tGK3sTbwi0ynrW9Q ($27.70 in chips) 
Seat 3: SS/yfeArhULzIcOPe8MdPg ($34.55 in chips) 
Seat 4: UmcUp27+PbgBItv3ZNlAWQ ($25 in chips) 
Seat 5: cj4VBQya7HtVL2zCGd5jLQ ($55.45 in chips) 
Seat 6: fZQg9veL7Dd/Z04ZTjC+wQ ($25 in chips) 
cj4VBQya7HtVL2zCGd5jLQ: posts small blind $0.10
fZQg9veL7Dd/Z04ZTjC+wQ: posts big blind $0.25
tcbEu7VzyHQ+0lh+skbQhQ: sits out 
*** HOLE CARDS ***
TSmua8tGK3sTbwi0ynrW9Q: folds 
SS/yfeArhULzIcOPe8MdPg: folds 
UmcUp27+PbgBItv3ZNlAWQ: calls $0.25
cj4VBQya7HtVL2zCGd5jLQ: calls $0.15
fZQg9veL7Dd/Z04ZTjC+wQ: checks 
*** FLOP *** [4d Kh 8c]
cj4VBQya7HtVL2zCGd5jLQ: checks 
fZQg9veL7Dd/Z04ZTjC+wQ: checks 
UmcUp27+PbgBItv3ZNlAWQ: bets $1
cj4VBQya7HtVL2zCGd5jLQ: folds 
fZQg9veL7Dd/Z04ZTjC+wQ: folds 
Uncalled bet ($1) returned to UmcUp27+PbgBItv3ZNlAWQ
UmcUp27+PbgBItv3ZNlAWQ collected $0.75 from pot
UmcUp27+PbgBItv3ZNlAWQ: doesn't show hand 
*** SUMMARY ***
Total pot $0.75 | Rake $0 
Board [4d Kh 8c]
Seat 1: TSmua8tGK3sTbwi0ynrW9Q folded before Flop (didn't bet)
Seat 3: SS/yfeArhULzIcOPe8MdPg folded before Flop (didn't bet)
Seat 4: UmcUp27+PbgBItv3ZNlAWQ (button) collected ($0.75)
Seat 5: cj4VBQya7HtVL2zCGd5jLQ (small blind) folded on the Flop
Seat 6: fZQg9veL7Dd/Z04ZTjC+wQ (big blind) folded on the Flop




PokerStars Game #59941634646:  Hold'em No Limit ($0.10/$0.25) - 2009/07/01 1:41:23 ET
Table '/JJyyIstHfkT7t/bW+WXgg' 6-max Seat #3 is the button
Seat 1: wsP46AGpqDjHZQmlRHKa9g ($25.85 in chips) 
Seat 2: obJgSnVgWWWaAUtVILo77Q ($7.75 in chips) 
Seat 3: DR0nVIhVP77oEBlO9J8vlg ($45.65 in chips) 
Seat 4: JFIAqU8lCZ0vWwEl4bdGsg ($35.50 in chips) 
Seat 5: +ZlnqPoP3Hg4BIUxDfKd/A ($48.50 in chips) 
JFIAqU8lCZ0vWwEl4bdGsg: posts small blind $0.10
+ZlnqPoP3Hg4BIUxDfKd/A: posts big blind $0.25
UmcUp27+PbgBItv3ZNlAWQ: sits out 
*** HOLE CARDS ***
wsP46AGpqDjHZQmlRHKa9g: folds 
obJgSnVgWWWaAUtVILo77Q: folds 
DR0nVIhVP77oEBlO9J8vlg: calls $0.25
JFIAqU8lCZ0vWwEl4bdGsg: folds 
+ZlnqPoP3Hg4BIUxDfKd/A: checks 
*** FLOP *** [Qh 7s 2h]
+ZlnqPoP3Hg4BIUxDfKd/A: checks 
DR0nVIhVP77oEBlO9J8vlg: bets $0.50
+ZlnqPoP3Hg4BIUxDfKd/A: folds 
Uncalled bet ($0.50) returned to DR0nVIhVP77oEBlO9J8vlg
DR0nVIhVP77oEBlO9J8vlg collected $0.60 from pot
DR0nVIhVP77oEBlO9J8vlg: doesn't show hand 
*** SUMMARY ***
Total pot $0.60 | Rake $0 
Board [Qh 7s 2h]
Seat 1: wsP46AGpqDjHZQmlRHKa9g folded before Flop (didn't bet)
Seat 2: obJgSnVgWWWaAUtVILo77Q folded before Flop (didn't bet)
Seat 3: DR0nVIhVP77oEBlO9J8vlg (button) collected ($0.60)
Seat 4: JFIAqU8lCZ0vWwEl4bdGsg (small blind) folded before Flop
Seat 5: +ZlnqPoP3Hg4BIUxDfKd/A (big blind) folded on the Flop




PokerStars Game #59941634710:  Hold'em No Limit ($0.10/$0.25) - 2009/07/01 1:41:23 ET
Table '0w9m+UkNlGMNoPyQqzWk6A' 9-max Seat #3 is the button
Seat 1: yoL2UPRJrmSO7wXIS4Ak4g ($27.85 in chips) 
Seat 2: tYsOBqdU1+x+yFI7zHO7hQ ($50.05 in chips) 
Seat 3: VWwtMkIjXloiX/RKh7RGWQ ($7.40 in chips) 
Seat 4: z5GxcHlYz/GSz6W2uFiTtg ($23.25 in chips) 
Seat 5: HPEB+AtKw1+C/cxU0o1ciw ($49.05 in chips) 
Seat 6: CgIo2ItZqi4o3ayVG6HanQ ($30.65 in chips) 
Seat 7: 57qrNGHDvf6GhB8zVLsAtQ ($4.80 in chips) 
Seat 8: I+ARcuQBEroNUEjIZ2pprg ($14 in chips) 
Seat 9: KqS/lY/fNB9qUxokm9QfeA ($16 in chips) 
z5GxcHlYz/GSz6W2uFiTtg: posts small blind $0.10
HPEB+AtKw1+C/cxU0o1ciw: posts big blind $0.25
*** HOLE CARDS ***
CgIo2ItZqi4o3ayVG6HanQ: folds 
57qrNGHDvf6GhB8zVLsAtQ: folds 
I+ARcuQBEroNUEjIZ2pprg: raises $0.50 to $0.75
KqS/lY/fNB9qUxokm9QfeA: folds 
yoL2UPRJrmSO7wXIS4Ak4g: folds 
tYsOBqdU1+x+yFI7zHO7hQ: folds 
VWwtMkIjXloiX/RKh7RGWQ: folds 
z5GxcHlYz/GSz6W2uFiTtg: folds 
HPEB+AtKw1+C/cxU0o1ciw: folds 
Uncalled bet ($0.50) returned to I+ARcuQBEroNUEjIZ2pprg
I+ARcuQBEroNUEjIZ2pprg collected $0.60 from pot
I+ARcuQBEroNUEjIZ2pprg: doesn't show hand 
*** SUMMARY ***
Total pot $0.60 | Rake $0 
Seat 1: yoL2UPRJrmSO7wXIS4Ak4g folded before Flop (didn't bet)
Seat 2: tYsOBqdU1+x+yFI7zHO7hQ folded before Flop (didn't bet)
Seat 3: VWwtMkIjXloiX/RKh7RGWQ (button) folded before Flop (didn't bet)
Seat 4: z5GxcHlYz/GSz6W2uFiTtg (small blind) folded before Flop
Seat 5: HPEB+AtKw1+C/cxU0o1ciw (big blind) folded before Flop
Seat 6: CgIo2ItZqi4o3ayVG6HanQ folded before Flop (didn't bet)
Seat 7: 57qrNGHDvf6GhB8zVLsAtQ folded before Flop (didn't bet)
Seat 8: I+ARcuQBEroNUEjIZ2pprg collected ($0.60)
Seat 9: KqS/lY/fNB9qUxokm9QfeA folded before Flop (didn't bet)




PokerStars Game #59941634524:  Hold'em No Limit ($0.10/$0.25) - 2009/07/01 1:41:23 ET
Table 'P1IJQ2p3ACFySC35W1qwQw' 9-max Seat #7 is the button
Seat 1: bXpVeaSTPBFSPJmeXxO7nw ($4.65 in chips) 
Seat 2: vO3QVRovWemcGMkm7ijAIA ($5.70 in chips) 
Seat 3: PVxvfRTRvkgZf9WtquEkwQ ($25.35 in chips) 
Seat 4: c/9X4zftzphFxYtxp5kp9w ($28.15 in chips) 
Seat 5: ghNKXUBl/H+t83JF079ZBA ($56.45 in chips) 
Seat 6: ljemhp25Zg+nlA9DLCIiUw ($64.45 in chips) 
Seat 7: 7je+LC5Mfs6nL8YBVh4frQ ($4.30 in chips) 
Seat 8: tLcDklc2rBORNfixyRfVfw ($26 in chips) 
Seat 9: XXajyXkgbSGJKxQP3mal/Q ($15.75 in chips) 
tLcDklc2rBORNfixyRfVfw: posts small blind $0.10
XXajyXkgbSGJKxQP3mal/Q: posts big blind $0.25
*** HOLE CARDS ***
bXpVeaSTPBFSPJmeXxO7nw: folds 
vO3QVRovWemcGMkm7ijAIA: folds 
PVxvfRTRvkgZf9WtquEkwQ: folds 
c/9X4zftzphFxYtxp5kp9w: folds 
ghNKXUBl/H+t83JF079ZBA: folds 
ljemhp25Zg+nlA9DLCIiUw: folds 
7je+LC5Mfs6nL8YBVh4frQ: raises $0.50 to $0.75
tLcDklc2rBORNfixyRfVfw: folds 
XXajyXkgbSGJKxQP3mal/Q: calls $0.50
*** FLOP *** [6d Ad Ac]
XXajyXkgbSGJKxQP3mal/Q: checks 
7je+LC5Mfs6nL8YBVh4frQ: bets $1.50
XXajyXkgbSGJKxQP3mal/Q: folds 
Uncalled bet ($1.50) returned to 7je+LC5Mfs6nL8YBVh4frQ
7je+LC5Mfs6nL8YBVh4frQ collected $1.55 from pot
7je+LC5Mfs6nL8YBVh4frQ: doesn't show hand 
*** SUMMARY ***
Total pot $1.60 | Rake $0.05 
Board [6d Ad Ac]
Seat 1: bXpVeaSTPBFSPJmeXxO7nw folded before Flop (didn't bet)
Seat 2: vO3QVRovWemcGMkm7ijAIA folded before Flop (didn't bet)
Seat 3: PVxvfRTRvkgZf9WtquEkwQ folded before Flop (didn't bet)
Seat 4: c/9X4zftzphFxYtxp5kp9w folded before Flop (didn't bet)
Seat 5: ghNKXUBl/H+t83JF079ZBA folded before Flop (didn't bet)
Seat 6: ljemhp25Zg+nlA9DLCIiUw folded before Flop (didn't bet)
Seat 7: 7je+LC5Mfs6nL8YBVh4frQ (button) collected ($1.55)
Seat 8: tLcDklc2rBORNfixyRfVfw (small blind) folded before Flop
Seat 9: XXajyXkgbSGJKxQP3mal/Q (big blind) folded on the Flop




PokerStars Game #59941634862:  Hold'em No Limit ($0.10/$0.25) - 2009/07/01 1:41:23 ET
Table 'NgexmgEDEzICBeSO7YCrKQ' 6-max Seat #2 is the button
Seat 1: cezpHJ8FB07dj0xG+LhOvw ($29.80 in chips) 
Seat 2: 32YL2ZEp8NT4JB2RVM9euQ ($21.55 in chips) 
Seat 3: JFIAqU8lCZ0vWwEl4bdGsg ($26.95 in chips) 
Seat 4: xx+iYCDJhHJmNzrfeloyEg ($26.20 in chips) 
Seat 5: /MXkdT8TTs8Qp2LVTQNw6w ($37.80 in chips) 
Seat 6: k9nHZTHt8hYhYRcW8NTb4g ($12.70 in chips) 
JFIAqU8lCZ0vWwEl4bdGsg: posts small blind $0.10
xx+iYCDJhHJmNzrfeloyEg: posts big blind $0.25
*** HOLE CARDS ***
/MXkdT8TTs8Qp2LVTQNw6w: folds 
k9nHZTHt8hYhYRcW8NTb4g: raises $0.50 to $0.75
cezpHJ8FB07dj0xG+LhOvw: folds 
32YL2ZEp8NT4JB2RVM9euQ: folds 
JFIAqU8lCZ0vWwEl4bdGsg: folds 
xx+iYCDJhHJmNzrfeloyEg: calls $0.50
*** FLOP *** [4d 9d 2s]
xx+iYCDJhHJmNzrfeloyEg: checks 
k9nHZTHt8hYhYRcW8NTb4g: bets $1
xx+iYCDJhHJmNzrfeloyEg: raises $2 to $3
k9nHZTHt8hYhYRcW8NTb4g: folds 
Uncalled bet ($2) returned to xx+iYCDJhHJmNzrfeloyEg
xx+iYCDJhHJmNzrfeloyEg collected $3.45 from pot
xx+iYCDJhHJmNzrfeloyEg: doesn't show hand 
*** SUMMARY ***
Total pot $3.60 | Rake $0.15 
Board [4d 9d 2s]
Seat 1: cezpHJ8FB07dj0xG+LhOvw folded before Flop (didn't bet)
Seat 2: 32YL2ZEp8NT4JB2RVM9euQ (button) folded before Flop (didn't bet)
Seat 3: JFIAqU8lCZ0vWwEl4bdGsg (small blind) folded before Flop
Seat 4: xx+iYCDJhHJmNzrfeloyEg (big blind) collected ($3.45)
Seat 5: /MXkdT8TTs8Qp2LVTQNw6w folded before Flop (didn't bet)
Seat 6: k9nHZTHt8hYhYRcW8NTb4g folded on the Flop




PokerStars Game #59941634776:  Hold'em No Limit ($0.10/$0.25) - 2009/07/01 1:41:23 ET
Table '84TjTrgbsYZladOc4PWf4Q' 6-max Seat #5 is the button
Seat 1: /kW0t5kKllzd8HO2uEapHQ ($24.95 in chips) 
Seat 2: RpaEX9P7BCvyfPRLiRNg0A ($39.95 in chips) 
Seat 3: Ar4vsUIUfJ7gbYh1c1m59g ($12.35 in chips) 
Seat 4: SxIIgwXYLkwd6m3wLyPTCw ($21.95 in chips) 
Seat 5: cezpHJ8FB07dj0xG+LhOvw ($25 in chips) 
Seat 6: wCUaomJ6Nq5zomVGdUHP+w ($19.25 in chips) 
wCUaomJ6Nq5zomVGdUHP+w: posts small blind $0.10
/kW0t5kKllzd8HO2uEapHQ: posts big blind $0.25
*** HOLE CARDS ***
RpaEX9P7BCvyfPRLiRNg0A: folds 
Ar4vsUIUfJ7gbYh1c1m59g: folds 
SxIIgwXYLkwd6m3wLyPTCw: folds 
cezpHJ8FB07dj0xG+LhOvw: raises $0.50 to $0.75
wCUaomJ6Nq5zomVGdUHP+w: calls $0.65
/kW0t5kKllzd8HO2uEapHQ: calls $0.50
*** FLOP *** [6h 9s 3d]
wCUaomJ6Nq5zomVGdUHP+w: checks 
/kW0t5kKllzd8HO2uEapHQ: bets $0.50
cezpHJ8FB07dj0xG+LhOvw: raises $1.70 to $2.20
wCUaomJ6Nq5zomVGdUHP+w: folds 
/kW0t5kKllzd8HO2uEapHQ: folds 
Uncalled bet ($1.70) returned to cezpHJ8FB07dj0xG+LhOvw
cezpHJ8FB07dj0xG+LhOvw collected $3.10 from pot
*** SUMMARY ***
Total pot $3.25 | Rake $0.15 
Board [6h 9s 3d]
Seat 1: /kW0t5kKllzd8HO2uEapHQ (big blind) folded on the Flop
Seat 2: RpaEX9P7BCvyfPRLiRNg0A folded before Flop (didn't bet)
Seat 3: Ar4vsUIUfJ7gbYh1c1m59g folded before Flop (didn't bet)
Seat 4: SxIIgwXYLkwd6m3wLyPTCw folded before Flop (didn't bet)
Seat 5: cezpHJ8FB07dj0xG+LhOvw (button) collected ($3.10)
Seat 6: wCUaomJ6Nq5zomVGdUHP+w (small blind) folded on the Flop




PokerStars Game #59941634422:  Hold'em No Limit ($0.10/$0.25) - 2009/07/01 1:41:23 ET
Table 'ER5H84HUgJx7HyDLnELLeA' 6-max Seat #5 is the button
Seat 1: LJI7A1YgDM7hgh7o56+ReQ ($27.50 in chips) 
Seat 2: buyjetgNT1McXtdaP4zynA ($20.25 in chips) 
Seat 3: memV5jkoAdGrnRy3Q9PM7w ($19.55 in chips) 
Seat 4: vqWjZmdQu/Hxw96/IJTWdQ ($25 in chips) 
Seat 5: mfrkWA3PTeYPkbO6hi98Aw ($25.55 in chips) 
Seat 6: 3zD3qLXT1bEffAoWGnc7wg ($51.10 in chips) 
3zD3qLXT1bEffAoWGnc7wg: posts small blind $0.10
LJI7A1YgDM7hgh7o56+ReQ: posts big blind $0.25
*** HOLE CARDS ***
buyjetgNT1McXtdaP4zynA has timed out
buyjetgNT1McXtdaP4zynA: folds 
buyjetgNT1McXtdaP4zynA is sitting out
memV5jkoAdGrnRy3Q9PM7w: calls $0.25
vqWjZmdQu/Hxw96/IJTWdQ: folds 
mfrkWA3PTeYPkbO6hi98Aw: folds 
3zD3qLXT1bEffAoWGnc7wg: folds 
LJI7A1YgDM7hgh7o56+ReQ: checks 
*** FLOP *** [4c Ac 5d]
LJI7A1YgDM7hgh7o56+ReQ: checks 
memV5jkoAdGrnRy3Q9PM7w: checks 
*** TURN *** [4c Ac 5d] [3d]
LJI7A1YgDM7hgh7o56+ReQ: checks 
memV5jkoAdGrnRy3Q9PM7w: bets $1.25
LJI7A1YgDM7hgh7o56+ReQ: folds 
Uncalled bet ($1.25) returned to memV5jkoAdGrnRy3Q9PM7w
memV5jkoAdGrnRy3Q9PM7w collected $0.60 from pot
*** SUMMARY ***
Total pot $0.60 | Rake $0 
Board [4c Ac 5d 3d]
Seat 1: LJI7A1YgDM7hgh7o56+ReQ (big blind) folded on the Turn
Seat 2: buyjetgNT1McXtdaP4zynA folded before Flop (didn't bet)
Seat 3: memV5jkoAdGrnRy3Q9PM7w collected ($0.60)
Seat 4: vqWjZmdQu/Hxw96/IJTWdQ folded before Flop (didn't bet)
Seat 5: mfrkWA3PTeYPkbO6hi98Aw (button) folded before Flop (didn't bet)
Seat 6: 3zD3qLXT1bEffAoWGnc7wg (small blind) folded before Flop




PokerStars Game #59941635128:  Hold'em No Limit ($0.10/$0.25) - 2009/07/01 1:41:24 ET
Table 'wGizWOswEL6P5QrvVkno/g' 6-max Seat #6 is the button
Seat 1: Qbfkn+ucISvbd1Xh32zAGA ($24.75 in chips) 
Seat 2: mfrkWA3PTeYPkbO6hi98Aw ($25 in chips) 
Seat 3: bJFzs6QmEEnz4miMfSDtcg ($14.75 in chips) 
Seat 4: 32YL2ZEp8NT4JB2RVM9euQ ($16.65 in chips) 
Seat 5: wsP46AGpqDjHZQmlRHKa9g ($39.40 in chips) 
Seat 6: rfSnsAuAfXTb8w/obc9OVQ ($7.55 in chips) 
Qbfkn+ucISvbd1Xh32zAGA: posts small blind $0.10
mfrkWA3PTeYPkbO6hi98Aw: posts big blind $0.25
*** HOLE CARDS ***
bJFzs6QmEEnz4miMfSDtcg: folds 
32YL2ZEp8NT4JB2RVM9euQ: folds 
wsP46AGpqDjHZQmlRHKa9g: folds 
rfSnsAuAfXTb8w/obc9OVQ: raises $0.75 to $1
Qbfkn+ucISvbd1Xh32zAGA: folds 
mfrkWA3PTeYPkbO6hi98Aw: folds 
Uncalled bet ($0.75) returned to rfSnsAuAfXTb8w/obc9OVQ
rfSnsAuAfXTb8w/obc9OVQ collected $0.60 from pot
rfSnsAuAfXTb8w/obc9OVQ: doesn't show hand 
*** SUMMARY ***
Total pot $0.60 | Rake $0 
Seat 1: Qbfkn+ucISvbd1Xh32zAGA (small blind) folded before Flop
Seat 2: mfrkWA3PTeYPkbO6hi98Aw (big blind) folded before Flop
Seat 3: bJFzs6QmEEnz4miMfSDtcg folded before Flop (didn't bet)
Seat 4: 32YL2ZEp8NT4JB2RVM9euQ folded before Flop (didn't bet)
Seat 5: wsP46AGpqDjHZQmlRHKa9g folded before Flop (didn't bet)
Seat 6: rfSnsAuAfXTb8w/obc9OVQ (button) collected ($0.60)




PokerStars Game #59941635190:  Hold'em No Limit ($0.10/$0.25) - 2009/07/01 1:41:24 ET
Table 'iMiAw/kTZXopgYX4HI7sHg' 9-max Seat #6 is the button
Seat 1: PdIasPkzm2sqZnN41ZRXOg ($4.90 in chips) 
Seat 2: qwr38jl5txoR36M7G5qi4A ($8.25 in chips) 
Seat 3: HPEB+AtKw1+C/cxU0o1ciw ($28.25 in chips) 
Seat 4: eK8qa6EPcH2zhtbmWSvc9g ($32.40 in chips) 
Seat 5: 22dIObOuor/A+IKWkNoAlA ($5.10 in chips) 
Seat 6: Bb42QRQMhg5/Y0vHP8/2Xw ($28.70 in chips) 
Seat 7: ljkBp5cvgbHARUIwY5vUuA ($4.75 in chips) 
Seat 8: tLcDklc2rBORNfixyRfVfw ($25 in chips) 
Seat 9: K36tHfxDQBx3OFpy0baDPA ($27.50 in chips) 
ljkBp5cvgbHARUIwY5vUuA: posts small blind $0.10
tLcDklc2rBORNfixyRfVfw: posts big blind $0.25
*** HOLE CARDS ***
K36tHfxDQBx3OFpy0baDPA: folds 
PdIasPkzm2sqZnN41ZRXOg: folds 
qwr38jl5txoR36M7G5qi4A: folds 
HPEB+AtKw1+C/cxU0o1ciw: folds 
eK8qa6EPcH2zhtbmWSvc9g: folds 
22dIObOuor/A+IKWkNoAlA: folds 
Bb42QRQMhg5/Y0vHP8/2Xw: folds 
ljkBp5cvgbHARUIwY5vUuA: folds 
Uncalled bet ($0.15) returned to tLcDklc2rBORNfixyRfVfw
eK8qa6EPcH2zhtbmWSvc9g leaves the table
tLcDklc2rBORNfixyRfVfw collected $0.20 from pot
tLcDklc2rBORNfixyRfVfw: doesn't show hand 
*** SUMMARY ***
Total pot $0.20 | Rake $0 
Seat 1: PdIasPkzm2sqZnN41ZRXOg folded before Flop (didn't bet)
Seat 2: qwr38jl5txoR36M7G5qi4A folded before Flop (didn't bet)
Seat 3: HPEB+AtKw1+C/cxU0o1ciw folded before Flop (didn't bet)
Seat 4: eK8qa6EPcH2zhtbmWSvc9g folded before Flop (didn't bet)
Seat 5: 22dIObOuor/A+IKWkNoAlA folded before Flop (didn't bet)
Seat 6: Bb42QRQMhg5/Y0vHP8/2Xw (button) folded before Flop (didn't bet)
Seat 7: ljkBp5cvgbHARUIwY5vUuA (small blind) folded before Flop
Seat 8: tLcDklc2rBORNfixyRfVfw (big blind) collected ($0.20)
Seat 9: K36tHfxDQBx3OFpy0baDPA folded before Flop (didn't bet)




PokerStars Game #59941635956:  Hold'em No Limit ($0.10/$0.25) - 2009/07/01 1:41:25 ET
Table 'aisAlB9GIV21BwfUW3+Nbg' 9-max Seat #5 is the button
Seat 1: SqibpGx+lf+brY0fJVvD0w ($24.65 in chips) 
Seat 2: +7GnIVpCmyuij3NJfOgsTw ($13.40 in chips) 
Seat 3: CvL9Ch1HYCVbTsfpNucitg ($4.80 in chips) 
Seat 4: sD+TKtt36XiiN6jqHiLwDA ($26.20 in chips) 
Seat 5: ghNKXUBl/H+t83JF079ZBA ($27.40 in chips) 
Seat 6: 9gmYYQesalMrUjaF7nKfrQ ($16.30 in chips) 
Seat 7: jGjM+5lCSe6f2MEwxQGOAg ($37.60 in chips) 
Seat 8: VWUWpMLMj/Q1jRVpF7Aohw ($12.50 in chips) 
Seat 9: N0hGpTAEAj9k5msS6LPLAw ($10.75 in chips) 
9gmYYQesalMrUjaF7nKfrQ: posts small blind $0.10
jGjM+5lCSe6f2MEwxQGOAg: posts big blind $0.25
*** HOLE CARDS ***
VWUWpMLMj/Q1jRVpF7Aohw: folds 
N0hGpTAEAj9k5msS6LPLAw: folds 
SqibpGx+lf+brY0fJVvD0w: folds 
+7GnIVpCmyuij3NJfOgsTw: folds 
CvL9Ch1HYCVbTsfpNucitg: folds 
sD+TKtt36XiiN6jqHiLwDA: folds 
ghNKXUBl/H+t83JF079ZBA: folds 
9gmYYQesalMrUjaF7nKfrQ: folds 
Uncalled bet ($0.15) returned to jGjM+5lCSe6f2MEwxQGOAg
jGjM+5lCSe6f2MEwxQGOAg collected $0.20 from pot
*** SUMMARY ***
Total pot $0.20 | Rake $0 
Seat 1: SqibpGx+lf+brY0fJVvD0w folded before Flop (didn't bet)
Seat 2: +7GnIVpCmyuij3NJfOgsTw folded before Flop (didn't bet)
Seat 3: CvL9Ch1HYCVbTsfpNucitg folded before Flop (didn't bet)
Seat 4: sD+TKtt36XiiN6jqHiLwDA folded before Flop (didn't bet)
Seat 5: ghNKXUBl/H+t83JF079ZBA (button) folded before Flop (didn't bet)
Seat 6: 9gmYYQesalMrUjaF7nKfrQ (small blind) folded before Flop
Seat 7: jGjM+5lCSe6f2MEwxQGOAg (big blind) collected ($0.20)
Seat 8: VWUWpMLMj/Q1jRVpF7Aohw folded before Flop (didn't bet)
Seat 9: N0hGpTAEAj9k5msS6LPLAw folded before Flop (didn't bet)




PokerStars Game #59941635850:  Hold'em No Limit ($0.10/$0.25) - 2009/07/01 1:41:25 ET
Table 'dVzscin98UhGisTmV9BDcw' 9-max Seat #6 is the button
Seat 1: sBAwXpkpgyhyWbHIQcIJKA ($17.90 in chips) 
Seat 2: dfNim92Z6XK1/h5SFW5vDg ($28.25 in chips) 
Seat 4: aNpwfA31EREwO+ar4XzBCw ($42.25 in chips) 
Seat 5: 22dIObOuor/A+IKWkNoAlA ($10.10 in chips) 
Seat 6: bXpVeaSTPBFSPJmeXxO7nw ($4.30 in chips) 
Seat 7: cKlmpQMahVsmOaxFQDcoOg ($24.75 in chips) 
Seat 8: /vn2Qu2dvc9AMMq46Ae0jA ($48.10 in chips) 
Seat 9: arxNSjreDRGFg13EAM2F1w ($25 in chips) 
cKlmpQMahVsmOaxFQDcoOg: posts small blind $0.10
/vn2Qu2dvc9AMMq46Ae0jA: posts big blind $0.25
*** HOLE CARDS ***
arxNSjreDRGFg13EAM2F1w: folds 
sBAwXpkpgyhyWbHIQcIJKA: folds 
dfNim92Z6XK1/h5SFW5vDg: folds 
JKOHWhyNSj5IT6PzR/yHDg has returned
aNpwfA31EREwO+ar4XzBCw: folds 
22dIObOuor/A+IKWkNoAlA: folds 
bXpVeaSTPBFSPJmeXxO7nw: raises $4.05 to $4.30 and is all-in
cKlmpQMahVsmOaxFQDcoOg: folds 
/vn2Qu2dvc9AMMq46Ae0jA: calls $4.05
*** FLOP *** [7d 4s 6h]
*** TURN *** [7d 4s 6h] [8d]
*** RIVER *** [7d 4s 6h 8d] [Kd]
*** SHOW DOWN ***
/vn2Qu2dvc9AMMq46Ae0jA: shows [Ah Jh] (high card Ace)
bXpVeaSTPBFSPJmeXxO7nw: shows [Ac Kh] (a pair of Kings)
bXpVeaSTPBFSPJmeXxO7nw collected $8.30 from pot
JKOHWhyNSj5IT6PzR/yHDg leaves the table
*** SUMMARY ***
Total pot $8.70 | Rake $0.40 
Board [7d 4s 6h 8d Kd]
Seat 1: sBAwXpkpgyhyWbHIQcIJKA folded before Flop (didn't bet)
Seat 2: dfNim92Z6XK1/h5SFW5vDg folded before Flop (didn't bet)
Seat 4: aNpwfA31EREwO+ar4XzBCw folded before Flop (didn't bet)
Seat 5: 22dIObOuor/A+IKWkNoAlA folded before Flop (didn't bet)
Seat 6: bXpVeaSTPBFSPJmeXxO7nw (button) showed [Ac Kh] and won ($8.30) with a pair of Kings
Seat 7: cKlmpQMahVsmOaxFQDcoOg (small blind) folded before Flop
Seat 8: /vn2Qu2dvc9AMMq46Ae0jA (big blind) showed [Ah Jh] and lost with high card Ace
Seat 9: arxNSjreDRGFg13EAM2F1w folded before Flop (didn't bet)




PokerStars Game #59941635450:  Hold'em No Limit ($0.10/$0.25) - 2009/07/01 1:41:25 ET
Table 'hOE09W281uSob0XeJmUcRg' 6-max Seat #2 is the button
Seat 1: mfrkWA3PTeYPkbO6hi98Aw ($27.65 in chips) 
Seat 2: lYjWCpfCxX2kgcHY3v4Yow ($28.50 in chips) 
Seat 3: y+a/yGW/Jy4bPJFnaeTz5w ($13.85 in chips) 
Seat 5: JFIAqU8lCZ0vWwEl4bdGsg ($25 in chips) 
Seat 6: x4ZJ8E/TUrtoB7WiHcv8WA ($14.25 in chips) 
y+a/yGW/Jy4bPJFnaeTz5w: posts small blind $0.10
JFIAqU8lCZ0vWwEl4bdGsg: posts big blind $0.25
*** HOLE CARDS ***
x4ZJ8E/TUrtoB7WiHcv8WA: folds 
mfrkWA3PTeYPkbO6hi98Aw: folds 
lYjWCpfCxX2kgcHY3v4Yow: folds 
y+a/yGW/Jy4bPJFnaeTz5w: calls $0.15
JFIAqU8lCZ0vWwEl4bdGsg: checks 
*** FLOP *** [Ad Kc 6c]
y+a/yGW/Jy4bPJFnaeTz5w: checks 
JFIAqU8lCZ0vWwEl4bdGsg: checks 
*** TURN *** [Ad Kc 6c] [8s]
y+a/yGW/Jy4bPJFnaeTz5w: checks 
JFIAqU8lCZ0vWwEl4bdGsg: checks 
*** RIVER *** [Ad Kc 6c 8s] [2s]
y+a/yGW/Jy4bPJFnaeTz5w: checks 
JFIAqU8lCZ0vWwEl4bdGsg: checks 
*** SHOW DOWN ***
y+a/yGW/Jy4bPJFnaeTz5w: shows [7c Qs] (high card Ace)
JFIAqU8lCZ0vWwEl4bdGsg: mucks hand 
y+a/yGW/Jy4bPJFnaeTz5w collected $0.50 from pot
*** SUMMARY ***
Total pot $0.50 | Rake $0 
Board [Ad Kc 6c 8s 2s]
Seat 1: mfrkWA3PTeYPkbO6hi98Aw folded before Flop (didn't bet)
Seat 2: lYjWCpfCxX2kgcHY3v4Yow (button) folded before Flop (didn't bet)
Seat 3: y+a/yGW/Jy4bPJFnaeTz5w (small blind) showed [7c Qs] and won ($0.50) with high card Ace
Seat 5: JFIAqU8lCZ0vWwEl4bdGsg (big blind) mucked
Seat 6: x4ZJ8E/TUrtoB7WiHcv8WA folded before Flop (didn't bet)




PokerStars Game #59941635456:  Hold'em No Limit ($0.10/$0.25) - 2009/07/01 1:41:25 ET
Table '+2VxGVfkEqJ1AYfQy/JH2w' 6-max Seat #6 is the button
Seat 1: if4dh6jhJXeN3/qd3qCp9g ($24.75 in chips) 
Seat 2: qllppsCmUqovlriIWCeM/g ($4.05 in chips) 
Seat 3: NndRCAk4vU5JGDhTyy5LZg ($12.45 in chips) 
Seat 4: y+a/yGW/Jy4bPJFnaeTz5w ($16.95 in chips) 
Seat 5: XD1i5m5PvBDnRzJaG/vINw ($23.85 in chips) 
Seat 6: L3/N/gliETan8N5Gim5h4Q ($25 in chips) 
if4dh6jhJXeN3/qd3qCp9g: posts small blind $0.10
qllppsCmUqovlriIWCeM/g: posts big blind $0.25
*** HOLE CARDS ***
NndRCAk4vU5JGDhTyy5LZg: calls $0.25
y+a/yGW/Jy4bPJFnaeTz5w: folds 
XD1i5m5PvBDnRzJaG/vINw: raises $0.50 to $0.75
L3/N/gliETan8N5Gim5h4Q: folds 
if4dh6jhJXeN3/qd3qCp9g: folds 
qllppsCmUqovlriIWCeM/g: calls $0.50
NndRCAk4vU5JGDhTyy5LZg: calls $0.50
*** FLOP *** [Ah Kh Th]
qllppsCmUqovlriIWCeM/g: checks 
NndRCAk4vU5JGDhTyy5LZg: checks 
XD1i5m5PvBDnRzJaG/vINw: checks 
*** TURN *** [Ah Kh Th] [5d]
qllppsCmUqovlriIWCeM/g: bets $3.30 and is all-in
NndRCAk4vU5JGDhTyy5LZg: folds 
NndRCAk4vU5JGDhTyy5LZg is sitting out
XD1i5m5PvBDnRzJaG/vINw: folds 
Uncalled bet ($3.30) returned to qllppsCmUqovlriIWCeM/g
qllppsCmUqovlriIWCeM/g collected $2.25 from pot
NndRCAk4vU5JGDhTyy5LZg leaves the table
*** SUMMARY ***
Total pot $2.35 | Rake $0.10 
Board [Ah Kh Th 5d]
Seat 1: if4dh6jhJXeN3/qd3qCp9g (small blind) folded before Flop
Seat 2: qllppsCmUqovlriIWCeM/g (big blind) collected ($2.25)
Seat 3: NndRCAk4vU5JGDhTyy5LZg folded on the Turn
Seat 4: y+a/yGW/Jy4bPJFnaeTz5w folded before Flop (didn't bet)
Seat 5: XD1i5m5PvBDnRzJaG/vINw folded on the Turn
Seat 6: L3/N/gliETan8N5Gim5h4Q (button) folded before Flop (didn't bet)




PokerStars Game #59941635778:  Hold'em No Limit ($0.10/$0.25) - 2009/07/01 1:41:25 ET
Table 'APEHQjIcZHDZUA4iOjju2g' 6-max Seat #3 is the button
Seat 1: DE9hRlt14g+JdsRQ4wT7hg ($25 in chips) 
Seat 2: 3zD3qLXT1bEffAoWGnc7wg ($36.60 in chips) 
Seat 3: 3e/idKqDuPE10t6Zvr//SQ ($24.65 in chips) 
Seat 4: w2mQ4VsGljGwWXydz8tw2A ($37.50 in chips) 
Seat 5: /xN6gc9+8Hew0HxaB6VIVg ($43.90 in chips) 
Seat 6: KXtdqb+rIMkjc0RvHDksGQ ($25.95 in chips) 
w2mQ4VsGljGwWXydz8tw2A: posts small blind $0.10
w2mQ4VsGljGwWXydz8tw2A said, "feel my heart beating"
/xN6gc9+8Hew0HxaB6VIVg: posts big blind $0.25
*** HOLE CARDS ***
KXtdqb+rIMkjc0RvHDksGQ: folds 
DE9hRlt14g+JdsRQ4wT7hg: raises $0.75 to $1
3e/idKqDuPE10t6Zvr//SQ said, "rofl.\"
3zD3qLXT1bEffAoWGnc7wg: folds 
w2mQ4VsGljGwWXydz8tw2A said, "lol"
3e/idKqDuPE10t6Zvr//SQ: folds 
w2mQ4VsGljGwWXydz8tw2A: folds 
/xN6gc9+8Hew0HxaB6VIVg: folds 
Uncalled bet ($0.75) returned to DE9hRlt14g+JdsRQ4wT7hg
DE9hRlt14g+JdsRQ4wT7hg collected $0.60 from pot
DE9hRlt14g+JdsRQ4wT7hg: doesn't show hand 
*** SUMMARY ***
Total pot $0.60 | Rake $0 
Seat 1: DE9hRlt14g+JdsRQ4wT7hg collected ($0.60)
Seat 2: 3zD3qLXT1bEffAoWGnc7wg folded before Flop (didn't bet)
Seat 3: 3e/idKqDuPE10t6Zvr//SQ (button) folded before Flop (didn't bet)
Seat 4: w2mQ4VsGljGwWXydz8tw2A (small blind) folded before Flop
Seat 5: /xN6gc9+8Hew0HxaB6VIVg (big blind) folded before Flop
Seat 6: KXtdqb+rIMkjc0RvHDksGQ folded before Flop (didn't bet)




PokerStars Game #59941635810:  Hold'em No Limit ($0.10/$0.25) - 2009/07/01 1:41:25 ET
Table 'oG007Tb0LYbfANo6QWd16wWEMI3Mtn7dGARDbgNrKibgx Seat #9 is the button
Seat 1: DiSvPC2iudwL5j9u6Huyww ($46.75 in chips) 
Seat 2: zDrucyjVn5aeekNEc3cJrA ($14.50 in chips) 
Seat 4: zgi+EUykT/pZQpoUG6+oEg ($4.40 in chips) 
Seat 5: 8f0dtuUGqDbgE6up1lQAlg ($6.35 in chips) 
Seat 7: Mh2r9hTeTEDnh19sRZtW3g ($4.75 in chips) 
Seat 8: q4cNXFZGNhLfrTyVrIy6Mg ($11.05 in chips) 
Seat 9: EVqHvqty1ZsuvDFiSXlSqQ ($20.10 in chips) 
DiSvPC2iudwL5j9u6Huyww: posts small blind $0.10
zDrucyjVn5aeekNEc3cJrA: posts big blind $0.25
pN3IHvAKm2fz+sTRARTcrg: sits out 
*** HOLE CARDS ***
zgi+EUykT/pZQpoUG6+oEg: folds 
8f0dtuUGqDbgE6up1lQAlg: calls $0.25
Mh2r9hTeTEDnh19sRZtW3g: folds 
q4cNXFZGNhLfrTyVrIy6Mg: calls $0.25
EVqHvqty1ZsuvDFiSXlSqQ: folds 
DiSvPC2iudwL5j9u6Huyww: folds 
zDrucyjVn5aeekNEc3cJrA: checks 
*** FLOP *** [5s Ac 7h]
66x/U2lStcsdcsOvKlLBlg leaves the table
yqkowiRWZ6NvRN9UUkYIlA joins the table at seat #6 
zDrucyjVn5aeekNEc3cJrA: checks 
8f0dtuUGqDbgE6up1lQAlg: checks 
q4cNXFZGNhLfrTyVrIy6Mg: checks 
*** TURN *** [5s Ac 7h] [9c]
zDrucyjVn5aeekNEc3cJrA: checks 
8f0dtuUGqDbgE6up1lQAlg: checks 
q4cNXFZGNhLfrTyVrIy6Mg: checks 
*** RIVER *** [5s Ac 7h 9c] [3s]
zDrucyjVn5aeekNEc3cJrA: checks 
8f0dtuUGqDbgE6up1lQAlg: checks 
q4cNXFZGNhLfrTyVrIy6Mg: checks 
*** SHOW DOWN ***
zDrucyjVn5aeekNEc3cJrA: shows [Qd 5h] (a pair of Fives)
8f0dtuUGqDbgE6up1lQAlg: mucks hand 
q4cNXFZGNhLfrTyVrIy6Mg: mucks hand 
zDrucyjVn5aeekNEc3cJrA collected $0.85 from pot
zDrucyjVn5aeekNEc3cJrA is sitting out
*** SUMMARY ***
Total pot $0.85 | Rake $0 
Board [5s Ac 7h 9c 3s]
Seat 1: DiSvPC2iudwL5j9u6Huyww (small blind) folded before Flop
Seat 2: zDrucyjVn5aeekNEc3cJrA (big blind) showed [Qd 5h] and won ($0.85) with a pair of Fives
Seat 4: zgi+EUykT/pZQpoUG6+oEg folded before Flop (didn't bet)
Seat 5: 8f0dtuUGqDbgE6up1lQAlg mucked
Seat 7: Mh2r9hTeTEDnh19sRZtW3g folded before Flop (didn't bet)
Seat 8: q4cNXFZGNhLfrTyVrIy6Mg mucked
Seat 9: EVqHvqty1ZsuvDFiSXlSqQ (button) folded before Flop (didn't bet)




PokerStars Game #59941636588:  Hold'em No Limit ($0.10/$0.25) - 2009/07/01 1:41:26 ET
Table 'HbNAGS1OJWQKyfk7UfrYyw' 9-max Seat #1 is the button
Seat 1: 7cv+9Zc9HIQHNvYsMfV3uA ($25 in chips) 
Seat 2: fjwM06E3HzjUrynPRQi31Q ($4.85 in chips) 
Seat 7: n+stbTneifqFNME+tpoGrw ($25.50 in chips) 
fjwM06E3HzjUrynPRQi31Q: posts small blind $0.10
n+stbTneifqFNME+tpoGrw: posts big blind $0.25
*** HOLE CARDS ***
7cv+9Zc9HIQHNvYsMfV3uA: raises $0.75 to $1
fjwM06E3HzjUrynPRQi31Q: folds 
n+stbTneifqFNME+tpoGrw: folds 
Uncalled bet ($0.75) returned to 7cv+9Zc9HIQHNvYsMfV3uA
7cv+9Zc9HIQHNvYsMfV3uA collected $0.60 from pot
7cv+9Zc9HIQHNvYsMfV3uA leaves the table
*** SUMMARY ***
Total pot $0.60 | Rake $0 
Seat 1: 7cv+9Zc9HIQHNvYsMfV3uA (button) collected ($0.60)
Seat 2: fjwM06E3HzjUrynPRQi31Q (small blind) folded before Flop
Seat 7: n+stbTneifqFNME+tpoGrw (big blind) folded before Flop




PokerStars Game #59941636222:  Hold'em No Limit ($0.10/$0.25) - 2009/07/01 1:41:26 ET
Table 'srBTB98reCdD1TffxE6o7g' 6-max Seat #2 is the button
Seat 1: SFmT9ZsVopnukjvAzrxTRg ($33.95 in chips) 
Seat 2: mfrkWA3PTeYPkbO6hi98Aw ($25 in chips) 
Seat 3: VOmI0x4dDPnTESZd5B4d1Q ($47.95 in chips) 
Seat 4: 6DwBRH+xZ12AAZmeAg+aXw ($21.30 in chips) 
Seat 5: 8zUCJvLYLFM8AG6K5zjIvg ($12.30 in chips) 
Seat 6: BV+K0Phf5VBHr7aZPKqbUQ ($34.95 in chips) 
VOmI0x4dDPnTESZd5B4d1Q: posts small blind $0.10
6DwBRH+xZ12AAZmeAg+aXw: posts big blind $0.25
*** HOLE CARDS ***
8zUCJvLYLFM8AG6K5zjIvg: folds 
BV+K0Phf5VBHr7aZPKqbUQ: folds 
SFmT9ZsVopnukjvAzrxTRg: raises $0.75 to $1
mfrkWA3PTeYPkbO6hi98Aw: folds 
VOmI0x4dDPnTESZd5B4d1Q: folds 
6DwBRH+xZ12AAZmeAg+aXw: folds 
Uncalled bet ($0.75) returned to SFmT9ZsVopnukjvAzrxTRg
SFmT9ZsVopnukjvAzrxTRg collected $0.60 from pot
SFmT9ZsVopnukjvAzrxTRg: doesn't show hand 
*** SUMMARY ***
Total pot $0.60 | Rake $0 
Seat 1: SFmT9ZsVopnukjvAzrxTRg collected ($0.60)
Seat 2: mfrkWA3PTeYPkbO6hi98Aw (button) folded before Flop (didn't bet)
Seat 3: VOmI0x4dDPnTESZd5B4d1Q (small blind) folded before Flop
Seat 4: 6DwBRH+xZ12AAZmeAg+aXw (big blind) folded before Flop
Seat 5: 8zUCJvLYLFM8AG6K5zjIvg folded before Flop (didn't bet)
Seat 6: BV+K0Phf5VBHr7aZPKqbUQ folded before Flop (didn't bet)




PokerStars Game #59941635996:  Hold'em No Limit ($0.10/$0.25) - 2009/07/01 1:41:26 ET
Table 'jxoHy9yJy0bbH/Qx73FoPA' 9-max Seat #1 is the button
Seat 1: j4q3p0lesp63b1gZDwLBZw ($6.60 in chips) 
Seat 2: F7pnn6czNpHvRM55XcA2EA ($38.50 in chips) 
Seat 3: CVqCt93Mk0MhKMaZ4LZDSQ ($11.20 in chips) 
Seat 4: A1M0JIGHzqMXp7L2MdcxXw ($26.65 in chips) 
Seat 5: cZ99hugmLBj9KhTlc8nCSw ($25.10 in chips) 
Seat 6: tYsOBqdU1+x+yFI7zHO7hQ ($46.35 in chips) 
Seat 7: wGigCmBR/9XWkPpvYos3aQ ($26.40 in chips) 
Seat 9: CvL9Ch1HYCVbTsfpNucitg ($4.90 in chips) 
F7pnn6czNpHvRM55XcA2EA: posts small blind $0.10
CVqCt93Mk0MhKMaZ4LZDSQ: posts big blind $0.25
DigiSlarks: sits out 
*** HOLE CARDS ***
A1M0JIGHzqMXp7L2MdcxXw: folds 
cZ99hugmLBj9KhTlc8nCSw: folds 
tYsOBqdU1+x+yFI7zHO7hQ: folds 
wGigCmBR/9XWkPpvYos3aQ: folds 
CvL9Ch1HYCVbTsfpNucitg: folds 
j4q3p0lesp63b1gZDwLBZw: folds 
F7pnn6czNpHvRM55XcA2EA: folds 
Uncalled bet ($0.15) returned to CVqCt93Mk0MhKMaZ4LZDSQ
CVqCt93Mk0MhKMaZ4LZDSQ collected $0.20 from pot
*** SUMMARY ***
Total pot $0.20 | Rake $0 
Seat 1: j4q3p0lesp63b1gZDwLBZw (button) folded before Flop (didn't bet)
Seat 2: F7pnn6czNpHvRM55XcA2EA (small blind) folded before Flop
Seat 3: CVqCt93Mk0MhKMaZ4LZDSQ (big blind) collected ($0.20)
Seat 4: A1M0JIGHzqMXp7L2MdcxXw folded before Flop (didn't bet)
Seat 5: cZ99hugmLBj9KhTlc8nCSw folded before Flop (didn't bet)
Seat 6: tYsOBqdU1+x+yFI7zHO7hQ folded before Flop (didn't bet)
Seat 7: wGigCmBR/9XWkPpvYos3aQ folded before Flop (didn't bet)
Seat 9: CvL9Ch1HYCVbTsfpNucitg folded before Flop (didn't bet)




PokerStars Game #59941636070:  Hold'em No Limit ($0.10/$0.25) - 2009/07/01 1:41:26 ET
Table 'aT31tt16YvQM/Ue69HPLpA' 9-max Seat #4 is the button
Seat 1: fIgGw0jPUR7labvJPaPbeg ($8 in chips) 
Seat 2: PdIasPkzm2sqZnN41ZRXOg ($4.90 in chips) 
Seat 3: tYsOBqdU1+x+yFI7zHO7hQ ($26.15 in chips) 
Seat 4: wGigCmBR/9XWkPpvYos3aQ ($28 in chips) 
Seat 5: s2xLPOl/vhl/26apJ3vsOQ ($37.75 in chips) 
Seat 6: 7cv+9Zc9HIQHNvYsMfV3uA ($58.80 in chips) 
Seat 7: W8cIfrCR+zA8pCNyIuHu8g ($32.30 in chips) 
Seat 9: TvIuLx9zUCE+9Li58iImOQ ($16.95 in chips) 
s2xLPOl/vhl/26apJ3vsOQ: posts small blind $0.10
7cv+9Zc9HIQHNvYsMfV3uA: posts big blind $0.25
W6tExOcYX7qiy6Qdp+ZwFA: sits out 
*** HOLE CARDS ***
W8cIfrCR+zA8pCNyIuHu8g: folds 
TvIuLx9zUCE+9Li58iImOQ: folds 
fIgGw0jPUR7labvJPaPbeg: calls $0.25
PdIasPkzm2sqZnN41ZRXOg: folds 
tYsOBqdU1+x+yFI7zHO7hQ: folds 
wGigCmBR/9XWkPpvYos3aQ: raises $1 to $1.25
s2xLPOl/vhl/26apJ3vsOQ: folds 
7cv+9Zc9HIQHNvYsMfV3uA: folds 
fIgGw0jPUR7labvJPaPbeg: calls $1
*** FLOP *** [7d 7h Qc]
fIgGw0jPUR7labvJPaPbeg: checks 
wGigCmBR/9XWkPpvYos3aQ: bets $2.20
fIgGw0jPUR7labvJPaPbeg: raises $4.55 to $6.75 and is all-in
wGigCmBR/9XWkPpvYos3aQ: folds 
Uncalled bet ($4.55) returned to fIgGw0jPUR7labvJPaPbeg
fIgGw0jPUR7labvJPaPbeg collected $6.90 from pot
*** SUMMARY ***
Total pot $7.25 | Rake $0.35 
Board [7d 7h Qc]
Seat 1: fIgGw0jPUR7labvJPaPbeg collected ($6.90)
Seat 2: PdIasPkzm2sqZnN41ZRXOg folded before Flop (didn't bet)
Seat 3: tYsOBqdU1+x+yFI7zHO7hQ folded before Flop (didn't bet)
Seat 4: wGigCmBR/9XWkPpvYos3aQ (button) folded on the Flop
Seat 5: s2xLPOl/vhl/26apJ3vsOQ (small blind) folded before Flop
Seat 6: 7cv+9Zc9HIQHNvYsMfV3uA (big blind) folded before Flop
Seat 7: W8cIfrCR+zA8pCNyIuHu8g folded before Flop (didn't bet)
Seat 9: TvIuLx9zUCE+9Li58iImOQ folded before Flop (didn't bet)




PokerStars Game #59941636066:  Hold'em No Limit ($0.10/$0.25) - 2009/07/01 1:41:26 ET
Table 'IrJPyZ3JW2iIa+krdoSbJQ' 9-max Seat #2 is the button
Seat 1: Bb42QRQMhg5/Y0vHP8/2Xw ($26.25 in chips) 
Seat 2: X78b5v/uhqeXXoAijbw/yg ($26.20 in chips) 
Seat 3: CT7Xj/V/O5rBlhtt+RZeFQ ($25 in chips) 
Seat 4: bXpVeaSTPBFSPJmeXxO7nw ($5 in chips) 
Seat 5: tLcDklc2rBORNfixyRfVfw ($28.40 in chips) 
Seat 6: +sbyWwIcFp9kP0bDtMegfQ ($24.95 in chips) 
Seat 7: k7BTUnQVz23IhJmLKrwx8A ($19.20 in chips) 
Seat 8: zZqOSFjPK4R4cwx0dONetw ($19.40 in chips) 
Seat 9: Mh2r9hTeTEDnh19sRZtW3g ($5.80 in chips) 
CT7Xj/V/O5rBlhtt+RZeFQ: posts small blind $0.10
bXpVeaSTPBFSPJmeXxO7nw: posts big blind $0.25
*** HOLE CARDS ***
tLcDklc2rBORNfixyRfVfw: folds 
+sbyWwIcFp9kP0bDtMegfQ: folds 
k7BTUnQVz23IhJmLKrwx8A: calls $0.25
zZqOSFjPK4R4cwx0dONetw: raises $0.75 to $1
Mh2r9hTeTEDnh19sRZtW3g: folds 
Bb42QRQMhg5/Y0vHP8/2Xw: folds 
X78b5v/uhqeXXoAijbw/yg: folds 
CT7Xj/V/O5rBlhtt+RZeFQ: folds 
bXpVeaSTPBFSPJmeXxO7nw: folds 
k7BTUnQVz23IhJmLKrwx8A: calls $0.75
*** FLOP *** [Kc Td Kd]
k7BTUnQVz23IhJmLKrwx8A: checks 
zZqOSFjPK4R4cwx0dONetw: checks 
*** TURN *** [Kc Td Kd] [3h]
k7BTUnQVz23IhJmLKrwx8A: checks 
zZqOSFjPK4R4cwx0dONetw: checks 
*** RIVER *** [Kc Td Kd 3h] [5s]
k7BTUnQVz23IhJmLKrwx8A: checks 
zZqOSFjPK4R4cwx0dONetw: bets $1
k7BTUnQVz23IhJmLKrwx8A: folds 
Uncalled bet ($1) returned to zZqOSFjPK4R4cwx0dONetw
zZqOSFjPK4R4cwx0dONetw collected $2.25 from pot
*** SUMMARY ***
Total pot $2.35 | Rake $0.10 
Board [Kc Td Kd 3h 5s]
Seat 1: Bb42QRQMhg5/Y0vHP8/2Xw folded before Flop (didn't bet)
Seat 2: X78b5v/uhqeXXoAijbw/yg (button) folded before Flop (didn't bet)
Seat 3: CT7Xj/V/O5rBlhtt+RZeFQ (small blind) folded before Flop
Seat 4: bXpVeaSTPBFSPJmeXxO7nw (big blind) folded before Flop
Seat 5: tLcDklc2rBORNfixyRfVfw folded before Flop (didn't bet)
Seat 6: +sbyWwIcFp9kP0bDtMegfQ folded before Flop (didn't bet)
Seat 7: k7BTUnQVz23IhJmLKrwx8A folded on the River
Seat 8: zZqOSFjPK4R4cwx0dONetw collected ($2.25)
Seat 9: Mh2r9hTeTEDnh19sRZtW3g folded before Flop (didn't bet)




PokerStars Game #59941637080:  Hold'em No Limit ($0.10/$0.25) - 2009/07/01 1:41:27 ET
Table 'ktio12Pyq06LsrFhIorSqA' 9-max Seat #4 is the button
Seat 1: OneeONzF0MoH0pEdcBndwA ($33.60 in chips) 
Seat 2: tGsFgUKjSctVaAXabrlZxw ($4.40 in chips) 
Seat 4: 0QdZrkFD7aGKeBXPGbIomA ($5.30 in chips) 
Seat 5: e0pV1oisCAilWiG0FCxY6A ($17.75 in chips) 
Seat 6: jQL6XIewylQ8MmZhhq2YFg ($47.30 in chips) 
Seat 7: XGCfQsxa6PfAg3kJtzUmww ($23.95 in chips) 
Seat 8: Z5y2J55JmfLYR6/DPAGHwQ ($5 in chips) 
Seat 9: H5Se03ZqSX7tbULXur2MAg ($26.65 in chips) 
e0pV1oisCAilWiG0FCxY6A: posts small blind $0.10
jQL6XIewylQ8MmZhhq2YFg: posts big blind $0.25
DigiSlarks: sits out 
*** HOLE CARDS ***
XGCfQsxa6PfAg3kJtzUmww: folds 
Z5y2J55JmfLYR6/DPAGHwQ: calls $0.25
H5Se03ZqSX7tbULXur2MAg: folds 
OneeONzF0MoH0pEdcBndwA: folds 
tGsFgUKjSctVaAXabrlZxw: folds 
0QdZrkFD7aGKeBXPGbIomA: folds 
e0pV1oisCAilWiG0FCxY6A: calls $0.15
jQL6XIewylQ8MmZhhq2YFg: raises $0.75 to $1
Z5y2J55JmfLYR6/DPAGHwQ: calls $0.75
e0pV1oisCAilWiG0FCxY6A: calls $0.75
*** FLOP *** [8h Qh Kh]
e0pV1oisCAilWiG0FCxY6A: checks 
jQL6XIewylQ8MmZhhq2YFg: bets $1
Z5y2J55JmfLYR6/DPAGHwQ: raises $3 to $4 and is all-in
e0pV1oisCAilWiG0FCxY6A: folds 
jQL6XIewylQ8MmZhhq2YFg: calls $3
*** TURN *** [8h Qh Kh] [3d]
*** RIVER *** [8h Qh Kh 3d] [Jd]
*** SHOW DOWN ***
jQL6XIewylQ8MmZhhq2YFg: shows [Ac Qc] (a pair of Queens)
Z5y2J55JmfLYR6/DPAGHwQ: shows [Kc Qs] (two pair, Kings and Queens)
Z5y2J55JmfLYR6/DPAGHwQ collected $10.50 from pot
*** SUMMARY ***
Total pot $11 | Rake $0.50 
Board [8h Qh Kh 3d Jd]
Seat 1: OneeONzF0MoH0pEdcBndwA folded before Flop (didn't bet)
Seat 2: tGsFgUKjSctVaAXabrlZxw folded before Flop (didn't bet)
Seat 4: 0QdZrkFD7aGKeBXPGbIomA (button) folded before Flop (didn't bet)
Seat 5: e0pV1oisCAilWiG0FCxY6A (small blind) folded on the Flop
Seat 6: jQL6XIewylQ8MmZhhq2YFg (big blind) showed [Ac Qc] and lost with a pair of Queens
Seat 7: XGCfQsxa6PfAg3kJtzUmww folded before Flop (didn't bet)
Seat 8: Z5y2J55JmfLYR6/DPAGHwQ showed [Kc Qs] and won ($10.50) with two pair, Kings and Queens
Seat 9: H5Se03ZqSX7tbULXur2MAg folded before Flop (didn't bet)




PokerStars Game #59941637164:  Hold'em No Limit ($0.10/$0.25) - 2009/07/01 1:41:27 ET
Table 'ROYvQOMwUrvL3SOiHYcrWg' 9-max Seat #3 is the button
Seat 1: 22dIObOuor/A+IKWkNoAlA ($5 in chips) 
Seat 2: gehe91e0IyVT0QU/XBkEyg ($24.90 in chips) 
Seat 3: 8EbrQ/EvFWt2cr0GaU82gQ ($4.65 in chips) 
Seat 4: SHegmCn8B0InbWE/zFlvOw ($31.80 in chips) 
Seat 5: 7je+LC5Mfs6nL8YBVh4frQ ($5 in chips) 
Seat 7: tYsOBqdU1+x+yFI7zHO7hQ ($26.15 in chips) 
Seat 8: biJWLZ27fafNeBI2oT1KJw ($27.80 in chips) 
Seat 9: uhrboV251dcgYniYTdFIcA ($25 in chips) 
SHegmCn8B0InbWE/zFlvOw: posts small blind $0.10
7je+LC5Mfs6nL8YBVh4frQ: posts big blind $0.25
P+9ymZQ3ktpQu1bn7HIjew: sits out 
*** HOLE CARDS ***
tYsOBqdU1+x+yFI7zHO7hQ: folds 
biJWLZ27fafNeBI2oT1KJw: folds 
uhrboV251dcgYniYTdFIcA: raises $0.75 to $1
22dIObOuor/A+IKWkNoAlA: folds 
gehe91e0IyVT0QU/XBkEyg: folds 
8EbrQ/EvFWt2cr0GaU82gQ: folds 
SHegmCn8B0InbWE/zFlvOw: folds 
7je+LC5Mfs6nL8YBVh4frQ: folds 
Uncalled bet ($0.75) returned to uhrboV251dcgYniYTdFIcA
uhrboV251dcgYniYTdFIcA collected $0.60 from pot
uhrboV251dcgYniYTdFIcA: doesn't show hand 
*** SUMMARY ***
Total pot $0.60 | Rake $0 
Seat 1: 22dIObOuor/A+IKWkNoAlA folded before Flop (didn't bet)
Seat 2: gehe91e0IyVT0QU/XBkEyg folded before Flop (didn't bet)
Seat 3: 8EbrQ/EvFWt2cr0GaU82gQ (button) folded before Flop (didn't bet)
Seat 4: SHegmCn8B0InbWE/zFlvOw (small blind) folded before Flop
Seat 5: 7je+LC5Mfs6nL8YBVh4frQ (big blind) folded before Flop
Seat 7: tYsOBqdU1+x+yFI7zHO7hQ folded before Flop (didn't bet)
Seat 8: biJWLZ27fafNeBI2oT1KJw folded before Flop (didn't bet)
Seat 9: uhrboV251dcgYniYTdFIcA collected ($0.60)




PokerStars Game #59941637138:  Hold'em No Limit ($0.10/$0.25) - 2009/07/01 1:41:27 ET
Table 'oZuNsbNJuUyQLGKzQ/4JFg' 6-max Seat #3 is the button
Seat 1: vqWjZmdQu/Hxw96/IJTWdQ ($25.35 in chips) 
Seat 2: UA5OsKS3VPaxa7uC8La/kA ($33 in chips) 
Seat 3: 8ClCHtFXGNplITm+63KB+Q ($51.75 in chips) 
Seat 5: oBUDUfeUyCbZBsjxHZgSiw ($26.90 in chips) 
Seat 6: fwg6dK1+r4jy/y+JqenYYQ ($14.65 in chips) 
geomdnb will be allowed to play after the button
oBUDUfeUyCbZBsjxHZgSiw: posts small blind $0.10
fwg6dK1+r4jy/y+JqenYYQ: posts big blind $0.25
*** HOLE CARDS ***
vqWjZmdQu/Hxw96/IJTWdQ: folds 
UA5OsKS3VPaxa7uC8La/kA: raises $0.50 to $0.75
8ClCHtFXGNplITm+63KB+Q: calls $0.75
oBUDUfeUyCbZBsjxHZgSiw: folds 
fwg6dK1+r4jy/y+JqenYYQ: calls $0.50
*** FLOP *** [Qs 4h 7s]
fwg6dK1+r4jy/y+JqenYYQ: checks 
UA5OsKS3VPaxa7uC8La/kA: bets $1.50
8ClCHtFXGNplITm+63KB+Q: folds 
fwg6dK1+r4jy/y+JqenYYQ: folds 
Uncalled bet ($1.50) returned to UA5OsKS3VPaxa7uC8La/kA
UA5OsKS3VPaxa7uC8La/kA collected $2.25 from pot
*** SUMMARY ***
Total pot $2.35 | Rake $0.10 
Board [Qs 4h 7s]
Seat 1: vqWjZmdQu/Hxw96/IJTWdQ folded before Flop (didn't bet)
Seat 2: UA5OsKS3VPaxa7uC8La/kA collected ($2.25)
Seat 3: 8ClCHtFXGNplITm+63KB+Q (button) folded on the Flop
Seat 5: oBUDUfeUyCbZBsjxHZgSiw (small blind) folded before Flop
Seat 6: fwg6dK1+r4jy/y+JqenYYQ (big blind) folded on the Flop




PokerStars Game #59941637016:  Hold'em No Limit ($0.10/$0.25) - 2009/07/01 1:41:27 ET
Table 'ZEXL6Wh4qA4Afx8NnoBBAA' 6-max Seat #1 is the button
Seat 1: v8m8XHovI5tqEA9mvplDSw ($27.60 in chips) 
Seat 2: 6DwBRH+xZ12AAZmeAg+aXw ($34.90 in chips) 
Seat 3: +ZlnqPoP3Hg4BIUxDfKd/A ($31.75 in chips) 
Seat 4: FpN4KbLjlyRRKiVaQcoLqA ($30.05 in chips) 
Seat 5: if4dh6jhJXeN3/qd3qCp9g ($27 in chips) 
Seat 6: Lh8SlCq3OSDKWLUgAI/Lxw ($1.05 in chips) 
6DwBRH+xZ12AAZmeAg+aXw: posts small blind $0.10
+ZlnqPoP3Hg4BIUxDfKd/A: posts big blind $0.25
*** HOLE CARDS ***
FpN4KbLjlyRRKiVaQcoLqA: raises $0.50 to $0.75
if4dh6jhJXeN3/qd3qCp9g: folds 
Lh8SlCq3OSDKWLUgAI/Lxw: folds 
v8m8XHovI5tqEA9mvplDSw: folds 
6DwBRH+xZ12AAZmeAg+aXw: folds 
+ZlnqPoP3Hg4BIUxDfKd/A: calls $0.50
*** FLOP *** [9s 3h Kc]
+ZlnqPoP3Hg4BIUxDfKd/A: checks 
FpN4KbLjlyRRKiVaQcoLqA: bets $0.50
+ZlnqPoP3Hg4BIUxDfKd/A: folds 
Uncalled bet ($0.50) returned to FpN4KbLjlyRRKiVaQcoLqA
FpN4KbLjlyRRKiVaQcoLqA collected $1.55 from pot
FpN4KbLjlyRRKiVaQcoLqA: doesn't show hand 
*** SUMMARY ***
Total pot $1.60 | Rake $0.05 
Board [9s 3h Kc]
Seat 1: v8m8XHovI5tqEA9mvplDSw (button) folded before Flop (didn't bet)
Seat 2: 6DwBRH+xZ12AAZmeAg+aXw (small blind) folded before Flop
Seat 3: +ZlnqPoP3Hg4BIUxDfKd/A (big blind) folded on the Flop
Seat 4: FpN4KbLjlyRRKiVaQcoLqA collected ($1.55)
Seat 5: if4dh6jhJXeN3/qd3qCp9g folded before Flop (didn't bet)
Seat 6: Lh8SlCq3OSDKWLUgAI/Lxw folded before Flop (didn't bet)




PokerStars Game #59941636844:  Hold'em No Limit ($0.10/$0.25) - 2009/07/01 1:41:27 ET
Table 'g6ryG70feTw9nNm+XJLuXw' 6-max Seat #5 is the button
Seat 1: v+QfkGiuj9bgtuNoVnDO8w ($35.95 in chips) 
Seat 2: SxIIgwXYLkwd6m3wLyPTCw ($33.45 in chips) 
Seat 3: cezpHJ8FB07dj0xG+LhOvw ($25 in chips) 
Seat 4: GC/9yVD59DUCX7hUI7gcLw ($44.35 in chips) 
Seat 5: EE16Ua5b1HSsYej5zeXOlA ($25 in chips) 
Seat 6: tSR4329m40dZsN7YOpI9Kw ($35.60 in chips) 
tSR4329m40dZsN7YOpI9Kw: posts small blind $0.10
v+QfkGiuj9bgtuNoVnDO8w: posts big blind $0.25
*** HOLE CARDS ***
SxIIgwXYLkwd6m3wLyPTCw: folds 
cezpHJ8FB07dj0xG+LhOvw: folds 
GC/9yVD59DUCX7hUI7gcLw: folds 
EE16Ua5b1HSsYej5zeXOlA: raises $0.50 to $0.75
tSR4329m40dZsN7YOpI9Kw: raises $1.75 to $2.50
v+QfkGiuj9bgtuNoVnDO8w: folds 
EE16Ua5b1HSsYej5zeXOlA: folds 
Uncalled bet ($1.75) returned to tSR4329m40dZsN7YOpI9Kw
tSR4329m40dZsN7YOpI9Kw collected $1.75 from pot
*** SUMMARY ***
Total pot $1.75 | Rake $0 
Seat 1: v+QfkGiuj9bgtuNoVnDO8w (big blind) folded before Flop
Seat 2: SxIIgwXYLkwd6m3wLyPTCw folded before Flop (didn't bet)
Seat 3: cezpHJ8FB07dj0xG+LhOvw folded before Flop (didn't bet)
Seat 4: GC/9yVD59DUCX7hUI7gcLw folded before Flop (didn't bet)
Seat 5: EE16Ua5b1HSsYej5zeXOlA (button) folded before Flop
Seat 6: tSR4329m40dZsN7YOpI9Kw (small blind) collected ($1.75)




PokerStars Game #59941637050:  Hold'em No Limit ($0.10/$0.25) - 2009/07/01 1:41:27 ET
Table 'biAgO3TKQBU8XcrVAoU5TA' 6-max Seat #1 is the button
Seat 1: jhDPlkir8wBYAddboBuF7Q ($16.70 in chips) 
Seat 2: GbCVUNssQ7mqsPWr7J4d3w ($5.40 in chips) 
Seat 3: mfrkWA3PTeYPkbO6hi98Aw ($30.65 in chips) 
Seat 4: Hsvkc0/G2VV78oVmWYXecw ($5 in chips) 
Seat 5: n6UPMnVR4v8LFP0rWP73Fg ($12.20 in chips) 
Seat 6: wMiE3yTbDJGOLOF9th7KPA ($9.60 in chips) 
GbCVUNssQ7mqsPWr7J4d3w: posts small blind $0.10
mfrkWA3PTeYPkbO6hi98Aw: posts big blind $0.25
*** HOLE CARDS ***
Hsvkc0/G2VV78oVmWYXecw: folds 
n6UPMnVR4v8LFP0rWP73Fg has timed out
n6UPMnVR4v8LFP0rWP73Fg: folds 
n6UPMnVR4v8LFP0rWP73Fg is sitting out
wMiE3yTbDJGOLOF9th7KPA: calls $0.25
jhDPlkir8wBYAddboBuF7Q: raises $0.50 to $0.75
n6UPMnVR4v8LFP0rWP73Fg has returned
GbCVUNssQ7mqsPWr7J4d3w: folds 
mfrkWA3PTeYPkbO6hi98Aw: folds 
wMiE3yTbDJGOLOF9th7KPA: folds 
Uncalled bet ($0.50) returned to jhDPlkir8wBYAddboBuF7Q
jhDPlkir8wBYAddboBuF7Q collected $0.85 from pot
*** SUMMARY ***
Total pot $0.85 | Rake $0 
Seat 1: jhDPlkir8wBYAddboBuF7Q (button) collected ($0.85)
Seat 2: GbCVUNssQ7mqsPWr7J4d3w (small blind) folded before Flop
Seat 3: mfrkWA3PTeYPkbO6hi98Aw (big blind) folded before Flop
Seat 4: Hsvkc0/G2VV78oVmWYXecw folded before Flop (didn't bet)
Seat 5: n6UPMnVR4v8LFP0rWP73Fg folded before Flop (didn't bet)
Seat 6: wMiE3yTbDJGOLOF9th7KPA folded before Flop




PokerStars Game #59941636794:  Hold'em No Limit ($0.10/$0.25) - 2009/07/01 1:41:27 ET
Table 'mk323gviqdkOY5Aek/1EWg' 6-max Seat #4 is the button
Seat 1: L3/N/gliETan8N5Gim5h4Q ($25.75 in chips) 
Seat 2: GC/9yVD59DUCX7hUI7gcLw ($56.40 in chips) 
Seat 3: NuqYPwTLZYQhxOoVK3Yqlw ($24.65 in chips) 
Seat 4: +baiVgI/ETnBARLe5mARCw ($12.80 in chips) 
Seat 5: kjYRzIfvZNNflYMYRkkSVA ($25.90 in chips) 
Seat 6: KkXSr5xFjxLSD3wtAvT+WQ ($8.80 in chips) 
kjYRzIfvZNNflYMYRkkSVA: posts small blind $0.10
KkXSr5xFjxLSD3wtAvT+WQ: posts big blind $0.25
*** HOLE CARDS ***
L3/N/gliETan8N5Gim5h4Q: folds 
GC/9yVD59DUCX7hUI7gcLw: folds 
NuqYPwTLZYQhxOoVK3Yqlw: raises $0.75 to $1
+baiVgI/ETnBARLe5mARCw: calls $1
kjYRzIfvZNNflYMYRkkSVA: calls $0.90
KkXSr5xFjxLSD3wtAvT+WQ: folds 
*** FLOP *** [Ac Ah 9h]
kjYRzIfvZNNflYMYRkkSVA: checks 
NuqYPwTLZYQhxOoVK3Yqlw: checks 
+baiVgI/ETnBARLe5mARCw: checks 
*** TURN *** [Ac Ah 9h] [Th]
kjYRzIfvZNNflYMYRkkSVA: bets $1.25
NuqYPwTLZYQhxOoVK3Yqlw: folds 
+baiVgI/ETnBARLe5mARCw: folds 
Uncalled bet ($1.25) returned to kjYRzIfvZNNflYMYRkkSVA
kjYRzIfvZNNflYMYRkkSVA collected $3.10 from pot
kjYRzIfvZNNflYMYRkkSVA: doesn't show hand 
*** SUMMARY ***
Total pot $3.25 | Rake $0.15 
Board [Ac Ah 9h Th]
Seat 1: L3/N/gliETan8N5Gim5h4Q folded before Flop (didn't bet)
Seat 2: GC/9yVD59DUCX7hUI7gcLw folded before Flop (didn't bet)
Seat 3: NuqYPwTLZYQhxOoVK3Yqlw folded on the Turn
Seat 4: +baiVgI/ETnBARLe5mARCw (button) folded on the Turn
Seat 5: kjYRzIfvZNNflYMYRkkSVA (small blind) collected ($3.10)
Seat 6: KkXSr5xFjxLSD3wtAvT+WQ (big blind) folded before Flop




PokerStars Game #59941637326:  Hold'em No Limit ($0.10/$0.25) - 2009/07/01 1:41:28 ET
Table 'JPFXJXa5xBkjZ/W15BKqeQ' 9-max Seat #9 is the button
Seat 1: mNQH7Afv3tbDKl2tAb9BOg ($19.35 in chips) 
Seat 2: XMSS6mD5B42I8wasdOMipQ ($10.95 in chips) 
Seat 3: 56S3mA6Zs3pGR+0p0vUCtg ($21.70 in chips) 
Seat 4: wGigCmBR/9XWkPpvYos3aQ ($26.75 in chips) 
Seat 5: cZ99hugmLBj9KhTlc8nCSw ($25 in chips) 
Seat 6: tLcDklc2rBORNfixyRfVfw ($25.35 in chips) 
Seat 9: PVqNFEFMoGtpTPGnpm4LTQ ($25.90 in chips) 
mNQH7Afv3tbDKl2tAb9BOg: posts small blind $0.10
XMSS6mD5B42I8wasdOMipQ: posts big blind $0.25
PdIasPkzm2sqZnN41ZRXOg: sits out 
*** HOLE CARDS ***
56S3mA6Zs3pGR+0p0vUCtg: raises $1 to $1.25
wGigCmBR/9XWkPpvYos3aQ: folds 
cZ99hugmLBj9KhTlc8nCSw: folds 
tLcDklc2rBORNfixyRfVfw: folds 
PVqNFEFMoGtpTPGnpm4LTQ: folds 
mNQH7Afv3tbDKl2tAb9BOg: folds 
XMSS6mD5B42I8wasdOMipQ: folds 
Uncalled bet ($1) returned to 56S3mA6Zs3pGR+0p0vUCtg
56S3mA6Zs3pGR+0p0vUCtg collected $0.60 from pot
56S3mA6Zs3pGR+0p0vUCtg: doesn't show hand 
*** SUMMARY ***
Total pot $0.60 | Rake $0 
Seat 1: mNQH7Afv3tbDKl2tAb9BOg (small blind) folded before Flop
Seat 2: XMSS6mD5B42I8wasdOMipQ (big blind) folded before Flop
Seat 3: 56S3mA6Zs3pGR+0p0vUCtg collected ($0.60)
Seat 4: wGigCmBR/9XWkPpvYos3aQ folded before Flop (didn't bet)
Seat 5: cZ99hugmLBj9KhTlc8nCSw folded before Flop (didn't bet)
Seat 6: tLcDklc2rBORNfixyRfVfw folded before Flop (didn't bet)
Seat 9: PVqNFEFMoGtpTPGnpm4LTQ (button) folded before Flop (didn't bet)




PokerStars Game #59941637484:  Hold'em No Limit ($0.10/$0.25) - 2009/07/01 1:41:28 ET
Table 'qryc9C/ELyQ3lubOaELNAQ' 6-max Seat #4 is the button
Seat 1: OZc6kkoTwtITj1ZfreJK1A ($64.80 in chips) 
Seat 2: LtASJ9OlkqGrrUKGQlpGAw ($30.80 in chips) 
Seat 4: v+QfkGiuj9bgtuNoVnDO8w ($25.05 in chips) 
Seat 5: 9StOHp+Y1T0K13JdgS2oQQ ($33.65 in chips) 
Seat 6: u+J1MTXS2qhNVMbsBemNLg ($4.05 in chips) 
9StOHp+Y1T0K13JdgS2oQQ: posts small blind $0.10
u+J1MTXS2qhNVMbsBemNLg: posts big blind $0.25
leaf64: sits out 
*** HOLE CARDS ***
OZc6kkoTwtITj1ZfreJK1A: folds 
LtASJ9OlkqGrrUKGQlpGAw: folds 
v+QfkGiuj9bgtuNoVnDO8w: folds 
9StOHp+Y1T0K13JdgS2oQQ: folds 
Uncalled bet ($0.15) returned to u+J1MTXS2qhNVMbsBemNLg
u+J1MTXS2qhNVMbsBemNLg collected $0.20 from pot
u+J1MTXS2qhNVMbsBemNLg: doesn't show hand 
*** SUMMARY ***
Total pot $0.20 | Rake $0 
Seat 1: OZc6kkoTwtITj1ZfreJK1A folded before Flop (didn't bet)
Seat 2: LtASJ9OlkqGrrUKGQlpGAw folded before Flop (didn't bet)
Seat 4: v+QfkGiuj9bgtuNoVnDO8w (button) folded before Flop (didn't bet)
Seat 5: 9StOHp+Y1T0K13JdgS2oQQ (small blind) folded before Flop
Seat 6: u+J1MTXS2qhNVMbsBemNLg (big blind) collected ($0.20)




PokerStars Game #59941637468:  Hold'em No Limit ($0.10/$0.25) - 2009/07/01 1:41:28 ET
Table '3eK1r4Q4BSYFvsKkuTLpIA' 9-max Seat #8 is the button
Seat 1: vSkQm2EelzwRGDDQQk0Fqw ($4.65 in chips) 
Seat 2: aNpwfA31EREwO+ar4XzBCw ($27.75 in chips) 
Seat 3: 56S3mA6Zs3pGR+0p0vUCtg ($31.55 in chips) 
Seat 4: +2kMBNpY4nF1qNCRd8SJLA ($25 in chips) 
Seat 5: 775TiRJajPtN/ucpTmHrXA ($14.75 in chips) 
Seat 6: +HvCCmsGSQeatf+GZ9zk8Q ($39.20 in chips) 
Seat 7: ljemhp25Zg+nlA9DLCIiUw ($24.65 in chips) 
Seat 8: /29aHLC+Q6KCDcNv2bPfAg ($12.80 in chips) 
Seat 9: +sbyWwIcFp9kP0bDtMegfQ ($60.50 in chips) 
+sbyWwIcFp9kP0bDtMegfQ: posts small blind $0.10
vSkQm2EelzwRGDDQQk0Fqw: posts big blind $0.25
*** HOLE CARDS ***
aNpwfA31EREwO+ar4XzBCw: folds 
56S3mA6Zs3pGR+0p0vUCtg: folds 
+2kMBNpY4nF1qNCRd8SJLA: folds 
775TiRJajPtN/ucpTmHrXA: folds 
+HvCCmsGSQeatf+GZ9zk8Q: folds 
ljemhp25Zg+nlA9DLCIiUw: raises $0.50 to $0.75
/29aHLC+Q6KCDcNv2bPfAg: folds 
+sbyWwIcFp9kP0bDtMegfQ: folds 
vSkQm2EelzwRGDDQQk0Fqw: folds 
Uncalled bet ($0.50) returned to ljemhp25Zg+nlA9DLCIiUw
ljemhp25Zg+nlA9DLCIiUw collected $0.60 from pot
ljemhp25Zg+nlA9DLCIiUw: doesn't show hand 
*** SUMMARY ***
Total pot $0.60 | Rake $0 
Seat 1: vSkQm2EelzwRGDDQQk0Fqw (big blind) folded before Flop
Seat 2: aNpwfA31EREwO+ar4XzBCw folded before Flop (didn't bet)
Seat 3: 56S3mA6Zs3pGR+0p0vUCtg folded before Flop (didn't bet)
Seat 4: +2kMBNpY4nF1qNCRd8SJLA folded before Flop (didn't bet)
Seat 5: 775TiRJajPtN/ucpTmHrXA folded before Flop (didn't bet)
Seat 6: +HvCCmsGSQeatf+GZ9zk8Q folded before Flop (didn't bet)
Seat 7: ljemhp25Zg+nlA9DLCIiUw collected ($0.60)
Seat 8: /29aHLC+Q6KCDcNv2bPfAg (button) folded before Flop (didn't bet)
Seat 9: +sbyWwIcFp9kP0bDtMegfQ (small blind) folded before Flop




PokerStars Game #59941637546:  Hold'em No Limit ($0.10/$0.25) - 2009/07/01 1:41:28 ET
Table 'IdXp6nyeW4FYaEK4qKCnwQ' 9-max Seat #7 is the button
Seat 1: tLcDklc2rBORNfixyRfVfw ($25 in chips) 
Seat 2: HPEB+AtKw1+C/cxU0o1ciw ($32.50 in chips) 
Seat 3: eK8qa6EPcH2zhtbmWSvc9g ($33.05 in chips) 
Seat 4: j4q3p0lesp63b1gZDwLBZw ($5.35 in chips) 
Seat 5: U41wNf6XauAiBOQaKu2ZIA ($25.90 in chips) 
Seat 6: arxNSjreDRGFg13EAM2F1w ($25.85 in chips) 
Seat 7: w1ukf8uPa4+WH561TtVRxA ($37 in chips) 
Seat 8: dtZ84flFEi4Q+SGrHMJRDQ ($31.20 in chips) 
Seat 9: s2xLPOl/vhl/26apJ3vsOQ ($28.65 in chips) 
dtZ84flFEi4Q+SGrHMJRDQ: posts small blind $0.10
s2xLPOl/vhl/26apJ3vsOQ: posts big blind $0.25
*** HOLE CARDS ***
tLcDklc2rBORNfixyRfVfw: folds 
HPEB+AtKw1+C/cxU0o1ciw: folds 
eK8qa6EPcH2zhtbmWSvc9g: folds 
j4q3p0lesp63b1gZDwLBZw: folds 
U41wNf6XauAiBOQaKu2ZIA: calls $0.25
arxNSjreDRGFg13EAM2F1w: folds 
w1ukf8uPa4+WH561TtVRxA: folds 
dtZ84flFEi4Q+SGrHMJRDQ: folds 
s2xLPOl/vhl/26apJ3vsOQ: checks 
*** FLOP *** [Kc 3c 4s]
s2xLPOl/vhl/26apJ3vsOQ: checks 
U41wNf6XauAiBOQaKu2ZIA: checks 
*** TURN *** [Kc 3c 4s] [Ah]
s2xLPOl/vhl/26apJ3vsOQ: checks 
U41wNf6XauAiBOQaKu2ZIA: checks 
*** RIVER *** [Kc 3c 4s Ah] [Ac]
s2xLPOl/vhl/26apJ3vsOQ: checks 
U41wNf6XauAiBOQaKu2ZIA: checks 
*** SHOW DOWN ***
s2xLPOl/vhl/26apJ3vsOQ: shows [3s 2d] (two pair, Aces and Threes)
U41wNf6XauAiBOQaKu2ZIA: shows [Qh 7h] (a pair of Aces)
s2xLPOl/vhl/26apJ3vsOQ collected $0.60 from pot
*** SUMMARY ***
Total pot $0.60 | Rake $0 
Board [Kc 3c 4s Ah Ac]
Seat 1: tLcDklc2rBORNfixyRfVfw folded before Flop (didn't bet)
Seat 2: HPEB+AtKw1+C/cxU0o1ciw folded before Flop (didn't bet)
Seat 3: eK8qa6EPcH2zhtbmWSvc9g folded before Flop (didn't bet)
Seat 4: j4q3p0lesp63b1gZDwLBZw folded before Flop (didn't bet)
Seat 5: U41wNf6XauAiBOQaKu2ZIA showed [Qh 7h] and lost with a pair of Aces
Seat 6: arxNSjreDRGFg13EAM2F1w folded before Flop (didn't bet)
Seat 7: w1ukf8uPa4+WH561TtVRxA (button) folded before Flop (didn't bet)
Seat 8: dtZ84flFEi4Q+SGrHMJRDQ (small blind) folded before Flop
Seat 9: s2xLPOl/vhl/26apJ3vsOQ (big blind) showed [3s 2d] and won ($0.60) with two pair, Aces and Threes




PokerStars Game #59941637308:  Hold'em No Limit ($0.10/$0.25) - 2009/07/01 1:41:28 ET
Table '/VaaaFnlEJoYVomG9uxHkA' 9-max Seat #6 is the button
Seat 1: Th3FldXKQW6hWVVPahaoOQ ($26 in chips) 
Seat 2: DIkeSkosO/tsUp9d2JVyTA ($58.55 in chips) 
Seat 3: MtVtHDqIJTyUcXkRBBDIVA ($26.50 in chips) 
Seat 4: j4q3p0lesp63b1gZDwLBZw ($5 in chips) 
Seat 5: cZ99hugmLBj9KhTlc8nCSw ($25.50 in chips) 
Seat 6: qxWFg3MZuVyidB0SJh5ywg ($33.60 in chips) 
Seat 7: F7pnn6czNpHvRM55XcA2EA ($25.60 in chips) 
Seat 8: dfNim92Z6XK1/h5SFW5vDg ($46.25 in chips) 
Seat 9: qpG9m8I+cPw8VhB0mnGjYw ($25.10 in chips) 
F7pnn6czNpHvRM55XcA2EA: posts small blind $0.10
dfNim92Z6XK1/h5SFW5vDg: posts big blind $0.25
*** HOLE CARDS ***
qpG9m8I+cPw8VhB0mnGjYw: folds 
Th3FldXKQW6hWVVPahaoOQ: folds 
DIkeSkosO/tsUp9d2JVyTA: folds 
MtVtHDqIJTyUcXkRBBDIVA: folds 
j4q3p0lesp63b1gZDwLBZw: folds 
cZ99hugmLBj9KhTlc8nCSw: folds 
qxWFg3MZuVyidB0SJh5ywg: raises $0.75 to $1
F7pnn6czNpHvRM55XcA2EA: folds 
dfNim92Z6XK1/h5SFW5vDg: folds 
Uncalled bet ($0.75) returned to qxWFg3MZuVyidB0SJh5ywg
qxWFg3MZuVyidB0SJh5ywg collected $0.60 from pot
*** SUMMARY ***
Total pot $0.60 | Rake $0 
Seat 1: Th3FldXKQW6hWVVPahaoOQ folded before Flop (didn't bet)
Seat 2: DIkeSkosO/tsUp9d2JVyTA folded before Flop (didn't bet)
Seat 3: MtVtHDqIJTyUcXkRBBDIVA folded before Flop (didn't bet)
Seat 4: j4q3p0lesp63b1gZDwLBZw folded before Flop (didn't bet)
Seat 5: cZ99hugmLBj9KhTlc8nCSw folded before Flop (didn't bet)
Seat 6: qxWFg3MZuVyidB0SJh5ywg (button) collected ($0.60)
Seat 7: F7pnn6czNpHvRM55XcA2EA (small blind) folded before Flop
Seat 8: dfNim92Z6XK1/h5SFW5vDg (big blind) folded before Flop
Seat 9: qpG9m8I+cPw8VhB0mnGjYw folded before Flop (didn't bet)




PokerStars Game #59941637914:  Hold'em No Limit ($0.10/$0.25) - 2009/07/01 1:41:29 ET
Table 'JUMeG5SzDyo9HufhgemQeA' 9-max Seat #5 is the button
Seat 1: oLa/tXLfSLLB28mcLGrxcg ($24.55 in chips) 
Seat 2: Jve2LRs9vtGL7NdiNeXY/A ($15 in chips) 
Seat 3: IEvLSTIxhlti3EjZDarYnA ($32.50 in chips) 
Seat 4: 9+Um1wMtYNWnmPLUEU4viQ ($15 in chips) 
Seat 5: Ne5zBB6oEKrbigKRh6d6Xg ($12.50 in chips) 
Seat 6: wFCwdYKUXoQHhz8qeZuuAw ($25.20 in chips) 
Seat 7: aNpwfA31EREwO+ar4XzBCw ($32.50 in chips) 
Seat 8: zDrucyjVn5aeekNEc3cJrA ($37.70 in chips) 
Seat 9: V6p0jQ/RhUsqpHLmXvEX4Q ($13.80 in chips) 
wFCwdYKUXoQHhz8qeZuuAw: posts small blind $0.10
aNpwfA31EREwO+ar4XzBCw: posts big blind $0.25
Jve2LRs9vtGL7NdiNeXY/A: posts big blind $0.25
9+Um1wMtYNWnmPLUEU4viQ: posts big blind $0.25
*** HOLE CARDS ***
zDrucyjVn5aeekNEc3cJrA: folds 
zDrucyjVn5aeekNEc3cJrA is sitting out
V6p0jQ/RhUsqpHLmXvEX4Q: folds 
oLa/tXLfSLLB28mcLGrxcg: folds 
Jve2LRs9vtGL7NdiNeXY/A: raises $0.25 to $0.50
IEvLSTIxhlti3EjZDarYnA: folds 
9+Um1wMtYNWnmPLUEU4viQ: raises $0.75 to $1.25
Ne5zBB6oEKrbigKRh6d6Xg: calls $1.25
wFCwdYKUXoQHhz8qeZuuAw: folds 
aNpwfA31EREwO+ar4XzBCw: folds 
Jve2LRs9vtGL7NdiNeXY/A: calls $0.75
*** FLOP *** [Th 9h 8c]
Jve2LRs9vtGL7NdiNeXY/A: checks 
9+Um1wMtYNWnmPLUEU4viQ: bets $1.25
Ne5zBB6oEKrbigKRh6d6Xg: folds 
Jve2LRs9vtGL7NdiNeXY/A: folds 
Uncalled bet ($1.25) returned to 9+Um1wMtYNWnmPLUEU4viQ
9+Um1wMtYNWnmPLUEU4viQ collected $3.90 from pot
9+Um1wMtYNWnmPLUEU4viQ: doesn't show hand 
*** SUMMARY ***
Total pot $4.10 | Rake $0.20 
Board [Th 9h 8c]
Seat 1: oLa/tXLfSLLB28mcLGrxcg folded before Flop (didn't bet)
Seat 2: Jve2LRs9vtGL7NdiNeXY/A folded on the Flop
Seat 3: IEvLSTIxhlti3EjZDarYnA folded before Flop (didn't bet)
Seat 4: 9+Um1wMtYNWnmPLUEU4viQ collected ($3.90)
Seat 5: Ne5zBB6oEKrbigKRh6d6Xg (button) folded on the Flop
Seat 6: wFCwdYKUXoQHhz8qeZuuAw (small blind) folded before Flop
Seat 7: aNpwfA31EREwO+ar4XzBCw (big blind) folded before Flop
Seat 8: zDrucyjVn5aeekNEc3cJrA folded before Flop (didn't bet)
Seat 9: V6p0jQ/RhUsqpHLmXvEX4Q folded before Flop (didn't bet)




PokerStars Game #59941637838:  Hold'em No Limit ($0.10/$0.25) - 2009/07/01 1:41:29 ET
Table 'ORSZkZqq+7Ja2PdeCFAytA' 9-max Seat #8 is the button
Seat 1: 3FkcXBaxKqxYVagfYUZlmw ($12.50 in chips) 
Seat 2: FzknuThd6oNi5WfR7ciTfA ($22.50 in chips) 
Seat 3: s9a4d23HFxaL70yUWQ0/tQ ($17.65 in chips) 
Seat 4: tbgfV2Egwn85xEt865GWQQ ($15.15 in chips) 
Seat 5: +lWbsq4dTcA70SX/+hnmpg ($4.40 in chips) 
Seat 6: gMF+EMhmwpnaM5TFQquf2A ($13.75 in chips) 
Seat 7: L4arauLTM5DsCc2Y3lI8Yw ($4.50 in chips) 
Seat 8: npAYqa85pqnzfOK5ukX+BQ ($19.90 in chips) 
Seat 9: cMTFs4oCtNInkpDIecxT/w ($9.90 in chips) 
cMTFs4oCtNInkpDIecxT/w: posts small blind $0.10
3FkcXBaxKqxYVagfYUZlmw: posts big blind $0.25
*** HOLE CARDS ***
FzknuThd6oNi5WfR7ciTfA: raises $0.25 to $0.50
s9a4d23HFxaL70yUWQ0/tQ: folds 
tbgfV2Egwn85xEt865GWQQ: folds 
+lWbsq4dTcA70SX/+hnmpg: folds 
gMF+EMhmwpnaM5TFQquf2A: calls $0.50
L4arauLTM5DsCc2Y3lI8Yw: raises $4 to $4.50 and is all-in
npAYqa85pqnzfOK5ukX+BQ: folds 
cMTFs4oCtNInkpDIecxT/w: calls $4.40
3FkcXBaxKqxYVagfYUZlmw: folds 
FzknuThd6oNi5WfR7ciTfA: calls $4
gMF+EMhmwpnaM5TFQquf2A: calls $4
*** FLOP *** [8c 6s 4s]
cMTFs4oCtNInkpDIecxT/w: bets $5.40 and is all-in
FzknuThd6oNi5WfR7ciTfA: folds 
gMF+EMhmwpnaM5TFQquf2A: folds 
Uncalled bet ($5.40) returned to cMTFs4oCtNInkpDIecxT/w
*** TURN *** [8c 6s 4s] [3c]
*** RIVER *** [8c 6s 4s 3c] [5d]
*** SHOW DOWN ***
cMTFs4oCtNInkpDIecxT/w: shows [Js Jd] (a pair of Jacks)
L4arauLTM5DsCc2Y3lI8Yw: mucks hand 
cMTFs4oCtNInkpDIecxT/w collected $17.35 from pot
*** SUMMARY ***
Total pot $18.25 | Rake $0.90 
Board [8c 6s 4s 3c 5d]
Seat 1: 3FkcXBaxKqxYVagfYUZlmw (big blind) folded before Flop
Seat 2: FzknuThd6oNi5WfR7ciTfA folded on the Flop
Seat 3: s9a4d23HFxaL70yUWQ0/tQ folded before Flop (didn't bet)
Seat 4: tbgfV2Egwn85xEt865GWQQ folded before Flop (didn't bet)
Seat 5: +lWbsq4dTcA70SX/+hnmpg folded before Flop (didn't bet)
Seat 6: gMF+EMhmwpnaM5TFQquf2A folded on the Flop
Seat 7: L4arauLTM5DsCc2Y3lI8Yw mucked
Seat 8: npAYqa85pqnzfOK5ukX+BQ (button) folded before Flop (didn't bet)
Seat 9: cMTFs4oCtNInkpDIecxT/w (small blind) showed [Js Jd] and won ($17.35) with a pair of Jacks




PokerStars Game #59941638000:  Hold'em No Limit ($0.10/$0.25) - 2009/07/01 1:41:29 ET
Table 'L5GvbdQO5aCZJSE6pyQ8OA' 6-max Seat #3 is the button
Seat 1: eFj4lr1nuXLyCWNTShr1bg ($11.10 in chips) 
Seat 2: DihMHaz4WNETH1bPDe13kA ($29.05 in chips) 
Seat 3: JFIAqU8lCZ0vWwEl4bdGsg ($27.95 in chips) 
Seat 5: LyDHtw3/yniNHW+DvLXbog ($26.05 in chips) 
Seat 6: v+QfkGiuj9bgtuNoVnDO8w ($39.75 in chips) 
LyDHtw3/yniNHW+DvLXbog: posts small blind $0.10
v+QfkGiuj9bgtuNoVnDO8w: posts big blind $0.25
*** HOLE CARDS ***
eFj4lr1nuXLyCWNTShr1bg: folds 
DihMHaz4WNETH1bPDe13kA: folds 
JFIAqU8lCZ0vWwEl4bdGsg: raises $0.60 to $0.85
LyDHtw3/yniNHW+DvLXbog: folds 
v+QfkGiuj9bgtuNoVnDO8w: folds 
Uncalled bet ($0.60) returned to JFIAqU8lCZ0vWwEl4bdGsg
JFIAqU8lCZ0vWwEl4bdGsg collected $0.60 from pot
JFIAqU8lCZ0vWwEl4bdGsg: doesn't show hand 
*** SUMMARY ***
Total pot $0.60 | Rake $0 
Seat 1: eFj4lr1nuXLyCWNTShr1bg folded before Flop (didn't bet)
Seat 2: DihMHaz4WNETH1bPDe13kA folded before Flop (didn't bet)
Seat 3: JFIAqU8lCZ0vWwEl4bdGsg (button) collected ($0.60)
Seat 5: LyDHtw3/yniNHW+DvLXbog (small blind) folded before Flop
Seat 6: v+QfkGiuj9bgtuNoVnDO8w (big blind) folded before Flop




PokerStars Game #59941638152:  Hold'em No Limit ($0.10/$0.25) - 2009/07/01 1:41:29 ET
Table 'BpNkESDX1ip9c0K1hb5h7A' 6-max Seat #3 is the button
Seat 2: g+5jEA4Xq9vcMOfdFYNuFA ($10.70 in chips) 
Seat 3: fZQg9veL7Dd/Z04ZTjC+wQ ($25 in chips) 
Seat 4: kG34n23qFQA3nzdOJTQ1dA ($26.25 in chips) 
Seat 5: L3/N/gliETan8N5Gim5h4Q ($25.50 in chips) 
Seat 6: 8EEqTTh7T1q48sYDqbI2Xg ($21.90 in chips) 
kG34n23qFQA3nzdOJTQ1dA: posts small blind $0.10
L3/N/gliETan8N5Gim5h4Q: posts big blind $0.25
*** HOLE CARDS ***
sam030684 has returned
8EEqTTh7T1q48sYDqbI2Xg: calls $0.25
g+5jEA4Xq9vcMOfdFYNuFA: folds 
fZQg9veL7Dd/Z04ZTjC+wQ: raises $1 to $1.25
kG34n23qFQA3nzdOJTQ1dA: folds 
L3/N/gliETan8N5Gim5h4Q: folds 
8EEqTTh7T1q48sYDqbI2Xg: folds 
Uncalled bet ($1) returned to fZQg9veL7Dd/Z04ZTjC+wQ
fZQg9veL7Dd/Z04ZTjC+wQ collected $0.85 from pot
fZQg9veL7Dd/Z04ZTjC+wQ: doesn't show hand 
*** SUMMARY ***
Total pot $0.85 | Rake $0 
Seat 2: g+5jEA4Xq9vcMOfdFYNuFA folded before Flop (didn't bet)
Seat 3: fZQg9veL7Dd/Z04ZTjC+wQ (button) collected ($0.85)
Seat 4: kG34n23qFQA3nzdOJTQ1dA (small blind) folded before Flop
Seat 5: L3/N/gliETan8N5Gim5h4Q (big blind) folded before Flop
Seat 6: 8EEqTTh7T1q48sYDqbI2Xg folded before Flop




PokerStars Game #59941637740:  Hold'em No Limit ($0.10/$0.25) - 2009/07/01 1:41:29 ET
Table 'MRfAiS/4JSfnUDlCcZo0wAhfHe8uKeSJMyWAjSdM7ROQx Seat #2 is the button
Seat 1: 48oT5xFI+5CHUJlfoGrE4w ($31.25 in chips) 
Seat 2: /gJNBeCkWL4o85/jvlZ4BA ($29.35 in chips) 
Seat 3: FYepjhAvF8ZdVCmqHIy+eQ ($39.15 in chips) 
Seat 4: b4wRQV3APH8irVk6bUFe2Q ($28.15 in chips) 
Seat 6: L3/N/gliETan8N5Gim5h4Q ($25.35 in chips) 
FYepjhAvF8ZdVCmqHIy+eQ: posts small blind $0.10
b4wRQV3APH8irVk6bUFe2Q: posts big blind $0.25
*** HOLE CARDS ***
L3/N/gliETan8N5Gim5h4Q: raises $0.50 to $0.75
48oT5xFI+5CHUJlfoGrE4w: calls $0.75
/gJNBeCkWL4o85/jvlZ4BA: folds 
FYepjhAvF8ZdVCmqHIy+eQ: folds 
b4wRQV3APH8irVk6bUFe2Q: calls $0.50
*** FLOP *** [2d 8s Qd]
b4wRQV3APH8irVk6bUFe2Q: checks 
L3/N/gliETan8N5Gim5h4Q: checks 
48oT5xFI+5CHUJlfoGrE4w: checks 
*** TURN *** [2d 8s Qd] [3s]
b4wRQV3APH8irVk6bUFe2Q: checks 
L3/N/gliETan8N5Gim5h4Q: checks 
48oT5xFI+5CHUJlfoGrE4w: checks 
*** RIVER *** [2d 8s Qd 3s] [Ts]
b4wRQV3APH8irVk6bUFe2Q: bets $1.50
L3/N/gliETan8N5Gim5h4Q: folds 
48oT5xFI+5CHUJlfoGrE4w: folds 
Uncalled bet ($1.50) returned to b4wRQV3APH8irVk6bUFe2Q
b4wRQV3APH8irVk6bUFe2Q collected $2.25 from pot
*** SUMMARY ***
Total pot $2.35 | Rake $0.10 
Board [2d 8s Qd 3s Ts]
Seat 1: 48oT5xFI+5CHUJlfoGrE4w folded on the River
Seat 2: /gJNBeCkWL4o85/jvlZ4BA (button) folded before Flop (didn't bet)
Seat 3: FYepjhAvF8ZdVCmqHIy+eQ (small blind) folded before Flop
Seat 4: b4wRQV3APH8irVk6bUFe2Q (big blind) collected ($2.25)
Seat 6: L3/N/gliETan8N5Gim5h4Q folded on the River




PokerStars Game #59941637948:  Hold'em No Limit ($0.10/$0.25) - 2009/07/01 1:41:29 ET
Table 'IUwZ/e0bDHZPgsIWx0RnNg' 6-max Seat #3 is the button
Seat 1: V66QiVCQPofyl3a+dpPHQQ ($5.35 in chips) 
Seat 2: mvFHK3pE7tCxJEqLjKC70Q ($54.65 in chips) 
Seat 3: dOX4wnYV2sEqvDbF+8KSCw ($25.35 in chips) 
Seat 6: NhUN/JpAprdJeamFBgJH1w ($40.35 in chips) 
pistolp999 will be allowed to play after the button
geomdnb will be allowed to play after the button
NhUN/JpAprdJeamFBgJH1w: posts small blind $0.10
V66QiVCQPofyl3a+dpPHQQ: posts big blind $0.25
*** HOLE CARDS ***
mvFHK3pE7tCxJEqLjKC70Q: folds 
dOX4wnYV2sEqvDbF+8KSCw: folds 
NhUN/JpAprdJeamFBgJH1w: folds 
Uncalled bet ($0.15) returned to V66QiVCQPofyl3a+dpPHQQ
V66QiVCQPofyl3a+dpPHQQ collected $0.20 from pot
*** SUMMARY ***
Total pot $0.20 | Rake $0 
Seat 1: V66QiVCQPofyl3a+dpPHQQ (big blind) collected ($0.20)
Seat 2: mvFHK3pE7tCxJEqLjKC70Q folded before Flop (didn't bet)
Seat 3: dOX4wnYV2sEqvDbF+8KSCw (button) folded before Flop (didn't bet)
Seat 6: NhUN/JpAprdJeamFBgJH1w (small blind) folded before Flop




PokerStars Game #59941638144:  Hold'em No Limit ($0.10/$0.25) - 2009/07/01 1:41:29 ET
Table 'dNYnr4D4id1jwnEU66Yowg' 9-max Seat #6 is the button
Seat 1: 9lvO/qyU+xrU95Teu1fv0g ($4.65 in chips) 
Seat 4: VBHxUExRAMrbxUq/cVx9Gw ($4.95 in chips) 
Seat 5: 7cv+9Zc9HIQHNvYsMfV3uA ($26.05 in chips) 
Seat 6: 8EbrQ/EvFWt2cr0GaU82gQ ($4.65 in chips) 
Seat 7: DiSvPC2iudwL5j9u6Huyww ($25.55 in chips) 
Seat 8: RCqMONFrSPSArZh2Jsar/w ($22.45 in chips) 
Seat 9: K0dyGSZP/cgeQjH6o6u9Rw ($16.30 in chips) 
DiSvPC2iudwL5j9u6Huyww: posts small blind $0.10
RCqMONFrSPSArZh2Jsar/w: posts big blind $0.25
Dr.Hibbert55: sits out 
*** HOLE CARDS ***
K0dyGSZP/cgeQjH6o6u9Rw: folds 
K0dyGSZP/cgeQjH6o6u9Rw leaves the table
9lvO/qyU+xrU95Teu1fv0g: folds 
VBHxUExRAMrbxUq/cVx9Gw: folds 
7cv+9Zc9HIQHNvYsMfV3uA: folds 
8EbrQ/EvFWt2cr0GaU82gQ: folds 
DiSvPC2iudwL5j9u6Huyww: folds 
Uncalled bet ($0.15) returned to RCqMONFrSPSArZh2Jsar/w
RCqMONFrSPSArZh2Jsar/w collected $0.20 from pot
RCqMONFrSPSArZh2Jsar/w: doesn't show hand 
*** SUMMARY ***
Total pot $0.20 | Rake $0 
Seat 1: 9lvO/qyU+xrU95Teu1fv0g folded before Flop (didn't bet)
Seat 4: VBHxUExRAMrbxUq/cVx9Gw folded before Flop (didn't bet)
Seat 5: 7cv+9Zc9HIQHNvYsMfV3uA folded before Flop (didn't bet)
Seat 6: 8EbrQ/EvFWt2cr0GaU82gQ (button) folded before Flop (didn't bet)
Seat 7: DiSvPC2iudwL5j9u6Huyww (small blind) folded before Flop
Seat 8: RCqMONFrSPSArZh2Jsar/w (big blind) collected ($0.20)
Seat 9: K0dyGSZP/cgeQjH6o6u9Rw folded before Flop (didn't bet)




PokerStars Game #59941638142:  Hold'em No Limit ($0.10/$0.25) - 2009/07/01 1:41:29 ET
Table 'M7d9IrgQUUFFy/SZ3ksLYg' 6-max Seat #1 is the button
Seat 1: ypmjhffk/YHGc51wgVXUTw ($49.60 in chips) 
Seat 2: gqrr7lSWrQ1N8zKx8zZzvA ($10.80 in chips) 
Seat 3: 8JTm/CXBn3+kuQgcUOgPkw ($23.30 in chips) 
Seat 4: 8ClCHtFXGNplITm+63KB+Q ($24.90 in chips) 
Seat 5: kMa8BltUcBQVxnHfqdCfXg ($5.60 in chips) 
Seat 6: 7S16WhQHiAVLWwRuqPrpnw ($8.60 in chips) 
gqrr7lSWrQ1N8zKx8zZzvA: posts small blind $0.10
8JTm/CXBn3+kuQgcUOgPkw: posts big blind $0.25
*** HOLE CARDS ***
8ClCHtFXGNplITm+63KB+Q: folds 
kMa8BltUcBQVxnHfqdCfXg: calls $0.25
7S16WhQHiAVLWwRuqPrpnw: calls $0.25
ypmjhffk/YHGc51wgVXUTw: folds 
gqrr7lSWrQ1N8zKx8zZzvA: calls $0.15
8JTm/CXBn3+kuQgcUOgPkw: checks 
*** FLOP *** [2s 9s 4c]
gqrr7lSWrQ1N8zKx8zZzvA: checks 
8JTm/CXBn3+kuQgcUOgPkw: checks 
kMa8BltUcBQVxnHfqdCfXg: bets $0.25
7S16WhQHiAVLWwRuqPrpnw: calls $0.25
gqrr7lSWrQ1N8zKx8zZzvA: calls $0.25
8JTm/CXBn3+kuQgcUOgPkw: calls $0.25
*** TURN *** [2s 9s 4c] [3c]
gqrr7lSWrQ1N8zKx8zZzvA: checks 
8JTm/CXBn3+kuQgcUOgPkw: checks 
kMa8BltUcBQVxnHfqdCfXg: checks 
7S16WhQHiAVLWwRuqPrpnw: bets $1.25
gqrr7lSWrQ1N8zKx8zZzvA: calls $1.25
8JTm/CXBn3+kuQgcUOgPkw: folds 
kMa8BltUcBQVxnHfqdCfXg: folds 
*** RIVER *** [2s 9s 4c 3c] [9d]
gqrr7lSWrQ1N8zKx8zZzvA: checks 
7S16WhQHiAVLWwRuqPrpnw: checks 
*** SHOW DOWN ***
gqrr7lSWrQ1N8zKx8zZzvA: shows [Jc Tc] (a pair of Nines)
7S16WhQHiAVLWwRuqPrpnw: shows [3s 4h] (two pair, Nines and Fours)
7S16WhQHiAVLWwRuqPrpnw collected $4.30 from pot
*** SUMMARY ***
Total pot $4.50 | Rake $0.20 
Board [2s 9s 4c 3c 9d]
Seat 1: ypmjhffk/YHGc51wgVXUTw (button) folded before Flop (didn't bet)
Seat 2: gqrr7lSWrQ1N8zKx8zZzvA (small blind) showed [Jc Tc] and lost with a pair of Nines
Seat 3: 8JTm/CXBn3+kuQgcUOgPkw (big blind) folded on the Turn
Seat 4: 8ClCHtFXGNplITm+63KB+Q folded before Flop (didn't bet)
Seat 5: kMa8BltUcBQVxnHfqdCfXg folded on the Turn
Seat 6: 7S16WhQHiAVLWwRuqPrpnw showed [3s 4h] and won ($4.30) with two pair, Nines and Fours




PokerStars Game #59941637794:  Hold'em No Limit ($0.10/$0.25) - 2009/07/01 1:41:29 ET
Table '9L7XfAwuM7XsXE8LIg2o5Q' 6-max Seat #5 is the button
Seat 1: dOIoLBxmpLHSXBN9LZnf0Q ($24.85 in chips) 
Seat 2: LJI7A1YgDM7hgh7o56+ReQ ($26.60 in chips) 
Seat 3: kv2o5BKCLOrJIw4oc083jQ ($27.20 in chips) 
Seat 4: jp34e617tIzV8tKIWmfAbA ($39.95 in chips) 
Seat 5: OUv909q/YxsJgxpSlZxLJQ ($33.85 in chips) 
Seat 6: k9nHZTHt8hYhYRcW8NTb4g ($37.10 in chips) 
k9nHZTHt8hYhYRcW8NTb4g: posts small blind $0.10
dOIoLBxmpLHSXBN9LZnf0Q: posts big blind $0.25
*** HOLE CARDS ***
LJI7A1YgDM7hgh7o56+ReQ: folds 
kv2o5BKCLOrJIw4oc083jQ: folds 
jp34e617tIzV8tKIWmfAbA: folds 
OUv909q/YxsJgxpSlZxLJQ: folds 
k9nHZTHt8hYhYRcW8NTb4g: folds 
Uncalled bet ($0.15) returned to dOIoLBxmpLHSXBN9LZnf0Q
dOIoLBxmpLHSXBN9LZnf0Q collected $0.20 from pot
dOIoLBxmpLHSXBN9LZnf0Q: doesn't show hand 
*** SUMMARY ***
Total pot $0.20 | Rake $0 
Seat 1: dOIoLBxmpLHSXBN9LZnf0Q (big blind) collected ($0.20)
Seat 2: LJI7A1YgDM7hgh7o56+ReQ folded before Flop (didn't bet)
Seat 3: kv2o5BKCLOrJIw4oc083jQ folded before Flop (didn't bet)
Seat 4: jp34e617tIzV8tKIWmfAbA folded before Flop (didn't bet)
Seat 5: OUv909q/YxsJgxpSlZxLJQ (button) folded before Flop (didn't bet)
Seat 6: k9nHZTHt8hYhYRcW8NTb4g (small blind) folded before Flop




PokerStars Game #59941638494:  Hold'em No Limit ($0.10/$0.25) - 2009/07/01 1:41:30 ET
Table 'Loy/olZ5qoDOSvX4UTujGg' 6-max Seat #2 is the button
Seat 1: HipgaJhkN4ie/tTw4dK3Ug ($12.30 in chips) 
Seat 2: 4z7mPbMLNp4TezHXin63Vw ($17.80 in chips) 
Seat 3: 32YL2ZEp8NT4JB2RVM9euQ ($15.80 in chips) 
Seat 4: /gJNBeCkWL4o85/jvlZ4BA ($29.65 in chips) 
Seat 5: tSR4329m40dZsN7YOpI9Kw ($28.70 in chips) 
Seat 6: qGHGf/553gQnDoklMRe3tg ($24.60 in chips) 
32YL2ZEp8NT4JB2RVM9euQ: posts small blind $0.10
/gJNBeCkWL4o85/jvlZ4BA: posts big blind $0.25
*** HOLE CARDS ***
tSR4329m40dZsN7YOpI9Kw: folds 
qGHGf/553gQnDoklMRe3tg: raises $0.75 to $1
HipgaJhkN4ie/tTw4dK3Ug: calls $1
4z7mPbMLNp4TezHXin63Vw: folds 
32YL2ZEp8NT4JB2RVM9euQ: folds 
/gJNBeCkWL4o85/jvlZ4BA: calls $0.75
*** FLOP *** [Jd 4s Kh]
/gJNBeCkWL4o85/jvlZ4BA: checks 
qGHGf/553gQnDoklMRe3tg: bets $2
HipgaJhkN4ie/tTw4dK3Ug: folds 
/gJNBeCkWL4o85/jvlZ4BA: folds 
Uncalled bet ($2) returned to qGHGf/553gQnDoklMRe3tg
qGHGf/553gQnDoklMRe3tg collected $2.95 from pot
qGHGf/553gQnDoklMRe3tg: doesn't show hand 
*** SUMMARY ***
Total pot $3.10 | Rake $0.15 
Board [Jd 4s Kh]
Seat 1: HipgaJhkN4ie/tTw4dK3Ug folded on the Flop
Seat 2: 4z7mPbMLNp4TezHXin63Vw (button) folded before Flop (didn't bet)
Seat 3: 32YL2ZEp8NT4JB2RVM9euQ (small blind) folded before Flop
Seat 4: /gJNBeCkWL4o85/jvlZ4BA (big blind) folded on the Flop
Seat 5: tSR4329m40dZsN7YOpI9Kw folded before Flop (didn't bet)
Seat 6: qGHGf/553gQnDoklMRe3tg collected ($2.95)




PokerStars Game #59941638602:  Hold'em No Limit ($0.10/$0.25) - 2009/07/01 1:41:30 ET
Table 'KEoOIegxPF91KooL2AelUA' 6-max Seat #5 is the button
Seat 1: wsP46AGpqDjHZQmlRHKa9g ($40.30 in chips) 
Seat 2: 0Bg59Tnte1Tc7C4i9Jd9cQ ($5.20 in chips) 
Seat 3: zxeVQGaMKDsDzmSY+AInjA ($12.30 in chips) 
Seat 4: Wo60l2GQnSEc3bxPVyvIUw ($19.95 in chips) 
Seat 5: 08V++DOqzaNrRNsHIwi25w ($44.70 in chips) 
Seat 6: AMrBn4Vx9aAo/vv6WHLk6w ($3.40 in chips) 
AMrBn4Vx9aAo/vv6WHLk6w: posts small blind $0.10
wsP46AGpqDjHZQmlRHKa9g: posts big blind $0.25
*** HOLE CARDS ***
0Bg59Tnte1Tc7C4i9Jd9cQ: calls $0.25
zxeVQGaMKDsDzmSY+AInjA: calls $0.25
Wo60l2GQnSEc3bxPVyvIUw: folds 
08V++DOqzaNrRNsHIwi25w: folds 
AMrBn4Vx9aAo/vv6WHLk6w: calls $0.15
wsP46AGpqDjHZQmlRHKa9g: raises $1.50 to $1.75
0Bg59Tnte1Tc7C4i9Jd9cQ: calls $1.50
zxeVQGaMKDsDzmSY+AInjA: folds 
AMrBn4Vx9aAo/vv6WHLk6w: folds 
*** FLOP *** [4s 5s Td]
wsP46AGpqDjHZQmlRHKa9g: bets $4
0Bg59Tnte1Tc7C4i9Jd9cQ: folds 
Uncalled bet ($4) returned to wsP46AGpqDjHZQmlRHKa9g
wsP46AGpqDjHZQmlRHKa9g collected $3.80 from pot
*** SUMMARY ***
Total pot $4 | Rake $0.20 
Board [4s 5s Td]
Seat 1: wsP46AGpqDjHZQmlRHKa9g (big blind) collected ($3.80)
Seat 2: 0Bg59Tnte1Tc7C4i9Jd9cQ folded on the Flop
Seat 3: zxeVQGaMKDsDzmSY+AInjA folded before Flop
Seat 4: Wo60l2GQnSEc3bxPVyvIUw folded before Flop (didn't bet)
Seat 5: 08V++DOqzaNrRNsHIwi25w (button) folded before Flop (didn't bet)
Seat 6: AMrBn4Vx9aAo/vv6WHLk6w (small blind) folded before Flop




PokerStars Game #59941638372:  Hold'em No Limit ($0.10/$0.25) - 2009/07/01 1:41:30 ET
Table 'Pz8SfAzhP5nvWTsJRAxoDg' 6-max Seat #2 is the button
Seat 1: QiL+lEgEWwy21jk/ltaRLg ($25.95 in chips) 
Seat 2: xrf8tAXKQHG99HixCot1Iw ($25.15 in chips) 
Seat 3: mfrkWA3PTeYPkbO6hi98Aw ($27.95 in chips) 
Seat 4: 4lJto+Qj0K4JrFKvHaPTLw ($66.15 in chips) 
Seat 5: FYepjhAvF8ZdVCmqHIy+eQ ($28.75 in chips) 
Seat 6: QvTX2yGq3uKJiKPmns4TKQ ($24.65 in chips) 
mfrkWA3PTeYPkbO6hi98Aw: posts small blind $0.10
4lJto+Qj0K4JrFKvHaPTLw: posts big blind $0.25
*** HOLE CARDS ***
FYepjhAvF8ZdVCmqHIy+eQ: folds 
QvTX2yGq3uKJiKPmns4TKQ: folds 
QiL+lEgEWwy21jk/ltaRLg: folds 
xrf8tAXKQHG99HixCot1Iw: folds 
mfrkWA3PTeYPkbO6hi98Aw: folds 
Uncalled bet ($0.15) returned to 4lJto+Qj0K4JrFKvHaPTLw
4lJto+Qj0K4JrFKvHaPTLw collected $0.20 from pot
*** SUMMARY ***
Total pot $0.20 | Rake $0 
Seat 1: QiL+lEgEWwy21jk/ltaRLg folded before Flop (didn't bet)
Seat 2: xrf8tAXKQHG99HixCot1Iw (button) folded before Flop (didn't bet)
Seat 3: mfrkWA3PTeYPkbO6hi98Aw (small blind) folded before Flop
Seat 4: 4lJto+Qj0K4JrFKvHaPTLw (big blind) collected ($0.20)
Seat 5: FYepjhAvF8ZdVCmqHIy+eQ folded before Flop (didn't bet)
Seat 6: QvTX2yGq3uKJiKPmns4TKQ folded before Flop (didn't bet)




PokerStars Game #59941638280:  Hold'em No Limit ($0.10/$0.25) - 2009/07/01 1:41:30 ET
Table 'rtxA1Y01Nrq5VoyzTAuusQ' 9-max Seat #7 is the button
Seat 1: w1ukf8uPa4+WH561TtVRxA ($31.80 in chips) 
Seat 3: K9fS1IUr5GpiJG7VkJ7IbA ($4.90 in chips) 
Seat 4: lTfGgdGMRH+DZcKby2m9Nw ($13.95 in chips) 
Seat 5: MtVtHDqIJTyUcXkRBBDIVA ($27.55 in chips) 
Seat 7: 3PmVnC/15cl4oyI1TKIt4g ($4.90 in chips) 
Seat 8: DnDcAdn9P0zGovMERigpFA ($25 in chips) 
Seat 9: HPEB+AtKw1+C/cxU0o1ciw ($22.95 in chips) 
DnDcAdn9P0zGovMERigpFA: posts small blind $0.10
HPEB+AtKw1+C/cxU0o1ciw: posts big blind $0.25
Th3FldXKQW6hWVVPahaoOQ: sits out 
*** HOLE CARDS ***
w1ukf8uPa4+WH561TtVRxA: raises $0.50 to $0.75
K9fS1IUr5GpiJG7VkJ7IbA has timed out
K9fS1IUr5GpiJG7VkJ7IbA: folds 
K9fS1IUr5GpiJG7VkJ7IbA is sitting out
lTfGgdGMRH+DZcKby2m9Nw: folds 
K9fS1IUr5GpiJG7VkJ7IbA has returned
MtVtHDqIJTyUcXkRBBDIVA: folds 
3PmVnC/15cl4oyI1TKIt4g: raises $4.15 to $4.90 and is all-in
DnDcAdn9P0zGovMERigpFA: folds 
HPEB+AtKw1+C/cxU0o1ciw: folds 
w1ukf8uPa4+WH561TtVRxA: calls $4.15
*** FLOP *** [Kh Ac Qc]
*** TURN *** [Kh Ac Qc] [8c]
*** RIVER *** [Kh Ac Qc 8c] [6s]
*** SHOW DOWN ***
w1ukf8uPa4+WH561TtVRxA: shows [Jc Jd] (a pair of Jacks)
3PmVnC/15cl4oyI1TKIt4g: shows [Kd As] (two pair, Aces and Kings)
3PmVnC/15cl4oyI1TKIt4g collected $9.65 from pot
*** SUMMARY ***
Total pot $10.15 | Rake $0.50 
Board [Kh Ac Qc 8c 6s]
Seat 1: w1ukf8uPa4+WH561TtVRxA showed [Jc Jd] and lost with a pair of Jacks
Seat 3: K9fS1IUr5GpiJG7VkJ7IbA folded before Flop (didn't bet)
Seat 4: lTfGgdGMRH+DZcKby2m9Nw folded before Flop (didn't bet)
Seat 5: MtVtHDqIJTyUcXkRBBDIVA folded before Flop (didn't bet)
Seat 7: 3PmVnC/15cl4oyI1TKIt4g (button) showed [Kd As] and won ($9.65) with two pair, Aces and Kings
Seat 8: DnDcAdn9P0zGovMERigpFA (small blind) folded before Flop
Seat 9: HPEB+AtKw1+C/cxU0o1ciw (big blind) folded before Flop




PokerStars Game #59941638564:  Hold'em No Limit ($0.10/$0.25) - 2009/07/01 1:41:30 ET
Table 'HIOfhT0zga/KonFhIl6O3w' 9-max Seat #6 is the button
Seat 1: oLa/tXLfSLLB28mcLGrxcg ($24.90 in chips) 
Seat 2: er86weqXTpTB6/w2dKlYgA ($17.10 in chips) 
Seat 4: qwr38jl5txoR36M7G5qi4A ($8.65 in chips) 
Seat 5: K1MDeapSEyKyGPNZGOKfEg ($38 in chips) 
Seat 6: MThMMgdB293VOucmN9sliQ ($24.65 in chips) 
Seat 7: wvlPJBB0PtYkfeeSRDaIvQ ($13.55 in chips) 
Seat 9: dfNim92Z6XK1/h5SFW5vDg ($29.05 in chips) 
wvlPJBB0PtYkfeeSRDaIvQ: posts small blind $0.10
dfNim92Z6XK1/h5SFW5vDg: posts big blind $0.25
*** HOLE CARDS ***
oLa/tXLfSLLB28mcLGrxcg: folds 
er86weqXTpTB6/w2dKlYgA: calls $0.25
qwr38jl5txoR36M7G5qi4A: folds 
K1MDeapSEyKyGPNZGOKfEg: calls $0.25
MThMMgdB293VOucmN9sliQ: folds 
wvlPJBB0PtYkfeeSRDaIvQ: folds 
dfNim92Z6XK1/h5SFW5vDg: checks 
*** FLOP *** [Kh Ad 2h]
dfNim92Z6XK1/h5SFW5vDg: checks 
er86weqXTpTB6/w2dKlYgA: checks 
K1MDeapSEyKyGPNZGOKfEg: checks 
*** TURN *** [Kh Ad 2h] [Td]
X6+pSIPfovPcE87t+LmUKQ joins the table at seat #3 
dfNim92Z6XK1/h5SFW5vDg: checks 
er86weqXTpTB6/w2dKlYgA: checks 
K1MDeapSEyKyGPNZGOKfEg: checks 
*** RIVER *** [Kh Ad 2h Td] [Qs]
SpiiQQAzy4MUgV3I5W8giw joins the table at seat #8 
dfNim92Z6XK1/h5SFW5vDg: checks 
er86weqXTpTB6/w2dKlYgA: bets $1
K1MDeapSEyKyGPNZGOKfEg: calls $1
dfNim92Z6XK1/h5SFW5vDg: folds 
*** SHOW DOWN ***
er86weqXTpTB6/w2dKlYgA: shows [Ts Js] (a straight, Ten to Ace)
K1MDeapSEyKyGPNZGOKfEg: shows [Tc Jc] (a straight, Ten to Ace)
er86weqXTpTB6/w2dKlYgA collected $1.40 from pot
K1MDeapSEyKyGPNZGOKfEg collected $1.35 from pot
*** SUMMARY ***
Total pot $2.85 | Rake $0.10 
Board [Kh Ad 2h Td Qs]
Seat 1: oLa/tXLfSLLB28mcLGrxcg folded before Flop (didn't bet)
Seat 2: er86weqXTpTB6/w2dKlYgA showed [Ts Js] and won ($1.40) with a straight, Ten to Ace
Seat 4: qwr38jl5txoR36M7G5qi4A folded before Flop (didn't bet)
Seat 5: K1MDeapSEyKyGPNZGOKfEg showed [Tc Jc] and won ($1.35) with a straight, Ten to Ace
Seat 6: MThMMgdB293VOucmN9sliQ (button) folded before Flop (didn't bet)
Seat 7: wvlPJBB0PtYkfeeSRDaIvQ (small blind) folded before Flop
Seat 9: dfNim92Z6XK1/h5SFW5vDg (big blind) folded on the River




PokerStars Game #59941638572:  Hold'em No Limit ($0.10/$0.25) - 2009/07/01 1:41:30 ET
Table 'by7aHYEDnDd144EXOXa/jA' 9-max Seat #6 is the button
Seat 1: j4q3p0lesp63b1gZDwLBZw ($6.60 in chips) 
Seat 2: vSkQm2EelzwRGDDQQk0Fqw ($5 in chips) 
Seat 3: HOEaXncFu2ij+D5/CANAZA ($10.90 in chips) 
Seat 4: 2Xwi447v1rBHM+92U0CduA ($4.75 in chips) 
Seat 5: yyG4svzOpC1A+sUP/scg6w ($3.60 in chips) 
Seat 6: sC4BsflLWW26Qm9m+1AwJQ ($15.15 in chips) 
Seat 8: 7je+LC5Mfs6nL8YBVh4frQ ($3.75 in chips) 
Seat 9: K0b5wNInj6hUGRr6yzKFtw ($26.65 in chips) 
DigiSlarks will be allowed to play after the button
7je+LC5Mfs6nL8YBVh4frQ: posts small blind $0.10
K0b5wNInj6hUGRr6yzKFtw: posts big blind $0.25
*** HOLE CARDS ***
j4q3p0lesp63b1gZDwLBZw: folds 
vSkQm2EelzwRGDDQQk0Fqw: folds 
HOEaXncFu2ij+D5/CANAZA: calls $0.25
2Xwi447v1rBHM+92U0CduA: calls $0.25
yyG4svzOpC1A+sUP/scg6w: folds 
sC4BsflLWW26Qm9m+1AwJQ: calls $0.25
7je+LC5Mfs6nL8YBVh4frQ: calls $0.15
K0b5wNInj6hUGRr6yzKFtw: checks 
*** FLOP *** [Kh Kd 3d]
7je+LC5Mfs6nL8YBVh4frQ: checks 
K0b5wNInj6hUGRr6yzKFtw: checks 
HOEaXncFu2ij+D5/CANAZA: bets $0.25
2Xwi447v1rBHM+92U0CduA: folds 
sC4BsflLWW26Qm9m+1AwJQ: folds 
7je+LC5Mfs6nL8YBVh4frQ: folds 
K0b5wNInj6hUGRr6yzKFtw: calls $0.25
*** TURN *** [Kh Kd 3d] [Kc]
K0b5wNInj6hUGRr6yzKFtw: checks 
HOEaXncFu2ij+D5/CANAZA: bets $0.25
K0b5wNInj6hUGRr6yzKFtw: folds 
Uncalled bet ($0.25) returned to HOEaXncFu2ij+D5/CANAZA
HOEaXncFu2ij+D5/CANAZA collected $1.70 from pot
HOEaXncFu2ij+D5/CANAZA: doesn't show hand 
*** SUMMARY ***
Total pot $1.75 | Rake $0.05 
Board [Kh Kd 3d Kc]
Seat 1: j4q3p0lesp63b1gZDwLBZw folded before Flop (didn't bet)
Seat 2: vSkQm2EelzwRGDDQQk0Fqw folded before Flop (didn't bet)
Seat 3: HOEaXncFu2ij+D5/CANAZA collected ($1.70)
Seat 4: 2Xwi447v1rBHM+92U0CduA folded on the Flop
Seat 5: yyG4svzOpC1A+sUP/scg6w folded before Flop (didn't bet)
Seat 6: sC4BsflLWW26Qm9m+1AwJQ (button) folded on the Flop
Seat 8: 7je+LC5Mfs6nL8YBVh4frQ (small blind) folded on the Flop
Seat 9: K0b5wNInj6hUGRr6yzKFtw (big blind) folded on the Turn




PokerStars Game #59941638778:  Hold'em No Limit ($0.10/$0.25) - 2009/07/01 1:41:30 ET
Table 'AJGgX1ZYM8d68SWMvaLttg' 6-max Seat #5 is the button
Seat 2: zHHLkD2sRljslKKeQv/ZQw ($28.75 in chips) 
Seat 3: 8ClCHtFXGNplITm+63KB+Q ($36.70 in chips) 
Seat 4: Lz/GjRDgmgepqTR7qmS86w ($25.40 in chips) 
Seat 5: Hsvkc0/G2VV78oVmWYXecw ($5 in chips) 
Seat 6: UA5OsKS3VPaxa7uC8La/kA ($64.50 in chips) 
UA5OsKS3VPaxa7uC8La/kA: posts small blind $0.10
zHHLkD2sRljslKKeQv/ZQw: posts big blind $0.25
*** HOLE CARDS ***
8ClCHtFXGNplITm+63KB+Q: folds 
Lz/GjRDgmgepqTR7qmS86w: folds 
Hsvkc0/G2VV78oVmWYXecw: raises $0.50 to $0.75
UA5OsKS3VPaxa7uC8La/kA: folds 
zHHLkD2sRljslKKeQv/ZQw: folds 
Uncalled bet ($0.50) returned to Hsvkc0/G2VV78oVmWYXecw
Hsvkc0/G2VV78oVmWYXecw collected $0.60 from pot
Hsvkc0/G2VV78oVmWYXecw: doesn't show hand 
*** SUMMARY ***
Total pot $0.60 | Rake $0 
Seat 2: zHHLkD2sRljslKKeQv/ZQw (big blind) folded before Flop
Seat 3: 8ClCHtFXGNplITm+63KB+Q folded before Flop (didn't bet)
Seat 4: Lz/GjRDgmgepqTR7qmS86w folded before Flop (didn't bet)
Seat 5: Hsvkc0/G2VV78oVmWYXecw (button) collected ($0.60)
Seat 6: UA5OsKS3VPaxa7uC8La/kA (small blind) folded before Flop




PokerStars Game #59941638542:  Hold'em No Limit ($0.10/$0.25) - 2009/07/01 1:41:30 ET
Table '8PD/MTROSMd6Y8mZeykbpg' 6-max Seat #4 is the button
Seat 1: fxNpaToxECtD2Goelmg9vA ($25.10 in chips) 
Seat 2: +C3eP/ysyROWbEXJFPswVA ($25.10 in chips) 
Seat 3: vqWjZmdQu/Hxw96/IJTWdQ ($25.60 in chips) 
Seat 4: DFi/Lzkjsfv8QswS80JX9Q ($53.35 in chips) 
Seat 5: z3tQwy28dp5FykDJC/wzQw ($25.70 in chips) 
z3tQwy28dp5FykDJC/wzQw: posts small blind $0.10
fxNpaToxECtD2Goelmg9vA: posts big blind $0.25
*** HOLE CARDS ***
+C3eP/ysyROWbEXJFPswVA: folds 
vqWjZmdQu/Hxw96/IJTWdQ: folds 
DFi/Lzkjsfv8QswS80JX9Q: raises $0.75 to $1
+C3eP/ysyROWbEXJFPswVA leaves the table
z3tQwy28dp5FykDJC/wzQw: folds 
fxNpaToxECtD2Goelmg9vA: folds 
Uncalled bet ($0.75) returned to DFi/Lzkjsfv8QswS80JX9Q
DFi/Lzkjsfv8QswS80JX9Q collected $0.60 from pot
DFi/Lzkjsfv8QswS80JX9Q: doesn't show hand 
*** SUMMARY ***
Total pot $0.60 | Rake $0 
Seat 1: fxNpaToxECtD2Goelmg9vA (big blind) folded before Flop
Seat 2: +C3eP/ysyROWbEXJFPswVA folded before Flop (didn't bet)
Seat 3: vqWjZmdQu/Hxw96/IJTWdQ folded before Flop (didn't bet)
Seat 4: DFi/Lzkjsfv8QswS80JX9Q (button) collected ($0.60)
Seat 5: z3tQwy28dp5FykDJC/wzQw (small blind) folded before Flop




PokerStars Game #59941638618:  Hold'em No Limit ($0.10/$0.25) - 2009/07/01 1:41:30 ET
Table 'VQNfcI8vTBCTvRfd3veTLQ' 6-max Seat #6 is the button
Seat 2: 79ID/ub1Pt/mDpCprVmOoA ($32 in chips) 
Seat 3: LtASJ9OlkqGrrUKGQlpGAw ($12.10 in chips) 
Seat 4: QIWnfLSqfMcoFfdDe5LZPg ($41.05 in chips) 
Seat 5: gX2vbKwS/8zZPENAWB7hxQ ($20.40 in chips) 
Seat 6: LJI7A1YgDM7hgh7o56+ReQ ($27.35 in chips) 
QiL+lEgEWwy21jk/ltaRLg will be allowed to play after the button
79ID/ub1Pt/mDpCprVmOoA: posts small blind $0.10
LtASJ9OlkqGrrUKGQlpGAw: posts big blind $0.25
*** HOLE CARDS ***
QIWnfLSqfMcoFfdDe5LZPg: folds 
gX2vbKwS/8zZPENAWB7hxQ: calls $0.25
LJI7A1YgDM7hgh7o56+ReQ: folds 
79ID/ub1Pt/mDpCprVmOoA: folds 
LtASJ9OlkqGrrUKGQlpGAw: checks 
*** FLOP *** [Qh 6c 5s]
LtASJ9OlkqGrrUKGQlpGAw: checks 
gX2vbKwS/8zZPENAWB7hxQ: checks 
*** TURN *** [Qh 6c 5s] [7d]
LtASJ9OlkqGrrUKGQlpGAw: checks 
gX2vbKwS/8zZPENAWB7hxQ: bets $0.50
LtASJ9OlkqGrrUKGQlpGAw: folds 
Uncalled bet ($0.50) returned to gX2vbKwS/8zZPENAWB7hxQ
gX2vbKwS/8zZPENAWB7hxQ collected $0.60 from pot
*** SUMMARY ***
Total pot $0.60 | Rake $0 
Board [Qh 6c 5s 7d]
Seat 2: 79ID/ub1Pt/mDpCprVmOoA (small blind) folded before Flop
Seat 3: LtASJ9OlkqGrrUKGQlpGAw (big blind) folded on the Turn
Seat 4: QIWnfLSqfMcoFfdDe5LZPg folded before Flop (didn't bet)
Seat 5: gX2vbKwS/8zZPENAWB7hxQ collected ($0.60)
Seat 6: LJI7A1YgDM7hgh7o56+ReQ (button) folded before Flop (didn't bet)




PokerStars Game #59941638382:  Hold'em No Limit ($0.10/$0.25) - 2009/07/01 1:41:30 ET
Table 'GrYi0DZOHD1EvB+qiLExNw' 9-max Seat #9 is the button
Seat 1: sk7OEPqYdQE7GJKyQHkssg ($13.50 in chips) 
Seat 2: Th3FldXKQW6hWVVPahaoOQ ($47.05 in chips) 
Seat 3: 4oA316mXLIui1QY63GXBUg ($25 in chips) 
Seat 4: 8x95tVlB4uFBVHp71KihMA ($24.70 in chips) 
Seat 5: cZ99hugmLBj9KhTlc8nCSw ($25.30 in chips) 
Seat 6: arxNSjreDRGFg13EAM2F1w ($25.25 in chips) 
Seat 7: 9lvO/qyU+xrU95Teu1fv0g ($19.35 in chips) 
Seat 8: MtVtHDqIJTyUcXkRBBDIVA ($25 in chips) 
Seat 9: 5hAPbqNrvJb8PtLiceXtlg ($13.40 in chips) 
sk7OEPqYdQE7GJKyQHkssg: posts small blind $0.10
Th3FldXKQW6hWVVPahaoOQ: posts big blind $0.25
*** HOLE CARDS ***
4oA316mXLIui1QY63GXBUg: folds 
8x95tVlB4uFBVHp71KihMA: raises $0.25 to $0.50
cZ99hugmLBj9KhTlc8nCSw: folds 
arxNSjreDRGFg13EAM2F1w: folds 
9lvO/qyU+xrU95Teu1fv0g: folds 
MtVtHDqIJTyUcXkRBBDIVA: calls $0.50
5hAPbqNrvJb8PtLiceXtlg: folds 
sk7OEPqYdQE7GJKyQHkssg: calls $0.40
Th3FldXKQW6hWVVPahaoOQ: folds 
*** FLOP *** [Qs 7c Jh]
sk7OEPqYdQE7GJKyQHkssg: checks 
8x95tVlB4uFBVHp71KihMA: bets $1.20
MtVtHDqIJTyUcXkRBBDIVA: folds 
sk7OEPqYdQE7GJKyQHkssg: folds 
Uncalled bet ($1.20) returned to 8x95tVlB4uFBVHp71KihMA
8x95tVlB4uFBVHp71KihMA collected $1.70 from pot
*** SUMMARY ***
Total pot $1.75 | Rake $0.05 
Board [Qs 7c Jh]
Seat 1: sk7OEPqYdQE7GJKyQHkssg (small blind) folded on the Flop
Seat 2: Th3FldXKQW6hWVVPahaoOQ (big blind) folded before Flop
Seat 3: 4oA316mXLIui1QY63GXBUg folded before Flop (didn't bet)
Seat 4: 8x95tVlB4uFBVHp71KihMA collected ($1.70)
Seat 5: cZ99hugmLBj9KhTlc8nCSw folded before Flop (didn't bet)
Seat 6: arxNSjreDRGFg13EAM2F1w folded before Flop (didn't bet)
Seat 7: 9lvO/qyU+xrU95Teu1fv0g folded before Flop (didn't bet)
Seat 8: MtVtHDqIJTyUcXkRBBDIVA folded on the Flop
Seat 9: 5hAPbqNrvJb8PtLiceXtlg (button) folded before Flop (didn't bet)




PokerStars Game #59941639368:  Hold'em No Limit ($0.10/$0.25) - 2009/07/01 1:41:31 ET
Table 'IfRHUn9gQQA9I/Z4tn+BoA' 9-max Seat #9 is the button
Seat 2: VWUWpMLMj/Q1jRVpF7Aohw ($17.20 in chips) 
Seat 3: ModuIAhh03puxW6XFxQ3Nw ($18.15 in chips) 
Seat 4: QEbIGci+itdw+re8RM5fZA ($30.65 in chips) 
Seat 5: DdPXdieucQ+n99u1n3A+rQ ($5 in chips) 
Seat 6: UOjoGGQ58/uDS7V0xkjOrQ ($18.45 in chips) 
Seat 7: YzqSxP03XxZPbgPifgt69g ($28.15 in chips) 
Seat 8: cZ99hugmLBj9KhTlc8nCSw ($27.75 in chips) 
Seat 9: 7cv+9Zc9HIQHNvYsMfV3uA ($47.75 in chips) 
imHPFFqvfHGzsBBWeGuy4w will be allowed to play after the button
VWUWpMLMj/Q1jRVpF7Aohw: posts small blind $0.10
ModuIAhh03puxW6XFxQ3Nw: posts big blind $0.25
*** HOLE CARDS ***
QEbIGci+itdw+re8RM5fZA: folds 
DdPXdieucQ+n99u1n3A+rQ: folds 
UOjoGGQ58/uDS7V0xkjOrQ: calls $0.25
YzqSxP03XxZPbgPifgt69g: calls $0.25
cZ99hugmLBj9KhTlc8nCSw: folds 
7cv+9Zc9HIQHNvYsMfV3uA: folds 
VWUWpMLMj/Q1jRVpF7Aohw: calls $0.15
ModuIAhh03puxW6XFxQ3Nw: checks 
*** FLOP *** [Kd 2d 4d]
VWUWpMLMj/Q1jRVpF7Aohw: checks 
ModuIAhh03puxW6XFxQ3Nw: checks 
UOjoGGQ58/uDS7V0xkjOrQ: checks 
YzqSxP03XxZPbgPifgt69g: bets $0.25
VWUWpMLMj/Q1jRVpF7Aohw: folds 
ModuIAhh03puxW6XFxQ3Nw: folds 
UOjoGGQ58/uDS7V0xkjOrQ: calls $0.25
*** TURN *** [Kd 2d 4d] [6h]
UOjoGGQ58/uDS7V0xkjOrQ: checks 
YzqSxP03XxZPbgPifgt69g: bets $0.50
UOjoGGQ58/uDS7V0xkjOrQ: folds 
Uncalled bet ($0.50) returned to YzqSxP03XxZPbgPifgt69g
YzqSxP03XxZPbgPifgt69g collected $1.45 from pot
*** SUMMARY ***
Total pot $1.50 | Rake $0.05 
Board [Kd 2d 4d 6h]
Seat 2: VWUWpMLMj/Q1jRVpF7Aohw (small blind) folded on the Flop
Seat 3: ModuIAhh03puxW6XFxQ3Nw (big blind) folded on the Flop
Seat 4: QEbIGci+itdw+re8RM5fZA folded before Flop (didn't bet)
Seat 5: DdPXdieucQ+n99u1n3A+rQ folded before Flop (didn't bet)
Seat 6: UOjoGGQ58/uDS7V0xkjOrQ folded on the Turn
Seat 7: YzqSxP03XxZPbgPifgt69g collected ($1.45)
Seat 8: cZ99hugmLBj9KhTlc8nCSw folded before Flop (didn't bet)
Seat 9: 7cv+9Zc9HIQHNvYsMfV3uA (button) folded before Flop (didn't bet)




PokerStars Game #59941639382:  Hold'em No Limit ($0.10/$0.25) - 2009/07/01 1:41:31 ET
Table '+fuYjvJy9okLr23QyZtanA' 9-max Seat #6 is the button
Seat 1: l9hUFnOCgg4TPYga9bvxhw ($10.70 in chips) 
Seat 2: tLcDklc2rBORNfixyRfVfw ($25.10 in chips) 
Seat 3: eK8qa6EPcH2zhtbmWSvc9g ($52.65 in chips) 
Seat 4: Bb42QRQMhg5/Y0vHP8/2Xw ($30.50 in chips) 
Seat 5: bXpVeaSTPBFSPJmeXxO7nw ($4.65 in chips) 
Seat 6: wGigCmBR/9XWkPpvYos3aQ ($25.80 in chips) 
Seat 7: dfNim92Z6XK1/h5SFW5vDg ($26.65 in chips) 
Seat 9: OMhlmt2waO3z43ZSFNMmog ($29.15 in chips) 
dfNim92Z6XK1/h5SFW5vDg: posts small blind $0.10
qpG9m8I+cPw8VhB0mnGjYw: is sitting out 
OMhlmt2waO3z43ZSFNMmog: posts big blind $0.25
*** HOLE CARDS ***
qpG9m8I+cPw8VhB0mnGjYw leaves the table
l9hUFnOCgg4TPYga9bvxhw: folds 
tLcDklc2rBORNfixyRfVfw: folds 
eK8qa6EPcH2zhtbmWSvc9g: folds 
Bb42QRQMhg5/Y0vHP8/2Xw: folds 
bXpVeaSTPBFSPJmeXxO7nw: folds 
wGigCmBR/9XWkPpvYos3aQ: raises $0.65 to $0.90
KqS/lY/fNB9qUxokm9QfeA joins the table at seat #8 
dfNim92Z6XK1/h5SFW5vDg: folds 
OMhlmt2waO3z43ZSFNMmog: folds 
Uncalled bet ($0.65) returned to wGigCmBR/9XWkPpvYos3aQ
wGigCmBR/9XWkPpvYos3aQ collected $0.60 from pot
wGigCmBR/9XWkPpvYos3aQ: doesn't show hand 
*** SUMMARY ***
Total pot $0.60 | Rake $0 
Seat 1: l9hUFnOCgg4TPYga9bvxhw folded before Flop (didn't bet)
Seat 2: tLcDklc2rBORNfixyRfVfw folded before Flop (didn't bet)
Seat 3: eK8qa6EPcH2zhtbmWSvc9g folded before Flop (didn't bet)
Seat 4: Bb42QRQMhg5/Y0vHP8/2Xw folded before Flop (didn't bet)
Seat 5: bXpVeaSTPBFSPJmeXxO7nw folded before Flop (didn't bet)
Seat 6: wGigCmBR/9XWkPpvYos3aQ (button) collected ($0.60)
Seat 7: dfNim92Z6XK1/h5SFW5vDg (small blind) folded before Flop
Seat 9: OMhlmt2waO3z43ZSFNMmog (big blind) folded before Flop




PokerStars Game #59941639040:  Hold'em No Limit ($0.10/$0.25) - 2009/07/01 1:41:31 ET
Table 'zW+7jPbOLCvlPu+dUGY5WQ' 6-max Seat #5 is the button
Seat 1: eL3+wCBjFGfQ5FMdIZihwA ($25 in chips) 
Seat 2: cEMJmfAUQZmMChZe6aacKw ($8.95 in chips) 
Seat 3: 2G0C7dp4wlPpE21FHjjElQ ($32.85 in chips) 
Seat 4: i48129QFpEQQ+UN4aNtmww ($10.85 in chips) 
Seat 5: 5nwDw10uIM0XEyLhla0oGA ($40.80 in chips) 
Seat 6: qGHGf/553gQnDoklMRe3tg ($24.75 in chips) 
qGHGf/553gQnDoklMRe3tg: posts small blind $0.10
eL3+wCBjFGfQ5FMdIZihwA: posts big blind $0.25
*** HOLE CARDS ***
cEMJmfAUQZmMChZe6aacKw: folds 
2G0C7dp4wlPpE21FHjjElQ: folds 
i48129QFpEQQ+UN4aNtmww: calls $0.25
5nwDw10uIM0XEyLhla0oGA: raises $0.75 to $1
qGHGf/553gQnDoklMRe3tg: folds 
eL3+wCBjFGfQ5FMdIZihwA: raises $2 to $3
i48129QFpEQQ+UN4aNtmww: folds 
5nwDw10uIM0XEyLhla0oGA has timed out
5nwDw10uIM0XEyLhla0oGA: folds 
Uncalled bet ($2) returned to eL3+wCBjFGfQ5FMdIZihwA
5nwDw10uIM0XEyLhla0oGA is sitting out
eL3+wCBjFGfQ5FMdIZihwA collected $2.35 from pot
*** SUMMARY ***
Total pot $2.35 | Rake $0 
Seat 1: eL3+wCBjFGfQ5FMdIZihwA (big blind) collected ($2.35)
Seat 2: cEMJmfAUQZmMChZe6aacKw folded before Flop (didn't bet)
Seat 3: 2G0C7dp4wlPpE21FHjjElQ folded before Flop (didn't bet)
Seat 4: i48129QFpEQQ+UN4aNtmww folded before Flop
Seat 5: 5nwDw10uIM0XEyLhla0oGA (button) folded before Flop
Seat 6: qGHGf/553gQnDoklMRe3tg (small blind) folded before Flop




PokerStars Game #59941639082:  Hold'em No Limit ($0.10/$0.25) - 2009/07/01 1:41:31 ET
Table 'jdhJTJjFq2KTttwJcd+7nQ' 6-max Seat #6 is the button
Seat 1: LtASJ9OlkqGrrUKGQlpGAw ($27.30 in chips) 
Seat 2: Hsvkc0/G2VV78oVmWYXecw ($5 in chips) 
Seat 3: vqWjZmdQu/Hxw96/IJTWdQ ($25.35 in chips) 
Seat 4: vx7FwRcelVSsvNYAdp/z0A ($3.50 in chips) 
Seat 5: BV+K0Phf5VBHr7aZPKqbUQ ($26 in chips) 
Seat 6: yb6rnd48JuBccThV68VHAQ ($19.90 in chips) 
LtASJ9OlkqGrrUKGQlpGAw: posts small blind $0.10
Hsvkc0/G2VV78oVmWYXecw: posts big blind $0.25
*** HOLE CARDS ***
vqWjZmdQu/Hxw96/IJTWdQ: raises $0.75 to $1
vx7FwRcelVSsvNYAdp/z0A: folds 
BV+K0Phf5VBHr7aZPKqbUQ: folds 
yb6rnd48JuBccThV68VHAQ: folds 
LtASJ9OlkqGrrUKGQlpGAw: folds 
Hsvkc0/G2VV78oVmWYXecw: folds 
Uncalled bet ($0.75) returned to vqWjZmdQu/Hxw96/IJTWdQ
vqWjZmdQu/Hxw96/IJTWdQ collected $0.60 from pot
vqWjZmdQu/Hxw96/IJTWdQ: doesn't show hand 
*** SUMMARY ***
Total pot $0.60 | Rake $0 
Seat 1: LtASJ9OlkqGrrUKGQlpGAw (small blind) folded before Flop
Seat 2: Hsvkc0/G2VV78oVmWYXecw (big blind) folded before Flop
Seat 3: vqWjZmdQu/Hxw96/IJTWdQ collected ($0.60)
Seat 4: vx7FwRcelVSsvNYAdp/z0A folded before Flop (didn't bet)
Seat 5: BV+K0Phf5VBHr7aZPKqbUQ folded before Flop (didn't bet)
Seat 6: yb6rnd48JuBccThV68VHAQ (button) folded before Flop (didn't bet)




PokerStars Game #59941638920:  Hold'em No Limit ($0.10/$0.25) - 2009/07/01 1:41:31 ET
Table '2vH5RcmkT0F4XNS/EmmyMA' 6-max Seat #6 is the button
Seat 1: hOaWAImn5/MZDAWAPlYHCw ($5.55 in chips) 
Seat 2: W6Y6au0wf7gRAlqJYgOezw ($13.10 in chips) 
Seat 3: t8P79jKZYh/Wpx2V73pSqg ($30.25 in chips) 
Seat 4: FC6tJ9EOiutXO8hnpR4VgQ ($5.75 in chips) 
Seat 5: Hsvkc0/G2VV78oVmWYXecw ($5 in chips) 
Seat 6: if4dh6jhJXeN3/qd3qCp9g ($25 in chips) 
hOaWAImn5/MZDAWAPlYHCw: posts small blind $0.10
W6Y6au0wf7gRAlqJYgOezw: posts big blind $0.25
*** HOLE CARDS ***
t8P79jKZYh/Wpx2V73pSqg: folds 
FC6tJ9EOiutXO8hnpR4VgQ: raises $0.50 to $0.75
Hsvkc0/G2VV78oVmWYXecw: folds 
if4dh6jhJXeN3/qd3qCp9g: folds 
hOaWAImn5/MZDAWAPlYHCw: calls $0.65
W6Y6au0wf7gRAlqJYgOezw: folds 
*** FLOP *** [9c 6s 7s]
hOaWAImn5/MZDAWAPlYHCw: bets $0.75
FC6tJ9EOiutXO8hnpR4VgQ: folds 
Uncalled bet ($0.75) returned to hOaWAImn5/MZDAWAPlYHCw
hOaWAImn5/MZDAWAPlYHCw collected $1.70 from pot
*** SUMMARY ***
Total pot $1.75 | Rake $0.05 
Board [9c 6s 7s]
Seat 1: hOaWAImn5/MZDAWAPlYHCw (small blind) collected ($1.70)
Seat 2: W6Y6au0wf7gRAlqJYgOezw (big blind) folded before Flop
Seat 3: t8P79jKZYh/Wpx2V73pSqg folded before Flop (didn't bet)
Seat 4: FC6tJ9EOiutXO8hnpR4VgQ folded on the Flop
Seat 5: Hsvkc0/G2VV78oVmWYXecw folded before Flop (didn't bet)
Seat 6: if4dh6jhJXeN3/qd3qCp9g (button) folded before Flop (didn't bet)




PokerStars Game #59941639556:  Hold'em No Limit ($0.10/$0.25) - 2009/07/01 1:41:32 ET
Table '2AUmC2Rslg+QUbLfdgNdfg' 6-max Seat #6 is the button
Seat 1: YDXAegrCnzc0l6TSDNboXQ ($24.10 in chips) 
Seat 2: PLksyNlTVRVZwxJVC2/1eA ($23.85 in chips) 
Seat 3: JFIAqU8lCZ0vWwEl4bdGsg ($25.70 in chips) 
Seat 4: lquriepNQBhDV5P1SWHhnA ($26.60 in chips) 
Seat 5: AMc4cCwUJhokdGRYIaVPhQ ($22.25 in chips) 
Seat 6: xBWc54v+UTSJOiKpbAbJWg ($11.85 in chips) 
YDXAegrCnzc0l6TSDNboXQ: posts small blind $0.10
PLksyNlTVRVZwxJVC2/1eA: posts big blind $0.25
*** HOLE CARDS ***
JFIAqU8lCZ0vWwEl4bdGsg: folds 
lquriepNQBhDV5P1SWHhnA: folds 
AMc4cCwUJhokdGRYIaVPhQ: raises $0.25 to $0.50
xBWc54v+UTSJOiKpbAbJWg: folds 
YDXAegrCnzc0l6TSDNboXQ: folds 
PLksyNlTVRVZwxJVC2/1eA: folds 
Uncalled bet ($0.25) returned to AMc4cCwUJhokdGRYIaVPhQ
AMc4cCwUJhokdGRYIaVPhQ collected $0.60 from pot
*** SUMMARY ***
Total pot $0.60 | Rake $0 
Seat 1: YDXAegrCnzc0l6TSDNboXQ (small blind) folded before Flop
Seat 2: PLksyNlTVRVZwxJVC2/1eA (big blind) folded before Flop
Seat 3: JFIAqU8lCZ0vWwEl4bdGsg folded before Flop (didn't bet)
Seat 4: lquriepNQBhDV5P1SWHhnA folded before Flop (didn't bet)
Seat 5: AMc4cCwUJhokdGRYIaVPhQ collected ($0.60)
Seat 6: xBWc54v+UTSJOiKpbAbJWg (button) folded before Flop (didn't bet)




PokerStars Game #59941639664:  Hold'em No Limit ($0.10/$0.25) - 2009/07/01 1:41:32 ET
Table 'ykyWGjhNu7AvZXov27T4ew' 9-max Seat #9 is the button
Seat 2: MG90wfSJZnOejs/KD3vlQQ ($39.85 in chips) 
Seat 3: NPI9ArW8kwrb6a2IAL6xMQ ($26.45 in chips) 
Seat 4: W6tExOcYX7qiy6Qdp+ZwFA ($4.90 in chips) 
Seat 5: CmngQmkKTp8tkl6GMRTl6w ($8.50 in chips) 
Seat 6: AiXn/9o1EwOPZUHujnh/bA ($20.40 in chips) 
Seat 7: npAYqa85pqnzfOK5ukX+BQ ($21.90 in chips) 
Seat 8: tYsOBqdU1+x+yFI7zHO7hQ ($49.35 in chips) 
Seat 9: wk9M6R3w+aDHpr8WV87RmQ ($11.25 in chips) 
MG90wfSJZnOejs/KD3vlQQ: posts small blind $0.10
NPI9ArW8kwrb6a2IAL6xMQ: posts big blind $0.25
*** HOLE CARDS ***
Team Rsf joins the table at seat #1 
W6tExOcYX7qiy6Qdp+ZwFA: calls $0.25
CmngQmkKTp8tkl6GMRTl6w: folds 
AiXn/9o1EwOPZUHujnh/bA: folds 
npAYqa85pqnzfOK5ukX+BQ: folds 
tYsOBqdU1+x+yFI7zHO7hQ: folds 
wk9M6R3w+aDHpr8WV87RmQ: folds 
MG90wfSJZnOejs/KD3vlQQ: calls $0.15
NPI9ArW8kwrb6a2IAL6xMQ: checks 
*** FLOP *** [8h Ac 3h]
MG90wfSJZnOejs/KD3vlQQ: checks 
NPI9ArW8kwrb6a2IAL6xMQ: checks 
W6tExOcYX7qiy6Qdp+ZwFA: bets $0.75
MG90wfSJZnOejs/KD3vlQQ: folds 
NPI9ArW8kwrb6a2IAL6xMQ: calls $0.75
*** TURN *** [8h Ac 3h] [Qs]
NPI9ArW8kwrb6a2IAL6xMQ: checks 
W6tExOcYX7qiy6Qdp+ZwFA: bets $2
NPI9ArW8kwrb6a2IAL6xMQ: folds 
Uncalled bet ($2) returned to W6tExOcYX7qiy6Qdp+ZwFA
W6tExOcYX7qiy6Qdp+ZwFA collected $2.15 from pot
W6tExOcYX7qiy6Qdp+ZwFA: doesn't show hand 
*** SUMMARY ***
Total pot $2.25 | Rake $0.10 
Board [8h Ac 3h Qs]
Seat 2: MG90wfSJZnOejs/KD3vlQQ (small blind) folded on the Flop
Seat 3: NPI9ArW8kwrb6a2IAL6xMQ (big blind) folded on the Turn
Seat 4: W6tExOcYX7qiy6Qdp+ZwFA collected ($2.15)
Seat 5: CmngQmkKTp8tkl6GMRTl6w folded before Flop (didn't bet)
Seat 6: AiXn/9o1EwOPZUHujnh/bA folded before Flop (didn't bet)
Seat 7: npAYqa85pqnzfOK5ukX+BQ folded before Flop (didn't bet)
Seat 8: tYsOBqdU1+x+yFI7zHO7hQ folded before Flop (didn't bet)
Seat 9: wk9M6R3w+aDHpr8WV87RmQ (button) folded before Flop (didn't bet)




PokerStars Game #59941640180:  Hold'em No Limit ($0.10/$0.25) - 2009/07/01 1:41:33 ET
Table 'YYMg5qzxK1m9eGRo4SbxtQ' 9-max Seat #9 is the button
Seat 2: f/H6PsHRl4W1JyNsEDvPtg ($8.70 in chips) 
Seat 3: cFmpjvcjNoVAEAIQIxWkYg ($25 in chips) 
Seat 8: xoBFd/5k+L/pFn9VW1VyWg ($13 in chips) 
Seat 9: +sbyWwIcFp9kP0bDtMegfQ ($31.75 in chips) 
f/H6PsHRl4W1JyNsEDvPtg: posts small blind $0.10
cFmpjvcjNoVAEAIQIxWkYg: posts big blind $0.25
*** HOLE CARDS ***
xoBFd/5k+L/pFn9VW1VyWg: raises $0.75 to $1
+sbyWwIcFp9kP0bDtMegfQ: folds 
willthejoker joins the table at seat #4 
f/H6PsHRl4W1JyNsEDvPtg: folds 
cFmpjvcjNoVAEAIQIxWkYg: folds 
Uncalled bet ($0.75) returned to xoBFd/5k+L/pFn9VW1VyWg
xoBFd/5k+L/pFn9VW1VyWg collected $0.60 from pot
kc213 joins the table at seat #1 
*** SUMMARY ***
Total pot $0.60 | Rake $0 
Seat 2: f/H6PsHRl4W1JyNsEDvPtg (small blind) folded before Flop
Seat 3: cFmpjvcjNoVAEAIQIxWkYg (big blind) folded before Flop
Seat 8: xoBFd/5k+L/pFn9VW1VyWg collected ($0.60)
Seat 9: +sbyWwIcFp9kP0bDtMegfQ (button) folded before Flop (didn't bet)




PokerStars Game #59941640386:  Hold'em No Limit ($0.10/$0.25) - 2009/07/01 1:41:33 ET
Table 'BabJGL6tfXQp3leBGbYe8A' 9-max Seat #7 is the button
Seat 1: qwr38jl5txoR36M7G5qi4A ($8 in chips) 
Seat 2: dtZ84flFEi4Q+SGrHMJRDQ ($36 in chips) 
Seat 3: sD+TKtt36XiiN6jqHiLwDA ($25.20 in chips) 
Seat 4: gehe91e0IyVT0QU/XBkEyg ($28.45 in chips) 
Seat 5: GrNTWMdwy+jC6Lred1eDng ($15 in chips) 
Seat 6: egvg3mTBBVzMHnJPIQiKcA ($14.15 in chips) 
Seat 7: eK8qa6EPcH2zhtbmWSvc9g ($27.50 in chips) 
Seat 8: OgISYvc5hA85YuDnsXCH+Q ($22 in chips) 
Seat 9: P+9ymZQ3ktpQu1bn7HIjew ($10 in chips) 
OgISYvc5hA85YuDnsXCH+Q: posts small blind $0.10
P+9ymZQ3ktpQu1bn7HIjew: posts big blind $0.25
*** HOLE CARDS ***
qwr38jl5txoR36M7G5qi4A: folds 
dtZ84flFEi4Q+SGrHMJRDQ: folds 
sD+TKtt36XiiN6jqHiLwDA: folds 
gehe91e0IyVT0QU/XBkEyg: folds 
GrNTWMdwy+jC6Lred1eDng: folds 
egvg3mTBBVzMHnJPIQiKcA: folds 
eK8qa6EPcH2zhtbmWSvc9g: raises $0.50 to $0.75
OgISYvc5hA85YuDnsXCH+Q: folds 
P+9ymZQ3ktpQu1bn7HIjew: folds 
Uncalled bet ($0.50) returned to eK8qa6EPcH2zhtbmWSvc9g
eK8qa6EPcH2zhtbmWSvc9g collected $0.60 from pot
eK8qa6EPcH2zhtbmWSvc9g: doesn't show hand 
*** SUMMARY ***
Total pot $0.60 | Rake $0 
Seat 1: qwr38jl5txoR36M7G5qi4A folded before Flop (didn't bet)
Seat 2: dtZ84flFEi4Q+SGrHMJRDQ folded before Flop (didn't bet)
Seat 3: sD+TKtt36XiiN6jqHiLwDA folded before Flop (didn't bet)
Seat 4: gehe91e0IyVT0QU/XBkEyg folded before Flop (didn't bet)
Seat 5: GrNTWMdwy+jC6Lred1eDng folded before Flop (didn't bet)
Seat 6: egvg3mTBBVzMHnJPIQiKcA folded before Flop (didn't bet)
Seat 7: eK8qa6EPcH2zhtbmWSvc9g (button) collected ($0.60)
Seat 8: OgISYvc5hA85YuDnsXCH+Q (small blind) folded before Flop
Seat 9: P+9ymZQ3ktpQu1bn7HIjew (big blind) folded before Flop




PokerStars Game #59941640366:  Hold'em No Limit ($0.10/$0.25) - 2009/07/01 1:41:33 ET
Table '8Z6T3ssCpo3VV849U4RgBw' 9-max Seat #7 is the button
Seat 1: 8dNQBtNvCvzVgSnmDgi/LA ($16.05 in chips) 
Seat 2: SpiiQQAzy4MUgV3I5W8giw ($25.35 in chips) 
Seat 3: tLcDklc2rBORNfixyRfVfw ($41.50 in chips) 
Seat 4: RCqMONFrSPSArZh2Jsar/w ($18.90 in chips) 
Seat 5: zDrucyjVn5aeekNEc3cJrA ($16 in chips) 
Seat 6: sGFnnRCa1YAHAUmWgsW6Qg ($9.15 in chips) 
Seat 7: oLa/tXLfSLLB28mcLGrxcg ($24.05 in chips) 
Seat 8: PdIasPkzm2sqZnN41ZRXOg ($5.35 in chips) 
Seat 9: HDDm1BkZtdsRyw2DJdqq6A ($21.45 in chips) 
PdIasPkzm2sqZnN41ZRXOg: posts small blind $0.10
HDDm1BkZtdsRyw2DJdqq6A: posts big blind $0.25
*** HOLE CARDS ***
8dNQBtNvCvzVgSnmDgi/LA: folds 
SpiiQQAzy4MUgV3I5W8giw: folds 
tLcDklc2rBORNfixyRfVfw: folds 
8dNQBtNvCvzVgSnmDgi/LA leaves the table
RCqMONFrSPSArZh2Jsar/w: folds 
DigiSlarks joins the table at seat #1 
zDrucyjVn5aeekNEc3cJrA: folds 
zDrucyjVn5aeekNEc3cJrA is sitting out
sGFnnRCa1YAHAUmWgsW6Qg: folds 
oLa/tXLfSLLB28mcLGrxcg: folds 
PdIasPkzm2sqZnN41ZRXOg: folds 
Uncalled bet ($0.15) returned to HDDm1BkZtdsRyw2DJdqq6A
HDDm1BkZtdsRyw2DJdqq6A collected $0.20 from pot
HDDm1BkZtdsRyw2DJdqq6A: shows [Ks Ad] (high card Ace)
*** SUMMARY ***
Total pot $0.20 | Rake $0 
Seat 1: 8dNQBtNvCvzVgSnmDgi/LA folded before Flop (didn't bet)
Seat 2: SpiiQQAzy4MUgV3I5W8giw folded before Flop (didn't bet)
Seat 3: tLcDklc2rBORNfixyRfVfw folded before Flop (didn't bet)
Seat 4: RCqMONFrSPSArZh2Jsar/w folded before Flop (didn't bet)
Seat 5: zDrucyjVn5aeekNEc3cJrA folded before Flop (didn't bet)
Seat 6: sGFnnRCa1YAHAUmWgsW6Qg folded before Flop (didn't bet)
Seat 7: oLa/tXLfSLLB28mcLGrxcg (button) folded before Flop (didn't bet)
Seat 8: PdIasPkzm2sqZnN41ZRXOg (small blind) folded before Flop
Seat 9: HDDm1BkZtdsRyw2DJdqq6A (big blind) collected ($0.20)




PokerStars Game #59941640318:  Hold'em No Limit ($0.10/$0.25) - 2009/07/01 1:41:33 ET
Table 'T/iCKJXGphRN3xcdwfE/JQ' 6-max Seat #4 is the button
Seat 1: wAKC8C/zN0c8V5v13dm9mA ($25 in chips) 
Seat 2: EeUZtMU058v2ObUACOF4Og ($33.75 in chips) 
Seat 3: IWAjoCPXtc1XUaZdp+pCpA ($21.75 in chips) 
Seat 4: tSR4329m40dZsN7YOpI9Kw ($53.85 in chips) 
Seat 5: gaPMxLGp9SOj4Lq6t+/0Ig ($4.30 in chips) 
Seat 6: Ey4Kn6PlnYb2srYYBJHvzg ($16.45 in chips) 
gaPMxLGp9SOj4Lq6t+/0Ig: posts small blind $0.10
Ey4Kn6PlnYb2srYYBJHvzg: posts big blind $0.25
*** HOLE CARDS ***
wAKC8C/zN0c8V5v13dm9mA: folds 
EeUZtMU058v2ObUACOF4Og: folds 
IWAjoCPXtc1XUaZdp+pCpA: folds 
tSR4329m40dZsN7YOpI9Kw: raises $0.50 to $0.75
gaPMxLGp9SOj4Lq6t+/0Ig: folds 
Ey4Kn6PlnYb2srYYBJHvzg: folds 
Uncalled bet ($0.50) returned to tSR4329m40dZsN7YOpI9Kw
tSR4329m40dZsN7YOpI9Kw collected $0.60 from pot
*** SUMMARY ***
Total pot $0.60 | Rake $0 
Seat 1: wAKC8C/zN0c8V5v13dm9mA folded before Flop (didn't bet)
Seat 2: EeUZtMU058v2ObUACOF4Og folded before Flop (didn't bet)
Seat 3: IWAjoCPXtc1XUaZdp+pCpA folded before Flop (didn't bet)
Seat 4: tSR4329m40dZsN7YOpI9Kw (button) collected ($0.60)
Seat 5: gaPMxLGp9SOj4Lq6t+/0Ig (small blind) folded before Flop
Seat 6: Ey4Kn6PlnYb2srYYBJHvzg (big blind) folded before Flop




PokerStars Game #59941640442:  Hold'em No Limit ($0.10/$0.25) - 2009/07/01 1:41:33 ET
Table '6wawJ+MkkvuC3coG6r+Yhg' 6-max Seat #6 is the button
Seat 1: JQZew0FjzS19kTjeNtrE+A ($28 in chips) 
Seat 2: LtASJ9OlkqGrrUKGQlpGAw ($33.60 in chips) 
Seat 3: 3zD3qLXT1bEffAoWGnc7wg ($59.85 in chips) 
Seat 4: yxmjNFGiKI3b+XQGJzJVIg ($28.30 in chips) 
Seat 5: FZrgDbxAanC1xwZxXHJKVA ($2.85 in chips) 
Seat 6: B3X187C0tXFUfQpCu8pe8A ($27.10 in chips) 
JQZew0FjzS19kTjeNtrE+A: posts small blind $0.10
LtASJ9OlkqGrrUKGQlpGAw: posts big blind $0.25
*** HOLE CARDS ***
3zD3qLXT1bEffAoWGnc7wg: folds 
yxmjNFGiKI3b+XQGJzJVIg: folds 
FZrgDbxAanC1xwZxXHJKVA: folds 
B3X187C0tXFUfQpCu8pe8A: folds 
JQZew0FjzS19kTjeNtrE+A: folds 
Uncalled bet ($0.15) returned to LtASJ9OlkqGrrUKGQlpGAw
LtASJ9OlkqGrrUKGQlpGAw collected $0.20 from pot
LtASJ9OlkqGrrUKGQlpGAw: doesn't show hand 
*** SUMMARY ***
Total pot $0.20 | Rake $0 
Seat 1: JQZew0FjzS19kTjeNtrE+A (small blind) folded before Flop
Seat 2: LtASJ9OlkqGrrUKGQlpGAw (big blind) collected ($0.20)
Seat 3: 3zD3qLXT1bEffAoWGnc7wg folded before Flop (didn't bet)
Seat 4: yxmjNFGiKI3b+XQGJzJVIg folded before Flop (didn't bet)
Seat 5: FZrgDbxAanC1xwZxXHJKVA folded before Flop (didn't bet)
Seat 6: B3X187C0tXFUfQpCu8pe8A (button) folded before Flop (didn't bet)




PokerStars Game #59941640046:  Hold'em No Limit ($0.10/$0.25) - 2009/07/01 1:41:33 ET
Table 'Zi9/NqNs3XoL1eWhMCyZyg' 9-max Seat #8 is the button
Seat 3: ETC7YyRJTa2Ovhln64Ni5Q ($25 in chips) 
Seat 4: dmYlc+1cjwZMJ7wV+Z0rRg ($23.15 in chips) 
Seat 5: OiV1PWZ3IkN29JlmCcnTwQ ($4.90 in chips) 
Seat 7: 0QdZrkFD7aGKeBXPGbIomA ($6.60 in chips) 
Seat 8: nm4Dj/f+jJEwKVsUnKh73g ($37.80 in chips) 
Seat 9: tYsOBqdU1+x+yFI7zHO7hQ ($31.40 in chips) 
tYsOBqdU1+x+yFI7zHO7hQ: posts small blind $0.10
ETC7YyRJTa2Ovhln64Ni5Q: posts big blind $0.25
*** HOLE CARDS ***
dmYlc+1cjwZMJ7wV+Z0rRg: folds 
OiV1PWZ3IkN29JlmCcnTwQ: folds 
0QdZrkFD7aGKeBXPGbIomA: folds 
nm4Dj/f+jJEwKVsUnKh73g: folds 
tYsOBqdU1+x+yFI7zHO7hQ: raises $0.50 to $0.75
ETC7YyRJTa2Ovhln64Ni5Q: folds 
Uncalled bet ($0.50) returned to tYsOBqdU1+x+yFI7zHO7hQ
tYsOBqdU1+x+yFI7zHO7hQ collected $0.50 from pot
tYsOBqdU1+x+yFI7zHO7hQ: doesn't show hand 
*** SUMMARY ***
Total pot $0.50 | Rake $0 
Seat 3: ETC7YyRJTa2Ovhln64Ni5Q (big blind) folded before Flop
Seat 4: dmYlc+1cjwZMJ7wV+Z0rRg folded before Flop (didn't bet)
Seat 5: OiV1PWZ3IkN29JlmCcnTwQ folded before Flop (didn't bet)
Seat 7: 0QdZrkFD7aGKeBXPGbIomA folded before Flop (didn't bet)
Seat 8: nm4Dj/f+jJEwKVsUnKh73g (button) folded before Flop (didn't bet)
Seat 9: tYsOBqdU1+x+yFI7zHO7hQ (small blind) collected ($0.50)




PokerStars Game #59941640138:  Hold'em No Limit ($0.10/$0.25) - 2009/07/01 1:41:33 ET
Table 'NfXsh0UQA+o/kO9acV3WxA' 9-max Seat #8 is the button
Seat 1: pN3IHvAKm2fz+sTRARTcrg ($25 in chips) 
Seat 3: wCUaomJ6Nq5zomVGdUHP+w ($19.85 in chips) 
Seat 4: r6hsffOo1iKmaPYKwAZmFw ($30.05 in chips) 
Seat 6: cFmpjvcjNoVAEAIQIxWkYg ($25 in chips) 
Seat 7: yqkowiRWZ6NvRN9UUkYIlA ($5 in chips) 
Seat 8: +sbyWwIcFp9kP0bDtMegfQ ($41.75 in chips) 
Seat 9: uhrboV251dcgYniYTdFIcA ($25 in chips) 
uhrboV251dcgYniYTdFIcA: posts small blind $0.10
pN3IHvAKm2fz+sTRARTcrg: posts big blind $0.25
SchoolATC: sits out 
zgi+EUykT/pZQpoUG6+oEg: sits out 
*** HOLE CARDS ***
wCUaomJ6Nq5zomVGdUHP+w: folds 
r6hsffOo1iKmaPYKwAZmFw: folds 
cFmpjvcjNoVAEAIQIxWkYg: raises $0.50 to $0.75
yqkowiRWZ6NvRN9UUkYIlA: folds 
+sbyWwIcFp9kP0bDtMegfQ: folds 
uhrboV251dcgYniYTdFIcA: folds 
pN3IHvAKm2fz+sTRARTcrg: folds 
Uncalled bet ($0.50) returned to cFmpjvcjNoVAEAIQIxWkYg
cFmpjvcjNoVAEAIQIxWkYg collected $0.60 from pot
cFmpjvcjNoVAEAIQIxWkYg: doesn't show hand 
*** SUMMARY ***
Total pot $0.60 | Rake $0 
Seat 1: pN3IHvAKm2fz+sTRARTcrg (big blind) folded before Flop
Seat 3: wCUaomJ6Nq5zomVGdUHP+w folded before Flop (didn't bet)
Seat 4: r6hsffOo1iKmaPYKwAZmFw folded before Flop (didn't bet)
Seat 6: cFmpjvcjNoVAEAIQIxWkYg collected ($0.60)
Seat 7: yqkowiRWZ6NvRN9UUkYIlA folded before Flop (didn't bet)
Seat 8: +sbyWwIcFp9kP0bDtMegfQ (button) folded before Flop (didn't bet)
Seat 9: uhrboV251dcgYniYTdFIcA (small blind) folded before Flop




PokerStars Game #59941640158:  Hold'em No Limit ($0.10/$0.25) - 2009/07/01 1:41:33 ET
Table 'S6s+TmTlAjLHclBRvN5/fw' 9-max Seat #5 is the button
Seat 5: z5GxcHlYz/GSz6W2uFiTtg ($39.80 in chips) 
Seat 6: aNpwfA31EREwO+ar4XzBCw ($28.40 in chips) 
Seat 8: OlPJsgR4xypSg/w1z7Gyvw ($22.65 in chips) 
aNpwfA31EREwO+ar4XzBCw: posts small blind $0.10
vSkQm2EelzwRGDDQQk0Fqw: is sitting out 
OlPJsgR4xypSg/w1z7Gyvw: posts big blind $0.25
*** HOLE CARDS ***
vSkQm2EelzwRGDDQQk0Fqw leaves the table
z5GxcHlYz/GSz6W2uFiTtg: calls $0.25
aNpwfA31EREwO+ar4XzBCw: folds 
z2SmIaQ3+5n/eY1BN5HgPg joins the table at seat #3 
hO0e1+SO2lX0hqBn3Z/9KQ joins the table at seat #4 
OlPJsgR4xypSg/w1z7Gyvw: raises $1 to $1.25
z5GxcHlYz/GSz6W2uFiTtg: folds 
Uncalled bet ($1) returned to OlPJsgR4xypSg/w1z7Gyvw
OlPJsgR4xypSg/w1z7Gyvw collected $0.60 from pot
OlPJsgR4xypSg/w1z7Gyvw: doesn't show hand 
*** SUMMARY ***
Total pot $0.60 | Rake $0 
Seat 5: z5GxcHlYz/GSz6W2uFiTtg (button) folded before Flop
Seat 6: aNpwfA31EREwO+ar4XzBCw (small blind) folded before Flop
Seat 8: OlPJsgR4xypSg/w1z7Gyvw (big blind) collected ($0.60)




PokerStars Game #59941640872:  Hold'em No Limit ($0.10/$0.25) - 2009/07/01 1:41:34 ET
Table 'KU/HrxqxwDz8HKEhYTZ6uw' 6-max Seat #1 is the button
Seat 1: 7LKoiQHXpTQXJvWQrw907g ($29.65 in chips) 
Seat 2: kG34n23qFQA3nzdOJTQ1dA ($21.85 in chips) 
Seat 3: SFmT9ZsVopnukjvAzrxTRg ($25.80 in chips) 
Seat 4: AGwMM0FUhYZf81+oXvYQMg ($24.90 in chips) 
Seat 5: iyZxqznXjv3vtvOJymkoLQ ($51.25 in chips) 
Seat 6: qWxkCeqApAWdAA0evrfDvQ ($18.30 in chips) 
kG34n23qFQA3nzdOJTQ1dA: posts small blind $0.10
SFmT9ZsVopnukjvAzrxTRg: posts big blind $0.25
*** HOLE CARDS ***
AGwMM0FUhYZf81+oXvYQMg: calls $0.25
iyZxqznXjv3vtvOJymkoLQ: folds 
qWxkCeqApAWdAA0evrfDvQ: calls $0.25
7LKoiQHXpTQXJvWQrw907g: calls $0.25
kG34n23qFQA3nzdOJTQ1dA: folds 
SFmT9ZsVopnukjvAzrxTRg: checks 
*** FLOP *** [Th Ah 9d]
SFmT9ZsVopnukjvAzrxTRg: checks 
AGwMM0FUhYZf81+oXvYQMg: checks 
qWxkCeqApAWdAA0evrfDvQ: checks 
7LKoiQHXpTQXJvWQrw907g: checks 
*** TURN *** [Th Ah 9d] [6c]
SFmT9ZsVopnukjvAzrxTRg: checks 
AGwMM0FUhYZf81+oXvYQMg: checks 
qWxkCeqApAWdAA0evrfDvQ: checks 
7LKoiQHXpTQXJvWQrw907g: bets $0.75
SFmT9ZsVopnukjvAzrxTRg: folds 
AGwMM0FUhYZf81+oXvYQMg: calls $0.75
qWxkCeqApAWdAA0evrfDvQ: folds 
*** RIVER *** [Th Ah 9d 6c] [5d]
AGwMM0FUhYZf81+oXvYQMg: bets $1.75
7LKoiQHXpTQXJvWQrw907g: folds 
Uncalled bet ($1.75) returned to AGwMM0FUhYZf81+oXvYQMg
AGwMM0FUhYZf81+oXvYQMg collected $2.50 from pot
AGwMM0FUhYZf81+oXvYQMg: doesn't show hand 
*** SUMMARY ***
Total pot $2.60 | Rake $0.10 
Board [Th Ah 9d 6c 5d]
Seat 1: 7LKoiQHXpTQXJvWQrw907g (button) folded on the River
Seat 2: kG34n23qFQA3nzdOJTQ1dA (small blind) folded before Flop
Seat 3: SFmT9ZsVopnukjvAzrxTRg (big blind) folded on the Turn
Seat 4: AGwMM0FUhYZf81+oXvYQMg collected ($2.50)
Seat 5: iyZxqznXjv3vtvOJymkoLQ folded before Flop (didn't bet)
Seat 6: qWxkCeqApAWdAA0evrfDvQ folded on the Turn




PokerStars Game #59941640592:  Hold'em No Limit ($0.10/$0.25) - 2009/07/01 1:41:34 ET
Table 'FE/j6VqBY4j9Uq+VHURQCQ' 6-max Seat #5 is the button
Seat 1: ypmjhffk/YHGc51wgVXUTw ($41.20 in chips) 
Seat 2: 3zD3qLXT1bEffAoWGnc7wg ($39.75 in chips) 
Seat 3: lBoEwOFgzcERLIRUkUoRTw ($27.70 in chips) 
Seat 4: 7JyPCA0J2grhXQYxe1h3+A ($22.65 in chips) 
Seat 5: 4x9jCqgSw4272dnaIqnanw ($7.45 in chips) 
Seat 6: rpJ2ie+vculq8yrHlngRHQ ($18.70 in chips) 
rpJ2ie+vculq8yrHlngRHQ: posts small blind $0.10
ypmjhffk/YHGc51wgVXUTw: posts big blind $0.25
*** HOLE CARDS ***
3zD3qLXT1bEffAoWGnc7wg: folds 
lBoEwOFgzcERLIRUkUoRTw: folds 
7JyPCA0J2grhXQYxe1h3+A: folds 
4x9jCqgSw4272dnaIqnanw: calls $0.25
rpJ2ie+vculq8yrHlngRHQ: folds 
ypmjhffk/YHGc51wgVXUTw: checks 
*** FLOP *** [5d 2h As]
ypmjhffk/YHGc51wgVXUTw: checks 
4x9jCqgSw4272dnaIqnanw: checks 
*** TURN *** [5d 2h As] [8s]
ypmjhffk/YHGc51wgVXUTw: bets $0.25
4x9jCqgSw4272dnaIqnanw: folds 
Uncalled bet ($0.25) returned to ypmjhffk/YHGc51wgVXUTw
ypmjhffk/YHGc51wgVXUTw collected $0.60 from pot
ypmjhffk/YHGc51wgVXUTw: doesn't show hand 
*** SUMMARY ***
Total pot $0.60 | Rake $0 
Board [5d 2h As 8s]
Seat 1: ypmjhffk/YHGc51wgVXUTw (big blind) collected ($0.60)
Seat 2: 3zD3qLXT1bEffAoWGnc7wg folded before Flop (didn't bet)
Seat 3: lBoEwOFgzcERLIRUkUoRTw folded before Flop (didn't bet)
Seat 4: 7JyPCA0J2grhXQYxe1h3+A folded before Flop (didn't bet)
Seat 5: 4x9jCqgSw4272dnaIqnanw (button) folded on the Turn
Seat 6: rpJ2ie+vculq8yrHlngRHQ (small blind) folded before Flop




PokerStars Game #59941640716:  Hold'em No Limit ($0.10/$0.25) - 2009/07/01 1:41:34 ET
Table 'vFZR6Kf2Th5xBXT9brGW6A' 6-max Seat #5 is the button
Seat 1: Q3EMN7b0ie81AFWkDrhCjw ($21.35 in chips) 
Seat 2: QiL+lEgEWwy21jk/ltaRLg ($23.40 in chips) 
Seat 3: SH1WjKVUjPiyXySjWSdazw ($24.10 in chips) 
Seat 4: 79ID/ub1Pt/mDpCprVmOoA ($35.55 in chips) 
Seat 5: SS/yfeArhULzIcOPe8MdPg ($25.65 in chips) 
Seat 6: 4x9jCqgSw4272dnaIqnanw ($3.35 in chips) 
4x9jCqgSw4272dnaIqnanw: posts small blind $0.10
Q3EMN7b0ie81AFWkDrhCjw: posts big blind $0.25
*** HOLE CARDS ***
QiL+lEgEWwy21jk/ltaRLg: folds 
SH1WjKVUjPiyXySjWSdazw: folds 
79ID/ub1Pt/mDpCprVmOoA: folds 
SS/yfeArhULzIcOPe8MdPg: raises $0.75 to $1
4x9jCqgSw4272dnaIqnanw: folds 
Q3EMN7b0ie81AFWkDrhCjw: calls $0.75
*** FLOP *** [Ac 7c As]
Q3EMN7b0ie81AFWkDrhCjw: checks 
SS/yfeArhULzIcOPe8MdPg: bets $1.25
Q3EMN7b0ie81AFWkDrhCjw: folds 
Uncalled bet ($1.25) returned to SS/yfeArhULzIcOPe8MdPg
SS/yfeArhULzIcOPe8MdPg collected $2 from pot
*** SUMMARY ***
Total pot $2.10 | Rake $0.10 
Board [Ac 7c As]
Seat 1: Q3EMN7b0ie81AFWkDrhCjw (big blind) folded on the Flop
Seat 2: QiL+lEgEWwy21jk/ltaRLg folded before Flop (didn't bet)
Seat 3: SH1WjKVUjPiyXySjWSdazw folded before Flop (didn't bet)
Seat 4: 79ID/ub1Pt/mDpCprVmOoA folded before Flop (didn't bet)
Seat 5: SS/yfeArhULzIcOPe8MdPg (button) collected ($2)
Seat 6: 4x9jCqgSw4272dnaIqnanw (small blind) folded before Flop




PokerStars Game #59941641050:  Hold'em No Limit ($0.10/$0.25) - 2009/07/01 1:41:34 ET
Table 'gnrUwXkIPE0C8xl6cB4Hyw' 9-max Seat #5 is the button
Seat 1: EQXHDnIzAsORnIXRNtXRlA ($22.60 in chips) 
Seat 2: 7je+LC5Mfs6nL8YBVh4frQ ($5 in chips) 
Seat 3: PdIasPkzm2sqZnN41ZRXOg ($5 in chips) 
Seat 4: wGigCmBR/9XWkPpvYos3aQ ($25.35 in chips) 
Seat 5: gehe91e0IyVT0QU/XBkEyg ($27.15 in chips) 
Seat 6: dtZ84flFEi4Q+SGrHMJRDQ ($25.90 in chips) 
Seat 7: OXPkK84/qv92EMwXPiG5rQ ($10.10 in chips) 
Seat 8: 4awUyiDYTgylQKXZ9faBVA ($56.55 in chips) 
Seat 9: F7pnn6czNpHvRM55XcA2EA ($28.10 in chips) 
dtZ84flFEi4Q+SGrHMJRDQ: posts small blind $0.10
OXPkK84/qv92EMwXPiG5rQ: posts big blind $0.25
*** HOLE CARDS ***
4awUyiDYTgylQKXZ9faBVA: folds 
F7pnn6czNpHvRM55XcA2EA: folds 
EQXHDnIzAsORnIXRNtXRlA: folds 
7je+LC5Mfs6nL8YBVh4frQ: folds 
PdIasPkzm2sqZnN41ZRXOg: folds 
wGigCmBR/9XWkPpvYos3aQ: folds 
gehe91e0IyVT0QU/XBkEyg: folds 
dtZ84flFEi4Q+SGrHMJRDQ: folds 
Uncalled bet ($0.15) returned to OXPkK84/qv92EMwXPiG5rQ
OXPkK84/qv92EMwXPiG5rQ collected $0.20 from pot
OXPkK84/qv92EMwXPiG5rQ: doesn't show hand 
*** SUMMARY ***
Total pot $0.20 | Rake $0 
Seat 1: EQXHDnIzAsORnIXRNtXRlA folded before Flop (didn't bet)
Seat 2: 7je+LC5Mfs6nL8YBVh4frQ folded before Flop (didn't bet)
Seat 3: PdIasPkzm2sqZnN41ZRXOg folded before Flop (didn't bet)
Seat 4: wGigCmBR/9XWkPpvYos3aQ folded before Flop (didn't bet)
Seat 5: gehe91e0IyVT0QU/XBkEyg (button) folded before Flop (didn't bet)
Seat 6: dtZ84flFEi4Q+SGrHMJRDQ (small blind) folded before Flop
Seat 7: OXPkK84/qv92EMwXPiG5rQ (big blind) collected ($0.20)
Seat 8: 4awUyiDYTgylQKXZ9faBVA folded before Flop (didn't bet)
Seat 9: F7pnn6czNpHvRM55XcA2EA folded before Flop (didn't bet)




PokerStars Game #59941640742:  Hold'em No Limit ($0.10/$0.25) - 2009/07/01 1:41:34 ET
Table '4hfTdIVT/qPsJNfWXLsVIw' 9-max Seat #9 is the button
Seat 1: GbHFBbLqLGz0Pwn6CJeAuw ($30.45 in chips) 
Seat 2: Pt637jKksB5MzP0UNJAAkw ($37.35 in chips) 
Seat 3: xnVwSkROfRtOw4eSoDANtw ($8.10 in chips) 
Seat 4: 3PmVnC/15cl4oyI1TKIt4g ($6.10 in chips) 
Seat 5: dtZ84flFEi4Q+SGrHMJRDQ ($25.45 in chips) 
Seat 6: VWUWpMLMj/Q1jRVpF7Aohw ($13.15 in chips) 
Seat 8: 7cv+9Zc9HIQHNvYsMfV3uA ($29.25 in chips) 
Seat 9: 9njEKzpOKC62MllUFUBWrA ($10.05 in chips) 
GbHFBbLqLGz0Pwn6CJeAuw: posts small blind $0.10
Pt637jKksB5MzP0UNJAAkw: posts big blind $0.25
*** HOLE CARDS ***
xnVwSkROfRtOw4eSoDANtw: calls $0.25
3PmVnC/15cl4oyI1TKIt4g: calls $0.25
dtZ84flFEi4Q+SGrHMJRDQ: folds 
VWUWpMLMj/Q1jRVpF7Aohw: calls $0.25
7cv+9Zc9HIQHNvYsMfV3uA: calls $0.25
9njEKzpOKC62MllUFUBWrA: folds 
GbHFBbLqLGz0Pwn6CJeAuw: folds 
Pt637jKksB5MzP0UNJAAkw: raises $1.50 to $1.75
xnVwSkROfRtOw4eSoDANtw: folds 
3PmVnC/15cl4oyI1TKIt4g: folds 
VWUWpMLMj/Q1jRVpF7Aohw: folds 
7cv+9Zc9HIQHNvYsMfV3uA: folds 
Uncalled bet ($1.50) returned to Pt637jKksB5MzP0UNJAAkw
Pt637jKksB5MzP0UNJAAkw collected $1.35 from pot
*** SUMMARY ***
Total pot $1.35 | Rake $0 
Seat 1: GbHFBbLqLGz0Pwn6CJeAuw (small blind) folded before Flop
Seat 2: Pt637jKksB5MzP0UNJAAkw (big blind) collected ($1.35)
Seat 3: xnVwSkROfRtOw4eSoDANtw folded before Flop
Seat 4: 3PmVnC/15cl4oyI1TKIt4g folded before Flop
Seat 5: dtZ84flFEi4Q+SGrHMJRDQ folded before Flop (didn't bet)
Seat 6: VWUWpMLMj/Q1jRVpF7Aohw folded before Flop
Seat 8: 7cv+9Zc9HIQHNvYsMfV3uA folded before Flop
Seat 9: 9njEKzpOKC62MllUFUBWrA (button) folded before Flop (didn't bet)




PokerStars Game #59941640874:  Hold'em No Limit ($0.10/$0.25) - 2009/07/01 1:41:34 ET
Table 'AUM6O+mgQAaLDZKMQ/5/gA' 9-max Seat #1 is the button
Seat 1: EIObtVVE4WXRXvLGJA6NHw ($18.05 in chips) 
Seat 2: OXPkK84/qv92EMwXPiG5rQ ($9.25 in chips) 
Seat 3: CvL9Ch1HYCVbTsfpNucitg ($3.75 in chips) 
Seat 4: 4awUyiDYTgylQKXZ9faBVA ($28.05 in chips) 
Seat 5: +2kMBNpY4nF1qNCRd8SJLA ($25.65 in chips) 
Seat 6: v5jnQ1gfh9nLla3kMXG7Yg ($7.70 in chips) 
Seat 7: Bb42QRQMhg5/Y0vHP8/2Xw ($30.60 in chips) 
Seat 9: eK8qa6EPcH2zhtbmWSvc9g ($26.05 in chips) 
OXPkK84/qv92EMwXPiG5rQ: posts small blind $0.10
CvL9Ch1HYCVbTsfpNucitg: posts big blind $0.25
*** HOLE CARDS ***
4awUyiDYTgylQKXZ9faBVA: folds 
+2kMBNpY4nF1qNCRd8SJLA: folds 
v5jnQ1gfh9nLla3kMXG7Yg: calls $0.25
Bb42QRQMhg5/Y0vHP8/2Xw: folds 
eK8qa6EPcH2zhtbmWSvc9g: calls $0.25
EIObtVVE4WXRXvLGJA6NHw: raises $0.50 to $0.75
OXPkK84/qv92EMwXPiG5rQ: calls $0.65
CvL9Ch1HYCVbTsfpNucitg: folds 
v5jnQ1gfh9nLla3kMXG7Yg: folds 
eK8qa6EPcH2zhtbmWSvc9g: calls $0.50
*** FLOP *** [4s 9h Kc]
OXPkK84/qv92EMwXPiG5rQ: checks 
eK8qa6EPcH2zhtbmWSvc9g: checks 
EIObtVVE4WXRXvLGJA6NHw: bets $2
OXPkK84/qv92EMwXPiG5rQ: calls $2
eK8qa6EPcH2zhtbmWSvc9g: folds 
*** TURN *** [4s 9h Kc] [5s]
OXPkK84/qv92EMwXPiG5rQ: bets $2.50
EIObtVVE4WXRXvLGJA6NHw: folds 
Uncalled bet ($2.50) returned to OXPkK84/qv92EMwXPiG5rQ
OXPkK84/qv92EMwXPiG5rQ collected $6.45 from pot
OXPkK84/qv92EMwXPiG5rQ: doesn't show hand 
*** SUMMARY ***
Total pot $6.75 | Rake $0.30 
Board [4s 9h Kc 5s]
Seat 1: EIObtVVE4WXRXvLGJA6NHw (button) folded on the Turn
Seat 2: OXPkK84/qv92EMwXPiG5rQ (small blind) collected ($6.45)
Seat 3: CvL9Ch1HYCVbTsfpNucitg (big blind) folded before Flop
Seat 4: 4awUyiDYTgylQKXZ9faBVA folded before Flop (didn't bet)
Seat 5: +2kMBNpY4nF1qNCRd8SJLA folded before Flop (didn't bet)
Seat 6: v5jnQ1gfh9nLla3kMXG7Yg folded before Flop
Seat 7: Bb42QRQMhg5/Y0vHP8/2Xw folded before Flop (didn't bet)
Seat 9: eK8qa6EPcH2zhtbmWSvc9g folded on the Flop




PokerStars Game #59941640744:  Hold'em No Limit ($0.10/$0.25) - 2009/07/01 1:41:34 ET
Table 'i8VqsSY3xDtJ63IHleN8+A' 9-max Seat #6 is the button
Seat 3: 4awUyiDYTgylQKXZ9faBVA ($29.15 in chips) 
Seat 4: X78b5v/uhqeXXoAijbw/yg ($26.75 in chips) 
Seat 6: 3PmVnC/15cl4oyI1TKIt4g ($5.50 in chips) 
Seat 9: tLcDklc2rBORNfixyRfVfw ($25 in chips) 
CvL9Ch1HYCVbTsfpNucitg: is sitting out 
tLcDklc2rBORNfixyRfVfw: posts small blind $0.10
Mh2r9hTeTEDnh19sRZtW3g: is sitting out 
4awUyiDYTgylQKXZ9faBVA: posts big blind $0.25
*** HOLE CARDS ***
CvL9Ch1HYCVbTsfpNucitg leaves the table
Mh2r9hTeTEDnh19sRZtW3g leaves the table
X78b5v/uhqeXXoAijbw/yg: folds 
3PmVnC/15cl4oyI1TKIt4g: folds 
X78b5v/uhqeXXoAijbw/yg leaves the table
tLcDklc2rBORNfixyRfVfw: folds 
Uncalled bet ($0.15) returned to 4awUyiDYTgylQKXZ9faBVA
tLcDklc2rBORNfixyRfVfw leaves the table
4awUyiDYTgylQKXZ9faBVA collected $0.20 from pot
4awUyiDYTgylQKXZ9faBVA: doesn't show hand 
3PmVnC/15cl4oyI1TKIt4g leaves the table
*** SUMMARY ***
Total pot $0.20 | Rake $0 
Seat 3: 4awUyiDYTgylQKXZ9faBVA (big blind) collected ($0.20)
Seat 4: X78b5v/uhqeXXoAijbw/yg folded before Flop (didn't bet)
Seat 6: 3PmVnC/15cl4oyI1TKIt4g (button) folded before Flop (didn't bet)
Seat 9: tLcDklc2rBORNfixyRfVfw (small blind) folded before Flop




PokerStars Game #59941641618:  Hold'em No Limit ($0.10/$0.25) - 2009/07/01 1:41:35 ET
Table '3lS+sU5k6mwJCS2nFMmQ6Q' 9-max Seat #1 is the button
Seat 1: VWUWpMLMj/Q1jRVpF7Aohw ($13.45 in chips) 
Seat 3: 1DXccE2UUK5DIRVGlOKnTA ($18.05 in chips) 
Seat 4: ydoFOVgzvZv9ZhuWu9rXAw ($5.35 in chips) 
Seat 5: NcPAt5YjVvDFEJTTgAVj8g ($5.05 in chips) 
Seat 6: hJ4uYjNmSZdjrKA8cjZqCA ($36.75 in chips) 
Seat 7: Th3FldXKQW6hWVVPahaoOQ ($30.85 in chips) 
Seat 8: 9lvO/qyU+xrU95Teu1fv0g ($5 in chips) 
Seat 9: 4awUyiDYTgylQKXZ9faBVA ($49.20 in chips) 
1DXccE2UUK5DIRVGlOKnTA: posts small blind $0.10
ydoFOVgzvZv9ZhuWu9rXAw: posts big blind $0.25
*** HOLE CARDS ***
NcPAt5YjVvDFEJTTgAVj8g: folds 
hJ4uYjNmSZdjrKA8cjZqCA: calls $0.25
Th3FldXKQW6hWVVPahaoOQ: folds 
9lvO/qyU+xrU95Teu1fv0g: folds 
4awUyiDYTgylQKXZ9faBVA: folds 
VWUWpMLMj/Q1jRVpF7Aohw: folds 
1DXccE2UUK5DIRVGlOKnTA: calls $0.15
ydoFOVgzvZv9ZhuWu9rXAw: checks 
*** FLOP *** [2h 7h Kd]
1DXccE2UUK5DIRVGlOKnTA: checks 
ydoFOVgzvZv9ZhuWu9rXAw: bets $0.75
hJ4uYjNmSZdjrKA8cjZqCA: folds 
1DXccE2UUK5DIRVGlOKnTA: calls $0.75
*** TURN *** [2h 7h Kd] [9c]
1DXccE2UUK5DIRVGlOKnTA: checks 
ydoFOVgzvZv9ZhuWu9rXAw: bets $1.50
1DXccE2UUK5DIRVGlOKnTA: raises $2 to $3.50
ydoFOVgzvZv9ZhuWu9rXAw: raises $0.85 to $4.35 and is all-in
1DXccE2UUK5DIRVGlOKnTA: calls $0.85
*** RIVER *** [2h 7h Kd 9c] [3c]
*** SHOW DOWN ***
1DXccE2UUK5DIRVGlOKnTA: shows [7c 5c] (a pair of Sevens)
ydoFOVgzvZv9ZhuWu9rXAw: shows [9d Ks] (two pair, Kings and Nines)
ydoFOVgzvZv9ZhuWu9rXAw collected $10.45 from pot
*** SUMMARY ***
Total pot $10.95 | Rake $0.50 
Board [2h 7h Kd 9c 3c]
Seat 1: VWUWpMLMj/Q1jRVpF7Aohw (button) folded before Flop (didn't bet)
Seat 3: 1DXccE2UUK5DIRVGlOKnTA (small blind) showed [7c 5c] and lost with a pair of Sevens
Seat 4: ydoFOVgzvZv9ZhuWu9rXAw (big blind) showed [9d Ks] and won ($10.45) with two pair, Kings and Nines
Seat 5: NcPAt5YjVvDFEJTTgAVj8g folded before Flop (didn't bet)
Seat 6: hJ4uYjNmSZdjrKA8cjZqCA folded on the Flop
Seat 7: Th3FldXKQW6hWVVPahaoOQ folded before Flop (didn't bet)
Seat 8: 9lvO/qyU+xrU95Teu1fv0g folded before Flop (didn't bet)
Seat 9: 4awUyiDYTgylQKXZ9faBVA folded before Flop (didn't bet)




PokerStars Game #59941641590:  Hold'em No Limit ($0.10/$0.25) - 2009/07/01 1:41:35 ET
Table 'NtEQAxCeIK2io1CGtW658g' 6-max Seat #4 is the button
Seat 1: X437kMQ7AujoaDgjguhU9w ($11.80 in chips) 
Seat 3: m2yWOKfAxqHoy5DDN87Ttw ($38 in chips) 
Seat 4: 8296 ($11.55 in chips) 
Seat 5: Hsvkc0/G2VV78oVmWYXecw ($5 in chips) 
Seat 6: /gJNBeCkWL4o85/jvlZ4BA ($65.10 in chips) 
Hsvkc0/G2VV78oVmWYXecw: posts small blind $0.10
/gJNBeCkWL4o85/jvlZ4BA: posts big blind $0.25
*** HOLE CARDS ***
X437kMQ7AujoaDgjguhU9w: folds 
m2yWOKfAxqHoy5DDN87Ttw: folds 
8296: raises $0.25 to $0.50
Hsvkc0/G2VV78oVmWYXecw: folds 
/gJNBeCkWL4o85/jvlZ4BA: folds 
Uncalled bet ($0.25) returned to 8296
8296 collected $0.60 from pot
8296: doesn't show hand 
*** SUMMARY ***
Total pot $0.60 | Rake $0 
Seat 1: X437kMQ7AujoaDgjguhU9w folded before Flop (didn't bet)
Seat 3: m2yWOKfAxqHoy5DDN87Ttw folded before Flop (didn't bet)
Seat 4: 8296 (button) collected ($0.60)
Seat 5: Hsvkc0/G2VV78oVmWYXecw (small blind) folded before Flop
Seat 6: /gJNBeCkWL4o85/jvlZ4BA (big blind) folded before Flop




PokerStars Game #59941641384:  Hold'em No Limit ($0.10/$0.25) - 2009/07/01 1:41:35 ET
Table 'pPgW4R3kdH26lLi1MnE92w' 9-max Seat #6 is the button
Seat 1: F4P6SxCNY4vxdb318G9RwA ($19.60 in chips) 
Seat 2: cZ99hugmLBj9KhTlc8nCSw ($27.50 in chips) 
Seat 3: WaS7+xnv4bIVHoru6nxczA ($13.75 in chips) 
Seat 4: 68iMVGMbYGvnpcCiPOVbbw ($4.65 in chips) 
Seat 5: HPEB+AtKw1+C/cxU0o1ciw ($21.55 in chips) 
Seat 6: VllYilcih0t+gMD4GTRlgQ ($25.90 in chips) 
Seat 7: sD+TKtt36XiiN6jqHiLwDA ($27.95 in chips) 
Seat 8: aCVg6cCxQcqClhB9nq/p1w ($31.20 in chips) 
Seat 9: tcbEu7VzyHQ+0lh+skbQhQ ($63.30 in chips) 
sD+TKtt36XiiN6jqHiLwDA: posts small blind $0.10
aCVg6cCxQcqClhB9nq/p1w: posts big blind $0.25
*** HOLE CARDS ***
tcbEu7VzyHQ+0lh+skbQhQ: folds 
F4P6SxCNY4vxdb318G9RwA: folds 
cZ99hugmLBj9KhTlc8nCSw: folds 
WaS7+xnv4bIVHoru6nxczA: folds 
68iMVGMbYGvnpcCiPOVbbw: folds 
HPEB+AtKw1+C/cxU0o1ciw: folds 
VllYilcih0t+gMD4GTRlgQ: calls $0.25
sD+TKtt36XiiN6jqHiLwDA: calls $0.15
aCVg6cCxQcqClhB9nq/p1w: checks 
*** FLOP *** [7h Jh Qs]
sD+TKtt36XiiN6jqHiLwDA: bets $0.75
aCVg6cCxQcqClhB9nq/p1w: folds 
VllYilcih0t+gMD4GTRlgQ: folds 
Uncalled bet ($0.75) returned to sD+TKtt36XiiN6jqHiLwDA
sD+TKtt36XiiN6jqHiLwDA collected $0.75 from pot
sD+TKtt36XiiN6jqHiLwDA: doesn't show hand 
*** SUMMARY ***
Total pot $0.75 | Rake $0 
Board [7h Jh Qs]
Seat 1: F4P6SxCNY4vxdb318G9RwA folded before Flop (didn't bet)
Seat 2: cZ99hugmLBj9KhTlc8nCSw folded before Flop (didn't bet)
Seat 3: WaS7+xnv4bIVHoru6nxczA folded before Flop (didn't bet)
Seat 4: 68iMVGMbYGvnpcCiPOVbbw folded before Flop (didn't bet)
Seat 5: HPEB+AtKw1+C/cxU0o1ciw folded before Flop (didn't bet)
Seat 6: VllYilcih0t+gMD4GTRlgQ (button) folded on the Flop
Seat 7: sD+TKtt36XiiN6jqHiLwDA (small blind) collected ($0.75)
Seat 8: aCVg6cCxQcqClhB9nq/p1w (big blind) folded on the Flop
Seat 9: tcbEu7VzyHQ+0lh+skbQhQ folded before Flop (didn't bet)




PokerStars Game #59941641644:  Hold'em No Limit ($0.10/$0.25) - 2009/07/01 1:41:35 ET
Table 'yZgGBnUGXVCcEJdcqes8tw' 9-max Seat #3 is the button
Seat 1: 6RiVTYll/5D8zICp0MRpKw ($28.85 in chips) 
Seat 2: MG90wfSJZnOejs/KD3vlQQ ($25 in chips) 
Seat 3: z5GxcHlYz/GSz6W2uFiTtg ($23.30 in chips) 
Seat 4: M2QO2DxB5Wawg2h8HSpnYA ($10 in chips) 
Seat 5: dfNim92Z6XK1/h5SFW5vDg ($25.40 in chips) 
Seat 6: pRZytPRoJmxE0dmcJwYvfw ($5.95 in chips) 
Seat 7: eC8Pn1D6Y2pct8o62nQfvQ ($25.15 in chips) 
Seat 8: dtZ84flFEi4Q+SGrHMJRDQ ($31.65 in chips) 
Seat 9: M/9j4wkHH9i1JM51vgi1VA ($23.75 in chips) 
M2QO2DxB5Wawg2h8HSpnYA: posts small blind $0.10
dfNim92Z6XK1/h5SFW5vDg: posts big blind $0.25
*** HOLE CARDS ***
pRZytPRoJmxE0dmcJwYvfw: folds 
eC8Pn1D6Y2pct8o62nQfvQ: folds 
dtZ84flFEi4Q+SGrHMJRDQ: folds 
M/9j4wkHH9i1JM51vgi1VA: folds 
M/9j4wkHH9i1JM51vgi1VA is sitting out
6RiVTYll/5D8zICp0MRpKw: raises $0.50 to $0.75
MG90wfSJZnOejs/KD3vlQQ: folds 
z5GxcHlYz/GSz6W2uFiTtg: folds 
M2QO2DxB5Wawg2h8HSpnYA: folds 
dfNim92Z6XK1/h5SFW5vDg: folds 
Uncalled bet ($0.50) returned to 6RiVTYll/5D8zICp0MRpKw
6RiVTYll/5D8zICp0MRpKw collected $0.60 from pot
*** SUMMARY ***
Total pot $0.60 | Rake $0 
Seat 1: 6RiVTYll/5D8zICp0MRpKw collected ($0.60)
Seat 2: MG90wfSJZnOejs/KD3vlQQ folded before Flop (didn't bet)
Seat 3: z5GxcHlYz/GSz6W2uFiTtg (button) folded before Flop (didn't bet)
Seat 4: M2QO2DxB5Wawg2h8HSpnYA (small blind) folded before Flop
Seat 5: dfNim92Z6XK1/h5SFW5vDg (big blind) folded before Flop
Seat 6: pRZytPRoJmxE0dmcJwYvfw folded before Flop (didn't bet)
Seat 7: eC8Pn1D6Y2pct8o62nQfvQ folded before Flop (didn't bet)
Seat 8: dtZ84flFEi4Q+SGrHMJRDQ folded before Flop (didn't bet)
Seat 9: M/9j4wkHH9i1JM51vgi1VA folded before Flop (didn't bet)




PokerStars Game #59941641366:  Hold'em No Limit ($0.10/$0.25) - 2009/07/01 1:41:35 ET
Table 'eOXPe2c6mG7DOFKvMsZZfA' 6-max Seat #1 is the button
Seat 1: s21kVGMLPAoHdWR+muSonw ($25.40 in chips) 
Seat 2: gaPMxLGp9SOj4Lq6t+/0Ig ($7.20 in chips) 
Seat 3: kReyZ6g6Fu3tQ0nyjDf9kA ($21.05 in chips) 
Seat 4: zHHLkD2sRljslKKeQv/ZQw ($40.25 in chips) 
Seat 5: NhUN/JpAprdJeamFBgJH1w ($32.15 in chips) 
Seat 6: Qpv/hb5ak7LeaDig1L5L8w ($15.10 in chips) 
gaPMxLGp9SOj4Lq6t+/0Ig: posts small blind $0.10
kReyZ6g6Fu3tQ0nyjDf9kA: posts big blind $0.25
*** HOLE CARDS ***
zHHLkD2sRljslKKeQv/ZQw: raises $0.50 to $0.75
NhUN/JpAprdJeamFBgJH1w: folds 
Qpv/hb5ak7LeaDig1L5L8w: folds 
s21kVGMLPAoHdWR+muSonw: folds 
gaPMxLGp9SOj4Lq6t+/0Ig: folds 
kReyZ6g6Fu3tQ0nyjDf9kA: folds 
Uncalled bet ($0.50) returned to zHHLkD2sRljslKKeQv/ZQw
zHHLkD2sRljslKKeQv/ZQw collected $0.60 from pot
*** SUMMARY ***
Total pot $0.60 | Rake $0 
Seat 1: s21kVGMLPAoHdWR+muSonw (button) folded before Flop (didn't bet)
Seat 2: gaPMxLGp9SOj4Lq6t+/0Ig (small blind) folded before Flop
Seat 3: kReyZ6g6Fu3tQ0nyjDf9kA (big blind) folded before Flop
Seat 4: zHHLkD2sRljslKKeQv/ZQw collected ($0.60)
Seat 5: NhUN/JpAprdJeamFBgJH1w folded before Flop (didn't bet)
Seat 6: Qpv/hb5ak7LeaDig1L5L8w folded before Flop (didn't bet)




PokerStars Game #59941641472:  Hold'em No Limit ($0.10/$0.25) - 2009/07/01 1:41:35 ET
Table 'mF3KHGMaTpaBZbtBoyfTeg' 6-max Seat #5 is the button
Seat 1: 0HAB2GdCAM7p7V00xueAVQ ($25.60 in chips) 
Seat 2: 6qsh9pnysDKJNhfFhFmKRQ ($9.40 in chips) 
Seat 3: 9kUKGKkblnIx3m8rlVol6Q ($14.65 in chips) 
Seat 4: FYepjhAvF8ZdVCmqHIy+eQ ($25 in chips) 
Seat 5: 8ClCHtFXGNplITm+63KB+Q ($43.40 in chips) 
Seat 6: kG34n23qFQA3nzdOJTQ1dA ($27.25 in chips) 
kG34n23qFQA3nzdOJTQ1dA: posts small blind $0.10
0HAB2GdCAM7p7V00xueAVQ: posts big blind $0.25
*** HOLE CARDS ***
6qsh9pnysDKJNhfFhFmKRQ: calls $0.25
9kUKGKkblnIx3m8rlVol6Q: folds 
FYepjhAvF8ZdVCmqHIy+eQ: folds 
8ClCHtFXGNplITm+63KB+Q: folds 
kG34n23qFQA3nzdOJTQ1dA: raises $1.25 to $1.50
0HAB2GdCAM7p7V00xueAVQ: folds 
6qsh9pnysDKJNhfFhFmKRQ: folds 
Uncalled bet ($1.25) returned to kG34n23qFQA3nzdOJTQ1dA
kG34n23qFQA3nzdOJTQ1dA collected $0.75 from pot
*** SUMMARY ***
Total pot $0.75 | Rake $0 
Seat 1: 0HAB2GdCAM7p7V00xueAVQ (big blind) folded before Flop
Seat 2: 6qsh9pnysDKJNhfFhFmKRQ folded before Flop
Seat 3: 9kUKGKkblnIx3m8rlVol6Q folded before Flop (didn't bet)
Seat 4: FYepjhAvF8ZdVCmqHIy+eQ folded before Flop (didn't bet)
Seat 5: 8ClCHtFXGNplITm+63KB+Q (button) folded before Flop (didn't bet)
Seat 6: kG34n23qFQA3nzdOJTQ1dA (small blind) collected ($0.75)




PokerStars Game #59941641314:  Hold'em No Limit ($0.10/$0.25) - 2009/07/01 1:41:35 ET
Table 'Mef6A0EMopL6WaFO5/KO9g' 6-max Seat #4 is the button
Seat 1: GbCVUNssQ7mqsPWr7J4d3w ($4.65 in chips) 
Seat 2: 8ClCHtFXGNplITm+63KB+Q ($32.65 in chips) 
Seat 3: Wq26opBLDGJe91GRJn2epg ($12.30 in chips) 
Seat 4: lquriepNQBhDV5P1SWHhnA ($25 in chips) 
Seat 5: DihMHaz4WNETH1bPDe13kA ($25 in chips) 
Seat 6: jp34e617tIzV8tKIWmfAbA ($33.65 in chips) 
DihMHaz4WNETH1bPDe13kA: posts small blind $0.10
jp34e617tIzV8tKIWmfAbA: posts big blind $0.25
*** HOLE CARDS ***
GbCVUNssQ7mqsPWr7J4d3w: folds 
8ClCHtFXGNplITm+63KB+Q: folds 
Wq26opBLDGJe91GRJn2epg: raises $0.50 to $0.75
lquriepNQBhDV5P1SWHhnA: folds 
DihMHaz4WNETH1bPDe13kA: folds 
jp34e617tIzV8tKIWmfAbA: folds 
Uncalled bet ($0.50) returned to Wq26opBLDGJe91GRJn2epg
Wq26opBLDGJe91GRJn2epg collected $0.60 from pot
*** SUMMARY ***
Total pot $0.60 | Rake $0 
Seat 1: GbCVUNssQ7mqsPWr7J4d3w folded before Flop (didn't bet)
Seat 2: 8ClCHtFXGNplITm+63KB+Q folded before Flop (didn't bet)
Seat 3: Wq26opBLDGJe91GRJn2epg collected ($0.60)
Seat 4: lquriepNQBhDV5P1SWHhnA (button) folded before Flop (didn't bet)
Seat 5: DihMHaz4WNETH1bPDe13kA (small blind) folded before Flop
Seat 6: jp34e617tIzV8tKIWmfAbA (big blind) folded before Flop




PokerStars Game #59941642140:  Hold'em No Limit ($0.10/$0.25) - 2009/07/01 1:41:36 ET
Table 'DhkrdW2UOy2PfjSW28Kq8w' 6-max Seat #3 is the button
Seat 1: vu2kzHaDtgr6NM7rdq0chA ($26.65 in chips) 
Seat 2: v+QfkGiuj9bgtuNoVnDO8w ($25 in chips) 
Seat 3: B3X187C0tXFUfQpCu8pe8A ($22.90 in chips) 
Seat 4: 59HJSCM1X37BkMpI9N0mEw ($26.50 in chips) 
Seat 5: SxIIgwXYLkwd6m3wLyPTCw ($49.20 in chips) 
Seat 6: DihMHaz4WNETH1bPDe13kA ($25.40 in chips) 
59HJSCM1X37BkMpI9N0mEw: posts small blind $0.10
SxIIgwXYLkwd6m3wLyPTCw: posts big blind $0.25
*** HOLE CARDS ***
DihMHaz4WNETH1bPDe13kA: folds 
vu2kzHaDtgr6NM7rdq0chA: calls $0.25
v+QfkGiuj9bgtuNoVnDO8w: folds 
B3X187C0tXFUfQpCu8pe8A: folds 
59HJSCM1X37BkMpI9N0mEw: calls $0.15
SxIIgwXYLkwd6m3wLyPTCw: checks 
*** FLOP *** [Js 8s 6h]
59HJSCM1X37BkMpI9N0mEw: bets $0.75
SxIIgwXYLkwd6m3wLyPTCw: folds 
vu2kzHaDtgr6NM7rdq0chA: folds 
Uncalled bet ($0.75) returned to 59HJSCM1X37BkMpI9N0mEw
59HJSCM1X37BkMpI9N0mEw collected $0.75 from pot
59HJSCM1X37BkMpI9N0mEw: doesn't show hand 
*** SUMMARY ***
Total pot $0.75 | Rake $0 
Board [Js 8s 6h]
Seat 1: vu2kzHaDtgr6NM7rdq0chA folded on the Flop
Seat 2: v+QfkGiuj9bgtuNoVnDO8w folded before Flop (didn't bet)
Seat 3: B3X187C0tXFUfQpCu8pe8A (button) folded before Flop (didn't bet)
Seat 4: 59HJSCM1X37BkMpI9N0mEw (small blind) collected ($0.75)
Seat 5: SxIIgwXYLkwd6m3wLyPTCw (big blind) folded on the Flop
Seat 6: DihMHaz4WNETH1bPDe13kA folded before Flop (didn't bet)




PokerStars Game #59941641734:  Hold'em No Limit ($0.10/$0.25) - 2009/07/01 1:41:36 ET
Table 'CBnRhp0d6E2+/NtM7Vbruw' 9-max Seat #1 is the button
Seat 1: WQe4GbiYBiPsb5WKFKkijQ ($11.55 in chips) 
Seat 2: cZ99hugmLBj9KhTlc8nCSw ($25.25 in chips) 
Seat 3: aNpwfA31EREwO+ar4XzBCw ($34.05 in chips) 
Seat 4: EBI5F+kilCiSAA25omTumQ ($20.55 in chips) 
Seat 5: CT7Xj/V/O5rBlhtt+RZeFQ ($25 in chips) 
Seat 6: CvL9Ch1HYCVbTsfpNucitg ($4.65 in chips) 
Seat 7: j4q3p0lesp63b1gZDwLBZw ($5 in chips) 
Seat 8: MG90wfSJZnOejs/KD3vlQQ ($25 in chips) 
Seat 9: xHZZRLAaFUIC8WWI8ljOJA ($29.90 in chips) 
cZ99hugmLBj9KhTlc8nCSw: posts small blind $0.10
aNpwfA31EREwO+ar4XzBCw: posts big blind $0.25
*** HOLE CARDS ***
WQe4GbiYBiPsb5WKFKkijQ said, "no need for me :)"
EBI5F+kilCiSAA25omTumQ has timed out
EBI5F+kilCiSAA25omTumQ: folds 
EBI5F+kilCiSAA25omTumQ is sitting out
CT7Xj/V/O5rBlhtt+RZeFQ: folds 
CvL9Ch1HYCVbTsfpNucitg: folds 
j4q3p0lesp63b1gZDwLBZw: folds 
MG90wfSJZnOejs/KD3vlQQ: folds 
xHZZRLAaFUIC8WWI8ljOJA: folds 
WQe4GbiYBiPsb5WKFKkijQ: raises $0.25 to $0.50
cZ99hugmLBj9KhTlc8nCSw: raises $1 to $1.50
xHZZRLAaFUIC8WWI8ljOJA said, "nah"
aNpwfA31EREwO+ar4XzBCw: folds 
WQe4GbiYBiPsb5WKFKkijQ: calls $1
*** FLOP *** [3s Ac 2c]
xHZZRLAaFUIC8WWI8ljOJA said, "you just like to min raise :)"
cZ99hugmLBj9KhTlc8nCSw: bets $2
WQe4GbiYBiPsb5WKFKkijQ: folds 
Uncalled bet ($2) returned to cZ99hugmLBj9KhTlc8nCSw
cZ99hugmLBj9KhTlc8nCSw collected $3.10 from pot
cZ99hugmLBj9KhTlc8nCSw: doesn't show hand 
*** SUMMARY ***
Total pot $3.25 | Rake $0.15 
Board [3s Ac 2c]
Seat 1: WQe4GbiYBiPsb5WKFKkijQ (button) folded on the Flop
Seat 2: cZ99hugmLBj9KhTlc8nCSw (small blind) collected ($3.10)
Seat 3: aNpwfA31EREwO+ar4XzBCw (big blind) folded before Flop
Seat 4: EBI5F+kilCiSAA25omTumQ folded before Flop (didn't bet)
Seat 5: CT7Xj/V/O5rBlhtt+RZeFQ folded before Flop (didn't bet)
Seat 6: CvL9Ch1HYCVbTsfpNucitg folded before Flop (didn't bet)
Seat 7: j4q3p0lesp63b1gZDwLBZw folded before Flop (didn't bet)
Seat 8: MG90wfSJZnOejs/KD3vlQQ folded before Flop (didn't bet)
Seat 9: xHZZRLAaFUIC8WWI8ljOJA folded before Flop (didn't bet)




PokerStars Game #59941641858:  Hold'em No Limit ($0.10/$0.25) - 2009/07/01 1:41:36 ET
Table 'ouLhepGYovxB2x0QxH7cVg' 9-max Seat #9 is the button
Seat 1: ghNKXUBl/H+t83JF079ZBA ($25.10 in chips) 
Seat 2: r1Z5m4PwSI5ANp7qCE1OJw ($19 in chips) 
Seat 3: bXpVeaSTPBFSPJmeXxO7nw ($5.60 in chips) 
Seat 4: a0Sx6GHY7ln2Ns2C97eXeA ($38.30 in chips) 
Seat 5: LxRIJ6NkqjCD5zmzlF+y4w ($14.45 in chips) 
Seat 6: lSeLm4BdnSMLtIli62qjAQ ($7.50 in chips) 
Seat 7: JRV2PblFtPFz51l0Fwyz8g ($23.65 in chips) 
Seat 8: tLcDklc2rBORNfixyRfVfw ($25 in chips) 
Seat 9: ljemhp25Zg+nlA9DLCIiUw ($25 in chips) 
ghNKXUBl/H+t83JF079ZBA: posts small blind $0.10
r1Z5m4PwSI5ANp7qCE1OJw: posts big blind $0.25
*** HOLE CARDS ***
bXpVeaSTPBFSPJmeXxO7nw: folds 
a0Sx6GHY7ln2Ns2C97eXeA: folds 
LxRIJ6NkqjCD5zmzlF+y4w: folds 
lSeLm4BdnSMLtIli62qjAQ: folds 
JRV2PblFtPFz51l0Fwyz8g: folds 
tLcDklc2rBORNfixyRfVfw: folds 
ljemhp25Zg+nlA9DLCIiUw: raises $0.50 to $0.75
ghNKXUBl/H+t83JF079ZBA: folds 
r1Z5m4PwSI5ANp7qCE1OJw: folds 
Uncalled bet ($0.50) returned to ljemhp25Zg+nlA9DLCIiUw
ljemhp25Zg+nlA9DLCIiUw collected $0.60 from pot
ljemhp25Zg+nlA9DLCIiUw: doesn't show hand 
*** SUMMARY ***
Total pot $0.60 | Rake $0 
Seat 1: ghNKXUBl/H+t83JF079ZBA (small blind) folded before Flop
Seat 2: r1Z5m4PwSI5ANp7qCE1OJw (big blind) folded before Flop
Seat 3: bXpVeaSTPBFSPJmeXxO7nw folded before Flop (didn't bet)
Seat 4: a0Sx6GHY7ln2Ns2C97eXeA folded before Flop (didn't bet)
Seat 5: LxRIJ6NkqjCD5zmzlF+y4w folded before Flop (didn't bet)
Seat 6: lSeLm4BdnSMLtIli62qjAQ folded before Flop (didn't bet)
Seat 7: JRV2PblFtPFz51l0Fwyz8g folded before Flop (didn't bet)
Seat 8: tLcDklc2rBORNfixyRfVfw folded before Flop (didn't bet)
Seat 9: ljemhp25Zg+nlA9DLCIiUw (button) collected ($0.60)




PokerStars Game #59941641684:  Hold'em No Limit ($0.10/$0.25) - 2009/07/01 1:41:36 ET
Table 'nyTW9cVtYentc5V7xU/0jA' 6-max Seat #5 is the button
Seat 1: HI20pVxSHPZ29u9IDkmICg ($9.90 in chips) 
Seat 2: v6mkGzCBCCXcgWQNSYVtKg ($6.50 in chips) 
Seat 3: kG34n23qFQA3nzdOJTQ1dA ($36.45 in chips) 
Seat 4: NkB3D4eVHHXvB9Edaugc1Q ($20.80 in chips) 
Seat 5: zZAcuQ0EvirdEuiIbeaocQ ($14.45 in chips) 
HI20pVxSHPZ29u9IDkmICg: posts small blind $0.10
v6mkGzCBCCXcgWQNSYVtKg: posts big blind $0.25
*** HOLE CARDS ***
kG34n23qFQA3nzdOJTQ1dA: folds 
NkB3D4eVHHXvB9Edaugc1Q: folds 
zZAcuQ0EvirdEuiIbeaocQ: folds 
HI20pVxSHPZ29u9IDkmICg: raises $0.50 to $0.75
v6mkGzCBCCXcgWQNSYVtKg: folds 
Uncalled bet ($0.50) returned to HI20pVxSHPZ29u9IDkmICg
HI20pVxSHPZ29u9IDkmICg collected $0.50 from pot
*** SUMMARY ***
Total pot $0.50 | Rake $0 
Seat 1: HI20pVxSHPZ29u9IDkmICg (small blind) collected ($0.50)
Seat 2: v6mkGzCBCCXcgWQNSYVtKg (big blind) folded before Flop
Seat 3: kG34n23qFQA3nzdOJTQ1dA folded before Flop (didn't bet)
Seat 4: NkB3D4eVHHXvB9Edaugc1Q folded before Flop (didn't bet)
Seat 5: zZAcuQ0EvirdEuiIbeaocQ (button) folded before Flop (didn't bet)




PokerStars Game #59941642036:  Hold'em No Limit ($0.10/$0.25) - 2009/07/01 1:41:36 ET
Table 'aaXqTKUnxrX9DYXtxhWXxA' 6-max Seat #5 is the button
Seat 1: rnpAao581IcvQglpkpnkoQ ($8.35 in chips) 
Seat 2: DE9hRlt14g+JdsRQ4wT7hg ($34.05 in chips) 
Seat 4: 48oT5xFI+5CHUJlfoGrE4w ($10.55 in chips) 
Seat 5: kyRaCIljYA6l33lSKQfNsg ($25 in chips) 
Seat 6: buyjetgNT1McXtdaP4zynA ($47.95 in chips) 
buyjetgNT1McXtdaP4zynA: posts small blind $0.10
rnpAao581IcvQglpkpnkoQ: posts big blind $0.25
uUXdcVMNa05rfbntdvplfw: sits out 
*** HOLE CARDS ***
DE9hRlt14g+JdsRQ4wT7hg: folds 
48oT5xFI+5CHUJlfoGrE4w: folds 
kyRaCIljYA6l33lSKQfNsg: folds 
buyjetgNT1McXtdaP4zynA: calls $0.15
rnpAao581IcvQglpkpnkoQ: checks 
*** FLOP *** [As 4h Kd]
buyjetgNT1McXtdaP4zynA: checks 
rnpAao581IcvQglpkpnkoQ: checks 
*** TURN *** [As 4h Kd] [7s]
buyjetgNT1McXtdaP4zynA: checks 
rnpAao581IcvQglpkpnkoQ: checks 
*** RIVER *** [As 4h Kd 7s] [3h]
buyjetgNT1McXtdaP4zynA: checks 
rnpAao581IcvQglpkpnkoQ: checks 
*** SHOW DOWN ***
buyjetgNT1McXtdaP4zynA: shows [6d Jd] (high card Ace)
rnpAao581IcvQglpkpnkoQ: mucks hand 
buyjetgNT1McXtdaP4zynA collected $0.50 from pot
*** SUMMARY ***
Total pot $0.50 | Rake $0 
Board [As 4h Kd 7s 3h]
Seat 1: rnpAao581IcvQglpkpnkoQ (big blind) mucked
Seat 2: DE9hRlt14g+JdsRQ4wT7hg folded before Flop (didn't bet)
Seat 4: 48oT5xFI+5CHUJlfoGrE4w folded before Flop (didn't bet)
Seat 5: kyRaCIljYA6l33lSKQfNsg (button) folded before Flop (didn't bet)
Seat 6: buyjetgNT1McXtdaP4zynA (small blind) showed [6d Jd] and won ($0.50) with high card Ace




PokerStars Game #59941641772:  Hold'em No Limit ($0.10/$0.25) - 2009/07/01 1:41:36 ET
Table 'm+FQg/QP0VP1ZA3V62WtOg' 9-max Seat #9 is the button
Seat 4: qB12xUq3ftb2y8oTnNQzsg ($2.60 in chips) 
Seat 6: CT7Xj/V/O5rBlhtt+RZeFQ ($25.60 in chips) 
Seat 7: TPAF9YkMsjQFq978RNWZEQ ($14.80 in chips) 
Seat 9: zUXhymECc2C9W9ZNw6qppA ($10.55 in chips) 
qB12xUq3ftb2y8oTnNQzsg: posts small blind $0.10
CT7Xj/V/O5rBlhtt+RZeFQ: posts big blind $0.25
*** HOLE CARDS ***
TPAF9YkMsjQFq978RNWZEQ: raises $0.25 to $0.50
zUXhymECc2C9W9ZNw6qppA: folds 
qB12xUq3ftb2y8oTnNQzsg: folds 
TOWMILL joins the table at seat #5 
CT7Xj/V/O5rBlhtt+RZeFQ: calls $0.25
*** FLOP *** [Th 3c Qs]
qB12xUq3ftb2y8oTnNQzsg leaves the table
CT7Xj/V/O5rBlhtt+RZeFQ: checks 
TPAF9YkMsjQFq978RNWZEQ: bets $0.75
nhai joins the table at seat #3 
CT7Xj/V/O5rBlhtt+RZeFQ: folds 
Uncalled bet ($0.75) returned to TPAF9YkMsjQFq978RNWZEQ
TPAF9YkMsjQFq978RNWZEQ collected $1.05 from pot
*** SUMMARY ***
Total pot $1.10 | Rake $0.05 
Board [Th 3c Qs]
Seat 4: qB12xUq3ftb2y8oTnNQzsg (small blind) folded before Flop
Seat 6: CT7Xj/V/O5rBlhtt+RZeFQ (big blind) folded on the Flop
Seat 7: TPAF9YkMsjQFq978RNWZEQ collected ($1.05)
Seat 9: zUXhymECc2C9W9ZNw6qppA (button) folded before Flop (didn't bet)




PokerStars Game #59941642716:  Hold'em No Limit ($0.10/$0.25) - 2009/07/01 1:41:37 ET
Table 'RUOqTfzbAVGS5x+J9aZMHA' 9-max Seat #8 is the button
Seat 1: DnDcAdn9P0zGovMERigpFA ($25 in chips) 
Seat 2: Z5ZtGOON8kmSdSCll9Z3XA ($8.35 in chips) 
Seat 3: Th3FldXKQW6hWVVPahaoOQ ($25 in chips) 
Seat 4: K9Az8li/CO2TicltVWKamA ($40.20 in chips) 
Seat 5: MtVtHDqIJTyUcXkRBBDIVA ($30.90 in chips) 
Seat 6: ljemhp25Zg+nlA9DLCIiUw ($40.05 in chips) 
Seat 7: zgi+EUykT/pZQpoUG6+oEg ($4.30 in chips) 
Seat 8: dfNim92Z6XK1/h5SFW5vDg ($25 in chips) 
Seat 9: cZ99hugmLBj9KhTlc8nCSw ($25 in chips) 
cZ99hugmLBj9KhTlc8nCSw: posts small blind $0.10
DnDcAdn9P0zGovMERigpFA: posts big blind $0.25
*** HOLE CARDS ***
Z5ZtGOON8kmSdSCll9Z3XA: folds 
Th3FldXKQW6hWVVPahaoOQ: folds 
K9Az8li/CO2TicltVWKamA: raises $0.50 to $0.75
MtVtHDqIJTyUcXkRBBDIVA: folds 
ljemhp25Zg+nlA9DLCIiUw: folds 
zgi+EUykT/pZQpoUG6+oEg: folds 
dfNim92Z6XK1/h5SFW5vDg: folds 
cZ99hugmLBj9KhTlc8nCSw: folds 
DnDcAdn9P0zGovMERigpFA: folds 
Uncalled bet ($0.50) returned to K9Az8li/CO2TicltVWKamA
K9Az8li/CO2TicltVWKamA collected $0.60 from pot
K9Az8li/CO2TicltVWKamA: doesn't show hand 
*** SUMMARY ***
Total pot $0.60 | Rake $0 
Seat 1: DnDcAdn9P0zGovMERigpFA (big blind) folded before Flop
Seat 2: Z5ZtGOON8kmSdSCll9Z3XA folded before Flop (didn't bet)
Seat 3: Th3FldXKQW6hWVVPahaoOQ folded before Flop (didn't bet)
Seat 4: K9Az8li/CO2TicltVWKamA collected ($0.60)
Seat 5: MtVtHDqIJTyUcXkRBBDIVA folded before Flop (didn't bet)
Seat 6: ljemhp25Zg+nlA9DLCIiUw folded before Flop (didn't bet)
Seat 7: zgi+EUykT/pZQpoUG6+oEg folded before Flop (didn't bet)
Seat 8: dfNim92Z6XK1/h5SFW5vDg (button) folded before Flop (didn't bet)
Seat 9: cZ99hugmLBj9KhTlc8nCSw (small blind) folded before Flop




PokerStars Game #59941642746:  Hold'em No Limit ($0.10/$0.25) - 2009/07/01 1:41:37 ET
Table '4XGDnEByOol5up4aB2KbJw' 6-max Seat #4 is the button
Seat 1: kyRaCIljYA6l33lSKQfNsg ($26.85 in chips) 
Seat 2: SFmT9ZsVopnukjvAzrxTRg ($44.15 in chips) 
Seat 3: LtASJ9OlkqGrrUKGQlpGAw ($20.55 in chips) 
Seat 4: BV+K0Phf5VBHr7aZPKqbUQ ($26.50 in chips) 
Seat 5: Dh01+rohD2p9pXLYeBlC5Q ($16.15 in chips) 
Seat 6: a7Ux7aERFGCbT/L3ojVfAg ($9.35 in chips) 
Dh01+rohD2p9pXLYeBlC5Q: posts small blind $0.10
a7Ux7aERFGCbT/L3ojVfAg: posts big blind $0.25
*** HOLE CARDS ***
kyRaCIljYA6l33lSKQfNsg: folds 
SFmT9ZsVopnukjvAzrxTRg: folds 
LtASJ9OlkqGrrUKGQlpGAw: folds 
BV+K0Phf5VBHr7aZPKqbUQ: folds 
Dh01+rohD2p9pXLYeBlC5Q: calls $0.15
a7Ux7aERFGCbT/L3ojVfAg: checks 
*** FLOP *** [Ts 5d Qh]
Dh01+rohD2p9pXLYeBlC5Q: checks 
a7Ux7aERFGCbT/L3ojVfAg: checks 
*** TURN *** [Ts 5d Qh] [Tc]
Dh01+rohD2p9pXLYeBlC5Q: checks 
a7Ux7aERFGCbT/L3ojVfAg: checks 
*** RIVER *** [Ts 5d Qh Tc] [Ac]
Dh01+rohD2p9pXLYeBlC5Q: bets $1.50
a7Ux7aERFGCbT/L3ojVfAg: folds 
Uncalled bet ($1.50) returned to Dh01+rohD2p9pXLYeBlC5Q
Dh01+rohD2p9pXLYeBlC5Q collected $0.50 from pot
*** SUMMARY ***
Total pot $0.50 | Rake $0 
Board [Ts 5d Qh Tc Ac]
Seat 1: kyRaCIljYA6l33lSKQfNsg folded before Flop (didn't bet)
Seat 2: SFmT9ZsVopnukjvAzrxTRg folded before Flop (didn't bet)
Seat 3: LtASJ9OlkqGrrUKGQlpGAw folded before Flop (didn't bet)
Seat 4: BV+K0Phf5VBHr7aZPKqbUQ (button) folded before Flop (didn't bet)
Seat 5: Dh01+rohD2p9pXLYeBlC5Q (small blind) collected ($0.50)
Seat 6: a7Ux7aERFGCbT/L3ojVfAg (big blind) folded on the River




PokerStars Game #59941642478:  Hold'em No Limit ($0.10/$0.25) - 2009/07/01 1:41:37 ET
Table 'isKy4XK8wJM0x735/D4hWA' 6-max Seat #1 is the button
Seat 1: kwsRmpZ1ZaLooISs+zfyKg ($24.40 in chips) 
Seat 2: 6elpmfyt4Zw0yvd8lePSMQ ($22.20 in chips) 
Seat 3: jp34e617tIzV8tKIWmfAbA ($45 in chips) 
Seat 4: DFi/Lzkjsfv8QswS80JX9Q ($30.75 in chips) 
Seat 5: lquriepNQBhDV5P1SWHhnA ($25.60 in chips) 
Seat 6: GbCVUNssQ7mqsPWr7J4d3w ($4.65 in chips) 
6elpmfyt4Zw0yvd8lePSMQ: posts small blind $0.10
jp34e617tIzV8tKIWmfAbA: posts big blind $0.25
*** HOLE CARDS ***
DFi/Lzkjsfv8QswS80JX9Q: folds 
lquriepNQBhDV5P1SWHhnA: folds 
GbCVUNssQ7mqsPWr7J4d3w: folds 
kwsRmpZ1ZaLooISs+zfyKg: folds 
6elpmfyt4Zw0yvd8lePSMQ: calls $0.15
jp34e617tIzV8tKIWmfAbA: raises $0.50 to $0.75
6elpmfyt4Zw0yvd8lePSMQ: calls $0.50
*** FLOP *** [Kh Qc 4h]
6elpmfyt4Zw0yvd8lePSMQ: checks 
jp34e617tIzV8tKIWmfAbA: bets $1
6elpmfyt4Zw0yvd8lePSMQ: calls $1
*** TURN *** [Kh Qc 4h] [Ks]
6elpmfyt4Zw0yvd8lePSMQ: checks 
jp34e617tIzV8tKIWmfAbA: bets $2.25
6elpmfyt4Zw0yvd8lePSMQ: folds 
Uncalled bet ($2.25) returned to jp34e617tIzV8tKIWmfAbA
jp34e617tIzV8tKIWmfAbA collected $3.35 from pot
jp34e617tIzV8tKIWmfAbA: doesn't show hand 
*** SUMMARY ***
Total pot $3.50 | Rake $0.15 
Board [Kh Qc 4h Ks]
Seat 1: kwsRmpZ1ZaLooISs+zfyKg (button) folded before Flop (didn't bet)
Seat 2: 6elpmfyt4Zw0yvd8lePSMQ (small blind) folded on the Turn
Seat 3: jp34e617tIzV8tKIWmfAbA (big blind) collected ($3.35)
Seat 4: DFi/Lzkjsfv8QswS80JX9Q folded before Flop (didn't bet)
Seat 5: lquriepNQBhDV5P1SWHhnA folded before Flop (didn't bet)
Seat 6: GbCVUNssQ7mqsPWr7J4d3w folded before Flop (didn't bet)




PokerStars Game #59941642522:  Hold'em No Limit ($0.10/$0.25) - 2009/07/01 1:41:37 ET
Table '2clPgY3+dETPD/8zjXZdFw' 6-max Seat #2 is the button
Seat 1: 4WFKzsjLSGnvHbVxKabsvQ ($29.45 in chips) 
Seat 2: cWc85bEzdRzpUMhRKm8pwQ ($25 in chips) 
Seat 3: SFmT9ZsVopnukjvAzrxTRg ($25 in chips) 
Seat 4: ljjhtb6FVPTx9AT9HNdtqg ($18.65 in chips) 
Seat 5: LJI7A1YgDM7hgh7o56+ReQ ($25 in chips) 
Seat 6: 2G0C7dp4wlPpE21FHjjElQ ($27.25 in chips) 
SFmT9ZsVopnukjvAzrxTRg: posts small blind $0.10
ljjhtb6FVPTx9AT9HNdtqg: posts big blind $0.25
*** HOLE CARDS ***
LJI7A1YgDM7hgh7o56+ReQ: folds 
2G0C7dp4wlPpE21FHjjElQ: folds 
4WFKzsjLSGnvHbVxKabsvQ: folds 
cWc85bEzdRzpUMhRKm8pwQ: raises $0.75 to $1
SFmT9ZsVopnukjvAzrxTRg: folds 
ljjhtb6FVPTx9AT9HNdtqg: folds 
Uncalled bet ($0.75) returned to cWc85bEzdRzpUMhRKm8pwQ
cWc85bEzdRzpUMhRKm8pwQ collected $0.60 from pot
*** SUMMARY ***
Total pot $0.60 | Rake $0 
Seat 1: 4WFKzsjLSGnvHbVxKabsvQ folded before Flop (didn't bet)
Seat 2: cWc85bEzdRzpUMhRKm8pwQ (button) collected ($0.60)
Seat 3: SFmT9ZsVopnukjvAzrxTRg (small blind) folded before Flop
Seat 4: ljjhtb6FVPTx9AT9HNdtqg (big blind) folded before Flop
Seat 5: LJI7A1YgDM7hgh7o56+ReQ folded before Flop (didn't bet)
Seat 6: 2G0C7dp4wlPpE21FHjjElQ folded before Flop (didn't bet)




PokerStars Game #59941642562:  Hold'em No Limit ($0.10/$0.25) - 2009/07/01 1:41:37 ET
Table 'C8mMnVmvkagwolEzTvh07A' 9-max Seat #2 is the button
Seat 1: PqvgxdSg9z5VmrWpbYuz+g ($25.70 in chips) 
Seat 2: Bb42QRQMhg5/Y0vHP8/2Xw ($25 in chips) 
Seat 3: Th3FldXKQW6hWVVPahaoOQ ($35.45 in chips) 
Seat 4: dfNim92Z6XK1/h5SFW5vDg ($25 in chips) 
Seat 5: iGMlK+EhUflPB6jKQd95Cg ($27.85 in chips) 
Seat 7: qmEgnPhQt24xdw/ZRVPLbA ($46.95 in chips) 
Seat 9: 4awUyiDYTgylQKXZ9faBVA ($25 in chips) 
Th3FldXKQW6hWVVPahaoOQ: posts small blind $0.10
dfNim92Z6XK1/h5SFW5vDg: posts big blind $0.25
AiXn/9o1EwOPZUHujnh/bA: sits out 
*** HOLE CARDS ***
iGMlK+EhUflPB6jKQd95Cg: folds 
qmEgnPhQt24xdw/ZRVPLbA: raises $1 to $1.25
4awUyiDYTgylQKXZ9faBVA: folds 
PqvgxdSg9z5VmrWpbYuz+g: folds 
Bb42QRQMhg5/Y0vHP8/2Xw: folds 
Th3FldXKQW6hWVVPahaoOQ: folds 
dfNim92Z6XK1/h5SFW5vDg: folds 
Uncalled bet ($1) returned to qmEgnPhQt24xdw/ZRVPLbA
qmEgnPhQt24xdw/ZRVPLbA collected $0.60 from pot
qmEgnPhQt24xdw/ZRVPLbA: doesn't show hand 
*** SUMMARY ***
Total pot $0.60 | Rake $0 
Seat 1: PqvgxdSg9z5VmrWpbYuz+g folded before Flop (didn't bet)
Seat 2: Bb42QRQMhg5/Y0vHP8/2Xw (button) folded before Flop (didn't bet)
Seat 3: Th3FldXKQW6hWVVPahaoOQ (small blind) folded before Flop
Seat 4: dfNim92Z6XK1/h5SFW5vDg (big blind) folded before Flop
Seat 5: iGMlK+EhUflPB6jKQd95Cg folded before Flop (didn't bet)
Seat 7: qmEgnPhQt24xdw/ZRVPLbA collected ($0.60)
Seat 9: 4awUyiDYTgylQKXZ9faBVA folded before Flop (didn't bet)




PokerStars Game #59941642386:  Hold'em No Limit ($0.10/$0.25) - 2009/07/01 1:41:37 ET
Table '0mmHveGuaIfIMQlNE1eqMg' 9-max Seat #2 is the button
Seat 1: ydoFOVgzvZv9ZhuWu9rXAw ($5 in chips) 
Seat 2: rQhYIYXSyH/IivYM1dlV5A ($68.15 in chips) 
Seat 3: ghNKXUBl/H+t83JF079ZBA ($25.10 in chips) 
Seat 4: DnDcAdn9P0zGovMERigpFA ($35.35 in chips) 
Seat 5: Pt637jKksB5MzP0UNJAAkw ($9.20 in chips) 
Seat 6: 6RiVTYll/5D8zICp0MRpKw ($24.20 in chips) 
Seat 9: UNw/UrAelsQeSS17Rro/BA ($11.15 in chips) 
ghNKXUBl/H+t83JF079ZBA: posts small blind $0.10
DnDcAdn9P0zGovMERigpFA: posts big blind $0.25
5n7e7I+px7c6CQmLpPbtsg: sits out 
0XACOSNrAWmqNv9k1nF8rw: sits out 
*** HOLE CARDS ***
Pt637jKksB5MzP0UNJAAkw: folds 
6RiVTYll/5D8zICp0MRpKw: folds 
UNw/UrAelsQeSS17Rro/BA: folds 
ydoFOVgzvZv9ZhuWu9rXAw: folds 
rQhYIYXSyH/IivYM1dlV5A: raises $0.50 to $0.75
ghNKXUBl/H+t83JF079ZBA: folds 
DnDcAdn9P0zGovMERigpFA: folds 
Uncalled bet ($0.50) returned to rQhYIYXSyH/IivYM1dlV5A
rQhYIYXSyH/IivYM1dlV5A collected $0.60 from pot
*** SUMMARY ***
Total pot $0.60 | Rake $0 
Seat 1: ydoFOVgzvZv9ZhuWu9rXAw folded before Flop (didn't bet)
Seat 2: rQhYIYXSyH/IivYM1dlV5A (button) collected ($0.60)
Seat 3: ghNKXUBl/H+t83JF079ZBA (small blind) folded before Flop
Seat 4: DnDcAdn9P0zGovMERigpFA (big blind) folded before Flop
Seat 5: Pt637jKksB5MzP0UNJAAkw folded before Flop (didn't bet)
Seat 6: 6RiVTYll/5D8zICp0MRpKw folded before Flop (didn't bet)
Seat 9: UNw/UrAelsQeSS17Rro/BA folded before Flop (didn't bet)




PokerStars Game #59941642914:  Hold'em No Limit ($0.10/$0.25) - 2009/07/01 1:41:38 ET
Table 'IRgQPZVA4+IaZZIQshgwyg' 6-max Seat #2 is the button
Seat 1: cezpHJ8FB07dj0xG+LhOvw ($27.90 in chips) 
Seat 2: lquriepNQBhDV5P1SWHhnA ($25 in chips) 
Seat 3: DihMHaz4WNETH1bPDe13kA ($28.55 in chips) 
Seat 4: DE9hRlt14g+JdsRQ4wT7hg ($27.50 in chips) 
Seat 5: PbMzPZIePKifKQZfKDkbIw ($29.20 in chips) 
Seat 6: XbIIdTtuN1xO7zurECHBTg ($11.60 in chips) 
DihMHaz4WNETH1bPDe13kA: posts small blind $0.10
DE9hRlt14g+JdsRQ4wT7hg: posts big blind $0.25
*** HOLE CARDS ***
PbMzPZIePKifKQZfKDkbIw: folds 
XbIIdTtuN1xO7zurECHBTg: raises $0.50 to $0.75
cezpHJ8FB07dj0xG+LhOvw: folds 
lquriepNQBhDV5P1SWHhnA: folds 
DihMHaz4WNETH1bPDe13kA: folds 
DE9hRlt14g+JdsRQ4wT7hg: folds 
Uncalled bet ($0.50) returned to XbIIdTtuN1xO7zurECHBTg
XbIIdTtuN1xO7zurECHBTg collected $0.60 from pot
XbIIdTtuN1xO7zurECHBTg: doesn't show hand 
*** SUMMARY ***
Total pot $0.60 | Rake $0 
Seat 1: cezpHJ8FB07dj0xG+LhOvw folded before Flop (didn't bet)
Seat 2: lquriepNQBhDV5P1SWHhnA (button) folded before Flop (didn't bet)
Seat 3: DihMHaz4WNETH1bPDe13kA (small blind) folded before Flop
Seat 4: DE9hRlt14g+JdsRQ4wT7hg (big blind) folded before Flop
Seat 5: PbMzPZIePKifKQZfKDkbIw folded before Flop (didn't bet)
Seat 6: XbIIdTtuN1xO7zurECHBTg collected ($0.60)




PokerStars Game #59941643096:  Hold'em No Limit ($0.10/$0.25) - 2009/07/01 1:41:38 ET
Table 'rjcb+nlE+0GuJ6lBhuCkkA' 6-max Seat #4 is the button
Seat 1: lBoEwOFgzcERLIRUkUoRTw ($13.95 in chips) 
Seat 2: lJphax9e7/+O/3YCKPJ0yQ ($4.15 in chips) 
Seat 3: 8ClCHtFXGNplITm+63KB+Q ($66.50 in chips) 
Seat 4: BV+K0Phf5VBHr7aZPKqbUQ ($25.85 in chips) 
Seat 5: GC/9yVD59DUCX7hUI7gcLw ($41.85 in chips) 
Seat 6: 32YL2ZEp8NT4JB2RVM9euQ ($16 in chips) 
GC/9yVD59DUCX7hUI7gcLw: posts small blind $0.10
32YL2ZEp8NT4JB2RVM9euQ: posts big blind $0.25
*** HOLE CARDS ***
lBoEwOFgzcERLIRUkUoRTw: folds 
lJphax9e7/+O/3YCKPJ0yQ: calls $0.25
8ClCHtFXGNplITm+63KB+Q: folds 
BV+K0Phf5VBHr7aZPKqbUQ: raises $0.50 to $0.75
GC/9yVD59DUCX7hUI7gcLw: folds 
32YL2ZEp8NT4JB2RVM9euQ: folds 
lJphax9e7/+O/3YCKPJ0yQ: calls $0.50
*** FLOP *** [As 5s Ks]
lJphax9e7/+O/3YCKPJ0yQ: bets $0.50
BV+K0Phf5VBHr7aZPKqbUQ: calls $0.50
*** TURN *** [As 5s Ks] [7s]
lJphax9e7/+O/3YCKPJ0yQ: bets $1
BV+K0Phf5VBHr7aZPKqbUQ: folds 
Uncalled bet ($1) returned to lJphax9e7/+O/3YCKPJ0yQ
lJphax9e7/+O/3YCKPJ0yQ collected $2.75 from pot
*** SUMMARY ***
Total pot $2.85 | Rake $0.10 
Board [As 5s Ks 7s]
Seat 1: lBoEwOFgzcERLIRUkUoRTw folded before Flop (didn't bet)
Seat 2: lJphax9e7/+O/3YCKPJ0yQ collected ($2.75)
Seat 3: 8ClCHtFXGNplITm+63KB+Q folded before Flop (didn't bet)
Seat 4: BV+K0Phf5VBHr7aZPKqbUQ (button) folded on the Turn
Seat 5: GC/9yVD59DUCX7hUI7gcLw (small blind) folded before Flop
Seat 6: 32YL2ZEp8NT4JB2RVM9euQ (big blind) folded before Flop




PokerStars Game #59941643280:  Hold'em No Limit ($0.10/$0.25) - 2009/07/01 1:41:38 ET
Table 'KYX9dFNuOA9l2PV46IebqQ' 9-max Seat #7 is the button
Seat 5: g7MXhRmNZxv1lIkKkUKa4w ($15 in chips) 
Seat 7: dtZ84flFEi4Q+SGrHMJRDQ ($25.50 in chips) 
dtZ84flFEi4Q+SGrHMJRDQ: posts small blind $0.10
g7MXhRmNZxv1lIkKkUKa4w: posts big blind $0.25
*** HOLE CARDS ***
z2SmIaQ3+5n/eY1BN5HgPg joins the table at seat #2 
dtZ84flFEi4Q+SGrHMJRDQ: folds 
Uncalled bet ($0.15) returned to g7MXhRmNZxv1lIkKkUKa4w
dtZ84flFEi4Q+SGrHMJRDQ leaves the table
g7MXhRmNZxv1lIkKkUKa4w collected $0.20 from pot
g7MXhRmNZxv1lIkKkUKa4w: doesn't show hand 
*** SUMMARY ***
Total pot $0.20 | Rake $0 
Seat 5: g7MXhRmNZxv1lIkKkUKa4w (big blind) collected ($0.20)
Seat 7: dtZ84flFEi4Q+SGrHMJRDQ (button) (small blind) folded before Flop




PokerStars Game #59941643048:  Hold'em No Limit ($0.10/$0.25) - 2009/07/01 1:41:38 ET
Table 'zKwHJD0cmKNUure9qQTfFg' 6-max Seat #2 is the button
Seat 1: RXYRBsbRgZxcivyqSdOo3A ($3.90 in chips) 
Seat 2: xrf8tAXKQHG99HixCot1Iw ($26.55 in chips) 
Seat 3: 60PLIlpucQhA08L3YbNmag ($5.35 in chips) 
Seat 4: v+QfkGiuj9bgtuNoVnDO8w ($26.15 in chips) 
Seat 6: edio/rLJ06xeZOfLhoL3UA ($11.55 in chips) 
60PLIlpucQhA08L3YbNmag: posts small blind $0.10
v+QfkGiuj9bgtuNoVnDO8w: posts big blind $0.25
*** HOLE CARDS ***
edio/rLJ06xeZOfLhoL3UA: raises $1 to $1.25
E4AqQ1egsnu0oH2RqsbCmQ has returned
RXYRBsbRgZxcivyqSdOo3A: raises $2.65 to $3.90 and is all-in
xrf8tAXKQHG99HixCot1Iw: folds 
60PLIlpucQhA08L3YbNmag: calls $3.80
v+QfkGiuj9bgtuNoVnDO8w: folds 
edio/rLJ06xeZOfLhoL3UA: calls $2.65
*** FLOP *** [Qs 3s 6c]
60PLIlpucQhA08L3YbNmag: bets $1.45 and is all-in
edio/rLJ06xeZOfLhoL3UA: calls $1.45
*** TURN *** [Qs 3s 6c] [5d]
*** RIVER *** [Qs 3s 6c 5d] [Ah]
*** SHOW DOWN ***
60PLIlpucQhA08L3YbNmag: shows [As Jd] (a pair of Aces)
edio/rLJ06xeZOfLhoL3UA: mucks hand 
60PLIlpucQhA08L3YbNmag collected $2.75 from side pot
RXYRBsbRgZxcivyqSdOo3A: shows [Kh Ks] (a pair of Kings)
60PLIlpucQhA08L3YbNmag collected $11.40 from main pot
*** SUMMARY ***
Total pot $14.85 Main pot $11.40. Side pot $2.75. | Rake $0.70 
Board [Qs 3s 6c 5d Ah]
Seat 1: RXYRBsbRgZxcivyqSdOo3A showed [Kh Ks] and lost with a pair of Kings
Seat 2: xrf8tAXKQHG99HixCot1Iw (button) folded before Flop (didn't bet)
Seat 3: 60PLIlpucQhA08L3YbNmag (small blind) showed [As Jd] and won ($14.15) with a pair of Aces
Seat 4: v+QfkGiuj9bgtuNoVnDO8w (big blind) folded before Flop
Seat 6: edio/rLJ06xeZOfLhoL3UA mucked




PokerStars Game #59941643438:  Hold'em No Limit ($0.10/$0.25) - 2009/07/01 1:41:39 ET
Table 'GgmUtmhrYPRnhkqEEjD/Kw' 9-max Seat #9 is the button
Seat 2: ghNKXUBl/H+t83JF079ZBA ($25.25 in chips) 
Seat 3: dYvYZ723QlKIPiDa0pkedQ ($7.05 in chips) 
Seat 4: dfNim92Z6XK1/h5SFW5vDg ($25 in chips) 
Seat 5: ljemhp25Zg+nlA9DLCIiUw ($27 in chips) 
Seat 6: 4Ax0vobe1rLVIGZmkFINGA ($20.50 in chips) 
Seat 7: YwDw9cMqkbMznFK77rru4A ($5.40 in chips) 
Seat 8: DdPXdieucQ+n99u1n3A+rQ ($4.65 in chips) 
Seat 9: V6p0jQ/RhUsqpHLmXvEX4Q ($13.95 in chips) 
sGFnnRCa1YAHAUmWgsW6Qg: is sitting out 
sGFnnRCa1YAHAUmWgsW6Qg leaves the table
ghNKXUBl/H+t83JF079ZBA: posts small blind $0.10
dYvYZ723QlKIPiDa0pkedQ: posts big blind $0.25
*** HOLE CARDS ***
dfNim92Z6XK1/h5SFW5vDg: folds 
ljemhp25Zg+nlA9DLCIiUw: folds 
4Ax0vobe1rLVIGZmkFINGA: folds 
YwDw9cMqkbMznFK77rru4A: calls $0.25
DdPXdieucQ+n99u1n3A+rQ: folds 
V6p0jQ/RhUsqpHLmXvEX4Q: folds 
bXpVeaSTPBFSPJmeXxO7nw joins the table at seat #1 
ghNKXUBl/H+t83JF079ZBA: folds 
dYvYZ723QlKIPiDa0pkedQ: checks 
*** FLOP *** [6h 7h 5d]
dYvYZ723QlKIPiDa0pkedQ: checks 
YwDw9cMqkbMznFK77rru4A: checks 
*** TURN *** [6h 7h 5d] [4d]
dYvYZ723QlKIPiDa0pkedQ: checks 
YwDw9cMqkbMznFK77rru4A: checks 
*** RIVER *** [6h 7h 5d 4d] [7c]
dYvYZ723QlKIPiDa0pkedQ: checks 
YwDw9cMqkbMznFK77rru4A: checks 
*** SHOW DOWN ***
dYvYZ723QlKIPiDa0pkedQ: shows [Qs 6d] (two pair, Sevens and Sixes)
YwDw9cMqkbMznFK77rru4A: mucks hand 
dYvYZ723QlKIPiDa0pkedQ collected $0.60 from pot
*** SUMMARY ***
Total pot $0.60 | Rake $0 
Board [6h 7h 5d 4d 7c]
Seat 2: ghNKXUBl/H+t83JF079ZBA (small blind) folded before Flop
Seat 3: dYvYZ723QlKIPiDa0pkedQ (big blind) showed [Qs 6d] and won ($0.60) with two pair, Sevens and Sixes
Seat 4: dfNim92Z6XK1/h5SFW5vDg folded before Flop (didn't bet)
Seat 5: ljemhp25Zg+nlA9DLCIiUw folded before Flop (didn't bet)
Seat 6: 4Ax0vobe1rLVIGZmkFINGA folded before Flop (didn't bet)
Seat 7: YwDw9cMqkbMznFK77rru4A mucked
Seat 8: DdPXdieucQ+n99u1n3A+rQ folded before Flop (didn't bet)
Seat 9: V6p0jQ/RhUsqpHLmXvEX4Q (button) folded before Flop (didn't bet)




PokerStars Game #59941643822:  Hold'em No Limit ($0.10/$0.25) - 2009/07/01 1:41:39 ET
Table 'AchTjdLS1zBUbH3ZIx6f0w' 6-max Seat #5 is the button
Seat 1: rZ0bUtoerhFGDUSRQMnFog ($28.60 in chips) 
Seat 2: kG34n23qFQA3nzdOJTQ1dA ($66.25 in chips) 
Seat 3: k9vn40MOqqb+xF+7GZ6v2g ($28.20 in chips) 
Seat 4: q6WfTUAD9mowIP63ASq2Dg ($30.90 in chips) 
Seat 5: 0av6tRNdi0Ui4f15L7gsVg ($26 in chips) 
rZ0bUtoerhFGDUSRQMnFog: posts small blind $0.10
kG34n23qFQA3nzdOJTQ1dA: posts big blind $0.25
*** HOLE CARDS ***
k9vn40MOqqb+xF+7GZ6v2g: folds 
q6WfTUAD9mowIP63ASq2Dg: folds 
0av6tRNdi0Ui4f15L7gsVg: raises $0.50 to $0.75
rZ0bUtoerhFGDUSRQMnFog: folds 
kG34n23qFQA3nzdOJTQ1dA: folds 
Uncalled bet ($0.50) returned to 0av6tRNdi0Ui4f15L7gsVg
0av6tRNdi0Ui4f15L7gsVg collected $0.60 from pot
0av6tRNdi0Ui4f15L7gsVg: doesn't show hand 
mFv3iBCtrw9XfCDRB0d46Q leaves the table
*** SUMMARY ***
Total pot $0.60 | Rake $0 
Seat 1: rZ0bUtoerhFGDUSRQMnFog (small blind) folded before Flop
Seat 2: kG34n23qFQA3nzdOJTQ1dA (big blind) folded before Flop
Seat 3: k9vn40MOqqb+xF+7GZ6v2g folded before Flop (didn't bet)
Seat 4: q6WfTUAD9mowIP63ASq2Dg folded before Flop (didn't bet)
Seat 5: 0av6tRNdi0Ui4f15L7gsVg (button) collected ($0.60)




PokerStars Game #59941643676:  Hold'em No Limit ($0.10/$0.25) - 2009/07/01 1:41:39 ET
Table 'rpIHGyt2QpgQc5bvptAvDQ' 9-max Seat #7 is the button
Seat 2: FX0yWp7Ul3dMebXB0cFjEw ($5 in chips) 
Seat 4: ASXDkj9tmvF/T2AsNuxg7g ($6.95 in chips) 
Seat 6: Mq1ESwxx3LEsA4HjKKjU3Q ($20.25 in chips) 
Seat 7: GHgIdzlzMAmRmmX7jgXtuQ ($5 in chips) 
FX0yWp7Ul3dMebXB0cFjEw: posts small blind $0.10
ASXDkj9tmvF/T2AsNuxg7g: posts big blind $0.25
*** HOLE CARDS ***
Mq1ESwxx3LEsA4HjKKjU3Q: folds 
GHgIdzlzMAmRmmX7jgXtuQ: folds 
FX0yWp7Ul3dMebXB0cFjEw: calls $0.15
ASXDkj9tmvF/T2AsNuxg7g: checks 
*** FLOP *** [5h 6d 7c]
FX0yWp7Ul3dMebXB0cFjEw: checks 
ASXDkj9tmvF/T2AsNuxg7g: bets $0.50
FX0yWp7Ul3dMebXB0cFjEw: calls $0.50
*** TURN *** [5h 6d 7c] [4c]
FX0yWp7Ul3dMebXB0cFjEw: checks 
ASXDkj9tmvF/T2AsNuxg7g: checks 
*** RIVER *** [5h 6d 7c 4c] [Ah]
FX0yWp7Ul3dMebXB0cFjEw: bets $0.75
ASXDkj9tmvF/T2AsNuxg7g: folds 
Uncalled bet ($0.75) returned to FX0yWp7Ul3dMebXB0cFjEw
FX0yWp7Ul3dMebXB0cFjEw collected $1.45 from pot
*** SUMMARY ***
Total pot $1.50 | Rake $0.05 
Board [5h 6d 7c 4c Ah]
Seat 2: FX0yWp7Ul3dMebXB0cFjEw (small blind) collected ($1.45)
Seat 4: ASXDkj9tmvF/T2AsNuxg7g (big blind) folded on the River
Seat 6: Mq1ESwxx3LEsA4HjKKjU3Q folded before Flop (didn't bet)
Seat 7: GHgIdzlzMAmRmmX7jgXtuQ (button) folded before Flop (didn't bet)




PokerStars Game #59941643760:  Hold'em No Limit ($0.10/$0.25) - 2009/07/01 1:41:39 ET
Table 'sDHjMRwfSiz7+NDdZLUiyA' 9-max Seat #2 is the button
Seat 1: VGwr1eqhvdUtMfBFCvBnmg ($8.50 in chips) 
Seat 2: ljemhp25Zg+nlA9DLCIiUw ($26.75 in chips) 
Seat 3: SGA1WpAnQxFdFAYyt362gQ ($18.15 in chips) 
Seat 4: eK8qa6EPcH2zhtbmWSvc9g ($25.45 in chips) 
Seat 5: IGRfskE1v9H9Bn+fz8AgNQ ($37.40 in chips) 
Seat 6: 1qa0qHOCKZM3Uipx9DxYtQ ($14 in chips) 
Seat 7: K0b5wNInj6hUGRr6yzKFtw ($37.65 in chips) 
Seat 8: 3hMkm4U5yTRrkGJkxfijaQ ($5.15 in chips) 
Seat 9: 3PmVnC/15cl4oyI1TKIt4g ($4.30 in chips) 
SGA1WpAnQxFdFAYyt362gQ: posts small blind $0.10
eK8qa6EPcH2zhtbmWSvc9g: posts big blind $0.25
*** HOLE CARDS ***
IGRfskE1v9H9Bn+fz8AgNQ: folds 
1qa0qHOCKZM3Uipx9DxYtQ: raises $0.25 to $0.50
K0b5wNInj6hUGRr6yzKFtw: folds 
3hMkm4U5yTRrkGJkxfijaQ: calls $0.50
3PmVnC/15cl4oyI1TKIt4g: folds 
VGwr1eqhvdUtMfBFCvBnmg: folds 
ljemhp25Zg+nlA9DLCIiUw: folds 
SGA1WpAnQxFdFAYyt362gQ: folds 
eK8qa6EPcH2zhtbmWSvc9g: calls $0.25
*** FLOP *** [2s Jd 9s]
eK8qa6EPcH2zhtbmWSvc9g: checks 
1qa0qHOCKZM3Uipx9DxYtQ: bets $0.75
3hMkm4U5yTRrkGJkxfijaQ: calls $0.75
eK8qa6EPcH2zhtbmWSvc9g: folds 
*** TURN *** [2s Jd 9s] [8d]
1qa0qHOCKZM3Uipx9DxYtQ: bets $0.75
3hMkm4U5yTRrkGJkxfijaQ: calls $0.75
*** RIVER *** [2s Jd 9s 8d] [Kh]
1qa0qHOCKZM3Uipx9DxYtQ: bets $1.50
3hMkm4U5yTRrkGJkxfijaQ: folds 
Uncalled bet ($1.50) returned to 1qa0qHOCKZM3Uipx9DxYtQ
1qa0qHOCKZM3Uipx9DxYtQ collected $4.40 from pot
1qa0qHOCKZM3Uipx9DxYtQ: doesn't show hand 
*** SUMMARY ***
Total pot $4.60 | Rake $0.20 
Board [2s Jd 9s 8d Kh]
Seat 1: VGwr1eqhvdUtMfBFCvBnmg folded before Flop (didn't bet)
Seat 2: ljemhp25Zg+nlA9DLCIiUw (button) folded before Flop (didn't bet)
Seat 3: SGA1WpAnQxFdFAYyt362gQ (small blind) folded before Flop
Seat 4: eK8qa6EPcH2zhtbmWSvc9g (big blind) folded on the Flop
Seat 5: IGRfskE1v9H9Bn+fz8AgNQ folded before Flop (didn't bet)
Seat 6: 1qa0qHOCKZM3Uipx9DxYtQ collected ($4.40)
Seat 7: K0b5wNInj6hUGRr6yzKFtw folded before Flop (didn't bet)
Seat 8: 3hMkm4U5yTRrkGJkxfijaQ folded on the River
Seat 9: 3PmVnC/15cl4oyI1TKIt4g folded before Flop (didn't bet)




PokerStars Game #59941643952:  Hold'em No Limit ($0.10/$0.25) - 2009/07/01 1:41:39 ET
Table 'bIGKmJgZehWJ+FAo8b85iw' 9-max Seat #7 is the button
Seat 1: yyG4svzOpC1A+sUP/scg6w ($14.70 in chips) 
Seat 2: cCjRCvseA9rZn7Xr+GCCHg ($21.70 in chips) 
Seat 3: /FyMUX+W/tpNFcRWbUTJxQ ($10.80 in chips) 
Seat 4: LGxBRjCRn6KlQ/6B4eoXbA ($10 in chips) 
Seat 5: uLP/lYn7oKq9xCChBXsXxw ($25.25 in chips) 
Seat 6: PFNLAvMkr8qKc7xCiH0wTA ($18.85 in chips) 
Seat 7: HDDm1BkZtdsRyw2DJdqq6A ($31.50 in chips) 
Seat 8: +2kMBNpY4nF1qNCRd8SJLA ($55.05 in chips) 
Seat 9: aNpwfA31EREwO+ar4XzBCw ($32.10 in chips) 
+2kMBNpY4nF1qNCRd8SJLA: posts small blind $0.10
aNpwfA31EREwO+ar4XzBCw: posts big blind $0.25
*** HOLE CARDS ***
yyG4svzOpC1A+sUP/scg6w: folds 
cCjRCvseA9rZn7Xr+GCCHg: folds 
/FyMUX+W/tpNFcRWbUTJxQ: folds 
LGxBRjCRn6KlQ/6B4eoXbA: raises $9.75 to $10 and is all-in
uLP/lYn7oKq9xCChBXsXxw: folds 
PFNLAvMkr8qKc7xCiH0wTA: folds 
HDDm1BkZtdsRyw2DJdqq6A: calls $10
+2kMBNpY4nF1qNCRd8SJLA: folds 
aNpwfA31EREwO+ar4XzBCw: folds 
*** FLOP *** [4c 7c 9d]
*** TURN *** [4c 7c 9d] [Td]
*** RIVER *** [4c 7c 9d Td] [6s]
*** SHOW DOWN ***
LGxBRjCRn6KlQ/6B4eoXbA: shows [Jh Ad] (high card Ace)
HDDm1BkZtdsRyw2DJdqq6A: shows [Qs Ks] (high card King)
LGxBRjCRn6KlQ/6B4eoXbA collected $19.35 from pot
*** SUMMARY ***
Total pot $20.35 | Rake $1 
Board [4c 7c 9d Td 6s]
Seat 1: yyG4svzOpC1A+sUP/scg6w folded before Flop (didn't bet)
Seat 2: cCjRCvseA9rZn7Xr+GCCHg folded before Flop (didn't bet)
Seat 3: /FyMUX+W/tpNFcRWbUTJxQ folded before Flop (didn't bet)
Seat 4: LGxBRjCRn6KlQ/6B4eoXbA showed [Jh Ad] and won ($19.35) with high card Ace
Seat 5: uLP/lYn7oKq9xCChBXsXxw folded before Flop (didn't bet)
Seat 6: PFNLAvMkr8qKc7xCiH0wTA folded before Flop (didn't bet)
Seat 7: HDDm1BkZtdsRyw2DJdqq6A (button) showed [Qs Ks] and lost with high card King
Seat 8: +2kMBNpY4nF1qNCRd8SJLA (small blind) folded before Flop
Seat 9: aNpwfA31EREwO+ar4XzBCw (big blind) folded before Flop




PokerStars Game #59941643744:  Hold'em No Limit ($0.10/$0.25) - 2009/07/01 1:41:39 ET
Table 'GxdLtCpYxqT4aAbYqkEEpw' 6-max Seat #4 is the button
Seat 1: 2d/PU00mMdO9azAaXqcSbw ($14.25 in chips) 
Seat 2: 3iomNWHjIokoWh6JNWCUJQ ($3.40 in chips) 
Seat 3: LpmZGzLpOmfZUF7EV4ZlrQ ($16.25 in chips) 
Seat 4: 6wzJiRvp8HY6t+MQGnSIzA ($3.45 in chips) 
Seat 5: q6WfTUAD9mowIP63ASq2Dg ($36.95 in chips) 
Seat 6: DFi/Lzkjsfv8QswS80JX9Q ($25 in chips) 
q6WfTUAD9mowIP63ASq2Dg: posts small blind $0.10
DFi/Lzkjsfv8QswS80JX9Q: posts big blind $0.25
*** HOLE CARDS ***
2d/PU00mMdO9azAaXqcSbw: folds 
3iomNWHjIokoWh6JNWCUJQ: folds 
LpmZGzLpOmfZUF7EV4ZlrQ: folds 
6wzJiRvp8HY6t+MQGnSIzA: raises $0.50 to $0.75
q6WfTUAD9mowIP63ASq2Dg: folds 
DFi/Lzkjsfv8QswS80JX9Q: folds 
Uncalled bet ($0.50) returned to 6wzJiRvp8HY6t+MQGnSIzA
6wzJiRvp8HY6t+MQGnSIzA collected $0.60 from pot
6wzJiRvp8HY6t+MQGnSIzA: doesn't show hand 
*** SUMMARY ***
Total pot $0.60 | Rake $0 
Seat 1: 2d/PU00mMdO9azAaXqcSbw folded before Flop (didn't bet)
Seat 2: 3iomNWHjIokoWh6JNWCUJQ folded before Flop (didn't bet)
Seat 3: LpmZGzLpOmfZUF7EV4ZlrQ folded before Flop (didn't bet)
Seat 4: 6wzJiRvp8HY6t+MQGnSIzA (button) collected ($0.60)
Seat 5: q6WfTUAD9mowIP63ASq2Dg (small blind) folded before Flop
Seat 6: DFi/Lzkjsfv8QswS80JX9Q (big blind) folded before Flop




PokerStars Game #59941643926:  Hold'em No Limit ($0.10/$0.25) - 2009/07/01 1:41:39 ET
Table 'M8kYidAX3ib7pLKW7edFLw' 6-max Seat #6 is the button
Seat 1: jp34e617tIzV8tKIWmfAbA ($25.45 in chips) 
Seat 2: ypmjhffk/YHGc51wgVXUTw ($28.45 in chips) 
Seat 3: cezpHJ8FB07dj0xG+LhOvw ($27.45 in chips) 
Seat 4: Hsvkc0/G2VV78oVmWYXecw ($5.35 in chips) 
Seat 5: bDKopKTvPi3W+PEnYUX3tg ($44.85 in chips) 
Seat 6: NqFoyDgzLwu4dOmSRXnFBA ($19.65 in chips) 
jp34e617tIzV8tKIWmfAbA: posts small blind $0.10
ypmjhffk/YHGc51wgVXUTw: posts big blind $0.25
*** HOLE CARDS ***
cezpHJ8FB07dj0xG+LhOvw: folds 
Hsvkc0/G2VV78oVmWYXecw: folds 
bDKopKTvPi3W+PEnYUX3tg: folds 
NqFoyDgzLwu4dOmSRXnFBA: folds 
jp34e617tIzV8tKIWmfAbA: folds 
Uncalled bet ($0.15) returned to ypmjhffk/YHGc51wgVXUTw
ypmjhffk/YHGc51wgVXUTw collected $0.20 from pot
ypmjhffk/YHGc51wgVXUTw: doesn't show hand 
*** SUMMARY ***
Total pot $0.20 | Rake $0 
Seat 1: jp34e617tIzV8tKIWmfAbA (small blind) folded before Flop
Seat 2: ypmjhffk/YHGc51wgVXUTw (big blind) collected ($0.20)
Seat 3: cezpHJ8FB07dj0xG+LhOvw folded before Flop (didn't bet)
Seat 4: Hsvkc0/G2VV78oVmWYXecw folded before Flop (didn't bet)
Seat 5: bDKopKTvPi3W+PEnYUX3tg folded before Flop (didn't bet)
Seat 6: NqFoyDgzLwu4dOmSRXnFBA (button) folded before Flop (didn't bet)




PokerStars Game #59941643574:  Hold'em No Limit ($0.10/$0.25) - 2009/07/01 1:41:39 ET
Table 'LG9H161ZAHDkOww+ih3Ptg' 6-max Seat #4 is the button
Seat 1: avl8CO/tc0F6eVSiB/KNRA ($25.60 in chips) 
Seat 2: kwsRmpZ1ZaLooISs+zfyKg ($25.45 in chips) 
Seat 3: 5Evvx7UYqXTBuvIc/9s/hA ($16.70 in chips) 
Seat 4: 0C28L4/59aRNtHoBhqTcLg ($59.05 in chips) 
Seat 5: lYjWCpfCxX2kgcHY3v4Yow ($29.40 in chips) 
Seat 6: v8m8XHovI5tqEA9mvplDSw ($27.15 in chips) 
lYjWCpfCxX2kgcHY3v4Yow: posts small blind $0.10
v8m8XHovI5tqEA9mvplDSw: posts big blind $0.25
*** HOLE CARDS ***
avl8CO/tc0F6eVSiB/KNRA: folds 
kwsRmpZ1ZaLooISs+zfyKg: folds 
5Evvx7UYqXTBuvIc/9s/hA: folds 
0C28L4/59aRNtHoBhqTcLg: folds 
lYjWCpfCxX2kgcHY3v4Yow: folds 
Uncalled bet ($0.15) returned to v8m8XHovI5tqEA9mvplDSw
v8m8XHovI5tqEA9mvplDSw collected $0.20 from pot
v8m8XHovI5tqEA9mvplDSw: doesn't show hand 
*** SUMMARY ***
Total pot $0.20 | Rake $0 
Seat 1: avl8CO/tc0F6eVSiB/KNRA folded before Flop (didn't bet)
Seat 2: kwsRmpZ1ZaLooISs+zfyKg folded before Flop (didn't bet)
Seat 3: 5Evvx7UYqXTBuvIc/9s/hA folded before Flop (didn't bet)
Seat 4: 0C28L4/59aRNtHoBhqTcLg (button) folded before Flop (didn't bet)
Seat 5: lYjWCpfCxX2kgcHY3v4Yow (small blind) folded before Flop
Seat 6: v8m8XHovI5tqEA9mvplDSw (big blind) collected ($0.20)




PokerStars Game #59941643692:  Hold'em No Limit ($0.10/$0.25) - 2009/07/01 1:41:39 ET
Table 'Ok3oDLIsTc2+KxPcI0bAOA' 6-max Seat #4 is the button
Seat 1: agQm3ugZ3qSVYNgNu1ddeA ($42.10 in chips) 
Seat 2: wPSNSp4HYtytRMXTu3oPSQ ($25 in chips) 
Seat 3: lquriepNQBhDV5P1SWHhnA ($26.60 in chips) 
Seat 4: LJI7A1YgDM7hgh7o56+ReQ ($38.15 in chips) 
Seat 5: DFi/Lzkjsfv8QswS80JX9Q ($28.35 in chips) 
Seat 6: Hsvkc0/G2VV78oVmWYXecw ($5.30 in chips) 
DFi/Lzkjsfv8QswS80JX9Q: posts small blind $0.10
Hsvkc0/G2VV78oVmWYXecw: posts big blind $0.25
wPSNSp4HYtytRMXTu3oPSQ: posts big blind $0.25
*** HOLE CARDS ***
agQm3ugZ3qSVYNgNu1ddeA: folds 
wPSNSp4HYtytRMXTu3oPSQ: checks 
lquriepNQBhDV5P1SWHhnA: raises $1.25 to $1.50
LJI7A1YgDM7hgh7o56+ReQ: folds 
DFi/Lzkjsfv8QswS80JX9Q: folds 
Hsvkc0/G2VV78oVmWYXecw: folds 
wPSNSp4HYtytRMXTu3oPSQ: calls $1.25
*** FLOP *** [Qd Jd Ks]
wPSNSp4HYtytRMXTu3oPSQ: checks 
lquriepNQBhDV5P1SWHhnA: bets $3
wPSNSp4HYtytRMXTu3oPSQ: calls $3
*** TURN *** [Qd Jd Ks] [2s]
wPSNSp4HYtytRMXTu3oPSQ: checks 
lquriepNQBhDV5P1SWHhnA: bets $6
wPSNSp4HYtytRMXTu3oPSQ: calls $6
*** RIVER *** [Qd Jd Ks 2s] [Qs]
wPSNSp4HYtytRMXTu3oPSQ: checks 
lquriepNQBhDV5P1SWHhnA: checks 
*** SHOW DOWN ***
wPSNSp4HYtytRMXTu3oPSQ: shows [6d 4d] (a pair of Queens)
lquriepNQBhDV5P1SWHhnA: shows [Ad Kh] (two pair, Kings and Queens)
lquriepNQBhDV5P1SWHhnA collected $20.35 from pot
*** SUMMARY ***
Total pot $21.35 | Rake $1 
Board [Qd Jd Ks 2s Qs]
Seat 1: agQm3ugZ3qSVYNgNu1ddeA folded before Flop (didn't bet)
Seat 2: wPSNSp4HYtytRMXTu3oPSQ showed [6d 4d] and lost with a pair of Queens
Seat 3: lquriepNQBhDV5P1SWHhnA showed [Ad Kh] and won ($20.35) with two pair, Kings and Queens
Seat 4: LJI7A1YgDM7hgh7o56+ReQ (button) folded before Flop (didn't bet)
Seat 5: DFi/Lzkjsfv8QswS80JX9Q (small blind) folded before Flop
Seat 6: Hsvkc0/G2VV78oVmWYXecw (big blind) folded before Flop




PokerStars Game #59941643636:  Hold'em No Limit ($0.10/$0.25) - 2009/07/01 1:41:39 ET
Table 'sgdCtiuCu2BDZhyDi6RzTA' 6-max Seat #6 is the button
Seat 1: 3zD3qLXT1bEffAoWGnc7wg ($31.30 in chips) 
Seat 2: XD1i5m5PvBDnRzJaG/vINw ($24.40 in chips) 
Seat 3: eL3+wCBjFGfQ5FMdIZihwA ($26.35 in chips) 
Seat 4: rVKEgilmMX+EkKzDVvhmxA ($9.45 in chips) 
Seat 5: 0tQitW75xfmVWKldYHjmOQ ($3.65 in chips) 
Seat 6: KODslGU8ikCYS0/29dUkhg ($35.35 in chips) 
3zD3qLXT1bEffAoWGnc7wg: posts small blind $0.10
XD1i5m5PvBDnRzJaG/vINw: posts big blind $0.25
*** HOLE CARDS ***
eL3+wCBjFGfQ5FMdIZihwA: folds 
rVKEgilmMX+EkKzDVvhmxA: folds 
0tQitW75xfmVWKldYHjmOQ: folds 
KODslGU8ikCYS0/29dUkhg: calls $0.25
3zD3qLXT1bEffAoWGnc7wg: folds 
XD1i5m5PvBDnRzJaG/vINw: checks 
*** FLOP *** [4s Qc Ac]
XD1i5m5PvBDnRzJaG/vINw: checks 
KODslGU8ikCYS0/29dUkhg: checks 
*** TURN *** [4s Qc Ac] [3h]
XD1i5m5PvBDnRzJaG/vINw: checks 
KODslGU8ikCYS0/29dUkhg: checks 
*** RIVER *** [4s Qc Ac 3h] [Jc]
XD1i5m5PvBDnRzJaG/vINw: checks 
KODslGU8ikCYS0/29dUkhg: checks 
*** SHOW DOWN ***
XD1i5m5PvBDnRzJaG/vINw: shows [Ks 7s] (high card Ace)
KODslGU8ikCYS0/29dUkhg: shows [8c 3c] (a flush, Ace high)
KODslGU8ikCYS0/29dUkhg collected $0.60 from pot
*** SUMMARY ***
Total pot $0.60 | Rake $0 
Board [4s Qc Ac 3h Jc]
Seat 1: 3zD3qLXT1bEffAoWGnc7wg (small blind) folded before Flop
Seat 2: XD1i5m5PvBDnRzJaG/vINw (big blind) showed [Ks 7s] and lost with high card Ace
Seat 3: eL3+wCBjFGfQ5FMdIZihwA folded before Flop (didn't bet)
Seat 4: rVKEgilmMX+EkKzDVvhmxA folded before Flop (didn't bet)
Seat 5: 0tQitW75xfmVWKldYHjmOQ folded before Flop (didn't bet)
Seat 6: KODslGU8ikCYS0/29dUkhg (button) showed [8c 3c] and won ($0.60) with a flush, Ace high




PokerStars Game #59941644342:  Hold'em No Limit ($0.10/$0.25) - 2009/07/01 1:41:40 ET
Table 'i93c3z9RLowvuJTKA2F4Jg' 6-max Seat #2 is the button
Seat 1: tbSZq5LHglyHk61mH9eDBw ($26.40 in chips) 
Seat 2: TSmua8tGK3sTbwi0ynrW9Q ($29.95 in chips) 
Seat 3: v8m8XHovI5tqEA9mvplDSw ($31.40 in chips) 
Seat 4: o86X2Q5GEDU3uP9oj1iFZA ($32.30 in chips) 
Seat 5: lYjWCpfCxX2kgcHY3v4Yow ($36 in chips) 
Seat 6: FpN4KbLjlyRRKiVaQcoLqA ($19 in chips) 
v8m8XHovI5tqEA9mvplDSw: posts small blind $0.10
o86X2Q5GEDU3uP9oj1iFZA: posts big blind $0.25
*** HOLE CARDS ***
lYjWCpfCxX2kgcHY3v4Yow: folds 
FpN4KbLjlyRRKiVaQcoLqA: folds 
tbSZq5LHglyHk61mH9eDBw: calls $0.25
TSmua8tGK3sTbwi0ynrW9Q: raises $0.75 to $1
v8m8XHovI5tqEA9mvplDSw: folds 
o86X2Q5GEDU3uP9oj1iFZA: folds 
tbSZq5LHglyHk61mH9eDBw: calls $0.75
*** FLOP *** [Td 2d Tc]
tbSZq5LHglyHk61mH9eDBw: checks 
TSmua8tGK3sTbwi0ynrW9Q: bets $1.75
tbSZq5LHglyHk61mH9eDBw: calls $1.75
*** TURN *** [Td 2d Tc] [9c]
tbSZq5LHglyHk61mH9eDBw: checks 
TSmua8tGK3sTbwi0ynrW9Q: checks 
*** RIVER *** [Td 2d Tc 9c] [8c]
tbSZq5LHglyHk61mH9eDBw: bets $4
TSmua8tGK3sTbwi0ynrW9Q: folds 
Uncalled bet ($4) returned to tbSZq5LHglyHk61mH9eDBw
tbSZq5LHglyHk61mH9eDBw collected $5.60 from pot
*** SUMMARY ***
Total pot $5.85 | Rake $0.25 
Board [Td 2d Tc 9c 8c]
Seat 1: tbSZq5LHglyHk61mH9eDBw collected ($5.60)
Seat 2: TSmua8tGK3sTbwi0ynrW9Q (button) folded on the River
Seat 3: v8m8XHovI5tqEA9mvplDSw (small blind) folded before Flop
Seat 4: o86X2Q5GEDU3uP9oj1iFZA (big blind) folded before Flop
Seat 5: lYjWCpfCxX2kgcHY3v4Yow folded before Flop (didn't bet)
Seat 6: FpN4KbLjlyRRKiVaQcoLqA folded before Flop (didn't bet)




PokerStars Game #59941644180:  Hold'em No Limit ($0.10/$0.25) - 2009/07/01 1:41:40 ET
Table 'mdub7rJf3Z5tCT9s/+1+Wg' 9-max Seat #4 is the button
Seat 1: cZ99hugmLBj9KhTlc8nCSw ($29.25 in chips) 
Seat 2: 539MC3AwKLWVFwzABc644Q ($9.60 in chips) 
Seat 3: PdIasPkzm2sqZnN41ZRXOg ($5.35 in chips) 
Seat 4: fDGyaQz0cs2s4FOYxkbIHA ($14.85 in chips) 
Seat 5: dfNim92Z6XK1/h5SFW5vDg ($25.35 in chips) 
Seat 6: T/CCwAWe2yhO0c4oHNwicw ($22.45 in chips) 
Seat 7: woe+9KKk+L3pZgMTuHcmog ($16.45 in chips) 
Seat 8: Z9AeOQX3yzuSvKAm/xyovg ($6.75 in chips) 
Seat 9: tYsOBqdU1+x+yFI7zHO7hQ ($36.80 in chips) 
dfNim92Z6XK1/h5SFW5vDg: posts small blind $0.10
T/CCwAWe2yhO0c4oHNwicw: posts big blind $0.25
*** HOLE CARDS ***
woe+9KKk+L3pZgMTuHcmog: folds 
Z9AeOQX3yzuSvKAm/xyovg: folds 
tYsOBqdU1+x+yFI7zHO7hQ: folds 
cZ99hugmLBj9KhTlc8nCSw: folds 
539MC3AwKLWVFwzABc644Q: folds 
PdIasPkzm2sqZnN41ZRXOg: folds 
fDGyaQz0cs2s4FOYxkbIHA: folds 
dfNim92Z6XK1/h5SFW5vDg: folds 
Uncalled bet ($0.15) returned to T/CCwAWe2yhO0c4oHNwicw
T/CCwAWe2yhO0c4oHNwicw collected $0.20 from pot
T/CCwAWe2yhO0c4oHNwicw: doesn't show hand 
*** SUMMARY ***
Total pot $0.20 | Rake $0 
Seat 1: cZ99hugmLBj9KhTlc8nCSw folded before Flop (didn't bet)
Seat 2: 539MC3AwKLWVFwzABc644Q folded before Flop (didn't bet)
Seat 3: PdIasPkzm2sqZnN41ZRXOg folded before Flop (didn't bet)
Seat 4: fDGyaQz0cs2s4FOYxkbIHA (button) folded before Flop (didn't bet)
Seat 5: dfNim92Z6XK1/h5SFW5vDg (small blind) folded before Flop
Seat 6: T/CCwAWe2yhO0c4oHNwicw (big blind) collected ($0.20)
Seat 7: woe+9KKk+L3pZgMTuHcmog folded before Flop (didn't bet)
Seat 8: Z9AeOQX3yzuSvKAm/xyovg folded before Flop (didn't bet)
Seat 9: tYsOBqdU1+x+yFI7zHO7hQ folded before Flop (didn't bet)




PokerStars Game #59941644346:  Hold'em No Limit ($0.10/$0.25) - 2009/07/01 1:41:40 ET
Table 'vud0GB/ZlDCvUFhBFIaTlg' 9-max Seat #1 is the button
Seat 1: DiSvPC2iudwL5j9u6Huyww ($28.50 in chips) 
Seat 2: tLcDklc2rBORNfixyRfVfw ($25 in chips) 
Seat 3: W2YYHvqjaEpRrO7stZkClQ ($4.65 in chips) 
Seat 5: eK8qa6EPcH2zhtbmWSvc9g ($25 in chips) 
Seat 6: gehe91e0IyVT0QU/XBkEyg ($24.90 in chips) 
Seat 7: iG7VeTyBWf6wYNvZpbTcbw ($17.10 in chips) 
Seat 8: Am29qRe4OYkVWs70NjNDBw ($16.10 in chips) 
Seat 9: PdIasPkzm2sqZnN41ZRXOg ($5.35 in chips) 
tLcDklc2rBORNfixyRfVfw: posts small blind $0.10
W2YYHvqjaEpRrO7stZkClQ: posts big blind $0.25
*** HOLE CARDS ***
eK8qa6EPcH2zhtbmWSvc9g: folds 
gehe91e0IyVT0QU/XBkEyg: folds 
iG7VeTyBWf6wYNvZpbTcbw: folds 
Am29qRe4OYkVWs70NjNDBw: folds 
PdIasPkzm2sqZnN41ZRXOg: calls $0.25
DiSvPC2iudwL5j9u6Huyww: folds 
tLcDklc2rBORNfixyRfVfw: folds 
W2YYHvqjaEpRrO7stZkClQ: checks 
*** FLOP *** [Ks 7d 4s]
W2YYHvqjaEpRrO7stZkClQ: checks 
PdIasPkzm2sqZnN41ZRXOg: checks 
*** TURN *** [Ks 7d 4s] [7h]
W2YYHvqjaEpRrO7stZkClQ: checks 
PdIasPkzm2sqZnN41ZRXOg: checks 
*** RIVER *** [Ks 7d 4s 7h] [8h]
W2YYHvqjaEpRrO7stZkClQ: checks 
PdIasPkzm2sqZnN41ZRXOg: checks 
*** SHOW DOWN ***
W2YYHvqjaEpRrO7stZkClQ: shows [2h 9d] (a pair of Sevens)
PdIasPkzm2sqZnN41ZRXOg: shows [Ah Th] (a pair of Sevens - Ace kicker)
PdIasPkzm2sqZnN41ZRXOg collected $0.60 from pot
*** SUMMARY ***
Total pot $0.60 | Rake $0 
Board [Ks 7d 4s 7h 8h]
Seat 1: DiSvPC2iudwL5j9u6Huyww (button) folded before Flop (didn't bet)
Seat 2: tLcDklc2rBORNfixyRfVfw (small blind) folded before Flop
Seat 3: W2YYHvqjaEpRrO7stZkClQ (big blind) showed [2h 9d] and lost with a pair of Sevens
Seat 5: eK8qa6EPcH2zhtbmWSvc9g folded before Flop (didn't bet)
Seat 6: gehe91e0IyVT0QU/XBkEyg folded before Flop (didn't bet)
Seat 7: iG7VeTyBWf6wYNvZpbTcbw folded before Flop (didn't bet)
Seat 8: Am29qRe4OYkVWs70NjNDBw folded before Flop (didn't bet)
Seat 9: PdIasPkzm2sqZnN41ZRXOg showed [Ah Th] and won ($0.60) with a pair of Sevens




PokerStars Game #59941644582:  Hold'em No Limit ($0.10/$0.25) - 2009/07/01 1:41:41 ET
Table '4ZbiE0ZYjzqmgu6+sO1prg' 9-max Seat #7 is the button
Seat 1: eXiRSFoUjkV5taBc4N8rMQ ($8.75 in chips) 
Seat 2: 9lvO/qyU+xrU95Teu1fv0g ($5.55 in chips) 
Seat 3: HPEB+AtKw1+C/cxU0o1ciw ($25.55 in chips) 
Seat 4: w1ukf8uPa4+WH561TtVRxA ($25 in chips) 
Seat 5: +2kMBNpY4nF1qNCRd8SJLA ($43.95 in chips) 
Seat 7: aNpwfA31EREwO+ar4XzBCw ($25.95 in chips) 
Seat 8: cZ99hugmLBj9KhTlc8nCSw ($29.70 in chips) 
Seat 9: RCqMONFrSPSArZh2Jsar/w ($20 in chips) 
cZ99hugmLBj9KhTlc8nCSw: posts small blind $0.10
RCqMONFrSPSArZh2Jsar/w: posts big blind $0.25
*** HOLE CARDS ***
eXiRSFoUjkV5taBc4N8rMQ: folds 
9lvO/qyU+xrU95Teu1fv0g: folds 
HPEB+AtKw1+C/cxU0o1ciw: folds 
w1ukf8uPa4+WH561TtVRxA: folds 
+2kMBNpY4nF1qNCRd8SJLA: folds 
aNpwfA31EREwO+ar4XzBCw: folds 
cZ99hugmLBj9KhTlc8nCSw: folds 
Uncalled bet ($0.15) returned to RCqMONFrSPSArZh2Jsar/w
RCqMONFrSPSArZh2Jsar/w collected $0.20 from pot
RCqMONFrSPSArZh2Jsar/w: doesn't show hand 
*** SUMMARY ***
Total pot $0.20 | Rake $0 
Seat 1: eXiRSFoUjkV5taBc4N8rMQ folded before Flop (didn't bet)
Seat 2: 9lvO/qyU+xrU95Teu1fv0g folded before Flop (didn't bet)
Seat 3: HPEB+AtKw1+C/cxU0o1ciw folded before Flop (didn't bet)
Seat 4: w1ukf8uPa4+WH561TtVRxA folded before Flop (didn't bet)
Seat 5: +2kMBNpY4nF1qNCRd8SJLA folded before Flop (didn't bet)
Seat 7: aNpwfA31EREwO+ar4XzBCw (button) folded before Flop (didn't bet)
Seat 8: cZ99hugmLBj9KhTlc8nCSw (small blind) folded before Flop
Seat 9: RCqMONFrSPSArZh2Jsar/w (big blind) collected ($0.20)




PokerStars Game #59941644614:  Hold'em No Limit ($0.10/$0.25) - 2009/07/01 1:41:41 ET
Table 'nc6OeGk/wtaWV+6N+kgnZQgZetDqJh6q9A3mLO3ThCsASeat #3 is the button
Seat 1: DihMHaz4WNETH1bPDe13kA ($26.65 in chips) 
Seat 2: JFIAqU8lCZ0vWwEl4bdGsg ($33.05 in chips) 
Seat 3: jp34e617tIzV8tKIWmfAbA ($32.80 in chips) 
Seat 4: BV+K0Phf5VBHr7aZPKqbUQ ($29.10 in chips) 
BV+K0Phf5VBHr7aZPKqbUQ: posts small blind $0.10
8tR2s7yV/Fr0ePp1w5XnJw: is sitting out 
DihMHaz4WNETH1bPDe13kA: posts big blind $0.25
*** HOLE CARDS ***
8tR2s7yV/Fr0ePp1w5XnJw leaves the table
JFIAqU8lCZ0vWwEl4bdGsg: raises $0.60 to $0.85
jp34e617tIzV8tKIWmfAbA: folds 
BV+K0Phf5VBHr7aZPKqbUQ: folds 
5hAPbqNrvJb8PtLiceXtlgardph joins the table at seat #5 
DihMHaz4WNETH1bPDe13kA: folds 
Uncalled bet ($0.60) returned to JFIAqU8lCZ0vWwEl4bdGsg
JFIAqU8lCZ0vWwEl4bdGsg collected $0.60 from pot
JFIAqU8lCZ0vWwEl4bdGsg: doesn't show hand 
*** SUMMARY ***
Total pot $0.60 | Rake $0 
Seat 1: DihMHaz4WNETH1bPDe13kA (big blind) folded before Flop
Seat 2: JFIAqU8lCZ0vWwEl4bdGsg collected ($0.60)
Seat 3: jp34e617tIzV8tKIWmfAbA (button) folded before Flop (didn't bet)
Seat 4: BV+K0Phf5VBHr7aZPKqbUQ (small blind) folded before Flop




PokerStars Game #59941644790:  Hold'em No Limit ($0.10/$0.25) - 2009/07/01 1:41:41 ET
Table 'U0hCzoS0KCJL+eoE054K4Q' 9-max Seat #6 is the button
Seat 1: XVEauYThJRhSTUAMxB/2ow ($38.45 in chips) 
Seat 2: MG90wfSJZnOejs/KD3vlQQ ($25 in chips) 
Seat 3: 8Cp1H3sSs8+jTTwLfeYKcw ($27.20 in chips) 
Seat 4: Bb42QRQMhg5/Y0vHP8/2Xw ($25.10 in chips) 
Seat 5: zgi+EUykT/pZQpoUG6+oEg ($6 in chips) 
Seat 6: V6p0jQ/RhUsqpHLmXvEX4Q ($11.90 in chips) 
Seat 7: uetHVityNsFnyX2bBnKe2A ($18.45 in chips) 
Seat 8: K0b5wNInj6hUGRr6yzKFtw ($25 in chips) 
Seat 9: wGigCmBR/9XWkPpvYos3aQ ($33.10 in chips) 
uetHVityNsFnyX2bBnKe2A: posts small blind $0.10
K0b5wNInj6hUGRr6yzKFtw: posts big blind $0.25
*** HOLE CARDS ***
wGigCmBR/9XWkPpvYos3aQ: folds 
XVEauYThJRhSTUAMxB/2ow: folds 
MG90wfSJZnOejs/KD3vlQQ: raises $0.50 to $0.75
8Cp1H3sSs8+jTTwLfeYKcw: folds 
Bb42QRQMhg5/Y0vHP8/2Xw: calls $0.75
zgi+EUykT/pZQpoUG6+oEg: folds 
V6p0jQ/RhUsqpHLmXvEX4Q: folds 
uetHVityNsFnyX2bBnKe2A: folds 
K0b5wNInj6hUGRr6yzKFtw: raises $2.25 to $3
MG90wfSJZnOejs/KD3vlQQ: calls $2.25
Bb42QRQMhg5/Y0vHP8/2Xw: folds 
*** FLOP *** [Ts 6s Kd]
K0b5wNInj6hUGRr6yzKFtw: bets $3
MG90wfSJZnOejs/KD3vlQQ: folds 
Uncalled bet ($3) returned to K0b5wNInj6hUGRr6yzKFtw
K0b5wNInj6hUGRr6yzKFtw collected $6.55 from pot
K0b5wNInj6hUGRr6yzKFtw: doesn't show hand 
*** SUMMARY ***
Total pot $6.85 | Rake $0.30 
Board [Ts 6s Kd]
Seat 1: XVEauYThJRhSTUAMxB/2ow folded before Flop (didn't bet)
Seat 2: MG90wfSJZnOejs/KD3vlQQ folded on the Flop
Seat 3: 8Cp1H3sSs8+jTTwLfeYKcw folded before Flop (didn't bet)
Seat 4: Bb42QRQMhg5/Y0vHP8/2Xw folded before Flop
Seat 5: zgi+EUykT/pZQpoUG6+oEg folded before Flop (didn't bet)
Seat 6: V6p0jQ/RhUsqpHLmXvEX4Q (button) folded before Flop (didn't bet)
Seat 7: uetHVityNsFnyX2bBnKe2A (small blind) folded before Flop
Seat 8: K0b5wNInj6hUGRr6yzKFtw (big blind) collected ($6.55)
Seat 9: wGigCmBR/9XWkPpvYos3aQ folded before Flop (didn't bet)




PokerStars Game #59941644820:  Hold'em No Limit ($0.10/$0.25) - 2009/07/01 1:41:41 ET
Table '63uh7ZsO7Tnt+E8b/2bu3A' 6-max Seat #2 is the button
Seat 1: 0av6tRNdi0Ui4f15L7gsVg ($30.90 in chips) 
Seat 2: SFmT9ZsVopnukjvAzrxTRg ($30.95 in chips) 
Seat 3: yVP7GLZBzx47OPi6jzUxMw ($14.10 in chips) 
Seat 4: 2tYgzzRRW/D2GWb2A7f1jw ($6.60 in chips) 
Seat 5: GbCVUNssQ7mqsPWr7J4d3w ($4.75 in chips) 
Seat 6: qGHGf/553gQnDoklMRe3tg ($29 in chips) 
yVP7GLZBzx47OPi6jzUxMw: posts small blind $0.10
2tYgzzRRW/D2GWb2A7f1jw: posts big blind $0.25
*** HOLE CARDS ***
GbCVUNssQ7mqsPWr7J4d3w: folds 
qGHGf/553gQnDoklMRe3tg: folds 
0av6tRNdi0Ui4f15L7gsVg: folds 
SFmT9ZsVopnukjvAzrxTRg: folds 
yVP7GLZBzx47OPi6jzUxMw: calls $0.15
2tYgzzRRW/D2GWb2A7f1jw: checks 
*** FLOP *** [9d Ac 8c]
yVP7GLZBzx47OPi6jzUxMw: bets $0.25
2tYgzzRRW/D2GWb2A7f1jw: folds 
Uncalled bet ($0.25) returned to yVP7GLZBzx47OPi6jzUxMw
yVP7GLZBzx47OPi6jzUxMw collected $0.50 from pot
yVP7GLZBzx47OPi6jzUxMw: doesn't show hand 
*** SUMMARY ***
Total pot $0.50 | Rake $0 
Board [9d Ac 8c]
Seat 1: 0av6tRNdi0Ui4f15L7gsVg folded before Flop (didn't bet)
Seat 2: SFmT9ZsVopnukjvAzrxTRg (button) folded before Flop (didn't bet)
Seat 3: yVP7GLZBzx47OPi6jzUxMw (small blind) collected ($0.50)
Seat 4: 2tYgzzRRW/D2GWb2A7f1jw (big blind) folded on the Flop
Seat 5: GbCVUNssQ7mqsPWr7J4d3w folded before Flop (didn't bet)
Seat 6: qGHGf/553gQnDoklMRe3tg folded before Flop (didn't bet)




PokerStars Game #59941644878:  Hold'em No Limit ($0.10/$0.25) - 2009/07/01 1:41:41 ET
Table 'oJpFwZj9+FUGHX90Un8s9Q' 6-max Seat #4 is the button
Seat 1: 6DwBRH+xZ12AAZmeAg+aXw ($22.95 in chips) 
Seat 2: NtrVQ9UIql0rDCnKDKZ5FQ ($8.30 in chips) 
Seat 3: kyRaCIljYA6l33lSKQfNsg ($24.65 in chips) 
Seat 4: 6elpmfyt4Zw0yvd8lePSMQ ($22.75 in chips) 
Seat 5: kG34n23qFQA3nzdOJTQ1dA ($56.20 in chips) 
Seat 6: edio/rLJ06xeZOfLhoL3UA ($9 in chips) 
kG34n23qFQA3nzdOJTQ1dA: posts small blind $0.10
edio/rLJ06xeZOfLhoL3UA: posts big blind $0.25
*** HOLE CARDS ***
6DwBRH+xZ12AAZmeAg+aXw: folds 
NtrVQ9UIql0rDCnKDKZ5FQ: folds 
kyRaCIljYA6l33lSKQfNsg: folds 
6elpmfyt4Zw0yvd8lePSMQ: raises $0.50 to $0.75
kG34n23qFQA3nzdOJTQ1dA: folds 
edio/rLJ06xeZOfLhoL3UA: folds 
Uncalled bet ($0.50) returned to 6elpmfyt4Zw0yvd8lePSMQ
6elpmfyt4Zw0yvd8lePSMQ collected $0.60 from pot
6elpmfyt4Zw0yvd8lePSMQ: doesn't show hand 
*** SUMMARY ***
Total pot $0.60 | Rake $0 
Seat 1: 6DwBRH+xZ12AAZmeAg+aXw folded before Flop (didn't bet)
Seat 2: NtrVQ9UIql0rDCnKDKZ5FQ folded before Flop (didn't bet)
Seat 3: kyRaCIljYA6l33lSKQfNsg folded before Flop (didn't bet)
Seat 4: 6elpmfyt4Zw0yvd8lePSMQ (button) collected ($0.60)
Seat 5: kG34n23qFQA3nzdOJTQ1dA (small blind) folded before Flop
Seat 6: edio/rLJ06xeZOfLhoL3UA (big blind) folded before Flop




PokerStars Game #59941644858:  Hold'em No Limit ($0.10/$0.25) - 2009/07/01 1:41:41 ET
Table 'Pz8SfAzhP5nvWTsJRAxoDg' 6-max Seat #3 is the button
Seat 1: QiL+lEgEWwy21jk/ltaRLg ($25.95 in chips) 
Seat 2: xrf8tAXKQHG99HixCot1Iw ($25.15 in chips) 
Seat 3: mfrkWA3PTeYPkbO6hi98Aw ($27.85 in chips) 
Seat 4: 4lJto+Qj0K4JrFKvHaPTLw ($66.25 in chips) 
Seat 5: FYepjhAvF8ZdVCmqHIy+eQ ($28.75 in chips) 
Seat 6: QvTX2yGq3uKJiKPmns4TKQ ($24.65 in chips) 
4lJto+Qj0K4JrFKvHaPTLw: posts small blind $0.10
FYepjhAvF8ZdVCmqHIy+eQ: posts big blind $0.25
*** HOLE CARDS ***
QvTX2yGq3uKJiKPmns4TKQ: raises $0.75 to $1
QiL+lEgEWwy21jk/ltaRLg: folds 
xrf8tAXKQHG99HixCot1Iw: folds 
mfrkWA3PTeYPkbO6hi98Aw: folds 
4lJto+Qj0K4JrFKvHaPTLw: folds 
FYepjhAvF8ZdVCmqHIy+eQ: folds 
Uncalled bet ($0.75) returned to QvTX2yGq3uKJiKPmns4TKQ
QvTX2yGq3uKJiKPmns4TKQ collected $0.60 from pot
QvTX2yGq3uKJiKPmns4TKQ: doesn't show hand 
*** SUMMARY ***
Total pot $0.60 | Rake $0 
Seat 1: QiL+lEgEWwy21jk/ltaRLg folded before Flop (didn't bet)
Seat 2: xrf8tAXKQHG99HixCot1Iw folded before Flop (didn't bet)
Seat 3: mfrkWA3PTeYPkbO6hi98Aw (button) folded before Flop (didn't bet)
Seat 4: 4lJto+Qj0K4JrFKvHaPTLw (small blind) folded before Flop
Seat 5: FYepjhAvF8ZdVCmqHIy+eQ (big blind) folded before Flop
Seat 6: QvTX2yGq3uKJiKPmns4TKQ collected ($0.60)




PokerStars Game #59941644564:  Hold'em No Limit ($0.10/$0.25) - 2009/07/01 1:41:41 ET
Table '9o8Yb3JpUqurD4pNVmOikQ' 6-max Seat #2 is the button
Seat 1: SFmT9ZsVopnukjvAzrxTRg ($27.55 in chips) 
Seat 2: /gJNBeCkWL4o85/jvlZ4BA ($25 in chips) 
Seat 3: JgRqo1/2phbf7pab7N3BIQ ($24.30 in chips) 
Seat 4: j5NZbEJHsERuXjPHWqc1Nw ($8.75 in chips) 
Seat 5: L/ayP3FdbcybmfF6diPHaA ($14.30 in chips) 
Seat 6: LyDHtw3/yniNHW+DvLXbog ($26.05 in chips) 
JgRqo1/2phbf7pab7N3BIQ: posts small blind $0.10
j5NZbEJHsERuXjPHWqc1Nw: posts big blind $0.25
*** HOLE CARDS ***
L/ayP3FdbcybmfF6diPHaA: calls $0.25
LyDHtw3/yniNHW+DvLXbog: folds 
SFmT9ZsVopnukjvAzrxTRg: folds 
/gJNBeCkWL4o85/jvlZ4BA: folds 
JgRqo1/2phbf7pab7N3BIQ: calls $0.15
j5NZbEJHsERuXjPHWqc1Nw: raises $0.75 to $1
L/ayP3FdbcybmfF6diPHaA: calls $0.75
JgRqo1/2phbf7pab7N3BIQ: calls $0.75
*** FLOP *** [2s 3h 8s]
JgRqo1/2phbf7pab7N3BIQ: checks 
j5NZbEJHsERuXjPHWqc1Nw: bets $1.50
L/ayP3FdbcybmfF6diPHaA: folds 
L/ayP3FdbcybmfF6diPHaA is sitting out
L/ayP3FdbcybmfF6diPHaA has returned
JgRqo1/2phbf7pab7N3BIQ: calls $1.50
*** TURN *** [2s 3h 8s] [2h]
L/ayP3FdbcybmfF6diPHaA leaves the table
JgRqo1/2phbf7pab7N3BIQ: checks 
j5NZbEJHsERuXjPHWqc1Nw: bets $6.25 and is all-in
HIENAL joins the table at seat #5 
JgRqo1/2phbf7pab7N3BIQ: folds 
Uncalled bet ($6.25) returned to j5NZbEJHsERuXjPHWqc1Nw
j5NZbEJHsERuXjPHWqc1Nw collected $5.75 from pot
*** SUMMARY ***
Total pot $6 | Rake $0.25 
Board [2s 3h 8s 2h]
Seat 1: SFmT9ZsVopnukjvAzrxTRg folded before Flop (didn't bet)
Seat 2: /gJNBeCkWL4o85/jvlZ4BA (button) folded before Flop (didn't bet)
Seat 3: JgRqo1/2phbf7pab7N3BIQ (small blind) folded on the Turn
Seat 4: j5NZbEJHsERuXjPHWqc1Nw (big blind) collected ($5.75)
Seat 5: L/ayP3FdbcybmfF6diPHaA folded on the Flop
Seat 6: LyDHtw3/yniNHW+DvLXbog folded before Flop (didn't bet)




PokerStars Game #59941645000:  Hold'em No Limit ($0.10/$0.25) - 2009/07/01 1:41:41 ET
Table 'MiquQrQZJJq9ZtgRIp9HFQ' 6-max Seat #5 is the button
Seat 1: c3J/KYZ4cNsUEuz8v57I5A ($26.25 in chips) 
Seat 2: XaIzillDPjW0HcNtCRrgsQ ($5.20 in chips) 
Seat 3: Hsvkc0/G2VV78oVmWYXecw ($5 in chips) 
Seat 4: wAKC8C/zN0c8V5v13dm9mA ($57.75 in chips) 
Seat 5: iyZxqznXjv3vtvOJymkoLQ ($27.10 in chips) 
Seat 6: GbCVUNssQ7mqsPWr7J4d3w ($4.05 in chips) 
GbCVUNssQ7mqsPWr7J4d3w: posts small blind $0.10
c3J/KYZ4cNsUEuz8v57I5A: posts big blind $0.25
*** HOLE CARDS ***
XaIzillDPjW0HcNtCRrgsQ: calls $0.25
Hsvkc0/G2VV78oVmWYXecw: raises $0.50 to $0.75
wAKC8C/zN0c8V5v13dm9mA: folds 
iyZxqznXjv3vtvOJymkoLQ: folds 
GbCVUNssQ7mqsPWr7J4d3w: folds 
c3J/KYZ4cNsUEuz8v57I5A: folds 
XaIzillDPjW0HcNtCRrgsQ: calls $0.50
*** FLOP *** [3s 3h Js]
XaIzillDPjW0HcNtCRrgsQ: checks 
Hsvkc0/G2VV78oVmWYXecw: bets $1.25
XaIzillDPjW0HcNtCRrgsQ: folds 
Uncalled bet ($1.25) returned to Hsvkc0/G2VV78oVmWYXecw
Hsvkc0/G2VV78oVmWYXecw collected $1.80 from pot
Hsvkc0/G2VV78oVmWYXecw: doesn't show hand 
*** SUMMARY ***
Total pot $1.85 | Rake $0.05 
Board [3s 3h Js]
Seat 1: c3J/KYZ4cNsUEuz8v57I5A (big blind) folded before Flop
Seat 2: XaIzillDPjW0HcNtCRrgsQ folded on the Flop
Seat 3: Hsvkc0/G2VV78oVmWYXecw collected ($1.80)
Seat 4: wAKC8C/zN0c8V5v13dm9mA folded before Flop (didn't bet)
Seat 5: iyZxqznXjv3vtvOJymkoLQ (button) folded before Flop (didn't bet)
Seat 6: GbCVUNssQ7mqsPWr7J4d3w (small blind) folded before Flop




PokerStars Game #59941644638:  Hold'em No Limit ($0.10/$0.25) - 2009/07/01 1:41:41 ET
Table 'TJS4XvvOjO3k7mH74HJw5g' 9-max Seat #1 is the button
Seat 1: K8I2mpRME07ZlOsT2x75Lg ($5.95 in chips) 
Seat 4: f/e5w8nN3RjdX9H1eRlDdA ($0.90 in chips) 
Seat 5: UlMB386Cfzy3EwurQoBjcA ($10.45 in chips) 
Seat 6: SRik8xyC/rVIBoX7VaOoMA ($14.40 in chips) 
Seat 7: B9u+i1s5aZZkmLTLUopTBg ($15 in chips) 
Seat 8: Qv4VzEkN09uD11sjKv02Ig ($17.65 in chips) 
Seat 9: +sbyWwIcFp9kP0bDtMegfQ ($42.65 in chips) 
f/e5w8nN3RjdX9H1eRlDdA: posts small blind $0.10
UlMB386Cfzy3EwurQoBjcA: posts big blind $0.25
B9u+i1s5aZZkmLTLUopTBg: posts big blind $0.25
*** HOLE CARDS ***
SRik8xyC/rVIBoX7VaOoMA: folds 
yqkowiRWZ6NvRN9UUkYIlA joins the table at seat #2 
8EbrQ/EvFWt2cr0GaU82gQ joins the table at seat #3 
B9u+i1s5aZZkmLTLUopTBg: checks 
Qv4VzEkN09uD11sjKv02Ig: raises $0.25 to $0.50
+sbyWwIcFp9kP0bDtMegfQ: folds 
K8I2mpRME07ZlOsT2x75Lg: folds 
f/e5w8nN3RjdX9H1eRlDdA: folds 
UlMB386Cfzy3EwurQoBjcA: calls $0.25
B9u+i1s5aZZkmLTLUopTBg: calls $0.25
*** FLOP *** [Jh Qh Ts]
UlMB386Cfzy3EwurQoBjcA: checks 
B9u+i1s5aZZkmLTLUopTBg: checks 
Qv4VzEkN09uD11sjKv02Ig: bets $1.25
UlMB386Cfzy3EwurQoBjcA: folds 
B9u+i1s5aZZkmLTLUopTBg: folds 
Uncalled bet ($1.25) returned to Qv4VzEkN09uD11sjKv02Ig
Qv4VzEkN09uD11sjKv02Ig collected $1.55 from pot
*** SUMMARY ***
Total pot $1.60 | Rake $0.05 
Board [Jh Qh Ts]
Seat 1: K8I2mpRME07ZlOsT2x75Lg (button) folded before Flop (didn't bet)
Seat 4: f/e5w8nN3RjdX9H1eRlDdA (small blind) folded before Flop
Seat 5: UlMB386Cfzy3EwurQoBjcA (big blind) folded on the Flop
Seat 6: SRik8xyC/rVIBoX7VaOoMA folded before Flop (didn't bet)
Seat 7: B9u+i1s5aZZkmLTLUopTBg folded on the Flop
Seat 8: Qv4VzEkN09uD11sjKv02Ig collected ($1.55)
Seat 9: +sbyWwIcFp9kP0bDtMegfQ folded before Flop (didn't bet)




PokerStars Game #59941645162:  Hold'em No Limit ($0.10/$0.25) - 2009/07/01 1:41:42 ET
Table 'SHi8+hK6i7E2dJ/3Agbyig' 6-max Seat #4 is the button
Seat 1: gPEN9Zp33YTm/mu9/SYP1w ($30.70 in chips) 
Seat 2: LJI7A1YgDM7hgh7o56+ReQ ($28.80 in chips) 
Seat 3: P1Z7LWu+VU+WmJsI4mr0wA ($25 in chips) 
Seat 4: u0ikXOhAPSCLmg+l17oGRw ($10.60 in chips) 
Seat 5: v8m8XHovI5tqEA9mvplDSw ($53.55 in chips) 
Seat 6: cWc85bEzdRzpUMhRKm8pwQ ($25 in chips) 
v8m8XHovI5tqEA9mvplDSw: posts small blind $0.10
cWc85bEzdRzpUMhRKm8pwQ: posts big blind $0.25
*** HOLE CARDS ***
gPEN9Zp33YTm/mu9/SYP1w: folds 
LJI7A1YgDM7hgh7o56+ReQ: folds 
P1Z7LWu+VU+WmJsI4mr0wA: calls $0.25
u0ikXOhAPSCLmg+l17oGRw: calls $0.25
v8m8XHovI5tqEA9mvplDSw: folds 
cWc85bEzdRzpUMhRKm8pwQ: checks 
*** FLOP *** [2h Jh 6c]
cWc85bEzdRzpUMhRKm8pwQ: checks 
P1Z7LWu+VU+WmJsI4mr0wA: checks 
u0ikXOhAPSCLmg+l17oGRw: bets $0.50
cWc85bEzdRzpUMhRKm8pwQ: folds 
P1Z7LWu+VU+WmJsI4mr0wA: calls $0.50
*** TURN *** [2h Jh 6c] [7d]
P1Z7LWu+VU+WmJsI4mr0wA: checks 
u0ikXOhAPSCLmg+l17oGRw: bets $1
P1Z7LWu+VU+WmJsI4mr0wA: folds 
Uncalled bet ($1) returned to u0ikXOhAPSCLmg+l17oGRw
u0ikXOhAPSCLmg+l17oGRw collected $1.80 from pot
*** SUMMARY ***
Total pot $1.85 | Rake $0.05 
Board [2h Jh 6c 7d]
Seat 1: gPEN9Zp33YTm/mu9/SYP1w folded before Flop (didn't bet)
Seat 2: LJI7A1YgDM7hgh7o56+ReQ folded before Flop (didn't bet)
Seat 3: P1Z7LWu+VU+WmJsI4mr0wA folded on the Turn
Seat 4: u0ikXOhAPSCLmg+l17oGRw (button) collected ($1.80)
Seat 5: v8m8XHovI5tqEA9mvplDSw (small blind) folded before Flop
Seat 6: cWc85bEzdRzpUMhRKm8pwQ (big blind) folded on the Flop




PokerStars Game #59941645258:  Hold'em No Limit ($0.10/$0.25) - 2009/07/01 1:41:42 ET
Table 'sCop8wmj9zlSS2KJqk1QKQ' 9-max Seat #1 is the button
Seat 1: dtZ84flFEi4Q+SGrHMJRDQ ($29.45 in chips) 
Seat 2: YZaC69gFrepA6oCGtu7E0w ($39.10 in chips) 
Seat 3: OwQek9i+x54ZA6dn6e8qhg ($12.55 in chips) 
Seat 4: msUzkZl2RntUnTl6E8WaNA ($10.65 in chips) 
Seat 5: sD+TKtt36XiiN6jqHiLwDA ($6.75 in chips) 
Seat 6: hZuGwtYmFKPmQ+v1wlmdfA ($43.05 in chips) 
Seat 7: sx0lGrkT9fd4yFR+3cXUQg ($11.85 in chips) 
Seat 8: xnVwSkROfRtOw4eSoDANtw ($20.30 in chips) 
Seat 9: tLcDklc2rBORNfixyRfVfw ($25 in chips) 
YZaC69gFrepA6oCGtu7E0w: posts small blind $0.10
OwQek9i+x54ZA6dn6e8qhg: posts big blind $0.25
*** HOLE CARDS ***
msUzkZl2RntUnTl6E8WaNA: folds 
sD+TKtt36XiiN6jqHiLwDA: folds 
sD+TKtt36XiiN6jqHiLwDA leaves the table
hZuGwtYmFKPmQ+v1wlmdfA: folds 
sx0lGrkT9fd4yFR+3cXUQg: folds 
xnVwSkROfRtOw4eSoDANtw: folds 
tLcDklc2rBORNfixyRfVfw: folds 
weiwei539 joins the table at seat #5 
dtZ84flFEi4Q+SGrHMJRDQ: raises $0.50 to $0.75
YZaC69gFrepA6oCGtu7E0w: folds 
OwQek9i+x54ZA6dn6e8qhg: raises $0.75 to $1.50
dtZ84flFEi4Q+SGrHMJRDQ: raises $3 to $4.50
OwQek9i+x54ZA6dn6e8qhg: raises $3 to $7.50
dtZ84flFEi4Q+SGrHMJRDQ: raises $21.95 to $29.45 and is all-in
OwQek9i+x54ZA6dn6e8qhg: calls $5.05 and is all-in
Uncalled bet ($16.90) returned to dtZ84flFEi4Q+SGrHMJRDQ
*** FLOP *** [Td 7h 2c]
*** TURN *** [Td 7h 2c] [3h]
*** RIVER *** [Td 7h 2c 3h] [5s]
*** SHOW DOWN ***
OwQek9i+x54ZA6dn6e8qhg: shows [Ah Ks] (high card Ace)
dtZ84flFEi4Q+SGrHMJRDQ: shows [Kc Kh] (a pair of Kings)
dtZ84flFEi4Q+SGrHMJRDQ collected $23.95 from pot
*** SUMMARY ***
Total pot $25.20 | Rake $1.25 
Board [Td 7h 2c 3h 5s]
Seat 1: dtZ84flFEi4Q+SGrHMJRDQ (button) showed [Kc Kh] and won ($23.95) with a pair of Kings
Seat 2: YZaC69gFrepA6oCGtu7E0w (small blind) folded before Flop
Seat 3: OwQek9i+x54ZA6dn6e8qhg (big blind) showed [Ah Ks] and lost with high card Ace
Seat 4: msUzkZl2RntUnTl6E8WaNA folded before Flop (didn't bet)
Seat 5: sD+TKtt36XiiN6jqHiLwDA folded before Flop (didn't bet)
Seat 6: hZuGwtYmFKPmQ+v1wlmdfA folded before Flop (didn't bet)
Seat 7: sx0lGrkT9fd4yFR+3cXUQg folded before Flop (didn't bet)
Seat 8: xnVwSkROfRtOw4eSoDANtw folded before Flop (didn't bet)
Seat 9: tLcDklc2rBORNfixyRfVfw folded before Flop (didn't bet)




PokerStars Game #59941645814:  Hold'em No Limit ($0.10/$0.25) - 2009/07/01 1:41:43 ET
Table 'Of/T60zpXg1GcjrZ7Lm//Q' 9-max Seat #2 is the button
Seat 1: Lro4e37x4FUa5P3yzDjskw ($16.80 in chips) 
Seat 2: qwr38jl5txoR36M7G5qi4A ($9.90 in chips) 
Seat 3: 6RiVTYll/5D8zICp0MRpKw ($23.90 in chips) 
Seat 4: Czut6V7acIqUJrrobjKAZg ($17.50 in chips) 
Seat 5: IiLkthQMEje9LS79rCFQ1Q ($9.45 in chips) 
Seat 6: tYsOBqdU1+x+yFI7zHO7hQ ($31.05 in chips) 
Seat 7: PVxvfRTRvkgZf9WtquEkwQ ($25 in chips) 
Seat 8: ghNKXUBl/H+t83JF079ZBA ($26.50 in chips) 
Seat 9: egvg3mTBBVzMHnJPIQiKcA ($14 in chips) 
6RiVTYll/5D8zICp0MRpKw: posts small blind $0.10
Czut6V7acIqUJrrobjKAZg: posts big blind $0.25
*** HOLE CARDS ***
IiLkthQMEje9LS79rCFQ1Q: folds 
tYsOBqdU1+x+yFI7zHO7hQ: folds 
PVxvfRTRvkgZf9WtquEkwQ: folds 
ghNKXUBl/H+t83JF079ZBA: folds 
egvg3mTBBVzMHnJPIQiKcA: folds 
Lro4e37x4FUa5P3yzDjskw: raises $0.25 to $0.50
qwr38jl5txoR36M7G5qi4A: folds 
6RiVTYll/5D8zICp0MRpKw: calls $0.40
Czut6V7acIqUJrrobjKAZg: calls $0.25
*** FLOP *** [8h 2d 8d]
6RiVTYll/5D8zICp0MRpKw: checks 
Czut6V7acIqUJrrobjKAZg: checks 
Lro4e37x4FUa5P3yzDjskw: bets $0.50
6RiVTYll/5D8zICp0MRpKw: calls $0.50
Czut6V7acIqUJrrobjKAZg: folds 
*** TURN *** [8h 2d 8d] [7c]
6RiVTYll/5D8zICp0MRpKw: checks 
Lro4e37x4FUa5P3yzDjskw: bets $1
6RiVTYll/5D8zICp0MRpKw: folds 
Uncalled bet ($1) returned to Lro4e37x4FUa5P3yzDjskw
Lro4e37x4FUa5P3yzDjskw collected $2.40 from pot
*** SUMMARY ***
Total pot $2.50 | Rake $0.10 
Board [8h 2d 8d 7c]
Seat 1: Lro4e37x4FUa5P3yzDjskw collected ($2.40)
Seat 2: qwr38jl5txoR36M7G5qi4A (button) folded before Flop (didn't bet)
Seat 3: 6RiVTYll/5D8zICp0MRpKw (small blind) folded on the Turn
Seat 4: Czut6V7acIqUJrrobjKAZg (big blind) folded on the Flop
Seat 5: IiLkthQMEje9LS79rCFQ1Q folded before Flop (didn't bet)
Seat 6: tYsOBqdU1+x+yFI7zHO7hQ folded before Flop (didn't bet)
Seat 7: PVxvfRTRvkgZf9WtquEkwQ folded before Flop (didn't bet)
Seat 8: ghNKXUBl/H+t83JF079ZBA folded before Flop (didn't bet)
Seat 9: egvg3mTBBVzMHnJPIQiKcA folded before Flop (didn't bet)




PokerStars Game #59941645662:  Hold'em No Limit ($0.10/$0.25) - 2009/07/01 1:41:43 ET
Table 'nB7Q7zfNfy6ig6DB+rsgWQ' 6-max Seat #1 is the button
Seat 1: Hzy03WtPHMYwLYM7hTTxQw ($25 in chips) 
Seat 2: 4BHo0wlX9INjkj2727qE0w ($7.65 in chips) 
Seat 3: p3NYOxYhkL7txPRSeXHDeg ($30.80 in chips) 
Seat 4: DihMHaz4WNETH1bPDe13kA ($77.65 in chips) 
Seat 6: MEGIwX0eHRUj63lwYaNhVg ($9.70 in chips) 
4BHo0wlX9INjkj2727qE0w: posts small blind $0.10
p3NYOxYhkL7txPRSeXHDeg: posts big blind $0.25
ripbrokeith: sits out 
*** HOLE CARDS ***
DihMHaz4WNETH1bPDe13kA: folds 
MEGIwX0eHRUj63lwYaNhVg: folds 
Hzy03WtPHMYwLYM7hTTxQw: raises $0.75 to $1
4BHo0wlX9INjkj2727qE0w: calls $0.90
p3NYOxYhkL7txPRSeXHDeg: folds 
*** FLOP *** [4s 4h As]
4BHo0wlX9INjkj2727qE0w: bets $0.50
Hzy03WtPHMYwLYM7hTTxQw: folds 
Uncalled bet ($0.50) returned to 4BHo0wlX9INjkj2727qE0w
4BHo0wlX9INjkj2727qE0w collected $2.15 from pot
*** SUMMARY ***
Total pot $2.25 | Rake $0.10 
Board [4s 4h As]
Seat 1: Hzy03WtPHMYwLYM7hTTxQw (button) folded on the Flop
Seat 2: 4BHo0wlX9INjkj2727qE0w (small blind) collected ($2.15)
Seat 3: p3NYOxYhkL7txPRSeXHDeg (big blind) folded before Flop
Seat 4: DihMHaz4WNETH1bPDe13kA folded before Flop (didn't bet)
Seat 6: MEGIwX0eHRUj63lwYaNhVg folded before Flop (didn't bet)




PokerStars Game #59941645622:  Hold'em No Limit ($0.10/$0.25) - 2009/07/01 1:41:43 ET
Table 'QegsWX65l3n/K0A8XB78yg' 6-max Seat #2 is the button
Seat 1: p6adJRMXMBLr+xtQzqazIQ ($12 in chips) 
Seat 2: GC/9yVD59DUCX7hUI7gcLw ($48.85 in chips) 
Seat 3: 1lxYIAoJdZwAbzIkzWmSkw ($1.50 in chips) 
Seat 5: OMGl+YMGogf2JWIRfT2/Yg ($12.15 in chips) 
Seat 6: 5PWs02z65jSO5pr/M6wx/w ($4.85 in chips) 
1lxYIAoJdZwAbzIkzWmSkw: posts small blind $0.10
mFv3iBCtrw9XfCDRB0d46Q: is sitting out 
OMGl+YMGogf2JWIRfT2/Yg: posts big blind $0.25
*** HOLE CARDS ***
5PWs02z65jSO5pr/M6wx/w: folds 
p6adJRMXMBLr+xtQzqazIQ: raises $0.75 to $1
GC/9yVD59DUCX7hUI7gcLw: folds 
1lxYIAoJdZwAbzIkzWmSkw: folds 
OMGl+YMGogf2JWIRfT2/Yg: folds 
Uncalled bet ($0.75) returned to p6adJRMXMBLr+xtQzqazIQ
p6adJRMXMBLr+xtQzqazIQ collected $0.60 from pot
mFv3iBCtrw9XfCDRB0d46Q has returned
*** SUMMARY ***
Total pot $0.60 | Rake $0 
Seat 1: p6adJRMXMBLr+xtQzqazIQ collected ($0.60)
Seat 2: GC/9yVD59DUCX7hUI7gcLw (button) folded before Flop (didn't bet)
Seat 3: 1lxYIAoJdZwAbzIkzWmSkw (small blind) folded before Flop
Seat 5: OMGl+YMGogf2JWIRfT2/Yg (big blind) folded before Flop
Seat 6: 5PWs02z65jSO5pr/M6wx/w folded before Flop (didn't bet)




PokerStars Game #59941645934:  Hold'em No Limit ($0.10/$0.25) - 2009/07/01 1:41:43 ET
Table 'Do4nrTNDYpK3sQjwFxX+Og' 6-max Seat #3 is the button
Seat 1: 7JrQNOR9wRBxq9ijFhWieg ($38.10 in chips) 
Seat 2: tzMoGl9F0PUr5NibYueeSw ($68.45 in chips) 
Seat 3: TSmua8tGK3sTbwi0ynrW9Q ($25 in chips) 
Seat 4: cWc85bEzdRzpUMhRKm8pwQ ($33.50 in chips) 
Seat 5: Ew/TYPQIsbQ2X8nm5iAJBg ($35.70 in chips) 
Seat 6: lBoEwOFgzcERLIRUkUoRTw ($23.90 in chips) 
cWc85bEzdRzpUMhRKm8pwQ: posts small blind $0.10
Ew/TYPQIsbQ2X8nm5iAJBg: posts big blind $0.25
*** HOLE CARDS ***
lBoEwOFgzcERLIRUkUoRTw: folds 
7JrQNOR9wRBxq9ijFhWieg: raises $0.50 to $0.75
tzMoGl9F0PUr5NibYueeSw: folds 
TSmua8tGK3sTbwi0ynrW9Q: folds 
cWc85bEzdRzpUMhRKm8pwQ: folds 
Ew/TYPQIsbQ2X8nm5iAJBg: calls $0.50
*** FLOP *** [7d Ah Ac]
Ew/TYPQIsbQ2X8nm5iAJBg: checks 
7JrQNOR9wRBxq9ijFhWieg: checks 
*** TURN *** [7d Ah Ac] [Qc]
Ew/TYPQIsbQ2X8nm5iAJBg: checks 
7JrQNOR9wRBxq9ijFhWieg: bets $1
Ew/TYPQIsbQ2X8nm5iAJBg: folds 
Uncalled bet ($1) returned to 7JrQNOR9wRBxq9ijFhWieg
7JrQNOR9wRBxq9ijFhWieg collected $1.55 from pot
7JrQNOR9wRBxq9ijFhWieg: doesn't show hand 
*** SUMMARY ***
Total pot $1.60 | Rake $0.05 
Board [7d Ah Ac Qc]
Seat 1: 7JrQNOR9wRBxq9ijFhWieg collected ($1.55)
Seat 2: tzMoGl9F0PUr5NibYueeSw folded before Flop (didn't bet)
Seat 3: TSmua8tGK3sTbwi0ynrW9Q (button) folded before Flop (didn't bet)
Seat 4: cWc85bEzdRzpUMhRKm8pwQ (small blind) folded before Flop
Seat 5: Ew/TYPQIsbQ2X8nm5iAJBg (big blind) folded on the Turn
Seat 6: lBoEwOFgzcERLIRUkUoRTw folded before Flop (didn't bet)




PokerStars Game #59941645852:  Hold'em No Limit ($0.10/$0.25) - 2009/07/01 1:41:43 ET
Table 'vZfV/Uj0q8joA1du9sRJSg' 6-max Seat #3 is the button
Seat 1: Hsvkc0/G2VV78oVmWYXecw ($6.40 in chips) 
Seat 2: wMiE3yTbDJGOLOF9th7KPA ($14.15 in chips) 
Seat 3: cWc85bEzdRzpUMhRKm8pwQ ($25 in chips) 
Seat 4: v+QfkGiuj9bgtuNoVnDO8w ($40.25 in chips) 
Seat 5: kyRaCIljYA6l33lSKQfNsg ($24.20 in chips) 
Seat 6: 8ClCHtFXGNplITm+63KB+Q ($48.15 in chips) 
v+QfkGiuj9bgtuNoVnDO8w: posts small blind $0.10
kyRaCIljYA6l33lSKQfNsg: posts big blind $0.25
*** HOLE CARDS ***
8ClCHtFXGNplITm+63KB+Q: raises $0.75 to $1
Hsvkc0/G2VV78oVmWYXecw: folds 
wMiE3yTbDJGOLOF9th7KPA: calls $1
cWc85bEzdRzpUMhRKm8pwQ: folds 
v+QfkGiuj9bgtuNoVnDO8w: folds 
kyRaCIljYA6l33lSKQfNsg: raises $2 to $3
8ClCHtFXGNplITm+63KB+Q: calls $2
wMiE3yTbDJGOLOF9th7KPA: folds 
*** FLOP *** [2c 9h 8c]
kyRaCIljYA6l33lSKQfNsg: bets $4.50
8ClCHtFXGNplITm+63KB+Q: folds 
Uncalled bet ($4.50) returned to kyRaCIljYA6l33lSKQfNsg
kyRaCIljYA6l33lSKQfNsg collected $6.75 from pot
*** SUMMARY ***
Total pot $7.10 | Rake $0.35 
Board [2c 9h 8c]
Seat 1: Hsvkc0/G2VV78oVmWYXecw folded before Flop (didn't bet)
Seat 2: wMiE3yTbDJGOLOF9th7KPA folded before Flop
Seat 3: cWc85bEzdRzpUMhRKm8pwQ (button) folded before Flop (didn't bet)
Seat 4: v+QfkGiuj9bgtuNoVnDO8w (small blind) folded before Flop
Seat 5: kyRaCIljYA6l33lSKQfNsg (big blind) collected ($6.75)
Seat 6: 8ClCHtFXGNplITm+63KB+Q folded on the Flop




PokerStars Game #59941646484:  Hold'em No Limit ($0.10/$0.25) - 2009/07/01 1:41:44 ET
Table 'Xi38lWH8L2JHRAsKYVX8Qg' 6-max Seat #2 is the button
Seat 1: shP7DFAtX7gXcgMJX/OmRQ ($19.80 in chips) 
Seat 2: VOmI0x4dDPnTESZd5B4d1Q ($9.60 in chips) 
Seat 3: 6DwBRH+xZ12AAZmeAg+aXw ($30.35 in chips) 
Seat 4: kG34n23qFQA3nzdOJTQ1dA ($27.45 in chips) 
Seat 5: 79ID/ub1Pt/mDpCprVmOoA ($78.80 in chips) 
Seat 6: kyRaCIljYA6l33lSKQfNsg ($29.40 in chips) 
6DwBRH+xZ12AAZmeAg+aXw: posts small blind $0.10
kG34n23qFQA3nzdOJTQ1dA: posts big blind $0.25
*** HOLE CARDS ***
79ID/ub1Pt/mDpCprVmOoA: folds 
kyRaCIljYA6l33lSKQfNsg: folds 
shP7DFAtX7gXcgMJX/OmRQ: calls $0.25
VOmI0x4dDPnTESZd5B4d1Q: folds 
6DwBRH+xZ12AAZmeAg+aXw: folds 
kG34n23qFQA3nzdOJTQ1dA: checks 
*** FLOP *** [8d 6d Qc]
kG34n23qFQA3nzdOJTQ1dA: checks 
shP7DFAtX7gXcgMJX/OmRQ: checks 
*** TURN *** [8d 6d Qc] [Kc]
kG34n23qFQA3nzdOJTQ1dA: checks 
shP7DFAtX7gXcgMJX/OmRQ: checks 
*** RIVER *** [8d 6d Qc Kc] [4c]
kG34n23qFQA3nzdOJTQ1dA: checks 
shP7DFAtX7gXcgMJX/OmRQ: bets $1
kG34n23qFQA3nzdOJTQ1dA: folds 
Uncalled bet ($1) returned to shP7DFAtX7gXcgMJX/OmRQ
shP7DFAtX7gXcgMJX/OmRQ collected $0.60 from pot
shP7DFAtX7gXcgMJX/OmRQ: doesn't show hand 
*** SUMMARY ***
Total pot $0.60 | Rake $0 
Board [8d 6d Qc Kc 4c]
Seat 1: shP7DFAtX7gXcgMJX/OmRQ collected ($0.60)
Seat 2: VOmI0x4dDPnTESZd5B4d1Q (button) folded before Flop (didn't bet)
Seat 3: 6DwBRH+xZ12AAZmeAg+aXw (small blind) folded before Flop
Seat 4: kG34n23qFQA3nzdOJTQ1dA (big blind) folded on the River
Seat 5: 79ID/ub1Pt/mDpCprVmOoA folded before Flop (didn't bet)
Seat 6: kyRaCIljYA6l33lSKQfNsg folded before Flop (didn't bet)




PokerStars Game #59941646310:  Hold'em No Limit ($0.10/$0.25) - 2009/07/01 1:41:44 ET
Table 'WEMI3Mtn7dGARDbgNrKibgQvLFJzpzymuOsaaRYi+8fgx Seat #5 is the button
Seat 2: PdIasPkzm2sqZnN41ZRXOg ($5 in chips) 
Seat 4: tLcDklc2rBORNfixyRfVfw ($25.25 in chips) 
Seat 5: MG90wfSJZnOejs/KD3vlQQ ($36.75 in chips) 
Seat 7: rQhYIYXSyH/IivYM1dlV5A ($12.05 in chips) 
Seat 8: gehe91e0IyVT0QU/XBkEyg ($25.25 in chips) 
Seat 9: BWzInv8o0kN1pJybv/VjpQ ($44.60 in chips) 
rQhYIYXSyH/IivYM1dlV5A: posts small blind $0.10
gehe91e0IyVT0QU/XBkEyg: posts big blind $0.25
cZ99hugmLBj9KhTlc8nCSw: sits out 
Dr.Hibbert55: sits out 
*** HOLE CARDS ***
BWzInv8o0kN1pJybv/VjpQ: folds 
PdIasPkzm2sqZnN41ZRXOg: folds 
tLcDklc2rBORNfixyRfVfw: raises $0.75 to $1
MG90wfSJZnOejs/KD3vlQQ: folds 
rQhYIYXSyH/IivYM1dlV5A: folds 
gehe91e0IyVT0QU/XBkEyg: folds 
Uncalled bet ($0.75) returned to tLcDklc2rBORNfixyRfVfw
tLcDklc2rBORNfixyRfVfw collected $0.60 from pot
tLcDklc2rBORNfixyRfVfw: doesn't show hand 
*** SUMMARY ***
Total pot $0.60 | Rake $0 
Seat 2: PdIasPkzm2sqZnN41ZRXOg folded before Flop (didn't bet)
Seat 4: tLcDklc2rBORNfixyRfVfw collected ($0.60)
Seat 5: MG90wfSJZnOejs/KD3vlQQ (button) folded before Flop (didn't bet)
Seat 7: rQhYIYXSyH/IivYM1dlV5A (small blind) folded before Flop
Seat 8: gehe91e0IyVT0QU/XBkEyg (big blind) folded before Flop
Seat 9: BWzInv8o0kN1pJybv/VjpQ folded before Flop (didn't bet)




PokerStars Game #59941646550:  Hold'em No Limit ($0.10/$0.25) - 2009/07/01 1:41:44 ET
Table 'Qk/910N2Yhg8u5vqTJk50Q' 9-max Seat #7 is the button
Seat 1: zDrucyjVn5aeekNEc3cJrA ($22.55 in chips) 
Seat 2: Th3FldXKQW6hWVVPahaoOQ ($45.65 in chips) 
Seat 3: ghNKXUBl/H+t83JF079ZBA ($26 in chips) 
Seat 5: zReBEigsxqZnag0RZAgpgA ($15.75 in chips) 
Seat 6: nAWaA+gDUSWOad+I9mKUEg ($7.85 in chips) 
Seat 7: aNpwfA31EREwO+ar4XzBCw ($26.35 in chips) 
Seat 8: 9PMD136+PrUsTwnP6fczyA ($14 in chips) 
Seat 9: M2QO2DxB5Wawg2h8HSpnYA ($18.70 in chips) 
9PMD136+PrUsTwnP6fczyA: posts small blind $0.10
M2QO2DxB5Wawg2h8HSpnYA: posts big blind $0.25
zReBEigsxqZnag0RZAgpgA: posts big blind $0.25
nAWaA+gDUSWOad+I9mKUEg: posts big blind $0.25
*** HOLE CARDS ***
zDrucyjVn5aeekNEc3cJrA: folds 
zDrucyjVn5aeekNEc3cJrA is sitting out
Th3FldXKQW6hWVVPahaoOQ: folds 
ghNKXUBl/H+t83JF079ZBA: folds 
zReBEigsxqZnag0RZAgpgA: checks 
nAWaA+gDUSWOad+I9mKUEg: raises $0.25 to $0.50
aNpwfA31EREwO+ar4XzBCw: folds 
9PMD136+PrUsTwnP6fczyA: folds 
M2QO2DxB5Wawg2h8HSpnYA: calls $0.25
zReBEigsxqZnag0RZAgpgA: folds 
*** FLOP *** [Qs Ks 6d]
M2QO2DxB5Wawg2h8HSpnYA: checks 
nAWaA+gDUSWOad+I9mKUEg: bets $1
M2QO2DxB5Wawg2h8HSpnYA: folds 
Uncalled bet ($1) returned to nAWaA+gDUSWOad+I9mKUEg
nAWaA+gDUSWOad+I9mKUEg collected $1.30 from pot
nAWaA+gDUSWOad+I9mKUEg: doesn't show hand 
*** SUMMARY ***
Total pot $1.35 | Rake $0.05 
Board [Qs Ks 6d]
Seat 1: zDrucyjVn5aeekNEc3cJrA folded before Flop (didn't bet)
Seat 2: Th3FldXKQW6hWVVPahaoOQ folded before Flop (didn't bet)
Seat 3: ghNKXUBl/H+t83JF079ZBA folded before Flop (didn't bet)
Seat 5: zReBEigsxqZnag0RZAgpgA folded before Flop
Seat 6: nAWaA+gDUSWOad+I9mKUEg collected ($1.30)
Seat 7: aNpwfA31EREwO+ar4XzBCw (button) folded before Flop (didn't bet)
Seat 8: 9PMD136+PrUsTwnP6fczyA (small blind) folded before Flop
Seat 9: M2QO2DxB5Wawg2h8HSpnYA (big blind) folded on the Flop




PokerStars Game #59941646536:  Hold'em No Limit ($0.10/$0.25) - 2009/07/01 1:41:44 ET
Table 'wRXcD9iXgBbdvKhWmfnBnw' 6-max Seat #2 is the button
Seat 2: vUr8qM1UsCElsCI9B/McdQ ($27.35 in chips) 
Seat 3: l4ToKwb3EVcEuva7hPqMCQ ($8.45 in chips) 
Seat 4: 7NY6Es0O5qlPDxirJ9iU4g ($4.75 in chips) 
Seat 5: EE16Ua5b1HSsYej5zeXOlA ($44 in chips) 
Seat 6: JFIAqU8lCZ0vWwEl4bdGsg ($25 in chips) 
l4ToKwb3EVcEuva7hPqMCQ: posts small blind $0.10
7NY6Es0O5qlPDxirJ9iU4g: posts big blind $0.25
*** HOLE CARDS ***
EE16Ua5b1HSsYej5zeXOlA: folds 
JFIAqU8lCZ0vWwEl4bdGsg: folds 
vUr8qM1UsCElsCI9B/McdQ: calls $0.25
l4ToKwb3EVcEuva7hPqMCQ: folds 
7NY6Es0O5qlPDxirJ9iU4g: checks 
*** FLOP *** [Kd Qd 3h]
deboneman joins the table at seat #1 
7NY6Es0O5qlPDxirJ9iU4g: checks 
vUr8qM1UsCElsCI9B/McdQ: checks 
*** TURN *** [Kd Qd 3h] [9d]
7NY6Es0O5qlPDxirJ9iU4g: checks 
vUr8qM1UsCElsCI9B/McdQ: checks 
*** RIVER *** [Kd Qd 3h 9d] [7d]
7NY6Es0O5qlPDxirJ9iU4g: checks 
vUr8qM1UsCElsCI9B/McdQ: bets $0.25
7NY6Es0O5qlPDxirJ9iU4g: calls $0.25
*** SHOW DOWN ***
vUr8qM1UsCElsCI9B/McdQ: shows [Ah 7c] (a pair of Sevens)
7NY6Es0O5qlPDxirJ9iU4g: shows [Th 7s] (a pair of Sevens - lower kicker)
vUr8qM1UsCElsCI9B/McdQ collected $1.05 from pot
*** SUMMARY ***
Total pot $1.10 | Rake $0.05 
Board [Kd Qd 3h 9d 7d]
Seat 2: vUr8qM1UsCElsCI9B/McdQ (button) showed [Ah 7c] and won ($1.05) with a pair of Sevens
Seat 3: l4ToKwb3EVcEuva7hPqMCQ (small blind) folded before Flop
Seat 4: 7NY6Es0O5qlPDxirJ9iU4g (big blind) showed [Th 7s] and lost with a pair of Sevens
Seat 5: EE16Ua5b1HSsYej5zeXOlA folded before Flop (didn't bet)
Seat 6: JFIAqU8lCZ0vWwEl4bdGsg folded before Flop (didn't bet)




PokerStars Game #59941646574:  Hold'em No Limit ($0.10/$0.25) - 2009/07/01 1:41:44 ET
Table '6wawJ+MkkvuC3coG6r+YhgZiwAqg4o02gNro+JOAaFNgSeat #6 is the button
Seat 1: 6RiVTYll/5D8zICp0MRpKw ($25.20 in chips) 
Seat 2: tYsOBqdU1+x+yFI7zHO7hQ ($31.40 in chips) 
Seat 3: aNpwfA31EREwO+ar4XzBCw ($29 in chips) 
Seat 4: j4q3p0lesp63b1gZDwLBZw ($5.65 in chips) 
Seat 5: 6HoFYfVGBefsR5Vrz62qIw5hAPbqNrvJb8PtLiceXtlg0.10 in chips) 
Seat 6: 5n7e7I+px7c6CQmLpPbtsg ($5 in chips) 
Seat 7: yyG4svzOpC1A+sUP/scg6w ($8.05 in chips) 
Seat 8: VLIsy+xjx3olLSYO3JLS6g ($18.35 in chips) 
Seat 9: ljemhp25Zg+nlA9DLCIiUw ($23.40 in chips) 
yyG4svzOpC1A+sUP/scg6w: posts small blind $0.10
VLIsy+xjx3olLSYO3JLS6g: posts big blind $0.25
*** HOLE CARDS ***
ljemhp25Zg+nlA9DLCIiUw: folds 
6RiVTYll/5D8zICp0MRpKw: folds 
tYsOBqdU1+x+yFI7zHO7hQ: folds 
aNpwfA31EREwO+ar4XzBCw: folds 
j4q3p0lesp63b1gZDwLBZw: calls $0.25
6HoFYfVGBefsR5Vrz62qIw5hAPbqNrvJb8PtLiceXtlglds 
5n7e7I+px7c6CQmLpPbtsg: folds 
yyG4svzOpC1A+sUP/scg6w: folds 
VLIsy+xjx3olLSYO3JLS6g: checks 
*** FLOP *** [3d 2c Ad]
VLIsy+xjx3olLSYO3JLS6g: checks 
j4q3p0lesp63b1gZDwLBZw: bets $0.75
VLIsy+xjx3olLSYO3JLS6g: calls $0.75
*** TURN *** [3d 2c Ad] [5d]
VLIsy+xjx3olLSYO3JLS6g: checks 
j4q3p0lesp63b1gZDwLBZw: bets $2
VLIsy+xjx3olLSYO3JLS6g: calls $2
*** RIVER *** [3d 2c Ad 5d] [2d]
VLIsy+xjx3olLSYO3JLS6g: checks 
j4q3p0lesp63b1gZDwLBZw: checks 
*** SHOW DOWN ***
VLIsy+xjx3olLSYO3JLS6g: shows [6s 5h] (two pair, Fives and Deuces)
j4q3p0lesp63b1gZDwLBZw: shows [4c 4s] (a straight, Ace to Five)
j4q3p0lesp63b1gZDwLBZw collected $5.80 from pot
*** SUMMARY ***
Total pot $6.10 | Rake $0.30 
Board [3d 2c Ad 5d 2d]
Seat 1: 6RiVTYll/5D8zICp0MRpKw folded before Flop (didn't bet)
Seat 2: tYsOBqdU1+x+yFI7zHO7hQ folded before Flop (didn't bet)
Seat 3: aNpwfA31EREwO+ar4XzBCw folded before Flop (didn't bet)
Seat 4: j4q3p0lesp63b1gZDwLBZw showed [4c 4s] and won ($5.80) with a straight, Ace to Five
Seat 5: 6HoFYfVGBefsR5Vrz62qIw5hAPbqNrvJb8PtLiceXtlgded before Flop (didn't bet)
Seat 6: 5n7e7I+px7c6CQmLpPbtsg (button) folded before Flop (didn't bet)
Seat 7: yyG4svzOpC1A+sUP/scg6w (small blind) folded before Flop
Seat 8: VLIsy+xjx3olLSYO3JLS6g (big blind) showed [6s 5h] and lost with two pair, Fives and Deuces
Seat 9: ljemhp25Zg+nlA9DLCIiUw folded before Flop (didn't bet)




PokerStars Game #59941647038:  Hold'em No Limit ($0.10/$0.25) - 2009/07/01 1:41:45 ET
Table 'IuqVbFI+pwnJjvwBCGSGAw' 6-max Seat #1 is the button
Seat 1: LyDHtw3/yniNHW+DvLXbog ($25 in chips) 
Seat 2: wsP46AGpqDjHZQmlRHKa9g ($25.55 in chips) 
Seat 3: QiL+lEgEWwy21jk/ltaRLg ($22.60 in chips) 
Seat 5: if4dh6jhJXeN3/qd3qCp9g ($25 in chips) 
Seat 6: SJ5z7oeRzpbFT7jU55Mbag ($37.40 in chips) 
wsP46AGpqDjHZQmlRHKa9g: posts small blind $0.10
QiL+lEgEWwy21jk/ltaRLg: posts big blind $0.25
DE9hRlt14g+JdsRQ4wT7hg: sits out 
*** HOLE CARDS ***
if4dh6jhJXeN3/qd3qCp9g: folds 
SJ5z7oeRzpbFT7jU55Mbag: calls $0.25
LyDHtw3/yniNHW+DvLXbog: raises $0.75 to $1
wsP46AGpqDjHZQmlRHKa9g: folds 
QiL+lEgEWwy21jk/ltaRLg: folds 
SJ5z7oeRzpbFT7jU55Mbag: calls $0.75
*** FLOP *** [3c 4d Kc]
SJ5z7oeRzpbFT7jU55Mbag: checks 
LyDHtw3/yniNHW+DvLXbog: bets $1.50
SJ5z7oeRzpbFT7jU55Mbag: folds 
Uncalled bet ($1.50) returned to LyDHtw3/yniNHW+DvLXbog
LyDHtw3/yniNHW+DvLXbog collected $2.25 from pot
LyDHtw3/yniNHW+DvLXbog: doesn't show hand 
*** SUMMARY ***
Total pot $2.35 | Rake $0.10 
Board [3c 4d Kc]
Seat 1: LyDHtw3/yniNHW+DvLXbog (button) collected ($2.25)
Seat 2: wsP46AGpqDjHZQmlRHKa9g (small blind) folded before Flop
Seat 3: QiL+lEgEWwy21jk/ltaRLg (big blind) folded before Flop
Seat 5: if4dh6jhJXeN3/qd3qCp9g folded before Flop (didn't bet)
Seat 6: SJ5z7oeRzpbFT7jU55Mbag folded on the Flop




PokerStars Game #59941646976:  Hold'em No Limit ($0.10/$0.25) - 2009/07/01 1:41:45 ET
Table '3Ns9nuTkynfwbBfBXzg6ww' 6-max Seat #4 is the button
Seat 2: zxeVQGaMKDsDzmSY+AInjA ($33.60 in chips) 
Seat 3: eL3+wCBjFGfQ5FMdIZihwA ($24.65 in chips) 
Seat 4: qGHGf/553gQnDoklMRe3tg ($30.95 in chips) 
Seat 5: wqphQtauX5Qn7WRJZS1flA ($25.15 in chips) 
Seat 6: DE9hRlt14g+JdsRQ4wT7hg ($36.05 in chips) 
wqphQtauX5Qn7WRJZS1flA: posts small blind $0.10
DE9hRlt14g+JdsRQ4wT7hg: posts big blind $0.25
epAUIB7h2FJXzUPRIvSkRA: sits out 
*** HOLE CARDS ***
zxeVQGaMKDsDzmSY+AInjA: calls $0.25
eL3+wCBjFGfQ5FMdIZihwA: folds 
qGHGf/553gQnDoklMRe3tg: folds 
wqphQtauX5Qn7WRJZS1flA: raises $0.75 to $1
DE9hRlt14g+JdsRQ4wT7hg: folds 
zxeVQGaMKDsDzmSY+AInjA: folds 
Uncalled bet ($0.75) returned to wqphQtauX5Qn7WRJZS1flA
wqphQtauX5Qn7WRJZS1flA collected $0.75 from pot
wqphQtauX5Qn7WRJZS1flA: doesn't show hand 
*** SUMMARY ***
Total pot $0.75 | Rake $0 
Seat 2: zxeVQGaMKDsDzmSY+AInjA folded before Flop
Seat 3: eL3+wCBjFGfQ5FMdIZihwA folded before Flop (didn't bet)
Seat 4: qGHGf/553gQnDoklMRe3tg (button) folded before Flop (didn't bet)
Seat 5: wqphQtauX5Qn7WRJZS1flA (small blind) collected ($0.75)
Seat 6: DE9hRlt14g+JdsRQ4wT7hg (big blind) folded before Flop




PokerStars Game #59941646856:  Hold'em No Limit ($0.10/$0.25) - 2009/07/01 1:41:45 ET
Table 'emoxgHTxg9Uqeu06oLzLyg' 6-max Seat #3 is the button
Seat 1: QuJ87sC/OOZv/rYCnQDgUw ($24.05 in chips) 
Seat 2: wIFhgE1PVdX6Xf6aVlSTPg ($25.60 in chips) 
Seat 3: uD5epdBxuyc30pF1dO958Q ($10.80 in chips) 
Seat 4: 3VAbqAWh8ncE2SJOYIx2ZQ ($11.55 in chips) 
Seat 5: ZmsNNfGxipD8dY5iwrlOXQ ($8.90 in chips) 
Seat 6: iHZrkhpIO/3+tKuAoPx8HQ ($3.15 in chips) 
3VAbqAWh8ncE2SJOYIx2ZQ: posts small blind $0.10
ZmsNNfGxipD8dY5iwrlOXQ: posts big blind $0.25
*** HOLE CARDS ***
iHZrkhpIO/3+tKuAoPx8HQ: calls $0.25
QuJ87sC/OOZv/rYCnQDgUw: folds 
QuJ87sC/OOZv/rYCnQDgUw leaves the table
wIFhgE1PVdX6Xf6aVlSTPg: folds 
uD5epdBxuyc30pF1dO958Q: calls $0.25
3VAbqAWh8ncE2SJOYIx2ZQ: calls $0.15
ZmsNNfGxipD8dY5iwrlOXQ: folds 
*** FLOP *** [6c 9h Ks]
ZmsNNfGxipD8dY5iwrlOXQ leaves the table
3VAbqAWh8ncE2SJOYIx2ZQ: checks 
iHZrkhpIO/3+tKuAoPx8HQ: checks 
uD5epdBxuyc30pF1dO958Q: bets $0.25
3VAbqAWh8ncE2SJOYIx2ZQ: folds 
iHZrkhpIO/3+tKuAoPx8HQ: folds 
Uncalled bet ($0.25) returned to uD5epdBxuyc30pF1dO958Q
uD5epdBxuyc30pF1dO958Q collected $0.95 from pot
*** SUMMARY ***
Total pot $1 | Rake $0.05 
Board [6c 9h Ks]
Seat 1: QuJ87sC/OOZv/rYCnQDgUw folded before Flop (didn't bet)
Seat 2: wIFhgE1PVdX6Xf6aVlSTPg folded before Flop (didn't bet)
Seat 3: uD5epdBxuyc30pF1dO958Q (button) collected ($0.95)
Seat 4: 3VAbqAWh8ncE2SJOYIx2ZQ (small blind) folded on the Flop
Seat 5: ZmsNNfGxipD8dY5iwrlOXQ (big blind) folded before Flop
Seat 6: iHZrkhpIO/3+tKuAoPx8HQ folded on the Flop




PokerStars Game #59941647058:  Hold'em No Limit ($0.10/$0.25) - 2009/07/01 1:41:45 ET
Table 'HzFR0rxmDAPu5GzYR0AlYg' 6-max Seat #1 is the button
Seat 1: v+QfkGiuj9bgtuNoVnDO8w ($30.30 in chips) 
Seat 2: UA5OsKS3VPaxa7uC8La/kA ($53.10 in chips) 
Seat 3: kG34n23qFQA3nzdOJTQ1dA ($24.65 in chips) 
Seat 4: 8tR2s7yV/Fr0ePp1w5XnJw ($9.25 in chips) 
Seat 5: lquriepNQBhDV5P1SWHhnA ($30.20 in chips) 
Seat 6: jp34e617tIzV8tKIWmfAbA ($34.50 in chips) 
UA5OsKS3VPaxa7uC8La/kA: posts small blind $0.10
kG34n23qFQA3nzdOJTQ1dA: posts big blind $0.25
*** HOLE CARDS ***
8tR2s7yV/Fr0ePp1w5XnJw: folds 
lquriepNQBhDV5P1SWHhnA: folds 
8tR2s7yV/Fr0ePp1w5XnJw leaves the table
jp34e617tIzV8tKIWmfAbA: folds 
v+QfkGiuj9bgtuNoVnDO8w: folds 
UA5OsKS3VPaxa7uC8La/kA: folds 
Uncalled bet ($0.15) returned to kG34n23qFQA3nzdOJTQ1dA
kG34n23qFQA3nzdOJTQ1dA collected $0.20 from pot
*** SUMMARY ***
Total pot $0.20 | Rake $0 
Seat 1: v+QfkGiuj9bgtuNoVnDO8w (button) folded before Flop (didn't bet)
Seat 2: UA5OsKS3VPaxa7uC8La/kA (small blind) folded before Flop
Seat 3: kG34n23qFQA3nzdOJTQ1dA (big blind) collected ($0.20)
Seat 4: 8tR2s7yV/Fr0ePp1w5XnJw folded before Flop (didn't bet)
Seat 5: lquriepNQBhDV5P1SWHhnA folded before Flop (didn't bet)
Seat 6: jp34e617tIzV8tKIWmfAbA folded before Flop (didn't bet)




PokerStars Game #59941647078:  Hold'em No Limit ($0.10/$0.25) - 2009/07/01 1:41:45 ET
Table 'rO1I30HnuCPB0M8qEX1TCQ' 9-max Seat #3 is the button
Seat 1: dfsOFy2nKDeSF9SjtdIyVA ($12.50 in chips) 
Seat 2: z1hPotrGOZjUjyoopZ7Ulg ($20.30 in chips) 
Seat 3: 2wcFsZsqEP5w1StUTVzJCg ($13.15 in chips) 
Seat 4: yyG4svzOpC1A+sUP/scg6w ($10.50 in chips) 
Seat 5: W6tExOcYX7qiy6Qdp+ZwFA ($5.45 in chips) 
Seat 8: 6mStmDUknIn/RyBEoiIyoQ ($3.20 in chips) 
Seat 9: AiXn/9o1EwOPZUHujnh/bA ($21.90 in chips) 
yyG4svzOpC1A+sUP/scg6w: posts small blind $0.10
W6tExOcYX7qiy6Qdp+ZwFA: posts big blind $0.25
5n7e7I+px7c6CQmLpPbtsg: sits out 
bXpVeaSTPBFSPJmeXxO7nw: sits out 
*** HOLE CARDS ***
6mStmDUknIn/RyBEoiIyoQ: folds 
AiXn/9o1EwOPZUHujnh/bA: folds 
dfsOFy2nKDeSF9SjtdIyVA: folds 
z1hPotrGOZjUjyoopZ7Ulg: raises $0.50 to $0.75
2wcFsZsqEP5w1StUTVzJCg: folds 
yyG4svzOpC1A+sUP/scg6w: folds 
W6tExOcYX7qiy6Qdp+ZwFA: folds 
Uncalled bet ($0.50) returned to z1hPotrGOZjUjyoopZ7Ulg
z1hPotrGOZjUjyoopZ7Ulg collected $0.60 from pot
*** SUMMARY ***
Total pot $0.60 | Rake $0 
Seat 1: dfsOFy2nKDeSF9SjtdIyVA folded before Flop (didn't bet)
Seat 2: z1hPotrGOZjUjyoopZ7Ulg collected ($0.60)
Seat 3: 2wcFsZsqEP5w1StUTVzJCg (button) folded before Flop (didn't bet)
Seat 4: yyG4svzOpC1A+sUP/scg6w (small blind) folded before Flop
Seat 5: W6tExOcYX7qiy6Qdp+ZwFA (big blind) folded before Flop
Seat 8: 6mStmDUknIn/RyBEoiIyoQ folded before Flop (didn't bet)
Seat 9: AiXn/9o1EwOPZUHujnh/bA folded before Flop (didn't bet)




PokerStars Game #59941647892:  Hold'em No Limit ($0.10/$0.25) - 2009/07/01 1:41:46 ET
Table 'nXVbUw6/HYwA6x21+IZ3XQ' 9-max Seat #3 is the button
Seat 2: 9lvO/qyU+xrU95Teu1fv0g ($4.65 in chips) 
Seat 3: 7je+LC5Mfs6nL8YBVh4frQ ($6.40 in chips) 
Seat 4: H5Se03ZqSX7tbULXur2MAg ($23.95 in chips) 
Seat 6: ljemhp25Zg+nlA9DLCIiUw ($26.75 in chips) 
Seat 7: ShCS62CJp4MKfKLKvGKQbA ($12.50 in chips) 
Seat 8: dfNim92Z6XK1/h5SFW5vDg ($27.15 in chips) 
Seat 9: OTCjTlu92MEBtX/i9Gm7yA ($12.80 in chips) 
H5Se03ZqSX7tbULXur2MAg: posts small blind $0.10
ljemhp25Zg+nlA9DLCIiUw: posts big blind $0.25
*** HOLE CARDS ***
ShCS62CJp4MKfKLKvGKQbA: folds 
dfNim92Z6XK1/h5SFW5vDg: folds 
OTCjTlu92MEBtX/i9Gm7yA: folds 
9lvO/qyU+xrU95Teu1fv0g: folds 
7je+LC5Mfs6nL8YBVh4frQ: folds 
H5Se03ZqSX7tbULXur2MAg: folds 
Uncalled bet ($0.15) returned to ljemhp25Zg+nlA9DLCIiUw
H5Se03ZqSX7tbULXur2MAg leaves the table
ljemhp25Zg+nlA9DLCIiUw collected $0.20 from pot
ljemhp25Zg+nlA9DLCIiUw: doesn't show hand 
*** SUMMARY ***
Total pot $0.20 | Rake $0 
Seat 2: 9lvO/qyU+xrU95Teu1fv0g folded before Flop (didn't bet)
Seat 3: 7je+LC5Mfs6nL8YBVh4frQ (button) folded before Flop (didn't bet)
Seat 4: H5Se03ZqSX7tbULXur2MAg (small blind) folded before Flop
Seat 6: ljemhp25Zg+nlA9DLCIiUw (big blind) collected ($0.20)
Seat 7: ShCS62CJp4MKfKLKvGKQbA folded before Flop (didn't bet)
Seat 8: dfNim92Z6XK1/h5SFW5vDg folded before Flop (didn't bet)
Seat 9: OTCjTlu92MEBtX/i9Gm7yA folded before Flop (didn't bet)




PokerStars Game #59941647750:  Hold'em No Limit ($0.10/$0.25) - 2009/07/01 1:41:46 ET
Table 'JJzUs04lHpXg6nboT1/jeg' 6-max Seat #5 is the button
Seat 1: MqMK8OWPSY1V4stf1Hy5Jw ($38.95 in chips) 
Seat 2: jxfR29d+dK/7h7s3SvCk+g ($5.20 in chips) 
Seat 3: 4zXbHDe39qNX46dAo81b4w ($6.95 in chips) 
Seat 4: 7VfhiFY533nbUKvyEthASw ($29.85 in chips) 
Seat 5: QvTX2yGq3uKJiKPmns4TKQ ($20.75 in chips) 
Seat 6: wqphQtauX5Qn7WRJZS1flA ($31.15 in chips) 
wqphQtauX5Qn7WRJZS1flA: posts small blind $0.10
MqMK8OWPSY1V4stf1Hy5Jw: posts big blind $0.25
*** HOLE CARDS ***
jxfR29d+dK/7h7s3SvCk+g: folds 
4zXbHDe39qNX46dAo81b4w: folds 
7VfhiFY533nbUKvyEthASw: folds 
QvTX2yGq3uKJiKPmns4TKQ: folds 
wqphQtauX5Qn7WRJZS1flA: folds 
Uncalled bet ($0.15) returned to MqMK8OWPSY1V4stf1Hy5Jw
MqMK8OWPSY1V4stf1Hy5Jw collected $0.20 from pot
MqMK8OWPSY1V4stf1Hy5Jw: doesn't show hand 
*** SUMMARY ***
Total pot $0.20 | Rake $0 
Seat 1: MqMK8OWPSY1V4stf1Hy5Jw (big blind) collected ($0.20)
Seat 2: jxfR29d+dK/7h7s3SvCk+g folded before Flop (didn't bet)
Seat 3: 4zXbHDe39qNX46dAo81b4w folded before Flop (didn't bet)
Seat 4: 7VfhiFY533nbUKvyEthASw folded before Flop (didn't bet)
Seat 5: QvTX2yGq3uKJiKPmns4TKQ (button) folded before Flop (didn't bet)
Seat 6: wqphQtauX5Qn7WRJZS1flA (small blind) folded before Flop




PokerStars Game #59941647786:  Hold'em No Limit ($0.10/$0.25) - 2009/07/01 1:41:46 ET
Table 'ukli1Y7ieC5JQMTEFxM2Nw' 6-max Seat #2 is the button
Seat 1: N162H80ZIQevUf2EzGahCA ($10.05 in chips) 
Seat 2: u/yN5P9f3KlATg6WLWNkBQ ($43.55 in chips) 
Seat 3: ExeoJ1G/rSmWa3tRz7TlCA ($21.20 in chips) 
Seat 4: if4dh6jhJXeN3/qd3qCp9g ($29.85 in chips) 
Seat 5: Se+H4Z4PDr6+eIUDJX1rpg ($15.70 in chips) 
Seat 6: 32YL2ZEp8NT4JB2RVM9euQ ($29.55 in chips) 
ExeoJ1G/rSmWa3tRz7TlCA: posts small blind $0.10
if4dh6jhJXeN3/qd3qCp9g: posts big blind $0.25
*** HOLE CARDS ***
Se+H4Z4PDr6+eIUDJX1rpg: calls $0.25
32YL2ZEp8NT4JB2RVM9euQ: folds 
N162H80ZIQevUf2EzGahCA: folds 
u/yN5P9f3KlATg6WLWNkBQ: folds 
ExeoJ1G/rSmWa3tRz7TlCA: calls $0.15
if4dh6jhJXeN3/qd3qCp9g: checks 
*** FLOP *** [Qc Qh 2h]
ExeoJ1G/rSmWa3tRz7TlCA: checks 
if4dh6jhJXeN3/qd3qCp9g: checks 
Se+H4Z4PDr6+eIUDJX1rpg: checks 
*** TURN *** [Qc Qh 2h] [9c]
ExeoJ1G/rSmWa3tRz7TlCA: checks 
if4dh6jhJXeN3/qd3qCp9g: checks 
Se+H4Z4PDr6+eIUDJX1rpg: bets $0.75
ExeoJ1G/rSmWa3tRz7TlCA: calls $0.75
if4dh6jhJXeN3/qd3qCp9g: folds 
*** RIVER *** [Qc Qh 2h 9c] [Ah]
ExeoJ1G/rSmWa3tRz7TlCA: checks 
Se+H4Z4PDr6+eIUDJX1rpg: checks 
*** SHOW DOWN ***
ExeoJ1G/rSmWa3tRz7TlCA: shows [Jd Kh] (a pair of Queens)
Se+H4Z4PDr6+eIUDJX1rpg: shows [7d 9d] (two pair, Queens and Nines)
Se+H4Z4PDr6+eIUDJX1rpg collected $2.15 from pot
*** SUMMARY ***
Total pot $2.25 | Rake $0.10 
Board [Qc Qh 2h 9c Ah]
Seat 1: N162H80ZIQevUf2EzGahCA folded before Flop (didn't bet)
Seat 2: u/yN5P9f3KlATg6WLWNkBQ (button) folded before Flop (didn't bet)
Seat 3: ExeoJ1G/rSmWa3tRz7TlCA (small blind) showed [Jd Kh] and lost with a pair of Queens
Seat 4: if4dh6jhJXeN3/qd3qCp9g (big blind) folded on the Turn
Seat 5: Se+H4Z4PDr6+eIUDJX1rpg showed [7d 9d] and won ($2.15) with two pair, Queens and Nines
Seat 6: 32YL2ZEp8NT4JB2RVM9euQ folded before Flop (didn't bet)




PokerStars Game #59941647728:  Hold'em No Limit ($0.10/$0.25) - 2009/07/01 1:41:46 ET
Table 'jdhJTJjFq2KTttwJcd+7nQ' 6-max Seat #1 is the button
Seat 1: LtASJ9OlkqGrrUKGQlpGAw ($27.20 in chips) 
Seat 2: Hsvkc0/G2VV78oVmWYXecw ($5 in chips) 
Seat 3: vqWjZmdQu/Hxw96/IJTWdQ ($25.70 in chips) 
Seat 4: vx7FwRcelVSsvNYAdp/z0A ($3.50 in chips) 
Seat 5: BV+K0Phf5VBHr7aZPKqbUQ ($26 in chips) 
Seat 6: yb6rnd48JuBccThV68VHAQ ($19.90 in chips) 
Hsvkc0/G2VV78oVmWYXecw: posts small blind $0.10
vqWjZmdQu/Hxw96/IJTWdQ: posts big blind $0.25
*** HOLE CARDS ***
vx7FwRcelVSsvNYAdp/z0A: folds 
BV+K0Phf5VBHr7aZPKqbUQ: folds 
yb6rnd48JuBccThV68VHAQ: calls $0.25
LtASJ9OlkqGrrUKGQlpGAw: folds 
Hsvkc0/G2VV78oVmWYXecw: folds 
vqWjZmdQu/Hxw96/IJTWdQ: checks 
*** FLOP *** [4h 8h 7d]
vqWjZmdQu/Hxw96/IJTWdQ: bets $0.50
yb6rnd48JuBccThV68VHAQ: folds 
Uncalled bet ($0.50) returned to vqWjZmdQu/Hxw96/IJTWdQ
vqWjZmdQu/Hxw96/IJTWdQ collected $0.60 from pot
vqWjZmdQu/Hxw96/IJTWdQ: doesn't show hand 
*** SUMMARY ***
Total pot $0.60 | Rake $0 
Board [4h 8h 7d]
Seat 1: LtASJ9OlkqGrrUKGQlpGAw (button) folded before Flop (didn't bet)
Seat 2: Hsvkc0/G2VV78oVmWYXecw (small blind) folded before Flop
Seat 3: vqWjZmdQu/Hxw96/IJTWdQ (big blind) collected ($0.60)
Seat 4: vx7FwRcelVSsvNYAdp/z0A folded before Flop (didn't bet)
Seat 5: BV+K0Phf5VBHr7aZPKqbUQ folded before Flop (didn't bet)
Seat 6: yb6rnd48JuBccThV68VHAQ folded on the Flop




PokerStars Game #59941647526:  Hold'em No Limit ($0.10/$0.25) - 2009/07/01 1:41:46 ET
Table 'UVjmXTtsmlX1HxwwZ59akg' 9-max Seat #1 is the button
Seat 1: zDrucyjVn5aeekNEc3cJrA ($47.85 in chips) 
Seat 2: q+Qdg0Hoir+SyL7haBrUnw ($8.15 in chips) 
Seat 3: GmzfAfxcxu1kGbPC+9LkVg ($25 in chips) 
Seat 4: X78b5v/uhqeXXoAijbw/yg ($25 in chips) 
Seat 5: Bb42QRQMhg5/Y0vHP8/2Xw ($39.60 in chips) 
Seat 6: st9jtdNbm1W5GfBwRaCVqQ ($24.30 in chips) 
Seat 7: pB8IyCfDFZaVpov3NHEVJg ($25.25 in chips) 
Seat 8: aqxuKnMZWHy08QjWq1+MrQ ($2.40 in chips) 
q+Qdg0Hoir+SyL7haBrUnw: posts small blind $0.10
GmzfAfxcxu1kGbPC+9LkVg: posts big blind $0.25
ljemhp25Zg+nlA9DLCIiUw: sits out 
*** HOLE CARDS ***
X78b5v/uhqeXXoAijbw/yg: folds 
Bb42QRQMhg5/Y0vHP8/2Xw: raises $0.50 to $0.75
st9jtdNbm1W5GfBwRaCVqQ: folds 
pB8IyCfDFZaVpov3NHEVJg: folds 
aqxuKnMZWHy08QjWq1+MrQ: folds 
zDrucyjVn5aeekNEc3cJrA: folds 
zDrucyjVn5aeekNEc3cJrA is sitting out
q+Qdg0Hoir+SyL7haBrUnw: folds 
GmzfAfxcxu1kGbPC+9LkVg: folds 
Uncalled bet ($0.50) returned to Bb42QRQMhg5/Y0vHP8/2Xw
Bb42QRQMhg5/Y0vHP8/2Xw collected $0.60 from pot
*** SUMMARY ***
Total pot $0.60 | Rake $0 
Seat 1: zDrucyjVn5aeekNEc3cJrA (button) folded before Flop (didn't bet)
Seat 2: q+Qdg0Hoir+SyL7haBrUnw (small blind) folded before Flop
Seat 3: GmzfAfxcxu1kGbPC+9LkVg (big blind) folded before Flop
Seat 4: X78b5v/uhqeXXoAijbw/yg folded before Flop (didn't bet)
Seat 5: Bb42QRQMhg5/Y0vHP8/2Xw collected ($0.60)
Seat 6: st9jtdNbm1W5GfBwRaCVqQ folded before Flop (didn't bet)
Seat 7: pB8IyCfDFZaVpov3NHEVJg folded before Flop (didn't bet)
Seat 8: aqxuKnMZWHy08QjWq1+MrQ folded before Flop (didn't bet)




PokerStars Game #59941647662:  Hold'em No Limit ($0.10/$0.25) - 2009/07/01 1:41:46 ET
Table 'z2yOdY2zyGWG1gh9WV9XtQ' 9-max Seat #9 is the button
Seat 1: 7je+LC5Mfs6nL8YBVh4frQ ($4.75 in chips) 
Seat 2: bXpVeaSTPBFSPJmeXxO7nw ($5 in chips) 
Seat 3: X78b5v/uhqeXXoAijbw/yg ($27.75 in chips) 
Seat 4: 4awUyiDYTgylQKXZ9faBVA ($39.80 in chips) 
Seat 5: W6tExOcYX7qiy6Qdp+ZwFA ($10.55 in chips) 
Seat 6: NBYmTySMtIicyMj5Vjzqhw ($21.80 in chips) 
Seat 8: Mh2r9hTeTEDnh19sRZtW3g ($7.15 in chips) 
Seat 9: wGigCmBR/9XWkPpvYos3aQ ($34.05 in chips) 
7je+LC5Mfs6nL8YBVh4frQ: posts small blind $0.10
bXpVeaSTPBFSPJmeXxO7nw: posts big blind $0.25
*** HOLE CARDS ***
X78b5v/uhqeXXoAijbw/yg: folds 
4awUyiDYTgylQKXZ9faBVA: folds 
W6tExOcYX7qiy6Qdp+ZwFA: folds 
NBYmTySMtIicyMj5Vjzqhw: folds 
Mh2r9hTeTEDnh19sRZtW3g: raises $0.50 to $0.75
wGigCmBR/9XWkPpvYos3aQ: folds 
7je+LC5Mfs6nL8YBVh4frQ: folds 
bXpVeaSTPBFSPJmeXxO7nw: folds 
Uncalled bet ($0.50) returned to Mh2r9hTeTEDnh19sRZtW3g
Mh2r9hTeTEDnh19sRZtW3g collected $0.60 from pot
Mh2r9hTeTEDnh19sRZtW3g: doesn't show hand 
*** SUMMARY ***
Total pot $0.60 | Rake $0 
Seat 1: 7je+LC5Mfs6nL8YBVh4frQ (small blind) folded before Flop
Seat 2: bXpVeaSTPBFSPJmeXxO7nw (big blind) folded before Flop
Seat 3: X78b5v/uhqeXXoAijbw/yg folded before Flop (didn't bet)
Seat 4: 4awUyiDYTgylQKXZ9faBVA folded before Flop (didn't bet)
Seat 5: W6tExOcYX7qiy6Qdp+ZwFA folded before Flop (didn't bet)
Seat 6: NBYmTySMtIicyMj5Vjzqhw folded before Flop (didn't bet)
Seat 8: Mh2r9hTeTEDnh19sRZtW3g collected ($0.60)
Seat 9: wGigCmBR/9XWkPpvYos3aQ (button) folded before Flop (didn't bet)




PokerStars Game #59941647778:  Hold'em No Limit ($0.10/$0.25) - 2009/07/01 1:41:46 ET
Table 'G26g8jde1eR+mmabeFeSlw' 9-max Seat #4 is the button
Seat 1: qpG9m8I+cPw8VhB0mnGjYw ($29.40 in chips) 
Seat 2: BFYwQ0J4xWUQvouudojivA ($15.85 in chips) 
Seat 3: WKL8nUFr7TumC4EjLyqYzw ($6.50 in chips) 
Seat 4: 8EbrQ/EvFWt2cr0GaU82gQ ($4.65 in chips) 
Seat 5: hJ4uYjNmSZdjrKA8cjZqCA ($30.80 in chips) 
Seat 6: AHGkesF/mi4sDMpqrxBUoA ($9.05 in chips) 
Seat 7: nm4Dj/f+jJEwKVsUnKh73g ($38.80 in chips) 
Seat 8: bXpVeaSTPBFSPJmeXxO7nw ($5.35 in chips) 
Seat 9: VWUWpMLMj/Q1jRVpF7Aohw ($3.90 in chips) 
hJ4uYjNmSZdjrKA8cjZqCA: posts small blind $0.10
AHGkesF/mi4sDMpqrxBUoA: posts big blind $0.25
*** HOLE CARDS ***
nm4Dj/f+jJEwKVsUnKh73g: calls $0.25
bXpVeaSTPBFSPJmeXxO7nw has timed out
bXpVeaSTPBFSPJmeXxO7nw: folds 
bXpVeaSTPBFSPJmeXxO7nw is sitting out
bXpVeaSTPBFSPJmeXxO7nw leaves the table
VWUWpMLMj/Q1jRVpF7Aohw: calls $0.25
qpG9m8I+cPw8VhB0mnGjYw: folds 
BFYwQ0J4xWUQvouudojivA: calls $0.25
WKL8nUFr7TumC4EjLyqYzw: folds 
8EbrQ/EvFWt2cr0GaU82gQ: folds 
hJ4uYjNmSZdjrKA8cjZqCA: folds 
CvL9Ch1HYCVbTsfpNucitg joins the table at seat #8 
AHGkesF/mi4sDMpqrxBUoA has timed out
AHGkesF/mi4sDMpqrxBUoA: checks 
*** FLOP *** [4h 2h 5s]
AHGkesF/mi4sDMpqrxBUoA: checks 
nm4Dj/f+jJEwKVsUnKh73g: bets $0.25
VWUWpMLMj/Q1jRVpF7Aohw: folds 
BFYwQ0J4xWUQvouudojivA: calls $0.25
AHGkesF/mi4sDMpqrxBUoA: folds 
*** TURN *** [4h 2h 5s] [9s]
nm4Dj/f+jJEwKVsUnKh73g: checks 
BFYwQ0J4xWUQvouudojivA: checks 
*** RIVER *** [4h 2h 5s 9s] [7c]
nm4Dj/f+jJEwKVsUnKh73g: checks 
BFYwQ0J4xWUQvouudojivA: checks 
*** SHOW DOWN ***
nm4Dj/f+jJEwKVsUnKh73g: shows [8h 8s] (a pair of Eights)
BFYwQ0J4xWUQvouudojivA: mucks hand 
nm4Dj/f+jJEwKVsUnKh73g collected $1.55 from pot
*** SUMMARY ***
Total pot $1.60 | Rake $0.05 
Board [4h 2h 5s 9s 7c]
Seat 1: qpG9m8I+cPw8VhB0mnGjYw folded before Flop (didn't bet)
Seat 2: BFYwQ0J4xWUQvouudojivA mucked
Seat 3: WKL8nUFr7TumC4EjLyqYzw folded before Flop (didn't bet)
Seat 4: 8EbrQ/EvFWt2cr0GaU82gQ (button) folded before Flop (didn't bet)
Seat 5: hJ4uYjNmSZdjrKA8cjZqCA (small blind) folded before Flop
Seat 6: AHGkesF/mi4sDMpqrxBUoA (big blind) folded on the Flop
Seat 7: nm4Dj/f+jJEwKVsUnKh73g showed [8h 8s] and won ($1.55) with a pair of Eights
Seat 8: bXpVeaSTPBFSPJmeXxO7nw folded before Flop (didn't bet)
Seat 9: VWUWpMLMj/Q1jRVpF7Aohw folded on the Flop




PokerStars Game #59941648080:  Hold'em No Limit ($0.10/$0.25) - 2009/07/01 1:41:47 ET
Table '8QBBaev+cI2i/r2H6ml/lg' 9-max Seat #1 is the button
Seat 1: s2xLPOl/vhl/26apJ3vsOQ ($32.70 in chips) 
Seat 3: zgi+EUykT/pZQpoUG6+oEg ($4.40 in chips) 
Seat 4: ytpGB2nr/CLVHnyKMRiEFQ ($15 in chips) 
Seat 5: 0QdZrkFD7aGKeBXPGbIomA ($11.70 in chips) 
Seat 6: X6+pSIPfovPcE87t+LmUKQ ($5 in chips) 
Seat 7: eK8qa6EPcH2zhtbmWSvc9g ($31.05 in chips) 
Seat 8: vr1IK/Q4HXm8s8V0/dePzQ ($12.80 in chips) 
Seat 9: EUMLvzDkECHBit+xa+uGjg ($24.75 in chips) 
zgi+EUykT/pZQpoUG6+oEg: posts small blind $0.10
ytpGB2nr/CLVHnyKMRiEFQ: posts big blind $0.25
X6+pSIPfovPcE87t+LmUKQ: posts big blind $0.25
*** HOLE CARDS ***
y7tkvDmwKjURBkr73SZPXw joins the table at seat #2 
0QdZrkFD7aGKeBXPGbIomA: folds 
X6+pSIPfovPcE87t+LmUKQ: checks 
eK8qa6EPcH2zhtbmWSvc9g: folds 
vr1IK/Q4HXm8s8V0/dePzQ: calls $0.25
EUMLvzDkECHBit+xa+uGjg: folds 
s2xLPOl/vhl/26apJ3vsOQ: folds 
zgi+EUykT/pZQpoUG6+oEg: folds 
ytpGB2nr/CLVHnyKMRiEFQ: checks 
*** FLOP *** [As Kh 4h]
ytpGB2nr/CLVHnyKMRiEFQ: checks 
X6+pSIPfovPcE87t+LmUKQ: checks 
vr1IK/Q4HXm8s8V0/dePzQ: bets $0.50
ytpGB2nr/CLVHnyKMRiEFQ: calls $0.50
X6+pSIPfovPcE87t+LmUKQ: folds 
*** TURN *** [As Kh 4h] [7s]
ytpGB2nr/CLVHnyKMRiEFQ: checks 
vr1IK/Q4HXm8s8V0/dePzQ: checks 
*** RIVER *** [As Kh 4h 7s] [7c]
ytpGB2nr/CLVHnyKMRiEFQ: bets $1
vr1IK/Q4HXm8s8V0/dePzQ: folds 
Uncalled bet ($1) returned to ytpGB2nr/CLVHnyKMRiEFQ
ytpGB2nr/CLVHnyKMRiEFQ collected $1.80 from pot
*** SUMMARY ***
Total pot $1.85 | Rake $0.05 
Board [As Kh 4h 7s 7c]
Seat 1: s2xLPOl/vhl/26apJ3vsOQ (button) folded before Flop (didn't bet)
Seat 3: zgi+EUykT/pZQpoUG6+oEg (small blind) folded before Flop
Seat 4: ytpGB2nr/CLVHnyKMRiEFQ (big blind) collected ($1.80)
Seat 5: 0QdZrkFD7aGKeBXPGbIomA folded before Flop (didn't bet)
Seat 6: X6+pSIPfovPcE87t+LmUKQ folded on the Flop
Seat 7: eK8qa6EPcH2zhtbmWSvc9g folded before Flop (didn't bet)
Seat 8: vr1IK/Q4HXm8s8V0/dePzQ folded on the River
Seat 9: EUMLvzDkECHBit+xa+uGjg folded before Flop (didn't bet)




PokerStars Game #59941648278:  Hold'em No Limit ($0.10/$0.25) - 2009/07/01 1:41:47 ET
Table 'BpNkESDX1ip9c0K1hb5h7A' 6-max Seat #4 is the button
Seat 2: g+5jEA4Xq9vcMOfdFYNuFA ($10.70 in chips) 
Seat 3: fZQg9veL7Dd/Z04ZTjC+wQ ($25.60 in chips) 
Seat 4: kG34n23qFQA3nzdOJTQ1dA ($26.15 in chips) 
Seat 5: L3/N/gliETan8N5Gim5h4Q ($25.25 in chips) 
Seat 6: 8EEqTTh7T1q48sYDqbI2Xg ($21.65 in chips) 
L3/N/gliETan8N5Gim5h4Q: posts small blind $0.10
8EEqTTh7T1q48sYDqbI2Xg: posts big blind $0.25
sam030684: sits out 
*** HOLE CARDS ***
g+5jEA4Xq9vcMOfdFYNuFA: folds 
fZQg9veL7Dd/Z04ZTjC+wQ: folds 
kG34n23qFQA3nzdOJTQ1dA: calls $0.25
L3/N/gliETan8N5Gim5h4Q: calls $0.15
8EEqTTh7T1q48sYDqbI2Xg: checks 
*** FLOP *** [Jc Tc Ac]
L3/N/gliETan8N5Gim5h4Q: checks 
8EEqTTh7T1q48sYDqbI2Xg: checks 
kG34n23qFQA3nzdOJTQ1dA: checks 
*** TURN *** [Jc Tc Ac] [Th]
L3/N/gliETan8N5Gim5h4Q: bets $0.75
8EEqTTh7T1q48sYDqbI2Xg: folds 
kG34n23qFQA3nzdOJTQ1dA: folds 
Uncalled bet ($0.75) returned to L3/N/gliETan8N5Gim5h4Q
L3/N/gliETan8N5Gim5h4Q collected $0.75 from pot
L3/N/gliETan8N5Gim5h4Q: doesn't show hand 
*** SUMMARY ***
Total pot $0.75 | Rake $0 
Board [Jc Tc Ac Th]
Seat 2: g+5jEA4Xq9vcMOfdFYNuFA folded before Flop (didn't bet)
Seat 3: fZQg9veL7Dd/Z04ZTjC+wQ folded before Flop (didn't bet)
Seat 4: kG34n23qFQA3nzdOJTQ1dA (button) folded on the Turn
Seat 5: L3/N/gliETan8N5Gim5h4Q (small blind) collected ($0.75)
Seat 6: 8EEqTTh7T1q48sYDqbI2Xg (big blind) folded on the Turn




PokerStars Game #59941648268:  Hold'em No Limit ($0.10/$0.25) - 2009/07/01 1:41:47 ET
Table '60nA7av6bws9VnNmVwculA' 6-max Seat #5 is the button
Seat 1: if4dh6jhJXeN3/qd3qCp9g ($25 in chips) 
Seat 2: Bada343Si4xKu3fNXY99AA ($5.10 in chips) 
Seat 3: OUv909q/YxsJgxpSlZxLJQ ($30.50 in chips) 
Seat 4: +baiVgI/ETnBARLe5mARCw ($18.85 in chips) 
Seat 5: zXh+lOT41Q2iWgCNj+OcRw ($11.30 in chips) 
Seat 6: mfrkWA3PTeYPkbO6hi98Aw ($24.40 in chips) 
mfrkWA3PTeYPkbO6hi98Aw: posts small blind $0.10
if4dh6jhJXeN3/qd3qCp9g: posts big blind $0.25
*** HOLE CARDS ***
Bada343Si4xKu3fNXY99AA: calls $0.25
OUv909q/YxsJgxpSlZxLJQ: folds 
+baiVgI/ETnBARLe5mARCw: folds 
zXh+lOT41Q2iWgCNj+OcRw: calls $0.25
mfrkWA3PTeYPkbO6hi98Aw: calls $0.15
if4dh6jhJXeN3/qd3qCp9g: checks 
*** FLOP *** [8d 7d 8c]
mfrkWA3PTeYPkbO6hi98Aw: checks 
if4dh6jhJXeN3/qd3qCp9g: checks 
Bada343Si4xKu3fNXY99AA: checks 
zXh+lOT41Q2iWgCNj+OcRw: bets $0.50
mfrkWA3PTeYPkbO6hi98Aw: folds 
if4dh6jhJXeN3/qd3qCp9g: folds 
Bada343Si4xKu3fNXY99AA: calls $0.50
*** TURN *** [8d 7d 8c] [5h]
Bada343Si4xKu3fNXY99AA: checks 
zXh+lOT41Q2iWgCNj+OcRw: bets $0.50
Bada343Si4xKu3fNXY99AA: calls $0.50
*** RIVER *** [8d 7d 8c 5h] [Qs]
Bada343Si4xKu3fNXY99AA: checks 
zXh+lOT41Q2iWgCNj+OcRw: checks 
*** SHOW DOWN ***
Bada343Si4xKu3fNXY99AA: shows [Th 9h] (a pair of Eights)
zXh+lOT41Q2iWgCNj+OcRw: shows [6h 7c] (two pair, Eights and Sevens)
zXh+lOT41Q2iWgCNj+OcRw collected $2.90 from pot
*** SUMMARY ***
Total pot $3 | Rake $0.10 
Board [8d 7d 8c 5h Qs]
Seat 1: if4dh6jhJXeN3/qd3qCp9g (big blind) folded on the Flop
Seat 2: Bada343Si4xKu3fNXY99AA showed [Th 9h] and lost with a pair of Eights
Seat 3: OUv909q/YxsJgxpSlZxLJQ folded before Flop (didn't bet)
Seat 4: +baiVgI/ETnBARLe5mARCw folded before Flop (didn't bet)
Seat 5: zXh+lOT41Q2iWgCNj+OcRw (button) showed [6h 7c] and won ($2.90) with two pair, Eights and Sevens
Seat 6: mfrkWA3PTeYPkbO6hi98Aw (small blind) folded on the Flop




PokerStars Game #59941648926:  Hold'em No Limit ($0.10/$0.25) - 2009/07/01 1:41:48 ET
Table '9L7XfAwuM7XsXE8LIg2o5Q' 6-max Seat #6 is the button
Seat 1: dOIoLBxmpLHSXBN9LZnf0Q ($24.95 in chips) 
Seat 2: LJI7A1YgDM7hgh7o56+ReQ ($26.60 in chips) 
Seat 3: kv2o5BKCLOrJIw4oc083jQ ($27.20 in chips) 
Seat 4: jp34e617tIzV8tKIWmfAbA ($39.95 in chips) 
Seat 5: OUv909q/YxsJgxpSlZxLJQ ($33.85 in chips) 
Seat 6: k9nHZTHt8hYhYRcW8NTb4g ($37 in chips) 
dOIoLBxmpLHSXBN9LZnf0Q: posts small blind $0.10
LJI7A1YgDM7hgh7o56+ReQ: posts big blind $0.25
*** HOLE CARDS ***
kv2o5BKCLOrJIw4oc083jQ: folds 
jp34e617tIzV8tKIWmfAbA: folds 
kv2o5BKCLOrJIw4oc083jQ leaves the table
OUv909q/YxsJgxpSlZxLJQ: folds 
k9nHZTHt8hYhYRcW8NTb4g: folds 
dOIoLBxmpLHSXBN9LZnf0Q: calls $0.15
mFv3iBCtrw9XfCDRB0d46Q joins the table at seat #3 
LJI7A1YgDM7hgh7o56+ReQ: raises $0.75 to $1
dOIoLBxmpLHSXBN9LZnf0Q: raises $2.75 to $3.75
LJI7A1YgDM7hgh7o56+ReQ: folds 
Uncalled bet ($2.75) returned to dOIoLBxmpLHSXBN9LZnf0Q
dOIoLBxmpLHSXBN9LZnf0Q collected $2 from pot
dOIoLBxmpLHSXBN9LZnf0Q: doesn't show hand 
*** SUMMARY ***
Total pot $2 | Rake $0 
Seat 1: dOIoLBxmpLHSXBN9LZnf0Q (small blind) collected ($2)
Seat 2: LJI7A1YgDM7hgh7o56+ReQ (big blind) folded before Flop
Seat 3: kv2o5BKCLOrJIw4oc083jQ folded before Flop (didn't bet)
Seat 4: jp34e617tIzV8tKIWmfAbA folded before Flop (didn't bet)
Seat 5: OUv909q/YxsJgxpSlZxLJQ folded before Flop (didn't bet)
Seat 6: k9nHZTHt8hYhYRcW8NTb4g (button) folded before Flop (didn't bet)




