PokerStars Game #59941925670:  Hold'em No Limit ($0.10/$0.25) - 2009/07/01 1:50:33 ET
Table 'JJzUs04lHpXg6nboT1/jeg' 6-max Seat #1 is the button
Seat 1: vEZ/HxVuyR6kaq0BtZoUgQ ($10 in chips) 
Seat 2: jxfR29d+dK/7h7s3SvCk+g ($8.80 in chips) 
Seat 3: 4zXbHDe39qNX46dAo81b4w ($10.75 in chips) 
Seat 4: 7cx44/slbeTw+Cy7QB8Trg ($24.65 in chips) 
Seat 5: FDWzjQgBA5K04jOIY/j22w ($5 in chips) 
jxfR29d+dK/7h7s3SvCk+g: posts small blind $0.10
4zXbHDe39qNX46dAo81b4w: posts big blind $0.25
FDWzjQgBA5K04jOIY/j22w: posts big blind $0.25
*** HOLE CARDS ***
7cx44/slbeTw+Cy7QB8Trg: folds 
FDWzjQgBA5K04jOIY/j22w: checks 
bDKopKTvPi3W+PEnYUX3tg joins the table at seat #6 
vEZ/HxVuyR6kaq0BtZoUgQ: folds 
jxfR29d+dK/7h7s3SvCk+g: raises $0.25 to $0.50
4zXbHDe39qNX46dAo81b4w: calls $0.25
FDWzjQgBA5K04jOIY/j22w: folds 
*** FLOP *** [2s Th Kh]
jxfR29d+dK/7h7s3SvCk+g: checks 
4zXbHDe39qNX46dAo81b4w: bets $0.75
jxfR29d+dK/7h7s3SvCk+g: calls $0.75
*** TURN *** [2s Th Kh] [2d]
jxfR29d+dK/7h7s3SvCk+g: checks 
4zXbHDe39qNX46dAo81b4w: bets $2
jxfR29d+dK/7h7s3SvCk+g: calls $2
*** RIVER *** [2s Th Kh 2d] [8h]
jxfR29d+dK/7h7s3SvCk+g: bets $5
4zXbHDe39qNX46dAo81b4w: folds 
Uncalled bet ($5) returned to jxfR29d+dK/7h7s3SvCk+g
jxfR29d+dK/7h7s3SvCk+g collected $6.45 from pot
*** SUMMARY ***
Total pot $6.75 | Rake $0.30 
Board [2s Th Kh 2d 8h]
Seat 1: vEZ/HxVuyR6kaq0BtZoUgQ (button) folded before Flop (didn't bet)
Seat 2: jxfR29d+dK/7h7s3SvCk+g (small blind) collected ($6.45)
Seat 3: 4zXbHDe39qNX46dAo81b4w (big blind) folded on the River
Seat 4: 7cx44/slbeTw+Cy7QB8Trg folded before Flop (didn't bet)
Seat 5: FDWzjQgBA5K04jOIY/j22w folded before Flop




PokerStars Game #59941925634:  Hold'em No Limit ($0.10/$0.25) - 2009/07/01 1:50:33 ET
Table 'gYBWJG3hEuJg6kphY0yhMg' 9-max Seat #5 is the button
Seat 1: AcL/hxc9eT0dCr2TYk/0Dg ($24.55 in chips) 
Seat 2: RCqMONFrSPSArZh2Jsar/w ($19.25 in chips) 
Seat 3: wGigCmBR/9XWkPpvYos3aQ ($25 in chips) 
Seat 4: V6p0jQ/RhUsqpHLmXvEX4Q ($12.35 in chips) 
Seat 5: +sbyWwIcFp9kP0bDtMegfQ ($27.90 in chips) 
Seat 6: Z9W7+g1WMhhZDi7DwGbCFA ($5 in chips) 
Seat 7: aIEQGxUJwm61WfazSNFCdA ($13.55 in chips) 
Seat 8: 7je+LC5Mfs6nL8YBVh4frQ ($4.75 in chips) 
Seat 9: Bb42QRQMhg5/Y0vHP8/2Xw ($28.05 in chips) 
Z9W7+g1WMhhZDi7DwGbCFA: posts small blind $0.10
aIEQGxUJwm61WfazSNFCdA: posts big blind $0.25
*** HOLE CARDS ***
7je+LC5Mfs6nL8YBVh4frQ: folds 
Bb42QRQMhg5/Y0vHP8/2Xw: folds 
AcL/hxc9eT0dCr2TYk/0Dg: folds 
RCqMONFrSPSArZh2Jsar/w: folds 
wGigCmBR/9XWkPpvYos3aQ: raises $0.65 to $0.90
V6p0jQ/RhUsqpHLmXvEX4Q: folds 
+sbyWwIcFp9kP0bDtMegfQ: folds 
Z9W7+g1WMhhZDi7DwGbCFA: folds 
aIEQGxUJwm61WfazSNFCdA: calls $0.65
*** FLOP *** [Kd 7h 2h]
aIEQGxUJwm61WfazSNFCdA: checks 
wGigCmBR/9XWkPpvYos3aQ: bets $1.50
aIEQGxUJwm61WfazSNFCdA: calls $1.50
*** TURN *** [Kd 7h 2h] [4d]
aIEQGxUJwm61WfazSNFCdA: bets $2
wGigCmBR/9XWkPpvYos3aQ: calls $2
*** RIVER *** [Kd 7h 2h 4d] [6s]
aIEQGxUJwm61WfazSNFCdA: checks 
wGigCmBR/9XWkPpvYos3aQ: bets $20.60 and is all-in
aIEQGxUJwm61WfazSNFCdA: calls $9.15 and is all-in
Uncalled bet ($11.45) returned to wGigCmBR/9XWkPpvYos3aQ
*** SHOW DOWN ***
wGigCmBR/9XWkPpvYos3aQ: shows [8d Td] (high card King)
aIEQGxUJwm61WfazSNFCdA: shows [Kh 9h] (a pair of Kings)
aIEQGxUJwm61WfazSNFCdA collected $25.90 from pot
*** SUMMARY ***
Total pot $27.20 | Rake $1.30 
Board [Kd 7h 2h 4d 6s]
Seat 1: AcL/hxc9eT0dCr2TYk/0Dg folded before Flop (didn't bet)
Seat 2: RCqMONFrSPSArZh2Jsar/w folded before Flop (didn't bet)
Seat 3: wGigCmBR/9XWkPpvYos3aQ showed [8d Td] and lost with high card King
Seat 4: V6p0jQ/RhUsqpHLmXvEX4Q folded before Flop (didn't bet)
Seat 5: +sbyWwIcFp9kP0bDtMegfQ (button) folded before Flop (didn't bet)
Seat 6: Z9W7+g1WMhhZDi7DwGbCFA (small blind) folded before Flop
Seat 7: aIEQGxUJwm61WfazSNFCdA (big blind) showed [Kh 9h] and won ($25.90) with a pair of Kings
Seat 8: 7je+LC5Mfs6nL8YBVh4frQ folded before Flop (didn't bet)
Seat 9: Bb42QRQMhg5/Y0vHP8/2Xw folded before Flop (didn't bet)




PokerStars Game #59941925742:  Hold'em No Limit ($0.10/$0.25) - 2009/07/01 1:50:33 ET
Table 'dNYnr4D4id1jwnEU66Yowg' 9-max Seat #8 is the button
Seat 1: 9lvO/qyU+xrU95Teu1fv0g ($4.75 in chips) 
Seat 2: Qduu7ikeizo6q6Ei9YvcJA ($34.75 in chips) 
Seat 3: IOx4EH8+y3jYZJc/LTRvOw ($24.75 in chips) 
Seat 4: VBHxUExRAMrbxUq/cVx9Gw ($5 in chips) 
Seat 5: 7cv+9Zc9HIQHNvYsMfV3uA ($27.05 in chips) 
Seat 6: 8EbrQ/EvFWt2cr0GaU82gQ ($4.15 in chips) 
Seat 7: DiSvPC2iudwL5j9u6Huyww ($25 in chips) 
Seat 8: RCqMONFrSPSArZh2Jsar/w ($32.85 in chips) 
Seat 9: /FE4MKSoQhXaDp4PBoLM2g ($4.35 in chips) 
/FE4MKSoQhXaDp4PBoLM2g: posts small blind $0.10
9lvO/qyU+xrU95Teu1fv0g: posts big blind $0.25
*** HOLE CARDS ***
Qduu7ikeizo6q6Ei9YvcJA: calls $0.25
IOx4EH8+y3jYZJc/LTRvOw: folds 
VBHxUExRAMrbxUq/cVx9Gw: folds 
7cv+9Zc9HIQHNvYsMfV3uA: folds 
8EbrQ/EvFWt2cr0GaU82gQ: folds 
DiSvPC2iudwL5j9u6Huyww: folds 
RCqMONFrSPSArZh2Jsar/w: folds 
/FE4MKSoQhXaDp4PBoLM2g: calls $0.15
9lvO/qyU+xrU95Teu1fv0g: checks 
*** FLOP *** [Ks 9h 8d]
/FE4MKSoQhXaDp4PBoLM2g: checks 
9lvO/qyU+xrU95Teu1fv0g: checks 
Qduu7ikeizo6q6Ei9YvcJA: bets $0.75
/FE4MKSoQhXaDp4PBoLM2g: folds 
9lvO/qyU+xrU95Teu1fv0g: folds 
Uncalled bet ($0.75) returned to Qduu7ikeizo6q6Ei9YvcJA
Qduu7ikeizo6q6Ei9YvcJA collected $0.75 from pot
Qduu7ikeizo6q6Ei9YvcJA: doesn't show hand 
*** SUMMARY ***
Total pot $0.75 | Rake $0 
Board [Ks 9h 8d]
Seat 1: 9lvO/qyU+xrU95Teu1fv0g (big blind) folded on the Flop
Seat 2: Qduu7ikeizo6q6Ei9YvcJA collected ($0.75)
Seat 3: IOx4EH8+y3jYZJc/LTRvOw folded before Flop (didn't bet)
Seat 4: VBHxUExRAMrbxUq/cVx9Gw folded before Flop (didn't bet)
Seat 5: 7cv+9Zc9HIQHNvYsMfV3uA folded before Flop (didn't bet)
Seat 6: 8EbrQ/EvFWt2cr0GaU82gQ folded before Flop (didn't bet)
Seat 7: DiSvPC2iudwL5j9u6Huyww folded before Flop (didn't bet)
Seat 8: RCqMONFrSPSArZh2Jsar/w (button) folded before Flop (didn't bet)
Seat 9: /FE4MKSoQhXaDp4PBoLM2g (small blind) folded on the Flop




PokerStars Game #59941926608:  Hold'em No Limit ($0.10/$0.25) - 2009/07/01 1:50:34 ET
Table 'Jj2eLzVCUVAGBmM+Og79iQ' 9-max Seat #1 is the button
Seat 1: ShXPHWfjhfmAwLgDdm6bRQ ($6.90 in chips) 
Seat 2: 3BXzvZqgd3pARIFGfMXHww ($5.10 in chips) 
Seat 3: HPEB+AtKw1+C/cxU0o1ciw ($24.40 in chips) 
Seat 4: aNpwfA31EREwO+ar4XzBCw ($44.60 in chips) 
Seat 5: UkF1eqqUN0CCiimXAuN7og ($4.65 in chips) 
Seat 6: jZURAM/dgGCX+5lATlZugw ($17.35 in chips) 
Seat 7: K0b5wNInj6hUGRr6yzKFtw ($59.85 in chips) 
Seat 8: H5Se03ZqSX7tbULXur2MAg ($33.80 in chips) 
Seat 9: vSkQm2EelzwRGDDQQk0Fqw ($4.65 in chips) 
3BXzvZqgd3pARIFGfMXHww: posts small blind $0.10
HPEB+AtKw1+C/cxU0o1ciw: posts big blind $0.25
*** HOLE CARDS ***
aNpwfA31EREwO+ar4XzBCw: folds 
UkF1eqqUN0CCiimXAuN7og: folds 
jZURAM/dgGCX+5lATlZugw: folds 
K0b5wNInj6hUGRr6yzKFtw: folds 
K0b5wNInj6hUGRr6yzKFtw leaves the table
H5Se03ZqSX7tbULXur2MAg: folds 
vSkQm2EelzwRGDDQQk0Fqw: folds 
ShXPHWfjhfmAwLgDdm6bRQ: folds 
3BXzvZqgd3pARIFGfMXHww: raises $0.25 to $0.50
e3Caz8vey9WAdfgpuGpNjQ joins the table at seat #7 
HPEB+AtKw1+C/cxU0o1ciw: folds 
Uncalled bet ($0.25) returned to 3BXzvZqgd3pARIFGfMXHww
3BXzvZqgd3pARIFGfMXHww collected $0.50 from pot
3BXzvZqgd3pARIFGfMXHww: doesn't show hand 
*** SUMMARY ***
Total pot $0.50 | Rake $0 
Seat 1: ShXPHWfjhfmAwLgDdm6bRQ (button) folded before Flop (didn't bet)
Seat 2: 3BXzvZqgd3pARIFGfMXHww (small blind) collected ($0.50)
Seat 3: HPEB+AtKw1+C/cxU0o1ciw (big blind) folded before Flop
Seat 4: aNpwfA31EREwO+ar4XzBCw folded before Flop (didn't bet)
Seat 5: UkF1eqqUN0CCiimXAuN7og folded before Flop (didn't bet)
Seat 6: jZURAM/dgGCX+5lATlZugw folded before Flop (didn't bet)
Seat 7: K0b5wNInj6hUGRr6yzKFtw folded before Flop (didn't bet)
Seat 8: H5Se03ZqSX7tbULXur2MAg folded before Flop (didn't bet)
Seat 9: vSkQm2EelzwRGDDQQk0Fqw folded before Flop (didn't bet)




PokerStars Game #59941926360:  Hold'em No Limit ($0.10/$0.25) - 2009/07/01 1:50:34 ET
Table 'l8hUTjBTXBorNUR/tyvSLw' 9-max Seat #1 is the button
Seat 1: cZ99hugmLBj9KhTlc8nCSw ($27.85 in chips) 
Seat 2: B6xHiX1SJkS0CUNCKDVwuQ ($21.25 in chips) 
Seat 3: ShCS62CJp4MKfKLKvGKQbA ($9.10 in chips) 
Seat 4: vPtFvcPtn/Afz0sucO1cmQ ($36.70 in chips) 
Seat 5: yyG4svzOpC1A+sUP/scg6w ($6.60 in chips) 
Seat 6: EVqHvqty1ZsuvDFiSXlSqQ ($23.95 in chips) 
Seat 7: F7pnn6czNpHvRM55XcA2EA ($33.90 in chips) 
Seat 8: Mh2r9hTeTEDnh19sRZtW3g ($4.65 in chips) 
Seat 9: zDrucyjVn5aeekNEc3cJrA ($32.95 in chips) 
B6xHiX1SJkS0CUNCKDVwuQ: posts small blind $0.10
ShCS62CJp4MKfKLKvGKQbA: posts big blind $0.25
*** HOLE CARDS ***
vPtFvcPtn/Afz0sucO1cmQ: calls $0.25
yyG4svzOpC1A+sUP/scg6w: folds 
EVqHvqty1ZsuvDFiSXlSqQ: folds 
F7pnn6czNpHvRM55XcA2EA: folds 
Mh2r9hTeTEDnh19sRZtW3g: folds 
zDrucyjVn5aeekNEc3cJrA: folds 
cZ99hugmLBj9KhTlc8nCSw: folds 
B6xHiX1SJkS0CUNCKDVwuQ: calls $0.15
ShCS62CJp4MKfKLKvGKQbA: checks 
*** FLOP *** [7c 5s 3h]
B6xHiX1SJkS0CUNCKDVwuQ: checks 
ShCS62CJp4MKfKLKvGKQbA: checks 
vPtFvcPtn/Afz0sucO1cmQ: checks 
*** TURN *** [7c 5s 3h] [6d]
B6xHiX1SJkS0CUNCKDVwuQ: checks 
ShCS62CJp4MKfKLKvGKQbA: checks 
vPtFvcPtn/Afz0sucO1cmQ: bets $0.25
B6xHiX1SJkS0CUNCKDVwuQ: folds 
ShCS62CJp4MKfKLKvGKQbA: folds 
Uncalled bet ($0.25) returned to vPtFvcPtn/Afz0sucO1cmQ
vPtFvcPtn/Afz0sucO1cmQ collected $0.75 from pot
vPtFvcPtn/Afz0sucO1cmQ: doesn't show hand 
*** SUMMARY ***
Total pot $0.75 | Rake $0 
Board [7c 5s 3h 6d]
Seat 1: cZ99hugmLBj9KhTlc8nCSw (button) folded before Flop (didn't bet)
Seat 2: B6xHiX1SJkS0CUNCKDVwuQ (small blind) folded on the Turn
Seat 3: ShCS62CJp4MKfKLKvGKQbA (big blind) folded on the Turn
Seat 4: vPtFvcPtn/Afz0sucO1cmQ collected ($0.75)
Seat 5: yyG4svzOpC1A+sUP/scg6w folded before Flop (didn't bet)
Seat 6: EVqHvqty1ZsuvDFiSXlSqQ folded before Flop (didn't bet)
Seat 7: F7pnn6czNpHvRM55XcA2EA folded before Flop (didn't bet)
Seat 8: Mh2r9hTeTEDnh19sRZtW3g folded before Flop (didn't bet)
Seat 9: zDrucyjVn5aeekNEc3cJrA folded before Flop (didn't bet)




PokerStars Game #59941926728:  Hold'em No Limit ($0.10/$0.25) - 2009/07/01 1:50:34 ET
Table 'M8kYidAX3ib7pLKW7edFLw' 6-max Seat #1 is the button
Seat 1: jp34e617tIzV8tKIWmfAbA ($26.30 in chips) 
Seat 2: ypmjhffk/YHGc51wgVXUTw ($25 in chips) 
Seat 3: cezpHJ8FB07dj0xG+LhOvw ($27.40 in chips) 
Seat 4: Hsvkc0/G2VV78oVmWYXecw ($6.25 in chips) 
Seat 6: NqFoyDgzLwu4dOmSRXnFBA ($22.50 in chips) 
ypmjhffk/YHGc51wgVXUTw: posts small blind $0.10
cezpHJ8FB07dj0xG+LhOvw: posts big blind $0.25
GbCVUNssQ7mqsPWr7J4d3w: sits out 
*** HOLE CARDS ***
Hsvkc0/G2VV78oVmWYXecw: folds 
NqFoyDgzLwu4dOmSRXnFBA: calls $0.25
jp34e617tIzV8tKIWmfAbA: folds 
ypmjhffk/YHGc51wgVXUTw: folds 
cezpHJ8FB07dj0xG+LhOvw: checks 
*** FLOP *** [Ad 3d 4c]
cezpHJ8FB07dj0xG+LhOvw: checks 
NqFoyDgzLwu4dOmSRXnFBA: checks 
*** TURN *** [Ad 3d 4c] [2h]
cezpHJ8FB07dj0xG+LhOvw: checks 
NqFoyDgzLwu4dOmSRXnFBA: checks 
*** RIVER *** [Ad 3d 4c 2h] [3s]
cezpHJ8FB07dj0xG+LhOvw: checks 
Hsvkc0/G2VV78oVmWYXecw leaves the table
NqFoyDgzLwu4dOmSRXnFBA has timed out
NqFoyDgzLwu4dOmSRXnFBA: checks 
*** SHOW DOWN ***
cezpHJ8FB07dj0xG+LhOvw: shows [9h Jd] (a pair of Threes)
NqFoyDgzLwu4dOmSRXnFBA: shows [9s Qc] (a pair of Threes - Ace+Queen kicker)
NqFoyDgzLwu4dOmSRXnFBA collected $0.60 from pot
*** SUMMARY ***
Total pot $0.60 | Rake $0 
Board [Ad 3d 4c 2h 3s]
Seat 1: jp34e617tIzV8tKIWmfAbA (button) folded before Flop (didn't bet)
Seat 2: ypmjhffk/YHGc51wgVXUTw (small blind) folded before Flop
Seat 3: cezpHJ8FB07dj0xG+LhOvw (big blind) showed [9h Jd] and lost with a pair of Threes
Seat 4: Hsvkc0/G2VV78oVmWYXecw folded before Flop (didn't bet)
Seat 6: NqFoyDgzLwu4dOmSRXnFBA showed [9s Qc] and won ($0.60) with a pair of Threes




PokerStars Game #59941926638:  Hold'em No Limit ($0.10/$0.25) - 2009/07/01 1:50:34 ET
Table '2O5CgfSkSwrr4PDrlZ1RLQ' 6-max Seat #2 is the button
Seat 1: 3skmHD9EOATKdUzzyHh1KA ($31.60 in chips) 
Seat 2: wqphQtauX5Qn7WRJZS1flA ($28.75 in chips) 
Seat 3: oBUDUfeUyCbZBsjxHZgSiw ($20.25 in chips) 
Seat 4: epAUIB7h2FJXzUPRIvSkRA ($25 in chips) 
Seat 5: 0av6tRNdi0Ui4f15L7gsVg ($23.90 in chips) 
Seat 6: tj9xqoqQaDaFw7u1oyZrtA ($52.90 in chips) 
oBUDUfeUyCbZBsjxHZgSiw: posts small blind $0.10
epAUIB7h2FJXzUPRIvSkRA: posts big blind $0.25
*** HOLE CARDS ***
0av6tRNdi0Ui4f15L7gsVg: folds 
tj9xqoqQaDaFw7u1oyZrtA: folds 
3skmHD9EOATKdUzzyHh1KA: folds 
wqphQtauX5Qn7WRJZS1flA: raises $0.50 to $0.75
oBUDUfeUyCbZBsjxHZgSiw: folds 
epAUIB7h2FJXzUPRIvSkRA: folds 
Uncalled bet ($0.50) returned to wqphQtauX5Qn7WRJZS1flA
wqphQtauX5Qn7WRJZS1flA collected $0.60 from pot
wqphQtauX5Qn7WRJZS1flA: doesn't show hand 
*** SUMMARY ***
Total pot $0.60 | Rake $0 
Seat 1: 3skmHD9EOATKdUzzyHh1KA folded before Flop (didn't bet)
Seat 2: wqphQtauX5Qn7WRJZS1flA (button) collected ($0.60)
Seat 3: oBUDUfeUyCbZBsjxHZgSiw (small blind) folded before Flop
Seat 4: epAUIB7h2FJXzUPRIvSkRA (big blind) folded before Flop
Seat 5: 0av6tRNdi0Ui4f15L7gsVg folded before Flop (didn't bet)
Seat 6: tj9xqoqQaDaFw7u1oyZrtA folded before Flop (didn't bet)




PokerStars Game #59941926580:  Hold'em No Limit ($0.10/$0.25) - 2009/07/01 1:50:34 ET
Table 'emoxgHTxg9Uqeu06oLzLyg' 6-max Seat #6 is the button
Seat 1: epAUIB7h2FJXzUPRIvSkRA ($25 in chips) 
Seat 2: wIFhgE1PVdX6Xf6aVlSTPg ($28.55 in chips) 
Seat 3: uD5epdBxuyc30pF1dO958Q ($9.65 in chips) 
Seat 4: 3VAbqAWh8ncE2SJOYIx2ZQ ($15.90 in chips) 
Seat 5: OIjOiBfQstWrK/RuXx7zcw ($7.85 in chips) 
Seat 6: u3Ol7kv1LmvszuHNm9rc6w ($18.90 in chips) 
epAUIB7h2FJXzUPRIvSkRA: posts small blind $0.10
wIFhgE1PVdX6Xf6aVlSTPg: posts big blind $0.25
*** HOLE CARDS ***
uD5epdBxuyc30pF1dO958Q: folds 
3VAbqAWh8ncE2SJOYIx2ZQ: calls $0.25
OIjOiBfQstWrK/RuXx7zcw: folds 
u3Ol7kv1LmvszuHNm9rc6w: calls $0.25
epAUIB7h2FJXzUPRIvSkRA: calls $0.15
wIFhgE1PVdX6Xf6aVlSTPg: raises $0.90 to $1.15
3VAbqAWh8ncE2SJOYIx2ZQ: calls $0.90
u3Ol7kv1LmvszuHNm9rc6w: folds 
epAUIB7h2FJXzUPRIvSkRA: folds 
*** FLOP *** [2h 3d As]
wIFhgE1PVdX6Xf6aVlSTPg: bets $1.35
3VAbqAWh8ncE2SJOYIx2ZQ: folds 
Uncalled bet ($1.35) returned to wIFhgE1PVdX6Xf6aVlSTPg
wIFhgE1PVdX6Xf6aVlSTPg collected $2.70 from pot
wIFhgE1PVdX6Xf6aVlSTPg: doesn't show hand 
*** SUMMARY ***
Total pot $2.80 | Rake $0.10 
Board [2h 3d As]
Seat 1: epAUIB7h2FJXzUPRIvSkRA (small blind) folded before Flop
Seat 2: wIFhgE1PVdX6Xf6aVlSTPg (big blind) collected ($2.70)
Seat 3: uD5epdBxuyc30pF1dO958Q folded before Flop (didn't bet)
Seat 4: 3VAbqAWh8ncE2SJOYIx2ZQ folded on the Flop
Seat 5: OIjOiBfQstWrK/RuXx7zcw folded before Flop (didn't bet)
Seat 6: u3Ol7kv1LmvszuHNm9rc6w (button) folded before Flop




PokerStars Game #59941926722:  Hold'em No Limit ($0.10/$0.25) - 2009/07/01 1:50:34 ET
Table 'jdhJTJjFq2KTttwJcd+7nQ' 6-max Seat #4 is the button
Seat 1: LtASJ9OlkqGrrUKGQlpGAw ($26.50 in chips) 
Seat 2: Hsvkc0/G2VV78oVmWYXecw ($5 in chips) 
Seat 3: vqWjZmdQu/Hxw96/IJTWdQ ($28.80 in chips) 
Seat 4: vx7FwRcelVSsvNYAdp/z0A ($4.85 in chips) 
Seat 5: BV+K0Phf5VBHr7aZPKqbUQ ($33.15 in chips) 
Seat 6: yb6rnd48JuBccThV68VHAQ ($15.05 in chips) 
BV+K0Phf5VBHr7aZPKqbUQ: posts small blind $0.10
yb6rnd48JuBccThV68VHAQ: posts big blind $0.25
*** HOLE CARDS ***
LtASJ9OlkqGrrUKGQlpGAw: folds 
Hsvkc0/G2VV78oVmWYXecw: folds 
vqWjZmdQu/Hxw96/IJTWdQ: raises $0.75 to $1
vx7FwRcelVSsvNYAdp/z0A: folds 
BV+K0Phf5VBHr7aZPKqbUQ: folds 
yb6rnd48JuBccThV68VHAQ: folds 
Uncalled bet ($0.75) returned to vqWjZmdQu/Hxw96/IJTWdQ
vqWjZmdQu/Hxw96/IJTWdQ collected $0.60 from pot
vqWjZmdQu/Hxw96/IJTWdQ: doesn't show hand 
*** SUMMARY ***
Total pot $0.60 | Rake $0 
Seat 1: LtASJ9OlkqGrrUKGQlpGAw folded before Flop (didn't bet)
Seat 2: Hsvkc0/G2VV78oVmWYXecw folded before Flop (didn't bet)
Seat 3: vqWjZmdQu/Hxw96/IJTWdQ collected ($0.60)
Seat 4: vx7FwRcelVSsvNYAdp/z0A (button) folded before Flop (didn't bet)
Seat 5: BV+K0Phf5VBHr7aZPKqbUQ (small blind) folded before Flop
Seat 6: yb6rnd48JuBccThV68VHAQ (big blind) folded before Flop




PokerStars Game #59941926606:  Hold'em No Limit ($0.10/$0.25) - 2009/07/01 1:50:34 ET
Table 'IdXp6nyeW4FYaEK4qKCnwQ' 9-max Seat #4 is the button
Seat 1: tLcDklc2rBORNfixyRfVfw ($25 in chips) 
Seat 2: HPEB+AtKw1+C/cxU0o1ciw ($30.50 in chips) 
Seat 4: j4q3p0lesp63b1gZDwLBZw ($5 in chips) 
Seat 6: arxNSjreDRGFg13EAM2F1w ($30.60 in chips) 
Seat 7: w1ukf8uPa4+WH561TtVRxA ($37.25 in chips) 
Seat 8: dtZ84flFEi4Q+SGrHMJRDQ ($29.75 in chips) 
Seat 9: s2xLPOl/vhl/26apJ3vsOQ ($29.60 in chips) 
nAWaA+gDUSWOad+I9mKUEg will be allowed to play after the button
arxNSjreDRGFg13EAM2F1w: posts small blind $0.10
w1ukf8uPa4+WH561TtVRxA: posts big blind $0.25
JqeaikMej6KsqTKmUhl2Lw: sits out 
*** HOLE CARDS ***
dtZ84flFEi4Q+SGrHMJRDQ: folds 
s2xLPOl/vhl/26apJ3vsOQ: folds 
tLcDklc2rBORNfixyRfVfw: folds 
HPEB+AtKw1+C/cxU0o1ciw: folds 
j4q3p0lesp63b1gZDwLBZw: folds 
arxNSjreDRGFg13EAM2F1w: raises $0.50 to $0.75
w1ukf8uPa4+WH561TtVRxA: folds 
Uncalled bet ($0.50) returned to arxNSjreDRGFg13EAM2F1w
arxNSjreDRGFg13EAM2F1w collected $0.50 from pot
arxNSjreDRGFg13EAM2F1w: doesn't show hand 
*** SUMMARY ***
Total pot $0.50 | Rake $0 
Seat 1: tLcDklc2rBORNfixyRfVfw folded before Flop (didn't bet)
Seat 2: HPEB+AtKw1+C/cxU0o1ciw folded before Flop (didn't bet)
Seat 4: j4q3p0lesp63b1gZDwLBZw (button) folded before Flop (didn't bet)
Seat 6: arxNSjreDRGFg13EAM2F1w (small blind) collected ($0.50)
Seat 7: w1ukf8uPa4+WH561TtVRxA (big blind) folded before Flop
Seat 8: dtZ84flFEi4Q+SGrHMJRDQ folded before Flop (didn't bet)
Seat 9: s2xLPOl/vhl/26apJ3vsOQ folded before Flop (didn't bet)




PokerStars Game #59941927182:  Hold'em No Limit ($0.10/$0.25) - 2009/07/01 1:50:35 ET
Table 'sJ4KpS2GE5Qrsu1/cFjJUw' 9-max Seat #6 is the button
Seat 1: eDlQ+S+6L4e6gM1dkZhGgQ ($19.95 in chips) 
Seat 3: eK8qa6EPcH2zhtbmWSvc9g ($25 in chips) 
Seat 5: Q/gZC63lfOMr7YhWKPCxoQ ($8.40 in chips) 
Seat 6: OefE+Csvj5KR7ClGf3Hc2g ($3.75 in chips) 
Seat 7: Wi8djHgewBlVhpKWfp7isQ ($8.45 in chips) 
Seat 8: S7Ki0P+0AIGPuIfGJjW0gg ($30.70 in chips) 
Seat 9: 3PmVnC/15cl4oyI1TKIt4g ($4.40 in chips) 
Wi8djHgewBlVhpKWfp7isQ: posts small blind $0.10
S7Ki0P+0AIGPuIfGJjW0gg: posts big blind $0.25
ydoFOVgzvZv9ZhuWu9rXAw: sits out 
*** HOLE CARDS ***
3PmVnC/15cl4oyI1TKIt4g: folds 
eDlQ+S+6L4e6gM1dkZhGgQ: calls $0.25
eK8qa6EPcH2zhtbmWSvc9g: folds 
Q/gZC63lfOMr7YhWKPCxoQ: calls $0.25
OefE+Csvj5KR7ClGf3Hc2g: folds 
Wi8djHgewBlVhpKWfp7isQ: calls $0.15
S7Ki0P+0AIGPuIfGJjW0gg: checks 
*** FLOP *** [7s 2s 4d]
Wi8djHgewBlVhpKWfp7isQ: bets $0.50
S7Ki0P+0AIGPuIfGJjW0gg: folds 
eDlQ+S+6L4e6gM1dkZhGgQ: folds 
Q/gZC63lfOMr7YhWKPCxoQ: folds 
Uncalled bet ($0.50) returned to Wi8djHgewBlVhpKWfp7isQ
Wi8djHgewBlVhpKWfp7isQ collected $0.95 from pot
Wi8djHgewBlVhpKWfp7isQ: doesn't show hand 
*** SUMMARY ***
Total pot $1 | Rake $0.05 
Board [7s 2s 4d]
Seat 1: eDlQ+S+6L4e6gM1dkZhGgQ folded on the Flop
Seat 3: eK8qa6EPcH2zhtbmWSvc9g folded before Flop (didn't bet)
Seat 5: Q/gZC63lfOMr7YhWKPCxoQ folded on the Flop
Seat 6: OefE+Csvj5KR7ClGf3Hc2g (button) folded before Flop (didn't bet)
Seat 7: Wi8djHgewBlVhpKWfp7isQ (small blind) collected ($0.95)
Seat 8: S7Ki0P+0AIGPuIfGJjW0gg (big blind) folded on the Flop
Seat 9: 3PmVnC/15cl4oyI1TKIt4g folded before Flop (didn't bet)




PokerStars Game #59941926878:  Hold'em No Limit ($0.10/$0.25) - 2009/07/01 1:50:35 ET
Table 'IuqVbFI+pwnJjvwBCGSGAw' 6-max Seat #1 is the button
Seat 1: LyDHtw3/yniNHW+DvLXbog ($27.75 in chips) 
Seat 2: w43JQj2oYPpKQVG4Yzlq1w ($25.10 in chips) 
Seat 3: QiL+lEgEWwy21jk/ltaRLg ($20.80 in chips) 
Seat 4: DE9hRlt14g+JdsRQ4wT7hg ($28.20 in chips) 
Seat 5: if4dh6jhJXeN3/qd3qCp9g ($24.30 in chips) 
Seat 6: xC0kaiDYM6YTlgODL83O5A ($12.80 in chips) 
w43JQj2oYPpKQVG4Yzlq1w: posts small blind $0.10
QiL+lEgEWwy21jk/ltaRLg: posts big blind $0.25
*** HOLE CARDS ***
DE9hRlt14g+JdsRQ4wT7hg: raises $0.75 to $1
if4dh6jhJXeN3/qd3qCp9g: folds 
xC0kaiDYM6YTlgODL83O5A: folds 
LyDHtw3/yniNHW+DvLXbog: folds 
w43JQj2oYPpKQVG4Yzlq1w: folds 
QiL+lEgEWwy21jk/ltaRLg: raises $1 to $2
DE9hRlt14g+JdsRQ4wT7hg: calls $1
*** FLOP *** [9d 4c 2s]
QiL+lEgEWwy21jk/ltaRLg: checks 
DE9hRlt14g+JdsRQ4wT7hg: checks 
*** TURN *** [9d 4c 2s] [4s]
QiL+lEgEWwy21jk/ltaRLg: bets $1.50
DE9hRlt14g+JdsRQ4wT7hg: calls $1.50
*** RIVER *** [9d 4c 2s 4s] [Js]
QiL+lEgEWwy21jk/ltaRLg: checks 
DE9hRlt14g+JdsRQ4wT7hg: checks 
*** SHOW DOWN ***
QiL+lEgEWwy21jk/ltaRLg: shows [Qh Qs] (two pair, Queens and Fours)
DE9hRlt14g+JdsRQ4wT7hg: mucks hand 
QiL+lEgEWwy21jk/ltaRLg collected $6.80 from pot
*** SUMMARY ***
Total pot $7.10 | Rake $0.30 
Board [9d 4c 2s 4s Js]
Seat 1: LyDHtw3/yniNHW+DvLXbog (button) folded before Flop (didn't bet)
Seat 2: w43JQj2oYPpKQVG4Yzlq1w (small blind) folded before Flop
Seat 3: QiL+lEgEWwy21jk/ltaRLg (big blind) showed [Qh Qs] and won ($6.80) with two pair, Queens and Fours
Seat 4: DE9hRlt14g+JdsRQ4wT7hg mucked
Seat 5: if4dh6jhJXeN3/qd3qCp9g folded before Flop (didn't bet)
Seat 6: xC0kaiDYM6YTlgODL83O5A folded before Flop (didn't bet)




PokerStars Game #59941927130:  Hold'em No Limit ($0.10/$0.25) - 2009/07/01 1:50:35 ET
Table '+68ihX5Br1xgGorX6zsCBg' 9-max Seat #6 is the button
Seat 1: IFB2mhulUVYIbb+KWwDC9w ($4.05 in chips) 
Seat 2: TeAfhXG1R60d8yPEHN3JiA ($25.40 in chips) 
Seat 3: PdIasPkzm2sqZnN41ZRXOg ($5 in chips) 
Seat 4: Oi0EiPIjriUb/6zT65YeWA ($27.30 in chips) 
Seat 5: ghNKXUBl/H+t83JF079ZBA ($28.65 in chips) 
Seat 6: X78b5v/uhqeXXoAijbw/yg ($26.05 in chips) 
Seat 7: V6p0jQ/RhUsqpHLmXvEX4Q ($19.10 in chips) 
Seat 9: DiSvPC2iudwL5j9u6Huyww ($32.75 in chips) 
V6p0jQ/RhUsqpHLmXvEX4Q: posts small blind $0.10
DiSvPC2iudwL5j9u6Huyww: posts big blind $0.25
*** HOLE CARDS ***
IFB2mhulUVYIbb+KWwDC9w: calls $0.25
TeAfhXG1R60d8yPEHN3JiA: raises $0.50 to $0.75
PdIasPkzm2sqZnN41ZRXOg: raises $4.25 to $5 and is all-in
Oi0EiPIjriUb/6zT65YeWA: folds 
ghNKXUBl/H+t83JF079ZBA: folds 
X78b5v/uhqeXXoAijbw/yg: folds 
V6p0jQ/RhUsqpHLmXvEX4Q: folds 
DiSvPC2iudwL5j9u6Huyww: folds 
IFB2mhulUVYIbb+KWwDC9w: folds 
TeAfhXG1R60d8yPEHN3JiA: calls $4.25
*** FLOP *** [8c 4h 3s]
*** TURN *** [8c 4h 3s] [3h]
*** RIVER *** [8c 4h 3s 3h] [9c]
*** SHOW DOWN ***
TeAfhXG1R60d8yPEHN3JiA: shows [Jd Ac] (a pair of Threes)
PdIasPkzm2sqZnN41ZRXOg: shows [Js As] (a pair of Threes)
TeAfhXG1R60d8yPEHN3JiA collected $5.05 from pot
PdIasPkzm2sqZnN41ZRXOg collected $5.05 from pot
*** SUMMARY ***
Total pot $10.60 | Rake $0.50 
Board [8c 4h 3s 3h 9c]
Seat 1: IFB2mhulUVYIbb+KWwDC9w folded before Flop
Seat 2: TeAfhXG1R60d8yPEHN3JiA showed [Jd Ac] and won ($5.05) with a pair of Threes
Seat 3: PdIasPkzm2sqZnN41ZRXOg showed [Js As] and won ($5.05) with a pair of Threes
Seat 4: Oi0EiPIjriUb/6zT65YeWA folded before Flop (didn't bet)
Seat 5: ghNKXUBl/H+t83JF079ZBA folded before Flop (didn't bet)
Seat 6: X78b5v/uhqeXXoAijbw/yg (button) folded before Flop (didn't bet)
Seat 7: V6p0jQ/RhUsqpHLmXvEX4Q (small blind) folded before Flop
Seat 9: DiSvPC2iudwL5j9u6Huyww (big blind) folded before Flop




PokerStars Game #59941926962:  Hold'em No Limit ($0.10/$0.25) - 2009/07/01 1:50:35 ET
Table 'ouLhepGYovxB2x0QxH7cVg' 9-max Seat #8 is the button
Seat 1: ghNKXUBl/H+t83JF079ZBA ($25 in chips) 
Seat 2: r1Z5m4PwSI5ANp7qCE1OJw ($23.35 in chips) 
Seat 3: bXpVeaSTPBFSPJmeXxO7nw ($4.90 in chips) 
Seat 4: a0Sx6GHY7ln2Ns2C97eXeA ($59.40 in chips) 
Seat 5: v60REj6f8jzMYT0VsZvaPQ ($11.25 in chips) 
Seat 6: hYvTc4PYNrAaNAIVoM94Hw ($4.65 in chips) 
Seat 8: tLcDklc2rBORNfixyRfVfw ($25.25 in chips) 
Seat 9: ljemhp25Zg+nlA9DLCIiUw ($25.05 in chips) 
ljemhp25Zg+nlA9DLCIiUw: posts small blind $0.10
ghNKXUBl/H+t83JF079ZBA: posts big blind $0.25
*** HOLE CARDS ***
TW Suited leaves the table
r1Z5m4PwSI5ANp7qCE1OJw: raises $0.50 to $0.75
bXpVeaSTPBFSPJmeXxO7nw: folds 
a0Sx6GHY7ln2Ns2C97eXeA: folds 
v60REj6f8jzMYT0VsZvaPQ: calls $0.75
hYvTc4PYNrAaNAIVoM94Hw: folds 
tLcDklc2rBORNfixyRfVfw: folds 
ljemhp25Zg+nlA9DLCIiUw: folds 
ghNKXUBl/H+t83JF079ZBA: folds 
*** FLOP *** [7s 8s 5c]
r1Z5m4PwSI5ANp7qCE1OJw: bets $0.75
v60REj6f8jzMYT0VsZvaPQ: raises $1.50 to $2.25
r1Z5m4PwSI5ANp7qCE1OJw: raises $20.35 to $22.60 and is all-in
v60REj6f8jzMYT0VsZvaPQ: calls $8.25 and is all-in
Uncalled bet ($12.10) returned to r1Z5m4PwSI5ANp7qCE1OJw
*** TURN *** [7s 8s 5c] [2c]
*** RIVER *** [7s 8s 5c 2c] [3h]
*** SHOW DOWN ***
r1Z5m4PwSI5ANp7qCE1OJw: shows [Qs Ks] (high card King)
v60REj6f8jzMYT0VsZvaPQ: shows [Tc Td] (a pair of Tens)
v60REj6f8jzMYT0VsZvaPQ collected $21.75 from pot
*** SUMMARY ***
Total pot $22.85 | Rake $1.10 
Board [7s 8s 5c 2c 3h]
Seat 1: ghNKXUBl/H+t83JF079ZBA (big blind) folded before Flop
Seat 2: r1Z5m4PwSI5ANp7qCE1OJw showed [Qs Ks] and lost with high card King
Seat 3: bXpVeaSTPBFSPJmeXxO7nw folded before Flop (didn't bet)
Seat 4: a0Sx6GHY7ln2Ns2C97eXeA folded before Flop (didn't bet)
Seat 5: v60REj6f8jzMYT0VsZvaPQ showed [Tc Td] and won ($21.75) with a pair of Tens
Seat 6: hYvTc4PYNrAaNAIVoM94Hw folded before Flop (didn't bet)
Seat 8: tLcDklc2rBORNfixyRfVfw (button) folded before Flop (didn't bet)
Seat 9: ljemhp25Zg+nlA9DLCIiUw (small blind) folded before Flop




PokerStars Game #59941926764:  Hold'em No Limit ($0.10/$0.25) - 2009/07/01 1:50:35 ET
Table 'mVdLgAdN9rGe6mMwSrDdGQ' 6-max Seat #5 is the button
Seat 1: OyJ0KTHA5cwh0/yCo1/rdA ($11.10 in chips) 
Seat 3: +baiVgI/ETnBARLe5mARCw ($16.25 in chips) 
Seat 4: scNSjC6yyKvvfklSkuzLrw ($22.50 in chips) 
Seat 5: +TMG/MBWpiEnc9t7i07eTA ($23.15 in chips) 
Seat 6: DihMHaz4WNETH1bPDe13kA ($48.05 in chips) 
DihMHaz4WNETH1bPDe13kA: posts small blind $0.10
OyJ0KTHA5cwh0/yCo1/rdA: posts big blind $0.25
*** HOLE CARDS ***
+baiVgI/ETnBARLe5mARCw: folds 
scNSjC6yyKvvfklSkuzLrw: calls $0.25
+TMG/MBWpiEnc9t7i07eTA: folds 
DihMHaz4WNETH1bPDe13kA: folds 
OyJ0KTHA5cwh0/yCo1/rdA: checks 
*** FLOP *** [As Ac 3c]
OyJ0KTHA5cwh0/yCo1/rdA: checks 
n9QqWD4tpbongUBX2Oi58w has returned
scNSjC6yyKvvfklSkuzLrw: bets $0.75
OyJ0KTHA5cwh0/yCo1/rdA: calls $0.75
*** TURN *** [As Ac 3c] [Ks]
OyJ0KTHA5cwh0/yCo1/rdA: checks 
scNSjC6yyKvvfklSkuzLrw: bets $1
OyJ0KTHA5cwh0/yCo1/rdA: folds 
Uncalled bet ($1) returned to scNSjC6yyKvvfklSkuzLrw
scNSjC6yyKvvfklSkuzLrw collected $2 from pot
*** SUMMARY ***
Total pot $2.10 | Rake $0.10 
Board [As Ac 3c Ks]
Seat 1: OyJ0KTHA5cwh0/yCo1/rdA (big blind) folded on the Turn
Seat 3: +baiVgI/ETnBARLe5mARCw folded before Flop (didn't bet)
Seat 4: scNSjC6yyKvvfklSkuzLrw collected ($2)
Seat 5: +TMG/MBWpiEnc9t7i07eTA (button) folded before Flop (didn't bet)
Seat 6: DihMHaz4WNETH1bPDe13kA (small blind) folded before Flop




PokerStars Game #59941926784:  Hold'em No Limit ($0.10/$0.25) - 2009/07/01 1:50:35 ET
Table 'GgmUtmhrYPRnhkqEEjD/Kw' 9-max Seat #9 is the button
Seat 1: bXpVeaSTPBFSPJmeXxO7nw ($4.75 in chips) 
Seat 2: ghNKXUBl/H+t83JF079ZBA ($25 in chips) 
Seat 3: dYvYZ723QlKIPiDa0pkedQ ($7.60 in chips) 
Seat 4: dfNim92Z6XK1/h5SFW5vDg ($25 in chips) 
Seat 5: ljemhp25Zg+nlA9DLCIiUw ($26.85 in chips) 
Seat 6: 4Ax0vobe1rLVIGZmkFINGA ($18.95 in chips) 
Seat 7: YwDw9cMqkbMznFK77rru4A ($4.55 in chips) 
Seat 8: DdPXdieucQ+n99u1n3A+rQ ($4.30 in chips) 
Seat 9: V6p0jQ/RhUsqpHLmXvEX4Q ($15.20 in chips) 
bXpVeaSTPBFSPJmeXxO7nw: posts small blind $0.10
ghNKXUBl/H+t83JF079ZBA: posts big blind $0.25
*** HOLE CARDS ***
dYvYZ723QlKIPiDa0pkedQ: calls $0.25
dfNim92Z6XK1/h5SFW5vDg: folds 
ljemhp25Zg+nlA9DLCIiUw: folds 
4Ax0vobe1rLVIGZmkFINGA: calls $0.25
YwDw9cMqkbMznFK77rru4A: calls $0.25
DdPXdieucQ+n99u1n3A+rQ: folds 
V6p0jQ/RhUsqpHLmXvEX4Q: folds 
bXpVeaSTPBFSPJmeXxO7nw: raises $4.50 to $4.75 and is all-in
ghNKXUBl/H+t83JF079ZBA: folds 
dYvYZ723QlKIPiDa0pkedQ: folds 
4Ax0vobe1rLVIGZmkFINGA: calls $4.50
YwDw9cMqkbMznFK77rru4A: folds 
*** FLOP *** [8d 6h 9d]
*** TURN *** [8d 6h 9d] [Kd]
*** RIVER *** [8d 6h 9d Kd] [9h]
*** SHOW DOWN ***
bXpVeaSTPBFSPJmeXxO7nw: shows [Kh Qd] (two pair, Kings and Nines)
4Ax0vobe1rLVIGZmkFINGA: mucks hand 
bXpVeaSTPBFSPJmeXxO7nw collected $9.75 from pot
*** SUMMARY ***
Total pot $10.25 | Rake $0.50 
Board [8d 6h 9d Kd 9h]
Seat 1: bXpVeaSTPBFSPJmeXxO7nw (small blind) showed [Kh Qd] and won ($9.75) with two pair, Kings and Nines
Seat 2: ghNKXUBl/H+t83JF079ZBA (big blind) folded before Flop
Seat 3: dYvYZ723QlKIPiDa0pkedQ folded before Flop
Seat 4: dfNim92Z6XK1/h5SFW5vDg folded before Flop (didn't bet)
Seat 5: ljemhp25Zg+nlA9DLCIiUw folded before Flop (didn't bet)
Seat 6: 4Ax0vobe1rLVIGZmkFINGA mucked
Seat 7: YwDw9cMqkbMznFK77rru4A folded before Flop
Seat 8: DdPXdieucQ+n99u1n3A+rQ folded before Flop (didn't bet)
Seat 9: V6p0jQ/RhUsqpHLmXvEX4Q (button) folded before Flop (didn't bet)




PokerStars Game #59941927108:  Hold'em No Limit ($0.10/$0.25) - 2009/07/01 1:50:35 ET
Table 'QvLFJzpzymuOsaaRYi+8fgWEMI3Mtn7dGARDbgNrKibgx Seat #7 is the button
Seat 1: cZ99hugmLBj9KhTlc8nCSw ($26.70 in chips) 
Seat 2: PdIasPkzm2sqZnN41ZRXOg ($5 in chips) 
Seat 3: Qduu7ikeizo6q6Ei9YvcJA ($25 in chips) 
Seat 4: tLcDklc2rBORNfixyRfVfw ($25.25 in chips) 
Seat 5: MG90wfSJZnOejs/KD3vlQQ ($37.45 in chips) 
Seat 6: vKdukiQ4ktU4yJ0Xx3MKnA ($7.10 in chips) 
Seat 7: rQhYIYXSyH/IivYM1dlV5A ($10.85 in chips) 
Seat 8: gehe91e0IyVT0QU/XBkEyg ($27.10 in chips) 
Seat 9: BWzInv8o0kN1pJybv/VjpQ ($44.80 in chips) 
gehe91e0IyVT0QU/XBkEyg: posts small blind $0.10
BWzInv8o0kN1pJybv/VjpQ: posts big blind $0.25
*** HOLE CARDS ***
cZ99hugmLBj9KhTlc8nCSw: raises $0.50 to $0.75
PdIasPkzm2sqZnN41ZRXOg: folds 
Qduu7ikeizo6q6Ei9YvcJA: folds 
tLcDklc2rBORNfixyRfVfw: folds 
MG90wfSJZnOejs/KD3vlQQ: folds 
vKdukiQ4ktU4yJ0Xx3MKnA: folds 
rQhYIYXSyH/IivYM1dlV5A: folds 
gehe91e0IyVT0QU/XBkEyg: folds 
BWzInv8o0kN1pJybv/VjpQ: folds 
Uncalled bet ($0.50) returned to cZ99hugmLBj9KhTlc8nCSw
cZ99hugmLBj9KhTlc8nCSw collected $0.60 from pot
cZ99hugmLBj9KhTlc8nCSw: doesn't show hand 
*** SUMMARY ***
Total pot $0.60 | Rake $0 
Seat 1: cZ99hugmLBj9KhTlc8nCSw collected ($0.60)
Seat 2: PdIasPkzm2sqZnN41ZRXOg folded before Flop (didn't bet)
Seat 3: Qduu7ikeizo6q6Ei9YvcJA folded before Flop (didn't bet)
Seat 4: tLcDklc2rBORNfixyRfVfw folded before Flop (didn't bet)
Seat 5: MG90wfSJZnOejs/KD3vlQQ folded before Flop (didn't bet)
Seat 6: vKdukiQ4ktU4yJ0Xx3MKnA folded before Flop (didn't bet)
Seat 7: rQhYIYXSyH/IivYM1dlV5A (button) folded before Flop (didn't bet)
Seat 8: gehe91e0IyVT0QU/XBkEyg (small blind) folded before Flop
Seat 9: BWzInv8o0kN1pJybv/VjpQ (big blind) folded before Flop




PokerStars Game #59941927324:  Hold'em No Limit ($0.10/$0.25) - 2009/07/01 1:50:36 ET
Table 'U0hCzoS0KCJL+eoE054K4Q' 9-max Seat #6 is the button
Seat 1: XVEauYThJRhSTUAMxB/2ow ($37.55 in chips) 
Seat 2: MG90wfSJZnOejs/KD3vlQQ ($28.85 in chips) 
Seat 3: 8Cp1H3sSs8+jTTwLfeYKcw ($25.55 in chips) 
Seat 4: Bb42QRQMhg5/Y0vHP8/2Xw ($25 in chips) 
Seat 5: zgi+EUykT/pZQpoUG6+oEg ($5.65 in chips) 
Seat 6: V6p0jQ/RhUsqpHLmXvEX4Q ($11.55 in chips) 
Seat 7: uetHVityNsFnyX2bBnKe2A ($18.10 in chips) 
Seat 8: K0b5wNInj6hUGRr6yzKFtw ($27.45 in chips) 
Seat 9: wGigCmBR/9XWkPpvYos3aQ ($34.25 in chips) 
uetHVityNsFnyX2bBnKe2A: posts small blind $0.10
K0b5wNInj6hUGRr6yzKFtw: posts big blind $0.25
*** HOLE CARDS ***
wGigCmBR/9XWkPpvYos3aQ: folds 
XVEauYThJRhSTUAMxB/2ow: folds 
MG90wfSJZnOejs/KD3vlQQ: raises $0.50 to $0.75
8Cp1H3sSs8+jTTwLfeYKcw: folds 
Bb42QRQMhg5/Y0vHP8/2Xw: folds 
zgi+EUykT/pZQpoUG6+oEg: folds 
V6p0jQ/RhUsqpHLmXvEX4Q: folds 
uetHVityNsFnyX2bBnKe2A: folds 
K0b5wNInj6hUGRr6yzKFtw: folds 
Uncalled bet ($0.50) returned to MG90wfSJZnOejs/KD3vlQQ
MG90wfSJZnOejs/KD3vlQQ collected $0.60 from pot
MG90wfSJZnOejs/KD3vlQQ: doesn't show hand 
*** SUMMARY ***
Total pot $0.60 | Rake $0 
Seat 1: XVEauYThJRhSTUAMxB/2ow folded before Flop (didn't bet)
Seat 2: MG90wfSJZnOejs/KD3vlQQ collected ($0.60)
Seat 3: 8Cp1H3sSs8+jTTwLfeYKcw folded before Flop (didn't bet)
Seat 4: Bb42QRQMhg5/Y0vHP8/2Xw folded before Flop (didn't bet)
Seat 5: zgi+EUykT/pZQpoUG6+oEg folded before Flop (didn't bet)
Seat 6: V6p0jQ/RhUsqpHLmXvEX4Q (button) folded before Flop (didn't bet)
Seat 7: uetHVityNsFnyX2bBnKe2A (small blind) folded before Flop
Seat 8: K0b5wNInj6hUGRr6yzKFtw (big blind) folded before Flop
Seat 9: wGigCmBR/9XWkPpvYos3aQ folded before Flop (didn't bet)




PokerStars Game #59941927680:  Hold'em No Limit ($0.10/$0.25) - 2009/07/01 1:50:36 ET
Table 'ThBZ355rqvsb8UGb6ajbig' 9-max Seat #8 is the button
Seat 1: Z9W7+g1WMhhZDi7DwGbCFA ($10.45 in chips) 
Seat 2: 4awUyiDYTgylQKXZ9faBVA ($25.95 in chips) 
Seat 3: H5Se03ZqSX7tbULXur2MAg ($27.80 in chips) 
Seat 4: zgi+EUykT/pZQpoUG6+oEg ($5.40 in chips) 
Seat 5: cKlmpQMahVsmOaxFQDcoOg ($24.60 in chips) 
Seat 6: qwr38jl5txoR36M7G5qi4A ($11 in chips) 
Seat 8: pplNliE3WonjkPRf+GZq2A ($25.10 in chips) 
Seat 9: sD+TKtt36XiiN6jqHiLwDA ($24.75 in chips) 
sD+TKtt36XiiN6jqHiLwDA: posts small blind $0.10
Z9W7+g1WMhhZDi7DwGbCFA: posts big blind $0.25
*** HOLE CARDS ***
4awUyiDYTgylQKXZ9faBVA: folds 
H5Se03ZqSX7tbULXur2MAg: folds 
zgi+EUykT/pZQpoUG6+oEg: folds 
cKlmpQMahVsmOaxFQDcoOg: folds 
qwr38jl5txoR36M7G5qi4A: folds 
pplNliE3WonjkPRf+GZq2A: folds 
sD+TKtt36XiiN6jqHiLwDA: folds 
Uncalled bet ($0.15) returned to Z9W7+g1WMhhZDi7DwGbCFA
Z9W7+g1WMhhZDi7DwGbCFA collected $0.20 from pot
Z9W7+g1WMhhZDi7DwGbCFA: doesn't show hand 
*** SUMMARY ***
Total pot $0.20 | Rake $0 
Seat 1: Z9W7+g1WMhhZDi7DwGbCFA (big blind) collected ($0.20)
Seat 2: 4awUyiDYTgylQKXZ9faBVA folded before Flop (didn't bet)
Seat 3: H5Se03ZqSX7tbULXur2MAg folded before Flop (didn't bet)
Seat 4: zgi+EUykT/pZQpoUG6+oEg folded before Flop (didn't bet)
Seat 5: cKlmpQMahVsmOaxFQDcoOg folded before Flop (didn't bet)
Seat 6: qwr38jl5txoR36M7G5qi4A folded before Flop (didn't bet)
Seat 8: pplNliE3WonjkPRf+GZq2A (button) folded before Flop (didn't bet)
Seat 9: sD+TKtt36XiiN6jqHiLwDA (small blind) folded before Flop




PokerStars Game #59941927476:  Hold'em No Limit ($0.10/$0.25) - 2009/07/01 1:50:36 ET
Table 'O6cwjhrMn9pfzx1Ngn5zkQ' 6-max Seat #6 is the button
Seat 1: LJI7A1YgDM7hgh7o56+ReQ ($27.20 in chips) 
Seat 2: 8CPg15X6IHYR1pWm9ha1Sw ($25 in chips) 
Seat 3: EE16Ua5b1HSsYej5zeXOlA ($26.15 in chips) 
Seat 4: mfrkWA3PTeYPkbO6hi98Aw ($24.85 in chips) 
Seat 5: niLn0xUVlqh8If80xRjzCA ($28.60 in chips) 
Seat 6: 4TM16KVgEiQpLi4bVVWbVQ ($32.20 in chips) 
LJI7A1YgDM7hgh7o56+ReQ: posts small blind $0.10
8CPg15X6IHYR1pWm9ha1Sw: posts big blind $0.25
*** HOLE CARDS ***
EE16Ua5b1HSsYej5zeXOlA: folds 
mfrkWA3PTeYPkbO6hi98Aw: folds 
niLn0xUVlqh8If80xRjzCA: calls $0.25
4TM16KVgEiQpLi4bVVWbVQ: raises $1.25 to $1.50
LJI7A1YgDM7hgh7o56+ReQ: raises $2.50 to $4
8CPg15X6IHYR1pWm9ha1Sw: folds 
niLn0xUVlqh8If80xRjzCA: folds 
4TM16KVgEiQpLi4bVVWbVQ: raises $5 to $9
LJI7A1YgDM7hgh7o56+ReQ: folds 
Uncalled bet ($5) returned to 4TM16KVgEiQpLi4bVVWbVQ
4TM16KVgEiQpLi4bVVWbVQ collected $8.50 from pot
*** SUMMARY ***
Total pot $8.50 | Rake $0 
Seat 1: LJI7A1YgDM7hgh7o56+ReQ (small blind) folded before Flop
Seat 2: 8CPg15X6IHYR1pWm9ha1Sw (big blind) folded before Flop
Seat 3: EE16Ua5b1HSsYej5zeXOlA folded before Flop (didn't bet)
Seat 4: mfrkWA3PTeYPkbO6hi98Aw folded before Flop (didn't bet)
Seat 5: niLn0xUVlqh8If80xRjzCA folded before Flop
Seat 6: 4TM16KVgEiQpLi4bVVWbVQ (button) collected ($8.50)




PokerStars Game #59941927378:  Hold'em No Limit ($0.10/$0.25) - 2009/07/01 1:50:36 ET
Table 'Qr+t8WGovMECkBv+cV1lrg' 6-max Seat #2 is the button
Seat 1: EeUZtMU058v2ObUACOF4Og ($34.10 in chips) 
Seat 2: vqWjZmdQu/Hxw96/IJTWdQ ($41.25 in chips) 
Seat 3: uZKkrGByYgd4/ZBX2d4z+w ($20.85 in chips) 
Seat 4: 1NNFfYMd5Hsphl/FYz9fNA ($60.15 in chips) 
Seat 5: I50OxuNg9riRq9sywF6jMQ ($5 in chips) 
Seat 6: 9U3ZKjCsarN0DjR6mSE8Ug ($14.35 in chips) 
uZKkrGByYgd4/ZBX2d4z+w: posts small blind $0.10
1NNFfYMd5Hsphl/FYz9fNA: posts big blind $0.25
*** HOLE CARDS ***
I50OxuNg9riRq9sywF6jMQ: folds 
9U3ZKjCsarN0DjR6mSE8Ug: folds 
EeUZtMU058v2ObUACOF4Og: folds 
vqWjZmdQu/Hxw96/IJTWdQ: raises $0.75 to $1
uZKkrGByYgd4/ZBX2d4z+w: folds 
1NNFfYMd5Hsphl/FYz9fNA: folds 
Uncalled bet ($0.75) returned to vqWjZmdQu/Hxw96/IJTWdQ
vqWjZmdQu/Hxw96/IJTWdQ collected $0.60 from pot
vqWjZmdQu/Hxw96/IJTWdQ: doesn't show hand 
*** SUMMARY ***
Total pot $0.60 | Rake $0 
Seat 1: EeUZtMU058v2ObUACOF4Og folded before Flop (didn't bet)
Seat 2: vqWjZmdQu/Hxw96/IJTWdQ (button) collected ($0.60)
Seat 3: uZKkrGByYgd4/ZBX2d4z+w (small blind) folded before Flop
Seat 4: 1NNFfYMd5Hsphl/FYz9fNA (big blind) folded before Flop
Seat 5: I50OxuNg9riRq9sywF6jMQ folded before Flop (didn't bet)
Seat 6: 9U3ZKjCsarN0DjR6mSE8Ug folded before Flop (didn't bet)




PokerStars Game #59941928336:  Hold'em No Limit ($0.10/$0.25) - 2009/07/01 1:50:37 ET
Table 'fHv1Mk7ZbLjprZTGWKPiEQ' 6-max Seat #6 is the button
Seat 1: OIjOiBfQstWrK/RuXx7zcw ($3.80 in chips) 
Seat 2: 9U3ZKjCsarN0DjR6mSE8Ug ($14.05 in chips) 
Seat 3: /gJNBeCkWL4o85/jvlZ4BA ($25 in chips) 
Seat 4: TSmua8tGK3sTbwi0ynrW9Q ($60 in chips) 
Seat 5: LJI7A1YgDM7hgh7o56+ReQ ($25.95 in chips) 
Seat 6: AjG0X+rNtc2W08eph8oqpw ($52.40 in chips) 
OIjOiBfQstWrK/RuXx7zcw: posts small blind $0.10
9U3ZKjCsarN0DjR6mSE8Ug: posts big blind $0.25
*** HOLE CARDS ***
/gJNBeCkWL4o85/jvlZ4BA: folds 
TSmua8tGK3sTbwi0ynrW9Q: folds 
LJI7A1YgDM7hgh7o56+ReQ: folds 
AjG0X+rNtc2W08eph8oqpw: folds 
OIjOiBfQstWrK/RuXx7zcw: raises $0.25 to $0.50
9U3ZKjCsarN0DjR6mSE8Ug: calls $0.25
*** FLOP *** [7s Ks 8h]
OIjOiBfQstWrK/RuXx7zcw: checks 
9U3ZKjCsarN0DjR6mSE8Ug: checks 
*** TURN *** [7s Ks 8h] [3d]
OIjOiBfQstWrK/RuXx7zcw: bets $0.50
9U3ZKjCsarN0DjR6mSE8Ug: folds 
Uncalled bet ($0.50) returned to OIjOiBfQstWrK/RuXx7zcw
OIjOiBfQstWrK/RuXx7zcw collected $0.95 from pot
OIjOiBfQstWrK/RuXx7zcw: doesn't show hand 
*** SUMMARY ***
Total pot $1 | Rake $0.05 
Board [7s Ks 8h 3d]
Seat 1: OIjOiBfQstWrK/RuXx7zcw (small blind) collected ($0.95)
Seat 2: 9U3ZKjCsarN0DjR6mSE8Ug (big blind) folded on the Turn
Seat 3: /gJNBeCkWL4o85/jvlZ4BA folded before Flop (didn't bet)
Seat 4: TSmua8tGK3sTbwi0ynrW9Q folded before Flop (didn't bet)
Seat 5: LJI7A1YgDM7hgh7o56+ReQ folded before Flop (didn't bet)
Seat 6: AjG0X+rNtc2W08eph8oqpw (button) folded before Flop (didn't bet)




PokerStars Game #59941928280:  Hold'em No Limit ($0.10/$0.25) - 2009/07/01 1:50:37 ET
Table 'rtxA1Y01Nrq5VoyzTAuusQ' 9-max Seat #3 is the button
Seat 1: w1ukf8uPa4+WH561TtVRxA ($26.55 in chips) 
Seat 2: Th3FldXKQW6hWVVPahaoOQ ($25 in chips) 
Seat 3: K9fS1IUr5GpiJG7VkJ7IbA ($8.10 in chips) 
Seat 4: RHqgdFvufLCYe54+qd2gcA ($4.75 in chips) 
Seat 5: MtVtHDqIJTyUcXkRBBDIVA ($32.40 in chips) 
Seat 8: DnDcAdn9P0zGovMERigpFA ($25 in chips) 
Seat 9: HPEB+AtKw1+C/cxU0o1ciw ($22.35 in chips) 
RHqgdFvufLCYe54+qd2gcA: posts small blind $0.10
MtVtHDqIJTyUcXkRBBDIVA: posts big blind $0.25
W6tExOcYX7qiy6Qdp+ZwFA: sits out 
*** HOLE CARDS ***
DnDcAdn9P0zGovMERigpFA: folds 
HPEB+AtKw1+C/cxU0o1ciw: folds 
w1ukf8uPa4+WH561TtVRxA: folds 
Th3FldXKQW6hWVVPahaoOQ: folds 
K9fS1IUr5GpiJG7VkJ7IbA: folds 
RHqgdFvufLCYe54+qd2gcA: calls $0.15
MtVtHDqIJTyUcXkRBBDIVA: raises $0.50 to $0.75
RHqgdFvufLCYe54+qd2gcA: folds 
Uncalled bet ($0.50) returned to MtVtHDqIJTyUcXkRBBDIVA
MtVtHDqIJTyUcXkRBBDIVA collected $0.50 from pot
MtVtHDqIJTyUcXkRBBDIVA: doesn't show hand 
*** SUMMARY ***
Total pot $0.50 | Rake $0 
Seat 1: w1ukf8uPa4+WH561TtVRxA folded before Flop (didn't bet)
Seat 2: Th3FldXKQW6hWVVPahaoOQ folded before Flop (didn't bet)
Seat 3: K9fS1IUr5GpiJG7VkJ7IbA (button) folded before Flop (didn't bet)
Seat 4: RHqgdFvufLCYe54+qd2gcA (small blind) folded before Flop
Seat 5: MtVtHDqIJTyUcXkRBBDIVA (big blind) collected ($0.50)
Seat 8: DnDcAdn9P0zGovMERigpFA folded before Flop (didn't bet)
Seat 9: HPEB+AtKw1+C/cxU0o1ciw folded before Flop (didn't bet)




PokerStars Game #59941927894:  Hold'em No Limit ($0.10/$0.25) - 2009/07/01 1:50:37 ET
Table 'PCxB2W9H6ma8SwsZlImuOw' 9-max Seat #5 is the button
Seat 1: SqibpGx+lf+brY0fJVvD0w ($32.70 in chips) 
Seat 2: bXpVeaSTPBFSPJmeXxO7nw ($4.65 in chips) 
Seat 3: J2a/QHAWUgo6beDRoEyg2g ($5.85 in chips) 
Seat 4: RsPwA2DnzOke3hD/Of/DUg ($2.20 in chips) 
Seat 5: GZO7tOXatVoX17M2DqPcUQ ($15.15 in chips) 
Seat 6: 5/6dWEBUHldD7iGXa2LwsQ ($15.55 in chips) 
Seat 8: Pt637jKksB5MzP0UNJAAkw ($25.60 in chips) 
Seat 9: COwSH15MvHaRF7en6/TRZQ ($6.70 in chips) 
5/6dWEBUHldD7iGXa2LwsQ: posts small blind $0.10
Pt637jKksB5MzP0UNJAAkw: posts big blind $0.25
*** HOLE CARDS ***
COwSH15MvHaRF7en6/TRZQ: folds 
qwr38jl5txoR36M7G5qi4A joins the table at seat #7 
SqibpGx+lf+brY0fJVvD0w: folds 
bXpVeaSTPBFSPJmeXxO7nw: folds 
J2a/QHAWUgo6beDRoEyg2g: calls $0.25
RsPwA2DnzOke3hD/Of/DUg: folds 
GZO7tOXatVoX17M2DqPcUQ: raises $1.25 to $1.50
5/6dWEBUHldD7iGXa2LwsQ: folds 
Pt637jKksB5MzP0UNJAAkw: calls $1.25
J2a/QHAWUgo6beDRoEyg2g: folds 
*** FLOP *** [2s 9c 5c]
Pt637jKksB5MzP0UNJAAkw: checks 
GZO7tOXatVoX17M2DqPcUQ: bets $3
Pt637jKksB5MzP0UNJAAkw: folds 
Uncalled bet ($3) returned to GZO7tOXatVoX17M2DqPcUQ
GZO7tOXatVoX17M2DqPcUQ collected $3.20 from pot
*** SUMMARY ***
Total pot $3.35 | Rake $0.15 
Board [2s 9c 5c]
Seat 1: SqibpGx+lf+brY0fJVvD0w folded before Flop (didn't bet)
Seat 2: bXpVeaSTPBFSPJmeXxO7nw folded before Flop (didn't bet)
Seat 3: J2a/QHAWUgo6beDRoEyg2g folded before Flop
Seat 4: RsPwA2DnzOke3hD/Of/DUg folded before Flop (didn't bet)
Seat 5: GZO7tOXatVoX17M2DqPcUQ (button) collected ($3.20)
Seat 6: 5/6dWEBUHldD7iGXa2LwsQ (small blind) folded before Flop
Seat 8: Pt637jKksB5MzP0UNJAAkw (big blind) folded on the Flop
Seat 9: COwSH15MvHaRF7en6/TRZQ folded before Flop (didn't bet)




PokerStars Game #59941928016:  Hold'em No Limit ($0.10/$0.25) - 2009/07/01 1:50:37 ET
Table 'MRfAiS/4JSfnUDlCcZo0wAhfHe8uKeSJMyWAjSdM7ROQx Seat #2 is the button
Seat 1: 48oT5xFI+5CHUJlfoGrE4w ($29.55 in chips) 
Seat 2: /gJNBeCkWL4o85/jvlZ4BA ($25.85 in chips) 
Seat 4: b4wRQV3APH8irVk6bUFe2Q ($37.20 in chips) 
Seat 5: Q1uciOZPBR/WkAlqa6cL4A ($27.85 in chips) 
Seat 6: df01R5ThvHspD8FgKmaDvQ ($25 in chips) 
b4wRQV3APH8irVk6bUFe2Q: posts small blind $0.10
Q1uciOZPBR/WkAlqa6cL4A: posts big blind $0.25
*** HOLE CARDS ***
df01R5ThvHspD8FgKmaDvQ: folds 
48oT5xFI+5CHUJlfoGrE4w: folds 
/gJNBeCkWL4o85/jvlZ4BA: folds 
b4wRQV3APH8irVk6bUFe2Q: folds 
Uncalled bet ($0.15) returned to Q1uciOZPBR/WkAlqa6cL4A
Q1uciOZPBR/WkAlqa6cL4A collected $0.20 from pot
Q1uciOZPBR/WkAlqa6cL4A: doesn't show hand 
*** SUMMARY ***
Total pot $0.20 | Rake $0 
Seat 1: 48oT5xFI+5CHUJlfoGrE4w folded before Flop (didn't bet)
Seat 2: /gJNBeCkWL4o85/jvlZ4BA (button) folded before Flop (didn't bet)
Seat 4: b4wRQV3APH8irVk6bUFe2Q (small blind) folded before Flop
Seat 5: Q1uciOZPBR/WkAlqa6cL4A (big blind) collected ($0.20)
Seat 6: df01R5ThvHspD8FgKmaDvQ folded before Flop (didn't bet)




PokerStars Game #59941928126:  Hold'em No Limit ($0.10/$0.25) - 2009/07/01 1:50:37 ET
Table 'qInMnOOn7vKcj4bU7zju7g' 9-max Seat #9 is the button
Seat 1: CT7Xj/V/O5rBlhtt+RZeFQ ($38.15 in chips) 
Seat 2: HgIyqrvSG8TRRZl5mlzfHA ($61.85 in chips) 
Seat 3: zDrucyjVn5aeekNEc3cJrA ($25.80 in chips) 
Seat 4: ScCuCTbi71/EWsLKZXaZeg ($17.80 in chips) 
Seat 5: KlccfkOygm1GJZoSZYEgBw ($13.15 in chips) 
Seat 6: 4awUyiDYTgylQKXZ9faBVA ($25 in chips) 
Seat 7: st9jtdNbm1W5GfBwRaCVqQ ($24.75 in chips) 
Seat 8: Mh2r9hTeTEDnh19sRZtW3g ($11.35 in chips) 
Seat 9: sbArFaUiGjfmf5dg1O4ffg ($3.35 in chips) 
CT7Xj/V/O5rBlhtt+RZeFQ: posts small blind $0.10
HgIyqrvSG8TRRZl5mlzfHA: posts big blind $0.25
*** HOLE CARDS ***
zDrucyjVn5aeekNEc3cJrA: folds 
ScCuCTbi71/EWsLKZXaZeg: calls $0.25
KlccfkOygm1GJZoSZYEgBw: folds 
4awUyiDYTgylQKXZ9faBVA: raises $1 to $1.25
st9jtdNbm1W5GfBwRaCVqQ: folds 
Mh2r9hTeTEDnh19sRZtW3g: folds 
sbArFaUiGjfmf5dg1O4ffg: folds 
CT7Xj/V/O5rBlhtt+RZeFQ: folds 
HgIyqrvSG8TRRZl5mlzfHA: raises $1.75 to $3
ScCuCTbi71/EWsLKZXaZeg: calls $2.75
4awUyiDYTgylQKXZ9faBVA: calls $1.75
*** FLOP *** [Jd Jc 5h]
HgIyqrvSG8TRRZl5mlzfHA: bets $9
ScCuCTbi71/EWsLKZXaZeg: folds 
4awUyiDYTgylQKXZ9faBVA: folds 
Uncalled bet ($9) returned to HgIyqrvSG8TRRZl5mlzfHA
HgIyqrvSG8TRRZl5mlzfHA collected $8.65 from pot
HgIyqrvSG8TRRZl5mlzfHA: doesn't show hand 
*** SUMMARY ***
Total pot $9.10 | Rake $0.45 
Board [Jd Jc 5h]
Seat 1: CT7Xj/V/O5rBlhtt+RZeFQ (small blind) folded before Flop
Seat 2: HgIyqrvSG8TRRZl5mlzfHA (big blind) collected ($8.65)
Seat 3: zDrucyjVn5aeekNEc3cJrA folded before Flop (didn't bet)
Seat 4: ScCuCTbi71/EWsLKZXaZeg folded on the Flop
Seat 5: KlccfkOygm1GJZoSZYEgBw folded before Flop (didn't bet)
Seat 6: 4awUyiDYTgylQKXZ9faBVA folded on the Flop
Seat 7: st9jtdNbm1W5GfBwRaCVqQ folded before Flop (didn't bet)
Seat 8: Mh2r9hTeTEDnh19sRZtW3g folded before Flop (didn't bet)
Seat 9: sbArFaUiGjfmf5dg1O4ffg (button) folded before Flop (didn't bet)




PokerStars Game #59941928006:  Hold'em No Limit ($0.10/$0.25) - 2009/07/01 1:50:37 ET
Table 'dYNvO8G5kw5SRxb1Dljhogz2yOdY2zyGWG1gh9WV9XtQ Seat #6 is the button
Seat 1: vSkQm2EelzwRGDDQQk0Fqw ($17.30 in chips) 
Seat 2: PkBmevN3LdXkPj1LHOoTnQ ($1.35 in chips) 
Seat 3: 1Cs1GyQcoM1omwY7XZ3uRg ($12 in chips) 
Seat 4: sD+TKtt36XiiN6jqHiLwDA ($28.10 in chips) 
Seat 5: W7XGvw6ngGVq2hFwXk8Myg ($25.10 in chips) 
Seat 6: 22dIObOuor/A+IKWkNoAlA ($7.95 in chips) 
Seat 7: DiSvPC2iudwL5j9u6Huyww ($39.50 in chips) 
Seat 8: 6HoFYfVGBefsR5Vrz62qIw5hAPbqNrvJb8PtLiceXtlg1.05 in chips) 
Seat 9: PdIasPkzm2sqZnN41ZRXOg ($5 in chips) 
DiSvPC2iudwL5j9u6Huyww: posts small blind $0.10
6HoFYfVGBefsR5Vrz62qIw5hAPbqNrvJb8PtLiceXtlgsts big blind $0.25
*** HOLE CARDS ***
PdIasPkzm2sqZnN41ZRXOg: folds 
vSkQm2EelzwRGDDQQk0Fqw: folds 
PkBmevN3LdXkPj1LHOoTnQ: calls $0.25
1Cs1GyQcoM1omwY7XZ3uRg: calls $0.25
sD+TKtt36XiiN6jqHiLwDA: folds 
W7XGvw6ngGVq2hFwXk8Myg: calls $0.25
22dIObOuor/A+IKWkNoAlA: folds 
DiSvPC2iudwL5j9u6Huyww: folds 
6HoFYfVGBefsR5Vrz62qIw5hAPbqNrvJb8PtLiceXtlgecks 
*** FLOP *** [7h 4s Tc]
6HoFYfVGBefsR5Vrz62qIw5hAPbqNrvJb8PtLiceXtlgts $0.25
PkBmevN3LdXkPj1LHOoTnQ: calls $0.25
1Cs1GyQcoM1omwY7XZ3uRg: calls $0.25
W7XGvw6ngGVq2hFwXk8Myg: folds 
*** TURN *** [7h 4s Tc] [7s]
6HoFYfVGBefsR5Vrz62qIw5hAPbqNrvJb8PtLiceXtlgts $0.50
PkBmevN3LdXkPj1LHOoTnQ: raises $0.35 to $0.85 and is all-in
1Cs1GyQcoM1omwY7XZ3uRg: folds 
6HoFYfVGBefsR5Vrz62qIw5hAPbqNrvJb8PtLiceXtlglls $0.35
*** RIVER *** [7h 4s Tc 7s] [Jc]
*** SHOW DOWN ***
6HoFYfVGBefsR5Vrz62qIw5hAPbqNrvJb8PtLiceXtlgows [3s 4c] (two pair, Sevens and Fours)
PkBmevN3LdXkPj1LHOoTnQ: shows [Ks Th] (two pair, Tens and Sevens)
PkBmevN3LdXkPj1LHOoTnQ collected $3.40 from pot
*** SUMMARY ***
Total pot $3.55 | Rake $0.15 
Board [7h 4s Tc 7s Jc]
Seat 1: vSkQm2EelzwRGDDQQk0Fqw folded before Flop (didn't bet)
Seat 2: PkBmevN3LdXkPj1LHOoTnQ showed [Ks Th] and won ($3.40) with two pair, Tens and Sevens
Seat 3: 1Cs1GyQcoM1omwY7XZ3uRg folded on the Turn
Seat 4: sD+TKtt36XiiN6jqHiLwDA folded before Flop (didn't bet)
Seat 5: W7XGvw6ngGVq2hFwXk8Myg folded on the Flop
Seat 6: 22dIObOuor/A+IKWkNoAlA (button) folded before Flop (didn't bet)
Seat 7: DiSvPC2iudwL5j9u6Huyww (small blind) folded before Flop
Seat 8: 6HoFYfVGBefsR5Vrz62qIw5hAPbqNrvJb8PtLiceXtlgg blind) showed [3s 4c] and lost with two pair, Sevens and Fours
Seat 9: PdIasPkzm2sqZnN41ZRXOg folded before Flop (didn't bet)




PokerStars Game #59941928576:  Hold'em No Limit ($0.10/$0.25) - 2009/07/01 1:50:38 ET
Table 'hg+KpirwreMnBAFQr/SEUA' 9-max Seat #2 is the button
Seat 1: H5Se03ZqSX7tbULXur2MAg ($35.80 in chips) 
Seat 2: cpnBzHjFACn5zAY56UIvNA ($20.25 in chips) 
Seat 3: DdyXKuBx0HAOC7dWZmGxWg ($23.25 in chips) 
Seat 4: Z9W7+g1WMhhZDi7DwGbCFA ($5 in chips) 
Seat 5: +2kMBNpY4nF1qNCRd8SJLA ($25 in chips) 
Seat 6: Bb42QRQMhg5/Y0vHP8/2Xw ($25.35 in chips) 
Seat 7: 5LSuZS4qvcUri/Byfkln7w ($7.25 in chips) 
Seat 8: HPEB+AtKw1+C/cxU0o1ciw ($22.90 in chips) 
Seat 9: xbecloQJYmBOSkzT9lZ+rg ($20 in chips) 
DdyXKuBx0HAOC7dWZmGxWg: posts small blind $0.10
Z9W7+g1WMhhZDi7DwGbCFA: posts big blind $0.25
*** HOLE CARDS ***
+2kMBNpY4nF1qNCRd8SJLA: folds 
Bb42QRQMhg5/Y0vHP8/2Xw: calls $0.25
5LSuZS4qvcUri/Byfkln7w: calls $0.25
HPEB+AtKw1+C/cxU0o1ciw: calls $0.25
xbecloQJYmBOSkzT9lZ+rg: raises $0.50 to $0.75
H5Se03ZqSX7tbULXur2MAg: folds 
cpnBzHjFACn5zAY56UIvNA: folds 
DdyXKuBx0HAOC7dWZmGxWg: folds 
Z9W7+g1WMhhZDi7DwGbCFA: folds 
Bb42QRQMhg5/Y0vHP8/2Xw: calls $0.50
5LSuZS4qvcUri/Byfkln7w: calls $0.50
HPEB+AtKw1+C/cxU0o1ciw: calls $0.50
*** FLOP *** [As 6h 6c]
Bb42QRQMhg5/Y0vHP8/2Xw: checks 
5LSuZS4qvcUri/Byfkln7w: checks 
HPEB+AtKw1+C/cxU0o1ciw: checks 
xbecloQJYmBOSkzT9lZ+rg: checks 
*** TURN *** [As 6h 6c] [Ac]
Bb42QRQMhg5/Y0vHP8/2Xw: checks 
5LSuZS4qvcUri/Byfkln7w: checks 
HPEB+AtKw1+C/cxU0o1ciw: checks 
xbecloQJYmBOSkzT9lZ+rg: checks 
*** RIVER *** [As 6h 6c Ac] [9s]
Bb42QRQMhg5/Y0vHP8/2Xw: checks 
5LSuZS4qvcUri/Byfkln7w: checks 
HPEB+AtKw1+C/cxU0o1ciw: checks 
xbecloQJYmBOSkzT9lZ+rg: bets $1.50
Bb42QRQMhg5/Y0vHP8/2Xw: folds 
5LSuZS4qvcUri/Byfkln7w: folds 
HPEB+AtKw1+C/cxU0o1ciw: folds 
Uncalled bet ($1.50) returned to xbecloQJYmBOSkzT9lZ+rg
xbecloQJYmBOSkzT9lZ+rg collected $3.20 from pot
*** SUMMARY ***
Total pot $3.35 | Rake $0.15 
Board [As 6h 6c Ac 9s]
Seat 1: H5Se03ZqSX7tbULXur2MAg folded before Flop (didn't bet)
Seat 2: cpnBzHjFACn5zAY56UIvNA (button) folded before Flop (didn't bet)
Seat 3: DdyXKuBx0HAOC7dWZmGxWg (small blind) folded before Flop
Seat 4: Z9W7+g1WMhhZDi7DwGbCFA (big blind) folded before Flop
Seat 5: +2kMBNpY4nF1qNCRd8SJLA folded before Flop (didn't bet)
Seat 6: Bb42QRQMhg5/Y0vHP8/2Xw folded on the River
Seat 7: 5LSuZS4qvcUri/Byfkln7w folded on the River
Seat 8: HPEB+AtKw1+C/cxU0o1ciw folded on the River
Seat 9: xbecloQJYmBOSkzT9lZ+rg collected ($3.20)




PokerStars Game #59941928704:  Hold'em No Limit ($0.10/$0.25) - 2009/07/01 1:50:38 ET
Table 'fIMYcWwN4/aXFJvH5Z8Ymg' 6-max Seat #1 is the button
Seat 1: DihMHaz4WNETH1bPDe13kA ($25.35 in chips) 
Seat 2: Mhj3q7cxev+XjXZxEE6/Cw ($26.05 in chips) 
Seat 3: 9bpVv1/Qh9IYtXuCtl5VtQ ($24.65 in chips) 
Seat 4: 7cx44/slbeTw+Cy7QB8Trg ($25 in chips) 
Seat 6: jp34e617tIzV8tKIWmfAbA ($28.35 in chips) 
Mhj3q7cxev+XjXZxEE6/Cw: posts small blind $0.10
9bpVv1/Qh9IYtXuCtl5VtQ: posts big blind $0.25
*** HOLE CARDS ***
7cx44/slbeTw+Cy7QB8Trg: folds 
jp34e617tIzV8tKIWmfAbA: folds 
DihMHaz4WNETH1bPDe13kA: folds 
Mhj3q7cxev+XjXZxEE6/Cw: folds 
Uncalled bet ($0.15) returned to 9bpVv1/Qh9IYtXuCtl5VtQ
9bpVv1/Qh9IYtXuCtl5VtQ collected $0.20 from pot
9bpVv1/Qh9IYtXuCtl5VtQ: doesn't show hand 
*** SUMMARY ***
Total pot $0.20 | Rake $0 
Seat 1: DihMHaz4WNETH1bPDe13kA (button) folded before Flop (didn't bet)
Seat 2: Mhj3q7cxev+XjXZxEE6/Cw (small blind) folded before Flop
Seat 3: 9bpVv1/Qh9IYtXuCtl5VtQ (big blind) collected ($0.20)
Seat 4: 7cx44/slbeTw+Cy7QB8Trg folded before Flop (didn't bet)
Seat 6: jp34e617tIzV8tKIWmfAbA folded before Flop (didn't bet)




PokerStars Game #59941928556:  Hold'em No Limit ($0.10/$0.25) - 2009/07/01 1:50:38 ET
Table 'ggwTHpIC5qhhHJSYjK1XCw' 6-max Seat #2 is the button
Seat 1: QkldTZNd6k/x09xKp/8lIw ($5 in chips) 
Seat 2: /gJNBeCkWL4o85/jvlZ4BA ($25 in chips) 
Seat 3: 7cx44/slbeTw+Cy7QB8Trg ($24.25 in chips) 
Seat 4: JFIAqU8lCZ0vWwEl4bdGsg ($25 in chips) 
Seat 5: BvqhBa7W/To51LhEiIU/lw ($8.10 in chips) 
Seat 6: 732E3Iz0geWMK40ej+U9HA ($9.90 in chips) 
7cx44/slbeTw+Cy7QB8Trg: posts small blind $0.10
JFIAqU8lCZ0vWwEl4bdGsg: posts big blind $0.25
732E3Iz0geWMK40ej+U9HA: posts small & big blinds $0.35
QkldTZNd6k/x09xKp/8lIw: posts big blind $0.25
*** HOLE CARDS ***
BvqhBa7W/To51LhEiIU/lw: folds 
732E3Iz0geWMK40ej+U9HA: checks 
QkldTZNd6k/x09xKp/8lIw: checks 
/gJNBeCkWL4o85/jvlZ4BA: folds 
7cx44/slbeTw+Cy7QB8Trg: calls $0.15
JFIAqU8lCZ0vWwEl4bdGsg: checks 
*** FLOP *** [Kh 5c Td]
7cx44/slbeTw+Cy7QB8Trg: checks 
JFIAqU8lCZ0vWwEl4bdGsg: checks 
732E3Iz0geWMK40ej+U9HA: checks 
QkldTZNd6k/x09xKp/8lIw: checks 
*** TURN *** [Kh 5c Td] [2h]
7cx44/slbeTw+Cy7QB8Trg: checks 
JFIAqU8lCZ0vWwEl4bdGsg: checks 
732E3Iz0geWMK40ej+U9HA: checks 
QkldTZNd6k/x09xKp/8lIw: checks 
*** RIVER *** [Kh 5c Td 2h] [8s]
7cx44/slbeTw+Cy7QB8Trg: checks 
JFIAqU8lCZ0vWwEl4bdGsg: checks 
732E3Iz0geWMK40ej+U9HA: bets $0.50
QkldTZNd6k/x09xKp/8lIw: folds 
7cx44/slbeTw+Cy7QB8Trg: folds 
JFIAqU8lCZ0vWwEl4bdGsg: calls $0.50
*** SHOW DOWN ***
732E3Iz0geWMK40ej+U9HA: shows [8d Ad] (a pair of Eights)
JFIAqU8lCZ0vWwEl4bdGsg: shows [6s Th] (a pair of Tens)
JFIAqU8lCZ0vWwEl4bdGsg collected $2 from pot
*** SUMMARY ***
Total pot $2.10 | Rake $0.10 
Board [Kh 5c Td 2h 8s]
Seat 1: QkldTZNd6k/x09xKp/8lIw folded on the River
Seat 2: /gJNBeCkWL4o85/jvlZ4BA (button) folded before Flop (didn't bet)
Seat 3: 7cx44/slbeTw+Cy7QB8Trg (small blind) folded on the River
Seat 4: JFIAqU8lCZ0vWwEl4bdGsg (big blind) showed [6s Th] and won ($2) with a pair of Tens
Seat 5: BvqhBa7W/To51LhEiIU/lw folded before Flop (didn't bet)
Seat 6: 732E3Iz0geWMK40ej+U9HA showed [8d Ad] and lost with a pair of Eights




PokerStars Game #59941929404:  Hold'em No Limit ($0.10/$0.25) - 2009/07/01 1:50:39 ET
Table 'eOXPe2c6mG7DOFKvMsZZfA' 6-max Seat #2 is the button
Seat 1: s21kVGMLPAoHdWR+muSonw ($25.90 in chips) 
Seat 2: gaPMxLGp9SOj4Lq6t+/0Ig ($8.85 in chips) 
Seat 3: kReyZ6g6Fu3tQ0nyjDf9kA ($24.35 in chips) 
Seat 4: zHHLkD2sRljslKKeQv/ZQw ($32.50 in chips) 
Seat 5: NhUN/JpAprdJeamFBgJH1w ($34.05 in chips) 
Seat 6: Qpv/hb5ak7LeaDig1L5L8w ($14.45 in chips) 
kReyZ6g6Fu3tQ0nyjDf9kA: posts small blind $0.10
zHHLkD2sRljslKKeQv/ZQw: posts big blind $0.25
*** HOLE CARDS ***
NhUN/JpAprdJeamFBgJH1w: folds 
Qpv/hb5ak7LeaDig1L5L8w: folds 
s21kVGMLPAoHdWR+muSonw: folds 
gaPMxLGp9SOj4Lq6t+/0Ig: folds 
kReyZ6g6Fu3tQ0nyjDf9kA: calls $0.15
zHHLkD2sRljslKKeQv/ZQw: checks 
*** FLOP *** [5c 6s Qh]
kReyZ6g6Fu3tQ0nyjDf9kA: checks 
zHHLkD2sRljslKKeQv/ZQw: checks 
*** TURN *** [5c 6s Qh] [Jd]
kReyZ6g6Fu3tQ0nyjDf9kA: bets $0.25
zHHLkD2sRljslKKeQv/ZQw: folds 
Uncalled bet ($0.25) returned to kReyZ6g6Fu3tQ0nyjDf9kA
kReyZ6g6Fu3tQ0nyjDf9kA collected $0.50 from pot
*** SUMMARY ***
Total pot $0.50 | Rake $0 
Board [5c 6s Qh Jd]
Seat 1: s21kVGMLPAoHdWR+muSonw folded before Flop (didn't bet)
Seat 2: gaPMxLGp9SOj4Lq6t+/0Ig (button) folded before Flop (didn't bet)
Seat 3: kReyZ6g6Fu3tQ0nyjDf9kA (small blind) collected ($0.50)
Seat 4: zHHLkD2sRljslKKeQv/ZQw (big blind) folded on the Turn
Seat 5: NhUN/JpAprdJeamFBgJH1w folded before Flop (didn't bet)
Seat 6: Qpv/hb5ak7LeaDig1L5L8w folded before Flop (didn't bet)




PokerStars Game #59941929112:  Hold'em No Limit ($0.10/$0.25) - 2009/07/01 1:50:39 ET
Table 'O5NgMYt6EWbLBozZb3kseg' 6-max Seat #2 is the button
Seat 1: uS0JK3noJsnWbcX2Jtcj8A ($25 in chips) 
Seat 2: ZZm/rg8aThjE+A2LiItuzA ($11.95 in chips) 
Seat 3: 0bf6ZOD3FadOOzjtjXlcRQ ($4.85 in chips) 
Seat 4: ItRgvLhXTZHvtZowz+dbIw ($12.90 in chips) 
Seat 5: u3Ol7kv1LmvszuHNm9rc6w ($25.45 in chips) 
Seat 6: 3m6VfX7io8SA31qh1zCkgQ ($26.95 in chips) 
0bf6ZOD3FadOOzjtjXlcRQ: posts small blind $0.10
ItRgvLhXTZHvtZowz+dbIw: posts big blind $0.25
uS0JK3noJsnWbcX2Jtcj8A is disconnected 
uS0JK3noJsnWbcX2Jtcj8A is connected 
uS0JK3noJsnWbcX2Jtcj8A: posts big blind $0.25
*** HOLE CARDS ***
u3Ol7kv1LmvszuHNm9rc6w: folds 
3m6VfX7io8SA31qh1zCkgQ: calls $0.25
uS0JK3noJsnWbcX2Jtcj8A: checks 
ZZm/rg8aThjE+A2LiItuzA: calls $0.25
0bf6ZOD3FadOOzjtjXlcRQ: raises $4.60 to $4.85 and is all-in
ItRgvLhXTZHvtZowz+dbIw: folds 
3m6VfX7io8SA31qh1zCkgQ: calls $4.60
uS0JK3noJsnWbcX2Jtcj8A: folds 
ZZm/rg8aThjE+A2LiItuzA: folds 
*** FLOP *** [8h 6s 7c]
*** TURN *** [8h 6s 7c] [7h]
*** RIVER *** [8h 6s 7c 7h] [3c]
*** SHOW DOWN ***
0bf6ZOD3FadOOzjtjXlcRQ: shows [6c Kh] (two pair, Sevens and Sixes)
3m6VfX7io8SA31qh1zCkgQ: mucks hand 
0bf6ZOD3FadOOzjtjXlcRQ collected $9.95 from pot
*** SUMMARY ***
Total pot $10.45 | Rake $0.50 
Board [8h 6s 7c 7h 3c]
Seat 1: uS0JK3noJsnWbcX2Jtcj8A folded before Flop
Seat 2: ZZm/rg8aThjE+A2LiItuzA (button) folded before Flop
Seat 3: 0bf6ZOD3FadOOzjtjXlcRQ (small blind) showed [6c Kh] and won ($9.95) with two pair, Sevens and Sixes
Seat 4: ItRgvLhXTZHvtZowz+dbIw (big blind) folded before Flop
Seat 5: u3Ol7kv1LmvszuHNm9rc6w folded before Flop (didn't bet)
Seat 6: 3m6VfX7io8SA31qh1zCkgQ mucked




PokerStars Game #59941929188:  Hold'em No Limit ($0.10/$0.25) - 2009/07/01 1:50:39 ET
Table 'hfHe8uKeSJMyWAjSdM7ROQ' 6-max Seat #1 is the button
Seat 1: eHsmIvAb2JREg4O6hNPnXg ($44.55 in chips) 
Seat 2: QvTX2yGq3uKJiKPmns4TKQ ($29.30 in chips) 
Seat 3: dOX4wnYV2sEqvDbF+8KSCw ($25 in chips) 
Seat 4: b4wRQV3APH8irVk6bUFe2Q ($33.55 in chips) 
Seat 5: euswrBD1XG0Q5hB1iGJBKQ ($60.80 in chips) 
Seat 6: eL3+wCBjFGfQ5FMdIZihwA ($25 in chips) 
QvTX2yGq3uKJiKPmns4TKQ: posts small blind $0.10
dOX4wnYV2sEqvDbF+8KSCw: posts big blind $0.25
*** HOLE CARDS ***
b4wRQV3APH8irVk6bUFe2Q: raises $0.50 to $0.75
euswrBD1XG0Q5hB1iGJBKQ: folds 
eL3+wCBjFGfQ5FMdIZihwA: folds 
eHsmIvAb2JREg4O6hNPnXg: folds 
QvTX2yGq3uKJiKPmns4TKQ: folds 
dOX4wnYV2sEqvDbF+8KSCw: folds 
Uncalled bet ($0.50) returned to b4wRQV3APH8irVk6bUFe2Q
b4wRQV3APH8irVk6bUFe2Q collected $0.60 from pot
*** SUMMARY ***
Total pot $0.60 | Rake $0 
Seat 1: eHsmIvAb2JREg4O6hNPnXg (button) folded before Flop (didn't bet)
Seat 2: QvTX2yGq3uKJiKPmns4TKQ (small blind) folded before Flop
Seat 3: dOX4wnYV2sEqvDbF+8KSCw (big blind) folded before Flop
Seat 4: b4wRQV3APH8irVk6bUFe2Q collected ($0.60)
Seat 5: euswrBD1XG0Q5hB1iGJBKQ folded before Flop (didn't bet)
Seat 6: eL3+wCBjFGfQ5FMdIZihwA folded before Flop (didn't bet)




PokerStars Game #59941929426:  Hold'em No Limit ($0.10/$0.25) - 2009/07/01 1:50:39 ET
Table 'C8mMnVmvkagwolEzTvh07A' 9-max Seat #5 is the button
Seat 1: PqvgxdSg9z5VmrWpbYuz+g ($26.15 in chips) 
Seat 2: Bb42QRQMhg5/Y0vHP8/2Xw ($25.35 in chips) 
Seat 3: Th3FldXKQW6hWVVPahaoOQ ($34.50 in chips) 
Seat 4: dfNim92Z6XK1/h5SFW5vDg ($25 in chips) 
Seat 5: iGMlK+EhUflPB6jKQd95Cg ($25 in chips) 
Seat 6: AiXn/9o1EwOPZUHujnh/bA ($18.25 in chips) 
AiXn/9o1EwOPZUHujnh/bA: posts small blind $0.10
4awUyiDYTgylQKXZ9faBVA: is sitting out 
4awUyiDYTgylQKXZ9faBVA leaves the table
PqvgxdSg9z5VmrWpbYuz+g: posts big blind $0.25
*** HOLE CARDS ***
Bb42QRQMhg5/Y0vHP8/2Xw: folds 
18G4P1XstjNvItdGUITxgw joins the table at seat #9 
Th3FldXKQW6hWVVPahaoOQ: folds 
dfNim92Z6XK1/h5SFW5vDg: raises $0.75 to $1
iGMlK+EhUflPB6jKQd95Cg: folds 
AiXn/9o1EwOPZUHujnh/bA: folds 
PqvgxdSg9z5VmrWpbYuz+g: folds 
Uncalled bet ($0.75) returned to dfNim92Z6XK1/h5SFW5vDg
dfNim92Z6XK1/h5SFW5vDg collected $0.60 from pot
dfNim92Z6XK1/h5SFW5vDg: doesn't show hand 
*** SUMMARY ***
Total pot $0.60 | Rake $0 
Seat 1: PqvgxdSg9z5VmrWpbYuz+g (big blind) folded before Flop
Seat 2: Bb42QRQMhg5/Y0vHP8/2Xw folded before Flop (didn't bet)
Seat 3: Th3FldXKQW6hWVVPahaoOQ folded before Flop (didn't bet)
Seat 4: dfNim92Z6XK1/h5SFW5vDg collected ($0.60)
Seat 5: iGMlK+EhUflPB6jKQd95Cg (button) folded before Flop (didn't bet)
Seat 6: AiXn/9o1EwOPZUHujnh/bA (small blind) folded before Flop




PokerStars Game #59941929464:  Hold'em No Limit ($0.10/$0.25) - 2009/07/01 1:50:39 ET
Table '/AhP8uWRzEEhOATYIdmn0A' 9-max Seat #3 is the button
Seat 1: +sbyWwIcFp9kP0bDtMegfQ ($37.45 in chips) 
Seat 3: jx6dnobNHstDG0tabsbKHQ ($3.20 in chips) 
Seat 5: iZ1f67Ok/207yzIQOu1Kdg ($4.75 in chips) 
Seat 6: 8EbrQ/EvFWt2cr0GaU82gQ ($5 in chips) 
Seat 7: cZ99hugmLBj9KhTlc8nCSw ($25 in chips) 
Seat 8: K86cg2ifCMFAlmzsfTDjig ($42.60 in chips) 
Seat 9: OfGfQFPcghysTDljS9GQSQ ($10.60 in chips) 
+qc/EYCgLC65SpGvr35eNg will be allowed to play after the button
iZ1f67Ok/207yzIQOu1Kdg: posts small blind $0.10
8EbrQ/EvFWt2cr0GaU82gQ: posts big blind $0.25
DdPXdieucQ+n99u1n3A+rQ: sits out 
*** HOLE CARDS ***
cZ99hugmLBj9KhTlc8nCSw: folds 
K86cg2ifCMFAlmzsfTDjig: calls $0.25
OfGfQFPcghysTDljS9GQSQ: folds 
+sbyWwIcFp9kP0bDtMegfQ: folds 
jx6dnobNHstDG0tabsbKHQ: folds 
iZ1f67Ok/207yzIQOu1Kdg: folds 
8EbrQ/EvFWt2cr0GaU82gQ: checks 
*** FLOP *** [9s 4d 8c]
8EbrQ/EvFWt2cr0GaU82gQ: checks 
K86cg2ifCMFAlmzsfTDjig: checks 
*** TURN *** [9s 4d 8c] [5d]
8EbrQ/EvFWt2cr0GaU82gQ: checks 
K86cg2ifCMFAlmzsfTDjig: checks 
*** RIVER *** [9s 4d 8c 5d] [Qh]
8EbrQ/EvFWt2cr0GaU82gQ: checks 
K86cg2ifCMFAlmzsfTDjig: bets $1.50
8EbrQ/EvFWt2cr0GaU82gQ: folds 
Uncalled bet ($1.50) returned to K86cg2ifCMFAlmzsfTDjig
K86cg2ifCMFAlmzsfTDjig collected $0.60 from pot
K86cg2ifCMFAlmzsfTDjig: doesn't show hand 
*** SUMMARY ***
Total pot $0.60 | Rake $0 
Board [9s 4d 8c 5d Qh]
Seat 1: +sbyWwIcFp9kP0bDtMegfQ folded before Flop (didn't bet)
Seat 3: jx6dnobNHstDG0tabsbKHQ (button) folded before Flop (didn't bet)
Seat 5: iZ1f67Ok/207yzIQOu1Kdg (small blind) folded before Flop
Seat 6: 8EbrQ/EvFWt2cr0GaU82gQ (big blind) folded on the River
Seat 7: cZ99hugmLBj9KhTlc8nCSw folded before Flop (didn't bet)
Seat 8: K86cg2ifCMFAlmzsfTDjig collected ($0.60)
Seat 9: OfGfQFPcghysTDljS9GQSQ folded before Flop (didn't bet)




PokerStars Game #59941929048:  Hold'em No Limit ($0.10/$0.25) - 2009/07/01 1:50:39 ET
Table 'DhkrdW2UOy2PfjSW28Kq8w' 6-max Seat #3 is the button
Seat 2: v+QfkGiuj9bgtuNoVnDO8w ($27.30 in chips) 
Seat 3: B3X187C0tXFUfQpCu8pe8A ($21.40 in chips) 
Seat 4: 59HJSCM1X37BkMpI9N0mEw ($22.65 in chips) 
Seat 5: cS21pIxRHx5Gt42o7hPZzw ($11.45 in chips) 
Seat 6: DihMHaz4WNETH1bPDe13kA ($27.10 in chips) 
59HJSCM1X37BkMpI9N0mEw: posts small blind $0.10
cS21pIxRHx5Gt42o7hPZzw: posts big blind $0.25
Mhj3q7cxev+XjXZxEE6/Cw: sits out 
*** HOLE CARDS ***
DihMHaz4WNETH1bPDe13kA: folds 
v+QfkGiuj9bgtuNoVnDO8w: folds 
B3X187C0tXFUfQpCu8pe8A: folds 
59HJSCM1X37BkMpI9N0mEw: folds 
Uncalled bet ($0.15) returned to cS21pIxRHx5Gt42o7hPZzw
cS21pIxRHx5Gt42o7hPZzw collected $0.20 from pot
cS21pIxRHx5Gt42o7hPZzw: doesn't show hand 
*** SUMMARY ***
Total pot $0.20 | Rake $0 
Seat 2: v+QfkGiuj9bgtuNoVnDO8w folded before Flop (didn't bet)
Seat 3: B3X187C0tXFUfQpCu8pe8A (button) folded before Flop (didn't bet)
Seat 4: 59HJSCM1X37BkMpI9N0mEw (small blind) folded before Flop
Seat 5: cS21pIxRHx5Gt42o7hPZzw (big blind) collected ($0.20)
Seat 6: DihMHaz4WNETH1bPDe13kA folded before Flop (didn't bet)




PokerStars Game #59941929182:  Hold'em No Limit ($0.10/$0.25) - 2009/07/01 1:50:39 ET
Table 'Mef6A0EMopL6WaFO5/KO9g' 6-max Seat #1 is the button
Seat 1: GbCVUNssQ7mqsPWr7J4d3w ($4.65 in chips) 
Seat 2: 8ClCHtFXGNplITm+63KB+Q ($29.45 in chips) 
Seat 5: DihMHaz4WNETH1bPDe13kA ($41.40 in chips) 
Seat 6: jp34e617tIzV8tKIWmfAbA ($37.55 in chips) 
8ClCHtFXGNplITm+63KB+Q: posts small blind $0.10
MaddesZoggt: is sitting out 
MaddesZoggt leaves the table
DihMHaz4WNETH1bPDe13kA: posts big blind $0.25
*** HOLE CARDS ***
jp34e617tIzV8tKIWmfAbA: raises $0.50 to $0.75
GbCVUNssQ7mqsPWr7J4d3w: folds 
8ClCHtFXGNplITm+63KB+Q: folds 
DihMHaz4WNETH1bPDe13kA: folds 
Uncalled bet ($0.50) returned to jp34e617tIzV8tKIWmfAbA
jp34e617tIzV8tKIWmfAbA collected $0.60 from pot
jp34e617tIzV8tKIWmfAbA is sitting out
jp34e617tIzV8tKIWmfAbA: doesn't show hand 
*** SUMMARY ***
Total pot $0.60 | Rake $0 
Seat 1: GbCVUNssQ7mqsPWr7J4d3w (button) folded before Flop (didn't bet)
Seat 2: 8ClCHtFXGNplITm+63KB+Q (small blind) folded before Flop
Seat 5: DihMHaz4WNETH1bPDe13kA (big blind) folded before Flop
Seat 6: jp34e617tIzV8tKIWmfAbA collected ($0.60)




PokerStars Game #59941929342:  Hold'em No Limit ($0.10/$0.25) - 2009/07/01 1:50:39 ET
Table 'SgI2Cobdjtkh0Fd0/eTTDg' 9-max Seat #3 is the button
Seat 1: p4VoE724cQin02zatf/NOw ($4.75 in chips) 
Seat 2: uUc5QTI8+ZdC95UnznCsqg ($14.10 in chips) 
Seat 3: GeMoapCKDLc4ajT0Uk9ZQw ($9.65 in chips) 
Seat 4: s1y+qfkBnhgc67+X3ThjeA ($7.90 in chips) 
Seat 5: RHqgdFvufLCYe54+qd2gcA ($6.25 in chips) 
Seat 6: 6RiVTYll/5D8zICp0MRpKw ($27.85 in chips) 
Seat 7: RY9uq/FyiWrrnWBl/zGQKg ($24.90 in chips) 
Seat 8: wzU16tcf+7nj2MYKa4h7+Q ($10.50 in chips) 
Seat 9: cZ99hugmLBj9KhTlc8nCSw ($30.60 in chips) 
s1y+qfkBnhgc67+X3ThjeA: posts small blind $0.10
RHqgdFvufLCYe54+qd2gcA: posts big blind $0.25
*** HOLE CARDS ***
6RiVTYll/5D8zICp0MRpKw: folds 
RY9uq/FyiWrrnWBl/zGQKg: folds 
wzU16tcf+7nj2MYKa4h7+Q: folds 
cZ99hugmLBj9KhTlc8nCSw: folds 
p4VoE724cQin02zatf/NOw: raises $0.75 to $1
uUc5QTI8+ZdC95UnznCsqg: folds 
GeMoapCKDLc4ajT0Uk9ZQw: folds 
s1y+qfkBnhgc67+X3ThjeA: calls $0.90
RHqgdFvufLCYe54+qd2gcA: folds 
*** FLOP *** [Ts 3d 2s]
s1y+qfkBnhgc67+X3ThjeA: checks 
p4VoE724cQin02zatf/NOw: bets $1.75
s1y+qfkBnhgc67+X3ThjeA: folds 
Uncalled bet ($1.75) returned to p4VoE724cQin02zatf/NOw
p4VoE724cQin02zatf/NOw collected $2.15 from pot
*** SUMMARY ***
Total pot $2.25 | Rake $0.10 
Board [Ts 3d 2s]
Seat 1: p4VoE724cQin02zatf/NOw collected ($2.15)
Seat 2: uUc5QTI8+ZdC95UnznCsqg folded before Flop (didn't bet)
Seat 3: GeMoapCKDLc4ajT0Uk9ZQw (button) folded before Flop (didn't bet)
Seat 4: s1y+qfkBnhgc67+X3ThjeA (small blind) folded on the Flop
Seat 5: RHqgdFvufLCYe54+qd2gcA (big blind) folded before Flop
Seat 6: 6RiVTYll/5D8zICp0MRpKw folded before Flop (didn't bet)
Seat 7: RY9uq/FyiWrrnWBl/zGQKg folded before Flop (didn't bet)
Seat 8: wzU16tcf+7nj2MYKa4h7+Q folded before Flop (didn't bet)
Seat 9: cZ99hugmLBj9KhTlc8nCSw folded before Flop (didn't bet)




PokerStars Game #59941929278:  Hold'em No Limit ($0.10/$0.25) - 2009/07/01 1:50:39 ET
Table '8QBBaev+cI2i/r2H6ml/lg' 9-max Seat #3 is the button
Seat 1: s2xLPOl/vhl/26apJ3vsOQ ($38.40 in chips) 
Seat 2: y7tkvDmwKjURBkr73SZPXw ($10.15 in chips) 
Seat 3: zgi+EUykT/pZQpoUG6+oEg ($3.95 in chips) 
Seat 4: ytpGB2nr/CLVHnyKMRiEFQ ($17.20 in chips) 
Seat 5: 0QdZrkFD7aGKeBXPGbIomA ($11.45 in chips) 
Seat 6: X6+pSIPfovPcE87t+LmUKQ ($5 in chips) 
Seat 7: eK8qa6EPcH2zhtbmWSvc9g ($30.05 in chips) 
Seat 8: vr1IK/Q4HXm8s8V0/dePzQ ($11.60 in chips) 
Seat 9: EUMLvzDkECHBit+xa+uGjg ($23.75 in chips) 
ytpGB2nr/CLVHnyKMRiEFQ: posts small blind $0.10
0QdZrkFD7aGKeBXPGbIomA: posts big blind $0.25
*** HOLE CARDS ***
X6+pSIPfovPcE87t+LmUKQ: folds 
eK8qa6EPcH2zhtbmWSvc9g: folds 
vr1IK/Q4HXm8s8V0/dePzQ: folds 
EUMLvzDkECHBit+xa+uGjg: folds 
s2xLPOl/vhl/26apJ3vsOQ: folds 
y7tkvDmwKjURBkr73SZPXw: folds 
zgi+EUykT/pZQpoUG6+oEg: raises $0.75 to $1
ytpGB2nr/CLVHnyKMRiEFQ: folds 
0QdZrkFD7aGKeBXPGbIomA: folds 
Uncalled bet ($0.75) returned to zgi+EUykT/pZQpoUG6+oEg
zgi+EUykT/pZQpoUG6+oEg collected $0.60 from pot
zgi+EUykT/pZQpoUG6+oEg: doesn't show hand 
*** SUMMARY ***
Total pot $0.60 | Rake $0 
Seat 1: s2xLPOl/vhl/26apJ3vsOQ folded before Flop (didn't bet)
Seat 2: y7tkvDmwKjURBkr73SZPXw folded before Flop (didn't bet)
Seat 3: zgi+EUykT/pZQpoUG6+oEg (button) collected ($0.60)
Seat 4: ytpGB2nr/CLVHnyKMRiEFQ (small blind) folded before Flop
Seat 5: 0QdZrkFD7aGKeBXPGbIomA (big blind) folded before Flop
Seat 6: X6+pSIPfovPcE87t+LmUKQ folded before Flop (didn't bet)
Seat 7: eK8qa6EPcH2zhtbmWSvc9g folded before Flop (didn't bet)
Seat 8: vr1IK/Q4HXm8s8V0/dePzQ folded before Flop (didn't bet)
Seat 9: EUMLvzDkECHBit+xa+uGjg folded before Flop (didn't bet)




PokerStars Game #59941929916:  Hold'em No Limit ($0.10/$0.25) - 2009/07/01 1:50:40 ET
Table 'zW+7jPbOLCvlPu+dUGY5WQ' 6-max Seat #6 is the button
Seat 1: eL3+wCBjFGfQ5FMdIZihwA ($31.30 in chips) 
Seat 4: i48129QFpEQQ+UN4aNtmww ($15.55 in chips) 
Seat 5: rDRzxas/uMDi5Uteo081UQ ($15 in chips) 
Seat 6: qGHGf/553gQnDoklMRe3tg ($24.50 in chips) 
eL3+wCBjFGfQ5FMdIZihwA: posts small blind $0.10
i48129QFpEQQ+UN4aNtmww: posts big blind $0.25
rDRzxas/uMDi5Uteo081UQ: posts big blind $0.25
*** HOLE CARDS ***
rDRzxas/uMDi5Uteo081UQ: checks 
qGHGf/553gQnDoklMRe3tg: folds 
eL3+wCBjFGfQ5FMdIZihwA: folds 
i48129QFpEQQ+UN4aNtmww: checks 
*** FLOP *** [3h 7c Qs]
TQ7/UUMjrZ3WL5eLMho7VQ joins the table at seat #2 
i48129QFpEQQ+UN4aNtmww: bets $0.75
rDRzxas/uMDi5Uteo081UQ: folds 
Uncalled bet ($0.75) returned to i48129QFpEQQ+UN4aNtmww
i48129QFpEQQ+UN4aNtmww collected $0.60 from pot
i48129QFpEQQ+UN4aNtmww: doesn't show hand 
*** SUMMARY ***
Total pot $0.60 | Rake $0 
Board [3h 7c Qs]
Seat 1: eL3+wCBjFGfQ5FMdIZihwA (small blind) folded before Flop
Seat 4: i48129QFpEQQ+UN4aNtmww (big blind) collected ($0.60)
Seat 5: rDRzxas/uMDi5Uteo081UQ folded on the Flop
Seat 6: qGHGf/553gQnDoklMRe3tg (button) folded before Flop (didn't bet)




PokerStars Game #59941929938:  Hold'em No Limit ($0.10/$0.25) - 2009/07/01 1:50:40 ET
Table '5VWnrlxdjwVfMWkVS2WE7A' 6-max Seat #4 is the button
Seat 1: 82p+w3EmUaFFHuwpSeGY1w ($13.10 in chips) 
Seat 2: LJI7A1YgDM7hgh7o56+ReQ ($44.10 in chips) 
Seat 3: SFmT9ZsVopnukjvAzrxTRg ($37.35 in chips) 
Seat 4: Pb/gJ3OxOZx57fFp0MDgkg ($34.85 in chips) 
Seat 5: 32YL2ZEp8NT4JB2RVM9euQ ($15.75 in chips) 
Seat 6: LtASJ9OlkqGrrUKGQlpGAw ($25 in chips) 
32YL2ZEp8NT4JB2RVM9euQ: posts small blind $0.10
LtASJ9OlkqGrrUKGQlpGAw: posts big blind $0.25
*** HOLE CARDS ***
82p+w3EmUaFFHuwpSeGY1w: calls $0.25
LJI7A1YgDM7hgh7o56+ReQ: folds 
SFmT9ZsVopnukjvAzrxTRg: folds 
Pb/gJ3OxOZx57fFp0MDgkg: folds 
32YL2ZEp8NT4JB2RVM9euQ: calls $0.15
LtASJ9OlkqGrrUKGQlpGAw: checks 
*** FLOP *** [6d Qs Ts]
32YL2ZEp8NT4JB2RVM9euQ: checks 
LtASJ9OlkqGrrUKGQlpGAw: checks 
82p+w3EmUaFFHuwpSeGY1w: checks 
*** TURN *** [6d Qs Ts] [9s]
32YL2ZEp8NT4JB2RVM9euQ: checks 
Pb/gJ3OxOZx57fFp0MDgkg leaves the table
LtASJ9OlkqGrrUKGQlpGAw: checks 
82p+w3EmUaFFHuwpSeGY1w: checks 
*** RIVER *** [6d Qs Ts 9s] [7h]
32YL2ZEp8NT4JB2RVM9euQ: checks 
LtASJ9OlkqGrrUKGQlpGAw: checks 
82p+w3EmUaFFHuwpSeGY1w: checks 
*** SHOW DOWN ***
32YL2ZEp8NT4JB2RVM9euQ: shows [4d 4h] (a pair of Fours)
LtASJ9OlkqGrrUKGQlpGAw: mucks hand 
82p+w3EmUaFFHuwpSeGY1w: shows [Ad 6s] (a pair of Sixes)
82p+w3EmUaFFHuwpSeGY1w collected $0.75 from pot
*** SUMMARY ***
Total pot $0.75 | Rake $0 
Board [6d Qs Ts 9s 7h]
Seat 1: 82p+w3EmUaFFHuwpSeGY1w showed [Ad 6s] and won ($0.75) with a pair of Sixes
Seat 2: LJI7A1YgDM7hgh7o56+ReQ folded before Flop (didn't bet)
Seat 3: SFmT9ZsVopnukjvAzrxTRg folded before Flop (didn't bet)
Seat 4: Pb/gJ3OxOZx57fFp0MDgkg (button) folded before Flop (didn't bet)
Seat 5: 32YL2ZEp8NT4JB2RVM9euQ (small blind) showed [4d 4h] and lost with a pair of Fours
Seat 6: LtASJ9OlkqGrrUKGQlpGAw (big blind) mucked




PokerStars Game #59941929876:  Hold'em No Limit ($0.10/$0.25) - 2009/07/01 1:50:40 ET
Table 'C47I7CmrmFr8Oo7wOovVwQ' 6-max Seat #5 is the button
Seat 1: aKCh+0w6BCOX3sJAdIVLMw ($5 in chips) 
Seat 2: 8JTm/CXBn3+kuQgcUOgPkw ($24.75 in chips) 
Seat 3: H+8eOP3XJHXjACRDTiIHTQ ($21.95 in chips) 
Seat 4: yY5JuFtDfXWRaZlVby4LLw ($4.50 in chips) 
Seat 5: or309yYY9Y9bfFWtrB0yUg ($9.60 in chips) 
Seat 6: pD7ri5wL3vsa6S1ulMYQmQ ($26.70 in chips) 
pD7ri5wL3vsa6S1ulMYQmQ: posts small blind $0.10
aKCh+0w6BCOX3sJAdIVLMw: posts big blind $0.25
*** HOLE CARDS ***
8JTm/CXBn3+kuQgcUOgPkw: folds 
H+8eOP3XJHXjACRDTiIHTQ: calls $0.25
yY5JuFtDfXWRaZlVby4LLw: raises $4.25 to $4.50 and is all-in
or309yYY9Y9bfFWtrB0yUg: calls $4.50
pD7ri5wL3vsa6S1ulMYQmQ: folds 
aKCh+0w6BCOX3sJAdIVLMw: folds 
H+8eOP3XJHXjACRDTiIHTQ: folds 
*** FLOP *** [Ts 9h Qs]
*** TURN *** [Ts 9h Qs] [Jd]
*** RIVER *** [Ts 9h Qs Jd] [7d]
*** SHOW DOWN ***
yY5JuFtDfXWRaZlVby4LLw: shows [Ks Jc] (a straight, Nine to King)
or309yYY9Y9bfFWtrB0yUg: mucks hand 
yY5JuFtDfXWRaZlVby4LLw collected $9.15 from pot
*** SUMMARY ***
Total pot $9.60 | Rake $0.45 
Board [Ts 9h Qs Jd 7d]
Seat 1: aKCh+0w6BCOX3sJAdIVLMw (big blind) folded before Flop
Seat 2: 8JTm/CXBn3+kuQgcUOgPkw folded before Flop (didn't bet)
Seat 3: H+8eOP3XJHXjACRDTiIHTQ folded before Flop
Seat 4: yY5JuFtDfXWRaZlVby4LLw showed [Ks Jc] and won ($9.15) with a straight, Nine to King
Seat 5: or309yYY9Y9bfFWtrB0yUg (button) mucked
Seat 6: pD7ri5wL3vsa6S1ulMYQmQ (small blind) folded before Flop




PokerStars Game #59941930234:  Hold'em No Limit ($0.10/$0.25) - 2009/07/01 1:50:41 ET
Table 'nIRjSqm6RYUWJlyW2loYKA' 6-max Seat #4 is the button
Seat 1: w43JQj2oYPpKQVG4Yzlq1w ($25 in chips) 
Seat 2: NndRCAk4vU5JGDhTyy5LZg ($13.45 in chips) 
Seat 3: qjs7u/BI35gu5OgtqfLCZw ($16.20 in chips) 
Seat 4: /ZSSWvl8im2y38j1uEUAGA ($4.50 in chips) 
Seat 5: df01R5ThvHspD8FgKmaDvQ ($24.50 in chips) 
Seat 6: OIjOiBfQstWrK/RuXx7zcw ($6.85 in chips) 
df01R5ThvHspD8FgKmaDvQ: posts small blind $0.10
OIjOiBfQstWrK/RuXx7zcw: posts big blind $0.25
*** HOLE CARDS ***
w43JQj2oYPpKQVG4Yzlq1w: folds 
NndRCAk4vU5JGDhTyy5LZg: folds 
qjs7u/BI35gu5OgtqfLCZw: folds 
/ZSSWvl8im2y38j1uEUAGA: folds 
df01R5ThvHspD8FgKmaDvQ: folds 
Uncalled bet ($0.15) returned to OIjOiBfQstWrK/RuXx7zcw
OIjOiBfQstWrK/RuXx7zcw collected $0.20 from pot
OIjOiBfQstWrK/RuXx7zcw: doesn't show hand 
*** SUMMARY ***
Total pot $0.20 | Rake $0 
Seat 1: w43JQj2oYPpKQVG4Yzlq1w folded before Flop (didn't bet)
Seat 2: NndRCAk4vU5JGDhTyy5LZg folded before Flop (didn't bet)
Seat 3: qjs7u/BI35gu5OgtqfLCZw folded before Flop (didn't bet)
Seat 4: /ZSSWvl8im2y38j1uEUAGA (button) folded before Flop (didn't bet)
Seat 5: df01R5ThvHspD8FgKmaDvQ (small blind) folded before Flop
Seat 6: OIjOiBfQstWrK/RuXx7zcw (big blind) collected ($0.20)




PokerStars Game #59941930398:  Hold'em No Limit ($0.10/$0.25) - 2009/07/01 1:50:41 ET
Table 'x7YStLKc8hpt/pTgSetPKA' 9-max Seat #8 is the button
Seat 2: z5GxcHlYz/GSz6W2uFiTtg ($23.35 in chips) 
Seat 3: S7Ki0P+0AIGPuIfGJjW0gg ($11.10 in chips) 
Seat 4: ydoFOVgzvZv9ZhuWu9rXAw ($5 in chips) 
Seat 5: tLcDklc2rBORNfixyRfVfw ($25 in chips) 
Seat 6: 9YN2IkT2JYYKFErZtZvCtA ($49.25 in chips) 
Seat 7: dtZ84flFEi4Q+SGrHMJRDQ ($25 in chips) 
Seat 8: j4q3p0lesp63b1gZDwLBZw ($5.50 in chips) 
Seat 9: nm4Dj/f+jJEwKVsUnKh73g ($37.30 in chips) 
nm4Dj/f+jJEwKVsUnKh73g: posts small blind $0.10
tYsOBqdU1+x+yFI7zHO7hQ: is sitting out 
z5GxcHlYz/GSz6W2uFiTtg: posts big blind $0.25
*** HOLE CARDS ***
S7Ki0P+0AIGPuIfGJjW0gg: folds 
ydoFOVgzvZv9ZhuWu9rXAw: calls $0.25
tLcDklc2rBORNfixyRfVfw: folds 
tYsOBqdU1+x+yFI7zHO7hQ leaves the table
9YN2IkT2JYYKFErZtZvCtA: folds 
dtZ84flFEi4Q+SGrHMJRDQ: folds 
j4q3p0lesp63b1gZDwLBZw: folds 
nm4Dj/f+jJEwKVsUnKh73g: folds 
z5GxcHlYz/GSz6W2uFiTtg: checks 
*** FLOP *** [Ts 2h 7h]
z5GxcHlYz/GSz6W2uFiTtg: bets $0.75
ydoFOVgzvZv9ZhuWu9rXAw: raises $0.75 to $1.50
satchmoiluvu joins the table at seat #1 
z5GxcHlYz/GSz6W2uFiTtg: calls $0.75
*** TURN *** [Ts 2h 7h] [7c]
z5GxcHlYz/GSz6W2uFiTtg: checks 
ydoFOVgzvZv9ZhuWu9rXAw: checks 
*** RIVER *** [Ts 2h 7h 7c] [Qs]
z5GxcHlYz/GSz6W2uFiTtg: checks 
ydoFOVgzvZv9ZhuWu9rXAw: bets $1.75
z5GxcHlYz/GSz6W2uFiTtg: calls $1.75
*** SHOW DOWN ***
ydoFOVgzvZv9ZhuWu9rXAw: shows [Kc Kh] (two pair, Kings and Sevens)
z5GxcHlYz/GSz6W2uFiTtg: mucks hand 
ydoFOVgzvZv9ZhuWu9rXAw collected $6.80 from pot
*** SUMMARY ***
Total pot $7.10 | Rake $0.30 
Board [Ts 2h 7h 7c Qs]
Seat 2: z5GxcHlYz/GSz6W2uFiTtg (big blind) mucked
Seat 3: S7Ki0P+0AIGPuIfGJjW0gg folded before Flop (didn't bet)
Seat 4: ydoFOVgzvZv9ZhuWu9rXAw showed [Kc Kh] and won ($6.80) with two pair, Kings and Sevens
Seat 5: tLcDklc2rBORNfixyRfVfw folded before Flop (didn't bet)
Seat 6: 9YN2IkT2JYYKFErZtZvCtA folded before Flop (didn't bet)
Seat 7: dtZ84flFEi4Q+SGrHMJRDQ folded before Flop (didn't bet)
Seat 8: j4q3p0lesp63b1gZDwLBZw (button) folded before Flop (didn't bet)
Seat 9: nm4Dj/f+jJEwKVsUnKh73g (small blind) folded before Flop




PokerStars Game #59941930408:  Hold'em No Limit ($0.10/$0.25) - 2009/07/01 1:50:41 ET
Table 'Dun24l/X8kjpUHWBhkVOFw' 6-max Seat #1 is the button
Seat 1: u3Ol7kv1LmvszuHNm9rc6w ($21.80 in chips) 
Seat 2: 6hUmfDYq+83kvxWoTBQmfw ($25.15 in chips) 
Seat 3: FzAsD5THdVHZrHrSzc4boA ($25 in chips) 
Seat 5: KYBwVA7jgmSrbIEbEGElVg ($29.85 in chips) 
Seat 6: xrf8tAXKQHG99HixCot1Iw ($25 in chips) 
6hUmfDYq+83kvxWoTBQmfw: posts small blind $0.10
FzAsD5THdVHZrHrSzc4boA: posts big blind $0.25
aogAb4Eienxztk8p2v9VVw: sits out 
*** HOLE CARDS ***
KYBwVA7jgmSrbIEbEGElVg: calls $0.25
xrf8tAXKQHG99HixCot1Iw: folds 
u3Ol7kv1LmvszuHNm9rc6w: folds 
6hUmfDYq+83kvxWoTBQmfw: calls $0.15
FzAsD5THdVHZrHrSzc4boA: checks 
*** FLOP *** [9d 3d 6h]
6hUmfDYq+83kvxWoTBQmfw: checks 
FzAsD5THdVHZrHrSzc4boA: checks 
KYBwVA7jgmSrbIEbEGElVg: checks 
*** TURN *** [9d 3d 6h] [8h]
6hUmfDYq+83kvxWoTBQmfw: checks 
FzAsD5THdVHZrHrSzc4boA: bets $0.25
KYBwVA7jgmSrbIEbEGElVg: calls $0.25
6hUmfDYq+83kvxWoTBQmfw: folds 
*** RIVER *** [9d 3d 6h 8h] [Kc]
FzAsD5THdVHZrHrSzc4boA: bets $0.75
KYBwVA7jgmSrbIEbEGElVg: folds 
Uncalled bet ($0.75) returned to FzAsD5THdVHZrHrSzc4boA
FzAsD5THdVHZrHrSzc4boA collected $1.20 from pot
*** SUMMARY ***
Total pot $1.25 | Rake $0.05 
Board [9d 3d 6h 8h Kc]
Seat 1: u3Ol7kv1LmvszuHNm9rc6w (button) folded before Flop (didn't bet)
Seat 2: 6hUmfDYq+83kvxWoTBQmfw (small blind) folded on the Turn
Seat 3: FzAsD5THdVHZrHrSzc4boA (big blind) collected ($1.20)
Seat 5: KYBwVA7jgmSrbIEbEGElVg folded on the River
Seat 6: xrf8tAXKQHG99HixCot1Iw folded before Flop (didn't bet)




PokerStars Game #59941930010:  Hold'em No Limit ($0.10/$0.25) - 2009/07/01 1:50:41 ET
Table 'ZiwAqg4o02gNro+JOAaFNg6wawJ+MkkvuC3coG6r+YhgSeat #5 is the button
Seat 1: 6RiVTYll/5D8zICp0MRpKw ($29.85 in chips) 
Seat 2: VCKtuATyvAq9H2JSAQxPbA ($14.75 in chips) 
Seat 3: aNpwfA31EREwO+ar4XzBCw ($28.65 in chips) 
Seat 4: RHqgdFvufLCYe54+qd2gcA ($11.55 in chips) 
Seat 5: 6HoFYfVGBefsR5Vrz62qIw5hAPbqNrvJb8PtLiceXtlg.55 in chips) 
Seat 6: 5n7e7I+px7c6CQmLpPbtsg ($4.75 in chips) 
Seat 7: yyG4svzOpC1A+sUP/scg6w ($5.95 in chips) 
Seat 8: VLIsy+xjx3olLSYO3JLS6g ($13.45 in chips) 
Seat 9: ljemhp25Zg+nlA9DLCIiUw ($24.15 in chips) 
5n7e7I+px7c6CQmLpPbtsg: posts small blind $0.10
yyG4svzOpC1A+sUP/scg6w: posts big blind $0.25
*** HOLE CARDS ***
VLIsy+xjx3olLSYO3JLS6g: folds 
ljemhp25Zg+nlA9DLCIiUw: calls $0.25
6RiVTYll/5D8zICp0MRpKw: raises $1.25 to $1.50
VCKtuATyvAq9H2JSAQxPbA: calls $1.50
aNpwfA31EREwO+ar4XzBCw: raises $3.25 to $4.75
RHqgdFvufLCYe54+qd2gcA: folds 
6HoFYfVGBefsR5Vrz62qIw5hAPbqNrvJb8PtLiceXtlglds 
5n7e7I+px7c6CQmLpPbtsg: folds 
yyG4svzOpC1A+sUP/scg6w: folds 
ljemhp25Zg+nlA9DLCIiUw: folds 
6RiVTYll/5D8zICp0MRpKw: folds 
VCKtuATyvAq9H2JSAQxPbA: folds 
Uncalled bet ($3.25) returned to aNpwfA31EREwO+ar4XzBCw
aNpwfA31EREwO+ar4XzBCw collected $5.10 from pot
aNpwfA31EREwO+ar4XzBCw: doesn't show hand 
*** SUMMARY ***
Total pot $5.10 | Rake $0 
Seat 1: 6RiVTYll/5D8zICp0MRpKw folded before Flop
Seat 2: VCKtuATyvAq9H2JSAQxPbA folded before Flop
Seat 3: aNpwfA31EREwO+ar4XzBCw collected ($5.10)
Seat 4: RHqgdFvufLCYe54+qd2gcA folded before Flop (didn't bet)
Seat 5: 6HoFYfVGBefsR5Vrz62qIw5hAPbqNrvJb8PtLiceXtlgtton) folded before Flop (didn't bet)
Seat 6: 5n7e7I+px7c6CQmLpPbtsg (small blind) folded before Flop
Seat 7: yyG4svzOpC1A+sUP/scg6w (big blind) folded before Flop
Seat 8: VLIsy+xjx3olLSYO3JLS6g folded before Flop (didn't bet)
Seat 9: ljemhp25Zg+nlA9DLCIiUw folded before Flop




PokerStars Game #59941930482:  Hold'em No Limit ($0.10/$0.25) - 2009/07/01 1:50:41 ET
Table 'pyZQRcpxhWj2y2cT/ydvww52Meibn9NOL4XtVi1p2Upwx Seat #8 is the button
Seat 1: egvg3mTBBVzMHnJPIQiKcA ($21.25 in chips) 
Seat 2: Th3FldXKQW6hWVVPahaoOQ ($101.80 in chips) 
Seat 3: zgi+EUykT/pZQpoUG6+oEg ($4.30 in chips) 
Seat 4: NjesyqE7PJi4nEOa0oOq9w ($12.65 in chips) 
Seat 5: 5n7e7I+px7c6CQmLpPbtsg ($4.35 in chips) 
Seat 6: uvfXVx90QtCYG4geTioN+A ($23.50 in chips) 
Seat 7: mMd8CDS/but3UC+Zp7Up2w ($20 in chips) 
Seat 8: ipgcO7Pa6LC8XWpVttZfnA ($4.65 in chips) 
Seat 9: bC+Wg1ntzw3N48OwuR1eag ($4.30 in chips) 
bC+Wg1ntzw3N48OwuR1eag: posts small blind $0.10
egvg3mTBBVzMHnJPIQiKcA: posts big blind $0.25
mMd8CDS/but3UC+Zp7Up2w: posts big blind $0.25
*** HOLE CARDS ***
Th3FldXKQW6hWVVPahaoOQ: calls $0.25
zgi+EUykT/pZQpoUG6+oEg: folds 
NjesyqE7PJi4nEOa0oOq9w: calls $0.25
5n7e7I+px7c6CQmLpPbtsg: folds 
uvfXVx90QtCYG4geTioN+A: calls $0.25
mMd8CDS/but3UC+Zp7Up2w: checks 
ipgcO7Pa6LC8XWpVttZfnA: folds 
bC+Wg1ntzw3N48OwuR1eag: raises $1 to $1.25
egvg3mTBBVzMHnJPIQiKcA: folds 
Th3FldXKQW6hWVVPahaoOQ: folds 
NjesyqE7PJi4nEOa0oOq9w: calls $1
uvfXVx90QtCYG4geTioN+A: calls $1
mMd8CDS/but3UC+Zp7Up2w: folds 
*** FLOP *** [Qh Kh 5d]
bC+Wg1ntzw3N48OwuR1eag: checks 
NjesyqE7PJi4nEOa0oOq9w: bets $1.25
uvfXVx90QtCYG4geTioN+A: folds 
bC+Wg1ntzw3N48OwuR1eag: calls $1.25
*** TURN *** [Qh Kh 5d] [6h]
bC+Wg1ntzw3N48OwuR1eag: checks 
NjesyqE7PJi4nEOa0oOq9w: bets $2.25
bC+Wg1ntzw3N48OwuR1eag: calls $1.80 and is all-in
Uncalled bet ($0.45) returned to NjesyqE7PJi4nEOa0oOq9w
*** RIVER *** [Qh Kh 5d 6h] [7h]
*** SHOW DOWN ***
bC+Wg1ntzw3N48OwuR1eag: shows [Qs Kd] (two pair, Kings and Queens)
NjesyqE7PJi4nEOa0oOq9w: shows [As 8h] (a flush, King high)
NjesyqE7PJi4nEOa0oOq9w collected $10.10 from pot
*** SUMMARY ***
Total pot $10.60 | Rake $0.50 
Board [Qh Kh 5d 6h 7h]
Seat 1: egvg3mTBBVzMHnJPIQiKcA (big blind) folded before Flop
Seat 2: Th3FldXKQW6hWVVPahaoOQ folded before Flop
Seat 3: zgi+EUykT/pZQpoUG6+oEg folded before Flop (didn't bet)
Seat 4: NjesyqE7PJi4nEOa0oOq9w showed [As 8h] and won ($10.10) with a flush, King high
Seat 5: 5n7e7I+px7c6CQmLpPbtsg folded before Flop (didn't bet)
Seat 6: uvfXVx90QtCYG4geTioN+A folded on the Flop
Seat 7: mMd8CDS/but3UC+Zp7Up2w folded before Flop
Seat 8: ipgcO7Pa6LC8XWpVttZfnA (button) folded before Flop (didn't bet)
Seat 9: bC+Wg1ntzw3N48OwuR1eag (small blind) showed [Qs Kd] and lost with two pair, Kings and Queens




PokerStars Game #59941930282:  Hold'em No Limit ($0.10/$0.25) - 2009/07/01 1:50:41 ET
Table 'RUOqTfzbAVGS5x+J9aZMHA' 9-max Seat #8 is the button
Seat 1: DnDcAdn9P0zGovMERigpFA ($28.30 in chips) 
Seat 2: Z5ZtGOON8kmSdSCll9Z3XA ($6 in chips) 
Seat 3: Th3FldXKQW6hWVVPahaoOQ ($25 in chips) 
Seat 4: K9Az8li/CO2TicltVWKamA ($26.75 in chips) 
Seat 5: MtVtHDqIJTyUcXkRBBDIVA ($33.55 in chips) 
Seat 6: ljemhp25Zg+nlA9DLCIiUw ($48 in chips) 
Seat 7: zgi+EUykT/pZQpoUG6+oEg ($5 in chips) 
Seat 8: dfNim92Z6XK1/h5SFW5vDg ($28.35 in chips) 
Seat 9: cZ99hugmLBj9KhTlc8nCSw ($25 in chips) 
cZ99hugmLBj9KhTlc8nCSw: posts small blind $0.10
DnDcAdn9P0zGovMERigpFA: posts big blind $0.25
*** HOLE CARDS ***
Z5ZtGOON8kmSdSCll9Z3XA: folds 
Th3FldXKQW6hWVVPahaoOQ: folds 
K9Az8li/CO2TicltVWKamA: folds 
MtVtHDqIJTyUcXkRBBDIVA: folds 
ljemhp25Zg+nlA9DLCIiUw: folds 
zgi+EUykT/pZQpoUG6+oEg: folds 
dfNim92Z6XK1/h5SFW5vDg has timed out
dfNim92Z6XK1/h5SFW5vDg: folds 
dfNim92Z6XK1/h5SFW5vDg is sitting out
cZ99hugmLBj9KhTlc8nCSw: folds 
Uncalled bet ($0.15) returned to DnDcAdn9P0zGovMERigpFA
DnDcAdn9P0zGovMERigpFA collected $0.20 from pot
DnDcAdn9P0zGovMERigpFA: doesn't show hand 
*** SUMMARY ***
Total pot $0.20 | Rake $0 
Seat 1: DnDcAdn9P0zGovMERigpFA (big blind) collected ($0.20)
Seat 2: Z5ZtGOON8kmSdSCll9Z3XA folded before Flop (didn't bet)
Seat 3: Th3FldXKQW6hWVVPahaoOQ folded before Flop (didn't bet)
Seat 4: K9Az8li/CO2TicltVWKamA folded before Flop (didn't bet)
Seat 5: MtVtHDqIJTyUcXkRBBDIVA folded before Flop (didn't bet)
Seat 6: ljemhp25Zg+nlA9DLCIiUw folded before Flop (didn't bet)
Seat 7: zgi+EUykT/pZQpoUG6+oEg folded before Flop (didn't bet)
Seat 8: dfNim92Z6XK1/h5SFW5vDg (button) folded before Flop (didn't bet)
Seat 9: cZ99hugmLBj9KhTlc8nCSw (small blind) folded before Flop




PokerStars Game #59941930884:  Hold'em No Limit ($0.10/$0.25) - 2009/07/01 1:50:42 ET
Table 'WEMI3Mtn7dGARDbgNrKibg' 9-max Seat #9 is the button
Seat 1: Th3FldXKQW6hWVVPahaoOQ ($30.45 in chips) 
Seat 3: qwr38jl5txoR36M7G5qi4A ($10 in chips) 
Seat 4: Z5NNIVvnhb2IJbLcI79WYQ ($10.55 in chips) 
Seat 5: yzPZQFeaQTNf1YK3a0zRIw ($9.30 in chips) 
Seat 6: arxNSjreDRGFg13EAM2F1w ($25.10 in chips) 
Seat 7: DnDcAdn9P0zGovMERigpFA ($54.90 in chips) 
Seat 8: ghNKXUBl/H+t83JF079ZBA ($29.25 in chips) 
Seat 9: 2wcFsZsqEP5w1StUTVzJCg ($4.25 in chips) 
Th3FldXKQW6hWVVPahaoOQ: posts small blind $0.10
tYsOBqdU1+x+yFI7zHO7hQ: is sitting out 
qwr38jl5txoR36M7G5qi4A: posts big blind $0.25
*** HOLE CARDS ***
Z5NNIVvnhb2IJbLcI79WYQ: folds 
yzPZQFeaQTNf1YK3a0zRIw: folds 
arxNSjreDRGFg13EAM2F1w: folds 
tYsOBqdU1+x+yFI7zHO7hQ leaves the table
DnDcAdn9P0zGovMERigpFA: folds 
ghNKXUBl/H+t83JF079ZBA: folds 
2wcFsZsqEP5w1StUTVzJCg: folds 
Th3FldXKQW6hWVVPahaoOQ: folds 
Uncalled bet ($0.15) returned to qwr38jl5txoR36M7G5qi4A
qwr38jl5txoR36M7G5qi4A collected $0.20 from pot
qwr38jl5txoR36M7G5qi4A: doesn't show hand 
*** SUMMARY ***
Total pot $0.20 | Rake $0 
Seat 1: Th3FldXKQW6hWVVPahaoOQ (small blind) folded before Flop
Seat 3: qwr38jl5txoR36M7G5qi4A (big blind) collected ($0.20)
Seat 4: Z5NNIVvnhb2IJbLcI79WYQ folded before Flop (didn't bet)
Seat 5: yzPZQFeaQTNf1YK3a0zRIw folded before Flop (didn't bet)
Seat 6: arxNSjreDRGFg13EAM2F1w folded before Flop (didn't bet)
Seat 7: DnDcAdn9P0zGovMERigpFA folded before Flop (didn't bet)
Seat 8: ghNKXUBl/H+t83JF079ZBA folded before Flop (didn't bet)
Seat 9: 2wcFsZsqEP5w1StUTVzJCg (button) folded before Flop (didn't bet)




PokerStars Game #59941930808:  Hold'em No Limit ($0.10/$0.25) - 2009/07/01 1:50:42 ET
Table 'sm5gqEvXgLbkkE4dryW/5g' 6-max Seat #6 is the button
Seat 1: v8m8XHovI5tqEA9mvplDSw ($39.60 in chips) 
Seat 2: 5xs5/u2z1CO9zkRvH72MQg ($18.35 in chips) 
Seat 3: UT5XpwOH1ipkOF7n1MqDJA ($21.35 in chips) 
Seat 4: cWc85bEzdRzpUMhRKm8pwQ ($25.80 in chips) 
Seat 6: aogAb4Eienxztk8p2v9VVw ($22.15 in chips) 
v8m8XHovI5tqEA9mvplDSw: posts small blind $0.10
5xs5/u2z1CO9zkRvH72MQg: posts big blind $0.25
*** HOLE CARDS ***
UT5XpwOH1ipkOF7n1MqDJA: calls $0.25
cWc85bEzdRzpUMhRKm8pwQ: raises $1 to $1.25
AyreonChen joins the table at seat #5 
aogAb4Eienxztk8p2v9VVw: folds 
v8m8XHovI5tqEA9mvplDSw: folds 
5xs5/u2z1CO9zkRvH72MQg: folds 
UT5XpwOH1ipkOF7n1MqDJA: calls $1
*** FLOP *** [3h 2s Ah]
UT5XpwOH1ipkOF7n1MqDJA: checks 
cWc85bEzdRzpUMhRKm8pwQ: bets $2
UT5XpwOH1ipkOF7n1MqDJA: folds 
Uncalled bet ($2) returned to cWc85bEzdRzpUMhRKm8pwQ
cWc85bEzdRzpUMhRKm8pwQ collected $2.75 from pot
*** SUMMARY ***
Total pot $2.85 | Rake $0.10 
Board [3h 2s Ah]
Seat 1: v8m8XHovI5tqEA9mvplDSw (small blind) folded before Flop
Seat 2: 5xs5/u2z1CO9zkRvH72MQg (big blind) folded before Flop
Seat 3: UT5XpwOH1ipkOF7n1MqDJA folded on the Flop
Seat 4: cWc85bEzdRzpUMhRKm8pwQ collected ($2.75)
Seat 6: aogAb4Eienxztk8p2v9VVw (button) folded before Flop (didn't bet)




PokerStars Game #59941930888:  Hold'em No Limit ($0.10/$0.25) - 2009/07/01 1:50:42 ET
Table 'g+mPuNJBCHKE9ents7ZGtg' 6-max Seat #6 is the button
Seat 1: cezpHJ8FB07dj0xG+LhOvw ($58.25 in chips) 
Seat 2: fZQg9veL7Dd/Z04ZTjC+wQ ($57.10 in chips) 
Seat 4: yVrjRIW0SMxgpvqSIPSe/w ($14.95 in chips) 
Seat 5: D3ikCR8c/o9jB5irZ3uGlw ($19 in chips) 
Seat 6: Mn2V28t5aGq2d09z+/o6Fw ($24.50 in chips) 
cezpHJ8FB07dj0xG+LhOvw: posts small blind $0.10
fZQg9veL7Dd/Z04ZTjC+wQ: posts big blind $0.25
8CPg15X6IHYR1pWm9ha1Sw: sits out 
*** HOLE CARDS ***
yVrjRIW0SMxgpvqSIPSe/w: raises $0.50 to $0.75
D3ikCR8c/o9jB5irZ3uGlw: folds 
Mn2V28t5aGq2d09z+/o6Fw: calls $0.75
cezpHJ8FB07dj0xG+LhOvw: folds 
fZQg9veL7Dd/Z04ZTjC+wQ: calls $0.50
*** FLOP *** [As 9h Qh]
fZQg9veL7Dd/Z04ZTjC+wQ: checks 
yVrjRIW0SMxgpvqSIPSe/w: bets $1
Mn2V28t5aGq2d09z+/o6Fw: raises $2 to $3
fZQg9veL7Dd/Z04ZTjC+wQ: folds 
yVrjRIW0SMxgpvqSIPSe/w: raises $2 to $5
Mn2V28t5aGq2d09z+/o6Fw: raises $9 to $14
yVrjRIW0SMxgpvqSIPSe/w: raises $0.20 to $14.20 and is all-in
Mn2V28t5aGq2d09z+/o6Fw: calls $0.20
*** TURN *** [As 9h Qh] [Qs]
*** RIVER *** [As 9h Qh Qs] [8s]
*** SHOW DOWN ***
yVrjRIW0SMxgpvqSIPSe/w: shows [Js Ah] (two pair, Aces and Queens)
Mn2V28t5aGq2d09z+/o6Fw: shows [9c Qc] (a full house, Queens full of Nines)
Mn2V28t5aGq2d09z+/o6Fw collected $29.25 from pot
*** SUMMARY ***
Total pot $30.75 | Rake $1.50 
Board [As 9h Qh Qs 8s]
Seat 1: cezpHJ8FB07dj0xG+LhOvw (small blind) folded before Flop
Seat 2: fZQg9veL7Dd/Z04ZTjC+wQ (big blind) folded on the Flop
Seat 4: yVrjRIW0SMxgpvqSIPSe/w showed [Js Ah] and lost with two pair, Aces and Queens
Seat 5: D3ikCR8c/o9jB5irZ3uGlw folded before Flop (didn't bet)
Seat 6: Mn2V28t5aGq2d09z+/o6Fw (button) showed [9c Qc] and won ($29.25) with a full house, Queens full of Nines




PokerStars Game #59941930918:  Hold'em No Limit ($0.10/$0.25) - 2009/07/01 1:50:42 ET
Table 'IIO2q2znuuAXmiZ2qFTcmg' 6-max Seat #3 is the button
Seat 2: i9LqF5rD3bvtbEE7HWgr3Q ($26.85 in chips) 
Seat 3: j0aDOn9Nft1HLTQvGu1UwA ($12.20 in chips) 
Seat 5: iHZrkhpIO/3+tKuAoPx8HQ ($14.50 in chips) 
Seat 6: WT1/PiLHYHDQX0orTRlu9g ($15 in chips) 
iHZrkhpIO/3+tKuAoPx8HQ: posts small blind $0.10
WT1/PiLHYHDQX0orTRlu9g: posts big blind $0.25
*** HOLE CARDS ***
i9LqF5rD3bvtbEE7HWgr3Q: folds 
j0aDOn9Nft1HLTQvGu1UwA: raises $0.25 to $0.50
iHZrkhpIO/3+tKuAoPx8HQ: calls $0.40
WT1/PiLHYHDQX0orTRlu9g: calls $0.25
*** FLOP *** [2c Js 6d]
iHZrkhpIO/3+tKuAoPx8HQ: checks 
WT1/PiLHYHDQX0orTRlu9g: checks 
j0aDOn9Nft1HLTQvGu1UwA: bets $0.50
iHZrkhpIO/3+tKuAoPx8HQ: raises $1 to $1.50
WT1/PiLHYHDQX0orTRlu9g: folds 
j0aDOn9Nft1HLTQvGu1UwA: calls $1
*** TURN *** [2c Js 6d] [5d]
iHZrkhpIO/3+tKuAoPx8HQ: bets $1.50
j0aDOn9Nft1HLTQvGu1UwA: calls $1.50
*** RIVER *** [2c Js 6d 5d] [Kh]
iHZrkhpIO/3+tKuAoPx8HQ: bets $2
j0aDOn9Nft1HLTQvGu1UwA: calls $2
*** SHOW DOWN ***
iHZrkhpIO/3+tKuAoPx8HQ: shows [8c Jh] (a pair of Jacks)
j0aDOn9Nft1HLTQvGu1UwA: shows [Ad Jd] (a pair of Jacks - Ace kicker)
j0aDOn9Nft1HLTQvGu1UwA collected $10.95 from pot
*** SUMMARY ***
Total pot $11.50 | Rake $0.55 
Board [2c Js 6d 5d Kh]
Seat 2: i9LqF5rD3bvtbEE7HWgr3Q folded before Flop (didn't bet)
Seat 3: j0aDOn9Nft1HLTQvGu1UwA (button) showed [Ad Jd] and won ($10.95) with a pair of Jacks
Seat 5: iHZrkhpIO/3+tKuAoPx8HQ (small blind) showed [8c Jh] and lost with a pair of Jacks
Seat 6: WT1/PiLHYHDQX0orTRlu9g (big blind) folded on the Flop




PokerStars Game #59941930642:  Hold'em No Limit ($0.10/$0.25) - 2009/07/01 1:50:42 ET
Table 'HbNAGS1OJWQKyfk7UfrYyw' 9-max Seat #4 is the button
Seat 2: fjwM06E3HzjUrynPRQi31Q ($6 in chips) 
Seat 3: Yxal0LG80xJqTIctpMLWlg ($2.15 in chips) 
Seat 4: XwQK8xvCADxp0bUmji+Zyg ($18 in chips) 
Seat 5: clJsV3v77RS07bDKY+705w ($5 in chips) 
Seat 6: jntAuOS+eFQDYNiDN8dzag ($6 in chips) 
Seat 7: T+MjFnaPZsOyKbE9LYG2Qg ($14.75 in chips) 
Seat 9: nLE5Yo60EmSlJPyg0GgxXg ($30.75 in chips) 
clJsV3v77RS07bDKY+705w: posts small blind $0.10
jntAuOS+eFQDYNiDN8dzag: posts big blind $0.25
DiSvPC2iudwL5j9u6Huyww: sits out 
3PmVnC/15cl4oyI1TKIt4g: sits out 
*** HOLE CARDS ***
T+MjFnaPZsOyKbE9LYG2Qg: folds 
nLE5Yo60EmSlJPyg0GgxXg: raises $0.25 to $0.50
fjwM06E3HzjUrynPRQi31Q: folds 
Yxal0LG80xJqTIctpMLWlg: folds 
XwQK8xvCADxp0bUmji+Zyg: folds 
clJsV3v77RS07bDKY+705w: folds 
jntAuOS+eFQDYNiDN8dzag: calls $0.25
*** FLOP *** [6h Kh Qh]
jntAuOS+eFQDYNiDN8dzag: checks 
nLE5Yo60EmSlJPyg0GgxXg: bets $1.25
jntAuOS+eFQDYNiDN8dzag: folds 
Uncalled bet ($1.25) returned to nLE5Yo60EmSlJPyg0GgxXg
nLE5Yo60EmSlJPyg0GgxXg collected $1.05 from pot
*** SUMMARY ***
Total pot $1.10 | Rake $0.05 
Board [6h Kh Qh]
Seat 2: fjwM06E3HzjUrynPRQi31Q folded before Flop (didn't bet)
Seat 3: Yxal0LG80xJqTIctpMLWlg folded before Flop (didn't bet)
Seat 4: XwQK8xvCADxp0bUmji+Zyg (button) folded before Flop (didn't bet)
Seat 5: clJsV3v77RS07bDKY+705w (small blind) folded before Flop
Seat 6: jntAuOS+eFQDYNiDN8dzag (big blind) folded on the Flop
Seat 7: T+MjFnaPZsOyKbE9LYG2Qg folded before Flop (didn't bet)
Seat 9: nLE5Yo60EmSlJPyg0GgxXg collected ($1.05)




PokerStars Game #59941931436:  Hold'em No Limit ($0.10/$0.25) - 2009/07/01 1:50:43 ET
Table 'Loy/olZ5qoDOSvX4UTujGg' 6-max Seat #4 is the button
Seat 1: HipgaJhkN4ie/tTw4dK3Ug ($10.75 in chips) 
Seat 2: 4z7mPbMLNp4TezHXin63Vw ($14.45 in chips) 
Seat 3: 32YL2ZEp8NT4JB2RVM9euQ ($15 in chips) 
Seat 4: /gJNBeCkWL4o85/jvlZ4BA ($30.15 in chips) 
Seat 5: Ar4vsUIUfJ7gbYh1c1m59g ($19 in chips) 
Seat 6: qGHGf/553gQnDoklMRe3tg ($25.15 in chips) 
Ar4vsUIUfJ7gbYh1c1m59g: posts small blind $0.10
qGHGf/553gQnDoklMRe3tg: posts big blind $0.25
*** HOLE CARDS ***
HipgaJhkN4ie/tTw4dK3Ug: calls $0.25
4z7mPbMLNp4TezHXin63Vw: folds 
32YL2ZEp8NT4JB2RVM9euQ: folds 
/gJNBeCkWL4o85/jvlZ4BA: folds 
Ar4vsUIUfJ7gbYh1c1m59g: folds 
qGHGf/553gQnDoklMRe3tg: checks 
*** FLOP *** [7h Qc 9h]
qGHGf/553gQnDoklMRe3tg: checks 
HipgaJhkN4ie/tTw4dK3Ug: bets $0.50
qGHGf/553gQnDoklMRe3tg: folds 
Uncalled bet ($0.50) returned to HipgaJhkN4ie/tTw4dK3Ug
HipgaJhkN4ie/tTw4dK3Ug collected $0.60 from pot
HipgaJhkN4ie/tTw4dK3Ug: doesn't show hand 
*** SUMMARY ***
Total pot $0.60 | Rake $0 
Board [7h Qc 9h]
Seat 1: HipgaJhkN4ie/tTw4dK3Ug collected ($0.60)
Seat 2: 4z7mPbMLNp4TezHXin63Vw folded before Flop (didn't bet)
Seat 3: 32YL2ZEp8NT4JB2RVM9euQ folded before Flop (didn't bet)
Seat 4: /gJNBeCkWL4o85/jvlZ4BA (button) folded before Flop (didn't bet)
Seat 5: Ar4vsUIUfJ7gbYh1c1m59g (small blind) folded before Flop
Seat 6: qGHGf/553gQnDoklMRe3tg (big blind) folded on the Flop




PokerStars Game #59941931404:  Hold'em No Limit ($0.10/$0.25) - 2009/07/01 1:50:43 ET
Table 'D1Yq70l0nNCyMV6DA42p+Q' 9-max Seat #5 is the button
Seat 1: z5GxcHlYz/GSz6W2uFiTtg ($19.05 in chips) 
Seat 2: zgi+EUykT/pZQpoUG6+oEg ($5 in chips) 
Seat 3: 9lvO/qyU+xrU95Teu1fv0g ($6.50 in chips) 
Seat 4: VWUWpMLMj/Q1jRVpF7Aohw ($8.90 in chips) 
Seat 5: gehe91e0IyVT0QU/XBkEyg ($25 in chips) 
Seat 6: wGigCmBR/9XWkPpvYos3aQ ($33.55 in chips) 
Seat 8: zDrucyjVn5aeekNEc3cJrA ($24 in chips) 
Seat 9: h5wEs8qXrBqfLa9GjaSBzg ($17.25 in chips) 
wGigCmBR/9XWkPpvYos3aQ: posts small blind $0.10
zDrucyjVn5aeekNEc3cJrA: posts big blind $0.25
z5GxcHlYz/GSz6W2uFiTtg: posts small & big blinds $0.35
*** HOLE CARDS ***
h5wEs8qXrBqfLa9GjaSBzg: folds 
z5GxcHlYz/GSz6W2uFiTtg: checks 
zgi+EUykT/pZQpoUG6+oEg: folds 
9lvO/qyU+xrU95Teu1fv0g: folds 
VWUWpMLMj/Q1jRVpF7Aohw: folds 
gehe91e0IyVT0QU/XBkEyg: folds 
wGigCmBR/9XWkPpvYos3aQ: folds 
zDrucyjVn5aeekNEc3cJrA: checks 
*** FLOP *** [7d 3c 4d]
zDrucyjVn5aeekNEc3cJrA: checks 
z5GxcHlYz/GSz6W2uFiTtg: bets $0.50
zDrucyjVn5aeekNEc3cJrA: folds 
Uncalled bet ($0.50) returned to z5GxcHlYz/GSz6W2uFiTtg
z5GxcHlYz/GSz6W2uFiTtg collected $0.70 from pot
*** SUMMARY ***
Total pot $0.70 | Rake $0 
Board [7d 3c 4d]
Seat 1: z5GxcHlYz/GSz6W2uFiTtg collected ($0.70)
Seat 2: zgi+EUykT/pZQpoUG6+oEg folded before Flop (didn't bet)
Seat 3: 9lvO/qyU+xrU95Teu1fv0g folded before Flop (didn't bet)
Seat 4: VWUWpMLMj/Q1jRVpF7Aohw folded before Flop (didn't bet)
Seat 5: gehe91e0IyVT0QU/XBkEyg (button) folded before Flop (didn't bet)
Seat 6: wGigCmBR/9XWkPpvYos3aQ (small blind) folded before Flop
Seat 8: zDrucyjVn5aeekNEc3cJrA (big blind) folded on the Flop
Seat 9: h5wEs8qXrBqfLa9GjaSBzg folded before Flop (didn't bet)




PokerStars Game #59941931112:  Hold'em No Limit ($0.10/$0.25) - 2009/07/01 1:50:43 ET
Table 'YlRA05h9BJ1EhOUSNUjJdg' 9-max Seat #6 is the button
Seat 1: dtZ84flFEi4Q+SGrHMJRDQ ($25 in chips) 
Seat 2: Y2GFAe+PT7xnUUtgqCNDFw ($9.05 in chips) 
Seat 3: Z5ZtGOON8kmSdSCll9Z3XA ($12.85 in chips) 
Seat 4: HPEB+AtKw1+C/cxU0o1ciw ($33.95 in chips) 
Seat 5: sx0lGrkT9fd4yFR+3cXUQg ($11.15 in chips) 
Seat 6: QEbIGci+itdw+re8RM5fZA ($44.40 in chips) 
Seat 7: dfNim92Z6XK1/h5SFW5vDg ($25 in chips) 
Seat 8: dmYlc+1cjwZMJ7wV+Z0rRg ($32.90 in chips) 
dfNim92Z6XK1/h5SFW5vDg: posts small blind $0.10
dmYlc+1cjwZMJ7wV+Z0rRg: posts big blind $0.25
GeMoapCKDLc4ajT0Uk9ZQw: sits out 
*** HOLE CARDS ***
dtZ84flFEi4Q+SGrHMJRDQ: folds 
Y2GFAe+PT7xnUUtgqCNDFw: folds 
Z5ZtGOON8kmSdSCll9Z3XA: calls $0.25
HPEB+AtKw1+C/cxU0o1ciw: folds 
sx0lGrkT9fd4yFR+3cXUQg: folds 
QEbIGci+itdw+re8RM5fZA: folds 
dfNim92Z6XK1/h5SFW5vDg: folds 
dmYlc+1cjwZMJ7wV+Z0rRg: checks 
*** FLOP *** [4d 3c 5d]
dmYlc+1cjwZMJ7wV+Z0rRg: checks 
Z5ZtGOON8kmSdSCll9Z3XA: checks 
*** TURN *** [4d 3c 5d] [3h]
dmYlc+1cjwZMJ7wV+Z0rRg: checks 
Z5ZtGOON8kmSdSCll9Z3XA: checks 
*** RIVER *** [4d 3c 5d 3h] [5c]
dmYlc+1cjwZMJ7wV+Z0rRg: checks 
Z5ZtGOON8kmSdSCll9Z3XA: checks 
*** SHOW DOWN ***
dmYlc+1cjwZMJ7wV+Z0rRg: shows [2d Qc] (two pair, Fives and Threes)
Z5ZtGOON8kmSdSCll9Z3XA: shows [Qh Kd] (two pair, Fives and Threes - King kicker)
Z5ZtGOON8kmSdSCll9Z3XA collected $0.60 from pot
*** SUMMARY ***
Total pot $0.60 | Rake $0 
Board [4d 3c 5d 3h 5c]
Seat 1: dtZ84flFEi4Q+SGrHMJRDQ folded before Flop (didn't bet)
Seat 2: Y2GFAe+PT7xnUUtgqCNDFw folded before Flop (didn't bet)
Seat 3: Z5ZtGOON8kmSdSCll9Z3XA showed [Qh Kd] and won ($0.60) with two pair, Fives and Threes
Seat 4: HPEB+AtKw1+C/cxU0o1ciw folded before Flop (didn't bet)
Seat 5: sx0lGrkT9fd4yFR+3cXUQg folded before Flop (didn't bet)
Seat 6: QEbIGci+itdw+re8RM5fZA (button) folded before Flop (didn't bet)
Seat 7: dfNim92Z6XK1/h5SFW5vDg (small blind) folded before Flop
Seat 8: dmYlc+1cjwZMJ7wV+Z0rRg (big blind) showed [2d Qc] and lost with two pair, Fives and Threes




PokerStars Game #59941931342:  Hold'em No Limit ($0.10/$0.25) - 2009/07/01 1:50:43 ET
Table '4mnXP0EWt9mMZYzTIVDQ0w' 9-max Seat #2 is the button
Seat 1: Z5y2J55JmfLYR6/DPAGHwQ ($17.10 in chips) 
Seat 2: BLEU2x2bnGRovIelAY6slA ($25.05 in chips) 
Seat 3: Ns4HpwO7Oiffvyla/ie56w ($13.15 in chips) 
Seat 4: 9lvO/qyU+xrU95Teu1fv0g ($11.10 in chips) 
Seat 5: sSN8Y0AlsBeidZXPKmwXSw ($25.10 in chips) 
Seat 6: 5yjzPss7Y4kAWNDat3e0yQ ($35.65 in chips) 
Seat 7: TtioUKOdJQDGtQyRAYC5Xg ($5.75 in chips) 
Seat 8: 9YN2IkT2JYYKFErZtZvCtA ($14.05 in chips) 
Seat 9: N/O9ADKpmqB2ASZuqgodlw ($8.90 in chips) 
Ns4HpwO7Oiffvyla/ie56w: posts small blind $0.10
9lvO/qyU+xrU95Teu1fv0g: posts big blind $0.25
*** HOLE CARDS ***
sSN8Y0AlsBeidZXPKmwXSw: folds 
5yjzPss7Y4kAWNDat3e0yQ: folds 
TtioUKOdJQDGtQyRAYC5Xg: folds 
9YN2IkT2JYYKFErZtZvCtA: folds 
N/O9ADKpmqB2ASZuqgodlw: calls $0.25
Z5y2J55JmfLYR6/DPAGHwQ: folds 
BLEU2x2bnGRovIelAY6slA: folds 
Ns4HpwO7Oiffvyla/ie56w: calls $0.15
9lvO/qyU+xrU95Teu1fv0g: raises $0.75 to $1
N/O9ADKpmqB2ASZuqgodlw: calls $0.75
Ns4HpwO7Oiffvyla/ie56w: folds 
*** FLOP *** [As Ah Kh]
9lvO/qyU+xrU95Teu1fv0g: bets $1.25
N/O9ADKpmqB2ASZuqgodlw: folds 
Uncalled bet ($1.25) returned to 9lvO/qyU+xrU95Teu1fv0g
9lvO/qyU+xrU95Teu1fv0g collected $2.15 from pot
*** SUMMARY ***
Total pot $2.25 | Rake $0.10 
Board [As Ah Kh]
Seat 1: Z5y2J55JmfLYR6/DPAGHwQ folded before Flop (didn't bet)
Seat 2: BLEU2x2bnGRovIelAY6slA (button) folded before Flop (didn't bet)
Seat 3: Ns4HpwO7Oiffvyla/ie56w (small blind) folded before Flop
Seat 4: 9lvO/qyU+xrU95Teu1fv0g (big blind) collected ($2.15)
Seat 5: sSN8Y0AlsBeidZXPKmwXSw folded before Flop (didn't bet)
Seat 6: 5yjzPss7Y4kAWNDat3e0yQ folded before Flop (didn't bet)
Seat 7: TtioUKOdJQDGtQyRAYC5Xg folded before Flop (didn't bet)
Seat 8: 9YN2IkT2JYYKFErZtZvCtA folded before Flop (didn't bet)
Seat 9: N/O9ADKpmqB2ASZuqgodlw folded on the Flop




PokerStars Game #59941931086:  Hold'em No Limit ($0.10/$0.25) - 2009/07/01 1:50:43 ET
Table 'CM/C/FZf3VHIp50RjmBucQ' 9-max Seat #9 is the button
Seat 1: P8h+GtgJJRwRh2YdssBtbg ($5.60 in chips) 
Seat 2: OXPkK84/qv92EMwXPiG5rQ ($10 in chips) 
Seat 3: HPEB+AtKw1+C/cxU0o1ciw ($54.45 in chips) 
Seat 4: FYIiLXWy4mKC5ZGa/fnS0g ($15.40 in chips) 
Seat 5: t3m1RlE+8m1yb0ojo8ikCw ($12.40 in chips) 
Seat 6: FqpibuVWLNsAN/Z7ROZLnA ($5.55 in chips) 
Seat 7: +T7KwHtNiHQt6JhQegSH/w ($8.35 in chips) 
Seat 8: 5pDhXQ+RVy0BGcwfJAJfbg ($24.65 in chips) 
Seat 9: W6tExOcYX7qiy6Qdp+ZwFA ($4.90 in chips) 
P8h+GtgJJRwRh2YdssBtbg: posts small blind $0.10
OXPkK84/qv92EMwXPiG5rQ: posts big blind $0.25
*** HOLE CARDS ***
HPEB+AtKw1+C/cxU0o1ciw: folds 
FYIiLXWy4mKC5ZGa/fnS0g: raises $0.75 to $1
t3m1RlE+8m1yb0ojo8ikCw: calls $1
FqpibuVWLNsAN/Z7ROZLnA: folds 
+T7KwHtNiHQt6JhQegSH/w: calls $1
5pDhXQ+RVy0BGcwfJAJfbg: folds 
W6tExOcYX7qiy6Qdp+ZwFA: folds 
P8h+GtgJJRwRh2YdssBtbg: folds 
OXPkK84/qv92EMwXPiG5rQ: folds 
*** FLOP *** [9s Kh Qc]
FYIiLXWy4mKC5ZGa/fnS0g: bets $0.75
t3m1RlE+8m1yb0ojo8ikCw: folds 
+T7KwHtNiHQt6JhQegSH/w: raises $4.25 to $5
FYIiLXWy4mKC5ZGa/fnS0g: calls $4.25
*** TURN *** [9s Kh Qc] [6d]
FYIiLXWy4mKC5ZGa/fnS0g: checks 
+T7KwHtNiHQt6JhQegSH/w: bets $2.35 and is all-in
FYIiLXWy4mKC5ZGa/fnS0g: calls $2.35
*** RIVER *** [9s Kh Qc 6d] [3d]
*** SHOW DOWN ***
FYIiLXWy4mKC5ZGa/fnS0g: shows [Ah Qd] (a pair of Queens)
+T7KwHtNiHQt6JhQegSH/w: shows [Kc 7h] (a pair of Kings)
+T7KwHtNiHQt6JhQegSH/w collected $17.20 from pot
*** SUMMARY ***
Total pot $18.05 | Rake $0.85 
Board [9s Kh Qc 6d 3d]
Seat 1: P8h+GtgJJRwRh2YdssBtbg (small blind) folded before Flop
Seat 2: OXPkK84/qv92EMwXPiG5rQ (big blind) folded before Flop
Seat 3: HPEB+AtKw1+C/cxU0o1ciw folded before Flop (didn't bet)
Seat 4: FYIiLXWy4mKC5ZGa/fnS0g showed [Ah Qd] and lost with a pair of Queens
Seat 5: t3m1RlE+8m1yb0ojo8ikCw folded on the Flop
Seat 6: FqpibuVWLNsAN/Z7ROZLnA folded before Flop (didn't bet)
Seat 7: +T7KwHtNiHQt6JhQegSH/w showed [Kc 7h] and won ($17.20) with a pair of Kings
Seat 8: 5pDhXQ+RVy0BGcwfJAJfbg folded before Flop (didn't bet)
Seat 9: W6tExOcYX7qiy6Qdp+ZwFA (button) folded before Flop (didn't bet)




PokerStars Game #59941931374:  Hold'em No Limit ($0.10/$0.25) - 2009/07/01 1:50:43 ET
Table 'sSe6q4YTb/iS19t2eCFdsA' 9-max Seat #2 is the button
Seat 1: hJ4uYjNmSZdjrKA8cjZqCA ($18.40 in chips) 
Seat 2: 3l+i+xMeyDndSXMF2A5CDA ($5.40 in chips) 
Seat 3: OXPkK84/qv92EMwXPiG5rQ ($9.50 in chips) 
Seat 4: 22dIObOuor/A+IKWkNoAlA ($9.10 in chips) 
Seat 5: qS+jfnNoG75bT+uQ8CKhQA ($10.30 in chips) 
Seat 6: tYsOBqdU1+x+yFI7zHO7hQ ($27 in chips) 
Seat 7: t70KGeRtR3naHSqKDixsUg ($4.50 in chips) 
Seat 8: hvXZ0zFPZFP8Hf6dS36YEw ($16 in chips) 
Seat 9: Z9W7+g1WMhhZDi7DwGbCFA ($5.25 in chips) 
OXPkK84/qv92EMwXPiG5rQ: posts small blind $0.10
22dIObOuor/A+IKWkNoAlA: posts big blind $0.25
*** HOLE CARDS ***
qS+jfnNoG75bT+uQ8CKhQA: folds 
tYsOBqdU1+x+yFI7zHO7hQ: folds 
t70KGeRtR3naHSqKDixsUg: calls $0.25
hvXZ0zFPZFP8Hf6dS36YEw: folds 
Z9W7+g1WMhhZDi7DwGbCFA: folds 
hJ4uYjNmSZdjrKA8cjZqCA: folds 
3l+i+xMeyDndSXMF2A5CDA: folds 
OXPkK84/qv92EMwXPiG5rQ: calls $0.15
22dIObOuor/A+IKWkNoAlA: checks 
*** FLOP *** [Ts 4s Qs]
OXPkK84/qv92EMwXPiG5rQ: checks 
22dIObOuor/A+IKWkNoAlA: checks 
t70KGeRtR3naHSqKDixsUg: checks 
*** TURN *** [Ts 4s Qs] [Js]
OXPkK84/qv92EMwXPiG5rQ: checks 
22dIObOuor/A+IKWkNoAlA: checks 
t70KGeRtR3naHSqKDixsUg: checks 
*** RIVER *** [Ts 4s Qs Js] [Tc]
OXPkK84/qv92EMwXPiG5rQ: checks 
22dIObOuor/A+IKWkNoAlA: checks 
t70KGeRtR3naHSqKDixsUg: checks 
*** SHOW DOWN ***
OXPkK84/qv92EMwXPiG5rQ: shows [3d 2s] (a flush, Queen high)
22dIObOuor/A+IKWkNoAlA: mucks hand 
t70KGeRtR3naHSqKDixsUg: mucks hand 
OXPkK84/qv92EMwXPiG5rQ collected $0.75 from pot
*** SUMMARY ***
Total pot $0.75 | Rake $0 
Board [Ts 4s Qs Js Tc]
Seat 1: hJ4uYjNmSZdjrKA8cjZqCA folded before Flop (didn't bet)
Seat 2: 3l+i+xMeyDndSXMF2A5CDA (button) folded before Flop (didn't bet)
Seat 3: OXPkK84/qv92EMwXPiG5rQ (small blind) showed [3d 2s] and won ($0.75) with a flush, Queen high
Seat 4: 22dIObOuor/A+IKWkNoAlA (big blind) mucked
Seat 5: qS+jfnNoG75bT+uQ8CKhQA folded before Flop (didn't bet)
Seat 6: tYsOBqdU1+x+yFI7zHO7hQ folded before Flop (didn't bet)
Seat 7: t70KGeRtR3naHSqKDixsUg mucked
Seat 8: hvXZ0zFPZFP8Hf6dS36YEw folded before Flop (didn't bet)
Seat 9: Z9W7+g1WMhhZDi7DwGbCFA folded before Flop (didn't bet)




PokerStars Game #59941931944:  Hold'em No Limit ($0.10/$0.25) - 2009/07/01 1:50:44 ET
Table 'ktio12Pyq06LsrFhIorSqA' 9-max Seat #6 is the button
Seat 1: OneeONzF0MoH0pEdcBndwA ($37.80 in chips) 
Seat 2: tGsFgUKjSctVaAXabrlZxw ($4.70 in chips) 
Seat 3: Z9W7+g1WMhhZDi7DwGbCFA ($5 in chips) 
Seat 4: 0QdZrkFD7aGKeBXPGbIomA ($11.15 in chips) 
Seat 5: e0pV1oisCAilWiG0FCxY6A ($14.35 in chips) 
Seat 6: jQL6XIewylQ8MmZhhq2YFg ($39.05 in chips) 
Seat 7: XGCfQsxa6PfAg3kJtzUmww ($21.85 in chips) 
Seat 8: Z5y2J55JmfLYR6/DPAGHwQ ($12.20 in chips) 
Seat 9: H5Se03ZqSX7tbULXur2MAg ($25.55 in chips) 
XGCfQsxa6PfAg3kJtzUmww: posts small blind $0.10
Z5y2J55JmfLYR6/DPAGHwQ: posts big blind $0.25
*** HOLE CARDS ***
0QdZrkFD7aGKeBXPGbIomA said, "that's lotto"
H5Se03ZqSX7tbULXur2MAg: raises $0.50 to $0.75
OneeONzF0MoH0pEdcBndwA: folds 
tGsFgUKjSctVaAXabrlZxw: folds 
jQL6XIewylQ8MmZhhq2YFg said, "learn english u d i ck wad"
Z9W7+g1WMhhZDi7DwGbCFA: folds 
e0pV1oisCAilWiG0FCxY6A said, "lol"
0QdZrkFD7aGKeBXPGbIomA: folds 
e0pV1oisCAilWiG0FCxY6A: folds 
jQL6XIewylQ8MmZhhq2YFg: folds 
XGCfQsxa6PfAg3kJtzUmww: folds 
Z5y2J55JmfLYR6/DPAGHwQ: folds 
Uncalled bet ($0.50) returned to H5Se03ZqSX7tbULXur2MAg
H5Se03ZqSX7tbULXur2MAg collected $0.60 from pot
*** SUMMARY ***
Total pot $0.60 | Rake $0 
Seat 1: OneeONzF0MoH0pEdcBndwA folded before Flop (didn't bet)
Seat 2: tGsFgUKjSctVaAXabrlZxw folded before Flop (didn't bet)
Seat 3: Z9W7+g1WMhhZDi7DwGbCFA folded before Flop (didn't bet)
Seat 4: 0QdZrkFD7aGKeBXPGbIomA folded before Flop (didn't bet)
Seat 5: e0pV1oisCAilWiG0FCxY6A folded before Flop (didn't bet)
Seat 6: jQL6XIewylQ8MmZhhq2YFg (button) folded before Flop (didn't bet)
Seat 7: XGCfQsxa6PfAg3kJtzUmww (small blind) folded before Flop
Seat 8: Z5y2J55JmfLYR6/DPAGHwQ (big blind) folded before Flop
Seat 9: H5Se03ZqSX7tbULXur2MAg collected ($0.60)




PokerStars Game #59941931516:  Hold'em No Limit ($0.10/$0.25) - 2009/07/01 1:50:44 ET
Table 'NfXsh0UQA+o/kO9acV3WxA' 9-max Seat #3 is the button
Seat 1: pN3IHvAKm2fz+sTRARTcrg ($25 in chips) 
Seat 2: mhpFs2SZupy4zLRb62FLFA ($24.65 in chips) 
Seat 3: wCUaomJ6Nq5zomVGdUHP+w ($19.90 in chips) 
Seat 4: r6hsffOo1iKmaPYKwAZmFw ($30.15 in chips) 
Seat 5: zgi+EUykT/pZQpoUG6+oEg ($4.65 in chips) 
Seat 7: yqkowiRWZ6NvRN9UUkYIlA ($5 in chips) 
Seat 8: +sbyWwIcFp9kP0bDtMegfQ ($40.60 in chips) 
Seat 9: uhrboV251dcgYniYTdFIcA ($28.85 in chips) 
r6hsffOo1iKmaPYKwAZmFw: posts small blind $0.10
zgi+EUykT/pZQpoUG6+oEg: posts big blind $0.25
qwr38jl5txoR36M7G5qi4A: sits out 
*** HOLE CARDS ***
yqkowiRWZ6NvRN9UUkYIlA: folds 
+sbyWwIcFp9kP0bDtMegfQ: folds 
uhrboV251dcgYniYTdFIcA: folds 
pN3IHvAKm2fz+sTRARTcrg: folds 
mhpFs2SZupy4zLRb62FLFA: folds 
wCUaomJ6Nq5zomVGdUHP+w: calls $0.25
r6hsffOo1iKmaPYKwAZmFw: folds 
zgi+EUykT/pZQpoUG6+oEg: checks 
*** FLOP *** [2h Ks 6h]
zgi+EUykT/pZQpoUG6+oEg: checks 
wCUaomJ6Nq5zomVGdUHP+w: checks 
*** TURN *** [2h Ks 6h] [3h]
zgi+EUykT/pZQpoUG6+oEg: checks 
wCUaomJ6Nq5zomVGdUHP+w: checks 
*** RIVER *** [2h Ks 6h 3h] [8d]
zgi+EUykT/pZQpoUG6+oEg: checks 
wCUaomJ6Nq5zomVGdUHP+w: bets $0.50
zgi+EUykT/pZQpoUG6+oEg: folds 
Uncalled bet ($0.50) returned to wCUaomJ6Nq5zomVGdUHP+w
wCUaomJ6Nq5zomVGdUHP+w collected $0.60 from pot
*** SUMMARY ***
Total pot $0.60 | Rake $0 
Board [2h Ks 6h 3h 8d]
Seat 1: pN3IHvAKm2fz+sTRARTcrg folded before Flop (didn't bet)
Seat 2: mhpFs2SZupy4zLRb62FLFA folded before Flop (didn't bet)
Seat 3: wCUaomJ6Nq5zomVGdUHP+w (button) collected ($0.60)
Seat 4: r6hsffOo1iKmaPYKwAZmFw (small blind) folded before Flop
Seat 5: zgi+EUykT/pZQpoUG6+oEg (big blind) folded on the River
Seat 7: yqkowiRWZ6NvRN9UUkYIlA folded before Flop (didn't bet)
Seat 8: +sbyWwIcFp9kP0bDtMegfQ folded before Flop (didn't bet)
Seat 9: uhrboV251dcgYniYTdFIcA folded before Flop (didn't bet)




PokerStars Game #59941931852:  Hold'em No Limit ($0.10/$0.25) - 2009/07/01 1:50:44 ET
Table 'ukli1Y7ieC5JQMTEFxM2Nw' 6-max Seat #1 is the button
Seat 1: N162H80ZIQevUf2EzGahCA ($6.30 in chips) 
Seat 3: ExeoJ1G/rSmWa3tRz7TlCA ($23.35 in chips) 
Seat 4: if4dh6jhJXeN3/qd3qCp9g ($26.75 in chips) 
Seat 5: Se+H4Z4PDr6+eIUDJX1rpg ($18.15 in chips) 
Seat 6: 32YL2ZEp8NT4JB2RVM9euQ ($32 in chips) 
ExeoJ1G/rSmWa3tRz7TlCA: posts small blind $0.10
if4dh6jhJXeN3/qd3qCp9g: posts big blind $0.25
*** HOLE CARDS ***
Se+H4Z4PDr6+eIUDJX1rpg: calls $0.25
32YL2ZEp8NT4JB2RVM9euQ: folds 
N162H80ZIQevUf2EzGahCA: folds 
N162H80ZIQevUf2EzGahCA is sitting out
N162H80ZIQevUf2EzGahCA leaves the table
ExeoJ1G/rSmWa3tRz7TlCA: raises $0.75 to $1
if4dh6jhJXeN3/qd3qCp9g: folds 
Se+H4Z4PDr6+eIUDJX1rpg: calls $0.75
*** FLOP *** [Ts Qh Kd]
ExeoJ1G/rSmWa3tRz7TlCA: checks 
Se+H4Z4PDr6+eIUDJX1rpg: checks 
*** TURN *** [Ts Qh Kd] [3h]
ExeoJ1G/rSmWa3tRz7TlCA: bets $1
ukgMpMoFTQKuBqKbuPdCgg joins the table at seat #1 
i9LqF5rD3bvtbEE7HWgr3Q joins the table at seat #2 
Se+H4Z4PDr6+eIUDJX1rpg: folds 
Uncalled bet ($1) returned to ExeoJ1G/rSmWa3tRz7TlCA
ExeoJ1G/rSmWa3tRz7TlCA collected $2.15 from pot
*** SUMMARY ***
Total pot $2.25 | Rake $0.10 
Board [Ts Qh Kd 3h]
Seat 1: N162H80ZIQevUf2EzGahCA (button) folded before Flop (didn't bet)
Seat 3: ExeoJ1G/rSmWa3tRz7TlCA (small blind) collected ($2.15)
Seat 4: if4dh6jhJXeN3/qd3qCp9g (big blind) folded before Flop
Seat 5: Se+H4Z4PDr6+eIUDJX1rpg folded on the Turn
Seat 6: 32YL2ZEp8NT4JB2RVM9euQ folded before Flop (didn't bet)




PokerStars Game #59941931578:  Hold'em No Limit ($0.10/$0.25) - 2009/07/01 1:50:44 ET
Table 'vZfV/Uj0q8joA1du9sRJSg' 6-max Seat #3 is the button
Seat 1: Hsvkc0/G2VV78oVmWYXecw ($5 in chips) 
Seat 2: wMiE3yTbDJGOLOF9th7KPA ($11.40 in chips) 
Seat 3: cWc85bEzdRzpUMhRKm8pwQ ($25 in chips) 
Seat 4: v+QfkGiuj9bgtuNoVnDO8w ($43.25 in chips) 
Seat 5: kyRaCIljYA6l33lSKQfNsg ($29.30 in chips) 
Seat 6: 8ClCHtFXGNplITm+63KB+Q ($48.70 in chips) 
v+QfkGiuj9bgtuNoVnDO8w: posts small blind $0.10
kyRaCIljYA6l33lSKQfNsg: posts big blind $0.25
*** HOLE CARDS ***
8ClCHtFXGNplITm+63KB+Q: raises $0.75 to $1
Hsvkc0/G2VV78oVmWYXecw: folds 
wMiE3yTbDJGOLOF9th7KPA: calls $1
cWc85bEzdRzpUMhRKm8pwQ: folds 
v+QfkGiuj9bgtuNoVnDO8w: folds 
kyRaCIljYA6l33lSKQfNsg: folds 
*** FLOP *** [Ah Jh 5h]
Hsvkc0/G2VV78oVmWYXecw leaves the table
8ClCHtFXGNplITm+63KB+Q: checks 
wMiE3yTbDJGOLOF9th7KPA: bets $0.75
8ClCHtFXGNplITm+63KB+Q: folds 
Uncalled bet ($0.75) returned to wMiE3yTbDJGOLOF9th7KPA
wMiE3yTbDJGOLOF9th7KPA collected $2.25 from pot
*** SUMMARY ***
Total pot $2.35 | Rake $0.10 
Board [Ah Jh 5h]
Seat 1: Hsvkc0/G2VV78oVmWYXecw folded before Flop (didn't bet)
Seat 2: wMiE3yTbDJGOLOF9th7KPA collected ($2.25)
Seat 3: cWc85bEzdRzpUMhRKm8pwQ (button) folded before Flop (didn't bet)
Seat 4: v+QfkGiuj9bgtuNoVnDO8w (small blind) folded before Flop
Seat 5: kyRaCIljYA6l33lSKQfNsg (big blind) folded before Flop
Seat 6: 8ClCHtFXGNplITm+63KB+Q folded on the Flop




PokerStars Game #59941931968:  Hold'em No Limit ($0.10/$0.25) - 2009/07/01 1:50:44 ET
Table 'WY+lMaAoIdBZmwk27/RJCA' 6-max Seat #5 is the button
Seat 1: zHHLkD2sRljslKKeQv/ZQw ($26.35 in chips) 
Seat 2: NhUN/JpAprdJeamFBgJH1w ($28.25 in chips) 
Seat 3: QqiZLFrN8iOUT/GHw7ztOA ($26.60 in chips) 
Seat 4: 0av6tRNdi0Ui4f15L7gsVg ($23.15 in chips) 
Seat 5: vqWjZmdQu/Hxw96/IJTWdQ ($27.95 in chips) 
Seat 6: cWc85bEzdRzpUMhRKm8pwQ ($26.45 in chips) 
cWc85bEzdRzpUMhRKm8pwQ: posts small blind $0.10
zHHLkD2sRljslKKeQv/ZQw: posts big blind $0.25
*** HOLE CARDS ***
NhUN/JpAprdJeamFBgJH1w: folds 
QqiZLFrN8iOUT/GHw7ztOA: folds 
0av6tRNdi0Ui4f15L7gsVg: folds 
vqWjZmdQu/Hxw96/IJTWdQ: folds 
cWc85bEzdRzpUMhRKm8pwQ: raises $0.75 to $1
zHHLkD2sRljslKKeQv/ZQw: calls $0.75
*** FLOP *** [Ah Kd 3d]
cWc85bEzdRzpUMhRKm8pwQ: bets $1.50
zHHLkD2sRljslKKeQv/ZQw: calls $1.50
*** TURN *** [Ah Kd 3d] [8h]
cWc85bEzdRzpUMhRKm8pwQ: bets $3.50
zHHLkD2sRljslKKeQv/ZQw: raises $4 to $7.50
cWc85bEzdRzpUMhRKm8pwQ: folds 
Uncalled bet ($4) returned to zHHLkD2sRljslKKeQv/ZQw
zHHLkD2sRljslKKeQv/ZQw collected $11.45 from pot
*** SUMMARY ***
Total pot $12 | Rake $0.55 
Board [Ah Kd 3d 8h]
Seat 1: zHHLkD2sRljslKKeQv/ZQw (big blind) collected ($11.45)
Seat 2: NhUN/JpAprdJeamFBgJH1w folded before Flop (didn't bet)
Seat 3: QqiZLFrN8iOUT/GHw7ztOA folded before Flop (didn't bet)
Seat 4: 0av6tRNdi0Ui4f15L7gsVg folded before Flop (didn't bet)
Seat 5: vqWjZmdQu/Hxw96/IJTWdQ (button) folded before Flop (didn't bet)
Seat 6: cWc85bEzdRzpUMhRKm8pwQ (small blind) folded on the Turn




PokerStars Game #59941932324:  Hold'em No Limit ($0.10/$0.25) - 2009/07/01 1:50:45 ET
Table 'Yb2CyZosw7N3yRRVLhKnKg' 9-max Seat #8 is the button
Seat 1: j97ZRZFRWNUsBUL7hv78tA ($14.65 in chips) 
Seat 2: dtZ84flFEi4Q+SGrHMJRDQ ($26.15 in chips) 
Seat 3: wUanlt/hhheMA+jOrJk2Tg ($9.15 in chips) 
Seat 4: FG10kumpruEJ3PQJ7oGglQ ($17.25 in chips) 
Seat 6: CgIo2ItZqi4o3ayVG6HanQ ($43.75 in chips) 
Seat 7: ljemhp25Zg+nlA9DLCIiUw ($24.75 in chips) 
Seat 8: HxDF4QSxC4z39D7teZpprQ ($13.20 in chips) 
Seat 9: 6DVf3fwEGECnjQ4Yp9AsFw ($16.30 in chips) 
6DVf3fwEGECnjQ4Yp9AsFw: posts small blind $0.10
j97ZRZFRWNUsBUL7hv78tA: posts big blind $0.25
ydoFOVgzvZv9ZhuWu9rXAw: sits out 
*** HOLE CARDS ***
dtZ84flFEi4Q+SGrHMJRDQ: folds 
wUanlt/hhheMA+jOrJk2Tg: folds 
FG10kumpruEJ3PQJ7oGglQ: calls $0.25
CgIo2ItZqi4o3ayVG6HanQ: folds 
ljemhp25Zg+nlA9DLCIiUw: folds 
HxDF4QSxC4z39D7teZpprQ: calls $0.25
6DVf3fwEGECnjQ4Yp9AsFw: folds 
j97ZRZFRWNUsBUL7hv78tA: checks 
*** FLOP *** [6c Ts 9c]
j97ZRZFRWNUsBUL7hv78tA: checks 
FG10kumpruEJ3PQJ7oGglQ: checks 
HxDF4QSxC4z39D7teZpprQ: checks 
*** TURN *** [6c Ts 9c] [As]
j97ZRZFRWNUsBUL7hv78tA: checks 
FG10kumpruEJ3PQJ7oGglQ: bets $1
HxDF4QSxC4z39D7teZpprQ: folds 
j97ZRZFRWNUsBUL7hv78tA: folds 
Uncalled bet ($1) returned to FG10kumpruEJ3PQJ7oGglQ
FG10kumpruEJ3PQJ7oGglQ collected $0.85 from pot
*** SUMMARY ***
Total pot $0.85 | Rake $0 
Board [6c Ts 9c As]
Seat 1: j97ZRZFRWNUsBUL7hv78tA (big blind) folded on the Turn
Seat 2: dtZ84flFEi4Q+SGrHMJRDQ folded before Flop (didn't bet)
Seat 3: wUanlt/hhheMA+jOrJk2Tg folded before Flop (didn't bet)
Seat 4: FG10kumpruEJ3PQJ7oGglQ collected ($0.85)
Seat 6: CgIo2ItZqi4o3ayVG6HanQ folded before Flop (didn't bet)
Seat 7: ljemhp25Zg+nlA9DLCIiUw folded before Flop (didn't bet)
Seat 8: HxDF4QSxC4z39D7teZpprQ (button) folded on the Turn
Seat 9: 6DVf3fwEGECnjQ4Yp9AsFw (small blind) folded before Flop




PokerStars Game #59941932208:  Hold'em No Limit ($0.10/$0.25) - 2009/07/01 1:50:45 ET
Table 'KKk6y4pAXeymxYcd0uZLqg' 9-max Seat #9 is the button
Seat 1: HPEB+AtKw1+C/cxU0o1ciw ($25 in chips) 
Seat 2: k55YB7uP2TAZEba6pnHYiA ($19.70 in chips) 
Seat 3: tLcDklc2rBORNfixyRfVfw ($25 in chips) 
Seat 5: wGigCmBR/9XWkPpvYos3aQ ($40.70 in chips) 
Seat 6: QEbIGci+itdw+re8RM5fZA ($25 in chips) 
Seat 7: JjOuv8Vf56aiQjWi/rTPFA ($22.90 in chips) 
Seat 8: +2kMBNpY4nF1qNCRd8SJLA ($36.05 in chips) 
Seat 9: oLa/tXLfSLLB28mcLGrxcg ($25.10 in chips) 
HPEB+AtKw1+C/cxU0o1ciw: posts small blind $0.10
k55YB7uP2TAZEba6pnHYiA: posts big blind $0.25
18G4P1XstjNvItdGUITxgw: sits out 
*** HOLE CARDS ***
tLcDklc2rBORNfixyRfVfw: folds 
wGigCmBR/9XWkPpvYos3aQ: folds 
QEbIGci+itdw+re8RM5fZA: folds 
JjOuv8Vf56aiQjWi/rTPFA: folds 
+2kMBNpY4nF1qNCRd8SJLA: folds 
oLa/tXLfSLLB28mcLGrxcg: folds 
HPEB+AtKw1+C/cxU0o1ciw: folds 
Uncalled bet ($0.15) returned to k55YB7uP2TAZEba6pnHYiA
k55YB7uP2TAZEba6pnHYiA collected $0.20 from pot
k55YB7uP2TAZEba6pnHYiA: doesn't show hand 
*** SUMMARY ***
Total pot $0.20 | Rake $0 
Seat 1: HPEB+AtKw1+C/cxU0o1ciw (small blind) folded before Flop
Seat 2: k55YB7uP2TAZEba6pnHYiA (big blind) collected ($0.20)
Seat 3: tLcDklc2rBORNfixyRfVfw folded before Flop (didn't bet)
Seat 5: wGigCmBR/9XWkPpvYos3aQ folded before Flop (didn't bet)
Seat 6: QEbIGci+itdw+re8RM5fZA folded before Flop (didn't bet)
Seat 7: JjOuv8Vf56aiQjWi/rTPFA folded before Flop (didn't bet)
Seat 8: +2kMBNpY4nF1qNCRd8SJLA folded before Flop (didn't bet)
Seat 9: oLa/tXLfSLLB28mcLGrxcg (button) folded before Flop (didn't bet)




PokerStars Game #59941932442:  Hold'em No Limit ($0.10/$0.25) - 2009/07/01 1:50:45 ET
Table '9L7XfAwuM7XsXE8LIg2o5Q' 6-max Seat #2 is the button
Seat 1: dOIoLBxmpLHSXBN9LZnf0Q ($27.30 in chips) 
Seat 2: LJI7A1YgDM7hgh7o56+ReQ ($27.30 in chips) 
Seat 4: jp34e617tIzV8tKIWmfAbA ($38.55 in chips) 
Seat 5: ErIN0JRL5srYjT6en1f8YQ ($25 in chips) 
Seat 6: k9nHZTHt8hYhYRcW8NTb4g ($18.85 in chips) 
jp34e617tIzV8tKIWmfAbA: posts small blind $0.10
ErIN0JRL5srYjT6en1f8YQ: posts big blind $0.25
*** HOLE CARDS ***
k9nHZTHt8hYhYRcW8NTb4g: folds 
dOIoLBxmpLHSXBN9LZnf0Q: raises $0.50 to $0.75
LJI7A1YgDM7hgh7o56+ReQ: folds 
jp34e617tIzV8tKIWmfAbA: folds 
ErIN0JRL5srYjT6en1f8YQ: calls $0.50
*** FLOP *** [3d 7c 5s]
ErIN0JRL5srYjT6en1f8YQ: checks 
f1OIgv29LuXUMe6o34kTQg joins the table at seat #3 
dOIoLBxmpLHSXBN9LZnf0Q: bets $1
ErIN0JRL5srYjT6en1f8YQ: calls $1
*** TURN *** [3d 7c 5s] [9h]
ErIN0JRL5srYjT6en1f8YQ: checks 
dOIoLBxmpLHSXBN9LZnf0Q: bets $3.75
ErIN0JRL5srYjT6en1f8YQ: folds 
Uncalled bet ($3.75) returned to dOIoLBxmpLHSXBN9LZnf0Q
dOIoLBxmpLHSXBN9LZnf0Q collected $3.45 from pot
dOIoLBxmpLHSXBN9LZnf0Q: doesn't show hand 
*** SUMMARY ***
Total pot $3.60 | Rake $0.15 
Board [3d 7c 5s 9h]
Seat 1: dOIoLBxmpLHSXBN9LZnf0Q collected ($3.45)
Seat 2: LJI7A1YgDM7hgh7o56+ReQ (button) folded before Flop (didn't bet)
Seat 4: jp34e617tIzV8tKIWmfAbA (small blind) folded before Flop
Seat 5: ErIN0JRL5srYjT6en1f8YQ (big blind) folded on the Turn
Seat 6: k9nHZTHt8hYhYRcW8NTb4g folded before Flop (didn't bet)




PokerStars Game #59941932690:  Hold'em No Limit ($0.10/$0.25) - 2009/07/01 1:50:46 ET
Table 'LXz5SsUCyWcm+4JDJh466A' 9-max Seat #4 is the button
Seat 2: H5Se03ZqSX7tbULXur2MAg ($22.60 in chips) 
Seat 3: dfNim92Z6XK1/h5SFW5vDg ($25 in chips) 
Seat 4: K0b5wNInj6hUGRr6yzKFtw ($27.25 in chips) 
Seat 5: CGZe30OcuMyA3kN5MnfQcQ ($15.70 in chips) 
Seat 6: 6RiVTYll/5D8zICp0MRpKw ($24.75 in chips) 
Seat 7: J2a/QHAWUgo6beDRoEyg2g ($10.90 in chips) 
Seat 8: zOHElTcFiTsexeDCkAPYkQ ($58.20 in chips) 
Seat 9: dtZ84flFEi4Q+SGrHMJRDQ ($25 in chips) 
CGZe30OcuMyA3kN5MnfQcQ: posts small blind $0.10
6RiVTYll/5D8zICp0MRpKw: posts big blind $0.25
*** HOLE CARDS ***
MG90wfSJZnOejs/KD3vlQQ has returned
J2a/QHAWUgo6beDRoEyg2g: calls $0.25
zOHElTcFiTsexeDCkAPYkQ: raises $0.25 to $0.50
dtZ84flFEi4Q+SGrHMJRDQ: folds 
H5Se03ZqSX7tbULXur2MAg: folds 
dfNim92Z6XK1/h5SFW5vDg: folds 
K0b5wNInj6hUGRr6yzKFtw: calls $0.50
CGZe30OcuMyA3kN5MnfQcQ: folds 
6RiVTYll/5D8zICp0MRpKw: folds 
J2a/QHAWUgo6beDRoEyg2g: calls $0.25
*** FLOP *** [9h Jh 2h]
J2a/QHAWUgo6beDRoEyg2g: checks 
zOHElTcFiTsexeDCkAPYkQ: bets $57.70 and is all-in
K0b5wNInj6hUGRr6yzKFtw: calls $26.75 and is all-in
J2a/QHAWUgo6beDRoEyg2g: folds 
Uncalled bet ($30.95) returned to zOHElTcFiTsexeDCkAPYkQ
*** TURN *** [9h Jh 2h] [9d]
*** RIVER *** [9h Jh 2h 9d] [2s]
*** SHOW DOWN ***
zOHElTcFiTsexeDCkAPYkQ: shows [As 6s] (two pair, Nines and Deuces)
K0b5wNInj6hUGRr6yzKFtw: shows [Qh Th] (a flush, Queen high)
K0b5wNInj6hUGRr6yzKFtw collected $52.60 from pot
*** SUMMARY ***
Total pot $55.35 | Rake $2.75 
Board [9h Jh 2h 9d 2s]
Seat 2: H5Se03ZqSX7tbULXur2MAg folded before Flop (didn't bet)
Seat 3: dfNim92Z6XK1/h5SFW5vDg folded before Flop (didn't bet)
Seat 4: K0b5wNInj6hUGRr6yzKFtw (button) showed [Qh Th] and won ($52.60) with a flush, Queen high
Seat 5: CGZe30OcuMyA3kN5MnfQcQ (small blind) folded before Flop
Seat 6: 6RiVTYll/5D8zICp0MRpKw (big blind) folded before Flop
Seat 7: J2a/QHAWUgo6beDRoEyg2g folded on the Flop
Seat 8: zOHElTcFiTsexeDCkAPYkQ showed [As 6s] and lost with two pair, Nines and Deuces
Seat 9: dtZ84flFEi4Q+SGrHMJRDQ folded before Flop (didn't bet)




PokerStars Game #59941932598:  Hold'em No Limit ($0.10/$0.25) - 2009/07/01 1:50:46 ET
Table 'mF3KHGMaTpaBZbtBoyfTeg' 6-max Seat #5 is the button
Seat 1: 0HAB2GdCAM7p7V00xueAVQ ($34.25 in chips) 
Seat 2: xrf8tAXKQHG99HixCot1Iw ($27.35 in chips) 
Seat 3: 9kUKGKkblnIx3m8rlVol6Q ($15 in chips) 
Seat 5: 8ClCHtFXGNplITm+63KB+Q ($45.25 in chips) 
Seat 6: kG34n23qFQA3nzdOJTQ1dA ($26.55 in chips) 
kG34n23qFQA3nzdOJTQ1dA: posts small blind $0.10
0HAB2GdCAM7p7V00xueAVQ: posts big blind $0.25
9kUKGKkblnIx3m8rlVol6Q: posts small blind $0.10
*** HOLE CARDS ***
xrf8tAXKQHG99HixCot1Iw: folds 
qNYqNZMLP1I54EVl8faRRg joins the table at seat #4 
9kUKGKkblnIx3m8rlVol6Q: folds 
8ClCHtFXGNplITm+63KB+Q: folds 
kG34n23qFQA3nzdOJTQ1dA: folds 
Uncalled bet ($0.15) returned to 0HAB2GdCAM7p7V00xueAVQ
0HAB2GdCAM7p7V00xueAVQ collected $0.30 from pot
0HAB2GdCAM7p7V00xueAVQ: doesn't show hand 
*** SUMMARY ***
Total pot $0.30 | Rake $0 
Seat 1: 0HAB2GdCAM7p7V00xueAVQ (big blind) collected ($0.30)
Seat 2: xrf8tAXKQHG99HixCot1Iw folded before Flop (didn't bet)
Seat 3: 9kUKGKkblnIx3m8rlVol6Q folded before Flop
Seat 5: 8ClCHtFXGNplITm+63KB+Q (button) folded before Flop (didn't bet)
Seat 6: kG34n23qFQA3nzdOJTQ1dA (small blind) folded before Flop




PokerStars Game #59941932854:  Hold'em No Limit ($0.10/$0.25) - 2009/07/01 1:50:46 ET
Table '0M5QEJGOThqZwQ/sjbjXYw' 6-max Seat #3 is the button
Seat 2: /gJNBeCkWL4o85/jvlZ4BA ($34.60 in chips) 
Seat 3: 3zD3qLXT1bEffAoWGnc7wg ($25 in chips) 
Seat 5: cWc85bEzdRzpUMhRKm8pwQ ($53.15 in chips) 
Seat 6: bb63I02U6p9a5MNFa1gCiw ($21.35 in chips) 
cWc85bEzdRzpUMhRKm8pwQ: posts small blind $0.10
bb63I02U6p9a5MNFa1gCiw: posts big blind $0.25
*** HOLE CARDS ***
/gJNBeCkWL4o85/jvlZ4BA: raises $0.75 to $1
3zD3qLXT1bEffAoWGnc7wg: folds 
PToTQrV0TmESDzjJftg6QQ joins the table at seat #4 
cWc85bEzdRzpUMhRKm8pwQ: folds 
bb63I02U6p9a5MNFa1gCiw: raises $0.75 to $1.75
/gJNBeCkWL4o85/jvlZ4BA: calls $0.75
*** FLOP *** [3h 9c Qh]
bb63I02U6p9a5MNFa1gCiw: bets $1.50
/gJNBeCkWL4o85/jvlZ4BA: folds 
Uncalled bet ($1.50) returned to bb63I02U6p9a5MNFa1gCiw
bb63I02U6p9a5MNFa1gCiw collected $3.45 from pot
bb63I02U6p9a5MNFa1gCiw: doesn't show hand 
*** SUMMARY ***
Total pot $3.60 | Rake $0.15 
Board [3h 9c Qh]
Seat 2: /gJNBeCkWL4o85/jvlZ4BA folded on the Flop
Seat 3: 3zD3qLXT1bEffAoWGnc7wg (button) folded before Flop (didn't bet)
Seat 5: cWc85bEzdRzpUMhRKm8pwQ (small blind) folded before Flop
Seat 6: bb63I02U6p9a5MNFa1gCiw (big blind) collected ($3.45)




PokerStars Game #59941932746:  Hold'em No Limit ($0.10/$0.25) - 2009/07/01 1:50:46 ET
Table '5NipxzzFB2DffzDpddyQoQ' 6-max Seat #2 is the button
Seat 2: iauW7L/+7qzAuHow7CD75Q ($5 in chips) 
Seat 3: QvTX2yGq3uKJiKPmns4TKQ ($24.95 in chips) 
Seat 5: faP2NVl/cFTZ1nE4pXzg8Q ($20.95 in chips) 
Seat 6: 7JqTFMyeNSVWsmp/yW35Tw ($54.05 in chips) 
QvTX2yGq3uKJiKPmns4TKQ: posts small blind $0.10
7JqTFMyeNSVWsmp/yW35Tw said, "just get it in G"
faP2NVl/cFTZ1nE4pXzg8Q: posts big blind $0.25
*** HOLE CARDS ***
7JqTFMyeNSVWsmp/yW35Tw: folds 
iauW7L/+7qzAuHow7CD75Q: folds 
bruce958 leaves the table
QvTX2yGq3uKJiKPmns4TKQ: calls $0.15
faP2NVl/cFTZ1nE4pXzg8Q: checks 
*** FLOP *** [6h 3c 6c]
QvTX2yGq3uKJiKPmns4TKQ: checks 
faP2NVl/cFTZ1nE4pXzg8Q: bets $1.50
QvTX2yGq3uKJiKPmns4TKQ: folds 
Uncalled bet ($1.50) returned to faP2NVl/cFTZ1nE4pXzg8Q
faP2NVl/cFTZ1nE4pXzg8Q collected $0.50 from pot
faP2NVl/cFTZ1nE4pXzg8Q: doesn't show hand 
*** SUMMARY ***
Total pot $0.50 | Rake $0 
Board [6h 3c 6c]
Seat 2: iauW7L/+7qzAuHow7CD75Q (button) folded before Flop (didn't bet)
Seat 3: QvTX2yGq3uKJiKPmns4TKQ (small blind) folded on the Flop
Seat 5: faP2NVl/cFTZ1nE4pXzg8Q (big blind) collected ($0.50)
Seat 6: 7JqTFMyeNSVWsmp/yW35Tw folded before Flop (didn't bet)




PokerStars Game #59941932596:  Hold'em No Limit ($0.10/$0.25) - 2009/07/01 1:50:46 ET
Table '+2VxGVfkEqJ1AYfQy/JH2w' 6-max Seat #3 is the button
Seat 1: if4dh6jhJXeN3/qd3qCp9g ($28.05 in chips) 
Seat 2: qllppsCmUqovlriIWCeM/g ($5.80 in chips) 
Seat 3: epAUIB7h2FJXzUPRIvSkRA ($25 in chips) 
Seat 4: y+a/yGW/Jy4bPJFnaeTz5w ($16.35 in chips) 
Seat 5: XD1i5m5PvBDnRzJaG/vINw ($23.90 in chips) 
Seat 6: YQNVDzvw3TmGaFiq9MhRgA ($5.85 in chips) 
y+a/yGW/Jy4bPJFnaeTz5w: posts small blind $0.10
XD1i5m5PvBDnRzJaG/vINw: posts big blind $0.25
*** HOLE CARDS ***
YQNVDzvw3TmGaFiq9MhRgA: calls $0.25
if4dh6jhJXeN3/qd3qCp9g: folds 
qllppsCmUqovlriIWCeM/g: calls $0.25
epAUIB7h2FJXzUPRIvSkRA: raises $1.25 to $1.50
y+a/yGW/Jy4bPJFnaeTz5w: folds 
XD1i5m5PvBDnRzJaG/vINw: folds 
YQNVDzvw3TmGaFiq9MhRgA: folds 
qllppsCmUqovlriIWCeM/g: folds 
Uncalled bet ($1.25) returned to epAUIB7h2FJXzUPRIvSkRA
XD1i5m5PvBDnRzJaG/vINw leaves the table
epAUIB7h2FJXzUPRIvSkRA collected $1.10 from pot
epAUIB7h2FJXzUPRIvSkRA: doesn't show hand 
*** SUMMARY ***
Total pot $1.10 | Rake $0 
Seat 1: if4dh6jhJXeN3/qd3qCp9g folded before Flop (didn't bet)
Seat 2: qllppsCmUqovlriIWCeM/g folded before Flop
Seat 3: epAUIB7h2FJXzUPRIvSkRA (button) collected ($1.10)
Seat 4: y+a/yGW/Jy4bPJFnaeTz5w (small blind) folded before Flop
Seat 5: XD1i5m5PvBDnRzJaG/vINw (big blind) folded before Flop
Seat 6: YQNVDzvw3TmGaFiq9MhRgA folded before Flop




PokerStars Game #59941932710:  Hold'em No Limit ($0.10/$0.25) - 2009/07/01 1:50:46 ET
Table '60nA7av6bws9VnNmVwculA' 6-max Seat #1 is the button
Seat 1: if4dh6jhJXeN3/qd3qCp9g ($25 in chips) 
Seat 2: Bada343Si4xKu3fNXY99AA ($5.50 in chips) 
Seat 3: mnuJq+Q1IXKm/pCy+OzxmQ ($22.45 in chips) 
Seat 4: +baiVgI/ETnBARLe5mARCw ($18.60 in chips) 
Seat 5: zXh+lOT41Q2iWgCNj+OcRw ($11.60 in chips) 
Seat 6: mfrkWA3PTeYPkbO6hi98Aw ($24.40 in chips) 
Bada343Si4xKu3fNXY99AA: posts small blind $0.10
mnuJq+Q1IXKm/pCy+OzxmQ: posts big blind $0.25
*** HOLE CARDS ***
+baiVgI/ETnBARLe5mARCw: folds 
zXh+lOT41Q2iWgCNj+OcRw: folds 
mfrkWA3PTeYPkbO6hi98Aw: raises $0.75 to $1
if4dh6jhJXeN3/qd3qCp9g: folds 
Bada343Si4xKu3fNXY99AA: folds 
mnuJq+Q1IXKm/pCy+OzxmQ: calls $0.75
*** FLOP *** [9c 4s Js]
mnuJq+Q1IXKm/pCy+OzxmQ: checks 
mfrkWA3PTeYPkbO6hi98Aw: bets $1.50
mnuJq+Q1IXKm/pCy+OzxmQ: calls $1.50
*** TURN *** [9c 4s Js] [8c]
mnuJq+Q1IXKm/pCy+OzxmQ: bets $1.25
mfrkWA3PTeYPkbO6hi98Aw: calls $1.25
*** RIVER *** [9c 4s Js 8c] [Kh]
mnuJq+Q1IXKm/pCy+OzxmQ: bets $2.50
mfrkWA3PTeYPkbO6hi98Aw: folds 
Uncalled bet ($2.50) returned to mnuJq+Q1IXKm/pCy+OzxmQ
mnuJq+Q1IXKm/pCy+OzxmQ collected $7.25 from pot
mnuJq+Q1IXKm/pCy+OzxmQ: doesn't show hand 
*** SUMMARY ***
Total pot $7.60 | Rake $0.35 
Board [9c 4s Js 8c Kh]
Seat 1: if4dh6jhJXeN3/qd3qCp9g (button) folded before Flop (didn't bet)
Seat 2: Bada343Si4xKu3fNXY99AA (small blind) folded before Flop
Seat 3: mnuJq+Q1IXKm/pCy+OzxmQ (big blind) collected ($7.25)
Seat 4: +baiVgI/ETnBARLe5mARCw folded before Flop (didn't bet)
Seat 5: zXh+lOT41Q2iWgCNj+OcRw folded before Flop (didn't bet)
Seat 6: mfrkWA3PTeYPkbO6hi98Aw folded on the River




PokerStars Game #59941933284:  Hold'em No Limit ($0.10/$0.25) - 2009/07/01 1:50:47 ET
Table 'FE/j6VqBY4j9Uq+VHURQCQ' 6-max Seat #2 is the button
Seat 1: ypmjhffk/YHGc51wgVXUTw ($39.30 in chips) 
Seat 2: 3zD3qLXT1bEffAoWGnc7wg ($37.10 in chips) 
Seat 3: lBoEwOFgzcERLIRUkUoRTw ($27.25 in chips) 
Seat 4: 7JyPCA0J2grhXQYxe1h3+A ($7.10 in chips) 
Seat 5: bJFzs6QmEEnz4miMfSDtcg ($16.90 in chips) 
Seat 6: Q1uciOZPBR/WkAlqa6cL4A ($25.35 in chips) 
lBoEwOFgzcERLIRUkUoRTw: posts small blind $0.10
7JyPCA0J2grhXQYxe1h3+A: posts big blind $0.25
*** HOLE CARDS ***
bJFzs6QmEEnz4miMfSDtcg: folds 
Q1uciOZPBR/WkAlqa6cL4A: folds 
ypmjhffk/YHGc51wgVXUTw: folds 
3zD3qLXT1bEffAoWGnc7wg: raises $0.50 to $0.75
lBoEwOFgzcERLIRUkUoRTw: calls $0.65
7JyPCA0J2grhXQYxe1h3+A: folds 
*** FLOP *** [Tc 6s 8d]
lBoEwOFgzcERLIRUkUoRTw: checks 
3zD3qLXT1bEffAoWGnc7wg: checks 
*** TURN *** [Tc 6s 8d] [Ts]
lBoEwOFgzcERLIRUkUoRTw: bets $0.75
3zD3qLXT1bEffAoWGnc7wg: folds 
Uncalled bet ($0.75) returned to lBoEwOFgzcERLIRUkUoRTw
lBoEwOFgzcERLIRUkUoRTw collected $1.70 from pot
*** SUMMARY ***
Total pot $1.75 | Rake $0.05 
Board [Tc 6s 8d Ts]
Seat 1: ypmjhffk/YHGc51wgVXUTw folded before Flop (didn't bet)
Seat 2: 3zD3qLXT1bEffAoWGnc7wg (button) folded on the Turn
Seat 3: lBoEwOFgzcERLIRUkUoRTw (small blind) collected ($1.70)
Seat 4: 7JyPCA0J2grhXQYxe1h3+A (big blind) folded before Flop
Seat 5: bJFzs6QmEEnz4miMfSDtcg folded before Flop (didn't bet)
Seat 6: Q1uciOZPBR/WkAlqa6cL4A folded before Flop (didn't bet)




PokerStars Game #59941933550:  Hold'em No Limit ($0.10/$0.25) - 2009/07/01 1:50:47 ET
Table 'wPWRBZPJl1HAnysw7qRR0A' 6-max Seat #3 is the button
Seat 1: m7ne1MOFTQXlsXT7/R/rug ($12.15 in chips) 
Seat 2: xC0kaiDYM6YTlgODL83O5A ($22.65 in chips) 
Seat 3: 1ZpoLWO2nm2w1Nd1v9Sr3g ($6.85 in chips) 
Seat 4: epAUIB7h2FJXzUPRIvSkRA ($48.95 in chips) 
Seat 5: y0B+UpYpOUJz3JWtlJQBSA ($15.40 in chips) 
Seat 6: VXTONriS+Ohik+r0FeicIw ($25.95 in chips) 
epAUIB7h2FJXzUPRIvSkRA: posts small blind $0.10
y0B+UpYpOUJz3JWtlJQBSA: posts big blind $0.25
*** HOLE CARDS ***
VXTONriS+Ohik+r0FeicIw: folds 
m7ne1MOFTQXlsXT7/R/rug: folds 
xC0kaiDYM6YTlgODL83O5A: raises $0.50 to $0.75
1ZpoLWO2nm2w1Nd1v9Sr3g: folds 
epAUIB7h2FJXzUPRIvSkRA: folds 
y0B+UpYpOUJz3JWtlJQBSA: folds 
Uncalled bet ($0.50) returned to xC0kaiDYM6YTlgODL83O5A
xC0kaiDYM6YTlgODL83O5A collected $0.60 from pot
*** SUMMARY ***
Total pot $0.60 | Rake $0 
Seat 1: m7ne1MOFTQXlsXT7/R/rug folded before Flop (didn't bet)
Seat 2: xC0kaiDYM6YTlgODL83O5A collected ($0.60)
Seat 3: 1ZpoLWO2nm2w1Nd1v9Sr3g (button) folded before Flop (didn't bet)
Seat 4: epAUIB7h2FJXzUPRIvSkRA (small blind) folded before Flop
Seat 5: y0B+UpYpOUJz3JWtlJQBSA (big blind) folded before Flop
Seat 6: VXTONriS+Ohik+r0FeicIw folded before Flop (didn't bet)




PokerStars Game #59941933332:  Hold'em No Limit ($0.10/$0.25) - 2009/07/01 1:50:47 ET
Table 'vud0GB/ZlDCvUFhBFIaTlg' 9-max Seat #7 is the button
Seat 1: DiSvPC2iudwL5j9u6Huyww ($29.50 in chips) 
Seat 2: tLcDklc2rBORNfixyRfVfw ($25 in chips) 
Seat 3: W2YYHvqjaEpRrO7stZkClQ ($5.05 in chips) 
Seat 6: gehe91e0IyVT0QU/XBkEyg ($24.90 in chips) 
Seat 7: iG7VeTyBWf6wYNvZpbTcbw ($21.65 in chips) 
Seat 8: E0iYnEVO2ho7dH3QcCjw7g ($19.50 in chips) 
Seat 9: PdIasPkzm2sqZnN41ZRXOg ($5.20 in chips) 
E0iYnEVO2ho7dH3QcCjw7g: posts small blind $0.10
PdIasPkzm2sqZnN41ZRXOg: posts big blind $0.25
JqeaikMej6KsqTKmUhl2Lw: sits out 
*** HOLE CARDS ***
DiSvPC2iudwL5j9u6Huyww: folds 
tLcDklc2rBORNfixyRfVfw: folds 
W2YYHvqjaEpRrO7stZkClQ: folds 
PFv56Q1PTkDC084eXIAYmw joins the table at seat #5 
gehe91e0IyVT0QU/XBkEyg has timed out
gehe91e0IyVT0QU/XBkEyg: folds 
gehe91e0IyVT0QU/XBkEyg is sitting out
iG7VeTyBWf6wYNvZpbTcbw: calls $0.25
E0iYnEVO2ho7dH3QcCjw7g: calls $0.15
gehe91e0IyVT0QU/XBkEyg has returned
PdIasPkzm2sqZnN41ZRXOg: checks 
*** FLOP *** [Js Kh 5h]
E0iYnEVO2ho7dH3QcCjw7g: checks 
PdIasPkzm2sqZnN41ZRXOg: checks 
iG7VeTyBWf6wYNvZpbTcbw: bets $1
E0iYnEVO2ho7dH3QcCjw7g: folds 
PdIasPkzm2sqZnN41ZRXOg: folds 
Uncalled bet ($1) returned to iG7VeTyBWf6wYNvZpbTcbw
iG7VeTyBWf6wYNvZpbTcbw collected $0.75 from pot
*** SUMMARY ***
Total pot $0.75 | Rake $0 
Board [Js Kh 5h]
Seat 1: DiSvPC2iudwL5j9u6Huyww folded before Flop (didn't bet)
Seat 2: tLcDklc2rBORNfixyRfVfw folded before Flop (didn't bet)
Seat 3: W2YYHvqjaEpRrO7stZkClQ folded before Flop (didn't bet)
Seat 6: gehe91e0IyVT0QU/XBkEyg folded before Flop (didn't bet)
Seat 7: iG7VeTyBWf6wYNvZpbTcbw (button) collected ($0.75)
Seat 8: E0iYnEVO2ho7dH3QcCjw7g (small blind) folded on the Flop
Seat 9: PdIasPkzm2sqZnN41ZRXOg (big blind) folded on the Flop




PokerStars Game #59941933140:  Hold'em No Limit ($0.10/$0.25) - 2009/07/01 1:50:47 ET
Table 'bIGKmJgZehWJ+FAo8b85iw' 9-max Seat #7 is the button
Seat 1: yyG4svzOpC1A+sUP/scg6w ($7.50 in chips) 
Seat 2: cCjRCvseA9rZn7Xr+GCCHg ($25.80 in chips) 
Seat 3: /FyMUX+W/tpNFcRWbUTJxQ ($23.50 in chips) 
Seat 4: LGxBRjCRn6KlQ/6B4eoXbA ($36.15 in chips) 
Seat 5: uLP/lYn7oKq9xCChBXsXxw ($24.65 in chips) 
Seat 6: PFNLAvMkr8qKc7xCiH0wTA ($19.90 in chips) 
Seat 7: mMd8CDS/but3UC+Zp7Up2w ($20 in chips) 
Seat 8: +2kMBNpY4nF1qNCRd8SJLA ($53.95 in chips) 
+2kMBNpY4nF1qNCRd8SJLA: posts small blind $0.10
aNpwfA31EREwO+ar4XzBCw: is sitting out 
yyG4svzOpC1A+sUP/scg6w: posts big blind $0.25
*** HOLE CARDS ***
aNpwfA31EREwO+ar4XzBCw leaves the table
cCjRCvseA9rZn7Xr+GCCHg: folds 
TidusNexus joins the table at seat #9 
/FyMUX+W/tpNFcRWbUTJxQ: raises $1 to $1.25
LGxBRjCRn6KlQ/6B4eoXbA: folds 
uLP/lYn7oKq9xCChBXsXxw: folds 
PFNLAvMkr8qKc7xCiH0wTA: folds 
mMd8CDS/but3UC+Zp7Up2w: folds 
+2kMBNpY4nF1qNCRd8SJLA: folds 
yyG4svzOpC1A+sUP/scg6w: folds 
Uncalled bet ($1) returned to /FyMUX+W/tpNFcRWbUTJxQ
/FyMUX+W/tpNFcRWbUTJxQ collected $0.60 from pot
/FyMUX+W/tpNFcRWbUTJxQ: doesn't show hand 
*** SUMMARY ***
Total pot $0.60 | Rake $0 
Seat 1: yyG4svzOpC1A+sUP/scg6w (big blind) folded before Flop
Seat 2: cCjRCvseA9rZn7Xr+GCCHg folded before Flop (didn't bet)
Seat 3: /FyMUX+W/tpNFcRWbUTJxQ collected ($0.60)
Seat 4: LGxBRjCRn6KlQ/6B4eoXbA folded before Flop (didn't bet)
Seat 5: uLP/lYn7oKq9xCChBXsXxw folded before Flop (didn't bet)
Seat 6: PFNLAvMkr8qKc7xCiH0wTA folded before Flop (didn't bet)
Seat 7: mMd8CDS/but3UC+Zp7Up2w (button) folded before Flop (didn't bet)
Seat 8: +2kMBNpY4nF1qNCRd8SJLA (small blind) folded before Flop




PokerStars Game #59941933476:  Hold'em No Limit ($0.10/$0.25) - 2009/07/01 1:50:47 ET
Table 'm+FQg/QP0VP1ZA3V62WtOg' 9-max Seat #1 is the button
Seat 1: qwr38jl5txoR36M7G5qi4A ($10 in chips) 
Seat 2: yqkowiRWZ6NvRN9UUkYIlA ($5 in chips) 
Seat 3: +KblIivb6tainScpwm14RQ ($11.30 in chips) 
Seat 5: wf5j8xvJtko6ZXyCbzzlVQ ($9.45 in chips) 
Seat 6: CT7Xj/V/O5rBlhtt+RZeFQ ($38.60 in chips) 
Seat 7: TPAF9YkMsjQFq978RNWZEQ ($22.05 in chips) 
Seat 8: E0iYnEVO2ho7dH3QcCjw7g ($19.65 in chips) 
Seat 9: zUXhymECc2C9W9ZNw6qppA ($13.45 in chips) 
yqkowiRWZ6NvRN9UUkYIlA: posts small blind $0.10
+KblIivb6tainScpwm14RQ: posts big blind $0.25
UcVReRDrJa8R5MbJDpfsZA: sits out 
*** HOLE CARDS ***
wf5j8xvJtko6ZXyCbzzlVQ: raises $0.25 to $0.50
CT7Xj/V/O5rBlhtt+RZeFQ: folds 
TPAF9YkMsjQFq978RNWZEQ: folds 
E0iYnEVO2ho7dH3QcCjw7g: folds 
zUXhymECc2C9W9ZNw6qppA has timed out while disconnected
zUXhymECc2C9W9ZNw6qppA: folds 
zUXhymECc2C9W9ZNw6qppA is sitting out
qwr38jl5txoR36M7G5qi4A: folds 
yqkowiRWZ6NvRN9UUkYIlA: folds 
+KblIivb6tainScpwm14RQ: calls $0.25
*** FLOP *** [Jc 7h 2h]
+KblIivb6tainScpwm14RQ: checks 
wf5j8xvJtko6ZXyCbzzlVQ: bets $0.50
+KblIivb6tainScpwm14RQ: folds 
Uncalled bet ($0.50) returned to wf5j8xvJtko6ZXyCbzzlVQ
wf5j8xvJtko6ZXyCbzzlVQ collected $1.05 from pot
*** SUMMARY ***
Total pot $1.10 | Rake $0.05 
Board [Jc 7h 2h]
Seat 1: qwr38jl5txoR36M7G5qi4A (button) folded before Flop (didn't bet)
Seat 2: yqkowiRWZ6NvRN9UUkYIlA (small blind) folded before Flop
Seat 3: +KblIivb6tainScpwm14RQ (big blind) folded on the Flop
Seat 5: wf5j8xvJtko6ZXyCbzzlVQ collected ($1.05)
Seat 6: CT7Xj/V/O5rBlhtt+RZeFQ folded before Flop (didn't bet)
Seat 7: TPAF9YkMsjQFq978RNWZEQ folded before Flop (didn't bet)
Seat 8: E0iYnEVO2ho7dH3QcCjw7g folded before Flop (didn't bet)
Seat 9: zUXhymECc2C9W9ZNw6qppA folded before Flop (didn't bet)




PokerStars Game #59941933568:  Hold'em No Limit ($0.10/$0.25) - 2009/07/01 1:50:47 ET
Table 'Jz+kWRxWNGk9w24fdQEveA' 9-max Seat #4 is the button
Seat 1: Z9W7+g1WMhhZDi7DwGbCFA ($5 in chips) 
Seat 2: ljemhp25Zg+nlA9DLCIiUw ($37.75 in chips) 
Seat 3: N5sUK8M0br9djLrW97V9pQ ($20.45 in chips) 
Seat 4: HPEB+AtKw1+C/cxU0o1ciw ($28.65 in chips) 
Seat 5: d6eSA7wOH5mRaSyVDVRBLw ($17.55 in chips) 
Seat 7: wGigCmBR/9XWkPpvYos3aQ ($27.35 in chips) 
Seat 8: j4q3p0lesp63b1gZDwLBZw ($5 in chips) 
Seat 9: V6p0jQ/RhUsqpHLmXvEX4Q ($17.35 in chips) 
d6eSA7wOH5mRaSyVDVRBLw: posts small blind $0.10
Rodogor: is sitting out 
wGigCmBR/9XWkPpvYos3aQ: posts big blind $0.25
*** HOLE CARDS ***
j4q3p0lesp63b1gZDwLBZw: folds 
Rodogor leaves the table
AiXn/9o1EwOPZUHujnh/bA joins the table at seat #6 
V6p0jQ/RhUsqpHLmXvEX4Q: folds 
Z9W7+g1WMhhZDi7DwGbCFA: folds 
ljemhp25Zg+nlA9DLCIiUw: raises $0.50 to $0.75
N5sUK8M0br9djLrW97V9pQ: calls $0.75
HPEB+AtKw1+C/cxU0o1ciw: folds 
d6eSA7wOH5mRaSyVDVRBLw: calls $0.65
wGigCmBR/9XWkPpvYos3aQ: calls $0.50
*** FLOP *** [7c Ks 2s]
d6eSA7wOH5mRaSyVDVRBLw: checks 
wGigCmBR/9XWkPpvYos3aQ: checks 
ljemhp25Zg+nlA9DLCIiUw: checks 
N5sUK8M0br9djLrW97V9pQ: bets $1.75
d6eSA7wOH5mRaSyVDVRBLw: folds 
wGigCmBR/9XWkPpvYos3aQ: folds 
ljemhp25Zg+nlA9DLCIiUw: folds 
Uncalled bet ($1.75) returned to N5sUK8M0br9djLrW97V9pQ
N5sUK8M0br9djLrW97V9pQ collected $2.85 from pot
N5sUK8M0br9djLrW97V9pQ: doesn't show hand 
*** SUMMARY ***
Total pot $3 | Rake $0.15 
Board [7c Ks 2s]
Seat 1: Z9W7+g1WMhhZDi7DwGbCFA folded before Flop (didn't bet)
Seat 2: ljemhp25Zg+nlA9DLCIiUw folded on the Flop
Seat 3: N5sUK8M0br9djLrW97V9pQ collected ($2.85)
Seat 4: HPEB+AtKw1+C/cxU0o1ciw (button) folded before Flop (didn't bet)
Seat 5: d6eSA7wOH5mRaSyVDVRBLw (small blind) folded on the Flop
Seat 7: wGigCmBR/9XWkPpvYos3aQ (big blind) folded on the Flop
Seat 8: j4q3p0lesp63b1gZDwLBZw folded before Flop (didn't bet)
Seat 9: V6p0jQ/RhUsqpHLmXvEX4Q folded before Flop (didn't bet)




PokerStars Game #59941933296:  Hold'em No Limit ($0.10/$0.25) - 2009/07/01 1:50:47 ET
Table 'G+4ZdyRoPjgaJY/jxSlZzQ' 9-max Seat #8 is the button
Seat 1: ghNKXUBl/H+t83JF079ZBA ($23.75 in chips) 
Seat 2: CT7Xj/V/O5rBlhtt+RZeFQ ($25 in chips) 
Seat 3: FaGtAm5QUVcixGhAKIvbLg ($7.40 in chips) 
Seat 4: 3PmVnC/15cl4oyI1TKIt4g ($4.65 in chips) 
Seat 5: BT6Oal0iO4P6kDuT7HFQDw ($23.50 in chips) 
Seat 6: oFwaTjy3ok/+qFghsrcGvg ($21.55 in chips) 
Seat 7: qwr38jl5txoR36M7G5qi4A ($10.65 in chips) 
Seat 8: bXpVeaSTPBFSPJmeXxO7nw ($4.30 in chips) 
Seat 9: tLcDklc2rBORNfixyRfVfw ($26.60 in chips) 
tLcDklc2rBORNfixyRfVfw: posts small blind $0.10
ghNKXUBl/H+t83JF079ZBA: posts big blind $0.25
*** HOLE CARDS ***
CT7Xj/V/O5rBlhtt+RZeFQ: folds 
FaGtAm5QUVcixGhAKIvbLg: calls $0.25
3PmVnC/15cl4oyI1TKIt4g: folds 
BT6Oal0iO4P6kDuT7HFQDw: folds 
oFwaTjy3ok/+qFghsrcGvg: folds 
qwr38jl5txoR36M7G5qi4A: raises $1 to $1.25
bXpVeaSTPBFSPJmeXxO7nw: folds 
tLcDklc2rBORNfixyRfVfw: folds 
ghNKXUBl/H+t83JF079ZBA: folds 
FaGtAm5QUVcixGhAKIvbLg: calls $1
*** FLOP *** [5d 4h Kd]
FaGtAm5QUVcixGhAKIvbLg: checks 
qwr38jl5txoR36M7G5qi4A: bets $1.75
FaGtAm5QUVcixGhAKIvbLg: folds 
Uncalled bet ($1.75) returned to qwr38jl5txoR36M7G5qi4A
qwr38jl5txoR36M7G5qi4A collected $2.75 from pot
qwr38jl5txoR36M7G5qi4A: doesn't show hand 
*** SUMMARY ***
Total pot $2.85 | Rake $0.10 
Board [5d 4h Kd]
Seat 1: ghNKXUBl/H+t83JF079ZBA (big blind) folded before Flop
Seat 2: CT7Xj/V/O5rBlhtt+RZeFQ folded before Flop (didn't bet)
Seat 3: FaGtAm5QUVcixGhAKIvbLg folded on the Flop
Seat 4: 3PmVnC/15cl4oyI1TKIt4g folded before Flop (didn't bet)
Seat 5: BT6Oal0iO4P6kDuT7HFQDw folded before Flop (didn't bet)
Seat 6: oFwaTjy3ok/+qFghsrcGvg folded before Flop (didn't bet)
Seat 7: qwr38jl5txoR36M7G5qi4A collected ($2.75)
Seat 8: bXpVeaSTPBFSPJmeXxO7nw (button) folded before Flop (didn't bet)
Seat 9: tLcDklc2rBORNfixyRfVfw (small blind) folded before Flop




PokerStars Game #59941933746:  Hold'em No Limit ($0.10/$0.25) - 2009/07/01 1:50:48 ET
Table 'pPgW4R3kdH26lLi1MnE92w' 9-max Seat #6 is the button
Seat 1: F4P6SxCNY4vxdb318G9RwA ($20 in chips) 
Seat 2: cZ99hugmLBj9KhTlc8nCSw ($28 in chips) 
Seat 3: WaS7+xnv4bIVHoru6nxczA ($14 in chips) 
Seat 4: iZ1f67Ok/207yzIQOu1Kdg ($2.15 in chips) 
Seat 5: HPEB+AtKw1+C/cxU0o1ciw ($24.25 in chips) 
Seat 6: +qc/EYCgLC65SpGvr35eNg ($24.65 in chips) 
Seat 7: sD+TKtt36XiiN6jqHiLwDA ($28.80 in chips) 
Seat 8: clJsV3v77RS07bDKY+705w ($5 in chips) 
Seat 9: tcbEu7VzyHQ+0lh+skbQhQ ($64.90 in chips) 
sD+TKtt36XiiN6jqHiLwDA: posts small blind $0.10
clJsV3v77RS07bDKY+705w: posts big blind $0.25
*** HOLE CARDS ***
tcbEu7VzyHQ+0lh+skbQhQ: folds 
F4P6SxCNY4vxdb318G9RwA: folds 
cZ99hugmLBj9KhTlc8nCSw: folds 
WaS7+xnv4bIVHoru6nxczA: folds 
iZ1f67Ok/207yzIQOu1Kdg: folds 
HPEB+AtKw1+C/cxU0o1ciw: folds 
+qc/EYCgLC65SpGvr35eNg: raises $0.75 to $1
sD+TKtt36XiiN6jqHiLwDA: folds 
clJsV3v77RS07bDKY+705w: folds 
Uncalled bet ($0.75) returned to +qc/EYCgLC65SpGvr35eNg
+qc/EYCgLC65SpGvr35eNg collected $0.60 from pot
+qc/EYCgLC65SpGvr35eNg: doesn't show hand 
*** SUMMARY ***
Total pot $0.60 | Rake $0 
Seat 1: F4P6SxCNY4vxdb318G9RwA folded before Flop (didn't bet)
Seat 2: cZ99hugmLBj9KhTlc8nCSw folded before Flop (didn't bet)
Seat 3: WaS7+xnv4bIVHoru6nxczA folded before Flop (didn't bet)
Seat 4: iZ1f67Ok/207yzIQOu1Kdg folded before Flop (didn't bet)
Seat 5: HPEB+AtKw1+C/cxU0o1ciw folded before Flop (didn't bet)
Seat 6: +qc/EYCgLC65SpGvr35eNg (button) collected ($0.60)
Seat 7: sD+TKtt36XiiN6jqHiLwDA (small blind) folded before Flop
Seat 8: clJsV3v77RS07bDKY+705w (big blind) folded before Flop
Seat 9: tcbEu7VzyHQ+0lh+skbQhQ folded before Flop (didn't bet)




PokerStars Game #59941933894:  Hold'em No Limit ($0.10/$0.25) - 2009/07/01 1:50:48 ET
Table 'jdhJTJjFq2KTttwJcd+7nQ' 6-max Seat #5 is the button
Seat 1: LtASJ9OlkqGrrUKGQlpGAw ($26.50 in chips) 
Seat 2: Hsvkc0/G2VV78oVmWYXecw ($5 in chips) 
Seat 3: vqWjZmdQu/Hxw96/IJTWdQ ($29.15 in chips) 
Seat 4: vx7FwRcelVSsvNYAdp/z0A ($4.85 in chips) 
Seat 5: BV+K0Phf5VBHr7aZPKqbUQ ($33.05 in chips) 
Seat 6: yb6rnd48JuBccThV68VHAQ ($14.80 in chips) 
yb6rnd48JuBccThV68VHAQ: posts small blind $0.10
LtASJ9OlkqGrrUKGQlpGAw: posts big blind $0.25
*** HOLE CARDS ***
Hsvkc0/G2VV78oVmWYXecw: folds 
vqWjZmdQu/Hxw96/IJTWdQ: raises $0.75 to $1
vx7FwRcelVSsvNYAdp/z0A: folds 
BV+K0Phf5VBHr7aZPKqbUQ: folds 
yb6rnd48JuBccThV68VHAQ: calls $0.90
LtASJ9OlkqGrrUKGQlpGAw: folds 
*** FLOP *** [Ts 2h Js]
yb6rnd48JuBccThV68VHAQ: checks 
vqWjZmdQu/Hxw96/IJTWdQ: bets $1.75
yb6rnd48JuBccThV68VHAQ: folds 
Uncalled bet ($1.75) returned to vqWjZmdQu/Hxw96/IJTWdQ
vqWjZmdQu/Hxw96/IJTWdQ collected $2.15 from pot
vqWjZmdQu/Hxw96/IJTWdQ: doesn't show hand 
*** SUMMARY ***
Total pot $2.25 | Rake $0.10 
Board [Ts 2h Js]
Seat 1: LtASJ9OlkqGrrUKGQlpGAw (big blind) folded before Flop
Seat 2: Hsvkc0/G2VV78oVmWYXecw folded before Flop (didn't bet)
Seat 3: vqWjZmdQu/Hxw96/IJTWdQ collected ($2.15)
Seat 4: vx7FwRcelVSsvNYAdp/z0A folded before Flop (didn't bet)
Seat 5: BV+K0Phf5VBHr7aZPKqbUQ (button) folded before Flop (didn't bet)
Seat 6: yb6rnd48JuBccThV68VHAQ (small blind) folded on the Flop




PokerStars Game #59941934050:  Hold'em No Limit ($0.10/$0.25) - 2009/07/01 1:50:49 ET
Table 'SHi8+hK6i7E2dJ/3Agbyig' 6-max Seat #2 is the button
Seat 1: gPEN9Zp33YTm/mu9/SYP1w ($28.05 in chips) 
Seat 2: LJI7A1YgDM7hgh7o56+ReQ ($25.25 in chips) 
Seat 3: VXTONriS+Ohik+r0FeicIw ($25.10 in chips) 
Seat 4: u0ikXOhAPSCLmg+l17oGRw ($22.15 in chips) 
Seat 5: v8m8XHovI5tqEA9mvplDSw ($48.95 in chips) 
Seat 6: cWc85bEzdRzpUMhRKm8pwQ ($31.95 in chips) 
VXTONriS+Ohik+r0FeicIw: posts small blind $0.10
u0ikXOhAPSCLmg+l17oGRw: posts big blind $0.25
*** HOLE CARDS ***
v8m8XHovI5tqEA9mvplDSw: folds 
cWc85bEzdRzpUMhRKm8pwQ: raises $0.75 to $1
gPEN9Zp33YTm/mu9/SYP1w: calls $1
LJI7A1YgDM7hgh7o56+ReQ: calls $1
VXTONriS+Ohik+r0FeicIw: folds 
u0ikXOhAPSCLmg+l17oGRw: calls $0.75
*** FLOP *** [Qs 4h 4d]
u0ikXOhAPSCLmg+l17oGRw: checks 
cWc85bEzdRzpUMhRKm8pwQ: bets $2.50
gPEN9Zp33YTm/mu9/SYP1w: folds 
LJI7A1YgDM7hgh7o56+ReQ: folds 
u0ikXOhAPSCLmg+l17oGRw: folds 
Uncalled bet ($2.50) returned to cWc85bEzdRzpUMhRKm8pwQ
cWc85bEzdRzpUMhRKm8pwQ collected $3.90 from pot
*** SUMMARY ***
Total pot $4.10 | Rake $0.20 
Board [Qs 4h 4d]
Seat 1: gPEN9Zp33YTm/mu9/SYP1w folded on the Flop
Seat 2: LJI7A1YgDM7hgh7o56+ReQ (button) folded on the Flop
Seat 3: VXTONriS+Ohik+r0FeicIw (small blind) folded before Flop
Seat 4: u0ikXOhAPSCLmg+l17oGRw (big blind) folded on the Flop
Seat 5: v8m8XHovI5tqEA9mvplDSw folded before Flop (didn't bet)
Seat 6: cWc85bEzdRzpUMhRKm8pwQ collected ($3.90)




PokerStars Game #59941934176:  Hold'em No Limit ($0.10/$0.25) - 2009/07/01 1:50:49 ET
Table '2clPgY3+dETPD/8zjXZdFw' 6-max Seat #4 is the button
Seat 1: 7cx44/slbeTw+Cy7QB8Trg ($25.45 in chips) 
Seat 2: cWc85bEzdRzpUMhRKm8pwQ ($25 in chips) 
Seat 3: FL1UWpN6oReBdznWDOy9Gg ($16.10 in chips) 
Seat 4: ljjhtb6FVPTx9AT9HNdtqg ($23.10 in chips) 
Seat 5: LJI7A1YgDM7hgh7o56+ReQ ($30.55 in chips) 
Seat 6: c3J/KYZ4cNsUEuz8v57I5A ($25 in chips) 
LJI7A1YgDM7hgh7o56+ReQ: posts small blind $0.10
c3J/KYZ4cNsUEuz8v57I5A: posts big blind $0.25
*** HOLE CARDS ***
7cx44/slbeTw+Cy7QB8Trg: raises $0.50 to $0.75
cWc85bEzdRzpUMhRKm8pwQ: folds 
FL1UWpN6oReBdznWDOy9Gg: folds 
ljjhtb6FVPTx9AT9HNdtqg: folds 
LJI7A1YgDM7hgh7o56+ReQ: folds 
c3J/KYZ4cNsUEuz8v57I5A: folds 
Uncalled bet ($0.50) returned to 7cx44/slbeTw+Cy7QB8Trg
7cx44/slbeTw+Cy7QB8Trg collected $0.60 from pot
7cx44/slbeTw+Cy7QB8Trg: doesn't show hand 
*** SUMMARY ***
Total pot $0.60 | Rake $0 
Seat 1: 7cx44/slbeTw+Cy7QB8Trg collected ($0.60)
Seat 2: cWc85bEzdRzpUMhRKm8pwQ folded before Flop (didn't bet)
Seat 3: FL1UWpN6oReBdznWDOy9Gg folded before Flop (didn't bet)
Seat 4: ljjhtb6FVPTx9AT9HNdtqg (button) folded before Flop (didn't bet)
Seat 5: LJI7A1YgDM7hgh7o56+ReQ (small blind) folded before Flop
Seat 6: c3J/KYZ4cNsUEuz8v57I5A (big blind) folded before Flop




PokerStars Game #59941934428:  Hold'em No Limit ($0.10/$0.25) - 2009/07/01 1:50:49 ET
Table 'uFgIyfWPagvEVGEb86da7A' 9-max Seat #7 is the button
Seat 1: CT7Xj/V/O5rBlhtt+RZeFQ ($25.75 in chips) 
Seat 2: o3zvoO+PsqGti+1NZGNRrQ ($1.25 in chips) 
Seat 3: eGAnPT3w+iltM7HF59dzIg ($5.40 in chips) 
Seat 4: IGRfskE1v9H9Bn+fz8AgNQ ($27.60 in chips) 
Seat 5: X78b5v/uhqeXXoAijbw/yg ($28.55 in chips) 
Seat 6: zDrucyjVn5aeekNEc3cJrA ($26.75 in chips) 
Seat 7: 9zx7Mlww974uHUqoiq2eXA ($11.85 in chips) 
Seat 8: uLP/lYn7oKq9xCChBXsXxw ($25.30 in chips) 
Seat 9: sL5EaDXc90Iyxlm8ERXRQw ($18.35 in chips) 
uLP/lYn7oKq9xCChBXsXxw: posts small blind $0.10
sL5EaDXc90Iyxlm8ERXRQw: posts big blind $0.25
*** HOLE CARDS ***
CT7Xj/V/O5rBlhtt+RZeFQ: folds 
o3zvoO+PsqGti+1NZGNRrQ: folds 
eGAnPT3w+iltM7HF59dzIg: folds 
IGRfskE1v9H9Bn+fz8AgNQ: calls $0.25
X78b5v/uhqeXXoAijbw/yg: folds 
zDrucyjVn5aeekNEc3cJrA: folds 
9zx7Mlww974uHUqoiq2eXA: folds 
uLP/lYn7oKq9xCChBXsXxw: calls $0.15
sL5EaDXc90Iyxlm8ERXRQw: raises $0.25 to $0.50
IGRfskE1v9H9Bn+fz8AgNQ: calls $0.25
uLP/lYn7oKq9xCChBXsXxw: calls $0.25
*** FLOP *** [Tc Kc Kh]
uLP/lYn7oKq9xCChBXsXxw: checks 
sL5EaDXc90Iyxlm8ERXRQw: bets $1
IGRfskE1v9H9Bn+fz8AgNQ: calls $1
uLP/lYn7oKq9xCChBXsXxw: folds 
*** TURN *** [Tc Kc Kh] [Js]
sL5EaDXc90Iyxlm8ERXRQw: checks 
IGRfskE1v9H9Bn+fz8AgNQ: checks 
*** RIVER *** [Tc Kc Kh Js] [6d]
9zx7Mlww974uHUqoiq2eXA is disconnected 
9zx7Mlww974uHUqoiq2eXA is connected 
sL5EaDXc90Iyxlm8ERXRQw: checks 
IGRfskE1v9H9Bn+fz8AgNQ: bets $2.75
sL5EaDXc90Iyxlm8ERXRQw: calls $2.75
*** SHOW DOWN ***
IGRfskE1v9H9Bn+fz8AgNQ: shows [Qs Qd] (two pair, Kings and Queens)
sL5EaDXc90Iyxlm8ERXRQw: mucks hand 
IGRfskE1v9H9Bn+fz8AgNQ collected $8.60 from pot
sL5EaDXc90Iyxlm8ERXRQw leaves the table
*** SUMMARY ***
Total pot $9 | Rake $0.40 
Board [Tc Kc Kh Js 6d]
Seat 1: CT7Xj/V/O5rBlhtt+RZeFQ folded before Flop (didn't bet)
Seat 2: o3zvoO+PsqGti+1NZGNRrQ folded before Flop (didn't bet)
Seat 3: eGAnPT3w+iltM7HF59dzIg folded before Flop (didn't bet)
Seat 4: IGRfskE1v9H9Bn+fz8AgNQ showed [Qs Qd] and won ($8.60) with two pair, Kings and Queens
Seat 5: X78b5v/uhqeXXoAijbw/yg folded before Flop (didn't bet)
Seat 6: zDrucyjVn5aeekNEc3cJrA folded before Flop (didn't bet)
Seat 7: 9zx7Mlww974uHUqoiq2eXA (button) folded before Flop (didn't bet)
Seat 8: uLP/lYn7oKq9xCChBXsXxw (small blind) folded on the Flop
Seat 9: sL5EaDXc90Iyxlm8ERXRQw (big blind) mucked




PokerStars Game #59941934276:  Hold'em No Limit ($0.10/$0.25) - 2009/07/01 1:50:49 ET
Table '/asc7VQ/OpF/oVJ3erB80w' 9-max Seat #6 is the button
Seat 2: +LseQ4csMghI3KY4cLSGMQ ($20.20 in chips) 
Seat 3: WEb58GPxGJGcxGh34AFZRQ ($9.40 in chips) 
Seat 4: Rjy74A2wdEiDWplMcUbA+w ($7.75 in chips) 
Seat 5: QB9VESHry/CRTDKMGwKwsQ ($40.70 in chips) 
Seat 6: wnerYvSRWT9Sm4X3ip/c8w ($24.65 in chips) 
Seat 7: 7Qlge5BZqMQvXxiy4HU3Hw ($5.70 in chips) 
Seat 8: jB7U2KxE3pjvDhvZHXK2Ag ($17.85 in chips) 
Seat 9: zUXhymECc2C9W9ZNw6qppA ($19.05 in chips) 
7Qlge5BZqMQvXxiy4HU3Hw: posts small blind $0.10
jB7U2KxE3pjvDhvZHXK2Ag: posts big blind $0.25
3PmVnC/15cl4oyI1TKIt4g: sits out 
*** HOLE CARDS ***
zUXhymECc2C9W9ZNw6qppA has timed out while disconnected
zUXhymECc2C9W9ZNw6qppA: folds 
zUXhymECc2C9W9ZNw6qppA is sitting out
+LseQ4csMghI3KY4cLSGMQ: calls $0.25
WEb58GPxGJGcxGh34AFZRQ: folds 
Rjy74A2wdEiDWplMcUbA+w: folds 
QB9VESHry/CRTDKMGwKwsQ: folds 
wnerYvSRWT9Sm4X3ip/c8w: calls $0.25
7Qlge5BZqMQvXxiy4HU3Hw: calls $0.15
jB7U2KxE3pjvDhvZHXK2Ag: checks 
*** FLOP *** [Tc 2c Th]
7Qlge5BZqMQvXxiy4HU3Hw: checks 
jB7U2KxE3pjvDhvZHXK2Ag: bets $0.25
+LseQ4csMghI3KY4cLSGMQ: calls $0.25
wnerYvSRWT9Sm4X3ip/c8w: calls $0.25
7Qlge5BZqMQvXxiy4HU3Hw: folds 
*** TURN *** [Tc 2c Th] [7c]
jB7U2KxE3pjvDhvZHXK2Ag: checks 
+LseQ4csMghI3KY4cLSGMQ: bets $0.50
wnerYvSRWT9Sm4X3ip/c8w: calls $0.50
jB7U2KxE3pjvDhvZHXK2Ag: calls $0.50
*** RIVER *** [Tc 2c Th 7c] [3d]
jB7U2KxE3pjvDhvZHXK2Ag: checks 
+LseQ4csMghI3KY4cLSGMQ: checks 
wnerYvSRWT9Sm4X3ip/c8w: bets $1.50
jB7U2KxE3pjvDhvZHXK2Ag: folds 
+LseQ4csMghI3KY4cLSGMQ: raises $2.50 to $4
wnerYvSRWT9Sm4X3ip/c8w: calls $2.50
*** SHOW DOWN ***
+LseQ4csMghI3KY4cLSGMQ: shows [7h 8s] (two pair, Tens and Sevens)
wnerYvSRWT9Sm4X3ip/c8w: shows [2h 2d] (a full house, Deuces full of Tens)
wnerYvSRWT9Sm4X3ip/c8w collected $10.70 from pot
*** SUMMARY ***
Total pot $11.25 | Rake $0.55 
Board [Tc 2c Th 7c 3d]
Seat 2: +LseQ4csMghI3KY4cLSGMQ showed [7h 8s] and lost with two pair, Tens and Sevens
Seat 3: WEb58GPxGJGcxGh34AFZRQ folded before Flop (didn't bet)
Seat 4: Rjy74A2wdEiDWplMcUbA+w folded before Flop (didn't bet)
Seat 5: QB9VESHry/CRTDKMGwKwsQ folded before Flop (didn't bet)
Seat 6: wnerYvSRWT9Sm4X3ip/c8w (button) showed [2h 2d] and won ($10.70) with a full house, Deuces full of Tens
Seat 7: 7Qlge5BZqMQvXxiy4HU3Hw (small blind) folded on the Flop
Seat 8: jB7U2KxE3pjvDhvZHXK2Ag (big blind) folded on the River
Seat 9: zUXhymECc2C9W9ZNw6qppA folded before Flop (didn't bet)




PokerStars Game #59941934092:  Hold'em No Limit ($0.10/$0.25) - 2009/07/01 1:50:49 ET
Table 'S6s+TmTlAjLHclBRvN5/fw' 9-max Seat #4 is the button
Seat 3: z2SmIaQ3+5n/eY1BN5HgPg ($5 in chips) 
Seat 4: RSal7+azPhXeqQO5L8XPfg ($18.85 in chips) 
Seat 5: 8hSJOE8UscCqt6t47gp0/g ($8.90 in chips) 
Seat 6: QkBggokTsSaL9vRv6V8nzQ ($11.10 in chips) 
8hSJOE8UscCqt6t47gp0/g: posts small blind $0.10
QkBggokTsSaL9vRv6V8nzQ: posts big blind $0.25
*** HOLE CARDS ***
z2SmIaQ3+5n/eY1BN5HgPg: raises $1 to $1.25
RSal7+azPhXeqQO5L8XPfg: calls $1.25
8hSJOE8UscCqt6t47gp0/g: folds 
QkBggokTsSaL9vRv6V8nzQ: calls $1
*** FLOP *** [9c 5c 8s]
QkBggokTsSaL9vRv6V8nzQ: checks 
z2SmIaQ3+5n/eY1BN5HgPg: bets $3.75 and is all-in
RSal7+azPhXeqQO5L8XPfg: folds 
QkBggokTsSaL9vRv6V8nzQ: folds 
Uncalled bet ($3.75) returned to z2SmIaQ3+5n/eY1BN5HgPg
z2SmIaQ3+5n/eY1BN5HgPg collected $3.70 from pot
z2SmIaQ3+5n/eY1BN5HgPg: doesn't show hand 
*** SUMMARY ***
Total pot $3.85 | Rake $0.15 
Board [9c 5c 8s]
Seat 3: z2SmIaQ3+5n/eY1BN5HgPg collected ($3.70)
Seat 4: RSal7+azPhXeqQO5L8XPfg (button) folded on the Flop
Seat 5: 8hSJOE8UscCqt6t47gp0/g (small blind) folded before Flop
Seat 6: QkBggokTsSaL9vRv6V8nzQ (big blind) folded on the Flop




PokerStars Game #59941934816:  Hold'em No Limit ($0.10/$0.25) - 2009/07/01 1:50:50 ET
Table 'vFZR6Kf2Th5xBXT9brGW6A' 6-max Seat #5 is the button
Seat 1: Q1uciOZPBR/WkAlqa6cL4A ($25 in chips) 
Seat 2: QiL+lEgEWwy21jk/ltaRLg ($20.80 in chips) 
Seat 3: SH1WjKVUjPiyXySjWSdazw ($41.40 in chips) 
Seat 4: 79ID/ub1Pt/mDpCprVmOoA ($34.85 in chips) 
Seat 5: SS/yfeArhULzIcOPe8MdPg ($27.60 in chips) 
Seat 6: 4x9jCqgSw4272dnaIqnanw ($10.30 in chips) 
4x9jCqgSw4272dnaIqnanw: posts small blind $0.10
Q1uciOZPBR/WkAlqa6cL4A: posts big blind $0.25
*** HOLE CARDS ***
QiL+lEgEWwy21jk/ltaRLg: folds 
SH1WjKVUjPiyXySjWSdazw: folds 
79ID/ub1Pt/mDpCprVmOoA: folds 
SS/yfeArhULzIcOPe8MdPg: folds 
4x9jCqgSw4272dnaIqnanw: calls $0.15
Q1uciOZPBR/WkAlqa6cL4A: raises $0.75 to $1
4x9jCqgSw4272dnaIqnanw: calls $0.75
*** FLOP *** [6d Ts Ad]
4x9jCqgSw4272dnaIqnanw: checks 
Q1uciOZPBR/WkAlqa6cL4A: checks 
*** TURN *** [6d Ts Ad] [Qc]
4x9jCqgSw4272dnaIqnanw: checks 
Q1uciOZPBR/WkAlqa6cL4A: bets $1.25
4x9jCqgSw4272dnaIqnanw: calls $1.25
*** RIVER *** [6d Ts Ad Qc] [7h]
4x9jCqgSw4272dnaIqnanw: checks 
Q1uciOZPBR/WkAlqa6cL4A: bets $2
4x9jCqgSw4272dnaIqnanw: folds 
Uncalled bet ($2) returned to Q1uciOZPBR/WkAlqa6cL4A
Q1uciOZPBR/WkAlqa6cL4A collected $4.30 from pot
Q1uciOZPBR/WkAlqa6cL4A: doesn't show hand 
*** SUMMARY ***
Total pot $4.50 | Rake $0.20 
Board [6d Ts Ad Qc 7h]
Seat 1: Q1uciOZPBR/WkAlqa6cL4A (big blind) collected ($4.30)
Seat 2: QiL+lEgEWwy21jk/ltaRLg folded before Flop (didn't bet)
Seat 3: SH1WjKVUjPiyXySjWSdazw folded before Flop (didn't bet)
Seat 4: 79ID/ub1Pt/mDpCprVmOoA folded before Flop (didn't bet)
Seat 5: SS/yfeArhULzIcOPe8MdPg (button) folded before Flop (didn't bet)
Seat 6: 4x9jCqgSw4272dnaIqnanw (small blind) folded on the River




PokerStars Game #59941934858:  Hold'em No Limit ($0.10/$0.25) - 2009/07/01 1:50:50 ET
Table 'wRXcD9iXgBbdvKhWmfnBnw' 6-max Seat #4 is the button
Seat 1: Mhj3q7cxev+XjXZxEE6/Cw ($25 in chips) 
Seat 2: vUr8qM1UsCElsCI9B/McdQ ($21.30 in chips) 
Seat 3: SxIIgwXYLkwd6m3wLyPTCw ($26.15 in chips) 
Seat 4: mnuJq+Q1IXKm/pCy+OzxmQ ($19.25 in chips) 
Seat 5: EE16Ua5b1HSsYej5zeXOlA ($48.45 in chips) 
Seat 6: JFIAqU8lCZ0vWwEl4bdGsg ($34 in chips) 
EE16Ua5b1HSsYej5zeXOlA: posts small blind $0.10
JFIAqU8lCZ0vWwEl4bdGsg: posts big blind $0.25
*** HOLE CARDS ***
Mhj3q7cxev+XjXZxEE6/Cw: folds 
vUr8qM1UsCElsCI9B/McdQ: folds 
SxIIgwXYLkwd6m3wLyPTCw: folds 
mnuJq+Q1IXKm/pCy+OzxmQ: folds 
EE16Ua5b1HSsYej5zeXOlA: raises $0.60 to $0.85
JFIAqU8lCZ0vWwEl4bdGsg: folds 
Uncalled bet ($0.60) returned to EE16Ua5b1HSsYej5zeXOlA
EE16Ua5b1HSsYej5zeXOlA collected $0.50 from pot
EE16Ua5b1HSsYej5zeXOlA: doesn't show hand 
*** SUMMARY ***
Total pot $0.50 | Rake $0 
Seat 1: Mhj3q7cxev+XjXZxEE6/Cw folded before Flop (didn't bet)
Seat 2: vUr8qM1UsCElsCI9B/McdQ folded before Flop (didn't bet)
Seat 3: SxIIgwXYLkwd6m3wLyPTCw folded before Flop (didn't bet)
Seat 4: mnuJq+Q1IXKm/pCy+OzxmQ (button) folded before Flop (didn't bet)
Seat 5: EE16Ua5b1HSsYej5zeXOlA (small blind) collected ($0.50)
Seat 6: JFIAqU8lCZ0vWwEl4bdGsg (big blind) folded before Flop




PokerStars Game #59941935108:  Hold'em No Limit ($0.10/$0.25) - 2009/07/01 1:50:51 ET
Table 'srBTB98reCdD1TffxE6o7g' 6-max Seat #1 is the button
Seat 1: SFmT9ZsVopnukjvAzrxTRg ($36.55 in chips) 
Seat 2: mfrkWA3PTeYPkbO6hi98Aw ($24.75 in chips) 
Seat 3: VOmI0x4dDPnTESZd5B4d1Q ($42.40 in chips) 
Seat 4: 6DwBRH+xZ12AAZmeAg+aXw ($16.20 in chips) 
Seat 5: K1zv48sQUGQiaLk5VWWDqw ($25.90 in chips) 
Seat 6: BV+K0Phf5VBHr7aZPKqbUQ ($30.75 in chips) 
mfrkWA3PTeYPkbO6hi98Aw: posts small blind $0.10
VOmI0x4dDPnTESZd5B4d1Q: posts big blind $0.25
*** HOLE CARDS ***
6DwBRH+xZ12AAZmeAg+aXw: raises $0.50 to $0.75
K1zv48sQUGQiaLk5VWWDqw: folds 
BV+K0Phf5VBHr7aZPKqbUQ: folds 
SFmT9ZsVopnukjvAzrxTRg: folds 
mfrkWA3PTeYPkbO6hi98Aw: folds 
VOmI0x4dDPnTESZd5B4d1Q: folds 
Uncalled bet ($0.50) returned to 6DwBRH+xZ12AAZmeAg+aXw
6DwBRH+xZ12AAZmeAg+aXw collected $0.60 from pot
6DwBRH+xZ12AAZmeAg+aXw: doesn't show hand 
*** SUMMARY ***
Total pot $0.60 | Rake $0 
Seat 1: SFmT9ZsVopnukjvAzrxTRg (button) folded before Flop (didn't bet)
Seat 2: mfrkWA3PTeYPkbO6hi98Aw (small blind) folded before Flop
Seat 3: VOmI0x4dDPnTESZd5B4d1Q (big blind) folded before Flop
Seat 4: 6DwBRH+xZ12AAZmeAg+aXw collected ($0.60)
Seat 5: K1zv48sQUGQiaLk5VWWDqw folded before Flop (didn't bet)
Seat 6: BV+K0Phf5VBHr7aZPKqbUQ folded before Flop (didn't bet)




PokerStars Game #59941935286:  Hold'em No Limit ($0.10/$0.25) - 2009/07/01 1:50:51 ET
Table 'rO1I30HnuCPB0M8qEX1TCQ' 9-max Seat #6 is the button
Seat 1: Utuc935Snv3aKbSqGcz2Kg ($15 in chips) 
Seat 2: z1hPotrGOZjUjyoopZ7Ulg ($25.15 in chips) 
Seat 3: 2wcFsZsqEP5w1StUTVzJCg ($12.80 in chips) 
Seat 4: yyG4svzOpC1A+sUP/scg6w ($9.80 in chips) 
Seat 5: WQe4GbiYBiPsb5WKFKkijQ ($8.75 in chips) 
Seat 6: 5n7e7I+px7c6CQmLpPbtsg ($6.25 in chips) 
Seat 8: CGjLyv/AvljZy2g76nYkzQ ($25 in chips) 
AiXn/9o1EwOPZUHujnh/bA will be allowed to play after the button
CGjLyv/AvljZy2g76nYkzQ: posts small blind $0.10
wnerYvSRWT9Sm4X3ip/c8w: is sitting out 
wnerYvSRWT9Sm4X3ip/c8w leaves the table
Utuc935Snv3aKbSqGcz2Kg: posts big blind $0.25
*** HOLE CARDS ***
z1hPotrGOZjUjyoopZ7Ulg: folds 
2wcFsZsqEP5w1StUTVzJCg: folds 
I.F.R joins the table at seat #9 
yyG4svzOpC1A+sUP/scg6w: raises $0.50 to $0.75
I.F.R leaves the table
WQe4GbiYBiPsb5WKFKkijQ: raises $0.50 to $1.25
5n7e7I+px7c6CQmLpPbtsg: folds 
CGjLyv/AvljZy2g76nYkzQ: folds 
Utuc935Snv3aKbSqGcz2Kg: folds 
yyG4svzOpC1A+sUP/scg6w: raises $1.50 to $2.75
WQe4GbiYBiPsb5WKFKkijQ: raises $6 to $8.75 and is all-in
yyG4svzOpC1A+sUP/scg6w: calls $6
*** FLOP *** [9d 2s 5s]
*** TURN *** [9d 2s 5s] [8c]
*** RIVER *** [9d 2s 5s 8c] [4c]
*** SHOW DOWN ***
yyG4svzOpC1A+sUP/scg6w: shows [Ad As] (a pair of Aces)
WQe4GbiYBiPsb5WKFKkijQ: mucks hand 
SpiiQQAzy4MUgV3I5W8giw joins the table at seat #9 
yyG4svzOpC1A+sUP/scg6w collected $17 from pot
*** SUMMARY ***
Total pot $17.85 | Rake $0.85 
Board [9d 2s 5s 8c 4c]
Seat 1: Utuc935Snv3aKbSqGcz2Kg (big blind) folded before Flop
Seat 2: z1hPotrGOZjUjyoopZ7Ulg folded before Flop (didn't bet)
Seat 3: 2wcFsZsqEP5w1StUTVzJCg folded before Flop (didn't bet)
Seat 4: yyG4svzOpC1A+sUP/scg6w showed [Ad As] and won ($17) with a pair of Aces
Seat 5: WQe4GbiYBiPsb5WKFKkijQ mucked
Seat 6: 5n7e7I+px7c6CQmLpPbtsg (button) folded before Flop (didn't bet)
Seat 8: CGjLyv/AvljZy2g76nYkzQ (small blind) folded before Flop




PokerStars Game #59941935130:  Hold'em No Limit ($0.10/$0.25) - 2009/07/01 1:50:51 ET
Table 'jItkp2PNTbH9Cf7gqsAF7g' 9-max Seat #2 is the button
Seat 1: wGigCmBR/9XWkPpvYos3aQ ($26.50 in chips) 
Seat 2: qwr38jl5txoR36M7G5qi4A ($7.60 in chips) 
Seat 3: 0YaJElQVLqWThIZnqq3w1g ($11.95 in chips) 
Seat 4: oJOvZw/Iayou0f0k6dkBhg ($5.30 in chips) 
Seat 5: NO6qGDOw12lhu3zh1xW3Bg ($19.40 in chips) 
Seat 6: cZ99hugmLBj9KhTlc8nCSw ($51.25 in chips) 
Seat 8: cq6LACCDFivk2+PeoiB2sw ($11.10 in chips) 
Seat 9: dtZ84flFEi4Q+SGrHMJRDQ ($25 in chips) 
0YaJElQVLqWThIZnqq3w1g: posts small blind $0.10
oJOvZw/Iayou0f0k6dkBhg: posts big blind $0.25
z5GxcHlYz/GSz6W2uFiTtg: sits out 
*** HOLE CARDS ***
NO6qGDOw12lhu3zh1xW3Bg: calls $0.25
cZ99hugmLBj9KhTlc8nCSw: folds 
cq6LACCDFivk2+PeoiB2sw: folds 
dtZ84flFEi4Q+SGrHMJRDQ: raises $0.75 to $1
wGigCmBR/9XWkPpvYos3aQ: folds 
qwr38jl5txoR36M7G5qi4A: folds 
0YaJElQVLqWThIZnqq3w1g: calls $0.90
oJOvZw/Iayou0f0k6dkBhg: folds 
NO6qGDOw12lhu3zh1xW3Bg: calls $0.75
*** FLOP *** [7s 4h 2h]
0YaJElQVLqWThIZnqq3w1g: checks 
NO6qGDOw12lhu3zh1xW3Bg: checks 
dtZ84flFEi4Q+SGrHMJRDQ: checks 
*** TURN *** [7s 4h 2h] [Jd]
0YaJElQVLqWThIZnqq3w1g: checks 
NO6qGDOw12lhu3zh1xW3Bg: checks 
dtZ84flFEi4Q+SGrHMJRDQ: checks 
*** RIVER *** [7s 4h 2h Jd] [Kc]
0YaJElQVLqWThIZnqq3w1g: checks 
NO6qGDOw12lhu3zh1xW3Bg: checks 
dtZ84flFEi4Q+SGrHMJRDQ: bets $1.25
0YaJElQVLqWThIZnqq3w1g: folds 
NO6qGDOw12lhu3zh1xW3Bg: folds 
Uncalled bet ($1.25) returned to dtZ84flFEi4Q+SGrHMJRDQ
dtZ84flFEi4Q+SGrHMJRDQ collected $3.10 from pot
dtZ84flFEi4Q+SGrHMJRDQ: doesn't show hand 
*** SUMMARY ***
Total pot $3.25 | Rake $0.15 
Board [7s 4h 2h Jd Kc]
Seat 1: wGigCmBR/9XWkPpvYos3aQ folded before Flop (didn't bet)
Seat 2: qwr38jl5txoR36M7G5qi4A (button) folded before Flop (didn't bet)
Seat 3: 0YaJElQVLqWThIZnqq3w1g (small blind) folded on the River
Seat 4: oJOvZw/Iayou0f0k6dkBhg (big blind) folded before Flop
Seat 5: NO6qGDOw12lhu3zh1xW3Bg folded on the River
Seat 6: cZ99hugmLBj9KhTlc8nCSw folded before Flop (didn't bet)
Seat 8: cq6LACCDFivk2+PeoiB2sw folded before Flop (didn't bet)
Seat 9: dtZ84flFEi4Q+SGrHMJRDQ collected ($3.10)




PokerStars Game #59941935236:  Hold'em No Limit ($0.10/$0.25) - 2009/07/01 1:50:51 ET
Table 'VuY5ej47Cy8nOI3Wogmhzw' 6-max Seat #1 is the button
Seat 1: EeUZtMU058v2ObUACOF4Og ($28.35 in chips) 
Seat 3: v+QfkGiuj9bgtuNoVnDO8w ($42.80 in chips) 
Seat 4: QqiZLFrN8iOUT/GHw7ztOA ($45.05 in chips) 
Seat 6: +KblIivb6tainScpwm14RQ ($10.95 in chips) 
v+QfkGiuj9bgtuNoVnDO8w: posts small blind $0.10
QqiZLFrN8iOUT/GHw7ztOA: posts big blind $0.25
m2yWOKfAxqHoy5DDN87Ttw: sits out 
*** HOLE CARDS ***
+KblIivb6tainScpwm14RQ: folds 
EeUZtMU058v2ObUACOF4Og: folds 
v+QfkGiuj9bgtuNoVnDO8w: folds 
Uncalled bet ($0.15) returned to QqiZLFrN8iOUT/GHw7ztOA
QqiZLFrN8iOUT/GHw7ztOA collected $0.20 from pot
*** SUMMARY ***
Total pot $0.20 | Rake $0 
Seat 1: EeUZtMU058v2ObUACOF4Og (button) folded before Flop (didn't bet)
Seat 3: v+QfkGiuj9bgtuNoVnDO8w (small blind) folded before Flop
Seat 4: QqiZLFrN8iOUT/GHw7ztOA (big blind) collected ($0.20)
Seat 6: +KblIivb6tainScpwm14RQ folded before Flop (didn't bet)




PokerStars Game #59941935266:  Hold'em No Limit ($0.10/$0.25) - 2009/07/01 1:50:51 ET
Table 'KU/HrxqxwDz8HKEhYTZ6uw' 6-max Seat #6 is the button
Seat 1: 7LKoiQHXpTQXJvWQrw907g ($38.30 in chips) 
Seat 2: kG34n23qFQA3nzdOJTQ1dA ($24.30 in chips) 
Seat 3: SFmT9ZsVopnukjvAzrxTRg ($26.10 in chips) 
Seat 5: iyZxqznXjv3vtvOJymkoLQ ($52.35 in chips) 
Seat 6: qWxkCeqApAWdAA0evrfDvQ ($8.50 in chips) 
7LKoiQHXpTQXJvWQrw907g: posts small blind $0.10
kG34n23qFQA3nzdOJTQ1dA: posts big blind $0.25
*** HOLE CARDS ***
SFmT9ZsVopnukjvAzrxTRg: folds 
iyZxqznXjv3vtvOJymkoLQ: folds 
qWxkCeqApAWdAA0evrfDvQ: folds 
7LKoiQHXpTQXJvWQrw907g: calls $0.15
kG34n23qFQA3nzdOJTQ1dA: checks 
*** FLOP *** [6h Jc Qd]
7LKoiQHXpTQXJvWQrw907g: checks 
kG34n23qFQA3nzdOJTQ1dA: checks 
*** TURN *** [6h Jc Qd] [8s]
7LKoiQHXpTQXJvWQrw907g: bets $0.50
kG34n23qFQA3nzdOJTQ1dA: folds 
Uncalled bet ($0.50) returned to 7LKoiQHXpTQXJvWQrw907g
7LKoiQHXpTQXJvWQrw907g collected $0.50 from pot
*** SUMMARY ***
Total pot $0.50 | Rake $0 
Board [6h Jc Qd 8s]
Seat 1: 7LKoiQHXpTQXJvWQrw907g (small blind) collected ($0.50)
Seat 2: kG34n23qFQA3nzdOJTQ1dA (big blind) folded on the Turn
Seat 3: SFmT9ZsVopnukjvAzrxTRg folded before Flop (didn't bet)
Seat 5: iyZxqznXjv3vtvOJymkoLQ folded before Flop (didn't bet)
Seat 6: qWxkCeqApAWdAA0evrfDvQ (button) folded before Flop (didn't bet)




PokerStars Game #59941935852:  Hold'em No Limit ($0.10/$0.25) - 2009/07/01 1:50:52 ET
Table 'sDHjMRwfSiz7+NDdZLUiyA' 9-max Seat #2 is the button
Seat 1: VGwr1eqhvdUtMfBFCvBnmg ($12.05 in chips) 
Seat 2: ljemhp25Zg+nlA9DLCIiUw ($24.85 in chips) 
Seat 3: SGA1WpAnQxFdFAYyt362gQ ($17.80 in chips) 
Seat 4: eK8qa6EPcH2zhtbmWSvc9g ($25.80 in chips) 
Seat 5: IGRfskE1v9H9Bn+fz8AgNQ ($36.10 in chips) 
Seat 6: 1qa0qHOCKZM3Uipx9DxYtQ ($16.35 in chips) 
Seat 7: K0b5wNInj6hUGRr6yzKFtw ($37.65 in chips) 
Seat 9: 3PmVnC/15cl4oyI1TKIt4g ($4.50 in chips) 
SGA1WpAnQxFdFAYyt362gQ: posts small blind $0.10
eK8qa6EPcH2zhtbmWSvc9g: posts big blind $0.25
*** HOLE CARDS ***
IGRfskE1v9H9Bn+fz8AgNQ: folds 
1qa0qHOCKZM3Uipx9DxYtQ: calls $0.25
K0b5wNInj6hUGRr6yzKFtw: folds 
3PmVnC/15cl4oyI1TKIt4g: folds 
3hMkm4U5yTRrkGJkxfijaQ has returned
VGwr1eqhvdUtMfBFCvBnmg: calls $0.25
ljemhp25Zg+nlA9DLCIiUw: raises $1 to $1.25
SGA1WpAnQxFdFAYyt362gQ: raises $1 to $2.25
eK8qa6EPcH2zhtbmWSvc9g: folds 
1qa0qHOCKZM3Uipx9DxYtQ: folds 
VGwr1eqhvdUtMfBFCvBnmg: folds 
ljemhp25Zg+nlA9DLCIiUw: calls $1
*** FLOP *** [Tc 9c 6s]
SGA1WpAnQxFdFAYyt362gQ: bets $1.50
ljemhp25Zg+nlA9DLCIiUw: folds 
Uncalled bet ($1.50) returned to SGA1WpAnQxFdFAYyt362gQ
SGA1WpAnQxFdFAYyt362gQ collected $5 from pot
SGA1WpAnQxFdFAYyt362gQ: doesn't show hand 
*** SUMMARY ***
Total pot $5.25 | Rake $0.25 
Board [Tc 9c 6s]
Seat 1: VGwr1eqhvdUtMfBFCvBnmg folded before Flop
Seat 2: ljemhp25Zg+nlA9DLCIiUw (button) folded on the Flop
Seat 3: SGA1WpAnQxFdFAYyt362gQ (small blind) collected ($5)
Seat 4: eK8qa6EPcH2zhtbmWSvc9g (big blind) folded before Flop
Seat 5: IGRfskE1v9H9Bn+fz8AgNQ folded before Flop (didn't bet)
Seat 6: 1qa0qHOCKZM3Uipx9DxYtQ folded before Flop
Seat 7: K0b5wNInj6hUGRr6yzKFtw folded before Flop (didn't bet)
Seat 9: 3PmVnC/15cl4oyI1TKIt4g folded before Flop (didn't bet)




PokerStars Game #59941936060:  Hold'em No Limit ($0.10/$0.25) - 2009/07/01 1:50:52 ET
Table '3EebBlzq5yHSY2444L4zlg' 9-max Seat #1 is the button
Seat 1: XMSS6mD5B42I8wasdOMipQ ($29.15 in chips) 
Seat 2: b9UnopCOpq2MWP1DwqSO3Q ($17.45 in chips) 
Seat 3: 18G4P1XstjNvItdGUITxgw ($25 in chips) 
Seat 5: PFNLAvMkr8qKc7xCiH0wTA ($51.95 in chips) 
Seat 6: QEbIGci+itdw+re8RM5fZA ($50 in chips) 
Seat 7: DiSvPC2iudwL5j9u6Huyww ($49.60 in chips) 
Seat 8: dtZ84flFEi4Q+SGrHMJRDQ ($28.70 in chips) 
Seat 9: iZmSlSzYu5fJ67tDdQzymQ ($23.90 in chips) 
b9UnopCOpq2MWP1DwqSO3Q: posts small blind $0.10
18G4P1XstjNvItdGUITxgw: posts big blind $0.25
PdIasPkzm2sqZnN41ZRXOg: sits out 
*** HOLE CARDS ***
PFNLAvMkr8qKc7xCiH0wTA: folds 
QEbIGci+itdw+re8RM5fZA: folds 
DiSvPC2iudwL5j9u6Huyww: folds 
dtZ84flFEi4Q+SGrHMJRDQ: folds 
iZmSlSzYu5fJ67tDdQzymQ: folds 
XMSS6mD5B42I8wasdOMipQ: raises $0.50 to $0.75
b9UnopCOpq2MWP1DwqSO3Q: folds 
18G4P1XstjNvItdGUITxgw: folds 
Uncalled bet ($0.50) returned to XMSS6mD5B42I8wasdOMipQ
XMSS6mD5B42I8wasdOMipQ collected $0.60 from pot
*** SUMMARY ***
Total pot $0.60 | Rake $0 
Seat 1: XMSS6mD5B42I8wasdOMipQ (button) collected ($0.60)
Seat 2: b9UnopCOpq2MWP1DwqSO3Q (small blind) folded before Flop
Seat 3: 18G4P1XstjNvItdGUITxgw (big blind) folded before Flop
Seat 5: PFNLAvMkr8qKc7xCiH0wTA folded before Flop (didn't bet)
Seat 6: QEbIGci+itdw+re8RM5fZA folded before Flop (didn't bet)
Seat 7: DiSvPC2iudwL5j9u6Huyww folded before Flop (didn't bet)
Seat 8: dtZ84flFEi4Q+SGrHMJRDQ folded before Flop (didn't bet)
Seat 9: iZmSlSzYu5fJ67tDdQzymQ folded before Flop (didn't bet)




PokerStars Game #59941935868:  Hold'em No Limit ($0.10/$0.25) - 2009/07/01 1:50:52 ET
Table '4UJB/UOZ5aepyF2v+hIoUg' 6-max Seat #6 is the button
Seat 1: 08V++DOqzaNrRNsHIwi25w ($25 in chips) 
Seat 3: zlYHXTtJ5tcx9kwK2h5n9A ($51.40 in chips) 
Seat 4: R6AGToFJQOYVZAjC2jXEKw ($14.70 in chips) 
Seat 5: 3zD3qLXT1bEffAoWGnc7wg ($25.80 in chips) 
Seat 6: 2aphcinkTZT0B0Uoah6cvQ ($15.10 in chips) 
08V++DOqzaNrRNsHIwi25w: posts small blind $0.10
ellenxmarie: is sitting out 
zlYHXTtJ5tcx9kwK2h5n9A: posts big blind $0.25
*** HOLE CARDS ***
R6AGToFJQOYVZAjC2jXEKw: raises $0.75 to $1
3zD3qLXT1bEffAoWGnc7wg: folds 
2aphcinkTZT0B0Uoah6cvQ: folds 
08V++DOqzaNrRNsHIwi25w: folds 
zlYHXTtJ5tcx9kwK2h5n9A: folds 
Uncalled bet ($0.75) returned to R6AGToFJQOYVZAjC2jXEKw
R6AGToFJQOYVZAjC2jXEKw collected $0.60 from pot
R6AGToFJQOYVZAjC2jXEKw: doesn't show hand 
*** SUMMARY ***
Total pot $0.60 | Rake $0 
Seat 1: 08V++DOqzaNrRNsHIwi25w (small blind) folded before Flop
Seat 3: zlYHXTtJ5tcx9kwK2h5n9A (big blind) folded before Flop
Seat 4: R6AGToFJQOYVZAjC2jXEKw collected ($0.60)
Seat 5: 3zD3qLXT1bEffAoWGnc7wg folded before Flop (didn't bet)
Seat 6: 2aphcinkTZT0B0Uoah6cvQ (button) folded before Flop (didn't bet)




PokerStars Game #59941935946:  Hold'em No Limit ($0.10/$0.25) - 2009/07/01 1:50:52 ET
Table 'HzFR0rxmDAPu5GzYR0AlYg' 6-max Seat #6 is the button
Seat 1: v+QfkGiuj9bgtuNoVnDO8w ($34.90 in chips) 
Seat 2: UA5OsKS3VPaxa7uC8La/kA ($51.60 in chips) 
Seat 3: kG34n23qFQA3nzdOJTQ1dA ($24.55 in chips) 
Seat 4: Mhj3q7cxev+XjXZxEE6/Cw ($25.35 in chips) 
Seat 6: jp34e617tIzV8tKIWmfAbA ($35.30 in chips) 
v+QfkGiuj9bgtuNoVnDO8w: posts small blind $0.10
UA5OsKS3VPaxa7uC8La/kA: posts big blind $0.25
*** HOLE CARDS ***
kG34n23qFQA3nzdOJTQ1dA: folds 
Mhj3q7cxev+XjXZxEE6/Cw: folds 
jp34e617tIzV8tKIWmfAbA: folds 
v+QfkGiuj9bgtuNoVnDO8w: raises $1 to $1.25
UA5OsKS3VPaxa7uC8La/kA: folds 
Uncalled bet ($1) returned to v+QfkGiuj9bgtuNoVnDO8w
v+QfkGiuj9bgtuNoVnDO8w collected $0.50 from pot
v+QfkGiuj9bgtuNoVnDO8w: doesn't show hand 
*** SUMMARY ***
Total pot $0.50 | Rake $0 
Seat 1: v+QfkGiuj9bgtuNoVnDO8w (small blind) collected ($0.50)
Seat 2: UA5OsKS3VPaxa7uC8La/kA (big blind) folded before Flop
Seat 3: kG34n23qFQA3nzdOJTQ1dA folded before Flop (didn't bet)
Seat 4: Mhj3q7cxev+XjXZxEE6/Cw folded before Flop (didn't bet)
Seat 6: jp34e617tIzV8tKIWmfAbA (button) folded before Flop (didn't bet)




PokerStars Game #59941935702:  Hold'em No Limit ($0.10/$0.25) - 2009/07/01 1:50:52 ET
Table 'Pz8SfAzhP5nvWTsJRAxoDg' 6-max Seat #4 is the button
Seat 1: QiL+lEgEWwy21jk/ltaRLg ($46.05 in chips) 
Seat 2: k021eD5in2AjaloW5PalMg ($18.45 in chips) 
Seat 3: mfrkWA3PTeYPkbO6hi98Aw ($31.45 in chips) 
Seat 4: 4lJto+Qj0K4JrFKvHaPTLw ($64.05 in chips) 
Seat 6: QvTX2yGq3uKJiKPmns4TKQ ($17.45 in chips) 
QvTX2yGq3uKJiKPmns4TKQ: posts small blind $0.10
QiL+lEgEWwy21jk/ltaRLg: posts big blind $0.25
*** HOLE CARDS ***
k021eD5in2AjaloW5PalMg: folds 
mfrkWA3PTeYPkbO6hi98Aw: folds 
4lJto+Qj0K4JrFKvHaPTLw: folds 
QvTX2yGq3uKJiKPmns4TKQ: calls $0.15
QiL+lEgEWwy21jk/ltaRLg: raises $0.50 to $0.75
QvTX2yGq3uKJiKPmns4TKQ: calls $0.50
*** FLOP *** [5h 9d 4c]
QvTX2yGq3uKJiKPmns4TKQ: checks 
u+J1MTXS2qhNVMbsBemNLg joins the table at seat #5 
QiL+lEgEWwy21jk/ltaRLg: bets $0.75
QvTX2yGq3uKJiKPmns4TKQ: folds 
Uncalled bet ($0.75) returned to QiL+lEgEWwy21jk/ltaRLg
QiL+lEgEWwy21jk/ltaRLg collected $1.45 from pot
*** SUMMARY ***
Total pot $1.50 | Rake $0.05 
Board [5h 9d 4c]
Seat 1: QiL+lEgEWwy21jk/ltaRLg (big blind) collected ($1.45)
Seat 2: k021eD5in2AjaloW5PalMg folded before Flop (didn't bet)
Seat 3: mfrkWA3PTeYPkbO6hi98Aw folded before Flop (didn't bet)
Seat 4: 4lJto+Qj0K4JrFKvHaPTLw (button) folded before Flop (didn't bet)
Seat 6: QvTX2yGq3uKJiKPmns4TKQ (small blind) folded on the Flop




PokerStars Game #59941935602:  Hold'em No Limit ($0.10/$0.25) - 2009/07/01 1:50:52 ET
Table 'FuFyQHmlO/QqQp//rDRrPg' 6-max Seat #5 is the button
Seat 1: jp34e617tIzV8tKIWmfAbA ($28.15 in chips) 
Seat 2: G3h3THGB1j3qdHDVHpnJWg ($37.20 in chips) 
Seat 3: EeUZtMU058v2ObUACOF4Og ($29.60 in chips) 
Seat 4: Ahsa9Yk5NPmCqQstq1EoQA ($14.40 in chips) 
Seat 5: xrf8tAXKQHG99HixCot1Iw ($26.55 in chips) 
Seat 6: 6DwBRH+xZ12AAZmeAg+aXw ($50.10 in chips) 
6DwBRH+xZ12AAZmeAg+aXw: posts small blind $0.10
jp34e617tIzV8tKIWmfAbA: posts big blind $0.25
*** HOLE CARDS ***
G3h3THGB1j3qdHDVHpnJWg: calls $0.25
EeUZtMU058v2ObUACOF4Og: folds 
Ahsa9Yk5NPmCqQstq1EoQA: calls $0.25
xrf8tAXKQHG99HixCot1Iw: folds 
6DwBRH+xZ12AAZmeAg+aXw: calls $0.15
jp34e617tIzV8tKIWmfAbA: raises $1 to $1.25
G3h3THGB1j3qdHDVHpnJWg: calls $1
Ahsa9Yk5NPmCqQstq1EoQA: calls $1
6DwBRH+xZ12AAZmeAg+aXw: folds 
*** FLOP *** [4h 3s 5s]
jp34e617tIzV8tKIWmfAbA: checks 
G3h3THGB1j3qdHDVHpnJWg: bets $1.25
Ahsa9Yk5NPmCqQstq1EoQA: calls $1.25
jp34e617tIzV8tKIWmfAbA: raises $4.25 to $5.50
G3h3THGB1j3qdHDVHpnJWg: folds 
Ahsa9Yk5NPmCqQstq1EoQA: calls $4.25
*** TURN *** [4h 3s 5s] [Th]
jp34e617tIzV8tKIWmfAbA: bets $8
Ahsa9Yk5NPmCqQstq1EoQA: calls $7.65 and is all-in
Uncalled bet ($0.35) returned to jp34e617tIzV8tKIWmfAbA
*** RIVER *** [4h 3s 5s Th] [9c]
*** SHOW DOWN ***
jp34e617tIzV8tKIWmfAbA: shows [Kh Kc] (a pair of Kings)
Ahsa9Yk5NPmCqQstq1EoQA: mucks hand 
jp34e617tIzV8tKIWmfAbA collected $30.05 from pot
*** SUMMARY ***
Total pot $31.55 | Rake $1.50 
Board [4h 3s 5s Th 9c]
Seat 1: jp34e617tIzV8tKIWmfAbA (big blind) showed [Kh Kc] and won ($30.05) with a pair of Kings
Seat 2: G3h3THGB1j3qdHDVHpnJWg folded on the Flop
Seat 3: EeUZtMU058v2ObUACOF4Og folded before Flop (didn't bet)
Seat 4: Ahsa9Yk5NPmCqQstq1EoQA mucked
Seat 5: xrf8tAXKQHG99HixCot1Iw (button) folded before Flop (didn't bet)
Seat 6: 6DwBRH+xZ12AAZmeAg+aXw (small blind) folded before Flop




PokerStars Game #59941935772:  Hold'em No Limit ($0.10/$0.25) - 2009/07/01 1:50:52 ET
Table '63uh7ZsO7Tnt+E8b/2bu3A' 6-max Seat #5 is the button
Seat 1: 0av6tRNdi0Ui4f15L7gsVg ($37.80 in chips) 
Seat 2: SFmT9ZsVopnukjvAzrxTRg ($25 in chips) 
Seat 3: yVP7GLZBzx47OPi6jzUxMw ($3.60 in chips) 
Seat 4: rnpAao581IcvQglpkpnkoQ ($12.25 in chips) 
Seat 5: Hsvkc0/G2VV78oVmWYXecw ($5 in chips) 
Seat 6: qGHGf/553gQnDoklMRe3tg ($26.65 in chips) 
qGHGf/553gQnDoklMRe3tg: posts small blind $0.10
0av6tRNdi0Ui4f15L7gsVg: posts big blind $0.25
*** HOLE CARDS ***
SFmT9ZsVopnukjvAzrxTRg: folds 
yVP7GLZBzx47OPi6jzUxMw: folds 
rnpAao581IcvQglpkpnkoQ: calls $0.25
Hsvkc0/G2VV78oVmWYXecw: raises $1 to $1.25
qGHGf/553gQnDoklMRe3tg: folds 
0av6tRNdi0Ui4f15L7gsVg: raises $3.75 to $5
rnpAao581IcvQglpkpnkoQ: folds 
Hsvkc0/G2VV78oVmWYXecw: calls $3.75 and is all-in
*** FLOP *** [7d 2h 8d]
*** TURN *** [7d 2h 8d] [4h]
*** RIVER *** [7d 2h 8d 4h] [6c]
*** SHOW DOWN ***
0av6tRNdi0Ui4f15L7gsVg: shows [Qh Qd] (a pair of Queens)
Hsvkc0/G2VV78oVmWYXecw: shows [5h 5c] (a straight, Four to Eight)
Hsvkc0/G2VV78oVmWYXecw collected $9.85 from pot
*** SUMMARY ***
Total pot $10.35 | Rake $0.50 
Board [7d 2h 8d 4h 6c]
Seat 1: 0av6tRNdi0Ui4f15L7gsVg (big blind) showed [Qh Qd] and lost with a pair of Queens
Seat 2: SFmT9ZsVopnukjvAzrxTRg folded before Flop (didn't bet)
Seat 3: yVP7GLZBzx47OPi6jzUxMw folded before Flop (didn't bet)
Seat 4: rnpAao581IcvQglpkpnkoQ folded before Flop
Seat 5: Hsvkc0/G2VV78oVmWYXecw (button) showed [5h 5c] and won ($9.85) with a straight, Four to Eight
Seat 6: qGHGf/553gQnDoklMRe3tg (small blind) folded before Flop




PokerStars Game #59941935782:  Hold'em No Limit ($0.10/$0.25) - 2009/07/01 1:50:52 ET
Table 'mk323gviqdkOY5Aek/1EWg' 6-max Seat #6 is the button
Seat 1: 7cx44/slbeTw+Cy7QB8Trg ($24.75 in chips) 
Seat 2: GC/9yVD59DUCX7hUI7gcLw ($54.40 in chips) 
Seat 3: NuqYPwTLZYQhxOoVK3Yqlw ($27.30 in chips) 
Seat 4: +baiVgI/ETnBARLe5mARCw ($11.20 in chips) 
Seat 5: kjYRzIfvZNNflYMYRkkSVA ($36.30 in chips) 
Seat 6: KkXSr5xFjxLSD3wtAvT+WQ ($7.75 in chips) 
7cx44/slbeTw+Cy7QB8Trg: posts small blind $0.10
GC/9yVD59DUCX7hUI7gcLw: posts big blind $0.25
*** HOLE CARDS ***
NuqYPwTLZYQhxOoVK3Yqlw: raises $0.75 to $1
+baiVgI/ETnBARLe5mARCw: folds 
kjYRzIfvZNNflYMYRkkSVA: folds 
KkXSr5xFjxLSD3wtAvT+WQ: calls $1
7cx44/slbeTw+Cy7QB8Trg: folds 
GC/9yVD59DUCX7hUI7gcLw: calls $0.75
*** FLOP *** [3h Ks Ac]
GC/9yVD59DUCX7hUI7gcLw: checks 
NuqYPwTLZYQhxOoVK3Yqlw: checks 
KkXSr5xFjxLSD3wtAvT+WQ: bets $1
GC/9yVD59DUCX7hUI7gcLw: raises $2.75 to $3.75
NuqYPwTLZYQhxOoVK3Yqlw: folds 
KkXSr5xFjxLSD3wtAvT+WQ: folds 
Uncalled bet ($2.75) returned to GC/9yVD59DUCX7hUI7gcLw
GC/9yVD59DUCX7hUI7gcLw collected $4.90 from pot
*** SUMMARY ***
Total pot $5.10 | Rake $0.20 
Board [3h Ks Ac]
Seat 1: 7cx44/slbeTw+Cy7QB8Trg (small blind) folded before Flop
Seat 2: GC/9yVD59DUCX7hUI7gcLw (big blind) collected ($4.90)
Seat 3: NuqYPwTLZYQhxOoVK3Yqlw folded on the Flop
Seat 4: +baiVgI/ETnBARLe5mARCw folded before Flop (didn't bet)
Seat 5: kjYRzIfvZNNflYMYRkkSVA folded before Flop (didn't bet)
Seat 6: KkXSr5xFjxLSD3wtAvT+WQ (button) folded on the Flop




PokerStars Game #59941936292:  Hold'em No Limit ($0.10/$0.25) - 2009/07/01 1:50:53 ET
Table '2AUmC2Rslg+QUbLfdgNdfg' 6-max Seat #6 is the button
Seat 1: YDXAegrCnzc0l6TSDNboXQ ($23.95 in chips) 
Seat 2: PLksyNlTVRVZwxJVC2/1eA ($24.75 in chips) 
Seat 3: JFIAqU8lCZ0vWwEl4bdGsg ($31.20 in chips) 
Seat 4: rfeJ/I60SIiPfszMkIoNNA ($10 in chips) 
Seat 5: AMc4cCwUJhokdGRYIaVPhQ ($31.10 in chips) 
Seat 6: xBWc54v+UTSJOiKpbAbJWg ($10.45 in chips) 
YDXAegrCnzc0l6TSDNboXQ: posts small blind $0.10
PLksyNlTVRVZwxJVC2/1eA: posts big blind $0.25
rfeJ/I60SIiPfszMkIoNNA: posts big blind $0.25
*** HOLE CARDS ***
JFIAqU8lCZ0vWwEl4bdGsg: folds 
rfeJ/I60SIiPfszMkIoNNA: checks 
AMc4cCwUJhokdGRYIaVPhQ: folds 
xBWc54v+UTSJOiKpbAbJWg: raises $0.25 to $0.50
YDXAegrCnzc0l6TSDNboXQ: folds 
PLksyNlTVRVZwxJVC2/1eA: raises $1.50 to $2
rfeJ/I60SIiPfszMkIoNNA: folds 
xBWc54v+UTSJOiKpbAbJWg: calls $1.50
*** FLOP *** [As Tc 9s]
PLksyNlTVRVZwxJVC2/1eA: bets $1.50
xBWc54v+UTSJOiKpbAbJWg: calls $1.50
*** TURN *** [As Tc 9s] [Jc]
PLksyNlTVRVZwxJVC2/1eA: bets $3.50
xBWc54v+UTSJOiKpbAbJWg: calls $3.50
*** RIVER *** [As Tc 9s Jc] [7s]
PLksyNlTVRVZwxJVC2/1eA: bets $3.50
xBWc54v+UTSJOiKpbAbJWg: calls $3.45 and is all-in
Uncalled bet ($0.05) returned to PLksyNlTVRVZwxJVC2/1eA
*** SHOW DOWN ***
PLksyNlTVRVZwxJVC2/1eA: shows [Ad Ac] (three of a kind, Aces)
xBWc54v+UTSJOiKpbAbJWg: shows [8h Ah] (a straight, Seven to Jack)
xBWc54v+UTSJOiKpbAbJWg collected $20.25 from pot
*** SUMMARY ***
Total pot $21.25 | Rake $1 
Board [As Tc 9s Jc 7s]
Seat 1: YDXAegrCnzc0l6TSDNboXQ (small blind) folded before Flop
Seat 2: PLksyNlTVRVZwxJVC2/1eA (big blind) showed [Ad Ac] and lost with three of a kind, Aces
Seat 3: JFIAqU8lCZ0vWwEl4bdGsg folded before Flop (didn't bet)
Seat 4: rfeJ/I60SIiPfszMkIoNNA folded before Flop
Seat 5: AMc4cCwUJhokdGRYIaVPhQ folded before Flop (didn't bet)
Seat 6: xBWc54v+UTSJOiKpbAbJWg (button) showed [8h Ah] and won ($20.25) with a straight, Seven to Jack




PokerStars Game #59941936474:  Hold'em No Limit ($0.10/$0.25) - 2009/07/01 1:50:53 ET
Table 'edvgY2YQ1I34euq4EVqGnA' 6-max Seat #1 is the button
Seat 1: mvFHK3pE7tCxJEqLjKC70Q ($30.35 in chips) 
Seat 2: Hsvkc0/G2VV78oVmWYXecw ($5 in chips) 
Seat 3: muaYRdOUlJzdJ0zHxvRGlQ ($15 in chips) 
Seat 4: TI/C5Q+DEl4fLR3AofwYdg ($22.60 in chips) 
Seat 5: EE16Ua5b1HSsYej5zeXOlA ($57.25 in chips) 
Seat 6: kG34n23qFQA3nzdOJTQ1dA ($70.40 in chips) 
Hsvkc0/G2VV78oVmWYXecw: posts small blind $0.10
muaYRdOUlJzdJ0zHxvRGlQ: posts big blind $0.25
*** HOLE CARDS ***
TI/C5Q+DEl4fLR3AofwYdg: folds 
EE16Ua5b1HSsYej5zeXOlA: folds 
kG34n23qFQA3nzdOJTQ1dA: folds 
mvFHK3pE7tCxJEqLjKC70Q: calls $0.25
Hsvkc0/G2VV78oVmWYXecw: folds 
muaYRdOUlJzdJ0zHxvRGlQ: checks 
*** FLOP *** [3h 8c 4h]
muaYRdOUlJzdJ0zHxvRGlQ: checks 
mvFHK3pE7tCxJEqLjKC70Q: bets $0.25
muaYRdOUlJzdJ0zHxvRGlQ: folds 
Uncalled bet ($0.25) returned to mvFHK3pE7tCxJEqLjKC70Q
mvFHK3pE7tCxJEqLjKC70Q collected $0.60 from pot
mvFHK3pE7tCxJEqLjKC70Q: doesn't show hand 
*** SUMMARY ***
Total pot $0.60 | Rake $0 
Board [3h 8c 4h]
Seat 1: mvFHK3pE7tCxJEqLjKC70Q (button) collected ($0.60)
Seat 2: Hsvkc0/G2VV78oVmWYXecw (small blind) folded before Flop
Seat 3: muaYRdOUlJzdJ0zHxvRGlQ (big blind) folded on the Flop
Seat 4: TI/C5Q+DEl4fLR3AofwYdg folded before Flop (didn't bet)
Seat 5: EE16Ua5b1HSsYej5zeXOlA folded before Flop (didn't bet)
Seat 6: kG34n23qFQA3nzdOJTQ1dA folded before Flop (didn't bet)




PokerStars Game #59941936092:  Hold'em No Limit ($0.10/$0.25) - 2009/07/01 1:50:53 ET
Table 'Qr+t8WGovMECkBv+cV1lrg' 6-max Seat #3 is the button
Seat 1: EeUZtMU058v2ObUACOF4Og ($34.10 in chips) 
Seat 2: vqWjZmdQu/Hxw96/IJTWdQ ($41.60 in chips) 
Seat 3: uZKkrGByYgd4/ZBX2d4z+w ($20.75 in chips) 
Seat 4: 1NNFfYMd5Hsphl/FYz9fNA ($59.90 in chips) 
Seat 5: I50OxuNg9riRq9sywF6jMQ ($5 in chips) 
Seat 6: 9U3ZKjCsarN0DjR6mSE8Ug ($14.35 in chips) 
1NNFfYMd5Hsphl/FYz9fNA: posts small blind $0.10
I50OxuNg9riRq9sywF6jMQ: posts big blind $0.25
*** HOLE CARDS ***
9U3ZKjCsarN0DjR6mSE8Ug: folds 
EeUZtMU058v2ObUACOF4Og: raises $0.75 to $1
vqWjZmdQu/Hxw96/IJTWdQ: folds 
uZKkrGByYgd4/ZBX2d4z+w: folds 
1NNFfYMd5Hsphl/FYz9fNA: folds 
I50OxuNg9riRq9sywF6jMQ: folds 
Uncalled bet ($0.75) returned to EeUZtMU058v2ObUACOF4Og
EeUZtMU058v2ObUACOF4Og collected $0.60 from pot
EeUZtMU058v2ObUACOF4Og: doesn't show hand 
*** SUMMARY ***
Total pot $0.60 | Rake $0 
Seat 1: EeUZtMU058v2ObUACOF4Og collected ($0.60)
Seat 2: vqWjZmdQu/Hxw96/IJTWdQ folded before Flop (didn't bet)
Seat 3: uZKkrGByYgd4/ZBX2d4z+w (button) folded before Flop (didn't bet)
Seat 4: 1NNFfYMd5Hsphl/FYz9fNA (small blind) folded before Flop
Seat 5: I50OxuNg9riRq9sywF6jMQ (big blind) folded before Flop
Seat 6: 9U3ZKjCsarN0DjR6mSE8Ug folded before Flop (didn't bet)




PokerStars Game #59941936526:  Hold'em No Limit ($0.10/$0.25) - 2009/07/01 1:50:53 ET
Table 'NtEQAxCeIK2io1CGtW658g' 6-max Seat #5 is the button
Seat 1: X437kMQ7AujoaDgjguhU9w ($11.05 in chips) 
Seat 2: DgyznDqq/mLiCqQGMzc+Aw ($9.15 in chips) 
Seat 3: 5nwDw10uIM0XEyLhla0oGA ($9.95 in chips) 
Seat 4: 8296 ($16.60 in chips) 
Seat 5: Hsvkc0/G2VV78oVmWYXecw ($6.85 in chips) 
Seat 6: /gJNBeCkWL4o85/jvlZ4BA ($70.80 in chips) 
/gJNBeCkWL4o85/jvlZ4BA: posts small blind $0.10
X437kMQ7AujoaDgjguhU9w: posts big blind $0.25
*** HOLE CARDS ***
DgyznDqq/mLiCqQGMzc+Aw: raises $0.25 to $0.50
5nwDw10uIM0XEyLhla0oGA: folds 
8296: calls $0.50
Hsvkc0/G2VV78oVmWYXecw: folds 
Hsvkc0/G2VV78oVmWYXecw leaves the table
/gJNBeCkWL4o85/jvlZ4BA: folds 
X437kMQ7AujoaDgjguhU9w: folds 
*** FLOP *** [3d 8d 9d]
DgyznDqq/mLiCqQGMzc+Aw: bets $0.25
8296: raises $2 to $2.25
DgyznDqq/mLiCqQGMzc+Aw: folds 
Uncalled bet ($2) returned to 8296
8296 collected $1.80 from pot
8296: doesn't show hand 
*** SUMMARY ***
Total pot $1.85 | Rake $0.05 
Board [3d 8d 9d]
Seat 1: X437kMQ7AujoaDgjguhU9w (big blind) folded before Flop
Seat 2: DgyznDqq/mLiCqQGMzc+Aw folded on the Flop
Seat 3: 5nwDw10uIM0XEyLhla0oGA folded before Flop (didn't bet)
Seat 4: 8296 collected ($1.80)
Seat 5: Hsvkc0/G2VV78oVmWYXecw (button) folded before Flop (didn't bet)
Seat 6: /gJNBeCkWL4o85/jvlZ4BA (small blind) folded before Flop




PokerStars Game #59941936472:  Hold'em No Limit ($0.10/$0.25) - 2009/07/01 1:50:53 ET
Table 'UVjmXTtsmlX1HxwwZ59akg' 9-max Seat #5 is the button
Seat 1: zDrucyjVn5aeekNEc3cJrA ($48.35 in chips) 
Seat 2: q+Qdg0Hoir+SyL7haBrUnw ($7.80 in chips) 
Seat 3: GmzfAfxcxu1kGbPC+9LkVg ($27.80 in chips) 
Seat 5: Bb42QRQMhg5/Y0vHP8/2Xw ($39.45 in chips) 
Seat 6: st9jtdNbm1W5GfBwRaCVqQ ($23.85 in chips) 
Seat 7: d7YasxuGLPiL7pj8IcGThw ($4.75 in chips) 
Seat 9: ljemhp25Zg+nlA9DLCIiUw ($25.25 in chips) 
st9jtdNbm1W5GfBwRaCVqQ: posts small blind $0.10
d7YasxuGLPiL7pj8IcGThw: posts big blind $0.25
18G4P1XstjNvItdGUITxgw: sits out 
*** HOLE CARDS ***
ljemhp25Zg+nlA9DLCIiUw: folds 
zDrucyjVn5aeekNEc3cJrA: folds 
q+Qdg0Hoir+SyL7haBrUnw: folds 
GmzfAfxcxu1kGbPC+9LkVg: folds 
Bb42QRQMhg5/Y0vHP8/2Xw: folds 
st9jtdNbm1W5GfBwRaCVqQ: raises $0.75 to $1
d7YasxuGLPiL7pj8IcGThw: folds 
Uncalled bet ($0.75) returned to st9jtdNbm1W5GfBwRaCVqQ
st9jtdNbm1W5GfBwRaCVqQ collected $0.50 from pot
st9jtdNbm1W5GfBwRaCVqQ: doesn't show hand 
aqxuKnMZWHy08QjWq1+MrQ has returned
*** SUMMARY ***
Total pot $0.50 | Rake $0 
Seat 1: zDrucyjVn5aeekNEc3cJrA folded before Flop (didn't bet)
Seat 2: q+Qdg0Hoir+SyL7haBrUnw folded before Flop (didn't bet)
Seat 3: GmzfAfxcxu1kGbPC+9LkVg folded before Flop (didn't bet)
Seat 5: Bb42QRQMhg5/Y0vHP8/2Xw (button) folded before Flop (didn't bet)
Seat 6: st9jtdNbm1W5GfBwRaCVqQ (small blind) collected ($0.50)
Seat 7: d7YasxuGLPiL7pj8IcGThw (big blind) folded before Flop
Seat 9: ljemhp25Zg+nlA9DLCIiUw folded before Flop (didn't bet)




PokerStars Game #59941936524:  Hold'em No Limit ($0.10/$0.25) - 2009/07/01 1:50:53 ET
Table 'djcjiEGabFQO0MNG6jEeJQ' 9-max Seat #2 is the button
Seat 1: Bb42QRQMhg5/Y0vHP8/2Xw ($25 in chips) 
Seat 2: WKL8nUFr7TumC4EjLyqYzw ($3.50 in chips) 
Seat 4: 2wcFsZsqEP5w1StUTVzJCg ($9.30 in chips) 
Seat 5: 9QQ67diwg/DShNDBou2R8Q ($24.75 in chips) 
Seat 6: aNpwfA31EREwO+ar4XzBCw ($78.50 in chips) 
Seat 7: 5pDhXQ+RVy0BGcwfJAJfbg ($26.60 in chips) 
Seat 8: +sbyWwIcFp9kP0bDtMegfQ ($46.25 in chips) 
Seat 9: HPEB+AtKw1+C/cxU0o1ciw ($46.50 in chips) 
8iNkA1BFZ6OivRPGlQz3HQ will be allowed to play after the button
2wcFsZsqEP5w1StUTVzJCg: posts small blind $0.10
9QQ67diwg/DShNDBou2R8Q: posts big blind $0.25
*** HOLE CARDS ***
aNpwfA31EREwO+ar4XzBCw: folds 
5pDhXQ+RVy0BGcwfJAJfbg: folds 
+sbyWwIcFp9kP0bDtMegfQ: folds 
HPEB+AtKw1+C/cxU0o1ciw: folds 
Bb42QRQMhg5/Y0vHP8/2Xw: folds 
WKL8nUFr7TumC4EjLyqYzw: raises $3.25 to $3.50 and is all-in
2wcFsZsqEP5w1StUTVzJCg: folds 
9QQ67diwg/DShNDBou2R8Q is connected 
9QQ67diwg/DShNDBou2R8Q: folds 
Uncalled bet ($3.25) returned to WKL8nUFr7TumC4EjLyqYzw
WKL8nUFr7TumC4EjLyqYzw collected $0.60 from pot
WKL8nUFr7TumC4EjLyqYzw: doesn't show hand 
*** SUMMARY ***
Total pot $0.60 | Rake $0 
Seat 1: Bb42QRQMhg5/Y0vHP8/2Xw folded before Flop (didn't bet)
Seat 2: WKL8nUFr7TumC4EjLyqYzw (button) collected ($0.60)
Seat 4: 2wcFsZsqEP5w1StUTVzJCg (small blind) folded before Flop
Seat 5: 9QQ67diwg/DShNDBou2R8Q (big blind) folded before Flop
Seat 6: aNpwfA31EREwO+ar4XzBCw folded before Flop (didn't bet)
Seat 7: 5pDhXQ+RVy0BGcwfJAJfbg folded before Flop (didn't bet)
Seat 8: +sbyWwIcFp9kP0bDtMegfQ folded before Flop (didn't bet)
Seat 9: HPEB+AtKw1+C/cxU0o1ciw folded before Flop (didn't bet)




PokerStars Game #59941936592:  Hold'em No Limit ($0.10/$0.25) - 2009/07/01 1:50:53 ET
Table 'SbSV5tlgLp0+/Z+13PW3Hg' 9-max Seat #6 is the button
Seat 1: x+W5+3qsdY4Iszf0hoH+Aw ($18.55 in chips) 
Seat 2: zDrucyjVn5aeekNEc3cJrA ($14.40 in chips) 
Seat 3: CT7Xj/V/O5rBlhtt+RZeFQ ($25.60 in chips) 
Seat 4: puj3K/wrNjEj86ZL/MyfLA ($9 in chips) 
Seat 6: pN3IHvAKm2fz+sTRARTcrg ($25.05 in chips) 
Seat 7: 3PmVnC/15cl4oyI1TKIt4g ($4.75 in chips) 
Seat 8: qBdqLaJhO+1itcMk70bsfA ($8.35 in chips) 
Seat 9: X78b5v/uhqeXXoAijbw/yg ($25 in chips) 
aNpwfA31EREwO+ar4XzBCw leaves the table
3PmVnC/15cl4oyI1TKIt4g: posts small blind $0.10
qBdqLaJhO+1itcMk70bsfA: posts big blind $0.25
*** HOLE CARDS ***
X78b5v/uhqeXXoAijbw/yg: folds 
x+W5+3qsdY4Iszf0hoH+Aw: folds 
zDrucyjVn5aeekNEc3cJrA: raises $0.75 to $1
CT7Xj/V/O5rBlhtt+RZeFQ: folds 
puj3K/wrNjEj86ZL/MyfLA: folds 
pN3IHvAKm2fz+sTRARTcrg: calls $1
3PmVnC/15cl4oyI1TKIt4g: folds 
clJsV3v77RS07bDKY+705w joins the table at seat #5 
qBdqLaJhO+1itcMk70bsfA: raises $7.35 to $8.35 and is all-in
zDrucyjVn5aeekNEc3cJrA: folds 
pN3IHvAKm2fz+sTRARTcrg: folds 
Uncalled bet ($7.35) returned to qBdqLaJhO+1itcMk70bsfA
qBdqLaJhO+1itcMk70bsfA collected $3.10 from pot
*** SUMMARY ***
Total pot $3.10 | Rake $0 
Seat 1: x+W5+3qsdY4Iszf0hoH+Aw folded before Flop (didn't bet)
Seat 2: zDrucyjVn5aeekNEc3cJrA folded before Flop
Seat 3: CT7Xj/V/O5rBlhtt+RZeFQ folded before Flop (didn't bet)
Seat 4: puj3K/wrNjEj86ZL/MyfLA folded before Flop (didn't bet)
Seat 6: pN3IHvAKm2fz+sTRARTcrg (button) folded before Flop
Seat 7: 3PmVnC/15cl4oyI1TKIt4g (small blind) folded before Flop
Seat 8: qBdqLaJhO+1itcMk70bsfA (big blind) collected ($3.10)
Seat 9: X78b5v/uhqeXXoAijbw/yg folded before Flop (didn't bet)




PokerStars Game #59941936590:  Hold'em No Limit ($0.10/$0.25) - 2009/07/01 1:50:53 ET
Table '3760QYRYyCWeXf0rLZ5S2g' 9-max Seat #2 is the button
Seat 1: CT7Xj/V/O5rBlhtt+RZeFQ ($27.55 in chips) 
Seat 2: zDrucyjVn5aeekNEc3cJrA ($26.95 in chips) 
Seat 4: ziFpkH3wCzqB/qXeq/Hy7g ($25 in chips) 
Seat 5: Bb42QRQMhg5/Y0vHP8/2Xw ($29.40 in chips) 
Seat 6: q+Qdg0Hoir+SyL7haBrUnw ($13.60 in chips) 
Seat 7: 6C2DoQ+GZHBOpb+qyrSnqA ($6.10 in chips) 
Seat 8: clJsV3v77RS07bDKY+705w ($5.25 in chips) 
Seat 9: BCwIzs00xY6DtWGghTGEwg ($14.75 in chips) 
4qA/3Ajg3pP6fqW+IX9/fQ will be allowed to play after the button
ziFpkH3wCzqB/qXeq/Hy7g: posts small blind $0.10
Bb42QRQMhg5/Y0vHP8/2Xw: posts big blind $0.25
*** HOLE CARDS ***
q+Qdg0Hoir+SyL7haBrUnw: folds 
6C2DoQ+GZHBOpb+qyrSnqA: folds 
clJsV3v77RS07bDKY+705w: folds 
BCwIzs00xY6DtWGghTGEwg: folds 
CT7Xj/V/O5rBlhtt+RZeFQ: folds 
zDrucyjVn5aeekNEc3cJrA: folds 
ziFpkH3wCzqB/qXeq/Hy7g: calls $0.15
Bb42QRQMhg5/Y0vHP8/2Xw: raises $1 to $1.25
ziFpkH3wCzqB/qXeq/Hy7g: folds 
Uncalled bet ($1) returned to Bb42QRQMhg5/Y0vHP8/2Xw
Bb42QRQMhg5/Y0vHP8/2Xw collected $0.50 from pot
*** SUMMARY ***
Total pot $0.50 | Rake $0 
Seat 1: CT7Xj/V/O5rBlhtt+RZeFQ folded before Flop (didn't bet)
Seat 2: zDrucyjVn5aeekNEc3cJrA (button) folded before Flop (didn't bet)
Seat 4: ziFpkH3wCzqB/qXeq/Hy7g (small blind) folded before Flop
Seat 5: Bb42QRQMhg5/Y0vHP8/2Xw (big blind) collected ($0.50)
Seat 6: q+Qdg0Hoir+SyL7haBrUnw folded before Flop (didn't bet)
Seat 7: 6C2DoQ+GZHBOpb+qyrSnqA folded before Flop (didn't bet)
Seat 8: clJsV3v77RS07bDKY+705w folded before Flop (didn't bet)
Seat 9: BCwIzs00xY6DtWGghTGEwg folded before Flop (didn't bet)




PokerStars Game #59941936158:  Hold'em No Limit ($0.10/$0.25) - 2009/07/01 1:50:53 ET
Table 'hOE09W281uSob0XeJmUcRg' 6-max Seat #2 is the button
Seat 1: mfrkWA3PTeYPkbO6hi98Aw ($26.60 in chips) 
Seat 2: lRKJ8o/CnOPFwfHHm6ioMw ($11.80 in chips) 
Seat 3: y+a/yGW/Jy4bPJFnaeTz5w ($12.20 in chips) 
Seat 5: JFIAqU8lCZ0vWwEl4bdGsg ($26.55 in chips) 
Seat 6: x4ZJ8E/TUrtoB7WiHcv8WA ($18.05 in chips) 
y+a/yGW/Jy4bPJFnaeTz5w: posts small blind $0.10
JFIAqU8lCZ0vWwEl4bdGsg: posts big blind $0.25
*** HOLE CARDS ***
x4ZJ8E/TUrtoB7WiHcv8WA: folds 
mfrkWA3PTeYPkbO6hi98Aw: raises $0.75 to $1
lRKJ8o/CnOPFwfHHm6ioMw: folds 
y+a/yGW/Jy4bPJFnaeTz5w: folds 
JFIAqU8lCZ0vWwEl4bdGsg: calls $0.75
*** FLOP *** [5c Js 2c]
JFIAqU8lCZ0vWwEl4bdGsg: checks 
mfrkWA3PTeYPkbO6hi98Aw: bets $1.50
JFIAqU8lCZ0vWwEl4bdGsg: folds 
Uncalled bet ($1.50) returned to mfrkWA3PTeYPkbO6hi98Aw
mfrkWA3PTeYPkbO6hi98Aw collected $2 from pot
mfrkWA3PTeYPkbO6hi98Aw: doesn't show hand 
*** SUMMARY ***
Total pot $2.10 | Rake $0.10 
Board [5c Js 2c]
Seat 1: mfrkWA3PTeYPkbO6hi98Aw collected ($2)
Seat 2: lRKJ8o/CnOPFwfHHm6ioMw (button) folded before Flop (didn't bet)
Seat 3: y+a/yGW/Jy4bPJFnaeTz5w (small blind) folded before Flop
Seat 5: JFIAqU8lCZ0vWwEl4bdGsg (big blind) folded on the Flop
Seat 6: x4ZJ8E/TUrtoB7WiHcv8WA folded before Flop (didn't bet)




PokerStars Game #59941936822:  Hold'em No Limit ($0.10/$0.25) - 2009/07/01 1:50:54 ET
Table '/Xx5AsbRD4oNGMTFFC/92Q' 6-max Seat #2 is the button
Seat 2: N/zeVku/lNn+kUQejwmLpg ($8 in chips) 
Seat 4: 7/ROHX4tuLekJ2diYIlMkw ($5 in chips) 
N/zeVku/lNn+kUQejwmLpg: posts small blind $0.10
7/ROHX4tuLekJ2diYIlMkw: posts big blind $0.25
*** HOLE CARDS ***
N/zeVku/lNn+kUQejwmLpg: raises $0.50 to $0.75
7/ROHX4tuLekJ2diYIlMkw: calls $0.50
*** FLOP *** [3d 2d 6d]
7/ROHX4tuLekJ2diYIlMkw: bets $0.25
N/zeVku/lNn+kUQejwmLpg: calls $0.25
*** TURN *** [3d 2d 6d] [7h]
7/ROHX4tuLekJ2diYIlMkw: bets $0.75
LAPERTUR joins the table at seat #3 
N/zeVku/lNn+kUQejwmLpg: calls $0.75
*** RIVER *** [3d 2d 6d 7h] [4s]
p4A+KsSkRO/5I6h0o4VQDQ joins the table at seat #6 
7/ROHX4tuLekJ2diYIlMkw: bets $0.75
N/zeVku/lNn+kUQejwmLpg: calls $0.75
*** SHOW DOWN ***
7/ROHX4tuLekJ2diYIlMkw: shows [7c 9s] (a pair of Sevens)
N/zeVku/lNn+kUQejwmLpg: mucks hand 
7/ROHX4tuLekJ2diYIlMkw collected $4.80 from pot
*** SUMMARY ***
Total pot $5 | Rake $0.20 
Board [3d 2d 6d 7h 4s]
Seat 2: N/zeVku/lNn+kUQejwmLpg (button) (small blind) mucked
Seat 4: 7/ROHX4tuLekJ2diYIlMkw (big blind) showed [7c 9s] and won ($4.80) with a pair of Sevens




PokerStars Game #59941936902:  Hold'em No Limit ($0.10/$0.25) - 2009/07/01 1:50:54 ET
Table 'IrJPyZ3JW2iIa+krdoSbJQ' 9-max Seat #2 is the button
Seat 1: Bb42QRQMhg5/Y0vHP8/2Xw ($25.90 in chips) 
Seat 2: X78b5v/uhqeXXoAijbw/yg ($42.60 in chips) 
Seat 3: CT7Xj/V/O5rBlhtt+RZeFQ ($25.35 in chips) 
Seat 4: bXpVeaSTPBFSPJmeXxO7nw ($4.65 in chips) 
Seat 5: tLcDklc2rBORNfixyRfVfw ($30.65 in chips) 
Seat 6: +sbyWwIcFp9kP0bDtMegfQ ($24.60 in chips) 
Seat 7: ozqb9Z1ZOsDwxxq9IKmjUA ($9.50 in chips) 
Seat 8: zZqOSFjPK4R4cwx0dONetw ($15 in chips) 
Seat 9: Mh2r9hTeTEDnh19sRZtW3g ($9.55 in chips) 
CT7Xj/V/O5rBlhtt+RZeFQ: posts small blind $0.10
bXpVeaSTPBFSPJmeXxO7nw: posts big blind $0.25
*** HOLE CARDS ***
tLcDklc2rBORNfixyRfVfw: folds 
+sbyWwIcFp9kP0bDtMegfQ: folds 
ozqb9Z1ZOsDwxxq9IKmjUA: folds 
zZqOSFjPK4R4cwx0dONetw: raises $0.50 to $0.75
Mh2r9hTeTEDnh19sRZtW3g: folds 
Bb42QRQMhg5/Y0vHP8/2Xw: folds 
X78b5v/uhqeXXoAijbw/yg: folds 
CT7Xj/V/O5rBlhtt+RZeFQ: raises $1 to $1.75
bXpVeaSTPBFSPJmeXxO7nw: folds 
zZqOSFjPK4R4cwx0dONetw: calls $1
*** FLOP *** [9d Ks 3s]
CT7Xj/V/O5rBlhtt+RZeFQ: bets $1.75
zZqOSFjPK4R4cwx0dONetw: raises $1.75 to $3.50
CT7Xj/V/O5rBlhtt+RZeFQ: calls $1.75
*** TURN *** [9d Ks 3s] [9h]
CT7Xj/V/O5rBlhtt+RZeFQ: checks 
zZqOSFjPK4R4cwx0dONetw: checks 
*** RIVER *** [9d Ks 3s 9h] [Ah]
CT7Xj/V/O5rBlhtt+RZeFQ: bets $10
zZqOSFjPK4R4cwx0dONetw: calls $9.75 and is all-in
Uncalled bet ($0.25) returned to CT7Xj/V/O5rBlhtt+RZeFQ
*** SHOW DOWN ***
CT7Xj/V/O5rBlhtt+RZeFQ: shows [As Kd] (two pair, Aces and Kings)
zZqOSFjPK4R4cwx0dONetw: mucks hand 
CT7Xj/V/O5rBlhtt+RZeFQ collected $28.80 from pot
*** SUMMARY ***
Total pot $30.25 | Rake $1.45 
Board [9d Ks 3s 9h Ah]
Seat 1: Bb42QRQMhg5/Y0vHP8/2Xw folded before Flop (didn't bet)
Seat 2: X78b5v/uhqeXXoAijbw/yg (button) folded before Flop (didn't bet)
Seat 3: CT7Xj/V/O5rBlhtt+RZeFQ (small blind) showed [As Kd] and won ($28.80) with two pair, Aces and Kings
Seat 4: bXpVeaSTPBFSPJmeXxO7nw (big blind) folded before Flop
Seat 5: tLcDklc2rBORNfixyRfVfw folded before Flop (didn't bet)
Seat 6: +sbyWwIcFp9kP0bDtMegfQ folded before Flop (didn't bet)
Seat 7: ozqb9Z1ZOsDwxxq9IKmjUA folded before Flop (didn't bet)
Seat 8: zZqOSFjPK4R4cwx0dONetw mucked
Seat 9: Mh2r9hTeTEDnh19sRZtW3g folded before Flop (didn't bet)




PokerStars Game #59941936790:  Hold'em No Limit ($0.10/$0.25) - 2009/07/01 1:50:54 ET
Table '6aL2C8IFwHHr6SG6RgXaow' 9-max Seat #4 is the button
Seat 1: FcL757vvzKRPFZ6h7YsPHA ($9.95 in chips) 
Seat 2: UmzixCpC0bAc1lDEjgB3NQ ($13.60 in chips) 
Seat 3: clJsV3v77RS07bDKY+705w ($5 in chips) 
Seat 4: BT6Oal0iO4P6kDuT7HFQDw ($19.15 in chips) 
Seat 5: wre31HfyzQGpIvID1istxw ($23.15 in chips) 
Seat 6: gehe91e0IyVT0QU/XBkEyg ($26.50 in chips) 
Seat 7: E0iYnEVO2ho7dH3QcCjw7g ($19.75 in chips) 
Seat 8: rQhYIYXSyH/IivYM1dlV5A ($21.95 in chips) 
Seat 9: CgIo2ItZqi4o3ayVG6HanQ ($23.50 in chips) 
wre31HfyzQGpIvID1istxw: posts small blind $0.10
gehe91e0IyVT0QU/XBkEyg: posts big blind $0.25
*** HOLE CARDS ***
E0iYnEVO2ho7dH3QcCjw7g: folds 
rQhYIYXSyH/IivYM1dlV5A: folds 
CgIo2ItZqi4o3ayVG6HanQ: folds 
FcL757vvzKRPFZ6h7YsPHA: raises $0.50 to $0.75
UmzixCpC0bAc1lDEjgB3NQ: folds 
clJsV3v77RS07bDKY+705w: folds 
BT6Oal0iO4P6kDuT7HFQDw: folds 
wre31HfyzQGpIvID1istxw: folds 
gehe91e0IyVT0QU/XBkEyg: folds 
Uncalled bet ($0.50) returned to FcL757vvzKRPFZ6h7YsPHA
FcL757vvzKRPFZ6h7YsPHA collected $0.60 from pot
FcL757vvzKRPFZ6h7YsPHA: doesn't show hand 
*** SUMMARY ***
Total pot $0.60 | Rake $0 
Seat 1: FcL757vvzKRPFZ6h7YsPHA collected ($0.60)
Seat 2: UmzixCpC0bAc1lDEjgB3NQ folded before Flop (didn't bet)
Seat 3: clJsV3v77RS07bDKY+705w folded before Flop (didn't bet)
Seat 4: BT6Oal0iO4P6kDuT7HFQDw (button) folded before Flop (didn't bet)
Seat 5: wre31HfyzQGpIvID1istxw (small blind) folded before Flop
Seat 6: gehe91e0IyVT0QU/XBkEyg (big blind) folded before Flop
Seat 7: E0iYnEVO2ho7dH3QcCjw7g folded before Flop (didn't bet)
Seat 8: rQhYIYXSyH/IivYM1dlV5A folded before Flop (didn't bet)
Seat 9: CgIo2ItZqi4o3ayVG6HanQ folded before Flop (didn't bet)




PokerStars Game #59941936922:  Hold'em No Limit ($0.10/$0.25) - 2009/07/01 1:50:54 ET
Table 'L5GvbdQO5aCZJSE6pyQ8OA' 6-max Seat #3 is the button
Seat 1: eFj4lr1nuXLyCWNTShr1bg ($11.45 in chips) 
Seat 2: DihMHaz4WNETH1bPDe13kA ($30.55 in chips) 
Seat 3: JFIAqU8lCZ0vWwEl4bdGsg ($25 in chips) 
Seat 4: trN/oHqTTbPw5MNuKrOpLw ($27.25 in chips) 
Seat 5: LyDHtw3/yniNHW+DvLXbog ($29.25 in chips) 
Seat 6: v+QfkGiuj9bgtuNoVnDO8w ($38.70 in chips) 
trN/oHqTTbPw5MNuKrOpLw: posts small blind $0.10
LyDHtw3/yniNHW+DvLXbog: posts big blind $0.25
*** HOLE CARDS ***
v+QfkGiuj9bgtuNoVnDO8w: folds 
eFj4lr1nuXLyCWNTShr1bg: folds 
DihMHaz4WNETH1bPDe13kA: folds 
JFIAqU8lCZ0vWwEl4bdGsg: raises $0.60 to $0.85
trN/oHqTTbPw5MNuKrOpLw: folds 
LyDHtw3/yniNHW+DvLXbog: folds 
Uncalled bet ($0.60) returned to JFIAqU8lCZ0vWwEl4bdGsg
JFIAqU8lCZ0vWwEl4bdGsg collected $0.60 from pot
JFIAqU8lCZ0vWwEl4bdGsg: doesn't show hand 
*** SUMMARY ***
Total pot $0.60 | Rake $0 
Seat 1: eFj4lr1nuXLyCWNTShr1bg folded before Flop (didn't bet)
Seat 2: DihMHaz4WNETH1bPDe13kA folded before Flop (didn't bet)
Seat 3: JFIAqU8lCZ0vWwEl4bdGsg (button) collected ($0.60)
Seat 4: trN/oHqTTbPw5MNuKrOpLw (small blind) folded before Flop
Seat 5: LyDHtw3/yniNHW+DvLXbog (big blind) folded before Flop
Seat 6: v+QfkGiuj9bgtuNoVnDO8w folded before Flop (didn't bet)




PokerStars Game #59941937100:  Hold'em No Limit ($0.10/$0.25) - 2009/07/01 1:50:54 ET
Table 'rjcb+nlE+0GuJ6lBhuCkkA' 6-max Seat #4 is the button
Seat 1: lBoEwOFgzcERLIRUkUoRTw ($12.90 in chips) 
Seat 2: lJphax9e7/+O/3YCKPJ0yQ ($6.80 in chips) 
Seat 3: 8ClCHtFXGNplITm+63KB+Q ($65.85 in chips) 
Seat 4: BV+K0Phf5VBHr7aZPKqbUQ ($35.15 in chips) 
Seat 5: GC/9yVD59DUCX7hUI7gcLw ($30.25 in chips) 
Seat 6: 32YL2ZEp8NT4JB2RVM9euQ ($16.05 in chips) 
GC/9yVD59DUCX7hUI7gcLw: posts small blind $0.10
32YL2ZEp8NT4JB2RVM9euQ: posts big blind $0.25
*** HOLE CARDS ***
lBoEwOFgzcERLIRUkUoRTw: folds 
lJphax9e7/+O/3YCKPJ0yQ: folds 
8ClCHtFXGNplITm+63KB+Q: folds 
BV+K0Phf5VBHr7aZPKqbUQ: raises $0.50 to $0.75
GC/9yVD59DUCX7hUI7gcLw: folds 
32YL2ZEp8NT4JB2RVM9euQ: folds 
Uncalled bet ($0.50) returned to BV+K0Phf5VBHr7aZPKqbUQ
BV+K0Phf5VBHr7aZPKqbUQ collected $0.60 from pot
BV+K0Phf5VBHr7aZPKqbUQ: doesn't show hand 
*** SUMMARY ***
Total pot $0.60 | Rake $0 
Seat 1: lBoEwOFgzcERLIRUkUoRTw folded before Flop (didn't bet)
Seat 2: lJphax9e7/+O/3YCKPJ0yQ folded before Flop (didn't bet)
Seat 3: 8ClCHtFXGNplITm+63KB+Q folded before Flop (didn't bet)
Seat 4: BV+K0Phf5VBHr7aZPKqbUQ (button) collected ($0.60)
Seat 5: GC/9yVD59DUCX7hUI7gcLw (small blind) folded before Flop
Seat 6: 32YL2ZEp8NT4JB2RVM9euQ (big blind) folded before Flop




PokerStars Game #59941936632:  Hold'em No Limit ($0.10/$0.25) - 2009/07/01 1:50:54 ET
Table 'nIRjSqm6RYUWJlyW2loYKA' 6-max Seat #5 is the button
Seat 1: w43JQj2oYPpKQVG4Yzlq1w ($25 in chips) 
Seat 2: NndRCAk4vU5JGDhTyy5LZg ($13.45 in chips) 
Seat 3: qjs7u/BI35gu5OgtqfLCZw ($16.20 in chips) 
Seat 4: /ZSSWvl8im2y38j1uEUAGA ($4.50 in chips) 
Seat 5: df01R5ThvHspD8FgKmaDvQ ($24.40 in chips) 
Seat 6: OIjOiBfQstWrK/RuXx7zcw ($6.95 in chips) 
OIjOiBfQstWrK/RuXx7zcw: posts small blind $0.10
w43JQj2oYPpKQVG4Yzlq1w: posts big blind $0.25
*** HOLE CARDS ***
NndRCAk4vU5JGDhTyy5LZg: calls $0.25
qjs7u/BI35gu5OgtqfLCZw: folds 
/ZSSWvl8im2y38j1uEUAGA: folds 
df01R5ThvHspD8FgKmaDvQ: folds 
OIjOiBfQstWrK/RuXx7zcw: calls $0.15
w43JQj2oYPpKQVG4Yzlq1w: checks 
*** FLOP *** [Ts Kc 6s]
OIjOiBfQstWrK/RuXx7zcw: checks 
w43JQj2oYPpKQVG4Yzlq1w: checks 
NndRCAk4vU5JGDhTyy5LZg: bets $0.75
OIjOiBfQstWrK/RuXx7zcw: folds 
w43JQj2oYPpKQVG4Yzlq1w: folds 
Uncalled bet ($0.75) returned to NndRCAk4vU5JGDhTyy5LZg
NndRCAk4vU5JGDhTyy5LZg collected $0.75 from pot
*** SUMMARY ***
Total pot $0.75 | Rake $0 
Board [Ts Kc 6s]
Seat 1: w43JQj2oYPpKQVG4Yzlq1w (big blind) folded on the Flop
Seat 2: NndRCAk4vU5JGDhTyy5LZg collected ($0.75)
Seat 3: qjs7u/BI35gu5OgtqfLCZw folded before Flop (didn't bet)
Seat 4: /ZSSWvl8im2y38j1uEUAGA folded before Flop (didn't bet)
Seat 5: df01R5ThvHspD8FgKmaDvQ (button) folded before Flop (didn't bet)
Seat 6: OIjOiBfQstWrK/RuXx7zcw (small blind) folded on the Flop




PokerStars Game #59941937618:  Hold'em No Limit ($0.10/$0.25) - 2009/07/01 1:50:55 ET
Table 'nyTW9cVtYentc5V7xU/0jA' 6-max Seat #6 is the button
Seat 1: HI20pVxSHPZ29u9IDkmICg ($6.90 in chips) 
Seat 2: opbAKk7WcZH8kDKUux3/0g ($5 in chips) 
Seat 3: kG34n23qFQA3nzdOJTQ1dA ($35.50 in chips) 
Seat 4: NkB3D4eVHHXvB9Edaugc1Q ($35.90 in chips) 
Seat 5: zZAcuQ0EvirdEuiIbeaocQ ($6.85 in chips) 
Seat 6: Cwf8Ho8JHNvwzsv9ah8uRQ ($18.40 in chips) 
HI20pVxSHPZ29u9IDkmICg: posts small blind $0.10
opbAKk7WcZH8kDKUux3/0g: posts big blind $0.25
*** HOLE CARDS ***
kG34n23qFQA3nzdOJTQ1dA: folds 
NkB3D4eVHHXvB9Edaugc1Q: calls $0.25
zZAcuQ0EvirdEuiIbeaocQ: calls $0.25
Cwf8Ho8JHNvwzsv9ah8uRQ: folds 
HI20pVxSHPZ29u9IDkmICg: folds 
opbAKk7WcZH8kDKUux3/0g: checks 
*** FLOP *** [8h 9h Qh]
opbAKk7WcZH8kDKUux3/0g: checks 
NkB3D4eVHHXvB9Edaugc1Q: checks 
zZAcuQ0EvirdEuiIbeaocQ: checks 
*** TURN *** [8h 9h Qh] [Qd]
opbAKk7WcZH8kDKUux3/0g: checks 
NkB3D4eVHHXvB9Edaugc1Q: checks 
zZAcuQ0EvirdEuiIbeaocQ: bets $0.50
opbAKk7WcZH8kDKUux3/0g: folds 
NkB3D4eVHHXvB9Edaugc1Q: raises $2.75 to $3.25
zZAcuQ0EvirdEuiIbeaocQ: folds 
Uncalled bet ($2.75) returned to NkB3D4eVHHXvB9Edaugc1Q
NkB3D4eVHHXvB9Edaugc1Q collected $1.80 from pot
NkB3D4eVHHXvB9Edaugc1Q: doesn't show hand 
*** SUMMARY ***
Total pot $1.85 | Rake $0.05 
Board [8h 9h Qh Qd]
Seat 1: HI20pVxSHPZ29u9IDkmICg (small blind) folded before Flop
Seat 2: opbAKk7WcZH8kDKUux3/0g (big blind) folded on the Turn
Seat 3: kG34n23qFQA3nzdOJTQ1dA folded before Flop (didn't bet)
Seat 4: NkB3D4eVHHXvB9Edaugc1Q collected ($1.80)
Seat 5: zZAcuQ0EvirdEuiIbeaocQ folded on the Turn
Seat 6: Cwf8Ho8JHNvwzsv9ah8uRQ (button) folded before Flop (didn't bet)




PokerStars Game #59941937536:  Hold'em No Limit ($0.10/$0.25) - 2009/07/01 1:50:55 ET
Table 'Xi38lWH8L2JHRAsKYVX8Qg' 6-max Seat #4 is the button
Seat 1: shP7DFAtX7gXcgMJX/OmRQ ($24.65 in chips) 
Seat 2: VOmI0x4dDPnTESZd5B4d1Q ($8.40 in chips) 
Seat 3: 6DwBRH+xZ12AAZmeAg+aXw ($31.20 in chips) 
Seat 4: kG34n23qFQA3nzdOJTQ1dA ($24.05 in chips) 
Seat 5: 79ID/ub1Pt/mDpCprVmOoA ($76.25 in chips) 
Seat 6: kyRaCIljYA6l33lSKQfNsg ($30.10 in chips) 
79ID/ub1Pt/mDpCprVmOoA: posts small blind $0.10
kyRaCIljYA6l33lSKQfNsg: posts big blind $0.25
*** HOLE CARDS ***
shP7DFAtX7gXcgMJX/OmRQ: folds 
VOmI0x4dDPnTESZd5B4d1Q: folds 
6DwBRH+xZ12AAZmeAg+aXw: folds 
kG34n23qFQA3nzdOJTQ1dA: folds 
79ID/ub1Pt/mDpCprVmOoA: folds 
Uncalled bet ($0.15) returned to kyRaCIljYA6l33lSKQfNsg
kyRaCIljYA6l33lSKQfNsg collected $0.20 from pot
*** SUMMARY ***
Total pot $0.20 | Rake $0 
Seat 1: shP7DFAtX7gXcgMJX/OmRQ folded before Flop (didn't bet)
Seat 2: VOmI0x4dDPnTESZd5B4d1Q folded before Flop (didn't bet)
Seat 3: 6DwBRH+xZ12AAZmeAg+aXw folded before Flop (didn't bet)
Seat 4: kG34n23qFQA3nzdOJTQ1dA (button) folded before Flop (didn't bet)
Seat 5: 79ID/ub1Pt/mDpCprVmOoA (small blind) folded before Flop
Seat 6: kyRaCIljYA6l33lSKQfNsg (big blind) collected ($0.20)




PokerStars Game #59941937650:  Hold'em No Limit ($0.10/$0.25) - 2009/07/01 1:50:55 ET
Table 'z2yOdY2zyGWG1gh9WV9XtQ' 9-max Seat #7 is the button
Seat 1: 8iyfEWL3auLDt9HEV3U5Vg ($25.35 in chips) 
Seat 2: /OxeiWKPcgcer/U4z8Kqxw ($14.75 in chips) 
Seat 3: X78b5v/uhqeXXoAijbw/yg ($26.90 in chips) 
Seat 4: Bb42QRQMhg5/Y0vHP8/2Xw ($25 in chips) 
Seat 6: NBYmTySMtIicyMj5Vjzqhw ($31.40 in chips) 
Seat 7: zDrucyjVn5aeekNEc3cJrA ($22.60 in chips) 
Seat 9: wGigCmBR/9XWkPpvYos3aQ ($34.65 in chips) 
wGigCmBR/9XWkPpvYos3aQ: posts small blind $0.10
8iyfEWL3auLDt9HEV3U5Vg: posts big blind $0.25
4qA/3Ajg3pP6fqW+IX9/fQ: sits out 
*** HOLE CARDS ***
/OxeiWKPcgcer/U4z8Kqxw: folds 
X78b5v/uhqeXXoAijbw/yg: folds 
Bb42QRQMhg5/Y0vHP8/2Xw: folds 
NBYmTySMtIicyMj5Vjzqhw: calls $0.25
zDrucyjVn5aeekNEc3cJrA: folds 
wGigCmBR/9XWkPpvYos3aQ: folds 
8iyfEWL3auLDt9HEV3U5Vg: checks 
*** FLOP *** [9d 8c 6d]
8iyfEWL3auLDt9HEV3U5Vg: bets $0.50
NBYmTySMtIicyMj5Vjzqhw: calls $0.50
*** TURN *** [9d 8c 6d] [Td]
8iyfEWL3auLDt9HEV3U5Vg: bets $0.50
NBYmTySMtIicyMj5Vjzqhw: calls $0.50
*** RIVER *** [9d 8c 6d Td] [Kh]
8iyfEWL3auLDt9HEV3U5Vg: checks 
NBYmTySMtIicyMj5Vjzqhw: checks 
*** SHOW DOWN ***
8iyfEWL3auLDt9HEV3U5Vg: shows [8h Ad] (a pair of Eights)
NBYmTySMtIicyMj5Vjzqhw: shows [Ts Jc] (a pair of Tens)
NBYmTySMtIicyMj5Vjzqhw collected $2.50 from pot
*** SUMMARY ***
Total pot $2.60 | Rake $0.10 
Board [9d 8c 6d Td Kh]
Seat 1: 8iyfEWL3auLDt9HEV3U5Vg (big blind) showed [8h Ad] and lost with a pair of Eights
Seat 2: /OxeiWKPcgcer/U4z8Kqxw folded before Flop (didn't bet)
Seat 3: X78b5v/uhqeXXoAijbw/yg folded before Flop (didn't bet)
Seat 4: Bb42QRQMhg5/Y0vHP8/2Xw folded before Flop (didn't bet)
Seat 6: NBYmTySMtIicyMj5Vjzqhw showed [Ts Jc] and won ($2.50) with a pair of Tens
Seat 7: zDrucyjVn5aeekNEc3cJrA (button) folded before Flop (didn't bet)
Seat 9: wGigCmBR/9XWkPpvYos3aQ (small blind) folded before Flop




PokerStars Game #59941937270:  Hold'em No Limit ($0.10/$0.25) - 2009/07/01 1:50:55 ET
Table 'rpIHGyt2QpgQc5bvptAvDQ' 9-max Seat #7 is the button
Seat 1: E0iYnEVO2ho7dH3QcCjw7g ($24.10 in chips) 
Seat 2: FX0yWp7Ul3dMebXB0cFjEw ($5 in chips) 
Seat 3: N6a/f6AW8S8G3JFw9IFxAg ($21.30 in chips) 
Seat 5: XhSvfX1gy0yx/qeW+SOeTw ($12.30 in chips) 
Seat 6: Mq1ESwxx3LEsA4HjKKjU3Q ($18.65 in chips) 
Seat 7: GHgIdzlzMAmRmmX7jgXtuQ ($1.70 in chips) 
Seat 8: oUgIL46CfA9GCdIuN1TVSw ($8.45 in chips) 
Seat 9: sUVgUtgbfVx6JpvApozwhQ ($5 in chips) 
oUgIL46CfA9GCdIuN1TVSw: posts small blind $0.10
sUVgUtgbfVx6JpvApozwhQ: posts big blind $0.25
*** HOLE CARDS ***
E0iYnEVO2ho7dH3QcCjw7g: folds 
FX0yWp7Ul3dMebXB0cFjEw: calls $0.25
N6a/f6AW8S8G3JFw9IFxAg: folds 
XhSvfX1gy0yx/qeW+SOeTw: calls $0.25
Mq1ESwxx3LEsA4HjKKjU3Q: calls $0.25
GHgIdzlzMAmRmmX7jgXtuQ: calls $0.25
oUgIL46CfA9GCdIuN1TVSw: calls $0.15
sUVgUtgbfVx6JpvApozwhQ: checks 
*** FLOP *** [2s Qs 5d]
ASXDkj9tmvF/T2AsNuxg7g has returned
oUgIL46CfA9GCdIuN1TVSw: checks 
sUVgUtgbfVx6JpvApozwhQ: checks 
FX0yWp7Ul3dMebXB0cFjEw: checks 
XhSvfX1gy0yx/qeW+SOeTw: checks 
Mq1ESwxx3LEsA4HjKKjU3Q: checks 
GHgIdzlzMAmRmmX7jgXtuQ: checks 
*** TURN *** [2s Qs 5d] [3d]
N6a/f6AW8S8G3JFw9IFxAg is disconnected 
N6a/f6AW8S8G3JFw9IFxAg is connected 
oUgIL46CfA9GCdIuN1TVSw: checks 
sUVgUtgbfVx6JpvApozwhQ: checks 
FX0yWp7Ul3dMebXB0cFjEw: checks 
XhSvfX1gy0yx/qeW+SOeTw: checks 
Mq1ESwxx3LEsA4HjKKjU3Q: checks 
GHgIdzlzMAmRmmX7jgXtuQ: checks 
*** RIVER *** [2s Qs 5d 3d] [6c]
oUgIL46CfA9GCdIuN1TVSw: checks 
N6a/f6AW8S8G3JFw9IFxAg is disconnected 
N6a/f6AW8S8G3JFw9IFxAg is connected 
sUVgUtgbfVx6JpvApozwhQ: checks 
FX0yWp7Ul3dMebXB0cFjEw: bets $0.75
XhSvfX1gy0yx/qeW+SOeTw: folds 
Mq1ESwxx3LEsA4HjKKjU3Q: calls $0.75
GHgIdzlzMAmRmmX7jgXtuQ: folds 
oUgIL46CfA9GCdIuN1TVSw: folds 
sUVgUtgbfVx6JpvApozwhQ: folds 
*** SHOW DOWN ***
FX0yWp7Ul3dMebXB0cFjEw: shows [Qh 4s] (a straight, Deuce to Six)
Mq1ESwxx3LEsA4HjKKjU3Q: shows [4c 4h] (a straight, Deuce to Six)
FX0yWp7Ul3dMebXB0cFjEw collected $1.45 from pot
Mq1ESwxx3LEsA4HjKKjU3Q collected $1.45 from pot
*** SUMMARY ***
Total pot $3 | Rake $0.10 
Board [2s Qs 5d 3d 6c]
Seat 1: E0iYnEVO2ho7dH3QcCjw7g folded before Flop (didn't bet)
Seat 2: FX0yWp7Ul3dMebXB0cFjEw showed [Qh 4s] and won ($1.45) with a straight, Deuce to Six
Seat 3: N6a/f6AW8S8G3JFw9IFxAg folded before Flop (didn't bet)
Seat 5: XhSvfX1gy0yx/qeW+SOeTw folded on the River
Seat 6: Mq1ESwxx3LEsA4HjKKjU3Q showed [4c 4h] and won ($1.45) with a straight, Deuce to Six
Seat 7: GHgIdzlzMAmRmmX7jgXtuQ (button) folded on the River
Seat 8: oUgIL46CfA9GCdIuN1TVSw (small blind) folded on the River
Seat 9: sUVgUtgbfVx6JpvApozwhQ (big blind) folded on the River




PokerStars Game #59941937576:  Hold'em No Limit ($0.10/$0.25) - 2009/07/01 1:50:55 ET
Table 'AchTjdLS1zBUbH3ZIx6f0w' 6-max Seat #1 is the button
Seat 1: rZ0bUtoerhFGDUSRQMnFog ($29.70 in chips) 
Seat 2: kG34n23qFQA3nzdOJTQ1dA ($65.65 in chips) 
Seat 4: q6WfTUAD9mowIP63ASq2Dg ($30.95 in chips) 
Seat 5: 0av6tRNdi0Ui4f15L7gsVg ($23.65 in chips) 
Seat 6: epAUIB7h2FJXzUPRIvSkRA ($25.75 in chips) 
kG34n23qFQA3nzdOJTQ1dA: posts small blind $0.10
TroutBumnz: is sitting out 
q6WfTUAD9mowIP63ASq2Dg: posts big blind $0.25
*** HOLE CARDS ***
0av6tRNdi0Ui4f15L7gsVg: folds 
TroutBumnz leaves the table
epAUIB7h2FJXzUPRIvSkRA: folds 
rZ0bUtoerhFGDUSRQMnFog: calls $0.25
kG34n23qFQA3nzdOJTQ1dA: folds 
q6WfTUAD9mowIP63ASq2Dg: checks 
*** FLOP *** [Ac Jh Kc]
MVzl6OsGybVDNd3Vr9LYAA joins the table at seat #3 
q6WfTUAD9mowIP63ASq2Dg: checks 
rZ0bUtoerhFGDUSRQMnFog: bets $0.25
q6WfTUAD9mowIP63ASq2Dg: folds 
Uncalled bet ($0.25) returned to rZ0bUtoerhFGDUSRQMnFog
rZ0bUtoerhFGDUSRQMnFog collected $0.60 from pot
rZ0bUtoerhFGDUSRQMnFog: doesn't show hand 
*** SUMMARY ***
Total pot $0.60 | Rake $0 
Board [Ac Jh Kc]
Seat 1: rZ0bUtoerhFGDUSRQMnFog (button) collected ($0.60)
Seat 2: kG34n23qFQA3nzdOJTQ1dA (small blind) folded before Flop
Seat 4: q6WfTUAD9mowIP63ASq2Dg (big blind) folded on the Flop
Seat 5: 0av6tRNdi0Ui4f15L7gsVg folded before Flop (didn't bet)
Seat 6: epAUIB7h2FJXzUPRIvSkRA folded before Flop (didn't bet)




PokerStars Game #59941938238:  Hold'em No Limit ($0.10/$0.25) - 2009/07/01 1:50:56 ET
Table 'KTZXQ4LREPjpS54R3DFTsw' 9-max Seat #6 is the button
Seat 1: dSjkBIV7Bv+ZCIWNBguf7w ($40.85 in chips) 
Seat 2: OlPJsgR4xypSg/w1z7Gyvw ($16.35 in chips) 
Seat 3: H5Se03ZqSX7tbULXur2MAg ($30.90 in chips) 
Seat 5: HPEB+AtKw1+C/cxU0o1ciw ($28.85 in chips) 
Seat 6: Mh2r9hTeTEDnh19sRZtW3g ($5.35 in chips) 
Seat 7: yyG4svzOpC1A+sUP/scg6w ($10.70 in chips) 
Seat 8: mMd8CDS/but3UC+Zp7Up2w ($20 in chips) 
Seat 9: V6p0jQ/RhUsqpHLmXvEX4Q ($12.35 in chips) 
yyG4svzOpC1A+sUP/scg6w: posts small blind $0.10
mMd8CDS/but3UC+Zp7Up2w: posts big blind $0.25
*** HOLE CARDS ***
AiXn/9o1EwOPZUHujnh/bA joins the table at seat #4 
V6p0jQ/RhUsqpHLmXvEX4Q: folds 
dSjkBIV7Bv+ZCIWNBguf7w: folds 
OlPJsgR4xypSg/w1z7Gyvw: folds 
H5Se03ZqSX7tbULXur2MAg: calls $0.25
OlPJsgR4xypSg/w1z7Gyvw leaves the table
HPEB+AtKw1+C/cxU0o1ciw: folds 
CGjLyv/AvljZy2g76nYkzQ joins the table at seat #2 
Mh2r9hTeTEDnh19sRZtW3g: folds 
yyG4svzOpC1A+sUP/scg6w: calls $0.15
mMd8CDS/but3UC+Zp7Up2w: checks 
*** FLOP *** [3d 9s 2d]
yyG4svzOpC1A+sUP/scg6w: checks 
mMd8CDS/but3UC+Zp7Up2w: checks 
H5Se03ZqSX7tbULXur2MAg: bets $0.75
yyG4svzOpC1A+sUP/scg6w: folds 
mMd8CDS/but3UC+Zp7Up2w: folds 
Uncalled bet ($0.75) returned to H5Se03ZqSX7tbULXur2MAg
H5Se03ZqSX7tbULXur2MAg collected $0.75 from pot
*** SUMMARY ***
Total pot $0.75 | Rake $0 
Board [3d 9s 2d]
Seat 1: dSjkBIV7Bv+ZCIWNBguf7w folded before Flop (didn't bet)
Seat 2: OlPJsgR4xypSg/w1z7Gyvw folded before Flop (didn't bet)
Seat 3: H5Se03ZqSX7tbULXur2MAg collected ($0.75)
Seat 5: HPEB+AtKw1+C/cxU0o1ciw folded before Flop (didn't bet)
Seat 6: Mh2r9hTeTEDnh19sRZtW3g (button) folded before Flop (didn't bet)
Seat 7: yyG4svzOpC1A+sUP/scg6w (small blind) folded on the Flop
Seat 8: mMd8CDS/but3UC+Zp7Up2w (big blind) folded on the Flop
Seat 9: V6p0jQ/RhUsqpHLmXvEX4Q folded before Flop (didn't bet)




PokerStars Game #59941938046:  Hold'em No Limit ($0.10/$0.25) - 2009/07/01 1:50:56 ET
Table '3lL16FBjWXTx3AjK5lMRww' 9-max Seat #7 is the button
Seat 1: fDGyaQz0cs2s4FOYxkbIHA ($15.55 in chips) 
Seat 2: c/9X4zftzphFxYtxp5kp9w ($21.55 in chips) 
Seat 3: QEbIGci+itdw+re8RM5fZA ($28.50 in chips) 
Seat 4: Z3a37Ry74FVl+CBZtAONiA ($6.40 in chips) 
Seat 5: M/9j4wkHH9i1JM51vgi1VA ($36.95 in chips) 
Seat 7: 6RiVTYll/5D8zICp0MRpKw ($26.30 in chips) 
Seat 8: ljemhp25Zg+nlA9DLCIiUw ($24.50 in chips) 
Seat 9: 00Ybni1cxfHtqmdWwh31Xg ($10.30 in chips) 
ljemhp25Zg+nlA9DLCIiUw: posts small blind $0.10
00Ybni1cxfHtqmdWwh31Xg: posts big blind $0.25
*** HOLE CARDS ***
fDGyaQz0cs2s4FOYxkbIHA: folds 
c/9X4zftzphFxYtxp5kp9w: calls $0.25
QEbIGci+itdw+re8RM5fZA: folds 
Z3a37Ry74FVl+CBZtAONiA: folds 
M/9j4wkHH9i1JM51vgi1VA: folds 
6RiVTYll/5D8zICp0MRpKw: folds 
ljemhp25Zg+nlA9DLCIiUw: folds 
00Ybni1cxfHtqmdWwh31Xg: checks 
*** FLOP *** [Ad 9c Tc]
00Ybni1cxfHtqmdWwh31Xg: checks 
c/9X4zftzphFxYtxp5kp9w: bets $0.50
00Ybni1cxfHtqmdWwh31Xg: folds 
Uncalled bet ($0.50) returned to c/9X4zftzphFxYtxp5kp9w
c/9X4zftzphFxYtxp5kp9w collected $0.60 from pot
*** SUMMARY ***
Total pot $0.60 | Rake $0 
Board [Ad 9c Tc]
Seat 1: fDGyaQz0cs2s4FOYxkbIHA folded before Flop (didn't bet)
Seat 2: c/9X4zftzphFxYtxp5kp9w collected ($0.60)
Seat 3: QEbIGci+itdw+re8RM5fZA folded before Flop (didn't bet)
Seat 4: Z3a37Ry74FVl+CBZtAONiA folded before Flop (didn't bet)
Seat 5: M/9j4wkHH9i1JM51vgi1VA folded before Flop (didn't bet)
Seat 7: 6RiVTYll/5D8zICp0MRpKw (button) folded before Flop (didn't bet)
Seat 8: ljemhp25Zg+nlA9DLCIiUw (small blind) folded before Flop
Seat 9: 00Ybni1cxfHtqmdWwh31Xg (big blind) folded on the Flop




PokerStars Game #59941938252:  Hold'em No Limit ($0.10/$0.25) - 2009/07/01 1:50:56 ET
Table '+198VWQSWBhYQOcizzuBkw' 6-max Seat #2 is the button
Seat 1: 34ttqW62uIRrqINCCmLcsw ($18.25 in chips) 
Seat 2: iauW7L/+7qzAuHow7CD75Q ($12.55 in chips) 
Seat 3: vw7gefupgmOJJN8lUemdWg ($21.20 in chips) 
Seat 4: TgDsTeCdLQt8kWbL00ByRA ($14.65 in chips) 
Seat 5: LtASJ9OlkqGrrUKGQlpGAw ($25 in chips) 
vw7gefupgmOJJN8lUemdWg: posts small blind $0.10
TgDsTeCdLQt8kWbL00ByRA: posts big blind $0.25
*** HOLE CARDS ***
LtASJ9OlkqGrrUKGQlpGAw: folds 
34ttqW62uIRrqINCCmLcsw: folds 
iauW7L/+7qzAuHow7CD75Q: calls $0.25
vw7gefupgmOJJN8lUemdWg: folds 
TgDsTeCdLQt8kWbL00ByRA: checks 
*** FLOP *** [Kh 8d 8c]
TgDsTeCdLQt8kWbL00ByRA: bets $0.50
iauW7L/+7qzAuHow7CD75Q: folds 
Uncalled bet ($0.50) returned to TgDsTeCdLQt8kWbL00ByRA
vw7gefupgmOJJN8lUemdWg said, "almost"
TgDsTeCdLQt8kWbL00ByRA collected $0.60 from pot
leEQ84f6wJYu5SB/vj27wg has returned
*** SUMMARY ***
Total pot $0.60 | Rake $0 
Board [Kh 8d 8c]
Seat 1: 34ttqW62uIRrqINCCmLcsw folded before Flop (didn't bet)
Seat 2: iauW7L/+7qzAuHow7CD75Q (button) folded on the Flop
Seat 3: vw7gefupgmOJJN8lUemdWg (small blind) folded before Flop
Seat 4: TgDsTeCdLQt8kWbL00ByRA (big blind) collected ($0.60)
Seat 5: LtASJ9OlkqGrrUKGQlpGAw folded before Flop (didn't bet)




PokerStars Game #59941937766:  Hold'em No Limit ($0.10/$0.25) - 2009/07/01 1:50:56 ET
Table 'o0CDOvKO/bn1WjeymDrXfA' 6-max Seat #5 is the button
Seat 1: if4dh6jhJXeN3/qd3qCp9g ($27.05 in chips) 
Seat 3: OtVWmpxX2/9L8bb1GSKTuA ($21.55 in chips) 
Seat 4: i9LqF5rD3bvtbEE7HWgr3Q ($25 in chips) 
Seat 5: dOIoLBxmpLHSXBN9LZnf0Q ($40.25 in chips) 
Seat 6: SS/yfeArhULzIcOPe8MdPg ($25 in chips) 
SS/yfeArhULzIcOPe8MdPg: posts small blind $0.10
if4dh6jhJXeN3/qd3qCp9g: posts big blind $0.25
*** HOLE CARDS ***
OtVWmpxX2/9L8bb1GSKTuA: folds 
i9LqF5rD3bvtbEE7HWgr3Q: folds 
dOIoLBxmpLHSXBN9LZnf0Q: folds 
OtVWmpxX2/9L8bb1GSKTuA leaves the table
SS/yfeArhULzIcOPe8MdPg: folds 
Uncalled bet ($0.15) returned to if4dh6jhJXeN3/qd3qCp9g
08V++DOqzaNrRNsHIwi25w joins the table at seat #2 
if4dh6jhJXeN3/qd3qCp9g collected $0.20 from pot
if4dh6jhJXeN3/qd3qCp9g: doesn't show hand 
*** SUMMARY ***
Total pot $0.20 | Rake $0 
Seat 1: if4dh6jhJXeN3/qd3qCp9g (big blind) collected ($0.20)
Seat 3: OtVWmpxX2/9L8bb1GSKTuA folded before Flop (didn't bet)
Seat 4: i9LqF5rD3bvtbEE7HWgr3Q folded before Flop (didn't bet)
Seat 5: dOIoLBxmpLHSXBN9LZnf0Q (button) folded before Flop (didn't bet)
Seat 6: SS/yfeArhULzIcOPe8MdPg (small blind) folded before Flop




PokerStars Game #59941938090:  Hold'em No Limit ($0.10/$0.25) - 2009/07/01 1:50:56 ET
Table 'sgdCtiuCu2BDZhyDi6RzTA' 6-max Seat #5 is the button
Seat 1: 3zD3qLXT1bEffAoWGnc7wg ($35.40 in chips) 
Seat 3: eL3+wCBjFGfQ5FMdIZihwA ($27.55 in chips) 
Seat 4: rVKEgilmMX+EkKzDVvhmxA ($6 in chips) 
Seat 5: 0tQitW75xfmVWKldYHjmOQ ($3.70 in chips) 
Seat 6: KODslGU8ikCYS0/29dUkhg ($33.20 in chips) 
KODslGU8ikCYS0/29dUkhg: posts small blind $0.10
3zD3qLXT1bEffAoWGnc7wg: posts big blind $0.25
*** HOLE CARDS ***
eL3+wCBjFGfQ5FMdIZihwA: folds 
rVKEgilmMX+EkKzDVvhmxA: calls $0.25
0tQitW75xfmVWKldYHjmOQ: folds 
KODslGU8ikCYS0/29dUkhg: calls $0.15
3zD3qLXT1bEffAoWGnc7wg: checks 
*** FLOP *** [7h 8s Qd]
KODslGU8ikCYS0/29dUkhg: checks 
88Xc2CgPRIRNHZycxJdBtQ joins the table at seat #2 
3zD3qLXT1bEffAoWGnc7wg: checks 
rVKEgilmMX+EkKzDVvhmxA: bets $0.75
KODslGU8ikCYS0/29dUkhg: folds 
3zD3qLXT1bEffAoWGnc7wg: folds 
Uncalled bet ($0.75) returned to rVKEgilmMX+EkKzDVvhmxA
rVKEgilmMX+EkKzDVvhmxA collected $0.75 from pot
*** SUMMARY ***
Total pot $0.75 | Rake $0 
Board [7h 8s Qd]
Seat 1: 3zD3qLXT1bEffAoWGnc7wg (big blind) folded on the Flop
Seat 3: eL3+wCBjFGfQ5FMdIZihwA folded before Flop (didn't bet)
Seat 4: rVKEgilmMX+EkKzDVvhmxA collected ($0.75)
Seat 5: 0tQitW75xfmVWKldYHjmOQ (button) folded before Flop (didn't bet)
Seat 6: KODslGU8ikCYS0/29dUkhg (small blind) folded on the Flop




PokerStars Game #59941937964:  Hold'em No Limit ($0.10/$0.25) - 2009/07/01 1:50:56 ET
Table 'a6FCGVBMPcT7J7BDN9q1zQ' 9-max Seat #2 is the button
Seat 1: bXpVeaSTPBFSPJmeXxO7nw ($4.65 in chips) 
Seat 2: M2QO2DxB5Wawg2h8HSpnYA ($13.10 in chips) 
Seat 3: tLcDklc2rBORNfixyRfVfw ($25 in chips) 
Seat 4: 8EbrQ/EvFWt2cr0GaU82gQ ($5 in chips) 
Seat 5: dtZ84flFEi4Q+SGrHMJRDQ ($25.55 in chips) 
Seat 6: dfNim92Z6XK1/h5SFW5vDg ($25 in chips) 
Seat 7: V0Yo5zRBVM8DYspLKafebg ($8.15 in chips) 
Seat 8: r6hsffOo1iKmaPYKwAZmFw ($64.35 in chips) 
Seat 9: wGigCmBR/9XWkPpvYos3aQ ($29.85 in chips) 
tLcDklc2rBORNfixyRfVfw: posts small blind $0.10
8EbrQ/EvFWt2cr0GaU82gQ: posts big blind $0.25
*** HOLE CARDS ***
dtZ84flFEi4Q+SGrHMJRDQ: folds 
dfNim92Z6XK1/h5SFW5vDg: folds 
V0Yo5zRBVM8DYspLKafebg: calls $0.25
r6hsffOo1iKmaPYKwAZmFw: folds 
wGigCmBR/9XWkPpvYos3aQ: folds 
bXpVeaSTPBFSPJmeXxO7nw: folds 
M2QO2DxB5Wawg2h8HSpnYA: raises $0.50 to $0.75
tLcDklc2rBORNfixyRfVfw: folds 
8EbrQ/EvFWt2cr0GaU82gQ: folds 
V0Yo5zRBVM8DYspLKafebg: raises $7.40 to $8.15 and is all-in
M2QO2DxB5Wawg2h8HSpnYA: calls $7.40
*** FLOP *** [Td Kc 2h]
*** TURN *** [Td Kc 2h] [5d]
*** RIVER *** [Td Kc 2h 5d] [Jh]
*** SHOW DOWN ***
V0Yo5zRBVM8DYspLKafebg: shows [Ks Kh] (three of a kind, Kings)
M2QO2DxB5Wawg2h8HSpnYA: mucks hand 
V0Yo5zRBVM8DYspLKafebg collected $15.85 from pot
*** SUMMARY ***
Total pot $16.65 | Rake $0.80 
Board [Td Kc 2h 5d Jh]
Seat 1: bXpVeaSTPBFSPJmeXxO7nw folded before Flop (didn't bet)
Seat 2: M2QO2DxB5Wawg2h8HSpnYA (button) mucked
Seat 3: tLcDklc2rBORNfixyRfVfw (small blind) folded before Flop
Seat 4: 8EbrQ/EvFWt2cr0GaU82gQ (big blind) folded before Flop
Seat 5: dtZ84flFEi4Q+SGrHMJRDQ folded before Flop (didn't bet)
Seat 6: dfNim92Z6XK1/h5SFW5vDg folded before Flop (didn't bet)
Seat 7: V0Yo5zRBVM8DYspLKafebg showed [Ks Kh] and won ($15.85) with three of a kind, Kings
Seat 8: r6hsffOo1iKmaPYKwAZmFw folded before Flop (didn't bet)
Seat 9: wGigCmBR/9XWkPpvYos3aQ folded before Flop (didn't bet)




PokerStars Game #59941938188:  Hold'em No Limit ($0.10/$0.25) - 2009/07/01 1:50:56 ET
Table 'aT31tt16YvQM/Ue69HPLpA' 9-max Seat #6 is the button
Seat 1: wxmepRUXfX1jdQfUD5uENQ ($4.75 in chips) 
Seat 2: PdIasPkzm2sqZnN41ZRXOg ($5 in chips) 
Seat 3: swK30YlQuxRQO7QFr4ZxCA ($25.35 in chips) 
Seat 4: wGigCmBR/9XWkPpvYos3aQ ($26.85 in chips) 
Seat 5: s2xLPOl/vhl/26apJ3vsOQ ($33.55 in chips) 
Seat 6: ghG12/paEL5VoDN85sW6RA ($14.65 in chips) 
Seat 9: TvIuLx9zUCE+9Li58iImOQ ($13.70 in chips) 
TvIuLx9zUCE+9Li58iImOQ: posts small blind $0.10
wxmepRUXfX1jdQfUD5uENQ: posts big blind $0.25
*** HOLE CARDS ***
PdIasPkzm2sqZnN41ZRXOg: folds 
swK30YlQuxRQO7QFr4ZxCA: folds 
wGigCmBR/9XWkPpvYos3aQ: folds 
s2xLPOl/vhl/26apJ3vsOQ: raises $0.75 to $1
ghG12/paEL5VoDN85sW6RA: folds 
TvIuLx9zUCE+9Li58iImOQ: folds 
wxmepRUXfX1jdQfUD5uENQ: folds 
Uncalled bet ($0.75) returned to s2xLPOl/vhl/26apJ3vsOQ
s2xLPOl/vhl/26apJ3vsOQ collected $0.60 from pot
*** SUMMARY ***
Total pot $0.60 | Rake $0 
Seat 1: wxmepRUXfX1jdQfUD5uENQ (big blind) folded before Flop
Seat 2: PdIasPkzm2sqZnN41ZRXOg folded before Flop (didn't bet)
Seat 3: swK30YlQuxRQO7QFr4ZxCA folded before Flop (didn't bet)
Seat 4: wGigCmBR/9XWkPpvYos3aQ folded before Flop (didn't bet)
Seat 5: s2xLPOl/vhl/26apJ3vsOQ collected ($0.60)
Seat 6: ghG12/paEL5VoDN85sW6RA (button) folded before Flop (didn't bet)
Seat 9: TvIuLx9zUCE+9Li58iImOQ (small blind) folded before Flop




PokerStars Game #59941937674:  Hold'em No Limit ($0.10/$0.25) - 2009/07/01 1:50:56 ET
Table 'nQC9LRg01NEuKFHF1nrDEw0XPo7K54oZIfG0xlNAcDRw-max Seat #1 is the button
Seat 1: qf+LMbROj8/qY878wkFHbQ ($18.50 in chips) 
Seat 2: ZhV6dUX9NQhT4zf7t+ZLJg ($23.45 in chips) 
Seat 3: 6+g0Lb6vfRDZkElV8ieHyQ ($26.10 in chips) 
Seat 4: u3Ol7kv1LmvszuHNm9rc6w ($24.65 in chips) 
Seat 5: kG34n23qFQA3nzdOJTQ1dA ($27.95 in chips) 
Seat 6: xQVFeVUDopz+akuEo2wXpQ ($52.40 in chips) 
ZhV6dUX9NQhT4zf7t+ZLJg: posts small blind $0.10
6+g0Lb6vfRDZkElV8ieHyQ: posts big blind $0.25
*** HOLE CARDS ***
u3Ol7kv1LmvszuHNm9rc6w: folds 
kG34n23qFQA3nzdOJTQ1dA: folds 
xQVFeVUDopz+akuEo2wXpQ: folds 
qf+LMbROj8/qY878wkFHbQ: folds 
ZhV6dUX9NQhT4zf7t+ZLJg: calls $0.15
6+g0Lb6vfRDZkElV8ieHyQ: checks 
*** FLOP *** [Th Ac Qh]
ZhV6dUX9NQhT4zf7t+ZLJg: checks 
6+g0Lb6vfRDZkElV8ieHyQ: checks 
*** TURN *** [Th Ac Qh] [Td]
ZhV6dUX9NQhT4zf7t+ZLJg: checks 
6+g0Lb6vfRDZkElV8ieHyQ: checks 
*** RIVER *** [Th Ac Qh Td] [2s]
ZhV6dUX9NQhT4zf7t+ZLJg: checks 
6+g0Lb6vfRDZkElV8ieHyQ: checks 
*** SHOW DOWN ***
ZhV6dUX9NQhT4zf7t+ZLJg: shows [Kc 8s] (a pair of Tens)
6+g0Lb6vfRDZkElV8ieHyQ: mucks hand 
ZhV6dUX9NQhT4zf7t+ZLJg collected $0.50 from pot
*** SUMMARY ***
Total pot $0.50 | Rake $0 
Board [Th Ac Qh Td 2s]
Seat 1: qf+LMbROj8/qY878wkFHbQ (button) folded before Flop (didn't bet)
Seat 2: ZhV6dUX9NQhT4zf7t+ZLJg (small blind) showed [Kc 8s] and won ($0.50) with a pair of Tens
Seat 3: 6+g0Lb6vfRDZkElV8ieHyQ (big blind) mucked
Seat 4: u3Ol7kv1LmvszuHNm9rc6w folded before Flop (didn't bet)
Seat 5: kG34n23qFQA3nzdOJTQ1dA folded before Flop (didn't bet)
Seat 6: xQVFeVUDopz+akuEo2wXpQ folded before Flop (didn't bet)




PokerStars Game #59941937886:  Hold'em No Limit ($0.10/$0.25) - 2009/07/01 1:50:56 ET
Table 'VQNfcI8vTBCTvRfd3veTLQ' 6-max Seat #5 is the button
Seat 1: QiL+lEgEWwy21jk/ltaRLg ($13.50 in chips) 
Seat 2: 79ID/ub1Pt/mDpCprVmOoA ($31.25 in chips) 
Seat 3: LtASJ9OlkqGrrUKGQlpGAw ($11.25 in chips) 
Seat 4: QIWnfLSqfMcoFfdDe5LZPg ($40.70 in chips) 
Seat 5: gX2vbKwS/8zZPENAWB7hxQ ($25.25 in chips) 
Seat 6: LJI7A1YgDM7hgh7o56+ReQ ($27.45 in chips) 
LJI7A1YgDM7hgh7o56+ReQ: posts small blind $0.10
QiL+lEgEWwy21jk/ltaRLg: posts big blind $0.25
*** HOLE CARDS ***
79ID/ub1Pt/mDpCprVmOoA: folds 
LtASJ9OlkqGrrUKGQlpGAw: folds 
QIWnfLSqfMcoFfdDe5LZPg: raises $0.50 to $0.75
gX2vbKwS/8zZPENAWB7hxQ: folds 
LJI7A1YgDM7hgh7o56+ReQ: folds 
QiL+lEgEWwy21jk/ltaRLg: folds 
Uncalled bet ($0.50) returned to QIWnfLSqfMcoFfdDe5LZPg
QIWnfLSqfMcoFfdDe5LZPg collected $0.60 from pot
*** SUMMARY ***
Total pot $0.60 | Rake $0 
Seat 1: QiL+lEgEWwy21jk/ltaRLg (big blind) folded before Flop
Seat 2: 79ID/ub1Pt/mDpCprVmOoA folded before Flop (didn't bet)
Seat 3: LtASJ9OlkqGrrUKGQlpGAw folded before Flop (didn't bet)
Seat 4: QIWnfLSqfMcoFfdDe5LZPg collected ($0.60)
Seat 5: gX2vbKwS/8zZPENAWB7hxQ (button) folded before Flop (didn't bet)
Seat 6: LJI7A1YgDM7hgh7o56+ReQ (small blind) folded before Flop




PokerStars Game #59941938206:  Hold'em No Limit ($0.10/$0.25) - 2009/07/01 1:50:56 ET
Table 'oJpFwZj9+FUGHX90Un8s9Q' 6-max Seat #1 is the button
Seat 1: 6DwBRH+xZ12AAZmeAg+aXw ($25.50 in chips) 
Seat 2: NtrVQ9UIql0rDCnKDKZ5FQ ($18.95 in chips) 
Seat 3: kyRaCIljYA6l33lSKQfNsg ($24.65 in chips) 
Seat 4: 6elpmfyt4Zw0yvd8lePSMQ ($22.40 in chips) 
Seat 5: kG34n23qFQA3nzdOJTQ1dA ($52.60 in chips) 
Seat 6: 7LpHJVeM6k1mQdC6HXYzww ($25 in chips) 
NtrVQ9UIql0rDCnKDKZ5FQ: posts small blind $0.10
kyRaCIljYA6l33lSKQfNsg: posts big blind $0.25
*** HOLE CARDS ***
6elpmfyt4Zw0yvd8lePSMQ: folds 
kG34n23qFQA3nzdOJTQ1dA: calls $0.25
7LpHJVeM6k1mQdC6HXYzww: folds 
6DwBRH+xZ12AAZmeAg+aXw: folds 
NtrVQ9UIql0rDCnKDKZ5FQ: folds 
kyRaCIljYA6l33lSKQfNsg: checks 
*** FLOP *** [Jc 6h Js]
kyRaCIljYA6l33lSKQfNsg: checks 
kG34n23qFQA3nzdOJTQ1dA: bets $0.50
kyRaCIljYA6l33lSKQfNsg: calls $0.50
*** TURN *** [Jc 6h Js] [Ac]
kyRaCIljYA6l33lSKQfNsg: checks 
kG34n23qFQA3nzdOJTQ1dA: bets $1.25
kyRaCIljYA6l33lSKQfNsg: calls $1.25
*** RIVER *** [Jc 6h Js Ac] [2h]
kyRaCIljYA6l33lSKQfNsg: checks 
kG34n23qFQA3nzdOJTQ1dA: bets $5
kyRaCIljYA6l33lSKQfNsg: calls $5
*** SHOW DOWN ***
kG34n23qFQA3nzdOJTQ1dA: shows [Ad Jd] (a full house, Jacks full of Aces)
kyRaCIljYA6l33lSKQfNsg: mucks hand 
kG34n23qFQA3nzdOJTQ1dA collected $13.45 from pot
*** SUMMARY ***
Total pot $14.10 | Rake $0.65 
Board [Jc 6h Js Ac 2h]
Seat 1: 6DwBRH+xZ12AAZmeAg+aXw (button) folded before Flop (didn't bet)
Seat 2: NtrVQ9UIql0rDCnKDKZ5FQ (small blind) folded before Flop
Seat 3: kyRaCIljYA6l33lSKQfNsg (big blind) mucked
Seat 4: 6elpmfyt4Zw0yvd8lePSMQ folded before Flop (didn't bet)
Seat 5: kG34n23qFQA3nzdOJTQ1dA showed [Ad Jd] and won ($13.45) with a full house, Jacks full of Aces
Seat 6: 7LpHJVeM6k1mQdC6HXYzww folded before Flop (didn't bet)




PokerStars Game #59941938614:  Hold'em No Limit ($0.10/$0.25) - 2009/07/01 1:50:57 ET
Table 'NtCSSONEf1zaJo3042tQug' 6-max Seat #1 is the button
Seat 1: KXtdqb+rIMkjc0RvHDksGQ ($31.15 in chips) 
Seat 2: vqWjZmdQu/Hxw96/IJTWdQ ($25 in chips) 
Seat 3: 9kUKGKkblnIx3m8rlVol6Q ($14.65 in chips) 
Seat 4: HxD1kB8zCmalQSdWAkKmlg ($27.50 in chips) 
Seat 5: tOAk1Og4mVObMBOfvdDYOw ($34.40 in chips) 
Seat 6: LxehwDpTQ19ph4Qmc78+Pw ($35.35 in chips) 
vqWjZmdQu/Hxw96/IJTWdQ: posts small blind $0.10
9kUKGKkblnIx3m8rlVol6Q: posts big blind $0.25
*** HOLE CARDS ***
HxD1kB8zCmalQSdWAkKmlg: raises $0.75 to $1
tOAk1Og4mVObMBOfvdDYOw: folds 
LxehwDpTQ19ph4Qmc78+Pw: folds 
KXtdqb+rIMkjc0RvHDksGQ: folds 
vqWjZmdQu/Hxw96/IJTWdQ: folds 
9kUKGKkblnIx3m8rlVol6Q: folds 
Uncalled bet ($0.75) returned to HxD1kB8zCmalQSdWAkKmlg
HxD1kB8zCmalQSdWAkKmlg collected $0.60 from pot
HxD1kB8zCmalQSdWAkKmlg: doesn't show hand 
*** SUMMARY ***
Total pot $0.60 | Rake $0 
Seat 1: KXtdqb+rIMkjc0RvHDksGQ (button) folded before Flop (didn't bet)
Seat 2: vqWjZmdQu/Hxw96/IJTWdQ (small blind) folded before Flop
Seat 3: 9kUKGKkblnIx3m8rlVol6Q (big blind) folded before Flop
Seat 4: HxD1kB8zCmalQSdWAkKmlg collected ($0.60)
Seat 5: tOAk1Og4mVObMBOfvdDYOw folded before Flop (didn't bet)
Seat 6: LxehwDpTQ19ph4Qmc78+Pw folded before Flop (didn't bet)




PokerStars Game #59941938518:  Hold'em No Limit ($0.10/$0.25) - 2009/07/01 1:50:57 ET
Table 'aaXqTKUnxrX9DYXtxhWXxA' 6-max Seat #3 is the button
Seat 1: aSrj4lVmn2owyQ1RbbOqxQ ($28.40 in chips) 
Seat 2: DE9hRlt14g+JdsRQ4wT7hg ($32.75 in chips) 
Seat 3: uUXdcVMNa05rfbntdvplfw ($7.75 in chips) 
Seat 4: 48oT5xFI+5CHUJlfoGrE4w ($7.80 in chips) 
Seat 5: kyRaCIljYA6l33lSKQfNsg ($23.85 in chips) 
Seat 6: buyjetgNT1McXtdaP4zynA ($51.50 in chips) 
48oT5xFI+5CHUJlfoGrE4w: posts small blind $0.10
kyRaCIljYA6l33lSKQfNsg: posts big blind $0.25
*** HOLE CARDS ***
buyjetgNT1McXtdaP4zynA: calls $0.25
aSrj4lVmn2owyQ1RbbOqxQ: calls $0.25
DE9hRlt14g+JdsRQ4wT7hg: folds 
uUXdcVMNa05rfbntdvplfw: folds 
48oT5xFI+5CHUJlfoGrE4w: raises $0.25 to $0.50
kyRaCIljYA6l33lSKQfNsg: folds 
buyjetgNT1McXtdaP4zynA: calls $0.25
aSrj4lVmn2owyQ1RbbOqxQ: calls $0.25
*** FLOP *** [8s 2c 6c]
48oT5xFI+5CHUJlfoGrE4w: checks 
buyjetgNT1McXtdaP4zynA: checks 
aSrj4lVmn2owyQ1RbbOqxQ: checks 
*** TURN *** [8s 2c 6c] [7s]
48oT5xFI+5CHUJlfoGrE4w: checks 
buyjetgNT1McXtdaP4zynA: folds 
buyjetgNT1McXtdaP4zynA leaves the table
aSrj4lVmn2owyQ1RbbOqxQ: bets $1
1lxYIAoJdZwAbzIkzWmSkw joins the table at seat #6 
48oT5xFI+5CHUJlfoGrE4w: folds 
Uncalled bet ($1) returned to aSrj4lVmn2owyQ1RbbOqxQ
aSrj4lVmn2owyQ1RbbOqxQ collected $1.70 from pot
aSrj4lVmn2owyQ1RbbOqxQ: doesn't show hand 
*** SUMMARY ***
Total pot $1.75 | Rake $0.05 
Board [8s 2c 6c 7s]
Seat 1: aSrj4lVmn2owyQ1RbbOqxQ collected ($1.70)
Seat 2: DE9hRlt14g+JdsRQ4wT7hg folded before Flop (didn't bet)
Seat 3: uUXdcVMNa05rfbntdvplfw (button) folded before Flop (didn't bet)
Seat 4: 48oT5xFI+5CHUJlfoGrE4w (small blind) folded on the Turn
Seat 5: kyRaCIljYA6l33lSKQfNsg (big blind) folded before Flop
Seat 6: buyjetgNT1McXtdaP4zynA folded on the Turn




PokerStars Game #59941938504:  Hold'em No Limit ($0.10/$0.25) - 2009/07/01 1:50:57 ET
Table 'APEHQjIcZHDZUA4iOjju2g' 6-max Seat #1 is the button
Seat 1: DE9hRlt14g+JdsRQ4wT7hg ($25 in chips) 
Seat 2: 3zD3qLXT1bEffAoWGnc7wg ($33.30 in chips) 
Seat 3: 3e/idKqDuPE10t6Zvr//SQ ($20 in chips) 
Seat 4: w2mQ4VsGljGwWXydz8tw2A ($34.60 in chips) 
Seat 5: /xN6gc9+8Hew0HxaB6VIVg ($45.65 in chips) 
Seat 6: KXtdqb+rIMkjc0RvHDksGQ ($42 in chips) 
3zD3qLXT1bEffAoWGnc7wg: posts small blind $0.10
3e/idKqDuPE10t6Zvr//SQ: posts big blind $0.25
*** HOLE CARDS ***
w2mQ4VsGljGwWXydz8tw2A: folds 
/xN6gc9+8Hew0HxaB6VIVg: folds 
KXtdqb+rIMkjc0RvHDksGQ: folds 
DE9hRlt14g+JdsRQ4wT7hg: folds 
3zD3qLXT1bEffAoWGnc7wg: raises $0.50 to $0.75
3e/idKqDuPE10t6Zvr//SQ: folds 
Uncalled bet ($0.50) returned to 3zD3qLXT1bEffAoWGnc7wg
3zD3qLXT1bEffAoWGnc7wg collected $0.50 from pot
3zD3qLXT1bEffAoWGnc7wg: doesn't show hand 
*** SUMMARY ***
Total pot $0.50 | Rake $0 
Seat 1: DE9hRlt14g+JdsRQ4wT7hg (button) folded before Flop (didn't bet)
Seat 2: 3zD3qLXT1bEffAoWGnc7wg (small blind) collected ($0.50)
Seat 3: 3e/idKqDuPE10t6Zvr//SQ (big blind) folded before Flop
Seat 4: w2mQ4VsGljGwWXydz8tw2A folded before Flop (didn't bet)
Seat 5: /xN6gc9+8Hew0HxaB6VIVg folded before Flop (didn't bet)
Seat 6: KXtdqb+rIMkjc0RvHDksGQ folded before Flop (didn't bet)




PokerStars Game #59941938386:  Hold'em No Limit ($0.10/$0.25) - 2009/07/01 1:50:57 ET
Table '63h13e5p7cWe02rClZ1CHw' 6-max Seat #2 is the button
Seat 1: pokjbbEcXXPlADXdSGHtZw ($21.35 in chips) 
Seat 2: k9nHZTHt8hYhYRcW8NTb4g ($24.95 in chips) 
Seat 4: xrf8tAXKQHG99HixCot1Iw ($28.10 in chips) 
Seat 5: iyZxqznXjv3vtvOJymkoLQ ($44.45 in chips) 
Seat 6: mfrkWA3PTeYPkbO6hi98Aw ($38.70 in chips) 
hOaWAImn5/MZDAWAPlYHCw will be allowed to play after the button
xrf8tAXKQHG99HixCot1Iw: posts small blind $0.10
iyZxqznXjv3vtvOJymkoLQ: posts big blind $0.25
*** HOLE CARDS ***
mfrkWA3PTeYPkbO6hi98Aw: folds 
pokjbbEcXXPlADXdSGHtZw: folds 
k9nHZTHt8hYhYRcW8NTb4g: raises $0.50 to $0.75
xrf8tAXKQHG99HixCot1Iw: folds 
iyZxqznXjv3vtvOJymkoLQ: folds 
Uncalled bet ($0.50) returned to k9nHZTHt8hYhYRcW8NTb4g
k9nHZTHt8hYhYRcW8NTb4g collected $0.60 from pot
k9nHZTHt8hYhYRcW8NTb4g: doesn't show hand 
*** SUMMARY ***
Total pot $0.60 | Rake $0 
Seat 1: pokjbbEcXXPlADXdSGHtZw folded before Flop (didn't bet)
Seat 2: k9nHZTHt8hYhYRcW8NTb4g (button) collected ($0.60)
Seat 4: xrf8tAXKQHG99HixCot1Iw (small blind) folded before Flop
Seat 5: iyZxqznXjv3vtvOJymkoLQ (big blind) folded before Flop
Seat 6: mfrkWA3PTeYPkbO6hi98Aw folded before Flop (didn't bet)




PokerStars Game #59941938752:  Hold'em No Limit ($0.10/$0.25) - 2009/07/01 1:50:57 ET
Table 'Ok3oDLIsTc2+KxPcI0bAOA' 6-max Seat #6 is the button
Seat 1: agQm3ugZ3qSVYNgNu1ddeA ($40.20 in chips) 
Seat 2: wPSNSp4HYtytRMXTu3oPSQ ($27.75 in chips) 
Seat 4: LJI7A1YgDM7hgh7o56+ReQ ($34.05 in chips) 
Seat 5: DFi/Lzkjsfv8QswS80JX9Q ($29.75 in chips) 
Seat 6: Hsvkc0/G2VV78oVmWYXecw ($5.45 in chips) 
agQm3ugZ3qSVYNgNu1ddeA: posts small blind $0.10
wPSNSp4HYtytRMXTu3oPSQ: posts big blind $0.25
*** HOLE CARDS ***
LJI7A1YgDM7hgh7o56+ReQ: folds 
DFi/Lzkjsfv8QswS80JX9Q: folds 
Hsvkc0/G2VV78oVmWYXecw: folds 
agQm3ugZ3qSVYNgNu1ddeA: calls $0.15
Hsvkc0/G2VV78oVmWYXecw leaves the table
wPSNSp4HYtytRMXTu3oPSQ: raises $0.75 to $1
agQm3ugZ3qSVYNgNu1ddeA: calls $0.75
*** FLOP *** [Kh 5d 4s]
agQm3ugZ3qSVYNgNu1ddeA: checks 
wPSNSp4HYtytRMXTu3oPSQ: bets $1.75
agQm3ugZ3qSVYNgNu1ddeA: folds 
Uncalled bet ($1.75) returned to wPSNSp4HYtytRMXTu3oPSQ
wPSNSp4HYtytRMXTu3oPSQ collected $1.90 from pot
wPSNSp4HYtytRMXTu3oPSQ: doesn't show hand 
*** SUMMARY ***
Total pot $2 | Rake $0.10 
Board [Kh 5d 4s]
Seat 1: agQm3ugZ3qSVYNgNu1ddeA (small blind) folded on the Flop
Seat 2: wPSNSp4HYtytRMXTu3oPSQ (big blind) collected ($1.90)
Seat 4: LJI7A1YgDM7hgh7o56+ReQ folded before Flop (didn't bet)
Seat 5: DFi/Lzkjsfv8QswS80JX9Q folded before Flop (didn't bet)
Seat 6: Hsvkc0/G2VV78oVmWYXecw (button) folded before Flop (didn't bet)




PokerStars Game #59941938910:  Hold'em No Limit ($0.10/$0.25) - 2009/07/01 1:50:58 ET
Table 'dZNBGqFYSwfOVZvDJ4VjIQ' 6-max Seat #5 is the button
Seat 1: v+QfkGiuj9bgtuNoVnDO8w ($38 in chips) 
Seat 2: 3zD3qLXT1bEffAoWGnc7wg ($27.95 in chips) 
Seat 3: kyRaCIljYA6l33lSKQfNsg ($29.35 in chips) 
Seat 5: +ZlnqPoP3Hg4BIUxDfKd/A ($26.70 in chips) 
Seat 6: ypmjhffk/YHGc51wgVXUTw ($31.35 in chips) 
ypmjhffk/YHGc51wgVXUTw: posts small blind $0.10
v+QfkGiuj9bgtuNoVnDO8w: posts big blind $0.25
GbCVUNssQ7mqsPWr7J4d3w: sits out 
*** HOLE CARDS ***
3zD3qLXT1bEffAoWGnc7wg: folds 
kyRaCIljYA6l33lSKQfNsg: folds 
+ZlnqPoP3Hg4BIUxDfKd/A: raises $0.75 to $1
ypmjhffk/YHGc51wgVXUTw: folds 
v+QfkGiuj9bgtuNoVnDO8w: folds 
Uncalled bet ($0.75) returned to +ZlnqPoP3Hg4BIUxDfKd/A
+ZlnqPoP3Hg4BIUxDfKd/A collected $0.60 from pot
+ZlnqPoP3Hg4BIUxDfKd/A: doesn't show hand 
*** SUMMARY ***
Total pot $0.60 | Rake $0 
Seat 1: v+QfkGiuj9bgtuNoVnDO8w (big blind) folded before Flop
Seat 2: 3zD3qLXT1bEffAoWGnc7wg folded before Flop (didn't bet)
Seat 3: kyRaCIljYA6l33lSKQfNsg folded before Flop (didn't bet)
Seat 5: +ZlnqPoP3Hg4BIUxDfKd/A (button) collected ($0.60)
Seat 6: ypmjhffk/YHGc51wgVXUTw (small blind) folded before Flop




PokerStars Game #59941939044:  Hold'em No Limit ($0.10/$0.25) - 2009/07/01 1:50:58 ET
Table 'IRgQPZVA4+IaZZIQshgwyg' 6-max Seat #5 is the button
Seat 1: cezpHJ8FB07dj0xG+LhOvw ($27.55 in chips) 
Seat 3: DihMHaz4WNETH1bPDe13kA ($27.45 in chips) 
Seat 4: DE9hRlt14g+JdsRQ4wT7hg ($25 in chips) 
Seat 5: w43JQj2oYPpKQVG4Yzlq1w ($28.05 in chips) 
Seat 6: x9/USY6PsmgUGQeluFLKDw ($21.05 in chips) 
x9/USY6PsmgUGQeluFLKDw: posts small blind $0.10
cezpHJ8FB07dj0xG+LhOvw: posts big blind $0.25
*** HOLE CARDS ***
DihMHaz4WNETH1bPDe13kA: folds 
DE9hRlt14g+JdsRQ4wT7hg: raises $0.75 to $1
w43JQj2oYPpKQVG4Yzlq1w: folds 
x9/USY6PsmgUGQeluFLKDw: folds 
cezpHJ8FB07dj0xG+LhOvw: folds 
Uncalled bet ($0.75) returned to DE9hRlt14g+JdsRQ4wT7hg
DE9hRlt14g+JdsRQ4wT7hg collected $0.60 from pot
DE9hRlt14g+JdsRQ4wT7hg: doesn't show hand 
*** SUMMARY ***
Total pot $0.60 | Rake $0 
Seat 1: cezpHJ8FB07dj0xG+LhOvw (big blind) folded before Flop
Seat 3: DihMHaz4WNETH1bPDe13kA folded before Flop (didn't bet)
Seat 4: DE9hRlt14g+JdsRQ4wT7hg collected ($0.60)
Seat 5: w43JQj2oYPpKQVG4Yzlq1w (button) folded before Flop (didn't bet)
Seat 6: x9/USY6PsmgUGQeluFLKDw (small blind) folded before Flop




PokerStars Game #59941939062:  Hold'em No Limit ($0.10/$0.25) - 2009/07/01 1:50:58 ET
Table 'n8mNkPYbe1AIQEkioNesZA' 9-max Seat #4 is the button
Seat 1: 9lvO/qyU+xrU95Teu1fv0g ($5.20 in chips) 
Seat 2: QEbIGci+itdw+re8RM5fZA ($29.30 in chips) 
Seat 3: zDrucyjVn5aeekNEc3cJrA ($18.40 in chips) 
Seat 4: zgi+EUykT/pZQpoUG6+oEg ($4.65 in chips) 
Seat 5: wGigCmBR/9XWkPpvYos3aQ ($28.75 in chips) 
Seat 6: HPEB+AtKw1+C/cxU0o1ciw ($46.55 in chips) 
Seat 7: vNfw/x/HNt0WgQC8SveThg ($5 in chips) 
Seat 8: aNpwfA31EREwO+ar4XzBCw ($32.20 in chips) 
Seat 9: gehe91e0IyVT0QU/XBkEyg ($28.25 in chips) 
wGigCmBR/9XWkPpvYos3aQ: posts small blind $0.10
HPEB+AtKw1+C/cxU0o1ciw: posts big blind $0.25
*** HOLE CARDS ***
vNfw/x/HNt0WgQC8SveThg is disconnected 
vNfw/x/HNt0WgQC8SveThg has timed out while disconnected
vNfw/x/HNt0WgQC8SveThg: folds 
vNfw/x/HNt0WgQC8SveThg is sitting out
aNpwfA31EREwO+ar4XzBCw: folds 
gehe91e0IyVT0QU/XBkEyg: folds 
9lvO/qyU+xrU95Teu1fv0g: folds 
QEbIGci+itdw+re8RM5fZA: folds 
vNfw/x/HNt0WgQC8SveThg is connected 
vNfw/x/HNt0WgQC8SveThg has returned
zDrucyjVn5aeekNEc3cJrA: folds 
zgi+EUykT/pZQpoUG6+oEg: folds 
wGigCmBR/9XWkPpvYos3aQ: folds 
Uncalled bet ($0.15) returned to HPEB+AtKw1+C/cxU0o1ciw
HPEB+AtKw1+C/cxU0o1ciw collected $0.20 from pot
HPEB+AtKw1+C/cxU0o1ciw: doesn't show hand 
*** SUMMARY ***
Total pot $0.20 | Rake $0 
Seat 1: 9lvO/qyU+xrU95Teu1fv0g folded before Flop (didn't bet)
Seat 2: QEbIGci+itdw+re8RM5fZA folded before Flop (didn't bet)
Seat 3: zDrucyjVn5aeekNEc3cJrA folded before Flop (didn't bet)
Seat 4: zgi+EUykT/pZQpoUG6+oEg (button) folded before Flop (didn't bet)
Seat 5: wGigCmBR/9XWkPpvYos3aQ (small blind) folded before Flop
Seat 6: HPEB+AtKw1+C/cxU0o1ciw (big blind) collected ($0.20)
Seat 7: vNfw/x/HNt0WgQC8SveThg folded before Flop (didn't bet)
Seat 8: aNpwfA31EREwO+ar4XzBCw folded before Flop (didn't bet)
Seat 9: gehe91e0IyVT0QU/XBkEyg folded before Flop (didn't bet)




PokerStars Game #59941939190:  Hold'em No Limit ($0.10/$0.25) - 2009/07/01 1:50:58 ET
Table 'ZEXL6Wh4qA4Afx8NnoBBAA' 6-max Seat #3 is the button
Seat 1: v8m8XHovI5tqEA9mvplDSw ($26.95 in chips) 
Seat 2: 6DwBRH+xZ12AAZmeAg+aXw ($21.65 in chips) 
Seat 3: +ZlnqPoP3Hg4BIUxDfKd/A ($32.05 in chips) 
Seat 4: FpN4KbLjlyRRKiVaQcoLqA ($29.50 in chips) 
Seat 5: if4dh6jhJXeN3/qd3qCp9g ($38.80 in chips) 
Seat 6: Lh8SlCq3OSDKWLUgAI/Lxw ($1.75 in chips) 
FpN4KbLjlyRRKiVaQcoLqA: posts small blind $0.10
if4dh6jhJXeN3/qd3qCp9g: posts big blind $0.25
*** HOLE CARDS ***
Lh8SlCq3OSDKWLUgAI/Lxw: folds 
v8m8XHovI5tqEA9mvplDSw: folds 
6DwBRH+xZ12AAZmeAg+aXw: raises $0.50 to $0.75
+ZlnqPoP3Hg4BIUxDfKd/A: calls $0.75
FpN4KbLjlyRRKiVaQcoLqA: raises $0.50 to $1.25
if4dh6jhJXeN3/qd3qCp9g: folds 
6DwBRH+xZ12AAZmeAg+aXw: calls $0.50
+ZlnqPoP3Hg4BIUxDfKd/A: calls $0.50
*** FLOP *** [Kh 7s 7d]
FpN4KbLjlyRRKiVaQcoLqA: checks 
6DwBRH+xZ12AAZmeAg+aXw: checks 
+ZlnqPoP3Hg4BIUxDfKd/A: checks 
*** TURN *** [Kh 7s 7d] [9c]
FpN4KbLjlyRRKiVaQcoLqA: checks 
6DwBRH+xZ12AAZmeAg+aXw: checks 
+ZlnqPoP3Hg4BIUxDfKd/A: checks 
*** RIVER *** [Kh 7s 7d 9c] [Ts]
FpN4KbLjlyRRKiVaQcoLqA: checks 
6DwBRH+xZ12AAZmeAg+aXw: checks 
+ZlnqPoP3Hg4BIUxDfKd/A: checks 
*** SHOW DOWN ***
FpN4KbLjlyRRKiVaQcoLqA: shows [Qs As] (a pair of Sevens)
6DwBRH+xZ12AAZmeAg+aXw: mucks hand 
+ZlnqPoP3Hg4BIUxDfKd/A: shows [4h 4s] (two pair, Sevens and Fours)
+ZlnqPoP3Hg4BIUxDfKd/A collected $3.80 from pot
*** SUMMARY ***
Total pot $4 | Rake $0.20 
Board [Kh 7s 7d 9c Ts]
Seat 1: v8m8XHovI5tqEA9mvplDSw folded before Flop (didn't bet)
Seat 2: 6DwBRH+xZ12AAZmeAg+aXw mucked
Seat 3: +ZlnqPoP3Hg4BIUxDfKd/A (button) showed [4h 4s] and won ($3.80) with two pair, Sevens and Fours
Seat 4: FpN4KbLjlyRRKiVaQcoLqA (small blind) showed [Qs As] and lost with a pair of Sevens
Seat 5: if4dh6jhJXeN3/qd3qCp9g (big blind) folded before Flop
Seat 6: Lh8SlCq3OSDKWLUgAI/Lxw folded before Flop (didn't bet)




PokerStars Game #59941938888:  Hold'em No Limit ($0.10/$0.25) - 2009/07/01 1:50:58 ET
Table 'AJGgX1ZYM8d68SWMvaLttg' 6-max Seat #6 is the button
Seat 1: Q1uciOZPBR/WkAlqa6cL4A ($25 in chips) 
Seat 2: zHHLkD2sRljslKKeQv/ZQw ($25.25 in chips) 
Seat 3: 8ClCHtFXGNplITm+63KB+Q ($38.95 in chips) 
Seat 4: e30C3DfdG5TfPnR16/oMmA ($21.75 in chips) 
Seat 5: Hsvkc0/G2VV78oVmWYXecw ($5 in chips) 
Seat 6: UA5OsKS3VPaxa7uC8La/kA ($63.65 in chips) 
Q1uciOZPBR/WkAlqa6cL4A: posts small blind $0.10
zHHLkD2sRljslKKeQv/ZQw: posts big blind $0.25
*** HOLE CARDS ***
8ClCHtFXGNplITm+63KB+Q: folds 
e30C3DfdG5TfPnR16/oMmA: folds 
Hsvkc0/G2VV78oVmWYXecw: folds 
Hsvkc0/G2VV78oVmWYXecw leaves the table
UA5OsKS3VPaxa7uC8La/kA: raises $0.50 to $0.75
Q1uciOZPBR/WkAlqa6cL4A: folds 
zHHLkD2sRljslKKeQv/ZQw: folds 
Uncalled bet ($0.50) returned to UA5OsKS3VPaxa7uC8La/kA
UA5OsKS3VPaxa7uC8La/kA collected $0.60 from pot
*** SUMMARY ***
Total pot $0.60 | Rake $0 
Seat 1: Q1uciOZPBR/WkAlqa6cL4A (small blind) folded before Flop
Seat 2: zHHLkD2sRljslKKeQv/ZQw (big blind) folded before Flop
Seat 3: 8ClCHtFXGNplITm+63KB+Q folded before Flop (didn't bet)
Seat 4: e30C3DfdG5TfPnR16/oMmA folded before Flop (didn't bet)
Seat 5: Hsvkc0/G2VV78oVmWYXecw folded before Flop (didn't bet)
Seat 6: UA5OsKS3VPaxa7uC8La/kA (button) collected ($0.60)




PokerStars Game #59941938940:  Hold'em No Limit ($0.10/$0.25) - 2009/07/01 1:50:58 ET
Table 'xmJKTGBeWCwutccj3YfupQ' 6-max Seat #4 is the button
Seat 1: sVbkVl4OznxBCfi66UB9vw ($40.90 in chips) 
Seat 2: QqiZLFrN8iOUT/GHw7ztOA ($23.95 in chips) 
Seat 3: T5wrp/d5jarm+SxNy8OQAg ($17.45 in chips) 
Seat 4: uWjhTVMpuIroxXcmD3Okug ($15.80 in chips) 
Seat 5: DE9hRlt14g+JdsRQ4wT7hg ($38.80 in chips) 
Seat 6: 9bpVv1/Qh9IYtXuCtl5VtQ ($25 in chips) 
DE9hRlt14g+JdsRQ4wT7hg: posts small blind $0.10
9bpVv1/Qh9IYtXuCtl5VtQ: posts big blind $0.25
*** HOLE CARDS ***
T5wrp/d5jarm+SxNy8OQAg said, "nh"
sVbkVl4OznxBCfi66UB9vw: folds 
QqiZLFrN8iOUT/GHw7ztOA: raises $0.75 to $1
T5wrp/d5jarm+SxNy8OQAg: folds 
uWjhTVMpuIroxXcmD3Okug: folds 
DE9hRlt14g+JdsRQ4wT7hg: folds 
9bpVv1/Qh9IYtXuCtl5VtQ: folds 
Uncalled bet ($0.75) returned to QqiZLFrN8iOUT/GHw7ztOA
QqiZLFrN8iOUT/GHw7ztOA collected $0.60 from pot
*** SUMMARY ***
Total pot $0.60 | Rake $0 
Seat 1: sVbkVl4OznxBCfi66UB9vw folded before Flop (didn't bet)
Seat 2: QqiZLFrN8iOUT/GHw7ztOA collected ($0.60)
Seat 3: T5wrp/d5jarm+SxNy8OQAg folded before Flop (didn't bet)
Seat 4: uWjhTVMpuIroxXcmD3Okug (button) folded before Flop (didn't bet)
Seat 5: DE9hRlt14g+JdsRQ4wT7hg (small blind) folded before Flop
Seat 6: 9bpVv1/Qh9IYtXuCtl5VtQ (big blind) folded before Flop




PokerStars Game #59941939232:  Hold'em No Limit ($0.10/$0.25) - 2009/07/01 1:50:58 ET
Table 'FBhJjLqab11/gKu8nyB/tw' 9-max Seat #4 is the button
Seat 1: +sbyWwIcFp9kP0bDtMegfQ ($18.30 in chips) 
Seat 3: V6p0jQ/RhUsqpHLmXvEX4Q ($12.35 in chips) 
Seat 4: CvL9Ch1HYCVbTsfpNucitg ($5.15 in chips) 
Seat 5: Mh2r9hTeTEDnh19sRZtW3g ($4.75 in chips) 
Seat 6: cZ99hugmLBj9KhTlc8nCSw ($31.70 in chips) 
Seat 7: CT7Xj/V/O5rBlhtt+RZeFQ ($25 in chips) 
Seat 8: Th3FldXKQW6hWVVPahaoOQ ($27.25 in chips) 
Mh2r9hTeTEDnh19sRZtW3g: posts small blind $0.10
cZ99hugmLBj9KhTlc8nCSw: posts big blind $0.25
H5Se03ZqSX7tbULXur2MAg: sits out 
18G4P1XstjNvItdGUITxgw: sits out 
*** HOLE CARDS ***
CT7Xj/V/O5rBlhtt+RZeFQ: folds 
Th3FldXKQW6hWVVPahaoOQ: folds 
+sbyWwIcFp9kP0bDtMegfQ: folds 
V6p0jQ/RhUsqpHLmXvEX4Q: folds 
CvL9Ch1HYCVbTsfpNucitg: folds 
Mh2r9hTeTEDnh19sRZtW3g: raises $0.50 to $0.75
cZ99hugmLBj9KhTlc8nCSw: folds 
Uncalled bet ($0.50) returned to Mh2r9hTeTEDnh19sRZtW3g
Mh2r9hTeTEDnh19sRZtW3g collected $0.50 from pot
Mh2r9hTeTEDnh19sRZtW3g: doesn't show hand 
*** SUMMARY ***
Total pot $0.50 | Rake $0 
Seat 1: +sbyWwIcFp9kP0bDtMegfQ folded before Flop (didn't bet)
Seat 3: V6p0jQ/RhUsqpHLmXvEX4Q folded before Flop (didn't bet)
Seat 4: CvL9Ch1HYCVbTsfpNucitg (button) folded before Flop (didn't bet)
Seat 5: Mh2r9hTeTEDnh19sRZtW3g (small blind) collected ($0.50)
Seat 6: cZ99hugmLBj9KhTlc8nCSw (big blind) folded before Flop
Seat 7: CT7Xj/V/O5rBlhtt+RZeFQ folded before Flop (didn't bet)
Seat 8: Th3FldXKQW6hWVVPahaoOQ folded before Flop (didn't bet)




PokerStars Game #59941939476:  Hold'em No Limit ($0.10/$0.25) - 2009/07/01 1:50:59 ET
Table 'sCop8wmj9zlSS2KJqk1QKQ' 9-max Seat #3 is the button
Seat 1: dtZ84flFEi4Q+SGrHMJRDQ ($39.85 in chips) 
Seat 2: YZaC69gFrepA6oCGtu7E0w ($41.10 in chips) 
Seat 3: M/9j4wkHH9i1JM51vgi1VA ($25.55 in chips) 
Seat 4: msUzkZl2RntUnTl6E8WaNA ($15.40 in chips) 
Seat 6: 6RiVTYll/5D8zICp0MRpKw ($25 in chips) 
Seat 8: xnVwSkROfRtOw4eSoDANtw ($19.55 in chips) 
Seat 9: tLcDklc2rBORNfixyRfVfw ($25 in chips) 
msUzkZl2RntUnTl6E8WaNA: posts small blind $0.10
6RiVTYll/5D8zICp0MRpKw: posts big blind $0.25
18G4P1XstjNvItdGUITxgw: sits out 
*** HOLE CARDS ***
xnVwSkROfRtOw4eSoDANtw: folds 
CvL9Ch1HYCVbTsfpNucitg joins the table at seat #5 
tLcDklc2rBORNfixyRfVfw: calls $0.25
dtZ84flFEi4Q+SGrHMJRDQ: folds 
YZaC69gFrepA6oCGtu7E0w: folds 
M/9j4wkHH9i1JM51vgi1VA: calls $0.25
msUzkZl2RntUnTl6E8WaNA: folds 
6RiVTYll/5D8zICp0MRpKw: checks 
*** FLOP *** [Qc 2d Th]
6RiVTYll/5D8zICp0MRpKw: checks 
tLcDklc2rBORNfixyRfVfw: checks 
M/9j4wkHH9i1JM51vgi1VA: bets $0.75
6RiVTYll/5D8zICp0MRpKw: folds 
tLcDklc2rBORNfixyRfVfw: folds 
Uncalled bet ($0.75) returned to M/9j4wkHH9i1JM51vgi1VA
M/9j4wkHH9i1JM51vgi1VA collected $0.85 from pot
M/9j4wkHH9i1JM51vgi1VA: doesn't show hand 
*** SUMMARY ***
Total pot $0.85 | Rake $0 
Board [Qc 2d Th]
Seat 1: dtZ84flFEi4Q+SGrHMJRDQ folded before Flop (didn't bet)
Seat 2: YZaC69gFrepA6oCGtu7E0w folded before Flop (didn't bet)
Seat 3: M/9j4wkHH9i1JM51vgi1VA (button) collected ($0.85)
Seat 4: msUzkZl2RntUnTl6E8WaNA (small blind) folded before Flop
Seat 6: 6RiVTYll/5D8zICp0MRpKw (big blind) folded on the Flop
Seat 8: xnVwSkROfRtOw4eSoDANtw folded before Flop (didn't bet)
Seat 9: tLcDklc2rBORNfixyRfVfw folded on the Flop




PokerStars Game #59941939268:  Hold'em No Limit ($0.10/$0.25) - 2009/07/01 1:50:59 ET
Table 'mdub7rJf3Z5tCT9s/+1+Wg' 9-max Seat #7 is the button
Seat 2: 539MC3AwKLWVFwzABc644Q ($10.90 in chips) 
Seat 3: PdIasPkzm2sqZnN41ZRXOg ($11.65 in chips) 
Seat 4: fDGyaQz0cs2s4FOYxkbIHA ($14.50 in chips) 
Seat 5: dfNim92Z6XK1/h5SFW5vDg ($25.90 in chips) 
Seat 6: T/CCwAWe2yhO0c4oHNwicw ($17.30 in chips) 
Seat 7: woe+9KKk+L3pZgMTuHcmog ($15.20 in chips) 
Seat 8: bXpVeaSTPBFSPJmeXxO7nw ($4.75 in chips) 
bXpVeaSTPBFSPJmeXxO7nw: posts small blind $0.10
tYsOBqdU1+x+yFI7zHO7hQ: is sitting out 
cZ99hugmLBj9KhTlc8nCSw: is sitting out 
539MC3AwKLWVFwzABc644Q: posts big blind $0.25
*** HOLE CARDS ***
tYsOBqdU1+x+yFI7zHO7hQ leaves the table
cZ99hugmLBj9KhTlc8nCSw leaves the table
PdIasPkzm2sqZnN41ZRXOg: folds 
fDGyaQz0cs2s4FOYxkbIHA: folds 
dfNim92Z6XK1/h5SFW5vDg: folds 
T/CCwAWe2yhO0c4oHNwicw: calls $0.25
woe+9KKk+L3pZgMTuHcmog: raises $0.75 to $1
bXpVeaSTPBFSPJmeXxO7nw: folds 
539MC3AwKLWVFwzABc644Q: folds 
T/CCwAWe2yhO0c4oHNwicw: folds 
Uncalled bet ($0.75) returned to woe+9KKk+L3pZgMTuHcmog
woe+9KKk+L3pZgMTuHcmog collected $0.85 from pot
*** SUMMARY ***
Total pot $0.85 | Rake $0 
Seat 2: 539MC3AwKLWVFwzABc644Q (big blind) folded before Flop
Seat 3: PdIasPkzm2sqZnN41ZRXOg folded before Flop (didn't bet)
Seat 4: fDGyaQz0cs2s4FOYxkbIHA folded before Flop (didn't bet)
Seat 5: dfNim92Z6XK1/h5SFW5vDg folded before Flop (didn't bet)
Seat 6: T/CCwAWe2yhO0c4oHNwicw folded before Flop
Seat 7: woe+9KKk+L3pZgMTuHcmog (button) collected ($0.85)
Seat 8: bXpVeaSTPBFSPJmeXxO7nw (small blind) folded before Flop




PokerStars Game #59941939558:  Hold'em No Limit ($0.10/$0.25) - 2009/07/01 1:50:59 ET
Table '3Ns9nuTkynfwbBfBXzg6ww' 6-max Seat #4 is the button
Seat 1: epAUIB7h2FJXzUPRIvSkRA ($25 in chips) 
Seat 2: zxeVQGaMKDsDzmSY+AInjA ($34 in chips) 
Seat 3: eL3+wCBjFGfQ5FMdIZihwA ($23.60 in chips) 
Seat 4: qGHGf/553gQnDoklMRe3tg ($30.50 in chips) 
Seat 5: wqphQtauX5Qn7WRJZS1flA ($23.80 in chips) 
Seat 6: DE9hRlt14g+JdsRQ4wT7hg ($39.10 in chips) 
wqphQtauX5Qn7WRJZS1flA: posts small blind $0.10
DE9hRlt14g+JdsRQ4wT7hg: posts big blind $0.25
*** HOLE CARDS ***
epAUIB7h2FJXzUPRIvSkRA: folds 
zxeVQGaMKDsDzmSY+AInjA: folds 
eL3+wCBjFGfQ5FMdIZihwA: folds 
qGHGf/553gQnDoklMRe3tg: raises $0.75 to $1
wqphQtauX5Qn7WRJZS1flA: folds 
DE9hRlt14g+JdsRQ4wT7hg: calls $0.75
*** FLOP *** [Jc Kc 5d]
DE9hRlt14g+JdsRQ4wT7hg: checks 
qGHGf/553gQnDoklMRe3tg: bets $1.50
DE9hRlt14g+JdsRQ4wT7hg: folds 
Uncalled bet ($1.50) returned to qGHGf/553gQnDoklMRe3tg
qGHGf/553gQnDoklMRe3tg collected $2 from pot
qGHGf/553gQnDoklMRe3tg: doesn't show hand 
*** SUMMARY ***
Total pot $2.10 | Rake $0.10 
Board [Jc Kc 5d]
Seat 1: epAUIB7h2FJXzUPRIvSkRA folded before Flop (didn't bet)
Seat 2: zxeVQGaMKDsDzmSY+AInjA folded before Flop (didn't bet)
Seat 3: eL3+wCBjFGfQ5FMdIZihwA folded before Flop (didn't bet)
Seat 4: qGHGf/553gQnDoklMRe3tg (button) collected ($2)
Seat 5: wqphQtauX5Qn7WRJZS1flA (small blind) folded before Flop
Seat 6: DE9hRlt14g+JdsRQ4wT7hg (big blind) folded on the Flop




PokerStars Game #59941939550:  Hold'em No Limit ($0.10/$0.25) - 2009/07/01 1:50:59 ET
Table 'gnrUwXkIPE0C8xl6cB4Hyw' 9-max Seat #9 is the button
Seat 1: EQXHDnIzAsORnIXRNtXRlA ($22.70 in chips) 
Seat 2: 7je+LC5Mfs6nL8YBVh4frQ ($5 in chips) 
Seat 3: PdIasPkzm2sqZnN41ZRXOg ($5.70 in chips) 
Seat 4: wGigCmBR/9XWkPpvYos3aQ ($25 in chips) 
Seat 5: gehe91e0IyVT0QU/XBkEyg ($31.30 in chips) 
Seat 6: dtZ84flFEi4Q+SGrHMJRDQ ($25.80 in chips) 
Seat 8: 4awUyiDYTgylQKXZ9faBVA ($60.30 in chips) 
Seat 9: F7pnn6czNpHvRM55XcA2EA ($25 in chips) 
EQXHDnIzAsORnIXRNtXRlA: posts small blind $0.10
7je+LC5Mfs6nL8YBVh4frQ: posts big blind $0.25
*** HOLE CARDS ***
PdIasPkzm2sqZnN41ZRXOg: folds 
wGigCmBR/9XWkPpvYos3aQ: folds 
gehe91e0IyVT0QU/XBkEyg has timed out
gehe91e0IyVT0QU/XBkEyg: folds 
gehe91e0IyVT0QU/XBkEyg is sitting out
gehe91e0IyVT0QU/XBkEyg has returned
dtZ84flFEi4Q+SGrHMJRDQ: folds 
4awUyiDYTgylQKXZ9faBVA: raises $0.75 to $1
F7pnn6czNpHvRM55XcA2EA: folds 
RHqgdFvufLCYe54+qd2gcA joins the table at seat #7 
EQXHDnIzAsORnIXRNtXRlA: folds 
7je+LC5Mfs6nL8YBVh4frQ: folds 
Uncalled bet ($0.75) returned to 4awUyiDYTgylQKXZ9faBVA
4awUyiDYTgylQKXZ9faBVA collected $0.60 from pot
4awUyiDYTgylQKXZ9faBVA: doesn't show hand 
*** SUMMARY ***
Total pot $0.60 | Rake $0 
Seat 1: EQXHDnIzAsORnIXRNtXRlA (small blind) folded before Flop
Seat 2: 7je+LC5Mfs6nL8YBVh4frQ (big blind) folded before Flop
Seat 3: PdIasPkzm2sqZnN41ZRXOg folded before Flop (didn't bet)
Seat 4: wGigCmBR/9XWkPpvYos3aQ folded before Flop (didn't bet)
Seat 5: gehe91e0IyVT0QU/XBkEyg folded before Flop (didn't bet)
Seat 6: dtZ84flFEi4Q+SGrHMJRDQ folded before Flop (didn't bet)
Seat 8: 4awUyiDYTgylQKXZ9faBVA collected ($0.60)
Seat 9: F7pnn6czNpHvRM55XcA2EA (button) folded before Flop (didn't bet)




PokerStars Game #59941939976:  Hold'em No Limit ($0.10/$0.25) - 2009/07/01 1:51:00 ET
Table 'YYMg5qzxK1m9eGRo4SbxtQ' 9-max Seat #7 is the button
Seat 1: 3PmVnC/15cl4oyI1TKIt4g ($5 in chips) 
Seat 2: f/H6PsHRl4W1JyNsEDvPtg ($14.60 in chips) 
Seat 3: eK8qa6EPcH2zhtbmWSvc9g ($25.25 in chips) 
Seat 4: ROxrieegd9WYtWcUKJAlbg ($10.25 in chips) 
Seat 5: 4awUyiDYTgylQKXZ9faBVA ($25 in chips) 
Seat 6: S5VeQLgBIiHrfs9AB2vBwA ($3.70 in chips) 
Seat 7: sUVgUtgbfVx6JpvApozwhQ ($7.45 in chips) 
Seat 8: xoBFd/5k+L/pFn9VW1VyWg ($13.70 in chips) 
Seat 9: +sbyWwIcFp9kP0bDtMegfQ ($31.60 in chips) 
xoBFd/5k+L/pFn9VW1VyWg: posts small blind $0.10
+sbyWwIcFp9kP0bDtMegfQ: posts big blind $0.25
*** HOLE CARDS ***
3PmVnC/15cl4oyI1TKIt4g: folds 
f/H6PsHRl4W1JyNsEDvPtg: folds 
eK8qa6EPcH2zhtbmWSvc9g: folds 
ROxrieegd9WYtWcUKJAlbg: calls $0.25
4awUyiDYTgylQKXZ9faBVA: raises $0.75 to $1
S5VeQLgBIiHrfs9AB2vBwA: calls $1
sUVgUtgbfVx6JpvApozwhQ: folds 
xoBFd/5k+L/pFn9VW1VyWg: folds 
+sbyWwIcFp9kP0bDtMegfQ: folds 
ROxrieegd9WYtWcUKJAlbg: raises $0.75 to $1.75
4awUyiDYTgylQKXZ9faBVA: folds 
S5VeQLgBIiHrfs9AB2vBwA: calls $0.75
*** FLOP *** [2d Qc Ts]
ROxrieegd9WYtWcUKJAlbg: bets $0.25
S5VeQLgBIiHrfs9AB2vBwA: calls $0.25
*** TURN *** [2d Qc Ts] [6c]
ROxrieegd9WYtWcUKJAlbg: bets $0.25
S5VeQLgBIiHrfs9AB2vBwA: calls $0.25
*** RIVER *** [2d Qc Ts 6c] [Jh]
ROxrieegd9WYtWcUKJAlbg: bets $0.25
S5VeQLgBIiHrfs9AB2vBwA: raises $1 to $1.25
ROxrieegd9WYtWcUKJAlbg: calls $1
*** SHOW DOWN ***
S5VeQLgBIiHrfs9AB2vBwA: shows [Ah Kh] (a straight, Ten to Ace)
ROxrieegd9WYtWcUKJAlbg: mucks hand 
S5VeQLgBIiHrfs9AB2vBwA collected $7.95 from pot
*** SUMMARY ***
Total pot $8.35 | Rake $0.40 
Board [2d Qc Ts 6c Jh]
Seat 1: 3PmVnC/15cl4oyI1TKIt4g folded before Flop (didn't bet)
Seat 2: f/H6PsHRl4W1JyNsEDvPtg folded before Flop (didn't bet)
Seat 3: eK8qa6EPcH2zhtbmWSvc9g folded before Flop (didn't bet)
Seat 4: ROxrieegd9WYtWcUKJAlbg mucked
Seat 5: 4awUyiDYTgylQKXZ9faBVA folded before Flop
Seat 6: S5VeQLgBIiHrfs9AB2vBwA showed [Ah Kh] and won ($7.95) with a straight, Ten to Ace
Seat 7: sUVgUtgbfVx6JpvApozwhQ (button) folded before Flop (didn't bet)
Seat 8: xoBFd/5k+L/pFn9VW1VyWg (small blind) folded before Flop
Seat 9: +sbyWwIcFp9kP0bDtMegfQ (big blind) folded before Flop




PokerStars Game #59941940104:  Hold'em No Limit ($0.10/$0.25) - 2009/07/01 1:51:00 ET
Table '8QBBaev+cI2i/r2H6ml/lg' 9-max Seat #4 is the button
Seat 1: s2xLPOl/vhl/26apJ3vsOQ ($38.40 in chips) 
Seat 2: y7tkvDmwKjURBkr73SZPXw ($10.15 in chips) 
Seat 3: zgi+EUykT/pZQpoUG6+oEg ($4.30 in chips) 
Seat 4: ytpGB2nr/CLVHnyKMRiEFQ ($17.10 in chips) 
Seat 5: 0QdZrkFD7aGKeBXPGbIomA ($11.20 in chips) 
Seat 6: X6+pSIPfovPcE87t+LmUKQ ($5 in chips) 
Seat 7: eK8qa6EPcH2zhtbmWSvc9g ($30.05 in chips) 
Seat 8: vr1IK/Q4HXm8s8V0/dePzQ ($11.60 in chips) 
Seat 9: EUMLvzDkECHBit+xa+uGjg ($23.75 in chips) 
0QdZrkFD7aGKeBXPGbIomA: posts small blind $0.10
X6+pSIPfovPcE87t+LmUKQ: posts big blind $0.25
*** HOLE CARDS ***
eK8qa6EPcH2zhtbmWSvc9g: folds 
vr1IK/Q4HXm8s8V0/dePzQ: calls $0.25
EUMLvzDkECHBit+xa+uGjg: folds 
s2xLPOl/vhl/26apJ3vsOQ: folds 
y7tkvDmwKjURBkr73SZPXw: calls $0.25
zgi+EUykT/pZQpoUG6+oEg: folds 
ytpGB2nr/CLVHnyKMRiEFQ: raises $0.75 to $1
0QdZrkFD7aGKeBXPGbIomA: folds 
X6+pSIPfovPcE87t+LmUKQ: folds 
vr1IK/Q4HXm8s8V0/dePzQ: calls $0.75
y7tkvDmwKjURBkr73SZPXw: calls $0.75
*** FLOP *** [2d 5c Td]
vr1IK/Q4HXm8s8V0/dePzQ: checks 
y7tkvDmwKjURBkr73SZPXw: checks 
ytpGB2nr/CLVHnyKMRiEFQ: bets $1.50
vr1IK/Q4HXm8s8V0/dePzQ: folds 
y7tkvDmwKjURBkr73SZPXw: calls $1.50
*** TURN *** [2d 5c Td] [Th]
y7tkvDmwKjURBkr73SZPXw: checks 
ytpGB2nr/CLVHnyKMRiEFQ: checks 
*** RIVER *** [2d 5c Td Th] [4h]
y7tkvDmwKjURBkr73SZPXw: checks 
ytpGB2nr/CLVHnyKMRiEFQ: bets $2
y7tkvDmwKjURBkr73SZPXw: folds 
Uncalled bet ($2) returned to ytpGB2nr/CLVHnyKMRiEFQ
ytpGB2nr/CLVHnyKMRiEFQ collected $6.05 from pot
ytpGB2nr/CLVHnyKMRiEFQ: doesn't show hand 
*** SUMMARY ***
Total pot $6.35 | Rake $0.30 
Board [2d 5c Td Th 4h]
Seat 1: s2xLPOl/vhl/26apJ3vsOQ folded before Flop (didn't bet)
Seat 2: y7tkvDmwKjURBkr73SZPXw folded on the River
Seat 3: zgi+EUykT/pZQpoUG6+oEg folded before Flop (didn't bet)
Seat 4: ytpGB2nr/CLVHnyKMRiEFQ (button) collected ($6.05)
Seat 5: 0QdZrkFD7aGKeBXPGbIomA (small blind) folded before Flop
Seat 6: X6+pSIPfovPcE87t+LmUKQ (big blind) folded before Flop
Seat 7: eK8qa6EPcH2zhtbmWSvc9g folded before Flop (didn't bet)
Seat 8: vr1IK/Q4HXm8s8V0/dePzQ folded on the Flop
Seat 9: EUMLvzDkECHBit+xa+uGjg folded before Flop (didn't bet)




PokerStars Game #59941940314:  Hold'em No Limit ($0.10/$0.25) - 2009/07/01 1:51:00 ET
Table '8PD/MTROSMd6Y8mZeykbpg' 6-max Seat #3 is the button
Seat 1: fxNpaToxECtD2Goelmg9vA ($28.50 in chips) 
Seat 2: 4TM16KVgEiQpLi4bVVWbVQ ($31.60 in chips) 
Seat 3: vqWjZmdQu/Hxw96/IJTWdQ ($25 in chips) 
Seat 4: DFi/Lzkjsfv8QswS80JX9Q ($47.80 in chips) 
Seat 5: z3tQwy28dp5FykDJC/wzQw ($26.20 in chips) 
Seat 6: trN/oHqTTbPw5MNuKrOpLw ($25.25 in chips) 
DFi/Lzkjsfv8QswS80JX9Q: posts small blind $0.10
z3tQwy28dp5FykDJC/wzQw: posts big blind $0.25
*** HOLE CARDS ***
trN/oHqTTbPw5MNuKrOpLw: folds 
fxNpaToxECtD2Goelmg9vA: folds 
4TM16KVgEiQpLi4bVVWbVQ: folds 
vqWjZmdQu/Hxw96/IJTWdQ: folds 
DFi/Lzkjsfv8QswS80JX9Q: folds 
Uncalled bet ($0.15) returned to z3tQwy28dp5FykDJC/wzQw
z3tQwy28dp5FykDJC/wzQw collected $0.20 from pot
*** SUMMARY ***
Total pot $0.20 | Rake $0 
Seat 1: fxNpaToxECtD2Goelmg9vA folded before Flop (didn't bet)
Seat 2: 4TM16KVgEiQpLi4bVVWbVQ folded before Flop (didn't bet)
Seat 3: vqWjZmdQu/Hxw96/IJTWdQ (button) folded before Flop (didn't bet)
Seat 4: DFi/Lzkjsfv8QswS80JX9Q (small blind) folded before Flop
Seat 5: z3tQwy28dp5FykDJC/wzQw (big blind) collected ($0.20)
Seat 6: trN/oHqTTbPw5MNuKrOpLw folded before Flop (didn't bet)




PokerStars Game #59941940826:  Hold'em No Limit ($0.10/$0.25) - 2009/07/01 1:51:01 ET
Table '0w9m+UkNlGMNoPyQqzWk6A' 9-max Seat #6 is the button
Seat 3: VWwtMkIjXloiX/RKh7RGWQ ($10.05 in chips) 
Seat 5: HPEB+AtKw1+C/cxU0o1ciw ($46.55 in chips) 
Seat 6: CgIo2ItZqi4o3ayVG6HanQ ($27.70 in chips) 
Seat 7: 57qrNGHDvf6GhB8zVLsAtQ ($4.20 in chips) 
Seat 8: cZ99hugmLBj9KhTlc8nCSw ($25 in chips) 
Seat 9: KqS/lY/fNB9qUxokm9QfeA ($12.45 in chips) 
57qrNGHDvf6GhB8zVLsAtQ: posts small blind $0.10
cZ99hugmLBj9KhTlc8nCSw: posts big blind $0.25
18G4P1XstjNvItdGUITxgw: sits out 
M1nKET7WOTLbVPuAbJa3EA: sits out 
z5GxcHlYz/GSz6W2uFiTtg: sits out 
*** HOLE CARDS ***
KqS/lY/fNB9qUxokm9QfeA: calls $0.25
VWwtMkIjXloiX/RKh7RGWQ: folds 
HPEB+AtKw1+C/cxU0o1ciw: folds 
CgIo2ItZqi4o3ayVG6HanQ: raises $0.50 to $0.75
57qrNGHDvf6GhB8zVLsAtQ: folds 
cZ99hugmLBj9KhTlc8nCSw: folds 
KqS/lY/fNB9qUxokm9QfeA: calls $0.50
*** FLOP *** [2s 2h 7s]
KqS/lY/fNB9qUxokm9QfeA: checks 
CgIo2ItZqi4o3ayVG6HanQ: checks 
*** TURN *** [2s 2h 7s] [Jd]
KqS/lY/fNB9qUxokm9QfeA: bets $0.75
CgIo2ItZqi4o3ayVG6HanQ: folds 
Uncalled bet ($0.75) returned to KqS/lY/fNB9qUxokm9QfeA
KqS/lY/fNB9qUxokm9QfeA collected $1.80 from pot
*** SUMMARY ***
Total pot $1.85 | Rake $0.05 
Board [2s 2h 7s Jd]
Seat 3: VWwtMkIjXloiX/RKh7RGWQ folded before Flop (didn't bet)
Seat 5: HPEB+AtKw1+C/cxU0o1ciw folded before Flop (didn't bet)
Seat 6: CgIo2ItZqi4o3ayVG6HanQ (button) folded on the Turn
Seat 7: 57qrNGHDvf6GhB8zVLsAtQ (small blind) folded before Flop
Seat 8: cZ99hugmLBj9KhTlc8nCSw (big blind) folded before Flop
Seat 9: KqS/lY/fNB9qUxokm9QfeA collected ($1.80)




PokerStars Game #59941940656:  Hold'em No Limit ($0.10/$0.25) - 2009/07/01 1:51:01 ET
Table '+VTTYgQLH1awDHk+IAxqGg' 9-max Seat #1 is the button
Seat 1: arxNSjreDRGFg13EAM2F1w ($26.55 in chips) 
Seat 2: 2wcFsZsqEP5w1StUTVzJCg ($6.15 in chips) 
Seat 3: AiXn/9o1EwOPZUHujnh/bA ($11.40 in chips) 
Seat 4: gE5rN2TDY1aXcZn/TOPeZw ($8.90 in chips) 
Seat 5: sD+TKtt36XiiN6jqHiLwDA ($24.80 in chips) 
Seat 6: clJsV3v77RS07bDKY+705w ($6.05 in chips) 
Seat 7: ljemhp25Zg+nlA9DLCIiUw ($25 in chips) 
Seat 8: 10vzP4r6ldwGLbYHKd9www ($18.65 in chips) 
Seat 9: S7Ki0P+0AIGPuIfGJjW0gg ($61.15 in chips) 
2wcFsZsqEP5w1StUTVzJCg: posts small blind $0.10
AiXn/9o1EwOPZUHujnh/bA: posts big blind $0.25
*** HOLE CARDS ***
gE5rN2TDY1aXcZn/TOPeZw: folds 
sD+TKtt36XiiN6jqHiLwDA: raises $0.75 to $1
clJsV3v77RS07bDKY+705w: folds 
ljemhp25Zg+nlA9DLCIiUw: raises $3 to $4
10vzP4r6ldwGLbYHKd9www: folds 
S7Ki0P+0AIGPuIfGJjW0gg: folds 
arxNSjreDRGFg13EAM2F1w: folds 
2wcFsZsqEP5w1StUTVzJCg: folds 
AiXn/9o1EwOPZUHujnh/bA: folds 
sD+TKtt36XiiN6jqHiLwDA: raises $20.80 to $24.80 and is all-in
ljemhp25Zg+nlA9DLCIiUw: folds 
Uncalled bet ($20.80) returned to sD+TKtt36XiiN6jqHiLwDA
sD+TKtt36XiiN6jqHiLwDA collected $8.35 from pot
sD+TKtt36XiiN6jqHiLwDA: doesn't show hand 
*** SUMMARY ***
Total pot $8.35 | Rake $0 
Seat 1: arxNSjreDRGFg13EAM2F1w (button) folded before Flop (didn't bet)
Seat 2: 2wcFsZsqEP5w1StUTVzJCg (small blind) folded before Flop
Seat 3: AiXn/9o1EwOPZUHujnh/bA (big blind) folded before Flop
Seat 4: gE5rN2TDY1aXcZn/TOPeZw folded before Flop (didn't bet)
Seat 5: sD+TKtt36XiiN6jqHiLwDA collected ($8.35)
Seat 6: clJsV3v77RS07bDKY+705w folded before Flop (didn't bet)
Seat 7: ljemhp25Zg+nlA9DLCIiUw folded before Flop
Seat 8: 10vzP4r6ldwGLbYHKd9www folded before Flop (didn't bet)
Seat 9: S7Ki0P+0AIGPuIfGJjW0gg folded before Flop (didn't bet)




PokerStars Game #59941940776:  Hold'em No Limit ($0.10/$0.25) - 2009/07/01 1:51:01 ET
Table 'KAnP7XvDtlku47YfJwdOVw' 9-max Seat #4 is the button
Seat 1: cH3q40adP+kFogl+2MtbkQ ($15 in chips) 
Seat 2: E0iYnEVO2ho7dH3QcCjw7g ($19.35 in chips) 
Seat 3: W6tExOcYX7qiy6Qdp+ZwFA ($7.25 in chips) 
Seat 4: 18G4P1XstjNvItdGUITxgw ($25 in chips) 
Seat 5: MG90wfSJZnOejs/KD3vlQQ ($33.75 in chips) 
Seat 6: z5GxcHlYz/GSz6W2uFiTtg ($21.65 in chips) 
Seat 7: Lro4e37x4FUa5P3yzDjskw ($9.15 in chips) 
Seat 8: OneeONzF0MoH0pEdcBndwA ($22.45 in chips) 
Seat 9: HDDm1BkZtdsRyw2DJdqq6A ($21.30 in chips) 
MG90wfSJZnOejs/KD3vlQQ: posts small blind $0.10
z5GxcHlYz/GSz6W2uFiTtg: posts big blind $0.25
*** HOLE CARDS ***
Lro4e37x4FUa5P3yzDjskw: folds 
OneeONzF0MoH0pEdcBndwA: folds 
HDDm1BkZtdsRyw2DJdqq6A: folds 
cH3q40adP+kFogl+2MtbkQ: folds 
E0iYnEVO2ho7dH3QcCjw7g: folds 
W6tExOcYX7qiy6Qdp+ZwFA: raises $0.50 to $0.75
18G4P1XstjNvItdGUITxgw: folds 
MG90wfSJZnOejs/KD3vlQQ: folds 
z5GxcHlYz/GSz6W2uFiTtg: folds 
Uncalled bet ($0.50) returned to W6tExOcYX7qiy6Qdp+ZwFA
W6tExOcYX7qiy6Qdp+ZwFA collected $0.60 from pot
W6tExOcYX7qiy6Qdp+ZwFA: doesn't show hand 
*** SUMMARY ***
Total pot $0.60 | Rake $0 
Seat 1: cH3q40adP+kFogl+2MtbkQ folded before Flop (didn't bet)
Seat 2: E0iYnEVO2ho7dH3QcCjw7g folded before Flop (didn't bet)
Seat 3: W6tExOcYX7qiy6Qdp+ZwFA collected ($0.60)
Seat 4: 18G4P1XstjNvItdGUITxgw (button) folded before Flop (didn't bet)
Seat 5: MG90wfSJZnOejs/KD3vlQQ (small blind) folded before Flop
Seat 6: z5GxcHlYz/GSz6W2uFiTtg (big blind) folded before Flop
Seat 7: Lro4e37x4FUa5P3yzDjskw folded before Flop (didn't bet)
Seat 8: OneeONzF0MoH0pEdcBndwA folded before Flop (didn't bet)
Seat 9: HDDm1BkZtdsRyw2DJdqq6A folded before Flop (didn't bet)




PokerStars Game #59941940714:  Hold'em No Limit ($0.10/$0.25) - 2009/07/01 1:51:01 ET
Table 'GrYi0DZOHD1EvB+qiLExNw' 9-max Seat #2 is the button
Seat 1: 7je+LC5Mfs6nL8YBVh4frQ ($5 in chips) 
Seat 2: Th3FldXKQW6hWVVPahaoOQ ($46.70 in chips) 
Seat 3: RHqgdFvufLCYe54+qd2gcA ($4.50 in chips) 
Seat 4: 8x95tVlB4uFBVHp71KihMA ($35.75 in chips) 
Seat 5: cZ99hugmLBj9KhTlc8nCSw ($25 in chips) 
Seat 6: arxNSjreDRGFg13EAM2F1w ($25 in chips) 
Seat 7: 9lvO/qyU+xrU95Teu1fv0g ($23.20 in chips) 
Seat 9: 5hAPbqNrvJb8PtLiceXtlg ($14.45 in chips) 
RHqgdFvufLCYe54+qd2gcA: posts small blind $0.10
8x95tVlB4uFBVHp71KihMA: posts big blind $0.25
*** HOLE CARDS ***
cZ99hugmLBj9KhTlc8nCSw: folds 
arxNSjreDRGFg13EAM2F1w: folds 
9lvO/qyU+xrU95Teu1fv0g: folds 
5hAPbqNrvJb8PtLiceXtlg: folds 
7je+LC5Mfs6nL8YBVh4frQ: folds 
Th3FldXKQW6hWVVPahaoOQ: raises $0.50 to $0.75
RHqgdFvufLCYe54+qd2gcA: folds 
8x95tVlB4uFBVHp71KihMA: folds 
Uncalled bet ($0.50) returned to Th3FldXKQW6hWVVPahaoOQ
Th3FldXKQW6hWVVPahaoOQ collected $0.60 from pot
Th3FldXKQW6hWVVPahaoOQ: doesn't show hand 
*** SUMMARY ***
Total pot $0.60 | Rake $0 
Seat 1: 7je+LC5Mfs6nL8YBVh4frQ folded before Flop (didn't bet)
Seat 2: Th3FldXKQW6hWVVPahaoOQ (button) collected ($0.60)
Seat 3: RHqgdFvufLCYe54+qd2gcA (small blind) folded before Flop
Seat 4: 8x95tVlB4uFBVHp71KihMA (big blind) folded before Flop
Seat 5: cZ99hugmLBj9KhTlc8nCSw folded before Flop (didn't bet)
Seat 6: arxNSjreDRGFg13EAM2F1w folded before Flop (didn't bet)
Seat 7: 9lvO/qyU+xrU95Teu1fv0g folded before Flop (didn't bet)
Seat 9: 5hAPbqNrvJb8PtLiceXtlg folded before Flop (didn't bet)




PokerStars Game #59941940778:  Hold'em No Limit ($0.10/$0.25) - 2009/07/01 1:51:01 ET
Table 'IfRHUn9gQQA9I/Z4tn+BoA' 9-max Seat #3 is the button
Seat 1: imHPFFqvfHGzsBBWeGuy4w ($23.75 in chips) 
Seat 2: VWUWpMLMj/Q1jRVpF7Aohw ($16.20 in chips) 
Seat 3: 4qA/3Ajg3pP6fqW+IX9/fQ ($4.65 in chips) 
Seat 4: QEbIGci+itdw+re8RM5fZA ($35.25 in chips) 
Seat 5: DdPXdieucQ+n99u1n3A+rQ ($5 in chips) 
Seat 6: UOjoGGQ58/uDS7V0xkjOrQ ($20.95 in chips) 
Seat 7: YzqSxP03XxZPbgPifgt69g ($33.40 in chips) 
Seat 8: cZ99hugmLBj9KhTlc8nCSw ($27.75 in chips) 
QEbIGci+itdw+re8RM5fZA: posts small blind $0.10
DdPXdieucQ+n99u1n3A+rQ: posts big blind $0.25
18G4P1XstjNvItdGUITxgw: sits out 
*** HOLE CARDS ***
UOjoGGQ58/uDS7V0xkjOrQ: calls $0.25
YzqSxP03XxZPbgPifgt69g: folds 
cZ99hugmLBj9KhTlc8nCSw: folds 
imHPFFqvfHGzsBBWeGuy4w: folds 
VWUWpMLMj/Q1jRVpF7Aohw: calls $0.25
4qA/3Ajg3pP6fqW+IX9/fQ: folds 
QEbIGci+itdw+re8RM5fZA: calls $0.15
DdPXdieucQ+n99u1n3A+rQ: checks 
*** FLOP *** [As 3c 7h]
QEbIGci+itdw+re8RM5fZA: checks 
DdPXdieucQ+n99u1n3A+rQ: checks 
UOjoGGQ58/uDS7V0xkjOrQ: checks 
VWUWpMLMj/Q1jRVpF7Aohw: checks 
*** TURN *** [As 3c 7h] [Kh]
QEbIGci+itdw+re8RM5fZA: checks 
DdPXdieucQ+n99u1n3A+rQ: checks 
UOjoGGQ58/uDS7V0xkjOrQ: bets $1
VWUWpMLMj/Q1jRVpF7Aohw: folds 
QEbIGci+itdw+re8RM5fZA: folds 
DdPXdieucQ+n99u1n3A+rQ: folds 
Uncalled bet ($1) returned to UOjoGGQ58/uDS7V0xkjOrQ
UOjoGGQ58/uDS7V0xkjOrQ collected $0.95 from pot
UOjoGGQ58/uDS7V0xkjOrQ: doesn't show hand 
*** SUMMARY ***
Total pot $1 | Rake $0.05 
Board [As 3c 7h Kh]
Seat 1: imHPFFqvfHGzsBBWeGuy4w folded before Flop (didn't bet)
Seat 2: VWUWpMLMj/Q1jRVpF7Aohw folded on the Turn
Seat 3: 4qA/3Ajg3pP6fqW+IX9/fQ (button) folded before Flop (didn't bet)
Seat 4: QEbIGci+itdw+re8RM5fZA (small blind) folded on the Turn
Seat 5: DdPXdieucQ+n99u1n3A+rQ (big blind) folded on the Turn
Seat 6: UOjoGGQ58/uDS7V0xkjOrQ collected ($0.95)
Seat 7: YzqSxP03XxZPbgPifgt69g folded before Flop (didn't bet)
Seat 8: cZ99hugmLBj9KhTlc8nCSw folded before Flop (didn't bet)




PokerStars Game #59941940594:  Hold'em No Limit ($0.10/$0.25) - 2009/07/01 1:51:01 ET
Table '3lS+sU5k6mwJCS2nFMmQ6Q' 9-max Seat #6 is the button
Seat 1: VWUWpMLMj/Q1jRVpF7Aohw ($13.55 in chips) 
Seat 2: PdIasPkzm2sqZnN41ZRXOg ($5.75 in chips) 
Seat 3: 1DXccE2UUK5DIRVGlOKnTA ($13.80 in chips) 
Seat 4: GeMoapCKDLc4ajT0Uk9ZQw ($9.65 in chips) 
Seat 6: hJ4uYjNmSZdjrKA8cjZqCA ($35.15 in chips) 
Seat 7: Th3FldXKQW6hWVVPahaoOQ ($31.30 in chips) 
Seat 8: 9lvO/qyU+xrU95Teu1fv0g ($5 in chips) 
Seat 9: 4awUyiDYTgylQKXZ9faBVA ($48.20 in chips) 
Th3FldXKQW6hWVVPahaoOQ: posts small blind $0.10
9lvO/qyU+xrU95Teu1fv0g: posts big blind $0.25
*** HOLE CARDS ***
4awUyiDYTgylQKXZ9faBVA: raises $0.75 to $1
VWUWpMLMj/Q1jRVpF7Aohw: folds 
PdIasPkzm2sqZnN41ZRXOg: folds 
1DXccE2UUK5DIRVGlOKnTA: calls $1
GeMoapCKDLc4ajT0Uk9ZQw: folds 
hJ4uYjNmSZdjrKA8cjZqCA: folds 
Th3FldXKQW6hWVVPahaoOQ: folds 
9lvO/qyU+xrU95Teu1fv0g: folds 
*** FLOP *** [5d Th Qc]
4awUyiDYTgylQKXZ9faBVA: bets $1.25
1DXccE2UUK5DIRVGlOKnTA: calls $1.25
*** TURN *** [5d Th Qc] [2d]
4awUyiDYTgylQKXZ9faBVA: bets $3
1DXccE2UUK5DIRVGlOKnTA: calls $3
*** RIVER *** [5d Th Qc 2d] [7h]
4awUyiDYTgylQKXZ9faBVA: bets $8.75
1DXccE2UUK5DIRVGlOKnTA: calls $8.55 and is all-in
Uncalled bet ($0.20) returned to 4awUyiDYTgylQKXZ9faBVA
*** SHOW DOWN ***
4awUyiDYTgylQKXZ9faBVA: shows [Qh Ks] (a pair of Queens)
1DXccE2UUK5DIRVGlOKnTA: mucks hand 
4awUyiDYTgylQKXZ9faBVA collected $26.60 from pot
*** SUMMARY ***
Total pot $27.95 | Rake $1.35 
Board [5d Th Qc 2d 7h]
Seat 1: VWUWpMLMj/Q1jRVpF7Aohw folded before Flop (didn't bet)
Seat 2: PdIasPkzm2sqZnN41ZRXOg folded before Flop (didn't bet)
Seat 3: 1DXccE2UUK5DIRVGlOKnTA mucked
Seat 4: GeMoapCKDLc4ajT0Uk9ZQw folded before Flop (didn't bet)
Seat 6: hJ4uYjNmSZdjrKA8cjZqCA (button) folded before Flop (didn't bet)
Seat 7: Th3FldXKQW6hWVVPahaoOQ (small blind) folded before Flop
Seat 8: 9lvO/qyU+xrU95Teu1fv0g (big blind) folded before Flop
Seat 9: 4awUyiDYTgylQKXZ9faBVA showed [Qh Ks] and won ($26.60) with a pair of Queens




PokerStars Game #59941940772:  Hold'em No Limit ($0.10/$0.25) - 2009/07/01 1:51:01 ET
Table 'DhkrdW2UOy2PfjSW28Kq8w' 6-max Seat #4 is the button
Seat 2: v+QfkGiuj9bgtuNoVnDO8w ($27.30 in chips) 
Seat 3: B3X187C0tXFUfQpCu8pe8A ($21.40 in chips) 
Seat 4: 59HJSCM1X37BkMpI9N0mEw ($22.55 in chips) 
Seat 5: cS21pIxRHx5Gt42o7hPZzw ($11.55 in chips) 
Seat 6: DihMHaz4WNETH1bPDe13kA ($27.10 in chips) 
cS21pIxRHx5Gt42o7hPZzw: posts small blind $0.10
DihMHaz4WNETH1bPDe13kA: posts big blind $0.25
Mhj3q7cxev+XjXZxEE6/Cw: sits out 
*** HOLE CARDS ***
v+QfkGiuj9bgtuNoVnDO8w: folds 
B3X187C0tXFUfQpCu8pe8A: calls $0.25
59HJSCM1X37BkMpI9N0mEw: calls $0.25
cS21pIxRHx5Gt42o7hPZzw: folds 
DihMHaz4WNETH1bPDe13kA: checks 
*** FLOP *** [8h 5s Jh]
DihMHaz4WNETH1bPDe13kA: checks 
B3X187C0tXFUfQpCu8pe8A: checks 
59HJSCM1X37BkMpI9N0mEw: checks 
*** TURN *** [8h 5s Jh] [9d]
DihMHaz4WNETH1bPDe13kA: checks 
B3X187C0tXFUfQpCu8pe8A: checks 
59HJSCM1X37BkMpI9N0mEw: bets $0.50
DihMHaz4WNETH1bPDe13kA: folds 
B3X187C0tXFUfQpCu8pe8A: calls $0.50
*** RIVER *** [8h 5s Jh 9d] [2c]
B3X187C0tXFUfQpCu8pe8A: checks 
59HJSCM1X37BkMpI9N0mEw: checks 
*** SHOW DOWN ***
B3X187C0tXFUfQpCu8pe8A: shows [7s 7h] (a pair of Sevens)
59HJSCM1X37BkMpI9N0mEw: mucks hand 
B3X187C0tXFUfQpCu8pe8A collected $1.80 from pot
*** SUMMARY ***
Total pot $1.85 | Rake $0.05 
Board [8h 5s Jh 9d 2c]
Seat 2: v+QfkGiuj9bgtuNoVnDO8w folded before Flop (didn't bet)
Seat 3: B3X187C0tXFUfQpCu8pe8A showed [7s 7h] and won ($1.80) with a pair of Sevens
Seat 4: 59HJSCM1X37BkMpI9N0mEw (button) mucked
Seat 5: cS21pIxRHx5Gt42o7hPZzw (small blind) folded before Flop
Seat 6: DihMHaz4WNETH1bPDe13kA (big blind) folded on the Turn




PokerStars Game #59941940470:  Hold'em No Limit ($0.10/$0.25) - 2009/07/01 1:51:01 ET
Table 'MRfAiS/4JSfnUDlCcZo0wAhfHe8uKeSJMyWAjSdM7ROQx Seat #4 is the button
Seat 1: 48oT5xFI+5CHUJlfoGrE4w ($29.55 in chips) 
Seat 2: /gJNBeCkWL4o85/jvlZ4BA ($25.85 in chips) 
Seat 4: b4wRQV3APH8irVk6bUFe2Q ($37.10 in chips) 
Seat 5: Q1uciOZPBR/WkAlqa6cL4A ($27.95 in chips) 
Seat 6: df01R5ThvHspD8FgKmaDvQ ($25 in chips) 
Q1uciOZPBR/WkAlqa6cL4A: posts small blind $0.10
df01R5ThvHspD8FgKmaDvQ: posts big blind $0.25
*** HOLE CARDS ***
48oT5xFI+5CHUJlfoGrE4w: raises $0.75 to $1
/gJNBeCkWL4o85/jvlZ4BA: folds 
b4wRQV3APH8irVk6bUFe2Q: folds 
Q1uciOZPBR/WkAlqa6cL4A: folds 
df01R5ThvHspD8FgKmaDvQ: folds 
Uncalled bet ($0.75) returned to 48oT5xFI+5CHUJlfoGrE4w
48oT5xFI+5CHUJlfoGrE4w collected $0.60 from pot
48oT5xFI+5CHUJlfoGrE4w: doesn't show hand 
*** SUMMARY ***
Total pot $0.60 | Rake $0 
Seat 1: 48oT5xFI+5CHUJlfoGrE4w collected ($0.60)
Seat 2: /gJNBeCkWL4o85/jvlZ4BA folded before Flop (didn't bet)
Seat 4: b4wRQV3APH8irVk6bUFe2Q (button) folded before Flop (didn't bet)
Seat 5: Q1uciOZPBR/WkAlqa6cL4A (small blind) folded before Flop
Seat 6: df01R5ThvHspD8FgKmaDvQ (big blind) folded before Flop




PokerStars Game #59941941008:  Hold'em No Limit ($0.10/$0.25) - 2009/07/01 1:51:02 ET
Table '2O5CgfSkSwrr4PDrlZ1RLQ' 6-max Seat #3 is the button
Seat 1: 3skmHD9EOATKdUzzyHh1KA ($31.60 in chips) 
Seat 2: wqphQtauX5Qn7WRJZS1flA ($29.10 in chips) 
Seat 3: oBUDUfeUyCbZBsjxHZgSiw ($20.15 in chips) 
Seat 4: epAUIB7h2FJXzUPRIvSkRA ($25 in chips) 
Seat 5: 0av6tRNdi0Ui4f15L7gsVg ($23.90 in chips) 
Seat 6: tj9xqoqQaDaFw7u1oyZrtA ($52.90 in chips) 
epAUIB7h2FJXzUPRIvSkRA: posts small blind $0.10
0av6tRNdi0Ui4f15L7gsVg: posts big blind $0.25
*** HOLE CARDS ***
tj9xqoqQaDaFw7u1oyZrtA: folds 
3skmHD9EOATKdUzzyHh1KA: folds 
wqphQtauX5Qn7WRJZS1flA: folds 
oBUDUfeUyCbZBsjxHZgSiw: raises $0.75 to $1
epAUIB7h2FJXzUPRIvSkRA: folds 
0av6tRNdi0Ui4f15L7gsVg: folds 
Uncalled bet ($0.75) returned to oBUDUfeUyCbZBsjxHZgSiw
oBUDUfeUyCbZBsjxHZgSiw collected $0.60 from pot
*** SUMMARY ***
Total pot $0.60 | Rake $0 
Seat 1: 3skmHD9EOATKdUzzyHh1KA folded before Flop (didn't bet)
Seat 2: wqphQtauX5Qn7WRJZS1flA folded before Flop (didn't bet)
Seat 3: oBUDUfeUyCbZBsjxHZgSiw (button) collected ($0.60)
Seat 4: epAUIB7h2FJXzUPRIvSkRA (small blind) folded before Flop
Seat 5: 0av6tRNdi0Ui4f15L7gsVg (big blind) folded before Flop
Seat 6: tj9xqoqQaDaFw7u1oyZrtA folded before Flop (didn't bet)




PokerStars Game #59941941376:  Hold'em No Limit ($0.10/$0.25) - 2009/07/01 1:51:02 ET
Table 'NgexmgEDEzICBeSO7YCrKQ' 6-max Seat #4 is the button
Seat 1: cezpHJ8FB07dj0xG+LhOvw ($28.55 in chips) 
Seat 2: 32YL2ZEp8NT4JB2RVM9euQ ($23.55 in chips) 
Seat 3: JFIAqU8lCZ0vWwEl4bdGsg ($27.20 in chips) 
Seat 4: xx+iYCDJhHJmNzrfeloyEg ($21.70 in chips) 
Seat 5: /MXkdT8TTs8Qp2LVTQNw6w ($41.70 in chips) 
Seat 6: k9nHZTHt8hYhYRcW8NTb4g ($11.65 in chips) 
/MXkdT8TTs8Qp2LVTQNw6w: posts small blind $0.10
k9nHZTHt8hYhYRcW8NTb4g: posts big blind $0.25
*** HOLE CARDS ***
cezpHJ8FB07dj0xG+LhOvw: folds 
32YL2ZEp8NT4JB2RVM9euQ: folds 
JFIAqU8lCZ0vWwEl4bdGsg: folds 
xx+iYCDJhHJmNzrfeloyEg: folds 
/MXkdT8TTs8Qp2LVTQNw6w: calls $0.15
k9nHZTHt8hYhYRcW8NTb4g: raises $0.75 to $1
/MXkdT8TTs8Qp2LVTQNw6w: folds 
Uncalled bet ($0.75) returned to k9nHZTHt8hYhYRcW8NTb4g
k9nHZTHt8hYhYRcW8NTb4g collected $0.50 from pot
k9nHZTHt8hYhYRcW8NTb4g: doesn't show hand 
xx+iYCDJhHJmNzrfeloyEg said, "  sneaky and underhanded"
*** SUMMARY ***
Total pot $0.50 | Rake $0 
Seat 1: cezpHJ8FB07dj0xG+LhOvw folded before Flop (didn't bet)
Seat 2: 32YL2ZEp8NT4JB2RVM9euQ folded before Flop (didn't bet)
Seat 3: JFIAqU8lCZ0vWwEl4bdGsg folded before Flop (didn't bet)
Seat 4: xx+iYCDJhHJmNzrfeloyEg (button) folded before Flop (didn't bet)
Seat 5: /MXkdT8TTs8Qp2LVTQNw6w (small blind) folded before Flop
Seat 6: k9nHZTHt8hYhYRcW8NTb4g (big blind) collected ($0.50)




PokerStars Game #59941941358:  Hold'em No Limit ($0.10/$0.25) - 2009/07/01 1:51:02 ET
Table '2VkNDXXsBj4bSZw/uK5atw' 6-max Seat #2 is the button
Seat 1: xrf8tAXKQHG99HixCot1Iw ($25 in chips) 
Seat 2: GbCVUNssQ7mqsPWr7J4d3w ($4.65 in chips) 
Seat 3: P+6Z5+8H5/Wyt/jHMovNvQ ($24.85 in chips) 
Seat 4: 4kIRqWKE/N0yUAcWVhLSoQ ($15.35 in chips) 
Seat 5: 7f0OkhFEOf3T+rVOFHRLnw ($21.25 in chips) 
Seat 6: n6UPMnVR4v8LFP0rWP73Fg ($11.85 in chips) 
P+6Z5+8H5/Wyt/jHMovNvQ: posts small blind $0.10
4kIRqWKE/N0yUAcWVhLSoQ: posts big blind $0.25
*** HOLE CARDS ***
7f0OkhFEOf3T+rVOFHRLnw: raises $0.25 to $0.50
n6UPMnVR4v8LFP0rWP73Fg: folds 
xrf8tAXKQHG99HixCot1Iw: folds 
GbCVUNssQ7mqsPWr7J4d3w: folds 
P+6Z5+8H5/Wyt/jHMovNvQ: calls $0.40
4kIRqWKE/N0yUAcWVhLSoQ: calls $0.25
*** FLOP *** [8h Tc Qh]
P+6Z5+8H5/Wyt/jHMovNvQ: checks 
4kIRqWKE/N0yUAcWVhLSoQ: checks 
7f0OkhFEOf3T+rVOFHRLnw: bets $1
P+6Z5+8H5/Wyt/jHMovNvQ: raises $2 to $3
4kIRqWKE/N0yUAcWVhLSoQ: folds 
7f0OkhFEOf3T+rVOFHRLnw: folds 
Uncalled bet ($2) returned to P+6Z5+8H5/Wyt/jHMovNvQ
P+6Z5+8H5/Wyt/jHMovNvQ collected $3.35 from pot
P+6Z5+8H5/Wyt/jHMovNvQ: doesn't show hand 
*** SUMMARY ***
Total pot $3.50 | Rake $0.15 
Board [8h Tc Qh]
Seat 1: xrf8tAXKQHG99HixCot1Iw folded before Flop (didn't bet)
Seat 2: GbCVUNssQ7mqsPWr7J4d3w (button) folded before Flop (didn't bet)
Seat 3: P+6Z5+8H5/Wyt/jHMovNvQ (small blind) collected ($3.35)
Seat 4: 4kIRqWKE/N0yUAcWVhLSoQ (big blind) folded on the Flop
Seat 5: 7f0OkhFEOf3T+rVOFHRLnw folded on the Flop
Seat 6: n6UPMnVR4v8LFP0rWP73Fg folded before Flop (didn't bet)




PokerStars Game #59941941122:  Hold'em No Limit ($0.10/$0.25) - 2009/07/01 1:51:02 ET
Table 'hfHe8uKeSJMyWAjSdM7ROQ' 6-max Seat #2 is the button
Seat 1: eHsmIvAb2JREg4O6hNPnXg ($44.55 in chips) 
Seat 2: QvTX2yGq3uKJiKPmns4TKQ ($29.20 in chips) 
Seat 3: dOX4wnYV2sEqvDbF+8KSCw ($25 in chips) 
Seat 4: b4wRQV3APH8irVk6bUFe2Q ($33.90 in chips) 
Seat 5: euswrBD1XG0Q5hB1iGJBKQ ($60.80 in chips) 
Seat 6: eL3+wCBjFGfQ5FMdIZihwA ($25 in chips) 
dOX4wnYV2sEqvDbF+8KSCw: posts small blind $0.10
b4wRQV3APH8irVk6bUFe2Q: posts big blind $0.25
*** HOLE CARDS ***
euswrBD1XG0Q5hB1iGJBKQ: folds 
eL3+wCBjFGfQ5FMdIZihwA: raises $0.50 to $0.75
eHsmIvAb2JREg4O6hNPnXg: calls $0.75
QvTX2yGq3uKJiKPmns4TKQ: folds 
dOX4wnYV2sEqvDbF+8KSCw: folds 
b4wRQV3APH8irVk6bUFe2Q: calls $0.50
*** FLOP *** [2s Qs 6s]
b4wRQV3APH8irVk6bUFe2Q: bets $0.25
eL3+wCBjFGfQ5FMdIZihwA: raises $1.75 to $2
eHsmIvAb2JREg4O6hNPnXg: folds 
b4wRQV3APH8irVk6bUFe2Q: folds 
Uncalled bet ($1.75) returned to eL3+wCBjFGfQ5FMdIZihwA
eL3+wCBjFGfQ5FMdIZihwA collected $2.75 from pot
*** SUMMARY ***
Total pot $2.85 | Rake $0.10 
Board [2s Qs 6s]
Seat 1: eHsmIvAb2JREg4O6hNPnXg folded on the Flop
Seat 2: QvTX2yGq3uKJiKPmns4TKQ (button) folded before Flop (didn't bet)
Seat 3: dOX4wnYV2sEqvDbF+8KSCw (small blind) folded before Flop
Seat 4: b4wRQV3APH8irVk6bUFe2Q (big blind) folded on the Flop
Seat 5: euswrBD1XG0Q5hB1iGJBKQ folded before Flop (didn't bet)
Seat 6: eL3+wCBjFGfQ5FMdIZihwA collected ($2.75)




PokerStars Game #59941941250:  Hold'em No Limit ($0.10/$0.25) - 2009/07/01 1:51:02 ET
Table 'MiquQrQZJJq9ZtgRIp9HFQ' 6-max Seat #6 is the button
Seat 1: c3J/KYZ4cNsUEuz8v57I5A ($25.15 in chips) 
Seat 2: 2+6voGl1T1DO63JePptI3g ($25.20 in chips) 
Seat 3: 9h7TNZ1TDGRUJXA6rI+ZTw ($9.75 in chips) 
Seat 4: wAKC8C/zN0c8V5v13dm9mA ($51.55 in chips) 
Seat 5: iyZxqznXjv3vtvOJymkoLQ ($26.40 in chips) 
Seat 6: GbCVUNssQ7mqsPWr7J4d3w ($4.50 in chips) 
c3J/KYZ4cNsUEuz8v57I5A: posts small blind $0.10
2+6voGl1T1DO63JePptI3g: posts big blind $0.25
*** HOLE CARDS ***
9h7TNZ1TDGRUJXA6rI+ZTw: calls $0.25
wAKC8C/zN0c8V5v13dm9mA: calls $0.25
iyZxqznXjv3vtvOJymkoLQ: folds 
GbCVUNssQ7mqsPWr7J4d3w: folds 
c3J/KYZ4cNsUEuz8v57I5A: folds 
2+6voGl1T1DO63JePptI3g: checks 
*** FLOP *** [3h 6c Ks]
2+6voGl1T1DO63JePptI3g: checks 
9h7TNZ1TDGRUJXA6rI+ZTw: checks 
wAKC8C/zN0c8V5v13dm9mA: checks 
*** TURN *** [3h 6c Ks] [7c]
2+6voGl1T1DO63JePptI3g: checks 
9h7TNZ1TDGRUJXA6rI+ZTw: checks 
wAKC8C/zN0c8V5v13dm9mA: checks 
*** RIVER *** [3h 6c Ks 7c] [4c]
2+6voGl1T1DO63JePptI3g: checks 
9h7TNZ1TDGRUJXA6rI+ZTw: checks 
wAKC8C/zN0c8V5v13dm9mA: checks 
*** SHOW DOWN ***
2+6voGl1T1DO63JePptI3g: shows [4d Ad] (a pair of Fours)
9h7TNZ1TDGRUJXA6rI+ZTw: shows [9d 9s] (a pair of Nines)
wAKC8C/zN0c8V5v13dm9mA: mucks hand 
9h7TNZ1TDGRUJXA6rI+ZTw collected $0.85 from pot
*** SUMMARY ***
Total pot $0.85 | Rake $0 
Board [3h 6c Ks 7c 4c]
Seat 1: c3J/KYZ4cNsUEuz8v57I5A (small blind) folded before Flop
Seat 2: 2+6voGl1T1DO63JePptI3g (big blind) showed [4d Ad] and lost with a pair of Fours
Seat 3: 9h7TNZ1TDGRUJXA6rI+ZTw showed [9d 9s] and won ($0.85) with a pair of Nines
Seat 4: wAKC8C/zN0c8V5v13dm9mA mucked
Seat 5: iyZxqznXjv3vtvOJymkoLQ folded before Flop (didn't bet)
Seat 6: GbCVUNssQ7mqsPWr7J4d3w (button) folded before Flop (didn't bet)




PokerStars Game #59941941812:  Hold'em No Limit ($0.10/$0.25) - 2009/07/01 1:51:03 ET
Table 'wPWRBZPJl1HAnysw7qRR0A' 6-max Seat #4 is the button
Seat 1: m7ne1MOFTQXlsXT7/R/rug ($12.15 in chips) 
Seat 2: xC0kaiDYM6YTlgODL83O5A ($23 in chips) 
Seat 3: 1ZpoLWO2nm2w1Nd1v9Sr3g ($6.85 in chips) 
Seat 4: epAUIB7h2FJXzUPRIvSkRA ($48.85 in chips) 
Seat 5: y0B+UpYpOUJz3JWtlJQBSA ($15.15 in chips) 
Seat 6: VXTONriS+Ohik+r0FeicIw ($25.95 in chips) 
y0B+UpYpOUJz3JWtlJQBSA: posts small blind $0.10
VXTONriS+Ohik+r0FeicIw: posts big blind $0.25
*** HOLE CARDS ***
m7ne1MOFTQXlsXT7/R/rug is disconnected 
m7ne1MOFTQXlsXT7/R/rug is connected 
m7ne1MOFTQXlsXT7/R/rug: folds 
xC0kaiDYM6YTlgODL83O5A: raises $0.50 to $0.75
1ZpoLWO2nm2w1Nd1v9Sr3g: folds 
epAUIB7h2FJXzUPRIvSkRA: folds 
y0B+UpYpOUJz3JWtlJQBSA: folds 
VXTONriS+Ohik+r0FeicIw: folds 
Uncalled bet ($0.50) returned to xC0kaiDYM6YTlgODL83O5A
xC0kaiDYM6YTlgODL83O5A collected $0.60 from pot
*** SUMMARY ***
Total pot $0.60 | Rake $0 
Seat 1: m7ne1MOFTQXlsXT7/R/rug folded before Flop (didn't bet)
Seat 2: xC0kaiDYM6YTlgODL83O5A collected ($0.60)
Seat 3: 1ZpoLWO2nm2w1Nd1v9Sr3g folded before Flop (didn't bet)
Seat 4: epAUIB7h2FJXzUPRIvSkRA (button) folded before Flop (didn't bet)
Seat 5: y0B+UpYpOUJz3JWtlJQBSA (small blind) folded before Flop
Seat 6: VXTONriS+Ohik+r0FeicIw (big blind) folded before Flop




PokerStars Game #59941941598:  Hold'em No Limit ($0.10/$0.25) - 2009/07/01 1:51:03 ET
Table 'MJ1SB76A4qJrlEa+C5e/8w' 6-max Seat #2 is the button
Seat 1: 0KDZiuXQg6UI9cqBR/AUnQ ($18.30 in chips) 
Seat 2: UA5OsKS3VPaxa7uC8La/kA ($37.40 in chips) 
Seat 3: DihMHaz4WNETH1bPDe13kA ($32.30 in chips) 
Seat 4: SFmT9ZsVopnukjvAzrxTRg ($30.40 in chips) 
Seat 5: Hsvkc0/G2VV78oVmWYXecw ($5.25 in chips) 
Seat 6: JFIAqU8lCZ0vWwEl4bdGsg ($34.65 in chips) 
DihMHaz4WNETH1bPDe13kA: posts small blind $0.10
SFmT9ZsVopnukjvAzrxTRg: posts big blind $0.25
*** HOLE CARDS ***
Hsvkc0/G2VV78oVmWYXecw: raises $0.50 to $0.75
JFIAqU8lCZ0vWwEl4bdGsg: folds 
0KDZiuXQg6UI9cqBR/AUnQ is disconnected 
0KDZiuXQg6UI9cqBR/AUnQ is connected 
0KDZiuXQg6UI9cqBR/AUnQ: calls $0.75
UA5OsKS3VPaxa7uC8La/kA: folds 
DihMHaz4WNETH1bPDe13kA: folds 
SFmT9ZsVopnukjvAzrxTRg: folds 
*** FLOP *** [3c 7h Js]
Hsvkc0/G2VV78oVmWYXecw: folds 
Hsvkc0/G2VV78oVmWYXecw leaves the table
0KDZiuXQg6UI9cqBR/AUnQ collected $1.80 from pot
0KDZiuXQg6UI9cqBR/AUnQ: doesn't show hand 
*** SUMMARY ***
Total pot $1.85 | Rake $0.05 
Board [3c 7h Js]
Seat 1: 0KDZiuXQg6UI9cqBR/AUnQ collected ($1.80)
Seat 2: UA5OsKS3VPaxa7uC8La/kA (button) folded before Flop (didn't bet)
Seat 3: DihMHaz4WNETH1bPDe13kA (small blind) folded before Flop
Seat 4: SFmT9ZsVopnukjvAzrxTRg (big blind) folded before Flop
Seat 5: Hsvkc0/G2VV78oVmWYXecw folded on the Flop
Seat 6: JFIAqU8lCZ0vWwEl4bdGsg folded before Flop (didn't bet)




PokerStars Game #59941941474:  Hold'em No Limit ($0.10/$0.25) - 2009/07/01 1:51:03 ET
Table 'mF3KHGMaTpaBZbtBoyfTeg' 6-max Seat #6 is the button
Seat 1: 0HAB2GdCAM7p7V00xueAVQ ($34.45 in chips) 
Seat 2: xrf8tAXKQHG99HixCot1Iw ($27.35 in chips) 
Seat 3: 9kUKGKkblnIx3m8rlVol6Q ($14.90 in chips) 
Seat 5: 8ClCHtFXGNplITm+63KB+Q ($45.25 in chips) 
Seat 6: kG34n23qFQA3nzdOJTQ1dA ($26.45 in chips) 
0HAB2GdCAM7p7V00xueAVQ: posts small blind $0.10
xrf8tAXKQHG99HixCot1Iw: posts big blind $0.25
qNYqNZMLP1I54EVl8faRRg: sits out 
*** HOLE CARDS ***
9kUKGKkblnIx3m8rlVol6Q: folds 
8ClCHtFXGNplITm+63KB+Q: folds 
kG34n23qFQA3nzdOJTQ1dA: folds 
0HAB2GdCAM7p7V00xueAVQ: calls $0.15
xrf8tAXKQHG99HixCot1Iw: raises $0.75 to $1
0HAB2GdCAM7p7V00xueAVQ: folds 
Uncalled bet ($0.75) returned to xrf8tAXKQHG99HixCot1Iw
xrf8tAXKQHG99HixCot1Iw collected $0.50 from pot
xrf8tAXKQHG99HixCot1Iw: doesn't show hand 
*** SUMMARY ***
Total pot $0.50 | Rake $0 
Seat 1: 0HAB2GdCAM7p7V00xueAVQ (small blind) folded before Flop
Seat 2: xrf8tAXKQHG99HixCot1Iw (big blind) collected ($0.50)
Seat 3: 9kUKGKkblnIx3m8rlVol6Q folded before Flop (didn't bet)
Seat 5: 8ClCHtFXGNplITm+63KB+Q folded before Flop (didn't bet)
Seat 6: kG34n23qFQA3nzdOJTQ1dA (button) folded before Flop (didn't bet)




PokerStars Game #59941941662:  Hold'em No Limit ($0.10/$0.25) - 2009/07/01 1:51:03 ET
Table 'b64Z+5XI1xkQzNfq4QHr3A' 6-max Seat #3 is the button
Seat 2: A6SjYLoKeIpFjPq0BK/2WA ($14 in chips) 
Seat 3: 7cx44/slbeTw+Cy7QB8Trg ($24.90 in chips) 
Seat 4: 564zqq2DUHXR3tdsOJU6JA ($16.05 in chips) 
Seat 6: 8ClCHtFXGNplITm+63KB+Q ($31.50 in chips) 
564zqq2DUHXR3tdsOJU6JA: posts small blind $0.10
JFIAqU8lCZ0vWwEl4bdGsg: is sitting out 
8ClCHtFXGNplITm+63KB+Q: posts big blind $0.25
*** HOLE CARDS ***
JFIAqU8lCZ0vWwEl4bdGsg leaves the table
A6SjYLoKeIpFjPq0BK/2WA: folds 
7cx44/slbeTw+Cy7QB8Trg: folds 
564zqq2DUHXR3tdsOJU6JA: raises $0.25 to $0.50
8ClCHtFXGNplITm+63KB+Q: folds 
Uncalled bet ($0.25) returned to 564zqq2DUHXR3tdsOJU6JA
564zqq2DUHXR3tdsOJU6JA collected $0.50 from pot
564zqq2DUHXR3tdsOJU6JA: doesn't show hand 
*** SUMMARY ***
Total pot $0.50 | Rake $0 
Seat 2: A6SjYLoKeIpFjPq0BK/2WA folded before Flop (didn't bet)
Seat 3: 7cx44/slbeTw+Cy7QB8Trg (button) folded before Flop (didn't bet)
Seat 4: 564zqq2DUHXR3tdsOJU6JA (small blind) collected ($0.50)
Seat 6: 8ClCHtFXGNplITm+63KB+Q (big blind) folded before Flop




PokerStars Game #59941941546:  Hold'em No Limit ($0.10/$0.25) - 2009/07/01 1:51:03 ET
Table '972HGIb0tQN/zRIK4TABEw' 9-max Seat #4 is the button
Seat 1: fHr2+mGa0RFK3qrpZcVUAQ ($13.40 in chips) 
Seat 4: aSrj4lVmn2owyQ1RbbOqxQ ($4.60 in chips) 
aSrj4lVmn2owyQ1RbbOqxQ: posts small blind $0.10
fHr2+mGa0RFK3qrpZcVUAQ: posts big blind $0.25
*** HOLE CARDS ***
n+stbTneifqFNME+tpoGrw joins the table at seat #5 
aSrj4lVmn2owyQ1RbbOqxQ: raises $0.50 to $0.75
fHr2+mGa0RFK3qrpZcVUAQ: folds 
Uncalled bet ($0.50) returned to aSrj4lVmn2owyQ1RbbOqxQ
aSrj4lVmn2owyQ1RbbOqxQ collected $0.50 from pot
aSrj4lVmn2owyQ1RbbOqxQ: doesn't show hand 
aNpwfA31EREwO+ar4XzBCw leaves the table
*** SUMMARY ***
Total pot $0.50 | Rake $0 
Seat 1: fHr2+mGa0RFK3qrpZcVUAQ (big blind) folded before Flop
Seat 4: aSrj4lVmn2owyQ1RbbOqxQ (button) (small blind) collected ($0.50)




PokerStars Game #59941941614:  Hold'em No Limit ($0.10/$0.25) - 2009/07/01 1:51:03 ET
Table 'wixGE3Zge1qBdnpWijIl/w' 9-max Seat #2 is the button
Seat 1: 4GJMmHGKzu+gVtalqRy7dA ($27.45 in chips) 
Seat 2: DnDcAdn9P0zGovMERigpFA ($77.25 in chips) 
Seat 3: Bb42QRQMhg5/Y0vHP8/2Xw ($25 in chips) 
Seat 4: X6+pSIPfovPcE87t+LmUKQ ($5 in chips) 
Seat 5: H5Se03ZqSX7tbULXur2MAg ($23.05 in chips) 
Seat 6: AP/rNvbsacTb4XtaAgKPiQ ($14.20 in chips) 
Seat 7: mMd8CDS/but3UC+Zp7Up2w ($21.95 in chips) 
Seat 8: ShCS62CJp4MKfKLKvGKQbA ($14.80 in chips) 
Seat 9: r6hsffOo1iKmaPYKwAZmFw ($28.80 in chips) 
Bb42QRQMhg5/Y0vHP8/2Xw: posts small blind $0.10
X6+pSIPfovPcE87t+LmUKQ: posts big blind $0.25
*** HOLE CARDS ***
H5Se03ZqSX7tbULXur2MAg: folds 
AP/rNvbsacTb4XtaAgKPiQ: folds 
mMd8CDS/but3UC+Zp7Up2w: calls $0.25
ShCS62CJp4MKfKLKvGKQbA: calls $0.25
r6hsffOo1iKmaPYKwAZmFw: folds 
4GJMmHGKzu+gVtalqRy7dA: folds 
DnDcAdn9P0zGovMERigpFA: folds 
Bb42QRQMhg5/Y0vHP8/2Xw: folds 
X6+pSIPfovPcE87t+LmUKQ: checks 
*** FLOP *** [2d 8s Ks]
X6+pSIPfovPcE87t+LmUKQ: checks 
mMd8CDS/but3UC+Zp7Up2w: checks 
ShCS62CJp4MKfKLKvGKQbA: checks 
*** TURN *** [2d 8s Ks] [Qs]
X6+pSIPfovPcE87t+LmUKQ: bets $0.50
mMd8CDS/but3UC+Zp7Up2w: folds 
ShCS62CJp4MKfKLKvGKQbA: folds 
Uncalled bet ($0.50) returned to X6+pSIPfovPcE87t+LmUKQ
X6+pSIPfovPcE87t+LmUKQ collected $0.85 from pot
*** SUMMARY ***
Total pot $0.85 | Rake $0 
Board [2d 8s Ks Qs]
Seat 1: 4GJMmHGKzu+gVtalqRy7dA folded before Flop (didn't bet)
Seat 2: DnDcAdn9P0zGovMERigpFA (button) folded before Flop (didn't bet)
Seat 3: Bb42QRQMhg5/Y0vHP8/2Xw (small blind) folded before Flop
Seat 4: X6+pSIPfovPcE87t+LmUKQ (big blind) collected ($0.85)
Seat 5: H5Se03ZqSX7tbULXur2MAg folded before Flop (didn't bet)
Seat 6: AP/rNvbsacTb4XtaAgKPiQ folded before Flop (didn't bet)
Seat 7: mMd8CDS/but3UC+Zp7Up2w folded on the Turn
Seat 8: ShCS62CJp4MKfKLKvGKQbA folded on the Turn
Seat 9: r6hsffOo1iKmaPYKwAZmFw folded before Flop (didn't bet)




PokerStars Game #59941941692:  Hold'em No Limit ($0.10/$0.25) - 2009/07/01 1:51:03 ET
Table 'TJS4XvvOjO3k7mH74HJw5g' 9-max Seat #4 is the button
Seat 1: K8I2mpRME07ZlOsT2x75Lg ($7.95 in chips) 
Seat 2: yqkowiRWZ6NvRN9UUkYIlA ($10.10 in chips) 
Seat 3: 8EbrQ/EvFWt2cr0GaU82gQ ($4.65 in chips) 
Seat 4: clJsV3v77RS07bDKY+705w ($5 in chips) 
Seat 5: UlMB386Cfzy3EwurQoBjcA ($7.45 in chips) 
Seat 6: 3PmVnC/15cl4oyI1TKIt4g ($5 in chips) 
Seat 7: B9u+i1s5aZZkmLTLUopTBg ($14.75 in chips) 
Seat 8: Qv4VzEkN09uD11sjKv02Ig ($17.95 in chips) 
Seat 9: +sbyWwIcFp9kP0bDtMegfQ ($44.45 in chips) 
UlMB386Cfzy3EwurQoBjcA: posts small blind $0.10
3PmVnC/15cl4oyI1TKIt4g: posts big blind $0.25
*** HOLE CARDS ***
B9u+i1s5aZZkmLTLUopTBg: calls $0.25
Qv4VzEkN09uD11sjKv02Ig: folds 
+sbyWwIcFp9kP0bDtMegfQ: folds 
K8I2mpRME07ZlOsT2x75Lg: calls $0.25
yqkowiRWZ6NvRN9UUkYIlA: raises $1.25 to $1.50
8EbrQ/EvFWt2cr0GaU82gQ: folds 
clJsV3v77RS07bDKY+705w: folds 
UlMB386Cfzy3EwurQoBjcA: folds 
3PmVnC/15cl4oyI1TKIt4g: folds 
B9u+i1s5aZZkmLTLUopTBg: calls $1.25
K8I2mpRME07ZlOsT2x75Lg: calls $1.25
*** FLOP *** [4c 7c 7s]
B9u+i1s5aZZkmLTLUopTBg: checks 
K8I2mpRME07ZlOsT2x75Lg: checks 
yqkowiRWZ6NvRN9UUkYIlA: checks 
*** TURN *** [4c 7c 7s] [Jh]
B9u+i1s5aZZkmLTLUopTBg: bets $2.25
K8I2mpRME07ZlOsT2x75Lg: folds 
yqkowiRWZ6NvRN9UUkYIlA: folds 
Uncalled bet ($2.25) returned to B9u+i1s5aZZkmLTLUopTBg
B9u+i1s5aZZkmLTLUopTBg collected $4.65 from pot
*** SUMMARY ***
Total pot $4.85 | Rake $0.20 
Board [4c 7c 7s Jh]
Seat 1: K8I2mpRME07ZlOsT2x75Lg folded on the Turn
Seat 2: yqkowiRWZ6NvRN9UUkYIlA folded on the Turn
Seat 3: 8EbrQ/EvFWt2cr0GaU82gQ folded before Flop (didn't bet)
Seat 4: clJsV3v77RS07bDKY+705w (button) folded before Flop (didn't bet)
Seat 5: UlMB386Cfzy3EwurQoBjcA (small blind) folded before Flop
Seat 6: 3PmVnC/15cl4oyI1TKIt4g (big blind) folded before Flop
Seat 7: B9u+i1s5aZZkmLTLUopTBg collected ($4.65)
Seat 8: Qv4VzEkN09uD11sjKv02Ig folded before Flop (didn't bet)
Seat 9: +sbyWwIcFp9kP0bDtMegfQ folded before Flop (didn't bet)




PokerStars Game #59941942288:  Hold'em No Limit ($0.10/$0.25) - 2009/07/01 1:51:04 ET
Table 'isKy4XK8wJM0x735/D4hWA' 6-max Seat #1 is the button
Seat 1: kwsRmpZ1ZaLooISs+zfyKg ($25.90 in chips) 
Seat 2: 6elpmfyt4Zw0yvd8lePSMQ ($38.15 in chips) 
Seat 3: jp34e617tIzV8tKIWmfAbA ($26.05 in chips) 
Seat 4: DFi/Lzkjsfv8QswS80JX9Q ($31.45 in chips) 
Seat 6: GbCVUNssQ7mqsPWr7J4d3w ($4.65 in chips) 
6elpmfyt4Zw0yvd8lePSMQ: posts small blind $0.10
jp34e617tIzV8tKIWmfAbA: posts big blind $0.25
*** HOLE CARDS ***
DFi/Lzkjsfv8QswS80JX9Q: folds 
GbCVUNssQ7mqsPWr7J4d3w: folds 
kwsRmpZ1ZaLooISs+zfyKg: raises $0.75 to $1
6elpmfyt4Zw0yvd8lePSMQ: folds 
jp34e617tIzV8tKIWmfAbA: calls $0.75
*** FLOP *** [Qd 7c Jd]
jp34e617tIzV8tKIWmfAbA: checks 
kwsRmpZ1ZaLooISs+zfyKg: bets $1.25
jp34e617tIzV8tKIWmfAbA: raises $3.25 to $4.50
kwsRmpZ1ZaLooISs+zfyKg: calls $3.25
*** TURN *** [Qd 7c Jd] [8h]
jp34e617tIzV8tKIWmfAbA: bets $20.55 and is all-in
kwsRmpZ1ZaLooISs+zfyKg: calls $20.40 and is all-in
Uncalled bet ($0.15) returned to jp34e617tIzV8tKIWmfAbA
*** RIVER *** [Qd 7c Jd 8h] [5c]
*** SHOW DOWN ***
jp34e617tIzV8tKIWmfAbA: shows [Ad Qc] (a pair of Queens)
kwsRmpZ1ZaLooISs+zfyKg: shows [Qs As] (a pair of Queens)
TheRuger joins the table at seat #5 
jp34e617tIzV8tKIWmfAbA collected $24.95 from pot
kwsRmpZ1ZaLooISs+zfyKg collected $24.95 from pot
*** SUMMARY ***
Total pot $51.90 | Rake $2 
Board [Qd 7c Jd 8h 5c]
Seat 1: kwsRmpZ1ZaLooISs+zfyKg (button) showed [Qs As] and won ($24.95) with a pair of Queens
Seat 2: 6elpmfyt4Zw0yvd8lePSMQ (small blind) folded before Flop
Seat 3: jp34e617tIzV8tKIWmfAbA (big blind) showed [Ad Qc] and won ($24.95) with a pair of Queens
Seat 4: DFi/Lzkjsfv8QswS80JX9Q folded before Flop (didn't bet)
Seat 6: GbCVUNssQ7mqsPWr7J4d3w folded before Flop (didn't bet)




PokerStars Game #59941942174:  Hold'em No Limit ($0.10/$0.25) - 2009/07/01 1:51:04 ET
Table 'VuY5ej47Cy8nOI3Wogmhzw' 6-max Seat #3 is the button
Seat 1: EeUZtMU058v2ObUACOF4Og ($28.35 in chips) 
Seat 3: v+QfkGiuj9bgtuNoVnDO8w ($42.70 in chips) 
Seat 4: QqiZLFrN8iOUT/GHw7ztOA ($45.15 in chips) 
Seat 5: m2yWOKfAxqHoy5DDN87Ttw ($25 in chips) 
Seat 6: +KblIivb6tainScpwm14RQ ($10.95 in chips) 
QqiZLFrN8iOUT/GHw7ztOA: posts small blind $0.10
m2yWOKfAxqHoy5DDN87Ttw: posts big blind $0.25
*** HOLE CARDS ***
+KblIivb6tainScpwm14RQ: folds 
king_sol77 leaves the table
EeUZtMU058v2ObUACOF4Og: folds 
v+QfkGiuj9bgtuNoVnDO8w: raises $0.75 to $1
QqiZLFrN8iOUT/GHw7ztOA: folds 
m2yWOKfAxqHoy5DDN87Ttw: calls $0.75
*** FLOP *** [6c 9c 3h]
m2yWOKfAxqHoy5DDN87Ttw: bets $1.50
v+QfkGiuj9bgtuNoVnDO8w: folds 
Uncalled bet ($1.50) returned to m2yWOKfAxqHoy5DDN87Ttw
m2yWOKfAxqHoy5DDN87Ttw collected $2 from pot
m2yWOKfAxqHoy5DDN87Ttw: doesn't show hand 
*** SUMMARY ***
Total pot $2.10 | Rake $0.10 
Board [6c 9c 3h]
Seat 1: EeUZtMU058v2ObUACOF4Og folded before Flop (didn't bet)
Seat 3: v+QfkGiuj9bgtuNoVnDO8w (button) folded on the Flop
Seat 4: QqiZLFrN8iOUT/GHw7ztOA (small blind) folded before Flop
Seat 5: m2yWOKfAxqHoy5DDN87Ttw (big blind) collected ($2)
Seat 6: +KblIivb6tainScpwm14RQ folded before Flop (didn't bet)




PokerStars Game #59941942052:  Hold'em No Limit ($0.10/$0.25) - 2009/07/01 1:51:04 ET
Table '84TjTrgbsYZladOc4PWf4Q' 6-max Seat #2 is the button
Seat 1: /kW0t5kKllzd8HO2uEapHQ ($17.20 in chips) 
Seat 2: RpaEX9P7BCvyfPRLiRNg0A ($47.35 in chips) 
Seat 3: Ar4vsUIUfJ7gbYh1c1m59g ($10.95 in chips) 
Seat 4: SxIIgwXYLkwd6m3wLyPTCw ($25 in chips) 
Seat 5: cezpHJ8FB07dj0xG+LhOvw ($29.15 in chips) 
Seat 6: wCUaomJ6Nq5zomVGdUHP+w ($21.80 in chips) 
Ar4vsUIUfJ7gbYh1c1m59g: posts small blind $0.10
SxIIgwXYLkwd6m3wLyPTCw: posts big blind $0.25
*** HOLE CARDS ***
cezpHJ8FB07dj0xG+LhOvw: folds 
wCUaomJ6Nq5zomVGdUHP+w: raises $0.75 to $1
/kW0t5kKllzd8HO2uEapHQ: folds 
RpaEX9P7BCvyfPRLiRNg0A: folds 
Ar4vsUIUfJ7gbYh1c1m59g: folds 
SxIIgwXYLkwd6m3wLyPTCw: calls $0.75
*** FLOP *** [7d Jd 9s]
SxIIgwXYLkwd6m3wLyPTCw: checks 
wCUaomJ6Nq5zomVGdUHP+w: bets $1
SxIIgwXYLkwd6m3wLyPTCw: raises $2.50 to $3.50
wCUaomJ6Nq5zomVGdUHP+w: calls $2.50
*** TURN *** [7d Jd 9s] [9h]
SxIIgwXYLkwd6m3wLyPTCw: bets $5
wCUaomJ6Nq5zomVGdUHP+w: calls $5
*** RIVER *** [7d Jd 9s 9h] [Qs]
SxIIgwXYLkwd6m3wLyPTCw: bets $5
wCUaomJ6Nq5zomVGdUHP+w: calls $5
*** SHOW DOWN ***
SxIIgwXYLkwd6m3wLyPTCw: shows [Jc Ac] (two pair, Jacks and Nines)
wCUaomJ6Nq5zomVGdUHP+w: mucks hand 
SxIIgwXYLkwd6m3wLyPTCw collected $27.70 from pot
*** SUMMARY ***
Total pot $29.10 | Rake $1.40 
Board [7d Jd 9s 9h Qs]
Seat 1: /kW0t5kKllzd8HO2uEapHQ folded before Flop (didn't bet)
Seat 2: RpaEX9P7BCvyfPRLiRNg0A (button) folded before Flop (didn't bet)
Seat 3: Ar4vsUIUfJ7gbYh1c1m59g (small blind) folded before Flop
Seat 4: SxIIgwXYLkwd6m3wLyPTCw (big blind) showed [Jc Ac] and won ($27.70) with two pair, Jacks and Nines
Seat 5: cezpHJ8FB07dj0xG+LhOvw folded before Flop (didn't bet)
Seat 6: wCUaomJ6Nq5zomVGdUHP+w mucked




PokerStars Game #59941942384:  Hold'em No Limit ($0.10/$0.25) - 2009/07/01 1:51:04 ET
Table '3LMlz3V4AziGlU+ikmyU8w' 6-max Seat #3 is the button
Seat 1: Wxq4Qyj0DnDXj2+taEOJFQ ($20.65 in chips) 
Seat 2: uR3AbFJLoOX86DOTtTgGcg ($34.50 in chips) 
Seat 3: Hzy03WtPHMYwLYM7hTTxQw ($31.10 in chips) 
Seat 4: 6DwBRH+xZ12AAZmeAg+aXw ($23.05 in chips) 
Seat 5: tOAk1Og4mVObMBOfvdDYOw ($25 in chips) 
Seat 6: 7LpHJVeM6k1mQdC6HXYzww ($49.80 in chips) 
6DwBRH+xZ12AAZmeAg+aXw: posts small blind $0.10
tOAk1Og4mVObMBOfvdDYOw: posts big blind $0.25
*** HOLE CARDS ***
7LpHJVeM6k1mQdC6HXYzww: folds 
Wxq4Qyj0DnDXj2+taEOJFQ: folds 
Wxq4Qyj0DnDXj2+taEOJFQ is sitting out
uR3AbFJLoOX86DOTtTgGcg: folds 
Wxq4Qyj0DnDXj2+taEOJFQ leaves the table
Hzy03WtPHMYwLYM7hTTxQw: raises $0.75 to $1
6DwBRH+xZ12AAZmeAg+aXw: raises $2 to $3
ErIN0JRL5srYjT6en1f8YQ joins the table at seat #1 
tOAk1Og4mVObMBOfvdDYOw: folds 
Hzy03WtPHMYwLYM7hTTxQw: calls $2
*** FLOP *** [3c Qc 3s]
6DwBRH+xZ12AAZmeAg+aXw: bets $4
Hzy03WtPHMYwLYM7hTTxQw: calls $4
*** TURN *** [3c Qc 3s] [9c]
6DwBRH+xZ12AAZmeAg+aXw: checks 
Hzy03WtPHMYwLYM7hTTxQw: bets $10.50
6DwBRH+xZ12AAZmeAg+aXw: raises $5.55 to $16.05 and is all-in
Hzy03WtPHMYwLYM7hTTxQw: calls $5.55
*** RIVER *** [3c Qc 3s 9c] [7h]
*** SHOW DOWN ***
6DwBRH+xZ12AAZmeAg+aXw: shows [Ad Qh] (two pair, Queens and Threes)
Hzy03WtPHMYwLYM7hTTxQw: shows [6c Ac] (a flush, Ace high)
Hzy03WtPHMYwLYM7hTTxQw collected $44.10 from pot
*** SUMMARY ***
Total pot $46.35 | Rake $2.25 
Board [3c Qc 3s 9c 7h]
Seat 1: Wxq4Qyj0DnDXj2+taEOJFQ folded before Flop (didn't bet)
Seat 2: uR3AbFJLoOX86DOTtTgGcg folded before Flop (didn't bet)
Seat 3: Hzy03WtPHMYwLYM7hTTxQw (button) showed [6c Ac] and won ($44.10) with a flush, Ace high
Seat 4: 6DwBRH+xZ12AAZmeAg+aXw (small blind) showed [Ad Qh] and lost with two pair, Queens and Threes
Seat 5: tOAk1Og4mVObMBOfvdDYOw (big blind) folded before Flop
Seat 6: 7LpHJVeM6k1mQdC6HXYzww folded before Flop (didn't bet)




PokerStars Game #59941942794:  Hold'em No Limit ($0.10/$0.25) - 2009/07/01 1:51:05 ET
Table 'mVdLgAdN9rGe6mMwSrDdGQ' 6-max Seat #6 is the button
Seat 1: OyJ0KTHA5cwh0/yCo1/rdA ($10.10 in chips) 
Seat 2: n9QqWD4tpbongUBX2Oi58w ($10 in chips) 
Seat 3: +baiVgI/ETnBARLe5mARCw ($16.25 in chips) 
Seat 4: scNSjC6yyKvvfklSkuzLrw ($23.50 in chips) 
Seat 5: +TMG/MBWpiEnc9t7i07eTA ($23.15 in chips) 
Seat 6: DihMHaz4WNETH1bPDe13kA ($47.95 in chips) 
OyJ0KTHA5cwh0/yCo1/rdA: posts small blind $0.10
n9QqWD4tpbongUBX2Oi58w: posts big blind $0.25
*** HOLE CARDS ***
+baiVgI/ETnBARLe5mARCw: folds 
scNSjC6yyKvvfklSkuzLrw: folds 
+TMG/MBWpiEnc9t7i07eTA: folds 
DihMHaz4WNETH1bPDe13kA: folds 
OyJ0KTHA5cwh0/yCo1/rdA: calls $0.15
n9QqWD4tpbongUBX2Oi58w: raises $0.75 to $1
OyJ0KTHA5cwh0/yCo1/rdA: calls $0.75
*** FLOP *** [9d 5c 9c]
OyJ0KTHA5cwh0/yCo1/rdA: checks 
n9QqWD4tpbongUBX2Oi58w: bets $1.50
OyJ0KTHA5cwh0/yCo1/rdA: folds 
Uncalled bet ($1.50) returned to n9QqWD4tpbongUBX2Oi58w
n9QqWD4tpbongUBX2Oi58w collected $1.90 from pot
n9QqWD4tpbongUBX2Oi58w: shows [Ad As] (two pair, Aces and Nines)
*** SUMMARY ***
Total pot $2 | Rake $0.10 
Board [9d 5c 9c]
Seat 1: OyJ0KTHA5cwh0/yCo1/rdA (small blind) folded on the Flop
Seat 2: n9QqWD4tpbongUBX2Oi58w (big blind) collected ($1.90)
Seat 3: +baiVgI/ETnBARLe5mARCw folded before Flop (didn't bet)
Seat 4: scNSjC6yyKvvfklSkuzLrw folded before Flop (didn't bet)
Seat 5: +TMG/MBWpiEnc9t7i07eTA folded before Flop (didn't bet)
Seat 6: DihMHaz4WNETH1bPDe13kA (button) folded before Flop (didn't bet)




PokerStars Game #59941942806:  Hold'em No Limit ($0.10/$0.25) - 2009/07/01 1:51:05 ET
Table 'oZuNsbNJuUyQLGKzQ/4JFg' 6-max Seat #1 is the button
Seat 1: vqWjZmdQu/Hxw96/IJTWdQ ($25 in chips) 
Seat 2: UA5OsKS3VPaxa7uC8La/kA ($35.15 in chips) 
Seat 3: 8ClCHtFXGNplITm+63KB+Q ($50.65 in chips) 
Seat 4: 9bpVv1/Qh9IYtXuCtl5VtQ ($31.20 in chips) 
Seat 5: oBUDUfeUyCbZBsjxHZgSiw ($23.85 in chips) 
Seat 6: fwg6dK1+r4jy/y+JqenYYQ ($12.45 in chips) 
UA5OsKS3VPaxa7uC8La/kA: posts small blind $0.10
8ClCHtFXGNplITm+63KB+Q: posts big blind $0.25
*** HOLE CARDS ***
9bpVv1/Qh9IYtXuCtl5VtQ: folds 
oBUDUfeUyCbZBsjxHZgSiw: raises $0.75 to $1
fwg6dK1+r4jy/y+JqenYYQ: calls $1
vqWjZmdQu/Hxw96/IJTWdQ: folds 
UA5OsKS3VPaxa7uC8La/kA: folds 
8ClCHtFXGNplITm+63KB+Q: folds 
*** FLOP *** [2s Kh Qs]
oBUDUfeUyCbZBsjxHZgSiw: bets $1.25
fwg6dK1+r4jy/y+JqenYYQ: raises $1.25 to $2.50
oBUDUfeUyCbZBsjxHZgSiw: calls $1.25
*** TURN *** [2s Kh Qs] [Qd]
oBUDUfeUyCbZBsjxHZgSiw: checks 
fwg6dK1+r4jy/y+JqenYYQ: checks 
*** RIVER *** [2s Kh Qs Qd] [Th]
oBUDUfeUyCbZBsjxHZgSiw: bets $20.35 and is all-in
fwg6dK1+r4jy/y+JqenYYQ: calls $8.95 and is all-in
Uncalled bet ($11.40) returned to oBUDUfeUyCbZBsjxHZgSiw
*** SHOW DOWN ***
oBUDUfeUyCbZBsjxHZgSiw: shows [Qc 7c] (three of a kind, Queens)
fwg6dK1+r4jy/y+JqenYYQ: shows [Qh Kd] (a full house, Queens full of Kings)
fwg6dK1+r4jy/y+JqenYYQ collected $24.05 from pot
*** SUMMARY ***
Total pot $25.25 | Rake $1.20 
Board [2s Kh Qs Qd Th]
Seat 1: vqWjZmdQu/Hxw96/IJTWdQ (button) folded before Flop (didn't bet)
Seat 2: UA5OsKS3VPaxa7uC8La/kA (small blind) folded before Flop
Seat 3: 8ClCHtFXGNplITm+63KB+Q (big blind) folded before Flop
Seat 4: 9bpVv1/Qh9IYtXuCtl5VtQ folded before Flop (didn't bet)
Seat 5: oBUDUfeUyCbZBsjxHZgSiw showed [Qc 7c] and lost with three of a kind, Queens
Seat 6: fwg6dK1+r4jy/y+JqenYYQ showed [Qh Kd] and won ($24.05) with a full house, Queens full of Kings




PokerStars Game #59941942766:  Hold'em No Limit ($0.10/$0.25) - 2009/07/01 1:51:05 ET
Table 'LG9H161ZAHDkOww+ih3Ptg' 6-max Seat #5 is the button
Seat 1: vEZ/HxVuyR6kaq0BtZoUgQ ($10 in chips) 
Seat 2: kwsRmpZ1ZaLooISs+zfyKg ($34.70 in chips) 
Seat 3: 5Evvx7UYqXTBuvIc/9s/hA ($15.20 in chips) 
Seat 4: 0C28L4/59aRNtHoBhqTcLg ($56.35 in chips) 
Seat 5: IDpUHu4U5YRh06nKQqhY8g ($10.15 in chips) 
Seat 6: v8m8XHovI5tqEA9mvplDSw ($24.75 in chips) 
v8m8XHovI5tqEA9mvplDSw: posts small blind $0.10
vEZ/HxVuyR6kaq0BtZoUgQ: posts big blind $0.25
*** HOLE CARDS ***
kwsRmpZ1ZaLooISs+zfyKg: folds 
5Evvx7UYqXTBuvIc/9s/hA: calls $0.25
0C28L4/59aRNtHoBhqTcLg: calls $0.25
IDpUHu4U5YRh06nKQqhY8g: calls $0.25
v8m8XHovI5tqEA9mvplDSw: calls $0.15
vEZ/HxVuyR6kaq0BtZoUgQ: checks 
*** FLOP *** [6h 4c Tc]
v8m8XHovI5tqEA9mvplDSw: checks 
vEZ/HxVuyR6kaq0BtZoUgQ: checks 
5Evvx7UYqXTBuvIc/9s/hA: checks 
0C28L4/59aRNtHoBhqTcLg: checks 
IDpUHu4U5YRh06nKQqhY8g: checks 
*** TURN *** [6h 4c Tc] [Ts]
v8m8XHovI5tqEA9mvplDSw: checks 
vEZ/HxVuyR6kaq0BtZoUgQ: checks 
5Evvx7UYqXTBuvIc/9s/hA: checks 
0C28L4/59aRNtHoBhqTcLg: checks 
IDpUHu4U5YRh06nKQqhY8g: checks 
*** RIVER *** [6h 4c Tc Ts] [9s]
v8m8XHovI5tqEA9mvplDSw: checks 
vEZ/HxVuyR6kaq0BtZoUgQ: checks 
5Evvx7UYqXTBuvIc/9s/hA: checks 
0C28L4/59aRNtHoBhqTcLg: checks 
IDpUHu4U5YRh06nKQqhY8g: checks 
*** SHOW DOWN ***
v8m8XHovI5tqEA9mvplDSw: shows [3c 3s] (two pair, Tens and Threes)
vEZ/HxVuyR6kaq0BtZoUgQ: shows [9h 5s] (two pair, Tens and Nines)
5Evvx7UYqXTBuvIc/9s/hA: mucks hand 
0C28L4/59aRNtHoBhqTcLg: shows [Jd 9d] (two pair, Tens and Nines - Jack kicker)
IDpUHu4U5YRh06nKQqhY8g: mucks hand 
0C28L4/59aRNtHoBhqTcLg collected $1.20 from pot
*** SUMMARY ***
Total pot $1.25 | Rake $0.05 
Board [6h 4c Tc Ts 9s]
Seat 1: vEZ/HxVuyR6kaq0BtZoUgQ (big blind) showed [9h 5s] and lost with two pair, Tens and Nines
Seat 2: kwsRmpZ1ZaLooISs+zfyKg folded before Flop (didn't bet)
Seat 3: 5Evvx7UYqXTBuvIc/9s/hA mucked
Seat 4: 0C28L4/59aRNtHoBhqTcLg showed [Jd 9d] and won ($1.20) with two pair, Tens and Nines
Seat 5: IDpUHu4U5YRh06nKQqhY8g (button) mucked
Seat 6: v8m8XHovI5tqEA9mvplDSw (small blind) showed [3c 3s] and lost with two pair, Tens and Threes




PokerStars Game #59941942762:  Hold'em No Limit ($0.10/$0.25) - 2009/07/01 1:51:05 ET
Table 'Jj2eLzVCUVAGBmM+Og79iQ' 9-max Seat #2 is the button
Seat 1: ShXPHWfjhfmAwLgDdm6bRQ ($6.90 in chips) 
Seat 2: 3BXzvZqgd3pARIFGfMXHww ($5.35 in chips) 
Seat 3: HPEB+AtKw1+C/cxU0o1ciw ($24.15 in chips) 
Seat 5: UkF1eqqUN0CCiimXAuN7og ($4.65 in chips) 
Seat 6: jZURAM/dgGCX+5lATlZugw ($17.35 in chips) 
Seat 7: e3Caz8vey9WAdfgpuGpNjQ ($15 in chips) 
Seat 8: H5Se03ZqSX7tbULXur2MAg ($33.80 in chips) 
Seat 9: vSkQm2EelzwRGDDQQk0Fqw ($4.65 in chips) 
HPEB+AtKw1+C/cxU0o1ciw: posts small blind $0.10
aNpwfA31EREwO+ar4XzBCw: is sitting out 
UkF1eqqUN0CCiimXAuN7og: posts big blind $0.25
e3Caz8vey9WAdfgpuGpNjQ: posts big blind $0.25
*** HOLE CARDS ***
aNpwfA31EREwO+ar4XzBCw leaves the table
jZURAM/dgGCX+5lATlZugw: folds 
e3Caz8vey9WAdfgpuGpNjQ: checks 
H5Se03ZqSX7tbULXur2MAg: folds 
vSkQm2EelzwRGDDQQk0Fqw: folds 
ShXPHWfjhfmAwLgDdm6bRQ: calls $0.25
3BXzvZqgd3pARIFGfMXHww: folds 
HPEB+AtKw1+C/cxU0o1ciw: folds 
UkF1eqqUN0CCiimXAuN7og: checks 
*** FLOP *** [Qh 2s Qd]
UkF1eqqUN0CCiimXAuN7og: checks 
e3Caz8vey9WAdfgpuGpNjQ: checks 
ShXPHWfjhfmAwLgDdm6bRQ: bets $0.25
UkF1eqqUN0CCiimXAuN7og: folds 
e3Caz8vey9WAdfgpuGpNjQ: calls $0.25
*** TURN *** [Qh 2s Qd] [8d]
e3Caz8vey9WAdfgpuGpNjQ: checks 
Bb42QRQMhg5/Y0vHP8/2Xw joins the table at seat #4 
ShXPHWfjhfmAwLgDdm6bRQ: bets $0.75
e3Caz8vey9WAdfgpuGpNjQ: folds 
Uncalled bet ($0.75) returned to ShXPHWfjhfmAwLgDdm6bRQ
ShXPHWfjhfmAwLgDdm6bRQ collected $1.30 from pot
ShXPHWfjhfmAwLgDdm6bRQ: doesn't show hand 
*** SUMMARY ***
Total pot $1.35 | Rake $0.05 
Board [Qh 2s Qd 8d]
Seat 1: ShXPHWfjhfmAwLgDdm6bRQ collected ($1.30)
Seat 2: 3BXzvZqgd3pARIFGfMXHww (button) folded before Flop (didn't bet)
Seat 3: HPEB+AtKw1+C/cxU0o1ciw (small blind) folded before Flop
Seat 5: UkF1eqqUN0CCiimXAuN7og (big blind) folded on the Flop
Seat 6: jZURAM/dgGCX+5lATlZugw folded before Flop (didn't bet)
Seat 7: e3Caz8vey9WAdfgpuGpNjQ folded on the Turn
Seat 8: H5Se03ZqSX7tbULXur2MAg folded before Flop (didn't bet)
Seat 9: vSkQm2EelzwRGDDQQk0Fqw folded before Flop (didn't bet)




PokerStars Game #59941943100:  Hold'em No Limit ($0.10/$0.25) - 2009/07/01 1:51:06 ET
Table '0XPo7K54oZIfG0xlNAcDRw' 9-max Seat #4 is the button
Seat 2: Prl9QvWQw/mISF4dSnnQUQ ($10.10 in chips) 
Seat 3: RHqgdFvufLCYe54+qd2gcA ($4.90 in chips) 
Seat 4: RubYqfvGrz2z+5ReNIj9QQ ($30.75 in chips) 
Seat 5: iOmwbUN7u4JFkV6VCA49aA ($16.35 in chips) 
Seat 6: M1nKET7WOTLbVPuAbJa3EA ($14.40 in chips) 
Seat 7: tYsOBqdU1+x+yFI7zHO7hQ ($28.45 in chips) 
Seat 8: v5jnQ1gfh9nLla3kMXG7Yg ($16.30 in chips) 
Seat 9: CmngQmkKTp8tkl6GMRTl6w ($13.25 in chips) 
iOmwbUN7u4JFkV6VCA49aA: posts small blind $0.10
M1nKET7WOTLbVPuAbJa3EA: posts big blind $0.25
4awUyiDYTgylQKXZ9faBVA: sits out 
*** HOLE CARDS ***
tYsOBqdU1+x+yFI7zHO7hQ: folds 
v5jnQ1gfh9nLla3kMXG7Yg: folds 
CmngQmkKTp8tkl6GMRTl6w: folds 
Prl9QvWQw/mISF4dSnnQUQ: calls $0.25
iOmwbUN7u4JFkV6VCA49aA said, "cool a 9 not bad"
RHqgdFvufLCYe54+qd2gcA: raises $0.75 to $1
RubYqfvGrz2z+5ReNIj9QQ: folds 
iOmwbUN7u4JFkV6VCA49aA said, "watch this"
iOmwbUN7u4JFkV6VCA49aA: calls $0.90
M1nKET7WOTLbVPuAbJa3EA: calls $0.75
Prl9QvWQw/mISF4dSnnQUQ: calls $0.75
*** FLOP *** [Jc 2c 2h]
iOmwbUN7u4JFkV6VCA49aA: checks 
M1nKET7WOTLbVPuAbJa3EA: bets $0.50
Prl9QvWQw/mISF4dSnnQUQ: calls $0.50
RHqgdFvufLCYe54+qd2gcA: raises $1.25 to $1.75
iOmwbUN7u4JFkV6VCA49aA: folds 
M1nKET7WOTLbVPuAbJa3EA: folds 
iOmwbUN7u4JFkV6VCA49aA said, "dam 55"
Prl9QvWQw/mISF4dSnnQUQ: folds 
Uncalled bet ($1.25) returned to RHqgdFvufLCYe54+qd2gcA
RHqgdFvufLCYe54+qd2gcA collected $5.25 from pot
RHqgdFvufLCYe54+qd2gcA: doesn't show hand 
*** SUMMARY ***
Total pot $5.50 | Rake $0.25 
Board [Jc 2c 2h]
Seat 2: Prl9QvWQw/mISF4dSnnQUQ folded on the Flop
Seat 3: RHqgdFvufLCYe54+qd2gcA collected ($5.25)
Seat 4: RubYqfvGrz2z+5ReNIj9QQ (button) folded before Flop (didn't bet)
Seat 5: iOmwbUN7u4JFkV6VCA49aA (small blind) folded on the Flop
Seat 6: M1nKET7WOTLbVPuAbJa3EA (big blind) folded on the Flop
Seat 7: tYsOBqdU1+x+yFI7zHO7hQ folded before Flop (didn't bet)
Seat 8: v5jnQ1gfh9nLla3kMXG7Yg folded before Flop (didn't bet)
Seat 9: CmngQmkKTp8tkl6GMRTl6w folded before Flop (didn't bet)




PokerStars Game #59941943136:  Hold'em No Limit ($0.10/$0.25) - 2009/07/01 1:51:06 ET
Table 'KYX9dFNuOA9l2PV46IebqQ' 9-max Seat #9 is the button
Seat 1: qZqVFan2U+GAA/c5LQFbcw ($14.80 in chips) 
Seat 2: GeMoapCKDLc4ajT0Uk9ZQw ($10 in chips) 
Seat 3: Uq3NSX4cIFaXe7pbXQuU+Q ($7.20 in chips) 
Seat 4: ly/lwri2xlF+wmFsvottuQ ($4.25 in chips) 
Seat 5: g7MXhRmNZxv1lIkKkUKa4w ($20 in chips) 
Seat 6: 4QYM+pWPc3J+6i8Zv8LvLg ($20.95 in chips) 
Seat 7: FVZtQJMz59M6BoiON/88Xg ($3.85 in chips) 
Seat 8: KRWTiGM4xH+MkvPtJz4+SA ($22.55 in chips) 
Seat 9: 6NECk10orj8iqgD3pZ2A0Q ($6.30 in chips) 
qZqVFan2U+GAA/c5LQFbcw: posts small blind $0.10
GeMoapCKDLc4ajT0Uk9ZQw: posts big blind $0.25
*** HOLE CARDS ***
Uq3NSX4cIFaXe7pbXQuU+Q: folds 
ly/lwri2xlF+wmFsvottuQ: folds 
g7MXhRmNZxv1lIkKkUKa4w: calls $0.25
4QYM+pWPc3J+6i8Zv8LvLg: calls $0.25
FVZtQJMz59M6BoiON/88Xg: raises $3.60 to $3.85 and is all-in
KRWTiGM4xH+MkvPtJz4+SA: folds 
6NECk10orj8iqgD3pZ2A0Q: folds 
qZqVFan2U+GAA/c5LQFbcw: folds 
GeMoapCKDLc4ajT0Uk9ZQw: folds 
g7MXhRmNZxv1lIkKkUKa4w: folds 
4QYM+pWPc3J+6i8Zv8LvLg: calls $3.60
*** FLOP *** [Ac Kh Tc]
*** TURN *** [Ac Kh Tc] [4h]
*** RIVER *** [Ac Kh Tc 4h] [Ks]
*** SHOW DOWN ***
4QYM+pWPc3J+6i8Zv8LvLg: shows [4c Jc] (two pair, Kings and Fours)
FVZtQJMz59M6BoiON/88Xg: mucks hand 
4QYM+pWPc3J+6i8Zv8LvLg collected $7.90 from pot
*** SUMMARY ***
Total pot $8.30 | Rake $0.40 
Board [Ac Kh Tc 4h Ks]
Seat 1: qZqVFan2U+GAA/c5LQFbcw (small blind) folded before Flop
Seat 2: GeMoapCKDLc4ajT0Uk9ZQw (big blind) folded before Flop
Seat 3: Uq3NSX4cIFaXe7pbXQuU+Q folded before Flop (didn't bet)
Seat 4: ly/lwri2xlF+wmFsvottuQ folded before Flop (didn't bet)
Seat 5: g7MXhRmNZxv1lIkKkUKa4w folded before Flop
Seat 6: 4QYM+pWPc3J+6i8Zv8LvLg showed [4c Jc] and won ($7.90) with two pair, Kings and Fours
Seat 7: FVZtQJMz59M6BoiON/88Xg mucked
Seat 8: KRWTiGM4xH+MkvPtJz4+SA folded before Flop (didn't bet)
Seat 9: 6NECk10orj8iqgD3pZ2A0Q (button) folded before Flop (didn't bet)




PokerStars Game #59941943214:  Hold'em No Limit ($0.10/$0.25) - 2009/07/01 1:51:06 ET
Table 'M7d9IrgQUUFFy/SZ3ksLYg' 6-max Seat #4 is the button
Seat 1: ypmjhffk/YHGc51wgVXUTw ($50.10 in chips) 
Seat 2: 8CPg15X6IHYR1pWm9ha1Sw ($27.55 in chips) 
Seat 3: epAUIB7h2FJXzUPRIvSkRA ($25.90 in chips) 
Seat 4: 8ClCHtFXGNplITm+63KB+Q ($22.50 in chips) 
Seat 5: kMa8BltUcBQVxnHfqdCfXg ($5.75 in chips) 
Seat 6: 7S16WhQHiAVLWwRuqPrpnw ($13.05 in chips) 
kMa8BltUcBQVxnHfqdCfXg: posts small blind $0.10
7S16WhQHiAVLWwRuqPrpnw: posts big blind $0.25
*** HOLE CARDS ***
ypmjhffk/YHGc51wgVXUTw: folds 
8CPg15X6IHYR1pWm9ha1Sw: raises $0.75 to $1
epAUIB7h2FJXzUPRIvSkRA: folds 
8ClCHtFXGNplITm+63KB+Q: folds 
kMa8BltUcBQVxnHfqdCfXg: folds 
7S16WhQHiAVLWwRuqPrpnw: calls $0.75
*** FLOP *** [2h Qc 2s]
kMa8BltUcBQVxnHfqdCfXg leaves the table
7S16WhQHiAVLWwRuqPrpnw: checks 
8CPg15X6IHYR1pWm9ha1Sw: bets $1.25
7S16WhQHiAVLWwRuqPrpnw: calls $1.25
*** TURN *** [2h Qc 2s] [8c]
7S16WhQHiAVLWwRuqPrpnw: checks 
8CPg15X6IHYR1pWm9ha1Sw: checks 
*** RIVER *** [2h Qc 2s 8c] [5s]
7S16WhQHiAVLWwRuqPrpnw: checks 
8CPg15X6IHYR1pWm9ha1Sw: checks 
*** SHOW DOWN ***
7S16WhQHiAVLWwRuqPrpnw: shows [Ac Kd] (a pair of Deuces)
8CPg15X6IHYR1pWm9ha1Sw: mucks hand 
7S16WhQHiAVLWwRuqPrpnw collected $4.40 from pot
*** SUMMARY ***
Total pot $4.60 | Rake $0.20 
Board [2h Qc 2s 8c 5s]
Seat 1: ypmjhffk/YHGc51wgVXUTw folded before Flop (didn't bet)
Seat 2: 8CPg15X6IHYR1pWm9ha1Sw mucked
Seat 3: epAUIB7h2FJXzUPRIvSkRA folded before Flop (didn't bet)
Seat 4: 8ClCHtFXGNplITm+63KB+Q (button) folded before Flop (didn't bet)
Seat 5: kMa8BltUcBQVxnHfqdCfXg (small blind) folded before Flop
Seat 6: 7S16WhQHiAVLWwRuqPrpnw (big blind) showed [Ac Kd] and won ($4.40) with a pair of Deuces




PokerStars Game #59941943670:  Hold'em No Limit ($0.10/$0.25) - 2009/07/01 1:51:07 ET
Table 'v+LTGPWbrLum+Ggd4ef6lg' 9-max Seat #7 is the button
Seat 2: clJsV3v77RS07bDKY+705w ($5 in chips) 
Seat 3: 7ovWM9c1nQLTFritEGRG/A ($3.10 in chips) 
Seat 5: +8OkYWUhGfkDbAtQl/ovYQ ($23.15 in chips) 
Seat 7: kUxTO3D2eQcx4oJIpJAK4Q ($8.25 in chips) 
Seat 8: +sbyWwIcFp9kP0bDtMegfQ ($40.20 in chips) 
Seat 9: cZ99hugmLBj9KhTlc8nCSw ($25 in chips) 
+sbyWwIcFp9kP0bDtMegfQ: posts small blind $0.10
cZ99hugmLBj9KhTlc8nCSw: posts big blind $0.25
yqkowiRWZ6NvRN9UUkYIlA: sits out 
*** HOLE CARDS ***
clJsV3v77RS07bDKY+705w: folds 
7ovWM9c1nQLTFritEGRG/A: folds 
+8OkYWUhGfkDbAtQl/ovYQ: folds 
kUxTO3D2eQcx4oJIpJAK4Q: folds 
+sbyWwIcFp9kP0bDtMegfQ: raises $0.75 to $1
cZ99hugmLBj9KhTlc8nCSw: raises $2 to $3
+sbyWwIcFp9kP0bDtMegfQ: calls $2
*** FLOP *** [3d 4d 3c]
+sbyWwIcFp9kP0bDtMegfQ: checks 
cZ99hugmLBj9KhTlc8nCSw: bets $4
+sbyWwIcFp9kP0bDtMegfQ: folds 
Uncalled bet ($4) returned to cZ99hugmLBj9KhTlc8nCSw
cZ99hugmLBj9KhTlc8nCSw collected $5.70 from pot
cZ99hugmLBj9KhTlc8nCSw: doesn't show hand 
*** SUMMARY ***
Total pot $6 | Rake $0.30 
Board [3d 4d 3c]
Seat 2: clJsV3v77RS07bDKY+705w folded before Flop (didn't bet)
Seat 3: 7ovWM9c1nQLTFritEGRG/A folded before Flop (didn't bet)
Seat 5: +8OkYWUhGfkDbAtQl/ovYQ folded before Flop (didn't bet)
Seat 7: kUxTO3D2eQcx4oJIpJAK4Q (button) folded before Flop (didn't bet)
Seat 8: +sbyWwIcFp9kP0bDtMegfQ (small blind) folded on the Flop
Seat 9: cZ99hugmLBj9KhTlc8nCSw (big blind) collected ($5.70)




PokerStars Game #59941943488:  Hold'em No Limit ($0.10/$0.25) - 2009/07/01 1:51:07 ET
Table 'ORSZkZqq+7Ja2PdeCFAytA' 9-max Seat #1 is the button
Seat 1: 3FkcXBaxKqxYVagfYUZlmw ($17.90 in chips) 
Seat 2: j4q3p0lesp63b1gZDwLBZw ($11.40 in chips) 
Seat 3: s9a4d23HFxaL70yUWQ0/tQ ($19.10 in chips) 
Seat 4: tbgfV2Egwn85xEt865GWQQ ($16.80 in chips) 
Seat 5: +lWbsq4dTcA70SX/+hnmpg ($5 in chips) 
Seat 6: gMF+EMhmwpnaM5TFQquf2A ($4.90 in chips) 
Seat 7: clJsV3v77RS07bDKY+705w ($10.80 in chips) 
Seat 9: cMTFs4oCtNInkpDIecxT/w ($14.70 in chips) 
j4q3p0lesp63b1gZDwLBZw: posts small blind $0.10
s9a4d23HFxaL70yUWQ0/tQ: posts big blind $0.25
*** HOLE CARDS ***
tbgfV2Egwn85xEt865GWQQ: folds 
+lWbsq4dTcA70SX/+hnmpg: folds 
gMF+EMhmwpnaM5TFQquf2A: calls $0.25
clJsV3v77RS07bDKY+705w: folds 
cMTFs4oCtNInkpDIecxT/w: calls $0.25
3FkcXBaxKqxYVagfYUZlmw: calls $0.25
j4q3p0lesp63b1gZDwLBZw: folds 
s9a4d23HFxaL70yUWQ0/tQ: checks 
*** FLOP *** [Qc 4h 3c]
j4q3p0lesp63b1gZDwLBZw leaves the table
s9a4d23HFxaL70yUWQ0/tQ: checks 
gMF+EMhmwpnaM5TFQquf2A: bets $0.50
cMTFs4oCtNInkpDIecxT/w: calls $0.50
3FkcXBaxKqxYVagfYUZlmw: calls $0.50
s9a4d23HFxaL70yUWQ0/tQ: folds 
*** TURN *** [Qc 4h 3c] [Jh]
gMF+EMhmwpnaM5TFQquf2A: bets $0.75
cMTFs4oCtNInkpDIecxT/w: calls $0.75
3FkcXBaxKqxYVagfYUZlmw: calls $0.75
*** RIVER *** [Qc 4h 3c Jh] [6c]
gMF+EMhmwpnaM5TFQquf2A: bets $1.25
cMTFs4oCtNInkpDIecxT/w: raises $1.25 to $2.50
3FkcXBaxKqxYVagfYUZlmw: raises $13.90 to $16.40 and is all-in
gMF+EMhmwpnaM5TFQquf2A: calls $2.15 and is all-in
ydoFOVgzvZv9ZhuWu9rXAw joins the table at seat #2 
cMTFs4oCtNInkpDIecxT/w: folds 
Uncalled bet ($13) returned to 3FkcXBaxKqxYVagfYUZlmw
*** SHOW DOWN ***
3FkcXBaxKqxYVagfYUZlmw: shows [Jc Ac] (a flush, Ace high)
gMF+EMhmwpnaM5TFQquf2A: mucks hand 
3FkcXBaxKqxYVagfYUZlmw collected $13.50 from pot
*** SUMMARY ***
Total pot $14.15 | Rake $0.65 
Board [Qc 4h 3c Jh 6c]
Seat 1: 3FkcXBaxKqxYVagfYUZlmw (button) showed [Jc Ac] and won ($13.50) with a flush, Ace high
Seat 2: j4q3p0lesp63b1gZDwLBZw (small blind) folded before Flop
Seat 3: s9a4d23HFxaL70yUWQ0/tQ (big blind) folded on the Flop
Seat 4: tbgfV2Egwn85xEt865GWQQ folded before Flop (didn't bet)
Seat 5: +lWbsq4dTcA70SX/+hnmpg folded before Flop (didn't bet)
Seat 6: gMF+EMhmwpnaM5TFQquf2A mucked
Seat 7: clJsV3v77RS07bDKY+705w folded before Flop (didn't bet)
Seat 9: cMTFs4oCtNInkpDIecxT/w folded on the River




PokerStars Game #59941943564:  Hold'em No Limit ($0.10/$0.25) - 2009/07/01 1:51:07 ET
Table 'zKwHJD0cmKNUure9qQTfFg' 6-max Seat #4 is the button
Seat 1: Hzrn9DZJegEZICufTNYkrg ($17.50 in chips) 
Seat 2: xrf8tAXKQHG99HixCot1Iw ($31.55 in chips) 
Seat 3: m9aw7LBAB5YX2ZqMtMkhqA ($18.20 in chips) 
Seat 4: v+QfkGiuj9bgtuNoVnDO8w ($25 in chips) 
Seat 6: edio/rLJ06xeZOfLhoL3UA ($5.85 in chips) 
edio/rLJ06xeZOfLhoL3UA: posts small blind $0.10
Hzrn9DZJegEZICufTNYkrg: posts big blind $0.25
*** HOLE CARDS ***
xrf8tAXKQHG99HixCot1Iw: folds 
m9aw7LBAB5YX2ZqMtMkhqA: calls $0.25
v+QfkGiuj9bgtuNoVnDO8w: folds 
edio/rLJ06xeZOfLhoL3UA: folds 
Hzrn9DZJegEZICufTNYkrg: checks 
*** FLOP *** [2c 4h Js]
Hzrn9DZJegEZICufTNYkrg: bets $0.50
m9aw7LBAB5YX2ZqMtMkhqA: calls $0.50
*** TURN *** [2c 4h Js] [7h]
yoelik has returned
Hzrn9DZJegEZICufTNYkrg: bets $0.25
m9aw7LBAB5YX2ZqMtMkhqA: calls $0.25
*** RIVER *** [2c 4h Js 7h] [3s]
Hzrn9DZJegEZICufTNYkrg: bets $0.25
m9aw7LBAB5YX2ZqMtMkhqA: calls $0.25
*** SHOW DOWN ***
Hzrn9DZJegEZICufTNYkrg: shows [8c Jh] (a pair of Jacks)
m9aw7LBAB5YX2ZqMtMkhqA: shows [Kc Ks] (a pair of Kings)
m9aw7LBAB5YX2ZqMtMkhqA collected $2.50 from pot
*** SUMMARY ***
Total pot $2.60 | Rake $0.10 
Board [2c 4h Js 7h 3s]
Seat 1: Hzrn9DZJegEZICufTNYkrg (big blind) showed [8c Jh] and lost with a pair of Jacks
Seat 2: xrf8tAXKQHG99HixCot1Iw folded before Flop (didn't bet)
Seat 3: m9aw7LBAB5YX2ZqMtMkhqA showed [Kc Ks] and won ($2.50) with a pair of Kings
Seat 4: v+QfkGiuj9bgtuNoVnDO8w (button) folded before Flop (didn't bet)
Seat 6: edio/rLJ06xeZOfLhoL3UA (small blind) folded before Flop




PokerStars Game #59941943494:  Hold'em No Limit ($0.10/$0.25) - 2009/07/01 1:51:07 ET
Table '7/qMNloI0nSXWiX5Y1watA' 9-max Seat #4 is the button
Seat 1: /LyhaB3V6jkgOfXORidqRQ ($10.40 in chips) 
Seat 2: wGigCmBR/9XWkPpvYos3aQ ($29.80 in chips) 
Seat 4: K0LdhPeU31rviEPo6Sv3TA ($9.10 in chips) 
Seat 8: ljemhp25Zg+nlA9DLCIiUw ($26.05 in chips) 
Seat 9: dmYlc+1cjwZMJ7wV+Z0rRg ($27.40 in chips) 
GeMoapCKDLc4ajT0Uk9ZQw will be allowed to play after the button
JqeaikMej6KsqTKmUhl2Lw will be allowed to play after the button
z5GxcHlYz/GSz6W2uFiTtg will be allowed to play after the button
ljemhp25Zg+nlA9DLCIiUw: posts small blind $0.10
dmYlc+1cjwZMJ7wV+Z0rRg: posts big blind $0.25
*** HOLE CARDS ***
/LyhaB3V6jkgOfXORidqRQ: folds 
wGigCmBR/9XWkPpvYos3aQ: folds 
K0LdhPeU31rviEPo6Sv3TA: raises $0.50 to $0.75
W2YYHvqjaEpRrO7stZkClQ said, "pff"
W2YYHvqjaEpRrO7stZkClQ leaves the table
ljemhp25Zg+nlA9DLCIiUw: folds 
dmYlc+1cjwZMJ7wV+Z0rRg: folds 
Uncalled bet ($0.50) returned to K0LdhPeU31rviEPo6Sv3TA
K0LdhPeU31rviEPo6Sv3TA collected $0.60 from pot
K0LdhPeU31rviEPo6Sv3TA: doesn't show hand 
*** SUMMARY ***
Total pot $0.60 | Rake $0 
Seat 1: /LyhaB3V6jkgOfXORidqRQ folded before Flop (didn't bet)
Seat 2: wGigCmBR/9XWkPpvYos3aQ folded before Flop (didn't bet)
Seat 4: K0LdhPeU31rviEPo6Sv3TA (button) collected ($0.60)
Seat 8: ljemhp25Zg+nlA9DLCIiUw (small blind) folded before Flop
Seat 9: dmYlc+1cjwZMJ7wV+Z0rRg (big blind) folded before Flop




PokerStars Game #59941944248:  Hold'em No Limit ($0.10/$0.25) - 2009/07/01 1:51:08 ET
Table 'jz4TpuH+ag+0iNe2ZcxckQ' 9-max Seat #4 is the button
Seat 2: clJsV3v77RS07bDKY+705w ($6.10 in chips) 
Seat 3: egvg3mTBBVzMHnJPIQiKcA ($18.50 in chips) 
Seat 4: k+2r6di6GXjNpAdrRkW9bA ($57.80 in chips) 
Seat 5: v1BVHNGLbP/nx7QO6K7+Jw ($27.75 in chips) 
Seat 6: gO1uiTGTzn5Cd3PECuws1g ($8.65 in chips) 
Seat 7: tLcDklc2rBORNfixyRfVfw ($53.65 in chips) 
Seat 8: uhrboV251dcgYniYTdFIcA ($25.35 in chips) 
Seat 9: W2YYHvqjaEpRrO7stZkClQ ($5.30 in chips) 
v1BVHNGLbP/nx7QO6K7+Jw: posts small blind $0.10
gO1uiTGTzn5Cd3PECuws1g: posts big blind $0.25
4awUyiDYTgylQKXZ9faBVA: sits out 
*** HOLE CARDS ***
tLcDklc2rBORNfixyRfVfw: folds 
uhrboV251dcgYniYTdFIcA: folds 
W2YYHvqjaEpRrO7stZkClQ: calls $0.25
clJsV3v77RS07bDKY+705w: folds 
egvg3mTBBVzMHnJPIQiKcA: folds 
k+2r6di6GXjNpAdrRkW9bA: folds 
v1BVHNGLbP/nx7QO6K7+Jw: calls $0.15
gO1uiTGTzn5Cd3PECuws1g: checks 
*** FLOP *** [4h 9c Ts]
v1BVHNGLbP/nx7QO6K7+Jw: checks 
gO1uiTGTzn5Cd3PECuws1g: bets $0.25
W2YYHvqjaEpRrO7stZkClQ: calls $0.25
v1BVHNGLbP/nx7QO6K7+Jw: folds 
*** TURN *** [4h 9c Ts] [7d]
gO1uiTGTzn5Cd3PECuws1g: bets $0.50
W2YYHvqjaEpRrO7stZkClQ: calls $0.50
*** RIVER *** [4h 9c Ts 7d] [6h]
gO1uiTGTzn5Cd3PECuws1g: bets $1
W2YYHvqjaEpRrO7stZkClQ: raises $3.30 to $4.30 and is all-in
gO1uiTGTzn5Cd3PECuws1g: calls $3.30
*** SHOW DOWN ***
W2YYHvqjaEpRrO7stZkClQ: shows [8c 8d] (a straight, Six to Ten)
gO1uiTGTzn5Cd3PECuws1g: shows [8h 9s] (a straight, Six to Ten)
gO1uiTGTzn5Cd3PECuws1g collected $5.20 from pot
W2YYHvqjaEpRrO7stZkClQ collected $5.15 from pot
*** SUMMARY ***
Total pot $10.85 | Rake $0.50 
Board [4h 9c Ts 7d 6h]
Seat 2: clJsV3v77RS07bDKY+705w folded before Flop (didn't bet)
Seat 3: egvg3mTBBVzMHnJPIQiKcA folded before Flop (didn't bet)
Seat 4: k+2r6di6GXjNpAdrRkW9bA (button) folded before Flop (didn't bet)
Seat 5: v1BVHNGLbP/nx7QO6K7+Jw (small blind) folded on the Flop
Seat 6: gO1uiTGTzn5Cd3PECuws1g (big blind) showed [8h 9s] and won ($5.20) with a straight, Six to Ten
Seat 7: tLcDklc2rBORNfixyRfVfw folded before Flop (didn't bet)
Seat 8: uhrboV251dcgYniYTdFIcA folded before Flop (didn't bet)
Seat 9: W2YYHvqjaEpRrO7stZkClQ showed [8c 8d] and won ($5.15) with a straight, Six to Ten




PokerStars Game #59941944474:  Hold'em No Limit ($0.10/$0.25) - 2009/07/01 1:51:08 ET
Table 'zW+7jPbOLCvlPu+dUGY5WQ' 6-max Seat #1 is the button
Seat 1: eL3+wCBjFGfQ5FMdIZihwA ($31.20 in chips) 
Seat 4: i48129QFpEQQ+UN4aNtmww ($15.90 in chips) 
Seat 5: rDRzxas/uMDi5Uteo081UQ ($14.75 in chips) 
Seat 6: qGHGf/553gQnDoklMRe3tg ($24.50 in chips) 
TQ7/UUMjrZ3WL5eLMho7VQ will be allowed to play after the button
AnnaskyII was removed from the table for failing to post
i48129QFpEQQ+UN4aNtmww: posts small blind $0.10
rDRzxas/uMDi5Uteo081UQ: posts big blind $0.25
*** HOLE CARDS ***
qGHGf/553gQnDoklMRe3tg: folds 
eL3+wCBjFGfQ5FMdIZihwA: folds 
i48129QFpEQQ+UN4aNtmww: raises $0.25 to $0.50
rDRzxas/uMDi5Uteo081UQ: folds 
Uncalled bet ($0.25) returned to i48129QFpEQQ+UN4aNtmww
i48129QFpEQQ+UN4aNtmww collected $0.50 from pot
*** SUMMARY ***
Total pot $0.50 | Rake $0 
Seat 1: eL3+wCBjFGfQ5FMdIZihwA (button) folded before Flop (didn't bet)
Seat 4: i48129QFpEQQ+UN4aNtmww (small blind) collected ($0.50)
Seat 5: rDRzxas/uMDi5Uteo081UQ (big blind) folded before Flop
Seat 6: qGHGf/553gQnDoklMRe3tg folded before Flop (didn't bet)




PokerStars Game #59941944240:  Hold'em No Limit ($0.10/$0.25) - 2009/07/01 1:51:08 ET
Table '5NipxzzFB2DffzDpddyQoQ' 6-max Seat #3 is the button
Seat 2: iauW7L/+7qzAuHow7CD75Q ($5 in chips) 
Seat 3: QvTX2yGq3uKJiKPmns4TKQ ($24.70 in chips) 
Seat 5: faP2NVl/cFTZ1nE4pXzg8Q ($21.20 in chips) 
Seat 6: 7JqTFMyeNSVWsmp/yW35Tw ($54.05 in chips) 
faP2NVl/cFTZ1nE4pXzg8Q: posts small blind $0.10
7JqTFMyeNSVWsmp/yW35Tw: posts big blind $0.25
*** HOLE CARDS ***
iauW7L/+7qzAuHow7CD75Q: folds 
QvTX2yGq3uKJiKPmns4TKQ: raises $0.50 to $0.75
faP2NVl/cFTZ1nE4pXzg8Q: folds 
7JqTFMyeNSVWsmp/yW35Tw: folds 
Uncalled bet ($0.50) returned to QvTX2yGq3uKJiKPmns4TKQ
iauW7L/+7qzAuHow7CD75Q said, "he was up alot otnight"
QvTX2yGq3uKJiKPmns4TKQ collected $0.60 from pot
QvTX2yGq3uKJiKPmns4TKQ: doesn't show hand 
*** SUMMARY ***
Total pot $0.60 | Rake $0 
Seat 2: iauW7L/+7qzAuHow7CD75Q folded before Flop (didn't bet)
Seat 3: QvTX2yGq3uKJiKPmns4TKQ (button) collected ($0.60)
Seat 5: faP2NVl/cFTZ1nE4pXzg8Q (small blind) folded before Flop
Seat 6: 7JqTFMyeNSVWsmp/yW35Tw (big blind) folded before Flop




PokerStars Game #59941943984:  Hold'em No Limit ($0.10/$0.25) - 2009/07/01 1:51:08 ET
Table 'h02LhQ7B/Zk4ETRxxHhGYA' 9-max Seat #7 is the button
Seat 1: sD+TKtt36XiiN6jqHiLwDA ($26.15 in chips) 
Seat 2: 9lvO/qyU+xrU95Teu1fv0g ($7.05 in chips) 
Seat 3: arxNSjreDRGFg13EAM2F1w ($30.40 in chips) 
Seat 4: ZyPfMsrS7T70lNdYA6rJ7w ($10.50 in chips) 
Seat 5: cUxk0Jk4lrUQv9CJl0LPlg ($28 in chips) 
Seat 6: UvM6sxFT7el5hVDehvWvTA ($30.40 in chips) 
Seat 7: y7w8+Oqq4SkI1dkRDCx2Zg ($3 in chips) 
Seat 8: mUoFJKqCzIUABvOFbiINlQ ($14.95 in chips) 
Seat 9: HcU1ud5gMXGuhN1QChAhfQ ($24.50 in chips) 
mUoFJKqCzIUABvOFbiINlQ: posts small blind $0.10
HcU1ud5gMXGuhN1QChAhfQ: posts big blind $0.25
*** HOLE CARDS ***
sD+TKtt36XiiN6jqHiLwDA: folds 
9lvO/qyU+xrU95Teu1fv0g: folds 
arxNSjreDRGFg13EAM2F1w: folds 
ZyPfMsrS7T70lNdYA6rJ7w: raises $0.50 to $0.75
cUxk0Jk4lrUQv9CJl0LPlg: folds 
UvM6sxFT7el5hVDehvWvTA: calls $0.75
y7w8+Oqq4SkI1dkRDCx2Zg: folds 
mUoFJKqCzIUABvOFbiINlQ: folds 
y7w8+Oqq4SkI1dkRDCx2Zg is sitting out
HcU1ud5gMXGuhN1QChAhfQ: folds 
*** FLOP *** [7c Kh 2c]
ZyPfMsrS7T70lNdYA6rJ7w: checks 
UvM6sxFT7el5hVDehvWvTA: bets $0.80
ZyPfMsrS7T70lNdYA6rJ7w: calls $0.80
*** TURN *** [7c Kh 2c] [Qd]
ZyPfMsrS7T70lNdYA6rJ7w: checks 
y7w8+Oqq4SkI1dkRDCx2Zg is disconnected 
UvM6sxFT7el5hVDehvWvTA: checks 
*** RIVER *** [7c Kh 2c Qd] [Qs]
ZyPfMsrS7T70lNdYA6rJ7w: bets $1
UvM6sxFT7el5hVDehvWvTA said, "full house?"
UvM6sxFT7el5hVDehvWvTA said, "set of kings?"
UvM6sxFT7el5hVDehvWvTA: calls $1
*** SHOW DOWN ***
ZyPfMsrS7T70lNdYA6rJ7w: shows [7d 7s] (a full house, Sevens full of Queens)
UvM6sxFT7el5hVDehvWvTA: mucks hand 
ZyPfMsrS7T70lNdYA6rJ7w collected $5.20 from pot
*** SUMMARY ***
Total pot $5.45 | Rake $0.25 
Board [7c Kh 2c Qd Qs]
Seat 1: sD+TKtt36XiiN6jqHiLwDA folded before Flop (didn't bet)
Seat 2: 9lvO/qyU+xrU95Teu1fv0g folded before Flop (didn't bet)
Seat 3: arxNSjreDRGFg13EAM2F1w folded before Flop (didn't bet)
Seat 4: ZyPfMsrS7T70lNdYA6rJ7w showed [7d 7s] and won ($5.20) with a full house, Sevens full of Queens
Seat 5: cUxk0Jk4lrUQv9CJl0LPlg folded before Flop (didn't bet)
Seat 6: UvM6sxFT7el5hVDehvWvTA mucked
Seat 7: y7w8+Oqq4SkI1dkRDCx2Zg (button) folded before Flop (didn't bet)
Seat 8: mUoFJKqCzIUABvOFbiINlQ (small blind) folded before Flop
Seat 9: HcU1ud5gMXGuhN1QChAhfQ (big blind) folded before Flop




PokerStars Game #59941944662:  Hold'em No Limit ($0.10/$0.25) - 2009/07/01 1:51:09 ET
Table 'XX2OuOsa8/8AC+/mR/Az6g' 9-max Seat #4 is the button
Seat 1: 56S3mA6Zs3pGR+0p0vUCtg ($23.15 in chips) 
Seat 2: Bb42QRQMhg5/Y0vHP8/2Xw ($25.25 in chips) 
Seat 3: oLa/tXLfSLLB28mcLGrxcg ($23.35 in chips) 
Seat 4: 5pDhXQ+RVy0BGcwfJAJfbg ($24.65 in chips) 
Seat 5: SpiiQQAzy4MUgV3I5W8giw ($20.90 in chips) 
Seat 6: RCqMONFrSPSArZh2Jsar/w ($24.65 in chips) 
Seat 8: qwr38jl5txoR36M7G5qi4A ($10.35 in chips) 
Seat 9: V6p0jQ/RhUsqpHLmXvEX4Q ($12 in chips) 
SpiiQQAzy4MUgV3I5W8giw: posts small blind $0.10
RCqMONFrSPSArZh2Jsar/w: posts big blind $0.25
*** HOLE CARDS ***
qwr38jl5txoR36M7G5qi4A: folds 
V6p0jQ/RhUsqpHLmXvEX4Q: folds 
56S3mA6Zs3pGR+0p0vUCtg: folds 
Bb42QRQMhg5/Y0vHP8/2Xw: folds 
oLa/tXLfSLLB28mcLGrxcg: calls $0.25
5pDhXQ+RVy0BGcwfJAJfbg: folds 
SpiiQQAzy4MUgV3I5W8giw: folds 
RCqMONFrSPSArZh2Jsar/w: checks 
*** FLOP *** [2s 8d 6d]
RCqMONFrSPSArZh2Jsar/w: checks 
oLa/tXLfSLLB28mcLGrxcg: checks 
*** TURN *** [2s 8d 6d] [3h]
RCqMONFrSPSArZh2Jsar/w: checks 
oLa/tXLfSLLB28mcLGrxcg: checks 
*** RIVER *** [2s 8d 6d 3h] [Js]
RCqMONFrSPSArZh2Jsar/w: checks 
oLa/tXLfSLLB28mcLGrxcg: checks 
*** SHOW DOWN ***
RCqMONFrSPSArZh2Jsar/w: shows [6s Kd] (a pair of Sixes)
oLa/tXLfSLLB28mcLGrxcg: mucks hand 
RCqMONFrSPSArZh2Jsar/w collected $0.60 from pot
*** SUMMARY ***
Total pot $0.60 | Rake $0 
Board [2s 8d 6d 3h Js]
Seat 1: 56S3mA6Zs3pGR+0p0vUCtg folded before Flop (didn't bet)
Seat 2: Bb42QRQMhg5/Y0vHP8/2Xw folded before Flop (didn't bet)
Seat 3: oLa/tXLfSLLB28mcLGrxcg mucked
Seat 4: 5pDhXQ+RVy0BGcwfJAJfbg (button) folded before Flop (didn't bet)
Seat 5: SpiiQQAzy4MUgV3I5W8giw (small blind) folded before Flop
Seat 6: RCqMONFrSPSArZh2Jsar/w (big blind) showed [6s Kd] and won ($0.60) with a pair of Sixes
Seat 8: qwr38jl5txoR36M7G5qi4A folded before Flop (didn't bet)
Seat 9: V6p0jQ/RhUsqpHLmXvEX4Q folded before Flop (didn't bet)




PokerStars Game #59941944648:  Hold'em No Limit ($0.10/$0.25) - 2009/07/01 1:51:09 ET
Table 'AUM6O+mgQAaLDZKMQ/5/gA' 9-max Seat #8 is the button
Seat 2: z5GxcHlYz/GSz6W2uFiTtg ($24.50 in chips) 
Seat 3: CvL9Ch1HYCVbTsfpNucitg ($5 in chips) 
Seat 4: 4awUyiDYTgylQKXZ9faBVA ($28.55 in chips) 
Seat 5: +2kMBNpY4nF1qNCRd8SJLA ($25.30 in chips) 
Seat 6: v5jnQ1gfh9nLla3kMXG7Yg ($11 in chips) 
Seat 7: Bb42QRQMhg5/Y0vHP8/2Xw ($28.50 in chips) 
Seat 8: zDrucyjVn5aeekNEc3cJrA ($17.05 in chips) 
Seat 9: eK8qa6EPcH2zhtbmWSvc9g ($29.45 in chips) 
eK8qa6EPcH2zhtbmWSvc9g: posts small blind $0.10
z5GxcHlYz/GSz6W2uFiTtg: posts big blind $0.25
*** HOLE CARDS ***
CvL9Ch1HYCVbTsfpNucitg: folds 
4awUyiDYTgylQKXZ9faBVA: folds 
+2kMBNpY4nF1qNCRd8SJLA: calls $0.25
v5jnQ1gfh9nLla3kMXG7Yg: calls $0.25
Bb42QRQMhg5/Y0vHP8/2Xw: folds 
SpiiQQAzy4MUgV3I5W8giw joins the table at seat #1 
zDrucyjVn5aeekNEc3cJrA: folds 
eK8qa6EPcH2zhtbmWSvc9g: folds 
z5GxcHlYz/GSz6W2uFiTtg: checks 
*** FLOP *** [4c Jc As]
z5GxcHlYz/GSz6W2uFiTtg: checks 
+2kMBNpY4nF1qNCRd8SJLA: bets $0.50
v5jnQ1gfh9nLla3kMXG7Yg: calls $0.50
z5GxcHlYz/GSz6W2uFiTtg: folds 
*** TURN *** [4c Jc As] [Th]
+2kMBNpY4nF1qNCRd8SJLA: checks 
v5jnQ1gfh9nLla3kMXG7Yg: checks 
*** RIVER *** [4c Jc As Th] [5c]
+2kMBNpY4nF1qNCRd8SJLA: bets $0.75
v5jnQ1gfh9nLla3kMXG7Yg: calls $0.75
*** SHOW DOWN ***
+2kMBNpY4nF1qNCRd8SJLA: shows [9h Ah] (a pair of Aces)
v5jnQ1gfh9nLla3kMXG7Yg: shows [5h Ad] (two pair, Aces and Fives)
v5jnQ1gfh9nLla3kMXG7Yg collected $3.20 from pot
*** SUMMARY ***
Total pot $3.35 | Rake $0.15 
Board [4c Jc As Th 5c]
Seat 2: z5GxcHlYz/GSz6W2uFiTtg (big blind) folded on the Flop
Seat 3: CvL9Ch1HYCVbTsfpNucitg folded before Flop (didn't bet)
Seat 4: 4awUyiDYTgylQKXZ9faBVA folded before Flop (didn't bet)
Seat 5: +2kMBNpY4nF1qNCRd8SJLA showed [9h Ah] and lost with a pair of Aces
Seat 6: v5jnQ1gfh9nLla3kMXG7Yg showed [5h Ad] and won ($3.20) with two pair, Aces and Fives
Seat 7: Bb42QRQMhg5/Y0vHP8/2Xw folded before Flop (didn't bet)
Seat 8: zDrucyjVn5aeekNEc3cJrA (button) folded before Flop (didn't bet)
Seat 9: eK8qa6EPcH2zhtbmWSvc9g (small blind) folded before Flop




PokerStars Game #59941944682:  Hold'em No Limit ($0.10/$0.25) - 2009/07/01 1:51:09 ET
Table 'fHv1Mk7ZbLjprZTGWKPiEQ' 6-max Seat #1 is the button
Seat 1: OIjOiBfQstWrK/RuXx7zcw ($4.25 in chips) 
Seat 2: 9U3ZKjCsarN0DjR6mSE8Ug ($13.55 in chips) 
Seat 3: /gJNBeCkWL4o85/jvlZ4BA ($25 in chips) 
Seat 4: TSmua8tGK3sTbwi0ynrW9Q ($60 in chips) 
Seat 5: LJI7A1YgDM7hgh7o56+ReQ ($25.95 in chips) 
Seat 6: AjG0X+rNtc2W08eph8oqpw ($52.40 in chips) 
9U3ZKjCsarN0DjR6mSE8Ug: posts small blind $0.10
/gJNBeCkWL4o85/jvlZ4BA: posts big blind $0.25
*** HOLE CARDS ***
TSmua8tGK3sTbwi0ynrW9Q: folds 
LJI7A1YgDM7hgh7o56+ReQ: folds 
AjG0X+rNtc2W08eph8oqpw: folds 
OIjOiBfQstWrK/RuXx7zcw: folds 
9U3ZKjCsarN0DjR6mSE8Ug: folds 
Uncalled bet ($0.15) returned to /gJNBeCkWL4o85/jvlZ4BA
/gJNBeCkWL4o85/jvlZ4BA collected $0.20 from pot
*** SUMMARY ***
Total pot $0.20 | Rake $0 
Seat 1: OIjOiBfQstWrK/RuXx7zcw (button) folded before Flop (didn't bet)
Seat 2: 9U3ZKjCsarN0DjR6mSE8Ug (small blind) folded before Flop
Seat 3: /gJNBeCkWL4o85/jvlZ4BA (big blind) collected ($0.20)
Seat 4: TSmua8tGK3sTbwi0ynrW9Q folded before Flop (didn't bet)
Seat 5: LJI7A1YgDM7hgh7o56+ReQ folded before Flop (didn't bet)
Seat 6: AjG0X+rNtc2W08eph8oqpw folded before Flop (didn't bet)




PokerStars Game #59941945582:  Hold'em No Limit ($0.10/$0.25) - 2009/07/01 1:51:10 ET
Table 'BpNkESDX1ip9c0K1hb5h7A' 6-max Seat #6 is the button
Seat 1: 5YZdVjBPZVEdubN4xEMPEg ($10.85 in chips) 
Seat 2: 9U3ZKjCsarN0DjR6mSE8Ug ($19.60 in chips) 
Seat 3: fZQg9veL7Dd/Z04ZTjC+wQ ($37.15 in chips) 
Seat 4: kG34n23qFQA3nzdOJTQ1dA ($26.50 in chips) 
Seat 5: OMGl+YMGogf2JWIRfT2/Yg ($7.40 in chips) 
Seat 6: 8EEqTTh7T1q48sYDqbI2Xg ($21.80 in chips) 
5YZdVjBPZVEdubN4xEMPEg: posts small blind $0.10
9U3ZKjCsarN0DjR6mSE8Ug: posts big blind $0.25
*** HOLE CARDS ***
fZQg9veL7Dd/Z04ZTjC+wQ: folds 
kG34n23qFQA3nzdOJTQ1dA: folds 
OMGl+YMGogf2JWIRfT2/Yg: calls $0.25
8EEqTTh7T1q48sYDqbI2Xg: folds 
5YZdVjBPZVEdubN4xEMPEg: calls $0.15
9U3ZKjCsarN0DjR6mSE8Ug: checks 
*** FLOP *** [8h Qs 6h]
5YZdVjBPZVEdubN4xEMPEg: checks 
9U3ZKjCsarN0DjR6mSE8Ug: checks 
OMGl+YMGogf2JWIRfT2/Yg: checks 
*** TURN *** [8h Qs 6h] [8c]
5YZdVjBPZVEdubN4xEMPEg: checks 
9U3ZKjCsarN0DjR6mSE8Ug: checks 
OMGl+YMGogf2JWIRfT2/Yg: checks 
*** RIVER *** [8h Qs 6h 8c] [4h]
5YZdVjBPZVEdubN4xEMPEg: bets $1
9U3ZKjCsarN0DjR6mSE8Ug: folds 
OMGl+YMGogf2JWIRfT2/Yg: folds 
Uncalled bet ($1) returned to 5YZdVjBPZVEdubN4xEMPEg
5YZdVjBPZVEdubN4xEMPEg collected $0.75 from pot
*** SUMMARY ***
Total pot $0.75 | Rake $0 
Board [8h Qs 6h 8c 4h]
Seat 1: 5YZdVjBPZVEdubN4xEMPEg (small blind) collected ($0.75)
Seat 2: 9U3ZKjCsarN0DjR6mSE8Ug (big blind) folded on the River
Seat 3: fZQg9veL7Dd/Z04ZTjC+wQ folded before Flop (didn't bet)
Seat 4: kG34n23qFQA3nzdOJTQ1dA folded before Flop (didn't bet)
Seat 5: OMGl+YMGogf2JWIRfT2/Yg folded on the River
Seat 6: 8EEqTTh7T1q48sYDqbI2Xg (button) folded before Flop (didn't bet)




PokerStars Game #59941945246:  Hold'em No Limit ($0.10/$0.25) - 2009/07/01 1:51:10 ET
Table 'Qr+t8WGovMECkBv+cV1lrg' 6-max Seat #4 is the button
Seat 1: EeUZtMU058v2ObUACOF4Og ($34.45 in chips) 
Seat 2: vqWjZmdQu/Hxw96/IJTWdQ ($41.60 in chips) 
Seat 3: uZKkrGByYgd4/ZBX2d4z+w ($20.75 in chips) 
Seat 4: 1NNFfYMd5Hsphl/FYz9fNA ($59.80 in chips) 
Seat 5: I50OxuNg9riRq9sywF6jMQ ($4.75 in chips) 
Seat 6: 9U3ZKjCsarN0DjR6mSE8Ug ($14.35 in chips) 
I50OxuNg9riRq9sywF6jMQ: posts small blind $0.10
9U3ZKjCsarN0DjR6mSE8Ug: posts big blind $0.25
*** HOLE CARDS ***
EeUZtMU058v2ObUACOF4Og: folds 
vqWjZmdQu/Hxw96/IJTWdQ: folds 
uZKkrGByYgd4/ZBX2d4z+w: calls $0.25
1NNFfYMd5Hsphl/FYz9fNA: raises $0.75 to $1
I50OxuNg9riRq9sywF6jMQ: folds 
9U3ZKjCsarN0DjR6mSE8Ug: folds 
uZKkrGByYgd4/ZBX2d4z+w: calls $0.75
*** FLOP *** [8s Ah 7d]
uZKkrGByYgd4/ZBX2d4z+w: checks 
1NNFfYMd5Hsphl/FYz9fNA: checks 
*** TURN *** [8s Ah 7d] [7c]
uZKkrGByYgd4/ZBX2d4z+w: checks 
1NNFfYMd5Hsphl/FYz9fNA: bets $1.25
uZKkrGByYgd4/ZBX2d4z+w: folds 
Uncalled bet ($1.25) returned to 1NNFfYMd5Hsphl/FYz9fNA
1NNFfYMd5Hsphl/FYz9fNA collected $2.25 from pot
*** SUMMARY ***
Total pot $2.35 | Rake $0.10 
Board [8s Ah 7d 7c]
Seat 1: EeUZtMU058v2ObUACOF4Og folded before Flop (didn't bet)
Seat 2: vqWjZmdQu/Hxw96/IJTWdQ folded before Flop (didn't bet)
Seat 3: uZKkrGByYgd4/ZBX2d4z+w folded on the Turn
Seat 4: 1NNFfYMd5Hsphl/FYz9fNA (button) collected ($2.25)
Seat 5: I50OxuNg9riRq9sywF6jMQ (small blind) folded before Flop
Seat 6: 9U3ZKjCsarN0DjR6mSE8Ug (big blind) folded before Flop




PokerStars Game #59941945248:  Hold'em No Limit ($0.10/$0.25) - 2009/07/01 1:51:10 ET
Table 'Zi9/NqNs3XoL1eWhMCyZyg' 9-max Seat #6 is the button
Seat 1: X6+pSIPfovPcE87t+LmUKQ ($4.50 in chips) 
Seat 2: 1wKfgJ8xXIiuc8C6qjkxhg ($4.60 in chips) 
Seat 3: ETC7YyRJTa2Ovhln64Ni5Q ($27.80 in chips) 
Seat 4: dmYlc+1cjwZMJ7wV+Z0rRg ($23.40 in chips) 
Seat 5: HE9eSITnljG4AKvgOR4BMw ($15 in chips) 
Seat 6: YQhfmYhgnDDlWCAFmBb36Q ($18.25 in chips) 
Seat 7: 0QdZrkFD7aGKeBXPGbIomA ($1.95 in chips) 
Seat 8: nm4Dj/f+jJEwKVsUnKh73g ($34.65 in chips) 
0QdZrkFD7aGKeBXPGbIomA: posts small blind $0.10
nm4Dj/f+jJEwKVsUnKh73g: posts big blind $0.25
3l+i+xMeyDndSXMF2A5CDA: sits out 
HE9eSITnljG4AKvgOR4BMw: posts big blind $0.25
*** HOLE CARDS ***
X6+pSIPfovPcE87t+LmUKQ: folds 
1wKfgJ8xXIiuc8C6qjkxhg: folds 
ETC7YyRJTa2Ovhln64Ni5Q: folds 
dmYlc+1cjwZMJ7wV+Z0rRg: raises $0.50 to $0.75
HE9eSITnljG4AKvgOR4BMw: folds 
YQhfmYhgnDDlWCAFmBb36Q: folds 
0QdZrkFD7aGKeBXPGbIomA: folds 
nm4Dj/f+jJEwKVsUnKh73g: folds 
Uncalled bet ($0.50) returned to dmYlc+1cjwZMJ7wV+Z0rRg
dmYlc+1cjwZMJ7wV+Z0rRg collected $0.85 from pot
dmYlc+1cjwZMJ7wV+Z0rRg: doesn't show hand 
*** SUMMARY ***
Total pot $0.85 | Rake $0 
Seat 1: X6+pSIPfovPcE87t+LmUKQ folded before Flop (didn't bet)
Seat 2: 1wKfgJ8xXIiuc8C6qjkxhg folded before Flop (didn't bet)
Seat 3: ETC7YyRJTa2Ovhln64Ni5Q folded before Flop (didn't bet)
Seat 4: dmYlc+1cjwZMJ7wV+Z0rRg collected ($0.85)
Seat 5: HE9eSITnljG4AKvgOR4BMw folded before Flop
Seat 6: YQhfmYhgnDDlWCAFmBb36Q (button) folded before Flop (didn't bet)
Seat 7: 0QdZrkFD7aGKeBXPGbIomA (small blind) folded before Flop
Seat 8: nm4Dj/f+jJEwKVsUnKh73g (big blind) folded before Flop




PokerStars Game #59941945108:  Hold'em No Limit ($0.10/$0.25) - 2009/07/01 1:51:10 ET
Table '4UJB/UOZ5aepyF2v+hIoUg' 6-max Seat #1 is the button
Seat 1: 08V++DOqzaNrRNsHIwi25w ($25 in chips) 
Seat 3: zlYHXTtJ5tcx9kwK2h5n9A ($51.15 in chips) 
Seat 4: R6AGToFJQOYVZAjC2jXEKw ($25 in chips) 
Seat 5: 3zD3qLXT1bEffAoWGnc7wg ($25.80 in chips) 
Seat 6: 2aphcinkTZT0B0Uoah6cvQ ($15.10 in chips) 
zlYHXTtJ5tcx9kwK2h5n9A: posts small blind $0.10
R6AGToFJQOYVZAjC2jXEKw: posts big blind $0.25
*** HOLE CARDS ***
3zD3qLXT1bEffAoWGnc7wg: folds 
2aphcinkTZT0B0Uoah6cvQ: folds 
08V++DOqzaNrRNsHIwi25w: raises $0.50 to $0.75
zlYHXTtJ5tcx9kwK2h5n9A: calls $0.65
R6AGToFJQOYVZAjC2jXEKw: folds 
*** FLOP *** [2s 3h 6s]
zlYHXTtJ5tcx9kwK2h5n9A: checks 
08V++DOqzaNrRNsHIwi25w: bets $1
zlYHXTtJ5tcx9kwK2h5n9A: calls $1
*** TURN *** [2s 3h 6s] [Th]
zlYHXTtJ5tcx9kwK2h5n9A: checks 
08V++DOqzaNrRNsHIwi25w: bets $3
zlYHXTtJ5tcx9kwK2h5n9A: folds 
Uncalled bet ($3) returned to 08V++DOqzaNrRNsHIwi25w
08V++DOqzaNrRNsHIwi25w collected $3.60 from pot
08V++DOqzaNrRNsHIwi25w: doesn't show hand 
*** SUMMARY ***
Total pot $3.75 | Rake $0.15 
Board [2s 3h 6s Th]
Seat 1: 08V++DOqzaNrRNsHIwi25w (button) collected ($3.60)
Seat 3: zlYHXTtJ5tcx9kwK2h5n9A (small blind) folded on the Turn
Seat 4: R6AGToFJQOYVZAjC2jXEKw (big blind) folded before Flop
Seat 5: 3zD3qLXT1bEffAoWGnc7wg folded before Flop (didn't bet)
Seat 6: 2aphcinkTZT0B0Uoah6cvQ folded before Flop (didn't bet)




PokerStars Game #59941945186:  Hold'em No Limit ($0.10/$0.25) - 2009/07/01 1:51:10 ET
Table 'nlpa8xI95gAflovnFxB2yg' 6-max Seat #4 is the button
Seat 1: fZQg9veL7Dd/Z04ZTjC+wQ ($61.80 in chips) 
Seat 2: Yuyy/pDz3yAO3EbHYRYnKw ($23.80 in chips) 
Seat 3: DihMHaz4WNETH1bPDe13kA ($25.50 in chips) 
Seat 4: if4dh6jhJXeN3/qd3qCp9g ($52 in chips) 
Seat 6: ATNFxN8fYVfSZMQW8dvbvw ($5 in chips) 
pSneaCslVpgO8mzi5yQMww will be allowed to play after the button
ATNFxN8fYVfSZMQW8dvbvw: posts small blind $0.10
fZQg9veL7Dd/Z04ZTjC+wQ: posts big blind $0.25
*** HOLE CARDS ***
Yuyy/pDz3yAO3EbHYRYnKw: calls $0.25
DihMHaz4WNETH1bPDe13kA: folds 
if4dh6jhJXeN3/qd3qCp9g: folds 
ATNFxN8fYVfSZMQW8dvbvw: calls $0.15
fZQg9veL7Dd/Z04ZTjC+wQ: raises $1.25 to $1.50
Yuyy/pDz3yAO3EbHYRYnKw: folds 
ATNFxN8fYVfSZMQW8dvbvw: folds 
Uncalled bet ($1.25) returned to fZQg9veL7Dd/Z04ZTjC+wQ
fZQg9veL7Dd/Z04ZTjC+wQ collected $0.75 from pot
fZQg9veL7Dd/Z04ZTjC+wQ: doesn't show hand 
*** SUMMARY ***
Total pot $0.75 | Rake $0 
Seat 1: fZQg9veL7Dd/Z04ZTjC+wQ (big blind) collected ($0.75)
Seat 2: Yuyy/pDz3yAO3EbHYRYnKw folded before Flop
Seat 3: DihMHaz4WNETH1bPDe13kA folded before Flop (didn't bet)
Seat 4: if4dh6jhJXeN3/qd3qCp9g (button) folded before Flop (didn't bet)
Seat 6: ATNFxN8fYVfSZMQW8dvbvw (small blind) folded before Flop




PokerStars Game #59941945554:  Hold'em No Limit ($0.10/$0.25) - 2009/07/01 1:51:10 ET
Table 'Mef6A0EMopL6WaFO5/KO9g' 6-max Seat #5 is the button
Seat 2: 8ClCHtFXGNplITm+63KB+Q ($29.35 in chips) 
Seat 5: DihMHaz4WNETH1bPDe13kA ($41.15 in chips) 
DihMHaz4WNETH1bPDe13kA: posts small blind $0.10
GbCVUNssQ7mqsPWr7J4d3w: is sitting out 
GbCVUNssQ7mqsPWr7J4d3w leaves the table
8ClCHtFXGNplITm+63KB+Q: posts big blind $0.25
*** HOLE CARDS ***
DihMHaz4WNETH1bPDe13kA: folds 
Uncalled bet ($0.15) returned to 8ClCHtFXGNplITm+63KB+Q
8ClCHtFXGNplITm+63KB+Q collected $0.20 from pot
8ClCHtFXGNplITm+63KB+Q: doesn't show hand 
8ClCHtFXGNplITm+63KB+Q leaves the table
*** SUMMARY ***
Total pot $0.20 | Rake $0 
Seat 2: 8ClCHtFXGNplITm+63KB+Q (big blind) collected ($0.20)
Seat 5: DihMHaz4WNETH1bPDe13kA (button) (small blind) folded before Flop




PokerStars Game #59941945742:  Hold'em No Limit ($0.10/$0.25) - 2009/07/01 1:51:11 ET
Table 'fRxOyfaHXkWUDLv4eSxFew' 9-max Seat #7 is the button
Seat 1: 6RiVTYll/5D8zICp0MRpKw ($29.40 in chips) 
Seat 2: M2QO2DxB5Wawg2h8HSpnYA ($10 in chips) 
Seat 3: E0iYnEVO2ho7dH3QcCjw7g ($29.70 in chips) 
Seat 4: MtVtHDqIJTyUcXkRBBDIVA ($27.60 in chips) 
Seat 5: dmYlc+1cjwZMJ7wV+Z0rRg ($21.65 in chips) 
Seat 6: arxNSjreDRGFg13EAM2F1w ($27.05 in chips) 
Seat 7: 1/DuWziR8CXhWB71aPQd9Q ($11.20 in chips) 
Seat 8: 5n7e7I+px7c6CQmLpPbtsg ($6.75 in chips) 
Seat 9: H5Se03ZqSX7tbULXur2MAg ($32.65 in chips) 
5n7e7I+px7c6CQmLpPbtsg: posts small blind $0.10
H5Se03ZqSX7tbULXur2MAg: posts big blind $0.25
*** HOLE CARDS ***
6RiVTYll/5D8zICp0MRpKw: folds 
M2QO2DxB5Wawg2h8HSpnYA: folds 
E0iYnEVO2ho7dH3QcCjw7g: folds 
MtVtHDqIJTyUcXkRBBDIVA: folds 
dmYlc+1cjwZMJ7wV+Z0rRg: folds 
arxNSjreDRGFg13EAM2F1w: folds 
1/DuWziR8CXhWB71aPQd9Q: calls $0.25
5n7e7I+px7c6CQmLpPbtsg: folds 
H5Se03ZqSX7tbULXur2MAg: checks 
*** FLOP *** [Ad 6h Qs]
H5Se03ZqSX7tbULXur2MAg: checks 
1/DuWziR8CXhWB71aPQd9Q: checks 
*** TURN *** [Ad 6h Qs] [9h]
H5Se03ZqSX7tbULXur2MAg: checks 
1/DuWziR8CXhWB71aPQd9Q: checks 
*** RIVER *** [Ad 6h Qs 9h] [9c]
H5Se03ZqSX7tbULXur2MAg: bets $0.50
1/DuWziR8CXhWB71aPQd9Q: folds 
Uncalled bet ($0.50) returned to H5Se03ZqSX7tbULXur2MAg
H5Se03ZqSX7tbULXur2MAg collected $0.60 from pot
*** SUMMARY ***
Total pot $0.60 | Rake $0 
Board [Ad 6h Qs 9h 9c]
Seat 1: 6RiVTYll/5D8zICp0MRpKw folded before Flop (didn't bet)
Seat 2: M2QO2DxB5Wawg2h8HSpnYA folded before Flop (didn't bet)
Seat 3: E0iYnEVO2ho7dH3QcCjw7g folded before Flop (didn't bet)
Seat 4: MtVtHDqIJTyUcXkRBBDIVA folded before Flop (didn't bet)
Seat 5: dmYlc+1cjwZMJ7wV+Z0rRg folded before Flop (didn't bet)
Seat 6: arxNSjreDRGFg13EAM2F1w folded before Flop (didn't bet)
Seat 7: 1/DuWziR8CXhWB71aPQd9Q (button) folded on the River
Seat 8: 5n7e7I+px7c6CQmLpPbtsg (small blind) folded before Flop
Seat 9: H5Se03ZqSX7tbULXur2MAg (big blind) collected ($0.60)




PokerStars Game #59941945726:  Hold'em No Limit ($0.10/$0.25) - 2009/07/01 1:51:11 ET
Table '52Meibn9NOL4XtVi1p2Upw' 9-max Seat #9 is the button
Seat 1: W6tExOcYX7qiy6Qdp+ZwFA ($6.30 in chips) 
Seat 2: CGjLyv/AvljZy2g76nYkzQ ($25 in chips) 
Seat 3: Bb42QRQMhg5/Y0vHP8/2Xw ($26 in chips) 
Seat 4: oLa/tXLfSLLB28mcLGrxcg ($31.65 in chips) 
Seat 6: N5sUK8M0br9djLrW97V9pQ ($28.50 in chips) 
Seat 7: Qduu7ikeizo6q6Ei9YvcJA ($32.75 in chips) 
Seat 8: w7VrLGwaVQzOQXfRqJitMQ ($21.50 in chips) 
Seat 9: RCqMONFrSPSArZh2Jsar/w ($15.95 in chips) 
W6tExOcYX7qiy6Qdp+ZwFA: posts small blind $0.10
CGjLyv/AvljZy2g76nYkzQ: posts big blind $0.25
*** HOLE CARDS ***
Bb42QRQMhg5/Y0vHP8/2Xw: folds 
MXCztnYJ58KLHMztZvKrxA has returned
MXCztnYJ58KLHMztZvKrxA said, "nh"
MXCztnYJ58KLHMztZvKrxA said, "sick"
oLa/tXLfSLLB28mcLGrxcg: folds 
N5sUK8M0br9djLrW97V9pQ: folds 
Qduu7ikeizo6q6Ei9YvcJA: folds 
w7VrLGwaVQzOQXfRqJitMQ: folds 
RCqMONFrSPSArZh2Jsar/w: folds 
W6tExOcYX7qiy6Qdp+ZwFA: raises $0.50 to $0.75
CGjLyv/AvljZy2g76nYkzQ: folds 
Uncalled bet ($0.50) returned to W6tExOcYX7qiy6Qdp+ZwFA
W6tExOcYX7qiy6Qdp+ZwFA collected $0.50 from pot
W6tExOcYX7qiy6Qdp+ZwFA: doesn't show hand 
*** SUMMARY ***
Total pot $0.50 | Rake $0 
Seat 1: W6tExOcYX7qiy6Qdp+ZwFA (small blind) collected ($0.50)
Seat 2: CGjLyv/AvljZy2g76nYkzQ (big blind) folded before Flop
Seat 3: Bb42QRQMhg5/Y0vHP8/2Xw folded before Flop (didn't bet)
Seat 4: oLa/tXLfSLLB28mcLGrxcg folded before Flop (didn't bet)
Seat 6: N5sUK8M0br9djLrW97V9pQ folded before Flop (didn't bet)
Seat 7: Qduu7ikeizo6q6Ei9YvcJA folded before Flop (didn't bet)
Seat 8: w7VrLGwaVQzOQXfRqJitMQ folded before Flop (didn't bet)
Seat 9: RCqMONFrSPSArZh2Jsar/w (button) folded before Flop (didn't bet)




PokerStars Game #59941946032:  Hold'em No Limit ($0.10/$0.25) - 2009/07/01 1:51:11 ET
Table 'KU/HrxqxwDz8HKEhYTZ6uw' 6-max Seat #1 is the button
Seat 1: 7LKoiQHXpTQXJvWQrw907g ($38.55 in chips) 
Seat 2: kG34n23qFQA3nzdOJTQ1dA ($24.05 in chips) 
Seat 3: SFmT9ZsVopnukjvAzrxTRg ($26.10 in chips) 
Seat 5: iyZxqznXjv3vtvOJymkoLQ ($52.35 in chips) 
Seat 6: qWxkCeqApAWdAA0evrfDvQ ($8.50 in chips) 
kG34n23qFQA3nzdOJTQ1dA: posts small blind $0.10
SFmT9ZsVopnukjvAzrxTRg: posts big blind $0.25
*** HOLE CARDS ***
iyZxqznXjv3vtvOJymkoLQ: folds 
qWxkCeqApAWdAA0evrfDvQ: folds 
7LKoiQHXpTQXJvWQrw907g: folds 
kG34n23qFQA3nzdOJTQ1dA: folds 
Uncalled bet ($0.15) returned to SFmT9ZsVopnukjvAzrxTRg
SFmT9ZsVopnukjvAzrxTRg collected $0.20 from pot
SFmT9ZsVopnukjvAzrxTRg: doesn't show hand 
*** SUMMARY ***
Total pot $0.20 | Rake $0 
Seat 1: 7LKoiQHXpTQXJvWQrw907g (button) folded before Flop (didn't bet)
Seat 2: kG34n23qFQA3nzdOJTQ1dA (small blind) folded before Flop
Seat 3: SFmT9ZsVopnukjvAzrxTRg (big blind) collected ($0.20)
Seat 5: iyZxqznXjv3vtvOJymkoLQ folded before Flop (didn't bet)
Seat 6: qWxkCeqApAWdAA0evrfDvQ folded before Flop (didn't bet)




PokerStars Game #59941946136:  Hold'em No Limit ($0.10/$0.25) - 2009/07/01 1:51:11 ET
Table 'T/iCKJXGphRN3xcdwfE/JQ' 6-max Seat #4 is the button
Seat 1: wAKC8C/zN0c8V5v13dm9mA ($26.15 in chips) 
Seat 2: EeUZtMU058v2ObUACOF4Og ($32.90 in chips) 
Seat 3: IWAjoCPXtc1XUaZdp+pCpA ($22.10 in chips) 
Seat 4: m2yWOKfAxqHoy5DDN87Ttw ($24.65 in chips) 
Seat 5: y85armT09GoP0OGsamp0jA ($18.30 in chips) 
Seat 6: Ey4Kn6PlnYb2srYYBJHvzg ($16.65 in chips) 
y85armT09GoP0OGsamp0jA: posts small blind $0.10
Ey4Kn6PlnYb2srYYBJHvzg: posts big blind $0.25
*** HOLE CARDS ***
wAKC8C/zN0c8V5v13dm9mA: folds 
EeUZtMU058v2ObUACOF4Og: calls $0.25
IWAjoCPXtc1XUaZdp+pCpA: folds 
m2yWOKfAxqHoy5DDN87Ttw: folds 
y85armT09GoP0OGsamp0jA: calls $0.15
Ey4Kn6PlnYb2srYYBJHvzg: checks 
*** FLOP *** [2s Jc 2c]
y85armT09GoP0OGsamp0jA: checks 
Ey4Kn6PlnYb2srYYBJHvzg: checks 
EeUZtMU058v2ObUACOF4Og: bets $0.25
y85armT09GoP0OGsamp0jA: folds 
Ey4Kn6PlnYb2srYYBJHvzg: folds 
Uncalled bet ($0.25) returned to EeUZtMU058v2ObUACOF4Og
EeUZtMU058v2ObUACOF4Og collected $0.75 from pot
EeUZtMU058v2ObUACOF4Og: doesn't show hand 
*** SUMMARY ***
Total pot $0.75 | Rake $0 
Board [2s Jc 2c]
Seat 1: wAKC8C/zN0c8V5v13dm9mA folded before Flop (didn't bet)
Seat 2: EeUZtMU058v2ObUACOF4Og collected ($0.75)
Seat 3: IWAjoCPXtc1XUaZdp+pCpA folded before Flop (didn't bet)
Seat 4: m2yWOKfAxqHoy5DDN87Ttw (button) folded before Flop (didn't bet)
Seat 5: y85armT09GoP0OGsamp0jA (small blind) folded on the Flop
Seat 6: Ey4Kn6PlnYb2srYYBJHvzg (big blind) folded on the Flop




PokerStars Game #59941945788:  Hold'em No Limit ($0.10/$0.25) - 2009/07/01 1:51:11 ET
Table '2clPgY3+dETPD/8zjXZdFw' 6-max Seat #5 is the button
Seat 1: 7cx44/slbeTw+Cy7QB8Trg ($25.80 in chips) 
Seat 2: cWc85bEzdRzpUMhRKm8pwQ ($25 in chips) 
Seat 3: FL1UWpN6oReBdznWDOy9Gg ($16.10 in chips) 
Seat 4: ljjhtb6FVPTx9AT9HNdtqg ($23.10 in chips) 
Seat 5: LJI7A1YgDM7hgh7o56+ReQ ($30.45 in chips) 
Seat 6: c3J/KYZ4cNsUEuz8v57I5A ($24.75 in chips) 
c3J/KYZ4cNsUEuz8v57I5A: posts small blind $0.10
7cx44/slbeTw+Cy7QB8Trg: posts big blind $0.25
*** HOLE CARDS ***
cWc85bEzdRzpUMhRKm8pwQ: folds 
FL1UWpN6oReBdznWDOy9Gg: folds 
ljjhtb6FVPTx9AT9HNdtqg: folds 
LJI7A1YgDM7hgh7o56+ReQ: folds 
c3J/KYZ4cNsUEuz8v57I5A: raises $0.50 to $0.75
7cx44/slbeTw+Cy7QB8Trg: calls $0.50
*** FLOP *** [9d 8c 3d]
c3J/KYZ4cNsUEuz8v57I5A: bets $0.75
7cx44/slbeTw+Cy7QB8Trg: raises $1.50 to $2.25
c3J/KYZ4cNsUEuz8v57I5A: folds 
Uncalled bet ($1.50) returned to 7cx44/slbeTw+Cy7QB8Trg
7cx44/slbeTw+Cy7QB8Trg collected $2.90 from pot
7cx44/slbeTw+Cy7QB8Trg: doesn't show hand 
*** SUMMARY ***
Total pot $3 | Rake $0.10 
Board [9d 8c 3d]
Seat 1: 7cx44/slbeTw+Cy7QB8Trg (big blind) collected ($2.90)
Seat 2: cWc85bEzdRzpUMhRKm8pwQ folded before Flop (didn't bet)
Seat 3: FL1UWpN6oReBdznWDOy9Gg folded before Flop (didn't bet)
Seat 4: ljjhtb6FVPTx9AT9HNdtqg folded before Flop (didn't bet)
Seat 5: LJI7A1YgDM7hgh7o56+ReQ (button) folded before Flop (didn't bet)
Seat 6: c3J/KYZ4cNsUEuz8v57I5A (small blind) folded on the Flop




PokerStars Game #59941946170:  Hold'em No Limit ($0.10/$0.25) - 2009/07/01 1:51:12 ET
Table '/JJyyIstHfkT7t/bW+WXgg' 6-max Seat #2 is the button
Seat 1: xC0kaiDYM6YTlgODL83O5A ($14.50 in chips) 
Seat 2: obJgSnVgWWWaAUtVILo77Q ($28.20 in chips) 
Seat 3: DR0nVIhVP77oEBlO9J8vlg ($25.85 in chips) 
Seat 4: JFIAqU8lCZ0vWwEl4bdGsg ($36.40 in chips) 
Seat 5: +ZlnqPoP3Hg4BIUxDfKd/A ($45.70 in chips) 
Seat 6: UmcUp27+PbgBItv3ZNlAWQ ($25.15 in chips) 
DR0nVIhVP77oEBlO9J8vlg: posts small blind $0.10
JFIAqU8lCZ0vWwEl4bdGsg: posts big blind $0.25
*** HOLE CARDS ***
+ZlnqPoP3Hg4BIUxDfKd/A: folds 
UmcUp27+PbgBItv3ZNlAWQ: raises $0.50 to $0.75
xC0kaiDYM6YTlgODL83O5A: folds 
obJgSnVgWWWaAUtVILo77Q: calls $0.75
DR0nVIhVP77oEBlO9J8vlg: folds 
JFIAqU8lCZ0vWwEl4bdGsg: folds 
*** FLOP *** [3h Td 3d]
UmcUp27+PbgBItv3ZNlAWQ: bets $0.25
obJgSnVgWWWaAUtVILo77Q: raises $0.75 to $1
UmcUp27+PbgBItv3ZNlAWQ: folds 
Uncalled bet ($0.75) returned to obJgSnVgWWWaAUtVILo77Q
obJgSnVgWWWaAUtVILo77Q collected $2.25 from pot
obJgSnVgWWWaAUtVILo77Q: doesn't show hand 
*** SUMMARY ***
Total pot $2.35 | Rake $0.10 
Board [3h Td 3d]
Seat 1: xC0kaiDYM6YTlgODL83O5A folded before Flop (didn't bet)
Seat 2: obJgSnVgWWWaAUtVILo77Q (button) collected ($2.25)
Seat 3: DR0nVIhVP77oEBlO9J8vlg (small blind) folded before Flop
Seat 4: JFIAqU8lCZ0vWwEl4bdGsg (big blind) folded before Flop
Seat 5: +ZlnqPoP3Hg4BIUxDfKd/A folded before Flop (didn't bet)
Seat 6: UmcUp27+PbgBItv3ZNlAWQ folded on the Flop




PokerStars Game #59941946478:  Hold'em No Limit ($0.10/$0.25) - 2009/07/01 1:51:12 ET
Table 'ThBZ355rqvsb8UGb6ajbig' 9-max Seat #9 is the button
Seat 1: Z9W7+g1WMhhZDi7DwGbCFA ($10.55 in chips) 
Seat 2: 4awUyiDYTgylQKXZ9faBVA ($25.95 in chips) 
Seat 3: H5Se03ZqSX7tbULXur2MAg ($27.80 in chips) 
Seat 4: zgi+EUykT/pZQpoUG6+oEg ($5.40 in chips) 
Seat 5: cKlmpQMahVsmOaxFQDcoOg ($24.60 in chips) 
Seat 6: qwr38jl5txoR36M7G5qi4A ($11 in chips) 
Seat 8: pplNliE3WonjkPRf+GZq2A ($25.10 in chips) 
Seat 9: sD+TKtt36XiiN6jqHiLwDA ($24.65 in chips) 
Z9W7+g1WMhhZDi7DwGbCFA: posts small blind $0.10
4awUyiDYTgylQKXZ9faBVA: posts big blind $0.25
*** HOLE CARDS ***
H5Se03ZqSX7tbULXur2MAg: folds 
zgi+EUykT/pZQpoUG6+oEg: folds 
cKlmpQMahVsmOaxFQDcoOg: folds 
qwr38jl5txoR36M7G5qi4A: folds 
pplNliE3WonjkPRf+GZq2A: folds 
sD+TKtt36XiiN6jqHiLwDA: folds 
Z9W7+g1WMhhZDi7DwGbCFA: folds 
Uncalled bet ($0.15) returned to 4awUyiDYTgylQKXZ9faBVA
4awUyiDYTgylQKXZ9faBVA collected $0.20 from pot
4awUyiDYTgylQKXZ9faBVA: doesn't show hand 
*** SUMMARY ***
Total pot $0.20 | Rake $0 
Seat 1: Z9W7+g1WMhhZDi7DwGbCFA (small blind) folded before Flop
Seat 2: 4awUyiDYTgylQKXZ9faBVA (big blind) collected ($0.20)
Seat 3: H5Se03ZqSX7tbULXur2MAg folded before Flop (didn't bet)
Seat 4: zgi+EUykT/pZQpoUG6+oEg folded before Flop (didn't bet)
Seat 5: cKlmpQMahVsmOaxFQDcoOg folded before Flop (didn't bet)
Seat 6: qwr38jl5txoR36M7G5qi4A folded before Flop (didn't bet)
Seat 8: pplNliE3WonjkPRf+GZq2A folded before Flop (didn't bet)
Seat 9: sD+TKtt36XiiN6jqHiLwDA (button) folded before Flop (didn't bet)




PokerStars Game #59941946546:  Hold'em No Limit ($0.10/$0.25) - 2009/07/01 1:51:12 ET
Table 'IdXp6nyeW4FYaEK4qKCnwQ' 9-max Seat #6 is the button
Seat 1: tLcDklc2rBORNfixyRfVfw ($25 in chips) 
Seat 2: HPEB+AtKw1+C/cxU0o1ciw ($30.50 in chips) 
Seat 4: j4q3p0lesp63b1gZDwLBZw ($5 in chips) 
Seat 5: nAWaA+gDUSWOad+I9mKUEg ($8.05 in chips) 
Seat 6: arxNSjreDRGFg13EAM2F1w ($30.85 in chips) 
Seat 7: w1ukf8uPa4+WH561TtVRxA ($37 in chips) 
Seat 8: dtZ84flFEi4Q+SGrHMJRDQ ($29.75 in chips) 
Seat 9: s2xLPOl/vhl/26apJ3vsOQ ($29.60 in chips) 
w1ukf8uPa4+WH561TtVRxA: posts small blind $0.10
dtZ84flFEi4Q+SGrHMJRDQ: posts big blind $0.25
JqeaikMej6KsqTKmUhl2Lw: sits out 
nAWaA+gDUSWOad+I9mKUEg: posts big blind $0.25
*** HOLE CARDS ***
s2xLPOl/vhl/26apJ3vsOQ: folds 
tLcDklc2rBORNfixyRfVfw: folds 
HPEB+AtKw1+C/cxU0o1ciw: folds 
j4q3p0lesp63b1gZDwLBZw: folds 
nAWaA+gDUSWOad+I9mKUEg: raises $0.50 to $0.75
arxNSjreDRGFg13EAM2F1w: folds 
w1ukf8uPa4+WH561TtVRxA: folds 
dtZ84flFEi4Q+SGrHMJRDQ: folds 
Uncalled bet ($0.50) returned to nAWaA+gDUSWOad+I9mKUEg
nAWaA+gDUSWOad+I9mKUEg collected $0.60 from pot
nAWaA+gDUSWOad+I9mKUEg: doesn't show hand 
*** SUMMARY ***
Total pot $0.60 | Rake $0 
Seat 1: tLcDklc2rBORNfixyRfVfw folded before Flop (didn't bet)
Seat 2: HPEB+AtKw1+C/cxU0o1ciw folded before Flop (didn't bet)
Seat 4: j4q3p0lesp63b1gZDwLBZw folded before Flop (didn't bet)
Seat 5: nAWaA+gDUSWOad+I9mKUEg collected ($0.60)
Seat 6: arxNSjreDRGFg13EAM2F1w (button) folded before Flop (didn't bet)
Seat 7: w1ukf8uPa4+WH561TtVRxA (small blind) folded before Flop
Seat 8: dtZ84flFEi4Q+SGrHMJRDQ (big blind) folded before Flop
Seat 9: s2xLPOl/vhl/26apJ3vsOQ folded before Flop (didn't bet)




PokerStars Game #59941946164:  Hold'em No Limit ($0.10/$0.25) - 2009/07/01 1:51:12 ET
Table 'WEMI3Mtn7dGARDbgNrKibg' 9-max Seat #1 is the button
Seat 1: Th3FldXKQW6hWVVPahaoOQ ($30.35 in chips) 
Seat 3: qwr38jl5txoR36M7G5qi4A ($10.10 in chips) 
Seat 4: Z5NNIVvnhb2IJbLcI79WYQ ($10.55 in chips) 
Seat 5: yzPZQFeaQTNf1YK3a0zRIw ($9.30 in chips) 
Seat 6: arxNSjreDRGFg13EAM2F1w ($25.10 in chips) 
Seat 7: DnDcAdn9P0zGovMERigpFA ($54.90 in chips) 
Seat 8: ghNKXUBl/H+t83JF079ZBA ($29.25 in chips) 
Seat 9: 2wcFsZsqEP5w1StUTVzJCg ($4.25 in chips) 
qwr38jl5txoR36M7G5qi4A: posts small blind $0.10
Z5NNIVvnhb2IJbLcI79WYQ: posts big blind $0.25
*** HOLE CARDS ***
yzPZQFeaQTNf1YK3a0zRIw: folds 
arxNSjreDRGFg13EAM2F1w: calls $0.25
DnDcAdn9P0zGovMERigpFA: folds 
ghNKXUBl/H+t83JF079ZBA: folds 
2wcFsZsqEP5w1StUTVzJCg: folds 
Th3FldXKQW6hWVVPahaoOQ: folds 
qwr38jl5txoR36M7G5qi4A: folds 
Z5NNIVvnhb2IJbLcI79WYQ: checks 
*** FLOP *** [3d Kh 3s]
Z5NNIVvnhb2IJbLcI79WYQ: checks 
arxNSjreDRGFg13EAM2F1w: checks 
*** TURN *** [3d Kh 3s] [9d]
Z5NNIVvnhb2IJbLcI79WYQ: bets $0.25
arxNSjreDRGFg13EAM2F1w: folds 
Uncalled bet ($0.25) returned to Z5NNIVvnhb2IJbLcI79WYQ
Z5NNIVvnhb2IJbLcI79WYQ collected $0.60 from pot
*** SUMMARY ***
Total pot $0.60 | Rake $0 
Board [3d Kh 3s 9d]
Seat 1: Th3FldXKQW6hWVVPahaoOQ (button) folded before Flop (didn't bet)
Seat 3: qwr38jl5txoR36M7G5qi4A (small blind) folded before Flop
Seat 4: Z5NNIVvnhb2IJbLcI79WYQ (big blind) collected ($0.60)
Seat 5: yzPZQFeaQTNf1YK3a0zRIw folded before Flop (didn't bet)
Seat 6: arxNSjreDRGFg13EAM2F1w folded on the Turn
Seat 7: DnDcAdn9P0zGovMERigpFA folded before Flop (didn't bet)
Seat 8: ghNKXUBl/H+t83JF079ZBA folded before Flop (didn't bet)
Seat 9: 2wcFsZsqEP5w1StUTVzJCg folded before Flop (didn't bet)




PokerStars Game #59941946578:  Hold'em No Limit ($0.10/$0.25) - 2009/07/01 1:51:12 ET
Table 'BabJGL6tfXQp3leBGbYe8A' 9-max Seat #1 is the button
Seat 1: qwr38jl5txoR36M7G5qi4A ($10.35 in chips) 
Seat 2: dtZ84flFEi4Q+SGrHMJRDQ ($40.25 in chips) 
Seat 3: sD+TKtt36XiiN6jqHiLwDA ($28.80 in chips) 
Seat 4: gehe91e0IyVT0QU/XBkEyg ($27.85 in chips) 
Seat 5: GrNTWMdwy+jC6Lred1eDng ($10.35 in chips) 
Seat 6: egvg3mTBBVzMHnJPIQiKcA ($13.90 in chips) 
Seat 7: eK8qa6EPcH2zhtbmWSvc9g ($28.20 in chips) 
Seat 8: OXPkK84/qv92EMwXPiG5rQ ($9.25 in chips) 
Seat 9: P+9ymZQ3ktpQu1bn7HIjew ($9.15 in chips) 
dtZ84flFEi4Q+SGrHMJRDQ: posts small blind $0.10
sD+TKtt36XiiN6jqHiLwDA: posts big blind $0.25
*** HOLE CARDS ***
gehe91e0IyVT0QU/XBkEyg: folds 
GrNTWMdwy+jC6Lred1eDng: folds 
egvg3mTBBVzMHnJPIQiKcA: calls $0.25
eK8qa6EPcH2zhtbmWSvc9g: folds 
OXPkK84/qv92EMwXPiG5rQ: calls $0.25
P+9ymZQ3ktpQu1bn7HIjew: folds 
qwr38jl5txoR36M7G5qi4A: folds 
dtZ84flFEi4Q+SGrHMJRDQ: folds 
sD+TKtt36XiiN6jqHiLwDA: checks 
*** FLOP *** [9d 2c 8s]
sD+TKtt36XiiN6jqHiLwDA: checks 
egvg3mTBBVzMHnJPIQiKcA: checks 
OXPkK84/qv92EMwXPiG5rQ: checks 
*** TURN *** [9d 2c 8s] [9c]
sD+TKtt36XiiN6jqHiLwDA: checks 
egvg3mTBBVzMHnJPIQiKcA: checks 
OXPkK84/qv92EMwXPiG5rQ: checks 
*** RIVER *** [9d 2c 8s 9c] [6h]
sD+TKtt36XiiN6jqHiLwDA: checks 
egvg3mTBBVzMHnJPIQiKcA: bets $1
OXPkK84/qv92EMwXPiG5rQ: folds 
sD+TKtt36XiiN6jqHiLwDA: calls $1
*** SHOW DOWN ***
egvg3mTBBVzMHnJPIQiKcA: shows [2s 2h] (a full house, Deuces full of Nines)
sD+TKtt36XiiN6jqHiLwDA: mucks hand 
egvg3mTBBVzMHnJPIQiKcA collected $2.75 from pot
*** SUMMARY ***
Total pot $2.85 | Rake $0.10 
Board [9d 2c 8s 9c 6h]
Seat 1: qwr38jl5txoR36M7G5qi4A (button) folded before Flop (didn't bet)
Seat 2: dtZ84flFEi4Q+SGrHMJRDQ (small blind) folded before Flop
Seat 3: sD+TKtt36XiiN6jqHiLwDA (big blind) mucked
Seat 4: gehe91e0IyVT0QU/XBkEyg folded before Flop (didn't bet)
Seat 5: GrNTWMdwy+jC6Lred1eDng folded before Flop (didn't bet)
Seat 6: egvg3mTBBVzMHnJPIQiKcA showed [2s 2h] and won ($2.75) with a full house, Deuces full of Nines
Seat 7: eK8qa6EPcH2zhtbmWSvc9g folded before Flop (didn't bet)
Seat 8: OXPkK84/qv92EMwXPiG5rQ folded on the River
Seat 9: P+9ymZQ3ktpQu1bn7HIjew folded before Flop (didn't bet)




PokerStars Game #59941946372:  Hold'em No Limit ($0.10/$0.25) - 2009/07/01 1:51:12 ET
Table 'nFlmVztKq1HJEWfxmdl15w' 9-max Seat #8 is the button
Seat 1: cZ99hugmLBj9KhTlc8nCSw ($25 in chips) 
Seat 2: Th3FldXKQW6hWVVPahaoOQ ($38.40 in chips) 
Seat 3: DdPXdieucQ+n99u1n3A+rQ ($5.70 in chips) 
Seat 4: +5dSUwD+/k2ktlnutSMivw ($10.50 in chips) 
Seat 5: Tx6zQdk5Ozt9ObEBlU7jeg ($45.05 in chips) 
Seat 6: 4awUyiDYTgylQKXZ9faBVA ($36.15 in chips) 
Seat 7: dfNim92Z6XK1/h5SFW5vDg ($34.95 in chips) 
Seat 8: +2kMBNpY4nF1qNCRd8SJLA ($33.15 in chips) 
Seat 9: DnDcAdn9P0zGovMERigpFA ($25.50 in chips) 
DnDcAdn9P0zGovMERigpFA: posts small blind $0.10
cZ99hugmLBj9KhTlc8nCSw: posts big blind $0.25
*** HOLE CARDS ***
Th3FldXKQW6hWVVPahaoOQ: calls $0.25
DdPXdieucQ+n99u1n3A+rQ: folds 
+5dSUwD+/k2ktlnutSMivw: calls $0.25
Tx6zQdk5Ozt9ObEBlU7jeg: folds 
4awUyiDYTgylQKXZ9faBVA: folds 
dfNim92Z6XK1/h5SFW5vDg: folds 
+2kMBNpY4nF1qNCRd8SJLA: folds 
DnDcAdn9P0zGovMERigpFA: folds 
cZ99hugmLBj9KhTlc8nCSw: checks 
*** FLOP *** [6s 4h Ah]
cZ99hugmLBj9KhTlc8nCSw: checks 
Th3FldXKQW6hWVVPahaoOQ: checks 
+5dSUwD+/k2ktlnutSMivw: checks 
*** TURN *** [6s 4h Ah] [Qh]
cZ99hugmLBj9KhTlc8nCSw: checks 
Th3FldXKQW6hWVVPahaoOQ: checks 
+5dSUwD+/k2ktlnutSMivw: checks 
*** RIVER *** [6s 4h Ah Qh] [2s]
cZ99hugmLBj9KhTlc8nCSw: checks 
Th3FldXKQW6hWVVPahaoOQ: checks 
+5dSUwD+/k2ktlnutSMivw: folds 
*** SHOW DOWN ***
cZ99hugmLBj9KhTlc8nCSw: shows [7c Ts] (high card Ace)
Th3FldXKQW6hWVVPahaoOQ: shows [3h 3c] (a pair of Threes)
Th3FldXKQW6hWVVPahaoOQ collected $0.85 from pot
*** SUMMARY ***
Total pot $0.85 | Rake $0 
Board [6s 4h Ah Qh 2s]
Seat 1: cZ99hugmLBj9KhTlc8nCSw (big blind) showed [7c Ts] and lost with high card Ace
Seat 2: Th3FldXKQW6hWVVPahaoOQ showed [3h 3c] and won ($0.85) with a pair of Threes
Seat 3: DdPXdieucQ+n99u1n3A+rQ folded before Flop (didn't bet)
Seat 4: +5dSUwD+/k2ktlnutSMivw folded on the River
Seat 5: Tx6zQdk5Ozt9ObEBlU7jeg folded before Flop (didn't bet)
Seat 6: 4awUyiDYTgylQKXZ9faBVA folded before Flop (didn't bet)
Seat 7: dfNim92Z6XK1/h5SFW5vDg folded before Flop (didn't bet)
Seat 8: +2kMBNpY4nF1qNCRd8SJLA (button) folded before Flop (didn't bet)
Seat 9: DnDcAdn9P0zGovMERigpFA (small blind) folded before Flop




PokerStars Game #59941947174:  Hold'em No Limit ($0.10/$0.25) - 2009/07/01 1:51:13 ET
Table '9lYs7ljXi6AgFAxYHlKLJw' 9-max Seat #3 is the button
Seat 1: K0b5wNInj6hUGRr6yzKFtw ($36.65 in chips) 
Seat 2: 0XACOSNrAWmqNv9k1nF8rw ($15.35 in chips) 
Seat 3: arxNSjreDRGFg13EAM2F1w ($37.10 in chips) 
Seat 4: UANt6y/SmDCY/jIxkBixcw ($32.75 in chips) 
Seat 5: dfNim92Z6XK1/h5SFW5vDg ($59.20 in chips) 
Seat 6: tYsOBqdU1+x+yFI7zHO7hQ ($25 in chips) 
Seat 7: ghNKXUBl/H+t83JF079ZBA ($28.75 in chips) 
Seat 8: 9YN2IkT2JYYKFErZtZvCtA ($18.60 in chips) 
Seat 9: cKlmpQMahVsmOaxFQDcoOg ($7.40 in chips) 
UANt6y/SmDCY/jIxkBixcw: posts small blind $0.10
dfNim92Z6XK1/h5SFW5vDg: posts big blind $0.25
*** HOLE CARDS ***
tYsOBqdU1+x+yFI7zHO7hQ: folds 
ghNKXUBl/H+t83JF079ZBA: folds 
9YN2IkT2JYYKFErZtZvCtA: folds 
cKlmpQMahVsmOaxFQDcoOg: folds 
cKlmpQMahVsmOaxFQDcoOg leaves the table
K0b5wNInj6hUGRr6yzKFtw: folds 
0XACOSNrAWmqNv9k1nF8rw: folds 
IVL33RWimYC8hA5O8TO69Q joins the table at seat #9 
arxNSjreDRGFg13EAM2F1w: raises $0.50 to $0.75
UANt6y/SmDCY/jIxkBixcw: folds 
dfNim92Z6XK1/h5SFW5vDg: folds 
Uncalled bet ($0.50) returned to arxNSjreDRGFg13EAM2F1w
arxNSjreDRGFg13EAM2F1w collected $0.60 from pot
arxNSjreDRGFg13EAM2F1w: doesn't show hand 
*** SUMMARY ***
Total pot $0.60 | Rake $0 
Seat 1: K0b5wNInj6hUGRr6yzKFtw folded before Flop (didn't bet)
Seat 2: 0XACOSNrAWmqNv9k1nF8rw folded before Flop (didn't bet)
Seat 3: arxNSjreDRGFg13EAM2F1w (button) collected ($0.60)
Seat 4: UANt6y/SmDCY/jIxkBixcw (small blind) folded before Flop
Seat 5: dfNim92Z6XK1/h5SFW5vDg (big blind) folded before Flop
Seat 6: tYsOBqdU1+x+yFI7zHO7hQ folded before Flop (didn't bet)
Seat 7: ghNKXUBl/H+t83JF079ZBA folded before Flop (didn't bet)
Seat 8: 9YN2IkT2JYYKFErZtZvCtA folded before Flop (didn't bet)
Seat 9: cKlmpQMahVsmOaxFQDcoOg folded before Flop (didn't bet)




PokerStars Game #59941946904:  Hold'em No Limit ($0.10/$0.25) - 2009/07/01 1:51:13 ET
Table 'K/f0NNaoGuhSz5DrzgVw7Q' 9-max Seat #6 is the button
Seat 1: sD+TKtt36XiiN6jqHiLwDA ($26.05 in chips) 
Seat 2: zgi+EUykT/pZQpoUG6+oEg ($4.65 in chips) 
Seat 4: 9bCz0uv2nUmznwuI0OjVGw ($11.30 in chips) 
Seat 5: DnDcAdn9P0zGovMERigpFA ($40.60 in chips) 
Seat 6: 3PVK0IdMlq2fElkVzzr4bg ($7.25 in chips) 
Seat 7: egvg3mTBBVzMHnJPIQiKcA ($14.15 in chips) 
Seat 8: RCqMONFrSPSArZh2Jsar/w ($25.70 in chips) 
Seat 9: tLcDklc2rBORNfixyRfVfw ($25 in chips) 
egvg3mTBBVzMHnJPIQiKcA: posts small blind $0.10
RCqMONFrSPSArZh2Jsar/w: posts big blind $0.25
z5GxcHlYz/GSz6W2uFiTtg: sits out 
*** HOLE CARDS ***
tLcDklc2rBORNfixyRfVfw: folds 
sD+TKtt36XiiN6jqHiLwDA: folds 
zgi+EUykT/pZQpoUG6+oEg: folds 
9bCz0uv2nUmznwuI0OjVGw: folds 
DnDcAdn9P0zGovMERigpFA: folds 
3PVK0IdMlq2fElkVzzr4bg: folds 
egvg3mTBBVzMHnJPIQiKcA: calls $0.15
RCqMONFrSPSArZh2Jsar/w: checks 
*** FLOP *** [8d 3h Ad]
egvg3mTBBVzMHnJPIQiKcA: checks 
RCqMONFrSPSArZh2Jsar/w: checks 
*** TURN *** [8d 3h Ad] [8c]
egvg3mTBBVzMHnJPIQiKcA: checks 
RCqMONFrSPSArZh2Jsar/w: checks 
*** RIVER *** [8d 3h Ad 8c] [7h]
egvg3mTBBVzMHnJPIQiKcA: bets $0.50
RCqMONFrSPSArZh2Jsar/w: folds 
Uncalled bet ($0.50) returned to egvg3mTBBVzMHnJPIQiKcA
egvg3mTBBVzMHnJPIQiKcA collected $0.50 from pot
egvg3mTBBVzMHnJPIQiKcA: doesn't show hand 
*** SUMMARY ***
Total pot $0.50 | Rake $0 
Board [8d 3h Ad 8c 7h]
Seat 1: sD+TKtt36XiiN6jqHiLwDA folded before Flop (didn't bet)
Seat 2: zgi+EUykT/pZQpoUG6+oEg folded before Flop (didn't bet)
Seat 4: 9bCz0uv2nUmznwuI0OjVGw folded before Flop (didn't bet)
Seat 5: DnDcAdn9P0zGovMERigpFA folded before Flop (didn't bet)
Seat 6: 3PVK0IdMlq2fElkVzzr4bg (button) folded before Flop (didn't bet)
Seat 7: egvg3mTBBVzMHnJPIQiKcA (small blind) collected ($0.50)
Seat 8: RCqMONFrSPSArZh2Jsar/w (big blind) folded on the River
Seat 9: tLcDklc2rBORNfixyRfVfw folded before Flop (didn't bet)




PokerStars Game #59941946794:  Hold'em No Limit ($0.10/$0.25) - 2009/07/01 1:51:13 ET
Table 'jdhJTJjFq2KTttwJcd+7nQ' 6-max Seat #6 is the button
Seat 1: LtASJ9OlkqGrrUKGQlpGAw ($26.25 in chips) 
Seat 2: Hsvkc0/G2VV78oVmWYXecw ($5 in chips) 
Seat 3: vqWjZmdQu/Hxw96/IJTWdQ ($30.30 in chips) 
Seat 4: vx7FwRcelVSsvNYAdp/z0A ($4.85 in chips) 
Seat 5: BV+K0Phf5VBHr7aZPKqbUQ ($33.05 in chips) 
Seat 6: yb6rnd48JuBccThV68VHAQ ($13.80 in chips) 
LtASJ9OlkqGrrUKGQlpGAw: posts small blind $0.10
Hsvkc0/G2VV78oVmWYXecw: posts big blind $0.25
*** HOLE CARDS ***
vqWjZmdQu/Hxw96/IJTWdQ: folds 
vx7FwRcelVSsvNYAdp/z0A: folds 
BV+K0Phf5VBHr7aZPKqbUQ: raises $0.50 to $0.75
yb6rnd48JuBccThV68VHAQ: calls $0.75
LtASJ9OlkqGrrUKGQlpGAw: folds 
Hsvkc0/G2VV78oVmWYXecw: folds 
*** FLOP *** [As 7h 2h]
Hsvkc0/G2VV78oVmWYXecw leaves the table
BV+K0Phf5VBHr7aZPKqbUQ: bets $1
yb6rnd48JuBccThV68VHAQ: raises $1 to $2
BV+K0Phf5VBHr7aZPKqbUQ: folds 
Uncalled bet ($1) returned to yb6rnd48JuBccThV68VHAQ
yb6rnd48JuBccThV68VHAQ collected $3.70 from pot
yb6rnd48JuBccThV68VHAQ: doesn't show hand 
*** SUMMARY ***
Total pot $3.85 | Rake $0.15 
Board [As 7h 2h]
Seat 1: LtASJ9OlkqGrrUKGQlpGAw (small blind) folded before Flop
Seat 2: Hsvkc0/G2VV78oVmWYXecw (big blind) folded before Flop
Seat 3: vqWjZmdQu/Hxw96/IJTWdQ folded before Flop (didn't bet)
Seat 4: vx7FwRcelVSsvNYAdp/z0A folded before Flop (didn't bet)
Seat 5: BV+K0Phf5VBHr7aZPKqbUQ folded on the Flop
Seat 6: yb6rnd48JuBccThV68VHAQ (button) collected ($3.70)




PokerStars Game #59941947010:  Hold'em No Limit ($0.10/$0.25) - 2009/07/01 1:51:13 ET
Table 'yAHDCs33TIgw3ra63xuU2Q' 9-max Seat #4 is the button
Seat 1: Z9AeOQX3yzuSvKAm/xyovg ($9.75 in chips) 
Seat 2: j4q3p0lesp63b1gZDwLBZw ($5 in chips) 
Seat 4: j5spkbnOCRiLGiH6iqBaqw ($11.05 in chips) 
Seat 5: 4awUyiDYTgylQKXZ9faBVA ($36.35 in chips) 
Seat 8: PCA4x6k6ozLkTt7qDUqp7w ($17.55 in chips) 
Seat 9: MtVtHDqIJTyUcXkRBBDIVA ($25 in chips) 
4awUyiDYTgylQKXZ9faBVA: posts small blind $0.10
DnDcAdn9P0zGovMERigpFA: is sitting out 
PCA4x6k6ozLkTt7qDUqp7w: posts big blind $0.25
*** HOLE CARDS ***
MtVtHDqIJTyUcXkRBBDIVA: folds 
DnDcAdn9P0zGovMERigpFA leaves the table
Z9AeOQX3yzuSvKAm/xyovg: raises $0.50 to $0.75
j4q3p0lesp63b1gZDwLBZw: folds 
j5spkbnOCRiLGiH6iqBaqw: calls $0.75
4awUyiDYTgylQKXZ9faBVA: folds 
PCA4x6k6ozLkTt7qDUqp7w: calls $0.50
*** FLOP *** [Kc Th 5s]
PCA4x6k6ozLkTt7qDUqp7w: checks 
Z9AeOQX3yzuSvKAm/xyovg: checks 
j5spkbnOCRiLGiH6iqBaqw: bets $0.75
PCA4x6k6ozLkTt7qDUqp7w: calls $0.75
Z9AeOQX3yzuSvKAm/xyovg: calls $0.75
*** TURN *** [Kc Th 5s] [Kh]
PCA4x6k6ozLkTt7qDUqp7w: checks 
Z9AeOQX3yzuSvKAm/xyovg: checks 
j5spkbnOCRiLGiH6iqBaqw: bets $0.75
PCA4x6k6ozLkTt7qDUqp7w: calls $0.75
Z9AeOQX3yzuSvKAm/xyovg: folds 
*** RIVER *** [Kc Th 5s Kh] [Ks]
PCA4x6k6ozLkTt7qDUqp7w: checks 
UXvybU2w7Zc8RP8R+ngNeg joins the table at seat #6 
j5spkbnOCRiLGiH6iqBaqw: bets $2
PCA4x6k6ozLkTt7qDUqp7w: calls $2
*** SHOW DOWN ***
j5spkbnOCRiLGiH6iqBaqw: shows [Kd Jh] (four of a kind, Kings)
PCA4x6k6ozLkTt7qDUqp7w: mucks hand 
j5spkbnOCRiLGiH6iqBaqw collected $9.65 from pot
*** SUMMARY ***
Total pot $10.10 | Rake $0.45 
Board [Kc Th 5s Kh Ks]
Seat 1: Z9AeOQX3yzuSvKAm/xyovg folded on the Turn
Seat 2: j4q3p0lesp63b1gZDwLBZw folded before Flop (didn't bet)
Seat 4: j5spkbnOCRiLGiH6iqBaqw (button) showed [Kd Jh] and won ($9.65) with four of a kind, Kings
Seat 5: 4awUyiDYTgylQKXZ9faBVA (small blind) folded before Flop
Seat 8: PCA4x6k6ozLkTt7qDUqp7w (big blind) mucked
Seat 9: MtVtHDqIJTyUcXkRBBDIVA folded before Flop (didn't bet)




PokerStars Game #59941947042:  Hold'em No Limit ($0.10/$0.25) - 2009/07/01 1:51:13 ET
Table 'sJ4KpS2GE5Qrsu1/cFjJUw' 9-max Seat #7 is the button
Seat 1: eDlQ+S+6L4e6gM1dkZhGgQ ($19.70 in chips) 
Seat 3: eK8qa6EPcH2zhtbmWSvc9g ($25 in chips) 
Seat 5: Q/gZC63lfOMr7YhWKPCxoQ ($8.15 in chips) 
Seat 6: OefE+Csvj5KR7ClGf3Hc2g ($3.75 in chips) 
Seat 7: Wi8djHgewBlVhpKWfp7isQ ($9.15 in chips) 
Seat 8: S7Ki0P+0AIGPuIfGJjW0gg ($30.45 in chips) 
Seat 9: 3PmVnC/15cl4oyI1TKIt4g ($4.40 in chips) 
S7Ki0P+0AIGPuIfGJjW0gg: posts small blind $0.10
3PmVnC/15cl4oyI1TKIt4g: posts big blind $0.25
ydoFOVgzvZv9ZhuWu9rXAw: sits out 
*** HOLE CARDS ***
eDlQ+S+6L4e6gM1dkZhGgQ: folds 
eK8qa6EPcH2zhtbmWSvc9g: folds 
Q/gZC63lfOMr7YhWKPCxoQ: calls $0.25
OefE+Csvj5KR7ClGf3Hc2g: folds 
Wi8djHgewBlVhpKWfp7isQ: folds 
S7Ki0P+0AIGPuIfGJjW0gg: folds 
3PmVnC/15cl4oyI1TKIt4g: checks 
*** FLOP *** [9s 3d 2s]
3PmVnC/15cl4oyI1TKIt4g: checks 
Q/gZC63lfOMr7YhWKPCxoQ: checks 
*** TURN *** [9s 3d 2s] [Jc]
3PmVnC/15cl4oyI1TKIt4g: checks 
Q/gZC63lfOMr7YhWKPCxoQ: bets $0.25
3PmVnC/15cl4oyI1TKIt4g: raises $0.50 to $0.75
Q/gZC63lfOMr7YhWKPCxoQ: folds 
Uncalled bet ($0.50) returned to 3PmVnC/15cl4oyI1TKIt4g
3PmVnC/15cl4oyI1TKIt4g collected $1.05 from pot
3PmVnC/15cl4oyI1TKIt4g: doesn't show hand 
*** SUMMARY ***
Total pot $1.10 | Rake $0.05 
Board [9s 3d 2s Jc]
Seat 1: eDlQ+S+6L4e6gM1dkZhGgQ folded before Flop (didn't bet)
Seat 3: eK8qa6EPcH2zhtbmWSvc9g folded before Flop (didn't bet)
Seat 5: Q/gZC63lfOMr7YhWKPCxoQ folded on the Turn
Seat 6: OefE+Csvj5KR7ClGf3Hc2g folded before Flop (didn't bet)
Seat 7: Wi8djHgewBlVhpKWfp7isQ (button) folded before Flop (didn't bet)
Seat 8: S7Ki0P+0AIGPuIfGJjW0gg (small blind) folded before Flop
Seat 9: 3PmVnC/15cl4oyI1TKIt4g (big blind) collected ($1.05)




PokerStars Game #59941947538:  Hold'em No Limit ($0.10/$0.25) - 2009/07/01 1:51:14 ET
Table 'srBTB98reCdD1TffxE6o7g' 6-max Seat #2 is the button
Seat 1: SFmT9ZsVopnukjvAzrxTRg ($36.55 in chips) 
Seat 2: mfrkWA3PTeYPkbO6hi98Aw ($24.65 in chips) 
Seat 3: VOmI0x4dDPnTESZd5B4d1Q ($42.15 in chips) 
Seat 4: 6DwBRH+xZ12AAZmeAg+aXw ($16.55 in chips) 
Seat 5: K1zv48sQUGQiaLk5VWWDqw ($25.90 in chips) 
Seat 6: BV+K0Phf5VBHr7aZPKqbUQ ($30.75 in chips) 
VOmI0x4dDPnTESZd5B4d1Q: posts small blind $0.10
6DwBRH+xZ12AAZmeAg+aXw: posts big blind $0.25
*** HOLE CARDS ***
K1zv48sQUGQiaLk5VWWDqw: raises $0.50 to $0.75
BV+K0Phf5VBHr7aZPKqbUQ: folds 
SFmT9ZsVopnukjvAzrxTRg: folds 
mfrkWA3PTeYPkbO6hi98Aw: folds 
VOmI0x4dDPnTESZd5B4d1Q: folds 
6DwBRH+xZ12AAZmeAg+aXw: folds 
Uncalled bet ($0.50) returned to K1zv48sQUGQiaLk5VWWDqw
K1zv48sQUGQiaLk5VWWDqw collected $0.60 from pot
K1zv48sQUGQiaLk5VWWDqw: doesn't show hand 
*** SUMMARY ***
Total pot $0.60 | Rake $0 
Seat 1: SFmT9ZsVopnukjvAzrxTRg folded before Flop (didn't bet)
Seat 2: mfrkWA3PTeYPkbO6hi98Aw (button) folded before Flop (didn't bet)
Seat 3: VOmI0x4dDPnTESZd5B4d1Q (small blind) folded before Flop
Seat 4: 6DwBRH+xZ12AAZmeAg+aXw (big blind) folded before Flop
Seat 5: K1zv48sQUGQiaLk5VWWDqw collected ($0.60)
Seat 6: BV+K0Phf5VBHr7aZPKqbUQ folded before Flop (didn't bet)




PokerStars Game #59941947286:  Hold'em No Limit ($0.10/$0.25) - 2009/07/01 1:51:14 ET
Table 'RPdw09/gGCIP4xFhDWJgXQ' 9-max Seat #3 is the button
Seat 1: aNpwfA31EREwO+ar4XzBCw ($27.50 in chips) 
Seat 2: Sd1tfhUq/M96GhXGv1hwFQ ($7.85 in chips) 
Seat 3: g5LAv1J/3Thw1zs/SEyfzw ($19.70 in chips) 
Seat 5: gehe91e0IyVT0QU/XBkEyg ($31.35 in chips) 
Seat 6: monZeAwXUmIA1l84cUd2hw ($13.75 in chips) 
Seat 7: EP17SQz/iWcuYdNOGeBgkw ($13.40 in chips) 
Seat 8: MG90wfSJZnOejs/KD3vlQQ ($29.80 in chips) 
Seat 9: O02ScVDnDZwH6KjZNJZMzA ($4.40 in chips) 
z5GxcHlYz/GSz6W2uFiTtg will be allowed to play after the button
gehe91e0IyVT0QU/XBkEyg: posts small blind $0.10
monZeAwXUmIA1l84cUd2hw: posts big blind $0.25
*** HOLE CARDS ***
EP17SQz/iWcuYdNOGeBgkw: folds 
MG90wfSJZnOejs/KD3vlQQ: folds 
O02ScVDnDZwH6KjZNJZMzA: calls $0.25
aNpwfA31EREwO+ar4XzBCw: folds 
Sd1tfhUq/M96GhXGv1hwFQ: folds 
g5LAv1J/3Thw1zs/SEyfzw: folds 
gehe91e0IyVT0QU/XBkEyg: folds 
monZeAwXUmIA1l84cUd2hw: checks 
*** FLOP *** [Tc Jc 4c]
monZeAwXUmIA1l84cUd2hw: checks 
O02ScVDnDZwH6KjZNJZMzA: checks 
*** TURN *** [Tc Jc 4c] [As]
monZeAwXUmIA1l84cUd2hw: checks 
O02ScVDnDZwH6KjZNJZMzA: bets $0.25
monZeAwXUmIA1l84cUd2hw: raises $0.25 to $0.50
O02ScVDnDZwH6KjZNJZMzA: calls $0.25
*** RIVER *** [Tc Jc 4c As] [7d]
monZeAwXUmIA1l84cUd2hw: checks 
O02ScVDnDZwH6KjZNJZMzA: checks 
*** SHOW DOWN ***
monZeAwXUmIA1l84cUd2hw: shows [3d 3s] (a pair of Threes)
O02ScVDnDZwH6KjZNJZMzA: shows [8d Ad] (a pair of Aces)
O02ScVDnDZwH6KjZNJZMzA collected $1.55 from pot
*** SUMMARY ***
Total pot $1.60 | Rake $0.05 
Board [Tc Jc 4c As 7d]
Seat 1: aNpwfA31EREwO+ar4XzBCw folded before Flop (didn't bet)
Seat 2: Sd1tfhUq/M96GhXGv1hwFQ folded before Flop (didn't bet)
Seat 3: g5LAv1J/3Thw1zs/SEyfzw (button) folded before Flop (didn't bet)
Seat 5: gehe91e0IyVT0QU/XBkEyg (small blind) folded before Flop
Seat 6: monZeAwXUmIA1l84cUd2hw (big blind) showed [3d 3s] and lost with a pair of Threes
Seat 7: EP17SQz/iWcuYdNOGeBgkw folded before Flop (didn't bet)
Seat 8: MG90wfSJZnOejs/KD3vlQQ folded before Flop (didn't bet)
Seat 9: O02ScVDnDZwH6KjZNJZMzA showed [8d Ad] and won ($1.55) with a pair of Aces




PokerStars Game #59941947304:  Hold'em No Limit ($0.10/$0.25) - 2009/07/01 1:51:14 ET
Table 'CBnRhp0d6E2+/NtM7Vbruw' 9-max Seat #6 is the button
Seat 1: 18G4P1XstjNvItdGUITxgw ($25 in chips) 
Seat 2: cZ99hugmLBj9KhTlc8nCSw ($26.50 in chips) 
Seat 3: Y3DZ6qQlLeBhixDj4M9vmg ($6.35 in chips) 
Seat 5: CT7Xj/V/O5rBlhtt+RZeFQ ($25.35 in chips) 
Seat 6: CvL9Ch1HYCVbTsfpNucitg ($3.95 in chips) 
Seat 7: j4q3p0lesp63b1gZDwLBZw ($5 in chips) 
Seat 8: MG90wfSJZnOejs/KD3vlQQ ($25.35 in chips) 
Seat 9: xHZZRLAaFUIC8WWI8ljOJA ($29.55 in chips) 
j4q3p0lesp63b1gZDwLBZw: posts small blind $0.10
MG90wfSJZnOejs/KD3vlQQ: posts big blind $0.25
*** HOLE CARDS ***
xHZZRLAaFUIC8WWI8ljOJA: folds 
18G4P1XstjNvItdGUITxgw: folds 
cZ99hugmLBj9KhTlc8nCSw: folds 
Y3DZ6qQlLeBhixDj4M9vmg: calls $0.25
CT7Xj/V/O5rBlhtt+RZeFQ: folds 
CvL9Ch1HYCVbTsfpNucitg: raises $1 to $1.25
j4q3p0lesp63b1gZDwLBZw: folds 
MG90wfSJZnOejs/KD3vlQQ: folds 
Y3DZ6qQlLeBhixDj4M9vmg: calls $1
*** FLOP *** [8s 2h Ac]
Y3DZ6qQlLeBhixDj4M9vmg: checks 
CvL9Ch1HYCVbTsfpNucitg: checks 
*** TURN *** [8s 2h Ac] [9s]
Y3DZ6qQlLeBhixDj4M9vmg: bets $1
CvL9Ch1HYCVbTsfpNucitg: calls $1
*** RIVER *** [8s 2h Ac 9s] [9c]
Y3DZ6qQlLeBhixDj4M9vmg: bets $0.25
CvL9Ch1HYCVbTsfpNucitg: calls $0.25
*** SHOW DOWN ***
Y3DZ6qQlLeBhixDj4M9vmg: shows [Ts 6s] (a pair of Nines)
CvL9Ch1HYCVbTsfpNucitg: shows [Qs Qc] (two pair, Queens and Nines)
CvL9Ch1HYCVbTsfpNucitg collected $5.10 from pot
*** SUMMARY ***
Total pot $5.35 | Rake $0.25 
Board [8s 2h Ac 9s 9c]
Seat 1: 18G4P1XstjNvItdGUITxgw folded before Flop (didn't bet)
Seat 2: cZ99hugmLBj9KhTlc8nCSw folded before Flop (didn't bet)
Seat 3: Y3DZ6qQlLeBhixDj4M9vmg showed [Ts 6s] and lost with a pair of Nines
Seat 5: CT7Xj/V/O5rBlhtt+RZeFQ folded before Flop (didn't bet)
Seat 6: CvL9Ch1HYCVbTsfpNucitg (button) showed [Qs Qc] and won ($5.10) with two pair, Queens and Nines
Seat 7: j4q3p0lesp63b1gZDwLBZw (small blind) folded before Flop
Seat 8: MG90wfSJZnOejs/KD3vlQQ (big blind) folded before Flop
Seat 9: xHZZRLAaFUIC8WWI8ljOJA folded before Flop (didn't bet)




PokerStars Game #59941947466:  Hold'em No Limit ($0.10/$0.25) - 2009/07/01 1:51:14 ET
Table 'RUOqTfzbAVGS5x+J9aZMHA' 9-max Seat #9 is the button
Seat 1: DnDcAdn9P0zGovMERigpFA ($28.40 in chips) 
Seat 2: Z5ZtGOON8kmSdSCll9Z3XA ($6 in chips) 
Seat 3: Th3FldXKQW6hWVVPahaoOQ ($25 in chips) 
Seat 4: K9Az8li/CO2TicltVWKamA ($26.75 in chips) 
Seat 5: MtVtHDqIJTyUcXkRBBDIVA ($33.55 in chips) 
Seat 6: ljemhp25Zg+nlA9DLCIiUw ($48 in chips) 
Seat 7: zgi+EUykT/pZQpoUG6+oEg ($5 in chips) 
Seat 9: cZ99hugmLBj9KhTlc8nCSw ($25 in chips) 
DnDcAdn9P0zGovMERigpFA: posts small blind $0.10
Z5ZtGOON8kmSdSCll9Z3XA: posts big blind $0.25
*** HOLE CARDS ***
Th3FldXKQW6hWVVPahaoOQ: folds 
K9Az8li/CO2TicltVWKamA: folds 
MtVtHDqIJTyUcXkRBBDIVA: folds 
ljemhp25Zg+nlA9DLCIiUw: folds 
zgi+EUykT/pZQpoUG6+oEg: folds 
cZ99hugmLBj9KhTlc8nCSw: folds 
DnDcAdn9P0zGovMERigpFA: folds 
Uncalled bet ($0.15) returned to Z5ZtGOON8kmSdSCll9Z3XA
Z5ZtGOON8kmSdSCll9Z3XA collected $0.20 from pot
*** SUMMARY ***
Total pot $0.20 | Rake $0 
Seat 1: DnDcAdn9P0zGovMERigpFA (small blind) folded before Flop
Seat 2: Z5ZtGOON8kmSdSCll9Z3XA (big blind) collected ($0.20)
Seat 3: Th3FldXKQW6hWVVPahaoOQ folded before Flop (didn't bet)
Seat 4: K9Az8li/CO2TicltVWKamA folded before Flop (didn't bet)
Seat 5: MtVtHDqIJTyUcXkRBBDIVA folded before Flop (didn't bet)
Seat 6: ljemhp25Zg+nlA9DLCIiUw folded before Flop (didn't bet)
Seat 7: zgi+EUykT/pZQpoUG6+oEg folded before Flop (didn't bet)
Seat 9: cZ99hugmLBj9KhTlc8nCSw (button) folded before Flop (didn't bet)




PokerStars Game #59941947248:  Hold'em No Limit ($0.10/$0.25) - 2009/07/01 1:51:14 ET
Table 'G26g8jde1eR+mmabeFeSlw' 9-max Seat #4 is the button
Seat 1: wnerYvSRWT9Sm4X3ip/c8w ($24.65 in chips) 
Seat 2: BFYwQ0J4xWUQvouudojivA ($15.45 in chips) 
Seat 4: 8EbrQ/EvFWt2cr0GaU82gQ ($5.40 in chips) 
Seat 5: hJ4uYjNmSZdjrKA8cjZqCA ($39.35 in chips) 
Seat 6: AHGkesF/mi4sDMpqrxBUoA ($8.55 in chips) 
Seat 7: nm4Dj/f+jJEwKVsUnKh73g ($38.55 in chips) 
Seat 8: CvL9Ch1HYCVbTsfpNucitg ($3.50 in chips) 
Seat 9: VWUWpMLMj/Q1jRVpF7Aohw ($13.30 in chips) 
hJ4uYjNmSZdjrKA8cjZqCA: posts small blind $0.10
AHGkesF/mi4sDMpqrxBUoA: posts big blind $0.25
*** HOLE CARDS ***
WKL8nUFr7TumC4EjLyqYzw leaves the table
nm4Dj/f+jJEwKVsUnKh73g: folds 
CvL9Ch1HYCVbTsfpNucitg: folds 
VWUWpMLMj/Q1jRVpF7Aohw: folds 
wnerYvSRWT9Sm4X3ip/c8w: folds 
BFYwQ0J4xWUQvouudojivA: folds 
8EbrQ/EvFWt2cr0GaU82gQ: folds 
hJ4uYjNmSZdjrKA8cjZqCA: folds 
Uncalled bet ($0.15) returned to AHGkesF/mi4sDMpqrxBUoA
AHGkesF/mi4sDMpqrxBUoA collected $0.20 from pot
*** SUMMARY ***
Total pot $0.20 | Rake $0 
Seat 1: wnerYvSRWT9Sm4X3ip/c8w folded before Flop (didn't bet)
Seat 2: BFYwQ0J4xWUQvouudojivA folded before Flop (didn't bet)
Seat 4: 8EbrQ/EvFWt2cr0GaU82gQ (button) folded before Flop (didn't bet)
Seat 5: hJ4uYjNmSZdjrKA8cjZqCA (small blind) folded before Flop
Seat 6: AHGkesF/mi4sDMpqrxBUoA (big blind) collected ($0.20)
Seat 7: nm4Dj/f+jJEwKVsUnKh73g folded before Flop (didn't bet)
Seat 8: CvL9Ch1HYCVbTsfpNucitg folded before Flop (didn't bet)
Seat 9: VWUWpMLMj/Q1jRVpF7Aohw folded before Flop (didn't bet)




PokerStars Game #59941947348:  Hold'em No Limit ($0.10/$0.25) - 2009/07/01 1:51:14 ET
Table 'oxYpQNT8OHNCvpMIFi7UoA' 9-max Seat #6 is the button
Seat 1: EVqHvqty1ZsuvDFiSXlSqQ ($32.70 in chips) 
Seat 2: 8+iP8mvFyeAviW/yUH1CJg ($32.80 in chips) 
Seat 3: ubsjZomMWSV0hAiBLa7K1A ($19.80 in chips) 
Seat 4: eK8qa6EPcH2zhtbmWSvc9g ($25 in chips) 
Seat 5: ZoqLw33zTU6EsjOkfv/cGw ($19.15 in chips) 
Seat 6: VBHxUExRAMrbxUq/cVx9Gw ($5.05 in chips) 
Seat 7: X78b5v/uhqeXXoAijbw/yg ($35.40 in chips) 
Seat 8: E2OrwPLjPzZjbllMp2olEw ($17.50 in chips) 
Seat 9: pN3IHvAKm2fz+sTRARTcrg ($25 in chips) 
X78b5v/uhqeXXoAijbw/yg: posts small blind $0.10
E2OrwPLjPzZjbllMp2olEw: posts big blind $0.25
*** HOLE CARDS ***
pN3IHvAKm2fz+sTRARTcrg: folds 
EVqHvqty1ZsuvDFiSXlSqQ: folds 
8+iP8mvFyeAviW/yUH1CJg: calls $0.25
ubsjZomMWSV0hAiBLa7K1A: folds 
eK8qa6EPcH2zhtbmWSvc9g: folds 
ZoqLw33zTU6EsjOkfv/cGw: calls $0.25
VBHxUExRAMrbxUq/cVx9Gw: folds 
X78b5v/uhqeXXoAijbw/yg: folds 
E2OrwPLjPzZjbllMp2olEw: checks 
*** FLOP *** [9c Td Ad]
E2OrwPLjPzZjbllMp2olEw: checks 
8+iP8mvFyeAviW/yUH1CJg: checks 
ZoqLw33zTU6EsjOkfv/cGw: checks 
*** TURN *** [9c Td Ad] [7h]
E2OrwPLjPzZjbllMp2olEw: checks 
8+iP8mvFyeAviW/yUH1CJg: checks 
ZoqLw33zTU6EsjOkfv/cGw: bets $0.50
E2OrwPLjPzZjbllMp2olEw: folds 
8+iP8mvFyeAviW/yUH1CJg: folds 
Uncalled bet ($0.50) returned to ZoqLw33zTU6EsjOkfv/cGw
8+iP8mvFyeAviW/yUH1CJg is sitting out
ZoqLw33zTU6EsjOkfv/cGw collected $0.85 from pot
ZoqLw33zTU6EsjOkfv/cGw: doesn't show hand 
*** SUMMARY ***
Total pot $0.85 | Rake $0 
Board [9c Td Ad 7h]
Seat 1: EVqHvqty1ZsuvDFiSXlSqQ folded before Flop (didn't bet)
Seat 2: 8+iP8mvFyeAviW/yUH1CJg folded on the Turn
Seat 3: ubsjZomMWSV0hAiBLa7K1A folded before Flop (didn't bet)
Seat 4: eK8qa6EPcH2zhtbmWSvc9g folded before Flop (didn't bet)
Seat 5: ZoqLw33zTU6EsjOkfv/cGw collected ($0.85)
Seat 6: VBHxUExRAMrbxUq/cVx9Gw (button) folded before Flop (didn't bet)
Seat 7: X78b5v/uhqeXXoAijbw/yg (small blind) folded before Flop
Seat 8: E2OrwPLjPzZjbllMp2olEw (big blind) folded on the Turn
Seat 9: pN3IHvAKm2fz+sTRARTcrg folded before Flop (didn't bet)




PokerStars Game #59941947460:  Hold'em No Limit ($0.10/$0.25) - 2009/07/01 1:51:14 ET
Table '4hfTdIVT/qPsJNfWXLsVIw' 9-max Seat #5 is the button
Seat 1: GbHFBbLqLGz0Pwn6CJeAuw ($38.20 in chips) 
Seat 2: Pt637jKksB5MzP0UNJAAkw ($39.85 in chips) 
Seat 3: xnVwSkROfRtOw4eSoDANtw ($2.10 in chips) 
Seat 4: 3PmVnC/15cl4oyI1TKIt4g ($6.55 in chips) 
Seat 5: dtZ84flFEi4Q+SGrHMJRDQ ($26 in chips) 
Seat 6: VWUWpMLMj/Q1jRVpF7Aohw ($11.90 in chips) 
Seat 7: d7YasxuGLPiL7pj8IcGThw ($7.45 in chips) 
Seat 8: 7cv+9Zc9HIQHNvYsMfV3uA ($32.55 in chips) 
Seat 9: 9njEKzpOKC62MllUFUBWrA ($22.25 in chips) 
VWUWpMLMj/Q1jRVpF7Aohw: posts small blind $0.10
d7YasxuGLPiL7pj8IcGThw: posts big blind $0.25
*** HOLE CARDS ***
7cv+9Zc9HIQHNvYsMfV3uA: folds 
9njEKzpOKC62MllUFUBWrA: folds 
7cv+9Zc9HIQHNvYsMfV3uA leaves the table
GbHFBbLqLGz0Pwn6CJeAuw: calls $0.25
Pt637jKksB5MzP0UNJAAkw: folds 
xnVwSkROfRtOw4eSoDANtw: folds 
3PmVnC/15cl4oyI1TKIt4g: folds 
dtZ84flFEi4Q+SGrHMJRDQ: raises $0.75 to $1
18G4P1XstjNvItdGUITxgw joins the table at seat #8 
VWUWpMLMj/Q1jRVpF7Aohw: folds 
d7YasxuGLPiL7pj8IcGThw: folds 
GbHFBbLqLGz0Pwn6CJeAuw: folds 
Uncalled bet ($0.75) returned to dtZ84flFEi4Q+SGrHMJRDQ
dtZ84flFEi4Q+SGrHMJRDQ collected $0.85 from pot
dtZ84flFEi4Q+SGrHMJRDQ: doesn't show hand 
*** SUMMARY ***
Total pot $0.85 | Rake $0 
Seat 1: GbHFBbLqLGz0Pwn6CJeAuw folded before Flop
Seat 2: Pt637jKksB5MzP0UNJAAkw folded before Flop (didn't bet)
Seat 3: xnVwSkROfRtOw4eSoDANtw folded before Flop (didn't bet)
Seat 4: 3PmVnC/15cl4oyI1TKIt4g folded before Flop (didn't bet)
Seat 5: dtZ84flFEi4Q+SGrHMJRDQ (button) collected ($0.85)
Seat 6: VWUWpMLMj/Q1jRVpF7Aohw (small blind) folded before Flop
Seat 7: d7YasxuGLPiL7pj8IcGThw (big blind) folded before Flop
Seat 8: 7cv+9Zc9HIQHNvYsMfV3uA folded before Flop (didn't bet)
Seat 9: 9njEKzpOKC62MllUFUBWrA folded before Flop (didn't bet)




PokerStars Game #59941947608:  Hold'em No Limit ($0.10/$0.25) - 2009/07/01 1:51:14 ET
Table '8Z6T3ssCpo3VV849U4RgBw' 9-max Seat #5 is the button
Seat 1: Z9W7+g1WMhhZDi7DwGbCFA ($6.15 in chips) 
Seat 2: SpiiQQAzy4MUgV3I5W8giw ($19.10 in chips) 
Seat 3: tLcDklc2rBORNfixyRfVfw ($40.90 in chips) 
Seat 4: RCqMONFrSPSArZh2Jsar/w ($15.90 in chips) 
Seat 5: zDrucyjVn5aeekNEc3cJrA ($15.65 in chips) 
Seat 6: 4qA/3Ajg3pP6fqW+IX9/fQ ($4.75 in chips) 
Seat 7: oLa/tXLfSLLB28mcLGrxcg ($24.85 in chips) 
Seat 8: PdIasPkzm2sqZnN41ZRXOg ($5.25 in chips) 
Seat 9: HDDm1BkZtdsRyw2DJdqq6A ($31.10 in chips) 
4qA/3Ajg3pP6fqW+IX9/fQ: posts small blind $0.10
oLa/tXLfSLLB28mcLGrxcg: posts big blind $0.25
*** HOLE CARDS ***
PdIasPkzm2sqZnN41ZRXOg: folds 
HDDm1BkZtdsRyw2DJdqq6A: folds 
Z9W7+g1WMhhZDi7DwGbCFA: calls $0.25
SpiiQQAzy4MUgV3I5W8giw: folds 
tLcDklc2rBORNfixyRfVfw: calls $0.25
RCqMONFrSPSArZh2Jsar/w: folds 
zDrucyjVn5aeekNEc3cJrA: folds 
4qA/3Ajg3pP6fqW+IX9/fQ: folds 
oLa/tXLfSLLB28mcLGrxcg: checks 
*** FLOP *** [Jh Qh 8c]
oLa/tXLfSLLB28mcLGrxcg: checks 
Z9W7+g1WMhhZDi7DwGbCFA: bets $0.50
tLcDklc2rBORNfixyRfVfw: folds 
oLa/tXLfSLLB28mcLGrxcg: folds 
Uncalled bet ($0.50) returned to Z9W7+g1WMhhZDi7DwGbCFA
Z9W7+g1WMhhZDi7DwGbCFA collected $0.85 from pot
Z9W7+g1WMhhZDi7DwGbCFA: doesn't show hand 
*** SUMMARY ***
Total pot $0.85 | Rake $0 
Board [Jh Qh 8c]
Seat 1: Z9W7+g1WMhhZDi7DwGbCFA collected ($0.85)
Seat 2: SpiiQQAzy4MUgV3I5W8giw folded before Flop (didn't bet)
Seat 3: tLcDklc2rBORNfixyRfVfw folded on the Flop
Seat 4: RCqMONFrSPSArZh2Jsar/w folded before Flop (didn't bet)
Seat 5: zDrucyjVn5aeekNEc3cJrA (button) folded before Flop (didn't bet)
Seat 6: 4qA/3Ajg3pP6fqW+IX9/fQ (small blind) folded before Flop
Seat 7: oLa/tXLfSLLB28mcLGrxcg (big blind) folded on the Flop
Seat 8: PdIasPkzm2sqZnN41ZRXOg folded before Flop (didn't bet)
Seat 9: HDDm1BkZtdsRyw2DJdqq6A folded before Flop (didn't bet)




PokerStars Game #59941947990:  Hold'em No Limit ($0.10/$0.25) - 2009/07/01 1:51:15 ET
Table 'xkqAWQFDrFt4p81M8UsoNw' 9-max Seat #4 is the button
Seat 1: tLcDklc2rBORNfixyRfVfw ($28.60 in chips) 
Seat 3: xHZZRLAaFUIC8WWI8ljOJA ($23.65 in chips) 
Seat 4: wGigCmBR/9XWkPpvYos3aQ ($25 in chips) 
Seat 5: H5Se03ZqSX7tbULXur2MAg ($24.75 in chips) 
Seat 6: 6RiVTYll/5D8zICp0MRpKw ($25 in chips) 
Seat 7: MG90wfSJZnOejs/KD3vlQQ ($44.55 in chips) 
Seat 8: MaqsqnOOkbNuPf4oWvOtnA ($45.20 in chips) 
Seat 9: Z9AeOQX3yzuSvKAm/xyovg ($7.55 in chips) 
H5Se03ZqSX7tbULXur2MAg: posts small blind $0.10
6RiVTYll/5D8zICp0MRpKw: posts big blind $0.25
z5GxcHlYz/GSz6W2uFiTtg: sits out 
*** HOLE CARDS ***
MG90wfSJZnOejs/KD3vlQQ: folds 
MaqsqnOOkbNuPf4oWvOtnA: folds 
Z9AeOQX3yzuSvKAm/xyovg: folds 
tLcDklc2rBORNfixyRfVfw: folds 
xHZZRLAaFUIC8WWI8ljOJA: raises $0.50 to $0.75
wGigCmBR/9XWkPpvYos3aQ: folds 
H5Se03ZqSX7tbULXur2MAg: calls $0.65
6RiVTYll/5D8zICp0MRpKw: folds 
*** FLOP *** [6c 3h Jc]
H5Se03ZqSX7tbULXur2MAg: checks 
xHZZRLAaFUIC8WWI8ljOJA: bets $0.75
H5Se03ZqSX7tbULXur2MAg: calls $0.75
*** TURN *** [6c 3h Jc] [Td]
H5Se03ZqSX7tbULXur2MAg: checks 
xHZZRLAaFUIC8WWI8ljOJA: checks 
*** RIVER *** [6c 3h Jc Td] [6h]
H5Se03ZqSX7tbULXur2MAg: bets $0.75
xHZZRLAaFUIC8WWI8ljOJA: calls $0.75
*** SHOW DOWN ***
H5Se03ZqSX7tbULXur2MAg: shows [Qd Jd] (two pair, Jacks and Sixes)
xHZZRLAaFUIC8WWI8ljOJA: mucks hand 
H5Se03ZqSX7tbULXur2MAg collected $4.55 from pot
*** SUMMARY ***
Total pot $4.75 | Rake $0.20 
Board [6c 3h Jc Td 6h]
Seat 1: tLcDklc2rBORNfixyRfVfw folded before Flop (didn't bet)
Seat 3: xHZZRLAaFUIC8WWI8ljOJA mucked
Seat 4: wGigCmBR/9XWkPpvYos3aQ (button) folded before Flop (didn't bet)
Seat 5: H5Se03ZqSX7tbULXur2MAg (small blind) showed [Qd Jd] and won ($4.55) with two pair, Jacks and Sixes
Seat 6: 6RiVTYll/5D8zICp0MRpKw (big blind) folded before Flop
Seat 7: MG90wfSJZnOejs/KD3vlQQ folded before Flop (didn't bet)
Seat 8: MaqsqnOOkbNuPf4oWvOtnA folded before Flop (didn't bet)
Seat 9: Z9AeOQX3yzuSvKAm/xyovg folded before Flop (didn't bet)




PokerStars Game #59941948054:  Hold'em No Limit ($0.10/$0.25) - 2009/07/01 1:51:15 ET
Table 'nc6OeGk/wtaWV+6N+kgnZQ' 6-max Seat #4 is the button
Seat 2: 8ClCHtFXGNplITm+63KB+Q ($37.60 in chips) 
Seat 3: y8wpMWGSX2zHZijurx21mg ($5.45 in chips) 
Seat 4: 3zD3qLXT1bEffAoWGnc7wg ($31.20 in chips) 
Seat 5: HCS0lMAAPmZE2Tl8J/SuKw ($9.05 in chips) 
Seat 6: kARKwAmU6kWJfiSICTYhVw ($10 in chips) 
HCS0lMAAPmZE2Tl8J/SuKw: posts small blind $0.10
kARKwAmU6kWJfiSICTYhVw: posts big blind $0.25
*** HOLE CARDS ***
8ClCHtFXGNplITm+63KB+Q: folds 
y8wpMWGSX2zHZijurx21mg: calls $0.25
3zD3qLXT1bEffAoWGnc7wg: folds 
HCS0lMAAPmZE2Tl8J/SuKw: calls $0.15
kARKwAmU6kWJfiSICTYhVw: checks 
*** FLOP *** [4h Kd 2c]
HCS0lMAAPmZE2Tl8J/SuKw: checks 
kARKwAmU6kWJfiSICTYhVw: checks 
y8wpMWGSX2zHZijurx21mg: bets $0.50
HCS0lMAAPmZE2Tl8J/SuKw: calls $0.50
kARKwAmU6kWJfiSICTYhVw: folds 
*** TURN *** [4h Kd 2c] [Ad]
HCS0lMAAPmZE2Tl8J/SuKw: checks 
y8wpMWGSX2zHZijurx21mg: bets $0.50
HCS0lMAAPmZE2Tl8J/SuKw: folds 
Uncalled bet ($0.50) returned to y8wpMWGSX2zHZijurx21mg
y8wpMWGSX2zHZijurx21mg collected $1.70 from pot
y8wpMWGSX2zHZijurx21mg: doesn't show hand 
*** SUMMARY ***
Total pot $1.75 | Rake $0.05 
Board [4h Kd 2c Ad]
Seat 2: 8ClCHtFXGNplITm+63KB+Q folded before Flop (didn't bet)
Seat 3: y8wpMWGSX2zHZijurx21mg collected ($1.70)
Seat 4: 3zD3qLXT1bEffAoWGnc7wg (button) folded before Flop (didn't bet)
Seat 5: HCS0lMAAPmZE2Tl8J/SuKw (small blind) folded on the Turn
Seat 6: kARKwAmU6kWJfiSICTYhVw (big blind) folded on the Flop




PokerStars Game #59941948012:  Hold'em No Limit ($0.10/$0.25) - 2009/07/01 1:51:15 ET
Table 'AHkg4ChqzcMauBx6Qvz8Nw' 6-max Seat #5 is the button
Seat 2: Vi0JMrTI2BGrPL7UIulJtA ($4 in chips) 
Seat 3: 9dToMv2GJLfi00HcpfMnIw ($30.10 in chips) 
Seat 4: Eznneya0vB6S+eXJdVleHA ($21.90 in chips) 
Seat 5: Bada343Si4xKu3fNXY99AA ($3.45 in chips) 
Seat 6: Hsvkc0/G2VV78oVmWYXecw ($5 in chips) 
Hsvkc0/G2VV78oVmWYXecw: posts small blind $0.10
Vi0JMrTI2BGrPL7UIulJtA: posts big blind $0.25
*** HOLE CARDS ***
9dToMv2GJLfi00HcpfMnIw: raises $0.50 to $0.75
Eznneya0vB6S+eXJdVleHA: folds 
Bada343Si4xKu3fNXY99AA: folds 
Hsvkc0/G2VV78oVmWYXecw: folds 
Vi0JMrTI2BGrPL7UIulJtA: folds 
Uncalled bet ($0.50) returned to 9dToMv2GJLfi00HcpfMnIw
Hsvkc0/G2VV78oVmWYXecw leaves the table
+RDf7SmUjY2kK0PzdBEYqg has returned
9dToMv2GJLfi00HcpfMnIw collected $0.60 from pot
9dToMv2GJLfi00HcpfMnIw: doesn't show hand 
*** SUMMARY ***
Total pot $0.60 | Rake $0 
Seat 2: Vi0JMrTI2BGrPL7UIulJtA (big blind) folded before Flop
Seat 3: 9dToMv2GJLfi00HcpfMnIw collected ($0.60)
Seat 4: Eznneya0vB6S+eXJdVleHA folded before Flop (didn't bet)
Seat 5: Bada343Si4xKu3fNXY99AA (button) folded before Flop (didn't bet)
Seat 6: Hsvkc0/G2VV78oVmWYXecw (small blind) folded before Flop




PokerStars Game #59941947976:  Hold'em No Limit ($0.10/$0.25) - 2009/07/01 1:51:15 ET
Table '29D3eoQzK5kOAT0OIDS2uQ' 6-max Seat #3 is the button
Seat 1: kG34n23qFQA3nzdOJTQ1dA ($43.15 in chips) 
Seat 2: FyE+TQ5JcCqI/tCCHf0jGA ($16.70 in chips) 
Seat 3: z3tQwy28dp5FykDJC/wzQw ($15.45 in chips) 
Seat 4: MqMK8OWPSY1V4stf1Hy5Jw ($64.45 in chips) 
Seat 5: Q3EMN7b0ie81AFWkDrhCjw ($26.95 in chips) 
MqMK8OWPSY1V4stf1Hy5Jw: posts small blind $0.10
Q3EMN7b0ie81AFWkDrhCjw: posts big blind $0.25
if4dh6jhJXeN3/qd3qCp9g: sits out 
*** HOLE CARDS ***
kG34n23qFQA3nzdOJTQ1dA: folds 
FyE+TQ5JcCqI/tCCHf0jGA: folds 
z3tQwy28dp5FykDJC/wzQw: calls $0.25
MqMK8OWPSY1V4stf1Hy5Jw: folds 
Q3EMN7b0ie81AFWkDrhCjw: raises $0.75 to $1
z3tQwy28dp5FykDJC/wzQw: folds 
Uncalled bet ($0.75) returned to Q3EMN7b0ie81AFWkDrhCjw
MqMK8OWPSY1V4stf1Hy5Jw leaves the table
Q3EMN7b0ie81AFWkDrhCjw collected $0.60 from pot
*** SUMMARY ***
Total pot $0.60 | Rake $0 
Seat 1: kG34n23qFQA3nzdOJTQ1dA folded before Flop (didn't bet)
Seat 2: FyE+TQ5JcCqI/tCCHf0jGA folded before Flop (didn't bet)
Seat 3: z3tQwy28dp5FykDJC/wzQw (button) folded before Flop
Seat 4: MqMK8OWPSY1V4stf1Hy5Jw (small blind) folded before Flop
Seat 5: Q3EMN7b0ie81AFWkDrhCjw (big blind) collected ($0.60)




PokerStars Game #59941947936:  Hold'em No Limit ($0.10/$0.25) - 2009/07/01 1:51:15 ET
Table 'g6ryG70feTw9nNm+XJLuXw' 6-max Seat #4 is the button
Seat 1: v+QfkGiuj9bgtuNoVnDO8w ($35.10 in chips) 
Seat 2: SxIIgwXYLkwd6m3wLyPTCw ($33.90 in chips) 
Seat 3: cezpHJ8FB07dj0xG+LhOvw ($25 in chips) 
Seat 4: GC/9yVD59DUCX7hUI7gcLw ($44.65 in chips) 
Seat 5: EE16Ua5b1HSsYej5zeXOlA ($25.10 in chips) 
Seat 6: Mhj3q7cxev+XjXZxEE6/Cw ($25.70 in chips) 
EE16Ua5b1HSsYej5zeXOlA: posts small blind $0.10
Mhj3q7cxev+XjXZxEE6/Cw: posts big blind $0.25
*** HOLE CARDS ***
v+QfkGiuj9bgtuNoVnDO8w: folds 
SxIIgwXYLkwd6m3wLyPTCw: folds 
cezpHJ8FB07dj0xG+LhOvw: folds 
GC/9yVD59DUCX7hUI7gcLw: raises $0.75 to $1
EE16Ua5b1HSsYej5zeXOlA: folds 
Mhj3q7cxev+XjXZxEE6/Cw: folds 
Uncalled bet ($0.75) returned to GC/9yVD59DUCX7hUI7gcLw
GC/9yVD59DUCX7hUI7gcLw collected $0.60 from pot
*** SUMMARY ***
Total pot $0.60 | Rake $0 
Seat 1: v+QfkGiuj9bgtuNoVnDO8w folded before Flop (didn't bet)
Seat 2: SxIIgwXYLkwd6m3wLyPTCw folded before Flop (didn't bet)
Seat 3: cezpHJ8FB07dj0xG+LhOvw folded before Flop (didn't bet)
Seat 4: GC/9yVD59DUCX7hUI7gcLw (button) collected ($0.60)
Seat 5: EE16Ua5b1HSsYej5zeXOlA (small blind) folded before Flop
Seat 6: Mhj3q7cxev+XjXZxEE6/Cw (big blind) folded before Flop




PokerStars Game #59941947756:  Hold'em No Limit ($0.10/$0.25) - 2009/07/01 1:51:15 ET
Table 'rjcb+nlE+0GuJ6lBhuCkkA' 6-max Seat #5 is the button
Seat 1: lBoEwOFgzcERLIRUkUoRTw ($12.90 in chips) 
Seat 2: lJphax9e7/+O/3YCKPJ0yQ ($6.80 in chips) 
Seat 3: 8ClCHtFXGNplITm+63KB+Q ($65.85 in chips) 
Seat 4: BV+K0Phf5VBHr7aZPKqbUQ ($35.50 in chips) 
Seat 5: GC/9yVD59DUCX7hUI7gcLw ($30.15 in chips) 
Seat 6: 32YL2ZEp8NT4JB2RVM9euQ ($15.80 in chips) 
32YL2ZEp8NT4JB2RVM9euQ: posts small blind $0.10
lBoEwOFgzcERLIRUkUoRTw: posts big blind $0.25
*** HOLE CARDS ***
lJphax9e7/+O/3YCKPJ0yQ: folds 
lJphax9e7/+O/3YCKPJ0yQ leaves the table
8ClCHtFXGNplITm+63KB+Q: folds 
BV+K0Phf5VBHr7aZPKqbUQ: folds 
GC/9yVD59DUCX7hUI7gcLw: folds 
32YL2ZEp8NT4JB2RVM9euQ: raises $0.75 to $1
lBoEwOFgzcERLIRUkUoRTw: folds 
Uncalled bet ($0.75) returned to 32YL2ZEp8NT4JB2RVM9euQ
32YL2ZEp8NT4JB2RVM9euQ collected $0.50 from pot
32YL2ZEp8NT4JB2RVM9euQ: doesn't show hand 
*** SUMMARY ***
Total pot $0.50 | Rake $0 
Seat 1: lBoEwOFgzcERLIRUkUoRTw (big blind) folded before Flop
Seat 2: lJphax9e7/+O/3YCKPJ0yQ folded before Flop (didn't bet)
Seat 3: 8ClCHtFXGNplITm+63KB+Q folded before Flop (didn't bet)
Seat 4: BV+K0Phf5VBHr7aZPKqbUQ folded before Flop (didn't bet)
Seat 5: GC/9yVD59DUCX7hUI7gcLw (button) folded before Flop (didn't bet)
Seat 6: 32YL2ZEp8NT4JB2RVM9euQ (small blind) collected ($0.50)




PokerStars Game #59941947768:  Hold'em No Limit ($0.10/$0.25) - 2009/07/01 1:51:15 ET
Table 'KEoOIegxPF91KooL2AelUA' 6-max Seat #3 is the button
Seat 1: 32YL2ZEp8NT4JB2RVM9euQ ($16.65 in chips) 
Seat 2: 0Bg59Tnte1Tc7C4i9Jd9cQ ($5.85 in chips) 
Seat 3: zxeVQGaMKDsDzmSY+AInjA ($12 in chips) 
Seat 4: Wo60l2GQnSEc3bxPVyvIUw ($8.25 in chips) 
Seat 5: VXTONriS+Ohik+r0FeicIw ($25 in chips) 
Seat 6: AMrBn4Vx9aAo/vv6WHLk6w ($3.50 in chips) 
Wo60l2GQnSEc3bxPVyvIUw: posts small blind $0.10
VXTONriS+Ohik+r0FeicIw: posts big blind $0.25
*** HOLE CARDS ***
AMrBn4Vx9aAo/vv6WHLk6w: calls $0.25
32YL2ZEp8NT4JB2RVM9euQ: folds 
0Bg59Tnte1Tc7C4i9Jd9cQ: folds 
zxeVQGaMKDsDzmSY+AInjA: folds 
Wo60l2GQnSEc3bxPVyvIUw: raises $0.50 to $0.75
VXTONriS+Ohik+r0FeicIw: raises $1.50 to $2.25
AMrBn4Vx9aAo/vv6WHLk6w: folds 
Wo60l2GQnSEc3bxPVyvIUw: calls $1.50
*** FLOP *** [2d 9h Jh]
Wo60l2GQnSEc3bxPVyvIUw: checks 
VXTONriS+Ohik+r0FeicIw: bets $3.50
Wo60l2GQnSEc3bxPVyvIUw: folds 
Uncalled bet ($3.50) returned to VXTONriS+Ohik+r0FeicIw
VXTONriS+Ohik+r0FeicIw collected $4.55 from pot
VXTONriS+Ohik+r0FeicIw: doesn't show hand 
*** SUMMARY ***
Total pot $4.75 | Rake $0.20 
Board [2d 9h Jh]
Seat 1: 32YL2ZEp8NT4JB2RVM9euQ folded before Flop (didn't bet)
Seat 2: 0Bg59Tnte1Tc7C4i9Jd9cQ folded before Flop (didn't bet)
Seat 3: zxeVQGaMKDsDzmSY+AInjA (button) folded before Flop (didn't bet)
Seat 4: Wo60l2GQnSEc3bxPVyvIUw (small blind) folded on the Flop
Seat 5: VXTONriS+Ohik+r0FeicIw (big blind) collected ($4.55)
Seat 6: AMrBn4Vx9aAo/vv6WHLk6w folded before Flop




PokerStars Game #59941948734:  Hold'em No Limit ($0.10/$0.25) - 2009/07/01 1:51:16 ET
Table '4XGDnEByOol5up4aB2KbJw' 6-max Seat #5 is the button
Seat 1: kyRaCIljYA6l33lSKQfNsg ($27.10 in chips) 
Seat 2: SFmT9ZsVopnukjvAzrxTRg ($45.90 in chips) 
Seat 3: LtASJ9OlkqGrrUKGQlpGAw ($18.55 in chips) 
Seat 4: BV+K0Phf5VBHr7aZPKqbUQ ($25 in chips) 
Seat 5: Dh01+rohD2p9pXLYeBlC5Q ($19.05 in chips) 
Seat 6: a7Ux7aERFGCbT/L3ojVfAg ($10.25 in chips) 
a7Ux7aERFGCbT/L3ojVfAg: posts small blind $0.10
kyRaCIljYA6l33lSKQfNsg: posts big blind $0.25
*** HOLE CARDS ***
SFmT9ZsVopnukjvAzrxTRg: folds 
LtASJ9OlkqGrrUKGQlpGAw: folds 
BV+K0Phf5VBHr7aZPKqbUQ: folds 
Dh01+rohD2p9pXLYeBlC5Q: raises $0.50 to $0.75
a7Ux7aERFGCbT/L3ojVfAg: folds 
kyRaCIljYA6l33lSKQfNsg: folds 
Uncalled bet ($0.50) returned to Dh01+rohD2p9pXLYeBlC5Q
Dh01+rohD2p9pXLYeBlC5Q collected $0.60 from pot
*** SUMMARY ***
Total pot $0.60 | Rake $0 
Seat 1: kyRaCIljYA6l33lSKQfNsg (big blind) folded before Flop
Seat 2: SFmT9ZsVopnukjvAzrxTRg folded before Flop (didn't bet)
Seat 3: LtASJ9OlkqGrrUKGQlpGAw folded before Flop (didn't bet)
Seat 4: BV+K0Phf5VBHr7aZPKqbUQ folded before Flop (didn't bet)
Seat 5: Dh01+rohD2p9pXLYeBlC5Q (button) collected ($0.60)
Seat 6: a7Ux7aERFGCbT/L3ojVfAg (small blind) folded before Flop




PokerStars Game #59941948730:  Hold'em No Limit ($0.10/$0.25) - 2009/07/01 1:51:16 ET
Table 'xmJKTGBeWCwutccj3YfupQ' 6-max Seat #5 is the button
Seat 1: sVbkVl4OznxBCfi66UB9vw ($40.90 in chips) 
Seat 2: QqiZLFrN8iOUT/GHw7ztOA ($24.30 in chips) 
Seat 3: T5wrp/d5jarm+SxNy8OQAg ($17.45 in chips) 
Seat 4: uWjhTVMpuIroxXcmD3Okug ($15.80 in chips) 
Seat 5: DE9hRlt14g+JdsRQ4wT7hg ($38.70 in chips) 
Seat 6: 9bpVv1/Qh9IYtXuCtl5VtQ ($24.75 in chips) 
9bpVv1/Qh9IYtXuCtl5VtQ: posts small blind $0.10
sVbkVl4OznxBCfi66UB9vw: posts big blind $0.25
*** HOLE CARDS ***
QqiZLFrN8iOUT/GHw7ztOA: folds 
T5wrp/d5jarm+SxNy8OQAg: folds 
uWjhTVMpuIroxXcmD3Okug: calls $0.25
DE9hRlt14g+JdsRQ4wT7hg: folds 
9bpVv1/Qh9IYtXuCtl5VtQ: raises $1 to $1.25
sVbkVl4OznxBCfi66UB9vw: folds 
uWjhTVMpuIroxXcmD3Okug: calls $1
*** FLOP *** [Qc 7d 4d]
9bpVv1/Qh9IYtXuCtl5VtQ: bets $2
uWjhTVMpuIroxXcmD3Okug: calls $2
*** TURN *** [Qc 7d 4d] [4c]
9bpVv1/Qh9IYtXuCtl5VtQ: checks 
uWjhTVMpuIroxXcmD3Okug: bets $12.55 and is all-in
9bpVv1/Qh9IYtXuCtl5VtQ said, "..."
9bpVv1/Qh9IYtXuCtl5VtQ: calls $12.55
*** RIVER *** [Qc 7d 4d 4c] [3c]
*** SHOW DOWN ***
9bpVv1/Qh9IYtXuCtl5VtQ: shows [Td Ad] (a pair of Fours)
uWjhTVMpuIroxXcmD3Okug: shows [5c 6c] (a flush, Queen high)
uWjhTVMpuIroxXcmD3Okug collected $30.30 from pot
*** SUMMARY ***
Total pot $31.85 | Rake $1.55 
Board [Qc 7d 4d 4c 3c]
Seat 1: sVbkVl4OznxBCfi66UB9vw (big blind) folded before Flop
Seat 2: QqiZLFrN8iOUT/GHw7ztOA folded before Flop (didn't bet)
Seat 3: T5wrp/d5jarm+SxNy8OQAg folded before Flop (didn't bet)
Seat 4: uWjhTVMpuIroxXcmD3Okug showed [5c 6c] and won ($30.30) with a flush, Queen high
Seat 5: DE9hRlt14g+JdsRQ4wT7hg (button) folded before Flop (didn't bet)
Seat 6: 9bpVv1/Qh9IYtXuCtl5VtQ (small blind) showed [Td Ad] and lost with a pair of Fours




PokerStars Game #59941948254:  Hold'em No Limit ($0.10/$0.25) - 2009/07/01 1:51:16 ET
Table 'APEHQjIcZHDZUA4iOjju2g' 6-max Seat #2 is the button
Seat 1: DE9hRlt14g+JdsRQ4wT7hg ($25 in chips) 
Seat 2: 3zD3qLXT1bEffAoWGnc7wg ($33.55 in chips) 
Seat 3: 3e/idKqDuPE10t6Zvr//SQ ($19.75 in chips) 
Seat 4: w2mQ4VsGljGwWXydz8tw2A ($34.60 in chips) 
Seat 5: /xN6gc9+8Hew0HxaB6VIVg ($45.65 in chips) 
Seat 6: KXtdqb+rIMkjc0RvHDksGQ ($42 in chips) 
3e/idKqDuPE10t6Zvr//SQ: posts small blind $0.10
w2mQ4VsGljGwWXydz8tw2A: posts big blind $0.25
*** HOLE CARDS ***
/xN6gc9+8Hew0HxaB6VIVg: folds 
KXtdqb+rIMkjc0RvHDksGQ: folds 
DE9hRlt14g+JdsRQ4wT7hg: folds 
3zD3qLXT1bEffAoWGnc7wg: raises $0.50 to $0.75
3e/idKqDuPE10t6Zvr//SQ: calls $0.65
w2mQ4VsGljGwWXydz8tw2A: calls $0.50
*** FLOP *** [4s 3c 8d]
3e/idKqDuPE10t6Zvr//SQ: checks 
w2mQ4VsGljGwWXydz8tw2A: bets $0.75
3zD3qLXT1bEffAoWGnc7wg: folds 
3e/idKqDuPE10t6Zvr//SQ: calls $0.75
*** TURN *** [4s 3c 8d] [As]
3e/idKqDuPE10t6Zvr//SQ: checks 
w2mQ4VsGljGwWXydz8tw2A: bets $1
3e/idKqDuPE10t6Zvr//SQ: calls $1
*** RIVER *** [4s 3c 8d As] [Td]
3e/idKqDuPE10t6Zvr//SQ: checks 
w2mQ4VsGljGwWXydz8tw2A: checks 
*** SHOW DOWN ***
3e/idKqDuPE10t6Zvr//SQ: shows [Ks Qs] (high card Ace)
w2mQ4VsGljGwWXydz8tw2A: shows [Ad 5s] (a pair of Aces)
w2mQ4VsGljGwWXydz8tw2A collected $5.50 from pot
*** SUMMARY ***
Total pot $5.75 | Rake $0.25 
Board [4s 3c 8d As Td]
Seat 1: DE9hRlt14g+JdsRQ4wT7hg folded before Flop (didn't bet)
Seat 2: 3zD3qLXT1bEffAoWGnc7wg (button) folded on the Flop
Seat 3: 3e/idKqDuPE10t6Zvr//SQ (small blind) showed [Ks Qs] and lost with high card Ace
Seat 4: w2mQ4VsGljGwWXydz8tw2A (big blind) showed [Ad 5s] and won ($5.50) with a pair of Aces
Seat 5: /xN6gc9+8Hew0HxaB6VIVg folded before Flop (didn't bet)
Seat 6: KXtdqb+rIMkjc0RvHDksGQ folded before Flop (didn't bet)




PokerStars Game #59941948572:  Hold'em No Limit ($0.10/$0.25) - 2009/07/01 1:51:16 ET
Table 'aT31tt16YvQM/Ue69HPLpA' 9-max Seat #9 is the button
Seat 1: wxmepRUXfX1jdQfUD5uENQ ($4.50 in chips) 
Seat 3: swK30YlQuxRQO7QFr4ZxCA ($25.35 in chips) 
Seat 4: wGigCmBR/9XWkPpvYos3aQ ($26.85 in chips) 
Seat 5: s2xLPOl/vhl/26apJ3vsOQ ($33.90 in chips) 
Seat 6: ghG12/paEL5VoDN85sW6RA ($14.65 in chips) 
Seat 9: TvIuLx9zUCE+9Li58iImOQ ($13.60 in chips) 
wxmepRUXfX1jdQfUD5uENQ: posts small blind $0.10
PdIasPkzm2sqZnN41ZRXOg: is sitting out 
swK30YlQuxRQO7QFr4ZxCA: posts big blind $0.25
*** HOLE CARDS ***
PdIasPkzm2sqZnN41ZRXOg leaves the table
wGigCmBR/9XWkPpvYos3aQ: folds 
s2xLPOl/vhl/26apJ3vsOQ: folds 
ghG12/paEL5VoDN85sW6RA: raises $0.50 to $0.75
TvIuLx9zUCE+9Li58iImOQ: folds 
wxmepRUXfX1jdQfUD5uENQ: folds 
swK30YlQuxRQO7QFr4ZxCA: folds 
Uncalled bet ($0.50) returned to ghG12/paEL5VoDN85sW6RA
ghG12/paEL5VoDN85sW6RA collected $0.60 from pot
*** SUMMARY ***
Total pot $0.60 | Rake $0 
Seat 1: wxmepRUXfX1jdQfUD5uENQ (small blind) folded before Flop
Seat 3: swK30YlQuxRQO7QFr4ZxCA (big blind) folded before Flop
Seat 4: wGigCmBR/9XWkPpvYos3aQ folded before Flop (didn't bet)
Seat 5: s2xLPOl/vhl/26apJ3vsOQ folded before Flop (didn't bet)
Seat 6: ghG12/paEL5VoDN85sW6RA collected ($0.60)
Seat 9: TvIuLx9zUCE+9Li58iImOQ (button) folded before Flop (didn't bet)




PokerStars Game #59941948286:  Hold'em No Limit ($0.10/$0.25) - 2009/07/01 1:51:16 ET
Table 'P1IJQ2p3ACFySC35W1qwQw' 9-max Seat #5 is the button
Seat 1: bXpVeaSTPBFSPJmeXxO7nw ($5.50 in chips) 
Seat 2: vO3QVRovWemcGMkm7ijAIA ($4.85 in chips) 
Seat 3: PVxvfRTRvkgZf9WtquEkwQ ($27.40 in chips) 
Seat 5: ghNKXUBl/H+t83JF079ZBA ($56.45 in chips) 
Seat 6: ljemhp25Zg+nlA9DLCIiUw ($64.20 in chips) 
Seat 7: 7je+LC5Mfs6nL8YBVh4frQ ($5.10 in chips) 
Seat 8: tLcDklc2rBORNfixyRfVfw ($26.25 in chips) 
Seat 9: GeMoapCKDLc4ajT0Uk9ZQw ($9.75 in chips) 
ljemhp25Zg+nlA9DLCIiUw: posts small blind $0.10
7je+LC5Mfs6nL8YBVh4frQ: posts big blind $0.25
*** HOLE CARDS ***
tLcDklc2rBORNfixyRfVfw: folds 
GeMoapCKDLc4ajT0Uk9ZQw: folds 
bXpVeaSTPBFSPJmeXxO7nw: folds 
vO3QVRovWemcGMkm7ijAIA: raises $0.50 to $0.75
PVxvfRTRvkgZf9WtquEkwQ: calls $0.75
ghNKXUBl/H+t83JF079ZBA: folds 
ljemhp25Zg+nlA9DLCIiUw: raises $2 to $2.75
7je+LC5Mfs6nL8YBVh4frQ: folds 
vO3QVRovWemcGMkm7ijAIA: folds 
PVxvfRTRvkgZf9WtquEkwQ: calls $2
*** FLOP *** [7c 5h 3s]
ljemhp25Zg+nlA9DLCIiUw: bets $4
PVxvfRTRvkgZf9WtquEkwQ: calls $4
*** TURN *** [7c 5h 3s] [9d]
ljemhp25Zg+nlA9DLCIiUw: checks 
PVxvfRTRvkgZf9WtquEkwQ: bets $5
ljemhp25Zg+nlA9DLCIiUw: folds 
Uncalled bet ($5) returned to PVxvfRTRvkgZf9WtquEkwQ
PVxvfRTRvkgZf9WtquEkwQ collected $13.80 from pot
PVxvfRTRvkgZf9WtquEkwQ: doesn't show hand 
*** SUMMARY ***
Total pot $14.50 | Rake $0.70 
Board [7c 5h 3s 9d]
Seat 1: bXpVeaSTPBFSPJmeXxO7nw folded before Flop (didn't bet)
Seat 2: vO3QVRovWemcGMkm7ijAIA folded before Flop
Seat 3: PVxvfRTRvkgZf9WtquEkwQ collected ($13.80)
Seat 5: ghNKXUBl/H+t83JF079ZBA (button) folded before Flop (didn't bet)
Seat 6: ljemhp25Zg+nlA9DLCIiUw (small blind) folded on the Turn
Seat 7: 7je+LC5Mfs6nL8YBVh4frQ (big blind) folded before Flop
Seat 8: tLcDklc2rBORNfixyRfVfw folded before Flop (didn't bet)
Seat 9: GeMoapCKDLc4ajT0Uk9ZQw folded before Flop (didn't bet)




PokerStars Game #59941948352:  Hold'em No Limit ($0.10/$0.25) - 2009/07/01 1:51:16 ET
Table 'fIMYcWwN4/aXFJvH5Z8Ymg' 6-max Seat #2 is the button
Seat 1: DihMHaz4WNETH1bPDe13kA ($25.35 in chips) 
Seat 2: Mhj3q7cxev+XjXZxEE6/Cw ($25.95 in chips) 
Seat 3: 9bpVv1/Qh9IYtXuCtl5VtQ ($24.75 in chips) 
Seat 4: 7cx44/slbeTw+Cy7QB8Trg ($25 in chips) 
Seat 6: jp34e617tIzV8tKIWmfAbA ($28.35 in chips) 
9bpVv1/Qh9IYtXuCtl5VtQ: posts small blind $0.10
7cx44/slbeTw+Cy7QB8Trg: posts big blind $0.25
*** HOLE CARDS ***
jp34e617tIzV8tKIWmfAbA: folds 
DihMHaz4WNETH1bPDe13kA: folds 
Mhj3q7cxev+XjXZxEE6/Cw: raises $0.50 to $0.75
JppOakN7YnIDLWiLzBbtSg joins the table at seat #5 
9bpVv1/Qh9IYtXuCtl5VtQ: folds 
7cx44/slbeTw+Cy7QB8Trg: folds 
Uncalled bet ($0.50) returned to Mhj3q7cxev+XjXZxEE6/Cw
Mhj3q7cxev+XjXZxEE6/Cw collected $0.60 from pot
Mhj3q7cxev+XjXZxEE6/Cw: doesn't show hand 
*** SUMMARY ***
Total pot $0.60 | Rake $0 
Seat 1: DihMHaz4WNETH1bPDe13kA folded before Flop (didn't bet)
Seat 2: Mhj3q7cxev+XjXZxEE6/Cw (button) collected ($0.60)
Seat 3: 9bpVv1/Qh9IYtXuCtl5VtQ (small blind) folded before Flop
Seat 4: 7cx44/slbeTw+Cy7QB8Trg (big blind) folded before Flop
Seat 6: jp34e617tIzV8tKIWmfAbA folded before Flop (didn't bet)




PokerStars Game #59941948402:  Hold'em No Limit ($0.10/$0.25) - 2009/07/01 1:51:16 ET
Table '0M5QEJGOThqZwQ/sjbjXYw' 6-max Seat #5 is the button
Seat 2: /gJNBeCkWL4o85/jvlZ4BA ($32.85 in chips) 
Seat 3: 3zD3qLXT1bEffAoWGnc7wg ($25 in chips) 
Seat 5: cWc85bEzdRzpUMhRKm8pwQ ($53.05 in chips) 
Seat 6: bb63I02U6p9a5MNFa1gCiw ($23.05 in chips) 
bb63I02U6p9a5MNFa1gCiw: posts small blind $0.10
/gJNBeCkWL4o85/jvlZ4BA: posts big blind $0.25
PToTQrV0TmESDzjJftg6QQ: sits out 
*** HOLE CARDS ***
3zD3qLXT1bEffAoWGnc7wg: folds 
cWc85bEzdRzpUMhRKm8pwQ: folds 
bb63I02U6p9a5MNFa1gCiw: folds 
Uncalled bet ($0.15) returned to /gJNBeCkWL4o85/jvlZ4BA
/gJNBeCkWL4o85/jvlZ4BA collected $0.20 from pot
*** SUMMARY ***
Total pot $0.20 | Rake $0 
Seat 2: /gJNBeCkWL4o85/jvlZ4BA (big blind) collected ($0.20)
Seat 3: 3zD3qLXT1bEffAoWGnc7wg folded before Flop (didn't bet)
Seat 5: cWc85bEzdRzpUMhRKm8pwQ (button) folded before Flop (didn't bet)
Seat 6: bb63I02U6p9a5MNFa1gCiw (small blind) folded before Flop




PokerStars Game #59941948556:  Hold'em No Limit ($0.10/$0.25) - 2009/07/01 1:51:16 ET
Table '1zj0+miaIL9cvwnT/50pOA' 9-max Seat #9 is the button
Seat 1: PVxvfRTRvkgZf9WtquEkwQ ($25 in chips) 
Seat 2: HPEB+AtKw1+C/cxU0o1ciw ($40.20 in chips) 
Seat 3: dtZ84flFEi4Q+SGrHMJRDQ ($29.35 in chips) 
Seat 4: PdIasPkzm2sqZnN41ZRXOg ($5.35 in chips) 
Seat 5: 57qrNGHDvf6GhB8zVLsAtQ ($8.05 in chips) 
Seat 6: YZaC69gFrepA6oCGtu7E0w ($28.45 in chips) 
Seat 7: 6RiVTYll/5D8zICp0MRpKw ($32.10 in chips) 
Seat 8: Ihhh49x48fayPIyvl2Rsmg ($35.35 in chips) 
Seat 9: AyqFvLFzJDE7yMbXP362BA ($18.95 in chips) 
PVxvfRTRvkgZf9WtquEkwQ: posts small blind $0.10
HPEB+AtKw1+C/cxU0o1ciw: posts big blind $0.25
*** HOLE CARDS ***
dtZ84flFEi4Q+SGrHMJRDQ: folds 
PdIasPkzm2sqZnN41ZRXOg: folds 
57qrNGHDvf6GhB8zVLsAtQ: folds 
YZaC69gFrepA6oCGtu7E0w: folds 
6RiVTYll/5D8zICp0MRpKw: folds 
Ihhh49x48fayPIyvl2Rsmg: calls $0.25
AyqFvLFzJDE7yMbXP362BA: folds 
PVxvfRTRvkgZf9WtquEkwQ: calls $0.15
HPEB+AtKw1+C/cxU0o1ciw: checks 
*** FLOP *** [2d Jd 6c]
PVxvfRTRvkgZf9WtquEkwQ: bets $0.75
HPEB+AtKw1+C/cxU0o1ciw: folds 
Ihhh49x48fayPIyvl2Rsmg: calls $0.75
*** TURN *** [2d Jd 6c] [3s]
PVxvfRTRvkgZf9WtquEkwQ: checks 
Ihhh49x48fayPIyvl2Rsmg: checks 
*** RIVER *** [2d Jd 6c 3s] [Ah]
PVxvfRTRvkgZf9WtquEkwQ: checks 
Ihhh49x48fayPIyvl2Rsmg: checks 
*** SHOW DOWN ***
PVxvfRTRvkgZf9WtquEkwQ: shows [7d 6d] (a pair of Sixes)
Ihhh49x48fayPIyvl2Rsmg: shows [Jh Th] (a pair of Jacks)
Ihhh49x48fayPIyvl2Rsmg collected $2.15 from pot
*** SUMMARY ***
Total pot $2.25 | Rake $0.10 
Board [2d Jd 6c 3s Ah]
Seat 1: PVxvfRTRvkgZf9WtquEkwQ (small blind) showed [7d 6d] and lost with a pair of Sixes
Seat 2: HPEB+AtKw1+C/cxU0o1ciw (big blind) folded on the Flop
Seat 3: dtZ84flFEi4Q+SGrHMJRDQ folded before Flop (didn't bet)
Seat 4: PdIasPkzm2sqZnN41ZRXOg folded before Flop (didn't bet)
Seat 5: 57qrNGHDvf6GhB8zVLsAtQ folded before Flop (didn't bet)
Seat 6: YZaC69gFrepA6oCGtu7E0w folded before Flop (didn't bet)
Seat 7: 6RiVTYll/5D8zICp0MRpKw folded before Flop (didn't bet)
Seat 8: Ihhh49x48fayPIyvl2Rsmg showed [Jh Th] and won ($2.15) with a pair of Jacks
Seat 9: AyqFvLFzJDE7yMbXP362BA (button) folded before Flop (didn't bet)




PokerStars Game #59941948860:  Hold'em No Limit ($0.10/$0.25) - 2009/07/01 1:51:17 ET
Table '50f2Xa1b1jp6cfdTAgXFIg' 9-max Seat #5 is the button
Seat 1: E0iYnEVO2ho7dH3QcCjw7g ($19.65 in chips) 
Seat 3: RSojRXQHk0IRANbJYopT9g ($24.45 in chips) 
Seat 4: ghNKXUBl/H+t83JF079ZBA ($27 in chips) 
Seat 5: C1w4aCCgQVVSgNijoEahAg ($15.50 in chips) 
Seat 6: tLcDklc2rBORNfixyRfVfw ($27.25 in chips) 
Seat 7: w1ukf8uPa4+WH561TtVRxA ($25 in chips) 
Seat 8: x+W5+3qsdY4Iszf0hoH+Aw ($13.80 in chips) 
Seat 9: gehe91e0IyVT0QU/XBkEyg ($25.75 in chips) 
tLcDklc2rBORNfixyRfVfw: posts small blind $0.10
w1ukf8uPa4+WH561TtVRxA: posts big blind $0.25
*** HOLE CARDS ***
x+W5+3qsdY4Iszf0hoH+Aw: calls $0.25
gehe91e0IyVT0QU/XBkEyg: folds 
E0iYnEVO2ho7dH3QcCjw7g: folds 
RSojRXQHk0IRANbJYopT9g: raises $0.50 to $0.75
ghNKXUBl/H+t83JF079ZBA: folds 
C1w4aCCgQVVSgNijoEahAg: folds 
tLcDklc2rBORNfixyRfVfw: folds 
w1ukf8uPa4+WH561TtVRxA: calls $0.50
x+W5+3qsdY4Iszf0hoH+Aw: calls $0.50
*** FLOP *** [5d 3d Qd]
w1ukf8uPa4+WH561TtVRxA: checks 
x+W5+3qsdY4Iszf0hoH+Aw: checks 
RSojRXQHk0IRANbJYopT9g: bets $0.75
w1ukf8uPa4+WH561TtVRxA: folds 
x+W5+3qsdY4Iszf0hoH+Aw: folds 
Uncalled bet ($0.75) returned to RSojRXQHk0IRANbJYopT9g
RSojRXQHk0IRANbJYopT9g collected $2.25 from pot
RSojRXQHk0IRANbJYopT9g: doesn't show hand 
*** SUMMARY ***
Total pot $2.35 | Rake $0.10 
Board [5d 3d Qd]
Seat 1: E0iYnEVO2ho7dH3QcCjw7g folded before Flop (didn't bet)
Seat 3: RSojRXQHk0IRANbJYopT9g collected ($2.25)
Seat 4: ghNKXUBl/H+t83JF079ZBA folded before Flop (didn't bet)
Seat 5: C1w4aCCgQVVSgNijoEahAg (button) folded before Flop (didn't bet)
Seat 6: tLcDklc2rBORNfixyRfVfw (small blind) folded before Flop
Seat 7: w1ukf8uPa4+WH561TtVRxA (big blind) folded on the Flop
Seat 8: x+W5+3qsdY4Iszf0hoH+Aw folded on the Flop
Seat 9: gehe91e0IyVT0QU/XBkEyg folded before Flop (didn't bet)




PokerStars Game #59941949174:  Hold'em No Limit ($0.10/$0.25) - 2009/07/01 1:51:17 ET
Table 'dZNBGqFYSwfOVZvDJ4VjIQ' 6-max Seat #6 is the button
Seat 1: v+QfkGiuj9bgtuNoVnDO8w ($37.75 in chips) 
Seat 2: 3zD3qLXT1bEffAoWGnc7wg ($27.95 in chips) 
Seat 3: kyRaCIljYA6l33lSKQfNsg ($29.35 in chips) 
Seat 5: +ZlnqPoP3Hg4BIUxDfKd/A ($27.05 in chips) 
Seat 6: ypmjhffk/YHGc51wgVXUTw ($31.25 in chips) 
v+QfkGiuj9bgtuNoVnDO8w: posts small blind $0.10
3zD3qLXT1bEffAoWGnc7wg: posts big blind $0.25
GbCVUNssQ7mqsPWr7J4d3w: sits out 
*** HOLE CARDS ***
kyRaCIljYA6l33lSKQfNsg: folds 
+ZlnqPoP3Hg4BIUxDfKd/A: raises $0.75 to $1
ypmjhffk/YHGc51wgVXUTw: folds 
v+QfkGiuj9bgtuNoVnDO8w: folds 
3zD3qLXT1bEffAoWGnc7wg: folds 
Uncalled bet ($0.75) returned to +ZlnqPoP3Hg4BIUxDfKd/A
+ZlnqPoP3Hg4BIUxDfKd/A collected $0.60 from pot
+ZlnqPoP3Hg4BIUxDfKd/A: doesn't show hand 
*** SUMMARY ***
Total pot $0.60 | Rake $0 
Seat 1: v+QfkGiuj9bgtuNoVnDO8w (small blind) folded before Flop
Seat 2: 3zD3qLXT1bEffAoWGnc7wg (big blind) folded before Flop
Seat 3: kyRaCIljYA6l33lSKQfNsg folded before Flop (didn't bet)
Seat 5: +ZlnqPoP3Hg4BIUxDfKd/A collected ($0.60)
Seat 6: ypmjhffk/YHGc51wgVXUTw (button) folded before Flop (didn't bet)




PokerStars Game #59941949106:  Hold'em No Limit ($0.10/$0.25) - 2009/07/01 1:51:17 ET
Table 'MRfAiS/4JSfnUDlCcZo0wAhfHe8uKeSJMyWAjSdM7ROQx Seat #5 is the button
Seat 1: 48oT5xFI+5CHUJlfoGrE4w ($29.90 in chips) 
Seat 2: /gJNBeCkWL4o85/jvlZ4BA ($25.85 in chips) 
Seat 4: b4wRQV3APH8irVk6bUFe2Q ($37.10 in chips) 
Seat 5: Q1uciOZPBR/WkAlqa6cL4A ($27.85 in chips) 
Seat 6: df01R5ThvHspD8FgKmaDvQ ($24.75 in chips) 
df01R5ThvHspD8FgKmaDvQ: posts small blind $0.10
48oT5xFI+5CHUJlfoGrE4w: posts big blind $0.25
*** HOLE CARDS ***
/gJNBeCkWL4o85/jvlZ4BA: folds 
b4wRQV3APH8irVk6bUFe2Q: folds 
Q1uciOZPBR/WkAlqa6cL4A: folds 
df01R5ThvHspD8FgKmaDvQ: calls $0.15
48oT5xFI+5CHUJlfoGrE4w: checks 
*** FLOP *** [9h 3c 8s]
df01R5ThvHspD8FgKmaDvQ: checks 
48oT5xFI+5CHUJlfoGrE4w: checks 
*** TURN *** [9h 3c 8s] [9s]
df01R5ThvHspD8FgKmaDvQ: bets $0.25
48oT5xFI+5CHUJlfoGrE4w: calls $0.25
*** RIVER *** [9h 3c 8s 9s] [Jc]
df01R5ThvHspD8FgKmaDvQ: bets $1.50
48oT5xFI+5CHUJlfoGrE4w: folds 
Uncalled bet ($1.50) returned to df01R5ThvHspD8FgKmaDvQ
df01R5ThvHspD8FgKmaDvQ collected $0.95 from pot
*** SUMMARY ***
Total pot $1 | Rake $0.05 
Board [9h 3c 8s 9s Jc]
Seat 1: 48oT5xFI+5CHUJlfoGrE4w (big blind) folded on the River
Seat 2: /gJNBeCkWL4o85/jvlZ4BA folded before Flop (didn't bet)
Seat 4: b4wRQV3APH8irVk6bUFe2Q folded before Flop (didn't bet)
Seat 5: Q1uciOZPBR/WkAlqa6cL4A (button) folded before Flop (didn't bet)
Seat 6: df01R5ThvHspD8FgKmaDvQ (small blind) collected ($0.95)




PokerStars Game #59941949110:  Hold'em No Limit ($0.10/$0.25) - 2009/07/01 1:51:17 ET
Table 'Loy/olZ5qoDOSvX4UTujGg' 6-max Seat #5 is the button
Seat 1: HipgaJhkN4ie/tTw4dK3Ug ($11.10 in chips) 
Seat 2: 4z7mPbMLNp4TezHXin63Vw ($14.45 in chips) 
Seat 3: 32YL2ZEp8NT4JB2RVM9euQ ($15 in chips) 
Seat 4: /gJNBeCkWL4o85/jvlZ4BA ($30.15 in chips) 
Seat 5: Ar4vsUIUfJ7gbYh1c1m59g ($18.90 in chips) 
Seat 6: qGHGf/553gQnDoklMRe3tg ($24.90 in chips) 
qGHGf/553gQnDoklMRe3tg: posts small blind $0.10
HipgaJhkN4ie/tTw4dK3Ug: posts big blind $0.25
*** HOLE CARDS ***
4z7mPbMLNp4TezHXin63Vw: calls $0.25
32YL2ZEp8NT4JB2RVM9euQ: folds 
/gJNBeCkWL4o85/jvlZ4BA: raises $1 to $1.25
Ar4vsUIUfJ7gbYh1c1m59g: folds 
qGHGf/553gQnDoklMRe3tg: folds 
HipgaJhkN4ie/tTw4dK3Ug: folds 
4z7mPbMLNp4TezHXin63Vw: calls $1
*** FLOP *** [Ah 9h Kc]
4z7mPbMLNp4TezHXin63Vw: checks 
/gJNBeCkWL4o85/jvlZ4BA: bets $1.50
4z7mPbMLNp4TezHXin63Vw: calls $1.50
*** TURN *** [Ah 9h Kc] [2h]
4z7mPbMLNp4TezHXin63Vw: checks 
/gJNBeCkWL4o85/jvlZ4BA: checks 
*** RIVER *** [Ah 9h Kc 2h] [8s]
4z7mPbMLNp4TezHXin63Vw: bets $1
/gJNBeCkWL4o85/jvlZ4BA: calls $1
*** SHOW DOWN ***
4z7mPbMLNp4TezHXin63Vw: shows [5s As] (a pair of Aces)
/gJNBeCkWL4o85/jvlZ4BA: mucks hand 
4z7mPbMLNp4TezHXin63Vw collected $7.50 from pot
*** SUMMARY ***
Total pot $7.85 | Rake $0.35 
Board [Ah 9h Kc 2h 8s]
Seat 1: HipgaJhkN4ie/tTw4dK3Ug (big blind) folded before Flop
Seat 2: 4z7mPbMLNp4TezHXin63Vw showed [5s As] and won ($7.50) with a pair of Aces
Seat 3: 32YL2ZEp8NT4JB2RVM9euQ folded before Flop (didn't bet)
Seat 4: /gJNBeCkWL4o85/jvlZ4BA mucked
Seat 5: Ar4vsUIUfJ7gbYh1c1m59g (button) folded before Flop (didn't bet)
Seat 6: qGHGf/553gQnDoklMRe3tg (small blind) folded before Flop




PokerStars Game #59941948932:  Hold'em No Limit ($0.10/$0.25) - 2009/07/01 1:51:17 ET
Table 'i93c3z9RLowvuJTKA2F4Jg' 6-max Seat #4 is the button
Seat 1: tbSZq5LHglyHk61mH9eDBw ($29.60 in chips) 
Seat 2: TSmua8tGK3sTbwi0ynrW9Q ($25.95 in chips) 
Seat 3: v8m8XHovI5tqEA9mvplDSw ($26.45 in chips) 
Seat 4: o86X2Q5GEDU3uP9oj1iFZA ($35.75 in chips) 
Seat 5: TI/C5Q+DEl4fLR3AofwYdg ($14.50 in chips) 
Seat 6: FpN4KbLjlyRRKiVaQcoLqA ($20.60 in chips) 
TI/C5Q+DEl4fLR3AofwYdg: posts small blind $0.10
FpN4KbLjlyRRKiVaQcoLqA: posts big blind $0.25
*** HOLE CARDS ***
tbSZq5LHglyHk61mH9eDBw: folds 
TSmua8tGK3sTbwi0ynrW9Q: folds 
v8m8XHovI5tqEA9mvplDSw: raises $0.50 to $0.75
o86X2Q5GEDU3uP9oj1iFZA: calls $0.75
TI/C5Q+DEl4fLR3AofwYdg: folds 
FpN4KbLjlyRRKiVaQcoLqA: folds 
*** FLOP *** [6h 7d 3c]
v8m8XHovI5tqEA9mvplDSw: checks 
o86X2Q5GEDU3uP9oj1iFZA: checks 
*** TURN *** [6h 7d 3c] [6d]
v8m8XHovI5tqEA9mvplDSw: bets $0.75
o86X2Q5GEDU3uP9oj1iFZA: calls $0.75
*** RIVER *** [6h 7d 3c 6d] [2s]
v8m8XHovI5tqEA9mvplDSw: checks 
o86X2Q5GEDU3uP9oj1iFZA: bets $2.50
v8m8XHovI5tqEA9mvplDSw: folds 
Uncalled bet ($2.50) returned to o86X2Q5GEDU3uP9oj1iFZA
o86X2Q5GEDU3uP9oj1iFZA collected $3.20 from pot
*** SUMMARY ***
Total pot $3.35 | Rake $0.15 
Board [6h 7d 3c 6d 2s]
Seat 1: tbSZq5LHglyHk61mH9eDBw folded before Flop (didn't bet)
Seat 2: TSmua8tGK3sTbwi0ynrW9Q folded before Flop (didn't bet)
Seat 3: v8m8XHovI5tqEA9mvplDSw folded on the River
Seat 4: o86X2Q5GEDU3uP9oj1iFZA (button) collected ($3.20)
Seat 5: TI/C5Q+DEl4fLR3AofwYdg (small blind) folded before Flop
Seat 6: FpN4KbLjlyRRKiVaQcoLqA (big blind) folded before Flop




PokerStars Game #59941948816:  Hold'em No Limit ($0.10/$0.25) - 2009/07/01 1:51:17 ET
Table 'QegsWX65l3n/K0A8XB78yg' 6-max Seat #2 is the button
Seat 1: p6adJRMXMBLr+xtQzqazIQ ($12 in chips) 
Seat 2: GC/9yVD59DUCX7hUI7gcLw ($55.50 in chips) 
Seat 3: iIgNoBh+3/Ix1/fLsg+HuA ($5.75 in chips) 
Seat 4: epAUIB7h2FJXzUPRIvSkRA ($25 in chips) 
Seat 5: QqiZLFrN8iOUT/GHw7ztOA ($28.95 in chips) 
Seat 6: 5PWs02z65jSO5pr/M6wx/w ($11.70 in chips) 
iIgNoBh+3/Ix1/fLsg+HuA: posts small blind $0.10
epAUIB7h2FJXzUPRIvSkRA: posts big blind $0.25
*** HOLE CARDS ***
QqiZLFrN8iOUT/GHw7ztOA: folds 
5PWs02z65jSO5pr/M6wx/w: folds 
p6adJRMXMBLr+xtQzqazIQ: folds 
GC/9yVD59DUCX7hUI7gcLw: folds 
iIgNoBh+3/Ix1/fLsg+HuA: raises $0.50 to $0.75
epAUIB7h2FJXzUPRIvSkRA: folds 
Uncalled bet ($0.50) returned to iIgNoBh+3/Ix1/fLsg+HuA
iIgNoBh+3/Ix1/fLsg+HuA collected $0.50 from pot
iIgNoBh+3/Ix1/fLsg+HuA: doesn't show hand 
*** SUMMARY ***
Total pot $0.50 | Rake $0 
Seat 1: p6adJRMXMBLr+xtQzqazIQ folded before Flop (didn't bet)
Seat 2: GC/9yVD59DUCX7hUI7gcLw (button) folded before Flop (didn't bet)
Seat 3: iIgNoBh+3/Ix1/fLsg+HuA (small blind) collected ($0.50)
Seat 4: epAUIB7h2FJXzUPRIvSkRA (big blind) folded before Flop
Seat 5: QqiZLFrN8iOUT/GHw7ztOA folded before Flop (didn't bet)
Seat 6: 5PWs02z65jSO5pr/M6wx/w folded before Flop (didn't bet)




PokerStars Game #59941949128:  Hold'em No Limit ($0.10/$0.25) - 2009/07/01 1:51:17 ET
Table 'Xi38lWH8L2JHRAsKYVX8Qg' 6-max Seat #5 is the button
Seat 1: shP7DFAtX7gXcgMJX/OmRQ ($24.65 in chips) 
Seat 2: VOmI0x4dDPnTESZd5B4d1Q ($8.40 in chips) 
Seat 3: 6DwBRH+xZ12AAZmeAg+aXw ($31.20 in chips) 
Seat 4: kG34n23qFQA3nzdOJTQ1dA ($24.05 in chips) 
Seat 5: 79ID/ub1Pt/mDpCprVmOoA ($76.15 in chips) 
Seat 6: kyRaCIljYA6l33lSKQfNsg ($30.20 in chips) 
kyRaCIljYA6l33lSKQfNsg: posts small blind $0.10
shP7DFAtX7gXcgMJX/OmRQ: posts big blind $0.25
*** HOLE CARDS ***
VOmI0x4dDPnTESZd5B4d1Q: folds 
6DwBRH+xZ12AAZmeAg+aXw: folds 
kG34n23qFQA3nzdOJTQ1dA: folds 
79ID/ub1Pt/mDpCprVmOoA: folds 
kyRaCIljYA6l33lSKQfNsg: folds 
Uncalled bet ($0.15) returned to shP7DFAtX7gXcgMJX/OmRQ
shP7DFAtX7gXcgMJX/OmRQ collected $0.20 from pot
shP7DFAtX7gXcgMJX/OmRQ: doesn't show hand 
*** SUMMARY ***
Total pot $0.20 | Rake $0 
Seat 1: shP7DFAtX7gXcgMJX/OmRQ (big blind) collected ($0.20)
Seat 2: VOmI0x4dDPnTESZd5B4d1Q folded before Flop (didn't bet)
Seat 3: 6DwBRH+xZ12AAZmeAg+aXw folded before Flop (didn't bet)
Seat 4: kG34n23qFQA3nzdOJTQ1dA folded before Flop (didn't bet)
Seat 5: 79ID/ub1Pt/mDpCprVmOoA (button) folded before Flop (didn't bet)
Seat 6: kyRaCIljYA6l33lSKQfNsg (small blind) folded before Flop




PokerStars Game #59941948798:  Hold'em No Limit ($0.10/$0.25) - 2009/07/01 1:51:17 ET
Table 'C47I7CmrmFr8Oo7wOovVwQ' 6-max Seat #6 is the button
Seat 1: aKCh+0w6BCOX3sJAdIVLMw ($4.75 in chips) 
Seat 2: 8JTm/CXBn3+kuQgcUOgPkw ($24.75 in chips) 
Seat 3: H+8eOP3XJHXjACRDTiIHTQ ($21.70 in chips) 
Seat 4: yY5JuFtDfXWRaZlVby4LLw ($9.15 in chips) 
Seat 5: or309yYY9Y9bfFWtrB0yUg ($5.10 in chips) 
Seat 6: pD7ri5wL3vsa6S1ulMYQmQ ($26.60 in chips) 
aKCh+0w6BCOX3sJAdIVLMw: posts small blind $0.10
8JTm/CXBn3+kuQgcUOgPkw: posts big blind $0.25
*** HOLE CARDS ***
H+8eOP3XJHXjACRDTiIHTQ: folds 
yY5JuFtDfXWRaZlVby4LLw: raises $0.25 to $0.50
or309yYY9Y9bfFWtrB0yUg: folds 
pD7ri5wL3vsa6S1ulMYQmQ: folds 
H+8eOP3XJHXjACRDTiIHTQ leaves the table
aKCh+0w6BCOX3sJAdIVLMw: folds 
8JTm/CXBn3+kuQgcUOgPkw: folds 
Uncalled bet ($0.25) returned to yY5JuFtDfXWRaZlVby4LLw
yY5JuFtDfXWRaZlVby4LLw collected $0.60 from pot
*** SUMMARY ***
Total pot $0.60 | Rake $0 
Seat 1: aKCh+0w6BCOX3sJAdIVLMw (small blind) folded before Flop
Seat 2: 8JTm/CXBn3+kuQgcUOgPkw (big blind) folded before Flop
Seat 3: H+8eOP3XJHXjACRDTiIHTQ folded before Flop (didn't bet)
Seat 4: yY5JuFtDfXWRaZlVby4LLw collected ($0.60)
Seat 5: or309yYY9Y9bfFWtrB0yUg folded before Flop (didn't bet)
Seat 6: pD7ri5wL3vsa6S1ulMYQmQ (button) folded before Flop (didn't bet)




PokerStars Game #59941949092:  Hold'em No Limit ($0.10/$0.25) - 2009/07/01 1:51:17 ET
Table '1HT8bEDpLPhOXxmqMtzF8w' 9-max Seat #8 is the button
Seat 1: YkkKQUDI0iWatY4h0WWaAQ ($12.65 in chips) 
Seat 2: r6hsffOo1iKmaPYKwAZmFw ($29 in chips) 
Seat 3: oLa/tXLfSLLB28mcLGrxcg ($23.50 in chips) 
Seat 6: bXpVeaSTPBFSPJmeXxO7nw ($5.90 in chips) 
Seat 7: PMhmqYBPHOAXjH25lRz69g ($16.75 in chips) 
Seat 8: ghNKXUBl/H+t83JF079ZBA ($33.30 in chips) 
Seat 9: Z9W7+g1WMhhZDi7DwGbCFA ($5 in chips) 
Z9W7+g1WMhhZDi7DwGbCFA: posts small blind $0.10
YkkKQUDI0iWatY4h0WWaAQ: posts big blind $0.25
*** HOLE CARDS ***
r6hsffOo1iKmaPYKwAZmFw: folds 
z5GxcHlYz/GSz6W2uFiTtg has returned
oLa/tXLfSLLB28mcLGrxcg: folds 
bXpVeaSTPBFSPJmeXxO7nw: folds 
PMhmqYBPHOAXjH25lRz69g: raises $0.50 to $0.75
ghNKXUBl/H+t83JF079ZBA: folds 
Z9W7+g1WMhhZDi7DwGbCFA: folds 
YkkKQUDI0iWatY4h0WWaAQ: folds 
Uncalled bet ($0.50) returned to PMhmqYBPHOAXjH25lRz69g
PMhmqYBPHOAXjH25lRz69g collected $0.60 from pot
PMhmqYBPHOAXjH25lRz69g: doesn't show hand 
*** SUMMARY ***
Total pot $0.60 | Rake $0 
Seat 1: YkkKQUDI0iWatY4h0WWaAQ (big blind) folded before Flop
Seat 2: r6hsffOo1iKmaPYKwAZmFw folded before Flop (didn't bet)
Seat 3: oLa/tXLfSLLB28mcLGrxcg folded before Flop (didn't bet)
Seat 6: bXpVeaSTPBFSPJmeXxO7nw folded before Flop (didn't bet)
Seat 7: PMhmqYBPHOAXjH25lRz69g collected ($0.60)
Seat 8: ghNKXUBl/H+t83JF079ZBA (button) folded before Flop (didn't bet)
Seat 9: Z9W7+g1WMhhZDi7DwGbCFA (small blind) folded before Flop




PokerStars Game #59941949738:  Hold'em No Limit ($0.10/$0.25) - 2009/07/01 1:51:18 ET
Table 'O6cwjhrMn9pfzx1Ngn5zkQ' 6-max Seat #1 is the button
Seat 1: LJI7A1YgDM7hgh7o56+ReQ ($25 in chips) 
Seat 2: 8CPg15X6IHYR1pWm9ha1Sw ($25 in chips) 
Seat 3: EE16Ua5b1HSsYej5zeXOlA ($26.15 in chips) 
Seat 4: mfrkWA3PTeYPkbO6hi98Aw ($24.85 in chips) 
Seat 5: niLn0xUVlqh8If80xRjzCA ($28.35 in chips) 
Seat 6: 4TM16KVgEiQpLi4bVVWbVQ ($36.70 in chips) 
8CPg15X6IHYR1pWm9ha1Sw: posts small blind $0.10
EE16Ua5b1HSsYej5zeXOlA: posts big blind $0.25
*** HOLE CARDS ***
mfrkWA3PTeYPkbO6hi98Aw: raises $0.75 to $1
niLn0xUVlqh8If80xRjzCA: folds 
4TM16KVgEiQpLi4bVVWbVQ said, "you are too good to be true new born!!"
4TM16KVgEiQpLi4bVVWbVQ: folds 
LJI7A1YgDM7hgh7o56+ReQ: folds 
8CPg15X6IHYR1pWm9ha1Sw: folds 
EE16Ua5b1HSsYej5zeXOlA: calls $0.75
*** FLOP *** [Ac 8s 4d]
EE16Ua5b1HSsYej5zeXOlA: checks 
mfrkWA3PTeYPkbO6hi98Aw: bets $1.50
EE16Ua5b1HSsYej5zeXOlA: calls $1.50
*** TURN *** [Ac 8s 4d] [8d]
EE16Ua5b1HSsYej5zeXOlA: checks 
mfrkWA3PTeYPkbO6hi98Aw: bets $3
EE16Ua5b1HSsYej5zeXOlA: calls $3
*** RIVER *** [Ac 8s 4d 8d] [Th]
EE16Ua5b1HSsYej5zeXOlA: bets $5.50
mfrkWA3PTeYPkbO6hi98Aw: raises $5.50 to $11
EE16Ua5b1HSsYej5zeXOlA: calls $5.50
*** SHOW DOWN ***
mfrkWA3PTeYPkbO6hi98Aw: shows [8c 9c] (three of a kind, Eights)
EE16Ua5b1HSsYej5zeXOlA: mucks hand 
mfrkWA3PTeYPkbO6hi98Aw collected $31.50 from pot
*** SUMMARY ***
Total pot $33.10 | Rake $1.60 
Board [Ac 8s 4d 8d Th]
Seat 1: LJI7A1YgDM7hgh7o56+ReQ (button) folded before Flop (didn't bet)
Seat 2: 8CPg15X6IHYR1pWm9ha1Sw (small blind) folded before Flop
Seat 3: EE16Ua5b1HSsYej5zeXOlA (big blind) mucked
Seat 4: mfrkWA3PTeYPkbO6hi98Aw showed [8c 9c] and won ($31.50) with three of a kind, Eights
Seat 5: niLn0xUVlqh8If80xRjzCA folded before Flop (didn't bet)
Seat 6: 4TM16KVgEiQpLi4bVVWbVQ folded before Flop (didn't bet)




PokerStars Game #59941949500:  Hold'em No Limit ($0.10/$0.25) - 2009/07/01 1:51:18 ET
Table 'VQNfcI8vTBCTvRfd3veTLQ' 6-max Seat #6 is the button
Seat 1: QiL+lEgEWwy21jk/ltaRLg ($13.25 in chips) 
Seat 2: 79ID/ub1Pt/mDpCprVmOoA ($31.25 in chips) 
Seat 3: LtASJ9OlkqGrrUKGQlpGAw ($11.25 in chips) 
Seat 4: QIWnfLSqfMcoFfdDe5LZPg ($41.05 in chips) 
Seat 5: gX2vbKwS/8zZPENAWB7hxQ ($25.25 in chips) 
Seat 6: LJI7A1YgDM7hgh7o56+ReQ ($27.35 in chips) 
QiL+lEgEWwy21jk/ltaRLg: posts small blind $0.10
79ID/ub1Pt/mDpCprVmOoA: posts big blind $0.25
*** HOLE CARDS ***
LtASJ9OlkqGrrUKGQlpGAw: calls $0.25
QIWnfLSqfMcoFfdDe5LZPg: folds 
gX2vbKwS/8zZPENAWB7hxQ: folds 
LJI7A1YgDM7hgh7o56+ReQ: folds 
QiL+lEgEWwy21jk/ltaRLg: folds 
79ID/ub1Pt/mDpCprVmOoA: checks 
*** FLOP *** [8d Qd 4h]
79ID/ub1Pt/mDpCprVmOoA: checks 
LtASJ9OlkqGrrUKGQlpGAw: checks 
*** TURN *** [8d Qd 4h] [2s]
79ID/ub1Pt/mDpCprVmOoA: checks 
LtASJ9OlkqGrrUKGQlpGAw: checks 
*** RIVER *** [8d Qd 4h 2s] [Tc]
79ID/ub1Pt/mDpCprVmOoA: bets $0.50
LtASJ9OlkqGrrUKGQlpGAw: folds 
Uncalled bet ($0.50) returned to 79ID/ub1Pt/mDpCprVmOoA
79ID/ub1Pt/mDpCprVmOoA collected $0.60 from pot
79ID/ub1Pt/mDpCprVmOoA: doesn't show hand 
*** SUMMARY ***
Total pot $0.60 | Rake $0 
Board [8d Qd 4h 2s Tc]
Seat 1: QiL+lEgEWwy21jk/ltaRLg (small blind) folded before Flop
Seat 2: 79ID/ub1Pt/mDpCprVmOoA (big blind) collected ($0.60)
Seat 3: LtASJ9OlkqGrrUKGQlpGAw folded on the River
Seat 4: QIWnfLSqfMcoFfdDe5LZPg folded before Flop (didn't bet)
Seat 5: gX2vbKwS/8zZPENAWB7hxQ folded before Flop (didn't bet)
Seat 6: LJI7A1YgDM7hgh7o56+ReQ (button) folded before Flop (didn't bet)




PokerStars Game #59941949732:  Hold'em No Limit ($0.10/$0.25) - 2009/07/01 1:51:18 ET
Table 'LwnjzXstPtSrqrV/oDpnXQ' 9-max Seat #2 is the button
Seat 1: 9YN2IkT2JYYKFErZtZvCtA ($21.55 in chips) 
Seat 2: uLP/lYn7oKq9xCChBXsXxw ($26.15 in chips) 
Seat 3: 7je+LC5Mfs6nL8YBVh4frQ ($3.55 in chips) 
Seat 4: CmngQmkKTp8tkl6GMRTl6w ($8.75 in chips) 
Seat 5: Th3FldXKQW6hWVVPahaoOQ ($26.25 in chips) 
Seat 6: ljemhp25Zg+nlA9DLCIiUw ($40 in chips) 
Seat 7: c/Dw/6HyqldTzIRodAIZmg ($13.40 in chips) 
Seat 8: ShXPHWfjhfmAwLgDdm6bRQ ($11.30 in chips) 
Seat 9: q6WfTUAD9mowIP63ASq2Dgz/khFDKGihQjwgoiKKPOeg15 in chips) 
7je+LC5Mfs6nL8YBVh4frQ: posts small blind $0.10
CmngQmkKTp8tkl6GMRTl6w: posts big blind $0.25
*** HOLE CARDS ***
Th3FldXKQW6hWVVPahaoOQ: folds 
ljemhp25Zg+nlA9DLCIiUw: folds 
c/Dw/6HyqldTzIRodAIZmg: folds 
ShXPHWfjhfmAwLgDdm6bRQ: calls $0.25
q6WfTUAD9mowIP63ASq2Dgz/khFDKGihQjwgoiKKPOegs 
9YN2IkT2JYYKFErZtZvCtA: folds 
uLP/lYn7oKq9xCChBXsXxw: folds 
7je+LC5Mfs6nL8YBVh4frQ: folds 
CmngQmkKTp8tkl6GMRTl6w: checks 
*** FLOP *** [8h 4s 9d]
CmngQmkKTp8tkl6GMRTl6w: checks 
ShXPHWfjhfmAwLgDdm6bRQ: checks 
*** TURN *** [8h 4s 9d] [5s]
CmngQmkKTp8tkl6GMRTl6w: checks 
ShXPHWfjhfmAwLgDdm6bRQ: bets $0.50
CmngQmkKTp8tkl6GMRTl6w: calls $0.50
*** RIVER *** [8h 4s 9d 5s] [Qh]
CmngQmkKTp8tkl6GMRTl6w: checks 
ShXPHWfjhfmAwLgDdm6bRQ: bets $1
CmngQmkKTp8tkl6GMRTl6w: calls $1
*** SHOW DOWN ***
ShXPHWfjhfmAwLgDdm6bRQ: shows [5h 5c] (three of a kind, Fives)
CmngQmkKTp8tkl6GMRTl6w: mucks hand 
ShXPHWfjhfmAwLgDdm6bRQ collected $3.45 from pot
*** SUMMARY ***
Total pot $3.60 | Rake $0.15 
Board [8h 4s 9d 5s Qh]
Seat 1: 9YN2IkT2JYYKFErZtZvCtA folded before Flop (didn't bet)
Seat 2: uLP/lYn7oKq9xCChBXsXxw (button) folded before Flop (didn't bet)
Seat 3: 7je+LC5Mfs6nL8YBVh4frQ (small blind) folded before Flop
Seat 4: CmngQmkKTp8tkl6GMRTl6w (big blind) mucked
Seat 5: Th3FldXKQW6hWVVPahaoOQ folded before Flop (didn't bet)
Seat 6: ljemhp25Zg+nlA9DLCIiUw folded before Flop (didn't bet)
Seat 7: c/Dw/6HyqldTzIRodAIZmg folded before Flop (didn't bet)
Seat 8: ShXPHWfjhfmAwLgDdm6bRQ showed [5h 5c] and won ($3.45) with three of a kind, Fives
Seat 9: q6WfTUAD9mowIP63ASq2Dgz/khFDKGihQjwgoiKKPOegd before Flop (didn't bet)




PokerStars Game #59941949650:  Hold'em No Limit ($0.10/$0.25) - 2009/07/01 1:51:18 ET
Table 'QzXakDK7ZHNjgIpoUFGSKQ' 9-max Seat #7 is the button
Seat 1: w1ukf8uPa4+WH561TtVRxA ($25 in chips) 
Seat 2: QEbIGci+itdw+re8RM5fZA ($25 in chips) 
Seat 3: eK8qa6EPcH2zhtbmWSvc9g ($25.30 in chips) 
Seat 4: 12pxJGeALcKLTBryE6kFxA ($14.50 in chips) 
Seat 5: MtVtHDqIJTyUcXkRBBDIVA ($31.20 in chips) 
Seat 6: gehe91e0IyVT0QU/XBkEyg ($25.75 in chips) 
Seat 7: wGigCmBR/9XWkPpvYos3aQ ($27.95 in chips) 
Seat 8: Z9W7+g1WMhhZDi7DwGbCFA ($5 in chips) 
Seat 9: lwrOE80tuooHfIBx/4LUSw ($25.70 in chips) 
Z9W7+g1WMhhZDi7DwGbCFA: posts small blind $0.10
lwrOE80tuooHfIBx/4LUSw: posts big blind $0.25
*** HOLE CARDS ***
w1ukf8uPa4+WH561TtVRxA: folds 
QEbIGci+itdw+re8RM5fZA: folds 
eK8qa6EPcH2zhtbmWSvc9g: folds 
12pxJGeALcKLTBryE6kFxA: folds 
MtVtHDqIJTyUcXkRBBDIVA: folds 
gehe91e0IyVT0QU/XBkEyg: folds 
wGigCmBR/9XWkPpvYos3aQ: raises $0.65 to $0.90
Z9W7+g1WMhhZDi7DwGbCFA: folds 
lwrOE80tuooHfIBx/4LUSw: calls $0.65
*** FLOP *** [2s 9c 2c]
lwrOE80tuooHfIBx/4LUSw: checks 
wGigCmBR/9XWkPpvYos3aQ: bets $1.50
lwrOE80tuooHfIBx/4LUSw: folds 
Uncalled bet ($1.50) returned to wGigCmBR/9XWkPpvYos3aQ
wGigCmBR/9XWkPpvYos3aQ collected $1.85 from pot
wGigCmBR/9XWkPpvYos3aQ: doesn't show hand 
*** SUMMARY ***
Total pot $1.90 | Rake $0.05 
Board [2s 9c 2c]
Seat 1: w1ukf8uPa4+WH561TtVRxA folded before Flop (didn't bet)
Seat 2: QEbIGci+itdw+re8RM5fZA folded before Flop (didn't bet)
Seat 3: eK8qa6EPcH2zhtbmWSvc9g folded before Flop (didn't bet)
Seat 4: 12pxJGeALcKLTBryE6kFxA folded before Flop (didn't bet)
Seat 5: MtVtHDqIJTyUcXkRBBDIVA folded before Flop (didn't bet)
Seat 6: gehe91e0IyVT0QU/XBkEyg folded before Flop (didn't bet)
Seat 7: wGigCmBR/9XWkPpvYos3aQ (button) collected ($1.85)
Seat 8: Z9W7+g1WMhhZDi7DwGbCFA (small blind) folded before Flop
Seat 9: lwrOE80tuooHfIBx/4LUSw (big blind) folded on the Flop




PokerStars Game #59941949600:  Hold'em No Limit ($0.10/$0.25) - 2009/07/01 1:51:18 ET
Table 'WEMI3Mtn7dGARDbgNrKibgoG007Tb0LYbfANo6QWd16wx Seat #1 is the button
Seat 1: DiSvPC2iudwL5j9u6Huyww ($46.30 in chips) 
Seat 2: zDrucyjVn5aeekNEc3cJrA ($14.50 in chips) 
Seat 3: pN3IHvAKm2fz+sTRARTcrg ($25 in chips) 
Seat 4: zgi+EUykT/pZQpoUG6+oEg ($5 in chips) 
Seat 5: 8f0dtuUGqDbgE6up1lQAlg ($4.75 in chips) 
Seat 6: yqkowiRWZ6NvRN9UUkYIlA ($5 in chips) 
Seat 7: Mh2r9hTeTEDnh19sRZtW3g ($5 in chips) 
Seat 8: q4cNXFZGNhLfrTyVrIy6Mg ($15.80 in chips) 
Seat 9: EVqHvqty1ZsuvDFiSXlSqQ ($28.85 in chips) 
zDrucyjVn5aeekNEc3cJrA: posts small blind $0.10
pN3IHvAKm2fz+sTRARTcrg: posts big blind $0.25
*** HOLE CARDS ***
zgi+EUykT/pZQpoUG6+oEg: folds 
8f0dtuUGqDbgE6up1lQAlg: calls $0.25
yqkowiRWZ6NvRN9UUkYIlA: folds 
Mh2r9hTeTEDnh19sRZtW3g: folds 
q4cNXFZGNhLfrTyVrIy6Mg: calls $0.25
EVqHvqty1ZsuvDFiSXlSqQ: calls $0.25
DiSvPC2iudwL5j9u6Huyww: folds 
zDrucyjVn5aeekNEc3cJrA: calls $0.15
pN3IHvAKm2fz+sTRARTcrg: checks 
*** FLOP *** [Ac 7c 3h]
zDrucyjVn5aeekNEc3cJrA: checks 
pN3IHvAKm2fz+sTRARTcrg: checks 
8f0dtuUGqDbgE6up1lQAlg: checks 
q4cNXFZGNhLfrTyVrIy6Mg: bets $0.25
EVqHvqty1ZsuvDFiSXlSqQ: folds 
zDrucyjVn5aeekNEc3cJrA: folds 
pN3IHvAKm2fz+sTRARTcrg: folds 
8f0dtuUGqDbgE6up1lQAlg: calls $0.25
*** TURN *** [Ac 7c 3h] [Ts]
8f0dtuUGqDbgE6up1lQAlg: checks 
q4cNXFZGNhLfrTyVrIy6Mg: checks 
*** RIVER *** [Ac 7c 3h Ts] [2s]
8f0dtuUGqDbgE6up1lQAlg: checks 
q4cNXFZGNhLfrTyVrIy6Mg: checks 
*** SHOW DOWN ***
8f0dtuUGqDbgE6up1lQAlg: shows [3d Qh] (a pair of Threes)
q4cNXFZGNhLfrTyVrIy6Mg: mucks hand 
8f0dtuUGqDbgE6up1lQAlg collected $1.70 from pot
*** SUMMARY ***
Total pot $1.75 | Rake $0.05 
Board [Ac 7c 3h Ts 2s]
Seat 1: DiSvPC2iudwL5j9u6Huyww (button) folded before Flop (didn't bet)
Seat 2: zDrucyjVn5aeekNEc3cJrA (small blind) folded on the Flop
Seat 3: pN3IHvAKm2fz+sTRARTcrg (big blind) folded on the Flop
Seat 4: zgi+EUykT/pZQpoUG6+oEg folded before Flop (didn't bet)
Seat 5: 8f0dtuUGqDbgE6up1lQAlg showed [3d Qh] and won ($1.70) with a pair of Threes
Seat 6: yqkowiRWZ6NvRN9UUkYIlA folded before Flop (didn't bet)
Seat 7: Mh2r9hTeTEDnh19sRZtW3g folded before Flop (didn't bet)
Seat 8: q4cNXFZGNhLfrTyVrIy6Mg mucked
Seat 9: EVqHvqty1ZsuvDFiSXlSqQ folded on the Flop




PokerStars Game #59941949854:  Hold'em No Limit ($0.10/$0.25) - 2009/07/01 1:51:19 ET
Table 'ktio12Pyq06LsrFhIorSqA' 9-max Seat #7 is the button
Seat 1: OneeONzF0MoH0pEdcBndwA ($37.80 in chips) 
Seat 2: tGsFgUKjSctVaAXabrlZxw ($4.70 in chips) 
Seat 3: Z9W7+g1WMhhZDi7DwGbCFA ($5 in chips) 
Seat 4: 0QdZrkFD7aGKeBXPGbIomA ($11.15 in chips) 
Seat 5: e0pV1oisCAilWiG0FCxY6A ($14.35 in chips) 
Seat 6: jQL6XIewylQ8MmZhhq2YFg ($39.05 in chips) 
Seat 7: XGCfQsxa6PfAg3kJtzUmww ($21.75 in chips) 
Seat 8: Z5y2J55JmfLYR6/DPAGHwQ ($11.95 in chips) 
Seat 9: H5Se03ZqSX7tbULXur2MAg ($25.90 in chips) 
Z5y2J55JmfLYR6/DPAGHwQ: posts small blind $0.10
H5Se03ZqSX7tbULXur2MAg: posts big blind $0.25
*** HOLE CARDS ***
OneeONzF0MoH0pEdcBndwA: folds 
tGsFgUKjSctVaAXabrlZxw: folds 
Z9W7+g1WMhhZDi7DwGbCFA: folds 
0QdZrkFD7aGKeBXPGbIomA: folds 
e0pV1oisCAilWiG0FCxY6A: folds 
jQL6XIewylQ8MmZhhq2YFg: raises $0.75 to $1
XGCfQsxa6PfAg3kJtzUmww: folds 
Z5y2J55JmfLYR6/DPAGHwQ: folds 
H5Se03ZqSX7tbULXur2MAg: folds 
Uncalled bet ($0.75) returned to jQL6XIewylQ8MmZhhq2YFg
jQL6XIewylQ8MmZhhq2YFg collected $0.60 from pot
jQL6XIewylQ8MmZhhq2YFg: doesn't show hand 
*** SUMMARY ***
Total pot $0.60 | Rake $0 
Seat 1: OneeONzF0MoH0pEdcBndwA folded before Flop (didn't bet)
Seat 2: tGsFgUKjSctVaAXabrlZxw folded before Flop (didn't bet)
Seat 3: Z9W7+g1WMhhZDi7DwGbCFA folded before Flop (didn't bet)
Seat 4: 0QdZrkFD7aGKeBXPGbIomA folded before Flop (didn't bet)
Seat 5: e0pV1oisCAilWiG0FCxY6A folded before Flop (didn't bet)
Seat 6: jQL6XIewylQ8MmZhhq2YFg collected ($0.60)
Seat 7: XGCfQsxa6PfAg3kJtzUmww (button) folded before Flop (didn't bet)
Seat 8: Z5y2J55JmfLYR6/DPAGHwQ (small blind) folded before Flop
Seat 9: H5Se03ZqSX7tbULXur2MAg (big blind) folded before Flop




PokerStars Game #59941950200:  Hold'em No Limit ($0.10/$0.25) - 2009/07/01 1:51:19 ET
Table 'SgI2Cobdjtkh0Fd0/eTTDg' 9-max Seat #4 is the button
Seat 1: p4VoE724cQin02zatf/NOw ($5.90 in chips) 
Seat 2: uUc5QTI8+ZdC95UnznCsqg ($14.10 in chips) 
Seat 3: GeMoapCKDLc4ajT0Uk9ZQw ($9.65 in chips) 
Seat 4: s1y+qfkBnhgc67+X3ThjeA ($6.90 in chips) 
Seat 5: RHqgdFvufLCYe54+qd2gcA ($6 in chips) 
Seat 6: 6RiVTYll/5D8zICp0MRpKw ($27.85 in chips) 
Seat 7: RY9uq/FyiWrrnWBl/zGQKg ($24.90 in chips) 
Seat 8: wzU16tcf+7nj2MYKa4h7+Q ($10.50 in chips) 
Seat 9: cZ99hugmLBj9KhTlc8nCSw ($30.60 in chips) 
RHqgdFvufLCYe54+qd2gcA: posts small blind $0.10
6RiVTYll/5D8zICp0MRpKw: posts big blind $0.25
*** HOLE CARDS ***
RY9uq/FyiWrrnWBl/zGQKg: calls $0.25
wzU16tcf+7nj2MYKa4h7+Q: folds 
cZ99hugmLBj9KhTlc8nCSw: folds 
p4VoE724cQin02zatf/NOw: raises $1.25 to $1.50
uUc5QTI8+ZdC95UnznCsqg: calls $1.50
GeMoapCKDLc4ajT0Uk9ZQw: folds 
s1y+qfkBnhgc67+X3ThjeA: folds 
RHqgdFvufLCYe54+qd2gcA: folds 
6RiVTYll/5D8zICp0MRpKw: folds 
RY9uq/FyiWrrnWBl/zGQKg: folds 
*** FLOP *** [9c Jc 2d]
p4VoE724cQin02zatf/NOw: checks 
s1y+qfkBnhgc67+X3ThjeA leaves the table
uUc5QTI8+ZdC95UnznCsqg: bets $1
p4VoE724cQin02zatf/NOw: calls $1
*** TURN *** [9c Jc 2d] [6d]
p4VoE724cQin02zatf/NOw: checks 
uUc5QTI8+ZdC95UnznCsqg: bets $2
p4VoE724cQin02zatf/NOw: folds 
Uncalled bet ($2) returned to uUc5QTI8+ZdC95UnznCsqg
uUc5QTI8+ZdC95UnznCsqg collected $5.35 from pot
uUc5QTI8+ZdC95UnznCsqg: doesn't show hand 
*** SUMMARY ***
Total pot $5.60 | Rake $0.25 
Board [9c Jc 2d 6d]
Seat 1: p4VoE724cQin02zatf/NOw folded on the Turn
Seat 2: uUc5QTI8+ZdC95UnznCsqg collected ($5.35)
Seat 3: GeMoapCKDLc4ajT0Uk9ZQw folded before Flop (didn't bet)
Seat 4: s1y+qfkBnhgc67+X3ThjeA (button) folded before Flop (didn't bet)
Seat 5: RHqgdFvufLCYe54+qd2gcA (small blind) folded before Flop
Seat 6: 6RiVTYll/5D8zICp0MRpKw (big blind) folded before Flop
Seat 7: RY9uq/FyiWrrnWBl/zGQKg folded before Flop
Seat 8: wzU16tcf+7nj2MYKa4h7+Q folded before Flop (didn't bet)
Seat 9: cZ99hugmLBj9KhTlc8nCSw folded before Flop (didn't bet)




PokerStars Game #59941950292:  Hold'em No Limit ($0.10/$0.25) - 2009/07/01 1:51:19 ET
Table 'Utmw+yX+E/wdhNDIim90lQ' 9-max Seat #8 is the button
Seat 1: cZ99hugmLBj9KhTlc8nCSw ($31.95 in chips) 
Seat 2: iGMlK+EhUflPB6jKQd95Cg ($27.35 in chips) 
Seat 3: dfNim92Z6XK1/h5SFW5vDg ($25 in chips) 
Seat 5: ghNKXUBl/H+t83JF079ZBA ($26.25 in chips) 
Seat 6: OlPJsgR4xypSg/w1z7Gyvw ($33.15 in chips) 
Seat 7: CImUHesK+ZER4v/VCA9IUg ($48.45 in chips) 
Seat 8: Mh2r9hTeTEDnh19sRZtW3g ($4.65 in chips) 
Seat 9: Th3FldXKQW6hWVVPahaoOQ ($27.25 in chips) 
Th3FldXKQW6hWVVPahaoOQ: posts small blind $0.10
cZ99hugmLBj9KhTlc8nCSw: posts big blind $0.25
bXpVeaSTPBFSPJmeXxO7nw: sits out 
*** HOLE CARDS ***
iGMlK+EhUflPB6jKQd95Cg: folds 
dfNim92Z6XK1/h5SFW5vDg: folds 
ghNKXUBl/H+t83JF079ZBA: folds 
OlPJsgR4xypSg/w1z7Gyvw: folds 
CImUHesK+ZER4v/VCA9IUg: raises $0.75 to $1
Mh2r9hTeTEDnh19sRZtW3g: folds 
Th3FldXKQW6hWVVPahaoOQ: folds 
cZ99hugmLBj9KhTlc8nCSw: folds 
Uncalled bet ($0.75) returned to CImUHesK+ZER4v/VCA9IUg
CImUHesK+ZER4v/VCA9IUg collected $0.60 from pot
CImUHesK+ZER4v/VCA9IUg: doesn't show hand 
*** SUMMARY ***
Total pot $0.60 | Rake $0 
Seat 1: cZ99hugmLBj9KhTlc8nCSw (big blind) folded before Flop
Seat 2: iGMlK+EhUflPB6jKQd95Cg folded before Flop (didn't bet)
Seat 3: dfNim92Z6XK1/h5SFW5vDg folded before Flop (didn't bet)
Seat 5: ghNKXUBl/H+t83JF079ZBA folded before Flop (didn't bet)
Seat 6: OlPJsgR4xypSg/w1z7Gyvw folded before Flop (didn't bet)
Seat 7: CImUHesK+ZER4v/VCA9IUg collected ($0.60)
Seat 8: Mh2r9hTeTEDnh19sRZtW3g (button) folded before Flop (didn't bet)
Seat 9: Th3FldXKQW6hWVVPahaoOQ (small blind) folded before Flop




PokerStars Game #59941950114:  Hold'em No Limit ($0.10/$0.25) - 2009/07/01 1:51:19 ET
Table 'ROYvQOMwUrvL3SOiHYcrWg' 9-max Seat #6 is the button
Seat 1: 22dIObOuor/A+IKWkNoAlA ($5.40 in chips) 
Seat 2: gehe91e0IyVT0QU/XBkEyg ($25.15 in chips) 
Seat 3: 8EbrQ/EvFWt2cr0GaU82gQ ($5 in chips) 
Seat 4: SHegmCn8B0InbWE/zFlvOw ($19.55 in chips) 
Seat 5: 7je+LC5Mfs6nL8YBVh4frQ ($4.65 in chips) 
Seat 6: P+9ymZQ3ktpQu1bn7HIjew ($20.15 in chips) 
Seat 8: biJWLZ27fafNeBI2oT1KJw ($27.90 in chips) 
Seat 9: uhrboV251dcgYniYTdFIcA ($31.80 in chips) 
18G4P1XstjNvItdGUITxgw will be allowed to play after the button
biJWLZ27fafNeBI2oT1KJw: posts small blind $0.10
uhrboV251dcgYniYTdFIcA: posts big blind $0.25
*** HOLE CARDS ***
22dIObOuor/A+IKWkNoAlA: folds 
gehe91e0IyVT0QU/XBkEyg: calls $0.25
8EbrQ/EvFWt2cr0GaU82gQ: folds 
SHegmCn8B0InbWE/zFlvOw: folds 
7je+LC5Mfs6nL8YBVh4frQ: folds 
P+9ymZQ3ktpQu1bn7HIjew: folds 
biJWLZ27fafNeBI2oT1KJw: calls $0.15
uhrboV251dcgYniYTdFIcA: checks 
*** FLOP *** [3d 7d 4s]
biJWLZ27fafNeBI2oT1KJw: checks 
uhrboV251dcgYniYTdFIcA: checks 
gehe91e0IyVT0QU/XBkEyg: checks 
*** TURN *** [3d 7d 4s] [7h]
biJWLZ27fafNeBI2oT1KJw: checks 
uhrboV251dcgYniYTdFIcA: checks 
gehe91e0IyVT0QU/XBkEyg: checks 
*** RIVER *** [3d 7d 4s 7h] [9c]
biJWLZ27fafNeBI2oT1KJw: bets $0.75
uhrboV251dcgYniYTdFIcA: folds 
gehe91e0IyVT0QU/XBkEyg: folds 
Uncalled bet ($0.75) returned to biJWLZ27fafNeBI2oT1KJw
biJWLZ27fafNeBI2oT1KJw collected $0.75 from pot
*** SUMMARY ***
Total pot $0.75 | Rake $0 
Board [3d 7d 4s 7h 9c]
Seat 1: 22dIObOuor/A+IKWkNoAlA folded before Flop (didn't bet)
Seat 2: gehe91e0IyVT0QU/XBkEyg folded on the River
Seat 3: 8EbrQ/EvFWt2cr0GaU82gQ folded before Flop (didn't bet)
Seat 4: SHegmCn8B0InbWE/zFlvOw folded before Flop (didn't bet)
Seat 5: 7je+LC5Mfs6nL8YBVh4frQ folded before Flop (didn't bet)
Seat 6: P+9ymZQ3ktpQu1bn7HIjew (button) folded before Flop (didn't bet)
Seat 8: biJWLZ27fafNeBI2oT1KJw (small blind) collected ($0.75)
Seat 9: uhrboV251dcgYniYTdFIcA (big blind) folded on the River




PokerStars Game #59941949914:  Hold'em No Limit ($0.10/$0.25) - 2009/07/01 1:51:19 ET
Table '6wawJ+MkkvuC3coG6r+Yhg' 6-max Seat #2 is the button
Seat 1: JQZew0FjzS19kTjeNtrE+A ($30.15 in chips) 
Seat 2: LtASJ9OlkqGrrUKGQlpGAw ($20.85 in chips) 
Seat 3: 3zD3qLXT1bEffAoWGnc7wg ($59.50 in chips) 
Seat 4: 9U3ZKjCsarN0DjR6mSE8Ug ($14 in chips) 
Seat 6: B3X187C0tXFUfQpCu8pe8A ($24.55 in chips) 
3zD3qLXT1bEffAoWGnc7wg: posts small blind $0.10
9U3ZKjCsarN0DjR6mSE8Ug: posts big blind $0.25
GbCVUNssQ7mqsPWr7J4d3w: sits out 
*** HOLE CARDS ***
B3X187C0tXFUfQpCu8pe8A: calls $0.25
JQZew0FjzS19kTjeNtrE+A: folds 
LtASJ9OlkqGrrUKGQlpGAw: folds 
3zD3qLXT1bEffAoWGnc7wg: folds 
9U3ZKjCsarN0DjR6mSE8Ug: checks 
*** FLOP *** [3s 7s 3c]
9U3ZKjCsarN0DjR6mSE8Ug: checks 
B3X187C0tXFUfQpCu8pe8A: checks 
*** TURN *** [3s 7s 3c] [5s]
9U3ZKjCsarN0DjR6mSE8Ug: bets $0.50
B3X187C0tXFUfQpCu8pe8A: folds 
Uncalled bet ($0.50) returned to 9U3ZKjCsarN0DjR6mSE8Ug
9U3ZKjCsarN0DjR6mSE8Ug collected $0.60 from pot
9U3ZKjCsarN0DjR6mSE8Ug: doesn't show hand 
*** SUMMARY ***
Total pot $0.60 | Rake $0 
Board [3s 7s 3c 5s]
Seat 1: JQZew0FjzS19kTjeNtrE+A folded before Flop (didn't bet)
Seat 2: LtASJ9OlkqGrrUKGQlpGAw (button) folded before Flop (didn't bet)
Seat 3: 3zD3qLXT1bEffAoWGnc7wg (small blind) folded before Flop
Seat 4: 9U3ZKjCsarN0DjR6mSE8Ug (big blind) collected ($0.60)
Seat 6: B3X187C0tXFUfQpCu8pe8A folded on the Turn




PokerStars Game #59941949970:  Hold'em No Limit ($0.10/$0.25) - 2009/07/01 1:51:19 ET
Table '5VWnrlxdjwVfMWkVS2WE7A' 6-max Seat #5 is the button
Seat 1: 82p+w3EmUaFFHuwpSeGY1w ($13.60 in chips) 
Seat 2: LJI7A1YgDM7hgh7o56+ReQ ($44.10 in chips) 
Seat 3: SFmT9ZsVopnukjvAzrxTRg ($37.35 in chips) 
Seat 5: 32YL2ZEp8NT4JB2RVM9euQ ($15.50 in chips) 
Seat 6: LtASJ9OlkqGrrUKGQlpGAw ($24.75 in chips) 
LtASJ9OlkqGrrUKGQlpGAw: posts small blind $0.10
82p+w3EmUaFFHuwpSeGY1w: posts big blind $0.25
*** HOLE CARDS ***
LJI7A1YgDM7hgh7o56+ReQ: folds 
eHsmIvAb2JREg4O6hNPnXg joins the table at seat #4 
SFmT9ZsVopnukjvAzrxTRg: raises $0.75 to $1
32YL2ZEp8NT4JB2RVM9euQ: folds 
LtASJ9OlkqGrrUKGQlpGAw: folds 
82p+w3EmUaFFHuwpSeGY1w: folds 
Uncalled bet ($0.75) returned to SFmT9ZsVopnukjvAzrxTRg
SFmT9ZsVopnukjvAzrxTRg collected $0.60 from pot
SFmT9ZsVopnukjvAzrxTRg: doesn't show hand 
*** SUMMARY ***
Total pot $0.60 | Rake $0 
Seat 1: 82p+w3EmUaFFHuwpSeGY1w (big blind) folded before Flop
Seat 2: LJI7A1YgDM7hgh7o56+ReQ folded before Flop (didn't bet)
Seat 3: SFmT9ZsVopnukjvAzrxTRg collected ($0.60)
Seat 5: 32YL2ZEp8NT4JB2RVM9euQ (button) folded before Flop (didn't bet)
Seat 6: LtASJ9OlkqGrrUKGQlpGAw (small blind) folded before Flop




PokerStars Game #59941949820:  Hold'em No Limit ($0.10/$0.25) - 2009/07/01 1:51:19 ET
Table 'nB7Q7zfNfy6ig6DB+rsgWQ' 6-max Seat #6 is the button
Seat 1: Hzy03WtPHMYwLYM7hTTxQw ($24.75 in chips) 
Seat 2: 4BHo0wlX9INjkj2727qE0w ($30.45 in chips) 
Seat 3: p3NYOxYhkL7txPRSeXHDeg ($31.50 in chips) 
Seat 4: DihMHaz4WNETH1bPDe13kA ($80.70 in chips) 
Seat 5: xC0kaiDYM6YTlgODL83O5A ($12.30 in chips) 
Seat 6: MEGIwX0eHRUj63lwYaNhVg ($7.60 in chips) 
Hzy03WtPHMYwLYM7hTTxQw: posts small blind $0.10
4BHo0wlX9INjkj2727qE0w: posts big blind $0.25
*** HOLE CARDS ***
p3NYOxYhkL7txPRSeXHDeg: calls $0.25
DihMHaz4WNETH1bPDe13kA: folds 
xC0kaiDYM6YTlgODL83O5A: calls $0.25
MEGIwX0eHRUj63lwYaNhVg: calls $0.25
Hzy03WtPHMYwLYM7hTTxQw: calls $0.15
4BHo0wlX9INjkj2727qE0w: checks 
*** FLOP *** [As 3h 4h]
Hzy03WtPHMYwLYM7hTTxQw: bets $1.50
4BHo0wlX9INjkj2727qE0w: folds 
p3NYOxYhkL7txPRSeXHDeg: calls $1.50
xC0kaiDYM6YTlgODL83O5A: folds 
MEGIwX0eHRUj63lwYaNhVg: calls $1.50
*** TURN *** [As 3h 4h] [6s]
Hzy03WtPHMYwLYM7hTTxQw: bets $4.75
p3NYOxYhkL7txPRSeXHDeg: folds 
MEGIwX0eHRUj63lwYaNhVg: raises $1.10 to $5.85 and is all-in
Hzy03WtPHMYwLYM7hTTxQw: calls $1.10
*** RIVER *** [As 3h 4h 6s] [8c]
*** SHOW DOWN ***
Hzy03WtPHMYwLYM7hTTxQw: shows [Ah Qd] (a pair of Aces)
MEGIwX0eHRUj63lwYaNhVg: mucks hand 
Hzy03WtPHMYwLYM7hTTxQw collected $16.60 from pot
MEGIwX0eHRUj63lwYaNhVg leaves the table
*** SUMMARY ***
Total pot $17.45 | Rake $0.85 
Board [As 3h 4h 6s 8c]
Seat 1: Hzy03WtPHMYwLYM7hTTxQw (small blind) showed [Ah Qd] and won ($16.60) with a pair of Aces
Seat 2: 4BHo0wlX9INjkj2727qE0w (big blind) folded on the Flop
Seat 3: p3NYOxYhkL7txPRSeXHDeg folded on the Turn
Seat 4: DihMHaz4WNETH1bPDe13kA folded before Flop (didn't bet)
Seat 5: xC0kaiDYM6YTlgODL83O5A folded on the Flop
Seat 6: MEGIwX0eHRUj63lwYaNhVg (button) mucked




PokerStars Game #59941950036:  Hold'em No Limit ($0.10/$0.25) - 2009/07/01 1:51:19 ET
Table 'biAgO3TKQBU8XcrVAoU5TA' 6-max Seat #3 is the button
Seat 1: jhDPlkir8wBYAddboBuF7Q ($8.05 in chips) 
Seat 2: NPueG39V6nKvDRuvBJ4U7g ($9.10 in chips) 
Seat 3: mfrkWA3PTeYPkbO6hi98Aw ($25 in chips) 
Seat 4: Hsvkc0/G2VV78oVmWYXecw ($5 in chips) 
Seat 5: n6UPMnVR4v8LFP0rWP73Fg ($15.35 in chips) 
Seat 6: wMiE3yTbDJGOLOF9th7KPA ($23.50 in chips) 
Hsvkc0/G2VV78oVmWYXecw: posts small blind $0.10
n6UPMnVR4v8LFP0rWP73Fg: posts big blind $0.25
NPueG39V6nKvDRuvBJ4U7g: posts big blind $0.25
*** HOLE CARDS ***
wMiE3yTbDJGOLOF9th7KPA: calls $0.25
jhDPlkir8wBYAddboBuF7Q: raises $0.25 to $0.50
NPueG39V6nKvDRuvBJ4U7g: calls $0.25
mfrkWA3PTeYPkbO6hi98Aw: calls $0.50
Hsvkc0/G2VV78oVmWYXecw: folds 
n6UPMnVR4v8LFP0rWP73Fg: calls $0.25
wMiE3yTbDJGOLOF9th7KPA: calls $0.25
*** FLOP *** [3d Jh 7s]
Hsvkc0/G2VV78oVmWYXecw leaves the table
n6UPMnVR4v8LFP0rWP73Fg: checks 
wMiE3yTbDJGOLOF9th7KPA: checks 
jhDPlkir8wBYAddboBuF7Q: bets $0.75
NPueG39V6nKvDRuvBJ4U7g: folds 
mfrkWA3PTeYPkbO6hi98Aw: calls $0.75
n6UPMnVR4v8LFP0rWP73Fg: raises $1 to $1.75
wMiE3yTbDJGOLOF9th7KPA: folds 
jhDPlkir8wBYAddboBuF7Q: calls $1
mfrkWA3PTeYPkbO6hi98Aw: calls $1
*** TURN *** [3d Jh 7s] [9c]
n6UPMnVR4v8LFP0rWP73Fg: bets $13.10 and is all-in
jhDPlkir8wBYAddboBuF7Q: calls $5.80 and is all-in
mfrkWA3PTeYPkbO6hi98Aw: folds 
Uncalled bet ($7.30) returned to n6UPMnVR4v8LFP0rWP73Fg
*** RIVER *** [3d Jh 7s 9c] [Qs]
*** SHOW DOWN ***
n6UPMnVR4v8LFP0rWP73Fg: shows [7h Jd] (two pair, Jacks and Sevens)
jhDPlkir8wBYAddboBuF7Q: mucks hand 
n6UPMnVR4v8LFP0rWP73Fg collected $18.50 from pot
*** SUMMARY ***
Total pot $19.45 | Rake $0.95 
Board [3d Jh 7s 9c Qs]
Seat 1: jhDPlkir8wBYAddboBuF7Q mucked
Seat 2: NPueG39V6nKvDRuvBJ4U7g folded on the Flop
Seat 3: mfrkWA3PTeYPkbO6hi98Aw (button) folded on the Turn
Seat 4: Hsvkc0/G2VV78oVmWYXecw (small blind) folded before Flop
Seat 5: n6UPMnVR4v8LFP0rWP73Fg (big blind) showed [7h Jd] and won ($18.50) with two pair, Jacks and Sevens
Seat 6: wMiE3yTbDJGOLOF9th7KPA folded on the Flop




PokerStars Game #59941950766:  Hold'em No Limit ($0.10/$0.25) - 2009/07/01 1:51:20 ET
Table 'l57rayEpPtZotP9nqgSWBg' 6-max Seat #6 is the button
Seat 1: DihMHaz4WNETH1bPDe13kA ($56.60 in chips) 
Seat 2: p6adJRMXMBLr+xtQzqazIQ ($15.05 in chips) 
Seat 3: xC0kaiDYM6YTlgODL83O5A ($24.75 in chips) 
Seat 4: OqkdGXy1SCzuN5Q0wNlFSg ($22.10 in chips) 
Seat 5: WKJHaZPUgrpTVyLOEjLYmg ($11.85 in chips) 
Seat 6: IGRfskE1v9H9Bn+fz8AgNQ ($15.55 in chips) 
DihMHaz4WNETH1bPDe13kA: posts small blind $0.10
p6adJRMXMBLr+xtQzqazIQ: posts big blind $0.25
*** HOLE CARDS ***
xC0kaiDYM6YTlgODL83O5A: raises $0.50 to $0.75
OqkdGXy1SCzuN5Q0wNlFSg: folds 
WKJHaZPUgrpTVyLOEjLYmg: folds 
IGRfskE1v9H9Bn+fz8AgNQ: folds 
DihMHaz4WNETH1bPDe13kA: folds 
p6adJRMXMBLr+xtQzqazIQ: folds 
Uncalled bet ($0.50) returned to xC0kaiDYM6YTlgODL83O5A
xC0kaiDYM6YTlgODL83O5A collected $0.60 from pot
*** SUMMARY ***
Total pot $0.60 | Rake $0 
Seat 1: DihMHaz4WNETH1bPDe13kA (small blind) folded before Flop
Seat 2: p6adJRMXMBLr+xtQzqazIQ (big blind) folded before Flop
Seat 3: xC0kaiDYM6YTlgODL83O5A collected ($0.60)
Seat 4: OqkdGXy1SCzuN5Q0wNlFSg folded before Flop (didn't bet)
Seat 5: WKJHaZPUgrpTVyLOEjLYmg folded before Flop (didn't bet)
Seat 6: IGRfskE1v9H9Bn+fz8AgNQ (button) folded before Flop (didn't bet)




PokerStars Game #59941950352:  Hold'em No Limit ($0.10/$0.25) - 2009/07/01 1:51:20 ET
Table 'YONIZZNvg4uZ4xNUO1deeA' 6-max Seat #1 is the button
Seat 1: GbCVUNssQ7mqsPWr7J4d3w ($4.30 in chips) 
Seat 2: evMMX/0gSDH791KdSAOaSg ($18.55 in chips) 
Seat 3: Eksrep3hySi2jeDHuaWiOQ ($8.50 in chips) 
Seat 4: w43JQj2oYPpKQVG4Yzlq1w ($25 in chips) 
Seat 5: if4dh6jhJXeN3/qd3qCp9g ($24.65 in chips) 
Seat 6: eL3+wCBjFGfQ5FMdIZihwA ($28.75 in chips) 
evMMX/0gSDH791KdSAOaSg: posts small blind $0.10
Eksrep3hySi2jeDHuaWiOQ: posts big blind $0.25
*** HOLE CARDS ***
w43JQj2oYPpKQVG4Yzlq1w: folds 
if4dh6jhJXeN3/qd3qCp9g: folds 
eL3+wCBjFGfQ5FMdIZihwA: raises $0.50 to $0.75
GbCVUNssQ7mqsPWr7J4d3w: folds 
evMMX/0gSDH791KdSAOaSg: folds 
Eksrep3hySi2jeDHuaWiOQ: folds 
Uncalled bet ($0.50) returned to eL3+wCBjFGfQ5FMdIZihwA
eL3+wCBjFGfQ5FMdIZihwA collected $0.60 from pot
*** SUMMARY ***
Total pot $0.60 | Rake $0 
Seat 1: GbCVUNssQ7mqsPWr7J4d3w (button) folded before Flop (didn't bet)
Seat 2: evMMX/0gSDH791KdSAOaSg (small blind) folded before Flop
Seat 3: Eksrep3hySi2jeDHuaWiOQ (big blind) folded before Flop
Seat 4: w43JQj2oYPpKQVG4Yzlq1w folded before Flop (didn't bet)
Seat 5: if4dh6jhJXeN3/qd3qCp9g folded before Flop (didn't bet)
Seat 6: eL3+wCBjFGfQ5FMdIZihwA collected ($0.60)




PokerStars Game #59941950742:  Hold'em No Limit ($0.10/$0.25) - 2009/07/01 1:51:20 ET
Table 'wGizWOswEL6P5QrvVkno/g' 6-max Seat #2 is the button
Seat 1: Qbfkn+ucISvbd1Xh32zAGA ($33.60 in chips) 
Seat 2: mfrkWA3PTeYPkbO6hi98Aw ($28.40 in chips) 
Seat 3: i9LqF5rD3bvtbEE7HWgr3Q ($25 in chips) 
Seat 4: yF9xHMEAvA+7Gn+eDkuVIg ($2.40 in chips) 
Seat 5: w43JQj2oYPpKQVG4Yzlq1w ($25 in chips) 
Seat 6: BuAE7g7dRfuqGPmQDlGyGg ($18.40 in chips) 
i9LqF5rD3bvtbEE7HWgr3Q: posts small blind $0.10
yF9xHMEAvA+7Gn+eDkuVIg: posts big blind $0.25
*** HOLE CARDS ***
w43JQj2oYPpKQVG4Yzlq1w: folds 
BuAE7g7dRfuqGPmQDlGyGg: calls $0.25
Qbfkn+ucISvbd1Xh32zAGA: folds 
mfrkWA3PTeYPkbO6hi98Aw: folds 
i9LqF5rD3bvtbEE7HWgr3Q: folds 
yF9xHMEAvA+7Gn+eDkuVIg: checks 
*** FLOP *** [4c 3s 8d]
yF9xHMEAvA+7Gn+eDkuVIg: checks 
BuAE7g7dRfuqGPmQDlGyGg: bets $0.50
yF9xHMEAvA+7Gn+eDkuVIg: folds 
Uncalled bet ($0.50) returned to BuAE7g7dRfuqGPmQDlGyGg
BuAE7g7dRfuqGPmQDlGyGg collected $0.60 from pot
*** SUMMARY ***
Total pot $0.60 | Rake $0 
Board [4c 3s 8d]
Seat 1: Qbfkn+ucISvbd1Xh32zAGA folded before Flop (didn't bet)
Seat 2: mfrkWA3PTeYPkbO6hi98Aw (button) folded before Flop (didn't bet)
Seat 3: i9LqF5rD3bvtbEE7HWgr3Q (small blind) folded before Flop
Seat 4: yF9xHMEAvA+7Gn+eDkuVIg (big blind) folded on the Flop
Seat 5: w43JQj2oYPpKQVG4Yzlq1w folded before Flop (didn't bet)
Seat 6: BuAE7g7dRfuqGPmQDlGyGg collected ($0.60)




PokerStars Game #59941950446:  Hold'em No Limit ($0.10/$0.25) - 2009/07/01 1:51:20 ET
Table 'rtxA1Y01Nrq5VoyzTAuusQ' 9-max Seat #4 is the button
Seat 1: w1ukf8uPa4+WH561TtVRxA ($26.55 in chips) 
Seat 2: Th3FldXKQW6hWVVPahaoOQ ($25 in chips) 
Seat 3: K9fS1IUr5GpiJG7VkJ7IbA ($8.10 in chips) 
Seat 4: RHqgdFvufLCYe54+qd2gcA ($4.50 in chips) 
Seat 5: MtVtHDqIJTyUcXkRBBDIVA ($32.65 in chips) 
Seat 7: W6tExOcYX7qiy6Qdp+ZwFA ($5 in chips) 
Seat 8: DnDcAdn9P0zGovMERigpFA ($25 in chips) 
Seat 9: HPEB+AtKw1+C/cxU0o1ciw ($22.35 in chips) 
MtVtHDqIJTyUcXkRBBDIVA: posts small blind $0.10
W6tExOcYX7qiy6Qdp+ZwFA: posts big blind $0.25
*** HOLE CARDS ***
DnDcAdn9P0zGovMERigpFA: raises $0.50 to $0.75
HPEB+AtKw1+C/cxU0o1ciw: folds 
w1ukf8uPa4+WH561TtVRxA: folds 
Th3FldXKQW6hWVVPahaoOQ: folds 
K9fS1IUr5GpiJG7VkJ7IbA: folds 
RHqgdFvufLCYe54+qd2gcA: calls $0.75
MtVtHDqIJTyUcXkRBBDIVA: folds 
W6tExOcYX7qiy6Qdp+ZwFA: folds 
*** FLOP *** [Qh Jd 2d]
DnDcAdn9P0zGovMERigpFA: checks 
RHqgdFvufLCYe54+qd2gcA: bets $1.25
DnDcAdn9P0zGovMERigpFA: folds 
Uncalled bet ($1.25) returned to RHqgdFvufLCYe54+qd2gcA
RHqgdFvufLCYe54+qd2gcA collected $1.80 from pot
RHqgdFvufLCYe54+qd2gcA: doesn't show hand 
*** SUMMARY ***
Total pot $1.85 | Rake $0.05 
Board [Qh Jd 2d]
Seat 1: w1ukf8uPa4+WH561TtVRxA folded before Flop (didn't bet)
Seat 2: Th3FldXKQW6hWVVPahaoOQ folded before Flop (didn't bet)
Seat 3: K9fS1IUr5GpiJG7VkJ7IbA folded before Flop (didn't bet)
Seat 4: RHqgdFvufLCYe54+qd2gcA (button) collected ($1.80)
Seat 5: MtVtHDqIJTyUcXkRBBDIVA (small blind) folded before Flop
Seat 7: W6tExOcYX7qiy6Qdp+ZwFA (big blind) folded before Flop
Seat 8: DnDcAdn9P0zGovMERigpFA folded on the Flop
Seat 9: HPEB+AtKw1+C/cxU0o1ciw folded before Flop (didn't bet)




PokerStars Game #59941951106:  Hold'em No Limit ($0.10/$0.25) - 2009/07/01 1:51:21 ET
Table 'KU/HrxqxwDz8HKEhYTZ6uw' 6-max Seat #2 is the button
Seat 1: 7LKoiQHXpTQXJvWQrw907g ($38.55 in chips) 
Seat 2: kG34n23qFQA3nzdOJTQ1dA ($23.95 in chips) 
Seat 3: SFmT9ZsVopnukjvAzrxTRg ($26.20 in chips) 
Seat 5: iyZxqznXjv3vtvOJymkoLQ ($52.35 in chips) 
Seat 6: qWxkCeqApAWdAA0evrfDvQ ($8.50 in chips) 
SFmT9ZsVopnukjvAzrxTRg: posts small blind $0.10
iyZxqznXjv3vtvOJymkoLQ: posts big blind $0.25
*** HOLE CARDS ***
qWxkCeqApAWdAA0evrfDvQ: calls $0.25
7LKoiQHXpTQXJvWQrw907g: calls $0.25
kG34n23qFQA3nzdOJTQ1dA: folds 
SFmT9ZsVopnukjvAzrxTRg: folds 
iyZxqznXjv3vtvOJymkoLQ: checks 
*** FLOP *** [9s 6h Ac]
iyZxqznXjv3vtvOJymkoLQ: checks 
qWxkCeqApAWdAA0evrfDvQ: bets $0.50
7LKoiQHXpTQXJvWQrw907g: folds 
iyZxqznXjv3vtvOJymkoLQ: folds 
Uncalled bet ($0.50) returned to qWxkCeqApAWdAA0evrfDvQ
qWxkCeqApAWdAA0evrfDvQ collected $0.85 from pot
*** SUMMARY ***
Total pot $0.85 | Rake $0 
Board [9s 6h Ac]
Seat 1: 7LKoiQHXpTQXJvWQrw907g folded on the Flop
Seat 2: kG34n23qFQA3nzdOJTQ1dA (button) folded before Flop (didn't bet)
Seat 3: SFmT9ZsVopnukjvAzrxTRg (small blind) folded before Flop
Seat 5: iyZxqznXjv3vtvOJymkoLQ (big blind) folded on the Flop
Seat 6: qWxkCeqApAWdAA0evrfDvQ collected ($0.85)




PokerStars Game #59941951306:  Hold'em No Limit ($0.10/$0.25) - 2009/07/01 1:51:21 ET
Table '+giHa6FUL6U5/AZnCJEGvQ' 9-max Seat #6 is the button
Seat 5: zDrucyjVn5aeekNEc3cJrA ($44.65 in chips) 
Seat 6: GTMnTen6sQSoCpS9sggLbg ($24.75 in chips) 
GTMnTen6sQSoCpS9sggLbg: posts small blind $0.10
zDrucyjVn5aeekNEc3cJrA: posts big blind $0.25
*** HOLE CARDS ***
GTMnTen6sQSoCpS9sggLbg: calls $0.15
zDrucyjVn5aeekNEc3cJrA: checks 
*** FLOP *** [Td Qh 6h]
zDrucyjVn5aeekNEc3cJrA: checks 
GTMnTen6sQSoCpS9sggLbg: bets $0.25
zDrucyjVn5aeekNEc3cJrA: folds 
Uncalled bet ($0.25) returned to GTMnTen6sQSoCpS9sggLbg
GTMnTen6sQSoCpS9sggLbg collected $0.50 from pot
GTMnTen6sQSoCpS9sggLbg: doesn't show hand 
*** SUMMARY ***
Total pot $0.50 | Rake $0 
Board [Td Qh 6h]
Seat 5: zDrucyjVn5aeekNEc3cJrA (big blind) folded on the Flop
Seat 6: GTMnTen6sQSoCpS9sggLbg (button) (small blind) collected ($0.50)




PokerStars Game #59941951100:  Hold'em No Limit ($0.10/$0.25) - 2009/07/01 1:51:21 ET
Table 'pPgW4R3kdH26lLi1MnE92w' 9-max Seat #7 is the button
Seat 1: F4P6SxCNY4vxdb318G9RwA ($20 in chips) 
Seat 2: cZ99hugmLBj9KhTlc8nCSw ($28 in chips) 
Seat 3: WaS7+xnv4bIVHoru6nxczA ($14 in chips) 
Seat 4: iZ1f67Ok/207yzIQOu1Kdg ($2.15 in chips) 
Seat 5: HPEB+AtKw1+C/cxU0o1ciw ($24.25 in chips) 
Seat 6: +qc/EYCgLC65SpGvr35eNg ($25 in chips) 
Seat 7: sD+TKtt36XiiN6jqHiLwDA ($28.70 in chips) 
Seat 8: clJsV3v77RS07bDKY+705w ($5 in chips) 
Seat 9: tcbEu7VzyHQ+0lh+skbQhQ ($64.90 in chips) 
clJsV3v77RS07bDKY+705w: posts small blind $0.10
tcbEu7VzyHQ+0lh+skbQhQ: posts big blind $0.25
*** HOLE CARDS ***
F4P6SxCNY4vxdb318G9RwA: folds 
cZ99hugmLBj9KhTlc8nCSw: folds 
WaS7+xnv4bIVHoru6nxczA: folds 
iZ1f67Ok/207yzIQOu1Kdg: raises $0.50 to $0.75
HPEB+AtKw1+C/cxU0o1ciw: folds 
+qc/EYCgLC65SpGvr35eNg: folds 
sD+TKtt36XiiN6jqHiLwDA: folds 
clJsV3v77RS07bDKY+705w: folds 
tcbEu7VzyHQ+0lh+skbQhQ: folds 
Uncalled bet ($0.50) returned to iZ1f67Ok/207yzIQOu1Kdg
iZ1f67Ok/207yzIQOu1Kdg collected $0.60 from pot
iZ1f67Ok/207yzIQOu1Kdg: doesn't show hand 
*** SUMMARY ***
Total pot $0.60 | Rake $0 
Seat 1: F4P6SxCNY4vxdb318G9RwA folded before Flop (didn't bet)
Seat 2: cZ99hugmLBj9KhTlc8nCSw folded before Flop (didn't bet)
Seat 3: WaS7+xnv4bIVHoru6nxczA folded before Flop (didn't bet)
Seat 4: iZ1f67Ok/207yzIQOu1Kdg collected ($0.60)
Seat 5: HPEB+AtKw1+C/cxU0o1ciw folded before Flop (didn't bet)
Seat 6: +qc/EYCgLC65SpGvr35eNg folded before Flop (didn't bet)
Seat 7: sD+TKtt36XiiN6jqHiLwDA (button) folded before Flop (didn't bet)
Seat 8: clJsV3v77RS07bDKY+705w (small blind) folded before Flop
Seat 9: tcbEu7VzyHQ+0lh+skbQhQ (big blind) folded before Flop




PokerStars Game #59941951008:  Hold'em No Limit ($0.10/$0.25) - 2009/07/01 1:51:21 ET
Table '63h13e5p7cWe02rClZ1CHw' 6-max Seat #4 is the button
Seat 1: pokjbbEcXXPlADXdSGHtZw ($21.35 in chips) 
Seat 2: k9nHZTHt8hYhYRcW8NTb4g ($25.30 in chips) 
Seat 3: hOaWAImn5/MZDAWAPlYHCw ($5 in chips) 
Seat 4: xrf8tAXKQHG99HixCot1Iw ($28 in chips) 
Seat 5: iyZxqznXjv3vtvOJymkoLQ ($44.20 in chips) 
Seat 6: mfrkWA3PTeYPkbO6hi98Aw ($38.70 in chips) 
iyZxqznXjv3vtvOJymkoLQ: posts small blind $0.10
mfrkWA3PTeYPkbO6hi98Aw: posts big blind $0.25
hOaWAImn5/MZDAWAPlYHCw: posts big blind $0.25
*** HOLE CARDS ***
pokjbbEcXXPlADXdSGHtZw: folds 
k9nHZTHt8hYhYRcW8NTb4g: folds 
hOaWAImn5/MZDAWAPlYHCw: raises $0.25 to $0.50
xrf8tAXKQHG99HixCot1Iw: folds 
iyZxqznXjv3vtvOJymkoLQ: folds 
mfrkWA3PTeYPkbO6hi98Aw: calls $0.25
*** FLOP *** [Ah 3s 3h]
mfrkWA3PTeYPkbO6hi98Aw: checks 
hOaWAImn5/MZDAWAPlYHCw: bets $0.75
mfrkWA3PTeYPkbO6hi98Aw: folds 
Uncalled bet ($0.75) returned to hOaWAImn5/MZDAWAPlYHCw
hOaWAImn5/MZDAWAPlYHCw collected $1.05 from pot
hOaWAImn5/MZDAWAPlYHCw: doesn't show hand 
*** SUMMARY ***
Total pot $1.10 | Rake $0.05 
Board [Ah 3s 3h]
Seat 1: pokjbbEcXXPlADXdSGHtZw folded before Flop (didn't bet)
Seat 2: k9nHZTHt8hYhYRcW8NTb4g folded before Flop (didn't bet)
Seat 3: hOaWAImn5/MZDAWAPlYHCw collected ($1.05)
Seat 4: xrf8tAXKQHG99HixCot1Iw (button) folded before Flop (didn't bet)
Seat 5: iyZxqznXjv3vtvOJymkoLQ (small blind) folded before Flop
Seat 6: mfrkWA3PTeYPkbO6hi98Aw (big blind) folded on the Flop




PokerStars Game #59941950982:  Hold'em No Limit ($0.10/$0.25) - 2009/07/01 1:51:21 ET
Table '+198VWQSWBhYQOcizzuBkw' 6-max Seat #3 is the button
Seat 1: 34ttqW62uIRrqINCCmLcsw ($18.25 in chips) 
Seat 2: iauW7L/+7qzAuHow7CD75Q ($12.30 in chips) 
Seat 3: vw7gefupgmOJJN8lUemdWg ($21.10 in chips) 
Seat 4: TgDsTeCdLQt8kWbL00ByRA ($15 in chips) 
Seat 5: LtASJ9OlkqGrrUKGQlpGAw ($25 in chips) 
Seat 6: leEQ84f6wJYu5SB/vj27wg ($15 in chips) 
TgDsTeCdLQt8kWbL00ByRA: posts small blind $0.10
LtASJ9OlkqGrrUKGQlpGAw: posts big blind $0.25
*** HOLE CARDS ***
leEQ84f6wJYu5SB/vj27wg: folds 
34ttqW62uIRrqINCCmLcsw: folds 
iauW7L/+7qzAuHow7CD75Q: folds 
vw7gefupgmOJJN8lUemdWg: raises $0.75 to $1
TgDsTeCdLQt8kWbL00ByRA: folds 
LtASJ9OlkqGrrUKGQlpGAw: folds 
Uncalled bet ($0.75) returned to vw7gefupgmOJJN8lUemdWg
vw7gefupgmOJJN8lUemdWg collected $0.60 from pot
vw7gefupgmOJJN8lUemdWg: doesn't show hand 
*** SUMMARY ***
Total pot $0.60 | Rake $0 
Seat 1: 34ttqW62uIRrqINCCmLcsw folded before Flop (didn't bet)
Seat 2: iauW7L/+7qzAuHow7CD75Q folded before Flop (didn't bet)
Seat 3: vw7gefupgmOJJN8lUemdWg (button) collected ($0.60)
Seat 4: TgDsTeCdLQt8kWbL00ByRA (small blind) folded before Flop
Seat 5: LtASJ9OlkqGrrUKGQlpGAw (big blind) folded before Flop
Seat 6: leEQ84f6wJYu5SB/vj27wg folded before Flop (didn't bet)




PokerStars Game #59941951344:  Hold'em No Limit ($0.10/$0.25) - 2009/07/01 1:51:21 ET
Table 'GxdLtCpYxqT4aAbYqkEEpw' 6-max Seat #5 is the button
Seat 1: 2d/PU00mMdO9azAaXqcSbw ($9.05 in chips) 
Seat 2: MCCWc70bl051s/EF6nHRcA ($23.65 in chips) 
Seat 3: LpmZGzLpOmfZUF7EV4ZlrQ ($15.90 in chips) 
Seat 4: 6wzJiRvp8HY6t+MQGnSIzA ($13.80 in chips) 
Seat 5: q6WfTUAD9mowIP63ASq2Dg ($44.90 in chips) 
Seat 6: DFi/Lzkjsfv8QswS80JX9Q ($25 in chips) 
DFi/Lzkjsfv8QswS80JX9Q: posts small blind $0.10
2d/PU00mMdO9azAaXqcSbw: posts big blind $0.25
*** HOLE CARDS ***
MCCWc70bl051s/EF6nHRcA: folds 
LpmZGzLpOmfZUF7EV4ZlrQ is disconnected 
LpmZGzLpOmfZUF7EV4ZlrQ has timed out while disconnected
LpmZGzLpOmfZUF7EV4ZlrQ: folds 
LpmZGzLpOmfZUF7EV4ZlrQ is sitting out
6wzJiRvp8HY6t+MQGnSIzA: folds 
q6WfTUAD9mowIP63ASq2Dg has timed out
q6WfTUAD9mowIP63ASq2Dg: folds 
q6WfTUAD9mowIP63ASq2Dg is sitting out
DFi/Lzkjsfv8QswS80JX9Q: folds 
Uncalled bet ($0.15) returned to 2d/PU00mMdO9azAaXqcSbw
LpmZGzLpOmfZUF7EV4ZlrQ is connected 
2d/PU00mMdO9azAaXqcSbw collected $0.20 from pot
2d/PU00mMdO9azAaXqcSbw: doesn't show hand 
LpmZGzLpOmfZUF7EV4ZlrQ has returned
*** SUMMARY ***
Total pot $0.20 | Rake $0 
Seat 1: 2d/PU00mMdO9azAaXqcSbw (big blind) collected ($0.20)
Seat 2: MCCWc70bl051s/EF6nHRcA folded before Flop (didn't bet)
Seat 3: LpmZGzLpOmfZUF7EV4ZlrQ folded before Flop (didn't bet)
Seat 4: 6wzJiRvp8HY6t+MQGnSIzA folded before Flop (didn't bet)
Seat 5: q6WfTUAD9mowIP63ASq2Dg (button) folded before Flop (didn't bet)
Seat 6: DFi/Lzkjsfv8QswS80JX9Q (small blind) folded before Flop




PokerStars Game #59941951742:  Hold'em No Limit ($0.10/$0.25) - 2009/07/01 1:51:22 ET
Table '8PD/MTROSMd6Y8mZeykbpg' 6-max Seat #4 is the button
Seat 1: fxNpaToxECtD2Goelmg9vA ($28.50 in chips) 
Seat 2: 4TM16KVgEiQpLi4bVVWbVQ ($31.60 in chips) 
Seat 3: vqWjZmdQu/Hxw96/IJTWdQ ($25 in chips) 
Seat 4: DFi/Lzkjsfv8QswS80JX9Q ($47.70 in chips) 
Seat 5: z3tQwy28dp5FykDJC/wzQw ($26.30 in chips) 
Seat 6: trN/oHqTTbPw5MNuKrOpLw ($25.25 in chips) 
z3tQwy28dp5FykDJC/wzQw: posts small blind $0.10
trN/oHqTTbPw5MNuKrOpLw: posts big blind $0.25
*** HOLE CARDS ***
fxNpaToxECtD2Goelmg9vA: calls $0.25
4TM16KVgEiQpLi4bVVWbVQ: folds 
vqWjZmdQu/Hxw96/IJTWdQ: folds 
DFi/Lzkjsfv8QswS80JX9Q: raises $1 to $1.25
z3tQwy28dp5FykDJC/wzQw: folds 
trN/oHqTTbPw5MNuKrOpLw: folds 
fxNpaToxECtD2Goelmg9vA: calls $1
*** FLOP *** [Kc 9d 6c]
fxNpaToxECtD2Goelmg9vA: checks 
DFi/Lzkjsfv8QswS80JX9Q: bets $1.75
fxNpaToxECtD2Goelmg9vA: folds 
Uncalled bet ($1.75) returned to DFi/Lzkjsfv8QswS80JX9Q
DFi/Lzkjsfv8QswS80JX9Q collected $2.75 from pot
DFi/Lzkjsfv8QswS80JX9Q: doesn't show hand 
*** SUMMARY ***
Total pot $2.85 | Rake $0.10 
Board [Kc 9d 6c]
Seat 1: fxNpaToxECtD2Goelmg9vA folded on the Flop
Seat 2: 4TM16KVgEiQpLi4bVVWbVQ folded before Flop (didn't bet)
Seat 3: vqWjZmdQu/Hxw96/IJTWdQ folded before Flop (didn't bet)
Seat 4: DFi/Lzkjsfv8QswS80JX9Q (button) collected ($2.75)
Seat 5: z3tQwy28dp5FykDJC/wzQw (small blind) folded before Flop
Seat 6: trN/oHqTTbPw5MNuKrOpLw (big blind) folded before Flop




PokerStars Game #59941951822:  Hold'em No Limit ($0.10/$0.25) - 2009/07/01 1:51:22 ET
Table 'Dun24l/X8kjpUHWBhkVOFw' 6-max Seat #2 is the button
Seat 1: u3Ol7kv1LmvszuHNm9rc6w ($21.80 in chips) 
Seat 2: 6hUmfDYq+83kvxWoTBQmfw ($24.90 in chips) 
Seat 3: FzAsD5THdVHZrHrSzc4boA ($25.70 in chips) 
Seat 4: aogAb4Eienxztk8p2v9VVw ($25 in chips) 
Seat 5: KYBwVA7jgmSrbIEbEGElVg ($29.35 in chips) 
Seat 6: xrf8tAXKQHG99HixCot1Iw ($25 in chips) 
FzAsD5THdVHZrHrSzc4boA: posts small blind $0.10
aogAb4Eienxztk8p2v9VVw: posts big blind $0.25
*** HOLE CARDS ***
KYBwVA7jgmSrbIEbEGElVg: calls $0.25
xrf8tAXKQHG99HixCot1Iw: folds 
u3Ol7kv1LmvszuHNm9rc6w: folds 
6hUmfDYq+83kvxWoTBQmfw: raises $1 to $1.25
FzAsD5THdVHZrHrSzc4boA: folds 
aogAb4Eienxztk8p2v9VVw: folds 
KYBwVA7jgmSrbIEbEGElVg: calls $1
*** FLOP *** [5c Kd 6s]
KYBwVA7jgmSrbIEbEGElVg: checks 
6hUmfDYq+83kvxWoTBQmfw: bets $2
KYBwVA7jgmSrbIEbEGElVg: folds 
Uncalled bet ($2) returned to 6hUmfDYq+83kvxWoTBQmfw
6hUmfDYq+83kvxWoTBQmfw collected $2.75 from pot
*** SUMMARY ***
Total pot $2.85 | Rake $0.10 
Board [5c Kd 6s]
Seat 1: u3Ol7kv1LmvszuHNm9rc6w folded before Flop (didn't bet)
Seat 2: 6hUmfDYq+83kvxWoTBQmfw (button) collected ($2.75)
Seat 3: FzAsD5THdVHZrHrSzc4boA (small blind) folded before Flop
Seat 4: aogAb4Eienxztk8p2v9VVw (big blind) folded before Flop
Seat 5: KYBwVA7jgmSrbIEbEGElVg folded on the Flop
Seat 6: xrf8tAXKQHG99HixCot1Iw folded before Flop (didn't bet)




PokerStars Game #59941951416:  Hold'em No Limit ($0.10/$0.25) - 2009/07/01 1:51:22 ET
Table 'NtCSSONEf1zaJo3042tQug' 6-max Seat #2 is the button
Seat 1: KXtdqb+rIMkjc0RvHDksGQ ($31.15 in chips) 
Seat 2: vqWjZmdQu/Hxw96/IJTWdQ ($25 in chips) 
Seat 3: 9kUKGKkblnIx3m8rlVol6Q ($14.40 in chips) 
Seat 5: tOAk1Og4mVObMBOfvdDYOw ($34.40 in chips) 
Seat 6: LxehwDpTQ19ph4Qmc78+Pw ($35.35 in chips) 
9kUKGKkblnIx3m8rlVol6Q: posts small blind $0.10
HxD1kB8zCmalQSdWAkKmlg: is sitting out 
tOAk1Og4mVObMBOfvdDYOw: posts big blind $0.25
*** HOLE CARDS ***
HxD1kB8zCmalQSdWAkKmlg leaves the table
LxehwDpTQ19ph4Qmc78+Pw: folds 
KXtdqb+rIMkjc0RvHDksGQ: folds 
vqWjZmdQu/Hxw96/IJTWdQ: folds 
9kUKGKkblnIx3m8rlVol6Q: raises $0.75 to $1
tOAk1Og4mVObMBOfvdDYOw: calls $0.75
*** FLOP *** [2c 7d Ts]
9kUKGKkblnIx3m8rlVol6Q: checks 
tOAk1Og4mVObMBOfvdDYOw: bets $1.25
9kUKGKkblnIx3m8rlVol6Q: folds 
Uncalled bet ($1.25) returned to tOAk1Og4mVObMBOfvdDYOw
tOAk1Og4mVObMBOfvdDYOw collected $1.90 from pot
tOAk1Og4mVObMBOfvdDYOw: doesn't show hand 
*** SUMMARY ***
Total pot $2 | Rake $0.10 
Board [2c 7d Ts]
Seat 1: KXtdqb+rIMkjc0RvHDksGQ folded before Flop (didn't bet)
Seat 2: vqWjZmdQu/Hxw96/IJTWdQ (button) folded before Flop (didn't bet)
Seat 3: 9kUKGKkblnIx3m8rlVol6Q (small blind) folded on the Flop
Seat 5: tOAk1Og4mVObMBOfvdDYOw (big blind) collected ($1.90)
Seat 6: LxehwDpTQ19ph4Qmc78+Pw folded before Flop (didn't bet)




PokerStars Game #59941951800:  Hold'em No Limit ($0.10/$0.25) - 2009/07/01 1:51:22 ET
Table 'NtEQAxCeIK2io1CGtW658g' 6-max Seat #6 is the button
Seat 1: X437kMQ7AujoaDgjguhU9w ($10.80 in chips) 
Seat 2: DgyznDqq/mLiCqQGMzc+Aw ($8.40 in chips) 
Seat 3: 5nwDw10uIM0XEyLhla0oGA ($25 in chips) 
Seat 4: 8296 ($17.65 in chips) 
Seat 6: /gJNBeCkWL4o85/jvlZ4BA ($70.70 in chips) 
X437kMQ7AujoaDgjguhU9w: posts small blind $0.10
DgyznDqq/mLiCqQGMzc+Aw: posts big blind $0.25
*** HOLE CARDS ***
5nwDw10uIM0XEyLhla0oGA: folds 
8296: calls $0.25
/gJNBeCkWL4o85/jvlZ4BA: folds 
X437kMQ7AujoaDgjguhU9w: calls $0.15
DgyznDqq/mLiCqQGMzc+Aw: checks 
*** FLOP *** [Ks 2d Jd]
X437kMQ7AujoaDgjguhU9w: bets $0.25
DgyznDqq/mLiCqQGMzc+Aw: folds 
8296: calls $0.25
*** TURN *** [Ks 2d Jd] [Js]
X437kMQ7AujoaDgjguhU9w: bets $0.50
8296: calls $0.50
*** RIVER *** [Ks 2d Jd Js] [6c]
X437kMQ7AujoaDgjguhU9w: bets $1
8296: calls $1
*** SHOW DOWN ***
X437kMQ7AujoaDgjguhU9w: shows [Kc 5d] (two pair, Kings and Jacks)
8296: mucks hand 
X437kMQ7AujoaDgjguhU9w collected $4.05 from pot
*** SUMMARY ***
Total pot $4.25 | Rake $0.20 
Board [Ks 2d Jd Js 6c]
Seat 1: X437kMQ7AujoaDgjguhU9w (small blind) showed [Kc 5d] and won ($4.05) with two pair, Kings and Jacks
Seat 2: DgyznDqq/mLiCqQGMzc+Aw (big blind) folded on the Flop
Seat 3: 5nwDw10uIM0XEyLhla0oGA folded before Flop (didn't bet)
Seat 4: 8296 mucked
Seat 6: /gJNBeCkWL4o85/jvlZ4BA (button) folded before Flop (didn't bet)




PokerStars Game #59941952024:  Hold'em No Limit ($0.10/$0.25) - 2009/07/01 1:51:23 ET
Table 'dVzscin98UhGisTmV9BDcw' 9-max Seat #5 is the button
Seat 1: sBAwXpkpgyhyWbHIQcIJKA ($17.15 in chips) 
Seat 2: dfNim92Z6XK1/h5SFW5vDg ($38.50 in chips) 
Seat 3: cZ99hugmLBj9KhTlc8nCSw ($25 in chips) 
Seat 5: E0iYnEVO2ho7dH3QcCjw7g ($24.55 in chips) 
Seat 6: A/OkFabqdcrG3ozpiYMiNQ ($25 in chips) 
Seat 7: cKlmpQMahVsmOaxFQDcoOg ($25.25 in chips) 
Seat 8: /vn2Qu2dvc9AMMq46Ae0jA ($35.50 in chips) 
Seat 9: arxNSjreDRGFg13EAM2F1w ($25 in chips) 
A/OkFabqdcrG3ozpiYMiNQ: posts small blind $0.10
cKlmpQMahVsmOaxFQDcoOg: posts big blind $0.25
*** HOLE CARDS ***
/vn2Qu2dvc9AMMq46Ae0jA: folds 
arxNSjreDRGFg13EAM2F1w: folds 
sBAwXpkpgyhyWbHIQcIJKA: folds 
dfNim92Z6XK1/h5SFW5vDg: folds 
cZ99hugmLBj9KhTlc8nCSw: folds 
E0iYnEVO2ho7dH3QcCjw7g: raises $0.75 to $1
A/OkFabqdcrG3ozpiYMiNQ: folds 
cKlmpQMahVsmOaxFQDcoOg: folds 
Uncalled bet ($0.75) returned to E0iYnEVO2ho7dH3QcCjw7g
E0iYnEVO2ho7dH3QcCjw7g collected $0.60 from pot
*** SUMMARY ***
Total pot $0.60 | Rake $0 
Seat 1: sBAwXpkpgyhyWbHIQcIJKA folded before Flop (didn't bet)
Seat 2: dfNim92Z6XK1/h5SFW5vDg folded before Flop (didn't bet)
Seat 3: cZ99hugmLBj9KhTlc8nCSw folded before Flop (didn't bet)
Seat 5: E0iYnEVO2ho7dH3QcCjw7g (button) collected ($0.60)
Seat 6: A/OkFabqdcrG3ozpiYMiNQ (small blind) folded before Flop
Seat 7: cKlmpQMahVsmOaxFQDcoOg (big blind) folded before Flop
Seat 8: /vn2Qu2dvc9AMMq46Ae0jA folded before Flop (didn't bet)
Seat 9: arxNSjreDRGFg13EAM2F1w folded before Flop (didn't bet)




PokerStars Game #59941952180:  Hold'em No Limit ($0.10/$0.25) - 2009/07/01 1:51:23 ET
Table 'AJGgX1ZYM8d68SWMvaLttg' 6-max Seat #1 is the button
Seat 1: Q1uciOZPBR/WkAlqa6cL4A ($25 in chips) 
Seat 2: zHHLkD2sRljslKKeQv/ZQw ($25 in chips) 
Seat 3: 8ClCHtFXGNplITm+63KB+Q ($38.95 in chips) 
Seat 4: e30C3DfdG5TfPnR16/oMmA ($21.75 in chips) 
Seat 6: UA5OsKS3VPaxa7uC8La/kA ($64 in chips) 
zHHLkD2sRljslKKeQv/ZQw: posts small blind $0.10
8ClCHtFXGNplITm+63KB+Q: posts big blind $0.25
*** HOLE CARDS ***
e30C3DfdG5TfPnR16/oMmA: folds 
UA5OsKS3VPaxa7uC8La/kA: raises $0.50 to $0.75
Q1uciOZPBR/WkAlqa6cL4A: folds 
zHHLkD2sRljslKKeQv/ZQw: calls $0.65
GbCVUNssQ7mqsPWr7J4d3w joins the table at seat #5 
8ClCHtFXGNplITm+63KB+Q: folds 
*** FLOP *** [Ac 8h Ts]
zHHLkD2sRljslKKeQv/ZQw: checks 
UA5OsKS3VPaxa7uC8La/kA: bets $1
zHHLkD2sRljslKKeQv/ZQw: calls $1
*** TURN *** [Ac 8h Ts] [7d]
zHHLkD2sRljslKKeQv/ZQw: checks 
UA5OsKS3VPaxa7uC8La/kA: checks 
*** RIVER *** [Ac 8h Ts 7d] [4h]
zHHLkD2sRljslKKeQv/ZQw: bets $2
UA5OsKS3VPaxa7uC8La/kA: folds 
Uncalled bet ($2) returned to zHHLkD2sRljslKKeQv/ZQw
zHHLkD2sRljslKKeQv/ZQw collected $3.60 from pot
*** SUMMARY ***
Total pot $3.75 | Rake $0.15 
Board [Ac 8h Ts 7d 4h]
Seat 1: Q1uciOZPBR/WkAlqa6cL4A (button) folded before Flop (didn't bet)
Seat 2: zHHLkD2sRljslKKeQv/ZQw (small blind) collected ($3.60)
Seat 3: 8ClCHtFXGNplITm+63KB+Q (big blind) folded before Flop
Seat 4: e30C3DfdG5TfPnR16/oMmA folded before Flop (didn't bet)
Seat 6: UA5OsKS3VPaxa7uC8La/kA folded on the River




PokerStars Game #59941952090:  Hold'em No Limit ($0.10/$0.25) - 2009/07/01 1:51:23 ET
Table 'S6s+TmTlAjLHclBRvN5/fw' 9-max Seat #5 is the button
Seat 3: z2SmIaQ3+5n/eY1BN5HgPg ($7.45 in chips) 
Seat 4: RSal7+azPhXeqQO5L8XPfg ($17.60 in chips) 
Seat 5: 8hSJOE8UscCqt6t47gp0/g ($8.80 in chips) 
Seat 6: QkBggokTsSaL9vRv6V8nzQ ($9.85 in chips) 
QkBggokTsSaL9vRv6V8nzQ: posts small blind $0.10
z2SmIaQ3+5n/eY1BN5HgPg: posts big blind $0.25
*** HOLE CARDS ***
RSal7+azPhXeqQO5L8XPfg: calls $0.25
8hSJOE8UscCqt6t47gp0/g: calls $0.25
QkBggokTsSaL9vRv6V8nzQ: calls $0.15
z2SmIaQ3+5n/eY1BN5HgPg: raises $1.25 to $1.50
RSal7+azPhXeqQO5L8XPfg: folds 
8hSJOE8UscCqt6t47gp0/g: calls $1.25
QkBggokTsSaL9vRv6V8nzQ: calls $1.25
*** FLOP *** [4h Ad 8d]
QkBggokTsSaL9vRv6V8nzQ: bets $2.50
z2SmIaQ3+5n/eY1BN5HgPg: raises $3.45 to $5.95 and is all-in
8hSJOE8UscCqt6t47gp0/g: folds 
QkBggokTsSaL9vRv6V8nzQ: folds 
Uncalled bet ($3.45) returned to z2SmIaQ3+5n/eY1BN5HgPg
z2SmIaQ3+5n/eY1BN5HgPg collected $9.30 from pot
z2SmIaQ3+5n/eY1BN5HgPg: doesn't show hand 
*** SUMMARY ***
Total pot $9.75 | Rake $0.45 
Board [4h Ad 8d]
Seat 3: z2SmIaQ3+5n/eY1BN5HgPg (big blind) collected ($9.30)
Seat 4: RSal7+azPhXeqQO5L8XPfg folded before Flop
Seat 5: 8hSJOE8UscCqt6t47gp0/g (button) folded on the Flop
Seat 6: QkBggokTsSaL9vRv6V8nzQ (small blind) folded on the Flop




PokerStars Game #59941952656:  Hold'em No Limit ($0.10/$0.25) - 2009/07/01 1:51:24 ET
Table 'JPFXJXa5xBkjZ/W15BKqeQ' 9-max Seat #3 is the button
Seat 1: zgi+EUykT/pZQpoUG6+oEg ($4.75 in chips) 
Seat 2: XMSS6mD5B42I8wasdOMipQ ($12.75 in chips) 
Seat 3: 56S3mA6Zs3pGR+0p0vUCtg ($19.20 in chips) 
Seat 4: wGigCmBR/9XWkPpvYos3aQ ($32.65 in chips) 
Seat 5: cZ99hugmLBj9KhTlc8nCSw ($25.60 in chips) 
Seat 6: tLcDklc2rBORNfixyRfVfw ($25 in chips) 
Seat 7: PdIasPkzm2sqZnN41ZRXOg ($5 in chips) 
Seat 9: V6p0jQ/RhUsqpHLmXvEX4Q ($12.25 in chips) 
wGigCmBR/9XWkPpvYos3aQ: posts small blind $0.10
cZ99hugmLBj9KhTlc8nCSw: posts big blind $0.25
*** HOLE CARDS ***
tLcDklc2rBORNfixyRfVfw: folds 
PdIasPkzm2sqZnN41ZRXOg: folds 
V6p0jQ/RhUsqpHLmXvEX4Q: folds 
zgi+EUykT/pZQpoUG6+oEg: folds 
XMSS6mD5B42I8wasdOMipQ: folds 
56S3mA6Zs3pGR+0p0vUCtg: raises $1 to $1.25
wGigCmBR/9XWkPpvYos3aQ: folds 
cZ99hugmLBj9KhTlc8nCSw: folds 
Uncalled bet ($1) returned to 56S3mA6Zs3pGR+0p0vUCtg
56S3mA6Zs3pGR+0p0vUCtg collected $0.60 from pot
56S3mA6Zs3pGR+0p0vUCtg: doesn't show hand 
*** SUMMARY ***
Total pot $0.60 | Rake $0 
Seat 1: zgi+EUykT/pZQpoUG6+oEg folded before Flop (didn't bet)
Seat 2: XMSS6mD5B42I8wasdOMipQ folded before Flop (didn't bet)
Seat 3: 56S3mA6Zs3pGR+0p0vUCtg (button) collected ($0.60)
Seat 4: wGigCmBR/9XWkPpvYos3aQ (small blind) folded before Flop
Seat 5: cZ99hugmLBj9KhTlc8nCSw (big blind) folded before Flop
Seat 6: tLcDklc2rBORNfixyRfVfw folded before Flop (didn't bet)
Seat 7: PdIasPkzm2sqZnN41ZRXOg folded before Flop (didn't bet)
Seat 9: V6p0jQ/RhUsqpHLmXvEX4Q folded before Flop (didn't bet)




PokerStars Game #59941952706:  Hold'em No Limit ($0.10/$0.25) - 2009/07/01 1:51:24 ET
Table 'ukli1Y7ieC5JQMTEFxM2Nw' 6-max Seat #3 is the button
Seat 1: ukgMpMoFTQKuBqKbuPdCgg ($12 in chips) 
Seat 3: ExeoJ1G/rSmWa3tRz7TlCA ($24.50 in chips) 
Seat 4: if4dh6jhJXeN3/qd3qCp9g ($26.50 in chips) 
Seat 5: Se+H4Z4PDr6+eIUDJX1rpg ($17.15 in chips) 
Seat 6: 32YL2ZEp8NT4JB2RVM9euQ ($32 in chips) 
if4dh6jhJXeN3/qd3qCp9g: posts small blind $0.10
Se+H4Z4PDr6+eIUDJX1rpg: posts big blind $0.25
ukgMpMoFTQKuBqKbuPdCgg: posts big blind $0.25
i9LqF5rD3bvtbEE7HWgr3Q: sits out 
*** HOLE CARDS ***
32YL2ZEp8NT4JB2RVM9euQ: folds 
ukgMpMoFTQKuBqKbuPdCgg: raises $0.25 to $0.50
ExeoJ1G/rSmWa3tRz7TlCA: folds 
if4dh6jhJXeN3/qd3qCp9g: folds 
Se+H4Z4PDr6+eIUDJX1rpg: calls $0.25
*** FLOP *** [6c 4h 8h]
Se+H4Z4PDr6+eIUDJX1rpg: checks 
ukgMpMoFTQKuBqKbuPdCgg: bets $1.25
Se+H4Z4PDr6+eIUDJX1rpg: calls $1.25
*** TURN *** [6c 4h 8h] [2d]
Se+H4Z4PDr6+eIUDJX1rpg: checks 
ukgMpMoFTQKuBqKbuPdCgg: checks 
*** RIVER *** [6c 4h 8h 2d] [4d]
Se+H4Z4PDr6+eIUDJX1rpg: bets $2.50
ukgMpMoFTQKuBqKbuPdCgg: folds 
Uncalled bet ($2.50) returned to Se+H4Z4PDr6+eIUDJX1rpg
Se+H4Z4PDr6+eIUDJX1rpg collected $3.45 from pot
*** SUMMARY ***
Total pot $3.60 | Rake $0.15 
Board [6c 4h 8h 2d 4d]
Seat 1: ukgMpMoFTQKuBqKbuPdCgg folded on the River
Seat 3: ExeoJ1G/rSmWa3tRz7TlCA (button) folded before Flop (didn't bet)
Seat 4: if4dh6jhJXeN3/qd3qCp9g (small blind) folded before Flop
Seat 5: Se+H4Z4PDr6+eIUDJX1rpg (big blind) collected ($3.45)
Seat 6: 32YL2ZEp8NT4JB2RVM9euQ folded before Flop (didn't bet)




PokerStars Game #59941952858:  Hold'em No Limit ($0.10/$0.25) - 2009/07/01 1:51:24 ET
Table 'vZfV/Uj0q8joA1du9sRJSg' 6-max Seat #4 is the button
Seat 2: wMiE3yTbDJGOLOF9th7KPA ($12.65 in chips) 
Seat 3: cWc85bEzdRzpUMhRKm8pwQ ($25 in chips) 
Seat 4: v+QfkGiuj9bgtuNoVnDO8w ($43.15 in chips) 
Seat 5: kyRaCIljYA6l33lSKQfNsg ($29.05 in chips) 
Seat 6: 8ClCHtFXGNplITm+63KB+Q ($47.70 in chips) 
kyRaCIljYA6l33lSKQfNsg: posts small blind $0.10
8ClCHtFXGNplITm+63KB+Q: posts big blind $0.25
*** HOLE CARDS ***
MVzl6OsGybVDNd3Vr9LYAA joins the table at seat #1 
wMiE3yTbDJGOLOF9th7KPA: raises $0.25 to $0.50
cWc85bEzdRzpUMhRKm8pwQ: folds 
v+QfkGiuj9bgtuNoVnDO8w: folds 
kyRaCIljYA6l33lSKQfNsg: folds 
8ClCHtFXGNplITm+63KB+Q: folds 
Uncalled bet ($0.25) returned to wMiE3yTbDJGOLOF9th7KPA
wMiE3yTbDJGOLOF9th7KPA collected $0.60 from pot
*** SUMMARY ***
Total pot $0.60 | Rake $0 
Seat 2: wMiE3yTbDJGOLOF9th7KPA collected ($0.60)
Seat 3: cWc85bEzdRzpUMhRKm8pwQ folded before Flop (didn't bet)
Seat 4: v+QfkGiuj9bgtuNoVnDO8w (button) folded before Flop (didn't bet)
Seat 5: kyRaCIljYA6l33lSKQfNsg (small blind) folded before Flop
Seat 6: 8ClCHtFXGNplITm+63KB+Q (big blind) folded before Flop




PokerStars Game #59941952830:  Hold'em No Limit ($0.10/$0.25) - 2009/07/01 1:51:24 ET
Table 'P2yJ+jwfNsBdF12fLKA6DQ' 9-max Seat #4 is the button
Seat 1: zDrucyjVn5aeekNEc3cJrA ($22.20 in chips) 
Seat 2: uQwmfH5LEVA5eyghJdyPUg ($14.90 in chips) 
Seat 3: 8EbrQ/EvFWt2cr0GaU82gQ ($4.65 in chips) 
Seat 4: 6NLAWFPZZfqlVkY8n9RULA ($13.40 in chips) 
Seat 5: B7VAFAMs/PYlYABlV+EkSA ($7.55 in chips) 
Seat 6: mUoFJKqCzIUABvOFbiINlQ ($14 in chips) 
Seat 7: yQc5nLaNmByxI15Jegu61w ($17.40 in chips) 
Seat 8: LMd3gq2uNfbWTfXTnSeQRw ($9.85 in chips) 
Seat 9: dN5zq7QdZCUe7NZFM6cECg ($20 in chips) 
B7VAFAMs/PYlYABlV+EkSA: posts small blind $0.10
mUoFJKqCzIUABvOFbiINlQ: posts big blind $0.25
*** HOLE CARDS ***
yQc5nLaNmByxI15Jegu61w: folds 
LMd3gq2uNfbWTfXTnSeQRw: calls $0.25
dN5zq7QdZCUe7NZFM6cECg: folds 
zDrucyjVn5aeekNEc3cJrA: folds 
uQwmfH5LEVA5eyghJdyPUg: folds 
8EbrQ/EvFWt2cr0GaU82gQ: folds 
6NLAWFPZZfqlVkY8n9RULA: folds 
B7VAFAMs/PYlYABlV+EkSA: calls $0.15
mUoFJKqCzIUABvOFbiINlQ: checks 
*** FLOP *** [Jd Qc 7c]
B7VAFAMs/PYlYABlV+EkSA: checks 
mUoFJKqCzIUABvOFbiINlQ: checks 
LMd3gq2uNfbWTfXTnSeQRw: checks 
*** TURN *** [Jd Qc 7c] [2s]
B7VAFAMs/PYlYABlV+EkSA: checks 
mUoFJKqCzIUABvOFbiINlQ: bets $0.25
LMd3gq2uNfbWTfXTnSeQRw: calls $0.25
B7VAFAMs/PYlYABlV+EkSA: folds 
*** RIVER *** [Jd Qc 7c 2s] [3c]
mUoFJKqCzIUABvOFbiINlQ: bets $0.25
LMd3gq2uNfbWTfXTnSeQRw: raises $0.50 to $0.75
mUoFJKqCzIUABvOFbiINlQ: calls $0.50
*** SHOW DOWN ***
LMd3gq2uNfbWTfXTnSeQRw: shows [6c 5c] (a flush, Queen high)
mUoFJKqCzIUABvOFbiINlQ: mucks hand 
LMd3gq2uNfbWTfXTnSeQRw collected $2.65 from pot
*** SUMMARY ***
Total pot $2.75 | Rake $0.10 
Board [Jd Qc 7c 2s 3c]
Seat 1: zDrucyjVn5aeekNEc3cJrA folded before Flop (didn't bet)
Seat 2: uQwmfH5LEVA5eyghJdyPUg folded before Flop (didn't bet)
Seat 3: 8EbrQ/EvFWt2cr0GaU82gQ folded before Flop (didn't bet)
Seat 4: 6NLAWFPZZfqlVkY8n9RULA (button) folded before Flop (didn't bet)
Seat 5: B7VAFAMs/PYlYABlV+EkSA (small blind) folded on the Turn
Seat 6: mUoFJKqCzIUABvOFbiINlQ (big blind) mucked
Seat 7: yQc5nLaNmByxI15Jegu61w folded before Flop (didn't bet)
Seat 8: LMd3gq2uNfbWTfXTnSeQRw showed [6c 5c] and won ($2.65) with a flush, Queen high
Seat 9: dN5zq7QdZCUe7NZFM6cECg folded before Flop (didn't bet)




PokerStars Game #59941952840:  Hold'em No Limit ($0.10/$0.25) - 2009/07/01 1:51:24 ET
Table '3EebBlzq5yHSY2444L4zlg' 9-max Seat #2 is the button
Seat 1: XMSS6mD5B42I8wasdOMipQ ($29.50 in chips) 
Seat 2: b9UnopCOpq2MWP1DwqSO3Q ($17.35 in chips) 
Seat 3: 18G4P1XstjNvItdGUITxgw ($25 in chips) 
Seat 4: PdIasPkzm2sqZnN41ZRXOg ($5 in chips) 
Seat 5: PFNLAvMkr8qKc7xCiH0wTA ($51.95 in chips) 
Seat 6: QEbIGci+itdw+re8RM5fZA ($50 in chips) 
Seat 7: DiSvPC2iudwL5j9u6Huyww ($49.60 in chips) 
Seat 8: dtZ84flFEi4Q+SGrHMJRDQ ($28.70 in chips) 
Seat 9: iZmSlSzYu5fJ67tDdQzymQ ($23.90 in chips) 
18G4P1XstjNvItdGUITxgw: posts small blind $0.10
PdIasPkzm2sqZnN41ZRXOg: posts big blind $0.25
*** HOLE CARDS ***
PFNLAvMkr8qKc7xCiH0wTA: folds 
QEbIGci+itdw+re8RM5fZA: folds 
DiSvPC2iudwL5j9u6Huyww: folds 
dtZ84flFEi4Q+SGrHMJRDQ: raises $0.75 to $1
iZmSlSzYu5fJ67tDdQzymQ: folds 
XMSS6mD5B42I8wasdOMipQ: calls $1
b9UnopCOpq2MWP1DwqSO3Q: folds 
18G4P1XstjNvItdGUITxgw: folds 
PdIasPkzm2sqZnN41ZRXOg: folds 
*** FLOP *** [Ac 4d 9h]
dtZ84flFEi4Q+SGrHMJRDQ: checks 
XMSS6mD5B42I8wasdOMipQ: checks 
*** TURN *** [Ac 4d 9h] [2s]
dtZ84flFEi4Q+SGrHMJRDQ: bets $0.75
XMSS6mD5B42I8wasdOMipQ: calls $0.75
*** RIVER *** [Ac 4d 9h 2s] [2h]
dtZ84flFEi4Q+SGrHMJRDQ: bets $0.75
XMSS6mD5B42I8wasdOMipQ: calls $0.75
*** SHOW DOWN ***
dtZ84flFEi4Q+SGrHMJRDQ: shows [Qs Qc] (two pair, Queens and Deuces)
XMSS6mD5B42I8wasdOMipQ: mucks hand 
dtZ84flFEi4Q+SGrHMJRDQ collected $5.10 from pot
*** SUMMARY ***
Total pot $5.35 | Rake $0.25 
Board [Ac 4d 9h 2s 2h]
Seat 1: XMSS6mD5B42I8wasdOMipQ mucked
Seat 2: b9UnopCOpq2MWP1DwqSO3Q (button) folded before Flop (didn't bet)
Seat 3: 18G4P1XstjNvItdGUITxgw (small blind) folded before Flop
Seat 4: PdIasPkzm2sqZnN41ZRXOg (big blind) folded before Flop
Seat 5: PFNLAvMkr8qKc7xCiH0wTA folded before Flop (didn't bet)
Seat 6: QEbIGci+itdw+re8RM5fZA folded before Flop (didn't bet)
Seat 7: DiSvPC2iudwL5j9u6Huyww folded before Flop (didn't bet)
Seat 8: dtZ84flFEi4Q+SGrHMJRDQ showed [Qs Qc] and won ($5.10) with two pair, Queens and Deuces
Seat 9: iZmSlSzYu5fJ67tDdQzymQ folded before Flop (didn't bet)




PokerStars Game #59941952826:  Hold'em No Limit ($0.10/$0.25) - 2009/07/01 1:51:24 ET
Table '2O5CgfSkSwrr4PDrlZ1RLQ' 6-max Seat #4 is the button
Seat 1: 3skmHD9EOATKdUzzyHh1KA ($31.60 in chips) 
Seat 2: wqphQtauX5Qn7WRJZS1flA ($29.10 in chips) 
Seat 3: oBUDUfeUyCbZBsjxHZgSiw ($20.50 in chips) 
Seat 4: epAUIB7h2FJXzUPRIvSkRA ($25 in chips) 
Seat 5: 0av6tRNdi0Ui4f15L7gsVg ($23.65 in chips) 
Seat 6: tj9xqoqQaDaFw7u1oyZrtA ($52.90 in chips) 
0av6tRNdi0Ui4f15L7gsVg: posts small blind $0.10
tj9xqoqQaDaFw7u1oyZrtA: posts big blind $0.25
*** HOLE CARDS ***
3skmHD9EOATKdUzzyHh1KA: folds 
wqphQtauX5Qn7WRJZS1flA: raises $0.50 to $0.75
oBUDUfeUyCbZBsjxHZgSiw: calls $0.75
epAUIB7h2FJXzUPRIvSkRA: folds 
0av6tRNdi0Ui4f15L7gsVg: folds 
tj9xqoqQaDaFw7u1oyZrtA: calls $0.50
*** FLOP *** [Ah 2s 2h]
tj9xqoqQaDaFw7u1oyZrtA: checks 
wqphQtauX5Qn7WRJZS1flA: bets $2
oBUDUfeUyCbZBsjxHZgSiw: folds 
tj9xqoqQaDaFw7u1oyZrtA: calls $2
*** TURN *** [Ah 2s 2h] [3c]
tj9xqoqQaDaFw7u1oyZrtA: checks 
wqphQtauX5Qn7WRJZS1flA: bets $3
tj9xqoqQaDaFw7u1oyZrtA: calls $3
*** RIVER *** [Ah 2s 2h 3c] [7c]
tj9xqoqQaDaFw7u1oyZrtA: checks 
wqphQtauX5Qn7WRJZS1flA: checks 
*** SHOW DOWN ***
tj9xqoqQaDaFw7u1oyZrtA: shows [9h Jh] (a pair of Deuces)
wqphQtauX5Qn7WRJZS1flA: shows [Qh Qd] (two pair, Queens and Deuces)
wqphQtauX5Qn7WRJZS1flA collected $11.75 from pot
*** SUMMARY ***
Total pot $12.35 | Rake $0.60 
Board [Ah 2s 2h 3c 7c]
Seat 1: 3skmHD9EOATKdUzzyHh1KA folded before Flop (didn't bet)
Seat 2: wqphQtauX5Qn7WRJZS1flA showed [Qh Qd] and won ($11.75) with two pair, Queens and Deuces
Seat 3: oBUDUfeUyCbZBsjxHZgSiw folded on the Flop
Seat 4: epAUIB7h2FJXzUPRIvSkRA (button) folded before Flop (didn't bet)
Seat 5: 0av6tRNdi0Ui4f15L7gsVg (small blind) folded before Flop
Seat 6: tj9xqoqQaDaFw7u1oyZrtA (big blind) showed [9h Jh] and lost with a pair of Deuces




PokerStars Game #59941952430:  Hold'em No Limit ($0.10/$0.25) - 2009/07/01 1:51:24 ET
Table 'edvgY2YQ1I34euq4EVqGnA' 6-max Seat #2 is the button
Seat 1: mvFHK3pE7tCxJEqLjKC70Q ($30.70 in chips) 
Seat 2: Hsvkc0/G2VV78oVmWYXecw ($5 in chips) 
Seat 3: muaYRdOUlJzdJ0zHxvRGlQ ($14.75 in chips) 
Seat 4: TI/C5Q+DEl4fLR3AofwYdg ($22.60 in chips) 
Seat 5: EE16Ua5b1HSsYej5zeXOlA ($57.25 in chips) 
Seat 6: kG34n23qFQA3nzdOJTQ1dA ($70.40 in chips) 
muaYRdOUlJzdJ0zHxvRGlQ: posts small blind $0.10
TI/C5Q+DEl4fLR3AofwYdg: posts big blind $0.25
*** HOLE CARDS ***
EE16Ua5b1HSsYej5zeXOlA: folds 
kG34n23qFQA3nzdOJTQ1dA: folds 
mvFHK3pE7tCxJEqLjKC70Q: folds 
Hsvkc0/G2VV78oVmWYXecw: folds 
Hsvkc0/G2VV78oVmWYXecw leaves the table
muaYRdOUlJzdJ0zHxvRGlQ: raises $0.25 to $0.50
TI/C5Q+DEl4fLR3AofwYdg: calls $0.25
*** FLOP *** [8d Kh Jc]
muaYRdOUlJzdJ0zHxvRGlQ: bets $0.75
TI/C5Q+DEl4fLR3AofwYdg: folds 
Uncalled bet ($0.75) returned to muaYRdOUlJzdJ0zHxvRGlQ
muaYRdOUlJzdJ0zHxvRGlQ collected $0.95 from pot
*** SUMMARY ***
Total pot $1 | Rake $0.05 
Board [8d Kh Jc]
Seat 1: mvFHK3pE7tCxJEqLjKC70Q folded before Flop (didn't bet)
Seat 2: Hsvkc0/G2VV78oVmWYXecw (button) folded before Flop (didn't bet)
Seat 3: muaYRdOUlJzdJ0zHxvRGlQ (small blind) collected ($0.95)
Seat 4: TI/C5Q+DEl4fLR3AofwYdg (big blind) folded on the Flop
Seat 5: EE16Ua5b1HSsYej5zeXOlA folded before Flop (didn't bet)
Seat 6: kG34n23qFQA3nzdOJTQ1dA folded before Flop (didn't bet)




PokerStars Game #59941953322:  Hold'em No Limit ($0.10/$0.25) - 2009/07/01 1:51:25 ET
Table 'xPn6TS/y/OWkX7Qa+MUuKA' 6-max Seat #1 is the button
Seat 1: JFIAqU8lCZ0vWwEl4bdGsg ($42.35 in chips) 
Seat 2: buyjetgNT1McXtdaP4zynA ($34.95 in chips) 
Seat 3: q6WfTUAD9mowIP63ASq2Dg ($24.15 in chips) 
Seat 4: SS/yfeArhULzIcOPe8MdPg ($25 in chips) 
Seat 5: w3cELw9vjLM+p8ojn/uZvQ ($5 in chips) 
Seat 6: DihMHaz4WNETH1bPDe13kA ($25 in chips) 
buyjetgNT1McXtdaP4zynA: posts small blind $0.10
q6WfTUAD9mowIP63ASq2Dg: posts big blind $0.25
w3cELw9vjLM+p8ojn/uZvQ: posts big blind $0.25
*** HOLE CARDS ***
SS/yfeArhULzIcOPe8MdPg said, "god..."
SS/yfeArhULzIcOPe8MdPg said, "wat u hav?"
SS/yfeArhULzIcOPe8MdPg said, "i had AQ..."
SS/yfeArhULzIcOPe8MdPg: folds 
w3cELw9vjLM+p8ojn/uZvQ: checks 
DihMHaz4WNETH1bPDe13kA: folds 
JFIAqU8lCZ0vWwEl4bdGsg: folds 
buyjetgNT1McXtdaP4zynA: folds 
q6WfTUAD9mowIP63ASq2Dg: checks 
*** FLOP *** [Ks Ah 8s]
buyjetgNT1McXtdaP4zynA leaves the table
q6WfTUAD9mowIP63ASq2Dg: checks 
w3cELw9vjLM+p8ojn/uZvQ: bets $0.50
q6WfTUAD9mowIP63ASq2Dg: folds 
Uncalled bet ($0.50) returned to w3cELw9vjLM+p8ojn/uZvQ
w3cELw9vjLM+p8ojn/uZvQ collected $0.60 from pot
w3cELw9vjLM+p8ojn/uZvQ: doesn't show hand 
*** SUMMARY ***
Total pot $0.60 | Rake $0 
Board [Ks Ah 8s]
Seat 1: JFIAqU8lCZ0vWwEl4bdGsg (button) folded before Flop (didn't bet)
Seat 2: buyjetgNT1McXtdaP4zynA (small blind) folded before Flop
Seat 3: q6WfTUAD9mowIP63ASq2Dg (big blind) folded on the Flop
Seat 4: SS/yfeArhULzIcOPe8MdPg folded before Flop (didn't bet)
Seat 5: w3cELw9vjLM+p8ojn/uZvQ collected ($0.60)
Seat 6: DihMHaz4WNETH1bPDe13kA folded before Flop (didn't bet)




PokerStars Game #59941953174:  Hold'em No Limit ($0.10/$0.25) - 2009/07/01 1:51:25 ET
Table '5SUMWYuPsGiOD0FY0QbgOw' 6-max Seat #2 is the button
Seat 1: SFmT9ZsVopnukjvAzrxTRg ($25 in chips) 
Seat 2: xrf8tAXKQHG99HixCot1Iw ($41.25 in chips) 
Seat 3: i9LqF5rD3bvtbEE7HWgr3Q ($25 in chips) 
Seat 4: BV+K0Phf5VBHr7aZPKqbUQ ($26.10 in chips) 
Seat 5: v+QfkGiuj9bgtuNoVnDO8w ($40.45 in chips) 
Seat 6: jA7YMtfNUnAaebB7Lj74EA ($23.15 in chips) 
i9LqF5rD3bvtbEE7HWgr3Q: posts small blind $0.10
BV+K0Phf5VBHr7aZPKqbUQ: posts big blind $0.25
*** HOLE CARDS ***
v+QfkGiuj9bgtuNoVnDO8w: folds 
jA7YMtfNUnAaebB7Lj74EA: calls $0.25
SFmT9ZsVopnukjvAzrxTRg: folds 
xrf8tAXKQHG99HixCot1Iw: raises $0.75 to $1
i9LqF5rD3bvtbEE7HWgr3Q: raises $2.50 to $3.50
BV+K0Phf5VBHr7aZPKqbUQ: folds 
jA7YMtfNUnAaebB7Lj74EA: raises $2.50 to $6
xrf8tAXKQHG99HixCot1Iw: folds 
i9LqF5rD3bvtbEE7HWgr3Q: calls $2.50
*** FLOP *** [2s Ts 5s]
i9LqF5rD3bvtbEE7HWgr3Q: checks 
jA7YMtfNUnAaebB7Lj74EA: bets $17.15 and is all-in
i9LqF5rD3bvtbEE7HWgr3Q: calls $17.15
*** TURN *** [2s Ts 5s] [8h]
*** RIVER *** [2s Ts 5s 8h] [3c]
*** SHOW DOWN ***
i9LqF5rD3bvtbEE7HWgr3Q: shows [As 4s] (a flush, Ace high)
jA7YMtfNUnAaebB7Lj74EA: mucks hand 
i9LqF5rD3bvtbEE7HWgr3Q collected $45.25 from pot
jA7YMtfNUnAaebB7Lj74EA leaves the table
*** SUMMARY ***
Total pot $47.55 | Rake $2.30 
Board [2s Ts 5s 8h 3c]
Seat 1: SFmT9ZsVopnukjvAzrxTRg folded before Flop (didn't bet)
Seat 2: xrf8tAXKQHG99HixCot1Iw (button) folded before Flop
Seat 3: i9LqF5rD3bvtbEE7HWgr3Q (small blind) showed [As 4s] and won ($45.25) with a flush, Ace high
Seat 4: BV+K0Phf5VBHr7aZPKqbUQ (big blind) folded before Flop
Seat 5: v+QfkGiuj9bgtuNoVnDO8w folded before Flop (didn't bet)
Seat 6: jA7YMtfNUnAaebB7Lj74EA mucked




PokerStars Game #59941953214:  Hold'em No Limit ($0.10/$0.25) - 2009/07/01 1:51:25 ET
Table 'FE/j6VqBY4j9Uq+VHURQCQ' 6-max Seat #3 is the button
Seat 1: ypmjhffk/YHGc51wgVXUTw ($39.30 in chips) 
Seat 2: 3zD3qLXT1bEffAoWGnc7wg ($36.35 in chips) 
Seat 3: lBoEwOFgzcERLIRUkUoRTw ($28.20 in chips) 
Seat 4: 7JyPCA0J2grhXQYxe1h3+A ($6.85 in chips) 
Seat 5: bJFzs6QmEEnz4miMfSDtcg ($16.90 in chips) 
Seat 6: Q1uciOZPBR/WkAlqa6cL4A ($25.35 in chips) 
7JyPCA0J2grhXQYxe1h3+A: posts small blind $0.10
bJFzs6QmEEnz4miMfSDtcg: posts big blind $0.25
*** HOLE CARDS ***
Q1uciOZPBR/WkAlqa6cL4A: calls $0.25
ypmjhffk/YHGc51wgVXUTw: raises $0.75 to $1
3zD3qLXT1bEffAoWGnc7wg: folds 
lBoEwOFgzcERLIRUkUoRTw: folds 
7JyPCA0J2grhXQYxe1h3+A: folds 
bJFzs6QmEEnz4miMfSDtcg: calls $0.75
Q1uciOZPBR/WkAlqa6cL4A: calls $0.75
*** FLOP *** [Kd 3s 7s]
bJFzs6QmEEnz4miMfSDtcg: checks 
Q1uciOZPBR/WkAlqa6cL4A: checks 
ypmjhffk/YHGc51wgVXUTw: bets $2.75
bJFzs6QmEEnz4miMfSDtcg: folds 
Q1uciOZPBR/WkAlqa6cL4A: raises $3.75 to $6.50
ypmjhffk/YHGc51wgVXUTw: folds 
Uncalled bet ($3.75) returned to Q1uciOZPBR/WkAlqa6cL4A
Q1uciOZPBR/WkAlqa6cL4A collected $8.20 from pot
Q1uciOZPBR/WkAlqa6cL4A: doesn't show hand 
*** SUMMARY ***
Total pot $8.60 | Rake $0.40 
Board [Kd 3s 7s]
Seat 1: ypmjhffk/YHGc51wgVXUTw folded on the Flop
Seat 2: 3zD3qLXT1bEffAoWGnc7wg folded before Flop (didn't bet)
Seat 3: lBoEwOFgzcERLIRUkUoRTw (button) folded before Flop (didn't bet)
Seat 4: 7JyPCA0J2grhXQYxe1h3+A (small blind) folded before Flop
Seat 5: bJFzs6QmEEnz4miMfSDtcg (big blind) folded on the Flop
Seat 6: Q1uciOZPBR/WkAlqa6cL4A collected ($8.20)




PokerStars Game #59941953438:  Hold'em No Limit ($0.10/$0.25) - 2009/07/01 1:51:25 ET
Table 'emoxgHTxg9Uqeu06oLzLyg' 6-max Seat #1 is the button
Seat 1: epAUIB7h2FJXzUPRIvSkRA ($25 in chips) 
Seat 2: wIFhgE1PVdX6Xf6aVlSTPg ($30.10 in chips) 
Seat 3: uD5epdBxuyc30pF1dO958Q ($9.65 in chips) 
Seat 4: 3VAbqAWh8ncE2SJOYIx2ZQ ($14.75 in chips) 
Seat 5: OIjOiBfQstWrK/RuXx7zcw ($7.85 in chips) 
Seat 6: u3Ol7kv1LmvszuHNm9rc6w ($18.65 in chips) 
wIFhgE1PVdX6Xf6aVlSTPg: posts small blind $0.10
uD5epdBxuyc30pF1dO958Q: posts big blind $0.25
*** HOLE CARDS ***
3VAbqAWh8ncE2SJOYIx2ZQ: folds 
OIjOiBfQstWrK/RuXx7zcw: folds 
u3Ol7kv1LmvszuHNm9rc6w: folds 
epAUIB7h2FJXzUPRIvSkRA: raises $0.75 to $1
wIFhgE1PVdX6Xf6aVlSTPg: folds 
uD5epdBxuyc30pF1dO958Q: raises $0.75 to $1.75
epAUIB7h2FJXzUPRIvSkRA: calls $0.75
*** FLOP *** [Tc 5d 3h]
uD5epdBxuyc30pF1dO958Q: bets $1.50
epAUIB7h2FJXzUPRIvSkRA: raises $2.25 to $3.75
uD5epdBxuyc30pF1dO958Q: calls $2.25
*** TURN *** [Tc 5d 3h] [8s]
uD5epdBxuyc30pF1dO958Q: bets $4.15 and is all-in
epAUIB7h2FJXzUPRIvSkRA: calls $4.15
*** RIVER *** [Tc 5d 3h 8s] [2h]
*** SHOW DOWN ***
uD5epdBxuyc30pF1dO958Q: shows [7c 7d] (a pair of Sevens)
epAUIB7h2FJXzUPRIvSkRA: shows [Th Jc] (a pair of Tens)
epAUIB7h2FJXzUPRIvSkRA collected $18.50 from pot
*** SUMMARY ***
Total pot $19.40 | Rake $0.90 
Board [Tc 5d 3h 8s 2h]
Seat 1: epAUIB7h2FJXzUPRIvSkRA (button) showed [Th Jc] and won ($18.50) with a pair of Tens
Seat 2: wIFhgE1PVdX6Xf6aVlSTPg (small blind) folded before Flop
Seat 3: uD5epdBxuyc30pF1dO958Q (big blind) showed [7c 7d] and lost with a pair of Sevens
Seat 4: 3VAbqAWh8ncE2SJOYIx2ZQ folded before Flop (didn't bet)
Seat 5: OIjOiBfQstWrK/RuXx7zcw folded before Flop (didn't bet)
Seat 6: u3Ol7kv1LmvszuHNm9rc6w folded before Flop (didn't bet)




PokerStars Game #59941953136:  Hold'em No Limit ($0.10/$0.25) - 2009/07/01 1:51:25 ET
Table 'mF3KHGMaTpaBZbtBoyfTeg' 6-max Seat #1 is the button
Seat 1: 0HAB2GdCAM7p7V00xueAVQ ($34.20 in chips) 
Seat 2: xrf8tAXKQHG99HixCot1Iw ($27.60 in chips) 
Seat 3: 9kUKGKkblnIx3m8rlVol6Q ($14.90 in chips) 
Seat 5: 8ClCHtFXGNplITm+63KB+Q ($45.25 in chips) 
Seat 6: kG34n23qFQA3nzdOJTQ1dA ($26.45 in chips) 
xrf8tAXKQHG99HixCot1Iw: posts small blind $0.10
9kUKGKkblnIx3m8rlVol6Q: posts big blind $0.25
qNYqNZMLP1I54EVl8faRRg: sits out 
*** HOLE CARDS ***
8ClCHtFXGNplITm+63KB+Q has timed out
8ClCHtFXGNplITm+63KB+Q: folds 
8ClCHtFXGNplITm+63KB+Q is sitting out
kG34n23qFQA3nzdOJTQ1dA: folds 
0HAB2GdCAM7p7V00xueAVQ: folds 
8ClCHtFXGNplITm+63KB+Q has returned
xrf8tAXKQHG99HixCot1Iw: raises $0.50 to $0.75
9kUKGKkblnIx3m8rlVol6Q: calls $0.50
*** FLOP *** [Ad 5s 4h]
xrf8tAXKQHG99HixCot1Iw: checks 
9kUKGKkblnIx3m8rlVol6Q: bets $1.25
xrf8tAXKQHG99HixCot1Iw: folds 
Uncalled bet ($1.25) returned to 9kUKGKkblnIx3m8rlVol6Q
9kUKGKkblnIx3m8rlVol6Q collected $1.45 from pot
9kUKGKkblnIx3m8rlVol6Q: doesn't show hand 
*** SUMMARY ***
Total pot $1.50 | Rake $0.05 
Board [Ad 5s 4h]
Seat 1: 0HAB2GdCAM7p7V00xueAVQ (button) folded before Flop (didn't bet)
Seat 2: xrf8tAXKQHG99HixCot1Iw (small blind) folded on the Flop
Seat 3: 9kUKGKkblnIx3m8rlVol6Q (big blind) collected ($1.45)
Seat 5: 8ClCHtFXGNplITm+63KB+Q folded before Flop (didn't bet)
Seat 6: kG34n23qFQA3nzdOJTQ1dA folded before Flop (didn't bet)




PokerStars Game #59941953398:  Hold'em No Limit ($0.10/$0.25) - 2009/07/01 1:51:25 ET
Table 'Pz8SfAzhP5nvWTsJRAxoDg' 6-max Seat #6 is the button
Seat 1: QiL+lEgEWwy21jk/ltaRLg ($46.75 in chips) 
Seat 2: k021eD5in2AjaloW5PalMg ($18.45 in chips) 
Seat 3: mfrkWA3PTeYPkbO6hi98Aw ($31.45 in chips) 
Seat 4: 4lJto+Qj0K4JrFKvHaPTLw ($64.05 in chips) 
Seat 6: QvTX2yGq3uKJiKPmns4TKQ ($16.70 in chips) 
QiL+lEgEWwy21jk/ltaRLg: posts small blind $0.10
k021eD5in2AjaloW5PalMg: posts big blind $0.25
u+J1MTXS2qhNVMbsBemNLg: sits out 
*** HOLE CARDS ***
mfrkWA3PTeYPkbO6hi98Aw: folds 
4lJto+Qj0K4JrFKvHaPTLw: folds 
QvTX2yGq3uKJiKPmns4TKQ: raises $0.50 to $0.75
QiL+lEgEWwy21jk/ltaRLg: folds 
k021eD5in2AjaloW5PalMg: folds 
Uncalled bet ($0.50) returned to QvTX2yGq3uKJiKPmns4TKQ
QvTX2yGq3uKJiKPmns4TKQ collected $0.60 from pot
QvTX2yGq3uKJiKPmns4TKQ: doesn't show hand 
*** SUMMARY ***
Total pot $0.60 | Rake $0 
Seat 1: QiL+lEgEWwy21jk/ltaRLg (small blind) folded before Flop
Seat 2: k021eD5in2AjaloW5PalMg (big blind) folded before Flop
Seat 3: mfrkWA3PTeYPkbO6hi98Aw folded before Flop (didn't bet)
Seat 4: 4lJto+Qj0K4JrFKvHaPTLw folded before Flop (didn't bet)
Seat 6: QvTX2yGq3uKJiKPmns4TKQ (button) collected ($0.60)




PokerStars Game #59941953382:  Hold'em No Limit ($0.10/$0.25) - 2009/07/01 1:51:25 ET
Table 'IIO2q2znuuAXmiZ2qFTcmg' 6-max Seat #5 is the button
Seat 2: i9LqF5rD3bvtbEE7HWgr3Q ($26.85 in chips) 
Seat 3: j0aDOn9Nft1HLTQvGu1UwA ($17.65 in chips) 
Seat 5: iHZrkhpIO/3+tKuAoPx8HQ ($9 in chips) 
Seat 6: WT1/PiLHYHDQX0orTRlu9g ($14.50 in chips) 
WT1/PiLHYHDQX0orTRlu9g: posts small blind $0.10
i9LqF5rD3bvtbEE7HWgr3Q: posts big blind $0.25
*** HOLE CARDS ***
j0aDOn9Nft1HLTQvGu1UwA: calls $0.25
iHZrkhpIO/3+tKuAoPx8HQ: calls $0.25
WT1/PiLHYHDQX0orTRlu9g: folds 
i9LqF5rD3bvtbEE7HWgr3Q: raises $1.25 to $1.50
j0aDOn9Nft1HLTQvGu1UwA: folds 
iHZrkhpIO/3+tKuAoPx8HQ: folds 
Uncalled bet ($1.25) returned to i9LqF5rD3bvtbEE7HWgr3Q
i9LqF5rD3bvtbEE7HWgr3Q collected $0.85 from pot
i9LqF5rD3bvtbEE7HWgr3Q: doesn't show hand 
*** SUMMARY ***
Total pot $0.85 | Rake $0 
Seat 2: i9LqF5rD3bvtbEE7HWgr3Q (big blind) collected ($0.85)
Seat 3: j0aDOn9Nft1HLTQvGu1UwA folded before Flop
Seat 5: iHZrkhpIO/3+tKuAoPx8HQ (button) folded before Flop
Seat 6: WT1/PiLHYHDQX0orTRlu9g (small blind) folded before Flop




PokerStars Game #59941953538:  Hold'em No Limit ($0.10/$0.25) - 2009/07/01 1:51:26 ET
Table '0mmHveGuaIfIMQlNE1eqMg' 9-max Seat #4 is the button
Seat 1: ydoFOVgzvZv9ZhuWu9rXAw ($5 in chips) 
Seat 2: rQhYIYXSyH/IivYM1dlV5A ($68.50 in chips) 
Seat 3: ghNKXUBl/H+t83JF079ZBA ($25 in chips) 
Seat 4: DnDcAdn9P0zGovMERigpFA ($39.70 in chips) 
Seat 6: 6RiVTYll/5D8zICp0MRpKw ($23.45 in chips) 
Seat 7: JqeaikMej6KsqTKmUhl2Lw ($25 in chips) 
Seat 8: 0XACOSNrAWmqNv9k1nF8rw ($17.05 in chips) 
Seat 9: UNw/UrAelsQeSS17Rro/BA ($8.65 in chips) 
0rQnT3MwKEGi6YXD9FufJw will be allowed to play after the button
6RiVTYll/5D8zICp0MRpKw: posts small blind $0.10
JqeaikMej6KsqTKmUhl2Lw: posts big blind $0.25
*** HOLE CARDS ***
0XACOSNrAWmqNv9k1nF8rw: calls $0.25
UNw/UrAelsQeSS17Rro/BA: calls $0.25
ydoFOVgzvZv9ZhuWu9rXAw: folds 
rQhYIYXSyH/IivYM1dlV5A: folds 
ghNKXUBl/H+t83JF079ZBA: folds 
DnDcAdn9P0zGovMERigpFA: folds 
6RiVTYll/5D8zICp0MRpKw: folds 
JqeaikMej6KsqTKmUhl2Lw: checks 
*** FLOP *** [8c Th Js]
JqeaikMej6KsqTKmUhl2Lw: checks 
0XACOSNrAWmqNv9k1nF8rw: checks 
UNw/UrAelsQeSS17Rro/BA: bets $1
JqeaikMej6KsqTKmUhl2Lw: folds 
0XACOSNrAWmqNv9k1nF8rw: calls $1
*** TURN *** [8c Th Js] [3c]
0XACOSNrAWmqNv9k1nF8rw: checks 
UNw/UrAelsQeSS17Rro/BA: bets $2.50
0XACOSNrAWmqNv9k1nF8rw: calls $2.50
*** RIVER *** [8c Th Js 3c] [9d]
0XACOSNrAWmqNv9k1nF8rw: bets $0.50
UNw/UrAelsQeSS17Rro/BA: calls $0.50
*** SHOW DOWN ***
0XACOSNrAWmqNv9k1nF8rw: shows [Qd Ac] (a straight, Eight to Queen)
UNw/UrAelsQeSS17Rro/BA: mucks hand 
0XACOSNrAWmqNv9k1nF8rw collected $8.45 from pot
*** SUMMARY ***
Total pot $8.85 | Rake $0.40 
Board [8c Th Js 3c 9d]
Seat 1: ydoFOVgzvZv9ZhuWu9rXAw folded before Flop (didn't bet)
Seat 2: rQhYIYXSyH/IivYM1dlV5A folded before Flop (didn't bet)
Seat 3: ghNKXUBl/H+t83JF079ZBA folded before Flop (didn't bet)
Seat 4: DnDcAdn9P0zGovMERigpFA (button) folded before Flop (didn't bet)
Seat 6: 6RiVTYll/5D8zICp0MRpKw (small blind) folded before Flop
Seat 7: JqeaikMej6KsqTKmUhl2Lw (big blind) folded on the Flop
Seat 8: 0XACOSNrAWmqNv9k1nF8rw showed [Qd Ac] and won ($8.45) with a straight, Eight to Queen
Seat 9: UNw/UrAelsQeSS17Rro/BA mucked




PokerStars Game #59941953512:  Hold'em No Limit ($0.10/$0.25) - 2009/07/01 1:51:26 ET
Table '5NipxzzFB2DffzDpddyQoQ' 6-max Seat #5 is the button
Seat 2: iauW7L/+7qzAuHow7CD75Q ($5 in chips) 
Seat 3: QvTX2yGq3uKJiKPmns4TKQ ($25.05 in chips) 
Seat 5: faP2NVl/cFTZ1nE4pXzg8Q ($21.10 in chips) 
Seat 6: 7JqTFMyeNSVWsmp/yW35Tw ($53.80 in chips) 
7JqTFMyeNSVWsmp/yW35Tw: posts small blind $0.10
iauW7L/+7qzAuHow7CD75Q: posts big blind $0.25
iauW7L/+7qzAuHow7CD75Q said, "tonight"
*** HOLE CARDS ***
QvTX2yGq3uKJiKPmns4TKQ: folds 
faP2NVl/cFTZ1nE4pXzg8Q: calls $0.25
7JqTFMyeNSVWsmp/yW35Tw: folds 
iauW7L/+7qzAuHow7CD75Q: checks 
*** FLOP *** [9d 4d Ks]
iauW7L/+7qzAuHow7CD75Q: checks 
7JqTFMyeNSVWsmp/yW35Tw said, "lol"
7JqTFMyeNSVWsmp/yW35Tw said, "rotflmao"
faP2NVl/cFTZ1nE4pXzg8Q: bets $1
iauW7L/+7qzAuHow7CD75Q: folds 
Uncalled bet ($1) returned to faP2NVl/cFTZ1nE4pXzg8Q
7JqTFMyeNSVWsmp/yW35Tw said, "classic"
faP2NVl/cFTZ1nE4pXzg8Q collected $0.60 from pot
Wxq4Qyj0DnDXj2+taEOJFQ joins the table at seat #4 
faP2NVl/cFTZ1nE4pXzg8Q: shows [Kd 8d] (a pair of Kings)
*** SUMMARY ***
Total pot $0.60 | Rake $0 
Board [9d 4d Ks]
Seat 2: iauW7L/+7qzAuHow7CD75Q (big blind) folded on the Flop
Seat 3: QvTX2yGq3uKJiKPmns4TKQ folded before Flop (didn't bet)
Seat 5: faP2NVl/cFTZ1nE4pXzg8Q (button) collected ($0.60)
Seat 6: 7JqTFMyeNSVWsmp/yW35Tw (small blind) folded before Flop




PokerStars Game #59941953794:  Hold'em No Limit ($0.10/$0.25) - 2009/07/01 1:51:26 ET
Table 'HzFR0rxmDAPu5GzYR0AlYg' 6-max Seat #1 is the button
Seat 1: v+QfkGiuj9bgtuNoVnDO8w ($35.15 in chips) 
Seat 2: UA5OsKS3VPaxa7uC8La/kA ($51.35 in chips) 
Seat 3: kG34n23qFQA3nzdOJTQ1dA ($24.55 in chips) 
Seat 4: Mhj3q7cxev+XjXZxEE6/Cw ($25.35 in chips) 
Seat 6: jp34e617tIzV8tKIWmfAbA ($35.30 in chips) 
UA5OsKS3VPaxa7uC8La/kA: posts small blind $0.10
kG34n23qFQA3nzdOJTQ1dA: posts big blind $0.25
*** HOLE CARDS ***
Mhj3q7cxev+XjXZxEE6/Cw: folds 
jp34e617tIzV8tKIWmfAbA: folds 
v+QfkGiuj9bgtuNoVnDO8w: folds 
UA5OsKS3VPaxa7uC8La/kA: raises $0.75 to $1
kG34n23qFQA3nzdOJTQ1dA: folds 
Uncalled bet ($0.75) returned to UA5OsKS3VPaxa7uC8La/kA
UA5OsKS3VPaxa7uC8La/kA collected $0.50 from pot
*** SUMMARY ***
Total pot $0.50 | Rake $0 
Seat 1: v+QfkGiuj9bgtuNoVnDO8w (button) folded before Flop (didn't bet)
Seat 2: UA5OsKS3VPaxa7uC8La/kA (small blind) collected ($0.50)
Seat 3: kG34n23qFQA3nzdOJTQ1dA (big blind) folded before Flop
Seat 4: Mhj3q7cxev+XjXZxEE6/Cw folded before Flop (didn't bet)
Seat 6: jp34e617tIzV8tKIWmfAbA folded before Flop (didn't bet)




PokerStars Game #59941953960:  Hold'em No Limit ($0.10/$0.25) - 2009/07/01 1:51:26 ET
Table 'o0CDOvKO/bn1WjeymDrXfA' 6-max Seat #6 is the button
Seat 1: if4dh6jhJXeN3/qd3qCp9g ($27.15 in chips) 
Seat 2: 08V++DOqzaNrRNsHIwi25w ($25 in chips) 
Seat 4: i9LqF5rD3bvtbEE7HWgr3Q ($25 in chips) 
Seat 5: dOIoLBxmpLHSXBN9LZnf0Q ($40.25 in chips) 
Seat 6: SS/yfeArhULzIcOPe8MdPg ($25 in chips) 
if4dh6jhJXeN3/qd3qCp9g: posts small blind $0.10
08V++DOqzaNrRNsHIwi25w: posts big blind $0.25
*** HOLE CARDS ***
MVzl6OsGybVDNd3Vr9LYAA joins the table at seat #3 
i9LqF5rD3bvtbEE7HWgr3Q: folds 
dOIoLBxmpLHSXBN9LZnf0Q: calls $0.25
SS/yfeArhULzIcOPe8MdPg: folds 
if4dh6jhJXeN3/qd3qCp9g: folds 
08V++DOqzaNrRNsHIwi25w: checks 
*** FLOP *** [9s Th 4d]
08V++DOqzaNrRNsHIwi25w: checks 
dOIoLBxmpLHSXBN9LZnf0Q: bets $1
08V++DOqzaNrRNsHIwi25w: folds 
Uncalled bet ($1) returned to dOIoLBxmpLHSXBN9LZnf0Q
dOIoLBxmpLHSXBN9LZnf0Q collected $0.60 from pot
dOIoLBxmpLHSXBN9LZnf0Q: doesn't show hand 
*** SUMMARY ***
Total pot $0.60 | Rake $0 
Board [9s Th 4d]
Seat 1: if4dh6jhJXeN3/qd3qCp9g (small blind) folded before Flop
Seat 2: 08V++DOqzaNrRNsHIwi25w (big blind) folded on the Flop
Seat 4: i9LqF5rD3bvtbEE7HWgr3Q folded before Flop (didn't bet)
Seat 5: dOIoLBxmpLHSXBN9LZnf0Q collected ($0.60)
Seat 6: SS/yfeArhULzIcOPe8MdPg (button) folded before Flop (didn't bet)




PokerStars Game #59941953878:  Hold'em No Limit ($0.10/$0.25) - 2009/07/01 1:51:26 ET
Table 'Qk/910N2Yhg8u5vqTJk50Q' 9-max Seat #2 is the button
Seat 1: zDrucyjVn5aeekNEc3cJrA ($22.55 in chips) 
Seat 2: Th3FldXKQW6hWVVPahaoOQ ($44.70 in chips) 
Seat 3: ghNKXUBl/H+t83JF079ZBA ($26 in chips) 
Seat 4: hYvTc4PYNrAaNAIVoM94Hw ($4.75 in chips) 
Seat 5: zReBEigsxqZnag0RZAgpgA ($14.10 in chips) 
Seat 6: U41wNf6XauAiBOQaKu2ZIA ($9.75 in chips) 
Seat 7: aNpwfA31EREwO+ar4XzBCw ($26.85 in chips) 
Seat 8: 5pDhXQ+RVy0BGcwfJAJfbg ($24.75 in chips) 
Seat 9: M2QO2DxB5Wawg2h8HSpnYA ($17.35 in chips) 
ghNKXUBl/H+t83JF079ZBA: posts small blind $0.10
hYvTc4PYNrAaNAIVoM94Hw: posts big blind $0.25
zDrucyjVn5aeekNEc3cJrA: posts small & big blinds $0.35
*** HOLE CARDS ***
zReBEigsxqZnag0RZAgpgA: calls $0.25
U41wNf6XauAiBOQaKu2ZIA: folds 
aNpwfA31EREwO+ar4XzBCw: folds 
5pDhXQ+RVy0BGcwfJAJfbg: folds 
M2QO2DxB5Wawg2h8HSpnYA: folds 
zDrucyjVn5aeekNEc3cJrA: checks 
Th3FldXKQW6hWVVPahaoOQ: folds 
ghNKXUBl/H+t83JF079ZBA: folds 
hYvTc4PYNrAaNAIVoM94Hw: checks 
*** FLOP *** [Jd Ah As]
hYvTc4PYNrAaNAIVoM94Hw: checks 
zReBEigsxqZnag0RZAgpgA: checks 
zDrucyjVn5aeekNEc3cJrA: checks 
*** TURN *** [Jd Ah As] [7s]
hYvTc4PYNrAaNAIVoM94Hw: checks 
zReBEigsxqZnag0RZAgpgA: bets $0.50
zDrucyjVn5aeekNEc3cJrA: folds 
hYvTc4PYNrAaNAIVoM94Hw: folds 
Uncalled bet ($0.50) returned to zReBEigsxqZnag0RZAgpgA
zReBEigsxqZnag0RZAgpgA collected $0.95 from pot
*** SUMMARY ***
Total pot $0.95 | Rake $0 
Board [Jd Ah As 7s]
Seat 1: zDrucyjVn5aeekNEc3cJrA folded on the Turn
Seat 2: Th3FldXKQW6hWVVPahaoOQ (button) folded before Flop (didn't bet)
Seat 3: ghNKXUBl/H+t83JF079ZBA (small blind) folded before Flop
Seat 4: hYvTc4PYNrAaNAIVoM94Hw (big blind) folded on the Turn
Seat 5: zReBEigsxqZnag0RZAgpgA collected ($0.95)
Seat 6: U41wNf6XauAiBOQaKu2ZIA folded before Flop (didn't bet)
Seat 7: aNpwfA31EREwO+ar4XzBCw folded before Flop (didn't bet)
Seat 8: 5pDhXQ+RVy0BGcwfJAJfbg folded before Flop (didn't bet)
Seat 9: M2QO2DxB5Wawg2h8HSpnYA folded before Flop (didn't bet)




PokerStars Game #59941953972:  Hold'em No Limit ($0.10/$0.25) - 2009/07/01 1:51:26 ET
Table 'axb9RsG8Zj1A0LEukTeFrQ' 9-max Seat #9 is the button
Seat 1: qwr38jl5txoR36M7G5qi4A ($8.25 in chips) 
Seat 2: zDrucyjVn5aeekNEc3cJrA ($21.40 in chips) 
Seat 3: H5Se03ZqSX7tbULXur2MAg ($25.05 in chips) 
Seat 4: tLcDklc2rBORNfixyRfVfw ($25.35 in chips) 
Seat 5: rLSSHKOHnb6yzVfDoQM/RA ($16.35 in chips) 
Seat 6: Iu9xjReQYvxYiqQm8n6MXQ ($4.85 in chips) 
Seat 7: PdIasPkzm2sqZnN41ZRXOg ($5 in chips) 
Seat 8: VBHxUExRAMrbxUq/cVx9Gw ($5 in chips) 
Seat 9: qbQE8CifKB4+OEvNF/61Rw ($57.35 in chips) 
qwr38jl5txoR36M7G5qi4A: posts small blind $0.10
zDrucyjVn5aeekNEc3cJrA: posts big blind $0.25
*** HOLE CARDS ***
H5Se03ZqSX7tbULXur2MAg: folds 
tLcDklc2rBORNfixyRfVfw: calls $0.25
rLSSHKOHnb6yzVfDoQM/RA: calls $0.25
Iu9xjReQYvxYiqQm8n6MXQ: raises $0.50 to $0.75
PdIasPkzm2sqZnN41ZRXOg: folds 
VBHxUExRAMrbxUq/cVx9Gw: folds 
qbQE8CifKB4+OEvNF/61Rw: calls $0.75
qwr38jl5txoR36M7G5qi4A: folds 
zDrucyjVn5aeekNEc3cJrA: folds 
tLcDklc2rBORNfixyRfVfw: calls $0.50
rLSSHKOHnb6yzVfDoQM/RA: calls $0.50
*** FLOP *** [9d 4s Js]
tLcDklc2rBORNfixyRfVfw: checks 
rLSSHKOHnb6yzVfDoQM/RA: checks 
Iu9xjReQYvxYiqQm8n6MXQ: bets $4.10 and is all-in
qbQE8CifKB4+OEvNF/61Rw: folds 
tLcDklc2rBORNfixyRfVfw: folds 
rLSSHKOHnb6yzVfDoQM/RA: calls $4.10
*** TURN *** [9d 4s Js] [Jc]
*** RIVER *** [9d 4s Js Jc] [Ac]
*** SHOW DOWN ***
rLSSHKOHnb6yzVfDoQM/RA: shows [Tc 9c] (two pair, Jacks and Nines)
Iu9xjReQYvxYiqQm8n6MXQ: shows [As 7s] (two pair, Aces and Jacks)
Iu9xjReQYvxYiqQm8n6MXQ collected $11 from pot
*** SUMMARY ***
Total pot $11.55 | Rake $0.55 
Board [9d 4s Js Jc Ac]
Seat 1: qwr38jl5txoR36M7G5qi4A (small blind) folded before Flop
Seat 2: zDrucyjVn5aeekNEc3cJrA (big blind) folded before Flop
Seat 3: H5Se03ZqSX7tbULXur2MAg folded before Flop (didn't bet)
Seat 4: tLcDklc2rBORNfixyRfVfw folded on the Flop
Seat 5: rLSSHKOHnb6yzVfDoQM/RA showed [Tc 9c] and lost with two pair, Jacks and Nines
Seat 6: Iu9xjReQYvxYiqQm8n6MXQ showed [As 7s] and won ($11) with two pair, Aces and Jacks
Seat 7: PdIasPkzm2sqZnN41ZRXOg folded before Flop (didn't bet)
Seat 8: VBHxUExRAMrbxUq/cVx9Gw folded before Flop (didn't bet)
Seat 9: qbQE8CifKB4+OEvNF/61Rw (button) folded on the Flop




PokerStars Game #59941953918:  Hold'em No Limit ($0.10/$0.25) - 2009/07/01 1:51:26 ET
Table 'Do4nrTNDYpK3sQjwFxX+Og' 6-max Seat #4 is the button
Seat 1: 7JrQNOR9wRBxq9ijFhWieg ($36.90 in chips) 
Seat 2: tzMoGl9F0PUr5NibYueeSw ($71.15 in chips) 
Seat 3: TSmua8tGK3sTbwi0ynrW9Q ($25 in chips) 
Seat 4: cWc85bEzdRzpUMhRKm8pwQ ($32.70 in chips) 
Seat 5: SxIIgwXYLkwd6m3wLyPTCw ($25 in chips) 
Seat 6: lBoEwOFgzcERLIRUkUoRTw ($24.20 in chips) 
SxIIgwXYLkwd6m3wLyPTCw: posts small blind $0.10
lBoEwOFgzcERLIRUkUoRTw: posts big blind $0.25
*** HOLE CARDS ***
7JrQNOR9wRBxq9ijFhWieg: folds 
tzMoGl9F0PUr5NibYueeSw: folds 
TSmua8tGK3sTbwi0ynrW9Q: folds 
cWc85bEzdRzpUMhRKm8pwQ: folds 
SxIIgwXYLkwd6m3wLyPTCw: raises $0.50 to $0.75
lBoEwOFgzcERLIRUkUoRTw: folds 
Uncalled bet ($0.50) returned to SxIIgwXYLkwd6m3wLyPTCw
SxIIgwXYLkwd6m3wLyPTCw collected $0.50 from pot
SxIIgwXYLkwd6m3wLyPTCw: doesn't show hand 
*** SUMMARY ***
Total pot $0.50 | Rake $0 
Seat 1: 7JrQNOR9wRBxq9ijFhWieg folded before Flop (didn't bet)
Seat 2: tzMoGl9F0PUr5NibYueeSw folded before Flop (didn't bet)
Seat 3: TSmua8tGK3sTbwi0ynrW9Q folded before Flop (didn't bet)
Seat 4: cWc85bEzdRzpUMhRKm8pwQ (button) folded before Flop (didn't bet)
Seat 5: SxIIgwXYLkwd6m3wLyPTCw (small blind) collected ($0.50)
Seat 6: lBoEwOFgzcERLIRUkUoRTw (big blind) folded before Flop




PokerStars Game #59941953628:  Hold'em No Limit ($0.10/$0.25) - 2009/07/01 1:51:26 ET
Table 'IUwZ/e0bDHZPgsIWx0RnNg' 6-max Seat #5 is the button
Seat 1: V66QiVCQPofyl3a+dpPHQQ ($4.70 in chips) 
Seat 2: mvFHK3pE7tCxJEqLjKC70Q ($55.60 in chips) 
Seat 3: dOX4wnYV2sEqvDbF+8KSCw ($27 in chips) 
Seat 4: OIjOiBfQstWrK/RuXx7zcw ($3.80 in chips) 
Seat 5: 9bpVv1/Qh9IYtXuCtl5VtQ ($25.95 in chips) 
Seat 6: NhUN/JpAprdJeamFBgJH1w ($38.65 in chips) 
NhUN/JpAprdJeamFBgJH1w: posts small blind $0.10
V66QiVCQPofyl3a+dpPHQQ: posts big blind $0.25
*** HOLE CARDS ***
mvFHK3pE7tCxJEqLjKC70Q: raises $0.50 to $0.75
dOX4wnYV2sEqvDbF+8KSCw: calls $0.75
OIjOiBfQstWrK/RuXx7zcw: calls $0.75
9bpVv1/Qh9IYtXuCtl5VtQ: calls $0.75
NhUN/JpAprdJeamFBgJH1w: folds 
V66QiVCQPofyl3a+dpPHQQ: folds 
*** FLOP *** [5d 8s 4c]
mvFHK3pE7tCxJEqLjKC70Q: checks 
dOX4wnYV2sEqvDbF+8KSCw: bets $2
OIjOiBfQstWrK/RuXx7zcw: raises $1.05 to $3.05 and is all-in
9bpVv1/Qh9IYtXuCtl5VtQ: folds 
mvFHK3pE7tCxJEqLjKC70Q: folds 
dOX4wnYV2sEqvDbF+8KSCw: calls $1.05
*** TURN *** [5d 8s 4c] [Qs]
*** RIVER *** [5d 8s 4c Qs] [2h]
*** SHOW DOWN ***
dOX4wnYV2sEqvDbF+8KSCw: shows [As Js] (high card Ace)
OIjOiBfQstWrK/RuXx7zcw: shows [8d 9d] (a pair of Eights)
OIjOiBfQstWrK/RuXx7zcw collected $9 from pot
*** SUMMARY ***
Total pot $9.45 | Rake $0.45 
Board [5d 8s 4c Qs 2h]
Seat 1: V66QiVCQPofyl3a+dpPHQQ (big blind) folded before Flop
Seat 2: mvFHK3pE7tCxJEqLjKC70Q folded on the Flop
Seat 3: dOX4wnYV2sEqvDbF+8KSCw showed [As Js] and lost with high card Ace
Seat 4: OIjOiBfQstWrK/RuXx7zcw showed [8d 9d] and won ($9) with a pair of Eights
Seat 5: 9bpVv1/Qh9IYtXuCtl5VtQ (button) folded on the Flop
Seat 6: NhUN/JpAprdJeamFBgJH1w (small blind) folded before Flop




PokerStars Game #59941954290:  Hold'em No Limit ($0.10/$0.25) - 2009/07/01 1:51:27 ET
Table 'Yb2CyZosw7N3yRRVLhKnKg' 9-max Seat #9 is the button
Seat 1: j97ZRZFRWNUsBUL7hv78tA ($14.40 in chips) 
Seat 2: dtZ84flFEi4Q+SGrHMJRDQ ($26.15 in chips) 
Seat 3: wUanlt/hhheMA+jOrJk2Tg ($9.15 in chips) 
Seat 4: FG10kumpruEJ3PQJ7oGglQ ($17.85 in chips) 
Seat 6: CgIo2ItZqi4o3ayVG6HanQ ($43.75 in chips) 
Seat 7: ljemhp25Zg+nlA9DLCIiUw ($24.75 in chips) 
Seat 8: HxDF4QSxC4z39D7teZpprQ ($12.95 in chips) 
Seat 9: 6DVf3fwEGECnjQ4Yp9AsFw ($16.20 in chips) 
j97ZRZFRWNUsBUL7hv78tA: posts small blind $0.10
dtZ84flFEi4Q+SGrHMJRDQ: posts big blind $0.25
ydoFOVgzvZv9ZhuWu9rXAw: sits out 
*** HOLE CARDS ***
wUanlt/hhheMA+jOrJk2Tg: folds 
FG10kumpruEJ3PQJ7oGglQ: raises $0.50 to $0.75
CgIo2ItZqi4o3ayVG6HanQ: calls $0.75
ljemhp25Zg+nlA9DLCIiUw: folds 
HxDF4QSxC4z39D7teZpprQ: calls $0.75
6DVf3fwEGECnjQ4Yp9AsFw: folds 
j97ZRZFRWNUsBUL7hv78tA: calls $0.65
dtZ84flFEi4Q+SGrHMJRDQ: folds 
*** FLOP *** [9d 3c Jd]
j97ZRZFRWNUsBUL7hv78tA: checks 
FG10kumpruEJ3PQJ7oGglQ: checks 
CgIo2ItZqi4o3ayVG6HanQ: checks 
HxDF4QSxC4z39D7teZpprQ: checks 
*** TURN *** [9d 3c Jd] [Kh]
j97ZRZFRWNUsBUL7hv78tA: checks 
FG10kumpruEJ3PQJ7oGglQ: checks 
CgIo2ItZqi4o3ayVG6HanQ: bets $1
HxDF4QSxC4z39D7teZpprQ: folds 
j97ZRZFRWNUsBUL7hv78tA: folds 
FG10kumpruEJ3PQJ7oGglQ: calls $1
*** RIVER *** [9d 3c Jd Kh] [9c]
FG10kumpruEJ3PQJ7oGglQ: checks 
CgIo2ItZqi4o3ayVG6HanQ: bets $2
FG10kumpruEJ3PQJ7oGglQ: folds 
Uncalled bet ($2) returned to CgIo2ItZqi4o3ayVG6HanQ
CgIo2ItZqi4o3ayVG6HanQ collected $5 from pot
*** SUMMARY ***
Total pot $5.25 | Rake $0.25 
Board [9d 3c Jd Kh 9c]
Seat 1: j97ZRZFRWNUsBUL7hv78tA (small blind) folded on the Turn
Seat 2: dtZ84flFEi4Q+SGrHMJRDQ (big blind) folded before Flop
Seat 3: wUanlt/hhheMA+jOrJk2Tg folded before Flop (didn't bet)
Seat 4: FG10kumpruEJ3PQJ7oGglQ folded on the River
Seat 6: CgIo2ItZqi4o3ayVG6HanQ collected ($5)
Seat 7: ljemhp25Zg+nlA9DLCIiUw folded before Flop (didn't bet)
Seat 8: HxDF4QSxC4z39D7teZpprQ folded on the Turn
Seat 9: 6DVf3fwEGECnjQ4Yp9AsFw (button) folded before Flop (didn't bet)




PokerStars Game #59941954104:  Hold'em No Limit ($0.10/$0.25) - 2009/07/01 1:51:27 ET
Table 'ouLhepGYovxB2x0QxH7cVg' 9-max Seat #9 is the button
Seat 1: ghNKXUBl/H+t83JF079ZBA ($25 in chips) 
Seat 2: r1Z5m4PwSI5ANp7qCE1OJw ($12.10 in chips) 
Seat 3: bXpVeaSTPBFSPJmeXxO7nw ($4.90 in chips) 
Seat 4: a0Sx6GHY7ln2Ns2C97eXeA ($59.40 in chips) 
Seat 5: v60REj6f8jzMYT0VsZvaPQ ($21.75 in chips) 
Seat 6: hYvTc4PYNrAaNAIVoM94Hw ($4.65 in chips) 
Seat 8: tLcDklc2rBORNfixyRfVfw ($25.25 in chips) 
Seat 9: ljemhp25Zg+nlA9DLCIiUw ($24.95 in chips) 
ghNKXUBl/H+t83JF079ZBA: posts small blind $0.10
r1Z5m4PwSI5ANp7qCE1OJw: posts big blind $0.25
*** HOLE CARDS ***
cKlmpQMahVsmOaxFQDcoOg joins the table at seat #7 
bXpVeaSTPBFSPJmeXxO7nw: folds 
a0Sx6GHY7ln2Ns2C97eXeA: folds 
v60REj6f8jzMYT0VsZvaPQ: raises $0.50 to $0.75
hYvTc4PYNrAaNAIVoM94Hw: folds 
tLcDklc2rBORNfixyRfVfw: folds 
ljemhp25Zg+nlA9DLCIiUw: folds 
ghNKXUBl/H+t83JF079ZBA: folds 
r1Z5m4PwSI5ANp7qCE1OJw: calls $0.50
*** FLOP *** [Ah 8h Ks]
r1Z5m4PwSI5ANp7qCE1OJw: checks 
v60REj6f8jzMYT0VsZvaPQ: bets $1
r1Z5m4PwSI5ANp7qCE1OJw: folds 
Uncalled bet ($1) returned to v60REj6f8jzMYT0VsZvaPQ
v60REj6f8jzMYT0VsZvaPQ collected $1.55 from pot
*** SUMMARY ***
Total pot $1.60 | Rake $0.05 
Board [Ah 8h Ks]
Seat 1: ghNKXUBl/H+t83JF079ZBA (small blind) folded before Flop
Seat 2: r1Z5m4PwSI5ANp7qCE1OJw (big blind) folded on the Flop
Seat 3: bXpVeaSTPBFSPJmeXxO7nw folded before Flop (didn't bet)
Seat 4: a0Sx6GHY7ln2Ns2C97eXeA folded before Flop (didn't bet)
Seat 5: v60REj6f8jzMYT0VsZvaPQ collected ($1.55)
Seat 6: hYvTc4PYNrAaNAIVoM94Hw folded before Flop (didn't bet)
Seat 8: tLcDklc2rBORNfixyRfVfw folded before Flop (didn't bet)
Seat 9: ljemhp25Zg+nlA9DLCIiUw (button) folded before Flop (didn't bet)




PokerStars Game #59941954320:  Hold'em No Limit ($0.10/$0.25) - 2009/07/01 1:51:27 ET
Table 'JJzUs04lHpXg6nboT1/jeg' 6-max Seat #2 is the button
Seat 1: vEZ/HxVuyR6kaq0BtZoUgQ ($10 in chips) 
Seat 2: jxfR29d+dK/7h7s3SvCk+g ($12 in chips) 
Seat 3: 4zXbHDe39qNX46dAo81b4w ($7.50 in chips) 
Seat 4: 7cx44/slbeTw+Cy7QB8Trg ($24.65 in chips) 
Seat 5: FDWzjQgBA5K04jOIY/j22w ($4.75 in chips) 
4zXbHDe39qNX46dAo81b4w: posts small blind $0.10
7cx44/slbeTw+Cy7QB8Trg: posts big blind $0.25
bDKopKTvPi3W+PEnYUX3tg: sits out 
*** HOLE CARDS ***
FDWzjQgBA5K04jOIY/j22w: folds 
vEZ/HxVuyR6kaq0BtZoUgQ: folds 
jxfR29d+dK/7h7s3SvCk+g: raises $0.50 to $0.75
4zXbHDe39qNX46dAo81b4w: folds 
7cx44/slbeTw+Cy7QB8Trg: folds 
Uncalled bet ($0.50) returned to jxfR29d+dK/7h7s3SvCk+g
jxfR29d+dK/7h7s3SvCk+g collected $0.60 from pot
*** SUMMARY ***
Total pot $0.60 | Rake $0 
Seat 1: vEZ/HxVuyR6kaq0BtZoUgQ folded before Flop (didn't bet)
Seat 2: jxfR29d+dK/7h7s3SvCk+g (button) collected ($0.60)
Seat 3: 4zXbHDe39qNX46dAo81b4w (small blind) folded before Flop
Seat 4: 7cx44/slbeTw+Cy7QB8Trg (big blind) folded before Flop
Seat 5: FDWzjQgBA5K04jOIY/j22w folded before Flop (didn't bet)




PokerStars Game #59941954184:  Hold'em No Limit ($0.10/$0.25) - 2009/07/01 1:51:27 ET
Table 'zW+7jPbOLCvlPu+dUGY5WQ' 6-max Seat #4 is the button
Seat 1: eL3+wCBjFGfQ5FMdIZihwA ($31.20 in chips) 
Seat 2: TQ7/UUMjrZ3WL5eLMho7VQ ($10 in chips) 
Seat 4: i48129QFpEQQ+UN4aNtmww ($16.15 in chips) 
Seat 5: rDRzxas/uMDi5Uteo081UQ ($14.50 in chips) 
Seat 6: qGHGf/553gQnDoklMRe3tg ($24.50 in chips) 
rDRzxas/uMDi5Uteo081UQ: posts small blind $0.10
qGHGf/553gQnDoklMRe3tg: posts big blind $0.25
TQ7/UUMjrZ3WL5eLMho7VQ: posts big blind $0.25
*** HOLE CARDS ***
eL3+wCBjFGfQ5FMdIZihwA: folds 
TQ7/UUMjrZ3WL5eLMho7VQ: raises $0.75 to $1
i48129QFpEQQ+UN4aNtmww: calls $1
rDRzxas/uMDi5Uteo081UQ: raises $0.75 to $1.75
qGHGf/553gQnDoklMRe3tg: folds 
TQ7/UUMjrZ3WL5eLMho7VQ: calls $0.75
i48129QFpEQQ+UN4aNtmww: calls $0.75
*** FLOP *** [Qd Ks 2h]
rDRzxas/uMDi5Uteo081UQ: checks 
TQ7/UUMjrZ3WL5eLMho7VQ: bets $3.50
i48129QFpEQQ+UN4aNtmww: folds 
rDRzxas/uMDi5Uteo081UQ: raises $3.50 to $7
TQ7/UUMjrZ3WL5eLMho7VQ: folds 
Uncalled bet ($3.50) returned to rDRzxas/uMDi5Uteo081UQ
rDRzxas/uMDi5Uteo081UQ collected $11.90 from pot
*** SUMMARY ***
Total pot $12.50 | Rake $0.60 
Board [Qd Ks 2h]
Seat 1: eL3+wCBjFGfQ5FMdIZihwA folded before Flop (didn't bet)
Seat 2: TQ7/UUMjrZ3WL5eLMho7VQ folded on the Flop
Seat 4: i48129QFpEQQ+UN4aNtmww (button) folded on the Flop
Seat 5: rDRzxas/uMDi5Uteo081UQ (small blind) collected ($11.90)
Seat 6: qGHGf/553gQnDoklMRe3tg (big blind) folded before Flop




PokerStars Game #59941954306:  Hold'em No Limit ($0.10/$0.25) - 2009/07/01 1:51:27 ET
Table 'Is9eNmJA1KnBOw0lcVkxUQ' 9-max Seat #6 is the button
Seat 3: ubsjZomMWSV0hAiBLa7K1A ($18.40 in chips) 
Seat 4: cZ99hugmLBj9KhTlc8nCSw ($25 in chips) 
Seat 5: Qduu7ikeizo6q6Ei9YvcJA ($24.65 in chips) 
Seat 6: HapyJHxV6lc3eqoT7yWL2A ($10.05 in chips) 
Seat 8: Th3FldXKQW6hWVVPahaoOQ ($25 in chips) 
18G4P1XstjNvItdGUITxgw will be allowed to play after the button
Th3FldXKQW6hWVVPahaoOQ: posts small blind $0.10
DdPXdieucQ+n99u1n3A+rQ: is sitting out 
DdPXdieucQ+n99u1n3A+rQ leaves the table
56S3mA6Zs3pGR+0p0vUCtg: is sitting out 
SargonEQ: is sitting out 
56S3mA6Zs3pGR+0p0vUCtg leaves the table
ubsjZomMWSV0hAiBLa7K1A: posts big blind $0.25
*** HOLE CARDS ***
SargonEQ leaves the table
cZ99hugmLBj9KhTlc8nCSw: folds 
cZ99hugmLBj9KhTlc8nCSw leaves the table
Qduu7ikeizo6q6Ei9YvcJA: raises $0.75 to $1
HapyJHxV6lc3eqoT7yWL2A: calls $1
Th3FldXKQW6hWVVPahaoOQ: folds 
ubsjZomMWSV0hAiBLa7K1A: folds 
*** FLOP *** [4c Th 4d]
Qduu7ikeizo6q6Ei9YvcJA: checks 
HapyJHxV6lc3eqoT7yWL2A: checks 
*** TURN *** [4c Th 4d] [Kc]
Qduu7ikeizo6q6Ei9YvcJA: bets $1.25
HapyJHxV6lc3eqoT7yWL2A: calls $1.25
*** RIVER *** [4c Th 4d Kc] [6h]
Qduu7ikeizo6q6Ei9YvcJA: checks 
HapyJHxV6lc3eqoT7yWL2A: bets $2.25
Qduu7ikeizo6q6Ei9YvcJA: calls $2.25
*** SHOW DOWN ***
HapyJHxV6lc3eqoT7yWL2A: shows [Jc 9c] (a pair of Fours)
Qduu7ikeizo6q6Ei9YvcJA: shows [5s 6s] (two pair, Sixes and Fours)
Qduu7ikeizo6q6Ei9YvcJA collected $8.90 from pot
mlXogR/AG8xUvCi1Il31lw joins the table at seat #1 
*** SUMMARY ***
Total pot $9.35 | Rake $0.45 
Board [4c Th 4d Kc 6h]
Seat 3: ubsjZomMWSV0hAiBLa7K1A (big blind) folded before Flop
Seat 4: cZ99hugmLBj9KhTlc8nCSw folded before Flop (didn't bet)
Seat 5: Qduu7ikeizo6q6Ei9YvcJA showed [5s 6s] and won ($8.90) with two pair, Sixes and Fours
Seat 6: HapyJHxV6lc3eqoT7yWL2A (button) showed [Jc 9c] and lost with a pair of Fours
Seat 8: Th3FldXKQW6hWVVPahaoOQ (small blind) folded before Flop




PokerStars Game #59941954888:  Hold'em No Limit ($0.10/$0.25) - 2009/07/01 1:51:28 ET
Table 'yZgGBnUGXVCcEJdcqes8tw' 9-max Seat #4 is the button
Seat 1: 6RiVTYll/5D8zICp0MRpKw ($30.30 in chips) 
Seat 2: MG90wfSJZnOejs/KD3vlQQ ($25 in chips) 
Seat 4: M2QO2DxB5Wawg2h8HSpnYA ($10 in chips) 
Seat 5: dfNim92Z6XK1/h5SFW5vDg ($26.10 in chips) 
Seat 6: RHqgdFvufLCYe54+qd2gcA ($5 in chips) 
Seat 7: eC8Pn1D6Y2pct8o62nQfvQ ($31.20 in chips) 
Seat 8: dtZ84flFEi4Q+SGrHMJRDQ ($29.80 in chips) 
Seat 9: M/9j4wkHH9i1JM51vgi1VA ($23.40 in chips) 
dfNim92Z6XK1/h5SFW5vDg: posts small blind $0.10
RHqgdFvufLCYe54+qd2gcA: posts big blind $0.25
z5GxcHlYz/GSz6W2uFiTtg: sits out 
*** HOLE CARDS ***
eC8Pn1D6Y2pct8o62nQfvQ: folds 
dtZ84flFEi4Q+SGrHMJRDQ: raises $0.75 to $1
M/9j4wkHH9i1JM51vgi1VA: folds 
6RiVTYll/5D8zICp0MRpKw: folds 
MG90wfSJZnOejs/KD3vlQQ: folds 
M2QO2DxB5Wawg2h8HSpnYA: folds 
dfNim92Z6XK1/h5SFW5vDg: folds 
RHqgdFvufLCYe54+qd2gcA: folds 
Uncalled bet ($0.75) returned to dtZ84flFEi4Q+SGrHMJRDQ
dtZ84flFEi4Q+SGrHMJRDQ collected $0.60 from pot
dtZ84flFEi4Q+SGrHMJRDQ: doesn't show hand 
*** SUMMARY ***
Total pot $0.60 | Rake $0 
Seat 1: 6RiVTYll/5D8zICp0MRpKw folded before Flop (didn't bet)
Seat 2: MG90wfSJZnOejs/KD3vlQQ folded before Flop (didn't bet)
Seat 4: M2QO2DxB5Wawg2h8HSpnYA (button) folded before Flop (didn't bet)
Seat 5: dfNim92Z6XK1/h5SFW5vDg (small blind) folded before Flop
Seat 6: RHqgdFvufLCYe54+qd2gcA (big blind) folded before Flop
Seat 7: eC8Pn1D6Y2pct8o62nQfvQ folded before Flop (didn't bet)
Seat 8: dtZ84flFEi4Q+SGrHMJRDQ collected ($0.60)
Seat 9: M/9j4wkHH9i1JM51vgi1VA folded before Flop (didn't bet)




PokerStars Game #59941954852:  Hold'em No Limit ($0.10/$0.25) - 2009/07/01 1:51:28 ET
Table 'IRgQPZVA4+IaZZIQshgwyg' 6-max Seat #6 is the button
Seat 1: cezpHJ8FB07dj0xG+LhOvw ($27.30 in chips) 
Seat 3: DihMHaz4WNETH1bPDe13kA ($27.45 in chips) 
Seat 4: DE9hRlt14g+JdsRQ4wT7hg ($25.35 in chips) 
Seat 5: w43JQj2oYPpKQVG4Yzlq1w ($28.05 in chips) 
Seat 6: x9/USY6PsmgUGQeluFLKDw ($20.95 in chips) 
cezpHJ8FB07dj0xG+LhOvw: posts small blind $0.10
DihMHaz4WNETH1bPDe13kA: posts big blind $0.25
*** HOLE CARDS ***
DE9hRlt14g+JdsRQ4wT7hg: folds 
w43JQj2oYPpKQVG4Yzlq1w: folds 
x9/USY6PsmgUGQeluFLKDw: folds 
cezpHJ8FB07dj0xG+LhOvw: folds 
Uncalled bet ($0.15) returned to DihMHaz4WNETH1bPDe13kA
DihMHaz4WNETH1bPDe13kA collected $0.20 from pot
*** SUMMARY ***
Total pot $0.20 | Rake $0 
Seat 1: cezpHJ8FB07dj0xG+LhOvw (small blind) folded before Flop
Seat 3: DihMHaz4WNETH1bPDe13kA (big blind) collected ($0.20)
Seat 4: DE9hRlt14g+JdsRQ4wT7hg folded before Flop (didn't bet)
Seat 5: w43JQj2oYPpKQVG4Yzlq1w folded before Flop (didn't bet)
Seat 6: x9/USY6PsmgUGQeluFLKDw (button) folded before Flop (didn't bet)




PokerStars Game #59941954650:  Hold'em No Limit ($0.10/$0.25) - 2009/07/01 1:51:28 ET
Table 'tq5CvS0RUqGkuBK0XTzqqg' 6-max Seat #6 is the button
Seat 1: +ZlnqPoP3Hg4BIUxDfKd/A ($29.70 in chips) 
Seat 3: VXTONriS+Ohik+r0FeicIw ($25 in chips) 
Seat 4: UT5XpwOH1ipkOF7n1MqDJA ($37.45 in chips) 
Seat 5: qGHGf/553gQnDoklMRe3tg ($37.90 in chips) 
Seat 6: QqiZLFrN8iOUT/GHw7ztOA ($24.30 in chips) 
+ZlnqPoP3Hg4BIUxDfKd/A: posts small blind $0.10
VXTONriS+Ohik+r0FeicIw: posts big blind $0.25
*** HOLE CARDS ***
ErIN0JRL5srYjT6en1f8YQ joins the table at seat #2 
UT5XpwOH1ipkOF7n1MqDJA: folds 
qGHGf/553gQnDoklMRe3tg: folds 
QqiZLFrN8iOUT/GHw7ztOA: folds 
+ZlnqPoP3Hg4BIUxDfKd/A: folds 
Uncalled bet ($0.15) returned to VXTONriS+Ohik+r0FeicIw
VXTONriS+Ohik+r0FeicIw collected $0.20 from pot
VXTONriS+Ohik+r0FeicIw: doesn't show hand 
*** SUMMARY ***
Total pot $0.20 | Rake $0 
Seat 1: +ZlnqPoP3Hg4BIUxDfKd/A (small blind) folded before Flop
Seat 3: VXTONriS+Ohik+r0FeicIw (big blind) collected ($0.20)
Seat 4: UT5XpwOH1ipkOF7n1MqDJA folded before Flop (didn't bet)
Seat 5: qGHGf/553gQnDoklMRe3tg folded before Flop (didn't bet)
Seat 6: QqiZLFrN8iOUT/GHw7ztOA (button) folded before Flop (didn't bet)




PokerStars Game #59941954568:  Hold'em No Limit ($0.10/$0.25) - 2009/07/01 1:51:28 ET
Table '7/qMNloI0nSXWiX5Y1watA' 9-max Seat #8 is the button
Seat 1: /LyhaB3V6jkgOfXORidqRQ ($10.40 in chips) 
Seat 2: wGigCmBR/9XWkPpvYos3aQ ($29.80 in chips) 
Seat 4: K0LdhPeU31rviEPo6Sv3TA ($9.45 in chips) 
Seat 8: ljemhp25Zg+nlA9DLCIiUw ($25.95 in chips) 
Seat 9: dmYlc+1cjwZMJ7wV+Z0rRg ($27.15 in chips) 
dmYlc+1cjwZMJ7wV+Z0rRg: posts small blind $0.10
/LyhaB3V6jkgOfXORidqRQ: posts big blind $0.25
GeMoapCKDLc4ajT0Uk9ZQw: sits out 
JqeaikMej6KsqTKmUhl2Lw: sits out 
z5GxcHlYz/GSz6W2uFiTtg: sits out 
*** HOLE CARDS ***
wGigCmBR/9XWkPpvYos3aQ: folds 
K0LdhPeU31rviEPo6Sv3TA: folds 
ljemhp25Zg+nlA9DLCIiUw: folds 
dmYlc+1cjwZMJ7wV+Z0rRg: raises $0.50 to $0.75
/LyhaB3V6jkgOfXORidqRQ: folds 
Uncalled bet ($0.50) returned to dmYlc+1cjwZMJ7wV+Z0rRg
dmYlc+1cjwZMJ7wV+Z0rRg collected $0.50 from pot
dmYlc+1cjwZMJ7wV+Z0rRg: doesn't show hand 
*** SUMMARY ***
Total pot $0.50 | Rake $0 
Seat 1: /LyhaB3V6jkgOfXORidqRQ (big blind) folded before Flop
Seat 2: wGigCmBR/9XWkPpvYos3aQ folded before Flop (didn't bet)
Seat 4: K0LdhPeU31rviEPo6Sv3TA folded before Flop (didn't bet)
Seat 8: ljemhp25Zg+nlA9DLCIiUw (button) folded before Flop (didn't bet)
Seat 9: dmYlc+1cjwZMJ7wV+Z0rRg (small blind) collected ($0.50)




PokerStars Game #59941954830:  Hold'em No Limit ($0.10/$0.25) - 2009/07/01 1:51:28 ET
Table '4mnXP0EWt9mMZYzTIVDQ0w' 9-max Seat #3 is the button
Seat 1: Z5y2J55JmfLYR6/DPAGHwQ ($17.10 in chips) 
Seat 2: BLEU2x2bnGRovIelAY6slA ($25.05 in chips) 
Seat 3: Ns4HpwO7Oiffvyla/ie56w ($17.50 in chips) 
Seat 4: 9lvO/qyU+xrU95Teu1fv0g ($12.25 in chips) 
Seat 5: sSN8Y0AlsBeidZXPKmwXSw ($25.10 in chips) 
Seat 6: 5yjzPss7Y4kAWNDat3e0yQ ($35.65 in chips) 
Seat 7: TtioUKOdJQDGtQyRAYC5Xg ($5.75 in chips) 
Seat 8: 9YN2IkT2JYYKFErZtZvCtA ($14.05 in chips) 
Seat 9: N/O9ADKpmqB2ASZuqgodlw ($7.90 in chips) 
9lvO/qyU+xrU95Teu1fv0g: posts small blind $0.10
sSN8Y0AlsBeidZXPKmwXSw: posts big blind $0.25
*** HOLE CARDS ***
5yjzPss7Y4kAWNDat3e0yQ: folds 
TtioUKOdJQDGtQyRAYC5Xg: raises $1 to $1.25
9YN2IkT2JYYKFErZtZvCtA: folds 
N/O9ADKpmqB2ASZuqgodlw: folds 
Z5y2J55JmfLYR6/DPAGHwQ: folds 
BLEU2x2bnGRovIelAY6slA: folds 
Ns4HpwO7Oiffvyla/ie56w: folds 
9lvO/qyU+xrU95Teu1fv0g: folds 
sSN8Y0AlsBeidZXPKmwXSw: folds 
Uncalled bet ($1) returned to TtioUKOdJQDGtQyRAYC5Xg
TtioUKOdJQDGtQyRAYC5Xg collected $0.60 from pot
TtioUKOdJQDGtQyRAYC5Xg: doesn't show hand 
*** SUMMARY ***
Total pot $0.60 | Rake $0 
Seat 1: Z5y2J55JmfLYR6/DPAGHwQ folded before Flop (didn't bet)
Seat 2: BLEU2x2bnGRovIelAY6slA folded before Flop (didn't bet)
Seat 3: Ns4HpwO7Oiffvyla/ie56w (button) folded before Flop (didn't bet)
Seat 4: 9lvO/qyU+xrU95Teu1fv0g (small blind) folded before Flop
Seat 5: sSN8Y0AlsBeidZXPKmwXSw (big blind) folded before Flop
Seat 6: 5yjzPss7Y4kAWNDat3e0yQ folded before Flop (didn't bet)
Seat 7: TtioUKOdJQDGtQyRAYC5Xg collected ($0.60)
Seat 8: 9YN2IkT2JYYKFErZtZvCtA folded before Flop (didn't bet)
Seat 9: N/O9ADKpmqB2ASZuqgodlw folded before Flop (didn't bet)




PokerStars Game #59941954910:  Hold'em No Limit ($0.10/$0.25) - 2009/07/01 1:51:28 ET
Table '6aL2C8IFwHHr6SG6RgXaow' 9-max Seat #5 is the button
Seat 1: FcL757vvzKRPFZ6h7YsPHA ($10.30 in chips) 
Seat 2: UmzixCpC0bAc1lDEjgB3NQ ($13.60 in chips) 
Seat 3: clJsV3v77RS07bDKY+705w ($5 in chips) 
Seat 4: BT6Oal0iO4P6kDuT7HFQDw ($19.15 in chips) 
Seat 5: wre31HfyzQGpIvID1istxw ($23.05 in chips) 
Seat 6: gehe91e0IyVT0QU/XBkEyg ($26.25 in chips) 
Seat 7: E0iYnEVO2ho7dH3QcCjw7g ($19.75 in chips) 
Seat 8: rQhYIYXSyH/IivYM1dlV5A ($21.95 in chips) 
Seat 9: CgIo2ItZqi4o3ayVG6HanQ ($23.50 in chips) 
gehe91e0IyVT0QU/XBkEyg: posts small blind $0.10
E0iYnEVO2ho7dH3QcCjw7g: posts big blind $0.25
*** HOLE CARDS ***
rQhYIYXSyH/IivYM1dlV5A: folds 
CgIo2ItZqi4o3ayVG6HanQ: folds 
FcL757vvzKRPFZ6h7YsPHA: folds 
UmzixCpC0bAc1lDEjgB3NQ: folds 
clJsV3v77RS07bDKY+705w: folds 
BT6Oal0iO4P6kDuT7HFQDw: folds 
wre31HfyzQGpIvID1istxw: raises $0.25 to $0.50
gehe91e0IyVT0QU/XBkEyg: folds 
E0iYnEVO2ho7dH3QcCjw7g: folds 
Uncalled bet ($0.25) returned to wre31HfyzQGpIvID1istxw
wre31HfyzQGpIvID1istxw collected $0.60 from pot
wre31HfyzQGpIvID1istxw: doesn't show hand 
*** SUMMARY ***
Total pot $0.60 | Rake $0 
Seat 1: FcL757vvzKRPFZ6h7YsPHA folded before Flop (didn't bet)
Seat 2: UmzixCpC0bAc1lDEjgB3NQ folded before Flop (didn't bet)
Seat 3: clJsV3v77RS07bDKY+705w folded before Flop (didn't bet)
Seat 4: BT6Oal0iO4P6kDuT7HFQDw folded before Flop (didn't bet)
Seat 5: wre31HfyzQGpIvID1istxw (button) collected ($0.60)
Seat 6: gehe91e0IyVT0QU/XBkEyg (small blind) folded before Flop
Seat 7: E0iYnEVO2ho7dH3QcCjw7g (big blind) folded before Flop
Seat 8: rQhYIYXSyH/IivYM1dlV5A folded before Flop (didn't bet)
Seat 9: CgIo2ItZqi4o3ayVG6HanQ folded before Flop (didn't bet)




PokerStars Game #59941954770:  Hold'em No Limit ($0.10/$0.25) - 2009/07/01 1:51:28 ET
Table 'R5qKG21jwFDYRcOht9qwqQ' 9-max Seat #3 is the button
Seat 1: N5sUK8M0br9djLrW97V9pQ ($24.15 in chips) 
Seat 2: N6foVRyErHqcNmshkqextQ ($13.45 in chips) 
Seat 3: M2QO2DxB5Wawg2h8HSpnYA ($10.50 in chips) 
Seat 6: EP17SQz/iWcuYdNOGeBgkw ($15.65 in chips) 
Seat 7: zgi+EUykT/pZQpoUG6+oEg ($4.65 in chips) 
Seat 8: hYvTc4PYNrAaNAIVoM94Hw ($4.40 in chips) 
Seat 9: MG90wfSJZnOejs/KD3vlQQ ($38.30 in chips) 
z5GxcHlYz/GSz6W2uFiTtg will be allowed to play after the button
EP17SQz/iWcuYdNOGeBgkw: posts small blind $0.10
zgi+EUykT/pZQpoUG6+oEg: posts big blind $0.25
*** HOLE CARDS ***
hYvTc4PYNrAaNAIVoM94Hw: calls $0.25
MG90wfSJZnOejs/KD3vlQQ: folds 
N5sUK8M0br9djLrW97V9pQ: folds 
N6foVRyErHqcNmshkqextQ: folds 
M2QO2DxB5Wawg2h8HSpnYA: folds 
EP17SQz/iWcuYdNOGeBgkw: calls $0.15
zgi+EUykT/pZQpoUG6+oEg: checks 
*** FLOP *** [Qd Kd 8d]
EP17SQz/iWcuYdNOGeBgkw: checks 
zgi+EUykT/pZQpoUG6+oEg: checks 
hYvTc4PYNrAaNAIVoM94Hw: bets $0.25
EP17SQz/iWcuYdNOGeBgkw: folds 
zgi+EUykT/pZQpoUG6+oEg: calls $0.25
*** TURN *** [Qd Kd 8d] [8c]
zgi+EUykT/pZQpoUG6+oEg: checks 
hYvTc4PYNrAaNAIVoM94Hw: bets $0.50
zgi+EUykT/pZQpoUG6+oEg: folds 
Uncalled bet ($0.50) returned to hYvTc4PYNrAaNAIVoM94Hw
hYvTc4PYNrAaNAIVoM94Hw collected $1.20 from pot
*** SUMMARY ***
Total pot $1.25 | Rake $0.05 
Board [Qd Kd 8d 8c]
Seat 1: N5sUK8M0br9djLrW97V9pQ folded before Flop (didn't bet)
Seat 2: N6foVRyErHqcNmshkqextQ folded before Flop (didn't bet)
Seat 3: M2QO2DxB5Wawg2h8HSpnYA (button) folded before Flop (didn't bet)
Seat 6: EP17SQz/iWcuYdNOGeBgkw (small blind) folded on the Flop
Seat 7: zgi+EUykT/pZQpoUG6+oEg (big blind) folded on the Turn
Seat 8: hYvTc4PYNrAaNAIVoM94Hw collected ($1.20)
Seat 9: MG90wfSJZnOejs/KD3vlQQ folded before Flop (didn't bet)




PokerStars Game #59941954742:  Hold'em No Limit ($0.10/$0.25) - 2009/07/01 1:51:28 ET
Table '/Xx5AsbRD4oNGMTFFC/92Q' 6-max Seat #2 is the button
Seat 2: N/zeVku/lNn+kUQejwmLpg ($5.50 in chips) 
Seat 4: 7/ROHX4tuLekJ2diYIlMkw ($7.30 in chips) 
Seat 6: p4A+KsSkRO/5I6h0o4VQDQ ($5 in chips) 
LAPERTUR will be allowed to play after the button
7/ROHX4tuLekJ2diYIlMkw: posts small blind $0.10
p4A+KsSkRO/5I6h0o4VQDQ: posts big blind $0.25
*** HOLE CARDS ***
kMa8BltUcBQVxnHfqdCfXg joins the table at seat #5 
N/zeVku/lNn+kUQejwmLpg: calls $0.25
7/ROHX4tuLekJ2diYIlMkw: calls $0.15
p4A+KsSkRO/5I6h0o4VQDQ: raises $0.75 to $1
N/zeVku/lNn+kUQejwmLpg: calls $0.75
7/ROHX4tuLekJ2diYIlMkw: calls $0.75
*** FLOP *** [6h 4h 2d]
LAPERTUR is sitting out
7/ROHX4tuLekJ2diYIlMkw: bets $6
p4A+KsSkRO/5I6h0o4VQDQ: folds 
N/zeVku/lNn+kUQejwmLpg: calls $4.50 and is all-in
Uncalled bet ($1.50) returned to 7/ROHX4tuLekJ2diYIlMkw
*** TURN *** [6h 4h 2d] [8h]
*** RIVER *** [6h 4h 2d 8h] [3c]
*** SHOW DOWN ***
7/ROHX4tuLekJ2diYIlMkw: shows [Kc 2c] (a pair of Deuces)
N/zeVku/lNn+kUQejwmLpg: shows [Ad 5s] (a straight, Deuce to Six)
N/zeVku/lNn+kUQejwmLpg collected $11.45 from pot
*** SUMMARY ***
Total pot $12 | Rake $0.55 
Board [6h 4h 2d 8h 3c]
Seat 2: N/zeVku/lNn+kUQejwmLpg (button) showed [Ad 5s] and won ($11.45) with a straight, Deuce to Six
Seat 4: 7/ROHX4tuLekJ2diYIlMkw (small blind) showed [Kc 2c] and lost with a pair of Deuces
Seat 6: p4A+KsSkRO/5I6h0o4VQDQ (big blind) folded on the Flop




PokerStars Game #59941955484:  Hold'em No Limit ($0.10/$0.25) - 2009/07/01 1:51:29 ET
Table 'mk323gviqdkOY5Aek/1EWg' 6-max Seat #1 is the button
Seat 1: 7cx44/slbeTw+Cy7QB8Trg ($24.65 in chips) 
Seat 2: GC/9yVD59DUCX7hUI7gcLw ($57.30 in chips) 
Seat 3: NuqYPwTLZYQhxOoVK3Yqlw ($26.30 in chips) 
Seat 4: +baiVgI/ETnBARLe5mARCw ($11.20 in chips) 
Seat 5: kjYRzIfvZNNflYMYRkkSVA ($36.30 in chips) 
Seat 6: KkXSr5xFjxLSD3wtAvT+WQ ($5.75 in chips) 
GC/9yVD59DUCX7hUI7gcLw: posts small blind $0.10
NuqYPwTLZYQhxOoVK3Yqlw: posts big blind $0.25
*** HOLE CARDS ***
+baiVgI/ETnBARLe5mARCw: folds 
kjYRzIfvZNNflYMYRkkSVA: folds 
KkXSr5xFjxLSD3wtAvT+WQ: calls $0.25
7cx44/slbeTw+Cy7QB8Trg: folds 
GC/9yVD59DUCX7hUI7gcLw: calls $0.15
NuqYPwTLZYQhxOoVK3Yqlw: checks 
*** FLOP *** [Qh Kc 3s]
GC/9yVD59DUCX7hUI7gcLw: checks 
NuqYPwTLZYQhxOoVK3Yqlw: checks 
KkXSr5xFjxLSD3wtAvT+WQ: bets $0.25
GC/9yVD59DUCX7hUI7gcLw: folds 
NuqYPwTLZYQhxOoVK3Yqlw: calls $0.25
*** TURN *** [Qh Kc 3s] [5s]
NuqYPwTLZYQhxOoVK3Yqlw: checks 
KkXSr5xFjxLSD3wtAvT+WQ: bets $0.25
NuqYPwTLZYQhxOoVK3Yqlw: calls $0.25
*** RIVER *** [Qh Kc 3s 5s] [Jc]
NuqYPwTLZYQhxOoVK3Yqlw: checks 
KkXSr5xFjxLSD3wtAvT+WQ: checks 
*** SHOW DOWN ***
NuqYPwTLZYQhxOoVK3Yqlw: shows [Tc Jh] (a pair of Jacks)
KkXSr5xFjxLSD3wtAvT+WQ: shows [Kh 4h] (a pair of Kings)
KkXSr5xFjxLSD3wtAvT+WQ collected $1.70 from pot
*** SUMMARY ***
Total pot $1.75 | Rake $0.05 
Board [Qh Kc 3s 5s Jc]
Seat 1: 7cx44/slbeTw+Cy7QB8Trg (button) folded before Flop (didn't bet)
Seat 2: GC/9yVD59DUCX7hUI7gcLw (small blind) folded on the Flop
Seat 3: NuqYPwTLZYQhxOoVK3Yqlw (big blind) showed [Tc Jh] and lost with a pair of Jacks
Seat 4: +baiVgI/ETnBARLe5mARCw folded before Flop (didn't bet)
Seat 5: kjYRzIfvZNNflYMYRkkSVA folded before Flop (didn't bet)
Seat 6: KkXSr5xFjxLSD3wtAvT+WQ showed [Kh 4h] and won ($1.70) with a pair of Kings




PokerStars Game #59941955030:  Hold'em No Limit ($0.10/$0.25) - 2009/07/01 1:51:29 ET
Table 'sgdCtiuCu2BDZhyDi6RzTA' 6-max Seat #6 is the button
Seat 1: 3zD3qLXT1bEffAoWGnc7wg ($35.15 in chips) 
Seat 2: 88Xc2CgPRIRNHZycxJdBtQ ($25 in chips) 
Seat 3: eL3+wCBjFGfQ5FMdIZihwA ($27.55 in chips) 
Seat 4: rVKEgilmMX+EkKzDVvhmxA ($6.50 in chips) 
Seat 5: 0tQitW75xfmVWKldYHjmOQ ($3.70 in chips) 
Seat 6: KODslGU8ikCYS0/29dUkhg ($32.95 in chips) 
3zD3qLXT1bEffAoWGnc7wg: posts small blind $0.10
88Xc2CgPRIRNHZycxJdBtQ: posts big blind $0.25
*** HOLE CARDS ***
eL3+wCBjFGfQ5FMdIZihwA: folds 
rVKEgilmMX+EkKzDVvhmxA: folds 
0tQitW75xfmVWKldYHjmOQ: folds 
KODslGU8ikCYS0/29dUkhg: calls $0.25
3zD3qLXT1bEffAoWGnc7wg: folds 
88Xc2CgPRIRNHZycxJdBtQ: checks 
*** FLOP *** [6s 2c Jh]
88Xc2CgPRIRNHZycxJdBtQ: bets $0.50
KODslGU8ikCYS0/29dUkhg: calls $0.50
*** TURN *** [6s 2c Jh] [Js]
88Xc2CgPRIRNHZycxJdBtQ: bets $0.75
KODslGU8ikCYS0/29dUkhg: folds 
Uncalled bet ($0.75) returned to 88Xc2CgPRIRNHZycxJdBtQ
88Xc2CgPRIRNHZycxJdBtQ collected $1.55 from pot
*** SUMMARY ***
Total pot $1.60 | Rake $0.05 
Board [6s 2c Jh Js]
Seat 1: 3zD3qLXT1bEffAoWGnc7wg (small blind) folded before Flop
Seat 2: 88Xc2CgPRIRNHZycxJdBtQ (big blind) collected ($1.55)
Seat 3: eL3+wCBjFGfQ5FMdIZihwA folded before Flop (didn't bet)
Seat 4: rVKEgilmMX+EkKzDVvhmxA folded before Flop (didn't bet)
Seat 5: 0tQitW75xfmVWKldYHjmOQ folded before Flop (didn't bet)
Seat 6: KODslGU8ikCYS0/29dUkhg (button) folded on the Turn




PokerStars Game #59941955334:  Hold'em No Limit ($0.10/$0.25) - 2009/07/01 1:51:29 ET
Table 'aT31tt16YvQM/Ue69HPLpA' 9-max Seat #1 is the button
Seat 1: wxmepRUXfX1jdQfUD5uENQ ($4.40 in chips) 
Seat 3: swK30YlQuxRQO7QFr4ZxCA ($25.10 in chips) 
Seat 4: wGigCmBR/9XWkPpvYos3aQ ($26.85 in chips) 
Seat 5: s2xLPOl/vhl/26apJ3vsOQ ($33.90 in chips) 
Seat 6: ghG12/paEL5VoDN85sW6RA ($15 in chips) 
Seat 9: TvIuLx9zUCE+9Li58iImOQ ($13.60 in chips) 
swK30YlQuxRQO7QFr4ZxCA: posts small blind $0.10
wGigCmBR/9XWkPpvYos3aQ: posts big blind $0.25
*** HOLE CARDS ***
s2xLPOl/vhl/26apJ3vsOQ: folds 
ghG12/paEL5VoDN85sW6RA: calls $0.25
TvIuLx9zUCE+9Li58iImOQ: folds 
wxmepRUXfX1jdQfUD5uENQ: folds 
swK30YlQuxRQO7QFr4ZxCA: folds 
JoKeR_1216 joins the table at seat #7 
wGigCmBR/9XWkPpvYos3aQ: checks 
*** FLOP *** [8c 9h 6d]
wGigCmBR/9XWkPpvYos3aQ: checks 
ghG12/paEL5VoDN85sW6RA: bets $0.50
8CoKLhwk8Ja6X+O9fxTEDg joins the table at seat #2 
wGigCmBR/9XWkPpvYos3aQ: folds 
Uncalled bet ($0.50) returned to ghG12/paEL5VoDN85sW6RA
ghG12/paEL5VoDN85sW6RA collected $0.60 from pot
*** SUMMARY ***
Total pot $0.60 | Rake $0 
Board [8c 9h 6d]
Seat 1: wxmepRUXfX1jdQfUD5uENQ (button) folded before Flop (didn't bet)
Seat 3: swK30YlQuxRQO7QFr4ZxCA (small blind) folded before Flop
Seat 4: wGigCmBR/9XWkPpvYos3aQ (big blind) folded on the Flop
Seat 5: s2xLPOl/vhl/26apJ3vsOQ folded before Flop (didn't bet)
Seat 6: ghG12/paEL5VoDN85sW6RA collected ($0.60)
Seat 9: TvIuLx9zUCE+9Li58iImOQ folded before Flop (didn't bet)




PokerStars Game #59941955250:  Hold'em No Limit ($0.10/$0.25) - 2009/07/01 1:51:29 ET
Table 'nXVbUw6/HYwA6x21+IZ3XQ' 9-max Seat #7 is the button
Seat 1: zDrucyjVn5aeekNEc3cJrA ($17.35 in chips) 
Seat 2: 9lvO/qyU+xrU95Teu1fv0g ($10.25 in chips) 
Seat 3: MB0wa15P+9QHcBApEdgQFw ($11.35 in chips) 
Seat 4: SpiiQQAzy4MUgV3I5W8giw ($24.65 in chips) 
Seat 5: M/9j4wkHH9i1JM51vgi1VA ($31.60 in chips) 
Seat 6: ljemhp25Zg+nlA9DLCIiUw ($26.85 in chips) 
Seat 7: ShCS62CJp4MKfKLKvGKQbA ($11.85 in chips) 
Seat 8: dfNim92Z6XK1/h5SFW5vDg ($25 in chips) 
Seat 9: OTCjTlu92MEBtX/i9Gm7yA ($9.60 in chips) 
dfNim92Z6XK1/h5SFW5vDg: posts small blind $0.10
OTCjTlu92MEBtX/i9Gm7yA: posts big blind $0.25
*** HOLE CARDS ***
zDrucyjVn5aeekNEc3cJrA: folds 
9lvO/qyU+xrU95Teu1fv0g: folds 
MB0wa15P+9QHcBApEdgQFw: raises $0.25 to $0.50
SpiiQQAzy4MUgV3I5W8giw: folds 
M/9j4wkHH9i1JM51vgi1VA: folds 
ljemhp25Zg+nlA9DLCIiUw: folds 
ShCS62CJp4MKfKLKvGKQbA: folds 
dfNim92Z6XK1/h5SFW5vDg: folds 
OTCjTlu92MEBtX/i9Gm7yA: folds 
Uncalled bet ($0.25) returned to MB0wa15P+9QHcBApEdgQFw
MB0wa15P+9QHcBApEdgQFw collected $0.60 from pot
MB0wa15P+9QHcBApEdgQFw: shows [Jc Ad] (high card Ace)
*** SUMMARY ***
Total pot $0.60 | Rake $0 
Seat 1: zDrucyjVn5aeekNEc3cJrA folded before Flop (didn't bet)
Seat 2: 9lvO/qyU+xrU95Teu1fv0g folded before Flop (didn't bet)
Seat 3: MB0wa15P+9QHcBApEdgQFw collected ($0.60)
Seat 4: SpiiQQAzy4MUgV3I5W8giw folded before Flop (didn't bet)
Seat 5: M/9j4wkHH9i1JM51vgi1VA folded before Flop (didn't bet)
Seat 6: ljemhp25Zg+nlA9DLCIiUw folded before Flop (didn't bet)
Seat 7: ShCS62CJp4MKfKLKvGKQbA (button) folded before Flop (didn't bet)
Seat 8: dfNim92Z6XK1/h5SFW5vDg (small blind) folded before Flop
Seat 9: OTCjTlu92MEBtX/i9Gm7yA (big blind) folded before Flop




PokerStars Game #59941955028:  Hold'em No Limit ($0.10/$0.25) - 2009/07/01 1:51:29 ET
Table 'bIGKmJgZehWJ+FAo8b85iw' 9-max Seat #8 is the button
Seat 1: yyG4svzOpC1A+sUP/scg6w ($7.25 in chips) 
Seat 2: cCjRCvseA9rZn7Xr+GCCHg ($25.80 in chips) 
Seat 3: /FyMUX+W/tpNFcRWbUTJxQ ($23.85 in chips) 
Seat 4: LGxBRjCRn6KlQ/6B4eoXbA ($36.15 in chips) 
Seat 5: uLP/lYn7oKq9xCChBXsXxw ($24.65 in chips) 
Seat 6: PFNLAvMkr8qKc7xCiH0wTA ($19.90 in chips) 
Seat 7: mMd8CDS/but3UC+Zp7Up2w ($20 in chips) 
Seat 8: +2kMBNpY4nF1qNCRd8SJLA ($53.85 in chips) 
TidusNexus will be allowed to play after the button
yyG4svzOpC1A+sUP/scg6w: posts small blind $0.10
cCjRCvseA9rZn7Xr+GCCHg: posts big blind $0.25
*** HOLE CARDS ***
/FyMUX+W/tpNFcRWbUTJxQ: folds 
LGxBRjCRn6KlQ/6B4eoXbA: calls $0.25
uLP/lYn7oKq9xCChBXsXxw: folds 
PFNLAvMkr8qKc7xCiH0wTA: folds 
mMd8CDS/but3UC+Zp7Up2w: folds 
+2kMBNpY4nF1qNCRd8SJLA: folds 
yyG4svzOpC1A+sUP/scg6w: calls $0.15
cCjRCvseA9rZn7Xr+GCCHg: checks 
*** FLOP *** [2s 5h 2d]
yyG4svzOpC1A+sUP/scg6w: checks 
cCjRCvseA9rZn7Xr+GCCHg: checks 
LGxBRjCRn6KlQ/6B4eoXbA: bets $0.75
yyG4svzOpC1A+sUP/scg6w: folds 
TidusNexus leaves the table
cCjRCvseA9rZn7Xr+GCCHg: folds 
Uncalled bet ($0.75) returned to LGxBRjCRn6KlQ/6B4eoXbA
LGxBRjCRn6KlQ/6B4eoXbA collected $0.75 from pot
LGxBRjCRn6KlQ/6B4eoXbA: doesn't show hand 
*** SUMMARY ***
Total pot $0.75 | Rake $0 
Board [2s 5h 2d]
Seat 1: yyG4svzOpC1A+sUP/scg6w (small blind) folded on the Flop
Seat 2: cCjRCvseA9rZn7Xr+GCCHg (big blind) folded on the Flop
Seat 3: /FyMUX+W/tpNFcRWbUTJxQ folded before Flop (didn't bet)
Seat 4: LGxBRjCRn6KlQ/6B4eoXbA collected ($0.75)
Seat 5: uLP/lYn7oKq9xCChBXsXxw folded before Flop (didn't bet)
Seat 6: PFNLAvMkr8qKc7xCiH0wTA folded before Flop (didn't bet)
Seat 7: mMd8CDS/but3UC+Zp7Up2w folded before Flop (didn't bet)
Seat 8: +2kMBNpY4nF1qNCRd8SJLA (button) folded before Flop (didn't bet)




PokerStars Game #59941955082:  Hold'em No Limit ($0.10/$0.25) - 2009/07/01 1:51:29 ET
Table 'PCxB2W9H6ma8SwsZlImuOw' 9-max Seat #6 is the button
Seat 1: SqibpGx+lf+brY0fJVvD0w ($32.70 in chips) 
Seat 2: bXpVeaSTPBFSPJmeXxO7nw ($4.65 in chips) 
Seat 3: J2a/QHAWUgo6beDRoEyg2g ($5.60 in chips) 
Seat 4: RsPwA2DnzOke3hD/Of/DUg ($2.20 in chips) 
Seat 5: GZO7tOXatVoX17M2DqPcUQ ($16.85 in chips) 
Seat 6: 5/6dWEBUHldD7iGXa2LwsQ ($15.45 in chips) 
Seat 8: Pt637jKksB5MzP0UNJAAkw ($24.10 in chips) 
Seat 9: COwSH15MvHaRF7en6/TRZQ ($6.70 in chips) 
qwr38jl5txoR36M7G5qi4A will be allowed to play after the button
Pt637jKksB5MzP0UNJAAkw: posts small blind $0.10
COwSH15MvHaRF7en6/TRZQ: posts big blind $0.25
*** HOLE CARDS ***
SqibpGx+lf+brY0fJVvD0w: raises $0.50 to $0.75
bXpVeaSTPBFSPJmeXxO7nw: folds 
J2a/QHAWUgo6beDRoEyg2g: calls $0.75
RsPwA2DnzOke3hD/Of/DUg: folds 
GZO7tOXatVoX17M2DqPcUQ: folds 
5/6dWEBUHldD7iGXa2LwsQ: folds 
Pt637jKksB5MzP0UNJAAkw: folds 
COwSH15MvHaRF7en6/TRZQ: raises $5.95 to $6.70 and is all-in
SqibpGx+lf+brY0fJVvD0w: calls $5.95
J2a/QHAWUgo6beDRoEyg2g: calls $4.85 and is all-in
*** FLOP *** [8h 6s 3c]
*** TURN *** [8h 6s 3c] [9s]
*** RIVER *** [8h 6s 3c 9s] [5h]
*** SHOW DOWN ***
COwSH15MvHaRF7en6/TRZQ: shows [Qh Qd] (a pair of Queens)
SqibpGx+lf+brY0fJVvD0w: mucks hand 
COwSH15MvHaRF7en6/TRZQ collected $2.05 from side pot
J2a/QHAWUgo6beDRoEyg2g: mucks hand 
COwSH15MvHaRF7en6/TRZQ collected $16.10 from main pot
*** SUMMARY ***
Total pot $19.10 Main pot $16.10. Side pot $2.05. | Rake $0.95 
Board [8h 6s 3c 9s 5h]
Seat 1: SqibpGx+lf+brY0fJVvD0w mucked
Seat 2: bXpVeaSTPBFSPJmeXxO7nw folded before Flop (didn't bet)
Seat 3: J2a/QHAWUgo6beDRoEyg2g mucked
Seat 4: RsPwA2DnzOke3hD/Of/DUg folded before Flop (didn't bet)
Seat 5: GZO7tOXatVoX17M2DqPcUQ folded before Flop (didn't bet)
Seat 6: 5/6dWEBUHldD7iGXa2LwsQ (button) folded before Flop (didn't bet)
Seat 8: Pt637jKksB5MzP0UNJAAkw (small blind) folded before Flop
Seat 9: COwSH15MvHaRF7en6/TRZQ (big blind) showed [Qh Qd] and won ($18.15) with a pair of Queens




PokerStars Game #59941955268:  Hold'em No Limit ($0.10/$0.25) - 2009/07/01 1:51:29 ET
Table 'sm5gqEvXgLbkkE4dryW/5g' 6-max Seat #1 is the button
Seat 1: v8m8XHovI5tqEA9mvplDSw ($39.50 in chips) 
Seat 2: 5xs5/u2z1CO9zkRvH72MQg ($18.10 in chips) 
Seat 3: UT5XpwOH1ipkOF7n1MqDJA ($20.10 in chips) 
Seat 4: cWc85bEzdRzpUMhRKm8pwQ ($27.30 in chips) 
Seat 6: aogAb4Eienxztk8p2v9VVw ($22.15 in chips) 
5xs5/u2z1CO9zkRvH72MQg: posts small blind $0.10
UT5XpwOH1ipkOF7n1MqDJA: posts big blind $0.25
AyreonChen: sits out 
*** HOLE CARDS ***
cWc85bEzdRzpUMhRKm8pwQ: folds 
aogAb4Eienxztk8p2v9VVw: folds 
v8m8XHovI5tqEA9mvplDSw: folds 
5xs5/u2z1CO9zkRvH72MQg: calls $0.15
UT5XpwOH1ipkOF7n1MqDJA: checks 
*** FLOP *** [Jd 2h 5d]
5xs5/u2z1CO9zkRvH72MQg: checks 
UT5XpwOH1ipkOF7n1MqDJA: bets $0.50
5xs5/u2z1CO9zkRvH72MQg: calls $0.50
*** TURN *** [Jd 2h 5d] [9d]
5xs5/u2z1CO9zkRvH72MQg: checks 
UT5XpwOH1ipkOF7n1MqDJA: checks 
*** RIVER *** [Jd 2h 5d 9d] [As]
5xs5/u2z1CO9zkRvH72MQg: checks 
UT5XpwOH1ipkOF7n1MqDJA: checks 
*** SHOW DOWN ***
5xs5/u2z1CO9zkRvH72MQg: shows [Qd Kc] (high card Ace)
UT5XpwOH1ipkOF7n1MqDJA: shows [6h Js] (a pair of Jacks)
UT5XpwOH1ipkOF7n1MqDJA collected $1.45 from pot
*** SUMMARY ***
Total pot $1.50 | Rake $0.05 
Board [Jd 2h 5d 9d As]
Seat 1: v8m8XHovI5tqEA9mvplDSw (button) folded before Flop (didn't bet)
Seat 2: 5xs5/u2z1CO9zkRvH72MQg (small blind) showed [Qd Kc] and lost with high card Ace
Seat 3: UT5XpwOH1ipkOF7n1MqDJA (big blind) showed [6h Js] and won ($1.45) with a pair of Jacks
Seat 4: cWc85bEzdRzpUMhRKm8pwQ folded before Flop (didn't bet)
Seat 6: aogAb4Eienxztk8p2v9VVw folded before Flop (didn't bet)




PokerStars Game #59941955346:  Hold'em No Limit ($0.10/$0.25) - 2009/07/01 1:51:29 ET
Table 'rhQuIjJo0UQ7RRUlF9umHg' 6-max Seat #1 is the button
Seat 1: 5O3Hj9Qg0SqOyKEXoLpjPg ($179.95 in chips) 
Seat 2: Ew/TYPQIsbQ2X8nm5iAJBg ($25.70 in chips) 
Seat 3: if4dh6jhJXeN3/qd3qCp9g ($27.05 in chips) 
Seat 5: dOX4wnYV2sEqvDbF+8KSCw ($66.55 in chips) 
Seat 6: /gJNBeCkWL4o85/jvlZ4BA ($47.70 in chips) 
Ew/TYPQIsbQ2X8nm5iAJBg: posts small blind $0.10
if4dh6jhJXeN3/qd3qCp9g: posts big blind $0.25
aogAb4Eienxztk8p2v9VVw: sits out 
*** HOLE CARDS ***
dOX4wnYV2sEqvDbF+8KSCw: folds 
/gJNBeCkWL4o85/jvlZ4BA: folds 
5O3Hj9Qg0SqOyKEXoLpjPg: calls $0.25
Ew/TYPQIsbQ2X8nm5iAJBg: folds 
if4dh6jhJXeN3/qd3qCp9g: checks 
*** FLOP *** [Ac Jc 2d]
if4dh6jhJXeN3/qd3qCp9g: checks 
5O3Hj9Qg0SqOyKEXoLpjPg: bets $0.50
if4dh6jhJXeN3/qd3qCp9g: folds 
Uncalled bet ($0.50) returned to 5O3Hj9Qg0SqOyKEXoLpjPg
5O3Hj9Qg0SqOyKEXoLpjPg collected $0.60 from pot
5O3Hj9Qg0SqOyKEXoLpjPg: doesn't show hand 
*** SUMMARY ***
Total pot $0.60 | Rake $0 
Board [Ac Jc 2d]
Seat 1: 5O3Hj9Qg0SqOyKEXoLpjPg (button) collected ($0.60)
Seat 2: Ew/TYPQIsbQ2X8nm5iAJBg (small blind) folded before Flop
Seat 3: if4dh6jhJXeN3/qd3qCp9g (big blind) folded on the Flop
Seat 5: dOX4wnYV2sEqvDbF+8KSCw folded before Flop (didn't bet)
Seat 6: /gJNBeCkWL4o85/jvlZ4BA folded before Flop (didn't bet)




PokerStars Game #59941955106:  Hold'em No Limit ($0.10/$0.25) - 2009/07/01 1:51:29 ET
Table 'AchTjdLS1zBUbH3ZIx6f0w' 6-max Seat #2 is the button
Seat 1: rZ0bUtoerhFGDUSRQMnFog ($30.05 in chips) 
Seat 2: kG34n23qFQA3nzdOJTQ1dA ($65.55 in chips) 
Seat 4: q6WfTUAD9mowIP63ASq2Dg ($30.70 in chips) 
Seat 5: 0av6tRNdi0Ui4f15L7gsVg ($23.65 in chips) 
Seat 6: epAUIB7h2FJXzUPRIvSkRA ($25.75 in chips) 
MVzl6OsGybVDNd3Vr9LYAA will be allowed to play after the button
q6WfTUAD9mowIP63ASq2Dg: posts small blind $0.10
0av6tRNdi0Ui4f15L7gsVg: posts big blind $0.25
*** HOLE CARDS ***
epAUIB7h2FJXzUPRIvSkRA: folds 
rZ0bUtoerhFGDUSRQMnFog: calls $0.25
kG34n23qFQA3nzdOJTQ1dA: folds 
q6WfTUAD9mowIP63ASq2Dg: raises $0.75 to $1
0av6tRNdi0Ui4f15L7gsVg: folds 
rZ0bUtoerhFGDUSRQMnFog: calls $0.75
*** FLOP *** [3d 4c 5c]
q6WfTUAD9mowIP63ASq2Dg: bets $1.50
rZ0bUtoerhFGDUSRQMnFog: calls $1.50
*** TURN *** [3d 4c 5c] [8c]
q6WfTUAD9mowIP63ASq2Dg: bets $3
rZ0bUtoerhFGDUSRQMnFog: calls $3
*** RIVER *** [3d 4c 5c 8c] [3h]
q6WfTUAD9mowIP63ASq2Dg: checks 
rZ0bUtoerhFGDUSRQMnFog: checks 
*** SHOW DOWN ***
q6WfTUAD9mowIP63ASq2Dg: shows [Ad Ah] (two pair, Aces and Threes)
rZ0bUtoerhFGDUSRQMnFog: mucks hand 
q6WfTUAD9mowIP63ASq2Dg collected $10.70 from pot
*** SUMMARY ***
Total pot $11.25 | Rake $0.55 
Board [3d 4c 5c 8c 3h]
Seat 1: rZ0bUtoerhFGDUSRQMnFog mucked
Seat 2: kG34n23qFQA3nzdOJTQ1dA (button) folded before Flop (didn't bet)
Seat 4: q6WfTUAD9mowIP63ASq2Dg (small blind) showed [Ad Ah] and won ($10.70) with two pair, Aces and Threes
Seat 5: 0av6tRNdi0Ui4f15L7gsVg (big blind) folded before Flop
Seat 6: epAUIB7h2FJXzUPRIvSkRA folded before Flop (didn't bet)




PokerStars Game #59941955652:  Hold'em No Limit ($0.10/$0.25) - 2009/07/01 1:51:30 ET
Table 'G26g8jde1eR+mmabeFeSlw' 9-max Seat #5 is the button
Seat 1: wnerYvSRWT9Sm4X3ip/c8w ($24.65 in chips) 
Seat 2: BFYwQ0J4xWUQvouudojivA ($15.45 in chips) 
Seat 4: 8EbrQ/EvFWt2cr0GaU82gQ ($5.40 in chips) 
Seat 5: hJ4uYjNmSZdjrKA8cjZqCA ($39.25 in chips) 
Seat 6: AHGkesF/mi4sDMpqrxBUoA ($8.65 in chips) 
Seat 7: nm4Dj/f+jJEwKVsUnKh73g ($38.55 in chips) 
Seat 8: CvL9Ch1HYCVbTsfpNucitg ($3.50 in chips) 
Seat 9: VWUWpMLMj/Q1jRVpF7Aohw ($13.30 in chips) 
AHGkesF/mi4sDMpqrxBUoA: posts small blind $0.10
nm4Dj/f+jJEwKVsUnKh73g: posts big blind $0.25
*** HOLE CARDS ***
CvL9Ch1HYCVbTsfpNucitg: folds 
VWUWpMLMj/Q1jRVpF7Aohw: folds 
wnerYvSRWT9Sm4X3ip/c8w: folds 
BFYwQ0J4xWUQvouudojivA: folds 
s2xLPOl/vhl/26apJ3vsOQ joins the table at seat #3 
8EbrQ/EvFWt2cr0GaU82gQ: folds 
hJ4uYjNmSZdjrKA8cjZqCA: calls $0.25
AHGkesF/mi4sDMpqrxBUoA: calls $0.15
nm4Dj/f+jJEwKVsUnKh73g: checks 
*** FLOP *** [7s 6c Qh]
AHGkesF/mi4sDMpqrxBUoA: checks 
nm4Dj/f+jJEwKVsUnKh73g: checks 
hJ4uYjNmSZdjrKA8cjZqCA: checks 
*** TURN *** [7s 6c Qh] [Ts]
AHGkesF/mi4sDMpqrxBUoA: checks 
nm4Dj/f+jJEwKVsUnKh73g: checks 
hJ4uYjNmSZdjrKA8cjZqCA: checks 
*** RIVER *** [7s 6c Qh Ts] [6d]
AHGkesF/mi4sDMpqrxBUoA: checks 
BFYwQ0J4xWUQvouudojivA leaves the table
nm4Dj/f+jJEwKVsUnKh73g: checks 
hJ4uYjNmSZdjrKA8cjZqCA: checks 
*** SHOW DOWN ***
AHGkesF/mi4sDMpqrxBUoA: shows [2d Kh] (a pair of Sixes)
nm4Dj/f+jJEwKVsUnKh73g: mucks hand 
hJ4uYjNmSZdjrKA8cjZqCA: shows [8d Ad] (a pair of Sixes - Ace kicker)
hJ4uYjNmSZdjrKA8cjZqCA collected $0.75 from pot
*** SUMMARY ***
Total pot $0.75 | Rake $0 
Board [7s 6c Qh Ts 6d]
Seat 1: wnerYvSRWT9Sm4X3ip/c8w folded before Flop (didn't bet)
Seat 2: BFYwQ0J4xWUQvouudojivA folded before Flop (didn't bet)
Seat 4: 8EbrQ/EvFWt2cr0GaU82gQ folded before Flop (didn't bet)
Seat 5: hJ4uYjNmSZdjrKA8cjZqCA (button) showed [8d Ad] and won ($0.75) with a pair of Sixes
Seat 6: AHGkesF/mi4sDMpqrxBUoA (small blind) showed [2d Kh] and lost with a pair of Sixes
Seat 7: nm4Dj/f+jJEwKVsUnKh73g (big blind) mucked
Seat 8: CvL9Ch1HYCVbTsfpNucitg folded before Flop (didn't bet)
Seat 9: VWUWpMLMj/Q1jRVpF7Aohw folded before Flop (didn't bet)




PokerStars Game #59941955816:  Hold'em No Limit ($0.10/$0.25) - 2009/07/01 1:51:30 ET
Table 'C47I7CmrmFr8Oo7wOovVwQ' 6-max Seat #1 is the button
Seat 1: aKCh+0w6BCOX3sJAdIVLMw ($4.65 in chips) 
Seat 2: 8JTm/CXBn3+kuQgcUOgPkw ($24.50 in chips) 
Seat 4: yY5JuFtDfXWRaZlVby4LLw ($9.50 in chips) 
Seat 5: or309yYY9Y9bfFWtrB0yUg ($5.10 in chips) 
Seat 6: pD7ri5wL3vsa6S1ulMYQmQ ($26.60 in chips) 
8JTm/CXBn3+kuQgcUOgPkw: posts small blind $0.10
yY5JuFtDfXWRaZlVby4LLw: posts big blind $0.25
*** HOLE CARDS ***
or309yYY9Y9bfFWtrB0yUg: folds 
pD7ri5wL3vsa6S1ulMYQmQ: folds 
aKCh+0w6BCOX3sJAdIVLMw: folds 
8JTm/CXBn3+kuQgcUOgPkw: folds 
Uncalled bet ($0.15) returned to yY5JuFtDfXWRaZlVby4LLw
yY5JuFtDfXWRaZlVby4LLw collected $0.20 from pot
*** SUMMARY ***
Total pot $0.20 | Rake $0 
Seat 1: aKCh+0w6BCOX3sJAdIVLMw (button) folded before Flop (didn't bet)
Seat 2: 8JTm/CXBn3+kuQgcUOgPkw (small blind) folded before Flop
Seat 4: yY5JuFtDfXWRaZlVby4LLw (big blind) collected ($0.20)
Seat 5: or309yYY9Y9bfFWtrB0yUg folded before Flop (didn't bet)
Seat 6: pD7ri5wL3vsa6S1ulMYQmQ folded before Flop (didn't bet)




PokerStars Game #59941955744:  Hold'em No Limit ($0.10/$0.25) - 2009/07/01 1:51:30 ET
Table 'b64Z+5XI1xkQzNfq4QHr3A' 6-max Seat #4 is the button
Seat 2: A6SjYLoKeIpFjPq0BK/2WA ($14 in chips) 
Seat 3: 7cx44/slbeTw+Cy7QB8Trg ($24.90 in chips) 
Seat 4: 564zqq2DUHXR3tdsOJU6JA ($16.30 in chips) 
Seat 6: 8ClCHtFXGNplITm+63KB+Q ($31.25 in chips) 
8ClCHtFXGNplITm+63KB+Q: posts small blind $0.10
A6SjYLoKeIpFjPq0BK/2WA: posts big blind $0.25
*** HOLE CARDS ***
7cx44/slbeTw+Cy7QB8Trg: folds 
08V++DOqzaNrRNsHIwi25w joins the table at seat #5 
564zqq2DUHXR3tdsOJU6JA: raises $1 to $1.25
8ClCHtFXGNplITm+63KB+Q: folds 
A6SjYLoKeIpFjPq0BK/2WA: folds 
Uncalled bet ($1) returned to 564zqq2DUHXR3tdsOJU6JA
564zqq2DUHXR3tdsOJU6JA collected $0.60 from pot
564zqq2DUHXR3tdsOJU6JA: doesn't show hand 
*** SUMMARY ***
Total pot $0.60 | Rake $0 
Seat 2: A6SjYLoKeIpFjPq0BK/2WA (big blind) folded before Flop
Seat 3: 7cx44/slbeTw+Cy7QB8Trg folded before Flop (didn't bet)
Seat 4: 564zqq2DUHXR3tdsOJU6JA (button) collected ($0.60)
Seat 6: 8ClCHtFXGNplITm+63KB+Q (small blind) folded before Flop




PokerStars Game #59941955740:  Hold'em No Limit ($0.10/$0.25) - 2009/07/01 1:51:30 ET
Table '0M5QEJGOThqZwQ/sjbjXYw' 6-max Seat #6 is the button
Seat 2: /gJNBeCkWL4o85/jvlZ4BA ($32.95 in chips) 
Seat 3: 3zD3qLXT1bEffAoWGnc7wg ($25 in chips) 
Seat 5: cWc85bEzdRzpUMhRKm8pwQ ($53.05 in chips) 
Seat 6: bb63I02U6p9a5MNFa1gCiw ($22.95 in chips) 
AnnaskyII was removed from the table for failing to post
/gJNBeCkWL4o85/jvlZ4BA: posts small blind $0.10
3zD3qLXT1bEffAoWGnc7wg: posts big blind $0.25
PToTQrV0TmESDzjJftg6QQ: sits out 
*** HOLE CARDS ***
cWc85bEzdRzpUMhRKm8pwQ: folds 
bb63I02U6p9a5MNFa1gCiw: raises $0.25 to $0.50
/gJNBeCkWL4o85/jvlZ4BA: folds 
3zD3qLXT1bEffAoWGnc7wg: calls $0.25
*** FLOP *** [Ah 2h 5s]
3zD3qLXT1bEffAoWGnc7wg: bets $0.75
bb63I02U6p9a5MNFa1gCiw: raises $0.75 to $1.50
3zD3qLXT1bEffAoWGnc7wg: calls $0.75
*** TURN *** [Ah 2h 5s] [Tc]
3zD3qLXT1bEffAoWGnc7wg: checks 
bb63I02U6p9a5MNFa1gCiw: bets $1.25
3zD3qLXT1bEffAoWGnc7wg: calls $1.25
*** RIVER *** [Ah 2h 5s Tc] [3h]
3zD3qLXT1bEffAoWGnc7wg: checks 
bb63I02U6p9a5MNFa1gCiw: bets $1.25
3zD3qLXT1bEffAoWGnc7wg: calls $1.25
*** SHOW DOWN ***
bb63I02U6p9a5MNFa1gCiw: shows [Jh Ac] (a pair of Aces)
3zD3qLXT1bEffAoWGnc7wg: shows [Qs Ad] (a pair of Aces - Queen kicker)
3zD3qLXT1bEffAoWGnc7wg collected $8.70 from pot
*** SUMMARY ***
Total pot $9.10 | Rake $0.40 
Board [Ah 2h 5s Tc 3h]
Seat 2: /gJNBeCkWL4o85/jvlZ4BA (small blind) folded before Flop
Seat 3: 3zD3qLXT1bEffAoWGnc7wg (big blind) showed [Qs Ad] and won ($8.70) with a pair of Aces
Seat 5: cWc85bEzdRzpUMhRKm8pwQ folded before Flop (didn't bet)
Seat 6: bb63I02U6p9a5MNFa1gCiw (button) showed [Jh Ac] and lost with a pair of Aces




PokerStars Game #59941955620:  Hold'em No Limit ($0.10/$0.25) - 2009/07/01 1:51:30 ET
Table 'AHkg4ChqzcMauBx6Qvz8Nw' 6-max Seat #2 is the button
Seat 2: Vi0JMrTI2BGrPL7UIulJtA ($3.75 in chips) 
Seat 3: 9dToMv2GJLfi00HcpfMnIw ($30.45 in chips) 
Seat 4: Eznneya0vB6S+eXJdVleHA ($21.90 in chips) 
Seat 5: Bada343Si4xKu3fNXY99AA ($3.45 in chips) 
9dToMv2GJLfi00HcpfMnIw: posts small blind $0.10
Eznneya0vB6S+eXJdVleHA: posts big blind $0.25
+RDf7SmUjY2kK0PzdBEYqg: sits out 
*** HOLE CARDS ***
Bada343Si4xKu3fNXY99AA: raises $0.50 to $0.75
Vi0JMrTI2BGrPL7UIulJtA: folds 
9dToMv2GJLfi00HcpfMnIw: folds 
Eznneya0vB6S+eXJdVleHA: folds 
Uncalled bet ($0.50) returned to Bada343Si4xKu3fNXY99AA
Bada343Si4xKu3fNXY99AA collected $0.60 from pot
*** SUMMARY ***
Total pot $0.60 | Rake $0 
Seat 2: Vi0JMrTI2BGrPL7UIulJtA (button) folded before Flop (didn't bet)
Seat 3: 9dToMv2GJLfi00HcpfMnIw (small blind) folded before Flop
Seat 4: Eznneya0vB6S+eXJdVleHA (big blind) folded before Flop
Seat 5: Bada343Si4xKu3fNXY99AA collected ($0.60)




PokerStars Game #59941955592:  Hold'em No Limit ($0.10/$0.25) - 2009/07/01 1:51:30 ET
Table 'by7aHYEDnDd144EXOXa/jA' 9-max Seat #8 is the button
Seat 1: j4q3p0lesp63b1gZDwLBZw ($7.65 in chips) 
Seat 2: vSkQm2EelzwRGDDQQk0Fqw ($8.90 in chips) 
Seat 3: HOEaXncFu2ij+D5/CANAZA ($12.85 in chips) 
Seat 4: 2Xwi447v1rBHM+92U0CduA ($4.40 in chips) 
Seat 5: yyG4svzOpC1A+sUP/scg6w ($3.85 in chips) 
Seat 6: sC4BsflLWW26Qm9m+1AwJQ ($9.65 in chips) 
Seat 7: Z9W7+g1WMhhZDi7DwGbCFA ($5.35 in chips) 
Seat 8: 7je+LC5Mfs6nL8YBVh4frQ ($3.35 in chips) 
Seat 9: K0b5wNInj6hUGRr6yzKFtw ($25 in chips) 
K0b5wNInj6hUGRr6yzKFtw: posts small blind $0.10
j4q3p0lesp63b1gZDwLBZw: posts big blind $0.25
*** HOLE CARDS ***
vSkQm2EelzwRGDDQQk0Fqw: folds 
HOEaXncFu2ij+D5/CANAZA: calls $0.25
2Xwi447v1rBHM+92U0CduA: calls $0.25
yyG4svzOpC1A+sUP/scg6w: folds 
sC4BsflLWW26Qm9m+1AwJQ: folds 
Z9W7+g1WMhhZDi7DwGbCFA: folds 
7je+LC5Mfs6nL8YBVh4frQ: folds 
K0b5wNInj6hUGRr6yzKFtw: folds 
j4q3p0lesp63b1gZDwLBZw: checks 
*** FLOP *** [2d Qc 7s]
j4q3p0lesp63b1gZDwLBZw: checks 
HOEaXncFu2ij+D5/CANAZA: bets $0.25
2Xwi447v1rBHM+92U0CduA: folds 
j4q3p0lesp63b1gZDwLBZw: folds 
Uncalled bet ($0.25) returned to HOEaXncFu2ij+D5/CANAZA
HOEaXncFu2ij+D5/CANAZA collected $0.85 from pot
HOEaXncFu2ij+D5/CANAZA: doesn't show hand 
*** SUMMARY ***
Total pot $0.85 | Rake $0 
Board [2d Qc 7s]
Seat 1: j4q3p0lesp63b1gZDwLBZw (big blind) folded on the Flop
Seat 2: vSkQm2EelzwRGDDQQk0Fqw folded before Flop (didn't bet)
Seat 3: HOEaXncFu2ij+D5/CANAZA collected ($0.85)
Seat 4: 2Xwi447v1rBHM+92U0CduA folded on the Flop
Seat 5: yyG4svzOpC1A+sUP/scg6w folded before Flop (didn't bet)
Seat 6: sC4BsflLWW26Qm9m+1AwJQ folded before Flop (didn't bet)
Seat 7: Z9W7+g1WMhhZDi7DwGbCFA folded before Flop (didn't bet)
Seat 8: 7je+LC5Mfs6nL8YBVh4frQ (button) folded before Flop (didn't bet)
Seat 9: K0b5wNInj6hUGRr6yzKFtw (small blind) folded before Flop




PokerStars Game #59941955700:  Hold'em No Limit ($0.10/$0.25) - 2009/07/01 1:51:30 ET
Table 'U0hCzoS0KCJL+eoE054K4Q' 9-max Seat #7 is the button
Seat 1: XVEauYThJRhSTUAMxB/2ow ($37.55 in chips) 
Seat 2: MG90wfSJZnOejs/KD3vlQQ ($29.20 in chips) 
Seat 3: 8Cp1H3sSs8+jTTwLfeYKcw ($25.55 in chips) 
Seat 4: Bb42QRQMhg5/Y0vHP8/2Xw ($25 in chips) 
Seat 5: zgi+EUykT/pZQpoUG6+oEg ($5.65 in chips) 
Seat 6: V6p0jQ/RhUsqpHLmXvEX4Q ($11.55 in chips) 
Seat 7: uetHVityNsFnyX2bBnKe2A ($18 in chips) 
Seat 8: K0b5wNInj6hUGRr6yzKFtw ($27.20 in chips) 
Seat 9: wGigCmBR/9XWkPpvYos3aQ ($34.25 in chips) 
K0b5wNInj6hUGRr6yzKFtw: posts small blind $0.10
wGigCmBR/9XWkPpvYos3aQ: posts big blind $0.25
*** HOLE CARDS ***
XVEauYThJRhSTUAMxB/2ow: raises $0.50 to $0.75
MG90wfSJZnOejs/KD3vlQQ: folds 
8Cp1H3sSs8+jTTwLfeYKcw: folds 
Bb42QRQMhg5/Y0vHP8/2Xw: folds 
zgi+EUykT/pZQpoUG6+oEg: folds 
V6p0jQ/RhUsqpHLmXvEX4Q: folds 
uetHVityNsFnyX2bBnKe2A: folds 
K0b5wNInj6hUGRr6yzKFtw: folds 
wGigCmBR/9XWkPpvYos3aQ: folds 
Uncalled bet ($0.50) returned to XVEauYThJRhSTUAMxB/2ow
XVEauYThJRhSTUAMxB/2ow collected $0.60 from pot
XVEauYThJRhSTUAMxB/2ow: doesn't show hand 
*** SUMMARY ***
Total pot $0.60 | Rake $0 
Seat 1: XVEauYThJRhSTUAMxB/2ow collected ($0.60)
Seat 2: MG90wfSJZnOejs/KD3vlQQ folded before Flop (didn't bet)
Seat 3: 8Cp1H3sSs8+jTTwLfeYKcw folded before Flop (didn't bet)
Seat 4: Bb42QRQMhg5/Y0vHP8/2Xw folded before Flop (didn't bet)
Seat 5: zgi+EUykT/pZQpoUG6+oEg folded before Flop (didn't bet)
Seat 6: V6p0jQ/RhUsqpHLmXvEX4Q folded before Flop (didn't bet)
Seat 7: uetHVityNsFnyX2bBnKe2A (button) folded before Flop (didn't bet)
Seat 8: K0b5wNInj6hUGRr6yzKFtw (small blind) folded before Flop
Seat 9: wGigCmBR/9XWkPpvYos3aQ (big blind) folded before Flop




PokerStars Game #59941955738:  Hold'em No Limit ($0.10/$0.25) - 2009/07/01 1:51:30 ET
Table 'wRXcD9iXgBbdvKhWmfnBnw' 6-max Seat #5 is the button
Seat 1: Mhj3q7cxev+XjXZxEE6/Cw ($25 in chips) 
Seat 2: vUr8qM1UsCElsCI9B/McdQ ($21.30 in chips) 
Seat 3: SxIIgwXYLkwd6m3wLyPTCw ($26.15 in chips) 
Seat 4: mnuJq+Q1IXKm/pCy+OzxmQ ($19.25 in chips) 
Seat 5: EE16Ua5b1HSsYej5zeXOlA ($48.70 in chips) 
Seat 6: JFIAqU8lCZ0vWwEl4bdGsg ($33.75 in chips) 
JFIAqU8lCZ0vWwEl4bdGsg: posts small blind $0.10
Mhj3q7cxev+XjXZxEE6/Cw: posts big blind $0.25
*** HOLE CARDS ***
vUr8qM1UsCElsCI9B/McdQ: folds 
SxIIgwXYLkwd6m3wLyPTCw: folds 
mnuJq+Q1IXKm/pCy+OzxmQ: folds 
EE16Ua5b1HSsYej5zeXOlA: raises $0.50 to $0.75
JFIAqU8lCZ0vWwEl4bdGsg: folds 
Mhj3q7cxev+XjXZxEE6/Cw: raises $1.75 to $2.50
EE16Ua5b1HSsYej5zeXOlA: calls $1.75
*** FLOP *** [9d Jc 7s]
Mhj3q7cxev+XjXZxEE6/Cw: checks 
EE16Ua5b1HSsYej5zeXOlA: checks 
*** TURN *** [9d Jc 7s] [4d]
Mhj3q7cxev+XjXZxEE6/Cw: checks 
EE16Ua5b1HSsYej5zeXOlA: bets $3
Mhj3q7cxev+XjXZxEE6/Cw: folds 
Uncalled bet ($3) returned to EE16Ua5b1HSsYej5zeXOlA
EE16Ua5b1HSsYej5zeXOlA collected $4.85 from pot
EE16Ua5b1HSsYej5zeXOlA: doesn't show hand 
*** SUMMARY ***
Total pot $5.10 | Rake $0.25 
Board [9d Jc 7s 4d]
Seat 1: Mhj3q7cxev+XjXZxEE6/Cw (big blind) folded on the Turn
Seat 2: vUr8qM1UsCElsCI9B/McdQ folded before Flop (didn't bet)
Seat 3: SxIIgwXYLkwd6m3wLyPTCw folded before Flop (didn't bet)
Seat 4: mnuJq+Q1IXKm/pCy+OzxmQ folded before Flop (didn't bet)
Seat 5: EE16Ua5b1HSsYej5zeXOlA (button) collected ($4.85)
Seat 6: JFIAqU8lCZ0vWwEl4bdGsg (small blind) folded before Flop




PokerStars Game #59941956266:  Hold'em No Limit ($0.10/$0.25) - 2009/07/01 1:51:31 ET
Table 'fHv1Mk7ZbLjprZTGWKPiEQ' 6-max Seat #2 is the button
Seat 1: OIjOiBfQstWrK/RuXx7zcw ($4.25 in chips) 
Seat 2: 9U3ZKjCsarN0DjR6mSE8Ug ($13.45 in chips) 
Seat 3: /gJNBeCkWL4o85/jvlZ4BA ($25.10 in chips) 
Seat 4: TSmua8tGK3sTbwi0ynrW9Q ($60 in chips) 
Seat 5: LJI7A1YgDM7hgh7o56+ReQ ($25.95 in chips) 
Seat 6: AjG0X+rNtc2W08eph8oqpw ($52.40 in chips) 
/gJNBeCkWL4o85/jvlZ4BA: posts small blind $0.10
TSmua8tGK3sTbwi0ynrW9Q: posts big blind $0.25
*** HOLE CARDS ***
LJI7A1YgDM7hgh7o56+ReQ: raises $0.75 to $1
AjG0X+rNtc2W08eph8oqpw: folds 
OIjOiBfQstWrK/RuXx7zcw: folds 
9U3ZKjCsarN0DjR6mSE8Ug: folds 
/gJNBeCkWL4o85/jvlZ4BA: folds 
TSmua8tGK3sTbwi0ynrW9Q: folds 
Uncalled bet ($0.75) returned to LJI7A1YgDM7hgh7o56+ReQ
LJI7A1YgDM7hgh7o56+ReQ collected $0.60 from pot
LJI7A1YgDM7hgh7o56+ReQ: doesn't show hand 
*** SUMMARY ***
Total pot $0.60 | Rake $0 
Seat 1: OIjOiBfQstWrK/RuXx7zcw folded before Flop (didn't bet)
Seat 2: 9U3ZKjCsarN0DjR6mSE8Ug (button) folded before Flop (didn't bet)
Seat 3: /gJNBeCkWL4o85/jvlZ4BA (small blind) folded before Flop
Seat 4: TSmua8tGK3sTbwi0ynrW9Q (big blind) folded before Flop
Seat 5: LJI7A1YgDM7hgh7o56+ReQ collected ($0.60)
Seat 6: AjG0X+rNtc2W08eph8oqpw folded before Flop (didn't bet)




PokerStars Game #59941956442:  Hold'em No Limit ($0.10/$0.25) - 2009/07/01 1:51:31 ET
Table '9L7XfAwuM7XsXE8LIg2o5Q' 6-max Seat #4 is the button
Seat 1: dOIoLBxmpLHSXBN9LZnf0Q ($29 in chips) 
Seat 2: LJI7A1YgDM7hgh7o56+ReQ ($27.30 in chips) 
Seat 3: f1OIgv29LuXUMe6o34kTQg ($15.90 in chips) 
Seat 4: jp34e617tIzV8tKIWmfAbA ($38.45 in chips) 
Seat 5: ErIN0JRL5srYjT6en1f8YQ ($23.25 in chips) 
Seat 6: k9nHZTHt8hYhYRcW8NTb4g ($18.85 in chips) 
ErIN0JRL5srYjT6en1f8YQ: posts small blind $0.10
k9nHZTHt8hYhYRcW8NTb4g: posts big blind $0.25
f1OIgv29LuXUMe6o34kTQg: posts big blind $0.25
*** HOLE CARDS ***
dOIoLBxmpLHSXBN9LZnf0Q: folds 
LJI7A1YgDM7hgh7o56+ReQ: folds 
f1OIgv29LuXUMe6o34kTQg: checks 
jp34e617tIzV8tKIWmfAbA: folds 
ErIN0JRL5srYjT6en1f8YQ: folds 
k9nHZTHt8hYhYRcW8NTb4g: checks 
*** FLOP *** [4c 5s 4d]
k9nHZTHt8hYhYRcW8NTb4g: checks 
f1OIgv29LuXUMe6o34kTQg: bets $0.50
k9nHZTHt8hYhYRcW8NTb4g: folds 
Uncalled bet ($0.50) returned to f1OIgv29LuXUMe6o34kTQg
f1OIgv29LuXUMe6o34kTQg collected $0.60 from pot
f1OIgv29LuXUMe6o34kTQg: doesn't show hand 
*** SUMMARY ***
Total pot $0.60 | Rake $0 
Board [4c 5s 4d]
Seat 1: dOIoLBxmpLHSXBN9LZnf0Q folded before Flop (didn't bet)
Seat 2: LJI7A1YgDM7hgh7o56+ReQ folded before Flop (didn't bet)
Seat 3: f1OIgv29LuXUMe6o34kTQg collected ($0.60)
Seat 4: jp34e617tIzV8tKIWmfAbA (button) folded before Flop (didn't bet)
Seat 5: ErIN0JRL5srYjT6en1f8YQ (small blind) folded before Flop
Seat 6: k9nHZTHt8hYhYRcW8NTb4g (big blind) folded on the Flop




PokerStars Game #59941956002:  Hold'em No Limit ($0.10/$0.25) - 2009/07/01 1:51:31 ET
Table 'ER5H84HUgJx7HyDLnELLeA' 6-max Seat #5 is the button
Seat 1: LJI7A1YgDM7hgh7o56+ReQ ($26.25 in chips) 
Seat 2: buyjetgNT1McXtdaP4zynA ($21.40 in chips) 
Seat 3: cS21pIxRHx5Gt42o7hPZzw ($13 in chips) 
Seat 4: vqWjZmdQu/Hxw96/IJTWdQ ($25 in chips) 
Seat 5: mfrkWA3PTeYPkbO6hi98Aw ($26.20 in chips) 
Seat 6: 3zD3qLXT1bEffAoWGnc7wg ($51.10 in chips) 
3zD3qLXT1bEffAoWGnc7wg: posts small blind $0.10
LJI7A1YgDM7hgh7o56+ReQ: posts big blind $0.25
*** HOLE CARDS ***
buyjetgNT1McXtdaP4zynA: folds 
cS21pIxRHx5Gt42o7hPZzw: folds 
vqWjZmdQu/Hxw96/IJTWdQ: raises $0.50 to $0.75
mfrkWA3PTeYPkbO6hi98Aw: folds 
3zD3qLXT1bEffAoWGnc7wg: calls $0.65
LJI7A1YgDM7hgh7o56+ReQ: folds 
*** FLOP *** [Ah 6s 8h]
3zD3qLXT1bEffAoWGnc7wg: checks 
vqWjZmdQu/Hxw96/IJTWdQ: checks 
*** TURN *** [Ah 6s 8h] [Jh]
buyjetgNT1McXtdaP4zynA leaves the table
3zD3qLXT1bEffAoWGnc7wg: checks 
vqWjZmdQu/Hxw96/IJTWdQ: checks 
*** RIVER *** [Ah 6s 8h Jh] [Th]
3zD3qLXT1bEffAoWGnc7wg: checks 
vqWjZmdQu/Hxw96/IJTWdQ: checks 
*** SHOW DOWN ***
3zD3qLXT1bEffAoWGnc7wg: shows [8s 9s] (a pair of Eights)
vqWjZmdQu/Hxw96/IJTWdQ: mucks hand 
3zD3qLXT1bEffAoWGnc7wg collected $1.70 from pot
*** SUMMARY ***
Total pot $1.75 | Rake $0.05 
Board [Ah 6s 8h Jh Th]
Seat 1: LJI7A1YgDM7hgh7o56+ReQ (big blind) folded before Flop
Seat 2: buyjetgNT1McXtdaP4zynA folded before Flop (didn't bet)
Seat 3: cS21pIxRHx5Gt42o7hPZzw folded before Flop (didn't bet)
Seat 4: vqWjZmdQu/Hxw96/IJTWdQ mucked
Seat 5: mfrkWA3PTeYPkbO6hi98Aw (button) folded before Flop (didn't bet)
Seat 6: 3zD3qLXT1bEffAoWGnc7wg (small blind) showed [8s 9s] and won ($1.70) with a pair of Eights




PokerStars Game #59941956096:  Hold'em No Limit ($0.10/$0.25) - 2009/07/01 1:51:31 ET
Table '3Ns9nuTkynfwbBfBXzg6ww' 6-max Seat #5 is the button
Seat 1: epAUIB7h2FJXzUPRIvSkRA ($25 in chips) 
Seat 2: zxeVQGaMKDsDzmSY+AInjA ($34 in chips) 
Seat 3: eL3+wCBjFGfQ5FMdIZihwA ($23.60 in chips) 
Seat 4: qGHGf/553gQnDoklMRe3tg ($31.50 in chips) 
Seat 5: wqphQtauX5Qn7WRJZS1flA ($23.70 in chips) 
Seat 6: DE9hRlt14g+JdsRQ4wT7hg ($38.10 in chips) 
DE9hRlt14g+JdsRQ4wT7hg: posts small blind $0.10
epAUIB7h2FJXzUPRIvSkRA: posts big blind $0.25
*** HOLE CARDS ***
zxeVQGaMKDsDzmSY+AInjA: folds 
eL3+wCBjFGfQ5FMdIZihwA: folds 
qGHGf/553gQnDoklMRe3tg: folds 
wqphQtauX5Qn7WRJZS1flA: raises $0.50 to $0.75
DE9hRlt14g+JdsRQ4wT7hg: folds 
epAUIB7h2FJXzUPRIvSkRA: folds 
Uncalled bet ($0.50) returned to wqphQtauX5Qn7WRJZS1flA
wqphQtauX5Qn7WRJZS1flA collected $0.60 from pot
wqphQtauX5Qn7WRJZS1flA: doesn't show hand 
*** SUMMARY ***
Total pot $0.60 | Rake $0 
Seat 1: epAUIB7h2FJXzUPRIvSkRA (big blind) folded before Flop
Seat 2: zxeVQGaMKDsDzmSY+AInjA folded before Flop (didn't bet)
Seat 3: eL3+wCBjFGfQ5FMdIZihwA folded before Flop (didn't bet)
Seat 4: qGHGf/553gQnDoklMRe3tg folded before Flop (didn't bet)
Seat 5: wqphQtauX5Qn7WRJZS1flA (button) collected ($0.60)
Seat 6: DE9hRlt14g+JdsRQ4wT7hg (small blind) folded before Flop




PokerStars Game #59941956552:  Hold'em No Limit ($0.10/$0.25) - 2009/07/01 1:51:31 ET
Table 'NfXsh0UQA+o/kO9acV3WxA' 9-max Seat #4 is the button
Seat 1: pN3IHvAKm2fz+sTRARTcrg ($25 in chips) 
Seat 2: mhpFs2SZupy4zLRb62FLFA ($24.65 in chips) 
Seat 3: wCUaomJ6Nq5zomVGdUHP+w ($20.25 in chips) 
Seat 4: r6hsffOo1iKmaPYKwAZmFw ($30.05 in chips) 
Seat 5: zgi+EUykT/pZQpoUG6+oEg ($4.40 in chips) 
Seat 6: qwr38jl5txoR36M7G5qi4A ($10 in chips) 
Seat 7: yqkowiRWZ6NvRN9UUkYIlA ($5 in chips) 
Seat 8: +sbyWwIcFp9kP0bDtMegfQ ($40.60 in chips) 
Seat 9: uhrboV251dcgYniYTdFIcA ($28.85 in chips) 
zgi+EUykT/pZQpoUG6+oEg: posts small blind $0.10
qwr38jl5txoR36M7G5qi4A: posts big blind $0.25
*** HOLE CARDS ***
yqkowiRWZ6NvRN9UUkYIlA: folds 
+sbyWwIcFp9kP0bDtMegfQ: folds 
uhrboV251dcgYniYTdFIcA: calls $0.25
pN3IHvAKm2fz+sTRARTcrg: folds 
mhpFs2SZupy4zLRb62FLFA: folds 
wCUaomJ6Nq5zomVGdUHP+w: calls $0.25
r6hsffOo1iKmaPYKwAZmFw: folds 
zgi+EUykT/pZQpoUG6+oEg: folds 
qwr38jl5txoR36M7G5qi4A: checks 
*** FLOP *** [Ah Ac Td]
qwr38jl5txoR36M7G5qi4A: checks 
uhrboV251dcgYniYTdFIcA: checks 
wCUaomJ6Nq5zomVGdUHP+w: checks 
*** TURN *** [Ah Ac Td] [Jd]
qwr38jl5txoR36M7G5qi4A: checks 
uhrboV251dcgYniYTdFIcA: checks 
wCUaomJ6Nq5zomVGdUHP+w: checks 
*** RIVER *** [Ah Ac Td Jd] [Js]
qwr38jl5txoR36M7G5qi4A: checks 
uhrboV251dcgYniYTdFIcA: bets $1.25
wCUaomJ6Nq5zomVGdUHP+w: folds 
qwr38jl5txoR36M7G5qi4A: folds 
Uncalled bet ($1.25) returned to uhrboV251dcgYniYTdFIcA
uhrboV251dcgYniYTdFIcA collected $0.85 from pot
uhrboV251dcgYniYTdFIcA: doesn't show hand 
*** SUMMARY ***
Total pot $0.85 | Rake $0 
Board [Ah Ac Td Jd Js]
Seat 1: pN3IHvAKm2fz+sTRARTcrg folded before Flop (didn't bet)
Seat 2: mhpFs2SZupy4zLRb62FLFA folded before Flop (didn't bet)
Seat 3: wCUaomJ6Nq5zomVGdUHP+w folded on the River
Seat 4: r6hsffOo1iKmaPYKwAZmFw (button) folded before Flop (didn't bet)
Seat 5: zgi+EUykT/pZQpoUG6+oEg (small blind) folded before Flop
Seat 6: qwr38jl5txoR36M7G5qi4A (big blind) folded on the River
Seat 7: yqkowiRWZ6NvRN9UUkYIlA folded before Flop (didn't bet)
Seat 8: +sbyWwIcFp9kP0bDtMegfQ folded before Flop (didn't bet)
Seat 9: uhrboV251dcgYniYTdFIcA collected ($0.85)




PokerStars Game #59941956298:  Hold'em No Limit ($0.10/$0.25) - 2009/07/01 1:51:31 ET
Table 'KAnP7XvDtlku47YfJwdOVw' 9-max Seat #5 is the button
Seat 1: cH3q40adP+kFogl+2MtbkQ ($15 in chips) 
Seat 2: E0iYnEVO2ho7dH3QcCjw7g ($19.35 in chips) 
Seat 3: W6tExOcYX7qiy6Qdp+ZwFA ($7.60 in chips) 
Seat 4: 18G4P1XstjNvItdGUITxgw ($25 in chips) 
Seat 5: MG90wfSJZnOejs/KD3vlQQ ($33.65 in chips) 
Seat 6: z5GxcHlYz/GSz6W2uFiTtg ($21.40 in chips) 
Seat 7: Lro4e37x4FUa5P3yzDjskw ($9.15 in chips) 
Seat 8: OneeONzF0MoH0pEdcBndwA ($22.45 in chips) 
Seat 9: HDDm1BkZtdsRyw2DJdqq6A ($21.30 in chips) 
z5GxcHlYz/GSz6W2uFiTtg: posts small blind $0.10
Lro4e37x4FUa5P3yzDjskw: posts big blind $0.25
*** HOLE CARDS ***
OneeONzF0MoH0pEdcBndwA: folds 
HDDm1BkZtdsRyw2DJdqq6A: calls $0.25
cH3q40adP+kFogl+2MtbkQ has timed out
cH3q40adP+kFogl+2MtbkQ: folds 
cH3q40adP+kFogl+2MtbkQ is sitting out
E0iYnEVO2ho7dH3QcCjw7g: folds 
W6tExOcYX7qiy6Qdp+ZwFA: folds 
cH3q40adP+kFogl+2MtbkQ has returned
18G4P1XstjNvItdGUITxgw: folds 
OneeONzF0MoH0pEdcBndwA leaves the table
MG90wfSJZnOejs/KD3vlQQ: calls $0.25
z5GxcHlYz/GSz6W2uFiTtg: calls $0.15
Lro4e37x4FUa5P3yzDjskw: checks 
*** FLOP *** [Qd Ks 2s]
z5GxcHlYz/GSz6W2uFiTtg: checks 
Lro4e37x4FUa5P3yzDjskw: bets $0.50
HDDm1BkZtdsRyw2DJdqq6A: calls $0.50
MG90wfSJZnOejs/KD3vlQQ: folds 
z5GxcHlYz/GSz6W2uFiTtg: folds 
*** TURN *** [Qd Ks 2s] [2d]
Lro4e37x4FUa5P3yzDjskw: bets $0.50
HDDm1BkZtdsRyw2DJdqq6A: raises $0.75 to $1.25
Lro4e37x4FUa5P3yzDjskw: raises $0.75 to $2
HDDm1BkZtdsRyw2DJdqq6A: calls $0.75
*** RIVER *** [Qd Ks 2s 2d] [Qc]
Lro4e37x4FUa5P3yzDjskw: bets $4.75
HDDm1BkZtdsRyw2DJdqq6A: calls $4.75
*** SHOW DOWN ***
Lro4e37x4FUa5P3yzDjskw: shows [Jd 2h] (a full house, Deuces full of Queens)
HDDm1BkZtdsRyw2DJdqq6A: mucks hand 
Lro4e37x4FUa5P3yzDjskw collected $14.75 from pot
*** SUMMARY ***
Total pot $15.50 | Rake $0.75 
Board [Qd Ks 2s 2d Qc]
Seat 1: cH3q40adP+kFogl+2MtbkQ folded before Flop (didn't bet)
Seat 2: E0iYnEVO2ho7dH3QcCjw7g folded before Flop (didn't bet)
Seat 3: W6tExOcYX7qiy6Qdp+ZwFA folded before Flop (didn't bet)
Seat 4: 18G4P1XstjNvItdGUITxgw folded before Flop (didn't bet)
Seat 5: MG90wfSJZnOejs/KD3vlQQ (button) folded on the Flop
Seat 6: z5GxcHlYz/GSz6W2uFiTtg (small blind) folded on the Flop
Seat 7: Lro4e37x4FUa5P3yzDjskw (big blind) showed [Jd 2h] and won ($14.75) with a full house, Deuces full of Queens
Seat 8: OneeONzF0MoH0pEdcBndwA folded before Flop (didn't bet)
Seat 9: HDDm1BkZtdsRyw2DJdqq6A mucked




PokerStars Game #59941956004:  Hold'em No Limit ($0.10/$0.25) - 2009/07/01 1:51:31 ET
Table 'QvLFJzpzymuOsaaRYi+8fgWEMI3Mtn7dGARDbgNrKibgx Seat #8 is the button
Seat 1: cZ99hugmLBj9KhTlc8nCSw ($27.05 in chips) 
Seat 2: PdIasPkzm2sqZnN41ZRXOg ($5 in chips) 
Seat 3: Qduu7ikeizo6q6Ei9YvcJA ($25 in chips) 
Seat 4: tLcDklc2rBORNfixyRfVfw ($25.25 in chips) 
Seat 5: MG90wfSJZnOejs/KD3vlQQ ($37.45 in chips) 
Seat 6: vKdukiQ4ktU4yJ0Xx3MKnA ($7.10 in chips) 
Seat 7: rQhYIYXSyH/IivYM1dlV5A ($10.85 in chips) 
Seat 8: gehe91e0IyVT0QU/XBkEyg ($27 in chips) 
Seat 9: BWzInv8o0kN1pJybv/VjpQ ($44.55 in chips) 
BWzInv8o0kN1pJybv/VjpQ: posts small blind $0.10
cZ99hugmLBj9KhTlc8nCSw: posts big blind $0.25
*** HOLE CARDS ***
PdIasPkzm2sqZnN41ZRXOg: folds 
Qduu7ikeizo6q6Ei9YvcJA: folds 
tLcDklc2rBORNfixyRfVfw: folds 
MG90wfSJZnOejs/KD3vlQQ: folds 
vKdukiQ4ktU4yJ0Xx3MKnA: folds 
rQhYIYXSyH/IivYM1dlV5A: raises $0.50 to $0.75
gehe91e0IyVT0QU/XBkEyg: folds 
BWzInv8o0kN1pJybv/VjpQ: calls $0.65
cZ99hugmLBj9KhTlc8nCSw: folds 
*** FLOP *** [Jc Ah 3s]
BWzInv8o0kN1pJybv/VjpQ: checks 
rQhYIYXSyH/IivYM1dlV5A: bets $0.75
BWzInv8o0kN1pJybv/VjpQ: folds 
Uncalled bet ($0.75) returned to rQhYIYXSyH/IivYM1dlV5A
rQhYIYXSyH/IivYM1dlV5A collected $1.70 from pot
*** SUMMARY ***
Total pot $1.75 | Rake $0.05 
Board [Jc Ah 3s]
Seat 1: cZ99hugmLBj9KhTlc8nCSw (big blind) folded before Flop
Seat 2: PdIasPkzm2sqZnN41ZRXOg folded before Flop (didn't bet)
Seat 3: Qduu7ikeizo6q6Ei9YvcJA folded before Flop (didn't bet)
Seat 4: tLcDklc2rBORNfixyRfVfw folded before Flop (didn't bet)
Seat 5: MG90wfSJZnOejs/KD3vlQQ folded before Flop (didn't bet)
Seat 6: vKdukiQ4ktU4yJ0Xx3MKnA folded before Flop (didn't bet)
Seat 7: rQhYIYXSyH/IivYM1dlV5A collected ($1.70)
Seat 8: gehe91e0IyVT0QU/XBkEyg (button) folded before Flop (didn't bet)
Seat 9: BWzInv8o0kN1pJybv/VjpQ (small blind) folded on the Flop




PokerStars Game #59941956300:  Hold'em No Limit ($0.10/$0.25) - 2009/07/01 1:51:31 ET
Table 'sSe6q4YTb/iS19t2eCFdsA' 9-max Seat #3 is the button
Seat 1: hJ4uYjNmSZdjrKA8cjZqCA ($18.40 in chips) 
Seat 2: 3l+i+xMeyDndSXMF2A5CDA ($5.40 in chips) 
Seat 3: OXPkK84/qv92EMwXPiG5rQ ($10 in chips) 
Seat 4: 22dIObOuor/A+IKWkNoAlA ($8.85 in chips) 
Seat 5: qS+jfnNoG75bT+uQ8CKhQA ($10.30 in chips) 
Seat 6: tYsOBqdU1+x+yFI7zHO7hQ ($27 in chips) 
Seat 7: t70KGeRtR3naHSqKDixsUg ($4.25 in chips) 
Seat 8: hvXZ0zFPZFP8Hf6dS36YEw ($16 in chips) 
Seat 9: Z9W7+g1WMhhZDi7DwGbCFA ($5.25 in chips) 
22dIObOuor/A+IKWkNoAlA: posts small blind $0.10
qS+jfnNoG75bT+uQ8CKhQA: posts big blind $0.25
*** HOLE CARDS ***
tYsOBqdU1+x+yFI7zHO7hQ: folds 
t70KGeRtR3naHSqKDixsUg: calls $0.25
hvXZ0zFPZFP8Hf6dS36YEw: folds 
Z9W7+g1WMhhZDi7DwGbCFA: folds 
hJ4uYjNmSZdjrKA8cjZqCA: calls $0.25
3l+i+xMeyDndSXMF2A5CDA: folds 
OXPkK84/qv92EMwXPiG5rQ: folds 
22dIObOuor/A+IKWkNoAlA: folds 
qS+jfnNoG75bT+uQ8CKhQA: checks 
*** FLOP *** [Js 3c 2c]
qS+jfnNoG75bT+uQ8CKhQA: checks 
t70KGeRtR3naHSqKDixsUg: bets $0.25
hJ4uYjNmSZdjrKA8cjZqCA: calls $0.25
qS+jfnNoG75bT+uQ8CKhQA: folds 
*** TURN *** [Js 3c 2c] [Qh]
t70KGeRtR3naHSqKDixsUg: bets $0.25
hJ4uYjNmSZdjrKA8cjZqCA: calls $0.25
*** RIVER *** [Js 3c 2c Qh] [5d]
t70KGeRtR3naHSqKDixsUg: bets $0.25
hJ4uYjNmSZdjrKA8cjZqCA: raises $1.75 to $2
t70KGeRtR3naHSqKDixsUg: calls $1.75
*** SHOW DOWN ***
hJ4uYjNmSZdjrKA8cjZqCA: shows [4h 4s] (a pair of Fours)
t70KGeRtR3naHSqKDixsUg: shows [Jh Ad] (a pair of Jacks)
t70KGeRtR3naHSqKDixsUg collected $5.60 from pot
*** SUMMARY ***
Total pot $5.85 | Rake $0.25 
Board [Js 3c 2c Qh 5d]
Seat 1: hJ4uYjNmSZdjrKA8cjZqCA showed [4h 4s] and lost with a pair of Fours
Seat 2: 3l+i+xMeyDndSXMF2A5CDA folded before Flop (didn't bet)
Seat 3: OXPkK84/qv92EMwXPiG5rQ (button) folded before Flop (didn't bet)
Seat 4: 22dIObOuor/A+IKWkNoAlA (small blind) folded before Flop
Seat 5: qS+jfnNoG75bT+uQ8CKhQA (big blind) folded on the Flop
Seat 6: tYsOBqdU1+x+yFI7zHO7hQ folded before Flop (didn't bet)
Seat 7: t70KGeRtR3naHSqKDixsUg showed [Jh Ad] and won ($5.60) with a pair of Jacks
Seat 8: hvXZ0zFPZFP8Hf6dS36YEw folded before Flop (didn't bet)
Seat 9: Z9W7+g1WMhhZDi7DwGbCFA folded before Flop (didn't bet)




PokerStars Game #59941957104:  Hold'em No Limit ($0.10/$0.25) - 2009/07/01 1:51:32 ET
Table 'iMiAw/kTZXopgYX4HI7sHg' 9-max Seat #9 is the button
Seat 1: PdIasPkzm2sqZnN41ZRXOg ($4.75 in chips) 
Seat 2: qwr38jl5txoR36M7G5qi4A ($8.25 in chips) 
Seat 3: HPEB+AtKw1+C/cxU0o1ciw ($27.90 in chips) 
Seat 4: Z9W7+g1WMhhZDi7DwGbCFA ($7.15 in chips) 
Seat 5: 22dIObOuor/A+IKWkNoAlA ($5.45 in chips) 
Seat 6: Bb42QRQMhg5/Y0vHP8/2Xw ($28.80 in chips) 
Seat 7: ipLwYjdAXnvG54zETKPvbQ ($12.90 in chips) 
Seat 8: tLcDklc2rBORNfixyRfVfw ($29.90 in chips) 
Seat 9: fxHuzml2pBE+ABvr6emfng ($15.25 in chips) 
PdIasPkzm2sqZnN41ZRXOg: posts small blind $0.10
qwr38jl5txoR36M7G5qi4A: posts big blind $0.25
*** HOLE CARDS ***
HPEB+AtKw1+C/cxU0o1ciw: folds 
Z9W7+g1WMhhZDi7DwGbCFA: folds 
22dIObOuor/A+IKWkNoAlA: folds 
Bb42QRQMhg5/Y0vHP8/2Xw: folds 
ipLwYjdAXnvG54zETKPvbQ: folds 
tLcDklc2rBORNfixyRfVfw: raises $0.75 to $1
fxHuzml2pBE+ABvr6emfng: calls $1
PdIasPkzm2sqZnN41ZRXOg: folds 
qwr38jl5txoR36M7G5qi4A: folds 
*** FLOP *** [Tc Kd 4c]
tLcDklc2rBORNfixyRfVfw: checks 
fxHuzml2pBE+ABvr6emfng: bets $1.25
tLcDklc2rBORNfixyRfVfw: folds 
Uncalled bet ($1.25) returned to fxHuzml2pBE+ABvr6emfng
fxHuzml2pBE+ABvr6emfng collected $2.25 from pot
*** SUMMARY ***
Total pot $2.35 | Rake $0.10 
Board [Tc Kd 4c]
Seat 1: PdIasPkzm2sqZnN41ZRXOg (small blind) folded before Flop
Seat 2: qwr38jl5txoR36M7G5qi4A (big blind) folded before Flop
Seat 3: HPEB+AtKw1+C/cxU0o1ciw folded before Flop (didn't bet)
Seat 4: Z9W7+g1WMhhZDi7DwGbCFA folded before Flop (didn't bet)
Seat 5: 22dIObOuor/A+IKWkNoAlA folded before Flop (didn't bet)
Seat 6: Bb42QRQMhg5/Y0vHP8/2Xw folded before Flop (didn't bet)
Seat 7: ipLwYjdAXnvG54zETKPvbQ folded before Flop (didn't bet)
Seat 8: tLcDklc2rBORNfixyRfVfw folded on the Flop
Seat 9: fxHuzml2pBE+ABvr6emfng (button) collected ($2.25)




PokerStars Game #59941957058:  Hold'em No Limit ($0.10/$0.25) - 2009/07/01 1:51:32 ET
Table 'aisAlB9GIV21BwfUW3+Nbg' 9-max Seat #9 is the button
Seat 1: SqibpGx+lf+brY0fJVvD0w ($24.60 in chips) 
Seat 2: zgi+EUykT/pZQpoUG6+oEg ($5 in chips) 
Seat 3: CvL9Ch1HYCVbTsfpNucitg ($4.55 in chips) 
Seat 4: sD+TKtt36XiiN6jqHiLwDA ($26.50 in chips) 
Seat 5: ghNKXUBl/H+t83JF079ZBA ($27.40 in chips) 
Seat 6: 9gmYYQesalMrUjaF7nKfrQ ($15.85 in chips) 
Seat 8: VWUWpMLMj/Q1jRVpF7Aohw ($25.95 in chips) 
Seat 9: N0hGpTAEAj9k5msS6LPLAw ($20.60 in chips) 
SqibpGx+lf+brY0fJVvD0w: posts small blind $0.10
zgi+EUykT/pZQpoUG6+oEg: posts big blind $0.25
*** HOLE CARDS ***
CvL9Ch1HYCVbTsfpNucitg: folds 
sD+TKtt36XiiN6jqHiLwDA: folds 
ghNKXUBl/H+t83JF079ZBA: raises $0.75 to $1
9gmYYQesalMrUjaF7nKfrQ: folds 
VWUWpMLMj/Q1jRVpF7Aohw: folds 
N0hGpTAEAj9k5msS6LPLAw: folds 
QUyZmk8wzvBAtbHg9JXClw joins the table at seat #7 
SqibpGx+lf+brY0fJVvD0w: folds 
zgi+EUykT/pZQpoUG6+oEg: folds 
Uncalled bet ($0.75) returned to ghNKXUBl/H+t83JF079ZBA
ghNKXUBl/H+t83JF079ZBA collected $0.60 from pot
ghNKXUBl/H+t83JF079ZBA: doesn't show hand 
*** SUMMARY ***
Total pot $0.60 | Rake $0 
Seat 1: SqibpGx+lf+brY0fJVvD0w (small blind) folded before Flop
Seat 2: zgi+EUykT/pZQpoUG6+oEg (big blind) folded before Flop
Seat 3: CvL9Ch1HYCVbTsfpNucitg folded before Flop (didn't bet)
Seat 4: sD+TKtt36XiiN6jqHiLwDA folded before Flop (didn't bet)
Seat 5: ghNKXUBl/H+t83JF079ZBA collected ($0.60)
Seat 6: 9gmYYQesalMrUjaF7nKfrQ folded before Flop (didn't bet)
Seat 8: VWUWpMLMj/Q1jRVpF7Aohw folded before Flop (didn't bet)
Seat 9: N0hGpTAEAj9k5msS6LPLAw (button) folded before Flop (didn't bet)




PokerStars Game #59941957052:  Hold'em No Limit ($0.10/$0.25) - 2009/07/01 1:51:32 ET
Table 'Ok3oDLIsTc2+KxPcI0bAOA' 6-max Seat #1 is the button
Seat 1: agQm3ugZ3qSVYNgNu1ddeA ($39.20 in chips) 
Seat 2: wPSNSp4HYtytRMXTu3oPSQ ($28.65 in chips) 
Seat 4: LJI7A1YgDM7hgh7o56+ReQ ($34.05 in chips) 
Seat 5: DFi/Lzkjsfv8QswS80JX9Q ($29.75 in chips) 
wPSNSp4HYtytRMXTu3oPSQ: posts small blind $0.10
LJI7A1YgDM7hgh7o56+ReQ: posts big blind $0.25
*** HOLE CARDS ***
DFi/Lzkjsfv8QswS80JX9Q: folds 
agQm3ugZ3qSVYNgNu1ddeA: folds 
mVwoM9qpwrGzpTUusIu2Ig joins the table at seat #3 
wPSNSp4HYtytRMXTu3oPSQ: calls $0.15
LJI7A1YgDM7hgh7o56+ReQ: checks 
*** FLOP *** [Kh Kc Qd]
wPSNSp4HYtytRMXTu3oPSQ: checks 
LJI7A1YgDM7hgh7o56+ReQ: checks 
*** TURN *** [Kh Kc Qd] [Ks]
wPSNSp4HYtytRMXTu3oPSQ: checks 
LJI7A1YgDM7hgh7o56+ReQ: checks 
*** RIVER *** [Kh Kc Qd Ks] [As]
wPSNSp4HYtytRMXTu3oPSQ: bets $0.25
LJI7A1YgDM7hgh7o56+ReQ: folds 
Uncalled bet ($0.25) returned to wPSNSp4HYtytRMXTu3oPSQ
wPSNSp4HYtytRMXTu3oPSQ collected $0.50 from pot
wPSNSp4HYtytRMXTu3oPSQ: doesn't show hand 
*** SUMMARY ***
Total pot $0.50 | Rake $0 
Board [Kh Kc Qd Ks As]
Seat 1: agQm3ugZ3qSVYNgNu1ddeA (button) folded before Flop (didn't bet)
Seat 2: wPSNSp4HYtytRMXTu3oPSQ (small blind) collected ($0.50)
Seat 4: LJI7A1YgDM7hgh7o56+ReQ (big blind) folded on the River
Seat 5: DFi/Lzkjsfv8QswS80JX9Q folded before Flop (didn't bet)




PokerStars Game #59941957056:  Hold'em No Limit ($0.10/$0.25) - 2009/07/01 1:51:32 ET
Table 'g+mPuNJBCHKE9ents7ZGtg' 6-max Seat #1 is the button
Seat 1: cezpHJ8FB07dj0xG+LhOvw ($58.15 in chips) 
Seat 2: fZQg9veL7Dd/Z04ZTjC+wQ ($56.35 in chips) 
Seat 3: 8CPg15X6IHYR1pWm9ha1Sw ($25 in chips) 
Seat 5: D3ikCR8c/o9jB5irZ3uGlw ($19 in chips) 
Seat 6: Mn2V28t5aGq2d09z+/o6Fw ($38.80 in chips) 
fZQg9veL7Dd/Z04ZTjC+wQ: posts small blind $0.10
8CPg15X6IHYR1pWm9ha1Sw: posts big blind $0.25
*** HOLE CARDS ***
D3ikCR8c/o9jB5irZ3uGlw: calls $0.25
Mn2V28t5aGq2d09z+/o6Fw: calls $0.25
cezpHJ8FB07dj0xG+LhOvw: folds 
fZQg9veL7Dd/Z04ZTjC+wQ: calls $0.15
8CPg15X6IHYR1pWm9ha1Sw: checks 
*** FLOP *** [3d 2s 4h]
fZQg9veL7Dd/Z04ZTjC+wQ: checks 
8CPg15X6IHYR1pWm9ha1Sw: checks 
D3ikCR8c/o9jB5irZ3uGlw: bets $0.50
Mn2V28t5aGq2d09z+/o6Fw: raises $1 to $1.50
fZQg9veL7Dd/Z04ZTjC+wQ: folds 
8CPg15X6IHYR1pWm9ha1Sw: folds 
D3ikCR8c/o9jB5irZ3uGlw: calls $1
*** TURN *** [3d 2s 4h] [Qc]
D3ikCR8c/o9jB5irZ3uGlw: checks 
Mn2V28t5aGq2d09z+/o6Fw: checks 
*** RIVER *** [3d 2s 4h Qc] [Js]
D3ikCR8c/o9jB5irZ3uGlw: bets $0.25
Mn2V28t5aGq2d09z+/o6Fw: calls $0.25
yVrjRIW0SMxgpvqSIPSe/w leaves the table
*** SHOW DOWN ***
D3ikCR8c/o9jB5irZ3uGlw: shows [4d 3h] (two pair, Fours and Threes)
Mn2V28t5aGq2d09z+/o6Fw: mucks hand 
D3ikCR8c/o9jB5irZ3uGlw collected $4.30 from pot
*** SUMMARY ***
Total pot $4.50 | Rake $0.20 
Board [3d 2s 4h Qc Js]
Seat 1: cezpHJ8FB07dj0xG+LhOvw (button) folded before Flop (didn't bet)
Seat 2: fZQg9veL7Dd/Z04ZTjC+wQ (small blind) folded on the Flop
Seat 3: 8CPg15X6IHYR1pWm9ha1Sw (big blind) folded on the Flop
Seat 5: D3ikCR8c/o9jB5irZ3uGlw showed [4d 3h] and won ($4.30) with two pair, Fours and Threes
Seat 6: Mn2V28t5aGq2d09z+/o6Fw mucked




PokerStars Game #59941956828:  Hold'em No Limit ($0.10/$0.25) - 2009/07/01 1:51:32 ET
Table 'nQC9LRg01NEuKFHF1nrDEw0XPo7K54oZIfG0xlNAcDRw-max Seat #2 is the button
Seat 1: qf+LMbROj8/qY878wkFHbQ ($18.50 in chips) 
Seat 2: ZhV6dUX9NQhT4zf7t+ZLJg ($23.70 in chips) 
Seat 3: 6+g0Lb6vfRDZkElV8ieHyQ ($25.85 in chips) 
Seat 4: u3Ol7kv1LmvszuHNm9rc6w ($24.65 in chips) 
Seat 5: kG34n23qFQA3nzdOJTQ1dA ($27.95 in chips) 
Seat 6: xQVFeVUDopz+akuEo2wXpQ ($52.40 in chips) 
6+g0Lb6vfRDZkElV8ieHyQ: posts small blind $0.10
u3Ol7kv1LmvszuHNm9rc6w: posts big blind $0.25
*** HOLE CARDS ***
kG34n23qFQA3nzdOJTQ1dA: folds 
xQVFeVUDopz+akuEo2wXpQ: folds 
qf+LMbROj8/qY878wkFHbQ: calls $0.25
ZhV6dUX9NQhT4zf7t+ZLJg: calls $0.25
6+g0Lb6vfRDZkElV8ieHyQ: calls $0.15
u3Ol7kv1LmvszuHNm9rc6w: checks 
*** FLOP *** [3c Jc 4h]
6+g0Lb6vfRDZkElV8ieHyQ: checks 
u3Ol7kv1LmvszuHNm9rc6w: bets $0.50
qf+LMbROj8/qY878wkFHbQ: folds 
ZhV6dUX9NQhT4zf7t+ZLJg: folds 
6+g0Lb6vfRDZkElV8ieHyQ: folds 
Uncalled bet ($0.50) returned to u3Ol7kv1LmvszuHNm9rc6w
u3Ol7kv1LmvszuHNm9rc6w collected $0.95 from pot
u3Ol7kv1LmvszuHNm9rc6w: doesn't show hand 
*** SUMMARY ***
Total pot $1 | Rake $0.05 
Board [3c Jc 4h]
Seat 1: qf+LMbROj8/qY878wkFHbQ folded on the Flop
Seat 2: ZhV6dUX9NQhT4zf7t+ZLJg (button) folded on the Flop
Seat 3: 6+g0Lb6vfRDZkElV8ieHyQ (small blind) folded on the Flop
Seat 4: u3Ol7kv1LmvszuHNm9rc6w (big blind) collected ($0.95)
Seat 5: kG34n23qFQA3nzdOJTQ1dA folded before Flop (didn't bet)
Seat 6: xQVFeVUDopz+akuEo2wXpQ folded before Flop (didn't bet)




PokerStars Game #59941957100:  Hold'em No Limit ($0.10/$0.25) - 2009/07/01 1:51:32 ET
Table '63uh7ZsO7Tnt+E8b/2bu3A' 6-max Seat #6 is the button
Seat 1: 0av6tRNdi0Ui4f15L7gsVg ($32.80 in chips) 
Seat 2: SFmT9ZsVopnukjvAzrxTRg ($25 in chips) 
Seat 3: yVP7GLZBzx47OPi6jzUxMw ($3.60 in chips) 
Seat 4: rnpAao581IcvQglpkpnkoQ ($12 in chips) 
Seat 5: Hsvkc0/G2VV78oVmWYXecw ($9.85 in chips) 
Seat 6: qGHGf/553gQnDoklMRe3tg ($26.55 in chips) 
0av6tRNdi0Ui4f15L7gsVg: posts small blind $0.10
SFmT9ZsVopnukjvAzrxTRg: posts big blind $0.25
*** HOLE CARDS ***
yVP7GLZBzx47OPi6jzUxMw: folds 
rnpAao581IcvQglpkpnkoQ: calls $0.25
Hsvkc0/G2VV78oVmWYXecw: folds 
Hsvkc0/G2VV78oVmWYXecw leaves the table
qGHGf/553gQnDoklMRe3tg: folds 
0av6tRNdi0Ui4f15L7gsVg: calls $0.15
SFmT9ZsVopnukjvAzrxTRg: checks 
*** FLOP *** [Ac 7s Qc]
0av6tRNdi0Ui4f15L7gsVg: checks 
SFmT9ZsVopnukjvAzrxTRg: checks 
rnpAao581IcvQglpkpnkoQ: bets $1
0av6tRNdi0Ui4f15L7gsVg: folds 
SFmT9ZsVopnukjvAzrxTRg: folds 
Uncalled bet ($1) returned to rnpAao581IcvQglpkpnkoQ
rnpAao581IcvQglpkpnkoQ collected $0.75 from pot
*** SUMMARY ***
Total pot $0.75 | Rake $0 
Board [Ac 7s Qc]
Seat 1: 0av6tRNdi0Ui4f15L7gsVg (small blind) folded on the Flop
Seat 2: SFmT9ZsVopnukjvAzrxTRg (big blind) folded on the Flop
Seat 3: yVP7GLZBzx47OPi6jzUxMw folded before Flop (didn't bet)
Seat 4: rnpAao581IcvQglpkpnkoQ collected ($0.75)
Seat 5: Hsvkc0/G2VV78oVmWYXecw folded before Flop (didn't bet)
Seat 6: qGHGf/553gQnDoklMRe3tg (button) folded before Flop (didn't bet)




PokerStars Game #59941956782:  Hold'em No Limit ($0.10/$0.25) - 2009/07/01 1:51:32 ET
Table 'jxoHy9yJy0bbH/Qx73FoPA' 9-max Seat #9 is the button
Seat 1: j4q3p0lesp63b1gZDwLBZw ($13.55 in chips) 
Seat 3: CVqCt93Mk0MhKMaZ4LZDSQ ($2.35 in chips) 
Seat 4: bXpVeaSTPBFSPJmeXxO7nw ($4.65 in chips) 
Seat 6: Z9AeOQX3yzuSvKAm/xyovg ($9.75 in chips) 
Seat 7: wGigCmBR/9XWkPpvYos3aQ ($26.40 in chips) 
Seat 8: Z9W7+g1WMhhZDi7DwGbCFA ($5 in chips) 
Seat 9: CvL9Ch1HYCVbTsfpNucitg ($4.55 in chips) 
j4q3p0lesp63b1gZDwLBZw: posts small blind $0.10
F7pnn6czNpHvRM55XcA2EA: is sitting out 
CVqCt93Mk0MhKMaZ4LZDSQ: posts big blind $0.25
0rQnT3MwKEGi6YXD9FufJw: sits out 
*** HOLE CARDS ***
CVqCt93Mk0MhKMaZ4LZDSQ said, "nh"
bXpVeaSTPBFSPJmeXxO7nw: folds 
Z9AeOQX3yzuSvKAm/xyovg: folds 
wGigCmBR/9XWkPpvYos3aQ: folds 
F7pnn6czNpHvRM55XcA2EA has returned
Z9W7+g1WMhhZDi7DwGbCFA: folds 
CvL9Ch1HYCVbTsfpNucitg: folds 
j4q3p0lesp63b1gZDwLBZw: folds 
Uncalled bet ($0.15) returned to CVqCt93Mk0MhKMaZ4LZDSQ
j4q3p0lesp63b1gZDwLBZw leaves the table
F7pnn6czNpHvRM55XcA2EA leaves the table
CVqCt93Mk0MhKMaZ4LZDSQ collected $0.20 from pot
*** SUMMARY ***
Total pot $0.20 | Rake $0 
Seat 1: j4q3p0lesp63b1gZDwLBZw (small blind) folded before Flop
Seat 3: CVqCt93Mk0MhKMaZ4LZDSQ (big blind) collected ($0.20)
Seat 4: bXpVeaSTPBFSPJmeXxO7nw folded before Flop (didn't bet)
Seat 6: Z9AeOQX3yzuSvKAm/xyovg folded before Flop (didn't bet)
Seat 7: wGigCmBR/9XWkPpvYos3aQ folded before Flop (didn't bet)
Seat 8: Z9W7+g1WMhhZDi7DwGbCFA folded before Flop (didn't bet)
Seat 9: CvL9Ch1HYCVbTsfpNucitg (button) folded before Flop (didn't bet)




PokerStars Game #59941957648:  Hold'em No Limit ($0.10/$0.25) - 2009/07/01 1:51:33 ET
Table 'HbNAGS1OJWQKyfk7UfrYyw' 9-max Seat #5 is the button
Seat 2: fjwM06E3HzjUrynPRQi31Q ($6 in chips) 
Seat 3: Yxal0LG80xJqTIctpMLWlg ($2.15 in chips) 
Seat 4: XwQK8xvCADxp0bUmji+Zyg ($18 in chips) 
Seat 5: clJsV3v77RS07bDKY+705w ($5 in chips) 
Seat 6: jntAuOS+eFQDYNiDN8dzag ($5.50 in chips) 
Seat 7: T+MjFnaPZsOyKbE9LYG2Qg ($14.75 in chips) 
Seat 9: nLE5Yo60EmSlJPyg0GgxXg ($31.30 in chips) 
jntAuOS+eFQDYNiDN8dzag: posts small blind $0.10
T+MjFnaPZsOyKbE9LYG2Qg: posts big blind $0.25
DiSvPC2iudwL5j9u6Huyww: sits out 
3PmVnC/15cl4oyI1TKIt4g: sits out 
*** HOLE CARDS ***
nLE5Yo60EmSlJPyg0GgxXg: calls $0.25
fjwM06E3HzjUrynPRQi31Q: calls $0.25
Yxal0LG80xJqTIctpMLWlg: folds 
XwQK8xvCADxp0bUmji+Zyg: calls $0.25
clJsV3v77RS07bDKY+705w: folds 
jntAuOS+eFQDYNiDN8dzag: raises $5.25 to $5.50 and is all-in
T+MjFnaPZsOyKbE9LYG2Qg: calls $5.25
nLE5Yo60EmSlJPyg0GgxXg: folds 
fjwM06E3HzjUrynPRQi31Q: folds 
XwQK8xvCADxp0bUmji+Zyg: folds 
*** FLOP *** [7d Qc 2d]
*** TURN *** [7d Qc 2d] [9c]
*** RIVER *** [7d Qc 2d 9c] [Js]
*** SHOW DOWN ***
jntAuOS+eFQDYNiDN8dzag: shows [Ts Jc] (a pair of Jacks)
T+MjFnaPZsOyKbE9LYG2Qg: shows [7c 7h] (three of a kind, Sevens)
T+MjFnaPZsOyKbE9LYG2Qg collected $11.20 from pot
*** SUMMARY ***
Total pot $11.75 | Rake $0.55 
Board [7d Qc 2d 9c Js]
Seat 2: fjwM06E3HzjUrynPRQi31Q folded before Flop
Seat 3: Yxal0LG80xJqTIctpMLWlg folded before Flop (didn't bet)
Seat 4: XwQK8xvCADxp0bUmji+Zyg folded before Flop
Seat 5: clJsV3v77RS07bDKY+705w (button) folded before Flop (didn't bet)
Seat 6: jntAuOS+eFQDYNiDN8dzag (small blind) showed [Ts Jc] and lost with a pair of Jacks
Seat 7: T+MjFnaPZsOyKbE9LYG2Qg (big blind) showed [7c 7h] and won ($11.20) with three of a kind, Sevens
Seat 9: nLE5Yo60EmSlJPyg0GgxXg folded before Flop




PokerStars Game #59941957616:  Hold'em No Limit ($0.10/$0.25) - 2009/07/01 1:51:33 ET
Table 'SHi8+hK6i7E2dJ/3Agbyig' 6-max Seat #3 is the button
Seat 1: gPEN9Zp33YTm/mu9/SYP1w ($27.05 in chips) 
Seat 2: LJI7A1YgDM7hgh7o56+ReQ ($25 in chips) 
Seat 3: VXTONriS+Ohik+r0FeicIw ($25 in chips) 
Seat 4: u0ikXOhAPSCLmg+l17oGRw ($21.15 in chips) 
Seat 5: v8m8XHovI5tqEA9mvplDSw ($48.95 in chips) 
Seat 6: cWc85bEzdRzpUMhRKm8pwQ ($34.85 in chips) 
u0ikXOhAPSCLmg+l17oGRw: posts small blind $0.10
v8m8XHovI5tqEA9mvplDSw: posts big blind $0.25
*** HOLE CARDS ***
cWc85bEzdRzpUMhRKm8pwQ: folds 
gPEN9Zp33YTm/mu9/SYP1w: folds 
LJI7A1YgDM7hgh7o56+ReQ: folds 
VXTONriS+Ohik+r0FeicIw: folds 
u0ikXOhAPSCLmg+l17oGRw: calls $0.15
v8m8XHovI5tqEA9mvplDSw: checks 
*** FLOP *** [9d Ts 3s]
u0ikXOhAPSCLmg+l17oGRw: checks 
v8m8XHovI5tqEA9mvplDSw: bets $0.50
u0ikXOhAPSCLmg+l17oGRw: calls $0.50
*** TURN *** [9d Ts 3s] [6d]
u0ikXOhAPSCLmg+l17oGRw: checks 
v8m8XHovI5tqEA9mvplDSw: checks 
*** RIVER *** [9d Ts 3s 6d] [As]
u0ikXOhAPSCLmg+l17oGRw: bets $1.50
v8m8XHovI5tqEA9mvplDSw: folds 
Uncalled bet ($1.50) returned to u0ikXOhAPSCLmg+l17oGRw
u0ikXOhAPSCLmg+l17oGRw collected $1.45 from pot
*** SUMMARY ***
Total pot $1.50 | Rake $0.05 
Board [9d Ts 3s 6d As]
Seat 1: gPEN9Zp33YTm/mu9/SYP1w folded before Flop (didn't bet)
Seat 2: LJI7A1YgDM7hgh7o56+ReQ folded before Flop (didn't bet)
Seat 3: VXTONriS+Ohik+r0FeicIw (button) folded before Flop (didn't bet)
Seat 4: u0ikXOhAPSCLmg+l17oGRw (small blind) collected ($1.45)
Seat 5: v8m8XHovI5tqEA9mvplDSw (big blind) folded on the River
Seat 6: cWc85bEzdRzpUMhRKm8pwQ folded before Flop (didn't bet)




PokerStars Game #59941957322:  Hold'em No Limit ($0.10/$0.25) - 2009/07/01 1:51:33 ET
Table 'C8mMnVmvkagwolEzTvh07A' 9-max Seat #6 is the button
Seat 1: PqvgxdSg9z5VmrWpbYuz+g ($25.90 in chips) 
Seat 2: Bb42QRQMhg5/Y0vHP8/2Xw ($25.35 in chips) 
Seat 3: Th3FldXKQW6hWVVPahaoOQ ($34.50 in chips) 
Seat 4: dfNim92Z6XK1/h5SFW5vDg ($25.35 in chips) 
Seat 5: iGMlK+EhUflPB6jKQd95Cg ($25 in chips) 
Seat 6: AiXn/9o1EwOPZUHujnh/bA ($18.15 in chips) 
18G4P1XstjNvItdGUITxgw will be allowed to play after the button
PqvgxdSg9z5VmrWpbYuz+g: posts small blind $0.10
Bb42QRQMhg5/Y0vHP8/2Xw: posts big blind $0.25
*** HOLE CARDS ***
Th3FldXKQW6hWVVPahaoOQ: folds 
dfNim92Z6XK1/h5SFW5vDg: folds 
iGMlK+EhUflPB6jKQd95Cg: folds 
AiXn/9o1EwOPZUHujnh/bA: folds 
PqvgxdSg9z5VmrWpbYuz+g: calls $0.15
Bb42QRQMhg5/Y0vHP8/2Xw: checks 
*** FLOP *** [9c 7h 6s]
PqvgxdSg9z5VmrWpbYuz+g: bets $1
Bb42QRQMhg5/Y0vHP8/2Xw: folds 
Uncalled bet ($1) returned to PqvgxdSg9z5VmrWpbYuz+g
PqvgxdSg9z5VmrWpbYuz+g collected $0.50 from pot
PqvgxdSg9z5VmrWpbYuz+g: doesn't show hand 
*** SUMMARY ***
Total pot $0.50 | Rake $0 
Board [9c 7h 6s]
Seat 1: PqvgxdSg9z5VmrWpbYuz+g (small blind) collected ($0.50)
Seat 2: Bb42QRQMhg5/Y0vHP8/2Xw (big blind) folded on the Flop
Seat 3: Th3FldXKQW6hWVVPahaoOQ folded before Flop (didn't bet)
Seat 4: dfNim92Z6XK1/h5SFW5vDg folded before Flop (didn't bet)
Seat 5: iGMlK+EhUflPB6jKQd95Cg folded before Flop (didn't bet)
Seat 6: AiXn/9o1EwOPZUHujnh/bA (button) folded before Flop (didn't bet)




PokerStars Game #59941957306:  Hold'em No Limit ($0.10/$0.25) - 2009/07/01 1:51:33 ET
Table '3lL16FBjWXTx3AjK5lMRww' 9-max Seat #8 is the button
Seat 1: fDGyaQz0cs2s4FOYxkbIHA ($15.55 in chips) 
Seat 2: c/9X4zftzphFxYtxp5kp9w ($21.90 in chips) 
Seat 3: QEbIGci+itdw+re8RM5fZA ($28.50 in chips) 
Seat 4: Z3a37Ry74FVl+CBZtAONiA ($6.40 in chips) 
Seat 5: M/9j4wkHH9i1JM51vgi1VA ($36.95 in chips) 
Seat 7: 6RiVTYll/5D8zICp0MRpKw ($26.30 in chips) 
Seat 8: ljemhp25Zg+nlA9DLCIiUw ($24.40 in chips) 
Seat 9: 00Ybni1cxfHtqmdWwh31Xg ($10.05 in chips) 
00Ybni1cxfHtqmdWwh31Xg: posts small blind $0.10
fDGyaQz0cs2s4FOYxkbIHA: posts big blind $0.25
*** HOLE CARDS ***
c/9X4zftzphFxYtxp5kp9w: raises $0.50 to $0.75
QEbIGci+itdw+re8RM5fZA: folds 
Z3a37Ry74FVl+CBZtAONiA: folds 
M/9j4wkHH9i1JM51vgi1VA: folds 
6RiVTYll/5D8zICp0MRpKw: folds 
ljemhp25Zg+nlA9DLCIiUw: folds 
00Ybni1cxfHtqmdWwh31Xg: folds 
fDGyaQz0cs2s4FOYxkbIHA: folds 
Uncalled bet ($0.50) returned to c/9X4zftzphFxYtxp5kp9w
c/9X4zftzphFxYtxp5kp9w collected $0.60 from pot
*** SUMMARY ***
Total pot $0.60 | Rake $0 
Seat 1: fDGyaQz0cs2s4FOYxkbIHA (big blind) folded before Flop
Seat 2: c/9X4zftzphFxYtxp5kp9w collected ($0.60)
Seat 3: QEbIGci+itdw+re8RM5fZA folded before Flop (didn't bet)
Seat 4: Z3a37Ry74FVl+CBZtAONiA folded before Flop (didn't bet)
Seat 5: M/9j4wkHH9i1JM51vgi1VA folded before Flop (didn't bet)
Seat 7: 6RiVTYll/5D8zICp0MRpKw folded before Flop (didn't bet)
Seat 8: ljemhp25Zg+nlA9DLCIiUw (button) folded before Flop (didn't bet)
Seat 9: 00Ybni1cxfHtqmdWwh31Xg (small blind) folded before Flop




PokerStars Game #59941958258:  Hold'em No Limit ($0.10/$0.25) - 2009/07/01 1:51:34 ET
Table 'M7d9IrgQUUFFy/SZ3ksLYg' 6-max Seat #6 is the button
Seat 1: ypmjhffk/YHGc51wgVXUTw ($50.10 in chips) 
Seat 2: 8CPg15X6IHYR1pWm9ha1Sw ($25.30 in chips) 
Seat 3: epAUIB7h2FJXzUPRIvSkRA ($25.90 in chips) 
Seat 4: 8ClCHtFXGNplITm+63KB+Q ($22.50 in chips) 
Seat 6: 7S16WhQHiAVLWwRuqPrpnw ($15.20 in chips) 
ypmjhffk/YHGc51wgVXUTw: posts small blind $0.10
8CPg15X6IHYR1pWm9ha1Sw: posts big blind $0.25
*** HOLE CARDS ***
epAUIB7h2FJXzUPRIvSkRA: folds 
8ClCHtFXGNplITm+63KB+Q: folds 
7S16WhQHiAVLWwRuqPrpnw: calls $0.25
MVzl6OsGybVDNd3Vr9LYAA joins the table at seat #5 
ypmjhffk/YHGc51wgVXUTw: calls $0.15
8CPg15X6IHYR1pWm9ha1Sw: checks 
*** FLOP *** [7s 4d Ah]
ypmjhffk/YHGc51wgVXUTw: bets $0.50
8CPg15X6IHYR1pWm9ha1Sw: folds 
7S16WhQHiAVLWwRuqPrpnw: calls $0.50
*** TURN *** [7s 4d Ah] [Js]
ypmjhffk/YHGc51wgVXUTw: checks 
7S16WhQHiAVLWwRuqPrpnw: checks 
*** RIVER *** [7s 4d Ah Js] [Ks]
ypmjhffk/YHGc51wgVXUTw: checks 
7S16WhQHiAVLWwRuqPrpnw: checks 
*** SHOW DOWN ***
ypmjhffk/YHGc51wgVXUTw: shows [7d 9d] (a pair of Sevens)
7S16WhQHiAVLWwRuqPrpnw: mucks hand 
ypmjhffk/YHGc51wgVXUTw collected $1.70 from pot
*** SUMMARY ***
Total pot $1.75 | Rake $0.05 
Board [7s 4d Ah Js Ks]
Seat 1: ypmjhffk/YHGc51wgVXUTw (small blind) showed [7d 9d] and won ($1.70) with a pair of Sevens
Seat 2: 8CPg15X6IHYR1pWm9ha1Sw (big blind) folded on the Flop
Seat 3: epAUIB7h2FJXzUPRIvSkRA folded before Flop (didn't bet)
Seat 4: 8ClCHtFXGNplITm+63KB+Q folded before Flop (didn't bet)
Seat 6: 7S16WhQHiAVLWwRuqPrpnw (button) mucked




PokerStars Game #59941958158:  Hold'em No Limit ($0.10/$0.25) - 2009/07/01 1:51:34 ET
Table 'HIOfhT0zga/KonFhIl6O3w' 9-max Seat #6 is the button
Seat 1: oLa/tXLfSLLB28mcLGrxcg ($27.15 in chips) 
Seat 2: er86weqXTpTB6/w2dKlYgA ($8.35 in chips) 
Seat 3: X6+pSIPfovPcE87t+LmUKQ ($4.50 in chips) 
Seat 4: qwr38jl5txoR36M7G5qi4A ($15.85 in chips) 
Seat 5: K1MDeapSEyKyGPNZGOKfEg ($36.80 in chips) 
Seat 6: MThMMgdB293VOucmN9sliQ ($25.10 in chips) 
Seat 7: wvlPJBB0PtYkfeeSRDaIvQ ($13.20 in chips) 
Seat 8: SpiiQQAzy4MUgV3I5W8giw ($25 in chips) 
Seat 9: dfNim92Z6XK1/h5SFW5vDg ($28.70 in chips) 
wvlPJBB0PtYkfeeSRDaIvQ: posts small blind $0.10
SpiiQQAzy4MUgV3I5W8giw: posts big blind $0.25
*** HOLE CARDS ***
dfNim92Z6XK1/h5SFW5vDg: folds 
oLa/tXLfSLLB28mcLGrxcg: folds 
er86weqXTpTB6/w2dKlYgA: folds 
X6+pSIPfovPcE87t+LmUKQ: folds 
qwr38jl5txoR36M7G5qi4A: folds 
K1MDeapSEyKyGPNZGOKfEg: folds 
MThMMgdB293VOucmN9sliQ: raises $0.75 to $1
wvlPJBB0PtYkfeeSRDaIvQ: folds 
SpiiQQAzy4MUgV3I5W8giw: folds 
Uncalled bet ($0.75) returned to MThMMgdB293VOucmN9sliQ
MThMMgdB293VOucmN9sliQ collected $0.60 from pot
*** SUMMARY ***
Total pot $0.60 | Rake $0 
Seat 1: oLa/tXLfSLLB28mcLGrxcg folded before Flop (didn't bet)
Seat 2: er86weqXTpTB6/w2dKlYgA folded before Flop (didn't bet)
Seat 3: X6+pSIPfovPcE87t+LmUKQ folded before Flop (didn't bet)
Seat 4: qwr38jl5txoR36M7G5qi4A folded before Flop (didn't bet)
Seat 5: K1MDeapSEyKyGPNZGOKfEg folded before Flop (didn't bet)
Seat 6: MThMMgdB293VOucmN9sliQ (button) collected ($0.60)
Seat 7: wvlPJBB0PtYkfeeSRDaIvQ (small blind) folded before Flop
Seat 8: SpiiQQAzy4MUgV3I5W8giw (big blind) folded before Flop
Seat 9: dfNim92Z6XK1/h5SFW5vDg folded before Flop (didn't bet)




PokerStars Game #59941957778:  Hold'em No Limit ($0.10/$0.25) - 2009/07/01 1:51:34 ET
Table 'QegsWX65l3n/K0A8XB78yg' 6-max Seat #3 is the button
Seat 1: p6adJRMXMBLr+xtQzqazIQ ($12 in chips) 
Seat 2: GC/9yVD59DUCX7hUI7gcLw ($55.50 in chips) 
Seat 3: iIgNoBh+3/Ix1/fLsg+HuA ($6 in chips) 
Seat 4: epAUIB7h2FJXzUPRIvSkRA ($25 in chips) 
Seat 5: QqiZLFrN8iOUT/GHw7ztOA ($28.95 in chips) 
Seat 6: 5PWs02z65jSO5pr/M6wx/w ($11.70 in chips) 
epAUIB7h2FJXzUPRIvSkRA: posts small blind $0.10
QqiZLFrN8iOUT/GHw7ztOA: posts big blind $0.25
*** HOLE CARDS ***
5PWs02z65jSO5pr/M6wx/w: calls $0.25
p6adJRMXMBLr+xtQzqazIQ: folds 
GC/9yVD59DUCX7hUI7gcLw: folds 
iIgNoBh+3/Ix1/fLsg+HuA: folds 
epAUIB7h2FJXzUPRIvSkRA: folds 
QqiZLFrN8iOUT/GHw7ztOA: raises $0.75 to $1
5PWs02z65jSO5pr/M6wx/w: calls $0.75
*** FLOP *** [3s Tc 8h]
QqiZLFrN8iOUT/GHw7ztOA: bets $1.50
5PWs02z65jSO5pr/M6wx/w: raises $2 to $3.50
QqiZLFrN8iOUT/GHw7ztOA: folds 
Uncalled bet ($2) returned to 5PWs02z65jSO5pr/M6wx/w
5PWs02z65jSO5pr/M6wx/w collected $4.85 from pot
*** SUMMARY ***
Total pot $5.10 | Rake $0.25 
Board [3s Tc 8h]
Seat 1: p6adJRMXMBLr+xtQzqazIQ folded before Flop (didn't bet)
Seat 2: GC/9yVD59DUCX7hUI7gcLw folded before Flop (didn't bet)
Seat 3: iIgNoBh+3/Ix1/fLsg+HuA (button) folded before Flop (didn't bet)
Seat 4: epAUIB7h2FJXzUPRIvSkRA (small blind) folded before Flop
Seat 5: QqiZLFrN8iOUT/GHw7ztOA (big blind) folded on the Flop
Seat 6: 5PWs02z65jSO5pr/M6wx/w collected ($4.85)




PokerStars Game #59941958372:  Hold'em No Limit ($0.10/$0.25) - 2009/07/01 1:51:35 ET
Table 'mVdLgAdN9rGe6mMwSrDdGQ' 6-max Seat #1 is the button
Seat 1: OyJ0KTHA5cwh0/yCo1/rdA ($9.10 in chips) 
Seat 2: n9QqWD4tpbongUBX2Oi58w ($10.90 in chips) 
Seat 3: +baiVgI/ETnBARLe5mARCw ($16.25 in chips) 
Seat 4: scNSjC6yyKvvfklSkuzLrw ($23.50 in chips) 
Seat 5: +TMG/MBWpiEnc9t7i07eTA ($23.15 in chips) 
Seat 6: DihMHaz4WNETH1bPDe13kA ($47.95 in chips) 
n9QqWD4tpbongUBX2Oi58w: posts small blind $0.10
+baiVgI/ETnBARLe5mARCw: posts big blind $0.25
*** HOLE CARDS ***
scNSjC6yyKvvfklSkuzLrw: calls $0.25
+TMG/MBWpiEnc9t7i07eTA: folds 
DihMHaz4WNETH1bPDe13kA: folds 
OyJ0KTHA5cwh0/yCo1/rdA: calls $0.25
n9QqWD4tpbongUBX2Oi58w: folds 
+baiVgI/ETnBARLe5mARCw: checks 
*** FLOP *** [7c Th 4d]
+baiVgI/ETnBARLe5mARCw: checks 
scNSjC6yyKvvfklSkuzLrw: bets $0.75
OyJ0KTHA5cwh0/yCo1/rdA: calls $0.75
+baiVgI/ETnBARLe5mARCw: folds 
*** TURN *** [7c Th 4d] [2h]
scNSjC6yyKvvfklSkuzLrw: bets $1
OyJ0KTHA5cwh0/yCo1/rdA: calls $1
*** RIVER *** [7c Th 4d 2h] [Kc]
scNSjC6yyKvvfklSkuzLrw: bets $2
OyJ0KTHA5cwh0/yCo1/rdA: folds 
Uncalled bet ($2) returned to scNSjC6yyKvvfklSkuzLrw
scNSjC6yyKvvfklSkuzLrw collected $4.15 from pot
*** SUMMARY ***
Total pot $4.35 | Rake $0.20 
Board [7c Th 4d 2h Kc]
Seat 1: OyJ0KTHA5cwh0/yCo1/rdA (button) folded on the River
Seat 2: n9QqWD4tpbongUBX2Oi58w (small blind) folded before Flop
Seat 3: +baiVgI/ETnBARLe5mARCw (big blind) folded on the Flop
Seat 4: scNSjC6yyKvvfklSkuzLrw collected ($4.15)
Seat 5: +TMG/MBWpiEnc9t7i07eTA folded before Flop (didn't bet)
Seat 6: DihMHaz4WNETH1bPDe13kA folded before Flop (didn't bet)




PokerStars Game #59941958392:  Hold'em No Limit ($0.10/$0.25) - 2009/07/01 1:51:35 ET
Table 'oJpFwZj9+FUGHX90Un8s9Q' 6-max Seat #2 is the button
Seat 1: 6DwBRH+xZ12AAZmeAg+aXw ($25.50 in chips) 
Seat 2: NtrVQ9UIql0rDCnKDKZ5FQ ($18.85 in chips) 
Seat 3: kyRaCIljYA6l33lSKQfNsg ($17.65 in chips) 
Seat 4: 6elpmfyt4Zw0yvd8lePSMQ ($22.40 in chips) 
Seat 5: kG34n23qFQA3nzdOJTQ1dA ($59.05 in chips) 
Seat 6: 7LpHJVeM6k1mQdC6HXYzww ($25 in chips) 
kyRaCIljYA6l33lSKQfNsg: posts small blind $0.10
6elpmfyt4Zw0yvd8lePSMQ: posts big blind $0.25
*** HOLE CARDS ***
kG34n23qFQA3nzdOJTQ1dA: folds 
7LpHJVeM6k1mQdC6HXYzww: folds 
6DwBRH+xZ12AAZmeAg+aXw: folds 
NtrVQ9UIql0rDCnKDKZ5FQ: calls $0.25
kyRaCIljYA6l33lSKQfNsg: folds 
6elpmfyt4Zw0yvd8lePSMQ: checks 
*** FLOP *** [Ah Jd 4d]
6elpmfyt4Zw0yvd8lePSMQ: checks 
NtrVQ9UIql0rDCnKDKZ5FQ: bets $0.25
6elpmfyt4Zw0yvd8lePSMQ: calls $0.25
*** TURN *** [Ah Jd 4d] [Kc]
6elpmfyt4Zw0yvd8lePSMQ: checks 
NtrVQ9UIql0rDCnKDKZ5FQ: bets $0.25
6elpmfyt4Zw0yvd8lePSMQ: calls $0.25
*** RIVER *** [Ah Jd 4d Kc] [Qc]
6elpmfyt4Zw0yvd8lePSMQ: checks 
NtrVQ9UIql0rDCnKDKZ5FQ: checks 
*** SHOW DOWN ***
6elpmfyt4Zw0yvd8lePSMQ: shows [Jh 7d] (a pair of Jacks)
NtrVQ9UIql0rDCnKDKZ5FQ: shows [7s As] (a pair of Aces)
NtrVQ9UIql0rDCnKDKZ5FQ collected $1.55 from pot
*** SUMMARY ***
Total pot $1.60 | Rake $0.05 
Board [Ah Jd 4d Kc Qc]
Seat 1: 6DwBRH+xZ12AAZmeAg+aXw folded before Flop (didn't bet)
Seat 2: NtrVQ9UIql0rDCnKDKZ5FQ (button) showed [7s As] and won ($1.55) with a pair of Aces
Seat 3: kyRaCIljYA6l33lSKQfNsg (small blind) folded before Flop
Seat 4: 6elpmfyt4Zw0yvd8lePSMQ (big blind) showed [Jh 7d] and lost with a pair of Jacks
Seat 5: kG34n23qFQA3nzdOJTQ1dA folded before Flop (didn't bet)
Seat 6: 7LpHJVeM6k1mQdC6HXYzww folded before Flop (didn't bet)




PokerStars Game #59941958426:  Hold'em No Limit ($0.10/$0.25) - 2009/07/01 1:51:35 ET
Table 'CM/C/FZf3VHIp50RjmBucQ' 9-max Seat #1 is the button
Seat 1: P8h+GtgJJRwRh2YdssBtbg ($5.50 in chips) 
Seat 2: OXPkK84/qv92EMwXPiG5rQ ($9.75 in chips) 
Seat 3: HPEB+AtKw1+C/cxU0o1ciw ($54.45 in chips) 
Seat 4: FYIiLXWy4mKC5ZGa/fnS0g ($7.05 in chips) 
Seat 5: t3m1RlE+8m1yb0ojo8ikCw ($11.40 in chips) 
Seat 6: FqpibuVWLNsAN/Z7ROZLnA ($5.55 in chips) 
Seat 7: +T7KwHtNiHQt6JhQegSH/w ($17.20 in chips) 
Seat 8: 5pDhXQ+RVy0BGcwfJAJfbg ($24.65 in chips) 
Seat 9: W6tExOcYX7qiy6Qdp+ZwFA ($4.90 in chips) 
OXPkK84/qv92EMwXPiG5rQ: posts small blind $0.10
HPEB+AtKw1+C/cxU0o1ciw: posts big blind $0.25
*** HOLE CARDS ***
FYIiLXWy4mKC5ZGa/fnS0g: calls $0.25
t3m1RlE+8m1yb0ojo8ikCw: calls $0.25
FqpibuVWLNsAN/Z7ROZLnA: folds 
+T7KwHtNiHQt6JhQegSH/w: folds 
5pDhXQ+RVy0BGcwfJAJfbg: folds 
W6tExOcYX7qiy6Qdp+ZwFA: folds 
P8h+GtgJJRwRh2YdssBtbg: folds 
OXPkK84/qv92EMwXPiG5rQ: folds 
HPEB+AtKw1+C/cxU0o1ciw: checks 
*** FLOP *** [Jc Kd 4c]
HPEB+AtKw1+C/cxU0o1ciw: checks 
FYIiLXWy4mKC5ZGa/fnS0g: checks 
t3m1RlE+8m1yb0ojo8ikCw: bets $0.50
HPEB+AtKw1+C/cxU0o1ciw: calls $0.50
FYIiLXWy4mKC5ZGa/fnS0g: folds 
*** TURN *** [Jc Kd 4c] [2c]
HPEB+AtKw1+C/cxU0o1ciw: checks 
t3m1RlE+8m1yb0ojo8ikCw: checks 
*** RIVER *** [Jc Kd 4c 2c] [Ah]
HPEB+AtKw1+C/cxU0o1ciw: checks 
t3m1RlE+8m1yb0ojo8ikCw: folds 
HPEB+AtKw1+C/cxU0o1ciw collected $1.80 from pot
HPEB+AtKw1+C/cxU0o1ciw: doesn't show hand 
*** SUMMARY ***
Total pot $1.85 | Rake $0.05 
Board [Jc Kd 4c 2c Ah]
Seat 1: P8h+GtgJJRwRh2YdssBtbg (button) folded before Flop (didn't bet)
Seat 2: OXPkK84/qv92EMwXPiG5rQ (small blind) folded before Flop
Seat 3: HPEB+AtKw1+C/cxU0o1ciw (big blind) collected ($1.80)
Seat 4: FYIiLXWy4mKC5ZGa/fnS0g folded on the Flop
Seat 5: t3m1RlE+8m1yb0ojo8ikCw folded on the River
Seat 6: FqpibuVWLNsAN/Z7ROZLnA folded before Flop (didn't bet)
Seat 7: +T7KwHtNiHQt6JhQegSH/w folded before Flop (didn't bet)
Seat 8: 5pDhXQ+RVy0BGcwfJAJfbg folded before Flop (didn't bet)
Seat 9: W6tExOcYX7qiy6Qdp+ZwFA folded before Flop (didn't bet)




PokerStars Game #59941958542:  Hold'em No Limit ($0.10/$0.25) - 2009/07/01 1:51:35 ET
Table 'r562aMIMs5kgo28FEU6lkA' 9-max Seat #1 is the button
Seat 1: H5Se03ZqSX7tbULXur2MAg ($14.45 in chips) 
Seat 2: N8muFAHrFHW6elSMGuyVLQ ($25.70 in chips) 
Seat 3: xoBFd/5k+L/pFn9VW1VyWg ($10.60 in chips) 
Seat 4: V6p0jQ/RhUsqpHLmXvEX4Q ($19.75 in chips) 
Seat 5: zDrucyjVn5aeekNEc3cJrA ($35.20 in chips) 
Seat 6: RCqMONFrSPSArZh2Jsar/w ($20 in chips) 
Seat 7: Bb42QRQMhg5/Y0vHP8/2Xw ($25 in chips) 
Seat 8: B6xHiX1SJkS0CUNCKDVwuQ ($20.65 in chips) 
Seat 9: yyG4svzOpC1A+sUP/scg6w ($7 in chips) 
N8muFAHrFHW6elSMGuyVLQ: posts small blind $0.10
xoBFd/5k+L/pFn9VW1VyWg: posts big blind $0.25
*** HOLE CARDS ***
V6p0jQ/RhUsqpHLmXvEX4Q: folds 
zDrucyjVn5aeekNEc3cJrA: folds 
RCqMONFrSPSArZh2Jsar/w: folds 
Bb42QRQMhg5/Y0vHP8/2Xw: folds 
B6xHiX1SJkS0CUNCKDVwuQ: folds 
yyG4svzOpC1A+sUP/scg6w: folds 
H5Se03ZqSX7tbULXur2MAg: raises $0.50 to $0.75
N8muFAHrFHW6elSMGuyVLQ: folds 
xoBFd/5k+L/pFn9VW1VyWg: folds 
Uncalled bet ($0.50) returned to H5Se03ZqSX7tbULXur2MAg
H5Se03ZqSX7tbULXur2MAg collected $0.60 from pot
H5Se03ZqSX7tbULXur2MAg: doesn't show hand 
*** SUMMARY ***
Total pot $0.60 | Rake $0 
Seat 1: H5Se03ZqSX7tbULXur2MAg (button) collected ($0.60)
Seat 2: N8muFAHrFHW6elSMGuyVLQ (small blind) folded before Flop
Seat 3: xoBFd/5k+L/pFn9VW1VyWg (big blind) folded before Flop
Seat 4: V6p0jQ/RhUsqpHLmXvEX4Q folded before Flop (didn't bet)
Seat 5: zDrucyjVn5aeekNEc3cJrA folded before Flop (didn't bet)
Seat 6: RCqMONFrSPSArZh2Jsar/w folded before Flop (didn't bet)
Seat 7: Bb42QRQMhg5/Y0vHP8/2Xw folded before Flop (didn't bet)
Seat 8: B6xHiX1SJkS0CUNCKDVwuQ folded before Flop (didn't bet)
Seat 9: yyG4svzOpC1A+sUP/scg6w folded before Flop (didn't bet)




PokerStars Game #59941958408:  Hold'em No Limit ($0.10/$0.25) - 2009/07/01 1:51:35 ET
Table '9iHhO6FyZVM8XpSc23TIgg' 6-max Seat #2 is the button
Seat 2: bJFzs6QmEEnz4miMfSDtcg ($32.75 in chips) 
Seat 3: TSmua8tGK3sTbwi0ynrW9Q ($28.95 in chips) 
Seat 4: cfJccEfyn6IkquPN08hFsA ($25.40 in chips) 
Seat 5: OMGl+YMGogf2JWIRfT2/Yg ($10 in chips) 
Seat 6: iyZxqznXjv3vtvOJymkoLQ ($33.85 in chips) 
TSmua8tGK3sTbwi0ynrW9Q: posts small blind $0.10
cfJccEfyn6IkquPN08hFsA: posts big blind $0.25
*** HOLE CARDS ***
OMGl+YMGogf2JWIRfT2/Yg: calls $0.25
iyZxqznXjv3vtvOJymkoLQ: folds 
bJFzs6QmEEnz4miMfSDtcg: folds 
TSmua8tGK3sTbwi0ynrW9Q: folds 
NhUN/JpAprdJeamFBgJH1w leaves the table
cfJccEfyn6IkquPN08hFsA: checks 
*** FLOP *** [Qs 7s Td]
cfJccEfyn6IkquPN08hFsA: checks 
OMGl+YMGogf2JWIRfT2/Yg: checks 
*** TURN *** [Qs 7s Td] [Qd]
cfJccEfyn6IkquPN08hFsA: bets $0.50
OMGl+YMGogf2JWIRfT2/Yg: folds 
Uncalled bet ($0.50) returned to cfJccEfyn6IkquPN08hFsA
cfJccEfyn6IkquPN08hFsA collected $0.60 from pot
cfJccEfyn6IkquPN08hFsA: doesn't show hand 
*** SUMMARY ***
Total pot $0.60 | Rake $0 
Board [Qs 7s Td Qd]
Seat 2: bJFzs6QmEEnz4miMfSDtcg (button) folded before Flop (didn't bet)
Seat 3: TSmua8tGK3sTbwi0ynrW9Q (small blind) folded before Flop
Seat 4: cfJccEfyn6IkquPN08hFsA (big blind) collected ($0.60)
Seat 5: OMGl+YMGogf2JWIRfT2/Yg folded on the Turn
Seat 6: iyZxqznXjv3vtvOJymkoLQ folded before Flop (didn't bet)




PokerStars Game #59941958620:  Hold'em No Limit ($0.10/$0.25) - 2009/07/01 1:51:35 ET
Table 'dZNBGqFYSwfOVZvDJ4VjIQ' 6-max Seat #1 is the button
Seat 1: v+QfkGiuj9bgtuNoVnDO8w ($37.65 in chips) 
Seat 2: 3zD3qLXT1bEffAoWGnc7wg ($27.70 in chips) 
Seat 3: kyRaCIljYA6l33lSKQfNsg ($29.35 in chips) 
Seat 5: +ZlnqPoP3Hg4BIUxDfKd/A ($27.40 in chips) 
Seat 6: ypmjhffk/YHGc51wgVXUTw ($31.25 in chips) 
3zD3qLXT1bEffAoWGnc7wg: posts small blind $0.10
kyRaCIljYA6l33lSKQfNsg: posts big blind $0.25
GbCVUNssQ7mqsPWr7J4d3w: sits out 
*** HOLE CARDS ***
+ZlnqPoP3Hg4BIUxDfKd/A: folds 
ypmjhffk/YHGc51wgVXUTw: folds 
v+QfkGiuj9bgtuNoVnDO8w: folds 
3zD3qLXT1bEffAoWGnc7wg: folds 
Uncalled bet ($0.15) returned to kyRaCIljYA6l33lSKQfNsg
kyRaCIljYA6l33lSKQfNsg collected $0.20 from pot
*** SUMMARY ***
Total pot $0.20 | Rake $0 
Seat 1: v+QfkGiuj9bgtuNoVnDO8w (button) folded before Flop (didn't bet)
Seat 2: 3zD3qLXT1bEffAoWGnc7wg (small blind) folded before Flop
Seat 3: kyRaCIljYA6l33lSKQfNsg (big blind) collected ($0.20)
Seat 5: +ZlnqPoP3Hg4BIUxDfKd/A folded before Flop (didn't bet)
Seat 6: ypmjhffk/YHGc51wgVXUTw folded before Flop (didn't bet)




PokerStars Game #59941958944:  Hold'em No Limit ($0.10/$0.25) - 2009/07/01 1:51:36 ET
Table 'YlRA05h9BJ1EhOUSNUjJdg' 9-max Seat #7 is the button
Seat 1: dtZ84flFEi4Q+SGrHMJRDQ ($25 in chips) 
Seat 2: Y2GFAe+PT7xnUUtgqCNDFw ($9.05 in chips) 
Seat 3: Z5ZtGOON8kmSdSCll9Z3XA ($13.20 in chips) 
Seat 4: HPEB+AtKw1+C/cxU0o1ciw ($33.95 in chips) 
Seat 5: sx0lGrkT9fd4yFR+3cXUQg ($11.15 in chips) 
Seat 6: QEbIGci+itdw+re8RM5fZA ($44.40 in chips) 
Seat 7: dfNim92Z6XK1/h5SFW5vDg ($25 in chips) 
Seat 8: dmYlc+1cjwZMJ7wV+Z0rRg ($32.65 in chips) 
Seat 9: GeMoapCKDLc4ajT0Uk9ZQw ($10 in chips) 
dmYlc+1cjwZMJ7wV+Z0rRg: posts small blind $0.10
GeMoapCKDLc4ajT0Uk9ZQw: posts big blind $0.25
*** HOLE CARDS ***
dtZ84flFEi4Q+SGrHMJRDQ: folds 
Y2GFAe+PT7xnUUtgqCNDFw: folds 
Z5ZtGOON8kmSdSCll9Z3XA: folds 
HPEB+AtKw1+C/cxU0o1ciw: folds 
sx0lGrkT9fd4yFR+3cXUQg is disconnected 
sx0lGrkT9fd4yFR+3cXUQg is connected 
sx0lGrkT9fd4yFR+3cXUQg: folds 
QEbIGci+itdw+re8RM5fZA: raises $0.50 to $0.75
dfNim92Z6XK1/h5SFW5vDg: folds 
dmYlc+1cjwZMJ7wV+Z0rRg: folds 
GeMoapCKDLc4ajT0Uk9ZQw: raises $1 to $1.75
QEbIGci+itdw+re8RM5fZA: folds 
Uncalled bet ($1) returned to GeMoapCKDLc4ajT0Uk9ZQw
GeMoapCKDLc4ajT0Uk9ZQw collected $1.60 from pot
*** SUMMARY ***
Total pot $1.60 | Rake $0 
Seat 1: dtZ84flFEi4Q+SGrHMJRDQ folded before Flop (didn't bet)
Seat 2: Y2GFAe+PT7xnUUtgqCNDFw folded before Flop (didn't bet)
Seat 3: Z5ZtGOON8kmSdSCll9Z3XA folded before Flop (didn't bet)
Seat 4: HPEB+AtKw1+C/cxU0o1ciw folded before Flop (didn't bet)
Seat 5: sx0lGrkT9fd4yFR+3cXUQg folded before Flop (didn't bet)
Seat 6: QEbIGci+itdw+re8RM5fZA folded before Flop
Seat 7: dfNim92Z6XK1/h5SFW5vDg (button) folded before Flop (didn't bet)
Seat 8: dmYlc+1cjwZMJ7wV+Z0rRg (small blind) folded before Flop
Seat 9: GeMoapCKDLc4ajT0Uk9ZQw (big blind) collected ($1.60)




PokerStars Game #59941958950:  Hold'em No Limit ($0.10/$0.25) - 2009/07/01 1:51:36 ET
Table 'srBTB98reCdD1TffxE6o7g' 6-max Seat #3 is the button
Seat 1: SFmT9ZsVopnukjvAzrxTRg ($36.55 in chips) 
Seat 2: mfrkWA3PTeYPkbO6hi98Aw ($24.65 in chips) 
Seat 3: VOmI0x4dDPnTESZd5B4d1Q ($42.05 in chips) 
Seat 4: 6DwBRH+xZ12AAZmeAg+aXw ($16.30 in chips) 
Seat 5: K1zv48sQUGQiaLk5VWWDqw ($26.25 in chips) 
Seat 6: BV+K0Phf5VBHr7aZPKqbUQ ($30.75 in chips) 
6DwBRH+xZ12AAZmeAg+aXw: posts small blind $0.10
K1zv48sQUGQiaLk5VWWDqw: posts big blind $0.25
*** HOLE CARDS ***
BV+K0Phf5VBHr7aZPKqbUQ: folds 
SFmT9ZsVopnukjvAzrxTRg: folds 
mfrkWA3PTeYPkbO6hi98Aw: folds 
VOmI0x4dDPnTESZd5B4d1Q: raises $1.25 to $1.50
6DwBRH+xZ12AAZmeAg+aXw: folds 
K1zv48sQUGQiaLk5VWWDqw: folds 
Uncalled bet ($1.25) returned to VOmI0x4dDPnTESZd5B4d1Q
VOmI0x4dDPnTESZd5B4d1Q collected $0.60 from pot
VOmI0x4dDPnTESZd5B4d1Q: doesn't show hand 
*** SUMMARY ***
Total pot $0.60 | Rake $0 
Seat 1: SFmT9ZsVopnukjvAzrxTRg folded before Flop (didn't bet)
Seat 2: mfrkWA3PTeYPkbO6hi98Aw folded before Flop (didn't bet)
Seat 3: VOmI0x4dDPnTESZd5B4d1Q (button) collected ($0.60)
Seat 4: 6DwBRH+xZ12AAZmeAg+aXw (small blind) folded before Flop
Seat 5: K1zv48sQUGQiaLk5VWWDqw (big blind) folded before Flop
Seat 6: BV+K0Phf5VBHr7aZPKqbUQ folded before Flop (didn't bet)




PokerStars Game #59941959656:  Hold'em No Limit ($0.10/$0.25) - 2009/07/01 1:51:37 ET
Table 'Xi38lWH8L2JHRAsKYVX8Qg' 6-max Seat #6 is the button
Seat 1: shP7DFAtX7gXcgMJX/OmRQ ($24.75 in chips) 
Seat 2: VOmI0x4dDPnTESZd5B4d1Q ($8.40 in chips) 
Seat 3: 6DwBRH+xZ12AAZmeAg+aXw ($31.20 in chips) 
Seat 4: kG34n23qFQA3nzdOJTQ1dA ($24.05 in chips) 
Seat 5: 79ID/ub1Pt/mDpCprVmOoA ($76.15 in chips) 
Seat 6: kyRaCIljYA6l33lSKQfNsg ($30.10 in chips) 
shP7DFAtX7gXcgMJX/OmRQ: posts small blind $0.10
VOmI0x4dDPnTESZd5B4d1Q: posts big blind $0.25
*** HOLE CARDS ***
6DwBRH+xZ12AAZmeAg+aXw: folds 
kG34n23qFQA3nzdOJTQ1dA: folds 
79ID/ub1Pt/mDpCprVmOoA: folds 
kyRaCIljYA6l33lSKQfNsg: folds 
shP7DFAtX7gXcgMJX/OmRQ: calls $0.15
VOmI0x4dDPnTESZd5B4d1Q: checks 
*** FLOP *** [9c Ah 6c]
shP7DFAtX7gXcgMJX/OmRQ: checks 
VOmI0x4dDPnTESZd5B4d1Q: checks 
*** TURN *** [9c Ah 6c] [3c]
shP7DFAtX7gXcgMJX/OmRQ: checks 
VOmI0x4dDPnTESZd5B4d1Q: checks 
*** RIVER *** [9c Ah 6c 3c] [Qc]
shP7DFAtX7gXcgMJX/OmRQ: bets $0.50
VOmI0x4dDPnTESZd5B4d1Q: folds 
Uncalled bet ($0.50) returned to shP7DFAtX7gXcgMJX/OmRQ
shP7DFAtX7gXcgMJX/OmRQ collected $0.50 from pot
shP7DFAtX7gXcgMJX/OmRQ: doesn't show hand 
*** SUMMARY ***
Total pot $0.50 | Rake $0 
Board [9c Ah 6c 3c Qc]
Seat 1: shP7DFAtX7gXcgMJX/OmRQ (small blind) collected ($0.50)
Seat 2: VOmI0x4dDPnTESZd5B4d1Q (big blind) folded on the River
Seat 3: 6DwBRH+xZ12AAZmeAg+aXw folded before Flop (didn't bet)
Seat 4: kG34n23qFQA3nzdOJTQ1dA folded before Flop (didn't bet)
Seat 5: 79ID/ub1Pt/mDpCprVmOoA folded before Flop (didn't bet)
Seat 6: kyRaCIljYA6l33lSKQfNsg (button) folded before Flop (didn't bet)




PokerStars Game #59941959426:  Hold'em No Limit ($0.10/$0.25) - 2009/07/01 1:51:37 ET
Table 'nIRjSqm6RYUWJlyW2loYKA' 6-max Seat #6 is the button
Seat 1: w43JQj2oYPpKQVG4Yzlq1w ($25 in chips) 
Seat 2: NndRCAk4vU5JGDhTyy5LZg ($13.95 in chips) 
Seat 3: qjs7u/BI35gu5OgtqfLCZw ($16.20 in chips) 
Seat 4: /ZSSWvl8im2y38j1uEUAGA ($4.50 in chips) 
Seat 5: df01R5ThvHspD8FgKmaDvQ ($24.40 in chips) 
Seat 6: OIjOiBfQstWrK/RuXx7zcw ($6.70 in chips) 
w43JQj2oYPpKQVG4Yzlq1w: posts small blind $0.10
NndRCAk4vU5JGDhTyy5LZg: posts big blind $0.25
*** HOLE CARDS ***
qjs7u/BI35gu5OgtqfLCZw: folds 
/ZSSWvl8im2y38j1uEUAGA: calls $0.25
df01R5ThvHspD8FgKmaDvQ: raises $0.25 to $0.50
OIjOiBfQstWrK/RuXx7zcw: folds 
w43JQj2oYPpKQVG4Yzlq1w: folds 
NndRCAk4vU5JGDhTyy5LZg: calls $0.25
/ZSSWvl8im2y38j1uEUAGA: raises $1 to $1.50
df01R5ThvHspD8FgKmaDvQ: calls $1
NndRCAk4vU5JGDhTyy5LZg: calls $1
*** FLOP *** [Qd 7s As]
NndRCAk4vU5JGDhTyy5LZg: checks 
/ZSSWvl8im2y38j1uEUAGA: checks 
df01R5ThvHspD8FgKmaDvQ: checks 
*** TURN *** [Qd 7s As] [6h]
NndRCAk4vU5JGDhTyy5LZg: checks 
/ZSSWvl8im2y38j1uEUAGA: checks 
df01R5ThvHspD8FgKmaDvQ: checks 
*** RIVER *** [Qd 7s As 6h] [5c]
NndRCAk4vU5JGDhTyy5LZg: bets $0.75
/ZSSWvl8im2y38j1uEUAGA: raises $2.25 to $3 and is all-in
df01R5ThvHspD8FgKmaDvQ: folds 
NndRCAk4vU5JGDhTyy5LZg: folds 
Uncalled bet ($2.25) returned to /ZSSWvl8im2y38j1uEUAGA
/ZSSWvl8im2y38j1uEUAGA collected $5.85 from pot
*** SUMMARY ***
Total pot $6.10 | Rake $0.25 
Board [Qd 7s As 6h 5c]
Seat 1: w43JQj2oYPpKQVG4Yzlq1w (small blind) folded before Flop
Seat 2: NndRCAk4vU5JGDhTyy5LZg (big blind) folded on the River
Seat 3: qjs7u/BI35gu5OgtqfLCZw folded before Flop (didn't bet)
Seat 4: /ZSSWvl8im2y38j1uEUAGA collected ($5.85)
Seat 5: df01R5ThvHspD8FgKmaDvQ folded on the River
Seat 6: OIjOiBfQstWrK/RuXx7zcw (button) folded before Flop (didn't bet)




PokerStars Game #59941959634:  Hold'em No Limit ($0.10/$0.25) - 2009/07/01 1:51:37 ET
Table '0w9m+UkNlGMNoPyQqzWk6A' 9-max Seat #7 is the button
Seat 3: VWwtMkIjXloiX/RKh7RGWQ ($10.05 in chips) 
Seat 5: HPEB+AtKw1+C/cxU0o1ciw ($46.55 in chips) 
Seat 6: CgIo2ItZqi4o3ayVG6HanQ ($26.95 in chips) 
Seat 7: 57qrNGHDvf6GhB8zVLsAtQ ($4.10 in chips) 
Seat 8: cZ99hugmLBj9KhTlc8nCSw ($25 in chips) 
Seat 9: KqS/lY/fNB9qUxokm9QfeA ($13.50 in chips) 
cZ99hugmLBj9KhTlc8nCSw: posts small blind $0.10
KqS/lY/fNB9qUxokm9QfeA: posts big blind $0.25
18G4P1XstjNvItdGUITxgw: sits out 
M1nKET7WOTLbVPuAbJa3EA: sits out 
z5GxcHlYz/GSz6W2uFiTtg: sits out 
*** HOLE CARDS ***
VWwtMkIjXloiX/RKh7RGWQ: folds 
HPEB+AtKw1+C/cxU0o1ciw: folds 
CgIo2ItZqi4o3ayVG6HanQ: folds 
57qrNGHDvf6GhB8zVLsAtQ: folds 
cZ99hugmLBj9KhTlc8nCSw: folds 
Uncalled bet ($0.15) returned to KqS/lY/fNB9qUxokm9QfeA
KqS/lY/fNB9qUxokm9QfeA collected $0.20 from pot
*** SUMMARY ***
Total pot $0.20 | Rake $0 
Seat 3: VWwtMkIjXloiX/RKh7RGWQ folded before Flop (didn't bet)
Seat 5: HPEB+AtKw1+C/cxU0o1ciw folded before Flop (didn't bet)
Seat 6: CgIo2ItZqi4o3ayVG6HanQ folded before Flop (didn't bet)
Seat 7: 57qrNGHDvf6GhB8zVLsAtQ (button) folded before Flop (didn't bet)
Seat 8: cZ99hugmLBj9KhTlc8nCSw (small blind) folded before Flop
Seat 9: KqS/lY/fNB9qUxokm9QfeA (big blind) collected ($0.20)




PokerStars Game #59941959570:  Hold'em No Limit ($0.10/$0.25) - 2009/07/01 1:51:37 ET
Table 'tErGGDyESv/0llKumVeZuQ' 9-max Seat #2 is the button
Seat 1: 3PmVnC/15cl4oyI1TKIt4g ($4.75 in chips) 
Seat 2: pN3IHvAKm2fz+sTRARTcrg ($28.35 in chips) 
Seat 3: qwr38jl5txoR36M7G5qi4A ($10 in chips) 
Seat 4: yqkowiRWZ6NvRN9UUkYIlA ($5 in chips) 
Seat 5: 6RQUxA3jk+ePxB/+Hc0IKw ($17.35 in chips) 
Seat 6: zDrucyjVn5aeekNEc3cJrA ($59.60 in chips) 
Seat 7: uhrboV251dcgYniYTdFIcA ($25 in chips) 
Seat 8: clJsV3v77RS07bDKY+705w ($5 in chips) 
Seat 9: d6n762oPkegG086ZJyV5MA ($27.50 in chips) 
qwr38jl5txoR36M7G5qi4A: posts small blind $0.10
yqkowiRWZ6NvRN9UUkYIlA: posts big blind $0.25
*** HOLE CARDS ***
6RQUxA3jk+ePxB/+Hc0IKw: calls $0.25
zDrucyjVn5aeekNEc3cJrA: folds 
uhrboV251dcgYniYTdFIcA: folds 
clJsV3v77RS07bDKY+705w: folds 
d6n762oPkegG086ZJyV5MA: folds 
3PmVnC/15cl4oyI1TKIt4g: folds 
pN3IHvAKm2fz+sTRARTcrg: folds 
qwr38jl5txoR36M7G5qi4A: calls $0.15
yqkowiRWZ6NvRN9UUkYIlA: checks 
*** FLOP *** [8d Qh 7d]
qwr38jl5txoR36M7G5qi4A: bets $0.75
yqkowiRWZ6NvRN9UUkYIlA: folds 
6RQUxA3jk+ePxB/+Hc0IKw: folds 
Uncalled bet ($0.75) returned to qwr38jl5txoR36M7G5qi4A
qwr38jl5txoR36M7G5qi4A collected $0.75 from pot
qwr38jl5txoR36M7G5qi4A: doesn't show hand 
*** SUMMARY ***
Total pot $0.75 | Rake $0 
Board [8d Qh 7d]
Seat 1: 3PmVnC/15cl4oyI1TKIt4g folded before Flop (didn't bet)
Seat 2: pN3IHvAKm2fz+sTRARTcrg (button) folded before Flop (didn't bet)
Seat 3: qwr38jl5txoR36M7G5qi4A (small blind) collected ($0.75)
Seat 4: yqkowiRWZ6NvRN9UUkYIlA (big blind) folded on the Flop
Seat 5: 6RQUxA3jk+ePxB/+Hc0IKw folded on the Flop
Seat 6: zDrucyjVn5aeekNEc3cJrA folded before Flop (didn't bet)
Seat 7: uhrboV251dcgYniYTdFIcA folded before Flop (didn't bet)
Seat 8: clJsV3v77RS07bDKY+705w folded before Flop (didn't bet)
Seat 9: d6n762oPkegG086ZJyV5MA folded before Flop (didn't bet)




PokerStars Game #59941959632:  Hold'em No Limit ($0.10/$0.25) - 2009/07/01 1:51:37 ET
Table '9o8Yb3JpUqurD4pNVmOikQ' 6-max Seat #5 is the button
Seat 1: SFmT9ZsVopnukjvAzrxTRg ($25.30 in chips) 
Seat 2: /gJNBeCkWL4o85/jvlZ4BA ($26.50 in chips) 
Seat 3: JgRqo1/2phbf7pab7N3BIQ ($21.75 in chips) 
Seat 5: QqiZLFrN8iOUT/GHw7ztOA ($23.95 in chips) 
Seat 6: LyDHtw3/yniNHW+DvLXbog ($28.90 in chips) 
LyDHtw3/yniNHW+DvLXbog: posts small blind $0.10
SFmT9ZsVopnukjvAzrxTRg: posts big blind $0.25
AyreonChen: sits out 
*** HOLE CARDS ***
/gJNBeCkWL4o85/jvlZ4BA: folds 
JgRqo1/2phbf7pab7N3BIQ: folds 
QqiZLFrN8iOUT/GHw7ztOA: folds 
LyDHtw3/yniNHW+DvLXbog: folds 
Uncalled bet ($0.15) returned to SFmT9ZsVopnukjvAzrxTRg
SFmT9ZsVopnukjvAzrxTRg collected $0.20 from pot
SFmT9ZsVopnukjvAzrxTRg: doesn't show hand 
*** SUMMARY ***
Total pot $0.20 | Rake $0 
Seat 1: SFmT9ZsVopnukjvAzrxTRg (big blind) collected ($0.20)
Seat 2: /gJNBeCkWL4o85/jvlZ4BA folded before Flop (didn't bet)
Seat 3: JgRqo1/2phbf7pab7N3BIQ folded before Flop (didn't bet)
Seat 5: QqiZLFrN8iOUT/GHw7ztOA (button) folded before Flop (didn't bet)
Seat 6: LyDHtw3/yniNHW+DvLXbog (small blind) folded before Flop




PokerStars Game #59941960046:  Hold'em No Limit ($0.10/$0.25) - 2009/07/01 1:51:38 ET
Table '5VWnrlxdjwVfMWkVS2WE7A' 6-max Seat #6 is the button
Seat 1: 82p+w3EmUaFFHuwpSeGY1w ($13.35 in chips) 
Seat 2: LJI7A1YgDM7hgh7o56+ReQ ($44.10 in chips) 
Seat 3: SFmT9ZsVopnukjvAzrxTRg ($37.70 in chips) 
Seat 5: 32YL2ZEp8NT4JB2RVM9euQ ($15.50 in chips) 
Seat 6: LtASJ9OlkqGrrUKGQlpGAw ($24.65 in chips) 
82p+w3EmUaFFHuwpSeGY1w: posts small blind $0.10
LJI7A1YgDM7hgh7o56+ReQ: posts big blind $0.25
eHsmIvAb2JREg4O6hNPnXg: sits out 
*** HOLE CARDS ***
SFmT9ZsVopnukjvAzrxTRg: folds 
SFmT9ZsVopnukjvAzrxTRg leaves the table
32YL2ZEp8NT4JB2RVM9euQ: folds 
LtASJ9OlkqGrrUKGQlpGAw: folds 
82p+w3EmUaFFHuwpSeGY1w: raises $0.25 to $0.50
LJI7A1YgDM7hgh7o56+ReQ: raises $1.50 to $2
82p+w3EmUaFFHuwpSeGY1w: calls $1.50
*** FLOP *** [6h 2d 6d]
82p+w3EmUaFFHuwpSeGY1w: checks 
LJI7A1YgDM7hgh7o56+ReQ: checks 
*** TURN *** [6h 2d 6d] [Ad]
82p+w3EmUaFFHuwpSeGY1w: checks 
LJI7A1YgDM7hgh7o56+ReQ: checks 
*** RIVER *** [6h 2d 6d Ad] [7s]
82p+w3EmUaFFHuwpSeGY1w: checks 
z1xdRIff40SSVI/g56tgiw joins the table at seat #3 
LJI7A1YgDM7hgh7o56+ReQ: checks 
*** SHOW DOWN ***
82p+w3EmUaFFHuwpSeGY1w: shows [Jd Jc] (two pair, Jacks and Sixes)
LJI7A1YgDM7hgh7o56+ReQ: mucks hand 
82p+w3EmUaFFHuwpSeGY1w collected $3.80 from pot
*** SUMMARY ***
Total pot $4 | Rake $0.20 
Board [6h 2d 6d Ad 7s]
Seat 1: 82p+w3EmUaFFHuwpSeGY1w (small blind) showed [Jd Jc] and won ($3.80) with two pair, Jacks and Sixes
Seat 2: LJI7A1YgDM7hgh7o56+ReQ (big blind) mucked
Seat 3: SFmT9ZsVopnukjvAzrxTRg folded before Flop (didn't bet)
Seat 5: 32YL2ZEp8NT4JB2RVM9euQ folded before Flop (didn't bet)
Seat 6: LtASJ9OlkqGrrUKGQlpGAw (button) folded before Flop (didn't bet)




PokerStars Game #59941959860:  Hold'em No Limit ($0.10/$0.25) - 2009/07/01 1:51:38 ET
Table 'zKwHJD0cmKNUure9qQTfFg' 6-max Seat #6 is the button
Seat 1: Hzrn9DZJegEZICufTNYkrg ($16.25 in chips) 
Seat 2: xrf8tAXKQHG99HixCot1Iw ($31.55 in chips) 
Seat 3: m9aw7LBAB5YX2ZqMtMkhqA ($19.45 in chips) 
Seat 4: v+QfkGiuj9bgtuNoVnDO8w ($25 in chips) 
Seat 6: edio/rLJ06xeZOfLhoL3UA ($5.75 in chips) 
Hzrn9DZJegEZICufTNYkrg: posts small blind $0.10
xrf8tAXKQHG99HixCot1Iw: posts big blind $0.25
yoelik: sits out 
*** HOLE CARDS ***
m9aw7LBAB5YX2ZqMtMkhqA: folds 
v+QfkGiuj9bgtuNoVnDO8w: raises $0.75 to $1
edio/rLJ06xeZOfLhoL3UA: folds 
Hzrn9DZJegEZICufTNYkrg: calls $0.90
xrf8tAXKQHG99HixCot1Iw: folds 
*** FLOP *** [9d 4h As]
Hzrn9DZJegEZICufTNYkrg: checks 
v+QfkGiuj9bgtuNoVnDO8w: bets $1.50
Hzrn9DZJegEZICufTNYkrg: calls $1.50
*** TURN *** [9d 4h As] [6h]
Hzrn9DZJegEZICufTNYkrg: checks 
v+QfkGiuj9bgtuNoVnDO8w: bets $3.50
Hzrn9DZJegEZICufTNYkrg: calls $3.50
*** RIVER *** [9d 4h As 6h] [Qc]
Hzrn9DZJegEZICufTNYkrg: checks 
v+QfkGiuj9bgtuNoVnDO8w: bets $7.50
Hzrn9DZJegEZICufTNYkrg: calls $7.50
*** SHOW DOWN ***
v+QfkGiuj9bgtuNoVnDO8w: shows [Kc Ac] (a pair of Aces)
Hzrn9DZJegEZICufTNYkrg: mucks hand 
v+QfkGiuj9bgtuNoVnDO8w collected $25.95 from pot
*** SUMMARY ***
Total pot $27.25 | Rake $1.30 
Board [9d 4h As 6h Qc]
Seat 1: Hzrn9DZJegEZICufTNYkrg (small blind) mucked
Seat 2: xrf8tAXKQHG99HixCot1Iw (big blind) folded before Flop
Seat 3: m9aw7LBAB5YX2ZqMtMkhqA folded before Flop (didn't bet)
Seat 4: v+QfkGiuj9bgtuNoVnDO8w showed [Kc Ac] and won ($25.95) with a pair of Aces
Seat 6: edio/rLJ06xeZOfLhoL3UA (button) folded before Flop (didn't bet)




PokerStars Game #59941959910:  Hold'em No Limit ($0.10/$0.25) - 2009/07/01 1:51:38 ET
Table 'VuY5ej47Cy8nOI3Wogmhzw' 6-max Seat #4 is the button
Seat 1: EeUZtMU058v2ObUACOF4Og ($28.35 in chips) 
Seat 3: v+QfkGiuj9bgtuNoVnDO8w ($41.70 in chips) 
Seat 4: QqiZLFrN8iOUT/GHw7ztOA ($45.05 in chips) 
Seat 5: m2yWOKfAxqHoy5DDN87Ttw ($26 in chips) 
Seat 6: +KblIivb6tainScpwm14RQ ($10.95 in chips) 
m2yWOKfAxqHoy5DDN87Ttw: posts small blind $0.10
+KblIivb6tainScpwm14RQ: posts big blind $0.25
*** HOLE CARDS ***
EeUZtMU058v2ObUACOF4Og: raises $0.75 to $1
v+QfkGiuj9bgtuNoVnDO8w: folds 
QqiZLFrN8iOUT/GHw7ztOA: folds 
m2yWOKfAxqHoy5DDN87Ttw: calls $0.90
+KblIivb6tainScpwm14RQ: folds 
*** FLOP *** [Ah 6h 5s]
m2yWOKfAxqHoy5DDN87Ttw: checks 
EeUZtMU058v2ObUACOF4Og: bets $2
m2yWOKfAxqHoy5DDN87Ttw: folds 
Uncalled bet ($2) returned to EeUZtMU058v2ObUACOF4Og
EeUZtMU058v2ObUACOF4Og collected $2.15 from pot
EeUZtMU058v2ObUACOF4Og: doesn't show hand 
*** SUMMARY ***
Total pot $2.25 | Rake $0.10 
Board [Ah 6h 5s]
Seat 1: EeUZtMU058v2ObUACOF4Og collected ($2.15)
Seat 3: v+QfkGiuj9bgtuNoVnDO8w folded before Flop (didn't bet)
Seat 4: QqiZLFrN8iOUT/GHw7ztOA (button) folded before Flop (didn't bet)
Seat 5: m2yWOKfAxqHoy5DDN87Ttw (small blind) folded on the Flop
Seat 6: +KblIivb6tainScpwm14RQ (big blind) folded before Flop




PokerStars Game #59941960108:  Hold'em No Limit ($0.10/$0.25) - 2009/07/01 1:51:38 ET
Table 'luMgmRPIo47e7iXDlheIwA' 6-max Seat #6 is the button
Seat 1: EQ3WxdGe/KZrM6Lx4T02sg ($37.40 in chips) 
Seat 2: NhUN/JpAprdJeamFBgJH1w ($25 in chips) 
Seat 3: w43JQj2oYPpKQVG4Yzlq1w ($31.60 in chips) 
Seat 4: xrf8tAXKQHG99HixCot1Iw ($25.90 in chips) 
Seat 5: cWc85bEzdRzpUMhRKm8pwQ ($44.90 in chips) 
Seat 6: qGHGf/553gQnDoklMRe3tg ($24.20 in chips) 
EQ3WxdGe/KZrM6Lx4T02sg: posts small blind $0.10
NhUN/JpAprdJeamFBgJH1w: posts big blind $0.25
*** HOLE CARDS ***
w43JQj2oYPpKQVG4Yzlq1w: calls $0.25
xrf8tAXKQHG99HixCot1Iw: folds 
cWc85bEzdRzpUMhRKm8pwQ: folds 
qGHGf/553gQnDoklMRe3tg: calls $0.25
EQ3WxdGe/KZrM6Lx4T02sg: folds 
NhUN/JpAprdJeamFBgJH1w: checks 
*** FLOP *** [8d 3s 5d]
NhUN/JpAprdJeamFBgJH1w: checks 
w43JQj2oYPpKQVG4Yzlq1w: checks 
qGHGf/553gQnDoklMRe3tg: bets $0.75
NhUN/JpAprdJeamFBgJH1w: folds 
w43JQj2oYPpKQVG4Yzlq1w: calls $0.75
*** TURN *** [8d 3s 5d] [3h]
w43JQj2oYPpKQVG4Yzlq1w: checks 
qGHGf/553gQnDoklMRe3tg: checks 
*** RIVER *** [8d 3s 5d 3h] [Kd]
w43JQj2oYPpKQVG4Yzlq1w: bets $1.50
qGHGf/553gQnDoklMRe3tg: calls $1.50
*** SHOW DOWN ***
w43JQj2oYPpKQVG4Yzlq1w: shows [6h 6c] (two pair, Sixes and Threes)
qGHGf/553gQnDoklMRe3tg: shows [6d 9d] (a flush, King high)
qGHGf/553gQnDoklMRe3tg collected $5.10 from pot
*** SUMMARY ***
Total pot $5.35 | Rake $0.25 
Board [8d 3s 5d 3h Kd]
Seat 1: EQ3WxdGe/KZrM6Lx4T02sg (small blind) folded before Flop
Seat 2: NhUN/JpAprdJeamFBgJH1w (big blind) folded on the Flop
Seat 3: w43JQj2oYPpKQVG4Yzlq1w showed [6h 6c] and lost with two pair, Sixes and Threes
Seat 4: xrf8tAXKQHG99HixCot1Iw folded before Flop (didn't bet)
Seat 5: cWc85bEzdRzpUMhRKm8pwQ folded before Flop (didn't bet)
Seat 6: qGHGf/553gQnDoklMRe3tg (button) showed [6d 9d] and won ($5.10) with a flush, King high




PokerStars Game #59941959994:  Hold'em No Limit ($0.10/$0.25) - 2009/07/01 1:51:38 ET
Table 'IuqVbFI+pwnJjvwBCGSGAw' 6-max Seat #2 is the button
Seat 1: LyDHtw3/yniNHW+DvLXbog ($27.75 in chips) 
Seat 2: w43JQj2oYPpKQVG4Yzlq1w ($25 in chips) 
Seat 3: QiL+lEgEWwy21jk/ltaRLg ($24.10 in chips) 
Seat 4: DE9hRlt14g+JdsRQ4wT7hg ($25 in chips) 
Seat 5: if4dh6jhJXeN3/qd3qCp9g ($25 in chips) 
Seat 6: xC0kaiDYM6YTlgODL83O5A ($12.80 in chips) 
QiL+lEgEWwy21jk/ltaRLg: posts small blind $0.10
DE9hRlt14g+JdsRQ4wT7hg: posts big blind $0.25
*** HOLE CARDS ***
if4dh6jhJXeN3/qd3qCp9g: folds 
xC0kaiDYM6YTlgODL83O5A: folds 
LyDHtw3/yniNHW+DvLXbog: folds 
w43JQj2oYPpKQVG4Yzlq1w: folds 
QiL+lEgEWwy21jk/ltaRLg: raises $0.50 to $0.75
DE9hRlt14g+JdsRQ4wT7hg: folds 
Uncalled bet ($0.50) returned to QiL+lEgEWwy21jk/ltaRLg
QiL+lEgEWwy21jk/ltaRLg collected $0.50 from pot
if4dh6jhJXeN3/qd3qCp9g leaves the table
*** SUMMARY ***
Total pot $0.50 | Rake $0 
Seat 1: LyDHtw3/yniNHW+DvLXbog folded before Flop (didn't bet)
Seat 2: w43JQj2oYPpKQVG4Yzlq1w (button) folded before Flop (didn't bet)
Seat 3: QiL+lEgEWwy21jk/ltaRLg (small blind) collected ($0.50)
Seat 4: DE9hRlt14g+JdsRQ4wT7hg (big blind) folded before Flop
Seat 5: if4dh6jhJXeN3/qd3qCp9g folded before Flop (didn't bet)
Seat 6: xC0kaiDYM6YTlgODL83O5A folded before Flop (didn't bet)




PokerStars Game #59941959908:  Hold'em No Limit ($0.10/$0.25) - 2009/07/01 1:51:38 ET
Table '9lYs7ljXi6AgFAxYHlKLJw' 9-max Seat #4 is the button
Seat 1: K0b5wNInj6hUGRr6yzKFtw ($36.65 in chips) 
Seat 2: 0XACOSNrAWmqNv9k1nF8rw ($15.35 in chips) 
Seat 3: arxNSjreDRGFg13EAM2F1w ($37.45 in chips) 
Seat 4: UANt6y/SmDCY/jIxkBixcw ($32.65 in chips) 
Seat 5: dfNim92Z6XK1/h5SFW5vDg ($58.95 in chips) 
Seat 7: ghNKXUBl/H+t83JF079ZBA ($28.75 in chips) 
Seat 8: 9YN2IkT2JYYKFErZtZvCtA ($18.60 in chips) 
dfNim92Z6XK1/h5SFW5vDg: posts small blind $0.10
tYsOBqdU1+x+yFI7zHO7hQ: is sitting out 
ghNKXUBl/H+t83JF079ZBA: posts big blind $0.25
IVL33RWimYC8hA5O8TO69Q: sits out 
*** HOLE CARDS ***
tYsOBqdU1+x+yFI7zHO7hQ leaves the table
9YN2IkT2JYYKFErZtZvCtA: folds 
K0b5wNInj6hUGRr6yzKFtw: folds 
0XACOSNrAWmqNv9k1nF8rw: calls $0.25
arxNSjreDRGFg13EAM2F1w: folds 
UANt6y/SmDCY/jIxkBixcw: raises $0.50 to $0.75
dfNim92Z6XK1/h5SFW5vDg: folds 
ghNKXUBl/H+t83JF079ZBA: folds 
0XACOSNrAWmqNv9k1nF8rw: calls $0.50
*** FLOP *** [8d 8h 4c]
0XACOSNrAWmqNv9k1nF8rw: checks 
j4q3p0lesp63b1gZDwLBZw joins the table at seat #6 
UANt6y/SmDCY/jIxkBixcw: bets $1
0XACOSNrAWmqNv9k1nF8rw: folds 
Uncalled bet ($1) returned to UANt6y/SmDCY/jIxkBixcw
UANt6y/SmDCY/jIxkBixcw collected $1.80 from pot
*** SUMMARY ***
Total pot $1.85 | Rake $0.05 
Board [8d 8h 4c]
Seat 1: K0b5wNInj6hUGRr6yzKFtw folded before Flop (didn't bet)
Seat 2: 0XACOSNrAWmqNv9k1nF8rw folded on the Flop
Seat 3: arxNSjreDRGFg13EAM2F1w folded before Flop (didn't bet)
Seat 4: UANt6y/SmDCY/jIxkBixcw (button) collected ($1.80)
Seat 5: dfNim92Z6XK1/h5SFW5vDg (small blind) folded before Flop
Seat 7: ghNKXUBl/H+t83JF079ZBA (big blind) folded before Flop
Seat 8: 9YN2IkT2JYYKFErZtZvCtA folded before Flop (didn't bet)




PokerStars Game #59941960480:  Hold'em No Limit ($0.10/$0.25) - 2009/07/01 1:51:39 ET
Table 'NgexmgEDEzICBeSO7YCrKQ' 6-max Seat #5 is the button
Seat 1: cezpHJ8FB07dj0xG+LhOvw ($28.55 in chips) 
Seat 2: 32YL2ZEp8NT4JB2RVM9euQ ($23.55 in chips) 
Seat 3: JFIAqU8lCZ0vWwEl4bdGsg ($27.20 in chips) 
Seat 4: xx+iYCDJhHJmNzrfeloyEg ($21.70 in chips) 
Seat 5: /MXkdT8TTs8Qp2LVTQNw6w ($41.45 in chips) 
Seat 6: k9nHZTHt8hYhYRcW8NTb4g ($11.90 in chips) 
k9nHZTHt8hYhYRcW8NTb4g: posts small blind $0.10
cezpHJ8FB07dj0xG+LhOvw: posts big blind $0.25
*** HOLE CARDS ***
32YL2ZEp8NT4JB2RVM9euQ: raises $0.75 to $1
JFIAqU8lCZ0vWwEl4bdGsg: folds 
xx+iYCDJhHJmNzrfeloyEg: calls $1
/MXkdT8TTs8Qp2LVTQNw6w: folds 
/MXkdT8TTs8Qp2LVTQNw6w said, "i'd say you might be right"
k9nHZTHt8hYhYRcW8NTb4g: folds 
cezpHJ8FB07dj0xG+LhOvw: folds 
*** FLOP *** [Ah 8d As]
32YL2ZEp8NT4JB2RVM9euQ: bets $1.25
xx+iYCDJhHJmNzrfeloyEg: raises $2.75 to $4
32YL2ZEp8NT4JB2RVM9euQ: folds 
Uncalled bet ($2.75) returned to xx+iYCDJhHJmNzrfeloyEg
xx+iYCDJhHJmNzrfeloyEg collected $4.65 from pot
xx+iYCDJhHJmNzrfeloyEg: doesn't show hand 
*** SUMMARY ***
Total pot $4.85 | Rake $0.20 
Board [Ah 8d As]
Seat 1: cezpHJ8FB07dj0xG+LhOvw (big blind) folded before Flop
Seat 2: 32YL2ZEp8NT4JB2RVM9euQ folded on the Flop
Seat 3: JFIAqU8lCZ0vWwEl4bdGsg folded before Flop (didn't bet)
Seat 4: xx+iYCDJhHJmNzrfeloyEg collected ($4.65)
Seat 5: /MXkdT8TTs8Qp2LVTQNw6w (button) folded before Flop (didn't bet)
Seat 6: k9nHZTHt8hYhYRcW8NTb4g (small blind) folded before Flop




PokerStars Game #59941960766:  Hold'em No Limit ($0.10/$0.25) - 2009/07/01 1:51:39 ET
Table 'IdXp6nyeW4FYaEK4qKCnwQ' 9-max Seat #7 is the button
Seat 1: tLcDklc2rBORNfixyRfVfw ($25 in chips) 
Seat 2: HPEB+AtKw1+C/cxU0o1ciw ($30.50 in chips) 
Seat 4: j4q3p0lesp63b1gZDwLBZw ($5 in chips) 
Seat 5: nAWaA+gDUSWOad+I9mKUEg ($8.40 in chips) 
Seat 6: arxNSjreDRGFg13EAM2F1w ($30.85 in chips) 
Seat 7: w1ukf8uPa4+WH561TtVRxA ($36.90 in chips) 
Seat 8: dtZ84flFEi4Q+SGrHMJRDQ ($29.50 in chips) 
Seat 9: s2xLPOl/vhl/26apJ3vsOQ ($29.60 in chips) 
dtZ84flFEi4Q+SGrHMJRDQ: posts small blind $0.10
s2xLPOl/vhl/26apJ3vsOQ: posts big blind $0.25
JqeaikMej6KsqTKmUhl2Lw: sits out 
*** HOLE CARDS ***
tLcDklc2rBORNfixyRfVfw: folds 
HPEB+AtKw1+C/cxU0o1ciw: folds 
j4q3p0lesp63b1gZDwLBZw: folds 
nAWaA+gDUSWOad+I9mKUEg: calls $0.25
arxNSjreDRGFg13EAM2F1w: folds 
w1ukf8uPa4+WH561TtVRxA: folds 
dtZ84flFEi4Q+SGrHMJRDQ: folds 
s2xLPOl/vhl/26apJ3vsOQ: checks 
*** FLOP *** [7s Qd Ts]
s2xLPOl/vhl/26apJ3vsOQ: checks 
nAWaA+gDUSWOad+I9mKUEg: bets $0.50
s2xLPOl/vhl/26apJ3vsOQ: calls $0.50
*** TURN *** [7s Qd Ts] [Kc]
s2xLPOl/vhl/26apJ3vsOQ: checks 
nAWaA+gDUSWOad+I9mKUEg: bets $1
s2xLPOl/vhl/26apJ3vsOQ: folds 
Uncalled bet ($1) returned to nAWaA+gDUSWOad+I9mKUEg
nAWaA+gDUSWOad+I9mKUEg collected $1.55 from pot
nAWaA+gDUSWOad+I9mKUEg: doesn't show hand 
*** SUMMARY ***
Total pot $1.60 | Rake $0.05 
Board [7s Qd Ts Kc]
Seat 1: tLcDklc2rBORNfixyRfVfw folded before Flop (didn't bet)
Seat 2: HPEB+AtKw1+C/cxU0o1ciw folded before Flop (didn't bet)
Seat 4: j4q3p0lesp63b1gZDwLBZw folded before Flop (didn't bet)
Seat 5: nAWaA+gDUSWOad+I9mKUEg collected ($1.55)
Seat 6: arxNSjreDRGFg13EAM2F1w folded before Flop (didn't bet)
Seat 7: w1ukf8uPa4+WH561TtVRxA (button) folded before Flop (didn't bet)
Seat 8: dtZ84flFEi4Q+SGrHMJRDQ (small blind) folded before Flop
Seat 9: s2xLPOl/vhl/26apJ3vsOQ (big blind) folded on the Turn




PokerStars Game #59941960598:  Hold'em No Limit ($0.10/$0.25) - 2009/07/01 1:51:39 ET
Table 'tq5CvS0RUqGkuBK0XTzqqg' 6-max Seat #1 is the button
Seat 1: +ZlnqPoP3Hg4BIUxDfKd/A ($29.60 in chips) 
Seat 3: VXTONriS+Ohik+r0FeicIw ($25.10 in chips) 
Seat 4: UT5XpwOH1ipkOF7n1MqDJA ($37.45 in chips) 
Seat 5: qGHGf/553gQnDoklMRe3tg ($37.90 in chips) 
Seat 6: QqiZLFrN8iOUT/GHw7ztOA ($24.30 in chips) 
ErIN0JRL5srYjT6en1f8YQ will be allowed to play after the button
VXTONriS+Ohik+r0FeicIw: posts small blind $0.10
UT5XpwOH1ipkOF7n1MqDJA: posts big blind $0.25
*** HOLE CARDS ***
qGHGf/553gQnDoklMRe3tg: raises $0.75 to $1
QqiZLFrN8iOUT/GHw7ztOA: calls $1
+ZlnqPoP3Hg4BIUxDfKd/A: raises $2.75 to $3.75
VXTONriS+Ohik+r0FeicIw: folds 
UT5XpwOH1ipkOF7n1MqDJA: folds 
qGHGf/553gQnDoklMRe3tg: folds 
QqiZLFrN8iOUT/GHw7ztOA: folds 
Uncalled bet ($2.75) returned to +ZlnqPoP3Hg4BIUxDfKd/A
+ZlnqPoP3Hg4BIUxDfKd/A collected $3.35 from pot
+ZlnqPoP3Hg4BIUxDfKd/A: doesn't show hand 
*** SUMMARY ***
Total pot $3.35 | Rake $0 
Seat 1: +ZlnqPoP3Hg4BIUxDfKd/A (button) collected ($3.35)
Seat 3: VXTONriS+Ohik+r0FeicIw (small blind) folded before Flop
Seat 4: UT5XpwOH1ipkOF7n1MqDJA (big blind) folded before Flop
Seat 5: qGHGf/553gQnDoklMRe3tg folded before Flop
Seat 6: QqiZLFrN8iOUT/GHw7ztOA folded before Flop




PokerStars Game #59941960912:  Hold'em No Limit ($0.10/$0.25) - 2009/07/01 1:51:40 ET
Table 'rjcb+nlE+0GuJ6lBhuCkkA' 6-max Seat #6 is the button
Seat 1: lBoEwOFgzcERLIRUkUoRTw ($12.65 in chips) 
Seat 3: 8ClCHtFXGNplITm+63KB+Q ($65.85 in chips) 
Seat 4: BV+K0Phf5VBHr7aZPKqbUQ ($35.50 in chips) 
Seat 5: GC/9yVD59DUCX7hUI7gcLw ($30.15 in chips) 
Seat 6: 32YL2ZEp8NT4JB2RVM9euQ ($16.05 in chips) 
lBoEwOFgzcERLIRUkUoRTw: posts small blind $0.10
8ClCHtFXGNplITm+63KB+Q: posts big blind $0.25
*** HOLE CARDS ***
BV+K0Phf5VBHr7aZPKqbUQ: folds 
GC/9yVD59DUCX7hUI7gcLw: folds 
32YL2ZEp8NT4JB2RVM9euQ: raises $0.75 to $1
lBoEwOFgzcERLIRUkUoRTw: folds 
8ClCHtFXGNplITm+63KB+Q: folds 
Uncalled bet ($0.75) returned to 32YL2ZEp8NT4JB2RVM9euQ
32YL2ZEp8NT4JB2RVM9euQ collected $0.60 from pot
32YL2ZEp8NT4JB2RVM9euQ: doesn't show hand 
*** SUMMARY ***
Total pot $0.60 | Rake $0 
Seat 1: lBoEwOFgzcERLIRUkUoRTw (small blind) folded before Flop
Seat 3: 8ClCHtFXGNplITm+63KB+Q (big blind) folded before Flop
Seat 4: BV+K0Phf5VBHr7aZPKqbUQ folded before Flop (didn't bet)
Seat 5: GC/9yVD59DUCX7hUI7gcLw folded before Flop (didn't bet)
Seat 6: 32YL2ZEp8NT4JB2RVM9euQ (button) collected ($0.60)




PokerStars Game #59941961024:  Hold'em No Limit ($0.10/$0.25) - 2009/07/01 1:51:40 ET
Table '+VTTYgQLH1awDHk+IAxqGg' 9-max Seat #2 is the button
Seat 1: arxNSjreDRGFg13EAM2F1w ($26.55 in chips) 
Seat 2: 2wcFsZsqEP5w1StUTVzJCg ($6.05 in chips) 
Seat 3: AiXn/9o1EwOPZUHujnh/bA ($11.15 in chips) 
Seat 4: gE5rN2TDY1aXcZn/TOPeZw ($8.90 in chips) 
Seat 5: sD+TKtt36XiiN6jqHiLwDA ($29.15 in chips) 
Seat 6: clJsV3v77RS07bDKY+705w ($6.05 in chips) 
Seat 7: ljemhp25Zg+nlA9DLCIiUw ($25 in chips) 
Seat 8: 10vzP4r6ldwGLbYHKd9www ($18.65 in chips) 
Seat 9: S7Ki0P+0AIGPuIfGJjW0gg ($61.15 in chips) 
AiXn/9o1EwOPZUHujnh/bA: posts small blind $0.10
gE5rN2TDY1aXcZn/TOPeZw: posts big blind $0.25
*** HOLE CARDS ***
sD+TKtt36XiiN6jqHiLwDA: folds 
clJsV3v77RS07bDKY+705w: folds 
ljemhp25Zg+nlA9DLCIiUw: folds 
10vzP4r6ldwGLbYHKd9www: calls $0.25
S7Ki0P+0AIGPuIfGJjW0gg: folds 
arxNSjreDRGFg13EAM2F1w: folds 
2wcFsZsqEP5w1StUTVzJCg: folds 
AiXn/9o1EwOPZUHujnh/bA: folds 
gE5rN2TDY1aXcZn/TOPeZw: checks 
*** FLOP *** [Kh 7h Ts]
gE5rN2TDY1aXcZn/TOPeZw: checks 
10vzP4r6ldwGLbYHKd9www: checks 
*** TURN *** [Kh 7h Ts] [Ah]
gE5rN2TDY1aXcZn/TOPeZw: checks 
10vzP4r6ldwGLbYHKd9www: bets $0.25
gE5rN2TDY1aXcZn/TOPeZw: folds 
Uncalled bet ($0.25) returned to 10vzP4r6ldwGLbYHKd9www
10vzP4r6ldwGLbYHKd9www collected $0.60 from pot
*** SUMMARY ***
Total pot $0.60 | Rake $0 
Board [Kh 7h Ts Ah]
Seat 1: arxNSjreDRGFg13EAM2F1w folded before Flop (didn't bet)
Seat 2: 2wcFsZsqEP5w1StUTVzJCg (button) folded before Flop (didn't bet)
Seat 3: AiXn/9o1EwOPZUHujnh/bA (small blind) folded before Flop
Seat 4: gE5rN2TDY1aXcZn/TOPeZw (big blind) folded on the Turn
Seat 5: sD+TKtt36XiiN6jqHiLwDA folded before Flop (didn't bet)
Seat 6: clJsV3v77RS07bDKY+705w folded before Flop (didn't bet)
Seat 7: ljemhp25Zg+nlA9DLCIiUw folded before Flop (didn't bet)
Seat 8: 10vzP4r6ldwGLbYHKd9www collected ($0.60)
Seat 9: S7Ki0P+0AIGPuIfGJjW0gg folded before Flop (didn't bet)




PokerStars Game #59941960914:  Hold'em No Limit ($0.10/$0.25) - 2009/07/01 1:51:40 ET
Table 'L5GvbdQO5aCZJSE6pyQ8OA' 6-max Seat #4 is the button
Seat 1: eFj4lr1nuXLyCWNTShr1bg ($11.45 in chips) 
Seat 2: DihMHaz4WNETH1bPDe13kA ($30.55 in chips) 
Seat 3: JFIAqU8lCZ0vWwEl4bdGsg ($25.35 in chips) 
Seat 4: trN/oHqTTbPw5MNuKrOpLw ($27.15 in chips) 
Seat 5: LyDHtw3/yniNHW+DvLXbog ($29 in chips) 
Seat 6: v+QfkGiuj9bgtuNoVnDO8w ($38.70 in chips) 
LyDHtw3/yniNHW+DvLXbog: posts small blind $0.10
v+QfkGiuj9bgtuNoVnDO8w: posts big blind $0.25
*** HOLE CARDS ***
eFj4lr1nuXLyCWNTShr1bg: folds 
DihMHaz4WNETH1bPDe13kA: folds 
JFIAqU8lCZ0vWwEl4bdGsg: folds 
trN/oHqTTbPw5MNuKrOpLw: folds 
LyDHtw3/yniNHW+DvLXbog: raises $0.50 to $0.75
v+QfkGiuj9bgtuNoVnDO8w: folds 
Uncalled bet ($0.50) returned to LyDHtw3/yniNHW+DvLXbog
LyDHtw3/yniNHW+DvLXbog collected $0.50 from pot
LyDHtw3/yniNHW+DvLXbog: doesn't show hand 
*** SUMMARY ***
Total pot $0.50 | Rake $0 
Seat 1: eFj4lr1nuXLyCWNTShr1bg folded before Flop (didn't bet)
Seat 2: DihMHaz4WNETH1bPDe13kA folded before Flop (didn't bet)
Seat 3: JFIAqU8lCZ0vWwEl4bdGsg folded before Flop (didn't bet)
Seat 4: trN/oHqTTbPw5MNuKrOpLw (button) folded before Flop (didn't bet)
Seat 5: LyDHtw3/yniNHW+DvLXbog (small blind) collected ($0.50)
Seat 6: v+QfkGiuj9bgtuNoVnDO8w (big blind) folded before Flop




PokerStars Game #59941961268:  Hold'em No Limit ($0.10/$0.25) - 2009/07/01 1:51:40 ET
Table 'g6ryG70feTw9nNm+XJLuXw' 6-max Seat #5 is the button
Seat 1: v+QfkGiuj9bgtuNoVnDO8w ($35.10 in chips) 
Seat 2: SxIIgwXYLkwd6m3wLyPTCw ($33.90 in chips) 
Seat 3: cezpHJ8FB07dj0xG+LhOvw ($25 in chips) 
Seat 4: GC/9yVD59DUCX7hUI7gcLw ($45 in chips) 
Seat 5: EE16Ua5b1HSsYej5zeXOlA ($25 in chips) 
Seat 6: Mhj3q7cxev+XjXZxEE6/Cw ($25.45 in chips) 
Mhj3q7cxev+XjXZxEE6/Cw: posts small blind $0.10
v+QfkGiuj9bgtuNoVnDO8w: posts big blind $0.25
*** HOLE CARDS ***
SxIIgwXYLkwd6m3wLyPTCw: folds 
cezpHJ8FB07dj0xG+LhOvw: folds 
GC/9yVD59DUCX7hUI7gcLw: raises $0.75 to $1
EE16Ua5b1HSsYej5zeXOlA: calls $1
Mhj3q7cxev+XjXZxEE6/Cw: raises $3.50 to $4.50
v+QfkGiuj9bgtuNoVnDO8w: folds 
GC/9yVD59DUCX7hUI7gcLw: folds 
EE16Ua5b1HSsYej5zeXOlA: folds 
Uncalled bet ($3.50) returned to Mhj3q7cxev+XjXZxEE6/Cw
Mhj3q7cxev+XjXZxEE6/Cw collected $3.25 from pot
Mhj3q7cxev+XjXZxEE6/Cw: doesn't show hand 
*** SUMMARY ***
Total pot $3.25 | Rake $0 
Seat 1: v+QfkGiuj9bgtuNoVnDO8w (big blind) folded before Flop
Seat 2: SxIIgwXYLkwd6m3wLyPTCw folded before Flop (didn't bet)
Seat 3: cezpHJ8FB07dj0xG+LhOvw folded before Flop (didn't bet)
Seat 4: GC/9yVD59DUCX7hUI7gcLw folded before Flop
Seat 5: EE16Ua5b1HSsYej5zeXOlA (button) folded before Flop
Seat 6: Mhj3q7cxev+XjXZxEE6/Cw (small blind) collected ($3.25)




PokerStars Game #59941960988:  Hold'em No Limit ($0.10/$0.25) - 2009/07/01 1:51:40 ET
Table 'vFZR6Kf2Th5xBXT9brGW6A' 6-max Seat #6 is the button
Seat 1: Q1uciOZPBR/WkAlqa6cL4A ($27.05 in chips) 
Seat 2: QiL+lEgEWwy21jk/ltaRLg ($20.80 in chips) 
Seat 3: SH1WjKVUjPiyXySjWSdazw ($41.40 in chips) 
Seat 4: 79ID/ub1Pt/mDpCprVmOoA ($34.85 in chips) 
Seat 5: SS/yfeArhULzIcOPe8MdPg ($27.60 in chips) 
Seat 6: 4x9jCqgSw4272dnaIqnanw ($8.05 in chips) 
Q1uciOZPBR/WkAlqa6cL4A: posts small blind $0.10
QiL+lEgEWwy21jk/ltaRLg: posts big blind $0.25
*** HOLE CARDS ***
SH1WjKVUjPiyXySjWSdazw: folds 
79ID/ub1Pt/mDpCprVmOoA: folds 
SH1WjKVUjPiyXySjWSdazw leaves the table
SS/yfeArhULzIcOPe8MdPg: folds 
4x9jCqgSw4272dnaIqnanw: calls $0.25
Q1uciOZPBR/WkAlqa6cL4A: raises $1.25 to $1.50
QiL+lEgEWwy21jk/ltaRLg: folds 
4x9jCqgSw4272dnaIqnanw: folds 
Uncalled bet ($1.25) returned to Q1uciOZPBR/WkAlqa6cL4A
Q1uciOZPBR/WkAlqa6cL4A collected $0.75 from pot
Q1uciOZPBR/WkAlqa6cL4A: doesn't show hand 
*** SUMMARY ***
Total pot $0.75 | Rake $0 
Seat 1: Q1uciOZPBR/WkAlqa6cL4A (small blind) collected ($0.75)
Seat 2: QiL+lEgEWwy21jk/ltaRLg (big blind) folded before Flop
Seat 3: SH1WjKVUjPiyXySjWSdazw folded before Flop (didn't bet)
Seat 4: 79ID/ub1Pt/mDpCprVmOoA folded before Flop (didn't bet)
Seat 5: SS/yfeArhULzIcOPe8MdPg folded before Flop (didn't bet)
Seat 6: 4x9jCqgSw4272dnaIqnanw (button) folded before Flop




PokerStars Game #59941961076:  Hold'em No Limit ($0.10/$0.25) - 2009/07/01 1:51:40 ET
Table '972HGIb0tQN/zRIK4TABEw' 9-max Seat #4 is the button
Seat 1: fHr2+mGa0RFK3qrpZcVUAQ ($13.15 in chips) 
Seat 4: aSrj4lVmn2owyQ1RbbOqxQ ($4.85 in chips) 
Seat 5: n+stbTneifqFNME+tpoGrw ($25 in chips) 
n+stbTneifqFNME+tpoGrw: posts small blind $0.10
fHr2+mGa0RFK3qrpZcVUAQ: posts big blind $0.25
*** HOLE CARDS ***
aSrj4lVmn2owyQ1RbbOqxQ: calls $0.25
n+stbTneifqFNME+tpoGrw: raises $1 to $1.25
fHr2+mGa0RFK3qrpZcVUAQ: calls $1
aSrj4lVmn2owyQ1RbbOqxQ: folds 
*** FLOP *** [Qs Tc Jc]
n+stbTneifqFNME+tpoGrw: bets $1.25
fHr2+mGa0RFK3qrpZcVUAQ: folds 
Uncalled bet ($1.25) returned to n+stbTneifqFNME+tpoGrw
n+stbTneifqFNME+tpoGrw collected $2.65 from pot
n+stbTneifqFNME+tpoGrw: doesn't show hand 
*** SUMMARY ***
Total pot $2.75 | Rake $0.10 
Board [Qs Tc Jc]
Seat 1: fHr2+mGa0RFK3qrpZcVUAQ (big blind) folded on the Flop
Seat 4: aSrj4lVmn2owyQ1RbbOqxQ (button) folded before Flop
Seat 5: n+stbTneifqFNME+tpoGrw (small blind) collected ($2.65)




PokerStars Game #59941961606:  Hold'em No Limit ($0.10/$0.25) - 2009/07/01 1:51:41 ET
Table 'l57rayEpPtZotP9nqgSWBg' 6-max Seat #1 is the button
Seat 1: DihMHaz4WNETH1bPDe13kA ($56.50 in chips) 
Seat 2: p6adJRMXMBLr+xtQzqazIQ ($14.80 in chips) 
Seat 3: xC0kaiDYM6YTlgODL83O5A ($25.10 in chips) 
Seat 4: OqkdGXy1SCzuN5Q0wNlFSg ($22.10 in chips) 
Seat 5: WKJHaZPUgrpTVyLOEjLYmg ($11.85 in chips) 
Seat 6: IGRfskE1v9H9Bn+fz8AgNQ ($15.55 in chips) 
p6adJRMXMBLr+xtQzqazIQ: posts small blind $0.10
xC0kaiDYM6YTlgODL83O5A: posts big blind $0.25
*** HOLE CARDS ***
OqkdGXy1SCzuN5Q0wNlFSg: folds 
OqkdGXy1SCzuN5Q0wNlFSg leaves the table
WKJHaZPUgrpTVyLOEjLYmg: raises $0.75 to $1
IGRfskE1v9H9Bn+fz8AgNQ: folds 
ErIN0JRL5srYjT6en1f8YQ joins the table at seat #4 
DihMHaz4WNETH1bPDe13kA: folds 
p6adJRMXMBLr+xtQzqazIQ: raises $13.80 to $14.80 and is all-in
xC0kaiDYM6YTlgODL83O5A: folds 
WKJHaZPUgrpTVyLOEjLYmg: folds 
Uncalled bet ($13.80) returned to p6adJRMXMBLr+xtQzqazIQ
p6adJRMXMBLr+xtQzqazIQ collected $2.25 from pot
p6adJRMXMBLr+xtQzqazIQ: doesn't show hand 
*** SUMMARY ***
Total pot $2.25 | Rake $0 
Seat 1: DihMHaz4WNETH1bPDe13kA (button) folded before Flop (didn't bet)
Seat 2: p6adJRMXMBLr+xtQzqazIQ (small blind) collected ($2.25)
Seat 3: xC0kaiDYM6YTlgODL83O5A (big blind) folded before Flop
Seat 4: OqkdGXy1SCzuN5Q0wNlFSg folded before Flop (didn't bet)
Seat 5: WKJHaZPUgrpTVyLOEjLYmg folded before Flop
Seat 6: IGRfskE1v9H9Bn+fz8AgNQ folded before Flop (didn't bet)




PokerStars Game #59941961530:  Hold'em No Limit ($0.10/$0.25) - 2009/07/01 1:51:41 ET
Table 'mdub7rJf3Z5tCT9s/+1+Wg' 9-max Seat #8 is the button
Seat 2: 539MC3AwKLWVFwzABc644Q ($10.65 in chips) 
Seat 4: fDGyaQz0cs2s4FOYxkbIHA ($14.50 in chips) 
Seat 5: dfNim92Z6XK1/h5SFW5vDg ($25.90 in chips) 
Seat 6: T/CCwAWe2yhO0c4oHNwicw ($17.05 in chips) 
Seat 7: woe+9KKk+L3pZgMTuHcmog ($15.80 in chips) 
Seat 8: bXpVeaSTPBFSPJmeXxO7nw ($4.65 in chips) 
539MC3AwKLWVFwzABc644Q: posts small blind $0.10
PdIasPkzm2sqZnN41ZRXOg: is sitting out 
fDGyaQz0cs2s4FOYxkbIHA: posts big blind $0.25
*** HOLE CARDS ***
PdIasPkzm2sqZnN41ZRXOg leaves the table
dfNim92Z6XK1/h5SFW5vDg: folds 
T/CCwAWe2yhO0c4oHNwicw: folds 
woe+9KKk+L3pZgMTuHcmog: calls $0.25
bXpVeaSTPBFSPJmeXxO7nw: folds 
539MC3AwKLWVFwzABc644Q: folds 
fDGyaQz0cs2s4FOYxkbIHA: checks 
*** FLOP *** [Jh Kd 7c]
fDGyaQz0cs2s4FOYxkbIHA: checks 
woe+9KKk+L3pZgMTuHcmog: checks 
*** TURN *** [Jh Kd 7c] [Ad]
fDGyaQz0cs2s4FOYxkbIHA: bets $0.50
EgDmMA1aiBPBqXe32LIyEw joins the table at seat #9 
woe+9KKk+L3pZgMTuHcmog: folds 
Uncalled bet ($0.50) returned to fDGyaQz0cs2s4FOYxkbIHA
fDGyaQz0cs2s4FOYxkbIHA collected $0.60 from pot
fDGyaQz0cs2s4FOYxkbIHA: doesn't show hand 
*** SUMMARY ***
Total pot $0.60 | Rake $0 
Board [Jh Kd 7c Ad]
Seat 2: 539MC3AwKLWVFwzABc644Q (small blind) folded before Flop
Seat 4: fDGyaQz0cs2s4FOYxkbIHA (big blind) collected ($0.60)
Seat 5: dfNim92Z6XK1/h5SFW5vDg folded before Flop (didn't bet)
Seat 6: T/CCwAWe2yhO0c4oHNwicw folded before Flop (didn't bet)
Seat 7: woe+9KKk+L3pZgMTuHcmog folded on the Turn
Seat 8: bXpVeaSTPBFSPJmeXxO7nw (button) folded before Flop (didn't bet)




PokerStars Game #59941961450:  Hold'em No Limit ($0.10/$0.25) - 2009/07/01 1:51:41 ET
Table 'BmUMTVcNATeov2rAGYU0Qg' 9-max Seat #8 is the button
Seat 1: QEbIGci+itdw+re8RM5fZA ($33.60 in chips) 
Seat 2: jJnMGXoBXye+afMd0k0rUw ($11.65 in chips) 
Seat 3: ir5Jy8ck6DrdqgJ/3chcWw ($18.85 in chips) 
Seat 4: aNpwfA31EREwO+ar4XzBCw ($37.35 in chips) 
Seat 5: QBNcj9fHxkh/+s/oVw+JmQ ($24 in chips) 
Seat 6: w1ukf8uPa4+WH561TtVRxA ($25.35 in chips) 
Seat 7: CmngQmkKTp8tkl6GMRTl6w ($10.10 in chips) 
Seat 8: Jve2LRs9vtGL7NdiNeXY/A ($12.75 in chips) 
QEbIGci+itdw+re8RM5fZA: posts small blind $0.10
jJnMGXoBXye+afMd0k0rUw: posts big blind $0.25
*** HOLE CARDS ***
ir5Jy8ck6DrdqgJ/3chcWw: calls $0.25
aNpwfA31EREwO+ar4XzBCw: folds 
/artgaAtyUtUtD8FZo6puA said, "wow... a5..."
/artgaAtyUtUtD8FZo6puA said, "damn"
QBNcj9fHxkh/+s/oVw+JmQ: folds 
/artgaAtyUtUtD8FZo6puA has returned
w1ukf8uPa4+WH561TtVRxA: raises $1 to $1.25
CmngQmkKTp8tkl6GMRTl6w: folds 
Jve2LRs9vtGL7NdiNeXY/A: folds 
QEbIGci+itdw+re8RM5fZA: folds 
jJnMGXoBXye+afMd0k0rUw: folds 
ir5Jy8ck6DrdqgJ/3chcWw: calls $1
*** FLOP *** [2s 5s 3h]
ir5Jy8ck6DrdqgJ/3chcWw: checks 
w1ukf8uPa4+WH561TtVRxA: bets $1.75
ir5Jy8ck6DrdqgJ/3chcWw: calls $1.75
*** TURN *** [2s 5s 3h] [Qd]
ir5Jy8ck6DrdqgJ/3chcWw: bets $0.50
w1ukf8uPa4+WH561TtVRxA: raises $4 to $4.50
ir5Jy8ck6DrdqgJ/3chcWw: folds 
Uncalled bet ($4) returned to w1ukf8uPa4+WH561TtVRxA
w1ukf8uPa4+WH561TtVRxA collected $7 from pot
w1ukf8uPa4+WH561TtVRxA: doesn't show hand 
*** SUMMARY ***
Total pot $7.35 | Rake $0.35 
Board [2s 5s 3h Qd]
Seat 1: QEbIGci+itdw+re8RM5fZA (small blind) folded before Flop
Seat 2: jJnMGXoBXye+afMd0k0rUw (big blind) folded before Flop
Seat 3: ir5Jy8ck6DrdqgJ/3chcWw folded on the Turn
Seat 4: aNpwfA31EREwO+ar4XzBCw folded before Flop (didn't bet)
Seat 5: QBNcj9fHxkh/+s/oVw+JmQ folded before Flop (didn't bet)
Seat 6: w1ukf8uPa4+WH561TtVRxA collected ($7)
Seat 7: CmngQmkKTp8tkl6GMRTl6w folded before Flop (didn't bet)
Seat 8: Jve2LRs9vtGL7NdiNeXY/A (button) folded before Flop (didn't bet)




PokerStars Game #59941961722:  Hold'em No Limit ($0.10/$0.25) - 2009/07/01 1:51:41 ET
Table '+fuYjvJy9okLr23QyZtanA' 9-max Seat #9 is the button
Seat 2: tLcDklc2rBORNfixyRfVfw ($25.50 in chips) 
Seat 3: eK8qa6EPcH2zhtbmWSvc9g ($52.30 in chips) 
Seat 4: Bb42QRQMhg5/Y0vHP8/2Xw ($32.25 in chips) 
Seat 5: bXpVeaSTPBFSPJmeXxO7nw ($4.30 in chips) 
Seat 6: wGigCmBR/9XWkPpvYos3aQ ($29.80 in chips) 
Seat 7: dfNim92Z6XK1/h5SFW5vDg ($36.50 in chips) 
Seat 8: KqS/lY/fNB9qUxokm9QfeA ($8.45 in chips) 
Seat 9: OMhlmt2waO3z43ZSFNMmog ($29.45 in chips) 
tLcDklc2rBORNfixyRfVfw: posts small blind $0.10
eK8qa6EPcH2zhtbmWSvc9g: posts big blind $0.25
*** HOLE CARDS ***
Bb42QRQMhg5/Y0vHP8/2Xw: folds 
bXpVeaSTPBFSPJmeXxO7nw: folds 
wGigCmBR/9XWkPpvYos3aQ: folds 
dfNim92Z6XK1/h5SFW5vDg: folds 
KqS/lY/fNB9qUxokm9QfeA: calls $0.25
OMhlmt2waO3z43ZSFNMmog: calls $0.25
tLcDklc2rBORNfixyRfVfw: folds 
eK8qa6EPcH2zhtbmWSvc9g: checks 
*** FLOP *** [9c Ks 4c]
eK8qa6EPcH2zhtbmWSvc9g: checks 
KqS/lY/fNB9qUxokm9QfeA: checks 
OMhlmt2waO3z43ZSFNMmog: bets $1.25
eK8qa6EPcH2zhtbmWSvc9g: folds 
KqS/lY/fNB9qUxokm9QfeA: folds 
Uncalled bet ($1.25) returned to OMhlmt2waO3z43ZSFNMmog
OMhlmt2waO3z43ZSFNMmog collected $0.85 from pot
OMhlmt2waO3z43ZSFNMmog: doesn't show hand 
*** SUMMARY ***
Total pot $0.85 | Rake $0 
Board [9c Ks 4c]
Seat 2: tLcDklc2rBORNfixyRfVfw (small blind) folded before Flop
Seat 3: eK8qa6EPcH2zhtbmWSvc9g (big blind) folded on the Flop
Seat 4: Bb42QRQMhg5/Y0vHP8/2Xw folded before Flop (didn't bet)
Seat 5: bXpVeaSTPBFSPJmeXxO7nw folded before Flop (didn't bet)
Seat 6: wGigCmBR/9XWkPpvYos3aQ folded before Flop (didn't bet)
Seat 7: dfNim92Z6XK1/h5SFW5vDg folded before Flop (didn't bet)
Seat 8: KqS/lY/fNB9qUxokm9QfeA folded on the Flop
Seat 9: OMhlmt2waO3z43ZSFNMmog (button) collected ($0.85)




PokerStars Game #59941962138:  Hold'em No Limit ($0.10/$0.25) - 2009/07/01 1:51:42 ET
Table 'sCop8wmj9zlSS2KJqk1QKQ' 9-max Seat #4 is the button
Seat 1: dtZ84flFEi4Q+SGrHMJRDQ ($39.85 in chips) 
Seat 2: YZaC69gFrepA6oCGtu7E0w ($41.10 in chips) 
Seat 3: M/9j4wkHH9i1JM51vgi1VA ($26.15 in chips) 
Seat 4: msUzkZl2RntUnTl6E8WaNA ($15.30 in chips) 
Seat 6: 6RiVTYll/5D8zICp0MRpKw ($24.75 in chips) 
Seat 7: 18G4P1XstjNvItdGUITxgw ($25 in chips) 
Seat 8: xnVwSkROfRtOw4eSoDANtw ($19.55 in chips) 
Seat 9: tLcDklc2rBORNfixyRfVfw ($25 in chips) 
CvL9Ch1HYCVbTsfpNucitg will be allowed to play after the button
6RiVTYll/5D8zICp0MRpKw: posts small blind $0.10
18G4P1XstjNvItdGUITxgw: posts big blind $0.25
*** HOLE CARDS ***
xnVwSkROfRtOw4eSoDANtw: folds 
tLcDklc2rBORNfixyRfVfw: folds 
dtZ84flFEi4Q+SGrHMJRDQ: folds 
YZaC69gFrepA6oCGtu7E0w: folds 
M/9j4wkHH9i1JM51vgi1VA: folds 
msUzkZl2RntUnTl6E8WaNA: folds 
6RiVTYll/5D8zICp0MRpKw: raises $0.75 to $1
18G4P1XstjNvItdGUITxgw: raises $7 to $8
6RiVTYll/5D8zICp0MRpKw: folds 
Uncalled bet ($7) returned to 18G4P1XstjNvItdGUITxgw
18G4P1XstjNvItdGUITxgw collected $2 from pot
18G4P1XstjNvItdGUITxgw: doesn't show hand 
*** SUMMARY ***
Total pot $2 | Rake $0 
Seat 1: dtZ84flFEi4Q+SGrHMJRDQ folded before Flop (didn't bet)
Seat 2: YZaC69gFrepA6oCGtu7E0w folded before Flop (didn't bet)
Seat 3: M/9j4wkHH9i1JM51vgi1VA folded before Flop (didn't bet)
Seat 4: msUzkZl2RntUnTl6E8WaNA (button) folded before Flop (didn't bet)
Seat 6: 6RiVTYll/5D8zICp0MRpKw (small blind) folded before Flop
Seat 7: 18G4P1XstjNvItdGUITxgw (big blind) collected ($2)
Seat 8: xnVwSkROfRtOw4eSoDANtw folded before Flop (didn't bet)
Seat 9: tLcDklc2rBORNfixyRfVfw folded before Flop (didn't bet)




PokerStars Game #59941961984:  Hold'em No Limit ($0.10/$0.25) - 2009/07/01 1:51:42 ET
Table 'zhqgUUprOJ14VxKxPHcT/Q' 9-max Seat #2 is the button
Seat 1: 22dIObOuor/A+IKWkNoAlA ($5.50 in chips) 
Seat 2: GY095KWhBevJ1Ttvl8WseA ($14.10 in chips) 
Seat 3: 4XHsdGnQ76EBdBvsrSs8bA ($20.65 in chips) 
Seat 4: wGigCmBR/9XWkPpvYos3aQ ($33.45 in chips) 
Seat 5: +sbyWwIcFp9kP0bDtMegfQ ($33.25 in chips) 
Seat 6: PdIasPkzm2sqZnN41ZRXOg ($5 in chips) 
Seat 8: EQXHDnIzAsORnIXRNtXRlA ($29.50 in chips) 
Seat 9: CGjLyv/AvljZy2g76nYkzQ ($25.50 in chips) 
4XHsdGnQ76EBdBvsrSs8bA: posts small blind $0.10
wGigCmBR/9XWkPpvYos3aQ: posts big blind $0.25
bXpVeaSTPBFSPJmeXxO7nw: sits out 
*** HOLE CARDS ***
+sbyWwIcFp9kP0bDtMegfQ: raises $0.75 to $1
PdIasPkzm2sqZnN41ZRXOg: folds 
EQXHDnIzAsORnIXRNtXRlA: folds 
CGjLyv/AvljZy2g76nYkzQ: folds 
22dIObOuor/A+IKWkNoAlA: folds 
GY095KWhBevJ1Ttvl8WseA: folds 
4XHsdGnQ76EBdBvsrSs8bA: calls $0.90
wGigCmBR/9XWkPpvYos3aQ: folds 
*** FLOP *** [3c Ts 4c]
4XHsdGnQ76EBdBvsrSs8bA: bets $1.25
+sbyWwIcFp9kP0bDtMegfQ: calls $1.25
*** TURN *** [3c Ts 4c] [2h]
4XHsdGnQ76EBdBvsrSs8bA: bets $2.50
+sbyWwIcFp9kP0bDtMegfQ: folds 
Uncalled bet ($2.50) returned to 4XHsdGnQ76EBdBvsrSs8bA
4XHsdGnQ76EBdBvsrSs8bA collected $4.55 from pot
4XHsdGnQ76EBdBvsrSs8bA: doesn't show hand 
*** SUMMARY ***
Total pot $4.75 | Rake $0.20 
Board [3c Ts 4c 2h]
Seat 1: 22dIObOuor/A+IKWkNoAlA folded before Flop (didn't bet)
Seat 2: GY095KWhBevJ1Ttvl8WseA (button) folded before Flop (didn't bet)
Seat 3: 4XHsdGnQ76EBdBvsrSs8bA (small blind) collected ($4.55)
Seat 4: wGigCmBR/9XWkPpvYos3aQ (big blind) folded before Flop
Seat 5: +sbyWwIcFp9kP0bDtMegfQ folded on the Turn
Seat 6: PdIasPkzm2sqZnN41ZRXOg folded before Flop (didn't bet)
Seat 8: EQXHDnIzAsORnIXRNtXRlA folded before Flop (didn't bet)
Seat 9: CGjLyv/AvljZy2g76nYkzQ folded before Flop (didn't bet)




PokerStars Game #59941961958:  Hold'em No Limit ($0.10/$0.25) - 2009/07/01 1:51:42 ET
Table '4hfTdIVT/qPsJNfWXLsVIw' 9-max Seat #6 is the button
Seat 1: GbHFBbLqLGz0Pwn6CJeAuw ($37.95 in chips) 
Seat 2: Pt637jKksB5MzP0UNJAAkw ($39.85 in chips) 
Seat 3: xnVwSkROfRtOw4eSoDANtw ($2.10 in chips) 
Seat 4: 3PmVnC/15cl4oyI1TKIt4g ($6.55 in chips) 
Seat 5: dtZ84flFEi4Q+SGrHMJRDQ ($26.60 in chips) 
Seat 6: VWUWpMLMj/Q1jRVpF7Aohw ($11.80 in chips) 
Seat 7: d7YasxuGLPiL7pj8IcGThw ($7.20 in chips) 
Seat 8: 18G4P1XstjNvItdGUITxgw ($25 in chips) 
Seat 9: 9njEKzpOKC62MllUFUBWrA ($22.25 in chips) 
d7YasxuGLPiL7pj8IcGThw: posts small blind $0.10
18G4P1XstjNvItdGUITxgw: posts big blind $0.25
*** HOLE CARDS ***
9njEKzpOKC62MllUFUBWrA: calls $0.25
GbHFBbLqLGz0Pwn6CJeAuw: folds 
Pt637jKksB5MzP0UNJAAkw: raises $0.75 to $1
xnVwSkROfRtOw4eSoDANtw: folds 
3PmVnC/15cl4oyI1TKIt4g: folds 
dtZ84flFEi4Q+SGrHMJRDQ: folds 
VWUWpMLMj/Q1jRVpF7Aohw: folds 
d7YasxuGLPiL7pj8IcGThw: folds 
18G4P1XstjNvItdGUITxgw: calls $0.75
9njEKzpOKC62MllUFUBWrA: calls $0.75
*** FLOP *** [Js 8d 2d]
18G4P1XstjNvItdGUITxgw: bets $0.50
9njEKzpOKC62MllUFUBWrA: folds 
Pt637jKksB5MzP0UNJAAkw: calls $0.50
*** TURN *** [Js 8d 2d] [5s]
18G4P1XstjNvItdGUITxgw: checks 
Pt637jKksB5MzP0UNJAAkw: bets $1.75
18G4P1XstjNvItdGUITxgw: raises $3.25 to $5
Pt637jKksB5MzP0UNJAAkw: folds 
Uncalled bet ($3.25) returned to 18G4P1XstjNvItdGUITxgw
18G4P1XstjNvItdGUITxgw collected $7.25 from pot
18G4P1XstjNvItdGUITxgw: doesn't show hand 
*** SUMMARY ***
Total pot $7.60 | Rake $0.35 
Board [Js 8d 2d 5s]
Seat 1: GbHFBbLqLGz0Pwn6CJeAuw folded before Flop (didn't bet)
Seat 2: Pt637jKksB5MzP0UNJAAkw folded on the Turn
Seat 3: xnVwSkROfRtOw4eSoDANtw folded before Flop (didn't bet)
Seat 4: 3PmVnC/15cl4oyI1TKIt4g folded before Flop (didn't bet)
Seat 5: dtZ84flFEi4Q+SGrHMJRDQ folded before Flop (didn't bet)
Seat 6: VWUWpMLMj/Q1jRVpF7Aohw (button) folded before Flop (didn't bet)
Seat 7: d7YasxuGLPiL7pj8IcGThw (small blind) folded before Flop
Seat 8: 18G4P1XstjNvItdGUITxgw (big blind) collected ($7.25)
Seat 9: 9njEKzpOKC62MllUFUBWrA folded on the Flop




PokerStars Game #59941961938:  Hold'em No Limit ($0.10/$0.25) - 2009/07/01 1:51:42 ET
Table 'Zi9/NqNs3XoL1eWhMCyZyg' 9-max Seat #7 is the button
Seat 1: X6+pSIPfovPcE87t+LmUKQ ($4.50 in chips) 
Seat 2: 1wKfgJ8xXIiuc8C6qjkxhg ($4.60 in chips) 
Seat 3: ETC7YyRJTa2Ovhln64Ni5Q ($27.80 in chips) 
Seat 4: dmYlc+1cjwZMJ7wV+Z0rRg ($24 in chips) 
Seat 5: HE9eSITnljG4AKvgOR4BMw ($14.75 in chips) 
Seat 6: YQhfmYhgnDDlWCAFmBb36Q ($18.25 in chips) 
Seat 7: 0QdZrkFD7aGKeBXPGbIomA ($1.85 in chips) 
Seat 8: nm4Dj/f+jJEwKVsUnKh73g ($34.40 in chips) 
Seat 9: 3l+i+xMeyDndSXMF2A5CDA ($5 in chips) 
nm4Dj/f+jJEwKVsUnKh73g: posts small blind $0.10
3l+i+xMeyDndSXMF2A5CDA: posts big blind $0.25
*** HOLE CARDS ***
X6+pSIPfovPcE87t+LmUKQ: folds 
1wKfgJ8xXIiuc8C6qjkxhg: calls $0.25
ETC7YyRJTa2Ovhln64Ni5Q: folds 
dmYlc+1cjwZMJ7wV+Z0rRg: folds 
HE9eSITnljG4AKvgOR4BMw: folds 
YQhfmYhgnDDlWCAFmBb36Q: calls $0.25
0QdZrkFD7aGKeBXPGbIomA: calls $0.25
nm4Dj/f+jJEwKVsUnKh73g: folds 
3l+i+xMeyDndSXMF2A5CDA: checks 
*** FLOP *** [9d 3d 8c]
3l+i+xMeyDndSXMF2A5CDA: checks 
1wKfgJ8xXIiuc8C6qjkxhg: checks 
YQhfmYhgnDDlWCAFmBb36Q: checks 
0QdZrkFD7aGKeBXPGbIomA: checks 
*** TURN *** [9d 3d 8c] [3h]
3l+i+xMeyDndSXMF2A5CDA: checks 
1wKfgJ8xXIiuc8C6qjkxhg: bets $0.50
YQhfmYhgnDDlWCAFmBb36Q: calls $0.50
0QdZrkFD7aGKeBXPGbIomA: folds 
3l+i+xMeyDndSXMF2A5CDA: folds 
*** RIVER *** [9d 3d 8c 3h] [9s]
1wKfgJ8xXIiuc8C6qjkxhg: bets $1
YQhfmYhgnDDlWCAFmBb36Q: folds 
Uncalled bet ($1) returned to 1wKfgJ8xXIiuc8C6qjkxhg
1wKfgJ8xXIiuc8C6qjkxhg collected $2 from pot
*** SUMMARY ***
Total pot $2.10 | Rake $0.10 
Board [9d 3d 8c 3h 9s]
Seat 1: X6+pSIPfovPcE87t+LmUKQ folded before Flop (didn't bet)
Seat 2: 1wKfgJ8xXIiuc8C6qjkxhg collected ($2)
Seat 3: ETC7YyRJTa2Ovhln64Ni5Q folded before Flop (didn't bet)
Seat 4: dmYlc+1cjwZMJ7wV+Z0rRg folded before Flop (didn't bet)
Seat 5: HE9eSITnljG4AKvgOR4BMw folded before Flop (didn't bet)
Seat 6: YQhfmYhgnDDlWCAFmBb36Q folded on the River
Seat 7: 0QdZrkFD7aGKeBXPGbIomA (button) folded on the Turn
Seat 8: nm4Dj/f+jJEwKVsUnKh73g (small blind) folded before Flop
Seat 9: 3l+i+xMeyDndSXMF2A5CDA (big blind) folded on the Turn




PokerStars Game #59941962552:  Hold'em No Limit ($0.10/$0.25) - 2009/07/01 1:51:43 ET
Table 'ZiwAqg4o02gNro+JOAaFNg6wawJ+MkkvuC3coG6r+YhgSeat #6 is the button
Seat 1: 6RiVTYll/5D8zICp0MRpKw ($28.35 in chips) 
Seat 2: VCKtuATyvAq9H2JSAQxPbA ($13.25 in chips) 
Seat 3: aNpwfA31EREwO+ar4XzBCw ($32.25 in chips) 
Seat 4: RHqgdFvufLCYe54+qd2gcA ($11.55 in chips) 
Seat 5: 6HoFYfVGBefsR5Vrz62qIw5hAPbqNrvJb8PtLiceXtlg.55 in chips) 
Seat 6: 5n7e7I+px7c6CQmLpPbtsg ($4.65 in chips) 
Seat 7: yyG4svzOpC1A+sUP/scg6w ($5.70 in chips) 
Seat 8: VLIsy+xjx3olLSYO3JLS6g ($13.45 in chips) 
Seat 9: ljemhp25Zg+nlA9DLCIiUw ($23.90 in chips) 
yyG4svzOpC1A+sUP/scg6w: posts small blind $0.10
VLIsy+xjx3olLSYO3JLS6g: posts big blind $0.25
*** HOLE CARDS ***
ljemhp25Zg+nlA9DLCIiUw: folds 
6RiVTYll/5D8zICp0MRpKw: folds 
VCKtuATyvAq9H2JSAQxPbA: calls $0.25
aNpwfA31EREwO+ar4XzBCw: folds 
RHqgdFvufLCYe54+qd2gcA: folds 
6HoFYfVGBefsR5Vrz62qIw5hAPbqNrvJb8PtLiceXtlgises $0.25 to $0.50
5n7e7I+px7c6CQmLpPbtsg: folds 
yyG4svzOpC1A+sUP/scg6w: folds 
VLIsy+xjx3olLSYO3JLS6g: raises $1.50 to $2
VCKtuATyvAq9H2JSAQxPbA: calls $1.75
6HoFYfVGBefsR5Vrz62qIw5hAPbqNrvJb8PtLiceXtlglds 
*** FLOP *** [Jc 2s 9s]
VLIsy+xjx3olLSYO3JLS6g: bets $2.50
VCKtuATyvAq9H2JSAQxPbA: folds 
Uncalled bet ($2.50) returned to VLIsy+xjx3olLSYO3JLS6g
VLIsy+xjx3olLSYO3JLS6g collected $4.40 from pot
VLIsy+xjx3olLSYO3JLS6g: doesn't show hand 
*** SUMMARY ***
Total pot $4.60 | Rake $0.20 
Board [Jc 2s 9s]
Seat 1: 6RiVTYll/5D8zICp0MRpKw folded before Flop (didn't bet)
Seat 2: VCKtuATyvAq9H2JSAQxPbA folded on the Flop
Seat 3: aNpwfA31EREwO+ar4XzBCw folded before Flop (didn't bet)
Seat 4: RHqgdFvufLCYe54+qd2gcA folded before Flop (didn't bet)
Seat 5: 6HoFYfVGBefsR5Vrz62qIw5hAPbqNrvJb8PtLiceXtlgded before Flop
Seat 6: 5n7e7I+px7c6CQmLpPbtsg (button) folded before Flop (didn't bet)
Seat 7: yyG4svzOpC1A+sUP/scg6w (small blind) folded before Flop
Seat 8: VLIsy+xjx3olLSYO3JLS6g (big blind) collected ($4.40)
Seat 9: ljemhp25Zg+nlA9DLCIiUw folded before Flop (didn't bet)




PokerStars Game #59941963084:  Hold'em No Limit ($0.10/$0.25) - 2009/07/01 1:51:44 ET
Table 'SbSV5tlgLp0+/Z+13PW3Hg' 9-max Seat #7 is the button
Seat 1: x+W5+3qsdY4Iszf0hoH+Aw ($18.55 in chips) 
Seat 2: zDrucyjVn5aeekNEc3cJrA ($13.40 in chips) 
Seat 3: CT7Xj/V/O5rBlhtt+RZeFQ ($25.60 in chips) 
Seat 4: puj3K/wrNjEj86ZL/MyfLA ($9 in chips) 
Seat 5: clJsV3v77RS07bDKY+705w ($5 in chips) 
Seat 6: pN3IHvAKm2fz+sTRARTcrg ($25 in chips) 
Seat 7: 3PmVnC/15cl4oyI1TKIt4g ($4.65 in chips) 
Seat 8: qBdqLaJhO+1itcMk70bsfA ($10.45 in chips) 
qBdqLaJhO+1itcMk70bsfA: posts small blind $0.10
X78b5v/uhqeXXoAijbw/yg: is sitting out 
x+W5+3qsdY4Iszf0hoH+Aw: posts big blind $0.25
clJsV3v77RS07bDKY+705w: posts big blind $0.25
*** HOLE CARDS ***
X78b5v/uhqeXXoAijbw/yg leaves the table
zDrucyjVn5aeekNEc3cJrA: folds 
CGjLyv/AvljZy2g76nYkzQ joins the table at seat #9 
CT7Xj/V/O5rBlhtt+RZeFQ: calls $0.25
puj3K/wrNjEj86ZL/MyfLA: calls $0.25
clJsV3v77RS07bDKY+705w: checks 
pN3IHvAKm2fz+sTRARTcrg: folds 
3PmVnC/15cl4oyI1TKIt4g: folds 
qBdqLaJhO+1itcMk70bsfA: folds 
x+W5+3qsdY4Iszf0hoH+Aw: checks 
*** FLOP *** [As Kc 9d]
x+W5+3qsdY4Iszf0hoH+Aw: checks 
CT7Xj/V/O5rBlhtt+RZeFQ: checks 
puj3K/wrNjEj86ZL/MyfLA: checks 
clJsV3v77RS07bDKY+705w: checks 
*** TURN *** [As Kc 9d] [Js]
x+W5+3qsdY4Iszf0hoH+Aw: checks 
CT7Xj/V/O5rBlhtt+RZeFQ: checks 
puj3K/wrNjEj86ZL/MyfLA: checks 
clJsV3v77RS07bDKY+705w: bets $0.75
x+W5+3qsdY4Iszf0hoH+Aw: folds 
CT7Xj/V/O5rBlhtt+RZeFQ: folds 
puj3K/wrNjEj86ZL/MyfLA: folds 
Uncalled bet ($0.75) returned to clJsV3v77RS07bDKY+705w
clJsV3v77RS07bDKY+705w collected $1.05 from pot
clJsV3v77RS07bDKY+705w: doesn't show hand 
*** SUMMARY ***
Total pot $1.10 | Rake $0.05 
Board [As Kc 9d Js]
Seat 1: x+W5+3qsdY4Iszf0hoH+Aw (big blind) folded on the Turn
Seat 2: zDrucyjVn5aeekNEc3cJrA folded before Flop (didn't bet)
Seat 3: CT7Xj/V/O5rBlhtt+RZeFQ folded on the Turn
Seat 4: puj3K/wrNjEj86ZL/MyfLA folded on the Turn
Seat 5: clJsV3v77RS07bDKY+705w collected ($1.05)
Seat 6: pN3IHvAKm2fz+sTRARTcrg folded before Flop (didn't bet)
Seat 7: 3PmVnC/15cl4oyI1TKIt4g (button) folded before Flop (didn't bet)
Seat 8: qBdqLaJhO+1itcMk70bsfA (small blind) folded before Flop




PokerStars Game #59941963254:  Hold'em No Limit ($0.10/$0.25) - 2009/07/01 1:51:44 ET
Table '3760QYRYyCWeXf0rLZ5S2g' 9-max Seat #4 is the button
Seat 1: CT7Xj/V/O5rBlhtt+RZeFQ ($27.55 in chips) 
Seat 2: zDrucyjVn5aeekNEc3cJrA ($26.95 in chips) 
Seat 4: ziFpkH3wCzqB/qXeq/Hy7g ($25 in chips) 
Seat 5: Bb42QRQMhg5/Y0vHP8/2Xw ($29.65 in chips) 
Seat 6: q+Qdg0Hoir+SyL7haBrUnw ($13.60 in chips) 
Seat 7: 6C2DoQ+GZHBOpb+qyrSnqA ($6.10 in chips) 
Seat 8: clJsV3v77RS07bDKY+705w ($5.25 in chips) 
Seat 9: BCwIzs00xY6DtWGghTGEwg ($14.75 in chips) 
Bb42QRQMhg5/Y0vHP8/2Xw: posts small blind $0.10
q+Qdg0Hoir+SyL7haBrUnw: posts big blind $0.25
4qA/3Ajg3pP6fqW+IX9/fQ: sits out 
*** HOLE CARDS ***
6C2DoQ+GZHBOpb+qyrSnqA: folds 
clJsV3v77RS07bDKY+705w: folds 
BCwIzs00xY6DtWGghTGEwg: folds 
CT7Xj/V/O5rBlhtt+RZeFQ: folds 
zDrucyjVn5aeekNEc3cJrA: folds 
ziFpkH3wCzqB/qXeq/Hy7g: folds 
Bb42QRQMhg5/Y0vHP8/2Xw: folds 
Uncalled bet ($0.15) returned to q+Qdg0Hoir+SyL7haBrUnw
q+Qdg0Hoir+SyL7haBrUnw collected $0.20 from pot
*** SUMMARY ***
Total pot $0.20 | Rake $0 
Seat 1: CT7Xj/V/O5rBlhtt+RZeFQ folded before Flop (didn't bet)
Seat 2: zDrucyjVn5aeekNEc3cJrA folded before Flop (didn't bet)
Seat 4: ziFpkH3wCzqB/qXeq/Hy7g (button) folded before Flop (didn't bet)
Seat 5: Bb42QRQMhg5/Y0vHP8/2Xw (small blind) folded before Flop
Seat 6: q+Qdg0Hoir+SyL7haBrUnw (big blind) collected ($0.20)
Seat 7: 6C2DoQ+GZHBOpb+qyrSnqA folded before Flop (didn't bet)
Seat 8: clJsV3v77RS07bDKY+705w folded before Flop (didn't bet)
Seat 9: BCwIzs00xY6DtWGghTGEwg folded before Flop (didn't bet)




PokerStars Game #59941963228:  Hold'em No Limit ($0.10/$0.25) - 2009/07/01 1:51:44 ET
Table 'gnrUwXkIPE0C8xl6cB4Hyw' 9-max Seat #1 is the button
Seat 1: EQXHDnIzAsORnIXRNtXRlA ($22.60 in chips) 
Seat 2: 7je+LC5Mfs6nL8YBVh4frQ ($4.75 in chips) 
Seat 3: PdIasPkzm2sqZnN41ZRXOg ($5.70 in chips) 
Seat 4: wGigCmBR/9XWkPpvYos3aQ ($25 in chips) 
Seat 5: gehe91e0IyVT0QU/XBkEyg ($31.30 in chips) 
Seat 6: dtZ84flFEi4Q+SGrHMJRDQ ($25.80 in chips) 
Seat 8: 4awUyiDYTgylQKXZ9faBVA ($60.65 in chips) 
Seat 9: F7pnn6czNpHvRM55XcA2EA ($25 in chips) 
7je+LC5Mfs6nL8YBVh4frQ: posts small blind $0.10
PdIasPkzm2sqZnN41ZRXOg: posts big blind $0.25
RHqgdFvufLCYe54+qd2gcA: sits out 
*** HOLE CARDS ***
wGigCmBR/9XWkPpvYos3aQ: folds 
gehe91e0IyVT0QU/XBkEyg: folds 
dtZ84flFEi4Q+SGrHMJRDQ: folds 
4awUyiDYTgylQKXZ9faBVA: folds 
F7pnn6czNpHvRM55XcA2EA: raises $0.25 to $0.50
EQXHDnIzAsORnIXRNtXRlA: folds 
7je+LC5Mfs6nL8YBVh4frQ: folds 
PdIasPkzm2sqZnN41ZRXOg: folds 
Uncalled bet ($0.25) returned to F7pnn6czNpHvRM55XcA2EA
F7pnn6czNpHvRM55XcA2EA collected $0.60 from pot
F7pnn6czNpHvRM55XcA2EA: doesn't show hand 
*** SUMMARY ***
Total pot $0.60 | Rake $0 
Seat 1: EQXHDnIzAsORnIXRNtXRlA (button) folded before Flop (didn't bet)
Seat 2: 7je+LC5Mfs6nL8YBVh4frQ (small blind) folded before Flop
Seat 3: PdIasPkzm2sqZnN41ZRXOg (big blind) folded before Flop
Seat 4: wGigCmBR/9XWkPpvYos3aQ folded before Flop (didn't bet)
Seat 5: gehe91e0IyVT0QU/XBkEyg folded before Flop (didn't bet)
Seat 6: dtZ84flFEi4Q+SGrHMJRDQ folded before Flop (didn't bet)
Seat 8: 4awUyiDYTgylQKXZ9faBVA folded before Flop (didn't bet)
Seat 9: F7pnn6czNpHvRM55XcA2EA collected ($0.60)




PokerStars Game #59941963464:  Hold'em No Limit ($0.10/$0.25) - 2009/07/01 1:51:44 ET
Table 'Ez9TB43XM4QgMDQkIW9DYw' 9-max Seat #7 is the button
Seat 1: ShCS62CJp4MKfKLKvGKQbA ($11.55 in chips) 
Seat 2: PFNLAvMkr8qKc7xCiH0wTA ($17 in chips) 
Seat 3: PdIasPkzm2sqZnN41ZRXOg ($6.25 in chips) 
Seat 4: ubsjZomMWSV0hAiBLa7K1A ($20.45 in chips) 
Seat 6: 76o85YBHJ9veRYp2LPuluQ ($16.55 in chips) 
Seat 7: Bb42QRQMhg5/Y0vHP8/2Xw ($55.60 in chips) 
Seat 8: +2kMBNpY4nF1qNCRd8SJLA ($28.50 in chips) 
Seat 9: QEbIGci+itdw+re8RM5fZA ($25 in chips) 
+2kMBNpY4nF1qNCRd8SJLA: posts small blind $0.10
QEbIGci+itdw+re8RM5fZA: posts big blind $0.25
18G4P1XstjNvItdGUITxgw: sits out 
*** HOLE CARDS ***
ShCS62CJp4MKfKLKvGKQbA: folds 
PFNLAvMkr8qKc7xCiH0wTA: folds 
PdIasPkzm2sqZnN41ZRXOg: folds 
ubsjZomMWSV0hAiBLa7K1A: folds 
76o85YBHJ9veRYp2LPuluQ: raises $0.25 to $0.50
Bb42QRQMhg5/Y0vHP8/2Xw: folds 
+2kMBNpY4nF1qNCRd8SJLA: calls $0.40
QEbIGci+itdw+re8RM5fZA: calls $0.25
*** FLOP *** [8s 3s 2d]
+2kMBNpY4nF1qNCRd8SJLA: checks 
QEbIGci+itdw+re8RM5fZA: checks 
76o85YBHJ9veRYp2LPuluQ: bets $0.50
+2kMBNpY4nF1qNCRd8SJLA: folds 
QEbIGci+itdw+re8RM5fZA: folds 
Uncalled bet ($0.50) returned to 76o85YBHJ9veRYp2LPuluQ
76o85YBHJ9veRYp2LPuluQ collected $1.45 from pot
76o85YBHJ9veRYp2LPuluQ: doesn't show hand 
*** SUMMARY ***
Total pot $1.50 | Rake $0.05 
Board [8s 3s 2d]
Seat 1: ShCS62CJp4MKfKLKvGKQbA folded before Flop (didn't bet)
Seat 2: PFNLAvMkr8qKc7xCiH0wTA folded before Flop (didn't bet)
Seat 3: PdIasPkzm2sqZnN41ZRXOg folded before Flop (didn't bet)
Seat 4: ubsjZomMWSV0hAiBLa7K1A folded before Flop (didn't bet)
Seat 6: 76o85YBHJ9veRYp2LPuluQ collected ($1.45)
Seat 7: Bb42QRQMhg5/Y0vHP8/2Xw (button) folded before Flop (didn't bet)
Seat 8: +2kMBNpY4nF1qNCRd8SJLA (small blind) folded on the Flop
Seat 9: QEbIGci+itdw+re8RM5fZA (big blind) folded on the Flop




PokerStars Game #59941963402:  Hold'em No Limit ($0.10/$0.25) - 2009/07/01 1:51:44 ET
Table 'JJzUs04lHpXg6nboT1/jeg' 6-max Seat #3 is the button
Seat 1: vEZ/HxVuyR6kaq0BtZoUgQ ($10 in chips) 
Seat 2: jxfR29d+dK/7h7s3SvCk+g ($12.35 in chips) 
Seat 3: 4zXbHDe39qNX46dAo81b4w ($7.40 in chips) 
Seat 4: 7cx44/slbeTw+Cy7QB8Trg ($24.40 in chips) 
Seat 5: FDWzjQgBA5K04jOIY/j22w ($4.75 in chips) 
7cx44/slbeTw+Cy7QB8Trg: posts small blind $0.10
FDWzjQgBA5K04jOIY/j22w: posts big blind $0.25
bDKopKTvPi3W+PEnYUX3tg: sits out 
*** HOLE CARDS ***
vEZ/HxVuyR6kaq0BtZoUgQ: raises $0.50 to $0.75
jxfR29d+dK/7h7s3SvCk+g: calls $0.75
4zXbHDe39qNX46dAo81b4w: raises $6.65 to $7.40 and is all-in
7cx44/slbeTw+Cy7QB8Trg: folds 
FDWzjQgBA5K04jOIY/j22w: folds 
vEZ/HxVuyR6kaq0BtZoUgQ: folds 
jxfR29d+dK/7h7s3SvCk+g: folds 
Uncalled bet ($6.65) returned to 4zXbHDe39qNX46dAo81b4w
4zXbHDe39qNX46dAo81b4w collected $2.60 from pot
*** SUMMARY ***
Total pot $2.60 | Rake $0 
Seat 1: vEZ/HxVuyR6kaq0BtZoUgQ folded before Flop
Seat 2: jxfR29d+dK/7h7s3SvCk+g folded before Flop
Seat 3: 4zXbHDe39qNX46dAo81b4w (button) collected ($2.60)
Seat 4: 7cx44/slbeTw+Cy7QB8Trg (small blind) folded before Flop
Seat 5: FDWzjQgBA5K04jOIY/j22w (big blind) folded before Flop




PokerStars Game #59941963374:  Hold'em No Limit ($0.10/$0.25) - 2009/07/01 1:51:44 ET
Table '29D3eoQzK5kOAT0OIDS2uQ' 6-max Seat #5 is the button
Seat 1: kG34n23qFQA3nzdOJTQ1dA ($43.15 in chips) 
Seat 2: FyE+TQ5JcCqI/tCCHf0jGA ($16.70 in chips) 
Seat 3: z3tQwy28dp5FykDJC/wzQw ($15.20 in chips) 
Seat 5: Q3EMN7b0ie81AFWkDrhCjw ($27.30 in chips) 
if4dh6jhJXeN3/qd3qCp9g will be allowed to play after the button
kG34n23qFQA3nzdOJTQ1dA: posts small blind $0.10
FyE+TQ5JcCqI/tCCHf0jGA: posts big blind $0.25
*** HOLE CARDS ***
z3tQwy28dp5FykDJC/wzQw: calls $0.25
Q3EMN7b0ie81AFWkDrhCjw: calls $0.25
kG34n23qFQA3nzdOJTQ1dA: folds 
FyE+TQ5JcCqI/tCCHf0jGA: checks 
*** FLOP *** [3s Td Ad]
FyE+TQ5JcCqI/tCCHf0jGA: checks 
z3tQwy28dp5FykDJC/wzQw: bets $0.75
Q3EMN7b0ie81AFWkDrhCjw: calls $0.75
FyE+TQ5JcCqI/tCCHf0jGA: folds 
*** TURN *** [3s Td Ad] [5c]
z3tQwy28dp5FykDJC/wzQw: checks 
Q3EMN7b0ie81AFWkDrhCjw: checks 
*** RIVER *** [3s Td Ad 5c] [As]
z3tQwy28dp5FykDJC/wzQw: checks 
Q3EMN7b0ie81AFWkDrhCjw: bets $3
0wUowrieiZhJzm3L0SoiKA joins the table at seat #4 
z3tQwy28dp5FykDJC/wzQw: raises $3 to $6
Q3EMN7b0ie81AFWkDrhCjw: raises $20.30 to $26.30 and is all-in
z3tQwy28dp5FykDJC/wzQw: calls $8.20 and is all-in
Uncalled bet ($12.10) returned to Q3EMN7b0ie81AFWkDrhCjw
*** SHOW DOWN ***
Q3EMN7b0ie81AFWkDrhCjw: shows [4h 2c] (a straight, Ace to Five)
z3tQwy28dp5FykDJC/wzQw: mucks hand 
Q3EMN7b0ie81AFWkDrhCjw collected $29.25 from pot
z3tQwy28dp5FykDJC/wzQw leaves the table
*** SUMMARY ***
Total pot $30.75 | Rake $1.50 
Board [3s Td Ad 5c As]
Seat 1: kG34n23qFQA3nzdOJTQ1dA (small blind) folded before Flop
Seat 2: FyE+TQ5JcCqI/tCCHf0jGA (big blind) folded on the Flop
Seat 3: z3tQwy28dp5FykDJC/wzQw mucked
Seat 5: Q3EMN7b0ie81AFWkDrhCjw (button) showed [4h 2c] and won ($29.25) with a straight, Ace to Five




PokerStars Game #59941963072:  Hold'em No Limit ($0.10/$0.25) - 2009/07/01 1:51:44 ET
Table 'FBhJjLqab11/gKu8nyB/tw' 9-max Seat #5 is the button
Seat 1: +sbyWwIcFp9kP0bDtMegfQ ($18.30 in chips) 
Seat 3: V6p0jQ/RhUsqpHLmXvEX4Q ($12.35 in chips) 
Seat 4: CvL9Ch1HYCVbTsfpNucitg ($5.15 in chips) 
Seat 5: Mh2r9hTeTEDnh19sRZtW3g ($5 in chips) 
Seat 6: cZ99hugmLBj9KhTlc8nCSw ($31.45 in chips) 
Seat 7: CT7Xj/V/O5rBlhtt+RZeFQ ($25 in chips) 
Seat 8: Th3FldXKQW6hWVVPahaoOQ ($27.25 in chips) 
cZ99hugmLBj9KhTlc8nCSw: posts small blind $0.10
CT7Xj/V/O5rBlhtt+RZeFQ: posts big blind $0.25
H5Se03ZqSX7tbULXur2MAg: sits out 
18G4P1XstjNvItdGUITxgw: sits out 
*** HOLE CARDS ***
Th3FldXKQW6hWVVPahaoOQ: calls $0.25
+sbyWwIcFp9kP0bDtMegfQ: folds 
V6p0jQ/RhUsqpHLmXvEX4Q: folds 
CvL9Ch1HYCVbTsfpNucitg: folds 
Mh2r9hTeTEDnh19sRZtW3g: folds 
cZ99hugmLBj9KhTlc8nCSw: folds 
CT7Xj/V/O5rBlhtt+RZeFQ: checks 
*** FLOP *** [9s 8h 8s]
CT7Xj/V/O5rBlhtt+RZeFQ: bets $0.75
Th3FldXKQW6hWVVPahaoOQ: folds 
Uncalled bet ($0.75) returned to CT7Xj/V/O5rBlhtt+RZeFQ
CT7Xj/V/O5rBlhtt+RZeFQ collected $0.60 from pot
CT7Xj/V/O5rBlhtt+RZeFQ: doesn't show hand 
*** SUMMARY ***
Total pot $0.60 | Rake $0 
Board [9s 8h 8s]
Seat 1: +sbyWwIcFp9kP0bDtMegfQ folded before Flop (didn't bet)
Seat 3: V6p0jQ/RhUsqpHLmXvEX4Q folded before Flop (didn't bet)
Seat 4: CvL9Ch1HYCVbTsfpNucitg folded before Flop (didn't bet)
Seat 5: Mh2r9hTeTEDnh19sRZtW3g (button) folded before Flop (didn't bet)
Seat 6: cZ99hugmLBj9KhTlc8nCSw (small blind) folded before Flop
Seat 7: CT7Xj/V/O5rBlhtt+RZeFQ (big blind) collected ($0.60)
Seat 8: Th3FldXKQW6hWVVPahaoOQ folded on the Flop




PokerStars Game #59941963862:  Hold'em No Limit ($0.10/$0.25) - 2009/07/01 1:51:45 ET
Table '+198VWQSWBhYQOcizzuBkw' 6-max Seat #4 is the button
Seat 1: 34ttqW62uIRrqINCCmLcsw ($18.25 in chips) 
Seat 2: iauW7L/+7qzAuHow7CD75Q ($12.30 in chips) 
Seat 3: vw7gefupgmOJJN8lUemdWg ($21.45 in chips) 
Seat 4: TgDsTeCdLQt8kWbL00ByRA ($14.90 in chips) 
Seat 5: LtASJ9OlkqGrrUKGQlpGAw ($24.75 in chips) 
Seat 6: leEQ84f6wJYu5SB/vj27wg ($15 in chips) 
LtASJ9OlkqGrrUKGQlpGAw: posts small blind $0.10
leEQ84f6wJYu5SB/vj27wg: posts big blind $0.25
*** HOLE CARDS ***
34ttqW62uIRrqINCCmLcsw: folds 
iauW7L/+7qzAuHow7CD75Q: folds 
vw7gefupgmOJJN8lUemdWg: raises $0.25 to $0.50
TgDsTeCdLQt8kWbL00ByRA: calls $0.50
LtASJ9OlkqGrrUKGQlpGAw: folds 
leEQ84f6wJYu5SB/vj27wg: folds 
*** FLOP *** [Th Ad 7h]
vw7gefupgmOJJN8lUemdWg: bets $0.50
TgDsTeCdLQt8kWbL00ByRA: folds 
Uncalled bet ($0.50) returned to vw7gefupgmOJJN8lUemdWg
vw7gefupgmOJJN8lUemdWg collected $1.30 from pot
vw7gefupgmOJJN8lUemdWg: doesn't show hand 
*** SUMMARY ***
Total pot $1.35 | Rake $0.05 
Board [Th Ad 7h]
Seat 1: 34ttqW62uIRrqINCCmLcsw folded before Flop (didn't bet)
Seat 2: iauW7L/+7qzAuHow7CD75Q folded before Flop (didn't bet)
Seat 3: vw7gefupgmOJJN8lUemdWg collected ($1.30)
Seat 4: TgDsTeCdLQt8kWbL00ByRA (button) folded on the Flop
Seat 5: LtASJ9OlkqGrrUKGQlpGAw (small blind) folded before Flop
Seat 6: leEQ84f6wJYu5SB/vj27wg (big blind) folded before Flop




PokerStars Game #59941964026:  Hold'em No Limit ($0.10/$0.25) - 2009/07/01 1:51:45 ET
Table 'vZfV/Uj0q8joA1du9sRJSg' 6-max Seat #5 is the button
Seat 1: MVzl6OsGybVDNd3Vr9LYAA ($25 in chips) 
Seat 2: wMiE3yTbDJGOLOF9th7KPA ($13 in chips) 
Seat 3: cWc85bEzdRzpUMhRKm8pwQ ($25 in chips) 
Seat 4: v+QfkGiuj9bgtuNoVnDO8w ($43.15 in chips) 
Seat 5: kyRaCIljYA6l33lSKQfNsg ($28.95 in chips) 
Seat 6: 8ClCHtFXGNplITm+63KB+Q ($47.45 in chips) 
8ClCHtFXGNplITm+63KB+Q: posts small blind $0.10
MVzl6OsGybVDNd3Vr9LYAA: posts big blind $0.25
*** HOLE CARDS ***
wMiE3yTbDJGOLOF9th7KPA: calls $0.25
cWc85bEzdRzpUMhRKm8pwQ: folds 
v+QfkGiuj9bgtuNoVnDO8w: folds 
kyRaCIljYA6l33lSKQfNsg: folds 
8ClCHtFXGNplITm+63KB+Q: folds 
MVzl6OsGybVDNd3Vr9LYAA: checks 
*** FLOP *** [Jh 5h 8c]
MVzl6OsGybVDNd3Vr9LYAA: checks 
wMiE3yTbDJGOLOF9th7KPA: bets $0.25
MVzl6OsGybVDNd3Vr9LYAA: calls $0.25
*** TURN *** [Jh 5h 8c] [As]
MVzl6OsGybVDNd3Vr9LYAA: bets $1
wMiE3yTbDJGOLOF9th7KPA: folds 
Uncalled bet ($1) returned to MVzl6OsGybVDNd3Vr9LYAA
MVzl6OsGybVDNd3Vr9LYAA collected $1.05 from pot
MVzl6OsGybVDNd3Vr9LYAA: doesn't show hand 
*** SUMMARY ***
Total pot $1.10 | Rake $0.05 
Board [Jh 5h 8c As]
Seat 1: MVzl6OsGybVDNd3Vr9LYAA (big blind) collected ($1.05)
Seat 2: wMiE3yTbDJGOLOF9th7KPA folded on the Turn
Seat 3: cWc85bEzdRzpUMhRKm8pwQ folded before Flop (didn't bet)
Seat 4: v+QfkGiuj9bgtuNoVnDO8w folded before Flop (didn't bet)
Seat 5: kyRaCIljYA6l33lSKQfNsg (button) folded before Flop (didn't bet)
Seat 6: 8ClCHtFXGNplITm+63KB+Q (small blind) folded before Flop




PokerStars Game #59941963742:  Hold'em No Limit ($0.10/$0.25) - 2009/07/01 1:51:45 ET
Table 'm+FQg/QP0VP1ZA3V62WtOg' 9-max Seat #2 is the button
Seat 1: qwr38jl5txoR36M7G5qi4A ($10 in chips) 
Seat 2: yqkowiRWZ6NvRN9UUkYIlA ($5 in chips) 
Seat 3: +KblIivb6tainScpwm14RQ ($10.80 in chips) 
Seat 4: UcVReRDrJa8R5MbJDpfsZA ($15 in chips) 
Seat 5: wf5j8xvJtko6ZXyCbzzlVQ ($10 in chips) 
Seat 6: CT7Xj/V/O5rBlhtt+RZeFQ ($38.60 in chips) 
Seat 7: TPAF9YkMsjQFq978RNWZEQ ($22.05 in chips) 
Seat 8: E0iYnEVO2ho7dH3QcCjw7g ($19.65 in chips) 
+KblIivb6tainScpwm14RQ: posts small blind $0.10
UcVReRDrJa8R5MbJDpfsZA: posts big blind $0.25
*** HOLE CARDS ***
wf5j8xvJtko6ZXyCbzzlVQ: folds 
CT7Xj/V/O5rBlhtt+RZeFQ: folds 
TPAF9YkMsjQFq978RNWZEQ: calls $0.25
E0iYnEVO2ho7dH3QcCjw7g: folds 
qwr38jl5txoR36M7G5qi4A: folds 
yqkowiRWZ6NvRN9UUkYIlA: calls $0.25
+KblIivb6tainScpwm14RQ: folds 
UcVReRDrJa8R5MbJDpfsZA has timed out
UcVReRDrJa8R5MbJDpfsZA: checks 
*** FLOP *** [5h Jc Ah]
zUXhymECc2C9W9ZNw6qppA is connected 
UcVReRDrJa8R5MbJDpfsZA has timed out
UcVReRDrJa8R5MbJDpfsZA: checks 
TPAF9YkMsjQFq978RNWZEQ: bets $0.50
yqkowiRWZ6NvRN9UUkYIlA: folds 
zUXhymECc2C9W9ZNw6qppA has returned
UcVReRDrJa8R5MbJDpfsZA: calls $0.50
*** TURN *** [5h Jc Ah] [3d]
UcVReRDrJa8R5MbJDpfsZA: checks 
TPAF9YkMsjQFq978RNWZEQ: bets $0.50
UcVReRDrJa8R5MbJDpfsZA: calls $0.50
*** RIVER *** [5h Jc Ah 3d] [As]
UcVReRDrJa8R5MbJDpfsZA: bets $0.25
TPAF9YkMsjQFq978RNWZEQ: calls $0.25
*** SHOW DOWN ***
UcVReRDrJa8R5MbJDpfsZA: shows [Kd Jh] (two pair, Aces and Jacks)
TPAF9YkMsjQFq978RNWZEQ: shows [Kh Kc] (two pair, Aces and Kings)
TPAF9YkMsjQFq978RNWZEQ collected $3.20 from pot
*** SUMMARY ***
Total pot $3.35 | Rake $0.15 
Board [5h Jc Ah 3d As]
Seat 1: qwr38jl5txoR36M7G5qi4A folded before Flop (didn't bet)
Seat 2: yqkowiRWZ6NvRN9UUkYIlA (button) folded on the Flop
Seat 3: +KblIivb6tainScpwm14RQ (small blind) folded before Flop
Seat 4: UcVReRDrJa8R5MbJDpfsZA (big blind) showed [Kd Jh] and lost with two pair, Aces and Jacks
Seat 5: wf5j8xvJtko6ZXyCbzzlVQ folded before Flop (didn't bet)
Seat 6: CT7Xj/V/O5rBlhtt+RZeFQ folded before Flop (didn't bet)
Seat 7: TPAF9YkMsjQFq978RNWZEQ showed [Kh Kc] and won ($3.20) with two pair, Aces and Kings
Seat 8: E0iYnEVO2ho7dH3QcCjw7g folded before Flop (didn't bet)




PokerStars Game #59941963778:  Hold'em No Limit ($0.10/$0.25) - 2009/07/01 1:51:45 ET
Table 'GrYi0DZOHD1EvB+qiLExNw' 9-max Seat #3 is the button
Seat 1: 7je+LC5Mfs6nL8YBVh4frQ ($5 in chips) 
Seat 2: Th3FldXKQW6hWVVPahaoOQ ($47.05 in chips) 
Seat 3: RHqgdFvufLCYe54+qd2gcA ($4.40 in chips) 
Seat 4: 8x95tVlB4uFBVHp71KihMA ($35.50 in chips) 
Seat 5: cZ99hugmLBj9KhTlc8nCSw ($25 in chips) 
Seat 6: arxNSjreDRGFg13EAM2F1w ($25 in chips) 
Seat 7: 9lvO/qyU+xrU95Teu1fv0g ($23.20 in chips) 
Seat 9: 5hAPbqNrvJb8PtLiceXtlg ($14.45 in chips) 
8x95tVlB4uFBVHp71KihMA: posts small blind $0.10
cZ99hugmLBj9KhTlc8nCSw: posts big blind $0.25
*** HOLE CARDS ***
MtVtHDqIJTyUcXkRBBDIVA leaves the table
arxNSjreDRGFg13EAM2F1w: calls $0.25
9lvO/qyU+xrU95Teu1fv0g: folds 
5hAPbqNrvJb8PtLiceXtlg: folds 
7je+LC5Mfs6nL8YBVh4frQ: folds 
Th3FldXKQW6hWVVPahaoOQ: folds 
RHqgdFvufLCYe54+qd2gcA: folds 
8x95tVlB4uFBVHp71KihMA: calls $0.15
cZ99hugmLBj9KhTlc8nCSw: checks 
*** FLOP *** [2d 7c 6h]
8x95tVlB4uFBVHp71KihMA: checks 
cZ99hugmLBj9KhTlc8nCSw: checks 
arxNSjreDRGFg13EAM2F1w: checks 
*** TURN *** [2d 7c 6h] [As]
8x95tVlB4uFBVHp71KihMA: checks 
cZ99hugmLBj9KhTlc8nCSw: checks 
arxNSjreDRGFg13EAM2F1w: bets $0.25
8x95tVlB4uFBVHp71KihMA: calls $0.25
cZ99hugmLBj9KhTlc8nCSw: folds 
*** RIVER *** [2d 7c 6h As] [5d]
8x95tVlB4uFBVHp71KihMA: checks 
arxNSjreDRGFg13EAM2F1w: bets $0.50
8x95tVlB4uFBVHp71KihMA: folds 
Uncalled bet ($0.50) returned to arxNSjreDRGFg13EAM2F1w
arxNSjreDRGFg13EAM2F1w collected $1.20 from pot
arxNSjreDRGFg13EAM2F1w: doesn't show hand 
*** SUMMARY ***
Total pot $1.25 | Rake $0.05 
Board [2d 7c 6h As 5d]
Seat 1: 7je+LC5Mfs6nL8YBVh4frQ folded before Flop (didn't bet)
Seat 2: Th3FldXKQW6hWVVPahaoOQ folded before Flop (didn't bet)
Seat 3: RHqgdFvufLCYe54+qd2gcA (button) folded before Flop (didn't bet)
Seat 4: 8x95tVlB4uFBVHp71KihMA (small blind) folded on the River
Seat 5: cZ99hugmLBj9KhTlc8nCSw (big blind) folded on the Turn
Seat 6: arxNSjreDRGFg13EAM2F1w collected ($1.20)
Seat 7: 9lvO/qyU+xrU95Teu1fv0g folded before Flop (didn't bet)
Seat 9: 5hAPbqNrvJb8PtLiceXtlg folded before Flop (didn't bet)




PokerStars Game #59941963602:  Hold'em No Limit ($0.10/$0.25) - 2009/07/01 1:51:45 ET
Table 'tANpk8z1C5o0Pq/hpYShHw' 9-max Seat #1 is the button
Seat 1: rQhYIYXSyH/IivYM1dlV5A ($16.75 in chips) 
Seat 2: og4yH4sZUZdC8jjgW8zPJQ ($1.85 in chips) 
Seat 3: zDrucyjVn5aeekNEc3cJrA ($18.55 in chips) 
Seat 4: j4q3p0lesp63b1gZDwLBZw ($5 in chips) 
Seat 5: X6+pSIPfovPcE87t+LmUKQ ($6.80 in chips) 
Seat 6: kN0AWJG6biW8tHtuF+wTjA ($11.95 in chips) 
Seat 7: aNpwfA31EREwO+ar4XzBCw ($26.95 in chips) 
Seat 9: gE5rN2TDY1aXcZn/TOPeZw ($9.50 in chips) 
og4yH4sZUZdC8jjgW8zPJQ: posts small blind $0.10
zDrucyjVn5aeekNEc3cJrA: posts big blind $0.25
V6p0jQ/RhUsqpHLmXvEX4Q: sits out 
*** HOLE CARDS ***
j4q3p0lesp63b1gZDwLBZw: folds 
X6+pSIPfovPcE87t+LmUKQ: folds 
kN0AWJG6biW8tHtuF+wTjA: folds 
aNpwfA31EREwO+ar4XzBCw: folds 
gE5rN2TDY1aXcZn/TOPeZw: calls $0.25
rQhYIYXSyH/IivYM1dlV5A: folds 
og4yH4sZUZdC8jjgW8zPJQ: calls $0.15
zDrucyjVn5aeekNEc3cJrA: checks 
*** FLOP *** [Kc 3c Js]
og4yH4sZUZdC8jjgW8zPJQ: bets $0.25
zDrucyjVn5aeekNEc3cJrA: calls $0.25
gE5rN2TDY1aXcZn/TOPeZw: raises $0.50 to $0.75
og4yH4sZUZdC8jjgW8zPJQ: calls $0.50
zDrucyjVn5aeekNEc3cJrA: folds 
*** TURN *** [Kc 3c Js] [Ts]
og4yH4sZUZdC8jjgW8zPJQ: checks 
gE5rN2TDY1aXcZn/TOPeZw: bets $1.25
og4yH4sZUZdC8jjgW8zPJQ: folds 
Uncalled bet ($1.25) returned to gE5rN2TDY1aXcZn/TOPeZw
gE5rN2TDY1aXcZn/TOPeZw collected $2.40 from pot
gE5rN2TDY1aXcZn/TOPeZw: doesn't show hand 
*** SUMMARY ***
Total pot $2.50 | Rake $0.10 
Board [Kc 3c Js Ts]
Seat 1: rQhYIYXSyH/IivYM1dlV5A (button) folded before Flop (didn't bet)
Seat 2: og4yH4sZUZdC8jjgW8zPJQ (small blind) folded on the Turn
Seat 3: zDrucyjVn5aeekNEc3cJrA (big blind) folded on the Flop
Seat 4: j4q3p0lesp63b1gZDwLBZw folded before Flop (didn't bet)
Seat 5: X6+pSIPfovPcE87t+LmUKQ folded before Flop (didn't bet)
Seat 6: kN0AWJG6biW8tHtuF+wTjA folded before Flop (didn't bet)
Seat 7: aNpwfA31EREwO+ar4XzBCw folded before Flop (didn't bet)
Seat 9: gE5rN2TDY1aXcZn/TOPeZw collected ($2.40)




PokerStars Game #59941963996:  Hold'em No Limit ($0.10/$0.25) - 2009/07/01 1:51:45 ET
Table 'dVzscin98UhGisTmV9BDcw' 9-max Seat #6 is the button
Seat 1: sBAwXpkpgyhyWbHIQcIJKA ($17.15 in chips) 
Seat 2: dfNim92Z6XK1/h5SFW5vDg ($38.50 in chips) 
Seat 3: cZ99hugmLBj9KhTlc8nCSw ($25 in chips) 
Seat 5: E0iYnEVO2ho7dH3QcCjw7g ($24.90 in chips) 
Seat 6: A/OkFabqdcrG3ozpiYMiNQ ($24.90 in chips) 
Seat 7: cKlmpQMahVsmOaxFQDcoOg ($25 in chips) 
Seat 8: /vn2Qu2dvc9AMMq46Ae0jA ($35.50 in chips) 
Seat 9: arxNSjreDRGFg13EAM2F1w ($25 in chips) 
cKlmpQMahVsmOaxFQDcoOg: posts small blind $0.10
/vn2Qu2dvc9AMMq46Ae0jA: posts big blind $0.25
*** HOLE CARDS ***
arxNSjreDRGFg13EAM2F1w: folds 
sBAwXpkpgyhyWbHIQcIJKA: raises $0.50 to $0.75
dfNim92Z6XK1/h5SFW5vDg: folds 
cZ99hugmLBj9KhTlc8nCSw: folds 
E0iYnEVO2ho7dH3QcCjw7g: folds 
A/OkFabqdcrG3ozpiYMiNQ: calls $0.75
cKlmpQMahVsmOaxFQDcoOg: folds 
/vn2Qu2dvc9AMMq46Ae0jA: calls $0.50
*** FLOP *** [6s 6h 3c]
/vn2Qu2dvc9AMMq46Ae0jA: checks 
sBAwXpkpgyhyWbHIQcIJKA: checks 
A/OkFabqdcrG3ozpiYMiNQ: checks 
*** TURN *** [6s 6h 3c] [6c]
/vn2Qu2dvc9AMMq46Ae0jA: bets $1
sBAwXpkpgyhyWbHIQcIJKA: folds 
A/OkFabqdcrG3ozpiYMiNQ: folds 
Uncalled bet ($1) returned to /vn2Qu2dvc9AMMq46Ae0jA
/vn2Qu2dvc9AMMq46Ae0jA collected $2.25 from pot
*** SUMMARY ***
Total pot $2.35 | Rake $0.10 
Board [6s 6h 3c 6c]
Seat 1: sBAwXpkpgyhyWbHIQcIJKA folded on the Turn
Seat 2: dfNim92Z6XK1/h5SFW5vDg folded before Flop (didn't bet)
Seat 3: cZ99hugmLBj9KhTlc8nCSw folded before Flop (didn't bet)
Seat 5: E0iYnEVO2ho7dH3QcCjw7g folded before Flop (didn't bet)
Seat 6: A/OkFabqdcrG3ozpiYMiNQ (button) folded on the Turn
Seat 7: cKlmpQMahVsmOaxFQDcoOg (small blind) folded before Flop
Seat 8: /vn2Qu2dvc9AMMq46Ae0jA (big blind) collected ($2.25)
Seat 9: arxNSjreDRGFg13EAM2F1w folded before Flop (didn't bet)




PokerStars Game #59941963668:  Hold'em No Limit ($0.10/$0.25) - 2009/07/01 1:51:45 ET
Table 'IIO2q2znuuAXmiZ2qFTcmg' 6-max Seat #6 is the button
Seat 2: i9LqF5rD3bvtbEE7HWgr3Q ($27.45 in chips) 
Seat 3: j0aDOn9Nft1HLTQvGu1UwA ($17.40 in chips) 
Seat 5: iHZrkhpIO/3+tKuAoPx8HQ ($8.75 in chips) 
Seat 6: WT1/PiLHYHDQX0orTRlu9g ($14.40 in chips) 
AnnaskyII was removed from the table for failing to post
i9LqF5rD3bvtbEE7HWgr3Q: posts small blind $0.10
j0aDOn9Nft1HLTQvGu1UwA: posts big blind $0.25
*** HOLE CARDS ***
iHZrkhpIO/3+tKuAoPx8HQ: calls $0.25
WT1/PiLHYHDQX0orTRlu9g: raises $0.75 to $1
i9LqF5rD3bvtbEE7HWgr3Q: folds 
j0aDOn9Nft1HLTQvGu1UwA: folds 
iHZrkhpIO/3+tKuAoPx8HQ: calls $0.75
*** FLOP *** [Kd 3h 2d]
iHZrkhpIO/3+tKuAoPx8HQ: checks 
WT1/PiLHYHDQX0orTRlu9g: bets $3
iHZrkhpIO/3+tKuAoPx8HQ: folds 
Uncalled bet ($3) returned to WT1/PiLHYHDQX0orTRlu9g
WT1/PiLHYHDQX0orTRlu9g collected $2.25 from pot
*** SUMMARY ***
Total pot $2.35 | Rake $0.10 
Board [Kd 3h 2d]
Seat 2: i9LqF5rD3bvtbEE7HWgr3Q (small blind) folded before Flop
Seat 3: j0aDOn9Nft1HLTQvGu1UwA (big blind) folded before Flop
Seat 5: iHZrkhpIO/3+tKuAoPx8HQ folded on the Flop
Seat 6: WT1/PiLHYHDQX0orTRlu9g (button) collected ($2.25)




PokerStars Game #59941964034:  Hold'em No Limit ($0.10/$0.25) - 2009/07/01 1:51:45 ET
Table '5NipxzzFB2DffzDpddyQoQ' 6-max Seat #6 is the button
Seat 2: iauW7L/+7qzAuHow7CD75Q ($4.75 in chips) 
Seat 3: QvTX2yGq3uKJiKPmns4TKQ ($25.05 in chips) 
Seat 5: faP2NVl/cFTZ1nE4pXzg8Q ($21.45 in chips) 
Seat 6: 7JqTFMyeNSVWsmp/yW35Tw ($53.70 in chips) 
iauW7L/+7qzAuHow7CD75Q: posts small blind $0.10
QvTX2yGq3uKJiKPmns4TKQ: posts big blind $0.25
Wxq4Qyj0DnDXj2+taEOJFQ: sits out 
*** HOLE CARDS ***
faP2NVl/cFTZ1nE4pXzg8Q: calls $0.25
7JqTFMyeNSVWsmp/yW35Tw: folds 
iauW7L/+7qzAuHow7CD75Q: folds 
QvTX2yGq3uKJiKPmns4TKQ: checks 
*** FLOP *** [Kd 9h Tc]
QvTX2yGq3uKJiKPmns4TKQ: checks 
faP2NVl/cFTZ1nE4pXzg8Q: checks 
*** TURN *** [Kd 9h Tc] [2c]
QvTX2yGq3uKJiKPmns4TKQ: checks 
faP2NVl/cFTZ1nE4pXzg8Q: checks 
*** RIVER *** [Kd 9h Tc 2c] [5d]
QvTX2yGq3uKJiKPmns4TKQ: checks 
faP2NVl/cFTZ1nE4pXzg8Q: checks 
*** SHOW DOWN ***
QvTX2yGq3uKJiKPmns4TKQ: shows [5s Qs] (a pair of Fives)
faP2NVl/cFTZ1nE4pXzg8Q: mucks hand 
QvTX2yGq3uKJiKPmns4TKQ collected $0.60 from pot
*** SUMMARY ***
Total pot $0.60 | Rake $0 
Board [Kd 9h Tc 2c 5d]
Seat 2: iauW7L/+7qzAuHow7CD75Q (small blind) folded before Flop
Seat 3: QvTX2yGq3uKJiKPmns4TKQ (big blind) showed [5s Qs] and won ($0.60) with a pair of Fives
Seat 5: faP2NVl/cFTZ1nE4pXzg8Q mucked
Seat 6: 7JqTFMyeNSVWsmp/yW35Tw (button) folded before Flop (didn't bet)




PokerStars Game #59941963560:  Hold'em No Limit ($0.10/$0.25) - 2009/07/01 1:51:45 ET
Table 'Of/T60zpXg1GcjrZ7Lm//Q' 9-max Seat #3 is the button
Seat 1: Lro4e37x4FUa5P3yzDjskw ($20 in chips) 
Seat 2: qwr38jl5txoR36M7G5qi4A ($9.55 in chips) 
Seat 3: 6RiVTYll/5D8zICp0MRpKw ($22.50 in chips) 
Seat 4: Czut6V7acIqUJrrobjKAZg ($6.55 in chips) 
Seat 5: 6mStmDUknIn/RyBEoiIyoQ ($9 in chips) 
Seat 6: tYsOBqdU1+x+yFI7zHO7hQ ($31.45 in chips) 
Seat 7: PVxvfRTRvkgZf9WtquEkwQ ($25 in chips) 
Seat 8: ghNKXUBl/H+t83JF079ZBA ($26.50 in chips) 
Seat 9: egvg3mTBBVzMHnJPIQiKcA ($15.05 in chips) 
Czut6V7acIqUJrrobjKAZg: posts small blind $0.10
6mStmDUknIn/RyBEoiIyoQ: posts big blind $0.25
*** HOLE CARDS ***
tYsOBqdU1+x+yFI7zHO7hQ: folds 
PVxvfRTRvkgZf9WtquEkwQ: folds 
ghNKXUBl/H+t83JF079ZBA: folds 
egvg3mTBBVzMHnJPIQiKcA: folds 
Lro4e37x4FUa5P3yzDjskw: folds 
qwr38jl5txoR36M7G5qi4A: raises $0.75 to $1
6RiVTYll/5D8zICp0MRpKw: folds 
Czut6V7acIqUJrrobjKAZg: folds 
6mStmDUknIn/RyBEoiIyoQ: calls $0.75
*** FLOP *** [Jh Ad 5h]
6mStmDUknIn/RyBEoiIyoQ: checks 
qwr38jl5txoR36M7G5qi4A: bets $0.75
6mStmDUknIn/RyBEoiIyoQ: raises $0.75 to $1.50
qwr38jl5txoR36M7G5qi4A: raises $0.75 to $2.25
6mStmDUknIn/RyBEoiIyoQ: calls $0.75
*** TURN *** [Jh Ad 5h] [9s]
6mStmDUknIn/RyBEoiIyoQ: checks 
qwr38jl5txoR36M7G5qi4A: bets $1.50
6mStmDUknIn/RyBEoiIyoQ: folds 
Uncalled bet ($1.50) returned to qwr38jl5txoR36M7G5qi4A
qwr38jl5txoR36M7G5qi4A collected $6.30 from pot
qwr38jl5txoR36M7G5qi4A: doesn't show hand 
*** SUMMARY ***
Total pot $6.60 | Rake $0.30 
Board [Jh Ad 5h 9s]
Seat 1: Lro4e37x4FUa5P3yzDjskw folded before Flop (didn't bet)
Seat 2: qwr38jl5txoR36M7G5qi4A collected ($6.30)
Seat 3: 6RiVTYll/5D8zICp0MRpKw (button) folded before Flop (didn't bet)
Seat 4: Czut6V7acIqUJrrobjKAZg (small blind) folded before Flop
Seat 5: 6mStmDUknIn/RyBEoiIyoQ (big blind) folded on the Turn
Seat 6: tYsOBqdU1+x+yFI7zHO7hQ folded before Flop (didn't bet)
Seat 7: PVxvfRTRvkgZf9WtquEkwQ folded before Flop (didn't bet)
Seat 8: ghNKXUBl/H+t83JF079ZBA folded before Flop (didn't bet)
Seat 9: egvg3mTBBVzMHnJPIQiKcA folded before Flop (didn't bet)




PokerStars Game #59941963952:  Hold'em No Limit ($0.10/$0.25) - 2009/07/01 1:51:45 ET
Table 'G+4ZdyRoPjgaJY/jxSlZzQ' 9-max Seat #9 is the button
Seat 1: ghNKXUBl/H+t83JF079ZBA ($23.50 in chips) 
Seat 2: CT7Xj/V/O5rBlhtt+RZeFQ ($25 in chips) 
Seat 3: FaGtAm5QUVcixGhAKIvbLg ($6.15 in chips) 
Seat 4: 3PmVnC/15cl4oyI1TKIt4g ($4.65 in chips) 
Seat 5: BT6Oal0iO4P6kDuT7HFQDw ($23.50 in chips) 
Seat 6: oFwaTjy3ok/+qFghsrcGvg ($21.55 in chips) 
Seat 7: qwr38jl5txoR36M7G5qi4A ($12.15 in chips) 
Seat 8: bXpVeaSTPBFSPJmeXxO7nw ($4.30 in chips) 
Seat 9: tLcDklc2rBORNfixyRfVfw ($26.50 in chips) 
ghNKXUBl/H+t83JF079ZBA: posts small blind $0.10
CT7Xj/V/O5rBlhtt+RZeFQ: posts big blind $0.25
*** HOLE CARDS ***
FaGtAm5QUVcixGhAKIvbLg: folds 
3PmVnC/15cl4oyI1TKIt4g: folds 
BT6Oal0iO4P6kDuT7HFQDw: folds 
oFwaTjy3ok/+qFghsrcGvg: calls $0.25
qwr38jl5txoR36M7G5qi4A: calls $0.25
bXpVeaSTPBFSPJmeXxO7nw: folds 
tLcDklc2rBORNfixyRfVfw: folds 
ghNKXUBl/H+t83JF079ZBA: folds 
CT7Xj/V/O5rBlhtt+RZeFQ: checks 
*** FLOP *** [Jc Jh 5d]
CT7Xj/V/O5rBlhtt+RZeFQ: checks 
oFwaTjy3ok/+qFghsrcGvg: checks 
qwr38jl5txoR36M7G5qi4A: bets $0.75
CT7Xj/V/O5rBlhtt+RZeFQ: folds 
oFwaTjy3ok/+qFghsrcGvg: folds 
Uncalled bet ($0.75) returned to qwr38jl5txoR36M7G5qi4A
qwr38jl5txoR36M7G5qi4A collected $0.85 from pot
qwr38jl5txoR36M7G5qi4A: doesn't show hand 
*** SUMMARY ***
Total pot $0.85 | Rake $0 
Board [Jc Jh 5d]
Seat 1: ghNKXUBl/H+t83JF079ZBA (small blind) folded before Flop
Seat 2: CT7Xj/V/O5rBlhtt+RZeFQ (big blind) folded on the Flop
Seat 3: FaGtAm5QUVcixGhAKIvbLg folded before Flop (didn't bet)
Seat 4: 3PmVnC/15cl4oyI1TKIt4g folded before Flop (didn't bet)
Seat 5: BT6Oal0iO4P6kDuT7HFQDw folded before Flop (didn't bet)
Seat 6: oFwaTjy3ok/+qFghsrcGvg folded on the Flop
Seat 7: qwr38jl5txoR36M7G5qi4A collected ($0.85)
Seat 8: bXpVeaSTPBFSPJmeXxO7nw folded before Flop (didn't bet)
Seat 9: tLcDklc2rBORNfixyRfVfw (button) folded before Flop (didn't bet)




PokerStars Game #59941964356:  Hold'em No Limit ($0.10/$0.25) - 2009/07/01 1:51:46 ET
Table 'pAhiNHs/spaABQia+7gWNQ' 9-max Seat #1 is the button
Seat 1: ipgcO7Pa6LC8XWpVttZfnA ($4.65 in chips) 
Seat 2: dfNim92Z6XK1/h5SFW5vDg ($25 in chips) 
Seat 3: bXpVeaSTPBFSPJmeXxO7nw ($5 in chips) 
Seat 4: Qduu7ikeizo6q6Ei9YvcJA ($48.10 in chips) 
Seat 5: OlPJsgR4xypSg/w1z7Gyvw ($33.60 in chips) 
Seat 6: oLa/tXLfSLLB28mcLGrxcg ($24.25 in chips) 
Seat 7: +WTkVY3GeLxqGQBbMZQiWQ ($10.30 in chips) 
Seat 8: PskTLlFIRHSp61inskRzVg ($9.35 in chips) 
Seat 9: zgi+EUykT/pZQpoUG6+oEg ($5.80 in chips) 
dfNim92Z6XK1/h5SFW5vDg: posts small blind $0.10
bXpVeaSTPBFSPJmeXxO7nw: posts big blind $0.25
*** HOLE CARDS ***
Qduu7ikeizo6q6Ei9YvcJA: folds 
OlPJsgR4xypSg/w1z7Gyvw: folds 
oLa/tXLfSLLB28mcLGrxcg: folds 
+WTkVY3GeLxqGQBbMZQiWQ: folds 
PskTLlFIRHSp61inskRzVg: raises $1 to $1.25
zgi+EUykT/pZQpoUG6+oEg: folds 
ipgcO7Pa6LC8XWpVttZfnA: folds 
dfNim92Z6XK1/h5SFW5vDg: folds 
bXpVeaSTPBFSPJmeXxO7nw: folds 
Uncalled bet ($1) returned to PskTLlFIRHSp61inskRzVg
PskTLlFIRHSp61inskRzVg collected $0.60 from pot
PskTLlFIRHSp61inskRzVg: doesn't show hand 
*** SUMMARY ***
Total pot $0.60 | Rake $0 
Seat 1: ipgcO7Pa6LC8XWpVttZfnA (button) folded before Flop (didn't bet)
Seat 2: dfNim92Z6XK1/h5SFW5vDg (small blind) folded before Flop
Seat 3: bXpVeaSTPBFSPJmeXxO7nw (big blind) folded before Flop
Seat 4: Qduu7ikeizo6q6Ei9YvcJA folded before Flop (didn't bet)
Seat 5: OlPJsgR4xypSg/w1z7Gyvw folded before Flop (didn't bet)
Seat 6: oLa/tXLfSLLB28mcLGrxcg folded before Flop (didn't bet)
Seat 7: +WTkVY3GeLxqGQBbMZQiWQ folded before Flop (didn't bet)
Seat 8: PskTLlFIRHSp61inskRzVg collected ($0.60)
Seat 9: zgi+EUykT/pZQpoUG6+oEg folded before Flop (didn't bet)




PokerStars Game #59941964432:  Hold'em No Limit ($0.10/$0.25) - 2009/07/01 1:51:46 ET
Table 'KYX9dFNuOA9l2PV46IebqQ' 9-max Seat #1 is the button
Seat 1: qZqVFan2U+GAA/c5LQFbcw ($14.70 in chips) 
Seat 2: GeMoapCKDLc4ajT0Uk9ZQw ($9.75 in chips) 
Seat 3: Uq3NSX4cIFaXe7pbXQuU+Q ($7.20 in chips) 
Seat 4: ly/lwri2xlF+wmFsvottuQ ($4.25 in chips) 
Seat 5: g7MXhRmNZxv1lIkKkUKa4w ($19.75 in chips) 
Seat 6: 4QYM+pWPc3J+6i8Zv8LvLg ($25 in chips) 
Seat 8: KRWTiGM4xH+MkvPtJz4+SA ($22.55 in chips) 
Seat 9: 6NECk10orj8iqgD3pZ2A0Q ($6.30 in chips) 
GeMoapCKDLc4ajT0Uk9ZQw: posts small blind $0.10
Uq3NSX4cIFaXe7pbXQuU+Q: posts big blind $0.25
*** HOLE CARDS ***
ly/lwri2xlF+wmFsvottuQ: folds 
FVZtQJMz59M6BoiON/88Xg leaves the table
g7MXhRmNZxv1lIkKkUKa4w: folds 
4QYM+pWPc3J+6i8Zv8LvLg: folds 
KRWTiGM4xH+MkvPtJz4+SA: folds 
6NECk10orj8iqgD3pZ2A0Q: folds 
qZqVFan2U+GAA/c5LQFbcw: folds 
GeMoapCKDLc4ajT0Uk9ZQw: folds 
Uncalled bet ($0.15) returned to Uq3NSX4cIFaXe7pbXQuU+Q
Uq3NSX4cIFaXe7pbXQuU+Q collected $0.20 from pot
*** SUMMARY ***
Total pot $0.20 | Rake $0 
Seat 1: qZqVFan2U+GAA/c5LQFbcw (button) folded before Flop (didn't bet)
Seat 2: GeMoapCKDLc4ajT0Uk9ZQw (small blind) folded before Flop
Seat 3: Uq3NSX4cIFaXe7pbXQuU+Q (big blind) collected ($0.20)
Seat 4: ly/lwri2xlF+wmFsvottuQ folded before Flop (didn't bet)
Seat 5: g7MXhRmNZxv1lIkKkUKa4w folded before Flop (didn't bet)
Seat 6: 4QYM+pWPc3J+6i8Zv8LvLg folded before Flop (didn't bet)
Seat 8: KRWTiGM4xH+MkvPtJz4+SA folded before Flop (didn't bet)
Seat 9: 6NECk10orj8iqgD3pZ2A0Q folded before Flop (didn't bet)




PokerStars Game #59941964290:  Hold'em No Limit ($0.10/$0.25) - 2009/07/01 1:51:46 ET
Table 'vud0GB/ZlDCvUFhBFIaTlg' 9-max Seat #8 is the button
Seat 1: DiSvPC2iudwL5j9u6Huyww ($29.50 in chips) 
Seat 2: tLcDklc2rBORNfixyRfVfw ($25 in chips) 
Seat 3: W2YYHvqjaEpRrO7stZkClQ ($5.05 in chips) 
Seat 5: PFv56Q1PTkDC084eXIAYmw ($5.60 in chips) 
Seat 6: gehe91e0IyVT0QU/XBkEyg ($24.90 in chips) 
Seat 7: iG7VeTyBWf6wYNvZpbTcbw ($22.15 in chips) 
Seat 8: E0iYnEVO2ho7dH3QcCjw7g ($19.25 in chips) 
Seat 9: PdIasPkzm2sqZnN41ZRXOg ($4.95 in chips) 
PdIasPkzm2sqZnN41ZRXOg: posts small blind $0.10
DiSvPC2iudwL5j9u6Huyww: posts big blind $0.25
JqeaikMej6KsqTKmUhl2Lw: sits out 
PFv56Q1PTkDC084eXIAYmw: posts big blind $0.25
*** HOLE CARDS ***
tLcDklc2rBORNfixyRfVfw: folds 
W2YYHvqjaEpRrO7stZkClQ: folds 
PFv56Q1PTkDC084eXIAYmw: checks 
gehe91e0IyVT0QU/XBkEyg: folds 
iG7VeTyBWf6wYNvZpbTcbw: folds 
E0iYnEVO2ho7dH3QcCjw7g: folds 
PdIasPkzm2sqZnN41ZRXOg: calls $0.15
DiSvPC2iudwL5j9u6Huyww: checks 
*** FLOP *** [9h 6d Ac]
PdIasPkzm2sqZnN41ZRXOg: bets $0.50
DiSvPC2iudwL5j9u6Huyww: folds 
PFv56Q1PTkDC084eXIAYmw: folds 
Uncalled bet ($0.50) returned to PdIasPkzm2sqZnN41ZRXOg
PdIasPkzm2sqZnN41ZRXOg collected $0.75 from pot
PdIasPkzm2sqZnN41ZRXOg: doesn't show hand 
*** SUMMARY ***
Total pot $0.75 | Rake $0 
Board [9h 6d Ac]
Seat 1: DiSvPC2iudwL5j9u6Huyww (big blind) folded on the Flop
Seat 2: tLcDklc2rBORNfixyRfVfw folded before Flop (didn't bet)
Seat 3: W2YYHvqjaEpRrO7stZkClQ folded before Flop (didn't bet)
Seat 5: PFv56Q1PTkDC084eXIAYmw folded on the Flop
Seat 6: gehe91e0IyVT0QU/XBkEyg folded before Flop (didn't bet)
Seat 7: iG7VeTyBWf6wYNvZpbTcbw folded before Flop (didn't bet)
Seat 8: E0iYnEVO2ho7dH3QcCjw7g (button) folded before Flop (didn't bet)
Seat 9: PdIasPkzm2sqZnN41ZRXOg (small blind) collected ($0.75)




PokerStars Game #59941964124:  Hold'em No Limit ($0.10/$0.25) - 2009/07/01 1:51:46 ET
Table 'T/iCKJXGphRN3xcdwfE/JQ' 6-max Seat #5 is the button
Seat 2: EeUZtMU058v2ObUACOF4Og ($33.40 in chips) 
Seat 3: IWAjoCPXtc1XUaZdp+pCpA ($22.10 in chips) 
Seat 4: m2yWOKfAxqHoy5DDN87Ttw ($24.65 in chips) 
Seat 5: y85armT09GoP0OGsamp0jA ($18.05 in chips) 
Seat 6: Ey4Kn6PlnYb2srYYBJHvzg ($16.40 in chips) 
Ey4Kn6PlnYb2srYYBJHvzg: posts small blind $0.10
wAKC8C/zN0c8V5v13dm9mA: is sitting out 
EeUZtMU058v2ObUACOF4Og: posts big blind $0.25
*** HOLE CARDS ***
IWAjoCPXtc1XUaZdp+pCpA: folds 
wAKC8C/zN0c8V5v13dm9mA leaves the table
m2yWOKfAxqHoy5DDN87Ttw: raises $0.75 to $1
y85armT09GoP0OGsamp0jA: folds 
Ey4Kn6PlnYb2srYYBJHvzg: calls $0.90
EeUZtMU058v2ObUACOF4Og: folds 
*** FLOP *** [4h 9d 7d]
Ey4Kn6PlnYb2srYYBJHvzg: checks 
m2yWOKfAxqHoy5DDN87Ttw: bets $1.50
Ey4Kn6PlnYb2srYYBJHvzg: calls $1.50
*** TURN *** [4h 9d 7d] [7s]
Ey4Kn6PlnYb2srYYBJHvzg: checks 
m2yWOKfAxqHoy5DDN87Ttw: bets $2.50
Ey4Kn6PlnYb2srYYBJHvzg: raises $2.50 to $5
m2yWOKfAxqHoy5DDN87Ttw: calls $2.50
*** RIVER *** [4h 9d 7d 7s] [7h]
Ey4Kn6PlnYb2srYYBJHvzg: bets $8.90 and is all-in
m2yWOKfAxqHoy5DDN87Ttw: calls $8.90
*** SHOW DOWN ***
Ey4Kn6PlnYb2srYYBJHvzg: shows [9h Th] (a full house, Sevens full of Nines)
m2yWOKfAxqHoy5DDN87Ttw: mucks hand 
Ey4Kn6PlnYb2srYYBJHvzg collected $31.45 from pot
*** SUMMARY ***
Total pot $33.05 | Rake $1.60 
Board [4h 9d 7d 7s 7h]
Seat 2: EeUZtMU058v2ObUACOF4Og (big blind) folded before Flop
Seat 3: IWAjoCPXtc1XUaZdp+pCpA folded before Flop (didn't bet)
Seat 4: m2yWOKfAxqHoy5DDN87Ttw mucked
Seat 5: y85armT09GoP0OGsamp0jA (button) folded before Flop (didn't bet)
Seat 6: Ey4Kn6PlnYb2srYYBJHvzg (small blind) showed [9h Th] and won ($31.45) with a full house, Sevens full of Nines




PokerStars Game #59941964522:  Hold'em No Limit ($0.10/$0.25) - 2009/07/01 1:51:46 ET
Table '6wawJ+MkkvuC3coG6r+Yhg' 6-max Seat #3 is the button
Seat 1: JQZew0FjzS19kTjeNtrE+A ($30.15 in chips) 
Seat 2: LtASJ9OlkqGrrUKGQlpGAw ($20.85 in chips) 
Seat 3: 3zD3qLXT1bEffAoWGnc7wg ($59.40 in chips) 
Seat 4: 9U3ZKjCsarN0DjR6mSE8Ug ($14.35 in chips) 
Seat 5: GbCVUNssQ7mqsPWr7J4d3w ($5 in chips) 
Seat 6: B3X187C0tXFUfQpCu8pe8A ($24.30 in chips) 
9U3ZKjCsarN0DjR6mSE8Ug: posts small blind $0.10
GbCVUNssQ7mqsPWr7J4d3w: posts big blind $0.25
*** HOLE CARDS ***
B3X187C0tXFUfQpCu8pe8A: folds 
JQZew0FjzS19kTjeNtrE+A: folds 
LtASJ9OlkqGrrUKGQlpGAw: folds 
3zD3qLXT1bEffAoWGnc7wg: raises $0.50 to $0.75
9U3ZKjCsarN0DjR6mSE8Ug: folds 
GbCVUNssQ7mqsPWr7J4d3w: folds 
Uncalled bet ($0.50) returned to 3zD3qLXT1bEffAoWGnc7wg
3zD3qLXT1bEffAoWGnc7wg collected $0.60 from pot
3zD3qLXT1bEffAoWGnc7wg: doesn't show hand 
*** SUMMARY ***
Total pot $0.60 | Rake $0 
Seat 1: JQZew0FjzS19kTjeNtrE+A folded before Flop (didn't bet)
Seat 2: LtASJ9OlkqGrrUKGQlpGAw folded before Flop (didn't bet)
Seat 3: 3zD3qLXT1bEffAoWGnc7wg (button) collected ($0.60)
Seat 4: 9U3ZKjCsarN0DjR6mSE8Ug (small blind) folded before Flop
Seat 5: GbCVUNssQ7mqsPWr7J4d3w (big blind) folded before Flop
Seat 6: B3X187C0tXFUfQpCu8pe8A folded before Flop (didn't bet)




PokerStars Game #59941964220:  Hold'em No Limit ($0.10/$0.25) - 2009/07/01 1:51:46 ET
Table 'Qr+t8WGovMECkBv+cV1lrg' 6-max Seat #5 is the button
Seat 1: EeUZtMU058v2ObUACOF4Og ($34.45 in chips) 
Seat 2: vqWjZmdQu/Hxw96/IJTWdQ ($41.60 in chips) 
Seat 3: uZKkrGByYgd4/ZBX2d4z+w ($19.75 in chips) 
Seat 4: 1NNFfYMd5Hsphl/FYz9fNA ($61.05 in chips) 
Seat 5: I50OxuNg9riRq9sywF6jMQ ($4.65 in chips) 
Seat 6: 9U3ZKjCsarN0DjR6mSE8Ug ($14.10 in chips) 
9U3ZKjCsarN0DjR6mSE8Ug: posts small blind $0.10
EeUZtMU058v2ObUACOF4Og: posts big blind $0.25
*** HOLE CARDS ***
vqWjZmdQu/Hxw96/IJTWdQ: folds 
uZKkrGByYgd4/ZBX2d4z+w: folds 
1NNFfYMd5Hsphl/FYz9fNA: raises $0.50 to $0.75
I50OxuNg9riRq9sywF6jMQ: folds 
9U3ZKjCsarN0DjR6mSE8Ug: folds 
EeUZtMU058v2ObUACOF4Og: folds 
Uncalled bet ($0.50) returned to 1NNFfYMd5Hsphl/FYz9fNA
1NNFfYMd5Hsphl/FYz9fNA collected $0.60 from pot
1NNFfYMd5Hsphl/FYz9fNA: doesn't show hand 
*** SUMMARY ***
Total pot $0.60 | Rake $0 
Seat 1: EeUZtMU058v2ObUACOF4Og (big blind) folded before Flop
Seat 2: vqWjZmdQu/Hxw96/IJTWdQ folded before Flop (didn't bet)
Seat 3: uZKkrGByYgd4/ZBX2d4z+w folded before Flop (didn't bet)
Seat 4: 1NNFfYMd5Hsphl/FYz9fNA collected ($0.60)
Seat 5: I50OxuNg9riRq9sywF6jMQ (button) folded before Flop (didn't bet)
Seat 6: 9U3ZKjCsarN0DjR6mSE8Ug (small blind) folded before Flop




PokerStars Game #59941964364:  Hold'em No Limit ($0.10/$0.25) - 2009/07/01 1:51:46 ET
Table 'ykyWGjhNu7AvZXov27T4ew' 9-max Seat #4 is the button
Seat 1: skUI2T7o4P1rz460mMbAOg ($10.25 in chips) 
Seat 2: MG90wfSJZnOejs/KD3vlQQ ($38.85 in chips) 
Seat 3: NPI9ArW8kwrb6a2IAL6xMQ ($25 in chips) 
Seat 4: W6tExOcYX7qiy6Qdp+ZwFA ($5.60 in chips) 
Seat 5: CmngQmkKTp8tkl6GMRTl6w ($16.40 in chips) 
Seat 6: AiXn/9o1EwOPZUHujnh/bA ($20.15 in chips) 
Seat 8: tYsOBqdU1+x+yFI7zHO7hQ ($48.85 in chips) 
CmngQmkKTp8tkl6GMRTl6w: posts small blind $0.10
AiXn/9o1EwOPZUHujnh/bA: posts big blind $0.25
H5Se03ZqSX7tbULXur2MAg: sits out 
*** HOLE CARDS ***
tYsOBqdU1+x+yFI7zHO7hQ: raises $0.75 to $1
skUI2T7o4P1rz460mMbAOg: folds 
MG90wfSJZnOejs/KD3vlQQ: folds 
NPI9ArW8kwrb6a2IAL6xMQ: calls $1
W6tExOcYX7qiy6Qdp+ZwFA: folds 
CmngQmkKTp8tkl6GMRTl6w: folds 
AiXn/9o1EwOPZUHujnh/bA: folds 
*** FLOP *** [4c 5c 8h]
tYsOBqdU1+x+yFI7zHO7hQ: checks 
NPI9ArW8kwrb6a2IAL6xMQ: bets $1
tYsOBqdU1+x+yFI7zHO7hQ: folds 
Uncalled bet ($1) returned to NPI9ArW8kwrb6a2IAL6xMQ
NPI9ArW8kwrb6a2IAL6xMQ collected $2.25 from pot
*** SUMMARY ***
Total pot $2.35 | Rake $0.10 
Board [4c 5c 8h]
Seat 1: skUI2T7o4P1rz460mMbAOg folded before Flop (didn't bet)
Seat 2: MG90wfSJZnOejs/KD3vlQQ folded before Flop (didn't bet)
Seat 3: NPI9ArW8kwrb6a2IAL6xMQ collected ($2.25)
Seat 4: W6tExOcYX7qiy6Qdp+ZwFA (button) folded before Flop (didn't bet)
Seat 5: CmngQmkKTp8tkl6GMRTl6w (small blind) folded before Flop
Seat 6: AiXn/9o1EwOPZUHujnh/bA (big blind) folded before Flop
Seat 8: tYsOBqdU1+x+yFI7zHO7hQ folded on the Flop




PokerStars Game #59941964628:  Hold'em No Limit ($0.10/$0.25) - 2009/07/01 1:51:47 ET
Table 'sJ4KpS2GE5Qrsu1/cFjJUw' 9-max Seat #8 is the button
Seat 1: eDlQ+S+6L4e6gM1dkZhGgQ ($19.70 in chips) 
Seat 3: eK8qa6EPcH2zhtbmWSvc9g ($25 in chips) 
Seat 5: Q/gZC63lfOMr7YhWKPCxoQ ($7.65 in chips) 
Seat 6: OefE+Csvj5KR7ClGf3Hc2g ($3.75 in chips) 
Seat 7: Wi8djHgewBlVhpKWfp7isQ ($9.15 in chips) 
Seat 8: S7Ki0P+0AIGPuIfGJjW0gg ($30.35 in chips) 
Seat 9: 3PmVnC/15cl4oyI1TKIt4g ($4.95 in chips) 
3PmVnC/15cl4oyI1TKIt4g: posts small blind $0.10
eDlQ+S+6L4e6gM1dkZhGgQ: posts big blind $0.25
ydoFOVgzvZv9ZhuWu9rXAw: sits out 
*** HOLE CARDS ***
eK8qa6EPcH2zhtbmWSvc9g: folds 
Q/gZC63lfOMr7YhWKPCxoQ: calls $0.25
OefE+Csvj5KR7ClGf3Hc2g: folds 
Wi8djHgewBlVhpKWfp7isQ: calls $0.25
S7Ki0P+0AIGPuIfGJjW0gg: calls $0.25
3PmVnC/15cl4oyI1TKIt4g: folds 
eDlQ+S+6L4e6gM1dkZhGgQ: checks 
*** FLOP *** [9h Kc Ks]
eDlQ+S+6L4e6gM1dkZhGgQ: bets $0.25
Q/gZC63lfOMr7YhWKPCxoQ: folds 
Wi8djHgewBlVhpKWfp7isQ: calls $0.25
S7Ki0P+0AIGPuIfGJjW0gg: folds 
*** TURN *** [9h Kc Ks] [2c]
eDlQ+S+6L4e6gM1dkZhGgQ: bets $0.25
Wi8djHgewBlVhpKWfp7isQ: calls $0.25
*** RIVER *** [9h Kc Ks 2c] [Qd]
eDlQ+S+6L4e6gM1dkZhGgQ: bets $0.25
Wi8djHgewBlVhpKWfp7isQ: raises $1.75 to $2
eDlQ+S+6L4e6gM1dkZhGgQ: calls $1.75
*** SHOW DOWN ***
Wi8djHgewBlVhpKWfp7isQ: shows [Js Th] (a straight, Nine to King)
eDlQ+S+6L4e6gM1dkZhGgQ: mucks hand 
Wi8djHgewBlVhpKWfp7isQ collected $5.80 from pot
*** SUMMARY ***
Total pot $6.10 | Rake $0.30 
Board [9h Kc Ks 2c Qd]
Seat 1: eDlQ+S+6L4e6gM1dkZhGgQ (big blind) mucked
Seat 3: eK8qa6EPcH2zhtbmWSvc9g folded before Flop (didn't bet)
Seat 5: Q/gZC63lfOMr7YhWKPCxoQ folded on the Flop
Seat 6: OefE+Csvj5KR7ClGf3Hc2g folded before Flop (didn't bet)
Seat 7: Wi8djHgewBlVhpKWfp7isQ showed [Js Th] and won ($5.80) with a straight, Nine to King
Seat 8: S7Ki0P+0AIGPuIfGJjW0gg (button) folded on the Flop
Seat 9: 3PmVnC/15cl4oyI1TKIt4g (small blind) folded before Flop




PokerStars Game #59941964598:  Hold'em No Limit ($0.10/$0.25) - 2009/07/01 1:51:47 ET
Table 'ggwTHpIC5qhhHJSYjK1XCw' 6-max Seat #3 is the button
Seat 1: QkldTZNd6k/x09xKp/8lIw ($4.75 in chips) 
Seat 2: /gJNBeCkWL4o85/jvlZ4BA ($25 in chips) 
Seat 3: 7cx44/slbeTw+Cy7QB8Trg ($24 in chips) 
Seat 4: JFIAqU8lCZ0vWwEl4bdGsg ($26.25 in chips) 
Seat 5: BvqhBa7W/To51LhEiIU/lw ($8.10 in chips) 
Seat 6: 732E3Iz0geWMK40ej+U9HA ($9.05 in chips) 
JFIAqU8lCZ0vWwEl4bdGsg: posts small blind $0.10
BvqhBa7W/To51LhEiIU/lw: posts big blind $0.25
*** HOLE CARDS ***
732E3Iz0geWMK40ej+U9HA: folds 
QkldTZNd6k/x09xKp/8lIw: folds 
/gJNBeCkWL4o85/jvlZ4BA: raises $0.75 to $1
7cx44/slbeTw+Cy7QB8Trg: calls $1
JFIAqU8lCZ0vWwEl4bdGsg: folds 
BvqhBa7W/To51LhEiIU/lw: calls $0.75
*** FLOP *** [Qd Tc 5h]
BvqhBa7W/To51LhEiIU/lw: checks 
/gJNBeCkWL4o85/jvlZ4BA: checks 
7cx44/slbeTw+Cy7QB8Trg: checks 
*** TURN *** [Qd Tc 5h] [Ks]
BvqhBa7W/To51LhEiIU/lw: checks 
/gJNBeCkWL4o85/jvlZ4BA: checks 
7cx44/slbeTw+Cy7QB8Trg: checks 
*** RIVER *** [Qd Tc 5h Ks] [8h]
BvqhBa7W/To51LhEiIU/lw: bets $0.25
/gJNBeCkWL4o85/jvlZ4BA: folds 
7cx44/slbeTw+Cy7QB8Trg: calls $0.25
*** SHOW DOWN ***
BvqhBa7W/To51LhEiIU/lw: shows [4c As] (high card Ace)
7cx44/slbeTw+Cy7QB8Trg: shows [9d 9h] (a pair of Nines)
7cx44/slbeTw+Cy7QB8Trg collected $3.45 from pot
*** SUMMARY ***
Total pot $3.60 | Rake $0.15 
Board [Qd Tc 5h Ks 8h]
Seat 1: QkldTZNd6k/x09xKp/8lIw folded before Flop (didn't bet)
Seat 2: /gJNBeCkWL4o85/jvlZ4BA folded on the River
Seat 3: 7cx44/slbeTw+Cy7QB8Trg (button) showed [9d 9h] and won ($3.45) with a pair of Nines
Seat 4: JFIAqU8lCZ0vWwEl4bdGsg (small blind) folded before Flop
Seat 5: BvqhBa7W/To51LhEiIU/lw (big blind) showed [4c As] and lost with high card Ace
Seat 6: 732E3Iz0geWMK40ej+U9HA folded before Flop (didn't bet)




PokerStars Game #59941964650:  Hold'em No Limit ($0.10/$0.25) - 2009/07/01 1:51:47 ET
Table 'qryc9C/ELyQ3lubOaELNAQ' 6-max Seat #4 is the button
Seat 1: OZc6kkoTwtITj1ZfreJK1A ($84.30 in chips) 
Seat 2: LtASJ9OlkqGrrUKGQlpGAw ($29.45 in chips) 
Seat 3: wvIIdlbCgePONQwXjx9xzQ ($3.35 in chips) 
Seat 4: v+QfkGiuj9bgtuNoVnDO8w ($25 in chips) 
Seat 5: 9StOHp+Y1T0K13JdgS2oQQ ($38.30 in chips) 
9StOHp+Y1T0K13JdgS2oQQ: posts small blind $0.10
OZc6kkoTwtITj1ZfreJK1A: posts big blind $0.25
*** HOLE CARDS ***
LtASJ9OlkqGrrUKGQlpGAw: folds 
wvIIdlbCgePONQwXjx9xzQ: folds 
xmdItDBraeGrrs3wzz1J3w leaves the table
v+QfkGiuj9bgtuNoVnDO8w: folds 
9StOHp+Y1T0K13JdgS2oQQ: folds 
Uncalled bet ($0.15) returned to OZc6kkoTwtITj1ZfreJK1A
OZc6kkoTwtITj1ZfreJK1A collected $0.20 from pot
OZc6kkoTwtITj1ZfreJK1A: doesn't show hand 
*** SUMMARY ***
Total pot $0.20 | Rake $0 
Seat 1: OZc6kkoTwtITj1ZfreJK1A (big blind) collected ($0.20)
Seat 2: LtASJ9OlkqGrrUKGQlpGAw folded before Flop (didn't bet)
Seat 3: wvIIdlbCgePONQwXjx9xzQ folded before Flop (didn't bet)
Seat 4: v+QfkGiuj9bgtuNoVnDO8w (button) folded before Flop (didn't bet)
Seat 5: 9StOHp+Y1T0K13JdgS2oQQ (small blind) folded before Flop




PokerStars Game #59941965588:  Hold'em No Limit ($0.10/$0.25) - 2009/07/01 1:51:48 ET
Table 'RUOqTfzbAVGS5x+J9aZMHA' 9-max Seat #1 is the button
Seat 1: DnDcAdn9P0zGovMERigpFA ($28.30 in chips) 
Seat 2: Z5ZtGOON8kmSdSCll9Z3XA ($6.10 in chips) 
Seat 3: Th3FldXKQW6hWVVPahaoOQ ($25 in chips) 
Seat 4: K9Az8li/CO2TicltVWKamA ($26.75 in chips) 
Seat 5: MtVtHDqIJTyUcXkRBBDIVA ($33.55 in chips) 
Seat 6: ljemhp25Zg+nlA9DLCIiUw ($48 in chips) 
Seat 7: zgi+EUykT/pZQpoUG6+oEg ($5 in chips) 
Seat 9: cZ99hugmLBj9KhTlc8nCSw ($25 in chips) 
Z5ZtGOON8kmSdSCll9Z3XA: posts small blind $0.10
Th3FldXKQW6hWVVPahaoOQ: posts big blind $0.25
*** HOLE CARDS ***
K9Az8li/CO2TicltVWKamA: calls $0.25
MtVtHDqIJTyUcXkRBBDIVA: folds 
ljemhp25Zg+nlA9DLCIiUw: folds 
zgi+EUykT/pZQpoUG6+oEg: folds 
cZ99hugmLBj9KhTlc8nCSw: folds 
DnDcAdn9P0zGovMERigpFA: folds 
Z5ZtGOON8kmSdSCll9Z3XA: raises $0.50 to $0.75
Th3FldXKQW6hWVVPahaoOQ: folds 
K9Az8li/CO2TicltVWKamA: calls $0.50
*** FLOP *** [Jc As Kd]
Z5ZtGOON8kmSdSCll9Z3XA: bets $0.50
K9Az8li/CO2TicltVWKamA: calls $0.50
*** TURN *** [Jc As Kd] [Td]
Z5ZtGOON8kmSdSCll9Z3XA: bets $1.25
K9Az8li/CO2TicltVWKamA: calls $1.25
*** RIVER *** [Jc As Kd Td] [3d]
Z5ZtGOON8kmSdSCll9Z3XA: bets $3
K9Az8li/CO2TicltVWKamA: calls $3
*** SHOW DOWN ***
Z5ZtGOON8kmSdSCll9Z3XA: shows [Qs Qh] (a straight, Ten to Ace)
K9Az8li/CO2TicltVWKamA: mucks hand 
Z5ZtGOON8kmSdSCll9Z3XA collected $10.70 from pot
*** SUMMARY ***
Total pot $11.25 | Rake $0.55 
Board [Jc As Kd Td 3d]
Seat 1: DnDcAdn9P0zGovMERigpFA (button) folded before Flop (didn't bet)
Seat 2: Z5ZtGOON8kmSdSCll9Z3XA (small blind) showed [Qs Qh] and won ($10.70) with a straight, Ten to Ace
Seat 3: Th3FldXKQW6hWVVPahaoOQ (big blind) folded before Flop
Seat 4: K9Az8li/CO2TicltVWKamA mucked
Seat 5: MtVtHDqIJTyUcXkRBBDIVA folded before Flop (didn't bet)
Seat 6: ljemhp25Zg+nlA9DLCIiUw folded before Flop (didn't bet)
Seat 7: zgi+EUykT/pZQpoUG6+oEg folded before Flop (didn't bet)
Seat 9: cZ99hugmLBj9KhTlc8nCSw folded before Flop (didn't bet)




PokerStars Game #59941965304:  Hold'em No Limit ($0.10/$0.25) - 2009/07/01 1:51:48 ET
Table 'hOE09W281uSob0XeJmUcRg' 6-max Seat #3 is the button
Seat 1: mfrkWA3PTeYPkbO6hi98Aw ($27.60 in chips) 
Seat 2: lRKJ8o/CnOPFwfHHm6ioMw ($11.80 in chips) 
Seat 3: y+a/yGW/Jy4bPJFnaeTz5w ($12.10 in chips) 
Seat 5: JFIAqU8lCZ0vWwEl4bdGsg ($25.55 in chips) 
Seat 6: x4ZJ8E/TUrtoB7WiHcv8WA ($18.05 in chips) 
Shady697 was removed from the table for failing to post
JFIAqU8lCZ0vWwEl4bdGsg: posts small blind $0.10
x4ZJ8E/TUrtoB7WiHcv8WA: posts big blind $0.25
*** HOLE CARDS ***
mfrkWA3PTeYPkbO6hi98Aw: folds 
lRKJ8o/CnOPFwfHHm6ioMw: folds 
y+a/yGW/Jy4bPJFnaeTz5w: folds 
JFIAqU8lCZ0vWwEl4bdGsg: folds 
Uncalled bet ($0.15) returned to x4ZJ8E/TUrtoB7WiHcv8WA
MVzl6OsGybVDNd3Vr9LYAA joins the table at seat #4 
x4ZJ8E/TUrtoB7WiHcv8WA collected $0.20 from pot
x4ZJ8E/TUrtoB7WiHcv8WA: doesn't show hand 
*** SUMMARY ***
Total pot $0.20 | Rake $0 
Seat 1: mfrkWA3PTeYPkbO6hi98Aw folded before Flop (didn't bet)
Seat 2: lRKJ8o/CnOPFwfHHm6ioMw folded before Flop (didn't bet)
Seat 3: y+a/yGW/Jy4bPJFnaeTz5w (button) folded before Flop (didn't bet)
Seat 5: JFIAqU8lCZ0vWwEl4bdGsg (small blind) folded before Flop
Seat 6: x4ZJ8E/TUrtoB7WiHcv8WA (big blind) collected ($0.20)




PokerStars Game #59941965482:  Hold'em No Limit ($0.10/$0.25) - 2009/07/01 1:51:48 ET
Table 'M8kYidAX3ib7pLKW7edFLw' 6-max Seat #2 is the button
Seat 1: jp34e617tIzV8tKIWmfAbA ($26.30 in chips) 
Seat 2: ypmjhffk/YHGc51wgVXUTw ($25 in chips) 
Seat 3: cezpHJ8FB07dj0xG+LhOvw ($27.15 in chips) 
Seat 5: GbCVUNssQ7mqsPWr7J4d3w ($5 in chips) 
Seat 6: NqFoyDgzLwu4dOmSRXnFBA ($22.85 in chips) 
cezpHJ8FB07dj0xG+LhOvw: posts small blind $0.10
GbCVUNssQ7mqsPWr7J4d3w: posts big blind $0.25
*** HOLE CARDS ***
NqFoyDgzLwu4dOmSRXnFBA: folds 
jp34e617tIzV8tKIWmfAbA: folds 
ypmjhffk/YHGc51wgVXUTw: folds 
cezpHJ8FB07dj0xG+LhOvw: folds 
Uncalled bet ($0.15) returned to GbCVUNssQ7mqsPWr7J4d3w
GbCVUNssQ7mqsPWr7J4d3w collected $0.20 from pot
GbCVUNssQ7mqsPWr7J4d3w: doesn't show hand 
*** SUMMARY ***
Total pot $0.20 | Rake $0 
Seat 1: jp34e617tIzV8tKIWmfAbA folded before Flop (didn't bet)
Seat 2: ypmjhffk/YHGc51wgVXUTw (button) folded before Flop (didn't bet)
Seat 3: cezpHJ8FB07dj0xG+LhOvw (small blind) folded before Flop
Seat 5: GbCVUNssQ7mqsPWr7J4d3w (big blind) collected ($0.20)
Seat 6: NqFoyDgzLwu4dOmSRXnFBA folded before Flop (didn't bet)




PokerStars Game #59941965324:  Hold'em No Limit ($0.10/$0.25) - 2009/07/01 1:51:48 ET
Table 'hfHe8uKeSJMyWAjSdM7ROQ' 6-max Seat #3 is the button
Seat 1: eHsmIvAb2JREg4O6hNPnXg ($43.80 in chips) 
Seat 2: QvTX2yGq3uKJiKPmns4TKQ ($29.20 in chips) 
Seat 3: dOX4wnYV2sEqvDbF+8KSCw ($25 in chips) 
Seat 4: b4wRQV3APH8irVk6bUFe2Q ($32.90 in chips) 
Seat 5: euswrBD1XG0Q5hB1iGJBKQ ($60.80 in chips) 
Seat 6: eL3+wCBjFGfQ5FMdIZihwA ($26.75 in chips) 
b4wRQV3APH8irVk6bUFe2Q: posts small blind $0.10
euswrBD1XG0Q5hB1iGJBKQ: posts big blind $0.25
*** HOLE CARDS ***
eL3+wCBjFGfQ5FMdIZihwA: folds 
eHsmIvAb2JREg4O6hNPnXg: folds 
QvTX2yGq3uKJiKPmns4TKQ: folds 
dOX4wnYV2sEqvDbF+8KSCw: raises $0.75 to $1
b4wRQV3APH8irVk6bUFe2Q: folds 
euswrBD1XG0Q5hB1iGJBKQ: calls $0.75
*** FLOP *** [9h Ac Qc]
euswrBD1XG0Q5hB1iGJBKQ: checks 
dOX4wnYV2sEqvDbF+8KSCw: checks 
*** TURN *** [9h Ac Qc] [5h]
euswrBD1XG0Q5hB1iGJBKQ: checks 
dOX4wnYV2sEqvDbF+8KSCw: bets $1.50
euswrBD1XG0Q5hB1iGJBKQ: folds 
Uncalled bet ($1.50) returned to dOX4wnYV2sEqvDbF+8KSCw
dOX4wnYV2sEqvDbF+8KSCw collected $2 from pot
dOX4wnYV2sEqvDbF+8KSCw: doesn't show hand 
*** SUMMARY ***
Total pot $2.10 | Rake $0.10 
Board [9h Ac Qc 5h]
Seat 1: eHsmIvAb2JREg4O6hNPnXg folded before Flop (didn't bet)
Seat 2: QvTX2yGq3uKJiKPmns4TKQ folded before Flop (didn't bet)
Seat 3: dOX4wnYV2sEqvDbF+8KSCw (button) collected ($2)
Seat 4: b4wRQV3APH8irVk6bUFe2Q (small blind) folded before Flop
Seat 5: euswrBD1XG0Q5hB1iGJBKQ (big blind) folded on the Turn
Seat 6: eL3+wCBjFGfQ5FMdIZihwA folded before Flop (didn't bet)




PokerStars Game #59941965842:  Hold'em No Limit ($0.10/$0.25) - 2009/07/01 1:51:49 ET
Table '4XGDnEByOol5up4aB2KbJw' 6-max Seat #6 is the button
Seat 1: kyRaCIljYA6l33lSKQfNsg ($26.85 in chips) 
Seat 2: SFmT9ZsVopnukjvAzrxTRg ($45.90 in chips) 
Seat 3: LtASJ9OlkqGrrUKGQlpGAw ($18.55 in chips) 
Seat 4: BV+K0Phf5VBHr7aZPKqbUQ ($25 in chips) 
Seat 5: Dh01+rohD2p9pXLYeBlC5Q ($19.40 in chips) 
Seat 6: a7Ux7aERFGCbT/L3ojVfAg ($10.15 in chips) 
kyRaCIljYA6l33lSKQfNsg: posts small blind $0.10
SFmT9ZsVopnukjvAzrxTRg: posts big blind $0.25
*** HOLE CARDS ***
LtASJ9OlkqGrrUKGQlpGAw: folds 
BV+K0Phf5VBHr7aZPKqbUQ: folds 
Dh01+rohD2p9pXLYeBlC5Q: folds 
a7Ux7aERFGCbT/L3ojVfAg: calls $0.25
kyRaCIljYA6l33lSKQfNsg: folds 
SFmT9ZsVopnukjvAzrxTRg: checks 
*** FLOP *** [7s 3h 9c]
SFmT9ZsVopnukjvAzrxTRg: checks 
a7Ux7aERFGCbT/L3ojVfAg: checks 
*** TURN *** [7s 3h 9c] [Js]
SFmT9ZsVopnukjvAzrxTRg: checks 
a7Ux7aERFGCbT/L3ojVfAg: bets $0.25
SFmT9ZsVopnukjvAzrxTRg: folds 
Uncalled bet ($0.25) returned to a7Ux7aERFGCbT/L3ojVfAg
a7Ux7aERFGCbT/L3ojVfAg collected $0.60 from pot
*** SUMMARY ***
Total pot $0.60 | Rake $0 
Board [7s 3h 9c Js]
Seat 1: kyRaCIljYA6l33lSKQfNsg (small blind) folded before Flop
Seat 2: SFmT9ZsVopnukjvAzrxTRg (big blind) folded on the Turn
Seat 3: LtASJ9OlkqGrrUKGQlpGAw folded before Flop (didn't bet)
Seat 4: BV+K0Phf5VBHr7aZPKqbUQ folded before Flop (didn't bet)
Seat 5: Dh01+rohD2p9pXLYeBlC5Q folded before Flop (didn't bet)
Seat 6: a7Ux7aERFGCbT/L3ojVfAg (button) collected ($0.60)




PokerStars Game #59941965956:  Hold'em No Limit ($0.10/$0.25) - 2009/07/01 1:51:49 ET
Table '2VkNDXXsBj4bSZw/uK5atw' 6-max Seat #3 is the button
Seat 1: xrf8tAXKQHG99HixCot1Iw ($25 in chips) 
Seat 2: GbCVUNssQ7mqsPWr7J4d3w ($4.65 in chips) 
Seat 3: P+6Z5+8H5/Wyt/jHMovNvQ ($26.70 in chips) 
Seat 4: 4kIRqWKE/N0yUAcWVhLSoQ ($14.85 in chips) 
Seat 5: 7f0OkhFEOf3T+rVOFHRLnw ($19.75 in chips) 
Seat 6: n6UPMnVR4v8LFP0rWP73Fg ($11.85 in chips) 
4kIRqWKE/N0yUAcWVhLSoQ: posts small blind $0.10
7f0OkhFEOf3T+rVOFHRLnw: posts big blind $0.25
*** HOLE CARDS ***
n6UPMnVR4v8LFP0rWP73Fg: folds 
xrf8tAXKQHG99HixCot1Iw: folds 
GbCVUNssQ7mqsPWr7J4d3w: folds 
P+6Z5+8H5/Wyt/jHMovNvQ: calls $0.25
4kIRqWKE/N0yUAcWVhLSoQ: calls $0.15
7f0OkhFEOf3T+rVOFHRLnw: checks 
*** FLOP *** [3d Tc 8h]
4kIRqWKE/N0yUAcWVhLSoQ: bets $0.25
7f0OkhFEOf3T+rVOFHRLnw: calls $0.25
P+6Z5+8H5/Wyt/jHMovNvQ: folds 
*** TURN *** [3d Tc 8h] [8s]
4kIRqWKE/N0yUAcWVhLSoQ: bets $0.25
7f0OkhFEOf3T+rVOFHRLnw: calls $0.25
*** RIVER *** [3d Tc 8h 8s] [5h]
4kIRqWKE/N0yUAcWVhLSoQ: checks 
7f0OkhFEOf3T+rVOFHRLnw: bets $1.25
4kIRqWKE/N0yUAcWVhLSoQ: calls $1.25
*** SHOW DOWN ***
7f0OkhFEOf3T+rVOFHRLnw: shows [9d Js] (a pair of Eights)
4kIRqWKE/N0yUAcWVhLSoQ: shows [Ks 3s] (two pair, Eights and Threes)
4kIRqWKE/N0yUAcWVhLSoQ collected $4.05 from pot
*** SUMMARY ***
Total pot $4.25 | Rake $0.20 
Board [3d Tc 8h 8s 5h]
Seat 1: xrf8tAXKQHG99HixCot1Iw folded before Flop (didn't bet)
Seat 2: GbCVUNssQ7mqsPWr7J4d3w folded before Flop (didn't bet)
Seat 3: P+6Z5+8H5/Wyt/jHMovNvQ (button) folded on the Flop
Seat 4: 4kIRqWKE/N0yUAcWVhLSoQ (small blind) showed [Ks 3s] and won ($4.05) with two pair, Eights and Threes
Seat 5: 7f0OkhFEOf3T+rVOFHRLnw (big blind) showed [9d Js] and lost with a pair of Eights
Seat 6: n6UPMnVR4v8LFP0rWP73Fg folded before Flop (didn't bet)




PokerStars Game #59941965720:  Hold'em No Limit ($0.10/$0.25) - 2009/07/01 1:51:49 ET
Table 'rO1I30HnuCPB0M8qEX1TCQ' 9-max Seat #8 is the button
Seat 1: Utuc935Snv3aKbSqGcz2Kg ($14.75 in chips) 
Seat 2: z1hPotrGOZjUjyoopZ7Ulg ($25.15 in chips) 
Seat 3: 2wcFsZsqEP5w1StUTVzJCg ($12.80 in chips) 
Seat 4: yyG4svzOpC1A+sUP/scg6w ($18.05 in chips) 
Seat 6: 5n7e7I+px7c6CQmLpPbtsg ($6.25 in chips) 
Seat 7: AiXn/9o1EwOPZUHujnh/bA ($21.90 in chips) 
Seat 8: CGjLyv/AvljZy2g76nYkzQ ($25 in chips) 
SpiiQQAzy4MUgV3I5W8giw will be allowed to play after the button
Utuc935Snv3aKbSqGcz2Kg: posts small blind $0.10
z1hPotrGOZjUjyoopZ7Ulg: posts big blind $0.25
AiXn/9o1EwOPZUHujnh/bA: posts big blind $0.25
*** HOLE CARDS ***
2wcFsZsqEP5w1StUTVzJCg: folds 
yyG4svzOpC1A+sUP/scg6w: folds 
5n7e7I+px7c6CQmLpPbtsg: folds 
AiXn/9o1EwOPZUHujnh/bA: checks 
CGjLyv/AvljZy2g76nYkzQ: raises $1 to $1.25
WQe4GbiYBiPsb5WKFKkijQ leaves the table
Utuc935Snv3aKbSqGcz2Kg: calls $1.15
z1hPotrGOZjUjyoopZ7Ulg: folds 
AiXn/9o1EwOPZUHujnh/bA: folds 
*** FLOP *** [3d 2s Qc]
Utuc935Snv3aKbSqGcz2Kg: checks 
W2YYHvqjaEpRrO7stZkClQ joins the table at seat #5 
CGjLyv/AvljZy2g76nYkzQ: bets $1.75
Utuc935Snv3aKbSqGcz2Kg: calls $1.75
*** TURN *** [3d 2s Qc] [4c]
Utuc935Snv3aKbSqGcz2Kg: checks 
CGjLyv/AvljZy2g76nYkzQ: checks 
*** RIVER *** [3d 2s Qc 4c] [Ad]
Utuc935Snv3aKbSqGcz2Kg: checks 
CGjLyv/AvljZy2g76nYkzQ: checks 
*** SHOW DOWN ***
Utuc935Snv3aKbSqGcz2Kg: shows [9s 9h] (a pair of Nines)
CGjLyv/AvljZy2g76nYkzQ: shows [Qs Jd] (a pair of Queens)
CGjLyv/AvljZy2g76nYkzQ collected $6.20 from pot
*** SUMMARY ***
Total pot $6.50 | Rake $0.30 
Board [3d 2s Qc 4c Ad]
Seat 1: Utuc935Snv3aKbSqGcz2Kg (small blind) showed [9s 9h] and lost with a pair of Nines
Seat 2: z1hPotrGOZjUjyoopZ7Ulg (big blind) folded before Flop
Seat 3: 2wcFsZsqEP5w1StUTVzJCg folded before Flop (didn't bet)
Seat 4: yyG4svzOpC1A+sUP/scg6w folded before Flop (didn't bet)
Seat 6: 5n7e7I+px7c6CQmLpPbtsg folded before Flop (didn't bet)
Seat 7: AiXn/9o1EwOPZUHujnh/bA folded before Flop
Seat 8: CGjLyv/AvljZy2g76nYkzQ (button) showed [Qs Jd] and won ($6.20) with a pair of Queens




PokerStars Game #59941965852:  Hold'em No Limit ($0.10/$0.25) - 2009/07/01 1:51:49 ET
Table 'ktio12Pyq06LsrFhIorSqA' 9-max Seat #8 is the button
Seat 2: tGsFgUKjSctVaAXabrlZxw ($4.70 in chips) 
Seat 3: Z9W7+g1WMhhZDi7DwGbCFA ($5 in chips) 
Seat 4: 0QdZrkFD7aGKeBXPGbIomA ($11.15 in chips) 
Seat 5: e0pV1oisCAilWiG0FCxY6A ($14.35 in chips) 
Seat 6: jQL6XIewylQ8MmZhhq2YFg ($39.40 in chips) 
Seat 7: XGCfQsxa6PfAg3kJtzUmww ($21.75 in chips) 
Seat 8: Z5y2J55JmfLYR6/DPAGHwQ ($11.85 in chips) 
Seat 9: H5Se03ZqSX7tbULXur2MAg ($25.65 in chips) 
H5Se03ZqSX7tbULXur2MAg: posts small blind $0.10
OneeONzF0MoH0pEdcBndwA: is sitting out 
0QdZrkFD7aGKeBXPGbIomA said, "u stupid 88 in table and no dude"
tGsFgUKjSctVaAXabrlZxw: posts big blind $0.25
*** HOLE CARDS ***
Z9W7+g1WMhhZDi7DwGbCFA: folds 
0QdZrkFD7aGKeBXPGbIomA: folds 
OneeONzF0MoH0pEdcBndwA leaves the table
e0pV1oisCAilWiG0FCxY6A: folds 
jQL6XIewylQ8MmZhhq2YFg: folds 
XGCfQsxa6PfAg3kJtzUmww: folds 
Z5y2J55JmfLYR6/DPAGHwQ: raises $0.50 to $0.75
H5Se03ZqSX7tbULXur2MAg: folds 
tGsFgUKjSctVaAXabrlZxw: calls $0.50
*** FLOP *** [7d 6c 7c]
tGsFgUKjSctVaAXabrlZxw: bets $1.25
Z5y2J55JmfLYR6/DPAGHwQ: calls $1.25
*** TURN *** [7d 6c 7c] [Qs]
tGsFgUKjSctVaAXabrlZxw: bets $2.70 and is all-in
Z5y2J55JmfLYR6/DPAGHwQ: folds 
Uncalled bet ($2.70) returned to tGsFgUKjSctVaAXabrlZxw
tGsFgUKjSctVaAXabrlZxw collected $3.90 from pot
tGsFgUKjSctVaAXabrlZxw: doesn't show hand 
*** SUMMARY ***
Total pot $4.10 | Rake $0.20 
Board [7d 6c 7c Qs]
Seat 2: tGsFgUKjSctVaAXabrlZxw (big blind) collected ($3.90)
Seat 3: Z9W7+g1WMhhZDi7DwGbCFA folded before Flop (didn't bet)
Seat 4: 0QdZrkFD7aGKeBXPGbIomA folded before Flop (didn't bet)
Seat 5: e0pV1oisCAilWiG0FCxY6A folded before Flop (didn't bet)
Seat 6: jQL6XIewylQ8MmZhhq2YFg folded before Flop (didn't bet)
Seat 7: XGCfQsxa6PfAg3kJtzUmww folded before Flop (didn't bet)
Seat 8: Z5y2J55JmfLYR6/DPAGHwQ (button) folded on the Turn
Seat 9: H5Se03ZqSX7tbULXur2MAg (small blind) folded before Flop




PokerStars Game #59941966044:  Hold'em No Limit ($0.10/$0.25) - 2009/07/01 1:51:49 ET
Table 'ThBZ355rqvsb8UGb6ajbig' 9-max Seat #1 is the button
Seat 1: Z9W7+g1WMhhZDi7DwGbCFA ($10.45 in chips) 
Seat 2: 4awUyiDYTgylQKXZ9faBVA ($26.05 in chips) 
Seat 3: H5Se03ZqSX7tbULXur2MAg ($27.80 in chips) 
Seat 4: zgi+EUykT/pZQpoUG6+oEg ($5.40 in chips) 
Seat 5: cKlmpQMahVsmOaxFQDcoOg ($24.60 in chips) 
Seat 6: qwr38jl5txoR36M7G5qi4A ($11 in chips) 
Seat 8: pplNliE3WonjkPRf+GZq2A ($25.10 in chips) 
Seat 9: sD+TKtt36XiiN6jqHiLwDA ($24.65 in chips) 
4awUyiDYTgylQKXZ9faBVA: posts small blind $0.10
H5Se03ZqSX7tbULXur2MAg: posts big blind $0.25
*** HOLE CARDS ***
zgi+EUykT/pZQpoUG6+oEg: folds 
cKlmpQMahVsmOaxFQDcoOg: folds 
qwr38jl5txoR36M7G5qi4A: folds 
pplNliE3WonjkPRf+GZq2A: calls $0.25
sD+TKtt36XiiN6jqHiLwDA: folds 
Z9W7+g1WMhhZDi7DwGbCFA: folds 
4awUyiDYTgylQKXZ9faBVA: raises $1 to $1.25
H5Se03ZqSX7tbULXur2MAg: folds 
pplNliE3WonjkPRf+GZq2A: calls $1
*** FLOP *** [Th Jd 4d]
Z9W7+g1WMhhZDi7DwGbCFA leaves the table
4awUyiDYTgylQKXZ9faBVA: bets $1.50
pplNliE3WonjkPRf+GZq2A: calls $1.50
*** TURN *** [Th Jd 4d] [7s]
4awUyiDYTgylQKXZ9faBVA: bets $4
pplNliE3WonjkPRf+GZq2A: calls $4
*** RIVER *** [Th Jd 4d 7s] [Ac]
4awUyiDYTgylQKXZ9faBVA: checks 
pplNliE3WonjkPRf+GZq2A: bets $3
4awUyiDYTgylQKXZ9faBVA: calls $3
*** SHOW DOWN ***
pplNliE3WonjkPRf+GZq2A: shows [As Tc] (two pair, Aces and Tens)
4awUyiDYTgylQKXZ9faBVA: mucks hand 
pplNliE3WonjkPRf+GZq2A collected $18.80 from pot
*** SUMMARY ***
Total pot $19.75 | Rake $0.95 
Board [Th Jd 4d 7s Ac]
Seat 1: Z9W7+g1WMhhZDi7DwGbCFA (button) folded before Flop (didn't bet)
Seat 2: 4awUyiDYTgylQKXZ9faBVA (small blind) mucked
Seat 3: H5Se03ZqSX7tbULXur2MAg (big blind) folded before Flop
Seat 4: zgi+EUykT/pZQpoUG6+oEg folded before Flop (didn't bet)
Seat 5: cKlmpQMahVsmOaxFQDcoOg folded before Flop (didn't bet)
Seat 6: qwr38jl5txoR36M7G5qi4A folded before Flop (didn't bet)
Seat 8: pplNliE3WonjkPRf+GZq2A showed [As Tc] and won ($18.80) with two pair, Aces and Tens
Seat 9: sD+TKtt36XiiN6jqHiLwDA folded before Flop (didn't bet)




PokerStars Game #59941965980:  Hold'em No Limit ($0.10/$0.25) - 2009/07/01 1:51:49 ET
Table 'MJ1SB76A4qJrlEa+C5e/8w' 6-max Seat #3 is the button
Seat 1: 0KDZiuXQg6UI9cqBR/AUnQ ($19.35 in chips) 
Seat 2: UA5OsKS3VPaxa7uC8La/kA ($37.40 in chips) 
Seat 3: DihMHaz4WNETH1bPDe13kA ($32.20 in chips) 
Seat 4: SFmT9ZsVopnukjvAzrxTRg ($30.15 in chips) 
Seat 6: JFIAqU8lCZ0vWwEl4bdGsg ($34.65 in chips) 
SFmT9ZsVopnukjvAzrxTRg: posts small blind $0.10
JFIAqU8lCZ0vWwEl4bdGsg: posts big blind $0.25
*** HOLE CARDS ***
0KDZiuXQg6UI9cqBR/AUnQ: folds 
UA5OsKS3VPaxa7uC8La/kA: raises $0.50 to $0.75
DihMHaz4WNETH1bPDe13kA: folds 
SFmT9ZsVopnukjvAzrxTRg: folds 
JFIAqU8lCZ0vWwEl4bdGsg: folds 
Uncalled bet ($0.50) returned to UA5OsKS3VPaxa7uC8La/kA
UA5OsKS3VPaxa7uC8La/kA collected $0.60 from pot
*** SUMMARY ***
Total pot $0.60 | Rake $0 
Seat 1: 0KDZiuXQg6UI9cqBR/AUnQ folded before Flop (didn't bet)
Seat 2: UA5OsKS3VPaxa7uC8La/kA collected ($0.60)
Seat 3: DihMHaz4WNETH1bPDe13kA (button) folded before Flop (didn't bet)
Seat 4: SFmT9ZsVopnukjvAzrxTRg (small blind) folded before Flop
Seat 6: JFIAqU8lCZ0vWwEl4bdGsg (big blind) folded before Flop




PokerStars Game #59941966546:  Hold'em No Limit ($0.10/$0.25) - 2009/07/01 1:51:50 ET
Table '2vH5RcmkT0F4XNS/EmmyMA' 6-max Seat #6 is the button
Seat 2: W6Y6au0wf7gRAlqJYgOezw ($13.40 in chips) 
Seat 3: t8P79jKZYh/Wpx2V73pSqg ($24.60 in chips) 
Seat 4: FC6tJ9EOiutXO8hnpR4VgQ ($10.70 in chips) 
Seat 6: if4dh6jhJXeN3/qd3qCp9g ($24.85 in chips) 
JFIAqU8lCZ0vWwEl4bdGsg will be allowed to play after the button
W6Y6au0wf7gRAlqJYgOezw: posts small blind $0.10
t8P79jKZYh/Wpx2V73pSqg: posts big blind $0.25
MVzl6OsGybVDNd3Vr9LYAA: sits out 
*** HOLE CARDS ***
FC6tJ9EOiutXO8hnpR4VgQ: calls $0.25
if4dh6jhJXeN3/qd3qCp9g: folds 
W6Y6au0wf7gRAlqJYgOezw: calls $0.15
t8P79jKZYh/Wpx2V73pSqg: checks 
*** FLOP *** [8s Kh 7c]
W6Y6au0wf7gRAlqJYgOezw: checks 
t8P79jKZYh/Wpx2V73pSqg: bets $0.25
FC6tJ9EOiutXO8hnpR4VgQ: calls $0.25
W6Y6au0wf7gRAlqJYgOezw: calls $0.25
*** TURN *** [8s Kh 7c] [9h]
W6Y6au0wf7gRAlqJYgOezw: checks 
t8P79jKZYh/Wpx2V73pSqg: bets $0.50
FC6tJ9EOiutXO8hnpR4VgQ: calls $0.50
W6Y6au0wf7gRAlqJYgOezw: raises $2.50 to $3
t8P79jKZYh/Wpx2V73pSqg: calls $2.50
FC6tJ9EOiutXO8hnpR4VgQ: folds 
*** RIVER *** [8s Kh 7c 9h] [4c]
W6Y6au0wf7gRAlqJYgOezw: bets $9.90 and is all-in
t8P79jKZYh/Wpx2V73pSqg: folds 
Uncalled bet ($9.90) returned to W6Y6au0wf7gRAlqJYgOezw
W6Y6au0wf7gRAlqJYgOezw collected $7.65 from pot
*** SUMMARY ***
Total pot $8 | Rake $0.35 
Board [8s Kh 7c 9h 4c]
Seat 2: W6Y6au0wf7gRAlqJYgOezw (small blind) collected ($7.65)
Seat 3: t8P79jKZYh/Wpx2V73pSqg (big blind) folded on the River
Seat 4: FC6tJ9EOiutXO8hnpR4VgQ folded on the Turn
Seat 6: if4dh6jhJXeN3/qd3qCp9g (button) folded before Flop (didn't bet)




PokerStars Game #59941966694:  Hold'em No Limit ($0.10/$0.25) - 2009/07/01 1:51:50 ET
Table 'z2yOdY2zyGWG1gh9WV9XtQ' 9-max Seat #9 is the button
Seat 1: 8iyfEWL3auLDt9HEV3U5Vg ($24.10 in chips) 
Seat 2: /OxeiWKPcgcer/U4z8Kqxw ($14.75 in chips) 
Seat 3: X78b5v/uhqeXXoAijbw/yg ($26.90 in chips) 
Seat 4: Bb42QRQMhg5/Y0vHP8/2Xw ($25 in chips) 
Seat 6: NBYmTySMtIicyMj5Vjzqhw ($32.65 in chips) 
Seat 7: zDrucyjVn5aeekNEc3cJrA ($22.60 in chips) 
Seat 9: wGigCmBR/9XWkPpvYos3aQ ($34.55 in chips) 
8iyfEWL3auLDt9HEV3U5Vg: posts small blind $0.10
/OxeiWKPcgcer/U4z8Kqxw: posts big blind $0.25
4qA/3Ajg3pP6fqW+IX9/fQ: sits out 
*** HOLE CARDS ***
X78b5v/uhqeXXoAijbw/yg: raises $0.75 to $1
Bb42QRQMhg5/Y0vHP8/2Xw: folds 
NBYmTySMtIicyMj5Vjzqhw: folds 
zDrucyjVn5aeekNEc3cJrA: folds 
wGigCmBR/9XWkPpvYos3aQ: folds 
8iyfEWL3auLDt9HEV3U5Vg: folds 
/OxeiWKPcgcer/U4z8Kqxw: calls $0.75
*** FLOP *** [8c Qh 6c]
/OxeiWKPcgcer/U4z8Kqxw: bets $0.50
X78b5v/uhqeXXoAijbw/yg: calls $0.50
*** TURN *** [8c Qh 6c] [Kh]
/OxeiWKPcgcer/U4z8Kqxw: bets $1
X78b5v/uhqeXXoAijbw/yg: raises $2.50 to $3.50
/OxeiWKPcgcer/U4z8Kqxw: calls $2.50
*** RIVER *** [8c Qh 6c Kh] [Jd]
/OxeiWKPcgcer/U4z8Kqxw: checks 
X78b5v/uhqeXXoAijbw/yg: bets $5.50
/OxeiWKPcgcer/U4z8Kqxw: calls $5.50
*** SHOW DOWN ***
X78b5v/uhqeXXoAijbw/yg: shows [Qs Qd] (three of a kind, Queens)
/OxeiWKPcgcer/U4z8Kqxw: mucks hand 
X78b5v/uhqeXXoAijbw/yg collected $20.10 from pot
*** SUMMARY ***
Total pot $21.10 | Rake $1 
Board [8c Qh 6c Kh Jd]
Seat 1: 8iyfEWL3auLDt9HEV3U5Vg (small blind) folded before Flop
Seat 2: /OxeiWKPcgcer/U4z8Kqxw (big blind) mucked
Seat 3: X78b5v/uhqeXXoAijbw/yg showed [Qs Qd] and won ($20.10) with three of a kind, Queens
Seat 4: Bb42QRQMhg5/Y0vHP8/2Xw folded before Flop (didn't bet)
Seat 6: NBYmTySMtIicyMj5Vjzqhw folded before Flop (didn't bet)
Seat 7: zDrucyjVn5aeekNEc3cJrA folded before Flop (didn't bet)
Seat 9: wGigCmBR/9XWkPpvYos3aQ (button) folded before Flop (didn't bet)




PokerStars Game #59941967116:  Hold'em No Limit ($0.10/$0.25) - 2009/07/01 1:51:51 ET
Table 'nlpa8xI95gAflovnFxB2yg' 6-max Seat #6 is the button
Seat 1: fZQg9veL7Dd/Z04ZTjC+wQ ($62.30 in chips) 
Seat 2: Yuyy/pDz3yAO3EbHYRYnKw ($23.55 in chips) 
Seat 3: DihMHaz4WNETH1bPDe13kA ($25.50 in chips) 
Seat 4: if4dh6jhJXeN3/qd3qCp9g ($52 in chips) 
Seat 5: pSneaCslVpgO8mzi5yQMww ($11.90 in chips) 
Seat 6: ATNFxN8fYVfSZMQW8dvbvw ($4.75 in chips) 
fZQg9veL7Dd/Z04ZTjC+wQ: posts small blind $0.10
Yuyy/pDz3yAO3EbHYRYnKw: posts big blind $0.25
pSneaCslVpgO8mzi5yQMww: posts big blind $0.25
*** HOLE CARDS ***
DihMHaz4WNETH1bPDe13kA: folds 
if4dh6jhJXeN3/qd3qCp9g: folds 
pSneaCslVpgO8mzi5yQMww: checks 
ATNFxN8fYVfSZMQW8dvbvw: folds 
fZQg9veL7Dd/Z04ZTjC+wQ: folds 
Yuyy/pDz3yAO3EbHYRYnKw: checks 
*** FLOP *** [6h Ts 7c]
Yuyy/pDz3yAO3EbHYRYnKw: checks 
pSneaCslVpgO8mzi5yQMww: bets $0.75
Yuyy/pDz3yAO3EbHYRYnKw: folds 
Uncalled bet ($0.75) returned to pSneaCslVpgO8mzi5yQMww
pSneaCslVpgO8mzi5yQMww collected $0.60 from pot
*** SUMMARY ***
Total pot $0.60 | Rake $0 
Board [6h Ts 7c]
Seat 1: fZQg9veL7Dd/Z04ZTjC+wQ (small blind) folded before Flop
Seat 2: Yuyy/pDz3yAO3EbHYRYnKw (big blind) folded on the Flop
Seat 3: DihMHaz4WNETH1bPDe13kA folded before Flop (didn't bet)
Seat 4: if4dh6jhJXeN3/qd3qCp9g folded before Flop (didn't bet)
Seat 5: pSneaCslVpgO8mzi5yQMww collected ($0.60)
Seat 6: ATNFxN8fYVfSZMQW8dvbvw (button) folded before Flop (didn't bet)




PokerStars Game #59941966816:  Hold'em No Limit ($0.10/$0.25) - 2009/07/01 1:51:51 ET
Table 'KU/HrxqxwDz8HKEhYTZ6uw' 6-max Seat #3 is the button
Seat 1: 7LKoiQHXpTQXJvWQrw907g ($38.30 in chips) 
Seat 2: kG34n23qFQA3nzdOJTQ1dA ($23.95 in chips) 
Seat 3: SFmT9ZsVopnukjvAzrxTRg ($26.10 in chips) 
Seat 5: iyZxqznXjv3vtvOJymkoLQ ($52.10 in chips) 
Seat 6: qWxkCeqApAWdAA0evrfDvQ ($9.10 in chips) 
iyZxqznXjv3vtvOJymkoLQ: posts small blind $0.10
qWxkCeqApAWdAA0evrfDvQ: posts big blind $0.25
*** HOLE CARDS ***
7LKoiQHXpTQXJvWQrw907g: folds 
kG34n23qFQA3nzdOJTQ1dA: calls $0.25
SFmT9ZsVopnukjvAzrxTRg: raises $0.75 to $1
iyZxqznXjv3vtvOJymkoLQ: folds 
qWxkCeqApAWdAA0evrfDvQ: folds 
kG34n23qFQA3nzdOJTQ1dA: calls $0.75
*** FLOP *** [Ah Kh 9d]
kG34n23qFQA3nzdOJTQ1dA: checks 
SFmT9ZsVopnukjvAzrxTRg: checks 
*** TURN *** [Ah Kh 9d] [Js]
kG34n23qFQA3nzdOJTQ1dA: checks 
SFmT9ZsVopnukjvAzrxTRg: checks 
*** RIVER *** [Ah Kh 9d Js] [6d]
kG34n23qFQA3nzdOJTQ1dA: bets $1.25
SFmT9ZsVopnukjvAzrxTRg: folds 
Uncalled bet ($1.25) returned to kG34n23qFQA3nzdOJTQ1dA
kG34n23qFQA3nzdOJTQ1dA collected $2.25 from pot
*** SUMMARY ***
Total pot $2.35 | Rake $0.10 
Board [Ah Kh 9d Js 6d]
Seat 1: 7LKoiQHXpTQXJvWQrw907g folded before Flop (didn't bet)
Seat 2: kG34n23qFQA3nzdOJTQ1dA collected ($2.25)
Seat 3: SFmT9ZsVopnukjvAzrxTRg (button) folded on the River
Seat 5: iyZxqznXjv3vtvOJymkoLQ (small blind) folded before Flop
Seat 6: qWxkCeqApAWdAA0evrfDvQ (big blind) folded before Flop




PokerStars Game #59941966766:  Hold'em No Limit ($0.10/$0.25) - 2009/07/01 1:51:51 ET
Table 'HzFR0rxmDAPu5GzYR0AlYg' 6-max Seat #2 is the button
Seat 1: v+QfkGiuj9bgtuNoVnDO8w ($35.15 in chips) 
Seat 2: UA5OsKS3VPaxa7uC8La/kA ($51.60 in chips) 
Seat 3: kG34n23qFQA3nzdOJTQ1dA ($24.30 in chips) 
Seat 4: Mhj3q7cxev+XjXZxEE6/Cw ($25.35 in chips) 
Seat 6: jp34e617tIzV8tKIWmfAbA ($35.30 in chips) 
kG34n23qFQA3nzdOJTQ1dA: posts small blind $0.10
Mhj3q7cxev+XjXZxEE6/Cw: posts big blind $0.25
*** HOLE CARDS ***
jp34e617tIzV8tKIWmfAbA: folds 
v+QfkGiuj9bgtuNoVnDO8w: folds 
UA5OsKS3VPaxa7uC8La/kA: raises $0.50 to $0.75
kG34n23qFQA3nzdOJTQ1dA: calls $0.65
Mhj3q7cxev+XjXZxEE6/Cw: folds 
*** FLOP *** [5h Qc 3d]
kG34n23qFQA3nzdOJTQ1dA: checks 
UA5OsKS3VPaxa7uC8La/kA: bets $1
kG34n23qFQA3nzdOJTQ1dA: folds 
Uncalled bet ($1) returned to UA5OsKS3VPaxa7uC8La/kA
UA5OsKS3VPaxa7uC8La/kA collected $1.70 from pot
*** SUMMARY ***
Total pot $1.75 | Rake $0.05 
Board [5h Qc 3d]
Seat 1: v+QfkGiuj9bgtuNoVnDO8w folded before Flop (didn't bet)
Seat 2: UA5OsKS3VPaxa7uC8La/kA (button) collected ($1.70)
Seat 3: kG34n23qFQA3nzdOJTQ1dA (small blind) folded on the Flop
Seat 4: Mhj3q7cxev+XjXZxEE6/Cw (big blind) folded before Flop
Seat 6: jp34e617tIzV8tKIWmfAbA folded before Flop (didn't bet)




PokerStars Game #59941967740:  Hold'em No Limit ($0.10/$0.25) - 2009/07/01 1:51:52 ET
Table 'NtCSSONEf1zaJo3042tQug' 6-max Seat #3 is the button
Seat 1: KXtdqb+rIMkjc0RvHDksGQ ($31.15 in chips) 
Seat 2: vqWjZmdQu/Hxw96/IJTWdQ ($25 in chips) 
Seat 3: 9kUKGKkblnIx3m8rlVol6Q ($13.40 in chips) 
Seat 5: tOAk1Og4mVObMBOfvdDYOw ($35.30 in chips) 
Seat 6: LxehwDpTQ19ph4Qmc78+Pw ($35.35 in chips) 
tOAk1Og4mVObMBOfvdDYOw: posts small blind $0.10
LxehwDpTQ19ph4Qmc78+Pw: posts big blind $0.25
*** HOLE CARDS ***
KXtdqb+rIMkjc0RvHDksGQ: folds 
vqWjZmdQu/Hxw96/IJTWdQ: raises $0.75 to $1
9kUKGKkblnIx3m8rlVol6Q: calls $1
tOAk1Og4mVObMBOfvdDYOw: folds 
LxehwDpTQ19ph4Qmc78+Pw: calls $0.75
*** FLOP *** [6h Ad Ac]
LxehwDpTQ19ph4Qmc78+Pw: checks 
vqWjZmdQu/Hxw96/IJTWdQ: checks 
9kUKGKkblnIx3m8rlVol6Q: checks 
*** TURN *** [6h Ad Ac] [9h]
LxehwDpTQ19ph4Qmc78+Pw: checks 
vqWjZmdQu/Hxw96/IJTWdQ: checks 
9kUKGKkblnIx3m8rlVol6Q: checks 
*** RIVER *** [6h Ad Ac 9h] [Jc]
LxehwDpTQ19ph4Qmc78+Pw: bets $0.75
vqWjZmdQu/Hxw96/IJTWdQ: folds 
9kUKGKkblnIx3m8rlVol6Q: calls $0.75
*** SHOW DOWN ***
LxehwDpTQ19ph4Qmc78+Pw: shows [Qs Kd] (a pair of Aces)
9kUKGKkblnIx3m8rlVol6Q: shows [Qh Jh] (two pair, Aces and Jacks)
9kUKGKkblnIx3m8rlVol6Q collected $4.40 from pot
*** SUMMARY ***
Total pot $4.60 | Rake $0.20 
Board [6h Ad Ac 9h Jc]
Seat 1: KXtdqb+rIMkjc0RvHDksGQ folded before Flop (didn't bet)
Seat 2: vqWjZmdQu/Hxw96/IJTWdQ folded on the River
Seat 3: 9kUKGKkblnIx3m8rlVol6Q (button) showed [Qh Jh] and won ($4.40) with two pair, Aces and Jacks
Seat 5: tOAk1Og4mVObMBOfvdDYOw (small blind) folded before Flop
Seat 6: LxehwDpTQ19ph4Qmc78+Pw (big blind) showed [Qs Kd] and lost with a pair of Aces




PokerStars Game #59941967410:  Hold'em No Limit ($0.10/$0.25) - 2009/07/01 1:51:52 ET
Table '+2VxGVfkEqJ1AYfQy/JH2w' 6-max Seat #4 is the button
Seat 1: if4dh6jhJXeN3/qd3qCp9g ($28.05 in chips) 
Seat 2: qllppsCmUqovlriIWCeM/g ($5.55 in chips) 
Seat 3: epAUIB7h2FJXzUPRIvSkRA ($25.85 in chips) 
Seat 4: y+a/yGW/Jy4bPJFnaeTz5w ($16.25 in chips) 
Seat 6: YQNVDzvw3TmGaFiq9MhRgA ($5.60 in chips) 
YQNVDzvw3TmGaFiq9MhRgA: posts small blind $0.10
if4dh6jhJXeN3/qd3qCp9g: posts big blind $0.25
*** HOLE CARDS ***
qllppsCmUqovlriIWCeM/g: folds 
epAUIB7h2FJXzUPRIvSkRA: folds 
y+a/yGW/Jy4bPJFnaeTz5w: calls $0.25
YQNVDzvw3TmGaFiq9MhRgA: calls $0.15
if4dh6jhJXeN3/qd3qCp9g: raises $1 to $1.25
y+a/yGW/Jy4bPJFnaeTz5w: folds 
YQNVDzvw3TmGaFiq9MhRgA: folds 
Uncalled bet ($1) returned to if4dh6jhJXeN3/qd3qCp9g
if4dh6jhJXeN3/qd3qCp9g collected $0.75 from pot
if4dh6jhJXeN3/qd3qCp9g: doesn't show hand 
*** SUMMARY ***
Total pot $0.75 | Rake $0 
Seat 1: if4dh6jhJXeN3/qd3qCp9g (big blind) collected ($0.75)
Seat 2: qllppsCmUqovlriIWCeM/g folded before Flop (didn't bet)
Seat 3: epAUIB7h2FJXzUPRIvSkRA folded before Flop (didn't bet)
Seat 4: y+a/yGW/Jy4bPJFnaeTz5w (button) folded before Flop
Seat 6: YQNVDzvw3TmGaFiq9MhRgA (small blind) folded before Flop




PokerStars Game #59941967406:  Hold'em No Limit ($0.10/$0.25) - 2009/07/01 1:51:52 ET
Table 'sDHjMRwfSiz7+NDdZLUiyA' 9-max Seat #3 is the button
Seat 1: VGwr1eqhvdUtMfBFCvBnmg ($11.80 in chips) 
Seat 2: ljemhp25Zg+nlA9DLCIiUw ($25 in chips) 
Seat 3: SGA1WpAnQxFdFAYyt362gQ ($20.55 in chips) 
Seat 4: eK8qa6EPcH2zhtbmWSvc9g ($25.55 in chips) 
Seat 5: IGRfskE1v9H9Bn+fz8AgNQ ($36.10 in chips) 
Seat 6: 1qa0qHOCKZM3Uipx9DxYtQ ($16.10 in chips) 
Seat 7: K0b5wNInj6hUGRr6yzKFtw ($37.65 in chips) 
Seat 8: 3hMkm4U5yTRrkGJkxfijaQ ($12.95 in chips) 
Seat 9: 3PmVnC/15cl4oyI1TKIt4g ($4.50 in chips) 
eK8qa6EPcH2zhtbmWSvc9g: posts small blind $0.10
IGRfskE1v9H9Bn+fz8AgNQ: posts big blind $0.25
*** HOLE CARDS ***
1qa0qHOCKZM3Uipx9DxYtQ: raises $0.25 to $0.50
K0b5wNInj6hUGRr6yzKFtw: folds 
3hMkm4U5yTRrkGJkxfijaQ: calls $0.50
3PmVnC/15cl4oyI1TKIt4g: folds 
VGwr1eqhvdUtMfBFCvBnmg: folds 
ljemhp25Zg+nlA9DLCIiUw: folds 
SGA1WpAnQxFdFAYyt362gQ: folds 
eK8qa6EPcH2zhtbmWSvc9g: folds 
IGRfskE1v9H9Bn+fz8AgNQ: calls $0.25
*** FLOP *** [Td Ad Js]
IGRfskE1v9H9Bn+fz8AgNQ: checks 
1qa0qHOCKZM3Uipx9DxYtQ: bets $1
3hMkm4U5yTRrkGJkxfijaQ: folds 
IGRfskE1v9H9Bn+fz8AgNQ: calls $1
*** TURN *** [Td Ad Js] [Qd]
IGRfskE1v9H9Bn+fz8AgNQ: checks 
1qa0qHOCKZM3Uipx9DxYtQ: bets $3
IGRfskE1v9H9Bn+fz8AgNQ: folds 
Uncalled bet ($3) returned to 1qa0qHOCKZM3Uipx9DxYtQ
1qa0qHOCKZM3Uipx9DxYtQ collected $3.45 from pot
*** SUMMARY ***
Total pot $3.60 | Rake $0.15 
Board [Td Ad Js Qd]
Seat 1: VGwr1eqhvdUtMfBFCvBnmg folded before Flop (didn't bet)
Seat 2: ljemhp25Zg+nlA9DLCIiUw folded before Flop (didn't bet)
Seat 3: SGA1WpAnQxFdFAYyt362gQ (button) folded before Flop (didn't bet)
Seat 4: eK8qa6EPcH2zhtbmWSvc9g (small blind) folded before Flop
Seat 5: IGRfskE1v9H9Bn+fz8AgNQ (big blind) folded on the Turn
Seat 6: 1qa0qHOCKZM3Uipx9DxYtQ collected ($3.45)
Seat 7: K0b5wNInj6hUGRr6yzKFtw folded before Flop (didn't bet)
Seat 8: 3hMkm4U5yTRrkGJkxfijaQ folded on the Flop
Seat 9: 3PmVnC/15cl4oyI1TKIt4g folded before Flop (didn't bet)




PokerStars Game #59941967404:  Hold'em No Limit ($0.10/$0.25) - 2009/07/01 1:51:52 ET
Table 'dYNvO8G5kw5SRxb1Dljhogz2yOdY2zyGWG1gh9WV9XtQ Seat #7 is the button
Seat 1: vSkQm2EelzwRGDDQQk0Fqw ($17.30 in chips) 
Seat 2: PkBmevN3LdXkPj1LHOoTnQ ($3.40 in chips) 
Seat 3: 1Cs1GyQcoM1omwY7XZ3uRg ($11.50 in chips) 
Seat 4: sD+TKtt36XiiN6jqHiLwDA ($28.10 in chips) 
Seat 5: W7XGvw6ngGVq2hFwXk8Myg ($24.85 in chips) 
Seat 6: 22dIObOuor/A+IKWkNoAlA ($7.95 in chips) 
Seat 7: DiSvPC2iudwL5j9u6Huyww ($39.40 in chips) 
Seat 8: 6HoFYfVGBefsR5Vrz62qIw5hAPbqNrvJb8PtLiceXtlg9.70 in chips) 
Seat 9: PdIasPkzm2sqZnN41ZRXOg ($5 in chips) 
6HoFYfVGBefsR5Vrz62qIw5hAPbqNrvJb8PtLiceXtlgsts small blind $0.10
PdIasPkzm2sqZnN41ZRXOg: posts big blind $0.25
*** HOLE CARDS ***
vSkQm2EelzwRGDDQQk0Fqw: folds 
PkBmevN3LdXkPj1LHOoTnQ: calls $0.25
1Cs1GyQcoM1omwY7XZ3uRg: calls $0.25
sD+TKtt36XiiN6jqHiLwDA: folds 
W7XGvw6ngGVq2hFwXk8Myg: calls $0.25
22dIObOuor/A+IKWkNoAlA: folds 
DiSvPC2iudwL5j9u6Huyww: folds 
6HoFYfVGBefsR5Vrz62qIw5hAPbqNrvJb8PtLiceXtlglds 
PdIasPkzm2sqZnN41ZRXOg: checks 
*** FLOP *** [Ad Th 6c]
PdIasPkzm2sqZnN41ZRXOg: checks 
PkBmevN3LdXkPj1LHOoTnQ: checks 
1Cs1GyQcoM1omwY7XZ3uRg: checks 
W7XGvw6ngGVq2hFwXk8Myg: checks 
*** TURN *** [Ad Th 6c] [As]
PdIasPkzm2sqZnN41ZRXOg: checks 
PkBmevN3LdXkPj1LHOoTnQ: checks 
1Cs1GyQcoM1omwY7XZ3uRg: checks 
W7XGvw6ngGVq2hFwXk8Myg: checks 
*** RIVER *** [Ad Th 6c As] [Js]
PdIasPkzm2sqZnN41ZRXOg: checks 
PkBmevN3LdXkPj1LHOoTnQ: checks 
1Cs1GyQcoM1omwY7XZ3uRg: bets $2
W7XGvw6ngGVq2hFwXk8Myg: folds 
PdIasPkzm2sqZnN41ZRXOg: folds 
PkBmevN3LdXkPj1LHOoTnQ: folds 
Uncalled bet ($2) returned to 1Cs1GyQcoM1omwY7XZ3uRg
1Cs1GyQcoM1omwY7XZ3uRg collected $1.05 from pot
*** SUMMARY ***
Total pot $1.10 | Rake $0.05 
Board [Ad Th 6c As Js]
Seat 1: vSkQm2EelzwRGDDQQk0Fqw folded before Flop (didn't bet)
Seat 2: PkBmevN3LdXkPj1LHOoTnQ folded on the River
Seat 3: 1Cs1GyQcoM1omwY7XZ3uRg collected ($1.05)
Seat 4: sD+TKtt36XiiN6jqHiLwDA folded before Flop (didn't bet)
Seat 5: W7XGvw6ngGVq2hFwXk8Myg folded on the River
Seat 6: 22dIObOuor/A+IKWkNoAlA folded before Flop (didn't bet)
Seat 7: DiSvPC2iudwL5j9u6Huyww (button) folded before Flop (didn't bet)
Seat 8: 6HoFYfVGBefsR5Vrz62qIw5hAPbqNrvJb8PtLiceXtlgall blind) folded before Flop
Seat 9: PdIasPkzm2sqZnN41ZRXOg (big blind) folded on the River




PokerStars Game #59941968130:  Hold'em No Limit ($0.10/$0.25) - 2009/07/01 1:51:53 ET
Table '8QBBaev+cI2i/r2H6ml/lg' 9-max Seat #5 is the button
Seat 1: s2xLPOl/vhl/26apJ3vsOQ ($38.40 in chips) 
Seat 2: y7tkvDmwKjURBkr73SZPXw ($7.65 in chips) 
Seat 3: zgi+EUykT/pZQpoUG6+oEg ($4.30 in chips) 
Seat 4: ytpGB2nr/CLVHnyKMRiEFQ ($20.65 in chips) 
Seat 5: 0QdZrkFD7aGKeBXPGbIomA ($11.10 in chips) 
Seat 6: X6+pSIPfovPcE87t+LmUKQ ($4.75 in chips) 
Seat 7: eK8qa6EPcH2zhtbmWSvc9g ($30.05 in chips) 
Seat 8: vr1IK/Q4HXm8s8V0/dePzQ ($10.60 in chips) 
Seat 9: EUMLvzDkECHBit+xa+uGjg ($23.75 in chips) 
X6+pSIPfovPcE87t+LmUKQ: posts small blind $0.10
eK8qa6EPcH2zhtbmWSvc9g: posts big blind $0.25
*** HOLE CARDS ***
vr1IK/Q4HXm8s8V0/dePzQ: folds 
EUMLvzDkECHBit+xa+uGjg: raises $0.50 to $0.75
s2xLPOl/vhl/26apJ3vsOQ: folds 
y7tkvDmwKjURBkr73SZPXw: folds 
zgi+EUykT/pZQpoUG6+oEg: folds 
ytpGB2nr/CLVHnyKMRiEFQ: calls $0.75
0QdZrkFD7aGKeBXPGbIomA: folds 
X6+pSIPfovPcE87t+LmUKQ: folds 
eK8qa6EPcH2zhtbmWSvc9g: folds 
*** FLOP *** [9d 8h 9c]
EUMLvzDkECHBit+xa+uGjg: checks 
ytpGB2nr/CLVHnyKMRiEFQ: checks 
*** TURN *** [9d 8h 9c] [Kd]
EUMLvzDkECHBit+xa+uGjg: bets $1
ytpGB2nr/CLVHnyKMRiEFQ: calls $1
*** RIVER *** [9d 8h 9c Kd] [5c]
EUMLvzDkECHBit+xa+uGjg: bets $2.25
ytpGB2nr/CLVHnyKMRiEFQ: raises $2.75 to $5
EUMLvzDkECHBit+xa+uGjg: calls $2.75
*** SHOW DOWN ***
ytpGB2nr/CLVHnyKMRiEFQ: shows [7d 6d] (a straight, Five to Nine)
EUMLvzDkECHBit+xa+uGjg: mucks hand 
ytpGB2nr/CLVHnyKMRiEFQ collected $13.20 from pot
*** SUMMARY ***
Total pot $13.85 | Rake $0.65 
Board [9d 8h 9c Kd 5c]
Seat 1: s2xLPOl/vhl/26apJ3vsOQ folded before Flop (didn't bet)
Seat 2: y7tkvDmwKjURBkr73SZPXw folded before Flop (didn't bet)
Seat 3: zgi+EUykT/pZQpoUG6+oEg folded before Flop (didn't bet)
Seat 4: ytpGB2nr/CLVHnyKMRiEFQ showed [7d 6d] and won ($13.20) with a straight, Five to Nine
Seat 5: 0QdZrkFD7aGKeBXPGbIomA (button) folded before Flop (didn't bet)
Seat 6: X6+pSIPfovPcE87t+LmUKQ (small blind) folded before Flop
Seat 7: eK8qa6EPcH2zhtbmWSvc9g (big blind) folded before Flop
Seat 8: vr1IK/Q4HXm8s8V0/dePzQ folded before Flop (didn't bet)
Seat 9: EUMLvzDkECHBit+xa+uGjg mucked




PokerStars Game #59941967848:  Hold'em No Limit ($0.10/$0.25) - 2009/07/01 1:51:53 ET
Table 'UVjmXTtsmlX1HxwwZ59akg' 9-max Seat #6 is the button
Seat 1: zDrucyjVn5aeekNEc3cJrA ($48.35 in chips) 
Seat 2: q+Qdg0Hoir+SyL7haBrUnw ($7.80 in chips) 
Seat 3: GmzfAfxcxu1kGbPC+9LkVg ($27.80 in chips) 
Seat 5: Bb42QRQMhg5/Y0vHP8/2Xw ($39.45 in chips) 
Seat 6: st9jtdNbm1W5GfBwRaCVqQ ($24.10 in chips) 
Seat 7: d7YasxuGLPiL7pj8IcGThw ($4.50 in chips) 
Seat 8: aqxuKnMZWHy08QjWq1+MrQ ($2.75 in chips) 
Seat 9: ljemhp25Zg+nlA9DLCIiUw ($25.25 in chips) 
d7YasxuGLPiL7pj8IcGThw: posts small blind $0.10
aqxuKnMZWHy08QjWq1+MrQ: posts big blind $0.25
18G4P1XstjNvItdGUITxgw: sits out 
*** HOLE CARDS ***
ljemhp25Zg+nlA9DLCIiUw: folds 
zDrucyjVn5aeekNEc3cJrA: calls $0.25
q+Qdg0Hoir+SyL7haBrUnw: folds 
GmzfAfxcxu1kGbPC+9LkVg: calls $0.25
Bb42QRQMhg5/Y0vHP8/2Xw: folds 
st9jtdNbm1W5GfBwRaCVqQ: folds 
d7YasxuGLPiL7pj8IcGThw: folds 
aqxuKnMZWHy08QjWq1+MrQ: raises $2.50 to $2.75 and is all-in
zDrucyjVn5aeekNEc3cJrA: folds 
GmzfAfxcxu1kGbPC+9LkVg: folds 
Uncalled bet ($2.50) returned to aqxuKnMZWHy08QjWq1+MrQ
aqxuKnMZWHy08QjWq1+MrQ collected $0.85 from pot
*** SUMMARY ***
Total pot $0.85 | Rake $0 
Seat 1: zDrucyjVn5aeekNEc3cJrA folded before Flop
Seat 2: q+Qdg0Hoir+SyL7haBrUnw folded before Flop (didn't bet)
Seat 3: GmzfAfxcxu1kGbPC+9LkVg folded before Flop
Seat 5: Bb42QRQMhg5/Y0vHP8/2Xw folded before Flop (didn't bet)
Seat 6: st9jtdNbm1W5GfBwRaCVqQ (button) folded before Flop (didn't bet)
Seat 7: d7YasxuGLPiL7pj8IcGThw (small blind) folded before Flop
Seat 8: aqxuKnMZWHy08QjWq1+MrQ (big blind) collected ($0.85)
Seat 9: ljemhp25Zg+nlA9DLCIiUw folded before Flop (didn't bet)




PokerStars Game #59941968132:  Hold'em No Limit ($0.10/$0.25) - 2009/07/01 1:51:53 ET
Table 'yZgGBnUGXVCcEJdcqes8tw' 9-max Seat #5 is the button
Seat 1: 6RiVTYll/5D8zICp0MRpKw ($30.30 in chips) 
Seat 2: MG90wfSJZnOejs/KD3vlQQ ($25 in chips) 
Seat 4: M2QO2DxB5Wawg2h8HSpnYA ($10 in chips) 
Seat 5: dfNim92Z6XK1/h5SFW5vDg ($26 in chips) 
Seat 6: RHqgdFvufLCYe54+qd2gcA ($4.75 in chips) 
Seat 7: eC8Pn1D6Y2pct8o62nQfvQ ($31.20 in chips) 
Seat 8: dtZ84flFEi4Q+SGrHMJRDQ ($30.15 in chips) 
Seat 9: M/9j4wkHH9i1JM51vgi1VA ($23.40 in chips) 
RHqgdFvufLCYe54+qd2gcA: posts small blind $0.10
eC8Pn1D6Y2pct8o62nQfvQ: posts big blind $0.25
z5GxcHlYz/GSz6W2uFiTtg: sits out 
*** HOLE CARDS ***
dtZ84flFEi4Q+SGrHMJRDQ: folds 
M/9j4wkHH9i1JM51vgi1VA: folds 
6RiVTYll/5D8zICp0MRpKw: folds 
MG90wfSJZnOejs/KD3vlQQ: folds 
M2QO2DxB5Wawg2h8HSpnYA: calls $0.25
dfNim92Z6XK1/h5SFW5vDg: folds 
RHqgdFvufLCYe54+qd2gcA: folds 
eC8Pn1D6Y2pct8o62nQfvQ: checks 
*** FLOP *** [3s Kh 8h]
eC8Pn1D6Y2pct8o62nQfvQ: checks 
M2QO2DxB5Wawg2h8HSpnYA: checks 
*** TURN *** [3s Kh 8h] [Ad]
eC8Pn1D6Y2pct8o62nQfvQ: bets $0.50
M2QO2DxB5Wawg2h8HSpnYA: folds 
Uncalled bet ($0.50) returned to eC8Pn1D6Y2pct8o62nQfvQ
eC8Pn1D6Y2pct8o62nQfvQ collected $0.60 from pot
eC8Pn1D6Y2pct8o62nQfvQ: doesn't show hand 
*** SUMMARY ***
Total pot $0.60 | Rake $0 
Board [3s Kh 8h Ad]
Seat 1: 6RiVTYll/5D8zICp0MRpKw folded before Flop (didn't bet)
Seat 2: MG90wfSJZnOejs/KD3vlQQ folded before Flop (didn't bet)
Seat 4: M2QO2DxB5Wawg2h8HSpnYA folded on the Turn
Seat 5: dfNim92Z6XK1/h5SFW5vDg (button) folded before Flop (didn't bet)
Seat 6: RHqgdFvufLCYe54+qd2gcA (small blind) folded before Flop
Seat 7: eC8Pn1D6Y2pct8o62nQfvQ (big blind) collected ($0.60)
Seat 8: dtZ84flFEi4Q+SGrHMJRDQ folded before Flop (didn't bet)
Seat 9: M/9j4wkHH9i1JM51vgi1VA folded before Flop (didn't bet)




PokerStars Game #59941967784:  Hold'em No Limit ($0.10/$0.25) - 2009/07/01 1:51:53 ET
Table '+68ihX5Br1xgGorX6zsCBg' 9-max Seat #7 is the button
Seat 1: IFB2mhulUVYIbb+KWwDC9w ($3.80 in chips) 
Seat 2: TeAfhXG1R60d8yPEHN3JiA ($25.45 in chips) 
Seat 3: PdIasPkzm2sqZnN41ZRXOg ($5.05 in chips) 
Seat 4: Oi0EiPIjriUb/6zT65YeWA ($27.30 in chips) 
Seat 5: ghNKXUBl/H+t83JF079ZBA ($28.65 in chips) 
Seat 6: X78b5v/uhqeXXoAijbw/yg ($26.05 in chips) 
Seat 7: V6p0jQ/RhUsqpHLmXvEX4Q ($19 in chips) 
Seat 9: DiSvPC2iudwL5j9u6Huyww ($32.50 in chips) 
DiSvPC2iudwL5j9u6Huyww: posts small blind $0.10
IFB2mhulUVYIbb+KWwDC9w: posts big blind $0.25
*** HOLE CARDS ***
TeAfhXG1R60d8yPEHN3JiA: calls $0.25
PdIasPkzm2sqZnN41ZRXOg: folds 
Oi0EiPIjriUb/6zT65YeWA: folds 
ghNKXUBl/H+t83JF079ZBA: folds 
X78b5v/uhqeXXoAijbw/yg: folds 
V6p0jQ/RhUsqpHLmXvEX4Q: folds 
DiSvPC2iudwL5j9u6Huyww: folds 
IFB2mhulUVYIbb+KWwDC9w: raises $0.25 to $0.50
TeAfhXG1R60d8yPEHN3JiA: calls $0.25
*** FLOP *** [Ad 3h As]
IFB2mhulUVYIbb+KWwDC9w: bets $0.25
TeAfhXG1R60d8yPEHN3JiA: raises $0.25 to $0.50
IFB2mhulUVYIbb+KWwDC9w: calls $0.25
*** TURN *** [Ad 3h As] [5d]
IFB2mhulUVYIbb+KWwDC9w: checks 
TeAfhXG1R60d8yPEHN3JiA: bets $0.25
IFB2mhulUVYIbb+KWwDC9w: calls $0.25
*** RIVER *** [Ad 3h As 5d] [8h]
IFB2mhulUVYIbb+KWwDC9w: bets $0.25
TeAfhXG1R60d8yPEHN3JiA: calls $0.25
*** SHOW DOWN ***
IFB2mhulUVYIbb+KWwDC9w: shows [6d 6h] (two pair, Aces and Sixes)
TeAfhXG1R60d8yPEHN3JiA: mucks hand 
IFB2mhulUVYIbb+KWwDC9w collected $2.95 from pot
*** SUMMARY ***
Total pot $3.10 | Rake $0.15 
Board [Ad 3h As 5d 8h]
Seat 1: IFB2mhulUVYIbb+KWwDC9w (big blind) showed [6d 6h] and won ($2.95) with two pair, Aces and Sixes
Seat 2: TeAfhXG1R60d8yPEHN3JiA mucked
Seat 3: PdIasPkzm2sqZnN41ZRXOg folded before Flop (didn't bet)
Seat 4: Oi0EiPIjriUb/6zT65YeWA folded before Flop (didn't bet)
Seat 5: ghNKXUBl/H+t83JF079ZBA folded before Flop (didn't bet)
Seat 6: X78b5v/uhqeXXoAijbw/yg folded before Flop (didn't bet)
Seat 7: V6p0jQ/RhUsqpHLmXvEX4Q (button) folded before Flop (didn't bet)
Seat 9: DiSvPC2iudwL5j9u6Huyww (small blind) folded before Flop




PokerStars Game #59941967812:  Hold'em No Limit ($0.10/$0.25) - 2009/07/01 1:51:53 ET
Table 'NtEQAxCeIK2io1CGtW658g' 6-max Seat #1 is the button
Seat 1: X437kMQ7AujoaDgjguhU9w ($12.85 in chips) 
Seat 2: DgyznDqq/mLiCqQGMzc+Aw ($8.15 in chips) 
Seat 3: 5nwDw10uIM0XEyLhla0oGA ($25 in chips) 
Seat 4: 8296 ($15.65 in chips) 
Seat 6: /gJNBeCkWL4o85/jvlZ4BA ($70.70 in chips) 
DgyznDqq/mLiCqQGMzc+Aw: posts small blind $0.10
5nwDw10uIM0XEyLhla0oGA: posts big blind $0.25
*** HOLE CARDS ***
8296: folds 
/gJNBeCkWL4o85/jvlZ4BA: folds 
X437kMQ7AujoaDgjguhU9w: calls $0.25
DgyznDqq/mLiCqQGMzc+Aw: folds 
5nwDw10uIM0XEyLhla0oGA: raises $0.50 to $0.75
X437kMQ7AujoaDgjguhU9w: calls $0.50
*** FLOP *** [Td 7c 4d]
5nwDw10uIM0XEyLhla0oGA: bets $1
X437kMQ7AujoaDgjguhU9w: raises $11.10 to $12.10 and is all-in
5nwDw10uIM0XEyLhla0oGA: calls $11.10
*** TURN *** [Td 7c 4d] [2d]
*** RIVER *** [Td 7c 4d 2d] [Ks]
*** SHOW DOWN ***
5nwDw10uIM0XEyLhla0oGA: shows [Kd 7d] (a flush, King high)
X437kMQ7AujoaDgjguhU9w: mucks hand 
5nwDw10uIM0XEyLhla0oGA collected $24.55 from pot
*** SUMMARY ***
Total pot $25.80 | Rake $1.25 
Board [Td 7c 4d 2d Ks]
Seat 1: X437kMQ7AujoaDgjguhU9w (button) mucked
Seat 2: DgyznDqq/mLiCqQGMzc+Aw (small blind) folded before Flop
Seat 3: 5nwDw10uIM0XEyLhla0oGA (big blind) showed [Kd 7d] and won ($24.55) with a flush, King high
Seat 4: 8296 folded before Flop (didn't bet)
Seat 6: /gJNBeCkWL4o85/jvlZ4BA folded before Flop (didn't bet)




PokerStars Game #59941967756:  Hold'em No Limit ($0.10/$0.25) - 2009/07/01 1:51:53 ET
Table 'Pz8SfAzhP5nvWTsJRAxoDg' 6-max Seat #1 is the button
Seat 1: QiL+lEgEWwy21jk/ltaRLg ($46.65 in chips) 
Seat 2: k021eD5in2AjaloW5PalMg ($18.20 in chips) 
Seat 3: mfrkWA3PTeYPkbO6hi98Aw ($31.45 in chips) 
Seat 4: 4lJto+Qj0K4JrFKvHaPTLw ($64.05 in chips) 
Seat 5: u+J1MTXS2qhNVMbsBemNLg ($5 in chips) 
Seat 6: QvTX2yGq3uKJiKPmns4TKQ ($17.05 in chips) 
k021eD5in2AjaloW5PalMg: posts small blind $0.10
mfrkWA3PTeYPkbO6hi98Aw: posts big blind $0.25
u+J1MTXS2qhNVMbsBemNLg: posts big blind $0.25
*** HOLE CARDS ***
4lJto+Qj0K4JrFKvHaPTLw: folds 
u+J1MTXS2qhNVMbsBemNLg: checks 
QvTX2yGq3uKJiKPmns4TKQ: calls $0.25
QiL+lEgEWwy21jk/ltaRLg: raises $0.25 to $0.50
k021eD5in2AjaloW5PalMg: calls $0.40
mfrkWA3PTeYPkbO6hi98Aw: folds 
u+J1MTXS2qhNVMbsBemNLg: folds 
QvTX2yGq3uKJiKPmns4TKQ: calls $0.25
*** FLOP *** [Qh 9h Kh]
k021eD5in2AjaloW5PalMg: checks 
QvTX2yGq3uKJiKPmns4TKQ: checks 
QiL+lEgEWwy21jk/ltaRLg: checks 
*** TURN *** [Qh 9h Kh] [8h]
k021eD5in2AjaloW5PalMg: bets $0.75
QvTX2yGq3uKJiKPmns4TKQ: folds 
QiL+lEgEWwy21jk/ltaRLg: folds 
Uncalled bet ($0.75) returned to k021eD5in2AjaloW5PalMg
k021eD5in2AjaloW5PalMg collected $1.90 from pot
*** SUMMARY ***
Total pot $2 | Rake $0.10 
Board [Qh 9h Kh 8h]
Seat 1: QiL+lEgEWwy21jk/ltaRLg (button) folded on the Turn
Seat 2: k021eD5in2AjaloW5PalMg (small blind) collected ($1.90)
Seat 3: mfrkWA3PTeYPkbO6hi98Aw (big blind) folded before Flop
Seat 4: 4lJto+Qj0K4JrFKvHaPTLw folded before Flop (didn't bet)
Seat 5: u+J1MTXS2qhNVMbsBemNLg folded before Flop
Seat 6: QvTX2yGq3uKJiKPmns4TKQ folded on the Turn




PokerStars Game #59941967890:  Hold'em No Limit ($0.10/$0.25) - 2009/07/01 1:51:53 ET
Table 'jxoHy9yJy0bbH/Qx73FoPA' 9-max Seat #3 is the button
Seat 3: CVqCt93Mk0MhKMaZ4LZDSQ ($2.45 in chips) 
Seat 4: bXpVeaSTPBFSPJmeXxO7nw ($4.65 in chips) 
Seat 5: 0rQnT3MwKEGi6YXD9FufJw ($5 in chips) 
Seat 6: Z9AeOQX3yzuSvKAm/xyovg ($9.75 in chips) 
Seat 7: wGigCmBR/9XWkPpvYos3aQ ($26.40 in chips) 
Seat 8: Z9W7+g1WMhhZDi7DwGbCFA ($5 in chips) 
Seat 9: CvL9Ch1HYCVbTsfpNucitg ($4.55 in chips) 
bXpVeaSTPBFSPJmeXxO7nw: posts small blind $0.10
0rQnT3MwKEGi6YXD9FufJw: posts big blind $0.25
*** HOLE CARDS ***
Z9AeOQX3yzuSvKAm/xyovg: folds 
wGigCmBR/9XWkPpvYos3aQ: folds 
Z9W7+g1WMhhZDi7DwGbCFA: folds 
CvL9Ch1HYCVbTsfpNucitg: raises $0.75 to $1
CVqCt93Mk0MhKMaZ4LZDSQ: folds 
bXpVeaSTPBFSPJmeXxO7nw: calls $0.90
0rQnT3MwKEGi6YXD9FufJw: folds 
*** FLOP *** [5s 7d Js]
bXpVeaSTPBFSPJmeXxO7nw: bets $3.65 and is all-in
CvL9Ch1HYCVbTsfpNucitg: calls $3.55 and is all-in
Uncalled bet ($0.10) returned to bXpVeaSTPBFSPJmeXxO7nw
*** TURN *** [5s 7d Js] [6h]
*** RIVER *** [5s 7d Js 6h] [5h]
*** SHOW DOWN ***
bXpVeaSTPBFSPJmeXxO7nw: shows [9d 9s] (two pair, Nines and Fives)
CvL9Ch1HYCVbTsfpNucitg: mucks hand 
bXpVeaSTPBFSPJmeXxO7nw collected $8.90 from pot
*** SUMMARY ***
Total pot $9.35 | Rake $0.45 
Board [5s 7d Js 6h 5h]
Seat 3: CVqCt93Mk0MhKMaZ4LZDSQ (button) folded before Flop (didn't bet)
Seat 4: bXpVeaSTPBFSPJmeXxO7nw (small blind) showed [9d 9s] and won ($8.90) with two pair, Nines and Fives
Seat 5: 0rQnT3MwKEGi6YXD9FufJw (big blind) folded before Flop
Seat 6: Z9AeOQX3yzuSvKAm/xyovg folded before Flop (didn't bet)
Seat 7: wGigCmBR/9XWkPpvYos3aQ folded before Flop (didn't bet)
Seat 8: Z9W7+g1WMhhZDi7DwGbCFA folded before Flop (didn't bet)
Seat 9: CvL9Ch1HYCVbTsfpNucitg mucked




PokerStars Game #59941968524:  Hold'em No Limit ($0.10/$0.25) - 2009/07/01 1:51:54 ET
Table 'wPWRBZPJl1HAnysw7qRR0A' 6-max Seat #5 is the button
Seat 1: m7ne1MOFTQXlsXT7/R/rug ($12.15 in chips) 
Seat 2: xC0kaiDYM6YTlgODL83O5A ($23.35 in chips) 
Seat 3: 1ZpoLWO2nm2w1Nd1v9Sr3g ($6.85 in chips) 
Seat 4: epAUIB7h2FJXzUPRIvSkRA ($48.85 in chips) 
Seat 5: y0B+UpYpOUJz3JWtlJQBSA ($15.05 in chips) 
Seat 6: VXTONriS+Ohik+r0FeicIw ($25.70 in chips) 
VXTONriS+Ohik+r0FeicIw: posts small blind $0.10
m7ne1MOFTQXlsXT7/R/rug: posts big blind $0.25
*** HOLE CARDS ***
xC0kaiDYM6YTlgODL83O5A: folds 
1ZpoLWO2nm2w1Nd1v9Sr3g: raises $0.50 to $0.75
epAUIB7h2FJXzUPRIvSkRA: folds 
y0B+UpYpOUJz3JWtlJQBSA: folds 
VXTONriS+Ohik+r0FeicIw: folds 
m7ne1MOFTQXlsXT7/R/rug: folds 
Uncalled bet ($0.50) returned to 1ZpoLWO2nm2w1Nd1v9Sr3g
1ZpoLWO2nm2w1Nd1v9Sr3g collected $0.60 from pot
1ZpoLWO2nm2w1Nd1v9Sr3g: doesn't show hand 
*** SUMMARY ***
Total pot $0.60 | Rake $0 
Seat 1: m7ne1MOFTQXlsXT7/R/rug (big blind) folded before Flop
Seat 2: xC0kaiDYM6YTlgODL83O5A folded before Flop (didn't bet)
Seat 3: 1ZpoLWO2nm2w1Nd1v9Sr3g collected ($0.60)
Seat 4: epAUIB7h2FJXzUPRIvSkRA folded before Flop (didn't bet)
Seat 5: y0B+UpYpOUJz3JWtlJQBSA (button) folded before Flop (didn't bet)
Seat 6: VXTONriS+Ohik+r0FeicIw (small blind) folded before Flop




PokerStars Game #59941968744:  Hold'em No Limit ($0.10/$0.25) - 2009/07/01 1:51:54 ET
Table 'DhkrdW2UOy2PfjSW28Kq8w' 6-max Seat #5 is the button
Seat 1: Mhj3q7cxev+XjXZxEE6/Cw ($25 in chips) 
Seat 2: v+QfkGiuj9bgtuNoVnDO8w ($27.30 in chips) 
Seat 3: B3X187C0tXFUfQpCu8pe8A ($22.45 in chips) 
Seat 4: 59HJSCM1X37BkMpI9N0mEw ($21.80 in chips) 
Seat 5: cS21pIxRHx5Gt42o7hPZzw ($11.45 in chips) 
Seat 6: DihMHaz4WNETH1bPDe13kA ($26.85 in chips) 
DihMHaz4WNETH1bPDe13kA: posts small blind $0.10
Mhj3q7cxev+XjXZxEE6/Cw: posts big blind $0.25
*** HOLE CARDS ***
v+QfkGiuj9bgtuNoVnDO8w: folds 
B3X187C0tXFUfQpCu8pe8A: folds 
59HJSCM1X37BkMpI9N0mEw: calls $0.25
cS21pIxRHx5Gt42o7hPZzw: folds 
DihMHaz4WNETH1bPDe13kA: folds 
Mhj3q7cxev+XjXZxEE6/Cw: checks 
*** FLOP *** [Kc Kd 8d]
Mhj3q7cxev+XjXZxEE6/Cw: checks 
59HJSCM1X37BkMpI9N0mEw: checks 
*** TURN *** [Kc Kd 8d] [3d]
Mhj3q7cxev+XjXZxEE6/Cw: checks 
59HJSCM1X37BkMpI9N0mEw: checks 
*** RIVER *** [Kc Kd 8d 3d] [4d]
Mhj3q7cxev+XjXZxEE6/Cw: checks 
59HJSCM1X37BkMpI9N0mEw: bets $4.75
Mhj3q7cxev+XjXZxEE6/Cw: folds 
Uncalled bet ($4.75) returned to 59HJSCM1X37BkMpI9N0mEw
59HJSCM1X37BkMpI9N0mEw collected $0.60 from pot
59HJSCM1X37BkMpI9N0mEw: doesn't show hand 
*** SUMMARY ***
Total pot $0.60 | Rake $0 
Board [Kc Kd 8d 3d 4d]
Seat 1: Mhj3q7cxev+XjXZxEE6/Cw (big blind) folded on the River
Seat 2: v+QfkGiuj9bgtuNoVnDO8w folded before Flop (didn't bet)
Seat 3: B3X187C0tXFUfQpCu8pe8A folded before Flop (didn't bet)
Seat 4: 59HJSCM1X37BkMpI9N0mEw collected ($0.60)
Seat 5: cS21pIxRHx5Gt42o7hPZzw (button) folded before Flop (didn't bet)
Seat 6: DihMHaz4WNETH1bPDe13kA (small blind) folded before Flop




PokerStars Game #59941968536:  Hold'em No Limit ($0.10/$0.25) - 2009/07/01 1:51:54 ET
Table 'KKk6y4pAXeymxYcd0uZLqg' 9-max Seat #1 is the button
Seat 1: HPEB+AtKw1+C/cxU0o1ciw ($24.90 in chips) 
Seat 2: k55YB7uP2TAZEba6pnHYiA ($19.80 in chips) 
Seat 3: tLcDklc2rBORNfixyRfVfw ($25 in chips) 
Seat 5: wGigCmBR/9XWkPpvYos3aQ ($40.70 in chips) 
Seat 6: QEbIGci+itdw+re8RM5fZA ($25 in chips) 
Seat 7: JjOuv8Vf56aiQjWi/rTPFA ($22.90 in chips) 
Seat 8: +2kMBNpY4nF1qNCRd8SJLA ($36.05 in chips) 
Seat 9: oLa/tXLfSLLB28mcLGrxcg ($25.10 in chips) 
k55YB7uP2TAZEba6pnHYiA: posts small blind $0.10
tLcDklc2rBORNfixyRfVfw: posts big blind $0.25
18G4P1XstjNvItdGUITxgw: sits out 
*** HOLE CARDS ***
wGigCmBR/9XWkPpvYos3aQ: folds 
QEbIGci+itdw+re8RM5fZA: folds 
JjOuv8Vf56aiQjWi/rTPFA: folds 
+2kMBNpY4nF1qNCRd8SJLA: folds 
oLa/tXLfSLLB28mcLGrxcg: raises $0.75 to $1
HPEB+AtKw1+C/cxU0o1ciw: folds 
k55YB7uP2TAZEba6pnHYiA: folds 
tLcDklc2rBORNfixyRfVfw: folds 
Uncalled bet ($0.75) returned to oLa/tXLfSLLB28mcLGrxcg
oLa/tXLfSLLB28mcLGrxcg collected $0.60 from pot
oLa/tXLfSLLB28mcLGrxcg: doesn't show hand 
*** SUMMARY ***
Total pot $0.60 | Rake $0 
Seat 1: HPEB+AtKw1+C/cxU0o1ciw (button) folded before Flop (didn't bet)
Seat 2: k55YB7uP2TAZEba6pnHYiA (small blind) folded before Flop
Seat 3: tLcDklc2rBORNfixyRfVfw (big blind) folded before Flop
Seat 5: wGigCmBR/9XWkPpvYos3aQ folded before Flop (didn't bet)
Seat 6: QEbIGci+itdw+re8RM5fZA folded before Flop (didn't bet)
Seat 7: JjOuv8Vf56aiQjWi/rTPFA folded before Flop (didn't bet)
Seat 8: +2kMBNpY4nF1qNCRd8SJLA folded before Flop (didn't bet)
Seat 9: oLa/tXLfSLLB28mcLGrxcg collected ($0.60)




PokerStars Game #59941968776:  Hold'em No Limit ($0.10/$0.25) - 2009/07/01 1:51:54 ET
Table '/VaaaFnlEJoYVomG9uxHkA' 9-max Seat #9 is the button
Seat 1: Th3FldXKQW6hWVVPahaoOQ ($25 in chips) 
Seat 2: DIkeSkosO/tsUp9d2JVyTA ($56.45 in chips) 
Seat 3: MtVtHDqIJTyUcXkRBBDIVA ($26.50 in chips) 
Seat 4: j4q3p0lesp63b1gZDwLBZw ($5.35 in chips) 
Seat 5: cZ99hugmLBj9KhTlc8nCSw ($25 in chips) 
Seat 7: F7pnn6czNpHvRM55XcA2EA ($31.25 in chips) 
Seat 8: dfNim92Z6XK1/h5SFW5vDg ($50.50 in chips) 
Seat 9: DdPXdieucQ+n99u1n3A+rQ ($4.65 in chips) 
Th3FldXKQW6hWVVPahaoOQ: posts small blind $0.10
DIkeSkosO/tsUp9d2JVyTA: posts big blind $0.25
*** HOLE CARDS ***
MtVtHDqIJTyUcXkRBBDIVA: folds 
j4q3p0lesp63b1gZDwLBZw: folds 
MtVtHDqIJTyUcXkRBBDIVA is sitting out
cZ99hugmLBj9KhTlc8nCSw: folds 
F7pnn6czNpHvRM55XcA2EA: folds 
dfNim92Z6XK1/h5SFW5vDg: folds 
DdPXdieucQ+n99u1n3A+rQ: folds 
Th3FldXKQW6hWVVPahaoOQ: folds 
Uncalled bet ($0.15) returned to DIkeSkosO/tsUp9d2JVyTA
DIkeSkosO/tsUp9d2JVyTA collected $0.20 from pot
DIkeSkosO/tsUp9d2JVyTA: doesn't show hand 
*** SUMMARY ***
Total pot $0.20 | Rake $0 
Seat 1: Th3FldXKQW6hWVVPahaoOQ (small blind) folded before Flop
Seat 2: DIkeSkosO/tsUp9d2JVyTA (big blind) collected ($0.20)
Seat 3: MtVtHDqIJTyUcXkRBBDIVA folded before Flop (didn't bet)
Seat 4: j4q3p0lesp63b1gZDwLBZw folded before Flop (didn't bet)
Seat 5: cZ99hugmLBj9KhTlc8nCSw folded before Flop (didn't bet)
Seat 7: F7pnn6czNpHvRM55XcA2EA folded before Flop (didn't bet)
Seat 8: dfNim92Z6XK1/h5SFW5vDg folded before Flop (didn't bet)
Seat 9: DdPXdieucQ+n99u1n3A+rQ (button) folded before Flop (didn't bet)




PokerStars Game #59941968422:  Hold'em No Limit ($0.10/$0.25) - 2009/07/01 1:51:54 ET
Table '4mnXP0EWt9mMZYzTIVDQ0w' 9-max Seat #4 is the button
Seat 1: Z5y2J55JmfLYR6/DPAGHwQ ($17.10 in chips) 
Seat 2: BLEU2x2bnGRovIelAY6slA ($25.05 in chips) 
Seat 3: Ns4HpwO7Oiffvyla/ie56w ($17.50 in chips) 
Seat 4: 9lvO/qyU+xrU95Teu1fv0g ($12.15 in chips) 
Seat 5: sSN8Y0AlsBeidZXPKmwXSw ($24.85 in chips) 
Seat 6: 5yjzPss7Y4kAWNDat3e0yQ ($35.65 in chips) 
Seat 7: TtioUKOdJQDGtQyRAYC5Xg ($6.10 in chips) 
Seat 8: 9YN2IkT2JYYKFErZtZvCtA ($14.05 in chips) 
Seat 9: N/O9ADKpmqB2ASZuqgodlw ($7.90 in chips) 
sSN8Y0AlsBeidZXPKmwXSw: posts small blind $0.10
5yjzPss7Y4kAWNDat3e0yQ: posts big blind $0.25
*** HOLE CARDS ***
TtioUKOdJQDGtQyRAYC5Xg: calls $0.25
9YN2IkT2JYYKFErZtZvCtA: folds 
N/O9ADKpmqB2ASZuqgodlw: calls $0.25
Z5y2J55JmfLYR6/DPAGHwQ: folds 
BLEU2x2bnGRovIelAY6slA: folds 
Ns4HpwO7Oiffvyla/ie56w: folds 
9lvO/qyU+xrU95Teu1fv0g: folds 
sSN8Y0AlsBeidZXPKmwXSw: calls $0.15
5yjzPss7Y4kAWNDat3e0yQ: checks 
*** FLOP *** [Qs 2c Qd]
sSN8Y0AlsBeidZXPKmwXSw: checks 
5yjzPss7Y4kAWNDat3e0yQ: checks 
TtioUKOdJQDGtQyRAYC5Xg: checks 
N/O9ADKpmqB2ASZuqgodlw: checks 
*** TURN *** [Qs 2c Qd] [2h]
sSN8Y0AlsBeidZXPKmwXSw: checks 
5yjzPss7Y4kAWNDat3e0yQ: checks 
TtioUKOdJQDGtQyRAYC5Xg: bets $0.75
N/O9ADKpmqB2ASZuqgodlw: calls $0.75
sSN8Y0AlsBeidZXPKmwXSw: folds 
5yjzPss7Y4kAWNDat3e0yQ: folds 
*** RIVER *** [Qs 2c Qd 2h] [6c]
TtioUKOdJQDGtQyRAYC5Xg: bets $1
N/O9ADKpmqB2ASZuqgodlw: raises $3.10 to $4.10
TtioUKOdJQDGtQyRAYC5Xg: folds 
Uncalled bet ($3.10) returned to N/O9ADKpmqB2ASZuqgodlw
N/O9ADKpmqB2ASZuqgodlw collected $4.30 from pot
*** SUMMARY ***
Total pot $4.50 | Rake $0.20 
Board [Qs 2c Qd 2h 6c]
Seat 1: Z5y2J55JmfLYR6/DPAGHwQ folded before Flop (didn't bet)
Seat 2: BLEU2x2bnGRovIelAY6slA folded before Flop (didn't bet)
Seat 3: Ns4HpwO7Oiffvyla/ie56w folded before Flop (didn't bet)
Seat 4: 9lvO/qyU+xrU95Teu1fv0g (button) folded before Flop (didn't bet)
Seat 5: sSN8Y0AlsBeidZXPKmwXSw (small blind) folded on the Turn
Seat 6: 5yjzPss7Y4kAWNDat3e0yQ (big blind) folded on the Turn
Seat 7: TtioUKOdJQDGtQyRAYC5Xg folded on the River
Seat 8: 9YN2IkT2JYYKFErZtZvCtA folded before Flop (didn't bet)
Seat 9: N/O9ADKpmqB2ASZuqgodlw collected ($4.30)




PokerStars Game #59941969250:  Hold'em No Limit ($0.10/$0.25) - 2009/07/01 1:51:55 ET
Table 'WjNvuuSgTjm8jh0j9vcCgQ' 9-max Seat #5 is the button
Seat 1: q+Qdg0Hoir+SyL7haBrUnw ($7.70 in chips) 
Seat 2: ghNKXUBl/H+t83JF079ZBA ($24.90 in chips) 
Seat 3: pSKReiGBNW9NsF2jAZnlwg ($19.55 in chips) 
Seat 4: X78b5v/uhqeXXoAijbw/yg ($31 in chips) 
Seat 5: ziFpkH3wCzqB/qXeq/Hy7g ($26.60 in chips) 
Seat 6: ubsjZomMWSV0hAiBLa7K1A ($22.05 in chips) 
Seat 7: NSX8YOj+RznxoL+rO1YU4w ($18.40 in chips) 
Seat 9: CT7Xj/V/O5rBlhtt+RZeFQ ($25.25 in chips) 
ubsjZomMWSV0hAiBLa7K1A: posts small blind $0.10
NSX8YOj+RznxoL+rO1YU4w: posts big blind $0.25
clJsV3v77RS07bDKY+705w: sits out 
*** HOLE CARDS ***
CT7Xj/V/O5rBlhtt+RZeFQ: folds 
q+Qdg0Hoir+SyL7haBrUnw: folds 
ghNKXUBl/H+t83JF079ZBA: folds 
pSKReiGBNW9NsF2jAZnlwg: calls $0.25
X78b5v/uhqeXXoAijbw/yg: folds 
ziFpkH3wCzqB/qXeq/Hy7g: calls $0.25
ubsjZomMWSV0hAiBLa7K1A: folds 
NSX8YOj+RznxoL+rO1YU4w: checks 
*** FLOP *** [3s Jd Qh]
NSX8YOj+RznxoL+rO1YU4w: checks 
pSKReiGBNW9NsF2jAZnlwg: checks 
ziFpkH3wCzqB/qXeq/Hy7g: checks 
*** TURN *** [3s Jd Qh] [7s]
NSX8YOj+RznxoL+rO1YU4w: checks 
pSKReiGBNW9NsF2jAZnlwg: checks 
ziFpkH3wCzqB/qXeq/Hy7g: checks 
*** RIVER *** [3s Jd Qh 7s] [Jc]
NSX8YOj+RznxoL+rO1YU4w: checks 
pSKReiGBNW9NsF2jAZnlwg: bets $0.50
ziFpkH3wCzqB/qXeq/Hy7g: folds 
NSX8YOj+RznxoL+rO1YU4w: folds 
Uncalled bet ($0.50) returned to pSKReiGBNW9NsF2jAZnlwg
pSKReiGBNW9NsF2jAZnlwg collected $0.85 from pot
*** SUMMARY ***
Total pot $0.85 | Rake $0 
Board [3s Jd Qh 7s Jc]
Seat 1: q+Qdg0Hoir+SyL7haBrUnw folded before Flop (didn't bet)
Seat 2: ghNKXUBl/H+t83JF079ZBA folded before Flop (didn't bet)
Seat 3: pSKReiGBNW9NsF2jAZnlwg collected ($0.85)
Seat 4: X78b5v/uhqeXXoAijbw/yg folded before Flop (didn't bet)
Seat 5: ziFpkH3wCzqB/qXeq/Hy7g (button) folded on the River
Seat 6: ubsjZomMWSV0hAiBLa7K1A (small blind) folded before Flop
Seat 7: NSX8YOj+RznxoL+rO1YU4w (big blind) folded on the River
Seat 9: CT7Xj/V/O5rBlhtt+RZeFQ folded before Flop (didn't bet)




PokerStars Game #59941969024:  Hold'em No Limit ($0.10/$0.25) - 2009/07/01 1:51:55 ET
Table 'b64Z+5XI1xkQzNfq4QHr3A' 6-max Seat #6 is the button
Seat 2: A6SjYLoKeIpFjPq0BK/2WA ($13.75 in chips) 
Seat 3: 7cx44/slbeTw+Cy7QB8Trg ($24.90 in chips) 
Seat 4: 564zqq2DUHXR3tdsOJU6JA ($16.65 in chips) 
Seat 6: 8ClCHtFXGNplITm+63KB+Q ($31.15 in chips) 
Superchimp8 was removed from the table for failing to post
A6SjYLoKeIpFjPq0BK/2WA: posts small blind $0.10
7cx44/slbeTw+Cy7QB8Trg: posts big blind $0.25
08V++DOqzaNrRNsHIwi25w: sits out 
*** HOLE CARDS ***
564zqq2DUHXR3tdsOJU6JA: raises $0.50 to $0.75
8ClCHtFXGNplITm+63KB+Q: folds 
A6SjYLoKeIpFjPq0BK/2WA: folds 
7cx44/slbeTw+Cy7QB8Trg: folds 
Uncalled bet ($0.50) returned to 564zqq2DUHXR3tdsOJU6JA
564zqq2DUHXR3tdsOJU6JA collected $0.60 from pot
564zqq2DUHXR3tdsOJU6JA: doesn't show hand 
*** SUMMARY ***
Total pot $0.60 | Rake $0 
Seat 2: A6SjYLoKeIpFjPq0BK/2WA (small blind) folded before Flop
Seat 3: 7cx44/slbeTw+Cy7QB8Trg (big blind) folded before Flop
Seat 4: 564zqq2DUHXR3tdsOJU6JA collected ($0.60)
Seat 6: 8ClCHtFXGNplITm+63KB+Q (button) folded before Flop (didn't bet)




PokerStars Game #59941969038:  Hold'em No Limit ($0.10/$0.25) - 2009/07/01 1:51:55 ET
Table 'fHv1Mk7ZbLjprZTGWKPiEQ' 6-max Seat #3 is the button
Seat 1: OIjOiBfQstWrK/RuXx7zcw ($4.25 in chips) 
Seat 2: 9U3ZKjCsarN0DjR6mSE8Ug ($13.45 in chips) 
Seat 3: /gJNBeCkWL4o85/jvlZ4BA ($25 in chips) 
Seat 4: TSmua8tGK3sTbwi0ynrW9Q ($59.75 in chips) 
Seat 5: LJI7A1YgDM7hgh7o56+ReQ ($26.30 in chips) 
Seat 6: AjG0X+rNtc2W08eph8oqpw ($52.40 in chips) 
TSmua8tGK3sTbwi0ynrW9Q: posts small blind $0.10
LJI7A1YgDM7hgh7o56+ReQ: posts big blind $0.25
*** HOLE CARDS ***
AjG0X+rNtc2W08eph8oqpw: folds 
OIjOiBfQstWrK/RuXx7zcw: folds 
9U3ZKjCsarN0DjR6mSE8Ug: folds 
/gJNBeCkWL4o85/jvlZ4BA: folds 
TSmua8tGK3sTbwi0ynrW9Q: raises $0.75 to $1
LJI7A1YgDM7hgh7o56+ReQ: folds 
Uncalled bet ($0.75) returned to TSmua8tGK3sTbwi0ynrW9Q
TSmua8tGK3sTbwi0ynrW9Q collected $0.50 from pot
*** SUMMARY ***
Total pot $0.50 | Rake $0 
Seat 1: OIjOiBfQstWrK/RuXx7zcw folded before Flop (didn't bet)
Seat 2: 9U3ZKjCsarN0DjR6mSE8Ug folded before Flop (didn't bet)
Seat 3: /gJNBeCkWL4o85/jvlZ4BA (button) folded before Flop (didn't bet)
Seat 4: TSmua8tGK3sTbwi0ynrW9Q (small blind) collected ($0.50)
Seat 5: LJI7A1YgDM7hgh7o56+ReQ (big blind) folded before Flop
Seat 6: AjG0X+rNtc2W08eph8oqpw folded before Flop (didn't bet)




PokerStars Game #59941969550:  Hold'em No Limit ($0.10/$0.25) - 2009/07/01 1:51:56 ET
Table 'rhQuIjJo0UQ7RRUlF9umHg' 6-max Seat #2 is the button
Seat 1: 5O3Hj9Qg0SqOyKEXoLpjPg ($180.30 in chips) 
Seat 2: Ew/TYPQIsbQ2X8nm5iAJBg ($25.60 in chips) 
Seat 3: if4dh6jhJXeN3/qd3qCp9g ($26.80 in chips) 
Seat 4: aogAb4Eienxztk8p2v9VVw ($25 in chips) 
Seat 5: dOX4wnYV2sEqvDbF+8KSCw ($66.55 in chips) 
Seat 6: /gJNBeCkWL4o85/jvlZ4BA ($47.70 in chips) 
if4dh6jhJXeN3/qd3qCp9g: posts small blind $0.10
aogAb4Eienxztk8p2v9VVw: posts big blind $0.25
*** HOLE CARDS ***
dOX4wnYV2sEqvDbF+8KSCw: folds 
/gJNBeCkWL4o85/jvlZ4BA: folds 
5O3Hj9Qg0SqOyKEXoLpjPg: calls $0.25
Ew/TYPQIsbQ2X8nm5iAJBg: calls $0.25
if4dh6jhJXeN3/qd3qCp9g: calls $0.15
aogAb4Eienxztk8p2v9VVw: checks 
*** FLOP *** [Js Qc 8h]
if4dh6jhJXeN3/qd3qCp9g: checks 
aogAb4Eienxztk8p2v9VVw: checks 
5O3Hj9Qg0SqOyKEXoLpjPg: checks 
Ew/TYPQIsbQ2X8nm5iAJBg: checks 
*** TURN *** [Js Qc 8h] [Jd]
if4dh6jhJXeN3/qd3qCp9g: checks 
aogAb4Eienxztk8p2v9VVw: checks 
5O3Hj9Qg0SqOyKEXoLpjPg: checks 
Ew/TYPQIsbQ2X8nm5iAJBg: checks 
*** RIVER *** [Js Qc 8h Jd] [Ac]
if4dh6jhJXeN3/qd3qCp9g: checks 
aogAb4Eienxztk8p2v9VVw: checks 
5O3Hj9Qg0SqOyKEXoLpjPg: checks 
Ew/TYPQIsbQ2X8nm5iAJBg: checks 
*** SHOW DOWN ***
if4dh6jhJXeN3/qd3qCp9g: shows [4d Ad] (two pair, Aces and Jacks)
aogAb4Eienxztk8p2v9VVw: shows [Ah 9d] (two pair, Aces and Jacks)
5O3Hj9Qg0SqOyKEXoLpjPg: mucks hand 
Ew/TYPQIsbQ2X8nm5iAJBg: mucks hand 
if4dh6jhJXeN3/qd3qCp9g collected $0.50 from pot
aogAb4Eienxztk8p2v9VVw collected $0.45 from pot
*** SUMMARY ***
Total pot $1 | Rake $0.05 
Board [Js Qc 8h Jd Ac]
Seat 1: 5O3Hj9Qg0SqOyKEXoLpjPg mucked
Seat 2: Ew/TYPQIsbQ2X8nm5iAJBg (button) mucked
Seat 3: if4dh6jhJXeN3/qd3qCp9g (small blind) showed [4d Ad] and won ($0.50) with two pair, Aces and Jacks
Seat 4: aogAb4Eienxztk8p2v9VVw (big blind) showed [Ah 9d] and won ($0.45) with two pair, Aces and Jacks
Seat 5: dOX4wnYV2sEqvDbF+8KSCw folded before Flop (didn't bet)
Seat 6: /gJNBeCkWL4o85/jvlZ4BA folded before Flop (didn't bet)




PokerStars Game #59941969668:  Hold'em No Limit ($0.10/$0.25) - 2009/07/01 1:51:56 ET
Table 'dZNBGqFYSwfOVZvDJ4VjIQ' 6-max Seat #2 is the button
Seat 1: v+QfkGiuj9bgtuNoVnDO8w ($37.65 in chips) 
Seat 2: 3zD3qLXT1bEffAoWGnc7wg ($27.60 in chips) 
Seat 3: kyRaCIljYA6l33lSKQfNsg ($29.45 in chips) 
Seat 4: GbCVUNssQ7mqsPWr7J4d3w ($5 in chips) 
Seat 5: +ZlnqPoP3Hg4BIUxDfKd/A ($27.40 in chips) 
Seat 6: ypmjhffk/YHGc51wgVXUTw ($31.25 in chips) 
kyRaCIljYA6l33lSKQfNsg: posts small blind $0.10
GbCVUNssQ7mqsPWr7J4d3w: posts big blind $0.25
*** HOLE CARDS ***
+ZlnqPoP3Hg4BIUxDfKd/A: folds 
ypmjhffk/YHGc51wgVXUTw: folds 
v+QfkGiuj9bgtuNoVnDO8w: folds 
3zD3qLXT1bEffAoWGnc7wg: raises $0.50 to $0.75
kyRaCIljYA6l33lSKQfNsg: folds 
GbCVUNssQ7mqsPWr7J4d3w: folds 
Uncalled bet ($0.50) returned to 3zD3qLXT1bEffAoWGnc7wg
3zD3qLXT1bEffAoWGnc7wg collected $0.60 from pot
3zD3qLXT1bEffAoWGnc7wg: doesn't show hand 
*** SUMMARY ***
Total pot $0.60 | Rake $0 
Seat 1: v+QfkGiuj9bgtuNoVnDO8w folded before Flop (didn't bet)
Seat 2: 3zD3qLXT1bEffAoWGnc7wg (button) collected ($0.60)
Seat 3: kyRaCIljYA6l33lSKQfNsg (small blind) folded before Flop
Seat 4: GbCVUNssQ7mqsPWr7J4d3w (big blind) folded before Flop
Seat 5: +ZlnqPoP3Hg4BIUxDfKd/A folded before Flop (didn't bet)
Seat 6: ypmjhffk/YHGc51wgVXUTw folded before Flop (didn't bet)




PokerStars Game #59941969592:  Hold'em No Limit ($0.10/$0.25) - 2009/07/01 1:51:56 ET
Table '60nA7av6bws9VnNmVwculA' 6-max Seat #2 is the button
Seat 1: if4dh6jhJXeN3/qd3qCp9g ($25 in chips) 
Seat 2: Bada343Si4xKu3fNXY99AA ($5.40 in chips) 
Seat 3: mnuJq+Q1IXKm/pCy+OzxmQ ($25.95 in chips) 
Seat 4: +baiVgI/ETnBARLe5mARCw ($18.60 in chips) 
Seat 5: zXh+lOT41Q2iWgCNj+OcRw ($11.60 in chips) 
Seat 6: mfrkWA3PTeYPkbO6hi98Aw ($25 in chips) 
mnuJq+Q1IXKm/pCy+OzxmQ: posts small blind $0.10
+baiVgI/ETnBARLe5mARCw: posts big blind $0.25
*** HOLE CARDS ***
zXh+lOT41Q2iWgCNj+OcRw: folds 
mfrkWA3PTeYPkbO6hi98Aw: folds 
if4dh6jhJXeN3/qd3qCp9g: folds 
Bada343Si4xKu3fNXY99AA: folds 
mnuJq+Q1IXKm/pCy+OzxmQ: folds 
Uncalled bet ($0.15) returned to +baiVgI/ETnBARLe5mARCw
+baiVgI/ETnBARLe5mARCw collected $0.20 from pot
+baiVgI/ETnBARLe5mARCw: doesn't show hand 
*** SUMMARY ***
Total pot $0.20 | Rake $0 
Seat 1: if4dh6jhJXeN3/qd3qCp9g folded before Flop (didn't bet)
Seat 2: Bada343Si4xKu3fNXY99AA (button) folded before Flop (didn't bet)
Seat 3: mnuJq+Q1IXKm/pCy+OzxmQ (small blind) folded before Flop
Seat 4: +baiVgI/ETnBARLe5mARCw (big blind) collected ($0.20)
Seat 5: zXh+lOT41Q2iWgCNj+OcRw folded before Flop (didn't bet)
Seat 6: mfrkWA3PTeYPkbO6hi98Aw folded before Flop (didn't bet)




PokerStars Game #59941969846:  Hold'em No Limit ($0.10/$0.25) - 2009/07/01 1:51:56 ET
Table '3Ns9nuTkynfwbBfBXzg6ww' 6-max Seat #6 is the button
Seat 1: epAUIB7h2FJXzUPRIvSkRA ($25 in chips) 
Seat 2: zxeVQGaMKDsDzmSY+AInjA ($34 in chips) 
Seat 3: eL3+wCBjFGfQ5FMdIZihwA ($23.60 in chips) 
Seat 4: qGHGf/553gQnDoklMRe3tg ($31.50 in chips) 
Seat 5: wqphQtauX5Qn7WRJZS1flA ($24.05 in chips) 
Seat 6: DE9hRlt14g+JdsRQ4wT7hg ($38 in chips) 
epAUIB7h2FJXzUPRIvSkRA: posts small blind $0.10
zxeVQGaMKDsDzmSY+AInjA: posts big blind $0.25
*** HOLE CARDS ***
eL3+wCBjFGfQ5FMdIZihwA: folds 
qGHGf/553gQnDoklMRe3tg: raises $0.75 to $1
wqphQtauX5Qn7WRJZS1flA: folds 
DE9hRlt14g+JdsRQ4wT7hg: folds 
epAUIB7h2FJXzUPRIvSkRA: folds 
zxeVQGaMKDsDzmSY+AInjA: calls $0.75
*** FLOP *** [Qs 3c 9h]
zxeVQGaMKDsDzmSY+AInjA: checks 
qGHGf/553gQnDoklMRe3tg: bets $1.50
zxeVQGaMKDsDzmSY+AInjA: calls $1.50
*** TURN *** [Qs 3c 9h] [7h]
zxeVQGaMKDsDzmSY+AInjA: checks 
qGHGf/553gQnDoklMRe3tg: bets $3
zxeVQGaMKDsDzmSY+AInjA: folds 
Uncalled bet ($3) returned to qGHGf/553gQnDoklMRe3tg
qGHGf/553gQnDoklMRe3tg collected $4.85 from pot
*** SUMMARY ***
Total pot $5.10 | Rake $0.25 
Board [Qs 3c 9h 7h]
Seat 1: epAUIB7h2FJXzUPRIvSkRA (small blind) folded before Flop
Seat 2: zxeVQGaMKDsDzmSY+AInjA (big blind) folded on the Turn
Seat 3: eL3+wCBjFGfQ5FMdIZihwA folded before Flop (didn't bet)
Seat 4: qGHGf/553gQnDoklMRe3tg collected ($4.85)
Seat 5: wqphQtauX5Qn7WRJZS1flA folded before Flop (didn't bet)
Seat 6: DE9hRlt14g+JdsRQ4wT7hg (button) folded before Flop (didn't bet)




PokerStars Game #59941969882:  Hold'em No Limit ($0.10/$0.25) - 2009/07/01 1:51:56 ET
Table '4ZbiE0ZYjzqmgu6+sO1prg' 9-max Seat #8 is the button
Seat 2: 9lvO/qyU+xrU95Teu1fv0g ($5.55 in chips) 
Seat 3: HPEB+AtKw1+C/cxU0o1ciw ($25.20 in chips) 
Seat 4: w1ukf8uPa4+WH561TtVRxA ($25.25 in chips) 
Seat 5: +2kMBNpY4nF1qNCRd8SJLA ($43.60 in chips) 
Seat 6: UmzixCpC0bAc1lDEjgB3NQ ($11.05 in chips) 
Seat 7: aNpwfA31EREwO+ar4XzBCw ($25.95 in chips) 
Seat 8: cZ99hugmLBj9KhTlc8nCSw ($29.25 in chips) 
Seat 9: RCqMONFrSPSArZh2Jsar/w ($19.85 in chips) 
RCqMONFrSPSArZh2Jsar/w: posts small blind $0.10
9lvO/qyU+xrU95Teu1fv0g: posts big blind $0.25
*** HOLE CARDS ***
HPEB+AtKw1+C/cxU0o1ciw: folds 
w1ukf8uPa4+WH561TtVRxA: folds 
+2kMBNpY4nF1qNCRd8SJLA: raises $0.75 to $1
UmzixCpC0bAc1lDEjgB3NQ: folds 
aNpwfA31EREwO+ar4XzBCw: folds 
cZ99hugmLBj9KhTlc8nCSw: folds 
RCqMONFrSPSArZh2Jsar/w: raises $2 to $3
9lvO/qyU+xrU95Teu1fv0g: folds 
+2kMBNpY4nF1qNCRd8SJLA: calls $2
*** FLOP *** [Ah Th Td]
RCqMONFrSPSArZh2Jsar/w: bets $2.50
+2kMBNpY4nF1qNCRd8SJLA: calls $2.50
*** TURN *** [Ah Th Td] [3d]
RCqMONFrSPSArZh2Jsar/w: checks 
+2kMBNpY4nF1qNCRd8SJLA: bets $2
RCqMONFrSPSArZh2Jsar/w: calls $2
*** RIVER *** [Ah Th Td 3d] [Ks]
RCqMONFrSPSArZh2Jsar/w: checks 
+2kMBNpY4nF1qNCRd8SJLA: bets $3
RCqMONFrSPSArZh2Jsar/w: calls $3
*** SHOW DOWN ***
+2kMBNpY4nF1qNCRd8SJLA: shows [As Kd] (two pair, Aces and Kings)
RCqMONFrSPSArZh2Jsar/w: mucks hand 
Iu9xjReQYvxYiqQm8n6MXQ joins the table at seat #1 
+2kMBNpY4nF1qNCRd8SJLA collected $20.25 from pot
*** SUMMARY ***
Total pot $21.25 | Rake $1 
Board [Ah Th Td 3d Ks]
Seat 2: 9lvO/qyU+xrU95Teu1fv0g (big blind) folded before Flop
Seat 3: HPEB+AtKw1+C/cxU0o1ciw folded before Flop (didn't bet)
Seat 4: w1ukf8uPa4+WH561TtVRxA folded before Flop (didn't bet)
Seat 5: +2kMBNpY4nF1qNCRd8SJLA showed [As Kd] and won ($20.25) with two pair, Aces and Kings
Seat 6: UmzixCpC0bAc1lDEjgB3NQ folded before Flop (didn't bet)
Seat 7: aNpwfA31EREwO+ar4XzBCw folded before Flop (didn't bet)
Seat 8: cZ99hugmLBj9KhTlc8nCSw (button) folded before Flop (didn't bet)
Seat 9: RCqMONFrSPSArZh2Jsar/w (small blind) mucked




PokerStars Game #59941969820:  Hold'em No Limit ($0.10/$0.25) - 2009/07/01 1:51:56 ET
Table 'x7YStLKc8hpt/pTgSetPKA' 9-max Seat #9 is the button
Seat 2: z5GxcHlYz/GSz6W2uFiTtg ($19.85 in chips) 
Seat 3: S7Ki0P+0AIGPuIfGJjW0gg ($11.10 in chips) 
Seat 4: ydoFOVgzvZv9ZhuWu9rXAw ($8.30 in chips) 
Seat 5: tLcDklc2rBORNfixyRfVfw ($25 in chips) 
Seat 6: 9YN2IkT2JYYKFErZtZvCtA ($49.25 in chips) 
Seat 7: dtZ84flFEi4Q+SGrHMJRDQ ($25 in chips) 
Seat 8: j4q3p0lesp63b1gZDwLBZw ($5.50 in chips) 
Seat 9: nm4Dj/f+jJEwKVsUnKh73g ($37.20 in chips) 
satchmoiluvu will be allowed to play after the button
z5GxcHlYz/GSz6W2uFiTtg: posts small blind $0.10
S7Ki0P+0AIGPuIfGJjW0gg: posts big blind $0.25
*** HOLE CARDS ***
ydoFOVgzvZv9ZhuWu9rXAw: folds 
tLcDklc2rBORNfixyRfVfw: folds 
9YN2IkT2JYYKFErZtZvCtA: raises $0.75 to $1
dtZ84flFEi4Q+SGrHMJRDQ: folds 
ydoFOVgzvZv9ZhuWu9rXAw leaves the table
j4q3p0lesp63b1gZDwLBZw: folds 
nm4Dj/f+jJEwKVsUnKh73g: folds 
z5GxcHlYz/GSz6W2uFiTtg: folds 
S7Ki0P+0AIGPuIfGJjW0gg: folds 
Uncalled bet ($0.75) returned to 9YN2IkT2JYYKFErZtZvCtA
9YN2IkT2JYYKFErZtZvCtA collected $0.60 from pot
9YN2IkT2JYYKFErZtZvCtA: doesn't show hand 
*** SUMMARY ***
Total pot $0.60 | Rake $0 
Seat 2: z5GxcHlYz/GSz6W2uFiTtg (small blind) folded before Flop
Seat 3: S7Ki0P+0AIGPuIfGJjW0gg (big blind) folded before Flop
Seat 4: ydoFOVgzvZv9ZhuWu9rXAw folded before Flop (didn't bet)
Seat 5: tLcDklc2rBORNfixyRfVfw folded before Flop (didn't bet)
Seat 6: 9YN2IkT2JYYKFErZtZvCtA collected ($0.60)
Seat 7: dtZ84flFEi4Q+SGrHMJRDQ folded before Flop (didn't bet)
Seat 8: j4q3p0lesp63b1gZDwLBZw folded before Flop (didn't bet)
Seat 9: nm4Dj/f+jJEwKVsUnKh73g (button) folded before Flop (didn't bet)




PokerStars Game #59941969642:  Hold'em No Limit ($0.10/$0.25) - 2009/07/01 1:51:56 ET
Table 'edvgY2YQ1I34euq4EVqGnA' 6-max Seat #3 is the button
Seat 1: mvFHK3pE7tCxJEqLjKC70Q ($30.70 in chips) 
Seat 3: muaYRdOUlJzdJ0zHxvRGlQ ($15.20 in chips) 
Seat 4: TI/C5Q+DEl4fLR3AofwYdg ($22.10 in chips) 
Seat 5: EE16Ua5b1HSsYej5zeXOlA ($57.25 in chips) 
Seat 6: kG34n23qFQA3nzdOJTQ1dA ($70.40 in chips) 
TI/C5Q+DEl4fLR3AofwYdg: posts small blind $0.10
EE16Ua5b1HSsYej5zeXOlA: posts big blind $0.25
*** HOLE CARDS ***
kG34n23qFQA3nzdOJTQ1dA: folds 
mvFHK3pE7tCxJEqLjKC70Q: folds 
muaYRdOUlJzdJ0zHxvRGlQ: calls $0.25
TI/C5Q+DEl4fLR3AofwYdg: raises $0.50 to $0.75
EE16Ua5b1HSsYej5zeXOlA: folds 
muaYRdOUlJzdJ0zHxvRGlQ: calls $0.50
*** FLOP *** [2h 7c 5d]
TI/C5Q+DEl4fLR3AofwYdg: bets $1
muaYRdOUlJzdJ0zHxvRGlQ: calls $1
*** TURN *** [2h 7c 5d] [Qd]
TI/C5Q+DEl4fLR3AofwYdg: bets $1
muaYRdOUlJzdJ0zHxvRGlQ: calls $1
*** RIVER *** [2h 7c 5d Qd] [5s]
TI/C5Q+DEl4fLR3AofwYdg: bets $3
FRpCzMJnbXYfQIPzAs4Faw joins the table at seat #2 
muaYRdOUlJzdJ0zHxvRGlQ: raises $9.45 to $12.45 and is all-in
TI/C5Q+DEl4fLR3AofwYdg: folds 
Uncalled bet ($9.45) returned to muaYRdOUlJzdJ0zHxvRGlQ
muaYRdOUlJzdJ0zHxvRGlQ collected $11.20 from pot
*** SUMMARY ***
Total pot $11.75 | Rake $0.55 
Board [2h 7c 5d Qd 5s]
Seat 1: mvFHK3pE7tCxJEqLjKC70Q folded before Flop (didn't bet)
Seat 3: muaYRdOUlJzdJ0zHxvRGlQ (button) collected ($11.20)
Seat 4: TI/C5Q+DEl4fLR3AofwYdg (small blind) folded on the River
Seat 5: EE16Ua5b1HSsYej5zeXOlA (big blind) folded before Flop
Seat 6: kG34n23qFQA3nzdOJTQ1dA folded before Flop (didn't bet)




PokerStars Game #59941969722:  Hold'em No Limit ($0.10/$0.25) - 2009/07/01 1:51:56 ET
Table 'IRgQPZVA4+IaZZIQshgwyg' 6-max Seat #1 is the button
Seat 1: cezpHJ8FB07dj0xG+LhOvw ($27.20 in chips) 
Seat 3: DihMHaz4WNETH1bPDe13kA ($27.55 in chips) 
Seat 4: DE9hRlt14g+JdsRQ4wT7hg ($25.35 in chips) 
Seat 5: w43JQj2oYPpKQVG4Yzlq1w ($28.05 in chips) 
Seat 6: x9/USY6PsmgUGQeluFLKDw ($20.95 in chips) 
DihMHaz4WNETH1bPDe13kA: posts small blind $0.10
DE9hRlt14g+JdsRQ4wT7hg: posts big blind $0.25
*** HOLE CARDS ***
HZrrzaHXN9+c2uyWFqzULg joins the table at seat #2 
w43JQj2oYPpKQVG4Yzlq1w: folds 
x9/USY6PsmgUGQeluFLKDw: folds 
cezpHJ8FB07dj0xG+LhOvw: raises $0.50 to $0.75
DihMHaz4WNETH1bPDe13kA: folds 
DE9hRlt14g+JdsRQ4wT7hg: folds 
Uncalled bet ($0.50) returned to cezpHJ8FB07dj0xG+LhOvw
cezpHJ8FB07dj0xG+LhOvw collected $0.60 from pot
*** SUMMARY ***
Total pot $0.60 | Rake $0 
Seat 1: cezpHJ8FB07dj0xG+LhOvw (button) collected ($0.60)
Seat 3: DihMHaz4WNETH1bPDe13kA (small blind) folded before Flop
Seat 4: DE9hRlt14g+JdsRQ4wT7hg (big blind) folded before Flop
Seat 5: w43JQj2oYPpKQVG4Yzlq1w folded before Flop (didn't bet)
Seat 6: x9/USY6PsmgUGQeluFLKDw folded before Flop (didn't bet)




PokerStars Game #59941969492:  Hold'em No Limit ($0.10/$0.25) - 2009/07/01 1:51:56 ET
Table 'pPgW4R3kdH26lLi1MnE92w' 9-max Seat #8 is the button
Seat 1: F4P6SxCNY4vxdb318G9RwA ($20 in chips) 
Seat 2: cZ99hugmLBj9KhTlc8nCSw ($28 in chips) 
Seat 3: WaS7+xnv4bIVHoru6nxczA ($14 in chips) 
Seat 4: iZ1f67Ok/207yzIQOu1Kdg ($2.50 in chips) 
Seat 5: HPEB+AtKw1+C/cxU0o1ciw ($24.25 in chips) 
Seat 6: +qc/EYCgLC65SpGvr35eNg ($25 in chips) 
Seat 7: sD+TKtt36XiiN6jqHiLwDA ($28.70 in chips) 
Seat 8: clJsV3v77RS07bDKY+705w ($5 in chips) 
Seat 9: tcbEu7VzyHQ+0lh+skbQhQ ($64.65 in chips) 
tcbEu7VzyHQ+0lh+skbQhQ: posts small blind $0.10
F4P6SxCNY4vxdb318G9RwA: posts big blind $0.25
*** HOLE CARDS ***
cZ99hugmLBj9KhTlc8nCSw: folds 
WaS7+xnv4bIVHoru6nxczA: folds 
iZ1f67Ok/207yzIQOu1Kdg: folds 
HPEB+AtKw1+C/cxU0o1ciw: folds 
+qc/EYCgLC65SpGvr35eNg: calls $0.25
sD+TKtt36XiiN6jqHiLwDA: folds 
clJsV3v77RS07bDKY+705w: folds 
tcbEu7VzyHQ+0lh+skbQhQ: calls $0.15
F4P6SxCNY4vxdb318G9RwA: checks 
*** FLOP *** [2c 3h 6c]
tcbEu7VzyHQ+0lh+skbQhQ: bets $0.75
F4P6SxCNY4vxdb318G9RwA: folds 
+qc/EYCgLC65SpGvr35eNg: calls $0.75
*** TURN *** [2c 3h 6c] [Jc]
tcbEu7VzyHQ+0lh+skbQhQ: bets $1.75
+qc/EYCgLC65SpGvr35eNg: folds 
Uncalled bet ($1.75) returned to tcbEu7VzyHQ+0lh+skbQhQ
tcbEu7VzyHQ+0lh+skbQhQ collected $2.15 from pot
*** SUMMARY ***
Total pot $2.25 | Rake $0.10 
Board [2c 3h 6c Jc]
Seat 1: F4P6SxCNY4vxdb318G9RwA (big blind) folded on the Flop
Seat 2: cZ99hugmLBj9KhTlc8nCSw folded before Flop (didn't bet)
Seat 3: WaS7+xnv4bIVHoru6nxczA folded before Flop (didn't bet)
Seat 4: iZ1f67Ok/207yzIQOu1Kdg folded before Flop (didn't bet)
Seat 5: HPEB+AtKw1+C/cxU0o1ciw folded before Flop (didn't bet)
Seat 6: +qc/EYCgLC65SpGvr35eNg folded on the Turn
Seat 7: sD+TKtt36XiiN6jqHiLwDA folded before Flop (didn't bet)
Seat 8: clJsV3v77RS07bDKY+705w (button) folded before Flop (didn't bet)
Seat 9: tcbEu7VzyHQ+0lh+skbQhQ (small blind) collected ($2.15)




PokerStars Game #59941969792:  Hold'em No Limit ($0.10/$0.25) - 2009/07/01 1:51:56 ET
Table 'fRxOyfaHXkWUDLv4eSxFew' 9-max Seat #8 is the button
Seat 1: 6RiVTYll/5D8zICp0MRpKw ($29.40 in chips) 
Seat 2: M2QO2DxB5Wawg2h8HSpnYA ($10 in chips) 
Seat 3: E0iYnEVO2ho7dH3QcCjw7g ($29.70 in chips) 
Seat 4: MtVtHDqIJTyUcXkRBBDIVA ($27.60 in chips) 
Seat 5: dmYlc+1cjwZMJ7wV+Z0rRg ($21.65 in chips) 
Seat 6: arxNSjreDRGFg13EAM2F1w ($27.05 in chips) 
Seat 7: 1/DuWziR8CXhWB71aPQd9Q ($10.95 in chips) 
Seat 8: 5n7e7I+px7c6CQmLpPbtsg ($6.65 in chips) 
Seat 9: H5Se03ZqSX7tbULXur2MAg ($33 in chips) 
H5Se03ZqSX7tbULXur2MAg: posts small blind $0.10
6RiVTYll/5D8zICp0MRpKw: posts big blind $0.25
*** HOLE CARDS ***
M2QO2DxB5Wawg2h8HSpnYA: folds 
E0iYnEVO2ho7dH3QcCjw7g: folds 
MtVtHDqIJTyUcXkRBBDIVA: raises $0.50 to $0.75
dmYlc+1cjwZMJ7wV+Z0rRg: calls $0.75
arxNSjreDRGFg13EAM2F1w: folds 
1/DuWziR8CXhWB71aPQd9Q: folds 
5n7e7I+px7c6CQmLpPbtsg: folds 
H5Se03ZqSX7tbULXur2MAg: folds 
6RiVTYll/5D8zICp0MRpKw: calls $0.50
*** FLOP *** [As Ac Qc]
6RiVTYll/5D8zICp0MRpKw: checks 
MtVtHDqIJTyUcXkRBBDIVA: bets $1.50
dmYlc+1cjwZMJ7wV+Z0rRg: folds 
6RiVTYll/5D8zICp0MRpKw: calls $1.50
*** TURN *** [As Ac Qc] [9h]
6RiVTYll/5D8zICp0MRpKw: checks 
MtVtHDqIJTyUcXkRBBDIVA: bets $3.25
6RiVTYll/5D8zICp0MRpKw: folds 
Uncalled bet ($3.25) returned to MtVtHDqIJTyUcXkRBBDIVA
MtVtHDqIJTyUcXkRBBDIVA collected $5.10 from pot
MtVtHDqIJTyUcXkRBBDIVA: doesn't show hand 
*** SUMMARY ***
Total pot $5.35 | Rake $0.25 
Board [As Ac Qc 9h]
Seat 1: 6RiVTYll/5D8zICp0MRpKw (big blind) folded on the Turn
Seat 2: M2QO2DxB5Wawg2h8HSpnYA folded before Flop (didn't bet)
Seat 3: E0iYnEVO2ho7dH3QcCjw7g folded before Flop (didn't bet)
Seat 4: MtVtHDqIJTyUcXkRBBDIVA collected ($5.10)
Seat 5: dmYlc+1cjwZMJ7wV+Z0rRg folded on the Flop
Seat 6: arxNSjreDRGFg13EAM2F1w folded before Flop (didn't bet)
Seat 7: 1/DuWziR8CXhWB71aPQd9Q folded before Flop (didn't bet)
Seat 8: 5n7e7I+px7c6CQmLpPbtsg (button) folded before Flop (didn't bet)
Seat 9: H5Se03ZqSX7tbULXur2MAg (small blind) folded before Flop




PokerStars Game #59941970396:  Hold'em No Limit ($0.10/$0.25) - 2009/07/01 1:51:57 ET
Table 'dNYnr4D4id1jwnEU66Yowg' 9-max Seat #9 is the button
Seat 1: 9lvO/qyU+xrU95Teu1fv0g ($4.50 in chips) 
Seat 2: Qduu7ikeizo6q6Ei9YvcJA ($35.25 in chips) 
Seat 3: IOx4EH8+y3jYZJc/LTRvOw ($24.75 in chips) 
Seat 4: VBHxUExRAMrbxUq/cVx9Gw ($5 in chips) 
Seat 5: 7cv+9Zc9HIQHNvYsMfV3uA ($27.05 in chips) 
Seat 6: 8EbrQ/EvFWt2cr0GaU82gQ ($4.15 in chips) 
Seat 7: DiSvPC2iudwL5j9u6Huyww ($25 in chips) 
Seat 8: RCqMONFrSPSArZh2Jsar/w ($32.85 in chips) 
Seat 9: /FE4MKSoQhXaDp4PBoLM2g ($4.10 in chips) 
9lvO/qyU+xrU95Teu1fv0g: posts small blind $0.10
Qduu7ikeizo6q6Ei9YvcJA: posts big blind $0.25
*** HOLE CARDS ***
IOx4EH8+y3jYZJc/LTRvOw: raises $0.25 to $0.50
VBHxUExRAMrbxUq/cVx9Gw: folds 
7cv+9Zc9HIQHNvYsMfV3uA: raises $1.25 to $1.75
8EbrQ/EvFWt2cr0GaU82gQ: folds 
DiSvPC2iudwL5j9u6Huyww: folds 
RCqMONFrSPSArZh2Jsar/w: folds 
/FE4MKSoQhXaDp4PBoLM2g: folds 
9lvO/qyU+xrU95Teu1fv0g: folds 
Qduu7ikeizo6q6Ei9YvcJA: folds 
IOx4EH8+y3jYZJc/LTRvOw: calls $1.25
*** FLOP *** [8d 5h Kc]
IOx4EH8+y3jYZJc/LTRvOw: checks 
7cv+9Zc9HIQHNvYsMfV3uA: bets $2.75
IOx4EH8+y3jYZJc/LTRvOw: raises $2.75 to $5.50
7cv+9Zc9HIQHNvYsMfV3uA: folds 
Uncalled bet ($2.75) returned to IOx4EH8+y3jYZJc/LTRvOw
IOx4EH8+y3jYZJc/LTRvOw collected $8.90 from pot
*** SUMMARY ***
Total pot $9.35 | Rake $0.45 
Board [8d 5h Kc]
Seat 1: 9lvO/qyU+xrU95Teu1fv0g (small blind) folded before Flop
Seat 2: Qduu7ikeizo6q6Ei9YvcJA (big blind) folded before Flop
Seat 3: IOx4EH8+y3jYZJc/LTRvOw collected ($8.90)
Seat 4: VBHxUExRAMrbxUq/cVx9Gw folded before Flop (didn't bet)
Seat 5: 7cv+9Zc9HIQHNvYsMfV3uA folded on the Flop
Seat 6: 8EbrQ/EvFWt2cr0GaU82gQ folded before Flop (didn't bet)
Seat 7: DiSvPC2iudwL5j9u6Huyww folded before Flop (didn't bet)
Seat 8: RCqMONFrSPSArZh2Jsar/w folded before Flop (didn't bet)
Seat 9: /FE4MKSoQhXaDp4PBoLM2g (button) folded before Flop (didn't bet)




PokerStars Game #59941970236:  Hold'em No Limit ($0.10/$0.25) - 2009/07/01 1:51:57 ET
Table 'AHkg4ChqzcMauBx6Qvz8Nw' 6-max Seat #3 is the button
Seat 1: +RDf7SmUjY2kK0PzdBEYqg ($2.05 in chips) 
Seat 2: Vi0JMrTI2BGrPL7UIulJtA ($3.75 in chips) 
Seat 3: 9dToMv2GJLfi00HcpfMnIw ($30.35 in chips) 
Seat 4: Eznneya0vB6S+eXJdVleHA ($21.65 in chips) 
Seat 5: Bada343Si4xKu3fNXY99AA ($3.80 in chips) 
Eznneya0vB6S+eXJdVleHA: posts small blind $0.10
Bada343Si4xKu3fNXY99AA: posts big blind $0.25
+RDf7SmUjY2kK0PzdBEYqg: posts big blind $0.25
*** HOLE CARDS ***
+RDf7SmUjY2kK0PzdBEYqg: checks 
Vi0JMrTI2BGrPL7UIulJtA: calls $0.25
9dToMv2GJLfi00HcpfMnIw: calls $0.25
Eznneya0vB6S+eXJdVleHA: calls $0.15
Bada343Si4xKu3fNXY99AA: checks 
*** FLOP *** [As 4c 8h]
Eznneya0vB6S+eXJdVleHA: checks 
Bada343Si4xKu3fNXY99AA: checks 
+RDf7SmUjY2kK0PzdBEYqg: bets $0.25
Vi0JMrTI2BGrPL7UIulJtA: folds 
9dToMv2GJLfi00HcpfMnIw: calls $0.25
Eznneya0vB6S+eXJdVleHA: folds 
Bada343Si4xKu3fNXY99AA: folds 
*** TURN *** [As 4c 8h] [Ks]
+RDf7SmUjY2kK0PzdBEYqg: bets $0.50
9dToMv2GJLfi00HcpfMnIw: raises $0.50 to $1
+RDf7SmUjY2kK0PzdBEYqg: raises $0.50 to $1.50
9dToMv2GJLfi00HcpfMnIw: raises $0.50 to $2
+RDf7SmUjY2kK0PzdBEYqg: calls $0.05 and is all-in
Uncalled bet ($0.45) returned to 9dToMv2GJLfi00HcpfMnIw
*** RIVER *** [As 4c 8h Ks] [2h]
*** SHOW DOWN ***
+RDf7SmUjY2kK0PzdBEYqg: shows [4d 4h] (three of a kind, Fours)
9dToMv2GJLfi00HcpfMnIw: mucks hand 
+RDf7SmUjY2kK0PzdBEYqg collected $4.65 from pot
*** SUMMARY ***
Total pot $4.85 | Rake $0.20 
Board [As 4c 8h Ks 2h]
Seat 1: +RDf7SmUjY2kK0PzdBEYqg showed [4d 4h] and won ($4.65) with three of a kind, Fours
Seat 2: Vi0JMrTI2BGrPL7UIulJtA folded on the Flop
Seat 3: 9dToMv2GJLfi00HcpfMnIw (button) mucked
Seat 4: Eznneya0vB6S+eXJdVleHA (small blind) folded on the Flop
Seat 5: Bada343Si4xKu3fNXY99AA (big blind) folded on the Flop




PokerStars Game #59941970716:  Hold'em No Limit ($0.10/$0.25) - 2009/07/01 1:51:58 ET
Table 'KYX9dFNuOA9l2PV46IebqQ' 9-max Seat #2 is the button
Seat 1: qZqVFan2U+GAA/c5LQFbcw ($14.70 in chips) 
Seat 2: GeMoapCKDLc4ajT0Uk9ZQw ($9.65 in chips) 
Seat 3: Uq3NSX4cIFaXe7pbXQuU+Q ($7.30 in chips) 
Seat 4: ly/lwri2xlF+wmFsvottuQ ($4.25 in chips) 
Seat 5: g7MXhRmNZxv1lIkKkUKa4w ($19.75 in chips) 
Seat 6: 4QYM+pWPc3J+6i8Zv8LvLg ($25 in chips) 
Seat 8: KRWTiGM4xH+MkvPtJz4+SA ($22.55 in chips) 
Seat 9: 6NECk10orj8iqgD3pZ2A0Q ($6.30 in chips) 
Uq3NSX4cIFaXe7pbXQuU+Q: posts small blind $0.10
ly/lwri2xlF+wmFsvottuQ: posts big blind $0.25
*** HOLE CARDS ***
g7MXhRmNZxv1lIkKkUKa4w: calls $0.25
4QYM+pWPc3J+6i8Zv8LvLg: folds 
KRWTiGM4xH+MkvPtJz4+SA: calls $0.25
6NECk10orj8iqgD3pZ2A0Q: raises $0.25 to $0.50
qZqVFan2U+GAA/c5LQFbcw: folds 
I.F.R joins the table at seat #7 
GeMoapCKDLc4ajT0Uk9ZQw: folds 
Uq3NSX4cIFaXe7pbXQuU+Q: folds 
ly/lwri2xlF+wmFsvottuQ: folds 
g7MXhRmNZxv1lIkKkUKa4w: calls $0.25
KRWTiGM4xH+MkvPtJz4+SA: folds 
*** FLOP *** [8d 6d 4d]
g7MXhRmNZxv1lIkKkUKa4w: checks 
6NECk10orj8iqgD3pZ2A0Q: checks 
*** TURN *** [8d 6d 4d] [Ad]
g7MXhRmNZxv1lIkKkUKa4w: bets $0.50
6NECk10orj8iqgD3pZ2A0Q: raises $0.50 to $1
g7MXhRmNZxv1lIkKkUKa4w: calls $0.50
*** RIVER *** [8d 6d 4d Ad] [3h]
g7MXhRmNZxv1lIkKkUKa4w: bets $1
6NECk10orj8iqgD3pZ2A0Q: raises $1 to $2
g7MXhRmNZxv1lIkKkUKa4w: calls $1
*** SHOW DOWN ***
6NECk10orj8iqgD3pZ2A0Q: shows [Qd Qh] (a flush, Ace high)
g7MXhRmNZxv1lIkKkUKa4w: mucks hand 
6NECk10orj8iqgD3pZ2A0Q collected $7.25 from pot
*** SUMMARY ***
Total pot $7.60 | Rake $0.35 
Board [8d 6d 4d Ad 3h]
Seat 1: qZqVFan2U+GAA/c5LQFbcw folded before Flop (didn't bet)
Seat 2: GeMoapCKDLc4ajT0Uk9ZQw (button) folded before Flop (didn't bet)
Seat 3: Uq3NSX4cIFaXe7pbXQuU+Q (small blind) folded before Flop
Seat 4: ly/lwri2xlF+wmFsvottuQ (big blind) folded before Flop
Seat 5: g7MXhRmNZxv1lIkKkUKa4w mucked
Seat 6: 4QYM+pWPc3J+6i8Zv8LvLg folded before Flop (didn't bet)
Seat 8: KRWTiGM4xH+MkvPtJz4+SA folded before Flop
Seat 9: 6NECk10orj8iqgD3pZ2A0Q showed [Qd Qh] and won ($7.25) with a flush, Ace high




PokerStars Game #59941970592:  Hold'em No Limit ($0.10/$0.25) - 2009/07/01 1:51:58 ET
Table '63h13e5p7cWe02rClZ1CHw' 6-max Seat #5 is the button
Seat 1: pokjbbEcXXPlADXdSGHtZw ($21.35 in chips) 
Seat 2: k9nHZTHt8hYhYRcW8NTb4g ($25.30 in chips) 
Seat 3: hOaWAImn5/MZDAWAPlYHCw ($5.55 in chips) 
Seat 4: xrf8tAXKQHG99HixCot1Iw ($28 in chips) 
Seat 5: iyZxqznXjv3vtvOJymkoLQ ($44.10 in chips) 
Seat 6: mfrkWA3PTeYPkbO6hi98Aw ($38.20 in chips) 
mfrkWA3PTeYPkbO6hi98Aw: posts small blind $0.10
pokjbbEcXXPlADXdSGHtZw: posts big blind $0.25
*** HOLE CARDS ***
k9nHZTHt8hYhYRcW8NTb4g: raises $0.50 to $0.75
hOaWAImn5/MZDAWAPlYHCw: folds 
xrf8tAXKQHG99HixCot1Iw: folds 
hOaWAImn5/MZDAWAPlYHCw leaves the table
iyZxqznXjv3vtvOJymkoLQ: folds 
mfrkWA3PTeYPkbO6hi98Aw: folds 
pokjbbEcXXPlADXdSGHtZw: folds 
Uncalled bet ($0.50) returned to k9nHZTHt8hYhYRcW8NTb4g
k9nHZTHt8hYhYRcW8NTb4g collected $0.60 from pot
k9nHZTHt8hYhYRcW8NTb4g: doesn't show hand 
*** SUMMARY ***
Total pot $0.60 | Rake $0 
Seat 1: pokjbbEcXXPlADXdSGHtZw (big blind) folded before Flop
Seat 2: k9nHZTHt8hYhYRcW8NTb4g collected ($0.60)
Seat 3: hOaWAImn5/MZDAWAPlYHCw folded before Flop (didn't bet)
Seat 4: xrf8tAXKQHG99HixCot1Iw folded before Flop (didn't bet)
Seat 5: iyZxqznXjv3vtvOJymkoLQ (button) folded before Flop (didn't bet)
Seat 6: mfrkWA3PTeYPkbO6hi98Aw (small blind) folded before Flop




PokerStars Game #59941971066:  Hold'em No Limit ($0.10/$0.25) - 2009/07/01 1:51:59 ET
Table 'wGizWOswEL6P5QrvVkno/g' 6-max Seat #3 is the button
Seat 1: Qbfkn+ucISvbd1Xh32zAGA ($33.60 in chips) 
Seat 2: mfrkWA3PTeYPkbO6hi98Aw ($28.40 in chips) 
Seat 3: i9LqF5rD3bvtbEE7HWgr3Q ($25 in chips) 
Seat 4: yF9xHMEAvA+7Gn+eDkuVIg ($2.15 in chips) 
Seat 5: w43JQj2oYPpKQVG4Yzlq1w ($25 in chips) 
Seat 6: BuAE7g7dRfuqGPmQDlGyGg ($18.75 in chips) 
yF9xHMEAvA+7Gn+eDkuVIg: posts small blind $0.10
w43JQj2oYPpKQVG4Yzlq1w: posts big blind $0.25
*** HOLE CARDS ***
BuAE7g7dRfuqGPmQDlGyGg: folds 
Qbfkn+ucISvbd1Xh32zAGA: folds 
mfrkWA3PTeYPkbO6hi98Aw: raises $0.75 to $1
i9LqF5rD3bvtbEE7HWgr3Q: raises $2.25 to $3.25
yF9xHMEAvA+7Gn+eDkuVIg: folds 
w43JQj2oYPpKQVG4Yzlq1w: folds 
mfrkWA3PTeYPkbO6hi98Aw: folds 
Uncalled bet ($2.25) returned to i9LqF5rD3bvtbEE7HWgr3Q
i9LqF5rD3bvtbEE7HWgr3Q collected $2.35 from pot
i9LqF5rD3bvtbEE7HWgr3Q: doesn't show hand 
*** SUMMARY ***
Total pot $2.35 | Rake $0 
Seat 1: Qbfkn+ucISvbd1Xh32zAGA folded before Flop (didn't bet)
Seat 2: mfrkWA3PTeYPkbO6hi98Aw folded before Flop
Seat 3: i9LqF5rD3bvtbEE7HWgr3Q (button) collected ($2.35)
Seat 4: yF9xHMEAvA+7Gn+eDkuVIg (small blind) folded before Flop
Seat 5: w43JQj2oYPpKQVG4Yzlq1w (big blind) folded before Flop
Seat 6: BuAE7g7dRfuqGPmQDlGyGg folded before Flop (didn't bet)




PokerStars Game #59941971340:  Hold'em No Limit ($0.10/$0.25) - 2009/07/01 1:51:59 ET
Table 'jdhJTJjFq2KTttwJcd+7nQ' 6-max Seat #1 is the button
Seat 1: LtASJ9OlkqGrrUKGQlpGAw ($26.15 in chips) 
Seat 3: vqWjZmdQu/Hxw96/IJTWdQ ($30.30 in chips) 
Seat 4: vx7FwRcelVSsvNYAdp/z0A ($4.85 in chips) 
Seat 5: BV+K0Phf5VBHr7aZPKqbUQ ($31.30 in chips) 
Seat 6: yb6rnd48JuBccThV68VHAQ ($15.75 in chips) 
vqWjZmdQu/Hxw96/IJTWdQ: posts small blind $0.10
vx7FwRcelVSsvNYAdp/z0A: posts big blind $0.25
*** HOLE CARDS ***
BV+K0Phf5VBHr7aZPKqbUQ: folds 
yb6rnd48JuBccThV68VHAQ: folds 
LtASJ9OlkqGrrUKGQlpGAw: folds 
vqWjZmdQu/Hxw96/IJTWdQ: folds 
Uncalled bet ($0.15) returned to vx7FwRcelVSsvNYAdp/z0A
vx7FwRcelVSsvNYAdp/z0A collected $0.20 from pot
vx7FwRcelVSsvNYAdp/z0A: doesn't show hand 
*** SUMMARY ***
Total pot $0.20 | Rake $0 
Seat 1: LtASJ9OlkqGrrUKGQlpGAw (button) folded before Flop (didn't bet)
Seat 3: vqWjZmdQu/Hxw96/IJTWdQ (small blind) folded before Flop
Seat 4: vx7FwRcelVSsvNYAdp/z0A (big blind) collected ($0.20)
Seat 5: BV+K0Phf5VBHr7aZPKqbUQ folded before Flop (didn't bet)
Seat 6: yb6rnd48JuBccThV68VHAQ folded before Flop (didn't bet)




PokerStars Game #59941971426:  Hold'em No Limit ($0.10/$0.25) - 2009/07/01 1:51:59 ET
Table 'aisAlB9GIV21BwfUW3+Nbg' 9-max Seat #1 is the button
Seat 1: SqibpGx+lf+brY0fJVvD0w ($24.50 in chips) 
Seat 2: zgi+EUykT/pZQpoUG6+oEg ($4.75 in chips) 
Seat 3: CvL9Ch1HYCVbTsfpNucitg ($4.55 in chips) 
Seat 4: sD+TKtt36XiiN6jqHiLwDA ($26.50 in chips) 
Seat 5: ghNKXUBl/H+t83JF079ZBA ($27.75 in chips) 
Seat 6: 9gmYYQesalMrUjaF7nKfrQ ($15.85 in chips) 
Seat 7: QUyZmk8wzvBAtbHg9JXClw ($15 in chips) 
Seat 8: VWUWpMLMj/Q1jRVpF7Aohw ($25.95 in chips) 
Seat 9: N0hGpTAEAj9k5msS6LPLAw ($20.60 in chips) 
zgi+EUykT/pZQpoUG6+oEg: posts small blind $0.10
CvL9Ch1HYCVbTsfpNucitg: posts big blind $0.25
QUyZmk8wzvBAtbHg9JXClw: posts big blind $0.25
*** HOLE CARDS ***
sD+TKtt36XiiN6jqHiLwDA: folds 
ghNKXUBl/H+t83JF079ZBA: folds 
9gmYYQesalMrUjaF7nKfrQ: folds 
QUyZmk8wzvBAtbHg9JXClw: checks 
VWUWpMLMj/Q1jRVpF7Aohw: folds 
N0hGpTAEAj9k5msS6LPLAw: folds 
SqibpGx+lf+brY0fJVvD0w: calls $0.25
zgi+EUykT/pZQpoUG6+oEg: folds 
CvL9Ch1HYCVbTsfpNucitg: checks 
*** FLOP *** [5h 2c Jd]
CvL9Ch1HYCVbTsfpNucitg: bets $0.75
QUyZmk8wzvBAtbHg9JXClw: folds 
SqibpGx+lf+brY0fJVvD0w: folds 
Uncalled bet ($0.75) returned to CvL9Ch1HYCVbTsfpNucitg
CvL9Ch1HYCVbTsfpNucitg collected $0.85 from pot
CvL9Ch1HYCVbTsfpNucitg: doesn't show hand 
*** SUMMARY ***
Total pot $0.85 | Rake $0 
Board [5h 2c Jd]
Seat 1: SqibpGx+lf+brY0fJVvD0w (button) folded on the Flop
Seat 2: zgi+EUykT/pZQpoUG6+oEg (small blind) folded before Flop
Seat 3: CvL9Ch1HYCVbTsfpNucitg (big blind) collected ($0.85)
Seat 4: sD+TKtt36XiiN6jqHiLwDA folded before Flop (didn't bet)
Seat 5: ghNKXUBl/H+t83JF079ZBA folded before Flop (didn't bet)
Seat 6: 9gmYYQesalMrUjaF7nKfrQ folded before Flop (didn't bet)
Seat 7: QUyZmk8wzvBAtbHg9JXClw folded on the Flop
Seat 8: VWUWpMLMj/Q1jRVpF7Aohw folded before Flop (didn't bet)
Seat 9: N0hGpTAEAj9k5msS6LPLAw folded before Flop (didn't bet)




PokerStars Game #59941971200:  Hold'em No Limit ($0.10/$0.25) - 2009/07/01 1:51:59 ET
Table 'a6FCGVBMPcT7J7BDN9q1zQ' 9-max Seat #3 is the button
Seat 1: bXpVeaSTPBFSPJmeXxO7nw ($4.65 in chips) 
Seat 2: M2QO2DxB5Wawg2h8HSpnYA ($10 in chips) 
Seat 3: tLcDklc2rBORNfixyRfVfw ($25 in chips) 
Seat 4: 8EbrQ/EvFWt2cr0GaU82gQ ($4.75 in chips) 
Seat 5: dtZ84flFEi4Q+SGrHMJRDQ ($25.55 in chips) 
Seat 6: dfNim92Z6XK1/h5SFW5vDg ($25 in chips) 
Seat 7: V0Yo5zRBVM8DYspLKafebg ($15.85 in chips) 
Seat 8: r6hsffOo1iKmaPYKwAZmFw ($64.35 in chips) 
Seat 9: wGigCmBR/9XWkPpvYos3aQ ($29.85 in chips) 
8EbrQ/EvFWt2cr0GaU82gQ: posts small blind $0.10
dtZ84flFEi4Q+SGrHMJRDQ: posts big blind $0.25
*** HOLE CARDS ***
dfNim92Z6XK1/h5SFW5vDg: folds 
V0Yo5zRBVM8DYspLKafebg: raises $0.25 to $0.50
r6hsffOo1iKmaPYKwAZmFw: folds 
wGigCmBR/9XWkPpvYos3aQ: calls $0.50
bXpVeaSTPBFSPJmeXxO7nw: folds 
M2QO2DxB5Wawg2h8HSpnYA: calls $0.50
tLcDklc2rBORNfixyRfVfw: calls $0.50
8EbrQ/EvFWt2cr0GaU82gQ: folds 
dtZ84flFEi4Q+SGrHMJRDQ: folds 
*** FLOP *** [3c 2h 2d]
V0Yo5zRBVM8DYspLKafebg: checks 
wGigCmBR/9XWkPpvYos3aQ: checks 
M2QO2DxB5Wawg2h8HSpnYA: bets $1
tLcDklc2rBORNfixyRfVfw: folds 
V0Yo5zRBVM8DYspLKafebg: folds 
wGigCmBR/9XWkPpvYos3aQ: folds 
Uncalled bet ($1) returned to M2QO2DxB5Wawg2h8HSpnYA
M2QO2DxB5Wawg2h8HSpnYA collected $2.25 from pot
M2QO2DxB5Wawg2h8HSpnYA: doesn't show hand 
*** SUMMARY ***
Total pot $2.35 | Rake $0.10 
Board [3c 2h 2d]
Seat 1: bXpVeaSTPBFSPJmeXxO7nw folded before Flop (didn't bet)
Seat 2: M2QO2DxB5Wawg2h8HSpnYA collected ($2.25)
Seat 3: tLcDklc2rBORNfixyRfVfw (button) folded on the Flop
Seat 4: 8EbrQ/EvFWt2cr0GaU82gQ (small blind) folded before Flop
Seat 5: dtZ84flFEi4Q+SGrHMJRDQ (big blind) folded before Flop
Seat 6: dfNim92Z6XK1/h5SFW5vDg folded before Flop (didn't bet)
Seat 7: V0Yo5zRBVM8DYspLKafebg folded on the Flop
Seat 8: r6hsffOo1iKmaPYKwAZmFw folded before Flop (didn't bet)
Seat 9: wGigCmBR/9XWkPpvYos3aQ folded on the Flop




PokerStars Game #59941971666:  Hold'em No Limit ($0.10/$0.25) - 2009/07/01 1:52:00 ET
Table 'wixGE3Zge1qBdnpWijIl/w' 9-max Seat #3 is the button
Seat 1: 4GJMmHGKzu+gVtalqRy7dA ($27.45 in chips) 
Seat 2: DnDcAdn9P0zGovMERigpFA ($77.25 in chips) 
Seat 3: Bb42QRQMhg5/Y0vHP8/2Xw ($25 in chips) 
Seat 4: X6+pSIPfovPcE87t+LmUKQ ($5.60 in chips) 
Seat 5: H5Se03ZqSX7tbULXur2MAg ($23.05 in chips) 
Seat 6: AP/rNvbsacTb4XtaAgKPiQ ($14.20 in chips) 
Seat 7: mMd8CDS/but3UC+Zp7Up2w ($21.70 in chips) 
Seat 8: ShCS62CJp4MKfKLKvGKQbA ($14.55 in chips) 
Seat 9: r6hsffOo1iKmaPYKwAZmFw ($28.80 in chips) 
X6+pSIPfovPcE87t+LmUKQ: posts small blind $0.10
H5Se03ZqSX7tbULXur2MAg: posts big blind $0.25
*** HOLE CARDS ***
AP/rNvbsacTb4XtaAgKPiQ: calls $0.25
mMd8CDS/but3UC+Zp7Up2w: folds 
ShCS62CJp4MKfKLKvGKQbA: folds 
r6hsffOo1iKmaPYKwAZmFw: folds 
4GJMmHGKzu+gVtalqRy7dA: calls $0.25
DnDcAdn9P0zGovMERigpFA: folds 
Bb42QRQMhg5/Y0vHP8/2Xw: folds 
X6+pSIPfovPcE87t+LmUKQ: calls $0.15
H5Se03ZqSX7tbULXur2MAg: checks 
*** FLOP *** [Tc 4s 5c]
X6+pSIPfovPcE87t+LmUKQ: checks 
H5Se03ZqSX7tbULXur2MAg: checks 
AP/rNvbsacTb4XtaAgKPiQ: bets $0.75
4GJMmHGKzu+gVtalqRy7dA: folds 
X6+pSIPfovPcE87t+LmUKQ: calls $0.75
H5Se03ZqSX7tbULXur2MAg: folds 
*** TURN *** [Tc 4s 5c] [Kd]
X6+pSIPfovPcE87t+LmUKQ: checks 
AP/rNvbsacTb4XtaAgKPiQ: checks 
*** RIVER *** [Tc 4s 5c Kd] [6h]
X6+pSIPfovPcE87t+LmUKQ: bets $1.25
AP/rNvbsacTb4XtaAgKPiQ: folds 
Uncalled bet ($1.25) returned to X6+pSIPfovPcE87t+LmUKQ
X6+pSIPfovPcE87t+LmUKQ collected $2.40 from pot
*** SUMMARY ***
Total pot $2.50 | Rake $0.10 
Board [Tc 4s 5c Kd 6h]
Seat 1: 4GJMmHGKzu+gVtalqRy7dA folded on the Flop
Seat 2: DnDcAdn9P0zGovMERigpFA folded before Flop (didn't bet)
Seat 3: Bb42QRQMhg5/Y0vHP8/2Xw (button) folded before Flop (didn't bet)
Seat 4: X6+pSIPfovPcE87t+LmUKQ (small blind) collected ($2.40)
Seat 5: H5Se03ZqSX7tbULXur2MAg (big blind) folded on the Flop
Seat 6: AP/rNvbsacTb4XtaAgKPiQ folded on the River
Seat 7: mMd8CDS/but3UC+Zp7Up2w folded before Flop (didn't bet)
Seat 8: ShCS62CJp4MKfKLKvGKQbA folded before Flop (didn't bet)
Seat 9: r6hsffOo1iKmaPYKwAZmFw folded before Flop (didn't bet)




PokerStars Game #59941971522:  Hold'em No Limit ($0.10/$0.25) - 2009/07/01 1:52:00 ET
Table 'LXz5SsUCyWcm+4JDJh466A' 9-max Seat #5 is the button
Seat 1: MG90wfSJZnOejs/KD3vlQQ ($25 in chips) 
Seat 2: H5Se03ZqSX7tbULXur2MAg ($22.60 in chips) 
Seat 3: dfNim92Z6XK1/h5SFW5vDg ($25 in chips) 
Seat 4: K0b5wNInj6hUGRr6yzKFtw ($52.60 in chips) 
Seat 5: CGZe30OcuMyA3kN5MnfQcQ ($15.60 in chips) 
Seat 6: 6RiVTYll/5D8zICp0MRpKw ($24.50 in chips) 
Seat 7: J2a/QHAWUgo6beDRoEyg2g ($10.40 in chips) 
Seat 8: zOHElTcFiTsexeDCkAPYkQ ($30.95 in chips) 
Seat 9: dtZ84flFEi4Q+SGrHMJRDQ ($25 in chips) 
6RiVTYll/5D8zICp0MRpKw: posts small blind $0.10
J2a/QHAWUgo6beDRoEyg2g: posts big blind $0.25
*** HOLE CARDS ***
zOHElTcFiTsexeDCkAPYkQ: raises $0.75 to $1
dtZ84flFEi4Q+SGrHMJRDQ: folds 
MG90wfSJZnOejs/KD3vlQQ: folds 
H5Se03ZqSX7tbULXur2MAg: folds 
dfNim92Z6XK1/h5SFW5vDg: folds 
K0b5wNInj6hUGRr6yzKFtw: folds 
CGZe30OcuMyA3kN5MnfQcQ has timed out
CGZe30OcuMyA3kN5MnfQcQ: folds 
CGZe30OcuMyA3kN5MnfQcQ is sitting out
6RiVTYll/5D8zICp0MRpKw: folds 
J2a/QHAWUgo6beDRoEyg2g: calls $0.75
*** FLOP *** [Ah 3c 7c]
CGZe30OcuMyA3kN5MnfQcQ has returned
J2a/QHAWUgo6beDRoEyg2g: checks 
zOHElTcFiTsexeDCkAPYkQ: checks 
*** TURN *** [Ah 3c 7c] [7h]
J2a/QHAWUgo6beDRoEyg2g: checks 
zOHElTcFiTsexeDCkAPYkQ: checks 
*** RIVER *** [Ah 3c 7c 7h] [7s]
J2a/QHAWUgo6beDRoEyg2g: checks 
zOHElTcFiTsexeDCkAPYkQ: checks 
*** SHOW DOWN ***
J2a/QHAWUgo6beDRoEyg2g: shows [Ts Kh] (three of a kind, Sevens)
zOHElTcFiTsexeDCkAPYkQ: mucks hand 
J2a/QHAWUgo6beDRoEyg2g collected $2 from pot
*** SUMMARY ***
Total pot $2.10 | Rake $0.10 
Board [Ah 3c 7c 7h 7s]
Seat 1: MG90wfSJZnOejs/KD3vlQQ folded before Flop (didn't bet)
Seat 2: H5Se03ZqSX7tbULXur2MAg folded before Flop (didn't bet)
Seat 3: dfNim92Z6XK1/h5SFW5vDg folded before Flop (didn't bet)
Seat 4: K0b5wNInj6hUGRr6yzKFtw folded before Flop (didn't bet)
Seat 5: CGZe30OcuMyA3kN5MnfQcQ (button) folded before Flop (didn't bet)
Seat 6: 6RiVTYll/5D8zICp0MRpKw (small blind) folded before Flop
Seat 7: J2a/QHAWUgo6beDRoEyg2g (big blind) showed [Ts Kh] and won ($2) with three of a kind, Sevens
Seat 8: zOHElTcFiTsexeDCkAPYkQ mucked
Seat 9: dtZ84flFEi4Q+SGrHMJRDQ folded before Flop (didn't bet)




PokerStars Game #59941971752:  Hold'em No Limit ($0.10/$0.25) - 2009/07/01 1:52:00 ET
Table 'qInMnOOn7vKcj4bU7zju7g' 9-max Seat #1 is the button
Seat 1: CT7Xj/V/O5rBlhtt+RZeFQ ($38.05 in chips) 
Seat 2: HgIyqrvSG8TRRZl5mlzfHA ($67.50 in chips) 
Seat 3: zDrucyjVn5aeekNEc3cJrA ($25.80 in chips) 
Seat 4: ScCuCTbi71/EWsLKZXaZeg ($14.80 in chips) 
Seat 5: KlccfkOygm1GJZoSZYEgBw ($13.15 in chips) 
Seat 6: 4awUyiDYTgylQKXZ9faBVA ($25 in chips) 
Seat 7: st9jtdNbm1W5GfBwRaCVqQ ($24.75 in chips) 
Seat 8: Mh2r9hTeTEDnh19sRZtW3g ($11.35 in chips) 
Seat 9: sbArFaUiGjfmf5dg1O4ffg ($3.35 in chips) 
HgIyqrvSG8TRRZl5mlzfHA: posts small blind $0.10
zDrucyjVn5aeekNEc3cJrA: posts big blind $0.25
*** HOLE CARDS ***
ScCuCTbi71/EWsLKZXaZeg: calls $0.25
KlccfkOygm1GJZoSZYEgBw: folds 
4awUyiDYTgylQKXZ9faBVA: folds 
st9jtdNbm1W5GfBwRaCVqQ: folds 
Mh2r9hTeTEDnh19sRZtW3g: folds 
sbArFaUiGjfmf5dg1O4ffg: calls $0.25
CT7Xj/V/O5rBlhtt+RZeFQ: folds 
HgIyqrvSG8TRRZl5mlzfHA: raises $0.75 to $1
zDrucyjVn5aeekNEc3cJrA: folds 
ScCuCTbi71/EWsLKZXaZeg: calls $0.75
sbArFaUiGjfmf5dg1O4ffg: calls $0.75
*** FLOP *** [Kh 3s Td]
HgIyqrvSG8TRRZl5mlzfHA: checks 
ScCuCTbi71/EWsLKZXaZeg: checks 
sbArFaUiGjfmf5dg1O4ffg: bets $2.35 and is all-in
HgIyqrvSG8TRRZl5mlzfHA: raises $2.35 to $4.70
ScCuCTbi71/EWsLKZXaZeg: folds 
Uncalled bet ($2.35) returned to HgIyqrvSG8TRRZl5mlzfHA
*** TURN *** [Kh 3s Td] [6d]
*** RIVER *** [Kh 3s Td 6d] [3c]
*** SHOW DOWN ***
HgIyqrvSG8TRRZl5mlzfHA: shows [Qd Kd] (two pair, Kings and Threes)
sbArFaUiGjfmf5dg1O4ffg: mucks hand 
HgIyqrvSG8TRRZl5mlzfHA collected $7.60 from pot
sbArFaUiGjfmf5dg1O4ffg leaves the table
*** SUMMARY ***
Total pot $7.95 | Rake $0.35 
Board [Kh 3s Td 6d 3c]
Seat 1: CT7Xj/V/O5rBlhtt+RZeFQ (button) folded before Flop (didn't bet)
Seat 2: HgIyqrvSG8TRRZl5mlzfHA (small blind) showed [Qd Kd] and won ($7.60) with two pair, Kings and Threes
Seat 3: zDrucyjVn5aeekNEc3cJrA (big blind) folded before Flop
Seat 4: ScCuCTbi71/EWsLKZXaZeg folded on the Flop
Seat 5: KlccfkOygm1GJZoSZYEgBw folded before Flop (didn't bet)
Seat 6: 4awUyiDYTgylQKXZ9faBVA folded before Flop (didn't bet)
Seat 7: st9jtdNbm1W5GfBwRaCVqQ folded before Flop (didn't bet)
Seat 8: Mh2r9hTeTEDnh19sRZtW3g folded before Flop (didn't bet)
Seat 9: sbArFaUiGjfmf5dg1O4ffg mucked




PokerStars Game #59941971602:  Hold'em No Limit ($0.10/$0.25) - 2009/07/01 1:52:00 ET
Table '6aL2C8IFwHHr6SG6RgXaow' 9-max Seat #6 is the button
Seat 1: FcL757vvzKRPFZ6h7YsPHA ($10.30 in chips) 
Seat 2: UmzixCpC0bAc1lDEjgB3NQ ($13.60 in chips) 
Seat 3: clJsV3v77RS07bDKY+705w ($5 in chips) 
Seat 4: BT6Oal0iO4P6kDuT7HFQDw ($19.15 in chips) 
Seat 5: wre31HfyzQGpIvID1istxw ($23.40 in chips) 
Seat 6: gehe91e0IyVT0QU/XBkEyg ($26.15 in chips) 
Seat 7: E0iYnEVO2ho7dH3QcCjw7g ($19.50 in chips) 
Seat 8: rQhYIYXSyH/IivYM1dlV5A ($21.95 in chips) 
Seat 9: CgIo2ItZqi4o3ayVG6HanQ ($23.50 in chips) 
E0iYnEVO2ho7dH3QcCjw7g: posts small blind $0.10
rQhYIYXSyH/IivYM1dlV5A: posts big blind $0.25
*** HOLE CARDS ***
CgIo2ItZqi4o3ayVG6HanQ: folds 
FcL757vvzKRPFZ6h7YsPHA: folds 
UmzixCpC0bAc1lDEjgB3NQ: calls $0.25
clJsV3v77RS07bDKY+705w: folds 
BT6Oal0iO4P6kDuT7HFQDw: folds 
wre31HfyzQGpIvID1istxw: folds 
gehe91e0IyVT0QU/XBkEyg: folds 
E0iYnEVO2ho7dH3QcCjw7g: calls $0.15
rQhYIYXSyH/IivYM1dlV5A: checks 
*** FLOP *** [9d Th 2s]
E0iYnEVO2ho7dH3QcCjw7g: checks 
rQhYIYXSyH/IivYM1dlV5A: bets $0.75
UmzixCpC0bAc1lDEjgB3NQ: calls $0.75
E0iYnEVO2ho7dH3QcCjw7g: folds 
*** TURN *** [9d Th 2s] [2h]
rQhYIYXSyH/IivYM1dlV5A: checks 
UmzixCpC0bAc1lDEjgB3NQ: bets $1
rQhYIYXSyH/IivYM1dlV5A: calls $1
*** RIVER *** [9d Th 2s 2h] [7h]
rQhYIYXSyH/IivYM1dlV5A: checks 
UmzixCpC0bAc1lDEjgB3NQ: bets $2.50
rQhYIYXSyH/IivYM1dlV5A: calls $2.50
*** SHOW DOWN ***
UmzixCpC0bAc1lDEjgB3NQ: shows [Qc 9h] (two pair, Nines and Deuces)
rQhYIYXSyH/IivYM1dlV5A: shows [As Td] (two pair, Tens and Deuces)
rQhYIYXSyH/IivYM1dlV5A collected $8.80 from pot
*** SUMMARY ***
Total pot $9.25 | Rake $0.45 
Board [9d Th 2s 2h 7h]
Seat 1: FcL757vvzKRPFZ6h7YsPHA folded before Flop (didn't bet)
Seat 2: UmzixCpC0bAc1lDEjgB3NQ showed [Qc 9h] and lost with two pair, Nines and Deuces
Seat 3: clJsV3v77RS07bDKY+705w folded before Flop (didn't bet)
Seat 4: BT6Oal0iO4P6kDuT7HFQDw folded before Flop (didn't bet)
Seat 5: wre31HfyzQGpIvID1istxw folded before Flop (didn't bet)
Seat 6: gehe91e0IyVT0QU/XBkEyg (button) folded before Flop (didn't bet)
Seat 7: E0iYnEVO2ho7dH3QcCjw7g (small blind) folded on the Flop
Seat 8: rQhYIYXSyH/IivYM1dlV5A (big blind) showed [As Td] and won ($8.80) with two pair, Tens and Deuces
Seat 9: CgIo2ItZqi4o3ayVG6HanQ folded before Flop (didn't bet)




PokerStars Game #59941971988:  Hold'em No Limit ($0.10/$0.25) - 2009/07/01 1:52:00 ET
Table '/AhP8uWRzEEhOATYIdmn0A' 9-max Seat #5 is the button
Seat 1: +sbyWwIcFp9kP0bDtMegfQ ($37.45 in chips) 
Seat 3: jx6dnobNHstDG0tabsbKHQ ($3.20 in chips) 
Seat 4: +qc/EYCgLC65SpGvr35eNg ($25 in chips) 
Seat 5: iZ1f67Ok/207yzIQOu1Kdg ($4.65 in chips) 
Seat 6: 8EbrQ/EvFWt2cr0GaU82gQ ($4.75 in chips) 
Seat 7: cZ99hugmLBj9KhTlc8nCSw ($25 in chips) 
Seat 8: K86cg2ifCMFAlmzsfTDjig ($42.95 in chips) 
Seat 9: OfGfQFPcghysTDljS9GQSQ ($10.60 in chips) 
8EbrQ/EvFWt2cr0GaU82gQ: posts small blind $0.10
cZ99hugmLBj9KhTlc8nCSw: posts big blind $0.25
DdPXdieucQ+n99u1n3A+rQ: sits out 
+qc/EYCgLC65SpGvr35eNg: posts big blind $0.25
*** HOLE CARDS ***
K86cg2ifCMFAlmzsfTDjig: calls $0.25
OfGfQFPcghysTDljS9GQSQ: folds 
+sbyWwIcFp9kP0bDtMegfQ: folds 
jx6dnobNHstDG0tabsbKHQ: raises $2.95 to $3.20 and is all-in
+qc/EYCgLC65SpGvr35eNg: folds 
iZ1f67Ok/207yzIQOu1Kdg: folds 
8EbrQ/EvFWt2cr0GaU82gQ: folds 
cZ99hugmLBj9KhTlc8nCSw: folds 
K86cg2ifCMFAlmzsfTDjig: calls $2.95
*** FLOP *** [5d 2d 3c]
*** TURN *** [5d 2d 3c] [Js]
*** RIVER *** [5d 2d 3c Js] [Ts]
*** SHOW DOWN ***
K86cg2ifCMFAlmzsfTDjig: shows [5h 4h] (a pair of Fives)
jx6dnobNHstDG0tabsbKHQ: shows [Td Qh] (a pair of Tens)
jx6dnobNHstDG0tabsbKHQ collected $6.65 from pot
*** SUMMARY ***
Total pot $7 | Rake $0.35 
Board [5d 2d 3c Js Ts]
Seat 1: +sbyWwIcFp9kP0bDtMegfQ folded before Flop (didn't bet)
Seat 3: jx6dnobNHstDG0tabsbKHQ showed [Td Qh] and won ($6.65) with a pair of Tens
Seat 4: +qc/EYCgLC65SpGvr35eNg folded before Flop
Seat 5: iZ1f67Ok/207yzIQOu1Kdg (button) folded before Flop (didn't bet)
Seat 6: 8EbrQ/EvFWt2cr0GaU82gQ (small blind) folded before Flop
Seat 7: cZ99hugmLBj9KhTlc8nCSw (big blind) folded before Flop
Seat 8: K86cg2ifCMFAlmzsfTDjig showed [5h 4h] and lost with a pair of Fives
Seat 9: OfGfQFPcghysTDljS9GQSQ folded before Flop (didn't bet)




PokerStars Game #59941971674:  Hold'em No Limit ($0.10/$0.25) - 2009/07/01 1:52:00 ET
Table 'IuqVbFI+pwnJjvwBCGSGAw' 6-max Seat #3 is the button
Seat 1: LyDHtw3/yniNHW+DvLXbog ($27.75 in chips) 
Seat 2: w43JQj2oYPpKQVG4Yzlq1w ($25 in chips) 
Seat 3: QiL+lEgEWwy21jk/ltaRLg ($24.35 in chips) 
Seat 4: DE9hRlt14g+JdsRQ4wT7hg ($25 in chips) 
Seat 6: xC0kaiDYM6YTlgODL83O5A ($12.80 in chips) 
DE9hRlt14g+JdsRQ4wT7hg: posts small blind $0.10
xC0kaiDYM6YTlgODL83O5A: posts big blind $0.25
*** HOLE CARDS ***
LyDHtw3/yniNHW+DvLXbog: folds 
w43JQj2oYPpKQVG4Yzlq1w: folds 
QiL+lEgEWwy21jk/ltaRLg: raises $0.50 to $0.75
DE9hRlt14g+JdsRQ4wT7hg: folds 
xC0kaiDYM6YTlgODL83O5A: folds 
Uncalled bet ($0.50) returned to QiL+lEgEWwy21jk/ltaRLg
QiL+lEgEWwy21jk/ltaRLg collected $0.60 from pot
*** SUMMARY ***
Total pot $0.60 | Rake $0 
Seat 1: LyDHtw3/yniNHW+DvLXbog folded before Flop (didn't bet)
Seat 2: w43JQj2oYPpKQVG4Yzlq1w folded before Flop (didn't bet)
Seat 3: QiL+lEgEWwy21jk/ltaRLg (button) collected ($0.60)
Seat 4: DE9hRlt14g+JdsRQ4wT7hg (small blind) folded before Flop
Seat 6: xC0kaiDYM6YTlgODL83O5A (big blind) folded before Flop




PokerStars Game #59941971708:  Hold'em No Limit ($0.10/$0.25) - 2009/07/01 1:52:00 ET
Table '9o8Yb3JpUqurD4pNVmOikQ' 6-max Seat #6 is the button
Seat 1: SFmT9ZsVopnukjvAzrxTRg ($25.40 in chips) 
Seat 2: /gJNBeCkWL4o85/jvlZ4BA ($26.50 in chips) 
Seat 3: JgRqo1/2phbf7pab7N3BIQ ($21.75 in chips) 
Seat 5: QqiZLFrN8iOUT/GHw7ztOA ($23.95 in chips) 
Seat 6: LyDHtw3/yniNHW+DvLXbog ($28.80 in chips) 
SFmT9ZsVopnukjvAzrxTRg: posts small blind $0.10
/gJNBeCkWL4o85/jvlZ4BA: posts big blind $0.25
AyreonChen: sits out 
*** HOLE CARDS ***
JgRqo1/2phbf7pab7N3BIQ: calls $0.25
QqiZLFrN8iOUT/GHw7ztOA: folds 
LyDHtw3/yniNHW+DvLXbog: folds 
SFmT9ZsVopnukjvAzrxTRg: folds 
/gJNBeCkWL4o85/jvlZ4BA: checks 
*** FLOP *** [Ks Th Ac]
/gJNBeCkWL4o85/jvlZ4BA: bets $1.25
JgRqo1/2phbf7pab7N3BIQ: calls $1.25
*** TURN *** [Ks Th Ac] [2s]
/gJNBeCkWL4o85/jvlZ4BA: bets $2
JgRqo1/2phbf7pab7N3BIQ: calls $2
*** RIVER *** [Ks Th Ac 2s] [Jc]
/gJNBeCkWL4o85/jvlZ4BA: checks 
JgRqo1/2phbf7pab7N3BIQ: checks 
*** SHOW DOWN ***
/gJNBeCkWL4o85/jvlZ4BA: shows [2d Ad] (two pair, Aces and Deuces)
JgRqo1/2phbf7pab7N3BIQ: mucks hand 
/gJNBeCkWL4o85/jvlZ4BA collected $6.80 from pot
*** SUMMARY ***
Total pot $7.10 | Rake $0.30 
Board [Ks Th Ac 2s Jc]
Seat 1: SFmT9ZsVopnukjvAzrxTRg (small blind) folded before Flop
Seat 2: /gJNBeCkWL4o85/jvlZ4BA (big blind) showed [2d Ad] and won ($6.80) with two pair, Aces and Deuces
Seat 3: JgRqo1/2phbf7pab7N3BIQ mucked
Seat 5: QqiZLFrN8iOUT/GHw7ztOA folded before Flop (didn't bet)
Seat 6: LyDHtw3/yniNHW+DvLXbog (button) folded before Flop (didn't bet)




PokerStars Game #59941971632:  Hold'em No Limit ($0.10/$0.25) - 2009/07/01 1:52:00 ET
Table 'O5NgMYt6EWbLBozZb3kseg' 6-max Seat #3 is the button
Seat 1: uS0JK3noJsnWbcX2Jtcj8A ($24.75 in chips) 
Seat 2: ZZm/rg8aThjE+A2LiItuzA ($11.70 in chips) 
Seat 3: 0bf6ZOD3FadOOzjtjXlcRQ ($9.95 in chips) 
Seat 4: ItRgvLhXTZHvtZowz+dbIw ($12.65 in chips) 
Seat 5: u3Ol7kv1LmvszuHNm9rc6w ($25.45 in chips) 
Seat 6: 3m6VfX7io8SA31qh1zCkgQ ($22.10 in chips) 
ItRgvLhXTZHvtZowz+dbIw: posts small blind $0.10
u3Ol7kv1LmvszuHNm9rc6w: posts big blind $0.25
*** HOLE CARDS ***
3m6VfX7io8SA31qh1zCkgQ: folds 
uS0JK3noJsnWbcX2Jtcj8A: folds 
ZZm/rg8aThjE+A2LiItuzA: folds 
0bf6ZOD3FadOOzjtjXlcRQ: raises $0.75 to $1
ItRgvLhXTZHvtZowz+dbIw: folds 
u3Ol7kv1LmvszuHNm9rc6w: folds 
Uncalled bet ($0.75) returned to 0bf6ZOD3FadOOzjtjXlcRQ
0bf6ZOD3FadOOzjtjXlcRQ collected $0.60 from pot
0bf6ZOD3FadOOzjtjXlcRQ: doesn't show hand 
*** SUMMARY ***
Total pot $0.60 | Rake $0 
Seat 1: uS0JK3noJsnWbcX2Jtcj8A folded before Flop (didn't bet)
Seat 2: ZZm/rg8aThjE+A2LiItuzA folded before Flop (didn't bet)
Seat 3: 0bf6ZOD3FadOOzjtjXlcRQ (button) collected ($0.60)
Seat 4: ItRgvLhXTZHvtZowz+dbIw (small blind) folded before Flop
Seat 5: u3Ol7kv1LmvszuHNm9rc6w (big blind) folded before Flop
Seat 6: 3m6VfX7io8SA31qh1zCkgQ folded before Flop (didn't bet)




PokerStars Game #59941971832:  Hold'em No Limit ($0.10/$0.25) - 2009/07/01 1:52:00 ET
Table 'BpNkESDX1ip9c0K1hb5h7A' 6-max Seat #1 is the button
Seat 1: 5YZdVjBPZVEdubN4xEMPEg ($11.35 in chips) 
Seat 2: 9U3ZKjCsarN0DjR6mSE8Ug ($19.35 in chips) 
Seat 3: fZQg9veL7Dd/Z04ZTjC+wQ ($37.15 in chips) 
Seat 4: kG34n23qFQA3nzdOJTQ1dA ($26.50 in chips) 
Seat 5: OMGl+YMGogf2JWIRfT2/Yg ($7.15 in chips) 
Seat 6: 8EEqTTh7T1q48sYDqbI2Xg ($21.80 in chips) 
9U3ZKjCsarN0DjR6mSE8Ug: posts small blind $0.10
fZQg9veL7Dd/Z04ZTjC+wQ: posts big blind $0.25
*** HOLE CARDS ***
kG34n23qFQA3nzdOJTQ1dA: folds 
OMGl+YMGogf2JWIRfT2/Yg: raises $0.25 to $0.50
8EEqTTh7T1q48sYDqbI2Xg: folds 
5YZdVjBPZVEdubN4xEMPEg: folds 
9U3ZKjCsarN0DjR6mSE8Ug: calls $0.40
fZQg9veL7Dd/Z04ZTjC+wQ: calls $0.25
*** FLOP *** [5h Kd 6s]
5YZdVjBPZVEdubN4xEMPEg is sitting out
9U3ZKjCsarN0DjR6mSE8Ug: bets $0.75
fZQg9veL7Dd/Z04ZTjC+wQ: calls $0.75
OMGl+YMGogf2JWIRfT2/Yg: calls $0.75
*** TURN *** [5h Kd 6s] [7s]
9U3ZKjCsarN0DjR6mSE8Ug: checks 
fZQg9veL7Dd/Z04ZTjC+wQ: bets $3.50
OMGl+YMGogf2JWIRfT2/Yg: calls $3.50
9U3ZKjCsarN0DjR6mSE8Ug: raises $5.50 to $9
fZQg9veL7Dd/Z04ZTjC+wQ: folds 
OMGl+YMGogf2JWIRfT2/Yg: calls $2.40 and is all-in
Uncalled bet ($3.10) returned to 9U3ZKjCsarN0DjR6mSE8Ug
*** RIVER *** [5h Kd 6s 7s] [9d]
*** SHOW DOWN ***
9U3ZKjCsarN0DjR6mSE8Ug: shows [6c 6h] (three of a kind, Sixes)
OMGl+YMGogf2JWIRfT2/Yg: shows [Ts Ks] (a pair of Kings)
9U3ZKjCsarN0DjR6mSE8Ug collected $18.15 from pot
*** SUMMARY ***
Total pot $19.05 | Rake $0.90 
Board [5h Kd 6s 7s 9d]
Seat 1: 5YZdVjBPZVEdubN4xEMPEg (button) folded before Flop (didn't bet)
Seat 2: 9U3ZKjCsarN0DjR6mSE8Ug (small blind) showed [6c 6h] and won ($18.15) with three of a kind, Sixes
Seat 3: fZQg9veL7Dd/Z04ZTjC+wQ (big blind) folded on the Turn
Seat 4: kG34n23qFQA3nzdOJTQ1dA folded before Flop (didn't bet)
Seat 5: OMGl+YMGogf2JWIRfT2/Yg showed [Ts Ks] and lost with a pair of Kings
Seat 6: 8EEqTTh7T1q48sYDqbI2Xg folded before Flop (didn't bet)




PokerStars Game #59941972006:  Hold'em No Limit ($0.10/$0.25) - 2009/07/01 1:52:00 ET
Table 'Dun24l/X8kjpUHWBhkVOFw' 6-max Seat #3 is the button
Seat 1: u3Ol7kv1LmvszuHNm9rc6w ($21.80 in chips) 
Seat 2: 6hUmfDYq+83kvxWoTBQmfw ($26.40 in chips) 
Seat 3: FzAsD5THdVHZrHrSzc4boA ($25.60 in chips) 
Seat 4: aogAb4Eienxztk8p2v9VVw ($24.75 in chips) 
Seat 5: KYBwVA7jgmSrbIEbEGElVg ($28.10 in chips) 
Seat 6: xrf8tAXKQHG99HixCot1Iw ($25 in chips) 
aogAb4Eienxztk8p2v9VVw: posts small blind $0.10
KYBwVA7jgmSrbIEbEGElVg: posts big blind $0.25
*** HOLE CARDS ***
xrf8tAXKQHG99HixCot1Iw: folds 
u3Ol7kv1LmvszuHNm9rc6w: raises $0.50 to $0.75
6hUmfDYq+83kvxWoTBQmfw: calls $0.75
FzAsD5THdVHZrHrSzc4boA: calls $0.75
aogAb4Eienxztk8p2v9VVw: folds 
KYBwVA7jgmSrbIEbEGElVg: calls $0.50
*** FLOP *** [8c Kc 2c]
KYBwVA7jgmSrbIEbEGElVg: bets $2
u3Ol7kv1LmvszuHNm9rc6w: folds 
6hUmfDYq+83kvxWoTBQmfw: calls $2
FzAsD5THdVHZrHrSzc4boA: calls $2
*** TURN *** [8c Kc 2c] [4s]
KYBwVA7jgmSrbIEbEGElVg: bets $2
6hUmfDYq+83kvxWoTBQmfw: calls $2
FzAsD5THdVHZrHrSzc4boA: calls $2
*** RIVER *** [8c Kc 2c 4s] [8h]
KYBwVA7jgmSrbIEbEGElVg: bets $3
6hUmfDYq+83kvxWoTBQmfw: calls $3
FzAsD5THdVHZrHrSzc4boA: raises $6 to $9
KYBwVA7jgmSrbIEbEGElVg: folds 
6hUmfDYq+83kvxWoTBQmfw: calls $6
*** SHOW DOWN ***
FzAsD5THdVHZrHrSzc4boA: shows [Qc Ac] (a flush, Ace high)
6hUmfDYq+83kvxWoTBQmfw: mucks hand 
FzAsD5THdVHZrHrSzc4boA collected $34.35 from pot
*** SUMMARY ***
Total pot $36.10 | Rake $1.75 
Board [8c Kc 2c 4s 8h]
Seat 1: u3Ol7kv1LmvszuHNm9rc6w folded on the Flop
Seat 2: 6hUmfDYq+83kvxWoTBQmfw mucked
Seat 3: FzAsD5THdVHZrHrSzc4boA (button) showed [Qc Ac] and won ($34.35) with a flush, Ace high
Seat 4: aogAb4Eienxztk8p2v9VVw (small blind) folded before Flop
Seat 5: KYBwVA7jgmSrbIEbEGElVg (big blind) folded on the River
Seat 6: xrf8tAXKQHG99HixCot1Iw folded before Flop (didn't bet)




PokerStars Game #59941971834:  Hold'em No Limit ($0.10/$0.25) - 2009/07/01 1:52:00 ET
Table 'v+LTGPWbrLum+Ggd4ef6lg' 9-max Seat #8 is the button
Seat 2: clJsV3v77RS07bDKY+705w ($5 in chips) 
Seat 3: 7ovWM9c1nQLTFritEGRG/A ($3.10 in chips) 
Seat 5: +8OkYWUhGfkDbAtQl/ovYQ ($23.15 in chips) 
Seat 7: kUxTO3D2eQcx4oJIpJAK4Q ($8.25 in chips) 
Seat 8: +sbyWwIcFp9kP0bDtMegfQ ($37.20 in chips) 
Seat 9: cZ99hugmLBj9KhTlc8nCSw ($27.70 in chips) 
cZ99hugmLBj9KhTlc8nCSw: posts small blind $0.10
clJsV3v77RS07bDKY+705w: posts big blind $0.25
yqkowiRWZ6NvRN9UUkYIlA: sits out 
*** HOLE CARDS ***
7ovWM9c1nQLTFritEGRG/A: folds 
+8OkYWUhGfkDbAtQl/ovYQ: folds 
kUxTO3D2eQcx4oJIpJAK4Q: folds 
+sbyWwIcFp9kP0bDtMegfQ: folds 
cZ99hugmLBj9KhTlc8nCSw: folds 
Uncalled bet ($0.15) returned to clJsV3v77RS07bDKY+705w
clJsV3v77RS07bDKY+705w collected $0.20 from pot
clJsV3v77RS07bDKY+705w: doesn't show hand 
*** SUMMARY ***
Total pot $0.20 | Rake $0 
Seat 2: clJsV3v77RS07bDKY+705w (big blind) collected ($0.20)
Seat 3: 7ovWM9c1nQLTFritEGRG/A folded before Flop (didn't bet)
Seat 5: +8OkYWUhGfkDbAtQl/ovYQ folded before Flop (didn't bet)
Seat 7: kUxTO3D2eQcx4oJIpJAK4Q folded before Flop (didn't bet)
Seat 8: +sbyWwIcFp9kP0bDtMegfQ (button) folded before Flop (didn't bet)
Seat 9: cZ99hugmLBj9KhTlc8nCSw (small blind) folded before Flop




PokerStars Game #59941971816:  Hold'em No Limit ($0.10/$0.25) - 2009/07/01 1:52:00 ET
Table '0w9m+UkNlGMNoPyQqzWk6A' 9-max Seat #8 is the button
Seat 1: 18G4P1XstjNvItdGUITxgw ($25 in chips) 
Seat 3: VWwtMkIjXloiX/RKh7RGWQ ($10.05 in chips) 
Seat 5: HPEB+AtKw1+C/cxU0o1ciw ($46.55 in chips) 
Seat 6: CgIo2ItZqi4o3ayVG6HanQ ($26.95 in chips) 
Seat 7: 57qrNGHDvf6GhB8zVLsAtQ ($4.10 in chips) 
Seat 8: cZ99hugmLBj9KhTlc8nCSw ($25 in chips) 
Seat 9: KqS/lY/fNB9qUxokm9QfeA ($13.60 in chips) 
KqS/lY/fNB9qUxokm9QfeA: posts small blind $0.10
18G4P1XstjNvItdGUITxgw: posts big blind $0.25
M1nKET7WOTLbVPuAbJa3EA: sits out 
z5GxcHlYz/GSz6W2uFiTtg: sits out 
*** HOLE CARDS ***
VWwtMkIjXloiX/RKh7RGWQ: folds 
HPEB+AtKw1+C/cxU0o1ciw: calls $0.25
CgIo2ItZqi4o3ayVG6HanQ: folds 
57qrNGHDvf6GhB8zVLsAtQ: folds 
cZ99hugmLBj9KhTlc8nCSw: folds 
KqS/lY/fNB9qUxokm9QfeA: raises $0.50 to $0.75
18G4P1XstjNvItdGUITxgw: folds 
HPEB+AtKw1+C/cxU0o1ciw: folds 
Uncalled bet ($0.50) returned to KqS/lY/fNB9qUxokm9QfeA
KqS/lY/fNB9qUxokm9QfeA collected $0.75 from pot
KqS/lY/fNB9qUxokm9QfeA: shows [Ac Ad] (a pair of Aces)
*** SUMMARY ***
Total pot $0.75 | Rake $0 
Seat 1: 18G4P1XstjNvItdGUITxgw (big blind) folded before Flop
Seat 3: VWwtMkIjXloiX/RKh7RGWQ folded before Flop (didn't bet)
Seat 5: HPEB+AtKw1+C/cxU0o1ciw folded before Flop
Seat 6: CgIo2ItZqi4o3ayVG6HanQ folded before Flop (didn't bet)
Seat 7: 57qrNGHDvf6GhB8zVLsAtQ folded before Flop (didn't bet)
Seat 8: cZ99hugmLBj9KhTlc8nCSw (button) folded before Flop (didn't bet)
Seat 9: KqS/lY/fNB9qUxokm9QfeA (small blind) collected ($0.75)




PokerStars Game #59941972194:  Hold'em No Limit ($0.10/$0.25) - 2009/07/01 1:52:01 ET
Table '3lL16FBjWXTx3AjK5lMRww' 9-max Seat #9 is the button
Seat 1: fDGyaQz0cs2s4FOYxkbIHA ($15.30 in chips) 
Seat 3: QEbIGci+itdw+re8RM5fZA ($28.50 in chips) 
Seat 4: Z3a37Ry74FVl+CBZtAONiA ($6.40 in chips) 
Seat 5: M/9j4wkHH9i1JM51vgi1VA ($36.95 in chips) 
Seat 7: 6RiVTYll/5D8zICp0MRpKw ($26.30 in chips) 
Seat 8: ljemhp25Zg+nlA9DLCIiUw ($24.40 in chips) 
Seat 9: 00Ybni1cxfHtqmdWwh31Xg ($9.95 in chips) 
fDGyaQz0cs2s4FOYxkbIHA: posts small blind $0.10
c/9X4zftzphFxYtxp5kp9w: is sitting out 
QEbIGci+itdw+re8RM5fZA: posts big blind $0.25
*** HOLE CARDS ***
c/9X4zftzphFxYtxp5kp9w leaves the table
Z3a37Ry74FVl+CBZtAONiA: folds 
M/9j4wkHH9i1JM51vgi1VA: folds 
bXpVeaSTPBFSPJmeXxO7nw joins the table at seat #2 
6RiVTYll/5D8zICp0MRpKw: folds 
ljemhp25Zg+nlA9DLCIiUw: raises $0.50 to $0.75
00Ybni1cxfHtqmdWwh31Xg: folds 
fDGyaQz0cs2s4FOYxkbIHA: calls $0.65
QEbIGci+itdw+re8RM5fZA: folds 
*** FLOP *** [7h 3c 9d]
fDGyaQz0cs2s4FOYxkbIHA: checks 
ljemhp25Zg+nlA9DLCIiUw: bets $1.25
fDGyaQz0cs2s4FOYxkbIHA: folds 
Uncalled bet ($1.25) returned to ljemhp25Zg+nlA9DLCIiUw
ljemhp25Zg+nlA9DLCIiUw collected $1.70 from pot
ljemhp25Zg+nlA9DLCIiUw: doesn't show hand 
*** SUMMARY ***
Total pot $1.75 | Rake $0.05 
Board [7h 3c 9d]
Seat 1: fDGyaQz0cs2s4FOYxkbIHA (small blind) folded on the Flop
Seat 3: QEbIGci+itdw+re8RM5fZA (big blind) folded before Flop
Seat 4: Z3a37Ry74FVl+CBZtAONiA folded before Flop (didn't bet)
Seat 5: M/9j4wkHH9i1JM51vgi1VA folded before Flop (didn't bet)
Seat 7: 6RiVTYll/5D8zICp0MRpKw folded before Flop (didn't bet)
Seat 8: ljemhp25Zg+nlA9DLCIiUw collected ($1.70)
Seat 9: 00Ybni1cxfHtqmdWwh31Xg (button) folded before Flop (didn't bet)




PokerStars Game #59941972216:  Hold'em No Limit ($0.10/$0.25) - 2009/07/01 1:52:01 ET
Table '2AUmC2Rslg+QUbLfdgNdfg' 6-max Seat #1 is the button
Seat 1: YDXAegrCnzc0l6TSDNboXQ ($23.85 in chips) 
Seat 2: PLksyNlTVRVZwxJVC2/1eA ($14.30 in chips) 
Seat 3: JFIAqU8lCZ0vWwEl4bdGsg ($31.20 in chips) 
Seat 4: rfeJ/I60SIiPfszMkIoNNA ($9.75 in chips) 
Seat 5: AMc4cCwUJhokdGRYIaVPhQ ($31.10 in chips) 
Seat 6: xBWc54v+UTSJOiKpbAbJWg ($20.25 in chips) 
PLksyNlTVRVZwxJVC2/1eA: posts small blind $0.10
JFIAqU8lCZ0vWwEl4bdGsg: posts big blind $0.25
*** HOLE CARDS ***
rfeJ/I60SIiPfszMkIoNNA: folds 
AMc4cCwUJhokdGRYIaVPhQ: folds 
xBWc54v+UTSJOiKpbAbJWg: calls $0.25
YDXAegrCnzc0l6TSDNboXQ: calls $0.25
PLksyNlTVRVZwxJVC2/1eA: folds 
JFIAqU8lCZ0vWwEl4bdGsg: checks 
*** FLOP *** [9s 2c Jc]
JFIAqU8lCZ0vWwEl4bdGsg: checks 
xBWc54v+UTSJOiKpbAbJWg: checks 
YDXAegrCnzc0l6TSDNboXQ: checks 
*** TURN *** [9s 2c Jc] [8h]
JFIAqU8lCZ0vWwEl4bdGsg: bets $0.85
xBWc54v+UTSJOiKpbAbJWg: folds 
YDXAegrCnzc0l6TSDNboXQ: calls $0.85
*** RIVER *** [9s 2c Jc 8h] [2h]
JFIAqU8lCZ0vWwEl4bdGsg: bets $4
YDXAegrCnzc0l6TSDNboXQ: folds 
Uncalled bet ($4) returned to JFIAqU8lCZ0vWwEl4bdGsg
JFIAqU8lCZ0vWwEl4bdGsg collected $2.45 from pot
JFIAqU8lCZ0vWwEl4bdGsg: doesn't show hand 
*** SUMMARY ***
Total pot $2.55 | Rake $0.10 
Board [9s 2c Jc 8h 2h]
Seat 1: YDXAegrCnzc0l6TSDNboXQ (button) folded on the River
Seat 2: PLksyNlTVRVZwxJVC2/1eA (small blind) folded before Flop
Seat 3: JFIAqU8lCZ0vWwEl4bdGsg (big blind) collected ($2.45)
Seat 4: rfeJ/I60SIiPfszMkIoNNA folded before Flop (didn't bet)
Seat 5: AMc4cCwUJhokdGRYIaVPhQ folded before Flop (didn't bet)
Seat 6: xBWc54v+UTSJOiKpbAbJWg folded on the Turn




PokerStars Game #59941972376:  Hold'em No Limit ($0.10/$0.25) - 2009/07/01 1:52:01 ET
Table '/JJyyIstHfkT7t/bW+WXgg' 6-max Seat #3 is the button
Seat 1: xC0kaiDYM6YTlgODL83O5A ($14.50 in chips) 
Seat 2: obJgSnVgWWWaAUtVILo77Q ($29.45 in chips) 
Seat 3: DR0nVIhVP77oEBlO9J8vlg ($25.75 in chips) 
Seat 4: JFIAqU8lCZ0vWwEl4bdGsg ($36.15 in chips) 
Seat 5: +ZlnqPoP3Hg4BIUxDfKd/A ($45.70 in chips) 
Seat 6: UmcUp27+PbgBItv3ZNlAWQ ($25 in chips) 
JFIAqU8lCZ0vWwEl4bdGsg: posts small blind $0.10
+ZlnqPoP3Hg4BIUxDfKd/A: posts big blind $0.25
*** HOLE CARDS ***
UmcUp27+PbgBItv3ZNlAWQ: folds 
xC0kaiDYM6YTlgODL83O5A: folds 
obJgSnVgWWWaAUtVILo77Q: folds 
DR0nVIhVP77oEBlO9J8vlg: folds 
JFIAqU8lCZ0vWwEl4bdGsg: raises $0.60 to $0.85
+ZlnqPoP3Hg4BIUxDfKd/A: raises $2.10 to $2.95
JFIAqU8lCZ0vWwEl4bdGsg: folds 
Uncalled bet ($2.10) returned to +ZlnqPoP3Hg4BIUxDfKd/A
+ZlnqPoP3Hg4BIUxDfKd/A collected $1.70 from pot
+ZlnqPoP3Hg4BIUxDfKd/A: doesn't show hand 
*** SUMMARY ***
Total pot $1.70 | Rake $0 
Seat 1: xC0kaiDYM6YTlgODL83O5A folded before Flop (didn't bet)
Seat 2: obJgSnVgWWWaAUtVILo77Q folded before Flop (didn't bet)
Seat 3: DR0nVIhVP77oEBlO9J8vlg (button) folded before Flop (didn't bet)
Seat 4: JFIAqU8lCZ0vWwEl4bdGsg (small blind) folded before Flop
Seat 5: +ZlnqPoP3Hg4BIUxDfKd/A (big blind) collected ($1.70)
Seat 6: UmcUp27+PbgBItv3ZNlAWQ folded before Flop (didn't bet)




PokerStars Game #59941972136:  Hold'em No Limit ($0.10/$0.25) - 2009/07/01 1:52:01 ET
Table 'jItkp2PNTbH9Cf7gqsAF7g' 9-max Seat #3 is the button
Seat 1: wGigCmBR/9XWkPpvYos3aQ ($26.50 in chips) 
Seat 2: qwr38jl5txoR36M7G5qi4A ($7.60 in chips) 
Seat 3: 0YaJElQVLqWThIZnqq3w1g ($10.95 in chips) 
Seat 4: oJOvZw/Iayou0f0k6dkBhg ($5.05 in chips) 
Seat 5: NO6qGDOw12lhu3zh1xW3Bg ($18.40 in chips) 
Seat 6: cZ99hugmLBj9KhTlc8nCSw ($51.25 in chips) 
Seat 8: cq6LACCDFivk2+PeoiB2sw ($11.10 in chips) 
Seat 9: dtZ84flFEi4Q+SGrHMJRDQ ($27.10 in chips) 
oJOvZw/Iayou0f0k6dkBhg: posts small blind $0.10
NO6qGDOw12lhu3zh1xW3Bg: posts big blind $0.25
z5GxcHlYz/GSz6W2uFiTtg: sits out 
*** HOLE CARDS ***
cZ99hugmLBj9KhTlc8nCSw: folds 
cq6LACCDFivk2+PeoiB2sw: calls $0.25
dtZ84flFEi4Q+SGrHMJRDQ: folds 
wGigCmBR/9XWkPpvYos3aQ: folds 
qwr38jl5txoR36M7G5qi4A: folds 
0YaJElQVLqWThIZnqq3w1g: calls $0.25
oJOvZw/Iayou0f0k6dkBhg: calls $0.15
NO6qGDOw12lhu3zh1xW3Bg: checks 
*** FLOP *** [Jh 7c 2c]
oJOvZw/Iayou0f0k6dkBhg: checks 
NO6qGDOw12lhu3zh1xW3Bg: checks 
cq6LACCDFivk2+PeoiB2sw: checks 
0YaJElQVLqWThIZnqq3w1g: folds 
*** TURN *** [Jh 7c 2c] [4s]
0YaJElQVLqWThIZnqq3w1g leaves the table
oJOvZw/Iayou0f0k6dkBhg: checks 
NO6qGDOw12lhu3zh1xW3Bg: checks 
cq6LACCDFivk2+PeoiB2sw: checks 
*** RIVER *** [Jh 7c 2c 4s] [Qc]
oJOvZw/Iayou0f0k6dkBhg: bets $0.25
NO6qGDOw12lhu3zh1xW3Bg: folds 
K0b5wNInj6hUGRr6yzKFtw joins the table at seat #3 
cq6LACCDFivk2+PeoiB2sw: raises $3.50 to $3.75
oJOvZw/Iayou0f0k6dkBhg: folds 
Uncalled bet ($3.50) returned to cq6LACCDFivk2+PeoiB2sw
cq6LACCDFivk2+PeoiB2sw collected $1.45 from pot
*** SUMMARY ***
Total pot $1.50 | Rake $0.05 
Board [Jh 7c 2c 4s Qc]
Seat 1: wGigCmBR/9XWkPpvYos3aQ folded before Flop (didn't bet)
Seat 2: qwr38jl5txoR36M7G5qi4A folded before Flop (didn't bet)
Seat 3: 0YaJElQVLqWThIZnqq3w1g (button) folded on the Flop
Seat 4: oJOvZw/Iayou0f0k6dkBhg (small blind) folded on the River
Seat 5: NO6qGDOw12lhu3zh1xW3Bg (big blind) folded on the River
Seat 6: cZ99hugmLBj9KhTlc8nCSw folded before Flop (didn't bet)
Seat 8: cq6LACCDFivk2+PeoiB2sw collected ($1.45)
Seat 9: dtZ84flFEi4Q+SGrHMJRDQ folded before Flop (didn't bet)




PokerStars Game #59941972272:  Hold'em No Limit ($0.10/$0.25) - 2009/07/01 1:52:01 ET
Table 'K/f0NNaoGuhSz5DrzgVw7Q' 9-max Seat #7 is the button
Seat 1: sD+TKtt36XiiN6jqHiLwDA ($26.05 in chips) 
Seat 2: zgi+EUykT/pZQpoUG6+oEg ($4.65 in chips) 
Seat 4: 9bCz0uv2nUmznwuI0OjVGw ($11.30 in chips) 
Seat 5: DnDcAdn9P0zGovMERigpFA ($40.60 in chips) 
Seat 6: 3PVK0IdMlq2fElkVzzr4bg ($7.25 in chips) 
Seat 7: egvg3mTBBVzMHnJPIQiKcA ($14.40 in chips) 
Seat 8: RCqMONFrSPSArZh2Jsar/w ($25.45 in chips) 
Seat 9: tLcDklc2rBORNfixyRfVfw ($25 in chips) 
RCqMONFrSPSArZh2Jsar/w: posts small blind $0.10
tLcDklc2rBORNfixyRfVfw: posts big blind $0.25
z5GxcHlYz/GSz6W2uFiTtg: sits out 
*** HOLE CARDS ***
sD+TKtt36XiiN6jqHiLwDA: folds 
zgi+EUykT/pZQpoUG6+oEg: folds 
9bCz0uv2nUmznwuI0OjVGw: calls $0.25
DnDcAdn9P0zGovMERigpFA: folds 
3PVK0IdMlq2fElkVzzr4bg: calls $0.25
egvg3mTBBVzMHnJPIQiKcA: calls $0.25
RCqMONFrSPSArZh2Jsar/w: folds 
tLcDklc2rBORNfixyRfVfw: checks 
*** FLOP *** [Td Th Qc]
tLcDklc2rBORNfixyRfVfw: checks 
9bCz0uv2nUmznwuI0OjVGw: checks 
3PVK0IdMlq2fElkVzzr4bg: checks 
egvg3mTBBVzMHnJPIQiKcA: checks 
*** TURN *** [Td Th Qc] [4c]
tLcDklc2rBORNfixyRfVfw: checks 
9bCz0uv2nUmznwuI0OjVGw: checks 
3PVK0IdMlq2fElkVzzr4bg: checks 
egvg3mTBBVzMHnJPIQiKcA: checks 
*** RIVER *** [Td Th Qc 4c] [4s]
tLcDklc2rBORNfixyRfVfw: checks 
9bCz0uv2nUmznwuI0OjVGw: checks 
3PVK0IdMlq2fElkVzzr4bg: checks 
egvg3mTBBVzMHnJPIQiKcA: checks 
*** SHOW DOWN ***
tLcDklc2rBORNfixyRfVfw: shows [Js 2s] (two pair, Tens and Fours)
9bCz0uv2nUmznwuI0OjVGw: shows [9h 7h] (two pair, Tens and Fours)
3PVK0IdMlq2fElkVzzr4bg: shows [Jd 7s] (two pair, Tens and Fours)
egvg3mTBBVzMHnJPIQiKcA: shows [7c 7d] (two pair, Tens and Sevens)
egvg3mTBBVzMHnJPIQiKcA collected $1.05 from pot
*** SUMMARY ***
Total pot $1.10 | Rake $0.05 
Board [Td Th Qc 4c 4s]
Seat 1: sD+TKtt36XiiN6jqHiLwDA folded before Flop (didn't bet)
Seat 2: zgi+EUykT/pZQpoUG6+oEg folded before Flop (didn't bet)
Seat 4: 9bCz0uv2nUmznwuI0OjVGw showed [9h 7h] and lost with two pair, Tens and Fours
Seat 5: DnDcAdn9P0zGovMERigpFA folded before Flop (didn't bet)
Seat 6: 3PVK0IdMlq2fElkVzzr4bg showed [Jd 7s] and lost with two pair, Tens and Fours
Seat 7: egvg3mTBBVzMHnJPIQiKcA (button) showed [7c 7d] and won ($1.05) with two pair, Tens and Sevens
Seat 8: RCqMONFrSPSArZh2Jsar/w (small blind) folded before Flop
Seat 9: tLcDklc2rBORNfixyRfVfw (big blind) showed [Js 2s] and lost with two pair, Tens and Fours




PokerStars Game #59941972218:  Hold'em No Limit ($0.10/$0.25) - 2009/07/01 1:52:01 ET
Table '1HT8bEDpLPhOXxmqMtzF8w' 9-max Seat #9 is the button
Seat 1: YkkKQUDI0iWatY4h0WWaAQ ($12.40 in chips) 
Seat 2: r6hsffOo1iKmaPYKwAZmFw ($29 in chips) 
Seat 3: oLa/tXLfSLLB28mcLGrxcg ($23.50 in chips) 
Seat 5: z5GxcHlYz/GSz6W2uFiTtg ($25 in chips) 
Seat 6: bXpVeaSTPBFSPJmeXxO7nw ($5.90 in chips) 
Seat 7: PMhmqYBPHOAXjH25lRz69g ($17.10 in chips) 
Seat 8: ghNKXUBl/H+t83JF079ZBA ($33.30 in chips) 
Seat 9: Z9W7+g1WMhhZDi7DwGbCFA ($5 in chips) 
YkkKQUDI0iWatY4h0WWaAQ: posts small blind $0.10
YaTpJQaFLj1usIcoGPRVJQ joins the table at seat #4 
r6hsffOo1iKmaPYKwAZmFw: posts big blind $0.25
z5GxcHlYz/GSz6W2uFiTtg: posts big blind $0.25
*** HOLE CARDS ***
oLa/tXLfSLLB28mcLGrxcg: folds 
z5GxcHlYz/GSz6W2uFiTtg: checks 
bXpVeaSTPBFSPJmeXxO7nw: folds 
PMhmqYBPHOAXjH25lRz69g: folds 
ghNKXUBl/H+t83JF079ZBA: folds 
Z9W7+g1WMhhZDi7DwGbCFA: folds 
YkkKQUDI0iWatY4h0WWaAQ: calls $0.15
r6hsffOo1iKmaPYKwAZmFw: checks 
*** FLOP *** [Ks 5h 7d]
YkkKQUDI0iWatY4h0WWaAQ: checks 
r6hsffOo1iKmaPYKwAZmFw: checks 
z5GxcHlYz/GSz6W2uFiTtg: bets $0.50
YkkKQUDI0iWatY4h0WWaAQ: folds 
r6hsffOo1iKmaPYKwAZmFw: folds 
Uncalled bet ($0.50) returned to z5GxcHlYz/GSz6W2uFiTtg
z5GxcHlYz/GSz6W2uFiTtg collected $0.75 from pot
*** SUMMARY ***
Total pot $0.75 | Rake $0 
Board [Ks 5h 7d]
Seat 1: YkkKQUDI0iWatY4h0WWaAQ (small blind) folded on the Flop
Seat 2: r6hsffOo1iKmaPYKwAZmFw (big blind) folded on the Flop
Seat 3: oLa/tXLfSLLB28mcLGrxcg folded before Flop (didn't bet)
Seat 5: z5GxcHlYz/GSz6W2uFiTtg collected ($0.75)
Seat 6: bXpVeaSTPBFSPJmeXxO7nw folded before Flop (didn't bet)
Seat 7: PMhmqYBPHOAXjH25lRz69g folded before Flop (didn't bet)
Seat 8: ghNKXUBl/H+t83JF079ZBA folded before Flop (didn't bet)
Seat 9: Z9W7+g1WMhhZDi7DwGbCFA (button) folded before Flop (didn't bet)




PokerStars Game #59941972040:  Hold'em No Limit ($0.10/$0.25) - 2009/07/01 1:52:01 ET
Table 'nc6OeGk/wtaWV+6N+kgnZQ' 6-max Seat #5 is the button
Seat 2: 8ClCHtFXGNplITm+63KB+Q ($37.60 in chips) 
Seat 3: y8wpMWGSX2zHZijurx21mg ($6.40 in chips) 
Seat 4: 3zD3qLXT1bEffAoWGnc7wg ($31.20 in chips) 
Seat 5: HCS0lMAAPmZE2Tl8J/SuKw ($8.30 in chips) 
Seat 6: kARKwAmU6kWJfiSICTYhVw ($9.75 in chips) 
kARKwAmU6kWJfiSICTYhVw: posts small blind $0.10
8ClCHtFXGNplITm+63KB+Q: posts big blind $0.25
*** HOLE CARDS ***
y8wpMWGSX2zHZijurx21mg: calls $0.25
3zD3qLXT1bEffAoWGnc7wg: folds 
HCS0lMAAPmZE2Tl8J/SuKw: calls $0.25
kARKwAmU6kWJfiSICTYhVw: folds 
8ClCHtFXGNplITm+63KB+Q: checks 
*** FLOP *** [4c 3h Kh]
8ClCHtFXGNplITm+63KB+Q: checks 
y8wpMWGSX2zHZijurx21mg: bets $0.25
HCS0lMAAPmZE2Tl8J/SuKw: calls $0.25
8ClCHtFXGNplITm+63KB+Q: folds 
*** TURN *** [4c 3h Kh] [Td]
y8wpMWGSX2zHZijurx21mg: bets $0.50
HCS0lMAAPmZE2Tl8J/SuKw: calls $0.50
*** RIVER *** [4c 3h Kh Td] [5h]
y8wpMWGSX2zHZijurx21mg: bets $0.50
HCS0lMAAPmZE2Tl8J/SuKw: folds 
Uncalled bet ($0.50) returned to y8wpMWGSX2zHZijurx21mg
y8wpMWGSX2zHZijurx21mg collected $2.25 from pot
y8wpMWGSX2zHZijurx21mg: doesn't show hand 
*** SUMMARY ***
Total pot $2.35 | Rake $0.10 
Board [4c 3h Kh Td 5h]
Seat 2: 8ClCHtFXGNplITm+63KB+Q (big blind) folded on the Flop
Seat 3: y8wpMWGSX2zHZijurx21mg collected ($2.25)
Seat 4: 3zD3qLXT1bEffAoWGnc7wg folded before Flop (didn't bet)
Seat 5: HCS0lMAAPmZE2Tl8J/SuKw (button) folded on the River
Seat 6: kARKwAmU6kWJfiSICTYhVw (small blind) folded before Flop




PokerStars Game #59941972338:  Hold'em No Limit ($0.10/$0.25) - 2009/07/01 1:52:01 ET
Table '4UJB/UOZ5aepyF2v+hIoUg' 6-max Seat #3 is the button
Seat 1: 08V++DOqzaNrRNsHIwi25w ($26.85 in chips) 
Seat 3: zlYHXTtJ5tcx9kwK2h5n9A ($49.40 in chips) 
Seat 4: R6AGToFJQOYVZAjC2jXEKw ($24.75 in chips) 
Seat 5: 3zD3qLXT1bEffAoWGnc7wg ($25.80 in chips) 
Seat 6: 2aphcinkTZT0B0Uoah6cvQ ($15.10 in chips) 
R6AGToFJQOYVZAjC2jXEKw: posts small blind $0.10
3zD3qLXT1bEffAoWGnc7wg: posts big blind $0.25
*** HOLE CARDS ***
2aphcinkTZT0B0Uoah6cvQ: folds 
08V++DOqzaNrRNsHIwi25w: raises $0.50 to $0.75
zlYHXTtJ5tcx9kwK2h5n9A: folds 
R6AGToFJQOYVZAjC2jXEKw: calls $0.65
3zD3qLXT1bEffAoWGnc7wg: calls $0.50
*** FLOP *** [9s 8d Kd]
ellenxmarie leaves the table
R6AGToFJQOYVZAjC2jXEKw: checks 
3zD3qLXT1bEffAoWGnc7wg: bets $1.25
08V++DOqzaNrRNsHIwi25w: raises $2.75 to $4
R6AGToFJQOYVZAjC2jXEKw: folds 
3zD3qLXT1bEffAoWGnc7wg: calls $2.75
*** TURN *** [9s 8d Kd] [5h]
3zD3qLXT1bEffAoWGnc7wg: checks 
08V++DOqzaNrRNsHIwi25w: bets $6.25
3zD3qLXT1bEffAoWGnc7wg: calls $6.25
*** RIVER *** [9s 8d Kd 5h] [5d]
3zD3qLXT1bEffAoWGnc7wg: checks 
08V++DOqzaNrRNsHIwi25w: checks 
*** SHOW DOWN ***
3zD3qLXT1bEffAoWGnc7wg: shows [Jd Kc] (two pair, Kings and Fives)
08V++DOqzaNrRNsHIwi25w: shows [Ac Ah] (two pair, Aces and Fives)
08V++DOqzaNrRNsHIwi25w collected $21.65 from pot
*** SUMMARY ***
Total pot $22.75 | Rake $1.10 
Board [9s 8d Kd 5h 5d]
Seat 1: 08V++DOqzaNrRNsHIwi25w showed [Ac Ah] and won ($21.65) with two pair, Aces and Fives
Seat 3: zlYHXTtJ5tcx9kwK2h5n9A (button) folded before Flop (didn't bet)
Seat 4: R6AGToFJQOYVZAjC2jXEKw (small blind) folded on the Flop
Seat 5: 3zD3qLXT1bEffAoWGnc7wg (big blind) showed [Jd Kc] and lost with two pair, Kings and Fives
Seat 6: 2aphcinkTZT0B0Uoah6cvQ folded before Flop (didn't bet)




PokerStars Game #59941972386:  Hold'em No Limit ($0.10/$0.25) - 2009/07/01 1:52:01 ET
Table '0M5QEJGOThqZwQ/sjbjXYw' 6-max Seat #2 is the button
Seat 2: /gJNBeCkWL4o85/jvlZ4BA ($32.85 in chips) 
Seat 3: 3zD3qLXT1bEffAoWGnc7wg ($29.20 in chips) 
Seat 4: PToTQrV0TmESDzjJftg6QQ ($25 in chips) 
Seat 5: cWc85bEzdRzpUMhRKm8pwQ ($53.05 in chips) 
Seat 6: bb63I02U6p9a5MNFa1gCiw ($18.45 in chips) 
3zD3qLXT1bEffAoWGnc7wg: posts small blind $0.10
PToTQrV0TmESDzjJftg6QQ: posts big blind $0.25
*** HOLE CARDS ***
cWc85bEzdRzpUMhRKm8pwQ: folds 
bb63I02U6p9a5MNFa1gCiw: calls $0.25
/gJNBeCkWL4o85/jvlZ4BA: folds 
3zD3qLXT1bEffAoWGnc7wg: calls $0.15
PToTQrV0TmESDzjJftg6QQ: checks 
*** FLOP *** [Tc Jd Ts]
3zD3qLXT1bEffAoWGnc7wg: checks 
PToTQrV0TmESDzjJftg6QQ: checks 
bb63I02U6p9a5MNFa1gCiw: checks 
*** TURN *** [Tc Jd Ts] [Js]
3zD3qLXT1bEffAoWGnc7wg: checks 
PToTQrV0TmESDzjJftg6QQ: checks 
bb63I02U6p9a5MNFa1gCiw: checks 
*** RIVER *** [Tc Jd Ts Js] [Jc]
3zD3qLXT1bEffAoWGnc7wg: checks 
PToTQrV0TmESDzjJftg6QQ: checks 
bb63I02U6p9a5MNFa1gCiw: bets $0.50
3zD3qLXT1bEffAoWGnc7wg: folds 
PToTQrV0TmESDzjJftg6QQ: calls $0.50
*** SHOW DOWN ***
bb63I02U6p9a5MNFa1gCiw: shows [4h Kd] (a full house, Jacks full of Tens)
PToTQrV0TmESDzjJftg6QQ: shows [3c 6c] (a full house, Jacks full of Tens)
PToTQrV0TmESDzjJftg6QQ collected $0.85 from pot
bb63I02U6p9a5MNFa1gCiw collected $0.85 from pot
*** SUMMARY ***
Total pot $1.75 | Rake $0.05 
Board [Tc Jd Ts Js Jc]
Seat 2: /gJNBeCkWL4o85/jvlZ4BA (button) folded before Flop (didn't bet)
Seat 3: 3zD3qLXT1bEffAoWGnc7wg (small blind) folded on the River
Seat 4: PToTQrV0TmESDzjJftg6QQ (big blind) showed [3c 6c] and won ($0.85) with a full house, Jacks full of Tens
Seat 5: cWc85bEzdRzpUMhRKm8pwQ folded before Flop (didn't bet)
Seat 6: bb63I02U6p9a5MNFa1gCiw showed [4h Kd] and won ($0.85) with a full house, Jacks full of Tens




PokerStars Game #59941972528:  Hold'em No Limit ($0.10/$0.25) - 2009/07/01 1:52:01 ET
Table 'Ok3oDLIsTc2+KxPcI0bAOA' 6-max Seat #2 is the button
Seat 1: agQm3ugZ3qSVYNgNu1ddeA ($39.20 in chips) 
Seat 2: wPSNSp4HYtytRMXTu3oPSQ ($28.90 in chips) 
Seat 4: LJI7A1YgDM7hgh7o56+ReQ ($33.80 in chips) 
Seat 5: DFi/Lzkjsfv8QswS80JX9Q ($29.75 in chips) 
mVwoM9qpwrGzpTUusIu2Ig will be allowed to play after the button
LJI7A1YgDM7hgh7o56+ReQ: posts small blind $0.10
DFi/Lzkjsfv8QswS80JX9Q: posts big blind $0.25
*** HOLE CARDS ***
agQm3ugZ3qSVYNgNu1ddeA: folds 
wPSNSp4HYtytRMXTu3oPSQ: calls $0.25
LJI7A1YgDM7hgh7o56+ReQ: folds 
DFi/Lzkjsfv8QswS80JX9Q: checks 
*** FLOP *** [Kc As 3h]
DFi/Lzkjsfv8QswS80JX9Q: checks 
wPSNSp4HYtytRMXTu3oPSQ: bets $0.50
DFi/Lzkjsfv8QswS80JX9Q: folds 
Uncalled bet ($0.50) returned to wPSNSp4HYtytRMXTu3oPSQ
wPSNSp4HYtytRMXTu3oPSQ collected $0.60 from pot
wPSNSp4HYtytRMXTu3oPSQ: doesn't show hand 
*** SUMMARY ***
Total pot $0.60 | Rake $0 
Board [Kc As 3h]
Seat 1: agQm3ugZ3qSVYNgNu1ddeA folded before Flop (didn't bet)
Seat 2: wPSNSp4HYtytRMXTu3oPSQ (button) collected ($0.60)
Seat 4: LJI7A1YgDM7hgh7o56+ReQ (small blind) folded before Flop
Seat 5: DFi/Lzkjsfv8QswS80JX9Q (big blind) folded on the Flop




PokerStars Game #59941972904:  Hold'em No Limit ($0.10/$0.25) - 2009/07/01 1:52:02 ET
Table 'WEMI3Mtn7dGARDbgNrKibg' 9-max Seat #3 is the button
Seat 1: Th3FldXKQW6hWVVPahaoOQ ($30.35 in chips) 
Seat 3: qwr38jl5txoR36M7G5qi4A ($10 in chips) 
Seat 4: Z5NNIVvnhb2IJbLcI79WYQ ($10.90 in chips) 
Seat 5: yzPZQFeaQTNf1YK3a0zRIw ($9.30 in chips) 
Seat 6: arxNSjreDRGFg13EAM2F1w ($25 in chips) 
Seat 7: DnDcAdn9P0zGovMERigpFA ($54.90 in chips) 
Seat 8: ghNKXUBl/H+t83JF079ZBA ($29.25 in chips) 
Seat 9: 2wcFsZsqEP5w1StUTVzJCg ($4.25 in chips) 
Z5NNIVvnhb2IJbLcI79WYQ: posts small blind $0.10
yzPZQFeaQTNf1YK3a0zRIw: posts big blind $0.25
*** HOLE CARDS ***
arxNSjreDRGFg13EAM2F1w: folds 
DnDcAdn9P0zGovMERigpFA: folds 
ghNKXUBl/H+t83JF079ZBA: folds 
2wcFsZsqEP5w1StUTVzJCg: folds 
Th3FldXKQW6hWVVPahaoOQ: folds 
qwr38jl5txoR36M7G5qi4A: folds 
Z5NNIVvnhb2IJbLcI79WYQ: calls $0.15
yzPZQFeaQTNf1YK3a0zRIw: checks 
*** FLOP *** [2s 8s Qc]
Z5NNIVvnhb2IJbLcI79WYQ: bets $0.25
yzPZQFeaQTNf1YK3a0zRIw: calls $0.25
*** TURN *** [2s 8s Qc] [Tc]
Z5NNIVvnhb2IJbLcI79WYQ: checks 
yzPZQFeaQTNf1YK3a0zRIw: checks 
*** RIVER *** [2s 8s Qc Tc] [Jc]
Z5NNIVvnhb2IJbLcI79WYQ: bets $0.50
yzPZQFeaQTNf1YK3a0zRIw: calls $0.50
*** SHOW DOWN ***
Z5NNIVvnhb2IJbLcI79WYQ: shows [8d 9s] (a straight, Eight to Queen)
yzPZQFeaQTNf1YK3a0zRIw: shows [Kh 9d] (a straight, Nine to King)
yzPZQFeaQTNf1YK3a0zRIw collected $1.95 from pot
*** SUMMARY ***
Total pot $2 | Rake $0.05 
Board [2s 8s Qc Tc Jc]
Seat 1: Th3FldXKQW6hWVVPahaoOQ folded before Flop (didn't bet)
Seat 3: qwr38jl5txoR36M7G5qi4A (button) folded before Flop (didn't bet)
Seat 4: Z5NNIVvnhb2IJbLcI79WYQ (small blind) showed [8d 9s] and lost with a straight, Eight to Queen
Seat 5: yzPZQFeaQTNf1YK3a0zRIw (big blind) showed [Kh 9d] and won ($1.95) with a straight, Nine to King
Seat 6: arxNSjreDRGFg13EAM2F1w folded before Flop (didn't bet)
Seat 7: DnDcAdn9P0zGovMERigpFA folded before Flop (didn't bet)
Seat 8: ghNKXUBl/H+t83JF079ZBA folded before Flop (didn't bet)
Seat 9: 2wcFsZsqEP5w1StUTVzJCg folded before Flop (didn't bet)




PokerStars Game #59941972682:  Hold'em No Limit ($0.10/$0.25) - 2009/07/01 1:52:02 ET
Table 'MRfAiS/4JSfnUDlCcZo0wAhfHe8uKeSJMyWAjSdM7ROQx Seat #6 is the button
Seat 1: 48oT5xFI+5CHUJlfoGrE4w ($29.40 in chips) 
Seat 2: /gJNBeCkWL4o85/jvlZ4BA ($25.85 in chips) 
Seat 4: b4wRQV3APH8irVk6bUFe2Q ($37.10 in chips) 
Seat 5: Q1uciOZPBR/WkAlqa6cL4A ($27.85 in chips) 
Seat 6: df01R5ThvHspD8FgKmaDvQ ($25.20 in chips) 
48oT5xFI+5CHUJlfoGrE4w: posts small blind $0.10
/gJNBeCkWL4o85/jvlZ4BA: posts big blind $0.25
*** HOLE CARDS ***
b4wRQV3APH8irVk6bUFe2Q: folds 
Q1uciOZPBR/WkAlqa6cL4A: folds 
df01R5ThvHspD8FgKmaDvQ: raises $0.50 to $0.75
48oT5xFI+5CHUJlfoGrE4w: folds 
/gJNBeCkWL4o85/jvlZ4BA: calls $0.50
*** FLOP *** [7d 8c 7s]
/gJNBeCkWL4o85/jvlZ4BA: checks 
df01R5ThvHspD8FgKmaDvQ: bets $0.75
/gJNBeCkWL4o85/jvlZ4BA: folds 
Uncalled bet ($0.75) returned to df01R5ThvHspD8FgKmaDvQ
df01R5ThvHspD8FgKmaDvQ collected $1.55 from pot
*** SUMMARY ***
Total pot $1.60 | Rake $0.05 
Board [7d 8c 7s]
Seat 1: 48oT5xFI+5CHUJlfoGrE4w (small blind) folded before Flop
Seat 2: /gJNBeCkWL4o85/jvlZ4BA (big blind) folded on the Flop
Seat 4: b4wRQV3APH8irVk6bUFe2Q folded before Flop (didn't bet)
Seat 5: Q1uciOZPBR/WkAlqa6cL4A folded before Flop (didn't bet)
Seat 6: df01R5ThvHspD8FgKmaDvQ (button) collected ($1.55)




PokerStars Game #59941972614:  Hold'em No Limit ($0.10/$0.25) - 2009/07/01 1:52:02 ET
Table 'C47I7CmrmFr8Oo7wOovVwQ' 6-max Seat #4 is the button
Seat 1: aKCh+0w6BCOX3sJAdIVLMw ($5.35 in chips) 
Seat 2: 8JTm/CXBn3+kuQgcUOgPkw ($24.40 in chips) 
Seat 4: yY5JuFtDfXWRaZlVby4LLw ($9.10 in chips) 
Seat 5: or309yYY9Y9bfFWtrB0yUg ($4.85 in chips) 
Seat 6: pD7ri5wL3vsa6S1ulMYQmQ ($26.60 in chips) 
or309yYY9Y9bfFWtrB0yUg: posts small blind $0.10
pD7ri5wL3vsa6S1ulMYQmQ: posts big blind $0.25
p4qhycZstfeeDkKv3zEBjw: sits out 
*** HOLE CARDS ***
aKCh+0w6BCOX3sJAdIVLMw: folds 
8JTm/CXBn3+kuQgcUOgPkw: folds 
yY5JuFtDfXWRaZlVby4LLw: folds 
or309yYY9Y9bfFWtrB0yUg: raises $0.25 to $0.50
pD7ri5wL3vsa6S1ulMYQmQ: folds 
Uncalled bet ($0.25) returned to or309yYY9Y9bfFWtrB0yUg
or309yYY9Y9bfFWtrB0yUg collected $0.50 from pot
*** SUMMARY ***
Total pot $0.50 | Rake $0 
Seat 1: aKCh+0w6BCOX3sJAdIVLMw folded before Flop (didn't bet)
Seat 2: 8JTm/CXBn3+kuQgcUOgPkw folded before Flop (didn't bet)
Seat 4: yY5JuFtDfXWRaZlVby4LLw (button) folded before Flop (didn't bet)
Seat 5: or309yYY9Y9bfFWtrB0yUg (small blind) collected ($0.50)
Seat 6: pD7ri5wL3vsa6S1ulMYQmQ (big blind) folded before Flop




PokerStars Game #59941972712:  Hold'em No Limit ($0.10/$0.25) - 2009/07/01 1:52:02 ET
Table '7/qMNloI0nSXWiX5Y1watA' 9-max Seat #9 is the button
Seat 1: /LyhaB3V6jkgOfXORidqRQ ($10.15 in chips) 
Seat 2: wGigCmBR/9XWkPpvYos3aQ ($29.80 in chips) 
Seat 4: K0LdhPeU31rviEPo6Sv3TA ($9.45 in chips) 
Seat 8: ljemhp25Zg+nlA9DLCIiUw ($25.95 in chips) 
Seat 9: dmYlc+1cjwZMJ7wV+Z0rRg ($27.40 in chips) 
/LyhaB3V6jkgOfXORidqRQ: posts small blind $0.10
wGigCmBR/9XWkPpvYos3aQ: posts big blind $0.25
GeMoapCKDLc4ajT0Uk9ZQw: sits out 
JqeaikMej6KsqTKmUhl2Lw: sits out 
z5GxcHlYz/GSz6W2uFiTtg: sits out 
*** HOLE CARDS ***
K0LdhPeU31rviEPo6Sv3TA: folds 
ljemhp25Zg+nlA9DLCIiUw: folds 
dmYlc+1cjwZMJ7wV+Z0rRg: folds 
/LyhaB3V6jkgOfXORidqRQ: calls $0.15
wGigCmBR/9XWkPpvYos3aQ: checks 
*** FLOP *** [Ks 2d Qc]
/LyhaB3V6jkgOfXORidqRQ: checks 
wGigCmBR/9XWkPpvYos3aQ: checks 
*** TURN *** [Ks 2d Qc] [5c]
/LyhaB3V6jkgOfXORidqRQ: checks 
wGigCmBR/9XWkPpvYos3aQ: bets $0.30
/LyhaB3V6jkgOfXORidqRQ: folds 
Uncalled bet ($0.30) returned to wGigCmBR/9XWkPpvYos3aQ
wGigCmBR/9XWkPpvYos3aQ collected $0.50 from pot
wGigCmBR/9XWkPpvYos3aQ: doesn't show hand 
*** SUMMARY ***
Total pot $0.50 | Rake $0 
Board [Ks 2d Qc 5c]
Seat 1: /LyhaB3V6jkgOfXORidqRQ (small blind) folded on the Turn
Seat 2: wGigCmBR/9XWkPpvYos3aQ (big blind) collected ($0.50)
Seat 4: K0LdhPeU31rviEPo6Sv3TA folded before Flop (didn't bet)
Seat 8: ljemhp25Zg+nlA9DLCIiUw folded before Flop (didn't bet)
Seat 9: dmYlc+1cjwZMJ7wV+Z0rRg (button) folded before Flop (didn't bet)




PokerStars Game #59941972694:  Hold'em No Limit ($0.10/$0.25) - 2009/07/01 1:52:02 ET
Table 'l8hUTjBTXBorNUR/tyvSLw' 9-max Seat #2 is the button
Seat 1: cZ99hugmLBj9KhTlc8nCSw ($27.85 in chips) 
Seat 2: B6xHiX1SJkS0CUNCKDVwuQ ($21 in chips) 
Seat 3: ShCS62CJp4MKfKLKvGKQbA ($8.85 in chips) 
Seat 4: vPtFvcPtn/Afz0sucO1cmQ ($37.20 in chips) 
Seat 5: yyG4svzOpC1A+sUP/scg6w ($6.60 in chips) 
Seat 6: EVqHvqty1ZsuvDFiSXlSqQ ($23.95 in chips) 
Seat 7: F7pnn6czNpHvRM55XcA2EA ($33.90 in chips) 
Seat 8: Mh2r9hTeTEDnh19sRZtW3g ($4.65 in chips) 
Seat 9: zDrucyjVn5aeekNEc3cJrA ($32.95 in chips) 
ShCS62CJp4MKfKLKvGKQbA: posts small blind $0.10
vPtFvcPtn/Afz0sucO1cmQ: posts big blind $0.25
*** HOLE CARDS ***
yyG4svzOpC1A+sUP/scg6w: folds 
EVqHvqty1ZsuvDFiSXlSqQ: folds 
F7pnn6czNpHvRM55XcA2EA: folds 
Mh2r9hTeTEDnh19sRZtW3g: folds 
zDrucyjVn5aeekNEc3cJrA: folds 
cZ99hugmLBj9KhTlc8nCSw: folds 
B6xHiX1SJkS0CUNCKDVwuQ: folds 
ShCS62CJp4MKfKLKvGKQbA: folds 
Uncalled bet ($0.15) returned to vPtFvcPtn/Afz0sucO1cmQ
vPtFvcPtn/Afz0sucO1cmQ collected $0.20 from pot
vPtFvcPtn/Afz0sucO1cmQ: doesn't show hand 
*** SUMMARY ***
Total pot $0.20 | Rake $0 
Seat 1: cZ99hugmLBj9KhTlc8nCSw folded before Flop (didn't bet)
Seat 2: B6xHiX1SJkS0CUNCKDVwuQ (button) folded before Flop (didn't bet)
Seat 3: ShCS62CJp4MKfKLKvGKQbA (small blind) folded before Flop
Seat 4: vPtFvcPtn/Afz0sucO1cmQ (big blind) collected ($0.20)
Seat 5: yyG4svzOpC1A+sUP/scg6w folded before Flop (didn't bet)
Seat 6: EVqHvqty1ZsuvDFiSXlSqQ folded before Flop (didn't bet)
Seat 7: F7pnn6czNpHvRM55XcA2EA folded before Flop (didn't bet)
Seat 8: Mh2r9hTeTEDnh19sRZtW3g folded before Flop (didn't bet)
Seat 9: zDrucyjVn5aeekNEc3cJrA folded before Flop (didn't bet)




PokerStars Game #59941972584:  Hold'em No Limit ($0.10/$0.25) - 2009/07/01 1:52:02 ET
Table 'KEoOIegxPF91KooL2AelUA' 6-max Seat #4 is the button
Seat 1: 32YL2ZEp8NT4JB2RVM9euQ ($16.65 in chips) 
Seat 2: 0Bg59Tnte1Tc7C4i9Jd9cQ ($5.85 in chips) 
Seat 3: zxeVQGaMKDsDzmSY+AInjA ($12 in chips) 
Seat 4: Wo60l2GQnSEc3bxPVyvIUw ($6 in chips) 
Seat 5: VXTONriS+Ohik+r0FeicIw ($27.30 in chips) 
Seat 6: AMrBn4Vx9aAo/vv6WHLk6w ($3.25 in chips) 
VXTONriS+Ohik+r0FeicIw: posts small blind $0.10
AMrBn4Vx9aAo/vv6WHLk6w: posts big blind $0.25
*** HOLE CARDS ***
32YL2ZEp8NT4JB2RVM9euQ: folds 
0Bg59Tnte1Tc7C4i9Jd9cQ: folds 
zxeVQGaMKDsDzmSY+AInjA: raises $0.50 to $0.75
Wo60l2GQnSEc3bxPVyvIUw: calls $0.75
VXTONriS+Ohik+r0FeicIw: folds 
AMrBn4Vx9aAo/vv6WHLk6w: folds 
*** FLOP *** [2h 6d Qh]
zxeVQGaMKDsDzmSY+AInjA: checks 
Wo60l2GQnSEc3bxPVyvIUw: bets $1
zxeVQGaMKDsDzmSY+AInjA: calls $1
*** TURN *** [2h 6d Qh] [Kd]
zxeVQGaMKDsDzmSY+AInjA: checks 
Wo60l2GQnSEc3bxPVyvIUw: checks 
*** RIVER *** [2h 6d Qh Kd] [4s]
zxeVQGaMKDsDzmSY+AInjA: checks 
Wo60l2GQnSEc3bxPVyvIUw: bets $1
zxeVQGaMKDsDzmSY+AInjA: calls $1
*** SHOW DOWN ***
Wo60l2GQnSEc3bxPVyvIUw: shows [2d 3h] (a pair of Deuces)
zxeVQGaMKDsDzmSY+AInjA: mucks hand 
Wo60l2GQnSEc3bxPVyvIUw collected $5.60 from pot
*** SUMMARY ***
Total pot $5.85 | Rake $0.25 
Board [2h 6d Qh Kd 4s]
Seat 1: 32YL2ZEp8NT4JB2RVM9euQ folded before Flop (didn't bet)
Seat 2: 0Bg59Tnte1Tc7C4i9Jd9cQ folded before Flop (didn't bet)
Seat 3: zxeVQGaMKDsDzmSY+AInjA mucked
Seat 4: Wo60l2GQnSEc3bxPVyvIUw (button) showed [2d 3h] and won ($5.60) with a pair of Deuces
Seat 5: VXTONriS+Ohik+r0FeicIw (small blind) folded before Flop
Seat 6: AMrBn4Vx9aAo/vv6WHLk6w (big blind) folded before Flop




PokerStars Game #59941973558:  Hold'em No Limit ($0.10/$0.25) - 2009/07/01 1:52:03 ET
Table 'mF3KHGMaTpaBZbtBoyfTeg' 6-max Seat #2 is the button
Seat 1: 0HAB2GdCAM7p7V00xueAVQ ($34.20 in chips) 
Seat 2: xrf8tAXKQHG99HixCot1Iw ($26.85 in chips) 
Seat 3: 9kUKGKkblnIx3m8rlVol6Q ($15.60 in chips) 
Seat 4: qNYqNZMLP1I54EVl8faRRg ($6.80 in chips) 
Seat 5: 8ClCHtFXGNplITm+63KB+Q ($45.25 in chips) 
Seat 6: kG34n23qFQA3nzdOJTQ1dA ($26.45 in chips) 
9kUKGKkblnIx3m8rlVol6Q: posts small blind $0.10
qNYqNZMLP1I54EVl8faRRg: posts big blind $0.25
*** HOLE CARDS ***
8ClCHtFXGNplITm+63KB+Q: folds 
kG34n23qFQA3nzdOJTQ1dA: folds 
0HAB2GdCAM7p7V00xueAVQ: calls $0.25
xrf8tAXKQHG99HixCot1Iw: raises $0.75 to $1
9kUKGKkblnIx3m8rlVol6Q: folds 
qNYqNZMLP1I54EVl8faRRg: calls $0.75
0HAB2GdCAM7p7V00xueAVQ: calls $0.75
*** FLOP *** [9s 4c Ah]
qNYqNZMLP1I54EVl8faRRg: bets $5.80 and is all-in
0HAB2GdCAM7p7V00xueAVQ: folds 
xrf8tAXKQHG99HixCot1Iw: folds 
Uncalled bet ($5.80) returned to qNYqNZMLP1I54EVl8faRRg
qNYqNZMLP1I54EVl8faRRg collected $2.95 from pot
*** SUMMARY ***
Total pot $3.10 | Rake $0.15 
Board [9s 4c Ah]
Seat 1: 0HAB2GdCAM7p7V00xueAVQ folded on the Flop
Seat 2: xrf8tAXKQHG99HixCot1Iw (button) folded on the Flop
Seat 3: 9kUKGKkblnIx3m8rlVol6Q (small blind) folded before Flop
Seat 4: qNYqNZMLP1I54EVl8faRRg (big blind) collected ($2.95)
Seat 5: 8ClCHtFXGNplITm+63KB+Q folded before Flop (didn't bet)
Seat 6: kG34n23qFQA3nzdOJTQ1dA folded before Flop (didn't bet)




PokerStars Game #59941973454:  Hold'em No Limit ($0.10/$0.25) - 2009/07/01 1:52:03 ET
Table 'YONIZZNvg4uZ4xNUO1deeA' 6-max Seat #2 is the button
Seat 1: GbCVUNssQ7mqsPWr7J4d3w ($4.30 in chips) 
Seat 2: evMMX/0gSDH791KdSAOaSg ($18.45 in chips) 
Seat 3: Eksrep3hySi2jeDHuaWiOQ ($8.25 in chips) 
Seat 4: w43JQj2oYPpKQVG4Yzlq1w ($25 in chips) 
Seat 5: if4dh6jhJXeN3/qd3qCp9g ($25 in chips) 
Seat 6: eL3+wCBjFGfQ5FMdIZihwA ($29.10 in chips) 
Eksrep3hySi2jeDHuaWiOQ: posts small blind $0.10
w43JQj2oYPpKQVG4Yzlq1w: posts big blind $0.25
*** HOLE CARDS ***
if4dh6jhJXeN3/qd3qCp9g: folds 
eL3+wCBjFGfQ5FMdIZihwA: folds 
GbCVUNssQ7mqsPWr7J4d3w: folds 
evMMX/0gSDH791KdSAOaSg: folds 
Eksrep3hySi2jeDHuaWiOQ: raises $0.25 to $0.50
w43JQj2oYPpKQVG4Yzlq1w: folds 
Uncalled bet ($0.25) returned to Eksrep3hySi2jeDHuaWiOQ
Eksrep3hySi2jeDHuaWiOQ collected $0.50 from pot
*** SUMMARY ***
Total pot $0.50 | Rake $0 
Seat 1: GbCVUNssQ7mqsPWr7J4d3w folded before Flop (didn't bet)
Seat 2: evMMX/0gSDH791KdSAOaSg (button) folded before Flop (didn't bet)
Seat 3: Eksrep3hySi2jeDHuaWiOQ (small blind) collected ($0.50)
Seat 4: w43JQj2oYPpKQVG4Yzlq1w (big blind) folded before Flop
Seat 5: if4dh6jhJXeN3/qd3qCp9g folded before Flop (didn't bet)
Seat 6: eL3+wCBjFGfQ5FMdIZihwA folded before Flop (didn't bet)




PokerStars Game #59941973160:  Hold'em No Limit ($0.10/$0.25) - 2009/07/01 1:52:03 ET
Table '2clPgY3+dETPD/8zjXZdFw' 6-max Seat #6 is the button
Seat 1: 7cx44/slbeTw+Cy7QB8Trg ($27.20 in chips) 
Seat 2: cWc85bEzdRzpUMhRKm8pwQ ($25 in chips) 
Seat 3: FL1UWpN6oReBdznWDOy9Gg ($16.10 in chips) 
Seat 4: ljjhtb6FVPTx9AT9HNdtqg ($23.10 in chips) 
Seat 5: LJI7A1YgDM7hgh7o56+ReQ ($30.45 in chips) 
Seat 6: c3J/KYZ4cNsUEuz8v57I5A ($23.25 in chips) 
7cx44/slbeTw+Cy7QB8Trg: posts small blind $0.10
cWc85bEzdRzpUMhRKm8pwQ: posts big blind $0.25
*** HOLE CARDS ***
FL1UWpN6oReBdznWDOy9Gg: raises $0.25 to $0.50
ljjhtb6FVPTx9AT9HNdtqg: folds 
LJI7A1YgDM7hgh7o56+ReQ: folds 
c3J/KYZ4cNsUEuz8v57I5A: folds 
7cx44/slbeTw+Cy7QB8Trg: folds 
cWc85bEzdRzpUMhRKm8pwQ: folds 
Uncalled bet ($0.25) returned to FL1UWpN6oReBdznWDOy9Gg
FL1UWpN6oReBdznWDOy9Gg collected $0.60 from pot
*** SUMMARY ***
Total pot $0.60 | Rake $0 
Seat 1: 7cx44/slbeTw+Cy7QB8Trg (small blind) folded before Flop
Seat 2: cWc85bEzdRzpUMhRKm8pwQ (big blind) folded before Flop
Seat 3: FL1UWpN6oReBdznWDOy9Gg collected ($0.60)
Seat 4: ljjhtb6FVPTx9AT9HNdtqg folded before Flop (didn't bet)
Seat 5: LJI7A1YgDM7hgh7o56+ReQ folded before Flop (didn't bet)
Seat 6: c3J/KYZ4cNsUEuz8v57I5A (button) folded before Flop (didn't bet)




PokerStars Game #59941973432:  Hold'em No Limit ($0.10/$0.25) - 2009/07/01 1:52:03 ET
Table 'C8mMnVmvkagwolEzTvh07A' 9-max Seat #1 is the button
Seat 1: PqvgxdSg9z5VmrWpbYuz+g ($26.15 in chips) 
Seat 2: Bb42QRQMhg5/Y0vHP8/2Xw ($25.10 in chips) 
Seat 3: Th3FldXKQW6hWVVPahaoOQ ($34.50 in chips) 
Seat 4: dfNim92Z6XK1/h5SFW5vDg ($25.35 in chips) 
Seat 5: iGMlK+EhUflPB6jKQd95Cg ($25 in chips) 
Seat 6: AiXn/9o1EwOPZUHujnh/bA ($18.15 in chips) 
Bb42QRQMhg5/Y0vHP8/2Xw: posts small blind $0.10
Th3FldXKQW6hWVVPahaoOQ: posts big blind $0.25
18G4P1XstjNvItdGUITxgw: sits out 
*** HOLE CARDS ***
dfNim92Z6XK1/h5SFW5vDg: folds 
iGMlK+EhUflPB6jKQd95Cg: folds 
AiXn/9o1EwOPZUHujnh/bA: calls $0.25
PqvgxdSg9z5VmrWpbYuz+g: raises $0.75 to $1
Bb42QRQMhg5/Y0vHP8/2Xw: folds 
Th3FldXKQW6hWVVPahaoOQ: folds 
AiXn/9o1EwOPZUHujnh/bA: folds 
Uncalled bet ($0.75) returned to PqvgxdSg9z5VmrWpbYuz+g
PqvgxdSg9z5VmrWpbYuz+g collected $0.85 from pot
PqvgxdSg9z5VmrWpbYuz+g: doesn't show hand 
*** SUMMARY ***
Total pot $0.85 | Rake $0 
Seat 1: PqvgxdSg9z5VmrWpbYuz+g (button) collected ($0.85)
Seat 2: Bb42QRQMhg5/Y0vHP8/2Xw (small blind) folded before Flop
Seat 3: Th3FldXKQW6hWVVPahaoOQ (big blind) folded before Flop
Seat 4: dfNim92Z6XK1/h5SFW5vDg folded before Flop (didn't bet)
Seat 5: iGMlK+EhUflPB6jKQd95Cg folded before Flop (didn't bet)
Seat 6: AiXn/9o1EwOPZUHujnh/bA folded before Flop




PokerStars Game #59941973616:  Hold'em No Limit ($0.10/$0.25) - 2009/07/01 1:52:03 ET
Table '+giHa6FUL6U5/AZnCJEGvQ' 9-max Seat #5 is the button
Seat 5: zDrucyjVn5aeekNEc3cJrA ($44.40 in chips) 
Seat 6: GTMnTen6sQSoCpS9sggLbg ($25 in chips) 
zDrucyjVn5aeekNEc3cJrA: posts small blind $0.10
GTMnTen6sQSoCpS9sggLbg: posts big blind $0.25
*** HOLE CARDS ***
zDrucyjVn5aeekNEc3cJrA: calls $0.15
GTMnTen6sQSoCpS9sggLbg: checks 
*** FLOP *** [3c 9c Ad]
GTMnTen6sQSoCpS9sggLbg: checks 
zDrucyjVn5aeekNEc3cJrA: checks 
*** TURN *** [3c 9c Ad] [3s]
GTMnTen6sQSoCpS9sggLbg: bets $0.50
XQRLaOXTf3pRraVvFq7T1g joins the table at seat #4 
zDrucyjVn5aeekNEc3cJrA: folds 
Uncalled bet ($0.50) returned to GTMnTen6sQSoCpS9sggLbg
GTMnTen6sQSoCpS9sggLbg collected $0.50 from pot
GTMnTen6sQSoCpS9sggLbg: doesn't show hand 
*** SUMMARY ***
Total pot $0.50 | Rake $0 
Board [3c 9c Ad 3s]
Seat 5: zDrucyjVn5aeekNEc3cJrA (button) (small blind) folded on the Turn
Seat 6: GTMnTen6sQSoCpS9sggLbg (big blind) collected ($0.50)




PokerStars Game #59941973292:  Hold'em No Limit ($0.10/$0.25) - 2009/07/01 1:52:03 ET
Table 'gYBWJG3hEuJg6kphY0yhMg' 9-max Seat #6 is the button
Seat 1: AcL/hxc9eT0dCr2TYk/0Dg ($24.55 in chips) 
Seat 2: RCqMONFrSPSArZh2Jsar/w ($19.25 in chips) 
Seat 3: wGigCmBR/9XWkPpvYos3aQ ($25 in chips) 
Seat 4: V6p0jQ/RhUsqpHLmXvEX4Q ($12.35 in chips) 
Seat 5: +sbyWwIcFp9kP0bDtMegfQ ($27.90 in chips) 
Seat 6: Z9W7+g1WMhhZDi7DwGbCFA ($5 in chips) 
Seat 7: aIEQGxUJwm61WfazSNFCdA ($25.90 in chips) 
Seat 8: 7je+LC5Mfs6nL8YBVh4frQ ($4.75 in chips) 
Seat 9: Bb42QRQMhg5/Y0vHP8/2Xw ($28.05 in chips) 
aIEQGxUJwm61WfazSNFCdA: posts small blind $0.10
7je+LC5Mfs6nL8YBVh4frQ: posts big blind $0.25
*** HOLE CARDS ***
Bb42QRQMhg5/Y0vHP8/2Xw: folds 
AcL/hxc9eT0dCr2TYk/0Dg: raises $0.50 to $0.75
RCqMONFrSPSArZh2Jsar/w: calls $0.75
wGigCmBR/9XWkPpvYos3aQ: folds 
V6p0jQ/RhUsqpHLmXvEX4Q: folds 
+sbyWwIcFp9kP0bDtMegfQ: folds 
Z9W7+g1WMhhZDi7DwGbCFA: folds 
aIEQGxUJwm61WfazSNFCdA: folds 
7je+LC5Mfs6nL8YBVh4frQ: folds 
*** FLOP *** [3s Ah 5c]
AcL/hxc9eT0dCr2TYk/0Dg: bets $1.25
RCqMONFrSPSArZh2Jsar/w: calls $1.25
*** TURN *** [3s Ah 5c] [Jd]
AcL/hxc9eT0dCr2TYk/0Dg: bets $2.25
RCqMONFrSPSArZh2Jsar/w: folds 
Uncalled bet ($2.25) returned to AcL/hxc9eT0dCr2TYk/0Dg
AcL/hxc9eT0dCr2TYk/0Dg collected $4.15 from pot
AcL/hxc9eT0dCr2TYk/0Dg: doesn't show hand 
*** SUMMARY ***
Total pot $4.35 | Rake $0.20 
Board [3s Ah 5c Jd]
Seat 1: AcL/hxc9eT0dCr2TYk/0Dg collected ($4.15)
Seat 2: RCqMONFrSPSArZh2Jsar/w folded on the Turn
Seat 3: wGigCmBR/9XWkPpvYos3aQ folded before Flop (didn't bet)
Seat 4: V6p0jQ/RhUsqpHLmXvEX4Q folded before Flop (didn't bet)
Seat 5: +sbyWwIcFp9kP0bDtMegfQ folded before Flop (didn't bet)
Seat 6: Z9W7+g1WMhhZDi7DwGbCFA (button) folded before Flop (didn't bet)
Seat 7: aIEQGxUJwm61WfazSNFCdA (small blind) folded before Flop
Seat 8: 7je+LC5Mfs6nL8YBVh4frQ (big blind) folded before Flop
Seat 9: Bb42QRQMhg5/Y0vHP8/2Xw folded before Flop (didn't bet)




PokerStars Game #59941973548:  Hold'em No Limit ($0.10/$0.25) - 2009/07/01 1:52:03 ET
Table 'Utmw+yX+E/wdhNDIim90lQ' 9-max Seat #9 is the button
Seat 1: cZ99hugmLBj9KhTlc8nCSw ($31.70 in chips) 
Seat 2: iGMlK+EhUflPB6jKQd95Cg ($27.35 in chips) 
Seat 3: dfNim92Z6XK1/h5SFW5vDg ($25 in chips) 
Seat 5: ghNKXUBl/H+t83JF079ZBA ($26.25 in chips) 
Seat 6: OlPJsgR4xypSg/w1z7Gyvw ($33.15 in chips) 
Seat 7: CImUHesK+ZER4v/VCA9IUg ($48.80 in chips) 
Seat 8: Mh2r9hTeTEDnh19sRZtW3g ($4.65 in chips) 
Seat 9: Th3FldXKQW6hWVVPahaoOQ ($27.15 in chips) 
cZ99hugmLBj9KhTlc8nCSw: posts small blind $0.10
iGMlK+EhUflPB6jKQd95Cg: posts big blind $0.25
bXpVeaSTPBFSPJmeXxO7nw: sits out 
*** HOLE CARDS ***
dfNim92Z6XK1/h5SFW5vDg: folds 
ghNKXUBl/H+t83JF079ZBA: raises $0.75 to $1
OlPJsgR4xypSg/w1z7Gyvw: folds 
CImUHesK+ZER4v/VCA9IUg: folds 
Mh2r9hTeTEDnh19sRZtW3g: folds 
Th3FldXKQW6hWVVPahaoOQ: folds 
cZ99hugmLBj9KhTlc8nCSw: folds 
iGMlK+EhUflPB6jKQd95Cg: folds 
Uncalled bet ($0.75) returned to ghNKXUBl/H+t83JF079ZBA
ghNKXUBl/H+t83JF079ZBA collected $0.60 from pot
ghNKXUBl/H+t83JF079ZBA: doesn't show hand 
*** SUMMARY ***
Total pot $0.60 | Rake $0 
Seat 1: cZ99hugmLBj9KhTlc8nCSw (small blind) folded before Flop
Seat 2: iGMlK+EhUflPB6jKQd95Cg (big blind) folded before Flop
Seat 3: dfNim92Z6XK1/h5SFW5vDg folded before Flop (didn't bet)
Seat 5: ghNKXUBl/H+t83JF079ZBA collected ($0.60)
Seat 6: OlPJsgR4xypSg/w1z7Gyvw folded before Flop (didn't bet)
Seat 7: CImUHesK+ZER4v/VCA9IUg folded before Flop (didn't bet)
Seat 8: Mh2r9hTeTEDnh19sRZtW3g folded before Flop (didn't bet)
Seat 9: Th3FldXKQW6hWVVPahaoOQ (button) folded before Flop (didn't bet)




PokerStars Game #59941974006:  Hold'em No Limit ($0.10/$0.25) - 2009/07/01 1:52:04 ET
Table 'VuY5ej47Cy8nOI3Wogmhzw' 6-max Seat #5 is the button
Seat 1: EeUZtMU058v2ObUACOF4Og ($29.50 in chips) 
Seat 3: v+QfkGiuj9bgtuNoVnDO8w ($41.70 in chips) 
Seat 4: QqiZLFrN8iOUT/GHw7ztOA ($45.05 in chips) 
Seat 5: m2yWOKfAxqHoy5DDN87Ttw ($25 in chips) 
Seat 6: +KblIivb6tainScpwm14RQ ($10.70 in chips) 
+KblIivb6tainScpwm14RQ: posts small blind $0.10
EeUZtMU058v2ObUACOF4Og: posts big blind $0.25
*** HOLE CARDS ***
v+QfkGiuj9bgtuNoVnDO8w: raises $0.75 to $1
QqiZLFrN8iOUT/GHw7ztOA: folds 
m2yWOKfAxqHoy5DDN87Ttw: folds 
+KblIivb6tainScpwm14RQ: folds 
EeUZtMU058v2ObUACOF4Og: folds 
Uncalled bet ($0.75) returned to v+QfkGiuj9bgtuNoVnDO8w
v+QfkGiuj9bgtuNoVnDO8w collected $0.60 from pot
v+QfkGiuj9bgtuNoVnDO8w: doesn't show hand 
*** SUMMARY ***
Total pot $0.60 | Rake $0 
Seat 1: EeUZtMU058v2ObUACOF4Og (big blind) folded before Flop
Seat 3: v+QfkGiuj9bgtuNoVnDO8w collected ($0.60)
Seat 4: QqiZLFrN8iOUT/GHw7ztOA folded before Flop (didn't bet)
Seat 5: m2yWOKfAxqHoy5DDN87Ttw (button) folded before Flop (didn't bet)
Seat 6: +KblIivb6tainScpwm14RQ (small blind) folded before Flop




PokerStars Game #59941973916:  Hold'em No Limit ($0.10/$0.25) - 2009/07/01 1:52:04 ET
Table 'Qr+t8WGovMECkBv+cV1lrg' 6-max Seat #6 is the button
Seat 1: EeUZtMU058v2ObUACOF4Og ($34.20 in chips) 
Seat 2: vqWjZmdQu/Hxw96/IJTWdQ ($41.60 in chips) 
Seat 3: uZKkrGByYgd4/ZBX2d4z+w ($19.75 in chips) 
Seat 4: 1NNFfYMd5Hsphl/FYz9fNA ($61.40 in chips) 
Seat 5: I50OxuNg9riRq9sywF6jMQ ($4.65 in chips) 
Seat 6: 9U3ZKjCsarN0DjR6mSE8Ug ($14 in chips) 
EeUZtMU058v2ObUACOF4Og: posts small blind $0.10
vqWjZmdQu/Hxw96/IJTWdQ: posts big blind $0.25
*** HOLE CARDS ***
uZKkrGByYgd4/ZBX2d4z+w: folds 
1NNFfYMd5Hsphl/FYz9fNA: folds 
I50OxuNg9riRq9sywF6jMQ: folds 
9U3ZKjCsarN0DjR6mSE8Ug: folds 
EeUZtMU058v2ObUACOF4Og: calls $0.15
vqWjZmdQu/Hxw96/IJTWdQ: checks 
*** FLOP *** [9h Ks Qd]
EeUZtMU058v2ObUACOF4Og: bets $0.50
vqWjZmdQu/Hxw96/IJTWdQ: folds 
Uncalled bet ($0.50) returned to EeUZtMU058v2ObUACOF4Og
EeUZtMU058v2ObUACOF4Og collected $0.50 from pot
EeUZtMU058v2ObUACOF4Og: doesn't show hand 
*** SUMMARY ***
Total pot $0.50 | Rake $0 
Board [9h Ks Qd]
Seat 1: EeUZtMU058v2ObUACOF4Og (small blind) collected ($0.50)
Seat 2: vqWjZmdQu/Hxw96/IJTWdQ (big blind) folded on the Flop
Seat 3: uZKkrGByYgd4/ZBX2d4z+w folded before Flop (didn't bet)
Seat 4: 1NNFfYMd5Hsphl/FYz9fNA folded before Flop (didn't bet)
Seat 5: I50OxuNg9riRq9sywF6jMQ folded before Flop (didn't bet)
Seat 6: 9U3ZKjCsarN0DjR6mSE8Ug (button) folded before Flop (didn't bet)




PokerStars Game #59941973902:  Hold'em No Limit ($0.10/$0.25) - 2009/07/01 1:52:04 ET
Table '+UzantPJ4smVdrh+4GTu1w' 6-max Seat #5 is the button
Seat 1: TSmua8tGK3sTbwi0ynrW9Q ($39.50 in chips) 
Seat 2: tcbEu7VzyHQ+0lh+skbQhQ ($31 in chips) 
Seat 3: SS/yfeArhULzIcOPe8MdPg ($32.65 in chips) 
Seat 4: UmcUp27+PbgBItv3ZNlAWQ ($26.45 in chips) 
Seat 5: cj4VBQya7HtVL2zCGd5jLQ ($55.35 in chips) 
Seat 6: fZQg9veL7Dd/Z04ZTjC+wQ ($25 in chips) 
fZQg9veL7Dd/Z04ZTjC+wQ: posts small blind $0.10
TSmua8tGK3sTbwi0ynrW9Q: posts big blind $0.25
*** HOLE CARDS ***
tcbEu7VzyHQ+0lh+skbQhQ: calls $0.25
SS/yfeArhULzIcOPe8MdPg: folds 
UmcUp27+PbgBItv3ZNlAWQ: folds 
cj4VBQya7HtVL2zCGd5jLQ: folds 
fZQg9veL7Dd/Z04ZTjC+wQ: raises $1 to $1.25
TSmua8tGK3sTbwi0ynrW9Q: folds 
tcbEu7VzyHQ+0lh+skbQhQ: calls $1
*** FLOP *** [8s 2d 6s]
fZQg9veL7Dd/Z04ZTjC+wQ: bets $1.75
tcbEu7VzyHQ+0lh+skbQhQ: folds 
Uncalled bet ($1.75) returned to fZQg9veL7Dd/Z04ZTjC+wQ
fZQg9veL7Dd/Z04ZTjC+wQ collected $2.65 from pot
fZQg9veL7Dd/Z04ZTjC+wQ: doesn't show hand 
*** SUMMARY ***
Total pot $2.75 | Rake $0.10 
Board [8s 2d 6s]
Seat 1: TSmua8tGK3sTbwi0ynrW9Q (big blind) folded before Flop
Seat 2: tcbEu7VzyHQ+0lh+skbQhQ folded on the Flop
Seat 3: SS/yfeArhULzIcOPe8MdPg folded before Flop (didn't bet)
Seat 4: UmcUp27+PbgBItv3ZNlAWQ folded before Flop (didn't bet)
Seat 5: cj4VBQya7HtVL2zCGd5jLQ (button) folded before Flop (didn't bet)
Seat 6: fZQg9veL7Dd/Z04ZTjC+wQ (small blind) collected ($2.65)




PokerStars Game #59941974692:  Hold'em No Limit ($0.10/$0.25) - 2009/07/01 1:52:05 ET
Table 'oZuNsbNJuUyQLGKzQ/4JFg' 6-max Seat #2 is the button
Seat 1: vqWjZmdQu/Hxw96/IJTWdQ ($25 in chips) 
Seat 2: UA5OsKS3VPaxa7uC8La/kA ($35.05 in chips) 
Seat 3: 8ClCHtFXGNplITm+63KB+Q ($50.40 in chips) 
Seat 4: 9bpVv1/Qh9IYtXuCtl5VtQ ($31.20 in chips) 
Seat 5: oBUDUfeUyCbZBsjxHZgSiw ($11.40 in chips) 
Seat 6: fwg6dK1+r4jy/y+JqenYYQ ($24.05 in chips) 
8ClCHtFXGNplITm+63KB+Q: posts small blind $0.10
9bpVv1/Qh9IYtXuCtl5VtQ: posts big blind $0.25
*** HOLE CARDS ***
oBUDUfeUyCbZBsjxHZgSiw: folds 
fwg6dK1+r4jy/y+JqenYYQ: raises $0.25 to $0.50
vqWjZmdQu/Hxw96/IJTWdQ: folds 
UA5OsKS3VPaxa7uC8La/kA: folds 
8ClCHtFXGNplITm+63KB+Q: folds 
9bpVv1/Qh9IYtXuCtl5VtQ: calls $0.25
*** FLOP *** [Qc Ah As]
9bpVv1/Qh9IYtXuCtl5VtQ: checks 
fwg6dK1+r4jy/y+JqenYYQ: bets $1
9bpVv1/Qh9IYtXuCtl5VtQ: folds 
Uncalled bet ($1) returned to fwg6dK1+r4jy/y+JqenYYQ
fwg6dK1+r4jy/y+JqenYYQ collected $1.05 from pot
fwg6dK1+r4jy/y+JqenYYQ: doesn't show hand 
*** SUMMARY ***
Total pot $1.10 | Rake $0.05 
Board [Qc Ah As]
Seat 1: vqWjZmdQu/Hxw96/IJTWdQ folded before Flop (didn't bet)
Seat 2: UA5OsKS3VPaxa7uC8La/kA (button) folded before Flop (didn't bet)
Seat 3: 8ClCHtFXGNplITm+63KB+Q (small blind) folded before Flop
Seat 4: 9bpVv1/Qh9IYtXuCtl5VtQ (big blind) folded on the Flop
Seat 5: oBUDUfeUyCbZBsjxHZgSiw folded before Flop (didn't bet)
Seat 6: fwg6dK1+r4jy/y+JqenYYQ collected ($1.05)




PokerStars Game #59941974484:  Hold'em No Limit ($0.10/$0.25) - 2009/07/01 1:52:05 ET
Table 'sgdCtiuCu2BDZhyDi6RzTA' 6-max Seat #1 is the button
Seat 1: 3zD3qLXT1bEffAoWGnc7wg ($35.05 in chips) 
Seat 2: 88Xc2CgPRIRNHZycxJdBtQ ($25.80 in chips) 
Seat 3: eL3+wCBjFGfQ5FMdIZihwA ($27.55 in chips) 
Seat 4: rVKEgilmMX+EkKzDVvhmxA ($6.50 in chips) 
Seat 5: 0tQitW75xfmVWKldYHjmOQ ($3.70 in chips) 
Seat 6: KODslGU8ikCYS0/29dUkhg ($32.20 in chips) 
88Xc2CgPRIRNHZycxJdBtQ: posts small blind $0.10
eL3+wCBjFGfQ5FMdIZihwA: posts big blind $0.25
*** HOLE CARDS ***
rVKEgilmMX+EkKzDVvhmxA: folds 
0tQitW75xfmVWKldYHjmOQ: folds 
KODslGU8ikCYS0/29dUkhg: calls $0.25
3zD3qLXT1bEffAoWGnc7wg: raises $0.75 to $1
88Xc2CgPRIRNHZycxJdBtQ: folds 
eL3+wCBjFGfQ5FMdIZihwA: folds 
KODslGU8ikCYS0/29dUkhg: calls $0.75
*** FLOP *** [9s 9d Kh]
KODslGU8ikCYS0/29dUkhg: bets $0.25
3zD3qLXT1bEffAoWGnc7wg: folds 
Uncalled bet ($0.25) returned to KODslGU8ikCYS0/29dUkhg
KODslGU8ikCYS0/29dUkhg collected $2.25 from pot
*** SUMMARY ***
Total pot $2.35 | Rake $0.10 
Board [9s 9d Kh]
Seat 1: 3zD3qLXT1bEffAoWGnc7wg (button) folded on the Flop
Seat 2: 88Xc2CgPRIRNHZycxJdBtQ (small blind) folded before Flop
Seat 3: eL3+wCBjFGfQ5FMdIZihwA (big blind) folded before Flop
Seat 4: rVKEgilmMX+EkKzDVvhmxA folded before Flop (didn't bet)
Seat 5: 0tQitW75xfmVWKldYHjmOQ folded before Flop (didn't bet)
Seat 6: KODslGU8ikCYS0/29dUkhg collected ($2.25)




PokerStars Game #59941974174:  Hold'em No Limit ($0.10/$0.25) - 2009/07/01 1:52:05 ET
Table 'CBnRhp0d6E2+/NtM7Vbruw' 9-max Seat #7 is the button
Seat 1: 18G4P1XstjNvItdGUITxgw ($25 in chips) 
Seat 2: cZ99hugmLBj9KhTlc8nCSw ($26.50 in chips) 
Seat 3: Y3DZ6qQlLeBhixDj4M9vmg ($3.85 in chips) 
Seat 5: CT7Xj/V/O5rBlhtt+RZeFQ ($25.35 in chips) 
Seat 6: CvL9Ch1HYCVbTsfpNucitg ($6.55 in chips) 
Seat 7: j4q3p0lesp63b1gZDwLBZw ($5 in chips) 
Seat 8: MG90wfSJZnOejs/KD3vlQQ ($25.10 in chips) 
Seat 9: xHZZRLAaFUIC8WWI8ljOJA ($29.55 in chips) 
MG90wfSJZnOejs/KD3vlQQ: posts small blind $0.10
xHZZRLAaFUIC8WWI8ljOJA: posts big blind $0.25
*** HOLE CARDS ***
18G4P1XstjNvItdGUITxgw: folds 
cZ99hugmLBj9KhTlc8nCSw: folds 
Y3DZ6qQlLeBhixDj4M9vmg: calls $0.25
CT7Xj/V/O5rBlhtt+RZeFQ: folds 
CvL9Ch1HYCVbTsfpNucitg: folds 
j4q3p0lesp63b1gZDwLBZw: folds 
MG90wfSJZnOejs/KD3vlQQ: calls $0.15
xHZZRLAaFUIC8WWI8ljOJA: checks 
*** FLOP *** [3d 2d Jd]
MG90wfSJZnOejs/KD3vlQQ: checks 
xHZZRLAaFUIC8WWI8ljOJA: checks 
Y3DZ6qQlLeBhixDj4M9vmg: checks 
*** TURN *** [3d 2d Jd] [5s]
MG90wfSJZnOejs/KD3vlQQ: checks 
xHZZRLAaFUIC8WWI8ljOJA: bets $0.50
Y3DZ6qQlLeBhixDj4M9vmg: calls $0.50
MG90wfSJZnOejs/KD3vlQQ: folds 
*** RIVER *** [3d 2d Jd 5s] [3s]
xHZZRLAaFUIC8WWI8ljOJA: bets $0.50
Y3DZ6qQlLeBhixDj4M9vmg: raises $1 to $1.50
xHZZRLAaFUIC8WWI8ljOJA: calls $1
*** SHOW DOWN ***
Y3DZ6qQlLeBhixDj4M9vmg: shows [3h 4s] (three of a kind, Threes)
xHZZRLAaFUIC8WWI8ljOJA: mucks hand 
Y3DZ6qQlLeBhixDj4M9vmg collected $4.55 from pot
*** SUMMARY ***
Total pot $4.75 | Rake $0.20 
Board [3d 2d Jd 5s 3s]
Seat 1: 18G4P1XstjNvItdGUITxgw folded before Flop (didn't bet)
Seat 2: cZ99hugmLBj9KhTlc8nCSw folded before Flop (didn't bet)
Seat 3: Y3DZ6qQlLeBhixDj4M9vmg showed [3h 4s] and won ($4.55) with three of a kind, Threes
Seat 5: CT7Xj/V/O5rBlhtt+RZeFQ folded before Flop (didn't bet)
Seat 6: CvL9Ch1HYCVbTsfpNucitg folded before Flop (didn't bet)
Seat 7: j4q3p0lesp63b1gZDwLBZw (button) folded before Flop (didn't bet)
Seat 8: MG90wfSJZnOejs/KD3vlQQ (small blind) folded on the Turn
Seat 9: xHZZRLAaFUIC8WWI8ljOJA (big blind) mucked




PokerStars Game #59941974562:  Hold'em No Limit ($0.10/$0.25) - 2009/07/01 1:52:05 ET
Table 'emoxgHTxg9Uqeu06oLzLyg' 6-max Seat #2 is the button
Seat 1: epAUIB7h2FJXzUPRIvSkRA ($33.85 in chips) 
Seat 2: wIFhgE1PVdX6Xf6aVlSTPg ($30 in chips) 
Seat 4: 3VAbqAWh8ncE2SJOYIx2ZQ ($14.75 in chips) 
Seat 5: OIjOiBfQstWrK/RuXx7zcw ($7.85 in chips) 
Seat 6: u3Ol7kv1LmvszuHNm9rc6w ($18.65 in chips) 
3VAbqAWh8ncE2SJOYIx2ZQ: posts small blind $0.10
OIjOiBfQstWrK/RuXx7zcw: posts big blind $0.25
*** HOLE CARDS ***
u3Ol7kv1LmvszuHNm9rc6w: folds 
epAUIB7h2FJXzUPRIvSkRA: folds 
wIFhgE1PVdX6Xf6aVlSTPg: folds 
3VAbqAWh8ncE2SJOYIx2ZQ: folds 
Uncalled bet ($0.15) returned to OIjOiBfQstWrK/RuXx7zcw
OIjOiBfQstWrK/RuXx7zcw collected $0.20 from pot
OIjOiBfQstWrK/RuXx7zcw: doesn't show hand 
*** SUMMARY ***
Total pot $0.20 | Rake $0 
Seat 1: epAUIB7h2FJXzUPRIvSkRA folded before Flop (didn't bet)
Seat 2: wIFhgE1PVdX6Xf6aVlSTPg (button) folded before Flop (didn't bet)
Seat 4: 3VAbqAWh8ncE2SJOYIx2ZQ (small blind) folded before Flop
Seat 5: OIjOiBfQstWrK/RuXx7zcw (big blind) collected ($0.20)
Seat 6: u3Ol7kv1LmvszuHNm9rc6w folded before Flop (didn't bet)




PokerStars Game #59941974564:  Hold'em No Limit ($0.10/$0.25) - 2009/07/01 1:52:05 ET
Table '9SExUHslNkrPJ4XsrePaVw' 9-max Seat #2 is the button
Seat 1: RHqgdFvufLCYe54+qd2gcA ($4.15 in chips) 
Seat 2: cZ99hugmLBj9KhTlc8nCSw ($43.75 in chips) 
Seat 3: EP17SQz/iWcuYdNOGeBgkw ($11.80 in chips) 
Seat 4: 4awUyiDYTgylQKXZ9faBVA ($25 in chips) 
Seat 5: L+eJnUyhY8bMNYw755K8XQ ($17.55 in chips) 
Seat 6: YPJ90cgNXDABdYJcqmwB0A ($20.35 in chips) 
Seat 7: sx0lGrkT9fd4yFR+3cXUQg ($11.75 in chips) 
Seat 8: tLcDklc2rBORNfixyRfVfw ($26.35 in chips) 
Seat 9: /THNzAxdv2lBxcf4XTj/0g ($12.80 in chips) 
EP17SQz/iWcuYdNOGeBgkw: posts small blind $0.10
4awUyiDYTgylQKXZ9faBVA: posts big blind $0.25
*** HOLE CARDS ***
L+eJnUyhY8bMNYw755K8XQ: folds 
YPJ90cgNXDABdYJcqmwB0A: folds 
sx0lGrkT9fd4yFR+3cXUQg: folds 
tLcDklc2rBORNfixyRfVfw: folds 
/THNzAxdv2lBxcf4XTj/0g: raises $0.75 to $1
RHqgdFvufLCYe54+qd2gcA: folds 
cZ99hugmLBj9KhTlc8nCSw: folds 
EP17SQz/iWcuYdNOGeBgkw: folds 
4awUyiDYTgylQKXZ9faBVA: calls $0.75
*** FLOP *** [3c 4h 6h]
4awUyiDYTgylQKXZ9faBVA: bets $1
/THNzAxdv2lBxcf4XTj/0g: calls $1
*** TURN *** [3c 4h 6h] [Qc]
4awUyiDYTgylQKXZ9faBVA: checks 
/THNzAxdv2lBxcf4XTj/0g: bets $2.25
4awUyiDYTgylQKXZ9faBVA: folds 
Uncalled bet ($2.25) returned to /THNzAxdv2lBxcf4XTj/0g
/THNzAxdv2lBxcf4XTj/0g collected $3.90 from pot
/THNzAxdv2lBxcf4XTj/0g: doesn't show hand 
*** SUMMARY ***
Total pot $4.10 | Rake $0.20 
Board [3c 4h 6h Qc]
Seat 1: RHqgdFvufLCYe54+qd2gcA folded before Flop (didn't bet)
Seat 2: cZ99hugmLBj9KhTlc8nCSw (button) folded before Flop (didn't bet)
Seat 3: EP17SQz/iWcuYdNOGeBgkw (small blind) folded before Flop
Seat 4: 4awUyiDYTgylQKXZ9faBVA (big blind) folded on the Turn
Seat 5: L+eJnUyhY8bMNYw755K8XQ folded before Flop (didn't bet)
Seat 6: YPJ90cgNXDABdYJcqmwB0A folded before Flop (didn't bet)
Seat 7: sx0lGrkT9fd4yFR+3cXUQg folded before Flop (didn't bet)
Seat 8: tLcDklc2rBORNfixyRfVfw folded before Flop (didn't bet)
Seat 9: /THNzAxdv2lBxcf4XTj/0g collected ($3.90)




PokerStars Game #59941974844:  Hold'em No Limit ($0.10/$0.25) - 2009/07/01 1:52:06 ET
Table 'n8mNkPYbe1AIQEkioNesZA' 9-max Seat #5 is the button
Seat 1: 9lvO/qyU+xrU95Teu1fv0g ($5.20 in chips) 
Seat 2: QEbIGci+itdw+re8RM5fZA ($29.30 in chips) 
Seat 3: zDrucyjVn5aeekNEc3cJrA ($18.40 in chips) 
Seat 4: zgi+EUykT/pZQpoUG6+oEg ($4.65 in chips) 
Seat 5: wGigCmBR/9XWkPpvYos3aQ ($28.65 in chips) 
Seat 6: HPEB+AtKw1+C/cxU0o1ciw ($46.65 in chips) 
Seat 7: vNfw/x/HNt0WgQC8SveThg ($5 in chips) 
Seat 8: aNpwfA31EREwO+ar4XzBCw ($32.20 in chips) 
Seat 9: gehe91e0IyVT0QU/XBkEyg ($28.25 in chips) 
HPEB+AtKw1+C/cxU0o1ciw: posts small blind $0.10
vNfw/x/HNt0WgQC8SveThg: posts big blind $0.25
*** HOLE CARDS ***
aNpwfA31EREwO+ar4XzBCw: raises $0.50 to $0.75
gehe91e0IyVT0QU/XBkEyg: folds 
9lvO/qyU+xrU95Teu1fv0g: calls $0.75
QEbIGci+itdw+re8RM5fZA: folds 
zDrucyjVn5aeekNEc3cJrA: folds 
zgi+EUykT/pZQpoUG6+oEg: folds 
wGigCmBR/9XWkPpvYos3aQ: folds 
HPEB+AtKw1+C/cxU0o1ciw: folds 
vNfw/x/HNt0WgQC8SveThg: calls $0.50
*** FLOP *** [9c Th 2c]
vNfw/x/HNt0WgQC8SveThg: checks 
aNpwfA31EREwO+ar4XzBCw: checks 
9lvO/qyU+xrU95Teu1fv0g: checks 
*** TURN *** [9c Th 2c] [Qc]
vNfw/x/HNt0WgQC8SveThg: checks 
aNpwfA31EREwO+ar4XzBCw: checks 
9lvO/qyU+xrU95Teu1fv0g: bets $0.75
vNfw/x/HNt0WgQC8SveThg: folds 
aNpwfA31EREwO+ar4XzBCw: folds 
Uncalled bet ($0.75) returned to 9lvO/qyU+xrU95Teu1fv0g
9lvO/qyU+xrU95Teu1fv0g collected $2.25 from pot
*** SUMMARY ***
Total pot $2.35 | Rake $0.10 
Board [9c Th 2c Qc]
Seat 1: 9lvO/qyU+xrU95Teu1fv0g collected ($2.25)
Seat 2: QEbIGci+itdw+re8RM5fZA folded before Flop (didn't bet)
Seat 3: zDrucyjVn5aeekNEc3cJrA folded before Flop (didn't bet)
Seat 4: zgi+EUykT/pZQpoUG6+oEg folded before Flop (didn't bet)
Seat 5: wGigCmBR/9XWkPpvYos3aQ (button) folded before Flop (didn't bet)
Seat 6: HPEB+AtKw1+C/cxU0o1ciw (small blind) folded before Flop
Seat 7: vNfw/x/HNt0WgQC8SveThg (big blind) folded on the Turn
Seat 8: aNpwfA31EREwO+ar4XzBCw folded on the Turn
Seat 9: gehe91e0IyVT0QU/XBkEyg folded before Flop (didn't bet)




PokerStars Game #59941974842:  Hold'em No Limit ($0.10/$0.25) - 2009/07/01 1:52:06 ET
Table '3eK1r4Q4BSYFvsKkuTLpIA' 9-max Seat #9 is the button
Seat 1: vSkQm2EelzwRGDDQQk0Fqw ($4.05 in chips) 
Seat 2: 5n7e7I+px7c6CQmLpPbtsg ($5 in chips) 
Seat 3: 56S3mA6Zs3pGR+0p0vUCtg ($35.85 in chips) 
Seat 4: +2kMBNpY4nF1qNCRd8SJLA ($25 in chips) 
Seat 5: 775TiRJajPtN/ucpTmHrXA ($21.05 in chips) 
Seat 6: +HvCCmsGSQeatf+GZ9zk8Q ($29.50 in chips) 
Seat 7: ljemhp25Zg+nlA9DLCIiUw ($28.65 in chips) 
Seat 8: /29aHLC+Q6KCDcNv2bPfAg ($7.30 in chips) 
Seat 9: +sbyWwIcFp9kP0bDtMegfQ ($60.05 in chips) 
vSkQm2EelzwRGDDQQk0Fqw: posts small blind $0.10
5n7e7I+px7c6CQmLpPbtsg: posts big blind $0.25
*** HOLE CARDS ***
56S3mA6Zs3pGR+0p0vUCtg: folds 
+2kMBNpY4nF1qNCRd8SJLA: folds 
775TiRJajPtN/ucpTmHrXA: calls $0.25
+HvCCmsGSQeatf+GZ9zk8Q: folds 
ljemhp25Zg+nlA9DLCIiUw: calls $0.25
/29aHLC+Q6KCDcNv2bPfAg: calls $0.25
+sbyWwIcFp9kP0bDtMegfQ: folds 
56S3mA6Zs3pGR+0p0vUCtg leaves the table
vSkQm2EelzwRGDDQQk0Fqw: calls $0.15
5n7e7I+px7c6CQmLpPbtsg: checks 
*** FLOP *** [Ks Ah Tc]
vSkQm2EelzwRGDDQQk0Fqw: checks 
5n7e7I+px7c6CQmLpPbtsg: checks 
775TiRJajPtN/ucpTmHrXA: checks 
ljemhp25Zg+nlA9DLCIiUw: checks 
/29aHLC+Q6KCDcNv2bPfAg: checks 
*** TURN *** [Ks Ah Tc] [Th]
vSkQm2EelzwRGDDQQk0Fqw: checks 
5n7e7I+px7c6CQmLpPbtsg: checks 
775TiRJajPtN/ucpTmHrXA: checks 
ljemhp25Zg+nlA9DLCIiUw: checks 
/29aHLC+Q6KCDcNv2bPfAg: checks 
*** RIVER *** [Ks Ah Tc Th] [Qc]
cardman1978 joins the table at seat #3 
vSkQm2EelzwRGDDQQk0Fqw: checks 
5n7e7I+px7c6CQmLpPbtsg: checks 
775TiRJajPtN/ucpTmHrXA: checks 
ljemhp25Zg+nlA9DLCIiUw: checks 
/29aHLC+Q6KCDcNv2bPfAg: bets $0.50
vSkQm2EelzwRGDDQQk0Fqw: folds 
5n7e7I+px7c6CQmLpPbtsg: folds 
775TiRJajPtN/ucpTmHrXA: calls $0.50
ljemhp25Zg+nlA9DLCIiUw: folds 
*** SHOW DOWN ***
/29aHLC+Q6KCDcNv2bPfAg: shows [2s Ts] (three of a kind, Tens)
775TiRJajPtN/ucpTmHrXA: shows [Jh 8h] (a straight, Ten to Ace)
775TiRJajPtN/ucpTmHrXA collected $2.15 from pot
*** SUMMARY ***
Total pot $2.25 | Rake $0.10 
Board [Ks Ah Tc Th Qc]
Seat 1: vSkQm2EelzwRGDDQQk0Fqw (small blind) folded on the River
Seat 2: 5n7e7I+px7c6CQmLpPbtsg (big blind) folded on the River
Seat 3: 56S3mA6Zs3pGR+0p0vUCtg folded before Flop (didn't bet)
Seat 4: +2kMBNpY4nF1qNCRd8SJLA folded before Flop (didn't bet)
Seat 5: 775TiRJajPtN/ucpTmHrXA showed [Jh 8h] and won ($2.15) with a straight, Ten to Ace
Seat 6: +HvCCmsGSQeatf+GZ9zk8Q folded before Flop (didn't bet)
Seat 7: ljemhp25Zg+nlA9DLCIiUw folded on the River
Seat 8: /29aHLC+Q6KCDcNv2bPfAg showed [2s Ts] and lost with three of a kind, Tens
Seat 9: +sbyWwIcFp9kP0bDtMegfQ (button) folded before Flop (didn't bet)




PokerStars Game #59941974952:  Hold'em No Limit ($0.10/$0.25) - 2009/07/01 1:52:06 ET
Table 'pgrBYaOEx/BuqK5iAtlFzw' 9-max Seat #6 is the button
Seat 1: 6O+8t5ikoK+pNiFXnN/Fyw ($17.10 in chips) 
Seat 2: 2Xwi447v1rBHM+92U0CduA ($7.20 in chips) 
Seat 3: Bb42QRQMhg5/Y0vHP8/2Xw ($25 in chips) 
Seat 4: oLa/tXLfSLLB28mcLGrxcg ($23.90 in chips) 
Seat 5: BWzInv8o0kN1pJybv/VjpQ ($24.85 in chips) 
Seat 6: eubS00Znk+qsx0B0+7/Zow ($20.45 in chips) 
Seat 7: eK8qa6EPcH2zhtbmWSvc9g ($25 in chips) 
Seat 8: tLcDklc2rBORNfixyRfVfw ($27.45 in chips) 
eK8qa6EPcH2zhtbmWSvc9g: posts small blind $0.10
tLcDklc2rBORNfixyRfVfw: posts big blind $0.25
Z9W7+g1WMhhZDi7DwGbCFA: sits out 
*** HOLE CARDS ***
6O+8t5ikoK+pNiFXnN/Fyw: folds 
2Xwi447v1rBHM+92U0CduA: folds 
Bb42QRQMhg5/Y0vHP8/2Xw: folds 
oLa/tXLfSLLB28mcLGrxcg: folds 
BWzInv8o0kN1pJybv/VjpQ: folds 
eubS00Znk+qsx0B0+7/Zow: folds 
eK8qa6EPcH2zhtbmWSvc9g: folds 
Uncalled bet ($0.15) returned to tLcDklc2rBORNfixyRfVfw
tLcDklc2rBORNfixyRfVfw collected $0.20 from pot
tLcDklc2rBORNfixyRfVfw: doesn't show hand 
*** SUMMARY ***
Total pot $0.20 | Rake $0 
Seat 1: 6O+8t5ikoK+pNiFXnN/Fyw folded before Flop (didn't bet)
Seat 2: 2Xwi447v1rBHM+92U0CduA folded before Flop (didn't bet)
Seat 3: Bb42QRQMhg5/Y0vHP8/2Xw folded before Flop (didn't bet)
Seat 4: oLa/tXLfSLLB28mcLGrxcg folded before Flop (didn't bet)
Seat 5: BWzInv8o0kN1pJybv/VjpQ folded before Flop (didn't bet)
Seat 6: eubS00Znk+qsx0B0+7/Zow (button) folded before Flop (didn't bet)
Seat 7: eK8qa6EPcH2zhtbmWSvc9g (small blind) folded before Flop
Seat 8: tLcDklc2rBORNfixyRfVfw (big blind) collected ($0.20)




PokerStars Game #59941975156:  Hold'em No Limit ($0.10/$0.25) - 2009/07/01 1:52:06 ET
Table 'vFZR6Kf2Th5xBXT9brGW6A' 6-max Seat #1 is the button
Seat 1: Q1uciOZPBR/WkAlqa6cL4A ($27.55 in chips) 
Seat 2: QiL+lEgEWwy21jk/ltaRLg ($20.55 in chips) 
Seat 4: 79ID/ub1Pt/mDpCprVmOoA ($34.85 in chips) 
Seat 5: SS/yfeArhULzIcOPe8MdPg ($27.60 in chips) 
Seat 6: 4x9jCqgSw4272dnaIqnanw ($7.80 in chips) 
QiL+lEgEWwy21jk/ltaRLg: posts small blind $0.10
79ID/ub1Pt/mDpCprVmOoA: posts big blind $0.25
*** HOLE CARDS ***
SS/yfeArhULzIcOPe8MdPg: folds 
4x9jCqgSw4272dnaIqnanw: calls $0.25
Q1uciOZPBR/WkAlqa6cL4A: folds 
QiL+lEgEWwy21jk/ltaRLg: raises $0.25 to $0.50
texthgr8 joins the table at seat #3 
79ID/ub1Pt/mDpCprVmOoA: folds 
4x9jCqgSw4272dnaIqnanw: calls $0.25
*** FLOP *** [Js 3d 2d]
QiL+lEgEWwy21jk/ltaRLg: bets $0.50
4x9jCqgSw4272dnaIqnanw: calls $0.50
*** TURN *** [Js 3d 2d] [Jh]
texthgr8 leaves the table
QiL+lEgEWwy21jk/ltaRLg: bets $1
4x9jCqgSw4272dnaIqnanw: calls $1
*** RIVER *** [Js 3d 2d Jh] [5d]
QiL+lEgEWwy21jk/ltaRLg: bets $3.75
4x9jCqgSw4272dnaIqnanw: calls $3.75
*** SHOW DOWN ***
QiL+lEgEWwy21jk/ltaRLg: shows [5s 5h] (a full house, Fives full of Jacks)
4x9jCqgSw4272dnaIqnanw: mucks hand 
QiL+lEgEWwy21jk/ltaRLg collected $11.20 from pot
*** SUMMARY ***
Total pot $11.75 | Rake $0.55 
Board [Js 3d 2d Jh 5d]
Seat 1: Q1uciOZPBR/WkAlqa6cL4A (button) folded before Flop (didn't bet)
Seat 2: QiL+lEgEWwy21jk/ltaRLg (small blind) showed [5s 5h] and won ($11.20) with a full house, Fives full of Jacks
Seat 4: 79ID/ub1Pt/mDpCprVmOoA (big blind) folded before Flop
Seat 5: SS/yfeArhULzIcOPe8MdPg folded before Flop (didn't bet)
Seat 6: 4x9jCqgSw4272dnaIqnanw mucked




PokerStars Game #59941974828:  Hold'em No Limit ($0.10/$0.25) - 2009/07/01 1:52:06 ET
Table 'qryc9C/ELyQ3lubOaELNAQ' 6-max Seat #5 is the button
Seat 1: OZc6kkoTwtITj1ZfreJK1A ($84.40 in chips) 
Seat 2: LtASJ9OlkqGrrUKGQlpGAw ($29.45 in chips) 
Seat 3: wvIIdlbCgePONQwXjx9xzQ ($3.35 in chips) 
Seat 4: v+QfkGiuj9bgtuNoVnDO8w ($25 in chips) 
Seat 5: 9StOHp+Y1T0K13JdgS2oQQ ($38.20 in chips) 
OZc6kkoTwtITj1ZfreJK1A: posts small blind $0.10
LtASJ9OlkqGrrUKGQlpGAw: posts big blind $0.25
*** HOLE CARDS ***
wvIIdlbCgePONQwXjx9xzQ: folds 
wvIIdlbCgePONQwXjx9xzQ leaves the table
v+QfkGiuj9bgtuNoVnDO8w: folds 
9StOHp+Y1T0K13JdgS2oQQ: folds 
OZc6kkoTwtITj1ZfreJK1A: folds 
Uncalled bet ($0.15) returned to LtASJ9OlkqGrrUKGQlpGAw
LtASJ9OlkqGrrUKGQlpGAw collected $0.20 from pot
LtASJ9OlkqGrrUKGQlpGAw: doesn't show hand 
*** SUMMARY ***
Total pot $0.20 | Rake $0 
Seat 1: OZc6kkoTwtITj1ZfreJK1A (small blind) folded before Flop
Seat 2: LtASJ9OlkqGrrUKGQlpGAw (big blind) collected ($0.20)
Seat 3: wvIIdlbCgePONQwXjx9xzQ folded before Flop (didn't bet)
Seat 4: v+QfkGiuj9bgtuNoVnDO8w folded before Flop (didn't bet)
Seat 5: 9StOHp+Y1T0K13JdgS2oQQ (button) folded before Flop (didn't bet)




PokerStars Game #59941974918:  Hold'em No Limit ($0.10/$0.25) - 2009/07/01 1:52:06 ET
Table 'S6s+TmTlAjLHclBRvN5/fw' 9-max Seat #6 is the button
Seat 3: z2SmIaQ3+5n/eY1BN5HgPg ($12.75 in chips) 
Seat 4: RSal7+azPhXeqQO5L8XPfg ($17.35 in chips) 
Seat 5: 8hSJOE8UscCqt6t47gp0/g ($7.30 in chips) 
Seat 6: QkBggokTsSaL9vRv6V8nzQ ($5.85 in chips) 
z2SmIaQ3+5n/eY1BN5HgPg: posts small blind $0.10
RSal7+azPhXeqQO5L8XPfg: posts big blind $0.25
*** HOLE CARDS ***
8hSJOE8UscCqt6t47gp0/g: calls $0.25
QkBggokTsSaL9vRv6V8nzQ: folds 
z2SmIaQ3+5n/eY1BN5HgPg: calls $0.15
RSal7+azPhXeqQO5L8XPfg: checks 
*** FLOP *** [Ac Qd 5s]
z2SmIaQ3+5n/eY1BN5HgPg: checks 
RSal7+azPhXeqQO5L8XPfg: bets $0.50
8hSJOE8UscCqt6t47gp0/g: calls $0.50
z2SmIaQ3+5n/eY1BN5HgPg: folds 
*** TURN *** [Ac Qd 5s] [Qs]
RSal7+azPhXeqQO5L8XPfg: bets $0.75
8hSJOE8UscCqt6t47gp0/g: calls $0.75
*** RIVER *** [Ac Qd 5s Qs] [7h]
RSal7+azPhXeqQO5L8XPfg: bets $2
z2SmIaQ3+5n/eY1BN5HgPg said, "nice bluff"
8hSJOE8UscCqt6t47gp0/g: folds 
Uncalled bet ($2) returned to RSal7+azPhXeqQO5L8XPfg
RSal7+azPhXeqQO5L8XPfg collected $3.10 from pot
RSal7+azPhXeqQO5L8XPfg: doesn't show hand 
*** SUMMARY ***
Total pot $3.25 | Rake $0.15 
Board [Ac Qd 5s Qs 7h]
Seat 3: z2SmIaQ3+5n/eY1BN5HgPg (small blind) folded on the Flop
Seat 4: RSal7+azPhXeqQO5L8XPfg (big blind) collected ($3.10)
Seat 5: 8hSJOE8UscCqt6t47gp0/g folded on the River
Seat 6: QkBggokTsSaL9vRv6V8nzQ (button) folded before Flop (didn't bet)




PokerStars Game #59941974836:  Hold'em No Limit ($0.10/$0.25) - 2009/07/01 1:52:06 ET
Table 'nyTW9cVtYentc5V7xU/0jA' 6-max Seat #1 is the button
Seat 1: HI20pVxSHPZ29u9IDkmICg ($6.80 in chips) 
Seat 2: opbAKk7WcZH8kDKUux3/0g ($4.75 in chips) 
Seat 3: kG34n23qFQA3nzdOJTQ1dA ($35.50 in chips) 
Seat 4: NkB3D4eVHHXvB9Edaugc1Q ($36.95 in chips) 
Seat 5: zZAcuQ0EvirdEuiIbeaocQ ($6.10 in chips) 
Seat 6: Cwf8Ho8JHNvwzsv9ah8uRQ ($18.40 in chips) 
opbAKk7WcZH8kDKUux3/0g: posts small blind $0.10
kG34n23qFQA3nzdOJTQ1dA: posts big blind $0.25
*** HOLE CARDS ***
NkB3D4eVHHXvB9Edaugc1Q: calls $0.25
zZAcuQ0EvirdEuiIbeaocQ: calls $0.25
Cwf8Ho8JHNvwzsv9ah8uRQ: calls $0.25
HI20pVxSHPZ29u9IDkmICg: folds 
opbAKk7WcZH8kDKUux3/0g: calls $0.15
kG34n23qFQA3nzdOJTQ1dA: checks 
*** FLOP *** [8h 8s Qs]
opbAKk7WcZH8kDKUux3/0g: checks 
kG34n23qFQA3nzdOJTQ1dA: checks 
NkB3D4eVHHXvB9Edaugc1Q: checks 
zZAcuQ0EvirdEuiIbeaocQ: bets $0.75
Cwf8Ho8JHNvwzsv9ah8uRQ: folds 
opbAKk7WcZH8kDKUux3/0g: folds 
kG34n23qFQA3nzdOJTQ1dA: folds 
NkB3D4eVHHXvB9Edaugc1Q: folds 
Uncalled bet ($0.75) returned to zZAcuQ0EvirdEuiIbeaocQ
zZAcuQ0EvirdEuiIbeaocQ collected $1.20 from pot
zZAcuQ0EvirdEuiIbeaocQ: doesn't show hand 
*** SUMMARY ***
Total pot $1.25 | Rake $0.05 
Board [8h 8s Qs]
Seat 1: HI20pVxSHPZ29u9IDkmICg (button) folded before Flop (didn't bet)
Seat 2: opbAKk7WcZH8kDKUux3/0g (small blind) folded on the Flop
Seat 3: kG34n23qFQA3nzdOJTQ1dA (big blind) folded on the Flop
Seat 4: NkB3D4eVHHXvB9Edaugc1Q folded on the Flop
Seat 5: zZAcuQ0EvirdEuiIbeaocQ collected ($1.20)
Seat 6: Cwf8Ho8JHNvwzsv9ah8uRQ folded on the Flop




PokerStars Game #59941974944:  Hold'em No Limit ($0.10/$0.25) - 2009/07/01 1:52:06 ET
Table '6wawJ+MkkvuC3coG6r+Yhg' 6-max Seat #4 is the button
Seat 1: JQZew0FjzS19kTjeNtrE+A ($30.15 in chips) 
Seat 2: LtASJ9OlkqGrrUKGQlpGAw ($20.85 in chips) 
Seat 3: 3zD3qLXT1bEffAoWGnc7wg ($59.75 in chips) 
Seat 4: 9U3ZKjCsarN0DjR6mSE8Ug ($14.25 in chips) 
Seat 5: GbCVUNssQ7mqsPWr7J4d3w ($4.75 in chips) 
Seat 6: B3X187C0tXFUfQpCu8pe8A ($24.30 in chips) 
GbCVUNssQ7mqsPWr7J4d3w: posts small blind $0.10
B3X187C0tXFUfQpCu8pe8A: posts big blind $0.25
*** HOLE CARDS ***
JQZew0FjzS19kTjeNtrE+A: folds 
LtASJ9OlkqGrrUKGQlpGAw: folds 
3zD3qLXT1bEffAoWGnc7wg: raises $0.50 to $0.75
9U3ZKjCsarN0DjR6mSE8Ug: folds 
GbCVUNssQ7mqsPWr7J4d3w: folds 
B3X187C0tXFUfQpCu8pe8A: calls $0.50
*** FLOP *** [8h 2d 6h]
B3X187C0tXFUfQpCu8pe8A: checks 
3zD3qLXT1bEffAoWGnc7wg: bets $1.25
B3X187C0tXFUfQpCu8pe8A: folds 
Uncalled bet ($1.25) returned to 3zD3qLXT1bEffAoWGnc7wg
3zD3qLXT1bEffAoWGnc7wg collected $1.55 from pot
3zD3qLXT1bEffAoWGnc7wg: doesn't show hand 
*** SUMMARY ***
Total pot $1.60 | Rake $0.05 
Board [8h 2d 6h]
Seat 1: JQZew0FjzS19kTjeNtrE+A folded before Flop (didn't bet)
Seat 2: LtASJ9OlkqGrrUKGQlpGAw folded before Flop (didn't bet)
Seat 3: 3zD3qLXT1bEffAoWGnc7wg collected ($1.55)
Seat 4: 9U3ZKjCsarN0DjR6mSE8Ug (button) folded before Flop (didn't bet)
Seat 5: GbCVUNssQ7mqsPWr7J4d3w (small blind) folded before Flop
Seat 6: B3X187C0tXFUfQpCu8pe8A (big blind) folded on the Flop




PokerStars Game #59941975132:  Hold'em No Limit ($0.10/$0.25) - 2009/07/01 1:52:06 ET
Table 'VQNfcI8vTBCTvRfd3veTLQ' 6-max Seat #1 is the button
Seat 1: QiL+lEgEWwy21jk/ltaRLg ($13.15 in chips) 
Seat 2: 79ID/ub1Pt/mDpCprVmOoA ($31.60 in chips) 
Seat 3: LtASJ9OlkqGrrUKGQlpGAw ($11 in chips) 
Seat 4: QIWnfLSqfMcoFfdDe5LZPg ($41.05 in chips) 
Seat 5: gX2vbKwS/8zZPENAWB7hxQ ($25.25 in chips) 
Seat 6: LJI7A1YgDM7hgh7o56+ReQ ($27.35 in chips) 
79ID/ub1Pt/mDpCprVmOoA: posts small blind $0.10
LtASJ9OlkqGrrUKGQlpGAw: posts big blind $0.25
*** HOLE CARDS ***
QIWnfLSqfMcoFfdDe5LZPg: calls $0.25
gX2vbKwS/8zZPENAWB7hxQ: calls $0.25
LJI7A1YgDM7hgh7o56+ReQ: raises $1 to $1.25
QiL+lEgEWwy21jk/ltaRLg: folds 
79ID/ub1Pt/mDpCprVmOoA: folds 
LtASJ9OlkqGrrUKGQlpGAw: folds 
QIWnfLSqfMcoFfdDe5LZPg: calls $1
gX2vbKwS/8zZPENAWB7hxQ: folds 
*** FLOP *** [Jc 2d Ac]
QIWnfLSqfMcoFfdDe5LZPg: checks 
LJI7A1YgDM7hgh7o56+ReQ: bets $2.25
QIWnfLSqfMcoFfdDe5LZPg: raises $2.25 to $4.50
LJI7A1YgDM7hgh7o56+ReQ: calls $2.25
*** TURN *** [Jc 2d Ac] [9d]
QIWnfLSqfMcoFfdDe5LZPg: checks 
LJI7A1YgDM7hgh7o56+ReQ: checks 
*** RIVER *** [Jc 2d Ac 9d] [8d]
QIWnfLSqfMcoFfdDe5LZPg: bets $8
LJI7A1YgDM7hgh7o56+ReQ: folds 
Uncalled bet ($8) returned to QIWnfLSqfMcoFfdDe5LZPg
QIWnfLSqfMcoFfdDe5LZPg collected $11.55 from pot
QIWnfLSqfMcoFfdDe5LZPg: doesn't show hand 
*** SUMMARY ***
Total pot $12.10 | Rake $0.55 
Board [Jc 2d Ac 9d 8d]
Seat 1: QiL+lEgEWwy21jk/ltaRLg (button) folded before Flop (didn't bet)
Seat 2: 79ID/ub1Pt/mDpCprVmOoA (small blind) folded before Flop
Seat 3: LtASJ9OlkqGrrUKGQlpGAw (big blind) folded before Flop
Seat 4: QIWnfLSqfMcoFfdDe5LZPg collected ($11.55)
Seat 5: gX2vbKwS/8zZPENAWB7hxQ folded before Flop
Seat 6: LJI7A1YgDM7hgh7o56+ReQ folded on the River




PokerStars Game #59941975516:  Hold'em No Limit ($0.10/$0.25) - 2009/07/01 1:52:07 ET
Table 'nc6OeGk/wtaWV+6N+kgnZQgZetDqJh6q9A3mLO3ThCsASeat #1 is the button
Seat 1: DihMHaz4WNETH1bPDe13kA ($25 in chips) 
Seat 2: JFIAqU8lCZ0vWwEl4bdGsg ($34.95 in chips) 
Seat 3: jp34e617tIzV8tKIWmfAbA ($34.75 in chips) 
Seat 4: BV+K0Phf5VBHr7aZPKqbUQ ($32.90 in chips) 
Seat 5: SxIIgwXYLkwd6m3wLyPTCw ($25 in chips) 
Seat 6: Mhj3q7cxev+XjXZxEE6/Cw ($25 in chips) 
JFIAqU8lCZ0vWwEl4bdGsg: posts small blind $0.10
jp34e617tIzV8tKIWmfAbA: posts big blind $0.25
*** HOLE CARDS ***
BV+K0Phf5VBHr7aZPKqbUQ: folds 
SxIIgwXYLkwd6m3wLyPTCw: folds 
Mhj3q7cxev+XjXZxEE6/Cw: raises $0.50 to $0.75
DihMHaz4WNETH1bPDe13kA: raises $1.60 to $2.35
JFIAqU8lCZ0vWwEl4bdGsg: folds 
jp34e617tIzV8tKIWmfAbA: folds 
Mhj3q7cxev+XjXZxEE6/Cw: folds 
Uncalled bet ($1.60) returned to DihMHaz4WNETH1bPDe13kA
DihMHaz4WNETH1bPDe13kA collected $1.85 from pot
*** SUMMARY ***
Total pot $1.85 | Rake $0 
Seat 1: DihMHaz4WNETH1bPDe13kA (button) collected ($1.85)
Seat 2: JFIAqU8lCZ0vWwEl4bdGsg (small blind) folded before Flop
Seat 3: jp34e617tIzV8tKIWmfAbA (big blind) folded before Flop
Seat 4: BV+K0Phf5VBHr7aZPKqbUQ folded before Flop (didn't bet)
Seat 5: SxIIgwXYLkwd6m3wLyPTCw folded before Flop (didn't bet)
Seat 6: Mhj3q7cxev+XjXZxEE6/Cw folded before Flop




PokerStars Game #59941975536:  Hold'em No Limit ($0.10/$0.25) - 2009/07/01 1:52:07 ET
Table 'nQC9LRg01NEuKFHF1nrDEw0XPo7K54oZIfG0xlNAcDRw-max Seat #3 is the button
Seat 1: qf+LMbROj8/qY878wkFHbQ ($18.25 in chips) 
Seat 2: ZhV6dUX9NQhT4zf7t+ZLJg ($23.45 in chips) 
Seat 3: 6+g0Lb6vfRDZkElV8ieHyQ ($25.60 in chips) 
Seat 4: u3Ol7kv1LmvszuHNm9rc6w ($25.35 in chips) 
Seat 5: kG34n23qFQA3nzdOJTQ1dA ($27.95 in chips) 
Seat 6: xQVFeVUDopz+akuEo2wXpQ ($52.40 in chips) 
u3Ol7kv1LmvszuHNm9rc6w: posts small blind $0.10
kG34n23qFQA3nzdOJTQ1dA: posts big blind $0.25
*** HOLE CARDS ***
xQVFeVUDopz+akuEo2wXpQ: folds 
qf+LMbROj8/qY878wkFHbQ: folds 
ZhV6dUX9NQhT4zf7t+ZLJg: raises $0.25 to $0.50
6+g0Lb6vfRDZkElV8ieHyQ: folds 
u3Ol7kv1LmvszuHNm9rc6w: folds 
kG34n23qFQA3nzdOJTQ1dA: folds 
Uncalled bet ($0.25) returned to ZhV6dUX9NQhT4zf7t+ZLJg
ZhV6dUX9NQhT4zf7t+ZLJg collected $0.60 from pot
*** SUMMARY ***
Total pot $0.60 | Rake $0 
Seat 1: qf+LMbROj8/qY878wkFHbQ folded before Flop (didn't bet)
Seat 2: ZhV6dUX9NQhT4zf7t+ZLJg collected ($0.60)
Seat 3: 6+g0Lb6vfRDZkElV8ieHyQ (button) folded before Flop (didn't bet)
Seat 4: u3Ol7kv1LmvszuHNm9rc6w (small blind) folded before Flop
Seat 5: kG34n23qFQA3nzdOJTQ1dA (big blind) folded before Flop
Seat 6: xQVFeVUDopz+akuEo2wXpQ folded before Flop (didn't bet)




PokerStars Game #59941975348:  Hold'em No Limit ($0.10/$0.25) - 2009/07/01 1:52:07 ET
Table 'aaXqTKUnxrX9DYXtxhWXxA' 6-max Seat #4 is the button
Seat 1: aSrj4lVmn2owyQ1RbbOqxQ ($29.60 in chips) 
Seat 2: DE9hRlt14g+JdsRQ4wT7hg ($32.75 in chips) 
Seat 3: uUXdcVMNa05rfbntdvplfw ($7.75 in chips) 
Seat 4: 48oT5xFI+5CHUJlfoGrE4w ($7.30 in chips) 
Seat 5: kyRaCIljYA6l33lSKQfNsg ($23.60 in chips) 
Seat 6: 1lxYIAoJdZwAbzIkzWmSkw ($5.80 in chips) 
kyRaCIljYA6l33lSKQfNsg: posts small blind $0.10
1lxYIAoJdZwAbzIkzWmSkw: posts big blind $0.25
*** HOLE CARDS ***
aSrj4lVmn2owyQ1RbbOqxQ: raises $0.50 to $0.75
DE9hRlt14g+JdsRQ4wT7hg: folds 
uUXdcVMNa05rfbntdvplfw: folds 
48oT5xFI+5CHUJlfoGrE4w: folds 
kyRaCIljYA6l33lSKQfNsg: folds 
1lxYIAoJdZwAbzIkzWmSkw: calls $0.50
*** FLOP *** [Td 3d 7s]
1lxYIAoJdZwAbzIkzWmSkw: checks 
aSrj4lVmn2owyQ1RbbOqxQ: checks 
*** TURN *** [Td 3d 7s] [9c]
1lxYIAoJdZwAbzIkzWmSkw: bets $0.75
aSrj4lVmn2owyQ1RbbOqxQ: folds 
Uncalled bet ($0.75) returned to 1lxYIAoJdZwAbzIkzWmSkw
1lxYIAoJdZwAbzIkzWmSkw collected $1.55 from pot
*** SUMMARY ***
Total pot $1.60 | Rake $0.05 
Board [Td 3d 7s 9c]
Seat 1: aSrj4lVmn2owyQ1RbbOqxQ folded on the Turn
Seat 2: DE9hRlt14g+JdsRQ4wT7hg folded before Flop (didn't bet)
Seat 3: uUXdcVMNa05rfbntdvplfw folded before Flop (didn't bet)
Seat 4: 48oT5xFI+5CHUJlfoGrE4w (button) folded before Flop (didn't bet)
Seat 5: kyRaCIljYA6l33lSKQfNsg (small blind) folded before Flop
Seat 6: 1lxYIAoJdZwAbzIkzWmSkw (big blind) collected ($1.55)




PokerStars Game #59941975780:  Hold'em No Limit ($0.10/$0.25) - 2009/07/01 1:52:07 ET
Table 'MiquQrQZJJq9ZtgRIp9HFQ' 6-max Seat #1 is the button
Seat 1: c3J/KYZ4cNsUEuz8v57I5A ($25.05 in chips) 
Seat 2: 2+6voGl1T1DO63JePptI3g ($24.95 in chips) 
Seat 3: 9h7TNZ1TDGRUJXA6rI+ZTw ($10.35 in chips) 
Seat 4: wAKC8C/zN0c8V5v13dm9mA ($51.30 in chips) 
Seat 5: iyZxqznXjv3vtvOJymkoLQ ($26.40 in chips) 
Seat 6: GbCVUNssQ7mqsPWr7J4d3w ($4.50 in chips) 
2+6voGl1T1DO63JePptI3g: posts small blind $0.10
9h7TNZ1TDGRUJXA6rI+ZTw: posts big blind $0.25
*** HOLE CARDS ***
wAKC8C/zN0c8V5v13dm9mA: folds 
iyZxqznXjv3vtvOJymkoLQ: folds 
GbCVUNssQ7mqsPWr7J4d3w: folds 
c3J/KYZ4cNsUEuz8v57I5A: raises $0.50 to $0.75
2+6voGl1T1DO63JePptI3g: folds 
9h7TNZ1TDGRUJXA6rI+ZTw: folds 
Uncalled bet ($0.50) returned to c3J/KYZ4cNsUEuz8v57I5A
c3J/KYZ4cNsUEuz8v57I5A collected $0.60 from pot
c3J/KYZ4cNsUEuz8v57I5A: doesn't show hand 
*** SUMMARY ***
Total pot $0.60 | Rake $0 
Seat 1: c3J/KYZ4cNsUEuz8v57I5A (button) collected ($0.60)
Seat 2: 2+6voGl1T1DO63JePptI3g (small blind) folded before Flop
Seat 3: 9h7TNZ1TDGRUJXA6rI+ZTw (big blind) folded before Flop
Seat 4: wAKC8C/zN0c8V5v13dm9mA folded before Flop (didn't bet)
Seat 5: iyZxqznXjv3vtvOJymkoLQ folded before Flop (didn't bet)
Seat 6: GbCVUNssQ7mqsPWr7J4d3w folded before Flop (didn't bet)




PokerStars Game #59941975810:  Hold'em No Limit ($0.10/$0.25) - 2009/07/01 1:52:07 ET
Table 'WY+lMaAoIdBZmwk27/RJCA' 6-max Seat #6 is the button
Seat 1: zHHLkD2sRljslKKeQv/ZQw ($31.80 in chips) 
Seat 2: NhUN/JpAprdJeamFBgJH1w ($28.25 in chips) 
Seat 3: QqiZLFrN8iOUT/GHw7ztOA ($26.60 in chips) 
Seat 4: 0av6tRNdi0Ui4f15L7gsVg ($23.15 in chips) 
Seat 5: vqWjZmdQu/Hxw96/IJTWdQ ($27.95 in chips) 
Seat 6: cWc85bEzdRzpUMhRKm8pwQ ($25 in chips) 
zHHLkD2sRljslKKeQv/ZQw: posts small blind $0.10
NhUN/JpAprdJeamFBgJH1w: posts big blind $0.25
*** HOLE CARDS ***
QqiZLFrN8iOUT/GHw7ztOA: folds 
0av6tRNdi0Ui4f15L7gsVg: folds 
vqWjZmdQu/Hxw96/IJTWdQ: folds 
cWc85bEzdRzpUMhRKm8pwQ: raises $0.75 to $1
zHHLkD2sRljslKKeQv/ZQw: calls $0.90
NhUN/JpAprdJeamFBgJH1w: folds 
*** FLOP *** [6h 8h Ts]
zHHLkD2sRljslKKeQv/ZQw: bets $0.75
cWc85bEzdRzpUMhRKm8pwQ: folds 
Uncalled bet ($0.75) returned to zHHLkD2sRljslKKeQv/ZQw
zHHLkD2sRljslKKeQv/ZQw collected $2.15 from pot
*** SUMMARY ***
Total pot $2.25 | Rake $0.10 
Board [6h 8h Ts]
Seat 1: zHHLkD2sRljslKKeQv/ZQw (small blind) collected ($2.15)
Seat 2: NhUN/JpAprdJeamFBgJH1w (big blind) folded before Flop
Seat 3: QqiZLFrN8iOUT/GHw7ztOA folded before Flop (didn't bet)
Seat 4: 0av6tRNdi0Ui4f15L7gsVg folded before Flop (didn't bet)
Seat 5: vqWjZmdQu/Hxw96/IJTWdQ folded before Flop (didn't bet)
Seat 6: cWc85bEzdRzpUMhRKm8pwQ (button) folded on the Flop




PokerStars Game #59941975508:  Hold'em No Limit ($0.10/$0.25) - 2009/07/01 1:52:07 ET
Table '3lS+sU5k6mwJCS2nFMmQ6Q' 9-max Seat #7 is the button
Seat 1: VWUWpMLMj/Q1jRVpF7Aohw ($13.55 in chips) 
Seat 2: PdIasPkzm2sqZnN41ZRXOg ($5.75 in chips) 
Seat 4: GeMoapCKDLc4ajT0Uk9ZQw ($9.65 in chips) 
Seat 6: hJ4uYjNmSZdjrKA8cjZqCA ($35.15 in chips) 
Seat 7: Th3FldXKQW6hWVVPahaoOQ ($31.20 in chips) 
Seat 8: 9lvO/qyU+xrU95Teu1fv0g ($4.75 in chips) 
Seat 9: 4awUyiDYTgylQKXZ9faBVA ($61 in chips) 
9lvO/qyU+xrU95Teu1fv0g: posts small blind $0.10
4awUyiDYTgylQKXZ9faBVA: posts big blind $0.25
*** HOLE CARDS ***
VWUWpMLMj/Q1jRVpF7Aohw: folds 
PdIasPkzm2sqZnN41ZRXOg: folds 
1DXccE2UUK5DIRVGlOKnTA leaves the table
GeMoapCKDLc4ajT0Uk9ZQw: folds 
hJ4uYjNmSZdjrKA8cjZqCA: folds 
Th3FldXKQW6hWVVPahaoOQ: folds 
9lvO/qyU+xrU95Teu1fv0g: folds 
Uncalled bet ($0.15) returned to 4awUyiDYTgylQKXZ9faBVA
4awUyiDYTgylQKXZ9faBVA collected $0.20 from pot
4awUyiDYTgylQKXZ9faBVA: doesn't show hand 
*** SUMMARY ***
Total pot $0.20 | Rake $0 
Seat 1: VWUWpMLMj/Q1jRVpF7Aohw folded before Flop (didn't bet)
Seat 2: PdIasPkzm2sqZnN41ZRXOg folded before Flop (didn't bet)
Seat 4: GeMoapCKDLc4ajT0Uk9ZQw folded before Flop (didn't bet)
Seat 6: hJ4uYjNmSZdjrKA8cjZqCA folded before Flop (didn't bet)
Seat 7: Th3FldXKQW6hWVVPahaoOQ (button) folded before Flop (didn't bet)
Seat 8: 9lvO/qyU+xrU95Teu1fv0g (small blind) folded before Flop
Seat 9: 4awUyiDYTgylQKXZ9faBVA (big blind) collected ($0.20)




PokerStars Game #59941975596:  Hold'em No Limit ($0.10/$0.25) - 2009/07/01 1:52:07 ET
Table '9iHhO6FyZVM8XpSc23TIgg' 6-max Seat #3 is the button
Seat 2: bJFzs6QmEEnz4miMfSDtcg ($32.75 in chips) 
Seat 3: TSmua8tGK3sTbwi0ynrW9Q ($28.85 in chips) 
Seat 4: cfJccEfyn6IkquPN08hFsA ($25.75 in chips) 
Seat 5: OMGl+YMGogf2JWIRfT2/Yg ($9.75 in chips) 
Seat 6: iyZxqznXjv3vtvOJymkoLQ ($33.85 in chips) 
cfJccEfyn6IkquPN08hFsA: posts small blind $0.10
OMGl+YMGogf2JWIRfT2/Yg: posts big blind $0.25
*** HOLE CARDS ***
iyZxqznXjv3vtvOJymkoLQ: folds 
bJFzs6QmEEnz4miMfSDtcg: calls $0.25
TSmua8tGK3sTbwi0ynrW9Q: raises $0.75 to $1
cfJccEfyn6IkquPN08hFsA: folds 
OMGl+YMGogf2JWIRfT2/Yg: folds 
bJFzs6QmEEnz4miMfSDtcg: calls $0.75
*** FLOP *** [Qs 6d 5s]
bJFzs6QmEEnz4miMfSDtcg: checks 
wvIIdlbCgePONQwXjx9xzQ joins the table at seat #1 
TSmua8tGK3sTbwi0ynrW9Q: bets $1.50
bJFzs6QmEEnz4miMfSDtcg: calls $1.50
*** TURN *** [Qs 6d 5s] [2s]
bJFzs6QmEEnz4miMfSDtcg: checks 
TSmua8tGK3sTbwi0ynrW9Q: bets $2.75
bJFzs6QmEEnz4miMfSDtcg: calls $2.75
*** RIVER *** [Qs 6d 5s 2s] [Ks]
bJFzs6QmEEnz4miMfSDtcg: checks 
TSmua8tGK3sTbwi0ynrW9Q: bets $7.25
bJFzs6QmEEnz4miMfSDtcg: calls $7.25
*** SHOW DOWN ***
TSmua8tGK3sTbwi0ynrW9Q: shows [7s 6h] (a flush, King high)
bJFzs6QmEEnz4miMfSDtcg: mucks hand 
TSmua8tGK3sTbwi0ynrW9Q collected $24.15 from pot
*** SUMMARY ***
Total pot $25.35 | Rake $1.20 
Board [Qs 6d 5s 2s Ks]
Seat 2: bJFzs6QmEEnz4miMfSDtcg mucked
Seat 3: TSmua8tGK3sTbwi0ynrW9Q (button) showed [7s 6h] and won ($24.15) with a flush, King high
Seat 4: cfJccEfyn6IkquPN08hFsA (small blind) folded before Flop
Seat 5: OMGl+YMGogf2JWIRfT2/Yg (big blind) folded before Flop
Seat 6: iyZxqznXjv3vtvOJymkoLQ folded before Flop (didn't bet)




PokerStars Game #59941976114:  Hold'em No Limit ($0.10/$0.25) - 2009/07/01 1:52:08 ET
Table '63uh7ZsO7Tnt+E8b/2bu3A' 6-max Seat #1 is the button
Seat 1: 0av6tRNdi0Ui4f15L7gsVg ($32.55 in chips) 
Seat 2: SFmT9ZsVopnukjvAzrxTRg ($25 in chips) 
Seat 3: yVP7GLZBzx47OPi6jzUxMw ($3.60 in chips) 
Seat 4: rnpAao581IcvQglpkpnkoQ ($12.50 in chips) 
Seat 6: qGHGf/553gQnDoklMRe3tg ($26.55 in chips) 
SFmT9ZsVopnukjvAzrxTRg: posts small blind $0.10
yVP7GLZBzx47OPi6jzUxMw: posts big blind $0.25
*** HOLE CARDS ***
rnpAao581IcvQglpkpnkoQ: folds 
qGHGf/553gQnDoklMRe3tg: raises $0.75 to $1
0av6tRNdi0Ui4f15L7gsVg: calls $1
SFmT9ZsVopnukjvAzrxTRg: folds 
yVP7GLZBzx47OPi6jzUxMw: folds 
*** FLOP *** [7h 8c 5d]
qGHGf/553gQnDoklMRe3tg: bets $1.50
0av6tRNdi0Ui4f15L7gsVg: folds 
Uncalled bet ($1.50) returned to qGHGf/553gQnDoklMRe3tg
qGHGf/553gQnDoklMRe3tg collected $2.25 from pot
*** SUMMARY ***
Total pot $2.35 | Rake $0.10 
Board [7h 8c 5d]
Seat 1: 0av6tRNdi0Ui4f15L7gsVg (button) folded on the Flop
Seat 2: SFmT9ZsVopnukjvAzrxTRg (small blind) folded before Flop
Seat 3: yVP7GLZBzx47OPi6jzUxMw (big blind) folded before Flop
Seat 4: rnpAao581IcvQglpkpnkoQ folded before Flop (didn't bet)
Seat 6: qGHGf/553gQnDoklMRe3tg collected ($2.25)




PokerStars Game #59941976090:  Hold'em No Limit ($0.10/$0.25) - 2009/07/01 1:52:08 ET
Table 'YYMg5qzxK1m9eGRo4SbxtQ' 9-max Seat #8 is the button
Seat 1: 3PmVnC/15cl4oyI1TKIt4g ($5 in chips) 
Seat 2: f/H6PsHRl4W1JyNsEDvPtg ($14.60 in chips) 
Seat 3: eK8qa6EPcH2zhtbmWSvc9g ($25.25 in chips) 
Seat 4: ROxrieegd9WYtWcUKJAlbg ($6.75 in chips) 
Seat 5: 4awUyiDYTgylQKXZ9faBVA ($25 in chips) 
Seat 6: S5VeQLgBIiHrfs9AB2vBwA ($8.15 in chips) 
Seat 7: sUVgUtgbfVx6JpvApozwhQ ($7.45 in chips) 
Seat 8: xoBFd/5k+L/pFn9VW1VyWg ($13.60 in chips) 
Seat 9: +sbyWwIcFp9kP0bDtMegfQ ($31.35 in chips) 
+sbyWwIcFp9kP0bDtMegfQ: posts small blind $0.10
3PmVnC/15cl4oyI1TKIt4g: posts big blind $0.25
*** HOLE CARDS ***
f/H6PsHRl4W1JyNsEDvPtg: folds 
eK8qa6EPcH2zhtbmWSvc9g: folds 
ROxrieegd9WYtWcUKJAlbg: calls $0.25
f/H6PsHRl4W1JyNsEDvPtg leaves the table
4awUyiDYTgylQKXZ9faBVA: folds 
S5VeQLgBIiHrfs9AB2vBwA: folds 
clJsV3v77RS07bDKY+705w joins the table at seat #2 
sUVgUtgbfVx6JpvApozwhQ: folds 
xoBFd/5k+L/pFn9VW1VyWg: folds 
+sbyWwIcFp9kP0bDtMegfQ: calls $0.15
3PmVnC/15cl4oyI1TKIt4g: checks 
*** FLOP *** [Ah Td 6s]
+sbyWwIcFp9kP0bDtMegfQ: checks 
3PmVnC/15cl4oyI1TKIt4g: checks 
ROxrieegd9WYtWcUKJAlbg: checks 
*** TURN *** [Ah Td 6s] [4h]
+sbyWwIcFp9kP0bDtMegfQ: checks 
3PmVnC/15cl4oyI1TKIt4g: checks 
ROxrieegd9WYtWcUKJAlbg: checks 
*** RIVER *** [Ah Td 6s 4h] [2d]
xoBFd/5k+L/pFn9VW1VyWg is sitting out
+sbyWwIcFp9kP0bDtMegfQ: checks 
3PmVnC/15cl4oyI1TKIt4g: bets $0.50
ROxrieegd9WYtWcUKJAlbg: folds 
+sbyWwIcFp9kP0bDtMegfQ: folds 
Uncalled bet ($0.50) returned to 3PmVnC/15cl4oyI1TKIt4g
3PmVnC/15cl4oyI1TKIt4g collected $0.75 from pot
3PmVnC/15cl4oyI1TKIt4g: doesn't show hand 
*** SUMMARY ***
Total pot $0.75 | Rake $0 
Board [Ah Td 6s 4h 2d]
Seat 1: 3PmVnC/15cl4oyI1TKIt4g (big blind) collected ($0.75)
Seat 2: f/H6PsHRl4W1JyNsEDvPtg folded before Flop (didn't bet)
Seat 3: eK8qa6EPcH2zhtbmWSvc9g folded before Flop (didn't bet)
Seat 4: ROxrieegd9WYtWcUKJAlbg folded on the River
Seat 5: 4awUyiDYTgylQKXZ9faBVA folded before Flop (didn't bet)
Seat 6: S5VeQLgBIiHrfs9AB2vBwA folded before Flop (didn't bet)
Seat 7: sUVgUtgbfVx6JpvApozwhQ folded before Flop (didn't bet)
Seat 8: xoBFd/5k+L/pFn9VW1VyWg (button) folded before Flop (didn't bet)
Seat 9: +sbyWwIcFp9kP0bDtMegfQ (small blind) folded on the River




PokerStars Game #59941975962:  Hold'em No Limit ($0.10/$0.25) - 2009/07/01 1:52:08 ET
Table '84TjTrgbsYZladOc4PWf4Q' 6-max Seat #3 is the button
Seat 1: /kW0t5kKllzd8HO2uEapHQ ($17.20 in chips) 
Seat 2: RpaEX9P7BCvyfPRLiRNg0A ($47.35 in chips) 
Seat 3: Ar4vsUIUfJ7gbYh1c1m59g ($10.85 in chips) 
Seat 4: SxIIgwXYLkwd6m3wLyPTCw ($38.20 in chips) 
Seat 5: cezpHJ8FB07dj0xG+LhOvw ($29.15 in chips) 
Seat 6: wCUaomJ6Nq5zomVGdUHP+w ($7.30 in chips) 
SxIIgwXYLkwd6m3wLyPTCw: posts small blind $0.10
cezpHJ8FB07dj0xG+LhOvw: posts big blind $0.25
*** HOLE CARDS ***
wCUaomJ6Nq5zomVGdUHP+w: calls $0.25
/kW0t5kKllzd8HO2uEapHQ: raises $0.25 to $0.50
RpaEX9P7BCvyfPRLiRNg0A: calls $0.50
Ar4vsUIUfJ7gbYh1c1m59g: folds 
SxIIgwXYLkwd6m3wLyPTCw: folds 
cezpHJ8FB07dj0xG+LhOvw: calls $0.25
wCUaomJ6Nq5zomVGdUHP+w: calls $0.25
*** FLOP *** [Th 5c Kh]
cezpHJ8FB07dj0xG+LhOvw: checks 
wCUaomJ6Nq5zomVGdUHP+w: bets $1.25
/kW0t5kKllzd8HO2uEapHQ: folds 
RpaEX9P7BCvyfPRLiRNg0A: folds 
cezpHJ8FB07dj0xG+LhOvw: folds 
Uncalled bet ($1.25) returned to wCUaomJ6Nq5zomVGdUHP+w
wCUaomJ6Nq5zomVGdUHP+w collected $2 from pot
wCUaomJ6Nq5zomVGdUHP+w: doesn't show hand 
*** SUMMARY ***
Total pot $2.10 | Rake $0.10 
Board [Th 5c Kh]
Seat 1: /kW0t5kKllzd8HO2uEapHQ folded on the Flop
Seat 2: RpaEX9P7BCvyfPRLiRNg0A folded on the Flop
Seat 3: Ar4vsUIUfJ7gbYh1c1m59g (button) folded before Flop (didn't bet)
Seat 4: SxIIgwXYLkwd6m3wLyPTCw (small blind) folded before Flop
Seat 5: cezpHJ8FB07dj0xG+LhOvw (big blind) folded on the Flop
Seat 6: wCUaomJ6Nq5zomVGdUHP+w collected ($2)




PokerStars Game #59941976116:  Hold'em No Limit ($0.10/$0.25) - 2009/07/01 1:52:08 ET
Table '8PD/MTROSMd6Y8mZeykbpg' 6-max Seat #5 is the button
Seat 1: fxNpaToxECtD2Goelmg9vA ($27.25 in chips) 
Seat 2: 4TM16KVgEiQpLi4bVVWbVQ ($31.60 in chips) 
Seat 3: vqWjZmdQu/Hxw96/IJTWdQ ($25 in chips) 
Seat 4: DFi/Lzkjsfv8QswS80JX9Q ($49.20 in chips) 
Seat 5: z3tQwy28dp5FykDJC/wzQw ($26.20 in chips) 
Seat 6: trN/oHqTTbPw5MNuKrOpLw ($25 in chips) 
trN/oHqTTbPw5MNuKrOpLw: posts small blind $0.10
fxNpaToxECtD2Goelmg9vA: posts big blind $0.25
*** HOLE CARDS ***
4TM16KVgEiQpLi4bVVWbVQ: raises $0.75 to $1
vqWjZmdQu/Hxw96/IJTWdQ: folds 
DFi/Lzkjsfv8QswS80JX9Q: folds 
z3tQwy28dp5FykDJC/wzQw: folds 
trN/oHqTTbPw5MNuKrOpLw: folds 
fxNpaToxECtD2Goelmg9vA: folds 
Uncalled bet ($0.75) returned to 4TM16KVgEiQpLi4bVVWbVQ
4TM16KVgEiQpLi4bVVWbVQ collected $0.60 from pot
*** SUMMARY ***
Total pot $0.60 | Rake $0 
Seat 1: fxNpaToxECtD2Goelmg9vA (big blind) folded before Flop
Seat 2: 4TM16KVgEiQpLi4bVVWbVQ collected ($0.60)
Seat 3: vqWjZmdQu/Hxw96/IJTWdQ folded before Flop (didn't bet)
Seat 4: DFi/Lzkjsfv8QswS80JX9Q folded before Flop (didn't bet)
Seat 5: z3tQwy28dp5FykDJC/wzQw (button) folded before Flop (didn't bet)
Seat 6: trN/oHqTTbPw5MNuKrOpLw (small blind) folded before Flop




PokerStars Game #59941976194:  Hold'em No Limit ($0.10/$0.25) - 2009/07/01 1:52:08 ET
Table 'Xi38lWH8L2JHRAsKYVX8Qg' 6-max Seat #1 is the button
Seat 1: shP7DFAtX7gXcgMJX/OmRQ ($25 in chips) 
Seat 2: VOmI0x4dDPnTESZd5B4d1Q ($8.15 in chips) 
Seat 3: 6DwBRH+xZ12AAZmeAg+aXw ($31.20 in chips) 
Seat 4: kG34n23qFQA3nzdOJTQ1dA ($24.05 in chips) 
Seat 5: 79ID/ub1Pt/mDpCprVmOoA ($76.15 in chips) 
Seat 6: kyRaCIljYA6l33lSKQfNsg ($30.10 in chips) 
VOmI0x4dDPnTESZd5B4d1Q: posts small blind $0.10
6DwBRH+xZ12AAZmeAg+aXw: posts big blind $0.25
*** HOLE CARDS ***
kG34n23qFQA3nzdOJTQ1dA: calls $0.25
79ID/ub1Pt/mDpCprVmOoA: folds 
kyRaCIljYA6l33lSKQfNsg: folds 
shP7DFAtX7gXcgMJX/OmRQ: folds 
VOmI0x4dDPnTESZd5B4d1Q: calls $0.15
6DwBRH+xZ12AAZmeAg+aXw: checks 
*** FLOP *** [9d 6s Tc]
VOmI0x4dDPnTESZd5B4d1Q: checks 
6DwBRH+xZ12AAZmeAg+aXw: checks 
kG34n23qFQA3nzdOJTQ1dA: bets $0.75
VOmI0x4dDPnTESZd5B4d1Q: folds 
6DwBRH+xZ12AAZmeAg+aXw: folds 
Uncalled bet ($0.75) returned to kG34n23qFQA3nzdOJTQ1dA
kG34n23qFQA3nzdOJTQ1dA collected $0.75 from pot
*** SUMMARY ***
Total pot $0.75 | Rake $0 
Board [9d 6s Tc]
Seat 1: shP7DFAtX7gXcgMJX/OmRQ (button) folded before Flop (didn't bet)
Seat 2: VOmI0x4dDPnTESZd5B4d1Q (small blind) folded on the Flop
Seat 3: 6DwBRH+xZ12AAZmeAg+aXw (big blind) folded on the Flop
Seat 4: kG34n23qFQA3nzdOJTQ1dA collected ($0.75)
Seat 5: 79ID/ub1Pt/mDpCprVmOoA folded before Flop (didn't bet)
Seat 6: kyRaCIljYA6l33lSKQfNsg folded before Flop (didn't bet)




PokerStars Game #59941976760:  Hold'em No Limit ($0.10/$0.25) - 2009/07/01 1:52:09 ET
Table '+198VWQSWBhYQOcizzuBkw' 6-max Seat #5 is the button
Seat 1: 34ttqW62uIRrqINCCmLcsw ($18.25 in chips) 
Seat 2: iauW7L/+7qzAuHow7CD75Q ($12.30 in chips) 
Seat 3: vw7gefupgmOJJN8lUemdWg ($22.25 in chips) 
Seat 4: TgDsTeCdLQt8kWbL00ByRA ($14.40 in chips) 
Seat 5: LtASJ9OlkqGrrUKGQlpGAw ($24.65 in chips) 
Seat 6: leEQ84f6wJYu5SB/vj27wg ($14.75 in chips) 
leEQ84f6wJYu5SB/vj27wg: posts small blind $0.10
34ttqW62uIRrqINCCmLcsw: posts big blind $0.25
*** HOLE CARDS ***
iauW7L/+7qzAuHow7CD75Q: folds 
vw7gefupgmOJJN8lUemdWg: calls $0.25
TgDsTeCdLQt8kWbL00ByRA: raises $0.75 to $1
LtASJ9OlkqGrrUKGQlpGAw: folds 
leEQ84f6wJYu5SB/vj27wg: folds 
34ttqW62uIRrqINCCmLcsw: calls $0.75
vw7gefupgmOJJN8lUemdWg: calls $0.75
*** FLOP *** [3h 6s Jd]
34ttqW62uIRrqINCCmLcsw: checks 
vw7gefupgmOJJN8lUemdWg: checks 
TgDsTeCdLQt8kWbL00ByRA: checks 
*** TURN *** [3h 6s Jd] [9c]
34ttqW62uIRrqINCCmLcsw: checks 
vw7gefupgmOJJN8lUemdWg: bets $2.50
TgDsTeCdLQt8kWbL00ByRA: calls $2.50
34ttqW62uIRrqINCCmLcsw: raises $2.50 to $5
vw7gefupgmOJJN8lUemdWg: calls $2.50
TgDsTeCdLQt8kWbL00ByRA: raises $8.40 to $13.40 and is all-in
34ttqW62uIRrqINCCmLcsw: raises $3.85 to $17.25 and is all-in
vw7gefupgmOJJN8lUemdWg: folds 
Uncalled bet ($3.85) returned to 34ttqW62uIRrqINCCmLcsw
*** RIVER *** [3h 6s Jd 9c] [Qs]
*** SHOW DOWN ***
34ttqW62uIRrqINCCmLcsw: shows [6c 9d] (two pair, Nines and Sixes)
TgDsTeCdLQt8kWbL00ByRA: shows [Js Jc] (three of a kind, Jacks)
TgDsTeCdLQt8kWbL00ByRA collected $33.20 from pot
*** SUMMARY ***
Total pot $34.90 | Rake $1.70 
Board [3h 6s Jd 9c Qs]
Seat 1: 34ttqW62uIRrqINCCmLcsw (big blind) showed [6c 9d] and lost with two pair, Nines and Sixes
Seat 2: iauW7L/+7qzAuHow7CD75Q folded before Flop (didn't bet)
Seat 3: vw7gefupgmOJJN8lUemdWg folded on the Turn
Seat 4: TgDsTeCdLQt8kWbL00ByRA showed [Js Jc] and won ($33.20) with three of a kind, Jacks
Seat 5: LtASJ9OlkqGrrUKGQlpGAw (button) folded before Flop (didn't bet)
Seat 6: leEQ84f6wJYu5SB/vj27wg (small blind) folded before Flop




PokerStars Game #59941976438:  Hold'em No Limit ($0.10/$0.25) - 2009/07/01 1:52:09 ET
Table 'xmJKTGBeWCwutccj3YfupQ' 6-max Seat #6 is the button
Seat 1: sVbkVl4OznxBCfi66UB9vw ($40.65 in chips) 
Seat 2: QqiZLFrN8iOUT/GHw7ztOA ($24.30 in chips) 
Seat 3: T5wrp/d5jarm+SxNy8OQAg ($17.45 in chips) 
Seat 4: uWjhTVMpuIroxXcmD3Okug ($30.30 in chips) 
Seat 5: DE9hRlt14g+JdsRQ4wT7hg ($38.70 in chips) 
Seat 6: 9bpVv1/Qh9IYtXuCtl5VtQ ($8.95 in chips) 
sVbkVl4OznxBCfi66UB9vw: posts small blind $0.10
QqiZLFrN8iOUT/GHw7ztOA: posts big blind $0.25
*** HOLE CARDS ***
T5wrp/d5jarm+SxNy8OQAg: folds 
uWjhTVMpuIroxXcmD3Okug said, "? hhmmmmm"
T5wrp/d5jarm+SxNy8OQAg said, "wow"
uWjhTVMpuIroxXcmD3Okug: folds 
T5wrp/d5jarm+SxNy8OQAg said, "sick"
DE9hRlt14g+JdsRQ4wT7hg: raises $0.75 to $1
9bpVv1/Qh9IYtXuCtl5VtQ: folds 
sVbkVl4OznxBCfi66UB9vw: folds 
QqiZLFrN8iOUT/GHw7ztOA: folds 
Uncalled bet ($0.75) returned to DE9hRlt14g+JdsRQ4wT7hg
DE9hRlt14g+JdsRQ4wT7hg collected $0.60 from pot
DE9hRlt14g+JdsRQ4wT7hg: doesn't show hand 
*** SUMMARY ***
Total pot $0.60 | Rake $0 
Seat 1: sVbkVl4OznxBCfi66UB9vw (small blind) folded before Flop
Seat 2: QqiZLFrN8iOUT/GHw7ztOA (big blind) folded before Flop
Seat 3: T5wrp/d5jarm+SxNy8OQAg folded before Flop (didn't bet)
Seat 4: uWjhTVMpuIroxXcmD3Okug folded before Flop (didn't bet)
Seat 5: DE9hRlt14g+JdsRQ4wT7hg collected ($0.60)
Seat 6: 9bpVv1/Qh9IYtXuCtl5VtQ (button) folded before Flop (didn't bet)




PokerStars Game #59941976390:  Hold'em No Limit ($0.10/$0.25) - 2009/07/01 1:52:09 ET
Table 'nXVbUw6/HYwA6x21+IZ3XQ' 9-max Seat #8 is the button
Seat 1: zDrucyjVn5aeekNEc3cJrA ($17.35 in chips) 
Seat 2: 9lvO/qyU+xrU95Teu1fv0g ($10.25 in chips) 
Seat 3: MB0wa15P+9QHcBApEdgQFw ($11.70 in chips) 
Seat 4: SpiiQQAzy4MUgV3I5W8giw ($24.65 in chips) 
Seat 5: M/9j4wkHH9i1JM51vgi1VA ($31.60 in chips) 
Seat 6: ljemhp25Zg+nlA9DLCIiUw ($26.85 in chips) 
Seat 7: ShCS62CJp4MKfKLKvGKQbA ($11.85 in chips) 
Seat 8: dfNim92Z6XK1/h5SFW5vDg ($25 in chips) 
Seat 9: OTCjTlu92MEBtX/i9Gm7yA ($9.35 in chips) 
OTCjTlu92MEBtX/i9Gm7yA: posts small blind $0.10
zDrucyjVn5aeekNEc3cJrA: posts big blind $0.25
*** HOLE CARDS ***
9lvO/qyU+xrU95Teu1fv0g: folds 
MB0wa15P+9QHcBApEdgQFw: calls $0.25
SpiiQQAzy4MUgV3I5W8giw: folds 
M/9j4wkHH9i1JM51vgi1VA: calls $0.25
ljemhp25Zg+nlA9DLCIiUw: folds 
ShCS62CJp4MKfKLKvGKQbA: folds 
dfNim92Z6XK1/h5SFW5vDg: folds 
OTCjTlu92MEBtX/i9Gm7yA: calls $0.15
zDrucyjVn5aeekNEc3cJrA: checks 
*** FLOP *** [7s 8d Js]
OTCjTlu92MEBtX/i9Gm7yA: checks 
zDrucyjVn5aeekNEc3cJrA: checks 
MB0wa15P+9QHcBApEdgQFw: bets $0.50
M/9j4wkHH9i1JM51vgi1VA: folds 
OTCjTlu92MEBtX/i9Gm7yA: folds 
zDrucyjVn5aeekNEc3cJrA: folds 
Uncalled bet ($0.50) returned to MB0wa15P+9QHcBApEdgQFw
MB0wa15P+9QHcBApEdgQFw collected $0.95 from pot
MB0wa15P+9QHcBApEdgQFw: doesn't show hand 
*** SUMMARY ***
Total pot $1 | Rake $0.05 
Board [7s 8d Js]
Seat 1: zDrucyjVn5aeekNEc3cJrA (big blind) folded on the Flop
Seat 2: 9lvO/qyU+xrU95Teu1fv0g folded before Flop (didn't bet)
Seat 3: MB0wa15P+9QHcBApEdgQFw collected ($0.95)
Seat 4: SpiiQQAzy4MUgV3I5W8giw folded before Flop (didn't bet)
Seat 5: M/9j4wkHH9i1JM51vgi1VA folded on the Flop
Seat 6: ljemhp25Zg+nlA9DLCIiUw folded before Flop (didn't bet)
Seat 7: ShCS62CJp4MKfKLKvGKQbA folded before Flop (didn't bet)
Seat 8: dfNim92Z6XK1/h5SFW5vDg (button) folded before Flop (didn't bet)
Seat 9: OTCjTlu92MEBtX/i9Gm7yA (small blind) folded on the Flop




PokerStars Game #59941976566:  Hold'em No Limit ($0.10/$0.25) - 2009/07/01 1:52:09 ET
Table '8Z6T3ssCpo3VV849U4RgBw' 9-max Seat #6 is the button
Seat 1: Z9W7+g1WMhhZDi7DwGbCFA ($6.75 in chips) 
Seat 2: SpiiQQAzy4MUgV3I5W8giw ($19.10 in chips) 
Seat 3: tLcDklc2rBORNfixyRfVfw ($40.65 in chips) 
Seat 4: RCqMONFrSPSArZh2Jsar/w ($15.90 in chips) 
Seat 5: zDrucyjVn5aeekNEc3cJrA ($15.65 in chips) 
Seat 6: 4qA/3Ajg3pP6fqW+IX9/fQ ($4.65 in chips) 
Seat 7: oLa/tXLfSLLB28mcLGrxcg ($24.60 in chips) 
Seat 8: PdIasPkzm2sqZnN41ZRXOg ($5.25 in chips) 
Seat 9: HDDm1BkZtdsRyw2DJdqq6A ($31.10 in chips) 
oLa/tXLfSLLB28mcLGrxcg: posts small blind $0.10
PdIasPkzm2sqZnN41ZRXOg: posts big blind $0.25
*** HOLE CARDS ***
HDDm1BkZtdsRyw2DJdqq6A: raises $0.50 to $0.75
Z9W7+g1WMhhZDi7DwGbCFA: folds 
SpiiQQAzy4MUgV3I5W8giw: folds 
tLcDklc2rBORNfixyRfVfw: calls $0.75
RCqMONFrSPSArZh2Jsar/w: folds 
zDrucyjVn5aeekNEc3cJrA: folds 
4qA/3Ajg3pP6fqW+IX9/fQ: folds 
oLa/tXLfSLLB28mcLGrxcg: folds 
PdIasPkzm2sqZnN41ZRXOg: folds 
*** FLOP *** [Js As Ks]
HDDm1BkZtdsRyw2DJdqq6A: checks 
tLcDklc2rBORNfixyRfVfw: checks 
*** TURN *** [Js As Ks] [9c]
HDDm1BkZtdsRyw2DJdqq6A: bets $0.50
tLcDklc2rBORNfixyRfVfw: folds 
Uncalled bet ($0.50) returned to HDDm1BkZtdsRyw2DJdqq6A
HDDm1BkZtdsRyw2DJdqq6A collected $1.80 from pot
HDDm1BkZtdsRyw2DJdqq6A: doesn't show hand 
*** SUMMARY ***
Total pot $1.85 | Rake $0.05 
Board [Js As Ks 9c]
Seat 1: Z9W7+g1WMhhZDi7DwGbCFA folded before Flop (didn't bet)
Seat 2: SpiiQQAzy4MUgV3I5W8giw folded before Flop (didn't bet)
Seat 3: tLcDklc2rBORNfixyRfVfw folded on the Turn
Seat 4: RCqMONFrSPSArZh2Jsar/w folded before Flop (didn't bet)
Seat 5: zDrucyjVn5aeekNEc3cJrA folded before Flop (didn't bet)
Seat 6: 4qA/3Ajg3pP6fqW+IX9/fQ (button) folded before Flop (didn't bet)
Seat 7: oLa/tXLfSLLB28mcLGrxcg (small blind) folded before Flop
Seat 8: PdIasPkzm2sqZnN41ZRXOg (big blind) folded before Flop
Seat 9: HDDm1BkZtdsRyw2DJdqq6A collected ($1.80)




PokerStars Game #59941976776:  Hold'em No Limit ($0.10/$0.25) - 2009/07/01 1:52:09 ET
Table 'jz4TpuH+ag+0iNe2ZcxckQ' 9-max Seat #5 is the button
Seat 2: clJsV3v77RS07bDKY+705w ($6.10 in chips) 
Seat 3: egvg3mTBBVzMHnJPIQiKcA ($18.50 in chips) 
Seat 4: k+2r6di6GXjNpAdrRkW9bA ($57.80 in chips) 
Seat 5: v1BVHNGLbP/nx7QO6K7+Jw ($27.50 in chips) 
Seat 6: gO1uiTGTzn5Cd3PECuws1g ($8.55 in chips) 
Seat 7: tLcDklc2rBORNfixyRfVfw ($53.65 in chips) 
Seat 8: uhrboV251dcgYniYTdFIcA ($25.35 in chips) 
Seat 9: W2YYHvqjaEpRrO7stZkClQ ($5.15 in chips) 
gO1uiTGTzn5Cd3PECuws1g: posts small blind $0.10
tLcDklc2rBORNfixyRfVfw: posts big blind $0.25
4awUyiDYTgylQKXZ9faBVA: sits out 
*** HOLE CARDS ***
uhrboV251dcgYniYTdFIcA: raises $0.75 to $1
W2YYHvqjaEpRrO7stZkClQ: folds 
clJsV3v77RS07bDKY+705w: folds 
egvg3mTBBVzMHnJPIQiKcA: folds 
k+2r6di6GXjNpAdrRkW9bA: folds 
v1BVHNGLbP/nx7QO6K7+Jw: folds 
gO1uiTGTzn5Cd3PECuws1g: calls $0.90
tLcDklc2rBORNfixyRfVfw: folds 
*** FLOP *** [Kc Qs Ac]
gO1uiTGTzn5Cd3PECuws1g: bets $0.50
uhrboV251dcgYniYTdFIcA: raises $2.50 to $3
gO1uiTGTzn5Cd3PECuws1g: calls $2.50
*** TURN *** [Kc Qs Ac] [7d]
gO1uiTGTzn5Cd3PECuws1g: bets $0.75
uhrboV251dcgYniYTdFIcA: calls $0.75
*** RIVER *** [Kc Qs Ac 7d] [Kh]
gO1uiTGTzn5Cd3PECuws1g: bets $3.80 and is all-in
uhrboV251dcgYniYTdFIcA: calls $3.80
*** SHOW DOWN ***
gO1uiTGTzn5Cd3PECuws1g: shows [9c 4c] (a pair of Kings)
uhrboV251dcgYniYTdFIcA: shows [Qd As] (two pair, Aces and Kings)
uhrboV251dcgYniYTdFIcA collected $16.55 from pot
*** SUMMARY ***
Total pot $17.35 | Rake $0.80 
Board [Kc Qs Ac 7d Kh]
Seat 2: clJsV3v77RS07bDKY+705w folded before Flop (didn't bet)
Seat 3: egvg3mTBBVzMHnJPIQiKcA folded before Flop (didn't bet)
Seat 4: k+2r6di6GXjNpAdrRkW9bA folded before Flop (didn't bet)
Seat 5: v1BVHNGLbP/nx7QO6K7+Jw (button) folded before Flop (didn't bet)
Seat 6: gO1uiTGTzn5Cd3PECuws1g (small blind) showed [9c 4c] and lost with a pair of Kings
Seat 7: tLcDklc2rBORNfixyRfVfw (big blind) folded before Flop
Seat 8: uhrboV251dcgYniYTdFIcA showed [Qd As] and won ($16.55) with two pair, Aces and Kings
Seat 9: W2YYHvqjaEpRrO7stZkClQ folded before Flop (didn't bet)




PokerStars Game #59941976454:  Hold'em No Limit ($0.10/$0.25) - 2009/07/01 1:52:09 ET
Table 'ROYvQOMwUrvL3SOiHYcrWg' 9-max Seat #8 is the button
Seat 1: 22dIObOuor/A+IKWkNoAlA ($5.40 in chips) 
Seat 2: gehe91e0IyVT0QU/XBkEyg ($24.90 in chips) 
Seat 3: 8EbrQ/EvFWt2cr0GaU82gQ ($5 in chips) 
Seat 4: SHegmCn8B0InbWE/zFlvOw ($19.55 in chips) 
Seat 5: 7je+LC5Mfs6nL8YBVh4frQ ($4.65 in chips) 
Seat 6: P+9ymZQ3ktpQu1bn7HIjew ($20.15 in chips) 
Seat 8: biJWLZ27fafNeBI2oT1KJw ($28.40 in chips) 
Seat 9: uhrboV251dcgYniYTdFIcA ($31.55 in chips) 
uhrboV251dcgYniYTdFIcA: posts small blind $0.10
22dIObOuor/A+IKWkNoAlA: posts big blind $0.25
18G4P1XstjNvItdGUITxgw: sits out 
*** HOLE CARDS ***
gehe91e0IyVT0QU/XBkEyg: folds 
8EbrQ/EvFWt2cr0GaU82gQ: folds 
SHegmCn8B0InbWE/zFlvOw: calls $0.25
7je+LC5Mfs6nL8YBVh4frQ: folds 
P+9ymZQ3ktpQu1bn7HIjew: calls $0.25
biJWLZ27fafNeBI2oT1KJw: folds 
uhrboV251dcgYniYTdFIcA: calls $0.15
22dIObOuor/A+IKWkNoAlA: checks 
*** FLOP *** [Jc 9s 7c]
uhrboV251dcgYniYTdFIcA: checks 
22dIObOuor/A+IKWkNoAlA: bets $0.75
SHegmCn8B0InbWE/zFlvOw: calls $0.75
P+9ymZQ3ktpQu1bn7HIjew: calls $0.75
uhrboV251dcgYniYTdFIcA: folds 
*** TURN *** [Jc 9s 7c] [6s]
22dIObOuor/A+IKWkNoAlA: bets $4.40 and is all-in
SHegmCn8B0InbWE/zFlvOw: calls $4.40
P+9ymZQ3ktpQu1bn7HIjew: folds 
*** RIVER *** [Jc 9s 7c 6s] [Ad]
*** SHOW DOWN ***
22dIObOuor/A+IKWkNoAlA: shows [9h Jd] (two pair, Jacks and Nines)
SHegmCn8B0InbWE/zFlvOw: mucks hand 
22dIObOuor/A+IKWkNoAlA collected $11.50 from pot
*** SUMMARY ***
Total pot $12.05 | Rake $0.55 
Board [Jc 9s 7c 6s Ad]
Seat 1: 22dIObOuor/A+IKWkNoAlA (big blind) showed [9h Jd] and won ($11.50) with two pair, Jacks and Nines
Seat 2: gehe91e0IyVT0QU/XBkEyg folded before Flop (didn't bet)
Seat 3: 8EbrQ/EvFWt2cr0GaU82gQ folded before Flop (didn't bet)
Seat 4: SHegmCn8B0InbWE/zFlvOw mucked
Seat 5: 7je+LC5Mfs6nL8YBVh4frQ folded before Flop (didn't bet)
Seat 6: P+9ymZQ3ktpQu1bn7HIjew folded on the Turn
Seat 8: biJWLZ27fafNeBI2oT1KJw (button) folded before Flop (didn't bet)
Seat 9: uhrboV251dcgYniYTdFIcA (small blind) folded on the Flop




PokerStars Game #59941976610:  Hold'em No Limit ($0.10/$0.25) - 2009/07/01 1:52:09 ET
Table '3LMlz3V4AziGlU+ikmyU8w' 6-max Seat #5 is the button
Seat 1: ErIN0JRL5srYjT6en1f8YQ ($25 in chips) 
Seat 2: uR3AbFJLoOX86DOTtTgGcg ($34.50 in chips) 
Seat 3: Hzy03WtPHMYwLYM7hTTxQw ($52.15 in chips) 
Seat 5: tOAk1Og4mVObMBOfvdDYOw ($25 in chips) 
Seat 6: 7LpHJVeM6k1mQdC6HXYzww ($49.80 in chips) 
7LpHJVeM6k1mQdC6HXYzww: posts small blind $0.10
ErIN0JRL5srYjT6en1f8YQ: posts big blind $0.25
*** HOLE CARDS ***
6DwBRH+xZ12AAZmeAg+aXw said, "wp"
uR3AbFJLoOX86DOTtTgGcg: folds 
Hzy03WtPHMYwLYM7hTTxQw: folds 
tOAk1Og4mVObMBOfvdDYOw: raises $0.75 to $1
7LpHJVeM6k1mQdC6HXYzww: folds 
ErIN0JRL5srYjT6en1f8YQ: folds 
Uncalled bet ($0.75) returned to tOAk1Og4mVObMBOfvdDYOw
tOAk1Og4mVObMBOfvdDYOw collected $0.60 from pot
tOAk1Og4mVObMBOfvdDYOw: doesn't show hand 
*** SUMMARY ***
Total pot $0.60 | Rake $0 
Seat 1: ErIN0JRL5srYjT6en1f8YQ (big blind) folded before Flop
Seat 2: uR3AbFJLoOX86DOTtTgGcg folded before Flop (didn't bet)
Seat 3: Hzy03WtPHMYwLYM7hTTxQw folded before Flop (didn't bet)
Seat 5: tOAk1Og4mVObMBOfvdDYOw (button) collected ($0.60)
Seat 6: 7LpHJVeM6k1mQdC6HXYzww (small blind) folded before Flop




PokerStars Game #59941976804:  Hold'em No Limit ($0.10/$0.25) - 2009/07/01 1:52:09 ET
Table 'IIO2q2znuuAXmiZ2qFTcmg' 6-max Seat #2 is the button
Seat 2: i9LqF5rD3bvtbEE7HWgr3Q ($27.35 in chips) 
Seat 3: j0aDOn9Nft1HLTQvGu1UwA ($17.15 in chips) 
Seat 5: iHZrkhpIO/3+tKuAoPx8HQ ($7.75 in chips) 
Seat 6: WT1/PiLHYHDQX0orTRlu9g ($15.65 in chips) 
j0aDOn9Nft1HLTQvGu1UwA: posts small blind $0.10
iHZrkhpIO/3+tKuAoPx8HQ: posts big blind $0.25
*** HOLE CARDS ***
WT1/PiLHYHDQX0orTRlu9g: folds 
i9LqF5rD3bvtbEE7HWgr3Q: folds 
j0aDOn9Nft1HLTQvGu1UwA: calls $0.15
iHZrkhpIO/3+tKuAoPx8HQ: raises $0.75 to $1
j0aDOn9Nft1HLTQvGu1UwA: calls $0.75
*** FLOP *** [9c 7h Td]
j0aDOn9Nft1HLTQvGu1UwA: bets $0.25
iHZrkhpIO/3+tKuAoPx8HQ: raises $0.75 to $1
j0aDOn9Nft1HLTQvGu1UwA: calls $0.75
*** TURN *** [9c 7h Td] [8s]
j0aDOn9Nft1HLTQvGu1UwA: checks 
iHZrkhpIO/3+tKuAoPx8HQ: bets $1
j0aDOn9Nft1HLTQvGu1UwA: calls $1
*** RIVER *** [9c 7h Td 8s] [4s]
j0aDOn9Nft1HLTQvGu1UwA: checks 
iHZrkhpIO/3+tKuAoPx8HQ: checks 
*** SHOW DOWN ***
j0aDOn9Nft1HLTQvGu1UwA: shows [As Qh] (high card Ace)
iHZrkhpIO/3+tKuAoPx8HQ: shows [Ac Th] (a pair of Tens)
iHZrkhpIO/3+tKuAoPx8HQ collected $5.75 from pot
*** SUMMARY ***
Total pot $6 | Rake $0.25 
Board [9c 7h Td 8s 4s]
Seat 2: i9LqF5rD3bvtbEE7HWgr3Q (button) folded before Flop (didn't bet)
Seat 3: j0aDOn9Nft1HLTQvGu1UwA (small blind) showed [As Qh] and lost with high card Ace
Seat 5: iHZrkhpIO/3+tKuAoPx8HQ (big blind) showed [Ac Th] and won ($5.75) with a pair of Tens
Seat 6: WT1/PiLHYHDQX0orTRlu9g folded before Flop (didn't bet)




PokerStars Game #59941977134:  Hold'em No Limit ($0.10/$0.25) - 2009/07/01 1:52:10 ET
Table 'Y9EhDWuqWWQFM9SelXAj5g' 9-max Seat #1 is the button
Seat 1: zDrucyjVn5aeekNEc3cJrA ($30.80 in chips) 
Seat 2: W+njF1UnarGN2q2zP+R+cg ($13.60 in chips) 
Seat 3: XBq1lBzax7LjRqdJP2TqWg ($9.50 in chips) 
Seat 4: V6p0jQ/RhUsqpHLmXvEX4Q ($13 in chips) 
Seat 5: CvL9Ch1HYCVbTsfpNucitg ($6.20 in chips) 
Seat 6: egvg3mTBBVzMHnJPIQiKcA ($13.65 in chips) 
Seat 8: XDxyajtqmdag0QPvwcOG7Q ($14.60 in chips) 
Seat 9: bOrfviVhRBpaOfMqUc74Tw ($16.80 in chips) 
W+njF1UnarGN2q2zP+R+cg: posts small blind $0.10
XBq1lBzax7LjRqdJP2TqWg: posts big blind $0.25
SpiiQQAzy4MUgV3I5W8giw: sits out 
*** HOLE CARDS ***
V6p0jQ/RhUsqpHLmXvEX4Q: folds 
CvL9Ch1HYCVbTsfpNucitg: folds 
egvg3mTBBVzMHnJPIQiKcA: folds 
XDxyajtqmdag0QPvwcOG7Q: folds 
bOrfviVhRBpaOfMqUc74Tw: calls $0.25
zDrucyjVn5aeekNEc3cJrA: folds 
W+njF1UnarGN2q2zP+R+cg: calls $0.15
XBq1lBzax7LjRqdJP2TqWg: checks 
*** FLOP *** [7c 3s Kd]
W+njF1UnarGN2q2zP+R+cg: checks 
XBq1lBzax7LjRqdJP2TqWg: bets $0.25
bOrfviVhRBpaOfMqUc74Tw: calls $0.25
W+njF1UnarGN2q2zP+R+cg: folds 
*** TURN *** [7c 3s Kd] [7s]
XBq1lBzax7LjRqdJP2TqWg: bets $0.50
bOrfviVhRBpaOfMqUc74Tw: calls $0.50
*** RIVER *** [7c 3s Kd 7s] [2h]
XBq1lBzax7LjRqdJP2TqWg: bets $1
bOrfviVhRBpaOfMqUc74Tw: raises $2 to $3
XBq1lBzax7LjRqdJP2TqWg: calls $2
*** SHOW DOWN ***
bOrfviVhRBpaOfMqUc74Tw: shows [5h 7h] (three of a kind, Sevens)
XBq1lBzax7LjRqdJP2TqWg: mucks hand 
bOrfviVhRBpaOfMqUc74Tw collected $7.85 from pot
*** SUMMARY ***
Total pot $8.25 | Rake $0.40 
Board [7c 3s Kd 7s 2h]
Seat 1: zDrucyjVn5aeekNEc3cJrA (button) folded before Flop (didn't bet)
Seat 2: W+njF1UnarGN2q2zP+R+cg (small blind) folded on the Flop
Seat 3: XBq1lBzax7LjRqdJP2TqWg (big blind) mucked
Seat 4: V6p0jQ/RhUsqpHLmXvEX4Q folded before Flop (didn't bet)
Seat 5: CvL9Ch1HYCVbTsfpNucitg folded before Flop (didn't bet)
Seat 6: egvg3mTBBVzMHnJPIQiKcA folded before Flop (didn't bet)
Seat 8: XDxyajtqmdag0QPvwcOG7Q folded before Flop (didn't bet)
Seat 9: bOrfviVhRBpaOfMqUc74Tw showed [5h 7h] and won ($7.85) with three of a kind, Sevens




PokerStars Game #59941977194:  Hold'em No Limit ($0.10/$0.25) - 2009/07/01 1:52:10 ET
Table 'hOE09W281uSob0XeJmUcRg' 6-max Seat #5 is the button
Seat 1: mfrkWA3PTeYPkbO6hi98Aw ($27.60 in chips) 
Seat 2: lRKJ8o/CnOPFwfHHm6ioMw ($11.80 in chips) 
Seat 3: y+a/yGW/Jy4bPJFnaeTz5w ($12.10 in chips) 
Seat 5: JFIAqU8lCZ0vWwEl4bdGsg ($25.45 in chips) 
Seat 6: x4ZJ8E/TUrtoB7WiHcv8WA ($18.15 in chips) 
x4ZJ8E/TUrtoB7WiHcv8WA: posts small blind $0.10
mfrkWA3PTeYPkbO6hi98Aw: posts big blind $0.25
MVzl6OsGybVDNd3Vr9LYAA: sits out 
*** HOLE CARDS ***
lRKJ8o/CnOPFwfHHm6ioMw: folds 
y+a/yGW/Jy4bPJFnaeTz5w: folds 
JFIAqU8lCZ0vWwEl4bdGsg: raises $0.60 to $0.85
x4ZJ8E/TUrtoB7WiHcv8WA: folds 
lRKJ8o/CnOPFwfHHm6ioMw is sitting out
mfrkWA3PTeYPkbO6hi98Aw: folds 
Uncalled bet ($0.60) returned to JFIAqU8lCZ0vWwEl4bdGsg
JFIAqU8lCZ0vWwEl4bdGsg collected $0.60 from pot
JFIAqU8lCZ0vWwEl4bdGsg: doesn't show hand 
*** SUMMARY ***
Total pot $0.60 | Rake $0 
Seat 1: mfrkWA3PTeYPkbO6hi98Aw (big blind) folded before Flop
Seat 2: lRKJ8o/CnOPFwfHHm6ioMw folded before Flop (didn't bet)
Seat 3: y+a/yGW/Jy4bPJFnaeTz5w folded before Flop (didn't bet)
Seat 5: JFIAqU8lCZ0vWwEl4bdGsg (button) collected ($0.60)
Seat 6: x4ZJ8E/TUrtoB7WiHcv8WA (small blind) folded before Flop




PokerStars Game #59941977048:  Hold'em No Limit ($0.10/$0.25) - 2009/07/01 1:52:10 ET
Table 'Loy/olZ5qoDOSvX4UTujGg' 6-max Seat #6 is the button
Seat 1: HipgaJhkN4ie/tTw4dK3Ug ($10.85 in chips) 
Seat 2: 4z7mPbMLNp4TezHXin63Vw ($18.20 in chips) 
Seat 3: 32YL2ZEp8NT4JB2RVM9euQ ($15 in chips) 
Seat 4: /gJNBeCkWL4o85/jvlZ4BA ($26.40 in chips) 
Seat 5: Ar4vsUIUfJ7gbYh1c1m59g ($18.90 in chips) 
Seat 6: qGHGf/553gQnDoklMRe3tg ($24.80 in chips) 
HipgaJhkN4ie/tTw4dK3Ug: posts small blind $0.10
4z7mPbMLNp4TezHXin63Vw: posts big blind $0.25
*** HOLE CARDS ***
32YL2ZEp8NT4JB2RVM9euQ: folds 
/gJNBeCkWL4o85/jvlZ4BA: folds 
Ar4vsUIUfJ7gbYh1c1m59g: raises $0.75 to $1
qGHGf/553gQnDoklMRe3tg: folds 
HipgaJhkN4ie/tTw4dK3Ug: folds 
4z7mPbMLNp4TezHXin63Vw: folds 
Uncalled bet ($0.75) returned to Ar4vsUIUfJ7gbYh1c1m59g
Ar4vsUIUfJ7gbYh1c1m59g collected $0.60 from pot
*** SUMMARY ***
Total pot $0.60 | Rake $0 
Seat 1: HipgaJhkN4ie/tTw4dK3Ug (small blind) folded before Flop
Seat 2: 4z7mPbMLNp4TezHXin63Vw (big blind) folded before Flop
Seat 3: 32YL2ZEp8NT4JB2RVM9euQ folded before Flop (didn't bet)
Seat 4: /gJNBeCkWL4o85/jvlZ4BA folded before Flop (didn't bet)
Seat 5: Ar4vsUIUfJ7gbYh1c1m59g collected ($0.60)
Seat 6: qGHGf/553gQnDoklMRe3tg (button) folded before Flop (didn't bet)




PokerStars Game #59941977904:  Hold'em No Limit ($0.10/$0.25) - 2009/07/01 1:52:11 ET
Table 'eOXPe2c6mG7DOFKvMsZZfA' 6-max Seat #4 is the button
Seat 1: s21kVGMLPAoHdWR+muSonw ($25.90 in chips) 
Seat 2: gaPMxLGp9SOj4Lq6t+/0Ig ($10.95 in chips) 
Seat 3: kReyZ6g6Fu3tQ0nyjDf9kA ($23.85 in chips) 
Seat 4: zHHLkD2sRljslKKeQv/ZQw ($31.50 in chips) 
Seat 5: NhUN/JpAprdJeamFBgJH1w ($33.30 in chips) 
Seat 6: Qpv/hb5ak7LeaDig1L5L8w ($14.45 in chips) 
NhUN/JpAprdJeamFBgJH1w: posts small blind $0.10
Qpv/hb5ak7LeaDig1L5L8w: posts big blind $0.25
*** HOLE CARDS ***
s21kVGMLPAoHdWR+muSonw: folds 
gaPMxLGp9SOj4Lq6t+/0Ig: raises $0.75 to $1
kReyZ6g6Fu3tQ0nyjDf9kA: folds 
s21kVGMLPAoHdWR+muSonw leaves the table
zHHLkD2sRljslKKeQv/ZQw: folds 
NhUN/JpAprdJeamFBgJH1w: folds 
Qpv/hb5ak7LeaDig1L5L8w: calls $0.75
*** FLOP *** [Ac 2h 5d]
Qpv/hb5ak7LeaDig1L5L8w: checks 
gaPMxLGp9SOj4Lq6t+/0Ig: bets $1.25
Qpv/hb5ak7LeaDig1L5L8w: folds 
Uncalled bet ($1.25) returned to gaPMxLGp9SOj4Lq6t+/0Ig
gaPMxLGp9SOj4Lq6t+/0Ig collected $2 from pot
gaPMxLGp9SOj4Lq6t+/0Ig: doesn't show hand 
*** SUMMARY ***
Total pot $2.10 | Rake $0.10 
Board [Ac 2h 5d]
Seat 1: s21kVGMLPAoHdWR+muSonw folded before Flop (didn't bet)
Seat 2: gaPMxLGp9SOj4Lq6t+/0Ig collected ($2)
Seat 3: kReyZ6g6Fu3tQ0nyjDf9kA folded before Flop (didn't bet)
Seat 4: zHHLkD2sRljslKKeQv/ZQw (button) folded before Flop (didn't bet)
Seat 5: NhUN/JpAprdJeamFBgJH1w (small blind) folded before Flop
Seat 6: Qpv/hb5ak7LeaDig1L5L8w (big blind) folded on the Flop




PokerStars Game #59941977812:  Hold'em No Limit ($0.10/$0.25) - 2009/07/01 1:52:11 ET
Table 'o0CDOvKO/bn1WjeymDrXfA' 6-max Seat #1 is the button
Seat 1: if4dh6jhJXeN3/qd3qCp9g ($27.05 in chips) 
Seat 2: 08V++DOqzaNrRNsHIwi25w ($25 in chips) 
Seat 3: MVzl6OsGybVDNd3Vr9LYAA ($25 in chips) 
Seat 4: i9LqF5rD3bvtbEE7HWgr3Q ($25 in chips) 
Seat 5: dOIoLBxmpLHSXBN9LZnf0Q ($40.60 in chips) 
Seat 6: SS/yfeArhULzIcOPe8MdPg ($25 in chips) 
08V++DOqzaNrRNsHIwi25w: posts small blind $0.10
MVzl6OsGybVDNd3Vr9LYAA: posts big blind $0.25
*** HOLE CARDS ***
i9LqF5rD3bvtbEE7HWgr3Q: folds 
dOIoLBxmpLHSXBN9LZnf0Q: calls $0.25
SS/yfeArhULzIcOPe8MdPg: folds 
if4dh6jhJXeN3/qd3qCp9g: folds 
08V++DOqzaNrRNsHIwi25w: raises $0.75 to $1
MVzl6OsGybVDNd3Vr9LYAA: folds 
dOIoLBxmpLHSXBN9LZnf0Q: calls $0.75
*** FLOP *** [2d 7h Kc]
08V++DOqzaNrRNsHIwi25w: checks 
dOIoLBxmpLHSXBN9LZnf0Q: checks 
*** TURN *** [2d 7h Kc] [9h]
08V++DOqzaNrRNsHIwi25w: checks 
dOIoLBxmpLHSXBN9LZnf0Q: bets $0.50
08V++DOqzaNrRNsHIwi25w: calls $0.50
*** RIVER *** [2d 7h Kc 9h] [Kh]
08V++DOqzaNrRNsHIwi25w: checks 
dOIoLBxmpLHSXBN9LZnf0Q: checks 
*** SHOW DOWN ***
08V++DOqzaNrRNsHIwi25w: shows [9c Ac] (two pair, Kings and Nines)
dOIoLBxmpLHSXBN9LZnf0Q: mucks hand 
08V++DOqzaNrRNsHIwi25w collected $3.10 from pot
*** SUMMARY ***
Total pot $3.25 | Rake $0.15 
Board [2d 7h Kc 9h Kh]
Seat 1: if4dh6jhJXeN3/qd3qCp9g (button) folded before Flop (didn't bet)
Seat 2: 08V++DOqzaNrRNsHIwi25w (small blind) showed [9c Ac] and won ($3.10) with two pair, Kings and Nines
Seat 3: MVzl6OsGybVDNd3Vr9LYAA (big blind) folded before Flop
Seat 4: i9LqF5rD3bvtbEE7HWgr3Q folded before Flop (didn't bet)
Seat 5: dOIoLBxmpLHSXBN9LZnf0Q mucked
Seat 6: SS/yfeArhULzIcOPe8MdPg folded before Flop (didn't bet)




PokerStars Game #59941977604:  Hold'em No Limit ($0.10/$0.25) - 2009/07/01 1:52:11 ET
Table 'ouLhepGYovxB2x0QxH7cVg' 9-max Seat #1 is the button
Seat 1: ghNKXUBl/H+t83JF079ZBA ($25 in chips) 
Seat 2: r1Z5m4PwSI5ANp7qCE1OJw ($11.35 in chips) 
Seat 4: a0Sx6GHY7ln2Ns2C97eXeA ($59.40 in chips) 
Seat 5: v60REj6f8jzMYT0VsZvaPQ ($22.55 in chips) 
Seat 6: hYvTc4PYNrAaNAIVoM94Hw ($4.65 in chips) 
Seat 8: tLcDklc2rBORNfixyRfVfw ($25.25 in chips) 
Seat 9: ljemhp25Zg+nlA9DLCIiUw ($24.95 in chips) 
r1Z5m4PwSI5ANp7qCE1OJw: posts small blind $0.10
bXpVeaSTPBFSPJmeXxO7nw: is sitting out 
a0Sx6GHY7ln2Ns2C97eXeA: posts big blind $0.25
cKlmpQMahVsmOaxFQDcoOg: sits out 
*** HOLE CARDS ***
bXpVeaSTPBFSPJmeXxO7nw leaves the table
v60REj6f8jzMYT0VsZvaPQ: folds 
hYvTc4PYNrAaNAIVoM94Hw: folds 
tLcDklc2rBORNfixyRfVfw: folds 
ljemhp25Zg+nlA9DLCIiUw: folds 
ghNKXUBl/H+t83JF079ZBA: folds 
r1Z5m4PwSI5ANp7qCE1OJw: calls $0.15
a0Sx6GHY7ln2Ns2C97eXeA: raises $0.50 to $0.75
r1Z5m4PwSI5ANp7qCE1OJw: folds 
Uncalled bet ($0.50) returned to a0Sx6GHY7ln2Ns2C97eXeA
a0Sx6GHY7ln2Ns2C97eXeA collected $0.50 from pot
a0Sx6GHY7ln2Ns2C97eXeA: doesn't show hand 
*** SUMMARY ***
Total pot $0.50 | Rake $0 
Seat 1: ghNKXUBl/H+t83JF079ZBA (button) folded before Flop (didn't bet)
Seat 2: r1Z5m4PwSI5ANp7qCE1OJw (small blind) folded before Flop
Seat 4: a0Sx6GHY7ln2Ns2C97eXeA (big blind) collected ($0.50)
Seat 5: v60REj6f8jzMYT0VsZvaPQ folded before Flop (didn't bet)
Seat 6: hYvTc4PYNrAaNAIVoM94Hw folded before Flop (didn't bet)
Seat 8: tLcDklc2rBORNfixyRfVfw folded before Flop (didn't bet)
Seat 9: ljemhp25Zg+nlA9DLCIiUw folded before Flop (didn't bet)




PokerStars Game #59941977518:  Hold'em No Limit ($0.10/$0.25) - 2009/07/01 1:52:11 ET
Table 'MJ1SB76A4qJrlEa+C5e/8w' 6-max Seat #4 is the button
Seat 1: 0KDZiuXQg6UI9cqBR/AUnQ ($19.35 in chips) 
Seat 2: UA5OsKS3VPaxa7uC8La/kA ($37.75 in chips) 
Seat 3: DihMHaz4WNETH1bPDe13kA ($32.20 in chips) 
Seat 4: SFmT9ZsVopnukjvAzrxTRg ($30.05 in chips) 
Seat 6: JFIAqU8lCZ0vWwEl4bdGsg ($34.40 in chips) 
JFIAqU8lCZ0vWwEl4bdGsg: posts small blind $0.10
0KDZiuXQg6UI9cqBR/AUnQ is disconnected 
0KDZiuXQg6UI9cqBR/AUnQ is connected 
0KDZiuXQg6UI9cqBR/AUnQ: posts big blind $0.25
*** HOLE CARDS ***
UA5OsKS3VPaxa7uC8La/kA: folds 
DihMHaz4WNETH1bPDe13kA: calls $0.25
SFmT9ZsVopnukjvAzrxTRg: folds 
JFIAqU8lCZ0vWwEl4bdGsg: folds 
0KDZiuXQg6UI9cqBR/AUnQ: checks 
*** FLOP *** [Tc 6h 7s]
0KDZiuXQg6UI9cqBR/AUnQ: checks 
DihMHaz4WNETH1bPDe13kA: bets $0.40
0KDZiuXQg6UI9cqBR/AUnQ: raises $1.60 to $2
DihMHaz4WNETH1bPDe13kA: calls $1.60
*** TURN *** [Tc 6h 7s] [As]
fratb joins the table at seat #5 
0KDZiuXQg6UI9cqBR/AUnQ is disconnected 
0KDZiuXQg6UI9cqBR/AUnQ is connected 
0KDZiuXQg6UI9cqBR/AUnQ: checks 
DihMHaz4WNETH1bPDe13kA: bets $3.50
0KDZiuXQg6UI9cqBR/AUnQ: folds 
Uncalled bet ($3.50) returned to DihMHaz4WNETH1bPDe13kA
DihMHaz4WNETH1bPDe13kA collected $4.40 from pot
*** SUMMARY ***
Total pot $4.60 | Rake $0.20 
Board [Tc 6h 7s As]
Seat 1: 0KDZiuXQg6UI9cqBR/AUnQ (big blind) folded on the Turn
Seat 2: UA5OsKS3VPaxa7uC8La/kA folded before Flop (didn't bet)
Seat 3: DihMHaz4WNETH1bPDe13kA collected ($4.40)
Seat 4: SFmT9ZsVopnukjvAzrxTRg (button) folded before Flop (didn't bet)
Seat 6: JFIAqU8lCZ0vWwEl4bdGsg (small blind) folded before Flop




PokerStars Game #59941978440:  Hold'em No Limit ($0.10/$0.25) - 2009/07/01 1:52:12 ET
Table 'ER5H84HUgJx7HyDLnELLeA' 6-max Seat #6 is the button
Seat 1: LJI7A1YgDM7hgh7o56+ReQ ($26 in chips) 
Seat 3: cS21pIxRHx5Gt42o7hPZzw ($13 in chips) 
Seat 4: vqWjZmdQu/Hxw96/IJTWdQ ($25 in chips) 
Seat 5: mfrkWA3PTeYPkbO6hi98Aw ($26.20 in chips) 
Seat 6: 3zD3qLXT1bEffAoWGnc7wg ($52.05 in chips) 
LJI7A1YgDM7hgh7o56+ReQ: posts small blind $0.10
cS21pIxRHx5Gt42o7hPZzw: posts big blind $0.25
*** HOLE CARDS ***
vqWjZmdQu/Hxw96/IJTWdQ: raises $0.75 to $1
mfrkWA3PTeYPkbO6hi98Aw: folds 
3zD3qLXT1bEffAoWGnc7wg: folds 
LJI7A1YgDM7hgh7o56+ReQ: folds 
cS21pIxRHx5Gt42o7hPZzw: folds 
Uncalled bet ($0.75) returned to vqWjZmdQu/Hxw96/IJTWdQ
vqWjZmdQu/Hxw96/IJTWdQ collected $0.60 from pot
vqWjZmdQu/Hxw96/IJTWdQ: doesn't show hand 
*** SUMMARY ***
Total pot $0.60 | Rake $0 
Seat 1: LJI7A1YgDM7hgh7o56+ReQ (small blind) folded before Flop
Seat 3: cS21pIxRHx5Gt42o7hPZzw (big blind) folded before Flop
Seat 4: vqWjZmdQu/Hxw96/IJTWdQ collected ($0.60)
Seat 5: mfrkWA3PTeYPkbO6hi98Aw folded before Flop (didn't bet)
Seat 6: 3zD3qLXT1bEffAoWGnc7wg (button) folded before Flop (didn't bet)




PokerStars Game #59941978368:  Hold'em No Limit ($0.10/$0.25) - 2009/07/01 1:52:12 ET
Table 'JJzUs04lHpXg6nboT1/jeg' 6-max Seat #4 is the button
Seat 1: vEZ/HxVuyR6kaq0BtZoUgQ ($9.25 in chips) 
Seat 2: jxfR29d+dK/7h7s3SvCk+g ($11.60 in chips) 
Seat 3: 4zXbHDe39qNX46dAo81b4w ($9.25 in chips) 
Seat 4: 7cx44/slbeTw+Cy7QB8Trg ($24.30 in chips) 
Seat 5: FDWzjQgBA5K04jOIY/j22w ($4.50 in chips) 
Seat 6: bDKopKTvPi3W+PEnYUX3tg ($25 in chips) 
FDWzjQgBA5K04jOIY/j22w: posts small blind $0.10
bDKopKTvPi3W+PEnYUX3tg: posts big blind $0.25
*** HOLE CARDS ***
vEZ/HxVuyR6kaq0BtZoUgQ: folds 
jxfR29d+dK/7h7s3SvCk+g: folds 
4zXbHDe39qNX46dAo81b4w: folds 
7cx44/slbeTw+Cy7QB8Trg: folds 
FDWzjQgBA5K04jOIY/j22w: calls $0.15
bDKopKTvPi3W+PEnYUX3tg: checks 
*** FLOP *** [5s Td 8c]
FDWzjQgBA5K04jOIY/j22w: checks 
bDKopKTvPi3W+PEnYUX3tg: checks 
*** TURN *** [5s Td 8c] [4c]
FDWzjQgBA5K04jOIY/j22w: checks 
bDKopKTvPi3W+PEnYUX3tg: checks 
*** RIVER *** [5s Td 8c 4c] [Jh]
FDWzjQgBA5K04jOIY/j22w: checks 
bDKopKTvPi3W+PEnYUX3tg: checks 
*** SHOW DOWN ***
FDWzjQgBA5K04jOIY/j22w: shows [7h Kh] (high card King)
bDKopKTvPi3W+PEnYUX3tg: mucks hand 
FDWzjQgBA5K04jOIY/j22w collected $0.50 from pot
*** SUMMARY ***
Total pot $0.50 | Rake $0 
Board [5s Td 8c 4c Jh]
Seat 1: vEZ/HxVuyR6kaq0BtZoUgQ folded before Flop (didn't bet)
Seat 2: jxfR29d+dK/7h7s3SvCk+g folded before Flop (didn't bet)
Seat 3: 4zXbHDe39qNX46dAo81b4w folded before Flop (didn't bet)
Seat 4: 7cx44/slbeTw+Cy7QB8Trg (button) folded before Flop (didn't bet)
Seat 5: FDWzjQgBA5K04jOIY/j22w (small blind) showed [7h Kh] and won ($0.50) with high card King
Seat 6: bDKopKTvPi3W+PEnYUX3tg (big blind) mucked




PokerStars Game #59941978186:  Hold'em No Limit ($0.10/$0.25) - 2009/07/01 1:52:12 ET
Table 'mVdLgAdN9rGe6mMwSrDdGQ' 6-max Seat #2 is the button
Seat 1: OyJ0KTHA5cwh0/yCo1/rdA ($7.10 in chips) 
Seat 2: n9QqWD4tpbongUBX2Oi58w ($10.80 in chips) 
Seat 3: +baiVgI/ETnBARLe5mARCw ($16 in chips) 
Seat 4: scNSjC6yyKvvfklSkuzLrw ($25.65 in chips) 
Seat 5: +TMG/MBWpiEnc9t7i07eTA ($23.15 in chips) 
Seat 6: DihMHaz4WNETH1bPDe13kA ($47.95 in chips) 
+baiVgI/ETnBARLe5mARCw: posts small blind $0.10
scNSjC6yyKvvfklSkuzLrw: posts big blind $0.25
*** HOLE CARDS ***
+TMG/MBWpiEnc9t7i07eTA: folds 
DihMHaz4WNETH1bPDe13kA: folds 
OyJ0KTHA5cwh0/yCo1/rdA: raises $0.50 to $0.75
n9QqWD4tpbongUBX2Oi58w: folds 
+baiVgI/ETnBARLe5mARCw: folds 
scNSjC6yyKvvfklSkuzLrw: folds 
Uncalled bet ($0.50) returned to OyJ0KTHA5cwh0/yCo1/rdA
OyJ0KTHA5cwh0/yCo1/rdA collected $0.60 from pot
*** SUMMARY ***
Total pot $0.60 | Rake $0 
Seat 1: OyJ0KTHA5cwh0/yCo1/rdA collected ($0.60)
Seat 2: n9QqWD4tpbongUBX2Oi58w (button) folded before Flop (didn't bet)
Seat 3: +baiVgI/ETnBARLe5mARCw (small blind) folded before Flop
Seat 4: scNSjC6yyKvvfklSkuzLrw (big blind) folded before Flop
Seat 5: +TMG/MBWpiEnc9t7i07eTA folded before Flop (didn't bet)
Seat 6: DihMHaz4WNETH1bPDe13kA folded before Flop (didn't bet)




PokerStars Game #59941978040:  Hold'em No Limit ($0.10/$0.25) - 2009/07/01 1:52:12 ET
Table 'ZEXL6Wh4qA4Afx8NnoBBAA' 6-max Seat #4 is the button
Seat 1: v8m8XHovI5tqEA9mvplDSw ($26.95 in chips) 
Seat 2: 6DwBRH+xZ12AAZmeAg+aXw ($20.40 in chips) 
Seat 3: +ZlnqPoP3Hg4BIUxDfKd/A ($34.60 in chips) 
Seat 4: FpN4KbLjlyRRKiVaQcoLqA ($28.25 in chips) 
Seat 5: if4dh6jhJXeN3/qd3qCp9g ($38.55 in chips) 
Seat 6: Lh8SlCq3OSDKWLUgAI/Lxw ($1.75 in chips) 
if4dh6jhJXeN3/qd3qCp9g: posts small blind $0.10
Lh8SlCq3OSDKWLUgAI/Lxw: posts big blind $0.25
*** HOLE CARDS ***
v8m8XHovI5tqEA9mvplDSw: folds 
6DwBRH+xZ12AAZmeAg+aXw: raises $0.50 to $0.75
+ZlnqPoP3Hg4BIUxDfKd/A: folds 
FpN4KbLjlyRRKiVaQcoLqA: calls $0.75
if4dh6jhJXeN3/qd3qCp9g: folds 
Lh8SlCq3OSDKWLUgAI/Lxw: folds 
*** FLOP *** [Qs 3h Ts]
6DwBRH+xZ12AAZmeAg+aXw: bets $1
FpN4KbLjlyRRKiVaQcoLqA: calls $1
*** TURN *** [Qs 3h Ts] [5c]
6DwBRH+xZ12AAZmeAg+aXw: checks 
FpN4KbLjlyRRKiVaQcoLqA: bets $1
6DwBRH+xZ12AAZmeAg+aXw: folds 
Uncalled bet ($1) returned to FpN4KbLjlyRRKiVaQcoLqA
FpN4KbLjlyRRKiVaQcoLqA collected $3.70 from pot
FpN4KbLjlyRRKiVaQcoLqA: doesn't show hand 
*** SUMMARY ***
Total pot $3.85 | Rake $0.15 
Board [Qs 3h Ts 5c]
Seat 1: v8m8XHovI5tqEA9mvplDSw folded before Flop (didn't bet)
Seat 2: 6DwBRH+xZ12AAZmeAg+aXw folded on the Turn
Seat 3: +ZlnqPoP3Hg4BIUxDfKd/A folded before Flop (didn't bet)
Seat 4: FpN4KbLjlyRRKiVaQcoLqA (button) collected ($3.70)
Seat 5: if4dh6jhJXeN3/qd3qCp9g (small blind) folded before Flop
Seat 6: Lh8SlCq3OSDKWLUgAI/Lxw (big blind) folded before Flop




PokerStars Game #59941978194:  Hold'em No Limit ($0.10/$0.25) - 2009/07/01 1:52:12 ET
Table 'wPWRBZPJl1HAnysw7qRR0A' 6-max Seat #6 is the button
Seat 1: m7ne1MOFTQXlsXT7/R/rug ($11.90 in chips) 
Seat 2: xC0kaiDYM6YTlgODL83O5A ($23.35 in chips) 
Seat 3: 1ZpoLWO2nm2w1Nd1v9Sr3g ($7.20 in chips) 
Seat 4: epAUIB7h2FJXzUPRIvSkRA ($48.85 in chips) 
Seat 5: y0B+UpYpOUJz3JWtlJQBSA ($15.05 in chips) 
Seat 6: VXTONriS+Ohik+r0FeicIw ($25.60 in chips) 
m7ne1MOFTQXlsXT7/R/rug: posts small blind $0.10
xC0kaiDYM6YTlgODL83O5A: posts big blind $0.25
*** HOLE CARDS ***
1ZpoLWO2nm2w1Nd1v9Sr3g: folds 
1ZpoLWO2nm2w1Nd1v9Sr3g leaves the table
epAUIB7h2FJXzUPRIvSkRA: raises $0.75 to $1
y0B+UpYpOUJz3JWtlJQBSA: folds 
VXTONriS+Ohik+r0FeicIw: folds 
m7ne1MOFTQXlsXT7/R/rug: calls $0.90
xC0kaiDYM6YTlgODL83O5A: folds 
*** FLOP *** [Ks 9c 9h]
m7ne1MOFTQXlsXT7/R/rug: checks 
epAUIB7h2FJXzUPRIvSkRA: bets $1.50
m7ne1MOFTQXlsXT7/R/rug: folds 
Uncalled bet ($1.50) returned to epAUIB7h2FJXzUPRIvSkRA
epAUIB7h2FJXzUPRIvSkRA collected $2.15 from pot
epAUIB7h2FJXzUPRIvSkRA: doesn't show hand 
*** SUMMARY ***
Total pot $2.25 | Rake $0.10 
Board [Ks 9c 9h]
Seat 1: m7ne1MOFTQXlsXT7/R/rug (small blind) folded on the Flop
Seat 2: xC0kaiDYM6YTlgODL83O5A (big blind) folded before Flop
Seat 3: 1ZpoLWO2nm2w1Nd1v9Sr3g folded before Flop (didn't bet)
Seat 4: epAUIB7h2FJXzUPRIvSkRA collected ($2.15)
Seat 5: y0B+UpYpOUJz3JWtlJQBSA folded before Flop (didn't bet)
Seat 6: VXTONriS+Ohik+r0FeicIw (button) folded before Flop (didn't bet)




PokerStars Game #59941978118:  Hold'em No Limit ($0.10/$0.25) - 2009/07/01 1:52:12 ET
Table 'QegsWX65l3n/K0A8XB78yg' 6-max Seat #4 is the button
Seat 1: p6adJRMXMBLr+xtQzqazIQ ($12 in chips) 
Seat 2: GC/9yVD59DUCX7hUI7gcLw ($55.50 in chips) 
Seat 3: iIgNoBh+3/Ix1/fLsg+HuA ($6 in chips) 
Seat 4: epAUIB7h2FJXzUPRIvSkRA ($25 in chips) 
Seat 5: QqiZLFrN8iOUT/GHw7ztOA ($26.45 in chips) 
Seat 6: 5PWs02z65jSO5pr/M6wx/w ($14.05 in chips) 
QqiZLFrN8iOUT/GHw7ztOA: posts small blind $0.10
5PWs02z65jSO5pr/M6wx/w: posts big blind $0.25
*** HOLE CARDS ***
p6adJRMXMBLr+xtQzqazIQ: folds 
GC/9yVD59DUCX7hUI7gcLw: folds 
iIgNoBh+3/Ix1/fLsg+HuA: raises $0.50 to $0.75
epAUIB7h2FJXzUPRIvSkRA: raises $1.50 to $2.25
QqiZLFrN8iOUT/GHw7ztOA: folds 
5PWs02z65jSO5pr/M6wx/w: folds 
iIgNoBh+3/Ix1/fLsg+HuA: raises $3.75 to $6 and is all-in
epAUIB7h2FJXzUPRIvSkRA: calls $3.75
*** FLOP *** [As 4h Jc]
*** TURN *** [As 4h Jc] [Th]
*** RIVER *** [As 4h Jc Th] [6d]
*** SHOW DOWN ***
iIgNoBh+3/Ix1/fLsg+HuA: shows [5h 5d] (a pair of Fives)
epAUIB7h2FJXzUPRIvSkRA: shows [Kd Ah] (a pair of Aces)
epAUIB7h2FJXzUPRIvSkRA collected $11.75 from pot
*** SUMMARY ***
Total pot $12.35 | Rake $0.60 
Board [As 4h Jc Th 6d]
Seat 1: p6adJRMXMBLr+xtQzqazIQ folded before Flop (didn't bet)
Seat 2: GC/9yVD59DUCX7hUI7gcLw folded before Flop (didn't bet)
Seat 3: iIgNoBh+3/Ix1/fLsg+HuA showed [5h 5d] and lost with a pair of Fives
Seat 4: epAUIB7h2FJXzUPRIvSkRA (button) showed [Kd Ah] and won ($11.75) with a pair of Aces
Seat 5: QqiZLFrN8iOUT/GHw7ztOA (small blind) folded before Flop
Seat 6: 5PWs02z65jSO5pr/M6wx/w (big blind) folded before Flop




PokerStars Game #59941978290:  Hold'em No Limit ($0.10/$0.25) - 2009/07/01 1:52:12 ET
Table '60nA7av6bws9VnNmVwculA' 6-max Seat #3 is the button
Seat 1: if4dh6jhJXeN3/qd3qCp9g ($25 in chips) 
Seat 2: Bada343Si4xKu3fNXY99AA ($5.40 in chips) 
Seat 3: mnuJq+Q1IXKm/pCy+OzxmQ ($25.85 in chips) 
Seat 4: +baiVgI/ETnBARLe5mARCw ($18.70 in chips) 
Seat 5: zXh+lOT41Q2iWgCNj+OcRw ($11.60 in chips) 
Seat 6: mfrkWA3PTeYPkbO6hi98Aw ($25 in chips) 
+baiVgI/ETnBARLe5mARCw: posts small blind $0.10
zXh+lOT41Q2iWgCNj+OcRw: posts big blind $0.25
*** HOLE CARDS ***
mfrkWA3PTeYPkbO6hi98Aw: folds 
if4dh6jhJXeN3/qd3qCp9g: folds 
Bada343Si4xKu3fNXY99AA: folds 
mnuJq+Q1IXKm/pCy+OzxmQ: calls $0.25
+baiVgI/ETnBARLe5mARCw: folds 
zXh+lOT41Q2iWgCNj+OcRw: checks 
*** FLOP *** [Ah 6h Jd]
zXh+lOT41Q2iWgCNj+OcRw: checks 
mnuJq+Q1IXKm/pCy+OzxmQ: checks 
*** TURN *** [Ah 6h Jd] [Kd]
zXh+lOT41Q2iWgCNj+OcRw: bets $0.50
mnuJq+Q1IXKm/pCy+OzxmQ: folds 
Uncalled bet ($0.50) returned to zXh+lOT41Q2iWgCNj+OcRw
zXh+lOT41Q2iWgCNj+OcRw collected $0.60 from pot
*** SUMMARY ***
Total pot $0.60 | Rake $0 
Board [Ah 6h Jd Kd]
Seat 1: if4dh6jhJXeN3/qd3qCp9g folded before Flop (didn't bet)
Seat 2: Bada343Si4xKu3fNXY99AA folded before Flop (didn't bet)
Seat 3: mnuJq+Q1IXKm/pCy+OzxmQ (button) folded on the Turn
Seat 4: +baiVgI/ETnBARLe5mARCw (small blind) folded before Flop
Seat 5: zXh+lOT41Q2iWgCNj+OcRw (big blind) collected ($0.60)
Seat 6: mfrkWA3PTeYPkbO6hi98Aw folded before Flop (didn't bet)




PokerStars Game #59941978542:  Hold'em No Limit ($0.10/$0.25) - 2009/07/01 1:52:13 ET
Table 'srBTB98reCdD1TffxE6o7g' 6-max Seat #4 is the button
Seat 1: SFmT9ZsVopnukjvAzrxTRg ($36.55 in chips) 
Seat 2: mfrkWA3PTeYPkbO6hi98Aw ($24.65 in chips) 
Seat 3: VOmI0x4dDPnTESZd5B4d1Q ($42.40 in chips) 
Seat 4: 6DwBRH+xZ12AAZmeAg+aXw ($16.20 in chips) 
Seat 5: K1zv48sQUGQiaLk5VWWDqw ($26 in chips) 
Seat 6: BV+K0Phf5VBHr7aZPKqbUQ ($30.75 in chips) 
K1zv48sQUGQiaLk5VWWDqw: posts small blind $0.10
BV+K0Phf5VBHr7aZPKqbUQ: posts big blind $0.25
*** HOLE CARDS ***
SFmT9ZsVopnukjvAzrxTRg: folds 
SFmT9ZsVopnukjvAzrxTRg leaves the table
mfrkWA3PTeYPkbO6hi98Aw: folds 
VOmI0x4dDPnTESZd5B4d1Q: folds 
6DwBRH+xZ12AAZmeAg+aXw: folds 
K1zv48sQUGQiaLk5VWWDqw: calls $0.15
BV+K0Phf5VBHr7aZPKqbUQ: checks 
*** FLOP *** [6h 2d 5c]
K1zv48sQUGQiaLk5VWWDqw: bets $0.50
BV+K0Phf5VBHr7aZPKqbUQ: folds 
Uncalled bet ($0.50) returned to K1zv48sQUGQiaLk5VWWDqw
K1zv48sQUGQiaLk5VWWDqw collected $0.50 from pot
K1zv48sQUGQiaLk5VWWDqw: doesn't show hand 
*** SUMMARY ***
Total pot $0.50 | Rake $0 
Board [6h 2d 5c]
Seat 1: SFmT9ZsVopnukjvAzrxTRg folded before Flop (didn't bet)
Seat 2: mfrkWA3PTeYPkbO6hi98Aw folded before Flop (didn't bet)
Seat 3: VOmI0x4dDPnTESZd5B4d1Q folded before Flop (didn't bet)
Seat 4: 6DwBRH+xZ12AAZmeAg+aXw (button) folded before Flop (didn't bet)
Seat 5: K1zv48sQUGQiaLk5VWWDqw (small blind) collected ($0.50)
Seat 6: BV+K0Phf5VBHr7aZPKqbUQ (big blind) folded on the Flop




PokerStars Game #59941978846:  Hold'em No Limit ($0.10/$0.25) - 2009/07/01 1:52:13 ET
Table 'ohAuixfiLOYDylNUG5mNUw' 9-max Seat #4 is the button
Seat 1: qwr38jl5txoR36M7G5qi4A ($10 in chips) 
Seat 2: Th3FldXKQW6hWVVPahaoOQ ($26.15 in chips) 
Seat 3: gSakoFAgDDzXSb2eNBWKcg ($16.45 in chips) 
Seat 4: clJsV3v77RS07bDKY+705w ($5 in chips) 
Seat 7: y6clPkgMYve3yX9UTvvFUw ($19 in chips) 
Seat 8: ppMlNkhYgErlt4fuJO7ADA ($4.95 in chips) 
Seat 9: CT7Xj/V/O5rBlhtt+RZeFQ ($25 in chips) 
z5GxcHlYz/GSz6W2uFiTtg will be allowed to play after the button
18G4P1XstjNvItdGUITxgw will be allowed to play after the button
y6clPkgMYve3yX9UTvvFUw: posts small blind $0.10
ppMlNkhYgErlt4fuJO7ADA: posts big blind $0.25
*** HOLE CARDS ***
CT7Xj/V/O5rBlhtt+RZeFQ: folds 
qwr38jl5txoR36M7G5qi4A: folds 
Th3FldXKQW6hWVVPahaoOQ: folds 
gSakoFAgDDzXSb2eNBWKcg: folds 
clJsV3v77RS07bDKY+705w: folds 
y6clPkgMYve3yX9UTvvFUw: folds 
Uncalled bet ($0.15) returned to ppMlNkhYgErlt4fuJO7ADA
y6clPkgMYve3yX9UTvvFUw is sitting out
ppMlNkhYgErlt4fuJO7ADA collected $0.20 from pot
*** SUMMARY ***
Total pot $0.20 | Rake $0 
Seat 1: qwr38jl5txoR36M7G5qi4A folded before Flop (didn't bet)
Seat 2: Th3FldXKQW6hWVVPahaoOQ folded before Flop (didn't bet)
Seat 3: gSakoFAgDDzXSb2eNBWKcg folded before Flop (didn't bet)
Seat 4: clJsV3v77RS07bDKY+705w (button) folded before Flop (didn't bet)
Seat 7: y6clPkgMYve3yX9UTvvFUw (small blind) folded before Flop
Seat 8: ppMlNkhYgErlt4fuJO7ADA (big blind) collected ($0.20)
Seat 9: CT7Xj/V/O5rBlhtt+RZeFQ folded before Flop (didn't bet)




PokerStars Game #59941978510:  Hold'em No Limit ($0.10/$0.25) - 2009/07/01 1:52:13 ET
Table 'aT31tt16YvQM/Ue69HPLpA' 9-max Seat #3 is the button
Seat 1: wxmepRUXfX1jdQfUD5uENQ ($4.40 in chips) 
Seat 2: 8CoKLhwk8Ja6X+O9fxTEDg ($5 in chips) 
Seat 3: swK30YlQuxRQO7QFr4ZxCA ($25 in chips) 
Seat 4: wGigCmBR/9XWkPpvYos3aQ ($26.60 in chips) 
Seat 5: s2xLPOl/vhl/26apJ3vsOQ ($33.90 in chips) 
Seat 6: ghG12/paEL5VoDN85sW6RA ($15.35 in chips) 
Seat 9: TvIuLx9zUCE+9Li58iImOQ ($13.60 in chips) 
wGigCmBR/9XWkPpvYos3aQ: posts small blind $0.10
s2xLPOl/vhl/26apJ3vsOQ: posts big blind $0.25
JoKeR_1216: sits out 
8CoKLhwk8Ja6X+O9fxTEDg: posts big blind $0.25
*** HOLE CARDS ***
ghG12/paEL5VoDN85sW6RA: folds 
TvIuLx9zUCE+9Li58iImOQ: folds 
wxmepRUXfX1jdQfUD5uENQ: folds 
8CoKLhwk8Ja6X+O9fxTEDg: checks 
swK30YlQuxRQO7QFr4ZxCA: calls $0.25
wGigCmBR/9XWkPpvYos3aQ: folds 
s2xLPOl/vhl/26apJ3vsOQ: checks 
*** FLOP *** [Jh 7c 9d]
s2xLPOl/vhl/26apJ3vsOQ: checks 
8CoKLhwk8Ja6X+O9fxTEDg: bets $0.25
swK30YlQuxRQO7QFr4ZxCA: calls $0.25
s2xLPOl/vhl/26apJ3vsOQ: folds 
*** TURN *** [Jh 7c 9d] [9s]
8CoKLhwk8Ja6X+O9fxTEDg: bets $0.25
swK30YlQuxRQO7QFr4ZxCA: calls $0.25
*** RIVER *** [Jh 7c 9d 9s] [5s]
8CoKLhwk8Ja6X+O9fxTEDg: bets $1.75
swK30YlQuxRQO7QFr4ZxCA: folds 
Uncalled bet ($1.75) returned to 8CoKLhwk8Ja6X+O9fxTEDg
8CoKLhwk8Ja6X+O9fxTEDg collected $1.80 from pot
*** SUMMARY ***
Total pot $1.85 | Rake $0.05 
Board [Jh 7c 9d 9s 5s]
Seat 1: wxmepRUXfX1jdQfUD5uENQ folded before Flop (didn't bet)
Seat 2: 8CoKLhwk8Ja6X+O9fxTEDg collected ($1.80)
Seat 3: swK30YlQuxRQO7QFr4ZxCA (button) folded on the River
Seat 4: wGigCmBR/9XWkPpvYos3aQ (small blind) folded before Flop
Seat 5: s2xLPOl/vhl/26apJ3vsOQ (big blind) folded on the Flop
Seat 6: ghG12/paEL5VoDN85sW6RA folded before Flop (didn't bet)
Seat 9: TvIuLx9zUCE+9Li58iImOQ folded before Flop (didn't bet)




PokerStars Game #59941978584:  Hold'em No Limit ($0.10/$0.25) - 2009/07/01 1:52:13 ET
Table '/Xx5AsbRD4oNGMTFFC/92Q' 6-max Seat #4 is the button
Seat 2: N/zeVku/lNn+kUQejwmLpg ($11.45 in chips) 
Seat 4: 7/ROHX4tuLekJ2diYIlMkw ($1.80 in chips) 
Seat 6: p4A+KsSkRO/5I6h0o4VQDQ ($4 in chips) 
kMa8BltUcBQVxnHfqdCfXg will be allowed to play after the button
p4A+KsSkRO/5I6h0o4VQDQ: posts small blind $0.10
N/zeVku/lNn+kUQejwmLpg: posts big blind $0.25
*** HOLE CARDS ***
7/ROHX4tuLekJ2diYIlMkw: raises $0.50 to $0.75
p4A+KsSkRO/5I6h0o4VQDQ: folds 
N/zeVku/lNn+kUQejwmLpg: folds 
Uncalled bet ($0.50) returned to 7/ROHX4tuLekJ2diYIlMkw
7/ROHX4tuLekJ2diYIlMkw collected $0.60 from pot
*** SUMMARY ***
Total pot $0.60 | Rake $0 
Seat 2: N/zeVku/lNn+kUQejwmLpg (big blind) folded before Flop
Seat 4: 7/ROHX4tuLekJ2diYIlMkw (button) collected ($0.60)
Seat 6: p4A+KsSkRO/5I6h0o4VQDQ (small blind) folded before Flop




PokerStars Game #59941978650:  Hold'em No Limit ($0.10/$0.25) - 2009/07/01 1:52:13 ET
Table 'rtxA1Y01Nrq5VoyzTAuusQ' 9-max Seat #5 is the button
Seat 1: w1ukf8uPa4+WH561TtVRxA ($26.55 in chips) 
Seat 2: Th3FldXKQW6hWVVPahaoOQ ($25 in chips) 
Seat 3: K9fS1IUr5GpiJG7VkJ7IbA ($8.10 in chips) 
Seat 4: RHqgdFvufLCYe54+qd2gcA ($5.55 in chips) 
Seat 5: MtVtHDqIJTyUcXkRBBDIVA ($32.55 in chips) 
Seat 7: W6tExOcYX7qiy6Qdp+ZwFA ($4.75 in chips) 
Seat 8: DnDcAdn9P0zGovMERigpFA ($25 in chips) 
Seat 9: HPEB+AtKw1+C/cxU0o1ciw ($22.35 in chips) 
W6tExOcYX7qiy6Qdp+ZwFA: posts small blind $0.10
DnDcAdn9P0zGovMERigpFA: posts big blind $0.25
*** HOLE CARDS ***
HPEB+AtKw1+C/cxU0o1ciw: calls $0.25
w1ukf8uPa4+WH561TtVRxA: folds 
Th3FldXKQW6hWVVPahaoOQ: folds 
K9fS1IUr5GpiJG7VkJ7IbA: calls $0.25
RHqgdFvufLCYe54+qd2gcA: folds 
MtVtHDqIJTyUcXkRBBDIVA: folds 
W6tExOcYX7qiy6Qdp+ZwFA: calls $0.15
DnDcAdn9P0zGovMERigpFA: checks 
*** FLOP *** [3s Kc Jh]
W6tExOcYX7qiy6Qdp+ZwFA: checks 
DnDcAdn9P0zGovMERigpFA: checks 
HPEB+AtKw1+C/cxU0o1ciw: checks 
K9fS1IUr5GpiJG7VkJ7IbA: checks 
*** TURN *** [3s Kc Jh] [Ac]
W6tExOcYX7qiy6Qdp+ZwFA: checks 
DnDcAdn9P0zGovMERigpFA: checks 
HPEB+AtKw1+C/cxU0o1ciw: checks 
K9fS1IUr5GpiJG7VkJ7IbA: checks 
*** RIVER *** [3s Kc Jh Ac] [8h]
W6tExOcYX7qiy6Qdp+ZwFA: checks 
DnDcAdn9P0zGovMERigpFA: checks 
HPEB+AtKw1+C/cxU0o1ciw: checks 
K9fS1IUr5GpiJG7VkJ7IbA: checks 
*** SHOW DOWN ***
W6tExOcYX7qiy6Qdp+ZwFA: shows [5d 6h] (high card Ace)
DnDcAdn9P0zGovMERigpFA: shows [Kd Ts] (a pair of Kings)
HPEB+AtKw1+C/cxU0o1ciw: mucks hand 
K9fS1IUr5GpiJG7VkJ7IbA: mucks hand 
DnDcAdn9P0zGovMERigpFA collected $0.95 from pot
*** SUMMARY ***
Total pot $1 | Rake $0.05 
Board [3s Kc Jh Ac 8h]
Seat 1: w1ukf8uPa4+WH561TtVRxA folded before Flop (didn't bet)
Seat 2: Th3FldXKQW6hWVVPahaoOQ folded before Flop (didn't bet)
Seat 3: K9fS1IUr5GpiJG7VkJ7IbA mucked
Seat 4: RHqgdFvufLCYe54+qd2gcA folded before Flop (didn't bet)
Seat 5: MtVtHDqIJTyUcXkRBBDIVA (button) folded before Flop (didn't bet)
Seat 7: W6tExOcYX7qiy6Qdp+ZwFA (small blind) showed [5d 6h] and lost with high card Ace
Seat 8: DnDcAdn9P0zGovMERigpFA (big blind) showed [Kd Ts] and won ($0.95) with a pair of Kings
Seat 9: HPEB+AtKw1+C/cxU0o1ciw mucked




PokerStars Game #59941978874:  Hold'em No Limit ($0.10/$0.25) - 2009/07/01 1:52:13 ET
Table 'JPFXJXa5xBkjZ/W15BKqeQ' 9-max Seat #4 is the button
Seat 1: zgi+EUykT/pZQpoUG6+oEg ($4.75 in chips) 
Seat 2: XMSS6mD5B42I8wasdOMipQ ($12.75 in chips) 
Seat 3: 56S3mA6Zs3pGR+0p0vUCtg ($19.55 in chips) 
Seat 4: wGigCmBR/9XWkPpvYos3aQ ($32.55 in chips) 
Seat 5: cZ99hugmLBj9KhTlc8nCSw ($25.35 in chips) 
Seat 6: tLcDklc2rBORNfixyRfVfw ($25 in chips) 
Seat 7: PdIasPkzm2sqZnN41ZRXOg ($5 in chips) 
Seat 9: V6p0jQ/RhUsqpHLmXvEX4Q ($12.25 in chips) 
cZ99hugmLBj9KhTlc8nCSw: posts small blind $0.10
tLcDklc2rBORNfixyRfVfw: posts big blind $0.25
*** HOLE CARDS ***
PdIasPkzm2sqZnN41ZRXOg: folds 
V6p0jQ/RhUsqpHLmXvEX4Q: folds 
zgi+EUykT/pZQpoUG6+oEg: raises $0.75 to $1
XMSS6mD5B42I8wasdOMipQ: folds 
56S3mA6Zs3pGR+0p0vUCtg: folds 
wGigCmBR/9XWkPpvYos3aQ: folds 
cZ99hugmLBj9KhTlc8nCSw: folds 
tLcDklc2rBORNfixyRfVfw: folds 
Uncalled bet ($0.75) returned to zgi+EUykT/pZQpoUG6+oEg
zgi+EUykT/pZQpoUG6+oEg collected $0.60 from pot
zgi+EUykT/pZQpoUG6+oEg: doesn't show hand 
*** SUMMARY ***
Total pot $0.60 | Rake $0 
Seat 1: zgi+EUykT/pZQpoUG6+oEg collected ($0.60)
Seat 2: XMSS6mD5B42I8wasdOMipQ folded before Flop (didn't bet)
Seat 3: 56S3mA6Zs3pGR+0p0vUCtg folded before Flop (didn't bet)
Seat 4: wGigCmBR/9XWkPpvYos3aQ (button) folded before Flop (didn't bet)
Seat 5: cZ99hugmLBj9KhTlc8nCSw (small blind) folded before Flop
Seat 6: tLcDklc2rBORNfixyRfVfw (big blind) folded before Flop
Seat 7: PdIasPkzm2sqZnN41ZRXOg folded before Flop (didn't bet)
Seat 9: V6p0jQ/RhUsqpHLmXvEX4Q folded before Flop (didn't bet)




PokerStars Game #59941978876:  Hold'em No Limit ($0.10/$0.25) - 2009/07/01 1:52:13 ET
Table 'AJGgX1ZYM8d68SWMvaLttg' 6-max Seat #2 is the button
Seat 1: Q1uciOZPBR/WkAlqa6cL4A ($25 in chips) 
Seat 2: zHHLkD2sRljslKKeQv/ZQw ($26.85 in chips) 
Seat 3: 8ClCHtFXGNplITm+63KB+Q ($38.70 in chips) 
Seat 4: e30C3DfdG5TfPnR16/oMmA ($21.75 in chips) 
Seat 6: UA5OsKS3VPaxa7uC8La/kA ($62.25 in chips) 
8ClCHtFXGNplITm+63KB+Q: posts small blind $0.10
e30C3DfdG5TfPnR16/oMmA: posts big blind $0.25
GbCVUNssQ7mqsPWr7J4d3w: sits out 
*** HOLE CARDS ***
UA5OsKS3VPaxa7uC8La/kA: folds 
Q1uciOZPBR/WkAlqa6cL4A: folds 
zHHLkD2sRljslKKeQv/ZQw: calls $0.25
8ClCHtFXGNplITm+63KB+Q: calls $0.15
e30C3DfdG5TfPnR16/oMmA: checks 
*** FLOP *** [4c Qd 8d]
8ClCHtFXGNplITm+63KB+Q: checks 
e30C3DfdG5TfPnR16/oMmA: checks 
zHHLkD2sRljslKKeQv/ZQw: checks 
*** TURN *** [4c Qd 8d] [7h]
8ClCHtFXGNplITm+63KB+Q: checks 
e30C3DfdG5TfPnR16/oMmA: bets $0.50
zHHLkD2sRljslKKeQv/ZQw: folds 
8ClCHtFXGNplITm+63KB+Q: folds 
Uncalled bet ($0.50) returned to e30C3DfdG5TfPnR16/oMmA
e30C3DfdG5TfPnR16/oMmA collected $0.75 from pot
*** SUMMARY ***
Total pot $0.75 | Rake $0 
Board [4c Qd 8d 7h]
Seat 1: Q1uciOZPBR/WkAlqa6cL4A folded before Flop (didn't bet)
Seat 2: zHHLkD2sRljslKKeQv/ZQw (button) folded on the Turn
Seat 3: 8ClCHtFXGNplITm+63KB+Q (small blind) folded on the Turn
Seat 4: e30C3DfdG5TfPnR16/oMmA (big blind) collected ($0.75)
Seat 6: UA5OsKS3VPaxa7uC8La/kA folded before Flop (didn't bet)




PokerStars Game #59941978734:  Hold'em No Limit ($0.10/$0.25) - 2009/07/01 1:52:13 ET
Table 'M8kYidAX3ib7pLKW7edFLw' 6-max Seat #3 is the button
Seat 1: jp34e617tIzV8tKIWmfAbA ($26.30 in chips) 
Seat 2: ypmjhffk/YHGc51wgVXUTw ($25 in chips) 
Seat 3: cezpHJ8FB07dj0xG+LhOvw ($27.05 in chips) 
Seat 5: GbCVUNssQ7mqsPWr7J4d3w ($5.10 in chips) 
Seat 6: NqFoyDgzLwu4dOmSRXnFBA ($22.85 in chips) 
GbCVUNssQ7mqsPWr7J4d3w: posts small blind $0.10
NqFoyDgzLwu4dOmSRXnFBA: posts big blind $0.25
*** HOLE CARDS ***
jp34e617tIzV8tKIWmfAbA: folds 
ypmjhffk/YHGc51wgVXUTw: folds 
cezpHJ8FB07dj0xG+LhOvw: folds 
GbCVUNssQ7mqsPWr7J4d3w: raises $0.50 to $0.75
NqFoyDgzLwu4dOmSRXnFBA: raises $0.50 to $1.25
GbCVUNssQ7mqsPWr7J4d3w: calls $0.50
*** FLOP *** [4c 3h 5s]
GbCVUNssQ7mqsPWr7J4d3w: bets $1.75
UVeaJWNWVmtZSJnZBmf8ZQ joins the table at seat #4 
NqFoyDgzLwu4dOmSRXnFBA has timed out
NqFoyDgzLwu4dOmSRXnFBA: folds 
Uncalled bet ($1.75) returned to GbCVUNssQ7mqsPWr7J4d3w
NqFoyDgzLwu4dOmSRXnFBA is sitting out
ypmjhffk/YHGc51wgVXUTw leaves the table
GbCVUNssQ7mqsPWr7J4d3w collected $2.40 from pot
GbCVUNssQ7mqsPWr7J4d3w: doesn't show hand 
*** SUMMARY ***
Total pot $2.50 | Rake $0.10 
Board [4c 3h 5s]
Seat 1: jp34e617tIzV8tKIWmfAbA folded before Flop (didn't bet)
Seat 2: ypmjhffk/YHGc51wgVXUTw folded before Flop (didn't bet)
Seat 3: cezpHJ8FB07dj0xG+LhOvw (button) folded before Flop (didn't bet)
Seat 5: GbCVUNssQ7mqsPWr7J4d3w (small blind) collected ($2.40)
Seat 6: NqFoyDgzLwu4dOmSRXnFBA (big blind) folded on the Flop




PokerStars Game #59941978658:  Hold'em No Limit ($0.10/$0.25) - 2009/07/01 1:52:13 ET
Table 'jdhJTJjFq2KTttwJcd+7nQ' 6-max Seat #3 is the button
Seat 1: LtASJ9OlkqGrrUKGQlpGAw ($26.15 in chips) 
Seat 3: vqWjZmdQu/Hxw96/IJTWdQ ($30.20 in chips) 
Seat 4: vx7FwRcelVSsvNYAdp/z0A ($4.95 in chips) 
Seat 5: BV+K0Phf5VBHr7aZPKqbUQ ($31.30 in chips) 
Seat 6: yb6rnd48JuBccThV68VHAQ ($15.75 in chips) 
vx7FwRcelVSsvNYAdp/z0A: posts small blind $0.10
BV+K0Phf5VBHr7aZPKqbUQ: posts big blind $0.25
*** HOLE CARDS ***
yb6rnd48JuBccThV68VHAQ: folds 
LtASJ9OlkqGrrUKGQlpGAw: folds 
vqWjZmdQu/Hxw96/IJTWdQ: folds 
vx7FwRcelVSsvNYAdp/z0A: calls $0.15
BV+K0Phf5VBHr7aZPKqbUQ: checks 
*** FLOP *** [Tc 6h 6s]
vx7FwRcelVSsvNYAdp/z0A: checks 
BV+K0Phf5VBHr7aZPKqbUQ: checks 
*** TURN *** [Tc 6h 6s] [8c]
vx7FwRcelVSsvNYAdp/z0A: bets $0.25
BV+K0Phf5VBHr7aZPKqbUQ: folds 
Uncalled bet ($0.25) returned to vx7FwRcelVSsvNYAdp/z0A
vx7FwRcelVSsvNYAdp/z0A collected $0.50 from pot
*** SUMMARY ***
Total pot $0.50 | Rake $0 
Board [Tc 6h 6s 8c]
Seat 1: LtASJ9OlkqGrrUKGQlpGAw folded before Flop (didn't bet)
Seat 3: vqWjZmdQu/Hxw96/IJTWdQ (button) folded before Flop (didn't bet)
Seat 4: vx7FwRcelVSsvNYAdp/z0A (small blind) collected ($0.50)
Seat 5: BV+K0Phf5VBHr7aZPKqbUQ (big blind) folded on the Turn
Seat 6: yb6rnd48JuBccThV68VHAQ folded before Flop (didn't bet)




PokerStars Game #59941978756:  Hold'em No Limit ($0.10/$0.25) - 2009/07/01 1:52:13 ET
Table 'U0hCzoS0KCJL+eoE054K4Q' 9-max Seat #8 is the button
Seat 1: XVEauYThJRhSTUAMxB/2ow ($37.90 in chips) 
Seat 2: MG90wfSJZnOejs/KD3vlQQ ($29.20 in chips) 
Seat 3: 8Cp1H3sSs8+jTTwLfeYKcw ($25.55 in chips) 
Seat 4: Bb42QRQMhg5/Y0vHP8/2Xw ($25 in chips) 
Seat 5: zgi+EUykT/pZQpoUG6+oEg ($5.65 in chips) 
Seat 6: V6p0jQ/RhUsqpHLmXvEX4Q ($11.55 in chips) 
Seat 7: uetHVityNsFnyX2bBnKe2A ($18 in chips) 
Seat 8: K0b5wNInj6hUGRr6yzKFtw ($27.10 in chips) 
Seat 9: wGigCmBR/9XWkPpvYos3aQ ($34 in chips) 
wGigCmBR/9XWkPpvYos3aQ: posts small blind $0.10
XVEauYThJRhSTUAMxB/2ow: posts big blind $0.25
*** HOLE CARDS ***
MG90wfSJZnOejs/KD3vlQQ: folds 
8Cp1H3sSs8+jTTwLfeYKcw: calls $0.25
Bb42QRQMhg5/Y0vHP8/2Xw: folds 
zgi+EUykT/pZQpoUG6+oEg: folds 
V6p0jQ/RhUsqpHLmXvEX4Q: folds 
uetHVityNsFnyX2bBnKe2A: folds 
K0b5wNInj6hUGRr6yzKFtw: folds 
wGigCmBR/9XWkPpvYos3aQ: calls $0.15
XVEauYThJRhSTUAMxB/2ow: raises $0.75 to $1
8Cp1H3sSs8+jTTwLfeYKcw: calls $0.75
wGigCmBR/9XWkPpvYos3aQ: folds 
*** FLOP *** [6c 8h 4s]
XVEauYThJRhSTUAMxB/2ow: bets $0.75
8Cp1H3sSs8+jTTwLfeYKcw: calls $0.75
*** TURN *** [6c 8h 4s] [8s]
XVEauYThJRhSTUAMxB/2ow: checks 
8Cp1H3sSs8+jTTwLfeYKcw: bets $3
XVEauYThJRhSTUAMxB/2ow: folds 
Uncalled bet ($3) returned to 8Cp1H3sSs8+jTTwLfeYKcw
8Cp1H3sSs8+jTTwLfeYKcw collected $3.60 from pot
8Cp1H3sSs8+jTTwLfeYKcw: doesn't show hand 
*** SUMMARY ***
Total pot $3.75 | Rake $0.15 
Board [6c 8h 4s 8s]
Seat 1: XVEauYThJRhSTUAMxB/2ow (big blind) folded on the Turn
Seat 2: MG90wfSJZnOejs/KD3vlQQ folded before Flop (didn't bet)
Seat 3: 8Cp1H3sSs8+jTTwLfeYKcw collected ($3.60)
Seat 4: Bb42QRQMhg5/Y0vHP8/2Xw folded before Flop (didn't bet)
Seat 5: zgi+EUykT/pZQpoUG6+oEg folded before Flop (didn't bet)
Seat 6: V6p0jQ/RhUsqpHLmXvEX4Q folded before Flop (didn't bet)
Seat 7: uetHVityNsFnyX2bBnKe2A folded before Flop (didn't bet)
Seat 8: K0b5wNInj6hUGRr6yzKFtw (button) folded before Flop (didn't bet)
Seat 9: wGigCmBR/9XWkPpvYos3aQ (small blind) folded before Flop




PokerStars Game #59941979114:  Hold'em No Limit ($0.10/$0.25) - 2009/07/01 1:52:14 ET
Table 'BabJGL6tfXQp3leBGbYe8A' 9-max Seat #2 is the button
Seat 1: qwr38jl5txoR36M7G5qi4A ($10.35 in chips) 
Seat 2: dtZ84flFEi4Q+SGrHMJRDQ ($40.15 in chips) 
Seat 3: sD+TKtt36XiiN6jqHiLwDA ($27.55 in chips) 
Seat 4: gehe91e0IyVT0QU/XBkEyg ($27.85 in chips) 
Seat 5: GrNTWMdwy+jC6Lred1eDng ($10.35 in chips) 
Seat 6: egvg3mTBBVzMHnJPIQiKcA ($15.40 in chips) 
Seat 7: eK8qa6EPcH2zhtbmWSvc9g ($28.20 in chips) 
Seat 8: OXPkK84/qv92EMwXPiG5rQ ($9.75 in chips) 
Seat 9: P+9ymZQ3ktpQu1bn7HIjew ($9.15 in chips) 
sD+TKtt36XiiN6jqHiLwDA: posts small blind $0.10
gehe91e0IyVT0QU/XBkEyg: posts big blind $0.25
*** HOLE CARDS ***
GrNTWMdwy+jC6Lred1eDng: folds 
egvg3mTBBVzMHnJPIQiKcA: calls $0.25
eK8qa6EPcH2zhtbmWSvc9g: folds 
OXPkK84/qv92EMwXPiG5rQ: folds 
P+9ymZQ3ktpQu1bn7HIjew: folds 
qwr38jl5txoR36M7G5qi4A: folds 
dtZ84flFEi4Q+SGrHMJRDQ: folds 
sD+TKtt36XiiN6jqHiLwDA: folds 
gehe91e0IyVT0QU/XBkEyg: checks 
*** FLOP *** [Ah 7d 4h]
gehe91e0IyVT0QU/XBkEyg: checks 
egvg3mTBBVzMHnJPIQiKcA: bets $0.50
gehe91e0IyVT0QU/XBkEyg: folds 
Uncalled bet ($0.50) returned to egvg3mTBBVzMHnJPIQiKcA
egvg3mTBBVzMHnJPIQiKcA collected $0.60 from pot
egvg3mTBBVzMHnJPIQiKcA: doesn't show hand 
*** SUMMARY ***
Total pot $0.60 | Rake $0 
Board [Ah 7d 4h]
Seat 1: qwr38jl5txoR36M7G5qi4A folded before Flop (didn't bet)
Seat 2: dtZ84flFEi4Q+SGrHMJRDQ (button) folded before Flop (didn't bet)
Seat 3: sD+TKtt36XiiN6jqHiLwDA (small blind) folded before Flop
Seat 4: gehe91e0IyVT0QU/XBkEyg (big blind) folded on the Flop
Seat 5: GrNTWMdwy+jC6Lred1eDng folded before Flop (didn't bet)
Seat 6: egvg3mTBBVzMHnJPIQiKcA collected ($0.60)
Seat 7: eK8qa6EPcH2zhtbmWSvc9g folded before Flop (didn't bet)
Seat 8: OXPkK84/qv92EMwXPiG5rQ folded before Flop (didn't bet)
Seat 9: P+9ymZQ3ktpQu1bn7HIjew folded before Flop (didn't bet)




PokerStars Game #59941978994:  Hold'em No Limit ($0.10/$0.25) - 2009/07/01 1:52:14 ET
Table '63h13e5p7cWe02rClZ1CHw' 6-max Seat #6 is the button
Seat 1: pokjbbEcXXPlADXdSGHtZw ($21.10 in chips) 
Seat 2: k9nHZTHt8hYhYRcW8NTb4g ($25.65 in chips) 
Seat 4: xrf8tAXKQHG99HixCot1Iw ($28 in chips) 
Seat 5: iyZxqznXjv3vtvOJymkoLQ ($44.10 in chips) 
Seat 6: mfrkWA3PTeYPkbO6hi98Aw ($38.10 in chips) 
pokjbbEcXXPlADXdSGHtZw: posts small blind $0.10
k9nHZTHt8hYhYRcW8NTb4g: posts big blind $0.25
*** HOLE CARDS ***
xrf8tAXKQHG99HixCot1Iw: folds 
iyZxqznXjv3vtvOJymkoLQ: folds 
mfrkWA3PTeYPkbO6hi98Aw: folds 
pokjbbEcXXPlADXdSGHtZw: raises $0.75 to $1
k9nHZTHt8hYhYRcW8NTb4g: calls $0.75
*** FLOP *** [Jh 8s Qs]
pokjbbEcXXPlADXdSGHtZw: bets $1
k9nHZTHt8hYhYRcW8NTb4g: folds 
Uncalled bet ($1) returned to pokjbbEcXXPlADXdSGHtZw
pokjbbEcXXPlADXdSGHtZw collected $1.90 from pot
*** SUMMARY ***
Total pot $2 | Rake $0.10 
Board [Jh 8s Qs]
Seat 1: pokjbbEcXXPlADXdSGHtZw (small blind) collected ($1.90)
Seat 2: k9nHZTHt8hYhYRcW8NTb4g (big blind) folded on the Flop
Seat 4: xrf8tAXKQHG99HixCot1Iw folded before Flop (didn't bet)
Seat 5: iyZxqznXjv3vtvOJymkoLQ folded before Flop (didn't bet)
Seat 6: mfrkWA3PTeYPkbO6hi98Aw (button) folded before Flop (didn't bet)




PokerStars Game #59941979202:  Hold'em No Limit ($0.10/$0.25) - 2009/07/01 1:52:14 ET
Table '5SUMWYuPsGiOD0FY0QbgOw' 6-max Seat #3 is the button
Seat 1: SFmT9ZsVopnukjvAzrxTRg ($25 in chips) 
Seat 2: xrf8tAXKQHG99HixCot1Iw ($40.25 in chips) 
Seat 3: i9LqF5rD3bvtbEE7HWgr3Q ($47.10 in chips) 
Seat 4: BV+K0Phf5VBHr7aZPKqbUQ ($25.85 in chips) 
Seat 5: v+QfkGiuj9bgtuNoVnDO8w ($40.45 in chips) 
BV+K0Phf5VBHr7aZPKqbUQ: posts small blind $0.10
v+QfkGiuj9bgtuNoVnDO8w: posts big blind $0.25
*** HOLE CARDS ***
SFmT9ZsVopnukjvAzrxTRg: folds 
/CiXFpjc64KAfloGDN7A/Q joins the table at seat #6 
xrf8tAXKQHG99HixCot1Iw: raises $0.50 to $0.75
i9LqF5rD3bvtbEE7HWgr3Q: folds 
BV+K0Phf5VBHr7aZPKqbUQ: folds 
v+QfkGiuj9bgtuNoVnDO8w: folds 
Uncalled bet ($0.50) returned to xrf8tAXKQHG99HixCot1Iw
xrf8tAXKQHG99HixCot1Iw collected $0.60 from pot
xrf8tAXKQHG99HixCot1Iw: doesn't show hand 
*** SUMMARY ***
Total pot $0.60 | Rake $0 
Seat 1: SFmT9ZsVopnukjvAzrxTRg folded before Flop (didn't bet)
Seat 2: xrf8tAXKQHG99HixCot1Iw collected ($0.60)
Seat 3: i9LqF5rD3bvtbEE7HWgr3Q (button) folded before Flop (didn't bet)
Seat 4: BV+K0Phf5VBHr7aZPKqbUQ (small blind) folded before Flop
Seat 5: v+QfkGiuj9bgtuNoVnDO8w (big blind) folded before Flop




PokerStars Game #59941978980:  Hold'em No Limit ($0.10/$0.25) - 2009/07/01 1:52:14 ET
Table 'rjcb+nlE+0GuJ6lBhuCkkA' 6-max Seat #3 is the button
Seat 1: lBoEwOFgzcERLIRUkUoRTw ($12.55 in chips) 
Seat 3: 8ClCHtFXGNplITm+63KB+Q ($65.50 in chips) 
Seat 4: BV+K0Phf5VBHr7aZPKqbUQ ($35.60 in chips) 
Seat 5: GC/9yVD59DUCX7hUI7gcLw ($30.15 in chips) 
Seat 6: 32YL2ZEp8NT4JB2RVM9euQ ($16.40 in chips) 
BV+K0Phf5VBHr7aZPKqbUQ: posts small blind $0.10
GC/9yVD59DUCX7hUI7gcLw: posts big blind $0.25
*** HOLE CARDS ***
32YL2ZEp8NT4JB2RVM9euQ: folds 
lBoEwOFgzcERLIRUkUoRTw: folds 
32YL2ZEp8NT4JB2RVM9euQ leaves the table
8ClCHtFXGNplITm+63KB+Q: folds 
BV+K0Phf5VBHr7aZPKqbUQ: folds 
Uncalled bet ($0.15) returned to GC/9yVD59DUCX7hUI7gcLw
GC/9yVD59DUCX7hUI7gcLw collected $0.20 from pot
*** SUMMARY ***
Total pot $0.20 | Rake $0 
Seat 1: lBoEwOFgzcERLIRUkUoRTw folded before Flop (didn't bet)
Seat 3: 8ClCHtFXGNplITm+63KB+Q (button) folded before Flop (didn't bet)
Seat 4: BV+K0Phf5VBHr7aZPKqbUQ (small blind) folded before Flop
Seat 5: GC/9yVD59DUCX7hUI7gcLw (big blind) collected ($0.20)
Seat 6: 32YL2ZEp8NT4JB2RVM9euQ folded before Flop (didn't bet)




PokerStars Game #59941979424:  Hold'em No Limit ($0.10/$0.25) - 2009/07/01 1:52:14 ET
Table 'C47I7CmrmFr8Oo7wOovVwQ' 6-max Seat #5 is the button
Seat 1: aKCh+0w6BCOX3sJAdIVLMw ($5.35 in chips) 
Seat 2: 8JTm/CXBn3+kuQgcUOgPkw ($24.40 in chips) 
Seat 4: yY5JuFtDfXWRaZlVby4LLw ($9.10 in chips) 
Seat 5: or309yYY9Y9bfFWtrB0yUg ($5.10 in chips) 
Seat 6: pD7ri5wL3vsa6S1ulMYQmQ ($26.35 in chips) 
pD7ri5wL3vsa6S1ulMYQmQ: posts small blind $0.10
aKCh+0w6BCOX3sJAdIVLMw: posts big blind $0.25
p4qhycZstfeeDkKv3zEBjw: sits out 
*** HOLE CARDS ***
8JTm/CXBn3+kuQgcUOgPkw: folds 
yY5JuFtDfXWRaZlVby4LLw: calls $0.25
or309yYY9Y9bfFWtrB0yUg: folds 
pD7ri5wL3vsa6S1ulMYQmQ: folds 
aKCh+0w6BCOX3sJAdIVLMw: checks 
*** FLOP *** [2d 9h 4c]
aKCh+0w6BCOX3sJAdIVLMw: checks 
yY5JuFtDfXWRaZlVby4LLw: checks 
*** TURN *** [2d 9h 4c] [4d]
aKCh+0w6BCOX3sJAdIVLMw: bets $0.25
yY5JuFtDfXWRaZlVby4LLw: calls $0.25
*** RIVER *** [2d 9h 4c 4d] [Ks]
aKCh+0w6BCOX3sJAdIVLMw: bets $0.50
yY5JuFtDfXWRaZlVby4LLw: folds 
Uncalled bet ($0.50) returned to aKCh+0w6BCOX3sJAdIVLMw
aKCh+0w6BCOX3sJAdIVLMw collected $1.05 from pot
aKCh+0w6BCOX3sJAdIVLMw: doesn't show hand 
*** SUMMARY ***
Total pot $1.10 | Rake $0.05 
Board [2d 9h 4c 4d Ks]
Seat 1: aKCh+0w6BCOX3sJAdIVLMw (big blind) collected ($1.05)
Seat 2: 8JTm/CXBn3+kuQgcUOgPkw folded before Flop (didn't bet)
Seat 4: yY5JuFtDfXWRaZlVby4LLw folded on the River
Seat 5: or309yYY9Y9bfFWtrB0yUg (button) folded before Flop (didn't bet)
Seat 6: pD7ri5wL3vsa6S1ulMYQmQ (small blind) folded before Flop




PokerStars Game #59941979200:  Hold'em No Limit ($0.10/$0.25) - 2009/07/01 1:52:14 ET
Table '972HGIb0tQN/zRIK4TABEw' 9-max Seat #5 is the button
Seat 1: fHr2+mGa0RFK3qrpZcVUAQ ($11.90 in chips) 
Seat 4: aSrj4lVmn2owyQ1RbbOqxQ ($4.60 in chips) 
Seat 5: n+stbTneifqFNME+tpoGrw ($26.40 in chips) 
fHr2+mGa0RFK3qrpZcVUAQ: posts small blind $0.10
aSrj4lVmn2owyQ1RbbOqxQ: posts big blind $0.25
*** HOLE CARDS ***
n+stbTneifqFNME+tpoGrw: calls $0.25
fHr2+mGa0RFK3qrpZcVUAQ: folds 
aSrj4lVmn2owyQ1RbbOqxQ: checks 
*** FLOP *** [9d 4d 4s]
fHr2+mGa0RFK3qrpZcVUAQ leaves the table
aSrj4lVmn2owyQ1RbbOqxQ: checks 
n+stbTneifqFNME+tpoGrw: checks 
*** TURN *** [9d 4d 4s] [5c]
aSrj4lVmn2owyQ1RbbOqxQ: checks 
n+stbTneifqFNME+tpoGrw: bets $0.25
xmdItDBraeGrrs3wzz1J3w joins the table at seat #1 
aSrj4lVmn2owyQ1RbbOqxQ: folds 
Uncalled bet ($0.25) returned to n+stbTneifqFNME+tpoGrw
n+stbTneifqFNME+tpoGrw collected $0.60 from pot
n+stbTneifqFNME+tpoGrw: doesn't show hand 
*** SUMMARY ***
Total pot $0.60 | Rake $0 
Board [9d 4d 4s 5c]
Seat 1: fHr2+mGa0RFK3qrpZcVUAQ (small blind) folded before Flop
Seat 4: aSrj4lVmn2owyQ1RbbOqxQ (big blind) folded on the Turn
Seat 5: n+stbTneifqFNME+tpoGrw (button) collected ($0.60)




PokerStars Game #59941979338:  Hold'em No Limit ($0.10/$0.25) - 2009/07/01 1:52:14 ET
Table 'R5qKG21jwFDYRcOht9qwqQ' 9-max Seat #6 is the button
Seat 1: N5sUK8M0br9djLrW97V9pQ ($24.15 in chips) 
Seat 2: N6foVRyErHqcNmshkqextQ ($13.45 in chips) 
Seat 3: M2QO2DxB5Wawg2h8HSpnYA ($10.50 in chips) 
Seat 6: EP17SQz/iWcuYdNOGeBgkw ($15.40 in chips) 
Seat 7: zgi+EUykT/pZQpoUG6+oEg ($4.15 in chips) 
Seat 8: hYvTc4PYNrAaNAIVoM94Hw ($5.10 in chips) 
Seat 9: MG90wfSJZnOejs/KD3vlQQ ($38.30 in chips) 
zgi+EUykT/pZQpoUG6+oEg: posts small blind $0.10
hYvTc4PYNrAaNAIVoM94Hw: posts big blind $0.25
z5GxcHlYz/GSz6W2uFiTtg: sits out 
*** HOLE CARDS ***
MG90wfSJZnOejs/KD3vlQQ: raises $0.50 to $0.75
N5sUK8M0br9djLrW97V9pQ: folds 
N6foVRyErHqcNmshkqextQ: folds 
M2QO2DxB5Wawg2h8HSpnYA: folds 
EP17SQz/iWcuYdNOGeBgkw: calls $0.75
zgi+EUykT/pZQpoUG6+oEg: folds 
hYvTc4PYNrAaNAIVoM94Hw: calls $0.50
*** FLOP *** [2d 5c Ad]
hYvTc4PYNrAaNAIVoM94Hw: bets $0.75
MG90wfSJZnOejs/KD3vlQQ: raises $3.75 to $4.50
EP17SQz/iWcuYdNOGeBgkw: folds 
hYvTc4PYNrAaNAIVoM94Hw: calls $3.60 and is all-in
Uncalled bet ($0.15) returned to MG90wfSJZnOejs/KD3vlQQ
*** TURN *** [2d 5c Ad] [Tc]
*** RIVER *** [2d 5c Ad Tc] [7c]
*** SHOW DOWN ***
hYvTc4PYNrAaNAIVoM94Hw: shows [4h Ah] (a pair of Aces)
MG90wfSJZnOejs/KD3vlQQ: shows [As Qc] (a pair of Aces - Queen kicker)
MG90wfSJZnOejs/KD3vlQQ collected $10.55 from pot
*** SUMMARY ***
Total pot $11.05 | Rake $0.50 
Board [2d 5c Ad Tc 7c]
Seat 1: N5sUK8M0br9djLrW97V9pQ folded before Flop (didn't bet)
Seat 2: N6foVRyErHqcNmshkqextQ folded before Flop (didn't bet)
Seat 3: M2QO2DxB5Wawg2h8HSpnYA folded before Flop (didn't bet)
Seat 6: EP17SQz/iWcuYdNOGeBgkw (button) folded on the Flop
Seat 7: zgi+EUykT/pZQpoUG6+oEg (small blind) folded before Flop
Seat 8: hYvTc4PYNrAaNAIVoM94Hw (big blind) showed [4h Ah] and lost with a pair of Aces
Seat 9: MG90wfSJZnOejs/KD3vlQQ showed [As Qc] and won ($10.55) with a pair of Aces




PokerStars Game #59941979800:  Hold'em No Limit ($0.10/$0.25) - 2009/07/01 1:52:15 ET
Table 'SHi8+hK6i7E2dJ/3Agbyig' 6-max Seat #4 is the button
Seat 1: gPEN9Zp33YTm/mu9/SYP1w ($27.05 in chips) 
Seat 2: LJI7A1YgDM7hgh7o56+ReQ ($25 in chips) 
Seat 3: VXTONriS+Ohik+r0FeicIw ($25 in chips) 
Seat 4: u0ikXOhAPSCLmg+l17oGRw ($21.85 in chips) 
Seat 5: v8m8XHovI5tqEA9mvplDSw ($48.20 in chips) 
Seat 6: cWc85bEzdRzpUMhRKm8pwQ ($34.85 in chips) 
v8m8XHovI5tqEA9mvplDSw: posts small blind $0.10
cWc85bEzdRzpUMhRKm8pwQ: posts big blind $0.25
*** HOLE CARDS ***
gPEN9Zp33YTm/mu9/SYP1w: raises $1 to $1.25
LJI7A1YgDM7hgh7o56+ReQ: folds 
VXTONriS+Ohik+r0FeicIw: folds 
u0ikXOhAPSCLmg+l17oGRw: folds 
v8m8XHovI5tqEA9mvplDSw: calls $1.15
cWc85bEzdRzpUMhRKm8pwQ: folds 
*** FLOP *** [6c 9h Jd]
v8m8XHovI5tqEA9mvplDSw: checks 
gPEN9Zp33YTm/mu9/SYP1w: bets $2.50
v8m8XHovI5tqEA9mvplDSw: calls $2.50
*** TURN *** [6c 9h Jd] [4s]
v8m8XHovI5tqEA9mvplDSw: checks 
gPEN9Zp33YTm/mu9/SYP1w: checks 
*** RIVER *** [6c 9h Jd 4s] [6s]
v8m8XHovI5tqEA9mvplDSw: bets $5.25
gPEN9Zp33YTm/mu9/SYP1w: calls $5.25
*** SHOW DOWN ***
v8m8XHovI5tqEA9mvplDSw: shows [8d 8h] (two pair, Eights and Sixes)
gPEN9Zp33YTm/mu9/SYP1w: mucks hand 
v8m8XHovI5tqEA9mvplDSw collected $17.40 from pot
*** SUMMARY ***
Total pot $18.25 | Rake $0.85 
Board [6c 9h Jd 4s 6s]
Seat 1: gPEN9Zp33YTm/mu9/SYP1w mucked
Seat 2: LJI7A1YgDM7hgh7o56+ReQ folded before Flop (didn't bet)
Seat 3: VXTONriS+Ohik+r0FeicIw folded before Flop (didn't bet)
Seat 4: u0ikXOhAPSCLmg+l17oGRw (button) folded before Flop (didn't bet)
Seat 5: v8m8XHovI5tqEA9mvplDSw (small blind) showed [8d 8h] and won ($17.40) with two pair, Eights and Sixes
Seat 6: cWc85bEzdRzpUMhRKm8pwQ (big blind) folded before Flop




PokerStars Game #59941980328:  Hold'em No Limit ($0.10/$0.25) - 2009/07/01 1:52:16 ET
Table 'oJpFwZj9+FUGHX90Un8s9Q' 6-max Seat #3 is the button
Seat 1: 6DwBRH+xZ12AAZmeAg+aXw ($25.50 in chips) 
Seat 2: NtrVQ9UIql0rDCnKDKZ5FQ ($19.65 in chips) 
Seat 3: kyRaCIljYA6l33lSKQfNsg ($24.90 in chips) 
Seat 4: 6elpmfyt4Zw0yvd8lePSMQ ($21.65 in chips) 
Seat 5: kG34n23qFQA3nzdOJTQ1dA ($59.05 in chips) 
Seat 6: 7LpHJVeM6k1mQdC6HXYzww ($25 in chips) 
6elpmfyt4Zw0yvd8lePSMQ: posts small blind $0.10
kG34n23qFQA3nzdOJTQ1dA: posts big blind $0.25
*** HOLE CARDS ***
7LpHJVeM6k1mQdC6HXYzww: folds 
6DwBRH+xZ12AAZmeAg+aXw: folds 
NtrVQ9UIql0rDCnKDKZ5FQ: folds 
kyRaCIljYA6l33lSKQfNsg: folds 
6elpmfyt4Zw0yvd8lePSMQ: calls $0.15
kG34n23qFQA3nzdOJTQ1dA: checks 
*** FLOP *** [8s 8c 6c]
6elpmfyt4Zw0yvd8lePSMQ: checks 
kG34n23qFQA3nzdOJTQ1dA: checks 
*** TURN *** [8s 8c 6c] [Jh]
6elpmfyt4Zw0yvd8lePSMQ: checks 
kG34n23qFQA3nzdOJTQ1dA: checks 
*** RIVER *** [8s 8c 6c Jh] [3s]
6elpmfyt4Zw0yvd8lePSMQ: checks 
kG34n23qFQA3nzdOJTQ1dA: checks 
*** SHOW DOWN ***
6elpmfyt4Zw0yvd8lePSMQ: shows [3d 4c] (two pair, Eights and Threes)
kG34n23qFQA3nzdOJTQ1dA: mucks hand 
6elpmfyt4Zw0yvd8lePSMQ collected $0.50 from pot
*** SUMMARY ***
Total pot $0.50 | Rake $0 
Board [8s 8c 6c Jh 3s]
Seat 1: 6DwBRH+xZ12AAZmeAg+aXw folded before Flop (didn't bet)
Seat 2: NtrVQ9UIql0rDCnKDKZ5FQ folded before Flop (didn't bet)
Seat 3: kyRaCIljYA6l33lSKQfNsg (button) folded before Flop (didn't bet)
Seat 4: 6elpmfyt4Zw0yvd8lePSMQ (small blind) showed [3d 4c] and won ($0.50) with two pair, Eights and Threes
Seat 5: kG34n23qFQA3nzdOJTQ1dA (big blind) mucked
Seat 6: 7LpHJVeM6k1mQdC6HXYzww folded before Flop (didn't bet)




PokerStars Game #59941980588:  Hold'em No Limit ($0.10/$0.25) - 2009/07/01 1:52:16 ET
Table 'pyZQRcpxhWj2y2cT/ydvww52Meibn9NOL4XtVi1p2Upwx Seat #1 is the button
Seat 1: egvg3mTBBVzMHnJPIQiKcA ($21 in chips) 
Seat 2: Th3FldXKQW6hWVVPahaoOQ ($101.55 in chips) 
Seat 3: zgi+EUykT/pZQpoUG6+oEg ($4.30 in chips) 
Seat 4: NjesyqE7PJi4nEOa0oOq9w ($18.45 in chips) 
Seat 5: 5n7e7I+px7c6CQmLpPbtsg ($4.35 in chips) 
Seat 6: uvfXVx90QtCYG4geTioN+A ($22.25 in chips) 
Seat 7: mMd8CDS/but3UC+Zp7Up2w ($19.75 in chips) 
Seat 8: ipgcO7Pa6LC8XWpVttZfnA ($4.65 in chips) 
Th3FldXKQW6hWVVPahaoOQ: posts small blind $0.10
zgi+EUykT/pZQpoUG6+oEg: posts big blind $0.25
*** HOLE CARDS ***
bC+Wg1ntzw3N48OwuR1eag leaves the table
NjesyqE7PJi4nEOa0oOq9w: folds 
5n7e7I+px7c6CQmLpPbtsg: folds 
uvfXVx90QtCYG4geTioN+A: calls $0.25
W6tExOcYX7qiy6Qdp+ZwFA joins the table at seat #9 
mMd8CDS/but3UC+Zp7Up2w: calls $0.25
ipgcO7Pa6LC8XWpVttZfnA: folds 
egvg3mTBBVzMHnJPIQiKcA: folds 
Th3FldXKQW6hWVVPahaoOQ: folds 
zgi+EUykT/pZQpoUG6+oEg: checks 
*** FLOP *** [Qd Ad Qc]
zgi+EUykT/pZQpoUG6+oEg: checks 
uvfXVx90QtCYG4geTioN+A: bets $0.25
mMd8CDS/but3UC+Zp7Up2w: calls $0.25
zgi+EUykT/pZQpoUG6+oEg: folds 
*** TURN *** [Qd Ad Qc] [Tc]
uvfXVx90QtCYG4geTioN+A: bets $0.50
mMd8CDS/but3UC+Zp7Up2w: calls $0.50
*** RIVER *** [Qd Ad Qc Tc] [9d]
uvfXVx90QtCYG4geTioN+A: checks 
mMd8CDS/but3UC+Zp7Up2w: bets $1.75
uvfXVx90QtCYG4geTioN+A: calls $1.75
*** SHOW DOWN ***
mMd8CDS/but3UC+Zp7Up2w: shows [6d 7d] (a flush, Ace high)
uvfXVx90QtCYG4geTioN+A: mucks hand 
mMd8CDS/but3UC+Zp7Up2w collected $5.60 from pot
*** SUMMARY ***
Total pot $5.85 | Rake $0.25 
Board [Qd Ad Qc Tc 9d]
Seat 1: egvg3mTBBVzMHnJPIQiKcA (button) folded before Flop (didn't bet)
Seat 2: Th3FldXKQW6hWVVPahaoOQ (small blind) folded before Flop
Seat 3: zgi+EUykT/pZQpoUG6+oEg (big blind) folded on the Flop
Seat 4: NjesyqE7PJi4nEOa0oOq9w folded before Flop (didn't bet)
Seat 5: 5n7e7I+px7c6CQmLpPbtsg folded before Flop (didn't bet)
Seat 6: uvfXVx90QtCYG4geTioN+A mucked
Seat 7: mMd8CDS/but3UC+Zp7Up2w showed [6d 7d] and won ($5.60) with a flush, Ace high
Seat 8: ipgcO7Pa6LC8XWpVttZfnA folded before Flop (didn't bet)




PokerStars Game #59941980456:  Hold'em No Limit ($0.10/$0.25) - 2009/07/01 1:52:16 ET
Table '50f2Xa1b1jp6cfdTAgXFIg' 9-max Seat #6 is the button
Seat 1: E0iYnEVO2ho7dH3QcCjw7g ($19.65 in chips) 
Seat 3: RSojRXQHk0IRANbJYopT9g ($25.95 in chips) 
Seat 4: ghNKXUBl/H+t83JF079ZBA ($27 in chips) 
Seat 5: C1w4aCCgQVVSgNijoEahAg ($15.50 in chips) 
Seat 6: tLcDklc2rBORNfixyRfVfw ($27.15 in chips) 
Seat 7: w1ukf8uPa4+WH561TtVRxA ($25 in chips) 
Seat 8: x+W5+3qsdY4Iszf0hoH+Aw ($13.05 in chips) 
Seat 9: gehe91e0IyVT0QU/XBkEyg ($25.75 in chips) 
w1ukf8uPa4+WH561TtVRxA: posts small blind $0.10
x+W5+3qsdY4Iszf0hoH+Aw: posts big blind $0.25
*** HOLE CARDS ***
gehe91e0IyVT0QU/XBkEyg: raises $0.50 to $0.75
E0iYnEVO2ho7dH3QcCjw7g: folds 
RSojRXQHk0IRANbJYopT9g: folds 
ghNKXUBl/H+t83JF079ZBA: folds 
C1w4aCCgQVVSgNijoEahAg: calls $0.75
tLcDklc2rBORNfixyRfVfw: folds 
w1ukf8uPa4+WH561TtVRxA: folds 
x+W5+3qsdY4Iszf0hoH+Aw: calls $0.50
*** FLOP *** [2s 5h Qc]
x+W5+3qsdY4Iszf0hoH+Aw: checks 
gehe91e0IyVT0QU/XBkEyg: bets $1.75
C1w4aCCgQVVSgNijoEahAg: calls $1.75
x+W5+3qsdY4Iszf0hoH+Aw: raises $1.75 to $3.50
gehe91e0IyVT0QU/XBkEyg: raises $14 to $17.50
C1w4aCCgQVVSgNijoEahAg: folds 
x+W5+3qsdY4Iszf0hoH+Aw: calls $8.80 and is all-in
Uncalled bet ($5.20) returned to gehe91e0IyVT0QU/XBkEyg
*** TURN *** [2s 5h Qc] [Kd]
*** RIVER *** [2s 5h Qc Kd] [4s]
*** SHOW DOWN ***
x+W5+3qsdY4Iszf0hoH+Aw: shows [Jd Qd] (a pair of Queens)
gehe91e0IyVT0QU/XBkEyg: shows [Ac Qs] (a pair of Queens - Ace kicker)
gehe91e0IyVT0QU/XBkEyg collected $27.30 from pot
*** SUMMARY ***
Total pot $28.70 | Rake $1.40 
Board [2s 5h Qc Kd 4s]
Seat 1: E0iYnEVO2ho7dH3QcCjw7g folded before Flop (didn't bet)
Seat 3: RSojRXQHk0IRANbJYopT9g folded before Flop (didn't bet)
Seat 4: ghNKXUBl/H+t83JF079ZBA folded before Flop (didn't bet)
Seat 5: C1w4aCCgQVVSgNijoEahAg folded on the Flop
Seat 6: tLcDklc2rBORNfixyRfVfw (button) folded before Flop (didn't bet)
Seat 7: w1ukf8uPa4+WH561TtVRxA (small blind) folded before Flop
Seat 8: x+W5+3qsdY4Iszf0hoH+Aw (big blind) showed [Jd Qd] and lost with a pair of Queens
Seat 9: gehe91e0IyVT0QU/XBkEyg showed [Ac Qs] and won ($27.30) with a pair of Queens




PokerStars Game #59941980470:  Hold'em No Limit ($0.10/$0.25) - 2009/07/01 1:52:16 ET
Table 'AUM6O+mgQAaLDZKMQ/5/gA' 9-max Seat #9 is the button
Seat 2: z5GxcHlYz/GSz6W2uFiTtg ($24.25 in chips) 
Seat 3: CvL9Ch1HYCVbTsfpNucitg ($5 in chips) 
Seat 4: 4awUyiDYTgylQKXZ9faBVA ($28.55 in chips) 
Seat 5: +2kMBNpY4nF1qNCRd8SJLA ($25 in chips) 
Seat 6: v5jnQ1gfh9nLla3kMXG7Yg ($12.70 in chips) 
Seat 7: Bb42QRQMhg5/Y0vHP8/2Xw ($28.50 in chips) 
Seat 8: zDrucyjVn5aeekNEc3cJrA ($17.05 in chips) 
Seat 9: eK8qa6EPcH2zhtbmWSvc9g ($29.35 in chips) 
SpiiQQAzy4MUgV3I5W8giw will be allowed to play after the button
z5GxcHlYz/GSz6W2uFiTtg: posts small blind $0.10
CvL9Ch1HYCVbTsfpNucitg: posts big blind $0.25
*** HOLE CARDS ***
4awUyiDYTgylQKXZ9faBVA: folds 
+2kMBNpY4nF1qNCRd8SJLA: folds 
v5jnQ1gfh9nLla3kMXG7Yg: calls $0.25
Bb42QRQMhg5/Y0vHP8/2Xw: folds 
zDrucyjVn5aeekNEc3cJrA: folds 
eK8qa6EPcH2zhtbmWSvc9g: folds 
z5GxcHlYz/GSz6W2uFiTtg: calls $0.15
CvL9Ch1HYCVbTsfpNucitg: checks 
*** FLOP *** [9h 2s 6h]
z5GxcHlYz/GSz6W2uFiTtg: bets $0.25
CvL9Ch1HYCVbTsfpNucitg: folds 
v5jnQ1gfh9nLla3kMXG7Yg: calls $0.25
*** TURN *** [9h 2s 6h] [Kc]
z5GxcHlYz/GSz6W2uFiTtg: checks 
v5jnQ1gfh9nLla3kMXG7Yg: checks 
*** RIVER *** [9h 2s 6h Kc] [9d]
z5GxcHlYz/GSz6W2uFiTtg: checks 
v5jnQ1gfh9nLla3kMXG7Yg: folds 
z5GxcHlYz/GSz6W2uFiTtg collected $1.20 from pot
*** SUMMARY ***
Total pot $1.25 | Rake $0.05 
Board [9h 2s 6h Kc 9d]
Seat 2: z5GxcHlYz/GSz6W2uFiTtg (small blind) collected ($1.20)
Seat 3: CvL9Ch1HYCVbTsfpNucitg (big blind) folded on the Flop
Seat 4: 4awUyiDYTgylQKXZ9faBVA folded before Flop (didn't bet)
Seat 5: +2kMBNpY4nF1qNCRd8SJLA folded before Flop (didn't bet)
Seat 6: v5jnQ1gfh9nLla3kMXG7Yg folded on the River
Seat 7: Bb42QRQMhg5/Y0vHP8/2Xw folded before Flop (didn't bet)
Seat 8: zDrucyjVn5aeekNEc3cJrA folded before Flop (didn't bet)
Seat 9: eK8qa6EPcH2zhtbmWSvc9g (button) folded before Flop (didn't bet)




PokerStars Game #59941980494:  Hold'em No Limit ($0.10/$0.25) - 2009/07/01 1:52:16 ET
Table 'xPn6TS/y/OWkX7Qa+MUuKA' 6-max Seat #3 is the button
Seat 1: JFIAqU8lCZ0vWwEl4bdGsg ($42.35 in chips) 
Seat 3: q6WfTUAD9mowIP63ASq2Dg ($23.90 in chips) 
Seat 4: SS/yfeArhULzIcOPe8MdPg ($25 in chips) 
Seat 5: w3cELw9vjLM+p8ojn/uZvQ ($5.35 in chips) 
Seat 6: DihMHaz4WNETH1bPDe13kA ($25 in chips) 
SS/yfeArhULzIcOPe8MdPg: posts small blind $0.10
w3cELw9vjLM+p8ojn/uZvQ: posts big blind $0.25
*** HOLE CARDS ***
DihMHaz4WNETH1bPDe13kA: folds 
JFIAqU8lCZ0vWwEl4bdGsg: raises $0.60 to $0.85
q6WfTUAD9mowIP63ASq2Dg: folds 
SS/yfeArhULzIcOPe8MdPg: folds 
w3cELw9vjLM+p8ojn/uZvQ: raises $4.50 to $5.35 and is all-in
JFIAqU8lCZ0vWwEl4bdGsg: calls $4.50
*** FLOP *** [Ad Js 6d]
*** TURN *** [Ad Js 6d] [8c]
*** RIVER *** [Ad Js 6d 8c] [Jc]
*** SHOW DOWN ***
w3cELw9vjLM+p8ojn/uZvQ: shows [8h 8s] (a full house, Eights full of Jacks)
JFIAqU8lCZ0vWwEl4bdGsg: mucks hand 
w3cELw9vjLM+p8ojn/uZvQ collected $10.30 from pot
*** SUMMARY ***
Total pot $10.80 | Rake $0.50 
Board [Ad Js 6d 8c Jc]
Seat 1: JFIAqU8lCZ0vWwEl4bdGsg mucked
Seat 3: q6WfTUAD9mowIP63ASq2Dg (button) folded before Flop (didn't bet)
Seat 4: SS/yfeArhULzIcOPe8MdPg (small blind) folded before Flop
Seat 5: w3cELw9vjLM+p8ojn/uZvQ (big blind) showed [8h 8s] and won ($10.30) with a full house, Eights full of Jacks
Seat 6: DihMHaz4WNETH1bPDe13kA folded before Flop (didn't bet)




PokerStars Game #59941980486:  Hold'em No Limit ($0.10/$0.25) - 2009/07/01 1:52:16 ET
Table '5VWnrlxdjwVfMWkVS2WE7A' 6-max Seat #1 is the button
Seat 1: 82p+w3EmUaFFHuwpSeGY1w ($15.15 in chips) 
Seat 2: LJI7A1YgDM7hgh7o56+ReQ ($42.10 in chips) 
Seat 3: z1xdRIff40SSVI/g56tgiw ($15 in chips) 
Seat 5: 32YL2ZEp8NT4JB2RVM9euQ ($15.50 in chips) 
Seat 6: LtASJ9OlkqGrrUKGQlpGAw ($24.65 in chips) 
LJI7A1YgDM7hgh7o56+ReQ: posts small blind $0.10
z1xdRIff40SSVI/g56tgiw: posts big blind $0.25
eHsmIvAb2JREg4O6hNPnXg: sits out 
*** HOLE CARDS ***
32YL2ZEp8NT4JB2RVM9euQ: folds 
LtASJ9OlkqGrrUKGQlpGAw: folds 
82p+w3EmUaFFHuwpSeGY1w: calls $0.25
LJI7A1YgDM7hgh7o56+ReQ: folds 
z1xdRIff40SSVI/g56tgiw: checks 
*** FLOP *** [3s 7d 9c]
z1xdRIff40SSVI/g56tgiw: checks 
82p+w3EmUaFFHuwpSeGY1w: bets $0.25
z1xdRIff40SSVI/g56tgiw: calls $0.25
*** TURN *** [3s 7d 9c] [3c]
z1xdRIff40SSVI/g56tgiw: bets $1
82p+w3EmUaFFHuwpSeGY1w: calls $1
*** RIVER *** [3s 7d 9c 3c] [5c]
z1xdRIff40SSVI/g56tgiw: checks 
82p+w3EmUaFFHuwpSeGY1w: bets $1.75
z1xdRIff40SSVI/g56tgiw: folds 
Uncalled bet ($1.75) returned to 82p+w3EmUaFFHuwpSeGY1w
82p+w3EmUaFFHuwpSeGY1w collected $2.95 from pot
82p+w3EmUaFFHuwpSeGY1w: doesn't show hand 
*** SUMMARY ***
Total pot $3.10 | Rake $0.15 
Board [3s 7d 9c 3c 5c]
Seat 1: 82p+w3EmUaFFHuwpSeGY1w (button) collected ($2.95)
Seat 2: LJI7A1YgDM7hgh7o56+ReQ (small blind) folded before Flop
Seat 3: z1xdRIff40SSVI/g56tgiw (big blind) folded on the River
Seat 5: 32YL2ZEp8NT4JB2RVM9euQ folded before Flop (didn't bet)
Seat 6: LtASJ9OlkqGrrUKGQlpGAw folded before Flop (didn't bet)




PokerStars Game #59941980398:  Hold'em No Limit ($0.10/$0.25) - 2009/07/01 1:52:16 ET
Table 'GgmUtmhrYPRnhkqEEjD/Kw' 9-max Seat #1 is the button
Seat 1: bXpVeaSTPBFSPJmeXxO7nw ($9.75 in chips) 
Seat 2: ghNKXUBl/H+t83JF079ZBA ($25 in chips) 
Seat 3: dYvYZ723QlKIPiDa0pkedQ ($7.35 in chips) 
Seat 4: dfNim92Z6XK1/h5SFW5vDg ($25 in chips) 
Seat 5: ljemhp25Zg+nlA9DLCIiUw ($26.85 in chips) 
Seat 6: 4Ax0vobe1rLVIGZmkFINGA ($14.20 in chips) 
Seat 7: YwDw9cMqkbMznFK77rru4A ($4.30 in chips) 
Seat 8: DdPXdieucQ+n99u1n3A+rQ ($4.30 in chips) 
Seat 9: V6p0jQ/RhUsqpHLmXvEX4Q ($15.20 in chips) 
ghNKXUBl/H+t83JF079ZBA: posts small blind $0.10
dYvYZ723QlKIPiDa0pkedQ: posts big blind $0.25
*** HOLE CARDS ***
dfNim92Z6XK1/h5SFW5vDg: folds 
ljemhp25Zg+nlA9DLCIiUw: folds 
4Ax0vobe1rLVIGZmkFINGA: calls $0.25
YwDw9cMqkbMznFK77rru4A: folds 
DdPXdieucQ+n99u1n3A+rQ: folds 
V6p0jQ/RhUsqpHLmXvEX4Q: folds 
bXpVeaSTPBFSPJmeXxO7nw: folds 
ghNKXUBl/H+t83JF079ZBA: folds 
dYvYZ723QlKIPiDa0pkedQ: checks 
*** FLOP *** [Tc 6s 8d]
dYvYZ723QlKIPiDa0pkedQ: checks 
4Ax0vobe1rLVIGZmkFINGA: checks 
*** TURN *** [Tc 6s 8d] [3h]
dYvYZ723QlKIPiDa0pkedQ: checks 
4Ax0vobe1rLVIGZmkFINGA: bets $0.25
dYvYZ723QlKIPiDa0pkedQ: folds 
Uncalled bet ($0.25) returned to 4Ax0vobe1rLVIGZmkFINGA
4Ax0vobe1rLVIGZmkFINGA collected $0.60 from pot
4Ax0vobe1rLVIGZmkFINGA: doesn't show hand 
*** SUMMARY ***
Total pot $0.60 | Rake $0 
Board [Tc 6s 8d 3h]
Seat 1: bXpVeaSTPBFSPJmeXxO7nw (button) folded before Flop (didn't bet)
Seat 2: ghNKXUBl/H+t83JF079ZBA (small blind) folded before Flop
Seat 3: dYvYZ723QlKIPiDa0pkedQ (big blind) folded on the Turn
Seat 4: dfNim92Z6XK1/h5SFW5vDg folded before Flop (didn't bet)
Seat 5: ljemhp25Zg+nlA9DLCIiUw folded before Flop (didn't bet)
Seat 6: 4Ax0vobe1rLVIGZmkFINGA collected ($0.60)
Seat 7: YwDw9cMqkbMznFK77rru4A folded before Flop (didn't bet)
Seat 8: DdPXdieucQ+n99u1n3A+rQ folded before Flop (didn't bet)
Seat 9: V6p0jQ/RhUsqpHLmXvEX4Q folded before Flop (didn't bet)




PokerStars Game #59941980608:  Hold'em No Limit ($0.10/$0.25) - 2009/07/01 1:52:17 ET
Table 'JUMeG5SzDyo9HufhgemQeA' 9-max Seat #4 is the button
Seat 1: oLa/tXLfSLLB28mcLGrxcg ($24.05 in chips) 
Seat 2: Jve2LRs9vtGL7NdiNeXY/A ($15.15 in chips) 
Seat 3: IEvLSTIxhlti3EjZDarYnA ($30.90 in chips) 
Seat 4: 9+Um1wMtYNWnmPLUEU4viQ ($17.65 in chips) 
Seat 5: Ne5zBB6oEKrbigKRh6d6Xg ($12.55 in chips) 
Seat 6: wFCwdYKUXoQHhz8qeZuuAw ($23.65 in chips) 
Seat 7: aNpwfA31EREwO+ar4XzBCw ($32.15 in chips) 
Seat 8: zDrucyjVn5aeekNEc3cJrA ($37.35 in chips) 
Seat 9: V6p0jQ/RhUsqpHLmXvEX4Q ($14.70 in chips) 
Ne5zBB6oEKrbigKRh6d6Xg: posts small blind $0.10
wFCwdYKUXoQHhz8qeZuuAw: posts big blind $0.25
*** HOLE CARDS ***
aNpwfA31EREwO+ar4XzBCw: folds 
zDrucyjVn5aeekNEc3cJrA: folds 
aNpwfA31EREwO+ar4XzBCw leaves the table
V6p0jQ/RhUsqpHLmXvEX4Q: folds 
oLa/tXLfSLLB28mcLGrxcg: folds 
Jve2LRs9vtGL7NdiNeXY/A: calls $0.25
IEvLSTIxhlti3EjZDarYnA: calls $0.25
9+Um1wMtYNWnmPLUEU4viQ: folds 
Ne5zBB6oEKrbigKRh6d6Xg: calls $0.15
wFCwdYKUXoQHhz8qeZuuAw: checks 
*** FLOP *** [4c 7c Ts]
Ne5zBB6oEKrbigKRh6d6Xg: checks 
wFCwdYKUXoQHhz8qeZuuAw: checks 
Jve2LRs9vtGL7NdiNeXY/A: bets $0.50
IEvLSTIxhlti3EjZDarYnA: calls $0.50
Ne5zBB6oEKrbigKRh6d6Xg: folds 
wFCwdYKUXoQHhz8qeZuuAw: folds 
*** TURN *** [4c 7c Ts] [Kd]
Jve2LRs9vtGL7NdiNeXY/A: checks 
IEvLSTIxhlti3EjZDarYnA: bets $0.75
Jve2LRs9vtGL7NdiNeXY/A: calls $0.75
*** RIVER *** [4c 7c Ts Kd] [Td]
Jve2LRs9vtGL7NdiNeXY/A: checks 
IEvLSTIxhlti3EjZDarYnA: checks 
*** SHOW DOWN ***
Jve2LRs9vtGL7NdiNeXY/A: shows [9d 8s] (a pair of Tens)
IEvLSTIxhlti3EjZDarYnA: shows [Qc As] (a pair of Tens - Ace kicker)
IEvLSTIxhlti3EjZDarYnA collected $3.35 from pot
*** SUMMARY ***
Total pot $3.50 | Rake $0.15 
Board [4c 7c Ts Kd Td]
Seat 1: oLa/tXLfSLLB28mcLGrxcg folded before Flop (didn't bet)
Seat 2: Jve2LRs9vtGL7NdiNeXY/A showed [9d 8s] and lost with a pair of Tens
Seat 3: IEvLSTIxhlti3EjZDarYnA showed [Qc As] and won ($3.35) with a pair of Tens
Seat 4: 9+Um1wMtYNWnmPLUEU4viQ (button) folded before Flop (didn't bet)
Seat 5: Ne5zBB6oEKrbigKRh6d6Xg (small blind) folded on the Flop
Seat 6: wFCwdYKUXoQHhz8qeZuuAw (big blind) folded on the Flop
Seat 7: aNpwfA31EREwO+ar4XzBCw folded before Flop (didn't bet)
Seat 8: zDrucyjVn5aeekNEc3cJrA folded before Flop (didn't bet)
Seat 9: V6p0jQ/RhUsqpHLmXvEX4Q folded before Flop (didn't bet)




PokerStars Game #59941980904:  Hold'em No Limit ($0.10/$0.25) - 2009/07/01 1:52:17 ET
Table 'APEHQjIcZHDZUA4iOjju2g' 6-max Seat #3 is the button
Seat 1: DE9hRlt14g+JdsRQ4wT7hg ($25 in chips) 
Seat 2: 3zD3qLXT1bEffAoWGnc7wg ($32.80 in chips) 
Seat 3: 3e/idKqDuPE10t6Zvr//SQ ($17.25 in chips) 
Seat 4: w2mQ4VsGljGwWXydz8tw2A ($37.60 in chips) 
Seat 5: /xN6gc9+8Hew0HxaB6VIVg ($45.65 in chips) 
Seat 6: KXtdqb+rIMkjc0RvHDksGQ ($42 in chips) 
w2mQ4VsGljGwWXydz8tw2A: posts small blind $0.10
/xN6gc9+8Hew0HxaB6VIVg: posts big blind $0.25
*** HOLE CARDS ***
KXtdqb+rIMkjc0RvHDksGQ: folds 
DE9hRlt14g+JdsRQ4wT7hg: folds 
3zD3qLXT1bEffAoWGnc7wg: folds 
3e/idKqDuPE10t6Zvr//SQ: folds 
w2mQ4VsGljGwWXydz8tw2A: calls $0.15
/xN6gc9+8Hew0HxaB6VIVg: checks 
*** FLOP *** [Js 9c 9s]
w2mQ4VsGljGwWXydz8tw2A: checks 
/xN6gc9+8Hew0HxaB6VIVg: checks 
*** TURN *** [Js 9c 9s] [8d]
w2mQ4VsGljGwWXydz8tw2A: bets $0.75
/xN6gc9+8Hew0HxaB6VIVg: folds 
Uncalled bet ($0.75) returned to w2mQ4VsGljGwWXydz8tw2A
w2mQ4VsGljGwWXydz8tw2A collected $0.50 from pot
*** SUMMARY ***
Total pot $0.50 | Rake $0 
Board [Js 9c 9s 8d]
Seat 1: DE9hRlt14g+JdsRQ4wT7hg folded before Flop (didn't bet)
Seat 2: 3zD3qLXT1bEffAoWGnc7wg folded before Flop (didn't bet)
Seat 3: 3e/idKqDuPE10t6Zvr//SQ (button) folded before Flop (didn't bet)
Seat 4: w2mQ4VsGljGwWXydz8tw2A (small blind) collected ($0.50)
Seat 5: /xN6gc9+8Hew0HxaB6VIVg (big blind) folded on the Turn
Seat 6: KXtdqb+rIMkjc0RvHDksGQ folded before Flop (didn't bet)




PokerStars Game #59941981168:  Hold'em No Limit ($0.10/$0.25) - 2009/07/01 1:52:18 ET
Table 'FE/j6VqBY4j9Uq+VHURQCQ' 6-max Seat #4 is the button
Seat 1: ypmjhffk/YHGc51wgVXUTw ($35.55 in chips) 
Seat 2: 3zD3qLXT1bEffAoWGnc7wg ($36.35 in chips) 
Seat 3: lBoEwOFgzcERLIRUkUoRTw ($28.20 in chips) 
Seat 4: 7JyPCA0J2grhXQYxe1h3+A ($6.75 in chips) 
Seat 5: bJFzs6QmEEnz4miMfSDtcg ($15.90 in chips) 
Seat 6: Q1uciOZPBR/WkAlqa6cL4A ($29.80 in chips) 
bJFzs6QmEEnz4miMfSDtcg: posts small blind $0.10
Q1uciOZPBR/WkAlqa6cL4A: posts big blind $0.25
*** HOLE CARDS ***
ypmjhffk/YHGc51wgVXUTw: folds 
3zD3qLXT1bEffAoWGnc7wg: raises $0.50 to $0.75
lBoEwOFgzcERLIRUkUoRTw: folds 
7JyPCA0J2grhXQYxe1h3+A: folds 
bJFzs6QmEEnz4miMfSDtcg: calls $0.65
Q1uciOZPBR/WkAlqa6cL4A: folds 
*** FLOP *** [4s 4d 5h]
bJFzs6QmEEnz4miMfSDtcg: checks 
3zD3qLXT1bEffAoWGnc7wg: checks 
*** TURN *** [4s 4d 5h] [Ac]
bJFzs6QmEEnz4miMfSDtcg: checks 
3zD3qLXT1bEffAoWGnc7wg: bets $1
bJFzs6QmEEnz4miMfSDtcg: folds 
Uncalled bet ($1) returned to 3zD3qLXT1bEffAoWGnc7wg
3zD3qLXT1bEffAoWGnc7wg collected $1.70 from pot
3zD3qLXT1bEffAoWGnc7wg: doesn't show hand 
*** SUMMARY ***
Total pot $1.75 | Rake $0.05 
Board [4s 4d 5h Ac]
Seat 1: ypmjhffk/YHGc51wgVXUTw folded before Flop (didn't bet)
Seat 2: 3zD3qLXT1bEffAoWGnc7wg collected ($1.70)
Seat 3: lBoEwOFgzcERLIRUkUoRTw folded before Flop (didn't bet)
Seat 4: 7JyPCA0J2grhXQYxe1h3+A (button) folded before Flop (didn't bet)
Seat 5: bJFzs6QmEEnz4miMfSDtcg (small blind) folded on the Turn
Seat 6: Q1uciOZPBR/WkAlqa6cL4A (big blind) folded before Flop




PokerStars Game #59941981194:  Hold'em No Limit ($0.10/$0.25) - 2009/07/01 1:52:18 ET
Table 'P2yJ+jwfNsBdF12fLKA6DQ' 9-max Seat #5 is the button
Seat 1: zDrucyjVn5aeekNEc3cJrA ($22.20 in chips) 
Seat 2: uQwmfH5LEVA5eyghJdyPUg ($14.90 in chips) 
Seat 3: 8EbrQ/EvFWt2cr0GaU82gQ ($4.65 in chips) 
Seat 4: 6NLAWFPZZfqlVkY8n9RULA ($13.40 in chips) 
Seat 5: B7VAFAMs/PYlYABlV+EkSA ($7.30 in chips) 
Seat 6: mUoFJKqCzIUABvOFbiINlQ ($12.75 in chips) 
Seat 7: yQc5nLaNmByxI15Jegu61w ($17.40 in chips) 
Seat 8: LMd3gq2uNfbWTfXTnSeQRw ($11.25 in chips) 
Seat 9: dN5zq7QdZCUe7NZFM6cECg ($20 in chips) 
mUoFJKqCzIUABvOFbiINlQ: posts small blind $0.10
yQc5nLaNmByxI15Jegu61w: posts big blind $0.25
*** HOLE CARDS ***
LMd3gq2uNfbWTfXTnSeQRw: folds 
dN5zq7QdZCUe7NZFM6cECg: calls $0.25
zDrucyjVn5aeekNEc3cJrA: folds 
uQwmfH5LEVA5eyghJdyPUg: calls $0.25
8EbrQ/EvFWt2cr0GaU82gQ: folds 
6NLAWFPZZfqlVkY8n9RULA: folds 
B7VAFAMs/PYlYABlV+EkSA: raises $7.05 to $7.30 and is all-in
mUoFJKqCzIUABvOFbiINlQ: folds 
yQc5nLaNmByxI15Jegu61w: folds 
dN5zq7QdZCUe7NZFM6cECg: folds 
uQwmfH5LEVA5eyghJdyPUg: folds 
Uncalled bet ($7.05) returned to B7VAFAMs/PYlYABlV+EkSA
B7VAFAMs/PYlYABlV+EkSA collected $1.10 from pot
B7VAFAMs/PYlYABlV+EkSA: doesn't show hand 
*** SUMMARY ***
Total pot $1.10 | Rake $0 
Seat 1: zDrucyjVn5aeekNEc3cJrA folded before Flop (didn't bet)
Seat 2: uQwmfH5LEVA5eyghJdyPUg folded before Flop
Seat 3: 8EbrQ/EvFWt2cr0GaU82gQ folded before Flop (didn't bet)
Seat 4: 6NLAWFPZZfqlVkY8n9RULA folded before Flop (didn't bet)
Seat 5: B7VAFAMs/PYlYABlV+EkSA (button) collected ($1.10)
Seat 6: mUoFJKqCzIUABvOFbiINlQ (small blind) folded before Flop
Seat 7: yQc5nLaNmByxI15Jegu61w (big blind) folded before Flop
Seat 8: LMd3gq2uNfbWTfXTnSeQRw folded before Flop (didn't bet)
Seat 9: dN5zq7QdZCUe7NZFM6cECg folded before Flop




PokerStars Game #59941981152:  Hold'em No Limit ($0.10/$0.25) - 2009/07/01 1:52:18 ET
Table '52Meibn9NOL4XtVi1p2Upw' 9-max Seat #1 is the button
Seat 1: W6tExOcYX7qiy6Qdp+ZwFA ($6.55 in chips) 
Seat 2: CGjLyv/AvljZy2g76nYkzQ ($25 in chips) 
Seat 3: Bb42QRQMhg5/Y0vHP8/2Xw ($26 in chips) 
Seat 4: oLa/tXLfSLLB28mcLGrxcg ($31.65 in chips) 
Seat 5: MXCztnYJ58KLHMztZvKrxA ($10 in chips) 
Seat 6: N5sUK8M0br9djLrW97V9pQ ($28.50 in chips) 
Seat 7: Qduu7ikeizo6q6Ei9YvcJA ($32.75 in chips) 
Seat 8: w7VrLGwaVQzOQXfRqJitMQ ($21.50 in chips) 
Seat 9: RCqMONFrSPSArZh2Jsar/w ($15.95 in chips) 
CGjLyv/AvljZy2g76nYkzQ: posts small blind $0.10
Bb42QRQMhg5/Y0vHP8/2Xw: posts big blind $0.25
*** HOLE CARDS ***
oLa/tXLfSLLB28mcLGrxcg: folds 
MXCztnYJ58KLHMztZvKrxA: folds 
N5sUK8M0br9djLrW97V9pQ: folds 
Qduu7ikeizo6q6Ei9YvcJA: calls $0.25
w7VrLGwaVQzOQXfRqJitMQ: calls $0.25
RCqMONFrSPSArZh2Jsar/w: folds 
W6tExOcYX7qiy6Qdp+ZwFA: folds 
CGjLyv/AvljZy2g76nYkzQ: folds 
Bb42QRQMhg5/Y0vHP8/2Xw: checks 
*** FLOP *** [Jh Jd 2d]
Bb42QRQMhg5/Y0vHP8/2Xw: checks 
Qduu7ikeizo6q6Ei9YvcJA: bets $0.75
w7VrLGwaVQzOQXfRqJitMQ: folds 
Bb42QRQMhg5/Y0vHP8/2Xw: folds 
Uncalled bet ($0.75) returned to Qduu7ikeizo6q6Ei9YvcJA
Qduu7ikeizo6q6Ei9YvcJA collected $0.85 from pot
Qduu7ikeizo6q6Ei9YvcJA: doesn't show hand 
*** SUMMARY ***
Total pot $0.85 | Rake $0 
Board [Jh Jd 2d]
Seat 1: W6tExOcYX7qiy6Qdp+ZwFA (button) folded before Flop (didn't bet)
Seat 2: CGjLyv/AvljZy2g76nYkzQ (small blind) folded before Flop
Seat 3: Bb42QRQMhg5/Y0vHP8/2Xw (big blind) folded on the Flop
Seat 4: oLa/tXLfSLLB28mcLGrxcg folded before Flop (didn't bet)
Seat 5: MXCztnYJ58KLHMztZvKrxA folded before Flop (didn't bet)
Seat 6: N5sUK8M0br9djLrW97V9pQ folded before Flop (didn't bet)
Seat 7: Qduu7ikeizo6q6Ei9YvcJA collected ($0.85)
Seat 8: w7VrLGwaVQzOQXfRqJitMQ folded on the Flop
Seat 9: RCqMONFrSPSArZh2Jsar/w folded before Flop (didn't bet)




PokerStars Game #59941981216:  Hold'em No Limit ($0.10/$0.25) - 2009/07/01 1:52:18 ET
Table 'Jj2eLzVCUVAGBmM+Og79iQ' 9-max Seat #3 is the button
Seat 1: ShXPHWfjhfmAwLgDdm6bRQ ($7.70 in chips) 
Seat 2: 3BXzvZqgd3pARIFGfMXHww ($5.35 in chips) 
Seat 3: HPEB+AtKw1+C/cxU0o1ciw ($24.05 in chips) 
Seat 5: UkF1eqqUN0CCiimXAuN7og ($4.40 in chips) 
Seat 6: jZURAM/dgGCX+5lATlZugw ($17.35 in chips) 
Seat 7: e3Caz8vey9WAdfgpuGpNjQ ($14.50 in chips) 
Seat 8: H5Se03ZqSX7tbULXur2MAg ($33.80 in chips) 
Seat 9: vSkQm2EelzwRGDDQQk0Fqw ($4.65 in chips) 
Bb42QRQMhg5/Y0vHP8/2Xw will be allowed to play after the button
UkF1eqqUN0CCiimXAuN7og: posts small blind $0.10
jZURAM/dgGCX+5lATlZugw: posts big blind $0.25
*** HOLE CARDS ***
e3Caz8vey9WAdfgpuGpNjQ: folds 
H5Se03ZqSX7tbULXur2MAg: raises $0.50 to $0.75
vSkQm2EelzwRGDDQQk0Fqw: folds 
ShXPHWfjhfmAwLgDdm6bRQ: folds 
3BXzvZqgd3pARIFGfMXHww: folds 
HPEB+AtKw1+C/cxU0o1ciw: folds 
UkF1eqqUN0CCiimXAuN7og: folds 
jZURAM/dgGCX+5lATlZugw: folds 
Uncalled bet ($0.50) returned to H5Se03ZqSX7tbULXur2MAg
H5Se03ZqSX7tbULXur2MAg collected $0.60 from pot
*** SUMMARY ***
Total pot $0.60 | Rake $0 
Seat 1: ShXPHWfjhfmAwLgDdm6bRQ folded before Flop (didn't bet)
Seat 2: 3BXzvZqgd3pARIFGfMXHww folded before Flop (didn't bet)
Seat 3: HPEB+AtKw1+C/cxU0o1ciw (button) folded before Flop (didn't bet)
Seat 5: UkF1eqqUN0CCiimXAuN7og (small blind) folded before Flop
Seat 6: jZURAM/dgGCX+5lATlZugw (big blind) folded before Flop
Seat 7: e3Caz8vey9WAdfgpuGpNjQ folded before Flop (didn't bet)
Seat 8: H5Se03ZqSX7tbULXur2MAg collected ($0.60)
Seat 9: vSkQm2EelzwRGDDQQk0Fqw folded before Flop (didn't bet)




PokerStars Game #59941981202:  Hold'em No Limit ($0.10/$0.25) - 2009/07/01 1:52:18 ET
Table 'XX2OuOsa8/8AC+/mR/Az6g' 9-max Seat #5 is the button
Seat 1: 56S3mA6Zs3pGR+0p0vUCtg ($23.15 in chips) 
Seat 2: Bb42QRQMhg5/Y0vHP8/2Xw ($25.25 in chips) 
Seat 3: oLa/tXLfSLLB28mcLGrxcg ($23.10 in chips) 
Seat 4: 5pDhXQ+RVy0BGcwfJAJfbg ($24.65 in chips) 
Seat 5: SpiiQQAzy4MUgV3I5W8giw ($20.80 in chips) 
Seat 6: RCqMONFrSPSArZh2Jsar/w ($25 in chips) 
Seat 8: qwr38jl5txoR36M7G5qi4A ($10.35 in chips) 
Seat 9: V6p0jQ/RhUsqpHLmXvEX4Q ($12 in chips) 
RCqMONFrSPSArZh2Jsar/w: posts small blind $0.10
qwr38jl5txoR36M7G5qi4A: posts big blind $0.25
*** HOLE CARDS ***
V6p0jQ/RhUsqpHLmXvEX4Q: folds 
56S3mA6Zs3pGR+0p0vUCtg: folds 
Bb42QRQMhg5/Y0vHP8/2Xw: calls $0.25
oLa/tXLfSLLB28mcLGrxcg: folds 
5pDhXQ+RVy0BGcwfJAJfbg: folds 
SpiiQQAzy4MUgV3I5W8giw: folds 
RCqMONFrSPSArZh2Jsar/w: folds 
qwr38jl5txoR36M7G5qi4A: checks 
*** FLOP *** [6h 9h Qh]
qwr38jl5txoR36M7G5qi4A: checks 
Bb42QRQMhg5/Y0vHP8/2Xw: checks 
*** TURN *** [6h 9h Qh] [Qd]
qwr38jl5txoR36M7G5qi4A: checks 
Bb42QRQMhg5/Y0vHP8/2Xw: checks 
*** RIVER *** [6h 9h Qh Qd] [Ac]
qwr38jl5txoR36M7G5qi4A: checks 
Bb42QRQMhg5/Y0vHP8/2Xw: checks 
*** SHOW DOWN ***
qwr38jl5txoR36M7G5qi4A: shows [8s Td] (a pair of Queens)
Bb42QRQMhg5/Y0vHP8/2Xw: shows [Ks Ts] (a pair of Queens - Ace+King kicker)
Bb42QRQMhg5/Y0vHP8/2Xw collected $0.60 from pot
*** SUMMARY ***
Total pot $0.60 | Rake $0 
Board [6h 9h Qh Qd Ac]
Seat 1: 56S3mA6Zs3pGR+0p0vUCtg folded before Flop (didn't bet)
Seat 2: Bb42QRQMhg5/Y0vHP8/2Xw showed [Ks Ts] and won ($0.60) with a pair of Queens
Seat 3: oLa/tXLfSLLB28mcLGrxcg folded before Flop (didn't bet)
Seat 4: 5pDhXQ+RVy0BGcwfJAJfbg folded before Flop (didn't bet)
Seat 5: SpiiQQAzy4MUgV3I5W8giw (button) folded before Flop (didn't bet)
Seat 6: RCqMONFrSPSArZh2Jsar/w (small blind) folded before Flop
Seat 8: qwr38jl5txoR36M7G5qi4A (big blind) showed [8s Td] and lost with a pair of Queens
Seat 9: V6p0jQ/RhUsqpHLmXvEX4Q folded before Flop (didn't bet)




PokerStars Game #59941981200:  Hold'em No Limit ($0.10/$0.25) - 2009/07/01 1:52:18 ET
Table 'ukli1Y7ieC5JQMTEFxM2Nw' 6-max Seat #4 is the button
Seat 1: ukgMpMoFTQKuBqKbuPdCgg ($10.25 in chips) 
Seat 3: ExeoJ1G/rSmWa3tRz7TlCA ($24.50 in chips) 
Seat 4: if4dh6jhJXeN3/qd3qCp9g ($26.40 in chips) 
Seat 5: Se+H4Z4PDr6+eIUDJX1rpg ($18.85 in chips) 
Seat 6: 32YL2ZEp8NT4JB2RVM9euQ ($32 in chips) 
Se+H4Z4PDr6+eIUDJX1rpg: posts small blind $0.10
32YL2ZEp8NT4JB2RVM9euQ: posts big blind $0.25
i9LqF5rD3bvtbEE7HWgr3Q: sits out 
*** HOLE CARDS ***
ukgMpMoFTQKuBqKbuPdCgg: folds 
ExeoJ1G/rSmWa3tRz7TlCA: folds 
if4dh6jhJXeN3/qd3qCp9g: folds 
Se+H4Z4PDr6+eIUDJX1rpg: calls $0.15
32YL2ZEp8NT4JB2RVM9euQ: checks 
*** FLOP *** [6d Ac 9c]
Se+H4Z4PDr6+eIUDJX1rpg: checks 
32YL2ZEp8NT4JB2RVM9euQ: checks 
*** TURN *** [6d Ac 9c] [Ah]
Se+H4Z4PDr6+eIUDJX1rpg: checks 
32YL2ZEp8NT4JB2RVM9euQ: checks 
*** RIVER *** [6d Ac 9c Ah] [8c]
Se+H4Z4PDr6+eIUDJX1rpg: checks 
32YL2ZEp8NT4JB2RVM9euQ: checks 
*** SHOW DOWN ***
Se+H4Z4PDr6+eIUDJX1rpg: shows [5s Ts] (a pair of Aces)
32YL2ZEp8NT4JB2RVM9euQ: shows [Qh 2h] (a pair of Aces - Queen kicker)
32YL2ZEp8NT4JB2RVM9euQ collected $0.50 from pot
*** SUMMARY ***
Total pot $0.50 | Rake $0 
Board [6d Ac 9c Ah 8c]
Seat 1: ukgMpMoFTQKuBqKbuPdCgg folded before Flop (didn't bet)
Seat 3: ExeoJ1G/rSmWa3tRz7TlCA folded before Flop (didn't bet)
Seat 4: if4dh6jhJXeN3/qd3qCp9g (button) folded before Flop (didn't bet)
Seat 5: Se+H4Z4PDr6+eIUDJX1rpg (small blind) showed [5s Ts] and lost with a pair of Aces
Seat 6: 32YL2ZEp8NT4JB2RVM9euQ (big blind) showed [Qh 2h] and won ($0.50) with a pair of Aces




PokerStars Game #59941981640:  Hold'em No Limit ($0.10/$0.25) - 2009/07/01 1:52:19 ET
Table '3KDMdm1sfxFsNKkjc/PnBg' 9-max Seat #5 is the button
Seat 1: RN77cWdo2Yfi3gUEKq3PdA ($14.75 in chips) 
Seat 2: 5WLo/V8l3QfpUdK9JPp99w ($38.55 in chips) 
Seat 3: OXPkK84/qv92EMwXPiG5rQ ($10 in chips) 
Seat 4: F7pnn6czNpHvRM55XcA2EA ($37.10 in chips) 
Seat 5: +2kMBNpY4nF1qNCRd8SJLA ($26.70 in chips) 
Seat 6: yq2rcghljWKV3+gbDEsK+g ($14.50 in chips) 
Seat 7: gehe91e0IyVT0QU/XBkEyg ($32.15 in chips) 
Seat 9: K0b5wNInj6hUGRr6yzKFtw ($32.35 in chips) 
yq2rcghljWKV3+gbDEsK+g: posts small blind $0.10
gehe91e0IyVT0QU/XBkEyg: posts big blind $0.25
CGjLyv/AvljZy2g76nYkzQ: sits out 
*** HOLE CARDS ***
K0b5wNInj6hUGRr6yzKFtw: folds 
RN77cWdo2Yfi3gUEKq3PdA: folds 
5WLo/V8l3QfpUdK9JPp99w: raises $0.25 to $0.50
OXPkK84/qv92EMwXPiG5rQ: folds 
F7pnn6czNpHvRM55XcA2EA: folds 
+2kMBNpY4nF1qNCRd8SJLA: folds 
yq2rcghljWKV3+gbDEsK+g: calls $0.40
gehe91e0IyVT0QU/XBkEyg: calls $0.25
*** FLOP *** [9d Ks 3s]
yq2rcghljWKV3+gbDEsK+g: bets $0.25
gehe91e0IyVT0QU/XBkEyg: folds 
5WLo/V8l3QfpUdK9JPp99w: calls $0.25
*** TURN *** [9d Ks 3s] [3d]
yq2rcghljWKV3+gbDEsK+g: bets $1.25
5WLo/V8l3QfpUdK9JPp99w: calls $1.25
*** RIVER *** [9d Ks 3s 3d] [Ts]
yq2rcghljWKV3+gbDEsK+g: bets $4.75
5WLo/V8l3QfpUdK9JPp99w: folds 
Uncalled bet ($4.75) returned to yq2rcghljWKV3+gbDEsK+g
yq2rcghljWKV3+gbDEsK+g collected $4.30 from pot
yq2rcghljWKV3+gbDEsK+g: doesn't show hand 
*** SUMMARY ***
Total pot $4.50 | Rake $0.20 
Board [9d Ks 3s 3d Ts]
Seat 1: RN77cWdo2Yfi3gUEKq3PdA folded before Flop (didn't bet)
Seat 2: 5WLo/V8l3QfpUdK9JPp99w folded on the River
Seat 3: OXPkK84/qv92EMwXPiG5rQ folded before Flop (didn't bet)
Seat 4: F7pnn6czNpHvRM55XcA2EA folded before Flop (didn't bet)
Seat 5: +2kMBNpY4nF1qNCRd8SJLA (button) folded before Flop (didn't bet)
Seat 6: yq2rcghljWKV3+gbDEsK+g (small blind) collected ($4.30)
Seat 7: gehe91e0IyVT0QU/XBkEyg (big blind) folded on the Flop
Seat 9: K0b5wNInj6hUGRr6yzKFtw folded before Flop (didn't bet)




PokerStars Game #59941981828:  Hold'em No Limit ($0.10/$0.25) - 2009/07/01 1:52:19 ET
Table '5NipxzzFB2DffzDpddyQoQ' 6-max Seat #2 is the button
Seat 2: iauW7L/+7qzAuHow7CD75Q ($4.65 in chips) 
Seat 3: QvTX2yGq3uKJiKPmns4TKQ ($25.40 in chips) 
Seat 4: Wxq4Qyj0DnDXj2+taEOJFQ ($5 in chips) 
Seat 5: faP2NVl/cFTZ1nE4pXzg8Q ($21.20 in chips) 
Seat 6: 7JqTFMyeNSVWsmp/yW35Tw ($53.70 in chips) 
QvTX2yGq3uKJiKPmns4TKQ: posts small blind $0.10
Wxq4Qyj0DnDXj2+taEOJFQ: posts big blind $0.25
*** HOLE CARDS ***
W87HPwOk1KtWaYyshBe1gA has returned
faP2NVl/cFTZ1nE4pXzg8Q: calls $0.25
7JqTFMyeNSVWsmp/yW35Tw: folds 
iauW7L/+7qzAuHow7CD75Q: folds 
QvTX2yGq3uKJiKPmns4TKQ: calls $0.15
Wxq4Qyj0DnDXj2+taEOJFQ: checks 
*** FLOP *** [Kd 4d 3d]
QvTX2yGq3uKJiKPmns4TKQ: checks 
Wxq4Qyj0DnDXj2+taEOJFQ: checks 
faP2NVl/cFTZ1nE4pXzg8Q: bets $1
QvTX2yGq3uKJiKPmns4TKQ: folds 
Wxq4Qyj0DnDXj2+taEOJFQ: folds 
Uncalled bet ($1) returned to faP2NVl/cFTZ1nE4pXzg8Q
faP2NVl/cFTZ1nE4pXzg8Q collected $0.75 from pot
faP2NVl/cFTZ1nE4pXzg8Q: shows [6c Kh] (a pair of Kings)
*** SUMMARY ***
Total pot $0.75 | Rake $0 
Board [Kd 4d 3d]
Seat 2: iauW7L/+7qzAuHow7CD75Q (button) folded before Flop (didn't bet)
Seat 3: QvTX2yGq3uKJiKPmns4TKQ (small blind) folded on the Flop
Seat 4: Wxq4Qyj0DnDXj2+taEOJFQ (big blind) folded on the Flop
Seat 5: faP2NVl/cFTZ1nE4pXzg8Q collected ($0.75)
Seat 6: 7JqTFMyeNSVWsmp/yW35Tw folded before Flop (didn't bet)




PokerStars Game #59941981956:  Hold'em No Limit ($0.10/$0.25) - 2009/07/01 1:52:19 ET
Table 'g+mPuNJBCHKE9ents7ZGtg' 6-max Seat #2 is the button
Seat 1: cezpHJ8FB07dj0xG+LhOvw ($58.15 in chips) 
Seat 2: fZQg9veL7Dd/Z04ZTjC+wQ ($56.10 in chips) 
Seat 3: 8CPg15X6IHYR1pWm9ha1Sw ($25 in chips) 
Seat 6: Mn2V28t5aGq2d09z+/o6Fw ($36.80 in chips) 
8CPg15X6IHYR1pWm9ha1Sw: posts small blind $0.10
D3ikCR8c/o9jB5irZ3uGlw: is sitting out 
Mn2V28t5aGq2d09z+/o6Fw: posts big blind $0.25
*** HOLE CARDS ***
D3ikCR8c/o9jB5irZ3uGlw leaves the table
cezpHJ8FB07dj0xG+LhOvw: folds 
fZQg9veL7Dd/Z04ZTjC+wQ: raises $0.50 to $0.75
8CPg15X6IHYR1pWm9ha1Sw: folds 
Mn2V28t5aGq2d09z+/o6Fw: folds 
Uncalled bet ($0.50) returned to fZQg9veL7Dd/Z04ZTjC+wQ
fZQg9veL7Dd/Z04ZTjC+wQ collected $0.60 from pot
fZQg9veL7Dd/Z04ZTjC+wQ: doesn't show hand 
*** SUMMARY ***
Total pot $0.60 | Rake $0 
Seat 1: cezpHJ8FB07dj0xG+LhOvw folded before Flop (didn't bet)
Seat 2: fZQg9veL7Dd/Z04ZTjC+wQ (button) collected ($0.60)
Seat 3: 8CPg15X6IHYR1pWm9ha1Sw (small blind) folded before Flop
Seat 6: Mn2V28t5aGq2d09z+/o6Fw (big blind) folded before Flop




PokerStars Game #59941982452:  Hold'em No Limit ($0.10/$0.25) - 2009/07/01 1:52:20 ET
Table 'sCop8wmj9zlSS2KJqk1QKQ' 9-max Seat #6 is the button
Seat 1: dtZ84flFEi4Q+SGrHMJRDQ ($39.85 in chips) 
Seat 2: YZaC69gFrepA6oCGtu7E0w ($41.10 in chips) 
Seat 3: M/9j4wkHH9i1JM51vgi1VA ($26.15 in chips) 
Seat 4: msUzkZl2RntUnTl6E8WaNA ($15.30 in chips) 
Seat 6: 6RiVTYll/5D8zICp0MRpKw ($23.75 in chips) 
Seat 7: 18G4P1XstjNvItdGUITxgw ($26 in chips) 
Seat 8: xnVwSkROfRtOw4eSoDANtw ($19.55 in chips) 
Seat 9: tLcDklc2rBORNfixyRfVfw ($25 in chips) 
18G4P1XstjNvItdGUITxgw: posts small blind $0.10
xnVwSkROfRtOw4eSoDANtw: posts big blind $0.25
CvL9Ch1HYCVbTsfpNucitg: sits out 
*** HOLE CARDS ***
tLcDklc2rBORNfixyRfVfw: folds 
dtZ84flFEi4Q+SGrHMJRDQ: folds 
YZaC69gFrepA6oCGtu7E0w: raises $0.50 to $0.75
M/9j4wkHH9i1JM51vgi1VA: calls $0.75
msUzkZl2RntUnTl6E8WaNA: folds 
6RiVTYll/5D8zICp0MRpKw: folds 
18G4P1XstjNvItdGUITxgw: folds 
xnVwSkROfRtOw4eSoDANtw: folds 
*** FLOP *** [9h 9s 8s]
YZaC69gFrepA6oCGtu7E0w: bets $1
M/9j4wkHH9i1JM51vgi1VA: calls $1
*** TURN *** [9h 9s 8s] [3s]
YZaC69gFrepA6oCGtu7E0w: bets $2
M/9j4wkHH9i1JM51vgi1VA: folds 
Uncalled bet ($2) returned to YZaC69gFrepA6oCGtu7E0w
YZaC69gFrepA6oCGtu7E0w collected $3.70 from pot
*** SUMMARY ***
Total pot $3.85 | Rake $0.15 
Board [9h 9s 8s 3s]
Seat 1: dtZ84flFEi4Q+SGrHMJRDQ folded before Flop (didn't bet)
Seat 2: YZaC69gFrepA6oCGtu7E0w collected ($3.70)
Seat 3: M/9j4wkHH9i1JM51vgi1VA folded on the Turn
Seat 4: msUzkZl2RntUnTl6E8WaNA folded before Flop (didn't bet)
Seat 6: 6RiVTYll/5D8zICp0MRpKw (button) folded before Flop (didn't bet)
Seat 7: 18G4P1XstjNvItdGUITxgw (small blind) folded before Flop
Seat 8: xnVwSkROfRtOw4eSoDANtw (big blind) folded before Flop
Seat 9: tLcDklc2rBORNfixyRfVfw folded before Flop (didn't bet)




PokerStars Game #59941982260:  Hold'em No Limit ($0.10/$0.25) - 2009/07/01 1:52:20 ET
Table 'D1Yq70l0nNCyMV6DA42p+Q' 9-max Seat #6 is the button
Seat 1: z5GxcHlYz/GSz6W2uFiTtg ($19.40 in chips) 
Seat 2: zgi+EUykT/pZQpoUG6+oEg ($5 in chips) 
Seat 3: 9lvO/qyU+xrU95Teu1fv0g ($6.50 in chips) 
Seat 4: VWUWpMLMj/Q1jRVpF7Aohw ($8.90 in chips) 
Seat 5: gehe91e0IyVT0QU/XBkEyg ($25 in chips) 
Seat 6: wGigCmBR/9XWkPpvYos3aQ ($33.45 in chips) 
Seat 8: zDrucyjVn5aeekNEc3cJrA ($23.75 in chips) 
Seat 9: h5wEs8qXrBqfLa9GjaSBzg ($17.25 in chips) 
zDrucyjVn5aeekNEc3cJrA: posts small blind $0.10
h5wEs8qXrBqfLa9GjaSBzg: posts big blind $0.25
*** HOLE CARDS ***
z5GxcHlYz/GSz6W2uFiTtg: folds 
zgi+EUykT/pZQpoUG6+oEg: folds 
9lvO/qyU+xrU95Teu1fv0g: folds 
VWUWpMLMj/Q1jRVpF7Aohw: calls $0.25
gehe91e0IyVT0QU/XBkEyg: folds 
wGigCmBR/9XWkPpvYos3aQ: raises $1 to $1.25
zDrucyjVn5aeekNEc3cJrA: folds 
h5wEs8qXrBqfLa9GjaSBzg: folds 
VWUWpMLMj/Q1jRVpF7Aohw: calls $1
*** FLOP *** [As 7h Jc]
VWUWpMLMj/Q1jRVpF7Aohw: checks 
wGigCmBR/9XWkPpvYos3aQ: bets $1.80
VWUWpMLMj/Q1jRVpF7Aohw: folds 
Uncalled bet ($1.80) returned to wGigCmBR/9XWkPpvYos3aQ
wGigCmBR/9XWkPpvYos3aQ collected $2.75 from pot
wGigCmBR/9XWkPpvYos3aQ: doesn't show hand 
*** SUMMARY ***
Total pot $2.85 | Rake $0.10 
Board [As 7h Jc]
Seat 1: z5GxcHlYz/GSz6W2uFiTtg folded before Flop (didn't bet)
Seat 2: zgi+EUykT/pZQpoUG6+oEg folded before Flop (didn't bet)
Seat 3: 9lvO/qyU+xrU95Teu1fv0g folded before Flop (didn't bet)
Seat 4: VWUWpMLMj/Q1jRVpF7Aohw folded on the Flop
Seat 5: gehe91e0IyVT0QU/XBkEyg folded before Flop (didn't bet)
Seat 6: wGigCmBR/9XWkPpvYos3aQ (button) collected ($2.75)
Seat 8: zDrucyjVn5aeekNEc3cJrA (small blind) folded before Flop
Seat 9: h5wEs8qXrBqfLa9GjaSBzg (big blind) folded before Flop




PokerStars Game #59941982608:  Hold'em No Limit ($0.10/$0.25) - 2009/07/01 1:52:20 ET
Table 'TJS4XvvOjO3k7mH74HJw5g' 9-max Seat #5 is the button
Seat 1: K8I2mpRME07ZlOsT2x75Lg ($6.45 in chips) 
Seat 2: yqkowiRWZ6NvRN9UUkYIlA ($8.60 in chips) 
Seat 3: 8EbrQ/EvFWt2cr0GaU82gQ ($4.65 in chips) 
Seat 4: clJsV3v77RS07bDKY+705w ($5 in chips) 
Seat 5: UlMB386Cfzy3EwurQoBjcA ($7.35 in chips) 
Seat 6: 3PmVnC/15cl4oyI1TKIt4g ($4.75 in chips) 
Seat 7: B9u+i1s5aZZkmLTLUopTBg ($17.90 in chips) 
Seat 8: Qv4VzEkN09uD11sjKv02Ig ($17.95 in chips) 
Seat 9: +sbyWwIcFp9kP0bDtMegfQ ($44.45 in chips) 
3PmVnC/15cl4oyI1TKIt4g: posts small blind $0.10
B9u+i1s5aZZkmLTLUopTBg: posts big blind $0.25
*** HOLE CARDS ***
Qv4VzEkN09uD11sjKv02Ig: folds 
Qv4VzEkN09uD11sjKv02Ig leaves the table
+sbyWwIcFp9kP0bDtMegfQ: folds 
K8I2mpRME07ZlOsT2x75Lg: folds 
yqkowiRWZ6NvRN9UUkYIlA: folds 
8EbrQ/EvFWt2cr0GaU82gQ: raises $0.50 to $0.75
clJsV3v77RS07bDKY+705w: folds 
UlMB386Cfzy3EwurQoBjcA: folds 
3PmVnC/15cl4oyI1TKIt4g: folds 
B9u+i1s5aZZkmLTLUopTBg: folds 
Uncalled bet ($0.50) returned to 8EbrQ/EvFWt2cr0GaU82gQ
8EbrQ/EvFWt2cr0GaU82gQ collected $0.60 from pot
8EbrQ/EvFWt2cr0GaU82gQ: doesn't show hand 
*** SUMMARY ***
Total pot $0.60 | Rake $0 
Seat 1: K8I2mpRME07ZlOsT2x75Lg folded before Flop (didn't bet)
Seat 2: yqkowiRWZ6NvRN9UUkYIlA folded before Flop (didn't bet)
Seat 3: 8EbrQ/EvFWt2cr0GaU82gQ collected ($0.60)
Seat 4: clJsV3v77RS07bDKY+705w folded before Flop (didn't bet)
Seat 5: UlMB386Cfzy3EwurQoBjcA (button) folded before Flop (didn't bet)
Seat 6: 3PmVnC/15cl4oyI1TKIt4g (small blind) folded before Flop
Seat 7: B9u+i1s5aZZkmLTLUopTBg (big blind) folded before Flop
Seat 8: Qv4VzEkN09uD11sjKv02Ig folded before Flop (didn't bet)
Seat 9: +sbyWwIcFp9kP0bDtMegfQ folded before Flop (didn't bet)




PokerStars Game #59941982420:  Hold'em No Limit ($0.10/$0.25) - 2009/07/01 1:52:20 ET
Table 'mk323gviqdkOY5Aek/1EWg' 6-max Seat #2 is the button
Seat 1: 7cx44/slbeTw+Cy7QB8Trg ($24.65 in chips) 
Seat 2: GC/9yVD59DUCX7hUI7gcLw ($57.05 in chips) 
Seat 3: NuqYPwTLZYQhxOoVK3Yqlw ($25.55 in chips) 
Seat 4: +baiVgI/ETnBARLe5mARCw ($11.20 in chips) 
Seat 5: kjYRzIfvZNNflYMYRkkSVA ($36.30 in chips) 
Seat 6: KkXSr5xFjxLSD3wtAvT+WQ ($6.70 in chips) 
NuqYPwTLZYQhxOoVK3Yqlw: posts small blind $0.10
+baiVgI/ETnBARLe5mARCw: posts big blind $0.25
*** HOLE CARDS ***
kjYRzIfvZNNflYMYRkkSVA: folds 
KkXSr5xFjxLSD3wtAvT+WQ: calls $0.25
7cx44/slbeTw+Cy7QB8Trg: raises $0.75 to $1
GC/9yVD59DUCX7hUI7gcLw: folds 
NuqYPwTLZYQhxOoVK3Yqlw: folds 
+baiVgI/ETnBARLe5mARCw: folds 
KkXSr5xFjxLSD3wtAvT+WQ: folds 
Uncalled bet ($0.75) returned to 7cx44/slbeTw+Cy7QB8Trg
7cx44/slbeTw+Cy7QB8Trg collected $0.85 from pot
7cx44/slbeTw+Cy7QB8Trg: doesn't show hand 
*** SUMMARY ***
Total pot $0.85 | Rake $0 
Seat 1: 7cx44/slbeTw+Cy7QB8Trg collected ($0.85)
Seat 2: GC/9yVD59DUCX7hUI7gcLw (button) folded before Flop (didn't bet)
Seat 3: NuqYPwTLZYQhxOoVK3Yqlw (small blind) folded before Flop
Seat 4: +baiVgI/ETnBARLe5mARCw (big blind) folded before Flop
Seat 5: kjYRzIfvZNNflYMYRkkSVA folded before Flop (didn't bet)
Seat 6: KkXSr5xFjxLSD3wtAvT+WQ folded before Flop




PokerStars Game #59941982374:  Hold'em No Limit ($0.10/$0.25) - 2009/07/01 1:52:20 ET
Table 'fIMYcWwN4/aXFJvH5Z8Ymg' 6-max Seat #3 is the button
Seat 1: DihMHaz4WNETH1bPDe13kA ($25.35 in chips) 
Seat 2: Mhj3q7cxev+XjXZxEE6/Cw ($26.30 in chips) 
Seat 3: 9bpVv1/Qh9IYtXuCtl5VtQ ($24.65 in chips) 
Seat 4: 7cx44/slbeTw+Cy7QB8Trg ($24.75 in chips) 
Seat 5: JppOakN7YnIDLWiLzBbtSg ($25 in chips) 
Seat 6: jp34e617tIzV8tKIWmfAbA ($28.35 in chips) 
7cx44/slbeTw+Cy7QB8Trg: posts small blind $0.10
JppOakN7YnIDLWiLzBbtSg: posts big blind $0.25
*** HOLE CARDS ***
jp34e617tIzV8tKIWmfAbA: folds 
DihMHaz4WNETH1bPDe13kA: folds 
Mhj3q7cxev+XjXZxEE6/Cw: folds 
9bpVv1/Qh9IYtXuCtl5VtQ: raises $0.75 to $1
7cx44/slbeTw+Cy7QB8Trg: folds 
JppOakN7YnIDLWiLzBbtSg: raises $4 to $5
9bpVv1/Qh9IYtXuCtl5VtQ: folds 
Uncalled bet ($4) returned to JppOakN7YnIDLWiLzBbtSg
JppOakN7YnIDLWiLzBbtSg collected $2.10 from pot
JppOakN7YnIDLWiLzBbtSg: doesn't show hand 
*** SUMMARY ***
Total pot $2.10 | Rake $0 
Seat 1: DihMHaz4WNETH1bPDe13kA folded before Flop (didn't bet)
Seat 2: Mhj3q7cxev+XjXZxEE6/Cw folded before Flop (didn't bet)
Seat 3: 9bpVv1/Qh9IYtXuCtl5VtQ (button) folded before Flop
Seat 4: 7cx44/slbeTw+Cy7QB8Trg (small blind) folded before Flop
Seat 5: JppOakN7YnIDLWiLzBbtSg (big blind) collected ($2.10)
Seat 6: jp34e617tIzV8tKIWmfAbA folded before Flop (didn't bet)




PokerStars Game #59941982108:  Hold'em No Limit ($0.10/$0.25) - 2009/07/01 1:52:20 ET
Table 'xro+BVoe2Zuw1TYmz/McJQ' 9-max Seat #3 is the button
Seat 3: xUw+6BIJCkgxBKESwlj9Hg ($3.65 in chips) 
Seat 4: N2LVj3iImgnOoHVf8g0rIw ($53.10 in chips) 
Seat 5: H7ijH+qgNcEQW9eBvivIYg ($15.35 in chips) 
Seat 6: HPEB+AtKw1+C/cxU0o1ciw ($15.15 in chips) 
Seat 8: ljemhp25Zg+nlA9DLCIiUw ($24.65 in chips) 
Seat 9: OaRk2iGw9ua8N4zaKt+RBA ($22.80 in chips) 
N2LVj3iImgnOoHVf8g0rIw: posts small blind $0.10
H7ijH+qgNcEQW9eBvivIYg: posts big blind $0.25
OaRk2iGw9ua8N4zaKt+RBA is disconnected 
OaRk2iGw9ua8N4zaKt+RBA is connected 
OaRk2iGw9ua8N4zaKt+RBA: posts big blind $0.25
*** HOLE CARDS ***
HPEB+AtKw1+C/cxU0o1ciw: folds 
ljemhp25Zg+nlA9DLCIiUw: folds 
OaRk2iGw9ua8N4zaKt+RBA: checks 
xUw+6BIJCkgxBKESwlj9Hg: calls $0.25
N2LVj3iImgnOoHVf8g0rIw: raises $1.75 to $2
H7ijH+qgNcEQW9eBvivIYg: calls $1.75
OaRk2iGw9ua8N4zaKt+RBA: folds 
xUw+6BIJCkgxBKESwlj9Hg: calls $1.75
*** FLOP *** [Jh Td Jc]
N2LVj3iImgnOoHVf8g0rIw: bets $3
H7ijH+qgNcEQW9eBvivIYg: raises $3 to $6
xUw+6BIJCkgxBKESwlj9Hg: folds 
N2LVj3iImgnOoHVf8g0rIw: calls $3
*** TURN *** [Jh Td Jc] [7s]
N2LVj3iImgnOoHVf8g0rIw: bets $8.50
H7ijH+qgNcEQW9eBvivIYg: folds 
Uncalled bet ($8.50) returned to N2LVj3iImgnOoHVf8g0rIw
N2LVj3iImgnOoHVf8g0rIw collected $17.40 from pot
xUw+6BIJCkgxBKESwlj9Hg leaves the table
*** SUMMARY ***
Total pot $18.25 | Rake $0.85 
Board [Jh Td Jc 7s]
Seat 3: xUw+6BIJCkgxBKESwlj9Hg (button) folded on the Flop
Seat 4: N2LVj3iImgnOoHVf8g0rIw (small blind) collected ($17.40)
Seat 5: H7ijH+qgNcEQW9eBvivIYg (big blind) folded on the Turn
Seat 6: HPEB+AtKw1+C/cxU0o1ciw folded before Flop (didn't bet)
Seat 8: ljemhp25Zg+nlA9DLCIiUw folded before Flop (didn't bet)
Seat 9: OaRk2iGw9ua8N4zaKt+RBA folded before Flop




PokerStars Game #59941982750:  Hold'em No Limit ($0.10/$0.25) - 2009/07/01 1:52:21 ET
Table 'RPdw09/gGCIP4xFhDWJgXQ' 9-max Seat #5 is the button
Seat 1: aNpwfA31EREwO+ar4XzBCw ($27.50 in chips) 
Seat 2: Sd1tfhUq/M96GhXGv1hwFQ ($7.85 in chips) 
Seat 3: g5LAv1J/3Thw1zs/SEyfzw ($19.70 in chips) 
Seat 4: z5GxcHlYz/GSz6W2uFiTtg ($10.45 in chips) 
Seat 5: gehe91e0IyVT0QU/XBkEyg ($31.25 in chips) 
Seat 6: monZeAwXUmIA1l84cUd2hw ($13 in chips) 
Seat 7: EP17SQz/iWcuYdNOGeBgkw ($13.40 in chips) 
Seat 8: MG90wfSJZnOejs/KD3vlQQ ($29.80 in chips) 
Seat 9: O02ScVDnDZwH6KjZNJZMzA ($5.20 in chips) 
monZeAwXUmIA1l84cUd2hw: posts small blind $0.10
EP17SQz/iWcuYdNOGeBgkw: posts big blind $0.25
z5GxcHlYz/GSz6W2uFiTtg: posts small & big blinds $0.35
*** HOLE CARDS ***
MG90wfSJZnOejs/KD3vlQQ: calls $0.25
O02ScVDnDZwH6KjZNJZMzA: raises $0.75 to $1
aNpwfA31EREwO+ar4XzBCw: folds 
Sd1tfhUq/M96GhXGv1hwFQ: calls $1
g5LAv1J/3Thw1zs/SEyfzw: folds 
z5GxcHlYz/GSz6W2uFiTtg: folds 
gehe91e0IyVT0QU/XBkEyg: folds 
monZeAwXUmIA1l84cUd2hw: folds 
EP17SQz/iWcuYdNOGeBgkw: folds 
MG90wfSJZnOejs/KD3vlQQ: calls $0.75
*** FLOP *** [7c 3h 8h]
MG90wfSJZnOejs/KD3vlQQ: checks 
O02ScVDnDZwH6KjZNJZMzA: bets $2
Sd1tfhUq/M96GhXGv1hwFQ: raises $2.25 to $4.25
MG90wfSJZnOejs/KD3vlQQ: folds 
O02ScVDnDZwH6KjZNJZMzA: calls $2.20 and is all-in
Uncalled bet ($0.05) returned to Sd1tfhUq/M96GhXGv1hwFQ
*** TURN *** [7c 3h 8h] [6c]
*** RIVER *** [7c 3h 8h 6c] [4d]
*** SHOW DOWN ***
O02ScVDnDZwH6KjZNJZMzA: shows [Qh Qc] (a pair of Queens)
Sd1tfhUq/M96GhXGv1hwFQ: shows [Th 9d] (a straight, Six to Ten)
Sd1tfhUq/M96GhXGv1hwFQ collected $11.55 from pot
*** SUMMARY ***
Total pot $12.10 | Rake $0.55 
Board [7c 3h 8h 6c 4d]
Seat 1: aNpwfA31EREwO+ar4XzBCw folded before Flop (didn't bet)
Seat 2: Sd1tfhUq/M96GhXGv1hwFQ showed [Th 9d] and won ($11.55) with a straight, Six to Ten
Seat 3: g5LAv1J/3Thw1zs/SEyfzw folded before Flop (didn't bet)
Seat 4: z5GxcHlYz/GSz6W2uFiTtg folded before Flop
Seat 5: gehe91e0IyVT0QU/XBkEyg (button) folded before Flop (didn't bet)
Seat 6: monZeAwXUmIA1l84cUd2hw (small blind) folded before Flop
Seat 7: EP17SQz/iWcuYdNOGeBgkw (big blind) folded before Flop
Seat 8: MG90wfSJZnOejs/KD3vlQQ folded on the Flop
Seat 9: O02ScVDnDZwH6KjZNJZMzA showed [Qh Qc] and lost with a pair of Queens




PokerStars Game #59941982944:  Hold'em No Limit ($0.10/$0.25) - 2009/07/01 1:52:21 ET
Table 'sm5gqEvXgLbkkE4dryW/5g' 6-max Seat #2 is the button
Seat 1: v8m8XHovI5tqEA9mvplDSw ($39.50 in chips) 
Seat 2: 5xs5/u2z1CO9zkRvH72MQg ($17.35 in chips) 
Seat 3: UT5XpwOH1ipkOF7n1MqDJA ($20.80 in chips) 
Seat 4: cWc85bEzdRzpUMhRKm8pwQ ($27.30 in chips) 
Seat 6: aogAb4Eienxztk8p2v9VVw ($22.15 in chips) 
UT5XpwOH1ipkOF7n1MqDJA: posts small blind $0.10
cWc85bEzdRzpUMhRKm8pwQ: posts big blind $0.25
AyreonChen: sits out 
*** HOLE CARDS ***
aogAb4Eienxztk8p2v9VVw: raises $0.75 to $1
v8m8XHovI5tqEA9mvplDSw: calls $1
5xs5/u2z1CO9zkRvH72MQg: folds 
UT5XpwOH1ipkOF7n1MqDJA: calls $0.90
cWc85bEzdRzpUMhRKm8pwQ: folds 
*** FLOP *** [2h Tc Kd]
UT5XpwOH1ipkOF7n1MqDJA: checks 
aogAb4Eienxztk8p2v9VVw: bets $1.75
v8m8XHovI5tqEA9mvplDSw: calls $1.75
UT5XpwOH1ipkOF7n1MqDJA: folds 
*** TURN *** [2h Tc Kd] [Ks]
aogAb4Eienxztk8p2v9VVw: bets $2.50
v8m8XHovI5tqEA9mvplDSw: calls $2.50
*** RIVER *** [2h Tc Kd Ks] [3h]
aogAb4Eienxztk8p2v9VVw: bets $5
v8m8XHovI5tqEA9mvplDSw: folds 
Uncalled bet ($5) returned to aogAb4Eienxztk8p2v9VVw
aogAb4Eienxztk8p2v9VVw collected $11.20 from pot
aogAb4Eienxztk8p2v9VVw: doesn't show hand 
*** SUMMARY ***
Total pot $11.75 | Rake $0.55 
Board [2h Tc Kd Ks 3h]
Seat 1: v8m8XHovI5tqEA9mvplDSw folded on the River
Seat 2: 5xs5/u2z1CO9zkRvH72MQg (button) folded before Flop (didn't bet)
Seat 3: UT5XpwOH1ipkOF7n1MqDJA (small blind) folded on the Flop
Seat 4: cWc85bEzdRzpUMhRKm8pwQ (big blind) folded before Flop
Seat 6: aogAb4Eienxztk8p2v9VVw collected ($11.20)




PokerStars Game #59941982928:  Hold'em No Limit ($0.10/$0.25) - 2009/07/01 1:52:21 ET
Table 'VuY5ej47Cy8nOI3Wogmhzw' 6-max Seat #6 is the button
Seat 1: EeUZtMU058v2ObUACOF4Og ($29.25 in chips) 
Seat 3: v+QfkGiuj9bgtuNoVnDO8w ($42.05 in chips) 
Seat 4: QqiZLFrN8iOUT/GHw7ztOA ($45.05 in chips) 
Seat 5: m2yWOKfAxqHoy5DDN87Ttw ($25 in chips) 
Seat 6: +KblIivb6tainScpwm14RQ ($10.60 in chips) 
EeUZtMU058v2ObUACOF4Og: posts small blind $0.10
v+QfkGiuj9bgtuNoVnDO8w: posts big blind $0.25
*** HOLE CARDS ***
QqiZLFrN8iOUT/GHw7ztOA: folds 
m2yWOKfAxqHoy5DDN87Ttw: raises $1 to $1.25
+KblIivb6tainScpwm14RQ: folds 
EeUZtMU058v2ObUACOF4Og: folds 
v+QfkGiuj9bgtuNoVnDO8w: folds 
Uncalled bet ($1) returned to m2yWOKfAxqHoy5DDN87Ttw
m2yWOKfAxqHoy5DDN87Ttw collected $0.60 from pot
m2yWOKfAxqHoy5DDN87Ttw: doesn't show hand 
*** SUMMARY ***
Total pot $0.60 | Rake $0 
Seat 1: EeUZtMU058v2ObUACOF4Og (small blind) folded before Flop
Seat 3: v+QfkGiuj9bgtuNoVnDO8w (big blind) folded before Flop
Seat 4: QqiZLFrN8iOUT/GHw7ztOA folded before Flop (didn't bet)
Seat 5: m2yWOKfAxqHoy5DDN87Ttw collected ($0.60)
Seat 6: +KblIivb6tainScpwm14RQ (button) folded before Flop (didn't bet)




PokerStars Game #59941983180:  Hold'em No Limit ($0.10/$0.25) - 2009/07/01 1:52:21 ET
Table 'tq5CvS0RUqGkuBK0XTzqqg' 6-max Seat #3 is the button
Seat 1: +ZlnqPoP3Hg4BIUxDfKd/A ($31.95 in chips) 
Seat 3: VXTONriS+Ohik+r0FeicIw ($25 in chips) 
Seat 4: UT5XpwOH1ipkOF7n1MqDJA ($37.20 in chips) 
Seat 5: qGHGf/553gQnDoklMRe3tg ($36.90 in chips) 
Seat 6: QqiZLFrN8iOUT/GHw7ztOA ($23.30 in chips) 
UT5XpwOH1ipkOF7n1MqDJA: posts small blind $0.10
qGHGf/553gQnDoklMRe3tg: posts big blind $0.25
ErIN0JRL5srYjT6en1f8YQ: sits out 
*** HOLE CARDS ***
QqiZLFrN8iOUT/GHw7ztOA: folds 
+ZlnqPoP3Hg4BIUxDfKd/A: raises $0.75 to $1
VXTONriS+Ohik+r0FeicIw: folds 
UT5XpwOH1ipkOF7n1MqDJA: calls $0.90
qGHGf/553gQnDoklMRe3tg: folds 
*** FLOP *** [7s Ad Th]
UT5XpwOH1ipkOF7n1MqDJA: checks 
+ZlnqPoP3Hg4BIUxDfKd/A: bets $1.50
UT5XpwOH1ipkOF7n1MqDJA: calls $1.50
*** TURN *** [7s Ad Th] [Tc]
UT5XpwOH1ipkOF7n1MqDJA: checks 
+ZlnqPoP3Hg4BIUxDfKd/A: checks 
*** RIVER *** [7s Ad Th Tc] [2d]
UT5XpwOH1ipkOF7n1MqDJA: bets $2.50
+ZlnqPoP3Hg4BIUxDfKd/A: folds 
Uncalled bet ($2.50) returned to UT5XpwOH1ipkOF7n1MqDJA
UT5XpwOH1ipkOF7n1MqDJA collected $5 from pot
*** SUMMARY ***
Total pot $5.25 | Rake $0.25 
Board [7s Ad Th Tc 2d]
Seat 1: +ZlnqPoP3Hg4BIUxDfKd/A folded on the River
Seat 3: VXTONriS+Ohik+r0FeicIw (button) folded before Flop (didn't bet)
Seat 4: UT5XpwOH1ipkOF7n1MqDJA (small blind) collected ($5)
Seat 5: qGHGf/553gQnDoklMRe3tg (big blind) folded before Flop
Seat 6: QqiZLFrN8iOUT/GHw7ztOA folded before Flop (didn't bet)




PokerStars Game #59941982696:  Hold'em No Limit ($0.10/$0.25) - 2009/07/01 1:52:21 ET
Table 'yAHDCs33TIgw3ra63xuU2Q' 9-max Seat #5 is the button
Seat 1: Z9AeOQX3yzuSvKAm/xyovg ($8.25 in chips) 
Seat 2: j4q3p0lesp63b1gZDwLBZw ($5 in chips) 
Seat 4: j5spkbnOCRiLGiH6iqBaqw ($16.45 in chips) 
Seat 5: 4awUyiDYTgylQKXZ9faBVA ($36.25 in chips) 
Seat 8: PCA4x6k6ozLkTt7qDUqp7w ($13.30 in chips) 
UXvybU2w7Zc8RP8R+ngNeg will be allowed to play after the button
PCA4x6k6ozLkTt7qDUqp7w: posts small blind $0.10
MtVtHDqIJTyUcXkRBBDIVA: is sitting out 
Z9AeOQX3yzuSvKAm/xyovg: posts big blind $0.25
*** HOLE CARDS ***
j4q3p0lesp63b1gZDwLBZw: raises $0.75 to $1
j5spkbnOCRiLGiH6iqBaqw: folds 
MtVtHDqIJTyUcXkRBBDIVA has returned
MtVtHDqIJTyUcXkRBBDIVA leaves the table
4awUyiDYTgylQKXZ9faBVA: folds 
PCA4x6k6ozLkTt7qDUqp7w: folds 
Z9AeOQX3yzuSvKAm/xyovg: folds 
Uncalled bet ($0.75) returned to j4q3p0lesp63b1gZDwLBZw
PCA4x6k6ozLkTt7qDUqp7w leaves the table
j4q3p0lesp63b1gZDwLBZw collected $0.60 from pot
j4q3p0lesp63b1gZDwLBZw: doesn't show hand 
*** SUMMARY ***
Total pot $0.60 | Rake $0 
Seat 1: Z9AeOQX3yzuSvKAm/xyovg (big blind) folded before Flop
Seat 2: j4q3p0lesp63b1gZDwLBZw collected ($0.60)
Seat 4: j5spkbnOCRiLGiH6iqBaqw folded before Flop (didn't bet)
Seat 5: 4awUyiDYTgylQKXZ9faBVA (button) folded before Flop (didn't bet)
Seat 8: PCA4x6k6ozLkTt7qDUqp7w (small blind) folded before Flop




PokerStars Game #59941983514:  Hold'em No Limit ($0.10/$0.25) - 2009/07/01 1:52:22 ET
Table 'gnrUwXkIPE0C8xl6cB4Hyw' 9-max Seat #2 is the button
Seat 1: EQXHDnIzAsORnIXRNtXRlA ($22.60 in chips) 
Seat 2: 7je+LC5Mfs6nL8YBVh4frQ ($4.65 in chips) 
Seat 3: PdIasPkzm2sqZnN41ZRXOg ($5.45 in chips) 
Seat 4: wGigCmBR/9XWkPpvYos3aQ ($25 in chips) 
Seat 5: gehe91e0IyVT0QU/XBkEyg ($31.30 in chips) 
Seat 6: dtZ84flFEi4Q+SGrHMJRDQ ($25.80 in chips) 
Seat 8: 4awUyiDYTgylQKXZ9faBVA ($60.65 in chips) 
Seat 9: F7pnn6czNpHvRM55XcA2EA ($25.35 in chips) 
PdIasPkzm2sqZnN41ZRXOg: posts small blind $0.10
wGigCmBR/9XWkPpvYos3aQ: posts big blind $0.25
RHqgdFvufLCYe54+qd2gcA: sits out 
*** HOLE CARDS ***
gehe91e0IyVT0QU/XBkEyg: folds 
dtZ84flFEi4Q+SGrHMJRDQ: raises $0.75 to $1
4awUyiDYTgylQKXZ9faBVA: folds 
F7pnn6czNpHvRM55XcA2EA: folds 
EQXHDnIzAsORnIXRNtXRlA: folds 
7je+LC5Mfs6nL8YBVh4frQ: folds 
PdIasPkzm2sqZnN41ZRXOg: folds 
wGigCmBR/9XWkPpvYos3aQ: folds 
Uncalled bet ($0.75) returned to dtZ84flFEi4Q+SGrHMJRDQ
dtZ84flFEi4Q+SGrHMJRDQ collected $0.60 from pot
dtZ84flFEi4Q+SGrHMJRDQ: doesn't show hand 
*** SUMMARY ***
Total pot $0.60 | Rake $0 
Seat 1: EQXHDnIzAsORnIXRNtXRlA folded before Flop (didn't bet)
Seat 2: 7je+LC5Mfs6nL8YBVh4frQ (button) folded before Flop (didn't bet)
Seat 3: PdIasPkzm2sqZnN41ZRXOg (small blind) folded before Flop
Seat 4: wGigCmBR/9XWkPpvYos3aQ (big blind) folded before Flop
Seat 5: gehe91e0IyVT0QU/XBkEyg folded before Flop (didn't bet)
Seat 6: dtZ84flFEi4Q+SGrHMJRDQ collected ($0.60)
Seat 8: 4awUyiDYTgylQKXZ9faBVA folded before Flop (didn't bet)
Seat 9: F7pnn6czNpHvRM55XcA2EA folded before Flop (didn't bet)




PokerStars Game #59941983366:  Hold'em No Limit ($0.10/$0.25) - 2009/07/01 1:52:22 ET
Table 'IrJPyZ3JW2iIa+krdoSbJQ' 9-max Seat #3 is the button
Seat 1: Bb42QRQMhg5/Y0vHP8/2Xw ($25.90 in chips) 
Seat 2: X78b5v/uhqeXXoAijbw/yg ($42.60 in chips) 
Seat 3: CT7Xj/V/O5rBlhtt+RZeFQ ($39.15 in chips) 
Seat 4: bXpVeaSTPBFSPJmeXxO7nw ($4.40 in chips) 
Seat 5: tLcDklc2rBORNfixyRfVfw ($30.65 in chips) 
Seat 6: +sbyWwIcFp9kP0bDtMegfQ ($24.60 in chips) 
Seat 7: ozqb9Z1ZOsDwxxq9IKmjUA ($9.50 in chips) 
Seat 9: Mh2r9hTeTEDnh19sRZtW3g ($9.55 in chips) 
bXpVeaSTPBFSPJmeXxO7nw: posts small blind $0.10
tLcDklc2rBORNfixyRfVfw: posts big blind $0.25
*** HOLE CARDS ***
+sbyWwIcFp9kP0bDtMegfQ: folds 
ozqb9Z1ZOsDwxxq9IKmjUA: folds 
zZqOSFjPK4R4cwx0dONetw leaves the table
Mh2r9hTeTEDnh19sRZtW3g: folds 
Bb42QRQMhg5/Y0vHP8/2Xw: folds 
X78b5v/uhqeXXoAijbw/yg: folds 
CT7Xj/V/O5rBlhtt+RZeFQ: folds 
HoldEmHutch joins the table at seat #8 
bXpVeaSTPBFSPJmeXxO7nw: folds 
Uncalled bet ($0.15) returned to tLcDklc2rBORNfixyRfVfw
tLcDklc2rBORNfixyRfVfw collected $0.20 from pot
tLcDklc2rBORNfixyRfVfw: doesn't show hand 
*** SUMMARY ***
Total pot $0.20 | Rake $0 
Seat 1: Bb42QRQMhg5/Y0vHP8/2Xw folded before Flop (didn't bet)
Seat 2: X78b5v/uhqeXXoAijbw/yg folded before Flop (didn't bet)
Seat 3: CT7Xj/V/O5rBlhtt+RZeFQ (button) folded before Flop (didn't bet)
Seat 4: bXpVeaSTPBFSPJmeXxO7nw (small blind) folded before Flop
Seat 5: tLcDklc2rBORNfixyRfVfw (big blind) collected ($0.20)
Seat 6: +sbyWwIcFp9kP0bDtMegfQ folded before Flop (didn't bet)
Seat 7: ozqb9Z1ZOsDwxxq9IKmjUA folded before Flop (didn't bet)
Seat 9: Mh2r9hTeTEDnh19sRZtW3g folded before Flop (didn't bet)




PokerStars Game #59941983440:  Hold'em No Limit ($0.10/$0.25) - 2009/07/01 1:52:22 ET
Table 'emoxgHTxg9Uqeu06oLzLyg' 6-max Seat #4 is the button
Seat 1: epAUIB7h2FJXzUPRIvSkRA ($33.85 in chips) 
Seat 2: wIFhgE1PVdX6Xf6aVlSTPg ($30 in chips) 
Seat 4: 3VAbqAWh8ncE2SJOYIx2ZQ ($14.65 in chips) 
Seat 5: OIjOiBfQstWrK/RuXx7zcw ($7.95 in chips) 
Seat 6: u3Ol7kv1LmvszuHNm9rc6w ($18.65 in chips) 
OIjOiBfQstWrK/RuXx7zcw: posts small blind $0.10
u3Ol7kv1LmvszuHNm9rc6w: posts big blind $0.25
*** HOLE CARDS ***
epAUIB7h2FJXzUPRIvSkRA: folds 
wIFhgE1PVdX6Xf6aVlSTPg: folds 
3VAbqAWh8ncE2SJOYIx2ZQ: folds 
OIjOiBfQstWrK/RuXx7zcw: calls $0.15
u3Ol7kv1LmvszuHNm9rc6w: checks 
*** FLOP *** [4s 7s 8h]
OIjOiBfQstWrK/RuXx7zcw: checks 
u3Ol7kv1LmvszuHNm9rc6w: bets $0.50
OIjOiBfQstWrK/RuXx7zcw: calls $0.50
*** TURN *** [4s 7s 8h] [7c]
OIjOiBfQstWrK/RuXx7zcw: checks 
u3Ol7kv1LmvszuHNm9rc6w: checks 
*** RIVER *** [4s 7s 8h 7c] [As]
OIjOiBfQstWrK/RuXx7zcw: checks 
uD5epdBxuyc30pF1dO958Q leaves the table
u3Ol7kv1LmvszuHNm9rc6w: checks 
*** SHOW DOWN ***
OIjOiBfQstWrK/RuXx7zcw: shows [4d Kd] (two pair, Sevens and Fours)
u3Ol7kv1LmvszuHNm9rc6w: shows [3d 8s] (two pair, Eights and Sevens)
u3Ol7kv1LmvszuHNm9rc6w collected $1.45 from pot
*** SUMMARY ***
Total pot $1.50 | Rake $0.05 
Board [4s 7s 8h 7c As]
Seat 1: epAUIB7h2FJXzUPRIvSkRA folded before Flop (didn't bet)
Seat 2: wIFhgE1PVdX6Xf6aVlSTPg folded before Flop (didn't bet)
Seat 4: 3VAbqAWh8ncE2SJOYIx2ZQ (button) folded before Flop (didn't bet)
Seat 5: OIjOiBfQstWrK/RuXx7zcw (small blind) showed [4d Kd] and lost with two pair, Sevens and Fours
Seat 6: u3Ol7kv1LmvszuHNm9rc6w (big blind) showed [3d 8s] and won ($1.45) with two pair, Eights and Sevens




PokerStars Game #59941983648:  Hold'em No Limit ($0.10/$0.25) - 2009/07/01 1:52:22 ET
Table 'IuqVbFI+pwnJjvwBCGSGAw' 6-max Seat #4 is the button
Seat 1: LyDHtw3/yniNHW+DvLXbog ($27.75 in chips) 
Seat 2: w43JQj2oYPpKQVG4Yzlq1w ($25 in chips) 
Seat 3: QiL+lEgEWwy21jk/ltaRLg ($24.70 in chips) 
Seat 4: DE9hRlt14g+JdsRQ4wT7hg ($25 in chips) 
Seat 6: xC0kaiDYM6YTlgODL83O5A ($12.55 in chips) 
xC0kaiDYM6YTlgODL83O5A: posts small blind $0.10
LyDHtw3/yniNHW+DvLXbog: posts big blind $0.25
*** HOLE CARDS ***
w43JQj2oYPpKQVG4Yzlq1w: folds 
QiL+lEgEWwy21jk/ltaRLg: calls $0.25
DE9hRlt14g+JdsRQ4wT7hg: folds 
xC0kaiDYM6YTlgODL83O5A: folds 
LyDHtw3/yniNHW+DvLXbog: checks 
*** FLOP *** [2s 4c Jh]
LyDHtw3/yniNHW+DvLXbog: bets $0.50
QiL+lEgEWwy21jk/ltaRLg: raises $0.50 to $1
LyDHtw3/yniNHW+DvLXbog: calls $0.50
*** TURN *** [2s 4c Jh] [8c]
LyDHtw3/yniNHW+DvLXbog: checks 
QiL+lEgEWwy21jk/ltaRLg: checks 
*** RIVER *** [2s 4c Jh 8c] [6s]
LyDHtw3/yniNHW+DvLXbog: checks 
QiL+lEgEWwy21jk/ltaRLg: bets $1.25
LyDHtw3/yniNHW+DvLXbog: folds 
Uncalled bet ($1.25) returned to QiL+lEgEWwy21jk/ltaRLg
QiL+lEgEWwy21jk/ltaRLg collected $2.50 from pot
*** SUMMARY ***
Total pot $2.60 | Rake $0.10 
Board [2s 4c Jh 8c 6s]
Seat 1: LyDHtw3/yniNHW+DvLXbog (big blind) folded on the River
Seat 2: w43JQj2oYPpKQVG4Yzlq1w folded before Flop (didn't bet)
Seat 3: QiL+lEgEWwy21jk/ltaRLg collected ($2.50)
Seat 4: DE9hRlt14g+JdsRQ4wT7hg (button) folded before Flop (didn't bet)
Seat 6: xC0kaiDYM6YTlgODL83O5A (small blind) folded before Flop




PokerStars Game #59941983738:  Hold'em No Limit ($0.10/$0.25) - 2009/07/01 1:52:22 ET
Table 'i93c3z9RLowvuJTKA2F4Jg' 6-max Seat #5 is the button
Seat 1: tbSZq5LHglyHk61mH9eDBw ($29.60 in chips) 
Seat 2: TSmua8tGK3sTbwi0ynrW9Q ($25.95 in chips) 
Seat 3: v8m8XHovI5tqEA9mvplDSw ($24.95 in chips) 
Seat 4: o86X2Q5GEDU3uP9oj1iFZA ($37.45 in chips) 
Seat 5: TI/C5Q+DEl4fLR3AofwYdg ($14.40 in chips) 
Seat 6: FpN4KbLjlyRRKiVaQcoLqA ($20.35 in chips) 
FpN4KbLjlyRRKiVaQcoLqA: posts small blind $0.10
tbSZq5LHglyHk61mH9eDBw: posts big blind $0.25
*** HOLE CARDS ***
TSmua8tGK3sTbwi0ynrW9Q: raises $0.50 to $0.75
v8m8XHovI5tqEA9mvplDSw: calls $0.75
o86X2Q5GEDU3uP9oj1iFZA: folds 
TI/C5Q+DEl4fLR3AofwYdg: raises $2 to $2.75
FpN4KbLjlyRRKiVaQcoLqA: folds 
tbSZq5LHglyHk61mH9eDBw: calls $2.50
TSmua8tGK3sTbwi0ynrW9Q: folds 
v8m8XHovI5tqEA9mvplDSw: calls $2
*** FLOP *** [Jh 4s 2h]
tbSZq5LHglyHk61mH9eDBw: bets $0.75
v8m8XHovI5tqEA9mvplDSw: folds 
TI/C5Q+DEl4fLR3AofwYdg: raises $4.75 to $5.50
tbSZq5LHglyHk61mH9eDBw: calls $4.75
*** TURN *** [Jh 4s 2h] [8d]
tbSZq5LHglyHk61mH9eDBw: checks 
TI/C5Q+DEl4fLR3AofwYdg: checks 
*** RIVER *** [Jh 4s 2h 8d] [Ts]
tbSZq5LHglyHk61mH9eDBw: checks 
TI/C5Q+DEl4fLR3AofwYdg: bets $6.15 and is all-in
tbSZq5LHglyHk61mH9eDBw: folds 
Uncalled bet ($6.15) returned to TI/C5Q+DEl4fLR3AofwYdg
TI/C5Q+DEl4fLR3AofwYdg collected $19.15 from pot
TI/C5Q+DEl4fLR3AofwYdg: shows [Qs Ac] (high card Ace)
*** SUMMARY ***
Total pot $20.10 | Rake $0.95 
Board [Jh 4s 2h 8d Ts]
Seat 1: tbSZq5LHglyHk61mH9eDBw (big blind) folded on the River
Seat 2: TSmua8tGK3sTbwi0ynrW9Q folded before Flop
Seat 3: v8m8XHovI5tqEA9mvplDSw folded on the Flop
Seat 4: o86X2Q5GEDU3uP9oj1iFZA folded before Flop (didn't bet)
Seat 5: TI/C5Q+DEl4fLR3AofwYdg (button) collected ($19.15)
Seat 6: FpN4KbLjlyRRKiVaQcoLqA (small blind) folded before Flop




PokerStars Game #59941983748:  Hold'em No Limit ($0.10/$0.25) - 2009/07/01 1:52:22 ET
Table 'x7YStLKc8hpt/pTgSetPKA' 9-max Seat #2 is the button
Seat 2: z5GxcHlYz/GSz6W2uFiTtg ($19.75 in chips) 
Seat 3: S7Ki0P+0AIGPuIfGJjW0gg ($10.85 in chips) 
Seat 5: tLcDklc2rBORNfixyRfVfw ($25 in chips) 
Seat 6: 9YN2IkT2JYYKFErZtZvCtA ($49.60 in chips) 
Seat 7: dtZ84flFEi4Q+SGrHMJRDQ ($25 in chips) 
Seat 8: j4q3p0lesp63b1gZDwLBZw ($5.50 in chips) 
Seat 9: nm4Dj/f+jJEwKVsUnKh73g ($37.20 in chips) 
S7Ki0P+0AIGPuIfGJjW0gg: posts small blind $0.10
tLcDklc2rBORNfixyRfVfw: posts big blind $0.25
satchmoiluvu: sits out 
*** HOLE CARDS ***
9YN2IkT2JYYKFErZtZvCtA: folds 
dtZ84flFEi4Q+SGrHMJRDQ: folds 
j4q3p0lesp63b1gZDwLBZw: folds 
nm4Dj/f+jJEwKVsUnKh73g: raises $0.25 to $0.50
z5GxcHlYz/GSz6W2uFiTtg: folds 
S7Ki0P+0AIGPuIfGJjW0gg: folds 
tLcDklc2rBORNfixyRfVfw: folds 
Uncalled bet ($0.25) returned to nm4Dj/f+jJEwKVsUnKh73g
nm4Dj/f+jJEwKVsUnKh73g collected $0.60 from pot
*** SUMMARY ***
Total pot $0.60 | Rake $0 
Seat 2: z5GxcHlYz/GSz6W2uFiTtg (button) folded before Flop (didn't bet)
Seat 3: S7Ki0P+0AIGPuIfGJjW0gg (small blind) folded before Flop
Seat 5: tLcDklc2rBORNfixyRfVfw (big blind) folded before Flop
Seat 6: 9YN2IkT2JYYKFErZtZvCtA folded before Flop (didn't bet)
Seat 7: dtZ84flFEi4Q+SGrHMJRDQ folded before Flop (didn't bet)
Seat 8: j4q3p0lesp63b1gZDwLBZw folded before Flop (didn't bet)
Seat 9: nm4Dj/f+jJEwKVsUnKh73g collected ($0.60)




PokerStars Game #59941983882:  Hold'em No Limit ($0.10/$0.25) - 2009/07/01 1:52:23 ET
Table 'KTZXQ4LREPjpS54R3DFTsw' 9-max Seat #7 is the button
Seat 1: dSjkBIV7Bv+ZCIWNBguf7w ($40.85 in chips) 
Seat 3: H5Se03ZqSX7tbULXur2MAg ($31.40 in chips) 
Seat 5: HPEB+AtKw1+C/cxU0o1ciw ($28.85 in chips) 
Seat 6: Mh2r9hTeTEDnh19sRZtW3g ($5.35 in chips) 
Seat 7: yyG4svzOpC1A+sUP/scg6w ($10.45 in chips) 
Seat 8: mMd8CDS/but3UC+Zp7Up2w ($19.75 in chips) 
Seat 9: V6p0jQ/RhUsqpHLmXvEX4Q ($12.35 in chips) 
mMd8CDS/but3UC+Zp7Up2w: posts small blind $0.10
V6p0jQ/RhUsqpHLmXvEX4Q: posts big blind $0.25
CGjLyv/AvljZy2g76nYkzQ: sits out 
AiXn/9o1EwOPZUHujnh/bA: sits out 
*** HOLE CARDS ***
dSjkBIV7Bv+ZCIWNBguf7w: calls $0.25
H5Se03ZqSX7tbULXur2MAg: folds 
HPEB+AtKw1+C/cxU0o1ciw: folds 
Mh2r9hTeTEDnh19sRZtW3g: raises $0.75 to $1
yyG4svzOpC1A+sUP/scg6w: folds 
mMd8CDS/but3UC+Zp7Up2w: folds 
V6p0jQ/RhUsqpHLmXvEX4Q: folds 
dSjkBIV7Bv+ZCIWNBguf7w: calls $0.75
*** FLOP *** [Jh 6c As]
dSjkBIV7Bv+ZCIWNBguf7w: checks 
Mh2r9hTeTEDnh19sRZtW3g: bets $1.50
dSjkBIV7Bv+ZCIWNBguf7w: folds 
Uncalled bet ($1.50) returned to Mh2r9hTeTEDnh19sRZtW3g
Mh2r9hTeTEDnh19sRZtW3g collected $2.25 from pot
Mh2r9hTeTEDnh19sRZtW3g: doesn't show hand 
*** SUMMARY ***
Total pot $2.35 | Rake $0.10 
Board [Jh 6c As]
Seat 1: dSjkBIV7Bv+ZCIWNBguf7w folded on the Flop
Seat 3: H5Se03ZqSX7tbULXur2MAg folded before Flop (didn't bet)
Seat 5: HPEB+AtKw1+C/cxU0o1ciw folded before Flop (didn't bet)
Seat 6: Mh2r9hTeTEDnh19sRZtW3g collected ($2.25)
Seat 7: yyG4svzOpC1A+sUP/scg6w (button) folded before Flop (didn't bet)
Seat 8: mMd8CDS/but3UC+Zp7Up2w (small blind) folded before Flop
Seat 9: V6p0jQ/RhUsqpHLmXvEX4Q (big blind) folded before Flop




PokerStars Game #59941984314:  Hold'em No Limit ($0.10/$0.25) - 2009/07/01 1:52:24 ET
Table '/VaaaFnlEJoYVomG9uxHkA' 9-max Seat #1 is the button
Seat 1: Th3FldXKQW6hWVVPahaoOQ ($25 in chips) 
Seat 2: DIkeSkosO/tsUp9d2JVyTA ($56.55 in chips) 
Seat 4: j4q3p0lesp63b1gZDwLBZw ($5.35 in chips) 
Seat 5: cZ99hugmLBj9KhTlc8nCSw ($25 in chips) 
Seat 7: F7pnn6czNpHvRM55XcA2EA ($31.25 in chips) 
Seat 8: dfNim92Z6XK1/h5SFW5vDg ($50.50 in chips) 
Seat 9: DdPXdieucQ+n99u1n3A+rQ ($4.65 in chips) 
DIkeSkosO/tsUp9d2JVyTA: posts small blind $0.10
j4q3p0lesp63b1gZDwLBZw: posts big blind $0.25
*** HOLE CARDS ***
cZ99hugmLBj9KhTlc8nCSw: folds 
F7pnn6czNpHvRM55XcA2EA: folds 
dfNim92Z6XK1/h5SFW5vDg: folds 
DdPXdieucQ+n99u1n3A+rQ: folds 
Th3FldXKQW6hWVVPahaoOQ: folds 
DIkeSkosO/tsUp9d2JVyTA: folds 
Uncalled bet ($0.15) returned to j4q3p0lesp63b1gZDwLBZw
j4q3p0lesp63b1gZDwLBZw collected $0.20 from pot
j4q3p0lesp63b1gZDwLBZw: doesn't show hand 
*** SUMMARY ***
Total pot $0.20 | Rake $0 
Seat 1: Th3FldXKQW6hWVVPahaoOQ (button) folded before Flop (didn't bet)
Seat 2: DIkeSkosO/tsUp9d2JVyTA (small blind) folded before Flop
Seat 4: j4q3p0lesp63b1gZDwLBZw (big blind) collected ($0.20)
Seat 5: cZ99hugmLBj9KhTlc8nCSw folded before Flop (didn't bet)
Seat 7: F7pnn6czNpHvRM55XcA2EA folded before Flop (didn't bet)
Seat 8: dfNim92Z6XK1/h5SFW5vDg folded before Flop (didn't bet)
Seat 9: DdPXdieucQ+n99u1n3A+rQ folded before Flop (didn't bet)




PokerStars Game #59941984662:  Hold'em No Limit ($0.10/$0.25) - 2009/07/01 1:52:24 ET
Table 'xkqAWQFDrFt4p81M8UsoNw' 9-max Seat #5 is the button
Seat 1: tLcDklc2rBORNfixyRfVfw ($28.60 in chips) 
Seat 3: xHZZRLAaFUIC8WWI8ljOJA ($21.40 in chips) 
Seat 4: wGigCmBR/9XWkPpvYos3aQ ($25 in chips) 
Seat 5: H5Se03ZqSX7tbULXur2MAg ($27.05 in chips) 
Seat 6: 6RiVTYll/5D8zICp0MRpKw ($24.75 in chips) 
Seat 7: MG90wfSJZnOejs/KD3vlQQ ($44.55 in chips) 
Seat 8: MaqsqnOOkbNuPf4oWvOtnA ($45.20 in chips) 
Seat 9: Z9AeOQX3yzuSvKAm/xyovg ($7.55 in chips) 
6RiVTYll/5D8zICp0MRpKw: posts small blind $0.10
MG90wfSJZnOejs/KD3vlQQ: posts big blind $0.25
z5GxcHlYz/GSz6W2uFiTtg: sits out 
*** HOLE CARDS ***
MaqsqnOOkbNuPf4oWvOtnA: folds 
Z9AeOQX3yzuSvKAm/xyovg: folds 
tLcDklc2rBORNfixyRfVfw: folds 
xHZZRLAaFUIC8WWI8ljOJA: folds 
wGigCmBR/9XWkPpvYos3aQ: folds 
H5Se03ZqSX7tbULXur2MAg: folds 
6RiVTYll/5D8zICp0MRpKw: folds 
Uncalled bet ($0.15) returned to MG90wfSJZnOejs/KD3vlQQ
MG90wfSJZnOejs/KD3vlQQ collected $0.20 from pot
MG90wfSJZnOejs/KD3vlQQ: doesn't show hand 
*** SUMMARY ***
Total pot $0.20 | Rake $0 
Seat 1: tLcDklc2rBORNfixyRfVfw folded before Flop (didn't bet)
Seat 3: xHZZRLAaFUIC8WWI8ljOJA folded before Flop (didn't bet)
Seat 4: wGigCmBR/9XWkPpvYos3aQ folded before Flop (didn't bet)
Seat 5: H5Se03ZqSX7tbULXur2MAg (button) folded before Flop (didn't bet)
Seat 6: 6RiVTYll/5D8zICp0MRpKw (small blind) folded before Flop
Seat 7: MG90wfSJZnOejs/KD3vlQQ (big blind) collected ($0.20)
Seat 8: MaqsqnOOkbNuPf4oWvOtnA folded before Flop (didn't bet)
Seat 9: Z9AeOQX3yzuSvKAm/xyovg folded before Flop (didn't bet)




PokerStars Game #59941984466:  Hold'em No Limit ($0.10/$0.25) - 2009/07/01 1:52:24 ET
Table 'FuFyQHmlO/QqQp//rDRrPg' 6-max Seat #6 is the button
Seat 1: jp34e617tIzV8tKIWmfAbA ($43.80 in chips) 
Seat 2: G3h3THGB1j3qdHDVHpnJWg ($34.70 in chips) 
Seat 3: EeUZtMU058v2ObUACOF4Og ($29.60 in chips) 
Seat 5: xrf8tAXKQHG99HixCot1Iw ($26.55 in chips) 
Seat 6: 6DwBRH+xZ12AAZmeAg+aXw ($49.85 in chips) 
jp34e617tIzV8tKIWmfAbA: posts small blind $0.10
G3h3THGB1j3qdHDVHpnJWg: posts big blind $0.25
*** HOLE CARDS ***
EeUZtMU058v2ObUACOF4Og: raises $0.75 to $1
Ahsa9Yk5NPmCqQstq1EoQA leaves the table
xrf8tAXKQHG99HixCot1Iw: calls $1
6DwBRH+xZ12AAZmeAg+aXw: calls $1
jp34e617tIzV8tKIWmfAbA: folds 
G3h3THGB1j3qdHDVHpnJWg: folds 
*** FLOP *** [3h 8h 4c]
VXTONriS+Ohik+r0FeicIw joins the table at seat #4 
EeUZtMU058v2ObUACOF4Og: bets $2.50
xrf8tAXKQHG99HixCot1Iw: folds 
6DwBRH+xZ12AAZmeAg+aXw: calls $2.50
*** TURN *** [3h 8h 4c] [5s]
EeUZtMU058v2ObUACOF4Og: bets $5.25
6DwBRH+xZ12AAZmeAg+aXw: raises $10 to $15.25
EeUZtMU058v2ObUACOF4Og: folds 
Uncalled bet ($10) returned to 6DwBRH+xZ12AAZmeAg+aXw
6DwBRH+xZ12AAZmeAg+aXw collected $17.95 from pot
6DwBRH+xZ12AAZmeAg+aXw: doesn't show hand 
*** SUMMARY ***
Total pot $18.85 | Rake $0.90 
Board [3h 8h 4c 5s]
Seat 1: jp34e617tIzV8tKIWmfAbA (small blind) folded before Flop
Seat 2: G3h3THGB1j3qdHDVHpnJWg (big blind) folded before Flop
Seat 3: EeUZtMU058v2ObUACOF4Og folded on the Turn
Seat 5: xrf8tAXKQHG99HixCot1Iw folded on the Flop
Seat 6: 6DwBRH+xZ12AAZmeAg+aXw (button) collected ($17.95)




PokerStars Game #59941984452:  Hold'em No Limit ($0.10/$0.25) - 2009/07/01 1:52:24 ET
Table 'KU/HrxqxwDz8HKEhYTZ6uw' 6-max Seat #5 is the button
Seat 1: 7LKoiQHXpTQXJvWQrw907g ($38.30 in chips) 
Seat 2: kG34n23qFQA3nzdOJTQ1dA ($25.20 in chips) 
Seat 3: SFmT9ZsVopnukjvAzrxTRg ($25.10 in chips) 
Seat 5: iyZxqznXjv3vtvOJymkoLQ ($52 in chips) 
Seat 6: qWxkCeqApAWdAA0evrfDvQ ($8.85 in chips) 
qWxkCeqApAWdAA0evrfDvQ: posts small blind $0.10
7LKoiQHXpTQXJvWQrw907g: posts big blind $0.25
*** HOLE CARDS ***
kG34n23qFQA3nzdOJTQ1dA: folds 
SFmT9ZsVopnukjvAzrxTRg: raises $0.75 to $1
iyZxqznXjv3vtvOJymkoLQ: folds 
qWxkCeqApAWdAA0evrfDvQ: calls $0.90
7LKoiQHXpTQXJvWQrw907g: calls $0.75
*** FLOP *** [Ks 6c 4c]
qWxkCeqApAWdAA0evrfDvQ: checks 
7LKoiQHXpTQXJvWQrw907g: checks 
SFmT9ZsVopnukjvAzrxTRg: bets $1.75
qWxkCeqApAWdAA0evrfDvQ: folds 
7LKoiQHXpTQXJvWQrw907g: folds 
Uncalled bet ($1.75) returned to SFmT9ZsVopnukjvAzrxTRg
SFmT9ZsVopnukjvAzrxTRg collected $2.85 from pot
SFmT9ZsVopnukjvAzrxTRg: doesn't show hand 
*** SUMMARY ***
Total pot $3 | Rake $0.15 
Board [Ks 6c 4c]
Seat 1: 7LKoiQHXpTQXJvWQrw907g (big blind) folded on the Flop
Seat 2: kG34n23qFQA3nzdOJTQ1dA folded before Flop (didn't bet)
Seat 3: SFmT9ZsVopnukjvAzrxTRg collected ($2.85)
Seat 5: iyZxqznXjv3vtvOJymkoLQ (button) folded before Flop (didn't bet)
Seat 6: qWxkCeqApAWdAA0evrfDvQ (small blind) folded on the Flop




PokerStars Game #59941984518:  Hold'em No Limit ($0.10/$0.25) - 2009/07/01 1:52:24 ET
Table 'qryc9C/ELyQ3lubOaELNAQ' 6-max Seat #1 is the button
Seat 1: OZc6kkoTwtITj1ZfreJK1A ($84.30 in chips) 
Seat 2: LtASJ9OlkqGrrUKGQlpGAw ($29.55 in chips) 
Seat 4: v+QfkGiuj9bgtuNoVnDO8w ($25 in chips) 
Seat 5: 9StOHp+Y1T0K13JdgS2oQQ ($38.20 in chips) 
LtASJ9OlkqGrrUKGQlpGAw: posts small blind $0.10
v+QfkGiuj9bgtuNoVnDO8w: posts big blind $0.25
*** HOLE CARDS ***
9StOHp+Y1T0K13JdgS2oQQ: raises $0.50 to $0.75
OZc6kkoTwtITj1ZfreJK1A: folds 
LtASJ9OlkqGrrUKGQlpGAw: folds 
v+QfkGiuj9bgtuNoVnDO8w: folds 
Uncalled bet ($0.50) returned to 9StOHp+Y1T0K13JdgS2oQQ
9StOHp+Y1T0K13JdgS2oQQ collected $0.60 from pot
9StOHp+Y1T0K13JdgS2oQQ: doesn't show hand 
*** SUMMARY ***
Total pot $0.60 | Rake $0 
Seat 1: OZc6kkoTwtITj1ZfreJK1A (button) folded before Flop (didn't bet)
Seat 2: LtASJ9OlkqGrrUKGQlpGAw (small blind) folded before Flop
Seat 4: v+QfkGiuj9bgtuNoVnDO8w (big blind) folded before Flop
Seat 5: 9StOHp+Y1T0K13JdgS2oQQ collected ($0.60)




PokerStars Game #59941984644:  Hold'em No Limit ($0.10/$0.25) - 2009/07/01 1:52:24 ET
Table 'YlRA05h9BJ1EhOUSNUjJdg' 9-max Seat #8 is the button
Seat 1: dtZ84flFEi4Q+SGrHMJRDQ ($25 in chips) 
Seat 2: Y2GFAe+PT7xnUUtgqCNDFw ($9.05 in chips) 
Seat 3: Z5ZtGOON8kmSdSCll9Z3XA ($13.20 in chips) 
Seat 4: HPEB+AtKw1+C/cxU0o1ciw ($33.95 in chips) 
Seat 5: sx0lGrkT9fd4yFR+3cXUQg ($11.15 in chips) 
Seat 6: QEbIGci+itdw+re8RM5fZA ($43.65 in chips) 
Seat 7: dfNim92Z6XK1/h5SFW5vDg ($25 in chips) 
Seat 8: dmYlc+1cjwZMJ7wV+Z0rRg ($32.55 in chips) 
Seat 9: GeMoapCKDLc4ajT0Uk9ZQw ($10.85 in chips) 
GeMoapCKDLc4ajT0Uk9ZQw: posts small blind $0.10
dtZ84flFEi4Q+SGrHMJRDQ: posts big blind $0.25
*** HOLE CARDS ***
Y2GFAe+PT7xnUUtgqCNDFw: folds 
Z5ZtGOON8kmSdSCll9Z3XA: folds 
HPEB+AtKw1+C/cxU0o1ciw: folds 
sx0lGrkT9fd4yFR+3cXUQg: folds 
QEbIGci+itdw+re8RM5fZA: folds 
dfNim92Z6XK1/h5SFW5vDg: folds 
dmYlc+1cjwZMJ7wV+Z0rRg: folds 
GeMoapCKDLc4ajT0Uk9ZQw: folds 
Uncalled bet ($0.15) returned to dtZ84flFEi4Q+SGrHMJRDQ
dtZ84flFEi4Q+SGrHMJRDQ collected $0.20 from pot
dtZ84flFEi4Q+SGrHMJRDQ: doesn't show hand 
*** SUMMARY ***
Total pot $0.20 | Rake $0 
Seat 1: dtZ84flFEi4Q+SGrHMJRDQ (big blind) collected ($0.20)
Seat 2: Y2GFAe+PT7xnUUtgqCNDFw folded before Flop (didn't bet)
Seat 3: Z5ZtGOON8kmSdSCll9Z3XA folded before Flop (didn't bet)
Seat 4: HPEB+AtKw1+C/cxU0o1ciw folded before Flop (didn't bet)
Seat 5: sx0lGrkT9fd4yFR+3cXUQg folded before Flop (didn't bet)
Seat 6: QEbIGci+itdw+re8RM5fZA folded before Flop (didn't bet)
Seat 7: dfNim92Z6XK1/h5SFW5vDg folded before Flop (didn't bet)
Seat 8: dmYlc+1cjwZMJ7wV+Z0rRg (button) folded before Flop (didn't bet)
Seat 9: GeMoapCKDLc4ajT0Uk9ZQw (small blind) folded before Flop




PokerStars Game #59941985176:  Hold'em No Limit ($0.10/$0.25) - 2009/07/01 1:52:25 ET
Table 'QzXakDK7ZHNjgIpoUFGSKQ' 9-max Seat #8 is the button
Seat 1: w1ukf8uPa4+WH561TtVRxA ($25 in chips) 
Seat 2: QEbIGci+itdw+re8RM5fZA ($25 in chips) 
Seat 3: eK8qa6EPcH2zhtbmWSvc9g ($25.30 in chips) 
Seat 4: 12pxJGeALcKLTBryE6kFxA ($14.50 in chips) 
Seat 5: MtVtHDqIJTyUcXkRBBDIVA ($31.20 in chips) 
Seat 6: gehe91e0IyVT0QU/XBkEyg ($25.75 in chips) 
Seat 7: wGigCmBR/9XWkPpvYos3aQ ($28.90 in chips) 
Seat 8: Z9W7+g1WMhhZDi7DwGbCFA ($5 in chips) 
Seat 9: lwrOE80tuooHfIBx/4LUSw ($24.80 in chips) 
lwrOE80tuooHfIBx/4LUSw: posts small blind $0.10
w1ukf8uPa4+WH561TtVRxA: posts big blind $0.25
*** HOLE CARDS ***
QEbIGci+itdw+re8RM5fZA: folds 
eK8qa6EPcH2zhtbmWSvc9g: calls $0.25
12pxJGeALcKLTBryE6kFxA: raises $0.50 to $0.75
MtVtHDqIJTyUcXkRBBDIVA: folds 
gehe91e0IyVT0QU/XBkEyg: folds 
wGigCmBR/9XWkPpvYos3aQ: folds 
Z9W7+g1WMhhZDi7DwGbCFA: folds 
lwrOE80tuooHfIBx/4LUSw: folds 
w1ukf8uPa4+WH561TtVRxA: calls $0.50
eK8qa6EPcH2zhtbmWSvc9g: calls $0.50
*** FLOP *** [6s 2d 3d]
w1ukf8uPa4+WH561TtVRxA: checks 
eK8qa6EPcH2zhtbmWSvc9g: checks 
12pxJGeALcKLTBryE6kFxA: checks 
*** TURN *** [6s 2d 3d] [Qh]
w1ukf8uPa4+WH561TtVRxA: checks 
eK8qa6EPcH2zhtbmWSvc9g: checks 
12pxJGeALcKLTBryE6kFxA: bets $1.25
w1ukf8uPa4+WH561TtVRxA: folds 
eK8qa6EPcH2zhtbmWSvc9g: folds 
Uncalled bet ($1.25) returned to 12pxJGeALcKLTBryE6kFxA
12pxJGeALcKLTBryE6kFxA collected $2.25 from pot
12pxJGeALcKLTBryE6kFxA: doesn't show hand 
*** SUMMARY ***
Total pot $2.35 | Rake $0.10 
Board [6s 2d 3d Qh]
Seat 1: w1ukf8uPa4+WH561TtVRxA (big blind) folded on the Turn
Seat 2: QEbIGci+itdw+re8RM5fZA folded before Flop (didn't bet)
Seat 3: eK8qa6EPcH2zhtbmWSvc9g folded on the Turn
Seat 4: 12pxJGeALcKLTBryE6kFxA collected ($2.25)
Seat 5: MtVtHDqIJTyUcXkRBBDIVA folded before Flop (didn't bet)
Seat 6: gehe91e0IyVT0QU/XBkEyg folded before Flop (didn't bet)
Seat 7: wGigCmBR/9XWkPpvYos3aQ folded before Flop (didn't bet)
Seat 8: Z9W7+g1WMhhZDi7DwGbCFA (button) folded before Flop (didn't bet)
Seat 9: lwrOE80tuooHfIBx/4LUSw (small blind) folded before Flop




PokerStars Game #59941985156:  Hold'em No Limit ($0.10/$0.25) - 2009/07/01 1:52:25 ET
Table 'SgI2Cobdjtkh0Fd0/eTTDg' 9-max Seat #5 is the button
Seat 1: p4VoE724cQin02zatf/NOw ($3.40 in chips) 
Seat 2: uUc5QTI8+ZdC95UnznCsqg ($16.95 in chips) 
Seat 3: GeMoapCKDLc4ajT0Uk9ZQw ($9.65 in chips) 
Seat 5: RHqgdFvufLCYe54+qd2gcA ($5.90 in chips) 
Seat 6: 6RiVTYll/5D8zICp0MRpKw ($27.60 in chips) 
Seat 7: RY9uq/FyiWrrnWBl/zGQKg ($24.65 in chips) 
Seat 8: wzU16tcf+7nj2MYKa4h7+Q ($10.50 in chips) 
Seat 9: cZ99hugmLBj9KhTlc8nCSw ($30.60 in chips) 
6RiVTYll/5D8zICp0MRpKw: posts small blind $0.10
RY9uq/FyiWrrnWBl/zGQKg: posts big blind $0.25
*** HOLE CARDS ***
wzU16tcf+7nj2MYKa4h7+Q: folds 
cZ99hugmLBj9KhTlc8nCSw: folds 
p4VoE724cQin02zatf/NOw: folds 
uUc5QTI8+ZdC95UnznCsqg: calls $0.25
GeMoapCKDLc4ajT0Uk9ZQw: folds 
RHqgdFvufLCYe54+qd2gcA: raises $0.75 to $1
6RiVTYll/5D8zICp0MRpKw: folds 
RY9uq/FyiWrrnWBl/zGQKg: folds 
uUc5QTI8+ZdC95UnznCsqg: calls $0.75
*** FLOP *** [9s 2h 9h]
uUc5QTI8+ZdC95UnznCsqg: checks 
RHqgdFvufLCYe54+qd2gcA: bets $1.75
uUc5QTI8+ZdC95UnznCsqg: calls $1.75
*** TURN *** [9s 2h 9h] [Jc]
uUc5QTI8+ZdC95UnznCsqg: checks 
RHqgdFvufLCYe54+qd2gcA: bets $3.15 and is all-in
uUc5QTI8+ZdC95UnznCsqg: calls $3.15
*** RIVER *** [9s 2h 9h Jc] [Qh]
*** SHOW DOWN ***
uUc5QTI8+ZdC95UnznCsqg: shows [7h 9d] (three of a kind, Nines)
RHqgdFvufLCYe54+qd2gcA: mucks hand 
uUc5QTI8+ZdC95UnznCsqg collected $11.60 from pot
*** SUMMARY ***
Total pot $12.15 | Rake $0.55 
Board [9s 2h 9h Jc Qh]
Seat 1: p4VoE724cQin02zatf/NOw folded before Flop (didn't bet)
Seat 2: uUc5QTI8+ZdC95UnznCsqg showed [7h 9d] and won ($11.60) with three of a kind, Nines
Seat 3: GeMoapCKDLc4ajT0Uk9ZQw folded before Flop (didn't bet)
Seat 5: RHqgdFvufLCYe54+qd2gcA (button) mucked
Seat 6: 6RiVTYll/5D8zICp0MRpKw (small blind) folded before Flop
Seat 7: RY9uq/FyiWrrnWBl/zGQKg (big blind) folded before Flop
Seat 8: wzU16tcf+7nj2MYKa4h7+Q folded before Flop (didn't bet)
Seat 9: cZ99hugmLBj9KhTlc8nCSw folded before Flop (didn't bet)




PokerStars Game #59941985092:  Hold'em No Limit ($0.10/$0.25) - 2009/07/01 1:52:25 ET
Table 'vud0GB/ZlDCvUFhBFIaTlg' 9-max Seat #9 is the button
Seat 1: DiSvPC2iudwL5j9u6Huyww ($29.25 in chips) 
Seat 2: tLcDklc2rBORNfixyRfVfw ($25 in chips) 
Seat 3: W2YYHvqjaEpRrO7stZkClQ ($5.05 in chips) 
Seat 5: PFv56Q1PTkDC084eXIAYmw ($5.35 in chips) 
Seat 6: gehe91e0IyVT0QU/XBkEyg ($24.90 in chips) 
Seat 7: iG7VeTyBWf6wYNvZpbTcbw ($22.15 in chips) 
Seat 8: E0iYnEVO2ho7dH3QcCjw7g ($19.25 in chips) 
Seat 9: PdIasPkzm2sqZnN41ZRXOg ($5.45 in chips) 
DiSvPC2iudwL5j9u6Huyww: posts small blind $0.10
tLcDklc2rBORNfixyRfVfw: posts big blind $0.25
JqeaikMej6KsqTKmUhl2Lw: sits out 
*** HOLE CARDS ***
W2YYHvqjaEpRrO7stZkClQ: folds 
PFv56Q1PTkDC084eXIAYmw: folds 
gehe91e0IyVT0QU/XBkEyg: folds 
iG7VeTyBWf6wYNvZpbTcbw: folds 
E0iYnEVO2ho7dH3QcCjw7g: folds 
PdIasPkzm2sqZnN41ZRXOg: folds 
DiSvPC2iudwL5j9u6Huyww: folds 
Uncalled bet ($0.15) returned to tLcDklc2rBORNfixyRfVfw
tLcDklc2rBORNfixyRfVfw collected $0.20 from pot
tLcDklc2rBORNfixyRfVfw: doesn't show hand 
*** SUMMARY ***
Total pot $0.20 | Rake $0 
Seat 1: DiSvPC2iudwL5j9u6Huyww (small blind) folded before Flop
Seat 2: tLcDklc2rBORNfixyRfVfw (big blind) collected ($0.20)
Seat 3: W2YYHvqjaEpRrO7stZkClQ folded before Flop (didn't bet)
Seat 5: PFv56Q1PTkDC084eXIAYmw folded before Flop (didn't bet)
Seat 6: gehe91e0IyVT0QU/XBkEyg folded before Flop (didn't bet)
Seat 7: iG7VeTyBWf6wYNvZpbTcbw folded before Flop (didn't bet)
Seat 8: E0iYnEVO2ho7dH3QcCjw7g folded before Flop (didn't bet)
Seat 9: PdIasPkzm2sqZnN41ZRXOg (button) folded before Flop (didn't bet)




PokerStars Game #59941985106:  Hold'em No Limit ($0.10/$0.25) - 2009/07/01 1:52:25 ET
Table '/Xx5AsbRD4oNGMTFFC/92Q' 6-max Seat #6 is the button
Seat 2: N/zeVku/lNn+kUQejwmLpg ($11.20 in chips) 
Seat 4: 7/ROHX4tuLekJ2diYIlMkw ($2.15 in chips) 
Seat 5: kMa8BltUcBQVxnHfqdCfXg ($5 in chips) 
Seat 6: p4A+KsSkRO/5I6h0o4VQDQ ($3.90 in chips) 
N/zeVku/lNn+kUQejwmLpg: posts small blind $0.10
7/ROHX4tuLekJ2diYIlMkw: posts big blind $0.25
kMa8BltUcBQVxnHfqdCfXg: posts big blind $0.25
*** HOLE CARDS ***
kMa8BltUcBQVxnHfqdCfXg: checks 
gVYXlD41OO0ybr835GAnsQ joins the table at seat #1 
p4A+KsSkRO/5I6h0o4VQDQ has timed out
p4A+KsSkRO/5I6h0o4VQDQ: folds 
p4A+KsSkRO/5I6h0o4VQDQ is sitting out
N/zeVku/lNn+kUQejwmLpg: calls $0.15
7/ROHX4tuLekJ2diYIlMkw: raises $1.90 to $2.15 and is all-in
kMa8BltUcBQVxnHfqdCfXg: folds 
N/zeVku/lNn+kUQejwmLpg: folds 
Uncalled bet ($1.90) returned to 7/ROHX4tuLekJ2diYIlMkw
7/ROHX4tuLekJ2diYIlMkw collected $0.75 from pot
7/ROHX4tuLekJ2diYIlMkw: doesn't show hand 
*** SUMMARY ***
Total pot $0.75 | Rake $0 
Seat 2: N/zeVku/lNn+kUQejwmLpg (small blind) folded before Flop
Seat 4: 7/ROHX4tuLekJ2diYIlMkw (big blind) collected ($0.75)
Seat 5: kMa8BltUcBQVxnHfqdCfXg folded before Flop
Seat 6: p4A+KsSkRO/5I6h0o4VQDQ (button) folded before Flop (didn't bet)




PokerStars Game #59941984982:  Hold'em No Limit ($0.10/$0.25) - 2009/07/01 1:52:25 ET
Table 'rjcb+nlE+0GuJ6lBhuCkkA' 6-max Seat #4 is the button
Seat 1: lBoEwOFgzcERLIRUkUoRTw ($12.55 in chips) 
Seat 3: 8ClCHtFXGNplITm+63KB+Q ($65.50 in chips) 
Seat 4: BV+K0Phf5VBHr7aZPKqbUQ ($35.50 in chips) 
Seat 5: GC/9yVD59DUCX7hUI7gcLw ($30.25 in chips) 
GC/9yVD59DUCX7hUI7gcLw: posts small blind $0.10
lBoEwOFgzcERLIRUkUoRTw: posts big blind $0.25
*** HOLE CARDS ***
8ClCHtFXGNplITm+63KB+Q: calls $0.25
BV+K0Phf5VBHr7aZPKqbUQ: raises $1 to $1.25
GC/9yVD59DUCX7hUI7gcLw: folds 
lBoEwOFgzcERLIRUkUoRTw: folds 
8ClCHtFXGNplITm+63KB+Q: calls $1
*** FLOP *** [5s 9d 7s]
memV5jkoAdGrnRy3Q9PM7w joins the table at seat #2 
8ClCHtFXGNplITm+63KB+Q: checks 
BV+K0Phf5VBHr7aZPKqbUQ: bets $2
8ClCHtFXGNplITm+63KB+Q: calls $2
*** TURN *** [5s 9d 7s] [5c]
8ClCHtFXGNplITm+63KB+Q: checks 
BV+K0Phf5VBHr7aZPKqbUQ: bets $4
8ClCHtFXGNplITm+63KB+Q: folds 
Uncalled bet ($4) returned to BV+K0Phf5VBHr7aZPKqbUQ
BV+K0Phf5VBHr7aZPKqbUQ collected $6.55 from pot
BV+K0Phf5VBHr7aZPKqbUQ: doesn't show hand 
*** SUMMARY ***
Total pot $6.85 | Rake $0.30 
Board [5s 9d 7s 5c]
Seat 1: lBoEwOFgzcERLIRUkUoRTw (big blind) folded before Flop
Seat 3: 8ClCHtFXGNplITm+63KB+Q folded on the Turn
Seat 4: BV+K0Phf5VBHr7aZPKqbUQ (button) collected ($6.55)
Seat 5: GC/9yVD59DUCX7hUI7gcLw (small blind) folded before Flop




PokerStars Game #59941985090:  Hold'em No Limit ($0.10/$0.25) - 2009/07/01 1:52:25 ET
Table '2clPgY3+dETPD/8zjXZdFw' 6-max Seat #1 is the button
Seat 1: 7cx44/slbeTw+Cy7QB8Trg ($27.10 in chips) 
Seat 2: cWc85bEzdRzpUMhRKm8pwQ ($25 in chips) 
Seat 4: ljjhtb6FVPTx9AT9HNdtqg ($23.10 in chips) 
Seat 5: LJI7A1YgDM7hgh7o56+ReQ ($30.45 in chips) 
Seat 6: c3J/KYZ4cNsUEuz8v57I5A ($23.25 in chips) 
cWc85bEzdRzpUMhRKm8pwQ: posts small blind $0.10
FL1UWpN6oReBdznWDOy9Gg: is sitting out 
ljjhtb6FVPTx9AT9HNdtqg: posts big blind $0.25
*** HOLE CARDS ***
FL1UWpN6oReBdznWDOy9Gg leaves the table
LJI7A1YgDM7hgh7o56+ReQ: folds 
c3J/KYZ4cNsUEuz8v57I5A: folds 
7cx44/slbeTw+Cy7QB8Trg: folds 
cWc85bEzdRzpUMhRKm8pwQ: folds 
Uncalled bet ($0.15) returned to ljjhtb6FVPTx9AT9HNdtqg
ljjhtb6FVPTx9AT9HNdtqg collected $0.20 from pot
*** SUMMARY ***
Total pot $0.20 | Rake $0 
Seat 1: 7cx44/slbeTw+Cy7QB8Trg (button) folded before Flop (didn't bet)
Seat 2: cWc85bEzdRzpUMhRKm8pwQ (small blind) folded before Flop
Seat 4: ljjhtb6FVPTx9AT9HNdtqg (big blind) collected ($0.20)
Seat 5: LJI7A1YgDM7hgh7o56+ReQ folded before Flop (didn't bet)
Seat 6: c3J/KYZ4cNsUEuz8v57I5A folded before Flop (didn't bet)




PokerStars Game #59941985158:  Hold'em No Limit ($0.10/$0.25) - 2009/07/01 1:52:25 ET
Table 'nQC9LRg01NEuKFHF1nrDEw0XPo7K54oZIfG0xlNAcDRw-max Seat #4 is the button
Seat 1: qf+LMbROj8/qY878wkFHbQ ($18.25 in chips) 
Seat 2: ZhV6dUX9NQhT4zf7t+ZLJg ($23.80 in chips) 
Seat 3: 6+g0Lb6vfRDZkElV8ieHyQ ($25.60 in chips) 
Seat 4: u3Ol7kv1LmvszuHNm9rc6w ($25.25 in chips) 
Seat 5: kG34n23qFQA3nzdOJTQ1dA ($27.70 in chips) 
Seat 6: xQVFeVUDopz+akuEo2wXpQ ($52.40 in chips) 
kG34n23qFQA3nzdOJTQ1dA: posts small blind $0.10
xQVFeVUDopz+akuEo2wXpQ: posts big blind $0.25
*** HOLE CARDS ***
qf+LMbROj8/qY878wkFHbQ: raises $0.50 to $0.75
ZhV6dUX9NQhT4zf7t+ZLJg: calls $0.75
6+g0Lb6vfRDZkElV8ieHyQ: folds 
u3Ol7kv1LmvszuHNm9rc6w: folds 
kG34n23qFQA3nzdOJTQ1dA: folds 
xQVFeVUDopz+akuEo2wXpQ: folds 
*** FLOP *** [Ah 3s 6h]
qf+LMbROj8/qY878wkFHbQ: checks 
ZhV6dUX9NQhT4zf7t+ZLJg: checks 
*** TURN *** [Ah 3s 6h] [Td]
qf+LMbROj8/qY878wkFHbQ: bets $1
ZhV6dUX9NQhT4zf7t+ZLJg: calls $1
*** RIVER *** [Ah 3s 6h Td] [9h]
qf+LMbROj8/qY878wkFHbQ: bets $1.50
ZhV6dUX9NQhT4zf7t+ZLJg: calls $1.50
*** SHOW DOWN ***
qf+LMbROj8/qY878wkFHbQ: shows [Ac Jd] (a pair of Aces)
ZhV6dUX9NQhT4zf7t+ZLJg: mucks hand 
qf+LMbROj8/qY878wkFHbQ collected $6.55 from pot
*** SUMMARY ***
Total pot $6.85 | Rake $0.30 
Board [Ah 3s 6h Td 9h]
Seat 1: qf+LMbROj8/qY878wkFHbQ showed [Ac Jd] and won ($6.55) with a pair of Aces
Seat 2: ZhV6dUX9NQhT4zf7t+ZLJg mucked
Seat 3: 6+g0Lb6vfRDZkElV8ieHyQ folded before Flop (didn't bet)
Seat 4: u3Ol7kv1LmvszuHNm9rc6w (button) folded before Flop (didn't bet)
Seat 5: kG34n23qFQA3nzdOJTQ1dA (small blind) folded before Flop
Seat 6: xQVFeVUDopz+akuEo2wXpQ (big blind) folded before Flop




PokerStars Game #59941984986:  Hold'em No Limit ($0.10/$0.25) - 2009/07/01 1:52:25 ET
Table 'nlpa8xI95gAflovnFxB2yg' 6-max Seat #1 is the button
Seat 1: fZQg9veL7Dd/Z04ZTjC+wQ ($62.20 in chips) 
Seat 2: Yuyy/pDz3yAO3EbHYRYnKw ($23.30 in chips) 
Seat 3: DihMHaz4WNETH1bPDe13kA ($25.50 in chips) 
Seat 4: if4dh6jhJXeN3/qd3qCp9g ($52 in chips) 
Seat 5: pSneaCslVpgO8mzi5yQMww ($12.25 in chips) 
Seat 6: ATNFxN8fYVfSZMQW8dvbvw ($4.75 in chips) 
Yuyy/pDz3yAO3EbHYRYnKw: posts small blind $0.10
DihMHaz4WNETH1bPDe13kA: posts big blind $0.25
*** HOLE CARDS ***
if4dh6jhJXeN3/qd3qCp9g: folds 
pSneaCslVpgO8mzi5yQMww: calls $0.25
ATNFxN8fYVfSZMQW8dvbvw: raises $0.75 to $1
fZQg9veL7Dd/Z04ZTjC+wQ: folds 
Yuyy/pDz3yAO3EbHYRYnKw: folds 
DihMHaz4WNETH1bPDe13kA: folds 
pSneaCslVpgO8mzi5yQMww: raises $2.75 to $3.75
ATNFxN8fYVfSZMQW8dvbvw: raises $1 to $4.75 and is all-in
pSneaCslVpgO8mzi5yQMww: calls $1
*** FLOP *** [Th 3s 8d]
*** TURN *** [Th 3s 8d] [Ah]
*** RIVER *** [Th 3s 8d Ah] [7s]
*** SHOW DOWN ***
pSneaCslVpgO8mzi5yQMww: shows [Ks Kc] (a pair of Kings)
ATNFxN8fYVfSZMQW8dvbvw: shows [9h As] (a pair of Aces)
ATNFxN8fYVfSZMQW8dvbvw collected $9.40 from pot
*** SUMMARY ***
Total pot $9.85 | Rake $0.45 
Board [Th 3s 8d Ah 7s]
Seat 1: fZQg9veL7Dd/Z04ZTjC+wQ (button) folded before Flop (didn't bet)
Seat 2: Yuyy/pDz3yAO3EbHYRYnKw (small blind) folded before Flop
Seat 3: DihMHaz4WNETH1bPDe13kA (big blind) folded before Flop
Seat 4: if4dh6jhJXeN3/qd3qCp9g folded before Flop (didn't bet)
Seat 5: pSneaCslVpgO8mzi5yQMww showed [Ks Kc] and lost with a pair of Kings
Seat 6: ATNFxN8fYVfSZMQW8dvbvw showed [9h As] and won ($9.40) with a pair of Aces




PokerStars Game #59941984838:  Hold'em No Limit ($0.10/$0.25) - 2009/07/01 1:52:25 ET
Table '2VkNDXXsBj4bSZw/uK5atw' 6-max Seat #4 is the button
Seat 1: xrf8tAXKQHG99HixCot1Iw ($25 in chips) 
Seat 2: GbCVUNssQ7mqsPWr7J4d3w ($4.65 in chips) 
Seat 3: P+6Z5+8H5/Wyt/jHMovNvQ ($26.45 in chips) 
Seat 4: 4kIRqWKE/N0yUAcWVhLSoQ ($16.90 in chips) 
Seat 5: 7f0OkhFEOf3T+rVOFHRLnw ($17.75 in chips) 
Seat 6: n6UPMnVR4v8LFP0rWP73Fg ($11.85 in chips) 
7f0OkhFEOf3T+rVOFHRLnw: posts small blind $0.10
n6UPMnVR4v8LFP0rWP73Fg: posts big blind $0.25
*** HOLE CARDS ***
xrf8tAXKQHG99HixCot1Iw: folds 
GbCVUNssQ7mqsPWr7J4d3w: folds 
P+6Z5+8H5/Wyt/jHMovNvQ: raises $0.50 to $0.75
4kIRqWKE/N0yUAcWVhLSoQ: folds 
7f0OkhFEOf3T+rVOFHRLnw: raises $0.50 to $1.25
n6UPMnVR4v8LFP0rWP73Fg: folds 
P+6Z5+8H5/Wyt/jHMovNvQ: calls $0.50
*** FLOP *** [Kd Td Qc]
7f0OkhFEOf3T+rVOFHRLnw: bets $1.50
P+6Z5+8H5/Wyt/jHMovNvQ: folds 
Uncalled bet ($1.50) returned to 7f0OkhFEOf3T+rVOFHRLnw
7f0OkhFEOf3T+rVOFHRLnw collected $2.65 from pot
*** SUMMARY ***
Total pot $2.75 | Rake $0.10 
Board [Kd Td Qc]
Seat 1: xrf8tAXKQHG99HixCot1Iw folded before Flop (didn't bet)
Seat 2: GbCVUNssQ7mqsPWr7J4d3w folded before Flop (didn't bet)
Seat 3: P+6Z5+8H5/Wyt/jHMovNvQ folded on the Flop
Seat 4: 4kIRqWKE/N0yUAcWVhLSoQ (button) folded before Flop (didn't bet)
Seat 5: 7f0OkhFEOf3T+rVOFHRLnw (small blind) collected ($2.65)
Seat 6: n6UPMnVR4v8LFP0rWP73Fg (big blind) folded before Flop




PokerStars Game #59941985754:  Hold'em No Limit ($0.10/$0.25) - 2009/07/01 1:52:26 ET
Table '4XGDnEByOol5up4aB2KbJw' 6-max Seat #1 is the button
Seat 1: kyRaCIljYA6l33lSKQfNsg ($26.75 in chips) 
Seat 2: SFmT9ZsVopnukjvAzrxTRg ($45.65 in chips) 
Seat 3: LtASJ9OlkqGrrUKGQlpGAw ($18.55 in chips) 
Seat 4: BV+K0Phf5VBHr7aZPKqbUQ ($25 in chips) 
Seat 5: Dh01+rohD2p9pXLYeBlC5Q ($19.40 in chips) 
Seat 6: a7Ux7aERFGCbT/L3ojVfAg ($10.50 in chips) 
SFmT9ZsVopnukjvAzrxTRg: posts small blind $0.10
LtASJ9OlkqGrrUKGQlpGAw: posts big blind $0.25
*** HOLE CARDS ***
BV+K0Phf5VBHr7aZPKqbUQ: folds 
Dh01+rohD2p9pXLYeBlC5Q: calls $0.25
a7Ux7aERFGCbT/L3ojVfAg: raises $0.50 to $0.75
kyRaCIljYA6l33lSKQfNsg: folds 
SFmT9ZsVopnukjvAzrxTRg: folds 
LtASJ9OlkqGrrUKGQlpGAw: folds 
Dh01+rohD2p9pXLYeBlC5Q: calls $0.50
*** FLOP *** [8d 9c 4d]
Dh01+rohD2p9pXLYeBlC5Q: checks 
a7Ux7aERFGCbT/L3ojVfAg: checks 
*** TURN *** [8d 9c 4d] [Jh]
Dh01+rohD2p9pXLYeBlC5Q: checks 
a7Ux7aERFGCbT/L3ojVfAg: checks 
*** RIVER *** [8d 9c 4d Jh] [5h]
Dh01+rohD2p9pXLYeBlC5Q: checks 
a7Ux7aERFGCbT/L3ojVfAg: checks 
*** SHOW DOWN ***
Dh01+rohD2p9pXLYeBlC5Q: shows [Qc Kh] (high card King)
a7Ux7aERFGCbT/L3ojVfAg: shows [Qh Ah] (high card Ace)
a7Ux7aERFGCbT/L3ojVfAg collected $1.80 from pot
*** SUMMARY ***
Total pot $1.85 | Rake $0.05 
Board [8d 9c 4d Jh 5h]
Seat 1: kyRaCIljYA6l33lSKQfNsg (button) folded before Flop (didn't bet)
Seat 2: SFmT9ZsVopnukjvAzrxTRg (small blind) folded before Flop
Seat 3: LtASJ9OlkqGrrUKGQlpGAw (big blind) folded before Flop
Seat 4: BV+K0Phf5VBHr7aZPKqbUQ folded before Flop (didn't bet)
Seat 5: Dh01+rohD2p9pXLYeBlC5Q showed [Qc Kh] and lost with high card King
Seat 6: a7Ux7aERFGCbT/L3ojVfAg showed [Qh Ah] and won ($1.80) with high card Ace




PokerStars Game #59941985334:  Hold'em No Limit ($0.10/$0.25) - 2009/07/01 1:52:26 ET
Table '9L7XfAwuM7XsXE8LIg2o5Q' 6-max Seat #5 is the button
Seat 1: dOIoLBxmpLHSXBN9LZnf0Q ($29 in chips) 
Seat 2: LJI7A1YgDM7hgh7o56+ReQ ($27.30 in chips) 
Seat 3: f1OIgv29LuXUMe6o34kTQg ($16.25 in chips) 
Seat 4: jp34e617tIzV8tKIWmfAbA ($38.45 in chips) 
Seat 5: ErIN0JRL5srYjT6en1f8YQ ($23.15 in chips) 
Seat 6: k9nHZTHt8hYhYRcW8NTb4g ($18.60 in chips) 
k9nHZTHt8hYhYRcW8NTb4g: posts small blind $0.10
dOIoLBxmpLHSXBN9LZnf0Q: posts big blind $0.25
*** HOLE CARDS ***
LJI7A1YgDM7hgh7o56+ReQ: folds 
f1OIgv29LuXUMe6o34kTQg: folds 
jp34e617tIzV8tKIWmfAbA: folds 
ErIN0JRL5srYjT6en1f8YQ: raises $0.50 to $0.75
k9nHZTHt8hYhYRcW8NTb4g: folds 
dOIoLBxmpLHSXBN9LZnf0Q: raises $0.50 to $1.25
ErIN0JRL5srYjT6en1f8YQ: calls $0.50
*** FLOP *** [Th Qc 7h]
dOIoLBxmpLHSXBN9LZnf0Q: checks 
ErIN0JRL5srYjT6en1f8YQ: checks 
*** TURN *** [Th Qc 7h] [2d]
dOIoLBxmpLHSXBN9LZnf0Q: bets $3
ErIN0JRL5srYjT6en1f8YQ: folds 
Uncalled bet ($3) returned to dOIoLBxmpLHSXBN9LZnf0Q
dOIoLBxmpLHSXBN9LZnf0Q collected $2.50 from pot
dOIoLBxmpLHSXBN9LZnf0Q: doesn't show hand 
*** SUMMARY ***
Total pot $2.60 | Rake $0.10 
Board [Th Qc 7h 2d]
Seat 1: dOIoLBxmpLHSXBN9LZnf0Q (big blind) collected ($2.50)
Seat 2: LJI7A1YgDM7hgh7o56+ReQ folded before Flop (didn't bet)
Seat 3: f1OIgv29LuXUMe6o34kTQg folded before Flop (didn't bet)
Seat 4: jp34e617tIzV8tKIWmfAbA folded before Flop (didn't bet)
Seat 5: ErIN0JRL5srYjT6en1f8YQ (button) folded on the Turn
Seat 6: k9nHZTHt8hYhYRcW8NTb4g (small blind) folded before Flop




PokerStars Game #59941985778:  Hold'em No Limit ($0.10/$0.25) - 2009/07/01 1:52:26 ET
Table 'ktio12Pyq06LsrFhIorSqA' 9-max Seat #9 is the button
Seat 2: tGsFgUKjSctVaAXabrlZxw ($6.60 in chips) 
Seat 3: Z9W7+g1WMhhZDi7DwGbCFA ($5 in chips) 
Seat 4: 0QdZrkFD7aGKeBXPGbIomA ($11.15 in chips) 
Seat 5: e0pV1oisCAilWiG0FCxY6A ($14.35 in chips) 
Seat 6: jQL6XIewylQ8MmZhhq2YFg ($39.40 in chips) 
Seat 7: XGCfQsxa6PfAg3kJtzUmww ($21.75 in chips) 
Seat 8: Z5y2J55JmfLYR6/DPAGHwQ ($9.85 in chips) 
Seat 9: H5Se03ZqSX7tbULXur2MAg ($25.55 in chips) 
tGsFgUKjSctVaAXabrlZxw: posts small blind $0.10
Z9W7+g1WMhhZDi7DwGbCFA: posts big blind $0.25
*** HOLE CARDS ***
0QdZrkFD7aGKeBXPGbIomA said, "raise reraise all in  call"
0QdZrkFD7aGKeBXPGbIomA: folds 
e0pV1oisCAilWiG0FCxY6A: folds 
jQL6XIewylQ8MmZhhq2YFg: folds 
XGCfQsxa6PfAg3kJtzUmww: folds 
Z5y2J55JmfLYR6/DPAGHwQ: folds 
H5Se03ZqSX7tbULXur2MAg: folds 
tGsFgUKjSctVaAXabrlZxw: calls $0.15
Z9W7+g1WMhhZDi7DwGbCFA: checks 
*** FLOP *** [Kd Ah 2d]
jQL6XIewylQ8MmZhhq2YFg said, "it was 75 cents u re tard"
tGsFgUKjSctVaAXabrlZxw: checks 
Z9W7+g1WMhhZDi7DwGbCFA: checks 
*** TURN *** [Kd Ah 2d] [Kc]
jQL6XIewylQ8MmZhhq2YFg said, "thats niger money to me"
tGsFgUKjSctVaAXabrlZxw: bets $0.75
Z9W7+g1WMhhZDi7DwGbCFA: folds 
Uncalled bet ($0.75) returned to tGsFgUKjSctVaAXabrlZxw
tGsFgUKjSctVaAXabrlZxw collected $0.50 from pot
tGsFgUKjSctVaAXabrlZxw: doesn't show hand 
*** SUMMARY ***
Total pot $0.50 | Rake $0 
Board [Kd Ah 2d Kc]
Seat 2: tGsFgUKjSctVaAXabrlZxw (small blind) collected ($0.50)
Seat 3: Z9W7+g1WMhhZDi7DwGbCFA (big blind) folded on the Turn
Seat 4: 0QdZrkFD7aGKeBXPGbIomA folded before Flop (didn't bet)
Seat 5: e0pV1oisCAilWiG0FCxY6A folded before Flop (didn't bet)
Seat 6: jQL6XIewylQ8MmZhhq2YFg folded before Flop (didn't bet)
Seat 7: XGCfQsxa6PfAg3kJtzUmww folded before Flop (didn't bet)
Seat 8: Z5y2J55JmfLYR6/DPAGHwQ folded before Flop (didn't bet)
Seat 9: H5Se03ZqSX7tbULXur2MAg (button) folded before Flop (didn't bet)




PokerStars Game #59941985460:  Hold'em No Limit ($0.10/$0.25) - 2009/07/01 1:52:26 ET
Table 'b64Z+5XI1xkQzNfq4QHr3A' 6-max Seat #2 is the button
Seat 2: A6SjYLoKeIpFjPq0BK/2WA ($13.65 in chips) 
Seat 3: 7cx44/slbeTw+Cy7QB8Trg ($24.65 in chips) 
Seat 4: 564zqq2DUHXR3tdsOJU6JA ($17 in chips) 
Seat 6: 8ClCHtFXGNplITm+63KB+Q ($31.15 in chips) 
7cx44/slbeTw+Cy7QB8Trg: posts small blind $0.10
564zqq2DUHXR3tdsOJU6JA: posts big blind $0.25
08V++DOqzaNrRNsHIwi25w: sits out 
*** HOLE CARDS ***
8ClCHtFXGNplITm+63KB+Q: folds 
A6SjYLoKeIpFjPq0BK/2WA: folds 
7cx44/slbeTw+Cy7QB8Trg: folds 
Uncalled bet ($0.15) returned to 564zqq2DUHXR3tdsOJU6JA
564zqq2DUHXR3tdsOJU6JA collected $0.20 from pot
564zqq2DUHXR3tdsOJU6JA: doesn't show hand 
32YL2ZEp8NT4JB2RVM9euQ joins the table at seat #1 
*** SUMMARY ***
Total pot $0.20 | Rake $0 
Seat 2: A6SjYLoKeIpFjPq0BK/2WA (button) folded before Flop (didn't bet)
Seat 3: 7cx44/slbeTw+Cy7QB8Trg (small blind) folded before Flop
Seat 4: 564zqq2DUHXR3tdsOJU6JA (big blind) collected ($0.20)
Seat 6: 8ClCHtFXGNplITm+63KB+Q folded before Flop (didn't bet)




PokerStars Game #59941985474:  Hold'em No Limit ($0.10/$0.25) - 2009/07/01 1:52:26 ET
Table 'nFlmVztKq1HJEWfxmdl15w' 9-max Seat #9 is the button
Seat 1: cZ99hugmLBj9KhTlc8nCSw ($25 in chips) 
Seat 2: Th3FldXKQW6hWVVPahaoOQ ($39 in chips) 
Seat 3: DdPXdieucQ+n99u1n3A+rQ ($5.70 in chips) 
Seat 4: +5dSUwD+/k2ktlnutSMivw ($10.25 in chips) 
Seat 5: Tx6zQdk5Ozt9ObEBlU7jeg ($45.05 in chips) 
Seat 6: 4awUyiDYTgylQKXZ9faBVA ($36.15 in chips) 
Seat 7: dfNim92Z6XK1/h5SFW5vDg ($34.95 in chips) 
Seat 8: +2kMBNpY4nF1qNCRd8SJLA ($33.15 in chips) 
Seat 9: DnDcAdn9P0zGovMERigpFA ($25.40 in chips) 
cZ99hugmLBj9KhTlc8nCSw: posts small blind $0.10
Th3FldXKQW6hWVVPahaoOQ: posts big blind $0.25
*** HOLE CARDS ***
DdPXdieucQ+n99u1n3A+rQ: folds 
+5dSUwD+/k2ktlnutSMivw: folds 
Tx6zQdk5Ozt9ObEBlU7jeg: calls $0.25
4awUyiDYTgylQKXZ9faBVA: raises $1 to $1.25
dfNim92Z6XK1/h5SFW5vDg: folds 
+2kMBNpY4nF1qNCRd8SJLA: folds 
DnDcAdn9P0zGovMERigpFA: folds 
cZ99hugmLBj9KhTlc8nCSw: folds 
Th3FldXKQW6hWVVPahaoOQ: folds 
Tx6zQdk5Ozt9ObEBlU7jeg: calls $1
*** FLOP *** [Js 3c Ac]
Tx6zQdk5Ozt9ObEBlU7jeg: checks 
4awUyiDYTgylQKXZ9faBVA: bets $2
Tx6zQdk5Ozt9ObEBlU7jeg: folds 
Uncalled bet ($2) returned to 4awUyiDYTgylQKXZ9faBVA
4awUyiDYTgylQKXZ9faBVA collected $2.75 from pot
4awUyiDYTgylQKXZ9faBVA: doesn't show hand 
*** SUMMARY ***
Total pot $2.85 | Rake $0.10 
Board [Js 3c Ac]
Seat 1: cZ99hugmLBj9KhTlc8nCSw (small blind) folded before Flop
Seat 2: Th3FldXKQW6hWVVPahaoOQ (big blind) folded before Flop
Seat 3: DdPXdieucQ+n99u1n3A+rQ folded before Flop (didn't bet)
Seat 4: +5dSUwD+/k2ktlnutSMivw folded before Flop (didn't bet)
Seat 5: Tx6zQdk5Ozt9ObEBlU7jeg folded on the Flop
Seat 6: 4awUyiDYTgylQKXZ9faBVA collected ($2.75)
Seat 7: dfNim92Z6XK1/h5SFW5vDg folded before Flop (didn't bet)
Seat 8: +2kMBNpY4nF1qNCRd8SJLA folded before Flop (didn't bet)
Seat 9: DnDcAdn9P0zGovMERigpFA (button) folded before Flop (didn't bet)




PokerStars Game #59941986222:  Hold'em No Limit ($0.10/$0.25) - 2009/07/01 1:52:27 ET
Table 'pAhiNHs/spaABQia+7gWNQ' 9-max Seat #2 is the button
Seat 1: ipgcO7Pa6LC8XWpVttZfnA ($4.65 in chips) 
Seat 2: dfNim92Z6XK1/h5SFW5vDg ($25 in chips) 
Seat 3: bXpVeaSTPBFSPJmeXxO7nw ($4.75 in chips) 
Seat 4: Qduu7ikeizo6q6Ei9YvcJA ($48.10 in chips) 
Seat 5: OlPJsgR4xypSg/w1z7Gyvw ($33.60 in chips) 
Seat 6: oLa/tXLfSLLB28mcLGrxcg ($24.25 in chips) 
Seat 7: +WTkVY3GeLxqGQBbMZQiWQ ($10.30 in chips) 
Seat 8: PskTLlFIRHSp61inskRzVg ($9.70 in chips) 
Seat 9: zgi+EUykT/pZQpoUG6+oEg ($5.80 in chips) 
bXpVeaSTPBFSPJmeXxO7nw: posts small blind $0.10
Qduu7ikeizo6q6Ei9YvcJA: posts big blind $0.25
*** HOLE CARDS ***
OlPJsgR4xypSg/w1z7Gyvw: raises $0.75 to $1
oLa/tXLfSLLB28mcLGrxcg: folds 
+WTkVY3GeLxqGQBbMZQiWQ: folds 
PskTLlFIRHSp61inskRzVg: folds 
zgi+EUykT/pZQpoUG6+oEg: folds 
ipgcO7Pa6LC8XWpVttZfnA: folds 
dfNim92Z6XK1/h5SFW5vDg: folds 
bXpVeaSTPBFSPJmeXxO7nw: folds 
Qduu7ikeizo6q6Ei9YvcJA: calls $0.75
*** FLOP *** [8c 4s Ts]
Qduu7ikeizo6q6Ei9YvcJA: checks 
OlPJsgR4xypSg/w1z7Gyvw: bets $1.50
Qduu7ikeizo6q6Ei9YvcJA: folds 
Uncalled bet ($1.50) returned to OlPJsgR4xypSg/w1z7Gyvw
OlPJsgR4xypSg/w1z7Gyvw collected $2 from pot
*** SUMMARY ***
Total pot $2.10 | Rake $0.10 
Board [8c 4s Ts]
Seat 1: ipgcO7Pa6LC8XWpVttZfnA folded before Flop (didn't bet)
Seat 2: dfNim92Z6XK1/h5SFW5vDg (button) folded before Flop (didn't bet)
Seat 3: bXpVeaSTPBFSPJmeXxO7nw (small blind) folded before Flop
Seat 4: Qduu7ikeizo6q6Ei9YvcJA (big blind) folded on the Flop
Seat 5: OlPJsgR4xypSg/w1z7Gyvw collected ($2)
Seat 6: oLa/tXLfSLLB28mcLGrxcg folded before Flop (didn't bet)
Seat 7: +WTkVY3GeLxqGQBbMZQiWQ folded before Flop (didn't bet)
Seat 8: PskTLlFIRHSp61inskRzVg folded before Flop (didn't bet)
Seat 9: zgi+EUykT/pZQpoUG6+oEg folded before Flop (didn't bet)




PokerStars Game #59941986334:  Hold'em No Limit ($0.10/$0.25) - 2009/07/01 1:52:27 ET
Table 'P1IJQ2p3ACFySC35W1qwQw' 9-max Seat #6 is the button
Seat 1: bXpVeaSTPBFSPJmeXxO7nw ($5.50 in chips) 
Seat 2: vO3QVRovWemcGMkm7ijAIA ($4.10 in chips) 
Seat 3: PVxvfRTRvkgZf9WtquEkwQ ($34.45 in chips) 
Seat 5: ghNKXUBl/H+t83JF079ZBA ($56.45 in chips) 
Seat 6: ljemhp25Zg+nlA9DLCIiUw ($57.45 in chips) 
Seat 7: 7je+LC5Mfs6nL8YBVh4frQ ($4.85 in chips) 
Seat 8: tLcDklc2rBORNfixyRfVfw ($26.25 in chips) 
Seat 9: GeMoapCKDLc4ajT0Uk9ZQw ($9.75 in chips) 
7je+LC5Mfs6nL8YBVh4frQ: posts small blind $0.10
tLcDklc2rBORNfixyRfVfw: posts big blind $0.25
*** HOLE CARDS ***
GeMoapCKDLc4ajT0Uk9ZQw: folds 
bXpVeaSTPBFSPJmeXxO7nw: folds 
vO3QVRovWemcGMkm7ijAIA: calls $0.25
PVxvfRTRvkgZf9WtquEkwQ: folds 
ghNKXUBl/H+t83JF079ZBA: raises $1 to $1.25
ljemhp25Zg+nlA9DLCIiUw: calls $1.25
7je+LC5Mfs6nL8YBVh4frQ: folds 
tLcDklc2rBORNfixyRfVfw: folds 
vO3QVRovWemcGMkm7ijAIA: folds 
*** FLOP *** [6h Ac 6s]
ghNKXUBl/H+t83JF079ZBA: bets $2
ljemhp25Zg+nlA9DLCIiUw: calls $2
*** TURN *** [6h Ac 6s] [6d]
ghNKXUBl/H+t83JF079ZBA: bets $3.50
ljemhp25Zg+nlA9DLCIiUw: calls $3.50
*** RIVER *** [6h Ac 6s 6d] [6c]
ghNKXUBl/H+t83JF079ZBA: checks 
ljemhp25Zg+nlA9DLCIiUw: checks 
*** SHOW DOWN ***
ghNKXUBl/H+t83JF079ZBA: shows [Th Ks] (four of a kind, Sixes)
ljemhp25Zg+nlA9DLCIiUw: shows [Ah Qc] (four of a kind, Sixes)
ghNKXUBl/H+t83JF079ZBA collected $6.75 from pot
ljemhp25Zg+nlA9DLCIiUw collected $6.70 from pot
*** SUMMARY ***
Total pot $14.10 | Rake $0.65 
Board [6h Ac 6s 6d 6c]
Seat 1: bXpVeaSTPBFSPJmeXxO7nw folded before Flop (didn't bet)
Seat 2: vO3QVRovWemcGMkm7ijAIA folded before Flop
Seat 3: PVxvfRTRvkgZf9WtquEkwQ folded before Flop (didn't bet)
Seat 5: ghNKXUBl/H+t83JF079ZBA showed [Th Ks] and won ($6.75) with four of a kind, Sixes
Seat 6: ljemhp25Zg+nlA9DLCIiUw (button) showed [Ah Qc] and won ($6.70) with four of a kind, Sixes
Seat 7: 7je+LC5Mfs6nL8YBVh4frQ (small blind) folded before Flop
Seat 8: tLcDklc2rBORNfixyRfVfw (big blind) folded before Flop
Seat 9: GeMoapCKDLc4ajT0Uk9ZQw folded before Flop (didn't bet)




PokerStars Game #59941986342:  Hold'em No Limit ($0.10/$0.25) - 2009/07/01 1:52:27 ET
Table 'zW+7jPbOLCvlPu+dUGY5WQ' 6-max Seat #5 is the button
Seat 1: eL3+wCBjFGfQ5FMdIZihwA ($31.20 in chips) 
Seat 2: TQ7/UUMjrZ3WL5eLMho7VQ ($4.75 in chips) 
Seat 4: i48129QFpEQQ+UN4aNtmww ($14.40 in chips) 
Seat 5: rDRzxas/uMDi5Uteo081UQ ($21.15 in chips) 
Seat 6: qGHGf/553gQnDoklMRe3tg ($24.25 in chips) 
qGHGf/553gQnDoklMRe3tg: posts small blind $0.10
eL3+wCBjFGfQ5FMdIZihwA: posts big blind $0.25
*** HOLE CARDS ***
TQ7/UUMjrZ3WL5eLMho7VQ: calls $0.25
i48129QFpEQQ+UN4aNtmww: calls $0.25
rDRzxas/uMDi5Uteo081UQ: folds 
qGHGf/553gQnDoklMRe3tg: folds 
eL3+wCBjFGfQ5FMdIZihwA: checks 
*** FLOP *** [4d Ts 3s]
eL3+wCBjFGfQ5FMdIZihwA: checks 
TQ7/UUMjrZ3WL5eLMho7VQ: checks 
i48129QFpEQQ+UN4aNtmww: bets $0.75
eL3+wCBjFGfQ5FMdIZihwA: folds 
TQ7/UUMjrZ3WL5eLMho7VQ: folds 
Uncalled bet ($0.75) returned to i48129QFpEQQ+UN4aNtmww
i48129QFpEQQ+UN4aNtmww collected $0.85 from pot
i48129QFpEQQ+UN4aNtmww: doesn't show hand 
*** SUMMARY ***
Total pot $0.85 | Rake $0 
Board [4d Ts 3s]
Seat 1: eL3+wCBjFGfQ5FMdIZihwA (big blind) folded on the Flop
Seat 2: TQ7/UUMjrZ3WL5eLMho7VQ folded on the Flop
Seat 4: i48129QFpEQQ+UN4aNtmww collected ($0.85)
Seat 5: rDRzxas/uMDi5Uteo081UQ (button) folded before Flop (didn't bet)
Seat 6: qGHGf/553gQnDoklMRe3tg (small blind) folded before Flop




PokerStars Game #59941986056:  Hold'em No Limit ($0.10/$0.25) - 2009/07/01 1:52:27 ET
Table 'fHv1Mk7ZbLjprZTGWKPiEQ' 6-max Seat #4 is the button
Seat 1: OIjOiBfQstWrK/RuXx7zcw ($4.25 in chips) 
Seat 2: 9U3ZKjCsarN0DjR6mSE8Ug ($13.45 in chips) 
Seat 3: /gJNBeCkWL4o85/jvlZ4BA ($25 in chips) 
Seat 4: TSmua8tGK3sTbwi0ynrW9Q ($60 in chips) 
Seat 5: LJI7A1YgDM7hgh7o56+ReQ ($26.05 in chips) 
Seat 6: AjG0X+rNtc2W08eph8oqpw ($52.40 in chips) 
LJI7A1YgDM7hgh7o56+ReQ: posts small blind $0.10
AjG0X+rNtc2W08eph8oqpw: posts big blind $0.25
*** HOLE CARDS ***
OIjOiBfQstWrK/RuXx7zcw: folds 
9U3ZKjCsarN0DjR6mSE8Ug: raises $0.25 to $0.50
/gJNBeCkWL4o85/jvlZ4BA: folds 
TSmua8tGK3sTbwi0ynrW9Q: folds 
LJI7A1YgDM7hgh7o56+ReQ: folds 
AjG0X+rNtc2W08eph8oqpw: folds 
Uncalled bet ($0.25) returned to 9U3ZKjCsarN0DjR6mSE8Ug
9U3ZKjCsarN0DjR6mSE8Ug collected $0.60 from pot
9U3ZKjCsarN0DjR6mSE8Ug: doesn't show hand 
*** SUMMARY ***
Total pot $0.60 | Rake $0 
Seat 1: OIjOiBfQstWrK/RuXx7zcw folded before Flop (didn't bet)
Seat 2: 9U3ZKjCsarN0DjR6mSE8Ug collected ($0.60)
Seat 3: /gJNBeCkWL4o85/jvlZ4BA folded before Flop (didn't bet)
Seat 4: TSmua8tGK3sTbwi0ynrW9Q (button) folded before Flop (didn't bet)
Seat 5: LJI7A1YgDM7hgh7o56+ReQ (small blind) folded before Flop
Seat 6: AjG0X+rNtc2W08eph8oqpw (big blind) folded before Flop




PokerStars Game #59941986214:  Hold'em No Limit ($0.10/$0.25) - 2009/07/01 1:52:27 ET
Table 'ORSZkZqq+7Ja2PdeCFAytA' 9-max Seat #3 is the button
Seat 1: 3FkcXBaxKqxYVagfYUZlmw ($26.50 in chips) 
Seat 3: s9a4d23HFxaL70yUWQ0/tQ ($18.85 in chips) 
Seat 4: tbgfV2Egwn85xEt865GWQQ ($16.80 in chips) 
Seat 5: +lWbsq4dTcA70SX/+hnmpg ($5 in chips) 
Seat 7: clJsV3v77RS07bDKY+705w ($10.80 in chips) 
Seat 9: cMTFs4oCtNInkpDIecxT/w ($10.70 in chips) 
tbgfV2Egwn85xEt865GWQQ: posts small blind $0.10
+lWbsq4dTcA70SX/+hnmpg: posts big blind $0.25
ydoFOVgzvZv9ZhuWu9rXAw: sits out 
*** HOLE CARDS ***
gMF+EMhmwpnaM5TFQquf2A leaves the table
clJsV3v77RS07bDKY+705w: folds 
cMTFs4oCtNInkpDIecxT/w: folds 
3FkcXBaxKqxYVagfYUZlmw: folds 
s9a4d23HFxaL70yUWQ0/tQ: folds 
tbgfV2Egwn85xEt865GWQQ: raises $0.50 to $0.75
+lWbsq4dTcA70SX/+hnmpg: raises $0.50 to $1.25
cZ99hugmLBj9KhTlc8nCSw joins the table at seat #6 
tbgfV2Egwn85xEt865GWQQ: calls $0.50
*** FLOP *** [Kd Td Ks]
tbgfV2Egwn85xEt865GWQQ: bets $1.50
+lWbsq4dTcA70SX/+hnmpg: raises $1.50 to $3
tbgfV2Egwn85xEt865GWQQ: calls $1.50
*** TURN *** [Kd Td Ks] [2h]
tbgfV2Egwn85xEt865GWQQ: bets $0.50
+lWbsq4dTcA70SX/+hnmpg: raises $0.25 to $0.75 and is all-in
tbgfV2Egwn85xEt865GWQQ: calls $0.25
*** RIVER *** [Kd Td Ks 2h] [6h]
*** SHOW DOWN ***
tbgfV2Egwn85xEt865GWQQ: shows [As Jd] (a pair of Kings)
+lWbsq4dTcA70SX/+hnmpg: shows [Jh Js] (two pair, Kings and Jacks)
+lWbsq4dTcA70SX/+hnmpg collected $9.55 from pot
*** SUMMARY ***
Total pot $10 | Rake $0.45 
Board [Kd Td Ks 2h 6h]
Seat 1: 3FkcXBaxKqxYVagfYUZlmw folded before Flop (didn't bet)
Seat 3: s9a4d23HFxaL70yUWQ0/tQ (button) folded before Flop (didn't bet)
Seat 4: tbgfV2Egwn85xEt865GWQQ (small blind) showed [As Jd] and lost with a pair of Kings
Seat 5: +lWbsq4dTcA70SX/+hnmpg (big blind) showed [Jh Js] and won ($9.55) with two pair, Kings and Jacks
Seat 7: clJsV3v77RS07bDKY+705w folded before Flop (didn't bet)
Seat 9: cMTFs4oCtNInkpDIecxT/w folded before Flop (didn't bet)




PokerStars Game #59941986082:  Hold'em No Limit ($0.10/$0.25) - 2009/07/01 1:52:27 ET
Table 'PCxB2W9H6ma8SwsZlImuOw' 9-max Seat #8 is the button
Seat 1: SqibpGx+lf+brY0fJVvD0w ($26 in chips) 
Seat 2: bXpVeaSTPBFSPJmeXxO7nw ($4.65 in chips) 
Seat 4: RsPwA2DnzOke3hD/Of/DUg ($2.20 in chips) 
Seat 5: GZO7tOXatVoX17M2DqPcUQ ($16.85 in chips) 
Seat 6: 5/6dWEBUHldD7iGXa2LwsQ ($15.45 in chips) 
Seat 8: Pt637jKksB5MzP0UNJAAkw ($24 in chips) 
Seat 9: COwSH15MvHaRF7en6/TRZQ ($18.15 in chips) 
COwSH15MvHaRF7en6/TRZQ: posts small blind $0.10
SqibpGx+lf+brY0fJVvD0w: posts big blind $0.25
qwr38jl5txoR36M7G5qi4A: sits out 
*** HOLE CARDS ***
bXpVeaSTPBFSPJmeXxO7nw: folds 
J2a/QHAWUgo6beDRoEyg2g leaves the table
RsPwA2DnzOke3hD/Of/DUg: folds 
GZO7tOXatVoX17M2DqPcUQ: folds 
5/6dWEBUHldD7iGXa2LwsQ: folds 
Pt637jKksB5MzP0UNJAAkw: folds 
COwSH15MvHaRF7en6/TRZQ: folds 
Uncalled bet ($0.15) returned to SqibpGx+lf+brY0fJVvD0w
SqibpGx+lf+brY0fJVvD0w collected $0.20 from pot
*** SUMMARY ***
Total pot $0.20 | Rake $0 
Seat 1: SqibpGx+lf+brY0fJVvD0w (big blind) collected ($0.20)
Seat 2: bXpVeaSTPBFSPJmeXxO7nw folded before Flop (didn't bet)
Seat 4: RsPwA2DnzOke3hD/Of/DUg folded before Flop (didn't bet)
Seat 5: GZO7tOXatVoX17M2DqPcUQ folded before Flop (didn't bet)
Seat 6: 5/6dWEBUHldD7iGXa2LwsQ folded before Flop (didn't bet)
Seat 8: Pt637jKksB5MzP0UNJAAkw (button) folded before Flop (didn't bet)
Seat 9: COwSH15MvHaRF7en6/TRZQ (small blind) folded before Flop




PokerStars Game #59941986696:  Hold'em No Limit ($0.10/$0.25) - 2009/07/01 1:52:28 ET
Table 'L5GvbdQO5aCZJSE6pyQ8OA' 6-max Seat #5 is the button
Seat 1: eFj4lr1nuXLyCWNTShr1bg ($11.45 in chips) 
Seat 2: DihMHaz4WNETH1bPDe13kA ($30.55 in chips) 
Seat 3: JFIAqU8lCZ0vWwEl4bdGsg ($25.35 in chips) 
Seat 4: trN/oHqTTbPw5MNuKrOpLw ($27.15 in chips) 
Seat 5: LyDHtw3/yniNHW+DvLXbog ($29.25 in chips) 
Seat 6: v+QfkGiuj9bgtuNoVnDO8w ($38.45 in chips) 
v+QfkGiuj9bgtuNoVnDO8w: posts small blind $0.10
eFj4lr1nuXLyCWNTShr1bg: posts big blind $0.25
*** HOLE CARDS ***
DihMHaz4WNETH1bPDe13kA: folds 
JFIAqU8lCZ0vWwEl4bdGsg: folds 
trN/oHqTTbPw5MNuKrOpLw: folds 
LyDHtw3/yniNHW+DvLXbog: raises $0.75 to $1
v+QfkGiuj9bgtuNoVnDO8w: folds 
eFj4lr1nuXLyCWNTShr1bg: folds 
Uncalled bet ($0.75) returned to LyDHtw3/yniNHW+DvLXbog
LyDHtw3/yniNHW+DvLXbog collected $0.60 from pot
LyDHtw3/yniNHW+DvLXbog: doesn't show hand 
*** SUMMARY ***
Total pot $0.60 | Rake $0 
Seat 1: eFj4lr1nuXLyCWNTShr1bg (big blind) folded before Flop
Seat 2: DihMHaz4WNETH1bPDe13kA folded before Flop (didn't bet)
Seat 3: JFIAqU8lCZ0vWwEl4bdGsg folded before Flop (didn't bet)
Seat 4: trN/oHqTTbPw5MNuKrOpLw folded before Flop (didn't bet)
Seat 5: LyDHtw3/yniNHW+DvLXbog (button) collected ($0.60)
Seat 6: v+QfkGiuj9bgtuNoVnDO8w (small blind) folded before Flop




PokerStars Game #59941986494:  Hold'em No Limit ($0.10/$0.25) - 2009/07/01 1:52:28 ET
Table 'l57rayEpPtZotP9nqgSWBg' 6-max Seat #2 is the button
Seat 1: DihMHaz4WNETH1bPDe13kA ($56.50 in chips) 
Seat 2: p6adJRMXMBLr+xtQzqazIQ ($16.05 in chips) 
Seat 3: xC0kaiDYM6YTlgODL83O5A ($24.85 in chips) 
Seat 4: ErIN0JRL5srYjT6en1f8YQ ($25 in chips) 
Seat 5: WKJHaZPUgrpTVyLOEjLYmg ($10.85 in chips) 
Seat 6: IGRfskE1v9H9Bn+fz8AgNQ ($15.55 in chips) 
xC0kaiDYM6YTlgODL83O5A: posts small blind $0.10
ErIN0JRL5srYjT6en1f8YQ: posts big blind $0.25
*** HOLE CARDS ***
WKJHaZPUgrpTVyLOEjLYmg: folds 
IGRfskE1v9H9Bn+fz8AgNQ: folds 
DihMHaz4WNETH1bPDe13kA: raises $0.50 to $0.75
p6adJRMXMBLr+xtQzqazIQ: calls $0.75
xC0kaiDYM6YTlgODL83O5A: folds 
ErIN0JRL5srYjT6en1f8YQ: folds 
*** FLOP *** [Ac Kh Ts]
DihMHaz4WNETH1bPDe13kA: bets $1.15
p6adJRMXMBLr+xtQzqazIQ: calls $1.15
*** TURN *** [Ac Kh Ts] [5c]
DihMHaz4WNETH1bPDe13kA: checks 
p6adJRMXMBLr+xtQzqazIQ: checks 
*** RIVER *** [Ac Kh Ts 5c] [7c]
DihMHaz4WNETH1bPDe13kA: checks 
p6adJRMXMBLr+xtQzqazIQ: bets $1.25
DihMHaz4WNETH1bPDe13kA: calls $1.25
*** SHOW DOWN ***
p6adJRMXMBLr+xtQzqazIQ: shows [Kd 8d] (a pair of Kings)
DihMHaz4WNETH1bPDe13kA: shows [Ad Qd] (a pair of Aces)
DihMHaz4WNETH1bPDe13kA collected $6.35 from pot
*** SUMMARY ***
Total pot $6.65 | Rake $0.30 
Board [Ac Kh Ts 5c 7c]
Seat 1: DihMHaz4WNETH1bPDe13kA showed [Ad Qd] and won ($6.35) with a pair of Aces
Seat 2: p6adJRMXMBLr+xtQzqazIQ (button) showed [Kd 8d] and lost with a pair of Kings
Seat 3: xC0kaiDYM6YTlgODL83O5A (small blind) folded before Flop
Seat 4: ErIN0JRL5srYjT6en1f8YQ (big blind) folded before Flop
Seat 5: WKJHaZPUgrpTVyLOEjLYmg folded before Flop (didn't bet)
Seat 6: IGRfskE1v9H9Bn+fz8AgNQ folded before Flop (didn't bet)




PokerStars Game #59941986578:  Hold'em No Limit ($0.10/$0.25) - 2009/07/01 1:52:28 ET
Table 'YONIZZNvg4uZ4xNUO1deeA' 6-max Seat #3 is the button
Seat 1: GbCVUNssQ7mqsPWr7J4d3w ($4.30 in chips) 
Seat 2: evMMX/0gSDH791KdSAOaSg ($18.45 in chips) 
Seat 3: Eksrep3hySi2jeDHuaWiOQ ($8.50 in chips) 
Seat 4: w43JQj2oYPpKQVG4Yzlq1w ($25 in chips) 
Seat 5: if4dh6jhJXeN3/qd3qCp9g ($25 in chips) 
Seat 6: eL3+wCBjFGfQ5FMdIZihwA ($29.10 in chips) 
w43JQj2oYPpKQVG4Yzlq1w: posts small blind $0.10
if4dh6jhJXeN3/qd3qCp9g: posts big blind $0.25
*** HOLE CARDS ***
eL3+wCBjFGfQ5FMdIZihwA: folds 
GbCVUNssQ7mqsPWr7J4d3w: folds 
evMMX/0gSDH791KdSAOaSg: folds 
Eksrep3hySi2jeDHuaWiOQ: folds 
w43JQj2oYPpKQVG4Yzlq1w: folds 
Uncalled bet ($0.15) returned to if4dh6jhJXeN3/qd3qCp9g
if4dh6jhJXeN3/qd3qCp9g collected $0.20 from pot
if4dh6jhJXeN3/qd3qCp9g: doesn't show hand 
*** SUMMARY ***
Total pot $0.20 | Rake $0 
Seat 1: GbCVUNssQ7mqsPWr7J4d3w folded before Flop (didn't bet)
Seat 2: evMMX/0gSDH791KdSAOaSg folded before Flop (didn't bet)
Seat 3: Eksrep3hySi2jeDHuaWiOQ (button) folded before Flop (didn't bet)
Seat 4: w43JQj2oYPpKQVG4Yzlq1w (small blind) folded before Flop
Seat 5: if4dh6jhJXeN3/qd3qCp9g (big blind) collected ($0.20)
Seat 6: eL3+wCBjFGfQ5FMdIZihwA folded before Flop (didn't bet)




PokerStars Game #59941986800:  Hold'em No Limit ($0.10/$0.25) - 2009/07/01 1:52:28 ET
Table 'QvLFJzpzymuOsaaRYi+8fgWEMI3Mtn7dGARDbgNrKibgx Seat #9 is the button
Seat 1: cZ99hugmLBj9KhTlc8nCSw ($26.80 in chips) 
Seat 2: PdIasPkzm2sqZnN41ZRXOg ($5 in chips) 
Seat 3: Qduu7ikeizo6q6Ei9YvcJA ($25 in chips) 
Seat 4: tLcDklc2rBORNfixyRfVfw ($25.25 in chips) 
Seat 5: MG90wfSJZnOejs/KD3vlQQ ($37.45 in chips) 
Seat 6: vKdukiQ4ktU4yJ0Xx3MKnA ($7.10 in chips) 
Seat 7: rQhYIYXSyH/IivYM1dlV5A ($11.80 in chips) 
Seat 8: gehe91e0IyVT0QU/XBkEyg ($27 in chips) 
Seat 9: BWzInv8o0kN1pJybv/VjpQ ($43.80 in chips) 
cZ99hugmLBj9KhTlc8nCSw: posts small blind $0.10
PdIasPkzm2sqZnN41ZRXOg: posts big blind $0.25
*** HOLE CARDS ***
Qduu7ikeizo6q6Ei9YvcJA: folds 
tLcDklc2rBORNfixyRfVfw: folds 
MG90wfSJZnOejs/KD3vlQQ: folds 
vKdukiQ4ktU4yJ0Xx3MKnA: folds 
rQhYIYXSyH/IivYM1dlV5A: folds 
gehe91e0IyVT0QU/XBkEyg: folds 
BWzInv8o0kN1pJybv/VjpQ: folds 
cZ99hugmLBj9KhTlc8nCSw: folds 
Uncalled bet ($0.15) returned to PdIasPkzm2sqZnN41ZRXOg
PdIasPkzm2sqZnN41ZRXOg collected $0.20 from pot
PdIasPkzm2sqZnN41ZRXOg: doesn't show hand 
*** SUMMARY ***
Total pot $0.20 | Rake $0 
Seat 1: cZ99hugmLBj9KhTlc8nCSw (small blind) folded before Flop
Seat 2: PdIasPkzm2sqZnN41ZRXOg (big blind) collected ($0.20)
Seat 3: Qduu7ikeizo6q6Ei9YvcJA folded before Flop (didn't bet)
Seat 4: tLcDklc2rBORNfixyRfVfw folded before Flop (didn't bet)
Seat 5: MG90wfSJZnOejs/KD3vlQQ folded before Flop (didn't bet)
Seat 6: vKdukiQ4ktU4yJ0Xx3MKnA folded before Flop (didn't bet)
Seat 7: rQhYIYXSyH/IivYM1dlV5A folded before Flop (didn't bet)
Seat 8: gehe91e0IyVT0QU/XBkEyg folded before Flop (didn't bet)
Seat 9: BWzInv8o0kN1pJybv/VjpQ (button) folded before Flop (didn't bet)




PokerStars Game #59941987106:  Hold'em No Limit ($0.10/$0.25) - 2009/07/01 1:52:29 ET
Table 'ZiwAqg4o02gNro+JOAaFNg6wawJ+MkkvuC3coG6r+YhgSeat #7 is the button
Seat 1: 6RiVTYll/5D8zICp0MRpKw ($28.35 in chips) 
Seat 2: VCKtuATyvAq9H2JSAQxPbA ($11.25 in chips) 
Seat 3: aNpwfA31EREwO+ar4XzBCw ($32.25 in chips) 
Seat 4: RHqgdFvufLCYe54+qd2gcA ($11.55 in chips) 
Seat 5: 6HoFYfVGBefsR5Vrz62qIw5hAPbqNrvJb8PtLiceXtlg.05 in chips) 
Seat 6: 5n7e7I+px7c6CQmLpPbtsg ($4.65 in chips) 
Seat 7: yyG4svzOpC1A+sUP/scg6w ($5.60 in chips) 
Seat 8: VLIsy+xjx3olLSYO3JLS6g ($15.85 in chips) 
Seat 9: ljemhp25Zg+nlA9DLCIiUw ($23.90 in chips) 
VLIsy+xjx3olLSYO3JLS6g: posts small blind $0.10
ljemhp25Zg+nlA9DLCIiUw: posts big blind $0.25
*** HOLE CARDS ***
6RiVTYll/5D8zICp0MRpKw: folds 
VCKtuATyvAq9H2JSAQxPbA: folds 
aNpwfA31EREwO+ar4XzBCw: raises $0.75 to $1
RHqgdFvufLCYe54+qd2gcA: folds 
6HoFYfVGBefsR5Vrz62qIw5hAPbqNrvJb8PtLiceXtlglls $1
5n7e7I+px7c6CQmLpPbtsg: folds 
yyG4svzOpC1A+sUP/scg6w: folds 
VLIsy+xjx3olLSYO3JLS6g: folds 
ljemhp25Zg+nlA9DLCIiUw: folds 
*** FLOP *** [4d 5s 6s]
aNpwfA31EREwO+ar4XzBCw: bets $1.50
6HoFYfVGBefsR5Vrz62qIw5hAPbqNrvJb8PtLiceXtlgises $1.50 to $3
aNpwfA31EREwO+ar4XzBCw: raises $5 to $8
6HoFYfVGBefsR5Vrz62qIw5hAPbqNrvJb8PtLiceXtlglls $4.05 and is all-in
Uncalled bet ($0.95) returned to aNpwfA31EREwO+ar4XzBCw
*** TURN *** [4d 5s 6s] [5d]
*** RIVER *** [4d 5s 6s 5d] [6d]
*** SHOW DOWN ***
aNpwfA31EREwO+ar4XzBCw: shows [8c 8h] (two pair, Eights and Sixes)
6HoFYfVGBefsR5Vrz62qIw5hAPbqNrvJb8PtLiceXtlgcks hand 
aNpwfA31EREwO+ar4XzBCw collected $15.65 from pot
*** SUMMARY ***
Total pot $16.45 | Rake $0.80 
Board [4d 5s 6s 5d 6d]
Seat 1: 6RiVTYll/5D8zICp0MRpKw folded before Flop (didn't bet)
Seat 2: VCKtuATyvAq9H2JSAQxPbA folded before Flop (didn't bet)
Seat 3: aNpwfA31EREwO+ar4XzBCw showed [8c 8h] and won ($15.65) with two pair, Eights and Sixes
Seat 4: RHqgdFvufLCYe54+qd2gcA folded before Flop (didn't bet)
Seat 5: 6HoFYfVGBefsR5Vrz62qIw5hAPbqNrvJb8PtLiceXtlgked
Seat 6: 5n7e7I+px7c6CQmLpPbtsg folded before Flop (didn't bet)
Seat 7: yyG4svzOpC1A+sUP/scg6w (button) folded before Flop (didn't bet)
Seat 8: VLIsy+xjx3olLSYO3JLS6g (small blind) folded before Flop
Seat 9: ljemhp25Zg+nlA9DLCIiUw (big blind) folded before Flop




PokerStars Game #59941987060:  Hold'em No Limit ($0.10/$0.25) - 2009/07/01 1:52:29 ET
Table 'axb9RsG8Zj1A0LEukTeFrQ' 9-max Seat #1 is the button
Seat 1: qwr38jl5txoR36M7G5qi4A ($8.15 in chips) 
Seat 2: zDrucyjVn5aeekNEc3cJrA ($21.15 in chips) 
Seat 3: H5Se03ZqSX7tbULXur2MAg ($25.05 in chips) 
Seat 4: tLcDklc2rBORNfixyRfVfw ($25 in chips) 
Seat 5: rLSSHKOHnb6yzVfDoQM/RA ($11.50 in chips) 
Seat 6: Iu9xjReQYvxYiqQm8n6MXQ ($11 in chips) 
Seat 7: PdIasPkzm2sqZnN41ZRXOg ($5 in chips) 
Seat 8: VBHxUExRAMrbxUq/cVx9Gw ($5 in chips) 
Seat 9: qbQE8CifKB4+OEvNF/61Rw ($56.60 in chips) 
zDrucyjVn5aeekNEc3cJrA: posts small blind $0.10
H5Se03ZqSX7tbULXur2MAg: posts big blind $0.25
*** HOLE CARDS ***
tLcDklc2rBORNfixyRfVfw: folds 
rLSSHKOHnb6yzVfDoQM/RA: folds 
Iu9xjReQYvxYiqQm8n6MXQ: calls $0.25
PdIasPkzm2sqZnN41ZRXOg: folds 
VBHxUExRAMrbxUq/cVx9Gw: folds 
qbQE8CifKB4+OEvNF/61Rw: folds 
qwr38jl5txoR36M7G5qi4A: raises $1 to $1.25
zDrucyjVn5aeekNEc3cJrA: folds 
H5Se03ZqSX7tbULXur2MAg: folds 
Iu9xjReQYvxYiqQm8n6MXQ: folds 
Uncalled bet ($1) returned to qwr38jl5txoR36M7G5qi4A
qwr38jl5txoR36M7G5qi4A collected $0.85 from pot
qwr38jl5txoR36M7G5qi4A: doesn't show hand 
*** SUMMARY ***
Total pot $0.85 | Rake $0 
Seat 1: qwr38jl5txoR36M7G5qi4A (button) collected ($0.85)
Seat 2: zDrucyjVn5aeekNEc3cJrA (small blind) folded before Flop
Seat 3: H5Se03ZqSX7tbULXur2MAg (big blind) folded before Flop
Seat 4: tLcDklc2rBORNfixyRfVfw folded before Flop (didn't bet)
Seat 5: rLSSHKOHnb6yzVfDoQM/RA folded before Flop (didn't bet)
Seat 6: Iu9xjReQYvxYiqQm8n6MXQ folded before Flop
Seat 7: PdIasPkzm2sqZnN41ZRXOg folded before Flop (didn't bet)
Seat 8: VBHxUExRAMrbxUq/cVx9Gw folded before Flop (didn't bet)
Seat 9: qbQE8CifKB4+OEvNF/61Rw folded before Flop (didn't bet)




PokerStars Game #59941986876:  Hold'em No Limit ($0.10/$0.25) - 2009/07/01 1:52:29 ET
Table '+fuYjvJy9okLr23QyZtanA' 9-max Seat #2 is the button
Seat 2: tLcDklc2rBORNfixyRfVfw ($25.40 in chips) 
Seat 3: eK8qa6EPcH2zhtbmWSvc9g ($52.05 in chips) 
Seat 4: Bb42QRQMhg5/Y0vHP8/2Xw ($32.25 in chips) 
Seat 5: bXpVeaSTPBFSPJmeXxO7nw ($4.30 in chips) 
Seat 6: wGigCmBR/9XWkPpvYos3aQ ($29.80 in chips) 
Seat 7: dfNim92Z6XK1/h5SFW5vDg ($36.50 in chips) 
Seat 8: KqS/lY/fNB9qUxokm9QfeA ($8.20 in chips) 
Seat 9: OMhlmt2waO3z43ZSFNMmog ($30.05 in chips) 
eK8qa6EPcH2zhtbmWSvc9g: posts small blind $0.10
Bb42QRQMhg5/Y0vHP8/2Xw: posts big blind $0.25
*** HOLE CARDS ***
bXpVeaSTPBFSPJmeXxO7nw: folds 
wGigCmBR/9XWkPpvYos3aQ: raises $0.65 to $0.90
dfNim92Z6XK1/h5SFW5vDg: folds 
KqS/lY/fNB9qUxokm9QfeA: folds 
OMhlmt2waO3z43ZSFNMmog: folds 
tLcDklc2rBORNfixyRfVfw: calls $0.90
eK8qa6EPcH2zhtbmWSvc9g: folds 
Bb42QRQMhg5/Y0vHP8/2Xw: folds 
*** FLOP *** [6h 9d 2s]
wGigCmBR/9XWkPpvYos3aQ: bets $1.60
tLcDklc2rBORNfixyRfVfw: calls $1.60
*** TURN *** [6h 9d 2s] [3h]
wGigCmBR/9XWkPpvYos3aQ: bets $3.60
tLcDklc2rBORNfixyRfVfw: folds 
Uncalled bet ($3.60) returned to wGigCmBR/9XWkPpvYos3aQ
wGigCmBR/9XWkPpvYos3aQ collected $5.10 from pot
wGigCmBR/9XWkPpvYos3aQ: doesn't show hand 
*** SUMMARY ***
Total pot $5.35 | Rake $0.25 
Board [6h 9d 2s 3h]
Seat 2: tLcDklc2rBORNfixyRfVfw (button) folded on the Turn
Seat 3: eK8qa6EPcH2zhtbmWSvc9g (small blind) folded before Flop
Seat 4: Bb42QRQMhg5/Y0vHP8/2Xw (big blind) folded before Flop
Seat 5: bXpVeaSTPBFSPJmeXxO7nw folded before Flop (didn't bet)
Seat 6: wGigCmBR/9XWkPpvYos3aQ collected ($5.10)
Seat 7: dfNim92Z6XK1/h5SFW5vDg folded before Flop (didn't bet)
Seat 8: KqS/lY/fNB9qUxokm9QfeA folded before Flop (didn't bet)
Seat 9: OMhlmt2waO3z43ZSFNMmog folded before Flop (didn't bet)




PokerStars Game #59941987298:  Hold'em No Limit ($0.10/$0.25) - 2009/07/01 1:52:29 ET
Table '+2VxGVfkEqJ1AYfQy/JH2w' 6-max Seat #6 is the button
Seat 1: if4dh6jhJXeN3/qd3qCp9g ($28.55 in chips) 
Seat 2: qllppsCmUqovlriIWCeM/g ($5.55 in chips) 
Seat 3: epAUIB7h2FJXzUPRIvSkRA ($25.85 in chips) 
Seat 4: y+a/yGW/Jy4bPJFnaeTz5w ($16 in chips) 
Seat 6: YQNVDzvw3TmGaFiq9MhRgA ($5.35 in chips) 
if4dh6jhJXeN3/qd3qCp9g: posts small blind $0.10
qllppsCmUqovlriIWCeM/g: posts big blind $0.25
*** HOLE CARDS ***
epAUIB7h2FJXzUPRIvSkRA: folds 
y+a/yGW/Jy4bPJFnaeTz5w: raises $0.25 to $0.50
YQNVDzvw3TmGaFiq9MhRgA: calls $0.50
if4dh6jhJXeN3/qd3qCp9g: calls $0.40
qllppsCmUqovlriIWCeM/g: calls $0.25
*** FLOP *** [2d 5s 4c]
if4dh6jhJXeN3/qd3qCp9g: checks 
qllppsCmUqovlriIWCeM/g: bets $1
y+a/yGW/Jy4bPJFnaeTz5w: folds 
YQNVDzvw3TmGaFiq9MhRgA: raises $3.85 to $4.85 and is all-in
if4dh6jhJXeN3/qd3qCp9g: folds 
qllppsCmUqovlriIWCeM/g: folds 
Uncalled bet ($3.85) returned to YQNVDzvw3TmGaFiq9MhRgA
YQNVDzvw3TmGaFiq9MhRgA collected $3.85 from pot
*** SUMMARY ***
Total pot $4 | Rake $0.15 
Board [2d 5s 4c]
Seat 1: if4dh6jhJXeN3/qd3qCp9g (small blind) folded on the Flop
Seat 2: qllppsCmUqovlriIWCeM/g (big blind) folded on the Flop
Seat 3: epAUIB7h2FJXzUPRIvSkRA folded before Flop (didn't bet)
Seat 4: y+a/yGW/Jy4bPJFnaeTz5w folded on the Flop
Seat 6: YQNVDzvw3TmGaFiq9MhRgA (button) collected ($3.85)




PokerStars Game #59941987304:  Hold'em No Limit ($0.10/$0.25) - 2009/07/01 1:52:29 ET
Table 'Ok3oDLIsTc2+KxPcI0bAOA' 6-max Seat #4 is the button
Seat 2: wPSNSp4HYtytRMXTu3oPSQ ($29.25 in chips) 
Seat 3: mVwoM9qpwrGzpTUusIu2Ig ($15 in chips) 
Seat 4: LJI7A1YgDM7hgh7o56+ReQ ($33.70 in chips) 
Seat 5: DFi/Lzkjsfv8QswS80JX9Q ($29.50 in chips) 
DFi/Lzkjsfv8QswS80JX9Q: posts small blind $0.10
agQm3ugZ3qSVYNgNu1ddeA: is sitting out 
wPSNSp4HYtytRMXTu3oPSQ: posts big blind $0.25
agQm3ugZ3qSVYNgNu1ddeA leaves the table
mVwoM9qpwrGzpTUusIu2Ig: posts big blind $0.25
*** HOLE CARDS ***
mVwoM9qpwrGzpTUusIu2Ig: checks 
LJI7A1YgDM7hgh7o56+ReQ: folds 
DFi/Lzkjsfv8QswS80JX9Q: folds 
wPSNSp4HYtytRMXTu3oPSQ: checks 
*** FLOP *** [8h 6h 7s]
wPSNSp4HYtytRMXTu3oPSQ: checks 
mVwoM9qpwrGzpTUusIu2Ig: bets $0.50
wPSNSp4HYtytRMXTu3oPSQ: calls $0.50
*** TURN *** [8h 6h 7s] [2s]
wPSNSp4HYtytRMXTu3oPSQ: checks 
mVwoM9qpwrGzpTUusIu2Ig: checks 
*** RIVER *** [8h 6h 7s 2s] [5c]
wPSNSp4HYtytRMXTu3oPSQ: checks 
mVwoM9qpwrGzpTUusIu2Ig: bets $1
wPSNSp4HYtytRMXTu3oPSQ: folds 
Uncalled bet ($1) returned to mVwoM9qpwrGzpTUusIu2Ig
mVwoM9qpwrGzpTUusIu2Ig collected $1.55 from pot
*** SUMMARY ***
Total pot $1.60 | Rake $0.05 
Board [8h 6h 7s 2s 5c]
Seat 2: wPSNSp4HYtytRMXTu3oPSQ (big blind) folded on the River
Seat 3: mVwoM9qpwrGzpTUusIu2Ig collected ($1.55)
Seat 4: LJI7A1YgDM7hgh7o56+ReQ (button) folded before Flop (didn't bet)
Seat 5: DFi/Lzkjsfv8QswS80JX9Q (small blind) folded before Flop




PokerStars Game #59941987516:  Hold'em No Limit ($0.10/$0.25) - 2009/07/01 1:52:30 ET
Table '3760QYRYyCWeXf0rLZ5S2g' 9-max Seat #5 is the button
Seat 1: CT7Xj/V/O5rBlhtt+RZeFQ ($27.55 in chips) 
Seat 2: zDrucyjVn5aeekNEc3cJrA ($26.95 in chips) 
Seat 4: ziFpkH3wCzqB/qXeq/Hy7g ($25 in chips) 
Seat 5: Bb42QRQMhg5/Y0vHP8/2Xw ($29.55 in chips) 
Seat 6: q+Qdg0Hoir+SyL7haBrUnw ($13.70 in chips) 
Seat 7: 6C2DoQ+GZHBOpb+qyrSnqA ($6.10 in chips) 
Seat 8: clJsV3v77RS07bDKY+705w ($5.25 in chips) 
Seat 9: BCwIzs00xY6DtWGghTGEwg ($14.75 in chips) 
q+Qdg0Hoir+SyL7haBrUnw: posts small blind $0.10
6C2DoQ+GZHBOpb+qyrSnqA: posts big blind $0.25
4qA/3Ajg3pP6fqW+IX9/fQ: sits out 
*** HOLE CARDS ***
clJsV3v77RS07bDKY+705w: folds 
BCwIzs00xY6DtWGghTGEwg: folds 
CT7Xj/V/O5rBlhtt+RZeFQ: folds 
zDrucyjVn5aeekNEc3cJrA: folds 
ziFpkH3wCzqB/qXeq/Hy7g: raises $0.50 to $0.75
Bb42QRQMhg5/Y0vHP8/2Xw: folds 
q+Qdg0Hoir+SyL7haBrUnw: folds 
6C2DoQ+GZHBOpb+qyrSnqA: folds 
Uncalled bet ($0.50) returned to ziFpkH3wCzqB/qXeq/Hy7g
ziFpkH3wCzqB/qXeq/Hy7g collected $0.60 from pot
ziFpkH3wCzqB/qXeq/Hy7g: doesn't show hand 
*** SUMMARY ***
Total pot $0.60 | Rake $0 
Seat 1: CT7Xj/V/O5rBlhtt+RZeFQ folded before Flop (didn't bet)
Seat 2: zDrucyjVn5aeekNEc3cJrA folded before Flop (didn't bet)
Seat 4: ziFpkH3wCzqB/qXeq/Hy7g collected ($0.60)
Seat 5: Bb42QRQMhg5/Y0vHP8/2Xw (button) folded before Flop (didn't bet)
Seat 6: q+Qdg0Hoir+SyL7haBrUnw (small blind) folded before Flop
Seat 7: 6C2DoQ+GZHBOpb+qyrSnqA (big blind) folded before Flop
Seat 8: clJsV3v77RS07bDKY+705w folded before Flop (didn't bet)
Seat 9: BCwIzs00xY6DtWGghTGEwg folded before Flop (didn't bet)




PokerStars Game #59941987702:  Hold'em No Limit ($0.10/$0.25) - 2009/07/01 1:52:30 ET
Table 'HIOfhT0zga/KonFhIl6O3w' 9-max Seat #7 is the button
Seat 1: oLa/tXLfSLLB28mcLGrxcg ($27.15 in chips) 
Seat 2: er86weqXTpTB6/w2dKlYgA ($8.35 in chips) 
Seat 3: X6+pSIPfovPcE87t+LmUKQ ($4.50 in chips) 
Seat 4: qwr38jl5txoR36M7G5qi4A ($15.85 in chips) 
Seat 5: K1MDeapSEyKyGPNZGOKfEg ($36.80 in chips) 
Seat 6: MThMMgdB293VOucmN9sliQ ($25.45 in chips) 
Seat 7: wvlPJBB0PtYkfeeSRDaIvQ ($13.10 in chips) 
Seat 8: SpiiQQAzy4MUgV3I5W8giw ($24.75 in chips) 
Seat 9: dfNim92Z6XK1/h5SFW5vDg ($28.70 in chips) 
SpiiQQAzy4MUgV3I5W8giw: posts small blind $0.10
dfNim92Z6XK1/h5SFW5vDg: posts big blind $0.25
*** HOLE CARDS ***
oLa/tXLfSLLB28mcLGrxcg: folds 
er86weqXTpTB6/w2dKlYgA: folds 
X6+pSIPfovPcE87t+LmUKQ: folds 
qwr38jl5txoR36M7G5qi4A: folds 
K1MDeapSEyKyGPNZGOKfEg: calls $0.25
MThMMgdB293VOucmN9sliQ: folds 
wvlPJBB0PtYkfeeSRDaIvQ: folds 
SpiiQQAzy4MUgV3I5W8giw: folds 
dfNim92Z6XK1/h5SFW5vDg: checks 
*** FLOP *** [Tc 3h Jd]
dfNim92Z6XK1/h5SFW5vDg: checks 
K1MDeapSEyKyGPNZGOKfEg: checks 
*** TURN *** [Tc 3h Jd] [7h]
dfNim92Z6XK1/h5SFW5vDg: checks 
K1MDeapSEyKyGPNZGOKfEg: checks 
*** RIVER *** [Tc 3h Jd 7h] [As]
dfNim92Z6XK1/h5SFW5vDg: checks 
K1MDeapSEyKyGPNZGOKfEg: bets $0.50
dfNim92Z6XK1/h5SFW5vDg: folds 
Uncalled bet ($0.50) returned to K1MDeapSEyKyGPNZGOKfEg
K1MDeapSEyKyGPNZGOKfEg collected $0.60 from pot
*** SUMMARY ***
Total pot $0.60 | Rake $0 
Board [Tc 3h Jd 7h As]
Seat 1: oLa/tXLfSLLB28mcLGrxcg folded before Flop (didn't bet)
Seat 2: er86weqXTpTB6/w2dKlYgA folded before Flop (didn't bet)
Seat 3: X6+pSIPfovPcE87t+LmUKQ folded before Flop (didn't bet)
Seat 4: qwr38jl5txoR36M7G5qi4A folded before Flop (didn't bet)
Seat 5: K1MDeapSEyKyGPNZGOKfEg collected ($0.60)
Seat 6: MThMMgdB293VOucmN9sliQ folded before Flop (didn't bet)
Seat 7: wvlPJBB0PtYkfeeSRDaIvQ (button) folded before Flop (didn't bet)
Seat 8: SpiiQQAzy4MUgV3I5W8giw (small blind) folded before Flop
Seat 9: dfNim92Z6XK1/h5SFW5vDg (big blind) folded on the River




PokerStars Game #59941987580:  Hold'em No Limit ($0.10/$0.25) - 2009/07/01 1:52:30 ET
Table 'Qr+t8WGovMECkBv+cV1lrg' 6-max Seat #1 is the button
Seat 1: EeUZtMU058v2ObUACOF4Og ($34.45 in chips) 
Seat 2: vqWjZmdQu/Hxw96/IJTWdQ ($41.35 in chips) 
Seat 3: uZKkrGByYgd4/ZBX2d4z+w ($19.75 in chips) 
Seat 4: 1NNFfYMd5Hsphl/FYz9fNA ($61.40 in chips) 
Seat 5: I50OxuNg9riRq9sywF6jMQ ($4.65 in chips) 
Seat 6: 9U3ZKjCsarN0DjR6mSE8Ug ($14 in chips) 
vqWjZmdQu/Hxw96/IJTWdQ: posts small blind $0.10
uZKkrGByYgd4/ZBX2d4z+w: posts big blind $0.25
*** HOLE CARDS ***
1NNFfYMd5Hsphl/FYz9fNA: folds 
I50OxuNg9riRq9sywF6jMQ: folds 
9U3ZKjCsarN0DjR6mSE8Ug: folds 
EeUZtMU058v2ObUACOF4Og: folds 
vqWjZmdQu/Hxw96/IJTWdQ: folds 
Uncalled bet ($0.15) returned to uZKkrGByYgd4/ZBX2d4z+w
uZKkrGByYgd4/ZBX2d4z+w collected $0.20 from pot
*** SUMMARY ***
Total pot $0.20 | Rake $0 
Seat 1: EeUZtMU058v2ObUACOF4Og (button) folded before Flop (didn't bet)
Seat 2: vqWjZmdQu/Hxw96/IJTWdQ (small blind) folded before Flop
Seat 3: uZKkrGByYgd4/ZBX2d4z+w (big blind) collected ($0.20)
Seat 4: 1NNFfYMd5Hsphl/FYz9fNA folded before Flop (didn't bet)
Seat 5: I50OxuNg9riRq9sywF6jMQ folded before Flop (didn't bet)
Seat 6: 9U3ZKjCsarN0DjR6mSE8Ug folded before Flop (didn't bet)




PokerStars Game #59941987508:  Hold'em No Limit ($0.10/$0.25) - 2009/07/01 1:52:30 ET
Table 'xmJKTGBeWCwutccj3YfupQ' 6-max Seat #1 is the button
Seat 1: sVbkVl4OznxBCfi66UB9vw ($40.55 in chips) 
Seat 2: QqiZLFrN8iOUT/GHw7ztOA ($24.05 in chips) 
Seat 3: T5wrp/d5jarm+SxNy8OQAg ($17.45 in chips) 
Seat 4: uWjhTVMpuIroxXcmD3Okug ($30.30 in chips) 
Seat 5: DE9hRlt14g+JdsRQ4wT7hg ($39.05 in chips) 
Seat 6: 9bpVv1/Qh9IYtXuCtl5VtQ ($25 in chips) 
QqiZLFrN8iOUT/GHw7ztOA: posts small blind $0.10
T5wrp/d5jarm+SxNy8OQAg: posts big blind $0.25
*** HOLE CARDS ***
uWjhTVMpuIroxXcmD3Okug: folds 
DE9hRlt14g+JdsRQ4wT7hg: folds 
9bpVv1/Qh9IYtXuCtl5VtQ: raises $0.75 to $1
sVbkVl4OznxBCfi66UB9vw: folds 
QqiZLFrN8iOUT/GHw7ztOA: raises $1.75 to $2.75
T5wrp/d5jarm+SxNy8OQAg: folds 
uWjhTVMpuIroxXcmD3Okug said, "hook"
9bpVv1/Qh9IYtXuCtl5VtQ: calls $1.75
*** FLOP *** [3d 7h Ad]
uWjhTVMpuIroxXcmD3Okug said, "line"
QqiZLFrN8iOUT/GHw7ztOA: bets $4.25
9bpVv1/Qh9IYtXuCtl5VtQ: folds 
Uncalled bet ($4.25) returned to QqiZLFrN8iOUT/GHw7ztOA
QqiZLFrN8iOUT/GHw7ztOA collected $5.50 from pot
*** SUMMARY ***
Total pot $5.75 | Rake $0.25 
Board [3d 7h Ad]
Seat 1: sVbkVl4OznxBCfi66UB9vw (button) folded before Flop (didn't bet)
Seat 2: QqiZLFrN8iOUT/GHw7ztOA (small blind) collected ($5.50)
Seat 3: T5wrp/d5jarm+SxNy8OQAg (big blind) folded before Flop
Seat 4: uWjhTVMpuIroxXcmD3Okug folded before Flop (didn't bet)
Seat 5: DE9hRlt14g+JdsRQ4wT7hg folded before Flop (didn't bet)
Seat 6: 9bpVv1/Qh9IYtXuCtl5VtQ folded on the Flop




PokerStars Game #59941987476:  Hold'em No Limit ($0.10/$0.25) - 2009/07/01 1:52:30 ET
Table 'MiquQrQZJJq9ZtgRIp9HFQ' 6-max Seat #2 is the button
Seat 1: c3J/KYZ4cNsUEuz8v57I5A ($25.40 in chips) 
Seat 2: 2+6voGl1T1DO63JePptI3g ($24.85 in chips) 
Seat 3: 9h7TNZ1TDGRUJXA6rI+ZTw ($10.10 in chips) 
Seat 4: wAKC8C/zN0c8V5v13dm9mA ($51.30 in chips) 
Seat 5: iyZxqznXjv3vtvOJymkoLQ ($26.40 in chips) 
Seat 6: GbCVUNssQ7mqsPWr7J4d3w ($4.50 in chips) 
9h7TNZ1TDGRUJXA6rI+ZTw: posts small blind $0.10
wAKC8C/zN0c8V5v13dm9mA: posts big blind $0.25
*** HOLE CARDS ***
iyZxqznXjv3vtvOJymkoLQ: folds 
GbCVUNssQ7mqsPWr7J4d3w: folds 
c3J/KYZ4cNsUEuz8v57I5A: folds 
2+6voGl1T1DO63JePptI3g has timed out
2+6voGl1T1DO63JePptI3g: folds 
2+6voGl1T1DO63JePptI3g is sitting out
2+6voGl1T1DO63JePptI3g has returned
9h7TNZ1TDGRUJXA6rI+ZTw: folds 
Uncalled bet ($0.15) returned to wAKC8C/zN0c8V5v13dm9mA
wAKC8C/zN0c8V5v13dm9mA collected $0.20 from pot
*** SUMMARY ***
Total pot $0.20 | Rake $0 
Seat 1: c3J/KYZ4cNsUEuz8v57I5A folded before Flop (didn't bet)
Seat 2: 2+6voGl1T1DO63JePptI3g (button) folded before Flop (didn't bet)
Seat 3: 9h7TNZ1TDGRUJXA6rI+ZTw (small blind) folded before Flop
Seat 4: wAKC8C/zN0c8V5v13dm9mA (big blind) collected ($0.20)
Seat 5: iyZxqznXjv3vtvOJymkoLQ folded before Flop (didn't bet)
Seat 6: GbCVUNssQ7mqsPWr7J4d3w folded before Flop (didn't bet)




PokerStars Game #59941987454:  Hold'em No Limit ($0.10/$0.25) - 2009/07/01 1:52:30 ET
Table '9lYs7ljXi6AgFAxYHlKLJw' 9-max Seat #5 is the button
Seat 1: K0b5wNInj6hUGRr6yzKFtw ($36.65 in chips) 
Seat 2: 0XACOSNrAWmqNv9k1nF8rw ($14.60 in chips) 
Seat 3: arxNSjreDRGFg13EAM2F1w ($37.45 in chips) 
Seat 4: UANt6y/SmDCY/jIxkBixcw ($33.70 in chips) 
Seat 5: dfNim92Z6XK1/h5SFW5vDg ($58.85 in chips) 
Seat 7: ghNKXUBl/H+t83JF079ZBA ($28.50 in chips) 
Seat 8: 9YN2IkT2JYYKFErZtZvCtA ($18.60 in chips) 
j4q3p0lesp63b1gZDwLBZw will be allowed to play after the button
ghNKXUBl/H+t83JF079ZBA: posts small blind $0.10
9YN2IkT2JYYKFErZtZvCtA: posts big blind $0.25
IVL33RWimYC8hA5O8TO69Q: sits out 
*** HOLE CARDS ***
K0b5wNInj6hUGRr6yzKFtw: folds 
0XACOSNrAWmqNv9k1nF8rw: folds 
arxNSjreDRGFg13EAM2F1w: folds 
UANt6y/SmDCY/jIxkBixcw: folds 
dfNim92Z6XK1/h5SFW5vDg: raises $0.75 to $1
ghNKXUBl/H+t83JF079ZBA: folds 
9YN2IkT2JYYKFErZtZvCtA: folds 
Uncalled bet ($0.75) returned to dfNim92Z6XK1/h5SFW5vDg
dfNim92Z6XK1/h5SFW5vDg collected $0.60 from pot
dfNim92Z6XK1/h5SFW5vDg: doesn't show hand 
*** SUMMARY ***
Total pot $0.60 | Rake $0 
Seat 1: K0b5wNInj6hUGRr6yzKFtw folded before Flop (didn't bet)
Seat 2: 0XACOSNrAWmqNv9k1nF8rw folded before Flop (didn't bet)
Seat 3: arxNSjreDRGFg13EAM2F1w folded before Flop (didn't bet)
Seat 4: UANt6y/SmDCY/jIxkBixcw folded before Flop (didn't bet)
Seat 5: dfNim92Z6XK1/h5SFW5vDg (button) collected ($0.60)
Seat 7: ghNKXUBl/H+t83JF079ZBA (small blind) folded before Flop
Seat 8: 9YN2IkT2JYYKFErZtZvCtA (big blind) folded before Flop




PokerStars Game #59941987640:  Hold'em No Limit ($0.10/$0.25) - 2009/07/01 1:52:30 ET
Table 'HbNAGS1OJWQKyfk7UfrYyw' 9-max Seat #7 is the button
Seat 1: 3PmVnC/15cl4oyI1TKIt4g ($5 in chips) 
Seat 2: fjwM06E3HzjUrynPRQi31Q ($5.75 in chips) 
Seat 3: Yxal0LG80xJqTIctpMLWlg ($2.15 in chips) 
Seat 4: XwQK8xvCADxp0bUmji+Zyg ($17.75 in chips) 
Seat 5: clJsV3v77RS07bDKY+705w ($5 in chips) 
Seat 7: T+MjFnaPZsOyKbE9LYG2Qg ($20.45 in chips) 
Seat 9: nLE5Yo60EmSlJPyg0GgxXg ($31.05 in chips) 
DiSvPC2iudwL5j9u6Huyww will be allowed to play after the button
nLE5Yo60EmSlJPyg0GgxXg: posts small blind $0.10
3PmVnC/15cl4oyI1TKIt4g: posts big blind $0.25
*** HOLE CARDS ***
jntAuOS+eFQDYNiDN8dzag leaves the table
fjwM06E3HzjUrynPRQi31Q: folds 
Yxal0LG80xJqTIctpMLWlg: raises $1.90 to $2.15 and is all-in
XwQK8xvCADxp0bUmji+Zyg: folds 
eK8qa6EPcH2zhtbmWSvc9g joins the table at seat #6 
clJsV3v77RS07bDKY+705w: folds 
T+MjFnaPZsOyKbE9LYG2Qg: folds 
T+MjFnaPZsOyKbE9LYG2Qg leaves the table
nLE5Yo60EmSlJPyg0GgxXg: calls $2.05
3PmVnC/15cl4oyI1TKIt4g: calls $1.90
*** FLOP *** [Th Ts 5c]
bXpVeaSTPBFSPJmeXxO7nw joins the table at seat #7 
nLE5Yo60EmSlJPyg0GgxXg: checks 
3PmVnC/15cl4oyI1TKIt4g: bets $1
nLE5Yo60EmSlJPyg0GgxXg: calls $1
*** TURN *** [Th Ts 5c] [Qd]
nLE5Yo60EmSlJPyg0GgxXg: checks 
3PmVnC/15cl4oyI1TKIt4g: checks 
*** RIVER *** [Th Ts 5c Qd] [Ad]
nLE5Yo60EmSlJPyg0GgxXg: checks 
3PmVnC/15cl4oyI1TKIt4g: checks 
*** SHOW DOWN ***
nLE5Yo60EmSlJPyg0GgxXg: shows [6d Ks] (a pair of Tens)
3PmVnC/15cl4oyI1TKIt4g: shows [9c 9h] (two pair, Tens and Nines)
3PmVnC/15cl4oyI1TKIt4g collected $1.90 from side pot
Yxal0LG80xJqTIctpMLWlg: mucks hand 
3PmVnC/15cl4oyI1TKIt4g collected $6.15 from main pot
*** SUMMARY ***
Total pot $8.45 Main pot $6.15. Side pot $1.90. | Rake $0.40 
Board [Th Ts 5c Qd Ad]
Seat 1: 3PmVnC/15cl4oyI1TKIt4g (big blind) showed [9c 9h] and won ($8.05) with two pair, Tens and Nines
Seat 2: fjwM06E3HzjUrynPRQi31Q folded before Flop (didn't bet)
Seat 3: Yxal0LG80xJqTIctpMLWlg mucked
Seat 4: XwQK8xvCADxp0bUmji+Zyg folded before Flop (didn't bet)
Seat 5: clJsV3v77RS07bDKY+705w folded before Flop (didn't bet)
Seat 7: T+MjFnaPZsOyKbE9LYG2Qg (button) folded before Flop (didn't bet)
Seat 9: nLE5Yo60EmSlJPyg0GgxXg (small blind) showed [6d Ks] and lost with a pair of Tens




PokerStars Game #59941987938:  Hold'em No Limit ($0.10/$0.25) - 2009/07/01 1:52:31 ET
Table 'mVdLgAdN9rGe6mMwSrDdGQ' 6-max Seat #3 is the button
Seat 1: OyJ0KTHA5cwh0/yCo1/rdA ($7.45 in chips) 
Seat 2: n9QqWD4tpbongUBX2Oi58w ($10.80 in chips) 
Seat 3: +baiVgI/ETnBARLe5mARCw ($15.90 in chips) 
Seat 4: scNSjC6yyKvvfklSkuzLrw ($25.40 in chips) 
Seat 5: +TMG/MBWpiEnc9t7i07eTA ($23.15 in chips) 
Seat 6: DihMHaz4WNETH1bPDe13kA ($47.95 in chips) 
scNSjC6yyKvvfklSkuzLrw: posts small blind $0.10
+TMG/MBWpiEnc9t7i07eTA: posts big blind $0.25
*** HOLE CARDS ***
DihMHaz4WNETH1bPDe13kA: folds 
OyJ0KTHA5cwh0/yCo1/rdA: raises $0.50 to $0.75
n9QqWD4tpbongUBX2Oi58w: folds 
+baiVgI/ETnBARLe5mARCw: calls $0.75
scNSjC6yyKvvfklSkuzLrw: folds 
+TMG/MBWpiEnc9t7i07eTA: folds 
*** FLOP *** [2c Kc 5h]
OyJ0KTHA5cwh0/yCo1/rdA: bets $1
+baiVgI/ETnBARLe5mARCw: calls $1
*** TURN *** [2c Kc 5h] [Qc]
OyJ0KTHA5cwh0/yCo1/rdA: bets $5.70 and is all-in
+baiVgI/ETnBARLe5mARCw: folds 
Uncalled bet ($5.70) returned to OyJ0KTHA5cwh0/yCo1/rdA
OyJ0KTHA5cwh0/yCo1/rdA collected $3.70 from pot
OyJ0KTHA5cwh0/yCo1/rdA: doesn't show hand 
*** SUMMARY ***
Total pot $3.85 | Rake $0.15 
Board [2c Kc 5h Qc]
Seat 1: OyJ0KTHA5cwh0/yCo1/rdA collected ($3.70)
Seat 2: n9QqWD4tpbongUBX2Oi58w folded before Flop (didn't bet)
Seat 3: +baiVgI/ETnBARLe5mARCw (button) folded on the Turn
Seat 4: scNSjC6yyKvvfklSkuzLrw (small blind) folded before Flop
Seat 5: +TMG/MBWpiEnc9t7i07eTA (big blind) folded before Flop
Seat 6: DihMHaz4WNETH1bPDe13kA folded before Flop (didn't bet)




PokerStars Game #59941987936:  Hold'em No Limit ($0.10/$0.25) - 2009/07/01 1:52:31 ET
Table 'O5NgMYt6EWbLBozZb3kseg' 6-max Seat #4 is the button
Seat 1: uS0JK3noJsnWbcX2Jtcj8A ($24.75 in chips) 
Seat 2: ZZm/rg8aThjE+A2LiItuzA ($11.70 in chips) 
Seat 3: 0bf6ZOD3FadOOzjtjXlcRQ ($10.30 in chips) 
Seat 4: ItRgvLhXTZHvtZowz+dbIw ($12.55 in chips) 
Seat 5: u3Ol7kv1LmvszuHNm9rc6w ($25.20 in chips) 
Seat 6: 3m6VfX7io8SA31qh1zCkgQ ($22.10 in chips) 
u3Ol7kv1LmvszuHNm9rc6w: posts small blind $0.10
3m6VfX7io8SA31qh1zCkgQ: posts big blind $0.25
*** HOLE CARDS ***
uS0JK3noJsnWbcX2Jtcj8A: folds 
ZZm/rg8aThjE+A2LiItuzA: raises $0.75 to $1
0bf6ZOD3FadOOzjtjXlcRQ: folds 
ItRgvLhXTZHvtZowz+dbIw: folds 
u3Ol7kv1LmvszuHNm9rc6w: folds 
3m6VfX7io8SA31qh1zCkgQ: folds 
Uncalled bet ($0.75) returned to ZZm/rg8aThjE+A2LiItuzA
ZZm/rg8aThjE+A2LiItuzA collected $0.60 from pot
ZZm/rg8aThjE+A2LiItuzA: doesn't show hand 
*** SUMMARY ***
Total pot $0.60 | Rake $0 
Seat 1: uS0JK3noJsnWbcX2Jtcj8A folded before Flop (didn't bet)
Seat 2: ZZm/rg8aThjE+A2LiItuzA collected ($0.60)
Seat 3: 0bf6ZOD3FadOOzjtjXlcRQ folded before Flop (didn't bet)
Seat 4: ItRgvLhXTZHvtZowz+dbIw (button) folded before Flop (didn't bet)
Seat 5: u3Ol7kv1LmvszuHNm9rc6w (small blind) folded before Flop
Seat 6: 3m6VfX7io8SA31qh1zCkgQ (big blind) folded before Flop




PokerStars Game #59941988152:  Hold'em No Limit ($0.10/$0.25) - 2009/07/01 1:52:31 ET
Table '/JJyyIstHfkT7t/bW+WXgg' 6-max Seat #4 is the button
Seat 1: xC0kaiDYM6YTlgODL83O5A ($14.50 in chips) 
Seat 2: obJgSnVgWWWaAUtVILo77Q ($29.45 in chips) 
Seat 3: DR0nVIhVP77oEBlO9J8vlg ($25.75 in chips) 
Seat 4: JFIAqU8lCZ0vWwEl4bdGsg ($35.30 in chips) 
Seat 5: +ZlnqPoP3Hg4BIUxDfKd/A ($46.55 in chips) 
Seat 6: UmcUp27+PbgBItv3ZNlAWQ ($25 in chips) 
+ZlnqPoP3Hg4BIUxDfKd/A: posts small blind $0.10
UmcUp27+PbgBItv3ZNlAWQ: posts big blind $0.25
*** HOLE CARDS ***
xC0kaiDYM6YTlgODL83O5A: folds 
obJgSnVgWWWaAUtVILo77Q: calls $0.25
DR0nVIhVP77oEBlO9J8vlg: calls $0.25
JFIAqU8lCZ0vWwEl4bdGsg: folds 
+ZlnqPoP3Hg4BIUxDfKd/A: folds 
UmcUp27+PbgBItv3ZNlAWQ: checks 
*** FLOP *** [Td Qc 9h]
UmcUp27+PbgBItv3ZNlAWQ: checks 
obJgSnVgWWWaAUtVILo77Q: checks 
DR0nVIhVP77oEBlO9J8vlg: checks 
*** TURN *** [Td Qc 9h] [Qh]
UmcUp27+PbgBItv3ZNlAWQ: bets $0.50
obJgSnVgWWWaAUtVILo77Q: folds 
DR0nVIhVP77oEBlO9J8vlg: folds 
Uncalled bet ($0.50) returned to UmcUp27+PbgBItv3ZNlAWQ
UmcUp27+PbgBItv3ZNlAWQ collected $0.85 from pot
UmcUp27+PbgBItv3ZNlAWQ: doesn't show hand 
*** SUMMARY ***
Total pot $0.85 | Rake $0 
Board [Td Qc 9h Qh]
Seat 1: xC0kaiDYM6YTlgODL83O5A folded before Flop (didn't bet)
Seat 2: obJgSnVgWWWaAUtVILo77Q folded on the Turn
Seat 3: DR0nVIhVP77oEBlO9J8vlg folded on the Turn
Seat 4: JFIAqU8lCZ0vWwEl4bdGsg (button) folded before Flop (didn't bet)
Seat 5: +ZlnqPoP3Hg4BIUxDfKd/A (small blind) folded before Flop
Seat 6: UmcUp27+PbgBItv3ZNlAWQ (big blind) collected ($0.85)




PokerStars Game #59941988330:  Hold'em No Limit ($0.10/$0.25) - 2009/07/01 1:52:31 ET
Table 'sgdCtiuCu2BDZhyDi6RzTA' 6-max Seat #2 is the button
Seat 1: 3zD3qLXT1bEffAoWGnc7wg ($34.05 in chips) 
Seat 2: 88Xc2CgPRIRNHZycxJdBtQ ($25.70 in chips) 
Seat 3: eL3+wCBjFGfQ5FMdIZihwA ($27.30 in chips) 
Seat 4: rVKEgilmMX+EkKzDVvhmxA ($6.50 in chips) 
Seat 5: 0tQitW75xfmVWKldYHjmOQ ($3.70 in chips) 
Seat 6: KODslGU8ikCYS0/29dUkhg ($33.45 in chips) 
eL3+wCBjFGfQ5FMdIZihwA: posts small blind $0.10
rVKEgilmMX+EkKzDVvhmxA: posts big blind $0.25
*** HOLE CARDS ***
0tQitW75xfmVWKldYHjmOQ: calls $0.25
KODslGU8ikCYS0/29dUkhg: calls $0.25
3zD3qLXT1bEffAoWGnc7wg: raises $1 to $1.25
88Xc2CgPRIRNHZycxJdBtQ: folds 
eL3+wCBjFGfQ5FMdIZihwA: folds 
rVKEgilmMX+EkKzDVvhmxA: calls $1
0tQitW75xfmVWKldYHjmOQ: folds 
KODslGU8ikCYS0/29dUkhg: calls $1
*** FLOP *** [7c 4s Kd]
rVKEgilmMX+EkKzDVvhmxA: checks 
KODslGU8ikCYS0/29dUkhg: bets $0.50
3zD3qLXT1bEffAoWGnc7wg: calls $0.50
rVKEgilmMX+EkKzDVvhmxA: calls $0.50
*** TURN *** [7c 4s Kd] [6s]
rVKEgilmMX+EkKzDVvhmxA: checks 
KODslGU8ikCYS0/29dUkhg: bets $0.75
3zD3qLXT1bEffAoWGnc7wg: raises $2.50 to $3.25
rVKEgilmMX+EkKzDVvhmxA: folds 
KODslGU8ikCYS0/29dUkhg: raises $2.50 to $5.75
3zD3qLXT1bEffAoWGnc7wg: raises $26.55 to $32.30 and is all-in
KODslGU8ikCYS0/29dUkhg: calls $25.95 and is all-in
Uncalled bet ($0.60) returned to 3zD3qLXT1bEffAoWGnc7wg
*** RIVER *** [7c 4s Kd 6s] [Kh]
*** SHOW DOWN ***
KODslGU8ikCYS0/29dUkhg: shows [Ks 8s] (three of a kind, Kings)
3zD3qLXT1bEffAoWGnc7wg: shows [6c 6h] (a full house, Sixes full of Kings)
3zD3qLXT1bEffAoWGnc7wg collected $66 from pot
*** SUMMARY ***
Total pot $69 | Rake $3 
Board [7c 4s Kd 6s Kh]
Seat 1: 3zD3qLXT1bEffAoWGnc7wg showed [6c 6h] and won ($66) with a full house, Sixes full of Kings
Seat 2: 88Xc2CgPRIRNHZycxJdBtQ (button) folded before Flop (didn't bet)
Seat 3: eL3+wCBjFGfQ5FMdIZihwA (small blind) folded before Flop
Seat 4: rVKEgilmMX+EkKzDVvhmxA (big blind) folded on the Turn
Seat 5: 0tQitW75xfmVWKldYHjmOQ folded before Flop
Seat 6: KODslGU8ikCYS0/29dUkhg showed [Ks 8s] and lost with three of a kind, Kings




PokerStars Game #59941988156:  Hold'em No Limit ($0.10/$0.25) - 2009/07/01 1:52:31 ET
Table '/asc7VQ/OpF/oVJ3erB80w' 9-max Seat #7 is the button
Seat 1: 3PmVnC/15cl4oyI1TKIt4g ($5 in chips) 
Seat 2: +LseQ4csMghI3KY4cLSGMQ ($15.20 in chips) 
Seat 3: WEb58GPxGJGcxGh34AFZRQ ($9.40 in chips) 
Seat 4: Rjy74A2wdEiDWplMcUbA+w ($7.75 in chips) 
Seat 5: QB9VESHry/CRTDKMGwKwsQ ($40.70 in chips) 
Seat 6: wnerYvSRWT9Sm4X3ip/c8w ($30.35 in chips) 
Seat 7: 7Qlge5BZqMQvXxiy4HU3Hw ($5.45 in chips) 
Seat 8: jB7U2KxE3pjvDhvZHXK2Ag ($16.85 in chips) 
jB7U2KxE3pjvDhvZHXK2Ag: posts small blind $0.10
3PmVnC/15cl4oyI1TKIt4g: posts big blind $0.25
*** HOLE CARDS ***
+LseQ4csMghI3KY4cLSGMQ: calls $0.25
WEb58GPxGJGcxGh34AFZRQ: folds 
Rjy74A2wdEiDWplMcUbA+w: calls $0.25
QB9VESHry/CRTDKMGwKwsQ: calls $0.25
wnerYvSRWT9Sm4X3ip/c8w: folds 
7Qlge5BZqMQvXxiy4HU3Hw: calls $0.25
jB7U2KxE3pjvDhvZHXK2Ag: calls $0.15
3PmVnC/15cl4oyI1TKIt4g: checks 
*** FLOP *** [4d 9c Jc]
jB7U2KxE3pjvDhvZHXK2Ag: checks 
3PmVnC/15cl4oyI1TKIt4g: checks 
+LseQ4csMghI3KY4cLSGMQ: checks 
Rjy74A2wdEiDWplMcUbA+w: checks 
QB9VESHry/CRTDKMGwKwsQ: checks 
7Qlge5BZqMQvXxiy4HU3Hw: checks 
*** TURN *** [4d 9c Jc] [2c]
+LseQ4csMghI3KY4cLSGMQ said, "nice hand!"
jB7U2KxE3pjvDhvZHXK2Ag: checks 
3PmVnC/15cl4oyI1TKIt4g: bets $0.50
+LseQ4csMghI3KY4cLSGMQ: calls $0.50
Rjy74A2wdEiDWplMcUbA+w: folds 
QB9VESHry/CRTDKMGwKwsQ: folds 
7Qlge5BZqMQvXxiy4HU3Hw: folds 
zUXhymECc2C9W9ZNw6qppA is connected 
jB7U2KxE3pjvDhvZHXK2Ag: calls $0.50
*** RIVER *** [4d 9c Jc 2c] [3c]
jB7U2KxE3pjvDhvZHXK2Ag: checks 
3PmVnC/15cl4oyI1TKIt4g: checks 
+LseQ4csMghI3KY4cLSGMQ: bets $1
jB7U2KxE3pjvDhvZHXK2Ag: folds 
3PmVnC/15cl4oyI1TKIt4g: folds 
Uncalled bet ($1) returned to +LseQ4csMghI3KY4cLSGMQ
+LseQ4csMghI3KY4cLSGMQ collected $2.90 from pot
*** SUMMARY ***
Total pot $3 | Rake $0.10 
Board [4d 9c Jc 2c 3c]
Seat 1: 3PmVnC/15cl4oyI1TKIt4g (big blind) folded on the River
Seat 2: +LseQ4csMghI3KY4cLSGMQ collected ($2.90)
Seat 3: WEb58GPxGJGcxGh34AFZRQ folded before Flop (didn't bet)
Seat 4: Rjy74A2wdEiDWplMcUbA+w folded on the Turn
Seat 5: QB9VESHry/CRTDKMGwKwsQ folded on the Turn
Seat 6: wnerYvSRWT9Sm4X3ip/c8w folded before Flop (didn't bet)
Seat 7: 7Qlge5BZqMQvXxiy4HU3Hw (button) folded on the Turn
Seat 8: jB7U2KxE3pjvDhvZHXK2Ag (small blind) folded on the River




PokerStars Game #59941987910:  Hold'em No Limit ($0.10/$0.25) - 2009/07/01 1:52:31 ET
Table 'NtEQAxCeIK2io1CGtW658g' 6-max Seat #2 is the button
Seat 2: DgyznDqq/mLiCqQGMzc+Aw ($8.05 in chips) 
Seat 3: 5nwDw10uIM0XEyLhla0oGA ($36.70 in chips) 
Seat 4: 8296 ($15.65 in chips) 
Seat 6: /gJNBeCkWL4o85/jvlZ4BA ($70.70 in chips) 
5nwDw10uIM0XEyLhla0oGA: posts small blind $0.10
8296: posts big blind $0.25
*** HOLE CARDS ***
X437kMQ7AujoaDgjguhU9w leaves the table
/gJNBeCkWL4o85/jvlZ4BA: raises $0.75 to $1
DgyznDqq/mLiCqQGMzc+Aw: folds 
MgAtgQuaEEshtfbhCfs+bA joins the table at seat #5 
5nwDw10uIM0XEyLhla0oGA: folds 
8296: folds 
Uncalled bet ($0.75) returned to /gJNBeCkWL4o85/jvlZ4BA
/gJNBeCkWL4o85/jvlZ4BA collected $0.60 from pot
*** SUMMARY ***
Total pot $0.60 | Rake $0 
Seat 2: DgyznDqq/mLiCqQGMzc+Aw (button) folded before Flop (didn't bet)
Seat 3: 5nwDw10uIM0XEyLhla0oGA (small blind) folded before Flop
Seat 4: 8296 (big blind) folded before Flop
Seat 6: /gJNBeCkWL4o85/jvlZ4BA collected ($0.60)




PokerStars Game #59941988398:  Hold'em No Limit ($0.10/$0.25) - 2009/07/01 1:52:32 ET
Table 'sSe6q4YTb/iS19t2eCFdsA' 9-max Seat #4 is the button
Seat 1: hJ4uYjNmSZdjrKA8cjZqCA ($15.65 in chips) 
Seat 2: 3l+i+xMeyDndSXMF2A5CDA ($5.40 in chips) 
Seat 3: OXPkK84/qv92EMwXPiG5rQ ($10 in chips) 
Seat 4: 22dIObOuor/A+IKWkNoAlA ($8.75 in chips) 
Seat 5: qS+jfnNoG75bT+uQ8CKhQA ($10.05 in chips) 
Seat 7: t70KGeRtR3naHSqKDixsUg ($7.10 in chips) 
Seat 8: hvXZ0zFPZFP8Hf6dS36YEw ($16 in chips) 
Seat 9: Z9W7+g1WMhhZDi7DwGbCFA ($5.25 in chips) 
qS+jfnNoG75bT+uQ8CKhQA: posts small blind $0.10
tYsOBqdU1+x+yFI7zHO7hQ: is sitting out 
t70KGeRtR3naHSqKDixsUg: posts big blind $0.25
*** HOLE CARDS ***
hvXZ0zFPZFP8Hf6dS36YEw: folds 
Z9W7+g1WMhhZDi7DwGbCFA: folds 
hJ4uYjNmSZdjrKA8cjZqCA: folds 
3l+i+xMeyDndSXMF2A5CDA: raises $0.75 to $1
OXPkK84/qv92EMwXPiG5rQ: folds 
22dIObOuor/A+IKWkNoAlA: folds 
qS+jfnNoG75bT+uQ8CKhQA: folds 
t70KGeRtR3naHSqKDixsUg: folds 
Uncalled bet ($0.75) returned to 3l+i+xMeyDndSXMF2A5CDA
3l+i+xMeyDndSXMF2A5CDA collected $0.60 from pot
3l+i+xMeyDndSXMF2A5CDA: doesn't show hand 
*** SUMMARY ***
Total pot $0.60 | Rake $0 
Seat 1: hJ4uYjNmSZdjrKA8cjZqCA folded before Flop (didn't bet)
Seat 2: 3l+i+xMeyDndSXMF2A5CDA collected ($0.60)
Seat 3: OXPkK84/qv92EMwXPiG5rQ folded before Flop (didn't bet)
Seat 4: 22dIObOuor/A+IKWkNoAlA (button) folded before Flop (didn't bet)
Seat 5: qS+jfnNoG75bT+uQ8CKhQA (small blind) folded before Flop
Seat 7: t70KGeRtR3naHSqKDixsUg (big blind) folded before Flop
Seat 8: hvXZ0zFPZFP8Hf6dS36YEw folded before Flop (didn't bet)
Seat 9: Z9W7+g1WMhhZDi7DwGbCFA folded before Flop (didn't bet)




PokerStars Game #59941988698:  Hold'em No Limit ($0.10/$0.25) - 2009/07/01 1:52:32 ET
Table 'MRfAiS/4JSfnUDlCcZo0wAhfHe8uKeSJMyWAjSdM7ROQx Seat #1 is the button
Seat 1: 48oT5xFI+5CHUJlfoGrE4w ($29.30 in chips) 
Seat 2: /gJNBeCkWL4o85/jvlZ4BA ($25.10 in chips) 
Seat 4: b4wRQV3APH8irVk6bUFe2Q ($37.10 in chips) 
Seat 5: Q1uciOZPBR/WkAlqa6cL4A ($27.85 in chips) 
Seat 6: df01R5ThvHspD8FgKmaDvQ ($26 in chips) 
/gJNBeCkWL4o85/jvlZ4BA: posts small blind $0.10
b4wRQV3APH8irVk6bUFe2Q: posts big blind $0.25
*** HOLE CARDS ***
Q1uciOZPBR/WkAlqa6cL4A: folds 
df01R5ThvHspD8FgKmaDvQ: folds 
48oT5xFI+5CHUJlfoGrE4w: folds 
/gJNBeCkWL4o85/jvlZ4BA: raises $0.75 to $1
b4wRQV3APH8irVk6bUFe2Q: folds 
Uncalled bet ($0.75) returned to /gJNBeCkWL4o85/jvlZ4BA
/gJNBeCkWL4o85/jvlZ4BA collected $0.50 from pot
*** SUMMARY ***
Total pot $0.50 | Rake $0 
Seat 1: 48oT5xFI+5CHUJlfoGrE4w (button) folded before Flop (didn't bet)
Seat 2: /gJNBeCkWL4o85/jvlZ4BA (small blind) collected ($0.50)
Seat 4: b4wRQV3APH8irVk6bUFe2Q (big blind) folded before Flop
Seat 5: Q1uciOZPBR/WkAlqa6cL4A folded before Flop (didn't bet)
Seat 6: df01R5ThvHspD8FgKmaDvQ folded before Flop (didn't bet)




PokerStars Game #59941988840:  Hold'em No Limit ($0.10/$0.25) - 2009/07/01 1:52:32 ET
Table '1zj0+miaIL9cvwnT/50pOA' 9-max Seat #1 is the button
Seat 1: PVxvfRTRvkgZf9WtquEkwQ ($25 in chips) 
Seat 2: HPEB+AtKw1+C/cxU0o1ciw ($39.95 in chips) 
Seat 3: dtZ84flFEi4Q+SGrHMJRDQ ($29.35 in chips) 
Seat 4: PdIasPkzm2sqZnN41ZRXOg ($5.35 in chips) 
Seat 5: 57qrNGHDvf6GhB8zVLsAtQ ($8.05 in chips) 
Seat 6: YZaC69gFrepA6oCGtu7E0w ($28.45 in chips) 
Seat 7: 6RiVTYll/5D8zICp0MRpKw ($32.10 in chips) 
Seat 8: Ihhh49x48fayPIyvl2Rsmg ($36.50 in chips) 
Seat 9: AyqFvLFzJDE7yMbXP362BA ($18.95 in chips) 
HPEB+AtKw1+C/cxU0o1ciw: posts small blind $0.10
dtZ84flFEi4Q+SGrHMJRDQ: posts big blind $0.25
*** HOLE CARDS ***
PdIasPkzm2sqZnN41ZRXOg: folds 
57qrNGHDvf6GhB8zVLsAtQ: folds 
YZaC69gFrepA6oCGtu7E0w: raises $0.50 to $0.75
6RiVTYll/5D8zICp0MRpKw: folds 
Ihhh49x48fayPIyvl2Rsmg: folds 
AyqFvLFzJDE7yMbXP362BA: calls $0.75
PVxvfRTRvkgZf9WtquEkwQ: folds 
HPEB+AtKw1+C/cxU0o1ciw: calls $0.65
dtZ84flFEi4Q+SGrHMJRDQ: folds 
*** FLOP *** [7s Ks 8c]
HPEB+AtKw1+C/cxU0o1ciw: checks 
YZaC69gFrepA6oCGtu7E0w: bets $1
AyqFvLFzJDE7yMbXP362BA: folds 
HPEB+AtKw1+C/cxU0o1ciw: calls $1
*** TURN *** [7s Ks 8c] [2h]
HPEB+AtKw1+C/cxU0o1ciw: checks 
YZaC69gFrepA6oCGtu7E0w: checks 
*** RIVER *** [7s Ks 8c 2h] [4c]
HPEB+AtKw1+C/cxU0o1ciw: bets $1.50
YZaC69gFrepA6oCGtu7E0w: folds 
Uncalled bet ($1.50) returned to HPEB+AtKw1+C/cxU0o1ciw
HPEB+AtKw1+C/cxU0o1ciw collected $4.30 from pot
HPEB+AtKw1+C/cxU0o1ciw: doesn't show hand 
*** SUMMARY ***
Total pot $4.50 | Rake $0.20 
Board [7s Ks 8c 2h 4c]
Seat 1: PVxvfRTRvkgZf9WtquEkwQ (button) folded before Flop (didn't bet)
Seat 2: HPEB+AtKw1+C/cxU0o1ciw (small blind) collected ($4.30)
Seat 3: dtZ84flFEi4Q+SGrHMJRDQ (big blind) folded before Flop
Seat 4: PdIasPkzm2sqZnN41ZRXOg folded before Flop (didn't bet)
Seat 5: 57qrNGHDvf6GhB8zVLsAtQ folded before Flop (didn't bet)
Seat 6: YZaC69gFrepA6oCGtu7E0w folded on the River
Seat 7: 6RiVTYll/5D8zICp0MRpKw folded before Flop (didn't bet)
Seat 8: Ihhh49x48fayPIyvl2Rsmg folded before Flop (didn't bet)
Seat 9: AyqFvLFzJDE7yMbXP362BA folded on the Flop




PokerStars Game #59941988352:  Hold'em No Limit ($0.10/$0.25) - 2009/07/01 1:52:32 ET
Table 'vZfV/Uj0q8joA1du9sRJSg' 6-max Seat #6 is the button
Seat 1: MVzl6OsGybVDNd3Vr9LYAA ($25.55 in chips) 
Seat 2: wMiE3yTbDJGOLOF9th7KPA ($12.50 in chips) 
Seat 3: cWc85bEzdRzpUMhRKm8pwQ ($25 in chips) 
Seat 4: v+QfkGiuj9bgtuNoVnDO8w ($43.15 in chips) 
Seat 5: kyRaCIljYA6l33lSKQfNsg ($28.95 in chips) 
Seat 6: 8ClCHtFXGNplITm+63KB+Q ($47.35 in chips) 
MVzl6OsGybVDNd3Vr9LYAA: posts small blind $0.10
wMiE3yTbDJGOLOF9th7KPA: posts big blind $0.25
*** HOLE CARDS ***
cWc85bEzdRzpUMhRKm8pwQ: folds 
v+QfkGiuj9bgtuNoVnDO8w: raises $0.75 to $1
kyRaCIljYA6l33lSKQfNsg: folds 
8ClCHtFXGNplITm+63KB+Q: folds 
MVzl6OsGybVDNd3Vr9LYAA: folds 
wMiE3yTbDJGOLOF9th7KPA: calls $0.75
*** FLOP *** [7c 6s Kc]
wMiE3yTbDJGOLOF9th7KPA: bets $0.25
v+QfkGiuj9bgtuNoVnDO8w: raises $2 to $2.25
wMiE3yTbDJGOLOF9th7KPA: folds 
Uncalled bet ($2) returned to v+QfkGiuj9bgtuNoVnDO8w
v+QfkGiuj9bgtuNoVnDO8w collected $2.50 from pot
v+QfkGiuj9bgtuNoVnDO8w: doesn't show hand 
*** SUMMARY ***
Total pot $2.60 | Rake $0.10 
Board [7c 6s Kc]
Seat 1: MVzl6OsGybVDNd3Vr9LYAA (small blind) folded before Flop
Seat 2: wMiE3yTbDJGOLOF9th7KPA (big blind) folded on the Flop
Seat 3: cWc85bEzdRzpUMhRKm8pwQ folded before Flop (didn't bet)
Seat 4: v+QfkGiuj9bgtuNoVnDO8w collected ($2.50)
Seat 5: kyRaCIljYA6l33lSKQfNsg folded before Flop (didn't bet)
Seat 6: 8ClCHtFXGNplITm+63KB+Q (button) folded before Flop (didn't bet)




PokerStars Game #59941988380:  Hold'em No Limit ($0.10/$0.25) - 2009/07/01 1:52:32 ET
Table 'ouLhepGYovxB2x0QxH7cVg' 9-max Seat #2 is the button
Seat 1: ghNKXUBl/H+t83JF079ZBA ($25 in chips) 
Seat 2: r1Z5m4PwSI5ANp7qCE1OJw ($11.10 in chips) 
Seat 4: a0Sx6GHY7ln2Ns2C97eXeA ($59.65 in chips) 
Seat 5: v60REj6f8jzMYT0VsZvaPQ ($22.55 in chips) 
Seat 6: hYvTc4PYNrAaNAIVoM94Hw ($4.65 in chips) 
Seat 8: tLcDklc2rBORNfixyRfVfw ($25.25 in chips) 
Seat 9: ljemhp25Zg+nlA9DLCIiUw ($24.95 in chips) 
a0Sx6GHY7ln2Ns2C97eXeA: posts small blind $0.10
v60REj6f8jzMYT0VsZvaPQ: posts big blind $0.25
cKlmpQMahVsmOaxFQDcoOg: sits out 
*** HOLE CARDS ***
hYvTc4PYNrAaNAIVoM94Hw: calls $0.25
tLcDklc2rBORNfixyRfVfw: folds 
ljemhp25Zg+nlA9DLCIiUw: folds 
ghNKXUBl/H+t83JF079ZBA: folds 
r1Z5m4PwSI5ANp7qCE1OJw: calls $0.25
a0Sx6GHY7ln2Ns2C97eXeA: calls $0.15
v60REj6f8jzMYT0VsZvaPQ: checks 
*** FLOP *** [5s Kc Qs]
a0Sx6GHY7ln2Ns2C97eXeA: checks 
v60REj6f8jzMYT0VsZvaPQ: checks 
hYvTc4PYNrAaNAIVoM94Hw: bets $0.50
r1Z5m4PwSI5ANp7qCE1OJw: folds 
a0Sx6GHY7ln2Ns2C97eXeA: folds 
v60REj6f8jzMYT0VsZvaPQ: calls $0.50
*** TURN *** [5s Kc Qs] [Jd]
v60REj6f8jzMYT0VsZvaPQ: checks 
hYvTc4PYNrAaNAIVoM94Hw: bets $0.75
v60REj6f8jzMYT0VsZvaPQ: calls $0.75
*** RIVER *** [5s Kc Qs Jd] [5h]
v60REj6f8jzMYT0VsZvaPQ: checks 
hYvTc4PYNrAaNAIVoM94Hw: bets $1.50
v60REj6f8jzMYT0VsZvaPQ: folds 
Uncalled bet ($1.50) returned to hYvTc4PYNrAaNAIVoM94Hw
k020504 joins the table at seat #3 
hYvTc4PYNrAaNAIVoM94Hw collected $3.35 from pot
*** SUMMARY ***
Total pot $3.50 | Rake $0.15 
Board [5s Kc Qs Jd 5h]
Seat 1: ghNKXUBl/H+t83JF079ZBA folded before Flop (didn't bet)
Seat 2: r1Z5m4PwSI5ANp7qCE1OJw (button) folded on the Flop
Seat 4: a0Sx6GHY7ln2Ns2C97eXeA (small blind) folded on the Flop
Seat 5: v60REj6f8jzMYT0VsZvaPQ (big blind) folded on the River
Seat 6: hYvTc4PYNrAaNAIVoM94Hw collected ($3.35)
Seat 8: tLcDklc2rBORNfixyRfVfw folded before Flop (didn't bet)
Seat 9: ljemhp25Zg+nlA9DLCIiUw folded before Flop (didn't bet)




PokerStars Game #59941989222:  Hold'em No Limit ($0.10/$0.25) - 2009/07/01 1:52:33 ET
Table 'r562aMIMs5kgo28FEU6lkA' 9-max Seat #2 is the button
Seat 1: H5Se03ZqSX7tbULXur2MAg ($14.80 in chips) 
Seat 2: N8muFAHrFHW6elSMGuyVLQ ($25.60 in chips) 
Seat 3: xoBFd/5k+L/pFn9VW1VyWg ($10.35 in chips) 
Seat 4: V6p0jQ/RhUsqpHLmXvEX4Q ($19.75 in chips) 
Seat 5: zDrucyjVn5aeekNEc3cJrA ($35.20 in chips) 
Seat 6: RCqMONFrSPSArZh2Jsar/w ($20 in chips) 
Seat 7: Bb42QRQMhg5/Y0vHP8/2Xw ($25 in chips) 
Seat 8: B6xHiX1SJkS0CUNCKDVwuQ ($20.65 in chips) 
Seat 9: yyG4svzOpC1A+sUP/scg6w ($7 in chips) 
xoBFd/5k+L/pFn9VW1VyWg: posts small blind $0.10
V6p0jQ/RhUsqpHLmXvEX4Q: posts big blind $0.25
*** HOLE CARDS ***
zDrucyjVn5aeekNEc3cJrA: folds 
RCqMONFrSPSArZh2Jsar/w: raises $0.25 to $0.50
Bb42QRQMhg5/Y0vHP8/2Xw: folds 
B6xHiX1SJkS0CUNCKDVwuQ: folds 
yyG4svzOpC1A+sUP/scg6w: folds 
H5Se03ZqSX7tbULXur2MAg: folds 
N8muFAHrFHW6elSMGuyVLQ: folds 
xoBFd/5k+L/pFn9VW1VyWg: folds 
V6p0jQ/RhUsqpHLmXvEX4Q: folds 
Uncalled bet ($0.25) returned to RCqMONFrSPSArZh2Jsar/w
RCqMONFrSPSArZh2Jsar/w collected $0.60 from pot
RCqMONFrSPSArZh2Jsar/w: doesn't show hand 
N8muFAHrFHW6elSMGuyVLQ leaves the table
*** SUMMARY ***
Total pot $0.60 | Rake $0 
Seat 1: H5Se03ZqSX7tbULXur2MAg folded before Flop (didn't bet)
Seat 2: N8muFAHrFHW6elSMGuyVLQ (button) folded before Flop (didn't bet)
Seat 3: xoBFd/5k+L/pFn9VW1VyWg (small blind) folded before Flop
Seat 4: V6p0jQ/RhUsqpHLmXvEX4Q (big blind) folded before Flop
Seat 5: zDrucyjVn5aeekNEc3cJrA folded before Flop (didn't bet)
Seat 6: RCqMONFrSPSArZh2Jsar/w collected ($0.60)
Seat 7: Bb42QRQMhg5/Y0vHP8/2Xw folded before Flop (didn't bet)
Seat 8: B6xHiX1SJkS0CUNCKDVwuQ folded before Flop (didn't bet)
Seat 9: yyG4svzOpC1A+sUP/scg6w folded before Flop (didn't bet)




PokerStars Game #59941989226:  Hold'em No Limit ($0.10/$0.25) - 2009/07/01 1:52:33 ET
Table 'tErGGDyESv/0llKumVeZuQ' 9-max Seat #3 is the button
Seat 1: 3PmVnC/15cl4oyI1TKIt4g ($4.75 in chips) 
Seat 2: pN3IHvAKm2fz+sTRARTcrg ($28.35 in chips) 
Seat 3: qwr38jl5txoR36M7G5qi4A ($10.50 in chips) 
Seat 4: yqkowiRWZ6NvRN9UUkYIlA ($5 in chips) 
Seat 5: 6RQUxA3jk+ePxB/+Hc0IKw ($17.10 in chips) 
Seat 6: zDrucyjVn5aeekNEc3cJrA ($59.60 in chips) 
Seat 7: uhrboV251dcgYniYTdFIcA ($25 in chips) 
Seat 8: clJsV3v77RS07bDKY+705w ($5 in chips) 
Seat 9: d6n762oPkegG086ZJyV5MA ($27.50 in chips) 
yqkowiRWZ6NvRN9UUkYIlA: posts small blind $0.10
6RQUxA3jk+ePxB/+Hc0IKw: posts big blind $0.25
*** HOLE CARDS ***
zDrucyjVn5aeekNEc3cJrA: folds 
uhrboV251dcgYniYTdFIcA: folds 
clJsV3v77RS07bDKY+705w: raises $0.75 to $1
d6n762oPkegG086ZJyV5MA: folds 
3PmVnC/15cl4oyI1TKIt4g: folds 
pN3IHvAKm2fz+sTRARTcrg: folds 
qwr38jl5txoR36M7G5qi4A: folds 
yqkowiRWZ6NvRN9UUkYIlA: folds 
6RQUxA3jk+ePxB/+Hc0IKw: calls $0.75
*** FLOP *** [Qc Qd 6s]
6RQUxA3jk+ePxB/+Hc0IKw: checks 
clJsV3v77RS07bDKY+705w: bets $1.25
6RQUxA3jk+ePxB/+Hc0IKw: folds 
Uncalled bet ($1.25) returned to clJsV3v77RS07bDKY+705w
clJsV3v77RS07bDKY+705w collected $2 from pot
clJsV3v77RS07bDKY+705w: doesn't show hand 
*** SUMMARY ***
Total pot $2.10 | Rake $0.10 
Board [Qc Qd 6s]
Seat 1: 3PmVnC/15cl4oyI1TKIt4g folded before Flop (didn't bet)
Seat 2: pN3IHvAKm2fz+sTRARTcrg folded before Flop (didn't bet)
Seat 3: qwr38jl5txoR36M7G5qi4A (button) folded before Flop (didn't bet)
Seat 4: yqkowiRWZ6NvRN9UUkYIlA (small blind) folded before Flop
Seat 5: 6RQUxA3jk+ePxB/+Hc0IKw (big blind) folded on the Flop
Seat 6: zDrucyjVn5aeekNEc3cJrA folded before Flop (didn't bet)
Seat 7: uhrboV251dcgYniYTdFIcA folded before Flop (didn't bet)
Seat 8: clJsV3v77RS07bDKY+705w collected ($2)
Seat 9: d6n762oPkegG086ZJyV5MA folded before Flop (didn't bet)




PokerStars Game #59941989010:  Hold'em No Limit ($0.10/$0.25) - 2009/07/01 1:52:33 ET
Table 'HzFR0rxmDAPu5GzYR0AlYg' 6-max Seat #3 is the button
Seat 1: v+QfkGiuj9bgtuNoVnDO8w ($35.15 in chips) 
Seat 2: UA5OsKS3VPaxa7uC8La/kA ($52.55 in chips) 
Seat 3: kG34n23qFQA3nzdOJTQ1dA ($23.55 in chips) 
Seat 4: Mhj3q7cxev+XjXZxEE6/Cw ($25.10 in chips) 
Seat 6: jp34e617tIzV8tKIWmfAbA ($35.30 in chips) 
Mhj3q7cxev+XjXZxEE6/Cw: posts small blind $0.10
jp34e617tIzV8tKIWmfAbA: posts big blind $0.25
*** HOLE CARDS ***
v+QfkGiuj9bgtuNoVnDO8w: folds 
UA5OsKS3VPaxa7uC8La/kA: folds 
kG34n23qFQA3nzdOJTQ1dA: folds 
Mhj3q7cxev+XjXZxEE6/Cw: folds 
Uncalled bet ($0.15) returned to jp34e617tIzV8tKIWmfAbA
jp34e617tIzV8tKIWmfAbA collected $0.20 from pot
*** SUMMARY ***
Total pot $0.20 | Rake $0 
Seat 1: v+QfkGiuj9bgtuNoVnDO8w folded before Flop (didn't bet)
Seat 2: UA5OsKS3VPaxa7uC8La/kA folded before Flop (didn't bet)
Seat 3: kG34n23qFQA3nzdOJTQ1dA (button) folded before Flop (didn't bet)
Seat 4: Mhj3q7cxev+XjXZxEE6/Cw (small blind) folded before Flop
Seat 6: jp34e617tIzV8tKIWmfAbA (big blind) collected ($0.20)




PokerStars Game #59941989198:  Hold'em No Limit ($0.10/$0.25) - 2009/07/01 1:52:33 ET
Table 'AchTjdLS1zBUbH3ZIx6f0w' 6-max Seat #4 is the button
Seat 1: rZ0bUtoerhFGDUSRQMnFog ($24.55 in chips) 
Seat 2: kG34n23qFQA3nzdOJTQ1dA ($65.55 in chips) 
Seat 4: q6WfTUAD9mowIP63ASq2Dg ($35.90 in chips) 
Seat 5: 0av6tRNdi0Ui4f15L7gsVg ($23.40 in chips) 
Seat 6: epAUIB7h2FJXzUPRIvSkRA ($25.75 in chips) 
0av6tRNdi0Ui4f15L7gsVg: posts small blind $0.10
epAUIB7h2FJXzUPRIvSkRA: posts big blind $0.25
MVzl6OsGybVDNd3Vr9LYAA: sits out 
*** HOLE CARDS ***
rZ0bUtoerhFGDUSRQMnFog: folds 
kG34n23qFQA3nzdOJTQ1dA: folds 
q6WfTUAD9mowIP63ASq2Dg: folds 
0av6tRNdi0Ui4f15L7gsVg: folds 
Uncalled bet ($0.15) returned to epAUIB7h2FJXzUPRIvSkRA
epAUIB7h2FJXzUPRIvSkRA collected $0.20 from pot
epAUIB7h2FJXzUPRIvSkRA: doesn't show hand 
*** SUMMARY ***
Total pot $0.20 | Rake $0 
Seat 1: rZ0bUtoerhFGDUSRQMnFog folded before Flop (didn't bet)
Seat 2: kG34n23qFQA3nzdOJTQ1dA folded before Flop (didn't bet)
Seat 4: q6WfTUAD9mowIP63ASq2Dg (button) folded before Flop (didn't bet)
Seat 5: 0av6tRNdi0Ui4f15L7gsVg (small blind) folded before Flop
Seat 6: epAUIB7h2FJXzUPRIvSkRA (big blind) collected ($0.20)




PokerStars Game #59941989720:  Hold'em No Limit ($0.10/$0.25) - 2009/07/01 1:52:34 ET
Table 'djcjiEGabFQO0MNG6jEeJQ' 9-max Seat #4 is the button
Seat 1: Bb42QRQMhg5/Y0vHP8/2Xw ($25 in chips) 
Seat 2: WKL8nUFr7TumC4EjLyqYzw ($3.85 in chips) 
Seat 3: 8iNkA1BFZ6OivRPGlQz3HQ ($15 in chips) 
Seat 4: 2wcFsZsqEP5w1StUTVzJCg ($9.20 in chips) 
Seat 5: 9QQ67diwg/DShNDBou2R8Q ($24.50 in chips) 
Seat 7: 5pDhXQ+RVy0BGcwfJAJfbg ($26.60 in chips) 
Seat 8: +sbyWwIcFp9kP0bDtMegfQ ($46.25 in chips) 
Seat 9: HPEB+AtKw1+C/cxU0o1ciw ($46.50 in chips) 
9QQ67diwg/DShNDBou2R8Q: posts small blind $0.10
aNpwfA31EREwO+ar4XzBCw: is sitting out 
5pDhXQ+RVy0BGcwfJAJfbg: posts big blind $0.25
8iNkA1BFZ6OivRPGlQz3HQ: posts big blind $0.25
*** HOLE CARDS ***
aNpwfA31EREwO+ar4XzBCw leaves the table
+sbyWwIcFp9kP0bDtMegfQ: folds 
HPEB+AtKw1+C/cxU0o1ciw: calls $0.25
Bb42QRQMhg5/Y0vHP8/2Xw: calls $0.25
WKL8nUFr7TumC4EjLyqYzw: folds 
8iNkA1BFZ6OivRPGlQz3HQ: checks 
2wcFsZsqEP5w1StUTVzJCg: calls $0.25
9QQ67diwg/DShNDBou2R8Q: calls $0.15
5pDhXQ+RVy0BGcwfJAJfbg: checks 
*** FLOP *** [2c 3d 6c]
9QQ67diwg/DShNDBou2R8Q: checks 
ASTaylor70 joins the table at seat #6 
5pDhXQ+RVy0BGcwfJAJfbg: bets $0.50
HPEB+AtKw1+C/cxU0o1ciw: folds 
Bb42QRQMhg5/Y0vHP8/2Xw: calls $0.50
8iNkA1BFZ6OivRPGlQz3HQ: calls $0.50
2wcFsZsqEP5w1StUTVzJCg: calls $0.50
9QQ67diwg/DShNDBou2R8Q is connected 
9QQ67diwg/DShNDBou2R8Q: folds 
*** TURN *** [2c 3d 6c] [Qh]
5pDhXQ+RVy0BGcwfJAJfbg: checks 
Bb42QRQMhg5/Y0vHP8/2Xw: bets $2
8iNkA1BFZ6OivRPGlQz3HQ: folds 
2wcFsZsqEP5w1StUTVzJCg: calls $2
5pDhXQ+RVy0BGcwfJAJfbg: folds 
*** RIVER *** [2c 3d 6c Qh] [Qs]
Bb42QRQMhg5/Y0vHP8/2Xw: bets $7.50
2wcFsZsqEP5w1StUTVzJCg: calls $6.45 and is all-in
Uncalled bet ($1.05) returned to Bb42QRQMhg5/Y0vHP8/2Xw
*** SHOW DOWN ***
Bb42QRQMhg5/Y0vHP8/2Xw: shows [3h 3s] (a full house, Threes full of Queens)
2wcFsZsqEP5w1StUTVzJCg: shows [2s 2h] (a full house, Deuces full of Queens)
Bb42QRQMhg5/Y0vHP8/2Xw collected $19.40 from pot
*** SUMMARY ***
Total pot $20.40 | Rake $1 
Board [2c 3d 6c Qh Qs]
Seat 1: Bb42QRQMhg5/Y0vHP8/2Xw showed [3h 3s] and won ($19.40) with a full house, Threes full of Queens
Seat 2: WKL8nUFr7TumC4EjLyqYzw folded before Flop (didn't bet)
Seat 3: 8iNkA1BFZ6OivRPGlQz3HQ folded on the Turn
Seat 4: 2wcFsZsqEP5w1StUTVzJCg (button) showed [2s 2h] and lost with a full house, Deuces full of Queens
Seat 5: 9QQ67diwg/DShNDBou2R8Q (small blind) folded on the Flop
Seat 7: 5pDhXQ+RVy0BGcwfJAJfbg (big blind) folded on the Turn
Seat 8: +sbyWwIcFp9kP0bDtMegfQ folded before Flop (didn't bet)
Seat 9: HPEB+AtKw1+C/cxU0o1ciw folded on the Flop




PokerStars Game #59941989424:  Hold'em No Limit ($0.10/$0.25) - 2009/07/01 1:52:34 ET
Table 'g+mPuNJBCHKE9ents7ZGtg' 6-max Seat #3 is the button
Seat 1: cezpHJ8FB07dj0xG+LhOvw ($58.15 in chips) 
Seat 2: fZQg9veL7Dd/Z04ZTjC+wQ ($56.45 in chips) 
Seat 3: 8CPg15X6IHYR1pWm9ha1Sw ($25 in chips) 
Seat 6: Mn2V28t5aGq2d09z+/o6Fw ($36.55 in chips) 
Mn2V28t5aGq2d09z+/o6Fw: posts small blind $0.10
cezpHJ8FB07dj0xG+LhOvw: posts big blind $0.25
*** HOLE CARDS ***
fZQg9veL7Dd/Z04ZTjC+wQ: raises $0.50 to $0.75
8CPg15X6IHYR1pWm9ha1Sw: folds 
Mn2V28t5aGq2d09z+/o6Fw: folds 
cezpHJ8FB07dj0xG+LhOvw: folds 
Uncalled bet ($0.50) returned to fZQg9veL7Dd/Z04ZTjC+wQ
fZQg9veL7Dd/Z04ZTjC+wQ collected $0.60 from pot
fZQg9veL7Dd/Z04ZTjC+wQ: doesn't show hand 
*** SUMMARY ***
Total pot $0.60 | Rake $0 
Seat 1: cezpHJ8FB07dj0xG+LhOvw (big blind) folded before Flop
Seat 2: fZQg9veL7Dd/Z04ZTjC+wQ collected ($0.60)
Seat 3: 8CPg15X6IHYR1pWm9ha1Sw (button) folded before Flop (didn't bet)
Seat 6: Mn2V28t5aGq2d09z+/o6Fw (small blind) folded before Flop




PokerStars Game #59941989470:  Hold'em No Limit ($0.10/$0.25) - 2009/07/01 1:52:34 ET
Table 'Qk/910N2Yhg8u5vqTJk50Q' 9-max Seat #3 is the button
Seat 1: zDrucyjVn5aeekNEc3cJrA ($22.20 in chips) 
Seat 2: Th3FldXKQW6hWVVPahaoOQ ($44.70 in chips) 
Seat 3: ghNKXUBl/H+t83JF079ZBA ($25.90 in chips) 
Seat 4: hYvTc4PYNrAaNAIVoM94Hw ($4.50 in chips) 
Seat 5: zReBEigsxqZnag0RZAgpgA ($14.80 in chips) 
Seat 6: U41wNf6XauAiBOQaKu2ZIA ($9.75 in chips) 
Seat 7: aNpwfA31EREwO+ar4XzBCw ($26.85 in chips) 
Seat 8: 5pDhXQ+RVy0BGcwfJAJfbg ($24.75 in chips) 
Seat 9: M2QO2DxB5Wawg2h8HSpnYA ($17.35 in chips) 
hYvTc4PYNrAaNAIVoM94Hw: posts small blind $0.10
zReBEigsxqZnag0RZAgpgA: posts big blind $0.25
*** HOLE CARDS ***
U41wNf6XauAiBOQaKu2ZIA: folds 
aNpwfA31EREwO+ar4XzBCw: folds 
5pDhXQ+RVy0BGcwfJAJfbg: raises $0.75 to $1
M2QO2DxB5Wawg2h8HSpnYA: folds 
zDrucyjVn5aeekNEc3cJrA: folds 
Th3FldXKQW6hWVVPahaoOQ: folds 
ghNKXUBl/H+t83JF079ZBA: folds 
hYvTc4PYNrAaNAIVoM94Hw: folds 
zReBEigsxqZnag0RZAgpgA: folds 
Uncalled bet ($0.75) returned to 5pDhXQ+RVy0BGcwfJAJfbg
5pDhXQ+RVy0BGcwfJAJfbg collected $0.60 from pot
5pDhXQ+RVy0BGcwfJAJfbg: doesn't show hand 
*** SUMMARY ***
Total pot $0.60 | Rake $0 
Seat 1: zDrucyjVn5aeekNEc3cJrA folded before Flop (didn't bet)
Seat 2: Th3FldXKQW6hWVVPahaoOQ folded before Flop (didn't bet)
Seat 3: ghNKXUBl/H+t83JF079ZBA (button) folded before Flop (didn't bet)
Seat 4: hYvTc4PYNrAaNAIVoM94Hw (small blind) folded before Flop
Seat 5: zReBEigsxqZnag0RZAgpgA (big blind) folded before Flop
Seat 6: U41wNf6XauAiBOQaKu2ZIA folded before Flop (didn't bet)
Seat 7: aNpwfA31EREwO+ar4XzBCw folded before Flop (didn't bet)
Seat 8: 5pDhXQ+RVy0BGcwfJAJfbg collected ($0.60)
Seat 9: M2QO2DxB5Wawg2h8HSpnYA folded before Flop (didn't bet)




PokerStars Game #59941989488:  Hold'em No Limit ($0.10/$0.25) - 2009/07/01 1:52:34 ET
Table 'IRgQPZVA4+IaZZIQshgwyg' 6-max Seat #3 is the button
Seat 1: cezpHJ8FB07dj0xG+LhOvw ($27.55 in chips) 
Seat 2: HZrrzaHXN9+c2uyWFqzULg ($15 in chips) 
Seat 3: DihMHaz4WNETH1bPDe13kA ($27.45 in chips) 
Seat 4: DE9hRlt14g+JdsRQ4wT7hg ($25.10 in chips) 
Seat 5: w43JQj2oYPpKQVG4Yzlq1w ($28.05 in chips) 
Seat 6: x9/USY6PsmgUGQeluFLKDw ($20.95 in chips) 
DE9hRlt14g+JdsRQ4wT7hg: posts small blind $0.10
w43JQj2oYPpKQVG4Yzlq1w: posts big blind $0.25
HZrrzaHXN9+c2uyWFqzULg: posts big blind $0.25
*** HOLE CARDS ***
x9/USY6PsmgUGQeluFLKDw: folds 
cezpHJ8FB07dj0xG+LhOvw: folds 
HZrrzaHXN9+c2uyWFqzULg: checks 
DihMHaz4WNETH1bPDe13kA: folds 
DE9hRlt14g+JdsRQ4wT7hg: folds 
w43JQj2oYPpKQVG4Yzlq1w: checks 
*** FLOP *** [9d Jc 3h]
w43JQj2oYPpKQVG4Yzlq1w: checks 
HZrrzaHXN9+c2uyWFqzULg: bets $0.75
w43JQj2oYPpKQVG4Yzlq1w: folds 
Uncalled bet ($0.75) returned to HZrrzaHXN9+c2uyWFqzULg
HZrrzaHXN9+c2uyWFqzULg collected $0.60 from pot
*** SUMMARY ***
Total pot $0.60 | Rake $0 
Board [9d Jc 3h]
Seat 1: cezpHJ8FB07dj0xG+LhOvw folded before Flop (didn't bet)
Seat 2: HZrrzaHXN9+c2uyWFqzULg collected ($0.60)
Seat 3: DihMHaz4WNETH1bPDe13kA (button) folded before Flop (didn't bet)
Seat 4: DE9hRlt14g+JdsRQ4wT7hg (small blind) folded before Flop
Seat 5: w43JQj2oYPpKQVG4Yzlq1w (big blind) folded on the Flop
Seat 6: x9/USY6PsmgUGQeluFLKDw folded before Flop (didn't bet)




PokerStars Game #59941990434:  Hold'em No Limit ($0.10/$0.25) - 2009/07/01 1:52:35 ET
Table '2O5CgfSkSwrr4PDrlZ1RLQ' 6-max Seat #5 is the button
Seat 1: 3skmHD9EOATKdUzzyHh1KA ($31.60 in chips) 
Seat 2: wqphQtauX5Qn7WRJZS1flA ($35.10 in chips) 
Seat 3: oBUDUfeUyCbZBsjxHZgSiw ($19.75 in chips) 
Seat 4: epAUIB7h2FJXzUPRIvSkRA ($25 in chips) 
Seat 5: 0av6tRNdi0Ui4f15L7gsVg ($23.55 in chips) 
Seat 6: tj9xqoqQaDaFw7u1oyZrtA ($47.15 in chips) 
tj9xqoqQaDaFw7u1oyZrtA: posts small blind $0.10
3skmHD9EOATKdUzzyHh1KA: posts big blind $0.25
*** HOLE CARDS ***
wqphQtauX5Qn7WRJZS1flA: folds 
oBUDUfeUyCbZBsjxHZgSiw: raises $0.75 to $1
epAUIB7h2FJXzUPRIvSkRA: folds 
0av6tRNdi0Ui4f15L7gsVg: folds 
tj9xqoqQaDaFw7u1oyZrtA: calls $0.90
3skmHD9EOATKdUzzyHh1KA: folds 
*** FLOP *** [7d 8c 6h]
tj9xqoqQaDaFw7u1oyZrtA: checks 
oBUDUfeUyCbZBsjxHZgSiw: bets $1.50
tj9xqoqQaDaFw7u1oyZrtA: raises $1.50 to $3
oBUDUfeUyCbZBsjxHZgSiw: calls $1.50
*** TURN *** [7d 8c 6h] [2h]
tj9xqoqQaDaFw7u1oyZrtA: checks 
oBUDUfeUyCbZBsjxHZgSiw: checks 
*** RIVER *** [7d 8c 6h 2h] [Qh]
tj9xqoqQaDaFw7u1oyZrtA: bets $3.50
oBUDUfeUyCbZBsjxHZgSiw: calls $3.50
*** SHOW DOWN ***
tj9xqoqQaDaFw7u1oyZrtA: shows [Kc Js] (high card King)
oBUDUfeUyCbZBsjxHZgSiw: shows [6s Ks] (a pair of Sixes)
oBUDUfeUyCbZBsjxHZgSiw collected $14.55 from pot
*** SUMMARY ***
Total pot $15.25 | Rake $0.70 
Board [7d 8c 6h 2h Qh]
Seat 1: 3skmHD9EOATKdUzzyHh1KA (big blind) folded before Flop
Seat 2: wqphQtauX5Qn7WRJZS1flA folded before Flop (didn't bet)
Seat 3: oBUDUfeUyCbZBsjxHZgSiw showed [6s Ks] and won ($14.55) with a pair of Sixes
Seat 4: epAUIB7h2FJXzUPRIvSkRA folded before Flop (didn't bet)
Seat 5: 0av6tRNdi0Ui4f15L7gsVg (button) folded before Flop (didn't bet)
Seat 6: tj9xqoqQaDaFw7u1oyZrtA (small blind) showed [Kc Js] and lost with high card King




PokerStars Game #59941990454:  Hold'em No Limit ($0.10/$0.25) - 2009/07/01 1:52:35 ET
Table 'Loy/olZ5qoDOSvX4UTujGg' 6-max Seat #1 is the button
Seat 1: HipgaJhkN4ie/tTw4dK3Ug ($10.75 in chips) 
Seat 2: 4z7mPbMLNp4TezHXin63Vw ($17.95 in chips) 
Seat 3: 32YL2ZEp8NT4JB2RVM9euQ ($15 in chips) 
Seat 4: /gJNBeCkWL4o85/jvlZ4BA ($26.40 in chips) 
Seat 5: Ar4vsUIUfJ7gbYh1c1m59g ($19.25 in chips) 
Seat 6: qGHGf/553gQnDoklMRe3tg ($24.80 in chips) 
4z7mPbMLNp4TezHXin63Vw: posts small blind $0.10
32YL2ZEp8NT4JB2RVM9euQ: posts big blind $0.25
*** HOLE CARDS ***
/gJNBeCkWL4o85/jvlZ4BA: folds 
Ar4vsUIUfJ7gbYh1c1m59g: folds 
qGHGf/553gQnDoklMRe3tg: folds 
HipgaJhkN4ie/tTw4dK3Ug: folds 
4z7mPbMLNp4TezHXin63Vw: folds 
Uncalled bet ($0.15) returned to 32YL2ZEp8NT4JB2RVM9euQ
32YL2ZEp8NT4JB2RVM9euQ collected $0.20 from pot
32YL2ZEp8NT4JB2RVM9euQ: doesn't show hand 
*** SUMMARY ***
Total pot $0.20 | Rake $0 
Seat 1: HipgaJhkN4ie/tTw4dK3Ug (button) folded before Flop (didn't bet)
Seat 2: 4z7mPbMLNp4TezHXin63Vw (small blind) folded before Flop
Seat 3: 32YL2ZEp8NT4JB2RVM9euQ (big blind) collected ($0.20)
Seat 4: /gJNBeCkWL4o85/jvlZ4BA folded before Flop (didn't bet)
Seat 5: Ar4vsUIUfJ7gbYh1c1m59g folded before Flop (didn't bet)
Seat 6: qGHGf/553gQnDoklMRe3tg folded before Flop (didn't bet)




PokerStars Game #59941990092:  Hold'em No Limit ($0.10/$0.25) - 2009/07/01 1:52:35 ET
Table '4hfTdIVT/qPsJNfWXLsVIw' 9-max Seat #7 is the button
Seat 1: GbHFBbLqLGz0Pwn6CJeAuw ($37.95 in chips) 
Seat 2: Pt637jKksB5MzP0UNJAAkw ($36.60 in chips) 
Seat 3: xnVwSkROfRtOw4eSoDANtw ($2.10 in chips) 
Seat 4: 3PmVnC/15cl4oyI1TKIt4g ($6.55 in chips) 
Seat 5: dtZ84flFEi4Q+SGrHMJRDQ ($26.60 in chips) 
Seat 6: VWUWpMLMj/Q1jRVpF7Aohw ($11.80 in chips) 
Seat 7: d7YasxuGLPiL7pj8IcGThw ($7.10 in chips) 
Seat 8: 18G4P1XstjNvItdGUITxgw ($29 in chips) 
Seat 9: 9njEKzpOKC62MllUFUBWrA ($21.25 in chips) 
18G4P1XstjNvItdGUITxgw: posts small blind $0.10
9njEKzpOKC62MllUFUBWrA: posts big blind $0.25
*** HOLE CARDS ***
GbHFBbLqLGz0Pwn6CJeAuw: folds 
Pt637jKksB5MzP0UNJAAkw: raises $0.75 to $1
GbHFBbLqLGz0Pwn6CJeAuw is sitting out
xnVwSkROfRtOw4eSoDANtw: folds 
3PmVnC/15cl4oyI1TKIt4g: folds 
GbHFBbLqLGz0Pwn6CJeAuw leaves the table
dtZ84flFEi4Q+SGrHMJRDQ: folds 
VWUWpMLMj/Q1jRVpF7Aohw: folds 
d7YasxuGLPiL7pj8IcGThw: folds 
18G4P1XstjNvItdGUITxgw: folds 
9njEKzpOKC62MllUFUBWrA: folds 
Uncalled bet ($0.75) returned to Pt637jKksB5MzP0UNJAAkw
Pt637jKksB5MzP0UNJAAkw collected $0.60 from pot
Pt637jKksB5MzP0UNJAAkw: doesn't show hand 
*** SUMMARY ***
Total pot $0.60 | Rake $0 
Seat 1: GbHFBbLqLGz0Pwn6CJeAuw folded before Flop (didn't bet)
Seat 2: Pt637jKksB5MzP0UNJAAkw collected ($0.60)
Seat 3: xnVwSkROfRtOw4eSoDANtw folded before Flop (didn't bet)
Seat 4: 3PmVnC/15cl4oyI1TKIt4g folded before Flop (didn't bet)
Seat 5: dtZ84flFEi4Q+SGrHMJRDQ folded before Flop (didn't bet)
Seat 6: VWUWpMLMj/Q1jRVpF7Aohw folded before Flop (didn't bet)
Seat 7: d7YasxuGLPiL7pj8IcGThw (button) folded before Flop (didn't bet)
Seat 8: 18G4P1XstjNvItdGUITxgw (small blind) folded before Flop
Seat 9: 9njEKzpOKC62MllUFUBWrA (big blind) folded before Flop




PokerStars Game #59941990324:  Hold'em No Limit ($0.10/$0.25) - 2009/07/01 1:52:35 ET
Table 'Jz+kWRxWNGk9w24fdQEveA' 9-max Seat #5 is the button
Seat 1: Z9W7+g1WMhhZDi7DwGbCFA ($5 in chips) 
Seat 2: ljemhp25Zg+nlA9DLCIiUw ($37 in chips) 
Seat 3: N5sUK8M0br9djLrW97V9pQ ($22.55 in chips) 
Seat 4: HPEB+AtKw1+C/cxU0o1ciw ($28.65 in chips) 
Seat 5: d6eSA7wOH5mRaSyVDVRBLw ($16.80 in chips) 
Seat 7: wGigCmBR/9XWkPpvYos3aQ ($26.60 in chips) 
Seat 8: j4q3p0lesp63b1gZDwLBZw ($5 in chips) 
Seat 9: V6p0jQ/RhUsqpHLmXvEX4Q ($17.35 in chips) 
AiXn/9o1EwOPZUHujnh/bA will be allowed to play after the button
wGigCmBR/9XWkPpvYos3aQ: posts small blind $0.10
j4q3p0lesp63b1gZDwLBZw: posts big blind $0.25
*** HOLE CARDS ***
V6p0jQ/RhUsqpHLmXvEX4Q: folds 
Z9W7+g1WMhhZDi7DwGbCFA: folds 
ljemhp25Zg+nlA9DLCIiUw: folds 
N5sUK8M0br9djLrW97V9pQ: folds 
HPEB+AtKw1+C/cxU0o1ciw: folds 
d6eSA7wOH5mRaSyVDVRBLw: folds 
wGigCmBR/9XWkPpvYos3aQ: folds 
Uncalled bet ($0.15) returned to j4q3p0lesp63b1gZDwLBZw
j4q3p0lesp63b1gZDwLBZw collected $0.20 from pot
j4q3p0lesp63b1gZDwLBZw: doesn't show hand 
*** SUMMARY ***
Total pot $0.20 | Rake $0 
Seat 1: Z9W7+g1WMhhZDi7DwGbCFA folded before Flop (didn't bet)
Seat 2: ljemhp25Zg+nlA9DLCIiUw folded before Flop (didn't bet)
Seat 3: N5sUK8M0br9djLrW97V9pQ folded before Flop (didn't bet)
Seat 4: HPEB+AtKw1+C/cxU0o1ciw folded before Flop (didn't bet)
Seat 5: d6eSA7wOH5mRaSyVDVRBLw (button) folded before Flop (didn't bet)
Seat 7: wGigCmBR/9XWkPpvYos3aQ (small blind) folded before Flop
Seat 8: j4q3p0lesp63b1gZDwLBZw (big blind) collected ($0.20)
Seat 9: V6p0jQ/RhUsqpHLmXvEX4Q folded before Flop (didn't bet)




PokerStars Game #59941990298:  Hold'em No Limit ($0.10/$0.25) - 2009/07/01 1:52:35 ET
Table 'dVzscin98UhGisTmV9BDcw' 9-max Seat #7 is the button
Seat 1: sBAwXpkpgyhyWbHIQcIJKA ($16.40 in chips) 
Seat 2: dfNim92Z6XK1/h5SFW5vDg ($38.50 in chips) 
Seat 3: cZ99hugmLBj9KhTlc8nCSw ($25 in chips) 
Seat 5: E0iYnEVO2ho7dH3QcCjw7g ($24.90 in chips) 
Seat 6: A/OkFabqdcrG3ozpiYMiNQ ($24.15 in chips) 
Seat 7: cKlmpQMahVsmOaxFQDcoOg ($24.90 in chips) 
Seat 8: /vn2Qu2dvc9AMMq46Ae0jA ($37 in chips) 
Seat 9: arxNSjreDRGFg13EAM2F1w ($25 in chips) 
/vn2Qu2dvc9AMMq46Ae0jA: posts small blind $0.10
arxNSjreDRGFg13EAM2F1w: posts big blind $0.25
*** HOLE CARDS ***
sBAwXpkpgyhyWbHIQcIJKA: folds 
dfNim92Z6XK1/h5SFW5vDg: folds 
cZ99hugmLBj9KhTlc8nCSw: folds 
E0iYnEVO2ho7dH3QcCjw7g: folds 
A/OkFabqdcrG3ozpiYMiNQ: raises $0.50 to $0.75
cKlmpQMahVsmOaxFQDcoOg: raises $1 to $1.75
enotus joins the table at seat #4 
/vn2Qu2dvc9AMMq46Ae0jA: folds 
arxNSjreDRGFg13EAM2F1w: folds 
A/OkFabqdcrG3ozpiYMiNQ: calls $1
*** FLOP *** [Jd 6c 9s]
A/OkFabqdcrG3ozpiYMiNQ: checks 
cKlmpQMahVsmOaxFQDcoOg: bets $3
A/OkFabqdcrG3ozpiYMiNQ: calls $3
*** TURN *** [Jd 6c 9s] [7s]
A/OkFabqdcrG3ozpiYMiNQ: checks 
cKlmpQMahVsmOaxFQDcoOg: checks 
*** RIVER *** [Jd 6c 9s 7s] [Qs]
A/OkFabqdcrG3ozpiYMiNQ: checks 
cKlmpQMahVsmOaxFQDcoOg: bets $6
A/OkFabqdcrG3ozpiYMiNQ: calls $6
*** SHOW DOWN ***
cKlmpQMahVsmOaxFQDcoOg: shows [Qd Qc] (three of a kind, Queens)
A/OkFabqdcrG3ozpiYMiNQ: mucks hand 
cKlmpQMahVsmOaxFQDcoOg collected $20.80 from pot
*** SUMMARY ***
Total pot $21.85 | Rake $1.05 
Board [Jd 6c 9s 7s Qs]
Seat 1: sBAwXpkpgyhyWbHIQcIJKA folded before Flop (didn't bet)
Seat 2: dfNim92Z6XK1/h5SFW5vDg folded before Flop (didn't bet)
Seat 3: cZ99hugmLBj9KhTlc8nCSw folded before Flop (didn't bet)
Seat 5: E0iYnEVO2ho7dH3QcCjw7g folded before Flop (didn't bet)
Seat 6: A/OkFabqdcrG3ozpiYMiNQ mucked
Seat 7: cKlmpQMahVsmOaxFQDcoOg (button) showed [Qd Qc] and won ($20.80) with three of a kind, Queens
Seat 8: /vn2Qu2dvc9AMMq46Ae0jA (small blind) folded before Flop
Seat 9: arxNSjreDRGFg13EAM2F1w (big blind) folded before Flop




PokerStars Game #59941990086:  Hold'em No Limit ($0.10/$0.25) - 2009/07/01 1:52:35 ET
Table 'Is9eNmJA1KnBOw0lcVkxUQ' 9-max Seat #8 is the button
Seat 3: ubsjZomMWSV0hAiBLa7K1A ($18.15 in chips) 
Seat 5: Qduu7ikeizo6q6Ei9YvcJA ($29.05 in chips) 
Seat 6: HapyJHxV6lc3eqoT7yWL2A ($5.55 in chips) 
Seat 8: Th3FldXKQW6hWVVPahaoOQ ($25 in chips) 
mlXogR/AG8xUvCi1Il31lw will be allowed to play after the button
ubsjZomMWSV0hAiBLa7K1A: posts small blind $0.10
Qduu7ikeizo6q6Ei9YvcJA: posts big blind $0.25
18G4P1XstjNvItdGUITxgw: sits out 
*** HOLE CARDS ***
18G4P1XstjNvItdGUITxgw leaves the table
HapyJHxV6lc3eqoT7yWL2A: folds 
Th3FldXKQW6hWVVPahaoOQ: folds 
EssThirteen joins the table at seat #4 
ubsjZomMWSV0hAiBLa7K1A: raises $0.50 to $0.75
Qduu7ikeizo6q6Ei9YvcJA: calls $0.50
*** FLOP *** [6d Qs Jh]
ubsjZomMWSV0hAiBLa7K1A: checks 
Qduu7ikeizo6q6Ei9YvcJA: bets $1
ubsjZomMWSV0hAiBLa7K1A: folds 
Uncalled bet ($1) returned to Qduu7ikeizo6q6Ei9YvcJA
Qduu7ikeizo6q6Ei9YvcJA collected $1.45 from pot
Qduu7ikeizo6q6Ei9YvcJA: doesn't show hand 
*** SUMMARY ***
Total pot $1.50 | Rake $0.05 
Board [6d Qs Jh]
Seat 3: ubsjZomMWSV0hAiBLa7K1A (small blind) folded on the Flop
Seat 5: Qduu7ikeizo6q6Ei9YvcJA (big blind) collected ($1.45)
Seat 6: HapyJHxV6lc3eqoT7yWL2A folded before Flop (didn't bet)
Seat 8: Th3FldXKQW6hWVVPahaoOQ (button) folded before Flop (didn't bet)




PokerStars Game #59941990530:  Hold'em No Limit ($0.10/$0.25) - 2009/07/01 1:52:35 ET
Table 'eOXPe2c6mG7DOFKvMsZZfA' 6-max Seat #5 is the button
Seat 2: gaPMxLGp9SOj4Lq6t+/0Ig ($11.95 in chips) 
Seat 3: kReyZ6g6Fu3tQ0nyjDf9kA ($23.85 in chips) 
Seat 4: zHHLkD2sRljslKKeQv/ZQw ($31.50 in chips) 
Seat 5: NhUN/JpAprdJeamFBgJH1w ($33.20 in chips) 
Seat 6: Qpv/hb5ak7LeaDig1L5L8w ($13.45 in chips) 
Qpv/hb5ak7LeaDig1L5L8w: posts small blind $0.10
gaPMxLGp9SOj4Lq6t+/0Ig: posts big blind $0.25
*** HOLE CARDS ***
kReyZ6g6Fu3tQ0nyjDf9kA: folds 
zHHLkD2sRljslKKeQv/ZQw: folds 
NhUN/JpAprdJeamFBgJH1w: folds 
Qpv/hb5ak7LeaDig1L5L8w: folds 
Uncalled bet ($0.15) returned to gaPMxLGp9SOj4Lq6t+/0Ig
gaPMxLGp9SOj4Lq6t+/0Ig collected $0.20 from pot
gaPMxLGp9SOj4Lq6t+/0Ig: doesn't show hand 
*** SUMMARY ***
Total pot $0.20 | Rake $0 
Seat 2: gaPMxLGp9SOj4Lq6t+/0Ig (big blind) collected ($0.20)
Seat 3: kReyZ6g6Fu3tQ0nyjDf9kA folded before Flop (didn't bet)
Seat 4: zHHLkD2sRljslKKeQv/ZQw folded before Flop (didn't bet)
Seat 5: NhUN/JpAprdJeamFBgJH1w (button) folded before Flop (didn't bet)
Seat 6: Qpv/hb5ak7LeaDig1L5L8w (small blind) folded before Flop




PokerStars Game #59941989992:  Hold'em No Limit ($0.10/$0.25) - 2009/07/01 1:52:35 ET
Table 'NtCSSONEf1zaJo3042tQug' 6-max Seat #5 is the button
Seat 1: KXtdqb+rIMkjc0RvHDksGQ ($31.15 in chips) 
Seat 2: vqWjZmdQu/Hxw96/IJTWdQ ($25 in chips) 
Seat 3: 9kUKGKkblnIx3m8rlVol6Q ($16.05 in chips) 
Seat 5: tOAk1Og4mVObMBOfvdDYOw ($35.20 in chips) 
Seat 6: LxehwDpTQ19ph4Qmc78+Pw ($33.60 in chips) 
LxehwDpTQ19ph4Qmc78+Pw: posts small blind $0.10
KXtdqb+rIMkjc0RvHDksGQ: posts big blind $0.25
*** HOLE CARDS ***
vqWjZmdQu/Hxw96/IJTWdQ: folds 
9kUKGKkblnIx3m8rlVol6Q: folds 
tOAk1Og4mVObMBOfvdDYOw: folds 
LxehwDpTQ19ph4Qmc78+Pw: calls $0.15
KXtdqb+rIMkjc0RvHDksGQ: checks 
*** FLOP *** [7h 9h Ts]
LxehwDpTQ19ph4Qmc78+Pw: checks 
KXtdqb+rIMkjc0RvHDksGQ: checks 
*** TURN *** [7h 9h Ts] [2c]
LxehwDpTQ19ph4Qmc78+Pw: bets $0.25
KXtdqb+rIMkjc0RvHDksGQ: calls $0.25
*** RIVER *** [7h 9h Ts 2c] [5d]
LxehwDpTQ19ph4Qmc78+Pw: checks 
KXtdqb+rIMkjc0RvHDksGQ: checks 
*** SHOW DOWN ***
LxehwDpTQ19ph4Qmc78+Pw: shows [2d Kc] (a pair of Deuces)
KXtdqb+rIMkjc0RvHDksGQ: shows [6d 7s] (a pair of Sevens)
KXtdqb+rIMkjc0RvHDksGQ collected $0.95 from pot
*** SUMMARY ***
Total pot $1 | Rake $0.05 
Board [7h 9h Ts 2c 5d]
Seat 1: KXtdqb+rIMkjc0RvHDksGQ (big blind) showed [6d 7s] and won ($0.95) with a pair of Sevens
Seat 2: vqWjZmdQu/Hxw96/IJTWdQ folded before Flop (didn't bet)
Seat 3: 9kUKGKkblnIx3m8rlVol6Q folded before Flop (didn't bet)
Seat 5: tOAk1Og4mVObMBOfvdDYOw (button) folded before Flop (didn't bet)
Seat 6: LxehwDpTQ19ph4Qmc78+Pw (small blind) showed [2d Kc] and lost with a pair of Deuces




PokerStars Game #59941990234:  Hold'em No Limit ($0.10/$0.25) - 2009/07/01 1:52:35 ET
Table '3LMlz3V4AziGlU+ikmyU8w' 6-max Seat #6 is the button
Seat 1: ErIN0JRL5srYjT6en1f8YQ ($24.75 in chips) 
Seat 2: uR3AbFJLoOX86DOTtTgGcg ($34.50 in chips) 
Seat 3: Hzy03WtPHMYwLYM7hTTxQw ($52.15 in chips) 
Seat 5: tOAk1Og4mVObMBOfvdDYOw ($25.35 in chips) 
Seat 6: 7LpHJVeM6k1mQdC6HXYzww ($49.70 in chips) 
ErIN0JRL5srYjT6en1f8YQ: posts small blind $0.10
uR3AbFJLoOX86DOTtTgGcg: posts big blind $0.25
*** HOLE CARDS ***
Hzy03WtPHMYwLYM7hTTxQw: folds 
6DwBRH+xZ12AAZmeAg+aXw leaves the table
tOAk1Og4mVObMBOfvdDYOw: raises $0.75 to $1
7LpHJVeM6k1mQdC6HXYzww: folds 
ErIN0JRL5srYjT6en1f8YQ: folds 
uR3AbFJLoOX86DOTtTgGcg: calls $0.75
*** FLOP *** [6d 3c 4h]
uR3AbFJLoOX86DOTtTgGcg: checks 
tOAk1Og4mVObMBOfvdDYOw: checks 
*** TURN *** [6d 3c 4h] [5c]
uR3AbFJLoOX86DOTtTgGcg: checks 
tOAk1Og4mVObMBOfvdDYOw: checks 
*** RIVER *** [6d 3c 4h 5c] [Qh]
uR3AbFJLoOX86DOTtTgGcg: bets $0.25
tOAk1Og4mVObMBOfvdDYOw: folds 
Uncalled bet ($0.25) returned to uR3AbFJLoOX86DOTtTgGcg
uR3AbFJLoOX86DOTtTgGcg collected $2 from pot
k021eD5in2AjaloW5PalMg joins the table at seat #4 
*** SUMMARY ***
Total pot $2.10 | Rake $0.10 
Board [6d 3c 4h 5c Qh]
Seat 1: ErIN0JRL5srYjT6en1f8YQ (small blind) folded before Flop
Seat 2: uR3AbFJLoOX86DOTtTgGcg (big blind) collected ($2)
Seat 3: Hzy03WtPHMYwLYM7hTTxQw folded before Flop (didn't bet)
Seat 5: tOAk1Og4mVObMBOfvdDYOw folded on the River
Seat 6: 7LpHJVeM6k1mQdC6HXYzww (button) folded before Flop (didn't bet)




PokerStars Game #59941990070:  Hold'em No Limit ($0.10/$0.25) - 2009/07/01 1:52:35 ET
Table '7/qMNloI0nSXWiX5Y1watA' 9-max Seat #1 is the button
Seat 1: /LyhaB3V6jkgOfXORidqRQ ($9.90 in chips) 
Seat 2: wGigCmBR/9XWkPpvYos3aQ ($30.05 in chips) 
Seat 4: K0LdhPeU31rviEPo6Sv3TA ($9.45 in chips) 
Seat 8: ljemhp25Zg+nlA9DLCIiUw ($25.95 in chips) 
Seat 9: dmYlc+1cjwZMJ7wV+Z0rRg ($27.40 in chips) 
wGigCmBR/9XWkPpvYos3aQ: posts small blind $0.10
K0LdhPeU31rviEPo6Sv3TA: posts big blind $0.25
GeMoapCKDLc4ajT0Uk9ZQw: sits out 
JqeaikMej6KsqTKmUhl2Lw: sits out 
z5GxcHlYz/GSz6W2uFiTtg: sits out 
*** HOLE CARDS ***
ljemhp25Zg+nlA9DLCIiUw: folds 
dmYlc+1cjwZMJ7wV+Z0rRg: raises $0.50 to $0.75
/LyhaB3V6jkgOfXORidqRQ: folds 
wGigCmBR/9XWkPpvYos3aQ: folds 
K0LdhPeU31rviEPo6Sv3TA: folds 
Uncalled bet ($0.50) returned to dmYlc+1cjwZMJ7wV+Z0rRg
dmYlc+1cjwZMJ7wV+Z0rRg collected $0.60 from pot
dmYlc+1cjwZMJ7wV+Z0rRg: doesn't show hand 
*** SUMMARY ***
Total pot $0.60 | Rake $0 
Seat 1: /LyhaB3V6jkgOfXORidqRQ (button) folded before Flop (didn't bet)
Seat 2: wGigCmBR/9XWkPpvYos3aQ (small blind) folded before Flop
Seat 4: K0LdhPeU31rviEPo6Sv3TA (big blind) folded before Flop
Seat 8: ljemhp25Zg+nlA9DLCIiUw folded before Flop (didn't bet)
Seat 9: dmYlc+1cjwZMJ7wV+Z0rRg collected ($0.60)




PokerStars Game #59941990914:  Hold'em No Limit ($0.10/$0.25) - 2009/07/01 1:52:36 ET
Table 'LwnjzXstPtSrqrV/oDpnXQ' 9-max Seat #3 is the button
Seat 1: 9YN2IkT2JYYKFErZtZvCtA ($21.55 in chips) 
Seat 2: uLP/lYn7oKq9xCChBXsXxw ($26.15 in chips) 
Seat 3: 7je+LC5Mfs6nL8YBVh4frQ ($3.45 in chips) 
Seat 4: CmngQmkKTp8tkl6GMRTl6w ($7 in chips) 
Seat 5: Th3FldXKQW6hWVVPahaoOQ ($26.25 in chips) 
Seat 6: ljemhp25Zg+nlA9DLCIiUw ($40 in chips) 
Seat 7: c/Dw/6HyqldTzIRodAIZmg ($13.40 in chips) 
Seat 8: ShXPHWfjhfmAwLgDdm6bRQ ($13 in chips) 
Seat 9: q6WfTUAD9mowIP63ASq2Dgz/khFDKGihQjwgoiKKPOeg15 in chips) 
CmngQmkKTp8tkl6GMRTl6w: posts small blind $0.10
Th3FldXKQW6hWVVPahaoOQ: posts big blind $0.25
*** HOLE CARDS ***
ljemhp25Zg+nlA9DLCIiUw: folds 
ljemhp25Zg+nlA9DLCIiUw is sitting out
c/Dw/6HyqldTzIRodAIZmg: folds 
ShXPHWfjhfmAwLgDdm6bRQ: folds 
q6WfTUAD9mowIP63ASq2Dgz/khFDKGihQjwgoiKKPOegs $0.25
9YN2IkT2JYYKFErZtZvCtA: folds 
uLP/lYn7oKq9xCChBXsXxw: folds 
7je+LC5Mfs6nL8YBVh4frQ: folds 
CmngQmkKTp8tkl6GMRTl6w: calls $0.15
Th3FldXKQW6hWVVPahaoOQ: checks 
*** FLOP *** [Jh Ac 4s]
CmngQmkKTp8tkl6GMRTl6w: checks 
Th3FldXKQW6hWVVPahaoOQ: checks 
q6WfTUAD9mowIP63ASq2Dgz/khFDKGihQjwgoiKKPOeg $0.75
CmngQmkKTp8tkl6GMRTl6w: folds 
Th3FldXKQW6hWVVPahaoOQ: folds 
Uncalled bet ($0.75) returned to q6WfTUAD9mowIP63ASq2Dgz/khFDKGihQjwgoiKKPOegq6WfTUAD9mowIP63ASq2Dgt collected $0.75 from pot
q6WfTUAD9mowIP63ASq2Dgz/khFDKGihQjwgoiKKPOegn't show hand 
*** SUMMARY ***
Total pot $0.75 | Rake $0 
Board [Jh Ac 4s]
Seat 1: 9YN2IkT2JYYKFErZtZvCtA folded before Flop (didn't bet)
Seat 2: uLP/lYn7oKq9xCChBXsXxw folded before Flop (didn't bet)
Seat 3: 7je+LC5Mfs6nL8YBVh4frQ (button) folded before Flop (didn't bet)
Seat 4: CmngQmkKTp8tkl6GMRTl6w (small blind) folded on the Flop
Seat 5: Th3FldXKQW6hWVVPahaoOQ (big blind) folded on the Flop
Seat 6: ljemhp25Zg+nlA9DLCIiUw folded before Flop (didn't bet)
Seat 7: c/Dw/6HyqldTzIRodAIZmg folded before Flop (didn't bet)
Seat 8: ShXPHWfjhfmAwLgDdm6bRQ folded before Flop (didn't bet)
Seat 9: q6WfTUAD9mowIP63ASq2Dgz/khFDKGihQjwgoiKKPOegcted ($0.75)




PokerStars Game #59941990666:  Hold'em No Limit ($0.10/$0.25) - 2009/07/01 1:52:36 ET
Table '8PD/MTROSMd6Y8mZeykbpg' 6-max Seat #6 is the button
Seat 1: fxNpaToxECtD2Goelmg9vA ($27 in chips) 
Seat 2: 4TM16KVgEiQpLi4bVVWbVQ ($31.95 in chips) 
Seat 3: vqWjZmdQu/Hxw96/IJTWdQ ($25 in chips) 
Seat 4: DFi/Lzkjsfv8QswS80JX9Q ($49.20 in chips) 
Seat 5: z3tQwy28dp5FykDJC/wzQw ($26.20 in chips) 
Seat 6: trN/oHqTTbPw5MNuKrOpLw ($25 in chips) 
fxNpaToxECtD2Goelmg9vA: posts small blind $0.10
4TM16KVgEiQpLi4bVVWbVQ: posts big blind $0.25
*** HOLE CARDS ***
vqWjZmdQu/Hxw96/IJTWdQ: folds 
DFi/Lzkjsfv8QswS80JX9Q: raises $0.75 to $1
z3tQwy28dp5FykDJC/wzQw: folds 
trN/oHqTTbPw5MNuKrOpLw: folds 
fxNpaToxECtD2Goelmg9vA: folds 
4TM16KVgEiQpLi4bVVWbVQ: folds 
Uncalled bet ($0.75) returned to DFi/Lzkjsfv8QswS80JX9Q
DFi/Lzkjsfv8QswS80JX9Q collected $0.60 from pot
DFi/Lzkjsfv8QswS80JX9Q: doesn't show hand 
*** SUMMARY ***
Total pot $0.60 | Rake $0 
Seat 1: fxNpaToxECtD2Goelmg9vA (small blind) folded before Flop
Seat 2: 4TM16KVgEiQpLi4bVVWbVQ (big blind) folded before Flop
Seat 3: vqWjZmdQu/Hxw96/IJTWdQ folded before Flop (didn't bet)
Seat 4: DFi/Lzkjsfv8QswS80JX9Q collected ($0.60)
Seat 5: z3tQwy28dp5FykDJC/wzQw folded before Flop (didn't bet)
Seat 6: trN/oHqTTbPw5MNuKrOpLw (button) folded before Flop (didn't bet)




PokerStars Game #59941990848:  Hold'em No Limit ($0.10/$0.25) - 2009/07/01 1:52:36 ET
Table 'mdub7rJf3Z5tCT9s/+1+Wg' 9-max Seat #2 is the button
Seat 2: 539MC3AwKLWVFwzABc644Q ($10.55 in chips) 
Seat 4: fDGyaQz0cs2s4FOYxkbIHA ($14.85 in chips) 
Seat 5: dfNim92Z6XK1/h5SFW5vDg ($25.90 in chips) 
Seat 6: T/CCwAWe2yhO0c4oHNwicw ($17.05 in chips) 
Seat 7: woe+9KKk+L3pZgMTuHcmog ($15.55 in chips) 
Seat 8: bXpVeaSTPBFSPJmeXxO7nw ($4.65 in chips) 
Seat 9: EgDmMA1aiBPBqXe32LIyEw ($7 in chips) 
fDGyaQz0cs2s4FOYxkbIHA: posts small blind $0.10
dfNim92Z6XK1/h5SFW5vDg: posts big blind $0.25
EgDmMA1aiBPBqXe32LIyEw: posts big blind $0.25
*** HOLE CARDS ***
T/CCwAWe2yhO0c4oHNwicw: folds 
T/CCwAWe2yhO0c4oHNwicw leaves the table
woe+9KKk+L3pZgMTuHcmog: folds 
bXpVeaSTPBFSPJmeXxO7nw: folds 
EgDmMA1aiBPBqXe32LIyEw: checks 
539MC3AwKLWVFwzABc644Q: folds 
fDGyaQz0cs2s4FOYxkbIHA: folds 
dfNim92Z6XK1/h5SFW5vDg: checks 
*** FLOP *** [Qd 9s Jc]
dfNim92Z6XK1/h5SFW5vDg: bets $0.50
EgDmMA1aiBPBqXe32LIyEw: folds 
Uncalled bet ($0.50) returned to dfNim92Z6XK1/h5SFW5vDg
dfNim92Z6XK1/h5SFW5vDg collected $0.60 from pot
dfNim92Z6XK1/h5SFW5vDg: doesn't show hand 
*** SUMMARY ***
Total pot $0.60 | Rake $0 
Board [Qd 9s Jc]
Seat 2: 539MC3AwKLWVFwzABc644Q (button) folded before Flop (didn't bet)
Seat 4: fDGyaQz0cs2s4FOYxkbIHA (small blind) folded before Flop
Seat 5: dfNim92Z6XK1/h5SFW5vDg (big blind) collected ($0.60)
Seat 6: T/CCwAWe2yhO0c4oHNwicw folded before Flop (didn't bet)
Seat 7: woe+9KKk+L3pZgMTuHcmog folded before Flop (didn't bet)
Seat 8: bXpVeaSTPBFSPJmeXxO7nw folded before Flop (didn't bet)
Seat 9: EgDmMA1aiBPBqXe32LIyEw folded on the Flop




PokerStars Game #59941991166:  Hold'em No Limit ($0.10/$0.25) - 2009/07/01 1:52:37 ET
Table 'jxoHy9yJy0bbH/Qx73FoPA' 9-max Seat #4 is the button
Seat 3: CVqCt93Mk0MhKMaZ4LZDSQ ($2.45 in chips) 
Seat 4: bXpVeaSTPBFSPJmeXxO7nw ($9 in chips) 
Seat 5: 0rQnT3MwKEGi6YXD9FufJw ($4.75 in chips) 
Seat 6: Z9AeOQX3yzuSvKAm/xyovg ($9.75 in chips) 
Seat 7: wGigCmBR/9XWkPpvYos3aQ ($26.40 in chips) 
Seat 8: Z9W7+g1WMhhZDi7DwGbCFA ($5 in chips) 
Seat 9: CvL9Ch1HYCVbTsfpNucitg ($5 in chips) 
0rQnT3MwKEGi6YXD9FufJw: posts small blind $0.10
Z9AeOQX3yzuSvKAm/xyovg: posts big blind $0.25
*** HOLE CARDS ***
wGigCmBR/9XWkPpvYos3aQ: folds 
Z9W7+g1WMhhZDi7DwGbCFA: folds 
CvL9Ch1HYCVbTsfpNucitg: folds 
Nh/g25nULd6c6RoEAeukGg joins the table at seat #2 
CVqCt93Mk0MhKMaZ4LZDSQ: folds 
Concertfreak joins the table at seat #1 
bXpVeaSTPBFSPJmeXxO7nw: folds 
0rQnT3MwKEGi6YXD9FufJw: folds 
Uncalled bet ($0.15) returned to Z9AeOQX3yzuSvKAm/xyovg
Z9AeOQX3yzuSvKAm/xyovg collected $0.20 from pot
*** SUMMARY ***
Total pot $0.20 | Rake $0 
Seat 3: CVqCt93Mk0MhKMaZ4LZDSQ folded before Flop (didn't bet)
Seat 4: bXpVeaSTPBFSPJmeXxO7nw (button) folded before Flop (didn't bet)
Seat 5: 0rQnT3MwKEGi6YXD9FufJw (small blind) folded before Flop
Seat 6: Z9AeOQX3yzuSvKAm/xyovg (big blind) collected ($0.20)
Seat 7: wGigCmBR/9XWkPpvYos3aQ folded before Flop (didn't bet)
Seat 8: Z9W7+g1WMhhZDi7DwGbCFA folded before Flop (didn't bet)
Seat 9: CvL9Ch1HYCVbTsfpNucitg folded before Flop (didn't bet)




PokerStars Game #59941991456:  Hold'em No Limit ($0.10/$0.25) - 2009/07/01 1:52:37 ET
Table '3lS+sU5k6mwJCS2nFMmQ6Q' 9-max Seat #8 is the button
Seat 1: VWUWpMLMj/Q1jRVpF7Aohw ($13.55 in chips) 
Seat 2: PdIasPkzm2sqZnN41ZRXOg ($5.75 in chips) 
Seat 4: GeMoapCKDLc4ajT0Uk9ZQw ($9.65 in chips) 
Seat 6: hJ4uYjNmSZdjrKA8cjZqCA ($35.15 in chips) 
Seat 7: Th3FldXKQW6hWVVPahaoOQ ($31.20 in chips) 
Seat 8: 9lvO/qyU+xrU95Teu1fv0g ($4.65 in chips) 
Seat 9: 4awUyiDYTgylQKXZ9faBVA ($61.10 in chips) 
4awUyiDYTgylQKXZ9faBVA: posts small blind $0.10
VWUWpMLMj/Q1jRVpF7Aohw: posts big blind $0.25
*** HOLE CARDS ***
PdIasPkzm2sqZnN41ZRXOg: calls $0.25
GeMoapCKDLc4ajT0Uk9ZQw: folds 
hJ4uYjNmSZdjrKA8cjZqCA: raises $0.75 to $1
Th3FldXKQW6hWVVPahaoOQ: folds 
9lvO/qyU+xrU95Teu1fv0g: folds 
4awUyiDYTgylQKXZ9faBVA: folds 
VWUWpMLMj/Q1jRVpF7Aohw: folds 
PdIasPkzm2sqZnN41ZRXOg: calls $0.75
*** FLOP *** [2s 2c 6c]
PdIasPkzm2sqZnN41ZRXOg: checks 
hJ4uYjNmSZdjrKA8cjZqCA: bets $1.25
PdIasPkzm2sqZnN41ZRXOg: raises $3.50 to $4.75 and is all-in
hJ4uYjNmSZdjrKA8cjZqCA: calls $3.50
*** TURN *** [2s 2c 6c] [3h]
*** RIVER *** [2s 2c 6c 3h] [Ad]
*** SHOW DOWN ***
PdIasPkzm2sqZnN41ZRXOg: shows [9h 9s] (two pair, Nines and Deuces)
hJ4uYjNmSZdjrKA8cjZqCA: shows [Jd Js] (two pair, Jacks and Deuces)
hJ4uYjNmSZdjrKA8cjZqCA collected $11.30 from pot
*** SUMMARY ***
Total pot $11.85 | Rake $0.55 
Board [2s 2c 6c 3h Ad]
Seat 1: VWUWpMLMj/Q1jRVpF7Aohw (big blind) folded before Flop
Seat 2: PdIasPkzm2sqZnN41ZRXOg showed [9h 9s] and lost with two pair, Nines and Deuces
Seat 4: GeMoapCKDLc4ajT0Uk9ZQw folded before Flop (didn't bet)
Seat 6: hJ4uYjNmSZdjrKA8cjZqCA showed [Jd Js] and won ($11.30) with two pair, Jacks and Deuces
Seat 7: Th3FldXKQW6hWVVPahaoOQ folded before Flop (didn't bet)
Seat 8: 9lvO/qyU+xrU95Teu1fv0g (button) folded before Flop (didn't bet)
Seat 9: 4awUyiDYTgylQKXZ9faBVA (small blind) folded before Flop




PokerStars Game #59941991468:  Hold'em No Limit ($0.10/$0.25) - 2009/07/01 1:52:37 ET
Table 'nyTW9cVtYentc5V7xU/0jA' 6-max Seat #2 is the button
Seat 1: HI20pVxSHPZ29u9IDkmICg ($6.80 in chips) 
Seat 2: opbAKk7WcZH8kDKUux3/0g ($4.50 in chips) 
Seat 3: kG34n23qFQA3nzdOJTQ1dA ($35.25 in chips) 
Seat 4: NkB3D4eVHHXvB9Edaugc1Q ($36.70 in chips) 
Seat 5: zZAcuQ0EvirdEuiIbeaocQ ($7.05 in chips) 
Seat 6: Cwf8Ho8JHNvwzsv9ah8uRQ ($18.15 in chips) 
kG34n23qFQA3nzdOJTQ1dA: posts small blind $0.10
NkB3D4eVHHXvB9Edaugc1Q: posts big blind $0.25
*** HOLE CARDS ***
zZAcuQ0EvirdEuiIbeaocQ: calls $0.25
Cwf8Ho8JHNvwzsv9ah8uRQ: folds 
HI20pVxSHPZ29u9IDkmICg: raises $0.50 to $0.75
opbAKk7WcZH8kDKUux3/0g: folds 
kG34n23qFQA3nzdOJTQ1dA: folds 
NkB3D4eVHHXvB9Edaugc1Q: calls $0.50
zZAcuQ0EvirdEuiIbeaocQ: folds 
*** FLOP *** [Ks 6d Jc]
NkB3D4eVHHXvB9Edaugc1Q: bets $0.25
HI20pVxSHPZ29u9IDkmICg: raises $0.75 to $1
NkB3D4eVHHXvB9Edaugc1Q: folds 
Uncalled bet ($0.75) returned to HI20pVxSHPZ29u9IDkmICg
HI20pVxSHPZ29u9IDkmICg collected $2.25 from pot
*** SUMMARY ***
Total pot $2.35 | Rake $0.10 
Board [Ks 6d Jc]
Seat 1: HI20pVxSHPZ29u9IDkmICg collected ($2.25)
Seat 2: opbAKk7WcZH8kDKUux3/0g (button) folded before Flop (didn't bet)
Seat 3: kG34n23qFQA3nzdOJTQ1dA (small blind) folded before Flop
Seat 4: NkB3D4eVHHXvB9Edaugc1Q (big blind) folded on the Flop
Seat 5: zZAcuQ0EvirdEuiIbeaocQ folded before Flop
Seat 6: Cwf8Ho8JHNvwzsv9ah8uRQ folded before Flop (didn't bet)




PokerStars Game #59941991274:  Hold'em No Limit ($0.10/$0.25) - 2009/07/01 1:52:37 ET
Table 'NgexmgEDEzICBeSO7YCrKQ' 6-max Seat #6 is the button
Seat 1: cezpHJ8FB07dj0xG+LhOvw ($28.30 in chips) 
Seat 2: 32YL2ZEp8NT4JB2RVM9euQ ($21.30 in chips) 
Seat 3: JFIAqU8lCZ0vWwEl4bdGsg ($27.20 in chips) 
Seat 4: xx+iYCDJhHJmNzrfeloyEg ($24.10 in chips) 
Seat 5: /MXkdT8TTs8Qp2LVTQNw6w ($41.45 in chips) 
Seat 6: k9nHZTHt8hYhYRcW8NTb4g ($11.80 in chips) 
cezpHJ8FB07dj0xG+LhOvw: posts small blind $0.10
32YL2ZEp8NT4JB2RVM9euQ: posts big blind $0.25
*** HOLE CARDS ***
JFIAqU8lCZ0vWwEl4bdGsg: folds 
xx+iYCDJhHJmNzrfeloyEg: calls $0.25
/MXkdT8TTs8Qp2LVTQNw6w: raises $1 to $1.25
k9nHZTHt8hYhYRcW8NTb4g: calls $1.25
cezpHJ8FB07dj0xG+LhOvw: folds 
32YL2ZEp8NT4JB2RVM9euQ: folds 
xx+iYCDJhHJmNzrfeloyEg: folds 
*** FLOP *** [Ad 5d 5h]
/MXkdT8TTs8Qp2LVTQNw6w: bets $2
k9nHZTHt8hYhYRcW8NTb4g: folds 
Uncalled bet ($2) returned to /MXkdT8TTs8Qp2LVTQNw6w
/MXkdT8TTs8Qp2LVTQNw6w collected $2.95 from pot
/MXkdT8TTs8Qp2LVTQNw6w: doesn't show hand 
*** SUMMARY ***
Total pot $3.10 | Rake $0.15 
Board [Ad 5d 5h]
Seat 1: cezpHJ8FB07dj0xG+LhOvw (small blind) folded before Flop
Seat 2: 32YL2ZEp8NT4JB2RVM9euQ (big blind) folded before Flop
Seat 3: JFIAqU8lCZ0vWwEl4bdGsg folded before Flop (didn't bet)
Seat 4: xx+iYCDJhHJmNzrfeloyEg folded before Flop
Seat 5: /MXkdT8TTs8Qp2LVTQNw6w collected ($2.95)
Seat 6: k9nHZTHt8hYhYRcW8NTb4g (button) folded on the Flop




PokerStars Game #59941991562:  Hold'em No Limit ($0.10/$0.25) - 2009/07/01 1:52:37 ET
Table 'IUwZ/e0bDHZPgsIWx0RnNg' 6-max Seat #6 is the button
Seat 1: V66QiVCQPofyl3a+dpPHQQ ($4.45 in chips) 
Seat 2: mvFHK3pE7tCxJEqLjKC70Q ($54.85 in chips) 
Seat 3: dOX4wnYV2sEqvDbF+8KSCw ($25 in chips) 
Seat 4: OIjOiBfQstWrK/RuXx7zcw ($9 in chips) 
Seat 5: 9bpVv1/Qh9IYtXuCtl5VtQ ($25.20 in chips) 
Seat 6: NhUN/JpAprdJeamFBgJH1w ($38.55 in chips) 
V66QiVCQPofyl3a+dpPHQQ: posts small blind $0.10
mvFHK3pE7tCxJEqLjKC70Q: posts big blind $0.25
*** HOLE CARDS ***
dOX4wnYV2sEqvDbF+8KSCw: calls $0.25
OIjOiBfQstWrK/RuXx7zcw: raises $1 to $1.25
9bpVv1/Qh9IYtXuCtl5VtQ: folds 
NhUN/JpAprdJeamFBgJH1w: folds 
V66QiVCQPofyl3a+dpPHQQ: calls $1.15
mvFHK3pE7tCxJEqLjKC70Q: folds 
dOX4wnYV2sEqvDbF+8KSCw: folds 
*** FLOP *** [9s Ac Kh]
V66QiVCQPofyl3a+dpPHQQ: checks 
dOX4wnYV2sEqvDbF+8KSCw leaves the table
OIjOiBfQstWrK/RuXx7zcw: bets $1.25
V66QiVCQPofyl3a+dpPHQQ: folds 
Uncalled bet ($1.25) returned to OIjOiBfQstWrK/RuXx7zcw
OIjOiBfQstWrK/RuXx7zcw collected $2.85 from pot
OIjOiBfQstWrK/RuXx7zcw: doesn't show hand 
*** SUMMARY ***
Total pot $3 | Rake $0.15 
Board [9s Ac Kh]
Seat 1: V66QiVCQPofyl3a+dpPHQQ (small blind) folded on the Flop
Seat 2: mvFHK3pE7tCxJEqLjKC70Q (big blind) folded before Flop
Seat 3: dOX4wnYV2sEqvDbF+8KSCw folded before Flop
Seat 4: OIjOiBfQstWrK/RuXx7zcw collected ($2.85)
Seat 5: 9bpVv1/Qh9IYtXuCtl5VtQ folded before Flop (didn't bet)
Seat 6: NhUN/JpAprdJeamFBgJH1w (button) folded before Flop (didn't bet)




PokerStars Game #59941991382:  Hold'em No Limit ($0.10/$0.25) - 2009/07/01 1:52:37 ET
Table '3EebBlzq5yHSY2444L4zlg' 9-max Seat #3 is the button
Seat 1: XMSS6mD5B42I8wasdOMipQ ($27 in chips) 
Seat 2: b9UnopCOpq2MWP1DwqSO3Q ($17.35 in chips) 
Seat 3: 18G4P1XstjNvItdGUITxgw ($25 in chips) 
Seat 4: PdIasPkzm2sqZnN41ZRXOg ($4.75 in chips) 
Seat 5: PFNLAvMkr8qKc7xCiH0wTA ($51.95 in chips) 
Seat 6: QEbIGci+itdw+re8RM5fZA ($50 in chips) 
Seat 7: DiSvPC2iudwL5j9u6Huyww ($49.60 in chips) 
Seat 8: dtZ84flFEi4Q+SGrHMJRDQ ($31.30 in chips) 
Seat 9: iZmSlSzYu5fJ67tDdQzymQ ($23.90 in chips) 
PdIasPkzm2sqZnN41ZRXOg: posts small blind $0.10
PFNLAvMkr8qKc7xCiH0wTA: posts big blind $0.25
*** HOLE CARDS ***
QEbIGci+itdw+re8RM5fZA: folds 
DiSvPC2iudwL5j9u6Huyww: folds 
dtZ84flFEi4Q+SGrHMJRDQ: raises $0.75 to $1
iZmSlSzYu5fJ67tDdQzymQ: folds 
XMSS6mD5B42I8wasdOMipQ: folds 
b9UnopCOpq2MWP1DwqSO3Q: folds 
18G4P1XstjNvItdGUITxgw: folds 
PdIasPkzm2sqZnN41ZRXOg: calls $0.90
PFNLAvMkr8qKc7xCiH0wTA: folds 
*** FLOP *** [As 6d Kh]
PdIasPkzm2sqZnN41ZRXOg: checks 
dtZ84flFEi4Q+SGrHMJRDQ: bets $1
PdIasPkzm2sqZnN41ZRXOg: calls $1
*** TURN *** [As 6d Kh] [Kd]
PdIasPkzm2sqZnN41ZRXOg: checks 
dtZ84flFEi4Q+SGrHMJRDQ: bets $1
PdIasPkzm2sqZnN41ZRXOg: calls $1
*** RIVER *** [As 6d Kh Kd] [3d]
PdIasPkzm2sqZnN41ZRXOg: bets $1.75 and is all-in
dtZ84flFEi4Q+SGrHMJRDQ: calls $1.75
*** SHOW DOWN ***
PdIasPkzm2sqZnN41ZRXOg: shows [Ad Kc] (a full house, Kings full of Aces)
dtZ84flFEi4Q+SGrHMJRDQ: shows [Ac Ks] (a full house, Kings full of Aces)
PdIasPkzm2sqZnN41ZRXOg collected $4.65 from pot
dtZ84flFEi4Q+SGrHMJRDQ collected $4.65 from pot
*** SUMMARY ***
Total pot $9.75 | Rake $0.45 
Board [As 6d Kh Kd 3d]
Seat 1: XMSS6mD5B42I8wasdOMipQ folded before Flop (didn't bet)
Seat 2: b9UnopCOpq2MWP1DwqSO3Q folded before Flop (didn't bet)
Seat 3: 18G4P1XstjNvItdGUITxgw (button) folded before Flop (didn't bet)
Seat 4: PdIasPkzm2sqZnN41ZRXOg (small blind) showed [Ad Kc] and won ($4.65) with a full house, Kings full of Aces
Seat 5: PFNLAvMkr8qKc7xCiH0wTA (big blind) folded before Flop
Seat 6: QEbIGci+itdw+re8RM5fZA folded before Flop (didn't bet)
Seat 7: DiSvPC2iudwL5j9u6Huyww folded before Flop (didn't bet)
Seat 8: dtZ84flFEi4Q+SGrHMJRDQ showed [Ac Ks] and won ($4.65) with a full house, Kings full of Aces
Seat 9: iZmSlSzYu5fJ67tDdQzymQ folded before Flop (didn't bet)




PokerStars Game #59941991214:  Hold'em No Limit ($0.10/$0.25) - 2009/07/01 1:52:37 ET
Table 'uFgIyfWPagvEVGEb86da7A' 9-max Seat #8 is the button
Seat 1: CT7Xj/V/O5rBlhtt+RZeFQ ($25.75 in chips) 
Seat 2: o3zvoO+PsqGti+1NZGNRrQ ($1.25 in chips) 
Seat 3: eGAnPT3w+iltM7HF59dzIg ($5.40 in chips) 
Seat 4: IGRfskE1v9H9Bn+fz8AgNQ ($31.95 in chips) 
Seat 5: X78b5v/uhqeXXoAijbw/yg ($28.55 in chips) 
Seat 6: zDrucyjVn5aeekNEc3cJrA ($26.75 in chips) 
Seat 7: 9zx7Mlww974uHUqoiq2eXA ($11.85 in chips) 
Seat 8: uLP/lYn7oKq9xCChBXsXxw ($24.80 in chips) 
CT7Xj/V/O5rBlhtt+RZeFQ: posts small blind $0.10
o3zvoO+PsqGti+1NZGNRrQ: posts big blind $0.25
*** HOLE CARDS ***
eGAnPT3w+iltM7HF59dzIg: folds 
Mh2r9hTeTEDnh19sRZtW3g joins the table at seat #9 
IGRfskE1v9H9Bn+fz8AgNQ: folds 
X78b5v/uhqeXXoAijbw/yg: folds 
zDrucyjVn5aeekNEc3cJrA: calls $0.25
9zx7Mlww974uHUqoiq2eXA: calls $0.25
uLP/lYn7oKq9xCChBXsXxw: folds 
CT7Xj/V/O5rBlhtt+RZeFQ: calls $0.15
o3zvoO+PsqGti+1NZGNRrQ: checks 
*** FLOP *** [Ks 7c 8s]
CT7Xj/V/O5rBlhtt+RZeFQ: checks 
o3zvoO+PsqGti+1NZGNRrQ: checks 
zDrucyjVn5aeekNEc3cJrA: checks 
9zx7Mlww974uHUqoiq2eXA: bets $0.50
CT7Xj/V/O5rBlhtt+RZeFQ: folds 
o3zvoO+PsqGti+1NZGNRrQ: folds 
zDrucyjVn5aeekNEc3cJrA: folds 
Uncalled bet ($0.50) returned to 9zx7Mlww974uHUqoiq2eXA
9zx7Mlww974uHUqoiq2eXA collected $0.95 from pot
*** SUMMARY ***
Total pot $1 | Rake $0.05 
Board [Ks 7c 8s]
Seat 1: CT7Xj/V/O5rBlhtt+RZeFQ (small blind) folded on the Flop
Seat 2: o3zvoO+PsqGti+1NZGNRrQ (big blind) folded on the Flop
Seat 3: eGAnPT3w+iltM7HF59dzIg folded before Flop (didn't bet)
Seat 4: IGRfskE1v9H9Bn+fz8AgNQ folded before Flop (didn't bet)
Seat 5: X78b5v/uhqeXXoAijbw/yg folded before Flop (didn't bet)
Seat 6: zDrucyjVn5aeekNEc3cJrA folded on the Flop
Seat 7: 9zx7Mlww974uHUqoiq2eXA collected ($0.95)
Seat 8: uLP/lYn7oKq9xCChBXsXxw (button) folded before Flop (didn't bet)




PokerStars Game #59941991732:  Hold'em No Limit ($0.10/$0.25) - 2009/07/01 1:52:38 ET
Table 'iMiAw/kTZXopgYX4HI7sHg' 9-max Seat #1 is the button
Seat 1: PdIasPkzm2sqZnN41ZRXOg ($5 in chips) 
Seat 2: qwr38jl5txoR36M7G5qi4A ($8 in chips) 
Seat 3: HPEB+AtKw1+C/cxU0o1ciw ($27.90 in chips) 
Seat 4: Z9W7+g1WMhhZDi7DwGbCFA ($7.15 in chips) 
Seat 5: 22dIObOuor/A+IKWkNoAlA ($5.45 in chips) 
Seat 6: Bb42QRQMhg5/Y0vHP8/2Xw ($28.80 in chips) 
Seat 7: ipLwYjdAXnvG54zETKPvbQ ($12.90 in chips) 
Seat 8: tLcDklc2rBORNfixyRfVfw ($28.90 in chips) 
Seat 9: fxHuzml2pBE+ABvr6emfng ($16.50 in chips) 
qwr38jl5txoR36M7G5qi4A: posts small blind $0.10
HPEB+AtKw1+C/cxU0o1ciw: posts big blind $0.25
*** HOLE CARDS ***
Z9W7+g1WMhhZDi7DwGbCFA: folds 
22dIObOuor/A+IKWkNoAlA: folds 
Bb42QRQMhg5/Y0vHP8/2Xw: folds 
ipLwYjdAXnvG54zETKPvbQ: folds 
tLcDklc2rBORNfixyRfVfw: folds 
fxHuzml2pBE+ABvr6emfng: calls $0.25
PdIasPkzm2sqZnN41ZRXOg: folds 
qwr38jl5txoR36M7G5qi4A: folds 
HPEB+AtKw1+C/cxU0o1ciw: checks 
*** FLOP *** [Td Ks Kd]
HPEB+AtKw1+C/cxU0o1ciw: checks 
fxHuzml2pBE+ABvr6emfng: bets $0.50
HPEB+AtKw1+C/cxU0o1ciw: calls $0.50
*** TURN *** [Td Ks Kd] [2d]
HPEB+AtKw1+C/cxU0o1ciw: checks 
fxHuzml2pBE+ABvr6emfng: bets $0.50
HPEB+AtKw1+C/cxU0o1ciw: calls $0.50
*** RIVER *** [Td Ks Kd 2d] [9d]
HPEB+AtKw1+C/cxU0o1ciw: checks 
fxHuzml2pBE+ABvr6emfng: checks 
*** SHOW DOWN ***
HPEB+AtKw1+C/cxU0o1ciw: shows [Jh Th] (two pair, Kings and Tens)
fxHuzml2pBE+ABvr6emfng: shows [8h Kc] (three of a kind, Kings)
fxHuzml2pBE+ABvr6emfng collected $2.50 from pot
*** SUMMARY ***
Total pot $2.60 | Rake $0.10 
Board [Td Ks Kd 2d 9d]
Seat 1: PdIasPkzm2sqZnN41ZRXOg (button) folded before Flop (didn't bet)
Seat 2: qwr38jl5txoR36M7G5qi4A (small blind) folded before Flop
Seat 3: HPEB+AtKw1+C/cxU0o1ciw (big blind) showed [Jh Th] and lost with two pair, Kings and Tens
Seat 4: Z9W7+g1WMhhZDi7DwGbCFA folded before Flop (didn't bet)
Seat 5: 22dIObOuor/A+IKWkNoAlA folded before Flop (didn't bet)
Seat 6: Bb42QRQMhg5/Y0vHP8/2Xw folded before Flop (didn't bet)
Seat 7: ipLwYjdAXnvG54zETKPvbQ folded before Flop (didn't bet)
Seat 8: tLcDklc2rBORNfixyRfVfw folded before Flop (didn't bet)
Seat 9: fxHuzml2pBE+ABvr6emfng showed [8h Kc] and won ($2.50) with three of a kind, Kings




PokerStars Game #59941991874:  Hold'em No Limit ($0.10/$0.25) - 2009/07/01 1:52:38 ET
Table 'wGizWOswEL6P5QrvVkno/g' 6-max Seat #4 is the button
Seat 1: Qbfkn+ucISvbd1Xh32zAGA ($33.60 in chips) 
Seat 2: mfrkWA3PTeYPkbO6hi98Aw ($27.40 in chips) 
Seat 3: i9LqF5rD3bvtbEE7HWgr3Q ($26.35 in chips) 
Seat 4: yF9xHMEAvA+7Gn+eDkuVIg ($2.05 in chips) 
Seat 5: w43JQj2oYPpKQVG4Yzlq1w ($25 in chips) 
Seat 6: BuAE7g7dRfuqGPmQDlGyGg ($18.75 in chips) 
w43JQj2oYPpKQVG4Yzlq1w: posts small blind $0.10
BuAE7g7dRfuqGPmQDlGyGg: posts big blind $0.25
*** HOLE CARDS ***
Qbfkn+ucISvbd1Xh32zAGA: calls $0.25
mfrkWA3PTeYPkbO6hi98Aw: folds 
i9LqF5rD3bvtbEE7HWgr3Q: raises $1 to $1.25
yF9xHMEAvA+7Gn+eDkuVIg: folds 
w43JQj2oYPpKQVG4Yzlq1w: folds 
BuAE7g7dRfuqGPmQDlGyGg: folds 
Qbfkn+ucISvbd1Xh32zAGA: folds 
Uncalled bet ($1) returned to i9LqF5rD3bvtbEE7HWgr3Q
i9LqF5rD3bvtbEE7HWgr3Q collected $0.85 from pot
i9LqF5rD3bvtbEE7HWgr3Q: doesn't show hand 
*** SUMMARY ***
Total pot $0.85 | Rake $0 
Seat 1: Qbfkn+ucISvbd1Xh32zAGA folded before Flop
Seat 2: mfrkWA3PTeYPkbO6hi98Aw folded before Flop (didn't bet)
Seat 3: i9LqF5rD3bvtbEE7HWgr3Q collected ($0.85)
Seat 4: yF9xHMEAvA+7Gn+eDkuVIg (button) folded before Flop (didn't bet)
Seat 5: w43JQj2oYPpKQVG4Yzlq1w (small blind) folded before Flop
Seat 6: BuAE7g7dRfuqGPmQDlGyGg (big blind) folded before Flop




PokerStars Game #59941992038:  Hold'em No Limit ($0.10/$0.25) - 2009/07/01 1:52:38 ET
Table 'ohAuixfiLOYDylNUG5mNUw' 9-max Seat #8 is the button
Seat 1: qwr38jl5txoR36M7G5qi4A ($10 in chips) 
Seat 2: Th3FldXKQW6hWVVPahaoOQ ($26.15 in chips) 
Seat 3: gSakoFAgDDzXSb2eNBWKcg ($16.45 in chips) 
Seat 4: clJsV3v77RS07bDKY+705w ($5 in chips) 
Seat 8: ppMlNkhYgErlt4fuJO7ADA ($5.05 in chips) 
Seat 9: CT7Xj/V/O5rBlhtt+RZeFQ ($25 in chips) 
CT7Xj/V/O5rBlhtt+RZeFQ: posts small blind $0.10
qwr38jl5txoR36M7G5qi4A: posts big blind $0.25
z5GxcHlYz/GSz6W2uFiTtg: sits out 
18G4P1XstjNvItdGUITxgw: sits out 
*** HOLE CARDS ***
Th3FldXKQW6hWVVPahaoOQ: folds 
gSakoFAgDDzXSb2eNBWKcg: folds 
clJsV3v77RS07bDKY+705w: folds 
ppMlNkhYgErlt4fuJO7ADA: calls $0.25
CT7Xj/V/O5rBlhtt+RZeFQ: folds 
qwr38jl5txoR36M7G5qi4A: checks 
*** FLOP *** [6d 4h Qh]
qwr38jl5txoR36M7G5qi4A: checks 
ppMlNkhYgErlt4fuJO7ADA: bets $0.50
qwr38jl5txoR36M7G5qi4A: folds 
Uncalled bet ($0.50) returned to ppMlNkhYgErlt4fuJO7ADA
ppMlNkhYgErlt4fuJO7ADA collected $0.60 from pot
ppMlNkhYgErlt4fuJO7ADA: doesn't show hand 
*** SUMMARY ***
Total pot $0.60 | Rake $0 
Board [6d 4h Qh]
Seat 1: qwr38jl5txoR36M7G5qi4A (big blind) folded on the Flop
Seat 2: Th3FldXKQW6hWVVPahaoOQ folded before Flop (didn't bet)
Seat 3: gSakoFAgDDzXSb2eNBWKcg folded before Flop (didn't bet)
Seat 4: clJsV3v77RS07bDKY+705w folded before Flop (didn't bet)
Seat 8: ppMlNkhYgErlt4fuJO7ADA (button) collected ($0.60)
Seat 9: CT7Xj/V/O5rBlhtt+RZeFQ (small blind) folded before Flop




PokerStars Game #59941991796:  Hold'em No Limit ($0.10/$0.25) - 2009/07/01 1:52:38 ET
Table 'ykyWGjhNu7AvZXov27T4ew' 9-max Seat #5 is the button
Seat 1: skUI2T7o4P1rz460mMbAOg ($10.25 in chips) 
Seat 2: MG90wfSJZnOejs/KD3vlQQ ($38.85 in chips) 
Seat 3: NPI9ArW8kwrb6a2IAL6xMQ ($26.25 in chips) 
Seat 4: W6tExOcYX7qiy6Qdp+ZwFA ($5.60 in chips) 
Seat 5: CmngQmkKTp8tkl6GMRTl6w ($16.30 in chips) 
Seat 6: AiXn/9o1EwOPZUHujnh/bA ($19.90 in chips) 
Seat 9: H5Se03ZqSX7tbULXur2MAg ($25 in chips) 
AiXn/9o1EwOPZUHujnh/bA: posts small blind $0.10
tYsOBqdU1+x+yFI7zHO7hQ: is sitting out 
H5Se03ZqSX7tbULXur2MAg: posts big blind $0.25
*** HOLE CARDS ***
skUI2T7o4P1rz460mMbAOg: folds 
MG90wfSJZnOejs/KD3vlQQ: folds 
NPI9ArW8kwrb6a2IAL6xMQ: folds 
W6tExOcYX7qiy6Qdp+ZwFA: raises $0.50 to $0.75
CmngQmkKTp8tkl6GMRTl6w: folds 
AiXn/9o1EwOPZUHujnh/bA: folds 
H5Se03ZqSX7tbULXur2MAg: folds 
Uncalled bet ($0.50) returned to W6tExOcYX7qiy6Qdp+ZwFA
W6tExOcYX7qiy6Qdp+ZwFA collected $0.60 from pot
W6tExOcYX7qiy6Qdp+ZwFA: doesn't show hand 
*** SUMMARY ***
Total pot $0.60 | Rake $0 
Seat 1: skUI2T7o4P1rz460mMbAOg folded before Flop (didn't bet)
Seat 2: MG90wfSJZnOejs/KD3vlQQ folded before Flop (didn't bet)
Seat 3: NPI9ArW8kwrb6a2IAL6xMQ folded before Flop (didn't bet)
Seat 4: W6tExOcYX7qiy6Qdp+ZwFA collected ($0.60)
Seat 5: CmngQmkKTp8tkl6GMRTl6w (button) folded before Flop (didn't bet)
Seat 6: AiXn/9o1EwOPZUHujnh/bA (small blind) folded before Flop
Seat 9: H5Se03ZqSX7tbULXur2MAg (big blind) folded before Flop




PokerStars Game #59941991808:  Hold'em No Limit ($0.10/$0.25) - 2009/07/01 1:52:38 ET
Table '+giHa6FUL6U5/AZnCJEGvQ' 9-max Seat #5 is the button
Seat 4: XQRLaOXTf3pRraVvFq7T1g ($5 in chips) 
Seat 5: zDrucyjVn5aeekNEc3cJrA ($44.15 in chips) 
Seat 6: GTMnTen6sQSoCpS9sggLbg ($25.25 in chips) 
GTMnTen6sQSoCpS9sggLbg: posts small blind $0.10
XQRLaOXTf3pRraVvFq7T1g: posts big blind $0.25
*** HOLE CARDS ***
zDrucyjVn5aeekNEc3cJrA: folds 
GTMnTen6sQSoCpS9sggLbg: raises $0.25 to $0.50
XQRLaOXTf3pRraVvFq7T1g: calls $0.25
*** FLOP *** [Qs 8c Kc]
GTMnTen6sQSoCpS9sggLbg: bets $0.75
XQRLaOXTf3pRraVvFq7T1g: folds 
Uncalled bet ($0.75) returned to GTMnTen6sQSoCpS9sggLbg
GTMnTen6sQSoCpS9sggLbg collected $0.95 from pot
GTMnTen6sQSoCpS9sggLbg: doesn't show hand 
*** SUMMARY ***
Total pot $1 | Rake $0.05 
Board [Qs 8c Kc]
Seat 4: XQRLaOXTf3pRraVvFq7T1g (big blind) folded on the Flop
Seat 5: zDrucyjVn5aeekNEc3cJrA (button) folded before Flop (didn't bet)
Seat 6: GTMnTen6sQSoCpS9sggLbg (small blind) collected ($0.95)




PokerStars Game #59941992612:  Hold'em No Limit ($0.10/$0.25) - 2009/07/01 1:52:39 ET
Table '5SUMWYuPsGiOD0FY0QbgOw' 6-max Seat #4 is the button
Seat 1: SFmT9ZsVopnukjvAzrxTRg ($25 in chips) 
Seat 2: xrf8tAXKQHG99HixCot1Iw ($40.60 in chips) 
Seat 3: i9LqF5rD3bvtbEE7HWgr3Q ($47.10 in chips) 
Seat 4: BV+K0Phf5VBHr7aZPKqbUQ ($25.75 in chips) 
Seat 5: v+QfkGiuj9bgtuNoVnDO8w ($40.20 in chips) 
Seat 6: /CiXFpjc64KAfloGDN7A/Q ($15 in chips) 
v+QfkGiuj9bgtuNoVnDO8w: posts small blind $0.10
/CiXFpjc64KAfloGDN7A/Q: posts big blind $0.25
*** HOLE CARDS ***
SFmT9ZsVopnukjvAzrxTRg: folds 
xrf8tAXKQHG99HixCot1Iw: folds 
SFmT9ZsVopnukjvAzrxTRg leaves the table
i9LqF5rD3bvtbEE7HWgr3Q: folds 
BV+K0Phf5VBHr7aZPKqbUQ: raises $0.50 to $0.75
v+QfkGiuj9bgtuNoVnDO8w: folds 
/CiXFpjc64KAfloGDN7A/Q: folds 
Uncalled bet ($0.50) returned to BV+K0Phf5VBHr7aZPKqbUQ
BV+K0Phf5VBHr7aZPKqbUQ collected $0.60 from pot
BV+K0Phf5VBHr7aZPKqbUQ: doesn't show hand 
*** SUMMARY ***
Total pot $0.60 | Rake $0 
Seat 1: SFmT9ZsVopnukjvAzrxTRg folded before Flop (didn't bet)
Seat 2: xrf8tAXKQHG99HixCot1Iw folded before Flop (didn't bet)
Seat 3: i9LqF5rD3bvtbEE7HWgr3Q folded before Flop (didn't bet)
Seat 4: BV+K0Phf5VBHr7aZPKqbUQ (button) collected ($0.60)
Seat 5: v+QfkGiuj9bgtuNoVnDO8w (small blind) folded before Flop
Seat 6: /CiXFpjc64KAfloGDN7A/Q (big blind) folded before Flop




PokerStars Game #59941992076:  Hold'em No Limit ($0.10/$0.25) - 2009/07/01 1:52:39 ET
Table '+VTTYgQLH1awDHk+IAxqGg' 9-max Seat #3 is the button
Seat 1: arxNSjreDRGFg13EAM2F1w ($26.55 in chips) 
Seat 2: 2wcFsZsqEP5w1StUTVzJCg ($6.05 in chips) 
Seat 3: AiXn/9o1EwOPZUHujnh/bA ($11.05 in chips) 
Seat 4: gE5rN2TDY1aXcZn/TOPeZw ($8.65 in chips) 
Seat 5: sD+TKtt36XiiN6jqHiLwDA ($29.15 in chips) 
Seat 6: clJsV3v77RS07bDKY+705w ($6.05 in chips) 
Seat 7: ljemhp25Zg+nlA9DLCIiUw ($25 in chips) 
Seat 8: 10vzP4r6ldwGLbYHKd9www ($19 in chips) 
Seat 9: S7Ki0P+0AIGPuIfGJjW0gg ($61.15 in chips) 
gE5rN2TDY1aXcZn/TOPeZw: posts small blind $0.10
sD+TKtt36XiiN6jqHiLwDA: posts big blind $0.25
*** HOLE CARDS ***
clJsV3v77RS07bDKY+705w: folds 
ljemhp25Zg+nlA9DLCIiUw: calls $0.25
10vzP4r6ldwGLbYHKd9www: calls $0.25
S7Ki0P+0AIGPuIfGJjW0gg: folds 
arxNSjreDRGFg13EAM2F1w: raises $1.25 to $1.50
2wcFsZsqEP5w1StUTVzJCg: folds 
AiXn/9o1EwOPZUHujnh/bA: folds 
gE5rN2TDY1aXcZn/TOPeZw: folds 
sD+TKtt36XiiN6jqHiLwDA: folds 
ljemhp25Zg+nlA9DLCIiUw: folds 
10vzP4r6ldwGLbYHKd9www: folds 
Uncalled bet ($1.25) returned to arxNSjreDRGFg13EAM2F1w
arxNSjreDRGFg13EAM2F1w collected $1.10 from pot
arxNSjreDRGFg13EAM2F1w: doesn't show hand 
*** SUMMARY ***
Total pot $1.10 | Rake $0 
Seat 1: arxNSjreDRGFg13EAM2F1w collected ($1.10)
Seat 2: 2wcFsZsqEP5w1StUTVzJCg folded before Flop (didn't bet)
Seat 3: AiXn/9o1EwOPZUHujnh/bA (button) folded before Flop (didn't bet)
Seat 4: gE5rN2TDY1aXcZn/TOPeZw (small blind) folded before Flop
Seat 5: sD+TKtt36XiiN6jqHiLwDA (big blind) folded before Flop
Seat 6: clJsV3v77RS07bDKY+705w folded before Flop (didn't bet)
Seat 7: ljemhp25Zg+nlA9DLCIiUw folded before Flop
Seat 8: 10vzP4r6ldwGLbYHKd9www folded before Flop
Seat 9: S7Ki0P+0AIGPuIfGJjW0gg folded before Flop (didn't bet)




PokerStars Game #59941992240:  Hold'em No Limit ($0.10/$0.25) - 2009/07/01 1:52:39 ET
Table 'l8hUTjBTXBorNUR/tyvSLw' 9-max Seat #3 is the button
Seat 1: cZ99hugmLBj9KhTlc8nCSw ($27.85 in chips) 
Seat 2: B6xHiX1SJkS0CUNCKDVwuQ ($21 in chips) 
Seat 3: ShCS62CJp4MKfKLKvGKQbA ($8.75 in chips) 
Seat 4: vPtFvcPtn/Afz0sucO1cmQ ($37.30 in chips) 
Seat 5: yyG4svzOpC1A+sUP/scg6w ($6.60 in chips) 
Seat 6: EVqHvqty1ZsuvDFiSXlSqQ ($23.95 in chips) 
Seat 7: F7pnn6czNpHvRM55XcA2EA ($33.90 in chips) 
Seat 8: Mh2r9hTeTEDnh19sRZtW3g ($4.65 in chips) 
Seat 9: zDrucyjVn5aeekNEc3cJrA ($32.95 in chips) 
vPtFvcPtn/Afz0sucO1cmQ: posts small blind $0.10
yyG4svzOpC1A+sUP/scg6w: posts big blind $0.25
*** HOLE CARDS ***
EVqHvqty1ZsuvDFiSXlSqQ: folds 
F7pnn6czNpHvRM55XcA2EA: folds 
Mh2r9hTeTEDnh19sRZtW3g: folds 
zDrucyjVn5aeekNEc3cJrA: folds 
cZ99hugmLBj9KhTlc8nCSw: folds 
B6xHiX1SJkS0CUNCKDVwuQ: folds 
ShCS62CJp4MKfKLKvGKQbA: folds 
vPtFvcPtn/Afz0sucO1cmQ: folds 
Uncalled bet ($0.15) returned to yyG4svzOpC1A+sUP/scg6w
yyG4svzOpC1A+sUP/scg6w collected $0.20 from pot
yyG4svzOpC1A+sUP/scg6w: doesn't show hand 
*** SUMMARY ***
Total pot $0.20 | Rake $0 
Seat 1: cZ99hugmLBj9KhTlc8nCSw folded before Flop (didn't bet)
Seat 2: B6xHiX1SJkS0CUNCKDVwuQ folded before Flop (didn't bet)
Seat 3: ShCS62CJp4MKfKLKvGKQbA (button) folded before Flop (didn't bet)
Seat 4: vPtFvcPtn/Afz0sucO1cmQ (small blind) folded before Flop
Seat 5: yyG4svzOpC1A+sUP/scg6w (big blind) collected ($0.20)
Seat 6: EVqHvqty1ZsuvDFiSXlSqQ folded before Flop (didn't bet)
Seat 7: F7pnn6czNpHvRM55XcA2EA folded before Flop (didn't bet)
Seat 8: Mh2r9hTeTEDnh19sRZtW3g folded before Flop (didn't bet)
Seat 9: zDrucyjVn5aeekNEc3cJrA folded before Flop (didn't bet)




PokerStars Game #59941992182:  Hold'em No Limit ($0.10/$0.25) - 2009/07/01 1:52:39 ET
Table 'by7aHYEDnDd144EXOXa/jA' 9-max Seat #9 is the button
Seat 1: j4q3p0lesp63b1gZDwLBZw ($7.40 in chips) 
Seat 3: HOEaXncFu2ij+D5/CANAZA ($13.45 in chips) 
Seat 4: 2Xwi447v1rBHM+92U0CduA ($4.15 in chips) 
Seat 5: yyG4svzOpC1A+sUP/scg6w ($3.85 in chips) 
Seat 6: sC4BsflLWW26Qm9m+1AwJQ ($9.65 in chips) 
Seat 7: Z9W7+g1WMhhZDi7DwGbCFA ($5.35 in chips) 
Seat 8: 7je+LC5Mfs6nL8YBVh4frQ ($3.35 in chips) 
Seat 9: K0b5wNInj6hUGRr6yzKFtw ($25 in chips) 
j4q3p0lesp63b1gZDwLBZw: posts small blind $0.10
vSkQm2EelzwRGDDQQk0Fqw: is sitting out 
vSkQm2EelzwRGDDQQk0Fqw leaves the table
HOEaXncFu2ij+D5/CANAZA: posts big blind $0.25
*** HOLE CARDS ***
2Xwi447v1rBHM+92U0CduA: calls $0.25
yyG4svzOpC1A+sUP/scg6w: folds 
sC4BsflLWW26Qm9m+1AwJQ: calls $0.25
Z9W7+g1WMhhZDi7DwGbCFA: folds 
7je+LC5Mfs6nL8YBVh4frQ: folds 
K0b5wNInj6hUGRr6yzKFtw: folds 
j4q3p0lesp63b1gZDwLBZw: folds 
HOEaXncFu2ij+D5/CANAZA: checks 
*** FLOP *** [Kh Td 4c]
HOEaXncFu2ij+D5/CANAZA: checks 
2Xwi447v1rBHM+92U0CduA: bets $0.25
sC4BsflLWW26Qm9m+1AwJQ: folds 
HOEaXncFu2ij+D5/CANAZA: calls $0.25
*** TURN *** [Kh Td 4c] [7h]
tom008 joins the table at seat #2 
HOEaXncFu2ij+D5/CANAZA: checks 
2Xwi447v1rBHM+92U0CduA: checks 
*** RIVER *** [Kh Td 4c 7h] [6d]
HOEaXncFu2ij+D5/CANAZA: bets $0.25
2Xwi447v1rBHM+92U0CduA: calls $0.25
*** SHOW DOWN ***
HOEaXncFu2ij+D5/CANAZA: shows [Ad 9h] (high card Ace)
2Xwi447v1rBHM+92U0CduA: shows [9s Ac] (high card Ace)
HOEaXncFu2ij+D5/CANAZA collected $0.90 from pot
2Xwi447v1rBHM+92U0CduA collected $0.90 from pot
*** SUMMARY ***
Total pot $1.85 | Rake $0.05 
Board [Kh Td 4c 7h 6d]
Seat 1: j4q3p0lesp63b1gZDwLBZw (small blind) folded before Flop
Seat 3: HOEaXncFu2ij+D5/CANAZA (big blind) showed [Ad 9h] and won ($0.90) with high card Ace
Seat 4: 2Xwi447v1rBHM+92U0CduA showed [9s Ac] and won ($0.90) with high card Ace
Seat 5: yyG4svzOpC1A+sUP/scg6w folded before Flop (didn't bet)
Seat 6: sC4BsflLWW26Qm9m+1AwJQ folded on the Flop
Seat 7: Z9W7+g1WMhhZDi7DwGbCFA folded before Flop (didn't bet)
Seat 8: 7je+LC5Mfs6nL8YBVh4frQ folded before Flop (didn't bet)
Seat 9: K0b5wNInj6hUGRr6yzKFtw (button) folded before Flop (didn't bet)




PokerStars Game #59941992608:  Hold'em No Limit ($0.10/$0.25) - 2009/07/01 1:52:39 ET
Table 'hOE09W281uSob0XeJmUcRg' 6-max Seat #6 is the button
Seat 1: mfrkWA3PTeYPkbO6hi98Aw ($27.35 in chips) 
Seat 3: y+a/yGW/Jy4bPJFnaeTz5w ($12.10 in chips) 
Seat 5: JFIAqU8lCZ0vWwEl4bdGsg ($25.80 in chips) 
Seat 6: x4ZJ8E/TUrtoB7WiHcv8WA ($18.05 in chips) 
mfrkWA3PTeYPkbO6hi98Aw: posts small blind $0.10
y+a/yGW/Jy4bPJFnaeTz5w: posts big blind $0.25
MVzl6OsGybVDNd3Vr9LYAA: sits out 
*** HOLE CARDS ***
JFIAqU8lCZ0vWwEl4bdGsg: folds 
x4ZJ8E/TUrtoB7WiHcv8WA: folds 
mfrkWA3PTeYPkbO6hi98Aw: folds 
Uncalled bet ($0.15) returned to y+a/yGW/Jy4bPJFnaeTz5w
y+a/yGW/Jy4bPJFnaeTz5w collected $0.20 from pot
y+a/yGW/Jy4bPJFnaeTz5w: doesn't show hand 
*** SUMMARY ***
Total pot $0.20 | Rake $0 
Seat 1: mfrkWA3PTeYPkbO6hi98Aw (small blind) folded before Flop
Seat 3: y+a/yGW/Jy4bPJFnaeTz5w (big blind) collected ($0.20)
Seat 5: JFIAqU8lCZ0vWwEl4bdGsg folded before Flop (didn't bet)
Seat 6: x4ZJ8E/TUrtoB7WiHcv8WA (button) folded before Flop (didn't bet)




PokerStars Game #59941992304:  Hold'em No Limit ($0.10/$0.25) - 2009/07/01 1:52:39 ET
Table '29D3eoQzK5kOAT0OIDS2uQ' 6-max Seat #1 is the button
Seat 1: kG34n23qFQA3nzdOJTQ1dA ($43.05 in chips) 
Seat 2: FyE+TQ5JcCqI/tCCHf0jGA ($16.45 in chips) 
Seat 4: 0wUowrieiZhJzm3L0SoiKA ($15 in chips) 
Seat 5: Q3EMN7b0ie81AFWkDrhCjw ($41.35 in chips) 
FyE+TQ5JcCqI/tCCHf0jGA: posts small blind $0.10
08V++DOqzaNrRNsHIwi25w joins the table at seat #3 
0wUowrieiZhJzm3L0SoiKA: posts big blind $0.25
if4dh6jhJXeN3/qd3qCp9g: sits out 
*** HOLE CARDS ***
Q3EMN7b0ie81AFWkDrhCjw: calls $0.25
kG34n23qFQA3nzdOJTQ1dA: folds 
FyE+TQ5JcCqI/tCCHf0jGA: folds 
0wUowrieiZhJzm3L0SoiKA: checks 
*** FLOP *** [Ac 8h Th]
0wUowrieiZhJzm3L0SoiKA: bets $0.50
Q3EMN7b0ie81AFWkDrhCjw: folds 
Uncalled bet ($0.50) returned to 0wUowrieiZhJzm3L0SoiKA
0wUowrieiZhJzm3L0SoiKA collected $0.60 from pot
*** SUMMARY ***
Total pot $0.60 | Rake $0 
Board [Ac 8h Th]
Seat 1: kG34n23qFQA3nzdOJTQ1dA (button) folded before Flop (didn't bet)
Seat 2: FyE+TQ5JcCqI/tCCHf0jGA (small blind) folded before Flop
Seat 4: 0wUowrieiZhJzm3L0SoiKA (big blind) collected ($0.60)
Seat 5: Q3EMN7b0ie81AFWkDrhCjw folded on the Flop




PokerStars Game #59941992648:  Hold'em No Limit ($0.10/$0.25) - 2009/07/01 1:52:40 ET
Table '2clPgY3+dETPD/8zjXZdFw' 6-max Seat #2 is the button
Seat 1: 7cx44/slbeTw+Cy7QB8Trg ($27.10 in chips) 
Seat 2: cWc85bEzdRzpUMhRKm8pwQ ($25 in chips) 
Seat 4: ljjhtb6FVPTx9AT9HNdtqg ($23.20 in chips) 
Seat 5: LJI7A1YgDM7hgh7o56+ReQ ($30.45 in chips) 
Seat 6: c3J/KYZ4cNsUEuz8v57I5A ($23.25 in chips) 
ljjhtb6FVPTx9AT9HNdtqg: posts small blind $0.10
LJI7A1YgDM7hgh7o56+ReQ: posts big blind $0.25
*** HOLE CARDS ***
c3J/KYZ4cNsUEuz8v57I5A: folds 
7cx44/slbeTw+Cy7QB8Trg: raises $0.50 to $0.75
cWc85bEzdRzpUMhRKm8pwQ: folds 
ljjhtb6FVPTx9AT9HNdtqg: folds 
LJI7A1YgDM7hgh7o56+ReQ: folds 
Uncalled bet ($0.50) returned to 7cx44/slbeTw+Cy7QB8Trg
7cx44/slbeTw+Cy7QB8Trg collected $0.60 from pot
7cx44/slbeTw+Cy7QB8Trg: doesn't show hand 
*** SUMMARY ***
Total pot $0.60 | Rake $0 
Seat 1: 7cx44/slbeTw+Cy7QB8Trg collected ($0.60)
Seat 2: cWc85bEzdRzpUMhRKm8pwQ (button) folded before Flop (didn't bet)
Seat 4: ljjhtb6FVPTx9AT9HNdtqg (small blind) folded before Flop
Seat 5: LJI7A1YgDM7hgh7o56+ReQ (big blind) folded before Flop
Seat 6: c3J/KYZ4cNsUEuz8v57I5A folded before Flop (didn't bet)




PokerStars Game #59941992634:  Hold'em No Limit ($0.10/$0.25) - 2009/07/01 1:52:40 ET
Table 'KKk6y4pAXeymxYcd0uZLqg' 9-max Seat #2 is the button
Seat 1: HPEB+AtKw1+C/cxU0o1ciw ($24.90 in chips) 
Seat 2: k55YB7uP2TAZEba6pnHYiA ($19.70 in chips) 
Seat 3: tLcDklc2rBORNfixyRfVfw ($25 in chips) 
Seat 4: 18G4P1XstjNvItdGUITxgw ($25 in chips) 
Seat 5: wGigCmBR/9XWkPpvYos3aQ ($40.70 in chips) 
Seat 6: QEbIGci+itdw+re8RM5fZA ($25 in chips) 
Seat 7: JjOuv8Vf56aiQjWi/rTPFA ($22.90 in chips) 
Seat 8: +2kMBNpY4nF1qNCRd8SJLA ($36.05 in chips) 
Seat 9: oLa/tXLfSLLB28mcLGrxcg ($25.45 in chips) 
tLcDklc2rBORNfixyRfVfw: posts small blind $0.10
18G4P1XstjNvItdGUITxgw: posts big blind $0.25
*** HOLE CARDS ***
wGigCmBR/9XWkPpvYos3aQ: folds 
QEbIGci+itdw+re8RM5fZA: folds 
JjOuv8Vf56aiQjWi/rTPFA: folds 
+2kMBNpY4nF1qNCRd8SJLA: raises $0.75 to $1
oLa/tXLfSLLB28mcLGrxcg: folds 
HPEB+AtKw1+C/cxU0o1ciw: folds 
k55YB7uP2TAZEba6pnHYiA: folds 
tLcDklc2rBORNfixyRfVfw: folds 
18G4P1XstjNvItdGUITxgw: folds 
Uncalled bet ($0.75) returned to +2kMBNpY4nF1qNCRd8SJLA
+2kMBNpY4nF1qNCRd8SJLA collected $0.60 from pot
+2kMBNpY4nF1qNCRd8SJLA: doesn't show hand 
*** SUMMARY ***
Total pot $0.60 | Rake $0 
Seat 1: HPEB+AtKw1+C/cxU0o1ciw folded before Flop (didn't bet)
Seat 2: k55YB7uP2TAZEba6pnHYiA (button) folded before Flop (didn't bet)
Seat 3: tLcDklc2rBORNfixyRfVfw (small blind) folded before Flop
Seat 4: 18G4P1XstjNvItdGUITxgw (big blind) folded before Flop
Seat 5: wGigCmBR/9XWkPpvYos3aQ folded before Flop (didn't bet)
Seat 6: QEbIGci+itdw+re8RM5fZA folded before Flop (didn't bet)
Seat 7: JjOuv8Vf56aiQjWi/rTPFA folded before Flop (didn't bet)
Seat 8: +2kMBNpY4nF1qNCRd8SJLA collected ($0.60)
Seat 9: oLa/tXLfSLLB28mcLGrxcg folded before Flop (didn't bet)




PokerStars Game #59941992846:  Hold'em No Limit ($0.10/$0.25) - 2009/07/01 1:52:40 ET
Table 'Qr+t8WGovMECkBv+cV1lrg' 6-max Seat #2 is the button
Seat 1: EeUZtMU058v2ObUACOF4Og ($34.45 in chips) 
Seat 2: vqWjZmdQu/Hxw96/IJTWdQ ($41.25 in chips) 
Seat 3: uZKkrGByYgd4/ZBX2d4z+w ($19.85 in chips) 
Seat 4: 1NNFfYMd5Hsphl/FYz9fNA ($61.40 in chips) 
Seat 5: I50OxuNg9riRq9sywF6jMQ ($4.65 in chips) 
Seat 6: 9U3ZKjCsarN0DjR6mSE8Ug ($14 in chips) 
uZKkrGByYgd4/ZBX2d4z+w: posts small blind $0.10
1NNFfYMd5Hsphl/FYz9fNA: posts big blind $0.25
*** HOLE CARDS ***
I50OxuNg9riRq9sywF6jMQ: calls $0.25
9U3ZKjCsarN0DjR6mSE8Ug: folds 
EeUZtMU058v2ObUACOF4Og: calls $0.25
vqWjZmdQu/Hxw96/IJTWdQ: folds 
uZKkrGByYgd4/ZBX2d4z+w: calls $0.15
1NNFfYMd5Hsphl/FYz9fNA: checks 
*** FLOP *** [Th Ks 4d]
uZKkrGByYgd4/ZBX2d4z+w: checks 
1NNFfYMd5Hsphl/FYz9fNA: checks 
I50OxuNg9riRq9sywF6jMQ: bets $0.50
EeUZtMU058v2ObUACOF4Og: calls $0.50
uZKkrGByYgd4/ZBX2d4z+w: folds 
1NNFfYMd5Hsphl/FYz9fNA: folds 
*** TURN *** [Th Ks 4d] [Ts]
I50OxuNg9riRq9sywF6jMQ: checks 
EeUZtMU058v2ObUACOF4Og: checks 
*** RIVER *** [Th Ks 4d Ts] [6h]
I50OxuNg9riRq9sywF6jMQ: checks 
EeUZtMU058v2ObUACOF4Og: bets $33.70 and is all-in
I50OxuNg9riRq9sywF6jMQ: folds 
Uncalled bet ($33.70) returned to EeUZtMU058v2ObUACOF4Og
EeUZtMU058v2ObUACOF4Og collected $1.95 from pot
EeUZtMU058v2ObUACOF4Og: doesn't show hand 
*** SUMMARY ***
Total pot $2 | Rake $0.05 
Board [Th Ks 4d Ts 6h]
Seat 1: EeUZtMU058v2ObUACOF4Og collected ($1.95)
Seat 2: vqWjZmdQu/Hxw96/IJTWdQ (button) folded before Flop (didn't bet)
Seat 3: uZKkrGByYgd4/ZBX2d4z+w (small blind) folded on the Flop
Seat 4: 1NNFfYMd5Hsphl/FYz9fNA (big blind) folded on the Flop
Seat 5: I50OxuNg9riRq9sywF6jMQ folded on the River
Seat 6: 9U3ZKjCsarN0DjR6mSE8Ug folded before Flop (didn't bet)




PokerStars Game #59941992640:  Hold'em No Limit ($0.10/$0.25) - 2009/07/01 1:52:40 ET
Table 'v+LTGPWbrLum+Ggd4ef6lg' 9-max Seat #9 is the button
Seat 2: clJsV3v77RS07bDKY+705w ($5.10 in chips) 
Seat 3: 7ovWM9c1nQLTFritEGRG/A ($3.10 in chips) 
Seat 5: +8OkYWUhGfkDbAtQl/ovYQ ($23.15 in chips) 
Seat 7: kUxTO3D2eQcx4oJIpJAK4Q ($8.25 in chips) 
Seat 8: +sbyWwIcFp9kP0bDtMegfQ ($37.20 in chips) 
Seat 9: cZ99hugmLBj9KhTlc8nCSw ($27.60 in chips) 
clJsV3v77RS07bDKY+705w: posts small blind $0.10
7ovWM9c1nQLTFritEGRG/A: posts big blind $0.25
yqkowiRWZ6NvRN9UUkYIlA: sits out 
*** HOLE CARDS ***
+8OkYWUhGfkDbAtQl/ovYQ: raises $0.50 to $0.75
kUxTO3D2eQcx4oJIpJAK4Q: folds 
+sbyWwIcFp9kP0bDtMegfQ: folds 
cZ99hugmLBj9KhTlc8nCSw: folds 
clJsV3v77RS07bDKY+705w: folds 
7ovWM9c1nQLTFritEGRG/A: folds 
Uncalled bet ($0.50) returned to +8OkYWUhGfkDbAtQl/ovYQ
+8OkYWUhGfkDbAtQl/ovYQ collected $0.60 from pot
+8OkYWUhGfkDbAtQl/ovYQ: doesn't show hand 
*** SUMMARY ***
Total pot $0.60 | Rake $0 
Seat 2: clJsV3v77RS07bDKY+705w (small blind) folded before Flop
Seat 3: 7ovWM9c1nQLTFritEGRG/A (big blind) folded before Flop
Seat 5: +8OkYWUhGfkDbAtQl/ovYQ collected ($0.60)
Seat 7: kUxTO3D2eQcx4oJIpJAK4Q folded before Flop (didn't bet)
Seat 8: +sbyWwIcFp9kP0bDtMegfQ folded before Flop (didn't bet)
Seat 9: cZ99hugmLBj9KhTlc8nCSw (button) folded before Flop (didn't bet)




PokerStars Game #59941993464:  Hold'em No Limit ($0.10/$0.25) - 2009/07/01 1:52:41 ET
Table 'oJpFwZj9+FUGHX90Un8s9Q' 6-max Seat #4 is the button
Seat 1: 6DwBRH+xZ12AAZmeAg+aXw ($25.50 in chips) 
Seat 2: NtrVQ9UIql0rDCnKDKZ5FQ ($19.65 in chips) 
Seat 3: kyRaCIljYA6l33lSKQfNsg ($24.90 in chips) 
Seat 4: 6elpmfyt4Zw0yvd8lePSMQ ($21.90 in chips) 
Seat 5: kG34n23qFQA3nzdOJTQ1dA ($58.80 in chips) 
Seat 6: 7LpHJVeM6k1mQdC6HXYzww ($25 in chips) 
kG34n23qFQA3nzdOJTQ1dA: posts small blind $0.10
7LpHJVeM6k1mQdC6HXYzww: posts big blind $0.25
*** HOLE CARDS ***
6DwBRH+xZ12AAZmeAg+aXw: folds 
NtrVQ9UIql0rDCnKDKZ5FQ: calls $0.25
kyRaCIljYA6l33lSKQfNsg: raises $0.50 to $0.75
6elpmfyt4Zw0yvd8lePSMQ: folds 
kG34n23qFQA3nzdOJTQ1dA: folds 
7LpHJVeM6k1mQdC6HXYzww: folds 
NtrVQ9UIql0rDCnKDKZ5FQ: calls $0.50
*** FLOP *** [2c 7h 9s]
NtrVQ9UIql0rDCnKDKZ5FQ: checks 
kyRaCIljYA6l33lSKQfNsg: bets $0.25
NtrVQ9UIql0rDCnKDKZ5FQ: calls $0.25
*** TURN *** [2c 7h 9s] [8s]
NtrVQ9UIql0rDCnKDKZ5FQ: checks 
kyRaCIljYA6l33lSKQfNsg: checks 
*** RIVER *** [2c 7h 9s 8s] [4c]
NtrVQ9UIql0rDCnKDKZ5FQ: checks 
kyRaCIljYA6l33lSKQfNsg: bets $1.75
NtrVQ9UIql0rDCnKDKZ5FQ: calls $1.75
*** SHOW DOWN ***
kyRaCIljYA6l33lSKQfNsg: shows [Ad 7d] (a pair of Sevens)
NtrVQ9UIql0rDCnKDKZ5FQ: shows [9d Ts] (a pair of Nines)
NtrVQ9UIql0rDCnKDKZ5FQ collected $5.60 from pot
*** SUMMARY ***
Total pot $5.85 | Rake $0.25 
Board [2c 7h 9s 8s 4c]
Seat 1: 6DwBRH+xZ12AAZmeAg+aXw folded before Flop (didn't bet)
Seat 2: NtrVQ9UIql0rDCnKDKZ5FQ showed [9d Ts] and won ($5.60) with a pair of Nines
Seat 3: kyRaCIljYA6l33lSKQfNsg showed [Ad 7d] and lost with a pair of Sevens
Seat 4: 6elpmfyt4Zw0yvd8lePSMQ (button) folded before Flop (didn't bet)
Seat 5: kG34n23qFQA3nzdOJTQ1dA (small blind) folded before Flop
Seat 6: 7LpHJVeM6k1mQdC6HXYzww (big blind) folded before Flop




PokerStars Game #59941993222:  Hold'em No Limit ($0.10/$0.25) - 2009/07/01 1:52:41 ET
Table 'x7YStLKc8hpt/pTgSetPKA' 9-max Seat #3 is the button
Seat 2: z5GxcHlYz/GSz6W2uFiTtg ($19.75 in chips) 
Seat 3: S7Ki0P+0AIGPuIfGJjW0gg ($10.75 in chips) 
Seat 5: tLcDklc2rBORNfixyRfVfw ($25 in chips) 
Seat 6: 9YN2IkT2JYYKFErZtZvCtA ($49.60 in chips) 
Seat 7: dtZ84flFEi4Q+SGrHMJRDQ ($25 in chips) 
Seat 8: j4q3p0lesp63b1gZDwLBZw ($5.50 in chips) 
Seat 9: nm4Dj/f+jJEwKVsUnKh73g ($37.55 in chips) 
tLcDklc2rBORNfixyRfVfw: posts small blind $0.10
9YN2IkT2JYYKFErZtZvCtA: posts big blind $0.25
satchmoiluvu: sits out 
*** HOLE CARDS ***
dtZ84flFEi4Q+SGrHMJRDQ: folds 
j4q3p0lesp63b1gZDwLBZw: folds 
nm4Dj/f+jJEwKVsUnKh73g: folds 
z5GxcHlYz/GSz6W2uFiTtg: folds 
S7Ki0P+0AIGPuIfGJjW0gg: calls $0.25
tLcDklc2rBORNfixyRfVfw: folds 
9YN2IkT2JYYKFErZtZvCtA: checks 
*** FLOP *** [3d Ad As]
9YN2IkT2JYYKFErZtZvCtA: bets $0.50
S7Ki0P+0AIGPuIfGJjW0gg: calls $0.50
*** TURN *** [3d Ad As] [Ah]
9YN2IkT2JYYKFErZtZvCtA: bets $1
S7Ki0P+0AIGPuIfGJjW0gg: folds 
Uncalled bet ($1) returned to 9YN2IkT2JYYKFErZtZvCtA
9YN2IkT2JYYKFErZtZvCtA collected $1.55 from pot
9YN2IkT2JYYKFErZtZvCtA: doesn't show hand 
*** SUMMARY ***
Total pot $1.60 | Rake $0.05 
Board [3d Ad As Ah]
Seat 2: z5GxcHlYz/GSz6W2uFiTtg folded before Flop (didn't bet)
Seat 3: S7Ki0P+0AIGPuIfGJjW0gg (button) folded on the Turn
Seat 5: tLcDklc2rBORNfixyRfVfw (small blind) folded before Flop
Seat 6: 9YN2IkT2JYYKFErZtZvCtA (big blind) collected ($1.55)
Seat 7: dtZ84flFEi4Q+SGrHMJRDQ folded before Flop (didn't bet)
Seat 8: j4q3p0lesp63b1gZDwLBZw folded before Flop (didn't bet)
Seat 9: nm4Dj/f+jJEwKVsUnKh73g folded before Flop (didn't bet)




PokerStars Game #59941993486:  Hold'em No Limit ($0.10/$0.25) - 2009/07/01 1:52:41 ET
Table '0w9m+UkNlGMNoPyQqzWk6A' 9-max Seat #9 is the button
Seat 1: 18G4P1XstjNvItdGUITxgw ($25 in chips) 
Seat 3: VWwtMkIjXloiX/RKh7RGWQ ($10.05 in chips) 
Seat 5: HPEB+AtKw1+C/cxU0o1ciw ($46.30 in chips) 
Seat 6: CgIo2ItZqi4o3ayVG6HanQ ($26.95 in chips) 
Seat 7: 57qrNGHDvf6GhB8zVLsAtQ ($4.10 in chips) 
Seat 8: cZ99hugmLBj9KhTlc8nCSw ($25 in chips) 
Seat 9: KqS/lY/fNB9qUxokm9QfeA ($14.10 in chips) 
18G4P1XstjNvItdGUITxgw: posts small blind $0.10
M1nKET7WOTLbVPuAbJa3EA: is sitting out 
VWwtMkIjXloiX/RKh7RGWQ: posts big blind $0.25
z5GxcHlYz/GSz6W2uFiTtg: sits out 
*** HOLE CARDS ***
HPEB+AtKw1+C/cxU0o1ciw: folds 
CgIo2ItZqi4o3ayVG6HanQ: folds 
57qrNGHDvf6GhB8zVLsAtQ: raises $0.50 to $0.75
cZ99hugmLBj9KhTlc8nCSw: folds 
M1nKET7WOTLbVPuAbJa3EA has returned
KqS/lY/fNB9qUxokm9QfeA: folds 
18G4P1XstjNvItdGUITxgw: folds 
VWwtMkIjXloiX/RKh7RGWQ: calls $0.50
*** FLOP *** [2h 7d Tc]
VWwtMkIjXloiX/RKh7RGWQ: checks 
57qrNGHDvf6GhB8zVLsAtQ: bets $1
VWwtMkIjXloiX/RKh7RGWQ: calls $1
*** TURN *** [2h 7d Tc] [Js]
VWwtMkIjXloiX/RKh7RGWQ: checks 
57qrNGHDvf6GhB8zVLsAtQ: bets $1
VWwtMkIjXloiX/RKh7RGWQ: raises $1.50 to $2.50
57qrNGHDvf6GhB8zVLsAtQ: calls $1.35 and is all-in
Uncalled bet ($0.15) returned to VWwtMkIjXloiX/RKh7RGWQ
*** RIVER *** [2h 7d Tc Js] [3d]
*** SHOW DOWN ***
VWwtMkIjXloiX/RKh7RGWQ: shows [Jc 2c] (two pair, Jacks and Deuces)
57qrNGHDvf6GhB8zVLsAtQ: mucks hand 
VWwtMkIjXloiX/RKh7RGWQ collected $7.90 from pot
*** SUMMARY ***
Total pot $8.30 | Rake $0.40 
Board [2h 7d Tc Js 3d]
Seat 1: 18G4P1XstjNvItdGUITxgw (small blind) folded before Flop
Seat 3: VWwtMkIjXloiX/RKh7RGWQ (big blind) showed [Jc 2c] and won ($7.90) with two pair, Jacks and Deuces
Seat 5: HPEB+AtKw1+C/cxU0o1ciw folded before Flop (didn't bet)
Seat 6: CgIo2ItZqi4o3ayVG6HanQ folded before Flop (didn't bet)
Seat 7: 57qrNGHDvf6GhB8zVLsAtQ mucked
Seat 8: cZ99hugmLBj9KhTlc8nCSw folded before Flop (didn't bet)
Seat 9: KqS/lY/fNB9qUxokm9QfeA (button) folded before Flop (didn't bet)




PokerStars Game #59941993358:  Hold'em No Limit ($0.10/$0.25) - 2009/07/01 1:52:41 ET
Table 'pgrBYaOEx/BuqK5iAtlFzw' 9-max Seat #7 is the button
Seat 1: 6O+8t5ikoK+pNiFXnN/Fyw ($17.10 in chips) 
Seat 2: 2Xwi447v1rBHM+92U0CduA ($7.20 in chips) 
Seat 3: Bb42QRQMhg5/Y0vHP8/2Xw ($25 in chips) 
Seat 4: oLa/tXLfSLLB28mcLGrxcg ($23.90 in chips) 
Seat 5: BWzInv8o0kN1pJybv/VjpQ ($24.85 in chips) 
Seat 6: eubS00Znk+qsx0B0+7/Zow ($20.45 in chips) 
Seat 7: eK8qa6EPcH2zhtbmWSvc9g ($25 in chips) 
Seat 8: tLcDklc2rBORNfixyRfVfw ($27.55 in chips) 
Seat 9: Z9W7+g1WMhhZDi7DwGbCFA ($5 in chips) 
tLcDklc2rBORNfixyRfVfw: posts small blind $0.10
Z9W7+g1WMhhZDi7DwGbCFA: posts big blind $0.25
*** HOLE CARDS ***
6O+8t5ikoK+pNiFXnN/Fyw: folds 
2Xwi447v1rBHM+92U0CduA: folds 
Bb42QRQMhg5/Y0vHP8/2Xw: folds 
oLa/tXLfSLLB28mcLGrxcg: folds 
BWzInv8o0kN1pJybv/VjpQ: folds 
eubS00Znk+qsx0B0+7/Zow: calls $0.25
eK8qa6EPcH2zhtbmWSvc9g: folds 
tLcDklc2rBORNfixyRfVfw: folds 
Z9W7+g1WMhhZDi7DwGbCFA: checks 
*** FLOP *** [Jh Ah Qd]
Z9W7+g1WMhhZDi7DwGbCFA: bets $0.25
eubS00Znk+qsx0B0+7/Zow: calls $0.25
*** TURN *** [Jh Ah Qd] [5c]
Z9W7+g1WMhhZDi7DwGbCFA: bets $0.25
eubS00Znk+qsx0B0+7/Zow: calls $0.25
*** RIVER *** [Jh Ah Qd 5c] [7s]
Z9W7+g1WMhhZDi7DwGbCFA: checks 
eubS00Znk+qsx0B0+7/Zow: checks 
*** SHOW DOWN ***
Z9W7+g1WMhhZDi7DwGbCFA: shows [2h Th] (high card Ace)
eubS00Znk+qsx0B0+7/Zow: shows [8c Kh] (high card Ace - King kicker)
eubS00Znk+qsx0B0+7/Zow collected $1.55 from pot
*** SUMMARY ***
Total pot $1.60 | Rake $0.05 
Board [Jh Ah Qd 5c 7s]
Seat 1: 6O+8t5ikoK+pNiFXnN/Fyw folded before Flop (didn't bet)
Seat 2: 2Xwi447v1rBHM+92U0CduA folded before Flop (didn't bet)
Seat 3: Bb42QRQMhg5/Y0vHP8/2Xw folded before Flop (didn't bet)
Seat 4: oLa/tXLfSLLB28mcLGrxcg folded before Flop (didn't bet)
Seat 5: BWzInv8o0kN1pJybv/VjpQ folded before Flop (didn't bet)
Seat 6: eubS00Znk+qsx0B0+7/Zow showed [8c Kh] and won ($1.55) with high card Ace
Seat 7: eK8qa6EPcH2zhtbmWSvc9g (button) folded before Flop (didn't bet)
Seat 8: tLcDklc2rBORNfixyRfVfw (small blind) folded before Flop
Seat 9: Z9W7+g1WMhhZDi7DwGbCFA (big blind) showed [2h Th] and lost with high card Ace




PokerStars Game #59941993224:  Hold'em No Limit ($0.10/$0.25) - 2009/07/01 1:52:41 ET
Table 'RUOqTfzbAVGS5x+J9aZMHA' 9-max Seat #2 is the button
Seat 1: DnDcAdn9P0zGovMERigpFA ($28.30 in chips) 
Seat 2: Z5ZtGOON8kmSdSCll9Z3XA ($11.30 in chips) 
Seat 3: Th3FldXKQW6hWVVPahaoOQ ($25 in chips) 
Seat 4: K9Az8li/CO2TicltVWKamA ($21.25 in chips) 
Seat 5: MtVtHDqIJTyUcXkRBBDIVA ($33.55 in chips) 
Seat 6: ljemhp25Zg+nlA9DLCIiUw ($48 in chips) 
Seat 7: zgi+EUykT/pZQpoUG6+oEg ($5 in chips) 
Seat 9: cZ99hugmLBj9KhTlc8nCSw ($25 in chips) 
Th3FldXKQW6hWVVPahaoOQ: posts small blind $0.10
K9Az8li/CO2TicltVWKamA: posts big blind $0.25
*** HOLE CARDS ***
MtVtHDqIJTyUcXkRBBDIVA: folds 
ljemhp25Zg+nlA9DLCIiUw: folds 
zgi+EUykT/pZQpoUG6+oEg: folds 
cZ99hugmLBj9KhTlc8nCSw: folds 
DnDcAdn9P0zGovMERigpFA: raises $0.75 to $1
Z5ZtGOON8kmSdSCll9Z3XA: folds 
Th3FldXKQW6hWVVPahaoOQ: folds 
K9Az8li/CO2TicltVWKamA: folds 
Uncalled bet ($0.75) returned to DnDcAdn9P0zGovMERigpFA
DnDcAdn9P0zGovMERigpFA collected $0.60 from pot
DnDcAdn9P0zGovMERigpFA: doesn't show hand 
*** SUMMARY ***
Total pot $0.60 | Rake $0 
Seat 1: DnDcAdn9P0zGovMERigpFA collected ($0.60)
Seat 2: Z5ZtGOON8kmSdSCll9Z3XA (button) folded before Flop (didn't bet)
Seat 3: Th3FldXKQW6hWVVPahaoOQ (small blind) folded before Flop
Seat 4: K9Az8li/CO2TicltVWKamA (big blind) folded before Flop
Seat 5: MtVtHDqIJTyUcXkRBBDIVA folded before Flop (didn't bet)
Seat 6: ljemhp25Zg+nlA9DLCIiUw folded before Flop (didn't bet)
Seat 7: zgi+EUykT/pZQpoUG6+oEg folded before Flop (didn't bet)
Seat 9: cZ99hugmLBj9KhTlc8nCSw folded before Flop (didn't bet)




PokerStars Game #59941993300:  Hold'em No Limit ($0.10/$0.25) - 2009/07/01 1:52:41 ET
Table 'b64Z+5XI1xkQzNfq4QHr3A' 6-max Seat #3 is the button
Seat 2: A6SjYLoKeIpFjPq0BK/2WA ($13.65 in chips) 
Seat 3: 7cx44/slbeTw+Cy7QB8Trg ($24.55 in chips) 
Seat 4: 564zqq2DUHXR3tdsOJU6JA ($17.10 in chips) 
Seat 5: 08V++DOqzaNrRNsHIwi25w ($25 in chips) 
Seat 6: 8ClCHtFXGNplITm+63KB+Q ($31.15 in chips) 
564zqq2DUHXR3tdsOJU6JA: posts small blind $0.10
08V++DOqzaNrRNsHIwi25w: posts big blind $0.25
32YL2ZEp8NT4JB2RVM9euQ: sits out 
*** HOLE CARDS ***
8ClCHtFXGNplITm+63KB+Q: folds 
A6SjYLoKeIpFjPq0BK/2WA: calls $0.25
7cx44/slbeTw+Cy7QB8Trg: folds 
564zqq2DUHXR3tdsOJU6JA is disconnected 
564zqq2DUHXR3tdsOJU6JA has timed out while disconnected
564zqq2DUHXR3tdsOJU6JA: folds 
564zqq2DUHXR3tdsOJU6JA is sitting out
08V++DOqzaNrRNsHIwi25w: raises $1 to $1.25
A6SjYLoKeIpFjPq0BK/2WA: folds 
Uncalled bet ($1) returned to 08V++DOqzaNrRNsHIwi25w
08V++DOqzaNrRNsHIwi25w collected $0.60 from pot
08V++DOqzaNrRNsHIwi25w: doesn't show hand 
*** SUMMARY ***
Total pot $0.60 | Rake $0 
Seat 2: A6SjYLoKeIpFjPq0BK/2WA folded before Flop
Seat 3: 7cx44/slbeTw+Cy7QB8Trg (button) folded before Flop (didn't bet)
Seat 4: 564zqq2DUHXR3tdsOJU6JA (small blind) folded before Flop
Seat 5: 08V++DOqzaNrRNsHIwi25w (big blind) collected ($0.60)
Seat 6: 8ClCHtFXGNplITm+63KB+Q folded before Flop (didn't bet)




PokerStars Game #59941993732:  Hold'em No Limit ($0.10/$0.25) - 2009/07/01 1:52:42 ET
Table 'Utmw+yX+E/wdhNDIim90lQ' 9-max Seat #1 is the button
Seat 1: cZ99hugmLBj9KhTlc8nCSw ($31.60 in chips) 
Seat 2: iGMlK+EhUflPB6jKQd95Cg ($27.10 in chips) 
Seat 3: dfNim92Z6XK1/h5SFW5vDg ($25 in chips) 
Seat 5: ghNKXUBl/H+t83JF079ZBA ($26.60 in chips) 
Seat 6: OlPJsgR4xypSg/w1z7Gyvw ($33.15 in chips) 
Seat 7: CImUHesK+ZER4v/VCA9IUg ($48.80 in chips) 
Seat 8: Mh2r9hTeTEDnh19sRZtW3g ($4.65 in chips) 
Seat 9: Th3FldXKQW6hWVVPahaoOQ ($27.15 in chips) 
iGMlK+EhUflPB6jKQd95Cg: posts small blind $0.10
dfNim92Z6XK1/h5SFW5vDg: posts big blind $0.25
bXpVeaSTPBFSPJmeXxO7nw: sits out 
*** HOLE CARDS ***
ghNKXUBl/H+t83JF079ZBA: folds 
OlPJsgR4xypSg/w1z7Gyvw: calls $0.25
CImUHesK+ZER4v/VCA9IUg: folds 
Mh2r9hTeTEDnh19sRZtW3g: folds 
Th3FldXKQW6hWVVPahaoOQ: folds 
cZ99hugmLBj9KhTlc8nCSw: folds 
iGMlK+EhUflPB6jKQd95Cg: folds 
dfNim92Z6XK1/h5SFW5vDg: checks 
*** FLOP *** [4c 8h 7s]
dfNim92Z6XK1/h5SFW5vDg: checks 
OlPJsgR4xypSg/w1z7Gyvw: bets $0.50
dfNim92Z6XK1/h5SFW5vDg: folds 
Uncalled bet ($0.50) returned to OlPJsgR4xypSg/w1z7Gyvw
OlPJsgR4xypSg/w1z7Gyvw collected $0.60 from pot
*** SUMMARY ***
Total pot $0.60 | Rake $0 
Board [4c 8h 7s]
Seat 1: cZ99hugmLBj9KhTlc8nCSw (button) folded before Flop (didn't bet)
Seat 2: iGMlK+EhUflPB6jKQd95Cg (small blind) folded before Flop
Seat 3: dfNim92Z6XK1/h5SFW5vDg (big blind) folded on the Flop
Seat 5: ghNKXUBl/H+t83JF079ZBA folded before Flop (didn't bet)
Seat 6: OlPJsgR4xypSg/w1z7Gyvw collected ($0.60)
Seat 7: CImUHesK+ZER4v/VCA9IUg folded before Flop (didn't bet)
Seat 8: Mh2r9hTeTEDnh19sRZtW3g folded before Flop (didn't bet)
Seat 9: Th3FldXKQW6hWVVPahaoOQ folded before Flop (didn't bet)




PokerStars Game #59941993688:  Hold'em No Limit ($0.10/$0.25) - 2009/07/01 1:52:42 ET
Table 'QegsWX65l3n/K0A8XB78yg' 6-max Seat #5 is the button
Seat 1: p6adJRMXMBLr+xtQzqazIQ ($12 in chips) 
Seat 2: GC/9yVD59DUCX7hUI7gcLw ($55.50 in chips) 
Seat 4: epAUIB7h2FJXzUPRIvSkRA ($30.75 in chips) 
Seat 5: QqiZLFrN8iOUT/GHw7ztOA ($26.35 in chips) 
Seat 6: 5PWs02z65jSO5pr/M6wx/w ($13.80 in chips) 
5PWs02z65jSO5pr/M6wx/w: posts small blind $0.10
p6adJRMXMBLr+xtQzqazIQ: posts big blind $0.25
*** HOLE CARDS ***
iIgNoBh+3/Ix1/fLsg+HuA leaves the table
GC/9yVD59DUCX7hUI7gcLw: raises $0.75 to $1
epAUIB7h2FJXzUPRIvSkRA: folds 
QqiZLFrN8iOUT/GHw7ztOA: folds 
5PWs02z65jSO5pr/M6wx/w: folds 
p6adJRMXMBLr+xtQzqazIQ: folds 
Uncalled bet ($0.75) returned to GC/9yVD59DUCX7hUI7gcLw
GC/9yVD59DUCX7hUI7gcLw collected $0.60 from pot
*** SUMMARY ***
Total pot $0.60 | Rake $0 
Seat 1: p6adJRMXMBLr+xtQzqazIQ (big blind) folded before Flop
Seat 2: GC/9yVD59DUCX7hUI7gcLw collected ($0.60)
Seat 4: epAUIB7h2FJXzUPRIvSkRA folded before Flop (didn't bet)
Seat 5: QqiZLFrN8iOUT/GHw7ztOA (button) folded before Flop (didn't bet)
Seat 6: 5PWs02z65jSO5pr/M6wx/w (small blind) folded before Flop




PokerStars Game #59941994098:  Hold'em No Limit ($0.10/$0.25) - 2009/07/01 1:52:42 ET
Table 'ER5H84HUgJx7HyDLnELLeA' 6-max Seat #1 is the button
Seat 1: LJI7A1YgDM7hgh7o56+ReQ ($25.90 in chips) 
Seat 3: cS21pIxRHx5Gt42o7hPZzw ($12.75 in chips) 
Seat 4: vqWjZmdQu/Hxw96/IJTWdQ ($25.35 in chips) 
Seat 5: mfrkWA3PTeYPkbO6hi98Aw ($26.20 in chips) 
Seat 6: 3zD3qLXT1bEffAoWGnc7wg ($52.05 in chips) 
cS21pIxRHx5Gt42o7hPZzw: posts small blind $0.10
vqWjZmdQu/Hxw96/IJTWdQ: posts big blind $0.25
*** HOLE CARDS ***
mfrkWA3PTeYPkbO6hi98Aw: folds 
3zD3qLXT1bEffAoWGnc7wg: raises $0.50 to $0.75
LJI7A1YgDM7hgh7o56+ReQ: folds 
cS21pIxRHx5Gt42o7hPZzw: folds 
vqWjZmdQu/Hxw96/IJTWdQ: folds 
Uncalled bet ($0.50) returned to 3zD3qLXT1bEffAoWGnc7wg
3zD3qLXT1bEffAoWGnc7wg collected $0.60 from pot
3zD3qLXT1bEffAoWGnc7wg: doesn't show hand 
*** SUMMARY ***
Total pot $0.60 | Rake $0 
Seat 1: LJI7A1YgDM7hgh7o56+ReQ (button) folded before Flop (didn't bet)
Seat 3: cS21pIxRHx5Gt42o7hPZzw (small blind) folded before Flop
Seat 4: vqWjZmdQu/Hxw96/IJTWdQ (big blind) folded before Flop
Seat 5: mfrkWA3PTeYPkbO6hi98Aw folded before Flop (didn't bet)
Seat 6: 3zD3qLXT1bEffAoWGnc7wg collected ($0.60)




PokerStars Game #59941993976:  Hold'em No Limit ($0.10/$0.25) - 2009/07/01 1:52:42 ET
Table 'yAHDCs33TIgw3ra63xuU2Q' 9-max Seat #1 is the button
Seat 1: Z9AeOQX3yzuSvKAm/xyovg ($8 in chips) 
Seat 2: j4q3p0lesp63b1gZDwLBZw ($5.35 in chips) 
Seat 4: j5spkbnOCRiLGiH6iqBaqw ($16.45 in chips) 
Seat 5: 4awUyiDYTgylQKXZ9faBVA ($36.25 in chips) 
Seat 6: UXvybU2w7Zc8RP8R+ngNeg ($10 in chips) 
j4q3p0lesp63b1gZDwLBZw: posts small blind $0.10
j5spkbnOCRiLGiH6iqBaqw: posts big blind $0.25
UXvybU2w7Zc8RP8R+ngNeg: posts big blind $0.25
*** HOLE CARDS ***
4awUyiDYTgylQKXZ9faBVA: folds 
UXvybU2w7Zc8RP8R+ngNeg: checks 
Z9AeOQX3yzuSvKAm/xyovg: raises $0.75 to $1
j4q3p0lesp63b1gZDwLBZw: folds 
j5spkbnOCRiLGiH6iqBaqw: folds 
UXvybU2w7Zc8RP8R+ngNeg: folds 
Uncalled bet ($0.75) returned to Z9AeOQX3yzuSvKAm/xyovg
Z9AeOQX3yzuSvKAm/xyovg collected $0.85 from pot
*** SUMMARY ***
Total pot $0.85 | Rake $0 
Seat 1: Z9AeOQX3yzuSvKAm/xyovg (button) collected ($0.85)
Seat 2: j4q3p0lesp63b1gZDwLBZw (small blind) folded before Flop
Seat 4: j5spkbnOCRiLGiH6iqBaqw (big blind) folded before Flop
Seat 5: 4awUyiDYTgylQKXZ9faBVA folded before Flop (didn't bet)
Seat 6: UXvybU2w7Zc8RP8R+ngNeg folded before Flop




PokerStars Game #59941993796:  Hold'em No Limit ($0.10/$0.25) - 2009/07/01 1:52:42 ET
Table 'FBhJjLqab11/gKu8nyB/tw' 9-max Seat #6 is the button
Seat 1: +sbyWwIcFp9kP0bDtMegfQ ($18.30 in chips) 
Seat 3: V6p0jQ/RhUsqpHLmXvEX4Q ($12.35 in chips) 
Seat 4: CvL9Ch1HYCVbTsfpNucitg ($5.15 in chips) 
Seat 5: Mh2r9hTeTEDnh19sRZtW3g ($5 in chips) 
Seat 6: cZ99hugmLBj9KhTlc8nCSw ($31.35 in chips) 
Seat 7: CT7Xj/V/O5rBlhtt+RZeFQ ($25.35 in chips) 
Seat 8: Th3FldXKQW6hWVVPahaoOQ ($27 in chips) 
CT7Xj/V/O5rBlhtt+RZeFQ: posts small blind $0.10
Th3FldXKQW6hWVVPahaoOQ: posts big blind $0.25
H5Se03ZqSX7tbULXur2MAg: sits out 
18G4P1XstjNvItdGUITxgw: sits out 
*** HOLE CARDS ***
+sbyWwIcFp9kP0bDtMegfQ: folds 
V6p0jQ/RhUsqpHLmXvEX4Q: folds 
CvL9Ch1HYCVbTsfpNucitg: folds 
Mh2r9hTeTEDnh19sRZtW3g: raises $0.50 to $0.75
cZ99hugmLBj9KhTlc8nCSw: folds 
CT7Xj/V/O5rBlhtt+RZeFQ: folds 
Th3FldXKQW6hWVVPahaoOQ: folds 
Uncalled bet ($0.50) returned to Mh2r9hTeTEDnh19sRZtW3g
Mh2r9hTeTEDnh19sRZtW3g collected $0.60 from pot
Mh2r9hTeTEDnh19sRZtW3g: doesn't show hand 
*** SUMMARY ***
Total pot $0.60 | Rake $0 
Seat 1: +sbyWwIcFp9kP0bDtMegfQ folded before Flop (didn't bet)
Seat 3: V6p0jQ/RhUsqpHLmXvEX4Q folded before Flop (didn't bet)
Seat 4: CvL9Ch1HYCVbTsfpNucitg folded before Flop (didn't bet)
Seat 5: Mh2r9hTeTEDnh19sRZtW3g collected ($0.60)
Seat 6: cZ99hugmLBj9KhTlc8nCSw (button) folded before Flop (didn't bet)
Seat 7: CT7Xj/V/O5rBlhtt+RZeFQ (small blind) folded before Flop
Seat 8: Th3FldXKQW6hWVVPahaoOQ (big blind) folded before Flop




PokerStars Game #59941993918:  Hold'em No Limit ($0.10/$0.25) - 2009/07/01 1:52:42 ET
Table 'LG9H161ZAHDkOww+ih3Ptg' 6-max Seat #6 is the button
Seat 1: vEZ/HxVuyR6kaq0BtZoUgQ ($9.75 in chips) 
Seat 2: kwsRmpZ1ZaLooISs+zfyKg ($34.70 in chips) 
Seat 3: 5Evvx7UYqXTBuvIc/9s/hA ($14.95 in chips) 
Seat 4: 0C28L4/59aRNtHoBhqTcLg ($57.30 in chips) 
Seat 5: IDpUHu4U5YRh06nKQqhY8g ($9.90 in chips) 
Seat 6: v8m8XHovI5tqEA9mvplDSw ($24.50 in chips) 
vEZ/HxVuyR6kaq0BtZoUgQ: posts small blind $0.10
kwsRmpZ1ZaLooISs+zfyKg: posts big blind $0.25
*** HOLE CARDS ***
5Evvx7UYqXTBuvIc/9s/hA: folds 
0C28L4/59aRNtHoBhqTcLg: folds 
IDpUHu4U5YRh06nKQqhY8g: raises $0.50 to $0.75
v8m8XHovI5tqEA9mvplDSw: folds 
vEZ/HxVuyR6kaq0BtZoUgQ: folds 
kwsRmpZ1ZaLooISs+zfyKg: folds 
Uncalled bet ($0.50) returned to IDpUHu4U5YRh06nKQqhY8g
IDpUHu4U5YRh06nKQqhY8g collected $0.60 from pot
IDpUHu4U5YRh06nKQqhY8g: doesn't show hand 
*** SUMMARY ***
Total pot $0.60 | Rake $0 
Seat 1: vEZ/HxVuyR6kaq0BtZoUgQ (small blind) folded before Flop
Seat 2: kwsRmpZ1ZaLooISs+zfyKg (big blind) folded before Flop
Seat 3: 5Evvx7UYqXTBuvIc/9s/hA folded before Flop (didn't bet)
Seat 4: 0C28L4/59aRNtHoBhqTcLg folded before Flop (didn't bet)
Seat 5: IDpUHu4U5YRh06nKQqhY8g collected ($0.60)
Seat 6: v8m8XHovI5tqEA9mvplDSw (button) folded before Flop (didn't bet)




PokerStars Game #59941994178:  Hold'em No Limit ($0.10/$0.25) - 2009/07/01 1:52:43 ET
Table 'Do4nrTNDYpK3sQjwFxX+Og' 6-max Seat #5 is the button
Seat 1: 7JrQNOR9wRBxq9ijFhWieg ($36.90 in chips) 
Seat 2: tzMoGl9F0PUr5NibYueeSw ($71.15 in chips) 
Seat 3: TSmua8tGK3sTbwi0ynrW9Q ($25 in chips) 
Seat 4: cWc85bEzdRzpUMhRKm8pwQ ($32.70 in chips) 
Seat 5: SxIIgwXYLkwd6m3wLyPTCw ($25.25 in chips) 
Seat 6: lBoEwOFgzcERLIRUkUoRTw ($23.95 in chips) 
lBoEwOFgzcERLIRUkUoRTw: posts small blind $0.10
7JrQNOR9wRBxq9ijFhWieg: posts big blind $0.25
*** HOLE CARDS ***
tzMoGl9F0PUr5NibYueeSw: calls $0.25
TSmua8tGK3sTbwi0ynrW9Q: folds 
cWc85bEzdRzpUMhRKm8pwQ: folds 
SxIIgwXYLkwd6m3wLyPTCw: folds 
tzMoGl9F0PUr5NibYueeSw said, "last hand"
lBoEwOFgzcERLIRUkUoRTw: folds 
7JrQNOR9wRBxq9ijFhWieg: raises $0.50 to $0.75
tzMoGl9F0PUr5NibYueeSw: calls $0.50
*** FLOP *** [3c Qc Kd]
7JrQNOR9wRBxq9ijFhWieg: bets $1
tzMoGl9F0PUr5NibYueeSw: raises $1 to $2
7JrQNOR9wRBxq9ijFhWieg said, "won't pay off"
7JrQNOR9wRBxq9ijFhWieg: folds 
Uncalled bet ($1) returned to tzMoGl9F0PUr5NibYueeSw
tzMoGl9F0PUr5NibYueeSw collected $3.45 from pot
tzMoGl9F0PUr5NibYueeSw is sitting out
tzMoGl9F0PUr5NibYueeSw: shows [8c Ac] (high card Ace)
*** SUMMARY ***
Total pot $3.60 | Rake $0.15 
Board [3c Qc Kd]
Seat 1: 7JrQNOR9wRBxq9ijFhWieg (big blind) folded on the Flop
Seat 2: tzMoGl9F0PUr5NibYueeSw collected ($3.45)
Seat 3: TSmua8tGK3sTbwi0ynrW9Q folded before Flop (didn't bet)
Seat 4: cWc85bEzdRzpUMhRKm8pwQ folded before Flop (didn't bet)
Seat 5: SxIIgwXYLkwd6m3wLyPTCw (button) folded before Flop (didn't bet)
Seat 6: lBoEwOFgzcERLIRUkUoRTw (small blind) folded before Flop




PokerStars Game #59941994252:  Hold'em No Limit ($0.10/$0.25) - 2009/07/01 1:52:43 ET
Table 'ggwTHpIC5qhhHJSYjK1XCw' 6-max Seat #4 is the button
Seat 1: QkldTZNd6k/x09xKp/8lIw ($4.75 in chips) 
Seat 2: /gJNBeCkWL4o85/jvlZ4BA ($25 in chips) 
Seat 3: 7cx44/slbeTw+Cy7QB8Trg ($26.20 in chips) 
Seat 4: JFIAqU8lCZ0vWwEl4bdGsg ($26.15 in chips) 
Seat 5: BvqhBa7W/To51LhEiIU/lw ($6.85 in chips) 
Seat 6: 732E3Iz0geWMK40ej+U9HA ($9.05 in chips) 
BvqhBa7W/To51LhEiIU/lw: posts small blind $0.10
732E3Iz0geWMK40ej+U9HA: posts big blind $0.25
*** HOLE CARDS ***
QkldTZNd6k/x09xKp/8lIw: raises $0.25 to $0.50
/gJNBeCkWL4o85/jvlZ4BA: folds 
7cx44/slbeTw+Cy7QB8Trg: folds 
JFIAqU8lCZ0vWwEl4bdGsg: folds 
BvqhBa7W/To51LhEiIU/lw: calls $0.40
732E3Iz0geWMK40ej+U9HA: calls $0.25
*** FLOP *** [5s 6h Jd]
BvqhBa7W/To51LhEiIU/lw: bets $0.25
732E3Iz0geWMK40ej+U9HA: folds 
QkldTZNd6k/x09xKp/8lIw: calls $0.25
*** TURN *** [5s 6h Jd] [8c]
BvqhBa7W/To51LhEiIU/lw: bets $0.25
QkldTZNd6k/x09xKp/8lIw: calls $0.25
*** RIVER *** [5s 6h Jd 8c] [9h]
BvqhBa7W/To51LhEiIU/lw: bets $0.25
QkldTZNd6k/x09xKp/8lIw: calls $0.25
*** SHOW DOWN ***
BvqhBa7W/To51LhEiIU/lw: shows [6d 9d] (two pair, Nines and Sixes)
QkldTZNd6k/x09xKp/8lIw: mucks hand 
BvqhBa7W/To51LhEiIU/lw collected $2.90 from pot
*** SUMMARY ***
Total pot $3 | Rake $0.10 
Board [5s 6h Jd 8c 9h]
Seat 1: QkldTZNd6k/x09xKp/8lIw mucked
Seat 2: /gJNBeCkWL4o85/jvlZ4BA folded before Flop (didn't bet)
Seat 3: 7cx44/slbeTw+Cy7QB8Trg folded before Flop (didn't bet)
Seat 4: JFIAqU8lCZ0vWwEl4bdGsg (button) folded before Flop (didn't bet)
Seat 5: BvqhBa7W/To51LhEiIU/lw (small blind) showed [6d 9d] and won ($2.90) with two pair, Nines and Sixes
Seat 6: 732E3Iz0geWMK40ej+U9HA (big blind) folded on the Flop




PokerStars Game #59941994478:  Hold'em No Limit ($0.10/$0.25) - 2009/07/01 1:52:43 ET
Table 'JJzUs04lHpXg6nboT1/jeg' 6-max Seat #5 is the button
Seat 1: vEZ/HxVuyR6kaq0BtZoUgQ ($9.25 in chips) 
Seat 2: jxfR29d+dK/7h7s3SvCk+g ($11.60 in chips) 
Seat 3: 4zXbHDe39qNX46dAo81b4w ($9.25 in chips) 
Seat 4: 7cx44/slbeTw+Cy7QB8Trg ($24.30 in chips) 
Seat 5: FDWzjQgBA5K04jOIY/j22w ($4.75 in chips) 
Seat 6: bDKopKTvPi3W+PEnYUX3tg ($24.75 in chips) 
bDKopKTvPi3W+PEnYUX3tg: posts small blind $0.10
vEZ/HxVuyR6kaq0BtZoUgQ: posts big blind $0.25
*** HOLE CARDS ***
jxfR29d+dK/7h7s3SvCk+g: raises $0.25 to $0.50
4zXbHDe39qNX46dAo81b4w: raises $0.50 to $1
7cx44/slbeTw+Cy7QB8Trg: folds 
FDWzjQgBA5K04jOIY/j22w: folds 
bDKopKTvPi3W+PEnYUX3tg: folds 
vEZ/HxVuyR6kaq0BtZoUgQ: folds 
jxfR29d+dK/7h7s3SvCk+g: calls $0.50
*** FLOP *** [Jh Ks 2s]
jxfR29d+dK/7h7s3SvCk+g: bets $0.75
4zXbHDe39qNX46dAo81b4w: calls $0.75
*** TURN *** [Jh Ks 2s] [5c]
jxfR29d+dK/7h7s3SvCk+g: bets $0.75
4zXbHDe39qNX46dAo81b4w: calls $0.75
*** RIVER *** [Jh Ks 2s 5c] [4c]
jxfR29d+dK/7h7s3SvCk+g: bets $1.25
4zXbHDe39qNX46dAo81b4w: folds 
Uncalled bet ($1.25) returned to jxfR29d+dK/7h7s3SvCk+g
jxfR29d+dK/7h7s3SvCk+g collected $5.10 from pot
*** SUMMARY ***
Total pot $5.35 | Rake $0.25 
Board [Jh Ks 2s 5c 4c]
Seat 1: vEZ/HxVuyR6kaq0BtZoUgQ (big blind) folded before Flop
Seat 2: jxfR29d+dK/7h7s3SvCk+g collected ($5.10)
Seat 3: 4zXbHDe39qNX46dAo81b4w folded on the River
Seat 4: 7cx44/slbeTw+Cy7QB8Trg folded before Flop (didn't bet)
Seat 5: FDWzjQgBA5K04jOIY/j22w (button) folded before Flop (didn't bet)
Seat 6: bDKopKTvPi3W+PEnYUX3tg (small blind) folded before Flop




PokerStars Game #59941994440:  Hold'em No Limit ($0.10/$0.25) - 2009/07/01 1:52:43 ET
Table '+UzantPJ4smVdrh+4GTu1w' 6-max Seat #6 is the button
Seat 1: TSmua8tGK3sTbwi0ynrW9Q ($39.25 in chips) 
Seat 2: tcbEu7VzyHQ+0lh+skbQhQ ($29.75 in chips) 
Seat 3: SS/yfeArhULzIcOPe8MdPg ($32.65 in chips) 
Seat 4: UmcUp27+PbgBItv3ZNlAWQ ($26.45 in chips) 
Seat 5: cj4VBQya7HtVL2zCGd5jLQ ($55.35 in chips) 
Seat 6: fZQg9veL7Dd/Z04ZTjC+wQ ($26.40 in chips) 
TSmua8tGK3sTbwi0ynrW9Q: posts small blind $0.10
tcbEu7VzyHQ+0lh+skbQhQ: posts big blind $0.25
*** HOLE CARDS ***
SS/yfeArhULzIcOPe8MdPg: folds 
UmcUp27+PbgBItv3ZNlAWQ: folds 
cj4VBQya7HtVL2zCGd5jLQ: folds 
fZQg9veL7Dd/Z04ZTjC+wQ: folds 
TSmua8tGK3sTbwi0ynrW9Q: folds 
Uncalled bet ($0.15) returned to tcbEu7VzyHQ+0lh+skbQhQ
tcbEu7VzyHQ+0lh+skbQhQ collected $0.20 from pot
*** SUMMARY ***
Total pot $0.20 | Rake $0 
Seat 1: TSmua8tGK3sTbwi0ynrW9Q (small blind) folded before Flop
Seat 2: tcbEu7VzyHQ+0lh+skbQhQ (big blind) collected ($0.20)
Seat 3: SS/yfeArhULzIcOPe8MdPg folded before Flop (didn't bet)
Seat 4: UmcUp27+PbgBItv3ZNlAWQ folded before Flop (didn't bet)
Seat 5: cj4VBQya7HtVL2zCGd5jLQ folded before Flop (didn't bet)
Seat 6: fZQg9veL7Dd/Z04ZTjC+wQ (button) folded before Flop (didn't bet)




PokerStars Game #59941994304:  Hold'em No Limit ($0.10/$0.25) - 2009/07/01 1:52:43 ET
Table 'xkqAWQFDrFt4p81M8UsoNw' 9-max Seat #6 is the button
Seat 1: tLcDklc2rBORNfixyRfVfw ($28.60 in chips) 
Seat 3: xHZZRLAaFUIC8WWI8ljOJA ($21.40 in chips) 
Seat 4: wGigCmBR/9XWkPpvYos3aQ ($25 in chips) 
Seat 5: H5Se03ZqSX7tbULXur2MAg ($27.05 in chips) 
Seat 6: 6RiVTYll/5D8zICp0MRpKw ($24.65 in chips) 
Seat 7: MG90wfSJZnOejs/KD3vlQQ ($44.65 in chips) 
Seat 8: MaqsqnOOkbNuPf4oWvOtnA ($45.20 in chips) 
Seat 9: Z9AeOQX3yzuSvKAm/xyovg ($7.55 in chips) 
MG90wfSJZnOejs/KD3vlQQ: posts small blind $0.10
MaqsqnOOkbNuPf4oWvOtnA: posts big blind $0.25
z5GxcHlYz/GSz6W2uFiTtg: sits out 
*** HOLE CARDS ***
Z9AeOQX3yzuSvKAm/xyovg: folds 
tLcDklc2rBORNfixyRfVfw: folds 
xHZZRLAaFUIC8WWI8ljOJA: calls $0.25
wGigCmBR/9XWkPpvYos3aQ: folds 
H5Se03ZqSX7tbULXur2MAg: calls $0.25
6RiVTYll/5D8zICp0MRpKw: folds 
MG90wfSJZnOejs/KD3vlQQ: folds 
MaqsqnOOkbNuPf4oWvOtnA: checks 
*** FLOP *** [4d 6h 9s]
MaqsqnOOkbNuPf4oWvOtnA: checks 
xHZZRLAaFUIC8WWI8ljOJA: checks 
H5Se03ZqSX7tbULXur2MAg: bets $0.75
MaqsqnOOkbNuPf4oWvOtnA: calls $0.75
xHZZRLAaFUIC8WWI8ljOJA: calls $0.75
*** TURN *** [4d 6h 9s] [Kd]
MaqsqnOOkbNuPf4oWvOtnA: checks 
xHZZRLAaFUIC8WWI8ljOJA: checks 
H5Se03ZqSX7tbULXur2MAg: checks 
*** RIVER *** [4d 6h 9s Kd] [8c]
MaqsqnOOkbNuPf4oWvOtnA: bets $2
xHZZRLAaFUIC8WWI8ljOJA: folds 
H5Se03ZqSX7tbULXur2MAg: folds 
Uncalled bet ($2) returned to MaqsqnOOkbNuPf4oWvOtnA
MaqsqnOOkbNuPf4oWvOtnA collected $2.95 from pot
*** SUMMARY ***
Total pot $3.10 | Rake $0.15 
Board [4d 6h 9s Kd 8c]
Seat 1: tLcDklc2rBORNfixyRfVfw folded before Flop (didn't bet)
Seat 3: xHZZRLAaFUIC8WWI8ljOJA folded on the River
Seat 4: wGigCmBR/9XWkPpvYos3aQ folded before Flop (didn't bet)
Seat 5: H5Se03ZqSX7tbULXur2MAg folded on the River
Seat 6: 6RiVTYll/5D8zICp0MRpKw (button) folded before Flop (didn't bet)
Seat 7: MG90wfSJZnOejs/KD3vlQQ (small blind) folded before Flop
Seat 8: MaqsqnOOkbNuPf4oWvOtnA (big blind) collected ($2.95)
Seat 9: Z9AeOQX3yzuSvKAm/xyovg folded before Flop (didn't bet)




PokerStars Game #59941994276:  Hold'em No Limit ($0.10/$0.25) - 2009/07/01 1:52:43 ET
Table 'IdXp6nyeW4FYaEK4qKCnwQ' 9-max Seat #8 is the button
Seat 1: tLcDklc2rBORNfixyRfVfw ($25 in chips) 
Seat 2: HPEB+AtKw1+C/cxU0o1ciw ($30.50 in chips) 
Seat 4: j4q3p0lesp63b1gZDwLBZw ($5 in chips) 
Seat 5: nAWaA+gDUSWOad+I9mKUEg ($9.20 in chips) 
Seat 6: arxNSjreDRGFg13EAM2F1w ($30.85 in chips) 
Seat 7: w1ukf8uPa4+WH561TtVRxA ($36.90 in chips) 
Seat 8: dtZ84flFEi4Q+SGrHMJRDQ ($29.40 in chips) 
Seat 9: s2xLPOl/vhl/26apJ3vsOQ ($28.85 in chips) 
s2xLPOl/vhl/26apJ3vsOQ: posts small blind $0.10
tLcDklc2rBORNfixyRfVfw: posts big blind $0.25
JqeaikMej6KsqTKmUhl2Lw: sits out 
*** HOLE CARDS ***
HPEB+AtKw1+C/cxU0o1ciw: folds 
j4q3p0lesp63b1gZDwLBZw: folds 
nAWaA+gDUSWOad+I9mKUEg: calls $0.25
arxNSjreDRGFg13EAM2F1w: folds 
w1ukf8uPa4+WH561TtVRxA: raises $1 to $1.25
dtZ84flFEi4Q+SGrHMJRDQ: folds 
s2xLPOl/vhl/26apJ3vsOQ: folds 
tLcDklc2rBORNfixyRfVfw: folds 
nAWaA+gDUSWOad+I9mKUEg: folds 
Uncalled bet ($1) returned to w1ukf8uPa4+WH561TtVRxA
w1ukf8uPa4+WH561TtVRxA collected $0.85 from pot
w1ukf8uPa4+WH561TtVRxA: doesn't show hand 
*** SUMMARY ***
Total pot $0.85 | Rake $0 
Seat 1: tLcDklc2rBORNfixyRfVfw (big blind) folded before Flop
Seat 2: HPEB+AtKw1+C/cxU0o1ciw folded before Flop (didn't bet)
Seat 4: j4q3p0lesp63b1gZDwLBZw folded before Flop (didn't bet)
Seat 5: nAWaA+gDUSWOad+I9mKUEg folded before Flop
Seat 6: arxNSjreDRGFg13EAM2F1w folded before Flop (didn't bet)
Seat 7: w1ukf8uPa4+WH561TtVRxA collected ($0.85)
Seat 8: dtZ84flFEi4Q+SGrHMJRDQ (button) folded before Flop (didn't bet)
Seat 9: s2xLPOl/vhl/26apJ3vsOQ (small blind) folded before Flop




PokerStars Game #59941994572:  Hold'em No Limit ($0.10/$0.25) - 2009/07/01 1:52:43 ET
Table 'zhqgUUprOJ14VxKxPHcT/Q' 9-max Seat #3 is the button
Seat 1: 22dIObOuor/A+IKWkNoAlA ($5.50 in chips) 
Seat 2: GY095KWhBevJ1Ttvl8WseA ($14.10 in chips) 
Seat 3: 4XHsdGnQ76EBdBvsrSs8bA ($22.95 in chips) 
Seat 4: wGigCmBR/9XWkPpvYos3aQ ($33.20 in chips) 
Seat 5: +sbyWwIcFp9kP0bDtMegfQ ($31 in chips) 
Seat 6: PdIasPkzm2sqZnN41ZRXOg ($5 in chips) 
Seat 8: EQXHDnIzAsORnIXRNtXRlA ($29.50 in chips) 
Seat 9: CGjLyv/AvljZy2g76nYkzQ ($25.50 in chips) 
wGigCmBR/9XWkPpvYos3aQ: posts small blind $0.10
+sbyWwIcFp9kP0bDtMegfQ: posts big blind $0.25
bXpVeaSTPBFSPJmeXxO7nw: sits out 
*** HOLE CARDS ***
PdIasPkzm2sqZnN41ZRXOg: folds 
EQXHDnIzAsORnIXRNtXRlA: folds 
CGjLyv/AvljZy2g76nYkzQ: folds 
22dIObOuor/A+IKWkNoAlA: folds 
GY095KWhBevJ1Ttvl8WseA: calls $0.25
4XHsdGnQ76EBdBvsrSs8bA: raises $0.50 to $0.75
wGigCmBR/9XWkPpvYos3aQ: calls $0.65
+sbyWwIcFp9kP0bDtMegfQ: folds 
GY095KWhBevJ1Ttvl8WseA: calls $0.50
*** FLOP *** [2h Ks Ts]
wGigCmBR/9XWkPpvYos3aQ: checks 
GY095KWhBevJ1Ttvl8WseA: bets $0.75
4XHsdGnQ76EBdBvsrSs8bA: calls $0.75
wGigCmBR/9XWkPpvYos3aQ: folds 
*** TURN *** [2h Ks Ts] [7d]
GY095KWhBevJ1Ttvl8WseA: bets $1
4XHsdGnQ76EBdBvsrSs8bA: calls $1
*** RIVER *** [2h Ks Ts 7d] [6d]
GY095KWhBevJ1Ttvl8WseA: checks 
4XHsdGnQ76EBdBvsrSs8bA: checks 
*** SHOW DOWN ***
GY095KWhBevJ1Ttvl8WseA: shows [Kh 8c] (a pair of Kings)
4XHsdGnQ76EBdBvsrSs8bA: mucks hand 
GY095KWhBevJ1Ttvl8WseA collected $5.75 from pot
*** SUMMARY ***
Total pot $6 | Rake $0.25 
Board [2h Ks Ts 7d 6d]
Seat 1: 22dIObOuor/A+IKWkNoAlA folded before Flop (didn't bet)
Seat 2: GY095KWhBevJ1Ttvl8WseA showed [Kh 8c] and won ($5.75) with a pair of Kings
Seat 3: 4XHsdGnQ76EBdBvsrSs8bA (button) mucked
Seat 4: wGigCmBR/9XWkPpvYos3aQ (small blind) folded on the Flop
Seat 5: +sbyWwIcFp9kP0bDtMegfQ (big blind) folded before Flop
Seat 6: PdIasPkzm2sqZnN41ZRXOg folded before Flop (didn't bet)
Seat 8: EQXHDnIzAsORnIXRNtXRlA folded before Flop (didn't bet)
Seat 9: CGjLyv/AvljZy2g76nYkzQ folded before Flop (didn't bet)




PokerStars Game #59941995018:  Hold'em No Limit ($0.10/$0.25) - 2009/07/01 1:52:44 ET
Table 'jdhJTJjFq2KTttwJcd+7nQ' 6-max Seat #4 is the button
Seat 1: LtASJ9OlkqGrrUKGQlpGAw ($26.15 in chips) 
Seat 3: vqWjZmdQu/Hxw96/IJTWdQ ($30.20 in chips) 
Seat 4: vx7FwRcelVSsvNYAdp/z0A ($5.20 in chips) 
Seat 5: BV+K0Phf5VBHr7aZPKqbUQ ($31.05 in chips) 
Seat 6: yb6rnd48JuBccThV68VHAQ ($15.75 in chips) 
BV+K0Phf5VBHr7aZPKqbUQ: posts small blind $0.10
yb6rnd48JuBccThV68VHAQ: posts big blind $0.25
*** HOLE CARDS ***
LtASJ9OlkqGrrUKGQlpGAw: folds 
vqWjZmdQu/Hxw96/IJTWdQ: folds 
vx7FwRcelVSsvNYAdp/z0A: folds 
BV+K0Phf5VBHr7aZPKqbUQ: folds 
Uncalled bet ($0.15) returned to yb6rnd48JuBccThV68VHAQ
yb6rnd48JuBccThV68VHAQ collected $0.20 from pot
yb6rnd48JuBccThV68VHAQ: doesn't show hand 
*** SUMMARY ***
Total pot $0.20 | Rake $0 
Seat 1: LtASJ9OlkqGrrUKGQlpGAw folded before Flop (didn't bet)
Seat 3: vqWjZmdQu/Hxw96/IJTWdQ folded before Flop (didn't bet)
Seat 4: vx7FwRcelVSsvNYAdp/z0A (button) folded before Flop (didn't bet)
Seat 5: BV+K0Phf5VBHr7aZPKqbUQ (small blind) folded before Flop
Seat 6: yb6rnd48JuBccThV68VHAQ (big blind) collected ($0.20)




PokerStars Game #59941994744:  Hold'em No Limit ($0.10/$0.25) - 2009/07/01 1:52:44 ET
Table 'NtEQAxCeIK2io1CGtW658g' 6-max Seat #3 is the button
Seat 2: DgyznDqq/mLiCqQGMzc+Aw ($8.05 in chips) 
Seat 3: 5nwDw10uIM0XEyLhla0oGA ($36.60 in chips) 
Seat 4: 8296 ($15.40 in chips) 
Seat 5: MgAtgQuaEEshtfbhCfs+bA ($15 in chips) 
Seat 6: /gJNBeCkWL4o85/jvlZ4BA ($71.05 in chips) 
8296: posts small blind $0.10
MgAtgQuaEEshtfbhCfs+bA: posts big blind $0.25
*** HOLE CARDS ***
/gJNBeCkWL4o85/jvlZ4BA: folds 
DgyznDqq/mLiCqQGMzc+Aw: folds 
5nwDw10uIM0XEyLhla0oGA: folds 
8296: calls $0.15
MgAtgQuaEEshtfbhCfs+bA: checks 
*** FLOP *** [6d Jh 5h]
8296: checks 
MgAtgQuaEEshtfbhCfs+bA: checks 
*** TURN *** [6d Jh 5h] [4d]
8296: bets $0.50
MgAtgQuaEEshtfbhCfs+bA: calls $0.50
*** RIVER *** [6d Jh 5h 4d] [9c]
8296: checks 
MgAtgQuaEEshtfbhCfs+bA: checks 
*** SHOW DOWN ***
8296: shows [Qh Ah] (high card Ace)
MgAtgQuaEEshtfbhCfs+bA: mucks hand 
8296 collected $1.45 from pot
*** SUMMARY ***
Total pot $1.50 | Rake $0.05 
Board [6d Jh 5h 4d 9c]
Seat 2: DgyznDqq/mLiCqQGMzc+Aw folded before Flop (didn't bet)
Seat 3: 5nwDw10uIM0XEyLhla0oGA (button) folded before Flop (didn't bet)
Seat 4: 8296 (small blind) showed [Qh Ah] and won ($1.45) with high card Ace
Seat 5: MgAtgQuaEEshtfbhCfs+bA (big blind) mucked
Seat 6: /gJNBeCkWL4o85/jvlZ4BA folded before Flop (didn't bet)




PokerStars Game #59941994724:  Hold'em No Limit ($0.10/$0.25) - 2009/07/01 1:52:44 ET
Table 'luMgmRPIo47e7iXDlheIwA' 6-max Seat #1 is the button
Seat 1: EQ3WxdGe/KZrM6Lx4T02sg ($37.30 in chips) 
Seat 2: NhUN/JpAprdJeamFBgJH1w ($25 in chips) 
Seat 3: w43JQj2oYPpKQVG4Yzlq1w ($29.10 in chips) 
Seat 4: xrf8tAXKQHG99HixCot1Iw ($25.90 in chips) 
Seat 5: cWc85bEzdRzpUMhRKm8pwQ ($44.90 in chips) 
Seat 6: qGHGf/553gQnDoklMRe3tg ($26.80 in chips) 
NhUN/JpAprdJeamFBgJH1w: posts small blind $0.10
w43JQj2oYPpKQVG4Yzlq1w: posts big blind $0.25
*** HOLE CARDS ***
xrf8tAXKQHG99HixCot1Iw: folds 
cWc85bEzdRzpUMhRKm8pwQ: folds 
qGHGf/553gQnDoklMRe3tg: folds 
EQ3WxdGe/KZrM6Lx4T02sg: calls $0.25
NhUN/JpAprdJeamFBgJH1w: calls $0.15
w43JQj2oYPpKQVG4Yzlq1w: checks 
*** FLOP *** [8h 3d 2c]
NhUN/JpAprdJeamFBgJH1w: checks 
w43JQj2oYPpKQVG4Yzlq1w: checks 
EQ3WxdGe/KZrM6Lx4T02sg: bets $0.25
NhUN/JpAprdJeamFBgJH1w: calls $0.25
w43JQj2oYPpKQVG4Yzlq1w: folds 
*** TURN *** [8h 3d 2c] [Jc]
NhUN/JpAprdJeamFBgJH1w: checks 
EQ3WxdGe/KZrM6Lx4T02sg: bets $0.25
NhUN/JpAprdJeamFBgJH1w: calls $0.25
*** RIVER *** [8h 3d 2c Jc] [9d]
NhUN/JpAprdJeamFBgJH1w: checks 
EQ3WxdGe/KZrM6Lx4T02sg: bets $0.25
NhUN/JpAprdJeamFBgJH1w: folds 
Uncalled bet ($0.25) returned to EQ3WxdGe/KZrM6Lx4T02sg
EQ3WxdGe/KZrM6Lx4T02sg collected $1.70 from pot
*** SUMMARY ***
Total pot $1.75 | Rake $0.05 
Board [8h 3d 2c Jc 9d]
Seat 1: EQ3WxdGe/KZrM6Lx4T02sg (button) collected ($1.70)
Seat 2: NhUN/JpAprdJeamFBgJH1w (small blind) folded on the River
Seat 3: w43JQj2oYPpKQVG4Yzlq1w (big blind) folded on the Flop
Seat 4: xrf8tAXKQHG99HixCot1Iw folded before Flop (didn't bet)
Seat 5: cWc85bEzdRzpUMhRKm8pwQ folded before Flop (didn't bet)
Seat 6: qGHGf/553gQnDoklMRe3tg folded before Flop (didn't bet)




PokerStars Game #59941994842:  Hold'em No Limit ($0.10/$0.25) - 2009/07/01 1:52:44 ET
Table '6wawJ+MkkvuC3coG6r+Yhg' 6-max Seat #5 is the button
Seat 1: JQZew0FjzS19kTjeNtrE+A ($30.15 in chips) 
Seat 2: LtASJ9OlkqGrrUKGQlpGAw ($20.85 in chips) 
Seat 3: 3zD3qLXT1bEffAoWGnc7wg ($60.55 in chips) 
Seat 4: 9U3ZKjCsarN0DjR6mSE8Ug ($14.25 in chips) 
Seat 5: GbCVUNssQ7mqsPWr7J4d3w ($4.65 in chips) 
Seat 6: B3X187C0tXFUfQpCu8pe8A ($23.55 in chips) 
B3X187C0tXFUfQpCu8pe8A: posts small blind $0.10
JQZew0FjzS19kTjeNtrE+A: posts big blind $0.25
*** HOLE CARDS ***
LtASJ9OlkqGrrUKGQlpGAw: folds 
3zD3qLXT1bEffAoWGnc7wg: raises $0.50 to $0.75
9U3ZKjCsarN0DjR6mSE8Ug: folds 
GbCVUNssQ7mqsPWr7J4d3w: folds 
B3X187C0tXFUfQpCu8pe8A: folds 
JQZew0FjzS19kTjeNtrE+A: folds 
Uncalled bet ($0.50) returned to 3zD3qLXT1bEffAoWGnc7wg
3zD3qLXT1bEffAoWGnc7wg collected $0.60 from pot
3zD3qLXT1bEffAoWGnc7wg: doesn't show hand 
*** SUMMARY ***
Total pot $0.60 | Rake $0 
Seat 1: JQZew0FjzS19kTjeNtrE+A (big blind) folded before Flop
Seat 2: LtASJ9OlkqGrrUKGQlpGAw folded before Flop (didn't bet)
Seat 3: 3zD3qLXT1bEffAoWGnc7wg collected ($0.60)
Seat 4: 9U3ZKjCsarN0DjR6mSE8Ug folded before Flop (didn't bet)
Seat 5: GbCVUNssQ7mqsPWr7J4d3w (button) folded before Flop (didn't bet)
Seat 6: B3X187C0tXFUfQpCu8pe8A (small blind) folded before Flop




PokerStars Game #59941994774:  Hold'em No Limit ($0.10/$0.25) - 2009/07/01 1:52:44 ET
Table 'aaXqTKUnxrX9DYXtxhWXxA' 6-max Seat #5 is the button
Seat 1: aSrj4lVmn2owyQ1RbbOqxQ ($28.85 in chips) 
Seat 2: DE9hRlt14g+JdsRQ4wT7hg ($32.75 in chips) 
Seat 3: uUXdcVMNa05rfbntdvplfw ($7.75 in chips) 
Seat 4: 48oT5xFI+5CHUJlfoGrE4w ($7.30 in chips) 
Seat 5: kyRaCIljYA6l33lSKQfNsg ($23.50 in chips) 
Seat 6: 1lxYIAoJdZwAbzIkzWmSkw ($6.60 in chips) 
1lxYIAoJdZwAbzIkzWmSkw: posts small blind $0.10
aSrj4lVmn2owyQ1RbbOqxQ: posts big blind $0.25
*** HOLE CARDS ***
DE9hRlt14g+JdsRQ4wT7hg: raises $0.75 to $1
uUXdcVMNa05rfbntdvplfw: calls $1
48oT5xFI+5CHUJlfoGrE4w: folds 
kyRaCIljYA6l33lSKQfNsg: folds 
1lxYIAoJdZwAbzIkzWmSkw: folds 
aSrj4lVmn2owyQ1RbbOqxQ: folds 
*** FLOP *** [Qh As 8d]
DE9hRlt14g+JdsRQ4wT7hg: bets $1.50
uUXdcVMNa05rfbntdvplfw: calls $1.50
*** TURN *** [Qh As 8d] [Kh]
DE9hRlt14g+JdsRQ4wT7hg: checks 
uUXdcVMNa05rfbntdvplfw: checks 
*** RIVER *** [Qh As 8d Kh] [6s]
DE9hRlt14g+JdsRQ4wT7hg: checks 
uUXdcVMNa05rfbntdvplfw: bets $1.50
DE9hRlt14g+JdsRQ4wT7hg: folds 
Uncalled bet ($1.50) returned to uUXdcVMNa05rfbntdvplfw
uUXdcVMNa05rfbntdvplfw collected $5.10 from pot
*** SUMMARY ***
Total pot $5.35 | Rake $0.25 
Board [Qh As 8d Kh 6s]
Seat 1: aSrj4lVmn2owyQ1RbbOqxQ (big blind) folded before Flop
Seat 2: DE9hRlt14g+JdsRQ4wT7hg folded on the River
Seat 3: uUXdcVMNa05rfbntdvplfw collected ($5.10)
Seat 4: 48oT5xFI+5CHUJlfoGrE4w folded before Flop (didn't bet)
Seat 5: kyRaCIljYA6l33lSKQfNsg (button) folded before Flop (didn't bet)
Seat 6: 1lxYIAoJdZwAbzIkzWmSkw (small blind) folded before Flop




PokerStars Game #59941994764:  Hold'em No Limit ($0.10/$0.25) - 2009/07/01 1:52:44 ET
Table 'DhkrdW2UOy2PfjSW28Kq8w' 6-max Seat #6 is the button
Seat 1: Mhj3q7cxev+XjXZxEE6/Cw ($25 in chips) 
Seat 2: v+QfkGiuj9bgtuNoVnDO8w ($27.30 in chips) 
Seat 3: B3X187C0tXFUfQpCu8pe8A ($22.45 in chips) 
Seat 4: 59HJSCM1X37BkMpI9N0mEw ($22.15 in chips) 
Seat 5: cS21pIxRHx5Gt42o7hPZzw ($11.45 in chips) 
Seat 6: DihMHaz4WNETH1bPDe13kA ($26.75 in chips) 
Mhj3q7cxev+XjXZxEE6/Cw: posts small blind $0.10
v+QfkGiuj9bgtuNoVnDO8w: posts big blind $0.25
*** HOLE CARDS ***
B3X187C0tXFUfQpCu8pe8A: folds 
59HJSCM1X37BkMpI9N0mEw: calls $0.25
cS21pIxRHx5Gt42o7hPZzw: folds 
DihMHaz4WNETH1bPDe13kA: folds 
Mhj3q7cxev+XjXZxEE6/Cw: folds 
v+QfkGiuj9bgtuNoVnDO8w: checks 
*** FLOP *** [3c 2d 2h]
v+QfkGiuj9bgtuNoVnDO8w: checks 
59HJSCM1X37BkMpI9N0mEw: bets $0.50
v+QfkGiuj9bgtuNoVnDO8w: folds 
Uncalled bet ($0.50) returned to 59HJSCM1X37BkMpI9N0mEw
59HJSCM1X37BkMpI9N0mEw collected $0.60 from pot
59HJSCM1X37BkMpI9N0mEw: doesn't show hand 
*** SUMMARY ***
Total pot $0.60 | Rake $0 
Board [3c 2d 2h]
Seat 1: Mhj3q7cxev+XjXZxEE6/Cw (small blind) folded before Flop
Seat 2: v+QfkGiuj9bgtuNoVnDO8w (big blind) folded on the Flop
Seat 3: B3X187C0tXFUfQpCu8pe8A folded before Flop (didn't bet)
Seat 4: 59HJSCM1X37BkMpI9N0mEw collected ($0.60)
Seat 5: cS21pIxRHx5Gt42o7hPZzw folded before Flop (didn't bet)
Seat 6: DihMHaz4WNETH1bPDe13kA (button) folded before Flop (didn't bet)




PokerStars Game #59941994910:  Hold'em No Limit ($0.10/$0.25) - 2009/07/01 1:52:44 ET
Table 'PCxB2W9H6ma8SwsZlImuOw' 9-max Seat #9 is the button
Seat 1: SqibpGx+lf+brY0fJVvD0w ($26.10 in chips) 
Seat 2: bXpVeaSTPBFSPJmeXxO7nw ($4.65 in chips) 
Seat 4: RsPwA2DnzOke3hD/Of/DUg ($2.20 in chips) 
Seat 5: GZO7tOXatVoX17M2DqPcUQ ($16.85 in chips) 
Seat 6: 5/6dWEBUHldD7iGXa2LwsQ ($15.45 in chips) 
Seat 8: Pt637jKksB5MzP0UNJAAkw ($24 in chips) 
Seat 9: COwSH15MvHaRF7en6/TRZQ ($18.05 in chips) 
SqibpGx+lf+brY0fJVvD0w: posts small blind $0.10
bXpVeaSTPBFSPJmeXxO7nw: posts big blind $0.25
qwr38jl5txoR36M7G5qi4A: sits out 
*** HOLE CARDS ***
RsPwA2DnzOke3hD/Of/DUg: folds 
GZO7tOXatVoX17M2DqPcUQ: calls $0.25
5/6dWEBUHldD7iGXa2LwsQ: calls $0.25
Pt637jKksB5MzP0UNJAAkw: folds 
COwSH15MvHaRF7en6/TRZQ: folds 
clJsV3v77RS07bDKY+705w joins the table at seat #3 
SqibpGx+lf+brY0fJVvD0w: calls $0.15
Pt637jKksB5MzP0UNJAAkw leaves the table
bXpVeaSTPBFSPJmeXxO7nw: checks 
*** FLOP *** [Td 8c Ah]
SqibpGx+lf+brY0fJVvD0w: checks 
bXpVeaSTPBFSPJmeXxO7nw: checks 
GZO7tOXatVoX17M2DqPcUQ: checks 
5/6dWEBUHldD7iGXa2LwsQ: bets $0.75
SqibpGx+lf+brY0fJVvD0w: folds 
bXpVeaSTPBFSPJmeXxO7nw: folds 
GZO7tOXatVoX17M2DqPcUQ: raises $0.75 to $1.50
5/6dWEBUHldD7iGXa2LwsQ: calls $0.75
*** TURN *** [Td 8c Ah] [Ad]
GZO7tOXatVoX17M2DqPcUQ: checks 
5/6dWEBUHldD7iGXa2LwsQ: checks 
*** RIVER *** [Td 8c Ah Ad] [Ac]
GZO7tOXatVoX17M2DqPcUQ: checks 
5/6dWEBUHldD7iGXa2LwsQ: checks 
*** SHOW DOWN ***
GZO7tOXatVoX17M2DqPcUQ: shows [Jh 9h] (three of a kind, Aces)
5/6dWEBUHldD7iGXa2LwsQ: shows [9s 9d] (a full house, Aces full of Nines)
5/6dWEBUHldD7iGXa2LwsQ collected $3.85 from pot
*** SUMMARY ***
Total pot $4 | Rake $0.15 
Board [Td 8c Ah Ad Ac]
Seat 1: SqibpGx+lf+brY0fJVvD0w (small blind) folded on the Flop
Seat 2: bXpVeaSTPBFSPJmeXxO7nw (big blind) folded on the Flop
Seat 4: RsPwA2DnzOke3hD/Of/DUg folded before Flop (didn't bet)
Seat 5: GZO7tOXatVoX17M2DqPcUQ showed [Jh 9h] and lost with three of a kind, Aces
Seat 6: 5/6dWEBUHldD7iGXa2LwsQ showed [9s 9d] and won ($3.85) with a full house, Aces full of Nines
Seat 8: Pt637jKksB5MzP0UNJAAkw folded before Flop (didn't bet)
Seat 9: COwSH15MvHaRF7en6/TRZQ (button) folded before Flop (didn't bet)




PokerStars Game #59941994962:  Hold'em No Limit ($0.10/$0.25) - 2009/07/01 1:52:44 ET
Table 'G26g8jde1eR+mmabeFeSlw' 9-max Seat #6 is the button
Seat 1: wnerYvSRWT9Sm4X3ip/c8w ($24.65 in chips) 
Seat 4: 8EbrQ/EvFWt2cr0GaU82gQ ($5.40 in chips) 
Seat 5: hJ4uYjNmSZdjrKA8cjZqCA ($39.75 in chips) 
Seat 6: AHGkesF/mi4sDMpqrxBUoA ($8.40 in chips) 
Seat 7: nm4Dj/f+jJEwKVsUnKh73g ($38.30 in chips) 
Seat 8: CvL9Ch1HYCVbTsfpNucitg ($3.50 in chips) 
Seat 9: VWUWpMLMj/Q1jRVpF7Aohw ($13.30 in chips) 
nm4Dj/f+jJEwKVsUnKh73g: posts small blind $0.10
CvL9Ch1HYCVbTsfpNucitg: posts big blind $0.25
s2xLPOl/vhl/26apJ3vsOQ: sits out 
*** HOLE CARDS ***
VWUWpMLMj/Q1jRVpF7Aohw: folds 
wnerYvSRWT9Sm4X3ip/c8w: folds 
8EbrQ/EvFWt2cr0GaU82gQ: folds 
hJ4uYjNmSZdjrKA8cjZqCA: folds 
AHGkesF/mi4sDMpqrxBUoA: folds 
nm4Dj/f+jJEwKVsUnKh73g: raises $0.25 to $0.50
CvL9Ch1HYCVbTsfpNucitg: folds 
Uncalled bet ($0.25) returned to nm4Dj/f+jJEwKVsUnKh73g
nm4Dj/f+jJEwKVsUnKh73g collected $0.50 from pot
nm4Dj/f+jJEwKVsUnKh73g: doesn't show hand 
*** SUMMARY ***
Total pot $0.50 | Rake $0 
Seat 1: wnerYvSRWT9Sm4X3ip/c8w folded before Flop (didn't bet)
Seat 4: 8EbrQ/EvFWt2cr0GaU82gQ folded before Flop (didn't bet)
Seat 5: hJ4uYjNmSZdjrKA8cjZqCA folded before Flop (didn't bet)
Seat 6: AHGkesF/mi4sDMpqrxBUoA (button) folded before Flop (didn't bet)
Seat 7: nm4Dj/f+jJEwKVsUnKh73g (small blind) collected ($0.50)
Seat 8: CvL9Ch1HYCVbTsfpNucitg (big blind) folded before Flop
Seat 9: VWUWpMLMj/Q1jRVpF7Aohw folded before Flop (didn't bet)




PokerStars Game #59941995728:  Hold'em No Limit ($0.10/$0.25) - 2009/07/01 1:52:45 ET
Table '3lL16FBjWXTx3AjK5lMRww' 9-max Seat #1 is the button
Seat 1: fDGyaQz0cs2s4FOYxkbIHA ($14.55 in chips) 
Seat 3: QEbIGci+itdw+re8RM5fZA ($28.25 in chips) 
Seat 4: Z3a37Ry74FVl+CBZtAONiA ($6.40 in chips) 
Seat 5: M/9j4wkHH9i1JM51vgi1VA ($36.95 in chips) 
Seat 7: 6RiVTYll/5D8zICp0MRpKw ($26.30 in chips) 
Seat 8: ljemhp25Zg+nlA9DLCIiUw ($25.35 in chips) 
Seat 9: 00Ybni1cxfHtqmdWwh31Xg ($9.95 in chips) 
bXpVeaSTPBFSPJmeXxO7nw will be allowed to play after the button
QEbIGci+itdw+re8RM5fZA: posts small blind $0.10
Z3a37Ry74FVl+CBZtAONiA: posts big blind $0.25
*** HOLE CARDS ***
M/9j4wkHH9i1JM51vgi1VA: folds 
6RiVTYll/5D8zICp0MRpKw: folds 
ljemhp25Zg+nlA9DLCIiUw: folds 
00Ybni1cxfHtqmdWwh31Xg: folds 
fDGyaQz0cs2s4FOYxkbIHA: folds 
QEbIGci+itdw+re8RM5fZA: folds 
Uncalled bet ($0.15) returned to Z3a37Ry74FVl+CBZtAONiA
Z3a37Ry74FVl+CBZtAONiA collected $0.20 from pot
Z3a37Ry74FVl+CBZtAONiA: doesn't show hand 
*** SUMMARY ***
Total pot $0.20 | Rake $0 
Seat 1: fDGyaQz0cs2s4FOYxkbIHA (button) folded before Flop (didn't bet)
Seat 3: QEbIGci+itdw+re8RM5fZA (small blind) folded before Flop
Seat 4: Z3a37Ry74FVl+CBZtAONiA (big blind) collected ($0.20)
Seat 5: M/9j4wkHH9i1JM51vgi1VA folded before Flop (didn't bet)
Seat 7: 6RiVTYll/5D8zICp0MRpKw folded before Flop (didn't bet)
Seat 8: ljemhp25Zg+nlA9DLCIiUw folded before Flop (didn't bet)
Seat 9: 00Ybni1cxfHtqmdWwh31Xg folded before Flop (didn't bet)




PokerStars Game #59941995288:  Hold'em No Limit ($0.10/$0.25) - 2009/07/01 1:52:45 ET
Table 'mF3KHGMaTpaBZbtBoyfTeg' 6-max Seat #3 is the button
Seat 1: 0HAB2GdCAM7p7V00xueAVQ ($33.20 in chips) 
Seat 2: xrf8tAXKQHG99HixCot1Iw ($25.85 in chips) 
Seat 3: 9kUKGKkblnIx3m8rlVol6Q ($15.50 in chips) 
Seat 4: qNYqNZMLP1I54EVl8faRRg ($8.75 in chips) 
Seat 5: 8ClCHtFXGNplITm+63KB+Q ($45.25 in chips) 
Seat 6: kG34n23qFQA3nzdOJTQ1dA ($26.45 in chips) 
qNYqNZMLP1I54EVl8faRRg: posts small blind $0.10
8ClCHtFXGNplITm+63KB+Q: posts big blind $0.25
*** HOLE CARDS ***
kG34n23qFQA3nzdOJTQ1dA: folds 
0HAB2GdCAM7p7V00xueAVQ: raises $0.25 to $0.50
xrf8tAXKQHG99HixCot1Iw: folds 
9kUKGKkblnIx3m8rlVol6Q: calls $0.50
qNYqNZMLP1I54EVl8faRRg: raises $2 to $2.50
8ClCHtFXGNplITm+63KB+Q: calls $2.25
0HAB2GdCAM7p7V00xueAVQ: folds 
9kUKGKkblnIx3m8rlVol6Q: folds 
*** FLOP *** [8h 9c 2s]
qNYqNZMLP1I54EVl8faRRg: bets $6.25 and is all-in
8ClCHtFXGNplITm+63KB+Q: folds 
Uncalled bet ($6.25) returned to qNYqNZMLP1I54EVl8faRRg
qNYqNZMLP1I54EVl8faRRg collected $5.70 from pot
*** SUMMARY ***
Total pot $6 | Rake $0.30 
Board [8h 9c 2s]
Seat 1: 0HAB2GdCAM7p7V00xueAVQ folded before Flop
Seat 2: xrf8tAXKQHG99HixCot1Iw folded before Flop (didn't bet)
Seat 3: 9kUKGKkblnIx3m8rlVol6Q (button) folded before Flop
Seat 4: qNYqNZMLP1I54EVl8faRRg (small blind) collected ($5.70)
Seat 5: 8ClCHtFXGNplITm+63KB+Q (big blind) folded on the Flop
Seat 6: kG34n23qFQA3nzdOJTQ1dA folded before Flop (didn't bet)




PokerStars Game #59941995408:  Hold'em No Limit ($0.10/$0.25) - 2009/07/01 1:52:45 ET
Table 'WY+lMaAoIdBZmwk27/RJCA' 6-max Seat #1 is the button
Seat 1: zHHLkD2sRljslKKeQv/ZQw ($32.95 in chips) 
Seat 2: NhUN/JpAprdJeamFBgJH1w ($28 in chips) 
Seat 3: QqiZLFrN8iOUT/GHw7ztOA ($26.60 in chips) 
Seat 4: 0av6tRNdi0Ui4f15L7gsVg ($23.15 in chips) 
Seat 5: vqWjZmdQu/Hxw96/IJTWdQ ($27.95 in chips) 
Seat 6: cWc85bEzdRzpUMhRKm8pwQ ($25 in chips) 
NhUN/JpAprdJeamFBgJH1w: posts small blind $0.10
QqiZLFrN8iOUT/GHw7ztOA: posts big blind $0.25
*** HOLE CARDS ***
0av6tRNdi0Ui4f15L7gsVg: folds 
vqWjZmdQu/Hxw96/IJTWdQ: folds 
cWc85bEzdRzpUMhRKm8pwQ: folds 
zHHLkD2sRljslKKeQv/ZQw: folds 
NhUN/JpAprdJeamFBgJH1w: raises $0.50 to $0.75
QqiZLFrN8iOUT/GHw7ztOA: folds 
Uncalled bet ($0.50) returned to NhUN/JpAprdJeamFBgJH1w
NhUN/JpAprdJeamFBgJH1w collected $0.50 from pot
NhUN/JpAprdJeamFBgJH1w: doesn't show hand 
*** SUMMARY ***
Total pot $0.50 | Rake $0 
Seat 1: zHHLkD2sRljslKKeQv/ZQw (button) folded before Flop (didn't bet)
Seat 2: NhUN/JpAprdJeamFBgJH1w (small blind) collected ($0.50)
Seat 3: QqiZLFrN8iOUT/GHw7ztOA (big blind) folded before Flop
Seat 4: 0av6tRNdi0Ui4f15L7gsVg folded before Flop (didn't bet)
Seat 5: vqWjZmdQu/Hxw96/IJTWdQ folded before Flop (didn't bet)
Seat 6: cWc85bEzdRzpUMhRKm8pwQ folded before Flop (didn't bet)




PokerStars Game #59941995468:  Hold'em No Limit ($0.10/$0.25) - 2009/07/01 1:52:45 ET
Table 'C8mMnVmvkagwolEzTvh07A' 9-max Seat #2 is the button
Seat 1: PqvgxdSg9z5VmrWpbYuz+g ($26.75 in chips) 
Seat 2: Bb42QRQMhg5/Y0vHP8/2Xw ($25 in chips) 
Seat 3: Th3FldXKQW6hWVVPahaoOQ ($34.25 in chips) 
Seat 4: dfNim92Z6XK1/h5SFW5vDg ($25.35 in chips) 
Seat 5: iGMlK+EhUflPB6jKQd95Cg ($25 in chips) 
Seat 6: AiXn/9o1EwOPZUHujnh/bA ($17.90 in chips) 
Th3FldXKQW6hWVVPahaoOQ: posts small blind $0.10
dfNim92Z6XK1/h5SFW5vDg: posts big blind $0.25
18G4P1XstjNvItdGUITxgw: sits out 
*** HOLE CARDS ***
iGMlK+EhUflPB6jKQd95Cg: folds 
AiXn/9o1EwOPZUHujnh/bA: folds 
PqvgxdSg9z5VmrWpbYuz+g: folds 
Bb42QRQMhg5/Y0vHP8/2Xw: folds 
Th3FldXKQW6hWVVPahaoOQ: folds 
Uncalled bet ($0.15) returned to dfNim92Z6XK1/h5SFW5vDg
dfNim92Z6XK1/h5SFW5vDg collected $0.20 from pot
dfNim92Z6XK1/h5SFW5vDg: doesn't show hand 
*** SUMMARY ***
Total pot $0.20 | Rake $0 
Seat 1: PqvgxdSg9z5VmrWpbYuz+g folded before Flop (didn't bet)
Seat 2: Bb42QRQMhg5/Y0vHP8/2Xw (button) folded before Flop (didn't bet)
Seat 3: Th3FldXKQW6hWVVPahaoOQ (small blind) folded before Flop
Seat 4: dfNim92Z6XK1/h5SFW5vDg (big blind) collected ($0.20)
Seat 5: iGMlK+EhUflPB6jKQd95Cg folded before Flop (didn't bet)
Seat 6: AiXn/9o1EwOPZUHujnh/bA folded before Flop (didn't bet)




PokerStars Game #59941995470:  Hold'em No Limit ($0.10/$0.25) - 2009/07/01 1:52:45 ET
Table '63uh7ZsO7Tnt+E8b/2bu3A' 6-max Seat #2 is the button
Seat 1: 0av6tRNdi0Ui4f15L7gsVg ($31.55 in chips) 
Seat 2: SFmT9ZsVopnukjvAzrxTRg ($25 in chips) 
Seat 3: yVP7GLZBzx47OPi6jzUxMw ($3.35 in chips) 
Seat 4: rnpAao581IcvQglpkpnkoQ ($12.50 in chips) 
Seat 6: qGHGf/553gQnDoklMRe3tg ($27.80 in chips) 
yVP7GLZBzx47OPi6jzUxMw: posts small blind $0.10
rnpAao581IcvQglpkpnkoQ: posts big blind $0.25
*** HOLE CARDS ***
qGHGf/553gQnDoklMRe3tg: folds 
0av6tRNdi0Ui4f15L7gsVg: raises $0.50 to $0.75
SFmT9ZsVopnukjvAzrxTRg: folds 
yVP7GLZBzx47OPi6jzUxMw: folds 
rnpAao581IcvQglpkpnkoQ: folds 
Uncalled bet ($0.50) returned to 0av6tRNdi0Ui4f15L7gsVg
0av6tRNdi0Ui4f15L7gsVg collected $0.60 from pot
0av6tRNdi0Ui4f15L7gsVg: doesn't show hand 
*** SUMMARY ***
Total pot $0.60 | Rake $0 
Seat 1: 0av6tRNdi0Ui4f15L7gsVg collected ($0.60)
Seat 2: SFmT9ZsVopnukjvAzrxTRg (button) folded before Flop (didn't bet)
Seat 3: yVP7GLZBzx47OPi6jzUxMw (small blind) folded before Flop
Seat 4: rnpAao581IcvQglpkpnkoQ (big blind) folded before Flop
Seat 6: qGHGf/553gQnDoklMRe3tg folded before Flop (didn't bet)




PokerStars Game #59941995410:  Hold'em No Limit ($0.10/$0.25) - 2009/07/01 1:52:45 ET
Table 'M7d9IrgQUUFFy/SZ3ksLYg' 6-max Seat #1 is the button
Seat 1: ypmjhffk/YHGc51wgVXUTw ($51.05 in chips) 
Seat 2: 8CPg15X6IHYR1pWm9ha1Sw ($25.05 in chips) 
Seat 3: epAUIB7h2FJXzUPRIvSkRA ($25.90 in chips) 
Seat 4: 8ClCHtFXGNplITm+63KB+Q ($22.50 in chips) 
Seat 6: 7S16WhQHiAVLWwRuqPrpnw ($14.45 in chips) 
8CPg15X6IHYR1pWm9ha1Sw: posts small blind $0.10
epAUIB7h2FJXzUPRIvSkRA: posts big blind $0.25
MVzl6OsGybVDNd3Vr9LYAA: sits out 
*** HOLE CARDS ***
8ClCHtFXGNplITm+63KB+Q: folds 
7S16WhQHiAVLWwRuqPrpnw: folds 
ypmjhffk/YHGc51wgVXUTw: folds 
8CPg15X6IHYR1pWm9ha1Sw: folds 
Uncalled bet ($0.15) returned to epAUIB7h2FJXzUPRIvSkRA
epAUIB7h2FJXzUPRIvSkRA collected $0.20 from pot
epAUIB7h2FJXzUPRIvSkRA: doesn't show hand 
*** SUMMARY ***
Total pot $0.20 | Rake $0 
Seat 1: ypmjhffk/YHGc51wgVXUTw (button) folded before Flop (didn't bet)
Seat 2: 8CPg15X6IHYR1pWm9ha1Sw (small blind) folded before Flop
Seat 3: epAUIB7h2FJXzUPRIvSkRA (big blind) collected ($0.20)
Seat 4: 8ClCHtFXGNplITm+63KB+Q folded before Flop (didn't bet)
Seat 6: 7S16WhQHiAVLWwRuqPrpnw folded before Flop (didn't bet)




PokerStars Game #59941995516:  Hold'em No Limit ($0.10/$0.25) - 2009/07/01 1:52:45 ET
Table 'wPWRBZPJl1HAnysw7qRR0A' 6-max Seat #1 is the button
Seat 1: m7ne1MOFTQXlsXT7/R/rug ($10.90 in chips) 
Seat 2: xC0kaiDYM6YTlgODL83O5A ($23.10 in chips) 
Seat 4: epAUIB7h2FJXzUPRIvSkRA ($50 in chips) 
Seat 5: y0B+UpYpOUJz3JWtlJQBSA ($15.05 in chips) 
Seat 6: VXTONriS+Ohik+r0FeicIw ($25.60 in chips) 
xC0kaiDYM6YTlgODL83O5A: posts small blind $0.10
epAUIB7h2FJXzUPRIvSkRA: posts big blind $0.25
*** HOLE CARDS ***
y0B+UpYpOUJz3JWtlJQBSA: folds 
VXTONriS+Ohik+r0FeicIw: folds 
m7ne1MOFTQXlsXT7/R/rug: folds 
xC0kaiDYM6YTlgODL83O5A: folds 
Uncalled bet ($0.15) returned to epAUIB7h2FJXzUPRIvSkRA
epAUIB7h2FJXzUPRIvSkRA collected $0.20 from pot
epAUIB7h2FJXzUPRIvSkRA: doesn't show hand 
*** SUMMARY ***
Total pot $0.20 | Rake $0 
Seat 1: m7ne1MOFTQXlsXT7/R/rug (button) folded before Flop (didn't bet)
Seat 2: xC0kaiDYM6YTlgODL83O5A (small blind) folded before Flop
Seat 4: epAUIB7h2FJXzUPRIvSkRA (big blind) collected ($0.20)
Seat 5: y0B+UpYpOUJz3JWtlJQBSA folded before Flop (didn't bet)
Seat 6: VXTONriS+Ohik+r0FeicIw folded before Flop (didn't bet)




PokerStars Game #59941995520:  Hold'em No Limit ($0.10/$0.25) - 2009/07/01 1:52:45 ET
Table 'isKy4XK8wJM0x735/D4hWA' 6-max Seat #2 is the button
Seat 1: kwsRmpZ1ZaLooISs+zfyKg ($24.95 in chips) 
Seat 2: 6elpmfyt4Zw0yvd8lePSMQ ($38.05 in chips) 
Seat 3: jp34e617tIzV8tKIWmfAbA ($25.10 in chips) 
Seat 4: DFi/Lzkjsfv8QswS80JX9Q ($31.45 in chips) 
Seat 6: GbCVUNssQ7mqsPWr7J4d3w ($4.65 in chips) 
jp34e617tIzV8tKIWmfAbA: posts small blind $0.10
DFi/Lzkjsfv8QswS80JX9Q: posts big blind $0.25
TheRuger: sits out 
*** HOLE CARDS ***
GbCVUNssQ7mqsPWr7J4d3w: folds 
kwsRmpZ1ZaLooISs+zfyKg: folds 
6elpmfyt4Zw0yvd8lePSMQ: calls $0.25
jp34e617tIzV8tKIWmfAbA: raises $0.75 to $1
DFi/Lzkjsfv8QswS80JX9Q: folds 
6elpmfyt4Zw0yvd8lePSMQ: folds 
Uncalled bet ($0.75) returned to jp34e617tIzV8tKIWmfAbA
jp34e617tIzV8tKIWmfAbA collected $0.75 from pot
jp34e617tIzV8tKIWmfAbA: doesn't show hand 
*** SUMMARY ***
Total pot $0.75 | Rake $0 
Seat 1: kwsRmpZ1ZaLooISs+zfyKg folded before Flop (didn't bet)
Seat 2: 6elpmfyt4Zw0yvd8lePSMQ (button) folded before Flop
Seat 3: jp34e617tIzV8tKIWmfAbA (small blind) collected ($0.75)
Seat 4: DFi/Lzkjsfv8QswS80JX9Q (big blind) folded before Flop
Seat 6: GbCVUNssQ7mqsPWr7J4d3w folded before Flop (didn't bet)




PokerStars Game #59941995676:  Hold'em No Limit ($0.10/$0.25) - 2009/07/01 1:52:45 ET
Table 'G+4ZdyRoPjgaJY/jxSlZzQ' 9-max Seat #1 is the button
Seat 1: ghNKXUBl/H+t83JF079ZBA ($23.40 in chips) 
Seat 2: CT7Xj/V/O5rBlhtt+RZeFQ ($25 in chips) 
Seat 3: FaGtAm5QUVcixGhAKIvbLg ($6.15 in chips) 
Seat 4: 3PmVnC/15cl4oyI1TKIt4g ($4.65 in chips) 
Seat 5: BT6Oal0iO4P6kDuT7HFQDw ($23.50 in chips) 
Seat 6: oFwaTjy3ok/+qFghsrcGvg ($21.30 in chips) 
Seat 7: qwr38jl5txoR36M7G5qi4A ($12.75 in chips) 
Seat 8: bXpVeaSTPBFSPJmeXxO7nw ($4.30 in chips) 
Seat 9: tLcDklc2rBORNfixyRfVfw ($26.50 in chips) 
CT7Xj/V/O5rBlhtt+RZeFQ: posts small blind $0.10
FaGtAm5QUVcixGhAKIvbLg: posts big blind $0.25
*** HOLE CARDS ***
3PmVnC/15cl4oyI1TKIt4g: folds 
BT6Oal0iO4P6kDuT7HFQDw: raises $0.25 to $0.50
oFwaTjy3ok/+qFghsrcGvg: folds 
qwr38jl5txoR36M7G5qi4A: folds 
bXpVeaSTPBFSPJmeXxO7nw: folds 
tLcDklc2rBORNfixyRfVfw: folds 
ghNKXUBl/H+t83JF079ZBA: folds 
CT7Xj/V/O5rBlhtt+RZeFQ: folds 
FaGtAm5QUVcixGhAKIvbLg: raises $0.75 to $1.25
BT6Oal0iO4P6kDuT7HFQDw: calls $0.75
*** FLOP *** [Ac 7h Th]
FaGtAm5QUVcixGhAKIvbLg: bets $4.90 and is all-in
BT6Oal0iO4P6kDuT7HFQDw: calls $4.90
*** TURN *** [Ac 7h Th] [8d]
*** RIVER *** [Ac 7h Th 8d] [Js]
*** SHOW DOWN ***
FaGtAm5QUVcixGhAKIvbLg: shows [Jh Qd] (a pair of Jacks)
BT6Oal0iO4P6kDuT7HFQDw: mucks hand 
FaGtAm5QUVcixGhAKIvbLg collected $11.80 from pot
*** SUMMARY ***
Total pot $12.40 | Rake $0.60 
Board [Ac 7h Th 8d Js]
Seat 1: ghNKXUBl/H+t83JF079ZBA (button) folded before Flop (didn't bet)
Seat 2: CT7Xj/V/O5rBlhtt+RZeFQ (small blind) folded before Flop
Seat 3: FaGtAm5QUVcixGhAKIvbLg (big blind) showed [Jh Qd] and won ($11.80) with a pair of Jacks
Seat 4: 3PmVnC/15cl4oyI1TKIt4g folded before Flop (didn't bet)
Seat 5: BT6Oal0iO4P6kDuT7HFQDw mucked
Seat 6: oFwaTjy3ok/+qFghsrcGvg folded before Flop (didn't bet)
Seat 7: qwr38jl5txoR36M7G5qi4A folded before Flop (didn't bet)
Seat 8: bXpVeaSTPBFSPJmeXxO7nw folded before Flop (didn't bet)
Seat 9: tLcDklc2rBORNfixyRfVfw folded before Flop (didn't bet)




PokerStars Game #59941996018:  Hold'em No Limit ($0.10/$0.25) - 2009/07/01 1:52:46 ET
Table 'Jj2eLzVCUVAGBmM+Og79iQ' 9-max Seat #5 is the button
Seat 1: ShXPHWfjhfmAwLgDdm6bRQ ($7.70 in chips) 
Seat 2: 3BXzvZqgd3pARIFGfMXHww ($5.35 in chips) 
Seat 3: HPEB+AtKw1+C/cxU0o1ciw ($24.05 in chips) 
Seat 4: Bb42QRQMhg5/Y0vHP8/2Xw ($25 in chips) 
Seat 5: UkF1eqqUN0CCiimXAuN7og ($4.30 in chips) 
Seat 6: jZURAM/dgGCX+5lATlZugw ($17.10 in chips) 
Seat 7: e3Caz8vey9WAdfgpuGpNjQ ($14.50 in chips) 
Seat 8: H5Se03ZqSX7tbULXur2MAg ($34.15 in chips) 
Seat 9: vSkQm2EelzwRGDDQQk0Fqw ($4.65 in chips) 
jZURAM/dgGCX+5lATlZugw: posts small blind $0.10
e3Caz8vey9WAdfgpuGpNjQ: posts big blind $0.25
Bb42QRQMhg5/Y0vHP8/2Xw: posts big blind $0.25
*** HOLE CARDS ***
H5Se03ZqSX7tbULXur2MAg: raises $0.75 to $1
vSkQm2EelzwRGDDQQk0Fqw has timed out
vSkQm2EelzwRGDDQQk0Fqw: folds 
vSkQm2EelzwRGDDQQk0Fqw is sitting out
vSkQm2EelzwRGDDQQk0Fqw has returned
ShXPHWfjhfmAwLgDdm6bRQ: folds 
3BXzvZqgd3pARIFGfMXHww: folds 
HPEB+AtKw1+C/cxU0o1ciw: folds 
Bb42QRQMhg5/Y0vHP8/2Xw: folds 
UkF1eqqUN0CCiimXAuN7og: folds 
jZURAM/dgGCX+5lATlZugw: folds 
e3Caz8vey9WAdfgpuGpNjQ: folds 
Uncalled bet ($0.75) returned to H5Se03ZqSX7tbULXur2MAg
H5Se03ZqSX7tbULXur2MAg collected $0.85 from pot
*** SUMMARY ***
Total pot $0.85 | Rake $0 
Seat 1: ShXPHWfjhfmAwLgDdm6bRQ folded before Flop (didn't bet)
Seat 2: 3BXzvZqgd3pARIFGfMXHww folded before Flop (didn't bet)
Seat 3: HPEB+AtKw1+C/cxU0o1ciw folded before Flop (didn't bet)
Seat 4: Bb42QRQMhg5/Y0vHP8/2Xw folded before Flop
Seat 5: UkF1eqqUN0CCiimXAuN7og (button) folded before Flop (didn't bet)
Seat 6: jZURAM/dgGCX+5lATlZugw (small blind) folded before Flop
Seat 7: e3Caz8vey9WAdfgpuGpNjQ (big blind) folded before Flop
Seat 8: H5Se03ZqSX7tbULXur2MAg collected ($0.85)
Seat 9: vSkQm2EelzwRGDDQQk0Fqw folded before Flop (didn't bet)




PokerStars Game #59941996090:  Hold'em No Limit ($0.10/$0.25) - 2009/07/01 1:52:46 ET
Table 'sJ4KpS2GE5Qrsu1/cFjJUw' 9-max Seat #9 is the button
Seat 1: eDlQ+S+6L4e6gM1dkZhGgQ ($16.95 in chips) 
Seat 2: ydoFOVgzvZv9ZhuWu9rXAw ($5 in chips) 
Seat 3: eK8qa6EPcH2zhtbmWSvc9g ($25 in chips) 
Seat 5: Q/gZC63lfOMr7YhWKPCxoQ ($7.40 in chips) 
Seat 6: OefE+Csvj5KR7ClGf3Hc2g ($3.75 in chips) 
Seat 7: Wi8djHgewBlVhpKWfp7isQ ($12.20 in chips) 
Seat 8: S7Ki0P+0AIGPuIfGJjW0gg ($30.10 in chips) 
Seat 9: 3PmVnC/15cl4oyI1TKIt4g ($4.85 in chips) 
eDlQ+S+6L4e6gM1dkZhGgQ: posts small blind $0.10
ydoFOVgzvZv9ZhuWu9rXAw: posts big blind $0.25
*** HOLE CARDS ***
eK8qa6EPcH2zhtbmWSvc9g: folds 
Q/gZC63lfOMr7YhWKPCxoQ: calls $0.25
OefE+Csvj5KR7ClGf3Hc2g: folds 
Wi8djHgewBlVhpKWfp7isQ: folds 
S7Ki0P+0AIGPuIfGJjW0gg: folds 
3PmVnC/15cl4oyI1TKIt4g: folds 
eDlQ+S+6L4e6gM1dkZhGgQ: calls $0.15
ydoFOVgzvZv9ZhuWu9rXAw: checks 
*** FLOP *** [2s 9d 6c]
eDlQ+S+6L4e6gM1dkZhGgQ: checks 
ydoFOVgzvZv9ZhuWu9rXAw: checks 
Q/gZC63lfOMr7YhWKPCxoQ: checks 
*** TURN *** [2s 9d 6c] [Jc]
eDlQ+S+6L4e6gM1dkZhGgQ: checks 
ydoFOVgzvZv9ZhuWu9rXAw: checks 
Q/gZC63lfOMr7YhWKPCxoQ: checks 
*** RIVER *** [2s 9d 6c Jc] [3c]
Wi8djHgewBlVhpKWfp7isQ leaves the table
eDlQ+S+6L4e6gM1dkZhGgQ: checks 
ydoFOVgzvZv9ZhuWu9rXAw: checks 
Q/gZC63lfOMr7YhWKPCxoQ: bets $0.25
eDlQ+S+6L4e6gM1dkZhGgQ: folds 
ydoFOVgzvZv9ZhuWu9rXAw: folds 
Uncalled bet ($0.25) returned to Q/gZC63lfOMr7YhWKPCxoQ
Q/gZC63lfOMr7YhWKPCxoQ collected $0.75 from pot
Q/gZC63lfOMr7YhWKPCxoQ: doesn't show hand 
*** SUMMARY ***
Total pot $0.75 | Rake $0 
Board [2s 9d 6c Jc 3c]
Seat 1: eDlQ+S+6L4e6gM1dkZhGgQ (small blind) folded on the River
Seat 2: ydoFOVgzvZv9ZhuWu9rXAw (big blind) folded on the River
Seat 3: eK8qa6EPcH2zhtbmWSvc9g folded before Flop (didn't bet)
Seat 5: Q/gZC63lfOMr7YhWKPCxoQ collected ($0.75)
Seat 6: OefE+Csvj5KR7ClGf3Hc2g folded before Flop (didn't bet)
Seat 7: Wi8djHgewBlVhpKWfp7isQ folded before Flop (didn't bet)
Seat 8: S7Ki0P+0AIGPuIfGJjW0gg folded before Flop (didn't bet)
Seat 9: 3PmVnC/15cl4oyI1TKIt4g (button) folded before Flop (didn't bet)




PokerStars Game #59941996186:  Hold'em No Limit ($0.10/$0.25) - 2009/07/01 1:52:46 ET
Table '63h13e5p7cWe02rClZ1CHw' 6-max Seat #1 is the button
Seat 1: pokjbbEcXXPlADXdSGHtZw ($22 in chips) 
Seat 2: k9nHZTHt8hYhYRcW8NTb4g ($24.65 in chips) 
Seat 4: xrf8tAXKQHG99HixCot1Iw ($28 in chips) 
Seat 5: iyZxqznXjv3vtvOJymkoLQ ($44.10 in chips) 
Seat 6: mfrkWA3PTeYPkbO6hi98Aw ($38.10 in chips) 
k9nHZTHt8hYhYRcW8NTb4g: posts small blind $0.10
xrf8tAXKQHG99HixCot1Iw: posts big blind $0.25
*** HOLE CARDS ***
iyZxqznXjv3vtvOJymkoLQ: folds 
mfrkWA3PTeYPkbO6hi98Aw: folds 
pokjbbEcXXPlADXdSGHtZw: raises $0.50 to $0.75
k9nHZTHt8hYhYRcW8NTb4g: folds 
xrf8tAXKQHG99HixCot1Iw: folds 
Uncalled bet ($0.50) returned to pokjbbEcXXPlADXdSGHtZw
pokjbbEcXXPlADXdSGHtZw collected $0.60 from pot
*** SUMMARY ***
Total pot $0.60 | Rake $0 
Seat 1: pokjbbEcXXPlADXdSGHtZw (button) collected ($0.60)
Seat 2: k9nHZTHt8hYhYRcW8NTb4g (small blind) folded before Flop
Seat 4: xrf8tAXKQHG99HixCot1Iw (big blind) folded before Flop
Seat 5: iyZxqznXjv3vtvOJymkoLQ folded before Flop (didn't bet)
Seat 6: mfrkWA3PTeYPkbO6hi98Aw folded before Flop (didn't bet)




PokerStars Game #59941995972:  Hold'em No Limit ($0.10/$0.25) - 2009/07/01 1:52:46 ET
Table 'vFZR6Kf2Th5xBXT9brGW6A' 6-max Seat #2 is the button
Seat 1: Q1uciOZPBR/WkAlqa6cL4A ($27.55 in chips) 
Seat 2: QiL+lEgEWwy21jk/ltaRLg ($26 in chips) 
Seat 4: 79ID/ub1Pt/mDpCprVmOoA ($34.60 in chips) 
Seat 5: SS/yfeArhULzIcOPe8MdPg ($27.60 in chips) 
Seat 6: 4x9jCqgSw4272dnaIqnanw ($2.05 in chips) 
79ID/ub1Pt/mDpCprVmOoA: posts small blind $0.10
SS/yfeArhULzIcOPe8MdPg: posts big blind $0.25
*** HOLE CARDS ***
4x9jCqgSw4272dnaIqnanw: folds 
Q1uciOZPBR/WkAlqa6cL4A: folds 
QiL+lEgEWwy21jk/ltaRLg: folds 
79ID/ub1Pt/mDpCprVmOoA: raises $0.50 to $0.75
SS/yfeArhULzIcOPe8MdPg: raises $1.75 to $2.50
79ID/ub1Pt/mDpCprVmOoA: folds 
Uncalled bet ($1.75) returned to SS/yfeArhULzIcOPe8MdPg
SS/yfeArhULzIcOPe8MdPg collected $1.50 from pot
*** SUMMARY ***
Total pot $1.50 | Rake $0 
Seat 1: Q1uciOZPBR/WkAlqa6cL4A folded before Flop (didn't bet)
Seat 2: QiL+lEgEWwy21jk/ltaRLg (button) folded before Flop (didn't bet)
Seat 4: 79ID/ub1Pt/mDpCprVmOoA (small blind) folded before Flop
Seat 5: SS/yfeArhULzIcOPe8MdPg (big blind) collected ($1.50)
Seat 6: 4x9jCqgSw4272dnaIqnanw folded before Flop (didn't bet)




PokerStars Game #59941996148:  Hold'em No Limit ($0.10/$0.25) - 2009/07/01 1:52:46 ET
Table 'AchTjdLS1zBUbH3ZIx6f0w' 6-max Seat #5 is the button
Seat 1: rZ0bUtoerhFGDUSRQMnFog ($24.55 in chips) 
Seat 2: kG34n23qFQA3nzdOJTQ1dA ($65.55 in chips) 
Seat 4: q6WfTUAD9mowIP63ASq2Dg ($35.90 in chips) 
Seat 5: 0av6tRNdi0Ui4f15L7gsVg ($23.30 in chips) 
Seat 6: epAUIB7h2FJXzUPRIvSkRA ($25.85 in chips) 
epAUIB7h2FJXzUPRIvSkRA: posts small blind $0.10
rZ0bUtoerhFGDUSRQMnFog: posts big blind $0.25
MVzl6OsGybVDNd3Vr9LYAA: sits out 
*** HOLE CARDS ***
kG34n23qFQA3nzdOJTQ1dA: folds 
q6WfTUAD9mowIP63ASq2Dg: calls $0.25
0av6tRNdi0Ui4f15L7gsVg: calls $0.25
epAUIB7h2FJXzUPRIvSkRA: calls $0.15
rZ0bUtoerhFGDUSRQMnFog: raises $0.25 to $0.50
q6WfTUAD9mowIP63ASq2Dg: calls $0.25
0av6tRNdi0Ui4f15L7gsVg: calls $0.25
epAUIB7h2FJXzUPRIvSkRA: calls $0.25
*** FLOP *** [4h Jh 7s]
epAUIB7h2FJXzUPRIvSkRA: checks 
rZ0bUtoerhFGDUSRQMnFog: checks 
q6WfTUAD9mowIP63ASq2Dg: checks 
0av6tRNdi0Ui4f15L7gsVg: checks 
*** TURN *** [4h Jh 7s] [Jd]
epAUIB7h2FJXzUPRIvSkRA: checks 
rZ0bUtoerhFGDUSRQMnFog: checks 
q6WfTUAD9mowIP63ASq2Dg: checks 
0av6tRNdi0Ui4f15L7gsVg: checks 
*** RIVER *** [4h Jh 7s Jd] [6d]
epAUIB7h2FJXzUPRIvSkRA: checks 
rZ0bUtoerhFGDUSRQMnFog: checks 
q6WfTUAD9mowIP63ASq2Dg: checks 
0av6tRNdi0Ui4f15L7gsVg: checks 
*** SHOW DOWN ***
epAUIB7h2FJXzUPRIvSkRA: shows [3s 4s] (two pair, Jacks and Fours)
rZ0bUtoerhFGDUSRQMnFog: shows [Qd 4d] (two pair, Jacks and Fours - Queen kicker)
q6WfTUAD9mowIP63ASq2Dg: mucks hand 
0av6tRNdi0Ui4f15L7gsVg: mucks hand 
rZ0bUtoerhFGDUSRQMnFog collected $1.90 from pot
*** SUMMARY ***
Total pot $2 | Rake $0.10 
Board [4h Jh 7s Jd 6d]
Seat 1: rZ0bUtoerhFGDUSRQMnFog (big blind) showed [Qd 4d] and won ($1.90) with two pair, Jacks and Fours
Seat 2: kG34n23qFQA3nzdOJTQ1dA folded before Flop (didn't bet)
Seat 4: q6WfTUAD9mowIP63ASq2Dg mucked
Seat 5: 0av6tRNdi0Ui4f15L7gsVg (button) mucked
Seat 6: epAUIB7h2FJXzUPRIvSkRA (small blind) showed [3s 4s] and lost with two pair, Jacks and Fours




PokerStars Game #59941996272:  Hold'em No Limit ($0.10/$0.25) - 2009/07/01 1:52:46 ET
Table 'qryc9C/ELyQ3lubOaELNAQ' 6-max Seat #2 is the button
Seat 1: OZc6kkoTwtITj1ZfreJK1A ($84.30 in chips) 
Seat 2: LtASJ9OlkqGrrUKGQlpGAw ($29.45 in chips) 
Seat 4: v+QfkGiuj9bgtuNoVnDO8w ($25 in chips) 
Seat 5: 9StOHp+Y1T0K13JdgS2oQQ ($38.55 in chips) 
v+QfkGiuj9bgtuNoVnDO8w: posts small blind $0.10
9StOHp+Y1T0K13JdgS2oQQ: posts big blind $0.25
*** HOLE CARDS ***
OZc6kkoTwtITj1ZfreJK1A: folds 
LtASJ9OlkqGrrUKGQlpGAw: folds 
v+QfkGiuj9bgtuNoVnDO8w: folds 
Uncalled bet ($0.15) returned to 9StOHp+Y1T0K13JdgS2oQQ
9StOHp+Y1T0K13JdgS2oQQ collected $0.20 from pot
9StOHp+Y1T0K13JdgS2oQQ: doesn't show hand 
*** SUMMARY ***
Total pot $0.20 | Rake $0 
Seat 1: OZc6kkoTwtITj1ZfreJK1A folded before Flop (didn't bet)
Seat 2: LtASJ9OlkqGrrUKGQlpGAw (button) folded before Flop (didn't bet)
Seat 4: v+QfkGiuj9bgtuNoVnDO8w (small blind) folded before Flop
Seat 5: 9StOHp+Y1T0K13JdgS2oQQ (big blind) collected ($0.20)




PokerStars Game #59941996206:  Hold'em No Limit ($0.10/$0.25) - 2009/07/01 1:52:46 ET
Table '60nA7av6bws9VnNmVwculA' 6-max Seat #4 is the button
Seat 1: if4dh6jhJXeN3/qd3qCp9g ($25 in chips) 
Seat 2: Bada343Si4xKu3fNXY99AA ($5.40 in chips) 
Seat 3: mnuJq+Q1IXKm/pCy+OzxmQ ($25.60 in chips) 
Seat 4: +baiVgI/ETnBARLe5mARCw ($18.60 in chips) 
Seat 5: zXh+lOT41Q2iWgCNj+OcRw ($11.95 in chips) 
Seat 6: mfrkWA3PTeYPkbO6hi98Aw ($25 in chips) 
zXh+lOT41Q2iWgCNj+OcRw: posts small blind $0.10
mfrkWA3PTeYPkbO6hi98Aw: posts big blind $0.25
*** HOLE CARDS ***
if4dh6jhJXeN3/qd3qCp9g: folds 
Bada343Si4xKu3fNXY99AA: folds 
mnuJq+Q1IXKm/pCy+OzxmQ: folds 
+baiVgI/ETnBARLe5mARCw: folds 
zXh+lOT41Q2iWgCNj+OcRw: calls $0.15
mfrkWA3PTeYPkbO6hi98Aw: raises $1 to $1.25
zXh+lOT41Q2iWgCNj+OcRw: folds 
Uncalled bet ($1) returned to mfrkWA3PTeYPkbO6hi98Aw
mfrkWA3PTeYPkbO6hi98Aw collected $0.50 from pot
mfrkWA3PTeYPkbO6hi98Aw: doesn't show hand 
*** SUMMARY ***
Total pot $0.50 | Rake $0 
Seat 1: if4dh6jhJXeN3/qd3qCp9g folded before Flop (didn't bet)
Seat 2: Bada343Si4xKu3fNXY99AA folded before Flop (didn't bet)
Seat 3: mnuJq+Q1IXKm/pCy+OzxmQ folded before Flop (didn't bet)
Seat 4: +baiVgI/ETnBARLe5mARCw (button) folded before Flop (didn't bet)
Seat 5: zXh+lOT41Q2iWgCNj+OcRw (small blind) folded before Flop
Seat 6: mfrkWA3PTeYPkbO6hi98Aw (big blind) collected ($0.50)




PokerStars Game #59941995806:  Hold'em No Limit ($0.10/$0.25) - 2009/07/01 1:52:46 ET
Table 'UVjmXTtsmlX1HxwwZ59akg' 9-max Seat #7 is the button
Seat 1: zDrucyjVn5aeekNEc3cJrA ($48.10 in chips) 
Seat 2: q+Qdg0Hoir+SyL7haBrUnw ($7.80 in chips) 
Seat 3: GmzfAfxcxu1kGbPC+9LkVg ($27.55 in chips) 
Seat 5: Bb42QRQMhg5/Y0vHP8/2Xw ($39.45 in chips) 
Seat 6: st9jtdNbm1W5GfBwRaCVqQ ($24.10 in chips) 
Seat 7: d7YasxuGLPiL7pj8IcGThw ($4.40 in chips) 
Seat 8: aqxuKnMZWHy08QjWq1+MrQ ($3.35 in chips) 
aqxuKnMZWHy08QjWq1+MrQ: posts small blind $0.10
ljemhp25Zg+nlA9DLCIiUw: is sitting out 
zDrucyjVn5aeekNEc3cJrA: posts big blind $0.25
18G4P1XstjNvItdGUITxgw: sits out 
*** HOLE CARDS ***
q+Qdg0Hoir+SyL7haBrUnw: folds 
GmzfAfxcxu1kGbPC+9LkVg: folds 
Bb42QRQMhg5/Y0vHP8/2Xw: folds 
st9jtdNbm1W5GfBwRaCVqQ: folds 
d7YasxuGLPiL7pj8IcGThw: raises $0.25 to $0.50
aqxuKnMZWHy08QjWq1+MrQ: folds 
zDrucyjVn5aeekNEc3cJrA: folds 
Uncalled bet ($0.25) returned to d7YasxuGLPiL7pj8IcGThw
d7YasxuGLPiL7pj8IcGThw collected $0.60 from pot
*** SUMMARY ***
Total pot $0.60 | Rake $0 
Seat 1: zDrucyjVn5aeekNEc3cJrA (big blind) folded before Flop
Seat 2: q+Qdg0Hoir+SyL7haBrUnw folded before Flop (didn't bet)
Seat 3: GmzfAfxcxu1kGbPC+9LkVg folded before Flop (didn't bet)
Seat 5: Bb42QRQMhg5/Y0vHP8/2Xw folded before Flop (didn't bet)
Seat 6: st9jtdNbm1W5GfBwRaCVqQ folded before Flop (didn't bet)
Seat 7: d7YasxuGLPiL7pj8IcGThw (button) collected ($0.60)
Seat 8: aqxuKnMZWHy08QjWq1+MrQ (small blind) folded before Flop




PokerStars Game #59941996750:  Hold'em No Limit ($0.10/$0.25) - 2009/07/01 1:52:47 ET
Table '2VkNDXXsBj4bSZw/uK5atw' 6-max Seat #5 is the button
Seat 1: xrf8tAXKQHG99HixCot1Iw ($25 in chips) 
Seat 2: GbCVUNssQ7mqsPWr7J4d3w ($4.65 in chips) 
Seat 3: P+6Z5+8H5/Wyt/jHMovNvQ ($25.20 in chips) 
Seat 4: 4kIRqWKE/N0yUAcWVhLSoQ ($16.90 in chips) 
Seat 5: 7f0OkhFEOf3T+rVOFHRLnw ($19.15 in chips) 
Seat 6: n6UPMnVR4v8LFP0rWP73Fg ($11.60 in chips) 
n6UPMnVR4v8LFP0rWP73Fg: posts small blind $0.10
xrf8tAXKQHG99HixCot1Iw: posts big blind $0.25
*** HOLE CARDS ***
GbCVUNssQ7mqsPWr7J4d3w: folds 
P+6Z5+8H5/Wyt/jHMovNvQ: folds 
4kIRqWKE/N0yUAcWVhLSoQ: folds 
7f0OkhFEOf3T+rVOFHRLnw: calls $0.25
n6UPMnVR4v8LFP0rWP73Fg: calls $0.15
xrf8tAXKQHG99HixCot1Iw: checks 
*** FLOP *** [6h 5s 5c]
n6UPMnVR4v8LFP0rWP73Fg: checks 
xrf8tAXKQHG99HixCot1Iw: checks 
7f0OkhFEOf3T+rVOFHRLnw: checks 
*** TURN *** [6h 5s 5c] [3c]
n6UPMnVR4v8LFP0rWP73Fg: checks 
xrf8tAXKQHG99HixCot1Iw: checks 
7f0OkhFEOf3T+rVOFHRLnw: checks 
*** RIVER *** [6h 5s 5c 3c] [4c]
n6UPMnVR4v8LFP0rWP73Fg: bets $11.35 and is all-in
xrf8tAXKQHG99HixCot1Iw: folds 
7f0OkhFEOf3T+rVOFHRLnw: folds 
Uncalled bet ($11.35) returned to n6UPMnVR4v8LFP0rWP73Fg
n6UPMnVR4v8LFP0rWP73Fg collected $0.75 from pot
*** SUMMARY ***
Total pot $0.75 | Rake $0 
Board [6h 5s 5c 3c 4c]
Seat 1: xrf8tAXKQHG99HixCot1Iw (big blind) folded on the River
Seat 2: GbCVUNssQ7mqsPWr7J4d3w folded before Flop (didn't bet)
Seat 3: P+6Z5+8H5/Wyt/jHMovNvQ folded before Flop (didn't bet)
Seat 4: 4kIRqWKE/N0yUAcWVhLSoQ folded before Flop (didn't bet)
Seat 5: 7f0OkhFEOf3T+rVOFHRLnw (button) folded on the River
Seat 6: n6UPMnVR4v8LFP0rWP73Fg (small blind) collected ($0.75)




PokerStars Game #59941996738:  Hold'em No Limit ($0.10/$0.25) - 2009/07/01 1:52:47 ET
Table '7/qMNloI0nSXWiX5Y1watA' 9-max Seat #2 is the button
Seat 1: /LyhaB3V6jkgOfXORidqRQ ($9.90 in chips) 
Seat 2: wGigCmBR/9XWkPpvYos3aQ ($29.95 in chips) 
Seat 4: K0LdhPeU31rviEPo6Sv3TA ($9.20 in chips) 
Seat 5: GeMoapCKDLc4ajT0Uk9ZQw ($10 in chips) 
Seat 8: ljemhp25Zg+nlA9DLCIiUw ($25.95 in chips) 
Seat 9: dmYlc+1cjwZMJ7wV+Z0rRg ($27.75 in chips) 
K0LdhPeU31rviEPo6Sv3TA: posts small blind $0.10
GeMoapCKDLc4ajT0Uk9ZQw: posts big blind $0.25
JqeaikMej6KsqTKmUhl2Lw: sits out 
z5GxcHlYz/GSz6W2uFiTtg: sits out 
*** HOLE CARDS ***
ljemhp25Zg+nlA9DLCIiUw: folds 
dmYlc+1cjwZMJ7wV+Z0rRg: folds 
/LyhaB3V6jkgOfXORidqRQ: raises $0.25 to $0.50
wGigCmBR/9XWkPpvYos3aQ: folds 
K0LdhPeU31rviEPo6Sv3TA: folds 
GeMoapCKDLc4ajT0Uk9ZQw: folds 
Uncalled bet ($0.25) returned to /LyhaB3V6jkgOfXORidqRQ
/LyhaB3V6jkgOfXORidqRQ collected $0.60 from pot
*** SUMMARY ***
Total pot $0.60 | Rake $0 
Seat 1: /LyhaB3V6jkgOfXORidqRQ collected ($0.60)
Seat 2: wGigCmBR/9XWkPpvYos3aQ (button) folded before Flop (didn't bet)
Seat 4: K0LdhPeU31rviEPo6Sv3TA (small blind) folded before Flop
Seat 5: GeMoapCKDLc4ajT0Uk9ZQw (big blind) folded before Flop
Seat 8: ljemhp25Zg+nlA9DLCIiUw folded before Flop (didn't bet)
Seat 9: dmYlc+1cjwZMJ7wV+Z0rRg folded before Flop (didn't bet)




PokerStars Game #59941996508:  Hold'em No Limit ($0.10/$0.25) - 2009/07/01 1:52:47 ET
Table 'GxdLtCpYxqT4aAbYqkEEpw' 6-max Seat #6 is the button
Seat 1: 2d/PU00mMdO9azAaXqcSbw ($9.15 in chips) 
Seat 2: MCCWc70bl051s/EF6nHRcA ($23.65 in chips) 
Seat 3: LpmZGzLpOmfZUF7EV4ZlrQ ($15.90 in chips) 
Seat 4: 6wzJiRvp8HY6t+MQGnSIzA ($13.80 in chips) 
Seat 6: DFi/Lzkjsfv8QswS80JX9Q ($25 in chips) 
2d/PU00mMdO9azAaXqcSbw: posts small blind $0.10
MCCWc70bl051s/EF6nHRcA: posts big blind $0.25
*** HOLE CARDS ***
LpmZGzLpOmfZUF7EV4ZlrQ: folds 
6wzJiRvp8HY6t+MQGnSIzA: calls $0.25
DFi/Lzkjsfv8QswS80JX9Q: raises $1 to $1.25
2d/PU00mMdO9azAaXqcSbw: folds 
MCCWc70bl051s/EF6nHRcA: folds 
6wzJiRvp8HY6t+MQGnSIzA: folds 
Uncalled bet ($1) returned to DFi/Lzkjsfv8QswS80JX9Q
DFi/Lzkjsfv8QswS80JX9Q collected $0.85 from pot
DFi/Lzkjsfv8QswS80JX9Q: doesn't show hand 
*** SUMMARY ***
Total pot $0.85 | Rake $0 
Seat 1: 2d/PU00mMdO9azAaXqcSbw (small blind) folded before Flop
Seat 2: MCCWc70bl051s/EF6nHRcA (big blind) folded before Flop
Seat 3: LpmZGzLpOmfZUF7EV4ZlrQ folded before Flop (didn't bet)
Seat 4: 6wzJiRvp8HY6t+MQGnSIzA folded before Flop
Seat 6: DFi/Lzkjsfv8QswS80JX9Q (button) collected ($0.85)




PokerStars Game #59941996386:  Hold'em No Limit ($0.10/$0.25) - 2009/07/01 1:52:47 ET
Table '1HT8bEDpLPhOXxmqMtzF8w' 9-max Seat #1 is the button
Seat 1: YkkKQUDI0iWatY4h0WWaAQ ($12.15 in chips) 
Seat 2: r6hsffOo1iKmaPYKwAZmFw ($28.75 in chips) 
Seat 3: oLa/tXLfSLLB28mcLGrxcg ($23.50 in chips) 
Seat 4: YaTpJQaFLj1usIcoGPRVJQ ($5 in chips) 
Seat 5: z5GxcHlYz/GSz6W2uFiTtg ($25.50 in chips) 
Seat 6: bXpVeaSTPBFSPJmeXxO7nw ($5.90 in chips) 
Seat 7: PMhmqYBPHOAXjH25lRz69g ($17.10 in chips) 
Seat 8: ghNKXUBl/H+t83JF079ZBA ($33.30 in chips) 
Seat 9: Z9W7+g1WMhhZDi7DwGbCFA ($5 in chips) 
r6hsffOo1iKmaPYKwAZmFw: posts small blind $0.10
oLa/tXLfSLLB28mcLGrxcg: posts big blind $0.25
YaTpJQaFLj1usIcoGPRVJQ: posts big blind $0.25
*** HOLE CARDS ***
YaTpJQaFLj1usIcoGPRVJQ: checks 
z5GxcHlYz/GSz6W2uFiTtg: calls $0.25
bXpVeaSTPBFSPJmeXxO7nw: folds 
PMhmqYBPHOAXjH25lRz69g: folds 
ghNKXUBl/H+t83JF079ZBA: folds 
Z9W7+g1WMhhZDi7DwGbCFA: folds 
YkkKQUDI0iWatY4h0WWaAQ: folds 
r6hsffOo1iKmaPYKwAZmFw: calls $0.15
oLa/tXLfSLLB28mcLGrxcg: checks 
*** FLOP *** [4d Ah Jc]
r6hsffOo1iKmaPYKwAZmFw: checks 
oLa/tXLfSLLB28mcLGrxcg: checks 
YaTpJQaFLj1usIcoGPRVJQ: checks 
z5GxcHlYz/GSz6W2uFiTtg: checks 
*** TURN *** [4d Ah Jc] [2s]
r6hsffOo1iKmaPYKwAZmFw: checks 
oLa/tXLfSLLB28mcLGrxcg: checks 
YaTpJQaFLj1usIcoGPRVJQ: bets $0.25
z5GxcHlYz/GSz6W2uFiTtg: folds 
r6hsffOo1iKmaPYKwAZmFw: calls $0.25
oLa/tXLfSLLB28mcLGrxcg: folds 
*** RIVER *** [4d Ah Jc 2s] [5c]
r6hsffOo1iKmaPYKwAZmFw: checks 
YaTpJQaFLj1usIcoGPRVJQ: bets $0.25
r6hsffOo1iKmaPYKwAZmFw: calls $0.25
*** SHOW DOWN ***
YaTpJQaFLj1usIcoGPRVJQ: shows [Jh 5s] (two pair, Jacks and Fives)
r6hsffOo1iKmaPYKwAZmFw: mucks hand 
YaTpJQaFLj1usIcoGPRVJQ collected $1.95 from pot
*** SUMMARY ***
Total pot $2 | Rake $0.05 
Board [4d Ah Jc 2s 5c]
Seat 1: YkkKQUDI0iWatY4h0WWaAQ (button) folded before Flop (didn't bet)
Seat 2: r6hsffOo1iKmaPYKwAZmFw (small blind) mucked
Seat 3: oLa/tXLfSLLB28mcLGrxcg (big blind) folded on the Turn
Seat 4: YaTpJQaFLj1usIcoGPRVJQ showed [Jh 5s] and won ($1.95) with two pair, Jacks and Fives
Seat 5: z5GxcHlYz/GSz6W2uFiTtg folded on the Turn
Seat 6: bXpVeaSTPBFSPJmeXxO7nw folded before Flop (didn't bet)
Seat 7: PMhmqYBPHOAXjH25lRz69g folded before Flop (didn't bet)
Seat 8: ghNKXUBl/H+t83JF079ZBA folded before Flop (didn't bet)
Seat 9: Z9W7+g1WMhhZDi7DwGbCFA folded before Flop (didn't bet)




PokerStars Game #59941996536:  Hold'em No Limit ($0.10/$0.25) - 2009/07/01 1:52:47 ET
Table 'WEMI3Mtn7dGARDbgNrKibgoG007Tb0LYbfANo6QWd16wx Seat #2 is the button
Seat 1: DiSvPC2iudwL5j9u6Huyww ($46.30 in chips) 
Seat 2: zDrucyjVn5aeekNEc3cJrA ($14.25 in chips) 
Seat 3: pN3IHvAKm2fz+sTRARTcrg ($24.75 in chips) 
Seat 4: zgi+EUykT/pZQpoUG6+oEg ($5 in chips) 
Seat 5: 8f0dtuUGqDbgE6up1lQAlg ($5.95 in chips) 
Seat 6: yqkowiRWZ6NvRN9UUkYIlA ($5 in chips) 
Seat 7: Mh2r9hTeTEDnh19sRZtW3g ($5 in chips) 
Seat 8: q4cNXFZGNhLfrTyVrIy6Mg ($15.30 in chips) 
Seat 9: EVqHvqty1ZsuvDFiSXlSqQ ($28.60 in chips) 
pN3IHvAKm2fz+sTRARTcrg: posts small blind $0.10
zgi+EUykT/pZQpoUG6+oEg: posts big blind $0.25
*** HOLE CARDS ***
8f0dtuUGqDbgE6up1lQAlg: calls $0.25
yqkowiRWZ6NvRN9UUkYIlA: folds 
Mh2r9hTeTEDnh19sRZtW3g: folds 
q4cNXFZGNhLfrTyVrIy6Mg: calls $0.25
EVqHvqty1ZsuvDFiSXlSqQ: folds 
DiSvPC2iudwL5j9u6Huyww: folds 
zDrucyjVn5aeekNEc3cJrA: folds 
pN3IHvAKm2fz+sTRARTcrg: folds 
zgi+EUykT/pZQpoUG6+oEg: checks 
*** FLOP *** [Jc 4c Qc]
zgi+EUykT/pZQpoUG6+oEg: checks 
8f0dtuUGqDbgE6up1lQAlg: checks 
q4cNXFZGNhLfrTyVrIy6Mg: bets $0.25
zgi+EUykT/pZQpoUG6+oEg: folds 
8f0dtuUGqDbgE6up1lQAlg: calls $0.25
*** TURN *** [Jc 4c Qc] [3d]
8f0dtuUGqDbgE6up1lQAlg: checks 
q4cNXFZGNhLfrTyVrIy6Mg: checks 
*** RIVER *** [Jc 4c Qc 3d] [9c]
8f0dtuUGqDbgE6up1lQAlg: bets $3.75
q4cNXFZGNhLfrTyVrIy6Mg: folds 
Uncalled bet ($3.75) returned to 8f0dtuUGqDbgE6up1lQAlg
8f0dtuUGqDbgE6up1lQAlg collected $1.30 from pot
*** SUMMARY ***
Total pot $1.35 | Rake $0.05 
Board [Jc 4c Qc 3d 9c]
Seat 1: DiSvPC2iudwL5j9u6Huyww folded before Flop (didn't bet)
Seat 2: zDrucyjVn5aeekNEc3cJrA (button) folded before Flop (didn't bet)
Seat 3: pN3IHvAKm2fz+sTRARTcrg (small blind) folded before Flop
Seat 4: zgi+EUykT/pZQpoUG6+oEg (big blind) folded on the Flop
Seat 5: 8f0dtuUGqDbgE6up1lQAlg collected ($1.30)
Seat 6: yqkowiRWZ6NvRN9UUkYIlA folded before Flop (didn't bet)
Seat 7: Mh2r9hTeTEDnh19sRZtW3g folded before Flop (didn't bet)
Seat 8: q4cNXFZGNhLfrTyVrIy6Mg folded on the River
Seat 9: EVqHvqty1ZsuvDFiSXlSqQ folded before Flop (didn't bet)




PokerStars Game #59941997248:  Hold'em No Limit ($0.10/$0.25) - 2009/07/01 1:52:48 ET
Table 'NfXsh0UQA+o/kO9acV3WxA' 9-max Seat #5 is the button
Seat 1: pN3IHvAKm2fz+sTRARTcrg ($25 in chips) 
Seat 2: mhpFs2SZupy4zLRb62FLFA ($24.65 in chips) 
Seat 3: wCUaomJ6Nq5zomVGdUHP+w ($20 in chips) 
Seat 4: r6hsffOo1iKmaPYKwAZmFw ($30.05 in chips) 
Seat 5: zgi+EUykT/pZQpoUG6+oEg ($4.30 in chips) 
Seat 6: qwr38jl5txoR36M7G5qi4A ($10 in chips) 
Seat 7: yqkowiRWZ6NvRN9UUkYIlA ($5 in chips) 
Seat 8: +sbyWwIcFp9kP0bDtMegfQ ($40.60 in chips) 
Seat 9: uhrboV251dcgYniYTdFIcA ($29.45 in chips) 
qwr38jl5txoR36M7G5qi4A: posts small blind $0.10
yqkowiRWZ6NvRN9UUkYIlA: posts big blind $0.25
*** HOLE CARDS ***
+sbyWwIcFp9kP0bDtMegfQ: folds 
uhrboV251dcgYniYTdFIcA: folds 
pN3IHvAKm2fz+sTRARTcrg: folds 
mhpFs2SZupy4zLRb62FLFA: folds 
wCUaomJ6Nq5zomVGdUHP+w: folds 
r6hsffOo1iKmaPYKwAZmFw: raises $0.75 to $1
zgi+EUykT/pZQpoUG6+oEg: folds 
qwr38jl5txoR36M7G5qi4A: folds 
yqkowiRWZ6NvRN9UUkYIlA: folds 
Uncalled bet ($0.75) returned to r6hsffOo1iKmaPYKwAZmFw
r6hsffOo1iKmaPYKwAZmFw collected $0.60 from pot
r6hsffOo1iKmaPYKwAZmFw: doesn't show hand 
*** SUMMARY ***
Total pot $0.60 | Rake $0 
Seat 1: pN3IHvAKm2fz+sTRARTcrg folded before Flop (didn't bet)
Seat 2: mhpFs2SZupy4zLRb62FLFA folded before Flop (didn't bet)
Seat 3: wCUaomJ6Nq5zomVGdUHP+w folded before Flop (didn't bet)
Seat 4: r6hsffOo1iKmaPYKwAZmFw collected ($0.60)
Seat 5: zgi+EUykT/pZQpoUG6+oEg (button) folded before Flop (didn't bet)
Seat 6: qwr38jl5txoR36M7G5qi4A (small blind) folded before Flop
Seat 7: yqkowiRWZ6NvRN9UUkYIlA (big blind) folded before Flop
Seat 8: +sbyWwIcFp9kP0bDtMegfQ folded before Flop (didn't bet)
Seat 9: uhrboV251dcgYniYTdFIcA folded before Flop (didn't bet)




PokerStars Game #59941997142:  Hold'em No Limit ($0.10/$0.25) - 2009/07/01 1:52:48 ET
Table 'C47I7CmrmFr8Oo7wOovVwQ' 6-max Seat #6 is the button
Seat 1: aKCh+0w6BCOX3sJAdIVLMw ($5.90 in chips) 
Seat 2: 8JTm/CXBn3+kuQgcUOgPkw ($24.40 in chips) 
Seat 4: yY5JuFtDfXWRaZlVby4LLw ($8.60 in chips) 
Seat 5: or309yYY9Y9bfFWtrB0yUg ($5.10 in chips) 
Seat 6: pD7ri5wL3vsa6S1ulMYQmQ ($26.25 in chips) 
aKCh+0w6BCOX3sJAdIVLMw: posts small blind $0.10
8JTm/CXBn3+kuQgcUOgPkw: posts big blind $0.25
p4qhycZstfeeDkKv3zEBjw: sits out 
*** HOLE CARDS ***
yY5JuFtDfXWRaZlVby4LLw: folds 
or309yYY9Y9bfFWtrB0yUg: raises $0.25 to $0.50
pD7ri5wL3vsa6S1ulMYQmQ: raises $1.50 to $2
aKCh+0w6BCOX3sJAdIVLMw: folds 
8JTm/CXBn3+kuQgcUOgPkw: folds 
or309yYY9Y9bfFWtrB0yUg: raises $3.10 to $5.10 and is all-in
pD7ri5wL3vsa6S1ulMYQmQ: calls $3.10
*** FLOP *** [Jc 4c 8s]
*** TURN *** [Jc 4c 8s] [Kh]
*** RIVER *** [Jc 4c 8s Kh] [5h]
*** SHOW DOWN ***
or309yYY9Y9bfFWtrB0yUg: shows [Kc Qs] (a pair of Kings)
pD7ri5wL3vsa6S1ulMYQmQ: shows [As Ad] (a pair of Aces)
pD7ri5wL3vsa6S1ulMYQmQ collected $10.05 from pot
*** SUMMARY ***
Total pot $10.55 | Rake $0.50 
Board [Jc 4c 8s Kh 5h]
Seat 1: aKCh+0w6BCOX3sJAdIVLMw (small blind) folded before Flop
Seat 2: 8JTm/CXBn3+kuQgcUOgPkw (big blind) folded before Flop
Seat 4: yY5JuFtDfXWRaZlVby4LLw folded before Flop (didn't bet)
Seat 5: or309yYY9Y9bfFWtrB0yUg showed [Kc Qs] and lost with a pair of Kings
Seat 6: pD7ri5wL3vsa6S1ulMYQmQ (button) showed [As Ad] and won ($10.05) with a pair of Aces




PokerStars Game #59941997740:  Hold'em No Limit ($0.10/$0.25) - 2009/07/01 1:52:49 ET
Table 'Of/T60zpXg1GcjrZ7Lm//Q' 9-max Seat #4 is the button
Seat 1: Lro4e37x4FUa5P3yzDjskw ($20 in chips) 
Seat 2: qwr38jl5txoR36M7G5qi4A ($12.60 in chips) 
Seat 3: 6RiVTYll/5D8zICp0MRpKw ($22.50 in chips) 
Seat 4: Czut6V7acIqUJrrobjKAZg ($6.45 in chips) 
Seat 5: 6mStmDUknIn/RyBEoiIyoQ ($5.75 in chips) 
Seat 7: PVxvfRTRvkgZf9WtquEkwQ ($25 in chips) 
Seat 8: ghNKXUBl/H+t83JF079ZBA ($26.50 in chips) 
Seat 9: egvg3mTBBVzMHnJPIQiKcA ($15.05 in chips) 
6mStmDUknIn/RyBEoiIyoQ: posts small blind $0.10
tYsOBqdU1+x+yFI7zHO7hQ: is sitting out 
PVxvfRTRvkgZf9WtquEkwQ: posts big blind $0.25
*** HOLE CARDS ***
ghNKXUBl/H+t83JF079ZBA: folds 
egvg3mTBBVzMHnJPIQiKcA: folds 
Lro4e37x4FUa5P3yzDjskw: folds 
qwr38jl5txoR36M7G5qi4A: folds 
6RiVTYll/5D8zICp0MRpKw: folds 
Czut6V7acIqUJrrobjKAZg: raises $0.75 to $1
6mStmDUknIn/RyBEoiIyoQ: folds 
PVxvfRTRvkgZf9WtquEkwQ: folds 
Uncalled bet ($0.75) returned to Czut6V7acIqUJrrobjKAZg
Czut6V7acIqUJrrobjKAZg collected $0.60 from pot
*** SUMMARY ***
Total pot $0.60 | Rake $0 
Seat 1: Lro4e37x4FUa5P3yzDjskw folded before Flop (didn't bet)
Seat 2: qwr38jl5txoR36M7G5qi4A folded before Flop (didn't bet)
Seat 3: 6RiVTYll/5D8zICp0MRpKw folded before Flop (didn't bet)
Seat 4: Czut6V7acIqUJrrobjKAZg (button) collected ($0.60)
Seat 5: 6mStmDUknIn/RyBEoiIyoQ (small blind) folded before Flop
Seat 7: PVxvfRTRvkgZf9WtquEkwQ (big blind) folded before Flop
Seat 8: ghNKXUBl/H+t83JF079ZBA folded before Flop (didn't bet)
Seat 9: egvg3mTBBVzMHnJPIQiKcA folded before Flop (didn't bet)




PokerStars Game #59941997594:  Hold'em No Limit ($0.10/$0.25) - 2009/07/01 1:52:49 ET
Table 'eOXPe2c6mG7DOFKvMsZZfA' 6-max Seat #6 is the button
Seat 2: gaPMxLGp9SOj4Lq6t+/0Ig ($12.05 in chips) 
Seat 3: kReyZ6g6Fu3tQ0nyjDf9kA ($23.85 in chips) 
Seat 4: zHHLkD2sRljslKKeQv/ZQw ($31.50 in chips) 
Seat 5: NhUN/JpAprdJeamFBgJH1w ($33.20 in chips) 
Seat 6: Qpv/hb5ak7LeaDig1L5L8w ($13.35 in chips) 
gaPMxLGp9SOj4Lq6t+/0Ig: posts small blind $0.10
kReyZ6g6Fu3tQ0nyjDf9kA: posts big blind $0.25
*** HOLE CARDS ***
zHHLkD2sRljslKKeQv/ZQw: folds 
NhUN/JpAprdJeamFBgJH1w: raises $0.75 to $1
Qpv/hb5ak7LeaDig1L5L8w: folds 
gaPMxLGp9SOj4Lq6t+/0Ig: raises $11.05 to $12.05 and is all-in
kReyZ6g6Fu3tQ0nyjDf9kA: folds 
NhUN/JpAprdJeamFBgJH1w: folds 
Uncalled bet ($11.05) returned to gaPMxLGp9SOj4Lq6t+/0Ig
gaPMxLGp9SOj4Lq6t+/0Ig collected $2.25 from pot
gaPMxLGp9SOj4Lq6t+/0Ig: doesn't show hand 
*** SUMMARY ***
Total pot $2.25 | Rake $0 
Seat 2: gaPMxLGp9SOj4Lq6t+/0Ig (small blind) collected ($2.25)
Seat 3: kReyZ6g6Fu3tQ0nyjDf9kA (big blind) folded before Flop
Seat 4: zHHLkD2sRljslKKeQv/ZQw folded before Flop (didn't bet)
Seat 5: NhUN/JpAprdJeamFBgJH1w folded before Flop
Seat 6: Qpv/hb5ak7LeaDig1L5L8w (button) folded before Flop (didn't bet)




PokerStars Game #59941997636:  Hold'em No Limit ($0.10/$0.25) - 2009/07/01 1:52:49 ET
Table 'nB7Q7zfNfy6ig6DB+rsgWQ' 6-max Seat #1 is the button
Seat 1: Hzy03WtPHMYwLYM7hTTxQw ($33.75 in chips) 
Seat 2: 4BHo0wlX9INjkj2727qE0w ($30.20 in chips) 
Seat 3: p3NYOxYhkL7txPRSeXHDeg ($29.75 in chips) 
Seat 4: DihMHaz4WNETH1bPDe13kA ($80.70 in chips) 
Seat 5: xC0kaiDYM6YTlgODL83O5A ($22.05 in chips) 
4BHo0wlX9INjkj2727qE0w: posts small blind $0.10
p3NYOxYhkL7txPRSeXHDeg: posts big blind $0.25
*** HOLE CARDS ***
Joe Santana joins the table at seat #6 
DihMHaz4WNETH1bPDe13kA: folds 
xC0kaiDYM6YTlgODL83O5A: folds 
Hzy03WtPHMYwLYM7hTTxQw: raises $0.75 to $1
4BHo0wlX9INjkj2727qE0w: calls $0.90
p3NYOxYhkL7txPRSeXHDeg: folds 
*** FLOP *** [Jh 6d 5c]
4BHo0wlX9INjkj2727qE0w: bets $0.75
Hzy03WtPHMYwLYM7hTTxQw: raises $1.75 to $2.50
4BHo0wlX9INjkj2727qE0w: calls $1.75
*** TURN *** [Jh 6d 5c] [2d]
4BHo0wlX9INjkj2727qE0w: checks 
Hzy03WtPHMYwLYM7hTTxQw: bets $5.50
4BHo0wlX9INjkj2727qE0w: calls $5.50
*** RIVER *** [Jh 6d 5c 2d] [Jc]
4BHo0wlX9INjkj2727qE0w: checks 
Hzy03WtPHMYwLYM7hTTxQw: checks 
*** SHOW DOWN ***
4BHo0wlX9INjkj2727qE0w: shows [7h 8c] (a pair of Jacks)
Hzy03WtPHMYwLYM7hTTxQw: shows [Jd Td] (three of a kind, Jacks)
Hzy03WtPHMYwLYM7hTTxQw collected $17.40 from pot
*** SUMMARY ***
Total pot $18.25 | Rake $0.85 
Board [Jh 6d 5c 2d Jc]
Seat 1: Hzy03WtPHMYwLYM7hTTxQw (button) showed [Jd Td] and won ($17.40) with three of a kind, Jacks
Seat 2: 4BHo0wlX9INjkj2727qE0w (small blind) showed [7h 8c] and lost with a pair of Jacks
Seat 3: p3NYOxYhkL7txPRSeXHDeg (big blind) folded before Flop
Seat 4: DihMHaz4WNETH1bPDe13kA folded before Flop (didn't bet)
Seat 5: xC0kaiDYM6YTlgODL83O5A folded before Flop (didn't bet)




PokerStars Game #59941997350:  Hold'em No Limit ($0.10/$0.25) - 2009/07/01 1:52:49 ET
Table 'HzFR0rxmDAPu5GzYR0AlYg' 6-max Seat #4 is the button
Seat 1: v+QfkGiuj9bgtuNoVnDO8w ($35.15 in chips) 
Seat 2: UA5OsKS3VPaxa7uC8La/kA ($52.55 in chips) 
Seat 3: kG34n23qFQA3nzdOJTQ1dA ($23.55 in chips) 
Seat 4: Mhj3q7cxev+XjXZxEE6/Cw ($25 in chips) 
Seat 6: jp34e617tIzV8tKIWmfAbA ($35.40 in chips) 
jp34e617tIzV8tKIWmfAbA: posts small blind $0.10
v+QfkGiuj9bgtuNoVnDO8w: posts big blind $0.25
*** HOLE CARDS ***
UA5OsKS3VPaxa7uC8La/kA: folds 
kG34n23qFQA3nzdOJTQ1dA: folds 
Mhj3q7cxev+XjXZxEE6/Cw: raises $0.50 to $0.75
jp34e617tIzV8tKIWmfAbA: folds 
v+QfkGiuj9bgtuNoVnDO8w: folds 
Uncalled bet ($0.50) returned to Mhj3q7cxev+XjXZxEE6/Cw
Mhj3q7cxev+XjXZxEE6/Cw collected $0.60 from pot
Mhj3q7cxev+XjXZxEE6/Cw: doesn't show hand 
*** SUMMARY ***
Total pot $0.60 | Rake $0 
Seat 1: v+QfkGiuj9bgtuNoVnDO8w (big blind) folded before Flop
Seat 2: UA5OsKS3VPaxa7uC8La/kA folded before Flop (didn't bet)
Seat 3: kG34n23qFQA3nzdOJTQ1dA folded before Flop (didn't bet)
Seat 4: Mhj3q7cxev+XjXZxEE6/Cw (button) collected ($0.60)
Seat 6: jp34e617tIzV8tKIWmfAbA (small blind) folded before Flop




PokerStars Game #59941997568:  Hold'em No Limit ($0.10/$0.25) - 2009/07/01 1:52:49 ET
Table 'oZuNsbNJuUyQLGKzQ/4JFg' 6-max Seat #3 is the button
Seat 1: vqWjZmdQu/Hxw96/IJTWdQ ($25 in chips) 
Seat 2: UA5OsKS3VPaxa7uC8La/kA ($35.05 in chips) 
Seat 3: 8ClCHtFXGNplITm+63KB+Q ($50.30 in chips) 
Seat 4: 9bpVv1/Qh9IYtXuCtl5VtQ ($30.70 in chips) 
Seat 5: oBUDUfeUyCbZBsjxHZgSiw ($11.40 in chips) 
Seat 6: fwg6dK1+r4jy/y+JqenYYQ ($24.60 in chips) 
9bpVv1/Qh9IYtXuCtl5VtQ: posts small blind $0.10
oBUDUfeUyCbZBsjxHZgSiw: posts big blind $0.25
*** HOLE CARDS ***
fwg6dK1+r4jy/y+JqenYYQ: folds 
vqWjZmdQu/Hxw96/IJTWdQ: raises $0.75 to $1
UA5OsKS3VPaxa7uC8La/kA: folds 
8ClCHtFXGNplITm+63KB+Q: folds 
9bpVv1/Qh9IYtXuCtl5VtQ: folds 
oBUDUfeUyCbZBsjxHZgSiw: folds 
Uncalled bet ($0.75) returned to vqWjZmdQu/Hxw96/IJTWdQ
vqWjZmdQu/Hxw96/IJTWdQ collected $0.60 from pot
vqWjZmdQu/Hxw96/IJTWdQ: doesn't show hand 
*** SUMMARY ***
Total pot $0.60 | Rake $0 
Seat 1: vqWjZmdQu/Hxw96/IJTWdQ collected ($0.60)
Seat 2: UA5OsKS3VPaxa7uC8La/kA folded before Flop (didn't bet)
Seat 3: 8ClCHtFXGNplITm+63KB+Q (button) folded before Flop (didn't bet)
Seat 4: 9bpVv1/Qh9IYtXuCtl5VtQ (small blind) folded before Flop
Seat 5: oBUDUfeUyCbZBsjxHZgSiw (big blind) folded before Flop
Seat 6: fwg6dK1+r4jy/y+JqenYYQ folded before Flop (didn't bet)




PokerStars Game #59941997774:  Hold'em No Limit ($0.10/$0.25) - 2009/07/01 1:52:49 ET
Table 'KEoOIegxPF91KooL2AelUA' 6-max Seat #5 is the button
Seat 1: 32YL2ZEp8NT4JB2RVM9euQ ($16.65 in chips) 
Seat 2: 0Bg59Tnte1Tc7C4i9Jd9cQ ($5.85 in chips) 
Seat 3: zxeVQGaMKDsDzmSY+AInjA ($9.25 in chips) 
Seat 4: Wo60l2GQnSEc3bxPVyvIUw ($8.85 in chips) 
Seat 5: VXTONriS+Ohik+r0FeicIw ($27.20 in chips) 
Seat 6: AMrBn4Vx9aAo/vv6WHLk6w ($3 in chips) 
AMrBn4Vx9aAo/vv6WHLk6w: posts small blind $0.10
32YL2ZEp8NT4JB2RVM9euQ: posts big blind $0.25
*** HOLE CARDS ***
0Bg59Tnte1Tc7C4i9Jd9cQ: folds 
zxeVQGaMKDsDzmSY+AInjA: folds 
Wo60l2GQnSEc3bxPVyvIUw: calls $0.25
VXTONriS+Ohik+r0FeicIw: folds 
AMrBn4Vx9aAo/vv6WHLk6w: raises $0.75 to $1
32YL2ZEp8NT4JB2RVM9euQ: calls $0.75
Wo60l2GQnSEc3bxPVyvIUw: calls $0.75
*** FLOP *** [Tc 6h 5d]
AMrBn4Vx9aAo/vv6WHLk6w: bets $2 and is all-in
32YL2ZEp8NT4JB2RVM9euQ: folds 
Wo60l2GQnSEc3bxPVyvIUw: calls $2
*** TURN *** [Tc 6h 5d] [Jh]
*** RIVER *** [Tc 6h 5d Jh] [Ts]
*** SHOW DOWN ***
AMrBn4Vx9aAo/vv6WHLk6w: shows [Ad Jd] (two pair, Jacks and Tens)
Wo60l2GQnSEc3bxPVyvIUw: mucks hand 
AMrBn4Vx9aAo/vv6WHLk6w collected $6.70 from pot
*** SUMMARY ***
Total pot $7 | Rake $0.30 
Board [Tc 6h 5d Jh Ts]
Seat 1: 32YL2ZEp8NT4JB2RVM9euQ (big blind) folded on the Flop
Seat 2: 0Bg59Tnte1Tc7C4i9Jd9cQ folded before Flop (didn't bet)
Seat 3: zxeVQGaMKDsDzmSY+AInjA folded before Flop (didn't bet)
Seat 4: Wo60l2GQnSEc3bxPVyvIUw mucked
Seat 5: VXTONriS+Ohik+r0FeicIw (button) folded before Flop (didn't bet)
Seat 6: AMrBn4Vx9aAo/vv6WHLk6w (small blind) showed [Ad Jd] and won ($6.70) with two pair, Jacks and Tens




PokerStars Game #59941997872:  Hold'em No Limit ($0.10/$0.25) - 2009/07/01 1:52:50 ET
Table 'rhQuIjJo0UQ7RRUlF9umHg' 6-max Seat #3 is the button
Seat 1: 5O3Hj9Qg0SqOyKEXoLpjPg ($180.05 in chips) 
Seat 2: Ew/TYPQIsbQ2X8nm5iAJBg ($25.35 in chips) 
Seat 3: if4dh6jhJXeN3/qd3qCp9g ($27.05 in chips) 
Seat 4: aogAb4Eienxztk8p2v9VVw ($25.20 in chips) 
Seat 5: dOX4wnYV2sEqvDbF+8KSCw ($66.55 in chips) 
Seat 6: /gJNBeCkWL4o85/jvlZ4BA ($47.70 in chips) 
aogAb4Eienxztk8p2v9VVw: posts small blind $0.10
dOX4wnYV2sEqvDbF+8KSCw: posts big blind $0.25
*** HOLE CARDS ***
/gJNBeCkWL4o85/jvlZ4BA: calls $0.25
5O3Hj9Qg0SqOyKEXoLpjPg: raises $1 to $1.25
Ew/TYPQIsbQ2X8nm5iAJBg: folds 
if4dh6jhJXeN3/qd3qCp9g: folds 
aogAb4Eienxztk8p2v9VVw: calls $1.15
dOX4wnYV2sEqvDbF+8KSCw: folds 
/gJNBeCkWL4o85/jvlZ4BA: calls $1
*** FLOP *** [Kh 6d 8h]
aogAb4Eienxztk8p2v9VVw: checks 
/gJNBeCkWL4o85/jvlZ4BA: checks 
5O3Hj9Qg0SqOyKEXoLpjPg: bets $0.75
aogAb4Eienxztk8p2v9VVw: calls $0.75
/gJNBeCkWL4o85/jvlZ4BA: folds 
*** TURN *** [Kh 6d 8h] [Js]
aogAb4Eienxztk8p2v9VVw: checks 
5O3Hj9Qg0SqOyKEXoLpjPg: checks 
*** RIVER *** [Kh 6d 8h Js] [3c]
aogAb4Eienxztk8p2v9VVw: checks 
5O3Hj9Qg0SqOyKEXoLpjPg: checks 
*** SHOW DOWN ***
aogAb4Eienxztk8p2v9VVw: shows [Qh Qc] (a pair of Queens)
5O3Hj9Qg0SqOyKEXoLpjPg: mucks hand 
aogAb4Eienxztk8p2v9VVw collected $5.25 from pot
*** SUMMARY ***
Total pot $5.50 | Rake $0.25 
Board [Kh 6d 8h Js 3c]
Seat 1: 5O3Hj9Qg0SqOyKEXoLpjPg mucked
Seat 2: Ew/TYPQIsbQ2X8nm5iAJBg folded before Flop (didn't bet)
Seat 3: if4dh6jhJXeN3/qd3qCp9g (button) folded before Flop (didn't bet)
Seat 4: aogAb4Eienxztk8p2v9VVw (small blind) showed [Qh Qc] and won ($5.25) with a pair of Queens
Seat 5: dOX4wnYV2sEqvDbF+8KSCw (big blind) folded before Flop
Seat 6: /gJNBeCkWL4o85/jvlZ4BA folded on the Flop




PokerStars Game #59941998118:  Hold'em No Limit ($0.10/$0.25) - 2009/07/01 1:52:50 ET
Table 'AJGgX1ZYM8d68SWMvaLttg' 6-max Seat #3 is the button
Seat 1: Q1uciOZPBR/WkAlqa6cL4A ($25 in chips) 
Seat 2: zHHLkD2sRljslKKeQv/ZQw ($26.60 in chips) 
Seat 3: 8ClCHtFXGNplITm+63KB+Q ($38.45 in chips) 
Seat 4: e30C3DfdG5TfPnR16/oMmA ($22.25 in chips) 
Seat 5: GbCVUNssQ7mqsPWr7J4d3w ($5 in chips) 
Seat 6: UA5OsKS3VPaxa7uC8La/kA ($62.25 in chips) 
e30C3DfdG5TfPnR16/oMmA: posts small blind $0.10
GbCVUNssQ7mqsPWr7J4d3w: posts big blind $0.25
*** HOLE CARDS ***
UA5OsKS3VPaxa7uC8La/kA: folds 
Q1uciOZPBR/WkAlqa6cL4A: folds 
zHHLkD2sRljslKKeQv/ZQw: raises $0.50 to $0.75
8ClCHtFXGNplITm+63KB+Q: folds 
e30C3DfdG5TfPnR16/oMmA: folds 
GbCVUNssQ7mqsPWr7J4d3w: raises $4.25 to $5 and is all-in
zHHLkD2sRljslKKeQv/ZQw: folds 
Uncalled bet ($4.25) returned to GbCVUNssQ7mqsPWr7J4d3w
GbCVUNssQ7mqsPWr7J4d3w collected $1.60 from pot
GbCVUNssQ7mqsPWr7J4d3w: doesn't show hand 
*** SUMMARY ***
Total pot $1.60 | Rake $0 
Seat 1: Q1uciOZPBR/WkAlqa6cL4A folded before Flop (didn't bet)
Seat 2: zHHLkD2sRljslKKeQv/ZQw folded before Flop
Seat 3: 8ClCHtFXGNplITm+63KB+Q (button) folded before Flop (didn't bet)
Seat 4: e30C3DfdG5TfPnR16/oMmA (small blind) folded before Flop
Seat 5: GbCVUNssQ7mqsPWr7J4d3w (big blind) collected ($1.60)
Seat 6: UA5OsKS3VPaxa7uC8La/kA folded before Flop (didn't bet)




PokerStars Game #59941998206:  Hold'em No Limit ($0.10/$0.25) - 2009/07/01 1:52:50 ET
Table '5NipxzzFB2DffzDpddyQoQ' 6-max Seat #3 is the button
Seat 1: W87HPwOk1KtWaYyshBe1gA ($20.40 in chips) 
Seat 2: iauW7L/+7qzAuHow7CD75Q ($4.65 in chips) 
Seat 3: QvTX2yGq3uKJiKPmns4TKQ ($25.15 in chips) 
Seat 4: Wxq4Qyj0DnDXj2+taEOJFQ ($4.75 in chips) 
Seat 5: faP2NVl/cFTZ1nE4pXzg8Q ($21.70 in chips) 
Seat 6: 7JqTFMyeNSVWsmp/yW35Tw ($53.70 in chips) 
Wxq4Qyj0DnDXj2+taEOJFQ: posts small blind $0.10
faP2NVl/cFTZ1nE4pXzg8Q: posts big blind $0.25
W87HPwOk1KtWaYyshBe1gA: posts small & big blinds $0.35
*** HOLE CARDS ***
7JqTFMyeNSVWsmp/yW35Tw: folds 
W87HPwOk1KtWaYyshBe1gA: checks 
iauW7L/+7qzAuHow7CD75Q: raises $0.25 to $0.50
QvTX2yGq3uKJiKPmns4TKQ: folds 
7JqTFMyeNSVWsmp/yW35Tw said, "crap"
Wxq4Qyj0DnDXj2+taEOJFQ: folds 
iauW7L/+7qzAuHow7CD75Q said, "lol"
7JqTFMyeNSVWsmp/yW35Tw said, "Bdiddy and Tdiddy?"
faP2NVl/cFTZ1nE4pXzg8Q: calls $0.25
W87HPwOk1KtWaYyshBe1gA: calls $0.25
*** FLOP *** [6c Qh Js]
7JqTFMyeNSVWsmp/yW35Tw said, "WTF?"
iauW7L/+7qzAuHow7CD75Q said, "tdiddy"
faP2NVl/cFTZ1nE4pXzg8Q: checks 
iauW7L/+7qzAuHow7CD75Q said, "what r the odds"
W87HPwOk1KtWaYyshBe1gA said, "hehelol"
W87HPwOk1KtWaYyshBe1gA: checks 
iauW7L/+7qzAuHow7CD75Q: checks 
*** TURN *** [6c Qh Js] [8d]
faP2NVl/cFTZ1nE4pXzg8Q: bets $1
W87HPwOk1KtWaYyshBe1gA: folds 
7JqTFMyeNSVWsmp/yW35Tw said, "this table is off the hook"
iauW7L/+7qzAuHow7CD75Q: folds 
Uncalled bet ($1) returned to faP2NVl/cFTZ1nE4pXzg8Q
W87HPwOk1KtWaYyshBe1gA leaves the table
faP2NVl/cFTZ1nE4pXzg8Q collected $1.65 from pot
*** SUMMARY ***
Total pot $1.70 | Rake $0.05 
Board [6c Qh Js 8d]
Seat 1: W87HPwOk1KtWaYyshBe1gA folded on the Turn
Seat 2: iauW7L/+7qzAuHow7CD75Q folded on the Turn
Seat 3: QvTX2yGq3uKJiKPmns4TKQ (button) folded before Flop (didn't bet)
Seat 4: Wxq4Qyj0DnDXj2+taEOJFQ (small blind) folded before Flop
Seat 5: faP2NVl/cFTZ1nE4pXzg8Q (big blind) collected ($1.65)
Seat 6: 7JqTFMyeNSVWsmp/yW35Tw folded before Flop (didn't bet)




PokerStars Game #59941998094:  Hold'em No Limit ($0.10/$0.25) - 2009/07/01 1:52:50 ET
Table 'fIMYcWwN4/aXFJvH5Z8Ymg' 6-max Seat #4 is the button
Seat 1: DihMHaz4WNETH1bPDe13kA ($25.35 in chips) 
Seat 2: Mhj3q7cxev+XjXZxEE6/Cw ($26.30 in chips) 
Seat 3: 9bpVv1/Qh9IYtXuCtl5VtQ ($23.65 in chips) 
Seat 4: 7cx44/slbeTw+Cy7QB8Trg ($24.65 in chips) 
Seat 5: JppOakN7YnIDLWiLzBbtSg ($26.10 in chips) 
Seat 6: jp34e617tIzV8tKIWmfAbA ($28.35 in chips) 
JppOakN7YnIDLWiLzBbtSg: posts small blind $0.10
jp34e617tIzV8tKIWmfAbA: posts big blind $0.25
*** HOLE CARDS ***
DihMHaz4WNETH1bPDe13kA: folds 
Mhj3q7cxev+XjXZxEE6/Cw: folds 
9bpVv1/Qh9IYtXuCtl5VtQ: folds 
7cx44/slbeTw+Cy7QB8Trg: folds 
JppOakN7YnIDLWiLzBbtSg: folds 
Uncalled bet ($0.15) returned to jp34e617tIzV8tKIWmfAbA
jp34e617tIzV8tKIWmfAbA collected $0.20 from pot
*** SUMMARY ***
Total pot $0.20 | Rake $0 
Seat 1: DihMHaz4WNETH1bPDe13kA folded before Flop (didn't bet)
Seat 2: Mhj3q7cxev+XjXZxEE6/Cw folded before Flop (didn't bet)
Seat 3: 9bpVv1/Qh9IYtXuCtl5VtQ folded before Flop (didn't bet)
Seat 4: 7cx44/slbeTw+Cy7QB8Trg (button) folded before Flop (didn't bet)
Seat 5: JppOakN7YnIDLWiLzBbtSg (small blind) folded before Flop
Seat 6: jp34e617tIzV8tKIWmfAbA (big blind) collected ($0.20)




PokerStars Game #59941997912:  Hold'em No Limit ($0.10/$0.25) - 2009/07/01 1:52:50 ET
Table 'Yb2CyZosw7N3yRRVLhKnKg' 9-max Seat #1 is the button
Seat 1: j97ZRZFRWNUsBUL7hv78tA ($13.65 in chips) 
Seat 2: dtZ84flFEi4Q+SGrHMJRDQ ($25.90 in chips) 
Seat 3: wUanlt/hhheMA+jOrJk2Tg ($9.15 in chips) 
Seat 4: FG10kumpruEJ3PQJ7oGglQ ($16.10 in chips) 
Seat 6: CgIo2ItZqi4o3ayVG6HanQ ($47 in chips) 
Seat 7: ljemhp25Zg+nlA9DLCIiUw ($24.75 in chips) 
Seat 8: HxDF4QSxC4z39D7teZpprQ ($12.20 in chips) 
Seat 9: 6DVf3fwEGECnjQ4Yp9AsFw ($16.20 in chips) 
dtZ84flFEi4Q+SGrHMJRDQ: posts small blind $0.10
wUanlt/hhheMA+jOrJk2Tg: posts big blind $0.25
ydoFOVgzvZv9ZhuWu9rXAw: sits out 
*** HOLE CARDS ***
FG10kumpruEJ3PQJ7oGglQ: calls $0.25
CgIo2ItZqi4o3ayVG6HanQ: raises $0.50 to $0.75
ljemhp25Zg+nlA9DLCIiUw: calls $0.75
HxDF4QSxC4z39D7teZpprQ: calls $0.75
6DVf3fwEGECnjQ4Yp9AsFw: folds 
j97ZRZFRWNUsBUL7hv78tA: calls $0.75
dtZ84flFEi4Q+SGrHMJRDQ: folds 
wUanlt/hhheMA+jOrJk2Tg: folds 
FG10kumpruEJ3PQJ7oGglQ: calls $0.50
*** FLOP *** [7c Td Js]
FG10kumpruEJ3PQJ7oGglQ: checks 
CgIo2ItZqi4o3ayVG6HanQ: bets $1.50
ljemhp25Zg+nlA9DLCIiUw: folds 
HxDF4QSxC4z39D7teZpprQ: calls $1.50
j97ZRZFRWNUsBUL7hv78tA: folds 
FG10kumpruEJ3PQJ7oGglQ: calls $1.50
*** TURN *** [7c Td Js] [8s]
FG10kumpruEJ3PQJ7oGglQ: bets $2.25
CgIo2ItZqi4o3ayVG6HanQ: raises $2.75 to $5
HxDF4QSxC4z39D7teZpprQ: calls $5
FG10kumpruEJ3PQJ7oGglQ: folds 
*** RIVER *** [7c Td Js 8s] [5h]
CgIo2ItZqi4o3ayVG6HanQ: bets $5
HxDF4QSxC4z39D7teZpprQ: folds 
Uncalled bet ($5) returned to CgIo2ItZqi4o3ayVG6HanQ
CgIo2ItZqi4o3ayVG6HanQ collected $19.85 from pot
*** SUMMARY ***
Total pot $20.85 | Rake $1 
Board [7c Td Js 8s 5h]
Seat 1: j97ZRZFRWNUsBUL7hv78tA (button) folded on the Flop
Seat 2: dtZ84flFEi4Q+SGrHMJRDQ (small blind) folded before Flop
Seat 3: wUanlt/hhheMA+jOrJk2Tg (big blind) folded before Flop
Seat 4: FG10kumpruEJ3PQJ7oGglQ folded on the Turn
Seat 6: CgIo2ItZqi4o3ayVG6HanQ collected ($19.85)
Seat 7: ljemhp25Zg+nlA9DLCIiUw folded on the Flop
Seat 8: HxDF4QSxC4z39D7teZpprQ folded on the River
Seat 9: 6DVf3fwEGECnjQ4Yp9AsFw folded before Flop (didn't bet)




PokerStars Game #59941998260:  Hold'em No Limit ($0.10/$0.25) - 2009/07/01 1:52:50 ET
Table '0mmHveGuaIfIMQlNE1eqMg' 9-max Seat #6 is the button
Seat 1: ydoFOVgzvZv9ZhuWu9rXAw ($5 in chips) 
Seat 2: rQhYIYXSyH/IivYM1dlV5A ($68.50 in chips) 
Seat 3: ghNKXUBl/H+t83JF079ZBA ($25 in chips) 
Seat 4: DnDcAdn9P0zGovMERigpFA ($39.70 in chips) 
Seat 6: 6RiVTYll/5D8zICp0MRpKw ($23.35 in chips) 
Seat 7: JqeaikMej6KsqTKmUhl2Lw ($24.75 in chips) 
Seat 8: 0XACOSNrAWmqNv9k1nF8rw ($21.25 in chips) 
Seat 9: UNw/UrAelsQeSS17Rro/BA ($4.40 in chips) 
JqeaikMej6KsqTKmUhl2Lw: posts small blind $0.10
0XACOSNrAWmqNv9k1nF8rw: posts big blind $0.25
0rQnT3MwKEGi6YXD9FufJw: sits out 
*** HOLE CARDS ***
UNw/UrAelsQeSS17Rro/BA: folds 
ydoFOVgzvZv9ZhuWu9rXAw: folds 
rQhYIYXSyH/IivYM1dlV5A: folds 
ghNKXUBl/H+t83JF079ZBA: folds 
DnDcAdn9P0zGovMERigpFA: raises $0.75 to $1
6RiVTYll/5D8zICp0MRpKw: folds 
JqeaikMej6KsqTKmUhl2Lw: folds 
0XACOSNrAWmqNv9k1nF8rw: folds 
Uncalled bet ($0.75) returned to DnDcAdn9P0zGovMERigpFA
DnDcAdn9P0zGovMERigpFA collected $0.60 from pot
DnDcAdn9P0zGovMERigpFA: doesn't show hand 
*** SUMMARY ***
Total pot $0.60 | Rake $0 
Seat 1: ydoFOVgzvZv9ZhuWu9rXAw folded before Flop (didn't bet)
Seat 2: rQhYIYXSyH/IivYM1dlV5A folded before Flop (didn't bet)
Seat 3: ghNKXUBl/H+t83JF079ZBA folded before Flop (didn't bet)
Seat 4: DnDcAdn9P0zGovMERigpFA collected ($0.60)
Seat 6: 6RiVTYll/5D8zICp0MRpKw (button) folded before Flop (didn't bet)
Seat 7: JqeaikMej6KsqTKmUhl2Lw (small blind) folded before Flop
Seat 8: 0XACOSNrAWmqNv9k1nF8rw (big blind) folded before Flop
Seat 9: UNw/UrAelsQeSS17Rro/BA folded before Flop (didn't bet)




PokerStars Game #59941998158:  Hold'em No Limit ($0.10/$0.25) - 2009/07/01 1:52:50 ET
Table 'yZgGBnUGXVCcEJdcqes8tw' 9-max Seat #6 is the button
Seat 1: 6RiVTYll/5D8zICp0MRpKw ($30.30 in chips) 
Seat 2: MG90wfSJZnOejs/KD3vlQQ ($25 in chips) 
Seat 4: M2QO2DxB5Wawg2h8HSpnYA ($10 in chips) 
Seat 5: dfNim92Z6XK1/h5SFW5vDg ($26 in chips) 
Seat 6: RHqgdFvufLCYe54+qd2gcA ($4.65 in chips) 
Seat 7: eC8Pn1D6Y2pct8o62nQfvQ ($31.55 in chips) 
Seat 8: dtZ84flFEi4Q+SGrHMJRDQ ($30.15 in chips) 
Seat 9: M/9j4wkHH9i1JM51vgi1VA ($23.40 in chips) 
eC8Pn1D6Y2pct8o62nQfvQ: posts small blind $0.10
dtZ84flFEi4Q+SGrHMJRDQ: posts big blind $0.25
z5GxcHlYz/GSz6W2uFiTtg: sits out 
*** HOLE CARDS ***
M/9j4wkHH9i1JM51vgi1VA: calls $0.25
6RiVTYll/5D8zICp0MRpKw: folds 
MG90wfSJZnOejs/KD3vlQQ: folds 
M2QO2DxB5Wawg2h8HSpnYA: folds 
dfNim92Z6XK1/h5SFW5vDg: folds 
RHqgdFvufLCYe54+qd2gcA: folds 
eC8Pn1D6Y2pct8o62nQfvQ: folds 
dtZ84flFEi4Q+SGrHMJRDQ: checks 
*** FLOP *** [Kc 9d Jc]
dtZ84flFEi4Q+SGrHMJRDQ: checks 
M/9j4wkHH9i1JM51vgi1VA: checks 
*** TURN *** [Kc 9d Jc] [8c]
dtZ84flFEi4Q+SGrHMJRDQ: checks 
M/9j4wkHH9i1JM51vgi1VA: checks 
*** RIVER *** [Kc 9d Jc 8c] [7s]
dtZ84flFEi4Q+SGrHMJRDQ: checks 
M/9j4wkHH9i1JM51vgi1VA: bets $1
dtZ84flFEi4Q+SGrHMJRDQ: calls $1
*** SHOW DOWN ***
M/9j4wkHH9i1JM51vgi1VA: shows [5c 6c] (a flush, King high)
dtZ84flFEi4Q+SGrHMJRDQ: mucks hand 
M/9j4wkHH9i1JM51vgi1VA collected $2.50 from pot
*** SUMMARY ***
Total pot $2.60 | Rake $0.10 
Board [Kc 9d Jc 8c 7s]
Seat 1: 6RiVTYll/5D8zICp0MRpKw folded before Flop (didn't bet)
Seat 2: MG90wfSJZnOejs/KD3vlQQ folded before Flop (didn't bet)
Seat 4: M2QO2DxB5Wawg2h8HSpnYA folded before Flop (didn't bet)
Seat 5: dfNim92Z6XK1/h5SFW5vDg folded before Flop (didn't bet)
Seat 6: RHqgdFvufLCYe54+qd2gcA (button) folded before Flop (didn't bet)
Seat 7: eC8Pn1D6Y2pct8o62nQfvQ (small blind) folded before Flop
Seat 8: dtZ84flFEi4Q+SGrHMJRDQ (big blind) mucked
Seat 9: M/9j4wkHH9i1JM51vgi1VA showed [5c 6c] and won ($2.50) with a flush, King high




PokerStars Game #59941998172:  Hold'em No Limit ($0.10/$0.25) - 2009/07/01 1:52:50 ET
Table 'T/iCKJXGphRN3xcdwfE/JQ' 6-max Seat #6 is the button
Seat 2: EeUZtMU058v2ObUACOF4Og ($33.15 in chips) 
Seat 3: IWAjoCPXtc1XUaZdp+pCpA ($22.10 in chips) 
Seat 4: m2yWOKfAxqHoy5DDN87Ttw ($8.25 in chips) 
Seat 5: y85armT09GoP0OGsamp0jA ($18.05 in chips) 
Seat 6: Ey4Kn6PlnYb2srYYBJHvzg ($31.45 in chips) 
EeUZtMU058v2ObUACOF4Og: posts small blind $0.10
IWAjoCPXtc1XUaZdp+pCpA: posts big blind $0.25
*** HOLE CARDS ***
m2yWOKfAxqHoy5DDN87Ttw: raises $1 to $1.25
y85armT09GoP0OGsamp0jA: folds 
Ey4Kn6PlnYb2srYYBJHvzg: folds 
EeUZtMU058v2ObUACOF4Og: folds 
IWAjoCPXtc1XUaZdp+pCpA: folds 
Uncalled bet ($1) returned to m2yWOKfAxqHoy5DDN87Ttw
m2yWOKfAxqHoy5DDN87Ttw collected $0.60 from pot
m2yWOKfAxqHoy5DDN87Ttw: doesn't show hand 
*** SUMMARY ***
Total pot $0.60 | Rake $0 
Seat 2: EeUZtMU058v2ObUACOF4Og (small blind) folded before Flop
Seat 3: IWAjoCPXtc1XUaZdp+pCpA (big blind) folded before Flop
Seat 4: m2yWOKfAxqHoy5DDN87Ttw collected ($0.60)
Seat 5: y85armT09GoP0OGsamp0jA folded before Flop (didn't bet)
Seat 6: Ey4Kn6PlnYb2srYYBJHvzg (button) folded before Flop (didn't bet)




PokerStars Game #59941997966:  Hold'em No Limit ($0.10/$0.25) - 2009/07/01 1:52:50 ET
Table 'biAgO3TKQBU8XcrVAoU5TA' 6-max Seat #5 is the button
Seat 2: NPueG39V6nKvDRuvBJ4U7g ($8.60 in chips) 
Seat 3: mfrkWA3PTeYPkbO6hi98Aw ($22.75 in chips) 
Seat 5: n6UPMnVR4v8LFP0rWP73Fg ($25.80 in chips) 
Seat 6: wMiE3yTbDJGOLOF9th7KPA ($23 in chips) 
wMiE3yTbDJGOLOF9th7KPA: posts small blind $0.10
NPueG39V6nKvDRuvBJ4U7g: posts big blind $0.25
*** HOLE CARDS ***
jhDPlkir8wBYAddboBuF7Q leaves the table
mfrkWA3PTeYPkbO6hi98Aw: folds 
n6UPMnVR4v8LFP0rWP73Fg: folds 
blackmari joins the table at seat #4 
wMiE3yTbDJGOLOF9th7KPA: calls $0.15
NPueG39V6nKvDRuvBJ4U7g: checks 
*** FLOP *** [Jd 5s 3s]
wMiE3yTbDJGOLOF9th7KPA: bets $0.25
NPueG39V6nKvDRuvBJ4U7g: folds 
Uncalled bet ($0.25) returned to wMiE3yTbDJGOLOF9th7KPA
wMiE3yTbDJGOLOF9th7KPA collected $0.50 from pot
wMiE3yTbDJGOLOF9th7KPA: doesn't show hand 
*** SUMMARY ***
Total pot $0.50 | Rake $0 
Board [Jd 5s 3s]
Seat 2: NPueG39V6nKvDRuvBJ4U7g (big blind) folded on the Flop
Seat 3: mfrkWA3PTeYPkbO6hi98Aw folded before Flop (didn't bet)
Seat 5: n6UPMnVR4v8LFP0rWP73Fg (button) folded before Flop (didn't bet)
Seat 6: wMiE3yTbDJGOLOF9th7KPA (small blind) collected ($0.50)




PokerStars Game #59941998400:  Hold'em No Limit ($0.10/$0.25) - 2009/07/01 1:52:51 ET
Table 'VuY5ej47Cy8nOI3Wogmhzw' 6-max Seat #1 is the button
Seat 1: EeUZtMU058v2ObUACOF4Og ($29.15 in chips) 
Seat 3: v+QfkGiuj9bgtuNoVnDO8w ($41.80 in chips) 
Seat 4: QqiZLFrN8iOUT/GHw7ztOA ($45.05 in chips) 
Seat 5: m2yWOKfAxqHoy5DDN87Ttw ($25.35 in chips) 
Seat 6: +KblIivb6tainScpwm14RQ ($10.60 in chips) 
v+QfkGiuj9bgtuNoVnDO8w: posts small blind $0.10
QqiZLFrN8iOUT/GHw7ztOA: posts big blind $0.25
*** HOLE CARDS ***
m2yWOKfAxqHoy5DDN87Ttw: folds 
+KblIivb6tainScpwm14RQ: folds 
EeUZtMU058v2ObUACOF4Og: folds 
v+QfkGiuj9bgtuNoVnDO8w: folds 
Uncalled bet ($0.15) returned to QqiZLFrN8iOUT/GHw7ztOA
QqiZLFrN8iOUT/GHw7ztOA collected $0.20 from pot
*** SUMMARY ***
Total pot $0.20 | Rake $0 
Seat 1: EeUZtMU058v2ObUACOF4Og (button) folded before Flop (didn't bet)
Seat 3: v+QfkGiuj9bgtuNoVnDO8w (small blind) folded before Flop
Seat 4: QqiZLFrN8iOUT/GHw7ztOA (big blind) collected ($0.20)
Seat 5: m2yWOKfAxqHoy5DDN87Ttw folded before Flop (didn't bet)
Seat 6: +KblIivb6tainScpwm14RQ folded before Flop (didn't bet)




PokerStars Game #59941998398:  Hold'em No Limit ($0.10/$0.25) - 2009/07/01 1:52:51 ET
Table 'fHv1Mk7ZbLjprZTGWKPiEQ' 6-max Seat #5 is the button
Seat 1: OIjOiBfQstWrK/RuXx7zcw ($4.25 in chips) 
Seat 2: 9U3ZKjCsarN0DjR6mSE8Ug ($13.80 in chips) 
Seat 3: /gJNBeCkWL4o85/jvlZ4BA ($25 in chips) 
Seat 4: TSmua8tGK3sTbwi0ynrW9Q ($60 in chips) 
Seat 5: LJI7A1YgDM7hgh7o56+ReQ ($25.95 in chips) 
Seat 6: AjG0X+rNtc2W08eph8oqpw ($52.15 in chips) 
AjG0X+rNtc2W08eph8oqpw: posts small blind $0.10
OIjOiBfQstWrK/RuXx7zcw: posts big blind $0.25
*** HOLE CARDS ***
9U3ZKjCsarN0DjR6mSE8Ug: calls $0.25
/gJNBeCkWL4o85/jvlZ4BA: folds 
/gJNBeCkWL4o85/jvlZ4BA is sitting out
TSmua8tGK3sTbwi0ynrW9Q: folds 
/gJNBeCkWL4o85/jvlZ4BA has returned
LJI7A1YgDM7hgh7o56+ReQ: raises $1 to $1.25
AjG0X+rNtc2W08eph8oqpw: folds 
OIjOiBfQstWrK/RuXx7zcw: folds 
9U3ZKjCsarN0DjR6mSE8Ug: calls $1
*** FLOP *** [5s Jd 2c]
9U3ZKjCsarN0DjR6mSE8Ug: checks 
LJI7A1YgDM7hgh7o56+ReQ: bets $2.25
9U3ZKjCsarN0DjR6mSE8Ug: folds 
Uncalled bet ($2.25) returned to LJI7A1YgDM7hgh7o56+ReQ
LJI7A1YgDM7hgh7o56+ReQ collected $2.75 from pot
LJI7A1YgDM7hgh7o56+ReQ: doesn't show hand 
*** SUMMARY ***
Total pot $2.85 | Rake $0.10 
Board [5s Jd 2c]
Seat 1: OIjOiBfQstWrK/RuXx7zcw (big blind) folded before Flop
Seat 2: 9U3ZKjCsarN0DjR6mSE8Ug folded on the Flop
Seat 3: /gJNBeCkWL4o85/jvlZ4BA folded before Flop (didn't bet)
Seat 4: TSmua8tGK3sTbwi0ynrW9Q folded before Flop (didn't bet)
Seat 5: LJI7A1YgDM7hgh7o56+ReQ (button) collected ($2.75)
Seat 6: AjG0X+rNtc2W08eph8oqpw (small blind) folded before Flop




PokerStars Game #59941998760:  Hold'em No Limit ($0.10/$0.25) - 2009/07/01 1:52:51 ET
Table 'Pz8SfAzhP5nvWTsJRAxoDg' 6-max Seat #2 is the button
Seat 1: QiL+lEgEWwy21jk/ltaRLg ($46.15 in chips) 
Seat 2: k021eD5in2AjaloW5PalMg ($19.60 in chips) 
Seat 3: mfrkWA3PTeYPkbO6hi98Aw ($31.20 in chips) 
Seat 4: 4lJto+Qj0K4JrFKvHaPTLw ($64.05 in chips) 
Seat 5: u+J1MTXS2qhNVMbsBemNLg ($4.75 in chips) 
Seat 6: QvTX2yGq3uKJiKPmns4TKQ ($16.55 in chips) 
mfrkWA3PTeYPkbO6hi98Aw: posts small blind $0.10
4lJto+Qj0K4JrFKvHaPTLw: posts big blind $0.25
*** HOLE CARDS ***
u+J1MTXS2qhNVMbsBemNLg: calls $0.25
QvTX2yGq3uKJiKPmns4TKQ: folds 
QiL+lEgEWwy21jk/ltaRLg: folds 
k021eD5in2AjaloW5PalMg: folds 
k021eD5in2AjaloW5PalMg leaves the table
mfrkWA3PTeYPkbO6hi98Aw: calls $0.15
4lJto+Qj0K4JrFKvHaPTLw: checks 
*** FLOP *** [6s Tc 8s]
mfrkWA3PTeYPkbO6hi98Aw: checks 
4lJto+Qj0K4JrFKvHaPTLw: bets $0.50
u+J1MTXS2qhNVMbsBemNLg: calls $0.50
mfrkWA3PTeYPkbO6hi98Aw: folds 
*** TURN *** [6s Tc 8s] [7s]
4lJto+Qj0K4JrFKvHaPTLw: checks 
u+J1MTXS2qhNVMbsBemNLg: checks 
*** RIVER *** [6s Tc 8s 7s] [2s]
4lJto+Qj0K4JrFKvHaPTLw: checks 
u+J1MTXS2qhNVMbsBemNLg: bets $4 and is all-in
4lJto+Qj0K4JrFKvHaPTLw: folds 
Uncalled bet ($4) returned to u+J1MTXS2qhNVMbsBemNLg
u+J1MTXS2qhNVMbsBemNLg collected $1.70 from pot
u+J1MTXS2qhNVMbsBemNLg: doesn't show hand 
*** SUMMARY ***
Total pot $1.75 | Rake $0.05 
Board [6s Tc 8s 7s 2s]
Seat 1: QiL+lEgEWwy21jk/ltaRLg folded before Flop (didn't bet)
Seat 2: k021eD5in2AjaloW5PalMg (button) folded before Flop (didn't bet)
Seat 3: mfrkWA3PTeYPkbO6hi98Aw (small blind) folded on the Flop
Seat 4: 4lJto+Qj0K4JrFKvHaPTLw (big blind) folded on the River
Seat 5: u+J1MTXS2qhNVMbsBemNLg collected ($1.70)
Seat 6: QvTX2yGq3uKJiKPmns4TKQ folded before Flop (didn't bet)




PokerStars Game #59941999222:  Hold'em No Limit ($0.10/$0.25) - 2009/07/01 1:52:52 ET
Table '2AUmC2Rslg+QUbLfdgNdfg' 6-max Seat #2 is the button
Seat 1: YDXAegrCnzc0l6TSDNboXQ ($22.75 in chips) 
Seat 2: PLksyNlTVRVZwxJVC2/1eA ($14.20 in chips) 
Seat 3: JFIAqU8lCZ0vWwEl4bdGsg ($32.55 in chips) 
Seat 4: rfeJ/I60SIiPfszMkIoNNA ($9.75 in chips) 
Seat 5: AMc4cCwUJhokdGRYIaVPhQ ($31.10 in chips) 
Seat 6: xBWc54v+UTSJOiKpbAbJWg ($20 in chips) 
JFIAqU8lCZ0vWwEl4bdGsg: posts small blind $0.10
rfeJ/I60SIiPfszMkIoNNA: posts big blind $0.25
*** HOLE CARDS ***
AMc4cCwUJhokdGRYIaVPhQ: folds 
xBWc54v+UTSJOiKpbAbJWg: folds 
YDXAegrCnzc0l6TSDNboXQ: calls $0.25
PLksyNlTVRVZwxJVC2/1eA: folds 
JFIAqU8lCZ0vWwEl4bdGsg: folds 
rfeJ/I60SIiPfszMkIoNNA: checks 
*** FLOP *** [Kh 5c 7d]
rfeJ/I60SIiPfszMkIoNNA: checks 
YDXAegrCnzc0l6TSDNboXQ: bets $0.25
rfeJ/I60SIiPfszMkIoNNA: raises $0.25 to $0.50
YDXAegrCnzc0l6TSDNboXQ: calls $0.25
*** TURN *** [Kh 5c 7d] [8s]
rfeJ/I60SIiPfszMkIoNNA: bets $0.75
YDXAegrCnzc0l6TSDNboXQ: calls $0.75
*** RIVER *** [Kh 5c 7d 8s] [3c]
rfeJ/I60SIiPfszMkIoNNA: bets $1.50
YDXAegrCnzc0l6TSDNboXQ: folds 
Uncalled bet ($1.50) returned to rfeJ/I60SIiPfszMkIoNNA
rfeJ/I60SIiPfszMkIoNNA collected $2.95 from pot
rfeJ/I60SIiPfszMkIoNNA: doesn't show hand 
*** SUMMARY ***
Total pot $3.10 | Rake $0.15 
Board [Kh 5c 7d 8s 3c]
Seat 1: YDXAegrCnzc0l6TSDNboXQ folded on the River
Seat 2: PLksyNlTVRVZwxJVC2/1eA (button) folded before Flop (didn't bet)
Seat 3: JFIAqU8lCZ0vWwEl4bdGsg (small blind) folded before Flop
Seat 4: rfeJ/I60SIiPfszMkIoNNA (big blind) collected ($2.95)
Seat 5: AMc4cCwUJhokdGRYIaVPhQ folded before Flop (didn't bet)
Seat 6: xBWc54v+UTSJOiKpbAbJWg folded before Flop (didn't bet)




PokerStars Game #59941999086:  Hold'em No Limit ($0.10/$0.25) - 2009/07/01 1:52:52 ET
Table 'mk323gviqdkOY5Aek/1EWg' 6-max Seat #3 is the button
Seat 1: 7cx44/slbeTw+Cy7QB8Trg ($25.25 in chips) 
Seat 2: GC/9yVD59DUCX7hUI7gcLw ($57.05 in chips) 
Seat 3: NuqYPwTLZYQhxOoVK3Yqlw ($25.45 in chips) 
Seat 4: +baiVgI/ETnBARLe5mARCw ($10.95 in chips) 
Seat 5: kjYRzIfvZNNflYMYRkkSVA ($36.30 in chips) 
Seat 6: KkXSr5xFjxLSD3wtAvT+WQ ($6.45 in chips) 
+baiVgI/ETnBARLe5mARCw: posts small blind $0.10
kjYRzIfvZNNflYMYRkkSVA: posts big blind $0.25
*** HOLE CARDS ***
KkXSr5xFjxLSD3wtAvT+WQ: calls $0.25
7cx44/slbeTw+Cy7QB8Trg: folds 
GC/9yVD59DUCX7hUI7gcLw: folds 
NuqYPwTLZYQhxOoVK3Yqlw: raises $0.75 to $1
+baiVgI/ETnBARLe5mARCw: folds 
kjYRzIfvZNNflYMYRkkSVA: folds 
KkXSr5xFjxLSD3wtAvT+WQ: folds 
Uncalled bet ($0.75) returned to NuqYPwTLZYQhxOoVK3Yqlw
NuqYPwTLZYQhxOoVK3Yqlw collected $0.85 from pot
NuqYPwTLZYQhxOoVK3Yqlw: doesn't show hand 
*** SUMMARY ***
Total pot $0.85 | Rake $0 
Seat 1: 7cx44/slbeTw+Cy7QB8Trg folded before Flop (didn't bet)
Seat 2: GC/9yVD59DUCX7hUI7gcLw folded before Flop (didn't bet)
Seat 3: NuqYPwTLZYQhxOoVK3Yqlw (button) collected ($0.85)
Seat 4: +baiVgI/ETnBARLe5mARCw (small blind) folded before Flop
Seat 5: kjYRzIfvZNNflYMYRkkSVA (big blind) folded before Flop
Seat 6: KkXSr5xFjxLSD3wtAvT+WQ folded before Flop




PokerStars Game #59941998924:  Hold'em No Limit ($0.10/$0.25) - 2009/07/01 1:52:52 ET
Table '/VaaaFnlEJoYVomG9uxHkA' 9-max Seat #2 is the button
Seat 1: Th3FldXKQW6hWVVPahaoOQ ($25 in chips) 
Seat 2: DIkeSkosO/tsUp9d2JVyTA ($56.45 in chips) 
Seat 4: j4q3p0lesp63b1gZDwLBZw ($5.45 in chips) 
Seat 5: cZ99hugmLBj9KhTlc8nCSw ($25 in chips) 
Seat 7: F7pnn6czNpHvRM55XcA2EA ($31.25 in chips) 
Seat 8: dfNim92Z6XK1/h5SFW5vDg ($50.50 in chips) 
Seat 9: DdPXdieucQ+n99u1n3A+rQ ($4.65 in chips) 
j4q3p0lesp63b1gZDwLBZw: posts small blind $0.10
cZ99hugmLBj9KhTlc8nCSw: posts big blind $0.25
*** HOLE CARDS ***
F7pnn6czNpHvRM55XcA2EA: folds 
dfNim92Z6XK1/h5SFW5vDg: folds 
DdPXdieucQ+n99u1n3A+rQ: folds 
Th3FldXKQW6hWVVPahaoOQ: folds 
MtVtHDqIJTyUcXkRBBDIVA leaves the table
PdIasPkzm2sqZnN41ZRXOg joins the table at seat #3 
DIkeSkosO/tsUp9d2JVyTA has timed out
DIkeSkosO/tsUp9d2JVyTA: folds 
DIkeSkosO/tsUp9d2JVyTA is sitting out
j4q3p0lesp63b1gZDwLBZw: folds 
Uncalled bet ($0.15) returned to cZ99hugmLBj9KhTlc8nCSw
cZ99hugmLBj9KhTlc8nCSw collected $0.20 from pot
cZ99hugmLBj9KhTlc8nCSw: doesn't show hand 
*** SUMMARY ***
Total pot $0.20 | Rake $0 
Seat 1: Th3FldXKQW6hWVVPahaoOQ folded before Flop (didn't bet)
Seat 2: DIkeSkosO/tsUp9d2JVyTA (button) folded before Flop (didn't bet)
Seat 4: j4q3p0lesp63b1gZDwLBZw (small blind) folded before Flop
Seat 5: cZ99hugmLBj9KhTlc8nCSw (big blind) collected ($0.20)
Seat 7: F7pnn6czNpHvRM55XcA2EA folded before Flop (didn't bet)
Seat 8: dfNim92Z6XK1/h5SFW5vDg folded before Flop (didn't bet)
Seat 9: DdPXdieucQ+n99u1n3A+rQ folded before Flop (didn't bet)




PokerStars Game #59941998988:  Hold'em No Limit ($0.10/$0.25) - 2009/07/01 1:52:52 ET
Table '972HGIb0tQN/zRIK4TABEw' 9-max Seat #4 is the button
Seat 1: xmdItDBraeGrrs3wzz1J3w ($20 in chips) 
Seat 4: aSrj4lVmn2owyQ1RbbOqxQ ($4.35 in chips) 
Seat 5: n+stbTneifqFNME+tpoGrw ($26.75 in chips) 
n+stbTneifqFNME+tpoGrw: posts small blind $0.10
xmdItDBraeGrrs3wzz1J3w: posts big blind $0.25
*** HOLE CARDS ***
aSrj4lVmn2owyQ1RbbOqxQ: raises $0.50 to $0.75
n+stbTneifqFNME+tpoGrw: folds 
xmdItDBraeGrrs3wzz1J3w: calls $0.50
*** FLOP *** [Kh 2h Tc]
xmdItDBraeGrrs3wzz1J3w: bets $1.25
aSrj4lVmn2owyQ1RbbOqxQ: raises $2.35 to $3.60 and is all-in
xmdItDBraeGrrs3wzz1J3w: calls $2.35
*** TURN *** [Kh 2h Tc] [4s]
*** RIVER *** [Kh 2h Tc 4s] [8d]
*** SHOW DOWN ***
xmdItDBraeGrrs3wzz1J3w: shows [6h Jh] (high card King)
aSrj4lVmn2owyQ1RbbOqxQ: shows [9h Kc] (a pair of Kings)
aSrj4lVmn2owyQ1RbbOqxQ collected $8.40 from pot
*** SUMMARY ***
Total pot $8.80 | Rake $0.40 
Board [Kh 2h Tc 4s 8d]
Seat 1: xmdItDBraeGrrs3wzz1J3w (big blind) showed [6h Jh] and lost with high card King
Seat 4: aSrj4lVmn2owyQ1RbbOqxQ (button) showed [9h Kc] and won ($8.40) with a pair of Kings
Seat 5: n+stbTneifqFNME+tpoGrw (small blind) folded before Flop




PokerStars Game #59941999134:  Hold'em No Limit ($0.10/$0.25) - 2009/07/01 1:52:52 ET
Table 'KU/HrxqxwDz8HKEhYTZ6uw' 6-max Seat #6 is the button
Seat 1: 7LKoiQHXpTQXJvWQrw907g ($37.30 in chips) 
Seat 2: kG34n23qFQA3nzdOJTQ1dA ($25.20 in chips) 
Seat 3: SFmT9ZsVopnukjvAzrxTRg ($26.95 in chips) 
Seat 5: iyZxqznXjv3vtvOJymkoLQ ($52 in chips) 
Seat 6: qWxkCeqApAWdAA0evrfDvQ ($7.85 in chips) 
7LKoiQHXpTQXJvWQrw907g: posts small blind $0.10
kG34n23qFQA3nzdOJTQ1dA: posts big blind $0.25
*** HOLE CARDS ***
SFmT9ZsVopnukjvAzrxTRg: folds 
iyZxqznXjv3vtvOJymkoLQ: raises $0.50 to $0.75
SFmT9ZsVopnukjvAzrxTRg leaves the table
qWxkCeqApAWdAA0evrfDvQ: calls $0.75
7LKoiQHXpTQXJvWQrw907g: folds 
kG34n23qFQA3nzdOJTQ1dA: folds 
*** FLOP *** [Jd 4d 6h]
iyZxqznXjv3vtvOJymkoLQ: checks 
qWxkCeqApAWdAA0evrfDvQ: checks 
*** TURN *** [Jd 4d 6h] [8c]
iyZxqznXjv3vtvOJymkoLQ: bets $1
qWxkCeqApAWdAA0evrfDvQ: calls $1
*** RIVER *** [Jd 4d 6h 8c] [7h]
iyZxqznXjv3vtvOJymkoLQ: checks 
i9LqF5rD3bvtbEE7HWgr3Q joins the table at seat #3 
qWxkCeqApAWdAA0evrfDvQ: checks 
*** SHOW DOWN ***
iyZxqznXjv3vtvOJymkoLQ: shows [8d Kd] (a pair of Eights)
qWxkCeqApAWdAA0evrfDvQ: mucks hand 
iyZxqznXjv3vtvOJymkoLQ collected $3.70 from pot
*** SUMMARY ***
Total pot $3.85 | Rake $0.15 
Board [Jd 4d 6h 8c 7h]
Seat 1: 7LKoiQHXpTQXJvWQrw907g (small blind) folded before Flop
Seat 2: kG34n23qFQA3nzdOJTQ1dA (big blind) folded before Flop
Seat 3: SFmT9ZsVopnukjvAzrxTRg folded before Flop (didn't bet)
Seat 5: iyZxqznXjv3vtvOJymkoLQ showed [8d Kd] and won ($3.70) with a pair of Eights
Seat 6: qWxkCeqApAWdAA0evrfDvQ (button) mucked




PokerStars Game #59941999136:  Hold'em No Limit ($0.10/$0.25) - 2009/07/01 1:52:52 ET
Table 'zKwHJD0cmKNUure9qQTfFg' 6-max Seat #1 is the button
Seat 1: Hzrn9DZJegEZICufTNYkrg ($2.75 in chips) 
Seat 2: xrf8tAXKQHG99HixCot1Iw ($31.30 in chips) 
Seat 3: m9aw7LBAB5YX2ZqMtMkhqA ($19.45 in chips) 
Seat 4: v+QfkGiuj9bgtuNoVnDO8w ($37.45 in chips) 
Seat 6: edio/rLJ06xeZOfLhoL3UA ($5.75 in chips) 
xrf8tAXKQHG99HixCot1Iw: posts small blind $0.10
m9aw7LBAB5YX2ZqMtMkhqA: posts big blind $0.25
yoelik: sits out 
*** HOLE CARDS ***
v+QfkGiuj9bgtuNoVnDO8w: folds 
edio/rLJ06xeZOfLhoL3UA: raises $0.75 to $1
Hzrn9DZJegEZICufTNYkrg: folds 
xrf8tAXKQHG99HixCot1Iw: folds 
m9aw7LBAB5YX2ZqMtMkhqA: folds 
Uncalled bet ($0.75) returned to edio/rLJ06xeZOfLhoL3UA
edio/rLJ06xeZOfLhoL3UA collected $0.60 from pot
edio/rLJ06xeZOfLhoL3UA: doesn't show hand 
*** SUMMARY ***
Total pot $0.60 | Rake $0 
Seat 1: Hzrn9DZJegEZICufTNYkrg (button) folded before Flop (didn't bet)
Seat 2: xrf8tAXKQHG99HixCot1Iw (small blind) folded before Flop
Seat 3: m9aw7LBAB5YX2ZqMtMkhqA (big blind) folded before Flop
Seat 4: v+QfkGiuj9bgtuNoVnDO8w folded before Flop (didn't bet)
Seat 6: edio/rLJ06xeZOfLhoL3UA collected ($0.60)




PokerStars Game #59941998820:  Hold'em No Limit ($0.10/$0.25) - 2009/07/01 1:52:52 ET
Table 'IIO2q2znuuAXmiZ2qFTcmg' 6-max Seat #3 is the button
Seat 2: i9LqF5rD3bvtbEE7HWgr3Q ($27.35 in chips) 
Seat 3: j0aDOn9Nft1HLTQvGu1UwA ($14.15 in chips) 
Seat 5: iHZrkhpIO/3+tKuAoPx8HQ ($10.50 in chips) 
Seat 6: WT1/PiLHYHDQX0orTRlu9g ($15.65 in chips) 
iHZrkhpIO/3+tKuAoPx8HQ: posts small blind $0.10
WT1/PiLHYHDQX0orTRlu9g: posts big blind $0.25
*** HOLE CARDS ***
i9LqF5rD3bvtbEE7HWgr3Q: folds 
j0aDOn9Nft1HLTQvGu1UwA: folds 
iHZrkhpIO/3+tKuAoPx8HQ: calls $0.15
WT1/PiLHYHDQX0orTRlu9g: checks 
*** FLOP *** [6s 9s 2h]
iHZrkhpIO/3+tKuAoPx8HQ: checks 
WT1/PiLHYHDQX0orTRlu9g: bets $1
iHZrkhpIO/3+tKuAoPx8HQ: folds 
Uncalled bet ($1) returned to WT1/PiLHYHDQX0orTRlu9g
WT1/PiLHYHDQX0orTRlu9g collected $0.50 from pot
*** SUMMARY ***
Total pot $0.50 | Rake $0 
Board [6s 9s 2h]
Seat 2: i9LqF5rD3bvtbEE7HWgr3Q folded before Flop (didn't bet)
Seat 3: j0aDOn9Nft1HLTQvGu1UwA (button) folded before Flop (didn't bet)
Seat 5: iHZrkhpIO/3+tKuAoPx8HQ (small blind) folded on the Flop
Seat 6: WT1/PiLHYHDQX0orTRlu9g (big blind) collected ($0.50)




PokerStars Game #59941999240:  Hold'em No Limit ($0.10/$0.25) - 2009/07/01 1:52:52 ET
Table 'S6s+TmTlAjLHclBRvN5/fw' 9-max Seat #3 is the button
Seat 3: z2SmIaQ3+5n/eY1BN5HgPg ($12.50 in chips) 
Seat 4: RSal7+azPhXeqQO5L8XPfg ($18.95 in chips) 
Seat 5: 8hSJOE8UscCqt6t47gp0/g ($5.80 in chips) 
Seat 6: QkBggokTsSaL9vRv6V8nzQ ($5.85 in chips) 
RSal7+azPhXeqQO5L8XPfg: posts small blind $0.10
8hSJOE8UscCqt6t47gp0/g: posts big blind $0.25
*** HOLE CARDS ***
9V5ShhobeDoA6n0goHTukw joins the table at seat #2 
z2SmIaQ3+5n/eY1BN5HgPg said, "how do u get away with it??????"
QkBggokTsSaL9vRv6V8nzQ: raises $5.60 to $5.85 and is all-in
z2SmIaQ3+5n/eY1BN5HgPg: folds 
RSal7+azPhXeqQO5L8XPfg: folds 
8hSJOE8UscCqt6t47gp0/g: calls $5.55 and is all-in
Uncalled bet ($0.05) returned to QkBggokTsSaL9vRv6V8nzQ
*** FLOP *** [6d 7h 6c]
*** TURN *** [6d 7h 6c] [3h]
*** RIVER *** [6d 7h 6c 3h] [2c]
*** SHOW DOWN ***
8hSJOE8UscCqt6t47gp0/g: shows [Ks 9c] (a pair of Sixes)
QkBggokTsSaL9vRv6V8nzQ: shows [4c Ac] (a pair of Sixes - Ace kicker)
QkBggokTsSaL9vRv6V8nzQ collected $11.15 from pot
*** SUMMARY ***
Total pot $11.70 | Rake $0.55 
Board [6d 7h 6c 3h 2c]
Seat 3: z2SmIaQ3+5n/eY1BN5HgPg (button) folded before Flop (didn't bet)
Seat 4: RSal7+azPhXeqQO5L8XPfg (small blind) folded before Flop
Seat 5: 8hSJOE8UscCqt6t47gp0/g (big blind) showed [Ks 9c] and lost with a pair of Sixes
Seat 6: QkBggokTsSaL9vRv6V8nzQ showed [4c Ac] and won ($11.15) with a pair of Sixes




PokerStars Game #59941999038:  Hold'em No Limit ($0.10/$0.25) - 2009/07/01 1:52:52 ET
Table 'P2yJ+jwfNsBdF12fLKA6DQ' 9-max Seat #6 is the button
Seat 1: zDrucyjVn5aeekNEc3cJrA ($22.20 in chips) 
Seat 2: uQwmfH5LEVA5eyghJdyPUg ($14.65 in chips) 
Seat 3: 8EbrQ/EvFWt2cr0GaU82gQ ($4.65 in chips) 
Seat 4: 6NLAWFPZZfqlVkY8n9RULA ($13.40 in chips) 
Seat 5: B7VAFAMs/PYlYABlV+EkSA ($8.15 in chips) 
Seat 6: mUoFJKqCzIUABvOFbiINlQ ($12.65 in chips) 
Seat 7: yQc5nLaNmByxI15Jegu61w ($17.15 in chips) 
Seat 8: LMd3gq2uNfbWTfXTnSeQRw ($11.25 in chips) 
Seat 9: dN5zq7QdZCUe7NZFM6cECg ($19.75 in chips) 
yQc5nLaNmByxI15Jegu61w: posts small blind $0.10
LMd3gq2uNfbWTfXTnSeQRw: posts big blind $0.25
*** HOLE CARDS ***
dN5zq7QdZCUe7NZFM6cECg: folds 
zDrucyjVn5aeekNEc3cJrA: folds 
uQwmfH5LEVA5eyghJdyPUg: folds 
8EbrQ/EvFWt2cr0GaU82gQ: folds 
6NLAWFPZZfqlVkY8n9RULA: calls $0.25
B7VAFAMs/PYlYABlV+EkSA: folds 
mUoFJKqCzIUABvOFbiINlQ: folds 
yQc5nLaNmByxI15Jegu61w: calls $0.15
LMd3gq2uNfbWTfXTnSeQRw: checks 
*** FLOP *** [5h 4h 3d]
yQc5nLaNmByxI15Jegu61w: bets $0.50
LMd3gq2uNfbWTfXTnSeQRw: calls $0.50
6NLAWFPZZfqlVkY8n9RULA: calls $0.50
*** TURN *** [5h 4h 3d] [Ac]
yQc5nLaNmByxI15Jegu61w: checks 
LMd3gq2uNfbWTfXTnSeQRw: checks 
6NLAWFPZZfqlVkY8n9RULA: bets $0.50
yQc5nLaNmByxI15Jegu61w: folds 
LMd3gq2uNfbWTfXTnSeQRw: calls $0.50
*** RIVER *** [5h 4h 3d Ac] [Qd]
LMd3gq2uNfbWTfXTnSeQRw: checks 
dN5zq7QdZCUe7NZFM6cECg leaves the table
6NLAWFPZZfqlVkY8n9RULA: bets $1.25
LMd3gq2uNfbWTfXTnSeQRw: folds 
Uncalled bet ($1.25) returned to 6NLAWFPZZfqlVkY8n9RULA
6NLAWFPZZfqlVkY8n9RULA collected $3.10 from pot
6NLAWFPZZfqlVkY8n9RULA: doesn't show hand 
*** SUMMARY ***
Total pot $3.25 | Rake $0.15 
Board [5h 4h 3d Ac Qd]
Seat 1: zDrucyjVn5aeekNEc3cJrA folded before Flop (didn't bet)
Seat 2: uQwmfH5LEVA5eyghJdyPUg folded before Flop (didn't bet)
Seat 3: 8EbrQ/EvFWt2cr0GaU82gQ folded before Flop (didn't bet)
Seat 4: 6NLAWFPZZfqlVkY8n9RULA collected ($3.10)
Seat 5: B7VAFAMs/PYlYABlV+EkSA folded before Flop (didn't bet)
Seat 6: mUoFJKqCzIUABvOFbiINlQ (button) folded before Flop (didn't bet)
Seat 7: yQc5nLaNmByxI15Jegu61w (small blind) folded on the Turn
Seat 8: LMd3gq2uNfbWTfXTnSeQRw (big blind) folded on the River
Seat 9: dN5zq7QdZCUe7NZFM6cECg folded before Flop (didn't bet)




PokerStars Game #59941999054:  Hold'em No Limit ($0.10/$0.25) - 2009/07/01 1:52:52 ET
Table 'a6FCGVBMPcT7J7BDN9q1zQ' 9-max Seat #4 is the button
Seat 1: bXpVeaSTPBFSPJmeXxO7nw ($4.65 in chips) 
Seat 2: M2QO2DxB5Wawg2h8HSpnYA ($11.75 in chips) 
Seat 3: tLcDklc2rBORNfixyRfVfw ($25 in chips) 
Seat 4: 8EbrQ/EvFWt2cr0GaU82gQ ($4.65 in chips) 
Seat 5: dtZ84flFEi4Q+SGrHMJRDQ ($25.30 in chips) 
Seat 6: dfNim92Z6XK1/h5SFW5vDg ($25 in chips) 
Seat 7: V0Yo5zRBVM8DYspLKafebg ($15.35 in chips) 
Seat 8: r6hsffOo1iKmaPYKwAZmFw ($64.35 in chips) 
Seat 9: wGigCmBR/9XWkPpvYos3aQ ($29.35 in chips) 
dtZ84flFEi4Q+SGrHMJRDQ: posts small blind $0.10
dfNim92Z6XK1/h5SFW5vDg: posts big blind $0.25
*** HOLE CARDS ***
V0Yo5zRBVM8DYspLKafebg: calls $0.25
r6hsffOo1iKmaPYKwAZmFw: folds 
wGigCmBR/9XWkPpvYos3aQ: folds 
bXpVeaSTPBFSPJmeXxO7nw: folds 
M2QO2DxB5Wawg2h8HSpnYA: folds 
tLcDklc2rBORNfixyRfVfw: folds 
8EbrQ/EvFWt2cr0GaU82gQ: folds 
dtZ84flFEi4Q+SGrHMJRDQ: calls $0.15
dfNim92Z6XK1/h5SFW5vDg: checks 
*** FLOP *** [Kh Js Jh]
dtZ84flFEi4Q+SGrHMJRDQ: checks 
dfNim92Z6XK1/h5SFW5vDg: checks 
V0Yo5zRBVM8DYspLKafebg: checks 
*** TURN *** [Kh Js Jh] [3c]
dtZ84flFEi4Q+SGrHMJRDQ: checks 
dfNim92Z6XK1/h5SFW5vDg: checks 
V0Yo5zRBVM8DYspLKafebg: checks 
*** RIVER *** [Kh Js Jh 3c] [5s]
dtZ84flFEi4Q+SGrHMJRDQ: bets $0.50
dfNim92Z6XK1/h5SFW5vDg: folds 
V0Yo5zRBVM8DYspLKafebg: calls $0.50
*** SHOW DOWN ***
dtZ84flFEi4Q+SGrHMJRDQ: shows [Ad Kc] (two pair, Kings and Jacks)
V0Yo5zRBVM8DYspLKafebg: mucks hand 
dtZ84flFEi4Q+SGrHMJRDQ collected $1.70 from pot
*** SUMMARY ***
Total pot $1.75 | Rake $0.05 
Board [Kh Js Jh 3c 5s]
Seat 1: bXpVeaSTPBFSPJmeXxO7nw folded before Flop (didn't bet)
Seat 2: M2QO2DxB5Wawg2h8HSpnYA folded before Flop (didn't bet)
Seat 3: tLcDklc2rBORNfixyRfVfw folded before Flop (didn't bet)
Seat 4: 8EbrQ/EvFWt2cr0GaU82gQ (button) folded before Flop (didn't bet)
Seat 5: dtZ84flFEi4Q+SGrHMJRDQ (small blind) showed [Ad Kc] and won ($1.70) with two pair, Kings and Jacks
Seat 6: dfNim92Z6XK1/h5SFW5vDg (big blind) folded on the River
Seat 7: V0Yo5zRBVM8DYspLKafebg mucked
Seat 8: r6hsffOo1iKmaPYKwAZmFw folded before Flop (didn't bet)
Seat 9: wGigCmBR/9XWkPpvYos3aQ folded before Flop (didn't bet)




PokerStars Game #59941999698:  Hold'em No Limit ($0.10/$0.25) - 2009/07/01 1:52:53 ET
Table 'g+mPuNJBCHKE9ents7ZGtg' 6-max Seat #6 is the button
Seat 1: cezpHJ8FB07dj0xG+LhOvw ($57.90 in chips) 
Seat 2: fZQg9veL7Dd/Z04ZTjC+wQ ($56.80 in chips) 
Seat 3: 8CPg15X6IHYR1pWm9ha1Sw ($25 in chips) 
Seat 6: Mn2V28t5aGq2d09z+/o6Fw ($36.45 in chips) 
cezpHJ8FB07dj0xG+LhOvw: posts small blind $0.10
fZQg9veL7Dd/Z04ZTjC+wQ: posts big blind $0.25
*** HOLE CARDS ***
8CPg15X6IHYR1pWm9ha1Sw: folds 
Mn2V28t5aGq2d09z+/o6Fw: calls $0.25
cezpHJ8FB07dj0xG+LhOvw: folds 
fZQg9veL7Dd/Z04ZTjC+wQ: checks 
*** FLOP *** [Qd 4d Qh]
fZQg9veL7Dd/Z04ZTjC+wQ: bets $0.50
Mn2V28t5aGq2d09z+/o6Fw: folds 
Uncalled bet ($0.50) returned to fZQg9veL7Dd/Z04ZTjC+wQ
fZQg9veL7Dd/Z04ZTjC+wQ collected $0.60 from pot
fZQg9veL7Dd/Z04ZTjC+wQ: doesn't show hand 
*** SUMMARY ***
Total pot $0.60 | Rake $0 
Board [Qd 4d Qh]
Seat 1: cezpHJ8FB07dj0xG+LhOvw (small blind) folded before Flop
Seat 2: fZQg9veL7Dd/Z04ZTjC+wQ (big blind) collected ($0.60)
Seat 3: 8CPg15X6IHYR1pWm9ha1Sw folded before Flop (didn't bet)
Seat 6: Mn2V28t5aGq2d09z+/o6Fw (button) folded on the Flop




PokerStars Game #59942000322:  Hold'em No Limit ($0.10/$0.25) - 2009/07/01 1:52:54 ET
Table 'K/f0NNaoGuhSz5DrzgVw7Q' 9-max Seat #8 is the button
Seat 1: sD+TKtt36XiiN6jqHiLwDA ($26.05 in chips) 
Seat 2: zgi+EUykT/pZQpoUG6+oEg ($4.65 in chips) 
Seat 4: 9bCz0uv2nUmznwuI0OjVGw ($11.05 in chips) 
Seat 5: DnDcAdn9P0zGovMERigpFA ($40.60 in chips) 
Seat 6: 3PVK0IdMlq2fElkVzzr4bg ($7 in chips) 
Seat 7: egvg3mTBBVzMHnJPIQiKcA ($15.20 in chips) 
Seat 8: RCqMONFrSPSArZh2Jsar/w ($25.35 in chips) 
Seat 9: tLcDklc2rBORNfixyRfVfw ($25 in chips) 
tLcDklc2rBORNfixyRfVfw: posts small blind $0.10
sD+TKtt36XiiN6jqHiLwDA: posts big blind $0.25
z5GxcHlYz/GSz6W2uFiTtg: sits out 
*** HOLE CARDS ***
zgi+EUykT/pZQpoUG6+oEg: folds 
9bCz0uv2nUmznwuI0OjVGw: calls $0.25
DnDcAdn9P0zGovMERigpFA: folds 
3PVK0IdMlq2fElkVzzr4bg is disconnected 
3PVK0IdMlq2fElkVzzr4bg is connected 
3PVK0IdMlq2fElkVzzr4bg: folds 
egvg3mTBBVzMHnJPIQiKcA: folds 
RCqMONFrSPSArZh2Jsar/w: folds 
tLcDklc2rBORNfixyRfVfw: folds 
sD+TKtt36XiiN6jqHiLwDA: checks 
*** FLOP *** [5s As 8h]
sD+TKtt36XiiN6jqHiLwDA: checks 
9bCz0uv2nUmznwuI0OjVGw: bets $0.50
sD+TKtt36XiiN6jqHiLwDA: folds 
Uncalled bet ($0.50) returned to 9bCz0uv2nUmznwuI0OjVGw
9bCz0uv2nUmznwuI0OjVGw collected $0.60 from pot
9bCz0uv2nUmznwuI0OjVGw: doesn't show hand 
*** SUMMARY ***
Total pot $0.60 | Rake $0 
Board [5s As 8h]
Seat 1: sD+TKtt36XiiN6jqHiLwDA (big blind) folded on the Flop
Seat 2: zgi+EUykT/pZQpoUG6+oEg folded before Flop (didn't bet)
Seat 4: 9bCz0uv2nUmznwuI0OjVGw collected ($0.60)
Seat 5: DnDcAdn9P0zGovMERigpFA folded before Flop (didn't bet)
Seat 6: 3PVK0IdMlq2fElkVzzr4bg folded before Flop (didn't bet)
Seat 7: egvg3mTBBVzMHnJPIQiKcA folded before Flop (didn't bet)
Seat 8: RCqMONFrSPSArZh2Jsar/w (button) folded before Flop (didn't bet)
Seat 9: tLcDklc2rBORNfixyRfVfw (small blind) folded before Flop




PokerStars Game #59941999912:  Hold'em No Limit ($0.10/$0.25) - 2009/07/01 1:52:54 ET
Table 'gnrUwXkIPE0C8xl6cB4Hyw' 9-max Seat #3 is the button
Seat 1: EQXHDnIzAsORnIXRNtXRlA ($22.60 in chips) 
Seat 2: 7je+LC5Mfs6nL8YBVh4frQ ($4.65 in chips) 
Seat 3: PdIasPkzm2sqZnN41ZRXOg ($5.35 in chips) 
Seat 4: wGigCmBR/9XWkPpvYos3aQ ($25 in chips) 
Seat 5: gehe91e0IyVT0QU/XBkEyg ($31.30 in chips) 
Seat 6: dtZ84flFEi4Q+SGrHMJRDQ ($26.15 in chips) 
Seat 8: 4awUyiDYTgylQKXZ9faBVA ($60.65 in chips) 
Seat 9: F7pnn6czNpHvRM55XcA2EA ($25.35 in chips) 
wGigCmBR/9XWkPpvYos3aQ: posts small blind $0.10
gehe91e0IyVT0QU/XBkEyg: posts big blind $0.25
RHqgdFvufLCYe54+qd2gcA: sits out 
*** HOLE CARDS ***
dtZ84flFEi4Q+SGrHMJRDQ: folds 
4awUyiDYTgylQKXZ9faBVA: raises $0.75 to $1
F7pnn6czNpHvRM55XcA2EA: folds 
EQXHDnIzAsORnIXRNtXRlA: folds 
7je+LC5Mfs6nL8YBVh4frQ: folds 
PdIasPkzm2sqZnN41ZRXOg: folds 
wGigCmBR/9XWkPpvYos3aQ: folds 
gehe91e0IyVT0QU/XBkEyg: folds 
Uncalled bet ($0.75) returned to 4awUyiDYTgylQKXZ9faBVA
4awUyiDYTgylQKXZ9faBVA collected $0.60 from pot
4awUyiDYTgylQKXZ9faBVA: doesn't show hand 
*** SUMMARY ***
Total pot $0.60 | Rake $0 
Seat 1: EQXHDnIzAsORnIXRNtXRlA folded before Flop (didn't bet)
Seat 2: 7je+LC5Mfs6nL8YBVh4frQ folded before Flop (didn't bet)
Seat 3: PdIasPkzm2sqZnN41ZRXOg (button) folded before Flop (didn't bet)
Seat 4: wGigCmBR/9XWkPpvYos3aQ (small blind) folded before Flop
Seat 5: gehe91e0IyVT0QU/XBkEyg (big blind) folded before Flop
Seat 6: dtZ84flFEi4Q+SGrHMJRDQ folded before Flop (didn't bet)
Seat 8: 4awUyiDYTgylQKXZ9faBVA collected ($0.60)
Seat 9: F7pnn6czNpHvRM55XcA2EA folded before Flop (didn't bet)




PokerStars Game #59942000214:  Hold'em No Limit ($0.10/$0.25) - 2009/07/01 1:52:54 ET
Table 'nc6OeGk/wtaWV+6N+kgnZQ' 6-max Seat #6 is the button
Seat 2: 8ClCHtFXGNplITm+63KB+Q ($37.35 in chips) 
Seat 3: y8wpMWGSX2zHZijurx21mg ($7.65 in chips) 
Seat 4: 3zD3qLXT1bEffAoWGnc7wg ($31.20 in chips) 
Seat 5: HCS0lMAAPmZE2Tl8J/SuKw ($7.30 in chips) 
Seat 6: kARKwAmU6kWJfiSICTYhVw ($9.65 in chips) 
8ClCHtFXGNplITm+63KB+Q: posts small blind $0.10
y8wpMWGSX2zHZijurx21mg: posts big blind $0.25
*** HOLE CARDS ***
3zD3qLXT1bEffAoWGnc7wg: folds 
HCS0lMAAPmZE2Tl8J/SuKw: folds 
kARKwAmU6kWJfiSICTYhVw: folds 
8ClCHtFXGNplITm+63KB+Q: folds 
Uncalled bet ($0.15) returned to y8wpMWGSX2zHZijurx21mg
y8wpMWGSX2zHZijurx21mg collected $0.20 from pot
y8wpMWGSX2zHZijurx21mg: doesn't show hand 
*** SUMMARY ***
Total pot $0.20 | Rake $0 
Seat 2: 8ClCHtFXGNplITm+63KB+Q (small blind) folded before Flop
Seat 3: y8wpMWGSX2zHZijurx21mg (big blind) collected ($0.20)
Seat 4: 3zD3qLXT1bEffAoWGnc7wg folded before Flop (didn't bet)
Seat 5: HCS0lMAAPmZE2Tl8J/SuKw folded before Flop (didn't bet)
Seat 6: kARKwAmU6kWJfiSICTYhVw (button) folded before Flop (didn't bet)




PokerStars Game #59942000320:  Hold'em No Limit ($0.10/$0.25) - 2009/07/01 1:52:54 ET
Table 'M7d9IrgQUUFFy/SZ3ksLYg' 6-max Seat #2 is the button
Seat 1: ypmjhffk/YHGc51wgVXUTw ($51.05 in chips) 
Seat 2: 8CPg15X6IHYR1pWm9ha1Sw ($25 in chips) 
Seat 3: epAUIB7h2FJXzUPRIvSkRA ($26 in chips) 
Seat 4: 8ClCHtFXGNplITm+63KB+Q ($22.50 in chips) 
Seat 6: 7S16WhQHiAVLWwRuqPrpnw ($14.45 in chips) 
epAUIB7h2FJXzUPRIvSkRA: posts small blind $0.10
8ClCHtFXGNplITm+63KB+Q: posts big blind $0.25
MVzl6OsGybVDNd3Vr9LYAA: sits out 
*** HOLE CARDS ***
7S16WhQHiAVLWwRuqPrpnw: folds 
ypmjhffk/YHGc51wgVXUTw: folds 
8CPg15X6IHYR1pWm9ha1Sw: folds 
7S16WhQHiAVLWwRuqPrpnw leaves the table
epAUIB7h2FJXzUPRIvSkRA: raises $0.75 to $1
8ClCHtFXGNplITm+63KB+Q: folds 
Uncalled bet ($0.75) returned to epAUIB7h2FJXzUPRIvSkRA
epAUIB7h2FJXzUPRIvSkRA collected $0.50 from pot
epAUIB7h2FJXzUPRIvSkRA: doesn't show hand 
*** SUMMARY ***
Total pot $0.50 | Rake $0 
Seat 1: ypmjhffk/YHGc51wgVXUTw folded before Flop (didn't bet)
Seat 2: 8CPg15X6IHYR1pWm9ha1Sw (button) folded before Flop (didn't bet)
Seat 3: epAUIB7h2FJXzUPRIvSkRA (small blind) collected ($0.50)
Seat 4: 8ClCHtFXGNplITm+63KB+Q (big blind) folded before Flop
Seat 6: 7S16WhQHiAVLWwRuqPrpnw folded before Flop (didn't bet)




PokerStars Game #59941999946:  Hold'em No Limit ($0.10/$0.25) - 2009/07/01 1:52:54 ET
Table '2clPgY3+dETPD/8zjXZdFw' 6-max Seat #4 is the button
Seat 1: 7cx44/slbeTw+Cy7QB8Trg ($27.45 in chips) 
Seat 2: cWc85bEzdRzpUMhRKm8pwQ ($25 in chips) 
Seat 4: ljjhtb6FVPTx9AT9HNdtqg ($23.10 in chips) 
Seat 5: LJI7A1YgDM7hgh7o56+ReQ ($30.20 in chips) 
Seat 6: c3J/KYZ4cNsUEuz8v57I5A ($23.25 in chips) 
LJI7A1YgDM7hgh7o56+ReQ: posts small blind $0.10
c3J/KYZ4cNsUEuz8v57I5A: posts big blind $0.25
*** HOLE CARDS ***
7cx44/slbeTw+Cy7QB8Trg: folds 
cWc85bEzdRzpUMhRKm8pwQ: folds 
ljjhtb6FVPTx9AT9HNdtqg: raises $0.50 to $0.75
LJI7A1YgDM7hgh7o56+ReQ: folds 
c3J/KYZ4cNsUEuz8v57I5A: folds 
Uncalled bet ($0.50) returned to ljjhtb6FVPTx9AT9HNdtqg
ljjhtb6FVPTx9AT9HNdtqg collected $0.60 from pot
*** SUMMARY ***
Total pot $0.60 | Rake $0 
Seat 1: 7cx44/slbeTw+Cy7QB8Trg folded before Flop (didn't bet)
Seat 2: cWc85bEzdRzpUMhRKm8pwQ folded before Flop (didn't bet)
Seat 4: ljjhtb6FVPTx9AT9HNdtqg (button) collected ($0.60)
Seat 5: LJI7A1YgDM7hgh7o56+ReQ (small blind) folded before Flop
Seat 6: c3J/KYZ4cNsUEuz8v57I5A (big blind) folded before Flop




PokerStars Game #59942000218:  Hold'em No Limit ($0.10/$0.25) - 2009/07/01 1:52:54 ET
Table '0XPo7K54oZIfG0xlNAcDRw' 9-max Seat #5 is the button
Seat 2: Prl9QvWQw/mISF4dSnnQUQ ($8.60 in chips) 
Seat 3: RHqgdFvufLCYe54+qd2gcA ($8.65 in chips) 
Seat 4: RubYqfvGrz2z+5ReNIj9QQ ($30.75 in chips) 
Seat 5: iOmwbUN7u4JFkV6VCA49aA ($15.35 in chips) 
Seat 6: M1nKET7WOTLbVPuAbJa3EA ($12.90 in chips) 
Seat 8: v5jnQ1gfh9nLla3kMXG7Yg ($16.30 in chips) 
Seat 9: CmngQmkKTp8tkl6GMRTl6w ($13.25 in chips) 
M1nKET7WOTLbVPuAbJa3EA: posts small blind $0.10
tYsOBqdU1+x+yFI7zHO7hQ: is sitting out 
v5jnQ1gfh9nLla3kMXG7Yg: posts big blind $0.25
4awUyiDYTgylQKXZ9faBVA: sits out 
*** HOLE CARDS ***
CmngQmkKTp8tkl6GMRTl6w: folds 
Prl9QvWQw/mISF4dSnnQUQ: calls $0.25
RHqgdFvufLCYe54+qd2gcA: folds 
RubYqfvGrz2z+5ReNIj9QQ: folds 
iOmwbUN7u4JFkV6VCA49aA said, "27"
iOmwbUN7u4JFkV6VCA49aA: raises $1.25 to $1.50
M1nKET7WOTLbVPuAbJa3EA: folds 
v5jnQ1gfh9nLla3kMXG7Yg: folds 
Prl9QvWQw/mISF4dSnnQUQ: calls $1.25
*** FLOP *** [Js 4d 7h]
v5jnQ1gfh9nLla3kMXG7Yg leaves the table
Prl9QvWQw/mISF4dSnnQUQ: checks 
iOmwbUN7u4JFkV6VCA49aA: checks 
*** TURN *** [Js 4d 7h] [Ah]
Prl9QvWQw/mISF4dSnnQUQ: checks 
iOmwbUN7u4JFkV6VCA49aA: checks 
*** RIVER *** [Js 4d 7h Ah] [8d]
Prl9QvWQw/mISF4dSnnQUQ: bets $2.25
iOmwbUN7u4JFkV6VCA49aA: folds 
Uncalled bet ($2.25) returned to Prl9QvWQw/mISF4dSnnQUQ
Prl9QvWQw/mISF4dSnnQUQ collected $3.20 from pot
*** SUMMARY ***
Total pot $3.35 | Rake $0.15 
Board [Js 4d 7h Ah 8d]
Seat 2: Prl9QvWQw/mISF4dSnnQUQ collected ($3.20)
Seat 3: RHqgdFvufLCYe54+qd2gcA folded before Flop (didn't bet)
Seat 4: RubYqfvGrz2z+5ReNIj9QQ folded before Flop (didn't bet)
Seat 5: iOmwbUN7u4JFkV6VCA49aA (button) folded on the River
Seat 6: M1nKET7WOTLbVPuAbJa3EA (small blind) folded before Flop
Seat 8: v5jnQ1gfh9nLla3kMXG7Yg (big blind) folded before Flop
Seat 9: CmngQmkKTp8tkl6GMRTl6w folded before Flop (didn't bet)




PokerStars Game #59942000190:  Hold'em No Limit ($0.10/$0.25) - 2009/07/01 1:52:54 ET
Table 'R5qKG21jwFDYRcOht9qwqQ' 9-max Seat #7 is the button
Seat 1: N5sUK8M0br9djLrW97V9pQ ($24.15 in chips) 
Seat 2: N6foVRyErHqcNmshkqextQ ($13.45 in chips) 
Seat 3: M2QO2DxB5Wawg2h8HSpnYA ($10.50 in chips) 
Seat 6: EP17SQz/iWcuYdNOGeBgkw ($14.65 in chips) 
Seat 7: zgi+EUykT/pZQpoUG6+oEg ($4.05 in chips) 
Seat 9: MG90wfSJZnOejs/KD3vlQQ ($43.75 in chips) 
MG90wfSJZnOejs/KD3vlQQ: posts small blind $0.10
N5sUK8M0br9djLrW97V9pQ: posts big blind $0.25
z5GxcHlYz/GSz6W2uFiTtg: sits out 
*** HOLE CARDS ***
N6foVRyErHqcNmshkqextQ: folds 
M2QO2DxB5Wawg2h8HSpnYA: folds 
EP17SQz/iWcuYdNOGeBgkw: calls $0.25
zgi+EUykT/pZQpoUG6+oEg: folds 
hYvTc4PYNrAaNAIVoM94Hw leaves the table
MG90wfSJZnOejs/KD3vlQQ: calls $0.15
N5sUK8M0br9djLrW97V9pQ: raises $1 to $1.25
zUXhymECc2C9W9ZNw6qppA is connected 
EP17SQz/iWcuYdNOGeBgkw: folds 
MG90wfSJZnOejs/KD3vlQQ: calls $1
*** FLOP *** [As 5c 3h]
MG90wfSJZnOejs/KD3vlQQ: bets $2.10
UmmmmmYeah joins the table at seat #8 
N5sUK8M0br9djLrW97V9pQ: folds 
Uncalled bet ($2.10) returned to MG90wfSJZnOejs/KD3vlQQ
zUXhymECc2C9W9ZNw6qppA has returned
MG90wfSJZnOejs/KD3vlQQ collected $2.65 from pot
MG90wfSJZnOejs/KD3vlQQ: doesn't show hand 
*** SUMMARY ***
Total pot $2.75 | Rake $0.10 
Board [As 5c 3h]
Seat 1: N5sUK8M0br9djLrW97V9pQ (big blind) folded on the Flop
Seat 2: N6foVRyErHqcNmshkqextQ folded before Flop (didn't bet)
Seat 3: M2QO2DxB5Wawg2h8HSpnYA folded before Flop (didn't bet)
Seat 6: EP17SQz/iWcuYdNOGeBgkw folded before Flop
Seat 7: zgi+EUykT/pZQpoUG6+oEg (button) folded before Flop (didn't bet)
Seat 9: MG90wfSJZnOejs/KD3vlQQ (small blind) collected ($2.65)




PokerStars Game #59942000786:  Hold'em No Limit ($0.10/$0.25) - 2009/07/01 1:52:55 ET
Table '84TjTrgbsYZladOc4PWf4Q' 6-max Seat #4 is the button
Seat 1: /kW0t5kKllzd8HO2uEapHQ ($16.70 in chips) 
Seat 2: RpaEX9P7BCvyfPRLiRNg0A ($46.85 in chips) 
Seat 3: Ar4vsUIUfJ7gbYh1c1m59g ($10.85 in chips) 
Seat 4: SxIIgwXYLkwd6m3wLyPTCw ($38.10 in chips) 
Seat 5: cezpHJ8FB07dj0xG+LhOvw ($28.65 in chips) 
Seat 6: wCUaomJ6Nq5zomVGdUHP+w ($8.80 in chips) 
cezpHJ8FB07dj0xG+LhOvw: posts small blind $0.10
wCUaomJ6Nq5zomVGdUHP+w: posts big blind $0.25
*** HOLE CARDS ***
/kW0t5kKllzd8HO2uEapHQ: folds 
RpaEX9P7BCvyfPRLiRNg0A: raises $0.75 to $1
Ar4vsUIUfJ7gbYh1c1m59g: folds 
SxIIgwXYLkwd6m3wLyPTCw: calls $1
cezpHJ8FB07dj0xG+LhOvw: folds 
wCUaomJ6Nq5zomVGdUHP+w: folds 
*** FLOP *** [5d 2d 7c]
RpaEX9P7BCvyfPRLiRNg0A: bets $2
SxIIgwXYLkwd6m3wLyPTCw: calls $2
*** TURN *** [5d 2d 7c] [3c]
RpaEX9P7BCvyfPRLiRNg0A: checks 
SxIIgwXYLkwd6m3wLyPTCw: bets $4
RpaEX9P7BCvyfPRLiRNg0A: folds 
Uncalled bet ($4) returned to SxIIgwXYLkwd6m3wLyPTCw
SxIIgwXYLkwd6m3wLyPTCw collected $6.05 from pot
SxIIgwXYLkwd6m3wLyPTCw: doesn't show hand 
*** SUMMARY ***
Total pot $6.35 | Rake $0.30 
Board [5d 2d 7c 3c]
Seat 1: /kW0t5kKllzd8HO2uEapHQ folded before Flop (didn't bet)
Seat 2: RpaEX9P7BCvyfPRLiRNg0A folded on the Turn
Seat 3: Ar4vsUIUfJ7gbYh1c1m59g folded before Flop (didn't bet)
Seat 4: SxIIgwXYLkwd6m3wLyPTCw (button) collected ($6.05)
Seat 5: cezpHJ8FB07dj0xG+LhOvw (small blind) folded before Flop
Seat 6: wCUaomJ6Nq5zomVGdUHP+w (big blind) folded before Flop




PokerStars Game #59942000632:  Hold'em No Limit ($0.10/$0.25) - 2009/07/01 1:52:55 ET
Table 'dZNBGqFYSwfOVZvDJ4VjIQ' 6-max Seat #3 is the button
Seat 1: v+QfkGiuj9bgtuNoVnDO8w ($37.65 in chips) 
Seat 2: 3zD3qLXT1bEffAoWGnc7wg ($27.95 in chips) 
Seat 3: kyRaCIljYA6l33lSKQfNsg ($29.35 in chips) 
Seat 4: GbCVUNssQ7mqsPWr7J4d3w ($4.75 in chips) 
Seat 5: +ZlnqPoP3Hg4BIUxDfKd/A ($27.40 in chips) 
Seat 6: ypmjhffk/YHGc51wgVXUTw ($31.25 in chips) 
GbCVUNssQ7mqsPWr7J4d3w: posts small blind $0.10
+ZlnqPoP3Hg4BIUxDfKd/A: posts big blind $0.25
*** HOLE CARDS ***
ypmjhffk/YHGc51wgVXUTw: folds 
v+QfkGiuj9bgtuNoVnDO8w: folds 
3zD3qLXT1bEffAoWGnc7wg: folds 
kyRaCIljYA6l33lSKQfNsg: raises $0.50 to $0.75
GbCVUNssQ7mqsPWr7J4d3w: folds 
+ZlnqPoP3Hg4BIUxDfKd/A: folds 
Uncalled bet ($0.50) returned to kyRaCIljYA6l33lSKQfNsg
kyRaCIljYA6l33lSKQfNsg collected $0.60 from pot
*** SUMMARY ***
Total pot $0.60 | Rake $0 
Seat 1: v+QfkGiuj9bgtuNoVnDO8w folded before Flop (didn't bet)
Seat 2: 3zD3qLXT1bEffAoWGnc7wg folded before Flop (didn't bet)
Seat 3: kyRaCIljYA6l33lSKQfNsg (button) collected ($0.60)
Seat 4: GbCVUNssQ7mqsPWr7J4d3w (small blind) folded before Flop
Seat 5: +ZlnqPoP3Hg4BIUxDfKd/A (big blind) folded before Flop
Seat 6: ypmjhffk/YHGc51wgVXUTw folded before Flop (didn't bet)




PokerStars Game #59942000432:  Hold'em No Limit ($0.10/$0.25) - 2009/07/01 1:52:55 ET
Table '9o8Yb3JpUqurD4pNVmOikQ' 6-max Seat #1 is the button
Seat 1: SFmT9ZsVopnukjvAzrxTRg ($25.30 in chips) 
Seat 2: /gJNBeCkWL4o85/jvlZ4BA ($29.80 in chips) 
Seat 3: JgRqo1/2phbf7pab7N3BIQ ($18.25 in chips) 
Seat 5: QqiZLFrN8iOUT/GHw7ztOA ($23.95 in chips) 
Seat 6: LyDHtw3/yniNHW+DvLXbog ($28.80 in chips) 
/gJNBeCkWL4o85/jvlZ4BA: posts small blind $0.10
JgRqo1/2phbf7pab7N3BIQ: posts big blind $0.25
AyreonChen: sits out 
*** HOLE CARDS ***
QqiZLFrN8iOUT/GHw7ztOA: folds 
LyDHtw3/yniNHW+DvLXbog: folds 
SFmT9ZsVopnukjvAzrxTRg: folds 
/gJNBeCkWL4o85/jvlZ4BA: folds 
Uncalled bet ($0.15) returned to JgRqo1/2phbf7pab7N3BIQ
JgRqo1/2phbf7pab7N3BIQ collected $0.20 from pot
*** SUMMARY ***
Total pot $0.20 | Rake $0 
Seat 1: SFmT9ZsVopnukjvAzrxTRg (button) folded before Flop (didn't bet)
Seat 2: /gJNBeCkWL4o85/jvlZ4BA (small blind) folded before Flop
Seat 3: JgRqo1/2phbf7pab7N3BIQ (big blind) collected ($0.20)
Seat 5: QqiZLFrN8iOUT/GHw7ztOA folded before Flop (didn't bet)
Seat 6: LyDHtw3/yniNHW+DvLXbog folded before Flop (didn't bet)




PokerStars Game #59942000888:  Hold'em No Limit ($0.10/$0.25) - 2009/07/01 1:52:55 ET
Table 'YlRA05h9BJ1EhOUSNUjJdg' 9-max Seat #9 is the button
Seat 1: dtZ84flFEi4Q+SGrHMJRDQ ($25.10 in chips) 
Seat 2: Y2GFAe+PT7xnUUtgqCNDFw ($9.05 in chips) 
Seat 3: Z5ZtGOON8kmSdSCll9Z3XA ($13.20 in chips) 
Seat 4: HPEB+AtKw1+C/cxU0o1ciw ($33.95 in chips) 
Seat 5: sx0lGrkT9fd4yFR+3cXUQg ($11.15 in chips) 
Seat 6: QEbIGci+itdw+re8RM5fZA ($43.65 in chips) 
Seat 7: dfNim92Z6XK1/h5SFW5vDg ($25 in chips) 
Seat 8: dmYlc+1cjwZMJ7wV+Z0rRg ($32.55 in chips) 
Seat 9: GeMoapCKDLc4ajT0Uk9ZQw ($10.75 in chips) 
dtZ84flFEi4Q+SGrHMJRDQ: posts small blind $0.10
Y2GFAe+PT7xnUUtgqCNDFw: posts big blind $0.25
*** HOLE CARDS ***
Z5ZtGOON8kmSdSCll9Z3XA: calls $0.25
HPEB+AtKw1+C/cxU0o1ciw: folds 
sx0lGrkT9fd4yFR+3cXUQg: folds 
QEbIGci+itdw+re8RM5fZA: folds 
dfNim92Z6XK1/h5SFW5vDg: folds 
dmYlc+1cjwZMJ7wV+Z0rRg: folds 
GeMoapCKDLc4ajT0Uk9ZQw: folds 
dtZ84flFEi4Q+SGrHMJRDQ: calls $0.15
Y2GFAe+PT7xnUUtgqCNDFw: checks 
*** FLOP *** [8s Kd 5d]
dtZ84flFEi4Q+SGrHMJRDQ: checks 
Y2GFAe+PT7xnUUtgqCNDFw: checks 
Z5ZtGOON8kmSdSCll9Z3XA: bets $0.50
dtZ84flFEi4Q+SGrHMJRDQ: folds 
Y2GFAe+PT7xnUUtgqCNDFw: folds 
Uncalled bet ($0.50) returned to Z5ZtGOON8kmSdSCll9Z3XA
Z5ZtGOON8kmSdSCll9Z3XA collected $0.75 from pot
*** SUMMARY ***
Total pot $0.75 | Rake $0 
Board [8s Kd 5d]
Seat 1: dtZ84flFEi4Q+SGrHMJRDQ (small blind) folded on the Flop
Seat 2: Y2GFAe+PT7xnUUtgqCNDFw (big blind) folded on the Flop
Seat 3: Z5ZtGOON8kmSdSCll9Z3XA collected ($0.75)
Seat 4: HPEB+AtKw1+C/cxU0o1ciw folded before Flop (didn't bet)
Seat 5: sx0lGrkT9fd4yFR+3cXUQg folded before Flop (didn't bet)
Seat 6: QEbIGci+itdw+re8RM5fZA folded before Flop (didn't bet)
Seat 7: dfNim92Z6XK1/h5SFW5vDg folded before Flop (didn't bet)
Seat 8: dmYlc+1cjwZMJ7wV+Z0rRg folded before Flop (didn't bet)
Seat 9: GeMoapCKDLc4ajT0Uk9ZQw (button) folded before Flop (didn't bet)




PokerStars Game #59942000832:  Hold'em No Limit ($0.10/$0.25) - 2009/07/01 1:52:55 ET
Table 'rpIHGyt2QpgQc5bvptAvDQ' 9-max Seat #8 is the button
Seat 1: E0iYnEVO2ho7dH3QcCjw7g ($24.10 in chips) 
Seat 2: FX0yWp7Ul3dMebXB0cFjEw ($5.45 in chips) 
Seat 3: N6a/f6AW8S8G3JFw9IFxAg ($21.30 in chips) 
Seat 4: ASXDkj9tmvF/T2AsNuxg7g ($9 in chips) 
Seat 5: XhSvfX1gy0yx/qeW+SOeTw ($12.05 in chips) 
Seat 6: Mq1ESwxx3LEsA4HjKKjU3Q ($19.10 in chips) 
Seat 7: GHgIdzlzMAmRmmX7jgXtuQ ($1.45 in chips) 
Seat 8: oUgIL46CfA9GCdIuN1TVSw ($8.20 in chips) 
Seat 9: sUVgUtgbfVx6JpvApozwhQ ($5 in chips) 
sUVgUtgbfVx6JpvApozwhQ: posts small blind $0.10
E0iYnEVO2ho7dH3QcCjw7g: posts big blind $0.25
*** HOLE CARDS ***
FX0yWp7Ul3dMebXB0cFjEw: calls $0.25
N6a/f6AW8S8G3JFw9IFxAg: calls $0.25
ASXDkj9tmvF/T2AsNuxg7g: folds 
XhSvfX1gy0yx/qeW+SOeTw: calls $0.25
Mq1ESwxx3LEsA4HjKKjU3Q: folds 
GHgIdzlzMAmRmmX7jgXtuQ: folds 
oUgIL46CfA9GCdIuN1TVSw: calls $0.25
sUVgUtgbfVx6JpvApozwhQ has timed out
sUVgUtgbfVx6JpvApozwhQ: folds 
sUVgUtgbfVx6JpvApozwhQ is sitting out
E0iYnEVO2ho7dH3QcCjw7g: checks 
*** FLOP *** [6s Qs Js]
sUVgUtgbfVx6JpvApozwhQ has returned
E0iYnEVO2ho7dH3QcCjw7g: checks 
FX0yWp7Ul3dMebXB0cFjEw: checks 
N6a/f6AW8S8G3JFw9IFxAg: bets $2.25
XhSvfX1gy0yx/qeW+SOeTw: folds 
oUgIL46CfA9GCdIuN1TVSw: folds 
E0iYnEVO2ho7dH3QcCjw7g: folds 
FX0yWp7Ul3dMebXB0cFjEw: folds 
Uncalled bet ($2.25) returned to N6a/f6AW8S8G3JFw9IFxAg
N6a/f6AW8S8G3JFw9IFxAg collected $1.30 from pot
N6a/f6AW8S8G3JFw9IFxAg: doesn't show hand 
*** SUMMARY ***
Total pot $1.35 | Rake $0.05 
Board [6s Qs Js]
Seat 1: E0iYnEVO2ho7dH3QcCjw7g (big blind) folded on the Flop
Seat 2: FX0yWp7Ul3dMebXB0cFjEw folded on the Flop
Seat 3: N6a/f6AW8S8G3JFw9IFxAg collected ($1.30)
Seat 4: ASXDkj9tmvF/T2AsNuxg7g folded before Flop (didn't bet)
Seat 5: XhSvfX1gy0yx/qeW+SOeTw folded on the Flop
Seat 6: Mq1ESwxx3LEsA4HjKKjU3Q folded before Flop (didn't bet)
Seat 7: GHgIdzlzMAmRmmX7jgXtuQ folded before Flop (didn't bet)
Seat 8: oUgIL46CfA9GCdIuN1TVSw (button) folded on the Flop
Seat 9: sUVgUtgbfVx6JpvApozwhQ (small blind) folded before Flop




PokerStars Game #59942001246:  Hold'em No Limit ($0.10/$0.25) - 2009/07/01 1:52:56 ET
Table 'JPFXJXa5xBkjZ/W15BKqeQ' 9-max Seat #5 is the button
Seat 1: zgi+EUykT/pZQpoUG6+oEg ($5.10 in chips) 
Seat 2: XMSS6mD5B42I8wasdOMipQ ($12.75 in chips) 
Seat 3: 56S3mA6Zs3pGR+0p0vUCtg ($19.55 in chips) 
Seat 4: wGigCmBR/9XWkPpvYos3aQ ($32.55 in chips) 
Seat 5: cZ99hugmLBj9KhTlc8nCSw ($25.25 in chips) 
Seat 6: tLcDklc2rBORNfixyRfVfw ($25 in chips) 
Seat 7: PdIasPkzm2sqZnN41ZRXOg ($5 in chips) 
Seat 9: V6p0jQ/RhUsqpHLmXvEX4Q ($12.25 in chips) 
tLcDklc2rBORNfixyRfVfw: posts small blind $0.10
PdIasPkzm2sqZnN41ZRXOg: posts big blind $0.25
*** HOLE CARDS ***
V6p0jQ/RhUsqpHLmXvEX4Q: folds 
zgi+EUykT/pZQpoUG6+oEg: folds 
XMSS6mD5B42I8wasdOMipQ: raises $0.75 to $1
56S3mA6Zs3pGR+0p0vUCtg: calls $1
wGigCmBR/9XWkPpvYos3aQ: folds 
cZ99hugmLBj9KhTlc8nCSw: folds 
tLcDklc2rBORNfixyRfVfw: folds 
PdIasPkzm2sqZnN41ZRXOg: folds 
*** FLOP *** [Js 6d 3h]
XMSS6mD5B42I8wasdOMipQ: bets $1.25
56S3mA6Zs3pGR+0p0vUCtg: raises $2.50 to $3.75
XMSS6mD5B42I8wasdOMipQ: raises $8 to $11.75 and is all-in
56S3mA6Zs3pGR+0p0vUCtg: calls $8
*** TURN *** [Js 6d 3h] [3s]
*** RIVER *** [Js 6d 3h 3s] [8s]
*** SHOW DOWN ***
XMSS6mD5B42I8wasdOMipQ: shows [Tc Th] (two pair, Tens and Threes)
56S3mA6Zs3pGR+0p0vUCtg: shows [Ac Ah] (two pair, Aces and Threes)
56S3mA6Zs3pGR+0p0vUCtg collected $24.60 from pot
*** SUMMARY ***
Total pot $25.85 | Rake $1.25 
Board [Js 6d 3h 3s 8s]
Seat 1: zgi+EUykT/pZQpoUG6+oEg folded before Flop (didn't bet)
Seat 2: XMSS6mD5B42I8wasdOMipQ showed [Tc Th] and lost with two pair, Tens and Threes
Seat 3: 56S3mA6Zs3pGR+0p0vUCtg showed [Ac Ah] and won ($24.60) with two pair, Aces and Threes
Seat 4: wGigCmBR/9XWkPpvYos3aQ folded before Flop (didn't bet)
Seat 5: cZ99hugmLBj9KhTlc8nCSw (button) folded before Flop (didn't bet)
Seat 6: tLcDklc2rBORNfixyRfVfw (small blind) folded before Flop
Seat 7: PdIasPkzm2sqZnN41ZRXOg (big blind) folded before Flop
Seat 9: V6p0jQ/RhUsqpHLmXvEX4Q folded before Flop (didn't bet)




PokerStars Game #59942001094:  Hold'em No Limit ($0.10/$0.25) - 2009/07/01 1:52:56 ET
Table 'vud0GB/ZlDCvUFhBFIaTlg' 9-max Seat #1 is the button
Seat 1: DiSvPC2iudwL5j9u6Huyww ($29.15 in chips) 
Seat 2: tLcDklc2rBORNfixyRfVfw ($25.10 in chips) 
Seat 3: W2YYHvqjaEpRrO7stZkClQ ($5.05 in chips) 
Seat 5: PFv56Q1PTkDC084eXIAYmw ($5.35 in chips) 
Seat 6: gehe91e0IyVT0QU/XBkEyg ($24.90 in chips) 
Seat 7: iG7VeTyBWf6wYNvZpbTcbw ($22.15 in chips) 
Seat 8: E0iYnEVO2ho7dH3QcCjw7g ($19.25 in chips) 
Seat 9: PdIasPkzm2sqZnN41ZRXOg ($5.45 in chips) 
tLcDklc2rBORNfixyRfVfw: posts small blind $0.10
W2YYHvqjaEpRrO7stZkClQ: posts big blind $0.25
JqeaikMej6KsqTKmUhl2Lw: sits out 
*** HOLE CARDS ***
PFv56Q1PTkDC084eXIAYmw: folds 
gehe91e0IyVT0QU/XBkEyg: folds 
iG7VeTyBWf6wYNvZpbTcbw: folds 
E0iYnEVO2ho7dH3QcCjw7g: folds 
PdIasPkzm2sqZnN41ZRXOg: folds 
DiSvPC2iudwL5j9u6Huyww: folds 
tLcDklc2rBORNfixyRfVfw: raises $0.75 to $1
W2YYHvqjaEpRrO7stZkClQ: folds 
Uncalled bet ($0.75) returned to tLcDklc2rBORNfixyRfVfw
tLcDklc2rBORNfixyRfVfw collected $0.50 from pot
tLcDklc2rBORNfixyRfVfw: doesn't show hand 
*** SUMMARY ***
Total pot $0.50 | Rake $0 
Seat 1: DiSvPC2iudwL5j9u6Huyww (button) folded before Flop (didn't bet)
Seat 2: tLcDklc2rBORNfixyRfVfw (small blind) collected ($0.50)
Seat 3: W2YYHvqjaEpRrO7stZkClQ (big blind) folded before Flop
Seat 5: PFv56Q1PTkDC084eXIAYmw folded before Flop (didn't bet)
Seat 6: gehe91e0IyVT0QU/XBkEyg folded before Flop (didn't bet)
Seat 7: iG7VeTyBWf6wYNvZpbTcbw folded before Flop (didn't bet)
Seat 8: E0iYnEVO2ho7dH3QcCjw7g folded before Flop (didn't bet)
Seat 9: PdIasPkzm2sqZnN41ZRXOg folded before Flop (didn't bet)




PokerStars Game #59942001360:  Hold'em No Limit ($0.10/$0.25) - 2009/07/01 1:52:56 ET
Table 'Ez9TB43XM4QgMDQkIW9DYw' 9-max Seat #8 is the button
Seat 1: ShCS62CJp4MKfKLKvGKQbA ($11.55 in chips) 
Seat 2: PFNLAvMkr8qKc7xCiH0wTA ($17 in chips) 
Seat 3: PdIasPkzm2sqZnN41ZRXOg ($6.25 in chips) 
Seat 4: ubsjZomMWSV0hAiBLa7K1A ($20.45 in chips) 
Seat 6: 76o85YBHJ9veRYp2LPuluQ ($17.50 in chips) 
Seat 7: Bb42QRQMhg5/Y0vHP8/2Xw ($55.60 in chips) 
Seat 8: +2kMBNpY4nF1qNCRd8SJLA ($28 in chips) 
Seat 9: QEbIGci+itdw+re8RM5fZA ($25 in chips) 
QEbIGci+itdw+re8RM5fZA: posts small blind $0.10
ShCS62CJp4MKfKLKvGKQbA: posts big blind $0.25
18G4P1XstjNvItdGUITxgw: sits out 
*** HOLE CARDS ***
PFNLAvMkr8qKc7xCiH0wTA: folds 
PdIasPkzm2sqZnN41ZRXOg: raises $0.25 to $0.50
ubsjZomMWSV0hAiBLa7K1A: calls $0.50
76o85YBHJ9veRYp2LPuluQ: calls $0.50
Bb42QRQMhg5/Y0vHP8/2Xw: folds 
+2kMBNpY4nF1qNCRd8SJLA: folds 
QEbIGci+itdw+re8RM5fZA: calls $0.40
ShCS62CJp4MKfKLKvGKQbA: calls $0.25
*** FLOP *** [As 3c Qc]
QEbIGci+itdw+re8RM5fZA: checks 
ShCS62CJp4MKfKLKvGKQbA: checks 
PdIasPkzm2sqZnN41ZRXOg: checks 
ubsjZomMWSV0hAiBLa7K1A: checks 
76o85YBHJ9veRYp2LPuluQ: bets $0.50
QEbIGci+itdw+re8RM5fZA: folds 
ShCS62CJp4MKfKLKvGKQbA: calls $0.50
PdIasPkzm2sqZnN41ZRXOg: folds 
ubsjZomMWSV0hAiBLa7K1A: folds 
*** TURN *** [As 3c Qc] [6d]
ShCS62CJp4MKfKLKvGKQbA: checks 
76o85YBHJ9veRYp2LPuluQ: bets $1
ShCS62CJp4MKfKLKvGKQbA: calls $1
*** RIVER *** [As 3c Qc 6d] [6h]
ShCS62CJp4MKfKLKvGKQbA: checks 
76o85YBHJ9veRYp2LPuluQ: bets $2
ShCS62CJp4MKfKLKvGKQbA: calls $2
*** SHOW DOWN ***
76o85YBHJ9veRYp2LPuluQ: shows [Jh 5h] (a pair of Sixes)
ShCS62CJp4MKfKLKvGKQbA: shows [Kc Ac] (two pair, Aces and Sixes)
ShCS62CJp4MKfKLKvGKQbA collected $9.05 from pot
*** SUMMARY ***
Total pot $9.50 | Rake $0.45 
Board [As 3c Qc 6d 6h]
Seat 1: ShCS62CJp4MKfKLKvGKQbA (big blind) showed [Kc Ac] and won ($9.05) with two pair, Aces and Sixes
Seat 2: PFNLAvMkr8qKc7xCiH0wTA folded before Flop (didn't bet)
Seat 3: PdIasPkzm2sqZnN41ZRXOg folded on the Flop
Seat 4: ubsjZomMWSV0hAiBLa7K1A folded on the Flop
Seat 6: 76o85YBHJ9veRYp2LPuluQ showed [Jh 5h] and lost with a pair of Sixes
Seat 7: Bb42QRQMhg5/Y0vHP8/2Xw folded before Flop (didn't bet)
Seat 8: +2kMBNpY4nF1qNCRd8SJLA (button) folded before Flop (didn't bet)
Seat 9: QEbIGci+itdw+re8RM5fZA (small blind) folded on the Flop




PokerStars Game #59942001274:  Hold'em No Limit ($0.10/$0.25) - 2009/07/01 1:52:56 ET
Table 'emoxgHTxg9Uqeu06oLzLyg' 6-max Seat #5 is the button
Seat 1: epAUIB7h2FJXzUPRIvSkRA ($33.85 in chips) 
Seat 2: wIFhgE1PVdX6Xf6aVlSTPg ($30 in chips) 
Seat 4: 3VAbqAWh8ncE2SJOYIx2ZQ ($14.65 in chips) 
Seat 5: OIjOiBfQstWrK/RuXx7zcw ($7.20 in chips) 
Seat 6: u3Ol7kv1LmvszuHNm9rc6w ($19.35 in chips) 
u3Ol7kv1LmvszuHNm9rc6w: posts small blind $0.10
epAUIB7h2FJXzUPRIvSkRA: posts big blind $0.25
*** HOLE CARDS ***
wIFhgE1PVdX6Xf6aVlSTPg: folds 
3VAbqAWh8ncE2SJOYIx2ZQ: folds 
OIjOiBfQstWrK/RuXx7zcw: calls $0.25
u3Ol7kv1LmvszuHNm9rc6w: calls $0.15
epAUIB7h2FJXzUPRIvSkRA: checks 
*** FLOP *** [Ah Ad 9h]
u3Ol7kv1LmvszuHNm9rc6w: checks 
epAUIB7h2FJXzUPRIvSkRA: checks 
OIjOiBfQstWrK/RuXx7zcw: checks 
*** TURN *** [Ah Ad 9h] [As]
u3Ol7kv1LmvszuHNm9rc6w: bets $0.50
epAUIB7h2FJXzUPRIvSkRA: folds 
OIjOiBfQstWrK/RuXx7zcw: raises $0.50 to $1
u3Ol7kv1LmvszuHNm9rc6w: calls $0.50
*** RIVER *** [Ah Ad 9h As] [6s]
u3Ol7kv1LmvszuHNm9rc6w: checks 
OIjOiBfQstWrK/RuXx7zcw: bets $3
u3Ol7kv1LmvszuHNm9rc6w: calls $3
*** SHOW DOWN ***
OIjOiBfQstWrK/RuXx7zcw: shows [8d Ac] (four of a kind, Aces)
u3Ol7kv1LmvszuHNm9rc6w: mucks hand 
OIjOiBfQstWrK/RuXx7zcw collected $8.35 from pot
*** SUMMARY ***
Total pot $8.75 | Rake $0.40 
Board [Ah Ad 9h As 6s]
Seat 1: epAUIB7h2FJXzUPRIvSkRA (big blind) folded on the Turn
Seat 2: wIFhgE1PVdX6Xf6aVlSTPg folded before Flop (didn't bet)
Seat 4: 3VAbqAWh8ncE2SJOYIx2ZQ folded before Flop (didn't bet)
Seat 5: OIjOiBfQstWrK/RuXx7zcw (button) showed [8d Ac] and won ($8.35) with four of a kind, Aces
Seat 6: u3Ol7kv1LmvszuHNm9rc6w (small blind) mucked




PokerStars Game #59942001420:  Hold'em No Limit ($0.10/$0.25) - 2009/07/01 1:52:56 ET
Table 'MRfAiS/4JSfnUDlCcZo0wAhfHe8uKeSJMyWAjSdM7ROQx Seat #2 is the button
Seat 1: 48oT5xFI+5CHUJlfoGrE4w ($29.30 in chips) 
Seat 2: /gJNBeCkWL4o85/jvlZ4BA ($25.35 in chips) 
Seat 4: b4wRQV3APH8irVk6bUFe2Q ($36.85 in chips) 
Seat 5: Q1uciOZPBR/WkAlqa6cL4A ($27.85 in chips) 
Seat 6: df01R5ThvHspD8FgKmaDvQ ($26 in chips) 
b4wRQV3APH8irVk6bUFe2Q: posts small blind $0.10
Q1uciOZPBR/WkAlqa6cL4A: posts big blind $0.25
*** HOLE CARDS ***
df01R5ThvHspD8FgKmaDvQ: folds 
48oT5xFI+5CHUJlfoGrE4w: folds 
/gJNBeCkWL4o85/jvlZ4BA: raises $0.75 to $1
b4wRQV3APH8irVk6bUFe2Q: folds 
Q1uciOZPBR/WkAlqa6cL4A: folds 
Uncalled bet ($0.75) returned to /gJNBeCkWL4o85/jvlZ4BA
/gJNBeCkWL4o85/jvlZ4BA collected $0.60 from pot
*** SUMMARY ***
Total pot $0.60 | Rake $0 
Seat 1: 48oT5xFI+5CHUJlfoGrE4w folded before Flop (didn't bet)
Seat 2: /gJNBeCkWL4o85/jvlZ4BA (button) collected ($0.60)
Seat 4: b4wRQV3APH8irVk6bUFe2Q (small blind) folded before Flop
Seat 5: Q1uciOZPBR/WkAlqa6cL4A (big blind) folded before Flop
Seat 6: df01R5ThvHspD8FgKmaDvQ folded before Flop (didn't bet)




PokerStars Game #59942000990:  Hold'em No Limit ($0.10/$0.25) - 2009/07/01 1:52:56 ET
Table 'qryc9C/ELyQ3lubOaELNAQ' 6-max Seat #4 is the button
Seat 1: OZc6kkoTwtITj1ZfreJK1A ($84.30 in chips) 
Seat 2: LtASJ9OlkqGrrUKGQlpGAw ($29.45 in chips) 
Seat 4: v+QfkGiuj9bgtuNoVnDO8w ($25 in chips) 
Seat 5: 9StOHp+Y1T0K13JdgS2oQQ ($38.65 in chips) 
9StOHp+Y1T0K13JdgS2oQQ: posts small blind $0.10
OZc6kkoTwtITj1ZfreJK1A: posts big blind $0.25
*** HOLE CARDS ***
LtASJ9OlkqGrrUKGQlpGAw: folds 
v+QfkGiuj9bgtuNoVnDO8w: folds 
9StOHp+Y1T0K13JdgS2oQQ: folds 
Uncalled bet ($0.15) returned to OZc6kkoTwtITj1ZfreJK1A
OZc6kkoTwtITj1ZfreJK1A collected $0.20 from pot
OZc6kkoTwtITj1ZfreJK1A: doesn't show hand 
*** SUMMARY ***
Total pot $0.20 | Rake $0 
Seat 1: OZc6kkoTwtITj1ZfreJK1A (big blind) collected ($0.20)
Seat 2: LtASJ9OlkqGrrUKGQlpGAw folded before Flop (didn't bet)
Seat 4: v+QfkGiuj9bgtuNoVnDO8w (button) folded before Flop (didn't bet)
Seat 5: 9StOHp+Y1T0K13JdgS2oQQ (small blind) folded before Flop




PokerStars Game #59942001138:  Hold'em No Limit ($0.10/$0.25) - 2009/07/01 1:52:56 ET
Table '3Ns9nuTkynfwbBfBXzg6ww' 6-max Seat #1 is the button
Seat 1: epAUIB7h2FJXzUPRIvSkRA ($25 in chips) 
Seat 2: zxeVQGaMKDsDzmSY+AInjA ($31.50 in chips) 
Seat 3: eL3+wCBjFGfQ5FMdIZihwA ($23.60 in chips) 
Seat 4: qGHGf/553gQnDoklMRe3tg ($33.85 in chips) 
Seat 5: wqphQtauX5Qn7WRJZS1flA ($24.05 in chips) 
Seat 6: DE9hRlt14g+JdsRQ4wT7hg ($38 in chips) 
zxeVQGaMKDsDzmSY+AInjA: posts small blind $0.10
eL3+wCBjFGfQ5FMdIZihwA: posts big blind $0.25
*** HOLE CARDS ***
qGHGf/553gQnDoklMRe3tg: folds 
wqphQtauX5Qn7WRJZS1flA: folds 
DE9hRlt14g+JdsRQ4wT7hg: raises $0.75 to $1
epAUIB7h2FJXzUPRIvSkRA: folds 
zxeVQGaMKDsDzmSY+AInjA: folds 
eL3+wCBjFGfQ5FMdIZihwA: calls $0.75
*** FLOP *** [6h Qd 7d]
eL3+wCBjFGfQ5FMdIZihwA: checks 
DE9hRlt14g+JdsRQ4wT7hg: bets $1.50
eL3+wCBjFGfQ5FMdIZihwA: folds 
Uncalled bet ($1.50) returned to DE9hRlt14g+JdsRQ4wT7hg
DE9hRlt14g+JdsRQ4wT7hg collected $2 from pot
DE9hRlt14g+JdsRQ4wT7hg: doesn't show hand 
*** SUMMARY ***
Total pot $2.10 | Rake $0.10 
Board [6h Qd 7d]
Seat 1: epAUIB7h2FJXzUPRIvSkRA (button) folded before Flop (didn't bet)
Seat 2: zxeVQGaMKDsDzmSY+AInjA (small blind) folded before Flop
Seat 3: eL3+wCBjFGfQ5FMdIZihwA (big blind) folded on the Flop
Seat 4: qGHGf/553gQnDoklMRe3tg folded before Flop (didn't bet)
Seat 5: wqphQtauX5Qn7WRJZS1flA folded before Flop (didn't bet)
Seat 6: DE9hRlt14g+JdsRQ4wT7hg collected ($2)




PokerStars Game #59942001404:  Hold'em No Limit ($0.10/$0.25) - 2009/07/01 1:52:56 ET
Table 'Xi38lWH8L2JHRAsKYVX8Qg' 6-max Seat #2 is the button
Seat 1: shP7DFAtX7gXcgMJX/OmRQ ($25 in chips) 
Seat 2: VOmI0x4dDPnTESZd5B4d1Q ($7.90 in chips) 
Seat 3: 6DwBRH+xZ12AAZmeAg+aXw ($30.95 in chips) 
Seat 4: kG34n23qFQA3nzdOJTQ1dA ($25 in chips) 
Seat 5: 79ID/ub1Pt/mDpCprVmOoA ($76.15 in chips) 
Seat 6: kyRaCIljYA6l33lSKQfNsg ($30.10 in chips) 
6DwBRH+xZ12AAZmeAg+aXw: posts small blind $0.10
kG34n23qFQA3nzdOJTQ1dA: posts big blind $0.25
*** HOLE CARDS ***
79ID/ub1Pt/mDpCprVmOoA: raises $0.50 to $0.75
kyRaCIljYA6l33lSKQfNsg: folds 
shP7DFAtX7gXcgMJX/OmRQ: calls $0.75
VOmI0x4dDPnTESZd5B4d1Q: folds 
6DwBRH+xZ12AAZmeAg+aXw: folds 
kG34n23qFQA3nzdOJTQ1dA: folds 
*** FLOP *** [8d Th Qh]
79ID/ub1Pt/mDpCprVmOoA: bets $1.50
shP7DFAtX7gXcgMJX/OmRQ: calls $1.50
*** TURN *** [8d Th Qh] [7d]
79ID/ub1Pt/mDpCprVmOoA: checks 
shP7DFAtX7gXcgMJX/OmRQ: bets $1.50
79ID/ub1Pt/mDpCprVmOoA: folds 
Uncalled bet ($1.50) returned to shP7DFAtX7gXcgMJX/OmRQ
shP7DFAtX7gXcgMJX/OmRQ collected $4.65 from pot
shP7DFAtX7gXcgMJX/OmRQ: doesn't show hand 
*** SUMMARY ***
Total pot $4.85 | Rake $0.20 
Board [8d Th Qh 7d]
Seat 1: shP7DFAtX7gXcgMJX/OmRQ collected ($4.65)
Seat 2: VOmI0x4dDPnTESZd5B4d1Q (button) folded before Flop (didn't bet)
Seat 3: 6DwBRH+xZ12AAZmeAg+aXw (small blind) folded before Flop
Seat 4: kG34n23qFQA3nzdOJTQ1dA (big blind) folded before Flop
Seat 5: 79ID/ub1Pt/mDpCprVmOoA folded on the Turn
Seat 6: kyRaCIljYA6l33lSKQfNsg folded before Flop (didn't bet)




PokerStars Game #59942001456:  Hold'em No Limit ($0.10/$0.25) - 2009/07/01 1:52:57 ET
Table 'MiquQrQZJJq9ZtgRIp9HFQ' 6-max Seat #3 is the button
Seat 1: c3J/KYZ4cNsUEuz8v57I5A ($25.40 in chips) 
Seat 2: 2+6voGl1T1DO63JePptI3g ($24.85 in chips) 
Seat 3: 9h7TNZ1TDGRUJXA6rI+ZTw ($10 in chips) 
Seat 4: wAKC8C/zN0c8V5v13dm9mA ($51.40 in chips) 
Seat 5: iyZxqznXjv3vtvOJymkoLQ ($26.40 in chips) 
Seat 6: GbCVUNssQ7mqsPWr7J4d3w ($4.50 in chips) 
wAKC8C/zN0c8V5v13dm9mA: posts small blind $0.10
iyZxqznXjv3vtvOJymkoLQ: posts big blind $0.25
*** HOLE CARDS ***
GbCVUNssQ7mqsPWr7J4d3w: folds 
c3J/KYZ4cNsUEuz8v57I5A: folds 
2+6voGl1T1DO63JePptI3g: folds 
9h7TNZ1TDGRUJXA6rI+ZTw: folds 
wAKC8C/zN0c8V5v13dm9mA: folds 
Uncalled bet ($0.15) returned to iyZxqznXjv3vtvOJymkoLQ
iyZxqznXjv3vtvOJymkoLQ collected $0.20 from pot
iyZxqznXjv3vtvOJymkoLQ: doesn't show hand 
*** SUMMARY ***
Total pot $0.20 | Rake $0 
Seat 1: c3J/KYZ4cNsUEuz8v57I5A folded before Flop (didn't bet)
Seat 2: 2+6voGl1T1DO63JePptI3g folded before Flop (didn't bet)
Seat 3: 9h7TNZ1TDGRUJXA6rI+ZTw (button) folded before Flop (didn't bet)
Seat 4: wAKC8C/zN0c8V5v13dm9mA (small blind) folded before Flop
Seat 5: iyZxqznXjv3vtvOJymkoLQ (big blind) collected ($0.20)
Seat 6: GbCVUNssQ7mqsPWr7J4d3w folded before Flop (didn't bet)




PokerStars Game #59942001920:  Hold'em No Limit ($0.10/$0.25) - 2009/07/01 1:52:57 ET
Table 'TJS4XvvOjO3k7mH74HJw5g' 9-max Seat #6 is the button
Seat 1: K8I2mpRME07ZlOsT2x75Lg ($6.45 in chips) 
Seat 2: yqkowiRWZ6NvRN9UUkYIlA ($8.60 in chips) 
Seat 3: 8EbrQ/EvFWt2cr0GaU82gQ ($5 in chips) 
Seat 4: clJsV3v77RS07bDKY+705w ($5 in chips) 
Seat 5: UlMB386Cfzy3EwurQoBjcA ($7.35 in chips) 
Seat 6: 3PmVnC/15cl4oyI1TKIt4g ($4.65 in chips) 
Seat 7: B9u+i1s5aZZkmLTLUopTBg ($17.65 in chips) 
Seat 9: +sbyWwIcFp9kP0bDtMegfQ ($44.45 in chips) 
B9u+i1s5aZZkmLTLUopTBg: posts small blind $0.10
+sbyWwIcFp9kP0bDtMegfQ: posts big blind $0.25
*** HOLE CARDS ***
K8I2mpRME07ZlOsT2x75Lg: raises $0.25 to $0.50
yqkowiRWZ6NvRN9UUkYIlA: folds 
8EbrQ/EvFWt2cr0GaU82gQ: folds 
clJsV3v77RS07bDKY+705w: folds 
Savonys joins the table at seat #8 
UlMB386Cfzy3EwurQoBjcA: folds 
3PmVnC/15cl4oyI1TKIt4g: folds 
B9u+i1s5aZZkmLTLUopTBg: folds 
+sbyWwIcFp9kP0bDtMegfQ: folds 
Uncalled bet ($0.25) returned to K8I2mpRME07ZlOsT2x75Lg
K8I2mpRME07ZlOsT2x75Lg collected $0.60 from pot
*** SUMMARY ***
Total pot $0.60 | Rake $0 
Seat 1: K8I2mpRME07ZlOsT2x75Lg collected ($0.60)
Seat 2: yqkowiRWZ6NvRN9UUkYIlA folded before Flop (didn't bet)
Seat 3: 8EbrQ/EvFWt2cr0GaU82gQ folded before Flop (didn't bet)
Seat 4: clJsV3v77RS07bDKY+705w folded before Flop (didn't bet)
Seat 5: UlMB386Cfzy3EwurQoBjcA folded before Flop (didn't bet)
Seat 6: 3PmVnC/15cl4oyI1TKIt4g (button) folded before Flop (didn't bet)
Seat 7: B9u+i1s5aZZkmLTLUopTBg (small blind) folded before Flop
Seat 9: +sbyWwIcFp9kP0bDtMegfQ (big blind) folded before Flop




PokerStars Game #59942001708:  Hold'em No Limit ($0.10/$0.25) - 2009/07/01 1:52:57 ET
Table 'WEMI3Mtn7dGARDbgNrKibg' 9-max Seat #4 is the button
Seat 1: Th3FldXKQW6hWVVPahaoOQ ($30.35 in chips) 
Seat 3: qwr38jl5txoR36M7G5qi4A ($10 in chips) 
Seat 4: Z5NNIVvnhb2IJbLcI79WYQ ($9.90 in chips) 
Seat 5: yzPZQFeaQTNf1YK3a0zRIw ($10.25 in chips) 
Seat 6: arxNSjreDRGFg13EAM2F1w ($25 in chips) 
Seat 7: DnDcAdn9P0zGovMERigpFA ($54.90 in chips) 
Seat 8: ghNKXUBl/H+t83JF079ZBA ($29.25 in chips) 
Seat 9: 2wcFsZsqEP5w1StUTVzJCg ($4.25 in chips) 
yzPZQFeaQTNf1YK3a0zRIw: posts small blind $0.10
arxNSjreDRGFg13EAM2F1w: posts big blind $0.25
*** HOLE CARDS ***
DnDcAdn9P0zGovMERigpFA: folds 
ghNKXUBl/H+t83JF079ZBA: folds 
2wcFsZsqEP5w1StUTVzJCg: folds 
Th3FldXKQW6hWVVPahaoOQ: folds 
qwr38jl5txoR36M7G5qi4A: folds 
Z5NNIVvnhb2IJbLcI79WYQ: calls $0.25
yzPZQFeaQTNf1YK3a0zRIw: folds 
arxNSjreDRGFg13EAM2F1w: raises $0.75 to $1
Z5NNIVvnhb2IJbLcI79WYQ: folds 
Uncalled bet ($0.75) returned to arxNSjreDRGFg13EAM2F1w
arxNSjreDRGFg13EAM2F1w collected $0.60 from pot
arxNSjreDRGFg13EAM2F1w: doesn't show hand 
*** SUMMARY ***
Total pot $0.60 | Rake $0 
Seat 1: Th3FldXKQW6hWVVPahaoOQ folded before Flop (didn't bet)
Seat 3: qwr38jl5txoR36M7G5qi4A folded before Flop (didn't bet)
Seat 4: Z5NNIVvnhb2IJbLcI79WYQ (button) folded before Flop
Seat 5: yzPZQFeaQTNf1YK3a0zRIw (small blind) folded before Flop
Seat 6: arxNSjreDRGFg13EAM2F1w (big blind) collected ($0.60)
Seat 7: DnDcAdn9P0zGovMERigpFA folded before Flop (didn't bet)
Seat 8: ghNKXUBl/H+t83JF079ZBA folded before Flop (didn't bet)
Seat 9: 2wcFsZsqEP5w1StUTVzJCg folded before Flop (didn't bet)




PokerStars Game #59942001928:  Hold'em No Limit ($0.10/$0.25) - 2009/07/01 1:52:57 ET
Table 'sSe6q4YTb/iS19t2eCFdsA' 9-max Seat #5 is the button
Seat 1: hJ4uYjNmSZdjrKA8cjZqCA ($15.65 in chips) 
Seat 2: 3l+i+xMeyDndSXMF2A5CDA ($5.75 in chips) 
Seat 3: OXPkK84/qv92EMwXPiG5rQ ($10 in chips) 
Seat 4: 22dIObOuor/A+IKWkNoAlA ($8.75 in chips) 
Seat 5: qS+jfnNoG75bT+uQ8CKhQA ($9.95 in chips) 
Seat 7: t70KGeRtR3naHSqKDixsUg ($6.85 in chips) 
Seat 8: hvXZ0zFPZFP8Hf6dS36YEw ($16 in chips) 
Seat 9: Z9W7+g1WMhhZDi7DwGbCFA ($5.25 in chips) 
t70KGeRtR3naHSqKDixsUg: posts small blind $0.10
hvXZ0zFPZFP8Hf6dS36YEw: posts big blind $0.25
*** HOLE CARDS ***
Z9W7+g1WMhhZDi7DwGbCFA: folds 
hJ4uYjNmSZdjrKA8cjZqCA: folds 
3l+i+xMeyDndSXMF2A5CDA: folds 
OXPkK84/qv92EMwXPiG5rQ: folds 
22dIObOuor/A+IKWkNoAlA: folds 
qS+jfnNoG75bT+uQ8CKhQA: folds 
t70KGeRtR3naHSqKDixsUg: calls $0.15
hvXZ0zFPZFP8Hf6dS36YEw: checks 
*** FLOP *** [7h 3s Ac]
t70KGeRtR3naHSqKDixsUg: checks 
hvXZ0zFPZFP8Hf6dS36YEw: bets $0.25
t70KGeRtR3naHSqKDixsUg: calls $0.25
*** TURN *** [7h 3s Ac] [Tc]
t70KGeRtR3naHSqKDixsUg: checks 
hvXZ0zFPZFP8Hf6dS36YEw: bets $0.50
t70KGeRtR3naHSqKDixsUg: calls $0.50
*** RIVER *** [7h 3s Ac Tc] [9c]
t70KGeRtR3naHSqKDixsUg: bets $0.75
hvXZ0zFPZFP8Hf6dS36YEw: calls $0.75
*** SHOW DOWN ***
t70KGeRtR3naHSqKDixsUg: shows [Th Ad] (two pair, Aces and Tens)
hvXZ0zFPZFP8Hf6dS36YEw: mucks hand 
t70KGeRtR3naHSqKDixsUg collected $3.35 from pot
*** SUMMARY ***
Total pot $3.50 | Rake $0.15 
Board [7h 3s Ac Tc 9c]
Seat 1: hJ4uYjNmSZdjrKA8cjZqCA folded before Flop (didn't bet)
Seat 2: 3l+i+xMeyDndSXMF2A5CDA folded before Flop (didn't bet)
Seat 3: OXPkK84/qv92EMwXPiG5rQ folded before Flop (didn't bet)
Seat 4: 22dIObOuor/A+IKWkNoAlA folded before Flop (didn't bet)
Seat 5: qS+jfnNoG75bT+uQ8CKhQA (button) folded before Flop (didn't bet)
Seat 7: t70KGeRtR3naHSqKDixsUg (small blind) showed [Th Ad] and won ($3.35) with two pair, Aces and Tens
Seat 8: hvXZ0zFPZFP8Hf6dS36YEw (big blind) mucked
Seat 9: Z9W7+g1WMhhZDi7DwGbCFA folded before Flop (didn't bet)




PokerStars Game #59942001812:  Hold'em No Limit ($0.10/$0.25) - 2009/07/01 1:52:57 ET
Table 'jdhJTJjFq2KTttwJcd+7nQ' 6-max Seat #5 is the button
Seat 1: LtASJ9OlkqGrrUKGQlpGAw ($26.15 in chips) 
Seat 3: vqWjZmdQu/Hxw96/IJTWdQ ($30.20 in chips) 
Seat 4: vx7FwRcelVSsvNYAdp/z0A ($5.20 in chips) 
Seat 5: BV+K0Phf5VBHr7aZPKqbUQ ($30.95 in chips) 
Seat 6: yb6rnd48JuBccThV68VHAQ ($15.85 in chips) 
yb6rnd48JuBccThV68VHAQ: posts small blind $0.10
LtASJ9OlkqGrrUKGQlpGAw: posts big blind $0.25
*** HOLE CARDS ***
vqWjZmdQu/Hxw96/IJTWdQ: folds 
vx7FwRcelVSsvNYAdp/z0A: folds 
BV+K0Phf5VBHr7aZPKqbUQ: raises $0.50 to $0.75
yb6rnd48JuBccThV68VHAQ: calls $0.65
LtASJ9OlkqGrrUKGQlpGAw: folds 
*** FLOP *** [2c 2d Qs]
yb6rnd48JuBccThV68VHAQ: bets $1.75
BV+K0Phf5VBHr7aZPKqbUQ: folds 
Uncalled bet ($1.75) returned to yb6rnd48JuBccThV68VHAQ
yb6rnd48JuBccThV68VHAQ collected $1.70 from pot
yb6rnd48JuBccThV68VHAQ: doesn't show hand 
*** SUMMARY ***
Total pot $1.75 | Rake $0.05 
Board [2c 2d Qs]
Seat 1: LtASJ9OlkqGrrUKGQlpGAw (big blind) folded before Flop
Seat 3: vqWjZmdQu/Hxw96/IJTWdQ folded before Flop (didn't bet)
Seat 4: vx7FwRcelVSsvNYAdp/z0A folded before Flop (didn't bet)
Seat 5: BV+K0Phf5VBHr7aZPKqbUQ (button) folded on the Flop
Seat 6: yb6rnd48JuBccThV68VHAQ (small blind) collected ($1.70)




PokerStars Game #59942002226:  Hold'em No Limit ($0.10/$0.25) - 2009/07/01 1:52:58 ET
Table 'QegsWX65l3n/K0A8XB78yg' 6-max Seat #6 is the button
Seat 1: p6adJRMXMBLr+xtQzqazIQ ($12 in chips) 
Seat 2: GC/9yVD59DUCX7hUI7gcLw ($55.85 in chips) 
Seat 4: epAUIB7h2FJXzUPRIvSkRA ($30.75 in chips) 
Seat 5: QqiZLFrN8iOUT/GHw7ztOA ($26.35 in chips) 
Seat 6: 5PWs02z65jSO5pr/M6wx/w ($13.70 in chips) 
p6adJRMXMBLr+xtQzqazIQ: posts small blind $0.10
GC/9yVD59DUCX7hUI7gcLw: posts big blind $0.25
*** HOLE CARDS ***
epAUIB7h2FJXzUPRIvSkRA: folds 
QqiZLFrN8iOUT/GHw7ztOA: folds 
5PWs02z65jSO5pr/M6wx/w: calls $0.25
p6adJRMXMBLr+xtQzqazIQ: folds 
GC/9yVD59DUCX7hUI7gcLw: checks 
*** FLOP *** [2s 6c 5h]
GC/9yVD59DUCX7hUI7gcLw: bets $0.50
5PWs02z65jSO5pr/M6wx/w: folds 
Uncalled bet ($0.50) returned to GC/9yVD59DUCX7hUI7gcLw
GC/9yVD59DUCX7hUI7gcLw collected $0.60 from pot
*** SUMMARY ***
Total pot $0.60 | Rake $0 
Board [2s 6c 5h]
Seat 1: p6adJRMXMBLr+xtQzqazIQ (small blind) folded before Flop
Seat 2: GC/9yVD59DUCX7hUI7gcLw (big blind) collected ($0.60)
Seat 4: epAUIB7h2FJXzUPRIvSkRA folded before Flop (didn't bet)
Seat 5: QqiZLFrN8iOUT/GHw7ztOA folded before Flop (didn't bet)
Seat 6: 5PWs02z65jSO5pr/M6wx/w (button) folded on the Flop




PokerStars Game #59942002362:  Hold'em No Limit ($0.10/$0.25) - 2009/07/01 1:52:58 ET
Table '+198VWQSWBhYQOcizzuBkw' 6-max Seat #6 is the button
Seat 1: 34ttqW62uIRrqINCCmLcsw ($3.85 in chips) 
Seat 2: iauW7L/+7qzAuHow7CD75Q ($12.30 in chips) 
Seat 3: vw7gefupgmOJJN8lUemdWg ($16.25 in chips) 
Seat 4: TgDsTeCdLQt8kWbL00ByRA ($33.20 in chips) 
Seat 5: LtASJ9OlkqGrrUKGQlpGAw ($24.65 in chips) 
Seat 6: leEQ84f6wJYu5SB/vj27wg ($14.65 in chips) 
34ttqW62uIRrqINCCmLcsw: posts small blind $0.10
iauW7L/+7qzAuHow7CD75Q: posts big blind $0.25
*** HOLE CARDS ***
vw7gefupgmOJJN8lUemdWg: folds 
TgDsTeCdLQt8kWbL00ByRA: calls $0.25
vw7gefupgmOJJN8lUemdWg said, "10 10"
LtASJ9OlkqGrrUKGQlpGAw: folds 
leEQ84f6wJYu5SB/vj27wg: folds 
34ttqW62uIRrqINCCmLcsw: calls $0.15
iauW7L/+7qzAuHow7CD75Q: checks 
*** FLOP *** [9h 2c Ac]
34ttqW62uIRrqINCCmLcsw: checks 
iauW7L/+7qzAuHow7CD75Q: checks 
TgDsTeCdLQt8kWbL00ByRA: checks 
*** TURN *** [9h 2c Ac] [Qh]
34ttqW62uIRrqINCCmLcsw: checks 
iauW7L/+7qzAuHow7CD75Q: checks 
TgDsTeCdLQt8kWbL00ByRA: checks 
*** RIVER *** [9h 2c Ac Qh] [Ah]
vw7gefupgmOJJN8lUemdWg said, "they come in pairs"
34ttqW62uIRrqINCCmLcsw: checks 
iauW7L/+7qzAuHow7CD75Q: bets $0.25
TgDsTeCdLQt8kWbL00ByRA: calls $0.25
34ttqW62uIRrqINCCmLcsw: folds 
*** SHOW DOWN ***
iauW7L/+7qzAuHow7CD75Q: shows [2d Td] (two pair, Aces and Deuces)
TgDsTeCdLQt8kWbL00ByRA: shows [Qd 8d] (two pair, Aces and Queens)
TgDsTeCdLQt8kWbL00ByRA collected $1.20 from pot
*** SUMMARY ***
Total pot $1.25 | Rake $0.05 
Board [9h 2c Ac Qh Ah]
Seat 1: 34ttqW62uIRrqINCCmLcsw (small blind) folded on the River
Seat 2: iauW7L/+7qzAuHow7CD75Q (big blind) showed [2d Td] and lost with two pair, Aces and Deuces
Seat 3: vw7gefupgmOJJN8lUemdWg folded before Flop (didn't bet)
Seat 4: TgDsTeCdLQt8kWbL00ByRA showed [Qd 8d] and won ($1.20) with two pair, Aces and Queens
Seat 5: LtASJ9OlkqGrrUKGQlpGAw folded before Flop (didn't bet)
Seat 6: leEQ84f6wJYu5SB/vj27wg (button) folded before Flop (didn't bet)




PokerStars Game #59942002210:  Hold'em No Limit ($0.10/$0.25) - 2009/07/01 1:52:58 ET
Table 'edvgY2YQ1I34euq4EVqGnA' 6-max Seat #4 is the button
Seat 1: mvFHK3pE7tCxJEqLjKC70Q ($30.70 in chips) 
Seat 2: FRpCzMJnbXYfQIPzAs4Faw ($21.55 in chips) 
Seat 3: muaYRdOUlJzdJ0zHxvRGlQ ($20.65 in chips) 
Seat 4: TI/C5Q+DEl4fLR3AofwYdg ($16.35 in chips) 
Seat 5: EE16Ua5b1HSsYej5zeXOlA ($57 in chips) 
Seat 6: kG34n23qFQA3nzdOJTQ1dA ($70.40 in chips) 
EE16Ua5b1HSsYej5zeXOlA: posts small blind $0.10
kG34n23qFQA3nzdOJTQ1dA: posts big blind $0.25
FRpCzMJnbXYfQIPzAs4Faw: posts big blind $0.25
*** HOLE CARDS ***
mvFHK3pE7tCxJEqLjKC70Q: folds 
FRpCzMJnbXYfQIPzAs4Faw: checks 
muaYRdOUlJzdJ0zHxvRGlQ: folds 
TI/C5Q+DEl4fLR3AofwYdg: calls $0.25
EE16Ua5b1HSsYej5zeXOlA: calls $0.15
kG34n23qFQA3nzdOJTQ1dA: checks 
*** FLOP *** [4c Jh Kc]
EE16Ua5b1HSsYej5zeXOlA: checks 
kG34n23qFQA3nzdOJTQ1dA: checks 
FRpCzMJnbXYfQIPzAs4Faw: checks 
TI/C5Q+DEl4fLR3AofwYdg: bets $0.25
EE16Ua5b1HSsYej5zeXOlA: folds 
kG34n23qFQA3nzdOJTQ1dA: folds 
FRpCzMJnbXYfQIPzAs4Faw: folds 
Uncalled bet ($0.25) returned to TI/C5Q+DEl4fLR3AofwYdg
TI/C5Q+DEl4fLR3AofwYdg collected $0.95 from pot
TI/C5Q+DEl4fLR3AofwYdg: doesn't show hand 
*** SUMMARY ***
Total pot $1 | Rake $0.05 
Board [4c Jh Kc]
Seat 1: mvFHK3pE7tCxJEqLjKC70Q folded before Flop (didn't bet)
Seat 2: FRpCzMJnbXYfQIPzAs4Faw folded on the Flop
Seat 3: muaYRdOUlJzdJ0zHxvRGlQ folded before Flop (didn't bet)
Seat 4: TI/C5Q+DEl4fLR3AofwYdg (button) collected ($0.95)
Seat 5: EE16Ua5b1HSsYej5zeXOlA (small blind) folded on the Flop
Seat 6: kG34n23qFQA3nzdOJTQ1dA (big blind) folded on the Flop




PokerStars Game #59942002236:  Hold'em No Limit ($0.10/$0.25) - 2009/07/01 1:52:58 ET
Table 'nIRjSqm6RYUWJlyW2loYKA' 6-max Seat #1 is the button
Seat 1: w43JQj2oYPpKQVG4Yzlq1w ($25 in chips) 
Seat 2: NndRCAk4vU5JGDhTyy5LZg ($11.70 in chips) 
Seat 3: qjs7u/BI35gu5OgtqfLCZw ($16.20 in chips) 
Seat 4: /ZSSWvl8im2y38j1uEUAGA ($8.10 in chips) 
Seat 5: df01R5ThvHspD8FgKmaDvQ ($22.90 in chips) 
Seat 6: OIjOiBfQstWrK/RuXx7zcw ($6.70 in chips) 
NndRCAk4vU5JGDhTyy5LZg: posts small blind $0.10
qjs7u/BI35gu5OgtqfLCZw: posts big blind $0.25
*** HOLE CARDS ***
/ZSSWvl8im2y38j1uEUAGA: calls $0.25
df01R5ThvHspD8FgKmaDvQ: folds 
OIjOiBfQstWrK/RuXx7zcw: folds 
w43JQj2oYPpKQVG4Yzlq1w: folds 
NndRCAk4vU5JGDhTyy5LZg: folds 
qjs7u/BI35gu5OgtqfLCZw: checks 
*** FLOP *** [8d 8c 9h]
qjs7u/BI35gu5OgtqfLCZw: bets $0.50
/ZSSWvl8im2y38j1uEUAGA: calls $0.50
*** TURN *** [8d 8c 9h] [3s]
qjs7u/BI35gu5OgtqfLCZw: checks 
/ZSSWvl8im2y38j1uEUAGA: checks 
*** RIVER *** [8d 8c 9h 3s] [4c]
qjs7u/BI35gu5OgtqfLCZw: bets $1
/ZSSWvl8im2y38j1uEUAGA: folds 
Uncalled bet ($1) returned to qjs7u/BI35gu5OgtqfLCZw
qjs7u/BI35gu5OgtqfLCZw collected $1.55 from pot
qjs7u/BI35gu5OgtqfLCZw: doesn't show hand 
*** SUMMARY ***
Total pot $1.60 | Rake $0.05 
Board [8d 8c 9h 3s 4c]
Seat 1: w43JQj2oYPpKQVG4Yzlq1w (button) folded before Flop (didn't bet)
Seat 2: NndRCAk4vU5JGDhTyy5LZg (small blind) folded before Flop
Seat 3: qjs7u/BI35gu5OgtqfLCZw (big blind) collected ($1.55)
Seat 4: /ZSSWvl8im2y38j1uEUAGA folded on the River
Seat 5: df01R5ThvHspD8FgKmaDvQ folded before Flop (didn't bet)
Seat 6: OIjOiBfQstWrK/RuXx7zcw folded before Flop (didn't bet)




PokerStars Game #59942002036:  Hold'em No Limit ($0.10/$0.25) - 2009/07/01 1:52:58 ET
Table 'aT31tt16YvQM/Ue69HPLpA' 9-max Seat #4 is the button
Seat 1: wxmepRUXfX1jdQfUD5uENQ ($4.40 in chips) 
Seat 2: 8CoKLhwk8Ja6X+O9fxTEDg ($6.05 in chips) 
Seat 3: swK30YlQuxRQO7QFr4ZxCA ($24.25 in chips) 
Seat 4: wGigCmBR/9XWkPpvYos3aQ ($26.50 in chips) 
Seat 5: s2xLPOl/vhl/26apJ3vsOQ ($33.65 in chips) 
Seat 6: ghG12/paEL5VoDN85sW6RA ($15.35 in chips) 
Seat 9: TvIuLx9zUCE+9Li58iImOQ ($13.60 in chips) 
s2xLPOl/vhl/26apJ3vsOQ: posts small blind $0.10
ghG12/paEL5VoDN85sW6RA: posts big blind $0.25
JoKeR_1216: sits out 
*** HOLE CARDS ***
TvIuLx9zUCE+9Li58iImOQ: folds 
wxmepRUXfX1jdQfUD5uENQ: folds 
8CoKLhwk8Ja6X+O9fxTEDg: folds 
swK30YlQuxRQO7QFr4ZxCA: calls $0.25
wGigCmBR/9XWkPpvYos3aQ: raises $1 to $1.25
s2xLPOl/vhl/26apJ3vsOQ: folds 
ghG12/paEL5VoDN85sW6RA: calls $1
vSkQm2EelzwRGDDQQk0Fqw joins the table at seat #8 
swK30YlQuxRQO7QFr4ZxCA: calls $1
*** FLOP *** [Tc 6s 6h]
ghG12/paEL5VoDN85sW6RA: checks 
swK30YlQuxRQO7QFr4ZxCA: checks 
wGigCmBR/9XWkPpvYos3aQ: bets $3
ghG12/paEL5VoDN85sW6RA: calls $3
swK30YlQuxRQO7QFr4ZxCA: folds 
*** TURN *** [Tc 6s 6h] [9h]
ghG12/paEL5VoDN85sW6RA: checks 
wGigCmBR/9XWkPpvYos3aQ: checks 
*** RIVER *** [Tc 6s 6h 9h] [Td]
ghG12/paEL5VoDN85sW6RA: bets $4.50
wGigCmBR/9XWkPpvYos3aQ: folds 
Uncalled bet ($4.50) returned to ghG12/paEL5VoDN85sW6RA
ghG12/paEL5VoDN85sW6RA collected $9.40 from pot
*** SUMMARY ***
Total pot $9.85 | Rake $0.45 
Board [Tc 6s 6h 9h Td]
Seat 1: wxmepRUXfX1jdQfUD5uENQ folded before Flop (didn't bet)
Seat 2: 8CoKLhwk8Ja6X+O9fxTEDg folded before Flop (didn't bet)
Seat 3: swK30YlQuxRQO7QFr4ZxCA folded on the Flop
Seat 4: wGigCmBR/9XWkPpvYos3aQ (button) folded on the River
Seat 5: s2xLPOl/vhl/26apJ3vsOQ (small blind) folded before Flop
Seat 6: ghG12/paEL5VoDN85sW6RA (big blind) collected ($9.40)
Seat 9: TvIuLx9zUCE+9Li58iImOQ folded before Flop (didn't bet)




PokerStars Game #59942002692:  Hold'em No Limit ($0.10/$0.25) - 2009/07/01 1:52:59 ET
Table '4hfTdIVT/qPsJNfWXLsVIw' 9-max Seat #8 is the button
Seat 3: xnVwSkROfRtOw4eSoDANtw ($2.10 in chips) 
Seat 4: 3PmVnC/15cl4oyI1TKIt4g ($6.55 in chips) 
Seat 5: dtZ84flFEi4Q+SGrHMJRDQ ($26.60 in chips) 
Seat 6: VWUWpMLMj/Q1jRVpF7Aohw ($11.80 in chips) 
Seat 7: d7YasxuGLPiL7pj8IcGThw ($7.10 in chips) 
Seat 8: 18G4P1XstjNvItdGUITxgw ($28.90 in chips) 
Seat 9: 9njEKzpOKC62MllUFUBWrA ($21 in chips) 
9njEKzpOKC62MllUFUBWrA: posts small blind $0.10
Pt637jKksB5MzP0UNJAAkw: is sitting out 
xnVwSkROfRtOw4eSoDANtw: posts big blind $0.25
*** HOLE CARDS ***
Pt637jKksB5MzP0UNJAAkw leaves the table
3PmVnC/15cl4oyI1TKIt4g: folds 
MilPopov joins the table at seat #2 
dtZ84flFEi4Q+SGrHMJRDQ: folds 
VWUWpMLMj/Q1jRVpF7Aohw: folds 
d7YasxuGLPiL7pj8IcGThw: folds 
18G4P1XstjNvItdGUITxgw: folds 
9njEKzpOKC62MllUFUBWrA: calls $0.15
xnVwSkROfRtOw4eSoDANtw: checks 
*** FLOP *** [9d 5c 7d]
9njEKzpOKC62MllUFUBWrA: checks 
xnVwSkROfRtOw4eSoDANtw: bets $0.25
9njEKzpOKC62MllUFUBWrA: folds 
Uncalled bet ($0.25) returned to xnVwSkROfRtOw4eSoDANtw
xnVwSkROfRtOw4eSoDANtw collected $0.50 from pot
*** SUMMARY ***
Total pot $0.50 | Rake $0 
Board [9d 5c 7d]
Seat 3: xnVwSkROfRtOw4eSoDANtw (big blind) collected ($0.50)
Seat 4: 3PmVnC/15cl4oyI1TKIt4g folded before Flop (didn't bet)
Seat 5: dtZ84flFEi4Q+SGrHMJRDQ folded before Flop (didn't bet)
Seat 6: VWUWpMLMj/Q1jRVpF7Aohw folded before Flop (didn't bet)
Seat 7: d7YasxuGLPiL7pj8IcGThw folded before Flop (didn't bet)
Seat 8: 18G4P1XstjNvItdGUITxgw (button) folded before Flop (didn't bet)
Seat 9: 9njEKzpOKC62MllUFUBWrA (small blind) folded on the Flop




PokerStars Game #59942002660:  Hold'em No Limit ($0.10/$0.25) - 2009/07/01 1:52:59 ET
Table 'FE/j6VqBY4j9Uq+VHURQCQ' 6-max Seat #5 is the button
Seat 1: ypmjhffk/YHGc51wgVXUTw ($35.55 in chips) 
Seat 2: 3zD3qLXT1bEffAoWGnc7wg ($37.30 in chips) 
Seat 3: lBoEwOFgzcERLIRUkUoRTw ($28.20 in chips) 
Seat 4: 7JyPCA0J2grhXQYxe1h3+A ($6.75 in chips) 
Seat 5: bJFzs6QmEEnz4miMfSDtcg ($15.15 in chips) 
Seat 6: Q1uciOZPBR/WkAlqa6cL4A ($29.55 in chips) 
Q1uciOZPBR/WkAlqa6cL4A: posts small blind $0.10
ypmjhffk/YHGc51wgVXUTw: posts big blind $0.25
*** HOLE CARDS ***
3zD3qLXT1bEffAoWGnc7wg: raises $0.75 to $1
lBoEwOFgzcERLIRUkUoRTw: folds 
7JyPCA0J2grhXQYxe1h3+A: calls $1
bJFzs6QmEEnz4miMfSDtcg: calls $1
Q1uciOZPBR/WkAlqa6cL4A: folds 
ypmjhffk/YHGc51wgVXUTw: folds 
*** FLOP *** [6s 9h 5d]
ypmjhffk/YHGc51wgVXUTw leaves the table
3zD3qLXT1bEffAoWGnc7wg: checks 
7JyPCA0J2grhXQYxe1h3+A: checks 
bJFzs6QmEEnz4miMfSDtcg: checks 
*** TURN *** [6s 9h 5d] [7h]
3zD3qLXT1bEffAoWGnc7wg: checks 
7JyPCA0J2grhXQYxe1h3+A: checks 
bJFzs6QmEEnz4miMfSDtcg: checks 
*** RIVER *** [6s 9h 5d 7h] [6d]
3zD3qLXT1bEffAoWGnc7wg: checks 
7JyPCA0J2grhXQYxe1h3+A: checks 
bJFzs6QmEEnz4miMfSDtcg: checks 
*** SHOW DOWN ***
3zD3qLXT1bEffAoWGnc7wg: shows [Ah Ks] (a pair of Sixes)
7JyPCA0J2grhXQYxe1h3+A: shows [3s 3c] (two pair, Sixes and Threes)
bJFzs6QmEEnz4miMfSDtcg: mucks hand 
7JyPCA0J2grhXQYxe1h3+A collected $3.20 from pot
*** SUMMARY ***
Total pot $3.35 | Rake $0.15 
Board [6s 9h 5d 7h 6d]
Seat 1: ypmjhffk/YHGc51wgVXUTw (big blind) folded before Flop
Seat 2: 3zD3qLXT1bEffAoWGnc7wg showed [Ah Ks] and lost with a pair of Sixes
Seat 3: lBoEwOFgzcERLIRUkUoRTw folded before Flop (didn't bet)
Seat 4: 7JyPCA0J2grhXQYxe1h3+A showed [3s 3c] and won ($3.20) with two pair, Sixes and Threes
Seat 5: bJFzs6QmEEnz4miMfSDtcg (button) mucked
Seat 6: Q1uciOZPBR/WkAlqa6cL4A (small blind) folded before Flop




PokerStars Game #59942002978:  Hold'em No Limit ($0.10/$0.25) - 2009/07/01 1:52:59 ET
Table '/Xx5AsbRD4oNGMTFFC/92Q' 6-max Seat #2 is the button
Seat 1: gVYXlD41OO0ybr835GAnsQ ($5.85 in chips) 
Seat 2: N/zeVku/lNn+kUQejwmLpg ($10.95 in chips) 
Seat 4: 7/ROHX4tuLekJ2diYIlMkw ($2.65 in chips) 
Seat 5: kMa8BltUcBQVxnHfqdCfXg ($4.75 in chips) 
7/ROHX4tuLekJ2diYIlMkw: posts small blind $0.10
kMa8BltUcBQVxnHfqdCfXg: posts big blind $0.25
gVYXlD41OO0ybr835GAnsQ: posts big blind $0.25
*** HOLE CARDS ***
gVYXlD41OO0ybr835GAnsQ: checks 
N/zeVku/lNn+kUQejwmLpg: raises $0.25 to $0.50
7/ROHX4tuLekJ2diYIlMkw: calls $0.40
kMa8BltUcBQVxnHfqdCfXg: calls $0.25
gVYXlD41OO0ybr835GAnsQ: calls $0.25
*** FLOP *** [Qc 9c Ac]
p4A+KsSkRO/5I6h0o4VQDQ has returned
7/ROHX4tuLekJ2diYIlMkw: checks 
kMa8BltUcBQVxnHfqdCfXg: checks 
gVYXlD41OO0ybr835GAnsQ: bets $1
N/zeVku/lNn+kUQejwmLpg: folds 
7/ROHX4tuLekJ2diYIlMkw: folds 
kMa8BltUcBQVxnHfqdCfXg: folds 
Uncalled bet ($1) returned to gVYXlD41OO0ybr835GAnsQ
gVYXlD41OO0ybr835GAnsQ collected $1.90 from pot
gVYXlD41OO0ybr835GAnsQ: doesn't show hand 
*** SUMMARY ***
Total pot $2 | Rake $0.10 
Board [Qc 9c Ac]
Seat 1: gVYXlD41OO0ybr835GAnsQ collected ($1.90)
Seat 2: N/zeVku/lNn+kUQejwmLpg (button) folded on the Flop
Seat 4: 7/ROHX4tuLekJ2diYIlMkw (small blind) folded on the Flop
Seat 5: kMa8BltUcBQVxnHfqdCfXg (big blind) folded on the Flop




PokerStars Game #59942003542:  Hold'em No Limit ($0.10/$0.25) - 2009/07/01 1:53:00 ET
Table 'ktio12Pyq06LsrFhIorSqA' 9-max Seat #2 is the button
Seat 2: tGsFgUKjSctVaAXabrlZxw ($6.85 in chips) 
Seat 3: Z9W7+g1WMhhZDi7DwGbCFA ($5 in chips) 
Seat 4: 0QdZrkFD7aGKeBXPGbIomA ($11.15 in chips) 
Seat 5: e0pV1oisCAilWiG0FCxY6A ($14.35 in chips) 
Seat 6: jQL6XIewylQ8MmZhhq2YFg ($39.40 in chips) 
Seat 7: XGCfQsxa6PfAg3kJtzUmww ($21.75 in chips) 
Seat 8: Z5y2J55JmfLYR6/DPAGHwQ ($9.85 in chips) 
Seat 9: H5Se03ZqSX7tbULXur2MAg ($25.55 in chips) 
Z9W7+g1WMhhZDi7DwGbCFA: posts small blind $0.10
0QdZrkFD7aGKeBXPGbIomA: posts big blind $0.25
*** HOLE CARDS ***
0QdZrkFD7aGKeBXPGbIomA said, "np"
e0pV1oisCAilWiG0FCxY6A: folds 
jQL6XIewylQ8MmZhhq2YFg: raises $1 to $1.25
XGCfQsxa6PfAg3kJtzUmww: folds 
Z5y2J55JmfLYR6/DPAGHwQ: folds 
H5Se03ZqSX7tbULXur2MAg: folds 
tGsFgUKjSctVaAXabrlZxw said, "i find that language offensive"
tGsFgUKjSctVaAXabrlZxw: calls $1.25
Z9W7+g1WMhhZDi7DwGbCFA: folds 
e0pV1oisCAilWiG0FCxY6A said, "then * * * * off outta here"
K0b5wNInj6hUGRr6yzKFtw joins the table at seat #1 
jQL6XIewylQ8MmZhhq2YFg said, "lmfao"
0QdZrkFD7aGKeBXPGbIomA: folds 
*** FLOP *** [9c 8h 6d]
jQL6XIewylQ8MmZhhq2YFg: bets $1.50
tGsFgUKjSctVaAXabrlZxw said, "dumb a ss yanks"
tGsFgUKjSctVaAXabrlZxw: raises $4.10 to $5.60 and is all-in
jQL6XIewylQ8MmZhhq2YFg: calls $4.10
*** TURN *** [9c 8h 6d] [5c]
*** RIVER *** [9c 8h 6d 5c] [Kd]
*** SHOW DOWN ***
jQL6XIewylQ8MmZhhq2YFg: shows [Qc Qh] (a pair of Queens)
tGsFgUKjSctVaAXabrlZxw: mucks hand 
jQL6XIewylQ8MmZhhq2YFg collected $13.40 from pot
*** SUMMARY ***
Total pot $14.05 | Rake $0.65 
Board [9c 8h 6d 5c Kd]
Seat 2: tGsFgUKjSctVaAXabrlZxw (button) mucked
Seat 3: Z9W7+g1WMhhZDi7DwGbCFA (small blind) folded before Flop
Seat 4: 0QdZrkFD7aGKeBXPGbIomA (big blind) folded before Flop
Seat 5: e0pV1oisCAilWiG0FCxY6A folded before Flop (didn't bet)
Seat 6: jQL6XIewylQ8MmZhhq2YFg showed [Qc Qh] and won ($13.40) with a pair of Queens
Seat 7: XGCfQsxa6PfAg3kJtzUmww folded before Flop (didn't bet)
Seat 8: Z5y2J55JmfLYR6/DPAGHwQ folded before Flop (didn't bet)
Seat 9: H5Se03ZqSX7tbULXur2MAg folded before Flop (didn't bet)




PokerStars Game #59942003314:  Hold'em No Limit ($0.10/$0.25) - 2009/07/01 1:53:00 ET
Table 'xPn6TS/y/OWkX7Qa+MUuKA' 6-max Seat #4 is the button
Seat 1: JFIAqU8lCZ0vWwEl4bdGsg ($37 in chips) 
Seat 3: q6WfTUAD9mowIP63ASq2Dg ($23.90 in chips) 
Seat 4: SS/yfeArhULzIcOPe8MdPg ($25 in chips) 
Seat 5: w3cELw9vjLM+p8ojn/uZvQ ($10.30 in chips) 
Seat 6: DihMHaz4WNETH1bPDe13kA ($25 in chips) 
w3cELw9vjLM+p8ojn/uZvQ: posts small blind $0.10
DihMHaz4WNETH1bPDe13kA: posts big blind $0.25
*** HOLE CARDS ***
JFIAqU8lCZ0vWwEl4bdGsg: folds 
q6WfTUAD9mowIP63ASq2Dg: folds 
SS/yfeArhULzIcOPe8MdPg: folds 
w3cELw9vjLM+p8ojn/uZvQ: calls $0.15
DihMHaz4WNETH1bPDe13kA: checks 
*** FLOP *** [As 6h 4h]
w3cELw9vjLM+p8ojn/uZvQ: checks 
DihMHaz4WNETH1bPDe13kA: checks 
*** TURN *** [As 6h 4h] [5s]
w3cELw9vjLM+p8ojn/uZvQ: checks 
DihMHaz4WNETH1bPDe13kA: checks 
*** RIVER *** [As 6h 4h 5s] [Qd]
w3cELw9vjLM+p8ojn/uZvQ: checks 
DihMHaz4WNETH1bPDe13kA: checks 
*** SHOW DOWN ***
w3cELw9vjLM+p8ojn/uZvQ: shows [Th 2h] (high card Ace)
DihMHaz4WNETH1bPDe13kA: shows [5c Js] (a pair of Fives)
DihMHaz4WNETH1bPDe13kA collected $0.50 from pot
*** SUMMARY ***
Total pot $0.50 | Rake $0 
Board [As 6h 4h 5s Qd]
Seat 1: JFIAqU8lCZ0vWwEl4bdGsg folded before Flop (didn't bet)
Seat 3: q6WfTUAD9mowIP63ASq2Dg folded before Flop (didn't bet)
Seat 4: SS/yfeArhULzIcOPe8MdPg (button) folded before Flop (didn't bet)
Seat 5: w3cELw9vjLM+p8ojn/uZvQ (small blind) showed [Th 2h] and lost with high card Ace
Seat 6: DihMHaz4WNETH1bPDe13kA (big blind) showed [5c Js] and won ($0.50) with a pair of Fives




PokerStars Game #59942003176:  Hold'em No Limit ($0.10/$0.25) - 2009/07/01 1:53:00 ET
Table '0M5QEJGOThqZwQ/sjbjXYw' 6-max Seat #3 is the button
Seat 2: /gJNBeCkWL4o85/jvlZ4BA ($32.85 in chips) 
Seat 3: 3zD3qLXT1bEffAoWGnc7wg ($28.95 in chips) 
Seat 4: PToTQrV0TmESDzjJftg6QQ ($25.10 in chips) 
Seat 5: cWc85bEzdRzpUMhRKm8pwQ ($53.05 in chips) 
Seat 6: bb63I02U6p9a5MNFa1gCiw ($18.55 in chips) 
PToTQrV0TmESDzjJftg6QQ: posts small blind $0.10
cWc85bEzdRzpUMhRKm8pwQ: posts big blind $0.25
*** HOLE CARDS ***
bb63I02U6p9a5MNFa1gCiw: folds 
/gJNBeCkWL4o85/jvlZ4BA: folds 
3zD3qLXT1bEffAoWGnc7wg: folds 
PToTQrV0TmESDzjJftg6QQ: calls $0.15
cWc85bEzdRzpUMhRKm8pwQ: checks 
*** FLOP *** [5h 3s Ah]
PToTQrV0TmESDzjJftg6QQ: checks 
cWc85bEzdRzpUMhRKm8pwQ: bets $0.50
PToTQrV0TmESDzjJftg6QQ: folds 
Uncalled bet ($0.50) returned to cWc85bEzdRzpUMhRKm8pwQ
cWc85bEzdRzpUMhRKm8pwQ collected $0.50 from pot
*** SUMMARY ***
Total pot $0.50 | Rake $0 
Board [5h 3s Ah]
Seat 2: /gJNBeCkWL4o85/jvlZ4BA folded before Flop (didn't bet)
Seat 3: 3zD3qLXT1bEffAoWGnc7wg (button) folded before Flop (didn't bet)
Seat 4: PToTQrV0TmESDzjJftg6QQ (small blind) folded on the Flop
Seat 5: cWc85bEzdRzpUMhRKm8pwQ (big blind) collected ($0.50)
Seat 6: bb63I02U6p9a5MNFa1gCiw folded before Flop (didn't bet)




PokerStars Game #59942003232:  Hold'em No Limit ($0.10/$0.25) - 2009/07/01 1:53:00 ET
Table 'wPWRBZPJl1HAnysw7qRR0A' 6-max Seat #2 is the button
Seat 1: m7ne1MOFTQXlsXT7/R/rug ($10.90 in chips) 
Seat 2: xC0kaiDYM6YTlgODL83O5A ($23 in chips) 
Seat 4: epAUIB7h2FJXzUPRIvSkRA ($50.10 in chips) 
Seat 5: y0B+UpYpOUJz3JWtlJQBSA ($15.05 in chips) 
Seat 6: VXTONriS+Ohik+r0FeicIw ($25.60 in chips) 
epAUIB7h2FJXzUPRIvSkRA: posts small blind $0.10
y0B+UpYpOUJz3JWtlJQBSA: posts big blind $0.25
*** HOLE CARDS ***
VXTONriS+Ohik+r0FeicIw: raises $0.75 to $1
m7ne1MOFTQXlsXT7/R/rug: folds 
xC0kaiDYM6YTlgODL83O5A: folds 
epAUIB7h2FJXzUPRIvSkRA: folds 
y0B+UpYpOUJz3JWtlJQBSA: folds 
Uncalled bet ($0.75) returned to VXTONriS+Ohik+r0FeicIw
VXTONriS+Ohik+r0FeicIw collected $0.60 from pot
VXTONriS+Ohik+r0FeicIw: doesn't show hand 
*** SUMMARY ***
Total pot $0.60 | Rake $0 
Seat 1: m7ne1MOFTQXlsXT7/R/rug folded before Flop (didn't bet)
Seat 2: xC0kaiDYM6YTlgODL83O5A (button) folded before Flop (didn't bet)
Seat 4: epAUIB7h2FJXzUPRIvSkRA (small blind) folded before Flop
Seat 5: y0B+UpYpOUJz3JWtlJQBSA (big blind) folded before Flop
Seat 6: VXTONriS+Ohik+r0FeicIw collected ($0.60)




PokerStars Game #59942003088:  Hold'em No Limit ($0.10/$0.25) - 2009/07/01 1:53:00 ET
Table 'Zi9/NqNs3XoL1eWhMCyZyg' 9-max Seat #8 is the button
Seat 1: X6+pSIPfovPcE87t+LmUKQ ($4.50 in chips) 
Seat 2: 1wKfgJ8xXIiuc8C6qjkxhg ($5.85 in chips) 
Seat 3: ETC7YyRJTa2Ovhln64Ni5Q ($27.80 in chips) 
Seat 4: dmYlc+1cjwZMJ7wV+Z0rRg ($24 in chips) 
Seat 5: HE9eSITnljG4AKvgOR4BMw ($14.75 in chips) 
Seat 6: YQhfmYhgnDDlWCAFmBb36Q ($17.50 in chips) 
Seat 7: 0QdZrkFD7aGKeBXPGbIomA ($1.60 in chips) 
Seat 8: nm4Dj/f+jJEwKVsUnKh73g ($34.30 in chips) 
Seat 9: 3l+i+xMeyDndSXMF2A5CDA ($5 in chips) 
3l+i+xMeyDndSXMF2A5CDA: posts small blind $0.10
X6+pSIPfovPcE87t+LmUKQ: posts big blind $0.25
*** HOLE CARDS ***
1wKfgJ8xXIiuc8C6qjkxhg: folds 
ETC7YyRJTa2Ovhln64Ni5Q: folds 
dmYlc+1cjwZMJ7wV+Z0rRg: folds 
HE9eSITnljG4AKvgOR4BMw: folds 
YQhfmYhgnDDlWCAFmBb36Q: folds 
0QdZrkFD7aGKeBXPGbIomA: raises $0.75 to $1
nm4Dj/f+jJEwKVsUnKh73g: folds 
3l+i+xMeyDndSXMF2A5CDA: folds 
X6+pSIPfovPcE87t+LmUKQ: folds 
Uncalled bet ($0.75) returned to 0QdZrkFD7aGKeBXPGbIomA
0QdZrkFD7aGKeBXPGbIomA collected $0.60 from pot
0QdZrkFD7aGKeBXPGbIomA: doesn't show hand 
*** SUMMARY ***
Total pot $0.60 | Rake $0 
Seat 1: X6+pSIPfovPcE87t+LmUKQ (big blind) folded before Flop
Seat 2: 1wKfgJ8xXIiuc8C6qjkxhg folded before Flop (didn't bet)
Seat 3: ETC7YyRJTa2Ovhln64Ni5Q folded before Flop (didn't bet)
Seat 4: dmYlc+1cjwZMJ7wV+Z0rRg folded before Flop (didn't bet)
Seat 5: HE9eSITnljG4AKvgOR4BMw folded before Flop (didn't bet)
Seat 6: YQhfmYhgnDDlWCAFmBb36Q folded before Flop (didn't bet)
Seat 7: 0QdZrkFD7aGKeBXPGbIomA collected ($0.60)
Seat 8: nm4Dj/f+jJEwKVsUnKh73g (button) folded before Flop (didn't bet)
Seat 9: 3l+i+xMeyDndSXMF2A5CDA (small blind) folded before Flop




PokerStars Game #59942003154:  Hold'em No Limit ($0.10/$0.25) - 2009/07/01 1:53:00 ET
Table 'YONIZZNvg4uZ4xNUO1deeA' 6-max Seat #4 is the button
Seat 1: GbCVUNssQ7mqsPWr7J4d3w ($4.30 in chips) 
Seat 2: evMMX/0gSDH791KdSAOaSg ($18.45 in chips) 
Seat 3: Eksrep3hySi2jeDHuaWiOQ ($8.50 in chips) 
Seat 4: w43JQj2oYPpKQVG4Yzlq1w ($25 in chips) 
Seat 5: if4dh6jhJXeN3/qd3qCp9g ($25.10 in chips) 
Seat 6: eL3+wCBjFGfQ5FMdIZihwA ($29.10 in chips) 
if4dh6jhJXeN3/qd3qCp9g: posts small blind $0.10
eL3+wCBjFGfQ5FMdIZihwA: posts big blind $0.25
*** HOLE CARDS ***
GbCVUNssQ7mqsPWr7J4d3w: folds 
evMMX/0gSDH791KdSAOaSg: raises $0.50 to $0.75
Eksrep3hySi2jeDHuaWiOQ: folds 
w43JQj2oYPpKQVG4Yzlq1w: folds 
if4dh6jhJXeN3/qd3qCp9g: folds 
eL3+wCBjFGfQ5FMdIZihwA: calls $0.50
*** FLOP *** [9c Td 8d]
eL3+wCBjFGfQ5FMdIZihwA: checks 
evMMX/0gSDH791KdSAOaSg: checks 
*** TURN *** [9c Td 8d] [6d]
eL3+wCBjFGfQ5FMdIZihwA: checks 
evMMX/0gSDH791KdSAOaSg: bets $0.75
eL3+wCBjFGfQ5FMdIZihwA: calls $0.75
*** RIVER *** [9c Td 8d 6d] [7d]
eL3+wCBjFGfQ5FMdIZihwA: checks 
evMMX/0gSDH791KdSAOaSg: bets $16.95 and is all-in
eL3+wCBjFGfQ5FMdIZihwA: folds 
Uncalled bet ($16.95) returned to evMMX/0gSDH791KdSAOaSg
evMMX/0gSDH791KdSAOaSg collected $2.95 from pot
evMMX/0gSDH791KdSAOaSg: shows [Jd 9d] (a straight flush, Seven to Jack)
*** SUMMARY ***
Total pot $3.10 | Rake $0.15 
Board [9c Td 8d 6d 7d]
Seat 1: GbCVUNssQ7mqsPWr7J4d3w folded before Flop (didn't bet)
Seat 2: evMMX/0gSDH791KdSAOaSg collected ($2.95)
Seat 3: Eksrep3hySi2jeDHuaWiOQ folded before Flop (didn't bet)
Seat 4: w43JQj2oYPpKQVG4Yzlq1w (button) folded before Flop (didn't bet)
Seat 5: if4dh6jhJXeN3/qd3qCp9g (small blind) folded before Flop
Seat 6: eL3+wCBjFGfQ5FMdIZihwA (big blind) folded on the River




PokerStars Game #59942003148:  Hold'em No Limit ($0.10/$0.25) - 2009/07/01 1:53:00 ET
Table '5VWnrlxdjwVfMWkVS2WE7A' 6-max Seat #2 is the button
Seat 1: 82p+w3EmUaFFHuwpSeGY1w ($16.60 in chips) 
Seat 2: LJI7A1YgDM7hgh7o56+ReQ ($42 in chips) 
Seat 3: z1xdRIff40SSVI/g56tgiw ($13.50 in chips) 
Seat 4: eHsmIvAb2JREg4O6hNPnXg ($25 in chips) 
Seat 5: 32YL2ZEp8NT4JB2RVM9euQ ($15.50 in chips) 
Seat 6: LtASJ9OlkqGrrUKGQlpGAw ($24.65 in chips) 
z1xdRIff40SSVI/g56tgiw: posts small blind $0.10
eHsmIvAb2JREg4O6hNPnXg: posts big blind $0.25
*** HOLE CARDS ***
32YL2ZEp8NT4JB2RVM9euQ: folds 
LtASJ9OlkqGrrUKGQlpGAw: folds 
82p+w3EmUaFFHuwpSeGY1w: calls $0.25
LJI7A1YgDM7hgh7o56+ReQ: raises $1 to $1.25
z1xdRIff40SSVI/g56tgiw: folds 
eHsmIvAb2JREg4O6hNPnXg: calls $1
82p+w3EmUaFFHuwpSeGY1w: calls $1
*** FLOP *** [2c Kh 2d]
eHsmIvAb2JREg4O6hNPnXg: checks 
82p+w3EmUaFFHuwpSeGY1w: checks 
LJI7A1YgDM7hgh7o56+ReQ: bets $3
eHsmIvAb2JREg4O6hNPnXg: folds 
82p+w3EmUaFFHuwpSeGY1w: folds 
Uncalled bet ($3) returned to LJI7A1YgDM7hgh7o56+ReQ
LJI7A1YgDM7hgh7o56+ReQ collected $3.70 from pot
LJI7A1YgDM7hgh7o56+ReQ: doesn't show hand 
*** SUMMARY ***
Total pot $3.85 | Rake $0.15 
Board [2c Kh 2d]
Seat 1: 82p+w3EmUaFFHuwpSeGY1w folded on the Flop
Seat 2: LJI7A1YgDM7hgh7o56+ReQ (button) collected ($3.70)
Seat 3: z1xdRIff40SSVI/g56tgiw (small blind) folded before Flop
Seat 4: eHsmIvAb2JREg4O6hNPnXg (big blind) folded on the Flop
Seat 5: 32YL2ZEp8NT4JB2RVM9euQ folded before Flop (didn't bet)
Seat 6: LtASJ9OlkqGrrUKGQlpGAw folded before Flop (didn't bet)




PokerStars Game #59942003348:  Hold'em No Limit ($0.10/$0.25) - 2009/07/01 1:53:00 ET
Table 'ThBZ355rqvsb8UGb6ajbig' 9-max Seat #2 is the button
Seat 2: 4awUyiDYTgylQKXZ9faBVA ($25 in chips) 
Seat 3: H5Se03ZqSX7tbULXur2MAg ($27.55 in chips) 
Seat 4: zgi+EUykT/pZQpoUG6+oEg ($5.40 in chips) 
Seat 5: cKlmpQMahVsmOaxFQDcoOg ($24.60 in chips) 
Seat 6: qwr38jl5txoR36M7G5qi4A ($11 in chips) 
Seat 8: pplNliE3WonjkPRf+GZq2A ($34.15 in chips) 
Seat 9: sD+TKtt36XiiN6jqHiLwDA ($24.65 in chips) 
H5Se03ZqSX7tbULXur2MAg: posts small blind $0.10
zgi+EUykT/pZQpoUG6+oEg: posts big blind $0.25
*** HOLE CARDS ***
cKlmpQMahVsmOaxFQDcoOg: folds 
qwr38jl5txoR36M7G5qi4A: folds 
pplNliE3WonjkPRf+GZq2A: folds 
sD+TKtt36XiiN6jqHiLwDA: folds 
4awUyiDYTgylQKXZ9faBVA: folds 
H5Se03ZqSX7tbULXur2MAg: folds 
Uncalled bet ($0.15) returned to zgi+EUykT/pZQpoUG6+oEg
zgi+EUykT/pZQpoUG6+oEg collected $0.20 from pot
zgi+EUykT/pZQpoUG6+oEg: doesn't show hand 
*** SUMMARY ***
Total pot $0.20 | Rake $0 
Seat 2: 4awUyiDYTgylQKXZ9faBVA (button) folded before Flop (didn't bet)
Seat 3: H5Se03ZqSX7tbULXur2MAg (small blind) folded before Flop
Seat 4: zgi+EUykT/pZQpoUG6+oEg (big blind) collected ($0.20)
Seat 5: cKlmpQMahVsmOaxFQDcoOg folded before Flop (didn't bet)
Seat 6: qwr38jl5txoR36M7G5qi4A folded before Flop (didn't bet)
Seat 8: pplNliE3WonjkPRf+GZq2A folded before Flop (didn't bet)
Seat 9: sD+TKtt36XiiN6jqHiLwDA folded before Flop (didn't bet)




PokerStars Game #59942003738:  Hold'em No Limit ($0.10/$0.25) - 2009/07/01 1:53:01 ET
Table 'Loy/olZ5qoDOSvX4UTujGg' 6-max Seat #2 is the button
Seat 1: HipgaJhkN4ie/tTw4dK3Ug ($10.75 in chips) 
Seat 2: 4z7mPbMLNp4TezHXin63Vw ($17.85 in chips) 
Seat 3: 32YL2ZEp8NT4JB2RVM9euQ ($15.10 in chips) 
Seat 4: /gJNBeCkWL4o85/jvlZ4BA ($26.40 in chips) 
Seat 5: Ar4vsUIUfJ7gbYh1c1m59g ($19.25 in chips) 
Seat 6: qGHGf/553gQnDoklMRe3tg ($24.80 in chips) 
32YL2ZEp8NT4JB2RVM9euQ: posts small blind $0.10
/gJNBeCkWL4o85/jvlZ4BA: posts big blind $0.25
*** HOLE CARDS ***
Ar4vsUIUfJ7gbYh1c1m59g: folds 
qGHGf/553gQnDoklMRe3tg: folds 
HipgaJhkN4ie/tTw4dK3Ug: raises $0.25 to $0.50
4z7mPbMLNp4TezHXin63Vw: calls $0.50
32YL2ZEp8NT4JB2RVM9euQ: folds 
/gJNBeCkWL4o85/jvlZ4BA: folds 
*** FLOP *** [3c 9h 5c]
HipgaJhkN4ie/tTw4dK3Ug: bets $0.50
4z7mPbMLNp4TezHXin63Vw: folds 
Uncalled bet ($0.50) returned to HipgaJhkN4ie/tTw4dK3Ug
HipgaJhkN4ie/tTw4dK3Ug collected $1.30 from pot
*** SUMMARY ***
Total pot $1.35 | Rake $0.05 
Board [3c 9h 5c]
Seat 1: HipgaJhkN4ie/tTw4dK3Ug collected ($1.30)
Seat 2: 4z7mPbMLNp4TezHXin63Vw (button) folded on the Flop
Seat 3: 32YL2ZEp8NT4JB2RVM9euQ (small blind) folded before Flop
Seat 4: /gJNBeCkWL4o85/jvlZ4BA (big blind) folded before Flop
Seat 5: Ar4vsUIUfJ7gbYh1c1m59g folded before Flop (didn't bet)
Seat 6: qGHGf/553gQnDoklMRe3tg folded before Flop (didn't bet)




PokerStars Game #59942003600:  Hold'em No Limit ($0.10/$0.25) - 2009/07/01 1:53:01 ET
Table '8PD/MTROSMd6Y8mZeykbpg' 6-max Seat #1 is the button
Seat 1: fxNpaToxECtD2Goelmg9vA ($26.90 in chips) 
Seat 2: 4TM16KVgEiQpLi4bVVWbVQ ($31.70 in chips) 
Seat 3: vqWjZmdQu/Hxw96/IJTWdQ ($25 in chips) 
Seat 4: DFi/Lzkjsfv8QswS80JX9Q ($49.55 in chips) 
Seat 5: z3tQwy28dp5FykDJC/wzQw ($26.20 in chips) 
Seat 6: trN/oHqTTbPw5MNuKrOpLw ($25 in chips) 
4TM16KVgEiQpLi4bVVWbVQ: posts small blind $0.10
vqWjZmdQu/Hxw96/IJTWdQ: posts big blind $0.25
*** HOLE CARDS ***
DFi/Lzkjsfv8QswS80JX9Q: folds 
z3tQwy28dp5FykDJC/wzQw: calls $0.25
trN/oHqTTbPw5MNuKrOpLw: raises $0.75 to $1
fxNpaToxECtD2Goelmg9vA: folds 
4TM16KVgEiQpLi4bVVWbVQ: folds 
vqWjZmdQu/Hxw96/IJTWdQ: folds 
z3tQwy28dp5FykDJC/wzQw: calls $0.75
*** FLOP *** [5d 7c Js]
z3tQwy28dp5FykDJC/wzQw: bets $0.75
trN/oHqTTbPw5MNuKrOpLw: folds 
Uncalled bet ($0.75) returned to z3tQwy28dp5FykDJC/wzQw
z3tQwy28dp5FykDJC/wzQw collected $2.25 from pot
*** SUMMARY ***
Total pot $2.35 | Rake $0.10 
Board [5d 7c Js]
Seat 1: fxNpaToxECtD2Goelmg9vA (button) folded before Flop (didn't bet)
Seat 2: 4TM16KVgEiQpLi4bVVWbVQ (small blind) folded before Flop
Seat 3: vqWjZmdQu/Hxw96/IJTWdQ (big blind) folded before Flop
Seat 4: DFi/Lzkjsfv8QswS80JX9Q folded before Flop (didn't bet)
Seat 5: z3tQwy28dp5FykDJC/wzQw collected ($2.25)
Seat 6: trN/oHqTTbPw5MNuKrOpLw folded on the Flop




PokerStars Game #59942003898:  Hold'em No Limit ($0.10/$0.25) - 2009/07/01 1:53:01 ET
Table 'LXz5SsUCyWcm+4JDJh466A' 9-max Seat #6 is the button
Seat 1: MG90wfSJZnOejs/KD3vlQQ ($25 in chips) 
Seat 2: H5Se03ZqSX7tbULXur2MAg ($22.60 in chips) 
Seat 3: dfNim92Z6XK1/h5SFW5vDg ($25 in chips) 
Seat 4: K0b5wNInj6hUGRr6yzKFtw ($52.60 in chips) 
Seat 5: CGZe30OcuMyA3kN5MnfQcQ ($15.60 in chips) 
Seat 6: 6RiVTYll/5D8zICp0MRpKw ($24.40 in chips) 
Seat 7: J2a/QHAWUgo6beDRoEyg2g ($11.40 in chips) 
Seat 8: zOHElTcFiTsexeDCkAPYkQ ($29.95 in chips) 
Seat 9: dtZ84flFEi4Q+SGrHMJRDQ ($25 in chips) 
J2a/QHAWUgo6beDRoEyg2g: posts small blind $0.10
zOHElTcFiTsexeDCkAPYkQ: posts big blind $0.25
*** HOLE CARDS ***
dtZ84flFEi4Q+SGrHMJRDQ: folds 
MG90wfSJZnOejs/KD3vlQQ: folds 
H5Se03ZqSX7tbULXur2MAg: folds 
dfNim92Z6XK1/h5SFW5vDg: folds 
K0b5wNInj6hUGRr6yzKFtw: folds 
CGZe30OcuMyA3kN5MnfQcQ: raises $0.50 to $0.75
6RiVTYll/5D8zICp0MRpKw: calls $0.75
J2a/QHAWUgo6beDRoEyg2g: calls $0.65
zOHElTcFiTsexeDCkAPYkQ: calls $0.50
*** FLOP *** [6h 4d Ac]
J2a/QHAWUgo6beDRoEyg2g: checks 
zOHElTcFiTsexeDCkAPYkQ: checks 
CGZe30OcuMyA3kN5MnfQcQ: bets $1
6RiVTYll/5D8zICp0MRpKw: folds 
J2a/QHAWUgo6beDRoEyg2g: folds 
zOHElTcFiTsexeDCkAPYkQ: folds 
Uncalled bet ($1) returned to CGZe30OcuMyA3kN5MnfQcQ
CGZe30OcuMyA3kN5MnfQcQ collected $2.85 from pot
*** SUMMARY ***
Total pot $3 | Rake $0.15 
Board [6h 4d Ac]
Seat 1: MG90wfSJZnOejs/KD3vlQQ folded before Flop (didn't bet)
Seat 2: H5Se03ZqSX7tbULXur2MAg folded before Flop (didn't bet)
Seat 3: dfNim92Z6XK1/h5SFW5vDg folded before Flop (didn't bet)
Seat 4: K0b5wNInj6hUGRr6yzKFtw folded before Flop (didn't bet)
Seat 5: CGZe30OcuMyA3kN5MnfQcQ collected ($2.85)
Seat 6: 6RiVTYll/5D8zICp0MRpKw (button) folded on the Flop
Seat 7: J2a/QHAWUgo6beDRoEyg2g (small blind) folded on the Flop
Seat 8: zOHElTcFiTsexeDCkAPYkQ (big blind) folded on the Flop
Seat 9: dtZ84flFEi4Q+SGrHMJRDQ folded before Flop (didn't bet)




PokerStars Game #59942003956:  Hold'em No Limit ($0.10/$0.25) - 2009/07/01 1:53:01 ET
Table '9lYs7ljXi6AgFAxYHlKLJw' 9-max Seat #7 is the button
Seat 1: K0b5wNInj6hUGRr6yzKFtw ($36.65 in chips) 
Seat 2: 0XACOSNrAWmqNv9k1nF8rw ($14.60 in chips) 
Seat 3: arxNSjreDRGFg13EAM2F1w ($37.45 in chips) 
Seat 4: UANt6y/SmDCY/jIxkBixcw ($33.70 in chips) 
Seat 5: dfNim92Z6XK1/h5SFW5vDg ($59.20 in chips) 
Seat 7: ghNKXUBl/H+t83JF079ZBA ($28.40 in chips) 
Seat 8: 9YN2IkT2JYYKFErZtZvCtA ($18.35 in chips) 
Seat 9: IVL33RWimYC8hA5O8TO69Q ($5 in chips) 
9YN2IkT2JYYKFErZtZvCtA: posts small blind $0.10
IVL33RWimYC8hA5O8TO69Q: posts big blind $0.25
j4q3p0lesp63b1gZDwLBZw: sits out 
*** HOLE CARDS ***
K0b5wNInj6hUGRr6yzKFtw: folds 
0XACOSNrAWmqNv9k1nF8rw: folds 
arxNSjreDRGFg13EAM2F1w: folds 
UANt6y/SmDCY/jIxkBixcw: folds 
dfNim92Z6XK1/h5SFW5vDg: folds 
ghNKXUBl/H+t83JF079ZBA: folds 
9YN2IkT2JYYKFErZtZvCtA: folds 
Uncalled bet ($0.15) returned to IVL33RWimYC8hA5O8TO69Q
IVL33RWimYC8hA5O8TO69Q collected $0.20 from pot
*** SUMMARY ***
Total pot $0.20 | Rake $0 
Seat 1: K0b5wNInj6hUGRr6yzKFtw folded before Flop (didn't bet)
Seat 2: 0XACOSNrAWmqNv9k1nF8rw folded before Flop (didn't bet)
Seat 3: arxNSjreDRGFg13EAM2F1w folded before Flop (didn't bet)
Seat 4: UANt6y/SmDCY/jIxkBixcw folded before Flop (didn't bet)
Seat 5: dfNim92Z6XK1/h5SFW5vDg folded before Flop (didn't bet)
Seat 7: ghNKXUBl/H+t83JF079ZBA (button) folded before Flop (didn't bet)
Seat 8: 9YN2IkT2JYYKFErZtZvCtA (small blind) folded before Flop
Seat 9: IVL33RWimYC8hA5O8TO69Q (big blind) collected ($0.20)




PokerStars Game #59942004364:  Hold'em No Limit ($0.10/$0.25) - 2009/07/01 1:53:02 ET
Table 'srBTB98reCdD1TffxE6o7g' 6-max Seat #5 is the button
Seat 2: mfrkWA3PTeYPkbO6hi98Aw ($24.65 in chips) 
Seat 3: VOmI0x4dDPnTESZd5B4d1Q ($42.40 in chips) 
Seat 4: 6DwBRH+xZ12AAZmeAg+aXw ($16.20 in chips) 
Seat 5: K1zv48sQUGQiaLk5VWWDqw ($26.25 in chips) 
Seat 6: BV+K0Phf5VBHr7aZPKqbUQ ($30.50 in chips) 
BV+K0Phf5VBHr7aZPKqbUQ: posts small blind $0.10
mfrkWA3PTeYPkbO6hi98Aw: posts big blind $0.25
*** HOLE CARDS ***
VOmI0x4dDPnTESZd5B4d1Q: folds 
6DwBRH+xZ12AAZmeAg+aXw: raises $0.50 to $0.75
K1zv48sQUGQiaLk5VWWDqw: folds 
BV+K0Phf5VBHr7aZPKqbUQ: folds 
mfrkWA3PTeYPkbO6hi98Aw: folds 
Uncalled bet ($0.50) returned to 6DwBRH+xZ12AAZmeAg+aXw
6DwBRH+xZ12AAZmeAg+aXw collected $0.60 from pot
6DwBRH+xZ12AAZmeAg+aXw: doesn't show hand 
*** SUMMARY ***
Total pot $0.60 | Rake $0 
Seat 2: mfrkWA3PTeYPkbO6hi98Aw (big blind) folded before Flop
Seat 3: VOmI0x4dDPnTESZd5B4d1Q folded before Flop (didn't bet)
Seat 4: 6DwBRH+xZ12AAZmeAg+aXw collected ($0.60)
Seat 5: K1zv48sQUGQiaLk5VWWDqw (button) folded before Flop (didn't bet)
Seat 6: BV+K0Phf5VBHr7aZPKqbUQ (small blind) folded before Flop




PokerStars Game #59942004118:  Hold'em No Limit ($0.10/$0.25) - 2009/07/01 1:53:02 ET
Table '8QBBaev+cI2i/r2H6ml/lg' 9-max Seat #6 is the button
Seat 1: s2xLPOl/vhl/26apJ3vsOQ ($38.40 in chips) 
Seat 2: y7tkvDmwKjURBkr73SZPXw ($7.65 in chips) 
Seat 3: zgi+EUykT/pZQpoUG6+oEg ($4.30 in chips) 
Seat 4: ytpGB2nr/CLVHnyKMRiEFQ ($27.10 in chips) 
Seat 5: 0QdZrkFD7aGKeBXPGbIomA ($11.10 in chips) 
Seat 6: X6+pSIPfovPcE87t+LmUKQ ($4.65 in chips) 
Seat 7: eK8qa6EPcH2zhtbmWSvc9g ($29.80 in chips) 
Seat 8: vr1IK/Q4HXm8s8V0/dePzQ ($10.60 in chips) 
Seat 9: EUMLvzDkECHBit+xa+uGjg ($17 in chips) 
eK8qa6EPcH2zhtbmWSvc9g: posts small blind $0.10
vr1IK/Q4HXm8s8V0/dePzQ: posts big blind $0.25
*** HOLE CARDS ***
EUMLvzDkECHBit+xa+uGjg: raises $0.50 to $0.75
s2xLPOl/vhl/26apJ3vsOQ: folds 
y7tkvDmwKjURBkr73SZPXw: folds 
zgi+EUykT/pZQpoUG6+oEg: folds 
ytpGB2nr/CLVHnyKMRiEFQ: folds 
0QdZrkFD7aGKeBXPGbIomA: folds 
X6+pSIPfovPcE87t+LmUKQ: folds 
eK8qa6EPcH2zhtbmWSvc9g: folds 
vr1IK/Q4HXm8s8V0/dePzQ: folds 
Uncalled bet ($0.50) returned to EUMLvzDkECHBit+xa+uGjg
EUMLvzDkECHBit+xa+uGjg collected $0.60 from pot
*** SUMMARY ***
Total pot $0.60 | Rake $0 
Seat 1: s2xLPOl/vhl/26apJ3vsOQ folded before Flop (didn't bet)
Seat 2: y7tkvDmwKjURBkr73SZPXw folded before Flop (didn't bet)
Seat 3: zgi+EUykT/pZQpoUG6+oEg folded before Flop (didn't bet)
Seat 4: ytpGB2nr/CLVHnyKMRiEFQ folded before Flop (didn't bet)
Seat 5: 0QdZrkFD7aGKeBXPGbIomA folded before Flop (didn't bet)
Seat 6: X6+pSIPfovPcE87t+LmUKQ (button) folded before Flop (didn't bet)
Seat 7: eK8qa6EPcH2zhtbmWSvc9g (small blind) folded before Flop
Seat 8: vr1IK/Q4HXm8s8V0/dePzQ (big blind) folded before Flop
Seat 9: EUMLvzDkECHBit+xa+uGjg collected ($0.60)




PokerStars Game #59942004100:  Hold'em No Limit ($0.10/$0.25) - 2009/07/01 1:53:02 ET
Table 'ZEXL6Wh4qA4Afx8NnoBBAA' 6-max Seat #5 is the button
Seat 1: v8m8XHovI5tqEA9mvplDSw ($26.95 in chips) 
Seat 2: 6DwBRH+xZ12AAZmeAg+aXw ($18.65 in chips) 
Seat 3: +ZlnqPoP3Hg4BIUxDfKd/A ($34.60 in chips) 
Seat 4: FpN4KbLjlyRRKiVaQcoLqA ($30.20 in chips) 
Seat 5: if4dh6jhJXeN3/qd3qCp9g ($38.45 in chips) 
Seat 6: Lh8SlCq3OSDKWLUgAI/Lxw ($1.50 in chips) 
Lh8SlCq3OSDKWLUgAI/Lxw: posts small blind $0.10
v8m8XHovI5tqEA9mvplDSw: posts big blind $0.25
*** HOLE CARDS ***
6DwBRH+xZ12AAZmeAg+aXw: folds 
+ZlnqPoP3Hg4BIUxDfKd/A: folds 
FpN4KbLjlyRRKiVaQcoLqA: folds 
if4dh6jhJXeN3/qd3qCp9g: folds 
Lh8SlCq3OSDKWLUgAI/Lxw: calls $0.15
v8m8XHovI5tqEA9mvplDSw: checks 
*** FLOP *** [8s 7h Ks]
Lh8SlCq3OSDKWLUgAI/Lxw: checks 
v8m8XHovI5tqEA9mvplDSw: checks 
*** TURN *** [8s 7h Ks] [4c]
Lh8SlCq3OSDKWLUgAI/Lxw: checks 
v8m8XHovI5tqEA9mvplDSw: checks 
*** RIVER *** [8s 7h Ks 4c] [6d]
Lh8SlCq3OSDKWLUgAI/Lxw: checks 
v8m8XHovI5tqEA9mvplDSw: checks 
*** SHOW DOWN ***
Lh8SlCq3OSDKWLUgAI/Lxw: shows [7d As] (a pair of Sevens)
v8m8XHovI5tqEA9mvplDSw: shows [4h 5d] (a straight, Four to Eight)
v8m8XHovI5tqEA9mvplDSw collected $0.50 from pot
*** SUMMARY ***
Total pot $0.50 | Rake $0 
Board [8s 7h Ks 4c 6d]
Seat 1: v8m8XHovI5tqEA9mvplDSw (big blind) showed [4h 5d] and won ($0.50) with a straight, Four to Eight
Seat 2: 6DwBRH+xZ12AAZmeAg+aXw folded before Flop (didn't bet)
Seat 3: +ZlnqPoP3Hg4BIUxDfKd/A folded before Flop (didn't bet)
Seat 4: FpN4KbLjlyRRKiVaQcoLqA folded before Flop (didn't bet)
Seat 5: if4dh6jhJXeN3/qd3qCp9g (button) folded before Flop (didn't bet)
Seat 6: Lh8SlCq3OSDKWLUgAI/Lxw (small blind) showed [7d As] and lost with a pair of Sevens




PokerStars Game #59942004848:  Hold'em No Limit ($0.10/$0.25) - 2009/07/01 1:53:03 ET
Table '6wawJ+MkkvuC3coG6r+Yhg' 6-max Seat #6 is the button
Seat 1: JQZew0FjzS19kTjeNtrE+A ($29.90 in chips) 
Seat 2: LtASJ9OlkqGrrUKGQlpGAw ($20.85 in chips) 
Seat 3: 3zD3qLXT1bEffAoWGnc7wg ($60.90 in chips) 
Seat 4: 9U3ZKjCsarN0DjR6mSE8Ug ($14.25 in chips) 
Seat 5: GbCVUNssQ7mqsPWr7J4d3w ($4.65 in chips) 
Seat 6: B3X187C0tXFUfQpCu8pe8A ($23.45 in chips) 
JQZew0FjzS19kTjeNtrE+A: posts small blind $0.10
LtASJ9OlkqGrrUKGQlpGAw: posts big blind $0.25
*** HOLE CARDS ***
3zD3qLXT1bEffAoWGnc7wg: folds 
9U3ZKjCsarN0DjR6mSE8Ug: folds 
GbCVUNssQ7mqsPWr7J4d3w: folds 
B3X187C0tXFUfQpCu8pe8A: calls $0.25
JQZew0FjzS19kTjeNtrE+A: folds 
LtASJ9OlkqGrrUKGQlpGAw: checks 
*** FLOP *** [9h Qh 2d]
LtASJ9OlkqGrrUKGQlpGAw: checks 
B3X187C0tXFUfQpCu8pe8A: checks 
*** TURN *** [9h Qh 2d] [Th]
LtASJ9OlkqGrrUKGQlpGAw: checks 
B3X187C0tXFUfQpCu8pe8A: bets $0.50
LtASJ9OlkqGrrUKGQlpGAw: folds 
Uncalled bet ($0.50) returned to B3X187C0tXFUfQpCu8pe8A
B3X187C0tXFUfQpCu8pe8A collected $0.60 from pot
*** SUMMARY ***
Total pot $0.60 | Rake $0 
Board [9h Qh 2d Th]
Seat 1: JQZew0FjzS19kTjeNtrE+A (small blind) folded before Flop
Seat 2: LtASJ9OlkqGrrUKGQlpGAw (big blind) folded on the Turn
Seat 3: 3zD3qLXT1bEffAoWGnc7wg folded before Flop (didn't bet)
Seat 4: 9U3ZKjCsarN0DjR6mSE8Ug folded before Flop (didn't bet)
Seat 5: GbCVUNssQ7mqsPWr7J4d3w folded before Flop (didn't bet)
Seat 6: B3X187C0tXFUfQpCu8pe8A (button) collected ($0.60)




PokerStars Game #59942004964:  Hold'em No Limit ($0.10/$0.25) - 2009/07/01 1:53:03 ET
Table 'G26g8jde1eR+mmabeFeSlw' 9-max Seat #7 is the button
Seat 1: wnerYvSRWT9Sm4X3ip/c8w ($24.65 in chips) 
Seat 4: 8EbrQ/EvFWt2cr0GaU82gQ ($5.40 in chips) 
Seat 5: hJ4uYjNmSZdjrKA8cjZqCA ($39.75 in chips) 
Seat 6: AHGkesF/mi4sDMpqrxBUoA ($8.40 in chips) 
Seat 7: nm4Dj/f+jJEwKVsUnKh73g ($38.55 in chips) 
Seat 8: CvL9Ch1HYCVbTsfpNucitg ($5 in chips) 
Seat 9: VWUWpMLMj/Q1jRVpF7Aohw ($13.30 in chips) 
CvL9Ch1HYCVbTsfpNucitg: posts small blind $0.10
VWUWpMLMj/Q1jRVpF7Aohw: posts big blind $0.25
s2xLPOl/vhl/26apJ3vsOQ: sits out 
*** HOLE CARDS ***
wnerYvSRWT9Sm4X3ip/c8w: folds 
8EbrQ/EvFWt2cr0GaU82gQ: raises $0.50 to $0.75
hJ4uYjNmSZdjrKA8cjZqCA: folds 
AHGkesF/mi4sDMpqrxBUoA: calls $0.75
nm4Dj/f+jJEwKVsUnKh73g: folds 
CvL9Ch1HYCVbTsfpNucitg: raises $4.25 to $5 and is all-in
VWUWpMLMj/Q1jRVpF7Aohw: folds 
8EbrQ/EvFWt2cr0GaU82gQ: raises $0.40 to $5.40 and is all-in
AHGkesF/mi4sDMpqrxBUoA: folds 
Uncalled bet ($0.40) returned to 8EbrQ/EvFWt2cr0GaU82gQ
*** FLOP *** [3d As 6s]
*** TURN *** [3d As 6s] [9h]
*** RIVER *** [3d As 6s 9h] [Ks]
*** SHOW DOWN ***
CvL9Ch1HYCVbTsfpNucitg: shows [Ac Kh] (two pair, Aces and Kings)
8EbrQ/EvFWt2cr0GaU82gQ: shows [Ad Kc] (two pair, Aces and Kings)
CvL9Ch1HYCVbTsfpNucitg collected $5.25 from pot
8EbrQ/EvFWt2cr0GaU82gQ collected $5.20 from pot
*** SUMMARY ***
Total pot $11 | Rake $0.55 
Board [3d As 6s 9h Ks]
Seat 1: wnerYvSRWT9Sm4X3ip/c8w folded before Flop (didn't bet)
Seat 4: 8EbrQ/EvFWt2cr0GaU82gQ showed [Ad Kc] and won ($5.20) with two pair, Aces and Kings
Seat 5: hJ4uYjNmSZdjrKA8cjZqCA folded before Flop (didn't bet)
Seat 6: AHGkesF/mi4sDMpqrxBUoA folded before Flop
Seat 7: nm4Dj/f+jJEwKVsUnKh73g (button) folded before Flop (didn't bet)
Seat 8: CvL9Ch1HYCVbTsfpNucitg (small blind) showed [Ac Kh] and won ($5.25) with two pair, Aces and Kings
Seat 9: VWUWpMLMj/Q1jRVpF7Aohw (big blind) folded before Flop




PokerStars Game #59942004774:  Hold'em No Limit ($0.10/$0.25) - 2009/07/01 1:53:03 ET
Table 'CM/C/FZf3VHIp50RjmBucQ' 9-max Seat #2 is the button
Seat 1: P8h+GtgJJRwRh2YdssBtbg ($5.50 in chips) 
Seat 2: OXPkK84/qv92EMwXPiG5rQ ($9.65 in chips) 
Seat 3: HPEB+AtKw1+C/cxU0o1ciw ($55.50 in chips) 
Seat 4: FYIiLXWy4mKC5ZGa/fnS0g ($6.80 in chips) 
Seat 5: t3m1RlE+8m1yb0ojo8ikCw ($10.65 in chips) 
Seat 6: FqpibuVWLNsAN/Z7ROZLnA ($5.55 in chips) 
Seat 7: +T7KwHtNiHQt6JhQegSH/w ($17.20 in chips) 
Seat 8: 5pDhXQ+RVy0BGcwfJAJfbg ($24.65 in chips) 
Seat 9: W6tExOcYX7qiy6Qdp+ZwFA ($4.90 in chips) 
HPEB+AtKw1+C/cxU0o1ciw: posts small blind $0.10
FYIiLXWy4mKC5ZGa/fnS0g: posts big blind $0.25
*** HOLE CARDS ***
t3m1RlE+8m1yb0ojo8ikCw: calls $0.25
FqpibuVWLNsAN/Z7ROZLnA: folds 
+T7KwHtNiHQt6JhQegSH/w: calls $0.25
5pDhXQ+RVy0BGcwfJAJfbg: raises $0.75 to $1
W6tExOcYX7qiy6Qdp+ZwFA: folds 
P8h+GtgJJRwRh2YdssBtbg: folds 
OXPkK84/qv92EMwXPiG5rQ: folds 
HPEB+AtKw1+C/cxU0o1ciw: folds 
FYIiLXWy4mKC5ZGa/fnS0g: raises $1.25 to $2.25
t3m1RlE+8m1yb0ojo8ikCw: calls $2
+T7KwHtNiHQt6JhQegSH/w: calls $2
5pDhXQ+RVy0BGcwfJAJfbg: calls $1.25
*** FLOP *** [Kc Qc 9h]
FYIiLXWy4mKC5ZGa/fnS0g: bets $4.55 and is all-in
t3m1RlE+8m1yb0ojo8ikCw: folds 
+T7KwHtNiHQt6JhQegSH/w: calls $4.55
5pDhXQ+RVy0BGcwfJAJfbg: raises $11.45 to $16
+T7KwHtNiHQt6JhQegSH/w: calls $10.40 and is all-in
Uncalled bet ($1.05) returned to 5pDhXQ+RVy0BGcwfJAJfbg
*** TURN *** [Kc Qc 9h] [Qs]
*** RIVER *** [Kc Qc 9h Qs] [5s]
*** SHOW DOWN ***
+T7KwHtNiHQt6JhQegSH/w: shows [As 9d] (two pair, Queens and Nines)
5pDhXQ+RVy0BGcwfJAJfbg: shows [Ks Qd] (a full house, Queens full of Kings)
5pDhXQ+RVy0BGcwfJAJfbg collected $19.75 from side pot
FYIiLXWy4mKC5ZGa/fnS0g: shows [Ac Kd] (two pair, Kings and Queens)
5pDhXQ+RVy0BGcwfJAJfbg collected $21.65 from main pot
*** SUMMARY ***
Total pot $43.55 Main pot $21.65. Side pot $19.75. | Rake $2.15 
Board [Kc Qc 9h Qs 5s]
Seat 1: P8h+GtgJJRwRh2YdssBtbg folded before Flop (didn't bet)
Seat 2: OXPkK84/qv92EMwXPiG5rQ (button) folded before Flop (didn't bet)
Seat 3: HPEB+AtKw1+C/cxU0o1ciw (small blind) folded before Flop
Seat 4: FYIiLXWy4mKC5ZGa/fnS0g (big blind) showed [Ac Kd] and lost with two pair, Kings and Queens
Seat 5: t3m1RlE+8m1yb0ojo8ikCw folded on the Flop
Seat 6: FqpibuVWLNsAN/Z7ROZLnA folded before Flop (didn't bet)
Seat 7: +T7KwHtNiHQt6JhQegSH/w showed [As 9d] and lost with two pair, Queens and Nines
Seat 8: 5pDhXQ+RVy0BGcwfJAJfbg showed [Ks Qd] and won ($41.40) with a full house, Queens full of Kings
Seat 9: W6tExOcYX7qiy6Qdp+ZwFA folded before Flop (didn't bet)




PokerStars Game #59942004606:  Hold'em No Limit ($0.10/$0.25) - 2009/07/01 1:53:03 ET
Table 'aisAlB9GIV21BwfUW3+Nbg' 9-max Seat #2 is the button
Seat 1: SqibpGx+lf+brY0fJVvD0w ($24.25 in chips) 
Seat 2: zgi+EUykT/pZQpoUG6+oEg ($4.65 in chips) 
Seat 3: CvL9Ch1HYCVbTsfpNucitg ($5.15 in chips) 
Seat 4: sD+TKtt36XiiN6jqHiLwDA ($26.50 in chips) 
Seat 5: ghNKXUBl/H+t83JF079ZBA ($27.75 in chips) 
Seat 6: 9gmYYQesalMrUjaF7nKfrQ ($15.85 in chips) 
Seat 7: QUyZmk8wzvBAtbHg9JXClw ($14.75 in chips) 
Seat 8: VWUWpMLMj/Q1jRVpF7Aohw ($25.95 in chips) 
Seat 9: N0hGpTAEAj9k5msS6LPLAw ($20.60 in chips) 
CvL9Ch1HYCVbTsfpNucitg: posts small blind $0.10
sD+TKtt36XiiN6jqHiLwDA: posts big blind $0.25
*** HOLE CARDS ***
ghNKXUBl/H+t83JF079ZBA: raises $0.75 to $1
9gmYYQesalMrUjaF7nKfrQ: folds 
QUyZmk8wzvBAtbHg9JXClw: folds 
VWUWpMLMj/Q1jRVpF7Aohw: folds 
N0hGpTAEAj9k5msS6LPLAw: folds 
SqibpGx+lf+brY0fJVvD0w: folds 
zgi+EUykT/pZQpoUG6+oEg: folds 
CvL9Ch1HYCVbTsfpNucitg: folds 
sD+TKtt36XiiN6jqHiLwDA: folds 
Uncalled bet ($0.75) returned to ghNKXUBl/H+t83JF079ZBA
ghNKXUBl/H+t83JF079ZBA collected $0.60 from pot
ghNKXUBl/H+t83JF079ZBA: doesn't show hand 
*** SUMMARY ***
Total pot $0.60 | Rake $0 
Seat 1: SqibpGx+lf+brY0fJVvD0w folded before Flop (didn't bet)
Seat 2: zgi+EUykT/pZQpoUG6+oEg (button) folded before Flop (didn't bet)
Seat 3: CvL9Ch1HYCVbTsfpNucitg (small blind) folded before Flop
Seat 4: sD+TKtt36XiiN6jqHiLwDA (big blind) folded before Flop
Seat 5: ghNKXUBl/H+t83JF079ZBA collected ($0.60)
Seat 6: 9gmYYQesalMrUjaF7nKfrQ folded before Flop (didn't bet)
Seat 7: QUyZmk8wzvBAtbHg9JXClw folded before Flop (didn't bet)
Seat 8: VWUWpMLMj/Q1jRVpF7Aohw folded before Flop (didn't bet)
Seat 9: N0hGpTAEAj9k5msS6LPLAw folded before Flop (didn't bet)




PokerStars Game #59942004932:  Hold'em No Limit ($0.10/$0.25) - 2009/07/01 1:53:03 ET
Table '+68ihX5Br1xgGorX6zsCBg' 9-max Seat #9 is the button
Seat 1: IFB2mhulUVYIbb+KWwDC9w ($5.25 in chips) 
Seat 2: TeAfhXG1R60d8yPEHN3JiA ($23.95 in chips) 
Seat 3: PdIasPkzm2sqZnN41ZRXOg ($5.05 in chips) 
Seat 4: Oi0EiPIjriUb/6zT65YeWA ($27.30 in chips) 
Seat 5: ghNKXUBl/H+t83JF079ZBA ($28.65 in chips) 
Seat 6: X78b5v/uhqeXXoAijbw/yg ($26.05 in chips) 
Seat 7: V6p0jQ/RhUsqpHLmXvEX4Q ($19 in chips) 
Seat 9: DiSvPC2iudwL5j9u6Huyww ($32.40 in chips) 
IFB2mhulUVYIbb+KWwDC9w: posts small blind $0.10
TeAfhXG1R60d8yPEHN3JiA: posts big blind $0.25
*** HOLE CARDS ***
PdIasPkzm2sqZnN41ZRXOg: folds 
Oi0EiPIjriUb/6zT65YeWA: folds 
ghNKXUBl/H+t83JF079ZBA: folds 
X78b5v/uhqeXXoAijbw/yg: folds 
V6p0jQ/RhUsqpHLmXvEX4Q: folds 
DiSvPC2iudwL5j9u6Huyww: folds 
IFB2mhulUVYIbb+KWwDC9w: calls $0.15
TeAfhXG1R60d8yPEHN3JiA: checks 
*** FLOP *** [7h 3h Qh]
IFB2mhulUVYIbb+KWwDC9w: bets $0.25
TeAfhXG1R60d8yPEHN3JiA: calls $0.25
*** TURN *** [7h 3h Qh] [Qs]
IFB2mhulUVYIbb+KWwDC9w: bets $0.25
TeAfhXG1R60d8yPEHN3JiA: calls $0.25
*** RIVER *** [7h 3h Qh Qs] [2c]
IFB2mhulUVYIbb+KWwDC9w: bets $0.50
TeAfhXG1R60d8yPEHN3JiA: calls $0.50
*** SHOW DOWN ***
IFB2mhulUVYIbb+KWwDC9w: shows [7d 9h] (two pair, Queens and Sevens)
TeAfhXG1R60d8yPEHN3JiA: mucks hand 
IFB2mhulUVYIbb+KWwDC9w collected $2.40 from pot
*** SUMMARY ***
Total pot $2.50 | Rake $0.10 
Board [7h 3h Qh Qs 2c]
Seat 1: IFB2mhulUVYIbb+KWwDC9w (small blind) showed [7d 9h] and won ($2.40) with two pair, Queens and Sevens
Seat 2: TeAfhXG1R60d8yPEHN3JiA (big blind) mucked
Seat 3: PdIasPkzm2sqZnN41ZRXOg folded before Flop (didn't bet)
Seat 4: Oi0EiPIjriUb/6zT65YeWA folded before Flop (didn't bet)
Seat 5: ghNKXUBl/H+t83JF079ZBA folded before Flop (didn't bet)
Seat 6: X78b5v/uhqeXXoAijbw/yg folded before Flop (didn't bet)
Seat 7: V6p0jQ/RhUsqpHLmXvEX4Q folded before Flop (didn't bet)
Seat 9: DiSvPC2iudwL5j9u6Huyww (button) folded before Flop (didn't bet)




PokerStars Game #59942004824:  Hold'em No Limit ($0.10/$0.25) - 2009/07/01 1:53:03 ET
Table 'T/iCKJXGphRN3xcdwfE/JQ' 6-max Seat #2 is the button
Seat 2: EeUZtMU058v2ObUACOF4Og ($33.05 in chips) 
Seat 3: IWAjoCPXtc1XUaZdp+pCpA ($21.85 in chips) 
Seat 4: m2yWOKfAxqHoy5DDN87Ttw ($8.60 in chips) 
Seat 5: y85armT09GoP0OGsamp0jA ($18.05 in chips) 
Seat 6: Ey4Kn6PlnYb2srYYBJHvzg ($31.45 in chips) 
IWAjoCPXtc1XUaZdp+pCpA: posts small blind $0.10
Mn2V28t5aGq2d09z+/o6Fw joins the table at seat #1 
m2yWOKfAxqHoy5DDN87Ttw: posts big blind $0.25
*** HOLE CARDS ***
y85armT09GoP0OGsamp0jA: raises $0.50 to $0.75
Ey4Kn6PlnYb2srYYBJHvzg: folds 
EeUZtMU058v2ObUACOF4Og: folds 
IWAjoCPXtc1XUaZdp+pCpA: calls $0.65
m2yWOKfAxqHoy5DDN87Ttw: folds 
*** FLOP *** [As 4c 8h]
IWAjoCPXtc1XUaZdp+pCpA: checks 
y85armT09GoP0OGsamp0jA: bets $1
IWAjoCPXtc1XUaZdp+pCpA: folds 
Uncalled bet ($1) returned to y85armT09GoP0OGsamp0jA
y85armT09GoP0OGsamp0jA collected $1.70 from pot
*** SUMMARY ***
Total pot $1.75 | Rake $0.05 
Board [As 4c 8h]
Seat 2: EeUZtMU058v2ObUACOF4Og (button) folded before Flop (didn't bet)
Seat 3: IWAjoCPXtc1XUaZdp+pCpA (small blind) folded on the Flop
Seat 4: m2yWOKfAxqHoy5DDN87Ttw (big blind) folded before Flop
Seat 5: y85armT09GoP0OGsamp0jA collected ($1.70)
Seat 6: Ey4Kn6PlnYb2srYYBJHvzg folded before Flop (didn't bet)




PokerStars Game #59942004898:  Hold'em No Limit ($0.10/$0.25) - 2009/07/01 1:53:03 ET
Table 'hOE09W281uSob0XeJmUcRg' 6-max Seat #1 is the button
Seat 1: mfrkWA3PTeYPkbO6hi98Aw ($27.25 in chips) 
Seat 3: y+a/yGW/Jy4bPJFnaeTz5w ($12.20 in chips) 
Seat 4: MVzl6OsGybVDNd3Vr9LYAA ($25 in chips) 
Seat 5: JFIAqU8lCZ0vWwEl4bdGsg ($25.80 in chips) 
Seat 6: x4ZJ8E/TUrtoB7WiHcv8WA ($18.05 in chips) 
y+a/yGW/Jy4bPJFnaeTz5w: posts small blind $0.10
MVzl6OsGybVDNd3Vr9LYAA: posts big blind $0.25
*** HOLE CARDS ***
JFIAqU8lCZ0vWwEl4bdGsg: raises $0.60 to $0.85
x4ZJ8E/TUrtoB7WiHcv8WA: calls $0.85
mfrkWA3PTeYPkbO6hi98Aw: folds 
y+a/yGW/Jy4bPJFnaeTz5w: folds 
MVzl6OsGybVDNd3Vr9LYAA: folds 
*** FLOP *** [7h 2c 3h]
JFIAqU8lCZ0vWwEl4bdGsg: bets $1.25
lRKJ8o/CnOPFwfHHm6ioMw has returned
x4ZJ8E/TUrtoB7WiHcv8WA: calls $1.25
*** TURN *** [7h 2c 3h] [7c]
JFIAqU8lCZ0vWwEl4bdGsg: checks 
x4ZJ8E/TUrtoB7WiHcv8WA: checks 
*** RIVER *** [7h 2c 3h 7c] [8c]
JFIAqU8lCZ0vWwEl4bdGsg: checks 
x4ZJ8E/TUrtoB7WiHcv8WA: bets $2
JFIAqU8lCZ0vWwEl4bdGsg: folds 
Uncalled bet ($2) returned to x4ZJ8E/TUrtoB7WiHcv8WA
x4ZJ8E/TUrtoB7WiHcv8WA collected $4.35 from pot
x4ZJ8E/TUrtoB7WiHcv8WA: doesn't show hand 
*** SUMMARY ***
Total pot $4.55 | Rake $0.20 
Board [7h 2c 3h 7c 8c]
Seat 1: mfrkWA3PTeYPkbO6hi98Aw (button) folded before Flop (didn't bet)
Seat 3: y+a/yGW/Jy4bPJFnaeTz5w (small blind) folded before Flop
Seat 4: MVzl6OsGybVDNd3Vr9LYAA (big blind) folded before Flop
Seat 5: JFIAqU8lCZ0vWwEl4bdGsg folded on the River
Seat 6: x4ZJ8E/TUrtoB7WiHcv8WA collected ($4.35)




PokerStars Game #59942004904:  Hold'em No Limit ($0.10/$0.25) - 2009/07/01 1:53:03 ET
Table 'yAHDCs33TIgw3ra63xuU2Q' 9-max Seat #2 is the button
Seat 1: Z9AeOQX3yzuSvKAm/xyovg ($8.60 in chips) 
Seat 2: j4q3p0lesp63b1gZDwLBZw ($5.25 in chips) 
Seat 4: j5spkbnOCRiLGiH6iqBaqw ($16.20 in chips) 
Seat 5: 4awUyiDYTgylQKXZ9faBVA ($36.25 in chips) 
Seat 6: UXvybU2w7Zc8RP8R+ngNeg ($9.75 in chips) 
j5spkbnOCRiLGiH6iqBaqw: posts small blind $0.10
4awUyiDYTgylQKXZ9faBVA: posts big blind $0.25
*** HOLE CARDS ***
UXvybU2w7Zc8RP8R+ngNeg: folds 
Z9AeOQX3yzuSvKAm/xyovg: folds 
j4q3p0lesp63b1gZDwLBZw: raises $0.75 to $1
Z9AeOQX3yzuSvKAm/xyovg is sitting out
j5spkbnOCRiLGiH6iqBaqw: calls $0.90
4awUyiDYTgylQKXZ9faBVA: folds 
*** FLOP *** [Jd 3c 8h]
j5spkbnOCRiLGiH6iqBaqw: checks 
j4q3p0lesp63b1gZDwLBZw: bets $1.50
j5spkbnOCRiLGiH6iqBaqw: folds 
Uncalled bet ($1.50) returned to j4q3p0lesp63b1gZDwLBZw
j4q3p0lesp63b1gZDwLBZw collected $2.15 from pot
j4q3p0lesp63b1gZDwLBZw: doesn't show hand 
*** SUMMARY ***
Total pot $2.25 | Rake $0.10 
Board [Jd 3c 8h]
Seat 1: Z9AeOQX3yzuSvKAm/xyovg folded before Flop (didn't bet)
Seat 2: j4q3p0lesp63b1gZDwLBZw (button) collected ($2.15)
Seat 4: j5spkbnOCRiLGiH6iqBaqw (small blind) folded on the Flop
Seat 5: 4awUyiDYTgylQKXZ9faBVA (big blind) folded before Flop
Seat 6: UXvybU2w7Zc8RP8R+ngNeg folded before Flop (didn't bet)




PokerStars Game #59942005192:  Hold'em No Limit ($0.10/$0.25) - 2009/07/01 1:53:04 ET
Table '/AhP8uWRzEEhOATYIdmn0A' 9-max Seat #6 is the button
Seat 1: +sbyWwIcFp9kP0bDtMegfQ ($37.45 in chips) 
Seat 3: jx6dnobNHstDG0tabsbKHQ ($6.65 in chips) 
Seat 4: +qc/EYCgLC65SpGvr35eNg ($24.75 in chips) 
Seat 5: iZ1f67Ok/207yzIQOu1Kdg ($4.65 in chips) 
Seat 6: 8EbrQ/EvFWt2cr0GaU82gQ ($4.65 in chips) 
Seat 7: cZ99hugmLBj9KhTlc8nCSw ($25 in chips) 
Seat 8: K86cg2ifCMFAlmzsfTDjig ($39.75 in chips) 
Seat 9: OfGfQFPcghysTDljS9GQSQ ($10.60 in chips) 
cZ99hugmLBj9KhTlc8nCSw: posts small blind $0.10
K86cg2ifCMFAlmzsfTDjig: posts big blind $0.25
DdPXdieucQ+n99u1n3A+rQ: sits out 
*** HOLE CARDS ***
OfGfQFPcghysTDljS9GQSQ: calls $0.25
+sbyWwIcFp9kP0bDtMegfQ: folds 
jx6dnobNHstDG0tabsbKHQ: folds 
+qc/EYCgLC65SpGvr35eNg: folds 
iZ1f67Ok/207yzIQOu1Kdg: folds 
8EbrQ/EvFWt2cr0GaU82gQ: folds 
cZ99hugmLBj9KhTlc8nCSw: folds 
K86cg2ifCMFAlmzsfTDjig: raises $0.25 to $0.50
OfGfQFPcghysTDljS9GQSQ: calls $0.25
*** FLOP *** [9s 4s 4d]
K86cg2ifCMFAlmzsfTDjig: checks 
OfGfQFPcghysTDljS9GQSQ: checks 
*** TURN *** [9s 4s 4d] [Jc]
K86cg2ifCMFAlmzsfTDjig: checks 
OfGfQFPcghysTDljS9GQSQ: bets $1
K86cg2ifCMFAlmzsfTDjig: calls $1
*** RIVER *** [9s 4s 4d Jc] [5s]
K86cg2ifCMFAlmzsfTDjig: bets $1
OfGfQFPcghysTDljS9GQSQ: calls $1
*** SHOW DOWN ***
K86cg2ifCMFAlmzsfTDjig: shows [7c 8c] (a pair of Fours)
OfGfQFPcghysTDljS9GQSQ: shows [Jh Ac] (two pair, Jacks and Fours)
OfGfQFPcghysTDljS9GQSQ collected $4.90 from pot
*** SUMMARY ***
Total pot $5.10 | Rake $0.20 
Board [9s 4s 4d Jc 5s]
Seat 1: +sbyWwIcFp9kP0bDtMegfQ folded before Flop (didn't bet)
Seat 3: jx6dnobNHstDG0tabsbKHQ folded before Flop (didn't bet)
Seat 4: +qc/EYCgLC65SpGvr35eNg folded before Flop (didn't bet)
Seat 5: iZ1f67Ok/207yzIQOu1Kdg folded before Flop (didn't bet)
Seat 6: 8EbrQ/EvFWt2cr0GaU82gQ (button) folded before Flop (didn't bet)
Seat 7: cZ99hugmLBj9KhTlc8nCSw (small blind) folded before Flop
Seat 8: K86cg2ifCMFAlmzsfTDjig (big blind) showed [7c 8c] and lost with a pair of Fours
Seat 9: OfGfQFPcghysTDljS9GQSQ showed [Jh Ac] and won ($4.90) with two pair, Jacks and Fours




PokerStars Game #59942005222:  Hold'em No Limit ($0.10/$0.25) - 2009/07/01 1:53:04 ET
Table '5SUMWYuPsGiOD0FY0QbgOw' 6-max Seat #5 is the button
Seat 2: xrf8tAXKQHG99HixCot1Iw ($40.60 in chips) 
Seat 3: i9LqF5rD3bvtbEE7HWgr3Q ($47.10 in chips) 
Seat 4: BV+K0Phf5VBHr7aZPKqbUQ ($26.10 in chips) 
Seat 5: v+QfkGiuj9bgtuNoVnDO8w ($40.10 in chips) 
Seat 6: /CiXFpjc64KAfloGDN7A/Q ($14.75 in chips) 
/CiXFpjc64KAfloGDN7A/Q: posts small blind $0.10
xrf8tAXKQHG99HixCot1Iw: posts big blind $0.25
*** HOLE CARDS ***
i9LqF5rD3bvtbEE7HWgr3Q: folds 
BV+K0Phf5VBHr7aZPKqbUQ: folds 
v+QfkGiuj9bgtuNoVnDO8w: folds 
/CiXFpjc64KAfloGDN7A/Q: calls $0.15
xrf8tAXKQHG99HixCot1Iw: checks 
*** FLOP *** [Qs Jh Qh]
/CiXFpjc64KAfloGDN7A/Q: checks 
xrf8tAXKQHG99HixCot1Iw: checks 
*** TURN *** [Qs Jh Qh] [7d]
/CiXFpjc64KAfloGDN7A/Q: checks 
xrf8tAXKQHG99HixCot1Iw: checks 
*** RIVER *** [Qs Jh Qh 7d] [6s]
/CiXFpjc64KAfloGDN7A/Q: checks 
v+QfkGiuj9bgtuNoVnDO8w is sitting out
xrf8tAXKQHG99HixCot1Iw: checks 
*** SHOW DOWN ***
/CiXFpjc64KAfloGDN7A/Q: shows [Td 7c] (two pair, Queens and Sevens)
xrf8tAXKQHG99HixCot1Iw: mucks hand 
/CiXFpjc64KAfloGDN7A/Q collected $0.50 from pot
*** SUMMARY ***
Total pot $0.50 | Rake $0 
Board [Qs Jh Qh 7d 6s]
Seat 2: xrf8tAXKQHG99HixCot1Iw (big blind) mucked
Seat 3: i9LqF5rD3bvtbEE7HWgr3Q folded before Flop (didn't bet)
Seat 4: BV+K0Phf5VBHr7aZPKqbUQ folded before Flop (didn't bet)
Seat 5: v+QfkGiuj9bgtuNoVnDO8w (button) folded before Flop (didn't bet)
Seat 6: /CiXFpjc64KAfloGDN7A/Q (small blind) showed [Td 7c] and won ($0.50) with two pair, Queens and Sevens




PokerStars Game #59942005272:  Hold'em No Limit ($0.10/$0.25) - 2009/07/01 1:53:04 ET
Table 'nyTW9cVtYentc5V7xU/0jA' 6-max Seat #3 is the button
Seat 1: HI20pVxSHPZ29u9IDkmICg ($8.05 in chips) 
Seat 2: opbAKk7WcZH8kDKUux3/0g ($4.50 in chips) 
Seat 3: kG34n23qFQA3nzdOJTQ1dA ($35.15 in chips) 
Seat 4: NkB3D4eVHHXvB9Edaugc1Q ($35.70 in chips) 
Seat 5: zZAcuQ0EvirdEuiIbeaocQ ($6.80 in chips) 
Seat 6: Cwf8Ho8JHNvwzsv9ah8uRQ ($18.15 in chips) 
NkB3D4eVHHXvB9Edaugc1Q: posts small blind $0.10
zZAcuQ0EvirdEuiIbeaocQ: posts big blind $0.25
*** HOLE CARDS ***
Cwf8Ho8JHNvwzsv9ah8uRQ: folds 
HI20pVxSHPZ29u9IDkmICg: calls $0.25
opbAKk7WcZH8kDKUux3/0g: folds 
kG34n23qFQA3nzdOJTQ1dA: folds 
NkB3D4eVHHXvB9Edaugc1Q: raises $0.50 to $0.75
zZAcuQ0EvirdEuiIbeaocQ: folds 
HI20pVxSHPZ29u9IDkmICg: calls $0.50
*** FLOP *** [Qc 6h Jh]
NkB3D4eVHHXvB9Edaugc1Q: bets $0.75
HI20pVxSHPZ29u9IDkmICg: folds 
Uncalled bet ($0.75) returned to NkB3D4eVHHXvB9Edaugc1Q
NkB3D4eVHHXvB9Edaugc1Q collected $1.70 from pot
NkB3D4eVHHXvB9Edaugc1Q: doesn't show hand 
*** SUMMARY ***
Total pot $1.75 | Rake $0.05 
Board [Qc 6h Jh]
Seat 1: HI20pVxSHPZ29u9IDkmICg folded on the Flop
Seat 2: opbAKk7WcZH8kDKUux3/0g folded before Flop (didn't bet)
Seat 3: kG34n23qFQA3nzdOJTQ1dA (button) folded before Flop (didn't bet)
Seat 4: NkB3D4eVHHXvB9Edaugc1Q (small blind) collected ($1.70)
Seat 5: zZAcuQ0EvirdEuiIbeaocQ (big blind) folded before Flop
Seat 6: Cwf8Ho8JHNvwzsv9ah8uRQ folded before Flop (didn't bet)




PokerStars Game #59942005590:  Hold'em No Limit ($0.10/$0.25) - 2009/07/01 1:53:04 ET
Table '/JJyyIstHfkT7t/bW+WXgg' 6-max Seat #5 is the button
Seat 1: xC0kaiDYM6YTlgODL83O5A ($14.50 in chips) 
Seat 2: obJgSnVgWWWaAUtVILo77Q ($29.20 in chips) 
Seat 3: DR0nVIhVP77oEBlO9J8vlg ($25.50 in chips) 
Seat 4: JFIAqU8lCZ0vWwEl4bdGsg ($35.30 in chips) 
Seat 5: +ZlnqPoP3Hg4BIUxDfKd/A ($46.45 in chips) 
Seat 6: UmcUp27+PbgBItv3ZNlAWQ ($25.60 in chips) 
UmcUp27+PbgBItv3ZNlAWQ: posts small blind $0.10
xC0kaiDYM6YTlgODL83O5A: posts big blind $0.25
*** HOLE CARDS ***
obJgSnVgWWWaAUtVILo77Q: raises $0.25 to $0.50
DR0nVIhVP77oEBlO9J8vlg: calls $0.50
JFIAqU8lCZ0vWwEl4bdGsg: folds 
+ZlnqPoP3Hg4BIUxDfKd/A: folds 
UmcUp27+PbgBItv3ZNlAWQ: folds 
xC0kaiDYM6YTlgODL83O5A: folds 
*** FLOP *** [9h Ts As]
obJgSnVgWWWaAUtVILo77Q: checks 
DR0nVIhVP77oEBlO9J8vlg: checks 
*** TURN *** [9h Ts As] [3c]
obJgSnVgWWWaAUtVILo77Q: bets $0.50
DR0nVIhVP77oEBlO9J8vlg: calls $0.50
*** RIVER *** [9h Ts As 3c] [5s]
obJgSnVgWWWaAUtVILo77Q: bets $1.75
DR0nVIhVP77oEBlO9J8vlg: calls $1.75
*** SHOW DOWN ***
obJgSnVgWWWaAUtVILo77Q: shows [Ah 5c] (two pair, Aces and Fives)
DR0nVIhVP77oEBlO9J8vlg: mucks hand 
obJgSnVgWWWaAUtVILo77Q collected $5.60 from pot
*** SUMMARY ***
Total pot $5.85 | Rake $0.25 
Board [9h Ts As 3c 5s]
Seat 1: xC0kaiDYM6YTlgODL83O5A (big blind) folded before Flop
Seat 2: obJgSnVgWWWaAUtVILo77Q showed [Ah 5c] and won ($5.60) with two pair, Aces and Fives
Seat 3: DR0nVIhVP77oEBlO9J8vlg mucked
Seat 4: JFIAqU8lCZ0vWwEl4bdGsg folded before Flop (didn't bet)
Seat 5: +ZlnqPoP3Hg4BIUxDfKd/A (button) folded before Flop (didn't bet)
Seat 6: UmcUp27+PbgBItv3ZNlAWQ (small blind) folded before Flop




PokerStars Game #59942005586:  Hold'em No Limit ($0.10/$0.25) - 2009/07/01 1:53:04 ET
Table 'APEHQjIcZHDZUA4iOjju2g' 6-max Seat #4 is the button
Seat 1: DE9hRlt14g+JdsRQ4wT7hg ($25 in chips) 
Seat 2: 3zD3qLXT1bEffAoWGnc7wg ($32.80 in chips) 
Seat 3: 3e/idKqDuPE10t6Zvr//SQ ($17.25 in chips) 
Seat 4: w2mQ4VsGljGwWXydz8tw2A ($37.85 in chips) 
Seat 5: /xN6gc9+8Hew0HxaB6VIVg ($45.40 in chips) 
Seat 6: KXtdqb+rIMkjc0RvHDksGQ ($42 in chips) 
/xN6gc9+8Hew0HxaB6VIVg: posts small blind $0.10
KXtdqb+rIMkjc0RvHDksGQ: posts big blind $0.25
*** HOLE CARDS ***
DE9hRlt14g+JdsRQ4wT7hg: folds 
3zD3qLXT1bEffAoWGnc7wg: folds 
3e/idKqDuPE10t6Zvr//SQ: folds 
w2mQ4VsGljGwWXydz8tw2A: folds 
/xN6gc9+8Hew0HxaB6VIVg: calls $0.15
KXtdqb+rIMkjc0RvHDksGQ: checks 
*** FLOP *** [9s Ad 6s]
/xN6gc9+8Hew0HxaB6VIVg: bets $0.50
KXtdqb+rIMkjc0RvHDksGQ: calls $0.50
*** TURN *** [9s Ad 6s] [6d]
/xN6gc9+8Hew0HxaB6VIVg: checks 
KXtdqb+rIMkjc0RvHDksGQ: checks 
*** RIVER *** [9s Ad 6s 6d] [4s]
/xN6gc9+8Hew0HxaB6VIVg: checks 
KXtdqb+rIMkjc0RvHDksGQ: checks 
*** SHOW DOWN ***
/xN6gc9+8Hew0HxaB6VIVg: shows [Kc Td] (a pair of Sixes)
KXtdqb+rIMkjc0RvHDksGQ: shows [9d 7h] (two pair, Nines and Sixes)
KXtdqb+rIMkjc0RvHDksGQ collected $1.45 from pot
*** SUMMARY ***
Total pot $1.50 | Rake $0.05 
Board [9s Ad 6s 6d 4s]
Seat 1: DE9hRlt14g+JdsRQ4wT7hg folded before Flop (didn't bet)
Seat 2: 3zD3qLXT1bEffAoWGnc7wg folded before Flop (didn't bet)
Seat 3: 3e/idKqDuPE10t6Zvr//SQ folded before Flop (didn't bet)
Seat 4: w2mQ4VsGljGwWXydz8tw2A (button) folded before Flop (didn't bet)
Seat 5: /xN6gc9+8Hew0HxaB6VIVg (small blind) showed [Kc Td] and lost with a pair of Sixes
Seat 6: KXtdqb+rIMkjc0RvHDksGQ (big blind) showed [9d 7h] and won ($1.45) with two pair, Nines and Sixes




PokerStars Game #59942005700:  Hold'em No Limit ($0.10/$0.25) - 2009/07/01 1:53:05 ET
Table 'O5NgMYt6EWbLBozZb3kseg' 6-max Seat #5 is the button
Seat 1: uS0JK3noJsnWbcX2Jtcj8A ($24.75 in chips) 
Seat 2: ZZm/rg8aThjE+A2LiItuzA ($12.05 in chips) 
Seat 3: 0bf6ZOD3FadOOzjtjXlcRQ ($10.30 in chips) 
Seat 4: ItRgvLhXTZHvtZowz+dbIw ($12.55 in chips) 
Seat 5: u3Ol7kv1LmvszuHNm9rc6w ($25.10 in chips) 
Seat 6: 3m6VfX7io8SA31qh1zCkgQ ($21.85 in chips) 
3m6VfX7io8SA31qh1zCkgQ: posts small blind $0.10
uS0JK3noJsnWbcX2Jtcj8A: posts big blind $0.25
*** HOLE CARDS ***
ZZm/rg8aThjE+A2LiItuzA: calls $0.25
0bf6ZOD3FadOOzjtjXlcRQ: folds 
ItRgvLhXTZHvtZowz+dbIw: calls $0.25
0bf6ZOD3FadOOzjtjXlcRQ leaves the table
u3Ol7kv1LmvszuHNm9rc6w: folds 
ErIN0JRL5srYjT6en1f8YQ joins the table at seat #3 
3m6VfX7io8SA31qh1zCkgQ: calls $0.15
uS0JK3noJsnWbcX2Jtcj8A: checks 
*** FLOP *** [8h 6h 5s]
3m6VfX7io8SA31qh1zCkgQ: checks 
uS0JK3noJsnWbcX2Jtcj8A: bets $0.75
ZZm/rg8aThjE+A2LiItuzA: calls $0.75
ItRgvLhXTZHvtZowz+dbIw: calls $0.75
3m6VfX7io8SA31qh1zCkgQ: calls $0.75
*** TURN *** [8h 6h 5s] [Kd]
3m6VfX7io8SA31qh1zCkgQ: checks 
uS0JK3noJsnWbcX2Jtcj8A: bets $2
ZZm/rg8aThjE+A2LiItuzA: folds 
ItRgvLhXTZHvtZowz+dbIw: folds 
3m6VfX7io8SA31qh1zCkgQ: raises $2 to $4
uS0JK3noJsnWbcX2Jtcj8A: calls $2
*** RIVER *** [8h 6h 5s Kd] [4d]
3m6VfX7io8SA31qh1zCkgQ: bets $10.25
uS0JK3noJsnWbcX2Jtcj8A: raises $9.50 to $19.75 and is all-in
3m6VfX7io8SA31qh1zCkgQ: folds 
Uncalled bet ($9.50) returned to uS0JK3noJsnWbcX2Jtcj8A
uS0JK3noJsnWbcX2Jtcj8A collected $30.95 from pot
uS0JK3noJsnWbcX2Jtcj8A: shows [7c 6d] (a straight, Four to Eight)
*** SUMMARY ***
Total pot $32.50 | Rake $1.55 
Board [8h 6h 5s Kd 4d]
Seat 1: uS0JK3noJsnWbcX2Jtcj8A (big blind) collected ($30.95)
Seat 2: ZZm/rg8aThjE+A2LiItuzA folded on the Turn
Seat 3: 0bf6ZOD3FadOOzjtjXlcRQ folded before Flop (didn't bet)
Seat 4: ItRgvLhXTZHvtZowz+dbIw folded on the Turn
Seat 5: u3Ol7kv1LmvszuHNm9rc6w (button) folded before Flop (didn't bet)
Seat 6: 3m6VfX7io8SA31qh1zCkgQ (small blind) folded on the River




PokerStars Game #59942006124:  Hold'em No Limit ($0.10/$0.25) - 2009/07/01 1:53:05 ET
Table 'SHi8+hK6i7E2dJ/3Agbyig' 6-max Seat #5 is the button
Seat 1: gPEN9Zp33YTm/mu9/SYP1w ($18.05 in chips) 
Seat 2: LJI7A1YgDM7hgh7o56+ReQ ($25 in chips) 
Seat 3: VXTONriS+Ohik+r0FeicIw ($25 in chips) 
Seat 4: u0ikXOhAPSCLmg+l17oGRw ($21.85 in chips) 
Seat 5: v8m8XHovI5tqEA9mvplDSw ($56.60 in chips) 
Seat 6: cWc85bEzdRzpUMhRKm8pwQ ($34.60 in chips) 
cWc85bEzdRzpUMhRKm8pwQ: posts small blind $0.10
gPEN9Zp33YTm/mu9/SYP1w: posts big blind $0.25
*** HOLE CARDS ***
LJI7A1YgDM7hgh7o56+ReQ: folds 
VXTONriS+Ohik+r0FeicIw: raises $0.75 to $1
u0ikXOhAPSCLmg+l17oGRw: calls $1
v8m8XHovI5tqEA9mvplDSw: folds 
cWc85bEzdRzpUMhRKm8pwQ: folds 
gPEN9Zp33YTm/mu9/SYP1w: folds 
*** FLOP *** [Jc Kd Kc]
VXTONriS+Ohik+r0FeicIw: bets $1.50
u0ikXOhAPSCLmg+l17oGRw: folds 
Uncalled bet ($1.50) returned to VXTONriS+Ohik+r0FeicIw
VXTONriS+Ohik+r0FeicIw collected $2.25 from pot
VXTONriS+Ohik+r0FeicIw: doesn't show hand 
*** SUMMARY ***
Total pot $2.35 | Rake $0.10 
Board [Jc Kd Kc]
Seat 1: gPEN9Zp33YTm/mu9/SYP1w (big blind) folded before Flop
Seat 2: LJI7A1YgDM7hgh7o56+ReQ folded before Flop (didn't bet)
Seat 3: VXTONriS+Ohik+r0FeicIw collected ($2.25)
Seat 4: u0ikXOhAPSCLmg+l17oGRw folded on the Flop
Seat 5: v8m8XHovI5tqEA9mvplDSw (button) folded before Flop (didn't bet)
Seat 6: cWc85bEzdRzpUMhRKm8pwQ (small blind) folded before Flop




PokerStars Game #59942006040:  Hold'em No Limit ($0.10/$0.25) - 2009/07/01 1:53:05 ET
Table 'ORSZkZqq+7Ja2PdeCFAytA' 9-max Seat #4 is the button
Seat 1: 3FkcXBaxKqxYVagfYUZlmw ($26.50 in chips) 
Seat 3: s9a4d23HFxaL70yUWQ0/tQ ($18.85 in chips) 
Seat 4: tbgfV2Egwn85xEt865GWQQ ($11.80 in chips) 
Seat 5: +lWbsq4dTcA70SX/+hnmpg ($9.55 in chips) 
Seat 6: cZ99hugmLBj9KhTlc8nCSw ($25 in chips) 
Seat 7: clJsV3v77RS07bDKY+705w ($10.80 in chips) 
Seat 9: cMTFs4oCtNInkpDIecxT/w ($10.70 in chips) 
+lWbsq4dTcA70SX/+hnmpg: posts small blind $0.10
cZ99hugmLBj9KhTlc8nCSw: posts big blind $0.25
ydoFOVgzvZv9ZhuWu9rXAw: sits out 
*** HOLE CARDS ***
clJsV3v77RS07bDKY+705w: folds 
cMTFs4oCtNInkpDIecxT/w: folds 
3FkcXBaxKqxYVagfYUZlmw: folds 
s9a4d23HFxaL70yUWQ0/tQ: calls $0.25
tbgfV2Egwn85xEt865GWQQ: folds 
+lWbsq4dTcA70SX/+hnmpg: calls $0.15
cZ99hugmLBj9KhTlc8nCSw: checks 
*** FLOP *** [8s Ts Kc]
clJsV3v77RS07bDKY+705w leaves the table
+lWbsq4dTcA70SX/+hnmpg: checks 
cZ99hugmLBj9KhTlc8nCSw: checks 
s9a4d23HFxaL70yUWQ0/tQ: bets $0.50
+lWbsq4dTcA70SX/+hnmpg: folds 
cZ99hugmLBj9KhTlc8nCSw: folds 
Uncalled bet ($0.50) returned to s9a4d23HFxaL70yUWQ0/tQ
s9a4d23HFxaL70yUWQ0/tQ collected $0.75 from pot
s9a4d23HFxaL70yUWQ0/tQ: doesn't show hand 
*** SUMMARY ***
Total pot $0.75 | Rake $0 
Board [8s Ts Kc]
Seat 1: 3FkcXBaxKqxYVagfYUZlmw folded before Flop (didn't bet)
Seat 3: s9a4d23HFxaL70yUWQ0/tQ collected ($0.75)
Seat 4: tbgfV2Egwn85xEt865GWQQ (button) folded before Flop (didn't bet)
Seat 5: +lWbsq4dTcA70SX/+hnmpg (small blind) folded on the Flop
Seat 6: cZ99hugmLBj9KhTlc8nCSw (big blind) folded on the Flop
Seat 7: clJsV3v77RS07bDKY+705w folded before Flop (didn't bet)
Seat 9: cMTFs4oCtNInkpDIecxT/w folded before Flop (didn't bet)




PokerStars Game #59942006136:  Hold'em No Limit ($0.10/$0.25) - 2009/07/01 1:53:05 ET
Table 'FuFyQHmlO/QqQp//rDRrPg' 6-max Seat #1 is the button
Seat 1: jp34e617tIzV8tKIWmfAbA ($43.70 in chips) 
Seat 2: G3h3THGB1j3qdHDVHpnJWg ($34.45 in chips) 
Seat 3: EeUZtMU058v2ObUACOF4Og ($25 in chips) 
Seat 5: xrf8tAXKQHG99HixCot1Iw ($25.55 in chips) 
Seat 6: 6DwBRH+xZ12AAZmeAg+aXw ($59.05 in chips) 
G3h3THGB1j3qdHDVHpnJWg: posts small blind $0.10
EeUZtMU058v2ObUACOF4Og: posts big blind $0.25
VXTONriS+Ohik+r0FeicIw: sits out 
*** HOLE CARDS ***
xrf8tAXKQHG99HixCot1Iw: folds 
6DwBRH+xZ12AAZmeAg+aXw: raises $0.50 to $0.75
jp34e617tIzV8tKIWmfAbA: folds 
G3h3THGB1j3qdHDVHpnJWg: folds 
EeUZtMU058v2ObUACOF4Og: folds 
Uncalled bet ($0.50) returned to 6DwBRH+xZ12AAZmeAg+aXw
6DwBRH+xZ12AAZmeAg+aXw collected $0.60 from pot
6DwBRH+xZ12AAZmeAg+aXw: doesn't show hand 
*** SUMMARY ***
Total pot $0.60 | Rake $0 
Seat 1: jp34e617tIzV8tKIWmfAbA (button) folded before Flop (didn't bet)
Seat 2: G3h3THGB1j3qdHDVHpnJWg (small blind) folded before Flop
Seat 3: EeUZtMU058v2ObUACOF4Og (big blind) folded before Flop
Seat 5: xrf8tAXKQHG99HixCot1Iw folded before Flop (didn't bet)
Seat 6: 6DwBRH+xZ12AAZmeAg+aXw collected ($0.60)




PokerStars Game #59942005990:  Hold'em No Limit ($0.10/$0.25) - 2009/07/01 1:53:05 ET
Table 'ukli1Y7ieC5JQMTEFxM2Nw' 6-max Seat #5 is the button
Seat 1: ukgMpMoFTQKuBqKbuPdCgg ($10.25 in chips) 
Seat 3: ExeoJ1G/rSmWa3tRz7TlCA ($24.50 in chips) 
Seat 4: if4dh6jhJXeN3/qd3qCp9g ($26.40 in chips) 
Seat 5: Se+H4Z4PDr6+eIUDJX1rpg ($18.60 in chips) 
Seat 6: 32YL2ZEp8NT4JB2RVM9euQ ($32.25 in chips) 
32YL2ZEp8NT4JB2RVM9euQ: posts small blind $0.10
ukgMpMoFTQKuBqKbuPdCgg: posts big blind $0.25
i9LqF5rD3bvtbEE7HWgr3Q: sits out 
*** HOLE CARDS ***
ExeoJ1G/rSmWa3tRz7TlCA: folds 
if4dh6jhJXeN3/qd3qCp9g: folds 
Se+H4Z4PDr6+eIUDJX1rpg: folds 
32YL2ZEp8NT4JB2RVM9euQ: calls $0.15
ukgMpMoFTQKuBqKbuPdCgg: checks 
*** FLOP *** [3c 9d 5d]
32YL2ZEp8NT4JB2RVM9euQ: checks 
ukgMpMoFTQKuBqKbuPdCgg: bets $1.25
32YL2ZEp8NT4JB2RVM9euQ: folds 
Uncalled bet ($1.25) returned to ukgMpMoFTQKuBqKbuPdCgg
ukgMpMoFTQKuBqKbuPdCgg collected $0.50 from pot
ukgMpMoFTQKuBqKbuPdCgg: doesn't show hand 
*** SUMMARY ***
Total pot $0.50 | Rake $0 
Board [3c 9d 5d]
Seat 1: ukgMpMoFTQKuBqKbuPdCgg (big blind) collected ($0.50)
Seat 3: ExeoJ1G/rSmWa3tRz7TlCA folded before Flop (didn't bet)
Seat 4: if4dh6jhJXeN3/qd3qCp9g folded before Flop (didn't bet)
Seat 5: Se+H4Z4PDr6+eIUDJX1rpg (button) folded before Flop (didn't bet)
Seat 6: 32YL2ZEp8NT4JB2RVM9euQ (small blind) folded on the Flop




PokerStars Game #59942005648:  Hold'em No Limit ($0.10/$0.25) - 2009/07/01 1:53:05 ET
Table 'VuY5ej47Cy8nOI3Wogmhzw' 6-max Seat #3 is the button
Seat 1: EeUZtMU058v2ObUACOF4Og ($29.15 in chips) 
Seat 3: v+QfkGiuj9bgtuNoVnDO8w ($41.70 in chips) 
Seat 4: QqiZLFrN8iOUT/GHw7ztOA ($45.15 in chips) 
Seat 5: m2yWOKfAxqHoy5DDN87Ttw ($25.35 in chips) 
Seat 6: +KblIivb6tainScpwm14RQ ($10.60 in chips) 
QqiZLFrN8iOUT/GHw7ztOA: posts small blind $0.10
m2yWOKfAxqHoy5DDN87Ttw: posts big blind $0.25
*** HOLE CARDS ***
+KblIivb6tainScpwm14RQ: calls $0.25
EeUZtMU058v2ObUACOF4Og: folds 
v+QfkGiuj9bgtuNoVnDO8w: folds 
QqiZLFrN8iOUT/GHw7ztOA: folds 
m2yWOKfAxqHoy5DDN87Ttw: checks 
*** FLOP *** [5s Ac 2h]
m2yWOKfAxqHoy5DDN87Ttw: checks 
+KblIivb6tainScpwm14RQ: checks 
*** TURN *** [5s Ac 2h] [Td]
m2yWOKfAxqHoy5DDN87Ttw: checks 
+KblIivb6tainScpwm14RQ: bets $0.25
m2yWOKfAxqHoy5DDN87Ttw: folds 
Uncalled bet ($0.25) returned to +KblIivb6tainScpwm14RQ
+KblIivb6tainScpwm14RQ collected $0.60 from pot
*** SUMMARY ***
Total pot $0.60 | Rake $0 
Board [5s Ac 2h Td]
Seat 1: EeUZtMU058v2ObUACOF4Og folded before Flop (didn't bet)
Seat 3: v+QfkGiuj9bgtuNoVnDO8w (button) folded before Flop (didn't bet)
Seat 4: QqiZLFrN8iOUT/GHw7ztOA (small blind) folded before Flop
Seat 5: m2yWOKfAxqHoy5DDN87Ttw (big blind) folded on the Turn
Seat 6: +KblIivb6tainScpwm14RQ collected ($0.60)




PokerStars Game #59942005690:  Hold'em No Limit ($0.10/$0.25) - 2009/07/01 1:53:05 ET
Table 'hg+KpirwreMnBAFQr/SEUA' 9-max Seat #3 is the button
Seat 1: H5Se03ZqSX7tbULXur2MAg ($35.80 in chips) 
Seat 2: cpnBzHjFACn5zAY56UIvNA ($20.25 in chips) 
Seat 3: DdyXKuBx0HAOC7dWZmGxWg ($23.15 in chips) 
Seat 4: Z9W7+g1WMhhZDi7DwGbCFA ($5 in chips) 
Seat 5: +2kMBNpY4nF1qNCRd8SJLA ($25 in chips) 
Seat 6: Bb42QRQMhg5/Y0vHP8/2Xw ($25 in chips) 
Seat 7: 5LSuZS4qvcUri/Byfkln7w ($6.50 in chips) 
Seat 8: HPEB+AtKw1+C/cxU0o1ciw ($22.15 in chips) 
Seat 9: xbecloQJYmBOSkzT9lZ+rg ($22.45 in chips) 
Z9W7+g1WMhhZDi7DwGbCFA: posts small blind $0.10
+2kMBNpY4nF1qNCRd8SJLA: posts big blind $0.25
*** HOLE CARDS ***
Bb42QRQMhg5/Y0vHP8/2Xw: folds 
5LSuZS4qvcUri/Byfkln7w: calls $0.25
HPEB+AtKw1+C/cxU0o1ciw: folds 
xbecloQJYmBOSkzT9lZ+rg: raises $0.50 to $0.75
H5Se03ZqSX7tbULXur2MAg: calls $0.75
cpnBzHjFACn5zAY56UIvNA: folds 
DdyXKuBx0HAOC7dWZmGxWg: folds 
Z9W7+g1WMhhZDi7DwGbCFA: folds 
+2kMBNpY4nF1qNCRd8SJLA: folds 
5LSuZS4qvcUri/Byfkln7w: calls $0.50
*** FLOP *** [5h 2d Qc]
5LSuZS4qvcUri/Byfkln7w: checks 
xbecloQJYmBOSkzT9lZ+rg: checks 
H5Se03ZqSX7tbULXur2MAg: bets $1.50
5LSuZS4qvcUri/Byfkln7w: folds 
xbecloQJYmBOSkzT9lZ+rg: calls $1.50
*** TURN *** [5h 2d Qc] [9h]
xbecloQJYmBOSkzT9lZ+rg: checks 
H5Se03ZqSX7tbULXur2MAg: bets $2.75
xbecloQJYmBOSkzT9lZ+rg: folds 
Uncalled bet ($2.75) returned to H5Se03ZqSX7tbULXur2MAg
H5Se03ZqSX7tbULXur2MAg collected $5.35 from pot
*** SUMMARY ***
Total pot $5.60 | Rake $0.25 
Board [5h 2d Qc 9h]
Seat 1: H5Se03ZqSX7tbULXur2MAg collected ($5.35)
Seat 2: cpnBzHjFACn5zAY56UIvNA folded before Flop (didn't bet)
Seat 3: DdyXKuBx0HAOC7dWZmGxWg (button) folded before Flop (didn't bet)
Seat 4: Z9W7+g1WMhhZDi7DwGbCFA (small blind) folded before Flop
Seat 5: +2kMBNpY4nF1qNCRd8SJLA (big blind) folded before Flop
Seat 6: Bb42QRQMhg5/Y0vHP8/2Xw folded before Flop (didn't bet)
Seat 7: 5LSuZS4qvcUri/Byfkln7w folded on the Flop
Seat 8: HPEB+AtKw1+C/cxU0o1ciw folded before Flop (didn't bet)
Seat 9: xbecloQJYmBOSkzT9lZ+rg folded on the Turn




PokerStars Game #59942006018:  Hold'em No Limit ($0.10/$0.25) - 2009/07/01 1:53:05 ET
Table 'QvLFJzpzymuOsaaRYi+8fgWEMI3Mtn7dGARDbgNrKibgx Seat #1 is the button
Seat 1: cZ99hugmLBj9KhTlc8nCSw ($26.70 in chips) 
Seat 2: PdIasPkzm2sqZnN41ZRXOg ($5.10 in chips) 
Seat 3: Qduu7ikeizo6q6Ei9YvcJA ($25 in chips) 
Seat 4: tLcDklc2rBORNfixyRfVfw ($25.25 in chips) 
Seat 5: MG90wfSJZnOejs/KD3vlQQ ($37.45 in chips) 
Seat 6: vKdukiQ4ktU4yJ0Xx3MKnA ($7.10 in chips) 
Seat 7: rQhYIYXSyH/IivYM1dlV5A ($11.80 in chips) 
Seat 8: gehe91e0IyVT0QU/XBkEyg ($27 in chips) 
Seat 9: BWzInv8o0kN1pJybv/VjpQ ($43.80 in chips) 
PdIasPkzm2sqZnN41ZRXOg: posts small blind $0.10
Qduu7ikeizo6q6Ei9YvcJA: posts big blind $0.25
*** HOLE CARDS ***
tLcDklc2rBORNfixyRfVfw: folds 
MG90wfSJZnOejs/KD3vlQQ: folds 
vKdukiQ4ktU4yJ0Xx3MKnA: folds 
rQhYIYXSyH/IivYM1dlV5A: folds 
gehe91e0IyVT0QU/XBkEyg: folds 
BWzInv8o0kN1pJybv/VjpQ: folds 
cZ99hugmLBj9KhTlc8nCSw: raises $0.50 to $0.75
PdIasPkzm2sqZnN41ZRXOg: folds 
Qduu7ikeizo6q6Ei9YvcJA: calls $0.50
*** FLOP *** [2s Ad 9h]
Qduu7ikeizo6q6Ei9YvcJA: checks 
cZ99hugmLBj9KhTlc8nCSw: bets $1
Qduu7ikeizo6q6Ei9YvcJA: calls $1
*** TURN *** [2s Ad 9h] [5c]
Qduu7ikeizo6q6Ei9YvcJA: checks 
cZ99hugmLBj9KhTlc8nCSw: checks 
*** RIVER *** [2s Ad 9h 5c] [8h]
Qduu7ikeizo6q6Ei9YvcJA: bets $1.75
cZ99hugmLBj9KhTlc8nCSw: folds 
Uncalled bet ($1.75) returned to Qduu7ikeizo6q6Ei9YvcJA
Qduu7ikeizo6q6Ei9YvcJA collected $3.45 from pot
Qduu7ikeizo6q6Ei9YvcJA: doesn't show hand 
*** SUMMARY ***
Total pot $3.60 | Rake $0.15 
Board [2s Ad 9h 5c 8h]
Seat 1: cZ99hugmLBj9KhTlc8nCSw (button) folded on the River
Seat 2: PdIasPkzm2sqZnN41ZRXOg (small blind) folded before Flop
Seat 3: Qduu7ikeizo6q6Ei9YvcJA (big blind) collected ($3.45)
Seat 4: tLcDklc2rBORNfixyRfVfw folded before Flop (didn't bet)
Seat 5: MG90wfSJZnOejs/KD3vlQQ folded before Flop (didn't bet)
Seat 6: vKdukiQ4ktU4yJ0Xx3MKnA folded before Flop (didn't bet)
Seat 7: rQhYIYXSyH/IivYM1dlV5A folded before Flop (didn't bet)
Seat 8: gehe91e0IyVT0QU/XBkEyg folded before Flop (didn't bet)
Seat 9: BWzInv8o0kN1pJybv/VjpQ folded before Flop (didn't bet)




PokerStars Game #59942006300:  Hold'em No Limit ($0.10/$0.25) - 2009/07/01 1:53:06 ET
Table 'WjNvuuSgTjm8jh0j9vcCgQ' 9-max Seat #6 is the button
Seat 1: q+Qdg0Hoir+SyL7haBrUnw ($7.70 in chips) 
Seat 2: ghNKXUBl/H+t83JF079ZBA ($24.90 in chips) 
Seat 3: pSKReiGBNW9NsF2jAZnlwg ($20.15 in chips) 
Seat 4: X78b5v/uhqeXXoAijbw/yg ($31 in chips) 
Seat 5: ziFpkH3wCzqB/qXeq/Hy7g ($26.35 in chips) 
Seat 6: ubsjZomMWSV0hAiBLa7K1A ($21.95 in chips) 
Seat 7: NSX8YOj+RznxoL+rO1YU4w ($18.15 in chips) 
Seat 8: clJsV3v77RS07bDKY+705w ($5 in chips) 
Seat 9: CT7Xj/V/O5rBlhtt+RZeFQ ($25.25 in chips) 
NSX8YOj+RznxoL+rO1YU4w: posts small blind $0.10
clJsV3v77RS07bDKY+705w: posts big blind $0.25
*** HOLE CARDS ***
CT7Xj/V/O5rBlhtt+RZeFQ: folds 
q+Qdg0Hoir+SyL7haBrUnw: folds 
ghNKXUBl/H+t83JF079ZBA: folds 
pSKReiGBNW9NsF2jAZnlwg: calls $0.25
X78b5v/uhqeXXoAijbw/yg: folds 
ziFpkH3wCzqB/qXeq/Hy7g: folds 
ubsjZomMWSV0hAiBLa7K1A: calls $0.25
NSX8YOj+RznxoL+rO1YU4w: folds 
clJsV3v77RS07bDKY+705w: checks 
*** FLOP *** [Ks Qh 2s]
clJsV3v77RS07bDKY+705w: checks 
pSKReiGBNW9NsF2jAZnlwg: checks 
ubsjZomMWSV0hAiBLa7K1A: checks 
*** TURN *** [Ks Qh 2s] [3h]
clJsV3v77RS07bDKY+705w: checks 
pSKReiGBNW9NsF2jAZnlwg: bets $0.50
ubsjZomMWSV0hAiBLa7K1A: folds 
clJsV3v77RS07bDKY+705w: calls $0.50
*** RIVER *** [Ks Qh 2s 3h] [Ah]
clJsV3v77RS07bDKY+705w: checks 
pSKReiGBNW9NsF2jAZnlwg: checks 
*** SHOW DOWN ***
clJsV3v77RS07bDKY+705w: shows [9s 7s] (high card Ace)
pSKReiGBNW9NsF2jAZnlwg: shows [Kd 4d] (a pair of Kings)
pSKReiGBNW9NsF2jAZnlwg collected $1.80 from pot
*** SUMMARY ***
Total pot $1.85 | Rake $0.05 
Board [Ks Qh 2s 3h Ah]
Seat 1: q+Qdg0Hoir+SyL7haBrUnw folded before Flop (didn't bet)
Seat 2: ghNKXUBl/H+t83JF079ZBA folded before Flop (didn't bet)
Seat 3: pSKReiGBNW9NsF2jAZnlwg showed [Kd 4d] and won ($1.80) with a pair of Kings
Seat 4: X78b5v/uhqeXXoAijbw/yg folded before Flop (didn't bet)
Seat 5: ziFpkH3wCzqB/qXeq/Hy7g folded before Flop (didn't bet)
Seat 6: ubsjZomMWSV0hAiBLa7K1A (button) folded on the Turn
Seat 7: NSX8YOj+RznxoL+rO1YU4w (small blind) folded before Flop
Seat 8: clJsV3v77RS07bDKY+705w (big blind) showed [9s 7s] and lost with high card Ace
Seat 9: CT7Xj/V/O5rBlhtt+RZeFQ folded before Flop (didn't bet)




PokerStars Game #59942006536:  Hold'em No Limit ($0.10/$0.25) - 2009/07/01 1:53:06 ET
Table 'jxoHy9yJy0bbH/Qx73FoPA' 9-max Seat #5 is the button
Seat 2: Nh/g25nULd6c6RoEAeukGg ($5 in chips) 
Seat 3: CVqCt93Mk0MhKMaZ4LZDSQ ($2.45 in chips) 
Seat 4: bXpVeaSTPBFSPJmeXxO7nw ($9 in chips) 
Seat 5: 0rQnT3MwKEGi6YXD9FufJw ($4.65 in chips) 
Seat 6: Z9AeOQX3yzuSvKAm/xyovg ($9.85 in chips) 
Seat 7: wGigCmBR/9XWkPpvYos3aQ ($26.40 in chips) 
Seat 8: Z9W7+g1WMhhZDi7DwGbCFA ($5 in chips) 
Seat 9: CvL9Ch1HYCVbTsfpNucitg ($5 in chips) 
Z9AeOQX3yzuSvKAm/xyovg: posts small blind $0.10
wGigCmBR/9XWkPpvYos3aQ: posts big blind $0.25
Concertfreak: sits out 
Nh/g25nULd6c6RoEAeukGg: posts big blind $0.25
*** HOLE CARDS ***
Z9W7+g1WMhhZDi7DwGbCFA: folds 
CvL9Ch1HYCVbTsfpNucitg: folds 
Nh/g25nULd6c6RoEAeukGg: checks 
CVqCt93Mk0MhKMaZ4LZDSQ: folds 
bXpVeaSTPBFSPJmeXxO7nw: folds 
0rQnT3MwKEGi6YXD9FufJw: folds 
Z9AeOQX3yzuSvKAm/xyovg: folds 
wGigCmBR/9XWkPpvYos3aQ: checks 
*** FLOP *** [9h Td 8c]
wGigCmBR/9XWkPpvYos3aQ: checks 
Nh/g25nULd6c6RoEAeukGg: bets $0.25
wGigCmBR/9XWkPpvYos3aQ: folds 
Uncalled bet ($0.25) returned to Nh/g25nULd6c6RoEAeukGg
Nh/g25nULd6c6RoEAeukGg collected $0.60 from pot
Nh/g25nULd6c6RoEAeukGg: doesn't show hand 
*** SUMMARY ***
Total pot $0.60 | Rake $0 
Board [9h Td 8c]
Seat 2: Nh/g25nULd6c6RoEAeukGg collected ($0.60)
Seat 3: CVqCt93Mk0MhKMaZ4LZDSQ folded before Flop (didn't bet)
Seat 4: bXpVeaSTPBFSPJmeXxO7nw folded before Flop (didn't bet)
Seat 5: 0rQnT3MwKEGi6YXD9FufJw (button) folded before Flop (didn't bet)
Seat 6: Z9AeOQX3yzuSvKAm/xyovg (small blind) folded before Flop
Seat 7: wGigCmBR/9XWkPpvYos3aQ (big blind) folded on the Flop
Seat 8: Z9W7+g1WMhhZDi7DwGbCFA folded before Flop (didn't bet)
Seat 9: CvL9Ch1HYCVbTsfpNucitg folded before Flop (didn't bet)




PokerStars Game #59942006930:  Hold'em No Limit ($0.10/$0.25) - 2009/07/01 1:53:07 ET
Table 'sCop8wmj9zlSS2KJqk1QKQ' 9-max Seat #7 is the button
Seat 1: dtZ84flFEi4Q+SGrHMJRDQ ($39.85 in chips) 
Seat 2: YZaC69gFrepA6oCGtu7E0w ($43.05 in chips) 
Seat 3: M/9j4wkHH9i1JM51vgi1VA ($24.40 in chips) 
Seat 4: msUzkZl2RntUnTl6E8WaNA ($15.30 in chips) 
Seat 6: 6RiVTYll/5D8zICp0MRpKw ($23.75 in chips) 
Seat 7: 18G4P1XstjNvItdGUITxgw ($25.90 in chips) 
Seat 8: xnVwSkROfRtOw4eSoDANtw ($19.30 in chips) 
Seat 9: tLcDklc2rBORNfixyRfVfw ($25 in chips) 
xnVwSkROfRtOw4eSoDANtw: posts small blind $0.10
tLcDklc2rBORNfixyRfVfw: posts big blind $0.25
CvL9Ch1HYCVbTsfpNucitg: sits out 
*** HOLE CARDS ***
dtZ84flFEi4Q+SGrHMJRDQ: folds 
YZaC69gFrepA6oCGtu7E0w: folds 
M/9j4wkHH9i1JM51vgi1VA: folds 
msUzkZl2RntUnTl6E8WaNA: calls $0.25
6RiVTYll/5D8zICp0MRpKw: folds 
18G4P1XstjNvItdGUITxgw: folds 
xnVwSkROfRtOw4eSoDANtw: calls $0.15
tLcDklc2rBORNfixyRfVfw: raises $1.25 to $1.50
msUzkZl2RntUnTl6E8WaNA: folds 
xnVwSkROfRtOw4eSoDANtw: folds 
Uncalled bet ($1.25) returned to tLcDklc2rBORNfixyRfVfw
tLcDklc2rBORNfixyRfVfw collected $0.75 from pot
tLcDklc2rBORNfixyRfVfw: doesn't show hand 
*** SUMMARY ***
Total pot $0.75 | Rake $0 
Seat 1: dtZ84flFEi4Q+SGrHMJRDQ folded before Flop (didn't bet)
Seat 2: YZaC69gFrepA6oCGtu7E0w folded before Flop (didn't bet)
Seat 3: M/9j4wkHH9i1JM51vgi1VA folded before Flop (didn't bet)
Seat 4: msUzkZl2RntUnTl6E8WaNA folded before Flop
Seat 6: 6RiVTYll/5D8zICp0MRpKw folded before Flop (didn't bet)
Seat 7: 18G4P1XstjNvItdGUITxgw (button) folded before Flop (didn't bet)
Seat 8: xnVwSkROfRtOw4eSoDANtw (small blind) folded before Flop
Seat 9: tLcDklc2rBORNfixyRfVfw (big blind) collected ($0.75)




PokerStars Game #59942006798:  Hold'em No Limit ($0.10/$0.25) - 2009/07/01 1:53:07 ET
Table 'BpNkESDX1ip9c0K1hb5h7A' 6-max Seat #2 is the button
Seat 2: 9U3ZKjCsarN0DjR6mSE8Ug ($30.35 in chips) 
Seat 3: fZQg9veL7Dd/Z04ZTjC+wQ ($32.40 in chips) 
Seat 4: kG34n23qFQA3nzdOJTQ1dA ($26.50 in chips) 
Seat 6: 8EEqTTh7T1q48sYDqbI2Xg ($21.80 in chips) 
fZQg9veL7Dd/Z04ZTjC+wQ: posts small blind $0.10
kG34n23qFQA3nzdOJTQ1dA: posts big blind $0.25
*** HOLE CARDS ***
8EEqTTh7T1q48sYDqbI2Xg: folds 
OMGl+YMGogf2JWIRfT2/Yg has returned
9U3ZKjCsarN0DjR6mSE8Ug: folds 
fZQg9veL7Dd/Z04ZTjC+wQ: folds 
Uncalled bet ($0.15) returned to kG34n23qFQA3nzdOJTQ1dA
kG34n23qFQA3nzdOJTQ1dA collected $0.20 from pot
*** SUMMARY ***
Total pot $0.20 | Rake $0 
Seat 2: 9U3ZKjCsarN0DjR6mSE8Ug (button) folded before Flop (didn't bet)
Seat 3: fZQg9veL7Dd/Z04ZTjC+wQ (small blind) folded before Flop
Seat 4: kG34n23qFQA3nzdOJTQ1dA (big blind) collected ($0.20)
Seat 6: 8EEqTTh7T1q48sYDqbI2Xg folded before Flop (didn't bet)




PokerStars Game #59942006744:  Hold'em No Limit ($0.10/$0.25) - 2009/07/01 1:53:07 ET
Table 'pPgW4R3kdH26lLi1MnE92w' 9-max Seat #9 is the button
Seat 1: F4P6SxCNY4vxdb318G9RwA ($19.75 in chips) 
Seat 2: cZ99hugmLBj9KhTlc8nCSw ($28 in chips) 
Seat 3: WaS7+xnv4bIVHoru6nxczA ($14 in chips) 
Seat 4: iZ1f67Ok/207yzIQOu1Kdg ($2.50 in chips) 
Seat 5: HPEB+AtKw1+C/cxU0o1ciw ($24.25 in chips) 
Seat 6: +qc/EYCgLC65SpGvr35eNg ($24 in chips) 
Seat 7: sD+TKtt36XiiN6jqHiLwDA ($28.70 in chips) 
Seat 8: clJsV3v77RS07bDKY+705w ($5 in chips) 
Seat 9: tcbEu7VzyHQ+0lh+skbQhQ ($65.80 in chips) 
F4P6SxCNY4vxdb318G9RwA: posts small blind $0.10
cZ99hugmLBj9KhTlc8nCSw: posts big blind $0.25
*** HOLE CARDS ***
WaS7+xnv4bIVHoru6nxczA: folds 
iZ1f67Ok/207yzIQOu1Kdg: folds 
HPEB+AtKw1+C/cxU0o1ciw: folds 
+qc/EYCgLC65SpGvr35eNg: raises $0.75 to $1
sD+TKtt36XiiN6jqHiLwDA: folds 
clJsV3v77RS07bDKY+705w: folds 
tcbEu7VzyHQ+0lh+skbQhQ: folds 
F4P6SxCNY4vxdb318G9RwA: raises $2 to $3
cZ99hugmLBj9KhTlc8nCSw: folds 
+qc/EYCgLC65SpGvr35eNg: folds 
Uncalled bet ($2) returned to F4P6SxCNY4vxdb318G9RwA
F4P6SxCNY4vxdb318G9RwA collected $2.25 from pot
*** SUMMARY ***
Total pot $2.25 | Rake $0 
Seat 1: F4P6SxCNY4vxdb318G9RwA (small blind) collected ($2.25)
Seat 2: cZ99hugmLBj9KhTlc8nCSw (big blind) folded before Flop
Seat 3: WaS7+xnv4bIVHoru6nxczA folded before Flop (didn't bet)
Seat 4: iZ1f67Ok/207yzIQOu1Kdg folded before Flop (didn't bet)
Seat 5: HPEB+AtKw1+C/cxU0o1ciw folded before Flop (didn't bet)
Seat 6: +qc/EYCgLC65SpGvr35eNg folded before Flop
Seat 7: sD+TKtt36XiiN6jqHiLwDA folded before Flop (didn't bet)
Seat 8: clJsV3v77RS07bDKY+705w folded before Flop (didn't bet)
Seat 9: tcbEu7VzyHQ+0lh+skbQhQ (button) folded before Flop (didn't bet)




PokerStars Game #59942006800:  Hold'em No Limit ($0.10/$0.25) - 2009/07/01 1:53:07 ET
Table 'axb9RsG8Zj1A0LEukTeFrQ' 9-max Seat #2 is the button
Seat 1: qwr38jl5txoR36M7G5qi4A ($8.75 in chips) 
Seat 2: zDrucyjVn5aeekNEc3cJrA ($21.05 in chips) 
Seat 3: H5Se03ZqSX7tbULXur2MAg ($24.80 in chips) 
Seat 4: tLcDklc2rBORNfixyRfVfw ($25 in chips) 
Seat 5: rLSSHKOHnb6yzVfDoQM/RA ($11.50 in chips) 
Seat 6: Iu9xjReQYvxYiqQm8n6MXQ ($10.75 in chips) 
Seat 7: PdIasPkzm2sqZnN41ZRXOg ($5 in chips) 
Seat 8: VBHxUExRAMrbxUq/cVx9Gw ($5 in chips) 
Seat 9: qbQE8CifKB4+OEvNF/61Rw ($56.60 in chips) 
H5Se03ZqSX7tbULXur2MAg: posts small blind $0.10
tLcDklc2rBORNfixyRfVfw: posts big blind $0.25
*** HOLE CARDS ***
rLSSHKOHnb6yzVfDoQM/RA: folds 
Iu9xjReQYvxYiqQm8n6MXQ: folds 
PdIasPkzm2sqZnN41ZRXOg: folds 
Iu9xjReQYvxYiqQm8n6MXQ leaves the table
VBHxUExRAMrbxUq/cVx9Gw: folds 
qbQE8CifKB4+OEvNF/61Rw: calls $0.25
qwr38jl5txoR36M7G5qi4A: folds 
zDrucyjVn5aeekNEc3cJrA: folds 
H5Se03ZqSX7tbULXur2MAg: folds 
tLcDklc2rBORNfixyRfVfw: checks 
*** FLOP *** [6c Jh 7c]
tLcDklc2rBORNfixyRfVfw: checks 
qbQE8CifKB4+OEvNF/61Rw: checks 
*** TURN *** [6c Jh 7c] [2h]
tLcDklc2rBORNfixyRfVfw: checks 
qbQE8CifKB4+OEvNF/61Rw: checks 
*** RIVER *** [6c Jh 7c 2h] [3s]
tLcDklc2rBORNfixyRfVfw: checks 
qbQE8CifKB4+OEvNF/61Rw: bets $0.25
tLcDklc2rBORNfixyRfVfw: folds 
Uncalled bet ($0.25) returned to qbQE8CifKB4+OEvNF/61Rw
corks_soaker joins the table at seat #6 
qbQE8CifKB4+OEvNF/61Rw collected $0.60 from pot
qbQE8CifKB4+OEvNF/61Rw: shows [7s Jd] (two pair, Jacks and Sevens)
*** SUMMARY ***
Total pot $0.60 | Rake $0 
Board [6c Jh 7c 2h 3s]
Seat 1: qwr38jl5txoR36M7G5qi4A folded before Flop (didn't bet)
Seat 2: zDrucyjVn5aeekNEc3cJrA (button) folded before Flop (didn't bet)
Seat 3: H5Se03ZqSX7tbULXur2MAg (small blind) folded before Flop
Seat 4: tLcDklc2rBORNfixyRfVfw (big blind) folded on the River
Seat 5: rLSSHKOHnb6yzVfDoQM/RA folded before Flop (didn't bet)
Seat 6: Iu9xjReQYvxYiqQm8n6MXQ folded before Flop (didn't bet)
Seat 7: PdIasPkzm2sqZnN41ZRXOg folded before Flop (didn't bet)
Seat 8: VBHxUExRAMrbxUq/cVx9Gw folded before Flop (didn't bet)
Seat 9: qbQE8CifKB4+OEvNF/61Rw collected ($0.60)




PokerStars Game #59942007000:  Hold'em No Limit ($0.10/$0.25) - 2009/07/01 1:53:07 ET
Table 'v+LTGPWbrLum+Ggd4ef6lg' 9-max Seat #2 is the button
Seat 2: clJsV3v77RS07bDKY+705w ($5 in chips) 
Seat 3: 7ovWM9c1nQLTFritEGRG/A ($2.85 in chips) 
Seat 4: yqkowiRWZ6NvRN9UUkYIlA ($5 in chips) 
Seat 5: +8OkYWUhGfkDbAtQl/ovYQ ($23.50 in chips) 
Seat 7: kUxTO3D2eQcx4oJIpJAK4Q ($8.25 in chips) 
Seat 8: +sbyWwIcFp9kP0bDtMegfQ ($37.20 in chips) 
Seat 9: cZ99hugmLBj9KhTlc8nCSw ($27.60 in chips) 
7ovWM9c1nQLTFritEGRG/A: posts small blind $0.10
yqkowiRWZ6NvRN9UUkYIlA: posts big blind $0.25
*** HOLE CARDS ***
+8OkYWUhGfkDbAtQl/ovYQ: folds 
zUXhymECc2C9W9ZNw6qppA is connected 
kUxTO3D2eQcx4oJIpJAK4Q: raises $0.75 to $1
+sbyWwIcFp9kP0bDtMegfQ: folds 
zUXhymECc2C9W9ZNw6qppA has returned
cZ99hugmLBj9KhTlc8nCSw: folds 
clJsV3v77RS07bDKY+705w: folds 
7ovWM9c1nQLTFritEGRG/A: folds 
yqkowiRWZ6NvRN9UUkYIlA: folds 
Uncalled bet ($0.75) returned to kUxTO3D2eQcx4oJIpJAK4Q
kUxTO3D2eQcx4oJIpJAK4Q collected $0.60 from pot
kUxTO3D2eQcx4oJIpJAK4Q: doesn't show hand 
*** SUMMARY ***
Total pot $0.60 | Rake $0 
Seat 2: clJsV3v77RS07bDKY+705w (button) folded before Flop (didn't bet)
Seat 3: 7ovWM9c1nQLTFritEGRG/A (small blind) folded before Flop
Seat 4: yqkowiRWZ6NvRN9UUkYIlA (big blind) folded before Flop
Seat 5: +8OkYWUhGfkDbAtQl/ovYQ folded before Flop (didn't bet)
Seat 7: kUxTO3D2eQcx4oJIpJAK4Q collected ($0.60)
Seat 8: +sbyWwIcFp9kP0bDtMegfQ folded before Flop (didn't bet)
Seat 9: cZ99hugmLBj9KhTlc8nCSw folded before Flop (didn't bet)




PokerStars Game #59942007666:  Hold'em No Limit ($0.10/$0.25) - 2009/07/01 1:53:08 ET
Table '7/qMNloI0nSXWiX5Y1watA' 9-max Seat #4 is the button
Seat 1: /LyhaB3V6jkgOfXORidqRQ ($10.25 in chips) 
Seat 2: wGigCmBR/9XWkPpvYos3aQ ($29.95 in chips) 
Seat 4: K0LdhPeU31rviEPo6Sv3TA ($9.10 in chips) 
Seat 5: GeMoapCKDLc4ajT0Uk9ZQw ($9.75 in chips) 
Seat 6: JqeaikMej6KsqTKmUhl2Lw ($25 in chips) 
Seat 8: ljemhp25Zg+nlA9DLCIiUw ($25.95 in chips) 
Seat 9: dmYlc+1cjwZMJ7wV+Z0rRg ($27.75 in chips) 
GeMoapCKDLc4ajT0Uk9ZQw: posts small blind $0.10
JqeaikMej6KsqTKmUhl2Lw: posts big blind $0.25
z5GxcHlYz/GSz6W2uFiTtg: sits out 
*** HOLE CARDS ***
ljemhp25Zg+nlA9DLCIiUw: folds 
dmYlc+1cjwZMJ7wV+Z0rRg: folds 
/LyhaB3V6jkgOfXORidqRQ: folds 
wGigCmBR/9XWkPpvYos3aQ: folds 
K0LdhPeU31rviEPo6Sv3TA: raises $0.50 to $0.75
GeMoapCKDLc4ajT0Uk9ZQw: raises $9 to $9.75 and is all-in
JqeaikMej6KsqTKmUhl2Lw: folds 
K0LdhPeU31rviEPo6Sv3TA said, "sure"
K0LdhPeU31rviEPo6Sv3TA: folds 
Uncalled bet ($9) returned to GeMoapCKDLc4ajT0Uk9ZQw
GeMoapCKDLc4ajT0Uk9ZQw collected $1.75 from pot
*** SUMMARY ***
Total pot $1.75 | Rake $0 
Seat 1: /LyhaB3V6jkgOfXORidqRQ folded before Flop (didn't bet)
Seat 2: wGigCmBR/9XWkPpvYos3aQ folded before Flop (didn't bet)
Seat 4: K0LdhPeU31rviEPo6Sv3TA (button) folded before Flop
Seat 5: GeMoapCKDLc4ajT0Uk9ZQw (small blind) collected ($1.75)
Seat 6: JqeaikMej6KsqTKmUhl2Lw (big blind) folded before Flop
Seat 8: ljemhp25Zg+nlA9DLCIiUw folded before Flop (didn't bet)
Seat 9: dmYlc+1cjwZMJ7wV+Z0rRg folded before Flop (didn't bet)




PokerStars Game #59942007434:  Hold'em No Limit ($0.10/$0.25) - 2009/07/01 1:53:08 ET
Table 'z2yOdY2zyGWG1gh9WV9XtQ' 9-max Seat #1 is the button
Seat 1: 8iyfEWL3auLDt9HEV3U5Vg ($24 in chips) 
Seat 2: /OxeiWKPcgcer/U4z8Kqxw ($4.25 in chips) 
Seat 3: X78b5v/uhqeXXoAijbw/yg ($36.50 in chips) 
Seat 4: Bb42QRQMhg5/Y0vHP8/2Xw ($25 in chips) 
Seat 6: NBYmTySMtIicyMj5Vjzqhw ($32.65 in chips) 
Seat 7: zDrucyjVn5aeekNEc3cJrA ($22.60 in chips) 
Seat 9: wGigCmBR/9XWkPpvYos3aQ ($34.55 in chips) 
/OxeiWKPcgcer/U4z8Kqxw: posts small blind $0.10
X78b5v/uhqeXXoAijbw/yg: posts big blind $0.25
4qA/3Ajg3pP6fqW+IX9/fQ: sits out 
*** HOLE CARDS ***
Bb42QRQMhg5/Y0vHP8/2Xw: folds 
NBYmTySMtIicyMj5Vjzqhw: folds 
zDrucyjVn5aeekNEc3cJrA: calls $0.25
wGigCmBR/9XWkPpvYos3aQ: folds 
8iyfEWL3auLDt9HEV3U5Vg: folds 
/OxeiWKPcgcer/U4z8Kqxw: raises $0.75 to $1
X78b5v/uhqeXXoAijbw/yg: folds 
zDrucyjVn5aeekNEc3cJrA: folds 
Uncalled bet ($0.75) returned to /OxeiWKPcgcer/U4z8Kqxw
/OxeiWKPcgcer/U4z8Kqxw collected $0.75 from pot
/OxeiWKPcgcer/U4z8Kqxw: doesn't show hand 
*** SUMMARY ***
Total pot $0.75 | Rake $0 
Seat 1: 8iyfEWL3auLDt9HEV3U5Vg (button) folded before Flop (didn't bet)
Seat 2: /OxeiWKPcgcer/U4z8Kqxw (small blind) collected ($0.75)
Seat 3: X78b5v/uhqeXXoAijbw/yg (big blind) folded before Flop
Seat 4: Bb42QRQMhg5/Y0vHP8/2Xw folded before Flop (didn't bet)
Seat 6: NBYmTySMtIicyMj5Vjzqhw folded before Flop (didn't bet)
Seat 7: zDrucyjVn5aeekNEc3cJrA folded before Flop
Seat 9: wGigCmBR/9XWkPpvYos3aQ folded before Flop (didn't bet)




PokerStars Game #59942007474:  Hold'em No Limit ($0.10/$0.25) - 2009/07/01 1:53:08 ET
Table 'L5GvbdQO5aCZJSE6pyQ8OA' 6-max Seat #6 is the button
Seat 1: eFj4lr1nuXLyCWNTShr1bg ($11.20 in chips) 
Seat 2: DihMHaz4WNETH1bPDe13kA ($30.55 in chips) 
Seat 3: JFIAqU8lCZ0vWwEl4bdGsg ($25.35 in chips) 
Seat 4: trN/oHqTTbPw5MNuKrOpLw ($27.15 in chips) 
Seat 5: LyDHtw3/yniNHW+DvLXbog ($29.60 in chips) 
Seat 6: v+QfkGiuj9bgtuNoVnDO8w ($38.35 in chips) 
eFj4lr1nuXLyCWNTShr1bg: posts small blind $0.10
DihMHaz4WNETH1bPDe13kA: posts big blind $0.25
*** HOLE CARDS ***
JFIAqU8lCZ0vWwEl4bdGsg: folds 
trN/oHqTTbPw5MNuKrOpLw: raises $0.50 to $0.75
LyDHtw3/yniNHW+DvLXbog: folds 
v+QfkGiuj9bgtuNoVnDO8w: folds 
eFj4lr1nuXLyCWNTShr1bg: calls $0.65
DihMHaz4WNETH1bPDe13kA: folds 
*** FLOP *** [2c Qs 2h]
eFj4lr1nuXLyCWNTShr1bg: bets $0.75
trN/oHqTTbPw5MNuKrOpLw: calls $0.75
*** TURN *** [2c Qs 2h] [2d]
v+QfkGiuj9bgtuNoVnDO8w is sitting out
eFj4lr1nuXLyCWNTShr1bg: bets $1.25
trN/oHqTTbPw5MNuKrOpLw: folds 
Uncalled bet ($1.25) returned to eFj4lr1nuXLyCWNTShr1bg
eFj4lr1nuXLyCWNTShr1bg collected $3.10 from pot
eFj4lr1nuXLyCWNTShr1bg: doesn't show hand 
*** SUMMARY ***
Total pot $3.25 | Rake $0.15 
Board [2c Qs 2h 2d]
Seat 1: eFj4lr1nuXLyCWNTShr1bg (small blind) collected ($3.10)
Seat 2: DihMHaz4WNETH1bPDe13kA (big blind) folded before Flop
Seat 3: JFIAqU8lCZ0vWwEl4bdGsg folded before Flop (didn't bet)
Seat 4: trN/oHqTTbPw5MNuKrOpLw folded on the Turn
Seat 5: LyDHtw3/yniNHW+DvLXbog folded before Flop (didn't bet)
Seat 6: v+QfkGiuj9bgtuNoVnDO8w (button) folded before Flop (didn't bet)




PokerStars Game #59942007376:  Hold'em No Limit ($0.10/$0.25) - 2009/07/01 1:53:08 ET
Table 'O6cwjhrMn9pfzx1Ngn5zkQ' 6-max Seat #2 is the button
Seat 1: LJI7A1YgDM7hgh7o56+ReQ ($25 in chips) 
Seat 2: 8CPg15X6IHYR1pWm9ha1Sw ($25 in chips) 
Seat 3: EE16Ua5b1HSsYej5zeXOlA ($25 in chips) 
Seat 4: mfrkWA3PTeYPkbO6hi98Aw ($39.85 in chips) 
Seat 5: niLn0xUVlqh8If80xRjzCA ($28.35 in chips) 
Seat 6: 4TM16KVgEiQpLi4bVVWbVQ ($36.70 in chips) 
EE16Ua5b1HSsYej5zeXOlA: posts small blind $0.10
mfrkWA3PTeYPkbO6hi98Aw: posts big blind $0.25
*** HOLE CARDS ***
niLn0xUVlqh8If80xRjzCA: calls $0.25
4TM16KVgEiQpLi4bVVWbVQ: folds 
LJI7A1YgDM7hgh7o56+ReQ: folds 
8CPg15X6IHYR1pWm9ha1Sw: raises $0.50 to $0.75
EE16Ua5b1HSsYej5zeXOlA: folds 
mfrkWA3PTeYPkbO6hi98Aw: folds 
niLn0xUVlqh8If80xRjzCA: calls $0.50
*** FLOP *** [8c 7h 3c]
niLn0xUVlqh8If80xRjzCA: checks 
8CPg15X6IHYR1pWm9ha1Sw: bets $1
niLn0xUVlqh8If80xRjzCA: calls $1
*** TURN *** [8c 7h 3c] [9s]
niLn0xUVlqh8If80xRjzCA: checks 
8CPg15X6IHYR1pWm9ha1Sw: bets $2.25
niLn0xUVlqh8If80xRjzCA: calls $2.25
*** RIVER *** [8c 7h 3c 9s] [Kd]
niLn0xUVlqh8If80xRjzCA: checks 
8CPg15X6IHYR1pWm9ha1Sw: checks 
*** SHOW DOWN ***
niLn0xUVlqh8If80xRjzCA: shows [Ac 6c] (high card Ace)
8CPg15X6IHYR1pWm9ha1Sw: shows [6h 8h] (a pair of Eights)
8CPg15X6IHYR1pWm9ha1Sw collected $7.95 from pot
*** SUMMARY ***
Total pot $8.35 | Rake $0.40 
Board [8c 7h 3c 9s Kd]
Seat 1: LJI7A1YgDM7hgh7o56+ReQ folded before Flop (didn't bet)
Seat 2: 8CPg15X6IHYR1pWm9ha1Sw (button) showed [6h 8h] and won ($7.95) with a pair of Eights
Seat 3: EE16Ua5b1HSsYej5zeXOlA (small blind) folded before Flop
Seat 4: mfrkWA3PTeYPkbO6hi98Aw (big blind) folded before Flop
Seat 5: niLn0xUVlqh8If80xRjzCA showed [Ac 6c] and lost with high card Ace
Seat 6: 4TM16KVgEiQpLi4bVVWbVQ folded before Flop (didn't bet)




PokerStars Game #59942007526:  Hold'em No Limit ($0.10/$0.25) - 2009/07/01 1:53:08 ET
Table 'oxYpQNT8OHNCvpMIFi7UoA' 9-max Seat #7 is the button
Seat 1: EVqHvqty1ZsuvDFiSXlSqQ ($32.70 in chips) 
Seat 3: ubsjZomMWSV0hAiBLa7K1A ($19.80 in chips) 
Seat 4: eK8qa6EPcH2zhtbmWSvc9g ($25 in chips) 
Seat 5: ZoqLw33zTU6EsjOkfv/cGw ($19.75 in chips) 
Seat 6: VBHxUExRAMrbxUq/cVx9Gw ($5.05 in chips) 
Seat 7: X78b5v/uhqeXXoAijbw/yg ($35.30 in chips) 
Seat 8: E2OrwPLjPzZjbllMp2olEw ($17.25 in chips) 
Seat 9: pN3IHvAKm2fz+sTRARTcrg ($25 in chips) 
E2OrwPLjPzZjbllMp2olEw: posts small blind $0.10
pN3IHvAKm2fz+sTRARTcrg: posts big blind $0.25
*** HOLE CARDS ***
EVqHvqty1ZsuvDFiSXlSqQ: calls $0.25
ubsjZomMWSV0hAiBLa7K1A: folds 
eK8qa6EPcH2zhtbmWSvc9g: folds 
ZoqLw33zTU6EsjOkfv/cGw: folds 
VBHxUExRAMrbxUq/cVx9Gw: folds 
X78b5v/uhqeXXoAijbw/yg: raises $1 to $1.25
E2OrwPLjPzZjbllMp2olEw: folds 
pN3IHvAKm2fz+sTRARTcrg: folds 
8+iP8mvFyeAviW/yUH1CJg has returned
EVqHvqty1ZsuvDFiSXlSqQ: calls $1
*** FLOP *** [3c 9d Kd]
EVqHvqty1ZsuvDFiSXlSqQ: checks 
X78b5v/uhqeXXoAijbw/yg: bets $2
EVqHvqty1ZsuvDFiSXlSqQ: folds 
Uncalled bet ($2) returned to X78b5v/uhqeXXoAijbw/yg
X78b5v/uhqeXXoAijbw/yg collected $2.75 from pot
*** SUMMARY ***
Total pot $2.85 | Rake $0.10 
Board [3c 9d Kd]
Seat 1: EVqHvqty1ZsuvDFiSXlSqQ folded on the Flop
Seat 3: ubsjZomMWSV0hAiBLa7K1A folded before Flop (didn't bet)
Seat 4: eK8qa6EPcH2zhtbmWSvc9g folded before Flop (didn't bet)
Seat 5: ZoqLw33zTU6EsjOkfv/cGw folded before Flop (didn't bet)
Seat 6: VBHxUExRAMrbxUq/cVx9Gw folded before Flop (didn't bet)
Seat 7: X78b5v/uhqeXXoAijbw/yg (button) collected ($2.75)
Seat 8: E2OrwPLjPzZjbllMp2olEw (small blind) folded before Flop
Seat 9: pN3IHvAKm2fz+sTRARTcrg (big blind) folded before Flop




PokerStars Game #59942007684:  Hold'em No Limit ($0.10/$0.25) - 2009/07/01 1:53:08 ET
Table 'r562aMIMs5kgo28FEU6lkA' 9-max Seat #3 is the button
Seat 1: H5Se03ZqSX7tbULXur2MAg ($14.80 in chips) 
Seat 3: xoBFd/5k+L/pFn9VW1VyWg ($10.25 in chips) 
Seat 4: V6p0jQ/RhUsqpHLmXvEX4Q ($19.50 in chips) 
Seat 5: zDrucyjVn5aeekNEc3cJrA ($35.20 in chips) 
Seat 6: RCqMONFrSPSArZh2Jsar/w ($20.35 in chips) 
Seat 7: Bb42QRQMhg5/Y0vHP8/2Xw ($25 in chips) 
Seat 8: B6xHiX1SJkS0CUNCKDVwuQ ($20.65 in chips) 
Seat 9: yyG4svzOpC1A+sUP/scg6w ($7 in chips) 
V6p0jQ/RhUsqpHLmXvEX4Q: posts small blind $0.10
zDrucyjVn5aeekNEc3cJrA: posts big blind $0.25
*** HOLE CARDS ***
RCqMONFrSPSArZh2Jsar/w: folds 
Bb42QRQMhg5/Y0vHP8/2Xw: folds 
vSkQm2EelzwRGDDQQk0Fqw joins the table at seat #2 
B6xHiX1SJkS0CUNCKDVwuQ: raises $0.50 to $0.75
yyG4svzOpC1A+sUP/scg6w: folds 
H5Se03ZqSX7tbULXur2MAg: folds 
xoBFd/5k+L/pFn9VW1VyWg: folds 
xoBFd/5k+L/pFn9VW1VyWg is sitting out
V6p0jQ/RhUsqpHLmXvEX4Q: folds 
zDrucyjVn5aeekNEc3cJrA: folds 
Uncalled bet ($0.50) returned to B6xHiX1SJkS0CUNCKDVwuQ
B6xHiX1SJkS0CUNCKDVwuQ collected $0.60 from pot
B6xHiX1SJkS0CUNCKDVwuQ: doesn't show hand 
*** SUMMARY ***
Total pot $0.60 | Rake $0 
Seat 1: H5Se03ZqSX7tbULXur2MAg folded before Flop (didn't bet)
Seat 3: xoBFd/5k+L/pFn9VW1VyWg (button) folded before Flop (didn't bet)
Seat 4: V6p0jQ/RhUsqpHLmXvEX4Q (small blind) folded before Flop
Seat 5: zDrucyjVn5aeekNEc3cJrA (big blind) folded before Flop
Seat 6: RCqMONFrSPSArZh2Jsar/w folded before Flop (didn't bet)
Seat 7: Bb42QRQMhg5/Y0vHP8/2Xw folded before Flop (didn't bet)
Seat 8: B6xHiX1SJkS0CUNCKDVwuQ collected ($0.60)
Seat 9: yyG4svzOpC1A+sUP/scg6w folded before Flop (didn't bet)




PokerStars Game #59942007842:  Hold'em No Limit ($0.10/$0.25) - 2009/07/01 1:53:09 ET
Table 'h02LhQ7B/Zk4ETRxxHhGYA' 9-max Seat #8 is the button
Seat 1: sD+TKtt36XiiN6jqHiLwDA ($26.15 in chips) 
Seat 2: 9lvO/qyU+xrU95Teu1fv0g ($7.05 in chips) 
Seat 3: arxNSjreDRGFg13EAM2F1w ($30.40 in chips) 
Seat 4: ZyPfMsrS7T70lNdYA6rJ7w ($13.15 in chips) 
Seat 5: cUxk0Jk4lrUQv9CJl0LPlg ($28 in chips) 
Seat 6: UvM6sxFT7el5hVDehvWvTA ($27.85 in chips) 
Seat 8: mUoFJKqCzIUABvOFbiINlQ ($14.85 in chips) 
Seat 9: HcU1ud5gMXGuhN1QChAhfQ ($24.25 in chips) 
HcU1ud5gMXGuhN1QChAhfQ: posts small blind $0.10
sD+TKtt36XiiN6jqHiLwDA: posts big blind $0.25
*** HOLE CARDS ***
9lvO/qyU+xrU95Teu1fv0g: folds 
UvM6sxFT7el5hVDehvWvTA said, "near to that"
arxNSjreDRGFg13EAM2F1w: folds 
ZyPfMsrS7T70lNdYA6rJ7w: folds 
cUxk0Jk4lrUQv9CJl0LPlg: folds 
UvM6sxFT7el5hVDehvWvTA: folds 
mUoFJKqCzIUABvOFbiINlQ: folds 
HcU1ud5gMXGuhN1QChAhfQ: calls $0.15
sD+TKtt36XiiN6jqHiLwDA: checks 
*** FLOP *** [7s Td Qh]
HcU1ud5gMXGuhN1QChAhfQ: checks 
sD+TKtt36XiiN6jqHiLwDA: checks 
*** TURN *** [7s Td Qh] [5c]
HcU1ud5gMXGuhN1QChAhfQ: checks 
sD+TKtt36XiiN6jqHiLwDA: checks 
*** RIVER *** [7s Td Qh 5c] [5h]
HcU1ud5gMXGuhN1QChAhfQ: checks 
sD+TKtt36XiiN6jqHiLwDA: checks 
*** SHOW DOWN ***
HcU1ud5gMXGuhN1QChAhfQ: shows [6c 4d] (a pair of Fives)
sD+TKtt36XiiN6jqHiLwDA: shows [Jd 8h] (a pair of Fives - Queen+Jack kicker)
sD+TKtt36XiiN6jqHiLwDA collected $0.50 from pot
*** SUMMARY ***
Total pot $0.50 | Rake $0 
Board [7s Td Qh 5c 5h]
Seat 1: sD+TKtt36XiiN6jqHiLwDA (big blind) showed [Jd 8h] and won ($0.50) with a pair of Fives
Seat 2: 9lvO/qyU+xrU95Teu1fv0g folded before Flop (didn't bet)
Seat 3: arxNSjreDRGFg13EAM2F1w folded before Flop (didn't bet)
Seat 4: ZyPfMsrS7T70lNdYA6rJ7w folded before Flop (didn't bet)
Seat 5: cUxk0Jk4lrUQv9CJl0LPlg folded before Flop (didn't bet)
Seat 6: UvM6sxFT7el5hVDehvWvTA folded before Flop (didn't bet)
Seat 8: mUoFJKqCzIUABvOFbiINlQ (button) folded before Flop (didn't bet)
Seat 9: HcU1ud5gMXGuhN1QChAhfQ (small blind) showed [6c 4d] and lost with a pair of Fives




PokerStars Game #59942007770:  Hold'em No Limit ($0.10/$0.25) - 2009/07/01 1:53:09 ET
Table '2vH5RcmkT0F4XNS/EmmyMA' 6-max Seat #2 is the button
Seat 2: W6Y6au0wf7gRAlqJYgOezw ($17.55 in chips) 
Seat 3: t8P79jKZYh/Wpx2V73pSqg ($21.10 in chips) 
Seat 4: FC6tJ9EOiutXO8hnpR4VgQ ($9.70 in chips) 
Seat 6: if4dh6jhJXeN3/qd3qCp9g ($24.85 in chips) 
t8P79jKZYh/Wpx2V73pSqg: posts small blind $0.10
FC6tJ9EOiutXO8hnpR4VgQ: posts big blind $0.25
MVzl6OsGybVDNd3Vr9LYAA: sits out 
JFIAqU8lCZ0vWwEl4bdGsg: sits out 
*** HOLE CARDS ***
if4dh6jhJXeN3/qd3qCp9g: folds 
W6Y6au0wf7gRAlqJYgOezw: folds 
t8P79jKZYh/Wpx2V73pSqg: raises $0.75 to $1
FC6tJ9EOiutXO8hnpR4VgQ: folds 
Uncalled bet ($0.75) returned to t8P79jKZYh/Wpx2V73pSqg
t8P79jKZYh/Wpx2V73pSqg collected $0.50 from pot
*** SUMMARY ***
Total pot $0.50 | Rake $0 
Seat 2: W6Y6au0wf7gRAlqJYgOezw (button) folded before Flop (didn't bet)
Seat 3: t8P79jKZYh/Wpx2V73pSqg (small blind) collected ($0.50)
Seat 4: FC6tJ9EOiutXO8hnpR4VgQ (big blind) folded before Flop
Seat 6: if4dh6jhJXeN3/qd3qCp9g folded before Flop (didn't bet)




PokerStars Game #59942007706:  Hold'em No Limit ($0.10/$0.25) - 2009/07/01 1:53:09 ET
Table '63h13e5p7cWe02rClZ1CHw' 6-max Seat #2 is the button
Seat 1: pokjbbEcXXPlADXdSGHtZw ($22.35 in chips) 
Seat 2: k9nHZTHt8hYhYRcW8NTb4g ($24.55 in chips) 
Seat 4: xrf8tAXKQHG99HixCot1Iw ($27.75 in chips) 
Seat 5: iyZxqznXjv3vtvOJymkoLQ ($44.10 in chips) 
Seat 6: mfrkWA3PTeYPkbO6hi98Aw ($38.10 in chips) 
xrf8tAXKQHG99HixCot1Iw: posts small blind $0.10
iyZxqznXjv3vtvOJymkoLQ: posts big blind $0.25
*** HOLE CARDS ***
mfrkWA3PTeYPkbO6hi98Aw: folds 
pokjbbEcXXPlADXdSGHtZw: calls $0.25
k9nHZTHt8hYhYRcW8NTb4g: raises $0.75 to $1
xrf8tAXKQHG99HixCot1Iw: folds 
iyZxqznXjv3vtvOJymkoLQ: calls $0.75
pokjbbEcXXPlADXdSGHtZw: calls $0.75
*** FLOP *** [Ac 9d Jh]
iyZxqznXjv3vtvOJymkoLQ: checks 
pokjbbEcXXPlADXdSGHtZw: checks 
k9nHZTHt8hYhYRcW8NTb4g: bets $1.50
iyZxqznXjv3vtvOJymkoLQ: calls $1.50
Hunterswidow joins the table at seat #3 
pokjbbEcXXPlADXdSGHtZw: calls $1.50
*** TURN *** [Ac 9d Jh] [4h]
iyZxqznXjv3vtvOJymkoLQ: checks 
pokjbbEcXXPlADXdSGHtZw: checks 
k9nHZTHt8hYhYRcW8NTb4g: checks 
*** RIVER *** [Ac 9d Jh 4h] [As]
iyZxqznXjv3vtvOJymkoLQ: checks 
pokjbbEcXXPlADXdSGHtZw: checks 
k9nHZTHt8hYhYRcW8NTb4g: checks 
*** SHOW DOWN ***
iyZxqznXjv3vtvOJymkoLQ: shows [Jc Tc] (two pair, Aces and Jacks)
pokjbbEcXXPlADXdSGHtZw: shows [Jd Qs] (two pair, Aces and Jacks - Queen kicker)
k9nHZTHt8hYhYRcW8NTb4g: mucks hand 
pokjbbEcXXPlADXdSGHtZw collected $7.25 from pot
*** SUMMARY ***
Total pot $7.60 | Rake $0.35 
Board [Ac 9d Jh 4h As]
Seat 1: pokjbbEcXXPlADXdSGHtZw showed [Jd Qs] and won ($7.25) with two pair, Aces and Jacks
Seat 2: k9nHZTHt8hYhYRcW8NTb4g (button) mucked
Seat 4: xrf8tAXKQHG99HixCot1Iw (small blind) folded before Flop
Seat 5: iyZxqznXjv3vtvOJymkoLQ (big blind) showed [Jc Tc] and lost with two pair, Aces and Jacks
Seat 6: mfrkWA3PTeYPkbO6hi98Aw folded before Flop (didn't bet)




PokerStars Game #59942008098:  Hold'em No Limit ($0.10/$0.25) - 2009/07/01 1:53:09 ET
Table 'zKwHJD0cmKNUure9qQTfFg' 6-max Seat #2 is the button
Seat 1: Hzrn9DZJegEZICufTNYkrg ($2.75 in chips) 
Seat 2: xrf8tAXKQHG99HixCot1Iw ($31.20 in chips) 
Seat 3: m9aw7LBAB5YX2ZqMtMkhqA ($19.20 in chips) 
Seat 4: v+QfkGiuj9bgtuNoVnDO8w ($37.45 in chips) 
Seat 6: edio/rLJ06xeZOfLhoL3UA ($6.10 in chips) 
m9aw7LBAB5YX2ZqMtMkhqA: posts small blind $0.10
v+QfkGiuj9bgtuNoVnDO8w: posts big blind $0.25
yoelik: sits out 
*** HOLE CARDS ***
edio/rLJ06xeZOfLhoL3UA: raises $0.75 to $1
Hzrn9DZJegEZICufTNYkrg: folds 
xrf8tAXKQHG99HixCot1Iw: folds 
m9aw7LBAB5YX2ZqMtMkhqA: calls $0.90
v+QfkGiuj9bgtuNoVnDO8w: folds 
*** FLOP *** [6c 9s 9h]
m9aw7LBAB5YX2ZqMtMkhqA: bets $1
edio/rLJ06xeZOfLhoL3UA: calls $1
*** TURN *** [6c 9s 9h] [2s]
m9aw7LBAB5YX2ZqMtMkhqA: bets $1.75
edio/rLJ06xeZOfLhoL3UA: calls $1.75
*** RIVER *** [6c 9s 9h 2s] [7d]
m9aw7LBAB5YX2ZqMtMkhqA: bets $2.50
edio/rLJ06xeZOfLhoL3UA: folds 
Uncalled bet ($2.50) returned to m9aw7LBAB5YX2ZqMtMkhqA
yoelik leaves the table
m9aw7LBAB5YX2ZqMtMkhqA collected $7.40 from pot
m9aw7LBAB5YX2ZqMtMkhqA: shows [Ad Ah] (two pair, Aces and Nines)
*** SUMMARY ***
Total pot $7.75 | Rake $0.35 
Board [6c 9s 9h 2s 7d]
Seat 1: Hzrn9DZJegEZICufTNYkrg folded before Flop (didn't bet)
Seat 2: xrf8tAXKQHG99HixCot1Iw (button) folded before Flop (didn't bet)
Seat 3: m9aw7LBAB5YX2ZqMtMkhqA (small blind) collected ($7.40)
Seat 4: v+QfkGiuj9bgtuNoVnDO8w (big blind) folded before Flop
Seat 6: edio/rLJ06xeZOfLhoL3UA folded on the River




PokerStars Game #59942007702:  Hold'em No Limit ($0.10/$0.25) - 2009/07/01 1:53:09 ET
Table '2clPgY3+dETPD/8zjXZdFw' 6-max Seat #5 is the button
Seat 1: 7cx44/slbeTw+Cy7QB8Trg ($27.45 in chips) 
Seat 2: cWc85bEzdRzpUMhRKm8pwQ ($25 in chips) 
Seat 4: ljjhtb6FVPTx9AT9HNdtqg ($23.45 in chips) 
Seat 5: LJI7A1YgDM7hgh7o56+ReQ ($30.10 in chips) 
Seat 6: c3J/KYZ4cNsUEuz8v57I5A ($23 in chips) 
c3J/KYZ4cNsUEuz8v57I5A: posts small blind $0.10
7cx44/slbeTw+Cy7QB8Trg: posts big blind $0.25
*** HOLE CARDS ***
cWc85bEzdRzpUMhRKm8pwQ: folds 
ljjhtb6FVPTx9AT9HNdtqg: folds 
LJI7A1YgDM7hgh7o56+ReQ: raises $0.50 to $0.75
c3J/KYZ4cNsUEuz8v57I5A: folds 
7cx44/slbeTw+Cy7QB8Trg: folds 
Uncalled bet ($0.50) returned to LJI7A1YgDM7hgh7o56+ReQ
LJI7A1YgDM7hgh7o56+ReQ collected $0.60 from pot
LJI7A1YgDM7hgh7o56+ReQ: doesn't show hand 
*** SUMMARY ***
Total pot $0.60 | Rake $0 
Seat 1: 7cx44/slbeTw+Cy7QB8Trg (big blind) folded before Flop
Seat 2: cWc85bEzdRzpUMhRKm8pwQ folded before Flop (didn't bet)
Seat 4: ljjhtb6FVPTx9AT9HNdtqg folded before Flop (didn't bet)
Seat 5: LJI7A1YgDM7hgh7o56+ReQ (button) collected ($0.60)
Seat 6: c3J/KYZ4cNsUEuz8v57I5A (small blind) folded before Flop




PokerStars Game #59942007700:  Hold'em No Limit ($0.10/$0.25) - 2009/07/01 1:53:09 ET
Table 'nXVbUw6/HYwA6x21+IZ3XQ' 9-max Seat #9 is the button
Seat 1: zDrucyjVn5aeekNEc3cJrA ($17.10 in chips) 
Seat 2: 9lvO/qyU+xrU95Teu1fv0g ($10.25 in chips) 
Seat 3: MB0wa15P+9QHcBApEdgQFw ($12.40 in chips) 
Seat 4: SpiiQQAzy4MUgV3I5W8giw ($24.65 in chips) 
Seat 5: M/9j4wkHH9i1JM51vgi1VA ($31.35 in chips) 
Seat 6: ljemhp25Zg+nlA9DLCIiUw ($26.85 in chips) 
Seat 7: ShCS62CJp4MKfKLKvGKQbA ($11.85 in chips) 
Seat 8: dfNim92Z6XK1/h5SFW5vDg ($25 in chips) 
Seat 9: OTCjTlu92MEBtX/i9Gm7yA ($9.10 in chips) 
zDrucyjVn5aeekNEc3cJrA: posts small blind $0.10
9lvO/qyU+xrU95Teu1fv0g: posts big blind $0.25
*** HOLE CARDS ***
MB0wa15P+9QHcBApEdgQFw: folds 
SpiiQQAzy4MUgV3I5W8giw: folds 
M/9j4wkHH9i1JM51vgi1VA: folds 
ljemhp25Zg+nlA9DLCIiUw: folds 
ShCS62CJp4MKfKLKvGKQbA: folds 
dfNim92Z6XK1/h5SFW5vDg: folds 
OTCjTlu92MEBtX/i9Gm7yA: calls $0.25
zDrucyjVn5aeekNEc3cJrA: calls $0.15
9lvO/qyU+xrU95Teu1fv0g: checks 
*** FLOP *** [Qs 4h Tc]
zDrucyjVn5aeekNEc3cJrA: checks 
9lvO/qyU+xrU95Teu1fv0g: checks 
OTCjTlu92MEBtX/i9Gm7yA: bets $0.25
zDrucyjVn5aeekNEc3cJrA: folds 
9lvO/qyU+xrU95Teu1fv0g: folds 
Uncalled bet ($0.25) returned to OTCjTlu92MEBtX/i9Gm7yA
OTCjTlu92MEBtX/i9Gm7yA collected $0.75 from pot
OTCjTlu92MEBtX/i9Gm7yA: doesn't show hand 
*** SUMMARY ***
Total pot $0.75 | Rake $0 
Board [Qs 4h Tc]
Seat 1: zDrucyjVn5aeekNEc3cJrA (small blind) folded on the Flop
Seat 2: 9lvO/qyU+xrU95Teu1fv0g (big blind) folded on the Flop
Seat 3: MB0wa15P+9QHcBApEdgQFw folded before Flop (didn't bet)
Seat 4: SpiiQQAzy4MUgV3I5W8giw folded before Flop (didn't bet)
Seat 5: M/9j4wkHH9i1JM51vgi1VA folded before Flop (didn't bet)
Seat 6: ljemhp25Zg+nlA9DLCIiUw folded before Flop (didn't bet)
Seat 7: ShCS62CJp4MKfKLKvGKQbA folded before Flop (didn't bet)
Seat 8: dfNim92Z6XK1/h5SFW5vDg folded before Flop (didn't bet)
Seat 9: OTCjTlu92MEBtX/i9Gm7yA (button) collected ($0.75)




PokerStars Game #59942007748:  Hold'em No Limit ($0.10/$0.25) - 2009/07/01 1:53:09 ET
Table '9SExUHslNkrPJ4XsrePaVw' 9-max Seat #3 is the button
Seat 1: RHqgdFvufLCYe54+qd2gcA ($4.15 in chips) 
Seat 2: cZ99hugmLBj9KhTlc8nCSw ($43.75 in chips) 
Seat 3: EP17SQz/iWcuYdNOGeBgkw ($11.70 in chips) 
Seat 4: 4awUyiDYTgylQKXZ9faBVA ($25 in chips) 
Seat 5: L+eJnUyhY8bMNYw755K8XQ ($17.55 in chips) 
Seat 6: YPJ90cgNXDABdYJcqmwB0A ($20.35 in chips) 
Seat 7: sx0lGrkT9fd4yFR+3cXUQg ($11.75 in chips) 
Seat 8: tLcDklc2rBORNfixyRfVfw ($26.35 in chips) 
Seat 9: /THNzAxdv2lBxcf4XTj/0g ($14.70 in chips) 
4awUyiDYTgylQKXZ9faBVA: posts small blind $0.10
L+eJnUyhY8bMNYw755K8XQ: posts big blind $0.25
*** HOLE CARDS ***
YPJ90cgNXDABdYJcqmwB0A: folds 
sx0lGrkT9fd4yFR+3cXUQg: folds 
tLcDklc2rBORNfixyRfVfw: folds 
/THNzAxdv2lBxcf4XTj/0g: folds 
RHqgdFvufLCYe54+qd2gcA: raises $0.50 to $0.75
cZ99hugmLBj9KhTlc8nCSw: folds 
EP17SQz/iWcuYdNOGeBgkw: folds 
4awUyiDYTgylQKXZ9faBVA: folds 
L+eJnUyhY8bMNYw755K8XQ: folds 
Uncalled bet ($0.50) returned to RHqgdFvufLCYe54+qd2gcA
RHqgdFvufLCYe54+qd2gcA collected $0.60 from pot
RHqgdFvufLCYe54+qd2gcA: doesn't show hand 
*** SUMMARY ***
Total pot $0.60 | Rake $0 
Seat 1: RHqgdFvufLCYe54+qd2gcA collected ($0.60)
Seat 2: cZ99hugmLBj9KhTlc8nCSw folded before Flop (didn't bet)
Seat 3: EP17SQz/iWcuYdNOGeBgkw (button) folded before Flop (didn't bet)
Seat 4: 4awUyiDYTgylQKXZ9faBVA (small blind) folded before Flop
Seat 5: L+eJnUyhY8bMNYw755K8XQ (big blind) folded before Flop
Seat 6: YPJ90cgNXDABdYJcqmwB0A folded before Flop (didn't bet)
Seat 7: sx0lGrkT9fd4yFR+3cXUQg folded before Flop (didn't bet)
Seat 8: tLcDklc2rBORNfixyRfVfw folded before Flop (didn't bet)
Seat 9: /THNzAxdv2lBxcf4XTj/0g folded before Flop (didn't bet)




PokerStars Game #59942007786:  Hold'em No Limit ($0.10/$0.25) - 2009/07/01 1:53:09 ET
Table 'GgmUtmhrYPRnhkqEEjD/Kw' 9-max Seat #2 is the button
Seat 1: bXpVeaSTPBFSPJmeXxO7nw ($9.75 in chips) 
Seat 2: ghNKXUBl/H+t83JF079ZBA ($25 in chips) 
Seat 3: dYvYZ723QlKIPiDa0pkedQ ($7.10 in chips) 
Seat 4: dfNim92Z6XK1/h5SFW5vDg ($25 in chips) 
Seat 5: ljemhp25Zg+nlA9DLCIiUw ($26.85 in chips) 
Seat 6: 4Ax0vobe1rLVIGZmkFINGA ($14.55 in chips) 
Seat 7: YwDw9cMqkbMznFK77rru4A ($4.30 in chips) 
Seat 8: DdPXdieucQ+n99u1n3A+rQ ($4.30 in chips) 
Seat 9: V6p0jQ/RhUsqpHLmXvEX4Q ($15.20 in chips) 
dYvYZ723QlKIPiDa0pkedQ: posts small blind $0.10
dfNim92Z6XK1/h5SFW5vDg: posts big blind $0.25
*** HOLE CARDS ***
ljemhp25Zg+nlA9DLCIiUw: folds 
ljemhp25Zg+nlA9DLCIiUw is sitting out
4Ax0vobe1rLVIGZmkFINGA: calls $0.25
YwDw9cMqkbMznFK77rru4A: folds 
DdPXdieucQ+n99u1n3A+rQ: folds 
V6p0jQ/RhUsqpHLmXvEX4Q: folds 
bXpVeaSTPBFSPJmeXxO7nw: folds 
ghNKXUBl/H+t83JF079ZBA: folds 
dYvYZ723QlKIPiDa0pkedQ: calls $0.15
dfNim92Z6XK1/h5SFW5vDg: checks 
*** FLOP *** [7s 3c Ad]
dYvYZ723QlKIPiDa0pkedQ: checks 
dfNim92Z6XK1/h5SFW5vDg: checks 
4Ax0vobe1rLVIGZmkFINGA: checks 
*** TURN *** [7s 3c Ad] [9s]
dYvYZ723QlKIPiDa0pkedQ: checks 
dfNim92Z6XK1/h5SFW5vDg: checks 
4Ax0vobe1rLVIGZmkFINGA: bets $0.25
dYvYZ723QlKIPiDa0pkedQ: calls $0.25
dfNim92Z6XK1/h5SFW5vDg: folds 
*** RIVER *** [7s 3c Ad 9s] [6h]
dYvYZ723QlKIPiDa0pkedQ: checks 
4Ax0vobe1rLVIGZmkFINGA: bets $0.50
dYvYZ723QlKIPiDa0pkedQ: folds 
Uncalled bet ($0.50) returned to 4Ax0vobe1rLVIGZmkFINGA
4Ax0vobe1rLVIGZmkFINGA collected $1.20 from pot
4Ax0vobe1rLVIGZmkFINGA: doesn't show hand 
*** SUMMARY ***
Total pot $1.25 | Rake $0.05 
Board [7s 3c Ad 9s 6h]
Seat 1: bXpVeaSTPBFSPJmeXxO7nw folded before Flop (didn't bet)
Seat 2: ghNKXUBl/H+t83JF079ZBA (button) folded before Flop (didn't bet)
Seat 3: dYvYZ723QlKIPiDa0pkedQ (small blind) folded on the River
Seat 4: dfNim92Z6XK1/h5SFW5vDg (big blind) folded on the Turn
Seat 5: ljemhp25Zg+nlA9DLCIiUw folded before Flop (didn't bet)
Seat 6: 4Ax0vobe1rLVIGZmkFINGA collected ($1.20)
Seat 7: YwDw9cMqkbMznFK77rru4A folded before Flop (didn't bet)
Seat 8: DdPXdieucQ+n99u1n3A+rQ folded before Flop (didn't bet)
Seat 9: V6p0jQ/RhUsqpHLmXvEX4Q folded before Flop (didn't bet)




PokerStars Game #59942007902:  Hold'em No Limit ($0.10/$0.25) - 2009/07/01 1:53:09 ET
Table '4XGDnEByOol5up4aB2KbJw' 6-max Seat #2 is the button
Seat 1: kyRaCIljYA6l33lSKQfNsg ($26.75 in chips) 
Seat 2: SFmT9ZsVopnukjvAzrxTRg ($45.55 in chips) 
Seat 3: LtASJ9OlkqGrrUKGQlpGAw ($18.30 in chips) 
Seat 4: BV+K0Phf5VBHr7aZPKqbUQ ($25 in chips) 
Seat 5: Dh01+rohD2p9pXLYeBlC5Q ($18.65 in chips) 
Seat 6: a7Ux7aERFGCbT/L3ojVfAg ($11.55 in chips) 
LtASJ9OlkqGrrUKGQlpGAw: posts small blind $0.10
BV+K0Phf5VBHr7aZPKqbUQ: posts big blind $0.25
*** HOLE CARDS ***
Dh01+rohD2p9pXLYeBlC5Q: calls $0.25
a7Ux7aERFGCbT/L3ojVfAg: calls $0.25
kyRaCIljYA6l33lSKQfNsg: raises $0.50 to $0.75
SFmT9ZsVopnukjvAzrxTRg: folds 
LtASJ9OlkqGrrUKGQlpGAw: folds 
BV+K0Phf5VBHr7aZPKqbUQ: folds 
Dh01+rohD2p9pXLYeBlC5Q: calls $0.50
a7Ux7aERFGCbT/L3ojVfAg: calls $0.50
*** FLOP *** [Js 7d 8h]
Dh01+rohD2p9pXLYeBlC5Q: checks 
a7Ux7aERFGCbT/L3ojVfAg: checks 
kyRaCIljYA6l33lSKQfNsg: checks 
*** TURN *** [Js 7d 8h] [7s]
Dh01+rohD2p9pXLYeBlC5Q: bets $1
a7Ux7aERFGCbT/L3ojVfAg: folds 
kyRaCIljYA6l33lSKQfNsg: folds 
Uncalled bet ($1) returned to Dh01+rohD2p9pXLYeBlC5Q
Dh01+rohD2p9pXLYeBlC5Q collected $2.50 from pot
*** SUMMARY ***
Total pot $2.60 | Rake $0.10 
Board [Js 7d 8h 7s]
Seat 1: kyRaCIljYA6l33lSKQfNsg folded on the Turn
Seat 2: SFmT9ZsVopnukjvAzrxTRg (button) folded before Flop (didn't bet)
Seat 3: LtASJ9OlkqGrrUKGQlpGAw (small blind) folded before Flop
Seat 4: BV+K0Phf5VBHr7aZPKqbUQ (big blind) folded before Flop
Seat 5: Dh01+rohD2p9pXLYeBlC5Q collected ($2.50)
Seat 6: a7Ux7aERFGCbT/L3ojVfAg folded on the Turn




PokerStars Game #59942008082:  Hold'em No Limit ($0.10/$0.25) - 2009/07/01 1:53:09 ET
Table 'ykyWGjhNu7AvZXov27T4ew' 9-max Seat #6 is the button
Seat 1: skUI2T7o4P1rz460mMbAOg ($10.25 in chips) 
Seat 2: MG90wfSJZnOejs/KD3vlQQ ($38.85 in chips) 
Seat 3: NPI9ArW8kwrb6a2IAL6xMQ ($26.25 in chips) 
Seat 4: W6tExOcYX7qiy6Qdp+ZwFA ($5.95 in chips) 
Seat 5: CmngQmkKTp8tkl6GMRTl6w ($16.30 in chips) 
Seat 6: AiXn/9o1EwOPZUHujnh/bA ($19.80 in chips) 
Seat 9: H5Se03ZqSX7tbULXur2MAg ($24.75 in chips) 
H5Se03ZqSX7tbULXur2MAg: posts small blind $0.10
skUI2T7o4P1rz460mMbAOg: posts big blind $0.25
*** HOLE CARDS ***
MG90wfSJZnOejs/KD3vlQQ: folds 
NPI9ArW8kwrb6a2IAL6xMQ: calls $0.25
W6tExOcYX7qiy6Qdp+ZwFA: folds 
CmngQmkKTp8tkl6GMRTl6w: folds 
AiXn/9o1EwOPZUHujnh/bA: raises $0.50 to $0.75
H5Se03ZqSX7tbULXur2MAg: folds 
skUI2T7o4P1rz460mMbAOg: folds 
NPI9ArW8kwrb6a2IAL6xMQ: calls $0.50
*** FLOP *** [7h 8s Kh]
NPI9ArW8kwrb6a2IAL6xMQ: checks 
AiXn/9o1EwOPZUHujnh/bA: bets $1.25
NPI9ArW8kwrb6a2IAL6xMQ: folds 
Uncalled bet ($1.25) returned to AiXn/9o1EwOPZUHujnh/bA
AiXn/9o1EwOPZUHujnh/bA collected $1.80 from pot
*** SUMMARY ***
Total pot $1.85 | Rake $0.05 
Board [7h 8s Kh]
Seat 1: skUI2T7o4P1rz460mMbAOg (big blind) folded before Flop
Seat 2: MG90wfSJZnOejs/KD3vlQQ folded before Flop (didn't bet)
Seat 3: NPI9ArW8kwrb6a2IAL6xMQ folded on the Flop
Seat 4: W6tExOcYX7qiy6Qdp+ZwFA folded before Flop (didn't bet)
Seat 5: CmngQmkKTp8tkl6GMRTl6w folded before Flop (didn't bet)
Seat 6: AiXn/9o1EwOPZUHujnh/bA (button) collected ($1.80)
Seat 9: H5Se03ZqSX7tbULXur2MAg (small blind) folded before Flop




PokerStars Game #59942008638:  Hold'em No Limit ($0.10/$0.25) - 2009/07/01 1:53:10 ET
Table 'VQNfcI8vTBCTvRfd3veTLQ' 6-max Seat #2 is the button
Seat 1: QiL+lEgEWwy21jk/ltaRLg ($13.15 in chips) 
Seat 2: 79ID/ub1Pt/mDpCprVmOoA ($31.50 in chips) 
Seat 3: LtASJ9OlkqGrrUKGQlpGAw ($10.75 in chips) 
Seat 4: QIWnfLSqfMcoFfdDe5LZPg ($46.85 in chips) 
Seat 5: gX2vbKwS/8zZPENAWB7hxQ ($25 in chips) 
Seat 6: LJI7A1YgDM7hgh7o56+ReQ ($25 in chips) 
LtASJ9OlkqGrrUKGQlpGAw: posts small blind $0.10
QIWnfLSqfMcoFfdDe5LZPg: posts big blind $0.25
*** HOLE CARDS ***
gX2vbKwS/8zZPENAWB7hxQ: calls $0.25
LJI7A1YgDM7hgh7o56+ReQ: folds 
QiL+lEgEWwy21jk/ltaRLg: calls $0.25
79ID/ub1Pt/mDpCprVmOoA: folds 
LtASJ9OlkqGrrUKGQlpGAw: folds 
QIWnfLSqfMcoFfdDe5LZPg: checks 
*** FLOP *** [5d 6s 7d]
QIWnfLSqfMcoFfdDe5LZPg: checks 
gX2vbKwS/8zZPENAWB7hxQ: checks 
QiL+lEgEWwy21jk/ltaRLg: bets $0.75
QIWnfLSqfMcoFfdDe5LZPg: folds 
gX2vbKwS/8zZPENAWB7hxQ: calls $0.75
*** TURN *** [5d 6s 7d] [2d]
gX2vbKwS/8zZPENAWB7hxQ: checks 
QiL+lEgEWwy21jk/ltaRLg: checks 
*** RIVER *** [5d 6s 7d 2d] [Ah]
gX2vbKwS/8zZPENAWB7hxQ: bets $1.25
QiL+lEgEWwy21jk/ltaRLg: calls $1.25
*** SHOW DOWN ***
gX2vbKwS/8zZPENAWB7hxQ: shows [Td Ac] (a pair of Aces)
QiL+lEgEWwy21jk/ltaRLg: mucks hand 
gX2vbKwS/8zZPENAWB7hxQ collected $4.65 from pot
*** SUMMARY ***
Total pot $4.85 | Rake $0.20 
Board [5d 6s 7d 2d Ah]
Seat 1: QiL+lEgEWwy21jk/ltaRLg mucked
Seat 2: 79ID/ub1Pt/mDpCprVmOoA (button) folded before Flop (didn't bet)
Seat 3: LtASJ9OlkqGrrUKGQlpGAw (small blind) folded before Flop
Seat 4: QIWnfLSqfMcoFfdDe5LZPg (big blind) folded on the Flop
Seat 5: gX2vbKwS/8zZPENAWB7hxQ showed [Td Ac] and won ($4.65) with a pair of Aces
Seat 6: LJI7A1YgDM7hgh7o56+ReQ folded before Flop (didn't bet)




PokerStars Game #59942008318:  Hold'em No Limit ($0.10/$0.25) - 2009/07/01 1:53:10 ET
Table 'SbSV5tlgLp0+/Z+13PW3Hg' 9-max Seat #8 is the button
Seat 1: x+W5+3qsdY4Iszf0hoH+Aw ($18.30 in chips) 
Seat 2: zDrucyjVn5aeekNEc3cJrA ($13.40 in chips) 
Seat 3: CT7Xj/V/O5rBlhtt+RZeFQ ($25.35 in chips) 
Seat 4: puj3K/wrNjEj86ZL/MyfLA ($8.75 in chips) 
Seat 5: clJsV3v77RS07bDKY+705w ($5.80 in chips) 
Seat 6: pN3IHvAKm2fz+sTRARTcrg ($25 in chips) 
Seat 7: 3PmVnC/15cl4oyI1TKIt4g ($4.65 in chips) 
Seat 8: qBdqLaJhO+1itcMk70bsfA ($10.35 in chips) 
CGjLyv/AvljZy2g76nYkzQ will be allowed to play after the button
x+W5+3qsdY4Iszf0hoH+Aw: posts small blind $0.10
zDrucyjVn5aeekNEc3cJrA: posts big blind $0.25
*** HOLE CARDS ***
CT7Xj/V/O5rBlhtt+RZeFQ: folds 
puj3K/wrNjEj86ZL/MyfLA: calls $0.25
clJsV3v77RS07bDKY+705w: folds 
pN3IHvAKm2fz+sTRARTcrg: folds 
3PmVnC/15cl4oyI1TKIt4g: folds 
qBdqLaJhO+1itcMk70bsfA: calls $0.25
x+W5+3qsdY4Iszf0hoH+Aw: calls $0.15
zDrucyjVn5aeekNEc3cJrA: checks 
*** FLOP *** [Ad 7c 4d]
x+W5+3qsdY4Iszf0hoH+Aw: checks 
zDrucyjVn5aeekNEc3cJrA: checks 
puj3K/wrNjEj86ZL/MyfLA: checks 
qBdqLaJhO+1itcMk70bsfA: checks 
*** TURN *** [Ad 7c 4d] [Ac]
x+W5+3qsdY4Iszf0hoH+Aw: checks 
zDrucyjVn5aeekNEc3cJrA: checks 
puj3K/wrNjEj86ZL/MyfLA: bets $0.25
qBdqLaJhO+1itcMk70bsfA: calls $0.25
x+W5+3qsdY4Iszf0hoH+Aw: folds 
zDrucyjVn5aeekNEc3cJrA: folds 
*** RIVER *** [Ad 7c 4d Ac] [Td]
puj3K/wrNjEj86ZL/MyfLA: checks 
qBdqLaJhO+1itcMk70bsfA: checks 
*** SHOW DOWN ***
puj3K/wrNjEj86ZL/MyfLA: shows [Qd 9c] (a pair of Aces)
qBdqLaJhO+1itcMk70bsfA: mucks hand 
puj3K/wrNjEj86ZL/MyfLA collected $1.45 from pot
*** SUMMARY ***
Total pot $1.50 | Rake $0.05 
Board [Ad 7c 4d Ac Td]
Seat 1: x+W5+3qsdY4Iszf0hoH+Aw (small blind) folded on the Turn
Seat 2: zDrucyjVn5aeekNEc3cJrA (big blind) folded on the Turn
Seat 3: CT7Xj/V/O5rBlhtt+RZeFQ folded before Flop (didn't bet)
Seat 4: puj3K/wrNjEj86ZL/MyfLA showed [Qd 9c] and won ($1.45) with a pair of Aces
Seat 5: clJsV3v77RS07bDKY+705w folded before Flop (didn't bet)
Seat 6: pN3IHvAKm2fz+sTRARTcrg folded before Flop (didn't bet)
Seat 7: 3PmVnC/15cl4oyI1TKIt4g folded before Flop (didn't bet)
Seat 8: qBdqLaJhO+1itcMk70bsfA (button) mucked




PokerStars Game #59942008614:  Hold'em No Limit ($0.10/$0.25) - 2009/07/01 1:53:10 ET
Table '9iHhO6FyZVM8XpSc23TIgg' 6-max Seat #4 is the button
Seat 2: bJFzs6QmEEnz4miMfSDtcg ($20.25 in chips) 
Seat 3: TSmua8tGK3sTbwi0ynrW9Q ($40.50 in chips) 
Seat 4: cfJccEfyn6IkquPN08hFsA ($25.65 in chips) 
Seat 5: OMGl+YMGogf2JWIRfT2/Yg ($9.50 in chips) 
Seat 6: iyZxqznXjv3vtvOJymkoLQ ($33.85 in chips) 
OMGl+YMGogf2JWIRfT2/Yg: posts small blind $0.10
iyZxqznXjv3vtvOJymkoLQ: posts big blind $0.25
wvIIdlbCgePONQwXjx9xzQ: sits out 
*** HOLE CARDS ***
bJFzs6QmEEnz4miMfSDtcg: folds 
TSmua8tGK3sTbwi0ynrW9Q: folds 
cfJccEfyn6IkquPN08hFsA: raises $0.50 to $0.75
OMGl+YMGogf2JWIRfT2/Yg: folds 
iyZxqznXjv3vtvOJymkoLQ: folds 
Uncalled bet ($0.50) returned to cfJccEfyn6IkquPN08hFsA
cfJccEfyn6IkquPN08hFsA collected $0.60 from pot
cfJccEfyn6IkquPN08hFsA: doesn't show hand 
*** SUMMARY ***
Total pot $0.60 | Rake $0 
Seat 2: bJFzs6QmEEnz4miMfSDtcg folded before Flop (didn't bet)
Seat 3: TSmua8tGK3sTbwi0ynrW9Q folded before Flop (didn't bet)
Seat 4: cfJccEfyn6IkquPN08hFsA (button) collected ($0.60)
Seat 5: OMGl+YMGogf2JWIRfT2/Yg (small blind) folded before Flop
Seat 6: iyZxqznXjv3vtvOJymkoLQ (big blind) folded before Flop




PokerStars Game #59942008264:  Hold'em No Limit ($0.10/$0.25) - 2009/07/01 1:53:10 ET
Table 'nc6OeGk/wtaWV+6N+kgnZQ' 6-max Seat #2 is the button
Seat 2: 8ClCHtFXGNplITm+63KB+Q ($37.25 in chips) 
Seat 3: y8wpMWGSX2zHZijurx21mg ($7.75 in chips) 
Seat 4: 3zD3qLXT1bEffAoWGnc7wg ($31.20 in chips) 
Seat 5: HCS0lMAAPmZE2Tl8J/SuKw ($7.30 in chips) 
Seat 6: kARKwAmU6kWJfiSICTYhVw ($9.65 in chips) 
y8wpMWGSX2zHZijurx21mg: posts small blind $0.10
3zD3qLXT1bEffAoWGnc7wg: posts big blind $0.25
*** HOLE CARDS ***
Mxjust3 leaves the table
HCS0lMAAPmZE2Tl8J/SuKw: folds 
kARKwAmU6kWJfiSICTYhVw: folds 
8ClCHtFXGNplITm+63KB+Q: folds 
y8wpMWGSX2zHZijurx21mg: calls $0.15
3zD3qLXT1bEffAoWGnc7wg: checks 
*** FLOP *** [9c Td 5h]
y8wpMWGSX2zHZijurx21mg: bets $0.25
3zD3qLXT1bEffAoWGnc7wg: folds 
Uncalled bet ($0.25) returned to y8wpMWGSX2zHZijurx21mg
y8wpMWGSX2zHZijurx21mg collected $0.50 from pot
y8wpMWGSX2zHZijurx21mg: doesn't show hand 
*** SUMMARY ***
Total pot $0.50 | Rake $0 
Board [9c Td 5h]
Seat 2: 8ClCHtFXGNplITm+63KB+Q (button) folded before Flop (didn't bet)
Seat 3: y8wpMWGSX2zHZijurx21mg (small blind) collected ($0.50)
Seat 4: 3zD3qLXT1bEffAoWGnc7wg (big blind) folded on the Flop
Seat 5: HCS0lMAAPmZE2Tl8J/SuKw folded before Flop (didn't bet)
Seat 6: kARKwAmU6kWJfiSICTYhVw folded before Flop (didn't bet)




PokerStars Game #59942008342:  Hold'em No Limit ($0.10/$0.25) - 2009/07/01 1:53:10 ET
Table 'GxdLtCpYxqT4aAbYqkEEpw' 6-max Seat #1 is the button
Seat 1: 2d/PU00mMdO9azAaXqcSbw ($9.05 in chips) 
Seat 2: MCCWc70bl051s/EF6nHRcA ($23.40 in chips) 
Seat 3: LpmZGzLpOmfZUF7EV4ZlrQ ($15.90 in chips) 
Seat 4: 6wzJiRvp8HY6t+MQGnSIzA ($13.55 in chips) 
Seat 6: DFi/Lzkjsfv8QswS80JX9Q ($25.60 in chips) 
MCCWc70bl051s/EF6nHRcA: posts small blind $0.10
LpmZGzLpOmfZUF7EV4ZlrQ: posts big blind $0.25
*** HOLE CARDS ***
6wzJiRvp8HY6t+MQGnSIzA: raises $0.50 to $0.75
DFi/Lzkjsfv8QswS80JX9Q: folds 
2d/PU00mMdO9azAaXqcSbw: calls $0.75
MCCWc70bl051s/EF6nHRcA: folds 
q6WfTUAD9mowIP63ASq2Dg has returned
LpmZGzLpOmfZUF7EV4ZlrQ: folds 
*** FLOP *** [2c 7s 8c]
6wzJiRvp8HY6t+MQGnSIzA: bets $0.75
2d/PU00mMdO9azAaXqcSbw: calls $0.75
*** TURN *** [2c 7s 8c] [9d]
6wzJiRvp8HY6t+MQGnSIzA: bets $0.75
2d/PU00mMdO9azAaXqcSbw: raises $0.75 to $1.50
6wzJiRvp8HY6t+MQGnSIzA: calls $0.75
*** RIVER *** [2c 7s 8c 9d] [6d]
6wzJiRvp8HY6t+MQGnSIzA: bets $1
2d/PU00mMdO9azAaXqcSbw: raises $1 to $2
6wzJiRvp8HY6t+MQGnSIzA: raises $1.75 to $3.75
2d/PU00mMdO9azAaXqcSbw: calls $1.75
*** SHOW DOWN ***
6wzJiRvp8HY6t+MQGnSIzA: shows [Th 8d] (a straight, Six to Ten)
2d/PU00mMdO9azAaXqcSbw: mucks hand 
6wzJiRvp8HY6t+MQGnSIzA collected $13.20 from pot
*** SUMMARY ***
Total pot $13.85 | Rake $0.65 
Board [2c 7s 8c 9d 6d]
Seat 1: 2d/PU00mMdO9azAaXqcSbw (button) mucked
Seat 2: MCCWc70bl051s/EF6nHRcA (small blind) folded before Flop
Seat 3: LpmZGzLpOmfZUF7EV4ZlrQ (big blind) folded before Flop
Seat 4: 6wzJiRvp8HY6t+MQGnSIzA showed [Th 8d] and won ($13.20) with a straight, Six to Ten
Seat 6: DFi/Lzkjsfv8QswS80JX9Q folded before Flop (didn't bet)




PokerStars Game #59942008948:  Hold'em No Limit ($0.10/$0.25) - 2009/07/01 1:53:11 ET
Table 'bIGKmJgZehWJ+FAo8b85iw' 9-max Seat #1 is the button
Seat 1: yyG4svzOpC1A+sUP/scg6w ($7 in chips) 
Seat 2: cCjRCvseA9rZn7Xr+GCCHg ($25.55 in chips) 
Seat 3: /FyMUX+W/tpNFcRWbUTJxQ ($23.85 in chips) 
Seat 4: LGxBRjCRn6KlQ/6B4eoXbA ($36.65 in chips) 
Seat 5: uLP/lYn7oKq9xCChBXsXxw ($24.65 in chips) 
Seat 6: PFNLAvMkr8qKc7xCiH0wTA ($19.90 in chips) 
Seat 7: mMd8CDS/but3UC+Zp7Up2w ($20 in chips) 
Seat 8: +2kMBNpY4nF1qNCRd8SJLA ($53.85 in chips) 
CGjLyv/AvljZy2g76nYkzQ joins the table at seat #9 
cCjRCvseA9rZn7Xr+GCCHg: posts small blind $0.10
/FyMUX+W/tpNFcRWbUTJxQ: posts big blind $0.25
*** HOLE CARDS ***
LGxBRjCRn6KlQ/6B4eoXbA: raises $0.25 to $0.50
uLP/lYn7oKq9xCChBXsXxw: folds 
PFNLAvMkr8qKc7xCiH0wTA: calls $0.50
mMd8CDS/but3UC+Zp7Up2w: folds 
+2kMBNpY4nF1qNCRd8SJLA: folds 
yyG4svzOpC1A+sUP/scg6w: folds 
cCjRCvseA9rZn7Xr+GCCHg: calls $0.40
/FyMUX+W/tpNFcRWbUTJxQ: folds 
*** FLOP *** [4c 7d Tc]
cCjRCvseA9rZn7Xr+GCCHg: bets $1
LGxBRjCRn6KlQ/6B4eoXbA: calls $1
PFNLAvMkr8qKc7xCiH0wTA: calls $1
*** TURN *** [4c 7d Tc] [Th]
cCjRCvseA9rZn7Xr+GCCHg: checks 
LGxBRjCRn6KlQ/6B4eoXbA: checks 
PFNLAvMkr8qKc7xCiH0wTA: bets $2
cCjRCvseA9rZn7Xr+GCCHg: calls $2
LGxBRjCRn6KlQ/6B4eoXbA: folds 
*** RIVER *** [4c 7d Tc Th] [8d]
cCjRCvseA9rZn7Xr+GCCHg: checks 
PFNLAvMkr8qKc7xCiH0wTA: checks 
*** SHOW DOWN ***
cCjRCvseA9rZn7Xr+GCCHg: shows [Js Jd] (two pair, Jacks and Tens)
PFNLAvMkr8qKc7xCiH0wTA: mucks hand 
cCjRCvseA9rZn7Xr+GCCHg collected $8.35 from pot
*** SUMMARY ***
Total pot $8.75 | Rake $0.40 
Board [4c 7d Tc Th 8d]
Seat 1: yyG4svzOpC1A+sUP/scg6w (button) folded before Flop (didn't bet)
Seat 2: cCjRCvseA9rZn7Xr+GCCHg (small blind) showed [Js Jd] and won ($8.35) with two pair, Jacks and Tens
Seat 3: /FyMUX+W/tpNFcRWbUTJxQ (big blind) folded before Flop
Seat 4: LGxBRjCRn6KlQ/6B4eoXbA folded on the Turn
Seat 5: uLP/lYn7oKq9xCChBXsXxw folded before Flop (didn't bet)
Seat 6: PFNLAvMkr8qKc7xCiH0wTA mucked
Seat 7: mMd8CDS/but3UC+Zp7Up2w folded before Flop (didn't bet)
Seat 8: +2kMBNpY4nF1qNCRd8SJLA folded before Flop (didn't bet)




PokerStars Game #59942008738:  Hold'em No Limit ($0.10/$0.25) - 2009/07/01 1:53:11 ET
Table 'KYX9dFNuOA9l2PV46IebqQ' 9-max Seat #3 is the button
Seat 1: qZqVFan2U+GAA/c5LQFbcw ($14.70 in chips) 
Seat 2: GeMoapCKDLc4ajT0Uk9ZQw ($9.65 in chips) 
Seat 3: Uq3NSX4cIFaXe7pbXQuU+Q ($7.20 in chips) 
Seat 4: ly/lwri2xlF+wmFsvottuQ ($4 in chips) 
Seat 5: g7MXhRmNZxv1lIkKkUKa4w ($16.25 in chips) 
Seat 6: 4QYM+pWPc3J+6i8Zv8LvLg ($25 in chips) 
Seat 8: KRWTiGM4xH+MkvPtJz4+SA ($22.30 in chips) 
Seat 9: 6NECk10orj8iqgD3pZ2A0Q ($10.05 in chips) 
ly/lwri2xlF+wmFsvottuQ: posts small blind $0.10
g7MXhRmNZxv1lIkKkUKa4w: posts big blind $0.25
I.F.R: sits out 
*** HOLE CARDS ***
4QYM+pWPc3J+6i8Zv8LvLg: calls $0.25
KRWTiGM4xH+MkvPtJz4+SA: folds 
6NECk10orj8iqgD3pZ2A0Q: folds 
qZqVFan2U+GAA/c5LQFbcw: folds 
GeMoapCKDLc4ajT0Uk9ZQw: folds 
Uq3NSX4cIFaXe7pbXQuU+Q: folds 
ly/lwri2xlF+wmFsvottuQ: calls $0.15
g7MXhRmNZxv1lIkKkUKa4w: checks 
*** FLOP *** [2d 8d 6s]
ly/lwri2xlF+wmFsvottuQ: bets $0.50
g7MXhRmNZxv1lIkKkUKa4w: folds 
4QYM+pWPc3J+6i8Zv8LvLg: calls $0.50
*** TURN *** [2d 8d 6s] [Jd]
ly/lwri2xlF+wmFsvottuQ: bets $0.50
4QYM+pWPc3J+6i8Zv8LvLg: calls $0.50
*** RIVER *** [2d 8d 6s Jd] [Ts]
ly/lwri2xlF+wmFsvottuQ: bets $0.75
4QYM+pWPc3J+6i8Zv8LvLg: raises $0.75 to $1.50
I.F.R leaves the table
ly/lwri2xlF+wmFsvottuQ: folds 
Uncalled bet ($0.75) returned to 4QYM+pWPc3J+6i8Zv8LvLg
4QYM+pWPc3J+6i8Zv8LvLg collected $4.05 from pot
*** SUMMARY ***
Total pot $4.25 | Rake $0.20 
Board [2d 8d 6s Jd Ts]
Seat 1: qZqVFan2U+GAA/c5LQFbcw folded before Flop (didn't bet)
Seat 2: GeMoapCKDLc4ajT0Uk9ZQw folded before Flop (didn't bet)
Seat 3: Uq3NSX4cIFaXe7pbXQuU+Q (button) folded before Flop (didn't bet)
Seat 4: ly/lwri2xlF+wmFsvottuQ (small blind) folded on the River
Seat 5: g7MXhRmNZxv1lIkKkUKa4w (big blind) folded on the Flop
Seat 6: 4QYM+pWPc3J+6i8Zv8LvLg collected ($4.05)
Seat 8: KRWTiGM4xH+MkvPtJz4+SA folded before Flop (didn't bet)
Seat 9: 6NECk10orj8iqgD3pZ2A0Q folded before Flop (didn't bet)




PokerStars Game #59942009044:  Hold'em No Limit ($0.10/$0.25) - 2009/07/01 1:53:11 ET
Table 'M7d9IrgQUUFFy/SZ3ksLYg' 6-max Seat #3 is the button
Seat 1: ypmjhffk/YHGc51wgVXUTw ($51.05 in chips) 
Seat 2: 8CPg15X6IHYR1pWm9ha1Sw ($25 in chips) 
Seat 3: epAUIB7h2FJXzUPRIvSkRA ($26.25 in chips) 
Seat 4: 8ClCHtFXGNplITm+63KB+Q ($25 in chips) 
Seat 5: MVzl6OsGybVDNd3Vr9LYAA ($25 in chips) 
8ClCHtFXGNplITm+63KB+Q: posts small blind $0.10
MVzl6OsGybVDNd3Vr9LYAA: posts big blind $0.25
*** HOLE CARDS ***
ypmjhffk/YHGc51wgVXUTw: folds 
8CPg15X6IHYR1pWm9ha1Sw: raises $0.50 to $0.75
ypmjhffk/YHGc51wgVXUTw leaves the table
epAUIB7h2FJXzUPRIvSkRA: calls $0.75
8ClCHtFXGNplITm+63KB+Q: calls $0.65
MVzl6OsGybVDNd3Vr9LYAA: folds 
*** FLOP *** [3d Jh 8s]
8ClCHtFXGNplITm+63KB+Q: checks 
8CPg15X6IHYR1pWm9ha1Sw: bets $1
epAUIB7h2FJXzUPRIvSkRA: folds 
8ClCHtFXGNplITm+63KB+Q: calls $1
*** TURN *** [3d Jh 8s] [Kd]
8ClCHtFXGNplITm+63KB+Q: checks 
8CPg15X6IHYR1pWm9ha1Sw: bets $3.50
8ClCHtFXGNplITm+63KB+Q: folds 
Uncalled bet ($3.50) returned to 8CPg15X6IHYR1pWm9ha1Sw
8CPg15X6IHYR1pWm9ha1Sw collected $4.30 from pot
*** SUMMARY ***
Total pot $4.50 | Rake $0.20 
Board [3d Jh 8s Kd]
Seat 1: ypmjhffk/YHGc51wgVXUTw folded before Flop (didn't bet)
Seat 2: 8CPg15X6IHYR1pWm9ha1Sw collected ($4.30)
Seat 3: epAUIB7h2FJXzUPRIvSkRA (button) folded on the Flop
Seat 4: 8ClCHtFXGNplITm+63KB+Q (small blind) folded on the Turn
Seat 5: MVzl6OsGybVDNd3Vr9LYAA (big blind) folded before Flop




PokerStars Game #59942009186:  Hold'em No Limit ($0.10/$0.25) - 2009/07/01 1:53:11 ET
Table 'HzFR0rxmDAPu5GzYR0AlYg' 6-max Seat #6 is the button
Seat 1: v+QfkGiuj9bgtuNoVnDO8w ($34.90 in chips) 
Seat 2: UA5OsKS3VPaxa7uC8La/kA ($52.55 in chips) 
Seat 3: kG34n23qFQA3nzdOJTQ1dA ($23.55 in chips) 
Seat 4: Mhj3q7cxev+XjXZxEE6/Cw ($25.35 in chips) 
Seat 6: jp34e617tIzV8tKIWmfAbA ($35.30 in chips) 
v+QfkGiuj9bgtuNoVnDO8w: posts small blind $0.10
UA5OsKS3VPaxa7uC8La/kA: posts big blind $0.25
*** HOLE CARDS ***
kG34n23qFQA3nzdOJTQ1dA: folds 
Mhj3q7cxev+XjXZxEE6/Cw: folds 
jp34e617tIzV8tKIWmfAbA: folds 
v+QfkGiuj9bgtuNoVnDO8w: folds 
Uncalled bet ($0.15) returned to UA5OsKS3VPaxa7uC8La/kA
UA5OsKS3VPaxa7uC8La/kA collected $0.20 from pot
*** SUMMARY ***
Total pot $0.20 | Rake $0 
Seat 1: v+QfkGiuj9bgtuNoVnDO8w (small blind) folded before Flop
Seat 2: UA5OsKS3VPaxa7uC8La/kA (big blind) collected ($0.20)
Seat 3: kG34n23qFQA3nzdOJTQ1dA folded before Flop (didn't bet)
Seat 4: Mhj3q7cxev+XjXZxEE6/Cw folded before Flop (didn't bet)
Seat 6: jp34e617tIzV8tKIWmfAbA (button) folded before Flop (didn't bet)




PokerStars Game #59942008974:  Hold'em No Limit ($0.10/$0.25) - 2009/07/01 1:53:11 ET
Table '52Meibn9NOL4XtVi1p2Upw' 9-max Seat #2 is the button
Seat 1: W6tExOcYX7qiy6Qdp+ZwFA ($6.55 in chips) 
Seat 2: CGjLyv/AvljZy2g76nYkzQ ($25 in chips) 
Seat 3: Bb42QRQMhg5/Y0vHP8/2Xw ($25.75 in chips) 
Seat 4: oLa/tXLfSLLB28mcLGrxcg ($31.65 in chips) 
Seat 5: MXCztnYJ58KLHMztZvKrxA ($10 in chips) 
Seat 6: N5sUK8M0br9djLrW97V9pQ ($28.50 in chips) 
Seat 7: Qduu7ikeizo6q6Ei9YvcJA ($33.35 in chips) 
Seat 8: w7VrLGwaVQzOQXfRqJitMQ ($21.25 in chips) 
Seat 9: RCqMONFrSPSArZh2Jsar/w ($15.95 in chips) 
Bb42QRQMhg5/Y0vHP8/2Xw: posts small blind $0.10
oLa/tXLfSLLB28mcLGrxcg: posts big blind $0.25
*** HOLE CARDS ***
MXCztnYJ58KLHMztZvKrxA: folds 
N5sUK8M0br9djLrW97V9pQ: calls $0.25
Qduu7ikeizo6q6Ei9YvcJA: folds 
w7VrLGwaVQzOQXfRqJitMQ: folds 
RCqMONFrSPSArZh2Jsar/w: folds 
W6tExOcYX7qiy6Qdp+ZwFA: folds 
CGjLyv/AvljZy2g76nYkzQ: raises $1 to $1.25
Bb42QRQMhg5/Y0vHP8/2Xw: calls $1.15
oLa/tXLfSLLB28mcLGrxcg: folds 
N5sUK8M0br9djLrW97V9pQ: calls $1
*** FLOP *** [8h 4h 2h]
Bb42QRQMhg5/Y0vHP8/2Xw: checks 
N5sUK8M0br9djLrW97V9pQ: checks 
CGjLyv/AvljZy2g76nYkzQ: checks 
*** TURN *** [8h 4h 2h] [Ks]
Bb42QRQMhg5/Y0vHP8/2Xw: checks 
N5sUK8M0br9djLrW97V9pQ: checks 
CGjLyv/AvljZy2g76nYkzQ: bets $2.75
Bb42QRQMhg5/Y0vHP8/2Xw: folds 
N5sUK8M0br9djLrW97V9pQ: folds 
Uncalled bet ($2.75) returned to CGjLyv/AvljZy2g76nYkzQ
CGjLyv/AvljZy2g76nYkzQ collected $3.80 from pot
CGjLyv/AvljZy2g76nYkzQ: doesn't show hand 
*** SUMMARY ***
Total pot $4 | Rake $0.20 
Board [8h 4h 2h Ks]
Seat 1: W6tExOcYX7qiy6Qdp+ZwFA folded before Flop (didn't bet)
Seat 2: CGjLyv/AvljZy2g76nYkzQ (button) collected ($3.80)
Seat 3: Bb42QRQMhg5/Y0vHP8/2Xw (small blind) folded on the Turn
Seat 4: oLa/tXLfSLLB28mcLGrxcg (big blind) folded before Flop
Seat 5: MXCztnYJ58KLHMztZvKrxA folded before Flop (didn't bet)
Seat 6: N5sUK8M0br9djLrW97V9pQ folded on the Turn
Seat 7: Qduu7ikeizo6q6Ei9YvcJA folded before Flop (didn't bet)
Seat 8: w7VrLGwaVQzOQXfRqJitMQ folded before Flop (didn't bet)
Seat 9: RCqMONFrSPSArZh2Jsar/w folded before Flop (didn't bet)




PokerStars Game #59942009114:  Hold'em No Limit ($0.10/$0.25) - 2009/07/01 1:53:11 ET
Table '6aL2C8IFwHHr6SG6RgXaow' 9-max Seat #7 is the button
Seat 1: FcL757vvzKRPFZ6h7YsPHA ($10.30 in chips) 
Seat 2: UmzixCpC0bAc1lDEjgB3NQ ($9.10 in chips) 
Seat 3: clJsV3v77RS07bDKY+705w ($5 in chips) 
Seat 4: BT6Oal0iO4P6kDuT7HFQDw ($19.15 in chips) 
Seat 5: wre31HfyzQGpIvID1istxw ($23.40 in chips) 
Seat 6: gehe91e0IyVT0QU/XBkEyg ($26.15 in chips) 
Seat 7: E0iYnEVO2ho7dH3QcCjw7g ($19.25 in chips) 
Seat 8: rQhYIYXSyH/IivYM1dlV5A ($26.25 in chips) 
Seat 9: CgIo2ItZqi4o3ayVG6HanQ ($23.50 in chips) 
rQhYIYXSyH/IivYM1dlV5A: posts small blind $0.10
CgIo2ItZqi4o3ayVG6HanQ: posts big blind $0.25
*** HOLE CARDS ***
FcL757vvzKRPFZ6h7YsPHA: folds 
UmzixCpC0bAc1lDEjgB3NQ: folds 
clJsV3v77RS07bDKY+705w: folds 
BT6Oal0iO4P6kDuT7HFQDw: raises $0.50 to $0.75
wre31HfyzQGpIvID1istxw: calls $0.75
gehe91e0IyVT0QU/XBkEyg: folds 
E0iYnEVO2ho7dH3QcCjw7g: folds 
rQhYIYXSyH/IivYM1dlV5A: folds 
CgIo2ItZqi4o3ayVG6HanQ: folds 
*** FLOP *** [6c 8d 4d]
BT6Oal0iO4P6kDuT7HFQDw: bets $1
wre31HfyzQGpIvID1istxw: raises $1.50 to $2.50
BT6Oal0iO4P6kDuT7HFQDw: calls $1.50
*** TURN *** [6c 8d 4d] [Ad]
BT6Oal0iO4P6kDuT7HFQDw: checks 
wre31HfyzQGpIvID1istxw: bets $6.25
BT6Oal0iO4P6kDuT7HFQDw: folds 
Uncalled bet ($6.25) returned to wre31HfyzQGpIvID1istxw
wre31HfyzQGpIvID1istxw collected $6.55 from pot
wre31HfyzQGpIvID1istxw: doesn't show hand 
*** SUMMARY ***
Total pot $6.85 | Rake $0.30 
Board [6c 8d 4d Ad]
Seat 1: FcL757vvzKRPFZ6h7YsPHA folded before Flop (didn't bet)
Seat 2: UmzixCpC0bAc1lDEjgB3NQ folded before Flop (didn't bet)
Seat 3: clJsV3v77RS07bDKY+705w folded before Flop (didn't bet)
Seat 4: BT6Oal0iO4P6kDuT7HFQDw folded on the Turn
Seat 5: wre31HfyzQGpIvID1istxw collected ($6.55)
Seat 6: gehe91e0IyVT0QU/XBkEyg folded before Flop (didn't bet)
Seat 7: E0iYnEVO2ho7dH3QcCjw7g (button) folded before Flop (didn't bet)
Seat 8: rQhYIYXSyH/IivYM1dlV5A (small blind) folded before Flop
Seat 9: CgIo2ItZqi4o3ayVG6HanQ (big blind) folded before Flop




PokerStars Game #59942009038:  Hold'em No Limit ($0.10/$0.25) - 2009/07/01 1:53:11 ET
Table '+UzantPJ4smVdrh+4GTu1w' 6-max Seat #1 is the button
Seat 1: TSmua8tGK3sTbwi0ynrW9Q ($39.15 in chips) 
Seat 2: tcbEu7VzyHQ+0lh+skbQhQ ($29.85 in chips) 
Seat 3: SS/yfeArhULzIcOPe8MdPg ($32.65 in chips) 
Seat 4: UmcUp27+PbgBItv3ZNlAWQ ($26.45 in chips) 
Seat 5: cj4VBQya7HtVL2zCGd5jLQ ($55.35 in chips) 
Seat 6: fZQg9veL7Dd/Z04ZTjC+wQ ($26.40 in chips) 
tcbEu7VzyHQ+0lh+skbQhQ: posts small blind $0.10
SS/yfeArhULzIcOPe8MdPg: posts big blind $0.25
*** HOLE CARDS ***
UmcUp27+PbgBItv3ZNlAWQ: folds 
cj4VBQya7HtVL2zCGd5jLQ: folds 
fZQg9veL7Dd/Z04ZTjC+wQ: raises $0.50 to $0.75
TSmua8tGK3sTbwi0ynrW9Q: folds 
tcbEu7VzyHQ+0lh+skbQhQ: folds 
SS/yfeArhULzIcOPe8MdPg: folds 
Uncalled bet ($0.50) returned to fZQg9veL7Dd/Z04ZTjC+wQ
fZQg9veL7Dd/Z04ZTjC+wQ collected $0.60 from pot
fZQg9veL7Dd/Z04ZTjC+wQ: doesn't show hand 
*** SUMMARY ***
Total pot $0.60 | Rake $0 
Seat 1: TSmua8tGK3sTbwi0ynrW9Q (button) folded before Flop (didn't bet)
Seat 2: tcbEu7VzyHQ+0lh+skbQhQ (small blind) folded before Flop
Seat 3: SS/yfeArhULzIcOPe8MdPg (big blind) folded before Flop
Seat 4: UmcUp27+PbgBItv3ZNlAWQ folded before Flop (didn't bet)
Seat 5: cj4VBQya7HtVL2zCGd5jLQ folded before Flop (didn't bet)
Seat 6: fZQg9veL7Dd/Z04ZTjC+wQ collected ($0.60)




PokerStars Game #59942008910:  Hold'em No Limit ($0.10/$0.25) - 2009/07/01 1:53:11 ET
Table 'MiquQrQZJJq9ZtgRIp9HFQ' 6-max Seat #4 is the button
Seat 1: c3J/KYZ4cNsUEuz8v57I5A ($25.40 in chips) 
Seat 2: 2+6voGl1T1DO63JePptI3g ($24.85 in chips) 
Seat 3: 9h7TNZ1TDGRUJXA6rI+ZTw ($10 in chips) 
Seat 4: wAKC8C/zN0c8V5v13dm9mA ($51.30 in chips) 
Seat 5: iyZxqznXjv3vtvOJymkoLQ ($26.50 in chips) 
Seat 6: GbCVUNssQ7mqsPWr7J4d3w ($4.50 in chips) 
iyZxqznXjv3vtvOJymkoLQ: posts small blind $0.10
GbCVUNssQ7mqsPWr7J4d3w: posts big blind $0.25
*** HOLE CARDS ***
c3J/KYZ4cNsUEuz8v57I5A: folds 
2+6voGl1T1DO63JePptI3g has timed out
2+6voGl1T1DO63JePptI3g: folds 
2+6voGl1T1DO63JePptI3g is sitting out
9h7TNZ1TDGRUJXA6rI+ZTw: folds 
wAKC8C/zN0c8V5v13dm9mA: folds 
iyZxqznXjv3vtvOJymkoLQ: folds 
Uncalled bet ($0.15) returned to GbCVUNssQ7mqsPWr7J4d3w
2+6voGl1T1DO63JePptI3g leaves the table
GbCVUNssQ7mqsPWr7J4d3w collected $0.20 from pot
GbCVUNssQ7mqsPWr7J4d3w: doesn't show hand 
*** SUMMARY ***
Total pot $0.20 | Rake $0 
Seat 1: c3J/KYZ4cNsUEuz8v57I5A folded before Flop (didn't bet)
Seat 2: 2+6voGl1T1DO63JePptI3g folded before Flop (didn't bet)
Seat 3: 9h7TNZ1TDGRUJXA6rI+ZTw folded before Flop (didn't bet)
Seat 4: wAKC8C/zN0c8V5v13dm9mA (button) folded before Flop (didn't bet)
Seat 5: iyZxqznXjv3vtvOJymkoLQ (small blind) folded before Flop
Seat 6: GbCVUNssQ7mqsPWr7J4d3w (big blind) collected ($0.20)




PokerStars Game #59942009092:  Hold'em No Limit ($0.10/$0.25) - 2009/07/01 1:53:11 ET
Table 'mdub7rJf3Z5tCT9s/+1+Wg' 9-max Seat #4 is the button
Seat 2: 539MC3AwKLWVFwzABc644Q ($10.55 in chips) 
Seat 4: fDGyaQz0cs2s4FOYxkbIHA ($14.75 in chips) 
Seat 5: dfNim92Z6XK1/h5SFW5vDg ($26.25 in chips) 
Seat 7: woe+9KKk+L3pZgMTuHcmog ($15.55 in chips) 
Seat 8: bXpVeaSTPBFSPJmeXxO7nw ($4.65 in chips) 
Seat 9: EgDmMA1aiBPBqXe32LIyEw ($6.75 in chips) 
dfNim92Z6XK1/h5SFW5vDg: posts small blind $0.10
woe+9KKk+L3pZgMTuHcmog: posts big blind $0.25
*** HOLE CARDS ***
bXpVeaSTPBFSPJmeXxO7nw: folds 
EgDmMA1aiBPBqXe32LIyEw: folds 
539MC3AwKLWVFwzABc644Q: folds 
fDGyaQz0cs2s4FOYxkbIHA: folds 
dfNim92Z6XK1/h5SFW5vDg: calls $0.15
woe+9KKk+L3pZgMTuHcmog: checks 
*** FLOP *** [Ah Jd 7s]
dfNim92Z6XK1/h5SFW5vDg: checks 
woe+9KKk+L3pZgMTuHcmog: bets $1
dfNim92Z6XK1/h5SFW5vDg: folds 
Uncalled bet ($1) returned to woe+9KKk+L3pZgMTuHcmog
woe+9KKk+L3pZgMTuHcmog collected $0.50 from pot
*** SUMMARY ***
Total pot $0.50 | Rake $0 
Board [Ah Jd 7s]
Seat 2: 539MC3AwKLWVFwzABc644Q folded before Flop (didn't bet)
Seat 4: fDGyaQz0cs2s4FOYxkbIHA (button) folded before Flop (didn't bet)
Seat 5: dfNim92Z6XK1/h5SFW5vDg (small blind) folded on the Flop
Seat 7: woe+9KKk+L3pZgMTuHcmog (big blind) collected ($0.50)
Seat 8: bXpVeaSTPBFSPJmeXxO7nw folded before Flop (didn't bet)
Seat 9: EgDmMA1aiBPBqXe32LIyEw folded before Flop (didn't bet)




PokerStars Game #59942008686:  Hold'em No Limit ($0.10/$0.25) - 2009/07/01 1:53:11 ET
Table 'rO1I30HnuCPB0M8qEX1TCQ' 9-max Seat #1 is the button
Seat 1: Utuc935Snv3aKbSqGcz2Kg ($11.75 in chips) 
Seat 2: z1hPotrGOZjUjyoopZ7Ulg ($24.90 in chips) 
Seat 3: 2wcFsZsqEP5w1StUTVzJCg ($12.80 in chips) 
Seat 4: yyG4svzOpC1A+sUP/scg6w ($18.05 in chips) 
Seat 6: 5n7e7I+px7c6CQmLpPbtsg ($6.25 in chips) 
Seat 7: AiXn/9o1EwOPZUHujnh/bA ($21.65 in chips) 
Seat 8: CGjLyv/AvljZy2g76nYkzQ ($28.20 in chips) 
z1hPotrGOZjUjyoopZ7Ulg: posts small blind $0.10
2wcFsZsqEP5w1StUTVzJCg: posts big blind $0.25
W2YYHvqjaEpRrO7stZkClQ: sits out 
SpiiQQAzy4MUgV3I5W8giw: sits out 
*** HOLE CARDS ***
yyG4svzOpC1A+sUP/scg6w: folds 
5n7e7I+px7c6CQmLpPbtsg: folds 
AiXn/9o1EwOPZUHujnh/bA: folds 
CGjLyv/AvljZy2g76nYkzQ: folds 
Utuc935Snv3aKbSqGcz2Kg: folds 
z1hPotrGOZjUjyoopZ7Ulg: calls $0.15
2wcFsZsqEP5w1StUTVzJCg: checks 
*** FLOP *** [5s 4h Js]
z1hPotrGOZjUjyoopZ7Ulg: checks 
2wcFsZsqEP5w1StUTVzJCg: checks 
*** TURN *** [5s 4h Js] [6c]
z1hPotrGOZjUjyoopZ7Ulg: checks 
2wcFsZsqEP5w1StUTVzJCg: checks 
*** RIVER *** [5s 4h Js 6c] [8d]
z1hPotrGOZjUjyoopZ7Ulg: bets $0.50
2wcFsZsqEP5w1StUTVzJCg: folds 
Uncalled bet ($0.50) returned to z1hPotrGOZjUjyoopZ7Ulg
z1hPotrGOZjUjyoopZ7Ulg collected $0.50 from pot
*** SUMMARY ***
Total pot $0.50 | Rake $0 
Board [5s 4h Js 6c 8d]
Seat 1: Utuc935Snv3aKbSqGcz2Kg (button) folded before Flop (didn't bet)
Seat 2: z1hPotrGOZjUjyoopZ7Ulg (small blind) collected ($0.50)
Seat 3: 2wcFsZsqEP5w1StUTVzJCg (big blind) folded on the River
Seat 4: yyG4svzOpC1A+sUP/scg6w folded before Flop (didn't bet)
Seat 6: 5n7e7I+px7c6CQmLpPbtsg folded before Flop (didn't bet)
Seat 7: AiXn/9o1EwOPZUHujnh/bA folded before Flop (didn't bet)
Seat 8: CGjLyv/AvljZy2g76nYkzQ folded before Flop (didn't bet)




PokerStars Game #59942009182:  Hold'em No Limit ($0.10/$0.25) - 2009/07/01 1:53:11 ET
Table '+giHa6FUL6U5/AZnCJEGvQ' 9-max Seat #6 is the button
Seat 4: XQRLaOXTf3pRraVvFq7T1g ($4.50 in chips) 
Seat 5: zDrucyjVn5aeekNEc3cJrA ($44.15 in chips) 
Seat 6: GTMnTen6sQSoCpS9sggLbg ($25.70 in chips) 
XQRLaOXTf3pRraVvFq7T1g: posts small blind $0.10
zDrucyjVn5aeekNEc3cJrA: posts big blind $0.25
*** HOLE CARDS ***
GTMnTen6sQSoCpS9sggLbg: folds 
XQRLaOXTf3pRraVvFq7T1g: raises $0.50 to $0.75
zDrucyjVn5aeekNEc3cJrA: folds 
Uncalled bet ($0.50) returned to XQRLaOXTf3pRraVvFq7T1g
XQRLaOXTf3pRraVvFq7T1g collected $0.50 from pot
XQRLaOXTf3pRraVvFq7T1g: doesn't show hand 
*** SUMMARY ***
Total pot $0.50 | Rake $0 
Seat 4: XQRLaOXTf3pRraVvFq7T1g (small blind) collected ($0.50)
Seat 5: zDrucyjVn5aeekNEc3cJrA (big blind) folded before Flop
Seat 6: GTMnTen6sQSoCpS9sggLbg (button) folded before Flop (didn't bet)




PokerStars Game #59942009250:  Hold'em No Limit ($0.10/$0.25) - 2009/07/01 1:53:12 ET
Table 'RUOqTfzbAVGS5x+J9aZMHA' 9-max Seat #3 is the button
Seat 1: DnDcAdn9P0zGovMERigpFA ($28.65 in chips) 
Seat 2: Z5ZtGOON8kmSdSCll9Z3XA ($11.30 in chips) 
Seat 3: Th3FldXKQW6hWVVPahaoOQ ($25 in chips) 
Seat 4: K9Az8li/CO2TicltVWKamA ($21 in chips) 
Seat 6: ljemhp25Zg+nlA9DLCIiUw ($48 in chips) 
Seat 7: zgi+EUykT/pZQpoUG6+oEg ($5 in chips) 
Seat 9: cZ99hugmLBj9KhTlc8nCSw ($25 in chips) 
K9Az8li/CO2TicltVWKamA: posts small blind $0.10
MtVtHDqIJTyUcXkRBBDIVA: is sitting out 
ljemhp25Zg+nlA9DLCIiUw: posts big blind $0.25
*** HOLE CARDS ***
MtVtHDqIJTyUcXkRBBDIVA has returned
zgi+EUykT/pZQpoUG6+oEg: raises $0.75 to $1
cZ99hugmLBj9KhTlc8nCSw: folds 
DnDcAdn9P0zGovMERigpFA: folds 
Z5ZtGOON8kmSdSCll9Z3XA: folds 
Th3FldXKQW6hWVVPahaoOQ: folds 
K9Az8li/CO2TicltVWKamA: folds 
ljemhp25Zg+nlA9DLCIiUw: folds 
Uncalled bet ($0.75) returned to zgi+EUykT/pZQpoUG6+oEg
zgi+EUykT/pZQpoUG6+oEg collected $0.60 from pot
zgi+EUykT/pZQpoUG6+oEg: doesn't show hand 
*** SUMMARY ***
Total pot $0.60 | Rake $0 
Seat 1: DnDcAdn9P0zGovMERigpFA folded before Flop (didn't bet)
Seat 2: Z5ZtGOON8kmSdSCll9Z3XA folded before Flop (didn't bet)
Seat 3: Th3FldXKQW6hWVVPahaoOQ (button) folded before Flop (didn't bet)
Seat 4: K9Az8li/CO2TicltVWKamA (small blind) folded before Flop
Seat 6: ljemhp25Zg+nlA9DLCIiUw (big blind) folded before Flop
Seat 7: zgi+EUykT/pZQpoUG6+oEg collected ($0.60)
Seat 9: cZ99hugmLBj9KhTlc8nCSw folded before Flop (didn't bet)




PokerStars Game #59942009436:  Hold'em No Limit ($0.10/$0.25) - 2009/07/01 1:53:12 ET
Table 'jz4TpuH+ag+0iNe2ZcxckQ' 9-max Seat #7 is the button
Seat 2: clJsV3v77RS07bDKY+705w ($6.10 in chips) 
Seat 3: egvg3mTBBVzMHnJPIQiKcA ($18.50 in chips) 
Seat 4: k+2r6di6GXjNpAdrRkW9bA ($57.80 in chips) 
Seat 5: v1BVHNGLbP/nx7QO6K7+Jw ($27.50 in chips) 
Seat 7: tLcDklc2rBORNfixyRfVfw ($53.40 in chips) 
Seat 8: uhrboV251dcgYniYTdFIcA ($33.35 in chips) 
Seat 9: W2YYHvqjaEpRrO7stZkClQ ($5.15 in chips) 
uhrboV251dcgYniYTdFIcA: posts small blind $0.10
W2YYHvqjaEpRrO7stZkClQ: posts big blind $0.25
4awUyiDYTgylQKXZ9faBVA: sits out 
*** HOLE CARDS ***
gO1uiTGTzn5Cd3PECuws1g has returned
clJsV3v77RS07bDKY+705w: raises $0.75 to $1
egvg3mTBBVzMHnJPIQiKcA: folds 
k+2r6di6GXjNpAdrRkW9bA: folds 
v1BVHNGLbP/nx7QO6K7+Jw: calls $1
tLcDklc2rBORNfixyRfVfw: folds 
uhrboV251dcgYniYTdFIcA: calls $0.90
W2YYHvqjaEpRrO7stZkClQ: folds 
*** FLOP *** [4c Qs Jh]
uhrboV251dcgYniYTdFIcA: checks 
clJsV3v77RS07bDKY+705w: bets $2.25
v1BVHNGLbP/nx7QO6K7+Jw: folds 
uhrboV251dcgYniYTdFIcA: folds 
Uncalled bet ($2.25) returned to clJsV3v77RS07bDKY+705w
clJsV3v77RS07bDKY+705w collected $3.10 from pot
clJsV3v77RS07bDKY+705w: doesn't show hand 
*** SUMMARY ***
Total pot $3.25 | Rake $0.15 
Board [4c Qs Jh]
Seat 2: clJsV3v77RS07bDKY+705w collected ($3.10)
Seat 3: egvg3mTBBVzMHnJPIQiKcA folded before Flop (didn't bet)
Seat 4: k+2r6di6GXjNpAdrRkW9bA folded before Flop (didn't bet)
Seat 5: v1BVHNGLbP/nx7QO6K7+Jw folded on the Flop
Seat 7: tLcDklc2rBORNfixyRfVfw (button) folded before Flop (didn't bet)
Seat 8: uhrboV251dcgYniYTdFIcA (small blind) folded on the Flop
Seat 9: W2YYHvqjaEpRrO7stZkClQ (big blind) folded before Flop




PokerStars Game #59942009432:  Hold'em No Limit ($0.10/$0.25) - 2009/07/01 1:53:12 ET
Table 'dNYnr4D4id1jwnEU66Yowg' 9-max Seat #1 is the button
Seat 1: 9lvO/qyU+xrU95Teu1fv0g ($4.40 in chips) 
Seat 2: Qduu7ikeizo6q6Ei9YvcJA ($35 in chips) 
Seat 3: IOx4EH8+y3jYZJc/LTRvOw ($29.15 in chips) 
Seat 4: VBHxUExRAMrbxUq/cVx9Gw ($5 in chips) 
Seat 5: 7cv+9Zc9HIQHNvYsMfV3uA ($25 in chips) 
Seat 6: 8EbrQ/EvFWt2cr0GaU82gQ ($4.15 in chips) 
Seat 7: DiSvPC2iudwL5j9u6Huyww ($25 in chips) 
Seat 8: RCqMONFrSPSArZh2Jsar/w ($32.85 in chips) 
Seat 9: /FE4MKSoQhXaDp4PBoLM2g ($4.10 in chips) 
Qduu7ikeizo6q6Ei9YvcJA: posts small blind $0.10
IOx4EH8+y3jYZJc/LTRvOw: posts big blind $0.25
*** HOLE CARDS ***
VBHxUExRAMrbxUq/cVx9Gw: folds 
7cv+9Zc9HIQHNvYsMfV3uA: folds 
VBHxUExRAMrbxUq/cVx9Gw leaves the table
8EbrQ/EvFWt2cr0GaU82gQ: folds 
dtZ84flFEi4Q+SGrHMJRDQ joins the table at seat #4 
DiSvPC2iudwL5j9u6Huyww: folds 
RCqMONFrSPSArZh2Jsar/w: folds 
/FE4MKSoQhXaDp4PBoLM2g: calls $0.25
9lvO/qyU+xrU95Teu1fv0g: folds 
Qduu7ikeizo6q6Ei9YvcJA: calls $0.15
IOx4EH8+y3jYZJc/LTRvOw: checks 
*** FLOP *** [Ad As Jd]
Qduu7ikeizo6q6Ei9YvcJA: checks 
IOx4EH8+y3jYZJc/LTRvOw: bets $0.25
/FE4MKSoQhXaDp4PBoLM2g: calls $0.25
Qduu7ikeizo6q6Ei9YvcJA: calls $0.25
*** TURN *** [Ad As Jd] [6d]
Qduu7ikeizo6q6Ei9YvcJA: checks 
IOx4EH8+y3jYZJc/LTRvOw: bets $0.50
/FE4MKSoQhXaDp4PBoLM2g: calls $0.50
Qduu7ikeizo6q6Ei9YvcJA: folds 
*** RIVER *** [Ad As Jd 6d] [5d]
IOx4EH8+y3jYZJc/LTRvOw: bets $0.50
/FE4MKSoQhXaDp4PBoLM2g: folds 
Uncalled bet ($0.50) returned to IOx4EH8+y3jYZJc/LTRvOw
IOx4EH8+y3jYZJc/LTRvOw collected $2.40 from pot
*** SUMMARY ***
Total pot $2.50 | Rake $0.10 
Board [Ad As Jd 6d 5d]
Seat 1: 9lvO/qyU+xrU95Teu1fv0g (button) folded before Flop (didn't bet)
Seat 2: Qduu7ikeizo6q6Ei9YvcJA (small blind) folded on the Turn
Seat 3: IOx4EH8+y3jYZJc/LTRvOw (big blind) collected ($2.40)
Seat 4: VBHxUExRAMrbxUq/cVx9Gw folded before Flop (didn't bet)
Seat 5: 7cv+9Zc9HIQHNvYsMfV3uA folded before Flop (didn't bet)
Seat 6: 8EbrQ/EvFWt2cr0GaU82gQ folded before Flop (didn't bet)
Seat 7: DiSvPC2iudwL5j9u6Huyww folded before Flop (didn't bet)
Seat 8: RCqMONFrSPSArZh2Jsar/w folded before Flop (didn't bet)
Seat 9: /FE4MKSoQhXaDp4PBoLM2g folded on the River




PokerStars Game #59942009442:  Hold'em No Limit ($0.10/$0.25) - 2009/07/01 1:53:12 ET
Table 'Jz+kWRxWNGk9w24fdQEveA' 9-max Seat #7 is the button
Seat 1: Z9W7+g1WMhhZDi7DwGbCFA ($5 in chips) 
Seat 2: ljemhp25Zg+nlA9DLCIiUw ($37 in chips) 
Seat 3: N5sUK8M0br9djLrW97V9pQ ($22.55 in chips) 
Seat 4: HPEB+AtKw1+C/cxU0o1ciw ($28.65 in chips) 
Seat 5: d6eSA7wOH5mRaSyVDVRBLw ($16.80 in chips) 
Seat 6: AiXn/9o1EwOPZUHujnh/bA ($19 in chips) 
Seat 7: wGigCmBR/9XWkPpvYos3aQ ($26.50 in chips) 
Seat 8: j4q3p0lesp63b1gZDwLBZw ($5.10 in chips) 
Seat 9: V6p0jQ/RhUsqpHLmXvEX4Q ($17.35 in chips) 
j4q3p0lesp63b1gZDwLBZw: posts small blind $0.10
V6p0jQ/RhUsqpHLmXvEX4Q: posts big blind $0.25
AiXn/9o1EwOPZUHujnh/bA: posts big blind $0.25
*** HOLE CARDS ***
Z9W7+g1WMhhZDi7DwGbCFA: folds 
ljemhp25Zg+nlA9DLCIiUw: folds 
N5sUK8M0br9djLrW97V9pQ: calls $0.25
HPEB+AtKw1+C/cxU0o1ciw: folds 
d6eSA7wOH5mRaSyVDVRBLw: folds 
AiXn/9o1EwOPZUHujnh/bA: checks 
wGigCmBR/9XWkPpvYos3aQ: folds 
j4q3p0lesp63b1gZDwLBZw: folds 
V6p0jQ/RhUsqpHLmXvEX4Q: checks 
*** FLOP *** [Tc 5s Jd]
V6p0jQ/RhUsqpHLmXvEX4Q: checks 
N5sUK8M0br9djLrW97V9pQ: bets $0.75
AiXn/9o1EwOPZUHujnh/bA: folds 
V6p0jQ/RhUsqpHLmXvEX4Q: folds 
Uncalled bet ($0.75) returned to N5sUK8M0br9djLrW97V9pQ
N5sUK8M0br9djLrW97V9pQ collected $0.85 from pot
N5sUK8M0br9djLrW97V9pQ: doesn't show hand 
*** SUMMARY ***
Total pot $0.85 | Rake $0 
Board [Tc 5s Jd]
Seat 1: Z9W7+g1WMhhZDi7DwGbCFA folded before Flop (didn't bet)
Seat 2: ljemhp25Zg+nlA9DLCIiUw folded before Flop (didn't bet)
Seat 3: N5sUK8M0br9djLrW97V9pQ collected ($0.85)
Seat 4: HPEB+AtKw1+C/cxU0o1ciw folded before Flop (didn't bet)
Seat 5: d6eSA7wOH5mRaSyVDVRBLw folded before Flop (didn't bet)
Seat 6: AiXn/9o1EwOPZUHujnh/bA folded on the Flop
Seat 7: wGigCmBR/9XWkPpvYos3aQ (button) folded before Flop (didn't bet)
Seat 8: j4q3p0lesp63b1gZDwLBZw (small blind) folded before Flop
Seat 9: V6p0jQ/RhUsqpHLmXvEX4Q (big blind) folded on the Flop




PokerStars Game #59942009708:  Hold'em No Limit ($0.10/$0.25) - 2009/07/01 1:53:12 ET
Table 'AUM6O+mgQAaLDZKMQ/5/gA' 9-max Seat #2 is the button
Seat 2: z5GxcHlYz/GSz6W2uFiTtg ($24.95 in chips) 
Seat 3: CvL9Ch1HYCVbTsfpNucitg ($4.75 in chips) 
Seat 4: 4awUyiDYTgylQKXZ9faBVA ($28.55 in chips) 
Seat 5: +2kMBNpY4nF1qNCRd8SJLA ($25 in chips) 
Seat 6: v5jnQ1gfh9nLla3kMXG7Yg ($12.20 in chips) 
Seat 7: Bb42QRQMhg5/Y0vHP8/2Xw ($28.50 in chips) 
Seat 8: zDrucyjVn5aeekNEc3cJrA ($17.05 in chips) 
Seat 9: eK8qa6EPcH2zhtbmWSvc9g ($29.35 in chips) 
CvL9Ch1HYCVbTsfpNucitg: posts small blind $0.10
4awUyiDYTgylQKXZ9faBVA: posts big blind $0.25
SpiiQQAzy4MUgV3I5W8giw: sits out 
*** HOLE CARDS ***
+2kMBNpY4nF1qNCRd8SJLA: raises $0.75 to $1
v5jnQ1gfh9nLla3kMXG7Yg: folds 
Bb42QRQMhg5/Y0vHP8/2Xw: folds 
v5jnQ1gfh9nLla3kMXG7Yg leaves the table
zDrucyjVn5aeekNEc3cJrA: folds 
eK8qa6EPcH2zhtbmWSvc9g: folds 
z5GxcHlYz/GSz6W2uFiTtg: folds 
CvL9Ch1HYCVbTsfpNucitg: folds 
4awUyiDYTgylQKXZ9faBVA: folds 
Uncalled bet ($0.75) returned to +2kMBNpY4nF1qNCRd8SJLA
+2kMBNpY4nF1qNCRd8SJLA collected $0.60 from pot
V6p0jQ/RhUsqpHLmXvEX4Q joins the table at seat #6 
+2kMBNpY4nF1qNCRd8SJLA: doesn't show hand 
*** SUMMARY ***
Total pot $0.60 | Rake $0 
Seat 2: z5GxcHlYz/GSz6W2uFiTtg (button) folded before Flop (didn't bet)
Seat 3: CvL9Ch1HYCVbTsfpNucitg (small blind) folded before Flop
Seat 4: 4awUyiDYTgylQKXZ9faBVA (big blind) folded before Flop
Seat 5: +2kMBNpY4nF1qNCRd8SJLA collected ($0.60)
Seat 6: v5jnQ1gfh9nLla3kMXG7Yg folded before Flop (didn't bet)
Seat 7: Bb42QRQMhg5/Y0vHP8/2Xw folded before Flop (didn't bet)
Seat 8: zDrucyjVn5aeekNEc3cJrA folded before Flop (didn't bet)
Seat 9: eK8qa6EPcH2zhtbmWSvc9g folded before Flop (didn't bet)




PokerStars Game #59942009396:  Hold'em No Limit ($0.10/$0.25) - 2009/07/01 1:53:12 ET
Table 'rjcb+nlE+0GuJ6lBhuCkkA' 6-max Seat #5 is the button
Seat 1: lBoEwOFgzcERLIRUkUoRTw ($12.30 in chips) 
Seat 2: memV5jkoAdGrnRy3Q9PM7w ($15 in chips) 
Seat 3: 8ClCHtFXGNplITm+63KB+Q ($62.25 in chips) 
Seat 4: BV+K0Phf5VBHr7aZPKqbUQ ($38.80 in chips) 
Seat 5: GC/9yVD59DUCX7hUI7gcLw ($30.15 in chips) 
lBoEwOFgzcERLIRUkUoRTw: posts small blind $0.10
memV5jkoAdGrnRy3Q9PM7w: posts big blind $0.25
*** HOLE CARDS ***
8ClCHtFXGNplITm+63KB+Q: folds 
BV+K0Phf5VBHr7aZPKqbUQ: raises $0.50 to $0.75
GC/9yVD59DUCX7hUI7gcLw: folds 
lBoEwOFgzcERLIRUkUoRTw: folds 
memV5jkoAdGrnRy3Q9PM7w: calls $0.50
*** FLOP *** [Qd 2c Jc]
memV5jkoAdGrnRy3Q9PM7w: checks 
BV+K0Phf5VBHr7aZPKqbUQ: checks 
*** TURN *** [Qd 2c Jc] [8s]
memV5jkoAdGrnRy3Q9PM7w: checks 
BV+K0Phf5VBHr7aZPKqbUQ: bets $1
memV5jkoAdGrnRy3Q9PM7w: calls $1
*** RIVER *** [Qd 2c Jc 8s] [8c]
memV5jkoAdGrnRy3Q9PM7w: bets $3
BV+K0Phf5VBHr7aZPKqbUQ: calls $3
*** SHOW DOWN ***
memV5jkoAdGrnRy3Q9PM7w: shows [3s Ah] (a pair of Eights)
BV+K0Phf5VBHr7aZPKqbUQ: shows [As 8d] (three of a kind, Eights)
BV+K0Phf5VBHr7aZPKqbUQ collected $9.15 from pot
*** SUMMARY ***
Total pot $9.60 | Rake $0.45 
Board [Qd 2c Jc 8s 8c]
Seat 1: lBoEwOFgzcERLIRUkUoRTw (small blind) folded before Flop
Seat 2: memV5jkoAdGrnRy3Q9PM7w (big blind) showed [3s Ah] and lost with a pair of Eights
Seat 3: 8ClCHtFXGNplITm+63KB+Q folded before Flop (didn't bet)
Seat 4: BV+K0Phf5VBHr7aZPKqbUQ showed [As 8d] and won ($9.15) with three of a kind, Eights
Seat 5: GC/9yVD59DUCX7hUI7gcLw (button) folded before Flop (didn't bet)




PokerStars Game #59942009862:  Hold'em No Limit ($0.10/$0.25) - 2009/07/01 1:53:13 ET
Table 'D1Yq70l0nNCyMV6DA42p+Q' 9-max Seat #8 is the button
Seat 1: z5GxcHlYz/GSz6W2uFiTtg ($19.40 in chips) 
Seat 2: zgi+EUykT/pZQpoUG6+oEg ($5 in chips) 
Seat 3: 9lvO/qyU+xrU95Teu1fv0g ($6.50 in chips) 
Seat 4: VWUWpMLMj/Q1jRVpF7Aohw ($7.65 in chips) 
Seat 5: gehe91e0IyVT0QU/XBkEyg ($25 in chips) 
Seat 6: wGigCmBR/9XWkPpvYos3aQ ($34.95 in chips) 
Seat 8: zDrucyjVn5aeekNEc3cJrA ($23.65 in chips) 
Seat 9: h5wEs8qXrBqfLa9GjaSBzg ($17 in chips) 
h5wEs8qXrBqfLa9GjaSBzg: posts small blind $0.10
z5GxcHlYz/GSz6W2uFiTtg: posts big blind $0.25
*** HOLE CARDS ***
zgi+EUykT/pZQpoUG6+oEg: folds 
9lvO/qyU+xrU95Teu1fv0g: folds 
VWUWpMLMj/Q1jRVpF7Aohw: folds 
gehe91e0IyVT0QU/XBkEyg: folds 
wGigCmBR/9XWkPpvYos3aQ: folds 
zDrucyjVn5aeekNEc3cJrA: calls $0.25
h5wEs8qXrBqfLa9GjaSBzg: folds 
z5GxcHlYz/GSz6W2uFiTtg: checks 
*** FLOP *** [6c 8h 3h]
z5GxcHlYz/GSz6W2uFiTtg: checks 
h5wEs8qXrBqfLa9GjaSBzg is sitting out
zDrucyjVn5aeekNEc3cJrA: checks 
*** TURN *** [6c 8h 3h] [Ac]
z5GxcHlYz/GSz6W2uFiTtg: checks 
zDrucyjVn5aeekNEc3cJrA: bets $0.75
z5GxcHlYz/GSz6W2uFiTtg: folds 
Uncalled bet ($0.75) returned to zDrucyjVn5aeekNEc3cJrA
zDrucyjVn5aeekNEc3cJrA collected $0.60 from pot
*** SUMMARY ***
Total pot $0.60 | Rake $0 
Board [6c 8h 3h Ac]
Seat 1: z5GxcHlYz/GSz6W2uFiTtg (big blind) folded on the Turn
Seat 2: zgi+EUykT/pZQpoUG6+oEg folded before Flop (didn't bet)
Seat 3: 9lvO/qyU+xrU95Teu1fv0g folded before Flop (didn't bet)
Seat 4: VWUWpMLMj/Q1jRVpF7Aohw folded before Flop (didn't bet)
Seat 5: gehe91e0IyVT0QU/XBkEyg folded before Flop (didn't bet)
Seat 6: wGigCmBR/9XWkPpvYos3aQ folded before Flop (didn't bet)
Seat 8: zDrucyjVn5aeekNEc3cJrA (button) collected ($0.60)
Seat 9: h5wEs8qXrBqfLa9GjaSBzg (small blind) folded before Flop




PokerStars Game #59942010122:  Hold'em No Limit ($0.10/$0.25) - 2009/07/01 1:53:13 ET
Table 'ROYvQOMwUrvL3SOiHYcrWg' 9-max Seat #9 is the button
Seat 1: 22dIObOuor/A+IKWkNoAlA ($11.50 in chips) 
Seat 2: gehe91e0IyVT0QU/XBkEyg ($24.90 in chips) 
Seat 3: 8EbrQ/EvFWt2cr0GaU82gQ ($5 in chips) 
Seat 4: SHegmCn8B0InbWE/zFlvOw ($14.15 in chips) 
Seat 5: 7je+LC5Mfs6nL8YBVh4frQ ($4.65 in chips) 
Seat 6: P+9ymZQ3ktpQu1bn7HIjew ($19.15 in chips) 
Seat 8: biJWLZ27fafNeBI2oT1KJw ($28.40 in chips) 
Seat 9: uhrboV251dcgYniYTdFIcA ($31.30 in chips) 
22dIObOuor/A+IKWkNoAlA: posts small blind $0.10
gehe91e0IyVT0QU/XBkEyg: posts big blind $0.25
18G4P1XstjNvItdGUITxgw: sits out 
*** HOLE CARDS ***
8EbrQ/EvFWt2cr0GaU82gQ: folds 
SHegmCn8B0InbWE/zFlvOw: folds 
7je+LC5Mfs6nL8YBVh4frQ: folds 
P+9ymZQ3ktpQu1bn7HIjew: folds 
biJWLZ27fafNeBI2oT1KJw: calls $0.25
uhrboV251dcgYniYTdFIcA: folds 
22dIObOuor/A+IKWkNoAlA: folds 
gehe91e0IyVT0QU/XBkEyg: checks 
*** FLOP *** [Kc Kd Jc]
gehe91e0IyVT0QU/XBkEyg: checks 
biJWLZ27fafNeBI2oT1KJw: bets $1.25
gehe91e0IyVT0QU/XBkEyg: folds 
Uncalled bet ($1.25) returned to biJWLZ27fafNeBI2oT1KJw
biJWLZ27fafNeBI2oT1KJw collected $0.60 from pot
*** SUMMARY ***
Total pot $0.60 | Rake $0 
Board [Kc Kd Jc]
Seat 1: 22dIObOuor/A+IKWkNoAlA (small blind) folded before Flop
Seat 2: gehe91e0IyVT0QU/XBkEyg (big blind) folded on the Flop
Seat 3: 8EbrQ/EvFWt2cr0GaU82gQ folded before Flop (didn't bet)
Seat 4: SHegmCn8B0InbWE/zFlvOw folded before Flop (didn't bet)
Seat 5: 7je+LC5Mfs6nL8YBVh4frQ folded before Flop (didn't bet)
Seat 6: P+9ymZQ3ktpQu1bn7HIjew folded before Flop (didn't bet)
Seat 8: biJWLZ27fafNeBI2oT1KJw collected ($0.60)
Seat 9: uhrboV251dcgYniYTdFIcA (button) folded before Flop (didn't bet)




PokerStars Game #59942010028:  Hold'em No Limit ($0.10/$0.25) - 2009/07/01 1:53:13 ET
Table '63uh7ZsO7Tnt+E8b/2bu3A' 6-max Seat #3 is the button
Seat 1: 0av6tRNdi0Ui4f15L7gsVg ($31.90 in chips) 
Seat 2: SFmT9ZsVopnukjvAzrxTRg ($25 in chips) 
Seat 3: yVP7GLZBzx47OPi6jzUxMw ($3.25 in chips) 
Seat 4: rnpAao581IcvQglpkpnkoQ ($12.25 in chips) 
Seat 6: qGHGf/553gQnDoklMRe3tg ($27.80 in chips) 
rnpAao581IcvQglpkpnkoQ: posts small blind $0.10
qGHGf/553gQnDoklMRe3tg: posts big blind $0.25
*** HOLE CARDS ***
0av6tRNdi0Ui4f15L7gsVg: folds 
SFmT9ZsVopnukjvAzrxTRg: raises $0.75 to $1
yVP7GLZBzx47OPi6jzUxMw: folds 
rnpAao581IcvQglpkpnkoQ: calls $0.90
qGHGf/553gQnDoklMRe3tg: folds 
*** FLOP *** [7h Jd Kc]
rnpAao581IcvQglpkpnkoQ: bets $2.25
SFmT9ZsVopnukjvAzrxTRg: folds 
Uncalled bet ($2.25) returned to rnpAao581IcvQglpkpnkoQ
rnpAao581IcvQglpkpnkoQ collected $2.15 from pot
*** SUMMARY ***
Total pot $2.25 | Rake $0.10 
Board [7h Jd Kc]
Seat 1: 0av6tRNdi0Ui4f15L7gsVg folded before Flop (didn't bet)
Seat 2: SFmT9ZsVopnukjvAzrxTRg folded on the Flop
Seat 3: yVP7GLZBzx47OPi6jzUxMw (button) folded before Flop (didn't bet)
Seat 4: rnpAao581IcvQglpkpnkoQ (small blind) collected ($2.15)
Seat 6: qGHGf/553gQnDoklMRe3tg (big blind) folded before Flop




PokerStars Game #59942009934:  Hold'em No Limit ($0.10/$0.25) - 2009/07/01 1:53:13 ET
Table '4UJB/UOZ5aepyF2v+hIoUg' 6-max Seat #4 is the button
Seat 1: 08V++DOqzaNrRNsHIwi25w ($37.50 in chips) 
Seat 3: zlYHXTtJ5tcx9kwK2h5n9A ($49.40 in chips) 
Seat 4: R6AGToFJQOYVZAjC2jXEKw ($24 in chips) 
Seat 5: 3zD3qLXT1bEffAoWGnc7wg ($25 in chips) 
Seat 6: 2aphcinkTZT0B0Uoah6cvQ ($15.10 in chips) 
3zD3qLXT1bEffAoWGnc7wg: posts small blind $0.10
2aphcinkTZT0B0Uoah6cvQ: posts big blind $0.25
*** HOLE CARDS ***
08V++DOqzaNrRNsHIwi25w: raises $0.75 to $1
zlYHXTtJ5tcx9kwK2h5n9A: folds 
R6AGToFJQOYVZAjC2jXEKw: folds 
3zD3qLXT1bEffAoWGnc7wg: folds 
2aphcinkTZT0B0Uoah6cvQ: folds 
Uncalled bet ($0.75) returned to 08V++DOqzaNrRNsHIwi25w
08V++DOqzaNrRNsHIwi25w collected $0.60 from pot
08V++DOqzaNrRNsHIwi25w: doesn't show hand 
*** SUMMARY ***
Total pot $0.60 | Rake $0 
Seat 1: 08V++DOqzaNrRNsHIwi25w collected ($0.60)
Seat 3: zlYHXTtJ5tcx9kwK2h5n9A folded before Flop (didn't bet)
Seat 4: R6AGToFJQOYVZAjC2jXEKw (button) folded before Flop (didn't bet)
Seat 5: 3zD3qLXT1bEffAoWGnc7wg (small blind) folded before Flop
Seat 6: 2aphcinkTZT0B0Uoah6cvQ (big blind) folded before Flop




PokerStars Game #59942010252:  Hold'em No Limit ($0.10/$0.25) - 2009/07/01 1:53:13 ET
Table 'M8kYidAX3ib7pLKW7edFLw' 6-max Seat #5 is the button
Seat 1: jp34e617tIzV8tKIWmfAbA ($26.30 in chips) 
Seat 3: cezpHJ8FB07dj0xG+LhOvw ($27.05 in chips) 
Seat 4: UVeaJWNWVmtZSJnZBmf8ZQ ($25 in chips) 
Seat 5: GbCVUNssQ7mqsPWr7J4d3w ($6.25 in chips) 
jp34e617tIzV8tKIWmfAbA: posts small blind $0.10
cezpHJ8FB07dj0xG+LhOvw: posts big blind $0.25
UVeaJWNWVmtZSJnZBmf8ZQ: posts big blind $0.25
*** HOLE CARDS ***
NqFoyDgzLwu4dOmSRXnFBA has returned
UVeaJWNWVmtZSJnZBmf8ZQ: checks 
GbCVUNssQ7mqsPWr7J4d3w: raises $0.75 to $1
jp34e617tIzV8tKIWmfAbA: folds 
cezpHJ8FB07dj0xG+LhOvw: folds 
UVeaJWNWVmtZSJnZBmf8ZQ: calls $0.75
*** FLOP *** [3h 4c Kh]
UVeaJWNWVmtZSJnZBmf8ZQ: bets $1
GbCVUNssQ7mqsPWr7J4d3w: raises $1.50 to $2.50
UVeaJWNWVmtZSJnZBmf8ZQ: calls $1.50
*** TURN *** [3h 4c Kh] [9s]
UVeaJWNWVmtZSJnZBmf8ZQ: checks 
GbCVUNssQ7mqsPWr7J4d3w: bets $2.75 and is all-in
UVeaJWNWVmtZSJnZBmf8ZQ: folds 
Uncalled bet ($2.75) returned to GbCVUNssQ7mqsPWr7J4d3w
GbCVUNssQ7mqsPWr7J4d3w collected $7 from pot
GbCVUNssQ7mqsPWr7J4d3w: doesn't show hand 
*** SUMMARY ***
Total pot $7.35 | Rake $0.35 
Board [3h 4c Kh 9s]
Seat 1: jp34e617tIzV8tKIWmfAbA (small blind) folded before Flop
Seat 3: cezpHJ8FB07dj0xG+LhOvw (big blind) folded before Flop
Seat 4: UVeaJWNWVmtZSJnZBmf8ZQ folded on the Turn
Seat 5: GbCVUNssQ7mqsPWr7J4d3w (button) collected ($7)




PokerStars Game #59942009728:  Hold'em No Limit ($0.10/$0.25) - 2009/07/01 1:53:13 ET
Table 'qryc9C/ELyQ3lubOaELNAQ' 6-max Seat #5 is the button
Seat 1: OZc6kkoTwtITj1ZfreJK1A ($84.40 in chips) 
Seat 2: LtASJ9OlkqGrrUKGQlpGAw ($29.45 in chips) 
Seat 4: v+QfkGiuj9bgtuNoVnDO8w ($25 in chips) 
Seat 5: 9StOHp+Y1T0K13JdgS2oQQ ($38.55 in chips) 
OZc6kkoTwtITj1ZfreJK1A: posts small blind $0.10
LtASJ9OlkqGrrUKGQlpGAw: posts big blind $0.25
*** HOLE CARDS ***
v+QfkGiuj9bgtuNoVnDO8w: folds 
9StOHp+Y1T0K13JdgS2oQQ: folds 
OZc6kkoTwtITj1ZfreJK1A: calls $0.15
LtASJ9OlkqGrrUKGQlpGAw: checks 
*** FLOP *** [Ac 2h 9h]
OZc6kkoTwtITj1ZfreJK1A: checks 
LtASJ9OlkqGrrUKGQlpGAw: checks 
*** TURN *** [Ac 2h 9h] [6d]
OZc6kkoTwtITj1ZfreJK1A: checks 
LtASJ9OlkqGrrUKGQlpGAw: checks 
*** RIVER *** [Ac 2h 9h 6d] [Ad]
OZc6kkoTwtITj1ZfreJK1A: checks 
LtASJ9OlkqGrrUKGQlpGAw: checks 
*** SHOW DOWN ***
OZc6kkoTwtITj1ZfreJK1A: shows [Jc Td] (a pair of Aces)
LtASJ9OlkqGrrUKGQlpGAw: mucks hand 
OZc6kkoTwtITj1ZfreJK1A collected $0.50 from pot
*** SUMMARY ***
Total pot $0.50 | Rake $0 
Board [Ac 2h 9h 6d Ad]
Seat 1: OZc6kkoTwtITj1ZfreJK1A (small blind) showed [Jc Td] and won ($0.50) with a pair of Aces
Seat 2: LtASJ9OlkqGrrUKGQlpGAw (big blind) mucked
Seat 4: v+QfkGiuj9bgtuNoVnDO8w folded before Flop (didn't bet)
Seat 5: 9StOHp+Y1T0K13JdgS2oQQ (button) folded before Flop (didn't bet)




PokerStars Game #59942010192:  Hold'em No Limit ($0.10/$0.25) - 2009/07/01 1:53:13 ET
Table 'uZQt7Oyhyw4PsP/6/eKGig' 6-max Seat #3 is the button
Seat 3: 10f7J+bM02ZfDHx0PgkNSg ($5 in chips) 
Seat 4: 6NGH9IddsWu2kxhVxwD/Sg ($5 in chips) 
10f7J+bM02ZfDHx0PgkNSg: posts small blind $0.10
6NGH9IddsWu2kxhVxwD/Sg: posts big blind $0.25
*** HOLE CARDS ***
10f7J+bM02ZfDHx0PgkNSg: raises $0.25 to $0.50
6NGH9IddsWu2kxhVxwD/Sg: calls $0.25
*** FLOP *** [5c 9h Js]
6NGH9IddsWu2kxhVxwD/Sg: checks 
10f7J+bM02ZfDHx0PgkNSg: checks 
*** TURN *** [5c 9h Js] [6s]
6NGH9IddsWu2kxhVxwD/Sg: checks 
10f7J+bM02ZfDHx0PgkNSg: checks 
*** RIVER *** [5c 9h Js 6s] [4s]
6NGH9IddsWu2kxhVxwD/Sg: checks 
10f7J+bM02ZfDHx0PgkNSg: checks 
*** SHOW DOWN ***
6NGH9IddsWu2kxhVxwD/Sg: shows [3d 5d] (a pair of Fives)
10f7J+bM02ZfDHx0PgkNSg: mucks hand 
6NGH9IddsWu2kxhVxwD/Sg collected $0.95 from pot
*** SUMMARY ***
Total pot $1 | Rake $0.05 
Board [5c 9h Js 6s 4s]
Seat 3: 10f7J+bM02ZfDHx0PgkNSg (button) (small blind) mucked
Seat 4: 6NGH9IddsWu2kxhVxwD/Sg (big blind) showed [3d 5d] and won ($0.95) with a pair of Fives




PokerStars Game #59942010054:  Hold'em No Limit ($0.10/$0.25) - 2009/07/01 1:53:13 ET
Table 'BabJGL6tfXQp3leBGbYe8A' 9-max Seat #3 is the button
Seat 1: qwr38jl5txoR36M7G5qi4A ($10.35 in chips) 
Seat 2: dtZ84flFEi4Q+SGrHMJRDQ ($40.15 in chips) 
Seat 3: sD+TKtt36XiiN6jqHiLwDA ($27.45 in chips) 
Seat 4: gehe91e0IyVT0QU/XBkEyg ($27.60 in chips) 
Seat 5: GrNTWMdwy+jC6Lred1eDng ($10.35 in chips) 
Seat 6: egvg3mTBBVzMHnJPIQiKcA ($15.75 in chips) 
Seat 7: eK8qa6EPcH2zhtbmWSvc9g ($28.20 in chips) 
Seat 8: OXPkK84/qv92EMwXPiG5rQ ($9.75 in chips) 
Seat 9: P+9ymZQ3ktpQu1bn7HIjew ($9.15 in chips) 
gehe91e0IyVT0QU/XBkEyg: posts small blind $0.10
GrNTWMdwy+jC6Lred1eDng: posts big blind $0.25
*** HOLE CARDS ***
egvg3mTBBVzMHnJPIQiKcA: folds 
eK8qa6EPcH2zhtbmWSvc9g: folds 
OXPkK84/qv92EMwXPiG5rQ: folds 
P+9ymZQ3ktpQu1bn7HIjew: raises $0.25 to $0.50
qwr38jl5txoR36M7G5qi4A: folds 
dtZ84flFEi4Q+SGrHMJRDQ: folds 
sD+TKtt36XiiN6jqHiLwDA: folds 
gehe91e0IyVT0QU/XBkEyg: folds 
GrNTWMdwy+jC6Lred1eDng: folds 
Uncalled bet ($0.25) returned to P+9ymZQ3ktpQu1bn7HIjew
P+9ymZQ3ktpQu1bn7HIjew collected $0.60 from pot
P+9ymZQ3ktpQu1bn7HIjew: doesn't show hand 
*** SUMMARY ***
Total pot $0.60 | Rake $0 
Seat 1: qwr38jl5txoR36M7G5qi4A folded before Flop (didn't bet)
Seat 2: dtZ84flFEi4Q+SGrHMJRDQ folded before Flop (didn't bet)
Seat 3: sD+TKtt36XiiN6jqHiLwDA (button) folded before Flop (didn't bet)
Seat 4: gehe91e0IyVT0QU/XBkEyg (small blind) folded before Flop
Seat 5: GrNTWMdwy+jC6Lred1eDng (big blind) folded before Flop
Seat 6: egvg3mTBBVzMHnJPIQiKcA folded before Flop (didn't bet)
Seat 7: eK8qa6EPcH2zhtbmWSvc9g folded before Flop (didn't bet)
Seat 8: OXPkK84/qv92EMwXPiG5rQ folded before Flop (didn't bet)
Seat 9: P+9ymZQ3ktpQu1bn7HIjew collected ($0.60)




PokerStars Game #59942010142:  Hold'em No Limit ($0.10/$0.25) - 2009/07/01 1:53:13 ET
Table '+VTTYgQLH1awDHk+IAxqGg' 9-max Seat #4 is the button
Seat 1: arxNSjreDRGFg13EAM2F1w ($27.40 in chips) 
Seat 2: 2wcFsZsqEP5w1StUTVzJCg ($6.05 in chips) 
Seat 3: AiXn/9o1EwOPZUHujnh/bA ($11.05 in chips) 
Seat 4: gE5rN2TDY1aXcZn/TOPeZw ($8.55 in chips) 
Seat 5: sD+TKtt36XiiN6jqHiLwDA ($28.90 in chips) 
Seat 6: clJsV3v77RS07bDKY+705w ($6.05 in chips) 
Seat 7: ljemhp25Zg+nlA9DLCIiUw ($24.75 in chips) 
Seat 8: 10vzP4r6ldwGLbYHKd9www ($18.75 in chips) 
Seat 9: S7Ki0P+0AIGPuIfGJjW0gg ($61.15 in chips) 
sD+TKtt36XiiN6jqHiLwDA: posts small blind $0.10
clJsV3v77RS07bDKY+705w: posts big blind $0.25
*** HOLE CARDS ***
ljemhp25Zg+nlA9DLCIiUw: folds 
ljemhp25Zg+nlA9DLCIiUw is sitting out
10vzP4r6ldwGLbYHKd9www: raises $0.25 to $0.50
S7Ki0P+0AIGPuIfGJjW0gg: folds 
arxNSjreDRGFg13EAM2F1w: folds 
2wcFsZsqEP5w1StUTVzJCg: folds 
AiXn/9o1EwOPZUHujnh/bA: folds 
gE5rN2TDY1aXcZn/TOPeZw: folds 
sD+TKtt36XiiN6jqHiLwDA: folds 
clJsV3v77RS07bDKY+705w: folds 
Uncalled bet ($0.25) returned to 10vzP4r6ldwGLbYHKd9www
10vzP4r6ldwGLbYHKd9www collected $0.60 from pot
*** SUMMARY ***
Total pot $0.60 | Rake $0 
Seat 1: arxNSjreDRGFg13EAM2F1w folded before Flop (didn't bet)
Seat 2: 2wcFsZsqEP5w1StUTVzJCg folded before Flop (didn't bet)
Seat 3: AiXn/9o1EwOPZUHujnh/bA folded before Flop (didn't bet)
Seat 4: gE5rN2TDY1aXcZn/TOPeZw (button) folded before Flop (didn't bet)
Seat 5: sD+TKtt36XiiN6jqHiLwDA (small blind) folded before Flop
Seat 6: clJsV3v77RS07bDKY+705w (big blind) folded before Flop
Seat 7: ljemhp25Zg+nlA9DLCIiUw folded before Flop (didn't bet)
Seat 8: 10vzP4r6ldwGLbYHKd9www collected ($0.60)
Seat 9: S7Ki0P+0AIGPuIfGJjW0gg folded before Flop (didn't bet)




PokerStars Game #59942009890:  Hold'em No Limit ($0.10/$0.25) - 2009/07/01 1:53:13 ET
Table '3lL16FBjWXTx3AjK5lMRww' 9-max Seat #3 is the button
Seat 1: fDGyaQz0cs2s4FOYxkbIHA ($14.55 in chips) 
Seat 3: QEbIGci+itdw+re8RM5fZA ($28.15 in chips) 
Seat 4: Z3a37Ry74FVl+CBZtAONiA ($6.50 in chips) 
Seat 5: M/9j4wkHH9i1JM51vgi1VA ($36.95 in chips) 
Seat 7: 6RiVTYll/5D8zICp0MRpKw ($26.30 in chips) 
Seat 8: ljemhp25Zg+nlA9DLCIiUw ($25.35 in chips) 
Seat 9: 00Ybni1cxfHtqmdWwh31Xg ($9.95 in chips) 
Z3a37Ry74FVl+CBZtAONiA: posts small blind $0.10
M/9j4wkHH9i1JM51vgi1VA: posts big blind $0.25
bXpVeaSTPBFSPJmeXxO7nw: sits out 
*** HOLE CARDS ***
zUXhymECc2C9W9ZNw6qppA is connected 
6RiVTYll/5D8zICp0MRpKw: folds 
ljemhp25Zg+nlA9DLCIiUw: folds 
00Ybni1cxfHtqmdWwh31Xg: raises $0.50 to $0.75
fDGyaQz0cs2s4FOYxkbIHA: folds 
QEbIGci+itdw+re8RM5fZA: folds 
zUXhymECc2C9W9ZNw6qppA has returned
Z3a37Ry74FVl+CBZtAONiA: calls $0.65
M/9j4wkHH9i1JM51vgi1VA: calls $0.50
*** FLOP *** [Kh Qs 9d]
Z3a37Ry74FVl+CBZtAONiA: checks 
M/9j4wkHH9i1JM51vgi1VA: checks 
00Ybni1cxfHtqmdWwh31Xg: bets $1
Z3a37Ry74FVl+CBZtAONiA: folds 
M/9j4wkHH9i1JM51vgi1VA: folds 
Uncalled bet ($1) returned to 00Ybni1cxfHtqmdWwh31Xg
00Ybni1cxfHtqmdWwh31Xg collected $2.15 from pot
*** SUMMARY ***
Total pot $2.25 | Rake $0.10 
Board [Kh Qs 9d]
Seat 1: fDGyaQz0cs2s4FOYxkbIHA folded before Flop (didn't bet)
Seat 3: QEbIGci+itdw+re8RM5fZA (button) folded before Flop (didn't bet)
Seat 4: Z3a37Ry74FVl+CBZtAONiA (small blind) folded on the Flop
Seat 5: M/9j4wkHH9i1JM51vgi1VA (big blind) folded on the Flop
Seat 7: 6RiVTYll/5D8zICp0MRpKw folded before Flop (didn't bet)
Seat 8: ljemhp25Zg+nlA9DLCIiUw folded before Flop (didn't bet)
Seat 9: 00Ybni1cxfHtqmdWwh31Xg collected ($2.15)




PokerStars Game #59942010222:  Hold'em No Limit ($0.10/$0.25) - 2009/07/01 1:53:13 ET
Table 'xmJKTGBeWCwutccj3YfupQ' 6-max Seat #2 is the button
Seat 1: sVbkVl4OznxBCfi66UB9vw ($40.55 in chips) 
Seat 2: QqiZLFrN8iOUT/GHw7ztOA ($26.80 in chips) 
Seat 3: T5wrp/d5jarm+SxNy8OQAg ($17.20 in chips) 
Seat 4: uWjhTVMpuIroxXcmD3Okug ($30.30 in chips) 
Seat 5: DE9hRlt14g+JdsRQ4wT7hg ($39.05 in chips) 
Seat 6: 9bpVv1/Qh9IYtXuCtl5VtQ ($22.25 in chips) 
T5wrp/d5jarm+SxNy8OQAg: posts small blind $0.10
uWjhTVMpuIroxXcmD3Okug: posts big blind $0.25
*** HOLE CARDS ***
DE9hRlt14g+JdsRQ4wT7hg: raises $0.75 to $1
9bpVv1/Qh9IYtXuCtl5VtQ: folds 
sVbkVl4OznxBCfi66UB9vw: folds 
QqiZLFrN8iOUT/GHw7ztOA: folds 
T5wrp/d5jarm+SxNy8OQAg: calls $0.90
uWjhTVMpuIroxXcmD3Okug: folds 
*** FLOP *** [Ks 7c Ah]
T5wrp/d5jarm+SxNy8OQAg: checks 
DE9hRlt14g+JdsRQ4wT7hg: bets $1.50
T5wrp/d5jarm+SxNy8OQAg: folds 
Uncalled bet ($1.50) returned to DE9hRlt14g+JdsRQ4wT7hg
DE9hRlt14g+JdsRQ4wT7hg collected $2.15 from pot
DE9hRlt14g+JdsRQ4wT7hg: doesn't show hand 
*** SUMMARY ***
Total pot $2.25 | Rake $0.10 
Board [Ks 7c Ah]
Seat 1: sVbkVl4OznxBCfi66UB9vw folded before Flop (didn't bet)
Seat 2: QqiZLFrN8iOUT/GHw7ztOA (button) folded before Flop (didn't bet)
Seat 3: T5wrp/d5jarm+SxNy8OQAg (small blind) folded on the Flop
Seat 4: uWjhTVMpuIroxXcmD3Okug (big blind) folded before Flop
Seat 5: DE9hRlt14g+JdsRQ4wT7hg collected ($2.15)
Seat 6: 9bpVv1/Qh9IYtXuCtl5VtQ folded before Flop (didn't bet)




PokerStars Game #59942010564:  Hold'em No Limit ($0.10/$0.25) - 2009/07/01 1:53:14 ET
Table 'mk323gviqdkOY5Aek/1EWg' 6-max Seat #4 is the button
Seat 1: 7cx44/slbeTw+Cy7QB8Trg ($25.25 in chips) 
Seat 2: GC/9yVD59DUCX7hUI7gcLw ($57.05 in chips) 
Seat 3: NuqYPwTLZYQhxOoVK3Yqlw ($26.05 in chips) 
Seat 4: +baiVgI/ETnBARLe5mARCw ($10.85 in chips) 
Seat 5: kjYRzIfvZNNflYMYRkkSVA ($36.05 in chips) 
Seat 6: KkXSr5xFjxLSD3wtAvT+WQ ($6.20 in chips) 
kjYRzIfvZNNflYMYRkkSVA: posts small blind $0.10
KkXSr5xFjxLSD3wtAvT+WQ: posts big blind $0.25
*** HOLE CARDS ***
7cx44/slbeTw+Cy7QB8Trg: folds 
GC/9yVD59DUCX7hUI7gcLw: folds 
NuqYPwTLZYQhxOoVK3Yqlw: raises $0.75 to $1
+baiVgI/ETnBARLe5mARCw: folds 
kjYRzIfvZNNflYMYRkkSVA: folds 
KkXSr5xFjxLSD3wtAvT+WQ: folds 
Uncalled bet ($0.75) returned to NuqYPwTLZYQhxOoVK3Yqlw
NuqYPwTLZYQhxOoVK3Yqlw collected $0.60 from pot
NuqYPwTLZYQhxOoVK3Yqlw: doesn't show hand 
*** SUMMARY ***
Total pot $0.60 | Rake $0 
Seat 1: 7cx44/slbeTw+Cy7QB8Trg folded before Flop (didn't bet)
Seat 2: GC/9yVD59DUCX7hUI7gcLw folded before Flop (didn't bet)
Seat 3: NuqYPwTLZYQhxOoVK3Yqlw collected ($0.60)
Seat 4: +baiVgI/ETnBARLe5mARCw (button) folded before Flop (didn't bet)
Seat 5: kjYRzIfvZNNflYMYRkkSVA (small blind) folded before Flop
Seat 6: KkXSr5xFjxLSD3wtAvT+WQ (big blind) folded before Flop




PokerStars Game #59942010744:  Hold'em No Limit ($0.10/$0.25) - 2009/07/01 1:53:14 ET
Table 'l8hUTjBTXBorNUR/tyvSLw' 9-max Seat #4 is the button
Seat 1: cZ99hugmLBj9KhTlc8nCSw ($27.85 in chips) 
Seat 2: B6xHiX1SJkS0CUNCKDVwuQ ($21 in chips) 
Seat 3: ShCS62CJp4MKfKLKvGKQbA ($8.75 in chips) 
Seat 4: vPtFvcPtn/Afz0sucO1cmQ ($37.20 in chips) 
Seat 5: yyG4svzOpC1A+sUP/scg6w ($6.70 in chips) 
Seat 6: EVqHvqty1ZsuvDFiSXlSqQ ($23.95 in chips) 
Seat 7: F7pnn6czNpHvRM55XcA2EA ($33.90 in chips) 
Seat 8: Mh2r9hTeTEDnh19sRZtW3g ($4.65 in chips) 
Seat 9: zDrucyjVn5aeekNEc3cJrA ($32.95 in chips) 
yyG4svzOpC1A+sUP/scg6w: posts small blind $0.10
EVqHvqty1ZsuvDFiSXlSqQ: posts big blind $0.25
*** HOLE CARDS ***
F7pnn6czNpHvRM55XcA2EA: folds 
Mh2r9hTeTEDnh19sRZtW3g: folds 
zDrucyjVn5aeekNEc3cJrA: calls $0.25
cZ99hugmLBj9KhTlc8nCSw: folds 
B6xHiX1SJkS0CUNCKDVwuQ: raises $0.75 to $1
ShCS62CJp4MKfKLKvGKQbA: folds 
vPtFvcPtn/Afz0sucO1cmQ: folds 
yyG4svzOpC1A+sUP/scg6w: folds 
EVqHvqty1ZsuvDFiSXlSqQ: folds 
zDrucyjVn5aeekNEc3cJrA: folds 
Uncalled bet ($0.75) returned to B6xHiX1SJkS0CUNCKDVwuQ
B6xHiX1SJkS0CUNCKDVwuQ collected $0.85 from pot
B6xHiX1SJkS0CUNCKDVwuQ: doesn't show hand 
*** SUMMARY ***
Total pot $0.85 | Rake $0 
Seat 1: cZ99hugmLBj9KhTlc8nCSw folded before Flop (didn't bet)
Seat 2: B6xHiX1SJkS0CUNCKDVwuQ collected ($0.85)
Seat 3: ShCS62CJp4MKfKLKvGKQbA folded before Flop (didn't bet)
Seat 4: vPtFvcPtn/Afz0sucO1cmQ (button) folded before Flop (didn't bet)
Seat 5: yyG4svzOpC1A+sUP/scg6w (small blind) folded before Flop
Seat 6: EVqHvqty1ZsuvDFiSXlSqQ (big blind) folded before Flop
Seat 7: F7pnn6czNpHvRM55XcA2EA folded before Flop (didn't bet)
Seat 8: Mh2r9hTeTEDnh19sRZtW3g folded before Flop (didn't bet)
Seat 9: zDrucyjVn5aeekNEc3cJrA folded before Flop




PokerStars Game #59942010362:  Hold'em No Limit ($0.10/$0.25) - 2009/07/01 1:53:14 ET
Table 'Of/T60zpXg1GcjrZ7Lm//Q' 9-max Seat #5 is the button
Seat 1: Lro4e37x4FUa5P3yzDjskw ($20 in chips) 
Seat 2: qwr38jl5txoR36M7G5qi4A ($12.60 in chips) 
Seat 3: 6RiVTYll/5D8zICp0MRpKw ($22.50 in chips) 
Seat 4: Czut6V7acIqUJrrobjKAZg ($6.80 in chips) 
Seat 5: 6mStmDUknIn/RyBEoiIyoQ ($5.65 in chips) 
Seat 7: PVxvfRTRvkgZf9WtquEkwQ ($25 in chips) 
Seat 8: ghNKXUBl/H+t83JF079ZBA ($26.50 in chips) 
Seat 9: egvg3mTBBVzMHnJPIQiKcA ($15.05 in chips) 
PVxvfRTRvkgZf9WtquEkwQ: posts small blind $0.10
ghNKXUBl/H+t83JF079ZBA: posts big blind $0.25
*** HOLE CARDS ***
egvg3mTBBVzMHnJPIQiKcA: folds 
Lro4e37x4FUa5P3yzDjskw: folds 
qwr38jl5txoR36M7G5qi4A: raises $0.50 to $0.75
6RiVTYll/5D8zICp0MRpKw: folds 
Czut6V7acIqUJrrobjKAZg: folds 
6mStmDUknIn/RyBEoiIyoQ: folds 
PVxvfRTRvkgZf9WtquEkwQ: folds 
ghNKXUBl/H+t83JF079ZBA: folds 
Uncalled bet ($0.50) returned to qwr38jl5txoR36M7G5qi4A
qwr38jl5txoR36M7G5qi4A collected $0.60 from pot
*** SUMMARY ***
Total pot $0.60 | Rake $0 
Seat 1: Lro4e37x4FUa5P3yzDjskw folded before Flop (didn't bet)
Seat 2: qwr38jl5txoR36M7G5qi4A collected ($0.60)
Seat 3: 6RiVTYll/5D8zICp0MRpKw folded before Flop (didn't bet)
Seat 4: Czut6V7acIqUJrrobjKAZg folded before Flop (didn't bet)
Seat 5: 6mStmDUknIn/RyBEoiIyoQ (button) folded before Flop (didn't bet)
Seat 7: PVxvfRTRvkgZf9WtquEkwQ (small blind) folded before Flop
Seat 8: ghNKXUBl/H+t83JF079ZBA (big blind) folded before Flop
Seat 9: egvg3mTBBVzMHnJPIQiKcA folded before Flop (didn't bet)




PokerStars Game #59942010436:  Hold'em No Limit ($0.10/$0.25) - 2009/07/01 1:53:14 ET
Table 'GrYi0DZOHD1EvB+qiLExNw' 9-max Seat #4 is the button
Seat 1: 7je+LC5Mfs6nL8YBVh4frQ ($5 in chips) 
Seat 2: Th3FldXKQW6hWVVPahaoOQ ($47.05 in chips) 
Seat 3: RHqgdFvufLCYe54+qd2gcA ($4.40 in chips) 
Seat 4: 8x95tVlB4uFBVHp71KihMA ($35 in chips) 
Seat 5: cZ99hugmLBj9KhTlc8nCSw ($25 in chips) 
Seat 6: arxNSjreDRGFg13EAM2F1w ($25.70 in chips) 
Seat 7: 9lvO/qyU+xrU95Teu1fv0g ($23.20 in chips) 
Seat 9: 5hAPbqNrvJb8PtLiceXtlg ($14.45 in chips) 
cZ99hugmLBj9KhTlc8nCSw: posts small blind $0.10
arxNSjreDRGFg13EAM2F1w: posts big blind $0.25
*** HOLE CARDS ***
9lvO/qyU+xrU95Teu1fv0g: calls $0.25
5hAPbqNrvJb8PtLiceXtlg: folds 
7je+LC5Mfs6nL8YBVh4frQ: calls $0.25
Th3FldXKQW6hWVVPahaoOQ: folds 
RHqgdFvufLCYe54+qd2gcA: folds 
8x95tVlB4uFBVHp71KihMA: calls $0.25
cZ99hugmLBj9KhTlc8nCSw: folds 
arxNSjreDRGFg13EAM2F1w: checks 
*** FLOP *** [Kh Qc Qd]
arxNSjreDRGFg13EAM2F1w: checks 
9lvO/qyU+xrU95Teu1fv0g: checks 
7je+LC5Mfs6nL8YBVh4frQ: checks 
8x95tVlB4uFBVHp71KihMA: checks 
*** TURN *** [Kh Qc Qd] [Th]
arxNSjreDRGFg13EAM2F1w: checks 
9lvO/qyU+xrU95Teu1fv0g: checks 
7je+LC5Mfs6nL8YBVh4frQ: checks 
8x95tVlB4uFBVHp71KihMA: bets $0.75
arxNSjreDRGFg13EAM2F1w: folds 
9lvO/qyU+xrU95Teu1fv0g: folds 
7je+LC5Mfs6nL8YBVh4frQ: folds 
Uncalled bet ($0.75) returned to 8x95tVlB4uFBVHp71KihMA
8x95tVlB4uFBVHp71KihMA collected $1.05 from pot
*** SUMMARY ***
Total pot $1.10 | Rake $0.05 
Board [Kh Qc Qd Th]
Seat 1: 7je+LC5Mfs6nL8YBVh4frQ folded on the Turn
Seat 2: Th3FldXKQW6hWVVPahaoOQ folded before Flop (didn't bet)
Seat 3: RHqgdFvufLCYe54+qd2gcA folded before Flop (didn't bet)
Seat 4: 8x95tVlB4uFBVHp71KihMA (button) collected ($1.05)
Seat 5: cZ99hugmLBj9KhTlc8nCSw (small blind) folded before Flop
Seat 6: arxNSjreDRGFg13EAM2F1w (big blind) folded on the Turn
Seat 7: 9lvO/qyU+xrU95Teu1fv0g folded on the Turn
Seat 9: 5hAPbqNrvJb8PtLiceXtlg folded before Flop (didn't bet)




PokerStars Game #59942010570:  Hold'em No Limit ($0.10/$0.25) - 2009/07/01 1:53:14 ET
Table 'IIO2q2znuuAXmiZ2qFTcmg' 6-max Seat #5 is the button
Seat 2: i9LqF5rD3bvtbEE7HWgr3Q ($27.35 in chips) 
Seat 3: j0aDOn9Nft1HLTQvGu1UwA ($14.15 in chips) 
Seat 5: iHZrkhpIO/3+tKuAoPx8HQ ($10.25 in chips) 
Seat 6: WT1/PiLHYHDQX0orTRlu9g ($15.90 in chips) 
WT1/PiLHYHDQX0orTRlu9g: posts small blind $0.10
i9LqF5rD3bvtbEE7HWgr3Q: posts big blind $0.25
*** HOLE CARDS ***
j0aDOn9Nft1HLTQvGu1UwA: calls $0.25
iHZrkhpIO/3+tKuAoPx8HQ: calls $0.25
WT1/PiLHYHDQX0orTRlu9g: calls $0.15
i9LqF5rD3bvtbEE7HWgr3Q: checks 
*** FLOP *** [Kd 5c Qs]
WT1/PiLHYHDQX0orTRlu9g: checks 
i9LqF5rD3bvtbEE7HWgr3Q: checks 
j0aDOn9Nft1HLTQvGu1UwA: checks 
iHZrkhpIO/3+tKuAoPx8HQ: checks 
*** TURN *** [Kd 5c Qs] [Jh]
W6Y6au0wf7gRAlqJYgOezw has returned
WT1/PiLHYHDQX0orTRlu9g: checks 
i9LqF5rD3bvtbEE7HWgr3Q: bets $0.75
j0aDOn9Nft1HLTQvGu1UwA: calls $0.75
iHZrkhpIO/3+tKuAoPx8HQ: calls $0.75
WT1/PiLHYHDQX0orTRlu9g: folds 
*** RIVER *** [Kd 5c Qs Jh] [Td]
i9LqF5rD3bvtbEE7HWgr3Q: checks 
j0aDOn9Nft1HLTQvGu1UwA: checks 
iHZrkhpIO/3+tKuAoPx8HQ: checks 
*** SHOW DOWN ***
i9LqF5rD3bvtbEE7HWgr3Q: shows [9d Ts] (a straight, Nine to King)
j0aDOn9Nft1HLTQvGu1UwA: mucks hand 
iHZrkhpIO/3+tKuAoPx8HQ: mucks hand 
i9LqF5rD3bvtbEE7HWgr3Q collected $3.10 from pot
*** SUMMARY ***
Total pot $3.25 | Rake $0.15 
Board [Kd 5c Qs Jh Td]
Seat 2: i9LqF5rD3bvtbEE7HWgr3Q (big blind) showed [9d Ts] and won ($3.10) with a straight, Nine to King
Seat 3: j0aDOn9Nft1HLTQvGu1UwA mucked
Seat 5: iHZrkhpIO/3+tKuAoPx8HQ (button) mucked
Seat 6: WT1/PiLHYHDQX0orTRlu9g (small blind) folded on the Turn




PokerStars Game #59942010568:  Hold'em No Limit ($0.10/$0.25) - 2009/07/01 1:53:14 ET
Table 'Ok3oDLIsTc2+KxPcI0bAOA' 6-max Seat #5 is the button
Seat 2: wPSNSp4HYtytRMXTu3oPSQ ($28.50 in chips) 
Seat 3: mVwoM9qpwrGzpTUusIu2Ig ($15.80 in chips) 
Seat 4: LJI7A1YgDM7hgh7o56+ReQ ($33.70 in chips) 
Seat 5: DFi/Lzkjsfv8QswS80JX9Q ($29.40 in chips) 
wPSNSp4HYtytRMXTu3oPSQ: posts small blind $0.10
mVwoM9qpwrGzpTUusIu2Ig: posts big blind $0.25
*** HOLE CARDS ***
LJI7A1YgDM7hgh7o56+ReQ: folds 
DFi/Lzkjsfv8QswS80JX9Q: folds 
wPSNSp4HYtytRMXTu3oPSQ: calls $0.15
mVwoM9qpwrGzpTUusIu2Ig: checks 
*** FLOP *** [Kd 9s As]
wPSNSp4HYtytRMXTu3oPSQ: checks 
mVwoM9qpwrGzpTUusIu2Ig: checks 
*** TURN *** [Kd 9s As] [Kh]
wPSNSp4HYtytRMXTu3oPSQ: checks 
mVwoM9qpwrGzpTUusIu2Ig: checks 
*** RIVER *** [Kd 9s As Kh] [2c]
wPSNSp4HYtytRMXTu3oPSQ: checks 
mVwoM9qpwrGzpTUusIu2Ig: checks 
*** SHOW DOWN ***
wPSNSp4HYtytRMXTu3oPSQ: shows [Qc 6d] (a pair of Kings)
mdipie1 joins the table at seat #6 
mVwoM9qpwrGzpTUusIu2Ig: mucks hand 
wPSNSp4HYtytRMXTu3oPSQ collected $0.50 from pot
*** SUMMARY ***
Total pot $0.50 | Rake $0 
Board [Kd 9s As Kh 2c]
Seat 2: wPSNSp4HYtytRMXTu3oPSQ (small blind) showed [Qc 6d] and won ($0.50) with a pair of Kings
Seat 3: mVwoM9qpwrGzpTUusIu2Ig (big blind) mucked
Seat 4: LJI7A1YgDM7hgh7o56+ReQ folded before Flop (didn't bet)
Seat 5: DFi/Lzkjsfv8QswS80JX9Q (button) folded before Flop (didn't bet)




PokerStars Game #59942010648:  Hold'em No Limit ($0.10/$0.25) - 2009/07/01 1:53:14 ET
Table 'zW+7jPbOLCvlPu+dUGY5WQ' 6-max Seat #6 is the button
Seat 1: eL3+wCBjFGfQ5FMdIZihwA ($30.95 in chips) 
Seat 2: TQ7/UUMjrZ3WL5eLMho7VQ ($4.50 in chips) 
Seat 4: i48129QFpEQQ+UN4aNtmww ($15 in chips) 
Seat 5: rDRzxas/uMDi5Uteo081UQ ($21.15 in chips) 
Seat 6: qGHGf/553gQnDoklMRe3tg ($24.15 in chips) 
eL3+wCBjFGfQ5FMdIZihwA: posts small blind $0.10
TQ7/UUMjrZ3WL5eLMho7VQ: posts big blind $0.25
*** HOLE CARDS ***
i48129QFpEQQ+UN4aNtmww: calls $0.25
rDRzxas/uMDi5Uteo081UQ: folds 
qGHGf/553gQnDoklMRe3tg: raises $1 to $1.25
eL3+wCBjFGfQ5FMdIZihwA: folds 
TQ7/UUMjrZ3WL5eLMho7VQ: folds 
i48129QFpEQQ+UN4aNtmww: calls $1
*** FLOP *** [7h 4c Js]
i48129QFpEQQ+UN4aNtmww: checks 
qGHGf/553gQnDoklMRe3tg: checks 
*** TURN *** [7h 4c Js] [9c]
i48129QFpEQQ+UN4aNtmww: checks 
qGHGf/553gQnDoklMRe3tg: bets $2
i48129QFpEQQ+UN4aNtmww: calls $2
*** RIVER *** [7h 4c Js 9c] [7s]
i48129QFpEQQ+UN4aNtmww: checks 
qGHGf/553gQnDoklMRe3tg: checks 
*** SHOW DOWN ***
i48129QFpEQQ+UN4aNtmww: shows [Qh Tc] (a pair of Sevens)
qGHGf/553gQnDoklMRe3tg: shows [9d Kd] (two pair, Nines and Sevens)
qGHGf/553gQnDoklMRe3tg collected $6.55 from pot
*** SUMMARY ***
Total pot $6.85 | Rake $0.30 
Board [7h 4c Js 9c 7s]
Seat 1: eL3+wCBjFGfQ5FMdIZihwA (small blind) folded before Flop
Seat 2: TQ7/UUMjrZ3WL5eLMho7VQ (big blind) folded before Flop
Seat 4: i48129QFpEQQ+UN4aNtmww showed [Qh Tc] and lost with a pair of Sevens
Seat 5: rDRzxas/uMDi5Uteo081UQ folded before Flop (didn't bet)
Seat 6: qGHGf/553gQnDoklMRe3tg (button) showed [9d Kd] and won ($6.55) with two pair, Nines and Sevens




PokerStars Game #59942010640:  Hold'em No Limit ($0.10/$0.25) - 2009/07/01 1:53:14 ET
Table 'ER5H84HUgJx7HyDLnELLeA' 6-max Seat #3 is the button
Seat 1: LJI7A1YgDM7hgh7o56+ReQ ($25.90 in chips) 
Seat 3: cS21pIxRHx5Gt42o7hPZzw ($12.65 in chips) 
Seat 4: vqWjZmdQu/Hxw96/IJTWdQ ($25.10 in chips) 
Seat 5: mfrkWA3PTeYPkbO6hi98Aw ($26.20 in chips) 
Seat 6: 3zD3qLXT1bEffAoWGnc7wg ($52.40 in chips) 
vqWjZmdQu/Hxw96/IJTWdQ: posts small blind $0.10
mfrkWA3PTeYPkbO6hi98Aw: posts big blind $0.25
*** HOLE CARDS ***
3zD3qLXT1bEffAoWGnc7wg: folds 
LJI7A1YgDM7hgh7o56+ReQ: folds 
cS21pIxRHx5Gt42o7hPZzw: calls $0.25
vqWjZmdQu/Hxw96/IJTWdQ: folds 
mfrkWA3PTeYPkbO6hi98Aw: checks 
*** FLOP *** [7d 4c 3h]
mfrkWA3PTeYPkbO6hi98Aw: bets $0.50
cS21pIxRHx5Gt42o7hPZzw: calls $0.50
*** TURN *** [7d 4c 3h] [Ks]
mfrkWA3PTeYPkbO6hi98Aw: bets $1.25
cS21pIxRHx5Gt42o7hPZzw: folds 
Uncalled bet ($1.25) returned to mfrkWA3PTeYPkbO6hi98Aw
mfrkWA3PTeYPkbO6hi98Aw collected $1.55 from pot
mfrkWA3PTeYPkbO6hi98Aw: doesn't show hand 
*** SUMMARY ***
Total pot $1.60 | Rake $0.05 
Board [7d 4c 3h Ks]
Seat 1: LJI7A1YgDM7hgh7o56+ReQ folded before Flop (didn't bet)
Seat 3: cS21pIxRHx5Gt42o7hPZzw (button) folded on the Turn
Seat 4: vqWjZmdQu/Hxw96/IJTWdQ (small blind) folded before Flop
Seat 5: mfrkWA3PTeYPkbO6hi98Aw (big blind) collected ($1.55)
Seat 6: 3zD3qLXT1bEffAoWGnc7wg folded before Flop (didn't bet)




PokerStars Game #59942011016:  Hold'em No Limit ($0.10/$0.25) - 2009/07/01 1:53:15 ET
Table 'NtCSSONEf1zaJo3042tQug' 6-max Seat #6 is the button
Seat 1: KXtdqb+rIMkjc0RvHDksGQ ($31.60 in chips) 
Seat 2: vqWjZmdQu/Hxw96/IJTWdQ ($25 in chips) 
Seat 3: 9kUKGKkblnIx3m8rlVol6Q ($16.05 in chips) 
Seat 5: tOAk1Og4mVObMBOfvdDYOw ($35.20 in chips) 
Seat 6: LxehwDpTQ19ph4Qmc78+Pw ($33.10 in chips) 
KXtdqb+rIMkjc0RvHDksGQ: posts small blind $0.10
vqWjZmdQu/Hxw96/IJTWdQ: posts big blind $0.25
*** HOLE CARDS ***
9kUKGKkblnIx3m8rlVol6Q: folds 
tOAk1Og4mVObMBOfvdDYOw: raises $0.75 to $1
LxehwDpTQ19ph4Qmc78+Pw: calls $1
KXtdqb+rIMkjc0RvHDksGQ: folds 
vqWjZmdQu/Hxw96/IJTWdQ: folds 
*** FLOP *** [7s 3d Tc]
tOAk1Og4mVObMBOfvdDYOw: checks 
LxehwDpTQ19ph4Qmc78+Pw: checks 
*** TURN *** [7s 3d Tc] [As]
tOAk1Og4mVObMBOfvdDYOw: bets $1.50
LxehwDpTQ19ph4Qmc78+Pw: calls $1.50
*** RIVER *** [7s 3d Tc As] [9s]
tOAk1Og4mVObMBOfvdDYOw: checks 
LxehwDpTQ19ph4Qmc78+Pw: bets $1.50
tOAk1Og4mVObMBOfvdDYOw: calls $1.50
*** SHOW DOWN ***
LxehwDpTQ19ph4Qmc78+Pw: shows [Ad 8d] (a pair of Aces)
tOAk1Og4mVObMBOfvdDYOw: mucks hand 
LxehwDpTQ19ph4Qmc78+Pw collected $7.95 from pot
*** SUMMARY ***
Total pot $8.35 | Rake $0.40 
Board [7s 3d Tc As 9s]
Seat 1: KXtdqb+rIMkjc0RvHDksGQ (small blind) folded before Flop
Seat 2: vqWjZmdQu/Hxw96/IJTWdQ (big blind) folded before Flop
Seat 3: 9kUKGKkblnIx3m8rlVol6Q folded before Flop (didn't bet)
Seat 5: tOAk1Og4mVObMBOfvdDYOw mucked
Seat 6: LxehwDpTQ19ph4Qmc78+Pw (button) showed [Ad 8d] and won ($7.95) with a pair of Aces




PokerStars Game #59942011262:  Hold'em No Limit ($0.10/$0.25) - 2009/07/01 1:53:15 ET
Table 'Is9eNmJA1KnBOw0lcVkxUQ' 9-max Seat #3 is the button
Seat 1: mlXogR/AG8xUvCi1Il31lw ($5 in chips) 
Seat 3: ubsjZomMWSV0hAiBLa7K1A ($17.40 in chips) 
Seat 5: Qduu7ikeizo6q6Ei9YvcJA ($29.75 in chips) 
Seat 6: HapyJHxV6lc3eqoT7yWL2A ($5.55 in chips) 
Seat 8: Th3FldXKQW6hWVVPahaoOQ ($25 in chips) 
EssThirteen will be allowed to play after the button
Qduu7ikeizo6q6Ei9YvcJA: posts small blind $0.10
HapyJHxV6lc3eqoT7yWL2A: posts big blind $0.25
alanbarrie18 is connected 
mlXogR/AG8xUvCi1Il31lw: posts big blind $0.25
*** HOLE CARDS ***
Th3FldXKQW6hWVVPahaoOQ: folds 
Th3FldXKQW6hWVVPahaoOQ leaves the table
-M1TCH-22- joins the table at seat #7 
mlXogR/AG8xUvCi1Il31lw: raises $0.75 to $1
ubsjZomMWSV0hAiBLa7K1A: folds 
Qduu7ikeizo6q6Ei9YvcJA: folds 
HapyJHxV6lc3eqoT7yWL2A: folds 
Uncalled bet ($0.75) returned to mlXogR/AG8xUvCi1Il31lw
mlXogR/AG8xUvCi1Il31lw collected $0.60 from pot
mlXogR/AG8xUvCi1Il31lw: doesn't show hand 
*** SUMMARY ***
Total pot $0.60 | Rake $0 
Seat 1: mlXogR/AG8xUvCi1Il31lw collected ($0.60)
Seat 3: ubsjZomMWSV0hAiBLa7K1A (button) folded before Flop (didn't bet)
Seat 5: Qduu7ikeizo6q6Ei9YvcJA (small blind) folded before Flop
Seat 6: HapyJHxV6lc3eqoT7yWL2A (big blind) folded before Flop
Seat 8: Th3FldXKQW6hWVVPahaoOQ folded before Flop (didn't bet)




PokerStars Game #59942011078:  Hold'em No Limit ($0.10/$0.25) - 2009/07/01 1:53:15 ET
Table 'biAgO3TKQBU8XcrVAoU5TA' 6-max Seat #6 is the button
Seat 2: NPueG39V6nKvDRuvBJ4U7g ($8.35 in chips) 
Seat 3: mfrkWA3PTeYPkbO6hi98Aw ($22.75 in chips) 
Seat 5: n6UPMnVR4v8LFP0rWP73Fg ($25.80 in chips) 
Seat 6: wMiE3yTbDJGOLOF9th7KPA ($23.25 in chips) 
NPueG39V6nKvDRuvBJ4U7g: posts small blind $0.10
mfrkWA3PTeYPkbO6hi98Aw: posts big blind $0.25
blackmari: sits out 
*** HOLE CARDS ***
n6UPMnVR4v8LFP0rWP73Fg: folds 
wMiE3yTbDJGOLOF9th7KPA: calls $0.25
NPueG39V6nKvDRuvBJ4U7g: calls $0.15
mfrkWA3PTeYPkbO6hi98Aw: checks 
*** FLOP *** [Th Tc Kd]
NPueG39V6nKvDRuvBJ4U7g: checks 
mfrkWA3PTeYPkbO6hi98Aw: checks 
wMiE3yTbDJGOLOF9th7KPA: checks 
*** TURN *** [Th Tc Kd] [Qc]
NPueG39V6nKvDRuvBJ4U7g: checks 
mfrkWA3PTeYPkbO6hi98Aw: checks 
wMiE3yTbDJGOLOF9th7KPA: checks 
*** RIVER *** [Th Tc Kd Qc] [9s]
NPueG39V6nKvDRuvBJ4U7g: checks 
mfrkWA3PTeYPkbO6hi98Aw: checks 
wMiE3yTbDJGOLOF9th7KPA: checks 
*** SHOW DOWN ***
NPueG39V6nKvDRuvBJ4U7g: shows [2s 5s] (a pair of Tens)
mfrkWA3PTeYPkbO6hi98Aw: shows [9c 5d] (two pair, Tens and Nines)
wMiE3yTbDJGOLOF9th7KPA: mucks hand 
mfrkWA3PTeYPkbO6hi98Aw collected $0.75 from pot
*** SUMMARY ***
Total pot $0.75 | Rake $0 
Board [Th Tc Kd Qc 9s]
Seat 2: NPueG39V6nKvDRuvBJ4U7g (small blind) showed [2s 5s] and lost with a pair of Tens
Seat 3: mfrkWA3PTeYPkbO6hi98Aw (big blind) showed [9c 5d] and won ($0.75) with two pair, Tens and Nines
Seat 5: n6UPMnVR4v8LFP0rWP73Fg folded before Flop (didn't bet)
Seat 6: wMiE3yTbDJGOLOF9th7KPA (button) mucked




PokerStars Game #59942011772:  Hold'em No Limit ($0.10/$0.25) - 2009/07/01 1:53:16 ET
Table '0mmHveGuaIfIMQlNE1eqMg' 9-max Seat #7 is the button
Seat 1: ydoFOVgzvZv9ZhuWu9rXAw ($5 in chips) 
Seat 2: rQhYIYXSyH/IivYM1dlV5A ($68.50 in chips) 
Seat 3: ghNKXUBl/H+t83JF079ZBA ($25 in chips) 
Seat 4: DnDcAdn9P0zGovMERigpFA ($40.05 in chips) 
Seat 6: 6RiVTYll/5D8zICp0MRpKw ($23.35 in chips) 
Seat 7: JqeaikMej6KsqTKmUhl2Lw ($24.65 in chips) 
Seat 8: 0XACOSNrAWmqNv9k1nF8rw ($21 in chips) 
Seat 9: UNw/UrAelsQeSS17Rro/BA ($4.40 in chips) 
0XACOSNrAWmqNv9k1nF8rw: posts small blind $0.10
UNw/UrAelsQeSS17Rro/BA: posts big blind $0.25
0rQnT3MwKEGi6YXD9FufJw: sits out 
*** HOLE CARDS ***
ydoFOVgzvZv9ZhuWu9rXAw: folds 
rQhYIYXSyH/IivYM1dlV5A: folds 
ghNKXUBl/H+t83JF079ZBA: folds 
DnDcAdn9P0zGovMERigpFA: folds 
6RiVTYll/5D8zICp0MRpKw: folds 
JqeaikMej6KsqTKmUhl2Lw: raises $0.75 to $1
0XACOSNrAWmqNv9k1nF8rw: folds 
UNw/UrAelsQeSS17Rro/BA: calls $0.75
*** FLOP *** [Ac Th 7c]
UNw/UrAelsQeSS17Rro/BA: bets $2
JqeaikMej6KsqTKmUhl2Lw: folds 
Uncalled bet ($2) returned to UNw/UrAelsQeSS17Rro/BA
UNw/UrAelsQeSS17Rro/BA collected $2 from pot
*** SUMMARY ***
Total pot $2.10 | Rake $0.10 
Board [Ac Th 7c]
Seat 1: ydoFOVgzvZv9ZhuWu9rXAw folded before Flop (didn't bet)
Seat 2: rQhYIYXSyH/IivYM1dlV5A folded before Flop (didn't bet)
Seat 3: ghNKXUBl/H+t83JF079ZBA folded before Flop (didn't bet)
Seat 4: DnDcAdn9P0zGovMERigpFA folded before Flop (didn't bet)
Seat 6: 6RiVTYll/5D8zICp0MRpKw folded before Flop (didn't bet)
Seat 7: JqeaikMej6KsqTKmUhl2Lw (button) folded on the Flop
Seat 8: 0XACOSNrAWmqNv9k1nF8rw (small blind) folded before Flop
Seat 9: UNw/UrAelsQeSS17Rro/BA (big blind) collected ($2)




PokerStars Game #59942011294:  Hold'em No Limit ($0.10/$0.25) - 2009/07/01 1:53:16 ET
Table 'XX2OuOsa8/8AC+/mR/Az6g' 9-max Seat #6 is the button
Seat 1: 56S3mA6Zs3pGR+0p0vUCtg ($23.15 in chips) 
Seat 2: Bb42QRQMhg5/Y0vHP8/2Xw ($25.60 in chips) 
Seat 3: oLa/tXLfSLLB28mcLGrxcg ($23.10 in chips) 
Seat 4: 5pDhXQ+RVy0BGcwfJAJfbg ($24.65 in chips) 
Seat 5: SpiiQQAzy4MUgV3I5W8giw ($20.80 in chips) 
Seat 6: RCqMONFrSPSArZh2Jsar/w ($24.90 in chips) 
Seat 8: qwr38jl5txoR36M7G5qi4A ($10.10 in chips) 
Seat 9: V6p0jQ/RhUsqpHLmXvEX4Q ($12 in chips) 
qwr38jl5txoR36M7G5qi4A: posts small blind $0.10
V6p0jQ/RhUsqpHLmXvEX4Q: posts big blind $0.25
*** HOLE CARDS ***
56S3mA6Zs3pGR+0p0vUCtg: folds 
Bb42QRQMhg5/Y0vHP8/2Xw: folds 
oLa/tXLfSLLB28mcLGrxcg: raises $0.75 to $1
5pDhXQ+RVy0BGcwfJAJfbg: folds 
SpiiQQAzy4MUgV3I5W8giw: folds 
RCqMONFrSPSArZh2Jsar/w: folds 
qwr38jl5txoR36M7G5qi4A: folds 
V6p0jQ/RhUsqpHLmXvEX4Q: folds 
Uncalled bet ($0.75) returned to oLa/tXLfSLLB28mcLGrxcg
oLa/tXLfSLLB28mcLGrxcg collected $0.60 from pot
oLa/tXLfSLLB28mcLGrxcg: doesn't show hand 
*** SUMMARY ***
Total pot $0.60 | Rake $0 
Seat 1: 56S3mA6Zs3pGR+0p0vUCtg folded before Flop (didn't bet)
Seat 2: Bb42QRQMhg5/Y0vHP8/2Xw folded before Flop (didn't bet)
Seat 3: oLa/tXLfSLLB28mcLGrxcg collected ($0.60)
Seat 4: 5pDhXQ+RVy0BGcwfJAJfbg folded before Flop (didn't bet)
Seat 5: SpiiQQAzy4MUgV3I5W8giw folded before Flop (didn't bet)
Seat 6: RCqMONFrSPSArZh2Jsar/w (button) folded before Flop (didn't bet)
Seat 8: qwr38jl5txoR36M7G5qi4A (small blind) folded before Flop
Seat 9: V6p0jQ/RhUsqpHLmXvEX4Q (big blind) folded before Flop




PokerStars Game #59942011304:  Hold'em No Limit ($0.10/$0.25) - 2009/07/01 1:53:16 ET
Table '3760QYRYyCWeXf0rLZ5S2g' 9-max Seat #6 is the button
Seat 1: CT7Xj/V/O5rBlhtt+RZeFQ ($27.55 in chips) 
Seat 2: zDrucyjVn5aeekNEc3cJrA ($26.95 in chips) 
Seat 4: ziFpkH3wCzqB/qXeq/Hy7g ($25.35 in chips) 
Seat 5: Bb42QRQMhg5/Y0vHP8/2Xw ($29.55 in chips) 
Seat 6: q+Qdg0Hoir+SyL7haBrUnw ($13.60 in chips) 
Seat 7: 6C2DoQ+GZHBOpb+qyrSnqA ($5.85 in chips) 
Seat 8: clJsV3v77RS07bDKY+705w ($5.25 in chips) 
Seat 9: BCwIzs00xY6DtWGghTGEwg ($14.75 in chips) 
6C2DoQ+GZHBOpb+qyrSnqA: posts small blind $0.10
clJsV3v77RS07bDKY+705w: posts big blind $0.25
4qA/3Ajg3pP6fqW+IX9/fQ: sits out 
*** HOLE CARDS ***
BCwIzs00xY6DtWGghTGEwg: folds 
CT7Xj/V/O5rBlhtt+RZeFQ: folds 
zDrucyjVn5aeekNEc3cJrA: folds 
ziFpkH3wCzqB/qXeq/Hy7g: folds 
Bb42QRQMhg5/Y0vHP8/2Xw: calls $0.25
q+Qdg0Hoir+SyL7haBrUnw: folds 
6C2DoQ+GZHBOpb+qyrSnqA: calls $0.15
clJsV3v77RS07bDKY+705w: checks 
*** FLOP *** [2c 4c As]
6C2DoQ+GZHBOpb+qyrSnqA: checks 
clJsV3v77RS07bDKY+705w: checks 
Bb42QRQMhg5/Y0vHP8/2Xw: checks 
*** TURN *** [2c 4c As] [5h]
6C2DoQ+GZHBOpb+qyrSnqA: checks 
clJsV3v77RS07bDKY+705w: checks 
Bb42QRQMhg5/Y0vHP8/2Xw: checks 
*** RIVER *** [2c 4c As 5h] [4s]
6C2DoQ+GZHBOpb+qyrSnqA: checks 
clJsV3v77RS07bDKY+705w: checks 
Bb42QRQMhg5/Y0vHP8/2Xw: checks 
*** SHOW DOWN ***
6C2DoQ+GZHBOpb+qyrSnqA: shows [5d 9d] (two pair, Fives and Fours)
clJsV3v77RS07bDKY+705w: mucks hand 
Bb42QRQMhg5/Y0vHP8/2Xw: mucks hand 
6C2DoQ+GZHBOpb+qyrSnqA collected $0.75 from pot
*** SUMMARY ***
Total pot $0.75 | Rake $0 
Board [2c 4c As 5h 4s]
Seat 1: CT7Xj/V/O5rBlhtt+RZeFQ folded before Flop (didn't bet)
Seat 2: zDrucyjVn5aeekNEc3cJrA folded before Flop (didn't bet)
Seat 4: ziFpkH3wCzqB/qXeq/Hy7g folded before Flop (didn't bet)
Seat 5: Bb42QRQMhg5/Y0vHP8/2Xw mucked
Seat 6: q+Qdg0Hoir+SyL7haBrUnw (button) folded before Flop (didn't bet)
Seat 7: 6C2DoQ+GZHBOpb+qyrSnqA (small blind) showed [5d 9d] and won ($0.75) with two pair, Fives and Fours
Seat 8: clJsV3v77RS07bDKY+705w (big blind) mucked
Seat 9: BCwIzs00xY6DtWGghTGEwg folded before Flop (didn't bet)




PokerStars Game #59942011390:  Hold'em No Limit ($0.10/$0.25) - 2009/07/01 1:53:16 ET
Table 'wPWRBZPJl1HAnysw7qRR0A' 6-max Seat #4 is the button
Seat 1: m7ne1MOFTQXlsXT7/R/rug ($10.90 in chips) 
Seat 2: xC0kaiDYM6YTlgODL83O5A ($23 in chips) 
Seat 4: epAUIB7h2FJXzUPRIvSkRA ($50 in chips) 
Seat 5: y0B+UpYpOUJz3JWtlJQBSA ($14.80 in chips) 
y0B+UpYpOUJz3JWtlJQBSA: posts small blind $0.10
VXTONriS+Ohik+r0FeicIw: is sitting out 
m7ne1MOFTQXlsXT7/R/rug: posts big blind $0.25
*** HOLE CARDS ***
VXTONriS+Ohik+r0FeicIw leaves the table
xC0kaiDYM6YTlgODL83O5A: raises $0.50 to $0.75
epAUIB7h2FJXzUPRIvSkRA: calls $0.75
y0B+UpYpOUJz3JWtlJQBSA: calls $0.65
m7ne1MOFTQXlsXT7/R/rug: calls $0.50
*** FLOP *** [3s Ac Ah]
y0B+UpYpOUJz3JWtlJQBSA: checks 
m7ne1MOFTQXlsXT7/R/rug: checks 
xC0kaiDYM6YTlgODL83O5A: bets $0.25
epAUIB7h2FJXzUPRIvSkRA: raises $2.25 to $2.50
y0B+UpYpOUJz3JWtlJQBSA: calls $2.50
m7ne1MOFTQXlsXT7/R/rug: folds 
xC0kaiDYM6YTlgODL83O5A: folds 
*** TURN *** [3s Ac Ah] [Qd]
y0B+UpYpOUJz3JWtlJQBSA: checks 
epAUIB7h2FJXzUPRIvSkRA: bets $5.50
y0B+UpYpOUJz3JWtlJQBSA: raises $6.05 to $11.55 and is all-in
epAUIB7h2FJXzUPRIvSkRA: calls $6.05
*** RIVER *** [3s Ac Ah Qd] [Jd]
*** SHOW DOWN ***
y0B+UpYpOUJz3JWtlJQBSA: shows [Ad 9h] (three of a kind, Aces)
epAUIB7h2FJXzUPRIvSkRA: shows [3h 3d] (a full house, Threes full of Aces)
epAUIB7h2FJXzUPRIvSkRA collected $29.85 from pot
*** SUMMARY ***
Total pot $31.35 | Rake $1.50 
Board [3s Ac Ah Qd Jd]
Seat 1: m7ne1MOFTQXlsXT7/R/rug (big blind) folded on the Flop
Seat 2: xC0kaiDYM6YTlgODL83O5A folded on the Flop
Seat 4: epAUIB7h2FJXzUPRIvSkRA (button) showed [3h 3d] and won ($29.85) with a full house, Threes full of Aces
Seat 5: y0B+UpYpOUJz3JWtlJQBSA (small blind) showed [Ad 9h] and lost with three of a kind, Aces




PokerStars Game #59942011642:  Hold'em No Limit ($0.10/$0.25) - 2009/07/01 1:53:16 ET
Table '29D3eoQzK5kOAT0OIDS2uQ' 6-max Seat #2 is the button
Seat 1: kG34n23qFQA3nzdOJTQ1dA ($43.05 in chips) 
Seat 2: FyE+TQ5JcCqI/tCCHf0jGA ($16.35 in chips) 
Seat 4: 0wUowrieiZhJzm3L0SoiKA ($15.35 in chips) 
Seat 5: Q3EMN7b0ie81AFWkDrhCjw ($41.10 in chips) 
08V++DOqzaNrRNsHIwi25w will be allowed to play after the button
0wUowrieiZhJzm3L0SoiKA: posts small blind $0.10
Q3EMN7b0ie81AFWkDrhCjw: posts big blind $0.25
if4dh6jhJXeN3/qd3qCp9g: sits out 
*** HOLE CARDS ***
kG34n23qFQA3nzdOJTQ1dA: folds 
FyE+TQ5JcCqI/tCCHf0jGA: folds 
0wUowrieiZhJzm3L0SoiKA: raises $0.50 to $0.75
Q3EMN7b0ie81AFWkDrhCjw: calls $0.50
*** FLOP *** [Tc 4h 8c]
0wUowrieiZhJzm3L0SoiKA: bets $0.75
Q3EMN7b0ie81AFWkDrhCjw: calls $0.75
*** TURN *** [Tc 4h 8c] [Jd]
0wUowrieiZhJzm3L0SoiKA: bets $1.50
Q3EMN7b0ie81AFWkDrhCjw: calls $1.50
*** RIVER *** [Tc 4h 8c Jd] [Qd]
0wUowrieiZhJzm3L0SoiKA: bets $2.50
Q3EMN7b0ie81AFWkDrhCjw: folds 
Uncalled bet ($2.50) returned to 0wUowrieiZhJzm3L0SoiKA
0wUowrieiZhJzm3L0SoiKA collected $5.75 from pot
*** SUMMARY ***
Total pot $6 | Rake $0.25 
Board [Tc 4h 8c Jd Qd]
Seat 1: kG34n23qFQA3nzdOJTQ1dA folded before Flop (didn't bet)
Seat 2: FyE+TQ5JcCqI/tCCHf0jGA (button) folded before Flop (didn't bet)
Seat 4: 0wUowrieiZhJzm3L0SoiKA (small blind) collected ($5.75)
Seat 5: Q3EMN7b0ie81AFWkDrhCjw (big blind) folded on the River




PokerStars Game #59942011504:  Hold'em No Limit ($0.10/$0.25) - 2009/07/01 1:53:16 ET
Table 'QegsWX65l3n/K0A8XB78yg' 6-max Seat #1 is the button
Seat 1: p6adJRMXMBLr+xtQzqazIQ ($12 in chips) 
Seat 2: GC/9yVD59DUCX7hUI7gcLw ($56.20 in chips) 
Seat 4: epAUIB7h2FJXzUPRIvSkRA ($30.75 in chips) 
Seat 5: QqiZLFrN8iOUT/GHw7ztOA ($26.35 in chips) 
Seat 6: 5PWs02z65jSO5pr/M6wx/w ($13.45 in chips) 
GC/9yVD59DUCX7hUI7gcLw: posts small blind $0.10
epAUIB7h2FJXzUPRIvSkRA: posts big blind $0.25
*** HOLE CARDS ***
QqiZLFrN8iOUT/GHw7ztOA: folds 
5PWs02z65jSO5pr/M6wx/w: folds 
p6adJRMXMBLr+xtQzqazIQ: folds 
GC/9yVD59DUCX7hUI7gcLw: raises $0.75 to $1
epAUIB7h2FJXzUPRIvSkRA: folds 
Uncalled bet ($0.75) returned to GC/9yVD59DUCX7hUI7gcLw
GC/9yVD59DUCX7hUI7gcLw collected $0.50 from pot
*** SUMMARY ***
Total pot $0.50 | Rake $0 
Seat 1: p6adJRMXMBLr+xtQzqazIQ (button) folded before Flop (didn't bet)
Seat 2: GC/9yVD59DUCX7hUI7gcLw (small blind) collected ($0.50)
Seat 4: epAUIB7h2FJXzUPRIvSkRA (big blind) folded before Flop
Seat 5: QqiZLFrN8iOUT/GHw7ztOA folded before Flop (didn't bet)
Seat 6: 5PWs02z65jSO5pr/M6wx/w folded before Flop (didn't bet)




PokerStars Game #59942011402:  Hold'em No Limit ($0.10/$0.25) - 2009/07/01 1:53:16 ET
Table 'hfHe8uKeSJMyWAjSdM7ROQ' 6-max Seat #4 is the button
Seat 1: eHsmIvAb2JREg4O6hNPnXg ($43.80 in chips) 
Seat 2: QvTX2yGq3uKJiKPmns4TKQ ($29.20 in chips) 
Seat 3: dOX4wnYV2sEqvDbF+8KSCw ($26 in chips) 
Seat 4: b4wRQV3APH8irVk6bUFe2Q ($32.80 in chips) 
Seat 5: euswrBD1XG0Q5hB1iGJBKQ ($59.80 in chips) 
Seat 6: eL3+wCBjFGfQ5FMdIZihwA ($26.75 in chips) 
euswrBD1XG0Q5hB1iGJBKQ: posts small blind $0.10
eL3+wCBjFGfQ5FMdIZihwA: posts big blind $0.25
*** HOLE CARDS ***
eHsmIvAb2JREg4O6hNPnXg: raises $0.50 to $0.75
QvTX2yGq3uKJiKPmns4TKQ: folds 
dOX4wnYV2sEqvDbF+8KSCw: folds 
b4wRQV3APH8irVk6bUFe2Q: raises $1 to $1.75
euswrBD1XG0Q5hB1iGJBKQ: folds 
eL3+wCBjFGfQ5FMdIZihwA: folds 
eHsmIvAb2JREg4O6hNPnXg: calls $1
*** FLOP *** [2d 7h Jc]
eHsmIvAb2JREg4O6hNPnXg: checks 
b4wRQV3APH8irVk6bUFe2Q: bets $2.25
eHsmIvAb2JREg4O6hNPnXg: folds 
Uncalled bet ($2.25) returned to b4wRQV3APH8irVk6bUFe2Q
b4wRQV3APH8irVk6bUFe2Q collected $3.70 from pot
*** SUMMARY ***
Total pot $3.85 | Rake $0.15 
Board [2d 7h Jc]
Seat 1: eHsmIvAb2JREg4O6hNPnXg folded on the Flop
Seat 2: QvTX2yGq3uKJiKPmns4TKQ folded before Flop (didn't bet)
Seat 3: dOX4wnYV2sEqvDbF+8KSCw folded before Flop (didn't bet)
Seat 4: b4wRQV3APH8irVk6bUFe2Q (button) collected ($3.70)
Seat 5: euswrBD1XG0Q5hB1iGJBKQ (small blind) folded before Flop
Seat 6: eL3+wCBjFGfQ5FMdIZihwA (big blind) folded before Flop




PokerStars Game #59942011668:  Hold'em No Limit ($0.10/$0.25) - 2009/07/01 1:53:16 ET
Table 'oJpFwZj9+FUGHX90Un8s9Q' 6-max Seat #5 is the button
Seat 1: 6DwBRH+xZ12AAZmeAg+aXw ($25.50 in chips) 
Seat 2: NtrVQ9UIql0rDCnKDKZ5FQ ($22.50 in chips) 
Seat 3: kyRaCIljYA6l33lSKQfNsg ($22.15 in chips) 
Seat 4: 6elpmfyt4Zw0yvd8lePSMQ ($21.90 in chips) 
Seat 5: kG34n23qFQA3nzdOJTQ1dA ($58.70 in chips) 
Seat 6: 7LpHJVeM6k1mQdC6HXYzww ($25 in chips) 
7LpHJVeM6k1mQdC6HXYzww: posts small blind $0.10
6DwBRH+xZ12AAZmeAg+aXw: posts big blind $0.25
*** HOLE CARDS ***
NtrVQ9UIql0rDCnKDKZ5FQ: folds 
kyRaCIljYA6l33lSKQfNsg: folds 
6elpmfyt4Zw0yvd8lePSMQ: calls $0.25
kG34n23qFQA3nzdOJTQ1dA: folds 
7LpHJVeM6k1mQdC6HXYzww: folds 
6DwBRH+xZ12AAZmeAg+aXw: raises $0.75 to $1
6elpmfyt4Zw0yvd8lePSMQ: folds 
Uncalled bet ($0.75) returned to 6DwBRH+xZ12AAZmeAg+aXw
6DwBRH+xZ12AAZmeAg+aXw collected $0.60 from pot
6DwBRH+xZ12AAZmeAg+aXw: doesn't show hand 
*** SUMMARY ***
Total pot $0.60 | Rake $0 
Seat 1: 6DwBRH+xZ12AAZmeAg+aXw (big blind) collected ($0.60)
Seat 2: NtrVQ9UIql0rDCnKDKZ5FQ folded before Flop (didn't bet)
Seat 3: kyRaCIljYA6l33lSKQfNsg folded before Flop (didn't bet)
Seat 4: 6elpmfyt4Zw0yvd8lePSMQ folded before Flop
Seat 5: kG34n23qFQA3nzdOJTQ1dA (button) folded before Flop (didn't bet)
Seat 6: 7LpHJVeM6k1mQdC6HXYzww (small blind) folded before Flop




PokerStars Game #59942011330:  Hold'em No Limit ($0.10/$0.25) - 2009/07/01 1:53:16 ET
Table 'WY+lMaAoIdBZmwk27/RJCA' 6-max Seat #2 is the button
Seat 1: zHHLkD2sRljslKKeQv/ZQw ($32.95 in chips) 
Seat 2: NhUN/JpAprdJeamFBgJH1w ($28.25 in chips) 
Seat 3: QqiZLFrN8iOUT/GHw7ztOA ($26.35 in chips) 
Seat 4: 0av6tRNdi0Ui4f15L7gsVg ($23.15 in chips) 
Seat 5: vqWjZmdQu/Hxw96/IJTWdQ ($27.95 in chips) 
Seat 6: cWc85bEzdRzpUMhRKm8pwQ ($25 in chips) 
QqiZLFrN8iOUT/GHw7ztOA: posts small blind $0.10
0av6tRNdi0Ui4f15L7gsVg: posts big blind $0.25
*** HOLE CARDS ***
vqWjZmdQu/Hxw96/IJTWdQ: folds 
cWc85bEzdRzpUMhRKm8pwQ: folds 
zHHLkD2sRljslKKeQv/ZQw: raises $0.25 to $0.50
NhUN/JpAprdJeamFBgJH1w: folds 
QqiZLFrN8iOUT/GHw7ztOA: folds 
0av6tRNdi0Ui4f15L7gsVg: folds 
Uncalled bet ($0.25) returned to zHHLkD2sRljslKKeQv/ZQw
zHHLkD2sRljslKKeQv/ZQw collected $0.60 from pot
*** SUMMARY ***
Total pot $0.60 | Rake $0 
Seat 1: zHHLkD2sRljslKKeQv/ZQw collected ($0.60)
Seat 2: NhUN/JpAprdJeamFBgJH1w (button) folded before Flop (didn't bet)
Seat 3: QqiZLFrN8iOUT/GHw7ztOA (small blind) folded before Flop
Seat 4: 0av6tRNdi0Ui4f15L7gsVg (big blind) folded before Flop
Seat 5: vqWjZmdQu/Hxw96/IJTWdQ folded before Flop (didn't bet)
Seat 6: cWc85bEzdRzpUMhRKm8pwQ folded before Flop (didn't bet)




PokerStars Game #59942011706:  Hold'em No Limit ($0.10/$0.25) - 2009/07/01 1:53:16 ET
Table 'ThBZ355rqvsb8UGb6ajbig' 9-max Seat #3 is the button
Seat 2: 4awUyiDYTgylQKXZ9faBVA ($25 in chips) 
Seat 3: H5Se03ZqSX7tbULXur2MAg ($27.45 in chips) 
Seat 4: zgi+EUykT/pZQpoUG6+oEg ($5.50 in chips) 
Seat 5: cKlmpQMahVsmOaxFQDcoOg ($24.60 in chips) 
Seat 6: qwr38jl5txoR36M7G5qi4A ($11 in chips) 
Seat 8: pplNliE3WonjkPRf+GZq2A ($34.15 in chips) 
Seat 9: sD+TKtt36XiiN6jqHiLwDA ($24.65 in chips) 
zgi+EUykT/pZQpoUG6+oEg: posts small blind $0.10
cKlmpQMahVsmOaxFQDcoOg: posts big blind $0.25
*** HOLE CARDS ***
zUXhymECc2C9W9ZNw6qppA is connected 
qwr38jl5txoR36M7G5qi4A: folds 
pplNliE3WonjkPRf+GZq2A: folds 
sD+TKtt36XiiN6jqHiLwDA: raises $0.75 to $1
4awUyiDYTgylQKXZ9faBVA: folds 
H5Se03ZqSX7tbULXur2MAg: folds 
zgi+EUykT/pZQpoUG6+oEg: folds 
cKlmpQMahVsmOaxFQDcoOg: folds 
Uncalled bet ($0.75) returned to sD+TKtt36XiiN6jqHiLwDA
sD+TKtt36XiiN6jqHiLwDA collected $0.60 from pot
sD+TKtt36XiiN6jqHiLwDA: doesn't show hand 
*** SUMMARY ***
Total pot $0.60 | Rake $0 
Seat 2: 4awUyiDYTgylQKXZ9faBVA folded before Flop (didn't bet)
Seat 3: H5Se03ZqSX7tbULXur2MAg (button) folded before Flop (didn't bet)
Seat 4: zgi+EUykT/pZQpoUG6+oEg (small blind) folded before Flop
Seat 5: cKlmpQMahVsmOaxFQDcoOg (big blind) folded before Flop
Seat 6: qwr38jl5txoR36M7G5qi4A folded before Flop (didn't bet)
Seat 8: pplNliE3WonjkPRf+GZq2A folded before Flop (didn't bet)
Seat 9: sD+TKtt36XiiN6jqHiLwDA collected ($0.60)




PokerStars Game #59942012158:  Hold'em No Limit ($0.10/$0.25) - 2009/07/01 1:53:17 ET
Table 'nc6OeGk/wtaWV+6N+kgnZQgZetDqJh6q9A3mLO3ThCsASeat #2 is the button
Seat 1: DihMHaz4WNETH1bPDe13kA ($26.10 in chips) 
Seat 2: JFIAqU8lCZ0vWwEl4bdGsg ($34.85 in chips) 
Seat 3: jp34e617tIzV8tKIWmfAbA ($34.50 in chips) 
Seat 4: BV+K0Phf5VBHr7aZPKqbUQ ($32.90 in chips) 
Seat 5: SxIIgwXYLkwd6m3wLyPTCw ($25 in chips) 
Seat 6: Mhj3q7cxev+XjXZxEE6/Cw ($25 in chips) 
jp34e617tIzV8tKIWmfAbA: posts small blind $0.10
BV+K0Phf5VBHr7aZPKqbUQ: posts big blind $0.25
*** HOLE CARDS ***
SxIIgwXYLkwd6m3wLyPTCw: folds 
Mhj3q7cxev+XjXZxEE6/Cw: folds 
DihMHaz4WNETH1bPDe13kA: folds 
JFIAqU8lCZ0vWwEl4bdGsg: raises $0.60 to $0.85
jp34e617tIzV8tKIWmfAbA: folds 
BV+K0Phf5VBHr7aZPKqbUQ: folds 
Uncalled bet ($0.60) returned to JFIAqU8lCZ0vWwEl4bdGsg
JFIAqU8lCZ0vWwEl4bdGsg collected $0.60 from pot
JFIAqU8lCZ0vWwEl4bdGsg: doesn't show hand 
*** SUMMARY ***
Total pot $0.60 | Rake $0 
Seat 1: DihMHaz4WNETH1bPDe13kA folded before Flop (didn't bet)
Seat 2: JFIAqU8lCZ0vWwEl4bdGsg (button) collected ($0.60)
Seat 3: jp34e617tIzV8tKIWmfAbA (small blind) folded before Flop
Seat 4: BV+K0Phf5VBHr7aZPKqbUQ (big blind) folded before Flop
Seat 5: SxIIgwXYLkwd6m3wLyPTCw folded before Flop (didn't bet)
Seat 6: Mhj3q7cxev+XjXZxEE6/Cw folded before Flop (didn't bet)




PokerStars Game #59942011892:  Hold'em No Limit ($0.10/$0.25) - 2009/07/01 1:53:17 ET
Table 'g6ryG70feTw9nNm+XJLuXw' 6-max Seat #6 is the button
Seat 1: v+QfkGiuj9bgtuNoVnDO8w ($34.85 in chips) 
Seat 2: SxIIgwXYLkwd6m3wLyPTCw ($33.90 in chips) 
Seat 3: cezpHJ8FB07dj0xG+LhOvw ($25 in chips) 
Seat 4: GC/9yVD59DUCX7hUI7gcLw ($44 in chips) 
Seat 5: EE16Ua5b1HSsYej5zeXOlA ($25 in chips) 
Seat 6: Mhj3q7cxev+XjXZxEE6/Cw ($27.70 in chips) 
v+QfkGiuj9bgtuNoVnDO8w: posts small blind $0.10
SxIIgwXYLkwd6m3wLyPTCw: posts big blind $0.25
*** HOLE CARDS ***
cezpHJ8FB07dj0xG+LhOvw: folds 
GC/9yVD59DUCX7hUI7gcLw: raises $0.75 to $1
EE16Ua5b1HSsYej5zeXOlA: folds 
Mhj3q7cxev+XjXZxEE6/Cw: folds 
v+QfkGiuj9bgtuNoVnDO8w: folds 
SxIIgwXYLkwd6m3wLyPTCw: folds 
Uncalled bet ($0.75) returned to GC/9yVD59DUCX7hUI7gcLw
GC/9yVD59DUCX7hUI7gcLw collected $0.60 from pot
v+QfkGiuj9bgtuNoVnDO8w is sitting out
*** SUMMARY ***
Total pot $0.60 | Rake $0 
Seat 1: v+QfkGiuj9bgtuNoVnDO8w (small blind) folded before Flop
Seat 2: SxIIgwXYLkwd6m3wLyPTCw (big blind) folded before Flop
Seat 3: cezpHJ8FB07dj0xG+LhOvw folded before Flop (didn't bet)
Seat 4: GC/9yVD59DUCX7hUI7gcLw collected ($0.60)
Seat 5: EE16Ua5b1HSsYej5zeXOlA folded before Flop (didn't bet)
Seat 6: Mhj3q7cxev+XjXZxEE6/Cw (button) folded before Flop (didn't bet)




PokerStars Game #59942011980:  Hold'em No Limit ($0.10/$0.25) - 2009/07/01 1:53:17 ET
Table 'CBnRhp0d6E2+/NtM7Vbruw' 9-max Seat #8 is the button
Seat 1: 18G4P1XstjNvItdGUITxgw ($25 in chips) 
Seat 2: cZ99hugmLBj9KhTlc8nCSw ($26.50 in chips) 
Seat 3: Y3DZ6qQlLeBhixDj4M9vmg ($6.15 in chips) 
Seat 5: CT7Xj/V/O5rBlhtt+RZeFQ ($25.35 in chips) 
Seat 6: CvL9Ch1HYCVbTsfpNucitg ($6.55 in chips) 
Seat 7: j4q3p0lesp63b1gZDwLBZw ($5 in chips) 
Seat 8: MG90wfSJZnOejs/KD3vlQQ ($25 in chips) 
Seat 9: xHZZRLAaFUIC8WWI8ljOJA ($27.30 in chips) 
xHZZRLAaFUIC8WWI8ljOJA: posts small blind $0.10
18G4P1XstjNvItdGUITxgw: posts big blind $0.25
*** HOLE CARDS ***
cZ99hugmLBj9KhTlc8nCSw: folds 
Y3DZ6qQlLeBhixDj4M9vmg: raises $0.50 to $0.75
CT7Xj/V/O5rBlhtt+RZeFQ: folds 
CvL9Ch1HYCVbTsfpNucitg: folds 
j4q3p0lesp63b1gZDwLBZw: folds 
MG90wfSJZnOejs/KD3vlQQ: folds 
xHZZRLAaFUIC8WWI8ljOJA: folds 
18G4P1XstjNvItdGUITxgw: folds 
Uncalled bet ($0.50) returned to Y3DZ6qQlLeBhixDj4M9vmg
Y3DZ6qQlLeBhixDj4M9vmg collected $0.60 from pot
Y3DZ6qQlLeBhixDj4M9vmg: doesn't show hand 
*** SUMMARY ***
Total pot $0.60 | Rake $0 
Seat 1: 18G4P1XstjNvItdGUITxgw (big blind) folded before Flop
Seat 2: cZ99hugmLBj9KhTlc8nCSw folded before Flop (didn't bet)
Seat 3: Y3DZ6qQlLeBhixDj4M9vmg collected ($0.60)
Seat 5: CT7Xj/V/O5rBlhtt+RZeFQ folded before Flop (didn't bet)
Seat 6: CvL9Ch1HYCVbTsfpNucitg folded before Flop (didn't bet)
Seat 7: j4q3p0lesp63b1gZDwLBZw folded before Flop (didn't bet)
Seat 8: MG90wfSJZnOejs/KD3vlQQ (button) folded before Flop (didn't bet)
Seat 9: xHZZRLAaFUIC8WWI8ljOJA (small blind) folded before Flop




PokerStars Game #59942012062:  Hold'em No Limit ($0.10/$0.25) - 2009/07/01 1:53:17 ET
Table '3LMlz3V4AziGlU+ikmyU8w' 6-max Seat #1 is the button
Seat 1: ErIN0JRL5srYjT6en1f8YQ ($24.65 in chips) 
Seat 2: uR3AbFJLoOX86DOTtTgGcg ($35.50 in chips) 
Seat 3: Hzy03WtPHMYwLYM7hTTxQw ($52.15 in chips) 
Seat 5: tOAk1Og4mVObMBOfvdDYOw ($25 in chips) 
Seat 6: 7LpHJVeM6k1mQdC6HXYzww ($49.70 in chips) 
uR3AbFJLoOX86DOTtTgGcg: posts small blind $0.10
Hzy03WtPHMYwLYM7hTTxQw: posts big blind $0.25
k021eD5in2AjaloW5PalMg: sits out 
*** HOLE CARDS ***
tOAk1Og4mVObMBOfvdDYOw: raises $0.75 to $1
7LpHJVeM6k1mQdC6HXYzww: folds 
ErIN0JRL5srYjT6en1f8YQ: folds 
uR3AbFJLoOX86DOTtTgGcg: folds 
Hzy03WtPHMYwLYM7hTTxQw: folds 
Uncalled bet ($0.75) returned to tOAk1Og4mVObMBOfvdDYOw
tOAk1Og4mVObMBOfvdDYOw collected $0.60 from pot
tOAk1Og4mVObMBOfvdDYOw: doesn't show hand 
*** SUMMARY ***
Total pot $0.60 | Rake $0 
Seat 1: ErIN0JRL5srYjT6en1f8YQ (button) folded before Flop (didn't bet)
Seat 2: uR3AbFJLoOX86DOTtTgGcg (small blind) folded before Flop
Seat 3: Hzy03WtPHMYwLYM7hTTxQw (big blind) folded before Flop
Seat 5: tOAk1Og4mVObMBOfvdDYOw collected ($0.60)
Seat 6: 7LpHJVeM6k1mQdC6HXYzww folded before Flop (didn't bet)




PokerStars Game #59942012496:  Hold'em No Limit ($0.10/$0.25) - 2009/07/01 1:53:18 ET
Table 'ZiwAqg4o02gNro+JOAaFNg6wawJ+MkkvuC3coG6r+YhgSeat #8 is the button
Seat 1: 6RiVTYll/5D8zICp0MRpKw ($28.35 in chips) 
Seat 2: VCKtuATyvAq9H2JSAQxPbA ($11.25 in chips) 
Seat 3: aNpwfA31EREwO+ar4XzBCw ($39.85 in chips) 
Seat 4: RHqgdFvufLCYe54+qd2gcA ($11.55 in chips) 
Seat 6: 5n7e7I+px7c6CQmLpPbtsg ($4.65 in chips) 
Seat 7: yyG4svzOpC1A+sUP/scg6w ($5.60 in chips) 
Seat 8: VLIsy+xjx3olLSYO3JLS6g ($15.75 in chips) 
Seat 9: ljemhp25Zg+nlA9DLCIiUw ($23.65 in chips) 
ljemhp25Zg+nlA9DLCIiUw: posts small blind $0.10
6RiVTYll/5D8zICp0MRpKw: posts big blind $0.25
*** HOLE CARDS ***
VCKtuATyvAq9H2JSAQxPbA: calls $0.25
aNpwfA31EREwO+ar4XzBCw: folds 
RHqgdFvufLCYe54+qd2gcA: folds 
6HoFYfVGBefsR5Vrz62qIw5hAPbqNrvJb8PtLiceXtlgves the table
5n7e7I+px7c6CQmLpPbtsg: folds 
W6tExOcYX7qiy6Qdp+ZwFA joins the table at seat #5 
yyG4svzOpC1A+sUP/scg6w: folds 
VLIsy+xjx3olLSYO3JLS6g: raises $0.50 to $0.75
ljemhp25Zg+nlA9DLCIiUw: folds 
6RiVTYll/5D8zICp0MRpKw: folds 
VCKtuATyvAq9H2JSAQxPbA: calls $0.50
*** FLOP *** [4c Kc 2d]
VCKtuATyvAq9H2JSAQxPbA: checks 
VLIsy+xjx3olLSYO3JLS6g: bets $1
VCKtuATyvAq9H2JSAQxPbA: folds 
Uncalled bet ($1) returned to VLIsy+xjx3olLSYO3JLS6g
VLIsy+xjx3olLSYO3JLS6g collected $1.80 from pot
VLIsy+xjx3olLSYO3JLS6g: doesn't show hand 
*** SUMMARY ***
Total pot $1.85 | Rake $0.05 
Board [4c Kc 2d]
Seat 1: 6RiVTYll/5D8zICp0MRpKw (big blind) folded before Flop
Seat 2: VCKtuATyvAq9H2JSAQxPbA folded on the Flop
Seat 3: aNpwfA31EREwO+ar4XzBCw folded before Flop (didn't bet)
Seat 4: RHqgdFvufLCYe54+qd2gcA folded before Flop (didn't bet)
Seat 6: 5n7e7I+px7c6CQmLpPbtsg folded before Flop (didn't bet)
Seat 7: yyG4svzOpC1A+sUP/scg6w folded before Flop (didn't bet)
Seat 8: VLIsy+xjx3olLSYO3JLS6g (button) collected ($1.80)
Seat 9: ljemhp25Zg+nlA9DLCIiUw (small blind) folded before Flop




PokerStars Game #59942012362:  Hold'em No Limit ($0.10/$0.25) - 2009/07/01 1:53:18 ET
Table 'MRfAiS/4JSfnUDlCcZo0wAhfHe8uKeSJMyWAjSdM7ROQx Seat #4 is the button
Seat 1: 48oT5xFI+5CHUJlfoGrE4w ($29.30 in chips) 
Seat 2: /gJNBeCkWL4o85/jvlZ4BA ($25.70 in chips) 
Seat 4: b4wRQV3APH8irVk6bUFe2Q ($36.75 in chips) 
Seat 5: Q1uciOZPBR/WkAlqa6cL4A ($27.60 in chips) 
Seat 6: df01R5ThvHspD8FgKmaDvQ ($26 in chips) 
Q1uciOZPBR/WkAlqa6cL4A: posts small blind $0.10
df01R5ThvHspD8FgKmaDvQ: posts big blind $0.25
*** HOLE CARDS ***
48oT5xFI+5CHUJlfoGrE4w: folds 
/gJNBeCkWL4o85/jvlZ4BA: raises $0.75 to $1
b4wRQV3APH8irVk6bUFe2Q: folds 
Q1uciOZPBR/WkAlqa6cL4A: folds 
df01R5ThvHspD8FgKmaDvQ: folds 
Uncalled bet ($0.75) returned to /gJNBeCkWL4o85/jvlZ4BA
/gJNBeCkWL4o85/jvlZ4BA collected $0.60 from pot
*** SUMMARY ***
Total pot $0.60 | Rake $0 
Seat 1: 48oT5xFI+5CHUJlfoGrE4w folded before Flop (didn't bet)
Seat 2: /gJNBeCkWL4o85/jvlZ4BA collected ($0.60)
Seat 4: b4wRQV3APH8irVk6bUFe2Q (button) folded before Flop (didn't bet)
Seat 5: Q1uciOZPBR/WkAlqa6cL4A (small blind) folded before Flop
Seat 6: df01R5ThvHspD8FgKmaDvQ (big blind) folded before Flop




PokerStars Game #59942012570:  Hold'em No Limit ($0.10/$0.25) - 2009/07/01 1:53:18 ET
Table 'sDHjMRwfSiz7+NDdZLUiyA' 9-max Seat #4 is the button
Seat 1: VGwr1eqhvdUtMfBFCvBnmg ($11.80 in chips) 
Seat 2: ljemhp25Zg+nlA9DLCIiUw ($25 in chips) 
Seat 3: SGA1WpAnQxFdFAYyt362gQ ($20.55 in chips) 
Seat 4: eK8qa6EPcH2zhtbmWSvc9g ($25.45 in chips) 
Seat 5: IGRfskE1v9H9Bn+fz8AgNQ ($34.60 in chips) 
Seat 6: 1qa0qHOCKZM3Uipx9DxYtQ ($18.05 in chips) 
Seat 7: K0b5wNInj6hUGRr6yzKFtw ($37.65 in chips) 
Seat 8: 3hMkm4U5yTRrkGJkxfijaQ ($12.45 in chips) 
Seat 9: 3PmVnC/15cl4oyI1TKIt4g ($4.50 in chips) 
IGRfskE1v9H9Bn+fz8AgNQ: posts small blind $0.10
1qa0qHOCKZM3Uipx9DxYtQ: posts big blind $0.25
*** HOLE CARDS ***
K0b5wNInj6hUGRr6yzKFtw: folds 
3hMkm4U5yTRrkGJkxfijaQ: raises $0.25 to $0.50
3PmVnC/15cl4oyI1TKIt4g: folds 
VGwr1eqhvdUtMfBFCvBnmg: folds 
ljemhp25Zg+nlA9DLCIiUw: folds 
SGA1WpAnQxFdFAYyt362gQ: folds 
eK8qa6EPcH2zhtbmWSvc9g: folds 
IGRfskE1v9H9Bn+fz8AgNQ: folds 
1qa0qHOCKZM3Uipx9DxYtQ: raises $0.25 to $0.75
3hMkm4U5yTRrkGJkxfijaQ: calls $0.25
*** FLOP *** [2h Kh Qc]
1qa0qHOCKZM3Uipx9DxYtQ: bets $1.25
3hMkm4U5yTRrkGJkxfijaQ: folds 
Uncalled bet ($1.25) returned to 1qa0qHOCKZM3Uipx9DxYtQ
1qa0qHOCKZM3Uipx9DxYtQ collected $1.55 from pot
1qa0qHOCKZM3Uipx9DxYtQ: doesn't show hand 
*** SUMMARY ***
Total pot $1.60 | Rake $0.05 
Board [2h Kh Qc]
Seat 1: VGwr1eqhvdUtMfBFCvBnmg folded before Flop (didn't bet)
Seat 2: ljemhp25Zg+nlA9DLCIiUw folded before Flop (didn't bet)
Seat 3: SGA1WpAnQxFdFAYyt362gQ folded before Flop (didn't bet)
Seat 4: eK8qa6EPcH2zhtbmWSvc9g (button) folded before Flop (didn't bet)
Seat 5: IGRfskE1v9H9Bn+fz8AgNQ (small blind) folded before Flop
Seat 6: 1qa0qHOCKZM3Uipx9DxYtQ (big blind) collected ($1.55)
Seat 7: K0b5wNInj6hUGRr6yzKFtw folded before Flop (didn't bet)
Seat 8: 3hMkm4U5yTRrkGJkxfijaQ folded on the Flop
Seat 9: 3PmVnC/15cl4oyI1TKIt4g folded before Flop (didn't bet)




PokerStars Game #59942012574:  Hold'em No Limit ($0.10/$0.25) - 2009/07/01 1:53:18 ET
Table 'oZuNsbNJuUyQLGKzQ/4JFg' 6-max Seat #4 is the button
Seat 1: vqWjZmdQu/Hxw96/IJTWdQ ($25.35 in chips) 
Seat 2: UA5OsKS3VPaxa7uC8La/kA ($35.05 in chips) 
Seat 3: 8ClCHtFXGNplITm+63KB+Q ($50.30 in chips) 
Seat 4: 9bpVv1/Qh9IYtXuCtl5VtQ ($30.60 in chips) 
Seat 5: oBUDUfeUyCbZBsjxHZgSiw ($11.15 in chips) 
Seat 6: fwg6dK1+r4jy/y+JqenYYQ ($24.60 in chips) 
oBUDUfeUyCbZBsjxHZgSiw: posts small blind $0.10
fwg6dK1+r4jy/y+JqenYYQ: posts big blind $0.25
*** HOLE CARDS ***
vqWjZmdQu/Hxw96/IJTWdQ: folds 
UA5OsKS3VPaxa7uC8La/kA: folds 
8ClCHtFXGNplITm+63KB+Q: folds 
9bpVv1/Qh9IYtXuCtl5VtQ: folds 
oBUDUfeUyCbZBsjxHZgSiw: raises $0.75 to $1
fwg6dK1+r4jy/y+JqenYYQ: calls $0.75
*** FLOP *** [9h 8s 9c]
oBUDUfeUyCbZBsjxHZgSiw: checks 
fwg6dK1+r4jy/y+JqenYYQ: checks 
*** TURN *** [9h 8s 9c] [8h]
oBUDUfeUyCbZBsjxHZgSiw: bets $1.75
fwg6dK1+r4jy/y+JqenYYQ: calls $1.75
*** RIVER *** [9h 8s 9c 8h] [Kd]
oBUDUfeUyCbZBsjxHZgSiw: checks 
fwg6dK1+r4jy/y+JqenYYQ: checks 
*** SHOW DOWN ***
oBUDUfeUyCbZBsjxHZgSiw: shows [4c 2c] (two pair, Nines and Eights)
fwg6dK1+r4jy/y+JqenYYQ: shows [7s 6h] (two pair, Nines and Eights)
oBUDUfeUyCbZBsjxHZgSiw collected $2.65 from pot
fwg6dK1+r4jy/y+JqenYYQ collected $2.60 from pot
*** SUMMARY ***
Total pot $5.50 | Rake $0.25 
Board [9h 8s 9c 8h Kd]
Seat 1: vqWjZmdQu/Hxw96/IJTWdQ folded before Flop (didn't bet)
Seat 2: UA5OsKS3VPaxa7uC8La/kA folded before Flop (didn't bet)
Seat 3: 8ClCHtFXGNplITm+63KB+Q folded before Flop (didn't bet)
Seat 4: 9bpVv1/Qh9IYtXuCtl5VtQ (button) folded before Flop (didn't bet)
Seat 5: oBUDUfeUyCbZBsjxHZgSiw (small blind) showed [4c 2c] and won ($2.65) with two pair, Nines and Eights
Seat 6: fwg6dK1+r4jy/y+JqenYYQ (big blind) showed [7s 6h] and won ($2.60) with two pair, Nines and Eights




PokerStars Game #59942012464:  Hold'em No Limit ($0.10/$0.25) - 2009/07/01 1:53:18 ET
Table '9L7XfAwuM7XsXE8LIg2o5Q' 6-max Seat #6 is the button
Seat 1: dOIoLBxmpLHSXBN9LZnf0Q ($30.25 in chips) 
Seat 2: LJI7A1YgDM7hgh7o56+ReQ ($27.30 in chips) 
Seat 3: f1OIgv29LuXUMe6o34kTQg ($16.25 in chips) 
Seat 4: jp34e617tIzV8tKIWmfAbA ($38.45 in chips) 
Seat 5: ErIN0JRL5srYjT6en1f8YQ ($21.90 in chips) 
Seat 6: k9nHZTHt8hYhYRcW8NTb4g ($18.50 in chips) 
dOIoLBxmpLHSXBN9LZnf0Q: posts small blind $0.10
LJI7A1YgDM7hgh7o56+ReQ: posts big blind $0.25
*** HOLE CARDS ***
f1OIgv29LuXUMe6o34kTQg: raises $0.50 to $0.75
jp34e617tIzV8tKIWmfAbA: folds 
ErIN0JRL5srYjT6en1f8YQ: folds 
k9nHZTHt8hYhYRcW8NTb4g: folds 
dOIoLBxmpLHSXBN9LZnf0Q: folds 
LJI7A1YgDM7hgh7o56+ReQ: folds 
Uncalled bet ($0.50) returned to f1OIgv29LuXUMe6o34kTQg
f1OIgv29LuXUMe6o34kTQg collected $0.60 from pot
f1OIgv29LuXUMe6o34kTQg: doesn't show hand 
*** SUMMARY ***
Total pot $0.60 | Rake $0 
Seat 1: dOIoLBxmpLHSXBN9LZnf0Q (small blind) folded before Flop
Seat 2: LJI7A1YgDM7hgh7o56+ReQ (big blind) folded before Flop
Seat 3: f1OIgv29LuXUMe6o34kTQg collected ($0.60)
Seat 4: jp34e617tIzV8tKIWmfAbA folded before Flop (didn't bet)
Seat 5: ErIN0JRL5srYjT6en1f8YQ folded before Flop (didn't bet)
Seat 6: k9nHZTHt8hYhYRcW8NTb4g (button) folded before Flop (didn't bet)




PokerStars Game #59942012716:  Hold'em No Limit ($0.10/$0.25) - 2009/07/01 1:53:18 ET
Table 'dZNBGqFYSwfOVZvDJ4VjIQ' 6-max Seat #4 is the button
Seat 1: v+QfkGiuj9bgtuNoVnDO8w ($37.65 in chips) 
Seat 2: 3zD3qLXT1bEffAoWGnc7wg ($27.95 in chips) 
Seat 3: kyRaCIljYA6l33lSKQfNsg ($29.70 in chips) 
Seat 4: GbCVUNssQ7mqsPWr7J4d3w ($4.65 in chips) 
Seat 5: +ZlnqPoP3Hg4BIUxDfKd/A ($27.15 in chips) 
Seat 6: ypmjhffk/YHGc51wgVXUTw ($31.25 in chips) 
+ZlnqPoP3Hg4BIUxDfKd/A: posts small blind $0.10
ypmjhffk/YHGc51wgVXUTw: posts big blind $0.25
*** HOLE CARDS ***
v+QfkGiuj9bgtuNoVnDO8w: folds 
3zD3qLXT1bEffAoWGnc7wg: folds 
kyRaCIljYA6l33lSKQfNsg: folds 
GbCVUNssQ7mqsPWr7J4d3w: raises $0.75 to $1
+ZlnqPoP3Hg4BIUxDfKd/A: folds 
ypmjhffk/YHGc51wgVXUTw: folds 
Uncalled bet ($0.75) returned to GbCVUNssQ7mqsPWr7J4d3w
ypmjhffk/YHGc51wgVXUTw leaves the table
GbCVUNssQ7mqsPWr7J4d3w collected $0.60 from pot
GbCVUNssQ7mqsPWr7J4d3w: doesn't show hand 
*** SUMMARY ***
Total pot $0.60 | Rake $0 
Seat 1: v+QfkGiuj9bgtuNoVnDO8w folded before Flop (didn't bet)
Seat 2: 3zD3qLXT1bEffAoWGnc7wg folded before Flop (didn't bet)
Seat 3: kyRaCIljYA6l33lSKQfNsg folded before Flop (didn't bet)
Seat 4: GbCVUNssQ7mqsPWr7J4d3w (button) collected ($0.60)
Seat 5: +ZlnqPoP3Hg4BIUxDfKd/A (small blind) folded before Flop
Seat 6: ypmjhffk/YHGc51wgVXUTw (big blind) folded before Flop




PokerStars Game #59942012528:  Hold'em No Limit ($0.10/$0.25) - 2009/07/01 1:53:18 ET
Table 'UVjmXTtsmlX1HxwwZ59akg' 9-max Seat #8 is the button
Seat 1: zDrucyjVn5aeekNEc3cJrA ($47.85 in chips) 
Seat 2: q+Qdg0Hoir+SyL7haBrUnw ($7.80 in chips) 
Seat 3: GmzfAfxcxu1kGbPC+9LkVg ($27.55 in chips) 
Seat 5: Bb42QRQMhg5/Y0vHP8/2Xw ($39.45 in chips) 
Seat 6: st9jtdNbm1W5GfBwRaCVqQ ($24.10 in chips) 
Seat 7: d7YasxuGLPiL7pj8IcGThw ($4.75 in chips) 
Seat 8: aqxuKnMZWHy08QjWq1+MrQ ($3.25 in chips) 
zDrucyjVn5aeekNEc3cJrA: posts small blind $0.10
q+Qdg0Hoir+SyL7haBrUnw: posts big blind $0.25
18G4P1XstjNvItdGUITxgw: sits out 
*** HOLE CARDS ***
GmzfAfxcxu1kGbPC+9LkVg: folds 
Bb42QRQMhg5/Y0vHP8/2Xw: folds 
st9jtdNbm1W5GfBwRaCVqQ: folds 
d7YasxuGLPiL7pj8IcGThw: folds 
aqxuKnMZWHy08QjWq1+MrQ: folds 
zDrucyjVn5aeekNEc3cJrA: calls $0.15
q+Qdg0Hoir+SyL7haBrUnw: checks 
*** FLOP *** [9h 6s 6c]
zDrucyjVn5aeekNEc3cJrA: checks 
q+Qdg0Hoir+SyL7haBrUnw: checks 
*** TURN *** [9h 6s 6c] [3d]
zDrucyjVn5aeekNEc3cJrA: checks 
q+Qdg0Hoir+SyL7haBrUnw: bets $0.50
zDrucyjVn5aeekNEc3cJrA: folds 
Uncalled bet ($0.50) returned to q+Qdg0Hoir+SyL7haBrUnw
q+Qdg0Hoir+SyL7haBrUnw collected $0.50 from pot
*** SUMMARY ***
Total pot $0.50 | Rake $0 
Board [9h 6s 6c 3d]
Seat 1: zDrucyjVn5aeekNEc3cJrA (small blind) folded on the Turn
Seat 2: q+Qdg0Hoir+SyL7haBrUnw (big blind) collected ($0.50)
Seat 3: GmzfAfxcxu1kGbPC+9LkVg folded before Flop (didn't bet)
Seat 5: Bb42QRQMhg5/Y0vHP8/2Xw folded before Flop (didn't bet)
Seat 6: st9jtdNbm1W5GfBwRaCVqQ folded before Flop (didn't bet)
Seat 7: d7YasxuGLPiL7pj8IcGThw folded before Flop (didn't bet)
Seat 8: aqxuKnMZWHy08QjWq1+MrQ (button) folded before Flop (didn't bet)




PokerStars Game #59942013414:  Hold'em No Limit ($0.10/$0.25) - 2009/07/01 1:53:19 ET
Table 'nQC9LRg01NEuKFHF1nrDEw0XPo7K54oZIfG0xlNAcDRw-max Seat #5 is the button
Seat 1: qf+LMbROj8/qY878wkFHbQ ($21.55 in chips) 
Seat 2: ZhV6dUX9NQhT4zf7t+ZLJg ($20.55 in chips) 
Seat 3: 6+g0Lb6vfRDZkElV8ieHyQ ($25.60 in chips) 
Seat 4: u3Ol7kv1LmvszuHNm9rc6w ($25.25 in chips) 
Seat 5: kG34n23qFQA3nzdOJTQ1dA ($27.60 in chips) 
Seat 6: xQVFeVUDopz+akuEo2wXpQ ($52.15 in chips) 
xQVFeVUDopz+akuEo2wXpQ: posts small blind $0.10
qf+LMbROj8/qY878wkFHbQ: posts big blind $0.25
*** HOLE CARDS ***
ZhV6dUX9NQhT4zf7t+ZLJg: folds 
6+g0Lb6vfRDZkElV8ieHyQ: calls $0.25
u3Ol7kv1LmvszuHNm9rc6w: calls $0.25
kG34n23qFQA3nzdOJTQ1dA: folds 
xQVFeVUDopz+akuEo2wXpQ: calls $0.15
qf+LMbROj8/qY878wkFHbQ: checks 
*** FLOP *** [Kc 7h 4c]
xQVFeVUDopz+akuEo2wXpQ: checks 
qf+LMbROj8/qY878wkFHbQ: checks 
6+g0Lb6vfRDZkElV8ieHyQ: checks 
u3Ol7kv1LmvszuHNm9rc6w: checks 
*** TURN *** [Kc 7h 4c] [8h]
xQVFeVUDopz+akuEo2wXpQ: checks 
qf+LMbROj8/qY878wkFHbQ: checks 
6+g0Lb6vfRDZkElV8ieHyQ: checks 
u3Ol7kv1LmvszuHNm9rc6w: checks 
*** RIVER *** [Kc 7h 4c 8h] [9c]
xQVFeVUDopz+akuEo2wXpQ: checks 
qf+LMbROj8/qY878wkFHbQ: folds 
6+g0Lb6vfRDZkElV8ieHyQ: checks 
u3Ol7kv1LmvszuHNm9rc6w: checks 
*** SHOW DOWN ***
xQVFeVUDopz+akuEo2wXpQ: shows [Qh 2s] (high card King)
6+g0Lb6vfRDZkElV8ieHyQ: shows [Jh 9h] (a pair of Nines)
u3Ol7kv1LmvszuHNm9rc6w: mucks hand 
6+g0Lb6vfRDZkElV8ieHyQ collected $0.95 from pot
*** SUMMARY ***
Total pot $1 | Rake $0.05 
Board [Kc 7h 4c 8h 9c]
Seat 1: qf+LMbROj8/qY878wkFHbQ (big blind) folded on the River
Seat 2: ZhV6dUX9NQhT4zf7t+ZLJg folded before Flop (didn't bet)
Seat 3: 6+g0Lb6vfRDZkElV8ieHyQ showed [Jh 9h] and won ($0.95) with a pair of Nines
Seat 4: u3Ol7kv1LmvszuHNm9rc6w mucked
Seat 5: kG34n23qFQA3nzdOJTQ1dA (button) folded before Flop (didn't bet)
Seat 6: xQVFeVUDopz+akuEo2wXpQ (small blind) showed [Qh 2s] and lost with high card King




PokerStars Game #59942013280:  Hold'em No Limit ($0.10/$0.25) - 2009/07/01 1:53:19 ET
Table 'AJGgX1ZYM8d68SWMvaLttg' 6-max Seat #4 is the button
Seat 1: Q1uciOZPBR/WkAlqa6cL4A ($25 in chips) 
Seat 2: zHHLkD2sRljslKKeQv/ZQw ($25.85 in chips) 
Seat 3: 8ClCHtFXGNplITm+63KB+Q ($38.45 in chips) 
Seat 4: e30C3DfdG5TfPnR16/oMmA ($22.15 in chips) 
Seat 5: GbCVUNssQ7mqsPWr7J4d3w ($5.85 in chips) 
Seat 6: UA5OsKS3VPaxa7uC8La/kA ($62.25 in chips) 
GbCVUNssQ7mqsPWr7J4d3w: posts small blind $0.10
UA5OsKS3VPaxa7uC8La/kA: posts big blind $0.25
*** HOLE CARDS ***
Q1uciOZPBR/WkAlqa6cL4A: folds 
zHHLkD2sRljslKKeQv/ZQw: calls $0.25
8ClCHtFXGNplITm+63KB+Q: folds 
e30C3DfdG5TfPnR16/oMmA: raises $0.25 to $0.50
GbCVUNssQ7mqsPWr7J4d3w: folds 
UA5OsKS3VPaxa7uC8La/kA: folds 
zHHLkD2sRljslKKeQv/ZQw: calls $0.25
*** FLOP *** [4c 3d 7d]
zHHLkD2sRljslKKeQv/ZQw: checks 
e30C3DfdG5TfPnR16/oMmA: bets $0.75
zHHLkD2sRljslKKeQv/ZQw: calls $0.75
*** TURN *** [4c 3d 7d] [Jd]
zHHLkD2sRljslKKeQv/ZQw: checks 
e30C3DfdG5TfPnR16/oMmA: checks 
*** RIVER *** [4c 3d 7d Jd] [8s]
zHHLkD2sRljslKKeQv/ZQw: bets $0.50
e30C3DfdG5TfPnR16/oMmA: calls $0.50
*** SHOW DOWN ***
zHHLkD2sRljslKKeQv/ZQw: shows [Ad 3c] (a pair of Threes)
e30C3DfdG5TfPnR16/oMmA: mucks hand 
zHHLkD2sRljslKKeQv/ZQw collected $3.70 from pot
*** SUMMARY ***
Total pot $3.85 | Rake $0.15 
Board [4c 3d 7d Jd 8s]
Seat 1: Q1uciOZPBR/WkAlqa6cL4A folded before Flop (didn't bet)
Seat 2: zHHLkD2sRljslKKeQv/ZQw showed [Ad 3c] and won ($3.70) with a pair of Threes
Seat 3: 8ClCHtFXGNplITm+63KB+Q folded before Flop (didn't bet)
Seat 4: e30C3DfdG5TfPnR16/oMmA (button) mucked
Seat 5: GbCVUNssQ7mqsPWr7J4d3w (small blind) folded before Flop
Seat 6: UA5OsKS3VPaxa7uC8La/kA (big blind) folded before Flop




PokerStars Game #59942012974:  Hold'em No Limit ($0.10/$0.25) - 2009/07/01 1:53:19 ET
Table '60nA7av6bws9VnNmVwculA' 6-max Seat #5 is the button
Seat 1: if4dh6jhJXeN3/qd3qCp9g ($25 in chips) 
Seat 2: Bada343Si4xKu3fNXY99AA ($5.40 in chips) 
Seat 3: mnuJq+Q1IXKm/pCy+OzxmQ ($25.60 in chips) 
Seat 4: +baiVgI/ETnBARLe5mARCw ($18.60 in chips) 
Seat 5: zXh+lOT41Q2iWgCNj+OcRw ($11.70 in chips) 
Seat 6: mfrkWA3PTeYPkbO6hi98Aw ($25.25 in chips) 
mfrkWA3PTeYPkbO6hi98Aw: posts small blind $0.10
if4dh6jhJXeN3/qd3qCp9g: posts big blind $0.25
*** HOLE CARDS ***
Bada343Si4xKu3fNXY99AA: folds 
mnuJq+Q1IXKm/pCy+OzxmQ: folds 
+baiVgI/ETnBARLe5mARCw: folds 
zXh+lOT41Q2iWgCNj+OcRw: calls $0.25
mfrkWA3PTeYPkbO6hi98Aw: folds 
if4dh6jhJXeN3/qd3qCp9g: checks 
*** FLOP *** [5s 9h Ts]
if4dh6jhJXeN3/qd3qCp9g: checks 
zXh+lOT41Q2iWgCNj+OcRw: checks 
*** TURN *** [5s 9h Ts] [Ac]
if4dh6jhJXeN3/qd3qCp9g: checks 
zXh+lOT41Q2iWgCNj+OcRw: checks 
*** RIVER *** [5s 9h Ts Ac] [7s]
if4dh6jhJXeN3/qd3qCp9g: checks 
zXh+lOT41Q2iWgCNj+OcRw: checks 
*** SHOW DOWN ***
if4dh6jhJXeN3/qd3qCp9g: shows [4c 6h] (high card Ace)
zXh+lOT41Q2iWgCNj+OcRw: shows [Kd Qc] (high card Ace - King kicker)
zXh+lOT41Q2iWgCNj+OcRw collected $0.60 from pot
*** SUMMARY ***
Total pot $0.60 | Rake $0 
Board [5s 9h Ts Ac 7s]
Seat 1: if4dh6jhJXeN3/qd3qCp9g (big blind) showed [4c 6h] and lost with high card Ace
Seat 2: Bada343Si4xKu3fNXY99AA folded before Flop (didn't bet)
Seat 3: mnuJq+Q1IXKm/pCy+OzxmQ folded before Flop (didn't bet)
Seat 4: +baiVgI/ETnBARLe5mARCw folded before Flop (didn't bet)
Seat 5: zXh+lOT41Q2iWgCNj+OcRw (button) showed [Kd Qc] and won ($0.60) with high card Ace
Seat 6: mfrkWA3PTeYPkbO6hi98Aw (small blind) folded before Flop




PokerStars Game #59942013436:  Hold'em No Limit ($0.10/$0.25) - 2009/07/01 1:53:19 ET
Table 'LwnjzXstPtSrqrV/oDpnXQ' 9-max Seat #4 is the button
Seat 1: 9YN2IkT2JYYKFErZtZvCtA ($21.55 in chips) 
Seat 2: uLP/lYn7oKq9xCChBXsXxw ($26.15 in chips) 
Seat 3: 7je+LC5Mfs6nL8YBVh4frQ ($3.45 in chips) 
Seat 4: CmngQmkKTp8tkl6GMRTl6w ($8.35 in chips) 
Seat 5: Th3FldXKQW6hWVVPahaoOQ ($26 in chips) 
Seat 7: c/Dw/6HyqldTzIRodAIZmg ($13.40 in chips) 
Seat 8: ShXPHWfjhfmAwLgDdm6bRQ ($13 in chips) 
Seat 9: q6WfTUAD9mowIP63ASq2Dgz/khFDKGihQjwgoiKKPOeg65 in chips) 
Th3FldXKQW6hWVVPahaoOQ: posts small blind $0.10
c/Dw/6HyqldTzIRodAIZmg: posts big blind $0.25
*** HOLE CARDS ***
ShXPHWfjhfmAwLgDdm6bRQ: folds 
q6WfTUAD9mowIP63ASq2Dgz/khFDKGihQjwgoiKKPOegs $0.25
9YN2IkT2JYYKFErZtZvCtA: folds 
uLP/lYn7oKq9xCChBXsXxw: calls $0.25
7je+LC5Mfs6nL8YBVh4frQ: folds 
CmngQmkKTp8tkl6GMRTl6w: folds 
Th3FldXKQW6hWVVPahaoOQ: folds 
c/Dw/6HyqldTzIRodAIZmg: checks 
*** FLOP *** [Qh Jc 3d]
c/Dw/6HyqldTzIRodAIZmg: checks 
q6WfTUAD9mowIP63ASq2Dgz/khFDKGihQjwgoiKKPOeg $0.50
uLP/lYn7oKq9xCChBXsXxw: folds 
c/Dw/6HyqldTzIRodAIZmg: folds 
Uncalled bet ($0.50) returned to q6WfTUAD9mowIP63ASq2Dgz/khFDKGihQjwgoiKKPOegq6WfTUAD9mowIP63ASq2Dgt collected $0.85 from pot
q6WfTUAD9mowIP63ASq2Dgz/khFDKGihQjwgoiKKPOegn't show hand 
*** SUMMARY ***
Total pot $0.85 | Rake $0 
Board [Qh Jc 3d]
Seat 1: 9YN2IkT2JYYKFErZtZvCtA folded before Flop (didn't bet)
Seat 2: uLP/lYn7oKq9xCChBXsXxw folded on the Flop
Seat 3: 7je+LC5Mfs6nL8YBVh4frQ folded before Flop (didn't bet)
Seat 4: CmngQmkKTp8tkl6GMRTl6w (button) folded before Flop (didn't bet)
Seat 5: Th3FldXKQW6hWVVPahaoOQ (small blind) folded before Flop
Seat 7: c/Dw/6HyqldTzIRodAIZmg (big blind) folded on the Flop
Seat 8: ShXPHWfjhfmAwLgDdm6bRQ folded before Flop (didn't bet)
Seat 9: q6WfTUAD9mowIP63ASq2Dgz/khFDKGihQjwgoiKKPOegcted ($0.85)




PokerStars Game #59942013294:  Hold'em No Limit ($0.10/$0.25) - 2009/07/01 1:53:19 ET
Table 'KAnP7XvDtlku47YfJwdOVw' 9-max Seat #6 is the button
Seat 1: cH3q40adP+kFogl+2MtbkQ ($15 in chips) 
Seat 2: E0iYnEVO2ho7dH3QcCjw7g ($19.35 in chips) 
Seat 3: W6tExOcYX7qiy6Qdp+ZwFA ($7.60 in chips) 
Seat 4: 18G4P1XstjNvItdGUITxgw ($25 in chips) 
Seat 5: MG90wfSJZnOejs/KD3vlQQ ($33.40 in chips) 
Seat 6: z5GxcHlYz/GSz6W2uFiTtg ($21.15 in chips) 
Seat 7: Lro4e37x4FUa5P3yzDjskw ($16.40 in chips) 
Seat 9: HDDm1BkZtdsRyw2DJdqq6A ($13.80 in chips) 
Lro4e37x4FUa5P3yzDjskw: posts small blind $0.10
HDDm1BkZtdsRyw2DJdqq6A: posts big blind $0.25
*** HOLE CARDS ***
cH3q40adP+kFogl+2MtbkQ: calls $0.25
oleeelam joins the table at seat #8 
E0iYnEVO2ho7dH3QcCjw7g: folds 
W6tExOcYX7qiy6Qdp+ZwFA: folds 
18G4P1XstjNvItdGUITxgw: folds 
MG90wfSJZnOejs/KD3vlQQ: folds 
z5GxcHlYz/GSz6W2uFiTtg: folds 
Lro4e37x4FUa5P3yzDjskw: calls $0.15
HDDm1BkZtdsRyw2DJdqq6A: checks 
*** FLOP *** [6d 5c 7s]
Lro4e37x4FUa5P3yzDjskw: bets $0.50
HDDm1BkZtdsRyw2DJdqq6A: folds 
cH3q40adP+kFogl+2MtbkQ: calls $0.50
*** TURN *** [6d 5c 7s] [4h]
Lro4e37x4FUa5P3yzDjskw: bets $0.75
cH3q40adP+kFogl+2MtbkQ: calls $0.75
*** RIVER *** [6d 5c 7s 4h] [7c]
Lro4e37x4FUa5P3yzDjskw: checks 
cH3q40adP+kFogl+2MtbkQ: checks 
*** SHOW DOWN ***
Lro4e37x4FUa5P3yzDjskw: shows [2c Jd] (a pair of Sevens)
cH3q40adP+kFogl+2MtbkQ: shows [Ts 6s] (two pair, Sevens and Sixes)
cH3q40adP+kFogl+2MtbkQ collected $3.10 from pot
*** SUMMARY ***
Total pot $3.25 | Rake $0.15 
Board [6d 5c 7s 4h 7c]
Seat 1: cH3q40adP+kFogl+2MtbkQ showed [Ts 6s] and won ($3.10) with two pair, Sevens and Sixes
Seat 2: E0iYnEVO2ho7dH3QcCjw7g folded before Flop (didn't bet)
Seat 3: W6tExOcYX7qiy6Qdp+ZwFA folded before Flop (didn't bet)
Seat 4: 18G4P1XstjNvItdGUITxgw folded before Flop (didn't bet)
Seat 5: MG90wfSJZnOejs/KD3vlQQ folded before Flop (didn't bet)
Seat 6: z5GxcHlYz/GSz6W2uFiTtg (button) folded before Flop (didn't bet)
Seat 7: Lro4e37x4FUa5P3yzDjskw (small blind) showed [2c Jd] and lost with a pair of Sevens
Seat 9: HDDm1BkZtdsRyw2DJdqq6A (big blind) folded on the Flop




PokerStars Game #59942013104:  Hold'em No Limit ($0.10/$0.25) - 2009/07/01 1:53:19 ET
Table 'IrJPyZ3JW2iIa+krdoSbJQ' 9-max Seat #4 is the button
Seat 1: Bb42QRQMhg5/Y0vHP8/2Xw ($25.90 in chips) 
Seat 2: X78b5v/uhqeXXoAijbw/yg ($42.60 in chips) 
Seat 3: CT7Xj/V/O5rBlhtt+RZeFQ ($39.15 in chips) 
Seat 4: bXpVeaSTPBFSPJmeXxO7nw ($4.30 in chips) 
Seat 5: tLcDklc2rBORNfixyRfVfw ($30.75 in chips) 
Seat 6: +sbyWwIcFp9kP0bDtMegfQ ($24.60 in chips) 
Seat 7: ozqb9Z1ZOsDwxxq9IKmjUA ($9.50 in chips) 
Seat 9: Mh2r9hTeTEDnh19sRZtW3g ($9.55 in chips) 
tLcDklc2rBORNfixyRfVfw: posts small blind $0.10
+sbyWwIcFp9kP0bDtMegfQ: posts big blind $0.25
HoldEmHutch: sits out 
*** HOLE CARDS ***
ozqb9Z1ZOsDwxxq9IKmjUA: folds 
Mh2r9hTeTEDnh19sRZtW3g: folds 
Bb42QRQMhg5/Y0vHP8/2Xw: folds 
X78b5v/uhqeXXoAijbw/yg: folds 
CT7Xj/V/O5rBlhtt+RZeFQ: folds 
bXpVeaSTPBFSPJmeXxO7nw: folds 
tLcDklc2rBORNfixyRfVfw: folds 
Uncalled bet ($0.15) returned to +sbyWwIcFp9kP0bDtMegfQ
+sbyWwIcFp9kP0bDtMegfQ collected $0.20 from pot
+sbyWwIcFp9kP0bDtMegfQ: doesn't show hand 
*** SUMMARY ***
Total pot $0.20 | Rake $0 
Seat 1: Bb42QRQMhg5/Y0vHP8/2Xw folded before Flop (didn't bet)
Seat 2: X78b5v/uhqeXXoAijbw/yg folded before Flop (didn't bet)
Seat 3: CT7Xj/V/O5rBlhtt+RZeFQ folded before Flop (didn't bet)
Seat 4: bXpVeaSTPBFSPJmeXxO7nw (button) folded before Flop (didn't bet)
Seat 5: tLcDklc2rBORNfixyRfVfw (small blind) folded before Flop
Seat 6: +sbyWwIcFp9kP0bDtMegfQ (big blind) collected ($0.20)
Seat 7: ozqb9Z1ZOsDwxxq9IKmjUA folded before Flop (didn't bet)
Seat 9: Mh2r9hTeTEDnh19sRZtW3g folded before Flop (didn't bet)




PokerStars Game #59942013102:  Hold'em No Limit ($0.10/$0.25) - 2009/07/01 1:53:19 ET
Table 'C47I7CmrmFr8Oo7wOovVwQ' 6-max Seat #1 is the button
Seat 1: aKCh+0w6BCOX3sJAdIVLMw ($5.80 in chips) 
Seat 2: 8JTm/CXBn3+kuQgcUOgPkw ($24.15 in chips) 
Seat 3: p4qhycZstfeeDkKv3zEBjw ($15 in chips) 
Seat 4: yY5JuFtDfXWRaZlVby4LLw ($8.60 in chips) 
Seat 6: pD7ri5wL3vsa6S1ulMYQmQ ($31.20 in chips) 
8JTm/CXBn3+kuQgcUOgPkw: posts small blind $0.10
p4qhycZstfeeDkKv3zEBjw: posts big blind $0.25
*** HOLE CARDS ***
yY5JuFtDfXWRaZlVby4LLw: folds 
pD7ri5wL3vsa6S1ulMYQmQ: folds 
aKCh+0w6BCOX3sJAdIVLMw: folds 
8JTm/CXBn3+kuQgcUOgPkw: folds 
Uncalled bet ($0.15) returned to p4qhycZstfeeDkKv3zEBjw
or309yYY9Y9bfFWtrB0yUg leaves the table
p4qhycZstfeeDkKv3zEBjw collected $0.20 from pot
p4qhycZstfeeDkKv3zEBjw: doesn't show hand 
*** SUMMARY ***
Total pot $0.20 | Rake $0 
Seat 1: aKCh+0w6BCOX3sJAdIVLMw (button) folded before Flop (didn't bet)
Seat 2: 8JTm/CXBn3+kuQgcUOgPkw (small blind) folded before Flop
Seat 3: p4qhycZstfeeDkKv3zEBjw (big blind) collected ($0.20)
Seat 4: yY5JuFtDfXWRaZlVby4LLw folded before Flop (didn't bet)
Seat 6: pD7ri5wL3vsa6S1ulMYQmQ folded before Flop (didn't bet)




PokerStars Game #59942012944:  Hold'em No Limit ($0.10/$0.25) - 2009/07/01 1:53:19 ET
Table 'HbNAGS1OJWQKyfk7UfrYyw' 9-max Seat #9 is the button
Seat 2: fjwM06E3HzjUrynPRQi31Q ($5.75 in chips) 
Seat 4: XwQK8xvCADxp0bUmji+Zyg ($17.75 in chips) 
Seat 5: clJsV3v77RS07bDKY+705w ($5 in chips) 
Seat 9: nLE5Yo60EmSlJPyg0GgxXg ($27.90 in chips) 
3PmVnC/15cl4oyI1TKIt4g: is sitting out 
Yxal0LG80xJqTIctpMLWlg leaves the table
fjwM06E3HzjUrynPRQi31Q: posts small blind $0.10
XwQK8xvCADxp0bUmji+Zyg: posts big blind $0.25
eK8qa6EPcH2zhtbmWSvc9g: sits out 
bXpVeaSTPBFSPJmeXxO7nw: is sitting out 
bXpVeaSTPBFSPJmeXxO7nw leaves the table
DiSvPC2iudwL5j9u6Huyww: sits out 
*** HOLE CARDS ***
3PmVnC/15cl4oyI1TKIt4g leaves the table
clJsV3v77RS07bDKY+705w: folds 
nLE5Yo60EmSlJPyg0GgxXg: folds 
fjwM06E3HzjUrynPRQi31Q: calls $0.15
XwQK8xvCADxp0bUmji+Zyg: checks 
*** FLOP *** [Jh 9h 8d]
fjwM06E3HzjUrynPRQi31Q: checks 
XwQK8xvCADxp0bUmji+Zyg: checks 
*** TURN *** [Jh 9h 8d] [8c]
fjwM06E3HzjUrynPRQi31Q: checks 
XwQK8xvCADxp0bUmji+Zyg: checks 
*** RIVER *** [Jh 9h 8d 8c] [3s]
fjwM06E3HzjUrynPRQi31Q: checks 
XwQK8xvCADxp0bUmji+Zyg: checks 
*** SHOW DOWN ***
fjwM06E3HzjUrynPRQi31Q: shows [Kd 2s] (a pair of Eights)
XwQK8xvCADxp0bUmji+Zyg: shows [Kc 6s] (a pair of Eights)
fjwM06E3HzjUrynPRQi31Q collected $0.25 from pot
XwQK8xvCADxp0bUmji+Zyg collected $0.25 from pot
*** SUMMARY ***
Total pot $0.50 | Rake $0 
Board [Jh 9h 8d 8c 3s]
Seat 2: fjwM06E3HzjUrynPRQi31Q (small blind) showed [Kd 2s] and won ($0.25) with a pair of Eights
Seat 4: XwQK8xvCADxp0bUmji+Zyg (big blind) showed [Kc 6s] and won ($0.25) with a pair of Eights
Seat 5: clJsV3v77RS07bDKY+705w folded before Flop (didn't bet)
Seat 9: nLE5Yo60EmSlJPyg0GgxXg (button) folded before Flop (didn't bet)




PokerStars Game #59942013498:  Hold'em No Limit ($0.10/$0.25) - 2009/07/01 1:53:20 ET
Table 'BmUMTVcNATeov2rAGYU0Qg' 9-max Seat #1 is the button
Seat 1: QEbIGci+itdw+re8RM5fZA ($33.50 in chips) 
Seat 2: jJnMGXoBXye+afMd0k0rUw ($11.40 in chips) 
Seat 3: ir5Jy8ck6DrdqgJ/3chcWw ($15.35 in chips) 
Seat 4: aNpwfA31EREwO+ar4XzBCw ($37.35 in chips) 
Seat 5: QBNcj9fHxkh/+s/oVw+JmQ ($24 in chips) 
Seat 6: w1ukf8uPa4+WH561TtVRxA ($28.85 in chips) 
Seat 7: CmngQmkKTp8tkl6GMRTl6w ($10.10 in chips) 
Seat 8: Jve2LRs9vtGL7NdiNeXY/A ($12.75 in chips) 
Seat 9: /artgaAtyUtUtD8FZo6puA ($15 in chips) 
jJnMGXoBXye+afMd0k0rUw: posts small blind $0.10
ir5Jy8ck6DrdqgJ/3chcWw: posts big blind $0.25
/artgaAtyUtUtD8FZo6puA: posts small blind $0.10
*** HOLE CARDS ***
aNpwfA31EREwO+ar4XzBCw: folds 
aNpwfA31EREwO+ar4XzBCw leaves the table
QBNcj9fHxkh/+s/oVw+JmQ: folds 
w1ukf8uPa4+WH561TtVRxA: folds 
CmngQmkKTp8tkl6GMRTl6w: folds 
Jve2LRs9vtGL7NdiNeXY/A has timed out
Jve2LRs9vtGL7NdiNeXY/A: folds 
Jve2LRs9vtGL7NdiNeXY/A is sitting out
/artgaAtyUtUtD8FZo6puA: calls $0.25
QEbIGci+itdw+re8RM5fZA: raises $0.85 to $1.10
jJnMGXoBXye+afMd0k0rUw: folds 
ir5Jy8ck6DrdqgJ/3chcWw: folds 
/artgaAtyUtUtD8FZo6puA: calls $0.85
*** FLOP *** [3s Ac Qd]
Jve2LRs9vtGL7NdiNeXY/A has returned
/artgaAtyUtUtD8FZo6puA: checks 
QEbIGci+itdw+re8RM5fZA: bets $1.50
/artgaAtyUtUtD8FZo6puA: folds 
Uncalled bet ($1.50) returned to QEbIGci+itdw+re8RM5fZA
QEbIGci+itdw+re8RM5fZA collected $2.55 from pot
QEbIGci+itdw+re8RM5fZA: doesn't show hand 
*** SUMMARY ***
Total pot $2.65 | Rake $0.10 
Board [3s Ac Qd]
Seat 1: QEbIGci+itdw+re8RM5fZA (button) collected ($2.55)
Seat 2: jJnMGXoBXye+afMd0k0rUw (small blind) folded before Flop
Seat 3: ir5Jy8ck6DrdqgJ/3chcWw (big blind) folded before Flop
Seat 4: aNpwfA31EREwO+ar4XzBCw folded before Flop (didn't bet)
Seat 5: QBNcj9fHxkh/+s/oVw+JmQ folded before Flop (didn't bet)
Seat 6: w1ukf8uPa4+WH561TtVRxA folded before Flop (didn't bet)
Seat 7: CmngQmkKTp8tkl6GMRTl6w folded before Flop (didn't bet)
Seat 8: Jve2LRs9vtGL7NdiNeXY/A folded before Flop (didn't bet)
Seat 9: /artgaAtyUtUtD8FZo6puA folded on the Flop




PokerStars Game #59942013864:  Hold'em No Limit ($0.10/$0.25) - 2009/07/01 1:53:20 ET
Table 'HIOfhT0zga/KonFhIl6O3w' 9-max Seat #8 is the button
Seat 1: oLa/tXLfSLLB28mcLGrxcg ($27.15 in chips) 
Seat 2: er86weqXTpTB6/w2dKlYgA ($8.35 in chips) 
Seat 3: X6+pSIPfovPcE87t+LmUKQ ($4.50 in chips) 
Seat 4: qwr38jl5txoR36M7G5qi4A ($15.85 in chips) 
Seat 5: K1MDeapSEyKyGPNZGOKfEg ($37.15 in chips) 
Seat 6: MThMMgdB293VOucmN9sliQ ($25.45 in chips) 
Seat 7: wvlPJBB0PtYkfeeSRDaIvQ ($13.10 in chips) 
Seat 8: SpiiQQAzy4MUgV3I5W8giw ($24.65 in chips) 
Seat 9: dfNim92Z6XK1/h5SFW5vDg ($28.45 in chips) 
dfNim92Z6XK1/h5SFW5vDg: posts small blind $0.10
oLa/tXLfSLLB28mcLGrxcg: posts big blind $0.25
*** HOLE CARDS ***
er86weqXTpTB6/w2dKlYgA: calls $0.25
X6+pSIPfovPcE87t+LmUKQ: folds 
qwr38jl5txoR36M7G5qi4A: folds 
K1MDeapSEyKyGPNZGOKfEg: folds 
MThMMgdB293VOucmN9sliQ: folds 
wvlPJBB0PtYkfeeSRDaIvQ: folds 
SpiiQQAzy4MUgV3I5W8giw: folds 
dfNim92Z6XK1/h5SFW5vDg: folds 
oLa/tXLfSLLB28mcLGrxcg: checks 
*** FLOP *** [5c 9d Jh]
oLa/tXLfSLLB28mcLGrxcg: bets $0.25
er86weqXTpTB6/w2dKlYgA: folds 
Uncalled bet ($0.25) returned to oLa/tXLfSLLB28mcLGrxcg
oLa/tXLfSLLB28mcLGrxcg collected $0.60 from pot
oLa/tXLfSLLB28mcLGrxcg: doesn't show hand 
*** SUMMARY ***
Total pot $0.60 | Rake $0 
Board [5c 9d Jh]
Seat 1: oLa/tXLfSLLB28mcLGrxcg (big blind) collected ($0.60)
Seat 2: er86weqXTpTB6/w2dKlYgA folded on the Flop
Seat 3: X6+pSIPfovPcE87t+LmUKQ folded before Flop (didn't bet)
Seat 4: qwr38jl5txoR36M7G5qi4A folded before Flop (didn't bet)
Seat 5: K1MDeapSEyKyGPNZGOKfEg folded before Flop (didn't bet)
Seat 6: MThMMgdB293VOucmN9sliQ folded before Flop (didn't bet)
Seat 7: wvlPJBB0PtYkfeeSRDaIvQ folded before Flop (didn't bet)
Seat 8: SpiiQQAzy4MUgV3I5W8giw (button) folded before Flop (didn't bet)
Seat 9: dfNim92Z6XK1/h5SFW5vDg (small blind) folded before Flop




PokerStars Game #59942013886:  Hold'em No Limit ($0.10/$0.25) - 2009/07/01 1:53:20 ET
Table 'IRgQPZVA4+IaZZIQshgwyg' 6-max Seat #4 is the button
Seat 1: cezpHJ8FB07dj0xG+LhOvw ($27.55 in chips) 
Seat 2: HZrrzaHXN9+c2uyWFqzULg ($15.35 in chips) 
Seat 3: DihMHaz4WNETH1bPDe13kA ($27.45 in chips) 
Seat 4: DE9hRlt14g+JdsRQ4wT7hg ($25 in chips) 
Seat 5: w43JQj2oYPpKQVG4Yzlq1w ($27.80 in chips) 
Seat 6: x9/USY6PsmgUGQeluFLKDw ($20.95 in chips) 
w43JQj2oYPpKQVG4Yzlq1w: posts small blind $0.10
x9/USY6PsmgUGQeluFLKDw: posts big blind $0.25
*** HOLE CARDS ***
cezpHJ8FB07dj0xG+LhOvw: folds 
HZrrzaHXN9+c2uyWFqzULg: calls $0.25
DihMHaz4WNETH1bPDe13kA: folds 
DE9hRlt14g+JdsRQ4wT7hg: raises $1 to $1.25
w43JQj2oYPpKQVG4Yzlq1w: folds 
x9/USY6PsmgUGQeluFLKDw: folds 
HZrrzaHXN9+c2uyWFqzULg: folds 
Uncalled bet ($1) returned to DE9hRlt14g+JdsRQ4wT7hg
DE9hRlt14g+JdsRQ4wT7hg collected $0.85 from pot
DE9hRlt14g+JdsRQ4wT7hg: doesn't show hand 
*** SUMMARY ***
Total pot $0.85 | Rake $0 
Seat 1: cezpHJ8FB07dj0xG+LhOvw folded before Flop (didn't bet)
Seat 2: HZrrzaHXN9+c2uyWFqzULg folded before Flop
Seat 3: DihMHaz4WNETH1bPDe13kA folded before Flop (didn't bet)
Seat 4: DE9hRlt14g+JdsRQ4wT7hg (button) collected ($0.85)
Seat 5: w43JQj2oYPpKQVG4Yzlq1w (small blind) folded before Flop
Seat 6: x9/USY6PsmgUGQeluFLKDw (big blind) folded before Flop




PokerStars Game #59942013530:  Hold'em No Limit ($0.10/$0.25) - 2009/07/01 1:53:20 ET
Table 'C8mMnVmvkagwolEzTvh07A' 9-max Seat #3 is the button
Seat 1: PqvgxdSg9z5VmrWpbYuz+g ($26.75 in chips) 
Seat 2: Bb42QRQMhg5/Y0vHP8/2Xw ($25 in chips) 
Seat 3: Th3FldXKQW6hWVVPahaoOQ ($34.15 in chips) 
Seat 4: dfNim92Z6XK1/h5SFW5vDg ($25.45 in chips) 
Seat 5: iGMlK+EhUflPB6jKQd95Cg ($25 in chips) 
Seat 6: AiXn/9o1EwOPZUHujnh/bA ($17.90 in chips) 
dfNim92Z6XK1/h5SFW5vDg: posts small blind $0.10
iGMlK+EhUflPB6jKQd95Cg: posts big blind $0.25
18G4P1XstjNvItdGUITxgw: sits out 
*** HOLE CARDS ***
AiXn/9o1EwOPZUHujnh/bA: folds 
PqvgxdSg9z5VmrWpbYuz+g: raises $0.75 to $1
Bb42QRQMhg5/Y0vHP8/2Xw: folds 
Th3FldXKQW6hWVVPahaoOQ: folds 
dfNim92Z6XK1/h5SFW5vDg: folds 
iGMlK+EhUflPB6jKQd95Cg: folds 
Uncalled bet ($0.75) returned to PqvgxdSg9z5VmrWpbYuz+g
PqvgxdSg9z5VmrWpbYuz+g collected $0.60 from pot
PqvgxdSg9z5VmrWpbYuz+g: doesn't show hand 
*** SUMMARY ***
Total pot $0.60 | Rake $0 
Seat 1: PqvgxdSg9z5VmrWpbYuz+g collected ($0.60)
Seat 2: Bb42QRQMhg5/Y0vHP8/2Xw folded before Flop (didn't bet)
Seat 3: Th3FldXKQW6hWVVPahaoOQ (button) folded before Flop (didn't bet)
Seat 4: dfNim92Z6XK1/h5SFW5vDg (small blind) folded before Flop
Seat 5: iGMlK+EhUflPB6jKQd95Cg (big blind) folded before Flop
Seat 6: AiXn/9o1EwOPZUHujnh/bA folded before Flop (didn't bet)




PokerStars Game #59942014222:  Hold'em No Limit ($0.10/$0.25) - 2009/07/01 1:53:21 ET
Table 'wRXcD9iXgBbdvKhWmfnBnw' 6-max Seat #6 is the button
Seat 1: Mhj3q7cxev+XjXZxEE6/Cw ($25 in chips) 
Seat 2: vUr8qM1UsCElsCI9B/McdQ ($21.30 in chips) 
Seat 3: SxIIgwXYLkwd6m3wLyPTCw ($26.15 in chips) 
Seat 4: mnuJq+Q1IXKm/pCy+OzxmQ ($19.25 in chips) 
Seat 5: EE16Ua5b1HSsYej5zeXOlA ($51.05 in chips) 
Seat 6: JFIAqU8lCZ0vWwEl4bdGsg ($33.65 in chips) 
Mhj3q7cxev+XjXZxEE6/Cw: posts small blind $0.10
vUr8qM1UsCElsCI9B/McdQ: posts big blind $0.25
*** HOLE CARDS ***
SxIIgwXYLkwd6m3wLyPTCw: folds 
mnuJq+Q1IXKm/pCy+OzxmQ: folds 
EE16Ua5b1HSsYej5zeXOlA: raises $0.50 to $0.75
JFIAqU8lCZ0vWwEl4bdGsg: folds 
Mhj3q7cxev+XjXZxEE6/Cw: folds 
vUr8qM1UsCElsCI9B/McdQ: calls $0.50
*** FLOP *** [6c Jd Js]
vUr8qM1UsCElsCI9B/McdQ: checks 
EE16Ua5b1HSsYej5zeXOlA: bets $1.10
vUr8qM1UsCElsCI9B/McdQ: folds 
Uncalled bet ($1.10) returned to EE16Ua5b1HSsYej5zeXOlA
EE16Ua5b1HSsYej5zeXOlA collected $1.55 from pot
EE16Ua5b1HSsYej5zeXOlA: doesn't show hand 
*** SUMMARY ***
Total pot $1.60 | Rake $0.05 
Board [6c Jd Js]
Seat 1: Mhj3q7cxev+XjXZxEE6/Cw (small blind) folded before Flop
Seat 2: vUr8qM1UsCElsCI9B/McdQ (big blind) folded on the Flop
Seat 3: SxIIgwXYLkwd6m3wLyPTCw folded before Flop (didn't bet)
Seat 4: mnuJq+Q1IXKm/pCy+OzxmQ folded before Flop (didn't bet)
Seat 5: EE16Ua5b1HSsYej5zeXOlA collected ($1.55)
Seat 6: JFIAqU8lCZ0vWwEl4bdGsg (button) folded before Flop (didn't bet)




PokerStars Game #59942014250:  Hold'em No Limit ($0.10/$0.25) - 2009/07/01 1:53:21 ET
Table 'fIMYcWwN4/aXFJvH5Z8Ymg' 6-max Seat #5 is the button
Seat 1: DihMHaz4WNETH1bPDe13kA ($25.35 in chips) 
Seat 2: Mhj3q7cxev+XjXZxEE6/Cw ($26.30 in chips) 
Seat 3: 9bpVv1/Qh9IYtXuCtl5VtQ ($23.65 in chips) 
Seat 4: 7cx44/slbeTw+Cy7QB8Trg ($24.65 in chips) 
Seat 5: JppOakN7YnIDLWiLzBbtSg ($26 in chips) 
Seat 6: jp34e617tIzV8tKIWmfAbA ($28.45 in chips) 
jp34e617tIzV8tKIWmfAbA: posts small blind $0.10
DihMHaz4WNETH1bPDe13kA: posts big blind $0.25
*** HOLE CARDS ***
Mhj3q7cxev+XjXZxEE6/Cw: folds 
9bpVv1/Qh9IYtXuCtl5VtQ: folds 
7cx44/slbeTw+Cy7QB8Trg: folds 
JppOakN7YnIDLWiLzBbtSg: raises $0.75 to $1
jp34e617tIzV8tKIWmfAbA: folds 
DihMHaz4WNETH1bPDe13kA: folds 
Uncalled bet ($0.75) returned to JppOakN7YnIDLWiLzBbtSg
JppOakN7YnIDLWiLzBbtSg collected $0.60 from pot
JppOakN7YnIDLWiLzBbtSg: doesn't show hand 
*** SUMMARY ***
Total pot $0.60 | Rake $0 
Seat 1: DihMHaz4WNETH1bPDe13kA (big blind) folded before Flop
Seat 2: Mhj3q7cxev+XjXZxEE6/Cw folded before Flop (didn't bet)
Seat 3: 9bpVv1/Qh9IYtXuCtl5VtQ folded before Flop (didn't bet)
Seat 4: 7cx44/slbeTw+Cy7QB8Trg folded before Flop (didn't bet)
Seat 5: JppOakN7YnIDLWiLzBbtSg (button) collected ($0.60)
Seat 6: jp34e617tIzV8tKIWmfAbA (small blind) folded before Flop




PokerStars Game #59942014168:  Hold'em No Limit ($0.10/$0.25) - 2009/07/01 1:53:21 ET
Table 'vFZR6Kf2Th5xBXT9brGW6A' 6-max Seat #4 is the button
Seat 1: Q1uciOZPBR/WkAlqa6cL4A ($27.55 in chips) 
Seat 2: QiL+lEgEWwy21jk/ltaRLg ($26 in chips) 
Seat 4: 79ID/ub1Pt/mDpCprVmOoA ($33.85 in chips) 
Seat 5: SS/yfeArhULzIcOPe8MdPg ($28.35 in chips) 
SS/yfeArhULzIcOPe8MdPg: posts small blind $0.10
4x9jCqgSw4272dnaIqnanw: is sitting out 
Q1uciOZPBR/WkAlqa6cL4A: posts big blind $0.25
*** HOLE CARDS ***
4x9jCqgSw4272dnaIqnanw has returned
QiL+lEgEWwy21jk/ltaRLg: folds 
79ID/ub1Pt/mDpCprVmOoA: folds 
SS/yfeArhULzIcOPe8MdPg: raises $0.50 to $0.75
Q1uciOZPBR/WkAlqa6cL4A: folds 
Uncalled bet ($0.50) returned to SS/yfeArhULzIcOPe8MdPg
SS/yfeArhULzIcOPe8MdPg collected $0.50 from pot
*** SUMMARY ***
Total pot $0.50 | Rake $0 
Seat 1: Q1uciOZPBR/WkAlqa6cL4A (big blind) folded before Flop
Seat 2: QiL+lEgEWwy21jk/ltaRLg folded before Flop (didn't bet)
Seat 4: 79ID/ub1Pt/mDpCprVmOoA (button) folded before Flop (didn't bet)
Seat 5: SS/yfeArhULzIcOPe8MdPg (small blind) collected ($0.50)




PokerStars Game #59942014208:  Hold'em No Limit ($0.10/$0.25) - 2009/07/01 1:53:21 ET
Table 'AHkg4ChqzcMauBx6Qvz8Nw' 6-max Seat #4 is the button
Seat 1: +RDf7SmUjY2kK0PzdBEYqg ($4.65 in chips) 
Seat 2: Vi0JMrTI2BGrPL7UIulJtA ($3.50 in chips) 
Seat 3: 9dToMv2GJLfi00HcpfMnIw ($28.30 in chips) 
Seat 4: Eznneya0vB6S+eXJdVleHA ($21.40 in chips) 
Seat 5: Bada343Si4xKu3fNXY99AA ($3.55 in chips) 
Bada343Si4xKu3fNXY99AA: posts small blind $0.10
+RDf7SmUjY2kK0PzdBEYqg: posts big blind $0.25
*** HOLE CARDS ***
Eznneya0vB6S+eXJdVleHA said, "well  played"
Vi0JMrTI2BGrPL7UIulJtA: folds 
9dToMv2GJLfi00HcpfMnIw: folds 
Eznneya0vB6S+eXJdVleHA: folds 
Bada343Si4xKu3fNXY99AA: raises $0.50 to $0.75
+RDf7SmUjY2kK0PzdBEYqg: folds 
Uncalled bet ($0.50) returned to Bada343Si4xKu3fNXY99AA
Bada343Si4xKu3fNXY99AA collected $0.50 from pot
*** SUMMARY ***
Total pot $0.50 | Rake $0 
Seat 1: +RDf7SmUjY2kK0PzdBEYqg (big blind) folded before Flop
Seat 2: Vi0JMrTI2BGrPL7UIulJtA folded before Flop (didn't bet)
Seat 3: 9dToMv2GJLfi00HcpfMnIw folded before Flop (didn't bet)
Seat 4: Eznneya0vB6S+eXJdVleHA (button) folded before Flop (didn't bet)
Seat 5: Bada343Si4xKu3fNXY99AA (small blind) collected ($0.50)




PokerStars Game #59942014320:  Hold'em No Limit ($0.10/$0.25) - 2009/07/01 1:53:21 ET
Table '2clPgY3+dETPD/8zjXZdFw' 6-max Seat #6 is the button
Seat 1: 7cx44/slbeTw+Cy7QB8Trg ($27.20 in chips) 
Seat 2: cWc85bEzdRzpUMhRKm8pwQ ($25 in chips) 
Seat 4: ljjhtb6FVPTx9AT9HNdtqg ($23.45 in chips) 
Seat 5: LJI7A1YgDM7hgh7o56+ReQ ($30.45 in chips) 
Seat 6: c3J/KYZ4cNsUEuz8v57I5A ($22.90 in chips) 
7cx44/slbeTw+Cy7QB8Trg: posts small blind $0.10
cWc85bEzdRzpUMhRKm8pwQ: posts big blind $0.25
*** HOLE CARDS ***
ljjhtb6FVPTx9AT9HNdtqg: raises $0.50 to $0.75
LJI7A1YgDM7hgh7o56+ReQ: folds 
c3J/KYZ4cNsUEuz8v57I5A: raises $2 to $2.75
7cx44/slbeTw+Cy7QB8Trg: folds 
cWc85bEzdRzpUMhRKm8pwQ: folds 
ljjhtb6FVPTx9AT9HNdtqg: folds 
Uncalled bet ($2) returned to c3J/KYZ4cNsUEuz8v57I5A
c3J/KYZ4cNsUEuz8v57I5A collected $1.85 from pot
*** SUMMARY ***
Total pot $1.85 | Rake $0 
Seat 1: 7cx44/slbeTw+Cy7QB8Trg (small blind) folded before Flop
Seat 2: cWc85bEzdRzpUMhRKm8pwQ (big blind) folded before Flop
Seat 4: ljjhtb6FVPTx9AT9HNdtqg folded before Flop
Seat 5: LJI7A1YgDM7hgh7o56+ReQ folded before Flop (didn't bet)
Seat 6: c3J/KYZ4cNsUEuz8v57I5A (button) collected ($1.85)




PokerStars Game #59942014526:  Hold'em No Limit ($0.10/$0.25) - 2009/07/01 1:53:22 ET
Table 'tANpk8z1C5o0Pq/hpYShHw' 9-max Seat #2 is the button
Seat 1: rQhYIYXSyH/IivYM1dlV5A ($16.75 in chips) 
Seat 2: og4yH4sZUZdC8jjgW8zPJQ ($0.85 in chips) 
Seat 3: zDrucyjVn5aeekNEc3cJrA ($18.05 in chips) 
Seat 4: j4q3p0lesp63b1gZDwLBZw ($5 in chips) 
Seat 5: X6+pSIPfovPcE87t+LmUKQ ($6.80 in chips) 
Seat 6: kN0AWJG6biW8tHtuF+wTjA ($11.95 in chips) 
Seat 7: aNpwfA31EREwO+ar4XzBCw ($26.95 in chips) 
Seat 9: gE5rN2TDY1aXcZn/TOPeZw ($10.90 in chips) 
zDrucyjVn5aeekNEc3cJrA: posts small blind $0.10
j4q3p0lesp63b1gZDwLBZw: posts big blind $0.25
V6p0jQ/RhUsqpHLmXvEX4Q: sits out 
*** HOLE CARDS ***
X6+pSIPfovPcE87t+LmUKQ: folds 
kN0AWJG6biW8tHtuF+wTjA: folds 
aNpwfA31EREwO+ar4XzBCw: folds 
gE5rN2TDY1aXcZn/TOPeZw: folds 
rQhYIYXSyH/IivYM1dlV5A: calls $0.25
og4yH4sZUZdC8jjgW8zPJQ: raises $0.60 to $0.85 and is all-in
zDrucyjVn5aeekNEc3cJrA: folds 
j4q3p0lesp63b1gZDwLBZw: calls $0.60
rQhYIYXSyH/IivYM1dlV5A: folds 
*** FLOP *** [8s 5h Ks]
*** TURN *** [8s 5h Ks] [Td]
*** RIVER *** [8s 5h Ks Td] [6c]
*** SHOW DOWN ***
j4q3p0lesp63b1gZDwLBZw: shows [Jc Ah] (high card Ace)
og4yH4sZUZdC8jjgW8zPJQ: mucks hand 
j4q3p0lesp63b1gZDwLBZw collected $1.95 from pot
*** SUMMARY ***
Total pot $2.05 | Rake $0.10 
Board [8s 5h Ks Td 6c]
Seat 1: rQhYIYXSyH/IivYM1dlV5A folded before Flop
Seat 2: og4yH4sZUZdC8jjgW8zPJQ (button) mucked
Seat 3: zDrucyjVn5aeekNEc3cJrA (small blind) folded before Flop
Seat 4: j4q3p0lesp63b1gZDwLBZw (big blind) showed [Jc Ah] and won ($1.95) with high card Ace
Seat 5: X6+pSIPfovPcE87t+LmUKQ folded before Flop (didn't bet)
Seat 6: kN0AWJG6biW8tHtuF+wTjA folded before Flop (didn't bet)
Seat 7: aNpwfA31EREwO+ar4XzBCw folded before Flop (didn't bet)
Seat 9: gE5rN2TDY1aXcZn/TOPeZw folded before Flop (didn't bet)




PokerStars Game #59942014750:  Hold'em No Limit ($0.10/$0.25) - 2009/07/01 1:53:22 ET
Table 'Y9EhDWuqWWQFM9SelXAj5g' 9-max Seat #2 is the button
Seat 1: zDrucyjVn5aeekNEc3cJrA ($30.80 in chips) 
Seat 2: W+njF1UnarGN2q2zP+R+cg ($13.35 in chips) 
Seat 3: XBq1lBzax7LjRqdJP2TqWg ($5.50 in chips) 
Seat 4: V6p0jQ/RhUsqpHLmXvEX4Q ($13 in chips) 
Seat 5: CvL9Ch1HYCVbTsfpNucitg ($6.20 in chips) 
Seat 6: egvg3mTBBVzMHnJPIQiKcA ($13.65 in chips) 
Seat 8: XDxyajtqmdag0QPvwcOG7Q ($14.60 in chips) 
Seat 9: bOrfviVhRBpaOfMqUc74Tw ($20.65 in chips) 
XBq1lBzax7LjRqdJP2TqWg: posts small blind $0.10
V6p0jQ/RhUsqpHLmXvEX4Q: posts big blind $0.25
SpiiQQAzy4MUgV3I5W8giw: sits out 
*** HOLE CARDS ***
CvL9Ch1HYCVbTsfpNucitg: folds 
egvg3mTBBVzMHnJPIQiKcA: folds 
XDxyajtqmdag0QPvwcOG7Q: folds 
bOrfviVhRBpaOfMqUc74Tw: folds 
zDrucyjVn5aeekNEc3cJrA: calls $0.25
W+njF1UnarGN2q2zP+R+cg: folds 
XBq1lBzax7LjRqdJP2TqWg: calls $0.15
V6p0jQ/RhUsqpHLmXvEX4Q: checks 
*** FLOP *** [6d 5d Jd]
XBq1lBzax7LjRqdJP2TqWg: checks 
V6p0jQ/RhUsqpHLmXvEX4Q: checks 
zDrucyjVn5aeekNEc3cJrA: checks 
*** TURN *** [6d 5d Jd] [Jc]
XBq1lBzax7LjRqdJP2TqWg: checks 
V6p0jQ/RhUsqpHLmXvEX4Q: checks 
zDrucyjVn5aeekNEc3cJrA: checks 
*** RIVER *** [6d 5d Jd Jc] [Qs]
XBq1lBzax7LjRqdJP2TqWg: bets $0.50
V6p0jQ/RhUsqpHLmXvEX4Q: folds 
zDrucyjVn5aeekNEc3cJrA: folds 
Uncalled bet ($0.50) returned to XBq1lBzax7LjRqdJP2TqWg
XBq1lBzax7LjRqdJP2TqWg collected $0.75 from pot
XBq1lBzax7LjRqdJP2TqWg: doesn't show hand 
*** SUMMARY ***
Total pot $0.75 | Rake $0 
Board [6d 5d Jd Jc Qs]
Seat 1: zDrucyjVn5aeekNEc3cJrA folded on the River
Seat 2: W+njF1UnarGN2q2zP+R+cg (button) folded before Flop (didn't bet)
Seat 3: XBq1lBzax7LjRqdJP2TqWg (small blind) collected ($0.75)
Seat 4: V6p0jQ/RhUsqpHLmXvEX4Q (big blind) folded on the River
Seat 5: CvL9Ch1HYCVbTsfpNucitg folded before Flop (didn't bet)
Seat 6: egvg3mTBBVzMHnJPIQiKcA folded before Flop (didn't bet)
Seat 8: XDxyajtqmdag0QPvwcOG7Q folded before Flop (didn't bet)
Seat 9: bOrfviVhRBpaOfMqUc74Tw folded before Flop (didn't bet)




PokerStars Game #59942014560:  Hold'em No Limit ($0.10/$0.25) - 2009/07/01 1:53:22 ET
Table 'BpNkESDX1ip9c0K1hb5h7A' 6-max Seat #3 is the button
Seat 2: 9U3ZKjCsarN0DjR6mSE8Ug ($30.35 in chips) 
Seat 3: fZQg9veL7Dd/Z04ZTjC+wQ ($32.30 in chips) 
Seat 4: kG34n23qFQA3nzdOJTQ1dA ($26.60 in chips) 
Seat 5: OMGl+YMGogf2JWIRfT2/Yg ($5 in chips) 
Seat 6: 8EEqTTh7T1q48sYDqbI2Xg ($21.80 in chips) 
kG34n23qFQA3nzdOJTQ1dA: posts small blind $0.10
OMGl+YMGogf2JWIRfT2/Yg: posts big blind $0.25
*** HOLE CARDS ***
8EEqTTh7T1q48sYDqbI2Xg: folds 
9U3ZKjCsarN0DjR6mSE8Ug: raises $0.50 to $0.75
fZQg9veL7Dd/Z04ZTjC+wQ: folds 
kG34n23qFQA3nzdOJTQ1dA: calls $0.65
OMGl+YMGogf2JWIRfT2/Yg: folds 
*** FLOP *** [4d 9s 3h]
kG34n23qFQA3nzdOJTQ1dA: checks 
9U3ZKjCsarN0DjR6mSE8Ug: bets $0.75
kG34n23qFQA3nzdOJTQ1dA: folds 
Uncalled bet ($0.75) returned to 9U3ZKjCsarN0DjR6mSE8Ug
9U3ZKjCsarN0DjR6mSE8Ug collected $1.70 from pot
9U3ZKjCsarN0DjR6mSE8Ug: doesn't show hand 
*** SUMMARY ***
Total pot $1.75 | Rake $0.05 
Board [4d 9s 3h]
Seat 2: 9U3ZKjCsarN0DjR6mSE8Ug collected ($1.70)
Seat 3: fZQg9veL7Dd/Z04ZTjC+wQ (button) folded before Flop (didn't bet)
Seat 4: kG34n23qFQA3nzdOJTQ1dA (small blind) folded on the Flop
Seat 5: OMGl+YMGogf2JWIRfT2/Yg (big blind) folded before Flop
Seat 6: 8EEqTTh7T1q48sYDqbI2Xg folded before Flop (didn't bet)




PokerStars Game #59942015024:  Hold'em No Limit ($0.10/$0.25) - 2009/07/01 1:53:22 ET
Table 'gYBWJG3hEuJg6kphY0yhMg' 9-max Seat #7 is the button
Seat 1: AcL/hxc9eT0dCr2TYk/0Dg ($26.70 in chips) 
Seat 2: RCqMONFrSPSArZh2Jsar/w ($17.25 in chips) 
Seat 3: wGigCmBR/9XWkPpvYos3aQ ($25 in chips) 
Seat 4: V6p0jQ/RhUsqpHLmXvEX4Q ($12.35 in chips) 
Seat 5: +sbyWwIcFp9kP0bDtMegfQ ($27.90 in chips) 
Seat 6: Z9W7+g1WMhhZDi7DwGbCFA ($5 in chips) 
Seat 7: aIEQGxUJwm61WfazSNFCdA ($25.80 in chips) 
Seat 8: 7je+LC5Mfs6nL8YBVh4frQ ($4.50 in chips) 
Seat 9: Bb42QRQMhg5/Y0vHP8/2Xw ($28.05 in chips) 
7je+LC5Mfs6nL8YBVh4frQ: posts small blind $0.10
Bb42QRQMhg5/Y0vHP8/2Xw: posts big blind $0.25
*** HOLE CARDS ***
AcL/hxc9eT0dCr2TYk/0Dg: folds 
RCqMONFrSPSArZh2Jsar/w: folds 
wGigCmBR/9XWkPpvYos3aQ: raises $0.65 to $0.90
V6p0jQ/RhUsqpHLmXvEX4Q: folds 
+sbyWwIcFp9kP0bDtMegfQ: folds 
Z9W7+g1WMhhZDi7DwGbCFA: folds 
aIEQGxUJwm61WfazSNFCdA: folds 
7je+LC5Mfs6nL8YBVh4frQ: folds 
Bb42QRQMhg5/Y0vHP8/2Xw: calls $0.65
*** FLOP *** [3h 3s Kd]
Bb42QRQMhg5/Y0vHP8/2Xw: checks 
wGigCmBR/9XWkPpvYos3aQ: bets $1.50
Bb42QRQMhg5/Y0vHP8/2Xw: folds 
Uncalled bet ($1.50) returned to wGigCmBR/9XWkPpvYos3aQ
wGigCmBR/9XWkPpvYos3aQ collected $1.85 from pot
wGigCmBR/9XWkPpvYos3aQ: doesn't show hand 
*** SUMMARY ***
Total pot $1.90 | Rake $0.05 
Board [3h 3s Kd]
Seat 1: AcL/hxc9eT0dCr2TYk/0Dg folded before Flop (didn't bet)
Seat 2: RCqMONFrSPSArZh2Jsar/w folded before Flop (didn't bet)
Seat 3: wGigCmBR/9XWkPpvYos3aQ collected ($1.85)
Seat 4: V6p0jQ/RhUsqpHLmXvEX4Q folded before Flop (didn't bet)
Seat 5: +sbyWwIcFp9kP0bDtMegfQ folded before Flop (didn't bet)
Seat 6: Z9W7+g1WMhhZDi7DwGbCFA folded before Flop (didn't bet)
Seat 7: aIEQGxUJwm61WfazSNFCdA (button) folded before Flop (didn't bet)
Seat 8: 7je+LC5Mfs6nL8YBVh4frQ (small blind) folded before Flop
Seat 9: Bb42QRQMhg5/Y0vHP8/2Xw (big blind) folded on the Flop




PokerStars Game #59942014926:  Hold'em No Limit ($0.10/$0.25) - 2009/07/01 1:53:22 ET
Table 'mVdLgAdN9rGe6mMwSrDdGQ' 6-max Seat #4 is the button
Seat 1: OyJ0KTHA5cwh0/yCo1/rdA ($9.40 in chips) 
Seat 2: n9QqWD4tpbongUBX2Oi58w ($10.80 in chips) 
Seat 3: +baiVgI/ETnBARLe5mARCw ($14.15 in chips) 
Seat 4: scNSjC6yyKvvfklSkuzLrw ($25.30 in chips) 
Seat 5: +TMG/MBWpiEnc9t7i07eTA ($22.90 in chips) 
Seat 6: DihMHaz4WNETH1bPDe13kA ($47.95 in chips) 
+TMG/MBWpiEnc9t7i07eTA: posts small blind $0.10
DihMHaz4WNETH1bPDe13kA: posts big blind $0.25
*** HOLE CARDS ***
OyJ0KTHA5cwh0/yCo1/rdA: folds 
n9QqWD4tpbongUBX2Oi58w: folds 
+baiVgI/ETnBARLe5mARCw: calls $0.25
scNSjC6yyKvvfklSkuzLrw: folds 
+TMG/MBWpiEnc9t7i07eTA: calls $0.15
DihMHaz4WNETH1bPDe13kA: checks 
*** FLOP *** [4c As Js]
+TMG/MBWpiEnc9t7i07eTA: checks 
DihMHaz4WNETH1bPDe13kA: bets $0.50
+baiVgI/ETnBARLe5mARCw: calls $0.50
+TMG/MBWpiEnc9t7i07eTA: folds 
*** TURN *** [4c As Js] [3s]
DihMHaz4WNETH1bPDe13kA: checks 
+baiVgI/ETnBARLe5mARCw: checks 
*** RIVER *** [4c As Js 3s] [2s]
DihMHaz4WNETH1bPDe13kA: checks 
+baiVgI/ETnBARLe5mARCw: checks 
*** SHOW DOWN ***
DihMHaz4WNETH1bPDe13kA: shows [5c Ad] (a straight, Ace to Five)
+baiVgI/ETnBARLe5mARCw: shows [7s 7h] (a flush, Ace high)
+baiVgI/ETnBARLe5mARCw collected $1.70 from pot
*** SUMMARY ***
Total pot $1.75 | Rake $0.05 
Board [4c As Js 3s 2s]
Seat 1: OyJ0KTHA5cwh0/yCo1/rdA folded before Flop (didn't bet)
Seat 2: n9QqWD4tpbongUBX2Oi58w folded before Flop (didn't bet)
Seat 3: +baiVgI/ETnBARLe5mARCw showed [7s 7h] and won ($1.70) with a flush, Ace high
Seat 4: scNSjC6yyKvvfklSkuzLrw (button) folded before Flop (didn't bet)
Seat 5: +TMG/MBWpiEnc9t7i07eTA (small blind) folded on the Flop
Seat 6: DihMHaz4WNETH1bPDe13kA (big blind) showed [5c Ad] and lost with a straight, Ace to Five




PokerStars Game #59942015018:  Hold'em No Limit ($0.10/$0.25) - 2009/07/01 1:53:22 ET
Table 'wGizWOswEL6P5QrvVkno/g' 6-max Seat #5 is the button
Seat 1: Qbfkn+ucISvbd1Xh32zAGA ($33.35 in chips) 
Seat 2: mfrkWA3PTeYPkbO6hi98Aw ($27.40 in chips) 
Seat 3: i9LqF5rD3bvtbEE7HWgr3Q ($26.95 in chips) 
Seat 4: yF9xHMEAvA+7Gn+eDkuVIg ($2.05 in chips) 
Seat 5: w43JQj2oYPpKQVG4Yzlq1w ($25 in chips) 
Seat 6: BuAE7g7dRfuqGPmQDlGyGg ($18.50 in chips) 
BuAE7g7dRfuqGPmQDlGyGg: posts small blind $0.10
Qbfkn+ucISvbd1Xh32zAGA: posts big blind $0.25
*** HOLE CARDS ***
mfrkWA3PTeYPkbO6hi98Aw: folds 
i9LqF5rD3bvtbEE7HWgr3Q: folds 
yF9xHMEAvA+7Gn+eDkuVIg: folds 
w43JQj2oYPpKQVG4Yzlq1w: folds 
BuAE7g7dRfuqGPmQDlGyGg: calls $0.15
Qbfkn+ucISvbd1Xh32zAGA: checks 
*** FLOP *** [5h Td Ac]
BuAE7g7dRfuqGPmQDlGyGg: checks 
Qbfkn+ucISvbd1Xh32zAGA: checks 
*** TURN *** [5h Td Ac] [6c]
BuAE7g7dRfuqGPmQDlGyGg: checks 
Qbfkn+ucISvbd1Xh32zAGA: bets $0.50
BuAE7g7dRfuqGPmQDlGyGg: folds 
Uncalled bet ($0.50) returned to Qbfkn+ucISvbd1Xh32zAGA
Qbfkn+ucISvbd1Xh32zAGA collected $0.50 from pot
Qbfkn+ucISvbd1Xh32zAGA: doesn't show hand 
*** SUMMARY ***
Total pot $0.50 | Rake $0 
Board [5h Td Ac 6c]
Seat 1: Qbfkn+ucISvbd1Xh32zAGA (big blind) collected ($0.50)
Seat 2: mfrkWA3PTeYPkbO6hi98Aw folded before Flop (didn't bet)
Seat 3: i9LqF5rD3bvtbEE7HWgr3Q folded before Flop (didn't bet)
Seat 4: yF9xHMEAvA+7Gn+eDkuVIg folded before Flop (didn't bet)
Seat 5: w43JQj2oYPpKQVG4Yzlq1w (button) folded before Flop (didn't bet)
Seat 6: BuAE7g7dRfuqGPmQDlGyGg (small blind) folded on the Turn




PokerStars Game #59942015284:  Hold'em No Limit ($0.10/$0.25) - 2009/07/01 1:53:23 ET
Table 'ouLhepGYovxB2x0QxH7cVg' 9-max Seat #4 is the button
Seat 1: ghNKXUBl/H+t83JF079ZBA ($25 in chips) 
Seat 2: r1Z5m4PwSI5ANp7qCE1OJw ($10.85 in chips) 
Seat 4: a0Sx6GHY7ln2Ns2C97eXeA ($59.40 in chips) 
Seat 5: v60REj6f8jzMYT0VsZvaPQ ($21.05 in chips) 
Seat 6: hYvTc4PYNrAaNAIVoM94Hw ($6.50 in chips) 
Seat 8: tLcDklc2rBORNfixyRfVfw ($25.25 in chips) 
Seat 9: ljemhp25Zg+nlA9DLCIiUw ($24.95 in chips) 
v60REj6f8jzMYT0VsZvaPQ: posts small blind $0.10
hYvTc4PYNrAaNAIVoM94Hw: posts big blind $0.25
cKlmpQMahVsmOaxFQDcoOg: sits out 
k020504: sits out 
*** HOLE CARDS ***
tLcDklc2rBORNfixyRfVfw: folds 
ljemhp25Zg+nlA9DLCIiUw: folds 
ghNKXUBl/H+t83JF079ZBA: folds 
r1Z5m4PwSI5ANp7qCE1OJw: raises $0.50 to $0.75
a0Sx6GHY7ln2Ns2C97eXeA: folds 
v60REj6f8jzMYT0VsZvaPQ: folds 
hYvTc4PYNrAaNAIVoM94Hw: folds 
Uncalled bet ($0.50) returned to r1Z5m4PwSI5ANp7qCE1OJw
r1Z5m4PwSI5ANp7qCE1OJw collected $0.60 from pot
r1Z5m4PwSI5ANp7qCE1OJw: doesn't show hand 
*** SUMMARY ***
Total pot $0.60 | Rake $0 
Seat 1: ghNKXUBl/H+t83JF079ZBA folded before Flop (didn't bet)
Seat 2: r1Z5m4PwSI5ANp7qCE1OJw collected ($0.60)
Seat 4: a0Sx6GHY7ln2Ns2C97eXeA (button) folded before Flop (didn't bet)
Seat 5: v60REj6f8jzMYT0VsZvaPQ (small blind) folded before Flop
Seat 6: hYvTc4PYNrAaNAIVoM94Hw (big blind) folded before Flop
Seat 8: tLcDklc2rBORNfixyRfVfw folded before Flop (didn't bet)
Seat 9: ljemhp25Zg+nlA9DLCIiUw folded before Flop (didn't bet)




PokerStars Game #59942015194:  Hold'em No Limit ($0.10/$0.25) - 2009/07/01 1:53:23 ET
Table 'n8mNkPYbe1AIQEkioNesZA' 9-max Seat #6 is the button
Seat 1: 9lvO/qyU+xrU95Teu1fv0g ($6.70 in chips) 
Seat 2: QEbIGci+itdw+re8RM5fZA ($29.30 in chips) 
Seat 3: zDrucyjVn5aeekNEc3cJrA ($18.40 in chips) 
Seat 4: zgi+EUykT/pZQpoUG6+oEg ($4.65 in chips) 
Seat 5: wGigCmBR/9XWkPpvYos3aQ ($28.65 in chips) 
Seat 6: HPEB+AtKw1+C/cxU0o1ciw ($46.55 in chips) 
Seat 7: vNfw/x/HNt0WgQC8SveThg ($4.25 in chips) 
Seat 9: gehe91e0IyVT0QU/XBkEyg ($28.25 in chips) 
vNfw/x/HNt0WgQC8SveThg: posts small blind $0.10
aNpwfA31EREwO+ar4XzBCw: is sitting out 
gehe91e0IyVT0QU/XBkEyg: posts big blind $0.25
*** HOLE CARDS ***
aNpwfA31EREwO+ar4XzBCw leaves the table
9lvO/qyU+xrU95Teu1fv0g: raises $0.75 to $1
QEbIGci+itdw+re8RM5fZA: folds 
zDrucyjVn5aeekNEc3cJrA: folds 
zgi+EUykT/pZQpoUG6+oEg: raises $2 to $3
wGigCmBR/9XWkPpvYos3aQ: folds 
HPEB+AtKw1+C/cxU0o1ciw: folds 
vNfw/x/HNt0WgQC8SveThg: folds 
gehe91e0IyVT0QU/XBkEyg: folds 
9lvO/qyU+xrU95Teu1fv0g: calls $2
*** FLOP *** [8h Qc 2d]
9lvO/qyU+xrU95Teu1fv0g: checks 
zgi+EUykT/pZQpoUG6+oEg: bets $1.65 and is all-in
9lvO/qyU+xrU95Teu1fv0g: calls $1.65
*** TURN *** [8h Qc 2d] [8d]
*** RIVER *** [8h Qc 2d 8d] [5s]
*** SHOW DOWN ***
9lvO/qyU+xrU95Teu1fv0g: shows [As Kc] (a pair of Eights)
zgi+EUykT/pZQpoUG6+oEg: shows [Ac Ad] (two pair, Aces and Eights)
zgi+EUykT/pZQpoUG6+oEg collected $9.20 from pot
*** SUMMARY ***
Total pot $9.65 | Rake $0.45 
Board [8h Qc 2d 8d 5s]
Seat 1: 9lvO/qyU+xrU95Teu1fv0g showed [As Kc] and lost with a pair of Eights
Seat 2: QEbIGci+itdw+re8RM5fZA folded before Flop (didn't bet)
Seat 3: zDrucyjVn5aeekNEc3cJrA folded before Flop (didn't bet)
Seat 4: zgi+EUykT/pZQpoUG6+oEg showed [Ac Ad] and won ($9.20) with two pair, Aces and Eights
Seat 5: wGigCmBR/9XWkPpvYos3aQ folded before Flop (didn't bet)
Seat 6: HPEB+AtKw1+C/cxU0o1ciw (button) folded before Flop (didn't bet)
Seat 7: vNfw/x/HNt0WgQC8SveThg (small blind) folded before Flop
Seat 9: gehe91e0IyVT0QU/XBkEyg (big blind) folded before Flop




PokerStars Game #59942015210:  Hold'em No Limit ($0.10/$0.25) - 2009/07/01 1:53:23 ET
Table 'qInMnOOn7vKcj4bU7zju7g' 9-max Seat #2 is the button
Seat 1: CT7Xj/V/O5rBlhtt+RZeFQ ($38.05 in chips) 
Seat 2: HgIyqrvSG8TRRZl5mlzfHA ($71.75 in chips) 
Seat 3: zDrucyjVn5aeekNEc3cJrA ($25.55 in chips) 
Seat 4: ScCuCTbi71/EWsLKZXaZeg ($13.80 in chips) 
Seat 5: KlccfkOygm1GJZoSZYEgBw ($13.15 in chips) 
Seat 6: 4awUyiDYTgylQKXZ9faBVA ($25 in chips) 
Seat 7: st9jtdNbm1W5GfBwRaCVqQ ($24.75 in chips) 
Seat 8: Mh2r9hTeTEDnh19sRZtW3g ($11.35 in chips) 
zDrucyjVn5aeekNEc3cJrA: posts small blind $0.10
ScCuCTbi71/EWsLKZXaZeg: posts big blind $0.25
*** HOLE CARDS ***
KlccfkOygm1GJZoSZYEgBw: calls $0.25
4awUyiDYTgylQKXZ9faBVA: folds 
j4q3p0lesp63b1gZDwLBZw joins the table at seat #9 
st9jtdNbm1W5GfBwRaCVqQ: folds 
Mh2r9hTeTEDnh19sRZtW3g: folds 
CT7Xj/V/O5rBlhtt+RZeFQ: folds 
HgIyqrvSG8TRRZl5mlzfHA: folds 
zDrucyjVn5aeekNEc3cJrA: folds 
ScCuCTbi71/EWsLKZXaZeg: raises $1.75 to $2
KlccfkOygm1GJZoSZYEgBw: calls $1.75
*** FLOP *** [Ac Tc Kd]
ScCuCTbi71/EWsLKZXaZeg: bets $3
KlccfkOygm1GJZoSZYEgBw: raises $8.15 to $11.15 and is all-in
ScCuCTbi71/EWsLKZXaZeg: calls $8.15
*** TURN *** [Ac Tc Kd] [7h]
*** RIVER *** [Ac Tc Kd 7h] [Qc]
*** SHOW DOWN ***
ScCuCTbi71/EWsLKZXaZeg: shows [Ad 9s] (a pair of Aces)
KlccfkOygm1GJZoSZYEgBw: shows [Qh Ks] (two pair, Kings and Queens)
KlccfkOygm1GJZoSZYEgBw collected $25.10 from pot
*** SUMMARY ***
Total pot $26.40 | Rake $1.30 
Board [Ac Tc Kd 7h Qc]
Seat 1: CT7Xj/V/O5rBlhtt+RZeFQ folded before Flop (didn't bet)
Seat 2: HgIyqrvSG8TRRZl5mlzfHA (button) folded before Flop (didn't bet)
Seat 3: zDrucyjVn5aeekNEc3cJrA (small blind) folded before Flop
Seat 4: ScCuCTbi71/EWsLKZXaZeg (big blind) showed [Ad 9s] and lost with a pair of Aces
Seat 5: KlccfkOygm1GJZoSZYEgBw showed [Qh Ks] and won ($25.10) with two pair, Kings and Queens
Seat 6: 4awUyiDYTgylQKXZ9faBVA folded before Flop (didn't bet)
Seat 7: st9jtdNbm1W5GfBwRaCVqQ folded before Flop (didn't bet)
Seat 8: Mh2r9hTeTEDnh19sRZtW3g folded before Flop (didn't bet)




PokerStars Game #59942015500:  Hold'em No Limit ($0.10/$0.25) - 2009/07/01 1:53:23 ET
Table 'eOXPe2c6mG7DOFKvMsZZfA' 6-max Seat #2 is the button
Seat 2: gaPMxLGp9SOj4Lq6t+/0Ig ($13.30 in chips) 
Seat 3: kReyZ6g6Fu3tQ0nyjDf9kA ($23.60 in chips) 
Seat 4: zHHLkD2sRljslKKeQv/ZQw ($31.50 in chips) 
Seat 5: NhUN/JpAprdJeamFBgJH1w ($32.20 in chips) 
Seat 6: Qpv/hb5ak7LeaDig1L5L8w ($13.35 in chips) 
kReyZ6g6Fu3tQ0nyjDf9kA: posts small blind $0.10
zHHLkD2sRljslKKeQv/ZQw: posts big blind $0.25
*** HOLE CARDS ***
NhUN/JpAprdJeamFBgJH1w: folds 
Qpv/hb5ak7LeaDig1L5L8w: folds 
gaPMxLGp9SOj4Lq6t+/0Ig: folds 
kReyZ6g6Fu3tQ0nyjDf9kA: calls $0.15
zHHLkD2sRljslKKeQv/ZQw: checks 
*** FLOP *** [7c 3d Tc]
kReyZ6g6Fu3tQ0nyjDf9kA: checks 
zHHLkD2sRljslKKeQv/ZQw: checks 
*** TURN *** [7c 3d Tc] [8d]
kReyZ6g6Fu3tQ0nyjDf9kA: checks 
zHHLkD2sRljslKKeQv/ZQw: checks 
*** RIVER *** [7c 3d Tc 8d] [Th]
kReyZ6g6Fu3tQ0nyjDf9kA: checks 
zHHLkD2sRljslKKeQv/ZQw: checks 
*** SHOW DOWN ***
kReyZ6g6Fu3tQ0nyjDf9kA: shows [Qh 2h] (a pair of Tens)
zHHLkD2sRljslKKeQv/ZQw: shows [Ks 5d] (a pair of Tens - King kicker)
zHHLkD2sRljslKKeQv/ZQw collected $0.50 from pot
*** SUMMARY ***
Total pot $0.50 | Rake $0 
Board [7c 3d Tc 8d Th]
Seat 2: gaPMxLGp9SOj4Lq6t+/0Ig (button) folded before Flop (didn't bet)
Seat 3: kReyZ6g6Fu3tQ0nyjDf9kA (small blind) showed [Qh 2h] and lost with a pair of Tens
Seat 4: zHHLkD2sRljslKKeQv/ZQw (big blind) showed [Ks 5d] and won ($0.50) with a pair of Tens
Seat 5: NhUN/JpAprdJeamFBgJH1w folded before Flop (didn't bet)
Seat 6: Qpv/hb5ak7LeaDig1L5L8w folded before Flop (didn't bet)




PokerStars Game #59942015072:  Hold'em No Limit ($0.10/$0.25) - 2009/07/01 1:53:23 ET
Table 'NtEQAxCeIK2io1CGtW658g' 6-max Seat #4 is the button
Seat 2: DgyznDqq/mLiCqQGMzc+Aw ($8.05 in chips) 
Seat 3: 5nwDw10uIM0XEyLhla0oGA ($36.60 in chips) 
Seat 4: 8296 ($16.10 in chips) 
Seat 5: MgAtgQuaEEshtfbhCfs+bA ($14.25 in chips) 
Seat 6: /gJNBeCkWL4o85/jvlZ4BA ($71.05 in chips) 
MgAtgQuaEEshtfbhCfs+bA: posts small blind $0.10
/gJNBeCkWL4o85/jvlZ4BA: posts big blind $0.25
*** HOLE CARDS ***
DgyznDqq/mLiCqQGMzc+Aw: folds 
5nwDw10uIM0XEyLhla0oGA: raises $0.25 to $0.50
8296: folds 
MgAtgQuaEEshtfbhCfs+bA: folds 
/gJNBeCkWL4o85/jvlZ4BA: calls $0.25
*** FLOP *** [Qh Qd 9c]
/gJNBeCkWL4o85/jvlZ4BA: checks 
5nwDw10uIM0XEyLhla0oGA: bets $0.75
/gJNBeCkWL4o85/jvlZ4BA: folds 
Uncalled bet ($0.75) returned to 5nwDw10uIM0XEyLhla0oGA
5nwDw10uIM0XEyLhla0oGA collected $1.05 from pot
*** SUMMARY ***
Total pot $1.10 | Rake $0.05 
Board [Qh Qd 9c]
Seat 2: DgyznDqq/mLiCqQGMzc+Aw folded before Flop (didn't bet)
Seat 3: 5nwDw10uIM0XEyLhla0oGA collected ($1.05)
Seat 4: 8296 (button) folded before Flop (didn't bet)
Seat 5: MgAtgQuaEEshtfbhCfs+bA (small blind) folded before Flop
Seat 6: /gJNBeCkWL4o85/jvlZ4BA (big blind) folded on the Flop




PokerStars Game #59942015980:  Hold'em No Limit ($0.10/$0.25) - 2009/07/01 1:53:24 ET
Table 'vud0GB/ZlDCvUFhBFIaTlg' 9-max Seat #2 is the button
Seat 1: DiSvPC2iudwL5j9u6Huyww ($29.15 in chips) 
Seat 2: tLcDklc2rBORNfixyRfVfw ($25.35 in chips) 
Seat 3: W2YYHvqjaEpRrO7stZkClQ ($4.80 in chips) 
Seat 4: JqeaikMej6KsqTKmUhl2Lw ($25 in chips) 
Seat 5: PFv56Q1PTkDC084eXIAYmw ($5.35 in chips) 
Seat 6: gehe91e0IyVT0QU/XBkEyg ($24.90 in chips) 
Seat 7: iG7VeTyBWf6wYNvZpbTcbw ($22.15 in chips) 
Seat 8: E0iYnEVO2ho7dH3QcCjw7g ($19.25 in chips) 
Seat 9: PdIasPkzm2sqZnN41ZRXOg ($5.45 in chips) 
W2YYHvqjaEpRrO7stZkClQ: posts small blind $0.10
JqeaikMej6KsqTKmUhl2Lw: posts big blind $0.25
*** HOLE CARDS ***
PFv56Q1PTkDC084eXIAYmw: folds 
gehe91e0IyVT0QU/XBkEyg: folds 
iG7VeTyBWf6wYNvZpbTcbw: folds 
E0iYnEVO2ho7dH3QcCjw7g: folds 
PdIasPkzm2sqZnN41ZRXOg: folds 
DiSvPC2iudwL5j9u6Huyww: folds 
tLcDklc2rBORNfixyRfVfw: folds 
W2YYHvqjaEpRrO7stZkClQ: folds 
Uncalled bet ($0.15) returned to JqeaikMej6KsqTKmUhl2Lw
JqeaikMej6KsqTKmUhl2Lw collected $0.20 from pot
JqeaikMej6KsqTKmUhl2Lw: doesn't show hand 
*** SUMMARY ***
Total pot $0.20 | Rake $0 
Seat 1: DiSvPC2iudwL5j9u6Huyww folded before Flop (didn't bet)
Seat 2: tLcDklc2rBORNfixyRfVfw (button) folded before Flop (didn't bet)
Seat 3: W2YYHvqjaEpRrO7stZkClQ (small blind) folded before Flop
Seat 4: JqeaikMej6KsqTKmUhl2Lw (big blind) collected ($0.20)
Seat 5: PFv56Q1PTkDC084eXIAYmw folded before Flop (didn't bet)
Seat 6: gehe91e0IyVT0QU/XBkEyg folded before Flop (didn't bet)
Seat 7: iG7VeTyBWf6wYNvZpbTcbw folded before Flop (didn't bet)
Seat 8: E0iYnEVO2ho7dH3QcCjw7g folded before Flop (didn't bet)
Seat 9: PdIasPkzm2sqZnN41ZRXOg folded before Flop (didn't bet)




PokerStars Game #59942015992:  Hold'em No Limit ($0.10/$0.25) - 2009/07/01 1:53:24 ET
Table 'x7YStLKc8hpt/pTgSetPKA' 9-max Seat #5 is the button
Seat 2: z5GxcHlYz/GSz6W2uFiTtg ($19.75 in chips) 
Seat 3: S7Ki0P+0AIGPuIfGJjW0gg ($10 in chips) 
Seat 5: tLcDklc2rBORNfixyRfVfw ($25 in chips) 
Seat 6: 9YN2IkT2JYYKFErZtZvCtA ($50.40 in chips) 
Seat 7: dtZ84flFEi4Q+SGrHMJRDQ ($25 in chips) 
Seat 8: j4q3p0lesp63b1gZDwLBZw ($5.50 in chips) 
Seat 9: nm4Dj/f+jJEwKVsUnKh73g ($37.55 in chips) 
9YN2IkT2JYYKFErZtZvCtA: posts small blind $0.10
dtZ84flFEi4Q+SGrHMJRDQ: posts big blind $0.25
satchmoiluvu: sits out 
*** HOLE CARDS ***
j4q3p0lesp63b1gZDwLBZw: folds 
nm4Dj/f+jJEwKVsUnKh73g: calls $0.25
z5GxcHlYz/GSz6W2uFiTtg: calls $0.25
S7Ki0P+0AIGPuIfGJjW0gg: folds 
tLcDklc2rBORNfixyRfVfw: folds 
9YN2IkT2JYYKFErZtZvCtA: calls $0.15
dtZ84flFEi4Q+SGrHMJRDQ: checks 
*** FLOP *** [8h 5d 6c]
9YN2IkT2JYYKFErZtZvCtA: checks 
dtZ84flFEi4Q+SGrHMJRDQ: checks 
nm4Dj/f+jJEwKVsUnKh73g: checks 
z5GxcHlYz/GSz6W2uFiTtg: bets $0.50
9YN2IkT2JYYKFErZtZvCtA: calls $0.50
dtZ84flFEi4Q+SGrHMJRDQ: folds 
nm4Dj/f+jJEwKVsUnKh73g: folds 
*** TURN *** [8h 5d 6c] [4s]
9YN2IkT2JYYKFErZtZvCtA: checks 
z5GxcHlYz/GSz6W2uFiTtg: checks 
*** RIVER *** [8h 5d 6c 4s] [Qc]
9YN2IkT2JYYKFErZtZvCtA: bets $1
nm4Dj/f+jJEwKVsUnKh73g is sitting out
z5GxcHlYz/GSz6W2uFiTtg: folds 
Uncalled bet ($1) returned to 9YN2IkT2JYYKFErZtZvCtA
9YN2IkT2JYYKFErZtZvCtA collected $1.95 from pot
9YN2IkT2JYYKFErZtZvCtA: doesn't show hand 
*** SUMMARY ***
Total pot $2 | Rake $0.05 
Board [8h 5d 6c 4s Qc]
Seat 2: z5GxcHlYz/GSz6W2uFiTtg folded on the River
Seat 3: S7Ki0P+0AIGPuIfGJjW0gg folded before Flop (didn't bet)
Seat 5: tLcDklc2rBORNfixyRfVfw (button) folded before Flop (didn't bet)
Seat 6: 9YN2IkT2JYYKFErZtZvCtA (small blind) collected ($1.95)
Seat 7: dtZ84flFEi4Q+SGrHMJRDQ (big blind) folded on the Flop
Seat 8: j4q3p0lesp63b1gZDwLBZw folded before Flop (didn't bet)
Seat 9: nm4Dj/f+jJEwKVsUnKh73g folded on the Flop




PokerStars Game #59942015620:  Hold'em No Limit ($0.10/$0.25) - 2009/07/01 1:53:24 ET
Table 'nlpa8xI95gAflovnFxB2yg' 6-max Seat #2 is the button
Seat 1: fZQg9veL7Dd/Z04ZTjC+wQ ($62.20 in chips) 
Seat 2: Yuyy/pDz3yAO3EbHYRYnKw ($23.20 in chips) 
Seat 3: DihMHaz4WNETH1bPDe13kA ($25.25 in chips) 
Seat 4: if4dh6jhJXeN3/qd3qCp9g ($52 in chips) 
Seat 5: pSneaCslVpgO8mzi5yQMww ($7.50 in chips) 
Seat 6: ATNFxN8fYVfSZMQW8dvbvw ($9.40 in chips) 
DihMHaz4WNETH1bPDe13kA: posts small blind $0.10
if4dh6jhJXeN3/qd3qCp9g: posts big blind $0.25
*** HOLE CARDS ***
pSneaCslVpgO8mzi5yQMww: folds 
ATNFxN8fYVfSZMQW8dvbvw: raises $0.50 to $0.75
fZQg9veL7Dd/Z04ZTjC+wQ: folds 
Yuyy/pDz3yAO3EbHYRYnKw: folds 
DihMHaz4WNETH1bPDe13kA: folds 
if4dh6jhJXeN3/qd3qCp9g: folds 
Uncalled bet ($0.50) returned to ATNFxN8fYVfSZMQW8dvbvw
ATNFxN8fYVfSZMQW8dvbvw collected $0.60 from pot
ATNFxN8fYVfSZMQW8dvbvw: doesn't show hand 
*** SUMMARY ***
Total pot $0.60 | Rake $0 
Seat 1: fZQg9veL7Dd/Z04ZTjC+wQ folded before Flop (didn't bet)
Seat 2: Yuyy/pDz3yAO3EbHYRYnKw (button) folded before Flop (didn't bet)
Seat 3: DihMHaz4WNETH1bPDe13kA (small blind) folded before Flop
Seat 4: if4dh6jhJXeN3/qd3qCp9g (big blind) folded before Flop
Seat 5: pSneaCslVpgO8mzi5yQMww folded before Flop (didn't bet)
Seat 6: ATNFxN8fYVfSZMQW8dvbvw collected ($0.60)




PokerStars Game #59942015690:  Hold'em No Limit ($0.10/$0.25) - 2009/07/01 1:53:24 ET
Table 'vZfV/Uj0q8joA1du9sRJSg' 6-max Seat #1 is the button
Seat 1: MVzl6OsGybVDNd3Vr9LYAA ($25.45 in chips) 
Seat 2: wMiE3yTbDJGOLOF9th7KPA ($11.25 in chips) 
Seat 3: cWc85bEzdRzpUMhRKm8pwQ ($25 in chips) 
Seat 4: v+QfkGiuj9bgtuNoVnDO8w ($44.40 in chips) 
Seat 5: kyRaCIljYA6l33lSKQfNsg ($28.95 in chips) 
Seat 6: 8ClCHtFXGNplITm+63KB+Q ($47.35 in chips) 
wMiE3yTbDJGOLOF9th7KPA: posts small blind $0.10
cWc85bEzdRzpUMhRKm8pwQ: posts big blind $0.25
*** HOLE CARDS ***
v+QfkGiuj9bgtuNoVnDO8w: folds 
kyRaCIljYA6l33lSKQfNsg: folds 
8ClCHtFXGNplITm+63KB+Q: folds 
MVzl6OsGybVDNd3Vr9LYAA: raises $0.50 to $0.75
wMiE3yTbDJGOLOF9th7KPA: calls $0.65
cWc85bEzdRzpUMhRKm8pwQ: folds 
*** FLOP *** [3d Qd Qh]
wMiE3yTbDJGOLOF9th7KPA: bets $0.25
v+QfkGiuj9bgtuNoVnDO8w is sitting out
MVzl6OsGybVDNd3Vr9LYAA: raises $1 to $1.25
wMiE3yTbDJGOLOF9th7KPA: folds 
Uncalled bet ($1) returned to MVzl6OsGybVDNd3Vr9LYAA
MVzl6OsGybVDNd3Vr9LYAA collected $2.15 from pot
MVzl6OsGybVDNd3Vr9LYAA: doesn't show hand 
*** SUMMARY ***
Total pot $2.25 | Rake $0.10 
Board [3d Qd Qh]
Seat 1: MVzl6OsGybVDNd3Vr9LYAA (button) collected ($2.15)
Seat 2: wMiE3yTbDJGOLOF9th7KPA (small blind) folded on the Flop
Seat 3: cWc85bEzdRzpUMhRKm8pwQ (big blind) folded before Flop
Seat 4: v+QfkGiuj9bgtuNoVnDO8w folded before Flop (didn't bet)
Seat 5: kyRaCIljYA6l33lSKQfNsg folded before Flop (didn't bet)
Seat 6: 8ClCHtFXGNplITm+63KB+Q folded before Flop (didn't bet)




PokerStars Game #59942016572:  Hold'em No Limit ($0.10/$0.25) - 2009/07/01 1:53:25 ET
Table '9iHhO6FyZVM8XpSc23TIgg' 6-max Seat #5 is the button
Seat 1: wvIIdlbCgePONQwXjx9xzQ ($5 in chips) 
Seat 2: bJFzs6QmEEnz4miMfSDtcg ($20.25 in chips) 
Seat 3: TSmua8tGK3sTbwi0ynrW9Q ($40.50 in chips) 
Seat 4: cfJccEfyn6IkquPN08hFsA ($26 in chips) 
Seat 5: OMGl+YMGogf2JWIRfT2/Yg ($9.40 in chips) 
Seat 6: iyZxqznXjv3vtvOJymkoLQ ($33.60 in chips) 
iyZxqznXjv3vtvOJymkoLQ: posts small blind $0.10
wvIIdlbCgePONQwXjx9xzQ: posts big blind $0.25
*** HOLE CARDS ***
bJFzs6QmEEnz4miMfSDtcg: folds 
bJFzs6QmEEnz4miMfSDtcg is sitting out
bJFzs6QmEEnz4miMfSDtcg leaves the table
TSmua8tGK3sTbwi0ynrW9Q: folds 
cfJccEfyn6IkquPN08hFsA: raises $0.75 to $1
OMGl+YMGogf2JWIRfT2/Yg: folds 
iyZxqznXjv3vtvOJymkoLQ: folds 
wvIIdlbCgePONQwXjx9xzQ: folds 
Uncalled bet ($0.75) returned to cfJccEfyn6IkquPN08hFsA
cfJccEfyn6IkquPN08hFsA collected $0.60 from pot
cfJccEfyn6IkquPN08hFsA: doesn't show hand 
*** SUMMARY ***
Total pot $0.60 | Rake $0 
Seat 1: wvIIdlbCgePONQwXjx9xzQ (big blind) folded before Flop
Seat 2: bJFzs6QmEEnz4miMfSDtcg folded before Flop (didn't bet)
Seat 3: TSmua8tGK3sTbwi0ynrW9Q folded before Flop (didn't bet)
Seat 4: cfJccEfyn6IkquPN08hFsA collected ($0.60)
Seat 5: OMGl+YMGogf2JWIRfT2/Yg (button) folded before Flop (didn't bet)
Seat 6: iyZxqznXjv3vtvOJymkoLQ (small blind) folded before Flop




PokerStars Game #59942016178:  Hold'em No Limit ($0.10/$0.25) - 2009/07/01 1:53:25 ET
Table 'NfXsh0UQA+o/kO9acV3WxA' 9-max Seat #6 is the button
Seat 1: pN3IHvAKm2fz+sTRARTcrg ($25 in chips) 
Seat 2: mhpFs2SZupy4zLRb62FLFA ($24.65 in chips) 
Seat 3: wCUaomJ6Nq5zomVGdUHP+w ($20 in chips) 
Seat 4: r6hsffOo1iKmaPYKwAZmFw ($30.40 in chips) 
Seat 5: zgi+EUykT/pZQpoUG6+oEg ($4.30 in chips) 
Seat 6: qwr38jl5txoR36M7G5qi4A ($10 in chips) 
Seat 7: yqkowiRWZ6NvRN9UUkYIlA ($5 in chips) 
Seat 8: +sbyWwIcFp9kP0bDtMegfQ ($40.60 in chips) 
Seat 9: uhrboV251dcgYniYTdFIcA ($29.45 in chips) 
yqkowiRWZ6NvRN9UUkYIlA: posts small blind $0.10
+sbyWwIcFp9kP0bDtMegfQ: posts big blind $0.25
*** HOLE CARDS ***
uhrboV251dcgYniYTdFIcA: folds 
pN3IHvAKm2fz+sTRARTcrg: folds 
mhpFs2SZupy4zLRb62FLFA: folds 
wCUaomJ6Nq5zomVGdUHP+w: folds 
r6hsffOo1iKmaPYKwAZmFw: folds 
zgi+EUykT/pZQpoUG6+oEg: folds 
qwr38jl5txoR36M7G5qi4A: folds 
yqkowiRWZ6NvRN9UUkYIlA: raises $0.50 to $0.75
+sbyWwIcFp9kP0bDtMegfQ: calls $0.50
*** FLOP *** [3h Jh 8d]
yqkowiRWZ6NvRN9UUkYIlA: checks 
+sbyWwIcFp9kP0bDtMegfQ: checks 
*** TURN *** [3h Jh 8d] [Jc]
yqkowiRWZ6NvRN9UUkYIlA: checks 
+sbyWwIcFp9kP0bDtMegfQ: checks 
*** RIVER *** [3h Jh 8d Jc] [7s]
yqkowiRWZ6NvRN9UUkYIlA: checks 
+sbyWwIcFp9kP0bDtMegfQ: checks 
*** SHOW DOWN ***
yqkowiRWZ6NvRN9UUkYIlA: shows [6d Th] (a pair of Jacks)
+sbyWwIcFp9kP0bDtMegfQ: shows [Ac Qd] (a pair of Jacks - Ace kicker)
+sbyWwIcFp9kP0bDtMegfQ collected $1.45 from pot
*** SUMMARY ***
Total pot $1.50 | Rake $0.05 
Board [3h Jh 8d Jc 7s]
Seat 1: pN3IHvAKm2fz+sTRARTcrg folded before Flop (didn't bet)
Seat 2: mhpFs2SZupy4zLRb62FLFA folded before Flop (didn't bet)
Seat 3: wCUaomJ6Nq5zomVGdUHP+w folded before Flop (didn't bet)
Seat 4: r6hsffOo1iKmaPYKwAZmFw folded before Flop (didn't bet)
Seat 5: zgi+EUykT/pZQpoUG6+oEg folded before Flop (didn't bet)
Seat 6: qwr38jl5txoR36M7G5qi4A (button) folded before Flop (didn't bet)
Seat 7: yqkowiRWZ6NvRN9UUkYIlA (small blind) showed [6d Th] and lost with a pair of Jacks
Seat 8: +sbyWwIcFp9kP0bDtMegfQ (big blind) showed [Ac Qd] and won ($1.45) with a pair of Jacks
Seat 9: uhrboV251dcgYniYTdFIcA folded before Flop (didn't bet)




PokerStars Game #59942016188:  Hold'em No Limit ($0.10/$0.25) - 2009/07/01 1:53:25 ET
Table '8Z6T3ssCpo3VV849U4RgBw' 9-max Seat #7 is the button
Seat 1: Z9W7+g1WMhhZDi7DwGbCFA ($6.75 in chips) 
Seat 2: SpiiQQAzy4MUgV3I5W8giw ($19.10 in chips) 
Seat 3: tLcDklc2rBORNfixyRfVfw ($39.90 in chips) 
Seat 4: RCqMONFrSPSArZh2Jsar/w ($15.90 in chips) 
Seat 5: zDrucyjVn5aeekNEc3cJrA ($15.65 in chips) 
Seat 6: 4qA/3Ajg3pP6fqW+IX9/fQ ($4.65 in chips) 
Seat 7: oLa/tXLfSLLB28mcLGrxcg ($24.50 in chips) 
Seat 8: PdIasPkzm2sqZnN41ZRXOg ($5 in chips) 
Seat 9: HDDm1BkZtdsRyw2DJdqq6A ($32.15 in chips) 
PdIasPkzm2sqZnN41ZRXOg: posts small blind $0.10
HDDm1BkZtdsRyw2DJdqq6A: posts big blind $0.25
*** HOLE CARDS ***
Z9W7+g1WMhhZDi7DwGbCFA: folds 
SpiiQQAzy4MUgV3I5W8giw: folds 
tLcDklc2rBORNfixyRfVfw: folds 
RCqMONFrSPSArZh2Jsar/w: folds 
zDrucyjVn5aeekNEc3cJrA: calls $0.25
4qA/3Ajg3pP6fqW+IX9/fQ: raises $4.40 to $4.65 and is all-in
oLa/tXLfSLLB28mcLGrxcg: folds 
PdIasPkzm2sqZnN41ZRXOg: folds 
HDDm1BkZtdsRyw2DJdqq6A: folds 
zDrucyjVn5aeekNEc3cJrA: folds 
Uncalled bet ($4.40) returned to 4qA/3Ajg3pP6fqW+IX9/fQ
4qA/3Ajg3pP6fqW+IX9/fQ collected $0.85 from pot
4qA/3Ajg3pP6fqW+IX9/fQ: doesn't show hand 
*** SUMMARY ***
Total pot $0.85 | Rake $0 
Seat 1: Z9W7+g1WMhhZDi7DwGbCFA folded before Flop (didn't bet)
Seat 2: SpiiQQAzy4MUgV3I5W8giw folded before Flop (didn't bet)
Seat 3: tLcDklc2rBORNfixyRfVfw folded before Flop (didn't bet)
Seat 4: RCqMONFrSPSArZh2Jsar/w folded before Flop (didn't bet)
Seat 5: zDrucyjVn5aeekNEc3cJrA folded before Flop
Seat 6: 4qA/3Ajg3pP6fqW+IX9/fQ collected ($0.85)
Seat 7: oLa/tXLfSLLB28mcLGrxcg (button) folded before Flop (didn't bet)
Seat 8: PdIasPkzm2sqZnN41ZRXOg (small blind) folded before Flop
Seat 9: HDDm1BkZtdsRyw2DJdqq6A (big blind) folded before Flop




PokerStars Game #59942016138:  Hold'em No Limit ($0.10/$0.25) - 2009/07/01 1:53:25 ET
Table 'FBhJjLqab11/gKu8nyB/tw' 9-max Seat #7 is the button
Seat 1: +sbyWwIcFp9kP0bDtMegfQ ($18.30 in chips) 
Seat 3: V6p0jQ/RhUsqpHLmXvEX4Q ($12.35 in chips) 
Seat 4: CvL9Ch1HYCVbTsfpNucitg ($5.15 in chips) 
Seat 5: Mh2r9hTeTEDnh19sRZtW3g ($5.35 in chips) 
Seat 6: cZ99hugmLBj9KhTlc8nCSw ($31.35 in chips) 
Seat 7: CT7Xj/V/O5rBlhtt+RZeFQ ($25.25 in chips) 
Seat 8: Th3FldXKQW6hWVVPahaoOQ ($26.75 in chips) 
Seat 9: H5Se03ZqSX7tbULXur2MAg ($25 in chips) 
Th3FldXKQW6hWVVPahaoOQ: posts small blind $0.10
H5Se03ZqSX7tbULXur2MAg: posts big blind $0.25
18G4P1XstjNvItdGUITxgw: sits out 
*** HOLE CARDS ***
+sbyWwIcFp9kP0bDtMegfQ: folds 
V6p0jQ/RhUsqpHLmXvEX4Q: folds 
CvL9Ch1HYCVbTsfpNucitg: folds 
Mh2r9hTeTEDnh19sRZtW3g: folds 
cZ99hugmLBj9KhTlc8nCSw: folds 
CT7Xj/V/O5rBlhtt+RZeFQ: folds 
Th3FldXKQW6hWVVPahaoOQ: folds 
Uncalled bet ($0.15) returned to H5Se03ZqSX7tbULXur2MAg
H5Se03ZqSX7tbULXur2MAg collected $0.20 from pot
*** SUMMARY ***
Total pot $0.20 | Rake $0 
Seat 1: +sbyWwIcFp9kP0bDtMegfQ folded before Flop (didn't bet)
Seat 3: V6p0jQ/RhUsqpHLmXvEX4Q folded before Flop (didn't bet)
Seat 4: CvL9Ch1HYCVbTsfpNucitg folded before Flop (didn't bet)
Seat 5: Mh2r9hTeTEDnh19sRZtW3g folded before Flop (didn't bet)
Seat 6: cZ99hugmLBj9KhTlc8nCSw folded before Flop (didn't bet)
Seat 7: CT7Xj/V/O5rBlhtt+RZeFQ (button) folded before Flop (didn't bet)
Seat 8: Th3FldXKQW6hWVVPahaoOQ (small blind) folded before Flop
Seat 9: H5Se03ZqSX7tbULXur2MAg (big blind) collected ($0.20)




PokerStars Game #59942017104:  Hold'em No Limit ($0.10/$0.25) - 2009/07/01 1:53:26 ET
Table 'TJS4XvvOjO3k7mH74HJw5g' 9-max Seat #7 is the button
Seat 1: K8I2mpRME07ZlOsT2x75Lg ($6.80 in chips) 
Seat 2: yqkowiRWZ6NvRN9UUkYIlA ($8.60 in chips) 
Seat 3: 8EbrQ/EvFWt2cr0GaU82gQ ($5 in chips) 
Seat 4: clJsV3v77RS07bDKY+705w ($5 in chips) 
Seat 5: UlMB386Cfzy3EwurQoBjcA ($7.35 in chips) 
Seat 6: 3PmVnC/15cl4oyI1TKIt4g ($4.65 in chips) 
Seat 7: B9u+i1s5aZZkmLTLUopTBg ($17.55 in chips) 
Seat 9: +sbyWwIcFp9kP0bDtMegfQ ($44.20 in chips) 
Savonys will be allowed to play after the button
+sbyWwIcFp9kP0bDtMegfQ: posts small blind $0.10
K8I2mpRME07ZlOsT2x75Lg: posts big blind $0.25
*** HOLE CARDS ***
yqkowiRWZ6NvRN9UUkYIlA: folds 
8EbrQ/EvFWt2cr0GaU82gQ: folds 
clJsV3v77RS07bDKY+705w: folds 
UlMB386Cfzy3EwurQoBjcA: raises $0.50 to $0.75
3PmVnC/15cl4oyI1TKIt4g: folds 
B9u+i1s5aZZkmLTLUopTBg: calls $0.75
+sbyWwIcFp9kP0bDtMegfQ: folds 
K8I2mpRME07ZlOsT2x75Lg: folds 
*** FLOP *** [9s Tc 2h]
UlMB386Cfzy3EwurQoBjcA: bets $1
B9u+i1s5aZZkmLTLUopTBg: folds 
Uncalled bet ($1) returned to UlMB386Cfzy3EwurQoBjcA
UlMB386Cfzy3EwurQoBjcA collected $1.80 from pot
UlMB386Cfzy3EwurQoBjcA: doesn't show hand 
*** SUMMARY ***
Total pot $1.85 | Rake $0.05 
Board [9s Tc 2h]
Seat 1: K8I2mpRME07ZlOsT2x75Lg (big blind) folded before Flop
Seat 2: yqkowiRWZ6NvRN9UUkYIlA folded before Flop (didn't bet)
Seat 3: 8EbrQ/EvFWt2cr0GaU82gQ folded before Flop (didn't bet)
Seat 4: clJsV3v77RS07bDKY+705w folded before Flop (didn't bet)
Seat 5: UlMB386Cfzy3EwurQoBjcA collected ($1.80)
Seat 6: 3PmVnC/15cl4oyI1TKIt4g folded before Flop (didn't bet)
Seat 7: B9u+i1s5aZZkmLTLUopTBg (button) folded on the Flop
Seat 9: +sbyWwIcFp9kP0bDtMegfQ (small blind) folded before Flop




PokerStars Game #59942017100:  Hold'em No Limit ($0.10/$0.25) - 2009/07/01 1:53:26 ET
Table '/Xx5AsbRD4oNGMTFFC/92Q' 6-max Seat #4 is the button
Seat 1: gVYXlD41OO0ybr835GAnsQ ($7.25 in chips) 
Seat 2: N/zeVku/lNn+kUQejwmLpg ($10.45 in chips) 
Seat 4: 7/ROHX4tuLekJ2diYIlMkw ($2.15 in chips) 
Seat 5: kMa8BltUcBQVxnHfqdCfXg ($4.25 in chips) 
Seat 6: p4A+KsSkRO/5I6h0o4VQDQ ($3.90 in chips) 
kMa8BltUcBQVxnHfqdCfXg: posts small blind $0.10
p4A+KsSkRO/5I6h0o4VQDQ: posts big blind $0.25
*** HOLE CARDS ***
gVYXlD41OO0ybr835GAnsQ: folds 
N/zeVku/lNn+kUQejwmLpg: folds 
7/ROHX4tuLekJ2diYIlMkw: raises $1.90 to $2.15 and is all-in
N/zeVku/lNn+kUQejwmLpg leaves the table
kMa8BltUcBQVxnHfqdCfXg: folds 
p4A+KsSkRO/5I6h0o4VQDQ: folds 
Uncalled bet ($1.90) returned to 7/ROHX4tuLekJ2diYIlMkw
7/ROHX4tuLekJ2diYIlMkw collected $0.60 from pot
*** SUMMARY ***
Total pot $0.60 | Rake $0 
Seat 1: gVYXlD41OO0ybr835GAnsQ folded before Flop (didn't bet)
Seat 2: N/zeVku/lNn+kUQejwmLpg folded before Flop (didn't bet)
Seat 4: 7/ROHX4tuLekJ2diYIlMkw (button) collected ($0.60)
Seat 5: kMa8BltUcBQVxnHfqdCfXg (small blind) folded before Flop
Seat 6: p4A+KsSkRO/5I6h0o4VQDQ (big blind) folded before Flop




PokerStars Game #59942016648:  Hold'em No Limit ($0.10/$0.25) - 2009/07/01 1:53:26 ET
Table 'S6s+TmTlAjLHclBRvN5/fw' 9-max Seat #4 is the button
Seat 2: 9V5ShhobeDoA6n0goHTukw ($10 in chips) 
Seat 3: z2SmIaQ3+5n/eY1BN5HgPg ($12.50 in chips) 
Seat 4: RSal7+azPhXeqQO5L8XPfg ($18.85 in chips) 
Seat 6: QkBggokTsSaL9vRv6V8nzQ ($11.20 in chips) 
QkBggokTsSaL9vRv6V8nzQ: posts small blind $0.10
9V5ShhobeDoA6n0goHTukw: posts big blind $0.25
*** HOLE CARDS ***
z2SmIaQ3+5n/eY1BN5HgPg said, "lol\\\\"
z2SmIaQ3+5n/eY1BN5HgPg: folds 
RSal7+azPhXeqQO5L8XPfg: raises $0.75 to $1
QkBggokTsSaL9vRv6V8nzQ: calls $0.90
9V5ShhobeDoA6n0goHTukw: calls $0.75
*** FLOP *** [5d 8d 3s]
8hSJOE8UscCqt6t47gp0/g leaves the table
QkBggokTsSaL9vRv6V8nzQ: checks 
9V5ShhobeDoA6n0goHTukw: bets $1
RSal7+azPhXeqQO5L8XPfg: raises $2 to $3
QkBggokTsSaL9vRv6V8nzQ: folds 
9V5ShhobeDoA6n0goHTukw: folds 
Uncalled bet ($2) returned to RSal7+azPhXeqQO5L8XPfg
RSal7+azPhXeqQO5L8XPfg collected $4.80 from pot
*** SUMMARY ***
Total pot $5 | Rake $0.20 
Board [5d 8d 3s]
Seat 2: 9V5ShhobeDoA6n0goHTukw (big blind) folded on the Flop
Seat 3: z2SmIaQ3+5n/eY1BN5HgPg folded before Flop (didn't bet)
Seat 4: RSal7+azPhXeqQO5L8XPfg (button) collected ($4.80)
Seat 6: QkBggokTsSaL9vRv6V8nzQ (small blind) folded on the Flop




PokerStars Game #59942016814:  Hold'em No Limit ($0.10/$0.25) - 2009/07/01 1:53:26 ET
Table 'wixGE3Zge1qBdnpWijIl/w' 9-max Seat #4 is the button
Seat 1: 4GJMmHGKzu+gVtalqRy7dA ($27.20 in chips) 
Seat 2: DnDcAdn9P0zGovMERigpFA ($77.25 in chips) 
Seat 3: Bb42QRQMhg5/Y0vHP8/2Xw ($25 in chips) 
Seat 4: X6+pSIPfovPcE87t+LmUKQ ($7 in chips) 
Seat 5: H5Se03ZqSX7tbULXur2MAg ($22.80 in chips) 
Seat 6: AP/rNvbsacTb4XtaAgKPiQ ($13.20 in chips) 
Seat 7: mMd8CDS/but3UC+Zp7Up2w ($21.70 in chips) 
Seat 8: ShCS62CJp4MKfKLKvGKQbA ($14.55 in chips) 
Seat 9: r6hsffOo1iKmaPYKwAZmFw ($28.80 in chips) 
H5Se03ZqSX7tbULXur2MAg: posts small blind $0.10
AP/rNvbsacTb4XtaAgKPiQ: posts big blind $0.25
*** HOLE CARDS ***
mMd8CDS/but3UC+Zp7Up2w: folds 
ShCS62CJp4MKfKLKvGKQbA: folds 
r6hsffOo1iKmaPYKwAZmFw: folds 
4GJMmHGKzu+gVtalqRy7dA: folds 
DnDcAdn9P0zGovMERigpFA: folds 
Bb42QRQMhg5/Y0vHP8/2Xw: folds 
X6+pSIPfovPcE87t+LmUKQ: folds 
H5Se03ZqSX7tbULXur2MAg: folds 
Uncalled bet ($0.15) returned to AP/rNvbsacTb4XtaAgKPiQ
AP/rNvbsacTb4XtaAgKPiQ collected $0.20 from pot
AP/rNvbsacTb4XtaAgKPiQ: doesn't show hand 
*** SUMMARY ***
Total pot $0.20 | Rake $0 
Seat 1: 4GJMmHGKzu+gVtalqRy7dA folded before Flop (didn't bet)
Seat 2: DnDcAdn9P0zGovMERigpFA folded before Flop (didn't bet)
Seat 3: Bb42QRQMhg5/Y0vHP8/2Xw folded before Flop (didn't bet)
Seat 4: X6+pSIPfovPcE87t+LmUKQ (button) folded before Flop (didn't bet)
Seat 5: H5Se03ZqSX7tbULXur2MAg (small blind) folded before Flop
Seat 6: AP/rNvbsacTb4XtaAgKPiQ (big blind) collected ($0.20)
Seat 7: mMd8CDS/but3UC+Zp7Up2w folded before Flop (didn't bet)
Seat 8: ShCS62CJp4MKfKLKvGKQbA folded before Flop (didn't bet)
Seat 9: r6hsffOo1iKmaPYKwAZmFw folded before Flop (didn't bet)




PokerStars Game #59942016616:  Hold'em No Limit ($0.10/$0.25) - 2009/07/01 1:53:26 ET
Table 'pAhiNHs/spaABQia+7gWNQ' 9-max Seat #3 is the button
Seat 1: ipgcO7Pa6LC8XWpVttZfnA ($4.65 in chips) 
Seat 2: dfNim92Z6XK1/h5SFW5vDg ($25 in chips) 
Seat 3: bXpVeaSTPBFSPJmeXxO7nw ($4.65 in chips) 
Seat 4: Qduu7ikeizo6q6Ei9YvcJA ($47.10 in chips) 
Seat 5: OlPJsgR4xypSg/w1z7Gyvw ($34.60 in chips) 
Seat 6: oLa/tXLfSLLB28mcLGrxcg ($24.25 in chips) 
Seat 7: +WTkVY3GeLxqGQBbMZQiWQ ($10.30 in chips) 
Seat 8: PskTLlFIRHSp61inskRzVg ($9.70 in chips) 
Seat 9: zgi+EUykT/pZQpoUG6+oEg ($5.80 in chips) 
Qduu7ikeizo6q6Ei9YvcJA: posts small blind $0.10
OlPJsgR4xypSg/w1z7Gyvw: posts big blind $0.25
*** HOLE CARDS ***
oLa/tXLfSLLB28mcLGrxcg: folds 
+WTkVY3GeLxqGQBbMZQiWQ: folds 
PskTLlFIRHSp61inskRzVg: folds 
zgi+EUykT/pZQpoUG6+oEg: raises $0.75 to $1
ipgcO7Pa6LC8XWpVttZfnA: folds 
dfNim92Z6XK1/h5SFW5vDg: folds 
bXpVeaSTPBFSPJmeXxO7nw: folds 
Qduu7ikeizo6q6Ei9YvcJA: folds 
OlPJsgR4xypSg/w1z7Gyvw: folds 
Uncalled bet ($0.75) returned to zgi+EUykT/pZQpoUG6+oEg
zgi+EUykT/pZQpoUG6+oEg collected $0.60 from pot
zgi+EUykT/pZQpoUG6+oEg: doesn't show hand 
*** SUMMARY ***
Total pot $0.60 | Rake $0 
Seat 1: ipgcO7Pa6LC8XWpVttZfnA folded before Flop (didn't bet)
Seat 2: dfNim92Z6XK1/h5SFW5vDg folded before Flop (didn't bet)
Seat 3: bXpVeaSTPBFSPJmeXxO7nw (button) folded before Flop (didn't bet)
Seat 4: Qduu7ikeizo6q6Ei9YvcJA (small blind) folded before Flop
Seat 5: OlPJsgR4xypSg/w1z7Gyvw (big blind) folded before Flop
Seat 6: oLa/tXLfSLLB28mcLGrxcg folded before Flop (didn't bet)
Seat 7: +WTkVY3GeLxqGQBbMZQiWQ folded before Flop (didn't bet)
Seat 8: PskTLlFIRHSp61inskRzVg folded before Flop (didn't bet)
Seat 9: zgi+EUykT/pZQpoUG6+oEg collected ($0.60)




PokerStars Game #59942016646:  Hold'em No Limit ($0.10/$0.25) - 2009/07/01 1:53:26 ET
Table 'ohAuixfiLOYDylNUG5mNUw' 9-max Seat #9 is the button
Seat 1: qwr38jl5txoR36M7G5qi4A ($10 in chips) 
Seat 2: Th3FldXKQW6hWVVPahaoOQ ($26.15 in chips) 
Seat 3: gSakoFAgDDzXSb2eNBWKcg ($16.45 in chips) 
Seat 4: clJsV3v77RS07bDKY+705w ($5 in chips) 
Seat 8: ppMlNkhYgErlt4fuJO7ADA ($5.40 in chips) 
Seat 9: CT7Xj/V/O5rBlhtt+RZeFQ ($25 in chips) 
qwr38jl5txoR36M7G5qi4A: posts small blind $0.10
Th3FldXKQW6hWVVPahaoOQ: posts big blind $0.25
z5GxcHlYz/GSz6W2uFiTtg: sits out 
18G4P1XstjNvItdGUITxgw: sits out 
*** HOLE CARDS ***
gSakoFAgDDzXSb2eNBWKcg: folds 
clJsV3v77RS07bDKY+705w: raises $0.75 to $1
ppMlNkhYgErlt4fuJO7ADA: folds 
CT7Xj/V/O5rBlhtt+RZeFQ: folds 
qwr38jl5txoR36M7G5qi4A: folds 
Th3FldXKQW6hWVVPahaoOQ: folds 
Uncalled bet ($0.75) returned to clJsV3v77RS07bDKY+705w
clJsV3v77RS07bDKY+705w collected $0.60 from pot
*** SUMMARY ***
Total pot $0.60 | Rake $0 
Seat 1: qwr38jl5txoR36M7G5qi4A (small blind) folded before Flop
Seat 2: Th3FldXKQW6hWVVPahaoOQ (big blind) folded before Flop
Seat 3: gSakoFAgDDzXSb2eNBWKcg folded before Flop (didn't bet)
Seat 4: clJsV3v77RS07bDKY+705w collected ($0.60)
Seat 8: ppMlNkhYgErlt4fuJO7ADA folded before Flop (didn't bet)
Seat 9: CT7Xj/V/O5rBlhtt+RZeFQ (button) folded before Flop (didn't bet)




PokerStars Game #59942016824:  Hold'em No Limit ($0.10/$0.25) - 2009/07/01 1:53:26 ET
Table '+giHa6FUL6U5/AZnCJEGvQ' 9-max Seat #4 is the button
Seat 4: XQRLaOXTf3pRraVvFq7T1g ($4.75 in chips) 
Seat 5: zDrucyjVn5aeekNEc3cJrA ($43.90 in chips) 
Seat 6: GTMnTen6sQSoCpS9sggLbg ($25.70 in chips) 
zDrucyjVn5aeekNEc3cJrA: posts small blind $0.10
GTMnTen6sQSoCpS9sggLbg: posts big blind $0.25
*** HOLE CARDS ***
XQRLaOXTf3pRraVvFq7T1g: folds 
zDrucyjVn5aeekNEc3cJrA: folds 
Uncalled bet ($0.15) returned to GTMnTen6sQSoCpS9sggLbg
GTMnTen6sQSoCpS9sggLbg collected $0.20 from pot
thestavs joins the table at seat #3 
GTMnTen6sQSoCpS9sggLbg: doesn't show hand 
*** SUMMARY ***
Total pot $0.20 | Rake $0 
Seat 4: XQRLaOXTf3pRraVvFq7T1g (button) folded before Flop (didn't bet)
Seat 5: zDrucyjVn5aeekNEc3cJrA (small blind) folded before Flop
Seat 6: GTMnTen6sQSoCpS9sggLbg (big blind) collected ($0.20)




PokerStars Game #59942017306:  Hold'em No Limit ($0.10/$0.25) - 2009/07/01 1:53:27 ET
Table 'g+mPuNJBCHKE9ents7ZGtg' 6-max Seat #1 is the button
Seat 1: cezpHJ8FB07dj0xG+LhOvw ($57.80 in chips) 
Seat 2: fZQg9veL7Dd/Z04ZTjC+wQ ($57.15 in chips) 
Seat 6: Mn2V28t5aGq2d09z+/o6Fw ($36.20 in chips) 
fZQg9veL7Dd/Z04ZTjC+wQ: posts small blind $0.10
8CPg15X6IHYR1pWm9ha1Sw: is sitting out 
Mn2V28t5aGq2d09z+/o6Fw: posts big blind $0.25
*** HOLE CARDS ***
8CPg15X6IHYR1pWm9ha1Sw leaves the table
cezpHJ8FB07dj0xG+LhOvw: folds 
fZQg9veL7Dd/Z04ZTjC+wQ: calls $0.15
Mn2V28t5aGq2d09z+/o6Fw: checks 
*** FLOP *** [5c 2s Qh]
fZQg9veL7Dd/Z04ZTjC+wQ: checks 
Mn2V28t5aGq2d09z+/o6Fw: checks 
*** TURN *** [5c 2s Qh] [4c]
fZQg9veL7Dd/Z04ZTjC+wQ: checks 
Mn2V28t5aGq2d09z+/o6Fw: checks 
*** RIVER *** [5c 2s Qh 4c] [Ad]
fZQg9veL7Dd/Z04ZTjC+wQ: checks 
Mn2V28t5aGq2d09z+/o6Fw: checks 
*** SHOW DOWN ***
fZQg9veL7Dd/Z04ZTjC+wQ: shows [8s 7c] (high card Ace)
Mn2V28t5aGq2d09z+/o6Fw: shows [Ks 8d] (high card Ace - King kicker)
Mn2V28t5aGq2d09z+/o6Fw collected $0.50 from pot
*** SUMMARY ***
Total pot $0.50 | Rake $0 
Board [5c 2s Qh 4c Ad]
Seat 1: cezpHJ8FB07dj0xG+LhOvw (button) folded before Flop (didn't bet)
Seat 2: fZQg9veL7Dd/Z04ZTjC+wQ (small blind) showed [8s 7c] and lost with high card Ace
Seat 6: Mn2V28t5aGq2d09z+/o6Fw (big blind) showed [Ks 8d] and won ($0.50) with high card Ace




PokerStars Game #59942017358:  Hold'em No Limit ($0.10/$0.25) - 2009/07/01 1:53:27 ET
Table 'RUOqTfzbAVGS5x+J9aZMHA' 9-max Seat #4 is the button
Seat 1: DnDcAdn9P0zGovMERigpFA ($28.65 in chips) 
Seat 2: Z5ZtGOON8kmSdSCll9Z3XA ($11.30 in chips) 
Seat 3: Th3FldXKQW6hWVVPahaoOQ ($25 in chips) 
Seat 4: K9Az8li/CO2TicltVWKamA ($20.90 in chips) 
Seat 6: ljemhp25Zg+nlA9DLCIiUw ($47.75 in chips) 
Seat 7: zgi+EUykT/pZQpoUG6+oEg ($5.35 in chips) 
Seat 9: cZ99hugmLBj9KhTlc8nCSw ($25 in chips) 
MtVtHDqIJTyUcXkRBBDIVA will be allowed to play after the button
ljemhp25Zg+nlA9DLCIiUw: posts small blind $0.10
zgi+EUykT/pZQpoUG6+oEg: posts big blind $0.25
*** HOLE CARDS ***
cZ99hugmLBj9KhTlc8nCSw: folds 
MtVtHDqIJTyUcXkRBBDIVA leaves the table
DnDcAdn9P0zGovMERigpFA: folds 
Z5ZtGOON8kmSdSCll9Z3XA: folds 
Th3FldXKQW6hWVVPahaoOQ: folds 
K9Az8li/CO2TicltVWKamA: folds 
ljemhp25Zg+nlA9DLCIiUw: folds 
Uncalled bet ($0.15) returned to zgi+EUykT/pZQpoUG6+oEg
zgi+EUykT/pZQpoUG6+oEg collected $0.20 from pot
zgi+EUykT/pZQpoUG6+oEg: doesn't show hand 
*** SUMMARY ***
Total pot $0.20 | Rake $0 
Seat 1: DnDcAdn9P0zGovMERigpFA folded before Flop (didn't bet)
Seat 2: Z5ZtGOON8kmSdSCll9Z3XA folded before Flop (didn't bet)
Seat 3: Th3FldXKQW6hWVVPahaoOQ folded before Flop (didn't bet)
Seat 4: K9Az8li/CO2TicltVWKamA (button) folded before Flop (didn't bet)
Seat 6: ljemhp25Zg+nlA9DLCIiUw (small blind) folded before Flop
Seat 7: zgi+EUykT/pZQpoUG6+oEg (big blind) collected ($0.20)
Seat 9: cZ99hugmLBj9KhTlc8nCSw folded before Flop (didn't bet)




PokerStars Game #59942017292:  Hold'em No Limit ($0.10/$0.25) - 2009/07/01 1:53:27 ET
Table 'ggwTHpIC5qhhHJSYjK1XCw' 6-max Seat #5 is the button
Seat 1: QkldTZNd6k/x09xKp/8lIw ($3.50 in chips) 
Seat 2: /gJNBeCkWL4o85/jvlZ4BA ($25 in chips) 
Seat 3: 7cx44/slbeTw+Cy7QB8Trg ($26.20 in chips) 
Seat 4: JFIAqU8lCZ0vWwEl4bdGsg ($26.15 in chips) 
Seat 5: BvqhBa7W/To51LhEiIU/lw ($8.50 in chips) 
Seat 6: 732E3Iz0geWMK40ej+U9HA ($8.55 in chips) 
732E3Iz0geWMK40ej+U9HA: posts small blind $0.10
QkldTZNd6k/x09xKp/8lIw: posts big blind $0.25
*** HOLE CARDS ***
/gJNBeCkWL4o85/jvlZ4BA: folds 
7cx44/slbeTw+Cy7QB8Trg: folds 
JFIAqU8lCZ0vWwEl4bdGsg: raises $0.60 to $0.85
BvqhBa7W/To51LhEiIU/lw: folds 
732E3Iz0geWMK40ej+U9HA: calls $0.75
QkldTZNd6k/x09xKp/8lIw: folds 
*** FLOP *** [2c 8h Jh]
732E3Iz0geWMK40ej+U9HA: checks 
JFIAqU8lCZ0vWwEl4bdGsg: checks 
*** TURN *** [2c 8h Jh] [Qd]
732E3Iz0geWMK40ej+U9HA: checks 
JFIAqU8lCZ0vWwEl4bdGsg: checks 
*** RIVER *** [2c 8h Jh Qd] [4s]
732E3Iz0geWMK40ej+U9HA: checks 
JFIAqU8lCZ0vWwEl4bdGsg: checks 
*** SHOW DOWN ***
732E3Iz0geWMK40ej+U9HA: shows [Kc Tc] (high card King)
JFIAqU8lCZ0vWwEl4bdGsg: shows [5c Ac] (high card Ace)
JFIAqU8lCZ0vWwEl4bdGsg collected $1.90 from pot
*** SUMMARY ***
Total pot $1.95 | Rake $0.05 
Board [2c 8h Jh Qd 4s]
Seat 1: QkldTZNd6k/x09xKp/8lIw (big blind) folded before Flop
Seat 2: /gJNBeCkWL4o85/jvlZ4BA folded before Flop (didn't bet)
Seat 3: 7cx44/slbeTw+Cy7QB8Trg folded before Flop (didn't bet)
Seat 4: JFIAqU8lCZ0vWwEl4bdGsg showed [5c Ac] and won ($1.90) with high card Ace
Seat 5: BvqhBa7W/To51LhEiIU/lw (button) folded before Flop (didn't bet)
Seat 6: 732E3Iz0geWMK40ej+U9HA (small blind) showed [Kc Tc] and lost with high card King




PokerStars Game #59942017726:  Hold'em No Limit ($0.10/$0.25) - 2009/07/01 1:53:27 ET
Table 'aaXqTKUnxrX9DYXtxhWXxA' 6-max Seat #6 is the button
Seat 1: aSrj4lVmn2owyQ1RbbOqxQ ($28.60 in chips) 
Seat 2: DE9hRlt14g+JdsRQ4wT7hg ($30.25 in chips) 
Seat 3: uUXdcVMNa05rfbntdvplfw ($10.35 in chips) 
Seat 4: 48oT5xFI+5CHUJlfoGrE4w ($7.30 in chips) 
Seat 5: kyRaCIljYA6l33lSKQfNsg ($23.50 in chips) 
Seat 6: 1lxYIAoJdZwAbzIkzWmSkw ($6.50 in chips) 
aSrj4lVmn2owyQ1RbbOqxQ: posts small blind $0.10
DE9hRlt14g+JdsRQ4wT7hg: posts big blind $0.25
*** HOLE CARDS ***
uUXdcVMNa05rfbntdvplfw: folds 
48oT5xFI+5CHUJlfoGrE4w: folds 
kyRaCIljYA6l33lSKQfNsg: raises $0.50 to $0.75
1lxYIAoJdZwAbzIkzWmSkw: folds 
aSrj4lVmn2owyQ1RbbOqxQ: folds 
DE9hRlt14g+JdsRQ4wT7hg: folds 
Uncalled bet ($0.50) returned to kyRaCIljYA6l33lSKQfNsg
kyRaCIljYA6l33lSKQfNsg collected $0.60 from pot
*** SUMMARY ***
Total pot $0.60 | Rake $0 
Seat 1: aSrj4lVmn2owyQ1RbbOqxQ (small blind) folded before Flop
Seat 2: DE9hRlt14g+JdsRQ4wT7hg (big blind) folded before Flop
Seat 3: uUXdcVMNa05rfbntdvplfw folded before Flop (didn't bet)
Seat 4: 48oT5xFI+5CHUJlfoGrE4w folded before Flop (didn't bet)
Seat 5: kyRaCIljYA6l33lSKQfNsg collected ($0.60)
Seat 6: 1lxYIAoJdZwAbzIkzWmSkw (button) folded before Flop (didn't bet)




PokerStars Game #59942017708:  Hold'em No Limit ($0.10/$0.25) - 2009/07/01 1:53:27 ET
Table '2VkNDXXsBj4bSZw/uK5atw' 6-max Seat #6 is the button
Seat 1: xrf8tAXKQHG99HixCot1Iw ($25 in chips) 
Seat 2: GbCVUNssQ7mqsPWr7J4d3w ($4.65 in chips) 
Seat 3: P+6Z5+8H5/Wyt/jHMovNvQ ($25.20 in chips) 
Seat 4: 4kIRqWKE/N0yUAcWVhLSoQ ($16.90 in chips) 
Seat 5: 7f0OkhFEOf3T+rVOFHRLnw ($18.90 in chips) 
Seat 6: n6UPMnVR4v8LFP0rWP73Fg ($12.10 in chips) 
xrf8tAXKQHG99HixCot1Iw: posts small blind $0.10
GbCVUNssQ7mqsPWr7J4d3w: posts big blind $0.25
*** HOLE CARDS ***
P+6Z5+8H5/Wyt/jHMovNvQ: folds 
4kIRqWKE/N0yUAcWVhLSoQ: folds 
7f0OkhFEOf3T+rVOFHRLnw: folds 
n6UPMnVR4v8LFP0rWP73Fg: raises $0.25 to $0.50
xrf8tAXKQHG99HixCot1Iw: folds 
7f0OkhFEOf3T+rVOFHRLnw leaves the table
GbCVUNssQ7mqsPWr7J4d3w: folds 
Uncalled bet ($0.25) returned to n6UPMnVR4v8LFP0rWP73Fg
n6UPMnVR4v8LFP0rWP73Fg collected $0.60 from pot
n6UPMnVR4v8LFP0rWP73Fg: doesn't show hand 
*** SUMMARY ***
Total pot $0.60 | Rake $0 
Seat 1: xrf8tAXKQHG99HixCot1Iw (small blind) folded before Flop
Seat 2: GbCVUNssQ7mqsPWr7J4d3w (big blind) folded before Flop
Seat 3: P+6Z5+8H5/Wyt/jHMovNvQ folded before Flop (didn't bet)
Seat 4: 4kIRqWKE/N0yUAcWVhLSoQ folded before Flop (didn't bet)
Seat 5: 7f0OkhFEOf3T+rVOFHRLnw folded before Flop (didn't bet)
Seat 6: n6UPMnVR4v8LFP0rWP73Fg (button) collected ($0.60)




PokerStars Game #59942017356:  Hold'em No Limit ($0.10/$0.25) - 2009/07/01 1:53:27 ET
Table 'DhkrdW2UOy2PfjSW28Kq8w' 6-max Seat #1 is the button
Seat 1: Mhj3q7cxev+XjXZxEE6/Cw ($25 in chips) 
Seat 2: v+QfkGiuj9bgtuNoVnDO8w ($27.05 in chips) 
Seat 3: B3X187C0tXFUfQpCu8pe8A ($22.45 in chips) 
Seat 4: 59HJSCM1X37BkMpI9N0mEw ($22.50 in chips) 
Seat 5: cS21pIxRHx5Gt42o7hPZzw ($11.45 in chips) 
Seat 6: DihMHaz4WNETH1bPDe13kA ($26.75 in chips) 
v+QfkGiuj9bgtuNoVnDO8w: posts small blind $0.10
B3X187C0tXFUfQpCu8pe8A: posts big blind $0.25
*** HOLE CARDS ***
59HJSCM1X37BkMpI9N0mEw: folds 
cS21pIxRHx5Gt42o7hPZzw: raises $0.75 to $1
DihMHaz4WNETH1bPDe13kA: folds 
Mhj3q7cxev+XjXZxEE6/Cw: folds 
v+QfkGiuj9bgtuNoVnDO8w: folds 
B3X187C0tXFUfQpCu8pe8A: folds 
Uncalled bet ($0.75) returned to cS21pIxRHx5Gt42o7hPZzw
v+QfkGiuj9bgtuNoVnDO8w is sitting out
cS21pIxRHx5Gt42o7hPZzw collected $0.60 from pot
cS21pIxRHx5Gt42o7hPZzw: doesn't show hand 
*** SUMMARY ***
Total pot $0.60 | Rake $0 
Seat 1: Mhj3q7cxev+XjXZxEE6/Cw (button) folded before Flop (didn't bet)
Seat 2: v+QfkGiuj9bgtuNoVnDO8w (small blind) folded before Flop
Seat 3: B3X187C0tXFUfQpCu8pe8A (big blind) folded before Flop
Seat 4: 59HJSCM1X37BkMpI9N0mEw folded before Flop (didn't bet)
Seat 5: cS21pIxRHx5Gt42o7hPZzw collected ($0.60)
Seat 6: DihMHaz4WNETH1bPDe13kA folded before Flop (didn't bet)




PokerStars Game #59942017688:  Hold'em No Limit ($0.10/$0.25) - 2009/07/01 1:53:27 ET
Table '3lS+sU5k6mwJCS2nFMmQ6Q' 9-max Seat #9 is the button
Seat 1: VWUWpMLMj/Q1jRVpF7Aohw ($13.30 in chips) 
Seat 4: GeMoapCKDLc4ajT0Uk9ZQw ($9.65 in chips) 
Seat 6: hJ4uYjNmSZdjrKA8cjZqCA ($40.70 in chips) 
Seat 7: Th3FldXKQW6hWVVPahaoOQ ($31.20 in chips) 
Seat 8: 9lvO/qyU+xrU95Teu1fv0g ($4.65 in chips) 
Seat 9: 4awUyiDYTgylQKXZ9faBVA ($61 in chips) 
VWUWpMLMj/Q1jRVpF7Aohw: posts small blind $0.10
GeMoapCKDLc4ajT0Uk9ZQw: posts big blind $0.25
*** HOLE CARDS ***
hJ4uYjNmSZdjrKA8cjZqCA: folds 
PdIasPkzm2sqZnN41ZRXOg leaves the table
Th3FldXKQW6hWVVPahaoOQ: folds 
9lvO/qyU+xrU95Teu1fv0g: folds 
4awUyiDYTgylQKXZ9faBVA: raises $0.75 to $1
VWUWpMLMj/Q1jRVpF7Aohw: folds 
GeMoapCKDLc4ajT0Uk9ZQw: folds 
Uncalled bet ($0.75) returned to 4awUyiDYTgylQKXZ9faBVA
4awUyiDYTgylQKXZ9faBVA collected $0.60 from pot
4awUyiDYTgylQKXZ9faBVA: doesn't show hand 
*** SUMMARY ***
Total pot $0.60 | Rake $0 
Seat 1: VWUWpMLMj/Q1jRVpF7Aohw (small blind) folded before Flop
Seat 4: GeMoapCKDLc4ajT0Uk9ZQw (big blind) folded before Flop
Seat 6: hJ4uYjNmSZdjrKA8cjZqCA folded before Flop (didn't bet)
Seat 7: Th3FldXKQW6hWVVPahaoOQ folded before Flop (didn't bet)
Seat 8: 9lvO/qyU+xrU95Teu1fv0g folded before Flop (didn't bet)
Seat 9: 4awUyiDYTgylQKXZ9faBVA (button) collected ($0.60)




PokerStars Game #59942017446:  Hold'em No Limit ($0.10/$0.25) - 2009/07/01 1:53:27 ET
Table '9lYs7ljXi6AgFAxYHlKLJw' 9-max Seat #8 is the button
Seat 1: K0b5wNInj6hUGRr6yzKFtw ($36.65 in chips) 
Seat 2: 0XACOSNrAWmqNv9k1nF8rw ($14.60 in chips) 
Seat 3: arxNSjreDRGFg13EAM2F1w ($37.45 in chips) 
Seat 4: UANt6y/SmDCY/jIxkBixcw ($33.70 in chips) 
Seat 5: dfNim92Z6XK1/h5SFW5vDg ($59.20 in chips) 
Seat 7: ghNKXUBl/H+t83JF079ZBA ($28.40 in chips) 
Seat 8: 9YN2IkT2JYYKFErZtZvCtA ($18.25 in chips) 
Seat 9: IVL33RWimYC8hA5O8TO69Q ($5.10 in chips) 
IVL33RWimYC8hA5O8TO69Q: posts small blind $0.10
K0b5wNInj6hUGRr6yzKFtw: posts big blind $0.25
j4q3p0lesp63b1gZDwLBZw: sits out 
*** HOLE CARDS ***
0XACOSNrAWmqNv9k1nF8rw: folds 
arxNSjreDRGFg13EAM2F1w: folds 
UANt6y/SmDCY/jIxkBixcw: calls $0.25
dfNim92Z6XK1/h5SFW5vDg: folds 
ghNKXUBl/H+t83JF079ZBA: folds 
9YN2IkT2JYYKFErZtZvCtA: folds 
IVL33RWimYC8hA5O8TO69Q: raises $1 to $1.25
K0b5wNInj6hUGRr6yzKFtw: folds 
UANt6y/SmDCY/jIxkBixcw: folds 
Uncalled bet ($1) returned to IVL33RWimYC8hA5O8TO69Q
IVL33RWimYC8hA5O8TO69Q collected $0.75 from pot
*** SUMMARY ***
Total pot $0.75 | Rake $0 
Seat 1: K0b5wNInj6hUGRr6yzKFtw (big blind) folded before Flop
Seat 2: 0XACOSNrAWmqNv9k1nF8rw folded before Flop (didn't bet)
Seat 3: arxNSjreDRGFg13EAM2F1w folded before Flop (didn't bet)
Seat 4: UANt6y/SmDCY/jIxkBixcw folded before Flop
Seat 5: dfNim92Z6XK1/h5SFW5vDg folded before Flop (didn't bet)
Seat 7: ghNKXUBl/H+t83JF079ZBA folded before Flop (didn't bet)
Seat 8: 9YN2IkT2JYYKFErZtZvCtA (button) folded before Flop (didn't bet)
Seat 9: IVL33RWimYC8hA5O8TO69Q (small blind) collected ($0.75)




PokerStars Game #59942017458:  Hold'em No Limit ($0.10/$0.25) - 2009/07/01 1:53:27 ET
Table 'srBTB98reCdD1TffxE6o7g' 6-max Seat #6 is the button
Seat 2: mfrkWA3PTeYPkbO6hi98Aw ($24.40 in chips) 
Seat 3: VOmI0x4dDPnTESZd5B4d1Q ($42.40 in chips) 
Seat 4: 6DwBRH+xZ12AAZmeAg+aXw ($16.55 in chips) 
Seat 5: K1zv48sQUGQiaLk5VWWDqw ($26.25 in chips) 
Seat 6: BV+K0Phf5VBHr7aZPKqbUQ ($30.40 in chips) 
mfrkWA3PTeYPkbO6hi98Aw: posts small blind $0.10
VOmI0x4dDPnTESZd5B4d1Q: posts big blind $0.25
*** HOLE CARDS ***
6DwBRH+xZ12AAZmeAg+aXw: raises $0.50 to $0.75
K1zv48sQUGQiaLk5VWWDqw: folds 
BV+K0Phf5VBHr7aZPKqbUQ: folds 
mfrkWA3PTeYPkbO6hi98Aw: folds 
VOmI0x4dDPnTESZd5B4d1Q: raises $2.25 to $3
6DwBRH+xZ12AAZmeAg+aXw: folds 
Uncalled bet ($2.25) returned to VOmI0x4dDPnTESZd5B4d1Q
VOmI0x4dDPnTESZd5B4d1Q collected $1.60 from pot
VOmI0x4dDPnTESZd5B4d1Q: doesn't show hand 
*** SUMMARY ***
Total pot $1.60 | Rake $0 
Seat 2: mfrkWA3PTeYPkbO6hi98Aw (small blind) folded before Flop
Seat 3: VOmI0x4dDPnTESZd5B4d1Q (big blind) collected ($1.60)
Seat 4: 6DwBRH+xZ12AAZmeAg+aXw folded before Flop
Seat 5: K1zv48sQUGQiaLk5VWWDqw folded before Flop (didn't bet)
Seat 6: BV+K0Phf5VBHr7aZPKqbUQ (button) folded before Flop (didn't bet)




PokerStars Game #59942018058:  Hold'em No Limit ($0.10/$0.25) - 2009/07/01 1:53:28 ET
Table '4mnXP0EWt9mMZYzTIVDQ0w' 9-max Seat #5 is the button
Seat 1: Z5y2J55JmfLYR6/DPAGHwQ ($17.10 in chips) 
Seat 2: BLEU2x2bnGRovIelAY6slA ($25.05 in chips) 
Seat 3: Ns4HpwO7Oiffvyla/ie56w ($17.50 in chips) 
Seat 4: 9lvO/qyU+xrU95Teu1fv0g ($12.15 in chips) 
Seat 5: sSN8Y0AlsBeidZXPKmwXSw ($24.60 in chips) 
Seat 6: 5yjzPss7Y4kAWNDat3e0yQ ($35.40 in chips) 
Seat 7: TtioUKOdJQDGtQyRAYC5Xg ($4.10 in chips) 
Seat 8: 9YN2IkT2JYYKFErZtZvCtA ($14.05 in chips) 
Seat 9: N/O9ADKpmqB2ASZuqgodlw ($10.20 in chips) 
5yjzPss7Y4kAWNDat3e0yQ: posts small blind $0.10
TtioUKOdJQDGtQyRAYC5Xg: posts big blind $0.25
*** HOLE CARDS ***
9YN2IkT2JYYKFErZtZvCtA: folds 
N/O9ADKpmqB2ASZuqgodlw: folds 
Z5y2J55JmfLYR6/DPAGHwQ: folds 
BLEU2x2bnGRovIelAY6slA: calls $0.25
Ns4HpwO7Oiffvyla/ie56w: raises $0.25 to $0.50
9lvO/qyU+xrU95Teu1fv0g: folds 
sSN8Y0AlsBeidZXPKmwXSw: calls $0.50
5yjzPss7Y4kAWNDat3e0yQ: folds 
TtioUKOdJQDGtQyRAYC5Xg: calls $0.25
BLEU2x2bnGRovIelAY6slA: calls $0.25
*** FLOP *** [9d Td 7d]
TtioUKOdJQDGtQyRAYC5Xg: checks 
BLEU2x2bnGRovIelAY6slA: checks 
Ns4HpwO7Oiffvyla/ie56w: bets $0.50
sSN8Y0AlsBeidZXPKmwXSw: folds 
TtioUKOdJQDGtQyRAYC5Xg: folds 
BLEU2x2bnGRovIelAY6slA: folds 
Uncalled bet ($0.50) returned to Ns4HpwO7Oiffvyla/ie56w
Ns4HpwO7Oiffvyla/ie56w collected $2 from pot
Ns4HpwO7Oiffvyla/ie56w: doesn't show hand 
*** SUMMARY ***
Total pot $2.10 | Rake $0.10 
Board [9d Td 7d]
Seat 1: Z5y2J55JmfLYR6/DPAGHwQ folded before Flop (didn't bet)
Seat 2: BLEU2x2bnGRovIelAY6slA folded on the Flop
Seat 3: Ns4HpwO7Oiffvyla/ie56w collected ($2)
Seat 4: 9lvO/qyU+xrU95Teu1fv0g folded before Flop (didn't bet)
Seat 5: sSN8Y0AlsBeidZXPKmwXSw (button) folded on the Flop
Seat 6: 5yjzPss7Y4kAWNDat3e0yQ (small blind) folded before Flop
Seat 7: TtioUKOdJQDGtQyRAYC5Xg (big blind) folded on the Flop
Seat 8: 9YN2IkT2JYYKFErZtZvCtA folded before Flop (didn't bet)
Seat 9: N/O9ADKpmqB2ASZuqgodlw folded before Flop (didn't bet)




PokerStars Game #59942017932:  Hold'em No Limit ($0.10/$0.25) - 2009/07/01 1:53:28 ET
Table 'nFlmVztKq1HJEWfxmdl15w' 9-max Seat #1 is the button
Seat 1: cZ99hugmLBj9KhTlc8nCSw ($25 in chips) 
Seat 2: Th3FldXKQW6hWVVPahaoOQ ($38.75 in chips) 
Seat 3: DdPXdieucQ+n99u1n3A+rQ ($5.70 in chips) 
Seat 4: +5dSUwD+/k2ktlnutSMivw ($10.25 in chips) 
Seat 5: Tx6zQdk5Ozt9ObEBlU7jeg ($43.80 in chips) 
Seat 6: 4awUyiDYTgylQKXZ9faBVA ($37.65 in chips) 
Seat 7: dfNim92Z6XK1/h5SFW5vDg ($34.95 in chips) 
Seat 8: +2kMBNpY4nF1qNCRd8SJLA ($33.15 in chips) 
Seat 9: DnDcAdn9P0zGovMERigpFA ($25.40 in chips) 
Th3FldXKQW6hWVVPahaoOQ: posts small blind $0.10
DdPXdieucQ+n99u1n3A+rQ: posts big blind $0.25
*** HOLE CARDS ***
+5dSUwD+/k2ktlnutSMivw: calls $0.25
Tx6zQdk5Ozt9ObEBlU7jeg: calls $0.25
4awUyiDYTgylQKXZ9faBVA: raises $1 to $1.25
dfNim92Z6XK1/h5SFW5vDg: folds 
+2kMBNpY4nF1qNCRd8SJLA: folds 
DnDcAdn9P0zGovMERigpFA: folds 
cZ99hugmLBj9KhTlc8nCSw: folds 
Th3FldXKQW6hWVVPahaoOQ: folds 
DdPXdieucQ+n99u1n3A+rQ: folds 
+5dSUwD+/k2ktlnutSMivw: calls $1
Tx6zQdk5Ozt9ObEBlU7jeg: calls $1
*** FLOP *** [7h 6d Jh]
+5dSUwD+/k2ktlnutSMivw: checks 
Tx6zQdk5Ozt9ObEBlU7jeg: checks 
4awUyiDYTgylQKXZ9faBVA: checks 
*** TURN *** [7h 6d Jh] [9c]
+5dSUwD+/k2ktlnutSMivw: bets $2
Tx6zQdk5Ozt9ObEBlU7jeg: calls $2
4awUyiDYTgylQKXZ9faBVA: folds 
*** RIVER *** [7h 6d Jh 9c] [Ks]
+5dSUwD+/k2ktlnutSMivw: bets $2.25
Tx6zQdk5Ozt9ObEBlU7jeg: folds 
Uncalled bet ($2.25) returned to +5dSUwD+/k2ktlnutSMivw
+5dSUwD+/k2ktlnutSMivw collected $7.75 from pot
+5dSUwD+/k2ktlnutSMivw: doesn't show hand 
*** SUMMARY ***
Total pot $8.10 | Rake $0.35 
Board [7h 6d Jh 9c Ks]
Seat 1: cZ99hugmLBj9KhTlc8nCSw (button) folded before Flop (didn't bet)
Seat 2: Th3FldXKQW6hWVVPahaoOQ (small blind) folded before Flop
Seat 3: DdPXdieucQ+n99u1n3A+rQ (big blind) folded before Flop
Seat 4: +5dSUwD+/k2ktlnutSMivw collected ($7.75)
Seat 5: Tx6zQdk5Ozt9ObEBlU7jeg folded on the River
Seat 6: 4awUyiDYTgylQKXZ9faBVA folded on the Turn
Seat 7: dfNim92Z6XK1/h5SFW5vDg folded before Flop (didn't bet)
Seat 8: +2kMBNpY4nF1qNCRd8SJLA folded before Flop (didn't bet)
Seat 9: DnDcAdn9P0zGovMERigpFA folded before Flop (didn't bet)




PokerStars Game #59942018340:  Hold'em No Limit ($0.10/$0.25) - 2009/07/01 1:53:29 ET
Table 'Qk/910N2Yhg8u5vqTJk50Q' 9-max Seat #4 is the button
Seat 1: zDrucyjVn5aeekNEc3cJrA ($22.20 in chips) 
Seat 2: Th3FldXKQW6hWVVPahaoOQ ($44.70 in chips) 
Seat 3: ghNKXUBl/H+t83JF079ZBA ($25.90 in chips) 
Seat 4: hYvTc4PYNrAaNAIVoM94Hw ($4.40 in chips) 
Seat 5: zReBEigsxqZnag0RZAgpgA ($14.55 in chips) 
Seat 6: U41wNf6XauAiBOQaKu2ZIA ($9.75 in chips) 
Seat 7: aNpwfA31EREwO+ar4XzBCw ($26.85 in chips) 
Seat 8: 5pDhXQ+RVy0BGcwfJAJfbg ($25.10 in chips) 
Seat 9: M2QO2DxB5Wawg2h8HSpnYA ($17.35 in chips) 
zReBEigsxqZnag0RZAgpgA: posts small blind $0.10
U41wNf6XauAiBOQaKu2ZIA: posts big blind $0.25
*** HOLE CARDS ***
aNpwfA31EREwO+ar4XzBCw: folds 
aNpwfA31EREwO+ar4XzBCw leaves the table
I.F.R joins the table at seat #7 
5pDhXQ+RVy0BGcwfJAJfbg: folds 
M2QO2DxB5Wawg2h8HSpnYA: raises $0.75 to $1
zDrucyjVn5aeekNEc3cJrA: folds 
Th3FldXKQW6hWVVPahaoOQ: folds 
ghNKXUBl/H+t83JF079ZBA: folds 
hYvTc4PYNrAaNAIVoM94Hw: folds 
zReBEigsxqZnag0RZAgpgA: calls $0.90
U41wNf6XauAiBOQaKu2ZIA: calls $0.75
*** FLOP *** [8h 9c 3h]
zReBEigsxqZnag0RZAgpgA: checks 
U41wNf6XauAiBOQaKu2ZIA: bets $0.50
M2QO2DxB5Wawg2h8HSpnYA: calls $0.50
zReBEigsxqZnag0RZAgpgA: calls $0.50
*** TURN *** [8h 9c 3h] [Kd]
zReBEigsxqZnag0RZAgpgA: checks 
U41wNf6XauAiBOQaKu2ZIA: bets $0.75
M2QO2DxB5Wawg2h8HSpnYA: raises $1.50 to $2.25
zReBEigsxqZnag0RZAgpgA: calls $2.25
U41wNf6XauAiBOQaKu2ZIA: calls $1.50
*** RIVER *** [8h 9c 3h Kd] [Js]
zReBEigsxqZnag0RZAgpgA: checks 
U41wNf6XauAiBOQaKu2ZIA: checks 
M2QO2DxB5Wawg2h8HSpnYA: bets $3.50
zReBEigsxqZnag0RZAgpgA: calls $3.50
U41wNf6XauAiBOQaKu2ZIA: folds 
*** SHOW DOWN ***
M2QO2DxB5Wawg2h8HSpnYA: shows [As Qs] (high card Ace)
zReBEigsxqZnag0RZAgpgA: shows [Qh Kh] (a pair of Kings)
zReBEigsxqZnag0RZAgpgA collected $17.40 from pot
*** SUMMARY ***
Total pot $18.25 | Rake $0.85 
Board [8h 9c 3h Kd Js]
Seat 1: zDrucyjVn5aeekNEc3cJrA folded before Flop (didn't bet)
Seat 2: Th3FldXKQW6hWVVPahaoOQ folded before Flop (didn't bet)
Seat 3: ghNKXUBl/H+t83JF079ZBA folded before Flop (didn't bet)
Seat 4: hYvTc4PYNrAaNAIVoM94Hw (button) folded before Flop (didn't bet)
Seat 5: zReBEigsxqZnag0RZAgpgA (small blind) showed [Qh Kh] and won ($17.40) with a pair of Kings
Seat 6: U41wNf6XauAiBOQaKu2ZIA (big blind) folded on the River
Seat 7: aNpwfA31EREwO+ar4XzBCw folded before Flop (didn't bet)
Seat 8: 5pDhXQ+RVy0BGcwfJAJfbg folded before Flop (didn't bet)
Seat 9: M2QO2DxB5Wawg2h8HSpnYA showed [As Qs] and lost with high card Ace




PokerStars Game #59942018360:  Hold'em No Limit ($0.10/$0.25) - 2009/07/01 1:53:29 ET
Table 'Zi9/NqNs3XoL1eWhMCyZyg' 9-max Seat #9 is the button
Seat 1: X6+pSIPfovPcE87t+LmUKQ ($4.25 in chips) 
Seat 2: 1wKfgJ8xXIiuc8C6qjkxhg ($5.85 in chips) 
Seat 3: ETC7YyRJTa2Ovhln64Ni5Q ($27.80 in chips) 
Seat 4: dmYlc+1cjwZMJ7wV+Z0rRg ($24 in chips) 
Seat 5: HE9eSITnljG4AKvgOR4BMw ($14.75 in chips) 
Seat 6: YQhfmYhgnDDlWCAFmBb36Q ($17.50 in chips) 
Seat 7: 0QdZrkFD7aGKeBXPGbIomA ($1.95 in chips) 
Seat 8: nm4Dj/f+jJEwKVsUnKh73g ($34.30 in chips) 
Seat 9: 3l+i+xMeyDndSXMF2A5CDA ($5 in chips) 
X6+pSIPfovPcE87t+LmUKQ: posts small blind $0.10
1wKfgJ8xXIiuc8C6qjkxhg: posts big blind $0.25
*** HOLE CARDS ***
ETC7YyRJTa2Ovhln64Ni5Q: folds 
dmYlc+1cjwZMJ7wV+Z0rRg: folds 
HE9eSITnljG4AKvgOR4BMw: folds 
YQhfmYhgnDDlWCAFmBb36Q: calls $0.25
0QdZrkFD7aGKeBXPGbIomA: folds 
nm4Dj/f+jJEwKVsUnKh73g: folds 
3l+i+xMeyDndSXMF2A5CDA: folds 
X6+pSIPfovPcE87t+LmUKQ: folds 
1wKfgJ8xXIiuc8C6qjkxhg: checks 
*** FLOP *** [Kc 5c 7d]
1wKfgJ8xXIiuc8C6qjkxhg: checks 
YQhfmYhgnDDlWCAFmBb36Q: checks 
*** TURN *** [Kc 5c 7d] [4c]
1wKfgJ8xXIiuc8C6qjkxhg: checks 
YQhfmYhgnDDlWCAFmBb36Q: bets $0.50
1wKfgJ8xXIiuc8C6qjkxhg: calls $0.50
*** RIVER *** [Kc 5c 7d 4c] [2h]
1wKfgJ8xXIiuc8C6qjkxhg: bets $1.25
YQhfmYhgnDDlWCAFmBb36Q: folds 
Uncalled bet ($1.25) returned to 1wKfgJ8xXIiuc8C6qjkxhg
nm4Dj/f+jJEwKVsUnKh73g is sitting out
1wKfgJ8xXIiuc8C6qjkxhg collected $1.55 from pot
*** SUMMARY ***
Total pot $1.60 | Rake $0.05 
Board [Kc 5c 7d 4c 2h]
Seat 1: X6+pSIPfovPcE87t+LmUKQ (small blind) folded before Flop
Seat 2: 1wKfgJ8xXIiuc8C6qjkxhg (big blind) collected ($1.55)
Seat 3: ETC7YyRJTa2Ovhln64Ni5Q folded before Flop (didn't bet)
Seat 4: dmYlc+1cjwZMJ7wV+Z0rRg folded before Flop (didn't bet)
Seat 5: HE9eSITnljG4AKvgOR4BMw folded before Flop (didn't bet)
Seat 6: YQhfmYhgnDDlWCAFmBb36Q folded on the River
Seat 7: 0QdZrkFD7aGKeBXPGbIomA folded before Flop (didn't bet)
Seat 8: nm4Dj/f+jJEwKVsUnKh73g folded before Flop (didn't bet)
Seat 9: 3l+i+xMeyDndSXMF2A5CDA (button) folded before Flop (didn't bet)




PokerStars Game #59942018738:  Hold'em No Limit ($0.10/$0.25) - 2009/07/01 1:53:29 ET
Table 'jItkp2PNTbH9Cf7gqsAF7g' 9-max Seat #4 is the button
Seat 1: wGigCmBR/9XWkPpvYos3aQ ($26.50 in chips) 
Seat 2: qwr38jl5txoR36M7G5qi4A ($7.60 in chips) 
Seat 3: K0b5wNInj6hUGRr6yzKFtw ($25 in chips) 
Seat 4: oJOvZw/Iayou0f0k6dkBhg ($4.55 in chips) 
Seat 5: NO6qGDOw12lhu3zh1xW3Bg ($18.15 in chips) 
Seat 6: cZ99hugmLBj9KhTlc8nCSw ($51.25 in chips) 
Seat 8: cq6LACCDFivk2+PeoiB2sw ($12.05 in chips) 
Seat 9: dtZ84flFEi4Q+SGrHMJRDQ ($27.10 in chips) 
NO6qGDOw12lhu3zh1xW3Bg: posts small blind $0.10
cZ99hugmLBj9KhTlc8nCSw: posts big blind $0.25
z5GxcHlYz/GSz6W2uFiTtg: sits out 
K0b5wNInj6hUGRr6yzKFtw: posts big blind $0.25
*** HOLE CARDS ***
cq6LACCDFivk2+PeoiB2sw: folds 
dtZ84flFEi4Q+SGrHMJRDQ: folds 
wGigCmBR/9XWkPpvYos3aQ: raises $1 to $1.25
qwr38jl5txoR36M7G5qi4A: folds 
K0b5wNInj6hUGRr6yzKFtw: calls $1
oJOvZw/Iayou0f0k6dkBhg: folds 
NO6qGDOw12lhu3zh1xW3Bg: folds 
cZ99hugmLBj9KhTlc8nCSw: folds 
*** FLOP *** [3d 7c 2h]
wGigCmBR/9XWkPpvYos3aQ: bets $2
K0b5wNInj6hUGRr6yzKFtw: raises $2 to $4
wGigCmBR/9XWkPpvYos3aQ: folds 
Uncalled bet ($2) returned to K0b5wNInj6hUGRr6yzKFtw
K0b5wNInj6hUGRr6yzKFtw collected $6.55 from pot
K0b5wNInj6hUGRr6yzKFtw: doesn't show hand 
*** SUMMARY ***
Total pot $6.85 | Rake $0.30 
Board [3d 7c 2h]
Seat 1: wGigCmBR/9XWkPpvYos3aQ folded on the Flop
Seat 2: qwr38jl5txoR36M7G5qi4A folded before Flop (didn't bet)
Seat 3: K0b5wNInj6hUGRr6yzKFtw collected ($6.55)
Seat 4: oJOvZw/Iayou0f0k6dkBhg (button) folded before Flop (didn't bet)
Seat 5: NO6qGDOw12lhu3zh1xW3Bg (small blind) folded before Flop
Seat 6: cZ99hugmLBj9KhTlc8nCSw (big blind) folded before Flop
Seat 8: cq6LACCDFivk2+PeoiB2sw folded before Flop (didn't bet)
Seat 9: dtZ84flFEi4Q+SGrHMJRDQ folded before Flop (didn't bet)




PokerStars Game #59942018608:  Hold'em No Limit ($0.10/$0.25) - 2009/07/01 1:53:29 ET
Table '+fuYjvJy9okLr23QyZtanA' 9-max Seat #3 is the button
Seat 2: tLcDklc2rBORNfixyRfVfw ($25 in chips) 
Seat 3: eK8qa6EPcH2zhtbmWSvc9g ($51.95 in chips) 
Seat 4: Bb42QRQMhg5/Y0vHP8/2Xw ($32 in chips) 
Seat 5: bXpVeaSTPBFSPJmeXxO7nw ($4.30 in chips) 
Seat 6: wGigCmBR/9XWkPpvYos3aQ ($32.40 in chips) 
Seat 7: dfNim92Z6XK1/h5SFW5vDg ($36.50 in chips) 
Seat 8: KqS/lY/fNB9qUxokm9QfeA ($8.20 in chips) 
Seat 9: OMhlmt2waO3z43ZSFNMmog ($30.05 in chips) 
Bb42QRQMhg5/Y0vHP8/2Xw: posts small blind $0.10
bXpVeaSTPBFSPJmeXxO7nw: posts big blind $0.25
*** HOLE CARDS ***
wGigCmBR/9XWkPpvYos3aQ: folds 
dfNim92Z6XK1/h5SFW5vDg: folds 
KqS/lY/fNB9qUxokm9QfeA: calls $0.25
OMhlmt2waO3z43ZSFNMmog: folds 
tLcDklc2rBORNfixyRfVfw: folds 
eK8qa6EPcH2zhtbmWSvc9g: calls $0.25
Bb42QRQMhg5/Y0vHP8/2Xw: folds 
ShaunNZ25 leaves the table
bXpVeaSTPBFSPJmeXxO7nw: checks 
*** FLOP *** [Ks 2c Ah]
bXpVeaSTPBFSPJmeXxO7nw: checks 
KqS/lY/fNB9qUxokm9QfeA: checks 
eK8qa6EPcH2zhtbmWSvc9g: bets $0.50
bXpVeaSTPBFSPJmeXxO7nw: folds 
V6p0jQ/RhUsqpHLmXvEX4Q joins the table at seat #1 
KqS/lY/fNB9qUxokm9QfeA: calls $0.50
*** TURN *** [Ks 2c Ah] [2s]
KqS/lY/fNB9qUxokm9QfeA: checks 
eK8qa6EPcH2zhtbmWSvc9g: checks 
*** RIVER *** [Ks 2c Ah 2s] [Ad]
KqS/lY/fNB9qUxokm9QfeA: checks 
eK8qa6EPcH2zhtbmWSvc9g: bets $0.90
KqS/lY/fNB9qUxokm9QfeA: calls $0.90
*** SHOW DOWN ***
eK8qa6EPcH2zhtbmWSvc9g: shows [4h 4c] (two pair, Aces and Fours)
KqS/lY/fNB9qUxokm9QfeA: mucks hand 
eK8qa6EPcH2zhtbmWSvc9g collected $3.50 from pot
*** SUMMARY ***
Total pot $3.65 | Rake $0.15 
Board [Ks 2c Ah 2s Ad]
Seat 2: tLcDklc2rBORNfixyRfVfw folded before Flop (didn't bet)
Seat 3: eK8qa6EPcH2zhtbmWSvc9g (button) showed [4h 4c] and won ($3.50) with two pair, Aces and Fours
Seat 4: Bb42QRQMhg5/Y0vHP8/2Xw (small blind) folded before Flop
Seat 5: bXpVeaSTPBFSPJmeXxO7nw (big blind) folded on the Flop
Seat 6: wGigCmBR/9XWkPpvYos3aQ folded before Flop (didn't bet)
Seat 7: dfNim92Z6XK1/h5SFW5vDg folded before Flop (didn't bet)
Seat 8: KqS/lY/fNB9qUxokm9QfeA mucked
Seat 9: OMhlmt2waO3z43ZSFNMmog folded before Flop (didn't bet)




PokerStars Game #59942018682:  Hold'em No Limit ($0.10/$0.25) - 2009/07/01 1:53:29 ET
Table 'IUwZ/e0bDHZPgsIWx0RnNg' 6-max Seat #1 is the button
Seat 1: V66QiVCQPofyl3a+dpPHQQ ($3.20 in chips) 
Seat 2: mvFHK3pE7tCxJEqLjKC70Q ($54.60 in chips) 
Seat 4: OIjOiBfQstWrK/RuXx7zcw ($10.60 in chips) 
Seat 5: 9bpVv1/Qh9IYtXuCtl5VtQ ($25.20 in chips) 
Seat 6: NhUN/JpAprdJeamFBgJH1w ($38.55 in chips) 
mvFHK3pE7tCxJEqLjKC70Q: posts small blind $0.10
OIjOiBfQstWrK/RuXx7zcw: posts big blind $0.25
*** HOLE CARDS ***
9bpVv1/Qh9IYtXuCtl5VtQ: folds 
NhUN/JpAprdJeamFBgJH1w: raises $0.75 to $1
V66QiVCQPofyl3a+dpPHQQ: calls $1
mvFHK3pE7tCxJEqLjKC70Q: folds 
OIjOiBfQstWrK/RuXx7zcw: folds 
*** FLOP *** [Qd Jh 3s]
NhUN/JpAprdJeamFBgJH1w: bets $2.25
V66QiVCQPofyl3a+dpPHQQ: folds 
Uncalled bet ($2.25) returned to NhUN/JpAprdJeamFBgJH1w
NhUN/JpAprdJeamFBgJH1w collected $2.25 from pot
NhUN/JpAprdJeamFBgJH1w: doesn't show hand 
*** SUMMARY ***
Total pot $2.35 | Rake $0.10 
Board [Qd Jh 3s]
Seat 1: V66QiVCQPofyl3a+dpPHQQ (button) folded on the Flop
Seat 2: mvFHK3pE7tCxJEqLjKC70Q (small blind) folded before Flop
Seat 4: OIjOiBfQstWrK/RuXx7zcw (big blind) folded before Flop
Seat 5: 9bpVv1/Qh9IYtXuCtl5VtQ folded before Flop (didn't bet)
Seat 6: NhUN/JpAprdJeamFBgJH1w collected ($2.25)




PokerStars Game #59942018536:  Hold'em No Limit ($0.10/$0.25) - 2009/07/01 1:53:29 ET
Table '0M5QEJGOThqZwQ/sjbjXYw' 6-max Seat #4 is the button
Seat 2: /gJNBeCkWL4o85/jvlZ4BA ($32.85 in chips) 
Seat 3: 3zD3qLXT1bEffAoWGnc7wg ($28.95 in chips) 
Seat 4: PToTQrV0TmESDzjJftg6QQ ($24.85 in chips) 
Seat 5: cWc85bEzdRzpUMhRKm8pwQ ($53.30 in chips) 
Seat 6: bb63I02U6p9a5MNFa1gCiw ($18.55 in chips) 
cWc85bEzdRzpUMhRKm8pwQ: posts small blind $0.10
bb63I02U6p9a5MNFa1gCiw: posts big blind $0.25
*** HOLE CARDS ***
/gJNBeCkWL4o85/jvlZ4BA: folds 
3zD3qLXT1bEffAoWGnc7wg: raises $0.50 to $0.75
PToTQrV0TmESDzjJftg6QQ: folds 
cWc85bEzdRzpUMhRKm8pwQ: folds 
bb63I02U6p9a5MNFa1gCiw: folds 
Uncalled bet ($0.50) returned to 3zD3qLXT1bEffAoWGnc7wg
3zD3qLXT1bEffAoWGnc7wg collected $0.60 from pot
3zD3qLXT1bEffAoWGnc7wg: doesn't show hand 
*** SUMMARY ***
Total pot $0.60 | Rake $0 
Seat 2: /gJNBeCkWL4o85/jvlZ4BA folded before Flop (didn't bet)
Seat 3: 3zD3qLXT1bEffAoWGnc7wg collected ($0.60)
Seat 4: PToTQrV0TmESDzjJftg6QQ (button) folded before Flop (didn't bet)
Seat 5: cWc85bEzdRzpUMhRKm8pwQ (small blind) folded before Flop
Seat 6: bb63I02U6p9a5MNFa1gCiw (big blind) folded before Flop




