PokerStars Game #59939647390:  Hold'em No Limit ($0.10/$0.25) - 2009/07/01 0:45:16 ET
Table 'xro+BVoe2Zuw1TYmz/McJQ' 9-max Seat #4 is the button
Seat 1: xEQxarad8/T4jJdpZy5LGw ($7.35 in chips) 
Seat 2: MXCztnYJ58KLHMztZvKrxA ($9 in chips) 
Seat 3: COsrwJSFHQtxlUcrYtDQPQ ($36.60 in chips) 
Seat 4: N2LVj3iImgnOoHVf8g0rIw ($24.50 in chips) 
Seat 5: 87Warq49WFhxNpfNtKRmcQ ($27.25 in chips) 
Seat 6: HPEB+AtKw1+C/cxU0o1ciw ($26.25 in chips) 
Seat 7: QEbIGci+itdw+re8RM5fZA ($25 in chips) 
Seat 8: ljemhp25Zg+nlA9DLCIiUw ($24.75 in chips) 
Seat 9: H5Se03ZqSX7tbULXur2MAg ($24.30 in chips) 
87Warq49WFhxNpfNtKRmcQ: posts small blind $0.10
HPEB+AtKw1+C/cxU0o1ciw: posts big blind $0.25
*** HOLE CARDS ***
QEbIGci+itdw+re8RM5fZA: folds 
ljemhp25Zg+nlA9DLCIiUw: folds 
H5Se03ZqSX7tbULXur2MAg: folds 
xEQxarad8/T4jJdpZy5LGw: calls $0.25
MXCztnYJ58KLHMztZvKrxA: calls $0.25
COsrwJSFHQtxlUcrYtDQPQ: folds 
N2LVj3iImgnOoHVf8g0rIw: raises $0.50 to $0.75
87Warq49WFhxNpfNtKRmcQ: folds 
HPEB+AtKw1+C/cxU0o1ciw: folds 
xEQxarad8/T4jJdpZy5LGw: calls $0.50
MXCztnYJ58KLHMztZvKrxA: calls $0.50
*** FLOP *** [3h Qh 4s]
xEQxarad8/T4jJdpZy5LGw: checks 
MXCztnYJ58KLHMztZvKrxA: checks 
N2LVj3iImgnOoHVf8g0rIw: bets $1.50
xEQxarad8/T4jJdpZy5LGw: folds 
MXCztnYJ58KLHMztZvKrxA: folds 
Uncalled bet ($1.50) returned to N2LVj3iImgnOoHVf8g0rIw
N2LVj3iImgnOoHVf8g0rIw collected $2.50 from pot
*** SUMMARY ***
Total pot $2.60 | Rake $0.10 
Board [3h Qh 4s]
Seat 1: xEQxarad8/T4jJdpZy5LGw folded on the Flop
Seat 2: MXCztnYJ58KLHMztZvKrxA folded on the Flop
Seat 3: COsrwJSFHQtxlUcrYtDQPQ folded before Flop (didn't bet)
Seat 4: N2LVj3iImgnOoHVf8g0rIw (button) collected ($2.50)
Seat 5: 87Warq49WFhxNpfNtKRmcQ (small blind) folded before Flop
Seat 6: HPEB+AtKw1+C/cxU0o1ciw (big blind) folded before Flop
Seat 7: QEbIGci+itdw+re8RM5fZA folded before Flop (didn't bet)
Seat 8: ljemhp25Zg+nlA9DLCIiUw folded before Flop (didn't bet)
Seat 9: H5Se03ZqSX7tbULXur2MAg folded before Flop (didn't bet)




PokerStars Game #59939647294:  Hold'em No Limit ($0.10/$0.25) - 2009/07/01 0:45:16 ET
Table 'dVzscin98UhGisTmV9BDcw' 9-max Seat #2 is the button
Seat 1: sBAwXpkpgyhyWbHIQcIJKA ($19.05 in chips) 
Seat 2: dfNim92Z6XK1/h5SFW5vDg ($28.80 in chips) 
Seat 3: 1Clf3cPrqoy/YgvWdWK1Xw ($5 in chips) 
Seat 4: aNpwfA31EREwO+ar4XzBCw ($25.25 in chips) 
Seat 6: hBMUlEpyU74r/fwDgIpXjQ ($28.35 in chips) 
Seat 7: nEg1b6MIksd/4x5eLY735g ($64.65 in chips) 
Seat 8: /vn2Qu2dvc9AMMq46Ae0jA ($4.95 in chips) 
Seat 9: OYa/ZJBO+suuezfWsUMhZw ($5.45 in chips) 
1Clf3cPrqoy/YgvWdWK1Xw: posts small blind $0.10
aNpwfA31EREwO+ar4XzBCw: posts big blind $0.25
22dIObOuor/A+IKWkNoAlA: sits out 
*** HOLE CARDS ***
hBMUlEpyU74r/fwDgIpXjQ: folds 
nEg1b6MIksd/4x5eLY735g: folds 
/vn2Qu2dvc9AMMq46Ae0jA: calls $0.25
OYa/ZJBO+suuezfWsUMhZw: calls $0.25
sBAwXpkpgyhyWbHIQcIJKA: folds 
dfNim92Z6XK1/h5SFW5vDg: folds 
1Clf3cPrqoy/YgvWdWK1Xw: folds 
aNpwfA31EREwO+ar4XzBCw: checks 
*** FLOP *** [4s 5c 7s]
aNpwfA31EREwO+ar4XzBCw: checks 
/vn2Qu2dvc9AMMq46Ae0jA: bets $0.75
OYa/ZJBO+suuezfWsUMhZw: calls $0.75
aNpwfA31EREwO+ar4XzBCw: folds 
*** TURN *** [4s 5c 7s] [Ac]
/vn2Qu2dvc9AMMq46Ae0jA: bets $1.25
OYa/ZJBO+suuezfWsUMhZw: folds 
Uncalled bet ($1.25) returned to /vn2Qu2dvc9AMMq46Ae0jA
/vn2Qu2dvc9AMMq46Ae0jA collected $2.25 from pot
*** SUMMARY ***
Total pot $2.35 | Rake $0.10 
Board [4s 5c 7s Ac]
Seat 1: sBAwXpkpgyhyWbHIQcIJKA folded before Flop (didn't bet)
Seat 2: dfNim92Z6XK1/h5SFW5vDg (button) folded before Flop (didn't bet)
Seat 3: 1Clf3cPrqoy/YgvWdWK1Xw (small blind) folded before Flop
Seat 4: aNpwfA31EREwO+ar4XzBCw (big blind) folded on the Flop
Seat 6: hBMUlEpyU74r/fwDgIpXjQ folded before Flop (didn't bet)
Seat 7: nEg1b6MIksd/4x5eLY735g folded before Flop (didn't bet)
Seat 8: /vn2Qu2dvc9AMMq46Ae0jA collected ($2.25)
Seat 9: OYa/ZJBO+suuezfWsUMhZw folded on the Turn




PokerStars Game #59939647154:  Hold'em No Limit ($0.10/$0.25) - 2009/07/01 0:45:16 ET
Table 'sCop8wmj9zlSS2KJqk1QKQ' 9-max Seat #4 is the button
Seat 1: SXqVW4Q0evTUVZG6BbUNIA ($21.55 in chips) 
Seat 2: W4TLQcZ2TiM73eIgpIvlGg ($23.50 in chips) 
Seat 4: KNrY0Y/j01dK9gZK7dx7QA ($14.55 in chips) 
Seat 5: sD+TKtt36XiiN6jqHiLwDA ($24.75 in chips) 
Seat 6: hZuGwtYmFKPmQ+v1wlmdfA ($43.90 in chips) 
Seat 7: 4dd+rKHhaMiTl5LEkADvQQ ($4.90 in chips) 
Seat 9: tOdE7+08fkUzsTpCnhoPDA ($22.10 in chips) 
sD+TKtt36XiiN6jqHiLwDA: posts small blind $0.10
hZuGwtYmFKPmQ+v1wlmdfA: posts big blind $0.25
opOCI2p6kW0tINuVaAqmcQ: sits out 
*** HOLE CARDS ***
4dd+rKHhaMiTl5LEkADvQQ: folds 
6TWO15+WfJ5HfI8CbJ4a0w leaves the table
tOdE7+08fkUzsTpCnhoPDA: calls $0.25
SXqVW4Q0evTUVZG6BbUNIA: folds 
4dd+rKHhaMiTl5LEkADvQQ leaves the table
W4TLQcZ2TiM73eIgpIvlGg: calls $0.25
KNrY0Y/j01dK9gZK7dx7QA: folds 
sD+TKtt36XiiN6jqHiLwDA: calls $0.15
hZuGwtYmFKPmQ+v1wlmdfA: checks 
*** FLOP *** [Jc 2c 8c]
sD+TKtt36XiiN6jqHiLwDA: checks 
hZuGwtYmFKPmQ+v1wlmdfA: bets $1
tOdE7+08fkUzsTpCnhoPDA: folds 
OwQek9i+x54ZA6dn6e8qhg joins the table at seat #3 
W4TLQcZ2TiM73eIgpIvlGg: raises $2 to $3
sD+TKtt36XiiN6jqHiLwDA: folds 
hZuGwtYmFKPmQ+v1wlmdfA: raises $2 to $5
Q2EDbF7VwaTslnRa/mhhHw joins the table at seat #7 
W4TLQcZ2TiM73eIgpIvlGg: folds 
Uncalled bet ($2) returned to hZuGwtYmFKPmQ+v1wlmdfA
hZuGwtYmFKPmQ+v1wlmdfA collected $6.70 from pot
hZuGwtYmFKPmQ+v1wlmdfA: doesn't show hand 
*** SUMMARY ***
Total pot $7 | Rake $0.30 
Board [Jc 2c 8c]
Seat 1: SXqVW4Q0evTUVZG6BbUNIA folded before Flop (didn't bet)
Seat 2: W4TLQcZ2TiM73eIgpIvlGg folded on the Flop
Seat 4: KNrY0Y/j01dK9gZK7dx7QA (button) folded before Flop (didn't bet)
Seat 5: sD+TKtt36XiiN6jqHiLwDA (small blind) folded on the Flop
Seat 6: hZuGwtYmFKPmQ+v1wlmdfA (big blind) collected ($6.70)
Seat 7: 4dd+rKHhaMiTl5LEkADvQQ folded before Flop (didn't bet)
Seat 9: tOdE7+08fkUzsTpCnhoPDA folded on the Flop




PokerStars Game #59939647678:  Hold'em No Limit ($0.10/$0.25) - 2009/07/01 0:45:17 ET
Table 'edvgY2YQ1I34euq4EVqGnA' 6-max Seat #1 is the button
Seat 1: mvFHK3pE7tCxJEqLjKC70Q ($25.95 in chips) 
Seat 3: HjESR5/RHWT5gaSbIVQQ0Q ($17.85 in chips) 
Seat 4: JFIAqU8lCZ0vWwEl4bdGsg ($30.50 in chips) 
Seat 5: EE16Ua5b1HSsYej5zeXOlA ($25.60 in chips) 
Seat 6: kG34n23qFQA3nzdOJTQ1dA ($68.25 in chips) 
HjESR5/RHWT5gaSbIVQQ0Q: posts small blind $0.10
Icq9naXohH/QOb/LOvZPZQ joins the table at seat #2 
JFIAqU8lCZ0vWwEl4bdGsg: posts big blind $0.25
*** HOLE CARDS ***
EE16Ua5b1HSsYej5zeXOlA: raises $0.60 to $0.85
kG34n23qFQA3nzdOJTQ1dA: folds 
mvFHK3pE7tCxJEqLjKC70Q: calls $0.85
HjESR5/RHWT5gaSbIVQQ0Q: folds 
JFIAqU8lCZ0vWwEl4bdGsg: folds 
*** FLOP *** [Kc 2c 9h]
EE16Ua5b1HSsYej5zeXOlA: checks 
mvFHK3pE7tCxJEqLjKC70Q: bets $1.70
EE16Ua5b1HSsYej5zeXOlA: calls $1.70
*** TURN *** [Kc 2c 9h] [6h]
EE16Ua5b1HSsYej5zeXOlA: checks 
mvFHK3pE7tCxJEqLjKC70Q: bets $4
EE16Ua5b1HSsYej5zeXOlA: calls $4
*** RIVER *** [Kc 2c 9h 6h] [Th]
EE16Ua5b1HSsYej5zeXOlA: checks 
mvFHK3pE7tCxJEqLjKC70Q: checks 
*** SHOW DOWN ***
EE16Ua5b1HSsYej5zeXOlA: shows [Jh Qh] (a flush, Queen high)
mvFHK3pE7tCxJEqLjKC70Q: mucks hand 
EE16Ua5b1HSsYej5zeXOlA collected $12.80 from pot
Icq9naXohH/QOb/LOvZPZQ is disconnected 
*** SUMMARY ***
Total pot $13.45 | Rake $0.65 
Board [Kc 2c 9h 6h Th]
Seat 1: mvFHK3pE7tCxJEqLjKC70Q (button) mucked
Seat 3: HjESR5/RHWT5gaSbIVQQ0Q (small blind) folded before Flop
Seat 4: JFIAqU8lCZ0vWwEl4bdGsg (big blind) folded before Flop
Seat 5: EE16Ua5b1HSsYej5zeXOlA showed [Jh Qh] and won ($12.80) with a flush, Queen high
Seat 6: kG34n23qFQA3nzdOJTQ1dA folded before Flop (didn't bet)




PokerStars Game #59939647660:  Hold'em No Limit ($0.10/$0.25) - 2009/07/01 0:45:17 ET
Table 'BpNkESDX1ip9c0K1hb5h7A' 6-max Seat #1 is the button
Seat 1: 9jSiy0meE9XJKkdIZwyTEQ ($28.90 in chips) 
Seat 2: gqW2aBCmrIw65BvwjTFN6Q ($25.35 in chips) 
Seat 3: cHhVLDikFlByGGN+CM3w/A ($21.75 in chips) 
Seat 5: QvTX2yGq3uKJiKPmns4TKQ ($75.95 in chips) 
Seat 6: iUgsn+WyKFjjVd+tj13R2w ($14.50 in chips) 
gqW2aBCmrIw65BvwjTFN6Q: posts small blind $0.10
cHhVLDikFlByGGN+CM3w/A: posts big blind $0.25
x9VGscBU5oUWy8rQ+Ik80w: sits out 
*** HOLE CARDS ***
QvTX2yGq3uKJiKPmns4TKQ: folds 
iUgsn+WyKFjjVd+tj13R2w: calls $0.25
9jSiy0meE9XJKkdIZwyTEQ: folds 
gqW2aBCmrIw65BvwjTFN6Q: folds 
cHhVLDikFlByGGN+CM3w/A: raises $1.25 to $1.50
iUgsn+WyKFjjVd+tj13R2w: calls $1.25
*** FLOP *** [6h 2c 5s]
cHhVLDikFlByGGN+CM3w/A: bets $2
iUgsn+WyKFjjVd+tj13R2w: folds 
Uncalled bet ($2) returned to cHhVLDikFlByGGN+CM3w/A
cHhVLDikFlByGGN+CM3w/A collected $2.95 from pot
cHhVLDikFlByGGN+CM3w/A: doesn't show hand 
*** SUMMARY ***
Total pot $3.10 | Rake $0.15 
Board [6h 2c 5s]
Seat 1: 9jSiy0meE9XJKkdIZwyTEQ (button) folded before Flop (didn't bet)
Seat 2: gqW2aBCmrIw65BvwjTFN6Q (small blind) folded before Flop
Seat 3: cHhVLDikFlByGGN+CM3w/A (big blind) collected ($2.95)
Seat 5: QvTX2yGq3uKJiKPmns4TKQ folded before Flop (didn't bet)
Seat 6: iUgsn+WyKFjjVd+tj13R2w folded on the Flop




PokerStars Game #59939647698:  Hold'em No Limit ($0.10/$0.25) - 2009/07/01 0:45:17 ET
Table 'o0CDOvKO/bn1WjeymDrXfA' 6-max Seat #4 is the button
Seat 1: 32YL2ZEp8NT4JB2RVM9euQ ($16.25 in chips) 
Seat 2: oc4ZGs0W+3RIg2yPyJw3ig ($30.20 in chips) 
Seat 4: NuqYPwTLZYQhxOoVK3Yqlw ($24.65 in chips) 
Seat 5: u/yN5P9f3KlATg6WLWNkBQ ($28.10 in chips) 
Seat 6: Bada343Si4xKu3fNXY99AA ($31.50 in chips) 
u/yN5P9f3KlATg6WLWNkBQ: posts small blind $0.10
Bada343Si4xKu3fNXY99AA: posts big blind $0.25
EqXTTLKUlDlz7yi6ziyyWA has returned
oc4ZGs0W+3RIg2yPyJw3ig: posts small blind $0.10
*** HOLE CARDS ***
32YL2ZEp8NT4JB2RVM9euQ: folds 
oc4ZGs0W+3RIg2yPyJw3ig: folds 
NuqYPwTLZYQhxOoVK3Yqlw: raises $0.95 to $1.20
u/yN5P9f3KlATg6WLWNkBQ: folds 
Bada343Si4xKu3fNXY99AA: folds 
Uncalled bet ($0.95) returned to NuqYPwTLZYQhxOoVK3Yqlw
NuqYPwTLZYQhxOoVK3Yqlw collected $0.70 from pot
NuqYPwTLZYQhxOoVK3Yqlw: doesn't show hand 
*** SUMMARY ***
Total pot $0.70 | Rake $0 
Seat 1: 32YL2ZEp8NT4JB2RVM9euQ folded before Flop (didn't bet)
Seat 2: oc4ZGs0W+3RIg2yPyJw3ig folded before Flop
Seat 4: NuqYPwTLZYQhxOoVK3Yqlw (button) collected ($0.70)
Seat 5: u/yN5P9f3KlATg6WLWNkBQ (small blind) folded before Flop
Seat 6: Bada343Si4xKu3fNXY99AA (big blind) folded before Flop




PokerStars Game #59939647626:  Hold'em No Limit ($0.10/$0.25) - 2009/07/01 0:45:17 ET
Table 'GxdLtCpYxqT4aAbYqkEEpw' 6-max Seat #6 is the button
Seat 1: heEf/FkFGS9M1NmwH97YIA ($20.90 in chips) 
Seat 2: hADMNbkECXMb2C/C8R2Wlw ($25.70 in chips) 
Seat 3: 9jSiy0meE9XJKkdIZwyTEQ ($48.80 in chips) 
Seat 4: ErIN0JRL5srYjT6en1f8YQ ($28.50 in chips) 
Seat 5: q6WfTUAD9mowIP63ASq2Dg ($39.55 in chips) 
Seat 6: aogAb4Eienxztk8p2v9VVw ($24.15 in chips) 
heEf/FkFGS9M1NmwH97YIA: posts small blind $0.10
hADMNbkECXMb2C/C8R2Wlw: posts big blind $0.25
*** HOLE CARDS ***
9jSiy0meE9XJKkdIZwyTEQ: folds 
ErIN0JRL5srYjT6en1f8YQ: raises $0.50 to $0.75
q6WfTUAD9mowIP63ASq2Dg: calls $0.75
aogAb4Eienxztk8p2v9VVw: folds 
heEf/FkFGS9M1NmwH97YIA: calls $0.65
hADMNbkECXMb2C/C8R2Wlw: folds 
*** FLOP *** [9c Ks 7h]
heEf/FkFGS9M1NmwH97YIA: checks 
ErIN0JRL5srYjT6en1f8YQ: bets $1.25
q6WfTUAD9mowIP63ASq2Dg: folds 
heEf/FkFGS9M1NmwH97YIA: folds 
Uncalled bet ($1.25) returned to ErIN0JRL5srYjT6en1f8YQ
ErIN0JRL5srYjT6en1f8YQ collected $2.40 from pot
ErIN0JRL5srYjT6en1f8YQ: doesn't show hand 
*** SUMMARY ***
Total pot $2.50 | Rake $0.10 
Board [9c Ks 7h]
Seat 1: heEf/FkFGS9M1NmwH97YIA (small blind) folded on the Flop
Seat 2: hADMNbkECXMb2C/C8R2Wlw (big blind) folded before Flop
Seat 3: 9jSiy0meE9XJKkdIZwyTEQ folded before Flop (didn't bet)
Seat 4: ErIN0JRL5srYjT6en1f8YQ collected ($2.40)
Seat 5: q6WfTUAD9mowIP63ASq2Dg folded on the Flop
Seat 6: aogAb4Eienxztk8p2v9VVw (button) folded before Flop (didn't bet)




PokerStars Game #59939647684:  Hold'em No Limit ($0.10/$0.25) - 2009/07/01 0:45:17 ET
Table 'O6cwjhrMn9pfzx1Ngn5zkQ' 6-max Seat #2 is the button
Seat 1: k4mJ9nD/YOVTl8/kGW+U6w ($13.20 in chips) 
Seat 2: M6xK/VklCvdyyrmvzATlxQ ($13.25 in chips) 
Seat 3: EE16Ua5b1HSsYej5zeXOlA ($26.30 in chips) 
Seat 4: wKFJ513ucluNNiMlkXcDOQ ($32.45 in chips) 
Seat 5: niLn0xUVlqh8If80xRjzCA ($22.40 in chips) 
Seat 6: d0J1xuhsynEY81YHwAvJ5g ($27.45 in chips) 
EE16Ua5b1HSsYej5zeXOlA: posts small blind $0.10
wKFJ513ucluNNiMlkXcDOQ: posts big blind $0.25
*** HOLE CARDS ***
niLn0xUVlqh8If80xRjzCA: folds 
d0J1xuhsynEY81YHwAvJ5g: folds 
k4mJ9nD/YOVTl8/kGW+U6w: raises $0.50 to $0.75
M6xK/VklCvdyyrmvzATlxQ: calls $0.75
EE16Ua5b1HSsYej5zeXOlA: calls $0.65
wKFJ513ucluNNiMlkXcDOQ: folds 
*** FLOP *** [Td 2s 9c]
EE16Ua5b1HSsYej5zeXOlA: checks 
k4mJ9nD/YOVTl8/kGW+U6w: checks 
M6xK/VklCvdyyrmvzATlxQ: checks 
*** TURN *** [Td 2s 9c] [7h]
EE16Ua5b1HSsYej5zeXOlA: checks 
k4mJ9nD/YOVTl8/kGW+U6w: checks 
M6xK/VklCvdyyrmvzATlxQ: checks 
*** RIVER *** [Td 2s 9c 7h] [4s]
EE16Ua5b1HSsYej5zeXOlA: checks 
k4mJ9nD/YOVTl8/kGW+U6w: checks 
M6xK/VklCvdyyrmvzATlxQ: checks 
*** SHOW DOWN ***
EE16Ua5b1HSsYej5zeXOlA: shows [5s 6c] (high card Ten)
k4mJ9nD/YOVTl8/kGW+U6w: shows [Ah Kh] (high card Ace)
M6xK/VklCvdyyrmvzATlxQ: mucks hand 
k4mJ9nD/YOVTl8/kGW+U6w collected $2.40 from pot
*** SUMMARY ***
Total pot $2.50 | Rake $0.10 
Board [Td 2s 9c 7h 4s]
Seat 1: k4mJ9nD/YOVTl8/kGW+U6w showed [Ah Kh] and won ($2.40) with high card Ace
Seat 2: M6xK/VklCvdyyrmvzATlxQ (button) mucked
Seat 3: EE16Ua5b1HSsYej5zeXOlA (small blind) showed [5s 6c] and lost with high card Ten
Seat 4: wKFJ513ucluNNiMlkXcDOQ (big blind) folded before Flop
Seat 5: niLn0xUVlqh8If80xRjzCA folded before Flop (didn't bet)
Seat 6: d0J1xuhsynEY81YHwAvJ5g folded before Flop (didn't bet)




PokerStars Game #59939647944:  Hold'em No Limit ($0.10/$0.25) - 2009/07/01 0:45:17 ET
Table 'vZfV/Uj0q8joA1du9sRJSg' 6-max Seat #6 is the button
Seat 1: OAmGQMdOxnvuBNHdADx0ew ($4.85 in chips) 
Seat 2: wMiE3yTbDJGOLOF9th7KPA ($13.60 in chips) 
Seat 3: QJ/0wT0pYdWbDuqo9eNJgQ ($6.10 in chips) 
Seat 4: v+QfkGiuj9bgtuNoVnDO8w ($25.60 in chips) 
Seat 5: FStoHe64SQWqAsjya9pDkQ ($25 in chips) 
Seat 6: 8ClCHtFXGNplITm+63KB+Q ($27.05 in chips) 
OAmGQMdOxnvuBNHdADx0ew: posts small blind $0.10
wMiE3yTbDJGOLOF9th7KPA: posts big blind $0.25
*** HOLE CARDS ***
QJ/0wT0pYdWbDuqo9eNJgQ: folds 
v+QfkGiuj9bgtuNoVnDO8w: folds 
FStoHe64SQWqAsjya9pDkQ: folds 
8ClCHtFXGNplITm+63KB+Q: folds 
OAmGQMdOxnvuBNHdADx0ew: calls $0.15
wMiE3yTbDJGOLOF9th7KPA: checks 
*** FLOP *** [6h Qh Ah]
OAmGQMdOxnvuBNHdADx0ew: checks 
wMiE3yTbDJGOLOF9th7KPA: bets $0.25
OAmGQMdOxnvuBNHdADx0ew: calls $0.25
*** TURN *** [6h Qh Ah] [Th]
OAmGQMdOxnvuBNHdADx0ew: checks 
wMiE3yTbDJGOLOF9th7KPA: bets $0.50
OAmGQMdOxnvuBNHdADx0ew: folds 
Uncalled bet ($0.50) returned to wMiE3yTbDJGOLOF9th7KPA
wMiE3yTbDJGOLOF9th7KPA collected $0.95 from pot
wMiE3yTbDJGOLOF9th7KPA: doesn't show hand 
*** SUMMARY ***
Total pot $1 | Rake $0.05 
Board [6h Qh Ah Th]
Seat 1: OAmGQMdOxnvuBNHdADx0ew (small blind) folded on the Turn
Seat 2: wMiE3yTbDJGOLOF9th7KPA (big blind) collected ($0.95)
Seat 3: QJ/0wT0pYdWbDuqo9eNJgQ folded before Flop (didn't bet)
Seat 4: v+QfkGiuj9bgtuNoVnDO8w folded before Flop (didn't bet)
Seat 5: FStoHe64SQWqAsjya9pDkQ folded before Flop (didn't bet)
Seat 6: 8ClCHtFXGNplITm+63KB+Q (button) folded before Flop (didn't bet)




PokerStars Game #59939647440:  Hold'em No Limit ($0.10/$0.25) - 2009/07/01 0:45:17 ET
Table 'djcjiEGabFQO0MNG6jEeJQ' 9-max Seat #5 is the button
Seat 1: K7bAhhMMJ/XcTmGaBZVfFQ ($23.80 in chips) 
Seat 3: 1S/fpm+f42V/6MNZre+ccg ($27.95 in chips) 
Seat 4: E6WojUZ5V/6opnfMNTSjXQ ($12.25 in chips) 
Seat 5: cZ99hugmLBj9KhTlc8nCSw ($40.95 in chips) 
Seat 6: aNpwfA31EREwO+ar4XzBCw ($59.30 in chips) 
Seat 7: 56S3mA6Zs3pGR+0p0vUCtg ($30.45 in chips) 
Seat 8: +sbyWwIcFp9kP0bDtMegfQ ($54.30 in chips) 
Seat 9: HPEB+AtKw1+C/cxU0o1ciw ($47.65 in chips) 
aNpwfA31EREwO+ar4XzBCw: posts small blind $0.10
56S3mA6Zs3pGR+0p0vUCtg: posts big blind $0.25
*** HOLE CARDS ***
+sbyWwIcFp9kP0bDtMegfQ: folds 
HPEB+AtKw1+C/cxU0o1ciw: folds 
K7bAhhMMJ/XcTmGaBZVfFQ: folds 
1S/fpm+f42V/6MNZre+ccg: folds 
E6WojUZ5V/6opnfMNTSjXQ: calls $0.25
cZ99hugmLBj9KhTlc8nCSw: folds 
aNpwfA31EREwO+ar4XzBCw: folds 
56S3mA6Zs3pGR+0p0vUCtg: checks 
*** FLOP *** [3c Jh 9c]
56S3mA6Zs3pGR+0p0vUCtg: checks 
E6WojUZ5V/6opnfMNTSjXQ: bets $2
56S3mA6Zs3pGR+0p0vUCtg: folds 
Uncalled bet ($2) returned to E6WojUZ5V/6opnfMNTSjXQ
E6WojUZ5V/6opnfMNTSjXQ collected $0.60 from pot
*** SUMMARY ***
Total pot $0.60 | Rake $0 
Board [3c Jh 9c]
Seat 1: K7bAhhMMJ/XcTmGaBZVfFQ folded before Flop (didn't bet)
Seat 3: 1S/fpm+f42V/6MNZre+ccg folded before Flop (didn't bet)
Seat 4: E6WojUZ5V/6opnfMNTSjXQ collected ($0.60)
Seat 5: cZ99hugmLBj9KhTlc8nCSw (button) folded before Flop (didn't bet)
Seat 6: aNpwfA31EREwO+ar4XzBCw (small blind) folded before Flop
Seat 7: 56S3mA6Zs3pGR+0p0vUCtg (big blind) folded on the Flop
Seat 8: +sbyWwIcFp9kP0bDtMegfQ folded before Flop (didn't bet)
Seat 9: HPEB+AtKw1+C/cxU0o1ciw folded before Flop (didn't bet)




PokerStars Game #59939647764:  Hold'em No Limit ($0.10/$0.25) - 2009/07/01 0:45:17 ET
Table 'Qk/910N2Yhg8u5vqTJk50Q' 9-max Seat #1 is the button
Seat 1: zDrucyjVn5aeekNEc3cJrA ($24.75 in chips) 
Seat 2: Th3FldXKQW6hWVVPahaoOQ ($37.80 in chips) 
Seat 3: ghNKXUBl/H+t83JF079ZBA ($25 in chips) 
Seat 4: 33y9+GmQ3J84RvZXcraRTw ($21.20 in chips) 
Seat 5: 4oA316mXLIui1QY63GXBUg ($27 in chips) 
Seat 6: Uupj2MGlo48VpA/VyYrfrw ($5.55 in chips) 
Seat 8: H5Se03ZqSX7tbULXur2MAg ($25.50 in chips) 
Seat 9: M2QO2DxB5Wawg2h8HSpnYA ($19.05 in chips) 
Th3FldXKQW6hWVVPahaoOQ: posts small blind $0.10
ghNKXUBl/H+t83JF079ZBA: posts big blind $0.25
*** HOLE CARDS ***
33y9+GmQ3J84RvZXcraRTw: calls $0.25
TooKool4You leaves the table
4oA316mXLIui1QY63GXBUg: folds 
Uupj2MGlo48VpA/VyYrfrw: calls $0.25
H5Se03ZqSX7tbULXur2MAg: folds 
M2QO2DxB5Wawg2h8HSpnYA: folds 
aNpwfA31EREwO+ar4XzBCw joins the table at seat #7 
zDrucyjVn5aeekNEc3cJrA: folds 
Th3FldXKQW6hWVVPahaoOQ: folds 
ghNKXUBl/H+t83JF079ZBA: checks 
*** FLOP *** [3c 3d 9s]
ghNKXUBl/H+t83JF079ZBA: checks 
33y9+GmQ3J84RvZXcraRTw: checks 
Uupj2MGlo48VpA/VyYrfrw: bets $0.25
ghNKXUBl/H+t83JF079ZBA: folds 
33y9+GmQ3J84RvZXcraRTw: calls $0.25
*** TURN *** [3c 3d 9s] [Qc]
33y9+GmQ3J84RvZXcraRTw: checks 
Uupj2MGlo48VpA/VyYrfrw: bets $1
33y9+GmQ3J84RvZXcraRTw: folds 
Uncalled bet ($1) returned to Uupj2MGlo48VpA/VyYrfrw
Uupj2MGlo48VpA/VyYrfrw collected $1.30 from pot
Uupj2MGlo48VpA/VyYrfrw: doesn't show hand 
*** SUMMARY ***
Total pot $1.35 | Rake $0.05 
Board [3c 3d 9s Qc]
Seat 1: zDrucyjVn5aeekNEc3cJrA (button) folded before Flop (didn't bet)
Seat 2: Th3FldXKQW6hWVVPahaoOQ (small blind) folded before Flop
Seat 3: ghNKXUBl/H+t83JF079ZBA (big blind) folded on the Flop
Seat 4: 33y9+GmQ3J84RvZXcraRTw folded on the Turn
Seat 5: 4oA316mXLIui1QY63GXBUg folded before Flop (didn't bet)
Seat 6: Uupj2MGlo48VpA/VyYrfrw collected ($1.30)
Seat 8: H5Se03ZqSX7tbULXur2MAg folded before Flop (didn't bet)
Seat 9: M2QO2DxB5Wawg2h8HSpnYA folded before Flop (didn't bet)




PokerStars Game #59939647726:  Hold'em No Limit ($0.10/$0.25) - 2009/07/01 0:45:17 ET
Table '/AhP8uWRzEEhOATYIdmn0A' 9-max Seat #2 is the button
Seat 1: +sbyWwIcFp9kP0bDtMegfQ ($23.40 in chips) 
Seat 2: nvWCCH1JBjMjQkSaXl2Mog ($16.70 in chips) 
Seat 3: vSkQm2EelzwRGDDQQk0Fqw ($4.75 in chips) 
Seat 4: +WMpj67YqG8ilNkg2JwXpw ($15 in chips) 
Seat 5: BEIBUu2pIflPrCL+Iks4CQ ($13.50 in chips) 
Seat 7: 4oA316mXLIui1QY63GXBUg ($29.90 in chips) 
Seat 8: CYkY0dNBaYaKs8HVCVn3mQ ($5.85 in chips) 
Seat 9: DIBbjEYGs+TVdVgEB/4+3w ($29.25 in chips) 
vSkQm2EelzwRGDDQQk0Fqw: posts small blind $0.10
+WMpj67YqG8ilNkg2JwXpw: posts big blind $0.25
*** HOLE CARDS ***
BEIBUu2pIflPrCL+Iks4CQ: raises $0.50 to $0.75
4oA316mXLIui1QY63GXBUg: folds 
CYkY0dNBaYaKs8HVCVn3mQ: folds 
DIBbjEYGs+TVdVgEB/4+3w: folds 
+sbyWwIcFp9kP0bDtMegfQ: folds 
nvWCCH1JBjMjQkSaXl2Mog: folds 
vSkQm2EelzwRGDDQQk0Fqw: folds 
+WMpj67YqG8ilNkg2JwXpw: folds 
Uncalled bet ($0.50) returned to BEIBUu2pIflPrCL+Iks4CQ
BEIBUu2pIflPrCL+Iks4CQ collected $0.60 from pot
BEIBUu2pIflPrCL+Iks4CQ: doesn't show hand 
*** SUMMARY ***
Total pot $0.60 | Rake $0 
Seat 1: +sbyWwIcFp9kP0bDtMegfQ folded before Flop (didn't bet)
Seat 2: nvWCCH1JBjMjQkSaXl2Mog (button) folded before Flop (didn't bet)
Seat 3: vSkQm2EelzwRGDDQQk0Fqw (small blind) folded before Flop
Seat 4: +WMpj67YqG8ilNkg2JwXpw (big blind) folded before Flop
Seat 5: BEIBUu2pIflPrCL+Iks4CQ collected ($0.60)
Seat 7: 4oA316mXLIui1QY63GXBUg folded before Flop (didn't bet)
Seat 8: CYkY0dNBaYaKs8HVCVn3mQ folded before Flop (didn't bet)
Seat 9: DIBbjEYGs+TVdVgEB/4+3w folded before Flop (didn't bet)




PokerStars Game #59939648378:  Hold'em No Limit ($0.10/$0.25) - 2009/07/01 0:45:18 ET
Table 'mdub7rJf3Z5tCT9s/+1+Wg' 9-max Seat #4 is the button
Seat 1: neWdS67T0XWLJXFjrqXj5g ($15.15 in chips) 
Seat 3: t2nb95S5EEFOEzNx9Itz0g ($4.65 in chips) 
Seat 4: fDGyaQz0cs2s4FOYxkbIHA ($14.65 in chips) 
Seat 5: dfNim92Z6XK1/h5SFW5vDg ($25 in chips) 
Seat 6: hAFbY0iBwr4mouozgvjZBg ($49.85 in chips) 
Seat 7: woe+9KKk+L3pZgMTuHcmog ($32.05 in chips) 
Seat 8: cZ99hugmLBj9KhTlc8nCSw ($25 in chips) 
Seat 9: tYsOBqdU1+x+yFI7zHO7hQ ($36.40 in chips) 
dfNim92Z6XK1/h5SFW5vDg: posts small blind $0.10
hAFbY0iBwr4mouozgvjZBg: posts big blind $0.25
*** HOLE CARDS ***
woe+9KKk+L3pZgMTuHcmog: folds 
cZ99hugmLBj9KhTlc8nCSw: folds 
tYsOBqdU1+x+yFI7zHO7hQ: folds 
neWdS67T0XWLJXFjrqXj5g: folds 
t2nb95S5EEFOEzNx9Itz0g: folds 
fDGyaQz0cs2s4FOYxkbIHA: folds 
dfNim92Z6XK1/h5SFW5vDg: calls $0.15
hAFbY0iBwr4mouozgvjZBg: checks 
*** FLOP *** [Qh Qc 2h]
dfNim92Z6XK1/h5SFW5vDg: checks 
hAFbY0iBwr4mouozgvjZBg: checks 
*** TURN *** [Qh Qc 2h] [6s]
dfNim92Z6XK1/h5SFW5vDg: checks 
hAFbY0iBwr4mouozgvjZBg: bets $0.25
dfNim92Z6XK1/h5SFW5vDg: calls $0.25
*** RIVER *** [Qh Qc 2h 6s] [5s]
dfNim92Z6XK1/h5SFW5vDg: checks 
hAFbY0iBwr4mouozgvjZBg: checks 
*** SHOW DOWN ***
dfNim92Z6XK1/h5SFW5vDg: shows [Ah 6d] (two pair, Queens and Sixes)
hAFbY0iBwr4mouozgvjZBg: mucks hand 
dfNim92Z6XK1/h5SFW5vDg collected $0.95 from pot
*** SUMMARY ***
Total pot $1 | Rake $0.05 
Board [Qh Qc 2h 6s 5s]
Seat 1: neWdS67T0XWLJXFjrqXj5g folded before Flop (didn't bet)
Seat 3: t2nb95S5EEFOEzNx9Itz0g folded before Flop (didn't bet)
Seat 4: fDGyaQz0cs2s4FOYxkbIHA (button) folded before Flop (didn't bet)
Seat 5: dfNim92Z6XK1/h5SFW5vDg (small blind) showed [Ah 6d] and won ($0.95) with two pair, Queens and Sixes
Seat 6: hAFbY0iBwr4mouozgvjZBg (big blind) mucked
Seat 7: woe+9KKk+L3pZgMTuHcmog folded before Flop (didn't bet)
Seat 8: cZ99hugmLBj9KhTlc8nCSw folded before Flop (didn't bet)
Seat 9: tYsOBqdU1+x+yFI7zHO7hQ folded before Flop (didn't bet)




PokerStars Game #59939648120:  Hold'em No Limit ($0.10/$0.25) - 2009/07/01 0:45:18 ET
Table '3EebBlzq5yHSY2444L4zlg' 9-max Seat #5 is the button
Seat 1: 8B/dhbQjIWe6ASCdgzktNQ ($32.25 in chips) 
Seat 2: MIVCHqCqqlke0Lb0z7glcw ($24.35 in chips) 
Seat 3: IGbD5vKNhHe60dkdbjg/mw ($22.35 in chips) 
Seat 4: 1S/fpm+f42V/6MNZre+ccg ($25.10 in chips) 
Seat 5: 22Ph+hChb2fjC5+yk/mOew ($23.50 in chips) 
Seat 6: QEbIGci+itdw+re8RM5fZA ($27.90 in chips) 
Seat 7: DiSvPC2iudwL5j9u6Huyww ($27.90 in chips) 
Seat 8: Qi+clOtyDiibLdH2/1Qy8g ($27.85 in chips) 
Seat 9: GTcLfsDTPqgfHyhY9FNDMw ($10.65 in chips) 
QEbIGci+itdw+re8RM5fZA: posts small blind $0.10
DiSvPC2iudwL5j9u6Huyww: posts big blind $0.25
*** HOLE CARDS ***
Qi+clOtyDiibLdH2/1Qy8g: folds 
Qi+clOtyDiibLdH2/1Qy8g leaves the table
GTcLfsDTPqgfHyhY9FNDMw: folds 
8B/dhbQjIWe6ASCdgzktNQ: raises $0.75 to $1
MIVCHqCqqlke0Lb0z7glcw: folds 
IGbD5vKNhHe60dkdbjg/mw: folds 
1S/fpm+f42V/6MNZre+ccg: folds 
22Ph+hChb2fjC5+yk/mOew: calls $1
QEbIGci+itdw+re8RM5fZA: folds 
j97ZRZFRWNUsBUL7hv78tA joins the table at seat #8 
DiSvPC2iudwL5j9u6Huyww: folds 
*** FLOP *** [Qh 5s Jh]
8B/dhbQjIWe6ASCdgzktNQ: checks 
22Ph+hChb2fjC5+yk/mOew: checks 
*** TURN *** [Qh 5s Jh] [Th]
8B/dhbQjIWe6ASCdgzktNQ: checks 
22Ph+hChb2fjC5+yk/mOew: checks 
*** RIVER *** [Qh 5s Jh Th] [4h]
8B/dhbQjIWe6ASCdgzktNQ: checks 
22Ph+hChb2fjC5+yk/mOew: bets $0.50
8B/dhbQjIWe6ASCdgzktNQ: folds 
Uncalled bet ($0.50) returned to 22Ph+hChb2fjC5+yk/mOew
22Ph+hChb2fjC5+yk/mOew collected $2.25 from pot
22Ph+hChb2fjC5+yk/mOew: doesn't show hand 
*** SUMMARY ***
Total pot $2.35 | Rake $0.10 
Board [Qh 5s Jh Th 4h]
Seat 1: 8B/dhbQjIWe6ASCdgzktNQ folded on the River
Seat 2: MIVCHqCqqlke0Lb0z7glcw folded before Flop (didn't bet)
Seat 3: IGbD5vKNhHe60dkdbjg/mw folded before Flop (didn't bet)
Seat 4: 1S/fpm+f42V/6MNZre+ccg folded before Flop (didn't bet)
Seat 5: 22Ph+hChb2fjC5+yk/mOew (button) collected ($2.25)
Seat 6: QEbIGci+itdw+re8RM5fZA (small blind) folded before Flop
Seat 7: DiSvPC2iudwL5j9u6Huyww (big blind) folded before Flop
Seat 8: Qi+clOtyDiibLdH2/1Qy8g folded before Flop (didn't bet)
Seat 9: GTcLfsDTPqgfHyhY9FNDMw folded before Flop (didn't bet)




PokerStars Game #59939648070:  Hold'em No Limit ($0.10/$0.25) - 2009/07/01 0:45:18 ET
Table '7eunnLa5p3aGsPrUrNnn/A' 9-max Seat #2 is the button
Seat 1: Ml2bY77EHbM51ZWD7dnIWg ($33.65 in chips) 
Seat 2: aJy680tKSaP5er559aSuGA ($11.90 in chips) 
Seat 3: E0iYnEVO2ho7dH3QcCjw7g ($20.55 in chips) 
Seat 4: opOCI2p6kW0tINuVaAqmcQ ($29.20 in chips) 
Seat 5: JLfmdpDbz2ljMNE7ICboMQ ($6.85 in chips) 
Seat 6: jx9kXw1SAZrvXp9Nerz8+Q ($16.10 in chips) 
Seat 7: sD+TKtt36XiiN6jqHiLwDA ($24.40 in chips) 
Seat 8: 1Clf3cPrqoy/YgvWdWK1Xw ($5 in chips) 
Seat 9: rUpvA02nErFvZ4yFbDR8XA ($20.20 in chips) 
E0iYnEVO2ho7dH3QcCjw7g: posts small blind $0.10
opOCI2p6kW0tINuVaAqmcQ: posts big blind $0.25
*** HOLE CARDS ***
JLfmdpDbz2ljMNE7ICboMQ: calls $0.25
jx9kXw1SAZrvXp9Nerz8+Q: folds 
sD+TKtt36XiiN6jqHiLwDA: folds 
1Clf3cPrqoy/YgvWdWK1Xw: folds 
rUpvA02nErFvZ4yFbDR8XA: folds 
Ml2bY77EHbM51ZWD7dnIWg: folds 
aJy680tKSaP5er559aSuGA: folds 
E0iYnEVO2ho7dH3QcCjw7g: calls $0.15
opOCI2p6kW0tINuVaAqmcQ: checks 
*** FLOP *** [5h 8h Qs]
E0iYnEVO2ho7dH3QcCjw7g: checks 
opOCI2p6kW0tINuVaAqmcQ: checks 
JLfmdpDbz2ljMNE7ICboMQ: checks 
*** TURN *** [5h 8h Qs] [2c]
Ml2bY77EHbM51ZWD7dnIWg leaves the table
E0iYnEVO2ho7dH3QcCjw7g: checks 
22dIObOuor/A+IKWkNoAlA joins the table at seat #1 
opOCI2p6kW0tINuVaAqmcQ: checks 
JLfmdpDbz2ljMNE7ICboMQ: bets $1
E0iYnEVO2ho7dH3QcCjw7g: folds 
opOCI2p6kW0tINuVaAqmcQ: folds 
Uncalled bet ($1) returned to JLfmdpDbz2ljMNE7ICboMQ
JLfmdpDbz2ljMNE7ICboMQ collected $0.75 from pot
*** SUMMARY ***
Total pot $0.75 | Rake $0 
Board [5h 8h Qs 2c]
Seat 1: Ml2bY77EHbM51ZWD7dnIWg folded before Flop (didn't bet)
Seat 2: aJy680tKSaP5er559aSuGA (button) folded before Flop (didn't bet)
Seat 3: E0iYnEVO2ho7dH3QcCjw7g (small blind) folded on the Turn
Seat 4: opOCI2p6kW0tINuVaAqmcQ (big blind) folded on the Turn
Seat 5: JLfmdpDbz2ljMNE7ICboMQ collected ($0.75)
Seat 6: jx9kXw1SAZrvXp9Nerz8+Q folded before Flop (didn't bet)
Seat 7: sD+TKtt36XiiN6jqHiLwDA folded before Flop (didn't bet)
Seat 8: 1Clf3cPrqoy/YgvWdWK1Xw folded before Flop (didn't bet)
Seat 9: rUpvA02nErFvZ4yFbDR8XA folded before Flop (didn't bet)




PokerStars Game #59939648186:  Hold'em No Limit ($0.10/$0.25) - 2009/07/01 0:45:18 ET
Table 'Xi38lWH8L2JHRAsKYVX8Qg' 6-max Seat #2 is the button
Seat 1: AqQ7DFpHkgIzTwDu+rClcg ($5.90 in chips) 
Seat 2: 7iL6KfkJTFbyWmnLYk4+AA ($30.75 in chips) 
Seat 3: 6DwBRH+xZ12AAZmeAg+aXw ($25 in chips) 
Seat 4: kG34n23qFQA3nzdOJTQ1dA ($25.80 in chips) 
Seat 5: 79ID/ub1Pt/mDpCprVmOoA ($26.10 in chips) 
Seat 6: aogAb4Eienxztk8p2v9VVw ($10.55 in chips) 
6DwBRH+xZ12AAZmeAg+aXw: posts small blind $0.10
kG34n23qFQA3nzdOJTQ1dA: posts big blind $0.25
*** HOLE CARDS ***
79ID/ub1Pt/mDpCprVmOoA: folds 
aogAb4Eienxztk8p2v9VVw: folds 
AqQ7DFpHkgIzTwDu+rClcg: raises $0.50 to $0.75
7iL6KfkJTFbyWmnLYk4+AA: folds 
6DwBRH+xZ12AAZmeAg+aXw: folds 
kG34n23qFQA3nzdOJTQ1dA: folds 
Uncalled bet ($0.50) returned to AqQ7DFpHkgIzTwDu+rClcg
AqQ7DFpHkgIzTwDu+rClcg collected $0.60 from pot
*** SUMMARY ***
Total pot $0.60 | Rake $0 
Seat 1: AqQ7DFpHkgIzTwDu+rClcg collected ($0.60)
Seat 2: 7iL6KfkJTFbyWmnLYk4+AA (button) folded before Flop (didn't bet)
Seat 3: 6DwBRH+xZ12AAZmeAg+aXw (small blind) folded before Flop
Seat 4: kG34n23qFQA3nzdOJTQ1dA (big blind) folded before Flop
Seat 5: 79ID/ub1Pt/mDpCprVmOoA folded before Flop (didn't bet)
Seat 6: aogAb4Eienxztk8p2v9VVw folded before Flop (didn't bet)




PokerStars Game #59939648078:  Hold'em No Limit ($0.10/$0.25) - 2009/07/01 0:45:18 ET
Table 'vud0GB/ZlDCvUFhBFIaTlg' 9-max Seat #9 is the button
Seat 4: ss810etqPS9ni/HJIweF/g ($8.25 in chips) 
Seat 5: AwAabNdwDsTMb3aTomdOmg ($7.15 in chips) 
Seat 9: ROo8kPnsdL612mO7wzI5Bg ($7.75 in chips) 
ss810etqPS9ni/HJIweF/g: posts small blind $0.10
AwAabNdwDsTMb3aTomdOmg: posts big blind $0.25
Am29qRe4OYkVWs70NjNDBw: sits out 
*** HOLE CARDS ***
ROo8kPnsdL612mO7wzI5Bg: folds 
ss810etqPS9ni/HJIweF/g: raises $0.25 to $0.50
NDJWZaU2QihSadZB98k0tg joins the table at seat #6 
AwAabNdwDsTMb3aTomdOmg: calls $0.25
*** FLOP *** [Tc 2h 5c]
DHobes12 joins the table at seat #2 
ss810etqPS9ni/HJIweF/g: bets $0.25
AwAabNdwDsTMb3aTomdOmg: calls $0.25
*** TURN *** [Tc 2h 5c] [8s]
ss810etqPS9ni/HJIweF/g: bets $0.25
AwAabNdwDsTMb3aTomdOmg: raises $0.25 to $0.50
ss810etqPS9ni/HJIweF/g: calls $0.25
*** RIVER *** [Tc 2h 5c 8s] [9c]
ss810etqPS9ni/HJIweF/g: bets $0.25
AwAabNdwDsTMb3aTomdOmg: raises $1 to $1.25
ss810etqPS9ni/HJIweF/g: folds 
Uncalled bet ($1) returned to AwAabNdwDsTMb3aTomdOmg
AwAabNdwDsTMb3aTomdOmg collected $2.90 from pot
*** SUMMARY ***
Total pot $3 | Rake $0.10 
Board [Tc 2h 5c 8s 9c]
Seat 4: ss810etqPS9ni/HJIweF/g (small blind) folded on the River
Seat 5: AwAabNdwDsTMb3aTomdOmg (big blind) collected ($2.90)
Seat 9: ROo8kPnsdL612mO7wzI5Bg (button) folded before Flop (didn't bet)




PokerStars Game #59939648132:  Hold'em No Limit ($0.10/$0.25) - 2009/07/01 0:45:18 ET
Table '8Z6T3ssCpo3VV849U4RgBw' 9-max Seat #4 is the button
Seat 1: 8dNQBtNvCvzVgSnmDgi/LA ($11.65 in chips) 
Seat 3: DdPXdieucQ+n99u1n3A+rQ ($4.90 in chips) 
Seat 4: swWFmLwqgpSU1P6HAmCGPw ($15.65 in chips) 
Seat 5: zDrucyjVn5aeekNEc3cJrA ($22.80 in chips) 
Seat 7: VBHxUExRAMrbxUq/cVx9Gw ($5 in chips) 
Seat 8: hPhp/RE3cJ5YGaQ2xOHXXg ($3.90 in chips) 
Seat 9: yfkbMbx4w7MXhQDFPxOq0A ($19.05 in chips) 
zDrucyjVn5aeekNEc3cJrA: posts small blind $0.10
SXqVW4Q0evTUVZG6BbUNIA: is sitting out 
VBHxUExRAMrbxUq/cVx9Gw: posts big blind $0.25
*** HOLE CARDS ***
SXqVW4Q0evTUVZG6BbUNIA leaves the table
hPhp/RE3cJ5YGaQ2xOHXXg: folds 
yfkbMbx4w7MXhQDFPxOq0A: folds 
8dNQBtNvCvzVgSnmDgi/LA: folds 
DdPXdieucQ+n99u1n3A+rQ: folds 
swWFmLwqgpSU1P6HAmCGPw: calls $0.25
zDrucyjVn5aeekNEc3cJrA: calls $0.15
VBHxUExRAMrbxUq/cVx9Gw: checks 
*** FLOP *** [Ad Kc 4h]
zDrucyjVn5aeekNEc3cJrA: checks 
VBHxUExRAMrbxUq/cVx9Gw: checks 
swWFmLwqgpSU1P6HAmCGPw: checks 
*** TURN *** [Ad Kc 4h] [6h]
zDrucyjVn5aeekNEc3cJrA: checks 
VBHxUExRAMrbxUq/cVx9Gw: checks 
swWFmLwqgpSU1P6HAmCGPw: checks 
*** RIVER *** [Ad Kc 4h 6h] [Ah]
zDrucyjVn5aeekNEc3cJrA: checks 
VBHxUExRAMrbxUq/cVx9Gw: checks 
swWFmLwqgpSU1P6HAmCGPw: bets $0.50
zDrucyjVn5aeekNEc3cJrA: folds 
VBHxUExRAMrbxUq/cVx9Gw: calls $0.50
*** SHOW DOWN ***
swWFmLwqgpSU1P6HAmCGPw: shows [5s Qs] (a pair of Aces)
VBHxUExRAMrbxUq/cVx9Gw: shows [3c 3s] (two pair, Aces and Threes)
VBHxUExRAMrbxUq/cVx9Gw collected $1.70 from pot
y2juVuWuW+u1THo3kosjLQ joins the table at seat #2 
*** SUMMARY ***
Total pot $1.75 | Rake $0.05 
Board [Ad Kc 4h 6h Ah]
Seat 1: 8dNQBtNvCvzVgSnmDgi/LA folded before Flop (didn't bet)
Seat 3: DdPXdieucQ+n99u1n3A+rQ folded before Flop (didn't bet)
Seat 4: swWFmLwqgpSU1P6HAmCGPw (button) showed [5s Qs] and lost with a pair of Aces
Seat 5: zDrucyjVn5aeekNEc3cJrA (small blind) folded on the River
Seat 7: VBHxUExRAMrbxUq/cVx9Gw (big blind) showed [3c 3s] and won ($1.70) with two pair, Aces and Threes
Seat 8: hPhp/RE3cJ5YGaQ2xOHXXg folded before Flop (didn't bet)
Seat 9: yfkbMbx4w7MXhQDFPxOq0A folded before Flop (didn't bet)




PokerStars Game #59939648950:  Hold'em No Limit ($0.10/$0.25) - 2009/07/01 0:45:19 ET
Table 'IUwZ/e0bDHZPgsIWx0RnNg' 6-max Seat #3 is the button
Seat 1: 8JTm/CXBn3+kuQgcUOgPkw ($24.40 in chips) 
Seat 2: mvFHK3pE7tCxJEqLjKC70Q ($30.35 in chips) 
Seat 3: dOX4wnYV2sEqvDbF+8KSCw ($25.35 in chips) 
Seat 4: IyZ9SVxKy7TJvRGFneWTMg ($29.75 in chips) 
Seat 5: wsP46AGpqDjHZQmlRHKa9g ($25.50 in chips) 
Seat 6: NhUN/JpAprdJeamFBgJH1w ($25 in chips) 
IyZ9SVxKy7TJvRGFneWTMg: posts small blind $0.10
wsP46AGpqDjHZQmlRHKa9g: posts big blind $0.25
*** HOLE CARDS ***
NhUN/JpAprdJeamFBgJH1w: folds 
8JTm/CXBn3+kuQgcUOgPkw: calls $0.25
mvFHK3pE7tCxJEqLjKC70Q: folds 
dOX4wnYV2sEqvDbF+8KSCw: folds 
IyZ9SVxKy7TJvRGFneWTMg: folds 
wsP46AGpqDjHZQmlRHKa9g: checks 
*** FLOP *** [5h Tc 9d]
wsP46AGpqDjHZQmlRHKa9g: checks 
8JTm/CXBn3+kuQgcUOgPkw: bets $0.25
wsP46AGpqDjHZQmlRHKa9g: folds 
Uncalled bet ($0.25) returned to 8JTm/CXBn3+kuQgcUOgPkw
8JTm/CXBn3+kuQgcUOgPkw collected $0.60 from pot
8JTm/CXBn3+kuQgcUOgPkw: doesn't show hand 
*** SUMMARY ***
Total pot $0.60 | Rake $0 
Board [5h Tc 9d]
Seat 1: 8JTm/CXBn3+kuQgcUOgPkw collected ($0.60)
Seat 2: mvFHK3pE7tCxJEqLjKC70Q folded before Flop (didn't bet)
Seat 3: dOX4wnYV2sEqvDbF+8KSCw (button) folded before Flop (didn't bet)
Seat 4: IyZ9SVxKy7TJvRGFneWTMg (small blind) folded before Flop
Seat 5: wsP46AGpqDjHZQmlRHKa9g (big blind) folded on the Flop
Seat 6: NhUN/JpAprdJeamFBgJH1w folded before Flop (didn't bet)




PokerStars Game #59939649134:  Hold'em No Limit ($0.10/$0.25) - 2009/07/01 0:45:19 ET
Table 'AJGgX1ZYM8d68SWMvaLttg' 6-max Seat #6 is the button
Seat 1: sT4sjqzVMH/fZHz0hkbIPw ($43.85 in chips) 
Seat 2: zHHLkD2sRljslKKeQv/ZQw ($30.10 in chips) 
Seat 3: 4x9jCqgSw4272dnaIqnanw ($7 in chips) 
Seat 4: Lz/GjRDgmgepqTR7qmS86w ($14.80 in chips) 
Seat 5: SFmT9ZsVopnukjvAzrxTRg ($26.75 in chips) 
Seat 6: UA5OsKS3VPaxa7uC8La/kA ($27.40 in chips) 
sT4sjqzVMH/fZHz0hkbIPw: posts small blind $0.10
zHHLkD2sRljslKKeQv/ZQw: posts big blind $0.25
*** HOLE CARDS ***
4x9jCqgSw4272dnaIqnanw: folds 
Lz/GjRDgmgepqTR7qmS86w: folds 
SFmT9ZsVopnukjvAzrxTRg: raises $0.75 to $1
UA5OsKS3VPaxa7uC8La/kA: folds 
sT4sjqzVMH/fZHz0hkbIPw: calls $0.90
zHHLkD2sRljslKKeQv/ZQw: calls $0.75
*** FLOP *** [4s 8d 8c]
sT4sjqzVMH/fZHz0hkbIPw: bets $1.75
zHHLkD2sRljslKKeQv/ZQw: folds 
SFmT9ZsVopnukjvAzrxTRg: folds 
Uncalled bet ($1.75) returned to sT4sjqzVMH/fZHz0hkbIPw
sT4sjqzVMH/fZHz0hkbIPw collected $2.85 from pot
sT4sjqzVMH/fZHz0hkbIPw: doesn't show hand 
*** SUMMARY ***
Total pot $3 | Rake $0.15 
Board [4s 8d 8c]
Seat 1: sT4sjqzVMH/fZHz0hkbIPw (small blind) collected ($2.85)
Seat 2: zHHLkD2sRljslKKeQv/ZQw (big blind) folded on the Flop
Seat 3: 4x9jCqgSw4272dnaIqnanw folded before Flop (didn't bet)
Seat 4: Lz/GjRDgmgepqTR7qmS86w folded before Flop (didn't bet)
Seat 5: SFmT9ZsVopnukjvAzrxTRg folded on the Flop
Seat 6: UA5OsKS3VPaxa7uC8La/kA (button) folded before Flop (didn't bet)




PokerStars Game #59939649014:  Hold'em No Limit ($0.10/$0.25) - 2009/07/01 0:45:19 ET
Table 'Rv0EYnRU8WwZiwx0Zo3X3w' 9-max Seat #6 is the button
Seat 1: opOCI2p6kW0tINuVaAqmcQ ($52.95 in chips) 
Seat 2: Xpyqpb+DURDWnyJ3xTEIFQ ($28.40 in chips) 
Seat 3: STkR8XvpjNv79OOMhrlh2w ($25.60 in chips) 
Seat 4: IDkfbfxTm9KJ+DMyGVH8rw ($12.25 in chips) 
Seat 5: h4ggJZYBXV0mEZzYPYKfeA ($21.80 in chips) 
Seat 6: 5hAPbqNrvJb8PtLiceXtlg ($14.65 in chips) 
Seat 7: Th3FldXKQW6hWVVPahaoOQ ($38.25 in chips) 
Seat 8: 10vzP4r6ldwGLbYHKd9www ($14 in chips) 
Seat 9: r1pFKMwWp74QwhfPWJOAyw ($6.60 in chips) 
Th3FldXKQW6hWVVPahaoOQ: posts small blind $0.10
10vzP4r6ldwGLbYHKd9www: posts big blind $0.25
*** HOLE CARDS ***
r1pFKMwWp74QwhfPWJOAyw: folds 
opOCI2p6kW0tINuVaAqmcQ: folds 
Xpyqpb+DURDWnyJ3xTEIFQ: raises $0.75 to $1
STkR8XvpjNv79OOMhrlh2w: folds 
IDkfbfxTm9KJ+DMyGVH8rw: folds 
h4ggJZYBXV0mEZzYPYKfeA: folds 
5hAPbqNrvJb8PtLiceXtlg: folds 
Th3FldXKQW6hWVVPahaoOQ: folds 
10vzP4r6ldwGLbYHKd9www: folds 
Uncalled bet ($0.75) returned to Xpyqpb+DURDWnyJ3xTEIFQ
Xpyqpb+DURDWnyJ3xTEIFQ collected $0.60 from pot
*** SUMMARY ***
Total pot $0.60 | Rake $0 
Seat 1: opOCI2p6kW0tINuVaAqmcQ folded before Flop (didn't bet)
Seat 2: Xpyqpb+DURDWnyJ3xTEIFQ collected ($0.60)
Seat 3: STkR8XvpjNv79OOMhrlh2w folded before Flop (didn't bet)
Seat 4: IDkfbfxTm9KJ+DMyGVH8rw folded before Flop (didn't bet)
Seat 5: h4ggJZYBXV0mEZzYPYKfeA folded before Flop (didn't bet)
Seat 6: 5hAPbqNrvJb8PtLiceXtlg (button) folded before Flop (didn't bet)
Seat 7: Th3FldXKQW6hWVVPahaoOQ (small blind) folded before Flop
Seat 8: 10vzP4r6ldwGLbYHKd9www (big blind) folded before Flop
Seat 9: r1pFKMwWp74QwhfPWJOAyw folded before Flop (didn't bet)




PokerStars Game #59939649016:  Hold'em No Limit ($0.10/$0.25) - 2009/07/01 0:45:19 ET
Table 'BabJGL6tfXQp3leBGbYe8A' 9-max Seat #9 is the button
Seat 1: qwr38jl5txoR36M7G5qi4A ($7.50 in chips) 
Seat 2: G5EFgY1bi50mF1iH/+B4yQ ($10.55 in chips) 
Seat 3: Jdj7AsGFrlkCgDXeWK322A ($25.85 in chips) 
Seat 4: Yk91gygnxgAKPGHZ/jPVSw ($7.20 in chips) 
Seat 5: fKqW4kzqpoOv+YKE5kp3FA ($2.80 in chips) 
Seat 6: ELKIDQ6mBSQJr3wiHYHtvw ($7.40 in chips) 
Seat 8: TJEefy+0K5gBV+8LA5OK7Q ($25 in chips) 
Seat 9: xEQxarad8/T4jJdpZy5LGw ($11.10 in chips) 
qwr38jl5txoR36M7G5qi4A: posts small blind $0.10
G5EFgY1bi50mF1iH/+B4yQ: posts big blind $0.25
st9jtdNbm1W5GfBwRaCVqQ: sits out 
*** HOLE CARDS ***
Jdj7AsGFrlkCgDXeWK322A: folds 
Yk91gygnxgAKPGHZ/jPVSw: raises $0.25 to $0.50
fKqW4kzqpoOv+YKE5kp3FA: folds 
ELKIDQ6mBSQJr3wiHYHtvw: calls $0.50
TJEefy+0K5gBV+8LA5OK7Q: folds 
xEQxarad8/T4jJdpZy5LGw: raises $0.50 to $1
qwr38jl5txoR36M7G5qi4A: folds 
G5EFgY1bi50mF1iH/+B4yQ: folds 
Yk91gygnxgAKPGHZ/jPVSw: calls $0.50
ELKIDQ6mBSQJr3wiHYHtvw: folds 
*** FLOP *** [3d 2s Tc]
Yk91gygnxgAKPGHZ/jPVSw: bets $6.20 and is all-in
xEQxarad8/T4jJdpZy5LGw: folds 
Uncalled bet ($6.20) returned to Yk91gygnxgAKPGHZ/jPVSw
Yk91gygnxgAKPGHZ/jPVSw collected $2.75 from pot
Yk91gygnxgAKPGHZ/jPVSw: doesn't show hand 
*** SUMMARY ***
Total pot $2.85 | Rake $0.10 
Board [3d 2s Tc]
Seat 1: qwr38jl5txoR36M7G5qi4A (small blind) folded before Flop
Seat 2: G5EFgY1bi50mF1iH/+B4yQ (big blind) folded before Flop
Seat 3: Jdj7AsGFrlkCgDXeWK322A folded before Flop (didn't bet)
Seat 4: Yk91gygnxgAKPGHZ/jPVSw collected ($2.75)
Seat 5: fKqW4kzqpoOv+YKE5kp3FA folded before Flop (didn't bet)
Seat 6: ELKIDQ6mBSQJr3wiHYHtvw folded before Flop
Seat 8: TJEefy+0K5gBV+8LA5OK7Q folded before Flop (didn't bet)
Seat 9: xEQxarad8/T4jJdpZy5LGw (button) folded on the Flop




PokerStars Game #59939649634:  Hold'em No Limit ($0.10/$0.25) - 2009/07/01 0:45:20 ET
Table 'h3+tJ4Vtwq0R+eA8S73eZA' 9-max Seat #9 is the button
Seat 1: H5Se03ZqSX7tbULXur2MAg ($20.65 in chips) 
Seat 2: Th3FldXKQW6hWVVPahaoOQ ($27.40 in chips) 
Seat 3: crgjVDgmUqCw4RyLzbohWQ ($16.75 in chips) 
Seat 4: M2QO2DxB5Wawg2h8HSpnYA ($11.70 in chips) 
Seat 5: cZ99hugmLBj9KhTlc8nCSw ($31.45 in chips) 
Seat 6: TvIuLx9zUCE+9Li58iImOQ ($8.20 in chips) 
Seat 7: IIGtqtVGyvZR0ZMYMMPjeQ ($27 in chips) 
Seat 8: +2kMBNpY4nF1qNCRd8SJLA ($25.15 in chips) 
Seat 9: qwr38jl5txoR36M7G5qi4A ($7.90 in chips) 
H5Se03ZqSX7tbULXur2MAg: posts small blind $0.10
Th3FldXKQW6hWVVPahaoOQ: posts big blind $0.25
*** HOLE CARDS ***
crgjVDgmUqCw4RyLzbohWQ: folds 
M2QO2DxB5Wawg2h8HSpnYA: folds 
cZ99hugmLBj9KhTlc8nCSw: folds 
TvIuLx9zUCE+9Li58iImOQ: folds 
IIGtqtVGyvZR0ZMYMMPjeQ: calls $0.25
+2kMBNpY4nF1qNCRd8SJLA: folds 
qwr38jl5txoR36M7G5qi4A: folds 
H5Se03ZqSX7tbULXur2MAg: folds 
Th3FldXKQW6hWVVPahaoOQ: checks 
*** FLOP *** [Jh 9h 7s]
Th3FldXKQW6hWVVPahaoOQ: checks 
IIGtqtVGyvZR0ZMYMMPjeQ: checks 
*** TURN *** [Jh 9h 7s] [Tc]
Th3FldXKQW6hWVVPahaoOQ: checks 
IIGtqtVGyvZR0ZMYMMPjeQ: checks 
*** RIVER *** [Jh 9h 7s Tc] [2s]
Th3FldXKQW6hWVVPahaoOQ: checks 
IIGtqtVGyvZR0ZMYMMPjeQ: checks 
*** SHOW DOWN ***
Th3FldXKQW6hWVVPahaoOQ: shows [6c Qh] (high card Queen)
IIGtqtVGyvZR0ZMYMMPjeQ: shows [Ah Qc] (high card Ace)
IIGtqtVGyvZR0ZMYMMPjeQ collected $0.60 from pot
*** SUMMARY ***
Total pot $0.60 | Rake $0 
Board [Jh 9h 7s Tc 2s]
Seat 1: H5Se03ZqSX7tbULXur2MAg (small blind) folded before Flop
Seat 2: Th3FldXKQW6hWVVPahaoOQ (big blind) showed [6c Qh] and lost with high card Queen
Seat 3: crgjVDgmUqCw4RyLzbohWQ folded before Flop (didn't bet)
Seat 4: M2QO2DxB5Wawg2h8HSpnYA folded before Flop (didn't bet)
Seat 5: cZ99hugmLBj9KhTlc8nCSw folded before Flop (didn't bet)
Seat 6: TvIuLx9zUCE+9Li58iImOQ folded before Flop (didn't bet)
Seat 7: IIGtqtVGyvZR0ZMYMMPjeQ showed [Ah Qc] and won ($0.60) with high card Ace
Seat 8: +2kMBNpY4nF1qNCRd8SJLA folded before Flop (didn't bet)
Seat 9: qwr38jl5txoR36M7G5qi4A (button) folded before Flop (didn't bet)




PokerStars Game #59939649372:  Hold'em No Limit ($0.10/$0.25) - 2009/07/01 0:45:20 ET
Table '7/qMNloI0nSXWiX5Y1watA' 9-max Seat #7 is the button
Seat 1: lF4l0ujUfJ9uYJOg9Ch9/g ($43.10 in chips) 
Seat 2: 8B/dhbQjIWe6ASCdgzktNQ ($25.40 in chips) 
Seat 3: nEg1b6MIksd/4x5eLY735g ($43.50 in chips) 
Seat 4: 18G4P1XstjNvItdGUITxgw ($25 in chips) 
Seat 5: dfNim92Z6XK1/h5SFW5vDg ($41.05 in chips) 
Seat 6: vnCdP3GsLTKadDukKcJk/Q ($25 in chips) 
Seat 7: z5GxcHlYz/GSz6W2uFiTtg ($11.20 in chips) 
Seat 8: ljemhp25Zg+nlA9DLCIiUw ($23.45 in chips) 
Seat 9: aZgYUTCgC/6gwsjG/ryBrw ($25 in chips) 
ljemhp25Zg+nlA9DLCIiUw: posts small blind $0.10
aZgYUTCgC/6gwsjG/ryBrw: posts big blind $0.25
*** HOLE CARDS ***
lF4l0ujUfJ9uYJOg9Ch9/g: folds 
8B/dhbQjIWe6ASCdgzktNQ: folds 
nEg1b6MIksd/4x5eLY735g: folds 
18G4P1XstjNvItdGUITxgw: folds 
dfNim92Z6XK1/h5SFW5vDg: folds 
vnCdP3GsLTKadDukKcJk/Q: folds 
z5GxcHlYz/GSz6W2uFiTtg: folds 
ljemhp25Zg+nlA9DLCIiUw: folds 
Uncalled bet ($0.15) returned to aZgYUTCgC/6gwsjG/ryBrw
aZgYUTCgC/6gwsjG/ryBrw collected $0.20 from pot
aZgYUTCgC/6gwsjG/ryBrw: doesn't show hand 
*** SUMMARY ***
Total pot $0.20 | Rake $0 
Seat 1: lF4l0ujUfJ9uYJOg9Ch9/g folded before Flop (didn't bet)
Seat 2: 8B/dhbQjIWe6ASCdgzktNQ folded before Flop (didn't bet)
Seat 3: nEg1b6MIksd/4x5eLY735g folded before Flop (didn't bet)
Seat 4: 18G4P1XstjNvItdGUITxgw folded before Flop (didn't bet)
Seat 5: dfNim92Z6XK1/h5SFW5vDg folded before Flop (didn't bet)
Seat 6: vnCdP3GsLTKadDukKcJk/Q folded before Flop (didn't bet)
Seat 7: z5GxcHlYz/GSz6W2uFiTtg (button) folded before Flop (didn't bet)
Seat 8: ljemhp25Zg+nlA9DLCIiUw (small blind) folded before Flop
Seat 9: aZgYUTCgC/6gwsjG/ryBrw (big blind) collected ($0.20)




PokerStars Game #59939649904:  Hold'em No Limit ($0.10/$0.25) - 2009/07/01 0:45:20 ET
Table 'Utmw+yX+E/wdhNDIim90lQ' 9-max Seat #8 is the button
Seat 1: lwlnPm68QGGI/+pnAd4GAw ($59.10 in chips) 
Seat 2: iGMlK+EhUflPB6jKQd95Cg ($32.30 in chips) 
Seat 3: dfNim92Z6XK1/h5SFW5vDg ($25 in chips) 
Seat 4: ifYGvZDHQQ0aam4awTtHwA ($4.85 in chips) 
Seat 5: H9KUl8cmpLgEpOVDA00bCg ($5 in chips) 
Seat 6: OlPJsgR4xypSg/w1z7Gyvw ($19.65 in chips) 
Seat 7: CImUHesK+ZER4v/VCA9IUg ($64.20 in chips) 
Seat 8: DdPXdieucQ+n99u1n3A+rQ ($4.55 in chips) 
Seat 9: Th3FldXKQW6hWVVPahaoOQ ($27.25 in chips) 
Th3FldXKQW6hWVVPahaoOQ: posts small blind $0.10
lwlnPm68QGGI/+pnAd4GAw: posts big blind $0.25
*** HOLE CARDS ***
iGMlK+EhUflPB6jKQd95Cg: folds 
dfNim92Z6XK1/h5SFW5vDg: folds 
ifYGvZDHQQ0aam4awTtHwA: calls $0.25
H9KUl8cmpLgEpOVDA00bCg: folds 
OlPJsgR4xypSg/w1z7Gyvw: folds 
CImUHesK+ZER4v/VCA9IUg: folds 
DdPXdieucQ+n99u1n3A+rQ: raises $1 to $1.25
Th3FldXKQW6hWVVPahaoOQ: folds 
lwlnPm68QGGI/+pnAd4GAw: folds 
ifYGvZDHQQ0aam4awTtHwA: calls $1
*** FLOP *** [Qs 8s 6d]
ifYGvZDHQQ0aam4awTtHwA: checks 
DdPXdieucQ+n99u1n3A+rQ: bets $3.30 and is all-in
ifYGvZDHQQ0aam4awTtHwA: folds 
Uncalled bet ($3.30) returned to DdPXdieucQ+n99u1n3A+rQ
DdPXdieucQ+n99u1n3A+rQ collected $2.75 from pot
DdPXdieucQ+n99u1n3A+rQ: doesn't show hand 
*** SUMMARY ***
Total pot $2.85 | Rake $0.10 
Board [Qs 8s 6d]
Seat 1: lwlnPm68QGGI/+pnAd4GAw (big blind) folded before Flop
Seat 2: iGMlK+EhUflPB6jKQd95Cg folded before Flop (didn't bet)
Seat 3: dfNim92Z6XK1/h5SFW5vDg folded before Flop (didn't bet)
Seat 4: ifYGvZDHQQ0aam4awTtHwA folded on the Flop
Seat 5: H9KUl8cmpLgEpOVDA00bCg folded before Flop (didn't bet)
Seat 6: OlPJsgR4xypSg/w1z7Gyvw folded before Flop (didn't bet)
Seat 7: CImUHesK+ZER4v/VCA9IUg folded before Flop (didn't bet)
Seat 8: DdPXdieucQ+n99u1n3A+rQ (button) collected ($2.75)
Seat 9: Th3FldXKQW6hWVVPahaoOQ (small blind) folded before Flop




PokerStars Game #59939649868:  Hold'em No Limit ($0.10/$0.25) - 2009/07/01 0:45:20 ET
Table '84TjTrgbsYZladOc4PWf4Q' 6-max Seat #3 is the button
Seat 1: 79ID/ub1Pt/mDpCprVmOoA ($30 in chips) 
Seat 2: RpaEX9P7BCvyfPRLiRNg0A ($15 in chips) 
Seat 3: Ar4vsUIUfJ7gbYh1c1m59g ($14.65 in chips) 
Seat 4: SxIIgwXYLkwd6m3wLyPTCw ($25.10 in chips) 
Seat 5: YaAEMJGY5tem39deCUQRNw ($26.35 in chips) 
Seat 6: 7qRk4YH4/k/08LgJSv7rBQ ($26.45 in chips) 
SxIIgwXYLkwd6m3wLyPTCw: posts small blind $0.10
YaAEMJGY5tem39deCUQRNw: posts big blind $0.25
RpaEX9P7BCvyfPRLiRNg0A: posts big blind $0.25
*** HOLE CARDS ***
7qRk4YH4/k/08LgJSv7rBQ: folds 
79ID/ub1Pt/mDpCprVmOoA: folds 
RpaEX9P7BCvyfPRLiRNg0A: checks 
Ar4vsUIUfJ7gbYh1c1m59g: folds 
SxIIgwXYLkwd6m3wLyPTCw: folds 
YaAEMJGY5tem39deCUQRNw: checks 
*** FLOP *** [Jh 3c Qs]
YaAEMJGY5tem39deCUQRNw: checks 
RpaEX9P7BCvyfPRLiRNg0A: checks 
*** TURN *** [Jh 3c Qs] [Td]
YaAEMJGY5tem39deCUQRNw: checks 
RpaEX9P7BCvyfPRLiRNg0A: checks 
*** RIVER *** [Jh 3c Qs Td] [Jd]
YaAEMJGY5tem39deCUQRNw: checks 
RpaEX9P7BCvyfPRLiRNg0A: checks 
*** SHOW DOWN ***
YaAEMJGY5tem39deCUQRNw: shows [2h 4s] (a pair of Jacks)
RpaEX9P7BCvyfPRLiRNg0A: shows [7s Ad] (a pair of Jacks - Ace kicker)
RpaEX9P7BCvyfPRLiRNg0A collected $0.60 from pot
*** SUMMARY ***
Total pot $0.60 | Rake $0 
Board [Jh 3c Qs Td Jd]
Seat 1: 79ID/ub1Pt/mDpCprVmOoA folded before Flop (didn't bet)
Seat 2: RpaEX9P7BCvyfPRLiRNg0A showed [7s Ad] and won ($0.60) with a pair of Jacks
Seat 3: Ar4vsUIUfJ7gbYh1c1m59g (button) folded before Flop (didn't bet)
Seat 4: SxIIgwXYLkwd6m3wLyPTCw (small blind) folded before Flop
Seat 5: YaAEMJGY5tem39deCUQRNw (big blind) showed [2h 4s] and lost with a pair of Jacks
Seat 6: 7qRk4YH4/k/08LgJSv7rBQ folded before Flop (didn't bet)




PokerStars Game #59939649544:  Hold'em No Limit ($0.10/$0.25) - 2009/07/01 0:45:20 ET
Table 'LLHSnYPAXNI1sFlwPBn1tA' 6-max Seat #4 is the button
Seat 1: tVZW8k4GP+PvZ1DjD/9StA ($22.70 in chips) 
Seat 2: oseFhpinoe+Zg4j5xyBjyQ ($24.20 in chips) 
Seat 3: JFIAqU8lCZ0vWwEl4bdGsg ($25 in chips) 
Seat 4: FPlQHZog0ePFCETQ2KG4hQ ($26.85 in chips) 
Seat 5: jXbd3O6QdeNWctmpAsTgHA ($14.20 in chips) 
Seat 6: PCh4iIHq9rXvWY/FeXc/Jg ($30.20 in chips) 
jXbd3O6QdeNWctmpAsTgHA: posts small blind $0.10
PCh4iIHq9rXvWY/FeXc/Jg: posts big blind $0.25
*** HOLE CARDS ***
tVZW8k4GP+PvZ1DjD/9StA: folds 
oseFhpinoe+Zg4j5xyBjyQ: raises $0.25 to $0.50
JFIAqU8lCZ0vWwEl4bdGsg: folds 
FPlQHZog0ePFCETQ2KG4hQ: folds 
jXbd3O6QdeNWctmpAsTgHA: folds 
PCh4iIHq9rXvWY/FeXc/Jg: calls $0.25
*** FLOP *** [8d 6c 9c]
PCh4iIHq9rXvWY/FeXc/Jg: checks 
oseFhpinoe+Zg4j5xyBjyQ: bets $0.50
PCh4iIHq9rXvWY/FeXc/Jg: calls $0.50
*** TURN *** [8d 6c 9c] [Ah]
PCh4iIHq9rXvWY/FeXc/Jg: checks 
oseFhpinoe+Zg4j5xyBjyQ: bets $0.75
PCh4iIHq9rXvWY/FeXc/Jg: calls $0.75
*** RIVER *** [8d 6c 9c Ah] [5d]
PCh4iIHq9rXvWY/FeXc/Jg: checks 
oseFhpinoe+Zg4j5xyBjyQ: checks 
*** SHOW DOWN ***
PCh4iIHq9rXvWY/FeXc/Jg: shows [6d Td] (a pair of Sixes)
oseFhpinoe+Zg4j5xyBjyQ: mucks hand 
PCh4iIHq9rXvWY/FeXc/Jg collected $3.45 from pot
*** SUMMARY ***
Total pot $3.60 | Rake $0.15 
Board [8d 6c 9c Ah 5d]
Seat 1: tVZW8k4GP+PvZ1DjD/9StA folded before Flop (didn't bet)
Seat 2: oseFhpinoe+Zg4j5xyBjyQ mucked
Seat 3: JFIAqU8lCZ0vWwEl4bdGsg folded before Flop (didn't bet)
Seat 4: FPlQHZog0ePFCETQ2KG4hQ (button) folded before Flop (didn't bet)
Seat 5: jXbd3O6QdeNWctmpAsTgHA (small blind) folded before Flop
Seat 6: PCh4iIHq9rXvWY/FeXc/Jg (big blind) showed [6d Td] and won ($3.45) with a pair of Sixes




PokerStars Game #59939649586:  Hold'em No Limit ($0.10/$0.25) - 2009/07/01 0:45:20 ET
Table 'HbNAGS1OJWQKyfk7UfrYyw' 9-max Seat #8 is the button
Seat 1: YHeeiaUNFin/MUYZJuW1VA ($4.15 in chips) 
Seat 2: zE0IkNrJoJD964o4eqmCxQ ($5 in chips) 
Seat 3: DIBbjEYGs+TVdVgEB/4+3w ($30.20 in chips) 
Seat 5: cu58S48zQeRuppc18okJLA ($15.85 in chips) 
Seat 6: W4TLQcZ2TiM73eIgpIvlGg ($26.10 in chips) 
Seat 7: JJH2Xc95hFewheF67vSv4Q ($17 in chips) 
Seat 8: fsTS8sDyZ7BxKQFEMv9xCg ($6.85 in chips) 
cFmpjvcjNoVAEAIQIxWkYg will be allowed to play after the button
YHeeiaUNFin/MUYZJuW1VA: posts small blind $0.10
zE0IkNrJoJD964o4eqmCxQ: posts big blind $0.25
mdalglish: sits out 
*** HOLE CARDS ***
DIBbjEYGs+TVdVgEB/4+3w: calls $0.25
cu58S48zQeRuppc18okJLA: folds 
W4TLQcZ2TiM73eIgpIvlGg: folds 
JJH2Xc95hFewheF67vSv4Q: calls $0.25
fsTS8sDyZ7BxKQFEMv9xCg: calls $0.25
YHeeiaUNFin/MUYZJuW1VA: raises $0.50 to $0.75
zE0IkNrJoJD964o4eqmCxQ: calls $0.50
DIBbjEYGs+TVdVgEB/4+3w: calls $0.50
JJH2Xc95hFewheF67vSv4Q: calls $0.50
fsTS8sDyZ7BxKQFEMv9xCg: calls $0.50
*** FLOP *** [Th 2s 4s]
YHeeiaUNFin/MUYZJuW1VA: bets $3.40 and is all-in
zE0IkNrJoJD964o4eqmCxQ: raises $0.85 to $4.25 and is all-in
DIBbjEYGs+TVdVgEB/4+3w: folds 
JJH2Xc95hFewheF67vSv4Q: folds 
fsTS8sDyZ7BxKQFEMv9xCg: folds 
Uncalled bet ($0.85) returned to zE0IkNrJoJD964o4eqmCxQ
*** TURN *** [Th 2s 4s] [Ah]
*** RIVER *** [Th 2s 4s Ah] [5d]
*** SHOW DOWN ***
YHeeiaUNFin/MUYZJuW1VA: shows [Ac 6d] (a pair of Aces)
zE0IkNrJoJD964o4eqmCxQ: shows [As 9s] (a pair of Aces - Ten+Nine kicker)
zE0IkNrJoJD964o4eqmCxQ collected $10.05 from pot
fsTS8sDyZ7BxKQFEMv9xCg said, "had 23"
*** SUMMARY ***
Total pot $10.55 | Rake $0.50 
Board [Th 2s 4s Ah 5d]
Seat 1: YHeeiaUNFin/MUYZJuW1VA (small blind) showed [Ac 6d] and lost with a pair of Aces
Seat 2: zE0IkNrJoJD964o4eqmCxQ (big blind) showed [As 9s] and won ($10.05) with a pair of Aces
Seat 3: DIBbjEYGs+TVdVgEB/4+3w folded on the Flop
Seat 5: cu58S48zQeRuppc18okJLA folded before Flop (didn't bet)
Seat 6: W4TLQcZ2TiM73eIgpIvlGg folded before Flop (didn't bet)
Seat 7: JJH2Xc95hFewheF67vSv4Q folded on the Flop
Seat 8: fsTS8sDyZ7BxKQFEMv9xCg (button) folded on the Flop




PokerStars Game #59939649968:  Hold'em No Limit ($0.10/$0.25) - 2009/07/01 0:45:21 ET
Table 'JYkCJJ5Iv+Tu52jx2lpEcgT/iCKJXGphRN3xcdwfE/JQSeat #1 is the button
Seat 1: Yv4fucyyT28mjx8V5lxKJg ($30.25 in chips) 
Seat 2: hBMUlEpyU74r/fwDgIpXjQ ($35.35 in chips) 
Seat 3: Z5ZtGOON8kmSdSCll9Z3XA ($7.75 in chips) 
Seat 5: 6OVSxS1KoddUCYNkZ4hREw ($30.60 in chips) 
Seat 6: OiV1PWZ3IkN29JlmCcnTwQ ($4.65 in chips) 
Seat 7: N6fYvIzQLKaydFLKQGtMlQ ($22.30 in chips) 
Seat 9: H9KUl8cmpLgEpOVDA00bCg ($5.50 in chips) 
hBMUlEpyU74r/fwDgIpXjQ: posts small blind $0.10
Z5ZtGOON8kmSdSCll9Z3XA: posts big blind $0.25
*** HOLE CARDS ***
6OVSxS1KoddUCYNkZ4hREw: folds 
6RiVTYll/5D8zICp0MRpKw joins the table at seat #8 
OiV1PWZ3IkN29JlmCcnTwQ: folds 
N6fYvIzQLKaydFLKQGtMlQ: folds 
H9KUl8cmpLgEpOVDA00bCg: folds 
Yv4fucyyT28mjx8V5lxKJg: calls $0.25
hBMUlEpyU74r/fwDgIpXjQ: folds 
Z5ZtGOON8kmSdSCll9Z3XA: checks 
*** FLOP *** [4h 3c 4s]
Z5ZtGOON8kmSdSCll9Z3XA: checks 
Yv4fucyyT28mjx8V5lxKJg: checks 
*** TURN *** [4h 3c 4s] [8h]
Z5ZtGOON8kmSdSCll9Z3XA: bets $0.50
Yv4fucyyT28mjx8V5lxKJg: folds 
Uncalled bet ($0.50) returned to Z5ZtGOON8kmSdSCll9Z3XA
Z5ZtGOON8kmSdSCll9Z3XA collected $0.60 from pot
*** SUMMARY ***
Total pot $0.60 | Rake $0 
Board [4h 3c 4s 8h]
Seat 1: Yv4fucyyT28mjx8V5lxKJg (button) folded on the Turn
Seat 2: hBMUlEpyU74r/fwDgIpXjQ (small blind) folded before Flop
Seat 3: Z5ZtGOON8kmSdSCll9Z3XA (big blind) collected ($0.60)
Seat 5: 6OVSxS1KoddUCYNkZ4hREw folded before Flop (didn't bet)
Seat 6: OiV1PWZ3IkN29JlmCcnTwQ folded before Flop (didn't bet)
Seat 7: N6fYvIzQLKaydFLKQGtMlQ folded before Flop (didn't bet)
Seat 9: H9KUl8cmpLgEpOVDA00bCg folded before Flop (didn't bet)




PokerStars Game #59939650316:  Hold'em No Limit ($0.10/$0.25) - 2009/07/01 0:45:21 ET
Table '0mmHveGuaIfIMQlNE1eqMg' 9-max Seat #8 is the button
Seat 2: rQhYIYXSyH/IivYM1dlV5A ($57.65 in chips) 
Seat 3: ghNKXUBl/H+t83JF079ZBA ($25.75 in chips) 
Seat 4: r0/CtYRRIJAbPQm4qsv8LQ ($35.15 in chips) 
Seat 5: cVVfy+hwCb/YzSIyUWhKEw ($30.80 in chips) 
Seat 6: Xo1w+VqEZh0bV5wYupnNYg ($13.15 in chips) 
Seat 8: jiyia7h6fmxBdWBkH9lH5A ($2.60 in chips) 
Seat 9: W4TLQcZ2TiM73eIgpIvlGg ($34 in chips) 
W4TLQcZ2TiM73eIgpIvlGg: posts small blind $0.10
7QzbjWT00wQpau1iqvUmMA: is sitting out 
rQhYIYXSyH/IivYM1dlV5A: posts big blind $0.25
*** HOLE CARDS ***
ghNKXUBl/H+t83JF079ZBA: folds 
7QzbjWT00wQpau1iqvUmMA leaves the table
r0/CtYRRIJAbPQm4qsv8LQ: raises $0.25 to $0.50
cVVfy+hwCb/YzSIyUWhKEw: calls $0.50
Xo1w+VqEZh0bV5wYupnNYg: folds 
rQhYIYXSyH/IivYM1dlV5A said, "nh"
jiyia7h6fmxBdWBkH9lH5A: calls $0.50
W4TLQcZ2TiM73eIgpIvlGg: folds 
1S/fpm+f42V/6MNZre+ccg joins the table at seat #1 
rQhYIYXSyH/IivYM1dlV5A: calls $0.25
*** FLOP *** [4c 2s Th]
rQhYIYXSyH/IivYM1dlV5A: checks 
r0/CtYRRIJAbPQm4qsv8LQ: checks 
cVVfy+hwCb/YzSIyUWhKEw: checks 
jiyia7h6fmxBdWBkH9lH5A: checks 
*** TURN *** [4c 2s Th] [5d]
rQhYIYXSyH/IivYM1dlV5A: checks 
r0/CtYRRIJAbPQm4qsv8LQ: checks 
cVVfy+hwCb/YzSIyUWhKEw: checks 
jiyia7h6fmxBdWBkH9lH5A: bets $0.50
rQhYIYXSyH/IivYM1dlV5A: folds 
r0/CtYRRIJAbPQm4qsv8LQ: folds 
cVVfy+hwCb/YzSIyUWhKEw: folds 
Uncalled bet ($0.50) returned to jiyia7h6fmxBdWBkH9lH5A
jiyia7h6fmxBdWBkH9lH5A collected $2 from pot
*** SUMMARY ***
Total pot $2.10 | Rake $0.10 
Board [4c 2s Th 5d]
Seat 2: rQhYIYXSyH/IivYM1dlV5A (big blind) folded on the Turn
Seat 3: ghNKXUBl/H+t83JF079ZBA folded before Flop (didn't bet)
Seat 4: r0/CtYRRIJAbPQm4qsv8LQ folded on the Turn
Seat 5: cVVfy+hwCb/YzSIyUWhKEw folded on the Turn
Seat 6: Xo1w+VqEZh0bV5wYupnNYg folded before Flop (didn't bet)
Seat 8: jiyia7h6fmxBdWBkH9lH5A (button) collected ($2)
Seat 9: W4TLQcZ2TiM73eIgpIvlGg (small blind) folded before Flop




PokerStars Game #59939650542:  Hold'em No Limit ($0.10/$0.25) - 2009/07/01 0:45:21 ET
Table 'T/iCKJXGphRN3xcdwfE/JQ' 6-max Seat #3 is the button
Seat 1: zZ8zH49EwNs0mqgppOaL9g ($24.50 in chips) 
Seat 2: 6qsh9pnysDKJNhfFhFmKRQ ($9.40 in chips) 
Seat 3: R6AGToFJQOYVZAjC2jXEKw ($24.45 in chips) 
Seat 4: yzFNNFIfC89bBPwpFPx2ow ($57.90 in chips) 
Seat 5: DzdrMZ6l84e65/zfW+2bcA ($5.55 in chips) 
Seat 6: jKYGBgexhqKT13Xana4EHg ($14.30 in chips) 
yzFNNFIfC89bBPwpFPx2ow: posts small blind $0.10
DzdrMZ6l84e65/zfW+2bcA: posts big blind $0.25
*** HOLE CARDS ***
jKYGBgexhqKT13Xana4EHg: folds 
zZ8zH49EwNs0mqgppOaL9g: folds 
6qsh9pnysDKJNhfFhFmKRQ: calls $0.25
R6AGToFJQOYVZAjC2jXEKw: raises $0.75 to $1
yzFNNFIfC89bBPwpFPx2ow: folds 
DzdrMZ6l84e65/zfW+2bcA: folds 
6qsh9pnysDKJNhfFhFmKRQ: calls $0.75
*** FLOP *** [2c 4c 9s]
6qsh9pnysDKJNhfFhFmKRQ: checks 
R6AGToFJQOYVZAjC2jXEKw: bets $8.75
6qsh9pnysDKJNhfFhFmKRQ: folds 
Uncalled bet ($8.75) returned to R6AGToFJQOYVZAjC2jXEKw
R6AGToFJQOYVZAjC2jXEKw collected $2.25 from pot
R6AGToFJQOYVZAjC2jXEKw: doesn't show hand 
*** SUMMARY ***
Total pot $2.35 | Rake $0.10 
Board [2c 4c 9s]
Seat 1: zZ8zH49EwNs0mqgppOaL9g folded before Flop (didn't bet)
Seat 2: 6qsh9pnysDKJNhfFhFmKRQ folded on the Flop
Seat 3: R6AGToFJQOYVZAjC2jXEKw (button) collected ($2.25)
Seat 4: yzFNNFIfC89bBPwpFPx2ow (small blind) folded before Flop
Seat 5: DzdrMZ6l84e65/zfW+2bcA (big blind) folded before Flop
Seat 6: jKYGBgexhqKT13Xana4EHg folded before Flop (didn't bet)




PokerStars Game #59939650544:  Hold'em No Limit ($0.10/$0.25) - 2009/07/01 0:45:21 ET
Table 'srBTB98reCdD1TffxE6o7g' 6-max Seat #1 is the button
Seat 1: FEzezmgaiyVRh9sHKhd+9Q ($44.25 in chips) 
Seat 2: eSKnWz2RD4rvwnvB+rFzIg ($24.75 in chips) 
Seat 3: 4YSTu0Cdzpppe1lUgCZGCQ ($31.60 in chips) 
Seat 4: 6DwBRH+xZ12AAZmeAg+aXw ($25 in chips) 
Seat 5: n2OZezRXTtdzQt4SuIy8TQ ($36.50 in chips) 
Seat 6: gaPMxLGp9SOj4Lq6t+/0Ig ($15 in chips) 
eSKnWz2RD4rvwnvB+rFzIg: posts small blind $0.10
4YSTu0Cdzpppe1lUgCZGCQ: posts big blind $0.25
*** HOLE CARDS ***
6DwBRH+xZ12AAZmeAg+aXw: raises $0.50 to $0.75
n2OZezRXTtdzQt4SuIy8TQ: folds 
gaPMxLGp9SOj4Lq6t+/0Ig: calls $0.75
FEzezmgaiyVRh9sHKhd+9Q: folds 
eSKnWz2RD4rvwnvB+rFzIg: folds 
4YSTu0Cdzpppe1lUgCZGCQ: folds 
*** FLOP *** [Kc Td 8h]
6DwBRH+xZ12AAZmeAg+aXw: bets $1
gaPMxLGp9SOj4Lq6t+/0Ig: calls $1
*** TURN *** [Kc Td 8h] [7d]
6DwBRH+xZ12AAZmeAg+aXw: bets $2.25
gaPMxLGp9SOj4Lq6t+/0Ig: calls $2.25
*** RIVER *** [Kc Td 8h 7d] [Jd]
6DwBRH+xZ12AAZmeAg+aXw: checks 
gaPMxLGp9SOj4Lq6t+/0Ig: checks 
*** SHOW DOWN ***
6DwBRH+xZ12AAZmeAg+aXw: shows [Ac Ah] (a pair of Aces)
gaPMxLGp9SOj4Lq6t+/0Ig: mucks hand 
6DwBRH+xZ12AAZmeAg+aXw collected $7.95 from pot
*** SUMMARY ***
Total pot $8.35 | Rake $0.40 
Board [Kc Td 8h 7d Jd]
Seat 1: FEzezmgaiyVRh9sHKhd+9Q (button) folded before Flop (didn't bet)
Seat 2: eSKnWz2RD4rvwnvB+rFzIg (small blind) folded before Flop
Seat 3: 4YSTu0Cdzpppe1lUgCZGCQ (big blind) folded before Flop
Seat 4: 6DwBRH+xZ12AAZmeAg+aXw showed [Ac Ah] and won ($7.95) with a pair of Aces
Seat 5: n2OZezRXTtdzQt4SuIy8TQ folded before Flop (didn't bet)
Seat 6: gaPMxLGp9SOj4Lq6t+/0Ig mucked




PokerStars Game #59939649970:  Hold'em No Limit ($0.10/$0.25) - 2009/07/01 0:45:21 ET
Table 'vFZR6Kf2Th5xBXT9brGW6A' 6-max Seat #5 is the button
Seat 1: xRkU4+naLuz7dEZFbOn9cw ($29.60 in chips) 
Seat 2: REnO5xiZ66YabxDXq2ncvA ($50.80 in chips) 
Seat 3: wUwfsTnmpHcWa17qFlQr1Q ($5 in chips) 
Seat 4: 79ID/ub1Pt/mDpCprVmOoA ($26.15 in chips) 
Seat 5: NhUN/JpAprdJeamFBgJH1w ($30.55 in chips) 
Seat 6: d0J1xuhsynEY81YHwAvJ5g ($29.85 in chips) 
d0J1xuhsynEY81YHwAvJ5g: posts small blind $0.10
xRkU4+naLuz7dEZFbOn9cw: posts big blind $0.25
*** HOLE CARDS ***
REnO5xiZ66YabxDXq2ncvA has timed out
REnO5xiZ66YabxDXq2ncvA: folds 
REnO5xiZ66YabxDXq2ncvA is sitting out
wUwfsTnmpHcWa17qFlQr1Q: folds 
REnO5xiZ66YabxDXq2ncvA has returned
79ID/ub1Pt/mDpCprVmOoA: raises $0.50 to $0.75
NhUN/JpAprdJeamFBgJH1w: raises $1.75 to $2.50
d0J1xuhsynEY81YHwAvJ5g: folds 
xRkU4+naLuz7dEZFbOn9cw: folds 
79ID/ub1Pt/mDpCprVmOoA: folds 
Uncalled bet ($1.75) returned to NhUN/JpAprdJeamFBgJH1w
NhUN/JpAprdJeamFBgJH1w collected $1.85 from pot
NhUN/JpAprdJeamFBgJH1w: doesn't show hand 
*** SUMMARY ***
Total pot $1.85 | Rake $0 
Seat 1: xRkU4+naLuz7dEZFbOn9cw (big blind) folded before Flop
Seat 2: REnO5xiZ66YabxDXq2ncvA folded before Flop (didn't bet)
Seat 3: wUwfsTnmpHcWa17qFlQr1Q folded before Flop (didn't bet)
Seat 4: 79ID/ub1Pt/mDpCprVmOoA folded before Flop
Seat 5: NhUN/JpAprdJeamFBgJH1w (button) collected ($1.85)
Seat 6: d0J1xuhsynEY81YHwAvJ5g (small blind) folded before Flop




PokerStars Game #59939650356:  Hold'em No Limit ($0.10/$0.25) - 2009/07/01 0:45:21 ET
Table 'NtEQAxCeIK2io1CGtW658g' 6-max Seat #2 is the button
Seat 1: lnOV7k25gyN7L5t5YKTgIg ($16.85 in chips) 
Seat 2: nc79pm0LZRdhncq55evVqA ($25 in chips) 
Seat 3: m2yWOKfAxqHoy5DDN87Ttw ($23.50 in chips) 
Seat 4: 8296 ($13.40 in chips) 
Seat 5: FStoHe64SQWqAsjya9pDkQ ($26.20 in chips) 
Seat 6: /gJNBeCkWL4o85/jvlZ4BA ($68.05 in chips) 
m2yWOKfAxqHoy5DDN87Ttw: posts small blind $0.10
8296: posts big blind $0.25
*** HOLE CARDS ***
FStoHe64SQWqAsjya9pDkQ: raises $0.50 to $0.75
/gJNBeCkWL4o85/jvlZ4BA: folds 
lnOV7k25gyN7L5t5YKTgIg: folds 
nc79pm0LZRdhncq55evVqA: raises $1.50 to $2.25
m2yWOKfAxqHoy5DDN87Ttw: folds 
8296: folds 
FStoHe64SQWqAsjya9pDkQ: folds 
Uncalled bet ($1.50) returned to nc79pm0LZRdhncq55evVqA
nc79pm0LZRdhncq55evVqA collected $1.85 from pot
nc79pm0LZRdhncq55evVqA: doesn't show hand 
*** SUMMARY ***
Total pot $1.85 | Rake $0 
Seat 1: lnOV7k25gyN7L5t5YKTgIg folded before Flop (didn't bet)
Seat 2: nc79pm0LZRdhncq55evVqA (button) collected ($1.85)
Seat 3: m2yWOKfAxqHoy5DDN87Ttw (small blind) folded before Flop
Seat 4: 8296 (big blind) folded before Flop
Seat 5: FStoHe64SQWqAsjya9pDkQ folded before Flop
Seat 6: /gJNBeCkWL4o85/jvlZ4BA folded before Flop (didn't bet)




PokerStars Game #59939650208:  Hold'em No Limit ($0.10/$0.25) - 2009/07/01 0:45:21 ET
Table 'YYMg5qzxK1m9eGRo4SbxtQ' 9-max Seat #2 is the button
Seat 1: DiSvPC2iudwL5j9u6Huyww ($25 in chips) 
Seat 2: uH1RN27w9SKa7TpVR9EFrQ ($14.90 in chips) 
Seat 3: N6fYvIzQLKaydFLKQGtMlQ ($23.80 in chips) 
Seat 4: H8sSXb2KLK0U38tU9YITDw ($10.35 in chips) 
Seat 5: BEIBUu2pIflPrCL+Iks4CQ ($19.30 in chips) 
Seat 6: gehe91e0IyVT0QU/XBkEyg ($41.60 in chips) 
Seat 7: hPhp/RE3cJ5YGaQ2xOHXXg ($5.45 in chips) 
Seat 8: 18G4P1XstjNvItdGUITxgw ($26.40 in chips) 
Seat 9: +sbyWwIcFp9kP0bDtMegfQ ($36.55 in chips) 
N6fYvIzQLKaydFLKQGtMlQ: posts small blind $0.10
H8sSXb2KLK0U38tU9YITDw: posts big blind $0.25
*** HOLE CARDS ***
BEIBUu2pIflPrCL+Iks4CQ: folds 
gehe91e0IyVT0QU/XBkEyg: folds 
hPhp/RE3cJ5YGaQ2xOHXXg: folds 
18G4P1XstjNvItdGUITxgw: folds 
+sbyWwIcFp9kP0bDtMegfQ: folds 
DiSvPC2iudwL5j9u6Huyww: folds 
uH1RN27w9SKa7TpVR9EFrQ: raises $0.75 to $1
N6fYvIzQLKaydFLKQGtMlQ: folds 
H8sSXb2KLK0U38tU9YITDw: folds 
Uncalled bet ($0.75) returned to uH1RN27w9SKa7TpVR9EFrQ
uH1RN27w9SKa7TpVR9EFrQ collected $0.60 from pot
uH1RN27w9SKa7TpVR9EFrQ: doesn't show hand 
*** SUMMARY ***
Total pot $0.60 | Rake $0 
Seat 1: DiSvPC2iudwL5j9u6Huyww folded before Flop (didn't bet)
Seat 2: uH1RN27w9SKa7TpVR9EFrQ (button) collected ($0.60)
Seat 3: N6fYvIzQLKaydFLKQGtMlQ (small blind) folded before Flop
Seat 4: H8sSXb2KLK0U38tU9YITDw (big blind) folded before Flop
Seat 5: BEIBUu2pIflPrCL+Iks4CQ folded before Flop (didn't bet)
Seat 6: gehe91e0IyVT0QU/XBkEyg folded before Flop (didn't bet)
Seat 7: hPhp/RE3cJ5YGaQ2xOHXXg folded before Flop (didn't bet)
Seat 8: 18G4P1XstjNvItdGUITxgw folded before Flop (didn't bet)
Seat 9: +sbyWwIcFp9kP0bDtMegfQ folded before Flop (didn't bet)




PokerStars Game #59939651148:  Hold'em No Limit ($0.10/$0.25) - 2009/07/01 0:45:22 ET
Table 'pPgW4R3kdH26lLi1MnE92w' 9-max Seat #6 is the button
Seat 1: dPWIrImjP1yFagoUVDKR0Q ($8.90 in chips) 
Seat 2: cZ99hugmLBj9KhTlc8nCSw ($28.25 in chips) 
Seat 4: hBMUlEpyU74r/fwDgIpXjQ ($31.50 in chips) 
Seat 5: HPEB+AtKw1+C/cxU0o1ciw ($34.25 in chips) 
Seat 6: VllYilcih0t+gMD4GTRlgQ ($25 in chips) 
Seat 7: sD+TKtt36XiiN6jqHiLwDA ($24.75 in chips) 
Seat 8: aCVg6cCxQcqClhB9nq/p1w ($21.10 in chips) 
Seat 9: tcbEu7VzyHQ+0lh+skbQhQ ($18.25 in chips) 
sD+TKtt36XiiN6jqHiLwDA: posts small blind $0.10
aCVg6cCxQcqClhB9nq/p1w: posts big blind $0.25
nPydKI7KXtudhyCkYtLgZA: sits out 
*** HOLE CARDS ***
tcbEu7VzyHQ+0lh+skbQhQ: calls $0.25
dPWIrImjP1yFagoUVDKR0Q: calls $0.25
cZ99hugmLBj9KhTlc8nCSw: folds 
hBMUlEpyU74r/fwDgIpXjQ: calls $0.25
HPEB+AtKw1+C/cxU0o1ciw: folds 
VllYilcih0t+gMD4GTRlgQ: raises $1 to $1.25
sD+TKtt36XiiN6jqHiLwDA: folds 
aCVg6cCxQcqClhB9nq/p1w: folds 
tcbEu7VzyHQ+0lh+skbQhQ: folds 
dPWIrImjP1yFagoUVDKR0Q: calls $1
hBMUlEpyU74r/fwDgIpXjQ: folds 
*** FLOP *** [9s 9h Jd]
dPWIrImjP1yFagoUVDKR0Q: bets $1
VllYilcih0t+gMD4GTRlgQ: calls $1
*** TURN *** [9s 9h Jd] [Th]
dPWIrImjP1yFagoUVDKR0Q: bets $1
VllYilcih0t+gMD4GTRlgQ: calls $1
*** RIVER *** [9s 9h Jd Th] [2c]
dPWIrImjP1yFagoUVDKR0Q: checks 
VllYilcih0t+gMD4GTRlgQ: checks 
*** SHOW DOWN ***
dPWIrImjP1yFagoUVDKR0Q: shows [Qh As] (a pair of Nines)
VllYilcih0t+gMD4GTRlgQ: shows [Ad Kc] (a pair of Nines - Ace+King kicker)
VllYilcih0t+gMD4GTRlgQ collected $7 from pot
*** SUMMARY ***
Total pot $7.35 | Rake $0.35 
Board [9s 9h Jd Th 2c]
Seat 1: dPWIrImjP1yFagoUVDKR0Q showed [Qh As] and lost with a pair of Nines
Seat 2: cZ99hugmLBj9KhTlc8nCSw folded before Flop (didn't bet)
Seat 4: hBMUlEpyU74r/fwDgIpXjQ folded before Flop
Seat 5: HPEB+AtKw1+C/cxU0o1ciw folded before Flop (didn't bet)
Seat 6: VllYilcih0t+gMD4GTRlgQ (button) showed [Ad Kc] and won ($7) with a pair of Nines
Seat 7: sD+TKtt36XiiN6jqHiLwDA (small blind) folded before Flop
Seat 8: aCVg6cCxQcqClhB9nq/p1w (big blind) folded before Flop
Seat 9: tcbEu7VzyHQ+0lh+skbQhQ folded before Flop




PokerStars Game #59939651070:  Hold'em No Limit ($0.10/$0.25) - 2009/07/01 0:45:22 ET
Table 'B3/JTS7usG3rxMfTbMiZuw' 6-max Seat #4 is the button
Seat 1: wAKC8C/zN0c8V5v13dm9mA ($32.10 in chips) 
Seat 2: 2gqWqkOq59pvtJKe4nS+rw ($22.65 in chips) 
Seat 3: PbMzPZIePKifKQZfKDkbIw ($25 in chips) 
Seat 4: kPCKvyB1yAABEgvF7OaG0g ($23.65 in chips) 
Seat 5: NhUN/JpAprdJeamFBgJH1w ($29 in chips) 
Seat 6: 6DwBRH+xZ12AAZmeAg+aXw ($25 in chips) 
NhUN/JpAprdJeamFBgJH1w: posts small blind $0.10
6DwBRH+xZ12AAZmeAg+aXw: posts big blind $0.25
*** HOLE CARDS ***
wAKC8C/zN0c8V5v13dm9mA is disconnected 
wAKC8C/zN0c8V5v13dm9mA is connected 
wAKC8C/zN0c8V5v13dm9mA: folds 
2gqWqkOq59pvtJKe4nS+rw: folds 
PbMzPZIePKifKQZfKDkbIw: folds 
kPCKvyB1yAABEgvF7OaG0g: folds 
NhUN/JpAprdJeamFBgJH1w: folds 
Uncalled bet ($0.15) returned to 6DwBRH+xZ12AAZmeAg+aXw
6DwBRH+xZ12AAZmeAg+aXw collected $0.20 from pot
6DwBRH+xZ12AAZmeAg+aXw: doesn't show hand 
*** SUMMARY ***
Total pot $0.20 | Rake $0 
Seat 1: wAKC8C/zN0c8V5v13dm9mA folded before Flop (didn't bet)
Seat 2: 2gqWqkOq59pvtJKe4nS+rw folded before Flop (didn't bet)
Seat 3: PbMzPZIePKifKQZfKDkbIw folded before Flop (didn't bet)
Seat 4: kPCKvyB1yAABEgvF7OaG0g (button) folded before Flop (didn't bet)
Seat 5: NhUN/JpAprdJeamFBgJH1w (small blind) folded before Flop
Seat 6: 6DwBRH+xZ12AAZmeAg+aXw (big blind) collected ($0.20)




PokerStars Game #59939650698:  Hold'em No Limit ($0.10/$0.25) - 2009/07/01 0:45:22 ET
Table 'IrJPyZ3JW2iIa+krdoSbJQ' 9-max Seat #1 is the button
Seat 1: 4+E2msto8r80F3SH2gctVA ($24.75 in chips) 
Seat 3: vZGoOTJLQLhkPj4I+LNGig ($25.10 in chips) 
Seat 4: DnDcAdn9P0zGovMERigpFA ($25 in chips) 
Seat 5: sUVgUtgbfVx6JpvApozwhQ ($6.10 in chips) 
Seat 6: +sbyWwIcFp9kP0bDtMegfQ ($24.30 in chips) 
Seat 7: uH1RN27w9SKa7TpVR9EFrQ ($22.45 in chips) 
Seat 8: VBHxUExRAMrbxUq/cVx9Gw ($5 in chips) 
vZGoOTJLQLhkPj4I+LNGig: posts small blind $0.10
DnDcAdn9P0zGovMERigpFA: posts big blind $0.25
+WMpj67YqG8ilNkg2JwXpw: sits out 
*** HOLE CARDS ***
sUVgUtgbfVx6JpvApozwhQ: folds 
+sbyWwIcFp9kP0bDtMegfQ: raises $0.75 to $1
uH1RN27w9SKa7TpVR9EFrQ: folds 
VBHxUExRAMrbxUq/cVx9Gw: folds 
4+E2msto8r80F3SH2gctVA: folds 
vZGoOTJLQLhkPj4I+LNGig: folds 
DnDcAdn9P0zGovMERigpFA: folds 
Uncalled bet ($0.75) returned to +sbyWwIcFp9kP0bDtMegfQ
+sbyWwIcFp9kP0bDtMegfQ collected $0.60 from pot
*** SUMMARY ***
Total pot $0.60 | Rake $0 
Seat 1: 4+E2msto8r80F3SH2gctVA (button) folded before Flop (didn't bet)
Seat 3: vZGoOTJLQLhkPj4I+LNGig (small blind) folded before Flop
Seat 4: DnDcAdn9P0zGovMERigpFA (big blind) folded before Flop
Seat 5: sUVgUtgbfVx6JpvApozwhQ folded before Flop (didn't bet)
Seat 6: +sbyWwIcFp9kP0bDtMegfQ collected ($0.60)
Seat 7: uH1RN27w9SKa7TpVR9EFrQ folded before Flop (didn't bet)
Seat 8: VBHxUExRAMrbxUq/cVx9Gw folded before Flop (didn't bet)




PokerStars Game #59939651014:  Hold'em No Limit ($0.10/$0.25) - 2009/07/01 0:45:22 ET
Table 'G+4ZdyRoPjgaJY/jxSlZzQ' 9-max Seat #6 is the button
Seat 1: 0Ui5PFTLvpoTRdxcc8BNSQ ($31.55 in chips) 
Seat 2: 4awUyiDYTgylQKXZ9faBVA ($34.70 in chips) 
Seat 3: opOCI2p6kW0tINuVaAqmcQ ($30.95 in chips) 
Seat 5: s7Q6uNouhe7aE8JdFb9E+A ($26 in chips) 
Seat 6: gehe91e0IyVT0QU/XBkEyg ($27.80 in chips) 
Seat 8: 8GJHzzxiotOqC5gdtgpLoA ($7.85 in chips) 
Seat 9: AzTBzPGlrIHrrs1Q8oKcGA ($17.20 in chips) 
8GJHzzxiotOqC5gdtgpLoA: posts small blind $0.10
AzTBzPGlrIHrrs1Q8oKcGA: posts big blind $0.25
*** HOLE CARDS ***
0Ui5PFTLvpoTRdxcc8BNSQ has timed out
0Ui5PFTLvpoTRdxcc8BNSQ: folds 
0Ui5PFTLvpoTRdxcc8BNSQ is sitting out
4awUyiDYTgylQKXZ9faBVA: folds 
opOCI2p6kW0tINuVaAqmcQ: folds 
s7Q6uNouhe7aE8JdFb9E+A: folds 
gehe91e0IyVT0QU/XBkEyg: folds 
8GJHzzxiotOqC5gdtgpLoA: folds 
Uncalled bet ($0.15) returned to AzTBzPGlrIHrrs1Q8oKcGA
AzTBzPGlrIHrrs1Q8oKcGA collected $0.20 from pot
*** SUMMARY ***
Total pot $0.20 | Rake $0 
Seat 1: 0Ui5PFTLvpoTRdxcc8BNSQ folded before Flop (didn't bet)
Seat 2: 4awUyiDYTgylQKXZ9faBVA folded before Flop (didn't bet)
Seat 3: opOCI2p6kW0tINuVaAqmcQ folded before Flop (didn't bet)
Seat 5: s7Q6uNouhe7aE8JdFb9E+A folded before Flop (didn't bet)
Seat 6: gehe91e0IyVT0QU/XBkEyg (button) folded before Flop (didn't bet)
Seat 8: 8GJHzzxiotOqC5gdtgpLoA (small blind) folded before Flop
Seat 9: AzTBzPGlrIHrrs1Q8oKcGA (big blind) collected ($0.20)




PokerStars Game #59939650814:  Hold'em No Limit ($0.10/$0.25) - 2009/07/01 0:45:22 ET
Table 'z2yOdY2zyGWG1gh9WV9XtQ' 9-max Seat #5 is the button
Seat 1: k/tPF1MnFJtmPS14iqcejw ($28.35 in chips) 
Seat 2: s7Q6uNouhe7aE8JdFb9E+A ($25 in chips) 
Seat 4: BMTbQu92kfh1+tEQba3Flw ($16.80 in chips) 
Seat 5: DYB0aP91n+Rg/TIhycbaPQ ($15.45 in chips) 
Seat 6: vZGoOTJLQLhkPj4I+LNGig ($27.85 in chips) 
Seat 7: zDrucyjVn5aeekNEc3cJrA ($26.45 in chips) 
Seat 8: hIss79a4pu7GzJZepfgOpg ($26.25 in chips) 
vZGoOTJLQLhkPj4I+LNGig: posts small blind $0.10
zDrucyjVn5aeekNEc3cJrA: posts big blind $0.25
aPRz/2GxbXANYpVsQO8pdQ: sits out 
MIVCHqCqqlke0Lb0z7glcw: sits out 
*** HOLE CARDS ***
hIss79a4pu7GzJZepfgOpg: folds 
k/tPF1MnFJtmPS14iqcejw: raises $0.75 to $1
s7Q6uNouhe7aE8JdFb9E+A: folds 
BMTbQu92kfh1+tEQba3Flw: calls $1
DYB0aP91n+Rg/TIhycbaPQ: folds 
vZGoOTJLQLhkPj4I+LNGig: folds 
zDrucyjVn5aeekNEc3cJrA: folds 
*** FLOP *** [2h 5d 9s]
k/tPF1MnFJtmPS14iqcejw: bets $1.25
BMTbQu92kfh1+tEQba3Flw: folds 
Uncalled bet ($1.25) returned to k/tPF1MnFJtmPS14iqcejw
k/tPF1MnFJtmPS14iqcejw collected $2.25 from pot
k/tPF1MnFJtmPS14iqcejw: doesn't show hand 
*** SUMMARY ***
Total pot $2.35 | Rake $0.10 
Board [2h 5d 9s]
Seat 1: k/tPF1MnFJtmPS14iqcejw collected ($2.25)
Seat 2: s7Q6uNouhe7aE8JdFb9E+A folded before Flop (didn't bet)
Seat 4: BMTbQu92kfh1+tEQba3Flw folded on the Flop
Seat 5: DYB0aP91n+Rg/TIhycbaPQ (button) folded before Flop (didn't bet)
Seat 6: vZGoOTJLQLhkPj4I+LNGig (small blind) folded before Flop
Seat 7: zDrucyjVn5aeekNEc3cJrA (big blind) folded before Flop
Seat 8: hIss79a4pu7GzJZepfgOpg folded before Flop (didn't bet)




PokerStars Game #59939650636:  Hold'em No Limit ($0.10/$0.25) - 2009/07/01 0:45:22 ET
Table '+fuYjvJy9okLr23QyZtanA' 9-max Seat #5 is the button
Seat 1: s7Q6uNouhe7aE8JdFb9E+A ($25 in chips) 
Seat 4: H/l9NZvuOXwQIPOaVdj0rQ ($12 in chips) 
Seat 5: h48vKHbhkYz+3RYZCQ0tgA ($19.20 in chips) 
s7Q6uNouhe7aE8JdFb9E+A: posts small blind $0.10
H/l9NZvuOXwQIPOaVdj0rQ: posts big blind $0.25
*** HOLE CARDS ***
h48vKHbhkYz+3RYZCQ0tgA: raises $0.25 to $0.50
s7Q6uNouhe7aE8JdFb9E+A: folds 
H/l9NZvuOXwQIPOaVdj0rQ: calls $0.25
*** FLOP *** [7s Ad 6s]
H/l9NZvuOXwQIPOaVdj0rQ: bets $0.50
m8t4Jb/b1Fc5HHGe1uSZag joins the table at seat #6 
h48vKHbhkYz+3RYZCQ0tgA: raises $0.50 to $1
H/l9NZvuOXwQIPOaVdj0rQ: calls $0.50
*** TURN *** [7s Ad 6s] [9c]
H/l9NZvuOXwQIPOaVdj0rQ: bets $0.25
h48vKHbhkYz+3RYZCQ0tgA: raises $1.75 to $2
H/l9NZvuOXwQIPOaVdj0rQ: calls $1.75
*** RIVER *** [7s Ad 6s 9c] [2s]
H/l9NZvuOXwQIPOaVdj0rQ: checks 
h48vKHbhkYz+3RYZCQ0tgA: checks 
*** SHOW DOWN ***
H/l9NZvuOXwQIPOaVdj0rQ: shows [5s 4d] (high card Ace)
h48vKHbhkYz+3RYZCQ0tgA: shows [3d Ah] (a pair of Aces)
h48vKHbhkYz+3RYZCQ0tgA collected $6.80 from pot
*** SUMMARY ***
Total pot $7.10 | Rake $0.30 
Board [7s Ad 6s 9c 2s]
Seat 1: s7Q6uNouhe7aE8JdFb9E+A (small blind) folded before Flop
Seat 4: H/l9NZvuOXwQIPOaVdj0rQ (big blind) showed [5s 4d] and lost with high card Ace
Seat 5: h48vKHbhkYz+3RYZCQ0tgA (button) showed [3d Ah] and won ($6.80) with a pair of Aces




PokerStars Game #59939650714:  Hold'em No Limit ($0.10/$0.25) - 2009/07/01 0:45:22 ET
Table 'f9j+4UOgRPXbyNbQkZFm4w' 6-max Seat #1 is the button
Seat 1: BYxjLnV1/LL0aZcTbfAOvw ($25 in chips) 
Seat 3: wCBHaebpIJ2ZTqigoRi9DA ($21.95 in chips) 
Seat 4: hiTEr3yrERiQp3zHXRioVw ($27.15 in chips) 
Seat 5: 1lxYIAoJdZwAbzIkzWmSkw ($9.65 in chips) 
Seat 6: C84t1kUtjDF/zm38/Dpcng ($14 in chips) 
wCBHaebpIJ2ZTqigoRi9DA: posts small blind $0.10
hiTEr3yrERiQp3zHXRioVw: posts big blind $0.25
*** HOLE CARDS ***
1lxYIAoJdZwAbzIkzWmSkw: folds 
C84t1kUtjDF/zm38/Dpcng: raises $1.75 to $2
BYxjLnV1/LL0aZcTbfAOvw: folds 
wCBHaebpIJ2ZTqigoRi9DA: folds 
hiTEr3yrERiQp3zHXRioVw: folds 
Uncalled bet ($1.75) returned to C84t1kUtjDF/zm38/Dpcng
C84t1kUtjDF/zm38/Dpcng collected $0.60 from pot
*** SUMMARY ***
Total pot $0.60 | Rake $0 
Seat 1: BYxjLnV1/LL0aZcTbfAOvw (button) folded before Flop (didn't bet)
Seat 3: wCBHaebpIJ2ZTqigoRi9DA (small blind) folded before Flop
Seat 4: hiTEr3yrERiQp3zHXRioVw (big blind) folded before Flop
Seat 5: 1lxYIAoJdZwAbzIkzWmSkw folded before Flop (didn't bet)
Seat 6: C84t1kUtjDF/zm38/Dpcng collected ($0.60)




PokerStars Game #59939651226:  Hold'em No Limit ($0.10/$0.25) - 2009/07/01 0:45:22 ET
Table 'xmJKTGBeWCwutccj3YfupQ' 6-max Seat #5 is the button
Seat 2: BedjMfrlRfPgSq7CXpPAmg ($49.60 in chips) 
Seat 3: FStoHe64SQWqAsjya9pDkQ ($25 in chips) 
Seat 4: uWjhTVMpuIroxXcmD3Okug ($43.60 in chips) 
Seat 5: oBUDUfeUyCbZBsjxHZgSiw ($16.55 in chips) 
Seat 6: lYjWCpfCxX2kgcHY3v4Yow ($26.10 in chips) 
lYjWCpfCxX2kgcHY3v4Yow: posts small blind $0.10
acesnates2: is sitting out 
BedjMfrlRfPgSq7CXpPAmg: posts big blind $0.25
*** HOLE CARDS ***
FStoHe64SQWqAsjya9pDkQ: raises $0.50 to $0.75
uWjhTVMpuIroxXcmD3Okug: folds 
acesnates2 said, "smoke brk"
oBUDUfeUyCbZBsjxHZgSiw: folds 
lYjWCpfCxX2kgcHY3v4Yow: folds 
BedjMfrlRfPgSq7CXpPAmg: calls $0.50
*** FLOP *** [Tc 2s 5c]
BedjMfrlRfPgSq7CXpPAmg: checks 
uWjhTVMpuIroxXcmD3Okug said, "me too"
FStoHe64SQWqAsjya9pDkQ: bets $1
BedjMfrlRfPgSq7CXpPAmg: folds 
Uncalled bet ($1) returned to FStoHe64SQWqAsjya9pDkQ
uWjhTVMpuIroxXcmD3Okug is sitting out
FStoHe64SQWqAsjya9pDkQ collected $1.55 from pot
FStoHe64SQWqAsjya9pDkQ: doesn't show hand 
*** SUMMARY ***
Total pot $1.60 | Rake $0.05 
Board [Tc 2s 5c]
Seat 2: BedjMfrlRfPgSq7CXpPAmg (big blind) folded on the Flop
Seat 3: FStoHe64SQWqAsjya9pDkQ collected ($1.55)
Seat 4: uWjhTVMpuIroxXcmD3Okug folded before Flop (didn't bet)
Seat 5: oBUDUfeUyCbZBsjxHZgSiw (button) folded before Flop (didn't bet)
Seat 6: lYjWCpfCxX2kgcHY3v4Yow (small blind) folded before Flop




PokerStars Game #59939651650:  Hold'em No Limit ($0.10/$0.25) - 2009/07/01 0:45:23 ET
Table '4XGDnEByOol5up4aB2KbJw' 6-max Seat #3 is the button
Seat 1: kyRaCIljYA6l33lSKQfNsg ($26.85 in chips) 
Seat 2: SFmT9ZsVopnukjvAzrxTRg ($34.10 in chips) 
Seat 3: LtASJ9OlkqGrrUKGQlpGAw ($22.90 in chips) 
Seat 5: Dh01+rohD2p9pXLYeBlC5Q ($15.10 in chips) 
Seat 6: ELW+DKizJhLK7k40PMkD2Q ($35.60 in chips) 
Dh01+rohD2p9pXLYeBlC5Q: posts small blind $0.10
ELW+DKizJhLK7k40PMkD2Q: posts big blind $0.25
*** HOLE CARDS ***
kyRaCIljYA6l33lSKQfNsg: folds 
SFmT9ZsVopnukjvAzrxTRg: folds 
LtASJ9OlkqGrrUKGQlpGAw: folds 
Dh01+rohD2p9pXLYeBlC5Q: calls $0.15
ELW+DKizJhLK7k40PMkD2Q: raises $0.75 to $1
Dh01+rohD2p9pXLYeBlC5Q: raises $2 to $3
ELW+DKizJhLK7k40PMkD2Q: calls $2
*** FLOP *** [9h 7c As]
Dh01+rohD2p9pXLYeBlC5Q: checks 
ELW+DKizJhLK7k40PMkD2Q: checks 
*** TURN *** [9h 7c As] [Kh]
sjoibHX/s93+8Kwa5aB1dA has returned
Dh01+rohD2p9pXLYeBlC5Q: bets $3
ELW+DKizJhLK7k40PMkD2Q: folds 
Uncalled bet ($3) returned to Dh01+rohD2p9pXLYeBlC5Q
Dh01+rohD2p9pXLYeBlC5Q collected $5.70 from pot
*** SUMMARY ***
Total pot $6 | Rake $0.30 
Board [9h 7c As Kh]
Seat 1: kyRaCIljYA6l33lSKQfNsg folded before Flop (didn't bet)
Seat 2: SFmT9ZsVopnukjvAzrxTRg folded before Flop (didn't bet)
Seat 3: LtASJ9OlkqGrrUKGQlpGAw (button) folded before Flop (didn't bet)
Seat 5: Dh01+rohD2p9pXLYeBlC5Q (small blind) collected ($5.70)
Seat 6: ELW+DKizJhLK7k40PMkD2Q (big blind) folded on the Turn




PokerStars Game #59939651500:  Hold'em No Limit ($0.10/$0.25) - 2009/07/01 0:45:23 ET
Table 'yRuHgMpxv4rPBXeM6HFESw' 6-max Seat #3 is the button
Seat 1: MkNgTuvyxpHXkeIm5JITHQ ($10.70 in chips) 
Seat 2: iwlxXocltgSdaBmusNXanQ ($15.10 in chips) 
Seat 3: zZ8zH49EwNs0mqgppOaL9g ($50.20 in chips) 
Seat 4: ypXnt+kzrF/5y8QN2rkt1A ($24.35 in chips) 
Seat 5: gaPMxLGp9SOj4Lq6t+/0Ig ($13.30 in chips) 
Seat 6: 4YSTu0Cdzpppe1lUgCZGCQ ($25 in chips) 
ypXnt+kzrF/5y8QN2rkt1A: posts small blind $0.10
gaPMxLGp9SOj4Lq6t+/0Ig: posts big blind $0.25
*** HOLE CARDS ***
4YSTu0Cdzpppe1lUgCZGCQ: folds 
MkNgTuvyxpHXkeIm5JITHQ: calls $0.25
iwlxXocltgSdaBmusNXanQ: calls $0.25
zZ8zH49EwNs0mqgppOaL9g: folds 
ypXnt+kzrF/5y8QN2rkt1A: calls $0.15
gaPMxLGp9SOj4Lq6t+/0Ig: checks 
*** FLOP *** [Jc 9d Tc]
ypXnt+kzrF/5y8QN2rkt1A: checks 
gaPMxLGp9SOj4Lq6t+/0Ig: checks 
MkNgTuvyxpHXkeIm5JITHQ: checks 
iwlxXocltgSdaBmusNXanQ: bets $0.50
ypXnt+kzrF/5y8QN2rkt1A: folds 
gaPMxLGp9SOj4Lq6t+/0Ig: folds 
MkNgTuvyxpHXkeIm5JITHQ: folds 
Uncalled bet ($0.50) returned to iwlxXocltgSdaBmusNXanQ
iwlxXocltgSdaBmusNXanQ collected $0.95 from pot
*** SUMMARY ***
Total pot $1 | Rake $0.05 
Board [Jc 9d Tc]
Seat 1: MkNgTuvyxpHXkeIm5JITHQ folded on the Flop
Seat 2: iwlxXocltgSdaBmusNXanQ collected ($0.95)
Seat 3: zZ8zH49EwNs0mqgppOaL9g (button) folded before Flop (didn't bet)
Seat 4: ypXnt+kzrF/5y8QN2rkt1A (small blind) folded on the Flop
Seat 5: gaPMxLGp9SOj4Lq6t+/0Ig (big blind) folded on the Flop
Seat 6: 4YSTu0Cdzpppe1lUgCZGCQ folded before Flop (didn't bet)




PokerStars Game #59939651680:  Hold'em No Limit ($0.10/$0.25) - 2009/07/01 0:45:23 ET
Table '50f2Xa1b1jp6cfdTAgXFIg' 9-max Seat #7 is the button
Seat 1: JwUqpgqGHS96sdpExhhEqw ($7.75 in chips) 
Seat 3: GQTWTgG7Ydy9q/vohVnKmQ ($25.35 in chips) 
Seat 4: ghNKXUBl/H+t83JF079ZBA ($28.50 in chips) 
Seat 5: OlPJsgR4xypSg/w1z7Gyvw ($53.50 in chips) 
Seat 6: Vl8zO7J9ZOnk8Og8eXFezg ($40.90 in chips) 
Seat 7: TeWJxSETzbXGiYKx0y+dtg ($25.30 in chips) 
Seat 8: jeKWRUkMaVn8rEUjnJKqpg ($25 in chips) 
Seat 9: gehe91e0IyVT0QU/XBkEyg ($27.90 in chips) 
jeKWRUkMaVn8rEUjnJKqpg: posts small blind $0.10
gehe91e0IyVT0QU/XBkEyg: posts big blind $0.25
F7pnn6czNpHvRM55XcA2EA: sits out 
*** HOLE CARDS ***
JwUqpgqGHS96sdpExhhEqw: raises $0.50 to $0.75
GQTWTgG7Ydy9q/vohVnKmQ: folds 
ghNKXUBl/H+t83JF079ZBA: folds 
OlPJsgR4xypSg/w1z7Gyvw: folds 
Vl8zO7J9ZOnk8Og8eXFezg: folds 
TeWJxSETzbXGiYKx0y+dtg: folds 
jeKWRUkMaVn8rEUjnJKqpg: folds 
gehe91e0IyVT0QU/XBkEyg: folds 
Uncalled bet ($0.50) returned to JwUqpgqGHS96sdpExhhEqw
JwUqpgqGHS96sdpExhhEqw collected $0.60 from pot
*** SUMMARY ***
Total pot $0.60 | Rake $0 
Seat 1: JwUqpgqGHS96sdpExhhEqw collected ($0.60)
Seat 3: GQTWTgG7Ydy9q/vohVnKmQ folded before Flop (didn't bet)
Seat 4: ghNKXUBl/H+t83JF079ZBA folded before Flop (didn't bet)
Seat 5: OlPJsgR4xypSg/w1z7Gyvw folded before Flop (didn't bet)
Seat 6: Vl8zO7J9ZOnk8Og8eXFezg folded before Flop (didn't bet)
Seat 7: TeWJxSETzbXGiYKx0y+dtg (button) folded before Flop (didn't bet)
Seat 8: jeKWRUkMaVn8rEUjnJKqpg (small blind) folded before Flop
Seat 9: gehe91e0IyVT0QU/XBkEyg (big blind) folded before Flop




PokerStars Game #59939651772:  Hold'em No Limit ($0.10/$0.25) - 2009/07/01 0:45:23 ET
Table 'HQOv+27sJF7e8+zUsBlT2w' 9-max Seat #9 is the button
Seat 1: CbXUS6Z2rXZxL1AKduNtmQ ($26 in chips) 
Seat 2: MG90wfSJZnOejs/KD3vlQQ ($25 in chips) 
Seat 3: 18G4P1XstjNvItdGUITxgw ($29.45 in chips) 
Seat 4: kRW/Cdh6F1t40Vs43OFbYA ($16.85 in chips) 
Seat 5: nD+0ILJGeuYzreVIK9/wcA ($16.85 in chips) 
Seat 6: vZGoOTJLQLhkPj4I+LNGig ($30.25 in chips) 
Seat 7: GmzfAfxcxu1kGbPC+9LkVg ($24.05 in chips) 
Seat 8: RaXCy4DBrUrZSg4MF8FyDg ($13.55 in chips) 
Seat 9: gehe91e0IyVT0QU/XBkEyg ($25 in chips) 
CbXUS6Z2rXZxL1AKduNtmQ: posts small blind $0.10
MG90wfSJZnOejs/KD3vlQQ: posts big blind $0.25
*** HOLE CARDS ***
18G4P1XstjNvItdGUITxgw: folds 
kRW/Cdh6F1t40Vs43OFbYA: folds 
nD+0ILJGeuYzreVIK9/wcA: folds 
vZGoOTJLQLhkPj4I+LNGig: folds 
GmzfAfxcxu1kGbPC+9LkVg: folds 
RaXCy4DBrUrZSg4MF8FyDg: folds 
gehe91e0IyVT0QU/XBkEyg: folds 
CbXUS6Z2rXZxL1AKduNtmQ: calls $0.15
MG90wfSJZnOejs/KD3vlQQ: checks 
*** FLOP *** [6c Ad 6s]
CbXUS6Z2rXZxL1AKduNtmQ: checks 
MG90wfSJZnOejs/KD3vlQQ: bets $0.40
CbXUS6Z2rXZxL1AKduNtmQ: folds 
Uncalled bet ($0.40) returned to MG90wfSJZnOejs/KD3vlQQ
MG90wfSJZnOejs/KD3vlQQ collected $0.50 from pot
MG90wfSJZnOejs/KD3vlQQ: doesn't show hand 
*** SUMMARY ***
Total pot $0.50 | Rake $0 
Board [6c Ad 6s]
Seat 1: CbXUS6Z2rXZxL1AKduNtmQ (small blind) folded on the Flop
Seat 2: MG90wfSJZnOejs/KD3vlQQ (big blind) collected ($0.50)
Seat 3: 18G4P1XstjNvItdGUITxgw folded before Flop (didn't bet)
Seat 4: kRW/Cdh6F1t40Vs43OFbYA folded before Flop (didn't bet)
Seat 5: nD+0ILJGeuYzreVIK9/wcA folded before Flop (didn't bet)
Seat 6: vZGoOTJLQLhkPj4I+LNGig folded before Flop (didn't bet)
Seat 7: GmzfAfxcxu1kGbPC+9LkVg folded before Flop (didn't bet)
Seat 8: RaXCy4DBrUrZSg4MF8FyDg folded before Flop (didn't bet)
Seat 9: gehe91e0IyVT0QU/XBkEyg (button) folded before Flop (didn't bet)




PokerStars Game #59939651976:  Hold'em No Limit ($0.10/$0.25) - 2009/07/01 0:45:24 ET
Table 'h02LhQ7B/Zk4ETRxxHhGYA' 9-max Seat #1 is the button
Seat 1: sD+TKtt36XiiN6jqHiLwDA ($32.85 in chips) 
Seat 2: RJ/x9oZtt1RZLaJEQwZOxQ ($27.55 in chips) 
Seat 3: kqpa/IbqkUrwPb3hbA7/ww ($8.75 in chips) 
Seat 4: tYsOBqdU1+x+yFI7zHO7hQ ($38.20 in chips) 
Seat 5: cUxk0Jk4lrUQv9CJl0LPlg ($17.35 in chips) 
Seat 6: kN/irnQSdb8jibbN4f1O+Q ($18.95 in chips) 
Seat 7: rUpvA02nErFvZ4yFbDR8XA ($18.95 in chips) 
Seat 8: 7tW694tRVJnYdoa16Dw4RQ ($17.10 in chips) 
Seat 9: 1c/7DHPx5CDTmAfk8/bWeA ($15.90 in chips) 
RJ/x9oZtt1RZLaJEQwZOxQ: posts small blind $0.10
kqpa/IbqkUrwPb3hbA7/ww: posts big blind $0.25
*** HOLE CARDS ***
tYsOBqdU1+x+yFI7zHO7hQ: folds 
cUxk0Jk4lrUQv9CJl0LPlg: folds 
kN/irnQSdb8jibbN4f1O+Q: raises $0.50 to $0.75
rUpvA02nErFvZ4yFbDR8XA: folds 
7tW694tRVJnYdoa16Dw4RQ: folds 
1c/7DHPx5CDTmAfk8/bWeA: folds 
sD+TKtt36XiiN6jqHiLwDA: folds 
RJ/x9oZtt1RZLaJEQwZOxQ: folds 
kqpa/IbqkUrwPb3hbA7/ww: folds 
Uncalled bet ($0.50) returned to kN/irnQSdb8jibbN4f1O+Q
kN/irnQSdb8jibbN4f1O+Q collected $0.60 from pot
*** SUMMARY ***
Total pot $0.60 | Rake $0 
Seat 1: sD+TKtt36XiiN6jqHiLwDA (button) folded before Flop (didn't bet)
Seat 2: RJ/x9oZtt1RZLaJEQwZOxQ (small blind) folded before Flop
Seat 3: kqpa/IbqkUrwPb3hbA7/ww (big blind) folded before Flop
Seat 4: tYsOBqdU1+x+yFI7zHO7hQ folded before Flop (didn't bet)
Seat 5: cUxk0Jk4lrUQv9CJl0LPlg folded before Flop (didn't bet)
Seat 6: kN/irnQSdb8jibbN4f1O+Q collected ($0.60)
Seat 7: rUpvA02nErFvZ4yFbDR8XA folded before Flop (didn't bet)
Seat 8: 7tW694tRVJnYdoa16Dw4RQ folded before Flop (didn't bet)
Seat 9: 1c/7DHPx5CDTmAfk8/bWeA folded before Flop (didn't bet)




PokerStars Game #59939652514:  Hold'em No Limit ($0.10/$0.25) - 2009/07/01 0:45:24 ET
Table 'wPWRBZPJl1HAnysw7qRR0A' 6-max Seat #6 is the button
Seat 1: cPO/1/dTcZpLkQFm3jH3Rg ($49.35 in chips) 
Seat 2: 48oT5xFI+5CHUJlfoGrE4w ($7.70 in chips) 
Seat 3: gqW2aBCmrIw65BvwjTFN6Q ($27.15 in chips) 
Seat 4: kbpWbC+dJNBphHl1jtw7bw ($28.65 in chips) 
Seat 5: LtASJ9OlkqGrrUKGQlpGAw ($21.20 in chips) 
Seat 6: VLoE/jniCqHZuUkx8Esf6w ($24.45 in chips) 
cPO/1/dTcZpLkQFm3jH3Rg: posts small blind $0.10
48oT5xFI+5CHUJlfoGrE4w: posts big blind $0.25
*** HOLE CARDS ***
gqW2aBCmrIw65BvwjTFN6Q: folds 
kbpWbC+dJNBphHl1jtw7bw: folds 
LtASJ9OlkqGrrUKGQlpGAw: folds 
VLoE/jniCqHZuUkx8Esf6w: calls $0.25
cPO/1/dTcZpLkQFm3jH3Rg: folds 
48oT5xFI+5CHUJlfoGrE4w: checks 
*** FLOP *** [Ah Td Kd]
48oT5xFI+5CHUJlfoGrE4w: checks 
VLoE/jniCqHZuUkx8Esf6w: bets $0.50
48oT5xFI+5CHUJlfoGrE4w: folds 
Uncalled bet ($0.50) returned to VLoE/jniCqHZuUkx8Esf6w
VLoE/jniCqHZuUkx8Esf6w collected $0.60 from pot
*** SUMMARY ***
Total pot $0.60 | Rake $0 
Board [Ah Td Kd]
Seat 1: cPO/1/dTcZpLkQFm3jH3Rg (small blind) folded before Flop
Seat 2: 48oT5xFI+5CHUJlfoGrE4w (big blind) folded on the Flop
Seat 3: gqW2aBCmrIw65BvwjTFN6Q folded before Flop (didn't bet)
Seat 4: kbpWbC+dJNBphHl1jtw7bw folded before Flop (didn't bet)
Seat 5: LtASJ9OlkqGrrUKGQlpGAw folded before Flop (didn't bet)
Seat 6: VLoE/jniCqHZuUkx8Esf6w (button) collected ($0.60)




PokerStars Game #59939652366:  Hold'em No Limit ($0.10/$0.25) - 2009/07/01 0:45:24 ET
Table 'WY+lMaAoIdBZmwk27/RJCA' 6-max Seat #1 is the button
Seat 1: lYjWCpfCxX2kgcHY3v4Yow ($25.70 in chips) 
Seat 2: cPO/1/dTcZpLkQFm3jH3Rg ($25.10 in chips) 
Seat 3: 79Q62AM0VB++TQYiBlOYsA ($37.20 in chips) 
Seat 4: cGfAi40F+9odP4v0stvfiQ ($32.25 in chips) 
Seat 5: wKFJ513ucluNNiMlkXcDOQ ($25.35 in chips) 
Seat 6: I1TxPvWj8NfG8orglCinNA ($26 in chips) 
cPO/1/dTcZpLkQFm3jH3Rg: posts small blind $0.10
79Q62AM0VB++TQYiBlOYsA: posts big blind $0.25
*** HOLE CARDS ***
cGfAi40F+9odP4v0stvfiQ: calls $0.25
wKFJ513ucluNNiMlkXcDOQ: raises $1 to $1.25
I1TxPvWj8NfG8orglCinNA has timed out
I1TxPvWj8NfG8orglCinNA: folds 
I1TxPvWj8NfG8orglCinNA is sitting out
lYjWCpfCxX2kgcHY3v4Yow: folds 
I1TxPvWj8NfG8orglCinNA has returned
cPO/1/dTcZpLkQFm3jH3Rg: raises $2.75 to $4
79Q62AM0VB++TQYiBlOYsA: folds 
cGfAi40F+9odP4v0stvfiQ: folds 
wKFJ513ucluNNiMlkXcDOQ: folds 
Uncalled bet ($2.75) returned to cPO/1/dTcZpLkQFm3jH3Rg
cPO/1/dTcZpLkQFm3jH3Rg collected $3 from pot
*** SUMMARY ***
Total pot $3 | Rake $0 
Seat 1: lYjWCpfCxX2kgcHY3v4Yow (button) folded before Flop (didn't bet)
Seat 2: cPO/1/dTcZpLkQFm3jH3Rg (small blind) collected ($3)
Seat 3: 79Q62AM0VB++TQYiBlOYsA (big blind) folded before Flop
Seat 4: cGfAi40F+9odP4v0stvfiQ folded before Flop
Seat 5: wKFJ513ucluNNiMlkXcDOQ folded before Flop
Seat 6: I1TxPvWj8NfG8orglCinNA folded before Flop (didn't bet)




PokerStars Game #59939652374:  Hold'em No Limit ($0.10/$0.25) - 2009/07/01 0:45:24 ET
Table 'L5GvbdQO5aCZJSE6pyQ8OA' 6-max Seat #3 is the button
Seat 1: FOcO5GvOP3rgvLGPLVkg5g ($31.30 in chips) 
Seat 2: LxehwDpTQ19ph4Qmc78+Pw ($13.40 in chips) 
Seat 3: wKFJ513ucluNNiMlkXcDOQ ($27.10 in chips) 
Seat 4: ErIN0JRL5srYjT6en1f8YQ ($34.35 in chips) 
Seat 6: v+QfkGiuj9bgtuNoVnDO8w ($36.15 in chips) 
ErIN0JRL5srYjT6en1f8YQ: posts small blind $0.10
v+QfkGiuj9bgtuNoVnDO8w: posts big blind $0.25
*** HOLE CARDS ***
FOcO5GvOP3rgvLGPLVkg5g: folds 
LxehwDpTQ19ph4Qmc78+Pw: folds 
wKFJ513ucluNNiMlkXcDOQ: raises $0.75 to $1
4kWQxGbT5FZ1dkPd1bE45Q joins the table at seat #5 
ErIN0JRL5srYjT6en1f8YQ: folds 
v+QfkGiuj9bgtuNoVnDO8w: folds 
Uncalled bet ($0.75) returned to wKFJ513ucluNNiMlkXcDOQ
wKFJ513ucluNNiMlkXcDOQ collected $0.60 from pot
wKFJ513ucluNNiMlkXcDOQ: doesn't show hand 
*** SUMMARY ***
Total pot $0.60 | Rake $0 
Seat 1: FOcO5GvOP3rgvLGPLVkg5g folded before Flop (didn't bet)
Seat 2: LxehwDpTQ19ph4Qmc78+Pw folded before Flop (didn't bet)
Seat 3: wKFJ513ucluNNiMlkXcDOQ (button) collected ($0.60)
Seat 4: ErIN0JRL5srYjT6en1f8YQ (small blind) folded before Flop
Seat 6: v+QfkGiuj9bgtuNoVnDO8w (big blind) folded before Flop




PokerStars Game #59939652210:  Hold'em No Limit ($0.10/$0.25) - 2009/07/01 0:45:24 ET
Table '0M5QEJGOThqZwQ/sjbjXYw' 6-max Seat #5 is the button
Seat 1: RVBrV53KVTJ2T2VL8ucnfw ($27.95 in chips) 
Seat 2: /gJNBeCkWL4o85/jvlZ4BA ($44.10 in chips) 
Seat 4: fZQg9veL7Dd/Z04ZTjC+wQ ($32.45 in chips) 
Seat 5: ErIN0JRL5srYjT6en1f8YQ ($26.75 in chips) 
Seat 6: mYz11CHiw5KsDCRD5T7/jg ($59 in chips) 
mYz11CHiw5KsDCRD5T7/jg: posts small blind $0.10
RVBrV53KVTJ2T2VL8ucnfw: posts big blind $0.25
*** HOLE CARDS ***
/gJNBeCkWL4o85/jvlZ4BA: folds 
fZQg9veL7Dd/Z04ZTjC+wQ: raises $0.75 to $1
d0J1xuhsynEY81YHwAvJ5g joins the table at seat #3 
ErIN0JRL5srYjT6en1f8YQ: calls $1
mYz11CHiw5KsDCRD5T7/jg: folds 
RVBrV53KVTJ2T2VL8ucnfw: calls $0.75
*** FLOP *** [4c Qd 3d]
RVBrV53KVTJ2T2VL8ucnfw: checks 
fZQg9veL7Dd/Z04ZTjC+wQ: bets $2.50
ErIN0JRL5srYjT6en1f8YQ: raises $4 to $6.50
RVBrV53KVTJ2T2VL8ucnfw: folds 
fZQg9veL7Dd/Z04ZTjC+wQ: raises $24.95 to $31.45 and is all-in
ErIN0JRL5srYjT6en1f8YQ: calls $19.25 and is all-in
Uncalled bet ($5.70) returned to fZQg9veL7Dd/Z04ZTjC+wQ
*** TURN *** [4c Qd 3d] [9s]
*** RIVER *** [4c Qd 3d 9s] [6d]
*** SHOW DOWN ***
fZQg9veL7Dd/Z04ZTjC+wQ: shows [Qh Kh] (a pair of Queens)
ErIN0JRL5srYjT6en1f8YQ: shows [Qc Qs] (three of a kind, Queens)
ErIN0JRL5srYjT6en1f8YQ collected $52.60 from pot
*** SUMMARY ***
Total pot $54.60 | Rake $2 
Board [4c Qd 3d 9s 6d]
Seat 1: RVBrV53KVTJ2T2VL8ucnfw (big blind) folded on the Flop
Seat 2: /gJNBeCkWL4o85/jvlZ4BA folded before Flop (didn't bet)
Seat 4: fZQg9veL7Dd/Z04ZTjC+wQ showed [Qh Kh] and lost with a pair of Queens
Seat 5: ErIN0JRL5srYjT6en1f8YQ (button) showed [Qc Qs] and won ($52.60) with three of a kind, Queens
Seat 6: mYz11CHiw5KsDCRD5T7/jg (small blind) folded before Flop




PokerStars Game #59939652034:  Hold'em No Limit ($0.10/$0.25) - 2009/07/01 0:45:24 ET
Table 'zJTgUqdWn7ojWWqV4pItEQ' 9-max Seat #3 is the button
Seat 1: CbXUS6Z2rXZxL1AKduNtmQ ($30.10 in chips) 
Seat 2: 7wo6Sr7QG3Zo6BaBDV1BOw ($4 in chips) 
Seat 3: 2N94FgK4Y2izKFIB+wJOjw ($20.95 in chips) 
Seat 6: cQQdn+v2h6ICJU1fq6mEyA ($24.45 in chips) 
Seat 7: 4oA316mXLIui1QY63GXBUg ($25 in chips) 
Seat 8: iG7VeTyBWf6wYNvZpbTcbw ($14.75 in chips) 
Seat 9: DnDcAdn9P0zGovMERigpFA ($25.25 in chips) 
murdog71 will be allowed to play after the button
cQQdn+v2h6ICJU1fq6mEyA: posts small blind $0.10
4oA316mXLIui1QY63GXBUg: posts big blind $0.25
*** HOLE CARDS ***
iG7VeTyBWf6wYNvZpbTcbw: folds 
DnDcAdn9P0zGovMERigpFA: folds 
CbXUS6Z2rXZxL1AKduNtmQ: folds 
7wo6Sr7QG3Zo6BaBDV1BOw: raises $0.75 to $1
2N94FgK4Y2izKFIB+wJOjw: folds 
cQQdn+v2h6ICJU1fq6mEyA: calls $0.90
4oA316mXLIui1QY63GXBUg: folds 
*** FLOP *** [2h Kd 9d]
cQQdn+v2h6ICJU1fq6mEyA: bets $3
7wo6Sr7QG3Zo6BaBDV1BOw: folds 
Uncalled bet ($3) returned to cQQdn+v2h6ICJU1fq6mEyA
cQQdn+v2h6ICJU1fq6mEyA collected $2.15 from pot
cQQdn+v2h6ICJU1fq6mEyA: doesn't show hand 
*** SUMMARY ***
Total pot $2.25 | Rake $0.10 
Board [2h Kd 9d]
Seat 1: CbXUS6Z2rXZxL1AKduNtmQ folded before Flop (didn't bet)
Seat 2: 7wo6Sr7QG3Zo6BaBDV1BOw folded on the Flop
Seat 3: 2N94FgK4Y2izKFIB+wJOjw (button) folded before Flop (didn't bet)
Seat 6: cQQdn+v2h6ICJU1fq6mEyA (small blind) collected ($2.15)
Seat 7: 4oA316mXLIui1QY63GXBUg (big blind) folded before Flop
Seat 8: iG7VeTyBWf6wYNvZpbTcbw folded before Flop (didn't bet)
Seat 9: DnDcAdn9P0zGovMERigpFA folded before Flop (didn't bet)




PokerStars Game #59939652786:  Hold'em No Limit ($0.10/$0.25) - 2009/07/01 0:45:25 ET
Table 'luMgmRPIo47e7iXDlheIwA' 6-max Seat #4 is the button
Seat 1: z/jAqpWD9ifpbtEpwGyInw ($8.65 in chips) 
Seat 3: W6Y6au0wf7gRAlqJYgOezw ($12.80 in chips) 
Seat 4: n2OZezRXTtdzQt4SuIy8TQ ($23.85 in chips) 
zxeVQGaMKDsDzmSY+AInjA will be allowed to play after the button
z/jAqpWD9ifpbtEpwGyInw: posts small blind $0.10
W6Y6au0wf7gRAlqJYgOezw: posts big blind $0.25
*** HOLE CARDS ***
n2OZezRXTtdzQt4SuIy8TQ: folds 
z/jAqpWD9ifpbtEpwGyInw: calls $0.15
Zb8xGmbjS8ghABxs9n6huA joins the table at seat #6 
W6Y6au0wf7gRAlqJYgOezw: checks 
*** FLOP *** [Ah 6h Jc]
z/jAqpWD9ifpbtEpwGyInw: bets $0.25
W6Y6au0wf7gRAlqJYgOezw: folds 
Uncalled bet ($0.25) returned to z/jAqpWD9ifpbtEpwGyInw
z/jAqpWD9ifpbtEpwGyInw collected $0.50 from pot
z/jAqpWD9ifpbtEpwGyInw: doesn't show hand 
*** SUMMARY ***
Total pot $0.50 | Rake $0 
Board [Ah 6h Jc]
Seat 1: z/jAqpWD9ifpbtEpwGyInw (small blind) collected ($0.50)
Seat 3: W6Y6au0wf7gRAlqJYgOezw (big blind) folded on the Flop
Seat 4: n2OZezRXTtdzQt4SuIy8TQ (button) folded before Flop (didn't bet)




PokerStars Game #59939653010:  Hold'em No Limit ($0.10/$0.25) - 2009/07/01 0:45:25 ET
Table 'eOXPe2c6mG7DOFKvMsZZfA' 6-max Seat #5 is the button
Seat 1: ShXPHWfjhfmAwLgDdm6bRQ ($7.50 in chips) 
Seat 2: ELW+DKizJhLK7k40PMkD2Q ($33.65 in chips) 
Seat 3: kReyZ6g6Fu3tQ0nyjDf9kA ($29.65 in chips) 
Seat 4: zHHLkD2sRljslKKeQv/ZQw ($41.90 in chips) 
Seat 5: NhUN/JpAprdJeamFBgJH1w ($25 in chips) 
Seat 6: wKFJ513ucluNNiMlkXcDOQ ($26.95 in chips) 
wKFJ513ucluNNiMlkXcDOQ: posts small blind $0.10
ShXPHWfjhfmAwLgDdm6bRQ: posts big blind $0.25
*** HOLE CARDS ***
ELW+DKizJhLK7k40PMkD2Q: folds 
kReyZ6g6Fu3tQ0nyjDf9kA: folds 
zHHLkD2sRljslKKeQv/ZQw: folds 
NhUN/JpAprdJeamFBgJH1w: raises $0.75 to $1
wKFJ513ucluNNiMlkXcDOQ: folds 
ShXPHWfjhfmAwLgDdm6bRQ: folds 
Uncalled bet ($0.75) returned to NhUN/JpAprdJeamFBgJH1w
NhUN/JpAprdJeamFBgJH1w collected $0.60 from pot
NhUN/JpAprdJeamFBgJH1w: doesn't show hand 
*** SUMMARY ***
Total pot $0.60 | Rake $0 
Seat 1: ShXPHWfjhfmAwLgDdm6bRQ (big blind) folded before Flop
Seat 2: ELW+DKizJhLK7k40PMkD2Q folded before Flop (didn't bet)
Seat 3: kReyZ6g6Fu3tQ0nyjDf9kA folded before Flop (didn't bet)
Seat 4: zHHLkD2sRljslKKeQv/ZQw folded before Flop (didn't bet)
Seat 5: NhUN/JpAprdJeamFBgJH1w (button) collected ($0.60)
Seat 6: wKFJ513ucluNNiMlkXcDOQ (small blind) folded before Flop




PokerStars Game #59939652594:  Hold'em No Limit ($0.10/$0.25) - 2009/07/01 0:45:25 ET
Table '5510FxlYzKi+U6MIpo8IPA' 6-max Seat #4 is the button
Seat 1: KM6ogk7SqyRlk3m9b0h+7A ($20.65 in chips) 
Seat 2: gqW2aBCmrIw65BvwjTFN6Q ($25 in chips) 
Seat 3: v+QfkGiuj9bgtuNoVnDO8w ($33.90 in chips) 
Seat 4: cPO/1/dTcZpLkQFm3jH3Rg ($27.20 in chips) 
Seat 5: 5E1iMY5xyboow7Xm0v7Idw ($6.85 in chips) 
Seat 6: SFmT9ZsVopnukjvAzrxTRg ($30.25 in chips) 
5E1iMY5xyboow7Xm0v7Idw: posts small blind $0.10
SFmT9ZsVopnukjvAzrxTRg: posts big blind $0.25
*** HOLE CARDS ***
KM6ogk7SqyRlk3m9b0h+7A: folds 
gqW2aBCmrIw65BvwjTFN6Q: folds 
v+QfkGiuj9bgtuNoVnDO8w: folds 
cPO/1/dTcZpLkQFm3jH3Rg: folds 
5E1iMY5xyboow7Xm0v7Idw: calls $0.15
SFmT9ZsVopnukjvAzrxTRg: checks 
*** FLOP *** [3h 9s Ks]
5E1iMY5xyboow7Xm0v7Idw: checks 
SFmT9ZsVopnukjvAzrxTRg: checks 
*** TURN *** [3h 9s Ks] [5h]
5E1iMY5xyboow7Xm0v7Idw: bets $0.50
SFmT9ZsVopnukjvAzrxTRg: folds 
Uncalled bet ($0.50) returned to 5E1iMY5xyboow7Xm0v7Idw
5E1iMY5xyboow7Xm0v7Idw collected $0.50 from pot
5E1iMY5xyboow7Xm0v7Idw: doesn't show hand 
*** SUMMARY ***
Total pot $0.50 | Rake $0 
Board [3h 9s Ks 5h]
Seat 1: KM6ogk7SqyRlk3m9b0h+7A folded before Flop (didn't bet)
Seat 2: gqW2aBCmrIw65BvwjTFN6Q folded before Flop (didn't bet)
Seat 3: v+QfkGiuj9bgtuNoVnDO8w folded before Flop (didn't bet)
Seat 4: cPO/1/dTcZpLkQFm3jH3Rg (button) folded before Flop (didn't bet)
Seat 5: 5E1iMY5xyboow7Xm0v7Idw (small blind) collected ($0.50)
Seat 6: SFmT9ZsVopnukjvAzrxTRg (big blind) folded on the Turn




PokerStars Game #59939652850:  Hold'em No Limit ($0.10/$0.25) - 2009/07/01 0:45:25 ET
Table 'M8kYidAX3ib7pLKW7edFLw' 6-max Seat #6 is the button
Seat 1: jp34e617tIzV8tKIWmfAbA ($25 in chips) 
Seat 2: 4kWQxGbT5FZ1dkPd1bE45Q ($25 in chips) 
Seat 3: q+Sip/IIcvzqgZt1pJAWTw ($9.35 in chips) 
Seat 4: /bjna2FTN7pPjqYGzmDE0Q ($24.65 in chips) 
Seat 5: bDKopKTvPi3W+PEnYUX3tg ($49.20 in chips) 
Seat 6: NqFoyDgzLwu4dOmSRXnFBA ($14.05 in chips) 
q+Sip/IIcvzqgZt1pJAWTw said, "oh"
jp34e617tIzV8tKIWmfAbA: posts small blind $0.10
4kWQxGbT5FZ1dkPd1bE45Q: posts big blind $0.25
*** HOLE CARDS ***
q+Sip/IIcvzqgZt1pJAWTw: folds 
/bjna2FTN7pPjqYGzmDE0Q: folds 
bDKopKTvPi3W+PEnYUX3tg: folds 
NqFoyDgzLwu4dOmSRXnFBA: folds 
jp34e617tIzV8tKIWmfAbA: calls $0.15
4kWQxGbT5FZ1dkPd1bE45Q: checks 
*** FLOP *** [Js Qs Ts]
jp34e617tIzV8tKIWmfAbA: bets $0.50
4kWQxGbT5FZ1dkPd1bE45Q: folds 
Uncalled bet ($0.50) returned to jp34e617tIzV8tKIWmfAbA
jp34e617tIzV8tKIWmfAbA collected $0.50 from pot
*** SUMMARY ***
Total pot $0.50 | Rake $0 
Board [Js Qs Ts]
Seat 1: jp34e617tIzV8tKIWmfAbA (small blind) collected ($0.50)
Seat 2: 4kWQxGbT5FZ1dkPd1bE45Q (big blind) folded on the Flop
Seat 3: q+Sip/IIcvzqgZt1pJAWTw folded before Flop (didn't bet)
Seat 4: /bjna2FTN7pPjqYGzmDE0Q folded before Flop (didn't bet)
Seat 5: bDKopKTvPi3W+PEnYUX3tg folded before Flop (didn't bet)
Seat 6: NqFoyDgzLwu4dOmSRXnFBA (button) folded before Flop (didn't bet)




PokerStars Game #59939653024:  Hold'em No Limit ($0.10/$0.25) - 2009/07/01 0:45:25 ET
Table 'qryc9C/ELyQ3lubOaELNAQ' 6-max Seat #2 is the button
Seat 1: OZc6kkoTwtITj1ZfreJK1A ($24.60 in chips) 
Seat 2: qvQc9BHp2FhQjrltLiBN+w ($12.90 in chips) 
Seat 3: UXRtG8J9PoBZWTsNtqdoDA ($20.55 in chips) 
Seat 4: v+QfkGiuj9bgtuNoVnDO8w ($29 in chips) 
Seat 5: pV5UZbjsgam+HUQEd6G++w ($11.75 in chips) 
Seat 6: t2RfOOoa56xW0ZHJC0+5JQ ($8.10 in chips) 
UXRtG8J9PoBZWTsNtqdoDA: posts small blind $0.10
v+QfkGiuj9bgtuNoVnDO8w: posts big blind $0.25
*** HOLE CARDS ***
pV5UZbjsgam+HUQEd6G++w: folds 
t2RfOOoa56xW0ZHJC0+5JQ: folds 
OZc6kkoTwtITj1ZfreJK1A: calls $0.25
qvQc9BHp2FhQjrltLiBN+w: folds 
UXRtG8J9PoBZWTsNtqdoDA: calls $0.15
v+QfkGiuj9bgtuNoVnDO8w: checks 
*** FLOP *** [Js 7c 3d]
UXRtG8J9PoBZWTsNtqdoDA: bets $2
v+QfkGiuj9bgtuNoVnDO8w: folds 
OZc6kkoTwtITj1ZfreJK1A: folds 
Uncalled bet ($2) returned to UXRtG8J9PoBZWTsNtqdoDA
UXRtG8J9PoBZWTsNtqdoDA collected $0.75 from pot
*** SUMMARY ***
Total pot $0.75 | Rake $0 
Board [Js 7c 3d]
Seat 1: OZc6kkoTwtITj1ZfreJK1A folded on the Flop
Seat 2: qvQc9BHp2FhQjrltLiBN+w (button) folded before Flop (didn't bet)
Seat 3: UXRtG8J9PoBZWTsNtqdoDA (small blind) collected ($0.75)
Seat 4: v+QfkGiuj9bgtuNoVnDO8w (big blind) folded on the Flop
Seat 5: pV5UZbjsgam+HUQEd6G++w folded before Flop (didn't bet)
Seat 6: t2RfOOoa56xW0ZHJC0+5JQ folded before Flop (didn't bet)




PokerStars Game #59939652968:  Hold'em No Limit ($0.10/$0.25) - 2009/07/01 0:45:25 ET
Table '/JJyyIstHfkT7t/bW+WXgg' 6-max Seat #2 is the button
Seat 1: wsP46AGpqDjHZQmlRHKa9g ($25.05 in chips) 
Seat 2: eRDLpytVTPI4rY3iortMSw ($6.10 in chips) 
Seat 3: oc4ZGs0W+3RIg2yPyJw3ig ($25.60 in chips) 
Seat 4: ELW+DKizJhLK7k40PMkD2Q ($25.80 in chips) 
Seat 5: 2wkoolB4YxxVC2x99F9rcA ($29.75 in chips) 
Seat 6: d338A2rm6NtA1ECEZi4d2g ($16.15 in chips) 
oc4ZGs0W+3RIg2yPyJw3ig: posts small blind $0.10
ELW+DKizJhLK7k40PMkD2Q: posts big blind $0.25
*** HOLE CARDS ***
2wkoolB4YxxVC2x99F9rcA: raises $0.75 to $1
d338A2rm6NtA1ECEZi4d2g: folds 
wsP46AGpqDjHZQmlRHKa9g: folds 
eRDLpytVTPI4rY3iortMSw: folds 
eRDLpytVTPI4rY3iortMSw leaves the table
oc4ZGs0W+3RIg2yPyJw3ig: folds 
ELW+DKizJhLK7k40PMkD2Q: calls $0.75
*** FLOP *** [Ah Ts Kh]
ELW+DKizJhLK7k40PMkD2Q: checks 
2wkoolB4YxxVC2x99F9rcA: checks 
*** TURN *** [Ah Ts Kh] [8s]
ELW+DKizJhLK7k40PMkD2Q: checks 
BYxjLnV1/LL0aZcTbfAOvw joins the table at seat #2 
2wkoolB4YxxVC2x99F9rcA: bets $1
ELW+DKizJhLK7k40PMkD2Q: calls $1
*** RIVER *** [Ah Ts Kh 8s] [3s]
ELW+DKizJhLK7k40PMkD2Q: checks 
2wkoolB4YxxVC2x99F9rcA: bets $2.50
ELW+DKizJhLK7k40PMkD2Q: folds 
Uncalled bet ($2.50) returned to 2wkoolB4YxxVC2x99F9rcA
2wkoolB4YxxVC2x99F9rcA collected $3.90 from pot
2wkoolB4YxxVC2x99F9rcA: doesn't show hand 
*** SUMMARY ***
Total pot $4.10 | Rake $0.20 
Board [Ah Ts Kh 8s 3s]
Seat 1: wsP46AGpqDjHZQmlRHKa9g folded before Flop (didn't bet)
Seat 2: eRDLpytVTPI4rY3iortMSw (button) folded before Flop (didn't bet)
Seat 3: oc4ZGs0W+3RIg2yPyJw3ig (small blind) folded before Flop
Seat 4: ELW+DKizJhLK7k40PMkD2Q (big blind) folded on the River
Seat 5: 2wkoolB4YxxVC2x99F9rcA collected ($3.90)
Seat 6: d338A2rm6NtA1ECEZi4d2g folded before Flop (didn't bet)




PokerStars Game #59939653490:  Hold'em No Limit ($0.10/$0.25) - 2009/07/01 0:45:26 ET
Table 'FuFyQHmlO/QqQp//rDRrPg' 6-max Seat #6 is the button
Seat 1: jp34e617tIzV8tKIWmfAbA ($25 in chips) 
Seat 2: 0DvgWV5o6c/jYqQCjm4Haw ($25 in chips) 
Seat 3: zsU1ijOyYEi+40wBKPEbmw ($9.15 in chips) 
Seat 4: Eznneya0vB6S+eXJdVleHA ($5.05 in chips) 
Seat 5: wAKC8C/zN0c8V5v13dm9mA ($26.15 in chips) 
Seat 6: 6DwBRH+xZ12AAZmeAg+aXw ($29.55 in chips) 
jp34e617tIzV8tKIWmfAbA: posts small blind $0.10
0DvgWV5o6c/jYqQCjm4Haw: posts big blind $0.25
zsU1ijOyYEi+40wBKPEbmw: posts big blind $0.25
*** HOLE CARDS ***
zsU1ijOyYEi+40wBKPEbmw: checks 
Eznneya0vB6S+eXJdVleHA: calls $0.25
wAKC8C/zN0c8V5v13dm9mA is disconnected 
wAKC8C/zN0c8V5v13dm9mA has timed out while disconnected
wAKC8C/zN0c8V5v13dm9mA: folds 
wAKC8C/zN0c8V5v13dm9mA is sitting out
wAKC8C/zN0c8V5v13dm9mA is connected 
wAKC8C/zN0c8V5v13dm9mA has returned
6DwBRH+xZ12AAZmeAg+aXw: folds 
jp34e617tIzV8tKIWmfAbA: calls $0.15
0DvgWV5o6c/jYqQCjm4Haw: checks 
*** FLOP *** [5c Ah 4h]
jp34e617tIzV8tKIWmfAbA: checks 
0DvgWV5o6c/jYqQCjm4Haw: checks 
zsU1ijOyYEi+40wBKPEbmw: checks 
Eznneya0vB6S+eXJdVleHA: checks 
*** TURN *** [5c Ah 4h] [Qs]
jp34e617tIzV8tKIWmfAbA: checks 
0DvgWV5o6c/jYqQCjm4Haw: checks 
zsU1ijOyYEi+40wBKPEbmw: checks 
Eznneya0vB6S+eXJdVleHA: checks 
*** RIVER *** [5c Ah 4h Qs] [Jc]
jp34e617tIzV8tKIWmfAbA: checks 
0DvgWV5o6c/jYqQCjm4Haw: bets $0.70
zsU1ijOyYEi+40wBKPEbmw: folds 
Eznneya0vB6S+eXJdVleHA: folds 
jp34e617tIzV8tKIWmfAbA: folds 
Uncalled bet ($0.70) returned to 0DvgWV5o6c/jYqQCjm4Haw
0DvgWV5o6c/jYqQCjm4Haw collected $0.95 from pot
0DvgWV5o6c/jYqQCjm4Haw: doesn't show hand 
*** SUMMARY ***
Total pot $1 | Rake $0.05 
Board [5c Ah 4h Qs Jc]
Seat 1: jp34e617tIzV8tKIWmfAbA (small blind) folded on the River
Seat 2: 0DvgWV5o6c/jYqQCjm4Haw (big blind) collected ($0.95)
Seat 3: zsU1ijOyYEi+40wBKPEbmw folded on the River
Seat 4: Eznneya0vB6S+eXJdVleHA folded on the River
Seat 5: wAKC8C/zN0c8V5v13dm9mA folded before Flop (didn't bet)
Seat 6: 6DwBRH+xZ12AAZmeAg+aXw (button) folded before Flop (didn't bet)




PokerStars Game #59939653340:  Hold'em No Limit ($0.10/$0.25) - 2009/07/01 0:45:26 ET
Table 'FE/j6VqBY4j9Uq+VHURQCQ' 6-max Seat #2 is the button
Seat 1: wKFJ513ucluNNiMlkXcDOQ ($45.70 in chips) 
Seat 2: 3zD3qLXT1bEffAoWGnc7wg ($28.75 in chips) 
Seat 3: Zijzy/UtPWzWVUo81HHVjQ ($51.35 in chips) 
Seat 4: cPO/1/dTcZpLkQFm3jH3Rg ($25 in chips) 
Seat 5: wsP46AGpqDjHZQmlRHKa9g ($25 in chips) 
Seat 6: kARKwAmU6kWJfiSICTYhVw ($9.70 in chips) 
Zijzy/UtPWzWVUo81HHVjQ: posts small blind $0.10
cPO/1/dTcZpLkQFm3jH3Rg: posts big blind $0.25
*** HOLE CARDS ***
wsP46AGpqDjHZQmlRHKa9g: folds 
kARKwAmU6kWJfiSICTYhVw: calls $0.25
wKFJ513ucluNNiMlkXcDOQ: folds 
3zD3qLXT1bEffAoWGnc7wg: folds 
Zijzy/UtPWzWVUo81HHVjQ: folds 
cPO/1/dTcZpLkQFm3jH3Rg: raises $1.25 to $1.50
kARKwAmU6kWJfiSICTYhVw: raises $2 to $3.50
cPO/1/dTcZpLkQFm3jH3Rg: raises $19 to $22.50
kARKwAmU6kWJfiSICTYhVw: calls $6.20 and is all-in
Uncalled bet ($12.80) returned to cPO/1/dTcZpLkQFm3jH3Rg
*** FLOP *** [Ts 7h Ks]
*** TURN *** [Ts 7h Ks] [2h]
*** RIVER *** [Ts 7h Ks 2h] [Ac]
*** SHOW DOWN ***
cPO/1/dTcZpLkQFm3jH3Rg: shows [Ah Qc] (a pair of Aces)
kARKwAmU6kWJfiSICTYhVw: shows [Tc Th] (three of a kind, Tens)
kARKwAmU6kWJfiSICTYhVw collected $18.55 from pot
*** SUMMARY ***
Total pot $19.50 | Rake $0.95 
Board [Ts 7h Ks 2h Ac]
Seat 1: wKFJ513ucluNNiMlkXcDOQ folded before Flop (didn't bet)
Seat 2: 3zD3qLXT1bEffAoWGnc7wg (button) folded before Flop (didn't bet)
Seat 3: Zijzy/UtPWzWVUo81HHVjQ (small blind) folded before Flop
Seat 4: cPO/1/dTcZpLkQFm3jH3Rg (big blind) showed [Ah Qc] and lost with a pair of Aces
Seat 5: wsP46AGpqDjHZQmlRHKa9g folded before Flop (didn't bet)
Seat 6: kARKwAmU6kWJfiSICTYhVw showed [Tc Th] and won ($18.55) with three of a kind, Tens




PokerStars Game #59939653204:  Hold'em No Limit ($0.10/$0.25) - 2009/07/01 0:45:26 ET
Table 'MiquQrQZJJq9ZtgRIp9HFQ' 6-max Seat #6 is the button
Seat 1: hM0MSDtq2ow7J40bSR04ig ($4.30 in chips) 
Seat 2: DMQLAmut/l19xN5STQndFg ($4.30 in chips) 
Seat 3: BYxjLnV1/LL0aZcTbfAOvw ($25.35 in chips) 
Seat 4: 0HIrwssk0FQvyKULzUTtlg ($21.15 in chips) 
Seat 5: LXN9U+5F+9if/ead2+w1nw ($45.35 in chips) 
Seat 6: X9oXZTg4PhZVR+ilX2OYbA ($11.80 in chips) 
hM0MSDtq2ow7J40bSR04ig: posts small blind $0.10
DMQLAmut/l19xN5STQndFg: posts big blind $0.25
*** HOLE CARDS ***
BYxjLnV1/LL0aZcTbfAOvw: raises $0.75 to $1
0HIrwssk0FQvyKULzUTtlg: folds 
LXN9U+5F+9if/ead2+w1nw: folds 
X9oXZTg4PhZVR+ilX2OYbA: calls $1
LXN9U+5F+9if/ead2+w1nw is sitting out
hM0MSDtq2ow7J40bSR04ig: folds 
DMQLAmut/l19xN5STQndFg: calls $0.75
*** FLOP *** [9c 6s 5c]
DMQLAmut/l19xN5STQndFg: checks 
BYxjLnV1/LL0aZcTbfAOvw: checks 
X9oXZTg4PhZVR+ilX2OYbA: checks 
*** TURN *** [9c 6s 5c] [3c]
LXN9U+5F+9if/ead2+w1nw leaves the table
DMQLAmut/l19xN5STQndFg: bets $3.30 and is all-in
BYxjLnV1/LL0aZcTbfAOvw: folds 
X9oXZTg4PhZVR+ilX2OYbA: folds 
Uncalled bet ($3.30) returned to DMQLAmut/l19xN5STQndFg
DMQLAmut/l19xN5STQndFg collected $2.95 from pot
DMQLAmut/l19xN5STQndFg: doesn't show hand 
*** SUMMARY ***
Total pot $3.10 | Rake $0.15 
Board [9c 6s 5c 3c]
Seat 1: hM0MSDtq2ow7J40bSR04ig (small blind) folded before Flop
Seat 2: DMQLAmut/l19xN5STQndFg (big blind) collected ($2.95)
Seat 3: BYxjLnV1/LL0aZcTbfAOvw folded on the Turn
Seat 4: 0HIrwssk0FQvyKULzUTtlg folded before Flop (didn't bet)
Seat 5: LXN9U+5F+9if/ead2+w1nw folded before Flop (didn't bet)
Seat 6: X9oXZTg4PhZVR+ilX2OYbA (button) folded on the Turn




PokerStars Game #59939653202:  Hold'em No Limit ($0.10/$0.25) - 2009/07/01 0:45:26 ET
Table 'nRFAYu63wZNzrz/OBgzFTw' 9-max Seat #4 is the button
Seat 1: N6fYvIzQLKaydFLKQGtMlQ ($23.90 in chips) 
Seat 2: hJ4uYjNmSZdjrKA8cjZqCA ($19.45 in chips) 
Seat 4: OiV1PWZ3IkN29JlmCcnTwQ ($5.15 in chips) 
Seat 5: vKdukiQ4ktU4yJ0Xx3MKnA ($29.60 in chips) 
Seat 6: DnDcAdn9P0zGovMERigpFA ($25 in chips) 
Seat 7: COsrwJSFHQtxlUcrYtDQPQ ($27.20 in chips) 
Seat 8: amHgC+Q9cpfD/2w2yUtNbw ($9.75 in chips) 
Seat 9: SXqVW4Q0evTUVZG6BbUNIA ($30.55 in chips) 
vKdukiQ4ktU4yJ0Xx3MKnA: posts small blind $0.10
DnDcAdn9P0zGovMERigpFA: posts big blind $0.25
W8cIfrCR+zA8pCNyIuHu8g: sits out 
*** HOLE CARDS ***
COsrwJSFHQtxlUcrYtDQPQ: folds 
amHgC+Q9cpfD/2w2yUtNbw: folds 
COsrwJSFHQtxlUcrYtDQPQ leaves the table
SXqVW4Q0evTUVZG6BbUNIA: folds 
N6fYvIzQLKaydFLKQGtMlQ: folds 
hJ4uYjNmSZdjrKA8cjZqCA: calls $0.25
OiV1PWZ3IkN29JlmCcnTwQ: folds 
vKdukiQ4ktU4yJ0Xx3MKnA: folds 
DnDcAdn9P0zGovMERigpFA: checks 
*** FLOP *** [3c 5d 7c]
DnDcAdn9P0zGovMERigpFA: bets $0.50
hJ4uYjNmSZdjrKA8cjZqCA: folds 
Uncalled bet ($0.50) returned to DnDcAdn9P0zGovMERigpFA
DnDcAdn9P0zGovMERigpFA collected $0.60 from pot
DnDcAdn9P0zGovMERigpFA: doesn't show hand 
*** SUMMARY ***
Total pot $0.60 | Rake $0 
Board [3c 5d 7c]
Seat 1: N6fYvIzQLKaydFLKQGtMlQ folded before Flop (didn't bet)
Seat 2: hJ4uYjNmSZdjrKA8cjZqCA folded on the Flop
Seat 4: OiV1PWZ3IkN29JlmCcnTwQ (button) folded before Flop (didn't bet)
Seat 5: vKdukiQ4ktU4yJ0Xx3MKnA (small blind) folded before Flop
Seat 6: DnDcAdn9P0zGovMERigpFA (big blind) collected ($0.60)
Seat 7: COsrwJSFHQtxlUcrYtDQPQ folded before Flop (didn't bet)
Seat 8: amHgC+Q9cpfD/2w2yUtNbw folded before Flop (didn't bet)
Seat 9: SXqVW4Q0evTUVZG6BbUNIA folded before Flop (didn't bet)




PokerStars Game #59939653816:  Hold'em No Limit ($0.10/$0.25) - 2009/07/01 0:45:26 ET
Table 'axb9RsG8Zj1A0LEukTeFrQ' 9-max Seat #6 is the button
Seat 1: qwr38jl5txoR36M7G5qi4A ($9.90 in chips) 
Seat 2: zDrucyjVn5aeekNEc3cJrA ($21.60 in chips) 
Seat 3: cZ99hugmLBj9KhTlc8nCSw ($27.65 in chips) 
Seat 4: TeWJxSETzbXGiYKx0y+dtg ($24.65 in chips) 
Seat 5: rLSSHKOHnb6yzVfDoQM/RA ($12.05 in chips) 
Seat 6: FSuhElWc38JXYToR0dwhjg ($15.60 in chips) 
Seat 8: CqwJk5Z2+vb2f9j1o7IjKQ ($28.65 in chips) 
Seat 9: qbQE8CifKB4+OEvNF/61Rw ($37.40 in chips) 
CqwJk5Z2+vb2f9j1o7IjKQ: posts small blind $0.10
qbQE8CifKB4+OEvNF/61Rw: posts big blind $0.25
*** HOLE CARDS ***
qwr38jl5txoR36M7G5qi4A: folds 
zDrucyjVn5aeekNEc3cJrA: folds 
cZ99hugmLBj9KhTlc8nCSw: folds 
TeWJxSETzbXGiYKx0y+dtg: folds 
rLSSHKOHnb6yzVfDoQM/RA: folds 
FSuhElWc38JXYToR0dwhjg: folds 
CqwJk5Z2+vb2f9j1o7IjKQ: raises $0.25 to $0.50
qbQE8CifKB4+OEvNF/61Rw: calls $0.25
*** FLOP *** [Js 8s As]
CqwJk5Z2+vb2f9j1o7IjKQ: bets $0.75
qbQE8CifKB4+OEvNF/61Rw: raises $1.75 to $2.50
CqwJk5Z2+vb2f9j1o7IjKQ said, "ui bofffff"
CqwJk5Z2+vb2f9j1o7IjKQ said, "TILT"
CqwJk5Z2+vb2f9j1o7IjKQ said, "?"
CqwJk5Z2+vb2f9j1o7IjKQ said, "baitola"
CqwJk5Z2+vb2f9j1o7IjKQ: folds 
Uncalled bet ($1.75) returned to qbQE8CifKB4+OEvNF/61Rw
qbQE8CifKB4+OEvNF/61Rw collected $2.40 from pot
qbQE8CifKB4+OEvNF/61Rw: shows [6h Kc] (high card Ace)
*** SUMMARY ***
Total pot $2.50 | Rake $0.10 
Board [Js 8s As]
Seat 1: qwr38jl5txoR36M7G5qi4A folded before Flop (didn't bet)
Seat 2: zDrucyjVn5aeekNEc3cJrA folded before Flop (didn't bet)
Seat 3: cZ99hugmLBj9KhTlc8nCSw folded before Flop (didn't bet)
Seat 4: TeWJxSETzbXGiYKx0y+dtg folded before Flop (didn't bet)
Seat 5: rLSSHKOHnb6yzVfDoQM/RA folded before Flop (didn't bet)
Seat 6: FSuhElWc38JXYToR0dwhjg (button) folded before Flop (didn't bet)
Seat 8: CqwJk5Z2+vb2f9j1o7IjKQ (small blind) folded on the Flop
Seat 9: qbQE8CifKB4+OEvNF/61Rw (big blind) collected ($2.40)




PokerStars Game #59939653564:  Hold'em No Limit ($0.10/$0.25) - 2009/07/01 0:45:26 ET
Table '3lL16FBjWXTx3AjK5lMRww' 9-max Seat #2 is the button
Seat 1: fDGyaQz0cs2s4FOYxkbIHA ($15 in chips) 
Seat 2: YK2fIgjF+Z0ARwKKcGh1fw ($16.55 in chips) 
Seat 3: QEbIGci+itdw+re8RM5fZA ($26.15 in chips) 
Seat 4: Z3a37Ry74FVl+CBZtAONiA ($11.75 in chips) 
Seat 5: M/9j4wkHH9i1JM51vgi1VA ($22.50 in chips) 
Seat 6: hBMUlEpyU74r/fwDgIpXjQ ($41.60 in chips) 
Seat 8: ljemhp25Zg+nlA9DLCIiUw ($24.75 in chips) 
Seat 9: b8t3jWrxzeEt9HtZtc9wUQ ($8.50 in chips) 
QEbIGci+itdw+re8RM5fZA: posts small blind $0.10
Z3a37Ry74FVl+CBZtAONiA: posts big blind $0.25
6RiVTYll/5D8zICp0MRpKw: sits out 
*** HOLE CARDS ***
M/9j4wkHH9i1JM51vgi1VA: calls $0.25
hBMUlEpyU74r/fwDgIpXjQ: folds 
ljemhp25Zg+nlA9DLCIiUw: folds 
b8t3jWrxzeEt9HtZtc9wUQ: raises $0.50 to $0.75
fDGyaQz0cs2s4FOYxkbIHA: folds 
YK2fIgjF+Z0ARwKKcGh1fw: folds 
QEbIGci+itdw+re8RM5fZA: folds 
YK2fIgjF+Z0ARwKKcGh1fw leaves the table
Z3a37Ry74FVl+CBZtAONiA: folds 
M/9j4wkHH9i1JM51vgi1VA: folds 
Uncalled bet ($0.50) returned to b8t3jWrxzeEt9HtZtc9wUQ
b8t3jWrxzeEt9HtZtc9wUQ collected $0.85 from pot
*** SUMMARY ***
Total pot $0.85 | Rake $0 
Seat 1: fDGyaQz0cs2s4FOYxkbIHA folded before Flop (didn't bet)
Seat 2: YK2fIgjF+Z0ARwKKcGh1fw (button) folded before Flop (didn't bet)
Seat 3: QEbIGci+itdw+re8RM5fZA (small blind) folded before Flop
Seat 4: Z3a37Ry74FVl+CBZtAONiA (big blind) folded before Flop
Seat 5: M/9j4wkHH9i1JM51vgi1VA folded before Flop
Seat 6: hBMUlEpyU74r/fwDgIpXjQ folded before Flop (didn't bet)
Seat 8: ljemhp25Zg+nlA9DLCIiUw folded before Flop (didn't bet)
Seat 9: b8t3jWrxzeEt9HtZtc9wUQ collected ($0.85)




PokerStars Game #59939653810:  Hold'em No Limit ($0.10/$0.25) - 2009/07/01 0:45:26 ET
Table 'jz4TpuH+ag+0iNe2ZcxckQ' 9-max Seat #6 is the button
Seat 2: 18G4P1XstjNvItdGUITxgw ($37.45 in chips) 
Seat 3: Z5NNIVvnhb2IJbLcI79WYQ ($1.20 in chips) 
Seat 4: k+2r6di6GXjNpAdrRkW9bA ($69.20 in chips) 
Seat 5: uJlzv9KL7hgCIqIS2ofoaw ($8.45 in chips) 
Seat 6: ymx/m/7IEqTY+OQPano2gg ($7.70 in chips) 
Seat 7: sJNHTWcSlLHRCZ9+YRLLqA ($25 in chips) 
Seat 8: DlXs37dlX3tb7o/7lYXQSw ($25 in chips) 
Seat 9: 8B/dhbQjIWe6ASCdgzktNQ ($25.35 in chips) 
sJNHTWcSlLHRCZ9+YRLLqA: posts small blind $0.10
DlXs37dlX3tb7o/7lYXQSw: posts big blind $0.25
*** HOLE CARDS ***
lythinda leaves the table
8B/dhbQjIWe6ASCdgzktNQ: folds 
18G4P1XstjNvItdGUITxgw: folds 
Z5NNIVvnhb2IJbLcI79WYQ: calls $0.25
F7pnn6czNpHvRM55XcA2EA joins the table at seat #1 
k+2r6di6GXjNpAdrRkW9bA: calls $0.25
uJlzv9KL7hgCIqIS2ofoaw: folds 
ymx/m/7IEqTY+OQPano2gg: folds 
sJNHTWcSlLHRCZ9+YRLLqA: folds 
DlXs37dlX3tb7o/7lYXQSw: raises $1 to $1.25
Z5NNIVvnhb2IJbLcI79WYQ: calls $0.95 and is all-in
k+2r6di6GXjNpAdrRkW9bA: folds 
Uncalled bet ($0.05) returned to DlXs37dlX3tb7o/7lYXQSw
*** FLOP *** [Ad Qs 2d]
*** TURN *** [Ad Qs 2d] [9d]
*** RIVER *** [Ad Qs 2d 9d] [4h]
*** SHOW DOWN ***
DlXs37dlX3tb7o/7lYXQSw: shows [Kh Ah] (a pair of Aces)
Z5NNIVvnhb2IJbLcI79WYQ: mucks hand 
DlXs37dlX3tb7o/7lYXQSw collected $2.65 from pot
*** SUMMARY ***
Total pot $2.75 | Rake $0.10 
Board [Ad Qs 2d 9d 4h]
Seat 2: 18G4P1XstjNvItdGUITxgw folded before Flop (didn't bet)
Seat 3: Z5NNIVvnhb2IJbLcI79WYQ mucked
Seat 4: k+2r6di6GXjNpAdrRkW9bA folded before Flop
Seat 5: uJlzv9KL7hgCIqIS2ofoaw folded before Flop (didn't bet)
Seat 6: ymx/m/7IEqTY+OQPano2gg (button) folded before Flop (didn't bet)
Seat 7: sJNHTWcSlLHRCZ9+YRLLqA (small blind) folded before Flop
Seat 8: DlXs37dlX3tb7o/7lYXQSw (big blind) showed [Kh Ah] and won ($2.65) with a pair of Aces
Seat 9: 8B/dhbQjIWe6ASCdgzktNQ folded before Flop (didn't bet)




PokerStars Game #59939653862:  Hold'em No Limit ($0.10/$0.25) - 2009/07/01 0:45:27 ET
Table '9o8Yb3JpUqurD4pNVmOikQ' 6-max Seat #3 is the button
Seat 1: 5tB0F9NjPSUL4FzmzBMs2Q ($25.35 in chips) 
Seat 2: /gJNBeCkWL4o85/jvlZ4BA ($25.25 in chips) 
Seat 3: JgRqo1/2phbf7pab7N3BIQ ($13.40 in chips) 
Seat 6: k9vn40MOqqb+xF+7GZ6v2g ($34.05 in chips) 
4kWQxGbT5FZ1dkPd1bE45Q will be allowed to play after the button
k9vn40MOqqb+xF+7GZ6v2g: posts small blind $0.10
5tB0F9NjPSUL4FzmzBMs2Q: posts big blind $0.25
*** HOLE CARDS ***
/gJNBeCkWL4o85/jvlZ4BA: folds 
JgRqo1/2phbf7pab7N3BIQ: calls $0.25
k9vn40MOqqb+xF+7GZ6v2g: calls $0.15
5tB0F9NjPSUL4FzmzBMs2Q: checks 
*** FLOP *** [7h 3s 3h]
k9vn40MOqqb+xF+7GZ6v2g: checks 
5tB0F9NjPSUL4FzmzBMs2Q: checks 
JgRqo1/2phbf7pab7N3BIQ: bets $0.50
k9vn40MOqqb+xF+7GZ6v2g: folds 
5tB0F9NjPSUL4FzmzBMs2Q: folds 
Uncalled bet ($0.50) returned to JgRqo1/2phbf7pab7N3BIQ
JgRqo1/2phbf7pab7N3BIQ collected $0.75 from pot
*** SUMMARY ***
Total pot $0.75 | Rake $0 
Board [7h 3s 3h]
Seat 1: 5tB0F9NjPSUL4FzmzBMs2Q (big blind) folded on the Flop
Seat 2: /gJNBeCkWL4o85/jvlZ4BA folded before Flop (didn't bet)
Seat 3: JgRqo1/2phbf7pab7N3BIQ (button) collected ($0.75)
Seat 6: k9vn40MOqqb+xF+7GZ6v2g (small blind) folded on the Flop




PokerStars Game #59939654138:  Hold'em No Limit ($0.10/$0.25) - 2009/07/01 0:45:27 ET
Table 'gnrUwXkIPE0C8xl6cB4Hyw' 9-max Seat #7 is the button
Seat 1: lwrOE80tuooHfIBx/4LUSw ($24.75 in chips) 
Seat 2: zVd+j+mjRjWkMTxR5u0Rbw ($6 in chips) 
Seat 3: s7Q6uNouhe7aE8JdFb9E+A ($25.35 in chips) 
Seat 4: vnCdP3GsLTKadDukKcJk/Q ($25.05 in chips) 
Seat 5: UU+SYM9uvNEpASN41+yAdA ($31.10 in chips) 
Seat 6: W4TLQcZ2TiM73eIgpIvlGg ($23.25 in chips) 
Seat 7: Z9AeOQX3yzuSvKAm/xyovg ($8.20 in chips) 
Seat 8: oUgIL46CfA9GCdIuN1TVSw ($23.50 in chips) 
Seat 9: F7pnn6czNpHvRM55XcA2EA ($25 in chips) 
oUgIL46CfA9GCdIuN1TVSw: posts small blind $0.10
F7pnn6czNpHvRM55XcA2EA: posts big blind $0.25
*** HOLE CARDS ***
oUgIL46CfA9GCdIuN1TVSw said, "were in philly u frokm"
lwrOE80tuooHfIBx/4LUSw: folds 
zVd+j+mjRjWkMTxR5u0Rbw: folds 
UU+SYM9uvNEpASN41+yAdA said, "North"
s7Q6uNouhe7aE8JdFb9E+A: folds 
vnCdP3GsLTKadDukKcJk/Q: folds 
UU+SYM9uvNEpASN41+yAdA: calls $0.25
W4TLQcZ2TiM73eIgpIvlGg: calls $0.25
Z9AeOQX3yzuSvKAm/xyovg: folds 
oUgIL46CfA9GCdIuN1TVSw: calls $0.15
F7pnn6czNpHvRM55XcA2EA: checks 
*** FLOP *** [6s 9h Qc]
oUgIL46CfA9GCdIuN1TVSw: checks 
F7pnn6czNpHvRM55XcA2EA: checks 
UU+SYM9uvNEpASN41+yAdA: checks 
W4TLQcZ2TiM73eIgpIvlGg: checks 
*** TURN *** [6s 9h Qc] [9d]
oUgIL46CfA9GCdIuN1TVSw: checks 
F7pnn6czNpHvRM55XcA2EA: checks 
UU+SYM9uvNEpASN41+yAdA: checks 
W4TLQcZ2TiM73eIgpIvlGg: checks 
*** RIVER *** [6s 9h Qc 9d] [Kd]
oUgIL46CfA9GCdIuN1TVSw: bets $0.65
F7pnn6czNpHvRM55XcA2EA: folds 
UU+SYM9uvNEpASN41+yAdA: calls $0.65
W4TLQcZ2TiM73eIgpIvlGg: folds 
*** SHOW DOWN ***
oUgIL46CfA9GCdIuN1TVSw: shows [Kc 2c] (two pair, Kings and Nines)
UU+SYM9uvNEpASN41+yAdA: shows [Ks 8c] (two pair, Kings and Nines)
oUgIL46CfA9GCdIuN1TVSw collected $1.10 from pot
UU+SYM9uvNEpASN41+yAdA collected $1.10 from pot
*** SUMMARY ***
Total pot $2.30 | Rake $0.10 
Board [6s 9h Qc 9d Kd]
Seat 1: lwrOE80tuooHfIBx/4LUSw folded before Flop (didn't bet)
Seat 2: zVd+j+mjRjWkMTxR5u0Rbw folded before Flop (didn't bet)
Seat 3: s7Q6uNouhe7aE8JdFb9E+A folded before Flop (didn't bet)
Seat 4: vnCdP3GsLTKadDukKcJk/Q folded before Flop (didn't bet)
Seat 5: UU+SYM9uvNEpASN41+yAdA showed [Ks 8c] and won ($1.10) with two pair, Kings and Nines
Seat 6: W4TLQcZ2TiM73eIgpIvlGg folded on the River
Seat 7: Z9AeOQX3yzuSvKAm/xyovg (button) folded before Flop (didn't bet)
Seat 8: oUgIL46CfA9GCdIuN1TVSw (small blind) showed [Kc 2c] and won ($1.10) with two pair, Kings and Nines
Seat 9: F7pnn6czNpHvRM55XcA2EA (big blind) folded on the River




PokerStars Game #59939654338:  Hold'em No Limit ($0.10/$0.25) - 2009/07/01 0:45:27 ET
Table 'KEoOIegxPF91KooL2AelUA' 6-max Seat #1 is the button
Seat 1: wsP46AGpqDjHZQmlRHKa9g ($30.65 in chips) 
Seat 4: Vv37Oa9niKKVcR6Z7ceetw ($25 in chips) 
Seat 5: 2NLC44AHHKHEUooUQFYV+Q ($16.35 in chips) 
Vv37Oa9niKKVcR6Z7ceetw: posts small blind $0.10
2NLC44AHHKHEUooUQFYV+Q: posts big blind $0.25
*** HOLE CARDS ***
Vv37Oa9niKKVcR6Z7ceetw said, "fking sh it i reached before"
wsP46AGpqDjHZQmlRHKa9g: folds 
zxeVQGaMKDsDzmSY+AInjA joins the table at seat #3 
Vv37Oa9niKKVcR6Z7ceetw said, "1190 FPP"
Vv37Oa9niKKVcR6Z7ceetw: raises $0.50 to $0.75
Vv37Oa9niKKVcR6Z7ceetw said, "fking joke"
2NLC44AHHKHEUooUQFYV+Q: calls $0.50
*** FLOP *** [9d 3d Qh]
Vv37Oa9niKKVcR6Z7ceetw said, "no solver for 10 FPP"
Vv37Oa9niKKVcR6Z7ceetw: checks 
RYLaAIIwK9wxkPswt1yJYw joins the table at seat #2 
2NLC44AHHKHEUooUQFYV+Q: bets $1
Vv37Oa9niKKVcR6Z7ceetw: calls $1
*** TURN *** [9d 3d Qh] [9h]
Vv37Oa9niKKVcR6Z7ceetw: checks 
2NLC44AHHKHEUooUQFYV+Q: bets $1
Vv37Oa9niKKVcR6Z7ceetw: calls $1
*** RIVER *** [9d 3d Qh 9h] [5c]
Vv37Oa9niKKVcR6Z7ceetw: folds 
2NLC44AHHKHEUooUQFYV+Q collected $5.25 from pot
2NLC44AHHKHEUooUQFYV+Q is sitting out
*** SUMMARY ***
Total pot $5.50 | Rake $0.25 
Board [9d 3d Qh 9h 5c]
Seat 1: wsP46AGpqDjHZQmlRHKa9g (button) folded before Flop (didn't bet)
Seat 4: Vv37Oa9niKKVcR6Z7ceetw (small blind) folded on the River
Seat 5: 2NLC44AHHKHEUooUQFYV+Q (big blind) collected ($5.25)




PokerStars Game #59939654736:  Hold'em No Limit ($0.10/$0.25) - 2009/07/01 0:45:28 ET
Table 'NfXsh0UQA+o/kO9acV3WxA' 9-max Seat #7 is the button
Seat 1: H5Se03ZqSX7tbULXur2MAg ($24.90 in chips) 
Seat 4: sQ6szDwWrE+LMh1p4dVexA ($16.75 in chips) 
Seat 5: 3RCAkueG3Vc13VpRStCB+w ($37.80 in chips) 
Seat 7: HPEB+AtKw1+C/cxU0o1ciw ($31.25 in chips) 
Seat 8: +sbyWwIcFp9kP0bDtMegfQ ($24.40 in chips) 
+sbyWwIcFp9kP0bDtMegfQ: posts small blind $0.10
hetfield_08: is sitting out 
H5Se03ZqSX7tbULXur2MAg: posts big blind $0.25
*** HOLE CARDS ***
MrPo4/ymXwg9lzPRybrXbA joins the table at seat #2 
hetfield_08 leaves the table
MrPo4/ymXwg9lzPRybrXbA leaves the table
sQ6szDwWrE+LMh1p4dVexA: folds 
3RCAkueG3Vc13VpRStCB+w: raises $0.50 to $0.75
HPEB+AtKw1+C/cxU0o1ciw: folds 
+sbyWwIcFp9kP0bDtMegfQ: folds 
H5Se03ZqSX7tbULXur2MAg: calls $0.50
*** FLOP *** [Qs 5h Jd]
H5Se03ZqSX7tbULXur2MAg: checks 
3RCAkueG3Vc13VpRStCB+w: bets $1
H5Se03ZqSX7tbULXur2MAg: calls $1
*** TURN *** [Qs 5h Jd] [2d]
H5Se03ZqSX7tbULXur2MAg: checks 
3RCAkueG3Vc13VpRStCB+w: checks 
*** RIVER *** [Qs 5h Jd 2d] [8h]
H5Se03ZqSX7tbULXur2MAg: bets $1.50
3RCAkueG3Vc13VpRStCB+w: calls $1.50
*** SHOW DOWN ***
H5Se03ZqSX7tbULXur2MAg: shows [Qc Ad] (a pair of Queens)
3RCAkueG3Vc13VpRStCB+w: mucks hand 
H5Se03ZqSX7tbULXur2MAg collected $6.30 from pot
*** SUMMARY ***
Total pot $6.60 | Rake $0.30 
Board [Qs 5h Jd 2d 8h]
Seat 1: H5Se03ZqSX7tbULXur2MAg (big blind) showed [Qc Ad] and won ($6.30) with a pair of Queens
Seat 4: sQ6szDwWrE+LMh1p4dVexA folded before Flop (didn't bet)
Seat 5: 3RCAkueG3Vc13VpRStCB+w mucked
Seat 7: HPEB+AtKw1+C/cxU0o1ciw (button) folded before Flop (didn't bet)
Seat 8: +sbyWwIcFp9kP0bDtMegfQ (small blind) folded before Flop




PokerStars Game #59939654534:  Hold'em No Limit ($0.10/$0.25) - 2009/07/01 0:45:28 ET
Table 'mF3KHGMaTpaBZbtBoyfTeg' 6-max Seat #5 is the button
Seat 1: 0HAB2GdCAM7p7V00xueAVQ ($9.65 in chips) 
Seat 2: 4x9jCqgSw4272dnaIqnanw ($3.80 in chips) 
Seat 3: Hzrn9DZJegEZICufTNYkrg ($13.65 in chips) 
Seat 4: FYepjhAvF8ZdVCmqHIy+eQ ($25 in chips) 
Seat 5: sEQx9G5Cu8k1HNdQasxvUA ($29.75 in chips) 
Seat 6: kG34n23qFQA3nzdOJTQ1dA ($24.75 in chips) 
kG34n23qFQA3nzdOJTQ1dA: posts small blind $0.10
0HAB2GdCAM7p7V00xueAVQ: posts big blind $0.25
*** HOLE CARDS ***
4x9jCqgSw4272dnaIqnanw: raises $3.55 to $3.80 and is all-in
Hzrn9DZJegEZICufTNYkrg: folds 
FYepjhAvF8ZdVCmqHIy+eQ: folds 
sEQx9G5Cu8k1HNdQasxvUA: calls $3.80
kG34n23qFQA3nzdOJTQ1dA: folds 
0HAB2GdCAM7p7V00xueAVQ: folds 
*** FLOP *** [5d Kc Qc]
*** TURN *** [5d Kc Qc] [3c]
*** RIVER *** [5d Kc Qc 3c] [Ah]
*** SHOW DOWN ***
4x9jCqgSw4272dnaIqnanw: shows [Th Td] (a pair of Tens)
sEQx9G5Cu8k1HNdQasxvUA: shows [2s As] (a pair of Aces)
sEQx9G5Cu8k1HNdQasxvUA collected $7.60 from pot
*** SUMMARY ***
Total pot $7.95 | Rake $0.35 
Board [5d Kc Qc 3c Ah]
Seat 1: 0HAB2GdCAM7p7V00xueAVQ (big blind) folded before Flop
Seat 2: 4x9jCqgSw4272dnaIqnanw showed [Th Td] and lost with a pair of Tens
Seat 3: Hzrn9DZJegEZICufTNYkrg folded before Flop (didn't bet)
Seat 4: FYepjhAvF8ZdVCmqHIy+eQ folded before Flop (didn't bet)
Seat 5: sEQx9G5Cu8k1HNdQasxvUA (button) showed [2s As] and won ($7.60) with a pair of Aces
Seat 6: kG34n23qFQA3nzdOJTQ1dA (small blind) folded before Flop




PokerStars Game #59939654658:  Hold'em No Limit ($0.10/$0.25) - 2009/07/01 0:45:28 ET
Table 'QegsWX65l3n/K0A8XB78yg' 6-max Seat #3 is the button
Seat 1: 8ClCHtFXGNplITm+63KB+Q ($28.60 in chips) 
Seat 2: GC/9yVD59DUCX7hUI7gcLw ($32.55 in chips) 
Seat 3: 9jSiy0meE9XJKkdIZwyTEQ ($25.25 in chips) 
Seat 4: kyRaCIljYA6l33lSKQfNsg ($25.45 in chips) 
Seat 5: 4YSTu0Cdzpppe1lUgCZGCQ ($57.80 in chips) 
Seat 6: JE/wJXmjw3bpdmjwvh2pcg ($36.40 in chips) 
kyRaCIljYA6l33lSKQfNsg: posts small blind $0.10
4YSTu0Cdzpppe1lUgCZGCQ: posts big blind $0.25
*** HOLE CARDS ***
JE/wJXmjw3bpdmjwvh2pcg: calls $0.25
8ClCHtFXGNplITm+63KB+Q: folds 
GC/9yVD59DUCX7hUI7gcLw: folds 
9jSiy0meE9XJKkdIZwyTEQ: folds 
kyRaCIljYA6l33lSKQfNsg: folds 
4YSTu0Cdzpppe1lUgCZGCQ: checks 
*** FLOP *** [7h 7c Kc]
4YSTu0Cdzpppe1lUgCZGCQ: checks 
JE/wJXmjw3bpdmjwvh2pcg: checks 
*** TURN *** [7h 7c Kc] [7s]
4YSTu0Cdzpppe1lUgCZGCQ: checks 
JE/wJXmjw3bpdmjwvh2pcg: checks 
*** RIVER *** [7h 7c Kc 7s] [4c]
4YSTu0Cdzpppe1lUgCZGCQ: checks 
JE/wJXmjw3bpdmjwvh2pcg: bets $0.75
4YSTu0Cdzpppe1lUgCZGCQ: folds 
Uncalled bet ($0.75) returned to JE/wJXmjw3bpdmjwvh2pcg
JE/wJXmjw3bpdmjwvh2pcg collected $0.60 from pot
JE/wJXmjw3bpdmjwvh2pcg: doesn't show hand 
*** SUMMARY ***
Total pot $0.60 | Rake $0 
Board [7h 7c Kc 7s 4c]
Seat 1: 8ClCHtFXGNplITm+63KB+Q folded before Flop (didn't bet)
Seat 2: GC/9yVD59DUCX7hUI7gcLw folded before Flop (didn't bet)
Seat 3: 9jSiy0meE9XJKkdIZwyTEQ (button) folded before Flop (didn't bet)
Seat 4: kyRaCIljYA6l33lSKQfNsg (small blind) folded before Flop
Seat 5: 4YSTu0Cdzpppe1lUgCZGCQ (big blind) folded on the River
Seat 6: JE/wJXmjw3bpdmjwvh2pcg collected ($0.60)




PokerStars Game #59939654656:  Hold'em No Limit ($0.10/$0.25) - 2009/07/01 0:45:28 ET
Table 'MRfAiS/4JSfnUDlCcZo0wAhfHe8uKeSJMyWAjSdM7ROQx Seat #5 is the button
Seat 1: 48oT5xFI+5CHUJlfoGrE4w ($14.10 in chips) 
Seat 2: /gJNBeCkWL4o85/jvlZ4BA ($36.45 in chips) 
Seat 3: FYepjhAvF8ZdVCmqHIy+eQ ($45.15 in chips) 
Seat 4: Go8clNIDGP3feVvzBDG4pg ($14.80 in chips) 
Seat 5: qccGLncfUaN00Few5HsgYg ($29.35 in chips) 
Seat 6: VaDPspfGS2lnEkaGNrNqfg ($13 in chips) 
VaDPspfGS2lnEkaGNrNqfg: posts small blind $0.10
48oT5xFI+5CHUJlfoGrE4w: posts big blind $0.25
*** HOLE CARDS ***
/gJNBeCkWL4o85/jvlZ4BA: folds 
FYepjhAvF8ZdVCmqHIy+eQ: folds 
Go8clNIDGP3feVvzBDG4pg: folds 
qccGLncfUaN00Few5HsgYg: folds 
VaDPspfGS2lnEkaGNrNqfg: folds 
Uncalled bet ($0.15) returned to 48oT5xFI+5CHUJlfoGrE4w
48oT5xFI+5CHUJlfoGrE4w collected $0.20 from pot
48oT5xFI+5CHUJlfoGrE4w: doesn't show hand 
*** SUMMARY ***
Total pot $0.20 | Rake $0 
Seat 1: 48oT5xFI+5CHUJlfoGrE4w (big blind) collected ($0.20)
Seat 2: /gJNBeCkWL4o85/jvlZ4BA folded before Flop (didn't bet)
Seat 3: FYepjhAvF8ZdVCmqHIy+eQ folded before Flop (didn't bet)
Seat 4: Go8clNIDGP3feVvzBDG4pg folded before Flop (didn't bet)
Seat 5: qccGLncfUaN00Few5HsgYg (button) folded before Flop (didn't bet)
Seat 6: VaDPspfGS2lnEkaGNrNqfg (small blind) folded before Flop




PokerStars Game #59939654768:  Hold'em No Limit ($0.10/$0.25) - 2009/07/01 0:45:28 ET
Table 'tq5CvS0RUqGkuBK0XTzqqg' 6-max Seat #2 is the button
Seat 1: 39EF5EcifdyPS7v+EnfxLg ($16.80 in chips) 
Seat 2: mfrkWA3PTeYPkbO6hi98Aw ($68.25 in chips) 
Seat 3: PbMzPZIePKifKQZfKDkbIw ($26.65 in chips) 
Seat 4: W7FS+h5B+OhmwF+cTt3ZPQ ($19.45 in chips) 
Seat 5: qGHGf/553gQnDoklMRe3tg ($23.75 in chips) 
Seat 6: hOfhw8jxWiq14wXGL4Bh/Q ($15.15 in chips) 
PbMzPZIePKifKQZfKDkbIw: posts small blind $0.10
W7FS+h5B+OhmwF+cTt3ZPQ: posts big blind $0.25
*** HOLE CARDS ***
qGHGf/553gQnDoklMRe3tg: folds 
hOfhw8jxWiq14wXGL4Bh/Q: folds 
39EF5EcifdyPS7v+EnfxLg: calls $0.25
mfrkWA3PTeYPkbO6hi98Aw: raises $1 to $1.25
PbMzPZIePKifKQZfKDkbIw: folds 
W7FS+h5B+OhmwF+cTt3ZPQ: folds 
39EF5EcifdyPS7v+EnfxLg: folds 
Uncalled bet ($1) returned to mfrkWA3PTeYPkbO6hi98Aw
mfrkWA3PTeYPkbO6hi98Aw collected $0.85 from pot
mfrkWA3PTeYPkbO6hi98Aw: doesn't show hand 
*** SUMMARY ***
Total pot $0.85 | Rake $0 
Seat 1: 39EF5EcifdyPS7v+EnfxLg folded before Flop
Seat 2: mfrkWA3PTeYPkbO6hi98Aw (button) collected ($0.85)
Seat 3: PbMzPZIePKifKQZfKDkbIw (small blind) folded before Flop
Seat 4: W7FS+h5B+OhmwF+cTt3ZPQ (big blind) folded before Flop
Seat 5: qGHGf/553gQnDoklMRe3tg folded before Flop (didn't bet)
Seat 6: hOfhw8jxWiq14wXGL4Bh/Q folded before Flop (didn't bet)




PokerStars Game #59939654796:  Hold'em No Limit ($0.10/$0.25) - 2009/07/01 0:45:28 ET
Table 'zojWVNukhD2n8RTfHCOwwg' 9-max Seat #6 is the button
Seat 1: DIBbjEYGs+TVdVgEB/4+3w ($41.10 in chips) 
Seat 3: 1esmRaxnod+zAkE+7BtzMA ($16.60 in chips) 
Seat 6: 2xNcp4M2UG8Li2PMEnWcgA ($9.85 in chips) 
Seat 7: H5Se03ZqSX7tbULXur2MAg ($27.90 in chips) 
Seat 8: j4q3p0lesp63b1gZDwLBZw ($5 in chips) 
Seat 9: 4oA316mXLIui1QY63GXBUg ($25.25 in chips) 
H5Se03ZqSX7tbULXur2MAg: posts small blind $0.10
j4q3p0lesp63b1gZDwLBZw: posts big blind $0.25
V6p0jQ/RhUsqpHLmXvEX4Q: sits out 
*** HOLE CARDS ***
4oA316mXLIui1QY63GXBUg: folds 
DIBbjEYGs+TVdVgEB/4+3w: folds 
1esmRaxnod+zAkE+7BtzMA: calls $0.25
2xNcp4M2UG8Li2PMEnWcgA: calls $0.25
H5Se03ZqSX7tbULXur2MAg: folds 
j4q3p0lesp63b1gZDwLBZw: checks 
*** FLOP *** [4s Ad 9h]
j4q3p0lesp63b1gZDwLBZw: checks 
1esmRaxnod+zAkE+7BtzMA: checks 
2xNcp4M2UG8Li2PMEnWcgA: bets $0.25
j4q3p0lesp63b1gZDwLBZw: folds 
1esmRaxnod+zAkE+7BtzMA: calls $0.25
*** TURN *** [4s Ad 9h] [Js]
1esmRaxnod+zAkE+7BtzMA: checks 
2xNcp4M2UG8Li2PMEnWcgA: bets $0.50
1esmRaxnod+zAkE+7BtzMA: calls $0.50
*** RIVER *** [4s Ad 9h Js] [7c]
1esmRaxnod+zAkE+7BtzMA: checks 
2xNcp4M2UG8Li2PMEnWcgA: checks 
*** SHOW DOWN ***
1esmRaxnod+zAkE+7BtzMA: shows [6c 9c] (a pair of Nines)
2xNcp4M2UG8Li2PMEnWcgA: shows [9d 8d] (a pair of Nines - Ace+Jack+Eight kicker)
2xNcp4M2UG8Li2PMEnWcgA collected $2.25 from pot
*** SUMMARY ***
Total pot $2.35 | Rake $0.10 
Board [4s Ad 9h Js 7c]
Seat 1: DIBbjEYGs+TVdVgEB/4+3w folded before Flop (didn't bet)
Seat 3: 1esmRaxnod+zAkE+7BtzMA showed [6c 9c] and lost with a pair of Nines
Seat 6: 2xNcp4M2UG8Li2PMEnWcgA (button) showed [9d 8d] and won ($2.25) with a pair of Nines
Seat 7: H5Se03ZqSX7tbULXur2MAg (small blind) folded before Flop
Seat 8: j4q3p0lesp63b1gZDwLBZw (big blind) folded on the Flop
Seat 9: 4oA316mXLIui1QY63GXBUg folded before Flop (didn't bet)




PokerStars Game #59939654834:  Hold'em No Limit ($0.10/$0.25) - 2009/07/01 0:45:28 ET
Table 'WjNvuuSgTjm8jh0j9vcCgQ' 9-max Seat #1 is the button
Seat 1: NKymidkL3Kg3ILZPvtLSVg ($10.20 in chips) 
Seat 2: 9gmYYQesalMrUjaF7nKfrQ ($9.15 in chips) 
Seat 3: 8B/dhbQjIWe6ASCdgzktNQ ($25.35 in chips) 
Seat 4: Xbfvrzh7Jjg4vOZkdMSfbA ($15 in chips) 
Seat 5: Qi+clOtyDiibLdH2/1Qy8g ($19.15 in chips) 
Seat 6: S0s//NMht9qTAscBNd6CUA ($10 in chips) 
Seat 7: DdPXdieucQ+n99u1n3A+rQ ($5 in chips) 
Seat 8: ghNKXUBl/H+t83JF079ZBA ($29.25 in chips) 
Seat 9: zakeg0SqJYXCZcG4HxYSQQ ($7.80 in chips) 
9gmYYQesalMrUjaF7nKfrQ: posts small blind $0.10
8B/dhbQjIWe6ASCdgzktNQ: posts big blind $0.25
Xbfvrzh7Jjg4vOZkdMSfbA: posts big blind $0.25
S0s//NMht9qTAscBNd6CUA: posts big blind $0.25
zakeg0SqJYXCZcG4HxYSQQ: posts big blind $0.25
*** HOLE CARDS ***
Xbfvrzh7Jjg4vOZkdMSfbA: raises $0.50 to $0.75
Qi+clOtyDiibLdH2/1Qy8g: folds 
S0s//NMht9qTAscBNd6CUA: folds 
DdPXdieucQ+n99u1n3A+rQ: folds 
ghNKXUBl/H+t83JF079ZBA: folds 
zakeg0SqJYXCZcG4HxYSQQ: calls $0.50
NKymidkL3Kg3ILZPvtLSVg: folds 
9gmYYQesalMrUjaF7nKfrQ: folds 
8B/dhbQjIWe6ASCdgzktNQ: folds 
*** FLOP *** [Qh 6h Js]
Xbfvrzh7Jjg4vOZkdMSfbA: bets $0.25
zakeg0SqJYXCZcG4HxYSQQ: calls $0.25
*** TURN *** [Qh 6h Js] [Kd]
Xbfvrzh7Jjg4vOZkdMSfbA: bets $0.25
zakeg0SqJYXCZcG4HxYSQQ: raises $0.25 to $0.50
Xbfvrzh7Jjg4vOZkdMSfbA: calls $0.25
*** RIVER *** [Qh 6h Js Kd] [Qd]
Xbfvrzh7Jjg4vOZkdMSfbA: checks 
zakeg0SqJYXCZcG4HxYSQQ: checks 
*** SHOW DOWN ***
Xbfvrzh7Jjg4vOZkdMSfbA: shows [Ah 8h] (a pair of Queens)
zakeg0SqJYXCZcG4HxYSQQ: shows [Ac Kc] (two pair, Kings and Queens)
zakeg0SqJYXCZcG4HxYSQQ collected $3.45 from pot
*** SUMMARY ***
Total pot $3.60 | Rake $0.15 
Board [Qh 6h Js Kd Qd]
Seat 1: NKymidkL3Kg3ILZPvtLSVg (button) folded before Flop (didn't bet)
Seat 2: 9gmYYQesalMrUjaF7nKfrQ (small blind) folded before Flop
Seat 3: 8B/dhbQjIWe6ASCdgzktNQ (big blind) folded before Flop
Seat 4: Xbfvrzh7Jjg4vOZkdMSfbA showed [Ah 8h] and lost with a pair of Queens
Seat 5: Qi+clOtyDiibLdH2/1Qy8g folded before Flop (didn't bet)
Seat 6: S0s//NMht9qTAscBNd6CUA folded before Flop
Seat 7: DdPXdieucQ+n99u1n3A+rQ folded before Flop (didn't bet)
Seat 8: ghNKXUBl/H+t83JF079ZBA folded before Flop (didn't bet)
Seat 9: zakeg0SqJYXCZcG4HxYSQQ showed [Ac Kc] and won ($3.45) with two pair, Kings and Queens




PokerStars Game #59939654988:  Hold'em No Limit ($0.10/$0.25) - 2009/07/01 0:45:28 ET
Table 'Of/T60zpXg1GcjrZ7Lm//Q' 9-max Seat #4 is the button
Seat 1: Lro4e37x4FUa5P3yzDjskw ($7.50 in chips) 
Seat 2: hIss79a4pu7GzJZepfgOpg ($25 in chips) 
Seat 3: jeKWRUkMaVn8rEUjnJKqpg ($28 in chips) 
Seat 4: Czut6V7acIqUJrrobjKAZg ($24.55 in chips) 
Seat 6: tYsOBqdU1+x+yFI7zHO7hQ ($26 in chips) 
Seat 7: s7Q6uNouhe7aE8JdFb9E+A ($34.60 in chips) 
Seat 8: ghNKXUBl/H+t83JF079ZBA ($31.25 in chips) 
Seat 9: TeWJxSETzbXGiYKx0y+dtg ($25 in chips) 
tYsOBqdU1+x+yFI7zHO7hQ: posts small blind $0.10
s7Q6uNouhe7aE8JdFb9E+A: posts big blind $0.25
*** HOLE CARDS ***
ghNKXUBl/H+t83JF079ZBA: folds 
TeWJxSETzbXGiYKx0y+dtg: folds 
Lro4e37x4FUa5P3yzDjskw: folds 
hIss79a4pu7GzJZepfgOpg: folds 
jeKWRUkMaVn8rEUjnJKqpg: folds 
Czut6V7acIqUJrrobjKAZg: folds 
tYsOBqdU1+x+yFI7zHO7hQ: folds 
Uncalled bet ($0.15) returned to s7Q6uNouhe7aE8JdFb9E+A
s7Q6uNouhe7aE8JdFb9E+A collected $0.20 from pot
s7Q6uNouhe7aE8JdFb9E+A: doesn't show hand 
*** SUMMARY ***
Total pot $0.20 | Rake $0 
Seat 1: Lro4e37x4FUa5P3yzDjskw folded before Flop (didn't bet)
Seat 2: hIss79a4pu7GzJZepfgOpg folded before Flop (didn't bet)
Seat 3: jeKWRUkMaVn8rEUjnJKqpg folded before Flop (didn't bet)
Seat 4: Czut6V7acIqUJrrobjKAZg (button) folded before Flop (didn't bet)
Seat 6: tYsOBqdU1+x+yFI7zHO7hQ (small blind) folded before Flop
Seat 7: s7Q6uNouhe7aE8JdFb9E+A (big blind) collected ($0.20)
Seat 8: ghNKXUBl/H+t83JF079ZBA folded before Flop (didn't bet)
Seat 9: TeWJxSETzbXGiYKx0y+dtg folded before Flop (didn't bet)




PokerStars Game #59939655398:  Hold'em No Limit ($0.10/$0.25) - 2009/07/01 0:45:29 ET
Table 'JJzUs04lHpXg6nboT1/jeg' 6-max Seat #1 is the button
Seat 1: 5RMSJF80SS07S0IGqbJZeA ($23.65 in chips) 
Seat 3: uUXdcVMNa05rfbntdvplfw ($33.80 in chips) 
Seat 4: nwwpaieDRI0UPyVtChVHOg ($33.25 in chips) 
Seat 5: Vr2XE7yYBdg3RZSURDAPEg ($16.05 in chips) 
4kWQxGbT5FZ1dkPd1bE45Q will be allowed to play after the button
uUXdcVMNa05rfbntdvplfw: posts small blind $0.10
nwwpaieDRI0UPyVtChVHOg: posts big blind $0.25
*** HOLE CARDS ***
Vr2XE7yYBdg3RZSURDAPEg: raises $0.50 to $0.75
5RMSJF80SS07S0IGqbJZeA: calls $0.75
uUXdcVMNa05rfbntdvplfw: folds 
nwwpaieDRI0UPyVtChVHOg: folds 
*** FLOP *** [Qd Th Qh]
sbFQMajC1QuRxa8Jly3usQ has returned
Vr2XE7yYBdg3RZSURDAPEg: bets $0.25
5RMSJF80SS07S0IGqbJZeA: folds 
Uncalled bet ($0.25) returned to Vr2XE7yYBdg3RZSURDAPEg
Vr2XE7yYBdg3RZSURDAPEg collected $1.80 from pot
Vr2XE7yYBdg3RZSURDAPEg: doesn't show hand 
*** SUMMARY ***
Total pot $1.85 | Rake $0.05 
Board [Qd Th Qh]
Seat 1: 5RMSJF80SS07S0IGqbJZeA (button) folded on the Flop
Seat 3: uUXdcVMNa05rfbntdvplfw (small blind) folded before Flop
Seat 4: nwwpaieDRI0UPyVtChVHOg (big blind) folded before Flop
Seat 5: Vr2XE7yYBdg3RZSURDAPEg collected ($1.80)




PokerStars Game #59939655616:  Hold'em No Limit ($0.10/$0.25) - 2009/07/01 0:45:29 ET
Table 'Loy/olZ5qoDOSvX4UTujGg' 6-max Seat #1 is the button
Seat 1: yzFNNFIfC89bBPwpFPx2ow ($25 in chips) 
Seat 2: 5OssdLlobpBsQP4GLYbbZQ ($5 in chips) 
Seat 3: 32YL2ZEp8NT4JB2RVM9euQ ($20.30 in chips) 
Seat 4: /gJNBeCkWL4o85/jvlZ4BA ($27.10 in chips) 
Seat 5: 4YSTu0Cdzpppe1lUgCZGCQ ($62.35 in chips) 
Seat 6: 7FmwVDcdEtxDpHmP4hOXsQ ($52.35 in chips) 
5OssdLlobpBsQP4GLYbbZQ: posts small blind $0.10
32YL2ZEp8NT4JB2RVM9euQ: posts big blind $0.25
*** HOLE CARDS ***
/gJNBeCkWL4o85/jvlZ4BA: folds 
4YSTu0Cdzpppe1lUgCZGCQ: folds 
7FmwVDcdEtxDpHmP4hOXsQ: folds 
yzFNNFIfC89bBPwpFPx2ow: folds 
5OssdLlobpBsQP4GLYbbZQ: raises $0.75 to $1
32YL2ZEp8NT4JB2RVM9euQ: folds 
Uncalled bet ($0.75) returned to 5OssdLlobpBsQP4GLYbbZQ
5OssdLlobpBsQP4GLYbbZQ collected $0.50 from pot
5OssdLlobpBsQP4GLYbbZQ: doesn't show hand 
*** SUMMARY ***
Total pot $0.50 | Rake $0 
Seat 1: yzFNNFIfC89bBPwpFPx2ow (button) folded before Flop (didn't bet)
Seat 2: 5OssdLlobpBsQP4GLYbbZQ (small blind) collected ($0.50)
Seat 3: 32YL2ZEp8NT4JB2RVM9euQ (big blind) folded before Flop
Seat 4: /gJNBeCkWL4o85/jvlZ4BA folded before Flop (didn't bet)
Seat 5: 4YSTu0Cdzpppe1lUgCZGCQ folded before Flop (didn't bet)
Seat 6: 7FmwVDcdEtxDpHmP4hOXsQ folded before Flop (didn't bet)




PokerStars Game #59939655690:  Hold'em No Limit ($0.10/$0.25) - 2009/07/01 0:45:29 ET
Table 'l57rayEpPtZotP9nqgSWBg' 6-max Seat #1 is the button
Seat 1: oseFhpinoe+Zg4j5xyBjyQ ($20.15 in chips) 
Seat 2: ErIN0JRL5srYjT6en1f8YQ ($24.30 in chips) 
Seat 3: sEQx9G5Cu8k1HNdQasxvUA ($40.15 in chips) 
Seat 4: NIALbunHAyYqmfMf7mrPhw ($6.60 in chips) 
Seat 5: TSmua8tGK3sTbwi0ynrW9Q ($59.05 in chips) 
Seat 6: IGRfskE1v9H9Bn+fz8AgNQ ($24.65 in chips) 
ErIN0JRL5srYjT6en1f8YQ: posts small blind $0.10
sEQx9G5Cu8k1HNdQasxvUA: posts big blind $0.25
*** HOLE CARDS ***
NIALbunHAyYqmfMf7mrPhw: folds 
TSmua8tGK3sTbwi0ynrW9Q: folds 
IGRfskE1v9H9Bn+fz8AgNQ: folds 
oseFhpinoe+Zg4j5xyBjyQ: folds 
ErIN0JRL5srYjT6en1f8YQ: folds 
Uncalled bet ($0.15) returned to sEQx9G5Cu8k1HNdQasxvUA
sEQx9G5Cu8k1HNdQasxvUA collected $0.20 from pot
sEQx9G5Cu8k1HNdQasxvUA: doesn't show hand 
*** SUMMARY ***
Total pot $0.20 | Rake $0 
Seat 1: oseFhpinoe+Zg4j5xyBjyQ (button) folded before Flop (didn't bet)
Seat 2: ErIN0JRL5srYjT6en1f8YQ (small blind) folded before Flop
Seat 3: sEQx9G5Cu8k1HNdQasxvUA (big blind) collected ($0.20)
Seat 4: NIALbunHAyYqmfMf7mrPhw folded before Flop (didn't bet)
Seat 5: TSmua8tGK3sTbwi0ynrW9Q folded before Flop (didn't bet)
Seat 6: IGRfskE1v9H9Bn+fz8AgNQ folded before Flop (didn't bet)




PokerStars Game #59939655468:  Hold'em No Limit ($0.10/$0.25) - 2009/07/01 0:45:29 ET
Table 'VQNfcI8vTBCTvRfd3veTLQ' 6-max Seat #5 is the button
Seat 1: ymz+a8dgHSUFPooYplw7Ow ($24.90 in chips) 
Seat 2: KukIGupqqJCXA+Hp2bEFnA ($6.10 in chips) 
Seat 3: LtASJ9OlkqGrrUKGQlpGAw ($23.05 in chips) 
Seat 4: nc79pm0LZRdhncq55evVqA ($25 in chips) 
Seat 5: gX2vbKwS/8zZPENAWB7hxQ ($10.70 in chips) 
Seat 6: dlCLwmcvRShnuFDEVkdIEA ($12.15 in chips) 
dlCLwmcvRShnuFDEVkdIEA: posts small blind $0.10
ymz+a8dgHSUFPooYplw7Ow: posts big blind $0.25
*** HOLE CARDS ***
KukIGupqqJCXA+Hp2bEFnA: calls $0.25
LtASJ9OlkqGrrUKGQlpGAw: folds 
nc79pm0LZRdhncq55evVqA: folds 
gX2vbKwS/8zZPENAWB7hxQ: calls $0.25
dlCLwmcvRShnuFDEVkdIEA: calls $0.15
ymz+a8dgHSUFPooYplw7Ow: checks 
*** FLOP *** [9h 7s Ac]
dlCLwmcvRShnuFDEVkdIEA: checks 
ymz+a8dgHSUFPooYplw7Ow: checks 
KukIGupqqJCXA+Hp2bEFnA: checks 
gX2vbKwS/8zZPENAWB7hxQ: checks 
*** TURN *** [9h 7s Ac] [2h]
dlCLwmcvRShnuFDEVkdIEA: checks 
ymz+a8dgHSUFPooYplw7Ow: checks 
KukIGupqqJCXA+Hp2bEFnA: checks 
gX2vbKwS/8zZPENAWB7hxQ: bets $1
dlCLwmcvRShnuFDEVkdIEA: folds 
ymz+a8dgHSUFPooYplw7Ow: folds 
KukIGupqqJCXA+Hp2bEFnA: folds 
Uncalled bet ($1) returned to gX2vbKwS/8zZPENAWB7hxQ
gX2vbKwS/8zZPENAWB7hxQ collected $0.95 from pot
*** SUMMARY ***
Total pot $1 | Rake $0.05 
Board [9h 7s Ac 2h]
Seat 1: ymz+a8dgHSUFPooYplw7Ow (big blind) folded on the Turn
Seat 2: KukIGupqqJCXA+Hp2bEFnA folded on the Turn
Seat 3: LtASJ9OlkqGrrUKGQlpGAw folded before Flop (didn't bet)
Seat 4: nc79pm0LZRdhncq55evVqA folded before Flop (didn't bet)
Seat 5: gX2vbKwS/8zZPENAWB7hxQ (button) collected ($0.95)
Seat 6: dlCLwmcvRShnuFDEVkdIEA (small blind) folded on the Turn




PokerStars Game #59939655620:  Hold'em No Limit ($0.10/$0.25) - 2009/07/01 0:45:29 ET
Table '9iHhO6FyZVM8XpSc23TIgg' 6-max Seat #1 is the button
Seat 1: NhUN/JpAprdJeamFBgJH1w ($25 in chips) 
Seat 2: ErIN0JRL5srYjT6en1f8YQ ($31.80 in chips) 
Seat 4: cfJccEfyn6IkquPN08hFsA ($34.95 in chips) 
Seat 5: WmfI+HZXhME/HMG8E3/H2w ($32.10 in chips) 
Seat 6: WrLI51S2iMb8GLMB83gGqA ($25 in chips) 
ErIN0JRL5srYjT6en1f8YQ: posts small blind $0.10
cfJccEfyn6IkquPN08hFsA: posts big blind $0.25
*** HOLE CARDS ***
WmfI+HZXhME/HMG8E3/H2w: calls $0.25
WrLI51S2iMb8GLMB83gGqA: folds 
NhUN/JpAprdJeamFBgJH1w: folds 
ErIN0JRL5srYjT6en1f8YQ: calls $0.15
cfJccEfyn6IkquPN08hFsA: checks 
*** FLOP *** [As Kd 3h]
ErIN0JRL5srYjT6en1f8YQ: checks 
cfJccEfyn6IkquPN08hFsA: checks 
WmfI+HZXhME/HMG8E3/H2w: checks 
*** TURN *** [As Kd 3h] [2d]
ErIN0JRL5srYjT6en1f8YQ: checks 
cfJccEfyn6IkquPN08hFsA: bets $0.75
WmfI+HZXhME/HMG8E3/H2w: folds 
ErIN0JRL5srYjT6en1f8YQ: folds 
Uncalled bet ($0.75) returned to cfJccEfyn6IkquPN08hFsA
RYLaAIIwK9wxkPswt1yJYw joins the table at seat #3 
cfJccEfyn6IkquPN08hFsA collected $0.75 from pot
cfJccEfyn6IkquPN08hFsA: doesn't show hand 
*** SUMMARY ***
Total pot $0.75 | Rake $0 
Board [As Kd 3h 2d]
Seat 1: NhUN/JpAprdJeamFBgJH1w (button) folded before Flop (didn't bet)
Seat 2: ErIN0JRL5srYjT6en1f8YQ (small blind) folded on the Turn
Seat 4: cfJccEfyn6IkquPN08hFsA (big blind) collected ($0.75)
Seat 5: WmfI+HZXhME/HMG8E3/H2w folded on the Turn
Seat 6: WrLI51S2iMb8GLMB83gGqA folded before Flop (didn't bet)




PokerStars Game #59939655492:  Hold'em No Limit ($0.10/$0.25) - 2009/07/01 0:45:29 ET
Table 'M7d9IrgQUUFFy/SZ3ksLYg' 6-max Seat #1 is the button
Seat 1: cPO/1/dTcZpLkQFm3jH3Rg ($26.75 in chips) 
Seat 2: JE/wJXmjw3bpdmjwvh2pcg ($31.30 in chips) 
Seat 3: eHsmIvAb2JREg4O6hNPnXg ($17.25 in chips) 
Seat 4: 7FmwVDcdEtxDpHmP4hOXsQ ($29.90 in chips) 
Seat 6: /gJNBeCkWL4o85/jvlZ4BA ($25 in chips) 
JE/wJXmjw3bpdmjwvh2pcg: posts small blind $0.10
eHsmIvAb2JREg4O6hNPnXg: posts big blind $0.25
nc79pm0LZRdhncq55evVqA: sits out 
*** HOLE CARDS ***
7FmwVDcdEtxDpHmP4hOXsQ: raises $0.50 to $0.75
/gJNBeCkWL4o85/jvlZ4BA: folds 
cPO/1/dTcZpLkQFm3jH3Rg: calls $0.75
JE/wJXmjw3bpdmjwvh2pcg: folds 
eHsmIvAb2JREg4O6hNPnXg: raises $0.75 to $1.50
7FmwVDcdEtxDpHmP4hOXsQ: folds 
cPO/1/dTcZpLkQFm3jH3Rg: calls $0.75
*** FLOP *** [9c Js Ac]
eHsmIvAb2JREg4O6hNPnXg: bets $1.25
cPO/1/dTcZpLkQFm3jH3Rg: raises $1.25 to $2.50
eHsmIvAb2JREg4O6hNPnXg: raises $13.25 to $15.75 and is all-in
cPO/1/dTcZpLkQFm3jH3Rg: calls $13.25
*** TURN *** [9c Js Ac] [4c]
*** RIVER *** [9c Js Ac 4c] [7s]
*** SHOW DOWN ***
eHsmIvAb2JREg4O6hNPnXg: shows [Qd Ad] (a pair of Aces)
cPO/1/dTcZpLkQFm3jH3Rg: shows [Jd Jh] (three of a kind, Jacks)
cPO/1/dTcZpLkQFm3jH3Rg collected $33.60 from pot
*** SUMMARY ***
Total pot $35.35 | Rake $1.75 
Board [9c Js Ac 4c 7s]
Seat 1: cPO/1/dTcZpLkQFm3jH3Rg (button) showed [Jd Jh] and won ($33.60) with three of a kind, Jacks
Seat 2: JE/wJXmjw3bpdmjwvh2pcg (small blind) folded before Flop
Seat 3: eHsmIvAb2JREg4O6hNPnXg (big blind) showed [Qd Ad] and lost with a pair of Aces
Seat 4: 7FmwVDcdEtxDpHmP4hOXsQ folded before Flop
Seat 6: /gJNBeCkWL4o85/jvlZ4BA folded before Flop (didn't bet)




PokerStars Game #59939656116:  Hold'em No Limit ($0.10/$0.25) - 2009/07/01 0:45:30 ET
Table 'wRXcD9iXgBbdvKhWmfnBnw' 6-max Seat #1 is the button
Seat 1: LGWRgaQNaDFSlUGk26f0Ig ($22.70 in chips) 
Seat 2: SS/yfeArhULzIcOPe8MdPg ($25 in chips) 
Seat 3: 6zbQpY/G44U1Xvj7DZex0A ($40.75 in chips) 
Seat 4: mfrkWA3PTeYPkbO6hi98Aw ($24.70 in chips) 
Seat 5: EE16Ua5b1HSsYej5zeXOlA ($25 in chips) 
SS/yfeArhULzIcOPe8MdPg: posts small blind $0.10
6zbQpY/G44U1Xvj7DZex0A: posts big blind $0.25
*** HOLE CARDS ***
turtlerific has returned
mfrkWA3PTeYPkbO6hi98Aw: folds 
turtlerific leaves the table
EE16Ua5b1HSsYej5zeXOlA: folds 
LGWRgaQNaDFSlUGk26f0Ig: folds 
SS/yfeArhULzIcOPe8MdPg: folds 
Uncalled bet ($0.15) returned to 6zbQpY/G44U1Xvj7DZex0A
6zbQpY/G44U1Xvj7DZex0A collected $0.20 from pot
*** SUMMARY ***
Total pot $0.20 | Rake $0 
Seat 1: LGWRgaQNaDFSlUGk26f0Ig (button) folded before Flop (didn't bet)
Seat 2: SS/yfeArhULzIcOPe8MdPg (small blind) folded before Flop
Seat 3: 6zbQpY/G44U1Xvj7DZex0A (big blind) collected ($0.20)
Seat 4: mfrkWA3PTeYPkbO6hi98Aw folded before Flop (didn't bet)
Seat 5: EE16Ua5b1HSsYej5zeXOlA folded before Flop (didn't bet)




PokerStars Game #59939655790:  Hold'em No Limit ($0.10/$0.25) - 2009/07/01 0:45:30 ET
Table 'YmPuuzhvRUvgdYcNs5kZKw' 9-max Seat #3 is the button
Seat 1: Qi+clOtyDiibLdH2/1Qy8g ($25.30 in chips) 
Seat 3: uLP/lYn7oKq9xCChBXsXxw ($22.75 in chips) 
Seat 4: N6fYvIzQLKaydFLKQGtMlQ ($24.50 in chips) 
Seat 5: CvL9Ch1HYCVbTsfpNucitg ($5 in chips) 
Seat 6: z5GxcHlYz/GSz6W2uFiTtg ($26.15 in chips) 
Seat 7: opOCI2p6kW0tINuVaAqmcQ ($25 in chips) 
Seat 8: IeNTEKD96WqM7qU1RpSvOQ ($11.60 in chips) 
N6fYvIzQLKaydFLKQGtMlQ: posts small blind $0.10
CvL9Ch1HYCVbTsfpNucitg: posts big blind $0.25
the bear NF: sits out 
JtVGnq5doRa3PublncR+Yw: sits out 
*** HOLE CARDS ***
z5GxcHlYz/GSz6W2uFiTtg: folds 
opOCI2p6kW0tINuVaAqmcQ: folds 
IeNTEKD96WqM7qU1RpSvOQ: calls $0.25
Qi+clOtyDiibLdH2/1Qy8g: calls $0.25
uLP/lYn7oKq9xCChBXsXxw: folds 
uLP/lYn7oKq9xCChBXsXxw is sitting out
N6fYvIzQLKaydFLKQGtMlQ: folds 
CvL9Ch1HYCVbTsfpNucitg: checks 
*** FLOP *** [3c 7d Ah]
CvL9Ch1HYCVbTsfpNucitg: checks 
IeNTEKD96WqM7qU1RpSvOQ: bets $0.50
Qi+clOtyDiibLdH2/1Qy8g: folds 
CvL9Ch1HYCVbTsfpNucitg: folds 
Uncalled bet ($0.50) returned to IeNTEKD96WqM7qU1RpSvOQ
IeNTEKD96WqM7qU1RpSvOQ collected $0.85 from pot
*** SUMMARY ***
Total pot $0.85 | Rake $0 
Board [3c 7d Ah]
Seat 1: Qi+clOtyDiibLdH2/1Qy8g folded on the Flop
Seat 3: uLP/lYn7oKq9xCChBXsXxw (button) folded before Flop (didn't bet)
Seat 4: N6fYvIzQLKaydFLKQGtMlQ (small blind) folded before Flop
Seat 5: CvL9Ch1HYCVbTsfpNucitg (big blind) folded on the Flop
Seat 6: z5GxcHlYz/GSz6W2uFiTtg folded before Flop (didn't bet)
Seat 7: opOCI2p6kW0tINuVaAqmcQ folded before Flop (didn't bet)
Seat 8: IeNTEKD96WqM7qU1RpSvOQ collected ($0.85)




PokerStars Game #59939656232:  Hold'em No Limit ($0.10/$0.25) - 2009/07/01 0:45:30 ET
Table '/XCUCUl3yW6tdTJQEhJKGw' 6-max Seat #5 is the button
Seat 1: p8J112JmNRnCwV2+NAEzCA ($20.10 in chips) 
Seat 2: 8ClCHtFXGNplITm+63KB+Q ($28.30 in chips) 
Seat 3: /gJNBeCkWL4o85/jvlZ4BA ($36.25 in chips) 
Seat 4: SFmT9ZsVopnukjvAzrxTRg ($25 in chips) 
Seat 5: rf9ho6cin0bk70nP86p3rQ ($14.25 in chips) 
Seat 6: armfxZhGxeZVZBYAQFuIJQ ($34.75 in chips) 
armfxZhGxeZVZBYAQFuIJQ: posts small blind $0.10
p8J112JmNRnCwV2+NAEzCA: posts big blind $0.25
*** HOLE CARDS ***
8ClCHtFXGNplITm+63KB+Q: folds 
/gJNBeCkWL4o85/jvlZ4BA: folds 
SFmT9ZsVopnukjvAzrxTRg: raises $0.75 to $1
rf9ho6cin0bk70nP86p3rQ: folds 
armfxZhGxeZVZBYAQFuIJQ: folds 
p8J112JmNRnCwV2+NAEzCA: folds 
Uncalled bet ($0.75) returned to SFmT9ZsVopnukjvAzrxTRg
SFmT9ZsVopnukjvAzrxTRg collected $0.60 from pot
SFmT9ZsVopnukjvAzrxTRg: doesn't show hand 
*** SUMMARY ***
Total pot $0.60 | Rake $0 
Seat 1: p8J112JmNRnCwV2+NAEzCA (big blind) folded before Flop
Seat 2: 8ClCHtFXGNplITm+63KB+Q folded before Flop (didn't bet)
Seat 3: /gJNBeCkWL4o85/jvlZ4BA folded before Flop (didn't bet)
Seat 4: SFmT9ZsVopnukjvAzrxTRg collected ($0.60)
Seat 5: rf9ho6cin0bk70nP86p3rQ (button) folded before Flop (didn't bet)
Seat 6: armfxZhGxeZVZBYAQFuIJQ (small blind) folded before Flop




PokerStars Game #59939655814:  Hold'em No Limit ($0.10/$0.25) - 2009/07/01 0:45:30 ET
Table '1zj0+miaIL9cvwnT/50pOA' 9-max Seat #1 is the button
Seat 1: spidnpwmoJ1L6yeNW7D5UA ($33 in chips) 
Seat 2: HPEB+AtKw1+C/cxU0o1ciw ($28.20 in chips) 
Seat 3: CYkY0dNBaYaKs8HVCVn3mQ ($5 in chips) 
Seat 4: 6esz1u5YivjsX0UoeMBm3w ($23.20 in chips) 
Seat 6: ydoFOVgzvZv9ZhuWu9rXAw ($5 in chips) 
Seat 7: 6oWOdVz2WG2azNuOj9rMgg ($14.20 in chips) 
Seat 8: HOiu48bZMhEZSoJa8mjiMw ($32.40 in chips) 
Seat 9: OiV1PWZ3IkN29JlmCcnTwQ ($5.25 in chips) 
HPEB+AtKw1+C/cxU0o1ciw: posts small blind $0.10
CYkY0dNBaYaKs8HVCVn3mQ: posts big blind $0.25
DbN2dZXDtMsRORFhREVeJA: sits out 
*** HOLE CARDS ***
6esz1u5YivjsX0UoeMBm3w: folds 
ydoFOVgzvZv9ZhuWu9rXAw: folds 
6oWOdVz2WG2azNuOj9rMgg: folds 
HOiu48bZMhEZSoJa8mjiMw: calls $0.25
OiV1PWZ3IkN29JlmCcnTwQ: folds 
spidnpwmoJ1L6yeNW7D5UA: folds 
HPEB+AtKw1+C/cxU0o1ciw: folds 
CYkY0dNBaYaKs8HVCVn3mQ: raises $1 to $1.25
HOiu48bZMhEZSoJa8mjiMw: calls $1
*** FLOP *** [6h 4d 8s]
CYkY0dNBaYaKs8HVCVn3mQ: checks 
HOiu48bZMhEZSoJa8mjiMw: checks 
*** TURN *** [6h 4d 8s] [4h]
CYkY0dNBaYaKs8HVCVn3mQ: checks 
HOiu48bZMhEZSoJa8mjiMw: checks 
*** RIVER *** [6h 4d 8s 4h] [8d]
CYkY0dNBaYaKs8HVCVn3mQ: bets $1
HOiu48bZMhEZSoJa8mjiMw: folds 
Uncalled bet ($1) returned to CYkY0dNBaYaKs8HVCVn3mQ
CYkY0dNBaYaKs8HVCVn3mQ collected $2.50 from pot
CYkY0dNBaYaKs8HVCVn3mQ: doesn't show hand 
*** SUMMARY ***
Total pot $2.60 | Rake $0.10 
Board [6h 4d 8s 4h 8d]
Seat 1: spidnpwmoJ1L6yeNW7D5UA (button) folded before Flop (didn't bet)
Seat 2: HPEB+AtKw1+C/cxU0o1ciw (small blind) folded before Flop
Seat 3: CYkY0dNBaYaKs8HVCVn3mQ (big blind) collected ($2.50)
Seat 4: 6esz1u5YivjsX0UoeMBm3w folded before Flop (didn't bet)
Seat 6: ydoFOVgzvZv9ZhuWu9rXAw folded before Flop (didn't bet)
Seat 7: 6oWOdVz2WG2azNuOj9rMgg folded before Flop (didn't bet)
Seat 8: HOiu48bZMhEZSoJa8mjiMw folded on the River
Seat 9: OiV1PWZ3IkN29JlmCcnTwQ folded before Flop (didn't bet)




PokerStars Game #59939656262:  Hold'em No Limit ($0.10/$0.25) - 2009/07/01 0:45:30 ET
Table 'WEMI3Mtn7dGARDbgNrKibg' 9-max Seat #4 is the button
Seat 1: 7cv+9Zc9HIQHNvYsMfV3uA ($25 in chips) 
Seat 2: tYsOBqdU1+x+yFI7zHO7hQ ($46.20 in chips) 
Seat 3: jZaChyamGXWcP+qALPP5Jg ($29.45 in chips) 
Seat 4: yyG4svzOpC1A+sUP/scg6w ($7.50 in chips) 
Seat 6: VBHxUExRAMrbxUq/cVx9Gw ($4.75 in chips) 
Seat 7: DnDcAdn9P0zGovMERigpFA ($59 in chips) 
Seat 8: ghNKXUBl/H+t83JF079ZBA ($26.95 in chips) 
Seat 9: NTamLAiMZ86c5yM04t96LA ($55.65 in chips) 
VBHxUExRAMrbxUq/cVx9Gw: posts small blind $0.10
DnDcAdn9P0zGovMERigpFA: posts big blind $0.25
*** HOLE CARDS ***
ghNKXUBl/H+t83JF079ZBA: folds 
NTamLAiMZ86c5yM04t96LA: raises $0.50 to $0.75
7cv+9Zc9HIQHNvYsMfV3uA: folds 
tYsOBqdU1+x+yFI7zHO7hQ: folds 
jZaChyamGXWcP+qALPP5Jg: folds 
yyG4svzOpC1A+sUP/scg6w: folds 
VBHxUExRAMrbxUq/cVx9Gw: folds 
DnDcAdn9P0zGovMERigpFA: folds 
Uncalled bet ($0.50) returned to NTamLAiMZ86c5yM04t96LA
NTamLAiMZ86c5yM04t96LA collected $0.60 from pot
NTamLAiMZ86c5yM04t96LA: doesn't show hand 
*** SUMMARY ***
Total pot $0.60 | Rake $0 
Seat 1: 7cv+9Zc9HIQHNvYsMfV3uA folded before Flop (didn't bet)
Seat 2: tYsOBqdU1+x+yFI7zHO7hQ folded before Flop (didn't bet)
Seat 3: jZaChyamGXWcP+qALPP5Jg folded before Flop (didn't bet)
Seat 4: yyG4svzOpC1A+sUP/scg6w (button) folded before Flop (didn't bet)
Seat 6: VBHxUExRAMrbxUq/cVx9Gw (small blind) folded before Flop
Seat 7: DnDcAdn9P0zGovMERigpFA (big blind) folded before Flop
Seat 8: ghNKXUBl/H+t83JF079ZBA folded before Flop (didn't bet)
Seat 9: NTamLAiMZ86c5yM04t96LA collected ($0.60)




PokerStars Game #59939656170:  Hold'em No Limit ($0.10/$0.25) - 2009/07/01 0:45:30 ET
Table 'z2yOdY2zyGWG1gh9WV9XtQdYNvO8G5kw5SRxb1Dljhog Seat #3 is the button
Seat 1: Z9AeOQX3yzuSvKAm/xyovg ($8.75 in chips) 
Seat 2: vEBWvFD+KUWgDBKZKvA3SA ($3.90 in chips) 
Seat 3: 1Cs1GyQcoM1omwY7XZ3uRg ($14.70 in chips) 
Seat 4: sD+TKtt36XiiN6jqHiLwDA ($25.95 in chips) 
Seat 5: W7XGvw6ngGVq2hFwXk8Myg ($15.65 in chips) 
Seat 7: DiSvPC2iudwL5j9u6Huyww ($41.05 in chips) 
Seat 8: 5hAPbqNrvJb8PtLiceXtlg6HoFYfVGBefsR5Vrz62qIw4.40 in chips) 
Seat 9: sUVgUtgbfVx6JpvApozwhQ ($5.25 in chips) 
sD+TKtt36XiiN6jqHiLwDA: posts small blind $0.10
W7XGvw6ngGVq2hFwXk8Myg: posts big blind $0.25
22dIObOuor/A+IKWkNoAlA: sits out 
*** HOLE CARDS ***
DiSvPC2iudwL5j9u6Huyww: folds 
5hAPbqNrvJb8PtLiceXtlg6HoFYfVGBefsR5Vrz62qIwlds 
sUVgUtgbfVx6JpvApozwhQ: folds 
Z9AeOQX3yzuSvKAm/xyovg: folds 
vEBWvFD+KUWgDBKZKvA3SA: calls $0.25
1Cs1GyQcoM1omwY7XZ3uRg: calls $0.25
sD+TKtt36XiiN6jqHiLwDA: calls $0.15
W7XGvw6ngGVq2hFwXk8Myg: checks 
*** FLOP *** [7s Kc Td]
sD+TKtt36XiiN6jqHiLwDA: checks 
W7XGvw6ngGVq2hFwXk8Myg: checks 
vEBWvFD+KUWgDBKZKvA3SA: bets $0.50
1Cs1GyQcoM1omwY7XZ3uRg: calls $0.50
sD+TKtt36XiiN6jqHiLwDA: folds 
W7XGvw6ngGVq2hFwXk8Myg: calls $0.50
*** TURN *** [7s Kc Td] [7c]
W7XGvw6ngGVq2hFwXk8Myg: checks 
vEBWvFD+KUWgDBKZKvA3SA: checks 
1Cs1GyQcoM1omwY7XZ3uRg: bets $0.25
W7XGvw6ngGVq2hFwXk8Myg: calls $0.25
vEBWvFD+KUWgDBKZKvA3SA: calls $0.25
*** RIVER *** [7s Kc Td 7c] [2h]
W7XGvw6ngGVq2hFwXk8Myg: bets $0.25
vEBWvFD+KUWgDBKZKvA3SA: calls $0.25
1Cs1GyQcoM1omwY7XZ3uRg: calls $0.25
*** SHOW DOWN ***
W7XGvw6ngGVq2hFwXk8Myg: shows [4s Kh] (two pair, Kings and Sevens)
vEBWvFD+KUWgDBKZKvA3SA: mucks hand 
1Cs1GyQcoM1omwY7XZ3uRg: shows [Kd 4h] (two pair, Kings and Sevens)
vEBWvFD+KUWgDBKZKvA3SA is sitting out
W7XGvw6ngGVq2hFwXk8Myg collected $1.95 from pot
1Cs1GyQcoM1omwY7XZ3uRg collected $1.90 from pot
*** SUMMARY ***
Total pot $4 | Rake $0.15 
Board [7s Kc Td 7c 2h]
Seat 1: Z9AeOQX3yzuSvKAm/xyovg folded before Flop (didn't bet)
Seat 2: vEBWvFD+KUWgDBKZKvA3SA mucked
Seat 3: 1Cs1GyQcoM1omwY7XZ3uRg (button) showed [Kd 4h] and won ($1.90) with two pair, Kings and Sevens
Seat 4: sD+TKtt36XiiN6jqHiLwDA (small blind) folded on the Flop
Seat 5: W7XGvw6ngGVq2hFwXk8Myg (big blind) showed [4s Kh] and won ($1.95) with two pair, Kings and Sevens
Seat 7: DiSvPC2iudwL5j9u6Huyww folded before Flop (didn't bet)
Seat 8: 5hAPbqNrvJb8PtLiceXtlg6HoFYfVGBefsR5Vrz62qIwded before Flop (didn't bet)
Seat 9: sUVgUtgbfVx6JpvApozwhQ folded before Flop (didn't bet)




PokerStars Game #59939656288:  Hold'em No Limit ($0.10/$0.25) - 2009/07/01 0:45:30 ET
Table 'wixGE3Zge1qBdnpWijIl/w' 9-max Seat #1 is the button
Seat 1: 86vbuhJsyH+nbEg5qpDLyQ ($25.40 in chips) 
Seat 2: DnDcAdn9P0zGovMERigpFA ($25 in chips) 
Seat 3: DdPXdieucQ+n99u1n3A+rQ ($4.65 in chips) 
Seat 4: 4oA316mXLIui1QY63GXBUg ($25 in chips) 
Seat 5: MIVCHqCqqlke0Lb0z7glcw ($32 in chips) 
Seat 6: TlEYI/zXzaKGGsmuvWFd2A ($12.85 in chips) 
Seat 7: qIaaweMCAGmy9HZFT4r/6A ($58.95 in chips) 
Seat 8: hIss79a4pu7GzJZepfgOpg ($25 in chips) 
Seat 9: r6hsffOo1iKmaPYKwAZmFw ($25.85 in chips) 
DnDcAdn9P0zGovMERigpFA: posts small blind $0.10
DdPXdieucQ+n99u1n3A+rQ: posts big blind $0.25
*** HOLE CARDS ***
4oA316mXLIui1QY63GXBUg: folds 
MIVCHqCqqlke0Lb0z7glcw: folds 
TlEYI/zXzaKGGsmuvWFd2A: raises $1 to $1.25
qIaaweMCAGmy9HZFT4r/6A: folds 
hIss79a4pu7GzJZepfgOpg: folds 
r6hsffOo1iKmaPYKwAZmFw: folds 
86vbuhJsyH+nbEg5qpDLyQ: folds 
DnDcAdn9P0zGovMERigpFA: folds 
DdPXdieucQ+n99u1n3A+rQ: raises $3.40 to $4.65 and is all-in
TlEYI/zXzaKGGsmuvWFd2A: calls $3.40
*** FLOP *** [4c Jh 3c]
*** TURN *** [4c Jh 3c] [2c]
*** RIVER *** [4c Jh 3c 2c] [4h]
*** SHOW DOWN ***
DdPXdieucQ+n99u1n3A+rQ: shows [9s Ah] (a pair of Fours)
TlEYI/zXzaKGGsmuvWFd2A: mucks hand 
DdPXdieucQ+n99u1n3A+rQ collected $8.95 from pot
*** SUMMARY ***
Total pot $9.40 | Rake $0.45 
Board [4c Jh 3c 2c 4h]
Seat 1: 86vbuhJsyH+nbEg5qpDLyQ (button) folded before Flop (didn't bet)
Seat 2: DnDcAdn9P0zGovMERigpFA (small blind) folded before Flop
Seat 3: DdPXdieucQ+n99u1n3A+rQ (big blind) showed [9s Ah] and won ($8.95) with a pair of Fours
Seat 4: 4oA316mXLIui1QY63GXBUg folded before Flop (didn't bet)
Seat 5: MIVCHqCqqlke0Lb0z7glcw folded before Flop (didn't bet)
Seat 6: TlEYI/zXzaKGGsmuvWFd2A mucked
Seat 7: qIaaweMCAGmy9HZFT4r/6A folded before Flop (didn't bet)
Seat 8: hIss79a4pu7GzJZepfgOpg folded before Flop (didn't bet)
Seat 9: r6hsffOo1iKmaPYKwAZmFw folded before Flop (didn't bet)




PokerStars Game #59939656690:  Hold'em No Limit ($0.10/$0.25) - 2009/07/01 0:45:31 ET
Table 'LG9H161ZAHDkOww+ih3Ptg' 6-max Seat #4 is the button
Seat 1: avl8CO/tc0F6eVSiB/KNRA ($24.75 in chips) 
Seat 2: 9jSiy0meE9XJKkdIZwyTEQ ($28.60 in chips) 
Seat 4: 0C28L4/59aRNtHoBhqTcLg ($71.25 in chips) 
Seat 5: oseFhpinoe+Zg4j5xyBjyQ ($45.85 in chips) 
oseFhpinoe+Zg4j5xyBjyQ: posts small blind $0.10
avl8CO/tc0F6eVSiB/KNRA: posts big blind $0.25
*** HOLE CARDS ***
9jSiy0meE9XJKkdIZwyTEQ: folds 
0C28L4/59aRNtHoBhqTcLg: folds 
oseFhpinoe+Zg4j5xyBjyQ: raises $0.25 to $0.50
avl8CO/tc0F6eVSiB/KNRA: calls $0.25
*** FLOP *** [9d Jh 6h]
oseFhpinoe+Zg4j5xyBjyQ: bets $0.50
avl8CO/tc0F6eVSiB/KNRA: raises $0.75 to $1.25
oseFhpinoe+Zg4j5xyBjyQ: folds 
Uncalled bet ($0.75) returned to avl8CO/tc0F6eVSiB/KNRA
5Evvx7UYqXTBuvIc/9s/hA joins the table at seat #3 
avl8CO/tc0F6eVSiB/KNRA collected $1.95 from pot
avl8CO/tc0F6eVSiB/KNRA: doesn't show hand 
*** SUMMARY ***
Total pot $2 | Rake $0.05 
Board [9d Jh 6h]
Seat 1: avl8CO/tc0F6eVSiB/KNRA (big blind) collected ($1.95)
Seat 2: 9jSiy0meE9XJKkdIZwyTEQ folded before Flop (didn't bet)
Seat 4: 0C28L4/59aRNtHoBhqTcLg (button) folded before Flop (didn't bet)
Seat 5: oseFhpinoe+Zg4j5xyBjyQ (small blind) folded on the Flop




PokerStars Game #59939656420:  Hold'em No Limit ($0.10/$0.25) - 2009/07/01 0:45:31 ET
Table 'Do4nrTNDYpK3sQjwFxX+Og' 6-max Seat #4 is the button
Seat 1: 7JrQNOR9wRBxq9ijFhWieg ($30.10 in chips) 
Seat 2: tzMoGl9F0PUr5NibYueeSw ($44.40 in chips) 
Seat 3: TSmua8tGK3sTbwi0ynrW9Q ($32.80 in chips) 
Seat 4: df7bIV965hvGEDiUAs5cfQ ($14 in chips) 
Seat 5: Ew/TYPQIsbQ2X8nm5iAJBg ($30.90 in chips) 
Seat 6: eHsmIvAb2JREg4O6hNPnXg ($21.20 in chips) 
Ew/TYPQIsbQ2X8nm5iAJBg: posts small blind $0.10
eHsmIvAb2JREg4O6hNPnXg: posts big blind $0.25
*** HOLE CARDS ***
7JrQNOR9wRBxq9ijFhWieg: raises $0.50 to $0.75
tzMoGl9F0PUr5NibYueeSw: folds 
TSmua8tGK3sTbwi0ynrW9Q: folds 
df7bIV965hvGEDiUAs5cfQ: folds 
Ew/TYPQIsbQ2X8nm5iAJBg: folds 
eHsmIvAb2JREg4O6hNPnXg: folds 
Uncalled bet ($0.50) returned to 7JrQNOR9wRBxq9ijFhWieg
7JrQNOR9wRBxq9ijFhWieg collected $0.60 from pot
7JrQNOR9wRBxq9ijFhWieg: doesn't show hand 
*** SUMMARY ***
Total pot $0.60 | Rake $0 
Seat 1: 7JrQNOR9wRBxq9ijFhWieg collected ($0.60)
Seat 2: tzMoGl9F0PUr5NibYueeSw folded before Flop (didn't bet)
Seat 3: TSmua8tGK3sTbwi0ynrW9Q folded before Flop (didn't bet)
Seat 4: df7bIV965hvGEDiUAs5cfQ (button) folded before Flop (didn't bet)
Seat 5: Ew/TYPQIsbQ2X8nm5iAJBg (small blind) folded before Flop
Seat 6: eHsmIvAb2JREg4O6hNPnXg (big blind) folded before Flop




PokerStars Game #59939656956:  Hold'em No Limit ($0.10/$0.25) - 2009/07/01 0:45:31 ET
Table 'sgB7AwZtVgDTf4fi8RwWFQ' 9-max Seat #8 is the button
Seat 1: QEbIGci+itdw+re8RM5fZA ($25.45 in chips) 
Seat 2: DnDcAdn9P0zGovMERigpFA ($31.15 in chips) 
Seat 4: uiY0LY93PAPU4thuTHjtPQ ($3.05 in chips) 
Seat 5: gGaFLzGESKP3Tj9N/K7QNA ($6 in chips) 
Seat 6: YEdelvffSYRP4EDNfFp4dA ($15 in chips) 
Seat 8: Nq5F1B22aaLLZ+D9HbzcGg ($24.90 in chips) 
Seat 9: MG90wfSJZnOejs/KD3vlQQ ($32.80 in chips) 
MG90wfSJZnOejs/KD3vlQQ: posts small blind $0.10
QEbIGci+itdw+re8RM5fZA: posts big blind $0.25
gGaFLzGESKP3Tj9N/K7QNA: posts big blind $0.25
YEdelvffSYRP4EDNfFp4dA: posts big blind $0.25
*** HOLE CARDS ***
DnDcAdn9P0zGovMERigpFA: folds 
uiY0LY93PAPU4thuTHjtPQ: calls $0.25
gGaFLzGESKP3Tj9N/K7QNA: checks 
YEdelvffSYRP4EDNfFp4dA: checks 
Nq5F1B22aaLLZ+D9HbzcGg: folds 
MG90wfSJZnOejs/KD3vlQQ: folds 
QEbIGci+itdw+re8RM5fZA: raises $1.25 to $1.50
uiY0LY93PAPU4thuTHjtPQ: calls $1.25
gGaFLzGESKP3Tj9N/K7QNA: folds 
YEdelvffSYRP4EDNfFp4dA: folds 
*** FLOP *** [7s Th Kc]
QEbIGci+itdw+re8RM5fZA: bets $2
uiY0LY93PAPU4thuTHjtPQ: calls $1.55 and is all-in
Uncalled bet ($0.45) returned to QEbIGci+itdw+re8RM5fZA
*** TURN *** [7s Th Kc] [4s]
*** RIVER *** [7s Th Kc 4s] [3d]
*** SHOW DOWN ***
QEbIGci+itdw+re8RM5fZA: shows [Qd Qs] (a pair of Queens)
uiY0LY93PAPU4thuTHjtPQ: mucks hand 
QEbIGci+itdw+re8RM5fZA collected $6.40 from pot
uiY0LY93PAPU4thuTHjtPQ leaves the table
*** SUMMARY ***
Total pot $6.70 | Rake $0.30 
Board [7s Th Kc 4s 3d]
Seat 1: QEbIGci+itdw+re8RM5fZA (big blind) showed [Qd Qs] and won ($6.40) with a pair of Queens
Seat 2: DnDcAdn9P0zGovMERigpFA folded before Flop (didn't bet)
Seat 4: uiY0LY93PAPU4thuTHjtPQ mucked
Seat 5: gGaFLzGESKP3Tj9N/K7QNA folded before Flop
Seat 6: YEdelvffSYRP4EDNfFp4dA folded before Flop
Seat 8: Nq5F1B22aaLLZ+D9HbzcGg (button) folded before Flop (didn't bet)
Seat 9: MG90wfSJZnOejs/KD3vlQQ (small blind) folded before Flop




PokerStars Game #59939656626:  Hold'em No Limit ($0.10/$0.25) - 2009/07/01 0:45:31 ET
Table 'HzFR0rxmDAPu5GzYR0AlYg' 6-max Seat #2 is the button
Seat 1: v+QfkGiuj9bgtuNoVnDO8w ($25 in chips) 
Seat 2: UA5OsKS3VPaxa7uC8La/kA ($51.20 in chips) 
Seat 4: uy9x0X5l7O+IpGjLa77QgQ ($62.90 in chips) 
Seat 5: lquriepNQBhDV5P1SWHhnA ($25 in chips) 
Seat 6: jp34e617tIzV8tKIWmfAbA ($26.60 in chips) 
uy9x0X5l7O+IpGjLa77QgQ: posts small blind $0.10
lquriepNQBhDV5P1SWHhnA: posts big blind $0.25
*** HOLE CARDS ***
jp34e617tIzV8tKIWmfAbA: folds 
v+QfkGiuj9bgtuNoVnDO8w: folds 
UA5OsKS3VPaxa7uC8La/kA: raises $0.50 to $0.75
uy9x0X5l7O+IpGjLa77QgQ: calls $0.65
lquriepNQBhDV5P1SWHhnA: folds 
*** FLOP *** [Kd 6c 7s]
uy9x0X5l7O+IpGjLa77QgQ: checks 
UA5OsKS3VPaxa7uC8La/kA: bets $1
uy9x0X5l7O+IpGjLa77QgQ: raises $3 to $4
lfAPI6VglUPipZe8BpDaTA has returned
UA5OsKS3VPaxa7uC8La/kA: folds 
Uncalled bet ($3) returned to uy9x0X5l7O+IpGjLa77QgQ
uy9x0X5l7O+IpGjLa77QgQ collected $3.60 from pot
uy9x0X5l7O+IpGjLa77QgQ: doesn't show hand 
*** SUMMARY ***
Total pot $3.75 | Rake $0.15 
Board [Kd 6c 7s]
Seat 1: v+QfkGiuj9bgtuNoVnDO8w folded before Flop (didn't bet)
Seat 2: UA5OsKS3VPaxa7uC8La/kA (button) folded on the Flop
Seat 4: uy9x0X5l7O+IpGjLa77QgQ (small blind) collected ($3.60)
Seat 5: lquriepNQBhDV5P1SWHhnA (big blind) folded before Flop
Seat 6: jp34e617tIzV8tKIWmfAbA folded before Flop (didn't bet)




PokerStars Game #59939656624:  Hold'em No Limit ($0.10/$0.25) - 2009/07/01 0:45:31 ET
Table 'Mef6A0EMopL6WaFO5/KO9g' 6-max Seat #1 is the button
Seat 1: ELW+DKizJhLK7k40PMkD2Q ($26.25 in chips) 
Seat 2: 8ClCHtFXGNplITm+63KB+Q ($32.35 in chips) 
Seat 3: Wq26opBLDGJe91GRJn2epg ($19.45 in chips) 
Seat 5: WrLI51S2iMb8GLMB83gGqA ($35.90 in chips) 
Seat 6: jp34e617tIzV8tKIWmfAbA ($25.35 in chips) 
8ClCHtFXGNplITm+63KB+Q: posts small blind $0.10
Wq26opBLDGJe91GRJn2epg: posts big blind $0.25
lquriepNQBhDV5P1SWHhnA: sits out 
*** HOLE CARDS ***
WrLI51S2iMb8GLMB83gGqA: folds 
jp34e617tIzV8tKIWmfAbA: folds 
ELW+DKizJhLK7k40PMkD2Q: folds 
8ClCHtFXGNplITm+63KB+Q: calls $0.15
Wq26opBLDGJe91GRJn2epg: checks 
*** FLOP *** [7h Jc 8h]
8ClCHtFXGNplITm+63KB+Q: bets $0.50
Wq26opBLDGJe91GRJn2epg: calls $0.50
*** TURN *** [7h Jc 8h] [Kd]
8ClCHtFXGNplITm+63KB+Q: checks 
Wq26opBLDGJe91GRJn2epg: bets $0.50
8ClCHtFXGNplITm+63KB+Q: folds 
Uncalled bet ($0.50) returned to Wq26opBLDGJe91GRJn2epg
Wq26opBLDGJe91GRJn2epg collected $1.45 from pot
Wq26opBLDGJe91GRJn2epg: doesn't show hand 
*** SUMMARY ***
Total pot $1.50 | Rake $0.05 
Board [7h Jc 8h Kd]
Seat 1: ELW+DKizJhLK7k40PMkD2Q (button) folded before Flop (didn't bet)
Seat 2: 8ClCHtFXGNplITm+63KB+Q (small blind) folded on the Turn
Seat 3: Wq26opBLDGJe91GRJn2epg (big blind) collected ($1.45)
Seat 5: WrLI51S2iMb8GLMB83gGqA folded before Flop (didn't bet)
Seat 6: jp34e617tIzV8tKIWmfAbA folded before Flop (didn't bet)




PokerStars Game #59939657526:  Hold'em No Limit ($0.10/$0.25) - 2009/07/01 0:45:32 ET
Table 'mk323gviqdkOY5Aek/1EWg' 6-max Seat #4 is the button
Seat 1: e8w9qW2QMnrAqkudVQoHoA ($36.20 in chips) 
Seat 2: GC/9yVD59DUCX7hUI7gcLw ($25 in chips) 
Seat 3: aSrj4lVmn2owyQ1RbbOqxQ ($23.05 in chips) 
Seat 4: o08wk0F4gROLhZS04Iyl3w ($25 in chips) 
Seat 5: SFmT9ZsVopnukjvAzrxTRg ($61.65 in chips) 
Seat 6: KkXSr5xFjxLSD3wtAvT+WQ ($18.95 in chips) 
SFmT9ZsVopnukjvAzrxTRg: posts small blind $0.10
KkXSr5xFjxLSD3wtAvT+WQ: posts big blind $0.25
*** HOLE CARDS ***
e8w9qW2QMnrAqkudVQoHoA: calls $0.25
GC/9yVD59DUCX7hUI7gcLw: folds 
aSrj4lVmn2owyQ1RbbOqxQ: folds 
o08wk0F4gROLhZS04Iyl3w: folds 
SFmT9ZsVopnukjvAzrxTRg: folds 
KkXSr5xFjxLSD3wtAvT+WQ: checks 
*** FLOP *** [9s Ac Tc]
KkXSr5xFjxLSD3wtAvT+WQ: checks 
e8w9qW2QMnrAqkudVQoHoA: checks 
*** TURN *** [9s Ac Tc] [7d]
KkXSr5xFjxLSD3wtAvT+WQ: bets $0.25
e8w9qW2QMnrAqkudVQoHoA: folds 
Uncalled bet ($0.25) returned to KkXSr5xFjxLSD3wtAvT+WQ
KkXSr5xFjxLSD3wtAvT+WQ collected $0.60 from pot
KkXSr5xFjxLSD3wtAvT+WQ: doesn't show hand 
*** SUMMARY ***
Total pot $0.60 | Rake $0 
Board [9s Ac Tc 7d]
Seat 1: e8w9qW2QMnrAqkudVQoHoA folded on the Turn
Seat 2: GC/9yVD59DUCX7hUI7gcLw folded before Flop (didn't bet)
Seat 3: aSrj4lVmn2owyQ1RbbOqxQ folded before Flop (didn't bet)
Seat 4: o08wk0F4gROLhZS04Iyl3w (button) folded before Flop (didn't bet)
Seat 5: SFmT9ZsVopnukjvAzrxTRg (small blind) folded before Flop
Seat 6: KkXSr5xFjxLSD3wtAvT+WQ (big blind) collected ($0.60)




PokerStars Game #59939657142:  Hold'em No Limit ($0.10/$0.25) - 2009/07/01 0:45:32 ET
Table 'KYX9dFNuOA9l2PV46IebqQ' 9-max Seat #5 is the button
Seat 1: s7Q6uNouhe7aE8JdFb9E+A ($27.40 in chips) 
Seat 3: f+H1PHwj9cNu4Y6FfvKwQQ ($29.35 in chips) 
Seat 4: SkLOm0UugROBRt2EfMpOxQ ($23.05 in chips) 
Seat 5: HQMjiff9S04k8kyC4fHVgw ($1.95 in chips) 
Seat 6: DiSvPC2iudwL5j9u6Huyww ($25.10 in chips) 
Seat 7: QOyn4M230Dsb5atoXgDy9A ($14.90 in chips) 
Seat 8: 4oA316mXLIui1QY63GXBUg ($25 in chips) 
Seat 9: W4TLQcZ2TiM73eIgpIvlGg ($34.90 in chips) 
DiSvPC2iudwL5j9u6Huyww: posts small blind $0.10
QOyn4M230Dsb5atoXgDy9A: posts big blind $0.25
MrPo4/ymXwg9lzPRybrXbA: sits out 
*** HOLE CARDS ***
4oA316mXLIui1QY63GXBUg: folds 
W4TLQcZ2TiM73eIgpIvlGg: folds 
s7Q6uNouhe7aE8JdFb9E+A: folds 
f+H1PHwj9cNu4Y6FfvKwQQ: folds 
SkLOm0UugROBRt2EfMpOxQ: folds 
HQMjiff9S04k8kyC4fHVgw: raises $0.25 to $0.50
DiSvPC2iudwL5j9u6Huyww: folds 
QOyn4M230Dsb5atoXgDy9A: calls $0.25
*** FLOP *** [Qs 3h 8d]
QOyn4M230Dsb5atoXgDy9A: checks 
HQMjiff9S04k8kyC4fHVgw: bets $0.75
QOyn4M230Dsb5atoXgDy9A: calls $0.75
*** TURN *** [Qs 3h 8d] [4s]
QOyn4M230Dsb5atoXgDy9A: checks 
HQMjiff9S04k8kyC4fHVgw: checks 
*** RIVER *** [Qs 3h 8d 4s] [7d]
QOyn4M230Dsb5atoXgDy9A: checks 
HQMjiff9S04k8kyC4fHVgw: bets $0.50
QOyn4M230Dsb5atoXgDy9A: calls $0.50
*** SHOW DOWN ***
HQMjiff9S04k8kyC4fHVgw: shows [Ac Js] (high card Ace)
QOyn4M230Dsb5atoXgDy9A: mucks hand 
HQMjiff9S04k8kyC4fHVgw collected $3.45 from pot
*** SUMMARY ***
Total pot $3.60 | Rake $0.15 
Board [Qs 3h 8d 4s 7d]
Seat 1: s7Q6uNouhe7aE8JdFb9E+A folded before Flop (didn't bet)
Seat 3: f+H1PHwj9cNu4Y6FfvKwQQ folded before Flop (didn't bet)
Seat 4: SkLOm0UugROBRt2EfMpOxQ folded before Flop (didn't bet)
Seat 5: HQMjiff9S04k8kyC4fHVgw (button) showed [Ac Js] and won ($3.45) with high card Ace
Seat 6: DiSvPC2iudwL5j9u6Huyww (small blind) folded before Flop
Seat 7: QOyn4M230Dsb5atoXgDy9A (big blind) mucked
Seat 8: 4oA316mXLIui1QY63GXBUg folded before Flop (didn't bet)
Seat 9: W4TLQcZ2TiM73eIgpIvlGg folded before Flop (didn't bet)




PokerStars Game #59939657398:  Hold'em No Limit ($0.10/$0.25) - 2009/07/01 0:45:32 ET
Table 'ThBZ355rqvsb8UGb6ajbig' 9-max Seat #2 is the button
Seat 2: 4awUyiDYTgylQKXZ9faBVA ($28.90 in chips) 
Seat 3: LBrhQVB4w41YNd7kMYn/og ($11.60 in chips) 
Seat 4: GFNwOPqg/Zu4ZuokgGADNQ ($13 in chips) 
Seat 5: BX9NgIrtlXh1K47KYMsMtQ ($9 in chips) 
Seat 6: qwr38jl5txoR36M7G5qi4A ($7.50 in chips) 
Seat 7: t2nb95S5EEFOEzNx9Itz0g ($12.45 in chips) 
Seat 8: 6REZ3fl3I5Kaxoupd8cnLg ($28.70 in chips) 
Seat 9: 8B/dhbQjIWe6ASCdgzktNQ ($38.50 in chips) 
LBrhQVB4w41YNd7kMYn/og: posts small blind $0.10
GFNwOPqg/Zu4ZuokgGADNQ: posts big blind $0.25
*** HOLE CARDS ***
BX9NgIrtlXh1K47KYMsMtQ: calls $0.25
qwr38jl5txoR36M7G5qi4A: folds 
t2nb95S5EEFOEzNx9Itz0g: folds 
6REZ3fl3I5Kaxoupd8cnLg: folds 
8B/dhbQjIWe6ASCdgzktNQ: folds 
4awUyiDYTgylQKXZ9faBVA: folds 
LBrhQVB4w41YNd7kMYn/og: calls $0.15
GFNwOPqg/Zu4ZuokgGADNQ: checks 
*** FLOP *** [7c 5d Ah]
TeWJxSETzbXGiYKx0y+dtg leaves the table
LBrhQVB4w41YNd7kMYn/og: checks 
GFNwOPqg/Zu4ZuokgGADNQ: checks 
BX9NgIrtlXh1K47KYMsMtQ: checks 
*** TURN *** [7c 5d Ah] [4d]
LBrhQVB4w41YNd7kMYn/og: bets $0.75
GFNwOPqg/Zu4ZuokgGADNQ: calls $0.75
BX9NgIrtlXh1K47KYMsMtQ: folds 
*** RIVER *** [7c 5d Ah 4d] [3d]
cZ99hugmLBj9KhTlc8nCSw joins the table at seat #1 
LBrhQVB4w41YNd7kMYn/og: checks 
GFNwOPqg/Zu4ZuokgGADNQ: bets $2
LBrhQVB4w41YNd7kMYn/og: calls $2
*** SHOW DOWN ***
GFNwOPqg/Zu4ZuokgGADNQ: shows [9d Qd] (a flush, Queen high)
LBrhQVB4w41YNd7kMYn/og: mucks hand 
GFNwOPqg/Zu4ZuokgGADNQ collected $5.95 from pot
*** SUMMARY ***
Total pot $6.25 | Rake $0.30 
Board [7c 5d Ah 4d 3d]
Seat 2: 4awUyiDYTgylQKXZ9faBVA (button) folded before Flop (didn't bet)
Seat 3: LBrhQVB4w41YNd7kMYn/og (small blind) mucked
Seat 4: GFNwOPqg/Zu4ZuokgGADNQ (big blind) showed [9d Qd] and won ($5.95) with a flush, Queen high
Seat 5: BX9NgIrtlXh1K47KYMsMtQ folded on the Turn
Seat 6: qwr38jl5txoR36M7G5qi4A folded before Flop (didn't bet)
Seat 7: t2nb95S5EEFOEzNx9Itz0g folded before Flop (didn't bet)
Seat 8: 6REZ3fl3I5Kaxoupd8cnLg folded before Flop (didn't bet)
Seat 9: 8B/dhbQjIWe6ASCdgzktNQ folded before Flop (didn't bet)




PokerStars Game #59939658136:  Hold'em No Limit ($0.10/$0.25) - 2009/07/01 0:45:33 ET
Table 'CBnRhp0d6E2+/NtM7Vbruw' 9-max Seat #2 is the button
Seat 1: WQe4GbiYBiPsb5WKFKkijQ ($10.85 in chips) 
Seat 2: DIBbjEYGs+TVdVgEB/4+3w ($35.55 in chips) 
Seat 3: aNpwfA31EREwO+ar4XzBCw ($27.10 in chips) 
Seat 4: FR1anYnrxOdUfdNDELZ4SQ ($19.35 in chips) 
Seat 5: R6nIVAjK7uhK3Hj0f85A+A ($26.90 in chips) 
Seat 6: PqvgxdSg9z5VmrWpbYuz+g ($22.95 in chips) 
Seat 8: MG90wfSJZnOejs/KD3vlQQ ($30.85 in chips) 
Seat 9: BHKu5wmAIC0UlfmA78se7A ($3.75 in chips) 
aNpwfA31EREwO+ar4XzBCw: posts small blind $0.10
FR1anYnrxOdUfdNDELZ4SQ: posts big blind $0.25
MrPo4/ymXwg9lzPRybrXbA: sits out 
*** HOLE CARDS ***
R6nIVAjK7uhK3Hj0f85A+A: folds 
PqvgxdSg9z5VmrWpbYuz+g: folds 
MG90wfSJZnOejs/KD3vlQQ: folds 
BHKu5wmAIC0UlfmA78se7A: folds 
WQe4GbiYBiPsb5WKFKkijQ: raises $0.25 to $0.50
DIBbjEYGs+TVdVgEB/4+3w: folds 
aNpwfA31EREwO+ar4XzBCw: folds 
FR1anYnrxOdUfdNDELZ4SQ: calls $0.25
*** FLOP *** [2d 6c Qd]
FR1anYnrxOdUfdNDELZ4SQ: checks 
WQe4GbiYBiPsb5WKFKkijQ: bets $0.50
FR1anYnrxOdUfdNDELZ4SQ: folds 
Uncalled bet ($0.50) returned to WQe4GbiYBiPsb5WKFKkijQ
WQe4GbiYBiPsb5WKFKkijQ collected $1.05 from pot
WQe4GbiYBiPsb5WKFKkijQ: doesn't show hand 
*** SUMMARY ***
Total pot $1.10 | Rake $0.05 
Board [2d 6c Qd]
Seat 1: WQe4GbiYBiPsb5WKFKkijQ collected ($1.05)
Seat 2: DIBbjEYGs+TVdVgEB/4+3w (button) folded before Flop (didn't bet)
Seat 3: aNpwfA31EREwO+ar4XzBCw (small blind) folded before Flop
Seat 4: FR1anYnrxOdUfdNDELZ4SQ (big blind) folded on the Flop
Seat 5: R6nIVAjK7uhK3Hj0f85A+A folded before Flop (didn't bet)
Seat 6: PqvgxdSg9z5VmrWpbYuz+g folded before Flop (didn't bet)
Seat 8: MG90wfSJZnOejs/KD3vlQQ folded before Flop (didn't bet)
Seat 9: BHKu5wmAIC0UlfmA78se7A folded before Flop (didn't bet)




PokerStars Game #59939658272:  Hold'em No Limit ($0.10/$0.25) - 2009/07/01 0:45:33 ET
Table 'mNBkqbHtjDvzF6YU0ixV9Q' 9-max Seat #1 is the button
Seat 1: QsLvCwfSWqP+CfjwUnjpXQ ($15 in chips) 
Seat 6: Zb8xGmbjS8ghABxs9n6huA ($13.50 in chips) 
QsLvCwfSWqP+CfjwUnjpXQ: posts small blind $0.10
Zb8xGmbjS8ghABxs9n6huA: posts big blind $0.25
*** HOLE CARDS ***
QsLvCwfSWqP+CfjwUnjpXQ: calls $0.15
Zb8xGmbjS8ghABxs9n6huA: checks 
*** FLOP *** [5h Tc Kc]
Zb8xGmbjS8ghABxs9n6huA: bets $0.50
QsLvCwfSWqP+CfjwUnjpXQ: calls $0.50
*** TURN *** [5h Tc Kc] [9c]
Zb8xGmbjS8ghABxs9n6huA: checks 
QsLvCwfSWqP+CfjwUnjpXQ: checks 
*** RIVER *** [5h Tc Kc 9c] [4h]
Zb8xGmbjS8ghABxs9n6huA: bets $1
QsLvCwfSWqP+CfjwUnjpXQ: calls $1
*** SHOW DOWN ***
Zb8xGmbjS8ghABxs9n6huA: shows [8h 2c] (high card King)
QsLvCwfSWqP+CfjwUnjpXQ: shows [Kd 3c] (a pair of Kings)
Zb8xGmbjS8ghABxs9n6huA is sitting out
Zb8xGmbjS8ghABxs9n6huA has returned
QsLvCwfSWqP+CfjwUnjpXQ collected $3.35 from pot
*** SUMMARY ***
Total pot $3.50 | Rake $0.15 
Board [5h Tc Kc 9c 4h]
Seat 1: QsLvCwfSWqP+CfjwUnjpXQ (button) (small blind) showed [Kd 3c] and won ($3.35) with a pair of Kings
Seat 6: Zb8xGmbjS8ghABxs9n6huA (big blind) showed [8h 2c] and lost with high card King




PokerStars Game #59939658150:  Hold'em No Limit ($0.10/$0.25) - 2009/07/01 0:45:33 ET
Table 'Yb2CyZosw7N3yRRVLhKnKg' 9-max Seat #3 is the button
Seat 1: lcT2xQLmuzNRe6+aWd6eww ($34.75 in chips) 
Seat 2: dmYlc+1cjwZMJ7wV+Z0rRg ($24.30 in chips) 
Seat 3: I8/fpJ2v6LsVf0kxqaVdMQ ($15.15 in chips) 
Seat 4: H5Se03ZqSX7tbULXur2MAg ($28.75 in chips) 
Seat 5: QUCO+kde5iROhmqVTzQ6KQ ($31.75 in chips) 
Seat 6: opOCI2p6kW0tINuVaAqmcQ ($28.60 in chips) 
Seat 7: OiV1PWZ3IkN29JlmCcnTwQ ($4.90 in chips) 
Seat 8: aJy680tKSaP5er559aSuGA ($22.15 in chips) 
Seat 9: ZUElLjBpTRwlrnB3Y2g8ew ($13.65 in chips) 
H5Se03ZqSX7tbULXur2MAg: posts small blind $0.10
QUCO+kde5iROhmqVTzQ6KQ: posts big blind $0.25
*** HOLE CARDS ***
lcT2xQLmuzNRe6+aWd6eww said, "well, what did u raise"
opOCI2p6kW0tINuVaAqmcQ: folds 
OiV1PWZ3IkN29JlmCcnTwQ: folds 
aJy680tKSaP5er559aSuGA: folds 
lcT2xQLmuzNRe6+aWd6eww said, "nothing, so shut up"
ZUElLjBpTRwlrnB3Y2g8ew: folds 
lcT2xQLmuzNRe6+aWd6eww: folds 
QUCO+kde5iROhmqVTzQ6KQ said, "u coulda just said thx..."
dmYlc+1cjwZMJ7wV+Z0rRg: raises $0.50 to $0.75
I8/fpJ2v6LsVf0kxqaVdMQ: folds 
H5Se03ZqSX7tbULXur2MAg: folds 
QUCO+kde5iROhmqVTzQ6KQ said, "i meant it as a compliment till u started acting like an a$$"
QUCO+kde5iROhmqVTzQ6KQ: calls $0.50
*** FLOP *** [5c 9s Qh]
QUCO+kde5iROhmqVTzQ6KQ: checks 
dmYlc+1cjwZMJ7wV+Z0rRg: bets $0.50
QUCO+kde5iROhmqVTzQ6KQ: calls $0.50
*** TURN *** [5c 9s Qh] [2h]
QUCO+kde5iROhmqVTzQ6KQ: checks 
lcT2xQLmuzNRe6+aWd6eww said, "then say nice hand not catch, donk"
dmYlc+1cjwZMJ7wV+Z0rRg: bets $1
QUCO+kde5iROhmqVTzQ6KQ: folds 
Uncalled bet ($1) returned to dmYlc+1cjwZMJ7wV+Z0rRg
dmYlc+1cjwZMJ7wV+Z0rRg collected $2.50 from pot
dmYlc+1cjwZMJ7wV+Z0rRg: doesn't show hand 
*** SUMMARY ***
Total pot $2.60 | Rake $0.10 
Board [5c 9s Qh 2h]
Seat 1: lcT2xQLmuzNRe6+aWd6eww folded before Flop (didn't bet)
Seat 2: dmYlc+1cjwZMJ7wV+Z0rRg collected ($2.50)
Seat 3: I8/fpJ2v6LsVf0kxqaVdMQ (button) folded before Flop (didn't bet)
Seat 4: H5Se03ZqSX7tbULXur2MAg (small blind) folded before Flop
Seat 5: QUCO+kde5iROhmqVTzQ6KQ (big blind) folded on the Turn
Seat 6: opOCI2p6kW0tINuVaAqmcQ folded before Flop (didn't bet)
Seat 7: OiV1PWZ3IkN29JlmCcnTwQ folded before Flop (didn't bet)
Seat 8: aJy680tKSaP5er559aSuGA folded before Flop (didn't bet)
Seat 9: ZUElLjBpTRwlrnB3Y2g8ew folded before Flop (didn't bet)




PokerStars Game #59939658280:  Hold'em No Limit ($0.10/$0.25) - 2009/07/01 0:45:33 ET
Table '63h13e5p7cWe02rClZ1CHw' 6-max Seat #4 is the button
Seat 1: 7VfhiFY533nbUKvyEthASw ($7.80 in chips) 
Seat 2: k9nHZTHt8hYhYRcW8NTb4g ($21 in chips) 
Seat 3: 9jSiy0meE9XJKkdIZwyTEQ ($34.25 in chips) 
Seat 4: myagrRAhs0mdgmh5GNqvCw ($3.50 in chips) 
Seat 5: bE34il0XYGjWPD5/vbkMaQ ($22.40 in chips) 
Seat 6: mfrkWA3PTeYPkbO6hi98Aw ($22.50 in chips) 
bE34il0XYGjWPD5/vbkMaQ: posts small blind $0.10
mfrkWA3PTeYPkbO6hi98Aw: posts big blind $0.25
*** HOLE CARDS ***
7VfhiFY533nbUKvyEthASw: folds 
k9nHZTHt8hYhYRcW8NTb4g: folds 
9jSiy0meE9XJKkdIZwyTEQ: folds 
myagrRAhs0mdgmh5GNqvCw: calls $0.25
bE34il0XYGjWPD5/vbkMaQ: calls $0.15
mfrkWA3PTeYPkbO6hi98Aw: checks 
*** FLOP *** [7d 9h 8c]
bE34il0XYGjWPD5/vbkMaQ: checks 
mfrkWA3PTeYPkbO6hi98Aw: checks 
myagrRAhs0mdgmh5GNqvCw: bets $0.75
bE34il0XYGjWPD5/vbkMaQ: folds 
mfrkWA3PTeYPkbO6hi98Aw: folds 
Uncalled bet ($0.75) returned to myagrRAhs0mdgmh5GNqvCw
myagrRAhs0mdgmh5GNqvCw collected $0.75 from pot
*** SUMMARY ***
Total pot $0.75 | Rake $0 
Board [7d 9h 8c]
Seat 1: 7VfhiFY533nbUKvyEthASw folded before Flop (didn't bet)
Seat 2: k9nHZTHt8hYhYRcW8NTb4g folded before Flop (didn't bet)
Seat 3: 9jSiy0meE9XJKkdIZwyTEQ folded before Flop (didn't bet)
Seat 4: myagrRAhs0mdgmh5GNqvCw (button) collected ($0.75)
Seat 5: bE34il0XYGjWPD5/vbkMaQ (small blind) folded on the Flop
Seat 6: mfrkWA3PTeYPkbO6hi98Aw (big blind) folded on the Flop




PokerStars Game #59939658080:  Hold'em No Limit ($0.10/$0.25) - 2009/07/01 0:45:33 ET
Table 'nlpa8xI95gAflovnFxB2yg' 6-max Seat #4 is the button
Seat 1: fZQg9veL7Dd/Z04ZTjC+wQ ($66.05 in chips) 
Seat 2: WrLI51S2iMb8GLMB83gGqA ($25 in chips) 
Seat 3: I1TxPvWj8NfG8orglCinNA ($26.40 in chips) 
Seat 4: 5xjU9nfIjn1MBxIJKZvS5w ($32.10 in chips) 
Seat 5: 6DwBRH+xZ12AAZmeAg+aXw ($25 in chips) 
Seat 6: FPlQHZog0ePFCETQ2KG4hQ ($25 in chips) 
6DwBRH+xZ12AAZmeAg+aXw: posts small blind $0.10
FPlQHZog0ePFCETQ2KG4hQ: posts big blind $0.25
*** HOLE CARDS ***
fZQg9veL7Dd/Z04ZTjC+wQ: folds 
WrLI51S2iMb8GLMB83gGqA: folds 
I1TxPvWj8NfG8orglCinNA: folds 
5xjU9nfIjn1MBxIJKZvS5w: folds 
6DwBRH+xZ12AAZmeAg+aXw: folds 
Uncalled bet ($0.15) returned to FPlQHZog0ePFCETQ2KG4hQ
FPlQHZog0ePFCETQ2KG4hQ collected $0.20 from pot
*** SUMMARY ***
Total pot $0.20 | Rake $0 
Seat 1: fZQg9veL7Dd/Z04ZTjC+wQ folded before Flop (didn't bet)
Seat 2: WrLI51S2iMb8GLMB83gGqA folded before Flop (didn't bet)
Seat 3: I1TxPvWj8NfG8orglCinNA folded before Flop (didn't bet)
Seat 4: 5xjU9nfIjn1MBxIJKZvS5w (button) folded before Flop (didn't bet)
Seat 5: 6DwBRH+xZ12AAZmeAg+aXw (small blind) folded before Flop
Seat 6: FPlQHZog0ePFCETQ2KG4hQ (big blind) collected ($0.20)




PokerStars Game #59939658362:  Hold'em No Limit ($0.10/$0.25) - 2009/07/01 0:45:33 ET
Table 'Xi38lWH8L2JHRAsKYVX8Qg' 6-max Seat #3 is the button
Seat 1: AqQ7DFpHkgIzTwDu+rClcg ($6.25 in chips) 
Seat 2: 7iL6KfkJTFbyWmnLYk4+AA ($30.75 in chips) 
Seat 3: 6DwBRH+xZ12AAZmeAg+aXw ($25 in chips) 
Seat 4: kG34n23qFQA3nzdOJTQ1dA ($25.55 in chips) 
Seat 5: 79ID/ub1Pt/mDpCprVmOoA ($26.10 in chips) 
Seat 6: aogAb4Eienxztk8p2v9VVw ($10.55 in chips) 
kG34n23qFQA3nzdOJTQ1dA: posts small blind $0.10
79ID/ub1Pt/mDpCprVmOoA: posts big blind $0.25
*** HOLE CARDS ***
aogAb4Eienxztk8p2v9VVw: raises $0.50 to $0.75
AqQ7DFpHkgIzTwDu+rClcg: folds 
7iL6KfkJTFbyWmnLYk4+AA: folds 
6DwBRH+xZ12AAZmeAg+aXw: folds 
kG34n23qFQA3nzdOJTQ1dA: folds 
79ID/ub1Pt/mDpCprVmOoA: folds 
Uncalled bet ($0.50) returned to aogAb4Eienxztk8p2v9VVw
aogAb4Eienxztk8p2v9VVw collected $0.60 from pot
aogAb4Eienxztk8p2v9VVw: doesn't show hand 
*** SUMMARY ***
Total pot $0.60 | Rake $0 
Seat 1: AqQ7DFpHkgIzTwDu+rClcg folded before Flop (didn't bet)
Seat 2: 7iL6KfkJTFbyWmnLYk4+AA folded before Flop (didn't bet)
Seat 3: 6DwBRH+xZ12AAZmeAg+aXw (button) folded before Flop (didn't bet)
Seat 4: kG34n23qFQA3nzdOJTQ1dA (small blind) folded before Flop
Seat 5: 79ID/ub1Pt/mDpCprVmOoA (big blind) folded before Flop
Seat 6: aogAb4Eienxztk8p2v9VVw collected ($0.60)




PokerStars Game #59939658008:  Hold'em No Limit ($0.10/$0.25) - 2009/07/01 0:45:33 ET
Table 'g6ryG70feTw9nNm+XJLuXw' 6-max Seat #2 is the button
Seat 1: v+QfkGiuj9bgtuNoVnDO8w ($26.40 in chips) 
Seat 2: SxIIgwXYLkwd6m3wLyPTCw ($27.05 in chips) 
Seat 3: /6h8PvAHQmfuMUZ8OUF6Xw ($19.40 in chips) 
Seat 4: GC/9yVD59DUCX7hUI7gcLw ($40.85 in chips) 
Seat 5: EE16Ua5b1HSsYej5zeXOlA ($29.30 in chips) 
/6h8PvAHQmfuMUZ8OUF6Xw: posts small blind $0.10
GC/9yVD59DUCX7hUI7gcLw: posts big blind $0.25
*** HOLE CARDS ***
EE16Ua5b1HSsYej5zeXOlA: folds 
v+QfkGiuj9bgtuNoVnDO8w: folds 
SxIIgwXYLkwd6m3wLyPTCw: raises $0.50 to $0.75
/6h8PvAHQmfuMUZ8OUF6Xw: calls $0.65
GC/9yVD59DUCX7hUI7gcLw: calls $0.50
*** FLOP *** [Jc Qc 2c]
/6h8PvAHQmfuMUZ8OUF6Xw: checks 
GC/9yVD59DUCX7hUI7gcLw: checks 
SxIIgwXYLkwd6m3wLyPTCw: bets $1.50
/6h8PvAHQmfuMUZ8OUF6Xw: folds 
GC/9yVD59DUCX7hUI7gcLw: folds 
Uncalled bet ($1.50) returned to SxIIgwXYLkwd6m3wLyPTCw
SxIIgwXYLkwd6m3wLyPTCw collected $2.15 from pot
SxIIgwXYLkwd6m3wLyPTCw: doesn't show hand 
*** SUMMARY ***
Total pot $2.25 | Rake $0.10 
Board [Jc Qc 2c]
Seat 1: v+QfkGiuj9bgtuNoVnDO8w folded before Flop (didn't bet)
Seat 2: SxIIgwXYLkwd6m3wLyPTCw (button) collected ($2.15)
Seat 3: /6h8PvAHQmfuMUZ8OUF6Xw (small blind) folded on the Flop
Seat 4: GC/9yVD59DUCX7hUI7gcLw (big blind) folded on the Flop
Seat 5: EE16Ua5b1HSsYej5zeXOlA folded before Flop (didn't bet)




PokerStars Game #59939657984:  Hold'em No Limit ($0.10/$0.25) - 2009/07/01 0:45:33 ET
Table 'gZetDqJh6q9A3mLO3ThCsAnc6OeGk/wtaWV+6N+kgnZQSeat #5 is the button
Seat 1: 1YCU970EVCcjs4GQP5Zt0g ($12.40 in chips) 
Seat 2: JFIAqU8lCZ0vWwEl4bdGsg ($25 in chips) 
Seat 4: eHsmIvAb2JREg4O6hNPnXg ($9.60 in chips) 
Seat 5: mfrkWA3PTeYPkbO6hi98Aw ($44.70 in chips) 
Seat 6: R1hR3/XSBdOHwcbSUJRJbg ($61.75 in chips) 
R1hR3/XSBdOHwcbSUJRJbg: posts small blind $0.10
1YCU970EVCcjs4GQP5Zt0g: posts big blind $0.25
jp34e617tIzV8tKIWmfAbA: sits out 
*** HOLE CARDS ***
JFIAqU8lCZ0vWwEl4bdGsg: folds 
eHsmIvAb2JREg4O6hNPnXg: folds 
mfrkWA3PTeYPkbO6hi98Aw: raises $0.75 to $1
R1hR3/XSBdOHwcbSUJRJbg: folds 
1YCU970EVCcjs4GQP5Zt0g: calls $0.75
*** FLOP *** [Kc 4d 6h]
1YCU970EVCcjs4GQP5Zt0g: checks 
mfrkWA3PTeYPkbO6hi98Aw: bets $1.50
1YCU970EVCcjs4GQP5Zt0g: folds 
Uncalled bet ($1.50) returned to mfrkWA3PTeYPkbO6hi98Aw
mfrkWA3PTeYPkbO6hi98Aw collected $2 from pot
mfrkWA3PTeYPkbO6hi98Aw: doesn't show hand 
*** SUMMARY ***
Total pot $2.10 | Rake $0.10 
Board [Kc 4d 6h]
Seat 1: 1YCU970EVCcjs4GQP5Zt0g (big blind) folded on the Flop
Seat 2: JFIAqU8lCZ0vWwEl4bdGsg folded before Flop (didn't bet)
Seat 4: eHsmIvAb2JREg4O6hNPnXg folded before Flop (didn't bet)
Seat 5: mfrkWA3PTeYPkbO6hi98Aw (button) collected ($2)
Seat 6: R1hR3/XSBdOHwcbSUJRJbg (small blind) folded before Flop




PokerStars Game #59939658638:  Hold'em No Limit ($0.10/$0.25) - 2009/07/01 0:45:34 ET
Table 'nQC9LRg01NEuKFHF1nrDEw0XPo7K54oZIfG0xlNAcDRw-max Seat #1 is the button
Seat 1: Nj6/PdBvfG79w0yeIjPmmA ($13.95 in chips) 
Seat 2: cPO/1/dTcZpLkQFm3jH3Rg ($31.95 in chips) 
Seat 3: 6+g0Lb6vfRDZkElV8ieHyQ ($29.95 in chips) 
Seat 5: kG34n23qFQA3nzdOJTQ1dA ($28.15 in chips) 
Seat 6: xQVFeVUDopz+akuEo2wXpQ ($45.40 in chips) 
cPO/1/dTcZpLkQFm3jH3Rg: posts small blind $0.10
6+g0Lb6vfRDZkElV8ieHyQ: posts big blind $0.25
*** HOLE CARDS ***
kG34n23qFQA3nzdOJTQ1dA: folds 
xQVFeVUDopz+akuEo2wXpQ: calls $0.25
Nj6/PdBvfG79w0yeIjPmmA: calls $0.25
cPO/1/dTcZpLkQFm3jH3Rg: raises $1.75 to $2
6+g0Lb6vfRDZkElV8ieHyQ: folds 
xQVFeVUDopz+akuEo2wXpQ: folds 
Nj6/PdBvfG79w0yeIjPmmA: folds 
Uncalled bet ($1.75) returned to cPO/1/dTcZpLkQFm3jH3Rg
tLM9aw7T3kBEIhQEh1roOg has returned
cPO/1/dTcZpLkQFm3jH3Rg collected $1 from pot
*** SUMMARY ***
Total pot $1 | Rake $0 
Seat 1: Nj6/PdBvfG79w0yeIjPmmA (button) folded before Flop
Seat 2: cPO/1/dTcZpLkQFm3jH3Rg (small blind) collected ($1)
Seat 3: 6+g0Lb6vfRDZkElV8ieHyQ (big blind) folded before Flop
Seat 5: kG34n23qFQA3nzdOJTQ1dA folded before Flop (didn't bet)
Seat 6: xQVFeVUDopz+akuEo2wXpQ folded before Flop




PokerStars Game #59939658400:  Hold'em No Limit ($0.10/$0.25) - 2009/07/01 0:45:34 ET
Table 'g+mPuNJBCHKE9ents7ZGtg' 6-max Seat #1 is the button
Seat 1: YaAEMJGY5tem39deCUQRNw ($24 in chips) 
Seat 2: fZQg9veL7Dd/Z04ZTjC+wQ ($30.45 in chips) 
Seat 3: 9jSiy0meE9XJKkdIZwyTEQ ($36.45 in chips) 
Seat 4: mfrkWA3PTeYPkbO6hi98Aw ($24.30 in chips) 
Seat 5: 32YL2ZEp8NT4JB2RVM9euQ ($15.65 in chips) 
Seat 6: MS2T205Bjud7PnNoANu4vQ ($45.95 in chips) 
fZQg9veL7Dd/Z04ZTjC+wQ: posts small blind $0.10
9jSiy0meE9XJKkdIZwyTEQ: posts big blind $0.25
*** HOLE CARDS ***
mfrkWA3PTeYPkbO6hi98Aw: raises $0.75 to $1
32YL2ZEp8NT4JB2RVM9euQ: folds 
MS2T205Bjud7PnNoANu4vQ: folds 
YaAEMJGY5tem39deCUQRNw: folds 
fZQg9veL7Dd/Z04ZTjC+wQ: folds 
9jSiy0meE9XJKkdIZwyTEQ: folds 
Uncalled bet ($0.75) returned to mfrkWA3PTeYPkbO6hi98Aw
mfrkWA3PTeYPkbO6hi98Aw collected $0.60 from pot
mfrkWA3PTeYPkbO6hi98Aw: doesn't show hand 
*** SUMMARY ***
Total pot $0.60 | Rake $0 
Seat 1: YaAEMJGY5tem39deCUQRNw (button) folded before Flop (didn't bet)
Seat 2: fZQg9veL7Dd/Z04ZTjC+wQ (small blind) folded before Flop
Seat 3: 9jSiy0meE9XJKkdIZwyTEQ (big blind) folded before Flop
Seat 4: mfrkWA3PTeYPkbO6hi98Aw collected ($0.60)
Seat 5: 32YL2ZEp8NT4JB2RVM9euQ folded before Flop (didn't bet)
Seat 6: MS2T205Bjud7PnNoANu4vQ folded before Flop (didn't bet)




PokerStars Game #59939658600:  Hold'em No Limit ($0.10/$0.25) - 2009/07/01 0:45:34 ET
Table 'a0kk1yz54EMczhut3KjrxQ' 6-max Seat #3 is the button
Seat 1: V3LJvbHVJHmOj2fd7zIDhA ($29.95 in chips) 
Seat 2: nc79pm0LZRdhncq55evVqA ($25 in chips) 
Seat 3: FabaCGPqGJLjRL48CMvjiQ ($19.95 in chips) 
Seat 4: FYepjhAvF8ZdVCmqHIy+eQ ($28.30 in chips) 
Seat 5: cPO/1/dTcZpLkQFm3jH3Rg ($27.75 in chips) 
Seat 6: DTzxFTXVrCqrpjq9B9Vg/g ($15 in chips) 
FYepjhAvF8ZdVCmqHIy+eQ: posts small blind $0.10
cPO/1/dTcZpLkQFm3jH3Rg: posts big blind $0.25
*** HOLE CARDS ***
DTzxFTXVrCqrpjq9B9Vg/g: calls $0.25
V3LJvbHVJHmOj2fd7zIDhA: folds 
nc79pm0LZRdhncq55evVqA: folds 
FabaCGPqGJLjRL48CMvjiQ: folds 
FYepjhAvF8ZdVCmqHIy+eQ: folds 
cPO/1/dTcZpLkQFm3jH3Rg: checks 
*** FLOP *** [9s 2h Js]
cPO/1/dTcZpLkQFm3jH3Rg: checks 
DTzxFTXVrCqrpjq9B9Vg/g: bets $1.50
cPO/1/dTcZpLkQFm3jH3Rg: folds 
Uncalled bet ($1.50) returned to DTzxFTXVrCqrpjq9B9Vg/g
DTzxFTXVrCqrpjq9B9Vg/g collected $0.60 from pot
*** SUMMARY ***
Total pot $0.60 | Rake $0 
Board [9s 2h Js]
Seat 1: V3LJvbHVJHmOj2fd7zIDhA folded before Flop (didn't bet)
Seat 2: nc79pm0LZRdhncq55evVqA folded before Flop (didn't bet)
Seat 3: FabaCGPqGJLjRL48CMvjiQ (button) folded before Flop (didn't bet)
Seat 4: FYepjhAvF8ZdVCmqHIy+eQ (small blind) folded before Flop
Seat 5: cPO/1/dTcZpLkQFm3jH3Rg (big blind) folded on the Flop
Seat 6: DTzxFTXVrCqrpjq9B9Vg/g collected ($0.60)




PokerStars Game #59939658584:  Hold'em No Limit ($0.10/$0.25) - 2009/07/01 0:45:34 ET
Table 'nteM56rtr9SxLEblf0fvbw' 9-max Seat #7 is the button
Seat 1: H9KUl8cmpLgEpOVDA00bCg ($9.65 in chips) 
Seat 2: ljemhp25Zg+nlA9DLCIiUw ($25.20 in chips) 
Seat 4: cZ99hugmLBj9KhTlc8nCSw ($25.15 in chips) 
Seat 5: aJy680tKSaP5er559aSuGA ($5.20 in chips) 
Seat 6: LH8Esb23EO9V9GrKx+ymWQ ($5.80 in chips) 
Seat 7: dfNim92Z6XK1/h5SFW5vDg ($49.30 in chips) 
Seat 8: RJ/x9oZtt1RZLaJEQwZOxQ ($44.15 in chips) 
Seat 9: t2nb95S5EEFOEzNx9Itz0g ($6.55 in chips) 
RJ/x9oZtt1RZLaJEQwZOxQ: posts small blind $0.10
t2nb95S5EEFOEzNx9Itz0g: posts big blind $0.25
6RiVTYll/5D8zICp0MRpKw: sits out 
*** HOLE CARDS ***
H9KUl8cmpLgEpOVDA00bCg: folds 
ljemhp25Zg+nlA9DLCIiUw: folds 
cZ99hugmLBj9KhTlc8nCSw: folds 
aJy680tKSaP5er559aSuGA: folds 
LH8Esb23EO9V9GrKx+ymWQ: calls $0.25
dfNim92Z6XK1/h5SFW5vDg: calls $0.25
RJ/x9oZtt1RZLaJEQwZOxQ: calls $0.15
t2nb95S5EEFOEzNx9Itz0g: checks 
*** FLOP *** [5s Ah As]
RJ/x9oZtt1RZLaJEQwZOxQ: checks 
t2nb95S5EEFOEzNx9Itz0g: checks 
LH8Esb23EO9V9GrKx+ymWQ: checks 
dfNim92Z6XK1/h5SFW5vDg: checks 
*** TURN *** [5s Ah As] [Tc]
RJ/x9oZtt1RZLaJEQwZOxQ: checks 
t2nb95S5EEFOEzNx9Itz0g: checks 
LH8Esb23EO9V9GrKx+ymWQ: bets $0.50
dfNim92Z6XK1/h5SFW5vDg: folds 
RJ/x9oZtt1RZLaJEQwZOxQ: folds 
t2nb95S5EEFOEzNx9Itz0g: folds 
Uncalled bet ($0.50) returned to LH8Esb23EO9V9GrKx+ymWQ
LH8Esb23EO9V9GrKx+ymWQ collected $0.95 from pot
*** SUMMARY ***
Total pot $1 | Rake $0.05 
Board [5s Ah As Tc]
Seat 1: H9KUl8cmpLgEpOVDA00bCg folded before Flop (didn't bet)
Seat 2: ljemhp25Zg+nlA9DLCIiUw folded before Flop (didn't bet)
Seat 4: cZ99hugmLBj9KhTlc8nCSw folded before Flop (didn't bet)
Seat 5: aJy680tKSaP5er559aSuGA folded before Flop (didn't bet)
Seat 6: LH8Esb23EO9V9GrKx+ymWQ collected ($0.95)
Seat 7: dfNim92Z6XK1/h5SFW5vDg (button) folded on the Turn
Seat 8: RJ/x9oZtt1RZLaJEQwZOxQ (small blind) folded on the Turn
Seat 9: t2nb95S5EEFOEzNx9Itz0g (big blind) folded on the Turn




PokerStars Game #59939658910:  Hold'em No Limit ($0.10/$0.25) - 2009/07/01 0:45:34 ET
Table '9L7XfAwuM7XsXE8LIg2o5Q' 6-max Seat #6 is the button
Seat 1: H6XbZVba2aKDXlG0la0uow ($6.50 in chips) 
Seat 2: oseFhpinoe+Zg4j5xyBjyQ ($16.95 in chips) 
Seat 4: jp34e617tIzV8tKIWmfAbA ($26.05 in chips) 
Seat 6: k9nHZTHt8hYhYRcW8NTb4g ($28.20 in chips) 
H6XbZVba2aKDXlG0la0uow: posts small blind $0.10
oseFhpinoe+Zg4j5xyBjyQ: posts big blind $0.25
*** HOLE CARDS ***
jp34e617tIzV8tKIWmfAbA: raises $0.50 to $0.75
k9nHZTHt8hYhYRcW8NTb4g: folds 
H6XbZVba2aKDXlG0la0uow: folds 
JRODJ0tkruzJ7hwOFO9ogg joins the table at seat #3 
OUv909q/YxsJgxpSlZxLJQ joins the table at seat #5 
oseFhpinoe+Zg4j5xyBjyQ: folds 
Uncalled bet ($0.50) returned to jp34e617tIzV8tKIWmfAbA
jp34e617tIzV8tKIWmfAbA collected $0.60 from pot
jp34e617tIzV8tKIWmfAbA: doesn't show hand 
*** SUMMARY ***
Total pot $0.60 | Rake $0 
Seat 1: H6XbZVba2aKDXlG0la0uow (small blind) folded before Flop
Seat 2: oseFhpinoe+Zg4j5xyBjyQ (big blind) folded before Flop
Seat 4: jp34e617tIzV8tKIWmfAbA collected ($0.60)
Seat 6: k9nHZTHt8hYhYRcW8NTb4g (button) folded before Flop (didn't bet)




PokerStars Game #59939659564:  Hold'em No Limit ($0.10/$0.25) - 2009/07/01 0:45:35 ET
Table 'rtxA1Y01Nrq5VoyzTAuusQ' 9-max Seat #2 is the button
Seat 1: gAlaEiNZy/H/QuIVwzvHAQ ($13.05 in chips) 
Seat 2: xtpoxBFB+5CWL2iFqk9Zlg ($34.90 in chips) 
Seat 3: K9fS1IUr5GpiJG7VkJ7IbA ($34.65 in chips) 
Seat 5: HG/hVrkvCiG0erBa6RyLZA ($12.90 in chips) 
Seat 6: qccGLncfUaN00Few5HsgYg ($23.05 in chips) 
Seat 7: N6fYvIzQLKaydFLKQGtMlQ ($21.30 in chips) 
Seat 8: EUSBQy2KGzT65/CXiIu59Q ($31.70 in chips) 
Seat 9: HPEB+AtKw1+C/cxU0o1ciw ($24.25 in chips) 
K9fS1IUr5GpiJG7VkJ7IbA: posts small blind $0.10
HG/hVrkvCiG0erBa6RyLZA: posts big blind $0.25
gAlaEiNZy/H/QuIVwzvHAQ: posts big blind $0.25
*** HOLE CARDS ***
qccGLncfUaN00Few5HsgYg: folds 
I.O.S. leaves the table
N6fYvIzQLKaydFLKQGtMlQ: folds 
lTfGgdGMRH+DZcKby2m9Nw joins the table at seat #4 
EUSBQy2KGzT65/CXiIu59Q: folds 
HPEB+AtKw1+C/cxU0o1ciw: folds 
gAlaEiNZy/H/QuIVwzvHAQ: checks 
xtpoxBFB+5CWL2iFqk9Zlg: folds 
K9fS1IUr5GpiJG7VkJ7IbA: calls $0.15
HG/hVrkvCiG0erBa6RyLZA: checks 
*** FLOP *** [5s 4s 9d]
K9fS1IUr5GpiJG7VkJ7IbA: checks 
HG/hVrkvCiG0erBa6RyLZA: checks 
gAlaEiNZy/H/QuIVwzvHAQ: checks 
*** TURN *** [5s 4s 9d] [Tc]
K9fS1IUr5GpiJG7VkJ7IbA: bets $0.25
HG/hVrkvCiG0erBa6RyLZA: folds 
gAlaEiNZy/H/QuIVwzvHAQ: calls $0.25
*** RIVER *** [5s 4s 9d Tc] [5d]
K9fS1IUr5GpiJG7VkJ7IbA: bets $0.75
gAlaEiNZy/H/QuIVwzvHAQ: raises $1.25 to $2
K9fS1IUr5GpiJG7VkJ7IbA: raises $5 to $7
gAlaEiNZy/H/QuIVwzvHAQ: folds 
Uncalled bet ($5) returned to K9fS1IUr5GpiJG7VkJ7IbA
K9fS1IUr5GpiJG7VkJ7IbA collected $5 from pot
*** SUMMARY ***
Total pot $5.25 | Rake $0.25 
Board [5s 4s 9d Tc 5d]
Seat 1: gAlaEiNZy/H/QuIVwzvHAQ folded on the River
Seat 2: xtpoxBFB+5CWL2iFqk9Zlg (button) folded before Flop (didn't bet)
Seat 3: K9fS1IUr5GpiJG7VkJ7IbA (small blind) collected ($5)
Seat 5: HG/hVrkvCiG0erBa6RyLZA (big blind) folded on the Turn
Seat 6: qccGLncfUaN00Few5HsgYg folded before Flop (didn't bet)
Seat 7: N6fYvIzQLKaydFLKQGtMlQ folded before Flop (didn't bet)
Seat 8: EUSBQy2KGzT65/CXiIu59Q folded before Flop (didn't bet)
Seat 9: HPEB+AtKw1+C/cxU0o1ciw folded before Flop (didn't bet)




PokerStars Game #59939659578:  Hold'em No Limit ($0.10/$0.25) - 2009/07/01 0:45:35 ET
Table 'Zi9/NqNs3XoL1eWhMCyZyg' 9-max Seat #2 is the button
Seat 1: opOCI2p6kW0tINuVaAqmcQ ($25 in chips) 
Seat 2: Th3FldXKQW6hWVVPahaoOQ ($30.70 in chips) 
Seat 3: rUpvA02nErFvZ4yFbDR8XA ($22 in chips) 
Seat 4: D3XCkXRktDfPlSguxwfnRA ($12.75 in chips) 
Seat 5: OiV1PWZ3IkN29JlmCcnTwQ ($5 in chips) 
Seat 6: b3P5tPsBbrP+aAO9+Ts/Nw ($37.10 in chips) 
Seat 7: qul+IMROTuFj45eWi2Tpvg ($54.90 in chips) 
Seat 9: tYsOBqdU1+x+yFI7zHO7hQ ($30.75 in chips) 
rUpvA02nErFvZ4yFbDR8XA: posts small blind $0.10
D3XCkXRktDfPlSguxwfnRA: posts big blind $0.25
MrPo4/ymXwg9lzPRybrXbA: sits out 
*** HOLE CARDS ***
OiV1PWZ3IkN29JlmCcnTwQ: folds 
b3P5tPsBbrP+aAO9+Ts/Nw: folds 
qul+IMROTuFj45eWi2Tpvg: folds 
tYsOBqdU1+x+yFI7zHO7hQ: folds 
opOCI2p6kW0tINuVaAqmcQ: folds 
Th3FldXKQW6hWVVPahaoOQ: folds 
rUpvA02nErFvZ4yFbDR8XA: calls $0.15
D3XCkXRktDfPlSguxwfnRA: checks 
*** FLOP *** [5c 7s Kh]
rUpvA02nErFvZ4yFbDR8XA: bets $0.25
D3XCkXRktDfPlSguxwfnRA: raises $0.25 to $0.50
rUpvA02nErFvZ4yFbDR8XA: raises $0.75 to $1.25
D3XCkXRktDfPlSguxwfnRA: calls $0.75
*** TURN *** [5c 7s Kh] [Tc]
rUpvA02nErFvZ4yFbDR8XA: bets $2.25
D3XCkXRktDfPlSguxwfnRA: calls $2.25
*** RIVER *** [5c 7s Kh Tc] [5d]
rUpvA02nErFvZ4yFbDR8XA: bets $3
D3XCkXRktDfPlSguxwfnRA: calls $3
*** SHOW DOWN ***
rUpvA02nErFvZ4yFbDR8XA: shows [7c Kc] (two pair, Kings and Sevens)
D3XCkXRktDfPlSguxwfnRA: mucks hand 
rUpvA02nErFvZ4yFbDR8XA collected $12.85 from pot
*** SUMMARY ***
Total pot $13.50 | Rake $0.65 
Board [5c 7s Kh Tc 5d]
Seat 1: opOCI2p6kW0tINuVaAqmcQ folded before Flop (didn't bet)
Seat 2: Th3FldXKQW6hWVVPahaoOQ (button) folded before Flop (didn't bet)
Seat 3: rUpvA02nErFvZ4yFbDR8XA (small blind) showed [7c Kc] and won ($12.85) with two pair, Kings and Sevens
Seat 4: D3XCkXRktDfPlSguxwfnRA (big blind) mucked
Seat 5: OiV1PWZ3IkN29JlmCcnTwQ folded before Flop (didn't bet)
Seat 6: b3P5tPsBbrP+aAO9+Ts/Nw folded before Flop (didn't bet)
Seat 7: qul+IMROTuFj45eWi2Tpvg folded before Flop (didn't bet)
Seat 9: tYsOBqdU1+x+yFI7zHO7hQ folded before Flop (didn't bet)




PokerStars Game #59939659540:  Hold'em No Limit ($0.10/$0.25) - 2009/07/01 0:45:35 ET
Table '3760QYRYyCWeXf0rLZ5S2g' 9-max Seat #2 is the button
Seat 2: zDrucyjVn5aeekNEc3cJrA ($20.45 in chips) 
zDrucyjVn5aeekNEc3cJrA: posts small blind $0.10
MG90wfSJZnOejs/KD3vlQQ: is sitting out 
Hand cancelled
*** SUMMARY ***
Seat 2: zDrucyjVn5aeekNEc3cJrA (button) collected ($0)




PokerStars Game #59939659268:  Hold'em No Limit ($0.10/$0.25) - 2009/07/01 0:45:35 ET
Table 'KAnP7XvDtlku47YfJwdOVw' 9-max Seat #3 is the button
Seat 1: sJNHTWcSlLHRCZ9+YRLLqA ($25 in chips) 
Seat 2: CYkY0dNBaYaKs8HVCVn3mQ ($5 in chips) 
Seat 3: 7qgCOBwxmRRmkppeMkqy0Q ($5.65 in chips) 
Seat 4: E2OrwPLjPzZjbllMp2olEw ($16.90 in chips) 
Seat 5: MG90wfSJZnOejs/KD3vlQQ ($31.20 in chips) 
Seat 6: z5GxcHlYz/GSz6W2uFiTtg ($24.95 in chips) 
Seat 7: Lro4e37x4FUa5P3yzDjskw ($9.90 in chips) 
Seat 8: 3fPCxL5JUJVUL3eETYhxQQ ($8.75 in chips) 
Seat 9: qwr38jl5txoR36M7G5qi4A ($18.20 in chips) 
E2OrwPLjPzZjbllMp2olEw: posts small blind $0.10
MG90wfSJZnOejs/KD3vlQQ: posts big blind $0.25
*** HOLE CARDS ***
z5GxcHlYz/GSz6W2uFiTtg: calls $0.25
Lro4e37x4FUa5P3yzDjskw: folds 
3fPCxL5JUJVUL3eETYhxQQ: calls $0.25
qwr38jl5txoR36M7G5qi4A: folds 
sJNHTWcSlLHRCZ9+YRLLqA: calls $0.25
CYkY0dNBaYaKs8HVCVn3mQ: raises $4.75 to $5 and is all-in
7qgCOBwxmRRmkppeMkqy0Q: raises $0.65 to $5.65 and is all-in
E2OrwPLjPzZjbllMp2olEw: folds 
MG90wfSJZnOejs/KD3vlQQ: folds 
z5GxcHlYz/GSz6W2uFiTtg: folds 
3fPCxL5JUJVUL3eETYhxQQ: calls $5.40
sJNHTWcSlLHRCZ9+YRLLqA: folds 
*** FLOP *** [4c Ad Js]
*** TURN *** [4c Ad Js] [Ks]
*** RIVER *** [4c Ad Js Ks] [Jd]
*** SHOW DOWN ***
3fPCxL5JUJVUL3eETYhxQQ: shows [Kd Ts] (two pair, Kings and Jacks)
7qgCOBwxmRRmkppeMkqy0Q: shows [Kh Jh] (a full house, Jacks full of Kings)
7qgCOBwxmRRmkppeMkqy0Q collected $1.20 from side pot
CYkY0dNBaYaKs8HVCVn3mQ: shows [As Ac] (a full house, Aces full of Jacks)
CYkY0dNBaYaKs8HVCVn3mQ collected $15.10 from main pot
*** SUMMARY ***
Total pot $17.15 Main pot $15.10. Side pot $1.20. | Rake $0.85 
Board [4c Ad Js Ks Jd]
Seat 1: sJNHTWcSlLHRCZ9+YRLLqA folded before Flop
Seat 2: CYkY0dNBaYaKs8HVCVn3mQ showed [As Ac] and won ($15.10) with a full house, Aces full of Jacks
Seat 3: 7qgCOBwxmRRmkppeMkqy0Q (button) showed [Kh Jh] and won ($1.20) with a full house, Jacks full of Kings
Seat 4: E2OrwPLjPzZjbllMp2olEw (small blind) folded before Flop
Seat 5: MG90wfSJZnOejs/KD3vlQQ (big blind) folded before Flop
Seat 6: z5GxcHlYz/GSz6W2uFiTtg folded before Flop
Seat 7: Lro4e37x4FUa5P3yzDjskw folded before Flop (didn't bet)
Seat 8: 3fPCxL5JUJVUL3eETYhxQQ showed [Kd Ts] and lost with two pair, Kings and Jacks
Seat 9: qwr38jl5txoR36M7G5qi4A folded before Flop (didn't bet)




PokerStars Game #59939659538:  Hold'em No Limit ($0.10/$0.25) - 2009/07/01 0:45:35 ET
Table 'NgexmgEDEzICBeSO7YCrKQ' 6-max Seat #6 is the button
Seat 1: oseFhpinoe+Zg4j5xyBjyQ ($70.85 in chips) 
Seat 2: 32YL2ZEp8NT4JB2RVM9euQ ($15.65 in chips) 
Seat 3: JFIAqU8lCZ0vWwEl4bdGsg ($26.55 in chips) 
Seat 4: xx+iYCDJhHJmNzrfeloyEg ($38.60 in chips) 
Seat 5: /MXkdT8TTs8Qp2LVTQNw6w ($46.55 in chips) 
Seat 6: k9nHZTHt8hYhYRcW8NTb4g ($9.90 in chips) 
oseFhpinoe+Zg4j5xyBjyQ: posts small blind $0.10
32YL2ZEp8NT4JB2RVM9euQ: posts big blind $0.25
*** HOLE CARDS ***
JFIAqU8lCZ0vWwEl4bdGsg: folds 
xx+iYCDJhHJmNzrfeloyEg: folds 
/MXkdT8TTs8Qp2LVTQNw6w: raises $0.50 to $0.75
k9nHZTHt8hYhYRcW8NTb4g: folds 
oseFhpinoe+Zg4j5xyBjyQ: folds 
32YL2ZEp8NT4JB2RVM9euQ: folds 
Uncalled bet ($0.50) returned to /MXkdT8TTs8Qp2LVTQNw6w
/MXkdT8TTs8Qp2LVTQNw6w collected $0.60 from pot
/MXkdT8TTs8Qp2LVTQNw6w: doesn't show hand 
/MXkdT8TTs8Qp2LVTQNw6w said, "pah!"
*** SUMMARY ***
Total pot $0.60 | Rake $0 
Seat 1: oseFhpinoe+Zg4j5xyBjyQ (small blind) folded before Flop
Seat 2: 32YL2ZEp8NT4JB2RVM9euQ (big blind) folded before Flop
Seat 3: JFIAqU8lCZ0vWwEl4bdGsg folded before Flop (didn't bet)
Seat 4: xx+iYCDJhHJmNzrfeloyEg folded before Flop (didn't bet)
Seat 5: /MXkdT8TTs8Qp2LVTQNw6w collected ($0.60)
Seat 6: k9nHZTHt8hYhYRcW8NTb4g (button) folded before Flop (didn't bet)




PokerStars Game #59939659572:  Hold'em No Limit ($0.10/$0.25) - 2009/07/01 0:45:35 ET
Table 'ER5H84HUgJx7HyDLnELLeA' 6-max Seat #1 is the button
Seat 1: pjM/xh4+RG8zrxCobDgYDg ($16.70 in chips) 
Seat 2: nc79pm0LZRdhncq55evVqA ($48.25 in chips) 
Seat 3: BYxjLnV1/LL0aZcTbfAOvw ($25 in chips) 
Seat 4: tkRWn3WaJIfGmCXT2hPvJA ($19.15 in chips) 
Seat 5: mfrkWA3PTeYPkbO6hi98Aw ($24.90 in chips) 
Seat 6: 3zD3qLXT1bEffAoWGnc7wg ($30.85 in chips) 
nc79pm0LZRdhncq55evVqA: posts small blind $0.10
BYxjLnV1/LL0aZcTbfAOvw: posts big blind $0.25
*** HOLE CARDS ***
tkRWn3WaJIfGmCXT2hPvJA: folds 
mfrkWA3PTeYPkbO6hi98Aw: folds 
3zD3qLXT1bEffAoWGnc7wg: folds 
pjM/xh4+RG8zrxCobDgYDg: folds 
nc79pm0LZRdhncq55evVqA: folds 
Uncalled bet ($0.15) returned to BYxjLnV1/LL0aZcTbfAOvw
BYxjLnV1/LL0aZcTbfAOvw collected $0.20 from pot
BYxjLnV1/LL0aZcTbfAOvw: doesn't show hand 
*** SUMMARY ***
Total pot $0.20 | Rake $0 
Seat 1: pjM/xh4+RG8zrxCobDgYDg (button) folded before Flop (didn't bet)
Seat 2: nc79pm0LZRdhncq55evVqA (small blind) folded before Flop
Seat 3: BYxjLnV1/LL0aZcTbfAOvw (big blind) collected ($0.20)
Seat 4: tkRWn3WaJIfGmCXT2hPvJA folded before Flop (didn't bet)
Seat 5: mfrkWA3PTeYPkbO6hi98Aw folded before Flop (didn't bet)
Seat 6: 3zD3qLXT1bEffAoWGnc7wg folded before Flop (didn't bet)




PokerStars Game #59939659464:  Hold'em No Limit ($0.10/$0.25) - 2009/07/01 0:45:35 ET
Table 'oJpFwZj9+FUGHX90Un8s9Q' 6-max Seat #3 is the button
Seat 1: 6DwBRH+xZ12AAZmeAg+aXw ($25.25 in chips) 
Seat 2: IMmIhmfU3tqkaJABnD21Rg ($16.30 in chips) 
Seat 3: kyRaCIljYA6l33lSKQfNsg ($27.80 in chips) 
Seat 4: IX/nJvz3Mx/Ez6DgueFA4Q ($7.95 in chips) 
Seat 5: kG34n23qFQA3nzdOJTQ1dA ($24.65 in chips) 
Seat 6: Zijzy/UtPWzWVUo81HHVjQ ($40.45 in chips) 
IX/nJvz3Mx/Ez6DgueFA4Q: posts small blind $0.10
kG34n23qFQA3nzdOJTQ1dA: posts big blind $0.25
*** HOLE CARDS ***
IX/nJvz3Mx/Ez6DgueFA4Q said, "or more correctly lucky king"
Zijzy/UtPWzWVUo81HHVjQ: folds 
6DwBRH+xZ12AAZmeAg+aXw: raises $0.50 to $0.75
IMmIhmfU3tqkaJABnD21Rg: folds 
kyRaCIljYA6l33lSKQfNsg: folds 
IX/nJvz3Mx/Ez6DgueFA4Q: folds 
kG34n23qFQA3nzdOJTQ1dA: folds 
Uncalled bet ($0.50) returned to 6DwBRH+xZ12AAZmeAg+aXw
6DwBRH+xZ12AAZmeAg+aXw collected $0.60 from pot
6DwBRH+xZ12AAZmeAg+aXw: doesn't show hand 
*** SUMMARY ***
Total pot $0.60 | Rake $0 
Seat 1: 6DwBRH+xZ12AAZmeAg+aXw collected ($0.60)
Seat 2: IMmIhmfU3tqkaJABnD21Rg folded before Flop (didn't bet)
Seat 3: kyRaCIljYA6l33lSKQfNsg (button) folded before Flop (didn't bet)
Seat 4: IX/nJvz3Mx/Ez6DgueFA4Q (small blind) folded before Flop
Seat 5: kG34n23qFQA3nzdOJTQ1dA (big blind) folded before Flop
Seat 6: Zijzy/UtPWzWVUo81HHVjQ folded before Flop (didn't bet)




PokerStars Game #59939659594:  Hold'em No Limit ($0.10/$0.25) - 2009/07/01 0:45:35 ET
Table 'rO1I30HnuCPB0M8qEX1TCQ' 9-max Seat #8 is the button
Seat 4: spidnpwmoJ1L6yeNW7D5UA ($40.15 in chips) 
Seat 5: HVKi9hnDyvzObpL08/OarQ ($24.40 in chips) 
Seat 6: vO3QVRovWemcGMkm7ijAIA ($3.75 in chips) 
Seat 7: 4oA316mXLIui1QY63GXBUg ($30.25 in chips) 
Seat 8: DIBbjEYGs+TVdVgEB/4+3w ($36.50 in chips) 
Seat 9: PrviAnKmKklf+We6cR33cw ($31.90 in chips) 
PrviAnKmKklf+We6cR33cw: posts small blind $0.10
33y9+GmQ3J84RvZXcraRTw: is sitting out 
spidnpwmoJ1L6yeNW7D5UA: posts big blind $0.25
*** HOLE CARDS ***
HVKi9hnDyvzObpL08/OarQ: folds 
vO3QVRovWemcGMkm7ijAIA: folds 
4oA316mXLIui1QY63GXBUg: folds 
DIBbjEYGs+TVdVgEB/4+3w: folds 
PrviAnKmKklf+We6cR33cw: calls $0.15
spidnpwmoJ1L6yeNW7D5UA: checks 
*** FLOP *** [7c 7h Jh]
PrviAnKmKklf+We6cR33cw: checks 
spidnpwmoJ1L6yeNW7D5UA: bets $0.50
PrviAnKmKklf+We6cR33cw: raises $0.75 to $1.25
spidnpwmoJ1L6yeNW7D5UA: calls $0.75
*** TURN *** [7c 7h Jh] [9h]
PrviAnKmKklf+We6cR33cw: checks 
spidnpwmoJ1L6yeNW7D5UA: bets $0.75
PrviAnKmKklf+We6cR33cw: calls $0.75
*** RIVER *** [7c 7h Jh 9h] [3h]
r6hk+kJqlyUpcApRLTHqnQ joins the table at seat #3 
PrviAnKmKklf+We6cR33cw: checks 
spidnpwmoJ1L6yeNW7D5UA: checks 
*** SHOW DOWN ***
PrviAnKmKklf+We6cR33cw: shows [6s Jd] (two pair, Jacks and Sevens)
spidnpwmoJ1L6yeNW7D5UA: shows [7s 8s] (three of a kind, Sevens)
gehe91e0IyVT0QU/XBkEyg joins the table at seat #1 
spidnpwmoJ1L6yeNW7D5UA collected $4.30 from pot
*** SUMMARY ***
Total pot $4.50 | Rake $0.20 
Board [7c 7h Jh 9h 3h]
Seat 4: spidnpwmoJ1L6yeNW7D5UA (big blind) showed [7s 8s] and won ($4.30) with three of a kind, Sevens
Seat 5: HVKi9hnDyvzObpL08/OarQ folded before Flop (didn't bet)
Seat 6: vO3QVRovWemcGMkm7ijAIA folded before Flop (didn't bet)
Seat 7: 4oA316mXLIui1QY63GXBUg folded before Flop (didn't bet)
Seat 8: DIBbjEYGs+TVdVgEB/4+3w (button) folded before Flop (didn't bet)
Seat 9: PrviAnKmKklf+We6cR33cw (small blind) showed [6s Jd] and lost with two pair, Jacks and Sevens




PokerStars Game #59939659206:  Hold'em No Limit ($0.10/$0.25) - 2009/07/01 0:45:35 ET
Table 'nc6OeGk/wtaWV+6N+kgnZQ' 6-max Seat #3 is the button
Seat 1: 0/FYfBoKhINaqU/H5OSS1A ($2 in chips) 
Seat 2: 4vTIxEd0Qfkak22W0G6sTg ($12.20 in chips) 
Seat 3: 8f0dtuUGqDbgE6up1lQAlg ($20.25 in chips) 
Seat 4: UfU14XiqkyIQoIJy9COOsQ ($24.50 in chips) 
Seat 5: ymz+a8dgHSUFPooYplw7Ow ($25 in chips) 
UfU14XiqkyIQoIJy9COOsQ: posts small blind $0.10
ymz+a8dgHSUFPooYplw7Ow: posts big blind $0.25
Mch463E1dxQfVob352za6w: sits out 
*** HOLE CARDS ***
0/FYfBoKhINaqU/H5OSS1A: calls $0.25
4vTIxEd0Qfkak22W0G6sTg: folds 
8f0dtuUGqDbgE6up1lQAlg: calls $0.25
UfU14XiqkyIQoIJy9COOsQ: raises $0.50 to $0.75
ymz+a8dgHSUFPooYplw7Ow: folds 
0/FYfBoKhINaqU/H5OSS1A: calls $0.50
8f0dtuUGqDbgE6up1lQAlg: calls $0.50
*** FLOP *** [2d 8d 5s]
UfU14XiqkyIQoIJy9COOsQ: bets $1
0/FYfBoKhINaqU/H5OSS1A: folds 
8f0dtuUGqDbgE6up1lQAlg: calls $1
*** TURN *** [2d 8d 5s] [2h]
UfU14XiqkyIQoIJy9COOsQ: bets $1.75
8f0dtuUGqDbgE6up1lQAlg: calls $1.75
*** RIVER *** [2d 8d 5s 2h] [9h]
UfU14XiqkyIQoIJy9COOsQ: checks 
8f0dtuUGqDbgE6up1lQAlg: checks 
*** SHOW DOWN ***
UfU14XiqkyIQoIJy9COOsQ: shows [4c 4h] (two pair, Fours and Deuces)
8f0dtuUGqDbgE6up1lQAlg: shows [4d 4s] (two pair, Fours and Deuces)
UfU14XiqkyIQoIJy9COOsQ collected $3.85 from pot
8f0dtuUGqDbgE6up1lQAlg collected $3.80 from pot
*** SUMMARY ***
Total pot $8 | Rake $0.35 
Board [2d 8d 5s 2h 9h]
Seat 1: 0/FYfBoKhINaqU/H5OSS1A folded on the Flop
Seat 2: 4vTIxEd0Qfkak22W0G6sTg folded before Flop (didn't bet)
Seat 3: 8f0dtuUGqDbgE6up1lQAlg (button) showed [4d 4s] and won ($3.80) with two pair, Fours and Deuces
Seat 4: UfU14XiqkyIQoIJy9COOsQ (small blind) showed [4c 4h] and won ($3.85) with two pair, Fours and Deuces
Seat 5: ymz+a8dgHSUFPooYplw7Ow (big blind) folded before Flop




PokerStars Game #59939660162:  Hold'em No Limit ($0.10/$0.25) - 2009/07/01 0:45:36 ET
Table 'zW+7jPbOLCvlPu+dUGY5WQ' 6-max Seat #2 is the button
Seat 1: JE/wJXmjw3bpdmjwvh2pcg ($16.10 in chips) 
Seat 2: DXgVFTcE3WofABsNJ5G/nw ($37.55 in chips) 
Seat 3: BedjMfrlRfPgSq7CXpPAmg ($63.50 in chips) 
Seat 5: SFmT9ZsVopnukjvAzrxTRg ($55.45 in chips) 
Seat 6: BiLBinPhgpKAYzLgKJVU5A ($21.45 in chips) 
BedjMfrlRfPgSq7CXpPAmg: posts small blind $0.10
SFmT9ZsVopnukjvAzrxTRg: posts big blind $0.25
*** HOLE CARDS ***
BiLBinPhgpKAYzLgKJVU5A: folds 
JE/wJXmjw3bpdmjwvh2pcg: raises $0.75 to $1
DXgVFTcE3WofABsNJ5G/nw: calls $1
BedjMfrlRfPgSq7CXpPAmg: folds 
SFmT9ZsVopnukjvAzrxTRg: folds 
*** FLOP *** [Th 5c Td]
JE/wJXmjw3bpdmjwvh2pcg: folds 
DXgVFTcE3WofABsNJ5G/nw collected $2.25 from pot
DXgVFTcE3WofABsNJ5G/nw: doesn't show hand 
*** SUMMARY ***
Total pot $2.35 | Rake $0.10 
Board [Th 5c Td]
Seat 1: JE/wJXmjw3bpdmjwvh2pcg folded on the Flop
Seat 2: DXgVFTcE3WofABsNJ5G/nw (button) collected ($2.25)
Seat 3: BedjMfrlRfPgSq7CXpPAmg (small blind) folded before Flop
Seat 5: SFmT9ZsVopnukjvAzrxTRg (big blind) folded before Flop
Seat 6: BiLBinPhgpKAYzLgKJVU5A folded before Flop (didn't bet)




PokerStars Game #59939659674:  Hold'em No Limit ($0.10/$0.25) - 2009/07/01 0:45:36 ET
Table 'RPdw09/gGCIP4xFhDWJgXQ' 9-max Seat #6 is the button
Seat 1: aNpwfA31EREwO+ar4XzBCw ($25 in chips) 
Seat 2: Sd1tfhUq/M96GhXGv1hwFQ ($11 in chips) 
Seat 3: Qi+clOtyDiibLdH2/1Qy8g ($26 in chips) 
Seat 4: z5GxcHlYz/GSz6W2uFiTtg ($21.75 in chips) 
Seat 5: z0kymJfmEW9d8WGcY1n6OA ($9.80 in chips) 
Seat 6: monZeAwXUmIA1l84cUd2hw ($12.30 in chips) 
Seat 7: hIss79a4pu7GzJZepfgOpg ($25 in chips) 
Seat 8: MG90wfSJZnOejs/KD3vlQQ ($25 in chips) 
Seat 9: Yv4fucyyT28mjx8V5lxKJg ($47.05 in chips) 
hIss79a4pu7GzJZepfgOpg: posts small blind $0.10
MG90wfSJZnOejs/KD3vlQQ: posts big blind $0.25
*** HOLE CARDS ***
Yv4fucyyT28mjx8V5lxKJg: calls $0.25
aNpwfA31EREwO+ar4XzBCw: folds 
Sd1tfhUq/M96GhXGv1hwFQ: calls $0.25
Qi+clOtyDiibLdH2/1Qy8g: folds 
z5GxcHlYz/GSz6W2uFiTtg: folds 
z0kymJfmEW9d8WGcY1n6OA: folds 
monZeAwXUmIA1l84cUd2hw: folds 
hIss79a4pu7GzJZepfgOpg: calls $0.15
MG90wfSJZnOejs/KD3vlQQ: checks 
*** FLOP *** [9h Th 5c]
hIss79a4pu7GzJZepfgOpg: bets $0.50
MG90wfSJZnOejs/KD3vlQQ: folds 
Yv4fucyyT28mjx8V5lxKJg: calls $0.50
Sd1tfhUq/M96GhXGv1hwFQ: calls $0.50
*** TURN *** [9h Th 5c] [Ac]
hIss79a4pu7GzJZepfgOpg: bets $1
Yv4fucyyT28mjx8V5lxKJg: raises $45.30 to $46.30 and is all-in
Sd1tfhUq/M96GhXGv1hwFQ: folds 
hIss79a4pu7GzJZepfgOpg: folds 
Uncalled bet ($45.30) returned to Yv4fucyyT28mjx8V5lxKJg
Yv4fucyyT28mjx8V5lxKJg collected $4.30 from pot
Yv4fucyyT28mjx8V5lxKJg: doesn't show hand 
*** SUMMARY ***
Total pot $4.50 | Rake $0.20 
Board [9h Th 5c Ac]
Seat 1: aNpwfA31EREwO+ar4XzBCw folded before Flop (didn't bet)
Seat 2: Sd1tfhUq/M96GhXGv1hwFQ folded on the Turn
Seat 3: Qi+clOtyDiibLdH2/1Qy8g folded before Flop (didn't bet)
Seat 4: z5GxcHlYz/GSz6W2uFiTtg folded before Flop (didn't bet)
Seat 5: z0kymJfmEW9d8WGcY1n6OA folded before Flop (didn't bet)
Seat 6: monZeAwXUmIA1l84cUd2hw (button) folded before Flop (didn't bet)
Seat 7: hIss79a4pu7GzJZepfgOpg (small blind) folded on the Turn
Seat 8: MG90wfSJZnOejs/KD3vlQQ (big blind) folded on the Flop
Seat 9: Yv4fucyyT28mjx8V5lxKJg collected ($4.30)




PokerStars Game #59939659602:  Hold'em No Limit ($0.10/$0.25) - 2009/07/01 0:45:36 ET
Table 'rpIHGyt2QpgQc5bvptAvDQ' 9-max Seat #8 is the button
Seat 1: pIK8dHf+MqCSMpnx8j9HEw ($15.90 in chips) 
Seat 2: Xpyqpb+DURDWnyJ3xTEIFQ ($27.25 in chips) 
Seat 3: RNWwL4ZL6E6nNwmoYWS4Ug ($9 in chips) 
Seat 4: ottZQkg1UDWk85BtBzGJzg ($15 in chips) 
Seat 5: F7uW1LiDD9vUDBtB+5gRDg ($25.30 in chips) 
Seat 6: gehe91e0IyVT0QU/XBkEyg ($42 in chips) 
Seat 7: SXqVW4Q0evTUVZG6BbUNIA ($29.25 in chips) 
Seat 8: tYsOBqdU1+x+yFI7zHO7hQ ($25 in chips) 
Seat 9: nm4Dj/f+jJEwKVsUnKh73g ($23.55 in chips) 
nm4Dj/f+jJEwKVsUnKh73g: posts small blind $0.10
pIK8dHf+MqCSMpnx8j9HEw: posts big blind $0.25
*** HOLE CARDS ***
Xpyqpb+DURDWnyJ3xTEIFQ: raises $0.75 to $1
RNWwL4ZL6E6nNwmoYWS4Ug: calls $1
ottZQkg1UDWk85BtBzGJzg: folds 
F7uW1LiDD9vUDBtB+5gRDg: folds 
gehe91e0IyVT0QU/XBkEyg: folds 
SXqVW4Q0evTUVZG6BbUNIA: folds 
tYsOBqdU1+x+yFI7zHO7hQ: folds 
nm4Dj/f+jJEwKVsUnKh73g: calls $0.90
pIK8dHf+MqCSMpnx8j9HEw: calls $0.75
*** FLOP *** [5s 6d 3c]
nm4Dj/f+jJEwKVsUnKh73g: checks 
pIK8dHf+MqCSMpnx8j9HEw: bets $0.50
Xpyqpb+DURDWnyJ3xTEIFQ: folds 
RNWwL4ZL6E6nNwmoYWS4Ug: calls $0.50
nm4Dj/f+jJEwKVsUnKh73g: raises $1.75 to $2.25
pIK8dHf+MqCSMpnx8j9HEw: calls $1.75
RNWwL4ZL6E6nNwmoYWS4Ug: folds 
*** TURN *** [5s 6d 3c] [3d]
Xpyqpb+DURDWnyJ3xTEIFQ leaves the table
nm4Dj/f+jJEwKVsUnKh73g: bets $5.50
dtZ84flFEi4Q+SGrHMJRDQ joins the table at seat #2 
pIK8dHf+MqCSMpnx8j9HEw: folds 
Uncalled bet ($5.50) returned to nm4Dj/f+jJEwKVsUnKh73g
nm4Dj/f+jJEwKVsUnKh73g collected $8.60 from pot
nm4Dj/f+jJEwKVsUnKh73g: doesn't show hand 
*** SUMMARY ***
Total pot $9 | Rake $0.40 
Board [5s 6d 3c 3d]
Seat 1: pIK8dHf+MqCSMpnx8j9HEw (big blind) folded on the Turn
Seat 2: Xpyqpb+DURDWnyJ3xTEIFQ folded on the Flop
Seat 3: RNWwL4ZL6E6nNwmoYWS4Ug folded on the Flop
Seat 4: ottZQkg1UDWk85BtBzGJzg folded before Flop (didn't bet)
Seat 5: F7uW1LiDD9vUDBtB+5gRDg folded before Flop (didn't bet)
Seat 6: gehe91e0IyVT0QU/XBkEyg folded before Flop (didn't bet)
Seat 7: SXqVW4Q0evTUVZG6BbUNIA folded before Flop (didn't bet)
Seat 8: tYsOBqdU1+x+yFI7zHO7hQ (button) folded before Flop (didn't bet)
Seat 9: nm4Dj/f+jJEwKVsUnKh73g (small blind) collected ($8.60)




PokerStars Game #59939659778:  Hold'em No Limit ($0.10/$0.25) - 2009/07/01 0:45:36 ET
Table '3KDMdm1sfxFsNKkjc/PnBg' 9-max Seat #4 is the button
Seat 2: rUpvA02nErFvZ4yFbDR8XA ($19.50 in chips) 
Seat 3: GftT+l+xjKzcY0rMiNZfPg ($21.50 in chips) 
Seat 4: 4xnojP+j2Tm8s9Bh7QC5+Q ($18 in chips) 
Seat 5: +2kMBNpY4nF1qNCRd8SJLA ($25.85 in chips) 
Seat 6: N1HHRe1nNMukTQB6qMn6Kw ($16.80 in chips) 
Seat 7: gehe91e0IyVT0QU/XBkEyg ($25 in chips) 
Seat 8: st9jtdNbm1W5GfBwRaCVqQ ($28.30 in chips) 
Seat 9: K0b5wNInj6hUGRr6yzKFtw ($30.45 in chips) 
+2kMBNpY4nF1qNCRd8SJLA: posts small blind $0.10
N1HHRe1nNMukTQB6qMn6Kw: posts big blind $0.25
V6p0jQ/RhUsqpHLmXvEX4Q: sits out 
*** HOLE CARDS ***
gehe91e0IyVT0QU/XBkEyg: folds 
st9jtdNbm1W5GfBwRaCVqQ: folds 
K0b5wNInj6hUGRr6yzKFtw: folds 
rUpvA02nErFvZ4yFbDR8XA: folds 
GftT+l+xjKzcY0rMiNZfPg: raises $0.50 to $0.75
4xnojP+j2Tm8s9Bh7QC5+Q: calls $0.75
+2kMBNpY4nF1qNCRd8SJLA: folds 
N1HHRe1nNMukTQB6qMn6Kw: folds 
*** FLOP *** [As 6s 5h]
GftT+l+xjKzcY0rMiNZfPg: checks 
4xnojP+j2Tm8s9Bh7QC5+Q: checks 
*** TURN *** [As 6s 5h] [9h]
GftT+l+xjKzcY0rMiNZfPg: checks 
4xnojP+j2Tm8s9Bh7QC5+Q: bets $1
GftT+l+xjKzcY0rMiNZfPg: folds 
Uncalled bet ($1) returned to 4xnojP+j2Tm8s9Bh7QC5+Q
4xnojP+j2Tm8s9Bh7QC5+Q collected $1.80 from pot
*** SUMMARY ***
Total pot $1.85 | Rake $0.05 
Board [As 6s 5h 9h]
Seat 2: rUpvA02nErFvZ4yFbDR8XA folded before Flop (didn't bet)
Seat 3: GftT+l+xjKzcY0rMiNZfPg folded on the Turn
Seat 4: 4xnojP+j2Tm8s9Bh7QC5+Q (button) collected ($1.80)
Seat 5: +2kMBNpY4nF1qNCRd8SJLA (small blind) folded before Flop
Seat 6: N1HHRe1nNMukTQB6qMn6Kw (big blind) folded before Flop
Seat 7: gehe91e0IyVT0QU/XBkEyg folded before Flop (didn't bet)
Seat 8: st9jtdNbm1W5GfBwRaCVqQ folded before Flop (didn't bet)
Seat 9: K0b5wNInj6hUGRr6yzKFtw folded before Flop (didn't bet)




PokerStars Game #59939660124:  Hold'em No Limit ($0.10/$0.25) - 2009/07/01 0:45:36 ET
Table '4hfTdIVT/qPsJNfWXLsVIw' 9-max Seat #3 is the button
Seat 1: GbHFBbLqLGz0Pwn6CJeAuw ($25.60 in chips) 
Seat 2: NB5rKy+grn9jKcWXclZ7WA ($32.15 in chips) 
Seat 3: opOCI2p6kW0tINuVaAqmcQ ($26.15 in chips) 
Seat 4: OiV1PWZ3IkN29JlmCcnTwQ ($4.90 in chips) 
Seat 6: VWUWpMLMj/Q1jRVpF7Aohw ($9.75 in chips) 
Seat 7: z5GxcHlYz/GSz6W2uFiTtg ($31.75 in chips) 
Seat 8: jiyia7h6fmxBdWBkH9lH5A ($6.25 in chips) 
Seat 9: K5byIbXY6S+c1wAeHitZow ($12.05 in chips) 
OiV1PWZ3IkN29JlmCcnTwQ: posts small blind $0.10
VWUWpMLMj/Q1jRVpF7Aohw: posts big blind $0.25
*** HOLE CARDS ***
dtZ84flFEi4Q+SGrHMJRDQ joins the table at seat #5 
z5GxcHlYz/GSz6W2uFiTtg: calls $0.25
jiyia7h6fmxBdWBkH9lH5A: calls $0.25
K5byIbXY6S+c1wAeHitZow: folds 
GbHFBbLqLGz0Pwn6CJeAuw: calls $0.25
NB5rKy+grn9jKcWXclZ7WA: folds 
opOCI2p6kW0tINuVaAqmcQ: folds 
OiV1PWZ3IkN29JlmCcnTwQ: folds 
VWUWpMLMj/Q1jRVpF7Aohw: checks 
*** FLOP *** [Tc 9h 3c]
VWUWpMLMj/Q1jRVpF7Aohw: checks 
z5GxcHlYz/GSz6W2uFiTtg: bets $0.50
jiyia7h6fmxBdWBkH9lH5A: calls $0.50
GbHFBbLqLGz0Pwn6CJeAuw: calls $0.50
VWUWpMLMj/Q1jRVpF7Aohw: folds 
*** TURN *** [Tc 9h 3c] [3h]
z5GxcHlYz/GSz6W2uFiTtg: bets $0.25
jiyia7h6fmxBdWBkH9lH5A: raises $0.25 to $0.50
GbHFBbLqLGz0Pwn6CJeAuw: calls $0.50
z5GxcHlYz/GSz6W2uFiTtg: calls $0.25
*** RIVER *** [Tc 9h 3c 3h] [9s]
z5GxcHlYz/GSz6W2uFiTtg: checks 
jiyia7h6fmxBdWBkH9lH5A: bets $1
GbHFBbLqLGz0Pwn6CJeAuw: folds 
z5GxcHlYz/GSz6W2uFiTtg: calls $1
*** SHOW DOWN ***
jiyia7h6fmxBdWBkH9lH5A: shows [Ah Ac] (two pair, Aces and Nines)
z5GxcHlYz/GSz6W2uFiTtg: mucks hand 
jiyia7h6fmxBdWBkH9lH5A collected $5.85 from pot
*** SUMMARY ***
Total pot $6.10 | Rake $0.25 
Board [Tc 9h 3c 3h 9s]
Seat 1: GbHFBbLqLGz0Pwn6CJeAuw folded on the River
Seat 2: NB5rKy+grn9jKcWXclZ7WA folded before Flop (didn't bet)
Seat 3: opOCI2p6kW0tINuVaAqmcQ (button) folded before Flop (didn't bet)
Seat 4: OiV1PWZ3IkN29JlmCcnTwQ (small blind) folded before Flop
Seat 6: VWUWpMLMj/Q1jRVpF7Aohw (big blind) folded on the Flop
Seat 7: z5GxcHlYz/GSz6W2uFiTtg mucked
Seat 8: jiyia7h6fmxBdWBkH9lH5A showed [Ah Ac] and won ($5.85) with two pair, Aces and Nines
Seat 9: K5byIbXY6S+c1wAeHitZow folded before Flop (didn't bet)




PokerStars Game #59939660038:  Hold'em No Limit ($0.10/$0.25) - 2009/07/01 0:45:36 ET
Table 'ohAuixfiLOYDylNUG5mNUw' 9-max Seat #1 is the button
Seat 1: AtRN1hdV8HbL3X4XogDaLA ($39.55 in chips) 
Seat 2: yVwP/Nr5oXkAQp5dmdNUVQ ($25.10 in chips) 
Seat 3: HVKi9hnDyvzObpL08/OarQ ($25 in chips) 
Seat 4: jeKWRUkMaVn8rEUjnJKqpg ($25 in chips) 
Seat 5: wub1jsnHlpWmOX4uczVADA ($9.75 in chips) 
Seat 6: opOCI2p6kW0tINuVaAqmcQ ($25.60 in chips) 
Seat 8: ppMlNkhYgErlt4fuJO7ADA ($9.50 in chips) 
Seat 9: hIss79a4pu7GzJZepfgOpg ($25 in chips) 
yVwP/Nr5oXkAQp5dmdNUVQ: posts small blind $0.10
HVKi9hnDyvzObpL08/OarQ: posts big blind $0.25
aPRz/2GxbXANYpVsQO8pdQ: sits out 
*** HOLE CARDS ***
jeKWRUkMaVn8rEUjnJKqpg: folds 
wub1jsnHlpWmOX4uczVADA: folds 
opOCI2p6kW0tINuVaAqmcQ: folds 
ppMlNkhYgErlt4fuJO7ADA: folds 
hIss79a4pu7GzJZepfgOpg: folds 
AtRN1hdV8HbL3X4XogDaLA: calls $0.25
yVwP/Nr5oXkAQp5dmdNUVQ: folds 
HVKi9hnDyvzObpL08/OarQ: raises $0.75 to $1
AtRN1hdV8HbL3X4XogDaLA: calls $0.75
*** FLOP *** [4h 6d 7h]
HVKi9hnDyvzObpL08/OarQ: bets $1.50
AtRN1hdV8HbL3X4XogDaLA: folds 
Uncalled bet ($1.50) returned to HVKi9hnDyvzObpL08/OarQ
HVKi9hnDyvzObpL08/OarQ collected $2 from pot
*** SUMMARY ***
Total pot $2.10 | Rake $0.10 
Board [4h 6d 7h]
Seat 1: AtRN1hdV8HbL3X4XogDaLA (button) folded on the Flop
Seat 2: yVwP/Nr5oXkAQp5dmdNUVQ (small blind) folded before Flop
Seat 3: HVKi9hnDyvzObpL08/OarQ (big blind) collected ($2)
Seat 4: jeKWRUkMaVn8rEUjnJKqpg folded before Flop (didn't bet)
Seat 5: wub1jsnHlpWmOX4uczVADA folded before Flop (didn't bet)
Seat 6: opOCI2p6kW0tINuVaAqmcQ folded before Flop (didn't bet)
Seat 8: ppMlNkhYgErlt4fuJO7ADA folded before Flop (didn't bet)
Seat 9: hIss79a4pu7GzJZepfgOpg folded before Flop (didn't bet)




PokerStars Game #59939660188:  Hold'em No Limit ($0.10/$0.25) - 2009/07/01 0:45:36 ET
Table 'zhqgUUprOJ14VxKxPHcT/Q' 9-max Seat #8 is the button
Seat 2: GY095KWhBevJ1Ttvl8WseA ($14.35 in chips) 
Seat 3: G2offPrpnppc++nuXqs2JA ($17.25 in chips) 
Seat 4: EfeOSXE8Wc4WWEsgc3WzZg ($8.65 in chips) 
Seat 5: +sbyWwIcFp9kP0bDtMegfQ ($26.75 in chips) 
Seat 6: DIBbjEYGs+TVdVgEB/4+3w ($22.60 in chips) 
Seat 7: Ebzw1YytWRd/vXFjA8XReg ($24 in chips) 
Seat 8: amD2PwT1xB7aC2k57sa7Ig ($25 in chips) 
Seat 9: 4awUyiDYTgylQKXZ9faBVA ($35.85 in chips) 
4awUyiDYTgylQKXZ9faBVA: posts small blind $0.10
GY095KWhBevJ1Ttvl8WseA: posts big blind $0.25
*** HOLE CARDS ***
G2offPrpnppc++nuXqs2JA: folds 
EfeOSXE8Wc4WWEsgc3WzZg: calls $0.25
+sbyWwIcFp9kP0bDtMegfQ: folds 
DIBbjEYGs+TVdVgEB/4+3w: calls $0.25
Ebzw1YytWRd/vXFjA8XReg: folds 
amD2PwT1xB7aC2k57sa7Ig: folds 
4awUyiDYTgylQKXZ9faBVA: raises $1.25 to $1.50
GY095KWhBevJ1Ttvl8WseA: calls $1.25
EfeOSXE8Wc4WWEsgc3WzZg: folds 
DIBbjEYGs+TVdVgEB/4+3w: folds 
*** FLOP *** [Ah Qd 8c]
4awUyiDYTgylQKXZ9faBVA: checks 
GY095KWhBevJ1Ttvl8WseA: checks 
*** TURN *** [Ah Qd 8c] [7s]
4awUyiDYTgylQKXZ9faBVA: checks 
GY095KWhBevJ1Ttvl8WseA: checks 
*** RIVER *** [Ah Qd 8c 7s] [Td]
diego310 was removed from the table for failing to post
4awUyiDYTgylQKXZ9faBVA: checks 
22dIObOuor/A+IKWkNoAlA joins the table at seat #1 
GY095KWhBevJ1Ttvl8WseA: bets $6
4awUyiDYTgylQKXZ9faBVA: folds 
Uncalled bet ($6) returned to GY095KWhBevJ1Ttvl8WseA
GY095KWhBevJ1Ttvl8WseA collected $3.35 from pot
GY095KWhBevJ1Ttvl8WseA: doesn't show hand 
*** SUMMARY ***
Total pot $3.50 | Rake $0.15 
Board [Ah Qd 8c 7s Td]
Seat 2: GY095KWhBevJ1Ttvl8WseA (big blind) collected ($3.35)
Seat 3: G2offPrpnppc++nuXqs2JA folded before Flop (didn't bet)
Seat 4: EfeOSXE8Wc4WWEsgc3WzZg folded before Flop
Seat 5: +sbyWwIcFp9kP0bDtMegfQ folded before Flop (didn't bet)
Seat 6: DIBbjEYGs+TVdVgEB/4+3w folded before Flop
Seat 7: Ebzw1YytWRd/vXFjA8XReg folded before Flop (didn't bet)
Seat 8: amD2PwT1xB7aC2k57sa7Ig (button) folded before Flop (didn't bet)
Seat 9: 4awUyiDYTgylQKXZ9faBVA (small blind) folded on the River




PokerStars Game #59939660120:  Hold'em No Limit ($0.10/$0.25) - 2009/07/01 0:45:36 ET
Table 'O5NgMYt6EWbLBozZb3kseg' 6-max Seat #1 is the button
Seat 1: T2fEtpqj5ZyZAjEhNtsFAA ($56.50 in chips) 
Seat 2: VWbjqONyDvf8KegytgPLjQ ($57.15 in chips) 
Seat 5: vu2kzHaDtgr6NM7rdq0chA ($75.40 in chips) 
Seat 6: k9vn40MOqqb+xF+7GZ6v2g ($19 in chips) 
VWbjqONyDvf8KegytgPLjQ: posts small blind $0.10
vu2kzHaDtgr6NM7rdq0chA: posts big blind $0.25
*** HOLE CARDS ***
k9vn40MOqqb+xF+7GZ6v2g: folds 
T2fEtpqj5ZyZAjEhNtsFAA: folds 
VWbjqONyDvf8KegytgPLjQ: raises $1 to $1.25
vu2kzHaDtgr6NM7rdq0chA: folds 
Uncalled bet ($1) returned to VWbjqONyDvf8KegytgPLjQ
aogAb4Eienxztk8p2v9VVw has returned
dg3SMYXD7586yGx+LuFM0g has returned
VWbjqONyDvf8KegytgPLjQ collected $0.50 from pot
VWbjqONyDvf8KegytgPLjQ: doesn't show hand 
*** SUMMARY ***
Total pot $0.50 | Rake $0 
Seat 1: T2fEtpqj5ZyZAjEhNtsFAA (button) folded before Flop (didn't bet)
Seat 2: VWbjqONyDvf8KegytgPLjQ (small blind) collected ($0.50)
Seat 5: vu2kzHaDtgr6NM7rdq0chA (big blind) folded before Flop
Seat 6: k9vn40MOqqb+xF+7GZ6v2g folded before Flop (didn't bet)




PokerStars Game #59939660320:  Hold'em No Limit ($0.10/$0.25) - 2009/07/01 0:45:37 ET
Table 'zKwHJD0cmKNUure9qQTfFg' 6-max Seat #6 is the button
Seat 1: nwwpaieDRI0UPyVtChVHOg ($15 in chips) 
Seat 3: ljjhtb6FVPTx9AT9HNdtqg ($15 in chips) 
Seat 4: v+QfkGiuj9bgtuNoVnDO8w ($25.35 in chips) 
Seat 6: fBpPyuxbg0NbTlQHEs38sA ($15 in chips) 
nwwpaieDRI0UPyVtChVHOg: posts small blind $0.10
ljjhtb6FVPTx9AT9HNdtqg: posts big blind $0.25
*** HOLE CARDS ***
v+QfkGiuj9bgtuNoVnDO8w: folds 
fBpPyuxbg0NbTlQHEs38sA: calls $0.25
4kWQxGbT5FZ1dkPd1bE45Q joins the table at seat #2 
nwwpaieDRI0UPyVtChVHOg: folds 
ljjhtb6FVPTx9AT9HNdtqg: checks 
*** FLOP *** [3h 8s 5d]
ljjhtb6FVPTx9AT9HNdtqg: checks 
I1TxPvWj8NfG8orglCinNA has returned
fBpPyuxbg0NbTlQHEs38sA: checks 
*** TURN *** [3h 8s 5d] [Qc]
ljjhtb6FVPTx9AT9HNdtqg: checks 
fBpPyuxbg0NbTlQHEs38sA: bets $0.25
ljjhtb6FVPTx9AT9HNdtqg: calls $0.25
*** RIVER *** [3h 8s 5d Qc] [7h]
ljjhtb6FVPTx9AT9HNdtqg: checks 
fBpPyuxbg0NbTlQHEs38sA: bets $0.75
ljjhtb6FVPTx9AT9HNdtqg: folds 
Uncalled bet ($0.75) returned to fBpPyuxbg0NbTlQHEs38sA
fBpPyuxbg0NbTlQHEs38sA collected $1.05 from pot
fBpPyuxbg0NbTlQHEs38sA: doesn't show hand 
*** SUMMARY ***
Total pot $1.10 | Rake $0.05 
Board [3h 8s 5d Qc 7h]
Seat 1: nwwpaieDRI0UPyVtChVHOg (small blind) folded before Flop
Seat 3: ljjhtb6FVPTx9AT9HNdtqg (big blind) folded on the River
Seat 4: v+QfkGiuj9bgtuNoVnDO8w folded before Flop (didn't bet)
Seat 6: fBpPyuxbg0NbTlQHEs38sA (button) collected ($1.05)




PokerStars Game #59939660288:  Hold'em No Limit ($0.10/$0.25) - 2009/07/01 0:45:37 ET
Table '29D3eoQzK5kOAT0OIDS2uQ' 6-max Seat #5 is the button
Seat 1: kG34n23qFQA3nzdOJTQ1dA ($50.15 in chips) 
Seat 3: z3tQwy28dp5FykDJC/wzQw ($21.20 in chips) 
Seat 4: yzFNNFIfC89bBPwpFPx2ow ($25.65 in chips) 
Seat 5: Q3EMN7b0ie81AFWkDrhCjw ($34.90 in chips) 
Seat 6: bWbV4MVB/vVpiES1Ut4hew ($44 in chips) 
bWbV4MVB/vVpiES1Ut4hew: posts small blind $0.10
kG34n23qFQA3nzdOJTQ1dA: posts big blind $0.25
*** HOLE CARDS ***
z3tQwy28dp5FykDJC/wzQw: calls $0.25
yzFNNFIfC89bBPwpFPx2ow: folds 
Q3EMN7b0ie81AFWkDrhCjw: calls $0.25
bWbV4MVB/vVpiES1Ut4hew: folds 
kG34n23qFQA3nzdOJTQ1dA: checks 
*** FLOP *** [9c Th Qd]
kG34n23qFQA3nzdOJTQ1dA: checks 
z3tQwy28dp5FykDJC/wzQw: checks 
Q3EMN7b0ie81AFWkDrhCjw: bets $0.50
kG34n23qFQA3nzdOJTQ1dA: calls $0.50
eSKnWz2RD4rvwnvB+rFzIg joins the table at seat #2 
z3tQwy28dp5FykDJC/wzQw: calls $0.50
*** TURN *** [9c Th Qd] [Tc]
kG34n23qFQA3nzdOJTQ1dA: checks 
z3tQwy28dp5FykDJC/wzQw: checks 
Q3EMN7b0ie81AFWkDrhCjw: checks 
*** RIVER *** [9c Th Qd Tc] [9d]
kG34n23qFQA3nzdOJTQ1dA: checks 
z3tQwy28dp5FykDJC/wzQw: checks 
Q3EMN7b0ie81AFWkDrhCjw: checks 
*** SHOW DOWN ***
kG34n23qFQA3nzdOJTQ1dA: shows [8h Js] (a straight, Eight to Queen)
z3tQwy28dp5FykDJC/wzQw: shows [9s As] (a full house, Nines full of Tens)
Q3EMN7b0ie81AFWkDrhCjw: mucks hand 
z3tQwy28dp5FykDJC/wzQw collected $2.25 from pot
*** SUMMARY ***
Total pot $2.35 | Rake $0.10 
Board [9c Th Qd Tc 9d]
Seat 1: kG34n23qFQA3nzdOJTQ1dA (big blind) showed [8h Js] and lost with a straight, Eight to Queen
Seat 3: z3tQwy28dp5FykDJC/wzQw showed [9s As] and won ($2.25) with a full house, Nines full of Tens
Seat 4: yzFNNFIfC89bBPwpFPx2ow folded before Flop (didn't bet)
Seat 5: Q3EMN7b0ie81AFWkDrhCjw (button) mucked
Seat 6: bWbV4MVB/vVpiES1Ut4hew (small blind) folded before Flop




PokerStars Game #59939660488:  Hold'em No Limit ($0.10/$0.25) - 2009/07/01 0:45:37 ET
Table 'isKy4XK8wJM0x735/D4hWA' 6-max Seat #6 is the button
Seat 1: 7FmwVDcdEtxDpHmP4hOXsQ ($25 in chips) 
Seat 2: WrLI51S2iMb8GLMB83gGqA ($25 in chips) 
Seat 3: jp34e617tIzV8tKIWmfAbA ($25 in chips) 
Seat 4: k9vn40MOqqb+xF+7GZ6v2g ($28.30 in chips) 
Seat 6: M6xK/VklCvdyyrmvzATlxQ ($17.15 in chips) 
7FmwVDcdEtxDpHmP4hOXsQ: posts small blind $0.10
WrLI51S2iMb8GLMB83gGqA: posts big blind $0.25
lquriepNQBhDV5P1SWHhnA: sits out 
*** HOLE CARDS ***
jp34e617tIzV8tKIWmfAbA: folds 
k9vn40MOqqb+xF+7GZ6v2g: calls $0.25
M6xK/VklCvdyyrmvzATlxQ: calls $0.25
7FmwVDcdEtxDpHmP4hOXsQ: folds 
WrLI51S2iMb8GLMB83gGqA: raises $1.75 to $2
k9vn40MOqqb+xF+7GZ6v2g: folds 
M6xK/VklCvdyyrmvzATlxQ: folds 
Uncalled bet ($1.75) returned to WrLI51S2iMb8GLMB83gGqA
WrLI51S2iMb8GLMB83gGqA collected $0.85 from pot
WrLI51S2iMb8GLMB83gGqA: doesn't show hand 
*** SUMMARY ***
Total pot $0.85 | Rake $0 
Seat 1: 7FmwVDcdEtxDpHmP4hOXsQ (small blind) folded before Flop
Seat 2: WrLI51S2iMb8GLMB83gGqA (big blind) collected ($0.85)
Seat 3: jp34e617tIzV8tKIWmfAbA folded before Flop (didn't bet)
Seat 4: k9vn40MOqqb+xF+7GZ6v2g folded before Flop
Seat 6: M6xK/VklCvdyyrmvzATlxQ (button) folded before Flop




PokerStars Game #59939660670:  Hold'em No Limit ($0.10/$0.25) - 2009/07/01 0:45:37 ET
Table 'nXVbUw6/HYwA6x21+IZ3XQ' 9-max Seat #4 is the button
Seat 1: zDrucyjVn5aeekNEc3cJrA ($23.05 in chips) 
Seat 4: GmQux9F6mgOHtI4C9bVTNQ ($5 in chips) 
Seat 5: M/9j4wkHH9i1JM51vgi1VA ($20.55 in chips) 
Seat 6: ljemhp25Zg+nlA9DLCIiUw ($23.60 in chips) 
Seat 7: IupaN0QS3TJoOSYaS7zF9w ($7.45 in chips) 
Seat 8: dfNim92Z6XK1/h5SFW5vDg ($25 in chips) 
Seat 9: rm0e8CshiGK8hjW46YcNqg ($34.50 in chips) 
M/9j4wkHH9i1JM51vgi1VA: posts small blind $0.10
ljemhp25Zg+nlA9DLCIiUw: posts big blind $0.25
*** HOLE CARDS ***
IupaN0QS3TJoOSYaS7zF9w: folds 
dfNim92Z6XK1/h5SFW5vDg: folds 
rm0e8CshiGK8hjW46YcNqg: folds 
GmQux9F6mgOHtI4C9bVTNQ said, "****scab"
zDrucyjVn5aeekNEc3cJrA: folds 
GmQux9F6mgOHtI4C9bVTNQ: folds 
M/9j4wkHH9i1JM51vgi1VA: calls $0.15
ljemhp25Zg+nlA9DLCIiUw: checks 
*** FLOP *** [Jd Jc Js]
M/9j4wkHH9i1JM51vgi1VA: checks 
ljemhp25Zg+nlA9DLCIiUw: checks 
*** TURN *** [Jd Jc Js] [9d]
M/9j4wkHH9i1JM51vgi1VA: checks 
ljemhp25Zg+nlA9DLCIiUw: checks 
*** RIVER *** [Jd Jc Js 9d] [Kh]
IupaN0QS3TJoOSYaS7zF9w said, "lol"
M/9j4wkHH9i1JM51vgi1VA: checks 
ljemhp25Zg+nlA9DLCIiUw: checks 
*** SHOW DOWN ***
M/9j4wkHH9i1JM51vgi1VA: shows [3c As] (three of a kind, Jacks)
ljemhp25Zg+nlA9DLCIiUw: mucks hand 
GmQux9F6mgOHtI4C9bVTNQ said, "just learned that one and it's banned already/"
M/9j4wkHH9i1JM51vgi1VA collected $0.50 from pot
IupaN0QS3TJoOSYaS7zF9w said, "****tails"
GmQux9F6mgOHtI4C9bVTNQ said, "buttsecks"
*** SUMMARY ***
Total pot $0.50 | Rake $0 
Board [Jd Jc Js 9d Kh]
Seat 1: zDrucyjVn5aeekNEc3cJrA folded before Flop (didn't bet)
Seat 4: GmQux9F6mgOHtI4C9bVTNQ (button) folded before Flop (didn't bet)
Seat 5: M/9j4wkHH9i1JM51vgi1VA (small blind) showed [3c As] and won ($0.50) with three of a kind, Jacks
Seat 6: ljemhp25Zg+nlA9DLCIiUw (big blind) mucked
Seat 7: IupaN0QS3TJoOSYaS7zF9w folded before Flop (didn't bet)
Seat 8: dfNim92Z6XK1/h5SFW5vDg folded before Flop (didn't bet)
Seat 9: rm0e8CshiGK8hjW46YcNqg folded before Flop (didn't bet)




PokerStars Game #59939660296:  Hold'em No Limit ($0.10/$0.25) - 2009/07/01 0:45:37 ET
Table '+VTTYgQLH1awDHk+IAxqGg' 9-max Seat #2 is the button
Seat 1: s7Q6uNouhe7aE8JdFb9E+A ($25.25 in chips) 
Seat 2: 86vbuhJsyH+nbEg5qpDLyQ ($23.05 in chips) 
Seat 3: rSMoem/92WmnPjtw2tSQkA ($30.20 in chips) 
Seat 4: gE5rN2TDY1aXcZn/TOPeZw ($9.80 in chips) 
Seat 5: sD+TKtt36XiiN6jqHiLwDA ($38.60 in chips) 
Seat 7: W4TLQcZ2TiM73eIgpIvlGg ($26.20 in chips) 
Seat 9: CFZ+ACzShzC3naaIaOjbYQ ($8.10 in chips) 
rSMoem/92WmnPjtw2tSQkA: posts small blind $0.10
gE5rN2TDY1aXcZn/TOPeZw: posts big blind $0.25
gehe91e0IyVT0QU/XBkEyg: sits out 
j4q3p0lesp63b1gZDwLBZw: sits out 
*** HOLE CARDS ***
sD+TKtt36XiiN6jqHiLwDA: folds 
W4TLQcZ2TiM73eIgpIvlGg: folds 
CFZ+ACzShzC3naaIaOjbYQ: folds 
s7Q6uNouhe7aE8JdFb9E+A: raises $0.50 to $0.75
86vbuhJsyH+nbEg5qpDLyQ: folds 
rSMoem/92WmnPjtw2tSQkA: calls $0.65
gE5rN2TDY1aXcZn/TOPeZw: calls $0.50
*** FLOP *** [9s 2s 8h]
rSMoem/92WmnPjtw2tSQkA: checks 
gE5rN2TDY1aXcZn/TOPeZw: checks 
s7Q6uNouhe7aE8JdFb9E+A: checks 
*** TURN *** [9s 2s 8h] [5c]
rSMoem/92WmnPjtw2tSQkA: bets $2
gE5rN2TDY1aXcZn/TOPeZw: folds 
s7Q6uNouhe7aE8JdFb9E+A: folds 
Uncalled bet ($2) returned to rSMoem/92WmnPjtw2tSQkA
rSMoem/92WmnPjtw2tSQkA collected $2.15 from pot
*** SUMMARY ***
Total pot $2.25 | Rake $0.10 
Board [9s 2s 8h 5c]
Seat 1: s7Q6uNouhe7aE8JdFb9E+A folded on the Turn
Seat 2: 86vbuhJsyH+nbEg5qpDLyQ (button) folded before Flop (didn't bet)
Seat 3: rSMoem/92WmnPjtw2tSQkA (small blind) collected ($2.15)
Seat 4: gE5rN2TDY1aXcZn/TOPeZw (big blind) folded on the Turn
Seat 5: sD+TKtt36XiiN6jqHiLwDA folded before Flop (didn't bet)
Seat 7: W4TLQcZ2TiM73eIgpIvlGg folded before Flop (didn't bet)
Seat 9: CFZ+ACzShzC3naaIaOjbYQ folded before Flop (didn't bet)




PokerStars Game #59939660764:  Hold'em No Limit ($0.10/$0.25) - 2009/07/01 0:45:37 ET
Table 'fRxOyfaHXkWUDLv4eSxFew' 9-max Seat #6 is the button
Seat 2: TeWJxSETzbXGiYKx0y+dtg ($24.65 in chips) 
Seat 3: hBMUlEpyU74r/fwDgIpXjQ ($28.30 in chips) 
Seat 4: +WMpj67YqG8ilNkg2JwXpw ($15.95 in chips) 
Seat 6: N/O9ADKpmqB2ASZuqgodlw ($6.85 in chips) 
Seat 7: 7cv+9Zc9HIQHNvYsMfV3uA ($53.80 in chips) 
Seat 9: H5Se03ZqSX7tbULXur2MAg ($23.80 in chips) 
7cv+9Zc9HIQHNvYsMfV3uA: posts small blind $0.10
H5Se03ZqSX7tbULXur2MAg: posts big blind $0.25
6RiVTYll/5D8zICp0MRpKw: sits out 
*** HOLE CARDS ***
TeWJxSETzbXGiYKx0y+dtg: folds 
hBMUlEpyU74r/fwDgIpXjQ: folds 
+WMpj67YqG8ilNkg2JwXpw: folds 
N/O9ADKpmqB2ASZuqgodlw: calls $0.25
7cv+9Zc9HIQHNvYsMfV3uA: raises $1.25 to $1.50
H5Se03ZqSX7tbULXur2MAg: folds 
N/O9ADKpmqB2ASZuqgodlw: calls $1.25
*** FLOP *** [2h 9h 2s]
7cv+9Zc9HIQHNvYsMfV3uA: bets $3
N/O9ADKpmqB2ASZuqgodlw: folds 
Uncalled bet ($3) returned to 7cv+9Zc9HIQHNvYsMfV3uA
7cv+9Zc9HIQHNvYsMfV3uA collected $3.10 from pot
7cv+9Zc9HIQHNvYsMfV3uA: doesn't show hand 
*** SUMMARY ***
Total pot $3.25 | Rake $0.15 
Board [2h 9h 2s]
Seat 2: TeWJxSETzbXGiYKx0y+dtg folded before Flop (didn't bet)
Seat 3: hBMUlEpyU74r/fwDgIpXjQ folded before Flop (didn't bet)
Seat 4: +WMpj67YqG8ilNkg2JwXpw folded before Flop (didn't bet)
Seat 6: N/O9ADKpmqB2ASZuqgodlw (button) folded on the Flop
Seat 7: 7cv+9Zc9HIQHNvYsMfV3uA (small blind) collected ($3.10)
Seat 9: H5Se03ZqSX7tbULXur2MAg (big blind) folded before Flop




PokerStars Game #59939660786:  Hold'em No Limit ($0.10/$0.25) - 2009/07/01 0:45:37 ET
Table '8kaMIn+aON/ferW89Go6Pw' 9-max Seat #6 is the button
Seat 2: jeKWRUkMaVn8rEUjnJKqpg ($25.50 in chips) 
Seat 3: 7cv+9Zc9HIQHNvYsMfV3uA ($28.55 in chips) 
Seat 4: KRWTiGM4xH+MkvPtJz4+SA ($45.55 in chips) 
Seat 5: hIss79a4pu7GzJZepfgOpg ($31 in chips) 
Seat 6: 1S/fpm+f42V/6MNZre+ccg ($25 in chips) 
Seat 7: HVKi9hnDyvzObpL08/OarQ ($25.35 in chips) 
HVKi9hnDyvzObpL08/OarQ: posts small blind $0.10
jeKWRUkMaVn8rEUjnJKqpg: posts big blind $0.25
*** HOLE CARDS ***
7cv+9Zc9HIQHNvYsMfV3uA: folds 
KRWTiGM4xH+MkvPtJz4+SA: folds 
hIss79a4pu7GzJZepfgOpg: folds 
1S/fpm+f42V/6MNZre+ccg: raises $0.50 to $0.75
HVKi9hnDyvzObpL08/OarQ: calls $0.65
jeKWRUkMaVn8rEUjnJKqpg: calls $0.50
*** FLOP *** [Ah 4c Kh]
HVKi9hnDyvzObpL08/OarQ: checks 
jeKWRUkMaVn8rEUjnJKqpg: checks 
1S/fpm+f42V/6MNZre+ccg: checks 
*** TURN *** [Ah 4c Kh] [8h]
HVKi9hnDyvzObpL08/OarQ: checks 
jeKWRUkMaVn8rEUjnJKqpg: bets $1
1S/fpm+f42V/6MNZre+ccg: folds 
HVKi9hnDyvzObpL08/OarQ: folds 
Uncalled bet ($1) returned to jeKWRUkMaVn8rEUjnJKqpg
jeKWRUkMaVn8rEUjnJKqpg collected $2.15 from pot
jeKWRUkMaVn8rEUjnJKqpg: doesn't show hand 
*** SUMMARY ***
Total pot $2.25 | Rake $0.10 
Board [Ah 4c Kh 8h]
Seat 2: jeKWRUkMaVn8rEUjnJKqpg (big blind) collected ($2.15)
Seat 3: 7cv+9Zc9HIQHNvYsMfV3uA folded before Flop (didn't bet)
Seat 4: KRWTiGM4xH+MkvPtJz4+SA folded before Flop (didn't bet)
Seat 5: hIss79a4pu7GzJZepfgOpg folded before Flop (didn't bet)
Seat 6: 1S/fpm+f42V/6MNZre+ccg (button) folded on the Turn
Seat 7: HVKi9hnDyvzObpL08/OarQ (small blind) folded on the Turn




PokerStars Game #59939661054:  Hold'em No Limit ($0.10/$0.25) - 2009/07/01 0:45:38 ET
Table '5SUMWYuPsGiOD0FY0QbgOw' 6-max Seat #2 is the button
Seat 1: pq78iqNUnoL9mPwPKXxOzg ($13.20 in chips) 
Seat 2: wKFJ513ucluNNiMlkXcDOQ ($25 in chips) 
Seat 3: JUE7yMMP0aN5jzhYbdqO6Q ($27.30 in chips) 
Seat 4: hln5cQA1YXs/ERC2LEyoSA ($11.95 in chips) 
Seat 5: v+QfkGiuj9bgtuNoVnDO8w ($29.65 in chips) 
Seat 6: jA7YMtfNUnAaebB7Lj74EA ($26.60 in chips) 
JUE7yMMP0aN5jzhYbdqO6Q: posts small blind $0.10
hln5cQA1YXs/ERC2LEyoSA: posts big blind $0.25
*** HOLE CARDS ***
v+QfkGiuj9bgtuNoVnDO8w: folds 
jA7YMtfNUnAaebB7Lj74EA: calls $0.25
pq78iqNUnoL9mPwPKXxOzg: folds 
wKFJ513ucluNNiMlkXcDOQ: folds 
JUE7yMMP0aN5jzhYbdqO6Q: raises $0.25 to $0.50
hln5cQA1YXs/ERC2LEyoSA: calls $0.25
jA7YMtfNUnAaebB7Lj74EA: raises $0.25 to $0.75
JUE7yMMP0aN5jzhYbdqO6Q: calls $0.25
hln5cQA1YXs/ERC2LEyoSA: calls $0.25
*** FLOP *** [4h 4s Ks]
JUE7yMMP0aN5jzhYbdqO6Q: checks 
hln5cQA1YXs/ERC2LEyoSA: checks 
jA7YMtfNUnAaebB7Lj74EA: bets $0.50
JUE7yMMP0aN5jzhYbdqO6Q: folds 
hln5cQA1YXs/ERC2LEyoSA: folds 
Uncalled bet ($0.50) returned to jA7YMtfNUnAaebB7Lj74EA
jA7YMtfNUnAaebB7Lj74EA collected $2.15 from pot
*** SUMMARY ***
Total pot $2.25 | Rake $0.10 
Board [4h 4s Ks]
Seat 1: pq78iqNUnoL9mPwPKXxOzg folded before Flop (didn't bet)
Seat 2: wKFJ513ucluNNiMlkXcDOQ (button) folded before Flop (didn't bet)
Seat 3: JUE7yMMP0aN5jzhYbdqO6Q (small blind) folded on the Flop
Seat 4: hln5cQA1YXs/ERC2LEyoSA (big blind) folded on the Flop
Seat 5: v+QfkGiuj9bgtuNoVnDO8w folded before Flop (didn't bet)
Seat 6: jA7YMtfNUnAaebB7Lj74EA collected ($2.15)




PokerStars Game #59939661222:  Hold'em No Limit ($0.10/$0.25) - 2009/07/01 0:45:38 ET
Table 'dNYnr4D4id1jwnEU66Yowg' 9-max Seat #6 is the button
Seat 1: 41pZ+Uce9oq+8wmcVBXWIg ($20.10 in chips) 
Seat 2: +twYdIw+izmdFyX5TTFzjg ($15 in chips) 
Seat 4: d9fERE+24v0MqnylCrXchQ ($8.45 in chips) 
Seat 6: Lu6miJBtf3FVzUdzCWEtqQ ($17 in chips) 
Seat 8: sv2dZaqHRlfCDrW63Guhvg ($5.60 in chips) 
sv2dZaqHRlfCDrW63Guhvg: posts small blind $0.10
41pZ+Uce9oq+8wmcVBXWIg: posts big blind $0.25
+twYdIw+izmdFyX5TTFzjg: posts big blind $0.25
*** HOLE CARDS ***
+twYdIw+izmdFyX5TTFzjg: checks 
d9fERE+24v0MqnylCrXchQ: folds 
Lu6miJBtf3FVzUdzCWEtqQ: folds 
sv2dZaqHRlfCDrW63Guhvg: calls $0.15
41pZ+Uce9oq+8wmcVBXWIg: checks 
*** FLOP *** [8d 4h Th]
sv2dZaqHRlfCDrW63Guhvg: checks 
41pZ+Uce9oq+8wmcVBXWIg: checks 
+twYdIw+izmdFyX5TTFzjg: bets $0.75
sv2dZaqHRlfCDrW63Guhvg: folds 
41pZ+Uce9oq+8wmcVBXWIg: folds 
Uncalled bet ($0.75) returned to +twYdIw+izmdFyX5TTFzjg
+twYdIw+izmdFyX5TTFzjg collected $0.75 from pot
*** SUMMARY ***
Total pot $0.75 | Rake $0 
Board [8d 4h Th]
Seat 1: 41pZ+Uce9oq+8wmcVBXWIg (big blind) folded on the Flop
Seat 2: +twYdIw+izmdFyX5TTFzjg collected ($0.75)
Seat 4: d9fERE+24v0MqnylCrXchQ folded before Flop (didn't bet)
Seat 6: Lu6miJBtf3FVzUdzCWEtqQ (button) folded before Flop (didn't bet)
Seat 8: sv2dZaqHRlfCDrW63Guhvg (small blind) folded on the Flop




PokerStars Game #59939660914:  Hold'em No Limit ($0.10/$0.25) - 2009/07/01 0:45:38 ET
Table 'jItkp2PNTbH9Cf7gqsAF7g' 9-max Seat #7 is the button
Seat 1: OiV1PWZ3IkN29JlmCcnTwQ ($5.75 in chips) 
Seat 2: qwr38jl5txoR36M7G5qi4A ($7.50 in chips) 
Seat 3: E0iYnEVO2ho7dH3QcCjw7g ($23.10 in chips) 
Seat 4: GQTWTgG7Ydy9q/vohVnKmQ ($30.85 in chips) 
Seat 5: uH1RN27w9SKa7TpVR9EFrQ ($20.10 in chips) 
Seat 6: cZ99hugmLBj9KhTlc8nCSw ($59.10 in chips) 
Seat 7: st9jtdNbm1W5GfBwRaCVqQ ($20.35 in chips) 
Seat 8: t82lXIS9gxYmNHmDgWRFAQ ($10.95 in chips) 
t82lXIS9gxYmNHmDgWRFAQ: posts small blind $0.10
OiV1PWZ3IkN29JlmCcnTwQ: posts big blind $0.25
*** HOLE CARDS ***
qwr38jl5txoR36M7G5qi4A: folds 
E0iYnEVO2ho7dH3QcCjw7g: folds 
GQTWTgG7Ydy9q/vohVnKmQ: folds 
uH1RN27w9SKa7TpVR9EFrQ: folds 
cZ99hugmLBj9KhTlc8nCSw: folds 
st9jtdNbm1W5GfBwRaCVqQ: folds 
t82lXIS9gxYmNHmDgWRFAQ: raises $0.25 to $0.50
OiV1PWZ3IkN29JlmCcnTwQ: folds 
Uncalled bet ($0.25) returned to t82lXIS9gxYmNHmDgWRFAQ
t82lXIS9gxYmNHmDgWRFAQ collected $0.50 from pot
*** SUMMARY ***
Total pot $0.50 | Rake $0 
Seat 1: OiV1PWZ3IkN29JlmCcnTwQ (big blind) folded before Flop
Seat 2: qwr38jl5txoR36M7G5qi4A folded before Flop (didn't bet)
Seat 3: E0iYnEVO2ho7dH3QcCjw7g folded before Flop (didn't bet)
Seat 4: GQTWTgG7Ydy9q/vohVnKmQ folded before Flop (didn't bet)
Seat 5: uH1RN27w9SKa7TpVR9EFrQ folded before Flop (didn't bet)
Seat 6: cZ99hugmLBj9KhTlc8nCSw folded before Flop (didn't bet)
Seat 7: st9jtdNbm1W5GfBwRaCVqQ (button) folded before Flop (didn't bet)
Seat 8: t82lXIS9gxYmNHmDgWRFAQ (small blind) collected ($0.50)




PokerStars Game #59939660978:  Hold'em No Limit ($0.10/$0.25) - 2009/07/01 0:45:38 ET
Table '8QBBaev+cI2i/r2H6ml/lg' 9-max Seat #4 is the button
Seat 4: ZoG0obuajzVjwgd7lNHjgg ($4.30 in chips) 
Seat 6: cxE+szmvEUe7vE+z2ozM2Q ($10.80 in chips) 
ZoG0obuajzVjwgd7lNHjgg: posts small blind $0.10
cxE+szmvEUe7vE+z2ozM2Q: posts big blind $0.25
*** HOLE CARDS ***
ZoG0obuajzVjwgd7lNHjgg: raises $0.50 to $0.75
cxE+szmvEUe7vE+z2ozM2Q: calls $0.50
*** FLOP *** [Tc Ac 4s]
cxE+szmvEUe7vE+z2ozM2Q: checks 
Ml2bY77EHbM51ZWD7dnIWg leaves the table
ZoG0obuajzVjwgd7lNHjgg: bets $0.75
cxE+szmvEUe7vE+z2ozM2Q: folds 
Uncalled bet ($0.75) returned to ZoG0obuajzVjwgd7lNHjgg
ZoG0obuajzVjwgd7lNHjgg collected $1.45 from pot
*** SUMMARY ***
Total pot $1.50 | Rake $0.05 
Board [Tc Ac 4s]
Seat 4: ZoG0obuajzVjwgd7lNHjgg (button) (small blind) collected ($1.45)
Seat 6: cxE+szmvEUe7vE+z2ozM2Q (big blind) folded on the Flop




PokerStars Game #59939660906:  Hold'em No Limit ($0.10/$0.25) - 2009/07/01 0:45:38 ET
Table 'G26g8jde1eR+mmabeFeSlw' 9-max Seat #5 is the button
Seat 1: eygIcrabyU9hI2mw7NQsgg ($22.50 in chips) 
Seat 2: O2aLEhH7P83nWGvgV84KoA ($13.50 in chips) 
Seat 3: WKL8nUFr7TumC4EjLyqYzw ($5 in chips) 
Seat 4: 1Clf3cPrqoy/YgvWdWK1Xw ($10.25 in chips) 
Seat 5: hJ4uYjNmSZdjrKA8cjZqCA ($19.80 in chips) 
Seat 6: opOCI2p6kW0tINuVaAqmcQ ($25 in chips) 
Seat 7: nm4Dj/f+jJEwKVsUnKh73g ($26.25 in chips) 
Seat 8: G+6mJ0LVzvA9qwETH4Ostw ($25.40 in chips) 
Seat 9: VWUWpMLMj/Q1jRVpF7Aohw ($12.10 in chips) 
opOCI2p6kW0tINuVaAqmcQ: posts small blind $0.10
nm4Dj/f+jJEwKVsUnKh73g: posts big blind $0.25
*** HOLE CARDS ***
G+6mJ0LVzvA9qwETH4Ostw: folds 
VWUWpMLMj/Q1jRVpF7Aohw: raises $0.75 to $1
G+6mJ0LVzvA9qwETH4Ostw leaves the table
eygIcrabyU9hI2mw7NQsgg: folds 
O2aLEhH7P83nWGvgV84KoA: folds 
22dIObOuor/A+IKWkNoAlA joins the table at seat #8 
WKL8nUFr7TumC4EjLyqYzw: folds 
1Clf3cPrqoy/YgvWdWK1Xw: folds 
hJ4uYjNmSZdjrKA8cjZqCA: folds 
opOCI2p6kW0tINuVaAqmcQ: folds 
nm4Dj/f+jJEwKVsUnKh73g: raises $1.50 to $2.50
VWUWpMLMj/Q1jRVpF7Aohw: calls $1.50
*** FLOP *** [3s 9c 4c]
nm4Dj/f+jJEwKVsUnKh73g: checks 
VWUWpMLMj/Q1jRVpF7Aohw: checks 
*** TURN *** [3s 9c 4c] [Qh]
nm4Dj/f+jJEwKVsUnKh73g: bets $5
VWUWpMLMj/Q1jRVpF7Aohw: folds 
Uncalled bet ($5) returned to nm4Dj/f+jJEwKVsUnKh73g
nm4Dj/f+jJEwKVsUnKh73g collected $4.85 from pot
nm4Dj/f+jJEwKVsUnKh73g: doesn't show hand 
*** SUMMARY ***
Total pot $5.10 | Rake $0.25 
Board [3s 9c 4c Qh]
Seat 1: eygIcrabyU9hI2mw7NQsgg folded before Flop (didn't bet)
Seat 2: O2aLEhH7P83nWGvgV84KoA folded before Flop (didn't bet)
Seat 3: WKL8nUFr7TumC4EjLyqYzw folded before Flop (didn't bet)
Seat 4: 1Clf3cPrqoy/YgvWdWK1Xw folded before Flop (didn't bet)
Seat 5: hJ4uYjNmSZdjrKA8cjZqCA (button) folded before Flop (didn't bet)
Seat 6: opOCI2p6kW0tINuVaAqmcQ (small blind) folded before Flop
Seat 7: nm4Dj/f+jJEwKVsUnKh73g (big blind) collected ($4.85)
Seat 8: G+6mJ0LVzvA9qwETH4Ostw folded before Flop (didn't bet)
Seat 9: VWUWpMLMj/Q1jRVpF7Aohw folded on the Turn




PokerStars Game #59939661564:  Hold'em No Limit ($0.10/$0.25) - 2009/07/01 0:45:39 ET
Table '0w9m+UkNlGMNoPyQqzWk6A' 9-max Seat #9 is the button
Seat 1: 28AHlgXlrYLdiBUJNBoqWA ($21.80 in chips) 
Seat 2: tYsOBqdU1+x+yFI7zHO7hQ ($46.20 in chips) 
Seat 3: VWwtMkIjXloiX/RKh7RGWQ ($10.40 in chips) 
Seat 5: rPXwQUVloUl+qZm3CCtaJw ($16.75 in chips) 
Seat 6: sWBBy1WroEskLNyJzhkUag ($20.55 in chips) 
Seat 7: lrTLp1zpuCCs/e0pi2M8jw ($7.40 in chips) 
Seat 8: hPhp/RE3cJ5YGaQ2xOHXXg ($4.15 in chips) 
Seat 9: 56S3mA6Zs3pGR+0p0vUCtg ($27.80 in chips) 
28AHlgXlrYLdiBUJNBoqWA: posts small blind $0.10
tYsOBqdU1+x+yFI7zHO7hQ: posts big blind $0.25
VBHxUExRAMrbxUq/cVx9Gw: sits out 
*** HOLE CARDS ***
VWwtMkIjXloiX/RKh7RGWQ: calls $0.25
rPXwQUVloUl+qZm3CCtaJw: calls $0.25
sWBBy1WroEskLNyJzhkUag: folds 
lrTLp1zpuCCs/e0pi2M8jw: folds 
hPhp/RE3cJ5YGaQ2xOHXXg: folds 
56S3mA6Zs3pGR+0p0vUCtg: folds 
28AHlgXlrYLdiBUJNBoqWA: calls $0.15
tYsOBqdU1+x+yFI7zHO7hQ: checks 
*** FLOP *** [Kd 4d Kc]
28AHlgXlrYLdiBUJNBoqWA: folds 
28AHlgXlrYLdiBUJNBoqWA leaves the table
tYsOBqdU1+x+yFI7zHO7hQ: checks 
VWwtMkIjXloiX/RKh7RGWQ: checks 
rPXwQUVloUl+qZm3CCtaJw: checks 
*** TURN *** [Kd 4d Kc] [3s]
tYsOBqdU1+x+yFI7zHO7hQ: checks 
VWwtMkIjXloiX/RKh7RGWQ: checks 
DnDcAdn9P0zGovMERigpFA joins the table at seat #1 
rPXwQUVloUl+qZm3CCtaJw: checks 
*** RIVER *** [Kd 4d Kc 3s] [5h]
tYsOBqdU1+x+yFI7zHO7hQ: checks 
VWwtMkIjXloiX/RKh7RGWQ: bets $0.75
rPXwQUVloUl+qZm3CCtaJw: folds 
tYsOBqdU1+x+yFI7zHO7hQ: folds 
Uncalled bet ($0.75) returned to VWwtMkIjXloiX/RKh7RGWQ
VWwtMkIjXloiX/RKh7RGWQ collected $0.95 from pot
VWwtMkIjXloiX/RKh7RGWQ: doesn't show hand 
*** SUMMARY ***
Total pot $1 | Rake $0.05 
Board [Kd 4d Kc 3s 5h]
Seat 1: 28AHlgXlrYLdiBUJNBoqWA (small blind) folded on the Flop
Seat 2: tYsOBqdU1+x+yFI7zHO7hQ (big blind) folded on the River
Seat 3: VWwtMkIjXloiX/RKh7RGWQ collected ($0.95)
Seat 5: rPXwQUVloUl+qZm3CCtaJw folded on the River
Seat 6: sWBBy1WroEskLNyJzhkUag folded before Flop (didn't bet)
Seat 7: lrTLp1zpuCCs/e0pi2M8jw folded before Flop (didn't bet)
Seat 8: hPhp/RE3cJ5YGaQ2xOHXXg folded before Flop (didn't bet)
Seat 9: 56S3mA6Zs3pGR+0p0vUCtg (button) folded before Flop (didn't bet)




PokerStars Game #59939661568:  Hold'em No Limit ($0.10/$0.25) - 2009/07/01 0:45:39 ET
Table 'MRfAiS/4JSfnUDlCcZo0wAhfHe8uKeSJMyWAjSdM7ROQx Seat #6 is the button
Seat 1: 48oT5xFI+5CHUJlfoGrE4w ($14.20 in chips) 
Seat 2: /gJNBeCkWL4o85/jvlZ4BA ($36.45 in chips) 
Seat 3: FYepjhAvF8ZdVCmqHIy+eQ ($45.15 in chips) 
Seat 4: Go8clNIDGP3feVvzBDG4pg ($14.80 in chips) 
Seat 5: qccGLncfUaN00Few5HsgYg ($29.35 in chips) 
Seat 6: VaDPspfGS2lnEkaGNrNqfg ($12.90 in chips) 
48oT5xFI+5CHUJlfoGrE4w: posts small blind $0.10
/gJNBeCkWL4o85/jvlZ4BA: posts big blind $0.25
*** HOLE CARDS ***
FYepjhAvF8ZdVCmqHIy+eQ: folds 
Go8clNIDGP3feVvzBDG4pg: raises $1 to $1.25
qccGLncfUaN00Few5HsgYg: folds 
VaDPspfGS2lnEkaGNrNqfg: folds 
48oT5xFI+5CHUJlfoGrE4w: folds 
/gJNBeCkWL4o85/jvlZ4BA: folds 
Uncalled bet ($1) returned to Go8clNIDGP3feVvzBDG4pg
Go8clNIDGP3feVvzBDG4pg collected $0.60 from pot
Go8clNIDGP3feVvzBDG4pg: doesn't show hand 
*** SUMMARY ***
Total pot $0.60 | Rake $0 
Seat 1: 48oT5xFI+5CHUJlfoGrE4w (small blind) folded before Flop
Seat 2: /gJNBeCkWL4o85/jvlZ4BA (big blind) folded before Flop
Seat 3: FYepjhAvF8ZdVCmqHIy+eQ folded before Flop (didn't bet)
Seat 4: Go8clNIDGP3feVvzBDG4pg collected ($0.60)
Seat 5: qccGLncfUaN00Few5HsgYg folded before Flop (didn't bet)
Seat 6: VaDPspfGS2lnEkaGNrNqfg (button) folded before Flop (didn't bet)




PokerStars Game #59939661876:  Hold'em No Limit ($0.10/$0.25) - 2009/07/01 0:45:39 ET
Table 'sJ4KpS2GE5Qrsu1/cFjJUw' 9-max Seat #7 is the button
Seat 1: QsLvCwfSWqP+CfjwUnjpXQ ($16.70 in chips) 
Seat 3: eDil7UzSZCjyh1VP6SVXJQ ($13.75 in chips) 
Seat 5: FZrgDbxAanC1xwZxXHJKVA ($5.80 in chips) 
Seat 6: OefE+Csvj5KR7ClGf3Hc2g ($4.40 in chips) 
Seat 7: e4TN7vqqXBH+vGq4fHdZ3A ($5 in chips) 
Seat 8: f8ixGbSVIs6Be0mH69ldVQ ($5.55 in chips) 
f8ixGbSVIs6Be0mH69ldVQ: posts small blind $0.10
QsLvCwfSWqP+CfjwUnjpXQ: posts big blind $0.25
*** HOLE CARDS ***
eDil7UzSZCjyh1VP6SVXJQ: calls $0.25
FZrgDbxAanC1xwZxXHJKVA: calls $0.25
OefE+Csvj5KR7ClGf3Hc2g: calls $0.25
e4TN7vqqXBH+vGq4fHdZ3A: calls $0.25
f8ixGbSVIs6Be0mH69ldVQ: calls $0.15
QsLvCwfSWqP+CfjwUnjpXQ: checks 
*** FLOP *** [Jc 7s 4d]
f8ixGbSVIs6Be0mH69ldVQ: checks 
QsLvCwfSWqP+CfjwUnjpXQ: checks 
eDil7UzSZCjyh1VP6SVXJQ: checks 
FZrgDbxAanC1xwZxXHJKVA: checks 
OefE+Csvj5KR7ClGf3Hc2g: checks 
e4TN7vqqXBH+vGq4fHdZ3A: checks 
*** TURN *** [Jc 7s 4d] [6d]
f8ixGbSVIs6Be0mH69ldVQ: checks 
QsLvCwfSWqP+CfjwUnjpXQ: checks 
eDil7UzSZCjyh1VP6SVXJQ: checks 
FZrgDbxAanC1xwZxXHJKVA: checks 
OefE+Csvj5KR7ClGf3Hc2g: checks 
e4TN7vqqXBH+vGq4fHdZ3A: checks 
*** RIVER *** [Jc 7s 4d 6d] [4s]
f8ixGbSVIs6Be0mH69ldVQ: bets $0.50
QsLvCwfSWqP+CfjwUnjpXQ: folds 
eDil7UzSZCjyh1VP6SVXJQ: folds 
FZrgDbxAanC1xwZxXHJKVA: folds 
OefE+Csvj5KR7ClGf3Hc2g: folds 
e4TN7vqqXBH+vGq4fHdZ3A: folds 
Uncalled bet ($0.50) returned to f8ixGbSVIs6Be0mH69ldVQ
f8ixGbSVIs6Be0mH69ldVQ collected $1.45 from pot
f8ixGbSVIs6Be0mH69ldVQ: doesn't show hand 
*** SUMMARY ***
Total pot $1.50 | Rake $0.05 
Board [Jc 7s 4d 6d 4s]
Seat 1: QsLvCwfSWqP+CfjwUnjpXQ (big blind) folded on the River
Seat 3: eDil7UzSZCjyh1VP6SVXJQ folded on the River
Seat 5: FZrgDbxAanC1xwZxXHJKVA folded on the River
Seat 6: OefE+Csvj5KR7ClGf3Hc2g folded on the River
Seat 7: e4TN7vqqXBH+vGq4fHdZ3A (button) folded on the River
Seat 8: f8ixGbSVIs6Be0mH69ldVQ (small blind) collected ($1.45)




PokerStars Game #59939662160:  Hold'em No Limit ($0.10/$0.25) - 2009/07/01 0:45:40 ET
Table '9HJEqVOjSU5ECoVB4C4sgQ' 6-max Seat #5 is the button
Seat 1: SFmT9ZsVopnukjvAzrxTRg ($25 in chips) 
Seat 2: sEQx9G5Cu8k1HNdQasxvUA ($42.25 in chips) 
Seat 3: KM6ogk7SqyRlk3m9b0h+7A ($13.20 in chips) 
Seat 4: mfrkWA3PTeYPkbO6hi98Aw ($30.45 in chips) 
Seat 5: uH0CnA501RcgzNdK3N+BWw ($14.95 in chips) 
Seat 6: aOMbOQ6Ji1Gie6dYOurd5A ($8.65 in chips) 
aOMbOQ6Ji1Gie6dYOurd5A: posts small blind $0.10
SFmT9ZsVopnukjvAzrxTRg: posts big blind $0.25
*** HOLE CARDS ***
sEQx9G5Cu8k1HNdQasxvUA: raises $0.50 to $0.75
KM6ogk7SqyRlk3m9b0h+7A: calls $0.75
mfrkWA3PTeYPkbO6hi98Aw: folds 
uH0CnA501RcgzNdK3N+BWw: folds 
aOMbOQ6Ji1Gie6dYOurd5A: calls $0.65
SFmT9ZsVopnukjvAzrxTRg: folds 
*** FLOP *** [6h 6c 9h]
aOMbOQ6Ji1Gie6dYOurd5A: checks 
sEQx9G5Cu8k1HNdQasxvUA: bets $2
KM6ogk7SqyRlk3m9b0h+7A: raises $2 to $4
aOMbOQ6Ji1Gie6dYOurd5A: folds 
sEQx9G5Cu8k1HNdQasxvUA: calls $2
*** TURN *** [6h 6c 9h] [2d]
sEQx9G5Cu8k1HNdQasxvUA: checks 
KM6ogk7SqyRlk3m9b0h+7A: bets $4
sEQx9G5Cu8k1HNdQasxvUA: folds 
Uncalled bet ($4) returned to KM6ogk7SqyRlk3m9b0h+7A
KM6ogk7SqyRlk3m9b0h+7A collected $10 from pot
KM6ogk7SqyRlk3m9b0h+7A: doesn't show hand 
*** SUMMARY ***
Total pot $10.50 | Rake $0.50 
Board [6h 6c 9h 2d]
Seat 1: SFmT9ZsVopnukjvAzrxTRg (big blind) folded before Flop
Seat 2: sEQx9G5Cu8k1HNdQasxvUA folded on the Turn
Seat 3: KM6ogk7SqyRlk3m9b0h+7A collected ($10)
Seat 4: mfrkWA3PTeYPkbO6hi98Aw folded before Flop (didn't bet)
Seat 5: uH0CnA501RcgzNdK3N+BWw (button) folded before Flop (didn't bet)
Seat 6: aOMbOQ6Ji1Gie6dYOurd5A (small blind) folded on the Flop




PokerStars Game #59939662262:  Hold'em No Limit ($0.10/$0.25) - 2009/07/01 0:45:40 ET
Table 'fIMYcWwN4/aXFJvH5Z8Ymg' 6-max Seat #3 is the button
Seat 1: 64ZeDpsBsP594VsWmafRTQ ($8.20 in chips) 
Seat 2: vu2kzHaDtgr6NM7rdq0chA ($28.90 in chips) 
Seat 3: bWbV4MVB/vVpiES1Ut4hew ($46.25 in chips) 
Seat 4: 32YL2ZEp8NT4JB2RVM9euQ ($42.65 in chips) 
Seat 5: 9jSiy0meE9XJKkdIZwyTEQ ($32.05 in chips) 
Seat 6: jp34e617tIzV8tKIWmfAbA ($25 in chips) 
32YL2ZEp8NT4JB2RVM9euQ: posts small blind $0.10
9jSiy0meE9XJKkdIZwyTEQ: posts big blind $0.25
*** HOLE CARDS ***
jp34e617tIzV8tKIWmfAbA: calls $0.25
64ZeDpsBsP594VsWmafRTQ: folds 
vu2kzHaDtgr6NM7rdq0chA: folds 
bWbV4MVB/vVpiES1Ut4hew: folds 
32YL2ZEp8NT4JB2RVM9euQ: folds 
9jSiy0meE9XJKkdIZwyTEQ: checks 
*** FLOP *** [7h 6h 9h]
9jSiy0meE9XJKkdIZwyTEQ: checks 
jp34e617tIzV8tKIWmfAbA: bets $0.50
9jSiy0meE9XJKkdIZwyTEQ: folds 
Uncalled bet ($0.50) returned to jp34e617tIzV8tKIWmfAbA
jp34e617tIzV8tKIWmfAbA collected $0.60 from pot
jp34e617tIzV8tKIWmfAbA: doesn't show hand 
*** SUMMARY ***
Total pot $0.60 | Rake $0 
Board [7h 6h 9h]
Seat 1: 64ZeDpsBsP594VsWmafRTQ folded before Flop (didn't bet)
Seat 2: vu2kzHaDtgr6NM7rdq0chA folded before Flop (didn't bet)
Seat 3: bWbV4MVB/vVpiES1Ut4hew (button) folded before Flop (didn't bet)
Seat 4: 32YL2ZEp8NT4JB2RVM9euQ (small blind) folded before Flop
Seat 5: 9jSiy0meE9XJKkdIZwyTEQ (big blind) folded on the Flop
Seat 6: jp34e617tIzV8tKIWmfAbA collected ($0.60)




PokerStars Game #59939661998:  Hold'em No Limit ($0.10/$0.25) - 2009/07/01 0:45:40 ET
Table 'VuY5ej47Cy8nOI3Wogmhzw' 6-max Seat #6 is the button
Seat 1: aXzmR7FhrqQSWNNmNfbVnw ($18.35 in chips) 
Seat 2: j0aDOn9Nft1HLTQvGu1UwA ($4.80 in chips) 
Seat 3: s1D1gIXwINNo65XoAlN55g ($13.75 in chips) 
Seat 4: FC6tJ9EOiutXO8hnpR4VgQ ($3.65 in chips) 
Seat 6: +v0nBUereMsRzYp2Knh/cQ ($17.80 in chips) 
aXzmR7FhrqQSWNNmNfbVnw: posts small blind $0.10
j0aDOn9Nft1HLTQvGu1UwA: posts big blind $0.25
eSKnWz2RD4rvwnvB+rFzIg: sits out 
*** HOLE CARDS ***
s1D1gIXwINNo65XoAlN55g: folds 
FC6tJ9EOiutXO8hnpR4VgQ: folds 
+v0nBUereMsRzYp2Knh/cQ: calls $0.25
aXzmR7FhrqQSWNNmNfbVnw: calls $0.15
j0aDOn9Nft1HLTQvGu1UwA: raises $0.50 to $0.75
+v0nBUereMsRzYp2Knh/cQ: calls $0.50
aXzmR7FhrqQSWNNmNfbVnw: folds 
*** FLOP *** [7c Jh Kc]
FC6tJ9EOiutXO8hnpR4VgQ leaves the table
j0aDOn9Nft1HLTQvGu1UwA: bets $0.75
+v0nBUereMsRzYp2Knh/cQ: calls $0.75
*** TURN *** [7c Jh Kc] [9d]
j0aDOn9Nft1HLTQvGu1UwA: bets $0.75
+v0nBUereMsRzYp2Knh/cQ: calls $0.75
*** RIVER *** [7c Jh Kc 9d] [6h]
j0aDOn9Nft1HLTQvGu1UwA: bets $2
+v0nBUereMsRzYp2Knh/cQ: calls $2
*** SHOW DOWN ***
j0aDOn9Nft1HLTQvGu1UwA: shows [Ah Tc] (high card Ace)
+v0nBUereMsRzYp2Knh/cQ: shows [Kd 4c] (a pair of Kings)
+v0nBUereMsRzYp2Knh/cQ collected $8.35 from pot
*** SUMMARY ***
Total pot $8.75 | Rake $0.40 
Board [7c Jh Kc 9d 6h]
Seat 1: aXzmR7FhrqQSWNNmNfbVnw (small blind) folded before Flop
Seat 2: j0aDOn9Nft1HLTQvGu1UwA (big blind) showed [Ah Tc] and lost with high card Ace
Seat 3: s1D1gIXwINNo65XoAlN55g folded before Flop (didn't bet)
Seat 4: FC6tJ9EOiutXO8hnpR4VgQ folded before Flop (didn't bet)
Seat 6: +v0nBUereMsRzYp2Knh/cQ (button) showed [Kd 4c] and won ($8.35) with a pair of Kings




PokerStars Game #59939662970:  Hold'em No Limit ($0.10/$0.25) - 2009/07/01 0:45:41 ET
Table 'ORSZkZqq+7Ja2PdeCFAytA' 9-max Seat #5 is the button
Seat 1: Gpa8cld5y0mdOomHJgHhlA ($4.25 in chips) 
Seat 4: PJJTm/ccITEBlwPReiBTwg ($10 in chips) 
Seat 5: fOv1xoqR8m9slwElVu7Y+A ($17.70 in chips) 
Gpa8cld5y0mdOomHJgHhlA: posts small blind $0.10
PJJTm/ccITEBlwPReiBTwg: posts big blind $0.25
*** HOLE CARDS ***
fOv1xoqR8m9slwElVu7Y+A: raises $0.25 to $0.50
Gpa8cld5y0mdOomHJgHhlA: folds 
PJJTm/ccITEBlwPReiBTwg: folds 
Uncalled bet ($0.25) returned to fOv1xoqR8m9slwElVu7Y+A
fOv1xoqR8m9slwElVu7Y+A collected $0.60 from pot
fOv1xoqR8m9slwElVu7Y+A: doesn't show hand 
*** SUMMARY ***
Total pot $0.60 | Rake $0 
Seat 1: Gpa8cld5y0mdOomHJgHhlA (small blind) folded before Flop
Seat 4: PJJTm/ccITEBlwPReiBTwg (big blind) folded before Flop
Seat 5: fOv1xoqR8m9slwElVu7Y+A (button) collected ($0.60)




PokerStars Game #59939663020:  Hold'em No Limit ($0.10/$0.25) - 2009/07/01 0:45:41 ET
Table '8UiaYOdeBwzanG6w1SMeFg' 9-max Seat #4 is the button
Seat 2: 18G4P1XstjNvItdGUITxgw ($25 in chips) 
Seat 3: A7xJNkBMCQG6Zuocn2v8YQ ($16.65 in chips) 
Seat 4: H5Se03ZqSX7tbULXur2MAg ($28.75 in chips) 
Seat 5: UmzixCpC0bAc1lDEjgB3NQ ($19.85 in chips) 
Seat 6: N6fYvIzQLKaydFLKQGtMlQ ($23.30 in chips) 
Seat 7: E0iYnEVO2ho7dH3QcCjw7g ($21.25 in chips) 
Seat 8: hBMUlEpyU74r/fwDgIpXjQ ($53.40 in chips) 
UmzixCpC0bAc1lDEjgB3NQ: posts small blind $0.10
N6fYvIzQLKaydFLKQGtMlQ: posts big blind $0.25
K4All-In: sits out 
CYkY0dNBaYaKs8HVCVn3mQ: sits out 
*** HOLE CARDS ***
E0iYnEVO2ho7dH3QcCjw7g: raises $0.75 to $1
hBMUlEpyU74r/fwDgIpXjQ: folds 
18G4P1XstjNvItdGUITxgw: folds 
A7xJNkBMCQG6Zuocn2v8YQ: folds 
H5Se03ZqSX7tbULXur2MAg: folds 
UmzixCpC0bAc1lDEjgB3NQ: calls $0.90
N6fYvIzQLKaydFLKQGtMlQ: folds 
*** FLOP *** [7c Ts 6s]
UmzixCpC0bAc1lDEjgB3NQ: checks 
E0iYnEVO2ho7dH3QcCjw7g: bets $2.25
UmzixCpC0bAc1lDEjgB3NQ has timed out
UmzixCpC0bAc1lDEjgB3NQ: folds 
Uncalled bet ($2.25) returned to E0iYnEVO2ho7dH3QcCjw7g
UmzixCpC0bAc1lDEjgB3NQ is sitting out
E0iYnEVO2ho7dH3QcCjw7g collected $2.15 from pot
UmzixCpC0bAc1lDEjgB3NQ has returned
*** SUMMARY ***
Total pot $2.25 | Rake $0.10 
Board [7c Ts 6s]
Seat 2: 18G4P1XstjNvItdGUITxgw folded before Flop (didn't bet)
Seat 3: A7xJNkBMCQG6Zuocn2v8YQ folded before Flop (didn't bet)
Seat 4: H5Se03ZqSX7tbULXur2MAg (button) folded before Flop (didn't bet)
Seat 5: UmzixCpC0bAc1lDEjgB3NQ (small blind) folded on the Flop
Seat 6: N6fYvIzQLKaydFLKQGtMlQ (big blind) folded before Flop
Seat 7: E0iYnEVO2ho7dH3QcCjw7g collected ($2.15)
Seat 8: hBMUlEpyU74r/fwDgIpXjQ folded before Flop (didn't bet)




PokerStars Game #59939663216:  Hold'em No Limit ($0.10/$0.25) - 2009/07/01 0:45:41 ET
Table 'hOE09W281uSob0XeJmUcRg' 6-max Seat #1 is the button
Seat 1: edio/rLJ06xeZOfLhoL3UA ($32.75 in chips) 
Seat 2: GJsS3gwVwlbyroaWrnjqJg ($25.50 in chips) 
Seat 3: ZnMMHE6UGPdJdhLIYgoXfw ($15.10 in chips) 
Seat 4: TslQs7AQSLbVtr4X8JOOOQ ($19.20 in chips) 
Seat 5: 66a/8+qw1AZLNh63FuclPA ($83.95 in chips) 
Seat 6: x4ZJ8E/TUrtoB7WiHcv8WA ($8 in chips) 
GJsS3gwVwlbyroaWrnjqJg: posts small blind $0.10
ZnMMHE6UGPdJdhLIYgoXfw: posts big blind $0.25
*** HOLE CARDS ***
TslQs7AQSLbVtr4X8JOOOQ: folds 
66a/8+qw1AZLNh63FuclPA: folds 
x4ZJ8E/TUrtoB7WiHcv8WA: calls $0.25
edio/rLJ06xeZOfLhoL3UA: raises $1 to $1.25
GJsS3gwVwlbyroaWrnjqJg: folds 
ZnMMHE6UGPdJdhLIYgoXfw: calls $1
x4ZJ8E/TUrtoB7WiHcv8WA: calls $1
*** FLOP *** [4c Ah Jh]
ZnMMHE6UGPdJdhLIYgoXfw: checks 
x4ZJ8E/TUrtoB7WiHcv8WA: checks 
edio/rLJ06xeZOfLhoL3UA: bets $1.75
ZnMMHE6UGPdJdhLIYgoXfw: raises $1.75 to $3.50
x4ZJ8E/TUrtoB7WiHcv8WA: calls $3.50
edio/rLJ06xeZOfLhoL3UA: folds 
*** TURN *** [4c Ah Jh] [8d]
ZnMMHE6UGPdJdhLIYgoXfw: bets $6
x4ZJ8E/TUrtoB7WiHcv8WA: calls $3.25 and is all-in
Uncalled bet ($2.75) returned to ZnMMHE6UGPdJdhLIYgoXfw
*** RIVER *** [4c Ah Jh 8d] [Js]
*** SHOW DOWN ***
ZnMMHE6UGPdJdhLIYgoXfw: shows [Ac 6h] (two pair, Aces and Jacks)
x4ZJ8E/TUrtoB7WiHcv8WA: mucks hand 
ZnMMHE6UGPdJdhLIYgoXfw collected $18.20 from pot
*** SUMMARY ***
Total pot $19.10 | Rake $0.90 
Board [4c Ah Jh 8d Js]
Seat 1: edio/rLJ06xeZOfLhoL3UA (button) folded on the Flop
Seat 2: GJsS3gwVwlbyroaWrnjqJg (small blind) folded before Flop
Seat 3: ZnMMHE6UGPdJdhLIYgoXfw (big blind) showed [Ac 6h] and won ($18.20) with two pair, Aces and Jacks
Seat 4: TslQs7AQSLbVtr4X8JOOOQ folded before Flop (didn't bet)
Seat 5: 66a/8+qw1AZLNh63FuclPA folded before Flop (didn't bet)
Seat 6: x4ZJ8E/TUrtoB7WiHcv8WA mucked




PokerStars Game #59939662696:  Hold'em No Limit ($0.10/$0.25) - 2009/07/01 0:45:41 ET
Table '2AUmC2Rslg+QUbLfdgNdfg' 6-max Seat #6 is the button
Seat 1: lquriepNQBhDV5P1SWHhnA ($25 in chips) 
Seat 2: CCxAG7iPVlAv3brCqrGBEg ($13.40 in chips) 
Seat 3: iauW7L/+7qzAuHow7CD75Q ($8.95 in chips) 
Seat 4: B6R6e73iyJNddUtXtvYr3Q ($47.95 in chips) 
Seat 5: 8ClCHtFXGNplITm+63KB+Q ($25 in chips) 
Seat 6: BvTq4Tu0zBOsniW3eFCnkQ ($32.95 in chips) 
lquriepNQBhDV5P1SWHhnA: posts small blind $0.10
CCxAG7iPVlAv3brCqrGBEg: posts big blind $0.25
*** HOLE CARDS ***
iauW7L/+7qzAuHow7CD75Q: folds 
B6R6e73iyJNddUtXtvYr3Q: folds 
8ClCHtFXGNplITm+63KB+Q: folds 
BvTq4Tu0zBOsniW3eFCnkQ: folds 
lquriepNQBhDV5P1SWHhnA: folds 
Uncalled bet ($0.15) returned to CCxAG7iPVlAv3brCqrGBEg
CCxAG7iPVlAv3brCqrGBEg collected $0.20 from pot
*** SUMMARY ***
Total pot $0.20 | Rake $0 
Seat 1: lquriepNQBhDV5P1SWHhnA (small blind) folded before Flop
Seat 2: CCxAG7iPVlAv3brCqrGBEg (big blind) collected ($0.20)
Seat 3: iauW7L/+7qzAuHow7CD75Q folded before Flop (didn't bet)
Seat 4: B6R6e73iyJNddUtXtvYr3Q folded before Flop (didn't bet)
Seat 5: 8ClCHtFXGNplITm+63KB+Q folded before Flop (didn't bet)
Seat 6: BvTq4Tu0zBOsniW3eFCnkQ (button) folded before Flop (didn't bet)




PokerStars Game #59939662942:  Hold'em No Limit ($0.10/$0.25) - 2009/07/01 0:45:41 ET
Table '2VkNDXXsBj4bSZw/uK5atw' 6-max Seat #1 is the button
Seat 1: 7FmwVDcdEtxDpHmP4hOXsQ ($25.90 in chips) 
Seat 2: gqW2aBCmrIw65BvwjTFN6Q ($27.70 in chips) 
Seat 3: 8D0jr3B4e++Q/cTSnpHdzg ($15.70 in chips) 
Seat 4: yb6rnd48JuBccThV68VHAQ ($71.55 in chips) 
Seat 5: kyRaCIljYA6l33lSKQfNsg ($24.65 in chips) 
Seat 6: qGHGf/553gQnDoklMRe3tg ($24.90 in chips) 
gqW2aBCmrIw65BvwjTFN6Q: posts small blind $0.10
8D0jr3B4e++Q/cTSnpHdzg: posts big blind $0.25
*** HOLE CARDS ***
yb6rnd48JuBccThV68VHAQ: calls $0.25
kyRaCIljYA6l33lSKQfNsg: folds 
qGHGf/553gQnDoklMRe3tg: folds 
7FmwVDcdEtxDpHmP4hOXsQ: folds 
gqW2aBCmrIw65BvwjTFN6Q: raises $1.25 to $1.50
8D0jr3B4e++Q/cTSnpHdzg: folds 
yb6rnd48JuBccThV68VHAQ: calls $1.25
*** FLOP *** [Js 8s 6d]
gqW2aBCmrIw65BvwjTFN6Q: bets $2.75
yb6rnd48JuBccThV68VHAQ: folds 
Uncalled bet ($2.75) returned to gqW2aBCmrIw65BvwjTFN6Q
gqW2aBCmrIw65BvwjTFN6Q collected $3.10 from pot
gqW2aBCmrIw65BvwjTFN6Q: doesn't show hand 
*** SUMMARY ***
Total pot $3.25 | Rake $0.15 
Board [Js 8s 6d]
Seat 1: 7FmwVDcdEtxDpHmP4hOXsQ (button) folded before Flop (didn't bet)
Seat 2: gqW2aBCmrIw65BvwjTFN6Q (small blind) collected ($3.10)
Seat 3: 8D0jr3B4e++Q/cTSnpHdzg (big blind) folded before Flop
Seat 4: yb6rnd48JuBccThV68VHAQ folded on the Flop
Seat 5: kyRaCIljYA6l33lSKQfNsg folded before Flop (didn't bet)
Seat 6: qGHGf/553gQnDoklMRe3tg folded before Flop (didn't bet)




PokerStars Game #59939663106:  Hold'em No Limit ($0.10/$0.25) - 2009/07/01 0:45:41 ET
Table 'oxYpQNT8OHNCvpMIFi7UoA' 9-max Seat #9 is the button
Seat 1: H5Se03ZqSX7tbULXur2MAg ($24.75 in chips) 
Seat 2: Ofo77cVa49gHqAMfHrrMbw ($12.60 in chips) 
Seat 3: DBWHFmM+iV/PrUG8xKBQ7w ($8.90 in chips) 
Seat 4: ghNKXUBl/H+t83JF079ZBA ($25 in chips) 
Seat 5: SXqVW4Q0evTUVZG6BbUNIA ($34.15 in chips) 
Seat 6: +2kMBNpY4nF1qNCRd8SJLA ($25 in chips) 
Seat 7: yyG4svzOpC1A+sUP/scg6w ($7.95 in chips) 
Seat 8: OlPJsgR4xypSg/w1z7Gyvw ($18.85 in chips) 
Seat 9: KK7jFoJo1TzDCPdsfpPjtw ($41.15 in chips) 
H5Se03ZqSX7tbULXur2MAg: posts small blind $0.10
Ofo77cVa49gHqAMfHrrMbw: posts big blind $0.25
*** HOLE CARDS ***
DBWHFmM+iV/PrUG8xKBQ7w: folds 
ghNKXUBl/H+t83JF079ZBA: folds 
SXqVW4Q0evTUVZG6BbUNIA: folds 
+2kMBNpY4nF1qNCRd8SJLA: folds 
yyG4svzOpC1A+sUP/scg6w: folds 
OlPJsgR4xypSg/w1z7Gyvw: raises $0.75 to $1
KK7jFoJo1TzDCPdsfpPjtw: folds 
H5Se03ZqSX7tbULXur2MAg: folds 
Ofo77cVa49gHqAMfHrrMbw: folds 
Uncalled bet ($0.75) returned to OlPJsgR4xypSg/w1z7Gyvw
OlPJsgR4xypSg/w1z7Gyvw collected $0.60 from pot
OlPJsgR4xypSg/w1z7Gyvw: doesn't show hand 
*** SUMMARY ***
Total pot $0.60 | Rake $0 
Seat 1: H5Se03ZqSX7tbULXur2MAg (small blind) folded before Flop
Seat 2: Ofo77cVa49gHqAMfHrrMbw (big blind) folded before Flop
Seat 3: DBWHFmM+iV/PrUG8xKBQ7w folded before Flop (didn't bet)
Seat 4: ghNKXUBl/H+t83JF079ZBA folded before Flop (didn't bet)
Seat 5: SXqVW4Q0evTUVZG6BbUNIA folded before Flop (didn't bet)
Seat 6: +2kMBNpY4nF1qNCRd8SJLA folded before Flop (didn't bet)
Seat 7: yyG4svzOpC1A+sUP/scg6w folded before Flop (didn't bet)
Seat 8: OlPJsgR4xypSg/w1z7Gyvw collected ($0.60)
Seat 9: KK7jFoJo1TzDCPdsfpPjtw (button) folded before Flop (didn't bet)




PokerStars Game #59939662866:  Hold'em No Limit ($0.10/$0.25) - 2009/07/01 0:45:41 ET
Table 'K/f0NNaoGuhSz5DrzgVw7Q' 9-max Seat #2 is the button
Seat 1: sD+TKtt36XiiN6jqHiLwDA ($24.65 in chips) 
Seat 2: 18G4P1XstjNvItdGUITxgw ($25 in chips) 
Seat 3: VBHxUExRAMrbxUq/cVx9Gw ($5.10 in chips) 
Seat 4: 3L1qKVpA6QZjrddTpoh2zQ ($12.25 in chips) 
Seat 5: DnDcAdn9P0zGovMERigpFA ($30.75 in chips) 
Seat 6: 3PVK0IdMlq2fElkVzzr4bg ($17.60 in chips) 
Seat 7: st9jtdNbm1W5GfBwRaCVqQ ($28.25 in chips) 
Seat 8: E0iYnEVO2ho7dH3QcCjw7g ($19.65 in chips) 
Seat 9: B5Xu8WsfFPfBlsK3fbAtQQ ($8.20 in chips) 
VBHxUExRAMrbxUq/cVx9Gw: posts small blind $0.10
3L1qKVpA6QZjrddTpoh2zQ: posts big blind $0.25
*** HOLE CARDS ***
DnDcAdn9P0zGovMERigpFA: folds 
3PVK0IdMlq2fElkVzzr4bg: folds 
st9jtdNbm1W5GfBwRaCVqQ: folds 
E0iYnEVO2ho7dH3QcCjw7g: folds 
B5Xu8WsfFPfBlsK3fbAtQQ: calls $0.25
sD+TKtt36XiiN6jqHiLwDA: folds 
18G4P1XstjNvItdGUITxgw: folds 
VBHxUExRAMrbxUq/cVx9Gw: folds 
3L1qKVpA6QZjrddTpoh2zQ: checks 
*** FLOP *** [3h Jc 2s]
3L1qKVpA6QZjrddTpoh2zQ: checks 
B5Xu8WsfFPfBlsK3fbAtQQ: checks 
*** TURN *** [3h Jc 2s] [6c]
3L1qKVpA6QZjrddTpoh2zQ: bets $0.75
B5Xu8WsfFPfBlsK3fbAtQQ: folds 
Uncalled bet ($0.75) returned to 3L1qKVpA6QZjrddTpoh2zQ
3L1qKVpA6QZjrddTpoh2zQ collected $0.60 from pot
*** SUMMARY ***
Total pot $0.60 | Rake $0 
Board [3h Jc 2s 6c]
Seat 1: sD+TKtt36XiiN6jqHiLwDA folded before Flop (didn't bet)
Seat 2: 18G4P1XstjNvItdGUITxgw (button) folded before Flop (didn't bet)
Seat 3: VBHxUExRAMrbxUq/cVx9Gw (small blind) folded before Flop
Seat 4: 3L1qKVpA6QZjrddTpoh2zQ (big blind) collected ($0.60)
Seat 5: DnDcAdn9P0zGovMERigpFA folded before Flop (didn't bet)
Seat 6: 3PVK0IdMlq2fElkVzzr4bg folded before Flop (didn't bet)
Seat 7: st9jtdNbm1W5GfBwRaCVqQ folded before Flop (didn't bet)
Seat 8: E0iYnEVO2ho7dH3QcCjw7g folded before Flop (didn't bet)
Seat 9: B5Xu8WsfFPfBlsK3fbAtQQ folded on the Turn




PokerStars Game #59939663762:  Hold'em No Limit ($0.10/$0.25) - 2009/07/01 0:45:42 ET
Table '4ZbiE0ZYjzqmgu6+sO1prg' 9-max Seat #4 is the button
Seat 1: N6fYvIzQLKaydFLKQGtMlQ ($26.70 in chips) 
Seat 2: w31DkWCTQDVIzsHIrFRDxA ($8.40 in chips) 
Seat 3: HPEB+AtKw1+C/cxU0o1ciw ($26.65 in chips) 
Seat 4: Eb2mDXvZ4iY02krYdOYwMA ($28.10 in chips) 
Seat 5: COsrwJSFHQtxlUcrYtDQPQ ($25 in chips) 
Seat 6: rXm4QDVJt67H20lM6n6Z7Q ($7.90 in chips) 
Seat 7: 3RCAkueG3Vc13VpRStCB+w ($25 in chips) 
Seat 8: cZ99hugmLBj9KhTlc8nCSw ($25 in chips) 
COsrwJSFHQtxlUcrYtDQPQ: posts small blind $0.10
rXm4QDVJt67H20lM6n6Z7Q: posts big blind $0.25
*** HOLE CARDS ***
3RCAkueG3Vc13VpRStCB+w: raises $0.50 to $0.75
cZ99hugmLBj9KhTlc8nCSw: folds 
N6fYvIzQLKaydFLKQGtMlQ: folds 
w31DkWCTQDVIzsHIrFRDxA: folds 
HPEB+AtKw1+C/cxU0o1ciw: folds 
Eb2mDXvZ4iY02krYdOYwMA: calls $0.75
COsrwJSFHQtxlUcrYtDQPQ: folds 
rXm4QDVJt67H20lM6n6Z7Q: folds 
*** FLOP *** [5h 6d Kh]
3RCAkueG3Vc13VpRStCB+w: bets $1.25
Eb2mDXvZ4iY02krYdOYwMA: calls $1.25
*** TURN *** [5h 6d Kh] [3s]
3RCAkueG3Vc13VpRStCB+w: bets $3
Eb2mDXvZ4iY02krYdOYwMA: calls $3
*** RIVER *** [5h 6d Kh 3s] [7c]
3RCAkueG3Vc13VpRStCB+w: checks 
Eb2mDXvZ4iY02krYdOYwMA: bets $2
3RCAkueG3Vc13VpRStCB+w: folds 
Uncalled bet ($2) returned to Eb2mDXvZ4iY02krYdOYwMA
Eb2mDXvZ4iY02krYdOYwMA collected $9.85 from pot
Eb2mDXvZ4iY02krYdOYwMA: doesn't show hand 
*** SUMMARY ***
Total pot $10.35 | Rake $0.50 
Board [5h 6d Kh 3s 7c]
Seat 1: N6fYvIzQLKaydFLKQGtMlQ folded before Flop (didn't bet)
Seat 2: w31DkWCTQDVIzsHIrFRDxA folded before Flop (didn't bet)
Seat 3: HPEB+AtKw1+C/cxU0o1ciw folded before Flop (didn't bet)
Seat 4: Eb2mDXvZ4iY02krYdOYwMA (button) collected ($9.85)
Seat 5: COsrwJSFHQtxlUcrYtDQPQ (small blind) folded before Flop
Seat 6: rXm4QDVJt67H20lM6n6Z7Q (big blind) folded before Flop
Seat 7: 3RCAkueG3Vc13VpRStCB+w folded on the River
Seat 8: cZ99hugmLBj9KhTlc8nCSw folded before Flop (didn't bet)




PokerStars Game #59939663642:  Hold'em No Limit ($0.10/$0.25) - 2009/07/01 0:45:42 ET
Table 'nyTW9cVtYentc5V7xU/0jA' 6-max Seat #2 is the button
Seat 1: YfxPRDAWfqnGBhiIEdlTYg ($10.15 in chips) 
Seat 2: 7FmwVDcdEtxDpHmP4hOXsQ ($26.40 in chips) 
Seat 3: kG34n23qFQA3nzdOJTQ1dA ($26.80 in chips) 
Seat 4: NkB3D4eVHHXvB9Edaugc1Q ($14.50 in chips) 
Seat 5: BedjMfrlRfPgSq7CXpPAmg ($28.70 in chips) 
Seat 6: dQJByDqHOLbgqX/HobyAJA ($5.55 in chips) 
kG34n23qFQA3nzdOJTQ1dA: posts small blind $0.10
NkB3D4eVHHXvB9Edaugc1Q: posts big blind $0.25
*** HOLE CARDS ***
BedjMfrlRfPgSq7CXpPAmg: folds 
dQJByDqHOLbgqX/HobyAJA: calls $0.25
YfxPRDAWfqnGBhiIEdlTYg: folds 
7FmwVDcdEtxDpHmP4hOXsQ: folds 
kG34n23qFQA3nzdOJTQ1dA: folds 
NkB3D4eVHHXvB9Edaugc1Q: checks 
*** FLOP *** [6h 6d 2d]
NkB3D4eVHHXvB9Edaugc1Q: bets $0.25
dQJByDqHOLbgqX/HobyAJA: calls $0.25
*** TURN *** [6h 6d 2d] [7h]
NkB3D4eVHHXvB9Edaugc1Q: checks 
dQJByDqHOLbgqX/HobyAJA: checks 
*** RIVER *** [6h 6d 2d 7h] [4s]
NkB3D4eVHHXvB9Edaugc1Q: bets $0.25
dQJByDqHOLbgqX/HobyAJA: calls $0.25
*** SHOW DOWN ***
NkB3D4eVHHXvB9Edaugc1Q: shows [Qc Ah] (a pair of Sixes)
dQJByDqHOLbgqX/HobyAJA: mucks hand 
NkB3D4eVHHXvB9Edaugc1Q collected $1.55 from pot
*** SUMMARY ***
Total pot $1.60 | Rake $0.05 
Board [6h 6d 2d 7h 4s]
Seat 1: YfxPRDAWfqnGBhiIEdlTYg folded before Flop (didn't bet)
Seat 2: 7FmwVDcdEtxDpHmP4hOXsQ (button) folded before Flop (didn't bet)
Seat 3: kG34n23qFQA3nzdOJTQ1dA (small blind) folded before Flop
Seat 4: NkB3D4eVHHXvB9Edaugc1Q (big blind) showed [Qc Ah] and won ($1.55) with a pair of Sixes
Seat 5: BedjMfrlRfPgSq7CXpPAmg folded before Flop (didn't bet)
Seat 6: dQJByDqHOLbgqX/HobyAJA mucked




PokerStars Game #59939663358:  Hold'em No Limit ($0.10/$0.25) - 2009/07/01 0:45:42 ET
Table 'D1Yq70l0nNCyMV6DA42p+Q' 9-max Seat #3 is the button
Seat 1: z5GxcHlYz/GSz6W2uFiTtg ($15.70 in chips) 
Seat 2: OB0uLxxDeISeDjs0cxaocA ($30 in chips) 
Seat 3: j4q3p0lesp63b1gZDwLBZw ($5 in chips) 
Seat 5: gehe91e0IyVT0QU/XBkEyg ($25 in chips) 
Seat 7: 9mw49/JQZ9pj0wFynA329g ($14.70 in chips) 
Seat 8: zDrucyjVn5aeekNEc3cJrA ($24.70 in chips) 
Seat 9: AzwEspKch0yAWegVxdcE9A ($5 in chips) 
VWUWpMLMj/Q1jRVpF7Aohw will be allowed to play after the button
gehe91e0IyVT0QU/XBkEyg: posts small blind $0.10
hetfield_08: is sitting out 
9mw49/JQZ9pj0wFynA329g: posts big blind $0.25
AzwEspKch0yAWegVxdcE9A: posts big blind $0.25
*** HOLE CARDS ***
hetfield_08 leaves the table
zDrucyjVn5aeekNEc3cJrA: folds 
AzwEspKch0yAWegVxdcE9A: checks 
z5GxcHlYz/GSz6W2uFiTtg: calls $0.25
OB0uLxxDeISeDjs0cxaocA: calls $0.25
j4q3p0lesp63b1gZDwLBZw: folds 
gehe91e0IyVT0QU/XBkEyg: folds 
9mw49/JQZ9pj0wFynA329g: checks 
*** FLOP *** [8s 6d Ad]
9mw49/JQZ9pj0wFynA329g: checks 
AzwEspKch0yAWegVxdcE9A: checks 
z5GxcHlYz/GSz6W2uFiTtg: bets $0.75
OB0uLxxDeISeDjs0cxaocA: raises $0.75 to $1.50
9mw49/JQZ9pj0wFynA329g: calls $1.50
AzwEspKch0yAWegVxdcE9A: folds 
z5GxcHlYz/GSz6W2uFiTtg: calls $0.75
*** TURN *** [8s 6d Ad] [6h]
9mw49/JQZ9pj0wFynA329g: checks 
z5GxcHlYz/GSz6W2uFiTtg: bets $0.50
OB0uLxxDeISeDjs0cxaocA: calls $0.50
9mw49/JQZ9pj0wFynA329g: calls $0.50
*** RIVER *** [8s 6d Ad 6h] [5c]
9mw49/JQZ9pj0wFynA329g: checks 
Mr_GlamoRouS joins the table at seat #6 
z5GxcHlYz/GSz6W2uFiTtg: bets $0.50
OB0uLxxDeISeDjs0cxaocA: calls $0.50
9mw49/JQZ9pj0wFynA329g: calls $0.50
*** SHOW DOWN ***
z5GxcHlYz/GSz6W2uFiTtg: shows [As Tc] (two pair, Aces and Sixes)
OB0uLxxDeISeDjs0cxaocA: mucks hand 
9mw49/JQZ9pj0wFynA329g: mucks hand 
z5GxcHlYz/GSz6W2uFiTtg collected $8.20 from pot
*** SUMMARY ***
Total pot $8.60 | Rake $0.40 
Board [8s 6d Ad 6h 5c]
Seat 1: z5GxcHlYz/GSz6W2uFiTtg showed [As Tc] and won ($8.20) with two pair, Aces and Sixes
Seat 2: OB0uLxxDeISeDjs0cxaocA mucked
Seat 3: j4q3p0lesp63b1gZDwLBZw (button) folded before Flop (didn't bet)
Seat 5: gehe91e0IyVT0QU/XBkEyg (small blind) folded before Flop
Seat 7: 9mw49/JQZ9pj0wFynA329g (big blind) mucked
Seat 8: zDrucyjVn5aeekNEc3cJrA folded before Flop (didn't bet)
Seat 9: AzwEspKch0yAWegVxdcE9A folded on the Flop




PokerStars Game #59939663536:  Hold'em No Limit ($0.10/$0.25) - 2009/07/01 0:45:42 ET
Table 'Qr+t8WGovMECkBv+cV1lrg' 6-max Seat #4 is the button
Seat 2: 9h7TNZ1TDGRUJXA6rI+ZTw ($15.10 in chips) 
Seat 3: bjJnMpKgoF+vgHW2f1NCsg ($18.50 in chips) 
Seat 4: 3rlIjSrvbZoI2IILbnetnA ($24.85 in chips) 
Seat 5: iwlxXocltgSdaBmusNXanQ ($23.40 in chips) 
Seat 6: j5NZbEJHsERuXjPHWqc1Nw ($13.50 in chips) 
iwlxXocltgSdaBmusNXanQ: posts small blind $0.10
j5NZbEJHsERuXjPHWqc1Nw: posts big blind $0.25
*** HOLE CARDS ***
9h7TNZ1TDGRUJXA6rI+ZTw: calls $0.25
bjJnMpKgoF+vgHW2f1NCsg: folds 
3rlIjSrvbZoI2IILbnetnA: folds 
3rlIjSrvbZoI2IILbnetnA leaves the table
iwlxXocltgSdaBmusNXanQ: calls $0.15
j5NZbEJHsERuXjPHWqc1Nw: checks 
*** FLOP *** [9d Ah 2s]
1NNFfYMd5Hsphl/FYz9fNA joins the table at seat #4 
iwlxXocltgSdaBmusNXanQ: checks 
j5NZbEJHsERuXjPHWqc1Nw: checks 
9h7TNZ1TDGRUJXA6rI+ZTw: checks 
*** TURN *** [9d Ah 2s] [8c]
iwlxXocltgSdaBmusNXanQ: checks 
j5NZbEJHsERuXjPHWqc1Nw: checks 
9h7TNZ1TDGRUJXA6rI+ZTw: checks 
*** RIVER *** [9d Ah 2s 8c] [6d]
iwlxXocltgSdaBmusNXanQ: checks 
j5NZbEJHsERuXjPHWqc1Nw: checks 
9h7TNZ1TDGRUJXA6rI+ZTw: checks 
*** SHOW DOWN ***
iwlxXocltgSdaBmusNXanQ: shows [6c 7d] (a pair of Sixes)
j5NZbEJHsERuXjPHWqc1Nw: mucks hand 
9h7TNZ1TDGRUJXA6rI+ZTw: mucks hand 
iwlxXocltgSdaBmusNXanQ collected $0.75 from pot
*** SUMMARY ***
Total pot $0.75 | Rake $0 
Board [9d Ah 2s 8c 6d]
Seat 2: 9h7TNZ1TDGRUJXA6rI+ZTw mucked
Seat 3: bjJnMpKgoF+vgHW2f1NCsg folded before Flop (didn't bet)
Seat 4: 3rlIjSrvbZoI2IILbnetnA (button) folded before Flop (didn't bet)
Seat 5: iwlxXocltgSdaBmusNXanQ (small blind) showed [6c 7d] and won ($0.75) with a pair of Sixes
Seat 6: j5NZbEJHsERuXjPHWqc1Nw (big blind) mucked




PokerStars Game #59939664150:  Hold'em No Limit ($0.10/$0.25) - 2009/07/01 0:45:43 ET
Table 'MJ1SB76A4qJrlEa+C5e/8w' 6-max Seat #6 is the button
Seat 2: UA5OsKS3VPaxa7uC8La/kA ($28.65 in chips) 
Seat 3: IrrSNlaIjHnZjG6E7LgmEg ($14.95 in chips) 
Seat 4: 6boOPJDTFiEyZD2WdW0kCA ($13.15 in chips) 
Seat 5: eHsmIvAb2JREg4O6hNPnXg ($7.05 in chips) 
Seat 6: JFIAqU8lCZ0vWwEl4bdGsg ($29.80 in chips) 
UA5OsKS3VPaxa7uC8La/kA: posts small blind $0.10
IrrSNlaIjHnZjG6E7LgmEg: posts big blind $0.25
*** HOLE CARDS ***
6boOPJDTFiEyZD2WdW0kCA: folds 
eHsmIvAb2JREg4O6hNPnXg: raises $0.75 to $1
JFIAqU8lCZ0vWwEl4bdGsg: folds 
UA5OsKS3VPaxa7uC8La/kA: raises $3 to $4
IrrSNlaIjHnZjG6E7LgmEg: folds 
eHsmIvAb2JREg4O6hNPnXg: raises $3.05 to $7.05 and is all-in
UA5OsKS3VPaxa7uC8La/kA: calls $3.05
*** FLOP *** [3c Qs 8c]
*** TURN *** [3c Qs 8c] [2h]
*** RIVER *** [3c Qs 8c 2h] [2s]
*** SHOW DOWN ***
UA5OsKS3VPaxa7uC8La/kA: shows [Kh Ah] (a pair of Deuces)
eHsmIvAb2JREg4O6hNPnXg: shows [Ac As] (two pair, Aces and Deuces)
eHsmIvAb2JREg4O6hNPnXg collected $13.65 from pot
King Erez100 is disconnected 
*** SUMMARY ***
Total pot $14.35 | Rake $0.70 
Board [3c Qs 8c 2h 2s]
Seat 2: UA5OsKS3VPaxa7uC8La/kA (small blind) showed [Kh Ah] and lost with a pair of Deuces
Seat 3: IrrSNlaIjHnZjG6E7LgmEg (big blind) folded before Flop
Seat 4: 6boOPJDTFiEyZD2WdW0kCA folded before Flop (didn't bet)
Seat 5: eHsmIvAb2JREg4O6hNPnXg showed [Ac As] and won ($13.65) with two pair, Aces and Deuces
Seat 6: JFIAqU8lCZ0vWwEl4bdGsg (button) folded before Flop (didn't bet)




PokerStars Game #59939664038:  Hold'em No Limit ($0.10/$0.25) - 2009/07/01 0:45:43 ET
Table 'oZuNsbNJuUyQLGKzQ/4JFg' 6-max Seat #2 is the button
Seat 1: /hq3j+3FbArzS8nEzmqRuw ($12.70 in chips) 
Seat 2: UA5OsKS3VPaxa7uC8La/kA ($29.50 in chips) 
Seat 3: 8ClCHtFXGNplITm+63KB+Q ($33.55 in chips) 
Seat 4: pWN7DVB+VCCiq83kllzEtg ($15.85 in chips) 
Seat 5: IH5lT4+CuQFyy32Qf5ydDw ($15 in chips) 
Seat 6: 34ttqW62uIRrqINCCmLcsw ($22.40 in chips) 
8ClCHtFXGNplITm+63KB+Q: posts small blind $0.10
pWN7DVB+VCCiq83kllzEtg: posts big blind $0.25
*** HOLE CARDS ***
IH5lT4+CuQFyy32Qf5ydDw: folds 
34ttqW62uIRrqINCCmLcsw: calls $0.25
/hq3j+3FbArzS8nEzmqRuw: folds 
UA5OsKS3VPaxa7uC8La/kA: raises $1 to $1.25
8ClCHtFXGNplITm+63KB+Q: folds 
pWN7DVB+VCCiq83kllzEtg: folds 
34ttqW62uIRrqINCCmLcsw: calls $1
*** FLOP *** [4s As 9c]
34ttqW62uIRrqINCCmLcsw: checks 
UA5OsKS3VPaxa7uC8La/kA has timed out
UA5OsKS3VPaxa7uC8La/kA: checks 
*** TURN *** [4s As 9c] [Ac]
34ttqW62uIRrqINCCmLcsw: checks 
UA5OsKS3VPaxa7uC8La/kA: checks 
*** RIVER *** [4s As 9c Ac] [5d]
34ttqW62uIRrqINCCmLcsw: checks 
UA5OsKS3VPaxa7uC8La/kA: checks 
*** SHOW DOWN ***
34ttqW62uIRrqINCCmLcsw: shows [2h 8h] (a pair of Aces)
UA5OsKS3VPaxa7uC8La/kA: shows [Qd Kh] (a pair of Aces - King kicker)
UA5OsKS3VPaxa7uC8La/kA collected $2.75 from pot
*** SUMMARY ***
Total pot $2.85 | Rake $0.10 
Board [4s As 9c Ac 5d]
Seat 1: /hq3j+3FbArzS8nEzmqRuw folded before Flop (didn't bet)
Seat 2: UA5OsKS3VPaxa7uC8La/kA (button) showed [Qd Kh] and won ($2.75) with a pair of Aces
Seat 3: 8ClCHtFXGNplITm+63KB+Q (small blind) folded before Flop
Seat 4: pWN7DVB+VCCiq83kllzEtg (big blind) folded before Flop
Seat 5: IH5lT4+CuQFyy32Qf5ydDw folded before Flop (didn't bet)
Seat 6: 34ttqW62uIRrqINCCmLcsw showed [2h 8h] and lost with a pair of Aces




PokerStars Game #59939664106:  Hold'em No Limit ($0.10/$0.25) - 2009/07/01 0:45:43 ET
Table '3eK1r4Q4BSYFvsKkuTLpIA' 9-max Seat #7 is the button
Seat 1: qwr38jl5txoR36M7G5qi4A ($7.75 in chips) 
Seat 2: 7QzbjWT00wQpau1iqvUmMA ($4.65 in chips) 
Seat 3: 56S3mA6Zs3pGR+0p0vUCtg ($25 in chips) 
Seat 4: S2iyN4Q7njjhguIuE5g1CQ ($24.95 in chips) 
Seat 6: +HvCCmsGSQeatf+GZ9zk8Q ($38.60 in chips) 
Seat 7: GTcLfsDTPqgfHyhY9FNDMw ($7.65 in chips) 
Seat 8: Cni99AOp8W/F0ZWCuHNcIA ($11.25 in chips) 
Seat 9: +sbyWwIcFp9kP0bDtMegfQ ($37.75 in chips) 
Cni99AOp8W/F0ZWCuHNcIA: posts small blind $0.10
+sbyWwIcFp9kP0bDtMegfQ: posts big blind $0.25
*** HOLE CARDS ***
qwr38jl5txoR36M7G5qi4A: folds 
7QzbjWT00wQpau1iqvUmMA: raises $0.75 to $1
56S3mA6Zs3pGR+0p0vUCtg: folds 
S2iyN4Q7njjhguIuE5g1CQ: folds 
+HvCCmsGSQeatf+GZ9zk8Q: folds 
GTcLfsDTPqgfHyhY9FNDMw: folds 
Cni99AOp8W/F0ZWCuHNcIA: folds 
+sbyWwIcFp9kP0bDtMegfQ: folds 
Uncalled bet ($0.75) returned to 7QzbjWT00wQpau1iqvUmMA
7QzbjWT00wQpau1iqvUmMA collected $0.60 from pot
7QzbjWT00wQpau1iqvUmMA: doesn't show hand 
*** SUMMARY ***
Total pot $0.60 | Rake $0 
Seat 1: qwr38jl5txoR36M7G5qi4A folded before Flop (didn't bet)
Seat 2: 7QzbjWT00wQpau1iqvUmMA collected ($0.60)
Seat 3: 56S3mA6Zs3pGR+0p0vUCtg folded before Flop (didn't bet)
Seat 4: S2iyN4Q7njjhguIuE5g1CQ folded before Flop (didn't bet)
Seat 6: +HvCCmsGSQeatf+GZ9zk8Q folded before Flop (didn't bet)
Seat 7: GTcLfsDTPqgfHyhY9FNDMw (button) folded before Flop (didn't bet)
Seat 8: Cni99AOp8W/F0ZWCuHNcIA (small blind) folded before Flop
Seat 9: +sbyWwIcFp9kP0bDtMegfQ (big blind) folded before Flop




PokerStars Game #59939664074:  Hold'em No Limit ($0.10/$0.25) - 2009/07/01 0:45:43 ET
Table 'm+FQg/QP0VP1ZA3V62WtOg' 9-max Seat #1 is the button
Seat 1: qwr38jl5txoR36M7G5qi4A ($7.50 in chips) 
Seat 2: oKO7b50N6TzXbPBr/mcrUA ($21.70 in chips) 
Seat 3: 4oA316mXLIui1QY63GXBUg ($25 in chips) 
Seat 4: 86vbuhJsyH+nbEg5qpDLyQ ($25 in chips) 
Seat 5: DnDcAdn9P0zGovMERigpFA ($25 in chips) 
Seat 6: 0kGr2KqzSs4y4kVqyDiTag ($15.45 in chips) 
Seat 7: MIVCHqCqqlke0Lb0z7glcw ($25.90 in chips) 
Seat 9: ghNKXUBl/H+t83JF079ZBA ($25 in chips) 
oKO7b50N6TzXbPBr/mcrUA: posts small blind $0.10
4oA316mXLIui1QY63GXBUg: posts big blind $0.25
4awUyiDYTgylQKXZ9faBVA: sits out 
*** HOLE CARDS ***
86vbuhJsyH+nbEg5qpDLyQ: folds 
DnDcAdn9P0zGovMERigpFA: folds 
0kGr2KqzSs4y4kVqyDiTag: calls $0.25
MIVCHqCqqlke0Lb0z7glcw: folds 
ghNKXUBl/H+t83JF079ZBA: folds 
qwr38jl5txoR36M7G5qi4A: folds 
oKO7b50N6TzXbPBr/mcrUA: raises $0.75 to $1
4oA316mXLIui1QY63GXBUg: folds 
0kGr2KqzSs4y4kVqyDiTag: calls $0.75
*** FLOP *** [Ah Kh 3h]
oKO7b50N6TzXbPBr/mcrUA: bets $1.75
0kGr2KqzSs4y4kVqyDiTag: calls $1.75
*** TURN *** [Ah Kh 3h] [8h]
oKO7b50N6TzXbPBr/mcrUA: bets $1.75
0kGr2KqzSs4y4kVqyDiTag: raises $1.75 to $3.50
oKO7b50N6TzXbPBr/mcrUA: calls $1.75
*** RIVER *** [Ah Kh 3h 8h] [7c]
oKO7b50N6TzXbPBr/mcrUA: checks 
0kGr2KqzSs4y4kVqyDiTag: bets $3
oKO7b50N6TzXbPBr/mcrUA: calls $3
*** SHOW DOWN ***
0kGr2KqzSs4y4kVqyDiTag: shows [9s As] (a pair of Aces)
oKO7b50N6TzXbPBr/mcrUA: shows [9h Jd] (a flush, Ace high)
oKO7b50N6TzXbPBr/mcrUA collected $17.85 from pot
*** SUMMARY ***
Total pot $18.75 | Rake $0.90 
Board [Ah Kh 3h 8h 7c]
Seat 1: qwr38jl5txoR36M7G5qi4A (button) folded before Flop (didn't bet)
Seat 2: oKO7b50N6TzXbPBr/mcrUA (small blind) showed [9h Jd] and won ($17.85) with a flush, Ace high
Seat 3: 4oA316mXLIui1QY63GXBUg (big blind) folded before Flop
Seat 4: 86vbuhJsyH+nbEg5qpDLyQ folded before Flop (didn't bet)
Seat 5: DnDcAdn9P0zGovMERigpFA folded before Flop (didn't bet)
Seat 6: 0kGr2KqzSs4y4kVqyDiTag showed [9s As] and lost with a pair of Aces
Seat 7: MIVCHqCqqlke0Lb0z7glcw folded before Flop (didn't bet)
Seat 9: ghNKXUBl/H+t83JF079ZBA folded before Flop (didn't bet)




PokerStars Game #59939664302:  Hold'em No Limit ($0.10/$0.25) - 2009/07/01 0:45:43 ET
Table 'FBhJjLqab11/gKu8nyB/tw' 9-max Seat #9 is the button
Seat 1: +sbyWwIcFp9kP0bDtMegfQ ($19.50 in chips) 
Seat 2: 1pwQJV/Xr0GWPRefx/78VQ ($6.05 in chips) 
Seat 3: uy9x0X5l7O+IpGjLa77QgQ ($26.90 in chips) 
Seat 4: OTC1Bh+DhK778Qnsj6D8+A ($24.50 in chips) 
Seat 5: vZGoOTJLQLhkPj4I+LNGig ($45.75 in chips) 
Seat 6: QrNgXJWFdS+POsPJcil4aA ($12.75 in chips) 
Seat 7: 5Fj9JGGxQT7Djr6AyIiBVA ($23.40 in chips) 
Seat 8: 9lE3Zc4pjmKpQK8rDF1aaQ ($26.25 in chips) 
Seat 9: BEIBUu2pIflPrCL+Iks4CQ ($11.80 in chips) 
+sbyWwIcFp9kP0bDtMegfQ: posts small blind $0.10
1pwQJV/Xr0GWPRefx/78VQ: posts big blind $0.25
*** HOLE CARDS ***
uy9x0X5l7O+IpGjLa77QgQ: folds 
OTC1Bh+DhK778Qnsj6D8+A: folds 
vZGoOTJLQLhkPj4I+LNGig: folds 
QrNgXJWFdS+POsPJcil4aA: folds 
5Fj9JGGxQT7Djr6AyIiBVA: folds 
9lE3Zc4pjmKpQK8rDF1aaQ: folds 
BEIBUu2pIflPrCL+Iks4CQ: folds 
+sbyWwIcFp9kP0bDtMegfQ: folds 
Uncalled bet ($0.15) returned to 1pwQJV/Xr0GWPRefx/78VQ
1pwQJV/Xr0GWPRefx/78VQ collected $0.20 from pot
1pwQJV/Xr0GWPRefx/78VQ: doesn't show hand 
*** SUMMARY ***
Total pot $0.20 | Rake $0 
Seat 1: +sbyWwIcFp9kP0bDtMegfQ (small blind) folded before Flop
Seat 2: 1pwQJV/Xr0GWPRefx/78VQ (big blind) collected ($0.20)
Seat 3: uy9x0X5l7O+IpGjLa77QgQ folded before Flop (didn't bet)
Seat 4: OTC1Bh+DhK778Qnsj6D8+A folded before Flop (didn't bet)
Seat 5: vZGoOTJLQLhkPj4I+LNGig folded before Flop (didn't bet)
Seat 6: QrNgXJWFdS+POsPJcil4aA folded before Flop (didn't bet)
Seat 7: 5Fj9JGGxQT7Djr6AyIiBVA folded before Flop (didn't bet)
Seat 8: 9lE3Zc4pjmKpQK8rDF1aaQ folded before Flop (didn't bet)
Seat 9: BEIBUu2pIflPrCL+Iks4CQ (button) folded before Flop (didn't bet)




PokerStars Game #59939664146:  Hold'em No Limit ($0.10/$0.25) - 2009/07/01 0:45:43 ET
Table 'bIGKmJgZehWJ+FAo8b85iw' 9-max Seat #3 is the button
Seat 1: yyG4svzOpC1A+sUP/scg6w ($8.85 in chips) 
Seat 2: Ut3g/kEEdCCbe/gbWrHnDg ($20.15 in chips) 
Seat 3: TeWJxSETzbXGiYKx0y+dtg ($36.05 in chips) 
Seat 4: EJRVVUAJEYLdm1qbO8TzuQ ($8.55 in chips) 
Seat 5: PXXRcmL5z1Ibt+PO2FWHlA ($6.70 in chips) 
Seat 6: H5Se03ZqSX7tbULXur2MAg ($21.70 in chips) 
Seat 7: DdPXdieucQ+n99u1n3A+rQ ($11.45 in chips) 
Seat 8: +2kMBNpY4nF1qNCRd8SJLA ($25 in chips) 
Seat 9: aNpwfA31EREwO+ar4XzBCw ($25 in chips) 
EJRVVUAJEYLdm1qbO8TzuQ: posts small blind $0.10
PXXRcmL5z1Ibt+PO2FWHlA: posts big blind $0.25
*** HOLE CARDS ***
H5Se03ZqSX7tbULXur2MAg: folds 
DdPXdieucQ+n99u1n3A+rQ: folds 
+2kMBNpY4nF1qNCRd8SJLA: folds 
aNpwfA31EREwO+ar4XzBCw: folds 
yyG4svzOpC1A+sUP/scg6w: calls $0.25
Ut3g/kEEdCCbe/gbWrHnDg: folds 
Ut3g/kEEdCCbe/gbWrHnDg is sitting out
TeWJxSETzbXGiYKx0y+dtg: folds 
EJRVVUAJEYLdm1qbO8TzuQ: calls $0.15
PXXRcmL5z1Ibt+PO2FWHlA: checks 
*** FLOP *** [3h As 3d]
EJRVVUAJEYLdm1qbO8TzuQ: checks 
PXXRcmL5z1Ibt+PO2FWHlA: checks 
yyG4svzOpC1A+sUP/scg6w: bets $0.50
EJRVVUAJEYLdm1qbO8TzuQ: folds 
PXXRcmL5z1Ibt+PO2FWHlA: folds 
Uncalled bet ($0.50) returned to yyG4svzOpC1A+sUP/scg6w
yyG4svzOpC1A+sUP/scg6w collected $0.75 from pot
yyG4svzOpC1A+sUP/scg6w: doesn't show hand 
*** SUMMARY ***
Total pot $0.75 | Rake $0 
Board [3h As 3d]
Seat 1: yyG4svzOpC1A+sUP/scg6w collected ($0.75)
Seat 2: Ut3g/kEEdCCbe/gbWrHnDg folded before Flop (didn't bet)
Seat 3: TeWJxSETzbXGiYKx0y+dtg (button) folded before Flop (didn't bet)
Seat 4: EJRVVUAJEYLdm1qbO8TzuQ (small blind) folded on the Flop
Seat 5: PXXRcmL5z1Ibt+PO2FWHlA (big blind) folded on the Flop
Seat 6: H5Se03ZqSX7tbULXur2MAg folded before Flop (didn't bet)
Seat 7: DdPXdieucQ+n99u1n3A+rQ folded before Flop (didn't bet)
Seat 8: +2kMBNpY4nF1qNCRd8SJLA folded before Flop (didn't bet)
Seat 9: aNpwfA31EREwO+ar4XzBCw folded before Flop (didn't bet)




PokerStars Game #59939664202:  Hold'em No Limit ($0.10/$0.25) - 2009/07/01 0:45:43 ET
Table 'GrYi0DZOHD1EvB+qiLExNw' 9-max Seat #8 is the button
Seat 1: 4awUyiDYTgylQKXZ9faBVA ($25.35 in chips) 
Seat 2: Th3FldXKQW6hWVVPahaoOQ ($27.45 in chips) 
Seat 3: 4oA316mXLIui1QY63GXBUg ($25 in chips) 
Seat 4: 0GQg6tdDMBDzY6FKumSo9w ($48.10 in chips) 
Seat 5: cZ99hugmLBj9KhTlc8nCSw ($47.40 in chips) 
Seat 6: H9KUl8cmpLgEpOVDA00bCg ($4.20 in chips) 
Seat 7: 1Clf3cPrqoy/YgvWdWK1Xw ($5.35 in chips) 
Seat 8: nalbG/4/1Z1wQjRDWV7b2w ($8.05 in chips) 
Seat 9: OiV1PWZ3IkN29JlmCcnTwQ ($4.75 in chips) 
OiV1PWZ3IkN29JlmCcnTwQ: posts small blind $0.10
4awUyiDYTgylQKXZ9faBVA: posts big blind $0.25
*** HOLE CARDS ***
Th3FldXKQW6hWVVPahaoOQ: folds 
4oA316mXLIui1QY63GXBUg: folds 
0GQg6tdDMBDzY6FKumSo9w: folds 
cZ99hugmLBj9KhTlc8nCSw: folds 
H9KUl8cmpLgEpOVDA00bCg: folds 
1Clf3cPrqoy/YgvWdWK1Xw: folds 
nalbG/4/1Z1wQjRDWV7b2w: raises $7.80 to $8.05 and is all-in
OiV1PWZ3IkN29JlmCcnTwQ: folds 
4awUyiDYTgylQKXZ9faBVA: folds 
Uncalled bet ($7.80) returned to nalbG/4/1Z1wQjRDWV7b2w
nalbG/4/1Z1wQjRDWV7b2w collected $0.60 from pot
nalbG/4/1Z1wQjRDWV7b2w: doesn't show hand 
*** SUMMARY ***
Total pot $0.60 | Rake $0 
Seat 1: 4awUyiDYTgylQKXZ9faBVA (big blind) folded before Flop
Seat 2: Th3FldXKQW6hWVVPahaoOQ folded before Flop (didn't bet)
Seat 3: 4oA316mXLIui1QY63GXBUg folded before Flop (didn't bet)
Seat 4: 0GQg6tdDMBDzY6FKumSo9w folded before Flop (didn't bet)
Seat 5: cZ99hugmLBj9KhTlc8nCSw folded before Flop (didn't bet)
Seat 6: H9KUl8cmpLgEpOVDA00bCg folded before Flop (didn't bet)
Seat 7: 1Clf3cPrqoy/YgvWdWK1Xw folded before Flop (didn't bet)
Seat 8: nalbG/4/1Z1wQjRDWV7b2w (button) collected ($0.60)
Seat 9: OiV1PWZ3IkN29JlmCcnTwQ (small blind) folded before Flop




PokerStars Game #59939664914:  Hold'em No Limit ($0.10/$0.25) - 2009/07/01 0:45:44 ET
Table '6ae4XiTo6B597KfSSMr8Cg' 9-max Seat #2 is the button
Seat 1: 49YfVBEOwzD3/FVw+dTTBQ ($11.10 in chips) 
Seat 2: 5s3p6yoJBNW438dsyKTP8g ($46.20 in chips) 
Seat 3: yyG4svzOpC1A+sUP/scg6w ($8.95 in chips) 
Seat 4: dfNim92Z6XK1/h5SFW5vDg ($48.75 in chips) 
Seat 6: DlXs37dlX3tb7o/7lYXQSw ($25 in chips) 
Seat 7: 18G4P1XstjNvItdGUITxgw ($25 in chips) 
Seat 8: F7pnn6czNpHvRM55XcA2EA ($25.60 in chips) 
Seat 9: E0iYnEVO2ho7dH3QcCjw7g ($34.70 in chips) 
yyG4svzOpC1A+sUP/scg6w: posts small blind $0.10
dfNim92Z6XK1/h5SFW5vDg: posts big blind $0.25
*** HOLE CARDS ***
DlXs37dlX3tb7o/7lYXQSw: folds 
18G4P1XstjNvItdGUITxgw: raises $0.50 to $0.75
F7pnn6czNpHvRM55XcA2EA: folds 
E0iYnEVO2ho7dH3QcCjw7g: folds 
49YfVBEOwzD3/FVw+dTTBQ: folds 
5s3p6yoJBNW438dsyKTP8g: folds 
yyG4svzOpC1A+sUP/scg6w: folds 
dfNim92Z6XK1/h5SFW5vDg: folds 
Uncalled bet ($0.50) returned to 18G4P1XstjNvItdGUITxgw
18G4P1XstjNvItdGUITxgw collected $0.60 from pot
18G4P1XstjNvItdGUITxgw: doesn't show hand 
*** SUMMARY ***
Total pot $0.60 | Rake $0 
Seat 1: 49YfVBEOwzD3/FVw+dTTBQ folded before Flop (didn't bet)
Seat 2: 5s3p6yoJBNW438dsyKTP8g (button) folded before Flop (didn't bet)
Seat 3: yyG4svzOpC1A+sUP/scg6w (small blind) folded before Flop
Seat 4: dfNim92Z6XK1/h5SFW5vDg (big blind) folded before Flop
Seat 6: DlXs37dlX3tb7o/7lYXQSw folded before Flop (didn't bet)
Seat 7: 18G4P1XstjNvItdGUITxgw collected ($0.60)
Seat 8: F7pnn6czNpHvRM55XcA2EA folded before Flop (didn't bet)
Seat 9: E0iYnEVO2ho7dH3QcCjw7g folded before Flop (didn't bet)




PokerStars Game #59939665098:  Hold'em No Limit ($0.10/$0.25) - 2009/07/01 0:45:44 ET
Table 'NtEQAxCeIK2io1CGtW658g' 6-max Seat #3 is the button
Seat 1: lnOV7k25gyN7L5t5YKTgIg ($16.85 in chips) 
Seat 2: nc79pm0LZRdhncq55evVqA ($26.10 in chips) 
Seat 3: m2yWOKfAxqHoy5DDN87Ttw ($23.40 in chips) 
Seat 4: 8296 ($13.15 in chips) 
Seat 5: FStoHe64SQWqAsjya9pDkQ ($25.45 in chips) 
Seat 6: /gJNBeCkWL4o85/jvlZ4BA ($68.05 in chips) 
8296: posts small blind $0.10
FStoHe64SQWqAsjya9pDkQ: posts big blind $0.25
*** HOLE CARDS ***
/gJNBeCkWL4o85/jvlZ4BA: folds 
lnOV7k25gyN7L5t5YKTgIg: raises $0.50 to $0.75
nc79pm0LZRdhncq55evVqA: folds 
m2yWOKfAxqHoy5DDN87Ttw: folds 
8296: folds 
FStoHe64SQWqAsjya9pDkQ: folds 
Uncalled bet ($0.50) returned to lnOV7k25gyN7L5t5YKTgIg
lnOV7k25gyN7L5t5YKTgIg collected $0.60 from pot
lnOV7k25gyN7L5t5YKTgIg: doesn't show hand 
*** SUMMARY ***
Total pot $0.60 | Rake $0 
Seat 1: lnOV7k25gyN7L5t5YKTgIg collected ($0.60)
Seat 2: nc79pm0LZRdhncq55evVqA folded before Flop (didn't bet)
Seat 3: m2yWOKfAxqHoy5DDN87Ttw (button) folded before Flop (didn't bet)
Seat 4: 8296 (small blind) folded before Flop
Seat 5: FStoHe64SQWqAsjya9pDkQ (big blind) folded before Flop
Seat 6: /gJNBeCkWL4o85/jvlZ4BA folded before Flop (didn't bet)




PokerStars Game #59939664822:  Hold'em No Limit ($0.10/$0.25) - 2009/07/01 0:45:44 ET
Table 'L5GvbdQO5aCZJSE6pyQ8OA' 6-max Seat #4 is the button
Seat 1: FOcO5GvOP3rgvLGPLVkg5g ($31.30 in chips) 
Seat 2: LxehwDpTQ19ph4Qmc78+Pw ($13.40 in chips) 
Seat 3: wKFJ513ucluNNiMlkXcDOQ ($27.45 in chips) 
Seat 4: ErIN0JRL5srYjT6en1f8YQ ($34.25 in chips) 
Seat 6: v+QfkGiuj9bgtuNoVnDO8w ($35.90 in chips) 
4kWQxGbT5FZ1dkPd1bE45Q will be allowed to play after the button
v+QfkGiuj9bgtuNoVnDO8w: posts small blind $0.10
FOcO5GvOP3rgvLGPLVkg5g: posts big blind $0.25
*** HOLE CARDS ***
LxehwDpTQ19ph4Qmc78+Pw: folds 
wKFJ513ucluNNiMlkXcDOQ: folds 
ErIN0JRL5srYjT6en1f8YQ: folds 
v+QfkGiuj9bgtuNoVnDO8w: folds 
Uncalled bet ($0.15) returned to FOcO5GvOP3rgvLGPLVkg5g
FOcO5GvOP3rgvLGPLVkg5g collected $0.20 from pot
*** SUMMARY ***
Total pot $0.20 | Rake $0 
Seat 1: FOcO5GvOP3rgvLGPLVkg5g (big blind) collected ($0.20)
Seat 2: LxehwDpTQ19ph4Qmc78+Pw folded before Flop (didn't bet)
Seat 3: wKFJ513ucluNNiMlkXcDOQ folded before Flop (didn't bet)
Seat 4: ErIN0JRL5srYjT6en1f8YQ (button) folded before Flop (didn't bet)
Seat 6: v+QfkGiuj9bgtuNoVnDO8w (small blind) folded before Flop




PokerStars Game #59939664888:  Hold'em No Limit ($0.10/$0.25) - 2009/07/01 0:45:44 ET
Table 'sm5gqEvXgLbkkE4dryW/5g' 6-max Seat #2 is the button
Seat 1: gaPMxLGp9SOj4Lq6t+/0Ig ($15.40 in chips) 
Seat 2: s13YXIlhF/j3TO0bSnT7bA ($18.45 in chips) 
Seat 4: BedjMfrlRfPgSq7CXpPAmg ($57.65 in chips) 
Seat 5: M+WmDyCD/ZMu/5t6/iH2kw ($67.75 in chips) 
Seat 6: wKFJ513ucluNNiMlkXcDOQ ($27 in chips) 
BedjMfrlRfPgSq7CXpPAmg: posts small blind $0.10
M+WmDyCD/ZMu/5t6/iH2kw: posts big blind $0.25
*** HOLE CARDS ***
wKFJ513ucluNNiMlkXcDOQ: folds 
gaPMxLGp9SOj4Lq6t+/0Ig: folds 
s13YXIlhF/j3TO0bSnT7bA: folds 
BedjMfrlRfPgSq7CXpPAmg: raises $0.50 to $0.75
M+WmDyCD/ZMu/5t6/iH2kw: calls $0.50
*** FLOP *** [Ks 4s Qh]
I1TxPvWj8NfG8orglCinNA has returned
BedjMfrlRfPgSq7CXpPAmg: checks 
M+WmDyCD/ZMu/5t6/iH2kw: checks 
*** TURN *** [Ks 4s Qh] [9c]
BedjMfrlRfPgSq7CXpPAmg: checks 
M+WmDyCD/ZMu/5t6/iH2kw: checks 
*** RIVER *** [Ks 4s Qh 9c] [5s]
BedjMfrlRfPgSq7CXpPAmg: checks 
M+WmDyCD/ZMu/5t6/iH2kw: checks 
*** SHOW DOWN ***
BedjMfrlRfPgSq7CXpPAmg: shows [7s Jd] (high card King)
M+WmDyCD/ZMu/5t6/iH2kw: shows [Th Ah] (high card Ace)
M+WmDyCD/ZMu/5t6/iH2kw collected $1.45 from pot
*** SUMMARY ***
Total pot $1.50 | Rake $0.05 
Board [Ks 4s Qh 9c 5s]
Seat 1: gaPMxLGp9SOj4Lq6t+/0Ig folded before Flop (didn't bet)
Seat 2: s13YXIlhF/j3TO0bSnT7bA (button) folded before Flop (didn't bet)
Seat 4: BedjMfrlRfPgSq7CXpPAmg (small blind) showed [7s Jd] and lost with high card King
Seat 5: M+WmDyCD/ZMu/5t6/iH2kw (big blind) showed [Th Ah] and won ($1.45) with high card Ace
Seat 6: wKFJ513ucluNNiMlkXcDOQ folded before Flop (didn't bet)




PokerStars Game #59939664792:  Hold'em No Limit ($0.10/$0.25) - 2009/07/01 0:45:44 ET
Table 'dZNBGqFYSwfOVZvDJ4VjIQ' 6-max Seat #3 is the button
Seat 3: Mch463E1dxQfVob352za6w ($25 in chips) 
Seat 4: df01R5ThvHspD8FgKmaDvQ ($25.35 in chips) 
Seat 6: VbudEd0ZG+qPwMO9h+hjXw ($19.20 in chips) 
df01R5ThvHspD8FgKmaDvQ: posts small blind $0.10
hZJzYj+7+PvGu6ae1g//sQ: is sitting out 
hZJzYj+7+PvGu6ae1g//sQ leaves the table
VbudEd0ZG+qPwMO9h+hjXw: posts big blind $0.25
o08wk0F4gROLhZS04Iyl3w: sits out 
*** HOLE CARDS ***
3zD3qLXT1bEffAoWGnc7wg joins the table at seat #2 
Mch463E1dxQfVob352za6w: raises $0.50 to $0.75
pitty1199 joins the table at seat #5 
df01R5ThvHspD8FgKmaDvQ: calls $0.65
VbudEd0ZG+qPwMO9h+hjXw: folds 
*** FLOP *** [8c 9s 7h]
df01R5ThvHspD8FgKmaDvQ: checks 
Mch463E1dxQfVob352za6w: checks 
*** TURN *** [8c 9s 7h] [6h]
df01R5ThvHspD8FgKmaDvQ: bets $0.75
Mch463E1dxQfVob352za6w: calls $0.75
*** RIVER *** [8c 9s 7h 6h] [5h]
df01R5ThvHspD8FgKmaDvQ: bets $1.50
Mch463E1dxQfVob352za6w: folds 
Uncalled bet ($1.50) returned to df01R5ThvHspD8FgKmaDvQ
df01R5ThvHspD8FgKmaDvQ collected $3.10 from pot
*** SUMMARY ***
Total pot $3.25 | Rake $0.15 
Board [8c 9s 7h 6h 5h]
Seat 3: Mch463E1dxQfVob352za6w (button) folded on the River
Seat 4: df01R5ThvHspD8FgKmaDvQ (small blind) collected ($3.10)
Seat 6: VbudEd0ZG+qPwMO9h+hjXw (big blind) folded before Flop




PokerStars Game #59939664726:  Hold'em No Limit ($0.10/$0.25) - 2009/07/01 0:45:44 ET
Table '972HGIb0tQN/zRIK4TABEw' 9-max Seat #8 is the button
Seat 1: fHr2+mGa0RFK3qrpZcVUAQ ($10.40 in chips) 
Seat 3: W4TLQcZ2TiM73eIgpIvlGg ($23.90 in chips) 
Seat 4: BnWWUASA3YjU/ovKqaKNpA ($11.45 in chips) 
Seat 5: aY0AWwRTlmJDSHpDxE90Hg ($9.75 in chips) 
Seat 7: qS+jfnNoG75bT+uQ8CKhQA ($11.75 in chips) 
Seat 8: DIBbjEYGs+TVdVgEB/4+3w ($46.65 in chips) 
Seat 9: qUzFLsH4zPL5Zy77O+Qlbw ($2.60 in chips) 
qUzFLsH4zPL5Zy77O+Qlbw: posts small blind $0.10
fHr2+mGa0RFK3qrpZcVUAQ: posts big blind $0.25
*** HOLE CARDS ***
W4TLQcZ2TiM73eIgpIvlGg: folds 
BnWWUASA3YjU/ovKqaKNpA: calls $0.25
aY0AWwRTlmJDSHpDxE90Hg: calls $0.25
qS+jfnNoG75bT+uQ8CKhQA: folds 
rintinton joins the table at seat #6 
DIBbjEYGs+TVdVgEB/4+3w: folds 
qUzFLsH4zPL5Zy77O+Qlbw: calls $0.15
fHr2+mGa0RFK3qrpZcVUAQ: checks 
*** FLOP *** [Jh Ac 5s]
qUzFLsH4zPL5Zy77O+Qlbw: checks 
fHr2+mGa0RFK3qrpZcVUAQ: checks 
BnWWUASA3YjU/ovKqaKNpA: checks 
aY0AWwRTlmJDSHpDxE90Hg: checks 
*** TURN *** [Jh Ac 5s] [3h]
qUzFLsH4zPL5Zy77O+Qlbw: checks 
lc6GpYOW7MM4G+/65wMxXA has returned
fHr2+mGa0RFK3qrpZcVUAQ: checks 
BnWWUASA3YjU/ovKqaKNpA: bets $0.75
aY0AWwRTlmJDSHpDxE90Hg: folds 
qUzFLsH4zPL5Zy77O+Qlbw: folds 
fHr2+mGa0RFK3qrpZcVUAQ: folds 
Uncalled bet ($0.75) returned to BnWWUASA3YjU/ovKqaKNpA
BnWWUASA3YjU/ovKqaKNpA collected $0.95 from pot
BnWWUASA3YjU/ovKqaKNpA: doesn't show hand 
*** SUMMARY ***
Total pot $1 | Rake $0.05 
Board [Jh Ac 5s 3h]
Seat 1: fHr2+mGa0RFK3qrpZcVUAQ (big blind) folded on the Turn
Seat 3: W4TLQcZ2TiM73eIgpIvlGg folded before Flop (didn't bet)
Seat 4: BnWWUASA3YjU/ovKqaKNpA collected ($0.95)
Seat 5: aY0AWwRTlmJDSHpDxE90Hg folded on the Turn
Seat 7: qS+jfnNoG75bT+uQ8CKhQA folded before Flop (didn't bet)
Seat 8: DIBbjEYGs+TVdVgEB/4+3w (button) folded before Flop (didn't bet)
Seat 9: qUzFLsH4zPL5Zy77O+Qlbw (small blind) folded on the Turn




PokerStars Game #59939665240:  Hold'em No Limit ($0.10/$0.25) - 2009/07/01 0:45:45 ET
Table 'AHkg4ChqzcMauBx6Qvz8Nw' 6-max Seat #3 is the button
Seat 2: /bjna2FTN7pPjqYGzmDE0Q ($23.90 in chips) 
Seat 3: wvIIdlbCgePONQwXjx9xzQ ($5.25 in chips) 
Seat 4: N7O9jUEx2YiQn1+yRYTHmw ($41.20 in chips) 
Seat 5: LtASJ9OlkqGrrUKGQlpGAw ($36.70 in chips) 
Seat 6: SFmT9ZsVopnukjvAzrxTRg ($52.70 in chips) 
N7O9jUEx2YiQn1+yRYTHmw: posts small blind $0.10
LtASJ9OlkqGrrUKGQlpGAw: posts big blind $0.25
*** HOLE CARDS ***
picmate leaves the table
SFmT9ZsVopnukjvAzrxTRg: raises $0.75 to $1
/bjna2FTN7pPjqYGzmDE0Q: folds 
wvIIdlbCgePONQwXjx9xzQ: folds 
N7O9jUEx2YiQn1+yRYTHmw: calls $0.90
LtASJ9OlkqGrrUKGQlpGAw: folds 
*** FLOP *** [Ts 2d 9d]
N7O9jUEx2YiQn1+yRYTHmw: checks 
4kWQxGbT5FZ1dkPd1bE45Q joins the table at seat #1 
SFmT9ZsVopnukjvAzrxTRg: bets $1.50
N7O9jUEx2YiQn1+yRYTHmw: folds 
Uncalled bet ($1.50) returned to SFmT9ZsVopnukjvAzrxTRg
SFmT9ZsVopnukjvAzrxTRg collected $2.15 from pot
SFmT9ZsVopnukjvAzrxTRg: doesn't show hand 
*** SUMMARY ***
Total pot $2.25 | Rake $0.10 
Board [Ts 2d 9d]
Seat 2: /bjna2FTN7pPjqYGzmDE0Q folded before Flop (didn't bet)
Seat 3: wvIIdlbCgePONQwXjx9xzQ (button) folded before Flop (didn't bet)
Seat 4: N7O9jUEx2YiQn1+yRYTHmw (small blind) folded on the Flop
Seat 5: LtASJ9OlkqGrrUKGQlpGAw (big blind) folded before Flop
Seat 6: SFmT9ZsVopnukjvAzrxTRg collected ($2.15)




PokerStars Game #59939665296:  Hold'em No Limit ($0.10/$0.25) - 2009/07/01 0:45:45 ET
Table 'nB7Q7zfNfy6ig6DB+rsgWQ' 6-max Seat #4 is the button
Seat 1: ACU3rO57RhDJfAgHTq2ocA ($4.90 in chips) 
Seat 2: g6kf+5FIgWH33PmH6ZecMQ ($14 in chips) 
Seat 3: p3NYOxYhkL7txPRSeXHDeg ($33.15 in chips) 
Seat 4: YZjG5I7FqwMKy06BKVBS7w ($7.95 in chips) 
Seat 5: X0/5h4o4LdHWlM7o/9shzg ($7.75 in chips) 
Seat 6: BYxjLnV1/LL0aZcTbfAOvw ($41.90 in chips) 
X0/5h4o4LdHWlM7o/9shzg: posts small blind $0.10
BYxjLnV1/LL0aZcTbfAOvw: posts big blind $0.25
*** HOLE CARDS ***
ACU3rO57RhDJfAgHTq2ocA: folds 
g6kf+5FIgWH33PmH6ZecMQ: calls $0.25
p3NYOxYhkL7txPRSeXHDeg: calls $0.25
YZjG5I7FqwMKy06BKVBS7w: folds 
X0/5h4o4LdHWlM7o/9shzg: folds 
BYxjLnV1/LL0aZcTbfAOvw: checks 
*** FLOP *** [4h Jc Js]
BYxjLnV1/LL0aZcTbfAOvw: checks 
g6kf+5FIgWH33PmH6ZecMQ: checks 
p3NYOxYhkL7txPRSeXHDeg: checks 
*** TURN *** [4h Jc Js] [Ad]
BYxjLnV1/LL0aZcTbfAOvw: checks 
g6kf+5FIgWH33PmH6ZecMQ: bets $0.75
p3NYOxYhkL7txPRSeXHDeg: calls $0.75
BYxjLnV1/LL0aZcTbfAOvw: folds 
*** RIVER *** [4h Jc Js Ad] [2h]
g6kf+5FIgWH33PmH6ZecMQ: bets $5
p3NYOxYhkL7txPRSeXHDeg: folds 
Uncalled bet ($5) returned to g6kf+5FIgWH33PmH6ZecMQ
g6kf+5FIgWH33PmH6ZecMQ collected $2.25 from pot
g6kf+5FIgWH33PmH6ZecMQ: shows [4d 4c] (a full house, Fours full of Jacks)
*** SUMMARY ***
Total pot $2.35 | Rake $0.10 
Board [4h Jc Js Ad 2h]
Seat 1: ACU3rO57RhDJfAgHTq2ocA folded before Flop (didn't bet)
Seat 2: g6kf+5FIgWH33PmH6ZecMQ collected ($2.25)
Seat 3: p3NYOxYhkL7txPRSeXHDeg folded on the River
Seat 4: YZjG5I7FqwMKy06BKVBS7w (button) folded before Flop (didn't bet)
Seat 5: X0/5h4o4LdHWlM7o/9shzg (small blind) folded before Flop
Seat 6: BYxjLnV1/LL0aZcTbfAOvw (big blind) folded on the Turn




PokerStars Game #59939665226:  Hold'em No Limit ($0.10/$0.25) - 2009/07/01 0:45:45 ET
Table 'biAgO3TKQBU8XcrVAoU5TA' 6-max Seat #3 is the button
Seat 1: i48129QFpEQQ+UN4aNtmww ($14.40 in chips) 
Seat 2: 7qRk4YH4/k/08LgJSv7rBQ ($26.50 in chips) 
Seat 3: 7AHdX4G8gYtDJyNY+wK+6Q ($33.20 in chips) 
Seat 4: 2/AObG8G5tKFCPZ+CdivJQ ($7.85 in chips) 
Seat 5: 6DwBRH+xZ12AAZmeAg+aXw ($25 in chips) 
Seat 6: //i5P+6lSkIyZsqb+ojVQA ($13.70 in chips) 
2/AObG8G5tKFCPZ+CdivJQ: posts small blind $0.10
6DwBRH+xZ12AAZmeAg+aXw: posts big blind $0.25
*** HOLE CARDS ***
//i5P+6lSkIyZsqb+ojVQA: folds 
i48129QFpEQQ+UN4aNtmww: folds 
7qRk4YH4/k/08LgJSv7rBQ: folds 
7AHdX4G8gYtDJyNY+wK+6Q: calls $0.25
2/AObG8G5tKFCPZ+CdivJQ: raises $0.25 to $0.50
6DwBRH+xZ12AAZmeAg+aXw: calls $0.25
7AHdX4G8gYtDJyNY+wK+6Q: calls $0.25
*** FLOP *** [Js 4h Td]
2/AObG8G5tKFCPZ+CdivJQ: checks 
6DwBRH+xZ12AAZmeAg+aXw: checks 
7AHdX4G8gYtDJyNY+wK+6Q: checks 
*** TURN *** [Js 4h Td] [6s]
2/AObG8G5tKFCPZ+CdivJQ: bets $0.25
6DwBRH+xZ12AAZmeAg+aXw: folds 
7AHdX4G8gYtDJyNY+wK+6Q: calls $0.25
*** RIVER *** [Js 4h Td 6s] [5h]
2/AObG8G5tKFCPZ+CdivJQ: bets $0.25
7AHdX4G8gYtDJyNY+wK+6Q: folds 
Uncalled bet ($0.25) returned to 2/AObG8G5tKFCPZ+CdivJQ
2/AObG8G5tKFCPZ+CdivJQ collected $1.95 from pot
*** SUMMARY ***
Total pot $2 | Rake $0.05 
Board [Js 4h Td 6s 5h]
Seat 1: i48129QFpEQQ+UN4aNtmww folded before Flop (didn't bet)
Seat 2: 7qRk4YH4/k/08LgJSv7rBQ folded before Flop (didn't bet)
Seat 3: 7AHdX4G8gYtDJyNY+wK+6Q (button) folded on the River
Seat 4: 2/AObG8G5tKFCPZ+CdivJQ (small blind) collected ($1.95)
Seat 5: 6DwBRH+xZ12AAZmeAg+aXw (big blind) folded on the Turn
Seat 6: //i5P+6lSkIyZsqb+ojVQA folded before Flop (didn't bet)




PokerStars Game #59939665184:  Hold'em No Limit ($0.10/$0.25) - 2009/07/01 0:45:45 ET
Table 'xkqAWQFDrFt4p81M8UsoNw' 9-max Seat #2 is the button
Seat 1: N6fYvIzQLKaydFLKQGtMlQ ($24.65 in chips) 
Seat 2: z5GxcHlYz/GSz6W2uFiTtg ($37.05 in chips) 
Seat 3: HEUqKs2EYYGGXJCepUdL0g ($6 in chips) 
Seat 4: gY+PO8PaVC7pBPH/9HSv6Q ($4.60 in chips) 
Seat 5: OiV1PWZ3IkN29JlmCcnTwQ ($5 in chips) 
Seat 6: Yv4fucyyT28mjx8V5lxKJg ($24.85 in chips) 
Seat 7: MG90wfSJZnOejs/KD3vlQQ ($51.55 in chips) 
Seat 9: Wa7bjLwN7ptOQro84PxQGw ($4.40 in chips) 
HEUqKs2EYYGGXJCepUdL0g: posts small blind $0.10
gY+PO8PaVC7pBPH/9HSv6Q: posts big blind $0.25
s7Q6uNouhe7aE8JdFb9E+A: sits out 
*** HOLE CARDS ***
OiV1PWZ3IkN29JlmCcnTwQ: folds 
Yv4fucyyT28mjx8V5lxKJg: folds 
MG90wfSJZnOejs/KD3vlQQ: folds 
Wa7bjLwN7ptOQro84PxQGw: raises $0.50 to $0.75
N6fYvIzQLKaydFLKQGtMlQ: folds 
z5GxcHlYz/GSz6W2uFiTtg: folds 
HEUqKs2EYYGGXJCepUdL0g: folds 
gY+PO8PaVC7pBPH/9HSv6Q: folds 
Uncalled bet ($0.50) returned to Wa7bjLwN7ptOQro84PxQGw
Wa7bjLwN7ptOQro84PxQGw collected $0.60 from pot
*** SUMMARY ***
Total pot $0.60 | Rake $0 
Seat 1: N6fYvIzQLKaydFLKQGtMlQ folded before Flop (didn't bet)
Seat 2: z5GxcHlYz/GSz6W2uFiTtg (button) folded before Flop (didn't bet)
Seat 3: HEUqKs2EYYGGXJCepUdL0g (small blind) folded before Flop
Seat 4: gY+PO8PaVC7pBPH/9HSv6Q (big blind) folded before Flop
Seat 5: OiV1PWZ3IkN29JlmCcnTwQ folded before Flop (didn't bet)
Seat 6: Yv4fucyyT28mjx8V5lxKJg folded before Flop (didn't bet)
Seat 7: MG90wfSJZnOejs/KD3vlQQ folded before Flop (didn't bet)
Seat 9: Wa7bjLwN7ptOQro84PxQGw collected ($0.60)




PokerStars Game #59939665190:  Hold'em No Limit ($0.10/$0.25) - 2009/07/01 0:45:45 ET
Table 'sDHjMRwfSiz7+NDdZLUiyA' 9-max Seat #5 is the button
Seat 1: N6fYvIzQLKaydFLKQGtMlQ ($24.40 in chips) 
Seat 2: ljemhp25Zg+nlA9DLCIiUw ($27.15 in chips) 
Seat 3: SGA1WpAnQxFdFAYyt362gQ ($15.30 in chips) 
Seat 4: v5jnQ1gfh9nLla3kMXG7Yg ($16.30 in chips) 
Seat 5: IGRfskE1v9H9Bn+fz8AgNQ ($25.70 in chips) 
Seat 6: DlXs37dlX3tb7o/7lYXQSw ($24.75 in chips) 
Seat 7: K0b5wNInj6hUGRr6yzKFtw ($28.90 in chips) 
Seat 8: 3hMkm4U5yTRrkGJkxfijaQ ($28.30 in chips) 
Seat 9: Xpyqpb+DURDWnyJ3xTEIFQ ($41.40 in chips) 
DlXs37dlX3tb7o/7lYXQSw: posts small blind $0.10
K0b5wNInj6hUGRr6yzKFtw: posts big blind $0.25
*** HOLE CARDS ***
3hMkm4U5yTRrkGJkxfijaQ: calls $0.25
Xpyqpb+DURDWnyJ3xTEIFQ: folds 
N6fYvIzQLKaydFLKQGtMlQ: folds 
ljemhp25Zg+nlA9DLCIiUw: folds 
SGA1WpAnQxFdFAYyt362gQ: folds 
v5jnQ1gfh9nLla3kMXG7Yg: folds 
IGRfskE1v9H9Bn+fz8AgNQ: calls $0.25
DlXs37dlX3tb7o/7lYXQSw: folds 
K0b5wNInj6hUGRr6yzKFtw: checks 
*** FLOP *** [Kh Tc 5d]
K0b5wNInj6hUGRr6yzKFtw: checks 
3hMkm4U5yTRrkGJkxfijaQ: checks 
IGRfskE1v9H9Bn+fz8AgNQ: bets $0.75
K0b5wNInj6hUGRr6yzKFtw: folds 
3hMkm4U5yTRrkGJkxfijaQ: folds 
Uncalled bet ($0.75) returned to IGRfskE1v9H9Bn+fz8AgNQ
IGRfskE1v9H9Bn+fz8AgNQ collected $0.85 from pot
IGRfskE1v9H9Bn+fz8AgNQ: doesn't show hand 
*** SUMMARY ***
Total pot $0.85 | Rake $0 
Board [Kh Tc 5d]
Seat 1: N6fYvIzQLKaydFLKQGtMlQ folded before Flop (didn't bet)
Seat 2: ljemhp25Zg+nlA9DLCIiUw folded before Flop (didn't bet)
Seat 3: SGA1WpAnQxFdFAYyt362gQ folded before Flop (didn't bet)
Seat 4: v5jnQ1gfh9nLla3kMXG7Yg folded before Flop (didn't bet)
Seat 5: IGRfskE1v9H9Bn+fz8AgNQ (button) collected ($0.85)
Seat 6: DlXs37dlX3tb7o/7lYXQSw (small blind) folded before Flop
Seat 7: K0b5wNInj6hUGRr6yzKFtw (big blind) folded on the Flop
Seat 8: 3hMkm4U5yTRrkGJkxfijaQ folded on the Flop
Seat 9: Xpyqpb+DURDWnyJ3xTEIFQ folded before Flop (didn't bet)




PokerStars Game #59939665280:  Hold'em No Limit ($0.10/$0.25) - 2009/07/01 0:45:45 ET
Table 'HIOfhT0zga/KonFhIl6O3w' 9-max Seat #5 is the button
Seat 1: t2nb95S5EEFOEzNx9Itz0g ($5.85 in chips) 
Seat 2: er86weqXTpTB6/w2dKlYgA ($16.20 in chips) 
Seat 3: RxrlOCIHB/l30KL6EEws0g ($36.55 in chips) 
Seat 4: qwr38jl5txoR36M7G5qi4A ($7.50 in chips) 
Seat 5: K1MDeapSEyKyGPNZGOKfEg ($17.75 in chips) 
Seat 6: cZ99hugmLBj9KhTlc8nCSw ($26.05 in chips) 
Seat 7: H9KUl8cmpLgEpOVDA00bCg ($5.60 in chips) 
Seat 8: 3RCAkueG3Vc13VpRStCB+w ($25.85 in chips) 
Seat 9: dfNim92Z6XK1/h5SFW5vDg ($25 in chips) 
cZ99hugmLBj9KhTlc8nCSw: posts small blind $0.10
H9KUl8cmpLgEpOVDA00bCg: posts big blind $0.25
*** HOLE CARDS ***
3RCAkueG3Vc13VpRStCB+w: folds 
dfNim92Z6XK1/h5SFW5vDg: folds 
t2nb95S5EEFOEzNx9Itz0g: folds 
er86weqXTpTB6/w2dKlYgA: calls $0.25
RxrlOCIHB/l30KL6EEws0g: folds 
qwr38jl5txoR36M7G5qi4A: folds 
K1MDeapSEyKyGPNZGOKfEg: calls $0.25
cZ99hugmLBj9KhTlc8nCSw: folds 
H9KUl8cmpLgEpOVDA00bCg: checks 
*** FLOP *** [9h Qc As]
H9KUl8cmpLgEpOVDA00bCg: checks 
er86weqXTpTB6/w2dKlYgA: bets $0.25
K1MDeapSEyKyGPNZGOKfEg: calls $0.25
H9KUl8cmpLgEpOVDA00bCg: folds 
*** TURN *** [9h Qc As] [6h]
er86weqXTpTB6/w2dKlYgA: checks 
K1MDeapSEyKyGPNZGOKfEg: checks 
*** RIVER *** [9h Qc As 6h] [Jc]
er86weqXTpTB6/w2dKlYgA: checks 
K1MDeapSEyKyGPNZGOKfEg: checks 
*** SHOW DOWN ***
er86weqXTpTB6/w2dKlYgA: shows [Qs Ac] (two pair, Aces and Queens)
K1MDeapSEyKyGPNZGOKfEg: mucks hand 
er86weqXTpTB6/w2dKlYgA collected $1.30 from pot
*** SUMMARY ***
Total pot $1.35 | Rake $0.05 
Board [9h Qc As 6h Jc]
Seat 1: t2nb95S5EEFOEzNx9Itz0g folded before Flop (didn't bet)
Seat 2: er86weqXTpTB6/w2dKlYgA showed [Qs Ac] and won ($1.30) with two pair, Aces and Queens
Seat 3: RxrlOCIHB/l30KL6EEws0g folded before Flop (didn't bet)
Seat 4: qwr38jl5txoR36M7G5qi4A folded before Flop (didn't bet)
Seat 5: K1MDeapSEyKyGPNZGOKfEg (button) mucked
Seat 6: cZ99hugmLBj9KhTlc8nCSw (small blind) folded before Flop
Seat 7: H9KUl8cmpLgEpOVDA00bCg (big blind) folded on the Flop
Seat 8: 3RCAkueG3Vc13VpRStCB+w folded before Flop (didn't bet)
Seat 9: dfNim92Z6XK1/h5SFW5vDg folded before Flop (didn't bet)




PokerStars Game #59939665676:  Hold'em No Limit ($0.10/$0.25) - 2009/07/01 0:45:45 ET
Table 'IfRHUn9gQQA9I/Z4tn+BoA' 9-max Seat #1 is the button
Seat 1: vSkQm2EelzwRGDDQQk0Fqw ($4.30 in chips) 
Seat 2: V6p0jQ/RhUsqpHLmXvEX4Q ($12.10 in chips) 
Seat 3: iAQDnrJCZVD1LzAGxTYegw ($25.25 in chips) 
Seat 4: QEbIGci+itdw+re8RM5fZA ($25 in chips) 
Seat 5: 10584482 ($17 in chips) 
Seat 6: UOjoGGQ58/uDS7V0xkjOrQ ($7.25 in chips) 
Seat 7: TeWJxSETzbXGiYKx0y+dtg ($36.30 in chips) 
Seat 8: cZ99hugmLBj9KhTlc8nCSw ($25 in chips) 
Seat 9: 7cv+9Zc9HIQHNvYsMfV3uA ($25 in chips) 
V6p0jQ/RhUsqpHLmXvEX4Q: posts small blind $0.10
iAQDnrJCZVD1LzAGxTYegw: posts big blind $0.25
*** HOLE CARDS ***
QEbIGci+itdw+re8RM5fZA: folds 
10584482: calls $0.25
UOjoGGQ58/uDS7V0xkjOrQ: calls $0.25
TeWJxSETzbXGiYKx0y+dtg: folds 
cZ99hugmLBj9KhTlc8nCSw: raises $1 to $1.25
7cv+9Zc9HIQHNvYsMfV3uA: folds 
vSkQm2EelzwRGDDQQk0Fqw: folds 
V6p0jQ/RhUsqpHLmXvEX4Q: raises $2 to $3.25
iAQDnrJCZVD1LzAGxTYegw: folds 
10584482: folds 
UOjoGGQ58/uDS7V0xkjOrQ: folds 
cZ99hugmLBj9KhTlc8nCSw: folds 
Uncalled bet ($2) returned to V6p0jQ/RhUsqpHLmXvEX4Q
V6p0jQ/RhUsqpHLmXvEX4Q collected $3.25 from pot
V6p0jQ/RhUsqpHLmXvEX4Q: doesn't show hand 
*** SUMMARY ***
Total pot $3.25 | Rake $0 
Seat 1: vSkQm2EelzwRGDDQQk0Fqw (button) folded before Flop (didn't bet)
Seat 2: V6p0jQ/RhUsqpHLmXvEX4Q (small blind) collected ($3.25)
Seat 3: iAQDnrJCZVD1LzAGxTYegw (big blind) folded before Flop
Seat 4: QEbIGci+itdw+re8RM5fZA folded before Flop (didn't bet)
Seat 5: 10584482 folded before Flop
Seat 6: UOjoGGQ58/uDS7V0xkjOrQ folded before Flop
Seat 7: TeWJxSETzbXGiYKx0y+dtg folded before Flop (didn't bet)
Seat 8: cZ99hugmLBj9KhTlc8nCSw folded before Flop
Seat 9: 7cv+9Zc9HIQHNvYsMfV3uA folded before Flop (didn't bet)




PokerStars Game #59939666356:  Hold'em No Limit ($0.10/$0.25) - 2009/07/01 0:45:46 ET
Table 'GoBmKm3klK6VavJE4STfmQ' 9-max Seat #4 is the button
Seat 1: N6fYvIzQLKaydFLKQGtMlQ ($19.20 in chips) 
Seat 2: 1c/7DHPx5CDTmAfk8/bWeA ($15.75 in chips) 
Seat 3: 4awUyiDYTgylQKXZ9faBVA ($30.25 in chips) 
Seat 4: H5Se03ZqSX7tbULXur2MAg ($23.95 in chips) 
Seat 5: 8B/dhbQjIWe6ASCdgzktNQ ($25 in chips) 
Seat 6: S3QwXyGCcujfAwNubHpwbw ($6.15 in chips) 
Seat 7: s9a4d23HFxaL70yUWQ0/tQ ($20.40 in chips) 
Seat 8: cZ99hugmLBj9KhTlc8nCSw ($25 in chips) 
8B/dhbQjIWe6ASCdgzktNQ: posts small blind $0.10
S3QwXyGCcujfAwNubHpwbw: posts big blind $0.25
*** HOLE CARDS ***
s9a4d23HFxaL70yUWQ0/tQ: folds 
cZ99hugmLBj9KhTlc8nCSw: folds 
N6fYvIzQLKaydFLKQGtMlQ: raises $1 to $1.25
1c/7DHPx5CDTmAfk8/bWeA: folds 
4awUyiDYTgylQKXZ9faBVA: folds 
H5Se03ZqSX7tbULXur2MAg: folds 
8B/dhbQjIWe6ASCdgzktNQ: folds 
S3QwXyGCcujfAwNubHpwbw: calls $1
*** FLOP *** [8h Ah 5h]
S3QwXyGCcujfAwNubHpwbw: checks 
N6fYvIzQLKaydFLKQGtMlQ: bets $0.75
S3QwXyGCcujfAwNubHpwbw: folds 
Uncalled bet ($0.75) returned to N6fYvIzQLKaydFLKQGtMlQ
N6fYvIzQLKaydFLKQGtMlQ collected $2.50 from pot
*** SUMMARY ***
Total pot $2.60 | Rake $0.10 
Board [8h Ah 5h]
Seat 1: N6fYvIzQLKaydFLKQGtMlQ collected ($2.50)
Seat 2: 1c/7DHPx5CDTmAfk8/bWeA folded before Flop (didn't bet)
Seat 3: 4awUyiDYTgylQKXZ9faBVA folded before Flop (didn't bet)
Seat 4: H5Se03ZqSX7tbULXur2MAg (button) folded before Flop (didn't bet)
Seat 5: 8B/dhbQjIWe6ASCdgzktNQ (small blind) folded before Flop
Seat 6: S3QwXyGCcujfAwNubHpwbw (big blind) folded on the Flop
Seat 7: s9a4d23HFxaL70yUWQ0/tQ folded before Flop (didn't bet)
Seat 8: cZ99hugmLBj9KhTlc8nCSw folded before Flop (didn't bet)




PokerStars Game #59939665812:  Hold'em No Limit ($0.10/$0.25) - 2009/07/01 0:45:46 ET
Table 'nFlmVztKq1HJEWfxmdl15w' 9-max Seat #8 is the button
Seat 2: nPydKI7KXtudhyCkYtLgZA ($5 in chips) 
Seat 3: /XMgGtJ7mcWfe5s7McY9kw ($22 in chips) 
Seat 4: +5dSUwD+/k2ktlnutSMivw ($20.50 in chips) 
Seat 5: Tx6zQdk5Ozt9ObEBlU7jeg ($24.80 in chips) 
Seat 6: 4awUyiDYTgylQKXZ9faBVA ($29.25 in chips) 
Seat 7: Mm1VqYDg+pZQ8ufUXZHA1g ($11.15 in chips) 
Seat 8: +2kMBNpY4nF1qNCRd8SJLA ($25 in chips) 
Seat 9: LSrAei+fS8MYG9ie/GkG0Q ($15.50 in chips) 
LSrAei+fS8MYG9ie/GkG0Q: posts small blind $0.10
COsrwJSFHQtxlUcrYtDQPQ: is sitting out 
COsrwJSFHQtxlUcrYtDQPQ leaves the table
nPydKI7KXtudhyCkYtLgZA: posts big blind $0.25
*** HOLE CARDS ***
cZ99hugmLBj9KhTlc8nCSw joins the table at seat #1 
/XMgGtJ7mcWfe5s7McY9kw: folds 
+5dSUwD+/k2ktlnutSMivw: calls $0.25
Tx6zQdk5Ozt9ObEBlU7jeg: calls $0.25
4awUyiDYTgylQKXZ9faBVA: folds 
Mm1VqYDg+pZQ8ufUXZHA1g: raises $0.25 to $0.50
+2kMBNpY4nF1qNCRd8SJLA: raises $2.25 to $2.75
LSrAei+fS8MYG9ie/GkG0Q: folds 
nPydKI7KXtudhyCkYtLgZA: folds 
+5dSUwD+/k2ktlnutSMivw: folds 
Tx6zQdk5Ozt9ObEBlU7jeg: folds 
Mm1VqYDg+pZQ8ufUXZHA1g: folds 
Uncalled bet ($2.25) returned to +2kMBNpY4nF1qNCRd8SJLA
+2kMBNpY4nF1qNCRd8SJLA collected $1.85 from pot
*** SUMMARY ***
Total pot $1.85 | Rake $0 
Seat 2: nPydKI7KXtudhyCkYtLgZA (big blind) folded before Flop
Seat 3: /XMgGtJ7mcWfe5s7McY9kw folded before Flop (didn't bet)
Seat 4: +5dSUwD+/k2ktlnutSMivw folded before Flop
Seat 5: Tx6zQdk5Ozt9ObEBlU7jeg folded before Flop
Seat 6: 4awUyiDYTgylQKXZ9faBVA folded before Flop (didn't bet)
Seat 7: Mm1VqYDg+pZQ8ufUXZHA1g folded before Flop
Seat 8: +2kMBNpY4nF1qNCRd8SJLA (button) collected ($1.85)
Seat 9: LSrAei+fS8MYG9ie/GkG0Q (small blind) folded before Flop




PokerStars Game #59939666220:  Hold'em No Limit ($0.10/$0.25) - 2009/07/01 0:45:46 ET
Table 'AchTjdLS1zBUbH3ZIx6f0w' 6-max Seat #5 is the button
Seat 1: IzVI+wIP7IS+d0sugIrOPQ ($27.55 in chips) 
Seat 2: kG34n23qFQA3nzdOJTQ1dA ($40.20 in chips) 
Seat 3: ehifenV36yVvJMnV63D3cg ($5.90 in chips) 
Seat 4: q6WfTUAD9mowIP63ASq2Dg ($26.65 in chips) 
Seat 5: oBUDUfeUyCbZBsjxHZgSiw ($37 in chips) 
Seat 6: 5tB0F9NjPSUL4FzmzBMs2Q ($25 in chips) 
5tB0F9NjPSUL4FzmzBMs2Q: posts small blind $0.10
IzVI+wIP7IS+d0sugIrOPQ: posts big blind $0.25
*** HOLE CARDS ***
kG34n23qFQA3nzdOJTQ1dA: folds 
ehifenV36yVvJMnV63D3cg: folds 
q6WfTUAD9mowIP63ASq2Dg: raises $0.75 to $1
oBUDUfeUyCbZBsjxHZgSiw: calls $1
5tB0F9NjPSUL4FzmzBMs2Q: folds 
IzVI+wIP7IS+d0sugIrOPQ: calls $0.75
*** FLOP *** [Ts Ad 4d]
IzVI+wIP7IS+d0sugIrOPQ: checks 
q6WfTUAD9mowIP63ASq2Dg: bets $1.55
oBUDUfeUyCbZBsjxHZgSiw: folds 
IzVI+wIP7IS+d0sugIrOPQ: calls $1.55
*** TURN *** [Ts Ad 4d] [5c]
IzVI+wIP7IS+d0sugIrOPQ: checks 
q6WfTUAD9mowIP63ASq2Dg: bets $0.75
IzVI+wIP7IS+d0sugIrOPQ: calls $0.75
*** RIVER *** [Ts Ad 4d 5c] [5d]
IzVI+wIP7IS+d0sugIrOPQ: checks 
q6WfTUAD9mowIP63ASq2Dg: checks 
*** SHOW DOWN ***
IzVI+wIP7IS+d0sugIrOPQ: shows [Kh Qs] (a pair of Fives)
q6WfTUAD9mowIP63ASq2Dg: shows [Ac Ks] (two pair, Aces and Fives)
q6WfTUAD9mowIP63ASq2Dg collected $7.35 from pot
*** SUMMARY ***
Total pot $7.70 | Rake $0.35 
Board [Ts Ad 4d 5c 5d]
Seat 1: IzVI+wIP7IS+d0sugIrOPQ (big blind) showed [Kh Qs] and lost with a pair of Fives
Seat 2: kG34n23qFQA3nzdOJTQ1dA folded before Flop (didn't bet)
Seat 3: ehifenV36yVvJMnV63D3cg folded before Flop (didn't bet)
Seat 4: q6WfTUAD9mowIP63ASq2Dg showed [Ac Ks] and won ($7.35) with two pair, Aces and Fives
Seat 5: oBUDUfeUyCbZBsjxHZgSiw (button) folded on the Flop
Seat 6: 5tB0F9NjPSUL4FzmzBMs2Q (small blind) folded before Flop




PokerStars Game #59939665912:  Hold'em No Limit ($0.10/$0.25) - 2009/07/01 0:45:46 ET
Table '3Ns9nuTkynfwbBfBXzg6ww' 6-max Seat #1 is the button
Seat 1: KDYsHh8K2SUXXDvLsAhbJQ ($5.90 in chips) 
Seat 3: HyXsCmHsOHAlL2pzZ9IYAg ($4.85 in chips) 
Seat 4: qGHGf/553gQnDoklMRe3tg ($25 in chips) 
Seat 5: kBQU/db00TVAMeomlhblPg ($17.10 in chips) 
Seat 6: ZZm/rg8aThjE+A2LiItuzA ($12.60 in chips) 
zxeVQGaMKDsDzmSY+AInjA will be allowed to play after the button
HyXsCmHsOHAlL2pzZ9IYAg: posts small blind $0.10
qGHGf/553gQnDoklMRe3tg: posts big blind $0.25
*** HOLE CARDS ***
kBQU/db00TVAMeomlhblPg: calls $0.25
ZZm/rg8aThjE+A2LiItuzA: folds 
KDYsHh8K2SUXXDvLsAhbJQ: calls $0.25
HyXsCmHsOHAlL2pzZ9IYAg: calls $0.15
qGHGf/553gQnDoklMRe3tg: raises $1.25 to $1.50
kBQU/db00TVAMeomlhblPg: folds 
KDYsHh8K2SUXXDvLsAhbJQ: calls $1.25
HyXsCmHsOHAlL2pzZ9IYAg: folds 
*** FLOP *** [7c Th 6d]
qGHGf/553gQnDoklMRe3tg: checks 
KDYsHh8K2SUXXDvLsAhbJQ: bets $0.25
qGHGf/553gQnDoklMRe3tg: calls $0.25
*** TURN *** [7c Th 6d] [7d]
qGHGf/553gQnDoklMRe3tg: checks 
KDYsHh8K2SUXXDvLsAhbJQ: bets $0.50
qGHGf/553gQnDoklMRe3tg: calls $0.50
*** RIVER *** [7c Th 6d 7d] [9c]
qGHGf/553gQnDoklMRe3tg: checks 
KDYsHh8K2SUXXDvLsAhbJQ: bets $0.50
qGHGf/553gQnDoklMRe3tg: calls $0.50
*** SHOW DOWN ***
KDYsHh8K2SUXXDvLsAhbJQ: shows [9s Ts] (two pair, Tens and Nines)
qGHGf/553gQnDoklMRe3tg: mucks hand 
KDYsHh8K2SUXXDvLsAhbJQ collected $5.75 from pot
*** SUMMARY ***
Total pot $6 | Rake $0.25 
Board [7c Th 6d 7d 9c]
Seat 1: KDYsHh8K2SUXXDvLsAhbJQ (button) showed [9s Ts] and won ($5.75) with two pair, Tens and Nines
Seat 3: HyXsCmHsOHAlL2pzZ9IYAg (small blind) folded before Flop
Seat 4: qGHGf/553gQnDoklMRe3tg (big blind) mucked
Seat 5: kBQU/db00TVAMeomlhblPg folded before Flop
Seat 6: ZZm/rg8aThjE+A2LiItuzA folded before Flop (didn't bet)




PokerStars Game #59939666394:  Hold'em No Limit ($0.10/$0.25) - 2009/07/01 0:45:46 ET
Table 'zgAizkhIUPUrfr6LqN3ifw' 9-max Seat #8 is the button
Seat 1: st9jtdNbm1W5GfBwRaCVqQ ($25 in chips) 
Seat 2: s7Q6uNouhe7aE8JdFb9E+A ($27.20 in chips) 
Seat 3: hZuGwtYmFKPmQ+v1wlmdfA ($20.60 in chips) 
Seat 5: DdPXdieucQ+n99u1n3A+rQ ($5.15 in chips) 
Seat 6: TeWJxSETzbXGiYKx0y+dtg ($25 in chips) 
Seat 7: 1S/fpm+f42V/6MNZre+ccg ($27.05 in chips) 
Seat 8: MIVCHqCqqlke0Lb0z7glcw ($23.55 in chips) 
7cv+9Zc9HIQHNvYsMfV3uA will be allowed to play after the button
st9jtdNbm1W5GfBwRaCVqQ: posts small blind $0.10
s7Q6uNouhe7aE8JdFb9E+A: posts big blind $0.25
*** HOLE CARDS ***
hZuGwtYmFKPmQ+v1wlmdfA: folds 
DdPXdieucQ+n99u1n3A+rQ: folds 
TeWJxSETzbXGiYKx0y+dtg: folds 
1S/fpm+f42V/6MNZre+ccg: raises $0.50 to $0.75
MIVCHqCqqlke0Lb0z7glcw: folds 
st9jtdNbm1W5GfBwRaCVqQ: folds 
s7Q6uNouhe7aE8JdFb9E+A: folds 
Uncalled bet ($0.50) returned to 1S/fpm+f42V/6MNZre+ccg
1S/fpm+f42V/6MNZre+ccg collected $0.60 from pot
1S/fpm+f42V/6MNZre+ccg: doesn't show hand 
*** SUMMARY ***
Total pot $0.60 | Rake $0 
Seat 1: st9jtdNbm1W5GfBwRaCVqQ (small blind) folded before Flop
Seat 2: s7Q6uNouhe7aE8JdFb9E+A (big blind) folded before Flop
Seat 3: hZuGwtYmFKPmQ+v1wlmdfA folded before Flop (didn't bet)
Seat 5: DdPXdieucQ+n99u1n3A+rQ folded before Flop (didn't bet)
Seat 6: TeWJxSETzbXGiYKx0y+dtg folded before Flop (didn't bet)
Seat 7: 1S/fpm+f42V/6MNZre+ccg collected ($0.60)
Seat 8: MIVCHqCqqlke0Lb0z7glcw (button) folded before Flop (didn't bet)




PokerStars Game #59939666070:  Hold'em No Limit ($0.10/$0.25) - 2009/07/01 0:45:46 ET
Table 'WEMI3Mtn7dGARDbgNrKibgoG007Tb0LYbfANo6QWd16wx Seat #4 is the button
Seat 1: GEZ4LFjiwTFoPklBgpSnlw ($19.60 in chips) 
Seat 2: zDrucyjVn5aeekNEc3cJrA ($21.90 in chips) 
Seat 3: 56S3mA6Zs3pGR+0p0vUCtg ($24.30 in chips) 
Seat 4: oKO7b50N6TzXbPBr/mcrUA ($25 in chips) 
Seat 5: MIVCHqCqqlke0Lb0z7glcw ($24.40 in chips) 
Seat 7: sUVgUtgbfVx6JpvApozwhQ ($5.35 in chips) 
Seat 9: 86vbuhJsyH+nbEg5qpDLyQ ($25.95 in chips) 
MIVCHqCqqlke0Lb0z7glcw: posts small blind $0.10
sUVgUtgbfVx6JpvApozwhQ: posts big blind $0.25
*** HOLE CARDS ***
86vbuhJsyH+nbEg5qpDLyQ: calls $0.25
GEZ4LFjiwTFoPklBgpSnlw: folds 
zDrucyjVn5aeekNEc3cJrA: folds 
56S3mA6Zs3pGR+0p0vUCtg: raises $1 to $1.25
oKO7b50N6TzXbPBr/mcrUA: folds 
MIVCHqCqqlke0Lb0z7glcw: folds 
sUVgUtgbfVx6JpvApozwhQ: folds 
gehe91e0IyVT0QU/XBkEyg joins the table at seat #8 
86vbuhJsyH+nbEg5qpDLyQ: folds 
Uncalled bet ($1) returned to 56S3mA6Zs3pGR+0p0vUCtg
56S3mA6Zs3pGR+0p0vUCtg collected $0.85 from pot
56S3mA6Zs3pGR+0p0vUCtg: doesn't show hand 
*** SUMMARY ***
Total pot $0.85 | Rake $0 
Seat 1: GEZ4LFjiwTFoPklBgpSnlw folded before Flop (didn't bet)
Seat 2: zDrucyjVn5aeekNEc3cJrA folded before Flop (didn't bet)
Seat 3: 56S3mA6Zs3pGR+0p0vUCtg collected ($0.85)
Seat 4: oKO7b50N6TzXbPBr/mcrUA (button) folded before Flop (didn't bet)
Seat 5: MIVCHqCqqlke0Lb0z7glcw (small blind) folded before Flop
Seat 7: sUVgUtgbfVx6JpvApozwhQ (big blind) folded before Flop
Seat 9: 86vbuhJsyH+nbEg5qpDLyQ folded before Flop




PokerStars Game #59939666804:  Hold'em No Limit ($0.10/$0.25) - 2009/07/01 0:45:47 ET
Table 'uFgIyfWPagvEVGEb86da7A' 9-max Seat #4 is the button
Seat 1: 5MgYq10OC5iGoxQFwlJVuw ($15 in chips) 
Seat 2: o3zvoO+PsqGti+1NZGNRrQ ($5.60 in chips) 
Seat 3: q4GZp0xt5Unxtq8PS32SAQ ($35.35 in chips) 
Seat 4: IGRfskE1v9H9Bn+fz8AgNQ ($24.65 in chips) 
Seat 5: V6p0jQ/RhUsqpHLmXvEX4Q ($12.45 in chips) 
Seat 6: zDrucyjVn5aeekNEc3cJrA ($34.30 in chips) 
Seat 9: DnDcAdn9P0zGovMERigpFA ($25 in chips) 
V6p0jQ/RhUsqpHLmXvEX4Q: posts small blind $0.10
zDrucyjVn5aeekNEc3cJrA: posts big blind $0.25
MrPo4/ymXwg9lzPRybrXbA: sits out 
*** HOLE CARDS ***
DnDcAdn9P0zGovMERigpFA: folds 
5MgYq10OC5iGoxQFwlJVuw: folds 
o3zvoO+PsqGti+1NZGNRrQ: folds 
q4GZp0xt5Unxtq8PS32SAQ: raises $0.50 to $0.75
IGRfskE1v9H9Bn+fz8AgNQ: raises $2 to $2.75
V6p0jQ/RhUsqpHLmXvEX4Q: folds 
zDrucyjVn5aeekNEc3cJrA: folds 
q4GZp0xt5Unxtq8PS32SAQ: folds 
Uncalled bet ($2) returned to IGRfskE1v9H9Bn+fz8AgNQ
IGRfskE1v9H9Bn+fz8AgNQ collected $1.85 from pot
IGRfskE1v9H9Bn+fz8AgNQ: doesn't show hand 
*** SUMMARY ***
Total pot $1.85 | Rake $0 
Seat 1: 5MgYq10OC5iGoxQFwlJVuw folded before Flop (didn't bet)
Seat 2: o3zvoO+PsqGti+1NZGNRrQ folded before Flop (didn't bet)
Seat 3: q4GZp0xt5Unxtq8PS32SAQ folded before Flop
Seat 4: IGRfskE1v9H9Bn+fz8AgNQ (button) collected ($1.85)
Seat 5: V6p0jQ/RhUsqpHLmXvEX4Q (small blind) folded before Flop
Seat 6: zDrucyjVn5aeekNEc3cJrA (big blind) folded before Flop
Seat 9: DnDcAdn9P0zGovMERigpFA folded before Flop (didn't bet)




PokerStars Game #59939666696:  Hold'em No Limit ($0.10/$0.25) - 2009/07/01 0:45:47 ET
Table 'f9j+4UOgRPXbyNbQkZFm4w' 6-max Seat #3 is the button
Seat 1: BYxjLnV1/LL0aZcTbfAOvw ($25 in chips) 
Seat 3: wCBHaebpIJ2ZTqigoRi9DA ($21.85 in chips) 
Seat 4: hiTEr3yrERiQp3zHXRioVw ($26.90 in chips) 
Seat 5: 1lxYIAoJdZwAbzIkzWmSkw ($9.65 in chips) 
Seat 6: C84t1kUtjDF/zm38/Dpcng ($14.35 in chips) 
hiTEr3yrERiQp3zHXRioVw: posts small blind $0.10
1lxYIAoJdZwAbzIkzWmSkw: posts big blind $0.25
*** HOLE CARDS ***
Zb8xGmbjS8ghABxs9n6huA joins the table at seat #2 
C84t1kUtjDF/zm38/Dpcng: folds 
BYxjLnV1/LL0aZcTbfAOvw: folds 
wCBHaebpIJ2ZTqigoRi9DA: calls $0.25
hiTEr3yrERiQp3zHXRioVw: folds 
1lxYIAoJdZwAbzIkzWmSkw: checks 
*** FLOP *** [Jc 3c 8h]
1lxYIAoJdZwAbzIkzWmSkw: bets $0.50
wCBHaebpIJ2ZTqigoRi9DA: calls $0.50
*** TURN *** [Jc 3c 8h] [5h]
1lxYIAoJdZwAbzIkzWmSkw: bets $0.50
wCBHaebpIJ2ZTqigoRi9DA: calls $0.50
*** RIVER *** [Jc 3c 8h 5h] [Kc]
1lxYIAoJdZwAbzIkzWmSkw: checks 
wCBHaebpIJ2ZTqigoRi9DA: checks 
*** SHOW DOWN ***
1lxYIAoJdZwAbzIkzWmSkw: shows [8s 9s] (a pair of Eights)
wCBHaebpIJ2ZTqigoRi9DA: mucks hand 
1lxYIAoJdZwAbzIkzWmSkw collected $2.50 from pot
*** SUMMARY ***
Total pot $2.60 | Rake $0.10 
Board [Jc 3c 8h 5h Kc]
Seat 1: BYxjLnV1/LL0aZcTbfAOvw folded before Flop (didn't bet)
Seat 3: wCBHaebpIJ2ZTqigoRi9DA (button) mucked
Seat 4: hiTEr3yrERiQp3zHXRioVw (small blind) folded before Flop
Seat 5: 1lxYIAoJdZwAbzIkzWmSkw (big blind) showed [8s 9s] and won ($2.50) with a pair of Eights
Seat 6: C84t1kUtjDF/zm38/Dpcng folded before Flop (didn't bet)




PokerStars Game #59939666632:  Hold'em No Limit ($0.10/$0.25) - 2009/07/01 0:45:47 ET
Table '/asc7VQ/OpF/oVJ3erB80w' 9-max Seat #6 is the button
Seat 1: OiV1PWZ3IkN29JlmCcnTwQ ($4.90 in chips) 
Seat 2: Th3FldXKQW6hWVVPahaoOQ ($25.45 in chips) 
Seat 3: ie4EwTMMFYxrCXcenJdzsw ($8.50 in chips) 
Seat 4: H9KUl8cmpLgEpOVDA00bCg ($5.25 in chips) 
Seat 5: 8B/dhbQjIWe6ASCdgzktNQ ($25 in chips) 
Seat 6: t2nb95S5EEFOEzNx9Itz0g ($3.80 in chips) 
Seat 7: M2QO2DxB5Wawg2h8HSpnYA ($11.75 in chips) 
Seat 8: T5Hk9oiIr+JDDMnEqwFCrw ($4.80 in chips) 
Seat 9: UkJraTKWQIqFeHOyHQ7afQ ($13.90 in chips) 
M2QO2DxB5Wawg2h8HSpnYA: posts small blind $0.10
T5Hk9oiIr+JDDMnEqwFCrw: posts big blind $0.25
*** HOLE CARDS ***
UkJraTKWQIqFeHOyHQ7afQ: folds 
OiV1PWZ3IkN29JlmCcnTwQ: folds 
Th3FldXKQW6hWVVPahaoOQ: folds 
ie4EwTMMFYxrCXcenJdzsw: folds 
H9KUl8cmpLgEpOVDA00bCg: raises $0.50 to $0.75
8B/dhbQjIWe6ASCdgzktNQ: folds 
t2nb95S5EEFOEzNx9Itz0g: folds 
M2QO2DxB5Wawg2h8HSpnYA: folds 
T5Hk9oiIr+JDDMnEqwFCrw: calls $0.50
*** FLOP *** [Ah 8h Qd]
T5Hk9oiIr+JDDMnEqwFCrw: checks 
H9KUl8cmpLgEpOVDA00bCg: bets $1
T5Hk9oiIr+JDDMnEqwFCrw: calls $1
*** TURN *** [Ah 8h Qd] [9c]
T5Hk9oiIr+JDDMnEqwFCrw: checks 
H9KUl8cmpLgEpOVDA00bCg: bets $3.50 and is all-in
T5Hk9oiIr+JDDMnEqwFCrw: calls $3.05 and is all-in
Uncalled bet ($0.45) returned to H9KUl8cmpLgEpOVDA00bCg
*** RIVER *** [Ah 8h Qd 9c] [Ts]
*** SHOW DOWN ***
T5Hk9oiIr+JDDMnEqwFCrw: shows [Ad As] (three of a kind, Aces)
H9KUl8cmpLgEpOVDA00bCg: mucks hand 
T5Hk9oiIr+JDDMnEqwFCrw collected $9.25 from pot
*** SUMMARY ***
Total pot $9.70 | Rake $0.45 
Board [Ah 8h Qd 9c Ts]
Seat 1: OiV1PWZ3IkN29JlmCcnTwQ folded before Flop (didn't bet)
Seat 2: Th3FldXKQW6hWVVPahaoOQ folded before Flop (didn't bet)
Seat 3: ie4EwTMMFYxrCXcenJdzsw folded before Flop (didn't bet)
Seat 4: H9KUl8cmpLgEpOVDA00bCg mucked
Seat 5: 8B/dhbQjIWe6ASCdgzktNQ folded before Flop (didn't bet)
Seat 6: t2nb95S5EEFOEzNx9Itz0g (button) folded before Flop (didn't bet)
Seat 7: M2QO2DxB5Wawg2h8HSpnYA (small blind) folded before Flop
Seat 8: T5Hk9oiIr+JDDMnEqwFCrw (big blind) showed [Ad As] and won ($9.25) with three of a kind, Aces
Seat 9: UkJraTKWQIqFeHOyHQ7afQ folded before Flop (didn't bet)




PokerStars Game #59939666548:  Hold'em No Limit ($0.10/$0.25) - 2009/07/01 0:45:47 ET
Table 'Rv0EYnRU8WwZiwx0Zo3X3w' 9-max Seat #7 is the button
Seat 1: opOCI2p6kW0tINuVaAqmcQ ($52.95 in chips) 
Seat 2: Xpyqpb+DURDWnyJ3xTEIFQ ($28.75 in chips) 
Seat 3: STkR8XvpjNv79OOMhrlh2w ($25.60 in chips) 
Seat 4: IDkfbfxTm9KJ+DMyGVH8rw ($12.25 in chips) 
Seat 5: h4ggJZYBXV0mEZzYPYKfeA ($21.80 in chips) 
Seat 6: 5hAPbqNrvJb8PtLiceXtlg ($14.65 in chips) 
Seat 7: Th3FldXKQW6hWVVPahaoOQ ($38.15 in chips) 
Seat 8: 10vzP4r6ldwGLbYHKd9www ($13.75 in chips) 
Seat 9: r1pFKMwWp74QwhfPWJOAyw ($6.60 in chips) 
10vzP4r6ldwGLbYHKd9www: posts small blind $0.10
r1pFKMwWp74QwhfPWJOAyw: posts big blind $0.25
*** HOLE CARDS ***
opOCI2p6kW0tINuVaAqmcQ: folds 
Xpyqpb+DURDWnyJ3xTEIFQ: folds 
STkR8XvpjNv79OOMhrlh2w: folds 
IDkfbfxTm9KJ+DMyGVH8rw: folds 
h4ggJZYBXV0mEZzYPYKfeA: folds 
5hAPbqNrvJb8PtLiceXtlg: folds 
Th3FldXKQW6hWVVPahaoOQ: raises $0.50 to $0.75
10vzP4r6ldwGLbYHKd9www: folds 
r1pFKMwWp74QwhfPWJOAyw: folds 
Uncalled bet ($0.50) returned to Th3FldXKQW6hWVVPahaoOQ
Th3FldXKQW6hWVVPahaoOQ collected $0.60 from pot
Th3FldXKQW6hWVVPahaoOQ: doesn't show hand 
*** SUMMARY ***
Total pot $0.60 | Rake $0 
Seat 1: opOCI2p6kW0tINuVaAqmcQ folded before Flop (didn't bet)
Seat 2: Xpyqpb+DURDWnyJ3xTEIFQ folded before Flop (didn't bet)
Seat 3: STkR8XvpjNv79OOMhrlh2w folded before Flop (didn't bet)
Seat 4: IDkfbfxTm9KJ+DMyGVH8rw folded before Flop (didn't bet)
Seat 5: h4ggJZYBXV0mEZzYPYKfeA folded before Flop (didn't bet)
Seat 6: 5hAPbqNrvJb8PtLiceXtlg folded before Flop (didn't bet)
Seat 7: Th3FldXKQW6hWVVPahaoOQ (button) collected ($0.60)
Seat 8: 10vzP4r6ldwGLbYHKd9www (small blind) folded before Flop
Seat 9: r1pFKMwWp74QwhfPWJOAyw (big blind) folded before Flop




PokerStars Game #59939667444:  Hold'em No Limit ($0.10/$0.25) - 2009/07/01 0:45:48 ET
Table 'ZiwAqg4o02gNro+JOAaFNg6wawJ+MkkvuC3coG6r+YhgSeat #1 is the button
Seat 1: j4q3p0lesp63b1gZDwLBZw ($10.50 in chips) 
Seat 2: tYsOBqdU1+x+yFI7zHO7hQ ($31.80 in chips) 
Seat 3: aNpwfA31EREwO+ar4XzBCw ($25 in chips) 
Seat 4: FJflwqC6fqOpM3j0q8Bptw ($21.95 in chips) 
Seat 5: 5hAPbqNrvJb8PtLiceXtlg6HoFYfVGBefsR5Vrz62qIw9.15 in chips) 
Seat 6: hBMUlEpyU74r/fwDgIpXjQ ($27.95 in chips) 
Seat 7: opOCI2p6kW0tINuVaAqmcQ ($25 in chips) 
Seat 8: CYkY0dNBaYaKs8HVCVn3mQ ($5 in chips) 
Seat 9: ljemhp25Zg+nlA9DLCIiUw ($24.65 in chips) 
tYsOBqdU1+x+yFI7zHO7hQ: posts small blind $0.10
aNpwfA31EREwO+ar4XzBCw: posts big blind $0.25
*** HOLE CARDS ***
FJflwqC6fqOpM3j0q8Bptw: folds 
5hAPbqNrvJb8PtLiceXtlg6HoFYfVGBefsR5Vrz62qIwlds 
hBMUlEpyU74r/fwDgIpXjQ: folds 
opOCI2p6kW0tINuVaAqmcQ: folds 
CYkY0dNBaYaKs8HVCVn3mQ: folds 
ljemhp25Zg+nlA9DLCIiUw: folds 
j4q3p0lesp63b1gZDwLBZw: folds 
j4q3p0lesp63b1gZDwLBZw leaves the table
tYsOBqdU1+x+yFI7zHO7hQ: folds 
Uncalled bet ($0.15) returned to aNpwfA31EREwO+ar4XzBCw
aNpwfA31EREwO+ar4XzBCw collected $0.20 from pot
aNpwfA31EREwO+ar4XzBCw: doesn't show hand 
*** SUMMARY ***
Total pot $0.20 | Rake $0 
Seat 1: j4q3p0lesp63b1gZDwLBZw (button) folded before Flop (didn't bet)
Seat 2: tYsOBqdU1+x+yFI7zHO7hQ (small blind) folded before Flop
Seat 3: aNpwfA31EREwO+ar4XzBCw (big blind) collected ($0.20)
Seat 4: FJflwqC6fqOpM3j0q8Bptw folded before Flop (didn't bet)
Seat 5: 5hAPbqNrvJb8PtLiceXtlg6HoFYfVGBefsR5Vrz62qIwded before Flop (didn't bet)
Seat 6: hBMUlEpyU74r/fwDgIpXjQ folded before Flop (didn't bet)
Seat 7: opOCI2p6kW0tINuVaAqmcQ folded before Flop (didn't bet)
Seat 8: CYkY0dNBaYaKs8HVCVn3mQ folded before Flop (didn't bet)
Seat 9: ljemhp25Zg+nlA9DLCIiUw folded before Flop (didn't bet)




PokerStars Game #59939667188:  Hold'em No Limit ($0.10/$0.25) - 2009/07/01 0:45:48 ET
Table '4mnXP0EWt9mMZYzTIVDQ0w' 9-max Seat #5 is the button
Seat 1: PTFwg4rGxnfVvj2iP1OI2w ($11.50 in chips) 
Seat 2: j4q3p0lesp63b1gZDwLBZw ($6.85 in chips) 
Seat 4: E0iYnEVO2ho7dH3QcCjw7g ($24.30 in chips) 
Seat 5: sSN8Y0AlsBeidZXPKmwXSw ($12.90 in chips) 
Seat 6: n9toqYXSLowQ/sWq842dEQ ($9 in chips) 
Seat 7: s1y+qfkBnhgc67+X3ThjeA ($26.70 in chips) 
Seat 8: H9KUl8cmpLgEpOVDA00bCg ($4.30 in chips) 
Seat 9: wbCayoP+N6xpKgOfIqZsbA ($21.85 in chips) 
n9toqYXSLowQ/sWq842dEQ: posts small blind $0.10
s1y+qfkBnhgc67+X3ThjeA: posts big blind $0.25
*** HOLE CARDS ***
H9KUl8cmpLgEpOVDA00bCg: folds 
wbCayoP+N6xpKgOfIqZsbA: folds 
PTFwg4rGxnfVvj2iP1OI2w: folds 
j4q3p0lesp63b1gZDwLBZw: folds 
E0iYnEVO2ho7dH3QcCjw7g: raises $0.75 to $1
sSN8Y0AlsBeidZXPKmwXSw: folds 
n9toqYXSLowQ/sWq842dEQ: folds 
s1y+qfkBnhgc67+X3ThjeA: folds 
Uncalled bet ($0.75) returned to E0iYnEVO2ho7dH3QcCjw7g
E0iYnEVO2ho7dH3QcCjw7g collected $0.60 from pot
*** SUMMARY ***
Total pot $0.60 | Rake $0 
Seat 1: PTFwg4rGxnfVvj2iP1OI2w folded before Flop (didn't bet)
Seat 2: j4q3p0lesp63b1gZDwLBZw folded before Flop (didn't bet)
Seat 4: E0iYnEVO2ho7dH3QcCjw7g collected ($0.60)
Seat 5: sSN8Y0AlsBeidZXPKmwXSw (button) folded before Flop (didn't bet)
Seat 6: n9toqYXSLowQ/sWq842dEQ (small blind) folded before Flop
Seat 7: s1y+qfkBnhgc67+X3ThjeA (big blind) folded before Flop
Seat 8: H9KUl8cmpLgEpOVDA00bCg folded before Flop (didn't bet)
Seat 9: wbCayoP+N6xpKgOfIqZsbA folded before Flop (didn't bet)




PokerStars Game #59939667134:  Hold'em No Limit ($0.10/$0.25) - 2009/07/01 0:45:48 ET
Table 'ROYvQOMwUrvL3SOiHYcrWg' 9-max Seat #5 is the button
Seat 1: 7q7lZBfgmzjFr0jTNx4b6g ($7.45 in chips) 
Seat 2: hBMUlEpyU74r/fwDgIpXjQ ($46.75 in chips) 
Seat 4: SHegmCn8B0InbWE/zFlvOw ($24.95 in chips) 
Seat 5: jeKWRUkMaVn8rEUjnJKqpg ($25 in chips) 
Seat 6: OiV1PWZ3IkN29JlmCcnTwQ ($4.75 in chips) 
Seat 7: tYsOBqdU1+x+yFI7zHO7hQ ($28.80 in chips) 
Seat 8: biJWLZ27fafNeBI2oT1KJw ($17.20 in chips) 
Seat 9: yduPKWPzL8YlT5Zv/Nmrwg ($29.30 in chips) 
OiV1PWZ3IkN29JlmCcnTwQ: posts small blind $0.10
tYsOBqdU1+x+yFI7zHO7hQ: posts big blind $0.25
*** HOLE CARDS ***
biJWLZ27fafNeBI2oT1KJw: raises $0.50 to $0.75
yduPKWPzL8YlT5Zv/Nmrwg: folds 
7q7lZBfgmzjFr0jTNx4b6g: folds 
hBMUlEpyU74r/fwDgIpXjQ: folds 
7q7lZBfgmzjFr0jTNx4b6g is sitting out
SHegmCn8B0InbWE/zFlvOw: raises $0.50 to $1.25
jeKWRUkMaVn8rEUjnJKqpg: calls $1.25
OiV1PWZ3IkN29JlmCcnTwQ: folds 
tYsOBqdU1+x+yFI7zHO7hQ: folds 
biJWLZ27fafNeBI2oT1KJw: calls $0.50
*** FLOP *** [Kc Td 2h]
biJWLZ27fafNeBI2oT1KJw: bets $2
SHegmCn8B0InbWE/zFlvOw: folds 
jeKWRUkMaVn8rEUjnJKqpg: folds 
Uncalled bet ($2) returned to biJWLZ27fafNeBI2oT1KJw
biJWLZ27fafNeBI2oT1KJw collected $3.90 from pot
biJWLZ27fafNeBI2oT1KJw: shows [Ts Th] (three of a kind, Tens)
*** SUMMARY ***
Total pot $4.10 | Rake $0.20 
Board [Kc Td 2h]
Seat 1: 7q7lZBfgmzjFr0jTNx4b6g folded before Flop (didn't bet)
Seat 2: hBMUlEpyU74r/fwDgIpXjQ folded before Flop (didn't bet)
Seat 4: SHegmCn8B0InbWE/zFlvOw folded on the Flop
Seat 5: jeKWRUkMaVn8rEUjnJKqpg (button) folded on the Flop
Seat 6: OiV1PWZ3IkN29JlmCcnTwQ (small blind) folded before Flop
Seat 7: tYsOBqdU1+x+yFI7zHO7hQ (big blind) folded before Flop
Seat 8: biJWLZ27fafNeBI2oT1KJw collected ($3.90)
Seat 9: yduPKWPzL8YlT5Zv/Nmrwg folded before Flop (didn't bet)




PokerStars Game #59939667120:  Hold'em No Limit ($0.10/$0.25) - 2009/07/01 0:45:48 ET
Table '4UJB/UOZ5aepyF2v+hIoUg' 6-max Seat #3 is the button
Seat 2: TTpuqC1Ny2dgaNZLYg+ZXg ($9.75 in chips) 
Seat 3: dKMsTZMrd8Ire/Qysz7FAA ($4.55 in chips) 
Seat 4: UBrY0qLms3NqxITD3VvlAg ($17.60 in chips) 
Seat 5: hk8pxWcMqHKpvAKgXieLFw ($20.25 in chips) 
Seat 6: RP8Db3hfv5C09Dkfvq1lmw ($19.45 in chips) 
UBrY0qLms3NqxITD3VvlAg: posts small blind $0.10
hk8pxWcMqHKpvAKgXieLFw: posts big blind $0.25
Mch463E1dxQfVob352za6w: sits out 
*** HOLE CARDS ***
RP8Db3hfv5C09Dkfvq1lmw: folds 
TTpuqC1Ny2dgaNZLYg+ZXg has timed out
TTpuqC1Ny2dgaNZLYg+ZXg: folds 
TTpuqC1Ny2dgaNZLYg+ZXg is sitting out
dKMsTZMrd8Ire/Qysz7FAA: folds 
UBrY0qLms3NqxITD3VvlAg: folds 
Uncalled bet ($0.15) returned to hk8pxWcMqHKpvAKgXieLFw
hk8pxWcMqHKpvAKgXieLFw collected $0.20 from pot
*** SUMMARY ***
Total pot $0.20 | Rake $0 
Seat 2: TTpuqC1Ny2dgaNZLYg+ZXg folded before Flop (didn't bet)
Seat 3: dKMsTZMrd8Ire/Qysz7FAA (button) folded before Flop (didn't bet)
Seat 4: UBrY0qLms3NqxITD3VvlAg (small blind) folded before Flop
Seat 5: hk8pxWcMqHKpvAKgXieLFw (big blind) collected ($0.20)
Seat 6: RP8Db3hfv5C09Dkfvq1lmw folded before Flop (didn't bet)




PokerStars Game #59939667722:  Hold'em No Limit ($0.10/$0.25) - 2009/07/01 0:45:48 ET
Table '/VaaaFnlEJoYVomG9uxHkA' 9-max Seat #3 is the button
Seat 2: DIkeSkosO/tsUp9d2JVyTA ($11.50 in chips) 
Seat 3: 32P5dKDi4pEUiDHMQTV1uw ($23.50 in chips) 
Seat 4: j4q3p0lesp63b1gZDwLBZw ($5 in chips) 
Seat 5: LWN1wPrLH+695JIriXxDuw ($19 in chips) 
Seat 6: 5MgYq10OC5iGoxQFwlJVuw ($14.45 in chips) 
Seat 8: n9toqYXSLowQ/sWq842dEQ ($12 in chips) 
Seat 9: r1pFKMwWp74QwhfPWJOAyw ($10.25 in chips) 
j4q3p0lesp63b1gZDwLBZw: posts small blind $0.10
LWN1wPrLH+695JIriXxDuw: posts big blind $0.25
F7pnn6czNpHvRM55XcA2EA: sits out 
Th3FldXKQW6hWVVPahaoOQ: sits out 
*** HOLE CARDS ***
5MgYq10OC5iGoxQFwlJVuw: folds 
n9toqYXSLowQ/sWq842dEQ: raises $0.25 to $0.50
r1pFKMwWp74QwhfPWJOAyw: calls $0.50
DIkeSkosO/tsUp9d2JVyTA: calls $0.50
32P5dKDi4pEUiDHMQTV1uw: folds 
j4q3p0lesp63b1gZDwLBZw: folds 
LWN1wPrLH+695JIriXxDuw: folds 
*** FLOP *** [2s 7h 5h]
n9toqYXSLowQ/sWq842dEQ: bets $0.75
r1pFKMwWp74QwhfPWJOAyw: folds 
DIkeSkosO/tsUp9d2JVyTA: calls $0.75
*** TURN *** [2s 7h 5h] [5d]
n9toqYXSLowQ/sWq842dEQ: bets $1
DIkeSkosO/tsUp9d2JVyTA: calls $1
*** RIVER *** [2s 7h 5h 5d] [7s]
n9toqYXSLowQ/sWq842dEQ: checks 
DIkeSkosO/tsUp9d2JVyTA: checks 
*** SHOW DOWN ***
n9toqYXSLowQ/sWq842dEQ: shows [Kh Ac] (two pair, Sevens and Fives)
DIkeSkosO/tsUp9d2JVyTA: mucks hand 
n9toqYXSLowQ/sWq842dEQ collected $5.10 from pot
*** SUMMARY ***
Total pot $5.35 | Rake $0.25 
Board [2s 7h 5h 5d 7s]
Seat 2: DIkeSkosO/tsUp9d2JVyTA mucked
Seat 3: 32P5dKDi4pEUiDHMQTV1uw (button) folded before Flop (didn't bet)
Seat 4: j4q3p0lesp63b1gZDwLBZw (small blind) folded before Flop
Seat 5: LWN1wPrLH+695JIriXxDuw (big blind) folded before Flop
Seat 6: 5MgYq10OC5iGoxQFwlJVuw folded before Flop (didn't bet)
Seat 8: n9toqYXSLowQ/sWq842dEQ showed [Kh Ac] and won ($5.10) with two pair, Sevens and Fives
Seat 9: r1pFKMwWp74QwhfPWJOAyw folded on the Flop




PokerStars Game #59939667672:  Hold'em No Limit ($0.10/$0.25) - 2009/07/01 0:45:48 ET
Table 'FgLmv9bi/fJP8ldfbTOpkg' 9-max Seat #7 is the button
Seat 1: opOCI2p6kW0tINuVaAqmcQ ($25.95 in chips) 
Seat 2: mpsfNtnMVDqQHTe92AhIdw ($28.60 in chips) 
Seat 4: WfS0TjI8FyLemNTOo1e9qA ($10.55 in chips) 
Seat 6: oKO7b50N6TzXbPBr/mcrUA ($29 in chips) 
Seat 7: eFrBtVXGVoMq1UwCDg8Exg ($29.05 in chips) 
Seat 8: sJNHTWcSlLHRCZ9+YRLLqA ($25 in chips) 
Seat 9: ljemhp25Zg+nlA9DLCIiUw ($25 in chips) 
sJNHTWcSlLHRCZ9+YRLLqA: posts small blind $0.10
ljemhp25Zg+nlA9DLCIiUw: posts big blind $0.25
uJlzv9KL7hgCIqIS2ofoaw: sits out 
ucLrYHo2o2p/ZURC7/I6gQ: sits out 
*** HOLE CARDS ***
opOCI2p6kW0tINuVaAqmcQ: folds 
mpsfNtnMVDqQHTe92AhIdw: folds 
WfS0TjI8FyLemNTOo1e9qA: raises $1 to $1.25
oKO7b50N6TzXbPBr/mcrUA: folds 
eFrBtVXGVoMq1UwCDg8Exg: folds 
sJNHTWcSlLHRCZ9+YRLLqA: folds 
ljemhp25Zg+nlA9DLCIiUw: folds 
Uncalled bet ($1) returned to WfS0TjI8FyLemNTOo1e9qA
WfS0TjI8FyLemNTOo1e9qA collected $0.60 from pot
*** SUMMARY ***
Total pot $0.60 | Rake $0 
Seat 1: opOCI2p6kW0tINuVaAqmcQ folded before Flop (didn't bet)
Seat 2: mpsfNtnMVDqQHTe92AhIdw folded before Flop (didn't bet)
Seat 4: WfS0TjI8FyLemNTOo1e9qA collected ($0.60)
Seat 6: oKO7b50N6TzXbPBr/mcrUA folded before Flop (didn't bet)
Seat 7: eFrBtVXGVoMq1UwCDg8Exg (button) folded before Flop (didn't bet)
Seat 8: sJNHTWcSlLHRCZ9+YRLLqA (small blind) folded before Flop
Seat 9: ljemhp25Zg+nlA9DLCIiUw (big blind) folded before Flop




PokerStars Game #59939667450:  Hold'em No Limit ($0.10/$0.25) - 2009/07/01 0:45:48 ET
Table 'aT31tt16YvQM/Ue69HPLpA' 9-max Seat #1 is the button
Seat 1: uYY6p3irj4hBN7IeHiNGSw ($34.75 in chips) 
Seat 3: tYsOBqdU1+x+yFI7zHO7hQ ($26.65 in chips) 
Seat 4: s7Q6uNouhe7aE8JdFb9E+A ($25 in chips) 
Seat 5: cvtKnIIaTx2+P/KlOK+tfQ ($11.15 in chips) 
Seat 6: 7cv+9Zc9HIQHNvYsMfV3uA ($42.75 in chips) 
Seat 8: lrTLp1zpuCCs/e0pi2M8jw ($43.85 in chips) 
Seat 9: SXqVW4Q0evTUVZG6BbUNIA ($29.65 in chips) 
tYsOBqdU1+x+yFI7zHO7hQ: posts small blind $0.10
s7Q6uNouhe7aE8JdFb9E+A: posts big blind $0.25
*** HOLE CARDS ***
CYkY0dNBaYaKs8HVCVn3mQ has returned
cvtKnIIaTx2+P/KlOK+tfQ: folds 
s8SPJjToEJz2mPsHsMqL0A has returned
7cv+9Zc9HIQHNvYsMfV3uA: raises $0.75 to $1
lrTLp1zpuCCs/e0pi2M8jw: folds 
SXqVW4Q0evTUVZG6BbUNIA: folds 
uYY6p3irj4hBN7IeHiNGSw: folds 
tYsOBqdU1+x+yFI7zHO7hQ: raises $2.50 to $3.50
s7Q6uNouhe7aE8JdFb9E+A: folds 
7cv+9Zc9HIQHNvYsMfV3uA: folds 
Uncalled bet ($2.50) returned to tYsOBqdU1+x+yFI7zHO7hQ
tYsOBqdU1+x+yFI7zHO7hQ collected $2.25 from pot
tYsOBqdU1+x+yFI7zHO7hQ: doesn't show hand 
*** SUMMARY ***
Total pot $2.25 | Rake $0 
Seat 1: uYY6p3irj4hBN7IeHiNGSw (button) folded before Flop (didn't bet)
Seat 3: tYsOBqdU1+x+yFI7zHO7hQ (small blind) collected ($2.25)
Seat 4: s7Q6uNouhe7aE8JdFb9E+A (big blind) folded before Flop
Seat 5: cvtKnIIaTx2+P/KlOK+tfQ folded before Flop (didn't bet)
Seat 6: 7cv+9Zc9HIQHNvYsMfV3uA folded before Flop
Seat 8: lrTLp1zpuCCs/e0pi2M8jw folded before Flop (didn't bet)
Seat 9: SXqVW4Q0evTUVZG6BbUNIA folded before Flop (didn't bet)




PokerStars Game #59939667240:  Hold'em No Limit ($0.10/$0.25) - 2009/07/01 0:45:48 ET
Table '5VWnrlxdjwVfMWkVS2WE7A' 6-max Seat #4 is the button
Seat 1: BiLBinPhgpKAYzLgKJVU5A ($21.60 in chips) 
Seat 2: ELW+DKizJhLK7k40PMkD2Q ($28.60 in chips) 
Seat 3: cPO/1/dTcZpLkQFm3jH3Rg ($25 in chips) 
Seat 4: WZv4aSGl7ETtI/Z5BPKi7w ($32.50 in chips) 
Seat 5: JQZew0FjzS19kTjeNtrE+A ($42.05 in chips) 
Seat 6: LtASJ9OlkqGrrUKGQlpGAw ($16.40 in chips) 
JQZew0FjzS19kTjeNtrE+A: posts small blind $0.10
LtASJ9OlkqGrrUKGQlpGAw: posts big blind $0.25
*** HOLE CARDS ***
BiLBinPhgpKAYzLgKJVU5A: folds 
ELW+DKizJhLK7k40PMkD2Q: raises $0.75 to $1
cPO/1/dTcZpLkQFm3jH3Rg: folds 
WZv4aSGl7ETtI/Z5BPKi7w: folds 
JQZew0FjzS19kTjeNtrE+A: folds 
LtASJ9OlkqGrrUKGQlpGAw: folds 
Uncalled bet ($0.75) returned to ELW+DKizJhLK7k40PMkD2Q
ELW+DKizJhLK7k40PMkD2Q collected $0.60 from pot
*** SUMMARY ***
Total pot $0.60 | Rake $0 
Seat 1: BiLBinPhgpKAYzLgKJVU5A folded before Flop (didn't bet)
Seat 2: ELW+DKizJhLK7k40PMkD2Q collected ($0.60)
Seat 3: cPO/1/dTcZpLkQFm3jH3Rg folded before Flop (didn't bet)
Seat 4: WZv4aSGl7ETtI/Z5BPKi7w (button) folded before Flop (didn't bet)
Seat 5: JQZew0FjzS19kTjeNtrE+A (small blind) folded before Flop
Seat 6: LtASJ9OlkqGrrUKGQlpGAw (big blind) folded before Flop




PokerStars Game #59939667434:  Hold'em No Limit ($0.10/$0.25) - 2009/07/01 0:45:48 ET
Table 'oJpFwZj9+FUGHX90Un8s9Q' 6-max Seat #4 is the button
Seat 1: 6DwBRH+xZ12AAZmeAg+aXw ($25.60 in chips) 
Seat 2: IMmIhmfU3tqkaJABnD21Rg ($16.30 in chips) 
Seat 3: kyRaCIljYA6l33lSKQfNsg ($27.80 in chips) 
Seat 4: IX/nJvz3Mx/Ez6DgueFA4Q ($7.85 in chips) 
Seat 5: kG34n23qFQA3nzdOJTQ1dA ($24.40 in chips) 
Seat 6: Zijzy/UtPWzWVUo81HHVjQ ($40.45 in chips) 
kG34n23qFQA3nzdOJTQ1dA: posts small blind $0.10
Zijzy/UtPWzWVUo81HHVjQ: posts big blind $0.25
*** HOLE CARDS ***
6DwBRH+xZ12AAZmeAg+aXw: raises $0.50 to $0.75
IMmIhmfU3tqkaJABnD21Rg: calls $0.75
kyRaCIljYA6l33lSKQfNsg: folds 
IX/nJvz3Mx/Ez6DgueFA4Q: folds 
kG34n23qFQA3nzdOJTQ1dA: folds 
Zijzy/UtPWzWVUo81HHVjQ: folds 
*** FLOP *** [2h Qd Ts]
6DwBRH+xZ12AAZmeAg+aXw: bets $1
IMmIhmfU3tqkaJABnD21Rg: folds 
Uncalled bet ($1) returned to 6DwBRH+xZ12AAZmeAg+aXw
6DwBRH+xZ12AAZmeAg+aXw collected $1.80 from pot
6DwBRH+xZ12AAZmeAg+aXw: doesn't show hand 
*** SUMMARY ***
Total pot $1.85 | Rake $0.05 
Board [2h Qd Ts]
Seat 1: 6DwBRH+xZ12AAZmeAg+aXw collected ($1.80)
Seat 2: IMmIhmfU3tqkaJABnD21Rg folded on the Flop
Seat 3: kyRaCIljYA6l33lSKQfNsg folded before Flop (didn't bet)
Seat 4: IX/nJvz3Mx/Ez6DgueFA4Q (button) folded before Flop (didn't bet)
Seat 5: kG34n23qFQA3nzdOJTQ1dA (small blind) folded before Flop
Seat 6: Zijzy/UtPWzWVUo81HHVjQ (big blind) folded before Flop




PokerStars Game #59939668322:  Hold'em No Limit ($0.10/$0.25) - 2009/07/01 0:45:49 ET
Table '/XCUCUl3yW6tdTJQEhJKGw' 6-max Seat #6 is the button
Seat 1: p8J112JmNRnCwV2+NAEzCA ($19.85 in chips) 
Seat 2: 8ClCHtFXGNplITm+63KB+Q ($28.30 in chips) 
Seat 3: /gJNBeCkWL4o85/jvlZ4BA ($36.25 in chips) 
Seat 4: SFmT9ZsVopnukjvAzrxTRg ($25.35 in chips) 
Seat 5: rf9ho6cin0bk70nP86p3rQ ($14.25 in chips) 
Seat 6: armfxZhGxeZVZBYAQFuIJQ ($34.65 in chips) 
p8J112JmNRnCwV2+NAEzCA: posts small blind $0.10
8ClCHtFXGNplITm+63KB+Q: posts big blind $0.25
*** HOLE CARDS ***
/gJNBeCkWL4o85/jvlZ4BA: folds 
SFmT9ZsVopnukjvAzrxTRg: folds 
rf9ho6cin0bk70nP86p3rQ: folds 
armfxZhGxeZVZBYAQFuIJQ: folds 
p8J112JmNRnCwV2+NAEzCA: folds 
Uncalled bet ($0.15) returned to 8ClCHtFXGNplITm+63KB+Q
8ClCHtFXGNplITm+63KB+Q collected $0.20 from pot
8ClCHtFXGNplITm+63KB+Q: doesn't show hand 
*** SUMMARY ***
Total pot $0.20 | Rake $0 
Seat 1: p8J112JmNRnCwV2+NAEzCA (small blind) folded before Flop
Seat 2: 8ClCHtFXGNplITm+63KB+Q (big blind) collected ($0.20)
Seat 3: /gJNBeCkWL4o85/jvlZ4BA folded before Flop (didn't bet)
Seat 4: SFmT9ZsVopnukjvAzrxTRg folded before Flop (didn't bet)
Seat 5: rf9ho6cin0bk70nP86p3rQ folded before Flop (didn't bet)
Seat 6: armfxZhGxeZVZBYAQFuIJQ (button) folded before Flop (didn't bet)




PokerStars Game #59939668396:  Hold'em No Limit ($0.10/$0.25) - 2009/07/01 0:45:49 ET
Table 'tq5CvS0RUqGkuBK0XTzqqg' 6-max Seat #3 is the button
Seat 1: 39EF5EcifdyPS7v+EnfxLg ($16.55 in chips) 
Seat 2: mfrkWA3PTeYPkbO6hi98Aw ($68.85 in chips) 
Seat 3: PbMzPZIePKifKQZfKDkbIw ($26.55 in chips) 
Seat 4: W7FS+h5B+OhmwF+cTt3ZPQ ($19.20 in chips) 
Seat 5: qGHGf/553gQnDoklMRe3tg ($23.75 in chips) 
Seat 6: hOfhw8jxWiq14wXGL4Bh/Q ($15.15 in chips) 
W7FS+h5B+OhmwF+cTt3ZPQ: posts small blind $0.10
qGHGf/553gQnDoklMRe3tg: posts big blind $0.25
*** HOLE CARDS ***
hOfhw8jxWiq14wXGL4Bh/Q: raises $0.50 to $0.75
39EF5EcifdyPS7v+EnfxLg: folds 
mfrkWA3PTeYPkbO6hi98Aw: folds 
PbMzPZIePKifKQZfKDkbIw: folds 
W7FS+h5B+OhmwF+cTt3ZPQ: folds 
qGHGf/553gQnDoklMRe3tg: folds 
Uncalled bet ($0.50) returned to hOfhw8jxWiq14wXGL4Bh/Q
hOfhw8jxWiq14wXGL4Bh/Q collected $0.60 from pot
hOfhw8jxWiq14wXGL4Bh/Q: doesn't show hand 
*** SUMMARY ***
Total pot $0.60 | Rake $0 
Seat 1: 39EF5EcifdyPS7v+EnfxLg folded before Flop (didn't bet)
Seat 2: mfrkWA3PTeYPkbO6hi98Aw folded before Flop (didn't bet)
Seat 3: PbMzPZIePKifKQZfKDkbIw (button) folded before Flop (didn't bet)
Seat 4: W7FS+h5B+OhmwF+cTt3ZPQ (small blind) folded before Flop
Seat 5: qGHGf/553gQnDoklMRe3tg (big blind) folded before Flop
Seat 6: hOfhw8jxWiq14wXGL4Bh/Q collected ($0.60)




PokerStars Game #59939668326:  Hold'em No Limit ($0.10/$0.25) - 2009/07/01 0:45:49 ET
Table 'IdXp6nyeW4FYaEK4qKCnwQ' 9-max Seat #4 is the button
Seat 2: HPEB+AtKw1+C/cxU0o1ciw ($28.10 in chips) 
Seat 4: IK3/w7XV7rd8mVIsuasjYA ($4.40 in chips) 
Seat 5: U41wNf6XauAiBOQaKu2ZIA ($9.40 in chips) 
Seat 6: qeHpnumzEthsYultSkNjCA ($9 in chips) 
Seat 9: JJH2Xc95hFewheF67vSv4Q ($16.25 in chips) 
U41wNf6XauAiBOQaKu2ZIA: posts small blind $0.10
qeHpnumzEthsYultSkNjCA: posts big blind $0.25
*** HOLE CARDS ***
JJH2Xc95hFewheF67vSv4Q: calls $0.25
HPEB+AtKw1+C/cxU0o1ciw: folds 
IK3/w7XV7rd8mVIsuasjYA: calls $0.25
U41wNf6XauAiBOQaKu2ZIA: calls $0.15
qeHpnumzEthsYultSkNjCA: checks 
*** FLOP *** [8s 5d 5s]
U41wNf6XauAiBOQaKu2ZIA: bets $0.25
qeHpnumzEthsYultSkNjCA: calls $0.25
JJH2Xc95hFewheF67vSv4Q: calls $0.25
IK3/w7XV7rd8mVIsuasjYA: folds 
*** TURN *** [8s 5d 5s] [Js]
U41wNf6XauAiBOQaKu2ZIA: bets $0.75
qeHpnumzEthsYultSkNjCA: calls $0.75
JJH2Xc95hFewheF67vSv4Q: calls $0.75
*** RIVER *** [8s 5d 5s Js] [7s]
U41wNf6XauAiBOQaKu2ZIA: checks 
qeHpnumzEthsYultSkNjCA: checks 
JJH2Xc95hFewheF67vSv4Q: bets $1.25
U41wNf6XauAiBOQaKu2ZIA: calls $1.25
qeHpnumzEthsYultSkNjCA: calls $1.25
*** SHOW DOWN ***
JJH2Xc95hFewheF67vSv4Q: shows [Ks Ah] (a flush, King high)
U41wNf6XauAiBOQaKu2ZIA: mucks hand 
qeHpnumzEthsYultSkNjCA: mucks hand 
JJH2Xc95hFewheF67vSv4Q collected $7.40 from pot
*** SUMMARY ***
Total pot $7.75 | Rake $0.35 
Board [8s 5d 5s Js 7s]
Seat 2: HPEB+AtKw1+C/cxU0o1ciw folded before Flop (didn't bet)
Seat 4: IK3/w7XV7rd8mVIsuasjYA (button) folded on the Flop
Seat 5: U41wNf6XauAiBOQaKu2ZIA (small blind) mucked
Seat 6: qeHpnumzEthsYultSkNjCA (big blind) mucked
Seat 9: JJH2Xc95hFewheF67vSv4Q showed [Ks Ah] and won ($7.40) with a flush, King high




PokerStars Game #59939668096:  Hold'em No Limit ($0.10/$0.25) - 2009/07/01 0:45:49 ET
Table 'LwnjzXstPtSrqrV/oDpnXQ' 9-max Seat #9 is the button
Seat 1: sChhj/mp8dm+nGvBS5mOIA ($18.95 in chips) 
Seat 2: K7bAhhMMJ/XcTmGaBZVfFQ ($27.80 in chips) 
Seat 3: u+XLsbPQIcRvPRnS1bvZww ($13.10 in chips) 
Seat 4: nmvbguGv4wKulGg49bANbQ ($13.25 in chips) 
Seat 5: Th3FldXKQW6hWVVPahaoOQ ($29.15 in chips) 
Seat 6: ljemhp25Zg+nlA9DLCIiUw ($31.25 in chips) 
Seat 7: c/Dw/6HyqldTzIRodAIZmg ($13.65 in chips) 
Seat 8: h4ggJZYBXV0mEZzYPYKfeA ($33.05 in chips) 
Seat 9: N6fYvIzQLKaydFLKQGtMlQ ($24.05 in chips) 
sChhj/mp8dm+nGvBS5mOIA: posts small blind $0.10
K7bAhhMMJ/XcTmGaBZVfFQ: posts big blind $0.25
*** HOLE CARDS ***
u+XLsbPQIcRvPRnS1bvZww: folds 
nmvbguGv4wKulGg49bANbQ: folds 
Th3FldXKQW6hWVVPahaoOQ: folds 
ljemhp25Zg+nlA9DLCIiUw: calls $0.25
c/Dw/6HyqldTzIRodAIZmg: calls $0.25
h4ggJZYBXV0mEZzYPYKfeA: calls $0.25
N6fYvIzQLKaydFLKQGtMlQ: folds 
sChhj/mp8dm+nGvBS5mOIA: folds 
K7bAhhMMJ/XcTmGaBZVfFQ: checks 
*** FLOP *** [Ad 8d 9d]
K7bAhhMMJ/XcTmGaBZVfFQ: checks 
ljemhp25Zg+nlA9DLCIiUw: bets $0.85
c/Dw/6HyqldTzIRodAIZmg: folds 
h4ggJZYBXV0mEZzYPYKfeA: calls $0.85
K7bAhhMMJ/XcTmGaBZVfFQ: folds 
*** TURN *** [Ad 8d 9d] [3h]
ljemhp25Zg+nlA9DLCIiUw: bets $2.25
h4ggJZYBXV0mEZzYPYKfeA: folds 
Uncalled bet ($2.25) returned to ljemhp25Zg+nlA9DLCIiUw
ljemhp25Zg+nlA9DLCIiUw collected $2.70 from pot
ljemhp25Zg+nlA9DLCIiUw: doesn't show hand 
*** SUMMARY ***
Total pot $2.80 | Rake $0.10 
Board [Ad 8d 9d 3h]
Seat 1: sChhj/mp8dm+nGvBS5mOIA (small blind) folded before Flop
Seat 2: K7bAhhMMJ/XcTmGaBZVfFQ (big blind) folded on the Flop
Seat 3: u+XLsbPQIcRvPRnS1bvZww folded before Flop (didn't bet)
Seat 4: nmvbguGv4wKulGg49bANbQ folded before Flop (didn't bet)
Seat 5: Th3FldXKQW6hWVVPahaoOQ folded before Flop (didn't bet)
Seat 6: ljemhp25Zg+nlA9DLCIiUw collected ($2.70)
Seat 7: c/Dw/6HyqldTzIRodAIZmg folded on the Flop
Seat 8: h4ggJZYBXV0mEZzYPYKfeA folded on the Turn
Seat 9: N6fYvIzQLKaydFLKQGtMlQ (button) folded before Flop (didn't bet)




PokerStars Game #59939667956:  Hold'em No Limit ($0.10/$0.25) - 2009/07/01 0:45:49 ET
Table 'h02LhQ7B/Zk4ETRxxHhGYA' 9-max Seat #2 is the button
Seat 1: sD+TKtt36XiiN6jqHiLwDA ($32.85 in chips) 
Seat 2: RJ/x9oZtt1RZLaJEQwZOxQ ($27.45 in chips) 
Seat 3: kqpa/IbqkUrwPb3hbA7/ww ($8.50 in chips) 
Seat 4: tYsOBqdU1+x+yFI7zHO7hQ ($38.20 in chips) 
Seat 5: cUxk0Jk4lrUQv9CJl0LPlg ($17.35 in chips) 
Seat 6: kN/irnQSdb8jibbN4f1O+Q ($19.30 in chips) 
Seat 7: rUpvA02nErFvZ4yFbDR8XA ($18.95 in chips) 
Seat 8: 7tW694tRVJnYdoa16Dw4RQ ($17.10 in chips) 
Seat 9: 1c/7DHPx5CDTmAfk8/bWeA ($15.90 in chips) 
kqpa/IbqkUrwPb3hbA7/ww: posts small blind $0.10
tYsOBqdU1+x+yFI7zHO7hQ: posts big blind $0.25
*** HOLE CARDS ***
cUxk0Jk4lrUQv9CJl0LPlg: calls $0.25
kN/irnQSdb8jibbN4f1O+Q: folds 
rUpvA02nErFvZ4yFbDR8XA: calls $0.25
7tW694tRVJnYdoa16Dw4RQ: folds 
1c/7DHPx5CDTmAfk8/bWeA: folds 
sD+TKtt36XiiN6jqHiLwDA: folds 
RJ/x9oZtt1RZLaJEQwZOxQ: calls $0.25
kqpa/IbqkUrwPb3hbA7/ww: calls $0.15
tYsOBqdU1+x+yFI7zHO7hQ: checks 
*** FLOP *** [Tc Jc 3d]
kqpa/IbqkUrwPb3hbA7/ww: checks 
tYsOBqdU1+x+yFI7zHO7hQ: checks 
cUxk0Jk4lrUQv9CJl0LPlg: checks 
rUpvA02nErFvZ4yFbDR8XA: checks 
RJ/x9oZtt1RZLaJEQwZOxQ: checks 
*** TURN *** [Tc Jc 3d] [8d]
kqpa/IbqkUrwPb3hbA7/ww: checks 
tYsOBqdU1+x+yFI7zHO7hQ: checks 
cUxk0Jk4lrUQv9CJl0LPlg: checks 
rUpvA02nErFvZ4yFbDR8XA: checks 
RJ/x9oZtt1RZLaJEQwZOxQ: checks 
*** RIVER *** [Tc Jc 3d 8d] [5c]
kqpa/IbqkUrwPb3hbA7/ww: checks 
tYsOBqdU1+x+yFI7zHO7hQ: checks 
cUxk0Jk4lrUQv9CJl0LPlg: checks 
rUpvA02nErFvZ4yFbDR8XA: checks 
RJ/x9oZtt1RZLaJEQwZOxQ: checks 
*** SHOW DOWN ***
kqpa/IbqkUrwPb3hbA7/ww: shows [9c Ks] (high card King)
tYsOBqdU1+x+yFI7zHO7hQ: mucks hand 
cUxk0Jk4lrUQv9CJl0LPlg: shows [4h Ac] (high card Ace)
rUpvA02nErFvZ4yFbDR8XA: shows [8h 9h] (a pair of Eights)
RJ/x9oZtt1RZLaJEQwZOxQ: mucks hand 
rUpvA02nErFvZ4yFbDR8XA collected $1.20 from pot
*** SUMMARY ***
Total pot $1.25 | Rake $0.05 
Board [Tc Jc 3d 8d 5c]
Seat 1: sD+TKtt36XiiN6jqHiLwDA folded before Flop (didn't bet)
Seat 2: RJ/x9oZtt1RZLaJEQwZOxQ (button) mucked
Seat 3: kqpa/IbqkUrwPb3hbA7/ww (small blind) showed [9c Ks] and lost with high card King
Seat 4: tYsOBqdU1+x+yFI7zHO7hQ (big blind) mucked
Seat 5: cUxk0Jk4lrUQv9CJl0LPlg showed [4h Ac] and lost with high card Ace
Seat 6: kN/irnQSdb8jibbN4f1O+Q folded before Flop (didn't bet)
Seat 7: rUpvA02nErFvZ4yFbDR8XA showed [8h 9h] and won ($1.20) with a pair of Eights
Seat 8: 7tW694tRVJnYdoa16Dw4RQ folded before Flop (didn't bet)
Seat 9: 1c/7DHPx5CDTmAfk8/bWeA folded before Flop (didn't bet)




PokerStars Game #59939668220:  Hold'em No Limit ($0.10/$0.25) - 2009/07/01 0:45:49 ET
Table 'BdTkgy6SGkgNXul6irMoOw' 9-max Seat #4 is the button
Seat 1: Jd9JmKichu4pvsKjXEKNvA ($6.40 in chips) 
Seat 2: ljemhp25Zg+nlA9DLCIiUw ($38.45 in chips) 
Seat 3: RQ9/w/vIRUIpv009qodF2Q ($11.40 in chips) 
Seat 4: eygIcrabyU9hI2mw7NQsgg ($20.55 in chips) 
Seat 5: opOCI2p6kW0tINuVaAqmcQ ($25 in chips) 
Seat 6: STkR8XvpjNv79OOMhrlh2w ($25 in chips) 
Seat 7: b8t3jWrxzeEt9HtZtc9wUQ ($14.25 in chips) 
Seat 8: 8Y1YOndOSMx6Ei47RaGbrw ($13.50 in chips) 
Seat 9: 5dv9mRGKI/UifM58OINXVQ ($22.65 in chips) 
opOCI2p6kW0tINuVaAqmcQ: posts small blind $0.10
STkR8XvpjNv79OOMhrlh2w: posts big blind $0.25
*** HOLE CARDS ***
b8t3jWrxzeEt9HtZtc9wUQ: folds 
8Y1YOndOSMx6Ei47RaGbrw: calls $0.25
5dv9mRGKI/UifM58OINXVQ: calls $0.25
Jd9JmKichu4pvsKjXEKNvA: calls $0.25
ljemhp25Zg+nlA9DLCIiUw: folds 
RQ9/w/vIRUIpv009qodF2Q: calls $0.25
eygIcrabyU9hI2mw7NQsgg: folds 
opOCI2p6kW0tINuVaAqmcQ: folds 
STkR8XvpjNv79OOMhrlh2w: checks 
*** FLOP *** [Th 6s As]
STkR8XvpjNv79OOMhrlh2w: checks 
8Y1YOndOSMx6Ei47RaGbrw: checks 
5dv9mRGKI/UifM58OINXVQ: checks 
Jd9JmKichu4pvsKjXEKNvA: checks 
RQ9/w/vIRUIpv009qodF2Q: checks 
*** TURN *** [Th 6s As] [Ah]
STkR8XvpjNv79OOMhrlh2w: checks 
8Y1YOndOSMx6Ei47RaGbrw: bets $0.25
5dv9mRGKI/UifM58OINXVQ: calls $0.25
Jd9JmKichu4pvsKjXEKNvA: folds 
RQ9/w/vIRUIpv009qodF2Q: folds 
STkR8XvpjNv79OOMhrlh2w: folds 
*** RIVER *** [Th 6s As Ah] [Ad]
8Y1YOndOSMx6Ei47RaGbrw: bets $8.50
5dv9mRGKI/UifM58OINXVQ: folds 
Uncalled bet ($8.50) returned to 8Y1YOndOSMx6Ei47RaGbrw
8Y1YOndOSMx6Ei47RaGbrw collected $1.80 from pot
*** SUMMARY ***
Total pot $1.85 | Rake $0.05 
Board [Th 6s As Ah Ad]
Seat 1: Jd9JmKichu4pvsKjXEKNvA folded on the Turn
Seat 2: ljemhp25Zg+nlA9DLCIiUw folded before Flop (didn't bet)
Seat 3: RQ9/w/vIRUIpv009qodF2Q folded on the Turn
Seat 4: eygIcrabyU9hI2mw7NQsgg (button) folded before Flop (didn't bet)
Seat 5: opOCI2p6kW0tINuVaAqmcQ (small blind) folded before Flop
Seat 6: STkR8XvpjNv79OOMhrlh2w (big blind) folded on the Turn
Seat 7: b8t3jWrxzeEt9HtZtc9wUQ folded before Flop (didn't bet)
Seat 8: 8Y1YOndOSMx6Ei47RaGbrw collected ($1.80)
Seat 9: 5dv9mRGKI/UifM58OINXVQ folded on the River




PokerStars Game #59939668812:  Hold'em No Limit ($0.10/$0.25) - 2009/07/01 0:45:50 ET
Table 'RUOqTfzbAVGS5x+J9aZMHA' 9-max Seat #7 is the button
Seat 1: KBBTLXGhPdPj+4X0QKMkcg ($7.05 in chips) 
Seat 2: Z5ZtGOON8kmSdSCll9Z3XA ($9.35 in chips) 
Seat 3: JtVGnq5doRa3PublncR+Yw ($24.75 in chips) 
Seat 4: K9Az8li/CO2TicltVWKamA ($10.40 in chips) 
Seat 5: opOCI2p6kW0tINuVaAqmcQ ($25 in chips) 
Seat 6: ljemhp25Zg+nlA9DLCIiUw ($40.15 in chips) 
Seat 7: HxDF4QSxC4z39D7teZpprQ ($9.65 in chips) 
Seat 8: 3RCAkueG3Vc13VpRStCB+w ($23.85 in chips) 
Seat 9: cZ99hugmLBj9KhTlc8nCSw ($25 in chips) 
3RCAkueG3Vc13VpRStCB+w: posts small blind $0.10
cZ99hugmLBj9KhTlc8nCSw: posts big blind $0.25
*** HOLE CARDS ***
KBBTLXGhPdPj+4X0QKMkcg: calls $0.25
Z5ZtGOON8kmSdSCll9Z3XA: folds 
JtVGnq5doRa3PublncR+Yw: folds 
K9Az8li/CO2TicltVWKamA: folds 
opOCI2p6kW0tINuVaAqmcQ: folds 
ljemhp25Zg+nlA9DLCIiUw: folds 
HxDF4QSxC4z39D7teZpprQ: calls $0.25
3RCAkueG3Vc13VpRStCB+w: folds 
cZ99hugmLBj9KhTlc8nCSw: checks 
*** FLOP *** [9c Th Ad]
cZ99hugmLBj9KhTlc8nCSw: checks 
KBBTLXGhPdPj+4X0QKMkcg: checks 
HxDF4QSxC4z39D7teZpprQ: bets $0.75
cZ99hugmLBj9KhTlc8nCSw: folds 
KBBTLXGhPdPj+4X0QKMkcg: calls $0.75
*** TURN *** [9c Th Ad] [8h]
KBBTLXGhPdPj+4X0QKMkcg: checks 
HxDF4QSxC4z39D7teZpprQ: bets $1.25
KBBTLXGhPdPj+4X0QKMkcg: calls $1.25
*** RIVER *** [9c Th Ad 8h] [Jc]
KBBTLXGhPdPj+4X0QKMkcg: bets $1.25
HxDF4QSxC4z39D7teZpprQ: calls $1.25
*** SHOW DOWN ***
KBBTLXGhPdPj+4X0QKMkcg: shows [As 3c] (a pair of Aces)
HxDF4QSxC4z39D7teZpprQ: mucks hand 
KBBTLXGhPdPj+4X0QKMkcg collected $7 from pot
*** SUMMARY ***
Total pot $7.35 | Rake $0.35 
Board [9c Th Ad 8h Jc]
Seat 1: KBBTLXGhPdPj+4X0QKMkcg showed [As 3c] and won ($7) with a pair of Aces
Seat 2: Z5ZtGOON8kmSdSCll9Z3XA folded before Flop (didn't bet)
Seat 3: JtVGnq5doRa3PublncR+Yw folded before Flop (didn't bet)
Seat 4: K9Az8li/CO2TicltVWKamA folded before Flop (didn't bet)
Seat 5: opOCI2p6kW0tINuVaAqmcQ folded before Flop (didn't bet)
Seat 6: ljemhp25Zg+nlA9DLCIiUw folded before Flop (didn't bet)
Seat 7: HxDF4QSxC4z39D7teZpprQ (button) mucked
Seat 8: 3RCAkueG3Vc13VpRStCB+w (small blind) folded before Flop
Seat 9: cZ99hugmLBj9KhTlc8nCSw (big blind) folded on the Flop




PokerStars Game #59939669046:  Hold'em No Limit ($0.10/$0.25) - 2009/07/01 0:45:50 ET
Table 'hg+KpirwreMnBAFQr/SEUA' 9-max Seat #5 is the button
Seat 1: H5Se03ZqSX7tbULXur2MAg ($24.10 in chips) 
Seat 2: OlPJsgR4xypSg/w1z7Gyvw ($18.05 in chips) 
Seat 3: N6fYvIzQLKaydFLKQGtMlQ ($29.95 in chips) 
Seat 4: 7Tiam59GaMYACH/my1qVuw ($25 in chips) 
Seat 5: +2kMBNpY4nF1qNCRd8SJLA ($25.25 in chips) 
Seat 6: dAohy+E9dUFBp6GlYFiOtQ ($24.45 in chips) 
Seat 7: iGiuurat0/9pnLDHRit8Bw ($10 in chips) 
Seat 8: HPEB+AtKw1+C/cxU0o1ciw ($25 in chips) 
dAohy+E9dUFBp6GlYFiOtQ: posts small blind $0.10
iGiuurat0/9pnLDHRit8Bw: posts big blind $0.25
7Tiam59GaMYACH/my1qVuw: posts big blind $0.25
*** HOLE CARDS ***
HPEB+AtKw1+C/cxU0o1ciw: folds 
H5Se03ZqSX7tbULXur2MAg: folds 
OlPJsgR4xypSg/w1z7Gyvw: folds 
N6fYvIzQLKaydFLKQGtMlQ: folds 
7Tiam59GaMYACH/my1qVuw: checks 
mobyblastr joins the table at seat #9 
+2kMBNpY4nF1qNCRd8SJLA: calls $0.25
dAohy+E9dUFBp6GlYFiOtQ: calls $0.15
iGiuurat0/9pnLDHRit8Bw: checks 
*** FLOP *** [3c Jd Ad]
dAohy+E9dUFBp6GlYFiOtQ: checks 
iGiuurat0/9pnLDHRit8Bw: checks 
7Tiam59GaMYACH/my1qVuw: checks 
+2kMBNpY4nF1qNCRd8SJLA: checks 
*** TURN *** [3c Jd Ad] [Ac]
dAohy+E9dUFBp6GlYFiOtQ: checks 
iGiuurat0/9pnLDHRit8Bw: checks 
7Tiam59GaMYACH/my1qVuw: checks 
+2kMBNpY4nF1qNCRd8SJLA: checks 
*** RIVER *** [3c Jd Ad Ac] [6h]
dAohy+E9dUFBp6GlYFiOtQ: bets $0.50
iGiuurat0/9pnLDHRit8Bw: folds 
7Tiam59GaMYACH/my1qVuw: folds 
+2kMBNpY4nF1qNCRd8SJLA: folds 
Uncalled bet ($0.50) returned to dAohy+E9dUFBp6GlYFiOtQ
dAohy+E9dUFBp6GlYFiOtQ collected $0.95 from pot
dAohy+E9dUFBp6GlYFiOtQ: doesn't show hand 
*** SUMMARY ***
Total pot $1 | Rake $0.05 
Board [3c Jd Ad Ac 6h]
Seat 1: H5Se03ZqSX7tbULXur2MAg folded before Flop (didn't bet)
Seat 2: OlPJsgR4xypSg/w1z7Gyvw folded before Flop (didn't bet)
Seat 3: N6fYvIzQLKaydFLKQGtMlQ folded before Flop (didn't bet)
Seat 4: 7Tiam59GaMYACH/my1qVuw folded on the River
Seat 5: +2kMBNpY4nF1qNCRd8SJLA (button) folded on the River
Seat 6: dAohy+E9dUFBp6GlYFiOtQ (small blind) collected ($0.95)
Seat 7: iGiuurat0/9pnLDHRit8Bw (big blind) folded on the River
Seat 8: HPEB+AtKw1+C/cxU0o1ciw folded before Flop (didn't bet)




PokerStars Game #59939668930:  Hold'em No Limit ($0.10/$0.25) - 2009/07/01 0:45:50 ET
Table 'BmUMTVcNATeov2rAGYU0Qg' 9-max Seat #4 is the button
Seat 2: jJnMGXoBXye+afMd0k0rUw ($14.55 in chips) 
Seat 3: hJ4uYjNmSZdjrKA8cjZqCA ($20.90 in chips) 
Seat 4: aNpwfA31EREwO+ar4XzBCw ($35.50 in chips) 
Seat 5: EBPuArucumZnjWoW71jHBg ($42 in chips) 
Seat 8: f/H6PsHRl4W1JyNsEDvPtg ($10.25 in chips) 
Seat 9: aCVg6cCxQcqClhB9nq/p1w ($24.40 in chips) 
EBPuArucumZnjWoW71jHBg: posts small blind $0.10
deka1210: is sitting out 
f/H6PsHRl4W1JyNsEDvPtg: posts big blind $0.25
QEbIGci+itdw+re8RM5fZA: sits out 
*** HOLE CARDS ***
I.O.S. leaves the table
aCVg6cCxQcqClhB9nq/p1w: raises $0.25 to $0.50
deka1210 leaves the table
jJnMGXoBXye+afMd0k0rUw: folds 
hJ4uYjNmSZdjrKA8cjZqCA: folds 
aNpwfA31EREwO+ar4XzBCw: folds 
EBPuArucumZnjWoW71jHBg: calls $0.40
f/H6PsHRl4W1JyNsEDvPtg: folds 
*** FLOP *** [Ad 4h 9h]
BX9NgIrtlXh1K47KYMsMtQ joins the table at seat #6 
EBPuArucumZnjWoW71jHBg: checks 
aCVg6cCxQcqClhB9nq/p1w: bets $0.25
EBPuArucumZnjWoW71jHBg: calls $0.25
*** TURN *** [Ad 4h 9h] [4s]
navalhad@ joins the table at seat #7 
EBPuArucumZnjWoW71jHBg: checks 
aCVg6cCxQcqClhB9nq/p1w: bets $1
EBPuArucumZnjWoW71jHBg: folds 
Uncalled bet ($1) returned to aCVg6cCxQcqClhB9nq/p1w
aCVg6cCxQcqClhB9nq/p1w collected $1.70 from pot
*** SUMMARY ***
Total pot $1.75 | Rake $0.05 
Board [Ad 4h 9h 4s]
Seat 2: jJnMGXoBXye+afMd0k0rUw folded before Flop (didn't bet)
Seat 3: hJ4uYjNmSZdjrKA8cjZqCA folded before Flop (didn't bet)
Seat 4: aNpwfA31EREwO+ar4XzBCw (button) folded before Flop (didn't bet)
Seat 5: EBPuArucumZnjWoW71jHBg (small blind) folded on the Turn
Seat 8: f/H6PsHRl4W1JyNsEDvPtg (big blind) folded before Flop
Seat 9: aCVg6cCxQcqClhB9nq/p1w collected ($1.70)




PokerStars Game #59939669312:  Hold'em No Limit ($0.10/$0.25) - 2009/07/01 0:45:51 ET
Table 'eOXPe2c6mG7DOFKvMsZZfA' 6-max Seat #6 is the button
Seat 1: ShXPHWfjhfmAwLgDdm6bRQ ($7.25 in chips) 
Seat 2: ELW+DKizJhLK7k40PMkD2Q ($33.65 in chips) 
Seat 3: kReyZ6g6Fu3tQ0nyjDf9kA ($29.65 in chips) 
Seat 4: zHHLkD2sRljslKKeQv/ZQw ($41.90 in chips) 
Seat 5: NhUN/JpAprdJeamFBgJH1w ($25.35 in chips) 
Seat 6: wKFJ513ucluNNiMlkXcDOQ ($26.85 in chips) 
ShXPHWfjhfmAwLgDdm6bRQ: posts small blind $0.10
ELW+DKizJhLK7k40PMkD2Q: posts big blind $0.25
*** HOLE CARDS ***
kReyZ6g6Fu3tQ0nyjDf9kA: folds 
zHHLkD2sRljslKKeQv/ZQw: raises $0.50 to $0.75
NhUN/JpAprdJeamFBgJH1w: folds 
wKFJ513ucluNNiMlkXcDOQ: folds 
ShXPHWfjhfmAwLgDdm6bRQ: folds 
ELW+DKizJhLK7k40PMkD2Q: folds 
Uncalled bet ($0.50) returned to zHHLkD2sRljslKKeQv/ZQw
zHHLkD2sRljslKKeQv/ZQw collected $0.60 from pot
*** SUMMARY ***
Total pot $0.60 | Rake $0 
Seat 1: ShXPHWfjhfmAwLgDdm6bRQ (small blind) folded before Flop
Seat 2: ELW+DKizJhLK7k40PMkD2Q (big blind) folded before Flop
Seat 3: kReyZ6g6Fu3tQ0nyjDf9kA folded before Flop (didn't bet)
Seat 4: zHHLkD2sRljslKKeQv/ZQw collected ($0.60)
Seat 5: NhUN/JpAprdJeamFBgJH1w folded before Flop (didn't bet)
Seat 6: wKFJ513ucluNNiMlkXcDOQ (button) folded before Flop (didn't bet)




PokerStars Game #59939669146:  Hold'em No Limit ($0.10/$0.25) - 2009/07/01 0:45:51 ET
Table 'mF3KHGMaTpaBZbtBoyfTeg' 6-max Seat #6 is the button
Seat 1: 0HAB2GdCAM7p7V00xueAVQ ($9.40 in chips) 
Seat 2: 4x9jCqgSw4272dnaIqnanw ($5 in chips) 
Seat 3: Hzrn9DZJegEZICufTNYkrg ($13.65 in chips) 
Seat 4: FYepjhAvF8ZdVCmqHIy+eQ ($25 in chips) 
Seat 5: sEQx9G5Cu8k1HNdQasxvUA ($33.55 in chips) 
Seat 6: kG34n23qFQA3nzdOJTQ1dA ($24.65 in chips) 
0HAB2GdCAM7p7V00xueAVQ: posts small blind $0.10
4x9jCqgSw4272dnaIqnanw: posts big blind $0.25
*** HOLE CARDS ***
Hzrn9DZJegEZICufTNYkrg: calls $0.25
FYepjhAvF8ZdVCmqHIy+eQ: folds 
sEQx9G5Cu8k1HNdQasxvUA: raises $1 to $1.25
kG34n23qFQA3nzdOJTQ1dA: folds 
0HAB2GdCAM7p7V00xueAVQ: folds 
4x9jCqgSw4272dnaIqnanw: raises $3.75 to $5 and is all-in
Hzrn9DZJegEZICufTNYkrg: folds 
sEQx9G5Cu8k1HNdQasxvUA: calls $3.75
*** FLOP *** [2c Th Kc]
*** TURN *** [2c Th Kc] [5c]
*** RIVER *** [2c Th Kc 5c] [6c]
*** SHOW DOWN ***
4x9jCqgSw4272dnaIqnanw: shows [9h 9d] (a pair of Nines)
sEQx9G5Cu8k1HNdQasxvUA: shows [Ks 8h] (a pair of Kings)
sEQx9G5Cu8k1HNdQasxvUA collected $9.85 from pot
*** SUMMARY ***
Total pot $10.35 | Rake $0.50 
Board [2c Th Kc 5c 6c]
Seat 1: 0HAB2GdCAM7p7V00xueAVQ (small blind) folded before Flop
Seat 2: 4x9jCqgSw4272dnaIqnanw (big blind) showed [9h 9d] and lost with a pair of Nines
Seat 3: Hzrn9DZJegEZICufTNYkrg folded before Flop
Seat 4: FYepjhAvF8ZdVCmqHIy+eQ folded before Flop (didn't bet)
Seat 5: sEQx9G5Cu8k1HNdQasxvUA showed [Ks 8h] and won ($9.85) with a pair of Kings
Seat 6: kG34n23qFQA3nzdOJTQ1dA (button) folded before Flop (didn't bet)




PokerStars Game #59939669470:  Hold'em No Limit ($0.10/$0.25) - 2009/07/01 0:45:51 ET
Table 'o0CDOvKO/bn1WjeymDrXfA' 6-max Seat #5 is the button
Seat 1: 32YL2ZEp8NT4JB2RVM9euQ ($16.25 in chips) 
Seat 2: oc4ZGs0W+3RIg2yPyJw3ig ($30.10 in chips) 
Seat 3: EqXTTLKUlDlz7yi6ziyyWA ($25 in chips) 
Seat 4: NuqYPwTLZYQhxOoVK3Yqlw ($25.10 in chips) 
Seat 5: u/yN5P9f3KlATg6WLWNkBQ ($28 in chips) 
Seat 6: Bada343Si4xKu3fNXY99AA ($31.25 in chips) 
Bada343Si4xKu3fNXY99AA: posts small blind $0.10
32YL2ZEp8NT4JB2RVM9euQ: posts big blind $0.25
*** HOLE CARDS ***
oc4ZGs0W+3RIg2yPyJw3ig: calls $0.25
EqXTTLKUlDlz7yi6ziyyWA: folds 
NuqYPwTLZYQhxOoVK3Yqlw: folds 
u/yN5P9f3KlATg6WLWNkBQ: folds 
Bada343Si4xKu3fNXY99AA: calls $0.15
32YL2ZEp8NT4JB2RVM9euQ: checks 
*** FLOP *** [9h Td 3c]
Bada343Si4xKu3fNXY99AA: bets $0.50
32YL2ZEp8NT4JB2RVM9euQ: folds 
oc4ZGs0W+3RIg2yPyJw3ig: calls $0.50
*** TURN *** [9h Td 3c] [7s]
Bada343Si4xKu3fNXY99AA: checks 
oc4ZGs0W+3RIg2yPyJw3ig: bets $1
Bada343Si4xKu3fNXY99AA: calls $1
*** RIVER *** [9h Td 3c 7s] [2d]
Bada343Si4xKu3fNXY99AA: checks 
oc4ZGs0W+3RIg2yPyJw3ig: bets $3
Bada343Si4xKu3fNXY99AA: folds 
Uncalled bet ($3) returned to oc4ZGs0W+3RIg2yPyJw3ig
oc4ZGs0W+3RIg2yPyJw3ig collected $3.60 from pot
*** SUMMARY ***
Total pot $3.75 | Rake $0.15 
Board [9h Td 3c 7s 2d]
Seat 1: 32YL2ZEp8NT4JB2RVM9euQ (big blind) folded on the Flop
Seat 2: oc4ZGs0W+3RIg2yPyJw3ig collected ($3.60)
Seat 3: EqXTTLKUlDlz7yi6ziyyWA folded before Flop (didn't bet)
Seat 4: NuqYPwTLZYQhxOoVK3Yqlw folded before Flop (didn't bet)
Seat 5: u/yN5P9f3KlATg6WLWNkBQ (button) folded before Flop (didn't bet)
Seat 6: Bada343Si4xKu3fNXY99AA (small blind) folded on the River




PokerStars Game #59939669692:  Hold'em No Limit ($0.10/$0.25) - 2009/07/01 0:45:51 ET
Table 'zW+7jPbOLCvlPu+dUGY5WQ' 6-max Seat #3 is the button
Seat 1: JE/wJXmjw3bpdmjwvh2pcg ($25 in chips) 
Seat 2: DXgVFTcE3WofABsNJ5G/nw ($38.80 in chips) 
Seat 3: BedjMfrlRfPgSq7CXpPAmg ($63.40 in chips) 
Seat 5: SFmT9ZsVopnukjvAzrxTRg ($55.20 in chips) 
Seat 6: BiLBinPhgpKAYzLgKJVU5A ($21.45 in chips) 
SFmT9ZsVopnukjvAzrxTRg: posts small blind $0.10
BiLBinPhgpKAYzLgKJVU5A: posts big blind $0.25
*** HOLE CARDS ***
JE/wJXmjw3bpdmjwvh2pcg: folds 
DXgVFTcE3WofABsNJ5G/nw: folds 
BedjMfrlRfPgSq7CXpPAmg: folds 
SFmT9ZsVopnukjvAzrxTRg: folds 
Uncalled bet ($0.15) returned to BiLBinPhgpKAYzLgKJVU5A
BiLBinPhgpKAYzLgKJVU5A collected $0.20 from pot
*** SUMMARY ***
Total pot $0.20 | Rake $0 
Seat 1: JE/wJXmjw3bpdmjwvh2pcg folded before Flop (didn't bet)
Seat 2: DXgVFTcE3WofABsNJ5G/nw folded before Flop (didn't bet)
Seat 3: BedjMfrlRfPgSq7CXpPAmg (button) folded before Flop (didn't bet)
Seat 5: SFmT9ZsVopnukjvAzrxTRg (small blind) folded before Flop
Seat 6: BiLBinPhgpKAYzLgKJVU5A (big blind) collected ($0.20)




PokerStars Game #59939669706:  Hold'em No Limit ($0.10/$0.25) - 2009/07/01 0:45:51 ET
Table '+UzantPJ4smVdrh+4GTu1w' 6-max Seat #3 is the button
Seat 2: tcbEu7VzyHQ+0lh+skbQhQ ($14.95 in chips) 
Seat 3: SS/yfeArhULzIcOPe8MdPg ($50.90 in chips) 
Seat 4: IGRfskE1v9H9Bn+fz8AgNQ ($22.15 in chips) 
Seat 5: cj4VBQya7HtVL2zCGd5jLQ ($22.05 in chips) 
Seat 6: BYxjLnV1/LL0aZcTbfAOvw ($47.70 in chips) 
IGRfskE1v9H9Bn+fz8AgNQ: posts small blind $0.10
cj4VBQya7HtVL2zCGd5jLQ: posts big blind $0.25
4jrz/IbtclK1xNH6lZqJNA: sits out 
*** HOLE CARDS ***
BYxjLnV1/LL0aZcTbfAOvw: folds 
tcbEu7VzyHQ+0lh+skbQhQ: folds 
SS/yfeArhULzIcOPe8MdPg: folds 
IGRfskE1v9H9Bn+fz8AgNQ: folds 
Uncalled bet ($0.15) returned to cj4VBQya7HtVL2zCGd5jLQ
cj4VBQya7HtVL2zCGd5jLQ collected $0.20 from pot
*** SUMMARY ***
Total pot $0.20 | Rake $0 
Seat 2: tcbEu7VzyHQ+0lh+skbQhQ folded before Flop (didn't bet)
Seat 3: SS/yfeArhULzIcOPe8MdPg (button) folded before Flop (didn't bet)
Seat 4: IGRfskE1v9H9Bn+fz8AgNQ (small blind) folded before Flop
Seat 5: cj4VBQya7HtVL2zCGd5jLQ (big blind) collected ($0.20)
Seat 6: BYxjLnV1/LL0aZcTbfAOvw folded before Flop (didn't bet)




PokerStars Game #59939669466:  Hold'em No Limit ($0.10/$0.25) - 2009/07/01 0:45:51 ET
Table 'Of/T60zpXg1GcjrZ7Lm//Q' 9-max Seat #6 is the button
Seat 1: Lro4e37x4FUa5P3yzDjskw ($7.50 in chips) 
Seat 2: hIss79a4pu7GzJZepfgOpg ($25 in chips) 
Seat 3: jeKWRUkMaVn8rEUjnJKqpg ($28 in chips) 
Seat 4: Czut6V7acIqUJrrobjKAZg ($24.55 in chips) 
Seat 6: tYsOBqdU1+x+yFI7zHO7hQ ($25.90 in chips) 
Seat 7: s7Q6uNouhe7aE8JdFb9E+A ($34.70 in chips) 
Seat 8: ghNKXUBl/H+t83JF079ZBA ($31.25 in chips) 
Seat 9: TeWJxSETzbXGiYKx0y+dtg ($25 in chips) 
s7Q6uNouhe7aE8JdFb9E+A: posts small blind $0.10
ghNKXUBl/H+t83JF079ZBA: posts big blind $0.25
*** HOLE CARDS ***
TeWJxSETzbXGiYKx0y+dtg: folds 
Lro4e37x4FUa5P3yzDjskw: folds 
hIss79a4pu7GzJZepfgOpg: folds 
jeKWRUkMaVn8rEUjnJKqpg: folds 
Czut6V7acIqUJrrobjKAZg: raises $0.50 to $0.75
tYsOBqdU1+x+yFI7zHO7hQ: folds 
s7Q6uNouhe7aE8JdFb9E+A: folds 
ghNKXUBl/H+t83JF079ZBA: folds 
Uncalled bet ($0.50) returned to Czut6V7acIqUJrrobjKAZg
Czut6V7acIqUJrrobjKAZg collected $0.60 from pot
*** SUMMARY ***
Total pot $0.60 | Rake $0 
Seat 1: Lro4e37x4FUa5P3yzDjskw folded before Flop (didn't bet)
Seat 2: hIss79a4pu7GzJZepfgOpg folded before Flop (didn't bet)
Seat 3: jeKWRUkMaVn8rEUjnJKqpg folded before Flop (didn't bet)
Seat 4: Czut6V7acIqUJrrobjKAZg collected ($0.60)
Seat 6: tYsOBqdU1+x+yFI7zHO7hQ (button) folded before Flop (didn't bet)
Seat 7: s7Q6uNouhe7aE8JdFb9E+A (small blind) folded before Flop
Seat 8: ghNKXUBl/H+t83JF079ZBA (big blind) folded before Flop
Seat 9: TeWJxSETzbXGiYKx0y+dtg folded before Flop (didn't bet)




PokerStars Game #59939669622:  Hold'em No Limit ($0.10/$0.25) - 2009/07/01 0:45:51 ET
Table 'Y9EhDWuqWWQFM9SelXAj5g' 9-max Seat #9 is the button
Seat 1: zDrucyjVn5aeekNEc3cJrA ($19.20 in chips) 
Seat 2: nEg1b6MIksd/4x5eLY735g ($39.10 in chips) 
Seat 3: CbXUS6Z2rXZxL1AKduNtmQ ($25 in chips) 
Seat 4: 5MgYq10OC5iGoxQFwlJVuw ($14.30 in chips) 
Seat 6: STkR8XvpjNv79OOMhrlh2w ($28.95 in chips) 
Seat 7: aNpwfA31EREwO+ar4XzBCw ($30.25 in chips) 
Seat 8: XDxyajtqmdag0QPvwcOG7Q ($9.35 in chips) 
Seat 9: K7bAhhMMJ/XcTmGaBZVfFQ ($24.80 in chips) 
zDrucyjVn5aeekNEc3cJrA: posts small blind $0.10
nEg1b6MIksd/4x5eLY735g: posts big blind $0.25
*** HOLE CARDS ***
CbXUS6Z2rXZxL1AKduNtmQ: folds 
5MgYq10OC5iGoxQFwlJVuw: folds 
STkR8XvpjNv79OOMhrlh2w: folds 
aNpwfA31EREwO+ar4XzBCw: folds 
XDxyajtqmdag0QPvwcOG7Q: folds 
K7bAhhMMJ/XcTmGaBZVfFQ: raises $0.75 to $1
zDrucyjVn5aeekNEc3cJrA: folds 
nEg1b6MIksd/4x5eLY735g: folds 
Uncalled bet ($0.75) returned to K7bAhhMMJ/XcTmGaBZVfFQ
K7bAhhMMJ/XcTmGaBZVfFQ collected $0.60 from pot
K7bAhhMMJ/XcTmGaBZVfFQ: doesn't show hand 
*** SUMMARY ***
Total pot $0.60 | Rake $0 
Seat 1: zDrucyjVn5aeekNEc3cJrA (small blind) folded before Flop
Seat 2: nEg1b6MIksd/4x5eLY735g (big blind) folded before Flop
Seat 3: CbXUS6Z2rXZxL1AKduNtmQ folded before Flop (didn't bet)
Seat 4: 5MgYq10OC5iGoxQFwlJVuw folded before Flop (didn't bet)
Seat 6: STkR8XvpjNv79OOMhrlh2w folded before Flop (didn't bet)
Seat 7: aNpwfA31EREwO+ar4XzBCw folded before Flop (didn't bet)
Seat 8: XDxyajtqmdag0QPvwcOG7Q folded before Flop (didn't bet)
Seat 9: K7bAhhMMJ/XcTmGaBZVfFQ (button) collected ($0.60)




PokerStars Game #59939669414:  Hold'em No Limit ($0.10/$0.25) - 2009/07/01 0:45:51 ET
Table 'O5NgMYt6EWbLBozZb3kseg' 6-max Seat #2 is the button
Seat 1: T2fEtpqj5ZyZAjEhNtsFAA ($56.50 in chips) 
Seat 2: VWbjqONyDvf8KegytgPLjQ ($57.40 in chips) 
Seat 5: vu2kzHaDtgr6NM7rdq0chA ($75.15 in chips) 
Seat 6: k9vn40MOqqb+xF+7GZ6v2g ($19 in chips) 
dg3SMYXD7586yGx+LuFM0g will be allowed to play after the button
aogAb4Eienxztk8p2v9VVw will be allowed to play after the button
vu2kzHaDtgr6NM7rdq0chA: posts small blind $0.10
k9vn40MOqqb+xF+7GZ6v2g: posts big blind $0.25
*** HOLE CARDS ***
T2fEtpqj5ZyZAjEhNtsFAA: folds 
VWbjqONyDvf8KegytgPLjQ: raises $0.75 to $1
vu2kzHaDtgr6NM7rdq0chA: folds 
k9vn40MOqqb+xF+7GZ6v2g: folds 
Uncalled bet ($0.75) returned to VWbjqONyDvf8KegytgPLjQ
VWbjqONyDvf8KegytgPLjQ collected $0.60 from pot
VWbjqONyDvf8KegytgPLjQ: doesn't show hand 
*** SUMMARY ***
Total pot $0.60 | Rake $0 
Seat 1: T2fEtpqj5ZyZAjEhNtsFAA folded before Flop (didn't bet)
Seat 2: VWbjqONyDvf8KegytgPLjQ (button) collected ($0.60)
Seat 5: vu2kzHaDtgr6NM7rdq0chA (small blind) folded before Flop
Seat 6: k9vn40MOqqb+xF+7GZ6v2g (big blind) folded before Flop




PokerStars Game #59939669464:  Hold'em No Limit ($0.10/$0.25) - 2009/07/01 0:45:51 ET
Table 'xmJKTGBeWCwutccj3YfupQ' 6-max Seat #6 is the button
Seat 2: BedjMfrlRfPgSq7CXpPAmg ($48.85 in chips) 
Seat 3: FStoHe64SQWqAsjya9pDkQ ($25.80 in chips) 
Seat 5: oBUDUfeUyCbZBsjxHZgSiw ($16.55 in chips) 
Seat 6: lYjWCpfCxX2kgcHY3v4Yow ($26 in chips) 
BedjMfrlRfPgSq7CXpPAmg: posts small blind $0.10
FStoHe64SQWqAsjya9pDkQ: posts big blind $0.25
*** HOLE CARDS ***
oBUDUfeUyCbZBsjxHZgSiw: folds 
lYjWCpfCxX2kgcHY3v4Yow: raises $0.50 to $0.75
BedjMfrlRfPgSq7CXpPAmg: calls $0.65
FStoHe64SQWqAsjya9pDkQ: folds 
*** FLOP *** [8c Js Jd]
BedjMfrlRfPgSq7CXpPAmg: bets $1.10
lYjWCpfCxX2kgcHY3v4Yow: folds 
Uncalled bet ($1.10) returned to BedjMfrlRfPgSq7CXpPAmg
BedjMfrlRfPgSq7CXpPAmg collected $1.70 from pot
*** SUMMARY ***
Total pot $1.75 | Rake $0.05 
Board [8c Js Jd]
Seat 2: BedjMfrlRfPgSq7CXpPAmg (small blind) collected ($1.70)
Seat 3: FStoHe64SQWqAsjya9pDkQ (big blind) folded before Flop
Seat 5: oBUDUfeUyCbZBsjxHZgSiw folded before Flop (didn't bet)
Seat 6: lYjWCpfCxX2kgcHY3v4Yow (button) folded on the Flop




PokerStars Game #59939669904:  Hold'em No Limit ($0.10/$0.25) - 2009/07/01 0:45:52 ET
Table 'tErGGDyESv/0llKumVeZuQ' 9-max Seat #6 is the button
Seat 1: R3KkgiqTvuhazyCqaD9cZg ($11.75 in chips) 
Seat 3: CvL9Ch1HYCVbTsfpNucitg ($4.75 in chips) 
Seat 4: j1oAjkBBlFRUy+e+LF1vNQ ($6.95 in chips) 
Seat 5: le+pqvOEeS8Vvxt8ogLv/w ($11.40 in chips) 
Seat 6: zDrucyjVn5aeekNEc3cJrA ($29.50 in chips) 
Seat 7: s7Q6uNouhe7aE8JdFb9E+A ($25.40 in chips) 
Seat 8: Sv38qYH3jj8a8dddDi1aUA ($14.50 in chips) 
Seat 9: r284m4NA4rtNktI86R8/Yw ($13.55 in chips) 
s7Q6uNouhe7aE8JdFb9E+A: posts small blind $0.10
Sv38qYH3jj8a8dddDi1aUA: posts big blind $0.25
V6p0jQ/RhUsqpHLmXvEX4Q: sits out 
*** HOLE CARDS ***
r284m4NA4rtNktI86R8/Yw: folds 
R3KkgiqTvuhazyCqaD9cZg: folds 
CvL9Ch1HYCVbTsfpNucitg: folds 
j1oAjkBBlFRUy+e+LF1vNQ: raises $0.25 to $0.50
le+pqvOEeS8Vvxt8ogLv/w: calls $0.50
zDrucyjVn5aeekNEc3cJrA: folds 
s7Q6uNouhe7aE8JdFb9E+A: folds 
Sv38qYH3jj8a8dddDi1aUA: folds 
*** FLOP *** [Td 9h 5s]
j1oAjkBBlFRUy+e+LF1vNQ: bets $0.75
le+pqvOEeS8Vvxt8ogLv/w: folds 
Uncalled bet ($0.75) returned to j1oAjkBBlFRUy+e+LF1vNQ
j1oAjkBBlFRUy+e+LF1vNQ collected $1.30 from pot
j1oAjkBBlFRUy+e+LF1vNQ: doesn't show hand 
*** SUMMARY ***
Total pot $1.35 | Rake $0.05 
Board [Td 9h 5s]
Seat 1: R3KkgiqTvuhazyCqaD9cZg folded before Flop (didn't bet)
Seat 3: CvL9Ch1HYCVbTsfpNucitg folded before Flop (didn't bet)
Seat 4: j1oAjkBBlFRUy+e+LF1vNQ collected ($1.30)
Seat 5: le+pqvOEeS8Vvxt8ogLv/w folded on the Flop
Seat 6: zDrucyjVn5aeekNEc3cJrA (button) folded before Flop (didn't bet)
Seat 7: s7Q6uNouhe7aE8JdFb9E+A (small blind) folded before Flop
Seat 8: Sv38qYH3jj8a8dddDi1aUA (big blind) folded before Flop
Seat 9: r284m4NA4rtNktI86R8/Yw folded before Flop (didn't bet)




PokerStars Game #59939669976:  Hold'em No Limit ($0.10/$0.25) - 2009/07/01 0:45:52 ET
Table 'luMgmRPIo47e7iXDlheIwA' 6-max Seat #1 is the button
Seat 1: z/jAqpWD9ifpbtEpwGyInw ($8.90 in chips) 
Seat 3: W6Y6au0wf7gRAlqJYgOezw ($12.55 in chips) 
Seat 4: n2OZezRXTtdzQt4SuIy8TQ ($23.85 in chips) 
4YSTu0Cdzpppe1lUgCZGCQ was removed from the table for failing to post
W6Y6au0wf7gRAlqJYgOezw: posts small blind $0.10
n2OZezRXTtdzQt4SuIy8TQ: posts big blind $0.25
zxeVQGaMKDsDzmSY+AInjA: sits out 
Zb8xGmbjS8ghABxs9n6huA: sits out 
*** HOLE CARDS ***
z/jAqpWD9ifpbtEpwGyInw: calls $0.25
W6Y6au0wf7gRAlqJYgOezw: folds 
n2OZezRXTtdzQt4SuIy8TQ: checks 
*** FLOP *** [7h Jc Js]
n2OZezRXTtdzQt4SuIy8TQ: checks 
z/jAqpWD9ifpbtEpwGyInw: checks 
*** TURN *** [7h Jc Js] [8c]
n2OZezRXTtdzQt4SuIy8TQ: checks 
z/jAqpWD9ifpbtEpwGyInw: checks 
*** RIVER *** [7h Jc Js 8c] [Ac]
n2OZezRXTtdzQt4SuIy8TQ: checks 
z/jAqpWD9ifpbtEpwGyInw: bets $1
hZJzYj+7+PvGu6ae1g//sQ joins the table at seat #2 
n2OZezRXTtdzQt4SuIy8TQ: calls $1
*** SHOW DOWN ***
z/jAqpWD9ifpbtEpwGyInw: shows [Qd Jh] (three of a kind, Jacks)
n2OZezRXTtdzQt4SuIy8TQ: mucks hand 
z/jAqpWD9ifpbtEpwGyInw collected $2.50 from pot
*** SUMMARY ***
Total pot $2.60 | Rake $0.10 
Board [7h Jc Js 8c Ac]
Seat 1: z/jAqpWD9ifpbtEpwGyInw (button) showed [Qd Jh] and won ($2.50) with three of a kind, Jacks
Seat 3: W6Y6au0wf7gRAlqJYgOezw (small blind) folded before Flop
Seat 4: n2OZezRXTtdzQt4SuIy8TQ (big blind) mucked




PokerStars Game #59939669902:  Hold'em No Limit ($0.10/$0.25) - 2009/07/01 0:45:52 ET
Table 'by7aHYEDnDd144EXOXa/jA' 9-max Seat #9 is the button
Seat 2: vSkQm2EelzwRGDDQQk0Fqw ($5.25 in chips) 
Seat 3: 1Clf3cPrqoy/YgvWdWK1Xw ($5.55 in chips) 
Seat 4: vZGoOTJLQLhkPj4I+LNGig ($47.40 in chips) 
Seat 5: yyG4svzOpC1A+sUP/scg6w ($7.15 in chips) 
Seat 6: DIBbjEYGs+TVdVgEB/4+3w ($30.85 in chips) 
Seat 8: s7Q6uNouhe7aE8JdFb9E+A ($25.25 in chips) 
Seat 9: K0b5wNInj6hUGRr6yzKFtw ($25 in chips) 
vSkQm2EelzwRGDDQQk0Fqw: posts small blind $0.10
1Clf3cPrqoy/YgvWdWK1Xw: posts big blind $0.25
V6p0jQ/RhUsqpHLmXvEX4Q: sits out 
*** HOLE CARDS ***
vZGoOTJLQLhkPj4I+LNGig: folds 
yyG4svzOpC1A+sUP/scg6w: folds 
DIBbjEYGs+TVdVgEB/4+3w: folds 
s7Q6uNouhe7aE8JdFb9E+A: folds 
K0b5wNInj6hUGRr6yzKFtw: raises $0.75 to $1
vSkQm2EelzwRGDDQQk0Fqw: folds 
1Clf3cPrqoy/YgvWdWK1Xw: folds 
Uncalled bet ($0.75) returned to K0b5wNInj6hUGRr6yzKFtw
K0b5wNInj6hUGRr6yzKFtw collected $0.60 from pot
K0b5wNInj6hUGRr6yzKFtw: doesn't show hand 
*** SUMMARY ***
Total pot $0.60 | Rake $0 
Seat 2: vSkQm2EelzwRGDDQQk0Fqw (small blind) folded before Flop
Seat 3: 1Clf3cPrqoy/YgvWdWK1Xw (big blind) folded before Flop
Seat 4: vZGoOTJLQLhkPj4I+LNGig folded before Flop (didn't bet)
Seat 5: yyG4svzOpC1A+sUP/scg6w folded before Flop (didn't bet)
Seat 6: DIBbjEYGs+TVdVgEB/4+3w folded before Flop (didn't bet)
Seat 8: s7Q6uNouhe7aE8JdFb9E+A folded before Flop (didn't bet)
Seat 9: K0b5wNInj6hUGRr6yzKFtw (button) collected ($0.60)




PokerStars Game #59939670194:  Hold'em No Limit ($0.10/$0.25) - 2009/07/01 0:45:52 ET
Table 'pgrBYaOEx/BuqK5iAtlFzw' 9-max Seat #8 is the button
Seat 1: QsLvCwfSWqP+CfjwUnjpXQ ($29.90 in chips) 
Seat 3: rNeDTnQfuSImIGLqvEu7DQ ($8.60 in chips) 
Seat 4: 6meFEBwAfXU5eLC35rA/sw ($5.45 in chips) 
Seat 6: OqlfFV+MkgflYrm4Q6rLMA ($4.75 in chips) 
Seat 7: jXz58rvCgq0VjyVjUBf2mw ($24.65 in chips) 
Seat 8: cFmpjvcjNoVAEAIQIxWkYg ($25 in chips) 
Seat 9: CvL9Ch1HYCVbTsfpNucitg ($4.75 in chips) 
CvL9Ch1HYCVbTsfpNucitg: posts small blind $0.10
QsLvCwfSWqP+CfjwUnjpXQ: posts big blind $0.25
hZuGwtYmFKPmQ+v1wlmdfA: sits out 
*** HOLE CARDS ***
rNeDTnQfuSImIGLqvEu7DQ: calls $0.25
6meFEBwAfXU5eLC35rA/sw: calls $0.25
OqlfFV+MkgflYrm4Q6rLMA: folds 
jXz58rvCgq0VjyVjUBf2mw: folds 
cFmpjvcjNoVAEAIQIxWkYg: folds 
BWzInv8o0kN1pJybv/VjpQ joins the table at seat #5 
CvL9Ch1HYCVbTsfpNucitg: folds 
QsLvCwfSWqP+CfjwUnjpXQ: checks 
*** FLOP *** [3s Qc Jh]
QsLvCwfSWqP+CfjwUnjpXQ: checks 
rNeDTnQfuSImIGLqvEu7DQ: checks 
6meFEBwAfXU5eLC35rA/sw: checks 
*** TURN *** [3s Qc Jh] [3d]
QsLvCwfSWqP+CfjwUnjpXQ: checks 
rNeDTnQfuSImIGLqvEu7DQ: checks 
6meFEBwAfXU5eLC35rA/sw: bets $0.50
QsLvCwfSWqP+CfjwUnjpXQ: folds 
rNeDTnQfuSImIGLqvEu7DQ: folds 
Uncalled bet ($0.50) returned to 6meFEBwAfXU5eLC35rA/sw
6meFEBwAfXU5eLC35rA/sw collected $0.85 from pot
*** SUMMARY ***
Total pot $0.85 | Rake $0 
Board [3s Qc Jh 3d]
Seat 1: QsLvCwfSWqP+CfjwUnjpXQ (big blind) folded on the Turn
Seat 3: rNeDTnQfuSImIGLqvEu7DQ folded on the Turn
Seat 4: 6meFEBwAfXU5eLC35rA/sw collected ($0.85)
Seat 6: OqlfFV+MkgflYrm4Q6rLMA folded before Flop (didn't bet)
Seat 7: jXz58rvCgq0VjyVjUBf2mw folded before Flop (didn't bet)
Seat 8: cFmpjvcjNoVAEAIQIxWkYg (button) folded before Flop (didn't bet)
Seat 9: CvL9Ch1HYCVbTsfpNucitg (small blind) folded before Flop




PokerStars Game #59939670112:  Hold'em No Limit ($0.10/$0.25) - 2009/07/01 0:45:52 ET
Table 'Loy/olZ5qoDOSvX4UTujGg' 6-max Seat #2 is the button
Seat 1: yzFNNFIfC89bBPwpFPx2ow ($25 in chips) 
Seat 2: 5OssdLlobpBsQP4GLYbbZQ ($5.25 in chips) 
Seat 3: 32YL2ZEp8NT4JB2RVM9euQ ($20.05 in chips) 
Seat 4: /gJNBeCkWL4o85/jvlZ4BA ($27.10 in chips) 
Seat 5: 4YSTu0Cdzpppe1lUgCZGCQ ($62.35 in chips) 
Seat 6: 7FmwVDcdEtxDpHmP4hOXsQ ($52.35 in chips) 
32YL2ZEp8NT4JB2RVM9euQ: posts small blind $0.10
/gJNBeCkWL4o85/jvlZ4BA: posts big blind $0.25
*** HOLE CARDS ***
4YSTu0Cdzpppe1lUgCZGCQ: folds 
7FmwVDcdEtxDpHmP4hOXsQ: folds 
yzFNNFIfC89bBPwpFPx2ow: folds 
5OssdLlobpBsQP4GLYbbZQ: raises $0.75 to $1
32YL2ZEp8NT4JB2RVM9euQ: folds 
/gJNBeCkWL4o85/jvlZ4BA: folds 
Uncalled bet ($0.75) returned to 5OssdLlobpBsQP4GLYbbZQ
5OssdLlobpBsQP4GLYbbZQ collected $0.60 from pot
*** SUMMARY ***
Total pot $0.60 | Rake $0 
Seat 1: yzFNNFIfC89bBPwpFPx2ow folded before Flop (didn't bet)
Seat 2: 5OssdLlobpBsQP4GLYbbZQ (button) collected ($0.60)
Seat 3: 32YL2ZEp8NT4JB2RVM9euQ (small blind) folded before Flop
Seat 4: /gJNBeCkWL4o85/jvlZ4BA (big blind) folded before Flop
Seat 5: 4YSTu0Cdzpppe1lUgCZGCQ folded before Flop (didn't bet)
Seat 6: 7FmwVDcdEtxDpHmP4hOXsQ folded before Flop (didn't bet)




PokerStars Game #59939670312:  Hold'em No Limit ($0.10/$0.25) - 2009/07/01 0:45:52 ET
Table '6wawJ+MkkvuC3coG6r+Yhg' 6-max Seat #2 is the button
Seat 1: ELW+DKizJhLK7k40PMkD2Q ($32.50 in chips) 
Seat 2: LtASJ9OlkqGrrUKGQlpGAw ($26.05 in chips) 
Seat 3: KYBwVA7jgmSrbIEbEGElVg ($15.10 in chips) 
Seat 4: cS21pIxRHx5Gt42o7hPZzw ($11.50 in chips) 
Seat 5: A8uIskXJTblhVXWuYr+lkw ($8.20 in chips) 
Seat 6: oOGZlBAhqtG/HczLL/KLRQ ($21.10 in chips) 
KYBwVA7jgmSrbIEbEGElVg: posts small blind $0.10
cS21pIxRHx5Gt42o7hPZzw: posts big blind $0.25
*** HOLE CARDS ***
A8uIskXJTblhVXWuYr+lkw: calls $0.25
oOGZlBAhqtG/HczLL/KLRQ: folds 
ELW+DKizJhLK7k40PMkD2Q: folds 
LtASJ9OlkqGrrUKGQlpGAw: folds 
KYBwVA7jgmSrbIEbEGElVg: raises $0.75 to $1
cS21pIxRHx5Gt42o7hPZzw: folds 
A8uIskXJTblhVXWuYr+lkw: folds 
Uncalled bet ($0.75) returned to KYBwVA7jgmSrbIEbEGElVg
KYBwVA7jgmSrbIEbEGElVg collected $0.75 from pot
*** SUMMARY ***
Total pot $0.75 | Rake $0 
Seat 1: ELW+DKizJhLK7k40PMkD2Q folded before Flop (didn't bet)
Seat 2: LtASJ9OlkqGrrUKGQlpGAw (button) folded before Flop (didn't bet)
Seat 3: KYBwVA7jgmSrbIEbEGElVg (small blind) collected ($0.75)
Seat 4: cS21pIxRHx5Gt42o7hPZzw (big blind) folded before Flop
Seat 5: A8uIskXJTblhVXWuYr+lkw folded before Flop
Seat 6: oOGZlBAhqtG/HczLL/KLRQ folded before Flop (didn't bet)




PokerStars Game #59939670046:  Hold'em No Limit ($0.10/$0.25) - 2009/07/01 0:45:52 ET
Table 'BpNkESDX1ip9c0K1hb5h7A' 6-max Seat #2 is the button
Seat 1: 9jSiy0meE9XJKkdIZwyTEQ ($28.90 in chips) 
Seat 2: gqW2aBCmrIw65BvwjTFN6Q ($25.25 in chips) 
Seat 3: cHhVLDikFlByGGN+CM3w/A ($23.20 in chips) 
Seat 4: x9VGscBU5oUWy8rQ+Ik80w ($25 in chips) 
Seat 5: QvTX2yGq3uKJiKPmns4TKQ ($75.95 in chips) 
Seat 6: iUgsn+WyKFjjVd+tj13R2w ($13 in chips) 
cHhVLDikFlByGGN+CM3w/A: posts small blind $0.10
x9VGscBU5oUWy8rQ+Ik80w: posts big blind $0.25
*** HOLE CARDS ***
QvTX2yGq3uKJiKPmns4TKQ: folds 
iUgsn+WyKFjjVd+tj13R2w: folds 
9jSiy0meE9XJKkdIZwyTEQ: folds 
gqW2aBCmrIw65BvwjTFN6Q: raises $0.50 to $0.75
cHhVLDikFlByGGN+CM3w/A: calls $0.65
x9VGscBU5oUWy8rQ+Ik80w: folds 
*** FLOP *** [2c 5c Qh]
cHhVLDikFlByGGN+CM3w/A: checks 
gqW2aBCmrIw65BvwjTFN6Q: bets $1.25
cHhVLDikFlByGGN+CM3w/A: calls $1.25
*** TURN *** [2c 5c Qh] [9s]
cHhVLDikFlByGGN+CM3w/A: checks 
gqW2aBCmrIw65BvwjTFN6Q: bets $3
cHhVLDikFlByGGN+CM3w/A: raises $5 to $8
gqW2aBCmrIw65BvwjTFN6Q: folds 
Uncalled bet ($5) returned to cHhVLDikFlByGGN+CM3w/A
cHhVLDikFlByGGN+CM3w/A collected $9.75 from pot
cHhVLDikFlByGGN+CM3w/A: doesn't show hand 
*** SUMMARY ***
Total pot $10.25 | Rake $0.50 
Board [2c 5c Qh 9s]
Seat 1: 9jSiy0meE9XJKkdIZwyTEQ folded before Flop (didn't bet)
Seat 2: gqW2aBCmrIw65BvwjTFN6Q (button) folded on the Turn
Seat 3: cHhVLDikFlByGGN+CM3w/A (small blind) collected ($9.75)
Seat 4: x9VGscBU5oUWy8rQ+Ik80w (big blind) folded before Flop
Seat 5: QvTX2yGq3uKJiKPmns4TKQ folded before Flop (didn't bet)
Seat 6: iUgsn+WyKFjjVd+tj13R2w folded before Flop (didn't bet)




PokerStars Game #59939670766:  Hold'em No Limit ($0.10/$0.25) - 2009/07/01 0:45:53 ET
Table '1LkLBsok91+aSWIELy/cyw' 6-max Seat #6 is the button
Seat 1: /gJNBeCkWL4o85/jvlZ4BA ($25 in chips) 
Seat 2: oseFhpinoe+Zg4j5xyBjyQ ($25.35 in chips) 
Seat 3: +yxuvzJHyIWsJ515X8zJTQ ($16.45 in chips) 
Seat 4: vEZ/HxVuyR6kaq0BtZoUgQ ($4.10 in chips) 
Seat 5: ICa62oT7HjNrT1FWqSNbjg ($14.15 in chips) 
Seat 6: MuW7Zf0FjOGlCuY3aIrlsA ($31.80 in chips) 
/gJNBeCkWL4o85/jvlZ4BA: posts small blind $0.10
oseFhpinoe+Zg4j5xyBjyQ: posts big blind $0.25
ICa62oT7HjNrT1FWqSNbjg: posts big blind $0.25
*** HOLE CARDS ***
+yxuvzJHyIWsJ515X8zJTQ: folds 
vEZ/HxVuyR6kaq0BtZoUgQ: calls $0.25
ICa62oT7HjNrT1FWqSNbjg: checks 
MuW7Zf0FjOGlCuY3aIrlsA: calls $0.25
/gJNBeCkWL4o85/jvlZ4BA: calls $0.15
oseFhpinoe+Zg4j5xyBjyQ: checks 
*** FLOP *** [Js Ac 9s]
/gJNBeCkWL4o85/jvlZ4BA: checks 
oseFhpinoe+Zg4j5xyBjyQ: bets $0.75
vEZ/HxVuyR6kaq0BtZoUgQ: folds 
ICa62oT7HjNrT1FWqSNbjg: folds 
MuW7Zf0FjOGlCuY3aIrlsA: folds 
/gJNBeCkWL4o85/jvlZ4BA: folds 
Uncalled bet ($0.75) returned to oseFhpinoe+Zg4j5xyBjyQ
oseFhpinoe+Zg4j5xyBjyQ collected $1.20 from pot
oseFhpinoe+Zg4j5xyBjyQ: doesn't show hand 
*** SUMMARY ***
Total pot $1.25 | Rake $0.05 
Board [Js Ac 9s]
Seat 1: /gJNBeCkWL4o85/jvlZ4BA (small blind) folded on the Flop
Seat 2: oseFhpinoe+Zg4j5xyBjyQ (big blind) collected ($1.20)
Seat 3: +yxuvzJHyIWsJ515X8zJTQ folded before Flop (didn't bet)
Seat 4: vEZ/HxVuyR6kaq0BtZoUgQ folded on the Flop
Seat 5: ICa62oT7HjNrT1FWqSNbjg folded on the Flop
Seat 6: MuW7Zf0FjOGlCuY3aIrlsA (button) folded on the Flop




PokerStars Game #59939670874:  Hold'em No Limit ($0.10/$0.25) - 2009/07/01 0:45:53 ET
Table 'Pz8SfAzhP5nvWTsJRAxoDg' 6-max Seat #6 is the button
Seat 1: buyjetgNT1McXtdaP4zynA ($39.80 in chips) 
Seat 2: zxeVQGaMKDsDzmSY+AInjA ($15 in chips) 
Seat 3: mfrkWA3PTeYPkbO6hi98Aw ($39.55 in chips) 
Seat 4: 9U9Vy/656QCEfKznJWteag ($14 in chips) 
Seat 5: FYepjhAvF8ZdVCmqHIy+eQ ($30.10 in chips) 
Seat 6: FStoHe64SQWqAsjya9pDkQ ($25.35 in chips) 
buyjetgNT1McXtdaP4zynA: posts small blind $0.10
zxeVQGaMKDsDzmSY+AInjA: posts big blind $0.25
*** HOLE CARDS ***
mfrkWA3PTeYPkbO6hi98Aw: folds 
9U9Vy/656QCEfKznJWteag: raises $0.75 to $1
FYepjhAvF8ZdVCmqHIy+eQ: folds 
FStoHe64SQWqAsjya9pDkQ: folds 
buyjetgNT1McXtdaP4zynA: calls $0.90
zxeVQGaMKDsDzmSY+AInjA: folds 
*** FLOP *** [3s 2s Ah]
buyjetgNT1McXtdaP4zynA: checks 
9U9Vy/656QCEfKznJWteag: checks 
*** TURN *** [3s 2s Ah] [8c]
buyjetgNT1McXtdaP4zynA: bets $1.75
9U9Vy/656QCEfKznJWteag: folds 
Uncalled bet ($1.75) returned to buyjetgNT1McXtdaP4zynA
buyjetgNT1McXtdaP4zynA collected $2.15 from pot
*** SUMMARY ***
Total pot $2.25 | Rake $0.10 
Board [3s 2s Ah 8c]
Seat 1: buyjetgNT1McXtdaP4zynA (small blind) collected ($2.15)
Seat 2: zxeVQGaMKDsDzmSY+AInjA (big blind) folded before Flop
Seat 3: mfrkWA3PTeYPkbO6hi98Aw folded before Flop (didn't bet)
Seat 4: 9U9Vy/656QCEfKznJWteag folded on the Turn
Seat 5: FYepjhAvF8ZdVCmqHIy+eQ folded before Flop (didn't bet)
Seat 6: FStoHe64SQWqAsjya9pDkQ (button) folded before Flop (didn't bet)




PokerStars Game #59939670666:  Hold'em No Limit ($0.10/$0.25) - 2009/07/01 0:45:53 ET
Table 'ORSZkZqq+7Ja2PdeCFAytA' 9-max Seat #1 is the button
Seat 1: Gpa8cld5y0mdOomHJgHhlA ($4.15 in chips) 
Seat 4: PJJTm/ccITEBlwPReiBTwg ($9.75 in chips) 
Seat 5: fOv1xoqR8m9slwElVu7Y+A ($18.05 in chips) 
PJJTm/ccITEBlwPReiBTwg: posts small blind $0.10
fOv1xoqR8m9slwElVu7Y+A: posts big blind $0.25
*** HOLE CARDS ***
Gpa8cld5y0mdOomHJgHhlA: calls $0.25
PJJTm/ccITEBlwPReiBTwg: calls $0.15
fOv1xoqR8m9slwElVu7Y+A: checks 
*** FLOP *** [3c 7s 4h]
PJJTm/ccITEBlwPReiBTwg: checks 
fOv1xoqR8m9slwElVu7Y+A: bets $0.25
Gpa8cld5y0mdOomHJgHhlA: folds 
PJJTm/ccITEBlwPReiBTwg: calls $0.25
*** TURN *** [3c 7s 4h] [2h]
PJJTm/ccITEBlwPReiBTwg: checks 
fOv1xoqR8m9slwElVu7Y+A: bets $0.25
PJJTm/ccITEBlwPReiBTwg: calls $0.25
*** RIVER *** [3c 7s 4h 2h] [Jh]
PJJTm/ccITEBlwPReiBTwg: checks 
fOv1xoqR8m9slwElVu7Y+A: bets $0.25
PJJTm/ccITEBlwPReiBTwg: folds 
Uncalled bet ($0.25) returned to fOv1xoqR8m9slwElVu7Y+A
fOv1xoqR8m9slwElVu7Y+A collected $1.70 from pot
fOv1xoqR8m9slwElVu7Y+A: doesn't show hand 
*** SUMMARY ***
Total pot $1.75 | Rake $0.05 
Board [3c 7s 4h 2h Jh]
Seat 1: Gpa8cld5y0mdOomHJgHhlA (button) folded on the Flop
Seat 4: PJJTm/ccITEBlwPReiBTwg (small blind) folded on the River
Seat 5: fOv1xoqR8m9slwElVu7Y+A (big blind) collected ($1.70)




PokerStars Game #59939670476:  Hold'em No Limit ($0.10/$0.25) - 2009/07/01 0:45:53 ET
Table 'fIrOIN3HoXM27ZpRwKa6oA' 6-max Seat #2 is the button
Seat 1: I1TxPvWj8NfG8orglCinNA ($38.50 in chips) 
Seat 2: 5tB0F9NjPSUL4FzmzBMs2Q ($39.65 in chips) 
Seat 3: eSKnWz2RD4rvwnvB+rFzIg ($24.75 in chips) 
Seat 5: 8ClCHtFXGNplITm+63KB+Q ($26.45 in chips) 
Seat 6: v+QfkGiuj9bgtuNoVnDO8w ($28.85 in chips) 
eSKnWz2RD4rvwnvB+rFzIg: posts small blind $0.10
8ClCHtFXGNplITm+63KB+Q: posts big blind $0.25
*** HOLE CARDS ***
v+QfkGiuj9bgtuNoVnDO8w: folds 
I1TxPvWj8NfG8orglCinNA: folds 
5tB0F9NjPSUL4FzmzBMs2Q: folds 
eSKnWz2RD4rvwnvB+rFzIg: raises $0.50 to $0.75
8ClCHtFXGNplITm+63KB+Q: folds 
Uncalled bet ($0.50) returned to eSKnWz2RD4rvwnvB+rFzIg
eSKnWz2RD4rvwnvB+rFzIg collected $0.50 from pot
eSKnWz2RD4rvwnvB+rFzIg: doesn't show hand 
*** SUMMARY ***
Total pot $0.50 | Rake $0 
Seat 1: I1TxPvWj8NfG8orglCinNA folded before Flop (didn't bet)
Seat 2: 5tB0F9NjPSUL4FzmzBMs2Q (button) folded before Flop (didn't bet)
Seat 3: eSKnWz2RD4rvwnvB+rFzIg (small blind) collected ($0.50)
Seat 5: 8ClCHtFXGNplITm+63KB+Q (big blind) folded before Flop
Seat 6: v+QfkGiuj9bgtuNoVnDO8w folded before Flop (didn't bet)




PokerStars Game #59939670506:  Hold'em No Limit ($0.10/$0.25) - 2009/07/01 0:45:53 ET
Table 'LXz5SsUCyWcm+4JDJh466A' 9-max Seat #4 is the button
Seat 1: MG90wfSJZnOejs/KD3vlQQ ($23.25 in chips) 
Seat 2: H5Se03ZqSX7tbULXur2MAg ($24.15 in chips) 
Seat 3: Iu9xjReQYvxYiqQm8n6MXQ ($3.80 in chips) 
Seat 4: K0b5wNInj6hUGRr6yzKFtw ($25 in chips) 
Seat 6: opOCI2p6kW0tINuVaAqmcQ ($25 in chips) 
Seat 7: EnNp9cILTCYQ95g+8MNFGw ($28.75 in chips) 
Seat 8: VlJdQJbqyBs3oxP5BIw7jA ($99.60 in chips) 
Seat 9: 2N94FgK4Y2izKFIB+wJOjw ($16.95 in chips) 
Z5ZtGOON8kmSdSCll9Z3XA will be allowed to play after the button
opOCI2p6kW0tINuVaAqmcQ: posts small blind $0.10
EnNp9cILTCYQ95g+8MNFGw: posts big blind $0.25
*** HOLE CARDS ***
VlJdQJbqyBs3oxP5BIw7jA: folds 
2N94FgK4Y2izKFIB+wJOjw: folds 
MG90wfSJZnOejs/KD3vlQQ: raises $0.50 to $0.75
H5Se03ZqSX7tbULXur2MAg: folds 
Iu9xjReQYvxYiqQm8n6MXQ: folds 
K0b5wNInj6hUGRr6yzKFtw: folds 
opOCI2p6kW0tINuVaAqmcQ: calls $0.65
EnNp9cILTCYQ95g+8MNFGw: folds 
*** FLOP *** [4d 9c 7c]
opOCI2p6kW0tINuVaAqmcQ: checks 
2N94FgK4Y2izKFIB+wJOjw leaves the table
MG90wfSJZnOejs/KD3vlQQ: bets $1.40
opOCI2p6kW0tINuVaAqmcQ: folds 
Uncalled bet ($1.40) returned to MG90wfSJZnOejs/KD3vlQQ
dtZ84flFEi4Q+SGrHMJRDQ joins the table at seat #9 
MG90wfSJZnOejs/KD3vlQQ collected $1.70 from pot
MG90wfSJZnOejs/KD3vlQQ: doesn't show hand 
*** SUMMARY ***
Total pot $1.75 | Rake $0.05 
Board [4d 9c 7c]
Seat 1: MG90wfSJZnOejs/KD3vlQQ collected ($1.70)
Seat 2: H5Se03ZqSX7tbULXur2MAg folded before Flop (didn't bet)
Seat 3: Iu9xjReQYvxYiqQm8n6MXQ folded before Flop (didn't bet)
Seat 4: K0b5wNInj6hUGRr6yzKFtw (button) folded before Flop (didn't bet)
Seat 6: opOCI2p6kW0tINuVaAqmcQ (small blind) folded on the Flop
Seat 7: EnNp9cILTCYQ95g+8MNFGw (big blind) folded before Flop
Seat 8: VlJdQJbqyBs3oxP5BIw7jA folded before Flop (didn't bet)
Seat 9: 2N94FgK4Y2izKFIB+wJOjw folded before Flop (didn't bet)




PokerStars Game #59939671172:  Hold'em No Limit ($0.10/$0.25) - 2009/07/01 0:45:54 ET
Table '9lYs7ljXi6AgFAxYHlKLJw' 9-max Seat #9 is the button
Seat 1: K0b5wNInj6hUGRr6yzKFtw ($25.10 in chips) 
Seat 2: N6fYvIzQLKaydFLKQGtMlQ ($21.75 in chips) 
Seat 3: DnDcAdn9P0zGovMERigpFA ($25 in chips) 
Seat 4: UANt6y/SmDCY/jIxkBixcw ($30 in chips) 
Seat 5: dfNim92Z6XK1/h5SFW5vDg ($55.20 in chips) 
Seat 7: ghNKXUBl/H+t83JF079ZBA ($28.75 in chips) 
Seat 8: 8GJHzzxiotOqC5gdtgpLoA ($5.90 in chips) 
Seat 9: 18G4P1XstjNvItdGUITxgw ($36.15 in chips) 
K0b5wNInj6hUGRr6yzKFtw: posts small blind $0.10
N6fYvIzQLKaydFLKQGtMlQ: posts big blind $0.25
tYsOBqdU1+x+yFI7zHO7hQ: sits out 
*** HOLE CARDS ***
DnDcAdn9P0zGovMERigpFA: folds 
UANt6y/SmDCY/jIxkBixcw: folds 
dfNim92Z6XK1/h5SFW5vDg: folds 
ghNKXUBl/H+t83JF079ZBA: folds 
8GJHzzxiotOqC5gdtgpLoA: folds 
18G4P1XstjNvItdGUITxgw: folds 
K0b5wNInj6hUGRr6yzKFtw: folds 
Uncalled bet ($0.15) returned to N6fYvIzQLKaydFLKQGtMlQ
N6fYvIzQLKaydFLKQGtMlQ collected $0.20 from pot
*** SUMMARY ***
Total pot $0.20 | Rake $0 
Seat 1: K0b5wNInj6hUGRr6yzKFtw (small blind) folded before Flop
Seat 2: N6fYvIzQLKaydFLKQGtMlQ (big blind) collected ($0.20)
Seat 3: DnDcAdn9P0zGovMERigpFA folded before Flop (didn't bet)
Seat 4: UANt6y/SmDCY/jIxkBixcw folded before Flop (didn't bet)
Seat 5: dfNim92Z6XK1/h5SFW5vDg folded before Flop (didn't bet)
Seat 7: ghNKXUBl/H+t83JF079ZBA folded before Flop (didn't bet)
Seat 8: 8GJHzzxiotOqC5gdtgpLoA folded before Flop (didn't bet)
Seat 9: 18G4P1XstjNvItdGUITxgw (button) folded before Flop (didn't bet)




PokerStars Game #59939671496:  Hold'em No Limit ($0.10/$0.25) - 2009/07/01 0:45:54 ET
Table 'SkaFM7xfUr/Nd+JFPb7f2w' 9-max Seat #9 is the button
Seat 1: CvL9Ch1HYCVbTsfpNucitg ($4.75 in chips) 
Seat 2: QEbIGci+itdw+re8RM5fZA ($28.30 in chips) 
Seat 3: 4oA316mXLIui1QY63GXBUg ($25 in chips) 
Seat 4: DIBbjEYGs+TVdVgEB/4+3w ($39.20 in chips) 
Seat 5: GftT+l+xjKzcY0rMiNZfPg ($8.30 in chips) 
Seat 6: PskTLlFIRHSp61inskRzVg ($7.60 in chips) 
Seat 7: 7wo6Sr7QG3Zo6BaBDV1BOw ($5.85 in chips) 
Seat 8: Lro4e37x4FUa5P3yzDjskw ($12.45 in chips) 
Seat 9: STkR8XvpjNv79OOMhrlh2w ($59.10 in chips) 
CvL9Ch1HYCVbTsfpNucitg: posts small blind $0.10
QEbIGci+itdw+re8RM5fZA: posts big blind $0.25
*** HOLE CARDS ***
4oA316mXLIui1QY63GXBUg: folds 
DIBbjEYGs+TVdVgEB/4+3w: folds 
GftT+l+xjKzcY0rMiNZfPg: raises $0.50 to $0.75
PskTLlFIRHSp61inskRzVg: folds 
7wo6Sr7QG3Zo6BaBDV1BOw: folds 
Lro4e37x4FUa5P3yzDjskw: folds 
STkR8XvpjNv79OOMhrlh2w: folds 
CvL9Ch1HYCVbTsfpNucitg: folds 
QEbIGci+itdw+re8RM5fZA: folds 
Uncalled bet ($0.50) returned to GftT+l+xjKzcY0rMiNZfPg
GftT+l+xjKzcY0rMiNZfPg collected $0.60 from pot
GftT+l+xjKzcY0rMiNZfPg: doesn't show hand 
*** SUMMARY ***
Total pot $0.60 | Rake $0 
Seat 1: CvL9Ch1HYCVbTsfpNucitg (small blind) folded before Flop
Seat 2: QEbIGci+itdw+re8RM5fZA (big blind) folded before Flop
Seat 3: 4oA316mXLIui1QY63GXBUg folded before Flop (didn't bet)
Seat 4: DIBbjEYGs+TVdVgEB/4+3w folded before Flop (didn't bet)
Seat 5: GftT+l+xjKzcY0rMiNZfPg collected ($0.60)
Seat 6: PskTLlFIRHSp61inskRzVg folded before Flop (didn't bet)
Seat 7: 7wo6Sr7QG3Zo6BaBDV1BOw folded before Flop (didn't bet)
Seat 8: Lro4e37x4FUa5P3yzDjskw folded before Flop (didn't bet)
Seat 9: STkR8XvpjNv79OOMhrlh2w (button) folded before Flop (didn't bet)




PokerStars Game #59939671566:  Hold'em No Limit ($0.10/$0.25) - 2009/07/01 0:45:54 ET
Table 'JJzUs04lHpXg6nboT1/jeg' 6-max Seat #3 is the button
Seat 1: 5RMSJF80SS07S0IGqbJZeA ($22.90 in chips) 
Seat 3: uUXdcVMNa05rfbntdvplfw ($33.70 in chips) 
Seat 4: nwwpaieDRI0UPyVtChVHOg ($33 in chips) 
Seat 5: Vr2XE7yYBdg3RZSURDAPEg ($17.10 in chips) 
Seat 6: sbFQMajC1QuRxa8Jly3usQ ($6 in chips) 
nwwpaieDRI0UPyVtChVHOg: posts small blind $0.10
Vr2XE7yYBdg3RZSURDAPEg: posts big blind $0.25
4kWQxGbT5FZ1dkPd1bE45Q: sits out 
*** HOLE CARDS ***
sbFQMajC1QuRxa8Jly3usQ said, "fffff straight"
sbFQMajC1QuRxa8Jly3usQ: calls $0.25
5RMSJF80SS07S0IGqbJZeA: raises $0.50 to $0.75
uUXdcVMNa05rfbntdvplfw: calls $0.75
nwwpaieDRI0UPyVtChVHOg: folds 
Vr2XE7yYBdg3RZSURDAPEg: folds 
sbFQMajC1QuRxa8Jly3usQ: calls $0.50
*** FLOP *** [8c 4c Js]
sbFQMajC1QuRxa8Jly3usQ: checks 
5RMSJF80SS07S0IGqbJZeA: bets $0.75
uUXdcVMNa05rfbntdvplfw: raises $0.75 to $1.50
sbFQMajC1QuRxa8Jly3usQ said, "ur brave calling my all in with that flop though"
sbFQMajC1QuRxa8Jly3usQ: folds 
5RMSJF80SS07S0IGqbJZeA: calls $0.75
*** TURN *** [8c 4c Js] [5d]
5RMSJF80SS07S0IGqbJZeA: checks 
uUXdcVMNa05rfbntdvplfw: bets $2
5RMSJF80SS07S0IGqbJZeA: calls $2
*** RIVER *** [8c 4c Js 5d] [4s]
5RMSJF80SS07S0IGqbJZeA: checks 
uUXdcVMNa05rfbntdvplfw: bets $3.75
sbFQMajC1QuRxa8Jly3usQ said, "keep it up ill take ur money next time"
5RMSJF80SS07S0IGqbJZeA: raises $3.75 to $7.50
uUXdcVMNa05rfbntdvplfw: raises $21.95 to $29.45 and is all-in
5RMSJF80SS07S0IGqbJZeA: calls $11.15 and is all-in
Uncalled bet ($10.80) returned to uUXdcVMNa05rfbntdvplfw
*** SHOW DOWN ***
uUXdcVMNa05rfbntdvplfw: shows [8d 8h] (a full house, Eights full of Fours)
5RMSJF80SS07S0IGqbJZeA: mucks hand 
uUXdcVMNa05rfbntdvplfw collected $44.90 from pot
*** SUMMARY ***
Total pot $46.90 | Rake $2 
Board [8c 4c Js 5d 4s]
Seat 1: 5RMSJF80SS07S0IGqbJZeA mucked
Seat 3: uUXdcVMNa05rfbntdvplfw (button) showed [8d 8h] and won ($44.90) with a full house, Eights full of Fours
Seat 4: nwwpaieDRI0UPyVtChVHOg (small blind) folded before Flop
Seat 5: Vr2XE7yYBdg3RZSURDAPEg (big blind) folded before Flop
Seat 6: sbFQMajC1QuRxa8Jly3usQ folded on the Flop




PokerStars Game #59939671334:  Hold'em No Limit ($0.10/$0.25) - 2009/07/01 0:45:54 ET
Table 'wRXcD9iXgBbdvKhWmfnBnw' 6-max Seat #2 is the button
Seat 1: LGWRgaQNaDFSlUGk26f0Ig ($22.70 in chips) 
Seat 2: SS/yfeArhULzIcOPe8MdPg ($25 in chips) 
Seat 3: 6zbQpY/G44U1Xvj7DZex0A ($40.85 in chips) 
Seat 4: mfrkWA3PTeYPkbO6hi98Aw ($24.70 in chips) 
Seat 5: EE16Ua5b1HSsYej5zeXOlA ($25 in chips) 
6zbQpY/G44U1Xvj7DZex0A: posts small blind $0.10
mfrkWA3PTeYPkbO6hi98Aw: posts big blind $0.25
*** HOLE CARDS ***
EE16Ua5b1HSsYej5zeXOlA: folds 
LGWRgaQNaDFSlUGk26f0Ig: folds 
SS/yfeArhULzIcOPe8MdPg: folds 
6zbQpY/G44U1Xvj7DZex0A: raises $0.25 to $0.50
mfrkWA3PTeYPkbO6hi98Aw: calls $0.25
*** FLOP *** [8h 3d 6d]
6zbQpY/G44U1Xvj7DZex0A: bets $0.25
mfrkWA3PTeYPkbO6hi98Aw: calls $0.25
*** TURN *** [8h 3d 6d] [Kh]
6zbQpY/G44U1Xvj7DZex0A: bets $1
mfrkWA3PTeYPkbO6hi98Aw: raises $2 to $3
6zbQpY/G44U1Xvj7DZex0A: calls $2
*** RIVER *** [8h 3d 6d Kh] [5s]
6zbQpY/G44U1Xvj7DZex0A: checks 
mfrkWA3PTeYPkbO6hi98Aw: bets $4.50
6zbQpY/G44U1Xvj7DZex0A: calls $4.50
*** SHOW DOWN ***
mfrkWA3PTeYPkbO6hi98Aw: shows [Th 9h] (high card King)
6zbQpY/G44U1Xvj7DZex0A: shows [Jh Kc] (a pair of Kings)
6zbQpY/G44U1Xvj7DZex0A collected $15.70 from pot
*** SUMMARY ***
Total pot $16.50 | Rake $0.80 
Board [8h 3d 6d Kh 5s]
Seat 1: LGWRgaQNaDFSlUGk26f0Ig folded before Flop (didn't bet)
Seat 2: SS/yfeArhULzIcOPe8MdPg (button) folded before Flop (didn't bet)
Seat 3: 6zbQpY/G44U1Xvj7DZex0A (small blind) showed [Jh Kc] and won ($15.70) with a pair of Kings
Seat 4: mfrkWA3PTeYPkbO6hi98Aw (big blind) showed [Th 9h] and lost with high card King
Seat 5: EE16Ua5b1HSsYej5zeXOlA folded before Flop (didn't bet)




PokerStars Game #59939671238:  Hold'em No Limit ($0.10/$0.25) - 2009/07/01 0:45:54 ET
Table 'G+4ZdyRoPjgaJY/jxSlZzQ' 9-max Seat #8 is the button
Seat 2: 4awUyiDYTgylQKXZ9faBVA ($34.70 in chips) 
Seat 3: opOCI2p6kW0tINuVaAqmcQ ($30.95 in chips) 
Seat 5: s7Q6uNouhe7aE8JdFb9E+A ($26 in chips) 
Seat 6: gehe91e0IyVT0QU/XBkEyg ($27.80 in chips) 
Seat 8: 8GJHzzxiotOqC5gdtgpLoA ($7.75 in chips) 
Seat 9: AzTBzPGlrIHrrs1Q8oKcGA ($17.30 in chips) 
AzTBzPGlrIHrrs1Q8oKcGA: posts small blind $0.10
4awUyiDYTgylQKXZ9faBVA: posts big blind $0.25
*** HOLE CARDS ***
0Ui5PFTLvpoTRdxcc8BNSQ has returned
opOCI2p6kW0tINuVaAqmcQ: folds 
aGjnENGPM5z9UQkETl26TA joins the table at seat #4 
s7Q6uNouhe7aE8JdFb9E+A: folds 
gehe91e0IyVT0QU/XBkEyg: folds 
8GJHzzxiotOqC5gdtgpLoA: raises $0.75 to $1
AzTBzPGlrIHrrs1Q8oKcGA: folds 
4awUyiDYTgylQKXZ9faBVA: folds 
Uncalled bet ($0.75) returned to 8GJHzzxiotOqC5gdtgpLoA
8GJHzzxiotOqC5gdtgpLoA collected $0.60 from pot
8GJHzzxiotOqC5gdtgpLoA: doesn't show hand 
*** SUMMARY ***
Total pot $0.60 | Rake $0 
Seat 2: 4awUyiDYTgylQKXZ9faBVA (big blind) folded before Flop
Seat 3: opOCI2p6kW0tINuVaAqmcQ folded before Flop (didn't bet)
Seat 5: s7Q6uNouhe7aE8JdFb9E+A folded before Flop (didn't bet)
Seat 6: gehe91e0IyVT0QU/XBkEyg folded before Flop (didn't bet)
Seat 8: 8GJHzzxiotOqC5gdtgpLoA (button) collected ($0.60)
Seat 9: AzTBzPGlrIHrrs1Q8oKcGA (small blind) folded before Flop




PokerStars Game #59939672068:  Hold'em No Limit ($0.10/$0.25) - 2009/07/01 0:45:55 ET
Table 'GxdLtCpYxqT4aAbYqkEEpw' 6-max Seat #1 is the button
Seat 1: heEf/FkFGS9M1NmwH97YIA ($20.15 in chips) 
Seat 2: hADMNbkECXMb2C/C8R2Wlw ($25.45 in chips) 
Seat 3: 9jSiy0meE9XJKkdIZwyTEQ ($48.80 in chips) 
Seat 4: ErIN0JRL5srYjT6en1f8YQ ($30.15 in chips) 
Seat 5: q6WfTUAD9mowIP63ASq2Dg ($38.80 in chips) 
Seat 6: aogAb4Eienxztk8p2v9VVw ($24.15 in chips) 
hADMNbkECXMb2C/C8R2Wlw: posts small blind $0.10
9jSiy0meE9XJKkdIZwyTEQ: posts big blind $0.25
*** HOLE CARDS ***
ErIN0JRL5srYjT6en1f8YQ: folds 
q6WfTUAD9mowIP63ASq2Dg: folds 
aogAb4Eienxztk8p2v9VVw: folds 
heEf/FkFGS9M1NmwH97YIA: folds 
hADMNbkECXMb2C/C8R2Wlw: folds 
Uncalled bet ($0.15) returned to 9jSiy0meE9XJKkdIZwyTEQ
9jSiy0meE9XJKkdIZwyTEQ collected $0.20 from pot
9jSiy0meE9XJKkdIZwyTEQ: doesn't show hand 
*** SUMMARY ***
Total pot $0.20 | Rake $0 
Seat 1: heEf/FkFGS9M1NmwH97YIA (button) folded before Flop (didn't bet)
Seat 2: hADMNbkECXMb2C/C8R2Wlw (small blind) folded before Flop
Seat 3: 9jSiy0meE9XJKkdIZwyTEQ (big blind) collected ($0.20)
Seat 4: ErIN0JRL5srYjT6en1f8YQ folded before Flop (didn't bet)
Seat 5: q6WfTUAD9mowIP63ASq2Dg folded before Flop (didn't bet)
Seat 6: aogAb4Eienxztk8p2v9VVw folded before Flop (didn't bet)




PokerStars Game #59939671862:  Hold'em No Limit ($0.10/$0.25) - 2009/07/01 0:45:55 ET
Table 'NtCSSONEf1zaJo3042tQug' 6-max Seat #6 is the button
Seat 1: pdS3fOhVgLVaTP0O0GlIvw ($9.65 in chips) 
Seat 2: nbv8IVGAEHbfjk01ulU6ow ($22.15 in chips) 
Seat 3: d0J1xuhsynEY81YHwAvJ5g ($25 in chips) 
Seat 4: dOX4wnYV2sEqvDbF+8KSCw ($25 in chips) 
Seat 5: l/t3k8+r77gRew8U2BJs4Q ($9.75 in chips) 
Seat 6: LxehwDpTQ19ph4Qmc78+Pw ($17.15 in chips) 
pdS3fOhVgLVaTP0O0GlIvw: posts small blind $0.10
nbv8IVGAEHbfjk01ulU6ow: posts big blind $0.25
*** HOLE CARDS ***
d0J1xuhsynEY81YHwAvJ5g: calls $0.25
dOX4wnYV2sEqvDbF+8KSCw: folds 
l/t3k8+r77gRew8U2BJs4Q: calls $0.25
LxehwDpTQ19ph4Qmc78+Pw: folds 
pdS3fOhVgLVaTP0O0GlIvw: calls $0.15
nbv8IVGAEHbfjk01ulU6ow: raises $0.50 to $0.75
d0J1xuhsynEY81YHwAvJ5g: calls $0.50
l/t3k8+r77gRew8U2BJs4Q: calls $0.50
pdS3fOhVgLVaTP0O0GlIvw: calls $0.50
*** FLOP *** [4s 8s 6c]
pdS3fOhVgLVaTP0O0GlIvw: checks 
nbv8IVGAEHbfjk01ulU6ow: checks 
d0J1xuhsynEY81YHwAvJ5g: bets $2
l/t3k8+r77gRew8U2BJs4Q: folds 
pdS3fOhVgLVaTP0O0GlIvw: calls $2
nbv8IVGAEHbfjk01ulU6ow: folds 
*** TURN *** [4s 8s 6c] [2c]
pdS3fOhVgLVaTP0O0GlIvw: checks 
d0J1xuhsynEY81YHwAvJ5g: bets $5
pdS3fOhVgLVaTP0O0GlIvw: folds 
Uncalled bet ($5) returned to d0J1xuhsynEY81YHwAvJ5g
d0J1xuhsynEY81YHwAvJ5g collected $6.70 from pot
d0J1xuhsynEY81YHwAvJ5g: doesn't show hand 
*** SUMMARY ***
Total pot $7 | Rake $0.30 
Board [4s 8s 6c 2c]
Seat 1: pdS3fOhVgLVaTP0O0GlIvw (small blind) folded on the Turn
Seat 2: nbv8IVGAEHbfjk01ulU6ow (big blind) folded on the Flop
Seat 3: d0J1xuhsynEY81YHwAvJ5g collected ($6.70)
Seat 4: dOX4wnYV2sEqvDbF+8KSCw folded before Flop (didn't bet)
Seat 5: l/t3k8+r77gRew8U2BJs4Q folded on the Flop
Seat 6: LxehwDpTQ19ph4Qmc78+Pw (button) folded before Flop (didn't bet)




PokerStars Game #59939672154:  Hold'em No Limit ($0.10/$0.25) - 2009/07/01 0:45:55 ET
Table '5510FxlYzKi+U6MIpo8IPA' 6-max Seat #5 is the button
Seat 1: KM6ogk7SqyRlk3m9b0h+7A ($20.65 in chips) 
Seat 2: gqW2aBCmrIw65BvwjTFN6Q ($25 in chips) 
Seat 3: v+QfkGiuj9bgtuNoVnDO8w ($33.90 in chips) 
Seat 4: cPO/1/dTcZpLkQFm3jH3Rg ($27.20 in chips) 
Seat 5: 5E1iMY5xyboow7Xm0v7Idw ($7.10 in chips) 
Seat 6: SFmT9ZsVopnukjvAzrxTRg ($30 in chips) 
SFmT9ZsVopnukjvAzrxTRg: posts small blind $0.10
KM6ogk7SqyRlk3m9b0h+7A: posts big blind $0.25
*** HOLE CARDS ***
gqW2aBCmrIw65BvwjTFN6Q: folds 
v+QfkGiuj9bgtuNoVnDO8w: folds 
cPO/1/dTcZpLkQFm3jH3Rg: folds 
5E1iMY5xyboow7Xm0v7Idw: raises $0.50 to $0.75
SFmT9ZsVopnukjvAzrxTRg: folds 
KM6ogk7SqyRlk3m9b0h+7A: folds 
Uncalled bet ($0.50) returned to 5E1iMY5xyboow7Xm0v7Idw
5E1iMY5xyboow7Xm0v7Idw collected $0.60 from pot
5E1iMY5xyboow7Xm0v7Idw: doesn't show hand 
*** SUMMARY ***
Total pot $0.60 | Rake $0 
Seat 1: KM6ogk7SqyRlk3m9b0h+7A (big blind) folded before Flop
Seat 2: gqW2aBCmrIw65BvwjTFN6Q folded before Flop (didn't bet)
Seat 3: v+QfkGiuj9bgtuNoVnDO8w folded before Flop (didn't bet)
Seat 4: cPO/1/dTcZpLkQFm3jH3Rg folded before Flop (didn't bet)
Seat 5: 5E1iMY5xyboow7Xm0v7Idw (button) collected ($0.60)
Seat 6: SFmT9ZsVopnukjvAzrxTRg (small blind) folded before Flop




PokerStars Game #59939671920:  Hold'em No Limit ($0.10/$0.25) - 2009/07/01 0:45:55 ET
Table 'Xi38lWH8L2JHRAsKYVX8Qg' 6-max Seat #4 is the button
Seat 1: AqQ7DFpHkgIzTwDu+rClcg ($6.25 in chips) 
Seat 2: 7iL6KfkJTFbyWmnLYk4+AA ($30.75 in chips) 
Seat 3: 6DwBRH+xZ12AAZmeAg+aXw ($25 in chips) 
Seat 4: kG34n23qFQA3nzdOJTQ1dA ($25.45 in chips) 
Seat 5: 79ID/ub1Pt/mDpCprVmOoA ($25.85 in chips) 
Seat 6: aogAb4Eienxztk8p2v9VVw ($10.90 in chips) 
79ID/ub1Pt/mDpCprVmOoA: posts small blind $0.10
aogAb4Eienxztk8p2v9VVw: posts big blind $0.25
*** HOLE CARDS ***
AqQ7DFpHkgIzTwDu+rClcg: folds 
7iL6KfkJTFbyWmnLYk4+AA: folds 
6DwBRH+xZ12AAZmeAg+aXw: folds 
kG34n23qFQA3nzdOJTQ1dA: calls $0.25
79ID/ub1Pt/mDpCprVmOoA: folds 
aogAb4Eienxztk8p2v9VVw: checks 
*** FLOP *** [5c As 9h]
aogAb4Eienxztk8p2v9VVw: checks 
kG34n23qFQA3nzdOJTQ1dA: bets $0.50
aogAb4Eienxztk8p2v9VVw: folds 
Uncalled bet ($0.50) returned to kG34n23qFQA3nzdOJTQ1dA
kG34n23qFQA3nzdOJTQ1dA collected $0.60 from pot
*** SUMMARY ***
Total pot $0.60 | Rake $0 
Board [5c As 9h]
Seat 1: AqQ7DFpHkgIzTwDu+rClcg folded before Flop (didn't bet)
Seat 2: 7iL6KfkJTFbyWmnLYk4+AA folded before Flop (didn't bet)
Seat 3: 6DwBRH+xZ12AAZmeAg+aXw folded before Flop (didn't bet)
Seat 4: kG34n23qFQA3nzdOJTQ1dA (button) collected ($0.60)
Seat 5: 79ID/ub1Pt/mDpCprVmOoA (small blind) folded before Flop
Seat 6: aogAb4Eienxztk8p2v9VVw (big blind) folded on the Flop




PokerStars Game #59939671782:  Hold'em No Limit ($0.10/$0.25) - 2009/07/01 0:45:55 ET
Table 'qInMnOOn7vKcj4bU7zju7g' 9-max Seat #5 is the button
Seat 2: f/H6PsHRl4W1JyNsEDvPtg ($9.15 in chips) 
Seat 3: zDrucyjVn5aeekNEc3cJrA ($28.15 in chips) 
Seat 4: ZbKV588BRlpe7vF42jT9yg ($9.30 in chips) 
Seat 5: aNpwfA31EREwO+ar4XzBCw ($39.75 in chips) 
Seat 6: r1pFKMwWp74QwhfPWJOAyw ($9.85 in chips) 
Seat 7: 8B/dhbQjIWe6ASCdgzktNQ ($26.60 in chips) 
Seat 9: K7bAhhMMJ/XcTmGaBZVfFQ ($24 in chips) 
r1pFKMwWp74QwhfPWJOAyw: posts small blind $0.10
8B/dhbQjIWe6ASCdgzktNQ: posts big blind $0.25
*** HOLE CARDS ***
K7bAhhMMJ/XcTmGaBZVfFQ: folds 
f/H6PsHRl4W1JyNsEDvPtg: folds 
zDrucyjVn5aeekNEc3cJrA: folds 
ZbKV588BRlpe7vF42jT9yg: folds 
aNpwfA31EREwO+ar4XzBCw: folds 
r1pFKMwWp74QwhfPWJOAyw: folds 
Uncalled bet ($0.15) returned to 8B/dhbQjIWe6ASCdgzktNQ
8B/dhbQjIWe6ASCdgzktNQ collected $0.20 from pot
8B/dhbQjIWe6ASCdgzktNQ: doesn't show hand 
*** SUMMARY ***
Total pot $0.20 | Rake $0 
Seat 2: f/H6PsHRl4W1JyNsEDvPtg folded before Flop (didn't bet)
Seat 3: zDrucyjVn5aeekNEc3cJrA folded before Flop (didn't bet)
Seat 4: ZbKV588BRlpe7vF42jT9yg folded before Flop (didn't bet)
Seat 5: aNpwfA31EREwO+ar4XzBCw (button) folded before Flop (didn't bet)
Seat 6: r1pFKMwWp74QwhfPWJOAyw (small blind) folded before Flop
Seat 7: 8B/dhbQjIWe6ASCdgzktNQ (big blind) collected ($0.20)
Seat 9: K7bAhhMMJ/XcTmGaBZVfFQ folded before Flop (didn't bet)




PokerStars Game #59939672164:  Hold'em No Limit ($0.10/$0.25) - 2009/07/01 0:45:55 ET
Table '3lL16FBjWXTx3AjK5lMRww' 9-max Seat #3 is the button
Seat 1: fDGyaQz0cs2s4FOYxkbIHA ($15 in chips) 
Seat 3: QEbIGci+itdw+re8RM5fZA ($26.05 in chips) 
Seat 4: Z3a37Ry74FVl+CBZtAONiA ($11.50 in chips) 
Seat 5: M/9j4wkHH9i1JM51vgi1VA ($22.25 in chips) 
Seat 6: hBMUlEpyU74r/fwDgIpXjQ ($41.60 in chips) 
Seat 8: ljemhp25Zg+nlA9DLCIiUw ($24.75 in chips) 
Seat 9: b8t3jWrxzeEt9HtZtc9wUQ ($9.10 in chips) 
Z3a37Ry74FVl+CBZtAONiA: posts small blind $0.10
M/9j4wkHH9i1JM51vgi1VA: posts big blind $0.25
6RiVTYll/5D8zICp0MRpKw: sits out 
*** HOLE CARDS ***
hBMUlEpyU74r/fwDgIpXjQ: folds 
ljemhp25Zg+nlA9DLCIiUw: folds 
b8t3jWrxzeEt9HtZtc9wUQ: calls $0.25
fDGyaQz0cs2s4FOYxkbIHA: folds 
QEbIGci+itdw+re8RM5fZA: folds 
Z3a37Ry74FVl+CBZtAONiA: folds 
M/9j4wkHH9i1JM51vgi1VA: checks 
*** FLOP *** [9c Tc 2c]
M/9j4wkHH9i1JM51vgi1VA: checks 
b8t3jWrxzeEt9HtZtc9wUQ: checks 
*** TURN *** [9c Tc 2c] [Ts]
M/9j4wkHH9i1JM51vgi1VA: checks 
b8t3jWrxzeEt9HtZtc9wUQ: checks 
*** RIVER *** [9c Tc 2c Ts] [Th]
M/9j4wkHH9i1JM51vgi1VA: checks 
b8t3jWrxzeEt9HtZtc9wUQ: checks 
*** SHOW DOWN ***
M/9j4wkHH9i1JM51vgi1VA: shows [2d As] (a full house, Tens full of Deuces)
b8t3jWrxzeEt9HtZtc9wUQ: mucks hand 
M/9j4wkHH9i1JM51vgi1VA collected $0.60 from pot
*** SUMMARY ***
Total pot $0.60 | Rake $0 
Board [9c Tc 2c Ts Th]
Seat 1: fDGyaQz0cs2s4FOYxkbIHA folded before Flop (didn't bet)
Seat 3: QEbIGci+itdw+re8RM5fZA (button) folded before Flop (didn't bet)
Seat 4: Z3a37Ry74FVl+CBZtAONiA (small blind) folded before Flop
Seat 5: M/9j4wkHH9i1JM51vgi1VA (big blind) showed [2d As] and won ($0.60) with a full house, Tens full of Deuces
Seat 6: hBMUlEpyU74r/fwDgIpXjQ folded before Flop (didn't bet)
Seat 8: ljemhp25Zg+nlA9DLCIiUw folded before Flop (didn't bet)
Seat 9: b8t3jWrxzeEt9HtZtc9wUQ mucked




PokerStars Game #59939671858:  Hold'em No Limit ($0.10/$0.25) - 2009/07/01 0:45:55 ET
Table '50f2Xa1b1jp6cfdTAgXFIg' 9-max Seat #8 is the button
Seat 1: JwUqpgqGHS96sdpExhhEqw ($8.10 in chips) 
Seat 3: GQTWTgG7Ydy9q/vohVnKmQ ($25.35 in chips) 
Seat 4: ghNKXUBl/H+t83JF079ZBA ($28.50 in chips) 
Seat 5: OlPJsgR4xypSg/w1z7Gyvw ($53.50 in chips) 
Seat 6: Vl8zO7J9ZOnk8Og8eXFezg ($40.90 in chips) 
Seat 7: TeWJxSETzbXGiYKx0y+dtg ($25.30 in chips) 
Seat 8: jeKWRUkMaVn8rEUjnJKqpg ($25 in chips) 
Seat 9: gehe91e0IyVT0QU/XBkEyg ($27.65 in chips) 
gehe91e0IyVT0QU/XBkEyg: posts small blind $0.10
JwUqpgqGHS96sdpExhhEqw: posts big blind $0.25
F7pnn6czNpHvRM55XcA2EA: sits out 
*** HOLE CARDS ***
GQTWTgG7Ydy9q/vohVnKmQ: folds 
ghNKXUBl/H+t83JF079ZBA: folds 
OlPJsgR4xypSg/w1z7Gyvw: calls $0.25
Vl8zO7J9ZOnk8Og8eXFezg: folds 
TeWJxSETzbXGiYKx0y+dtg: raises $1 to $1.25
jeKWRUkMaVn8rEUjnJKqpg: calls $1.25
gehe91e0IyVT0QU/XBkEyg: folds 
JwUqpgqGHS96sdpExhhEqw: folds 
OlPJsgR4xypSg/w1z7Gyvw: calls $1
*** FLOP *** [4d 6s 3s]
OlPJsgR4xypSg/w1z7Gyvw: checks 
TeWJxSETzbXGiYKx0y+dtg: checks 
jeKWRUkMaVn8rEUjnJKqpg: bets $1.75
OlPJsgR4xypSg/w1z7Gyvw: folds 
TeWJxSETzbXGiYKx0y+dtg: folds 
Uncalled bet ($1.75) returned to jeKWRUkMaVn8rEUjnJKqpg
jeKWRUkMaVn8rEUjnJKqpg collected $3.90 from pot
jeKWRUkMaVn8rEUjnJKqpg: doesn't show hand 
*** SUMMARY ***
Total pot $4.10 | Rake $0.20 
Board [4d 6s 3s]
Seat 1: JwUqpgqGHS96sdpExhhEqw (big blind) folded before Flop
Seat 3: GQTWTgG7Ydy9q/vohVnKmQ folded before Flop (didn't bet)
Seat 4: ghNKXUBl/H+t83JF079ZBA folded before Flop (didn't bet)
Seat 5: OlPJsgR4xypSg/w1z7Gyvw folded on the Flop
Seat 6: Vl8zO7J9ZOnk8Og8eXFezg folded before Flop (didn't bet)
Seat 7: TeWJxSETzbXGiYKx0y+dtg folded on the Flop
Seat 8: jeKWRUkMaVn8rEUjnJKqpg (button) collected ($3.90)
Seat 9: gehe91e0IyVT0QU/XBkEyg (small blind) folded before Flop




PokerStars Game #59939671772:  Hold'em No Limit ($0.10/$0.25) - 2009/07/01 0:45:55 ET
Table '/AhP8uWRzEEhOATYIdmn0A' 9-max Seat #3 is the button
Seat 1: +sbyWwIcFp9kP0bDtMegfQ ($23.40 in chips) 
Seat 2: nvWCCH1JBjMjQkSaXl2Mog ($16.70 in chips) 
Seat 3: vSkQm2EelzwRGDDQQk0Fqw ($4.65 in chips) 
Seat 4: +WMpj67YqG8ilNkg2JwXpw ($14.75 in chips) 
Seat 5: BEIBUu2pIflPrCL+Iks4CQ ($13.85 in chips) 
Seat 7: 4oA316mXLIui1QY63GXBUg ($29.90 in chips) 
Seat 8: CYkY0dNBaYaKs8HVCVn3mQ ($5.85 in chips) 
Seat 9: DIBbjEYGs+TVdVgEB/4+3w ($29.25 in chips) 
+WMpj67YqG8ilNkg2JwXpw: posts small blind $0.10
BEIBUu2pIflPrCL+Iks4CQ: posts big blind $0.25
*** HOLE CARDS ***
4oA316mXLIui1QY63GXBUg: folds 
CYkY0dNBaYaKs8HVCVn3mQ: folds 
DIBbjEYGs+TVdVgEB/4+3w: folds 
+sbyWwIcFp9kP0bDtMegfQ: folds 
nvWCCH1JBjMjQkSaXl2Mog: raises $0.50 to $0.75
vSkQm2EelzwRGDDQQk0Fqw: folds 
+WMpj67YqG8ilNkg2JwXpw: folds 
BEIBUu2pIflPrCL+Iks4CQ: folds 
Uncalled bet ($0.50) returned to nvWCCH1JBjMjQkSaXl2Mog
nvWCCH1JBjMjQkSaXl2Mog collected $0.60 from pot
*** SUMMARY ***
Total pot $0.60 | Rake $0 
Seat 1: +sbyWwIcFp9kP0bDtMegfQ folded before Flop (didn't bet)
Seat 2: nvWCCH1JBjMjQkSaXl2Mog collected ($0.60)
Seat 3: vSkQm2EelzwRGDDQQk0Fqw (button) folded before Flop (didn't bet)
Seat 4: +WMpj67YqG8ilNkg2JwXpw (small blind) folded before Flop
Seat 5: BEIBUu2pIflPrCL+Iks4CQ (big blind) folded before Flop
Seat 7: 4oA316mXLIui1QY63GXBUg folded before Flop (didn't bet)
Seat 8: CYkY0dNBaYaKs8HVCVn3mQ folded before Flop (didn't bet)
Seat 9: DIBbjEYGs+TVdVgEB/4+3w folded before Flop (didn't bet)




PokerStars Game #59939672676:  Hold'em No Limit ($0.10/$0.25) - 2009/07/01 0:45:56 ET
Table 'XX2OuOsa8/8AC+/mR/Az6g' 9-max Seat #6 is the button
Seat 1: 56S3mA6Zs3pGR+0p0vUCtg ($26.65 in chips) 
Seat 2: MIVCHqCqqlke0Lb0z7glcw ($23.80 in chips) 
Seat 3: 4f9D0JPPUArSbyY3vqNlXQ ($7.90 in chips) 
Seat 5: jXz58rvCgq0VjyVjUBf2mw ($25 in chips) 
Seat 6: gT0nY7XiR+2FA+B3F4h8HQ ($25.35 in chips) 
Seat 7: zDrucyjVn5aeekNEc3cJrA ($20.20 in chips) 
Seat 8: qwr38jl5txoR36M7G5qi4A ($7.50 in chips) 
Seat 9: 86vbuhJsyH+nbEg5qpDLyQ ($45.95 in chips) 
zDrucyjVn5aeekNEc3cJrA: posts small blind $0.10
qwr38jl5txoR36M7G5qi4A: posts big blind $0.25
*** HOLE CARDS ***
86vbuhJsyH+nbEg5qpDLyQ: folds 
56S3mA6Zs3pGR+0p0vUCtg: folds 
MIVCHqCqqlke0Lb0z7glcw: folds 
4f9D0JPPUArSbyY3vqNlXQ: folds 
jXz58rvCgq0VjyVjUBf2mw: folds 
gT0nY7XiR+2FA+B3F4h8HQ: folds 
zDrucyjVn5aeekNEc3cJrA: calls $0.15
qwr38jl5txoR36M7G5qi4A: checks 
*** FLOP *** [8h Qs Th]
zDrucyjVn5aeekNEc3cJrA: checks 
qwr38jl5txoR36M7G5qi4A: checks 
*** TURN *** [8h Qs Th] [Ah]
zDrucyjVn5aeekNEc3cJrA: bets $1.50
qwr38jl5txoR36M7G5qi4A: folds 
Uncalled bet ($1.50) returned to zDrucyjVn5aeekNEc3cJrA
zDrucyjVn5aeekNEc3cJrA collected $0.50 from pot
*** SUMMARY ***
Total pot $0.50 | Rake $0 
Board [8h Qs Th Ah]
Seat 1: 56S3mA6Zs3pGR+0p0vUCtg folded before Flop (didn't bet)
Seat 2: MIVCHqCqqlke0Lb0z7glcw folded before Flop (didn't bet)
Seat 3: 4f9D0JPPUArSbyY3vqNlXQ folded before Flop (didn't bet)
Seat 5: jXz58rvCgq0VjyVjUBf2mw folded before Flop (didn't bet)
Seat 6: gT0nY7XiR+2FA+B3F4h8HQ (button) folded before Flop (didn't bet)
Seat 7: zDrucyjVn5aeekNEc3cJrA (small blind) collected ($0.50)
Seat 8: qwr38jl5txoR36M7G5qi4A (big blind) folded on the Turn
Seat 9: 86vbuhJsyH+nbEg5qpDLyQ folded before Flop (didn't bet)




PokerStars Game #59939672544:  Hold'em No Limit ($0.10/$0.25) - 2009/07/01 0:45:56 ET
Table 'aisAlB9GIV21BwfUW3+Nbg' 9-max Seat #3 is the button
Seat 1: H5Se03ZqSX7tbULXur2MAg ($30.30 in chips) 
Seat 2: 18G4P1XstjNvItdGUITxgw ($25 in chips) 
Seat 3: aaNpjkDAbOD7pVe8Z5CEgQ ($22.65 in chips) 
Seat 4: sD+TKtt36XiiN6jqHiLwDA ($24.75 in chips) 
Seat 5: ghNKXUBl/H+t83JF079ZBA ($25 in chips) 
Seat 6: 9gmYYQesalMrUjaF7nKfrQ ($7.60 in chips) 
Seat 7: sWBBy1WroEskLNyJzhkUag ($9.25 in chips) 
Seat 8: VWUWpMLMj/Q1jRVpF7Aohw ($13.80 in chips) 
Seat 9: OlPJsgR4xypSg/w1z7Gyvw ($28.30 in chips) 
sD+TKtt36XiiN6jqHiLwDA: posts small blind $0.10
ghNKXUBl/H+t83JF079ZBA: posts big blind $0.25
*** HOLE CARDS ***
9gmYYQesalMrUjaF7nKfrQ: folds 
sWBBy1WroEskLNyJzhkUag: folds 
VWUWpMLMj/Q1jRVpF7Aohw: calls $0.25
OlPJsgR4xypSg/w1z7Gyvw: folds 
H5Se03ZqSX7tbULXur2MAg: folds 
18G4P1XstjNvItdGUITxgw: folds 
aaNpjkDAbOD7pVe8Z5CEgQ: folds 
sD+TKtt36XiiN6jqHiLwDA: calls $0.15
ghNKXUBl/H+t83JF079ZBA: checks 
*** FLOP *** [8d 5s Js]
sD+TKtt36XiiN6jqHiLwDA: checks 
ghNKXUBl/H+t83JF079ZBA: checks 
VWUWpMLMj/Q1jRVpF7Aohw: bets $0.75
sD+TKtt36XiiN6jqHiLwDA: folds 
ghNKXUBl/H+t83JF079ZBA: folds 
Uncalled bet ($0.75) returned to VWUWpMLMj/Q1jRVpF7Aohw
VWUWpMLMj/Q1jRVpF7Aohw collected $0.75 from pot
*** SUMMARY ***
Total pot $0.75 | Rake $0 
Board [8d 5s Js]
Seat 1: H5Se03ZqSX7tbULXur2MAg folded before Flop (didn't bet)
Seat 2: 18G4P1XstjNvItdGUITxgw folded before Flop (didn't bet)
Seat 3: aaNpjkDAbOD7pVe8Z5CEgQ (button) folded before Flop (didn't bet)
Seat 4: sD+TKtt36XiiN6jqHiLwDA (small blind) folded on the Flop
Seat 5: ghNKXUBl/H+t83JF079ZBA (big blind) folded on the Flop
Seat 6: 9gmYYQesalMrUjaF7nKfrQ folded before Flop (didn't bet)
Seat 7: sWBBy1WroEskLNyJzhkUag folded before Flop (didn't bet)
Seat 8: VWUWpMLMj/Q1jRVpF7Aohw collected ($0.75)
Seat 9: OlPJsgR4xypSg/w1z7Gyvw folded before Flop (didn't bet)




PokerStars Game #59939672452:  Hold'em No Limit ($0.10/$0.25) - 2009/07/01 0:45:56 ET
Table '7/qMNloI0nSXWiX5Y1watA' 9-max Seat #8 is the button
Seat 1: lF4l0ujUfJ9uYJOg9Ch9/g ($43.10 in chips) 
Seat 2: 8B/dhbQjIWe6ASCdgzktNQ ($25.40 in chips) 
Seat 3: nEg1b6MIksd/4x5eLY735g ($43.50 in chips) 
Seat 4: 18G4P1XstjNvItdGUITxgw ($25 in chips) 
Seat 5: dfNim92Z6XK1/h5SFW5vDg ($41.05 in chips) 
Seat 6: vnCdP3GsLTKadDukKcJk/Q ($25 in chips) 
Seat 7: z5GxcHlYz/GSz6W2uFiTtg ($11.20 in chips) 
Seat 8: ljemhp25Zg+nlA9DLCIiUw ($23.35 in chips) 
Seat 9: aZgYUTCgC/6gwsjG/ryBrw ($25.10 in chips) 
aZgYUTCgC/6gwsjG/ryBrw: posts small blind $0.10
lF4l0ujUfJ9uYJOg9Ch9/g: posts big blind $0.25
*** HOLE CARDS ***
8B/dhbQjIWe6ASCdgzktNQ: folds 
nEg1b6MIksd/4x5eLY735g: raises $0.55 to $0.80
18G4P1XstjNvItdGUITxgw: folds 
dfNim92Z6XK1/h5SFW5vDg: folds 
vnCdP3GsLTKadDukKcJk/Q: folds 
z5GxcHlYz/GSz6W2uFiTtg: folds 
ljemhp25Zg+nlA9DLCIiUw: calls $0.80
aZgYUTCgC/6gwsjG/ryBrw: folds 
lF4l0ujUfJ9uYJOg9Ch9/g: folds 
*** FLOP *** [Js Qs Ks]
nEg1b6MIksd/4x5eLY735g: checks 
ljemhp25Zg+nlA9DLCIiUw: checks 
*** TURN *** [Js Qs Ks] [7s]
nEg1b6MIksd/4x5eLY735g: checks 
ljemhp25Zg+nlA9DLCIiUw: checks 
*** RIVER *** [Js Qs Ks 7s] [Tc]
nEg1b6MIksd/4x5eLY735g: checks 
ljemhp25Zg+nlA9DLCIiUw: checks 
*** SHOW DOWN ***
nEg1b6MIksd/4x5eLY735g: shows [4d 6d] (high card King)
ljemhp25Zg+nlA9DLCIiUw: shows [2c 2h] (a pair of Deuces)
ljemhp25Zg+nlA9DLCIiUw collected $1.90 from pot
*** SUMMARY ***
Total pot $1.95 | Rake $0.05 
Board [Js Qs Ks 7s Tc]
Seat 1: lF4l0ujUfJ9uYJOg9Ch9/g (big blind) folded before Flop
Seat 2: 8B/dhbQjIWe6ASCdgzktNQ folded before Flop (didn't bet)
Seat 3: nEg1b6MIksd/4x5eLY735g showed [4d 6d] and lost with high card King
Seat 4: 18G4P1XstjNvItdGUITxgw folded before Flop (didn't bet)
Seat 5: dfNim92Z6XK1/h5SFW5vDg folded before Flop (didn't bet)
Seat 6: vnCdP3GsLTKadDukKcJk/Q folded before Flop (didn't bet)
Seat 7: z5GxcHlYz/GSz6W2uFiTtg folded before Flop (didn't bet)
Seat 8: ljemhp25Zg+nlA9DLCIiUw (button) showed [2c 2h] and won ($1.90) with a pair of Deuces
Seat 9: aZgYUTCgC/6gwsjG/ryBrw (small blind) folded before Flop




PokerStars Game #59939672908:  Hold'em No Limit ($0.10/$0.25) - 2009/07/01 0:45:56 ET
Table 'dVzscin98UhGisTmV9BDcw' 9-max Seat #3 is the button
Seat 1: sBAwXpkpgyhyWbHIQcIJKA ($19.05 in chips) 
Seat 2: dfNim92Z6XK1/h5SFW5vDg ($28.80 in chips) 
Seat 3: 1Clf3cPrqoy/YgvWdWK1Xw ($5 in chips) 
Seat 4: aNpwfA31EREwO+ar4XzBCw ($25 in chips) 
Seat 5: 22dIObOuor/A+IKWkNoAlA ($5 in chips) 
Seat 6: hBMUlEpyU74r/fwDgIpXjQ ($28.35 in chips) 
Seat 7: nEg1b6MIksd/4x5eLY735g ($64.65 in chips) 
Seat 8: /vn2Qu2dvc9AMMq46Ae0jA ($6.20 in chips) 
Seat 9: OYa/ZJBO+suuezfWsUMhZw ($4.45 in chips) 
aNpwfA31EREwO+ar4XzBCw: posts small blind $0.10
22dIObOuor/A+IKWkNoAlA: posts big blind $0.25
*** HOLE CARDS ***
hBMUlEpyU74r/fwDgIpXjQ: folds 
nEg1b6MIksd/4x5eLY735g: folds 
/vn2Qu2dvc9AMMq46Ae0jA: folds 
OYa/ZJBO+suuezfWsUMhZw: folds 
sBAwXpkpgyhyWbHIQcIJKA: folds 
dfNim92Z6XK1/h5SFW5vDg: folds 
1Clf3cPrqoy/YgvWdWK1Xw: folds 
aNpwfA31EREwO+ar4XzBCw: folds 
Uncalled bet ($0.15) returned to 22dIObOuor/A+IKWkNoAlA
22dIObOuor/A+IKWkNoAlA collected $0.20 from pot
22dIObOuor/A+IKWkNoAlA: doesn't show hand 
*** SUMMARY ***
Total pot $0.20 | Rake $0 
Seat 1: sBAwXpkpgyhyWbHIQcIJKA folded before Flop (didn't bet)
Seat 2: dfNim92Z6XK1/h5SFW5vDg folded before Flop (didn't bet)
Seat 3: 1Clf3cPrqoy/YgvWdWK1Xw (button) folded before Flop (didn't bet)
Seat 4: aNpwfA31EREwO+ar4XzBCw (small blind) folded before Flop
Seat 5: 22dIObOuor/A+IKWkNoAlA (big blind) collected ($0.20)
Seat 6: hBMUlEpyU74r/fwDgIpXjQ folded before Flop (didn't bet)
Seat 7: nEg1b6MIksd/4x5eLY735g folded before Flop (didn't bet)
Seat 8: /vn2Qu2dvc9AMMq46Ae0jA folded before Flop (didn't bet)
Seat 9: OYa/ZJBO+suuezfWsUMhZw folded before Flop (didn't bet)




PokerStars Game #59939672888:  Hold'em No Limit ($0.10/$0.25) - 2009/07/01 0:45:56 ET
Table 'MiquQrQZJJq9ZtgRIp9HFQ' 6-max Seat #1 is the button
Seat 1: hM0MSDtq2ow7J40bSR04ig ($4.20 in chips) 
Seat 2: DMQLAmut/l19xN5STQndFg ($6.25 in chips) 
Seat 3: BYxjLnV1/LL0aZcTbfAOvw ($25 in chips) 
Seat 4: 0HIrwssk0FQvyKULzUTtlg ($21.15 in chips) 
Seat 6: X9oXZTg4PhZVR+ilX2OYbA ($10.80 in chips) 
DMQLAmut/l19xN5STQndFg: posts small blind $0.10
BYxjLnV1/LL0aZcTbfAOvw: posts big blind $0.25
*** HOLE CARDS ***
0HIrwssk0FQvyKULzUTtlg: calls $0.25
X9oXZTg4PhZVR+ilX2OYbA: raises $0.25 to $0.50
hM0MSDtq2ow7J40bSR04ig: calls $0.50
3zD3qLXT1bEffAoWGnc7wg joins the table at seat #5 
DMQLAmut/l19xN5STQndFg: folds 
BYxjLnV1/LL0aZcTbfAOvw: calls $0.25
0HIrwssk0FQvyKULzUTtlg: calls $0.25
*** FLOP *** [4d 2h Qs]
BYxjLnV1/LL0aZcTbfAOvw: checks 
0HIrwssk0FQvyKULzUTtlg: checks 
DMQLAmut/l19xN5STQndFg leaves the table
X9oXZTg4PhZVR+ilX2OYbA: checks 
hM0MSDtq2ow7J40bSR04ig: checks 
*** TURN *** [4d 2h Qs] [4c]
BYxjLnV1/LL0aZcTbfAOvw: bets $1.50
0HIrwssk0FQvyKULzUTtlg: folds 
X9oXZTg4PhZVR+ilX2OYbA: folds 
hM0MSDtq2ow7J40bSR04ig: folds 
Uncalled bet ($1.50) returned to BYxjLnV1/LL0aZcTbfAOvw
BYxjLnV1/LL0aZcTbfAOvw collected $2 from pot
BYxjLnV1/LL0aZcTbfAOvw: doesn't show hand 
*** SUMMARY ***
Total pot $2.10 | Rake $0.10 
Board [4d 2h Qs 4c]
Seat 1: hM0MSDtq2ow7J40bSR04ig (button) folded on the Turn
Seat 2: DMQLAmut/l19xN5STQndFg (small blind) folded before Flop
Seat 3: BYxjLnV1/LL0aZcTbfAOvw (big blind) collected ($2)
Seat 4: 0HIrwssk0FQvyKULzUTtlg folded on the Turn
Seat 6: X9oXZTg4PhZVR+ilX2OYbA folded on the Turn




PokerStars Game #59939672690:  Hold'em No Limit ($0.10/$0.25) - 2009/07/01 0:45:56 ET
Table 'R5f24ws6hGXlbvjq9ej+1Q' 9-max Seat #7 is the button
Seat 1: TeWJxSETzbXGiYKx0y+dtg ($30.10 in chips) 
Seat 5: YMlMWbkusacDBjx3A8lphw ($5.30 in chips) 
Seat 7: Z5ZtGOON8kmSdSCll9Z3XA ($7.25 in chips) 
Seat 8: qwr38jl5txoR36M7G5qi4A ($8.90 in chips) 
Seat 9: 33y9+GmQ3J84RvZXcraRTw ($27.50 in chips) 
qwr38jl5txoR36M7G5qi4A: posts small blind $0.10
33y9+GmQ3J84RvZXcraRTw: posts big blind $0.25
*** HOLE CARDS ***
TeWJxSETzbXGiYKx0y+dtg: folds 
YMlMWbkusacDBjx3A8lphw: calls $0.25
Z5ZtGOON8kmSdSCll9Z3XA: folds 
qwr38jl5txoR36M7G5qi4A: calls $0.15
33y9+GmQ3J84RvZXcraRTw: checks 
*** FLOP *** [Qh 7c Qs]
qwr38jl5txoR36M7G5qi4A: checks 
33y9+GmQ3J84RvZXcraRTw: checks 
YMlMWbkusacDBjx3A8lphw: checks 
*** TURN *** [Qh 7c Qs] [6d]
qwr38jl5txoR36M7G5qi4A: checks 
33y9+GmQ3J84RvZXcraRTw: checks 
YMlMWbkusacDBjx3A8lphw: checks 
*** RIVER *** [Qh 7c Qs 6d] [9s]
qwr38jl5txoR36M7G5qi4A: checks 
33y9+GmQ3J84RvZXcraRTw: checks 
YMlMWbkusacDBjx3A8lphw: checks 
*** SHOW DOWN ***
qwr38jl5txoR36M7G5qi4A: shows [Ks Ts] (a pair of Queens)
33y9+GmQ3J84RvZXcraRTw: mucks hand 
YMlMWbkusacDBjx3A8lphw: shows [2h 2s] (two pair, Queens and Deuces)
YMlMWbkusacDBjx3A8lphw collected $0.75 from pot
*** SUMMARY ***
Total pot $0.75 | Rake $0 
Board [Qh 7c Qs 6d 9s]
Seat 1: TeWJxSETzbXGiYKx0y+dtg folded before Flop (didn't bet)
Seat 5: YMlMWbkusacDBjx3A8lphw showed [2h 2s] and won ($0.75) with two pair, Queens and Deuces
Seat 7: Z5ZtGOON8kmSdSCll9Z3XA (button) folded before Flop (didn't bet)
Seat 8: qwr38jl5txoR36M7G5qi4A (small blind) showed [Ks Ts] and lost with a pair of Queens
Seat 9: 33y9+GmQ3J84RvZXcraRTw (big blind) mucked




PokerStars Game #59939672392:  Hold'em No Limit ($0.10/$0.25) - 2009/07/01 0:45:56 ET
Table 'SgI2Cobdjtkh0Fd0/eTTDg' 9-max Seat #5 is the button
Seat 2: 8B/dhbQjIWe6ASCdgzktNQ ($45.35 in chips) 
Seat 3: OiV1PWZ3IkN29JlmCcnTwQ ($4.55 in chips) 
Seat 4: 18G4P1XstjNvItdGUITxgw ($25 in chips) 
Seat 5: w/RUHfVzKTf7Bc19nucLpQ ($9.45 in chips) 
Seat 7: aJy680tKSaP5er559aSuGA ($16.60 in chips) 
Seat 9: cZ99hugmLBj9KhTlc8nCSw ($25 in chips) 
6RiVTYll/5D8zICp0MRpKw will be allowed to play after the button
aJy680tKSaP5er559aSuGA: posts small blind $0.10
cZ99hugmLBj9KhTlc8nCSw: posts big blind $0.25
*** HOLE CARDS ***
8B/dhbQjIWe6ASCdgzktNQ: folds 
OiV1PWZ3IkN29JlmCcnTwQ: folds 
18G4P1XstjNvItdGUITxgw: folds 
w/RUHfVzKTf7Bc19nucLpQ: raises $0.50 to $0.75
aJy680tKSaP5er559aSuGA: folds 
cZ99hugmLBj9KhTlc8nCSw: raises $1.50 to $2.25
w/RUHfVzKTf7Bc19nucLpQ: calls $1.50
*** FLOP *** [4c Js Qh]
cZ99hugmLBj9KhTlc8nCSw: bets $3
w/RUHfVzKTf7Bc19nucLpQ: calls $3
*** TURN *** [4c Js Qh] [6c]
cZ99hugmLBj9KhTlc8nCSw: bets $4.50
NcPAt5YjVvDFEJTTgAVj8g joins the table at seat #1 
w/RUHfVzKTf7Bc19nucLpQ: calls $4.20 and is all-in
Uncalled bet ($0.30) returned to cZ99hugmLBj9KhTlc8nCSw
*** RIVER *** [4c Js Qh 6c] [5h]
*** SHOW DOWN ***
cZ99hugmLBj9KhTlc8nCSw: shows [Kc As] (high card Ace)
w/RUHfVzKTf7Bc19nucLpQ: shows [Qc Ks] (a pair of Queens)
w/RUHfVzKTf7Bc19nucLpQ collected $18.10 from pot
*** SUMMARY ***
Total pot $19 | Rake $0.90 
Board [4c Js Qh 6c 5h]
Seat 2: 8B/dhbQjIWe6ASCdgzktNQ folded before Flop (didn't bet)
Seat 3: OiV1PWZ3IkN29JlmCcnTwQ folded before Flop (didn't bet)
Seat 4: 18G4P1XstjNvItdGUITxgw folded before Flop (didn't bet)
Seat 5: w/RUHfVzKTf7Bc19nucLpQ (button) showed [Qc Ks] and won ($18.10) with a pair of Queens
Seat 7: aJy680tKSaP5er559aSuGA (small blind) folded before Flop
Seat 9: cZ99hugmLBj9KhTlc8nCSw (big blind) showed [Kc As] and lost with high card Ace




PokerStars Game #59939673062:  Hold'em No Limit ($0.10/$0.25) - 2009/07/01 0:45:57 ET
Table 'T/iCKJXGphRN3xcdwfE/JQ' 6-max Seat #4 is the button
Seat 1: zZ8zH49EwNs0mqgppOaL9g ($24.50 in chips) 
Seat 2: 6qsh9pnysDKJNhfFhFmKRQ ($8.40 in chips) 
Seat 3: R6AGToFJQOYVZAjC2jXEKw ($25.70 in chips) 
Seat 4: yzFNNFIfC89bBPwpFPx2ow ($57.80 in chips) 
Seat 5: DzdrMZ6l84e65/zfW+2bcA ($5.30 in chips) 
Seat 6: jKYGBgexhqKT13Xana4EHg ($14.30 in chips) 
DzdrMZ6l84e65/zfW+2bcA: posts small blind $0.10
jKYGBgexhqKT13Xana4EHg: posts big blind $0.25
*** HOLE CARDS ***
zZ8zH49EwNs0mqgppOaL9g: folds 
6qsh9pnysDKJNhfFhFmKRQ: folds 
R6AGToFJQOYVZAjC2jXEKw: folds 
yzFNNFIfC89bBPwpFPx2ow: folds 
DzdrMZ6l84e65/zfW+2bcA: calls $0.15
jKYGBgexhqKT13Xana4EHg: checks 
*** FLOP *** [Kd 5s Th]
DzdrMZ6l84e65/zfW+2bcA: bets $0.50
jKYGBgexhqKT13Xana4EHg: folds 
Uncalled bet ($0.50) returned to DzdrMZ6l84e65/zfW+2bcA
DzdrMZ6l84e65/zfW+2bcA collected $0.50 from pot
DzdrMZ6l84e65/zfW+2bcA: doesn't show hand 
*** SUMMARY ***
Total pot $0.50 | Rake $0 
Board [Kd 5s Th]
Seat 1: zZ8zH49EwNs0mqgppOaL9g folded before Flop (didn't bet)
Seat 2: 6qsh9pnysDKJNhfFhFmKRQ folded before Flop (didn't bet)
Seat 3: R6AGToFJQOYVZAjC2jXEKw folded before Flop (didn't bet)
Seat 4: yzFNNFIfC89bBPwpFPx2ow (button) folded before Flop (didn't bet)
Seat 5: DzdrMZ6l84e65/zfW+2bcA (small blind) collected ($0.50)
Seat 6: jKYGBgexhqKT13Xana4EHg (big blind) folded on the Flop




PokerStars Game #59939673200:  Hold'em No Limit ($0.10/$0.25) - 2009/07/01 0:45:57 ET
Table '2AUmC2Rslg+QUbLfdgNdfg' 6-max Seat #1 is the button
Seat 1: lquriepNQBhDV5P1SWHhnA ($25 in chips) 
Seat 2: CCxAG7iPVlAv3brCqrGBEg ($13.50 in chips) 
Seat 3: iauW7L/+7qzAuHow7CD75Q ($8.95 in chips) 
Seat 4: B6R6e73iyJNddUtXtvYr3Q ($47.95 in chips) 
Seat 5: 8ClCHtFXGNplITm+63KB+Q ($25 in chips) 
Seat 6: BvTq4Tu0zBOsniW3eFCnkQ ($32.95 in chips) 
CCxAG7iPVlAv3brCqrGBEg: posts small blind $0.10
iauW7L/+7qzAuHow7CD75Q: posts big blind $0.25
*** HOLE CARDS ***
B6R6e73iyJNddUtXtvYr3Q: folds 
8ClCHtFXGNplITm+63KB+Q: folds 
BvTq4Tu0zBOsniW3eFCnkQ: raises $0.75 to $1
lquriepNQBhDV5P1SWHhnA: folds 
CCxAG7iPVlAv3brCqrGBEg: folds 
iauW7L/+7qzAuHow7CD75Q: folds 
Uncalled bet ($0.75) returned to BvTq4Tu0zBOsniW3eFCnkQ
BvTq4Tu0zBOsniW3eFCnkQ collected $0.60 from pot
BvTq4Tu0zBOsniW3eFCnkQ: doesn't show hand 
*** SUMMARY ***
Total pot $0.60 | Rake $0 
Seat 1: lquriepNQBhDV5P1SWHhnA (button) folded before Flop (didn't bet)
Seat 2: CCxAG7iPVlAv3brCqrGBEg (small blind) folded before Flop
Seat 3: iauW7L/+7qzAuHow7CD75Q (big blind) folded before Flop
Seat 4: B6R6e73iyJNddUtXtvYr3Q folded before Flop (didn't bet)
Seat 5: 8ClCHtFXGNplITm+63KB+Q folded before Flop (didn't bet)
Seat 6: BvTq4Tu0zBOsniW3eFCnkQ collected ($0.60)




PokerStars Game #59939673270:  Hold'em No Limit ($0.10/$0.25) - 2009/07/01 0:45:57 ET
Table 'Is9eNmJA1KnBOw0lcVkxUQ' 9-max Seat #1 is the button
Seat 1: 56S3mA6Zs3pGR+0p0vUCtg ($38.35 in chips) 
Seat 2: VllYilcih0t+gMD4GTRlgQ ($29.40 in chips) 
Seat 3: zFrHk6ssFhTu+DiVzVXr+g ($9.85 in chips) 
Seat 4: cZ99hugmLBj9KhTlc8nCSw ($25 in chips) 
Seat 6: HapyJHxV6lc3eqoT7yWL2A ($45.40 in chips) 
Seat 7: aNpwfA31EREwO+ar4XzBCw ($25 in chips) 
Seat 8: 1b3eMBC7sPXgDX9IYcruKg ($2.90 in chips) 
Seat 9: 7wo6Sr7QG3Zo6BaBDV1BOw ($5 in chips) 
VllYilcih0t+gMD4GTRlgQ: posts small blind $0.10
zFrHk6ssFhTu+DiVzVXr+g: posts big blind $0.25
V6p0jQ/RhUsqpHLmXvEX4Q: sits out 
*** HOLE CARDS ***
cZ99hugmLBj9KhTlc8nCSw: folds 
HapyJHxV6lc3eqoT7yWL2A: folds 
aNpwfA31EREwO+ar4XzBCw: folds 
1b3eMBC7sPXgDX9IYcruKg: folds 
7wo6Sr7QG3Zo6BaBDV1BOw: folds 
56S3mA6Zs3pGR+0p0vUCtg: folds 
VllYilcih0t+gMD4GTRlgQ: calls $0.15
zFrHk6ssFhTu+DiVzVXr+g: checks 
*** FLOP *** [As 7c 4c]
VllYilcih0t+gMD4GTRlgQ: checks 
zFrHk6ssFhTu+DiVzVXr+g: checks 
*** TURN *** [As 7c 4c] [5h]
VllYilcih0t+gMD4GTRlgQ: checks 
zFrHk6ssFhTu+DiVzVXr+g: bets $0.75
VllYilcih0t+gMD4GTRlgQ: folds 
Uncalled bet ($0.75) returned to zFrHk6ssFhTu+DiVzVXr+g
zFrHk6ssFhTu+DiVzVXr+g collected $0.50 from pot
zFrHk6ssFhTu+DiVzVXr+g: doesn't show hand 
*** SUMMARY ***
Total pot $0.50 | Rake $0 
Board [As 7c 4c 5h]
Seat 1: 56S3mA6Zs3pGR+0p0vUCtg (button) folded before Flop (didn't bet)
Seat 2: VllYilcih0t+gMD4GTRlgQ (small blind) folded on the Turn
Seat 3: zFrHk6ssFhTu+DiVzVXr+g (big blind) collected ($0.50)
Seat 4: cZ99hugmLBj9KhTlc8nCSw folded before Flop (didn't bet)
Seat 6: HapyJHxV6lc3eqoT7yWL2A folded before Flop (didn't bet)
Seat 7: aNpwfA31EREwO+ar4XzBCw folded before Flop (didn't bet)
Seat 8: 1b3eMBC7sPXgDX9IYcruKg folded before Flop (didn't bet)
Seat 9: 7wo6Sr7QG3Zo6BaBDV1BOw folded before Flop (didn't bet)




PokerStars Game #59939672956:  Hold'em No Limit ($0.10/$0.25) - 2009/07/01 0:45:57 ET
Table 'GgmUtmhrYPRnhkqEEjD/Kw' 9-max Seat #8 is the button
Seat 1: vnCdP3GsLTKadDukKcJk/Q ($25 in chips) 
Seat 2: ghNKXUBl/H+t83JF079ZBA ($25 in chips) 
Seat 3: DZek9vrzBExLUFtbWml/Eg ($10.95 in chips) 
Seat 4: uwmAXQRjyA4iX5kaC15P9A ($5.05 in chips) 
Seat 5: bwPJBTOHVE6kEKZYLU4rlA ($14.75 in chips) 
Seat 6: 4Ax0vobe1rLVIGZmkFINGA ($14.70 in chips) 
Seat 7: YwDw9cMqkbMznFK77rru4A ($16 in chips) 
Seat 8: mKwW7JjB4GQW2YtoYgqIgw ($8.15 in chips) 
vnCdP3GsLTKadDukKcJk/Q: posts small blind $0.10
ghNKXUBl/H+t83JF079ZBA: posts big blind $0.25
*** HOLE CARDS ***
DZek9vrzBExLUFtbWml/Eg: folds 
uwmAXQRjyA4iX5kaC15P9A: folds 
bwPJBTOHVE6kEKZYLU4rlA: calls $0.25
4Ax0vobe1rLVIGZmkFINGA: folds 
YwDw9cMqkbMznFK77rru4A: folds 
mKwW7JjB4GQW2YtoYgqIgw: calls $0.25
vnCdP3GsLTKadDukKcJk/Q: folds 
ghNKXUBl/H+t83JF079ZBA: checks 
*** FLOP *** [3s 9d 8d]
ghNKXUBl/H+t83JF079ZBA: checks 
bwPJBTOHVE6kEKZYLU4rlA: checks 
mKwW7JjB4GQW2YtoYgqIgw: bets $1
ghNKXUBl/H+t83JF079ZBA: folds 
bwPJBTOHVE6kEKZYLU4rlA: calls $1
*** TURN *** [3s 9d 8d] [Jd]
bwPJBTOHVE6kEKZYLU4rlA: checks 
mKwW7JjB4GQW2YtoYgqIgw: bets $1.75
bwPJBTOHVE6kEKZYLU4rlA: calls $1.75
*** RIVER *** [3s 9d 8d Jd] [5d]
bwPJBTOHVE6kEKZYLU4rlA: checks 
mKwW7JjB4GQW2YtoYgqIgw: checks 
*** SHOW DOWN ***
bwPJBTOHVE6kEKZYLU4rlA: shows [3c 3d] (a flush, Jack high)
mKwW7JjB4GQW2YtoYgqIgw: mucks hand 
bwPJBTOHVE6kEKZYLU4rlA collected $6.05 from pot
*** SUMMARY ***
Total pot $6.35 | Rake $0.30 
Board [3s 9d 8d Jd 5d]
Seat 1: vnCdP3GsLTKadDukKcJk/Q (small blind) folded before Flop
Seat 2: ghNKXUBl/H+t83JF079ZBA (big blind) folded on the Flop
Seat 3: DZek9vrzBExLUFtbWml/Eg folded before Flop (didn't bet)
Seat 4: uwmAXQRjyA4iX5kaC15P9A folded before Flop (didn't bet)
Seat 5: bwPJBTOHVE6kEKZYLU4rlA showed [3c 3d] and won ($6.05) with a flush, Jack high
Seat 6: 4Ax0vobe1rLVIGZmkFINGA folded before Flop (didn't bet)
Seat 7: YwDw9cMqkbMznFK77rru4A folded before Flop (didn't bet)
Seat 8: mKwW7JjB4GQW2YtoYgqIgw (button) mucked




PokerStars Game #59939673146:  Hold'em No Limit ($0.10/$0.25) - 2009/07/01 0:45:57 ET
Table 'WEMI3Mtn7dGARDbgNrKibg' 9-max Seat #6 is the button
Seat 1: 7cv+9Zc9HIQHNvYsMfV3uA ($25 in chips) 
Seat 2: tYsOBqdU1+x+yFI7zHO7hQ ($46.20 in chips) 
Seat 3: jZaChyamGXWcP+qALPP5Jg ($29.45 in chips) 
Seat 4: yyG4svzOpC1A+sUP/scg6w ($7.50 in chips) 
Seat 6: VBHxUExRAMrbxUq/cVx9Gw ($4.65 in chips) 
Seat 7: DnDcAdn9P0zGovMERigpFA ($58.75 in chips) 
Seat 8: ghNKXUBl/H+t83JF079ZBA ($26.95 in chips) 
Seat 9: NTamLAiMZ86c5yM04t96LA ($56 in chips) 
DnDcAdn9P0zGovMERigpFA: posts small blind $0.10
ghNKXUBl/H+t83JF079ZBA: posts big blind $0.25
*** HOLE CARDS ***
NTamLAiMZ86c5yM04t96LA: folds 
7cv+9Zc9HIQHNvYsMfV3uA: folds 
tYsOBqdU1+x+yFI7zHO7hQ: folds 
jZaChyamGXWcP+qALPP5Jg: folds 
yyG4svzOpC1A+sUP/scg6w: calls $0.25
VBHxUExRAMrbxUq/cVx9Gw: folds 
DnDcAdn9P0zGovMERigpFA: folds 
ghNKXUBl/H+t83JF079ZBA: checks 
*** FLOP *** [8c Qh 8d]
ghNKXUBl/H+t83JF079ZBA: bets $0.50
yyG4svzOpC1A+sUP/scg6w: folds 
Uncalled bet ($0.50) returned to ghNKXUBl/H+t83JF079ZBA
ghNKXUBl/H+t83JF079ZBA collected $0.60 from pot
ghNKXUBl/H+t83JF079ZBA: doesn't show hand 
*** SUMMARY ***
Total pot $0.60 | Rake $0 
Board [8c Qh 8d]
Seat 1: 7cv+9Zc9HIQHNvYsMfV3uA folded before Flop (didn't bet)
Seat 2: tYsOBqdU1+x+yFI7zHO7hQ folded before Flop (didn't bet)
Seat 3: jZaChyamGXWcP+qALPP5Jg folded before Flop (didn't bet)
Seat 4: yyG4svzOpC1A+sUP/scg6w folded on the Flop
Seat 6: VBHxUExRAMrbxUq/cVx9Gw (button) folded before Flop (didn't bet)
Seat 7: DnDcAdn9P0zGovMERigpFA (small blind) folded before Flop
Seat 8: ghNKXUBl/H+t83JF079ZBA (big blind) collected ($0.60)
Seat 9: NTamLAiMZ86c5yM04t96LA folded before Flop (didn't bet)




PokerStars Game #59939673524:  Hold'em No Limit ($0.10/$0.25) - 2009/07/01 0:45:57 ET
Table 'sSe6q4YTb/iS19t2eCFdsA' 9-max Seat #3 is the button
Seat 1: 5z3YkZTfH2GjoLK+6X7z2w ($11.55 in chips) 
Seat 2: rUpvA02nErFvZ4yFbDR8XA ($25.85 in chips) 
Seat 3: hBMUlEpyU74r/fwDgIpXjQ ($25.70 in chips) 
Seat 5: qS+jfnNoG75bT+uQ8CKhQA ($14 in chips) 
Seat 6: tYsOBqdU1+x+yFI7zHO7hQ ($26.05 in chips) 
Seat 7: t70KGeRtR3naHSqKDixsUg ($13.05 in chips) 
Seat 8: jeKWRUkMaVn8rEUjnJKqpg ($27.40 in chips) 
Seat 9: 4oA316mXLIui1QY63GXBUg ($25.25 in chips) 
22dIObOuor/A+IKWkNoAlA will be allowed to play after the button
qS+jfnNoG75bT+uQ8CKhQA: posts small blind $0.10
tYsOBqdU1+x+yFI7zHO7hQ: posts big blind $0.25
*** HOLE CARDS ***
t70KGeRtR3naHSqKDixsUg: folds 
jeKWRUkMaVn8rEUjnJKqpg: folds 
4oA316mXLIui1QY63GXBUg: folds 
5z3YkZTfH2GjoLK+6X7z2w: folds 
rUpvA02nErFvZ4yFbDR8XA: calls $0.25
hBMUlEpyU74r/fwDgIpXjQ: folds 
qS+jfnNoG75bT+uQ8CKhQA: calls $0.15
tYsOBqdU1+x+yFI7zHO7hQ: checks 
*** FLOP *** [8d Ad 5s]
qS+jfnNoG75bT+uQ8CKhQA: checks 
tYsOBqdU1+x+yFI7zHO7hQ: checks 
rUpvA02nErFvZ4yFbDR8XA: checks 
*** TURN *** [8d Ad 5s] [9c]
qS+jfnNoG75bT+uQ8CKhQA: checks 
tYsOBqdU1+x+yFI7zHO7hQ: checks 
rUpvA02nErFvZ4yFbDR8XA: checks 
*** RIVER *** [8d Ad 5s 9c] [2h]
qS+jfnNoG75bT+uQ8CKhQA: bets $0.75
tYsOBqdU1+x+yFI7zHO7hQ: folds 
rUpvA02nErFvZ4yFbDR8XA: folds 
Uncalled bet ($0.75) returned to qS+jfnNoG75bT+uQ8CKhQA
qS+jfnNoG75bT+uQ8CKhQA collected $0.75 from pot
*** SUMMARY ***
Total pot $0.75 | Rake $0 
Board [8d Ad 5s 9c 2h]
Seat 1: 5z3YkZTfH2GjoLK+6X7z2w folded before Flop (didn't bet)
Seat 2: rUpvA02nErFvZ4yFbDR8XA folded on the River
Seat 3: hBMUlEpyU74r/fwDgIpXjQ (button) folded before Flop (didn't bet)
Seat 5: qS+jfnNoG75bT+uQ8CKhQA (small blind) collected ($0.75)
Seat 6: tYsOBqdU1+x+yFI7zHO7hQ (big blind) folded on the River
Seat 7: t70KGeRtR3naHSqKDixsUg folded before Flop (didn't bet)
Seat 8: jeKWRUkMaVn8rEUjnJKqpg folded before Flop (didn't bet)
Seat 9: 4oA316mXLIui1QY63GXBUg folded before Flop (didn't bet)




PokerStars Game #59939674154:  Hold'em No Limit ($0.10/$0.25) - 2009/07/01 0:45:58 ET
Table 'P2yJ+jwfNsBdF12fLKA6DQ' 9-max Seat #3 is the button
Seat 1: zDrucyjVn5aeekNEc3cJrA ($26.15 in chips) 
Seat 2: V6p0jQ/RhUsqpHLmXvEX4Q ($12.35 in chips) 
Seat 3: aNpwfA31EREwO+ar4XzBCw ($26.85 in chips) 
Seat 4: dfNim92Z6XK1/h5SFW5vDg ($25 in chips) 
Seat 5: KUcJLaHvrSlvGyIGqDQp9A ($15.70 in chips) 
Seat 6: tIIUJycKjdqE3z/SXWAEwA ($5.60 in chips) 
Seat 7: 1/DuWziR8CXhWB71aPQd9Q ($9.65 in chips) 
Seat 8: LWN1wPrLH+695JIriXxDuw ($14.95 in chips) 
Seat 9: dN5zq7QdZCUe7NZFM6cECg ($20.90 in chips) 
dfNim92Z6XK1/h5SFW5vDg: posts small blind $0.10
KUcJLaHvrSlvGyIGqDQp9A: posts big blind $0.25
*** HOLE CARDS ***
tIIUJycKjdqE3z/SXWAEwA: calls $0.25
1/DuWziR8CXhWB71aPQd9Q: folds 
LWN1wPrLH+695JIriXxDuw: folds 
dN5zq7QdZCUe7NZFM6cECg: raises $1.50 to $1.75
zDrucyjVn5aeekNEc3cJrA: folds 
V6p0jQ/RhUsqpHLmXvEX4Q: folds 
aNpwfA31EREwO+ar4XzBCw: folds 
dfNim92Z6XK1/h5SFW5vDg: folds 
KUcJLaHvrSlvGyIGqDQp9A: folds 
tIIUJycKjdqE3z/SXWAEwA: calls $1.50
*** FLOP *** [Ad Qd 5s]
tIIUJycKjdqE3z/SXWAEwA: bets $3.85 and is all-in
dN5zq7QdZCUe7NZFM6cECg: calls $3.85
*** TURN *** [Ad Qd 5s] [5d]
*** RIVER *** [Ad Qd 5s 5d] [4c]
*** SHOW DOWN ***
tIIUJycKjdqE3z/SXWAEwA: shows [Ts Js] (a pair of Fives)
dN5zq7QdZCUe7NZFM6cECg: shows [Qs Qh] (a full house, Queens full of Fives)
tIIUJycKjdqE3z/SXWAEwA leaves the table
dN5zq7QdZCUe7NZFM6cECg collected $11 from pot
*** SUMMARY ***
Total pot $11.55 | Rake $0.55 
Board [Ad Qd 5s 5d 4c]
Seat 1: zDrucyjVn5aeekNEc3cJrA folded before Flop (didn't bet)
Seat 2: V6p0jQ/RhUsqpHLmXvEX4Q folded before Flop (didn't bet)
Seat 3: aNpwfA31EREwO+ar4XzBCw (button) folded before Flop (didn't bet)
Seat 4: dfNim92Z6XK1/h5SFW5vDg (small blind) folded before Flop
Seat 5: KUcJLaHvrSlvGyIGqDQp9A (big blind) folded before Flop
Seat 6: tIIUJycKjdqE3z/SXWAEwA showed [Ts Js] and lost with a pair of Fives
Seat 7: 1/DuWziR8CXhWB71aPQd9Q folded before Flop (didn't bet)
Seat 8: LWN1wPrLH+695JIriXxDuw folded before Flop (didn't bet)
Seat 9: dN5zq7QdZCUe7NZFM6cECg showed [Qs Qh] and won ($11) with a full house, Queens full of Fives




PokerStars Game #59939673642:  Hold'em No Limit ($0.10/$0.25) - 2009/07/01 0:45:58 ET
Table 'yZgGBnUGXVCcEJdcqes8tw' 9-max Seat #5 is the button
Seat 1: SXqVW4Q0evTUVZG6BbUNIA ($23.70 in chips) 
Seat 2: MG90wfSJZnOejs/KD3vlQQ ($25 in chips) 
Seat 3: z5GxcHlYz/GSz6W2uFiTtg ($26.05 in chips) 
Seat 4: opOCI2p6kW0tINuVaAqmcQ ($25.35 in chips) 
Seat 5: IGz29GAFM1DpSdXX+wXg3g ($18.30 in chips) 
Seat 6: H9i0g723A2AKb4nSMXqMPQ ($20.25 in chips) 
Seat 7: eC8Pn1D6Y2pct8o62nQfvQ ($28.05 in chips) 
Seat 8: dmYlc+1cjwZMJ7wV+Z0rRg ($25.15 in chips) 
Seat 9: M/9j4wkHH9i1JM51vgi1VA ($29.85 in chips) 
H9i0g723A2AKb4nSMXqMPQ: posts small blind $0.10
eC8Pn1D6Y2pct8o62nQfvQ: posts big blind $0.25
*** HOLE CARDS ***
dmYlc+1cjwZMJ7wV+Z0rRg: folds 
M/9j4wkHH9i1JM51vgi1VA: calls $0.25
SXqVW4Q0evTUVZG6BbUNIA: folds 
MG90wfSJZnOejs/KD3vlQQ: folds 
z5GxcHlYz/GSz6W2uFiTtg: raises $1 to $1.25
opOCI2p6kW0tINuVaAqmcQ: folds 
IGz29GAFM1DpSdXX+wXg3g: folds 
H9i0g723A2AKb4nSMXqMPQ: folds 
eC8Pn1D6Y2pct8o62nQfvQ: folds 
M/9j4wkHH9i1JM51vgi1VA: folds 
Uncalled bet ($1) returned to z5GxcHlYz/GSz6W2uFiTtg
z5GxcHlYz/GSz6W2uFiTtg collected $0.85 from pot
*** SUMMARY ***
Total pot $0.85 | Rake $0 
Seat 1: SXqVW4Q0evTUVZG6BbUNIA folded before Flop (didn't bet)
Seat 2: MG90wfSJZnOejs/KD3vlQQ folded before Flop (didn't bet)
Seat 3: z5GxcHlYz/GSz6W2uFiTtg collected ($0.85)
Seat 4: opOCI2p6kW0tINuVaAqmcQ folded before Flop (didn't bet)
Seat 5: IGz29GAFM1DpSdXX+wXg3g (button) folded before Flop (didn't bet)
Seat 6: H9i0g723A2AKb4nSMXqMPQ (small blind) folded before Flop
Seat 7: eC8Pn1D6Y2pct8o62nQfvQ (big blind) folded before Flop
Seat 8: dmYlc+1cjwZMJ7wV+Z0rRg folded before Flop (didn't bet)
Seat 9: M/9j4wkHH9i1JM51vgi1VA folded before Flop




PokerStars Game #59939673702:  Hold'em No Limit ($0.10/$0.25) - 2009/07/01 0:45:58 ET
Table 'fHv1Mk7ZbLjprZTGWKPiEQ' 6-max Seat #5 is the button
Seat 1: nrBtxp+MnBtUJ1AIhZxHkg ($25.95 in chips) 
Seat 2: f6TKWwdxmqfPaZe08T+mgg ($6.05 in chips) 
Seat 3: HyeBXe7tNOZjTdX/zI0BZQ ($14.10 in chips) 
Seat 4: TSmua8tGK3sTbwi0ynrW9Q ($51.90 in chips) 
Seat 5: edio/rLJ06xeZOfLhoL3UA ($26.55 in chips) 
Seat 6: AjG0X+rNtc2W08eph8oqpw ($8.70 in chips) 
AjG0X+rNtc2W08eph8oqpw: posts small blind $0.10
nrBtxp+MnBtUJ1AIhZxHkg: posts big blind $0.25
*** HOLE CARDS ***
f6TKWwdxmqfPaZe08T+mgg: folds 
HyeBXe7tNOZjTdX/zI0BZQ: folds 
TSmua8tGK3sTbwi0ynrW9Q: folds 
edio/rLJ06xeZOfLhoL3UA: raises $1 to $1.25
AjG0X+rNtc2W08eph8oqpw: folds 
nrBtxp+MnBtUJ1AIhZxHkg: folds 
Uncalled bet ($1) returned to edio/rLJ06xeZOfLhoL3UA
edio/rLJ06xeZOfLhoL3UA collected $0.60 from pot
edio/rLJ06xeZOfLhoL3UA: doesn't show hand 
*** SUMMARY ***
Total pot $0.60 | Rake $0 
Seat 1: nrBtxp+MnBtUJ1AIhZxHkg (big blind) folded before Flop
Seat 2: f6TKWwdxmqfPaZe08T+mgg folded before Flop (didn't bet)
Seat 3: HyeBXe7tNOZjTdX/zI0BZQ folded before Flop (didn't bet)
Seat 4: TSmua8tGK3sTbwi0ynrW9Q folded before Flop (didn't bet)
Seat 5: edio/rLJ06xeZOfLhoL3UA (button) collected ($0.60)
Seat 6: AjG0X+rNtc2W08eph8oqpw (small blind) folded before Flop




PokerStars Game #59939673668:  Hold'em No Limit ($0.10/$0.25) - 2009/07/01 0:45:58 ET
Table 'nlpa8xI95gAflovnFxB2yg' 6-max Seat #5 is the button
Seat 1: fZQg9veL7Dd/Z04ZTjC+wQ ($66.05 in chips) 
Seat 2: WrLI51S2iMb8GLMB83gGqA ($25 in chips) 
Seat 3: I1TxPvWj8NfG8orglCinNA ($26.40 in chips) 
Seat 4: 5xjU9nfIjn1MBxIJKZvS5w ($32.10 in chips) 
Seat 5: 6DwBRH+xZ12AAZmeAg+aXw ($25 in chips) 
Seat 6: FPlQHZog0ePFCETQ2KG4hQ ($25.10 in chips) 
FPlQHZog0ePFCETQ2KG4hQ: posts small blind $0.10
fZQg9veL7Dd/Z04ZTjC+wQ: posts big blind $0.25
*** HOLE CARDS ***
WrLI51S2iMb8GLMB83gGqA: folds 
I1TxPvWj8NfG8orglCinNA: folds 
5xjU9nfIjn1MBxIJKZvS5w: calls $0.25
6DwBRH+xZ12AAZmeAg+aXw: folds 
FPlQHZog0ePFCETQ2KG4hQ: folds 
fZQg9veL7Dd/Z04ZTjC+wQ: raises $1 to $1.25
5xjU9nfIjn1MBxIJKZvS5w: calls $1
*** FLOP *** [8s 2d Kc]
fZQg9veL7Dd/Z04ZTjC+wQ: checks 
5xjU9nfIjn1MBxIJKZvS5w: checks 
*** TURN *** [8s 2d Kc] [7c]
fZQg9veL7Dd/Z04ZTjC+wQ: bets $2.25
5xjU9nfIjn1MBxIJKZvS5w: folds 
Uncalled bet ($2.25) returned to fZQg9veL7Dd/Z04ZTjC+wQ
fZQg9veL7Dd/Z04ZTjC+wQ collected $2.50 from pot
fZQg9veL7Dd/Z04ZTjC+wQ: doesn't show hand 
*** SUMMARY ***
Total pot $2.60 | Rake $0.10 
Board [8s 2d Kc 7c]
Seat 1: fZQg9veL7Dd/Z04ZTjC+wQ (big blind) collected ($2.50)
Seat 2: WrLI51S2iMb8GLMB83gGqA folded before Flop (didn't bet)
Seat 3: I1TxPvWj8NfG8orglCinNA folded before Flop (didn't bet)
Seat 4: 5xjU9nfIjn1MBxIJKZvS5w folded on the Turn
Seat 5: 6DwBRH+xZ12AAZmeAg+aXw (button) folded before Flop (didn't bet)
Seat 6: FPlQHZog0ePFCETQ2KG4hQ (small blind) folded before Flop




PokerStars Game #59939673756:  Hold'em No Limit ($0.10/$0.25) - 2009/07/01 0:45:58 ET
Table 'ER5H84HUgJx7HyDLnELLeA' 6-max Seat #2 is the button
Seat 1: pjM/xh4+RG8zrxCobDgYDg ($16.70 in chips) 
Seat 2: nc79pm0LZRdhncq55evVqA ($48.15 in chips) 
Seat 3: BYxjLnV1/LL0aZcTbfAOvw ($25.10 in chips) 
Seat 4: tkRWn3WaJIfGmCXT2hPvJA ($19.15 in chips) 
Seat 5: mfrkWA3PTeYPkbO6hi98Aw ($24.90 in chips) 
Seat 6: 3zD3qLXT1bEffAoWGnc7wg ($30.85 in chips) 
BYxjLnV1/LL0aZcTbfAOvw: posts small blind $0.10
tkRWn3WaJIfGmCXT2hPvJA: posts big blind $0.25
*** HOLE CARDS ***
mfrkWA3PTeYPkbO6hi98Aw: folds 
3zD3qLXT1bEffAoWGnc7wg: folds 
pjM/xh4+RG8zrxCobDgYDg: folds 
nc79pm0LZRdhncq55evVqA: raises $0.75 to $1
BYxjLnV1/LL0aZcTbfAOvw: folds 
tkRWn3WaJIfGmCXT2hPvJA: folds 
Uncalled bet ($0.75) returned to nc79pm0LZRdhncq55evVqA
nc79pm0LZRdhncq55evVqA collected $0.60 from pot
nc79pm0LZRdhncq55evVqA: doesn't show hand 
*** SUMMARY ***
Total pot $0.60 | Rake $0 
Seat 1: pjM/xh4+RG8zrxCobDgYDg folded before Flop (didn't bet)
Seat 2: nc79pm0LZRdhncq55evVqA (button) collected ($0.60)
Seat 3: BYxjLnV1/LL0aZcTbfAOvw (small blind) folded before Flop
Seat 4: tkRWn3WaJIfGmCXT2hPvJA (big blind) folded before Flop
Seat 5: mfrkWA3PTeYPkbO6hi98Aw folded before Flop (didn't bet)
Seat 6: 3zD3qLXT1bEffAoWGnc7wg folded before Flop (didn't bet)




PokerStars Game #59939674032:  Hold'em No Limit ($0.10/$0.25) - 2009/07/01 0:45:58 ET
Table 'I0ZcuiUTeLuGYv26Nah7YA' 9-max Seat #3 is the button
Seat 1: iMiqaPr7dx84UF0wNUeh8A ($18.60 in chips) 
Seat 2: yzPZQFeaQTNf1YK3a0zRIw ($9.25 in chips) 
Seat 3: 1S/fpm+f42V/6MNZre+ccg ($30.55 in chips) 
Seat 4: 4awUyiDYTgylQKXZ9faBVA ($29.55 in chips) 
Seat 5: opOCI2p6kW0tINuVaAqmcQ ($43.15 in chips) 
Seat 6: JRV2PblFtPFz51l0Fwyz8g ($23.75 in chips) 
Seat 8: ijc1q+bpPQR12wxc0sWc4w ($15.95 in chips) 
4awUyiDYTgylQKXZ9faBVA: posts small blind $0.10
opOCI2p6kW0tINuVaAqmcQ: posts big blind $0.25
RJ/x9oZtt1RZLaJEQwZOxQ: sits out 
6RiVTYll/5D8zICp0MRpKw: sits out 
yzPZQFeaQTNf1YK3a0zRIw: posts big blind $0.25
*** HOLE CARDS ***
JRV2PblFtPFz51l0Fwyz8g: folds 
ijc1q+bpPQR12wxc0sWc4w: calls $0.25
iMiqaPr7dx84UF0wNUeh8A: raises $0.75 to $1
yzPZQFeaQTNf1YK3a0zRIw: folds 
1S/fpm+f42V/6MNZre+ccg: calls $1
4awUyiDYTgylQKXZ9faBVA: folds 
opOCI2p6kW0tINuVaAqmcQ: folds 
ijc1q+bpPQR12wxc0sWc4w: calls $0.75
*** FLOP *** [9d 2s 8h]
ijc1q+bpPQR12wxc0sWc4w: checks 
iMiqaPr7dx84UF0wNUeh8A: checks 
1S/fpm+f42V/6MNZre+ccg: checks 
*** TURN *** [9d 2s 8h] [6s]
ijc1q+bpPQR12wxc0sWc4w: bets $2
iMiqaPr7dx84UF0wNUeh8A: folds 
1S/fpm+f42V/6MNZre+ccg: folds 
Uncalled bet ($2) returned to ijc1q+bpPQR12wxc0sWc4w
ijc1q+bpPQR12wxc0sWc4w collected $3.45 from pot
*** SUMMARY ***
Total pot $3.60 | Rake $0.15 
Board [9d 2s 8h 6s]
Seat 1: iMiqaPr7dx84UF0wNUeh8A folded on the Turn
Seat 2: yzPZQFeaQTNf1YK3a0zRIw folded before Flop
Seat 3: 1S/fpm+f42V/6MNZre+ccg (button) folded on the Turn
Seat 4: 4awUyiDYTgylQKXZ9faBVA (small blind) folded before Flop
Seat 5: opOCI2p6kW0tINuVaAqmcQ (big blind) folded before Flop
Seat 6: JRV2PblFtPFz51l0Fwyz8g folded before Flop (didn't bet)
Seat 8: ijc1q+bpPQR12wxc0sWc4w collected ($3.45)




PokerStars Game #59939674808:  Hold'em No Limit ($0.10/$0.25) - 2009/07/01 0:45:59 ET
Table 'L5GvbdQO5aCZJSE6pyQ8OA' 6-max Seat #6 is the button
Seat 1: FOcO5GvOP3rgvLGPLVkg5g ($31.40 in chips) 
Seat 2: LxehwDpTQ19ph4Qmc78+Pw ($13.40 in chips) 
Seat 3: wKFJ513ucluNNiMlkXcDOQ ($27.45 in chips) 
Seat 4: ErIN0JRL5srYjT6en1f8YQ ($34.25 in chips) 
Seat 6: v+QfkGiuj9bgtuNoVnDO8w ($35.80 in chips) 
FOcO5GvOP3rgvLGPLVkg5g: posts small blind $0.10
LxehwDpTQ19ph4Qmc78+Pw: posts big blind $0.25
4kWQxGbT5FZ1dkPd1bE45Q: sits out 
*** HOLE CARDS ***
wKFJ513ucluNNiMlkXcDOQ: folds 
wKFJ513ucluNNiMlkXcDOQ leaves the table
ErIN0JRL5srYjT6en1f8YQ: folds 
v+QfkGiuj9bgtuNoVnDO8w: folds 
FOcO5GvOP3rgvLGPLVkg5g: raises $0.25 to $0.50
awQwF96aCUBjOczgehY95A joins the table at seat #3 
LxehwDpTQ19ph4Qmc78+Pw: calls $0.25
*** FLOP *** [8d As 8h]
FOcO5GvOP3rgvLGPLVkg5g: bets $0.85
LxehwDpTQ19ph4Qmc78+Pw: folds 
Uncalled bet ($0.85) returned to FOcO5GvOP3rgvLGPLVkg5g
FOcO5GvOP3rgvLGPLVkg5g collected $0.95 from pot
*** SUMMARY ***
Total pot $1 | Rake $0.05 
Board [8d As 8h]
Seat 1: FOcO5GvOP3rgvLGPLVkg5g (small blind) collected ($0.95)
Seat 2: LxehwDpTQ19ph4Qmc78+Pw (big blind) folded on the Flop
Seat 3: wKFJ513ucluNNiMlkXcDOQ folded before Flop (didn't bet)
Seat 4: ErIN0JRL5srYjT6en1f8YQ folded before Flop (didn't bet)
Seat 6: v+QfkGiuj9bgtuNoVnDO8w (button) folded before Flop (didn't bet)




PokerStars Game #59939674574:  Hold'em No Limit ($0.10/$0.25) - 2009/07/01 0:45:59 ET
Table 'IIO2q2znuuAXmiZ2qFTcmg' 6-max Seat #5 is the button
Seat 1: nwwpaieDRI0UPyVtChVHOg ($17 in chips) 
Seat 2: cS21pIxRHx5Gt42o7hPZzw ($15.60 in chips) 
Seat 3: hiTEr3yrERiQp3zHXRioVw ($41.35 in chips) 
Seat 4: 0HIrwssk0FQvyKULzUTtlg ($11.50 in chips) 
Seat 5: f9iRHw0d+kV7pbTYwF2+2g ($4.05 in chips) 
nwwpaieDRI0UPyVtChVHOg: posts small blind $0.10
cS21pIxRHx5Gt42o7hPZzw: posts big blind $0.25
*** HOLE CARDS ***
hiTEr3yrERiQp3zHXRioVw: folds 
0HIrwssk0FQvyKULzUTtlg: raises $0.75 to $1
f9iRHw0d+kV7pbTYwF2+2g said, "nh"
f9iRHw0d+kV7pbTYwF2+2g: raises $3.05 to $4.05 and is all-in
nwwpaieDRI0UPyVtChVHOg: folds 
sheikafella leaves the table
hiTEr3yrERiQp3zHXRioVw said, "ty"
cS21pIxRHx5Gt42o7hPZzw: folds 
0HIrwssk0FQvyKULzUTtlg: folds 
Uncalled bet ($3.05) returned to f9iRHw0d+kV7pbTYwF2+2g
f9iRHw0d+kV7pbTYwF2+2g collected $2.35 from pot
*** SUMMARY ***
Total pot $2.35 | Rake $0 
Seat 1: nwwpaieDRI0UPyVtChVHOg (small blind) folded before Flop
Seat 2: cS21pIxRHx5Gt42o7hPZzw (big blind) folded before Flop
Seat 3: hiTEr3yrERiQp3zHXRioVw folded before Flop (didn't bet)
Seat 4: 0HIrwssk0FQvyKULzUTtlg folded before Flop
Seat 5: f9iRHw0d+kV7pbTYwF2+2g (button) collected ($2.35)




PokerStars Game #59939674360:  Hold'em No Limit ($0.10/$0.25) - 2009/07/01 0:45:59 ET
Table 'M8kYidAX3ib7pLKW7edFLw' 6-max Seat #1 is the button
Seat 1: jp34e617tIzV8tKIWmfAbA ($25.25 in chips) 
Seat 2: 4kWQxGbT5FZ1dkPd1bE45Q ($25 in chips) 
Seat 3: q+Sip/IIcvzqgZt1pJAWTw ($9.35 in chips) 
Seat 4: /bjna2FTN7pPjqYGzmDE0Q ($24.65 in chips) 
Seat 5: bDKopKTvPi3W+PEnYUX3tg ($49.20 in chips) 
Seat 6: NqFoyDgzLwu4dOmSRXnFBA ($14.05 in chips) 
4kWQxGbT5FZ1dkPd1bE45Q: posts small blind $0.10
q+Sip/IIcvzqgZt1pJAWTw: posts big blind $0.25
*** HOLE CARDS ***
NqFoyDgzLwu4dOmSRXnFBA said, "and he went all in with that?"
q+Sip/IIcvzqgZt1pJAWTw said, "yup"
NqFoyDgzLwu4dOmSRXnFBA said, "bit silly"
/bjna2FTN7pPjqYGzmDE0Q: folds 
bDKopKTvPi3W+PEnYUX3tg: raises $0.50 to $0.75
NqFoyDgzLwu4dOmSRXnFBA: raises $0.75 to $1.50
q+Sip/IIcvzqgZt1pJAWTw said, "tillter prolly"
jp34e617tIzV8tKIWmfAbA: folds 
q+Sip/IIcvzqgZt1pJAWTw said, "tryin to gamble"
4kWQxGbT5FZ1dkPd1bE45Q: raises $2.75 to $4.25
q+Sip/IIcvzqgZt1pJAWTw: folds 
bDKopKTvPi3W+PEnYUX3tg: folds 
NqFoyDgzLwu4dOmSRXnFBA: raises $9.80 to $14.05 and is all-in
4kWQxGbT5FZ1dkPd1bE45Q: calls $9.80
*** FLOP *** [Js 6s Jd]
q+Sip/IIcvzqgZt1pJAWTw said, "gl"
*** TURN *** [Js 6s Jd] [Qs]
*** RIVER *** [Js 6s Jd Qs] [2c]
*** SHOW DOWN ***
4kWQxGbT5FZ1dkPd1bE45Q: shows [Ad Ac] (two pair, Aces and Jacks)
NqFoyDgzLwu4dOmSRXnFBA: shows [Kh Ks] (two pair, Kings and Jacks)
4kWQxGbT5FZ1dkPd1bE45Q collected $27.65 from pot
q+Sip/IIcvzqgZt1pJAWTw said, "nh"
*** SUMMARY ***
Total pot $29.10 | Rake $1.45 
Board [Js 6s Jd Qs 2c]
Seat 1: jp34e617tIzV8tKIWmfAbA (button) folded before Flop (didn't bet)
Seat 2: 4kWQxGbT5FZ1dkPd1bE45Q (small blind) showed [Ad Ac] and won ($27.65) with two pair, Aces and Jacks
Seat 3: q+Sip/IIcvzqgZt1pJAWTw (big blind) folded before Flop
Seat 4: /bjna2FTN7pPjqYGzmDE0Q folded before Flop (didn't bet)
Seat 5: bDKopKTvPi3W+PEnYUX3tg folded before Flop
Seat 6: NqFoyDgzLwu4dOmSRXnFBA showed [Kh Ks] and lost with two pair, Kings and Jacks




PokerStars Game #59939674710:  Hold'em No Limit ($0.10/$0.25) - 2009/07/01 0:45:59 ET
Table '5NipxzzFB2DffzDpddyQoQ' 6-max Seat #3 is the button
Seat 1: TslQs7AQSLbVtr4X8JOOOQ ($11.45 in chips) 
Seat 2: jxrNE4qd8KCOIqHjQcwCrA ($47.50 in chips) 
Seat 3: qGHGf/553gQnDoklMRe3tg ($48.45 in chips) 
Seat 4: Inq44d7PQ+8TbEKfPeuxVQ ($5.70 in chips) 
Seat 5: cS21pIxRHx5Gt42o7hPZzw ($7.15 in chips) 
Seat 6: lYjWCpfCxX2kgcHY3v4Yow ($26.55 in chips) 
Inq44d7PQ+8TbEKfPeuxVQ: posts small blind $0.10
cS21pIxRHx5Gt42o7hPZzw: posts big blind $0.25
*** HOLE CARDS ***
lYjWCpfCxX2kgcHY3v4Yow: folds 
TslQs7AQSLbVtr4X8JOOOQ: folds 
jxrNE4qd8KCOIqHjQcwCrA: folds 
qGHGf/553gQnDoklMRe3tg: raises $0.75 to $1
Inq44d7PQ+8TbEKfPeuxVQ: folds 
cS21pIxRHx5Gt42o7hPZzw: folds 
Uncalled bet ($0.75) returned to qGHGf/553gQnDoklMRe3tg
qGHGf/553gQnDoklMRe3tg collected $0.60 from pot
*** SUMMARY ***
Total pot $0.60 | Rake $0 
Seat 1: TslQs7AQSLbVtr4X8JOOOQ folded before Flop (didn't bet)
Seat 2: jxrNE4qd8KCOIqHjQcwCrA folded before Flop (didn't bet)
Seat 3: qGHGf/553gQnDoklMRe3tg (button) collected ($0.60)
Seat 4: Inq44d7PQ+8TbEKfPeuxVQ (small blind) folded before Flop
Seat 5: cS21pIxRHx5Gt42o7hPZzw (big blind) folded before Flop
Seat 6: lYjWCpfCxX2kgcHY3v4Yow folded before Flop (didn't bet)




PokerStars Game #59939674536:  Hold'em No Limit ($0.10/$0.25) - 2009/07/01 0:45:59 ET
Table 'NtEQAxCeIK2io1CGtW658g' 6-max Seat #4 is the button
Seat 1: lnOV7k25gyN7L5t5YKTgIg ($17.20 in chips) 
Seat 2: nc79pm0LZRdhncq55evVqA ($26.10 in chips) 
Seat 3: m2yWOKfAxqHoy5DDN87Ttw ($23.40 in chips) 
Seat 4: 8296 ($13.05 in chips) 
Seat 5: FStoHe64SQWqAsjya9pDkQ ($25.20 in chips) 
Seat 6: /gJNBeCkWL4o85/jvlZ4BA ($68.05 in chips) 
FStoHe64SQWqAsjya9pDkQ: posts small blind $0.10
/gJNBeCkWL4o85/jvlZ4BA: posts big blind $0.25
*** HOLE CARDS ***
lnOV7k25gyN7L5t5YKTgIg: calls $0.25
nc79pm0LZRdhncq55evVqA: calls $0.25
m2yWOKfAxqHoy5DDN87Ttw: folds 
8296: folds 
FStoHe64SQWqAsjya9pDkQ: calls $0.15
/gJNBeCkWL4o85/jvlZ4BA: checks 
*** FLOP *** [9c 9s 7h]
FStoHe64SQWqAsjya9pDkQ: checks 
/gJNBeCkWL4o85/jvlZ4BA: checks 
lnOV7k25gyN7L5t5YKTgIg: checks 
nc79pm0LZRdhncq55evVqA: bets $0.50
FStoHe64SQWqAsjya9pDkQ: folds 
/gJNBeCkWL4o85/jvlZ4BA: folds 
lnOV7k25gyN7L5t5YKTgIg: folds 
Uncalled bet ($0.50) returned to nc79pm0LZRdhncq55evVqA
nc79pm0LZRdhncq55evVqA collected $0.95 from pot
nc79pm0LZRdhncq55evVqA: doesn't show hand 
*** SUMMARY ***
Total pot $1 | Rake $0.05 
Board [9c 9s 7h]
Seat 1: lnOV7k25gyN7L5t5YKTgIg folded on the Flop
Seat 2: nc79pm0LZRdhncq55evVqA collected ($0.95)
Seat 3: m2yWOKfAxqHoy5DDN87Ttw folded before Flop (didn't bet)
Seat 4: 8296 (button) folded before Flop (didn't bet)
Seat 5: FStoHe64SQWqAsjya9pDkQ (small blind) folded on the Flop
Seat 6: /gJNBeCkWL4o85/jvlZ4BA (big blind) folded on the Flop




PokerStars Game #59939674764:  Hold'em No Limit ($0.10/$0.25) - 2009/07/01 0:45:59 ET
Table 'Ez9TB43XM4QgMDQkIW9DYw' 9-max Seat #9 is the button
Seat 1: YqWNLUj3exwMphJEDBi8Ug ($29.35 in chips) 
Seat 2: gtLY9BJ1dcPGyJ0NDNjaBg ($10.40 in chips) 
Seat 3: LorpmCSxb4uozpKwk8Awsg ($27.15 in chips) 
Seat 4: il+NK449FnwuQ8vyJ0Xn/g ($9 in chips) 
Seat 5: vZGoOTJLQLhkPj4I+LNGig ($25.35 in chips) 
Seat 6: 76o85YBHJ9veRYp2LPuluQ ($33.55 in chips) 
Seat 7: 18G4P1XstjNvItdGUITxgw ($25 in chips) 
Seat 8: +2kMBNpY4nF1qNCRd8SJLA ($25 in chips) 
Seat 9: QEbIGci+itdw+re8RM5fZA ($25 in chips) 
YqWNLUj3exwMphJEDBi8Ug: posts small blind $0.10
gtLY9BJ1dcPGyJ0NDNjaBg: posts big blind $0.25
*** HOLE CARDS ***
LorpmCSxb4uozpKwk8Awsg: folds 
il+NK449FnwuQ8vyJ0Xn/g: folds 
vZGoOTJLQLhkPj4I+LNGig: raises $0.75 to $1
76o85YBHJ9veRYp2LPuluQ: folds 
18G4P1XstjNvItdGUITxgw: folds 
+2kMBNpY4nF1qNCRd8SJLA: folds 
QEbIGci+itdw+re8RM5fZA: folds 
YqWNLUj3exwMphJEDBi8Ug: folds 
gtLY9BJ1dcPGyJ0NDNjaBg: folds 
Uncalled bet ($0.75) returned to vZGoOTJLQLhkPj4I+LNGig
vZGoOTJLQLhkPj4I+LNGig collected $0.60 from pot
vZGoOTJLQLhkPj4I+LNGig: doesn't show hand 
*** SUMMARY ***
Total pot $0.60 | Rake $0 
Seat 1: YqWNLUj3exwMphJEDBi8Ug (small blind) folded before Flop
Seat 2: gtLY9BJ1dcPGyJ0NDNjaBg (big blind) folded before Flop
Seat 3: LorpmCSxb4uozpKwk8Awsg folded before Flop (didn't bet)
Seat 4: il+NK449FnwuQ8vyJ0Xn/g folded before Flop (didn't bet)
Seat 5: vZGoOTJLQLhkPj4I+LNGig collected ($0.60)
Seat 6: 76o85YBHJ9veRYp2LPuluQ folded before Flop (didn't bet)
Seat 7: 18G4P1XstjNvItdGUITxgw folded before Flop (didn't bet)
Seat 8: +2kMBNpY4nF1qNCRd8SJLA folded before Flop (didn't bet)
Seat 9: QEbIGci+itdw+re8RM5fZA (button) folded before Flop (didn't bet)




PokerStars Game #59939674370:  Hold'em No Limit ($0.10/$0.25) - 2009/07/01 0:45:59 ET
Table '3lS+sU5k6mwJCS2nFMmQ6Q' 9-max Seat #9 is the button
Seat 1: VWUWpMLMj/Q1jRVpF7Aohw ($12.75 in chips) 
Seat 2: 4oA316mXLIui1QY63GXBUg ($25.50 in chips) 
Seat 3: 1DXccE2UUK5DIRVGlOKnTA ($9.85 in chips) 
Seat 4: 8B/dhbQjIWe6ASCdgzktNQ ($44.90 in chips) 
Seat 5: LuckyShot



PokerStars Game #59939675274:  Hold'em No Limit ($0.10/$0.25) - 2009/07/01 0:46:00 ET
Table 'djcjiEGabFQO0MNG6jEeJQ' 9-max Seat #6 is the button
Seat 1: K7bAhhMMJ/XcTmGaBZVfFQ ($23.80 in chips) 
Seat 3: 1S/fpm+f42V/6MNZre+ccg ($27.95 in chips) 
Seat 4: E6WojUZ5V/6opnfMNTSjXQ ($12.60 in chips) 
Seat 5: cZ99hugmLBj9KhTlc8nCSw ($40.95 in chips) 
Seat 6: aNpwfA31EREwO+ar4XzBCw ($59.20 in chips) 
Seat 7: 56S3mA6Zs3pGR+0p0vUCtg ($30.20 in chips) 
Seat 8: +sbyWwIcFp9kP0bDtMegfQ ($54.30 in chips) 
Seat 9: HPEB+AtKw1+C/cxU0o1ciw ($47.65 in chips) 
56S3mA6Zs3pGR+0p0vUCtg: posts small blind $0.10
+sbyWwIcFp9kP0bDtMegfQ: posts big blind $0.25
*** HOLE CARDS ***
HPEB+AtKw1+C/cxU0o1ciw: folds 
K7bAhhMMJ/XcTmGaBZVfFQ: calls $0.25
1S/fpm+f42V/6MNZre+ccg: folds 
E6WojUZ5V/6opnfMNTSjXQ: calls $0.25
cZ99hugmLBj9KhTlc8nCSw: folds 
aNpwfA31EREwO+ar4XzBCw: folds 
56S3mA6Zs3pGR+0p0vUCtg: folds 
+sbyWwIcFp9kP0bDtMegfQ: checks 
*** FLOP *** [Ah 6h Qh]
+sbyWwIcFp9kP0bDtMegfQ: checks 
K7bAhhMMJ/XcTmGaBZVfFQ: bets $0.60
E6WojUZ5V/6opnfMNTSjXQ: folds 
+sbyWwIcFp9kP0bDtMegfQ: folds 
Uncalled bet ($0.60) returned to K7bAhhMMJ/XcTmGaBZVfFQ
K7bAhhMMJ/XcTmGaBZVfFQ collected $0.85 from pot
K7bAhhMMJ/XcTmGaBZVfFQ: doesn't show hand 
*** SUMMARY ***
Total pot $0.85 | Rake $0 
Board [Ah 6h Qh]
Seat 1: K7bAhhMMJ/XcTmGaBZVfFQ collected ($0.85)
Seat 3: 1S/fpm+f42V/6MNZre+ccg folded before Flop (didn't bet)
Seat 4: E6WojUZ5V/6opnfMNTSjXQ folded on the Flop
Seat 5: cZ99hugmLBj9KhTlc8nCSw folded before Flop (didn't bet)
Seat 6: aNpwfA31EREwO+ar4XzBCw (button) folded before Flop (didn't bet)
Seat 7: 56S3mA6Zs3pGR+0p0vUCtg (small blind) folded before Flop
Seat 8: +sbyWwIcFp9kP0bDtMegfQ (big blind) folded on the Flop
Seat 9: HPEB+AtKw1+C/cxU0o1ciw folded before Flop (didn't bet)




PokerStars Game #59939675398:  Hold'em No Limit ($0.10/$0.25) - 2009/07/01 0:46:00 ET
Table 'ohAuixfiLOYDylNUG5mNUw' 9-max Seat #2 is the button
Seat 1: AtRN1hdV8HbL3X4XogDaLA ($38.55 in chips) 
Seat 2: yVwP/Nr5oXkAQp5dmdNUVQ ($25 in chips) 
Seat 3: HVKi9hnDyvzObpL08/OarQ ($26 in chips) 
Seat 4: jeKWRUkMaVn8rEUjnJKqpg ($25 in chips) 
Seat 5: wub1jsnHlpWmOX4uczVADA ($9.75 in chips) 
Seat 6: opOCI2p6kW0tINuVaAqmcQ ($25.60 in chips) 
Seat 8: ppMlNkhYgErlt4fuJO7ADA ($9.50 in chips) 
Seat 9: hIss79a4pu7GzJZepfgOpg ($25 in chips) 
HVKi9hnDyvzObpL08/OarQ: posts small blind $0.10
jeKWRUkMaVn8rEUjnJKqpg: posts big blind $0.25
aPRz/2GxbXANYpVsQO8pdQ: sits out 
*** HOLE CARDS ***
wub1jsnHlpWmOX4uczVADA: folds 
opOCI2p6kW0tINuVaAqmcQ: folds 
ppMlNkhYgErlt4fuJO7ADA: folds 
hIss79a4pu7GzJZepfgOpg: folds 
AtRN1hdV8HbL3X4XogDaLA: folds 
yVwP/Nr5oXkAQp5dmdNUVQ: folds 
HVKi9hnDyvzObpL08/OarQ: folds 
Uncalled bet ($0.15) returned to jeKWRUkMaVn8rEUjnJKqpg
jeKWRUkMaVn8rEUjnJKqpg collected $0.20 from pot
jeKWRUkMaVn8rEUjnJKqpg: doesn't show hand 
*** SUMMARY ***
Total pot $0.20 | Rake $0 
Seat 1: AtRN1hdV8HbL3X4XogDaLA folded before Flop (didn't bet)
Seat 2: yVwP/Nr5oXkAQp5dmdNUVQ (button) folded before Flop (didn't bet)
Seat 3: HVKi9hnDyvzObpL08/OarQ (small blind) folded before Flop
Seat 4: jeKWRUkMaVn8rEUjnJKqpg (big blind) collected ($0.20)
Seat 5: wub1jsnHlpWmOX4uczVADA folded before Flop (didn't bet)
Seat 6: opOCI2p6kW0tINuVaAqmcQ folded before Flop (didn't bet)
Seat 8: ppMlNkhYgErlt4fuJO7ADA folded before Flop (didn't bet)
Seat 9: hIss79a4pu7GzJZepfgOpg folded before Flop (didn't bet)




PokerStars Game #59939675124:  Hold'em No Limit ($0.10/$0.25) - 2009/07/01 0:46:00 ET
Table '8QBBaev+cI2i/r2H6ml/lg' 9-max Seat #6 is the button
Seat 4: ZoG0obuajzVjwgd7lNHjgg ($5 in chips) 
Seat 6: cxE+szmvEUe7vE+z2ozM2Q ($10.05 in chips) 
cxE+szmvEUe7vE+z2ozM2Q: posts small blind $0.10
ZoG0obuajzVjwgd7lNHjgg: posts big blind $0.25
*** HOLE CARDS ***
cxE+szmvEUe7vE+z2ozM2Q: raises $7.75 to $8
ZoG0obuajzVjwgd7lNHjgg: folds 
Uncalled bet ($7.75) returned to cxE+szmvEUe7vE+z2ozM2Q
cxE+szmvEUe7vE+z2ozM2Q collected $0.50 from pot
*** SUMMARY ***
Total pot $0.50 | Rake $0 
Seat 4: ZoG0obuajzVjwgd7lNHjgg (big blind) folded before Flop
Seat 6: cxE+szmvEUe7vE+z2ozM2Q (button) (small blind) collected ($0.50)




PokerStars Game #59939674990:  Hold'em No Limit ($0.10/$0.25) - 2009/07/01 0:46:00 ET
Table '/XCUCUl3yW6tdTJQEhJKGw' 6-max Seat #1 is the button
Seat 1: p8J112JmNRnCwV2+NAEzCA ($19.75 in chips) 
Seat 2: 8ClCHtFXGNplITm+63KB+Q ($28.40 in chips) 
Seat 3: /gJNBeCkWL4o85/jvlZ4BA ($36.25 in chips) 
Seat 4: SFmT9ZsVopnukjvAzrxTRg ($25.35 in chips) 
Seat 5: rf9ho6cin0bk70nP86p3rQ ($14.25 in chips) 
Seat 6: armfxZhGxeZVZBYAQFuIJQ ($34.65 in chips) 
8ClCHtFXGNplITm+63KB+Q: posts small blind $0.10
/gJNBeCkWL4o85/jvlZ4BA: posts big blind $0.25
*** HOLE CARDS ***
SFmT9ZsVopnukjvAzrxTRg: folds 
rf9ho6cin0bk70nP86p3rQ: calls $0.25
armfxZhGxeZVZBYAQFuIJQ: folds 
p8J112JmNRnCwV2+NAEzCA has timed out
p8J112JmNRnCwV2+NAEzCA: folds 
p8J112JmNRnCwV2+NAEzCA is sitting out
8ClCHtFXGNplITm+63KB+Q: calls $0.15
/gJNBeCkWL4o85/jvlZ4BA: checks 
*** FLOP *** [8c 5c 4c]
8ClCHtFXGNplITm+63KB+Q: checks 
/gJNBeCkWL4o85/jvlZ4BA: checks 
rf9ho6cin0bk70nP86p3rQ: checks 
*** TURN *** [8c 5c 4c] [9c]
8ClCHtFXGNplITm+63KB+Q: checks 
p8J112JmNRnCwV2+NAEzCA has returned
/gJNBeCkWL4o85/jvlZ4BA: checks 
rf9ho6cin0bk70nP86p3rQ: bets $0.50
8ClCHtFXGNplITm+63KB+Q: folds 
/gJNBeCkWL4o85/jvlZ4BA: calls $0.50
*** RIVER *** [8c 5c 4c 9c] [6h]
/gJNBeCkWL4o85/jvlZ4BA: checks 
rf9ho6cin0bk70nP86p3rQ: bets $0.75
/gJNBeCkWL4o85/jvlZ4BA: folds 
Uncalled bet ($0.75) returned to rf9ho6cin0bk70nP86p3rQ
rf9ho6cin0bk70nP86p3rQ collected $1.70 from pot
rf9ho6cin0bk70nP86p3rQ: doesn't show hand 
*** SUMMARY ***
Total pot $1.75 | Rake $0.05 
Board [8c 5c 4c 9c 6h]
Seat 1: p8J112JmNRnCwV2+NAEzCA (button) folded before Flop (didn't bet)
Seat 2: 8ClCHtFXGNplITm+63KB+Q (small blind) folded on the Turn
Seat 3: /gJNBeCkWL4o85/jvlZ4BA (big blind) folded on the River
Seat 4: SFmT9ZsVopnukjvAzrxTRg folded before Flop (didn't bet)
Seat 5: rf9ho6cin0bk70nP86p3rQ collected ($1.70)
Seat 6: armfxZhGxeZVZBYAQFuIJQ folded before Flop (didn't bet)




PokerStars Game #59939675622:  Hold'em No Limit ($0.10/$0.25) - 2009/07/01 0:46:01 ET
Table 'MRfAiS/4JSfnUDlCcZo0wAhfHe8uKeSJMyWAjSdM7ROQx Seat #1 is the button
Seat 1: 48oT5xFI+5CHUJlfoGrE4w ($14.10 in chips) 
Seat 2: /gJNBeCkWL4o85/jvlZ4BA ($36.20 in chips) 
Seat 3: FYepjhAvF8ZdVCmqHIy+eQ ($45.15 in chips) 
Seat 4: Go8clNIDGP3feVvzBDG4pg ($15.15 in chips) 
Seat 5: qccGLncfUaN00Few5HsgYg ($29.35 in chips) 
Seat 6: VaDPspfGS2lnEkaGNrNqfg ($12.90 in chips) 
/gJNBeCkWL4o85/jvlZ4BA: posts small blind $0.10
FYepjhAvF8ZdVCmqHIy+eQ: posts big blind $0.25
*** HOLE CARDS ***
Go8clNIDGP3feVvzBDG4pg: calls $0.25
qccGLncfUaN00Few5HsgYg: folds 
VaDPspfGS2lnEkaGNrNqfg: folds 
48oT5xFI+5CHUJlfoGrE4w: raises $0.50 to $0.75
/gJNBeCkWL4o85/jvlZ4BA: calls $0.65
FYepjhAvF8ZdVCmqHIy+eQ: folds 
Go8clNIDGP3feVvzBDG4pg: calls $0.50
*** FLOP *** [9h 7c Qs]
/gJNBeCkWL4o85/jvlZ4BA: bets $0.75
Go8clNIDGP3feVvzBDG4pg: calls $0.75
48oT5xFI+5CHUJlfoGrE4w: calls $0.75
*** TURN *** [9h 7c Qs] [3c]
/gJNBeCkWL4o85/jvlZ4BA: checks 
Go8clNIDGP3feVvzBDG4pg: checks 
48oT5xFI+5CHUJlfoGrE4w: bets $1
/gJNBeCkWL4o85/jvlZ4BA: folds 
Go8clNIDGP3feVvzBDG4pg: calls $1
*** RIVER *** [9h 7c Qs 3c] [7h]
Go8clNIDGP3feVvzBDG4pg: checks 
48oT5xFI+5CHUJlfoGrE4w: bets $1.50
Go8clNIDGP3feVvzBDG4pg: folds 
Uncalled bet ($1.50) returned to 48oT5xFI+5CHUJlfoGrE4w
48oT5xFI+5CHUJlfoGrE4w collected $6.45 from pot
48oT5xFI+5CHUJlfoGrE4w: doesn't show hand 
*** SUMMARY ***
Total pot $6.75 | Rake $0.30 
Board [9h 7c Qs 3c 7h]
Seat 1: 48oT5xFI+5CHUJlfoGrE4w (button) collected ($6.45)
Seat 2: /gJNBeCkWL4o85/jvlZ4BA (small blind) folded on the Turn
Seat 3: FYepjhAvF8ZdVCmqHIy+eQ (big blind) folded before Flop
Seat 4: Go8clNIDGP3feVvzBDG4pg folded on the River
Seat 5: qccGLncfUaN00Few5HsgYg folded before Flop (didn't bet)
Seat 6: VaDPspfGS2lnEkaGNrNqfg folded before Flop (didn't bet)




PokerStars Game #59939675888:  Hold'em No Limit ($0.10/$0.25) - 2009/07/01 0:46:01 ET
Table '2clPgY3+dETPD/8zjXZdFw' 6-max Seat #3 is the button
Seat 1: qllppsCmUqovlriIWCeM/g ($6.65 in chips) 
Seat 2: NzIFHwilc5zU7QhjDTgTZA ($4.80 in chips) 
Seat 3: 6pF9LtHn+EH0ChbOXzox9g ($6.05 in chips) 
Seat 4: 9KPR3sZ+CxRm7bQ8qxFzMQ ($7.15 in chips) 
Seat 5: sEQx9G5Cu8k1HNdQasxvUA ($60.20 in chips) 
Seat 6: Mch463E1dxQfVob352za6w ($25.95 in chips) 
9KPR3sZ+CxRm7bQ8qxFzMQ: posts small blind $0.10
sEQx9G5Cu8k1HNdQasxvUA: posts big blind $0.25
*** HOLE CARDS ***
Mch463E1dxQfVob352za6w: folds 
qllppsCmUqovlriIWCeM/g: calls $0.25
NzIFHwilc5zU7QhjDTgTZA: calls $0.25
6pF9LtHn+EH0ChbOXzox9g: folds 
9KPR3sZ+CxRm7bQ8qxFzMQ: calls $0.15
sEQx9G5Cu8k1HNdQasxvUA: checks 
*** FLOP *** [5h Td 6d]
9KPR3sZ+CxRm7bQ8qxFzMQ: checks 
sEQx9G5Cu8k1HNdQasxvUA: bets $1
qllppsCmUqovlriIWCeM/g: folds 
NzIFHwilc5zU7QhjDTgTZA: folds 
9KPR3sZ+CxRm7bQ8qxFzMQ: folds 
Uncalled bet ($1) returned to sEQx9G5Cu8k1HNdQasxvUA
sEQx9G5Cu8k1HNdQasxvUA collected $0.95 from pot
sEQx9G5Cu8k1HNdQasxvUA: doesn't show hand 
*** SUMMARY ***
Total pot $1 | Rake $0.05 
Board [5h Td 6d]
Seat 1: qllppsCmUqovlriIWCeM/g folded on the Flop
Seat 2: NzIFHwilc5zU7QhjDTgTZA folded on the Flop
Seat 3: 6pF9LtHn+EH0ChbOXzox9g (button) folded before Flop (didn't bet)
Seat 4: 9KPR3sZ+CxRm7bQ8qxFzMQ (small blind) folded on the Flop
Seat 5: sEQx9G5Cu8k1HNdQasxvUA (big blind) collected ($0.95)
Seat 6: Mch463E1dxQfVob352za6w folded before Flop (didn't bet)




PokerStars Game #59939675616:  Hold'em No Limit ($0.10/$0.25) - 2009/07/01 0:46:01 ET
Table 'rhQuIjJo0UQ7RRUlF9umHg' 6-max Seat #6 is the button
Seat 1: 5O3Hj9Qg0SqOyKEXoLpjPg ($52.50 in chips) 
Seat 2: Ew/TYPQIsbQ2X8nm5iAJBg ($51.50 in chips) 
Seat 4: buyjetgNT1McXtdaP4zynA ($24.70 in chips) 
Seat 5: 7qRk4YH4/k/08LgJSv7rBQ ($25.60 in chips) 
Seat 6: r284m4NA4rtNktI86R8/Yw ($12.05 in chips) 
5O3Hj9Qg0SqOyKEXoLpjPg: posts small blind $0.10
Ew/TYPQIsbQ2X8nm5iAJBg: posts big blind $0.25
*** HOLE CARDS ***
buyjetgNT1McXtdaP4zynA: calls $0.25
7qRk4YH4/k/08LgJSv7rBQ: raises $0.75 to $1
r284m4NA4rtNktI86R8/Yw: folds 
5O3Hj9Qg0SqOyKEXoLpjPg: calls $0.90
Ew/TYPQIsbQ2X8nm5iAJBg: folds 
buyjetgNT1McXtdaP4zynA: calls $0.75
*** FLOP *** [Jh Qd 6s]
5O3Hj9Qg0SqOyKEXoLpjPg: checks 
buyjetgNT1McXtdaP4zynA: bets $1.75
7qRk4YH4/k/08LgJSv7rBQ: folds 
5O3Hj9Qg0SqOyKEXoLpjPg: raises $1.75 to $3.50
buyjetgNT1McXtdaP4zynA: calls $1.75
*** TURN *** [Jh Qd 6s] [7s]
5O3Hj9Qg0SqOyKEXoLpjPg: bets $1.50
buyjetgNT1McXtdaP4zynA: calls $1.50
*** RIVER *** [Jh Qd 6s 7s] [8h]
5O3Hj9Qg0SqOyKEXoLpjPg: bets $3
nLE5Yo60EmSlJPyg0GgxXg has returned
buyjetgNT1McXtdaP4zynA: folds 
Uncalled bet ($3) returned to 5O3Hj9Qg0SqOyKEXoLpjPg
5O3Hj9Qg0SqOyKEXoLpjPg collected $12.65 from pot
5O3Hj9Qg0SqOyKEXoLpjPg: shows [6d 6h] (three of a kind, Sixes)
*** SUMMARY ***
Total pot $13.25 | Rake $0.60 
Board [Jh Qd 6s 7s 8h]
Seat 1: 5O3Hj9Qg0SqOyKEXoLpjPg (small blind) collected ($12.65)
Seat 2: Ew/TYPQIsbQ2X8nm5iAJBg (big blind) folded before Flop
Seat 4: buyjetgNT1McXtdaP4zynA folded on the River
Seat 5: 7qRk4YH4/k/08LgJSv7rBQ folded on the Flop
Seat 6: r284m4NA4rtNktI86R8/Yw (button) folded before Flop (didn't bet)




PokerStars Game #59939676086:  Hold'em No Limit ($0.10/$0.25) - 2009/07/01 0:46:01 ET
Table 'tANpk8z1C5o0Pq/hpYShHw' 9-max Seat #3 is the button
Seat 1: rQhYIYXSyH/IivYM1dlV5A ($23.15 in chips) 
Seat 2: og4yH4sZUZdC8jjgW8zPJQ ($9.65 in chips) 
Seat 3: zDrucyjVn5aeekNEc3cJrA ($20.25 in chips) 
Seat 4: dmQRblfPJL8cP867vJRZkg ($5.50 in chips) 
Seat 5: kWxV1qKcmWEussgWafGYNA ($50.35 in chips) 
Seat 8: sPhk0wImgnCyx4aYrPXnHA ($14.45 in chips) 
Seat 9: gE5rN2TDY1aXcZn/TOPeZw ($13.55 in chips) 
dmQRblfPJL8cP867vJRZkg: posts small blind $0.10
kWxV1qKcmWEussgWafGYNA: posts big blind $0.25
aNpwfA31EREwO+ar4XzBCw: sits out 
*** HOLE CARDS ***
sPhk0wImgnCyx4aYrPXnHA: calls $0.25
kN0AWJG6biW8tHtuF+wTjA joins the table at seat #6 
gE5rN2TDY1aXcZn/TOPeZw: folds 
rQhYIYXSyH/IivYM1dlV5A: folds 
og4yH4sZUZdC8jjgW8zPJQ: calls $0.25
zDrucyjVn5aeekNEc3cJrA: folds 
dmQRblfPJL8cP867vJRZkg: folds 
kWxV1qKcmWEussgWafGYNA: checks 
*** FLOP *** [Kh 7h Js]
kWxV1qKcmWEussgWafGYNA: checks 
sPhk0wImgnCyx4aYrPXnHA: checks 
og4yH4sZUZdC8jjgW8zPJQ: checks 
*** TURN *** [Kh 7h Js] [3d]
kWxV1qKcmWEussgWafGYNA: checks 
sPhk0wImgnCyx4aYrPXnHA: checks 
og4yH4sZUZdC8jjgW8zPJQ: checks 
*** RIVER *** [Kh 7h Js 3d] [Jh]
kWxV1qKcmWEussgWafGYNA: checks 
sPhk0wImgnCyx4aYrPXnHA: checks 
og4yH4sZUZdC8jjgW8zPJQ: bets $1.50
kWxV1qKcmWEussgWafGYNA: folds 
sPhk0wImgnCyx4aYrPXnHA: folds 
Uncalled bet ($1.50) returned to og4yH4sZUZdC8jjgW8zPJQ
og4yH4sZUZdC8jjgW8zPJQ collected $0.85 from pot
*** SUMMARY ***
Total pot $0.85 | Rake $0 
Board [Kh 7h Js 3d Jh]
Seat 1: rQhYIYXSyH/IivYM1dlV5A folded before Flop (didn't bet)
Seat 2: og4yH4sZUZdC8jjgW8zPJQ collected ($0.85)
Seat 3: zDrucyjVn5aeekNEc3cJrA (button) folded before Flop (didn't bet)
Seat 4: dmQRblfPJL8cP867vJRZkg (small blind) folded before Flop
Seat 5: kWxV1qKcmWEussgWafGYNA (big blind) folded on the River
Seat 8: sPhk0wImgnCyx4aYrPXnHA folded on the River
Seat 9: gE5rN2TDY1aXcZn/TOPeZw folded before Flop (didn't bet)




PokerStars Game #59939675826:  Hold'em No Limit ($0.10/$0.25) - 2009/07/01 0:46:01 ET
Table 'ONP9SkU1SytzTLuNlKzIPw' 9-max Seat #9 is the button
Seat 1: s7Q6uNouhe7aE8JdFb9E+A ($33.70 in chips) 
Seat 2: sJNHTWcSlLHRCZ9+YRLLqA ($25.50 in chips) 
Seat 3: 4BZw8NrbfRfUJKKKd1c2vA ($9.40 in chips) 
Seat 4: rKgOH+UzKBirOiqIwBD9Nw ($2.30 in chips) 
Seat 5: lSeLm4BdnSMLtIli62qjAQ ($3.90 in chips) 
Seat 6: 6X6eofOkuCCdkJdReOpjUQ ($26.05 in chips) 
Seat 7: DiSvPC2iudwL5j9u6Huyww ($25.85 in chips) 
Seat 8: sUVgUtgbfVx6JpvApozwhQ ($10.35 in chips) 
Seat 9: yyG4svzOpC1A+sUP/scg6w ($7.15 in chips) 
s7Q6uNouhe7aE8JdFb9E+A: posts small blind $0.10
sJNHTWcSlLHRCZ9+YRLLqA: posts big blind $0.25
*** HOLE CARDS ***
4BZw8NrbfRfUJKKKd1c2vA: folds 
rKgOH+UzKBirOiqIwBD9Nw: raises $0.25 to $0.50
lSeLm4BdnSMLtIli62qjAQ: folds 
6X6eofOkuCCdkJdReOpjUQ: folds 
DiSvPC2iudwL5j9u6Huyww: folds 
sUVgUtgbfVx6JpvApozwhQ: raises $9.85 to $10.35 and is all-in
yyG4svzOpC1A+sUP/scg6w: folds 
s7Q6uNouhe7aE8JdFb9E+A: folds 
sJNHTWcSlLHRCZ9+YRLLqA: folds 
rKgOH+UzKBirOiqIwBD9Nw: calls $1.80 and is all-in
Uncalled bet ($8.05) returned to sUVgUtgbfVx6JpvApozwhQ
*** FLOP *** [Kd 9d Qd]
*** TURN *** [Kd 9d Qd] [Qs]
*** RIVER *** [Kd 9d Qd Qs] [Kc]
*** SHOW DOWN ***
rKgOH+UzKBirOiqIwBD9Nw: shows [Ac 3d] (two pair, Kings and Queens)
sUVgUtgbfVx6JpvApozwhQ: shows [Qh Ah] (a full house, Queens full of Kings)
sUVgUtgbfVx6JpvApozwhQ collected $4.75 from pot
*** SUMMARY ***
Total pot $4.95 | Rake $0.20 
Board [Kd 9d Qd Qs Kc]
Seat 1: s7Q6uNouhe7aE8JdFb9E+A (small blind) folded before Flop
Seat 2: sJNHTWcSlLHRCZ9+YRLLqA (big blind) folded before Flop
Seat 3: 4BZw8NrbfRfUJKKKd1c2vA folded before Flop (didn't bet)
Seat 4: rKgOH+UzKBirOiqIwBD9Nw showed [Ac 3d] and lost with two pair, Kings and Queens
Seat 5: lSeLm4BdnSMLtIli62qjAQ folded before Flop (didn't bet)
Seat 6: 6X6eofOkuCCdkJdReOpjUQ folded before Flop (didn't bet)
Seat 7: DiSvPC2iudwL5j9u6Huyww folded before Flop (didn't bet)
Seat 8: sUVgUtgbfVx6JpvApozwhQ showed [Qh Ah] and won ($4.75) with a full house, Queens full of Kings
Seat 9: yyG4svzOpC1A+sUP/scg6w (button) folded before Flop (didn't bet)




PokerStars Game #59939676274:  Hold'em No Limit ($0.10/$0.25) - 2009/07/01 0:46:01 ET
Table 'YYMg5qzxK1m9eGRo4SbxtQ' 9-max Seat #3 is the button
Seat 1: DiSvPC2iudwL5j9u6Huyww ($25 in chips) 
Seat 2: uH1RN27w9SKa7TpVR9EFrQ ($15.25 in chips) 
Seat 3: N6fYvIzQLKaydFLKQGtMlQ ($23.70 in chips) 
Seat 4: H8sSXb2KLK0U38tU9YITDw ($10.10 in chips) 
Seat 5: BEIBUu2pIflPrCL+Iks4CQ ($19.30 in chips) 
Seat 6: gehe91e0IyVT0QU/XBkEyg ($41.60 in chips) 
Seat 7: hPhp/RE3cJ5YGaQ2xOHXXg ($5.45 in chips) 
Seat 8: 18G4P1XstjNvItdGUITxgw ($26.40 in chips) 
Seat 9: +sbyWwIcFp9kP0bDtMegfQ ($36.55 in chips) 
H8sSXb2KLK0U38tU9YITDw: posts small blind $0.10
BEIBUu2pIflPrCL+Iks4CQ: posts big blind $0.25
*** HOLE CARDS ***
gehe91e0IyVT0QU/XBkEyg: folds 
hPhp/RE3cJ5YGaQ2xOHXXg: folds 
18G4P1XstjNvItdGUITxgw: folds 
+sbyWwIcFp9kP0bDtMegfQ: folds 
DiSvPC2iudwL5j9u6Huyww: raises $0.50 to $0.75
uH1RN27w9SKa7TpVR9EFrQ: folds 
N6fYvIzQLKaydFLKQGtMlQ: folds 
H8sSXb2KLK0U38tU9YITDw: calls $0.65
BEIBUu2pIflPrCL+Iks4CQ: folds 
*** FLOP *** [7h 9c Jd]
H8sSXb2KLK0U38tU9YITDw: checks 
DiSvPC2iudwL5j9u6Huyww: checks 
*** TURN *** [7h 9c Jd] [Ad]
H8sSXb2KLK0U38tU9YITDw: bets $0.75
DiSvPC2iudwL5j9u6Huyww: folds 
Uncalled bet ($0.75) returned to H8sSXb2KLK0U38tU9YITDw
H8sSXb2KLK0U38tU9YITDw collected $1.70 from pot
H8sSXb2KLK0U38tU9YITDw: doesn't show hand 
*** SUMMARY ***
Total pot $1.75 | Rake $0.05 
Board [7h 9c Jd Ad]
Seat 1: DiSvPC2iudwL5j9u6Huyww folded on the Turn
Seat 2: uH1RN27w9SKa7TpVR9EFrQ folded before Flop (didn't bet)
Seat 3: N6fYvIzQLKaydFLKQGtMlQ (button) folded before Flop (didn't bet)
Seat 4: H8sSXb2KLK0U38tU9YITDw (small blind) collected ($1.70)
Seat 5: BEIBUu2pIflPrCL+Iks4CQ (big blind) folded before Flop
Seat 6: gehe91e0IyVT0QU/XBkEyg folded before Flop (didn't bet)
Seat 7: hPhp/RE3cJ5YGaQ2xOHXXg folded before Flop (didn't bet)
Seat 8: 18G4P1XstjNvItdGUITxgw folded before Flop (didn't bet)
Seat 9: +sbyWwIcFp9kP0bDtMegfQ folded before Flop (didn't bet)




PokerStars Game #59939676898:  Hold'em No Limit ($0.10/$0.25) - 2009/07/01 0:46:02 ET
Table 'UVjmXTtsmlX1HxwwZ59akg' 9-max Seat #1 is the button
Seat 1: zDrucyjVn5aeekNEc3cJrA ($28.70 in chips) 
Seat 4: lesMFbAzECwhRvI2qQ9kkg ($4.85 in chips) 
zDrucyjVn5aeekNEc3cJrA: posts small blind $0.10
lesMFbAzECwhRvI2qQ9kkg: posts big blind $0.25
*** HOLE CARDS ***
zDrucyjVn5aeekNEc3cJrA: folds 
Uncalled bet ($0.15) returned to lesMFbAzECwhRvI2qQ9kkg
lesMFbAzECwhRvI2qQ9kkg collected $0.20 from pot
lesMFbAzECwhRvI2qQ9kkg: doesn't show hand 
*** SUMMARY ***
Total pot $0.20 | Rake $0 
Seat 1: zDrucyjVn5aeekNEc3cJrA (button) (small blind) folded before Flop
Seat 4: lesMFbAzECwhRvI2qQ9kkg (big blind) collected ($0.20)




PokerStars Game #59939676708:  Hold'em No Limit ($0.10/$0.25) - 2009/07/01 0:46:02 ET
Table 'u5gc8WdJbaPqEonQaM8rHA' 9-max Seat #1 is the button
Seat 1: rXm4QDVJt67H20lM6n6Z7Q ($5.80 in chips) 
Seat 4: 7Tiam59GaMYACH/my1qVuw ($24.75 in chips) 
Seat 5: 4y3ZJtAlW/aXjQX7SXyjrQ ($25.55 in chips) 
Seat 8: 9j9dK6T4bnFE4nxAg16ycg ($30.90 in chips) 
7Tiam59GaMYACH/my1qVuw: posts small blind $0.10
4y3ZJtAlW/aXjQX7SXyjrQ: posts big blind $0.25
*** HOLE CARDS ***
9j9dK6T4bnFE4nxAg16ycg: folds 
rXm4QDVJt67H20lM6n6Z7Q: calls $0.25
7Tiam59GaMYACH/my1qVuw: folds 
4y3ZJtAlW/aXjQX7SXyjrQ: checks 
*** FLOP *** [8s 6s 6d]
4y3ZJtAlW/aXjQX7SXyjrQ: checks 
r6hsffOo1iKmaPYKwAZmFw joins the table at seat #3 
rXm4QDVJt67H20lM6n6Z7Q: bets $0.50
4y3ZJtAlW/aXjQX7SXyjrQ: folds 
Uncalled bet ($0.50) returned to rXm4QDVJt67H20lM6n6Z7Q
rXm4QDVJt67H20lM6n6Z7Q collected $0.60 from pot
rXm4QDVJt67H20lM6n6Z7Q: doesn't show hand 
*** SUMMARY ***
Total pot $0.60 | Rake $0 
Board [8s 6s 6d]
Seat 1: rXm4QDVJt67H20lM6n6Z7Q (button) collected ($0.60)
Seat 4: 7Tiam59GaMYACH/my1qVuw (small blind) folded before Flop
Seat 5: 4y3ZJtAlW/aXjQX7SXyjrQ (big blind) folded on the Flop
Seat 8: 9j9dK6T4bnFE4nxAg16ycg folded before Flop (didn't bet)




PokerStars Game #59939676722:  Hold'em No Limit ($0.10/$0.25) - 2009/07/01 0:46:02 ET
Table 'nRFAYu63wZNzrz/OBgzFTw' 9-max Seat #5 is the button
Seat 1: N6fYvIzQLKaydFLKQGtMlQ ($23.90 in chips) 
Seat 2: hJ4uYjNmSZdjrKA8cjZqCA ($19.20 in chips) 
Seat 4: OiV1PWZ3IkN29JlmCcnTwQ ($5.15 in chips) 
Seat 5: vKdukiQ4ktU4yJ0Xx3MKnA ($29.50 in chips) 
Seat 6: DnDcAdn9P0zGovMERigpFA ($25.35 in chips) 
Seat 8: amHgC+Q9cpfD/2w2yUtNbw ($9.75 in chips) 
Seat 9: SXqVW4Q0evTUVZG6BbUNIA ($30.55 in chips) 
DnDcAdn9P0zGovMERigpFA: posts small blind $0.10
amHgC+Q9cpfD/2w2yUtNbw: posts big blind $0.25
W8cIfrCR+zA8pCNyIuHu8g: sits out 
*** HOLE CARDS ***
dtZ84flFEi4Q+SGrHMJRDQ joins the table at seat #7 
SXqVW4Q0evTUVZG6BbUNIA: folds 
N6fYvIzQLKaydFLKQGtMlQ: folds 
hJ4uYjNmSZdjrKA8cjZqCA: folds 
OiV1PWZ3IkN29JlmCcnTwQ: folds 
vKdukiQ4ktU4yJ0Xx3MKnA: raises $0.75 to $1
DnDcAdn9P0zGovMERigpFA: folds 
amHgC+Q9cpfD/2w2yUtNbw: folds 
Uncalled bet ($0.75) returned to vKdukiQ4ktU4yJ0Xx3MKnA
vKdukiQ4ktU4yJ0Xx3MKnA collected $0.60 from pot
vKdukiQ4ktU4yJ0Xx3MKnA: doesn't show hand 
*** SUMMARY ***
Total pot $0.60 | Rake $0 
Seat 1: N6fYvIzQLKaydFLKQGtMlQ folded before Flop (didn't bet)
Seat 2: hJ4uYjNmSZdjrKA8cjZqCA folded before Flop (didn't bet)
Seat 4: OiV1PWZ3IkN29JlmCcnTwQ folded before Flop (didn't bet)
Seat 5: vKdukiQ4ktU4yJ0Xx3MKnA (button) collected ($0.60)
Seat 6: DnDcAdn9P0zGovMERigpFA (small blind) folded before Flop
Seat 8: amHgC+Q9cpfD/2w2yUtNbw (big blind) folded before Flop
Seat 9: SXqVW4Q0evTUVZG6BbUNIA folded before Flop (didn't bet)




PokerStars Game #59939676460:  Hold'em No Limit ($0.10/$0.25) - 2009/07/01 0:46:02 ET
Table 'wPWRBZPJl1HAnysw7qRR0A' 6-max Seat #1 is the button
Seat 1: cPO/1/dTcZpLkQFm3jH3Rg ($49.25 in chips) 
Seat 2: 48oT5xFI+5CHUJlfoGrE4w ($7.45 in chips) 
Seat 3: gqW2aBCmrIw65BvwjTFN6Q ($27.15 in chips) 
Seat 4: kbpWbC+dJNBphHl1jtw7bw ($28.65 in chips) 
Seat 5: LtASJ9OlkqGrrUKGQlpGAw ($21.20 in chips) 
Seat 6: VLoE/jniCqHZuUkx8Esf6w ($24.80 in chips) 
48oT5xFI+5CHUJlfoGrE4w: posts small blind $0.10
gqW2aBCmrIw65BvwjTFN6Q: posts big blind $0.25
*** HOLE CARDS ***
kbpWbC+dJNBphHl1jtw7bw: folds 
LtASJ9OlkqGrrUKGQlpGAw: calls $0.25
VLoE/jniCqHZuUkx8Esf6w: folds 
cPO/1/dTcZpLkQFm3jH3Rg: folds 
48oT5xFI+5CHUJlfoGrE4w: calls $0.15
gqW2aBCmrIw65BvwjTFN6Q: checks 
*** FLOP *** [2h Kc As]
48oT5xFI+5CHUJlfoGrE4w: bets $0.75
gqW2aBCmrIw65BvwjTFN6Q: folds 
LtASJ9OlkqGrrUKGQlpGAw: folds 
Uncalled bet ($0.75) returned to 48oT5xFI+5CHUJlfoGrE4w
48oT5xFI+5CHUJlfoGrE4w collected $0.75 from pot
48oT5xFI+5CHUJlfoGrE4w: doesn't show hand 
*** SUMMARY ***
Total pot $0.75 | Rake $0 
Board [2h Kc As]
Seat 1: cPO/1/dTcZpLkQFm3jH3Rg (button) folded before Flop (didn't bet)
Seat 2: 48oT5xFI+5CHUJlfoGrE4w (small blind) collected ($0.75)
Seat 3: gqW2aBCmrIw65BvwjTFN6Q (big blind) folded on the Flop
Seat 4: kbpWbC+dJNBphHl1jtw7bw folded before Flop (didn't bet)
Seat 5: LtASJ9OlkqGrrUKGQlpGAw folded on the Flop
Seat 6: VLoE/jniCqHZuUkx8Esf6w folded before Flop (didn't bet)




PokerStars Game #59939677112:  Hold'em No Limit ($0.10/$0.25) - 2009/07/01 0:46:03 ET
Table 'qryc9C/ELyQ3lubOaELNAQ' 6-max Seat #3 is the button
Seat 1: OZc6kkoTwtITj1ZfreJK1A ($24.35 in chips) 
Seat 2: qvQc9BHp2FhQjrltLiBN+w ($12.90 in chips) 
Seat 3: UXRtG8J9PoBZWTsNtqdoDA ($21.05 in chips) 
Seat 4: v+QfkGiuj9bgtuNoVnDO8w ($28.75 in chips) 
Seat 5: pV5UZbjsgam+HUQEd6G++w ($11.75 in chips) 
Seat 6: t2RfOOoa56xW0ZHJC0+5JQ ($8.10 in chips) 
v+QfkGiuj9bgtuNoVnDO8w: posts small blind $0.10
pV5UZbjsgam+HUQEd6G++w: posts big blind $0.25
*** HOLE CARDS ***
t2RfOOoa56xW0ZHJC0+5JQ: folds 
OZc6kkoTwtITj1ZfreJK1A: calls $0.25
t2RfOOoa56xW0ZHJC0+5JQ leaves the table
qvQc9BHp2FhQjrltLiBN+w: calls $0.25
UXRtG8J9PoBZWTsNtqdoDA: folds 
v+QfkGiuj9bgtuNoVnDO8w: folds 
pV5UZbjsgam+HUQEd6G++w: checks 
*** FLOP *** [7d Kh 2d]
WrLI51S2iMb8GLMB83gGqA joins the table at seat #6 
pV5UZbjsgam+HUQEd6G++w: checks 
OZc6kkoTwtITj1ZfreJK1A: bets $0.25
qvQc9BHp2FhQjrltLiBN+w: calls $0.25
pV5UZbjsgam+HUQEd6G++w: folds 
*** TURN *** [7d Kh 2d] [8d]
OZc6kkoTwtITj1ZfreJK1A: bets $0.75
qvQc9BHp2FhQjrltLiBN+w: calls $0.75
*** RIVER *** [7d Kh 2d 8d] [9d]
OZc6kkoTwtITj1ZfreJK1A: bets $5.25
qvQc9BHp2FhQjrltLiBN+w: folds 
Uncalled bet ($5.25) returned to OZc6kkoTwtITj1ZfreJK1A
OZc6kkoTwtITj1ZfreJK1A collected $2.75 from pot
OZc6kkoTwtITj1ZfreJK1A: doesn't show hand 
*** SUMMARY ***
Total pot $2.85 | Rake $0.10 
Board [7d Kh 2d 8d 9d]
Seat 1: OZc6kkoTwtITj1ZfreJK1A collected ($2.75)
Seat 2: qvQc9BHp2FhQjrltLiBN+w folded on the River
Seat 3: UXRtG8J9PoBZWTsNtqdoDA (button) folded before Flop (didn't bet)
Seat 4: v+QfkGiuj9bgtuNoVnDO8w (small blind) folded before Flop
Seat 5: pV5UZbjsgam+HUQEd6G++w (big blind) folded on the Flop
Seat 6: t2RfOOoa56xW0ZHJC0+5JQ folded before Flop (didn't bet)




PokerStars Game #59939677072:  Hold'em No Limit ($0.10/$0.25) - 2009/07/01 0:46:03 ET
Table 'sgdCtiuCu2BDZhyDi6RzTA' 6-max Seat #4 is the button
Seat 1: 3zD3qLXT1bEffAoWGnc7wg ($28.85 in chips) 
Seat 2: R7AqtFtjtvane2IbChcU+w ($14.75 in chips) 
Seat 3: yzFNNFIfC89bBPwpFPx2ow ($16.50 in chips) 
Seat 4: rVKEgilmMX+EkKzDVvhmxA ($5.90 in chips) 
Seat 5: kD/Cb2UM93FAVgDMhEEb5g ($10.25 in chips) 
Seat 6: KODslGU8ikCYS0/29dUkhg ($7.70 in chips) 
kD/Cb2UM93FAVgDMhEEb5g: posts small blind $0.10
KODslGU8ikCYS0/29dUkhg: posts big blind $0.25
*** HOLE CARDS ***
3zD3qLXT1bEffAoWGnc7wg: folds 
R7AqtFtjtvane2IbChcU+w: folds 
yzFNNFIfC89bBPwpFPx2ow: folds 
rVKEgilmMX+EkKzDVvhmxA: folds 
kD/Cb2UM93FAVgDMhEEb5g: raises $0.50 to $0.75
KODslGU8ikCYS0/29dUkhg: calls $0.50
*** FLOP *** [Qs As Qc]
kD/Cb2UM93FAVgDMhEEb5g: bets $0.75
KODslGU8ikCYS0/29dUkhg: calls $0.75
*** TURN *** [Qs As Qc] [7c]
kD/Cb2UM93FAVgDMhEEb5g: bets $1
KODslGU8ikCYS0/29dUkhg: calls $1
*** RIVER *** [Qs As Qc 7c] [7s]
kD/Cb2UM93FAVgDMhEEb5g: bets $1.25
KODslGU8ikCYS0/29dUkhg: calls $1.25
*** SHOW DOWN ***
kD/Cb2UM93FAVgDMhEEb5g: shows [Th Tc] (two pair, Queens and Tens)
KODslGU8ikCYS0/29dUkhg: shows [Ac 2c] (two pair, Aces and Queens)
KODslGU8ikCYS0/29dUkhg collected $7.15 from pot
*** SUMMARY ***
Total pot $7.50 | Rake $0.35 
Board [Qs As Qc 7c 7s]
Seat 1: 3zD3qLXT1bEffAoWGnc7wg folded before Flop (didn't bet)
Seat 2: R7AqtFtjtvane2IbChcU+w folded before Flop (didn't bet)
Seat 3: yzFNNFIfC89bBPwpFPx2ow folded before Flop (didn't bet)
Seat 4: rVKEgilmMX+EkKzDVvhmxA (button) folded before Flop (didn't bet)
Seat 5: kD/Cb2UM93FAVgDMhEEb5g (small blind) showed [Th Tc] and lost with two pair, Queens and Tens
Seat 6: KODslGU8ikCYS0/29dUkhg (big blind) showed [Ac 2c] and won ($7.15) with two pair, Aces and Queens




PokerStars Game #59939677462:  Hold'em No Limit ($0.10/$0.25) - 2009/07/01 0:46:03 ET
Table 'fvoGXKLawfAadYn02raohg' 9-max Seat #4 is the button
Seat 1: DIBbjEYGs+TVdVgEB/4+3w ($39.50 in chips) 
Seat 2: Ud3KoJmky17jahFh5jxdNA ($13.20 in chips) 
Seat 3: aNpwfA31EREwO+ar4XzBCw ($31.35 in chips) 
Seat 4: uibjYTUZq0zsChpZ84TeGQ ($14.45 in chips) 
Seat 5: +2kMBNpY4nF1qNCRd8SJLA ($25 in chips) 
Seat 7: 18G4P1XstjNvItdGUITxgw ($25.45 in chips) 
Seat 8: 4GJMmHGKzu+gVtalqRy7dA ($12.85 in chips) 
+2kMBNpY4nF1qNCRd8SJLA: posts small blind $0.10
SXqVW4Q0evTUVZG6BbUNIA: is sitting out 
18G4P1XstjNvItdGUITxgw: posts big blind $0.25
*** HOLE CARDS ***
SXqVW4Q0evTUVZG6BbUNIA leaves the table
F7pnn6czNpHvRM55XcA2EA joins the table at seat #9 
4GJMmHGKzu+gVtalqRy7dA: folds 
Th3FldXKQW6hWVVPahaoOQ joins the table at seat #6 
DIBbjEYGs+TVdVgEB/4+3w: folds 
Ud3KoJmky17jahFh5jxdNA: folds 
aNpwfA31EREwO+ar4XzBCw: folds 
uibjYTUZq0zsChpZ84TeGQ: calls $0.25
+2kMBNpY4nF1qNCRd8SJLA: calls $0.15
18G4P1XstjNvItdGUITxgw: checks 
*** FLOP *** [Ah Qc Jd]
+2kMBNpY4nF1qNCRd8SJLA: checks 
18G4P1XstjNvItdGUITxgw: checks 
uibjYTUZq0zsChpZ84TeGQ: checks 
*** TURN *** [Ah Qc Jd] [2d]
+2kMBNpY4nF1qNCRd8SJLA: checks 
18G4P1XstjNvItdGUITxgw: checks 
uibjYTUZq0zsChpZ84TeGQ: bets $1.25
+2kMBNpY4nF1qNCRd8SJLA: folds 
18G4P1XstjNvItdGUITxgw: folds 
Uncalled bet ($1.25) returned to uibjYTUZq0zsChpZ84TeGQ
uibjYTUZq0zsChpZ84TeGQ collected $0.75 from pot
uibjYTUZq0zsChpZ84TeGQ: doesn't show hand 
*** SUMMARY ***
Total pot $0.75 | Rake $0 
Board [Ah Qc Jd 2d]
Seat 1: DIBbjEYGs+TVdVgEB/4+3w folded before Flop (didn't bet)
Seat 2: Ud3KoJmky17jahFh5jxdNA folded before Flop (didn't bet)
Seat 3: aNpwfA31EREwO+ar4XzBCw folded before Flop (didn't bet)
Seat 4: uibjYTUZq0zsChpZ84TeGQ (button) collected ($0.75)
Seat 5: +2kMBNpY4nF1qNCRd8SJLA (small blind) folded on the Turn
Seat 7: 18G4P1XstjNvItdGUITxgw (big blind) folded on the Turn
Seat 8: 4GJMmHGKzu+gVtalqRy7dA folded before Flop (didn't bet)




PokerStars Game #59939677452:  Hold'em No Limit ($0.10/$0.25) - 2009/07/01 0:46:03 ET
Table 'Ok3oDLIsTc2+KxPcI0bAOA' 6-max Seat #3 is the button
Seat 1: agQm3ugZ3qSVYNgNu1ddeA ($26.90 in chips) 
Seat 2: oseFhpinoe+Zg4j5xyBjyQ ($30.80 in chips) 
Seat 3: I1TxPvWj8NfG8orglCinNA ($25 in chips) 
Seat 5: nc79pm0LZRdhncq55evVqA ($27.90 in chips) 
Seat 6: JFIAqU8lCZ0vWwEl4bdGsg ($42.65 in chips) 
nc79pm0LZRdhncq55evVqA: posts small blind $0.10
JFIAqU8lCZ0vWwEl4bdGsg: posts big blind $0.25
*** HOLE CARDS ***
agQm3ugZ3qSVYNgNu1ddeA: folds 
oseFhpinoe+Zg4j5xyBjyQ: raises $0.25 to $0.50
I1TxPvWj8NfG8orglCinNA: folds 
nc79pm0LZRdhncq55evVqA: folds 
JFIAqU8lCZ0vWwEl4bdGsg: calls $0.25
*** FLOP *** [3d 4d Ks]
AelnLvAynaZZ+KfVuqHhag joins the table at seat #4 
JFIAqU8lCZ0vWwEl4bdGsg: checks 
oseFhpinoe+Zg4j5xyBjyQ: bets $0.75
JFIAqU8lCZ0vWwEl4bdGsg: folds 
Uncalled bet ($0.75) returned to oseFhpinoe+Zg4j5xyBjyQ
oseFhpinoe+Zg4j5xyBjyQ collected $1.05 from pot
oseFhpinoe+Zg4j5xyBjyQ: doesn't show hand 
*** SUMMARY ***
Total pot $1.10 | Rake $0.05 
Board [3d 4d Ks]
Seat 1: agQm3ugZ3qSVYNgNu1ddeA folded before Flop (didn't bet)
Seat 2: oseFhpinoe+Zg4j5xyBjyQ collected ($1.05)
Seat 3: I1TxPvWj8NfG8orglCinNA (button) folded before Flop (didn't bet)
Seat 5: nc79pm0LZRdhncq55evVqA (small blind) folded before Flop
Seat 6: JFIAqU8lCZ0vWwEl4bdGsg (big blind) folded on the Flop




PokerStars Game #59939677642:  Hold'em No Limit ($0.10/$0.25) - 2009/07/01 0:46:04 ET
Table '9SExUHslNkrPJ4XsrePaVw' 9-max Seat #9 is the button
Seat 1: qpbN+BUWX0f/ckQSmOcmkw ($7.50 in chips) 
Seat 3: jeKWRUkMaVn8rEUjnJKqpg ($31.90 in chips) 
Seat 4: dyNjB7p93gTjZ0RXn2HnJA ($21.50 in chips) 
Seat 6: DYB0aP91n+Rg/TIhycbaPQ ($7.45 in chips) 
Seat 7: 7cv+9Zc9HIQHNvYsMfV3uA ($25 in chips) 
Seat 8: t2nb95S5EEFOEzNx9Itz0g ($7.80 in chips) 
Seat 9: /THNzAxdv2lBxcf4XTj/0g ($15.10 in chips) 
qpbN+BUWX0f/ckQSmOcmkw: posts small blind $0.10
ie4EwTMMFYxrCXcenJdzsw: is sitting out 
jeKWRUkMaVn8rEUjnJKqpg: posts big blind $0.25
ydoFOVgzvZv9ZhuWu9rXAw: sits out 
*** HOLE CARDS ***
dyNjB7p93gTjZ0RXn2HnJA: folds 
DYB0aP91n+Rg/TIhycbaPQ: calls $0.25
7cv+9Zc9HIQHNvYsMfV3uA: folds 
t2nb95S5EEFOEzNx9Itz0g: folds 
/THNzAxdv2lBxcf4XTj/0g: folds 
qpbN+BUWX0f/ckQSmOcmkw: calls $0.15
jeKWRUkMaVn8rEUjnJKqpg: checks 
*** FLOP *** [2c 5h 7c]
qpbN+BUWX0f/ckQSmOcmkw: checks 
jeKWRUkMaVn8rEUjnJKqpg: checks 
DYB0aP91n+Rg/TIhycbaPQ: bets $0.25
qpbN+BUWX0f/ckQSmOcmkw: folds 
jeKWRUkMaVn8rEUjnJKqpg: folds 
Uncalled bet ($0.25) returned to DYB0aP91n+Rg/TIhycbaPQ
DYB0aP91n+Rg/TIhycbaPQ collected $0.75 from pot
DYB0aP91n+Rg/TIhycbaPQ: doesn't show hand 
*** SUMMARY ***
Total pot $0.75 | Rake $0 
Board [2c 5h 7c]
Seat 1: qpbN+BUWX0f/ckQSmOcmkw (small blind) folded on the Flop
Seat 3: jeKWRUkMaVn8rEUjnJKqpg (big blind) folded on the Flop
Seat 4: dyNjB7p93gTjZ0RXn2HnJA folded before Flop (didn't bet)
Seat 6: DYB0aP91n+Rg/TIhycbaPQ collected ($0.75)
Seat 7: 7cv+9Zc9HIQHNvYsMfV3uA folded before Flop (didn't bet)
Seat 8: t2nb95S5EEFOEzNx9Itz0g folded before Flop (didn't bet)
Seat 9: /THNzAxdv2lBxcf4XTj/0g (button) folded before Flop (didn't bet)




PokerStars Game #59939677774:  Hold'em No Limit ($0.10/$0.25) - 2009/07/01 0:46:04 ET
Table 'TJS4XvvOjO3k7mH74HJw5g' 9-max Seat #7 is the button
Seat 1: SS+d2ix02WTTacMsjCk0OQ ($32.10 in chips) 
Seat 2: ghNKXUBl/H+t83JF079ZBA ($25 in chips) 
Seat 3: 8B/dhbQjIWe6ASCdgzktNQ ($34.55 in chips) 
Seat 5: NNZypfH1f/VIj3Skf/XIzg ($4.30 in chips) 
Seat 7: DiSvPC2iudwL5j9u6Huyww ($25 in chips) 
Seat 8: l9TiQshP7QOsNH6jZrL4Wg ($6.85 in chips) 
Seat 9: +sbyWwIcFp9kP0bDtMegfQ ($32.25 in chips) 
l9TiQshP7QOsNH6jZrL4Wg: posts small blind $0.10
+sbyWwIcFp9kP0bDtMegfQ: posts big blind $0.25
qwr38jl5txoR36M7G5qi4A joins the table at seat #4 
DnDcAdn9P0zGovMERigpFA: sits out 
*** HOLE CARDS ***
SS+d2ix02WTTacMsjCk0OQ: folds 
ghNKXUBl/H+t83JF079ZBA: folds 
8B/dhbQjIWe6ASCdgzktNQ: raises $0.75 to $1
NNZypfH1f/VIj3Skf/XIzg: folds 
DiSvPC2iudwL5j9u6Huyww: folds 
l9TiQshP7QOsNH6jZrL4Wg: calls $0.90
+sbyWwIcFp9kP0bDtMegfQ: folds 
*** FLOP *** [2c 9d Td]
l9TiQshP7QOsNH6jZrL4Wg: checks 
8B/dhbQjIWe6ASCdgzktNQ: bets $2.25
l9TiQshP7QOsNH6jZrL4Wg: folds 
Uncalled bet ($2.25) returned to 8B/dhbQjIWe6ASCdgzktNQ
8B/dhbQjIWe6ASCdgzktNQ collected $2.15 from pot
8B/dhbQjIWe6ASCdgzktNQ: doesn't show hand 
*** SUMMARY ***
Total pot $2.25 | Rake $0.10 
Board [2c 9d Td]
Seat 1: SS+d2ix02WTTacMsjCk0OQ folded before Flop (didn't bet)
Seat 2: ghNKXUBl/H+t83JF079ZBA folded before Flop (didn't bet)
Seat 3: 8B/dhbQjIWe6ASCdgzktNQ collected ($2.15)
Seat 5: NNZypfH1f/VIj3Skf/XIzg folded before Flop (didn't bet)
Seat 7: DiSvPC2iudwL5j9u6Huyww (button) folded before Flop (didn't bet)
Seat 8: l9TiQshP7QOsNH6jZrL4Wg (small blind) folded on the Flop
Seat 9: +sbyWwIcFp9kP0bDtMegfQ (big blind) folded before Flop




PokerStars Game #59939677616:  Hold'em No Limit ($0.10/$0.25) - 2009/07/01 0:46:04 ET
Table 'Do4nrTNDYpK3sQjwFxX+Og' 6-max Seat #5 is the button
Seat 1: 7JrQNOR9wRBxq9ijFhWieg ($30.45 in chips) 
Seat 2: tzMoGl9F0PUr5NibYueeSw ($44.40 in chips) 
Seat 3: TSmua8tGK3sTbwi0ynrW9Q ($32.80 in chips) 
Seat 4: df7bIV965hvGEDiUAs5cfQ ($14 in chips) 
Seat 5: Ew/TYPQIsbQ2X8nm5iAJBg ($30.80 in chips) 
Seat 6: eHsmIvAb2JREg4O6hNPnXg ($20.95 in chips) 
eHsmIvAb2JREg4O6hNPnXg: posts small blind $0.10
7JrQNOR9wRBxq9ijFhWieg: posts big blind $0.25
*** HOLE CARDS ***
tzMoGl9F0PUr5NibYueeSw: folds 
TSmua8tGK3sTbwi0ynrW9Q: folds 
df7bIV965hvGEDiUAs5cfQ: folds 
Ew/TYPQIsbQ2X8nm5iAJBg: folds 
eHsmIvAb2JREg4O6hNPnXg: raises $0.50 to $0.75
7JrQNOR9wRBxq9ijFhWieg: calls $0.50
*** FLOP *** [5c Ks Qc]
eHsmIvAb2JREg4O6hNPnXg: bets $1.50
7JrQNOR9wRBxq9ijFhWieg: folds 
Uncalled bet ($1.50) returned to eHsmIvAb2JREg4O6hNPnXg
eHsmIvAb2JREg4O6hNPnXg collected $1.45 from pot
*** SUMMARY ***
Total pot $1.50 | Rake $0.05 
Board [5c Ks Qc]
Seat 1: 7JrQNOR9wRBxq9ijFhWieg (big blind) folded on the Flop
Seat 2: tzMoGl9F0PUr5NibYueeSw folded before Flop (didn't bet)
Seat 3: TSmua8tGK3sTbwi0ynrW9Q folded before Flop (didn't bet)
Seat 4: df7bIV965hvGEDiUAs5cfQ folded before Flop (didn't bet)
Seat 5: Ew/TYPQIsbQ2X8nm5iAJBg (button) folded before Flop (didn't bet)
Seat 6: eHsmIvAb2JREg4O6hNPnXg (small blind) collected ($1.45)




PokerStars Game #59939678162:  Hold'em No Limit ($0.10/$0.25) - 2009/07/01 0:46:04 ET
Table 'B3/JTS7usG3rxMfTbMiZuw' 6-max Seat #5 is the button
Seat 1: wAKC8C/zN0c8V5v13dm9mA ($32.10 in chips) 
Seat 2: 2gqWqkOq59pvtJKe4nS+rw ($22.65 in chips) 
Seat 3: PbMzPZIePKifKQZfKDkbIw ($25 in chips) 
Seat 4: kPCKvyB1yAABEgvF7OaG0g ($23.65 in chips) 
Seat 5: NhUN/JpAprdJeamFBgJH1w ($28.90 in chips) 
Seat 6: 6DwBRH+xZ12AAZmeAg+aXw ($25.10 in chips) 
6DwBRH+xZ12AAZmeAg+aXw: posts small blind $0.10
wAKC8C/zN0c8V5v13dm9mA: posts big blind $0.25
*** HOLE CARDS ***
2gqWqkOq59pvtJKe4nS+rw: folds 
PbMzPZIePKifKQZfKDkbIw: raises $0.75 to $1
kPCKvyB1yAABEgvF7OaG0g: folds 
NhUN/JpAprdJeamFBgJH1w: folds 
6DwBRH+xZ12AAZmeAg+aXw: folds 
wAKC8C/zN0c8V5v13dm9mA: folds 
Uncalled bet ($0.75) returned to PbMzPZIePKifKQZfKDkbIw
PbMzPZIePKifKQZfKDkbIw collected $0.60 from pot
*** SUMMARY ***
Total pot $0.60 | Rake $0 
Seat 1: wAKC8C/zN0c8V5v13dm9mA (big blind) folded before Flop
Seat 2: 2gqWqkOq59pvtJKe4nS+rw folded before Flop (didn't bet)
Seat 3: PbMzPZIePKifKQZfKDkbIw collected ($0.60)
Seat 4: kPCKvyB1yAABEgvF7OaG0g folded before Flop (didn't bet)
Seat 5: NhUN/JpAprdJeamFBgJH1w (button) folded before Flop (didn't bet)
Seat 6: 6DwBRH+xZ12AAZmeAg+aXw (small blind) folded before Flop




PokerStars Game #59939677660:  Hold'em No Limit ($0.10/$0.25) - 2009/07/01 0:46:04 ET
Table 'IUwZ/e0bDHZPgsIWx0RnNg' 6-max Seat #4 is the button
Seat 1: 8JTm/CXBn3+kuQgcUOgPkw ($24.75 in chips) 
Seat 2: mvFHK3pE7tCxJEqLjKC70Q ($30.35 in chips) 
Seat 3: dOX4wnYV2sEqvDbF+8KSCw ($25.35 in chips) 
Seat 4: IyZ9SVxKy7TJvRGFneWTMg ($29.65 in chips) 
Seat 5: wsP46AGpqDjHZQmlRHKa9g ($25.25 in chips) 
Seat 6: NhUN/JpAprdJeamFBgJH1w ($25 in chips) 
wsP46AGpqDjHZQmlRHKa9g: posts small blind $0.10
NhUN/JpAprdJeamFBgJH1w: posts big blind $0.25
*** HOLE CARDS ***
8JTm/CXBn3+kuQgcUOgPkw: folds 
mvFHK3pE7tCxJEqLjKC70Q: folds 
dOX4wnYV2sEqvDbF+8KSCw: raises $0.75 to $1
IyZ9SVxKy7TJvRGFneWTMg: folds 
wsP46AGpqDjHZQmlRHKa9g: folds 
NhUN/JpAprdJeamFBgJH1w: folds 
Uncalled bet ($0.75) returned to dOX4wnYV2sEqvDbF+8KSCw
dOX4wnYV2sEqvDbF+8KSCw collected $0.60 from pot
dOX4wnYV2sEqvDbF+8KSCw: doesn't show hand 
*** SUMMARY ***
Total pot $0.60 | Rake $0 
Seat 1: 8JTm/CXBn3+kuQgcUOgPkw folded before Flop (didn't bet)
Seat 2: mvFHK3pE7tCxJEqLjKC70Q folded before Flop (didn't bet)
Seat 3: dOX4wnYV2sEqvDbF+8KSCw collected ($0.60)
Seat 4: IyZ9SVxKy7TJvRGFneWTMg (button) folded before Flop (didn't bet)
Seat 5: wsP46AGpqDjHZQmlRHKa9g (small blind) folded before Flop
Seat 6: NhUN/JpAprdJeamFBgJH1w (big blind) folded before Flop




PokerStars Game #59939677950:  Hold'em No Limit ($0.10/$0.25) - 2009/07/01 0:46:04 ET
Table '4XGDnEByOol5up4aB2KbJw' 6-max Seat #5 is the button
Seat 1: kyRaCIljYA6l33lSKQfNsg ($26.85 in chips) 
Seat 2: SFmT9ZsVopnukjvAzrxTRg ($34.10 in chips) 
Seat 3: LtASJ9OlkqGrrUKGQlpGAw ($22.90 in chips) 
Seat 4: sjoibHX/s93+8Kwa5aB1dA ($27.50 in chips) 
Seat 5: Dh01+rohD2p9pXLYeBlC5Q ($17.80 in chips) 
Seat 6: ELW+DKizJhLK7k40PMkD2Q ($32.60 in chips) 
ELW+DKizJhLK7k40PMkD2Q: posts small blind $0.10
kyRaCIljYA6l33lSKQfNsg: posts big blind $0.25
sjoibHX/s93+8Kwa5aB1dA: posts small & big blinds $0.35
*** HOLE CARDS ***
SFmT9ZsVopnukjvAzrxTRg: folds 
LtASJ9OlkqGrrUKGQlpGAw: folds 
sjoibHX/s93+8Kwa5aB1dA: checks 
Dh01+rohD2p9pXLYeBlC5Q: calls $0.25
ELW+DKizJhLK7k40PMkD2Q: folds 
kyRaCIljYA6l33lSKQfNsg: checks 
*** FLOP *** [2d Kc Ac]
kyRaCIljYA6l33lSKQfNsg: checks 
sjoibHX/s93+8Kwa5aB1dA: checks 
Dh01+rohD2p9pXLYeBlC5Q: checks 
*** TURN *** [2d Kc Ac] [Ts]
kyRaCIljYA6l33lSKQfNsg: checks 
sjoibHX/s93+8Kwa5aB1dA: bets $0.50
Dh01+rohD2p9pXLYeBlC5Q: folds 
kyRaCIljYA6l33lSKQfNsg: folds 
Uncalled bet ($0.50) returned to sjoibHX/s93+8Kwa5aB1dA
sjoibHX/s93+8Kwa5aB1dA collected $0.95 from pot
sjoibHX/s93+8Kwa5aB1dA: doesn't show hand 
*** SUMMARY ***
Total pot $0.95 | Rake $0 
Board [2d Kc Ac Ts]
Seat 1: kyRaCIljYA6l33lSKQfNsg (big blind) folded on the Turn
Seat 2: SFmT9ZsVopnukjvAzrxTRg folded before Flop (didn't bet)
Seat 3: LtASJ9OlkqGrrUKGQlpGAw folded before Flop (didn't bet)
Seat 4: sjoibHX/s93+8Kwa5aB1dA collected ($0.95)
Seat 5: Dh01+rohD2p9pXLYeBlC5Q (button) folded on the Turn
Seat 6: ELW+DKizJhLK7k40PMkD2Q (small blind) folded before Flop




PokerStars Game #59939677850:  Hold'em No Limit ($0.10/$0.25) - 2009/07/01 0:46:04 ET
Table 'C8mMnVmvkagwolEzTvh07A' 9-max Seat #4 is the button
Seat 1: t2nb95S5EEFOEzNx9Itz0g ($6.70 in chips) 
Seat 2: CbXUS6Z2rXZxL1AKduNtmQ ($30.10 in chips) 
Seat 3: Th3FldXKQW6hWVVPahaoOQ ($25 in chips) 
Seat 4: dfNim92Z6XK1/h5SFW5vDg ($25 in chips) 
Seat 5: iGMlK+EhUflPB6jKQd95Cg ($25.50 in chips) 
Seat 7: qmEgnPhQt24xdw/ZRVPLbA ($34.40 in chips) 
Seat 8: N6fYvIzQLKaydFLKQGtMlQ ($22.55 in chips) 
Seat 9: 4awUyiDYTgylQKXZ9faBVA ($25 in chips) 
iGMlK+EhUflPB6jKQd95Cg: posts small blind $0.10
qmEgnPhQt24xdw/ZRVPLbA: posts big blind $0.25
*** HOLE CARDS ***
N6fYvIzQLKaydFLKQGtMlQ: folds 
4awUyiDYTgylQKXZ9faBVA: folds 
t2nb95S5EEFOEzNx9Itz0g: raises $0.50 to $0.75
CbXUS6Z2rXZxL1AKduNtmQ: folds 
Th3FldXKQW6hWVVPahaoOQ: folds 
dfNim92Z6XK1/h5SFW5vDg: folds 
iGMlK+EhUflPB6jKQd95Cg: folds 
qmEgnPhQt24xdw/ZRVPLbA: calls $0.50
*** FLOP *** [3d 8c Qh]
qmEgnPhQt24xdw/ZRVPLbA: bets $1
t2nb95S5EEFOEzNx9Itz0g: raises $4.95 to $5.95 and is all-in
qmEgnPhQt24xdw/ZRVPLbA: folds 
Uncalled bet ($4.95) returned to t2nb95S5EEFOEzNx9Itz0g
t2nb95S5EEFOEzNx9Itz0g collected $3.45 from pot
t2nb95S5EEFOEzNx9Itz0g: doesn't show hand 
*** SUMMARY ***
Total pot $3.60 | Rake $0.15 
Board [3d 8c Qh]
Seat 1: t2nb95S5EEFOEzNx9Itz0g collected ($3.45)
Seat 2: CbXUS6Z2rXZxL1AKduNtmQ folded before Flop (didn't bet)
Seat 3: Th3FldXKQW6hWVVPahaoOQ folded before Flop (didn't bet)
Seat 4: dfNim92Z6XK1/h5SFW5vDg (button) folded before Flop (didn't bet)
Seat 5: iGMlK+EhUflPB6jKQd95Cg (small blind) folded before Flop
Seat 7: qmEgnPhQt24xdw/ZRVPLbA (big blind) folded on the Flop
Seat 8: N6fYvIzQLKaydFLKQGtMlQ folded before Flop (didn't bet)
Seat 9: 4awUyiDYTgylQKXZ9faBVA folded before Flop (didn't bet)




PokerStars Game #59939678024:  Hold'em No Limit ($0.10/$0.25) - 2009/07/01 0:46:04 ET
Table 'GrYi0DZOHD1EvB+qiLExNw' 9-max Seat #9 is the button
Seat 1: 4awUyiDYTgylQKXZ9faBVA ($25.10 in chips) 
Seat 2: Th3FldXKQW6hWVVPahaoOQ ($27.45 in chips) 
Seat 3: 4oA316mXLIui1QY63GXBUg ($25 in chips) 
Seat 4: 0GQg6tdDMBDzY6FKumSo9w ($48.10 in chips) 
Seat 5: cZ99hugmLBj9KhTlc8nCSw ($47.40 in chips) 
Seat 6: H9KUl8cmpLgEpOVDA00bCg ($4.20 in chips) 
Seat 7: 1Clf3cPrqoy/YgvWdWK1Xw ($5.35 in chips) 
Seat 8: nalbG/4/1Z1wQjRDWV7b2w ($8.40 in chips) 
Seat 9: OiV1PWZ3IkN29JlmCcnTwQ ($4.65 in chips) 
4awUyiDYTgylQKXZ9faBVA: posts small blind $0.10
Th3FldXKQW6hWVVPahaoOQ: posts big blind $0.25
*** HOLE CARDS ***
4oA316mXLIui1QY63GXBUg: folds 
0GQg6tdDMBDzY6FKumSo9w: folds 
cZ99hugmLBj9KhTlc8nCSw: folds 
H9KUl8cmpLgEpOVDA00bCg: folds 
1Clf3cPrqoy/YgvWdWK1Xw: folds 
nalbG/4/1Z1wQjRDWV7b2w: folds 
OiV1PWZ3IkN29JlmCcnTwQ: raises $0.75 to $1
4awUyiDYTgylQKXZ9faBVA: folds 
Th3FldXKQW6hWVVPahaoOQ: folds 
Uncalled bet ($0.75) returned to OiV1PWZ3IkN29JlmCcnTwQ
OiV1PWZ3IkN29JlmCcnTwQ collected $0.60 from pot
OiV1PWZ3IkN29JlmCcnTwQ: doesn't show hand 
*** SUMMARY ***
Total pot $0.60 | Rake $0 
Seat 1: 4awUyiDYTgylQKXZ9faBVA (small blind) folded before Flop
Seat 2: Th3FldXKQW6hWVVPahaoOQ (big blind) folded before Flop
Seat 3: 4oA316mXLIui1QY63GXBUg folded before Flop (didn't bet)
Seat 4: 0GQg6tdDMBDzY6FKumSo9w folded before Flop (didn't bet)
Seat 5: cZ99hugmLBj9KhTlc8nCSw folded before Flop (didn't bet)
Seat 6: H9KUl8cmpLgEpOVDA00bCg folded before Flop (didn't bet)
Seat 7: 1Clf3cPrqoy/YgvWdWK1Xw folded before Flop (didn't bet)
Seat 8: nalbG/4/1Z1wQjRDWV7b2w folded before Flop (didn't bet)
Seat 9: OiV1PWZ3IkN29JlmCcnTwQ (button) collected ($0.60)




PokerStars Game #59939678322:  Hold'em No Limit ($0.10/$0.25) - 2009/07/01 0:46:05 ET
Table 'x7YStLKc8hpt/pTgSetPKA' 9-max Seat #4 is the button
Seat 1: tYsOBqdU1+x+yFI7zHO7hQ ($25 in chips) 
Seat 2: z5GxcHlYz/GSz6W2uFiTtg ($34.65 in chips) 
Seat 3: S7Ki0P+0AIGPuIfGJjW0gg ($25.70 in chips) 
Seat 4: er5m2fugFz72ZXh/4+gSDg ($24.65 in chips) 
Seat 5: gxyie8xe6lDdpfG4quHtbw ($8.90 in chips) 
Seat 6: Yv4fucyyT28mjx8V5lxKJg ($36.80 in chips) 
Seat 7: +8FtfKCFr23+6O39P+U45Q ($29.50 in chips) 
Seat 8: jeKWRUkMaVn8rEUjnJKqpg ($33.15 in chips) 
Seat 9: nm4Dj/f+jJEwKVsUnKh73g ($27.80 in chips) 
gxyie8xe6lDdpfG4quHtbw: posts small blind $0.10
Yv4fucyyT28mjx8V5lxKJg: posts big blind $0.25
*** HOLE CARDS ***
+8FtfKCFr23+6O39P+U45Q: folds 
jeKWRUkMaVn8rEUjnJKqpg: calls $0.25
+8FtfKCFr23+6O39P+U45Q leaves the table
nm4Dj/f+jJEwKVsUnKh73g: folds 
tYsOBqdU1+x+yFI7zHO7hQ: folds 
dtZ84flFEi4Q+SGrHMJRDQ joins the table at seat #7 
z5GxcHlYz/GSz6W2uFiTtg: folds 
S7Ki0P+0AIGPuIfGJjW0gg: folds 
er5m2fugFz72ZXh/4+gSDg: folds 
gxyie8xe6lDdpfG4quHtbw: calls $0.15
Yv4fucyyT28mjx8V5lxKJg: checks 
*** FLOP *** [Kd 4s 5d]
gxyie8xe6lDdpfG4quHtbw: bets $0.50
Yv4fucyyT28mjx8V5lxKJg: raises $2.50 to $3
jeKWRUkMaVn8rEUjnJKqpg: calls $3
gxyie8xe6lDdpfG4quHtbw: folds 
*** TURN *** [Kd 4s 5d] [Ac]
Yv4fucyyT28mjx8V5lxKJg: checks 
jeKWRUkMaVn8rEUjnJKqpg: checks 
*** RIVER *** [Kd 4s 5d Ac] [2h]
Yv4fucyyT28mjx8V5lxKJg: checks 
jeKWRUkMaVn8rEUjnJKqpg: bets $5
Yv4fucyyT28mjx8V5lxKJg: folds 
Uncalled bet ($5) returned to jeKWRUkMaVn8rEUjnJKqpg
jeKWRUkMaVn8rEUjnJKqpg collected $6.90 from pot
jeKWRUkMaVn8rEUjnJKqpg: doesn't show hand 
*** SUMMARY ***
Total pot $7.25 | Rake $0.35 
Board [Kd 4s 5d Ac 2h]
Seat 1: tYsOBqdU1+x+yFI7zHO7hQ folded before Flop (didn't bet)
Seat 2: z5GxcHlYz/GSz6W2uFiTtg folded before Flop (didn't bet)
Seat 3: S7Ki0P+0AIGPuIfGJjW0gg folded before Flop (didn't bet)
Seat 4: er5m2fugFz72ZXh/4+gSDg (button) folded before Flop (didn't bet)
Seat 5: gxyie8xe6lDdpfG4quHtbw (small blind) folded on the Flop
Seat 6: Yv4fucyyT28mjx8V5lxKJg (big blind) folded on the River
Seat 7: +8FtfKCFr23+6O39P+U45Q folded before Flop (didn't bet)
Seat 8: jeKWRUkMaVn8rEUjnJKqpg collected ($6.90)
Seat 9: nm4Dj/f+jJEwKVsUnKh73g folded before Flop (didn't bet)




PokerStars Game #599396787588296old'em No Limit ($0.10/$0.25) - 2009/07/01 0:46:05 ET
Table 'nQC9LRg01NEuKFHF1nrDEw0XPo7K54oZIfG0xlNAcDRw-max Seat #2 is the button
Seat 1: Nj6/PdBvfG79w0yeIjPmmA ($13.70 in chips) 
Seat 2: cPO/1/dTcZpLkQFm3jH3Rg ($32.70 in chips) 
Seat 3: 6+g0Lb6vfRDZkElV8ieHyQ ($29.70 in chips) 
Seat 4: tLM9aw7T3kBEIhQEh1roOg ($8.70 in chips) 
Seat 5: kG34n23qFQA3nzdOJTQ1dA ($28.15 in chips) 
Seat 6: xQVFeVUDopz+akuEo2wXpQ ($45.15 in chips) 
6+g0Lb6vfRDZkElV8ieHyQ: posts small blind $0.10
tLM9aw7T3kBEIhQEh1roOg: posts big blind $0.25
*** HOLE CARDS ***
kG34n23qFQA3nzdOJTQ1dA: folds 
xQVFeVUDopz+akuEo2wXpQ: folds 
Nj6/PdBvfG79w0yeIjPmmA: folds 
cPO/1/dTcZpLkQFm3jH3Rg: folds 
6+g0Lb6vfRDZkElV8ieHyQ: calls $0.15
tLM9aw7T3kBEIhQEh1roOg: checks 
*** FLOP *** [3h Jh Kh]
6+g0Lb6vfRDZkElV8ieHyQ: bets $0.25
tLM9aw7T3kBEIhQEh1roOg: folds 
Uncalled bet ($0.25) returned to 6+g0Lb6vfRDZkElV8ieHyQ
6+g0Lb6vfRDZkElV8ieHyQ collected $0.50 from pot
*** SUMMARY ***
Total pot $0.50 | Rake $0 
Board [3h Jh Kh]
Seat 1: Nj6/PdBvfG79w0yeIjPmmA folded before Flop (didn't bet)
Seat 2: cPO/1/dTcZpLkQFm3jH3Rg (button) folded before Flop (didn't bet)
Seat 3: 6+g0Lb6vfRDZkElV8ieHyQ (small blind) collected ($0.50)
Seat 4: tLM9aw7T3kBEIhQEh1roOg (big blind) folded on the Flop
Seat 5: kG34n23qFQA3nzdOJTQ1dA folded before Flop (didn't bet)
Seat 6: xQVFeVUDopz+akuEo2wXpQ folded before Flop (didn't bet)




PokerStars Game #59939678626:  Hold'em No Limit ($0.10/$0.25) - 2009/07/01 0:46:05 ET
Table 'KU/HrxqxwDz8HKEhYTZ6uw' 6-max Seat #4 is the button
Seat 1: gaPMxLGp9SOj4Lq6t+/0Ig ($27.15 in chips) 
Seat 2: kG34n23qFQA3nzdOJTQ1dA ($24.30 in chips) 
Seat 3: 3seg9SJ1y+HUPN0X0XKF5Q ($6.45 in chips) 
Seat 4: ozxrnSdjO4oiCJmh7+KoTA ($25 in chips) 
Seat 5: 4YSTu0Cdzpppe1lUgCZGCQ ($32.50 in chips) 
Seat 6: QIWnfLSqfMcoFfdDe5LZPg ($19.10 in chips) 
4YSTu0Cdzpppe1lUgCZGCQ: posts small blind $0.10
QIWnfLSqfMcoFfdDe5LZPg: posts big blind $0.25
*** HOLE CARDS ***
gaPMxLGp9SOj4Lq6t+/0Ig: folds 
kG34n23qFQA3nzdOJTQ1dA: calls $0.25
3seg9SJ1y+HUPN0X0XKF5Q: folds 
ozxrnSdjO4oiCJmh7+KoTA: folds 
4YSTu0Cdzpppe1lUgCZGCQ: folds 
QIWnfLSqfMcoFfdDe5LZPg: checks 
*** FLOP *** [Js Kc 3c]
QIWnfLSqfMcoFfdDe5LZPg: checks 
kG34n23qFQA3nzdOJTQ1dA: checks 
*** TURN *** [Js Kc 3c] [Kh]
QIWnfLSqfMcoFfdDe5LZPg: checks 
kG34n23qFQA3nzdOJTQ1dA: checks 
*** RIVER *** [Js Kc 3c Kh] [Td]
QIWnfLSqfMcoFfdDe5LZPg: checks 
kG34n23qFQA3nzdOJTQ1dA: checks 
*** SHOW DOWN ***
QIWnfLSqfMcoFfdDe5LZPg: shows [5d 7s] (a pair of Kings)
kG34n23qFQA3nzdOJTQ1dA: shows [Ts Qs] (two pair, Kings and Tens)
kG34n23qFQA3nzdOJTQ1dA collected $0.60 from pot
*** SUMMARY ***
Total pot $0.60 | Rake $0 
Board [Js Kc 3c Kh Td]
Seat 1: gaPMxLGp9SOj4Lq6t+/0Ig folded before Flop (didn't bet)
Seat 2: kG34n23qFQA3nzdOJTQ1dA showed [Ts Qs] and won ($0.60) with two pair, Kings and Tens
Seat 3: 3seg9SJ1y+HUPN0X0XKF5Q folded before Flop (didn't bet)
Seat 4: ozxrnSdjO4oiCJmh7+KoTA (button) folded before Flop (didn't bet)
Seat 5: 4YSTu0Cdzpppe1lUgCZGCQ (small blind) folded before Flop
Seat 6: QIWnfLSqfMcoFfdDe5LZPg (big blind) showed [5d 7s] and lost with a pair of Kings




PokerStars Game #59939679236:  Hold'em No Limit ($0.10/$0.25) - 2009/07/01 0:46:06 ET
Table 'eOXPe2c6mG7DOFKvMsZZfA' 6-max Seat #1 is the button
Seat 1: ShXPHWfjhfmAwLgDdm6bRQ ($7.15 in chips) 
Seat 2: ELW+DKizJhLK7k40PMkD2Q ($33.40 in chips) 
Seat 3: kReyZ6g6Fu3tQ0nyjDf9kA ($29.65 in chips) 
Seat 4: zHHLkD2sRljslKKeQv/ZQw ($42.25 in chips) 
Seat 5: NhUN/JpAprdJeamFBgJH1w ($25.35 in chips) 
Seat 6: wKFJ513ucluNNiMlkXcDOQ ($26.85 in chips) 
ELW+DKizJhLK7k40PMkD2Q: posts small blind $0.10
kReyZ6g6Fu3tQ0nyjDf9kA: posts big blind $0.25
*** HOLE CARDS ***
zHHLkD2sRljslKKeQv/ZQw: calls $0.25
NhUN/JpAprdJeamFBgJH1w: folds 
wKFJ513ucluNNiMlkXcDOQ: raises $1 to $1.25
ShXPHWfjhfmAwLgDdm6bRQ: raises $5.90 to $7.15 and is all-in
ELW+DKizJhLK7k40PMkD2Q: folds 
kReyZ6g6Fu3tQ0nyjDf9kA: folds 
zHHLkD2sRljslKKeQv/ZQw: folds 
wKFJ513ucluNNiMlkXcDOQ: calls $5.90
*** FLOP *** [Ad 4d 3h]
*** TURN *** [Ad 4d 3h] [Qh]
*** RIVER *** [Ad 4d 3h Qh] [8d]
*** SHOW DOWN ***
wKFJ513ucluNNiMlkXcDOQ: shows [7h 4h] (a pair of Fours)
ShXPHWfjhfmAwLgDdm6bRQ: shows [Qs Qd] (three of a kind, Queens)
ShXPHWfjhfmAwLgDdm6bRQ collected $14.20 from pot
*** SUMMARY ***
Total pot $14.90 | Rake $0.70 
Board [Ad 4d 3h Qh 8d]
Seat 1: ShXPHWfjhfmAwLgDdm6bRQ (button) showed [Qs Qd] and won ($14.20) with three of a kind, Queens
Seat 2: ELW+DKizJhLK7k40PMkD2Q (small blind) folded before Flop
Seat 3: kReyZ6g6Fu3tQ0nyjDf9kA (big blind) folded before Flop
Seat 4: zHHLkD2sRljslKKeQv/ZQw folded before Flop
Seat 5: NhUN/JpAprdJeamFBgJH1w folded before Flop (didn't bet)
Seat 6: wKFJ513ucluNNiMlkXcDOQ showed [7h 4h] and lost with a pair of Fours




PokerStars Game #59939679098:  Hold'em No Limit ($0.10/$0.25) - 2009/07/01 0:46:06 ET
Table '84TjTrgbsYZladOc4PWf4Q' 6-max Seat #4 is the button
Seat 1: 79ID/ub1Pt/mDpCprVmOoA ($30 in chips) 
Seat 2: RpaEX9P7BCvyfPRLiRNg0A ($15.35 in chips) 
Seat 3: Ar4vsUIUfJ7gbYh1c1m59g ($14.65 in chips) 
Seat 4: SxIIgwXYLkwd6m3wLyPTCw ($25 in chips) 
Seat 5: YaAEMJGY5tem39deCUQRNw ($26.10 in chips) 
Seat 6: 7qRk4YH4/k/08LgJSv7rBQ ($26.45 in chips) 
YaAEMJGY5tem39deCUQRNw: posts small blind $0.10
7qRk4YH4/k/08LgJSv7rBQ: posts big blind $0.25
*** HOLE CARDS ***
79ID/ub1Pt/mDpCprVmOoA: folds 
RpaEX9P7BCvyfPRLiRNg0A: folds 
Ar4vsUIUfJ7gbYh1c1m59g: folds 
SxIIgwXYLkwd6m3wLyPTCw: folds 
YaAEMJGY5tem39deCUQRNw: raises $1.25 to $1.50
7qRk4YH4/k/08LgJSv7rBQ: folds 
Uncalled bet ($1.25) returned to YaAEMJGY5tem39deCUQRNw
YaAEMJGY5tem39deCUQRNw collected $0.50 from pot
*** SUMMARY ***
Total pot $0.50 | Rake $0 
Seat 1: 79ID/ub1Pt/mDpCprVmOoA folded before Flop (didn't bet)
Seat 2: RpaEX9P7BCvyfPRLiRNg0A folded before Flop (didn't bet)
Seat 3: Ar4vsUIUfJ7gbYh1c1m59g folded before Flop (didn't bet)
Seat 4: SxIIgwXYLkwd6m3wLyPTCw (button) folded before Flop (didn't bet)
Seat 5: YaAEMJGY5tem39deCUQRNw (small blind) collected ($0.50)
Seat 6: 7qRk4YH4/k/08LgJSv7rBQ (big blind) folded before Flop




PokerStars Game #59939679494:  Hold'em No Limit ($0.10/$0.25) - 2009/07/01 0:46:06 ET
Table 'VQNfcI8vTBCTvRfd3veTLQ' 6-max Seat #6 is the button
Seat 1: ymz+a8dgHSUFPooYplw7Ow ($24.65 in chips) 
Seat 2: KukIGupqqJCXA+Hp2bEFnA ($5.85 in chips) 
Seat 3: LtASJ9OlkqGrrUKGQlpGAw ($23.05 in chips) 
Seat 4: nc79pm0LZRdhncq55evVqA ($25 in chips) 
Seat 5: gX2vbKwS/8zZPENAWB7hxQ ($11.40 in chips) 
Seat 6: dlCLwmcvRShnuFDEVkdIEA ($11.90 in chips) 
ymz+a8dgHSUFPooYplw7Ow: posts small blind $0.10
KukIGupqqJCXA+Hp2bEFnA: posts big blind $0.25
*** HOLE CARDS ***
LtASJ9OlkqGrrUKGQlpGAw: folds 
nc79pm0LZRdhncq55evVqA: folds 
gX2vbKwS/8zZPENAWB7hxQ: folds 
dlCLwmcvRShnuFDEVkdIEA: calls $0.25
ymz+a8dgHSUFPooYplw7Ow: folds 
KukIGupqqJCXA+Hp2bEFnA: checks 
*** FLOP *** [9h Td 4c]
KukIGupqqJCXA+Hp2bEFnA: checks 
dlCLwmcvRShnuFDEVkdIEA: checks 
*** TURN *** [9h Td 4c] [3h]
KukIGupqqJCXA+Hp2bEFnA: checks 
dlCLwmcvRShnuFDEVkdIEA: checks 
*** RIVER *** [9h Td 4c 3h] [3s]
KukIGupqqJCXA+Hp2bEFnA: checks 
dlCLwmcvRShnuFDEVkdIEA: bets $0.25
KukIGupqqJCXA+Hp2bEFnA: folds 
Uncalled bet ($0.25) returned to dlCLwmcvRShnuFDEVkdIEA
dlCLwmcvRShnuFDEVkdIEA collected $0.60 from pot
dlCLwmcvRShnuFDEVkdIEA: doesn't show hand 
*** SUMMARY ***
Total pot $0.60 | Rake $0 
Board [9h Td 4c 3h 3s]
Seat 1: ymz+a8dgHSUFPooYplw7Ow (small blind) folded before Flop
Seat 2: KukIGupqqJCXA+Hp2bEFnA (big blind) folded on the River
Seat 3: LtASJ9OlkqGrrUKGQlpGAw folded before Flop (didn't bet)
Seat 4: nc79pm0LZRdhncq55evVqA folded before Flop (didn't bet)
Seat 5: gX2vbKwS/8zZPENAWB7hxQ folded before Flop (didn't bet)
Seat 6: dlCLwmcvRShnuFDEVkdIEA (button) collected ($0.60)




PokerStars Game #59939679046:  Hold'em No Limit ($0.10/$0.25) - 2009/07/01 0:46:06 ET
Table 'dNYnr4D4id1jwnEU66Yowg' 9-max Seat #8 is the button
Seat 1: 41pZ+Uce9oq+8wmcVBXWIg ($19.85 in chips) 
Seat 2: +twYdIw+izmdFyX5TTFzjg ($15.50 in chips) 
Seat 4: d9fERE+24v0MqnylCrXchQ ($8.45 in chips) 
Seat 6: Lu6miJBtf3FVzUdzCWEtqQ ($17 in chips) 
Seat 8: sv2dZaqHRlfCDrW63Guhvg ($5.35 in chips) 
41pZ+Uce9oq+8wmcVBXWIg: posts small blind $0.10
+twYdIw+izmdFyX5TTFzjg: posts big blind $0.25
*** HOLE CARDS ***
d9fERE+24v0MqnylCrXchQ: calls $0.25
Lu6miJBtf3FVzUdzCWEtqQ: folds 
sv2dZaqHRlfCDrW63Guhvg: folds 
41pZ+Uce9oq+8wmcVBXWIg: folds 
+twYdIw+izmdFyX5TTFzjg: checks 
*** FLOP *** [7c Tc 5s]
+twYdIw+izmdFyX5TTFzjg: checks 
d9fERE+24v0MqnylCrXchQ: checks 
*** TURN *** [7c Tc 5s] [6s]
+twYdIw+izmdFyX5TTFzjg: bets $0.25
d9fERE+24v0MqnylCrXchQ: calls $0.25
*** RIVER *** [7c Tc 5s 6s] [Js]
+twYdIw+izmdFyX5TTFzjg: bets $0.75
d9fERE+24v0MqnylCrXchQ: folds 
Uncalled bet ($0.75) returned to +twYdIw+izmdFyX5TTFzjg
+twYdIw+izmdFyX5TTFzjg collected $1.05 from pot
*** SUMMARY ***
Total pot $1.10 | Rake $0.05 
Board [7c Tc 5s 6s Js]
Seat 1: 41pZ+Uce9oq+8wmcVBXWIg (small blind) folded before Flop
Seat 2: +twYdIw+izmdFyX5TTFzjg (big blind) collected ($1.05)
Seat 4: d9fERE+24v0MqnylCrXchQ folded on the River
Seat 6: Lu6miJBtf3FVzUdzCWEtqQ folded before Flop (didn't bet)
Seat 8: sv2dZaqHRlfCDrW63Guhvg (button) folded before Flop (didn't bet)




PokerStars Game #59939679282:  Hold'em No Limit ($0.10/$0.25) - 2009/07/01 0:46:06 ET
Table 'yAHDCs33TIgw3ra63xuU2Q' 9-max Seat #9 is the button
Seat 1: 8B/dhbQjIWe6ASCdgzktNQ ($26.15 in chips) 
Seat 2: LBrhQVB4w41YNd7kMYn/og ($19.40 in chips) 
Seat 3: H9KUl8cmpLgEpOVDA00bCg ($4.90 in chips) 
Seat 4: rUdM7gwmNCaxMNSb2CFPhQ ($10.65 in chips) 
Seat 5: 4awUyiDYTgylQKXZ9faBVA ($25.50 in chips) 
Seat 6: Z5ZtGOON8kmSdSCll9Z3XA ($10.70 in chips) 
Seat 7: gYiMxTFOfUp1+zRgNLQmmQ ($22 in chips) 
Seat 8: tYsOBqdU1+x+yFI7zHO7hQ ($29.80 in chips) 
Seat 9: k+ydNCnnP3Hgwh0AnDYVrA ($11.90 in chips) 
8B/dhbQjIWe6ASCdgzktNQ: posts small blind $0.10
LBrhQVB4w41YNd7kMYn/og: posts big blind $0.25
*** HOLE CARDS ***
H9KUl8cmpLgEpOVDA00bCg: folds 
rUdM7gwmNCaxMNSb2CFPhQ: raises $0.75 to $1
4awUyiDYTgylQKXZ9faBVA: folds 
Z5ZtGOON8kmSdSCll9Z3XA: folds 
gYiMxTFOfUp1+zRgNLQmmQ: calls $1
tYsOBqdU1+x+yFI7zHO7hQ: folds 
k+ydNCnnP3Hgwh0AnDYVrA: folds 
8B/dhbQjIWe6ASCdgzktNQ: folds 
LBrhQVB4w41YNd7kMYn/og: raises $2.50 to $3.50
rUdM7gwmNCaxMNSb2CFPhQ: folds 
gYiMxTFOfUp1+zRgNLQmmQ: calls $2.50
*** FLOP *** [5s 6s 7c]
rUdM7gwmNCaxMNSb2CFPhQ said, "nr"
LBrhQVB4w41YNd7kMYn/og: checks 
gYiMxTFOfUp1+zRgNLQmmQ: bets $2.50
LBrhQVB4w41YNd7kMYn/og: folds 
Uncalled bet ($2.50) returned to gYiMxTFOfUp1+zRgNLQmmQ
gYiMxTFOfUp1+zRgNLQmmQ collected $7.70 from pot
*** SUMMARY ***
Total pot $8.10 | Rake $0.40 
Board [5s 6s 7c]
Seat 1: 8B/dhbQjIWe6ASCdgzktNQ (small blind) folded before Flop
Seat 2: LBrhQVB4w41YNd7kMYn/og (big blind) folded on the Flop
Seat 3: H9KUl8cmpLgEpOVDA00bCg folded before Flop (didn't bet)
Seat 4: rUdM7gwmNCaxMNSb2CFPhQ folded before Flop
Seat 5: 4awUyiDYTgylQKXZ9faBVA folded before Flop (didn't bet)
Seat 6: Z5ZtGOON8kmSdSCll9Z3XA folded before Flop (didn't bet)
Seat 7: gYiMxTFOfUp1+zRgNLQmmQ collected ($7.70)
Seat 8: tYsOBqdU1+x+yFI7zHO7hQ folded before Flop (didn't bet)
Seat 9: k+ydNCnnP3Hgwh0AnDYVrA (button) folded before Flop (didn't bet)




PokerStars Game #59939679360:  Hold'em No Limit ($0.10/$0.25) - 2009/07/01 0:46:06 ET
Table 'R5qKG21jwFDYRcOht9qwqQ' 9-max Seat #1 is the button
Seat 1: OgISYvc5hA85YuDnsXCH+Q ($16.05 in chips) 
Seat 2: N6foVRyErHqcNmshkqextQ ($13.90 in chips) 
Seat 3: M2QO2DxB5Wawg2h8HSpnYA ($10.35 in chips) 
Seat 4: z5GxcHlYz/GSz6W2uFiTtg ($27.95 in chips) 
Seat 5: 8B/dhbQjIWe6ASCdgzktNQ ($25 in chips) 
Seat 7: HYQiVfBGJsg4smSubKCBmA ($27.90 in chips) 
Seat 8: tYsOBqdU1+x+yFI7zHO7hQ ($25.35 in chips) 
Seat 9: MG90wfSJZnOejs/KD3vlQQ ($25.65 in chips) 
N6foVRyErHqcNmshkqextQ: posts small blind $0.10
M2QO2DxB5Wawg2h8HSpnYA: posts big blind $0.25
*** HOLE CARDS ***
z5GxcHlYz/GSz6W2uFiTtg: folds 
8B/dhbQjIWe6ASCdgzktNQ: folds 
HYQiVfBGJsg4smSubKCBmA: folds 
tYsOBqdU1+x+yFI7zHO7hQ: folds 
MG90wfSJZnOejs/KD3vlQQ: folds 
OgISYvc5hA85YuDnsXCH+Q: calls $0.25
N6foVRyErHqcNmshkqextQ: folds 
M2QO2DxB5Wawg2h8HSpnYA: checks 
*** FLOP *** [4c 9c Ah]
M2QO2DxB5Wawg2h8HSpnYA: checks 
OgISYvc5hA85YuDnsXCH+Q: bets $0.50
M2QO2DxB5Wawg2h8HSpnYA: folds 
Uncalled bet ($0.50) returned to OgISYvc5hA85YuDnsXCH+Q
OgISYvc5hA85YuDnsXCH+Q collected $0.60 from pot
OgISYvc5hA85YuDnsXCH+Q: doesn't show hand 
*** SUMMARY ***
Total pot $0.60 | Rake $0 
Board [4c 9c Ah]
Seat 1: OgISYvc5hA85YuDnsXCH+Q (button) collected ($0.60)
Seat 2: N6foVRyErHqcNmshkqextQ (small blind) folded before Flop
Seat 3: M2QO2DxB5Wawg2h8HSpnYA (big blind) folded on the Flop
Seat 4: z5GxcHlYz/GSz6W2uFiTtg folded before Flop (didn't bet)
Seat 5: 8B/dhbQjIWe6ASCdgzktNQ folded before Flop (didn't bet)
Seat 7: HYQiVfBGJsg4smSubKCBmA folded before Flop (didn't bet)
Seat 8: tYsOBqdU1+x+yFI7zHO7hQ folded before Flop (didn't bet)
Seat 9: MG90wfSJZnOejs/KD3vlQQ folded before Flop (didn't bet)




PokerStars Game #59939679596:  Hold'em No Limit ($0.10/$0.25) - 2009/07/01 0:46:07 ET
Table 'zKwHJD0cmKNUure9qQTfFg' 6-max Seat #1 is the button
Seat 1: nwwpaieDRI0UPyVtChVHOg ($14.90 in chips) 
Seat 3: ljjhtb6FVPTx9AT9HNdtqg ($14.50 in chips) 
Seat 4: v+QfkGiuj9bgtuNoVnDO8w ($25.35 in chips) 
Seat 6: fBpPyuxbg0NbTlQHEs38sA ($15.55 in chips) 
4kWQxGbT5FZ1dkPd1bE45Q will be allowed to play after the button
ljjhtb6FVPTx9AT9HNdtqg: posts small blind $0.10
v+QfkGiuj9bgtuNoVnDO8w: posts big blind $0.25
I1TxPvWj8NfG8orglCinNA: sits out 
*** HOLE CARDS ***
fBpPyuxbg0NbTlQHEs38sA: raises $0.25 to $0.50
nwwpaieDRI0UPyVtChVHOg: folds 
ljjhtb6FVPTx9AT9HNdtqg: folds 
v+QfkGiuj9bgtuNoVnDO8w: folds 
Uncalled bet ($0.25) returned to fBpPyuxbg0NbTlQHEs38sA
fBpPyuxbg0NbTlQHEs38sA collected $0.60 from pot
fBpPyuxbg0NbTlQHEs38sA: doesn't show hand 
*** SUMMARY ***
Total pot $0.60 | Rake $0 
Seat 1: nwwpaieDRI0UPyVtChVHOg (button) folded before Flop (didn't bet)
Seat 3: ljjhtb6FVPTx9AT9HNdtqg (small blind) folded before Flop
Seat 4: v+QfkGiuj9bgtuNoVnDO8w (big blind) folded before Flop
Seat 6: fBpPyuxbg0NbTlQHEs38sA collected ($0.60)




PokerStars Game #59939679692:  Hold'em No Limit ($0.10/$0.25) - 2009/07/01 0:46:07 ET
Table 'AUM6O+mgQAaLDZKMQ/5/gA' 9-max Seat #9 is the button
Seat 1: Eyuoq9VsHg1Puw0nNzXTjg ($5.35 in chips) 
Seat 2: p0Q0llBV74kraoiHI/UzWA ($28.30 in chips) 
Seat 3: 3m6VfX7io8SA31qh1zCkgQ ($13.95 in chips) 
Seat 4: GIv32m/KBYU5WdIHUImuIg ($2.10 in chips) 
Seat 5: +2kMBNpY4nF1qNCRd8SJLA ($25 in chips) 
Seat 6: cFmpjvcjNoVAEAIQIxWkYg ($25 in chips) 
Seat 7: jXz58rvCgq0VjyVjUBf2mw ($25.90 in chips) 
Seat 8: zDrucyjVn5aeekNEc3cJrA ($24.30 in chips) 
Seat 9: er5m2fugFz72ZXh/4+gSDg ($24.65 in chips) 
Eyuoq9VsHg1Puw0nNzXTjg: posts small blind $0.10
p0Q0llBV74kraoiHI/UzWA: posts big blind $0.25
*** HOLE CARDS ***
3m6VfX7io8SA31qh1zCkgQ: calls $0.25
GIv32m/KBYU5WdIHUImuIg: folds 
+2kMBNpY4nF1qNCRd8SJLA: folds 
cFmpjvcjNoVAEAIQIxWkYg: folds 
jXz58rvCgq0VjyVjUBf2mw: folds 
zDrucyjVn5aeekNEc3cJrA: folds 
er5m2fugFz72ZXh/4+gSDg: folds 
Eyuoq9VsHg1Puw0nNzXTjg: calls $0.15
p0Q0llBV74kraoiHI/UzWA: checks 
*** FLOP *** [Ah 8c 8s]
Eyuoq9VsHg1Puw0nNzXTjg: checks 
p0Q0llBV74kraoiHI/UzWA: checks 
3m6VfX7io8SA31qh1zCkgQ: checks 
*** TURN *** [Ah 8c 8s] [9c]
Eyuoq9VsHg1Puw0nNzXTjg: checks 
p0Q0llBV74kraoiHI/UzWA: checks 
3m6VfX7io8SA31qh1zCkgQ: bets $0.50
Eyuoq9VsHg1Puw0nNzXTjg: folds 
p0Q0llBV74kraoiHI/UzWA: folds 
Uncalled bet ($0.50) returned to 3m6VfX7io8SA31qh1zCkgQ
3m6VfX7io8SA31qh1zCkgQ collected $0.75 from pot
3m6VfX7io8SA31qh1zCkgQ: doesn't show hand 
3m6VfX7io8SA31qh1zCkgQ leaves the table
*** SUMMARY ***
Total pot $0.75 | Rake $0 
Board [Ah 8c 8s 9c]
Seat 1: Eyuoq9VsHg1Puw0nNzXTjg (small blind) folded on the Turn
Seat 2: p0Q0llBV74kraoiHI/UzWA (big blind) folded on the Turn
Seat 3: 3m6VfX7io8SA31qh1zCkgQ collected ($0.75)
Seat 4: GIv32m/KBYU5WdIHUImuIg folded before Flop (didn't bet)
Seat 5: +2kMBNpY4nF1qNCRd8SJLA folded before Flop (didn't bet)
Seat 6: cFmpjvcjNoVAEAIQIxWkYg folded before Flop (didn't bet)
Seat 7: jXz58rvCgq0VjyVjUBf2mw folded before Flop (didn't bet)
Seat 8: zDrucyjVn5aeekNEc3cJrA folded before Flop (didn't bet)
Seat 9: er5m2fugFz72ZXh/4+gSDg (button) folded before Flop (didn't bet)




PokerStars Game #59939679690:  Hold'em No Limit ($0.10/$0.25) - 2009/07/01 0:46:07 ET
Table 'vFZR6Kf2Th5xBXT9brGW6A' 6-max Seat #6 is the button
Seat 1: xRkU4+naLuz7dEZFbOn9cw ($29.35 in chips) 
Seat 2: REnO5xiZ66YabxDXq2ncvA ($50.80 in chips) 
Seat 3: wUwfsTnmpHcWa17qFlQr1Q ($5 in chips) 
Seat 4: 79ID/ub1Pt/mDpCprVmOoA ($25.40 in chips) 
Seat 5: NhUN/JpAprdJeamFBgJH1w ($31.65 in chips) 
Seat 6: d0J1xuhsynEY81YHwAvJ5g ($29.75 in chips) 
xRkU4+naLuz7dEZFbOn9cw: posts small blind $0.10
REnO5xiZ66YabxDXq2ncvA: posts big blind $0.25
*** HOLE CARDS ***
wUwfsTnmpHcWa17qFlQr1Q: raises $0.75 to $1
79ID/ub1Pt/mDpCprVmOoA: folds 
NhUN/JpAprdJeamFBgJH1w: folds 
d0J1xuhsynEY81YHwAvJ5g: folds 
xRkU4+naLuz7dEZFbOn9cw: folds 
REnO5xiZ66YabxDXq2ncvA has timed out
REnO5xiZ66YabxDXq2ncvA: folds 
Uncalled bet ($0.75) returned to wUwfsTnmpHcWa17qFlQr1Q
REnO5xiZ66YabxDXq2ncvA is sitting out
wUwfsTnmpHcWa17qFlQr1Q collected $0.60 from pot
*** SUMMARY ***
Total pot $0.60 | Rake $0 
Seat 1: xRkU4+naLuz7dEZFbOn9cw (small blind) folded before Flop
Seat 2: REnO5xiZ66YabxDXq2ncvA (big blind) folded before Flop
Seat 3: wUwfsTnmpHcWa17qFlQr1Q collected ($0.60)
Seat 4: 79ID/ub1Pt/mDpCprVmOoA folded before Flop (didn't bet)
Seat 5: NhUN/JpAprdJeamFBgJH1w folded before Flop (didn't bet)
Seat 6: d0J1xuhsynEY81YHwAvJ5g (button) folded before Flop (didn't bet)




PokerStars Game #59939680448:  Hold'em No Limit ($0.10/$0.25) - 2009/07/01 0:46:08 ET
Table 'AJGgX1ZYM8d68SWMvaLttg' 6-max Seat #1 is the button
Seat 1: sT4sjqzVMH/fZHz0hkbIPw ($45.70 in chips) 
Seat 2: zHHLkD2sRljslKKeQv/ZQw ($29.10 in chips) 
Seat 3: 4x9jCqgSw4272dnaIqnanw ($7 in chips) 
Seat 4: Lz/GjRDgmgepqTR7qmS86w ($14.80 in chips) 
Seat 5: SFmT9ZsVopnukjvAzrxTRg ($25.75 in chips) 
Seat 6: UA5OsKS3VPaxa7uC8La/kA ($27.40 in chips) 
zHHLkD2sRljslKKeQv/ZQw: posts small blind $0.10
4x9jCqgSw4272dnaIqnanw: posts big blind $0.25
*** HOLE CARDS ***
Lz/GjRDgmgepqTR7qmS86w: raises $0.75 to $1
SFmT9ZsVopnukjvAzrxTRg: folds 
UA5OsKS3VPaxa7uC8La/kA: folds 
sT4sjqzVMH/fZHz0hkbIPw: calls $1
zHHLkD2sRljslKKeQv/ZQw: calls $0.90
4x9jCqgSw4272dnaIqnanw: calls $0.75
*** FLOP *** [Kd 3s 7d]
zHHLkD2sRljslKKeQv/ZQw: checks 
4x9jCqgSw4272dnaIqnanw: checks 
Lz/GjRDgmgepqTR7qmS86w: checks 
sT4sjqzVMH/fZHz0hkbIPw: checks 
*** TURN *** [Kd 3s 7d] [7h]
zHHLkD2sRljslKKeQv/ZQw: checks 
4x9jCqgSw4272dnaIqnanw: checks 
Lz/GjRDgmgepqTR7qmS86w: checks 
sT4sjqzVMH/fZHz0hkbIPw: bets $2.75
zHHLkD2sRljslKKeQv/ZQw: folds 
4x9jCqgSw4272dnaIqnanw: folds 
Lz/GjRDgmgepqTR7qmS86w: folds 
Uncalled bet ($2.75) returned to sT4sjqzVMH/fZHz0hkbIPw
sT4sjqzVMH/fZHz0hkbIPw collected $3.80 from pot
sT4sjqzVMH/fZHz0hkbIPw: doesn't show hand 
*** SUMMARY ***
Total pot $4 | Rake $0.20 
Board [Kd 3s 7d 7h]
Seat 1: sT4sjqzVMH/fZHz0hkbIPw (button) collected ($3.80)
Seat 2: zHHLkD2sRljslKKeQv/ZQw (small blind) folded on the Turn
Seat 3: 4x9jCqgSw4272dnaIqnanw (big blind) folded on the Turn
Seat 4: Lz/GjRDgmgepqTR7qmS86w folded on the Turn
Seat 5: SFmT9ZsVopnukjvAzrxTRg folded before Flop (didn't bet)
Seat 6: UA5OsKS3VPaxa7uC8La/kA folded before Flop (didn't bet)




PokerStars Game #59939680546:  Hold'em No Limit ($0.10/$0.25) - 2009/07/01 0:46:08 ET
Table '5VWnrlxdjwVfMWkVS2WE7A' 6-max Seat #5 is the button
Seat 1: BiLBinPhgpKAYzLgKJVU5A ($21.60 in chips) 
Seat 2: ELW+DKizJhLK7k40PMkD2Q ($28.95 in chips) 
Seat 3: cPO/1/dTcZpLkQFm3jH3Rg ($25 in chips) 
Seat 4: WZv4aSGl7ETtI/Z5BPKi7w ($32.50 in chips) 
Seat 5: JQZew0FjzS19kTjeNtrE+A ($41.95 in chips) 
Seat 6: LtASJ9OlkqGrrUKGQlpGAw ($16.15 in chips) 
LtASJ9OlkqGrrUKGQlpGAw: posts small blind $0.10
BiLBinPhgpKAYzLgKJVU5A: posts big blind $0.25
*** HOLE CARDS ***
ELW+DKizJhLK7k40PMkD2Q: folds 
cPO/1/dTcZpLkQFm3jH3Rg: folds 
WZv4aSGl7ETtI/Z5BPKi7w: folds 
JQZew0FjzS19kTjeNtrE+A: folds 
LtASJ9OlkqGrrUKGQlpGAw: calls $0.15
BiLBinPhgpKAYzLgKJVU5A: checks 
*** FLOP *** [Qs 2d Ks]
LtASJ9OlkqGrrUKGQlpGAw: checks 
BiLBinPhgpKAYzLgKJVU5A: checks 
*** TURN *** [Qs 2d Ks] [Qc]
LtASJ9OlkqGrrUKGQlpGAw: bets $0.50
BiLBinPhgpKAYzLgKJVU5A: folds 
Uncalled bet ($0.50) returned to LtASJ9OlkqGrrUKGQlpGAw
LtASJ9OlkqGrrUKGQlpGAw collected $0.50 from pot
LtASJ9OlkqGrrUKGQlpGAw: doesn't show hand 
*** SUMMARY ***
Total pot $0.50 | Rake $0 
Board [Qs 2d Ks Qc]
Seat 1: BiLBinPhgpKAYzLgKJVU5A (big blind) folded on the Turn
Seat 2: ELW+DKizJhLK7k40PMkD2Q folded before Flop (didn't bet)
Seat 3: cPO/1/dTcZpLkQFm3jH3Rg folded before Flop (didn't bet)
Seat 4: WZv4aSGl7ETtI/Z5BPKi7w folded before Flop (didn't bet)
Seat 5: JQZew0FjzS19kTjeNtrE+A (button) folded before Flop (didn't bet)
Seat 6: LtASJ9OlkqGrrUKGQlpGAw (small blind) collected ($0.50)




PokerStars Game #59939680484:  Hold'em No Limit ($0.10/$0.25) - 2009/07/01 0:46:08 ET
Table 'rjcb+nlE+0GuJ6lBhuCkkA' 6-max Seat #1 is the button
Seat 1: 9jSiy0meE9XJKkdIZwyTEQ ($28.55 in chips) 
Seat 2: lJphax9e7/+O/3YCKPJ0yQ ($4.75 in chips) 
Seat 3: 8ClCHtFXGNplITm+63KB+Q ($36.90 in chips) 
Seat 4: NzIFHwilc5zU7QhjDTgTZA ($10.35 in chips) 
Seat 5: GC/9yVD59DUCX7hUI7gcLw ($31.50 in chips) 
Seat 6: 0DvgWV5o6c/jYqQCjm4Haw ($33.30 in chips) 
lJphax9e7/+O/3YCKPJ0yQ: posts small blind $0.10
8ClCHtFXGNplITm+63KB+Q: posts big blind $0.25
*** HOLE CARDS ***
NzIFHwilc5zU7QhjDTgTZA: raises $0.25 to $0.50
GC/9yVD59DUCX7hUI7gcLw: folds 
0DvgWV5o6c/jYqQCjm4Haw: folds 
9jSiy0meE9XJKkdIZwyTEQ: calls $0.50
lJphax9e7/+O/3YCKPJ0yQ: raises $0.25 to $0.75
8ClCHtFXGNplITm+63KB+Q: folds 
NzIFHwilc5zU7QhjDTgTZA: calls $0.25
9jSiy0meE9XJKkdIZwyTEQ: calls $0.25
*** FLOP *** [6h 9s 3s]
lJphax9e7/+O/3YCKPJ0yQ: bets $1
NzIFHwilc5zU7QhjDTgTZA: calls $1
9jSiy0meE9XJKkdIZwyTEQ: folds 
*** TURN *** [6h 9s 3s] [Tc]
lJphax9e7/+O/3YCKPJ0yQ: bets $1
NzIFHwilc5zU7QhjDTgTZA: raises $1 to $2
lJphax9e7/+O/3YCKPJ0yQ: raises $1 to $3 and is all-in
NzIFHwilc5zU7QhjDTgTZA: calls $1
*** RIVER *** [6h 9s 3s Tc] [8c]
*** SHOW DOWN ***
lJphax9e7/+O/3YCKPJ0yQ: shows [Jc Jd] (a pair of Jacks)
NzIFHwilc5zU7QhjDTgTZA: mucks hand 
lJphax9e7/+O/3YCKPJ0yQ collected $10 from pot
*** SUMMARY ***
Total pot $10.50 | Rake $0.50 
Board [6h 9s 3s Tc 8c]
Seat 1: 9jSiy0meE9XJKkdIZwyTEQ (button) folded on the Flop
Seat 2: lJphax9e7/+O/3YCKPJ0yQ (small blind) showed [Jc Jd] and won ($10) with a pair of Jacks
Seat 3: 8ClCHtFXGNplITm+63KB+Q (big blind) folded before Flop
Seat 4: NzIFHwilc5zU7QhjDTgTZA mucked
Seat 5: GC/9yVD59DUCX7hUI7gcLw folded before Flop (didn't bet)
Seat 6: 0DvgWV5o6c/jYqQCjm4Haw folded before Flop (didn't bet)




PokerStars Game #59939680334:  Hold'em No Limit ($0.10/$0.25) - 2009/07/01 0:46:08 ET
Table 'aaXqTKUnxrX9DYXtxhWXxA' 6-max Seat #5 is the button
Seat 1: njVkfGYrPiXfq4zLcgfVuA ($12.30 in chips) 
Seat 2: 1Zyw8DT57U6TzxWWRixa6Q ($10.45 in chips) 
Seat 3: cPO/1/dTcZpLkQFm3jH3Rg ($25 in chips) 
Seat 5: kyRaCIljYA6l33lSKQfNsg ($23.80 in chips) 
Seat 6: buyjetgNT1McXtdaP4zynA ($29.30 in chips) 
buyjetgNT1McXtdaP4zynA: posts small blind $0.10
njVkfGYrPiXfq4zLcgfVuA: posts big blind $0.25
*** HOLE CARDS ***
1Zyw8DT57U6TzxWWRixa6Q: folds 
cPO/1/dTcZpLkQFm3jH3Rg: folds 
kyRaCIljYA6l33lSKQfNsg: raises $0.50 to $0.75
4YSTu0Cdzpppe1lUgCZGCQ has returned
4YSTu0Cdzpppe1lUgCZGCQ leaves the table
buyjetgNT1McXtdaP4zynA: calls $0.65
njVkfGYrPiXfq4zLcgfVuA: folds 
*** FLOP *** [Qs 6c 3d]
njVkfGYrPiXfq4zLcgfVuA leaves the table
v8m8XHovI5tqEA9mvplDSw joins the table at seat #4 
buyjetgNT1McXtdaP4zynA: checks 
kyRaCIljYA6l33lSKQfNsg: bets $1
SFmT9ZsVopnukjvAzrxTRg joins the table at seat #1 
buyjetgNT1McXtdaP4zynA: folds 
Uncalled bet ($1) returned to kyRaCIljYA6l33lSKQfNsg
kyRaCIljYA6l33lSKQfNsg collected $1.70 from pot
*** SUMMARY ***
Total pot $1.75 | Rake $0.05 
Board [Qs 6c 3d]
Seat 1: njVkfGYrPiXfq4zLcgfVuA (big blind) folded before Flop
Seat 2: 1Zyw8DT57U6TzxWWRixa6Q folded before Flop (didn't bet)
Seat 3: cPO/1/dTcZpLkQFm3jH3Rg folded before Flop (didn't bet)
Seat 5: kyRaCIljYA6l33lSKQfNsg (button) collected ($1.70)
Seat 6: buyjetgNT1McXtdaP4zynA (small blind) folded on the Flop




PokerStars Game #59939680804:  Hold'em No Limit ($0.10/$0.25) - 2009/07/01 0:46:08 ET
Table 'JYkCJJ5Iv+Tu52jx2lpEcgT/iCKJXGphRN3xcdwfE/JQSeat #2 is the button
Seat 1: Yv4fucyyT28mjx8V5lxKJg ($30 in chips) 
Seat 2: hBMUlEpyU74r/fwDgIpXjQ ($35.25 in chips) 
Seat 3: Z5ZtGOON8kmSdSCll9Z3XA ($8.10 in chips) 
Seat 5: 6OVSxS1KoddUCYNkZ4hREw ($30.60 in chips) 
Seat 6: OiV1PWZ3IkN29JlmCcnTwQ ($4.65 in chips) 
Seat 7: N6fYvIzQLKaydFLKQGtMlQ ($22.30 in chips) 
Seat 9: H9KUl8cmpLgEpOVDA00bCg ($5.50 in chips) 
Z5ZtGOON8kmSdSCll9Z3XA: posts small blind $0.10
6OVSxS1KoddUCYNkZ4hREw: posts big blind $0.25
6RiVTYll/5D8zICp0MRpKw: sits out 
*** HOLE CARDS ***
OiV1PWZ3IkN29JlmCcnTwQ: folds 
N6fYvIzQLKaydFLKQGtMlQ: folds 
H9KUl8cmpLgEpOVDA00bCg: raises $0.75 to $1
Yv4fucyyT28mjx8V5lxKJg: folds 
hBMUlEpyU74r/fwDgIpXjQ: folds 
Z5ZtGOON8kmSdSCll9Z3XA: folds 
6OVSxS1KoddUCYNkZ4hREw: folds 
Uncalled bet ($0.75) returned to H9KUl8cmpLgEpOVDA00bCg
H9KUl8cmpLgEpOVDA00bCg collected $0.60 from pot
*** SUMMARY ***
Total pot $0.60 | Rake $0 
Seat 1: Yv4fucyyT28mjx8V5lxKJg folded before Flop (didn't bet)
Seat 2: hBMUlEpyU74r/fwDgIpXjQ (button) folded before Flop (didn't bet)
Seat 3: Z5ZtGOON8kmSdSCll9Z3XA (small blind) folded before Flop
Seat 5: 6OVSxS1KoddUCYNkZ4hREw (big blind) folded before Flop
Seat 6: OiV1PWZ3IkN29JlmCcnTwQ folded before Flop (didn't bet)
Seat 7: N6fYvIzQLKaydFLKQGtMlQ folded before Flop (didn't bet)
Seat 9: H9KUl8cmpLgEpOVDA00bCg collected ($0.60)




PokerStars Game #59939680610:  Hold'em No Limit ($0.10/$0.25) - 2009/07/01 0:46:08 ET
Table 'ouLhepGYovxB2x0QxH7cVg' 9-max Seat #6 is the button
Seat 1: ghNKXUBl/H+t83JF079ZBA ($30.35 in chips) 
Seat 2: r1Z5m4PwSI5ANp7qCE1OJw ($12.75 in chips) 
Seat 3: SkLOm0UugROBRt2EfMpOxQ ($23.75 in chips) 
Seat 4: a0Sx6GHY7ln2Ns2C97eXeA ($29.15 in chips) 
Seat 5: 18G4P1XstjNvItdGUITxgw ($25 in chips) 
Seat 6: r6hsffOo1iKmaPYKwAZmFw ($27.20 in chips) 
Seat 7: oHv2mIZJh3H0JR+WOZteZA ($23 in chips) 
Seat 8: opOCI2p6kW0tINuVaAqmcQ ($25 in chips) 
Seat 9: fIgGw0jPUR7labvJPaPbeg ($10.80 in chips) 
oHv2mIZJh3H0JR+WOZteZA: posts small blind $0.10
opOCI2p6kW0tINuVaAqmcQ: posts big blind $0.25
*** HOLE CARDS ***
fIgGw0jPUR7labvJPaPbeg: folds 
ghNKXUBl/H+t83JF079ZBA: folds 
r1Z5m4PwSI5ANp7qCE1OJw: folds 
SkLOm0UugROBRt2EfMpOxQ: folds 
a0Sx6GHY7ln2Ns2C97eXeA: folds 
18G4P1XstjNvItdGUITxgw: folds 
r6hsffOo1iKmaPYKwAZmFw: raises $0.75 to $1
oHv2mIZJh3H0JR+WOZteZA: folds 
opOCI2p6kW0tINuVaAqmcQ: folds 
Uncalled bet ($0.75) returned to r6hsffOo1iKmaPYKwAZmFw
r6hsffOo1iKmaPYKwAZmFw collected $0.60 from pot
r6hsffOo1iKmaPYKwAZmFw: doesn't show hand 
*** SUMMARY ***
Total pot $0.60 | Rake $0 
Seat 1: ghNKXUBl/H+t83JF079ZBA folded before Flop (didn't bet)
Seat 2: r1Z5m4PwSI5ANp7qCE1OJw folded before Flop (didn't bet)
Seat 3: SkLOm0UugROBRt2EfMpOxQ folded before Flop (didn't bet)
Seat 4: a0Sx6GHY7ln2Ns2C97eXeA folded before Flop (didn't bet)
Seat 5: 18G4P1XstjNvItdGUITxgw folded before Flop (didn't bet)
Seat 6: r6hsffOo1iKmaPYKwAZmFw (button) collected ($0.60)
Seat 7: oHv2mIZJh3H0JR+WOZteZA (small blind) folded before Flop
Seat 8: opOCI2p6kW0tINuVaAqmcQ (big blind) folded before Flop
Seat 9: fIgGw0jPUR7labvJPaPbeg folded before Flop (didn't bet)




PokerStars Game #59939680338:  Hold'em No Limit ($0.10/$0.25) - 2009/07/01 0:46:08 ET
Table 'KRiZ8S/xwAYkA4EWSX89ow' 9-max Seat #5 is the button
Seat 1: CYkY0dNBaYaKs8HVCVn3mQ ($7.45 in chips) 
Seat 2: vZGoOTJLQLhkPj4I+LNGig ($54.75 in chips) 
Seat 3: /fionJv+b9tkuIj/KKbXYw ($21.75 in chips) 
Seat 4: COsrwJSFHQtxlUcrYtDQPQ ($28.30 in chips) 
Seat 5: t2nb95S5EEFOEzNx9Itz0g ($4.95 in chips) 
Seat 6: DdPXdieucQ+n99u1n3A+rQ ($5.35 in chips) 
Seat 7: cZ99hugmLBj9KhTlc8nCSw ($25 in chips) 
Seat 8: nEg1b6MIksd/4x5eLY735g ($25.60 in chips) 
Seat 9: EcWpc/mcsCWBGKsSdZaXbA ($24.05 in chips) 
DdPXdieucQ+n99u1n3A+rQ: posts small blind $0.10
cZ99hugmLBj9KhTlc8nCSw: posts big blind $0.25
*** HOLE CARDS ***
nEg1b6MIksd/4x5eLY735g: folds 
EcWpc/mcsCWBGKsSdZaXbA: folds 
EcWpc/mcsCWBGKsSdZaXbA leaves the table
CYkY0dNBaYaKs8HVCVn3mQ: folds 
+WMpj67YqG8ilNkg2JwXpw joins the table at seat #9 
vZGoOTJLQLhkPj4I+LNGig: folds 
/fionJv+b9tkuIj/KKbXYw: folds 
COsrwJSFHQtxlUcrYtDQPQ: folds 
t2nb95S5EEFOEzNx9Itz0g: folds 
DdPXdieucQ+n99u1n3A+rQ: raises $0.50 to $0.75
cZ99hugmLBj9KhTlc8nCSw: folds 
Uncalled bet ($0.50) returned to DdPXdieucQ+n99u1n3A+rQ
DdPXdieucQ+n99u1n3A+rQ collected $0.50 from pot
DdPXdieucQ+n99u1n3A+rQ: doesn't show hand 
*** SUMMARY ***
Total pot $0.50 | Rake $0 
Seat 1: CYkY0dNBaYaKs8HVCVn3mQ folded before Flop (didn't bet)
Seat 2: vZGoOTJLQLhkPj4I+LNGig folded before Flop (didn't bet)
Seat 3: /fionJv+b9tkuIj/KKbXYw folded before Flop (didn't bet)
Seat 4: COsrwJSFHQtxlUcrYtDQPQ folded before Flop (didn't bet)
Seat 5: t2nb95S5EEFOEzNx9Itz0g (button) folded before Flop (didn't bet)
Seat 6: DdPXdieucQ+n99u1n3A+rQ (small blind) collected ($0.50)
Seat 7: cZ99hugmLBj9KhTlc8nCSw (big blind) folded before Flop
Seat 8: nEg1b6MIksd/4x5eLY735g folded before Flop (didn't bet)
Seat 9: EcWpc/mcsCWBGKsSdZaXbA folded before Flop (didn't bet)




PokerStars Game #59939680302:  Hold'em No Limit ($0.10/$0.25) - 2009/07/01 0:46:08 ET
Table 'mdub7rJf3Z5tCT9s/+1+Wg' 9-max Seat #5 is the button
Seat 1: neWdS67T0XWLJXFjrqXj5g ($15.15 in chips) 
Seat 3: t2nb95S5EEFOEzNx9Itz0g ($4.65 in chips) 
Seat 4: fDGyaQz0cs2s4FOYxkbIHA ($14.65 in chips) 
Seat 5: dfNim92Z6XK1/h5SFW5vDg ($25.45 in chips) 
Seat 6: hAFbY0iBwr4mouozgvjZBg ($49.35 in chips) 
Seat 7: woe+9KKk+L3pZgMTuHcmog ($32.05 in chips) 
Seat 8: cZ99hugmLBj9KhTlc8nCSw ($25 in chips) 
Seat 9: tYsOBqdU1+x+yFI7zHO7hQ ($36.40 in chips) 
hAFbY0iBwr4mouozgvjZBg: posts small blind $0.10
woe+9KKk+L3pZgMTuHcmog: posts big blind $0.25
*** HOLE CARDS ***
cZ99hugmLBj9KhTlc8nCSw: folds 
cZ99hugmLBj9KhTlc8nCSw leaves the table
tYsOBqdU1+x+yFI7zHO7hQ: folds 
neWdS67T0XWLJXFjrqXj5g: folds 
t2nb95S5EEFOEzNx9Itz0g: folds 
fDGyaQz0cs2s4FOYxkbIHA: folds 
dfNim92Z6XK1/h5SFW5vDg: folds 
22dIObOuor/A+IKWkNoAlA joins the table at seat #8 
hAFbY0iBwr4mouozgvjZBg: raises $0.50 to $0.75
woe+9KKk+L3pZgMTuHcmog: calls $0.50
*** FLOP *** [Ts Kh 2d]
hAFbY0iBwr4mouozgvjZBg: bets $0.75
woe+9KKk+L3pZgMTuHcmog: calls $0.75
*** TURN *** [Ts Kh 2d] [8h]
hAFbY0iBwr4mouozgvjZBg: bets $0.75
woe+9KKk+L3pZgMTuHcmog: raises $0.75 to $1.50
hAFbY0iBwr4mouozgvjZBg: calls $0.75
*** RIVER *** [Ts Kh 2d 8h] [9c]
hAFbY0iBwr4mouozgvjZBg: checks 
woe+9KKk+L3pZgMTuHcmog: checks 
*** SHOW DOWN ***
hAFbY0iBwr4mouozgvjZBg: shows [Ac Ah] (a pair of Aces)
woe+9KKk+L3pZgMTuHcmog: shows [Tc 8d] (two pair, Tens and Eights)
woe+9KKk+L3pZgMTuHcmog collected $5.75 from pot
*** SUMMARY ***
Total pot $6 | Rake $0.25 
Board [Ts Kh 2d 8h 9c]
Seat 1: neWdS67T0XWLJXFjrqXj5g folded before Flop (didn't bet)
Seat 3: t2nb95S5EEFOEzNx9Itz0g folded before Flop (didn't bet)
Seat 4: fDGyaQz0cs2s4FOYxkbIHA folded before Flop (didn't bet)
Seat 5: dfNim92Z6XK1/h5SFW5vDg (button) folded before Flop (didn't bet)
Seat 6: hAFbY0iBwr4mouozgvjZBg (small blind) showed [Ac Ah] and lost with a pair of Aces
Seat 7: woe+9KKk+L3pZgMTuHcmog (big blind) showed [Tc 8d] and won ($5.75) with two pair, Tens and Eights
Seat 8: cZ99hugmLBj9KhTlc8nCSw folded before Flop (didn't bet)
Seat 9: tYsOBqdU1+x+yFI7zHO7hQ folded before Flop (didn't bet)




PokerStars Game #59939680730:  Hold'em No Limit ($0.10/$0.25) - 2009/07/01 0:46:08 ET
Table '6aL2C8IFwHHr6SG6RgXaow' 9-max Seat #3 is the button
Seat 1: Z9AeOQX3yzuSvKAm/xyovg ($10 in chips) 
Seat 2: +gMmKt3DaQng9M42CmxIZg ($19.70 in chips) 
Seat 3: aCVg6cCxQcqClhB9nq/p1w ($24.65 in chips) 
Seat 4: tAxW5XKyzLgVZEyECMLCGw ($5.50 in chips) 
Seat 5: wre31HfyzQGpIvID1istxw ($16 in chips) 
Seat 6: HxDF4QSxC4z39D7teZpprQ ($33.35 in chips) 
Seat 7: rPToQDbLWB+dKnz7fcQSIg ($11.60 in chips) 
Seat 8: rQhYIYXSyH/IivYM1dlV5A ($20.75 in chips) 
tAxW5XKyzLgVZEyECMLCGw: posts small blind $0.10
wre31HfyzQGpIvID1istxw: posts big blind $0.25
jakethereed: sits out 
Z9AeOQX3yzuSvKAm/xyovg: posts big blind $0.25
*** HOLE CARDS ***
HxDF4QSxC4z39D7teZpprQ: calls $0.25
rPToQDbLWB+dKnz7fcQSIg: folds 
rQhYIYXSyH/IivYM1dlV5A: calls $0.25
Z9AeOQX3yzuSvKAm/xyovg: raises $1 to $1.25
+gMmKt3DaQng9M42CmxIZg: folds 
aCVg6cCxQcqClhB9nq/p1w: folds 
rPToQDbLWB+dKnz7fcQSIg is sitting out
tAxW5XKyzLgVZEyECMLCGw: folds 
wre31HfyzQGpIvID1istxw: calls $1
HxDF4QSxC4z39D7teZpprQ: calls $1
rQhYIYXSyH/IivYM1dlV5A: calls $1
*** FLOP *** [4c Tc 7h]
wre31HfyzQGpIvID1istxw: checks 
HxDF4QSxC4z39D7teZpprQ: checks 
rQhYIYXSyH/IivYM1dlV5A: bets $2
tAxW5XKyzLgVZEyECMLCGw said, "piper you like pipe"
Z9AeOQX3yzuSvKAm/xyovg: raises $6.75 to $8.75 and is all-in
wre31HfyzQGpIvID1istxw: folds 
HxDF4QSxC4z39D7teZpprQ: folds 
rQhYIYXSyH/IivYM1dlV5A said, "are you bluffing?"
tAxW5XKyzLgVZEyECMLCGw said, "yes"
tAxW5XKyzLgVZEyECMLCGw said, "hes bluffing"
rQhYIYXSyH/IivYM1dlV5A said, "you show if i fold?"
tAxW5XKyzLgVZEyECMLCGw said, "grow a pair"
rQhYIYXSyH/IivYM1dlV5A: folds 
Uncalled bet ($6.75) returned to Z9AeOQX3yzuSvKAm/xyovg
Z9AeOQX3yzuSvKAm/xyovg collected $8.70 from pot
*** SUMMARY ***
Total pot $9.10 | Rake $0.40 
Board [4c Tc 7h]
Seat 1: Z9AeOQX3yzuSvKAm/xyovg collected ($8.70)
Seat 2: +gMmKt3DaQng9M42CmxIZg folded before Flop (didn't bet)
Seat 3: aCVg6cCxQcqClhB9nq/p1w (button) folded before Flop (didn't bet)
Seat 4: tAxW5XKyzLgVZEyECMLCGw (small blind) folded before Flop
Seat 5: wre31HfyzQGpIvID1istxw (big blind) folded on the Flop
Seat 6: HxDF4QSxC4z39D7teZpprQ folded on the Flop
Seat 7: rPToQDbLWB+dKnz7fcQSIg folded before Flop (didn't bet)
Seat 8: rQhYIYXSyH/IivYM1dlV5A folded on the Flop




PokerStars Game #59939681002:  Hold'em No Limit ($0.10/$0.25) - 2009/07/01 0:46:09 ET
Table '9o8Yb3JpUqurD4pNVmOikQ' 6-max Seat #6 is the button
Seat 1: 5tB0F9NjPSUL4FzmzBMs2Q ($25.10 in chips) 
Seat 2: /gJNBeCkWL4o85/jvlZ4BA ($25.25 in chips) 
Seat 3: JgRqo1/2phbf7pab7N3BIQ ($13.90 in chips) 
Seat 6: k9vn40MOqqb+xF+7GZ6v2g ($33.80 in chips) 
5tB0F9NjPSUL4FzmzBMs2Q: posts small blind $0.10
/gJNBeCkWL4o85/jvlZ4BA: posts big blind $0.25
4kWQxGbT5FZ1dkPd1bE45Q: sits out 
*** HOLE CARDS ***
JgRqo1/2phbf7pab7N3BIQ: folds 
k9vn40MOqqb+xF+7GZ6v2g: folds 
5tB0F9NjPSUL4FzmzBMs2Q: raises $0.75 to $1
E/9GotBXacjJ6UrYx7l+KQ joins the table at seat #5 
/gJNBeCkWL4o85/jvlZ4BA: folds 
Uncalled bet ($0.75) returned to 5tB0F9NjPSUL4FzmzBMs2Q
5tB0F9NjPSUL4FzmzBMs2Q collected $0.50 from pot
*** SUMMARY ***
Total pot $0.50 | Rake $0 
Seat 1: 5tB0F9NjPSUL4FzmzBMs2Q (small blind) collected ($0.50)
Seat 2: /gJNBeCkWL4o85/jvlZ4BA (big blind) folded before Flop
Seat 3: JgRqo1/2phbf7pab7N3BIQ folded before Flop (didn't bet)
Seat 6: k9vn40MOqqb+xF+7GZ6v2g (button) folded before Flop (didn't bet)




PokerStars Game #59939681266:  Hold'em No Limit ($0.10/$0.25) - 2009/07/01 0:46:09 ET
Table '0M5QEJGOThqZwQ/sjbjXYw' 6-max Seat #6 is the button
Seat 1: RVBrV53KVTJ2T2VL8ucnfw ($26.95 in chips) 
Seat 2: /gJNBeCkWL4o85/jvlZ4BA ($44.10 in chips) 
Seat 4: fZQg9veL7Dd/Z04ZTjC+wQ ($25 in chips) 
Seat 5: ErIN0JRL5srYjT6en1f8YQ ($52.60 in chips) 
Seat 6: mYz11CHiw5KsDCRD5T7/jg ($58.90 in chips) 
RVBrV53KVTJ2T2VL8ucnfw: posts small blind $0.10
/gJNBeCkWL4o85/jvlZ4BA: posts big blind $0.25
d0J1xuhsynEY81YHwAvJ5g: sits out 
*** HOLE CARDS ***
fZQg9veL7Dd/Z04ZTjC+wQ: folds 
ErIN0JRL5srYjT6en1f8YQ: folds 
mYz11CHiw5KsDCRD5T7/jg: calls $0.25
RVBrV53KVTJ2T2VL8ucnfw: calls $0.15
/gJNBeCkWL4o85/jvlZ4BA: checks 
*** FLOP *** [Jd Qh 6d]
RVBrV53KVTJ2T2VL8ucnfw: checks 
/gJNBeCkWL4o85/jvlZ4BA: checks 
mYz11CHiw5KsDCRD5T7/jg: checks 
*** TURN *** [Jd Qh 6d] [Ah]
RVBrV53KVTJ2T2VL8ucnfw: bets $0.75
/gJNBeCkWL4o85/jvlZ4BA: calls $0.75
mYz11CHiw5KsDCRD5T7/jg: folds 
*** RIVER *** [Jd Qh 6d Ah] [7d]
RVBrV53KVTJ2T2VL8ucnfw: bets $2.25
/gJNBeCkWL4o85/jvlZ4BA: folds 
Uncalled bet ($2.25) returned to RVBrV53KVTJ2T2VL8ucnfw
RVBrV53KVTJ2T2VL8ucnfw collected $2.15 from pot
RVBrV53KVTJ2T2VL8ucnfw: doesn't show hand 
*** SUMMARY ***
Total pot $2.25 | Rake $0.10 
Board [Jd Qh 6d Ah 7d]
Seat 1: RVBrV53KVTJ2T2VL8ucnfw (small blind) collected ($2.15)
Seat 2: /gJNBeCkWL4o85/jvlZ4BA (big blind) folded on the River
Seat 4: fZQg9veL7Dd/Z04ZTjC+wQ folded before Flop (didn't bet)
Seat 5: ErIN0JRL5srYjT6en1f8YQ folded before Flop (didn't bet)
Seat 6: mYz11CHiw5KsDCRD5T7/jg (button) folded on the Turn




PokerStars Game #59939681170:  Hold'em No Limit ($0.10/$0.25) - 2009/07/01 0:46:09 ET
Table 'i93c3z9RLowvuJTKA2F4Jg' 6-max Seat #1 is the button
Seat 1: tbSZq5LHglyHk61mH9eDBw ($27.35 in chips) 
Seat 2: TSmua8tGK3sTbwi0ynrW9Q ($25 in chips) 
Seat 3: tVIFo6yuan1xauX1WIjH2w ($8.80 in chips) 
Seat 4: o86X2Q5GEDU3uP9oj1iFZA ($27.20 in chips) 
Seat 5: lYjWCpfCxX2kgcHY3v4Yow ($32.35 in chips) 
Seat 6: aSrj4lVmn2owyQ1RbbOqxQ ($32.80 in chips) 
TSmua8tGK3sTbwi0ynrW9Q: posts small blind $0.10
tVIFo6yuan1xauX1WIjH2w: posts big blind $0.25
*** HOLE CARDS ***
o86X2Q5GEDU3uP9oj1iFZA: folds 
lYjWCpfCxX2kgcHY3v4Yow: folds 
aSrj4lVmn2owyQ1RbbOqxQ: calls $0.25
tbSZq5LHglyHk61mH9eDBw: raises $0.75 to $1
TSmua8tGK3sTbwi0ynrW9Q: calls $0.90
tVIFo6yuan1xauX1WIjH2w: calls $0.75
aSrj4lVmn2owyQ1RbbOqxQ: folds 
*** FLOP *** [7c 6h Qd]
TSmua8tGK3sTbwi0ynrW9Q: checks 
tVIFo6yuan1xauX1WIjH2w: checks 
tbSZq5LHglyHk61mH9eDBw: bets $1.25
TSmua8tGK3sTbwi0ynrW9Q: folds 
tVIFo6yuan1xauX1WIjH2w: calls $1.25
*** TURN *** [7c 6h Qd] [Qc]
tVIFo6yuan1xauX1WIjH2w: checks 
tbSZq5LHglyHk61mH9eDBw: checks 
*** RIVER *** [7c 6h Qd Qc] [4s]
tVIFo6yuan1xauX1WIjH2w: bets $1.75
tbSZq5LHglyHk61mH9eDBw: calls $1.75
*** SHOW DOWN ***
tVIFo6yuan1xauX1WIjH2w: shows [Qs 9s] (three of a kind, Queens)
tbSZq5LHglyHk61mH9eDBw: shows [9d 9c] (two pair, Queens and Nines)
tVIFo6yuan1xauX1WIjH2w collected $8.80 from pot
*** SUMMARY ***
Total pot $9.25 | Rake $0.45 
Board [7c 6h Qd Qc 4s]
Seat 1: tbSZq5LHglyHk61mH9eDBw (button) showed [9d 9c] and lost with two pair, Queens and Nines
Seat 2: TSmua8tGK3sTbwi0ynrW9Q (small blind) folded on the Flop
Seat 3: tVIFo6yuan1xauX1WIjH2w (big blind) showed [Qs 9s] and won ($8.80) with three of a kind, Queens
Seat 4: o86X2Q5GEDU3uP9oj1iFZA folded before Flop (didn't bet)
Seat 5: lYjWCpfCxX2kgcHY3v4Yow folded before Flop (didn't bet)
Seat 6: aSrj4lVmn2owyQ1RbbOqxQ folded before Flop




PokerStars Game #59939680878:  Hold'em No Limit ($0.10/$0.25) - 2009/07/01 0:46:09 ET
Table 'tq5CvS0RUqGkuBK0XTzqqg' 6-max Seat #4 is the button
Seat 1: 39EF5EcifdyPS7v+EnfxLg ($16.55 in chips) 
Seat 2: mfrkWA3PTeYPkbO6hi98Aw ($68.85 in chips) 
Seat 3: PbMzPZIePKifKQZfKDkbIw ($26.55 in chips) 
Seat 4: W7FS+h5B+OhmwF+cTt3ZPQ ($19.10 in chips) 
Seat 5: qGHGf/553gQnDoklMRe3tg ($23.50 in chips) 
Seat 6: hOfhw8jxWiq14wXGL4Bh/Q ($15.50 in chips) 
qGHGf/553gQnDoklMRe3tg: posts small blind $0.10
hOfhw8jxWiq14wXGL4Bh/Q: posts big blind $0.25
*** HOLE CARDS ***
39EF5EcifdyPS7v+EnfxLg: raises $0.25 to $0.50
mfrkWA3PTeYPkbO6hi98Aw: folds 
PbMzPZIePKifKQZfKDkbIw: calls $0.50
W7FS+h5B+OhmwF+cTt3ZPQ: calls $0.50
qGHGf/553gQnDoklMRe3tg: folds 
hOfhw8jxWiq14wXGL4Bh/Q: folds 
*** FLOP *** [Qh 5d 7c]
39EF5EcifdyPS7v+EnfxLg: checks 
PbMzPZIePKifKQZfKDkbIw: checks 
W7FS+h5B+OhmwF+cTt3ZPQ: checks 
*** TURN *** [Qh 5d 7c] [7h]
39EF5EcifdyPS7v+EnfxLg: bets $0.50
PbMzPZIePKifKQZfKDkbIw: raises $1.25 to $1.75
W7FS+h5B+OhmwF+cTt3ZPQ: folds 
39EF5EcifdyPS7v+EnfxLg: folds 
Uncalled bet ($1.25) returned to PbMzPZIePKifKQZfKDkbIw
PbMzPZIePKifKQZfKDkbIw collected $2.75 from pot
*** SUMMARY ***
Total pot $2.85 | Rake $0.10 
Board [Qh 5d 7c 7h]
Seat 1: 39EF5EcifdyPS7v+EnfxLg folded on the Turn
Seat 2: mfrkWA3PTeYPkbO6hi98Aw folded before Flop (didn't bet)
Seat 3: PbMzPZIePKifKQZfKDkbIw collected ($2.75)
Seat 4: W7FS+h5B+OhmwF+cTt3ZPQ (button) folded on the Turn
Seat 5: qGHGf/553gQnDoklMRe3tg (small blind) folded before Flop
Seat 6: hOfhw8jxWiq14wXGL4Bh/Q (big blind) folded before Flop




PokerStars Game #59939681682:  Hold'em No Limit ($0.10/$0.25) - 2009/07/01 0:46:10 ET
Table 'O5NgMYt6EWbLBozZb3kseg' 6-max Seat #5 is the button
Seat 1: T2fEtpqj5ZyZAjEhNtsFAA ($56.50 in chips) 
Seat 2: VWbjqONyDvf8KegytgPLjQ ($57.75 in chips) 
Seat 3: dg3SMYXD7586yGx+LuFM0g ($20 in chips) 
Seat 4: aogAb4Eienxztk8p2v9VVw ($25 in chips) 
Seat 5: vu2kzHaDtgr6NM7rdq0chA ($75.05 in chips) 
Seat 6: k9vn40MOqqb+xF+7GZ6v2g ($18.75 in chips) 
k9vn40MOqqb+xF+7GZ6v2g: posts small blind $0.10
T2fEtpqj5ZyZAjEhNtsFAA: posts big blind $0.25
dg3SMYXD7586yGx+LuFM0g: posts small & big blinds $0.35
aogAb4Eienxztk8p2v9VVw: posts small & big blinds $0.35
*** HOLE CARDS ***
VWbjqONyDvf8KegytgPLjQ: folds 
dg3SMYXD7586yGx+LuFM0g: checks 
aogAb4Eienxztk8p2v9VVw: checks 
vu2kzHaDtgr6NM7rdq0chA: folds 
k9vn40MOqqb+xF+7GZ6v2g: calls $0.15
T2fEtpqj5ZyZAjEhNtsFAA: checks 
*** FLOP *** [Qh 8s 6c]
k9vn40MOqqb+xF+7GZ6v2g: checks 
T2fEtpqj5ZyZAjEhNtsFAA: checks 
dg3SMYXD7586yGx+LuFM0g: checks 
aogAb4Eienxztk8p2v9VVw: bets $0.50
k9vn40MOqqb+xF+7GZ6v2g: folds 
T2fEtpqj5ZyZAjEhNtsFAA: folds 
dg3SMYXD7586yGx+LuFM0g: calls $0.50
*** TURN *** [Qh 8s 6c] [Ac]
dg3SMYXD7586yGx+LuFM0g: checks 
aogAb4Eienxztk8p2v9VVw: bets $1
dg3SMYXD7586yGx+LuFM0g: folds 
Uncalled bet ($1) returned to aogAb4Eienxztk8p2v9VVw
aogAb4Eienxztk8p2v9VVw collected $2.10 from pot
aogAb4Eienxztk8p2v9VVw: doesn't show hand 
*** SUMMARY ***
Total pot $2.20 | Rake $0.10 
Board [Qh 8s 6c Ac]
Seat 1: T2fEtpqj5ZyZAjEhNtsFAA (big blind) folded on the Flop
Seat 2: VWbjqONyDvf8KegytgPLjQ folded before Flop (didn't bet)
Seat 3: dg3SMYXD7586yGx+LuFM0g folded on the Turn
Seat 4: aogAb4Eienxztk8p2v9VVw collected ($2.10)
Seat 5: vu2kzHaDtgr6NM7rdq0chA (button) folded before Flop (didn't bet)
Seat 6: k9vn40MOqqb+xF+7GZ6v2g (small blind) folded on the Flop




PokerStars Game #59939682088:  Hold'em No Limit ($0.10/$0.25) - 2009/07/01 0:46:10 ET
Table 'g+mPuNJBCHKE9ents7ZGtg' 6-max Seat #2 is the button
Seat 1: YaAEMJGY5tem39deCUQRNw ($24 in chips) 
Seat 2: fZQg9veL7Dd/Z04ZTjC+wQ ($30.35 in chips) 
Seat 3: 9jSiy0meE9XJKkdIZwyTEQ ($36.20 in chips) 
Seat 4: mfrkWA3PTeYPkbO6hi98Aw ($24.65 in chips) 
Seat 5: 32YL2ZEp8NT4JB2RVM9euQ ($15.65 in chips) 
Seat 6: MS2T205Bjud7PnNoANu4vQ ($45.95 in chips) 
9jSiy0meE9XJKkdIZwyTEQ: posts small blind $0.10
mfrkWA3PTeYPkbO6hi98Aw: posts big blind $0.25
*** HOLE CARDS ***
32YL2ZEp8NT4JB2RVM9euQ has timed out
32YL2ZEp8NT4JB2RVM9euQ: folds 
32YL2ZEp8NT4JB2RVM9euQ is sitting out
32YL2ZEp8NT4JB2RVM9euQ has returned
MS2T205Bjud7PnNoANu4vQ: raises $0.50 to $0.75
YaAEMJGY5tem39deCUQRNw: folds 
fZQg9veL7Dd/Z04ZTjC+wQ: folds 
9jSiy0meE9XJKkdIZwyTEQ: folds 
mfrkWA3PTeYPkbO6hi98Aw: folds 
Uncalled bet ($0.50) returned to MS2T205Bjud7PnNoANu4vQ
MS2T205Bjud7PnNoANu4vQ collected $0.60 from pot
*** SUMMARY ***
Total pot $0.60 | Rake $0 
Seat 1: YaAEMJGY5tem39deCUQRNw folded before Flop (didn't bet)
Seat 2: fZQg9veL7Dd/Z04ZTjC+wQ (button) folded before Flop (didn't bet)
Seat 3: 9jSiy0meE9XJKkdIZwyTEQ (small blind) folded before Flop
Seat 4: mfrkWA3PTeYPkbO6hi98Aw (big blind) folded before Flop
Seat 5: 32YL2ZEp8NT4JB2RVM9euQ folded before Flop (didn't bet)
Seat 6: MS2T205Bjud7PnNoANu4vQ collected ($0.60)




PokerStars Game #59939681802:  Hold'em No Limit ($0.10/$0.25) - 2009/07/01 0:46:10 ET
Table 'sIHZ0lzLr4NGCaBUKhmYhA' 6-max Seat #2 is the button
Seat 1: q6WfTUAD9mowIP63ASq2Dg ($40.70 in chips) 
Seat 2: 1xmHIWgZaOCqEMnW2GkFfw ($4.40 in chips) 
Seat 3: SxIIgwXYLkwd6m3wLyPTCw ($25 in chips) 
Seat 4: 4YSTu0Cdzpppe1lUgCZGCQ ($33.40 in chips) 
Seat 5: GJsS3gwVwlbyroaWrnjqJg ($25.40 in chips) 
SxIIgwXYLkwd6m3wLyPTCw: posts small blind $0.10
4YSTu0Cdzpppe1lUgCZGCQ: posts big blind $0.25
*** HOLE CARDS ***
GJsS3gwVwlbyroaWrnjqJg: folds 
q6WfTUAD9mowIP63ASq2Dg has timed out
q6WfTUAD9mowIP63ASq2Dg: folds 
q6WfTUAD9mowIP63ASq2Dg is sitting out
1xmHIWgZaOCqEMnW2GkFfw: calls $0.25
82p+w3EmUaFFHuwpSeGY1w joins the table at seat #6 
SxIIgwXYLkwd6m3wLyPTCw: folds 
q6WfTUAD9mowIP63ASq2Dg has returned
4YSTu0Cdzpppe1lUgCZGCQ: checks 
*** FLOP *** [Ac Jd 4c]
4YSTu0Cdzpppe1lUgCZGCQ: checks 
1xmHIWgZaOCqEMnW2GkFfw: checks 
*** TURN *** [Ac Jd 4c] [6h]
4YSTu0Cdzpppe1lUgCZGCQ: checks 
1xmHIWgZaOCqEMnW2GkFfw: checks 
*** RIVER *** [Ac Jd 4c 6h] [5s]
4YSTu0Cdzpppe1lUgCZGCQ: checks 
1xmHIWgZaOCqEMnW2GkFfw: checks 
*** SHOW DOWN ***
4YSTu0Cdzpppe1lUgCZGCQ: shows [5d 2c] (a pair of Fives)
1xmHIWgZaOCqEMnW2GkFfw: mucks hand 
4YSTu0Cdzpppe1lUgCZGCQ collected $0.60 from pot
*** SUMMARY ***
Total pot $0.60 | Rake $0 
Board [Ac Jd 4c 6h 5s]
Seat 1: q6WfTUAD9mowIP63ASq2Dg folded before Flop (didn't bet)
Seat 2: 1xmHIWgZaOCqEMnW2GkFfw (button) mucked
Seat 3: SxIIgwXYLkwd6m3wLyPTCw (small blind) folded before Flop
Seat 4: 4YSTu0Cdzpppe1lUgCZGCQ (big blind) showed [5d 2c] and won ($0.60) with a pair of Fives
Seat 5: GJsS3gwVwlbyroaWrnjqJg folded before Flop (didn't bet)




PokerStars Game #59939681946:  Hold'em No Limit ($0.10/$0.25) - 2009/07/01 0:46:10 ET
Table 'IIO2q2znuuAXmiZ2qFTcmgiHlyuN1lFZ6WTlMBiiMYXAx Seat #3 is the button
Seat 2: R6nIVAjK7uhK3Hj0f85A+A ($30.05 in chips) 
Seat 3: QGjA4xtpxSpgzm+HC+ps4w ($21.60 in chips) 
Seat 4: z5GxcHlYz/GSz6W2uFiTtg ($23.90 in chips) 
Seat 7: f4BMia+2fXTujHMlpcXcbA ($12.45 in chips) 
Seat 8: TeWJxSETzbXGiYKx0y+dtg ($25 in chips) 
z5GxcHlYz/GSz6W2uFiTtg: posts small blind $0.10
f4BMia+2fXTujHMlpcXcbA: posts big blind $0.25
*** HOLE CARDS ***
TeWJxSETzbXGiYKx0y+dtg: folds 
R6nIVAjK7uhK3Hj0f85A+A: folds 
QGjA4xtpxSpgzm+HC+ps4w: folds 
z5GxcHlYz/GSz6W2uFiTtg: calls $0.15
f4BMia+2fXTujHMlpcXcbA: checks 
*** FLOP *** [Jh Kh 2d]
z5GxcHlYz/GSz6W2uFiTtg: checks 
f4BMia+2fXTujHMlpcXcbA: bets $0.75
z5GxcHlYz/GSz6W2uFiTtg: folds 
Uncalled bet ($0.75) returned to f4BMia+2fXTujHMlpcXcbA
f4BMia+2fXTujHMlpcXcbA collected $0.50 from pot
*** SUMMARY ***
Total pot $0.50 | Rake $0 
Board [Jh Kh 2d]
Seat 2: R6nIVAjK7uhK3Hj0f85A+A folded before Flop (didn't bet)
Seat 3: QGjA4xtpxSpgzm+HC+ps4w (button) folded before Flop (didn't bet)
Seat 4: z5GxcHlYz/GSz6W2uFiTtg (small blind) folded on the Flop
Seat 7: f4BMia+2fXTujHMlpcXcbA (big blind) collected ($0.50)
Seat 8: TeWJxSETzbXGiYKx0y+dtg folded before Flop (didn't bet)




PokerStars Game #59939682348:  Hold'em No Limit ($0.10/$0.25) - 2009/07/01 0:46:11 ET
Table '+UzantPJ4smVdrh+4GTu1w' 6-max Seat #4 is the button
Seat 2: tcbEu7VzyHQ+0lh+skbQhQ ($14.95 in chips) 
Seat 3: SS/yfeArhULzIcOPe8MdPg ($50.90 in chips) 
Seat 4: IGRfskE1v9H9Bn+fz8AgNQ ($22.05 in chips) 
Seat 5: cj4VBQya7HtVL2zCGd5jLQ ($22.15 in chips) 
Seat 6: BYxjLnV1/LL0aZcTbfAOvw ($47.70 in chips) 
cj4VBQya7HtVL2zCGd5jLQ: posts small blind $0.10
BYxjLnV1/LL0aZcTbfAOvw: posts big blind $0.25
4jrz/IbtclK1xNH6lZqJNA: sits out 
*** HOLE CARDS ***
tcbEu7VzyHQ+0lh+skbQhQ: calls $0.25
SS/yfeArhULzIcOPe8MdPg: folds 
IGRfskE1v9H9Bn+fz8AgNQ: calls $0.25
cj4VBQya7HtVL2zCGd5jLQ: calls $0.15
BYxjLnV1/LL0aZcTbfAOvw: checks 
*** FLOP *** [4c Th Qh]
cj4VBQya7HtVL2zCGd5jLQ: checks 
BYxjLnV1/LL0aZcTbfAOvw: checks 
tcbEu7VzyHQ+0lh+skbQhQ: checks 
IGRfskE1v9H9Bn+fz8AgNQ: checks 
*** TURN *** [4c Th Qh] [9d]
cj4VBQya7HtVL2zCGd5jLQ: checks 
BYxjLnV1/LL0aZcTbfAOvw: checks 
tcbEu7VzyHQ+0lh+skbQhQ: checks 
IGRfskE1v9H9Bn+fz8AgNQ: checks 
*** RIVER *** [4c Th Qh 9d] [Ts]
cj4VBQya7HtVL2zCGd5jLQ: checks 
BYxjLnV1/LL0aZcTbfAOvw: checks 
tcbEu7VzyHQ+0lh+skbQhQ: checks 
IGRfskE1v9H9Bn+fz8AgNQ: checks 
*** SHOW DOWN ***
cj4VBQya7HtVL2zCGd5jLQ: shows [6s 2h] (a pair of Tens)
BYxjLnV1/LL0aZcTbfAOvw: shows [Jc 9s] (two pair, Tens and Nines)
tcbEu7VzyHQ+0lh+skbQhQ: mucks hand 
IGRfskE1v9H9Bn+fz8AgNQ: mucks hand 
BYxjLnV1/LL0aZcTbfAOvw collected $0.95 from pot
*** SUMMARY ***
Total pot $1 | Rake $0.05 
Board [4c Th Qh 9d Ts]
Seat 2: tcbEu7VzyHQ+0lh+skbQhQ mucked
Seat 3: SS/yfeArhULzIcOPe8MdPg folded before Flop (didn't bet)
Seat 4: IGRfskE1v9H9Bn+fz8AgNQ (button) mucked
Seat 5: cj4VBQya7HtVL2zCGd5jLQ (small blind) showed [6s 2h] and lost with a pair of Tens
Seat 6: BYxjLnV1/LL0aZcTbfAOvw (big blind) showed [Jc 9s] and won ($0.95) with two pair, Tens and Nines




PokerStars Game #59939682120:  Hold'em No Limit ($0.10/$0.25) - 2009/07/01 0:46:11 ET
Table '63h13e5p7cWe02rClZ1CHw' 6-max Seat #5 is the button
Seat 1: 7VfhiFY533nbUKvyEthASw ($7.80 in chips) 
Seat 2: k9nHZTHt8hYhYRcW8NTb4g ($21 in chips) 
Seat 3: 9jSiy0meE9XJKkdIZwyTEQ ($34.25 in chips) 
Seat 4: myagrRAhs0mdgmh5GNqvCw ($4 in chips) 
Seat 5: bE34il0XYGjWPD5/vbkMaQ ($22.15 in chips) 
Seat 6: mfrkWA3PTeYPkbO6hi98Aw ($22.25 in chips) 
mfrkWA3PTeYPkbO6hi98Aw: posts small blind $0.10
7VfhiFY533nbUKvyEthASw: posts big blind $0.25
*** HOLE CARDS ***
k9nHZTHt8hYhYRcW8NTb4g: folds 
9jSiy0meE9XJKkdIZwyTEQ: folds 
myagrRAhs0mdgmh5GNqvCw: folds 
bE34il0XYGjWPD5/vbkMaQ: folds 
mfrkWA3PTeYPkbO6hi98Aw: folds 
Uncalled bet ($0.15) returned to 7VfhiFY533nbUKvyEthASw
7VfhiFY533nbUKvyEthASw collected $0.20 from pot
7VfhiFY533nbUKvyEthASw: doesn't show hand 
*** SUMMARY ***
Total pot $0.20 | Rake $0 
Seat 1: 7VfhiFY533nbUKvyEthASw (big blind) collected ($0.20)
Seat 2: k9nHZTHt8hYhYRcW8NTb4g folded before Flop (didn't bet)
Seat 3: 9jSiy0meE9XJKkdIZwyTEQ folded before Flop (didn't bet)
Seat 4: myagrRAhs0mdgmh5GNqvCw folded before Flop (didn't bet)
Seat 5: bE34il0XYGjWPD5/vbkMaQ (button) folded before Flop (didn't bet)
Seat 6: mfrkWA3PTeYPkbO6hi98Aw (small blind) folded before Flop




PokerStars Game #59939682162:  Hold'em No Limit ($0.10/$0.25) - 2009/07/01 0:46:11 ET
Table 'nc6OeGk/wtaWV+6N+kgnZQ' 6-max Seat #4 is the button
Seat 1: 0/FYfBoKhINaqU/H5OSS1A ($1.25 in chips) 
Seat 2: 4vTIxEd0Qfkak22W0G6sTg ($12.20 in chips) 
Seat 3: 8f0dtuUGqDbgE6up1lQAlg ($20.55 in chips) 
Seat 4: UfU14XiqkyIQoIJy9COOsQ ($24.85 in chips) 
Seat 5: ymz+a8dgHSUFPooYplw7Ow ($24.75 in chips) 
Seat 6: Mch463E1dxQfVob352za6w ($25 in chips) 
ymz+a8dgHSUFPooYplw7Ow: posts small blind $0.10
Mch463E1dxQfVob352za6w: posts big blind $0.25
*** HOLE CARDS ***
8f0dtuUGqDbgE6up1lQAlg said, "jajajajaj"
0/FYfBoKhINaqU/H5OSS1A: folds 
4vTIxEd0Qfkak22W0G6sTg: raises $0.25 to $0.50
8f0dtuUGqDbgE6up1lQAlg: folds 
UfU14XiqkyIQoIJy9COOsQ: folds 
ymz+a8dgHSUFPooYplw7Ow: calls $0.40
Mch463E1dxQfVob352za6w: folds 
*** FLOP *** [3d 5d 6s]
ymz+a8dgHSUFPooYplw7Ow: checks 
4vTIxEd0Qfkak22W0G6sTg: bets $1.50
ymz+a8dgHSUFPooYplw7Ow: folds 
Uncalled bet ($1.50) returned to 4vTIxEd0Qfkak22W0G6sTg
4vTIxEd0Qfkak22W0G6sTg collected $1.20 from pot
*** SUMMARY ***
Total pot $1.25 | Rake $0.05 
Board [3d 5d 6s]
Seat 1: 0/FYfBoKhINaqU/H5OSS1A folded before Flop (didn't bet)
Seat 2: 4vTIxEd0Qfkak22W0G6sTg collected ($1.20)
Seat 3: 8f0dtuUGqDbgE6up1lQAlg folded before Flop (didn't bet)
Seat 4: UfU14XiqkyIQoIJy9COOsQ (button) folded before Flop (didn't bet)
Seat 5: ymz+a8dgHSUFPooYplw7Ow (small blind) folded on the Flop
Seat 6: Mch463E1dxQfVob352za6w (big blind) folded before Flop




PokerStars Game #59939682428:  Hold'em No Limit ($0.10/$0.25) - 2009/07/01 0:46:11 ET
Table '52Meibn9NOL4XtVi1p2Upw' 9-max Seat #8 is the button
Seat 1: LSrAei+fS8MYG9ie/GkG0Q ($12.80 in chips) 
Seat 2: BEIBUu2pIflPrCL+Iks4CQ ($12.25 in chips) 
Seat 3: MzBvksetB8XYtCt0FExJMg ($11.25 in chips) 
Seat 4: rCaXm4/EwAgWqCiClpbsqQ ($11.25 in chips) 
Seat 5: 4oA316mXLIui1QY63GXBUg ($27.70 in chips) 
Seat 6: 1wKfgJ8xXIiuc8C6qjkxhg ($9.45 in chips) 
Seat 7: R3KkgiqTvuhazyCqaD9cZg ($10 in chips) 
Seat 8: eKma8Z98pP7H8m4CEt075w ($22.95 in chips) 
Seat 9: 8B/dhbQjIWe6ASCdgzktNQ ($27.35 in chips) 
8B/dhbQjIWe6ASCdgzktNQ: posts small blind $0.10
LSrAei+fS8MYG9ie/GkG0Q: posts big blind $0.25
*** HOLE CARDS ***
BEIBUu2pIflPrCL+Iks4CQ: folds 
MzBvksetB8XYtCt0FExJMg: folds 
rCaXm4/EwAgWqCiClpbsqQ: folds 
4oA316mXLIui1QY63GXBUg: folds 
1wKfgJ8xXIiuc8C6qjkxhg: calls $0.25
R3KkgiqTvuhazyCqaD9cZg: folds 
eKma8Z98pP7H8m4CEt075w: folds 
8B/dhbQjIWe6ASCdgzktNQ: folds 
LSrAei+fS8MYG9ie/GkG0Q: checks 
*** FLOP *** [7h Ac Qc]
LSrAei+fS8MYG9ie/GkG0Q: checks 
1wKfgJ8xXIiuc8C6qjkxhg: bets $0.25
LSrAei+fS8MYG9ie/GkG0Q: folds 
Uncalled bet ($0.25) returned to 1wKfgJ8xXIiuc8C6qjkxhg
1wKfgJ8xXIiuc8C6qjkxhg collected $0.60 from pot
*** SUMMARY ***
Total pot $0.60 | Rake $0 
Board [7h Ac Qc]
Seat 1: LSrAei+fS8MYG9ie/GkG0Q (big blind) folded on the Flop
Seat 2: BEIBUu2pIflPrCL+Iks4CQ folded before Flop (didn't bet)
Seat 3: MzBvksetB8XYtCt0FExJMg folded before Flop (didn't bet)
Seat 4: rCaXm4/EwAgWqCiClpbsqQ folded before Flop (didn't bet)
Seat 5: 4oA316mXLIui1QY63GXBUg folded before Flop (didn't bet)
Seat 6: 1wKfgJ8xXIiuc8C6qjkxhg collected ($0.60)
Seat 7: R3KkgiqTvuhazyCqaD9cZg folded before Flop (didn't bet)
Seat 8: eKma8Z98pP7H8m4CEt075w (button) folded before Flop (didn't bet)
Seat 9: 8B/dhbQjIWe6ASCdgzktNQ (small blind) folded before Flop




PokerStars Game #59939682768:  Hold'em No Limit ($0.10/$0.25) - 2009/07/01 0:46:12 ET
Table '8QBBaev+cI2i/r2H6ml/lg' 9-max Seat #4 is the button
Seat 4: ZoG0obuajzVjwgd7lNHjgg ($4.75 in chips) 
Seat 6: cxE+szmvEUe7vE+z2ozM2Q ($10.30 in chips) 
ZoG0obuajzVjwgd7lNHjgg: posts small blind $0.10
cxE+szmvEUe7vE+z2ozM2Q: posts big blind $0.25
*** HOLE CARDS ***
ZoG0obuajzVjwgd7lNHjgg: raises $0.50 to $0.75
cxE+szmvEUe7vE+z2ozM2Q: calls $0.50
*** FLOP *** [3h Qh 9h]
cxE+szmvEUe7vE+z2ozM2Q: checks 
ZoG0obuajzVjwgd7lNHjgg: checks 
*** TURN *** [3h Qh 9h] [Kc]
cxE+szmvEUe7vE+z2ozM2Q: bets $1
ZoG0obuajzVjwgd7lNHjgg: folds 
Uncalled bet ($1) returned to cxE+szmvEUe7vE+z2ozM2Q
cxE+szmvEUe7vE+z2ozM2Q collected $1.45 from pot
cxE+szmvEUe7vE+z2ozM2Q: shows [6d Tc] (high card King)
*** SUMMARY ***
Total pot $1.50 | Rake $0.05 
Board [3h Qh 9h Kc]
Seat 4: ZoG0obuajzVjwgd7lNHjgg (button) (small blind) folded on the Turn
Seat 6: cxE+szmvEUe7vE+z2ozM2Q (big blind) collected ($1.45)




PokerStars Game #59939682858:  Hold'em No Limit ($0.10/$0.25) - 2009/07/01 0:46:12 ET
Table 'NgexmgEDEzICBeSO7YCrKQ' 6-max Seat #1 is the button
Seat 1: oseFhpinoe+Zg4j5xyBjyQ ($70.75 in chips) 
Seat 2: 32YL2ZEp8NT4JB2RVM9euQ ($15.40 in chips) 
Seat 3: JFIAqU8lCZ0vWwEl4bdGsg ($26.55 in chips) 
Seat 4: xx+iYCDJhHJmNzrfeloyEg ($38.60 in chips) 
Seat 5: /MXkdT8TTs8Qp2LVTQNw6w ($46.90 in chips) 
Seat 6: k9nHZTHt8hYhYRcW8NTb4g ($9.90 in chips) 
32YL2ZEp8NT4JB2RVM9euQ: posts small blind $0.10
JFIAqU8lCZ0vWwEl4bdGsg: posts big blind $0.25
*** HOLE CARDS ***
xx+iYCDJhHJmNzrfeloyEg: folds 
/MXkdT8TTs8Qp2LVTQNw6w: folds 
k9nHZTHt8hYhYRcW8NTb4g: folds 
oseFhpinoe+Zg4j5xyBjyQ: folds 
/MXkdT8TTs8Qp2LVTQNw6w said, "KK"
32YL2ZEp8NT4JB2RVM9euQ: raises $0.75 to $1
JFIAqU8lCZ0vWwEl4bdGsg: folds 
Uncalled bet ($0.75) returned to 32YL2ZEp8NT4JB2RVM9euQ
32YL2ZEp8NT4JB2RVM9euQ collected $0.50 from pot
32YL2ZEp8NT4JB2RVM9euQ: doesn't show hand 
*** SUMMARY ***
Total pot $0.50 | Rake $0 
Seat 1: oseFhpinoe+Zg4j5xyBjyQ (button) folded before Flop (didn't bet)
Seat 2: 32YL2ZEp8NT4JB2RVM9euQ (small blind) collected ($0.50)
Seat 3: JFIAqU8lCZ0vWwEl4bdGsg (big blind) folded before Flop
Seat 4: xx+iYCDJhHJmNzrfeloyEg folded before Flop (didn't bet)
Seat 5: /MXkdT8TTs8Qp2LVTQNw6w folded before Flop (didn't bet)
Seat 6: k9nHZTHt8hYhYRcW8NTb4g folded before Flop (didn't bet)




PokerStars Game #59939682740:  Hold'em No Limit ($0.10/$0.25) - 2009/07/01 0:46:12 ET
Table 'mk323gviqdkOY5Aek/1EWg' 6-max Seat #5 is the button
Seat 1: e8w9qW2QMnrAqkudVQoHoA ($35.95 in chips) 
Seat 2: GC/9yVD59DUCX7hUI7gcLw ($25 in chips) 
Seat 3: aSrj4lVmn2owyQ1RbbOqxQ ($23.05 in chips) 
Seat 4: o08wk0F4gROLhZS04Iyl3w ($25 in chips) 
Seat 5: SFmT9ZsVopnukjvAzrxTRg ($61.55 in chips) 
Seat 6: KkXSr5xFjxLSD3wtAvT+WQ ($19.30 in chips) 
KkXSr5xFjxLSD3wtAvT+WQ: posts small blind $0.10
e8w9qW2QMnrAqkudVQoHoA: posts big blind $0.25
*** HOLE CARDS ***
GC/9yVD59DUCX7hUI7gcLw: folds 
aSrj4lVmn2owyQ1RbbOqxQ: folds 
o08wk0F4gROLhZS04Iyl3w: raises $0.60 to $0.85
SFmT9ZsVopnukjvAzrxTRg: calls $0.85
KkXSr5xFjxLSD3wtAvT+WQ: folds 
e8w9qW2QMnrAqkudVQoHoA: calls $0.60
*** FLOP *** [6c 9d Kc]
e8w9qW2QMnrAqkudVQoHoA: checks 
o08wk0F4gROLhZS04Iyl3w: bets $2
SFmT9ZsVopnukjvAzrxTRg: folds 
e8w9qW2QMnrAqkudVQoHoA: folds 
Uncalled bet ($2) returned to o08wk0F4gROLhZS04Iyl3w
o08wk0F4gROLhZS04Iyl3w collected $2.55 from pot
*** SUMMARY ***
Total pot $2.65 | Rake $0.10 
Board [6c 9d Kc]
Seat 1: e8w9qW2QMnrAqkudVQoHoA (big blind) folded on the Flop
Seat 2: GC/9yVD59DUCX7hUI7gcLw folded before Flop (didn't bet)
Seat 3: aSrj4lVmn2owyQ1RbbOqxQ folded before Flop (didn't bet)
Seat 4: o08wk0F4gROLhZS04Iyl3w collected ($2.55)
Seat 5: SFmT9ZsVopnukjvAzrxTRg (button) folded on the Flop
Seat 6: KkXSr5xFjxLSD3wtAvT+WQ (small blind) folded before Flop




PokerStars Game #59939683088:  Hold'em No Limit ($0.10/$0.25) - 2009/07/01 0:46:12 ET
Table 'KEoOIegxPF91KooL2AelUA' 6-max Seat #4 is the button
Seat 1: wsP46AGpqDjHZQmlRHKa9g ($30.65 in chips) 
Seat 2: RYLaAIIwK9wxkPswt1yJYw ($25 in chips) 
Seat 4: Vv37Oa9niKKVcR6Z7ceetw ($22.25 in chips) 
wsP46AGpqDjHZQmlRHKa9g: posts small blind $0.10
2NLC44AHHKHEUooUQFYV+Q has returned
RYLaAIIwK9wxkPswt1yJYw: posts big blind $0.25
zxeVQGaMKDsDzmSY+AInjA: sits out 
*** HOLE CARDS ***
Vv37Oa9niKKVcR6Z7ceetw said, "puta mierda"
2NLC44AHHKHEUooUQFYV+Q is sitting out
Vv37Oa9niKKVcR6Z7ceetw: folds 
wsP46AGpqDjHZQmlRHKa9g: raises $0.50 to $0.75
2NLC44AHHKHEUooUQFYV+Q leaves the table
1YgYdjcEYMhI41phJetI3w joins the table at seat #6 
RYLaAIIwK9wxkPswt1yJYw: calls $0.50
*** FLOP *** [Qd 9h 7h]
wsP46AGpqDjHZQmlRHKa9g: bets $1
tburger7 joins the table at seat #5 
RYLaAIIwK9wxkPswt1yJYw: calls $1
*** TURN *** [Qd 9h 7h] [8s]
wsP46AGpqDjHZQmlRHKa9g: checks 
RYLaAIIwK9wxkPswt1yJYw: bets $1.50
wsP46AGpqDjHZQmlRHKa9g: folds 
Uncalled bet ($1.50) returned to RYLaAIIwK9wxkPswt1yJYw
RYLaAIIwK9wxkPswt1yJYw collected $3.35 from pot
*** SUMMARY ***
Total pot $3.50 | Rake $0.15 
Board [Qd 9h 7h 8s]
Seat 1: wsP46AGpqDjHZQmlRHKa9g (small blind) folded on the Turn
Seat 2: RYLaAIIwK9wxkPswt1yJYw (big blind) collected ($3.35)
Seat 4: Vv37Oa9niKKVcR6Z7ceetw (button) folded before Flop (didn't bet)




PokerStars Game #59939683782:  Hold'em No Limit ($0.10/$0.25) - 2009/07/01 0:46:13 ET
Table 'mVdLgAdN9rGe6mMwSrDdGQ' 6-max Seat #4 is the button
Seat 2: fSUx4e1vURbgXyDBEcRbAg ($4.35 in chips) 
Seat 3: kG34n23qFQA3nzdOJTQ1dA ($24.55 in chips) 
Seat 4: GJsS3gwVwlbyroaWrnjqJg ($24.65 in chips) 
Seat 5: oseFhpinoe+Zg4j5xyBjyQ ($55.30 in chips) 
Seat 6: Ew/TYPQIsbQ2X8nm5iAJBg ($36 in chips) 
oseFhpinoe+Zg4j5xyBjyQ: posts small blind $0.10
Ew/TYPQIsbQ2X8nm5iAJBg: posts big blind $0.25
*** HOLE CARDS ***
fSUx4e1vURbgXyDBEcRbAg: folds 
kG34n23qFQA3nzdOJTQ1dA: folds 
GJsS3gwVwlbyroaWrnjqJg: folds 
oseFhpinoe+Zg4j5xyBjyQ: raises $0.25 to $0.50
qhK49WKJUNyD5vnZcIeQdg has returned
Ew/TYPQIsbQ2X8nm5iAJBg: raises $1.75 to $2.25
oseFhpinoe+Zg4j5xyBjyQ: folds 
Uncalled bet ($1.75) returned to Ew/TYPQIsbQ2X8nm5iAJBg
Ew/TYPQIsbQ2X8nm5iAJBg collected $1 from pot
Ew/TYPQIsbQ2X8nm5iAJBg: doesn't show hand 
*** SUMMARY ***
Total pot $1 | Rake $0 
Seat 2: fSUx4e1vURbgXyDBEcRbAg folded before Flop (didn't bet)
Seat 3: kG34n23qFQA3nzdOJTQ1dA folded before Flop (didn't bet)
Seat 4: GJsS3gwVwlbyroaWrnjqJg (button) folded before Flop (didn't bet)
Seat 5: oseFhpinoe+Zg4j5xyBjyQ (small blind) folded before Flop
Seat 6: Ew/TYPQIsbQ2X8nm5iAJBg (big blind) collected ($1)




PokerStars Game #59939683262:  Hold'em No Limit ($0.10/$0.25) - 2009/07/01 0:46:13 ET
Table 'PCxB2W9H6ma8SwsZlImuOw' 9-max Seat #6 is the button
Seat 1: 5s3p6yoJBNW438dsyKTP8g ($31 in chips) 
Seat 2: wjH6l1gQaEfv+C45sAOwIQ ($37.80 in chips) 
Seat 3: opOCI2p6kW0tINuVaAqmcQ ($33.70 in chips) 
Seat 4: ydoFOVgzvZv9ZhuWu9rXAw ($4.90 in chips) 
Seat 5: h4ggJZYBXV0mEZzYPYKfeA ($23.35 in chips) 
Seat 6: E2c0EwJuNHUUdumOOgYQYA ($4.85 in chips) 
Seat 9: 1q23ISSsSMhv2lHXBfj9/A ($26.15 in chips) 
22dIObOuor/A+IKWkNoAlA will be allowed to play after the button
kk4O0+IswAtmyhr/WFvmCA will be allowed to play after the button
1q23ISSsSMhv2lHXBfj9/A: posts small blind $0.10
5s3p6yoJBNW438dsyKTP8g: posts big blind $0.25
*** HOLE CARDS ***
wjH6l1gQaEfv+C45sAOwIQ: folds 
opOCI2p6kW0tINuVaAqmcQ: folds 
ydoFOVgzvZv9ZhuWu9rXAw: folds 
h4ggJZYBXV0mEZzYPYKfeA: folds 
E2c0EwJuNHUUdumOOgYQYA: folds 
1q23ISSsSMhv2lHXBfj9/A: calls $0.15
5s3p6yoJBNW438dsyKTP8g: checks 
*** FLOP *** [6h 2c Jd]
1q23ISSsSMhv2lHXBfj9/A: checks 
5s3p6yoJBNW438dsyKTP8g: checks 
*** TURN *** [6h 2c Jd] [3h]
1q23ISSsSMhv2lHXBfj9/A: checks 
5s3p6yoJBNW438dsyKTP8g: checks 
*** RIVER *** [6h 2c Jd 3h] [As]
1q23ISSsSMhv2lHXBfj9/A: bets $0.25
5s3p6yoJBNW438dsyKTP8g: calls $0.25
*** SHOW DOWN ***
1q23ISSsSMhv2lHXBfj9/A: shows [Kd 8s] (high card Ace)
5s3p6yoJBNW438dsyKTP8g: mucks hand 
1q23ISSsSMhv2lHXBfj9/A collected $0.95 from pot
*** SUMMARY ***
Total pot $1 | Rake $0.05 
Board [6h 2c Jd 3h As]
Seat 1: 5s3p6yoJBNW438dsyKTP8g (big blind) mucked
Seat 2: wjH6l1gQaEfv+C45sAOwIQ folded before Flop (didn't bet)
Seat 3: opOCI2p6kW0tINuVaAqmcQ folded before Flop (didn't bet)
Seat 4: ydoFOVgzvZv9ZhuWu9rXAw folded before Flop (didn't bet)
Seat 5: h4ggJZYBXV0mEZzYPYKfeA folded before Flop (didn't bet)
Seat 6: E2c0EwJuNHUUdumOOgYQYA (button) folded before Flop (didn't bet)
Seat 9: 1q23ISSsSMhv2lHXBfj9/A (small blind) showed [Kd 8s] and won ($0.95) with high card Ace




PokerStars Game #59939683556:  Hold'em No Limit ($0.10/$0.25) - 2009/07/01 0:46:13 ET
Table 'jz4TpuH+ag+0iNe2ZcxckQ' 9-max Seat #7 is the button
Seat 2: 18G4P1XstjNvItdGUITxgw ($37.45 in chips) 
Seat 4: k+2r6di6GXjNpAdrRkW9bA ($68.95 in chips) 
Seat 5: uJlzv9KL7hgCIqIS2ofoaw ($8.45 in chips) 
Seat 6: ymx/m/7IEqTY+OQPano2gg ($7.70 in chips) 
Seat 7: sJNHTWcSlLHRCZ9+YRLLqA ($25 in chips) 
Seat 8: DlXs37dlX3tb7o/7lYXQSw ($26.45 in chips) 
Seat 9: 8B/dhbQjIWe6ASCdgzktNQ ($25.35 in chips) 
DlXs37dlX3tb7o/7lYXQSw: posts small blind $0.10
8B/dhbQjIWe6ASCdgzktNQ: posts big blind $0.25
F7pnn6czNpHvRM55XcA2EA: sits out 
*** HOLE CARDS ***
18G4P1XstjNvItdGUITxgw: folds 
k+2r6di6GXjNpAdrRkW9bA: calls $0.25
uJlzv9KL7hgCIqIS2ofoaw: folds 
ymx/m/7IEqTY+OQPano2gg: calls $0.25
sJNHTWcSlLHRCZ9+YRLLqA: folds 
DlXs37dlX3tb7o/7lYXQSw: folds 
8B/dhbQjIWe6ASCdgzktNQ: checks 
*** FLOP *** [Ac 5d Js]
8B/dhbQjIWe6ASCdgzktNQ: checks 
k+2r6di6GXjNpAdrRkW9bA: bets $1
ymx/m/7IEqTY+OQPano2gg: calls $1
8B/dhbQjIWe6ASCdgzktNQ: folds 
*** TURN *** [Ac 5d Js] [Qd]
k+2r6di6GXjNpAdrRkW9bA: bets $0.75
ymx/m/7IEqTY+OQPano2gg: calls $0.75
*** RIVER *** [Ac 5d Js Qd] [Ts]
k+2r6di6GXjNpAdrRkW9bA: checks 
ymx/m/7IEqTY+OQPano2gg: checks 
*** SHOW DOWN ***
k+2r6di6GXjNpAdrRkW9bA: shows [Th Ad] (two pair, Aces and Tens)
ymx/m/7IEqTY+OQPano2gg: mucks hand 
Z5NNIVvnhb2IJbLcI79WYQ has returned
k+2r6di6GXjNpAdrRkW9bA collected $4.15 from pot
*** SUMMARY ***
Total pot $4.35 | Rake $0.20 
Board [Ac 5d Js Qd Ts]
Seat 2: 18G4P1XstjNvItdGUITxgw folded before Flop (didn't bet)
Seat 4: k+2r6di6GXjNpAdrRkW9bA showed [Th Ad] and won ($4.15) with two pair, Aces and Tens
Seat 5: uJlzv9KL7hgCIqIS2ofoaw folded before Flop (didn't bet)
Seat 6: ymx/m/7IEqTY+OQPano2gg mucked
Seat 7: sJNHTWcSlLHRCZ9+YRLLqA (button) folded before Flop (didn't bet)
Seat 8: DlXs37dlX3tb7o/7lYXQSw (small blind) folded before Flop
Seat 9: 8B/dhbQjIWe6ASCdgzktNQ (big blind) folded on the Flop




PokerStars Game #59939683422:  Hold'em No Limit ($0.10/$0.25) - 2009/07/01 0:46:13 ET
Table 'IrJPyZ3JW2iIa+krdoSbJQ' 9-max Seat #3 is the button
Seat 1: 4+E2msto8r80F3SH2gctVA ($24.75 in chips) 
Seat 3: vZGoOTJLQLhkPj4I+LNGig ($25 in chips) 
Seat 4: DnDcAdn9P0zGovMERigpFA ($25 in chips) 
Seat 5: sUVgUtgbfVx6JpvApozwhQ ($6.10 in chips) 
Seat 6: +sbyWwIcFp9kP0bDtMegfQ ($24.65 in chips) 
Seat 7: uH1RN27w9SKa7TpVR9EFrQ ($22.45 in chips) 
Seat 8: VBHxUExRAMrbxUq/cVx9Gw ($5 in chips) 
DnDcAdn9P0zGovMERigpFA: posts small blind $0.10
sUVgUtgbfVx6JpvApozwhQ: posts big blind $0.25
+WMpj67YqG8ilNkg2JwXpw: sits out 
*** HOLE CARDS ***
+sbyWwIcFp9kP0bDtMegfQ: folds 
uH1RN27w9SKa7TpVR9EFrQ: folds 
VBHxUExRAMrbxUq/cVx9Gw: folds 
4+E2msto8r80F3SH2gctVA: folds 
vZGoOTJLQLhkPj4I+LNGig: folds 
DnDcAdn9P0zGovMERigpFA: calls $0.15
Mr_GlamoRouS joins the table at seat #2 
sUVgUtgbfVx6JpvApozwhQ: checks 
*** FLOP *** [Qd 3c 7h]
DnDcAdn9P0zGovMERigpFA: checks 
sUVgUtgbfVx6JpvApozwhQ: checks 
*** TURN *** [Qd 3c 7h] [7s]
DnDcAdn9P0zGovMERigpFA: checks 
sUVgUtgbfVx6JpvApozwhQ: checks 
*** RIVER *** [Qd 3c 7h 7s] [Qs]
DnDcAdn9P0zGovMERigpFA: checks 
sUVgUtgbfVx6JpvApozwhQ: checks 
*** SHOW DOWN ***
DnDcAdn9P0zGovMERigpFA: shows [4h 4c] (two pair, Queens and Sevens)
sUVgUtgbfVx6JpvApozwhQ: shows [2h 9h] (two pair, Queens and Sevens - Nine kicker)
sUVgUtgbfVx6JpvApozwhQ collected $0.50 from pot
*** SUMMARY ***
Total pot $0.50 | Rake $0 
Board [Qd 3c 7h 7s Qs]
Seat 1: 4+E2msto8r80F3SH2gctVA folded before Flop (didn't bet)
Seat 3: vZGoOTJLQLhkPj4I+LNGig (button) folded before Flop (didn't bet)
Seat 4: DnDcAdn9P0zGovMERigpFA (small blind) showed [4h 4c] and lost with two pair, Queens and Sevens
Seat 5: sUVgUtgbfVx6JpvApozwhQ (big blind) showed [2h 9h] and won ($0.50) with two pair, Queens and Sevens
Seat 6: +sbyWwIcFp9kP0bDtMegfQ folded before Flop (didn't bet)
Seat 7: uH1RN27w9SKa7TpVR9EFrQ folded before Flop (didn't bet)
Seat 8: VBHxUExRAMrbxUq/cVx9Gw folded before Flop (didn't bet)




PokerStars Game #59939683364:  Hold'em No Limit ($0.10/$0.25) - 2009/07/01 0:46:13 ET
Table 'hfHe8uKeSJMyWAjSdM7ROQ' 6-max Seat #5 is the button
Seat 1: eHsmIvAb2JREg4O6hNPnXg ($17.90 in chips) 
Seat 2: rnpAao581IcvQglpkpnkoQ ($5.80 in chips) 
Seat 3: og6TUWcndKo5oTDQjnQfjw ($37.35 in chips) 
Seat 4: iAfYkegiTr9eE85LoKmEgA ($6.95 in chips) 
Seat 5: euswrBD1XG0Q5hB1iGJBKQ ($19.20 in chips) 
Seat 6: SFmT9ZsVopnukjvAzrxTRg ($25 in chips) 
SFmT9ZsVopnukjvAzrxTRg: posts small blind $0.10
eHsmIvAb2JREg4O6hNPnXg: posts big blind $0.25
*** HOLE CARDS ***
rnpAao581IcvQglpkpnkoQ: calls $0.25
og6TUWcndKo5oTDQjnQfjw: calls $0.25
iAfYkegiTr9eE85LoKmEgA: folds 
euswrBD1XG0Q5hB1iGJBKQ: folds 
SFmT9ZsVopnukjvAzrxTRg: folds 
eHsmIvAb2JREg4O6hNPnXg: checks 
*** FLOP *** [Tc Th 2c]
eHsmIvAb2JREg4O6hNPnXg: checks 
rnpAao581IcvQglpkpnkoQ: checks 
og6TUWcndKo5oTDQjnQfjw: bets $0.50
eHsmIvAb2JREg4O6hNPnXg: folds 
rnpAao581IcvQglpkpnkoQ: calls $0.50
*** TURN *** [Tc Th 2c] [7d]
rnpAao581IcvQglpkpnkoQ: checks 
og6TUWcndKo5oTDQjnQfjw: bets $1.25
rnpAao581IcvQglpkpnkoQ: folds 
Uncalled bet ($1.25) returned to og6TUWcndKo5oTDQjnQfjw
og6TUWcndKo5oTDQjnQfjw collected $1.80 from pot
og6TUWcndKo5oTDQjnQfjw: doesn't show hand 
*** SUMMARY ***
Total pot $1.85 | Rake $0.05 
Board [Tc Th 2c 7d]
Seat 1: eHsmIvAb2JREg4O6hNPnXg (big blind) folded on the Flop
Seat 2: rnpAao581IcvQglpkpnkoQ folded on the Turn
Seat 3: og6TUWcndKo5oTDQjnQfjw collected ($1.80)
Seat 4: iAfYkegiTr9eE85LoKmEgA folded before Flop (didn't bet)
Seat 5: euswrBD1XG0Q5hB1iGJBKQ (button) folded before Flop (didn't bet)
Seat 6: SFmT9ZsVopnukjvAzrxTRg (small blind) folded before Flop




PokerStars Game #59939683760:  Hold'em No Limit ($0.10/$0.25) - 2009/07/01 0:46:13 ET
Table 'jItkp2PNTbH9Cf7gqsAF7g' 9-max Seat #8 is the button
Seat 1: OiV1PWZ3IkN29JlmCcnTwQ ($5.50 in chips) 
Seat 2: qwr38jl5txoR36M7G5qi4A ($7.50 in chips) 
Seat 3: E0iYnEVO2ho7dH3QcCjw7g ($23.10 in chips) 
Seat 4: GQTWTgG7Ydy9q/vohVnKmQ ($30.85 in chips) 
Seat 5: uH1RN27w9SKa7TpVR9EFrQ ($20.10 in chips) 
Seat 6: cZ99hugmLBj9KhTlc8nCSw ($59.10 in chips) 
Seat 7: st9jtdNbm1W5GfBwRaCVqQ ($20.35 in chips) 
Seat 8: t82lXIS9gxYmNHmDgWRFAQ ($11.20 in chips) 
OiV1PWZ3IkN29JlmCcnTwQ: posts small blind $0.10
qwr38jl5txoR36M7G5qi4A: posts big blind $0.25
*** HOLE CARDS ***
E0iYnEVO2ho7dH3QcCjw7g: folds 
GQTWTgG7Ydy9q/vohVnKmQ: raises $0.25 to $0.50
uH1RN27w9SKa7TpVR9EFrQ: folds 
cZ99hugmLBj9KhTlc8nCSw: folds 
st9jtdNbm1W5GfBwRaCVqQ: folds 
t82lXIS9gxYmNHmDgWRFAQ: calls $0.50
OiV1PWZ3IkN29JlmCcnTwQ: folds 
qwr38jl5txoR36M7G5qi4A: folds 
*** FLOP *** [6h 5d Ts]
GQTWTgG7Ydy9q/vohVnKmQ: bets $0.50
dtZ84flFEi4Q+SGrHMJRDQ joins the table at seat #9 
t82lXIS9gxYmNHmDgWRFAQ: calls $0.50
*** TURN *** [6h 5d Ts] [Jh]
GQTWTgG7Ydy9q/vohVnKmQ: bets $0.50
t82lXIS9gxYmNHmDgWRFAQ: folds 
Uncalled bet ($0.50) returned to GQTWTgG7Ydy9q/vohVnKmQ
GQTWTgG7Ydy9q/vohVnKmQ collected $2.25 from pot
GQTWTgG7Ydy9q/vohVnKmQ: doesn't show hand 
*** SUMMARY ***
Total pot $2.35 | Rake $0.10 
Board [6h 5d Ts Jh]
Seat 1: OiV1PWZ3IkN29JlmCcnTwQ (small blind) folded before Flop
Seat 2: qwr38jl5txoR36M7G5qi4A (big blind) folded before Flop
Seat 3: E0iYnEVO2ho7dH3QcCjw7g folded before Flop (didn't bet)
Seat 4: GQTWTgG7Ydy9q/vohVnKmQ collected ($2.25)
Seat 5: uH1RN27w9SKa7TpVR9EFrQ folded before Flop (didn't bet)
Seat 6: cZ99hugmLBj9KhTlc8nCSw folded before Flop (didn't bet)
Seat 7: st9jtdNbm1W5GfBwRaCVqQ folded before Flop (didn't bet)
Seat 8: t82lXIS9gxYmNHmDgWRFAQ (button) folded on the Turn




PokerStars Game #59939683846:  Hold'em No Limit ($0.10/$0.25) - 2009/07/01 0:46:13 ET
Table 'xkqAWQFDrFt4p81M8UsoNw' 9-max Seat #3 is the button
Seat 1: N6fYvIzQLKaydFLKQGtMlQ ($24.65 in chips) 
Seat 2: z5GxcHlYz/GSz6W2uFiTtg ($37.05 in chips) 
Seat 3: HEUqKs2EYYGGXJCepUdL0g ($5.90 in chips) 
Seat 4: gY+PO8PaVC7pBPH/9HSv6Q ($4.35 in chips) 
Seat 5: OiV1PWZ3IkN29JlmCcnTwQ ($5 in chips) 
Seat 6: Yv4fucyyT28mjx8V5lxKJg ($24.85 in chips) 
Seat 7: MG90wfSJZnOejs/KD3vlQQ ($51.55 in chips) 
Seat 9: Wa7bjLwN7ptOQro84PxQGw ($4.75 in chips) 
gY+PO8PaVC7pBPH/9HSv6Q: posts small blind $0.10
OiV1PWZ3IkN29JlmCcnTwQ: posts big blind $0.25
s7Q6uNouhe7aE8JdFb9E+A: sits out 
*** HOLE CARDS ***
Yv4fucyyT28mjx8V5lxKJg: folds 
MG90wfSJZnOejs/KD3vlQQ: folds 
Wa7bjLwN7ptOQro84PxQGw: calls $0.25
N6fYvIzQLKaydFLKQGtMlQ: folds 
z5GxcHlYz/GSz6W2uFiTtg: calls $0.25
HEUqKs2EYYGGXJCepUdL0g: calls $0.25
gY+PO8PaVC7pBPH/9HSv6Q: calls $0.15
OiV1PWZ3IkN29JlmCcnTwQ: checks 
*** FLOP *** [Tc 9d 5c]
gY+PO8PaVC7pBPH/9HSv6Q: checks 
OiV1PWZ3IkN29JlmCcnTwQ: checks 
Wa7bjLwN7ptOQro84PxQGw: checks 
z5GxcHlYz/GSz6W2uFiTtg: checks 
HEUqKs2EYYGGXJCepUdL0g: checks 
*** TURN *** [Tc 9d 5c] [Ah]
gY+PO8PaVC7pBPH/9HSv6Q: bets $0.75
Yv4fucyyT28mjx8V5lxKJg leaves the table
OiV1PWZ3IkN29JlmCcnTwQ: folds 
Wa7bjLwN7ptOQro84PxQGw: folds 
z5GxcHlYz/GSz6W2uFiTtg: folds 
HEUqKs2EYYGGXJCepUdL0g: folds 
Uncalled bet ($0.75) returned to gY+PO8PaVC7pBPH/9HSv6Q
gY+PO8PaVC7pBPH/9HSv6Q collected $1.20 from pot
*** SUMMARY ***
Total pot $1.25 | Rake $0.05 
Board [Tc 9d 5c Ah]
Seat 1: N6fYvIzQLKaydFLKQGtMlQ folded before Flop (didn't bet)
Seat 2: z5GxcHlYz/GSz6W2uFiTtg folded on the Turn
Seat 3: HEUqKs2EYYGGXJCepUdL0g (button) folded on the Turn
Seat 4: gY+PO8PaVC7pBPH/9HSv6Q (small blind) collected ($1.20)
Seat 5: OiV1PWZ3IkN29JlmCcnTwQ (big blind) folded on the Turn
Seat 6: Yv4fucyyT28mjx8V5lxKJg folded before Flop (didn't bet)
Seat 7: MG90wfSJZnOejs/KD3vlQQ folded before Flop (didn't bet)
Seat 9: Wa7bjLwN7ptOQro84PxQGw folded on the Turn




PokerStars Game #59939683406:  Hold'em No Limit ($0.10/$0.25) - 2009/07/01 0:46:13 ET
Table '+fuYjvJy9okLr23QyZtanA' 9-max Seat #1 is the button
Seat 1: s7Q6uNouhe7aE8JdFb9E+A ($25 in chips) 
Seat 4: H/l9NZvuOXwQIPOaVdj0rQ ($8.50 in chips) 
Seat 5: h48vKHbhkYz+3RYZCQ0tgA ($22.50 in chips) 
Seat 6: m8t4Jb/b1Fc5HHGe1uSZag ($7 in chips) 
H/l9NZvuOXwQIPOaVdj0rQ: posts small blind $0.10
h48vKHbhkYz+3RYZCQ0tgA: posts big blind $0.25
m8t4Jb/b1Fc5HHGe1uSZag: posts big blind $0.25
*** HOLE CARDS ***
m8t4Jb/b1Fc5HHGe1uSZag: checks 
s7Q6uNouhe7aE8JdFb9E+A: folds 
H/l9NZvuOXwQIPOaVdj0rQ: calls $0.15
h48vKHbhkYz+3RYZCQ0tgA: checks 
*** FLOP *** [7c Js Th]
H/l9NZvuOXwQIPOaVdj0rQ: bets $0.75
h48vKHbhkYz+3RYZCQ0tgA: folds 
m8t4Jb/b1Fc5HHGe1uSZag: calls $0.75
*** TURN *** [7c Js Th] [7s]
H/l9NZvuOXwQIPOaVdj0rQ: bets $7.50 and is all-in
m8t4Jb/b1Fc5HHGe1uSZag: folds 
Uncalled bet ($7.50) returned to H/l9NZvuOXwQIPOaVdj0rQ
H/l9NZvuOXwQIPOaVdj0rQ collected $2.15 from pot
H/l9NZvuOXwQIPOaVdj0rQ: doesn't show hand 
*** SUMMARY ***
Total pot $2.25 | Rake $0.10 
Board [7c Js Th 7s]
Seat 1: s7Q6uNouhe7aE8JdFb9E+A (button) folded before Flop (didn't bet)
Seat 4: H/l9NZvuOXwQIPOaVdj0rQ (small blind) collected ($2.15)
Seat 5: h48vKHbhkYz+3RYZCQ0tgA (big blind) folded on the Flop
Seat 6: m8t4Jb/b1Fc5HHGe1uSZag folded on the Turn




PokerStars Game #59939684322:  Hold'em No Limit ($0.10/$0.25) - 2009/07/01 0:46:14 ET
Table 'JPFXJXa5xBkjZ/W15BKqeQ' 9-max Seat #5 is the button
Seat 1: hPhp/RE3cJ5YGaQ2xOHXXg ($5.35 in chips) 
Seat 2: 1/f3/SJ8XpIW1Ek97d1xUw ($11.05 in chips) 
Seat 3: 56S3mA6Zs3pGR+0p0vUCtg ($26.80 in chips) 
Seat 4: VBHxUExRAMrbxUq/cVx9Gw ($5.25 in chips) 
Seat 5: cZ99hugmLBj9KhTlc8nCSw ($25.60 in chips) 
Seat 6: DdPXdieucQ+n99u1n3A+rQ ($4.85 in chips) 
Seat 8: zDrucyjVn5aeekNEc3cJrA ($22.50 in chips) 
Seat 9: uH1RN27w9SKa7TpVR9EFrQ ($9.65 in chips) 
DdPXdieucQ+n99u1n3A+rQ: posts small blind $0.10
zDrucyjVn5aeekNEc3cJrA: posts big blind $0.25
*** HOLE CARDS ***
uH1RN27w9SKa7TpVR9EFrQ: folds 
hPhp/RE3cJ5YGaQ2xOHXXg: folds 
1/f3/SJ8XpIW1Ek97d1xUw: folds 
56S3mA6Zs3pGR+0p0vUCtg: folds 
VBHxUExRAMrbxUq/cVx9Gw: folds 
cZ99hugmLBj9KhTlc8nCSw: folds 
DdPXdieucQ+n99u1n3A+rQ: raises $0.50 to $0.75
zDrucyjVn5aeekNEc3cJrA: folds 
Uncalled bet ($0.50) returned to DdPXdieucQ+n99u1n3A+rQ
DdPXdieucQ+n99u1n3A+rQ collected $0.50 from pot
DdPXdieucQ+n99u1n3A+rQ: doesn't show hand 
*** SUMMARY ***
Total pot $0.50 | Rake $0 
Seat 1: hPhp/RE3cJ5YGaQ2xOHXXg folded before Flop (didn't bet)
Seat 2: 1/f3/SJ8XpIW1Ek97d1xUw folded before Flop (didn't bet)
Seat 3: 56S3mA6Zs3pGR+0p0vUCtg folded before Flop (didn't bet)
Seat 4: VBHxUExRAMrbxUq/cVx9Gw folded before Flop (didn't bet)
Seat 5: cZ99hugmLBj9KhTlc8nCSw (button) folded before Flop (didn't bet)
Seat 6: DdPXdieucQ+n99u1n3A+rQ (small blind) collected ($0.50)
Seat 8: zDrucyjVn5aeekNEc3cJrA (big blind) folded before Flop
Seat 9: uH1RN27w9SKa7TpVR9EFrQ folded before Flop (didn't bet)




PokerStars Game #59939684050:  Hold'em No Limit ($0.10/$0.25) - 2009/07/01 0:46:14 ET
Table '4UJB/UOZ5aepyF2v+hIoUg' 6-max Seat #4 is the button
Seat 3: dKMsTZMrd8Ire/Qysz7FAA ($4.55 in chips) 
Seat 4: UBrY0qLms3NqxITD3VvlAg ($17.50 in chips) 
Seat 5: hk8pxWcMqHKpvAKgXieLFw ($20.35 in chips) 
Seat 6: RP8Db3hfv5C09Dkfvq1lmw ($19.45 in chips) 
hk8pxWcMqHKpvAKgXieLFw: posts small blind $0.10
RP8Db3hfv5C09Dkfvq1lmw: posts big blind $0.25
Mch463E1dxQfVob352za6w: sits out 
*** HOLE CARDS ***
dKMsTZMrd8Ire/Qysz7FAA: folds 
UBrY0qLms3NqxITD3VvlAg: folds 
hk8pxWcMqHKpvAKgXieLFw: calls $0.15
RP8Db3hfv5C09Dkfvq1lmw: checks 
*** FLOP *** [5s 6h 7s]
TTpuqC1Ny2dgaNZLYg+ZXg has returned
hk8pxWcMqHKpvAKgXieLFw: checks 
RP8Db3hfv5C09Dkfvq1lmw: checks 
*** TURN *** [5s 6h 7s] [Ks]
hk8pxWcMqHKpvAKgXieLFw: checks 
RP8Db3hfv5C09Dkfvq1lmw: checks 
*** RIVER *** [5s 6h 7s Ks] [Jd]
hk8pxWcMqHKpvAKgXieLFw: checks 
RP8Db3hfv5C09Dkfvq1lmw: bets $0.25
hk8pxWcMqHKpvAKgXieLFw: calls $0.25
*** SHOW DOWN ***
RP8Db3hfv5C09Dkfvq1lmw: shows [Jh Ac] (a pair of Jacks)
hk8pxWcMqHKpvAKgXieLFw: mucks hand 
RP8Db3hfv5C09Dkfvq1lmw collected $0.95 from pot
*** SUMMARY ***
Total pot $1 | Rake $0.05 
Board [5s 6h 7s Ks Jd]
Seat 3: dKMsTZMrd8Ire/Qysz7FAA folded before Flop (didn't bet)
Seat 4: UBrY0qLms3NqxITD3VvlAg (button) folded before Flop (didn't bet)
Seat 5: hk8pxWcMqHKpvAKgXieLFw (small blind) mucked
Seat 6: RP8Db3hfv5C09Dkfvq1lmw (big blind) showed [Jh Ac] and won ($0.95) with a pair of Jacks




PokerStars Game #59939683884:  Hold'em No Limit ($0.10/$0.25) - 2009/07/01 0:46:14 ET
Table 'LG9H161ZAHDkOww+ih3Ptg' 6-max Seat #5 is the button
Seat 1: avl8CO/tc0F6eVSiB/KNRA ($25.70 in chips) 
Seat 2: 9jSiy0meE9XJKkdIZwyTEQ ($28.60 in chips) 
Seat 4: 0C28L4/59aRNtHoBhqTcLg ($71.25 in chips) 
Seat 5: oseFhpinoe+Zg4j5xyBjyQ ($44.85 in chips) 
avl8CO/tc0F6eVSiB/KNRA: posts small blind $0.10
9jSiy0meE9XJKkdIZwyTEQ: posts big blind $0.25
5Evvx7UYqXTBuvIc/9s/hA: sits out 
*** HOLE CARDS ***
0C28L4/59aRNtHoBhqTcLg: calls $0.25
oseFhpinoe+Zg4j5xyBjyQ: folds 
avl8CO/tc0F6eVSiB/KNRA: folds 
9jSiy0meE9XJKkdIZwyTEQ: checks 
*** FLOP *** [5s Js 9h]
9jSiy0meE9XJKkdIZwyTEQ: checks 
0C28L4/59aRNtHoBhqTcLg: checks 
*** TURN *** [5s Js 9h] [8d]
9jSiy0meE9XJKkdIZwyTEQ: checks 
0C28L4/59aRNtHoBhqTcLg: bets $0.25
9jSiy0meE9XJKkdIZwyTEQ: folds 
Uncalled bet ($0.25) returned to 0C28L4/59aRNtHoBhqTcLg
0C28L4/59aRNtHoBhqTcLg collected $0.60 from pot
*** SUMMARY ***
Total pot $0.60 | Rake $0 
Board [5s Js 9h 8d]
Seat 1: avl8CO/tc0F6eVSiB/KNRA (small blind) folded before Flop
Seat 2: 9jSiy0meE9XJKkdIZwyTEQ (big blind) folded on the Turn
Seat 4: 0C28L4/59aRNtHoBhqTcLg collected ($0.60)
Seat 5: oseFhpinoe+Zg4j5xyBjyQ (button) folded before Flop (didn't bet)




PokerStars Game #59939684132:  Hold'em No Limit ($0.10/$0.25) - 2009/07/01 0:46:14 ET
Table 'GxdLtCpYxqT4aAbYqkEEpw' 6-max Seat #2 is the button
Seat 1: heEf/FkFGS9M1NmwH97YIA ($20.15 in chips) 
Seat 2: hADMNbkECXMb2C/C8R2Wlw ($25.35 in chips) 
Seat 3: 9jSiy0meE9XJKkdIZwyTEQ ($48.90 in chips) 
Seat 4: ErIN0JRL5srYjT6en1f8YQ ($30.15 in chips) 
Seat 5: q6WfTUAD9mowIP63ASq2Dg ($38.80 in chips) 
Seat 6: aogAb4Eienxztk8p2v9VVw ($24.15 in chips) 
9jSiy0meE9XJKkdIZwyTEQ: posts small blind $0.10
ErIN0JRL5srYjT6en1f8YQ: posts big blind $0.25
*** HOLE CARDS ***
q6WfTUAD9mowIP63ASq2Dg: raises $0.50 to $0.75
aogAb4Eienxztk8p2v9VVw: folds 
heEf/FkFGS9M1NmwH97YIA: folds 
hADMNbkECXMb2C/C8R2Wlw: folds 
9jSiy0meE9XJKkdIZwyTEQ: folds 
ErIN0JRL5srYjT6en1f8YQ: folds 
Uncalled bet ($0.50) returned to q6WfTUAD9mowIP63ASq2Dg
q6WfTUAD9mowIP63ASq2Dg collected $0.60 from pot
*** SUMMARY ***
Total pot $0.60 | Rake $0 
Seat 1: heEf/FkFGS9M1NmwH97YIA folded before Flop (didn't bet)
Seat 2: hADMNbkECXMb2C/C8R2Wlw (button) folded before Flop (didn't bet)
Seat 3: 9jSiy0meE9XJKkdIZwyTEQ (small blind) folded before Flop
Seat 4: ErIN0JRL5srYjT6en1f8YQ (big blind) folded before Flop
Seat 5: q6WfTUAD9mowIP63ASq2Dg collected ($0.60)
Seat 6: aogAb4Eienxztk8p2v9VVw folded before Flop (didn't bet)




PokerStars Game #59939684074:  Hold'em No Limit ($0.10/$0.25) - 2009/07/01 0:46:14 ET
Table 'a0kk1yz54EMczhut3KjrxQ' 6-max Seat #4 is the button
Seat 1: V3LJvbHVJHmOj2fd7zIDhA ($29.95 in chips) 
Seat 2: nc79pm0LZRdhncq55evVqA ($25 in chips) 
Seat 3: FabaCGPqGJLjRL48CMvjiQ ($19.95 in chips) 
Seat 4: FYepjhAvF8ZdVCmqHIy+eQ ($28.20 in chips) 
Seat 5: cPO/1/dTcZpLkQFm3jH3Rg ($27.50 in chips) 
Seat 6: DTzxFTXVrCqrpjq9B9Vg/g ($15.35 in chips) 
cPO/1/dTcZpLkQFm3jH3Rg: posts small blind $0.10
DTzxFTXVrCqrpjq9B9Vg/g: posts big blind $0.25
*** HOLE CARDS ***
V3LJvbHVJHmOj2fd7zIDhA: folds 
nc79pm0LZRdhncq55evVqA: folds 
FabaCGPqGJLjRL48CMvjiQ: calls $0.25
FYepjhAvF8ZdVCmqHIy+eQ: folds 
cPO/1/dTcZpLkQFm3jH3Rg: folds 
DTzxFTXVrCqrpjq9B9Vg/g: checks 
*** FLOP *** [6s 8d Td]
DTzxFTXVrCqrpjq9B9Vg/g: checks 
FabaCGPqGJLjRL48CMvjiQ: bets $0.25
DTzxFTXVrCqrpjq9B9Vg/g: calls $0.25
*** TURN *** [6s 8d Td] [9d]
DTzxFTXVrCqrpjq9B9Vg/g: checks 
FabaCGPqGJLjRL48CMvjiQ: bets $0.25
DTzxFTXVrCqrpjq9B9Vg/g: calls $0.25
*** RIVER *** [6s 8d Td 9d] [4c]
DTzxFTXVrCqrpjq9B9Vg/g: bets $2.50
FabaCGPqGJLjRL48CMvjiQ: folds 
Uncalled bet ($2.50) returned to DTzxFTXVrCqrpjq9B9Vg/g
DTzxFTXVrCqrpjq9B9Vg/g collected $1.55 from pot
*** SUMMARY ***
Total pot $1.60 | Rake $0.05 
Board [6s 8d Td 9d 4c]
Seat 1: V3LJvbHVJHmOj2fd7zIDhA folded before Flop (didn't bet)
Seat 2: nc79pm0LZRdhncq55evVqA folded before Flop (didn't bet)
Seat 3: FabaCGPqGJLjRL48CMvjiQ folded on the River
Seat 4: FYepjhAvF8ZdVCmqHIy+eQ (button) folded before Flop (didn't bet)
Seat 5: cPO/1/dTcZpLkQFm3jH3Rg (small blind) folded before Flop
Seat 6: DTzxFTXVrCqrpjq9B9Vg/g (big blind) collected ($1.55)




PokerStars Game #59939683982:  Hold'em No Limit ($0.10/$0.25) - 2009/07/01 0:46:14 ET
Table '0mmHveGuaIfIMQlNE1eqMg' 9-max Seat #9 is the button
Seat 2: rQhYIYXSyH/IivYM1dlV5A ($57.15 in chips) 
Seat 3: ghNKXUBl/H+t83JF079ZBA ($25.75 in chips) 
Seat 4: r0/CtYRRIJAbPQm4qsv8LQ ($34.65 in chips) 
Seat 5: cVVfy+hwCb/YzSIyUWhKEw ($30.30 in chips) 
Seat 6: Xo1w+VqEZh0bV5wYupnNYg ($13.15 in chips) 
Seat 8: jiyia7h6fmxBdWBkH9lH5A ($4.10 in chips) 
Seat 9: W4TLQcZ2TiM73eIgpIvlGg ($33.90 in chips) 
1S/fpm+f42V/6MNZre+ccg will be allowed to play after the button
rQhYIYXSyH/IivYM1dlV5A: posts small blind $0.10
ghNKXUBl/H+t83JF079ZBA: posts big blind $0.25
*** HOLE CARDS ***
r0/CtYRRIJAbPQm4qsv8LQ: folds 
cVVfy+hwCb/YzSIyUWhKEw: folds 
Xo1w+VqEZh0bV5wYupnNYg: calls $0.25
jiyia7h6fmxBdWBkH9lH5A: calls $0.25
W4TLQcZ2TiM73eIgpIvlGg: calls $0.25
rQhYIYXSyH/IivYM1dlV5A: calls $0.15
ghNKXUBl/H+t83JF079ZBA: checks 
*** FLOP *** [Qs Ad 4s]
rQhYIYXSyH/IivYM1dlV5A: checks 
ghNKXUBl/H+t83JF079ZBA: checks 
Xo1w+VqEZh0bV5wYupnNYg: checks 
jiyia7h6fmxBdWBkH9lH5A: checks 
W4TLQcZ2TiM73eIgpIvlGg: checks 
*** TURN *** [Qs Ad 4s] [Ah]
rQhYIYXSyH/IivYM1dlV5A: checks 
ghNKXUBl/H+t83JF079ZBA: checks 
Xo1w+VqEZh0bV5wYupnNYg: folds 
jiyia7h6fmxBdWBkH9lH5A: checks 
W4TLQcZ2TiM73eIgpIvlGg: checks 
*** RIVER *** [Qs Ad 4s Ah] [Ac]
rQhYIYXSyH/IivYM1dlV5A: checks 
ghNKXUBl/H+t83JF079ZBA: checks 
jiyia7h6fmxBdWBkH9lH5A: bets $0.50
W4TLQcZ2TiM73eIgpIvlGg: folds 
rQhYIYXSyH/IivYM1dlV5A: folds 
ghNKXUBl/H+t83JF079ZBA: folds 
Uncalled bet ($0.50) returned to jiyia7h6fmxBdWBkH9lH5A
jiyia7h6fmxBdWBkH9lH5A collected $1.20 from pot
*** SUMMARY ***
Total pot $1.25 | Rake $0.05 
Board [Qs Ad 4s Ah Ac]
Seat 2: rQhYIYXSyH/IivYM1dlV5A (small blind) folded on the River
Seat 3: ghNKXUBl/H+t83JF079ZBA (big blind) folded on the River
Seat 4: r0/CtYRRIJAbPQm4qsv8LQ folded before Flop (didn't bet)
Seat 5: cVVfy+hwCb/YzSIyUWhKEw folded before Flop (didn't bet)
Seat 6: Xo1w+VqEZh0bV5wYupnNYg folded on the Turn
Seat 8: jiyia7h6fmxBdWBkH9lH5A collected ($1.20)
Seat 9: W4TLQcZ2TiM73eIgpIvlGg (button) folded on the River




PokerStars Game #59939683888:  Hold'em No Limit ($0.10/$0.25) - 2009/07/01 0:46:14 ET
Table '9iHhO6FyZVM8XpSc23TIgg' 6-max Seat #2 is the button
Seat 1: NhUN/JpAprdJeamFBgJH1w ($25 in chips) 
Seat 2: ErIN0JRL5srYjT6en1f8YQ ($31.55 in chips) 
Seat 4: cfJccEfyn6IkquPN08hFsA ($35.45 in chips) 
Seat 5: WmfI+HZXhME/HMG8E3/H2w ($31.85 in chips) 
Seat 6: WrLI51S2iMb8GLMB83gGqA ($25 in chips) 
RYLaAIIwK9wxkPswt1yJYw will be allowed to play after the button
cfJccEfyn6IkquPN08hFsA: posts small blind $0.10
WmfI+HZXhME/HMG8E3/H2w: posts big blind $0.25
*** HOLE CARDS ***
WrLI51S2iMb8GLMB83gGqA: folds 
NhUN/JpAprdJeamFBgJH1w: folds 
ErIN0JRL5srYjT6en1f8YQ: raises $0.50 to $0.75
cfJccEfyn6IkquPN08hFsA: calls $0.65
WmfI+HZXhME/HMG8E3/H2w: calls $0.50
*** FLOP *** [Ts 9h 8h]
cfJccEfyn6IkquPN08hFsA: bets $2
WmfI+HZXhME/HMG8E3/H2w: folds 
ErIN0JRL5srYjT6en1f8YQ: folds 
Uncalled bet ($2) returned to cfJccEfyn6IkquPN08hFsA
cfJccEfyn6IkquPN08hFsA collected $2.15 from pot
cfJccEfyn6IkquPN08hFsA: doesn't show hand 
*** SUMMARY ***
Total pot $2.25 | Rake $0.10 
Board [Ts 9h 8h]
Seat 1: NhUN/JpAprdJeamFBgJH1w folded before Flop (didn't bet)
Seat 2: ErIN0JRL5srYjT6en1f8YQ (button) folded on the Flop
Seat 4: cfJccEfyn6IkquPN08hFsA (small blind) collected ($2.15)
Seat 5: WmfI+HZXhME/HMG8E3/H2w (big blind) folded on the Flop
Seat 6: WrLI51S2iMb8GLMB83gGqA folded before Flop (didn't bet)




PokerStars Game #59939684184:  Hold'em No Limit ($0.10/$0.25) - 2009/07/01 0:46:14 ET
Table 'g6ryG70feTw9nNm+XJLuXw' 6-max Seat #3 is the button
Seat 1: v+QfkGiuj9bgtuNoVnDO8w ($26.40 in chips) 
Seat 2: SxIIgwXYLkwd6m3wLyPTCw ($28.45 in chips) 
Seat 3: /6h8PvAHQmfuMUZ8OUF6Xw ($18.65 in chips) 
Seat 4: GC/9yVD59DUCX7hUI7gcLw ($40.10 in chips) 
Seat 5: EE16Ua5b1HSsYej5zeXOlA ($29.30 in chips) 
GC/9yVD59DUCX7hUI7gcLw: posts small blind $0.10
EE16Ua5b1HSsYej5zeXOlA: posts big blind $0.25
*** HOLE CARDS ***
v+QfkGiuj9bgtuNoVnDO8w: folds 
SxIIgwXYLkwd6m3wLyPTCw: raises $0.50 to $0.75
/6h8PvAHQmfuMUZ8OUF6Xw: folds 
GC/9yVD59DUCX7hUI7gcLw: folds 
EE16Ua5b1HSsYej5zeXOlA: calls $0.50
*** FLOP *** [6c 6h 9s]
EE16Ua5b1HSsYej5zeXOlA: checks 
SxIIgwXYLkwd6m3wLyPTCw: bets $1.25
EE16Ua5b1HSsYej5zeXOlA: raises $2.25 to $3.50
SxIIgwXYLkwd6m3wLyPTCw: folds 
Uncalled bet ($2.25) returned to EE16Ua5b1HSsYej5zeXOlA
EE16Ua5b1HSsYej5zeXOlA collected $3.90 from pot
EE16Ua5b1HSsYej5zeXOlA: doesn't show hand 
*** SUMMARY ***
Total pot $4.10 | Rake $0.20 
Board [6c 6h 9s]
Seat 1: v+QfkGiuj9bgtuNoVnDO8w folded before Flop (didn't bet)
Seat 2: SxIIgwXYLkwd6m3wLyPTCw folded on the Flop
Seat 3: /6h8PvAHQmfuMUZ8OUF6Xw (button) folded before Flop (didn't bet)
Seat 4: GC/9yVD59DUCX7hUI7gcLw (small blind) folded before Flop
Seat 5: EE16Ua5b1HSsYej5zeXOlA (big blind) collected ($3.90)




PokerStars Game #59939684066:  Hold'em No Limit ($0.10/$0.25) - 2009/07/01 0:46:14 ET
Table 'zW+7jPbOLCvlPu+dUGY5WQ' 6-max Seat #5 is the button
Seat 1: JE/wJXmjw3bpdmjwvh2pcg ($25 in chips) 
Seat 2: DXgVFTcE3WofABsNJ5G/nw ($38.80 in chips) 
Seat 3: BedjMfrlRfPgSq7CXpPAmg ($63.40 in chips) 
Seat 5: SFmT9ZsVopnukjvAzrxTRg ($55.10 in chips) 
Seat 6: BiLBinPhgpKAYzLgKJVU5A ($21.55 in chips) 
BiLBinPhgpKAYzLgKJVU5A: posts small blind $0.10
JE/wJXmjw3bpdmjwvh2pcg: posts big blind $0.25
*** HOLE CARDS ***
DXgVFTcE3WofABsNJ5G/nw: folds 
BedjMfrlRfPgSq7CXpPAmg: folds 
DXgVFTcE3WofABsNJ5G/nw leaves the table
SFmT9ZsVopnukjvAzrxTRg: raises $0.75 to $1
BiLBinPhgpKAYzLgKJVU5A: folds 
JE/wJXmjw3bpdmjwvh2pcg: folds 
Uncalled bet ($0.75) returned to SFmT9ZsVopnukjvAzrxTRg
JE/wJXmjw3bpdmjwvh2pcg is sitting out
SFmT9ZsVopnukjvAzrxTRg collected $0.60 from pot
SFmT9ZsVopnukjvAzrxTRg: doesn't show hand 
*** SUMMARY ***
Total pot $0.60 | Rake $0 
Seat 1: JE/wJXmjw3bpdmjwvh2pcg (big blind) folded before Flop
Seat 2: DXgVFTcE3WofABsNJ5G/nw folded before Flop (didn't bet)
Seat 3: BedjMfrlRfPgSq7CXpPAmg folded before Flop (didn't bet)
Seat 5: SFmT9ZsVopnukjvAzrxTRg (button) collected ($0.60)
Seat 6: BiLBinPhgpKAYzLgKJVU5A (small blind) folded before Flop




PokerStars Game #59939685064:  Hold'em No Limit ($0.10/$0.25) - 2009/07/01 0:46:15 ET
Table 'fRxOyfaHXkWUDLv4eSxFew' 9-max Seat #7 is the button
Seat 1: 6RiVTYll/5D8zICp0MRpKw ($25 in chips) 
Seat 2: TeWJxSETzbXGiYKx0y+dtg ($24.65 in chips) 
Seat 3: hBMUlEpyU74r/fwDgIpXjQ ($28.30 in chips) 
Seat 4: +WMpj67YqG8ilNkg2JwXpw ($15.95 in chips) 
Seat 6: N/O9ADKpmqB2ASZuqgodlw ($5.35 in chips) 
Seat 7: 7cv+9Zc9HIQHNvYsMfV3uA ($55.40 in chips) 
Seat 9: H5Se03ZqSX7tbULXur2MAg ($23.55 in chips) 
H5Se03ZqSX7tbULXur2MAg: posts small blind $0.10
6RiVTYll/5D8zICp0MRpKw: posts big blind $0.25
*** HOLE CARDS ***
TeWJxSETzbXGiYKx0y+dtg: folds 
hBMUlEpyU74r/fwDgIpXjQ: folds 
+WMpj67YqG8ilNkg2JwXpw: folds 
N/O9ADKpmqB2ASZuqgodlw: calls $0.25
7cv+9Zc9HIQHNvYsMfV3uA: folds 
H5Se03ZqSX7tbULXur2MAg: folds 
6RiVTYll/5D8zICp0MRpKw: checks 
*** FLOP *** [4s Qd Jc]
6RiVTYll/5D8zICp0MRpKw: checks 
N/O9ADKpmqB2ASZuqgodlw: bets $1.50
6RiVTYll/5D8zICp0MRpKw: folds 
Uncalled bet ($1.50) returned to N/O9ADKpmqB2ASZuqgodlw
N/O9ADKpmqB2ASZuqgodlw collected $0.60 from pot
*** SUMMARY ***
Total pot $0.60 | Rake $0 
Board [4s Qd Jc]
Seat 1: 6RiVTYll/5D8zICp0MRpKw (big blind) folded on the Flop
Seat 2: TeWJxSETzbXGiYKx0y+dtg folded before Flop (didn't bet)
Seat 3: hBMUlEpyU74r/fwDgIpXjQ folded before Flop (didn't bet)
Seat 4: +WMpj67YqG8ilNkg2JwXpw folded before Flop (didn't bet)
Seat 6: N/O9ADKpmqB2ASZuqgodlw collected ($0.60)
Seat 7: 7cv+9Zc9HIQHNvYsMfV3uA (button) folded before Flop (didn't bet)
Seat 9: H5Se03ZqSX7tbULXur2MAg (small blind) folded before Flop




PokerStars Game #59939685120:  Hold'em No Limit ($0.10/$0.25) - 2009/07/01 0:46:15 ET
Table 'jxoHy9yJy0bbH/Qx73FoPA' 9-max Seat #4 is the button
Seat 1: jN7A9nKK4RYzhFj4MrekhA ($15.30 in chips) 
Seat 2: F7pnn6czNpHvRM55XcA2EA ($25.95 in chips) 
Seat 3: /DYYmfrw4B9z+N2z81dNtA ($18.55 in chips) 
Seat 4: RJ/x9oZtt1RZLaJEQwZOxQ ($26.55 in chips) 
Seat 6: tYsOBqdU1+x+yFI7zHO7hQ ($51.65 in chips) 
Seat 8: hBMUlEpyU74r/fwDgIpXjQ ($33.30 in chips) 
Seat 9: IG1d4tXnNA98OKRYYE3l+A ($53.60 in chips) 
tYsOBqdU1+x+yFI7zHO7hQ: posts small blind $0.10
That O G: is sitting out 
hBMUlEpyU74r/fwDgIpXjQ: posts big blind $0.25
*** HOLE CARDS ***
IG1d4tXnNA98OKRYYE3l+A: raises $0.75 to $1
jN7A9nKK4RYzhFj4MrekhA: folds 
F7pnn6czNpHvRM55XcA2EA: folds 
/DYYmfrw4B9z+N2z81dNtA: folds 
RJ/x9oZtt1RZLaJEQwZOxQ: folds 
tYsOBqdU1+x+yFI7zHO7hQ: folds 
hBMUlEpyU74r/fwDgIpXjQ: folds 
Uncalled bet ($0.75) returned to IG1d4tXnNA98OKRYYE3l+A
That O G leaves the table
IG1d4tXnNA98OKRYYE3l+A collected $0.60 from pot
IG1d4tXnNA98OKRYYE3l+A: doesn't show hand 
*** SUMMARY ***
Total pot $0.60 | Rake $0 
Seat 1: jN7A9nKK4RYzhFj4MrekhA folded before Flop (didn't bet)
Seat 2: F7pnn6czNpHvRM55XcA2EA folded before Flop (didn't bet)
Seat 3: /DYYmfrw4B9z+N2z81dNtA folded before Flop (didn't bet)
Seat 4: RJ/x9oZtt1RZLaJEQwZOxQ (button) folded before Flop (didn't bet)
Seat 6: tYsOBqdU1+x+yFI7zHO7hQ (small blind) folded before Flop
Seat 8: hBMUlEpyU74r/fwDgIpXjQ (big blind) folded before Flop
Seat 9: IG1d4tXnNA98OKRYYE3l+A collected ($0.60)




PokerStars Game #59939685068:  Hold'em No Limit ($0.10/$0.25) - 2009/07/01 0:46:15 ET
Table 'fHv1Mk7ZbLjprZTGWKPiEQ' 6-max Seat #6 is the button
Seat 1: nrBtxp+MnBtUJ1AIhZxHkg ($25.70 in chips) 
Seat 2: f6TKWwdxmqfPaZe08T+mgg ($6.05 in chips) 
Seat 3: HyeBXe7tNOZjTdX/zI0BZQ ($14.10 in chips) 
Seat 4: TSmua8tGK3sTbwi0ynrW9Q ($51.90 in chips) 
Seat 5: edio/rLJ06xeZOfLhoL3UA ($26.90 in chips) 
Seat 6: AjG0X+rNtc2W08eph8oqpw ($8.60 in chips) 
nrBtxp+MnBtUJ1AIhZxHkg: posts small blind $0.10
f6TKWwdxmqfPaZe08T+mgg: posts big blind $0.25
*** HOLE CARDS ***
HyeBXe7tNOZjTdX/zI0BZQ: raises $0.25 to $0.50
TSmua8tGK3sTbwi0ynrW9Q: folds 
edio/rLJ06xeZOfLhoL3UA: raises $1.25 to $1.75
AjG0X+rNtc2W08eph8oqpw: folds 
nrBtxp+MnBtUJ1AIhZxHkg: calls $1.65
f6TKWwdxmqfPaZe08T+mgg: folds 
HyeBXe7tNOZjTdX/zI0BZQ: calls $1.25
*** FLOP *** [Jd Qs 9h]
nrBtxp+MnBtUJ1AIhZxHkg: checks 
HyeBXe7tNOZjTdX/zI0BZQ: checks 
edio/rLJ06xeZOfLhoL3UA: checks 
*** TURN *** [Jd Qs 9h] [Td]
nrBtxp+MnBtUJ1AIhZxHkg: checks 
HyeBXe7tNOZjTdX/zI0BZQ: bets $0.50
edio/rLJ06xeZOfLhoL3UA: calls $0.50
nrBtxp+MnBtUJ1AIhZxHkg: calls $0.50
*** RIVER *** [Jd Qs 9h Td] [Tc]
nrBtxp+MnBtUJ1AIhZxHkg: checks 
HyeBXe7tNOZjTdX/zI0BZQ: bets $0.75
edio/rLJ06xeZOfLhoL3UA: raises $4.25 to $5
nrBtxp+MnBtUJ1AIhZxHkg: folds 
HyeBXe7tNOZjTdX/zI0BZQ: calls $4.25
*** SHOW DOWN ***
edio/rLJ06xeZOfLhoL3UA: shows [7d As] (a pair of Tens)
HyeBXe7tNOZjTdX/zI0BZQ: shows [8d 9s] (a straight, Eight to Queen)
HyeBXe7tNOZjTdX/zI0BZQ collected $16.20 from pot
*** SUMMARY ***
Total pot $17 | Rake $0.80 
Board [Jd Qs 9h Td Tc]
Seat 1: nrBtxp+MnBtUJ1AIhZxHkg (small blind) folded on the River
Seat 2: f6TKWwdxmqfPaZe08T+mgg (big blind) folded before Flop
Seat 3: HyeBXe7tNOZjTdX/zI0BZQ showed [8d 9s] and won ($16.20) with a straight, Eight to Queen
Seat 4: TSmua8tGK3sTbwi0ynrW9Q folded before Flop (didn't bet)
Seat 5: edio/rLJ06xeZOfLhoL3UA showed [7d As] and lost with a pair of Tens
Seat 6: AjG0X+rNtc2W08eph8oqpw (button) folded before Flop (didn't bet)




PokerStars Game #59939684894:  Hold'em No Limit ($0.10/$0.25) - 2009/07/01 0:46:15 ET
Table 'QegsWX65l3n/K0A8XB78yg' 6-max Seat #4 is the button
Seat 1: 8ClCHtFXGNplITm+63KB+Q ($28.60 in chips) 
Seat 2: GC/9yVD59DUCX7hUI7gcLw ($32.55 in chips) 
Seat 3: 9jSiy0meE9XJKkdIZwyTEQ ($25.25 in chips) 
Seat 4: kyRaCIljYA6l33lSKQfNsg ($25.35 in chips) 
Seat 5: 4YSTu0Cdzpppe1lUgCZGCQ ($57.55 in chips) 
Seat 6: JE/wJXmjw3bpdmjwvh2pcg ($36.75 in chips) 
4YSTu0Cdzpppe1lUgCZGCQ: posts small blind $0.10
JE/wJXmjw3bpdmjwvh2pcg: posts big blind $0.25
*** HOLE CARDS ***
8ClCHtFXGNplITm+63KB+Q: folds 
GC/9yVD59DUCX7hUI7gcLw: folds 
9jSiy0meE9XJKkdIZwyTEQ: raises $0.60 to $0.85
kyRaCIljYA6l33lSKQfNsg: folds 
4YSTu0Cdzpppe1lUgCZGCQ: folds 
JE/wJXmjw3bpdmjwvh2pcg: folds 
Uncalled bet ($0.60) returned to 9jSiy0meE9XJKkdIZwyTEQ
9jSiy0meE9XJKkdIZwyTEQ collected $0.60 from pot
9jSiy0meE9XJKkdIZwyTEQ: doesn't show hand 
*** SUMMARY ***
Total pot $0.60 | Rake $0 
Seat 1: 8ClCHtFXGNplITm+63KB+Q folded before Flop (didn't bet)
Seat 2: GC/9yVD59DUCX7hUI7gcLw folded before Flop (didn't bet)
Seat 3: 9jSiy0meE9XJKkdIZwyTEQ collected ($0.60)
Seat 4: kyRaCIljYA6l33lSKQfNsg (button) folded before Flop (didn't bet)
Seat 5: 4YSTu0Cdzpppe1lUgCZGCQ (small blind) folded before Flop
Seat 6: JE/wJXmjw3bpdmjwvh2pcg (big blind) folded before Flop




PokerStars Game #59939684772:  Hold'em No Limit ($0.10/$0.25) - 2009/07/01 0:46:15 ET
Table 'ER5H84HUgJx7HyDLnELLeA' 6-max Seat #3 is the button
Seat 1: pjM/xh4+RG8zrxCobDgYDg ($16.70 in chips) 
Seat 2: nc79pm0LZRdhncq55evVqA ($48.50 in chips) 
Seat 3: BYxjLnV1/LL0aZcTbfAOvw ($25 in chips) 
Seat 4: tkRWn3WaJIfGmCXT2hPvJA ($18.90 in chips) 
Seat 5: mfrkWA3PTeYPkbO6hi98Aw ($24.90 in chips) 
Seat 6: 3zD3qLXT1bEffAoWGnc7wg ($30.85 in chips) 
tkRWn3WaJIfGmCXT2hPvJA: posts small blind $0.10
mfrkWA3PTeYPkbO6hi98Aw: posts big blind $0.25
*** HOLE CARDS ***
3zD3qLXT1bEffAoWGnc7wg: folds 
pjM/xh4+RG8zrxCobDgYDg: folds 
nc79pm0LZRdhncq55evVqA: folds 
BYxjLnV1/LL0aZcTbfAOvw: folds 
tkRWn3WaJIfGmCXT2hPvJA: calls $0.15
mfrkWA3PTeYPkbO6hi98Aw: checks 
*** FLOP *** [2c Ad 8c]
tkRWn3WaJIfGmCXT2hPvJA: bets $0.25
mfrkWA3PTeYPkbO6hi98Aw: raises $1 to $1.25
tkRWn3WaJIfGmCXT2hPvJA: folds 
Uncalled bet ($1) returned to mfrkWA3PTeYPkbO6hi98Aw
mfrkWA3PTeYPkbO6hi98Aw collected $0.95 from pot
mfrkWA3PTeYPkbO6hi98Aw: doesn't show hand 
*** SUMMARY ***
Total pot $1 | Rake $0.05 
Board [2c Ad 8c]
Seat 1: pjM/xh4+RG8zrxCobDgYDg folded before Flop (didn't bet)
Seat 2: nc79pm0LZRdhncq55evVqA folded before Flop (didn't bet)
Seat 3: BYxjLnV1/LL0aZcTbfAOvw (button) folded before Flop (didn't bet)
Seat 4: tkRWn3WaJIfGmCXT2hPvJA (small blind) folded on the Flop
Seat 5: mfrkWA3PTeYPkbO6hi98Aw (big blind) collected ($0.95)
Seat 6: 3zD3qLXT1bEffAoWGnc7wg folded before Flop (didn't bet)




PokerStars Game #59939684720:  Hold'em No Limit ($0.10/$0.25) - 2009/07/01 0:46:15 ET
Table 'WY+lMaAoIdBZmwk27/RJCA' 6-max Seat #2 is the button
Seat 1: lYjWCpfCxX2kgcHY3v4Yow ($25.70 in chips) 
Seat 2: cPO/1/dTcZpLkQFm3jH3Rg ($26.85 in chips) 
Seat 3: 79Q62AM0VB++TQYiBlOYsA ($36.95 in chips) 
Seat 4: cGfAi40F+9odP4v0stvfiQ ($32 in chips) 
Seat 5: wKFJ513ucluNNiMlkXcDOQ ($25 in chips) 
Seat 6: I1TxPvWj8NfG8orglCinNA ($26 in chips) 
79Q62AM0VB++TQYiBlOYsA: posts small blind $0.10
cGfAi40F+9odP4v0stvfiQ: posts big blind $0.25
*** HOLE CARDS ***
wKFJ513ucluNNiMlkXcDOQ: folds 
I1TxPvWj8NfG8orglCinNA: folds 
lYjWCpfCxX2kgcHY3v4Yow: folds 
cPO/1/dTcZpLkQFm3jH3Rg: folds 
79Q62AM0VB++TQYiBlOYsA: folds 
Uncalled bet ($0.15) returned to cGfAi40F+9odP4v0stvfiQ
cGfAi40F+9odP4v0stvfiQ collected $0.20 from pot
cGfAi40F+9odP4v0stvfiQ: doesn't show hand 
*** SUMMARY ***
Total pot $0.20 | Rake $0 
Seat 1: lYjWCpfCxX2kgcHY3v4Yow folded before Flop (didn't bet)
Seat 2: cPO/1/dTcZpLkQFm3jH3Rg (button) folded before Flop (didn't bet)
Seat 3: 79Q62AM0VB++TQYiBlOYsA (small blind) folded before Flop
Seat 4: cGfAi40F+9odP4v0stvfiQ (big blind) collected ($0.20)
Seat 5: wKFJ513ucluNNiMlkXcDOQ folded before Flop (didn't bet)
Seat 6: I1TxPvWj8NfG8orglCinNA folded before Flop (didn't bet)




PokerStars Game #59939684630:  Hold'em No Limit ($0.10/$0.25) - 2009/07/01 0:46:15 ET
Table '9lYs7ljXi6AgFAxYHlKLJw' 9-max Seat #1 is the button
Seat 1: K0b5wNInj6hUGRr6yzKFtw ($25 in chips) 
Seat 2: N6fYvIzQLKaydFLKQGtMlQ ($21.85 in chips) 
Seat 3: DnDcAdn9P0zGovMERigpFA ($25 in chips) 
Seat 4: UANt6y/SmDCY/jIxkBixcw ($30 in chips) 
Seat 5: dfNim92Z6XK1/h5SFW5vDg ($55.20 in chips) 
Seat 7: ghNKXUBl/H+t83JF079ZBA ($28.75 in chips) 
Seat 8: 8GJHzzxiotOqC5gdtgpLoA ($5.90 in chips) 
Seat 9: 18G4P1XstjNvItdGUITxgw ($36.15 in chips) 
N6fYvIzQLKaydFLKQGtMlQ: posts small blind $0.10
DnDcAdn9P0zGovMERigpFA: posts big blind $0.25
tYsOBqdU1+x+yFI7zHO7hQ: sits out 
*** HOLE CARDS ***
UANt6y/SmDCY/jIxkBixcw: calls $0.25
dfNim92Z6XK1/h5SFW5vDg: folds 
ghNKXUBl/H+t83JF079ZBA: folds 
8GJHzzxiotOqC5gdtgpLoA: folds 
18G4P1XstjNvItdGUITxgw: folds 
K0b5wNInj6hUGRr6yzKFtw: folds 
N6fYvIzQLKaydFLKQGtMlQ: folds 
DnDcAdn9P0zGovMERigpFA: checks 
*** FLOP *** [Jc Qs 8d]
DnDcAdn9P0zGovMERigpFA: checks 
UANt6y/SmDCY/jIxkBixcw: bets $0.50
DnDcAdn9P0zGovMERigpFA: folds 
Uncalled bet ($0.50) returned to UANt6y/SmDCY/jIxkBixcw
UANt6y/SmDCY/jIxkBixcw collected $0.60 from pot
UANt6y/SmDCY/jIxkBixcw: doesn't show hand 
*** SUMMARY ***
Total pot $0.60 | Rake $0 
Board [Jc Qs 8d]
Seat 1: K0b5wNInj6hUGRr6yzKFtw (button) folded before Flop (didn't bet)
Seat 2: N6fYvIzQLKaydFLKQGtMlQ (small blind) folded before Flop
Seat 3: DnDcAdn9P0zGovMERigpFA (big blind) folded on the Flop
Seat 4: UANt6y/SmDCY/jIxkBixcw collected ($0.60)
Seat 5: dfNim92Z6XK1/h5SFW5vDg folded before Flop (didn't bet)
Seat 7: ghNKXUBl/H+t83JF079ZBA folded before Flop (didn't bet)
Seat 8: 8GJHzzxiotOqC5gdtgpLoA folded before Flop (didn't bet)
Seat 9: 18G4P1XstjNvItdGUITxgw folded before Flop (didn't bet)




PokerStars Game #59939685044:  Hold'em No Limit ($0.10/$0.25) - 2009/07/01 0:46:15 ET
Table 'KTZXQ4LREPjpS54R3DFTsw' 9-max Seat #6 is the button
Seat 1: dSjkBIV7Bv+ZCIWNBguf7w ($34 in chips) 
Seat 2: hQgb9iRlpctfdl51mltYlw ($27.60 in chips) 
Seat 3: N6fYvIzQLKaydFLKQGtMlQ ($35.70 in chips) 
Seat 4: K0b5wNInj6hUGRr6yzKFtw ($25.15 in chips) 
Seat 5: HPEB+AtKw1+C/cxU0o1ciw ($31.25 in chips) 
Seat 6: 1q23ISSsSMhv2lHXBfj9/A ($23.50 in chips) 
Seat 7: yyG4svzOpC1A+sUP/scg6w ($8.30 in chips) 
Seat 8: wZluzulQ98aycXC12mG7qA ($5.80 in chips) 
yyG4svzOpC1A+sUP/scg6w: posts small blind $0.10
wZluzulQ98aycXC12mG7qA: posts big blind $0.25
V6p0jQ/RhUsqpHLmXvEX4Q: sits out 
*** HOLE CARDS ***
dSjkBIV7Bv+ZCIWNBguf7w: folds 
hQgb9iRlpctfdl51mltYlw: folds 
hQgb9iRlpctfdl51mltYlw leaves the table
N6fYvIzQLKaydFLKQGtMlQ: folds 
K0b5wNInj6hUGRr6yzKFtw: folds 
HPEB+AtKw1+C/cxU0o1ciw: folds 
1q23ISSsSMhv2lHXBfj9/A: folds 
yyG4svzOpC1A+sUP/scg6w: calls $0.15
wZluzulQ98aycXC12mG7qA: checks 
*** FLOP *** [Kd 6s 2s]
yyG4svzOpC1A+sUP/scg6w: checks 
wZluzulQ98aycXC12mG7qA: bets $0.25
yyG4svzOpC1A+sUP/scg6w: folds 
Uncalled bet ($0.25) returned to wZluzulQ98aycXC12mG7qA
wZluzulQ98aycXC12mG7qA collected $0.50 from pot
wZluzulQ98aycXC12mG7qA: doesn't show hand 
*** SUMMARY ***
Total pot $0.50 | Rake $0 
Board [Kd 6s 2s]
Seat 1: dSjkBIV7Bv+ZCIWNBguf7w folded before Flop (didn't bet)
Seat 2: hQgb9iRlpctfdl51mltYlw folded before Flop (didn't bet)
Seat 3: N6fYvIzQLKaydFLKQGtMlQ folded before Flop (didn't bet)
Seat 4: K0b5wNInj6hUGRr6yzKFtw folded before Flop (didn't bet)
Seat 5: HPEB+AtKw1+C/cxU0o1ciw folded before Flop (didn't bet)
Seat 6: 1q23ISSsSMhv2lHXBfj9/A (button) folded before Flop (didn't bet)
Seat 7: yyG4svzOpC1A+sUP/scg6w (small blind) folded on the Flop
Seat 8: wZluzulQ98aycXC12mG7qA (big blind) collected ($0.50)




PokerStars Game #59939685062:  Hold'em No Limit ($0.10/$0.25) - 2009/07/01 0:46:15 ET
Table 'sIHZ0lzLr4NGCaBUKhmYhAr562aMIMs5kgo28FEU6lkAax Seat #9 is the button
Seat 1: vZGoOTJLQLhkPj4I+LNGig ($31.55 in chips) 
Seat 2: N8muFAHrFHW6elSMGuyVLQ ($14.75 in chips) 
Seat 3: vX2B+8jhZFyBctQ3P4IKEw ($11 in chips) 
Seat 4: XBq1lBzax7LjRqdJP2TqWg ($11.60 in chips) 
Seat 5: zDrucyjVn5aeekNEc3cJrA ($37.30 in chips) 
Seat 7: R6nIVAjK7uhK3Hj0f85A+A ($18.35 in chips) 
Seat 8: B6xHiX1SJkS0CUNCKDVwuQ ($29.35 in chips) 
Seat 9: W4TLQcZ2TiM73eIgpIvlGg ($25.50 in chips) 
vZGoOTJLQLhkPj4I+LNGig: posts small blind $0.10
N8muFAHrFHW6elSMGuyVLQ: posts big blind $0.25
*** HOLE CARDS ***
rCaXm4/EwAgWqCiClpbsqQ has returned
vX2B+8jhZFyBctQ3P4IKEw: calls $0.25
XBq1lBzax7LjRqdJP2TqWg: folds 
zDrucyjVn5aeekNEc3cJrA: folds 
R6nIVAjK7uhK3Hj0f85A+A: folds 
B6xHiX1SJkS0CUNCKDVwuQ: raises $0.50 to $0.75
W4TLQcZ2TiM73eIgpIvlGg: folds 
vZGoOTJLQLhkPj4I+LNGig: folds 
N8muFAHrFHW6elSMGuyVLQ: folds 
vX2B+8jhZFyBctQ3P4IKEw: calls $0.50
*** FLOP *** [3s 3d 5d]
vX2B+8jhZFyBctQ3P4IKEw: checks 
B6xHiX1SJkS0CUNCKDVwuQ: bets $1
vX2B+8jhZFyBctQ3P4IKEw: folds 
Uncalled bet ($1) returned to B6xHiX1SJkS0CUNCKDVwuQ
B6xHiX1SJkS0CUNCKDVwuQ collected $1.80 from pot
B6xHiX1SJkS0CUNCKDVwuQ: doesn't show hand 
*** SUMMARY ***
Total pot $1.85 | Rake $0.05 
Board [3s 3d 5d]
Seat 1: vZGoOTJLQLhkPj4I+LNGig (small blind) folded before Flop
Seat 2: N8muFAHrFHW6elSMGuyVLQ (big blind) folded before Flop
Seat 3: vX2B+8jhZFyBctQ3P4IKEw folded on the Flop
Seat 4: XBq1lBzax7LjRqdJP2TqWg folded before Flop (didn't bet)
Seat 5: zDrucyjVn5aeekNEc3cJrA folded before Flop (didn't bet)
Seat 7: R6nIVAjK7uhK3Hj0f85A+A folded before Flop (didn't bet)
Seat 8: B6xHiX1SJkS0CUNCKDVwuQ collected ($1.80)
Seat 9: W4TLQcZ2TiM73eIgpIvlGg (button) folded before Flop (didn't bet)




PokerStars Game #59939684520:  Hold'em No Limit ($0.10/$0.25) - 2009/07/01 0:46:15 ET
Table 'RuT55t7dqtns1CdLsutksg' 9-max Seat #4 is the button
Seat 1: N6WEabmk+J6IGeE7kub1QQ ($40.35 in chips) 
Seat 2: CYkY0dNBaYaKs8HVCVn3mQ ($5 in chips) 
Seat 3: xOx0qYgTfvbPkTa+GuX0WA ($16 in chips) 
Seat 4: MG90wfSJZnOejs/KD3vlQQ ($26.70 in chips) 
Seat 5: 0D3Q+hLxjPei/5wgaaYhZA ($6.60 in chips) 
Seat 6: CqwJk5Z2+vb2f9j1o7IjKQ ($13.85 in chips) 
Seat 8: yyG4svzOpC1A+sUP/scg6w ($7.15 in chips) 
Seat 9: 42xLFHn85WRGGaaUZTNvwA ($7.05 in chips) 
0D3Q+hLxjPei/5wgaaYhZA: posts small blind $0.10
CqwJk5Z2+vb2f9j1o7IjKQ: posts big blind $0.25
7wo6Sr7QG3Zo6BaBDV1BOw: sits out 
42xLFHn85WRGGaaUZTNvwA: posts big blind $0.25
*** HOLE CARDS ***
yyG4svzOpC1A+sUP/scg6w: folds 
42xLFHn85WRGGaaUZTNvwA: raises $0.50 to $0.75
N6WEabmk+J6IGeE7kub1QQ: calls $0.75
CYkY0dNBaYaKs8HVCVn3mQ: folds 
xOx0qYgTfvbPkTa+GuX0WA: folds 
MG90wfSJZnOejs/KD3vlQQ: folds 
0D3Q+hLxjPei/5wgaaYhZA: calls $0.65
CqwJk5Z2+vb2f9j1o7IjKQ: folds 
*** FLOP *** [4h 6s Ts]
0D3Q+hLxjPei/5wgaaYhZA: bets $0.75
42xLFHn85WRGGaaUZTNvwA: calls $0.75
N6WEabmk+J6IGeE7kub1QQ: calls $0.75
*** TURN *** [4h 6s Ts] [2d]
0D3Q+hLxjPei/5wgaaYhZA: bets $5.10 and is all-in
42xLFHn85WRGGaaUZTNvwA: folds 
N6WEabmk+J6IGeE7kub1QQ: folds 
Uncalled bet ($5.10) returned to 0D3Q+hLxjPei/5wgaaYhZA
0D3Q+hLxjPei/5wgaaYhZA collected $4.55 from pot
*** SUMMARY ***
Total pot $4.75 | Rake $0.20 
Board [4h 6s Ts 2d]
Seat 1: N6WEabmk+J6IGeE7kub1QQ folded on the Turn
Seat 2: CYkY0dNBaYaKs8HVCVn3mQ folded before Flop (didn't bet)
Seat 3: xOx0qYgTfvbPkTa+GuX0WA folded before Flop (didn't bet)
Seat 4: MG90wfSJZnOejs/KD3vlQQ (button) folded before Flop (didn't bet)
Seat 5: 0D3Q+hLxjPei/5wgaaYhZA (small blind) collected ($4.55)
Seat 6: CqwJk5Z2+vb2f9j1o7IjKQ (big blind) folded before Flop
Seat 8: yyG4svzOpC1A+sUP/scg6w folded before Flop (didn't bet)
Seat 9: 42xLFHn85WRGGaaUZTNvwA folded on the Turn




PokerStars Game #59939684920:  Hold'em No Limit ($0.10/$0.25) - 2009/07/01 0:46:15 ET
Table 'vud0GB/ZlDCvUFhBFIaTlg' 9-max Seat #4 is the button
Seat 4: ss810etqPS9ni/HJIweF/g ($6.75 in chips) 
Seat 5: AwAabNdwDsTMb3aTomdOmg ($8.55 in chips) 
Seat 6: NDJWZaU2QihSadZB98k0tg ($25 in chips) 
Seat 9: ROo8kPnsdL612mO7wzI5Bg ($7.75 in chips) 
AwAabNdwDsTMb3aTomdOmg: posts small blind $0.10
NDJWZaU2QihSadZB98k0tg: posts big blind $0.25
Am29qRe4OYkVWs70NjNDBw: sits out 
DHobes12: sits out 
*** HOLE CARDS ***
ROo8kPnsdL612mO7wzI5Bg: folds 
ss810etqPS9ni/HJIweF/g: raises $0.75 to $1
AwAabNdwDsTMb3aTomdOmg: folds 
NDJWZaU2QihSadZB98k0tg: folds 
Uncalled bet ($0.75) returned to ss810etqPS9ni/HJIweF/g
ss810etqPS9ni/HJIweF/g collected $0.60 from pot
*** SUMMARY ***
Total pot $0.60 | Rake $0 
Seat 4: ss810etqPS9ni/HJIweF/g (button) collected ($0.60)
Seat 5: AwAabNdwDsTMb3aTomdOmg (small blind) folded before Flop
Seat 6: NDJWZaU2QihSadZB98k0tg (big blind) folded before Flop
Seat 9: ROo8kPnsdL612mO7wzI5Bg folded before Flop (didn't bet)




PokerStars Game #59939685758:  Hold'em No Limit ($0.10/$0.25) - 2009/07/01 0:46:16 ET
Table 'ykyWGjhNu7AvZXov27T4ew' 9-max Seat #8 is the button
Seat 2: MG90wfSJZnOejs/KD3vlQQ ($47.45 in chips) 
Seat 3: r1pFKMwWp74QwhfPWJOAyw ($5.50 in chips) 
Seat 4: hBMUlEpyU74r/fwDgIpXjQ ($25 in chips) 
Seat 5: lMysP2jE94oJvWGA6K5puw ($7 in chips) 
Seat 6: opOCI2p6kW0tINuVaAqmcQ ($25.55 in chips) 
Seat 7: CYkY0dNBaYaKs8HVCVn3mQ ($4.65 in chips) 
Seat 8: tYsOBqdU1+x+yFI7zHO7hQ ($35.50 in chips) 
Seat 9: nm4Dj/f+jJEwKVsUnKh73g ($24.50 in chips) 
nm4Dj/f+jJEwKVsUnKh73g: posts small blind $0.10
MG90wfSJZnOejs/KD3vlQQ: posts big blind $0.25
*** HOLE CARDS ***
r1pFKMwWp74QwhfPWJOAyw: calls $0.25
hBMUlEpyU74r/fwDgIpXjQ: folds 
lMysP2jE94oJvWGA6K5puw: folds 
opOCI2p6kW0tINuVaAqmcQ: folds 
CYkY0dNBaYaKs8HVCVn3mQ: folds 
tYsOBqdU1+x+yFI7zHO7hQ: folds 
nm4Dj/f+jJEwKVsUnKh73g: calls $0.15
MG90wfSJZnOejs/KD3vlQQ: checks 
*** FLOP *** [Qd 3s 4h]
nm4Dj/f+jJEwKVsUnKh73g: checks 
MG90wfSJZnOejs/KD3vlQQ: checks 
r1pFKMwWp74QwhfPWJOAyw: bets $0.25
nm4Dj/f+jJEwKVsUnKh73g: folds 
MG90wfSJZnOejs/KD3vlQQ: calls $0.25
*** TURN *** [Qd 3s 4h] [8s]
MG90wfSJZnOejs/KD3vlQQ: checks 
r1pFKMwWp74QwhfPWJOAyw: bets $0.50
MG90wfSJZnOejs/KD3vlQQ: folds 
Uncalled bet ($0.50) returned to r1pFKMwWp74QwhfPWJOAyw
r1pFKMwWp74QwhfPWJOAyw collected $1.20 from pot
*** SUMMARY ***
Total pot $1.25 | Rake $0.05 
Board [Qd 3s 4h 8s]
Seat 2: MG90wfSJZnOejs/KD3vlQQ (big blind) folded on the Turn
Seat 3: r1pFKMwWp74QwhfPWJOAyw collected ($1.20)
Seat 4: hBMUlEpyU74r/fwDgIpXjQ folded before Flop (didn't bet)
Seat 5: lMysP2jE94oJvWGA6K5puw folded before Flop (didn't bet)
Seat 6: opOCI2p6kW0tINuVaAqmcQ folded before Flop (didn't bet)
Seat 7: CYkY0dNBaYaKs8HVCVn3mQ folded before Flop (didn't bet)
Seat 8: tYsOBqdU1+x+yFI7zHO7hQ (button) folded before Flop (didn't bet)
Seat 9: nm4Dj/f+jJEwKVsUnKh73g (small blind) folded on the Flop




PokerStars Game #59939685418:  Hold'em No Limit ($0.10/$0.25) - 2009/07/01 0:46:16 ET
Table '2AUmC2Rslg+QUbLfdgNdfg' 6-max Seat #2 is the button
Seat 1: lquriepNQBhDV5P1SWHhnA ($25 in chips) 
Seat 2: CCxAG7iPVlAv3brCqrGBEg ($13.40 in chips) 
Seat 3: iauW7L/+7qzAuHow7CD75Q ($8.70 in chips) 
Seat 4: B6R6e73iyJNddUtXtvYr3Q ($47.95 in chips) 
Seat 5: 8ClCHtFXGNplITm+63KB+Q ($25 in chips) 
Seat 6: BvTq4Tu0zBOsniW3eFCnkQ ($33.30 in chips) 
iauW7L/+7qzAuHow7CD75Q: posts small blind $0.10
B6R6e73iyJNddUtXtvYr3Q: posts big blind $0.25
*** HOLE CARDS ***
8ClCHtFXGNplITm+63KB+Q: raises $0.75 to $1
BvTq4Tu0zBOsniW3eFCnkQ: folds 
lquriepNQBhDV5P1SWHhnA: folds 
CCxAG7iPVlAv3brCqrGBEg: folds 
iauW7L/+7qzAuHow7CD75Q: calls $0.90
B6R6e73iyJNddUtXtvYr3Q: folds 
*** FLOP *** [3d 5s 7s]
iauW7L/+7qzAuHow7CD75Q: checks 
8ClCHtFXGNplITm+63KB+Q: bets $2
iauW7L/+7qzAuHow7CD75Q: folds 
Uncalled bet ($2) returned to 8ClCHtFXGNplITm+63KB+Q
8ClCHtFXGNplITm+63KB+Q collected $2.15 from pot
8ClCHtFXGNplITm+63KB+Q: doesn't show hand 
*** SUMMARY ***
Total pot $2.25 | Rake $0.10 
Board [3d 5s 7s]
Seat 1: lquriepNQBhDV5P1SWHhnA folded before Flop (didn't bet)
Seat 2: CCxAG7iPVlAv3brCqrGBEg (button) folded before Flop (didn't bet)
Seat 3: iauW7L/+7qzAuHow7CD75Q (small blind) folded on the Flop
Seat 4: B6R6e73iyJNddUtXtvYr3Q (big blind) folded before Flop
Seat 5: 8ClCHtFXGNplITm+63KB+Q collected ($2.15)
Seat 6: BvTq4Tu0zBOsniW3eFCnkQ folded before Flop (didn't bet)




PokerStars Game #59939685394:  Hold'em No Limit ($0.10/$0.25) - 2009/07/01 0:46:16 ET
Table 'SHi8+hK6i7E2dJ/3Agbyig' 6-max Seat #4 is the button
Seat 1: gPEN9Zp33YTm/mu9/SYP1w ($27 in chips) 
Seat 2: Zijzy/UtPWzWVUo81HHVjQ ($40.80 in chips) 
Seat 3: 2p/OXJK5bWQbcvYltdbSfg ($29.55 in chips) 
Seat 4: +KSG/hZ6NXRHDk1WHcV2+Q ($13.15 in chips) 
Seat 5: T5wrp/d5jarm+SxNy8OQAg ($11.20 in chips) 
Seat 6: NVWCcUck2mqZMp/UrHDLKQ ($18.60 in chips) 
T5wrp/d5jarm+SxNy8OQAg: posts small blind $0.10
NVWCcUck2mqZMp/UrHDLKQ: posts big blind $0.25
*** HOLE CARDS ***
gPEN9Zp33YTm/mu9/SYP1w: folds 
Zijzy/UtPWzWVUo81HHVjQ: folds 
2p/OXJK5bWQbcvYltdbSfg: calls $0.25
+KSG/hZ6NXRHDk1WHcV2+Q: calls $0.25
T5wrp/d5jarm+SxNy8OQAg: folds 
NVWCcUck2mqZMp/UrHDLKQ: checks 
*** FLOP *** [9d 4d 2c]
T5wrp/d5jarm+SxNy8OQAg leaves the table
NVWCcUck2mqZMp/UrHDLKQ: checks 
2p/OXJK5bWQbcvYltdbSfg: bets $1
v8m8XHovI5tqEA9mvplDSw joins the table at seat #5 
+KSG/hZ6NXRHDk1WHcV2+Q: calls $1
NVWCcUck2mqZMp/UrHDLKQ: folds 
*** TURN *** [9d 4d 2c] [Kc]
2p/OXJK5bWQbcvYltdbSfg: bets $1
+KSG/hZ6NXRHDk1WHcV2+Q: folds 
Uncalled bet ($1) returned to 2p/OXJK5bWQbcvYltdbSfg
2p/OXJK5bWQbcvYltdbSfg collected $2.75 from pot
2p/OXJK5bWQbcvYltdbSfg: doesn't show hand 
*** SUMMARY ***
Total pot $2.85 | Rake $0.10 
Board [9d 4d 2c Kc]
Seat 1: gPEN9Zp33YTm/mu9/SYP1w folded before Flop (didn't bet)
Seat 2: Zijzy/UtPWzWVUo81HHVjQ folded before Flop (didn't bet)
Seat 3: 2p/OXJK5bWQbcvYltdbSfg collected ($2.75)
Seat 4: +KSG/hZ6NXRHDk1WHcV2+Q (button) folded on the Turn
Seat 5: T5wrp/d5jarm+SxNy8OQAg (small blind) folded before Flop
Seat 6: NVWCcUck2mqZMp/UrHDLKQ (big blind) folded on the Flop




PokerStars Game #59939685554:  Hold'em No Limit ($0.10/$0.25) - 2009/07/01 0:46:16 ET
Table '8kaMIn+aON/ferW89Go6Pw' 9-max Seat #7 is the button
Seat 2: jeKWRUkMaVn8rEUjnJKqpg ($26.90 in chips) 
Seat 3: 7cv+9Zc9HIQHNvYsMfV3uA ($28.55 in chips) 
Seat 4: KRWTiGM4xH+MkvPtJz4+SA ($45.55 in chips) 
Seat 5: hIss79a4pu7GzJZepfgOpg ($31 in chips) 
Seat 6: 1S/fpm+f42V/6MNZre+ccg ($25 in chips) 
Seat 7: HVKi9hnDyvzObpL08/OarQ ($24.60 in chips) 
jeKWRUkMaVn8rEUjnJKqpg: posts small blind $0.10
7cv+9Zc9HIQHNvYsMfV3uA: posts big blind $0.25
*** HOLE CARDS ***
KRWTiGM4xH+MkvPtJz4+SA: folds 
hIss79a4pu7GzJZepfgOpg: raises $0.75 to $1
1S/fpm+f42V/6MNZre+ccg: calls $1
HVKi9hnDyvzObpL08/OarQ: folds 
jeKWRUkMaVn8rEUjnJKqpg: folds 
Rjy74A2wdEiDWplMcUbA+w joins the table at seat #8 
7cv+9Zc9HIQHNvYsMfV3uA: folds 
*** FLOP *** [3s As Tc]
hIss79a4pu7GzJZepfgOpg: bets $1.25
1S/fpm+f42V/6MNZre+ccg: folds 
Uncalled bet ($1.25) returned to hIss79a4pu7GzJZepfgOpg
hIss79a4pu7GzJZepfgOpg collected $2.25 from pot
hIss79a4pu7GzJZepfgOpg: doesn't show hand 
*** SUMMARY ***
Total pot $2.35 | Rake $0.10 
Board [3s As Tc]
Seat 2: jeKWRUkMaVn8rEUjnJKqpg (small blind) folded before Flop
Seat 3: 7cv+9Zc9HIQHNvYsMfV3uA (big blind) folded before Flop
Seat 4: KRWTiGM4xH+MkvPtJz4+SA folded before Flop (didn't bet)
Seat 5: hIss79a4pu7GzJZepfgOpg collected ($2.25)
Seat 6: 1S/fpm+f42V/6MNZre+ccg folded on the Flop
Seat 7: HVKi9hnDyvzObpL08/OarQ (button) folded before Flop (didn't bet)




PokerStars Game #59939685302:  Hold'em No Limit ($0.10/$0.25) - 2009/07/01 0:46:16 ET
Table 'QzXakDK7ZHNjgIpoUFGSKQ' 9-max Seat #2 is the button
Seat 1: vZGoOTJLQLhkPj4I+LNGig ($25 in chips) 
Seat 2: HVKi9hnDyvzObpL08/OarQ ($23.40 in chips) 
Seat 4: Yv4fucyyT28mjx8V5lxKJg ($22.65 in chips) 
Seat 5: 7Tiam59GaMYACH/my1qVuw ($24.75 in chips) 
Seat 6: c7sk/W5UhCTyhjXh5MT/eg ($12.05 in chips) 
Seat 7: zUPSsmVPAK0z0iGmEx7WbA ($10.45 in chips) 
Seat 9: vnCdP3GsLTKadDukKcJk/Q ($25.25 in chips) 
Yv4fucyyT28mjx8V5lxKJg: posts small blind $0.10
7Tiam59GaMYACH/my1qVuw: posts big blind $0.25
*** HOLE CARDS ***
c7sk/W5UhCTyhjXh5MT/eg: folds 
zUPSsmVPAK0z0iGmEx7WbA: calls $0.25
vnCdP3GsLTKadDukKcJk/Q: folds 
vZGoOTJLQLhkPj4I+LNGig: folds 
HVKi9hnDyvzObpL08/OarQ: folds 
Yv4fucyyT28mjx8V5lxKJg: folds 
7Tiam59GaMYACH/my1qVuw: checks 
*** FLOP *** [Qs Ah 3s]
7Tiam59GaMYACH/my1qVuw: checks 
zUPSsmVPAK0z0iGmEx7WbA: bets $0.50
7Tiam59GaMYACH/my1qVuw: raises $0.50 to $1
zUPSsmVPAK0z0iGmEx7WbA: folds 
Uncalled bet ($0.50) returned to 7Tiam59GaMYACH/my1qVuw
7Tiam59GaMYACH/my1qVuw collected $1.55 from pot
*** SUMMARY ***
Total pot $1.60 | Rake $0.05 
Board [Qs Ah 3s]
Seat 1: vZGoOTJLQLhkPj4I+LNGig folded before Flop (didn't bet)
Seat 2: HVKi9hnDyvzObpL08/OarQ (button) folded before Flop (didn't bet)
Seat 4: Yv4fucyyT28mjx8V5lxKJg (small blind) folded before Flop
Seat 5: 7Tiam59GaMYACH/my1qVuw (big blind) collected ($1.55)
Seat 6: c7sk/W5UhCTyhjXh5MT/eg folded before Flop (didn't bet)
Seat 7: zUPSsmVPAK0z0iGmEx7WbA folded on the Flop
Seat 9: vnCdP3GsLTKadDukKcJk/Q folded before Flop (didn't bet)




PokerStars Game #59939685904:  Hold'em No Limit ($0.10/$0.25) - 2009/07/01 0:46:17 ET
Table 'AHkg4ChqzcMauBx6Qvz8Nw' 6-max Seat #4 is the button
Seat 2: /bjna2FTN7pPjqYGzmDE0Q ($23.90 in chips) 
Seat 3: wvIIdlbCgePONQwXjx9xzQ ($5.25 in chips) 
Seat 4: N7O9jUEx2YiQn1+yRYTHmw ($40.20 in chips) 
Seat 5: LtASJ9OlkqGrrUKGQlpGAw ($36.45 in chips) 
Seat 6: SFmT9ZsVopnukjvAzrxTRg ($53.85 in chips) 
LtASJ9OlkqGrrUKGQlpGAw: posts small blind $0.10
SFmT9ZsVopnukjvAzrxTRg: posts big blind $0.25
4kWQxGbT5FZ1dkPd1bE45Q: sits out 
*** HOLE CARDS ***
/bjna2FTN7pPjqYGzmDE0Q: folds 
wvIIdlbCgePONQwXjx9xzQ: raises $0.50 to $0.75
N7O9jUEx2YiQn1+yRYTHmw: folds 
LtASJ9OlkqGrrUKGQlpGAw: folds 
SFmT9ZsVopnukjvAzrxTRg: folds 
Uncalled bet ($0.50) returned to wvIIdlbCgePONQwXjx9xzQ
wvIIdlbCgePONQwXjx9xzQ collected $0.60 from pot
wvIIdlbCgePONQwXjx9xzQ: doesn't show hand 
*** SUMMARY ***
Total pot $0.60 | Rake $0 
Seat 2: /bjna2FTN7pPjqYGzmDE0Q folded before Flop (didn't bet)
Seat 3: wvIIdlbCgePONQwXjx9xzQ collected ($0.60)
Seat 4: N7O9jUEx2YiQn1+yRYTHmw (button) folded before Flop (didn't bet)
Seat 5: LtASJ9OlkqGrrUKGQlpGAw (small blind) folded before Flop
Seat 6: SFmT9ZsVopnukjvAzrxTRg (big blind) folded before Flop




PokerStars Game #59939686112:  Hold'em No Limit ($0.10/$0.25) - 2009/07/01 0:46:17 ET
Table 'Mef6A0EMopL6WaFO5/KO9g' 6-max Seat #2 is the button
Seat 1: ELW+DKizJhLK7k40PMkD2Q ($26.25 in chips) 
Seat 2: 8ClCHtFXGNplITm+63KB+Q ($31.60 in chips) 
Seat 3: Wq26opBLDGJe91GRJn2epg ($20.15 in chips) 
Seat 4: lquriepNQBhDV5P1SWHhnA ($25 in chips) 
Seat 5: WrLI51S2iMb8GLMB83gGqA ($35.90 in chips) 
Seat 6: jp34e617tIzV8tKIWmfAbA ($25.35 in chips) 
Wq26opBLDGJe91GRJn2epg: posts small blind $0.10
lquriepNQBhDV5P1SWHhnA: posts big blind $0.25
*** HOLE CARDS ***
WrLI51S2iMb8GLMB83gGqA: folds 
jp34e617tIzV8tKIWmfAbA: folds 
ELW+DKizJhLK7k40PMkD2Q: folds 
8ClCHtFXGNplITm+63KB+Q: folds 
Wq26opBLDGJe91GRJn2epg: calls $0.15
lquriepNQBhDV5P1SWHhnA: checks 
*** FLOP *** [8h Jh Ac]
Wq26opBLDGJe91GRJn2epg: checks 
lquriepNQBhDV5P1SWHhnA: checks 
*** TURN *** [8h Jh Ac] [7d]
Wq26opBLDGJe91GRJn2epg: bets $0.50
lquriepNQBhDV5P1SWHhnA: folds 
Uncalled bet ($0.50) returned to Wq26opBLDGJe91GRJn2epg
Wq26opBLDGJe91GRJn2epg collected $0.50 from pot
Wq26opBLDGJe91GRJn2epg: doesn't show hand 
*** SUMMARY ***
Total pot $0.50 | Rake $0 
Board [8h Jh Ac 7d]
Seat 1: ELW+DKizJhLK7k40PMkD2Q folded before Flop (didn't bet)
Seat 2: 8ClCHtFXGNplITm+63KB+Q (button) folded before Flop (didn't bet)
Seat 3: Wq26opBLDGJe91GRJn2epg (small blind) collected ($0.50)
Seat 4: lquriepNQBhDV5P1SWHhnA (big blind) folded on the Turn
Seat 5: WrLI51S2iMb8GLMB83gGqA folded before Flop (didn't bet)
Seat 6: jp34e617tIzV8tKIWmfAbA folded before Flop (didn't bet)




PokerStars Game #59939686328:  Hold'em No Limit ($0.10/$0.25) - 2009/07/01 0:46:17 ET
Table '7eunnLa5p3aGsPrUrNnn/A' 9-max Seat #3 is the button
Seat 2: aJy680tKSaP5er559aSuGA ($11.90 in chips) 
Seat 3: E0iYnEVO2ho7dH3QcCjw7g ($20.30 in chips) 
Seat 4: opOCI2p6kW0tINuVaAqmcQ ($28.95 in chips) 
Seat 5: JLfmdpDbz2ljMNE7ICboMQ ($7.35 in chips) 
Seat 6: jx9kXw1SAZrvXp9Nerz8+Q ($16.10 in chips) 
Seat 7: sD+TKtt36XiiN6jqHiLwDA ($24.40 in chips) 
Seat 8: 1Clf3cPrqoy/YgvWdWK1Xw ($5 in chips) 
Seat 9: rUpvA02nErFvZ4yFbDR8XA ($20.20 in chips) 
opOCI2p6kW0tINuVaAqmcQ: posts small blind $0.10
JLfmdpDbz2ljMNE7ICboMQ: posts big blind $0.25
22dIObOuor/A+IKWkNoAlA: sits out 
*** HOLE CARDS ***
jx9kXw1SAZrvXp9Nerz8+Q: folds 
sD+TKtt36XiiN6jqHiLwDA: folds 
1Clf3cPrqoy/YgvWdWK1Xw: folds 
rUpvA02nErFvZ4yFbDR8XA: folds 
aJy680tKSaP5er559aSuGA: folds 
E0iYnEVO2ho7dH3QcCjw7g: folds 
opOCI2p6kW0tINuVaAqmcQ: folds 
Uncalled bet ($0.15) returned to JLfmdpDbz2ljMNE7ICboMQ
JLfmdpDbz2ljMNE7ICboMQ collected $0.20 from pot
*** SUMMARY ***
Total pot $0.20 | Rake $0 
Seat 2: aJy680tKSaP5er559aSuGA folded before Flop (didn't bet)
Seat 3: E0iYnEVO2ho7dH3QcCjw7g (button) folded before Flop (didn't bet)
Seat 4: opOCI2p6kW0tINuVaAqmcQ (small blind) folded before Flop
Seat 5: JLfmdpDbz2ljMNE7ICboMQ (big blind) collected ($0.20)
Seat 6: jx9kXw1SAZrvXp9Nerz8+Q folded before Flop (didn't bet)
Seat 7: sD+TKtt36XiiN6jqHiLwDA folded before Flop (didn't bet)
Seat 8: 1Clf3cPrqoy/YgvWdWK1Xw folded before Flop (didn't bet)
Seat 9: rUpvA02nErFvZ4yFbDR8XA folded before Flop (didn't bet)




PokerStars Game #59939686324:  Hold'em No Limit ($0.10/$0.25) - 2009/07/01 0:46:17 ET
Table '+giHa6FUL6U5/AZnCJEGvQ' 9-max Seat #9 is the button
Seat 1: kYgmoJdHhyWAdwXflGZuKA ($34.05 in chips) 
Seat 2: YN6/TiJBEQVW8LDMQA1vFQ ($8.80 in chips) 
Seat 3: DIBbjEYGs+TVdVgEB/4+3w ($26.75 in chips) 
Seat 4: ljemhp25Zg+nlA9DLCIiUw ($49.85 in chips) 
Seat 5: zDrucyjVn5aeekNEc3cJrA ($47.15 in chips) 
Seat 6: cZ99hugmLBj9KhTlc8nCSw ($25.85 in chips) 
Seat 7: TeWJxSETzbXGiYKx0y+dtg ($25 in chips) 
Seat 8: t2nb95S5EEFOEzNx9Itz0g ($2.10 in chips) 
Seat 9: qwr38jl5txoR36M7G5qi4A ($7.50 in chips) 
kYgmoJdHhyWAdwXflGZuKA: posts small blind $0.10
YN6/TiJBEQVW8LDMQA1vFQ: posts big blind $0.25
*** HOLE CARDS ***
DIBbjEYGs+TVdVgEB/4+3w: folds 
ljemhp25Zg+nlA9DLCIiUw: folds 
zDrucyjVn5aeekNEc3cJrA: folds 
cZ99hugmLBj9KhTlc8nCSw: folds 
TeWJxSETzbXGiYKx0y+dtg: folds 
t2nb95S5EEFOEzNx9Itz0g: folds 
qwr38jl5txoR36M7G5qi4A: raises $0.50 to $0.75
kYgmoJdHhyWAdwXflGZuKA: folds 
YN6/TiJBEQVW8LDMQA1vFQ: folds 
Uncalled bet ($0.50) returned to qwr38jl5txoR36M7G5qi4A
qwr38jl5txoR36M7G5qi4A collected $0.60 from pot
qwr38jl5txoR36M7G5qi4A: doesn't show hand 
*** SUMMARY ***
Total pot $0.60 | Rake $0 
Seat 1: kYgmoJdHhyWAdwXflGZuKA (small blind) folded before Flop
Seat 2: YN6/TiJBEQVW8LDMQA1vFQ (big blind) folded before Flop
Seat 3: DIBbjEYGs+TVdVgEB/4+3w folded before Flop (didn't bet)
Seat 4: ljemhp25Zg+nlA9DLCIiUw folded before Flop (didn't bet)
Seat 5: zDrucyjVn5aeekNEc3cJrA folded before Flop (didn't bet)
Seat 6: cZ99hugmLBj9KhTlc8nCSw folded before Flop (didn't bet)
Seat 7: TeWJxSETzbXGiYKx0y+dtg folded before Flop (didn't bet)
Seat 8: t2nb95S5EEFOEzNx9Itz0g folded before Flop (didn't bet)
Seat 9: qwr38jl5txoR36M7G5qi4A (button) collected ($0.60)




PokerStars Game #59939686408:  Hold'em No Limit ($0.10/$0.25) - 2009/07/01 0:46:18 ET
Table '6ae4XiTo6B597KfSSMr8Cg' 9-max Seat #3 is the button
Seat 1: 49YfVBEOwzD3/FVw+dTTBQ ($11.10 in chips) 
Seat 2: 5s3p6yoJBNW438dsyKTP8g ($46.20 in chips) 
Seat 3: yyG4svzOpC1A+sUP/scg6w ($8.85 in chips) 
Seat 4: dfNim92Z6XK1/h5SFW5vDg ($48.50 in chips) 
Seat 6: DlXs37dlX3tb7o/7lYXQSw ($25 in chips) 
Seat 7: 18G4P1XstjNvItdGUITxgw ($25.35 in chips) 
Seat 8: F7pnn6czNpHvRM55XcA2EA ($25.60 in chips) 
Seat 9: E0iYnEVO2ho7dH3QcCjw7g ($34.70 in chips) 
dfNim92Z6XK1/h5SFW5vDg: posts small blind $0.10
DlXs37dlX3tb7o/7lYXQSw: posts big blind $0.25
*** HOLE CARDS ***
18G4P1XstjNvItdGUITxgw: folds 
F7pnn6czNpHvRM55XcA2EA: folds 
E0iYnEVO2ho7dH3QcCjw7g: raises $0.50 to $0.75
49YfVBEOwzD3/FVw+dTTBQ: folds 
5s3p6yoJBNW438dsyKTP8g: calls $0.75
yyG4svzOpC1A+sUP/scg6w: folds 
dfNim92Z6XK1/h5SFW5vDg: folds 
DlXs37dlX3tb7o/7lYXQSw: folds 
*** FLOP *** [6h 6d 9s]
E0iYnEVO2ho7dH3QcCjw7g: bets $1.50
5s3p6yoJBNW438dsyKTP8g: calls $1.50
*** TURN *** [6h 6d 9s] [Kd]
E0iYnEVO2ho7dH3QcCjw7g: bets $2.50
5s3p6yoJBNW438dsyKTP8g: folds 
Uncalled bet ($2.50) returned to E0iYnEVO2ho7dH3QcCjw7g
E0iYnEVO2ho7dH3QcCjw7g collected $4.65 from pot
*** SUMMARY ***
Total pot $4.85 | Rake $0.20 
Board [6h 6d 9s Kd]
Seat 1: 49YfVBEOwzD3/FVw+dTTBQ folded before Flop (didn't bet)
Seat 2: 5s3p6yoJBNW438dsyKTP8g folded on the Turn
Seat 3: yyG4svzOpC1A+sUP/scg6w (button) folded before Flop (didn't bet)
Seat 4: dfNim92Z6XK1/h5SFW5vDg (small blind) folded before Flop
Seat 6: DlXs37dlX3tb7o/7lYXQSw (big blind) folded before Flop
Seat 7: 18G4P1XstjNvItdGUITxgw folded before Flop (didn't bet)
Seat 8: F7pnn6czNpHvRM55XcA2EA folded before Flop (didn't bet)
Seat 9: E0iYnEVO2ho7dH3QcCjw7g collected ($4.65)




PokerStars Game #59939686704:  Hold'em No Limit ($0.10/$0.25) - 2009/07/01 0:46:18 ET
Table '0XPo7K54oZIfG0xlNAcDRw' 9-max Seat #4 is the button
Seat 1: opOCI2p6kW0tINuVaAqmcQ ($29.30 in chips) 
Seat 2: Jbrpc6KkvYcsiySJzLmFuA ($14.55 in chips) 
Seat 3: 6qsItdeWZoOL5be2e1RFng ($16.85 in chips) 
Seat 4: vOEICaqlJhPYytg64XnnkQ ($10.75 in chips) 
Seat 5: 8B/dhbQjIWe6ASCdgzktNQ ($40.35 in chips) 
Seat 6: 9gmYYQesalMrUjaF7nKfrQ ($9.70 in chips) 
Seat 7: tYsOBqdU1+x+yFI7zHO7hQ ($45.50 in chips) 
Seat 9: s7Q6uNouhe7aE8JdFb9E+A ($25 in chips) 
8B/dhbQjIWe6ASCdgzktNQ: posts small blind $0.10
9gmYYQesalMrUjaF7nKfrQ: posts big blind $0.25
OiV1PWZ3IkN29JlmCcnTwQ: sits out 
*** HOLE CARDS ***
tYsOBqdU1+x+yFI7zHO7hQ: folds 
s7Q6uNouhe7aE8JdFb9E+A: folds 
opOCI2p6kW0tINuVaAqmcQ: folds 
Jbrpc6KkvYcsiySJzLmFuA: calls $0.25
6qsItdeWZoOL5be2e1RFng: raises $0.25 to $0.50
vOEICaqlJhPYytg64XnnkQ: calls $0.50
8B/dhbQjIWe6ASCdgzktNQ: folds 
9gmYYQesalMrUjaF7nKfrQ: folds 
Jbrpc6KkvYcsiySJzLmFuA: calls $0.25
*** FLOP *** [5c 7c 4s]
Jbrpc6KkvYcsiySJzLmFuA: checks 
6qsItdeWZoOL5be2e1RFng: checks 
vOEICaqlJhPYytg64XnnkQ: checks 
*** TURN *** [5c 7c 4s] [Ac]
Jbrpc6KkvYcsiySJzLmFuA: checks 
6qsItdeWZoOL5be2e1RFng: checks 
vOEICaqlJhPYytg64XnnkQ: bets $1
Jbrpc6KkvYcsiySJzLmFuA: folds 
6qsItdeWZoOL5be2e1RFng: folds 
Uncalled bet ($1) returned to vOEICaqlJhPYytg64XnnkQ
vOEICaqlJhPYytg64XnnkQ collected $1.80 from pot
*** SUMMARY ***
Total pot $1.85 | Rake $0.05 
Board [5c 7c 4s Ac]
Seat 1: opOCI2p6kW0tINuVaAqmcQ folded before Flop (didn't bet)
Seat 2: Jbrpc6KkvYcsiySJzLmFuA folded on the Turn
Seat 3: 6qsItdeWZoOL5be2e1RFng folded on the Turn
Seat 4: vOEICaqlJhPYytg64XnnkQ (button) collected ($1.80)
Seat 5: 8B/dhbQjIWe6ASCdgzktNQ (small blind) folded before Flop
Seat 6: 9gmYYQesalMrUjaF7nKfrQ (big blind) folded before Flop
Seat 7: tYsOBqdU1+x+yFI7zHO7hQ folded before Flop (didn't bet)
Seat 9: s7Q6uNouhe7aE8JdFb9E+A folded before Flop (didn't bet)




PokerStars Game #59939687012:  Hold'em No Limit ($0.10/$0.25) - 2009/07/01 0:46:18 ET
Table 'luMgmRPIo47e7iXDlheIwA' 6-max Seat #3 is the button
Seat 1: z/jAqpWD9ifpbtEpwGyInw ($10.15 in chips) 
Seat 3: W6Y6au0wf7gRAlqJYgOezw ($12.45 in chips) 
Seat 4: n2OZezRXTtdzQt4SuIy8TQ ($22.60 in chips) 
Seat 5: zxeVQGaMKDsDzmSY+AInjA ($15 in chips) 
n2OZezRXTtdzQt4SuIy8TQ: posts small blind $0.10
zxeVQGaMKDsDzmSY+AInjA: posts big blind $0.25
Zb8xGmbjS8ghABxs9n6huA: sits out 
hZJzYj+7+PvGu6ae1g//sQ: sits out 
*** HOLE CARDS ***
z/jAqpWD9ifpbtEpwGyInw: folds 
W6Y6au0wf7gRAlqJYgOezw: raises $0.50 to $0.75
n2OZezRXTtdzQt4SuIy8TQ: folds 
zxeVQGaMKDsDzmSY+AInjA: folds 
Uncalled bet ($0.50) returned to W6Y6au0wf7gRAlqJYgOezw
W6Y6au0wf7gRAlqJYgOezw collected $0.60 from pot
*** SUMMARY ***
Total pot $0.60 | Rake $0 
Seat 1: z/jAqpWD9ifpbtEpwGyInw folded before Flop (didn't bet)
Seat 3: W6Y6au0wf7gRAlqJYgOezw (button) collected ($0.60)
Seat 4: n2OZezRXTtdzQt4SuIy8TQ (small blind) folded before Flop
Seat 5: zxeVQGaMKDsDzmSY+AInjA (big blind) folded before Flop




PokerStars Game #59939686604:  Hold'em No Limit ($0.10/$0.25) - 2009/07/01 0:46:18 ET
Table 'P1IJQ2p3ACFySC35W1qwQw' 9-max Seat #7 is the button
Seat 2: E0iYnEVO2ho7dH3QcCjw7g ($20 in chips) 
Seat 4: LuckyShot



PokerStars Game #59939686896:  Hold'em No Limit ($0.10/$0.25) - 2009/07/01 0:46:18 ET
Table 'srBTB98reCdD1TffxE6o7g' 6-max Seat #2 is the button
Seat 1: FEzezmgaiyVRh9sHKhd+9Q ($44.25 in chips) 
Seat 2: eSKnWz2RD4rvwnvB+rFzIg ($24.65 in chips) 
Seat 3: 4YSTu0Cdzpppe1lUgCZGCQ ($31.35 in chips) 
Seat 4: 6DwBRH+xZ12AAZmeAg+aXw ($28.95 in chips) 
Seat 5: n2OZezRXTtdzQt4SuIy8TQ ($36.50 in chips) 
Seat 6: gaPMxLGp9SOj4Lq6t+/0Ig ($11 in chips) 
4YSTu0Cdzpppe1lUgCZGCQ: posts small blind $0.10
6DwBRH+xZ12AAZmeAg+aXw: posts big blind $0.25
*** HOLE CARDS ***
n2OZezRXTtdzQt4SuIy8TQ: folds 
gaPMxLGp9SOj4Lq6t+/0Ig: folds 
FEzezmgaiyVRh9sHKhd+9Q: folds 
eSKnWz2RD4rvwnvB+rFzIg: folds 
4YSTu0Cdzpppe1lUgCZGCQ: calls $0.15
6DwBRH+xZ12AAZmeAg+aXw: raises $0.75 to $1
4YSTu0Cdzpppe1lUgCZGCQ: calls $0.75
*** FLOP *** [3s 3h 6d]
4YSTu0Cdzpppe1lUgCZGCQ: checks 
6DwBRH+xZ12AAZmeAg+aXw: bets $1
4YSTu0Cdzpppe1lUgCZGCQ: calls $1
*** TURN *** [3s 3h 6d] [2d]
4YSTu0Cdzpppe1lUgCZGCQ: checks 
6DwBRH+xZ12AAZmeAg+aXw: checks 
*** RIVER *** [3s 3h 6d 2d] [6h]
4YSTu0Cdzpppe1lUgCZGCQ: bets $1.75
6DwBRH+xZ12AAZmeAg+aXw: folds 
Uncalled bet ($1.75) returned to 4YSTu0Cdzpppe1lUgCZGCQ
4YSTu0Cdzpppe1lUgCZGCQ collected $3.85 from pot
4YSTu0Cdzpppe1lUgCZGCQ: doesn't show hand 
*** SUMMARY ***
Total pot $4 | Rake $0.15 
Board [3s 3h 6d 2d 6h]
Seat 1: FEzezmgaiyVRh9sHKhd+9Q folded before Flop (didn't bet)
Seat 2: eSKnWz2RD4rvwnvB+rFzIg (button) folded before Flop (didn't bet)
Seat 3: 4YSTu0Cdzpppe1lUgCZGCQ (small blind) collected ($3.85)
Seat 4: 6DwBRH+xZ12AAZmeAg+aXw (big blind) folded on the River
Seat 5: n2OZezRXTtdzQt4SuIy8TQ folded before Flop (didn't bet)
Seat 6: gaPMxLGp9SOj4Lq6t+/0Ig folded before Flop (didn't bet)




PokerStars Game #59939687114:  Hold'em No Limit ($0.10/$0.25) - 2009/07/01 0:46:19 ET
Table 'l57rayEpPtZotP9nqgSWBg' 6-max Seat #2 is the button
Seat 1: oseFhpinoe+Zg4j5xyBjyQ ($20.15 in chips) 
Seat 2: ErIN0JRL5srYjT6en1f8YQ ($24.20 in chips) 
Seat 3: sEQx9G5Cu8k1HNdQasxvUA ($40.25 in chips) 
Seat 4: NIALbunHAyYqmfMf7mrPhw ($6.60 in chips) 
Seat 5: TSmua8tGK3sTbwi0ynrW9Q ($59.05 in chips) 
Seat 6: IGRfskE1v9H9Bn+fz8AgNQ ($24.65 in chips) 
sEQx9G5Cu8k1HNdQasxvUA: posts small blind $0.10
NIALbunHAyYqmfMf7mrPhw: posts big blind $0.25
*** HOLE CARDS ***
TSmua8tGK3sTbwi0ynrW9Q: raises $0.50 to $0.75
IGRfskE1v9H9Bn+fz8AgNQ: calls $0.75
oseFhpinoe+Zg4j5xyBjyQ: folds 
ErIN0JRL5srYjT6en1f8YQ: folds 
sEQx9G5Cu8k1HNdQasxvUA: folds 
NIALbunHAyYqmfMf7mrPhw: folds 
*** FLOP *** [Kh 2d Ac]
TSmua8tGK3sTbwi0ynrW9Q: bets $1.25
IGRfskE1v9H9Bn+fz8AgNQ: folds 
Uncalled bet ($1.25) returned to TSmua8tGK3sTbwi0ynrW9Q
TSmua8tGK3sTbwi0ynrW9Q collected $1.80 from pot
*** SUMMARY ***
Total pot $1.85 | Rake $0.05 
Board [Kh 2d Ac]
Seat 1: oseFhpinoe+Zg4j5xyBjyQ folded before Flop (didn't bet)
Seat 2: ErIN0JRL5srYjT6en1f8YQ (button) folded before Flop (didn't bet)
Seat 3: sEQx9G5Cu8k1HNdQasxvUA (small blind) folded before Flop
Seat 4: NIALbunHAyYqmfMf7mrPhw (big blind) folded before Flop
Seat 5: TSmua8tGK3sTbwi0ynrW9Q collected ($1.80)
Seat 6: IGRfskE1v9H9Bn+fz8AgNQ folded on the Flop




PokerStars Game #59939687080:  Hold'em No Limit ($0.10/$0.25) - 2009/07/01 0:46:19 ET
Table 'zJTgUqdWn7ojWWqV4pItEQ' 9-max Seat #6 is the button
Seat 1: CbXUS6Z2rXZxL1AKduNtmQ ($30.10 in chips) 
Seat 2: 7wo6Sr7QG3Zo6BaBDV1BOw ($3 in chips) 
Seat 3: 2N94FgK4Y2izKFIB+wJOjw ($20.95 in chips) 
Seat 6: cQQdn+v2h6ICJU1fq6mEyA ($25.60 in chips) 
Seat 7: 4oA316mXLIui1QY63GXBUg ($25 in chips) 
Seat 8: iG7VeTyBWf6wYNvZpbTcbw ($14.75 in chips) 
Seat 9: DnDcAdn9P0zGovMERigpFA ($25.25 in chips) 
4oA316mXLIui1QY63GXBUg: posts small blind $0.10
iG7VeTyBWf6wYNvZpbTcbw: posts big blind $0.25
murdog71: sits out 
*** HOLE CARDS ***
DnDcAdn9P0zGovMERigpFA: folds 
CbXUS6Z2rXZxL1AKduNtmQ: folds 
7wo6Sr7QG3Zo6BaBDV1BOw: folds 
2N94FgK4Y2izKFIB+wJOjw: folds 
2N94FgK4Y2izKFIB+wJOjw leaves the table
cQQdn+v2h6ICJU1fq6mEyA: calls $0.25
4oA316mXLIui1QY63GXBUg: folds 
iG7VeTyBWf6wYNvZpbTcbw: checks 
*** FLOP *** [6d Qh Ah]
iG7VeTyBWf6wYNvZpbTcbw: checks 
cQQdn+v2h6ICJU1fq6mEyA: checks 
*** TURN *** [6d Qh Ah] [5c]
iG7VeTyBWf6wYNvZpbTcbw: checks 
cQQdn+v2h6ICJU1fq6mEyA: bets $0.75
iG7VeTyBWf6wYNvZpbTcbw: folds 
Uncalled bet ($0.75) returned to cQQdn+v2h6ICJU1fq6mEyA
cQQdn+v2h6ICJU1fq6mEyA collected $0.60 from pot
cQQdn+v2h6ICJU1fq6mEyA: doesn't show hand 
*** SUMMARY ***
Total pot $0.60 | Rake $0 
Board [6d Qh Ah 5c]
Seat 1: CbXUS6Z2rXZxL1AKduNtmQ folded before Flop (didn't bet)
Seat 2: 7wo6Sr7QG3Zo6BaBDV1BOw folded before Flop (didn't bet)
Seat 3: 2N94FgK4Y2izKFIB+wJOjw folded before Flop (didn't bet)
Seat 6: cQQdn+v2h6ICJU1fq6mEyA (button) collected ($0.60)
Seat 7: 4oA316mXLIui1QY63GXBUg (small blind) folded before Flop
Seat 8: iG7VeTyBWf6wYNvZpbTcbw (big blind) folded on the Turn
Seat 9: DnDcAdn9P0zGovMERigpFA folded before Flop (didn't bet)




PokerStars Game #59939687122:  Hold'em No Limit ($0.10/$0.25) - 2009/07/01 0:46:19 ET
Table '4mnXP0EWt9mMZYzTIVDQ0w' 9-max Seat #6 is the button
Seat 1: PTFwg4rGxnfVvj2iP1OI2w ($11.50 in chips) 
Seat 2: j4q3p0lesp63b1gZDwLBZw ($6.85 in chips) 
Seat 4: E0iYnEVO2ho7dH3QcCjw7g ($24.65 in chips) 
Seat 5: sSN8Y0AlsBeidZXPKmwXSw ($12.90 in chips) 
Seat 6: n9toqYXSLowQ/sWq842dEQ ($8.90 in chips) 
Seat 7: s1y+qfkBnhgc67+X3ThjeA ($26.45 in chips) 
Seat 8: H9KUl8cmpLgEpOVDA00bCg ($4.30 in chips) 
Seat 9: wbCayoP+N6xpKgOfIqZsbA ($21.85 in chips) 
s1y+qfkBnhgc67+X3ThjeA: posts small blind $0.10
H9KUl8cmpLgEpOVDA00bCg: posts big blind $0.25
*** HOLE CARDS ***
wbCayoP+N6xpKgOfIqZsbA: raises $0.75 to $1
PTFwg4rGxnfVvj2iP1OI2w: folds 
j4q3p0lesp63b1gZDwLBZw: folds 
E0iYnEVO2ho7dH3QcCjw7g: folds 
sSN8Y0AlsBeidZXPKmwXSw: calls $1
n9toqYXSLowQ/sWq842dEQ: folds 
s1y+qfkBnhgc67+X3ThjeA: folds 
ompa52 has returned
H9KUl8cmpLgEpOVDA00bCg: folds 
*** FLOP *** [7d 3c 7s]
wbCayoP+N6xpKgOfIqZsbA: bets $3
sSN8Y0AlsBeidZXPKmwXSw: calls $3
*** TURN *** [7d 3c 7s] [Td]
wbCayoP+N6xpKgOfIqZsbA: bets $10
sSN8Y0AlsBeidZXPKmwXSw: calls $8.90 and is all-in
Uncalled bet ($1.10) returned to wbCayoP+N6xpKgOfIqZsbA
*** RIVER *** [7d 3c 7s Td] [4c]
*** SHOW DOWN ***
wbCayoP+N6xpKgOfIqZsbA: shows [Qh Qc] (two pair, Queens and Sevens)
sSN8Y0AlsBeidZXPKmwXSw: shows [Ad As] (two pair, Aces and Sevens)
sSN8Y0AlsBeidZXPKmwXSw collected $24.90 from pot
*** SUMMARY ***
Total pot $26.15 | Rake $1.25 
Board [7d 3c 7s Td 4c]
Seat 1: PTFwg4rGxnfVvj2iP1OI2w folded before Flop (didn't bet)
Seat 2: j4q3p0lesp63b1gZDwLBZw folded before Flop (didn't bet)
Seat 4: E0iYnEVO2ho7dH3QcCjw7g folded before Flop (didn't bet)
Seat 5: sSN8Y0AlsBeidZXPKmwXSw showed [Ad As] and won ($24.90) with two pair, Aces and Sevens
Seat 6: n9toqYXSLowQ/sWq842dEQ (button) folded before Flop (didn't bet)
Seat 7: s1y+qfkBnhgc67+X3ThjeA (small blind) folded before Flop
Seat 8: H9KUl8cmpLgEpOVDA00bCg (big blind) folded before Flop
Seat 9: wbCayoP+N6xpKgOfIqZsbA showed [Qh Qc] and lost with two pair, Queens and Sevens




PokerStars Game #59939687112:  Hold'em No Limit ($0.10/$0.25) - 2009/07/01 0:46:19 ET
Table 'VuY5ej47Cy8nOI3Wogmhzw' 6-max Seat #1 is the button
Seat 1: aXzmR7FhrqQSWNNmNfbVnw ($18.10 in chips) 
Seat 2: j0aDOn9Nft1HLTQvGu1UwA ($0.55 in chips) 
Seat 3: s1D1gIXwINNo65XoAlN55g ($13.75 in chips) 
Seat 6: +v0nBUereMsRzYp2Knh/cQ ($21.90 in chips) 
j0aDOn9Nft1HLTQvGu1UwA: posts small blind $0.10
s1D1gIXwINNo65XoAlN55g: posts big blind $0.25
Zb8xGmbjS8ghABxs9n6huA joins the table at seat #4 
eSKnWz2RD4rvwnvB+rFzIg: sits out 
*** HOLE CARDS ***
+v0nBUereMsRzYp2Knh/cQ: calls $0.25
aXzmR7FhrqQSWNNmNfbVnw: calls $0.25
j0aDOn9Nft1HLTQvGu1UwA: raises $0.30 to $0.55 and is all-in
s1D1gIXwINNo65XoAlN55g: raises $0.30 to $0.85
+v0nBUereMsRzYp2Knh/cQ: calls $0.60
aXzmR7FhrqQSWNNmNfbVnw: calls $0.60
*** FLOP *** [Td 9d Tc]
s1D1gIXwINNo65XoAlN55g: checks 
+v0nBUereMsRzYp2Knh/cQ: checks 
aXzmR7FhrqQSWNNmNfbVnw: bets $1
s1D1gIXwINNo65XoAlN55g: calls $1
+v0nBUereMsRzYp2Knh/cQ: folds 
*** TURN *** [Td 9d Tc] [Jc]
s1D1gIXwINNo65XoAlN55g: bets $1.25
aXzmR7FhrqQSWNNmNfbVnw: calls $1.25
*** RIVER *** [Td 9d Tc Jc] [Kh]
s1D1gIXwINNo65XoAlN55g: bets $2.50
aXzmR7FhrqQSWNNmNfbVnw: raises $12.50 to $15 and is all-in
s1D1gIXwINNo65XoAlN55g: calls $8.15 and is all-in
Uncalled bet ($4.35) returned to aXzmR7FhrqQSWNNmNfbVnw
*** SHOW DOWN ***
aXzmR7FhrqQSWNNmNfbVnw: shows [Qd Qs] (a straight, Nine to King)
s1D1gIXwINNo65XoAlN55g: shows [Qh Jh] (a straight, Nine to King)
s1D1gIXwINNo65XoAlN55g collected $12.70 from side pot
aXzmR7FhrqQSWNNmNfbVnw collected $12.70 from side pot
j0aDOn9Nft1HLTQvGu1UwA: mucks hand 
s1D1gIXwINNo65XoAlN55g collected $1.05 from main pot
aXzmR7FhrqQSWNNmNfbVnw collected $1.05 from main pot
*** SUMMARY ***
Total pot $28.90 Main pot $2.10. Side pot $25.40. | Rake $1.40 
Board [Td 9d Tc Jc Kh]
Seat 1: aXzmR7FhrqQSWNNmNfbVnw (button) showed [Qd Qs] and won ($13.75) with a straight, Nine to King
Seat 2: j0aDOn9Nft1HLTQvGu1UwA (small blind) mucked
Seat 3: s1D1gIXwINNo65XoAlN55g (big blind) showed [Qh Jh] and won ($13.75) with a straight, Nine to King
Seat 6: +v0nBUereMsRzYp2Knh/cQ folded on the Flop




PokerStars Game #59939687526:  Hold'em No Limit ($0.10/$0.25) - 2009/07/01 0:46:19 ET
Table 'UVjmXTtsmlX1HxwwZ59akg' 9-max Seat #4 is the button
Seat 1: zDrucyjVn5aeekNEc3cJrA ($28.60 in chips) 
Seat 4: lesMFbAzECwhRvI2qQ9kkg ($4.95 in chips) 
lesMFbAzECwhRvI2qQ9kkg: posts small blind $0.10
zDrucyjVn5aeekNEc3cJrA: posts big blind $0.25
*** HOLE CARDS ***
lesMFbAzECwhRvI2qQ9kkg: calls $0.15
zDrucyjVn5aeekNEc3cJrA: checks 
*** FLOP *** [Th Qd 4d]
zDrucyjVn5aeekNEc3cJrA: checks 
lesMFbAzECwhRvI2qQ9kkg: bets $0.25
zDrucyjVn5aeekNEc3cJrA: folds 
Uncalled bet ($0.25) returned to lesMFbAzECwhRvI2qQ9kkg
lesMFbAzECwhRvI2qQ9kkg collected $0.50 from pot
lesMFbAzECwhRvI2qQ9kkg: doesn't show hand 
*** SUMMARY ***
Total pot $0.50 | Rake $0 
Board [Th Qd 4d]
Seat 1: zDrucyjVn5aeekNEc3cJrA (big blind) folded on the Flop
Seat 4: lesMFbAzECwhRvI2qQ9kkg (button) (small blind) collected ($0.50)




PokerStars Game #59939687246:  Hold'em No Limit ($0.10/$0.25) - 2009/07/01 0:46:19 ET
Table 'dVzscin98UhGisTmV9BDcw' 9-max Seat #4 is the button
Seat 1: sBAwXpkpgyhyWbHIQcIJKA ($19.05 in chips) 
Seat 2: dfNim92Z6XK1/h5SFW5vDg ($28.80 in chips) 
Seat 3: 1Clf3cPrqoy/YgvWdWK1Xw ($5 in chips) 
Seat 4: aNpwfA31EREwO+ar4XzBCw ($25 in chips) 
Seat 5: 22dIObOuor/A+IKWkNoAlA ($5.10 in chips) 
Seat 6: hBMUlEpyU74r/fwDgIpXjQ ($28.35 in chips) 
Seat 7: nEg1b6MIksd/4x5eLY735g ($64.65 in chips) 
Seat 8: /vn2Qu2dvc9AMMq46Ae0jA ($6.20 in chips) 
Seat 9: OYa/ZJBO+suuezfWsUMhZw ($4.45 in chips) 
22dIObOuor/A+IKWkNoAlA: posts small blind $0.10
hBMUlEpyU74r/fwDgIpXjQ: posts big blind $0.25
*** HOLE CARDS ***
nEg1b6MIksd/4x5eLY735g: folds 
/vn2Qu2dvc9AMMq46Ae0jA: calls $0.25
OYa/ZJBO+suuezfWsUMhZw: folds 
sBAwXpkpgyhyWbHIQcIJKA: folds 
dfNim92Z6XK1/h5SFW5vDg: folds 
1Clf3cPrqoy/YgvWdWK1Xw: folds 
aNpwfA31EREwO+ar4XzBCw: folds 
22dIObOuor/A+IKWkNoAlA: folds 
hBMUlEpyU74r/fwDgIpXjQ: checks 
*** FLOP *** [Qh 8s Td]
hBMUlEpyU74r/fwDgIpXjQ: checks 
/vn2Qu2dvc9AMMq46Ae0jA: bets $0.50
hBMUlEpyU74r/fwDgIpXjQ: folds 
Uncalled bet ($0.50) returned to /vn2Qu2dvc9AMMq46Ae0jA
/vn2Qu2dvc9AMMq46Ae0jA collected $0.60 from pot
*** SUMMARY ***
Total pot $0.60 | Rake $0 
Board [Qh 8s Td]
Seat 1: sBAwXpkpgyhyWbHIQcIJKA folded before Flop (didn't bet)
Seat 2: dfNim92Z6XK1/h5SFW5vDg folded before Flop (didn't bet)
Seat 3: 1Clf3cPrqoy/YgvWdWK1Xw folded before Flop (didn't bet)
Seat 4: aNpwfA31EREwO+ar4XzBCw (button) folded before Flop (didn't bet)
Seat 5: 22dIObOuor/A+IKWkNoAlA (small blind) folded before Flop
Seat 6: hBMUlEpyU74r/fwDgIpXjQ (big blind) folded on the Flop
Seat 7: nEg1b6MIksd/4x5eLY735g folded before Flop (didn't bet)
Seat 8: /vn2Qu2dvc9AMMq46Ae0jA collected ($0.60)
Seat 9: OYa/ZJBO+suuezfWsUMhZw folded before Flop (didn't bet)




PokerStars Game #59939687866:  Hold'em No Limit ($0.10/$0.25) - 2009/07/01 0:46:20 ET
Table 'wixGE3Zge1qBdnpWijIl/w' 9-max Seat #2 is the button
Seat 1: 86vbuhJsyH+nbEg5qpDLyQ ($25.40 in chips) 
Seat 2: DnDcAdn9P0zGovMERigpFA ($25 in chips) 
Seat 3: DdPXdieucQ+n99u1n3A+rQ ($8.95 in chips) 
Seat 4: 4oA316mXLIui1QY63GXBUg ($25 in chips) 
Seat 5: MIVCHqCqqlke0Lb0z7glcw ($32 in chips) 
Seat 6: TlEYI/zXzaKGGsmuvWFd2A ($8.20 in chips) 
Seat 7: qIaaweMCAGmy9HZFT4r/6A ($58.95 in chips) 
Seat 8: hIss79a4pu7GzJZepfgOpg ($25 in chips) 
Seat 9: r6hsffOo1iKmaPYKwAZmFw ($25.85 in chips) 
DdPXdieucQ+n99u1n3A+rQ: posts small blind $0.10
4oA316mXLIui1QY63GXBUg: posts big blind $0.25
*** HOLE CARDS ***
MIVCHqCqqlke0Lb0z7glcw: calls $0.25
TlEYI/zXzaKGGsmuvWFd2A: calls $0.25
qIaaweMCAGmy9HZFT4r/6A: calls $0.25
hIss79a4pu7GzJZepfgOpg: folds 
r6hsffOo1iKmaPYKwAZmFw: folds 
86vbuhJsyH+nbEg5qpDLyQ: folds 
DnDcAdn9P0zGovMERigpFA: folds 
DdPXdieucQ+n99u1n3A+rQ: folds 
4oA316mXLIui1QY63GXBUg: checks 
*** FLOP *** [4d 3d 6h]
4oA316mXLIui1QY63GXBUg: checks 
MIVCHqCqqlke0Lb0z7glcw: checks 
TlEYI/zXzaKGGsmuvWFd2A: checks 
qIaaweMCAGmy9HZFT4r/6A: checks 
*** TURN *** [4d 3d 6h] [Js]
4oA316mXLIui1QY63GXBUg: checks 
MIVCHqCqqlke0Lb0z7glcw: checks 
TlEYI/zXzaKGGsmuvWFd2A: checks 
qIaaweMCAGmy9HZFT4r/6A: checks 
*** RIVER *** [4d 3d 6h Js] [Jd]
4oA316mXLIui1QY63GXBUg: checks 
MIVCHqCqqlke0Lb0z7glcw: bets $0.50
TlEYI/zXzaKGGsmuvWFd2A: raises $7.45 to $7.95 and is all-in
qIaaweMCAGmy9HZFT4r/6A: folds 
4oA316mXLIui1QY63GXBUg: folds 
MIVCHqCqqlke0Lb0z7glcw: folds 
Uncalled bet ($7.45) returned to TlEYI/zXzaKGGsmuvWFd2A
TlEYI/zXzaKGGsmuvWFd2A collected $2 from pot
TlEYI/zXzaKGGsmuvWFd2A: doesn't show hand 
*** SUMMARY ***
Total pot $2.10 | Rake $0.10 
Board [4d 3d 6h Js Jd]
Seat 1: 86vbuhJsyH+nbEg5qpDLyQ folded before Flop (didn't bet)
Seat 2: DnDcAdn9P0zGovMERigpFA (button) folded before Flop (didn't bet)
Seat 3: DdPXdieucQ+n99u1n3A+rQ (small blind) folded before Flop
Seat 4: 4oA316mXLIui1QY63GXBUg (big blind) folded on the River
Seat 5: MIVCHqCqqlke0Lb0z7glcw folded on the River
Seat 6: TlEYI/zXzaKGGsmuvWFd2A collected ($2)
Seat 7: qIaaweMCAGmy9HZFT4r/6A folded on the River
Seat 8: hIss79a4pu7GzJZepfgOpg folded before Flop (didn't bet)
Seat 9: r6hsffOo1iKmaPYKwAZmFw folded before Flop (didn't bet)




PokerStars Game #59939687672:  Hold'em No Limit ($0.10/$0.25) - 2009/07/01 0:46:20 ET
Table 'WjNvuuSgTjm8jh0j9vcCgQ' 9-max Seat #2 is the button
Seat 1: NKymidkL3Kg3ILZPvtLSVg ($10.20 in chips) 
Seat 2: 9gmYYQesalMrUjaF7nKfrQ ($9.05 in chips) 
Seat 3: 8B/dhbQjIWe6ASCdgzktNQ ($25.10 in chips) 
Seat 4: Xbfvrzh7Jjg4vOZkdMSfbA ($13.50 in chips) 
Seat 5: Qi+clOtyDiibLdH2/1Qy8g ($19.15 in chips) 
Seat 6: S0s//NMht9qTAscBNd6CUA ($9.75 in chips) 
Seat 7: DdPXdieucQ+n99u1n3A+rQ ($5 in chips) 
Seat 8: ghNKXUBl/H+t83JF079ZBA ($29.25 in chips) 
Seat 9: zakeg0SqJYXCZcG4HxYSQQ ($9.75 in chips) 
8B/dhbQjIWe6ASCdgzktNQ: posts small blind $0.10
Xbfvrzh7Jjg4vOZkdMSfbA: posts big blind $0.25
*** HOLE CARDS ***
Qi+clOtyDiibLdH2/1Qy8g: folds 
S0s//NMht9qTAscBNd6CUA: folds 
DdPXdieucQ+n99u1n3A+rQ: folds 
ghNKXUBl/H+t83JF079ZBA: folds 
zakeg0SqJYXCZcG4HxYSQQ: calls $0.25
NKymidkL3Kg3ILZPvtLSVg: folds 
9gmYYQesalMrUjaF7nKfrQ: folds 
8B/dhbQjIWe6ASCdgzktNQ: folds 
Xbfvrzh7Jjg4vOZkdMSfbA: checks 
*** FLOP *** [3d Tc Qh]
Xbfvrzh7Jjg4vOZkdMSfbA: checks 
zakeg0SqJYXCZcG4HxYSQQ: bets $0.50
Xbfvrzh7Jjg4vOZkdMSfbA: calls $0.50
*** TURN *** [3d Tc Qh] [9h]
Xbfvrzh7Jjg4vOZkdMSfbA: bets $0.75
zakeg0SqJYXCZcG4HxYSQQ: calls $0.75
*** RIVER *** [3d Tc Qh 9h] [Ad]
Xbfvrzh7Jjg4vOZkdMSfbA: bets $2
zakeg0SqJYXCZcG4HxYSQQ: calls $2
*** SHOW DOWN ***
Xbfvrzh7Jjg4vOZkdMSfbA: shows [8c 7h] (high card Ace)
zakeg0SqJYXCZcG4HxYSQQ: shows [9d Td] (two pair, Tens and Nines)
zakeg0SqJYXCZcG4HxYSQQ collected $6.80 from pot
*** SUMMARY ***
Total pot $7.10 | Rake $0.30 
Board [3d Tc Qh 9h Ad]
Seat 1: NKymidkL3Kg3ILZPvtLSVg folded before Flop (didn't bet)
Seat 2: 9gmYYQesalMrUjaF7nKfrQ (button) folded before Flop (didn't bet)
Seat 3: 8B/dhbQjIWe6ASCdgzktNQ (small blind) folded before Flop
Seat 4: Xbfvrzh7Jjg4vOZkdMSfbA (big blind) showed [8c 7h] and lost with high card Ace
Seat 5: Qi+clOtyDiibLdH2/1Qy8g folded before Flop (didn't bet)
Seat 6: S0s//NMht9qTAscBNd6CUA folded before Flop (didn't bet)
Seat 7: DdPXdieucQ+n99u1n3A+rQ folded before Flop (didn't bet)
Seat 8: ghNKXUBl/H+t83JF079ZBA folded before Flop (didn't bet)
Seat 9: zakeg0SqJYXCZcG4HxYSQQ showed [9d Td] and won ($6.80) with two pair, Tens and Nines




PokerStars Game #59939688076:  Hold'em No Limit ($0.10/$0.25) - 2009/07/01 0:46:20 ET
Table 'ktio12Pyq06LsrFhIorSqA' 9-max Seat #8 is the button
Seat 1: OneeONzF0MoH0pEdcBndwA ($25 in chips) 
Seat 2: sX4bSd399rlGD2VqB7dh2Q ($12.15 in chips) 
Seat 3: 21oaELqROjaQrGRMDGa8pQ ($14 in chips) 
Seat 4: E0iYnEVO2ho7dH3QcCjw7g ($20 in chips) 
Seat 6: jQL6XIewylQ8MmZhhq2YFg ($39.85 in chips) 
Seat 7: XGCfQsxa6PfAg3kJtzUmww ($23.80 in chips) 
Seat 8: Z5y2J55JmfLYR6/DPAGHwQ ($17.05 in chips) 
Seat 9: 2Gn4w2tIKlLbK/3nwIeRYA ($10.50 in chips) 
2Gn4w2tIKlLbK/3nwIeRYA: posts small blind $0.10
OneeONzF0MoH0pEdcBndwA: posts big blind $0.25
*** HOLE CARDS ***
sX4bSd399rlGD2VqB7dh2Q: calls $0.25
21oaELqROjaQrGRMDGa8pQ: calls $0.25
E0iYnEVO2ho7dH3QcCjw7g: calls $0.25
jQL6XIewylQ8MmZhhq2YFg has timed out
jQL6XIewylQ8MmZhhq2YFg: folds 
jQL6XIewylQ8MmZhhq2YFg is sitting out
XGCfQsxa6PfAg3kJtzUmww: calls $0.25
jQL6XIewylQ8MmZhhq2YFg has returned
Z5y2J55JmfLYR6/DPAGHwQ: calls $0.25
2Gn4w2tIKlLbK/3nwIeRYA: calls $0.15
OneeONzF0MoH0pEdcBndwA: raises $2.25 to $2.50
sX4bSd399rlGD2VqB7dh2Q: folds 
21oaELqROjaQrGRMDGa8pQ: folds 
E0iYnEVO2ho7dH3QcCjw7g: calls $2.25
XGCfQsxa6PfAg3kJtzUmww: folds 
Z5y2J55JmfLYR6/DPAGHwQ: calls $2.25
2Gn4w2tIKlLbK/3nwIeRYA: calls $2.25
*** FLOP *** [8h Kh 3c]
2Gn4w2tIKlLbK/3nwIeRYA: bets $0.25
OneeONzF0MoH0pEdcBndwA: raises $6.50 to $6.75
E0iYnEVO2ho7dH3QcCjw7g: folds 
Z5y2J55JmfLYR6/DPAGHwQ: folds 
2Gn4w2tIKlLbK/3nwIeRYA: folds 
Uncalled bet ($6.50) returned to OneeONzF0MoH0pEdcBndwA
OneeONzF0MoH0pEdcBndwA collected $10.75 from pot
*** SUMMARY ***
Total pot $11.25 | Rake $0.50 
Board [8h Kh 3c]
Seat 1: OneeONzF0MoH0pEdcBndwA (big blind) collected ($10.75)
Seat 2: sX4bSd399rlGD2VqB7dh2Q folded before Flop
Seat 3: 21oaELqROjaQrGRMDGa8pQ folded before Flop
Seat 4: E0iYnEVO2ho7dH3QcCjw7g folded on the Flop
Seat 6: jQL6XIewylQ8MmZhhq2YFg folded before Flop (didn't bet)
Seat 7: XGCfQsxa6PfAg3kJtzUmww folded before Flop
Seat 8: Z5y2J55JmfLYR6/DPAGHwQ (button) folded on the Flop
Seat 9: 2Gn4w2tIKlLbK/3nwIeRYA (small blind) folded on the Flop




PokerStars Game #59939687692:  Hold'em No Limit ($0.10/$0.25) - 2009/07/01 0:46:20 ET
Table 'nXVbUw6/HYwA6x21+IZ3XQ' 9-max Seat #5 is the button
Seat 1: zDrucyjVn5aeekNEc3cJrA ($23.05 in chips) 
Seat 4: GmQux9F6mgOHtI4C9bVTNQ ($5 in chips) 
Seat 5: M/9j4wkHH9i1JM51vgi1VA ($20.80 in chips) 
Seat 6: ljemhp25Zg+nlA9DLCIiUw ($23.35 in chips) 
Seat 7: IupaN0QS3TJoOSYaS7zF9w ($7.45 in chips) 
Seat 8: dfNim92Z6XK1/h5SFW5vDg ($25 in chips) 
Seat 9: rm0e8CshiGK8hjW46YcNqg ($34.50 in chips) 
GmQux9F6mgOHtI4C9bVTNQ said, "buttsex"
ljemhp25Zg+nlA9DLCIiUw: posts small blind $0.10
IupaN0QS3TJoOSYaS7zF9w: posts big blind $0.25
*** HOLE CARDS ***
dfNim92Z6XK1/h5SFW5vDg: calls $0.25
rm0e8CshiGK8hjW46YcNqg: calls $0.25
zDrucyjVn5aeekNEc3cJrA: folds 
GmQux9F6mgOHtI4C9bVTNQ: folds 
M/9j4wkHH9i1JM51vgi1VA: folds 
rm0e8CshiGK8hjW46YcNqg said, "ascot"
ljemhp25Zg+nlA9DLCIiUw: calls $0.15
IupaN0QS3TJoOSYaS7zF9w: checks 
*** FLOP *** [4h Jc Kd]
ljemhp25Zg+nlA9DLCIiUw: checks 
IupaN0QS3TJoOSYaS7zF9w: bets $0.50
GmQux9F6mgOHtI4C9bVTNQ said, "asshat"
dfNim92Z6XK1/h5SFW5vDg: folds 
GmQux9F6mgOHtI4C9bVTNQ said, "assclown"
rm0e8CshiGK8hjW46YcNqg: calls $0.50
ljemhp25Zg+nlA9DLCIiUw: folds 
*** TURN *** [4h Jc Kd] [7d]
IupaN0QS3TJoOSYaS7zF9w: bets $0.50
rm0e8CshiGK8hjW46YcNqg: calls $0.50
*** RIVER *** [4h Jc Kd 7d] [8s]
IupaN0QS3TJoOSYaS7zF9w said, "gg nhams chat"
IupaN0QS3TJoOSYaS7zF9w: bets $0.75
rm0e8CshiGK8hjW46YcNqg: calls $0.75
*** SHOW DOWN ***
IupaN0QS3TJoOSYaS7zF9w: shows [Js Ad] (a pair of Jacks)
rm0e8CshiGK8hjW46YcNqg: shows [3d 5d] (high card King)
IupaN0QS3TJoOSYaS7zF9w collected $4.30 from pot
IupaN0QS3TJoOSYaS7zF9w said, "ty mayo"
*** SUMMARY ***
Total pot $4.50 | Rake $0.20 
Board [4h Jc Kd 7d 8s]
Seat 1: zDrucyjVn5aeekNEc3cJrA folded before Flop (didn't bet)
Seat 4: GmQux9F6mgOHtI4C9bVTNQ folded before Flop (didn't bet)
Seat 5: M/9j4wkHH9i1JM51vgi1VA (button) folded before Flop (didn't bet)
Seat 6: ljemhp25Zg+nlA9DLCIiUw (small blind) folded on the Flop
Seat 7: IupaN0QS3TJoOSYaS7zF9w (big blind) showed [Js Ad] and won ($4.30) with a pair of Jacks
Seat 8: dfNim92Z6XK1/h5SFW5vDg folded on the Flop
Seat 9: rm0e8CshiGK8hjW46YcNqg showed [3d 5d] and lost with high card King




PokerStars Game #59939687878:  Hold'em No Limit ($0.10/$0.25) - 2009/07/01 0:46:20 ET
Table 'Qk/910N2Yhg8u5vqTJk50Q' 9-max Seat #2 is the button
Seat 1: zDrucyjVn5aeekNEc3cJrA ($24.75 in chips) 
Seat 2: Th3FldXKQW6hWVVPahaoOQ ($37.70 in chips) 
Seat 3: ghNKXUBl/H+t83JF079ZBA ($25 in chips) 
Seat 5: 4oA316mXLIui1QY63GXBUg ($27 in chips) 
Seat 6: Uupj2MGlo48VpA/VyYrfrw ($6.35 in chips) 
Seat 8: H5Se03ZqSX7tbULXur2MAg ($25.50 in chips) 
Seat 9: M2QO2DxB5Wawg2h8HSpnYA ($19.05 in chips) 
ghNKXUBl/H+t83JF079ZBA: posts small blind $0.10
33y9+GmQ3J84RvZXcraRTw: is sitting out 
4oA316mXLIui1QY63GXBUg: posts big blind $0.25
aNpwfA31EREwO+ar4XzBCw: sits out 
*** HOLE CARDS ***
Uupj2MGlo48VpA/VyYrfrw: calls $0.25
H5Se03ZqSX7tbULXur2MAg: folds 
M2QO2DxB5Wawg2h8HSpnYA: calls $0.25
zDrucyjVn5aeekNEc3cJrA: folds 
Th3FldXKQW6hWVVPahaoOQ: folds 
ghNKXUBl/H+t83JF079ZBA: folds 
4oA316mXLIui1QY63GXBUg: checks 
*** FLOP *** [9s 6d 7h]
4oA316mXLIui1QY63GXBUg: checks 
Uupj2MGlo48VpA/VyYrfrw: bets $0.25
M2QO2DxB5Wawg2h8HSpnYA: calls $0.25
4oA316mXLIui1QY63GXBUg: folds 
*** TURN *** [9s 6d 7h] [Qc]
Uupj2MGlo48VpA/VyYrfrw: bets $1
M2QO2DxB5Wawg2h8HSpnYA: folds 
Uncalled bet ($1) returned to Uupj2MGlo48VpA/VyYrfrw
Uupj2MGlo48VpA/VyYrfrw collected $1.30 from pot
*** SUMMARY ***
Total pot $1.35 | Rake $0.05 
Board [9s 6d 7h Qc]
Seat 1: zDrucyjVn5aeekNEc3cJrA folded before Flop (didn't bet)
Seat 2: Th3FldXKQW6hWVVPahaoOQ (button) folded before Flop (didn't bet)
Seat 3: ghNKXUBl/H+t83JF079ZBA (small blind) folded before Flop
Seat 5: 4oA316mXLIui1QY63GXBUg (big blind) folded on the Flop
Seat 6: Uupj2MGlo48VpA/VyYrfrw collected ($1.30)
Seat 8: H5Se03ZqSX7tbULXur2MAg folded before Flop (didn't bet)
Seat 9: M2QO2DxB5Wawg2h8HSpnYA folded on the Turn




PokerStars Game #59939687954:  Hold'em No Limit ($0.10/$0.25) - 2009/07/01 0:46:20 ET
Table 'mF3KHGMaTpaBZbtBoyfTeg' 6-max Seat #1 is the button
Seat 1: 0HAB2GdCAM7p7V00xueAVQ ($9.30 in chips) 
Seat 2: 4x9jCqgSw4272dnaIqnanw ($5 in chips) 
Seat 3: Hzrn9DZJegEZICufTNYkrg ($13.40 in chips) 
Seat 4: FYepjhAvF8ZdVCmqHIy+eQ ($25 in chips) 
Seat 5: sEQx9G5Cu8k1HNdQasxvUA ($38.40 in chips) 
Seat 6: kG34n23qFQA3nzdOJTQ1dA ($24.65 in chips) 
4x9jCqgSw4272dnaIqnanw: posts small blind $0.10
Hzrn9DZJegEZICufTNYkrg: posts big blind $0.25
*** HOLE CARDS ***
FYepjhAvF8ZdVCmqHIy+eQ: folds 
sEQx9G5Cu8k1HNdQasxvUA: raises $0.75 to $1
kG34n23qFQA3nzdOJTQ1dA: folds 
0HAB2GdCAM7p7V00xueAVQ: calls $1
4x9jCqgSw4272dnaIqnanw: calls $0.90
Hzrn9DZJegEZICufTNYkrg: folds 
*** FLOP *** [3s 6d 2h]
4x9jCqgSw4272dnaIqnanw: checks 
sEQx9G5Cu8k1HNdQasxvUA: bets $3.25
0HAB2GdCAM7p7V00xueAVQ: folds 
4x9jCqgSw4272dnaIqnanw: folds 
Uncalled bet ($3.25) returned to sEQx9G5Cu8k1HNdQasxvUA
sEQx9G5Cu8k1HNdQasxvUA collected $3.10 from pot
sEQx9G5Cu8k1HNdQasxvUA: doesn't show hand 
*** SUMMARY ***
Total pot $3.25 | Rake $0.15 
Board [3s 6d 2h]
Seat 1: 0HAB2GdCAM7p7V00xueAVQ (button) folded on the Flop
Seat 2: 4x9jCqgSw4272dnaIqnanw (small blind) folded on the Flop
Seat 3: Hzrn9DZJegEZICufTNYkrg (big blind) folded before Flop
Seat 4: FYepjhAvF8ZdVCmqHIy+eQ folded before Flop (didn't bet)
Seat 5: sEQx9G5Cu8k1HNdQasxvUA collected ($3.10)
Seat 6: kG34n23qFQA3nzdOJTQ1dA folded before Flop (didn't bet)




PokerStars Game #59939687830:  Hold'em No Limit ($0.10/$0.25) - 2009/07/01 0:46:20 ET
Table '9L7XfAwuM7XsXE8LIg2o5Q' 6-max Seat #1 is the button
Seat 1: H6XbZVba2aKDXlG0la0uow ($6.40 in chips) 
Seat 2: oseFhpinoe+Zg4j5xyBjyQ ($16.70 in chips) 
Seat 3: JRODJ0tkruzJ7hwOFO9ogg ($5 in chips) 
Seat 4: jp34e617tIzV8tKIWmfAbA ($26.40 in chips) 
Seat 5: OUv909q/YxsJgxpSlZxLJQ ($25 in chips) 
Seat 6: k9nHZTHt8hYhYRcW8NTb4g ($28.20 in chips) 
oseFhpinoe+Zg4j5xyBjyQ: posts small blind $0.10
JRODJ0tkruzJ7hwOFO9ogg: posts big blind $0.25
OUv909q/YxsJgxpSlZxLJQ: posts big blind $0.25
*** HOLE CARDS ***
jp34e617tIzV8tKIWmfAbA: folds 
OUv909q/YxsJgxpSlZxLJQ: checks 
k9nHZTHt8hYhYRcW8NTb4g: raises $0.75 to $1
H6XbZVba2aKDXlG0la0uow: calls $1
oseFhpinoe+Zg4j5xyBjyQ: folds 
JRODJ0tkruzJ7hwOFO9ogg: folds 
OUv909q/YxsJgxpSlZxLJQ: calls $0.75
*** FLOP *** [4h Th Kc]
OUv909q/YxsJgxpSlZxLJQ: checks 
k9nHZTHt8hYhYRcW8NTb4g: bets $1.75
H6XbZVba2aKDXlG0la0uow: folds 
OUv909q/YxsJgxpSlZxLJQ: folds 
Uncalled bet ($1.75) returned to k9nHZTHt8hYhYRcW8NTb4g
k9nHZTHt8hYhYRcW8NTb4g collected $3.20 from pot
k9nHZTHt8hYhYRcW8NTb4g: doesn't show hand 
*** SUMMARY ***
Total pot $3.35 | Rake $0.15 
Board [4h Th Kc]
Seat 1: H6XbZVba2aKDXlG0la0uow (button) folded on the Flop
Seat 2: oseFhpinoe+Zg4j5xyBjyQ (small blind) folded before Flop
Seat 3: JRODJ0tkruzJ7hwOFO9ogg (big blind) folded before Flop
Seat 4: jp34e617tIzV8tKIWmfAbA folded before Flop (didn't bet)
Seat 5: OUv909q/YxsJgxpSlZxLJQ folded on the Flop
Seat 6: k9nHZTHt8hYhYRcW8NTb4g collected ($3.20)




PokerStars Game #59939688318:  Hold'em No Limit ($0.10/$0.25) - 2009/07/01 0:46:21 ET
Table 'b64Z+5XI1xkQzNfq4QHr3A' 6-max Seat #2 is the button
Seat 1: qccGLncfUaN00Few5HsgYg ($53.65 in chips) 
Seat 2: SS/yfeArhULzIcOPe8MdPg ($39.10 in chips) 
Seat 3: u/yN5P9f3KlATg6WLWNkBQ ($24.75 in chips) 
Seat 4: SxIIgwXYLkwd6m3wLyPTCw ($25 in chips) 
Seat 5: d0J1xuhsynEY81YHwAvJ5g ($33.25 in chips) 
Seat 6: 8ClCHtFXGNplITm+63KB+Q ($37.75 in chips) 
u/yN5P9f3KlATg6WLWNkBQ: posts small blind $0.10
SxIIgwXYLkwd6m3wLyPTCw: posts big blind $0.25
*** HOLE CARDS ***
d0J1xuhsynEY81YHwAvJ5g: folds 
8ClCHtFXGNplITm+63KB+Q: folds 
qccGLncfUaN00Few5HsgYg: folds 
SS/yfeArhULzIcOPe8MdPg: raises $0.75 to $1
u/yN5P9f3KlATg6WLWNkBQ: folds 
SxIIgwXYLkwd6m3wLyPTCw: folds 
Uncalled bet ($0.75) returned to SS/yfeArhULzIcOPe8MdPg
SS/yfeArhULzIcOPe8MdPg collected $0.60 from pot
*** SUMMARY ***
Total pot $0.60 | Rake $0 
Seat 1: qccGLncfUaN00Few5HsgYg folded before Flop (didn't bet)
Seat 2: SS/yfeArhULzIcOPe8MdPg (button) collected ($0.60)
Seat 3: u/yN5P9f3KlATg6WLWNkBQ (small blind) folded before Flop
Seat 4: SxIIgwXYLkwd6m3wLyPTCw (big blind) folded before Flop
Seat 5: d0J1xuhsynEY81YHwAvJ5g folded before Flop (didn't bet)
Seat 6: 8ClCHtFXGNplITm+63KB+Q folded before Flop (didn't bet)




PokerStars Game #59939688522:  Hold'em No Limit ($0.10/$0.25) - 2009/07/01 0:46:21 ET
Table 'YmPuuzhvRUvgdYcNs5kZKw' 9-max Seat #4 is the button
Seat 1: Qi+clOtyDiibLdH2/1Qy8g ($25.05 in chips) 
Seat 2: JtVGnq5doRa3PublncR+Yw ($25 in chips) 
Seat 4: N6fYvIzQLKaydFLKQGtMlQ ($24.40 in chips) 
Seat 5: CvL9Ch1HYCVbTsfpNucitg ($4.75 in chips) 
Seat 6: z5GxcHlYz/GSz6W2uFiTtg ($26.15 in chips) 
Seat 7: opOCI2p6kW0tINuVaAqmcQ ($25 in chips) 
Seat 8: IeNTEKD96WqM7qU1RpSvOQ ($12.20 in chips) 
CvL9Ch1HYCVbTsfpNucitg: posts small blind $0.10
z5GxcHlYz/GSz6W2uFiTtg: posts big blind $0.25
the bear NF: sits out 
JtVGnq5doRa3PublncR+Yw: posts big blind $0.25
*** HOLE CARDS ***
opOCI2p6kW0tINuVaAqmcQ: folds 
IeNTEKD96WqM7qU1RpSvOQ: calls $0.25
Qi+clOtyDiibLdH2/1Qy8g: folds 
JtVGnq5doRa3PublncR+Yw: checks 
N6fYvIzQLKaydFLKQGtMlQ: folds 
CvL9Ch1HYCVbTsfpNucitg: folds 
z5GxcHlYz/GSz6W2uFiTtg: checks 
*** FLOP *** [5c Ah Ts]
z5GxcHlYz/GSz6W2uFiTtg: checks 
IeNTEKD96WqM7qU1RpSvOQ: bets $0.75
JtVGnq5doRa3PublncR+Yw: folds 
z5GxcHlYz/GSz6W2uFiTtg: folds 
Uncalled bet ($0.75) returned to IeNTEKD96WqM7qU1RpSvOQ
IeNTEKD96WqM7qU1RpSvOQ collected $0.85 from pot
*** SUMMARY ***
Total pot $0.85 | Rake $0 
Board [5c Ah Ts]
Seat 1: Qi+clOtyDiibLdH2/1Qy8g folded before Flop (didn't bet)
Seat 2: JtVGnq5doRa3PublncR+Yw folded on the Flop
Seat 4: N6fYvIzQLKaydFLKQGtMlQ (button) folded before Flop (didn't bet)
Seat 5: CvL9Ch1HYCVbTsfpNucitg (small blind) folded before Flop
Seat 6: z5GxcHlYz/GSz6W2uFiTtg (big blind) folded on the Flop
Seat 7: opOCI2p6kW0tINuVaAqmcQ folded before Flop (didn't bet)
Seat 8: IeNTEKD96WqM7qU1RpSvOQ collected ($0.85)




PokerStars Game #59939688430:  Hold'em No Limit ($0.10/$0.25) - 2009/07/01 0:46:21 ET
Table 'zKwHJD0cmKNUure9qQTfFg' 6-max Seat #3 is the button
Seat 1: nwwpaieDRI0UPyVtChVHOg ($14.90 in chips) 
Seat 3: ljjhtb6FVPTx9AT9HNdtqg ($14.40 in chips) 
Seat 4: v+QfkGiuj9bgtuNoVnDO8w ($25.10 in chips) 
Seat 5: I1TxPvWj8NfG8orglCinNA ($29.80 in chips) 
Seat 6: fBpPyuxbg0NbTlQHEs38sA ($15.90 in chips) 
v+QfkGiuj9bgtuNoVnDO8w: posts small blind $0.10
I1TxPvWj8NfG8orglCinNA: posts big blind $0.25
4kWQxGbT5FZ1dkPd1bE45Q: sits out 
*** HOLE CARDS ***
fBpPyuxbg0NbTlQHEs38sA: raises $0.25 to $0.50
nwwpaieDRI0UPyVtChVHOg: folds 
ljjhtb6FVPTx9AT9HNdtqg: folds 
v+QfkGiuj9bgtuNoVnDO8w: folds 
I1TxPvWj8NfG8orglCinNA: folds 
Uncalled bet ($0.25) returned to fBpPyuxbg0NbTlQHEs38sA
fBpPyuxbg0NbTlQHEs38sA collected $0.60 from pot
fBpPyuxbg0NbTlQHEs38sA: doesn't show hand 
*** SUMMARY ***
Total pot $0.60 | Rake $0 
Seat 1: nwwpaieDRI0UPyVtChVHOg folded before Flop (didn't bet)
Seat 3: ljjhtb6FVPTx9AT9HNdtqg (button) folded before Flop (didn't bet)
Seat 4: v+QfkGiuj9bgtuNoVnDO8w (small blind) folded before Flop
Seat 5: I1TxPvWj8NfG8orglCinNA (big blind) folded before Flop
Seat 6: fBpPyuxbg0NbTlQHEs38sA collected ($0.60)




PokerStars Game #59939688340:  Hold'em No Limit ($0.10/$0.25) - 2009/07/01 0:46:21 ET
Table 'fIrOIN3HoXM27ZpRwKa6oA' 6-max Seat #3 is the button
Seat 1: I1TxPvWj8NfG8orglCinNA ($38.50 in chips) 
Seat 2: 5tB0F9NjPSUL4FzmzBMs2Q ($39.65 in chips) 
Seat 3: eSKnWz2RD4rvwnvB+rFzIg ($25 in chips) 
Seat 5: 8ClCHtFXGNplITm+63KB+Q ($26.20 in chips) 
Seat 6: v+QfkGiuj9bgtuNoVnDO8w ($28.85 in chips) 
8ClCHtFXGNplITm+63KB+Q: posts small blind $0.10
v+QfkGiuj9bgtuNoVnDO8w: posts big blind $0.25
*** HOLE CARDS ***
I1TxPvWj8NfG8orglCinNA: folds 
5tB0F9NjPSUL4FzmzBMs2Q: folds 
eSKnWz2RD4rvwnvB+rFzIg: raises $0.50 to $0.75
8ClCHtFXGNplITm+63KB+Q: folds 
v+QfkGiuj9bgtuNoVnDO8w: folds 
Uncalled bet ($0.50) returned to eSKnWz2RD4rvwnvB+rFzIg
eSKnWz2RD4rvwnvB+rFzIg collected $0.60 from pot
eSKnWz2RD4rvwnvB+rFzIg: doesn't show hand 
*** SUMMARY ***
Total pot $0.60 | Rake $0 
Seat 1: I1TxPvWj8NfG8orglCinNA folded before Flop (didn't bet)
Seat 2: 5tB0F9NjPSUL4FzmzBMs2Q folded before Flop (didn't bet)
Seat 3: eSKnWz2RD4rvwnvB+rFzIg (button) collected ($0.60)
Seat 5: 8ClCHtFXGNplITm+63KB+Q (small blind) folded before Flop
Seat 6: v+QfkGiuj9bgtuNoVnDO8w (big blind) folded before Flop




PokerStars Game #59939688550:  Hold'em No Limit ($0.10/$0.25) - 2009/07/01 0:46:21 ET
Table 'BabJGL6tfXQp3leBGbYe8A' 9-max Seat #1 is the button
Seat 1: qwr38jl5txoR36M7G5qi4A ($7.50 in chips) 
Seat 2: G5EFgY1bi50mF1iH/+B4yQ ($10.30 in chips) 
Seat 3: Jdj7AsGFrlkCgDXeWK322A ($25.85 in chips) 
Seat 4: Yk91gygnxgAKPGHZ/jPVSw ($8.95 in chips) 
Seat 5: fKqW4kzqpoOv+YKE5kp3FA ($2.80 in chips) 
Seat 6: ELKIDQ6mBSQJr3wiHYHtvw ($6.90 in chips) 
Seat 8: TJEefy+0K5gBV+8LA5OK7Q ($25 in chips) 
Seat 9: xEQxarad8/T4jJdpZy5LGw ($10.10 in chips) 
G5EFgY1bi50mF1iH/+B4yQ: posts small blind $0.10
Jdj7AsGFrlkCgDXeWK322A: posts big blind $0.25
st9jtdNbm1W5GfBwRaCVqQ: sits out 
*** HOLE CARDS ***
Yk91gygnxgAKPGHZ/jPVSw: calls $0.25
fKqW4kzqpoOv+YKE5kp3FA: folds 
ELKIDQ6mBSQJr3wiHYHtvw: folds 
TJEefy+0K5gBV+8LA5OK7Q: folds 
xEQxarad8/T4jJdpZy5LGw: folds 
qwr38jl5txoR36M7G5qi4A: folds 
G5EFgY1bi50mF1iH/+B4yQ: folds 
Jdj7AsGFrlkCgDXeWK322A: checks 
*** FLOP *** [2s 7c 3d]
Jdj7AsGFrlkCgDXeWK322A: checks 
Yk91gygnxgAKPGHZ/jPVSw: checks 
*** TURN *** [2s 7c 3d] [5s]
Jdj7AsGFrlkCgDXeWK322A: checks 
Yk91gygnxgAKPGHZ/jPVSw: checks 
*** RIVER *** [2s 7c 3d 5s] [Jd]
Jdj7AsGFrlkCgDXeWK322A: checks 
Yk91gygnxgAKPGHZ/jPVSw: checks 
*** SHOW DOWN ***
Jdj7AsGFrlkCgDXeWK322A: shows [6h Kc] (high card King)
Yk91gygnxgAKPGHZ/jPVSw: mucks hand 
Jdj7AsGFrlkCgDXeWK322A collected $0.60 from pot
*** SUMMARY ***
Total pot $0.60 | Rake $0 
Board [2s 7c 3d 5s Jd]
Seat 1: qwr38jl5txoR36M7G5qi4A (button) folded before Flop (didn't bet)
Seat 2: G5EFgY1bi50mF1iH/+B4yQ (small blind) folded before Flop
Seat 3: Jdj7AsGFrlkCgDXeWK322A (big blind) showed [6h Kc] and won ($0.60) with high card King
Seat 4: Yk91gygnxgAKPGHZ/jPVSw mucked
Seat 5: fKqW4kzqpoOv+YKE5kp3FA folded before Flop (didn't bet)
Seat 6: ELKIDQ6mBSQJr3wiHYHtvw folded before Flop (didn't bet)
Seat 8: TJEefy+0K5gBV+8LA5OK7Q folded before Flop (didn't bet)
Seat 9: xEQxarad8/T4jJdpZy5LGw folded before Flop (didn't bet)




PokerStars Game #59939689124:  Hold'em No Limit ($0.10/$0.25) - 2009/07/01 0:46:22 ET
Table 'SbSV5tlgLp0+/Z+13PW3Hg' 9-max Seat #3 is the button
Seat 2: zDrucyjVn5aeekNEc3cJrA ($19 in chips) 
Seat 3: s7Q6uNouhe7aE8JdFb9E+A ($25.50 in chips) 
Seat 4: NNZypfH1f/VIj3Skf/XIzg ($4.75 in chips) 
Seat 5: z5GxcHlYz/GSz6W2uFiTtg ($19.60 in chips) 
Seat 6: qwr38jl5txoR36M7G5qi4A ($7.90 in chips) 
Seat 7: j4q3p0lesp63b1gZDwLBZw ($6.35 in chips) 
Seat 8: 7cv+9Zc9HIQHNvYsMfV3uA ($26.60 in chips) 
Seat 9: rXm4QDVJt67H20lM6n6Z7Q ($18.50 in chips) 
NNZypfH1f/VIj3Skf/XIzg: posts small blind $0.10
z5GxcHlYz/GSz6W2uFiTtg: posts big blind $0.25
7milehigh3: sits out 
*** HOLE CARDS ***
qwr38jl5txoR36M7G5qi4A: folds 
j4q3p0lesp63b1gZDwLBZw: folds 
7cv+9Zc9HIQHNvYsMfV3uA: raises $0.75 to $1
rXm4QDVJt67H20lM6n6Z7Q: folds 
zDrucyjVn5aeekNEc3cJrA: folds 
s7Q6uNouhe7aE8JdFb9E+A: folds 
NNZypfH1f/VIj3Skf/XIzg: folds 
z5GxcHlYz/GSz6W2uFiTtg: folds 
Uncalled bet ($0.75) returned to 7cv+9Zc9HIQHNvYsMfV3uA
7cv+9Zc9HIQHNvYsMfV3uA collected $0.60 from pot
7cv+9Zc9HIQHNvYsMfV3uA: doesn't show hand 
*** SUMMARY ***
Total pot $0.60 | Rake $0 
Seat 2: zDrucyjVn5aeekNEc3cJrA folded before Flop (didn't bet)
Seat 3: s7Q6uNouhe7aE8JdFb9E+A (button) folded before Flop (didn't bet)
Seat 4: NNZypfH1f/VIj3Skf/XIzg (small blind) folded before Flop
Seat 5: z5GxcHlYz/GSz6W2uFiTtg (big blind) folded before Flop
Seat 6: qwr38jl5txoR36M7G5qi4A folded before Flop (didn't bet)
Seat 7: j4q3p0lesp63b1gZDwLBZw folded before Flop (didn't bet)
Seat 8: 7cv+9Zc9HIQHNvYsMfV3uA collected ($0.60)
Seat 9: rXm4QDVJt67H20lM6n6Z7Q folded before Flop (didn't bet)




PokerStars Game #59939689444:  Hold'em No Limit ($0.10/$0.25) - 2009/07/01 0:46:22 ET
Table 'FgLmv9bi/fJP8ldfbTOpkg' 9-max Seat #8 is the button
Seat 1: opOCI2p6kW0tINuVaAqmcQ ($25.95 in chips) 
Seat 2: mpsfNtnMVDqQHTe92AhIdw ($28.60 in chips) 
Seat 4: WfS0TjI8FyLemNTOo1e9qA ($10.90 in chips) 
Seat 5: ucLrYHo2o2p/ZURC7/I6gQ ($15 in chips) 
Seat 6: oKO7b50N6TzXbPBr/mcrUA ($29 in chips) 
Seat 7: eFrBtVXGVoMq1UwCDg8Exg ($29.05 in chips) 
Seat 8: sJNHTWcSlLHRCZ9+YRLLqA ($25 in chips) 
Seat 9: ljemhp25Zg+nlA9DLCIiUw ($24.75 in chips) 
ljemhp25Zg+nlA9DLCIiUw: posts small blind $0.10
opOCI2p6kW0tINuVaAqmcQ: posts big blind $0.25
uJlzv9KL7hgCIqIS2ofoaw: sits out 
ucLrYHo2o2p/ZURC7/I6gQ: posts big blind $0.25
*** HOLE CARDS ***
mpsfNtnMVDqQHTe92AhIdw: folds 
WfS0TjI8FyLemNTOo1e9qA: raises $1 to $1.25
ucLrYHo2o2p/ZURC7/I6gQ: folds 
oKO7b50N6TzXbPBr/mcrUA: folds 
eFrBtVXGVoMq1UwCDg8Exg: folds 
sJNHTWcSlLHRCZ9+YRLLqA: folds 
ljemhp25Zg+nlA9DLCIiUw: folds 
opOCI2p6kW0tINuVaAqmcQ: folds 
Uncalled bet ($1) returned to WfS0TjI8FyLemNTOo1e9qA
WfS0TjI8FyLemNTOo1e9qA collected $0.85 from pot
*** SUMMARY ***
Total pot $0.85 | Rake $0 
Seat 1: opOCI2p6kW0tINuVaAqmcQ (big blind) folded before Flop
Seat 2: mpsfNtnMVDqQHTe92AhIdw folded before Flop (didn't bet)
Seat 4: WfS0TjI8FyLemNTOo1e9qA collected ($0.85)
Seat 5: ucLrYHo2o2p/ZURC7/I6gQ folded before Flop
Seat 6: oKO7b50N6TzXbPBr/mcrUA folded before Flop (didn't bet)
Seat 7: eFrBtVXGVoMq1UwCDg8Exg folded before Flop (didn't bet)
Seat 8: sJNHTWcSlLHRCZ9+YRLLqA (button) folded before Flop (didn't bet)
Seat 9: ljemhp25Zg+nlA9DLCIiUw (small blind) folded before Flop




PokerStars Game #59939689206:  Hold'em No Limit ($0.10/$0.25) - 2009/07/01 0:46:22 ET
Table 'CM/C/FZf3VHIp50RjmBucQ' 9-max Seat #7 is the button
Seat 1: 1Clf3cPrqoy/YgvWdWK1Xw ($5 in chips) 
Seat 2: 1S/fpm+f42V/6MNZre+ccg ($30.10 in chips) 
Seat 3: dfNim92Z6XK1/h5SFW5vDg ($29.40 in chips) 
Seat 4: jN7A9nKK4RYzhFj4MrekhA ($14.25 in chips) 
Seat 5: TeWJxSETzbXGiYKx0y+dtg ($36.80 in chips) 
Seat 6: Zo0U/uoOdOJx9sV/NiB2JA ($9 in chips) 
Seat 7: j4q3p0lesp63b1gZDwLBZw ($5 in chips) 
Seat 8: cZ99hugmLBj9KhTlc8nCSw ($25.90 in chips) 
Seat 9: Yv4fucyyT28mjx8V5lxKJg ($19.75 in chips) 
cZ99hugmLBj9KhTlc8nCSw: posts small blind $0.10
Yv4fucyyT28mjx8V5lxKJg: posts big blind $0.25
Zo0U/uoOdOJx9sV/NiB2JA: posts big blind $0.25
*** HOLE CARDS ***
1Clf3cPrqoy/YgvWdWK1Xw: folds 
1S/fpm+f42V/6MNZre+ccg: folds 
dfNim92Z6XK1/h5SFW5vDg: folds 
jN7A9nKK4RYzhFj4MrekhA: calls $0.25
TeWJxSETzbXGiYKx0y+dtg: calls $0.25
Zo0U/uoOdOJx9sV/NiB2JA: checks 
j4q3p0lesp63b1gZDwLBZw: folds 
cZ99hugmLBj9KhTlc8nCSw: folds 
Yv4fucyyT28mjx8V5lxKJg: checks 
*** FLOP *** [2c 7s 7h]
Yv4fucyyT28mjx8V5lxKJg: checks 
jN7A9nKK4RYzhFj4MrekhA: checks 
TeWJxSETzbXGiYKx0y+dtg: checks 
Zo0U/uoOdOJx9sV/NiB2JA: checks 
*** TURN *** [2c 7s 7h] [3s]
Yv4fucyyT28mjx8V5lxKJg: bets $0.75
jN7A9nKK4RYzhFj4MrekhA: folds 
TeWJxSETzbXGiYKx0y+dtg: calls $0.75
Zo0U/uoOdOJx9sV/NiB2JA: folds 
*** RIVER *** [2c 7s 7h 3s] [Qc]
Yv4fucyyT28mjx8V5lxKJg: checks 
TeWJxSETzbXGiYKx0y+dtg: bets $8
Yv4fucyyT28mjx8V5lxKJg: folds 
Uncalled bet ($8) returned to TeWJxSETzbXGiYKx0y+dtg
Yv4fucyyT28mjx8V5lxKJg leaves the table
TeWJxSETzbXGiYKx0y+dtg collected $2.50 from pot
TeWJxSETzbXGiYKx0y+dtg: doesn't show hand 
*** SUMMARY ***
Total pot $2.60 | Rake $0.10 
Board [2c 7s 7h 3s Qc]
Seat 1: 1Clf3cPrqoy/YgvWdWK1Xw folded before Flop (didn't bet)
Seat 2: 1S/fpm+f42V/6MNZre+ccg folded before Flop (didn't bet)
Seat 3: dfNim92Z6XK1/h5SFW5vDg folded before Flop (didn't bet)
Seat 4: jN7A9nKK4RYzhFj4MrekhA folded on the Turn
Seat 5: TeWJxSETzbXGiYKx0y+dtg collected ($2.50)
Seat 6: Zo0U/uoOdOJx9sV/NiB2JA folded on the Turn
Seat 7: j4q3p0lesp63b1gZDwLBZw (button) folded before Flop (didn't bet)
Seat 8: cZ99hugmLBj9KhTlc8nCSw (small blind) folded before Flop
Seat 9: Yv4fucyyT28mjx8V5lxKJg (big blind) folded on the River




PokerStars Game #59939689528:  Hold'em No Limit ($0.10/$0.25) - 2009/07/01 0:46:22 ET
Table 'K/f0NNaoGuhSz5DrzgVw7Q' 9-max Seat #3 is the button
Seat 1: sD+TKtt36XiiN6jqHiLwDA ($24.65 in chips) 
Seat 2: 18G4P1XstjNvItdGUITxgw ($25 in chips) 
Seat 3: VBHxUExRAMrbxUq/cVx9Gw ($5 in chips) 
Seat 4: 3L1qKVpA6QZjrddTpoh2zQ ($12.60 in chips) 
Seat 5: DnDcAdn9P0zGovMERigpFA ($30.75 in chips) 
Seat 6: 3PVK0IdMlq2fElkVzzr4bg ($17.60 in chips) 
Seat 7: st9jtdNbm1W5GfBwRaCVqQ ($28.25 in chips) 
Seat 8: E0iYnEVO2ho7dH3QcCjw7g ($19.65 in chips) 
Seat 9: B5Xu8WsfFPfBlsK3fbAtQQ ($7.95 in chips) 
3L1qKVpA6QZjrddTpoh2zQ: posts small blind $0.10
DnDcAdn9P0zGovMERigpFA: posts big blind $0.25
*** HOLE CARDS ***
3PVK0IdMlq2fElkVzzr4bg: folds 
st9jtdNbm1W5GfBwRaCVqQ: folds 
E0iYnEVO2ho7dH3QcCjw7g: folds 
B5Xu8WsfFPfBlsK3fbAtQQ: calls $0.25
sD+TKtt36XiiN6jqHiLwDA: calls $0.25
18G4P1XstjNvItdGUITxgw: folds 
VBHxUExRAMrbxUq/cVx9Gw: folds 
3L1qKVpA6QZjrddTpoh2zQ: calls $0.15
DnDcAdn9P0zGovMERigpFA: checks 
*** FLOP *** [4c 2c 8h]
3L1qKVpA6QZjrddTpoh2zQ: checks 
DnDcAdn9P0zGovMERigpFA: checks 
B5Xu8WsfFPfBlsK3fbAtQQ: checks 
sD+TKtt36XiiN6jqHiLwDA: checks 
*** TURN *** [4c 2c 8h] [2d]
3L1qKVpA6QZjrddTpoh2zQ: bets $0.75
DnDcAdn9P0zGovMERigpFA: folds 
B5Xu8WsfFPfBlsK3fbAtQQ: folds 
sD+TKtt36XiiN6jqHiLwDA: folds 
Uncalled bet ($0.75) returned to 3L1qKVpA6QZjrddTpoh2zQ
3L1qKVpA6QZjrddTpoh2zQ collected $0.95 from pot
*** SUMMARY ***
Total pot $1 | Rake $0.05 
Board [4c 2c 8h 2d]
Seat 1: sD+TKtt36XiiN6jqHiLwDA folded on the Turn
Seat 2: 18G4P1XstjNvItdGUITxgw folded before Flop (didn't bet)
Seat 3: VBHxUExRAMrbxUq/cVx9Gw (button) folded before Flop (didn't bet)
Seat 4: 3L1qKVpA6QZjrddTpoh2zQ (small blind) collected ($0.95)
Seat 5: DnDcAdn9P0zGovMERigpFA (big blind) folded on the Turn
Seat 6: 3PVK0IdMlq2fElkVzzr4bg folded before Flop (didn't bet)
Seat 7: st9jtdNbm1W5GfBwRaCVqQ folded before Flop (didn't bet)
Seat 8: E0iYnEVO2ho7dH3QcCjw7g folded before Flop (didn't bet)
Seat 9: B5Xu8WsfFPfBlsK3fbAtQQ folded on the Turn




PokerStars Game #59939688920:  Hold'em No Limit ($0.10/$0.25) - 2009/07/01 0:46:22 ET
Table 'sm5gqEvXgLbkkE4dryW/5g' 6-max Seat #4 is the button
Seat 1: gaPMxLGp9SOj4Lq6t+/0Ig ($15.40 in chips) 
Seat 2: s13YXIlhF/j3TO0bSnT7bA ($18.45 in chips) 
Seat 4: BedjMfrlRfPgSq7CXpPAmg ($56.90 in chips) 
Seat 5: M+WmDyCD/ZMu/5t6/iH2kw ($68.45 in chips) 
Seat 6: wKFJ513ucluNNiMlkXcDOQ ($27 in chips) 
M+WmDyCD/ZMu/5t6/iH2kw: posts small blind $0.10
wKFJ513ucluNNiMlkXcDOQ: posts big blind $0.25
I1TxPvWj8NfG8orglCinNA: sits out 
*** HOLE CARDS ***
gaPMxLGp9SOj4Lq6t+/0Ig: folds 
s13YXIlhF/j3TO0bSnT7bA: folds 
BedjMfrlRfPgSq7CXpPAmg: folds 
M+WmDyCD/ZMu/5t6/iH2kw: calls $0.15
wKFJ513ucluNNiMlkXcDOQ: checks 
*** FLOP *** [9c Ac 7d]
M+WmDyCD/ZMu/5t6/iH2kw: checks 
wKFJ513ucluNNiMlkXcDOQ: bets $0.50
M+WmDyCD/ZMu/5t6/iH2kw: folds 
Uncalled bet ($0.50) returned to wKFJ513ucluNNiMlkXcDOQ
wKFJ513ucluNNiMlkXcDOQ collected $0.50 from pot
wKFJ513ucluNNiMlkXcDOQ: doesn't show hand 
*** SUMMARY ***
Total pot $0.50 | Rake $0 
Board [9c Ac 7d]
Seat 1: gaPMxLGp9SOj4Lq6t+/0Ig folded before Flop (didn't bet)
Seat 2: s13YXIlhF/j3TO0bSnT7bA folded before Flop (didn't bet)
Seat 4: BedjMfrlRfPgSq7CXpPAmg (button) folded before Flop (didn't bet)
Seat 5: M+WmDyCD/ZMu/5t6/iH2kw (small blind) folded on the Flop
Seat 6: wKFJ513ucluNNiMlkXcDOQ (big blind) collected ($0.50)




PokerStars Game #59939689314:  Hold'em No Limit ($0.10/$0.25) - 2009/07/01 0:46:22 ET
Table '2O5CgfSkSwrr4PDrlZ1RLQ' 6-max Seat #6 is the button
Seat 1: kyRaCIljYA6l33lSKQfNsg ($46.85 in chips) 
Seat 2: /gJNBeCkWL4o85/jvlZ4BA ($50.15 in chips) 
Seat 3: yzFNNFIfC89bBPwpFPx2ow ($25 in chips) 
Seat 4: 4x9jCqgSw4272dnaIqnanw ($5 in chips) 
Seat 5: AMrBn4Vx9aAo/vv6WHLk6w ($4.60 in chips) 
Seat 6: tj9xqoqQaDaFw7u1oyZrtA ($35.95 in chips) 
kyRaCIljYA6l33lSKQfNsg: posts small blind $0.10
/gJNBeCkWL4o85/jvlZ4BA: posts big blind $0.25
*** HOLE CARDS ***
yzFNNFIfC89bBPwpFPx2ow: folds 
4x9jCqgSw4272dnaIqnanw: raises $4.75 to $5 and is all-in
AMrBn4Vx9aAo/vv6WHLk6w: folds 
tj9xqoqQaDaFw7u1oyZrtA: folds 
kyRaCIljYA6l33lSKQfNsg: folds 
tj9xqoqQaDaFw7u1oyZrtA is sitting out
/gJNBeCkWL4o85/jvlZ4BA: folds 
Uncalled bet ($4.75) returned to 4x9jCqgSw4272dnaIqnanw
4x9jCqgSw4272dnaIqnanw collected $0.60 from pot
*** SUMMARY ***
Total pot $0.60 | Rake $0 
Seat 1: kyRaCIljYA6l33lSKQfNsg (small blind) folded before Flop
Seat 2: /gJNBeCkWL4o85/jvlZ4BA (big blind) folded before Flop
Seat 3: yzFNNFIfC89bBPwpFPx2ow folded before Flop (didn't bet)
Seat 4: 4x9jCqgSw4272dnaIqnanw collected ($0.60)
Seat 5: AMrBn4Vx9aAo/vv6WHLk6w folded before Flop (didn't bet)
Seat 6: tj9xqoqQaDaFw7u1oyZrtA (button) folded before Flop (didn't bet)




PokerStars Game #59939688950:  Hold'em No Limit ($0.10/$0.25) - 2009/07/01 0:46:22 ET
Table 'HzFR0rxmDAPu5GzYR0AlYg' 6-max Seat #4 is the button
Seat 1: v+QfkGiuj9bgtuNoVnDO8w ($25 in chips) 
Seat 2: UA5OsKS3VPaxa7uC8La/kA ($49.45 in chips) 
Seat 3: lfAPI6VglUPipZe8BpDaTA ($24.70 in chips) 
Seat 4: uy9x0X5l7O+IpGjLa77QgQ ($64.75 in chips) 
Seat 5: lquriepNQBhDV5P1SWHhnA ($25 in chips) 
Seat 6: jp34e617tIzV8tKIWmfAbA ($26.60 in chips) 
lquriepNQBhDV5P1SWHhnA: posts small blind $0.10
jp34e617tIzV8tKIWmfAbA: posts big blind $0.25
lfAPI6VglUPipZe8BpDaTA: posts small & big blinds $0.35
*** HOLE CARDS ***
v+QfkGiuj9bgtuNoVnDO8w: folds 
UA5OsKS3VPaxa7uC8La/kA: raises $1.25 to $1.50
lfAPI6VglUPipZe8BpDaTA: folds 
uy9x0X5l7O+IpGjLa77QgQ: folds 
lquriepNQBhDV5P1SWHhnA: folds 
jp34e617tIzV8tKIWmfAbA: folds 
Uncalled bet ($1.25) returned to UA5OsKS3VPaxa7uC8La/kA
UA5OsKS3VPaxa7uC8La/kA collected $0.95 from pot
*** SUMMARY ***
Total pot $0.95 | Rake $0 
Seat 1: v+QfkGiuj9bgtuNoVnDO8w folded before Flop (didn't bet)
Seat 2: UA5OsKS3VPaxa7uC8La/kA collected ($0.95)
Seat 3: lfAPI6VglUPipZe8BpDaTA folded before Flop
Seat 4: uy9x0X5l7O+IpGjLa77QgQ (button) folded before Flop (didn't bet)
Seat 5: lquriepNQBhDV5P1SWHhnA (small blind) folded before Flop
Seat 6: jp34e617tIzV8tKIWmfAbA (big blind) folded before Flop




PokerStars Game #59939689526:  Hold'em No Limit ($0.10/$0.25) - 2009/07/01 0:46:22 ET
Table 'Pz8SfAzhP5nvWTsJRAxoDg' 6-max Seat #1 is the button
Seat 1: buyjetgNT1McXtdaP4zynA ($40.95 in chips) 
Seat 2: zxeVQGaMKDsDzmSY+AInjA ($14.75 in chips) 
Seat 3: mfrkWA3PTeYPkbO6hi98Aw ($39.55 in chips) 
Seat 4: 9U9Vy/656QCEfKznJWteag ($13 in chips) 
Seat 5: FYepjhAvF8ZdVCmqHIy+eQ ($30.10 in chips) 
Seat 6: FStoHe64SQWqAsjya9pDkQ ($25.35 in chips) 
zxeVQGaMKDsDzmSY+AInjA: posts small blind $0.10
mfrkWA3PTeYPkbO6hi98Aw: posts big blind $0.25
*** HOLE CARDS ***
9U9Vy/656QCEfKznJWteag: calls $0.25
FYepjhAvF8ZdVCmqHIy+eQ: folds 
FStoHe64SQWqAsjya9pDkQ: folds 
buyjetgNT1McXtdaP4zynA has timed out
buyjetgNT1McXtdaP4zynA: folds 
buyjetgNT1McXtdaP4zynA is sitting out
buyjetgNT1McXtdaP4zynA has returned
zxeVQGaMKDsDzmSY+AInjA: calls $0.15
mfrkWA3PTeYPkbO6hi98Aw: checks 
*** FLOP *** [Kc 7d 7h]
zxeVQGaMKDsDzmSY+AInjA: checks 
mfrkWA3PTeYPkbO6hi98Aw: checks 
9U9Vy/656QCEfKznJWteag: checks 
*** TURN *** [Kc 7d 7h] [Ah]
zxeVQGaMKDsDzmSY+AInjA: checks 
mfrkWA3PTeYPkbO6hi98Aw: checks 
9U9Vy/656QCEfKznJWteag: checks 
*** RIVER *** [Kc 7d 7h Ah] [Tc]
zxeVQGaMKDsDzmSY+AInjA: bets $0.75
mfrkWA3PTeYPkbO6hi98Aw: calls $0.75
9U9Vy/656QCEfKznJWteag: folds 
*** SHOW DOWN ***
zxeVQGaMKDsDzmSY+AInjA: shows [Qh Js] (a straight, Ten to Ace)
mfrkWA3PTeYPkbO6hi98Aw: mucks hand 
zxeVQGaMKDsDzmSY+AInjA collected $2.15 from pot
*** SUMMARY ***
Total pot $2.25 | Rake $0.10 
Board [Kc 7d 7h Ah Tc]
Seat 1: buyjetgNT1McXtdaP4zynA (button) folded before Flop (didn't bet)
Seat 2: zxeVQGaMKDsDzmSY+AInjA (small blind) showed [Qh Js] and won ($2.15) with a straight, Ten to Ace
Seat 3: mfrkWA3PTeYPkbO6hi98Aw (big blind) mucked
Seat 4: 9U9Vy/656QCEfKznJWteag folded on the River
Seat 5: FYepjhAvF8ZdVCmqHIy+eQ folded before Flop (didn't bet)
Seat 6: FStoHe64SQWqAsjya9pDkQ folded before Flop (didn't bet)




PokerStars Game #59939689978:  Hold'em No Limit ($0.10/$0.25) - 2009/07/01 0:46:23 ET
Table 'isKy4XK8wJM0x735/D4hWA' 6-max Seat #1 is the button
Seat 1: 7FmwVDcdEtxDpHmP4hOXsQ ($25 in chips) 
Seat 2: WrLI51S2iMb8GLMB83gGqA ($25.60 in chips) 
Seat 3: jp34e617tIzV8tKIWmfAbA ($25 in chips) 
Seat 4: k9vn40MOqqb+xF+7GZ6v2g ($28.05 in chips) 
Seat 6: M6xK/VklCvdyyrmvzATlxQ ($16.90 in chips) 
WrLI51S2iMb8GLMB83gGqA: posts small blind $0.10
jp34e617tIzV8tKIWmfAbA: posts big blind $0.25
lquriepNQBhDV5P1SWHhnA: sits out 
*** HOLE CARDS ***
k9vn40MOqqb+xF+7GZ6v2g: folds 
M6xK/VklCvdyyrmvzATlxQ: raises $0.50 to $0.75
7FmwVDcdEtxDpHmP4hOXsQ: folds 
WrLI51S2iMb8GLMB83gGqA: folds 
jp34e617tIzV8tKIWmfAbA: folds 
Uncalled bet ($0.50) returned to M6xK/VklCvdyyrmvzATlxQ
M6xK/VklCvdyyrmvzATlxQ collected $0.60 from pot
M6xK/VklCvdyyrmvzATlxQ: doesn't show hand 
*** SUMMARY ***
Total pot $0.60 | Rake $0 
Seat 1: 7FmwVDcdEtxDpHmP4hOXsQ (button) folded before Flop (didn't bet)
Seat 2: WrLI51S2iMb8GLMB83gGqA (small blind) folded before Flop
Seat 3: jp34e617tIzV8tKIWmfAbA (big blind) folded before Flop
Seat 4: k9vn40MOqqb+xF+7GZ6v2g folded before Flop (didn't bet)
Seat 6: M6xK/VklCvdyyrmvzATlxQ collected ($0.60)




PokerStars Game #59939690152:  Hold'em No Limit ($0.10/$0.25) - 2009/07/01 0:46:23 ET
Table '3eK1r4Q4BSYFvsKkuTLpIA' 9-max Seat #8 is the button
Seat 1: qwr38jl5txoR36M7G5qi4A ($7.75 in chips) 
Seat 2: 7QzbjWT00wQpau1iqvUmMA ($5 in chips) 
Seat 3: 56S3mA6Zs3pGR+0p0vUCtg ($25 in chips) 
Seat 4: S2iyN4Q7njjhguIuE5g1CQ ($24.95 in chips) 
Seat 6: +HvCCmsGSQeatf+GZ9zk8Q ($38.60 in chips) 
Seat 7: GTcLfsDTPqgfHyhY9FNDMw ($7.65 in chips) 
Seat 8: Cni99AOp8W/F0ZWCuHNcIA ($11.15 in chips) 
Seat 9: +sbyWwIcFp9kP0bDtMegfQ ($37.50 in chips) 
+sbyWwIcFp9kP0bDtMegfQ: posts small blind $0.10
qwr38jl5txoR36M7G5qi4A: posts big blind $0.25
*** HOLE CARDS ***
7QzbjWT00wQpau1iqvUmMA: folds 
56S3mA6Zs3pGR+0p0vUCtg: folds 
S2iyN4Q7njjhguIuE5g1CQ: calls $0.25
7QzbjWT00wQpau1iqvUmMA leaves the table
+HvCCmsGSQeatf+GZ9zk8Q: folds 
GTcLfsDTPqgfHyhY9FNDMw: folds 
+HvCCmsGSQeatf+GZ9zk8Q is sitting out
Cni99AOp8W/F0ZWCuHNcIA: calls $0.25
+sbyWwIcFp9kP0bDtMegfQ: folds 
qwr38jl5txoR36M7G5qi4A: checks 
*** FLOP *** [6d 8s Kh]
qwr38jl5txoR36M7G5qi4A: checks 
S2iyN4Q7njjhguIuE5g1CQ: checks 
Cni99AOp8W/F0ZWCuHNcIA: checks 
*** TURN *** [6d 8s Kh] [3s]
qwr38jl5txoR36M7G5qi4A: bets $0.75
S2iyN4Q7njjhguIuE5g1CQ: folds 
Cni99AOp8W/F0ZWCuHNcIA: calls $0.75
*** RIVER *** [6d 8s Kh 3s] [Th]
aNpwfA31EREwO+ar4XzBCw joins the table at seat #2 
qwr38jl5txoR36M7G5qi4A: bets $1.50
Cni99AOp8W/F0ZWCuHNcIA: folds 
Uncalled bet ($1.50) returned to qwr38jl5txoR36M7G5qi4A
qwr38jl5txoR36M7G5qi4A collected $2.25 from pot
qwr38jl5txoR36M7G5qi4A: doesn't show hand 
*** SUMMARY ***
Total pot $2.35 | Rake $0.10 
Board [6d 8s Kh 3s Th]
Seat 1: qwr38jl5txoR36M7G5qi4A (big blind) collected ($2.25)
Seat 2: 7QzbjWT00wQpau1iqvUmMA folded before Flop (didn't bet)
Seat 3: 56S3mA6Zs3pGR+0p0vUCtg folded before Flop (didn't bet)
Seat 4: S2iyN4Q7njjhguIuE5g1CQ folded on the Turn
Seat 6: +HvCCmsGSQeatf+GZ9zk8Q folded before Flop (didn't bet)
Seat 7: GTcLfsDTPqgfHyhY9FNDMw folded before Flop (didn't bet)
Seat 8: Cni99AOp8W/F0ZWCuHNcIA (button) folded on the River
Seat 9: +sbyWwIcFp9kP0bDtMegfQ (small blind) folded before Flop




PokerStars Game #59939690172:  Hold'em No Limit ($0.10/$0.25) - 2009/07/01 0:46:23 ET
Table 'ZiwAqg4o02gNro+JOAaFNg6wawJ+MkkvuC3coG6r+YhgSeat #2 is the button
Seat 2: tYsOBqdU1+x+yFI7zHO7hQ ($31.70 in chips) 
Seat 3: aNpwfA31EREwO+ar4XzBCw ($25.10 in chips) 
Seat 4: FJflwqC6fqOpM3j0q8Bptw ($21.95 in chips) 
Seat 5: 5hAPbqNrvJb8PtLiceXtlg6HoFYfVGBefsR5Vrz62qIw9.15 in chips) 
Seat 6: hBMUlEpyU74r/fwDgIpXjQ ($27.95 in chips) 
Seat 7: opOCI2p6kW0tINuVaAqmcQ ($25 in chips) 
Seat 8: CYkY0dNBaYaKs8HVCVn3mQ ($5 in chips) 
Seat 9: ljemhp25Zg+nlA9DLCIiUw ($24.65 in chips) 
aNpwfA31EREwO+ar4XzBCw: posts small blind $0.10
FJflwqC6fqOpM3j0q8Bptw: posts big blind $0.25
*** HOLE CARDS ***
5hAPbqNrvJb8PtLiceXtlg6HoFYfVGBefsR5Vrz62qIwlds 
hBMUlEpyU74r/fwDgIpXjQ: folds 
opOCI2p6kW0tINuVaAqmcQ: folds 
CYkY0dNBaYaKs8HVCVn3mQ: folds 
6RiVTYll/5D8zICp0MRpKw joins the table at seat #1 
ljemhp25Zg+nlA9DLCIiUw: folds 
tYsOBqdU1+x+yFI7zHO7hQ: raises $0.50 to $0.75
aNpwfA31EREwO+ar4XzBCw: folds 
FJflwqC6fqOpM3j0q8Bptw: calls $0.50
*** FLOP *** [Js 5s Kc]
FJflwqC6fqOpM3j0q8Bptw: checks 
tYsOBqdU1+x+yFI7zHO7hQ: bets $1.25
FJflwqC6fqOpM3j0q8Bptw: calls $1.25
*** TURN *** [Js 5s Kc] [As]
FJflwqC6fqOpM3j0q8Bptw: checks 
tYsOBqdU1+x+yFI7zHO7hQ: checks 
*** RIVER *** [Js 5s Kc As] [6s]
FJflwqC6fqOpM3j0q8Bptw: bets $0.25
tYsOBqdU1+x+yFI7zHO7hQ: calls $0.25
*** SHOW DOWN ***
FJflwqC6fqOpM3j0q8Bptw: shows [Ks Qs] (a flush, Ace high)
tYsOBqdU1+x+yFI7zHO7hQ: mucks hand 
FJflwqC6fqOpM3j0q8Bptw collected $4.40 from pot
*** SUMMARY ***
Total pot $4.60 | Rake $0.20 
Board [Js 5s Kc As 6s]
Seat 2: tYsOBqdU1+x+yFI7zHO7hQ (button) mucked
Seat 3: aNpwfA31EREwO+ar4XzBCw (small blind) folded before Flop
Seat 4: FJflwqC6fqOpM3j0q8Bptw (big blind) showed [Ks Qs] and won ($4.40) with a flush, Ace high
Seat 5: 5hAPbqNrvJb8PtLiceXtlg6HoFYfVGBefsR5Vrz62qIwded before Flop (didn't bet)
Seat 6: hBMUlEpyU74r/fwDgIpXjQ folded before Flop (didn't bet)
Seat 7: opOCI2p6kW0tINuVaAqmcQ folded before Flop (didn't bet)
Seat 8: CYkY0dNBaYaKs8HVCVn3mQ folded before Flop (didn't bet)
Seat 9: ljemhp25Zg+nlA9DLCIiUw folded before Flop (didn't bet)




PokerStars Game #59939689848:  Hold'em No Limit ($0.10/$0.25) - 2009/07/01 0:46:23 ET
Table '52Meibn9NOL4XtVi1p2UpwpyZQRcpxhWj2y2cT/ydvwwx Seat #4 is the button
Seat 1: TeWJxSETzbXGiYKx0y+dtg ($26.60 in chips) 
Seat 2: Th3FldXKQW6hWVVPahaoOQ ($49.65 in chips) 
Seat 3: DgRMoUciGePff+edyvpt6g ($29.40 in chips) 
Seat 4: 8GJHzzxiotOqC5gdtgpLoA ($4.65 in chips) 
Seat 5: 4oA316mXLIui1QY63GXBUg ($25 in chips) 
Seat 6: 4awUyiDYTgylQKXZ9faBVA ($26.85 in chips) 
Seat 7: Xpyqpb+DURDWnyJ3xTEIFQ ($29.80 in chips) 
Seat 8: 18G4P1XstjNvItdGUITxgw ($25 in chips) 
4oA316mXLIui1QY63GXBUg: posts small blind $0.10
4awUyiDYTgylQKXZ9faBVA: posts big blind $0.25
*** HOLE CARDS ***
Xpyqpb+DURDWnyJ3xTEIFQ: folds 
18G4P1XstjNvItdGUITxgw: folds 
TeWJxSETzbXGiYKx0y+dtg: folds 
Th3FldXKQW6hWVVPahaoOQ: folds 
DgRMoUciGePff+edyvpt6g: calls $0.25
8GJHzzxiotOqC5gdtgpLoA: folds 
4oA316mXLIui1QY63GXBUg: folds 
4awUyiDYTgylQKXZ9faBVA: raises $0.75 to $1
DgRMoUciGePff+edyvpt6g: calls $0.75
*** FLOP *** [2c 8h Ks]
4awUyiDYTgylQKXZ9faBVA: bets $1.25
DgRMoUciGePff+edyvpt6g: folds 
Uncalled bet ($1.25) returned to 4awUyiDYTgylQKXZ9faBVA
4awUyiDYTgylQKXZ9faBVA collected $2 from pot
4awUyiDYTgylQKXZ9faBVA: doesn't show hand 
*** SUMMARY ***
Total pot $2.10 | Rake $0.10 
Board [2c 8h Ks]
Seat 1: TeWJxSETzbXGiYKx0y+dtg folded before Flop (didn't bet)
Seat 2: Th3FldXKQW6hWVVPahaoOQ folded before Flop (didn't bet)
Seat 3: DgRMoUciGePff+edyvpt6g folded on the Flop
Seat 4: 8GJHzzxiotOqC5gdtgpLoA (button) folded before Flop (didn't bet)
Seat 5: 4oA316mXLIui1QY63GXBUg (small blind) folded before Flop
Seat 6: 4awUyiDYTgylQKXZ9faBVA (big blind) collected ($2)
Seat 7: Xpyqpb+DURDWnyJ3xTEIFQ folded before Flop (didn't bet)
Seat 8: 18G4P1XstjNvItdGUITxgw folded before Flop (didn't bet)




PokerStars Game #59939689874:  Hold'em No Limit ($0.10/$0.25) - 2009/07/01 0:46:23 ET
Table 'Zi9/NqNs3XoL1eWhMCyZyg' 9-max Seat #3 is the button
Seat 1: opOCI2p6kW0tINuVaAqmcQ ($25 in chips) 
Seat 2: Th3FldXKQW6hWVVPahaoOQ ($30.70 in chips) 
Seat 3: rUpvA02nErFvZ4yFbDR8XA ($28.10 in chips) 
Seat 4: D3XCkXRktDfPlSguxwfnRA ($6 in chips) 
Seat 5: OiV1PWZ3IkN29JlmCcnTwQ ($5 in chips) 
Seat 6: b3P5tPsBbrP+aAO9+Ts/Nw ($37.10 in chips) 
Seat 7: qul+IMROTuFj45eWi2Tpvg ($54.90 in chips) 
Seat 9: tYsOBqdU1+x+yFI7zHO7hQ ($30.75 in chips) 
D3XCkXRktDfPlSguxwfnRA: posts small blind $0.10
OiV1PWZ3IkN29JlmCcnTwQ: posts big blind $0.25
MrPo4/ymXwg9lzPRybrXbA: sits out 
*** HOLE CARDS ***
b3P5tPsBbrP+aAO9+Ts/Nw: folds 
qul+IMROTuFj45eWi2Tpvg: calls $0.25
tYsOBqdU1+x+yFI7zHO7hQ: folds 
opOCI2p6kW0tINuVaAqmcQ: folds 
Th3FldXKQW6hWVVPahaoOQ: calls $0.25
rUpvA02nErFvZ4yFbDR8XA: folds 
D3XCkXRktDfPlSguxwfnRA: raises $1.25 to $1.50
OiV1PWZ3IkN29JlmCcnTwQ: folds 
qul+IMROTuFj45eWi2Tpvg: calls $1.25
Th3FldXKQW6hWVVPahaoOQ: calls $1.25
*** FLOP *** [5c 2h Ad]
D3XCkXRktDfPlSguxwfnRA: bets $1
qul+IMROTuFj45eWi2Tpvg: calls $1
Th3FldXKQW6hWVVPahaoOQ: folds 
*** TURN *** [5c 2h Ad] [Kh]
D3XCkXRktDfPlSguxwfnRA: bets $3.50 and is all-in
qul+IMROTuFj45eWi2Tpvg: calls $3.50
*** RIVER *** [5c 2h Ad Kh] [4c]
*** SHOW DOWN ***
D3XCkXRktDfPlSguxwfnRA: shows [3s 3d] (a straight, Ace to Five)
qul+IMROTuFj45eWi2Tpvg: shows [3h Th] (a straight, Ace to Five)
D3XCkXRktDfPlSguxwfnRA collected $6.55 from pot
qul+IMROTuFj45eWi2Tpvg collected $6.55 from pot
*** SUMMARY ***
Total pot $13.75 | Rake $0.65 
Board [5c 2h Ad Kh 4c]
Seat 1: opOCI2p6kW0tINuVaAqmcQ folded before Flop (didn't bet)
Seat 2: Th3FldXKQW6hWVVPahaoOQ folded on the Flop
Seat 3: rUpvA02nErFvZ4yFbDR8XA (button) folded before Flop (didn't bet)
Seat 4: D3XCkXRktDfPlSguxwfnRA (small blind) showed [3s 3d] and won ($6.55) with a straight, Ace to Five
Seat 5: OiV1PWZ3IkN29JlmCcnTwQ (big blind) folded before Flop
Seat 6: b3P5tPsBbrP+aAO9+Ts/Nw folded before Flop (didn't bet)
Seat 7: qul+IMROTuFj45eWi2Tpvg showed [3h Th] and won ($6.55) with a straight, Ace to Five
Seat 9: tYsOBqdU1+x+yFI7zHO7hQ folded before Flop (didn't bet)




PokerStars Game #59939689622:  Hold'em No Limit ($0.10/$0.25) - 2009/07/01 0:46:23 ET
Table '8TQqiBvztdoBMTFQQ4MYSA' 9-max Seat #1 is the button
Seat 1: LWN1wPrLH+695JIriXxDuw ($23.30 in chips) 
Seat 2: amD2PwT1xB7aC2k57sa7Ig ($22.20 in chips) 
Seat 3: DIBbjEYGs+TVdVgEB/4+3w ($25.15 in chips) 
Seat 4: EUMLvzDkECHBit+xa+uGjg ($22.35 in chips) 
Seat 5: vZGoOTJLQLhkPj4I+LNGig ($25 in chips) 
Seat 6: MIVCHqCqqlke0Lb0z7glcw ($37.60 in chips) 
Seat 7: STkR8XvpjNv79OOMhrlh2w ($25 in chips) 
Seat 9: SXqVW4Q0evTUVZG6BbUNIA ($42.30 in chips) 
amD2PwT1xB7aC2k57sa7Ig: posts small blind $0.10
DIBbjEYGs+TVdVgEB/4+3w: posts big blind $0.25
V6p0jQ/RhUsqpHLmXvEX4Q: sits out 
*** HOLE CARDS ***
EUMLvzDkECHBit+xa+uGjg: folds 
vZGoOTJLQLhkPj4I+LNGig: folds 
MIVCHqCqqlke0Lb0z7glcw: folds 
STkR8XvpjNv79OOMhrlh2w: calls $0.25
SXqVW4Q0evTUVZG6BbUNIA: folds 
LWN1wPrLH+695JIriXxDuw: calls $0.25
amD2PwT1xB7aC2k57sa7Ig: calls $0.15
DIBbjEYGs+TVdVgEB/4+3w: checks 
*** FLOP *** [3h 5d 6c]
amD2PwT1xB7aC2k57sa7Ig: bets $0.50
DIBbjEYGs+TVdVgEB/4+3w: folds 
STkR8XvpjNv79OOMhrlh2w: folds 
LWN1wPrLH+695JIriXxDuw: folds 
Uncalled bet ($0.50) returned to amD2PwT1xB7aC2k57sa7Ig
amD2PwT1xB7aC2k57sa7Ig collected $0.95 from pot
*** SUMMARY ***
Total pot $1 | Rake $0.05 
Board [3h 5d 6c]
Seat 1: LWN1wPrLH+695JIriXxDuw (button) folded on the Flop
Seat 2: amD2PwT1xB7aC2k57sa7Ig (small blind) collected ($0.95)
Seat 3: DIBbjEYGs+TVdVgEB/4+3w (big blind) folded on the Flop
Seat 4: EUMLvzDkECHBit+xa+uGjg folded before Flop (didn't bet)
Seat 5: vZGoOTJLQLhkPj4I+LNGig folded before Flop (didn't bet)
Seat 6: MIVCHqCqqlke0Lb0z7glcw folded before Flop (didn't bet)
Seat 7: STkR8XvpjNv79OOMhrlh2w folded on the Flop
Seat 9: SXqVW4Q0evTUVZG6BbUNIA folded before Flop (didn't bet)




PokerStars Game #59939689892:  Hold'em No Limit ($0.10/$0.25) - 2009/07/01 0:46:23 ET
Table 'ZEXL6Wh4qA4Afx8NnoBBAA' 6-max Seat #2 is the button
Seat 2: WrLI51S2iMb8GLMB83gGqA ($25 in chips) 
Seat 4: fZQg9veL7Dd/Z04ZTjC+wQ ($30.30 in chips) 
Seat 5: 9dToMv2GJLfi00HcpfMnIw ($19.75 in chips) 
Seat 6: 3rZnxe2K3O+xcVdF94i8lA ($25.30 in chips) 
pitty1199 will be allowed to play after the button
fZQg9veL7Dd/Z04ZTjC+wQ: posts small blind $0.10
9dToMv2GJLfi00HcpfMnIw: posts big blind $0.25
*** HOLE CARDS ***
aromao1234 leaves the table
3rZnxe2K3O+xcVdF94i8lA: calls $0.25
WrLI51S2iMb8GLMB83gGqA: raises $0.75 to $1
fZQg9veL7Dd/Z04ZTjC+wQ: folds 
v8m8XHovI5tqEA9mvplDSw joins the table at seat #1 
9dToMv2GJLfi00HcpfMnIw: folds 
3rZnxe2K3O+xcVdF94i8lA: calls $0.75
*** FLOP *** [9d 3s 7h]
3rZnxe2K3O+xcVdF94i8lA: bets $0.25
WrLI51S2iMb8GLMB83gGqA: raises $1.75 to $2
3rZnxe2K3O+xcVdF94i8lA: calls $1.75
*** TURN *** [9d 3s 7h] [Ad]
3rZnxe2K3O+xcVdF94i8lA: bets $0.75
WrLI51S2iMb8GLMB83gGqA: calls $0.75
*** RIVER *** [9d 3s 7h Ad] [8s]
3rZnxe2K3O+xcVdF94i8lA: bets $1.25
WrLI51S2iMb8GLMB83gGqA: raises $10.75 to $12
3rZnxe2K3O+xcVdF94i8lA: folds 
Uncalled bet ($10.75) returned to WrLI51S2iMb8GLMB83gGqA
WrLI51S2iMb8GLMB83gGqA collected $9.85 from pot
WrLI51S2iMb8GLMB83gGqA: doesn't show hand 
*** SUMMARY ***
Total pot $10.35 | Rake $0.50 
Board [9d 3s 7h Ad 8s]
Seat 2: WrLI51S2iMb8GLMB83gGqA (button) collected ($9.85)
Seat 4: fZQg9veL7Dd/Z04ZTjC+wQ (small blind) folded before Flop
Seat 5: 9dToMv2GJLfi00HcpfMnIw (big blind) folded before Flop
Seat 6: 3rZnxe2K3O+xcVdF94i8lA folded on the River




PokerStars Game #59939689824:  Hold'em No Limit ($0.10/$0.25) - 2009/07/01 0:46:23 ET
Table 'dZNBGqFYSwfOVZvDJ4VjIQ' 6-max Seat #4 is the button
Seat 1: o08wk0F4gROLhZS04Iyl3w ($27.45 in chips) 
Seat 3: Mch463E1dxQfVob352za6w ($25 in chips) 
Seat 4: df01R5ThvHspD8FgKmaDvQ ($26.95 in chips) 
Seat 6: VbudEd0ZG+qPwMO9h+hjXw ($18.95 in chips) 
pitty1199 will be allowed to play after the button
VbudEd0ZG+qPwMO9h+hjXw: posts small blind $0.10
o08wk0F4gROLhZS04Iyl3w: posts big blind $0.25
3zD3qLXT1bEffAoWGnc7wg: sits out 
*** HOLE CARDS ***
Mch463E1dxQfVob352za6w: raises $0.50 to $0.75
df01R5ThvHspD8FgKmaDvQ: folds 
VbudEd0ZG+qPwMO9h+hjXw: calls $0.65
o08wk0F4gROLhZS04Iyl3w: folds 
*** FLOP *** [3c 2h 9d]
VbudEd0ZG+qPwMO9h+hjXw: checks 
Mch463E1dxQfVob352za6w: bets $1
VbudEd0ZG+qPwMO9h+hjXw: folds 
Uncalled bet ($1) returned to Mch463E1dxQfVob352za6w
Mch463E1dxQfVob352za6w collected $1.70 from pot
Mch463E1dxQfVob352za6w: doesn't show hand 
*** SUMMARY ***
Total pot $1.75 | Rake $0.05 
Board [3c 2h 9d]
Seat 1: o08wk0F4gROLhZS04Iyl3w (big blind) folded before Flop
Seat 3: Mch463E1dxQfVob352za6w collected ($1.70)
Seat 4: df01R5ThvHspD8FgKmaDvQ (button) folded before Flop (didn't bet)
Seat 6: VbudEd0ZG+qPwMO9h+hjXw (small blind) folded on the Flop




PokerStars Game #59939690350:  Hold'em No Limit ($0.10/$0.25) - 2009/07/01 0:46:24 ET
Table '3KDMdm1sfxFsNKkjc/PnBg' 9-max Seat #5 is the button
Seat 2: rUpvA02nErFvZ4yFbDR8XA ($19.50 in chips) 
Seat 3: GftT+l+xjKzcY0rMiNZfPg ($20.75 in chips) 
Seat 4: 4xnojP+j2Tm8s9Bh7QC5+Q ($19.05 in chips) 
Seat 5: +2kMBNpY4nF1qNCRd8SJLA ($25.75 in chips) 
Seat 6: N1HHRe1nNMukTQB6qMn6Kw ($16.55 in chips) 
Seat 7: gehe91e0IyVT0QU/XBkEyg ($25 in chips) 
Seat 8: st9jtdNbm1W5GfBwRaCVqQ ($28.30 in chips) 
Seat 9: K0b5wNInj6hUGRr6yzKFtw ($30.45 in chips) 
N1HHRe1nNMukTQB6qMn6Kw: posts small blind $0.10
gehe91e0IyVT0QU/XBkEyg: posts big blind $0.25
V6p0jQ/RhUsqpHLmXvEX4Q: sits out 
*** HOLE CARDS ***
st9jtdNbm1W5GfBwRaCVqQ: folds 
K0b5wNInj6hUGRr6yzKFtw: raises $0.75 to $1
rUpvA02nErFvZ4yFbDR8XA: folds 
GftT+l+xjKzcY0rMiNZfPg: folds 
4xnojP+j2Tm8s9Bh7QC5+Q: calls $1
+2kMBNpY4nF1qNCRd8SJLA: folds 
N1HHRe1nNMukTQB6qMn6Kw: folds 
gehe91e0IyVT0QU/XBkEyg: folds 
*** FLOP *** [6d Kh 5c]
K0b5wNInj6hUGRr6yzKFtw: bets $1.25
4xnojP+j2Tm8s9Bh7QC5+Q: folds 
Uncalled bet ($1.25) returned to K0b5wNInj6hUGRr6yzKFtw
K0b5wNInj6hUGRr6yzKFtw collected $2.25 from pot
K0b5wNInj6hUGRr6yzKFtw: doesn't show hand 
*** SUMMARY ***
Total pot $2.35 | Rake $0.10 
Board [6d Kh 5c]
Seat 2: rUpvA02nErFvZ4yFbDR8XA folded before Flop (didn't bet)
Seat 3: GftT+l+xjKzcY0rMiNZfPg folded before Flop (didn't bet)
Seat 4: 4xnojP+j2Tm8s9Bh7QC5+Q folded on the Flop
Seat 5: +2kMBNpY4nF1qNCRd8SJLA (button) folded before Flop (didn't bet)
Seat 6: N1HHRe1nNMukTQB6qMn6Kw (small blind) folded before Flop
Seat 7: gehe91e0IyVT0QU/XBkEyg (big blind) folded before Flop
Seat 8: st9jtdNbm1W5GfBwRaCVqQ folded before Flop (didn't bet)
Seat 9: K0b5wNInj6hUGRr6yzKFtw collected ($2.25)




PokerStars Game #59939690486:  Hold'em No Limit ($0.10/$0.25) - 2009/07/01 0:46:24 ET
Table 'Y9EhDWuqWWQFM9SelXAj5g' 9-max Seat #1 is the button
Seat 1: zDrucyjVn5aeekNEc3cJrA ($19.10 in chips) 
Seat 2: nEg1b6MIksd/4x5eLY735g ($38.85 in chips) 
Seat 3: CbXUS6Z2rXZxL1AKduNtmQ ($25 in chips) 
Seat 4: 5MgYq10OC5iGoxQFwlJVuw ($14.30 in chips) 
Seat 6: STkR8XvpjNv79OOMhrlh2w ($28.95 in chips) 
Seat 7: aNpwfA31EREwO+ar4XzBCw ($30.25 in chips) 
Seat 8: XDxyajtqmdag0QPvwcOG7Q ($9.35 in chips) 
Seat 9: K7bAhhMMJ/XcTmGaBZVfFQ ($25.15 in chips) 
nEg1b6MIksd/4x5eLY735g: posts small blind $0.10
CbXUS6Z2rXZxL1AKduNtmQ: posts big blind $0.25
*** HOLE CARDS ***
5MgYq10OC5iGoxQFwlJVuw: folds 
STkR8XvpjNv79OOMhrlh2w: folds 
aNpwfA31EREwO+ar4XzBCw: folds 
XDxyajtqmdag0QPvwcOG7Q: folds 
K7bAhhMMJ/XcTmGaBZVfFQ: raises $0.75 to $1
zDrucyjVn5aeekNEc3cJrA: calls $1
nEg1b6MIksd/4x5eLY735g: folds 
CbXUS6Z2rXZxL1AKduNtmQ: folds 
*** FLOP *** [Td Ad 6d]
K7bAhhMMJ/XcTmGaBZVfFQ: bets $1.75
zDrucyjVn5aeekNEc3cJrA: folds 
Uncalled bet ($1.75) returned to K7bAhhMMJ/XcTmGaBZVfFQ
LY5GvFqMlE3xxbG85bDqlw has returned
K7bAhhMMJ/XcTmGaBZVfFQ collected $2.25 from pot
K7bAhhMMJ/XcTmGaBZVfFQ: doesn't show hand 
*** SUMMARY ***
Total pot $2.35 | Rake $0.10 
Board [Td Ad 6d]
Seat 1: zDrucyjVn5aeekNEc3cJrA (button) folded on the Flop
Seat 2: nEg1b6MIksd/4x5eLY735g (small blind) folded before Flop
Seat 3: CbXUS6Z2rXZxL1AKduNtmQ (big blind) folded before Flop
Seat 4: 5MgYq10OC5iGoxQFwlJVuw folded before Flop (didn't bet)
Seat 6: STkR8XvpjNv79OOMhrlh2w folded before Flop (didn't bet)
Seat 7: aNpwfA31EREwO+ar4XzBCw folded before Flop (didn't bet)
Seat 8: XDxyajtqmdag0QPvwcOG7Q folded before Flop (didn't bet)
Seat 9: K7bAhhMMJ/XcTmGaBZVfFQ collected ($2.25)




PokerStars Game #59939690396:  Hold'em No Limit ($0.10/$0.25) - 2009/07/01 0:46:24 ET
Table '3EebBlzq5yHSY2444L4zlg' 9-max Seat #6 is the button
Seat 1: 8B/dhbQjIWe6ASCdgzktNQ ($31.25 in chips) 
Seat 2: MIVCHqCqqlke0Lb0z7glcw ($24.35 in chips) 
Seat 3: IGbD5vKNhHe60dkdbjg/mw ($22.35 in chips) 
Seat 4: 1S/fpm+f42V/6MNZre+ccg ($25.10 in chips) 
Seat 5: 22Ph+hChb2fjC5+yk/mOew ($24.75 in chips) 
Seat 6: QEbIGci+itdw+re8RM5fZA ($27.80 in chips) 
Seat 7: DiSvPC2iudwL5j9u6Huyww ($27.65 in chips) 
Seat 8: j97ZRZFRWNUsBUL7hv78tA ($14.65 in chips) 
Seat 9: GTcLfsDTPqgfHyhY9FNDMw ($10.65 in chips) 
DiSvPC2iudwL5j9u6Huyww: posts small blind $0.10
j97ZRZFRWNUsBUL7hv78tA: posts big blind $0.25
*** HOLE CARDS ***
GTcLfsDTPqgfHyhY9FNDMw: folds 
8B/dhbQjIWe6ASCdgzktNQ: folds 
MIVCHqCqqlke0Lb0z7glcw: folds 
IGbD5vKNhHe60dkdbjg/mw: folds 
1S/fpm+f42V/6MNZre+ccg: folds 
22Ph+hChb2fjC5+yk/mOew: folds 
QEbIGci+itdw+re8RM5fZA: folds 
DiSvPC2iudwL5j9u6Huyww: folds 
Uncalled bet ($0.15) returned to j97ZRZFRWNUsBUL7hv78tA
j97ZRZFRWNUsBUL7hv78tA collected $0.20 from pot
*** SUMMARY ***
Total pot $0.20 | Rake $0 
Seat 1: 8B/dhbQjIWe6ASCdgzktNQ folded before Flop (didn't bet)
Seat 2: MIVCHqCqqlke0Lb0z7glcw folded before Flop (didn't bet)
Seat 3: IGbD5vKNhHe60dkdbjg/mw folded before Flop (didn't bet)
Seat 4: 1S/fpm+f42V/6MNZre+ccg folded before Flop (didn't bet)
Seat 5: 22Ph+hChb2fjC5+yk/mOew folded before Flop (didn't bet)
Seat 6: QEbIGci+itdw+re8RM5fZA (button) folded before Flop (didn't bet)
Seat 7: DiSvPC2iudwL5j9u6Huyww (small blind) folded before Flop
Seat 8: j97ZRZFRWNUsBUL7hv78tA (big blind) collected ($0.20)
Seat 9: GTcLfsDTPqgfHyhY9FNDMw folded before Flop (didn't bet)




PokerStars Game #59939690406:  Hold'em No Limit ($0.10/$0.25) - 2009/07/01 0:46:24 ET
Table 'T/iCKJXGphRN3xcdwfE/JQ' 6-max Seat #5 is the button
Seat 1: zZ8zH49EwNs0mqgppOaL9g ($24.50 in chips) 
Seat 2: 6qsh9pnysDKJNhfFhFmKRQ ($8.40 in chips) 
Seat 3: R6AGToFJQOYVZAjC2jXEKw ($25.70 in chips) 
Seat 4: yzFNNFIfC89bBPwpFPx2ow ($57.80 in chips) 
Seat 5: DzdrMZ6l84e65/zfW+2bcA ($5.55 in chips) 
Seat 6: jKYGBgexhqKT13Xana4EHg ($14.05 in chips) 
jKYGBgexhqKT13Xana4EHg: posts small blind $0.10
zZ8zH49EwNs0mqgppOaL9g: posts big blind $0.25
*** HOLE CARDS ***
6qsh9pnysDKJNhfFhFmKRQ: calls $0.25
R6AGToFJQOYVZAjC2jXEKw: raises $0.75 to $1
yzFNNFIfC89bBPwpFPx2ow: folds 
DzdrMZ6l84e65/zfW+2bcA: folds 
jKYGBgexhqKT13Xana4EHg: folds 
zZ8zH49EwNs0mqgppOaL9g: folds 
6qsh9pnysDKJNhfFhFmKRQ: calls $0.75
*** FLOP *** [6c 8h Jd]
6qsh9pnysDKJNhfFhFmKRQ: checks 
R6AGToFJQOYVZAjC2jXEKw: bets $1.75
6qsh9pnysDKJNhfFhFmKRQ: calls $1.75
*** TURN *** [6c 8h Jd] [2c]
6qsh9pnysDKJNhfFhFmKRQ: checks 
R6AGToFJQOYVZAjC2jXEKw: checks 
*** RIVER *** [6c 8h Jd 2c] [Js]
6qsh9pnysDKJNhfFhFmKRQ: checks 
R6AGToFJQOYVZAjC2jXEKw: bets $3
6qsh9pnysDKJNhfFhFmKRQ: raises $2.65 to $5.65 and is all-in
R6AGToFJQOYVZAjC2jXEKw: folds 
Uncalled bet ($2.65) returned to 6qsh9pnysDKJNhfFhFmKRQ
6qsh9pnysDKJNhfFhFmKRQ collected $11.30 from pot
*** SUMMARY ***
Total pot $11.85 | Rake $0.55 
Board [6c 8h Jd 2c Js]
Seat 1: zZ8zH49EwNs0mqgppOaL9g (big blind) folded before Flop
Seat 2: 6qsh9pnysDKJNhfFhFmKRQ collected ($11.30)
Seat 3: R6AGToFJQOYVZAjC2jXEKw folded on the River
Seat 4: yzFNNFIfC89bBPwpFPx2ow folded before Flop (didn't bet)
Seat 5: DzdrMZ6l84e65/zfW+2bcA (button) folded before Flop (didn't bet)
Seat 6: jKYGBgexhqKT13Xana4EHg (small blind) folded before Flop




PokerStars Game #59939691356:  Hold'em No Limit ($0.10/$0.25) - 2009/07/01 0:46:25 ET
Table 'oxYpQNT8OHNCvpMIFi7UoA' 9-max Seat #1 is the button
Seat 1: H5Se03ZqSX7tbULXur2MAg ($24.65 in chips) 
Seat 2: Ofo77cVa49gHqAMfHrrMbw ($12.35 in chips) 
Seat 3: DBWHFmM+iV/PrUG8xKBQ7w ($8.90 in chips) 
Seat 4: ghNKXUBl/H+t83JF079ZBA ($25 in chips) 
Seat 5: SXqVW4Q0evTUVZG6BbUNIA ($34.15 in chips) 
Seat 6: +2kMBNpY4nF1qNCRd8SJLA ($25 in chips) 
Seat 7: yyG4svzOpC1A+sUP/scg6w ($7.95 in chips) 
Seat 8: OlPJsgR4xypSg/w1z7Gyvw ($19.20 in chips) 
Seat 9: KK7jFoJo1TzDCPdsfpPjtw ($41.15 in chips) 
Ofo77cVa49gHqAMfHrrMbw: posts small blind $0.10
DBWHFmM+iV/PrUG8xKBQ7w: posts big blind $0.25
*** HOLE CARDS ***
ghNKXUBl/H+t83JF079ZBA: folds 
SXqVW4Q0evTUVZG6BbUNIA: folds 
+2kMBNpY4nF1qNCRd8SJLA: folds 
yyG4svzOpC1A+sUP/scg6w: raises $0.50 to $0.75
OlPJsgR4xypSg/w1z7Gyvw: folds 
KK7jFoJo1TzDCPdsfpPjtw: folds 
H5Se03ZqSX7tbULXur2MAg: folds 
Ofo77cVa49gHqAMfHrrMbw: folds 
DBWHFmM+iV/PrUG8xKBQ7w: folds 
Uncalled bet ($0.50) returned to yyG4svzOpC1A+sUP/scg6w
yyG4svzOpC1A+sUP/scg6w collected $0.60 from pot
*** SUMMARY ***
Total pot $0.60 | Rake $0 
Seat 1: H5Se03ZqSX7tbULXur2MAg (button) folded before Flop (didn't bet)
Seat 2: Ofo77cVa49gHqAMfHrrMbw (small blind) folded before Flop
Seat 3: DBWHFmM+iV/PrUG8xKBQ7w (big blind) folded before Flop
Seat 4: ghNKXUBl/H+t83JF079ZBA folded before Flop (didn't bet)
Seat 5: SXqVW4Q0evTUVZG6BbUNIA folded before Flop (didn't bet)
Seat 6: +2kMBNpY4nF1qNCRd8SJLA folded before Flop (didn't bet)
Seat 7: yyG4svzOpC1A+sUP/scg6w collected ($0.60)
Seat 8: OlPJsgR4xypSg/w1z7Gyvw folded before Flop (didn't bet)
Seat 9: KK7jFoJo1TzDCPdsfpPjtw folded before Flop (didn't bet)




PokerStars Game #59939691460:  Hold'em No Limit ($0.10/$0.25) - 2009/07/01 0:46:25 ET
Table 'ohAuixfiLOYDylNUG5mNUw' 9-max Seat #3 is the button
Seat 1: AtRN1hdV8HbL3X4XogDaLA ($38.55 in chips) 
Seat 2: yVwP/Nr5oXkAQp5dmdNUVQ ($25 in chips) 
Seat 3: HVKi9hnDyvzObpL08/OarQ ($25.90 in chips) 
Seat 4: jeKWRUkMaVn8rEUjnJKqpg ($25.10 in chips) 
Seat 5: wub1jsnHlpWmOX4uczVADA ($9.75 in chips) 
Seat 6: opOCI2p6kW0tINuVaAqmcQ ($25.60 in chips) 
Seat 8: ppMlNkhYgErlt4fuJO7ADA ($9.50 in chips) 
Seat 9: hIss79a4pu7GzJZepfgOpg ($25 in chips) 
jeKWRUkMaVn8rEUjnJKqpg: posts small blind $0.10
wub1jsnHlpWmOX4uczVADA: posts big blind $0.25
aPRz/2GxbXANYpVsQO8pdQ: sits out 
*** HOLE CARDS ***
opOCI2p6kW0tINuVaAqmcQ: folds 
ppMlNkhYgErlt4fuJO7ADA: calls $0.25
hIss79a4pu7GzJZepfgOpg: folds 
AtRN1hdV8HbL3X4XogDaLA: folds 
yVwP/Nr5oXkAQp5dmdNUVQ: folds 
HVKi9hnDyvzObpL08/OarQ: folds 
jeKWRUkMaVn8rEUjnJKqpg: folds 
wub1jsnHlpWmOX4uczVADA: checks 
*** FLOP *** [Qh 2c 6s]
wub1jsnHlpWmOX4uczVADA: checks 
ppMlNkhYgErlt4fuJO7ADA: bets $0.50
wub1jsnHlpWmOX4uczVADA: folds 
Uncalled bet ($0.50) returned to ppMlNkhYgErlt4fuJO7ADA
ppMlNkhYgErlt4fuJO7ADA collected $0.60 from pot
ppMlNkhYgErlt4fuJO7ADA: doesn't show hand 
*** SUMMARY ***
Total pot $0.60 | Rake $0 
Board [Qh 2c 6s]
Seat 1: AtRN1hdV8HbL3X4XogDaLA folded before Flop (didn't bet)
Seat 2: yVwP/Nr5oXkAQp5dmdNUVQ folded before Flop (didn't bet)
Seat 3: HVKi9hnDyvzObpL08/OarQ (button) folded before Flop (didn't bet)
Seat 4: jeKWRUkMaVn8rEUjnJKqpg (small blind) folded before Flop
Seat 5: wub1jsnHlpWmOX4uczVADA (big blind) folded on the Flop
Seat 6: opOCI2p6kW0tINuVaAqmcQ folded before Flop (didn't bet)
Seat 8: ppMlNkhYgErlt4fuJO7ADA collected ($0.60)
Seat 9: hIss79a4pu7GzJZepfgOpg folded before Flop (didn't bet)




PokerStars Game #59939692068:  Hold'em No Limit ($0.10/$0.25) - 2009/07/01 0:46:26 ET
Table 'n8mNkPYbe1AIQEkioNesZA' 9-max Seat #7 is the button
Seat 1: /VQLorsEOrMfI+KamzNQEA ($2.40 in chips) 
Seat 2: QEbIGci+itdw+re8RM5fZA ($35 in chips) 
Seat 3: zDrucyjVn5aeekNEc3cJrA ($19.70 in chips) 
Seat 5: j5kXXioAn7mKbcDKt4UzMw ($19.35 in chips) 
Seat 6: HPEB+AtKw1+C/cxU0o1ciw ($37 in chips) 
Seat 7: BrlfhE2AlcawLAz+eF5BDg ($4.60 in chips) 
Seat 8: N6fYvIzQLKaydFLKQGtMlQ ($27.15 in chips) 
Seat 9: gehe91e0IyVT0QU/XBkEyg ($28.50 in chips) 
N6fYvIzQLKaydFLKQGtMlQ: posts small blind $0.10
gehe91e0IyVT0QU/XBkEyg: posts big blind $0.25
*** HOLE CARDS ***
/VQLorsEOrMfI+KamzNQEA: folds 
QEbIGci+itdw+re8RM5fZA: folds 
zDrucyjVn5aeekNEc3cJrA: folds 
j5kXXioAn7mKbcDKt4UzMw: calls $0.25
HPEB+AtKw1+C/cxU0o1ciw: folds 
BrlfhE2AlcawLAz+eF5BDg: folds 
N6fYvIzQLKaydFLKQGtMlQ: calls $0.15
gehe91e0IyVT0QU/XBkEyg: checks 
*** FLOP *** [4c 7d 3h]
N6fYvIzQLKaydFLKQGtMlQ: checks 
gehe91e0IyVT0QU/XBkEyg: checks 
j5kXXioAn7mKbcDKt4UzMw: bets $0.25
N6fYvIzQLKaydFLKQGtMlQ: calls $0.25
gehe91e0IyVT0QU/XBkEyg: folds 
*** TURN *** [4c 7d 3h] [7h]
N6fYvIzQLKaydFLKQGtMlQ: checks 
j5kXXioAn7mKbcDKt4UzMw: bets $0.75
N6fYvIzQLKaydFLKQGtMlQ: calls $0.75
*** RIVER *** [4c 7d 3h 7h] [9s]
N6fYvIzQLKaydFLKQGtMlQ: checks 
j5kXXioAn7mKbcDKt4UzMw: checks 
*** SHOW DOWN ***
N6fYvIzQLKaydFLKQGtMlQ: shows [8h 6h] (a pair of Sevens)
j5kXXioAn7mKbcDKt4UzMw: shows [5c 5d] (two pair, Sevens and Fives)
j5kXXioAn7mKbcDKt4UzMw collected $2.65 from pot
*** SUMMARY ***
Total pot $2.75 | Rake $0.10 
Board [4c 7d 3h 7h 9s]
Seat 1: /VQLorsEOrMfI+KamzNQEA folded before Flop (didn't bet)
Seat 2: QEbIGci+itdw+re8RM5fZA folded before Flop (didn't bet)
Seat 3: zDrucyjVn5aeekNEc3cJrA folded before Flop (didn't bet)
Seat 5: j5kXXioAn7mKbcDKt4UzMw showed [5c 5d] and won ($2.65) with two pair, Sevens and Fives
Seat 6: HPEB+AtKw1+C/cxU0o1ciw folded before Flop (didn't bet)
Seat 7: BrlfhE2AlcawLAz+eF5BDg (button) folded before Flop (didn't bet)
Seat 8: N6fYvIzQLKaydFLKQGtMlQ (small blind) showed [8h 6h] and lost with a pair of Sevens
Seat 9: gehe91e0IyVT0QU/XBkEyg (big blind) folded on the Flop




PokerStars Game #59939691990:  Hold'em No Limit ($0.10/$0.25) - 2009/07/01 0:46:26 ET
Table 'a6FCGVBMPcT7J7BDN9q1zQ' 9-max Seat #6 is the button
Seat 1: s7Q6uNouhe7aE8JdFb9E+A ($44.10 in chips) 
Seat 2: h4ggJZYBXV0mEZzYPYKfeA ($34 in chips) 
Seat 3: hIss79a4pu7GzJZepfgOpg ($28.75 in chips) 
Seat 4: ydoFOVgzvZv9ZhuWu9rXAw ($5.50 in chips) 
Seat 6: Z9AeOQX3yzuSvKAm/xyovg ($9.30 in chips) 
Seat 7: V0Yo5zRBVM8DYspLKafebg ($28.05 in chips) 
Seat 8: r6hsffOo1iKmaPYKwAZmFw ($50.10 in chips) 
Seat 9: WwcXelmo9g129XJixVb2NA ($15.85 in chips) 
V0Yo5zRBVM8DYspLKafebg: posts small blind $0.10
r6hsffOo1iKmaPYKwAZmFw: posts big blind $0.25
*** HOLE CARDS ***
WwcXelmo9g129XJixVb2NA: folds 
LonePenquin leaves the table
s7Q6uNouhe7aE8JdFb9E+A: folds 
dtZ84flFEi4Q+SGrHMJRDQ joins the table at seat #5 
h4ggJZYBXV0mEZzYPYKfeA: folds 
hIss79a4pu7GzJZepfgOpg: folds 
ydoFOVgzvZv9ZhuWu9rXAw: folds 
Z9AeOQX3yzuSvKAm/xyovg: folds 
V0Yo5zRBVM8DYspLKafebg: calls $0.15
r6hsffOo1iKmaPYKwAZmFw: checks 
*** FLOP *** [Ah 4h Td]
V0Yo5zRBVM8DYspLKafebg: bets $1.50
r6hsffOo1iKmaPYKwAZmFw: folds 
Uncalled bet ($1.50) returned to V0Yo5zRBVM8DYspLKafebg
V0Yo5zRBVM8DYspLKafebg collected $0.50 from pot
*** SUMMARY ***
Total pot $0.50 | Rake $0 
Board [Ah 4h Td]
Seat 1: s7Q6uNouhe7aE8JdFb9E+A folded before Flop (didn't bet)
Seat 2: h4ggJZYBXV0mEZzYPYKfeA folded before Flop (didn't bet)
Seat 3: hIss79a4pu7GzJZepfgOpg folded before Flop (didn't bet)
Seat 4: ydoFOVgzvZv9ZhuWu9rXAw folded before Flop (didn't bet)
Seat 6: Z9AeOQX3yzuSvKAm/xyovg (button) folded before Flop (didn't bet)
Seat 7: V0Yo5zRBVM8DYspLKafebg (small blind) collected ($0.50)
Seat 8: r6hsffOo1iKmaPYKwAZmFw (big blind) folded on the Flop
Seat 9: WwcXelmo9g129XJixVb2NA folded before Flop (didn't bet)




PokerStars Game #59939691680:  Hold'em No Limit ($0.10/$0.25) - 2009/07/01 0:46:26 ET
Table 'Rv0EYnRU8WwZiwx0Zo3X3w' 9-max Seat #8 is the button
Seat 1: opOCI2p6kW0tINuVaAqmcQ ($52.95 in chips) 
Seat 2: Xpyqpb+DURDWnyJ3xTEIFQ ($28.75 in chips) 
Seat 3: STkR8XvpjNv79OOMhrlh2w ($25.60 in chips) 
Seat 4: IDkfbfxTm9KJ+DMyGVH8rw ($12.25 in chips) 
Seat 5: h4ggJZYBXV0mEZzYPYKfeA ($21.80 in chips) 
Seat 6: 5hAPbqNrvJb8PtLiceXtlg ($14.65 in chips) 
Seat 7: Th3FldXKQW6hWVVPahaoOQ ($38.50 in chips) 
Seat 8: 10vzP4r6ldwGLbYHKd9www ($13.65 in chips) 
Seat 9: r1pFKMwWp74QwhfPWJOAyw ($6.35 in chips) 
r1pFKMwWp74QwhfPWJOAyw: posts small blind $0.10
opOCI2p6kW0tINuVaAqmcQ: posts big blind $0.25
*** HOLE CARDS ***
Xpyqpb+DURDWnyJ3xTEIFQ: folds 
STkR8XvpjNv79OOMhrlh2w: folds 
IDkfbfxTm9KJ+DMyGVH8rw: folds 
h4ggJZYBXV0mEZzYPYKfeA: folds 
5hAPbqNrvJb8PtLiceXtlg: calls $0.25
Th3FldXKQW6hWVVPahaoOQ: folds 
10vzP4r6ldwGLbYHKd9www: calls $0.25
r1pFKMwWp74QwhfPWJOAyw: raises $0.25 to $0.50
opOCI2p6kW0tINuVaAqmcQ: folds 
5hAPbqNrvJb8PtLiceXtlg: calls $0.25
10vzP4r6ldwGLbYHKd9www: calls $0.25
*** FLOP *** [Th Qd Js]
r1pFKMwWp74QwhfPWJOAyw: bets $0.75
5hAPbqNrvJb8PtLiceXtlg: folds 
10vzP4r6ldwGLbYHKd9www: calls $0.75
*** TURN *** [Th Qd Js] [Jh]
r1pFKMwWp74QwhfPWJOAyw: bets $0.50
10vzP4r6ldwGLbYHKd9www: calls $0.50
*** RIVER *** [Th Qd Js Jh] [4s]
r1pFKMwWp74QwhfPWJOAyw: checks 
10vzP4r6ldwGLbYHKd9www: bets $0.75
r1pFKMwWp74QwhfPWJOAyw: calls $0.75
*** SHOW DOWN ***
10vzP4r6ldwGLbYHKd9www: shows [9s Jc] (three of a kind, Jacks)
r1pFKMwWp74QwhfPWJOAyw: mucks hand 
10vzP4r6ldwGLbYHKd9www collected $5.50 from pot
*** SUMMARY ***
Total pot $5.75 | Rake $0.25 
Board [Th Qd Js Jh 4s]
Seat 1: opOCI2p6kW0tINuVaAqmcQ (big blind) folded before Flop
Seat 2: Xpyqpb+DURDWnyJ3xTEIFQ folded before Flop (didn't bet)
Seat 3: STkR8XvpjNv79OOMhrlh2w folded before Flop (didn't bet)
Seat 4: IDkfbfxTm9KJ+DMyGVH8rw folded before Flop (didn't bet)
Seat 5: h4ggJZYBXV0mEZzYPYKfeA folded before Flop (didn't bet)
Seat 6: 5hAPbqNrvJb8PtLiceXtlg folded on the Flop
Seat 7: Th3FldXKQW6hWVVPahaoOQ folded before Flop (didn't bet)
Seat 8: 10vzP4r6ldwGLbYHKd9www (button) showed [9s Jc] and won ($5.50) with three of a kind, Jacks
Seat 9: r1pFKMwWp74QwhfPWJOAyw (small blind) mucked




PokerStars Game #59939691612:  Hold'em No Limit ($0.10/$0.25) - 2009/07/01 0:46:26 ET
Table 'IRgQPZVA4+IaZZIQshgwyg' 6-max Seat #1 is the button
Seat 1: d0J1xuhsynEY81YHwAvJ5g ($25 in chips) 
Seat 2: 9jSiy0meE9XJKkdIZwyTEQ ($35.20 in chips) 
Seat 3: 8EEqTTh7T1q48sYDqbI2Xg ($29.45 in chips) 
Seat 4: PXXRy0uk7WED5BEf+ReJDQ ($12.90 in chips) 
Seat 5: PbMzPZIePKifKQZfKDkbIw ($27.95 in chips) 
aromao1234 leaves the table
9jSiy0meE9XJKkdIZwyTEQ: posts small blind $0.10
8EEqTTh7T1q48sYDqbI2Xg: posts big blind $0.25
*** HOLE CARDS ***
PXXRy0uk7WED5BEf+ReJDQ: calls $0.25
PbMzPZIePKifKQZfKDkbIw: folds 
d0J1xuhsynEY81YHwAvJ5g: folds 
9jSiy0meE9XJKkdIZwyTEQ: folds 
8EEqTTh7T1q48sYDqbI2Xg: checks 
*** FLOP *** [Ac 6c As]
8EEqTTh7T1q48sYDqbI2Xg: checks 
PXXRy0uk7WED5BEf+ReJDQ: checks 
*** TURN *** [Ac 6c As] [Ah]
8EEqTTh7T1q48sYDqbI2Xg: checks 
PXXRy0uk7WED5BEf+ReJDQ: bets $0.25
8EEqTTh7T1q48sYDqbI2Xg: folds 
Uncalled bet ($0.25) returned to PXXRy0uk7WED5BEf+ReJDQ
PXXRy0uk7WED5BEf+ReJDQ collected $0.60 from pot
PXXRy0uk7WED5BEf+ReJDQ: doesn't show hand 
*** SUMMARY ***
Total pot $0.60 | Rake $0 
Board [Ac 6c As Ah]
Seat 1: d0J1xuhsynEY81YHwAvJ5g (button) folded before Flop (didn't bet)
Seat 2: 9jSiy0meE9XJKkdIZwyTEQ (small blind) folded before Flop
Seat 3: 8EEqTTh7T1q48sYDqbI2Xg (big blind) folded on the Turn
Seat 4: PXXRy0uk7WED5BEf+ReJDQ collected ($0.60)
Seat 5: PbMzPZIePKifKQZfKDkbIw folded before Flop (didn't bet)




PokerStars Game #59939691948:  Hold'em No Limit ($0.10/$0.25) - 2009/07/01 0:46:26 ET
Table 'qInMnOOn7vKcj4bU7zju7g' 9-max Seat #6 is the button
Seat 2: f/H6PsHRl4W1JyNsEDvPtg ($9.15 in chips) 
Seat 3: zDrucyjVn5aeekNEc3cJrA ($28.15 in chips) 
Seat 4: ZbKV588BRlpe7vF42jT9yg ($9.30 in chips) 
Seat 5: aNpwfA31EREwO+ar4XzBCw ($39.75 in chips) 
Seat 6: r1pFKMwWp74QwhfPWJOAyw ($9.75 in chips) 
Seat 7: 8B/dhbQjIWe6ASCdgzktNQ ($26.70 in chips) 
Seat 9: K7bAhhMMJ/XcTmGaBZVfFQ ($24 in chips) 
8B/dhbQjIWe6ASCdgzktNQ: posts small blind $0.10
K7bAhhMMJ/XcTmGaBZVfFQ: posts big blind $0.25
*** HOLE CARDS ***
f/H6PsHRl4W1JyNsEDvPtg: calls $0.25
zDrucyjVn5aeekNEc3cJrA: folds 
ZbKV588BRlpe7vF42jT9yg: folds 
aNpwfA31EREwO+ar4XzBCw: raises $1 to $1.25
r1pFKMwWp74QwhfPWJOAyw: folds 
8B/dhbQjIWe6ASCdgzktNQ: folds 
K7bAhhMMJ/XcTmGaBZVfFQ: folds 
f/H6PsHRl4W1JyNsEDvPtg: folds 
Uncalled bet ($1) returned to aNpwfA31EREwO+ar4XzBCw
aNpwfA31EREwO+ar4XzBCw collected $0.85 from pot
aNpwfA31EREwO+ar4XzBCw: doesn't show hand 
*** SUMMARY ***
Total pot $0.85 | Rake $0 
Seat 2: f/H6PsHRl4W1JyNsEDvPtg folded before Flop
Seat 3: zDrucyjVn5aeekNEc3cJrA folded before Flop (didn't bet)
Seat 4: ZbKV588BRlpe7vF42jT9yg folded before Flop (didn't bet)
Seat 5: aNpwfA31EREwO+ar4XzBCw collected ($0.85)
Seat 6: r1pFKMwWp74QwhfPWJOAyw (button) folded before Flop (didn't bet)
Seat 7: 8B/dhbQjIWe6ASCdgzktNQ (small blind) folded before Flop
Seat 9: K7bAhhMMJ/XcTmGaBZVfFQ (big blind) folded before Flop




PokerStars Game #59939692522:  Hold'em No Limit ($0.10/$0.25) - 2009/07/01 0:46:27 ET
Table '5510FxlYzKi+U6MIpo8IPA' 6-max Seat #6 is the button
Seat 1: KM6ogk7SqyRlk3m9b0h+7A ($20.40 in chips) 
Seat 2: gqW2aBCmrIw65BvwjTFN6Q ($25 in chips) 
Seat 3: v+QfkGiuj9bgtuNoVnDO8w ($33.90 in chips) 
Seat 4: cPO/1/dTcZpLkQFm3jH3Rg ($27.20 in chips) 
Seat 5: 5E1iMY5xyboow7Xm0v7Idw ($7.45 in chips) 
Seat 6: SFmT9ZsVopnukjvAzrxTRg ($29.90 in chips) 
KM6ogk7SqyRlk3m9b0h+7A: posts small blind $0.10
gqW2aBCmrIw65BvwjTFN6Q: posts big blind $0.25
*** HOLE CARDS ***
v+QfkGiuj9bgtuNoVnDO8w: folds 
cPO/1/dTcZpLkQFm3jH3Rg: folds 
5E1iMY5xyboow7Xm0v7Idw: raises $0.50 to $0.75
SFmT9ZsVopnukjvAzrxTRg: folds 
KM6ogk7SqyRlk3m9b0h+7A: folds 
gqW2aBCmrIw65BvwjTFN6Q: folds 
Uncalled bet ($0.50) returned to 5E1iMY5xyboow7Xm0v7Idw
5E1iMY5xyboow7Xm0v7Idw collected $0.60 from pot
5E1iMY5xyboow7Xm0v7Idw: doesn't show hand 
*** SUMMARY ***
Total pot $0.60 | Rake $0 
Seat 1: KM6ogk7SqyRlk3m9b0h+7A (small blind) folded before Flop
Seat 2: gqW2aBCmrIw65BvwjTFN6Q (big blind) folded before Flop
Seat 3: v+QfkGiuj9bgtuNoVnDO8w folded before Flop (didn't bet)
Seat 4: cPO/1/dTcZpLkQFm3jH3Rg folded before Flop (didn't bet)
Seat 5: 5E1iMY5xyboow7Xm0v7Idw collected ($0.60)
Seat 6: SFmT9ZsVopnukjvAzrxTRg (button) folded before Flop (didn't bet)




PokerStars Game #59939692784:  Hold'em No Limit ($0.10/$0.25) - 2009/07/01 0:46:27 ET
Table 'mNBkqbHtjDvzF6YU0ixV9Q' 9-max Seat #6 is the button
Seat 1: QsLvCwfSWqP+CfjwUnjpXQ ($16.60 in chips) 
Seat 6: Zb8xGmbjS8ghABxs9n6huA ($11.75 in chips) 
Zb8xGmbjS8ghABxs9n6huA: posts small blind $0.10
QsLvCwfSWqP+CfjwUnjpXQ: posts big blind $0.25
*** HOLE CARDS ***
Zb8xGmbjS8ghABxs9n6huA: raises $0.50 to $0.75
NZlEzoTKHCxRJwJ71iDzeA joins the table at seat #4 
QsLvCwfSWqP+CfjwUnjpXQ: folds 
Uncalled bet ($0.50) returned to Zb8xGmbjS8ghABxs9n6huA
Zb8xGmbjS8ghABxs9n6huA collected $0.50 from pot
*** SUMMARY ***
Total pot $0.50 | Rake $0 
Seat 1: QsLvCwfSWqP+CfjwUnjpXQ (big blind) folded before Flop
Seat 6: Zb8xGmbjS8ghABxs9n6huA (button) (small blind) collected ($0.50)




PokerStars Game #59939692624:  Hold'em No Limit ($0.10/$0.25) - 2009/07/01 0:46:27 ET
Table 'yZgGBnUGXVCcEJdcqes8tw' 9-max Seat #6 is the button
Seat 1: SXqVW4Q0evTUVZG6BbUNIA ($23.70 in chips) 
Seat 2: MG90wfSJZnOejs/KD3vlQQ ($25 in chips) 
Seat 3: z5GxcHlYz/GSz6W2uFiTtg ($26.65 in chips) 
Seat 4: opOCI2p6kW0tINuVaAqmcQ ($25.35 in chips) 
Seat 5: IGz29GAFM1DpSdXX+wXg3g ($18.30 in chips) 
Seat 6: H9i0g723A2AKb4nSMXqMPQ ($20.15 in chips) 
Seat 7: eC8Pn1D6Y2pct8o62nQfvQ ($27.80 in chips) 
Seat 9: M/9j4wkHH9i1JM51vgi1VA ($29.60 in chips) 
eC8Pn1D6Y2pct8o62nQfvQ: posts small blind $0.10
dmYlc+1cjwZMJ7wV+Z0rRg: is sitting out 
M/9j4wkHH9i1JM51vgi1VA: posts big blind $0.25
*** HOLE CARDS ***
SXqVW4Q0evTUVZG6BbUNIA: folds 
MG90wfSJZnOejs/KD3vlQQ: folds 
dmYlc+1cjwZMJ7wV+Z0rRg leaves the table
z5GxcHlYz/GSz6W2uFiTtg: calls $0.25
opOCI2p6kW0tINuVaAqmcQ: raises $0.50 to $0.75
IGz29GAFM1DpSdXX+wXg3g: calls $0.75
H9i0g723A2AKb4nSMXqMPQ: calls $0.75
eC8Pn1D6Y2pct8o62nQfvQ: folds 
M/9j4wkHH9i1JM51vgi1VA: folds 
dtZ84flFEi4Q+SGrHMJRDQ joins the table at seat #8 
z5GxcHlYz/GSz6W2uFiTtg: calls $0.50
*** FLOP *** [3s 5h 4d]
z5GxcHlYz/GSz6W2uFiTtg: bets $0.50
opOCI2p6kW0tINuVaAqmcQ: calls $0.50
IGz29GAFM1DpSdXX+wXg3g: folds 
H9i0g723A2AKb4nSMXqMPQ: calls $0.50
*** TURN *** [3s 5h 4d] [Ad]
z5GxcHlYz/GSz6W2uFiTtg: checks 
opOCI2p6kW0tINuVaAqmcQ: bets $3
H9i0g723A2AKb4nSMXqMPQ: calls $3
z5GxcHlYz/GSz6W2uFiTtg: folds 
*** RIVER *** [3s 5h 4d Ad] [3c]
opOCI2p6kW0tINuVaAqmcQ: bets $4
H9i0g723A2AKb4nSMXqMPQ: calls $4
*** SHOW DOWN ***
opOCI2p6kW0tINuVaAqmcQ: shows [2s 2h] (a straight, Ace to Five)
H9i0g723A2AKb4nSMXqMPQ: mucks hand 
opOCI2p6kW0tINuVaAqmcQ collected $17.95 from pot
*** SUMMARY ***
Total pot $18.85 | Rake $0.90 
Board [3s 5h 4d Ad 3c]
Seat 1: SXqVW4Q0evTUVZG6BbUNIA folded before Flop (didn't bet)
Seat 2: MG90wfSJZnOejs/KD3vlQQ folded before Flop (didn't bet)
Seat 3: z5GxcHlYz/GSz6W2uFiTtg folded on the Turn
Seat 4: opOCI2p6kW0tINuVaAqmcQ showed [2s 2h] and won ($17.95) with a straight, Ace to Five
Seat 5: IGz29GAFM1DpSdXX+wXg3g folded on the Flop
Seat 6: H9i0g723A2AKb4nSMXqMPQ (button) mucked
Seat 7: eC8Pn1D6Y2pct8o62nQfvQ (small blind) folded before Flop
Seat 9: M/9j4wkHH9i1JM51vgi1VA (big blind) folded before Flop




PokerStars Game #59939693018:  Hold'em No Limit ($0.10/$0.25) - 2009/07/01 0:46:28 ET
Table 'KYX9dFNuOA9l2PV46IebqQ' 9-max Seat #6 is the button
Seat 1: s7Q6uNouhe7aE8JdFb9E+A ($27.40 in chips) 
Seat 3: f+H1PHwj9cNu4Y6FfvKwQQ ($29.35 in chips) 
Seat 4: SkLOm0UugROBRt2EfMpOxQ ($25 in chips) 
Seat 5: HQMjiff9S04k8kyC4fHVgw ($3.65 in chips) 
Seat 6: DiSvPC2iudwL5j9u6Huyww ($25 in chips) 
Seat 7: QOyn4M230Dsb5atoXgDy9A ($13.15 in chips) 
Seat 8: 4oA316mXLIui1QY63GXBUg ($25 in chips) 
Seat 9: W4TLQcZ2TiM73eIgpIvlGg ($34.90 in chips) 
QOyn4M230Dsb5atoXgDy9A: posts small blind $0.10
4oA316mXLIui1QY63GXBUg: posts big blind $0.25
MrPo4/ymXwg9lzPRybrXbA: sits out 
*** HOLE CARDS ***
W4TLQcZ2TiM73eIgpIvlGg: folds 
s7Q6uNouhe7aE8JdFb9E+A: folds 
f+H1PHwj9cNu4Y6FfvKwQQ: folds 
SkLOm0UugROBRt2EfMpOxQ: raises $0.50 to $0.75
HQMjiff9S04k8kyC4fHVgw: folds 
DiSvPC2iudwL5j9u6Huyww: folds 
QOyn4M230Dsb5atoXgDy9A: folds 
4oA316mXLIui1QY63GXBUg: folds 
Uncalled bet ($0.50) returned to SkLOm0UugROBRt2EfMpOxQ
SkLOm0UugROBRt2EfMpOxQ collected $0.60 from pot
*** SUMMARY ***
Total pot $0.60 | Rake $0 
Seat 1: s7Q6uNouhe7aE8JdFb9E+A folded before Flop (didn't bet)
Seat 3: f+H1PHwj9cNu4Y6FfvKwQQ folded before Flop (didn't bet)
Seat 4: SkLOm0UugROBRt2EfMpOxQ collected ($0.60)
Seat 5: HQMjiff9S04k8kyC4fHVgw folded before Flop (didn't bet)
Seat 6: DiSvPC2iudwL5j9u6Huyww (button) folded before Flop (didn't bet)
Seat 7: QOyn4M230Dsb5atoXgDy9A (small blind) folded before Flop
Seat 8: 4oA316mXLIui1QY63GXBUg (big blind) folded before Flop
Seat 9: W4TLQcZ2TiM73eIgpIvlGg folded before Flop (didn't bet)




PokerStars Game #59939693322:  Hold'em No Limit ($0.10/$0.25) - 2009/07/01 0:46:28 ET
Table 'iMiAw/kTZXopgYX4HI7sHg' 9-max Seat #5 is the button
Seat 2: qwr38jl5txoR36M7G5qi4A ($7.50 in chips) 
Seat 3: HPEB+AtKw1+C/cxU0o1ciw ($22.05 in chips) 
Seat 4: S+cUFPGjDERB8nh2Ub77Bg ($12.60 in chips) 
Seat 5: UG5jx0ZzlHKfc+tNQpQoMQ ($2.35 in chips) 
Seat 6: mdk0yKND3u0wCmRU4tNRFg ($28.05 in chips) 
Seat 7: aPRz/2GxbXANYpVsQO8pdQ ($25 in chips) 
Seat 8: gU2i78hKxj5RUUH6zCK9bA ($6.25 in chips) 
Seat 9: K36tHfxDQBx3OFpy0baDPA ($20.75 in chips) 
mdk0yKND3u0wCmRU4tNRFg: posts small blind $0.10
aPRz/2GxbXANYpVsQO8pdQ: posts big blind $0.25
1Clf3cPrqoy/YgvWdWK1Xw: sits out 
*** HOLE CARDS ***
gU2i78hKxj5RUUH6zCK9bA: raises $0.50 to $0.75
K36tHfxDQBx3OFpy0baDPA: folds 
qwr38jl5txoR36M7G5qi4A: folds 
HPEB+AtKw1+C/cxU0o1ciw: folds 
S+cUFPGjDERB8nh2Ub77Bg: calls $0.75
UG5jx0ZzlHKfc+tNQpQoMQ: folds 
mdk0yKND3u0wCmRU4tNRFg: folds 
aPRz/2GxbXANYpVsQO8pdQ: folds 
*** FLOP *** [5s 3d 4c]
gU2i78hKxj5RUUH6zCK9bA: bets $0.75
S+cUFPGjDERB8nh2Ub77Bg: raises $0.75 to $1.50
gU2i78hKxj5RUUH6zCK9bA: calls $0.75
*** TURN *** [5s 3d 4c] [3h]
gU2i78hKxj5RUUH6zCK9bA: checks 
S+cUFPGjDERB8nh2Ub77Bg: bets $2
gU2i78hKxj5RUUH6zCK9bA: folds 
Uncalled bet ($2) returned to S+cUFPGjDERB8nh2Ub77Bg
S+cUFPGjDERB8nh2Ub77Bg collected $4.65 from pot
S+cUFPGjDERB8nh2Ub77Bg: doesn't show hand 
*** SUMMARY ***
Total pot $4.85 | Rake $0.20 
Board [5s 3d 4c 3h]
Seat 2: qwr38jl5txoR36M7G5qi4A folded before Flop (didn't bet)
Seat 3: HPEB+AtKw1+C/cxU0o1ciw folded before Flop (didn't bet)
Seat 4: S+cUFPGjDERB8nh2Ub77Bg collected ($4.65)
Seat 5: UG5jx0ZzlHKfc+tNQpQoMQ (button) folded before Flop (didn't bet)
Seat 6: mdk0yKND3u0wCmRU4tNRFg (small blind) folded before Flop
Seat 7: aPRz/2GxbXANYpVsQO8pdQ (big blind) folded before Flop
Seat 8: gU2i78hKxj5RUUH6zCK9bA folded on the Turn
Seat 9: K36tHfxDQBx3OFpy0baDPA folded before Flop (didn't bet)




PokerStars Game #59939693048:  Hold'em No Limit ($0.10/$0.25) - 2009/07/01 0:46:28 ET
Table 'FBhJjLqab11/gKu8nyB/tw' 9-max Seat #1 is the button
Seat 1: +sbyWwIcFp9kP0bDtMegfQ ($19.40 in chips) 
Seat 2: 1pwQJV/Xr0GWPRefx/78VQ ($6.15 in chips) 
Seat 3: uy9x0X5l7O+IpGjLa77QgQ ($26.90 in chips) 
Seat 4: OTC1Bh+DhK778Qnsj6D8+A ($24.50 in chips) 
Seat 5: vZGoOTJLQLhkPj4I+LNGig ($45.75 in chips) 
Seat 6: QrNgXJWFdS+POsPJcil4aA ($12.75 in chips) 
Seat 7: 5Fj9JGGxQT7Djr6AyIiBVA ($23.40 in chips) 
Seat 8: 9lE3Zc4pjmKpQK8rDF1aaQ ($26.25 in chips) 
Seat 9: BEIBUu2pIflPrCL+Iks4CQ ($11.80 in chips) 
1pwQJV/Xr0GWPRefx/78VQ: posts small blind $0.10
uy9x0X5l7O+IpGjLa77QgQ: posts big blind $0.25
*** HOLE CARDS ***
OTC1Bh+DhK778Qnsj6D8+A: raises $0.50 to $0.75
vZGoOTJLQLhkPj4I+LNGig: folds 
QrNgXJWFdS+POsPJcil4aA: folds 
5Fj9JGGxQT7Djr6AyIiBVA: folds 
9lE3Zc4pjmKpQK8rDF1aaQ: folds 
BEIBUu2pIflPrCL+Iks4CQ: calls $0.75
+sbyWwIcFp9kP0bDtMegfQ: folds 
1pwQJV/Xr0GWPRefx/78VQ: folds 
1pwQJV/Xr0GWPRefx/78VQ is sitting out
uy9x0X5l7O+IpGjLa77QgQ: folds 
*** FLOP *** [6h Jc Js]
OTC1Bh+DhK778Qnsj6D8+A: bets $1
BEIBUu2pIflPrCL+Iks4CQ: calls $1
*** TURN *** [6h Jc Js] [3d]
OTC1Bh+DhK778Qnsj6D8+A: checks 
BEIBUu2pIflPrCL+Iks4CQ: bets $2
OTC1Bh+DhK778Qnsj6D8+A: calls $2
*** RIVER *** [6h Jc Js 3d] [2h]
OTC1Bh+DhK778Qnsj6D8+A: bets $2
1pwQJV/Xr0GWPRefx/78VQ has returned
BEIBUu2pIflPrCL+Iks4CQ: folds 
Uncalled bet ($2) returned to OTC1Bh+DhK778Qnsj6D8+A
OTC1Bh+DhK778Qnsj6D8+A collected $7.50 from pot
OTC1Bh+DhK778Qnsj6D8+A: doesn't show hand 
*** SUMMARY ***
Total pot $7.85 | Rake $0.35 
Board [6h Jc Js 3d 2h]
Seat 1: +sbyWwIcFp9kP0bDtMegfQ (button) folded before Flop (didn't bet)
Seat 2: 1pwQJV/Xr0GWPRefx/78VQ (small blind) folded before Flop
Seat 3: uy9x0X5l7O+IpGjLa77QgQ (big blind) folded before Flop
Seat 4: OTC1Bh+DhK778Qnsj6D8+A collected ($7.50)
Seat 5: vZGoOTJLQLhkPj4I+LNGig folded before Flop (didn't bet)
Seat 6: QrNgXJWFdS+POsPJcil4aA folded before Flop (didn't bet)
Seat 7: 5Fj9JGGxQT7Djr6AyIiBVA folded before Flop (didn't bet)
Seat 8: 9lE3Zc4pjmKpQK8rDF1aaQ folded before Flop (didn't bet)
Seat 9: BEIBUu2pIflPrCL+Iks4CQ folded on the River




PokerStars Game #59939693126:  Hold'em No Limit ($0.10/$0.25) - 2009/07/01 0:46:28 ET
Table 'KKk6y4pAXeymxYcd0uZLqg' 9-max Seat #1 is the button
Seat 1: HPEB+AtKw1+C/cxU0o1ciw ($24.55 in chips) 
Seat 2: k55YB7uP2TAZEba6pnHYiA ($19.15 in chips) 
Seat 3: 4oA316mXLIui1QY63GXBUg ($25 in chips) 
Seat 4: GTcLfsDTPqgfHyhY9FNDMw ($15.50 in chips) 
Seat 5: U0VVxBdRWdhRNdbJ+Qky1A ($46.30 in chips) 
Seat 6: LWN1wPrLH+695JIriXxDuw ($10.75 in chips) 
Seat 7: R3KkgiqTvuhazyCqaD9cZg ($10 in chips) 
Seat 8: +2kMBNpY4nF1qNCRd8SJLA ($26.35 in chips) 
Seat 9: j4q3p0lesp63b1gZDwLBZw ($5 in chips) 
k55YB7uP2TAZEba6pnHYiA: posts small blind $0.10
4oA316mXLIui1QY63GXBUg: posts big blind $0.25
*** HOLE CARDS ***
GTcLfsDTPqgfHyhY9FNDMw: folds 
U0VVxBdRWdhRNdbJ+Qky1A: folds 
LWN1wPrLH+695JIriXxDuw: folds 
R3KkgiqTvuhazyCqaD9cZg: calls $0.25
+2kMBNpY4nF1qNCRd8SJLA: folds 
j4q3p0lesp63b1gZDwLBZw: folds 
HPEB+AtKw1+C/cxU0o1ciw: folds 
k55YB7uP2TAZEba6pnHYiA: calls $0.15
4oA316mXLIui1QY63GXBUg: checks 
*** FLOP *** [3h 4s Kc]
k55YB7uP2TAZEba6pnHYiA: checks 
4oA316mXLIui1QY63GXBUg: bets $0.50
R3KkgiqTvuhazyCqaD9cZg: calls $0.50
k55YB7uP2TAZEba6pnHYiA: folds 
*** TURN *** [3h 4s Kc] [5s]
4oA316mXLIui1QY63GXBUg: bets $0.50
R3KkgiqTvuhazyCqaD9cZg: calls $0.50
*** RIVER *** [3h 4s Kc 5s] [5d]
4oA316mXLIui1QY63GXBUg: bets $0.50
R3KkgiqTvuhazyCqaD9cZg: calls $0.50
*** SHOW DOWN ***
4oA316mXLIui1QY63GXBUg: shows [Td Kh] (two pair, Kings and Fives)
R3KkgiqTvuhazyCqaD9cZg: mucks hand 
4oA316mXLIui1QY63GXBUg collected $3.60 from pot
*** SUMMARY ***
Total pot $3.75 | Rake $0.15 
Board [3h 4s Kc 5s 5d]
Seat 1: HPEB+AtKw1+C/cxU0o1ciw (button) folded before Flop (didn't bet)
Seat 2: k55YB7uP2TAZEba6pnHYiA (small blind) folded on the Flop
Seat 3: 4oA316mXLIui1QY63GXBUg (big blind) showed [Td Kh] and won ($3.60) with two pair, Kings and Fives
Seat 4: GTcLfsDTPqgfHyhY9FNDMw folded before Flop (didn't bet)
Seat 5: U0VVxBdRWdhRNdbJ+Qky1A folded before Flop (didn't bet)
Seat 6: LWN1wPrLH+695JIriXxDuw folded before Flop (didn't bet)
Seat 7: R3KkgiqTvuhazyCqaD9cZg mucked
Seat 8: +2kMBNpY4nF1qNCRd8SJLA folded before Flop (didn't bet)
Seat 9: j4q3p0lesp63b1gZDwLBZw folded before Flop (didn't bet)




PokerStars Game #59939692956:  Hold'em No Limit ($0.10/$0.25) - 2009/07/01 0:46:28 ET
Table 'IIO2q2znuuAXmiZ2qFTcmg' 6-max Seat #1 is the button
Seat 1: nwwpaieDRI0UPyVtChVHOg ($16.90 in chips) 
Seat 2: cS21pIxRHx5Gt42o7hPZzw ($15.35 in chips) 
Seat 3: hiTEr3yrERiQp3zHXRioVw ($41.35 in chips) 
Seat 4: 0HIrwssk0FQvyKULzUTtlg ($10.50 in chips) 
Seat 5: f9iRHw0d+kV7pbTYwF2+2g ($5.40 in chips) 
cS21pIxRHx5Gt42o7hPZzw: posts small blind $0.10
hiTEr3yrERiQp3zHXRioVw: posts big blind $0.25
*** HOLE CARDS ***
0HIrwssk0FQvyKULzUTtlg: folds 
f9iRHw0d+kV7pbTYwF2+2g: folds 
nwwpaieDRI0UPyVtChVHOg: folds 
cS21pIxRHx5Gt42o7hPZzw: calls $0.15
hiTEr3yrERiQp3zHXRioVw: raises $0.50 to $0.75
cS21pIxRHx5Gt42o7hPZzw: calls $0.50
*** FLOP *** [8h Js Jd]
cS21pIxRHx5Gt42o7hPZzw: checks 
hiTEr3yrERiQp3zHXRioVw: checks 
*** TURN *** [8h Js Jd] [8s]
gqrr7lSWrQ1N8zKx8zZzvA joins the table at seat #6 
cS21pIxRHx5Gt42o7hPZzw: checks 
hiTEr3yrERiQp3zHXRioVw: checks 
*** RIVER *** [8h Js Jd 8s] [8d]
cS21pIxRHx5Gt42o7hPZzw: checks 
hiTEr3yrERiQp3zHXRioVw: checks 
*** SHOW DOWN ***
cS21pIxRHx5Gt42o7hPZzw: shows [2d 3d] (a full house, Eights full of Jacks)
hiTEr3yrERiQp3zHXRioVw: shows [Ts As] (a full house, Eights full of Jacks)
cS21pIxRHx5Gt42o7hPZzw collected $0.75 from pot
hiTEr3yrERiQp3zHXRioVw collected $0.70 from pot
*** SUMMARY ***
Total pot $1.50 | Rake $0.05 
Board [8h Js Jd 8s 8d]
Seat 1: nwwpaieDRI0UPyVtChVHOg (button) folded before Flop (didn't bet)
Seat 2: cS21pIxRHx5Gt42o7hPZzw (small blind) showed [2d 3d] and won ($0.75) with a full house, Eights full of Jacks
Seat 3: hiTEr3yrERiQp3zHXRioVw (big blind) showed [Ts As] and won ($0.70) with a full house, Eights full of Jacks
Seat 4: 0HIrwssk0FQvyKULzUTtlg folded before Flop (didn't bet)
Seat 5: f9iRHw0d+kV7pbTYwF2+2g folded before Flop (didn't bet)




PokerStars Game #59939693968:  Hold'em No Limit ($0.10/$0.25) - 2009/07/01 0:46:29 ET
Table 'ORSZkZqq+7Ja2PdeCFAytA' 9-max Seat #4 is the button
Seat 1: Gpa8cld5y0mdOomHJgHhlA ($3.90 in chips) 
Seat 4: PJJTm/ccITEBlwPReiBTwg ($9 in chips) 
Seat 5: fOv1xoqR8m9slwElVu7Y+A ($19 in chips) 
fOv1xoqR8m9slwElVu7Y+A: posts small blind $0.10
Gpa8cld5y0mdOomHJgHhlA: posts big blind $0.25
*** HOLE CARDS ***
PJJTm/ccITEBlwPReiBTwg: folds 
fOv1xoqR8m9slwElVu7Y+A: folds 
Uncalled bet ($0.15) returned to Gpa8cld5y0mdOomHJgHhlA
Gpa8cld5y0mdOomHJgHhlA collected $0.20 from pot
*** SUMMARY ***
Total pot $0.20 | Rake $0 
Seat 1: Gpa8cld5y0mdOomHJgHhlA (big blind) collected ($0.20)
Seat 4: PJJTm/ccITEBlwPReiBTwg (button) folded before Flop (didn't bet)
Seat 5: fOv1xoqR8m9slwElVu7Y+A (small blind) folded before Flop




PokerStars Game #59939693506:  Hold'em No Limit ($0.10/$0.25) - 2009/07/01 0:46:29 ET
Table '+198VWQSWBhYQOcizzuBkw' 6-max Seat #2 is the button
Seat 1: 9wWOoS2QEhCmOCt1GOwBKA ($7.70 in chips) 
Seat 2: R6AGToFJQOYVZAjC2jXEKw ($20.55 in chips) 
Seat 3: BYxjLnV1/LL0aZcTbfAOvw ($27.60 in chips) 
Seat 4: TgDsTeCdLQt8kWbL00ByRA ($32.85 in chips) 
Seat 5: LtASJ9OlkqGrrUKGQlpGAw ($29.70 in chips) 
Seat 6: 7qRk4YH4/k/08LgJSv7rBQ ($31.25 in chips) 
BYxjLnV1/LL0aZcTbfAOvw: posts small blind $0.10
TgDsTeCdLQt8kWbL00ByRA: posts big blind $0.25
*** HOLE CARDS ***
LtASJ9OlkqGrrUKGQlpGAw: folds 
7qRk4YH4/k/08LgJSv7rBQ: folds 
9wWOoS2QEhCmOCt1GOwBKA: calls $0.25
R6AGToFJQOYVZAjC2jXEKw: calls $0.25
BYxjLnV1/LL0aZcTbfAOvw: folds 
TgDsTeCdLQt8kWbL00ByRA: checks 
*** FLOP *** [7c 9s 5h]
TgDsTeCdLQt8kWbL00ByRA: checks 
9wWOoS2QEhCmOCt1GOwBKA: bets $0.50
R6AGToFJQOYVZAjC2jXEKw: raises $1 to $1.50
TgDsTeCdLQt8kWbL00ByRA: folds 
9wWOoS2QEhCmOCt1GOwBKA: calls $1
*** TURN *** [7c 9s 5h] [5d]
9wWOoS2QEhCmOCt1GOwBKA: bets $0.75
R6AGToFJQOYVZAjC2jXEKw: calls $0.75
*** RIVER *** [7c 9s 5h 5d] [Ac]
9wWOoS2QEhCmOCt1GOwBKA: checks 
R6AGToFJQOYVZAjC2jXEKw: checks 
*** SHOW DOWN ***
9wWOoS2QEhCmOCt1GOwBKA: shows [8h 7d] (two pair, Sevens and Fives)
R6AGToFJQOYVZAjC2jXEKw: shows [9d Ts] (two pair, Nines and Fives)
R6AGToFJQOYVZAjC2jXEKw collected $5.10 from pot
*** SUMMARY ***
Total pot $5.35 | Rake $0.25 
Board [7c 9s 5h 5d Ac]
Seat 1: 9wWOoS2QEhCmOCt1GOwBKA showed [8h 7d] and lost with two pair, Sevens and Fives
Seat 2: R6AGToFJQOYVZAjC2jXEKw (button) showed [9d Ts] and won ($5.10) with two pair, Nines and Fives
Seat 3: BYxjLnV1/LL0aZcTbfAOvw (small blind) folded before Flop
Seat 4: TgDsTeCdLQt8kWbL00ByRA (big blind) folded on the Flop
Seat 5: LtASJ9OlkqGrrUKGQlpGAw folded before Flop (didn't bet)
Seat 6: 7qRk4YH4/k/08LgJSv7rBQ folded before Flop (didn't bet)




PokerStars Game #59939693910:  Hold'em No Limit ($0.10/$0.25) - 2009/07/01 0:46:29 ET
Table '84TjTrgbsYZladOc4PWf4Q' 6-max Seat #5 is the button
Seat 1: 79ID/ub1Pt/mDpCprVmOoA ($30 in chips) 
Seat 2: RpaEX9P7BCvyfPRLiRNg0A ($15.35 in chips) 
Seat 3: Ar4vsUIUfJ7gbYh1c1m59g ($14.65 in chips) 
Seat 4: SxIIgwXYLkwd6m3wLyPTCw ($25 in chips) 
Seat 5: YaAEMJGY5tem39deCUQRNw ($26.35 in chips) 
Seat 6: 7qRk4YH4/k/08LgJSv7rBQ ($26.20 in chips) 
7qRk4YH4/k/08LgJSv7rBQ: posts small blind $0.10
79ID/ub1Pt/mDpCprVmOoA: posts big blind $0.25
*** HOLE CARDS ***
RpaEX9P7BCvyfPRLiRNg0A: folds 
Ar4vsUIUfJ7gbYh1c1m59g: folds 
SxIIgwXYLkwd6m3wLyPTCw: folds 
YaAEMJGY5tem39deCUQRNw: calls $0.25
7qRk4YH4/k/08LgJSv7rBQ: folds 
79ID/ub1Pt/mDpCprVmOoA: checks 
*** FLOP *** [8c 2d Ks]
79ID/ub1Pt/mDpCprVmOoA: checks 
YaAEMJGY5tem39deCUQRNw: bets $0.50
79ID/ub1Pt/mDpCprVmOoA: folds 
Uncalled bet ($0.50) returned to YaAEMJGY5tem39deCUQRNw
YaAEMJGY5tem39deCUQRNw collected $0.60 from pot
YaAEMJGY5tem39deCUQRNw: doesn't show hand 
*** SUMMARY ***
Total pot $0.60 | Rake $0 
Board [8c 2d Ks]
Seat 1: 79ID/ub1Pt/mDpCprVmOoA (big blind) folded on the Flop
Seat 2: RpaEX9P7BCvyfPRLiRNg0A folded before Flop (didn't bet)
Seat 3: Ar4vsUIUfJ7gbYh1c1m59g folded before Flop (didn't bet)
Seat 4: SxIIgwXYLkwd6m3wLyPTCw folded before Flop (didn't bet)
Seat 5: YaAEMJGY5tem39deCUQRNw (button) collected ($0.60)
Seat 6: 7qRk4YH4/k/08LgJSv7rBQ (small blind) folded before Flop




PokerStars Game #59939693552:  Hold'em No Limit ($0.10/$0.25) - 2009/07/01 0:46:29 ET
Table '6wawJ+MkkvuC3coG6r+Yhg' 6-max Seat #3 is the button
Seat 1: ELW+DKizJhLK7k40PMkD2Q ($32.50 in chips) 
Seat 2: LtASJ9OlkqGrrUKGQlpGAw ($26.05 in chips) 
Seat 3: KYBwVA7jgmSrbIEbEGElVg ($15.60 in chips) 
Seat 4: cS21pIxRHx5Gt42o7hPZzw ($11.25 in chips) 
Seat 5: A8uIskXJTblhVXWuYr+lkw ($7.95 in chips) 
Seat 6: oOGZlBAhqtG/HczLL/KLRQ ($21.10 in chips) 
cS21pIxRHx5Gt42o7hPZzw: posts small blind $0.10
A8uIskXJTblhVXWuYr+lkw: posts big blind $0.25
*** HOLE CARDS ***
oOGZlBAhqtG/HczLL/KLRQ: folds 
ELW+DKizJhLK7k40PMkD2Q: folds 
LtASJ9OlkqGrrUKGQlpGAw: folds 
KYBwVA7jgmSrbIEbEGElVg: raises $0.50 to $0.75
cS21pIxRHx5Gt42o7hPZzw: folds 
A8uIskXJTblhVXWuYr+lkw: calls $0.50
*** FLOP *** [9h Js 5c]
A8uIskXJTblhVXWuYr+lkw: bets $0.75
KYBwVA7jgmSrbIEbEGElVg: raises $1.75 to $2.50
A8uIskXJTblhVXWuYr+lkw: calls $1.75
*** TURN *** [9h Js 5c] [3c]
A8uIskXJTblhVXWuYr+lkw: checks 
KYBwVA7jgmSrbIEbEGElVg: bets $0.75
A8uIskXJTblhVXWuYr+lkw: calls $0.75
*** RIVER *** [9h Js 5c 3c] [Td]
A8uIskXJTblhVXWuYr+lkw: checks 
KYBwVA7jgmSrbIEbEGElVg: bets $0.50
A8uIskXJTblhVXWuYr+lkw: folds 
Uncalled bet ($0.50) returned to KYBwVA7jgmSrbIEbEGElVg
KYBwVA7jgmSrbIEbEGElVg collected $7.75 from pot
*** SUMMARY ***
Total pot $8.10 | Rake $0.35 
Board [9h Js 5c 3c Td]
Seat 1: ELW+DKizJhLK7k40PMkD2Q folded before Flop (didn't bet)
Seat 2: LtASJ9OlkqGrrUKGQlpGAw folded before Flop (didn't bet)
Seat 3: KYBwVA7jgmSrbIEbEGElVg (button) collected ($7.75)
Seat 4: cS21pIxRHx5Gt42o7hPZzw (small blind) folded before Flop
Seat 5: A8uIskXJTblhVXWuYr+lkw (big blind) folded on the River
Seat 6: oOGZlBAhqtG/HczLL/KLRQ folded before Flop (didn't bet)




PokerStars Game #59939694038:  Hold'em No Limit ($0.10/$0.25) - 2009/07/01 0:46:29 ET
Table 'AHkg4ChqzcMauBx6Qvz8Nw' 6-max Seat #5 is the button
Seat 1: 4kWQxGbT5FZ1dkPd1bE45Q ($25 in chips) 
Seat 2: /bjna2FTN7pPjqYGzmDE0Q ($23.90 in chips) 
Seat 3: wvIIdlbCgePONQwXjx9xzQ ($5.60 in chips) 
Seat 4: N7O9jUEx2YiQn1+yRYTHmw ($40.20 in chips) 
Seat 5: LtASJ9OlkqGrrUKGQlpGAw ($36.35 in chips) 
Seat 6: SFmT9ZsVopnukjvAzrxTRg ($53.60 in chips) 
SFmT9ZsVopnukjvAzrxTRg: posts small blind $0.10
4kWQxGbT5FZ1dkPd1bE45Q: posts big blind $0.25
*** HOLE CARDS ***
/bjna2FTN7pPjqYGzmDE0Q: folds 
wvIIdlbCgePONQwXjx9xzQ: folds 
N7O9jUEx2YiQn1+yRYTHmw: folds 
LtASJ9OlkqGrrUKGQlpGAw: folds 
SFmT9ZsVopnukjvAzrxTRg: raises $1.50 to $1.75
4kWQxGbT5FZ1dkPd1bE45Q: folds 
Uncalled bet ($1.50) returned to SFmT9ZsVopnukjvAzrxTRg
SFmT9ZsVopnukjvAzrxTRg collected $0.50 from pot
SFmT9ZsVopnukjvAzrxTRg: doesn't show hand 
*** SUMMARY ***
Total pot $0.50 | Rake $0 
Seat 1: 4kWQxGbT5FZ1dkPd1bE45Q (big blind) folded before Flop
Seat 2: /bjna2FTN7pPjqYGzmDE0Q folded before Flop (didn't bet)
Seat 3: wvIIdlbCgePONQwXjx9xzQ folded before Flop (didn't bet)
Seat 4: N7O9jUEx2YiQn1+yRYTHmw folded before Flop (didn't bet)
Seat 5: LtASJ9OlkqGrrUKGQlpGAw (button) folded before Flop (didn't bet)
Seat 6: SFmT9ZsVopnukjvAzrxTRg (small blind) collected ($0.50)




PokerStars Game #59939693878:  Hold'em No Limit ($0.10/$0.25) - 2009/07/01 0:46:29 ET
Table '5NipxzzFB2DffzDpddyQoQ' 6-max Seat #4 is the button
Seat 1: TslQs7AQSLbVtr4X8JOOOQ ($11.45 in chips) 
Seat 2: jxrNE4qd8KCOIqHjQcwCrA ($47.50 in chips) 
Seat 3: qGHGf/553gQnDoklMRe3tg ($48.80 in chips) 
Seat 4: Inq44d7PQ+8TbEKfPeuxVQ ($5.60 in chips) 
Seat 5: cS21pIxRHx5Gt42o7hPZzw ($6.90 in chips) 
Seat 6: lYjWCpfCxX2kgcHY3v4Yow ($26.55 in chips) 
cS21pIxRHx5Gt42o7hPZzw: posts small blind $0.10
lYjWCpfCxX2kgcHY3v4Yow: posts big blind $0.25
*** HOLE CARDS ***
TslQs7AQSLbVtr4X8JOOOQ: calls $0.25
jxrNE4qd8KCOIqHjQcwCrA: raises $0.75 to $1
qGHGf/553gQnDoklMRe3tg: folds 
Inq44d7PQ+8TbEKfPeuxVQ: folds 
cS21pIxRHx5Gt42o7hPZzw: calls $0.90
lYjWCpfCxX2kgcHY3v4Yow: folds 
TslQs7AQSLbVtr4X8JOOOQ: calls $0.75
*** FLOP *** [Qc 2s 7h]
cS21pIxRHx5Gt42o7hPZzw: checks 
TslQs7AQSLbVtr4X8JOOOQ: checks 
jxrNE4qd8KCOIqHjQcwCrA: bets $1.50
cS21pIxRHx5Gt42o7hPZzw: folds 
TslQs7AQSLbVtr4X8JOOOQ: folds 
Uncalled bet ($1.50) returned to jxrNE4qd8KCOIqHjQcwCrA
jxrNE4qd8KCOIqHjQcwCrA collected $3.10 from pot
jxrNE4qd8KCOIqHjQcwCrA: doesn't show hand 
*** SUMMARY ***
Total pot $3.25 | Rake $0.15 
Board [Qc 2s 7h]
Seat 1: TslQs7AQSLbVtr4X8JOOOQ folded on the Flop
Seat 2: jxrNE4qd8KCOIqHjQcwCrA collected ($3.10)
Seat 3: qGHGf/553gQnDoklMRe3tg folded before Flop (didn't bet)
Seat 4: Inq44d7PQ+8TbEKfPeuxVQ (button) folded before Flop (didn't bet)
Seat 5: cS21pIxRHx5Gt42o7hPZzw (small blind) folded on the Flop
Seat 6: lYjWCpfCxX2kgcHY3v4Yow (big blind) folded before Flop




PokerStars Game #59939693906:  Hold'em No Limit ($0.10/$0.25) - 2009/07/01 0:46:29 ET
Table 'Xi38lWH8L2JHRAsKYVX8Qg' 6-max Seat #5 is the button
Seat 1: AqQ7DFpHkgIzTwDu+rClcg ($6.25 in chips) 
Seat 2: 7iL6KfkJTFbyWmnLYk4+AA ($30.75 in chips) 
Seat 3: 6DwBRH+xZ12AAZmeAg+aXw ($25 in chips) 
Seat 4: kG34n23qFQA3nzdOJTQ1dA ($25.80 in chips) 
Seat 5: 79ID/ub1Pt/mDpCprVmOoA ($25.75 in chips) 
Seat 6: aogAb4Eienxztk8p2v9VVw ($25 in chips) 
aogAb4Eienxztk8p2v9VVw: posts small blind $0.10
AqQ7DFpHkgIzTwDu+rClcg: posts big blind $0.25
*** HOLE CARDS ***
7iL6KfkJTFbyWmnLYk4+AA: calls $0.25
6DwBRH+xZ12AAZmeAg+aXw: folds 
kG34n23qFQA3nzdOJTQ1dA: folds 
79ID/ub1Pt/mDpCprVmOoA: folds 
aogAb4Eienxztk8p2v9VVw: calls $0.15
AqQ7DFpHkgIzTwDu+rClcg: checks 
*** FLOP *** [Qd 6c 2c]
aogAb4Eienxztk8p2v9VVw: checks 
AqQ7DFpHkgIzTwDu+rClcg: bets $0.50
7iL6KfkJTFbyWmnLYk4+AA: raises $0.75 to $1.25
aogAb4Eienxztk8p2v9VVw: folds 
AqQ7DFpHkgIzTwDu+rClcg: folds 
Uncalled bet ($0.75) returned to 7iL6KfkJTFbyWmnLYk4+AA
7iL6KfkJTFbyWmnLYk4+AA collected $1.70 from pot
*** SUMMARY ***
Total pot $1.75 | Rake $0.05 
Board [Qd 6c 2c]
Seat 1: AqQ7DFpHkgIzTwDu+rClcg (big blind) folded on the Flop
Seat 2: 7iL6KfkJTFbyWmnLYk4+AA collected ($1.70)
Seat 3: 6DwBRH+xZ12AAZmeAg+aXw folded before Flop (didn't bet)
Seat 4: kG34n23qFQA3nzdOJTQ1dA folded before Flop (didn't bet)
Seat 5: 79ID/ub1Pt/mDpCprVmOoA (button) folded before Flop (didn't bet)
Seat 6: aogAb4Eienxztk8p2v9VVw (small blind) folded on the Flop




PokerStars Game #59939693726:  Hold'em No Limit ($0.10/$0.25) - 2009/07/01 0:46:29 ET
Table 'vZfV/Uj0q8joA1du9sRJSg' 6-max Seat #1 is the button
Seat 1: OAmGQMdOxnvuBNHdADx0ew ($4.35 in chips) 
Seat 2: wMiE3yTbDJGOLOF9th7KPA ($14.05 in chips) 
Seat 3: QJ/0wT0pYdWbDuqo9eNJgQ ($6.10 in chips) 
Seat 4: v+QfkGiuj9bgtuNoVnDO8w ($25.60 in chips) 
Seat 5: FStoHe64SQWqAsjya9pDkQ ($25 in chips) 
Seat 6: 8ClCHtFXGNplITm+63KB+Q ($27.05 in chips) 
wMiE3yTbDJGOLOF9th7KPA: posts small blind $0.10
QJ/0wT0pYdWbDuqo9eNJgQ: posts big blind $0.25
*** HOLE CARDS ***
v+QfkGiuj9bgtuNoVnDO8w: folds 
FStoHe64SQWqAsjya9pDkQ: folds 
8ClCHtFXGNplITm+63KB+Q: folds 
OAmGQMdOxnvuBNHdADx0ew: calls $0.25
wMiE3yTbDJGOLOF9th7KPA: calls $0.15
QJ/0wT0pYdWbDuqo9eNJgQ: checks 
*** FLOP *** [8d Ah 5d]
wMiE3yTbDJGOLOF9th7KPA: checks 
QJ/0wT0pYdWbDuqo9eNJgQ: bets $0.25
OAmGQMdOxnvuBNHdADx0ew: calls $0.25
wMiE3yTbDJGOLOF9th7KPA: calls $0.25
*** TURN *** [8d Ah 5d] [Ac]
wMiE3yTbDJGOLOF9th7KPA: checks 
QJ/0wT0pYdWbDuqo9eNJgQ: checks 
OAmGQMdOxnvuBNHdADx0ew: checks 
*** RIVER *** [8d Ah 5d Ac] [2c]
wMiE3yTbDJGOLOF9th7KPA: bets $0.50
QJ/0wT0pYdWbDuqo9eNJgQ: calls $0.50
OAmGQMdOxnvuBNHdADx0ew: calls $0.50
*** SHOW DOWN ***
wMiE3yTbDJGOLOF9th7KPA: shows [Th 7h] (a pair of Aces)
QJ/0wT0pYdWbDuqo9eNJgQ: shows [5s 3s] (two pair, Aces and Fives)
OAmGQMdOxnvuBNHdADx0ew: shows [Ks 8s] (two pair, Aces and Eights)
OAmGQMdOxnvuBNHdADx0ew collected $2.90 from pot
*** SUMMARY ***
Total pot $3 | Rake $0.10 
Board [8d Ah 5d Ac 2c]
Seat 1: OAmGQMdOxnvuBNHdADx0ew (button) showed [Ks 8s] and won ($2.90) with two pair, Aces and Eights
Seat 2: wMiE3yTbDJGOLOF9th7KPA (small blind) showed [Th 7h] and lost with a pair of Aces
Seat 3: QJ/0wT0pYdWbDuqo9eNJgQ (big blind) showed [5s 3s] and lost with two pair, Aces and Fives
Seat 4: v+QfkGiuj9bgtuNoVnDO8w folded before Flop (didn't bet)
Seat 5: FStoHe64SQWqAsjya9pDkQ folded before Flop (didn't bet)
Seat 6: 8ClCHtFXGNplITm+63KB+Q folded before Flop (didn't bet)




PokerStars Game #59939694480:  Hold'em No Limit ($0.10/$0.25) - 2009/07/01 0:46:30 ET
Table 'ggwTHpIC5qhhHJSYjK1XCw' 6-max Seat #3 is the button
Seat 1: BYxjLnV1/LL0aZcTbfAOvw ($34.55 in chips) 
Seat 2: mBAp/L4XPhNEkNUlUTV4Iw ($19.30 in chips) 
Seat 3: SxIIgwXYLkwd6m3wLyPTCw ($25 in chips) 
Seat 4: JFIAqU8lCZ0vWwEl4bdGsg ($25 in chips) 
Seat 5: 6zbQpY/G44U1Xvj7DZex0A ($20.55 in chips) 
Seat 6: QOk5VUJeDqXaA3RlMSluGA ($30.75 in chips) 
JFIAqU8lCZ0vWwEl4bdGsg: posts small blind $0.10
6zbQpY/G44U1Xvj7DZex0A: posts big blind $0.25
*** HOLE CARDS ***
QOk5VUJeDqXaA3RlMSluGA: folds 
BYxjLnV1/LL0aZcTbfAOvw: raises $0.75 to $1
mBAp/L4XPhNEkNUlUTV4Iw: calls $1
SxIIgwXYLkwd6m3wLyPTCw: calls $1
JFIAqU8lCZ0vWwEl4bdGsg: folds 
6zbQpY/G44U1Xvj7DZex0A: calls $0.75
*** FLOP *** [Qs Ks Kh]
6zbQpY/G44U1Xvj7DZex0A: checks 
BYxjLnV1/LL0aZcTbfAOvw: checks 
mBAp/L4XPhNEkNUlUTV4Iw: checks 
SxIIgwXYLkwd6m3wLyPTCw: bets $2.75
6zbQpY/G44U1Xvj7DZex0A: raises $2.75 to $5.50
BYxjLnV1/LL0aZcTbfAOvw: folds 
mBAp/L4XPhNEkNUlUTV4Iw: folds 
SxIIgwXYLkwd6m3wLyPTCw: calls $2.75
*** TURN *** [Qs Ks Kh] [5c]
6zbQpY/G44U1Xvj7DZex0A: bets $14.05 and is all-in
SxIIgwXYLkwd6m3wLyPTCw: calls $14.05
*** RIVER *** [Qs Ks Kh 5c] [2d]
*** SHOW DOWN ***
6zbQpY/G44U1Xvj7DZex0A: shows [Qh Qd] (a full house, Queens full of Kings)
SxIIgwXYLkwd6m3wLyPTCw: mucks hand 
6zbQpY/G44U1Xvj7DZex0A collected $41.10 from pot
*** SUMMARY ***
Total pot $43.20 | Rake $2.10 
Board [Qs Ks Kh 5c 2d]
Seat 1: BYxjLnV1/LL0aZcTbfAOvw folded on the Flop
Seat 2: mBAp/L4XPhNEkNUlUTV4Iw folded on the Flop
Seat 3: SxIIgwXYLkwd6m3wLyPTCw (button) mucked
Seat 4: JFIAqU8lCZ0vWwEl4bdGsg (small blind) folded before Flop
Seat 5: 6zbQpY/G44U1Xvj7DZex0A (big blind) showed [Qh Qd] and won ($41.10) with a full house, Queens full of Kings
Seat 6: QOk5VUJeDqXaA3RlMSluGA folded before Flop (didn't bet)




PokerStars Game #59939694702:  Hold'em No Limit ($0.10/$0.25) - 2009/07/01 0:46:30 ET
Table 'Of/T60zpXg1GcjrZ7Lm//Q' 9-max Seat #7 is the button
Seat 1: Lro4e37x4FUa5P3yzDjskw ($7.50 in chips) 
Seat 2: hIss79a4pu7GzJZepfgOpg ($25 in chips) 
Seat 3: jeKWRUkMaVn8rEUjnJKqpg ($28 in chips) 
Seat 4: Czut6V7acIqUJrrobjKAZg ($24.90 in chips) 
Seat 6: tYsOBqdU1+x+yFI7zHO7hQ ($25.90 in chips) 
Seat 7: s7Q6uNouhe7aE8JdFb9E+A ($34.60 in chips) 
Seat 8: ghNKXUBl/H+t83JF079ZBA ($31 in chips) 
Seat 9: TeWJxSETzbXGiYKx0y+dtg ($25 in chips) 
ghNKXUBl/H+t83JF079ZBA: posts small blind $0.10
TeWJxSETzbXGiYKx0y+dtg: posts big blind $0.25
*** HOLE CARDS ***
Lro4e37x4FUa5P3yzDjskw: raises $0.25 to $0.50
hIss79a4pu7GzJZepfgOpg: folds 
jeKWRUkMaVn8rEUjnJKqpg: calls $0.50
Czut6V7acIqUJrrobjKAZg: calls $0.50
tYsOBqdU1+x+yFI7zHO7hQ: folds 
s7Q6uNouhe7aE8JdFb9E+A: folds 
ghNKXUBl/H+t83JF079ZBA: folds 
TeWJxSETzbXGiYKx0y+dtg: calls $0.25
*** FLOP *** [8s 8d Js]
TeWJxSETzbXGiYKx0y+dtg: checks 
Lro4e37x4FUa5P3yzDjskw: bets $1
jeKWRUkMaVn8rEUjnJKqpg: folds 
Czut6V7acIqUJrrobjKAZg: raises $1 to $2
TeWJxSETzbXGiYKx0y+dtg: folds 
Lro4e37x4FUa5P3yzDjskw: raises $5 to $7 and is all-in
Czut6V7acIqUJrrobjKAZg: calls $5
*** TURN *** [8s 8d Js] [4d]
*** RIVER *** [8s 8d Js 4d] [Jd]
*** SHOW DOWN ***
Lro4e37x4FUa5P3yzDjskw: shows [Kd Ks] (two pair, Kings and Jacks)
Czut6V7acIqUJrrobjKAZg: mucks hand 
Lro4e37x4FUa5P3yzDjskw collected $15.30 from pot
*** SUMMARY ***
Total pot $16.10 | Rake $0.80 
Board [8s 8d Js 4d Jd]
Seat 1: Lro4e37x4FUa5P3yzDjskw showed [Kd Ks] and won ($15.30) with two pair, Kings and Jacks
Seat 2: hIss79a4pu7GzJZepfgOpg folded before Flop (didn't bet)
Seat 3: jeKWRUkMaVn8rEUjnJKqpg folded on the Flop
Seat 4: Czut6V7acIqUJrrobjKAZg mucked
Seat 6: tYsOBqdU1+x+yFI7zHO7hQ folded before Flop (didn't bet)
Seat 7: s7Q6uNouhe7aE8JdFb9E+A (button) folded before Flop (didn't bet)
Seat 8: ghNKXUBl/H+t83JF079ZBA (small blind) folded before Flop
Seat 9: TeWJxSETzbXGiYKx0y+dtg (big blind) folded on the Flop




PokerStars Game #59939695270:  Hold'em No Limit ($0.10/$0.25) - 2009/07/01 0:46:31 ET
Table '8Z6T3ssCpo3VV849U4RgBw' 9-max Seat #5 is the button
Seat 1: 8dNQBtNvCvzVgSnmDgi/LA ($11.65 in chips) 
Seat 2: y2juVuWuW+u1THo3kosjLQ ($15 in chips) 
Seat 3: DdPXdieucQ+n99u1n3A+rQ ($4.90 in chips) 
Seat 4: swWFmLwqgpSU1P6HAmCGPw ($14.90 in chips) 
Seat 5: zDrucyjVn5aeekNEc3cJrA ($22.55 in chips) 
Seat 7: VBHxUExRAMrbxUq/cVx9Gw ($5.95 in chips) 
Seat 8: hPhp/RE3cJ5YGaQ2xOHXXg ($3.90 in chips) 
Seat 9: yfkbMbx4w7MXhQDFPxOq0A ($19.05 in chips) 
VBHxUExRAMrbxUq/cVx9Gw: posts small blind $0.10
hPhp/RE3cJ5YGaQ2xOHXXg: posts big blind $0.25
y2juVuWuW+u1THo3kosjLQ: posts big blind $0.25
*** HOLE CARDS ***
yfkbMbx4w7MXhQDFPxOq0A: calls $0.25
8dNQBtNvCvzVgSnmDgi/LA: folds 
y2juVuWuW+u1THo3kosjLQ: checks 
DdPXdieucQ+n99u1n3A+rQ: folds 
swWFmLwqgpSU1P6HAmCGPw: folds 
zDrucyjVn5aeekNEc3cJrA: folds 
VBHxUExRAMrbxUq/cVx9Gw: folds 
hPhp/RE3cJ5YGaQ2xOHXXg: checks 
*** FLOP *** [8h 8s Kh]
Mr_GlamoRouS joins the table at seat #6 
hPhp/RE3cJ5YGaQ2xOHXXg: checks 
yfkbMbx4w7MXhQDFPxOq0A: bets $0.50
y2juVuWuW+u1THo3kosjLQ: folds 
hPhp/RE3cJ5YGaQ2xOHXXg: folds 
Uncalled bet ($0.50) returned to yfkbMbx4w7MXhQDFPxOq0A
yfkbMbx4w7MXhQDFPxOq0A collected $0.85 from pot
*** SUMMARY ***
Total pot $0.85 | Rake $0 
Board [8h 8s Kh]
Seat 1: 8dNQBtNvCvzVgSnmDgi/LA folded before Flop (didn't bet)
Seat 2: y2juVuWuW+u1THo3kosjLQ folded on the Flop
Seat 3: DdPXdieucQ+n99u1n3A+rQ folded before Flop (didn't bet)
Seat 4: swWFmLwqgpSU1P6HAmCGPw folded before Flop (didn't bet)
Seat 5: zDrucyjVn5aeekNEc3cJrA (button) folded before Flop (didn't bet)
Seat 7: VBHxUExRAMrbxUq/cVx9Gw (small blind) folded before Flop
Seat 8: hPhp/RE3cJ5YGaQ2xOHXXg (big blind) folded on the Flop
Seat 9: yfkbMbx4w7MXhQDFPxOq0A collected ($0.85)




PokerStars Game #59939695034:  Hold'em No Limit ($0.10/$0.25) - 2009/07/01 0:46:31 ET
Table '1HT8bEDpLPhOXxmqMtzF8w' 9-max Seat #9 is the button
Seat 1: s7Q6uNouhe7aE8JdFb9E+A ($42.85 in chips) 
Seat 2: r6hsffOo1iKmaPYKwAZmFw ($31.25 in chips) 
Seat 3: UJbH2fMMSFUo/jbJteWjjQ ($4.50 in chips) 
Seat 5: +iRmxp/CsJ/zuqdUG3CXNw ($14.65 in chips) 
Seat 6: 4oA316mXLIui1QY63GXBUg ($25 in chips) 
Seat 7: DIBbjEYGs+TVdVgEB/4+3w ($29.85 in chips) 
Seat 8: ghNKXUBl/H+t83JF079ZBA ($25.50 in chips) 
Seat 9: 86vbuhJsyH+nbEg5qpDLyQ ($19.15 in chips) 
s7Q6uNouhe7aE8JdFb9E+A: posts small blind $0.10
r6hsffOo1iKmaPYKwAZmFw: posts big blind $0.25
*** HOLE CARDS ***
fanie101 leaves the table
UJbH2fMMSFUo/jbJteWjjQ: calls $0.25
+iRmxp/CsJ/zuqdUG3CXNw: calls $0.25
4oA316mXLIui1QY63GXBUg: folds 
DIBbjEYGs+TVdVgEB/4+3w: folds 
ghNKXUBl/H+t83JF079ZBA: folds 
86vbuhJsyH+nbEg5qpDLyQ: folds 
s7Q6uNouhe7aE8JdFb9E+A: calls $0.15
r6hsffOo1iKmaPYKwAZmFw: checks 
*** FLOP *** [4s 3s 6c]
s7Q6uNouhe7aE8JdFb9E+A: bets $0.75
r6hsffOo1iKmaPYKwAZmFw: folds 
UJbH2fMMSFUo/jbJteWjjQ: folds 
+iRmxp/CsJ/zuqdUG3CXNw: calls $0.75
*** TURN *** [4s 3s 6c] [5c]
UJbH2fMMSFUo/jbJteWjjQ said, "ffff"
s7Q6uNouhe7aE8JdFb9E+A: bets $1.65
+iRmxp/CsJ/zuqdUG3CXNw: folds 
Uncalled bet ($1.65) returned to s7Q6uNouhe7aE8JdFb9E+A
s7Q6uNouhe7aE8JdFb9E+A collected $2.40 from pot
s7Q6uNouhe7aE8JdFb9E+A: doesn't show hand 
*** SUMMARY ***
Total pot $2.50 | Rake $0.10 
Board [4s 3s 6c 5c]
Seat 1: s7Q6uNouhe7aE8JdFb9E+A (small blind) collected ($2.40)
Seat 2: r6hsffOo1iKmaPYKwAZmFw (big blind) folded on the Flop
Seat 3: UJbH2fMMSFUo/jbJteWjjQ folded on the Flop
Seat 5: +iRmxp/CsJ/zuqdUG3CXNw folded on the Turn
Seat 6: 4oA316mXLIui1QY63GXBUg folded before Flop (didn't bet)
Seat 7: DIBbjEYGs+TVdVgEB/4+3w folded before Flop (didn't bet)
Seat 8: ghNKXUBl/H+t83JF079ZBA folded before Flop (didn't bet)
Seat 9: 86vbuhJsyH+nbEg5qpDLyQ (button) folded before Flop (didn't bet)




PokerStars Game #59939695006:  Hold'em No Limit ($0.10/$0.25) - 2009/07/01 0:46:31 ET
Table 'S6s+TmTlAjLHclBRvN5/fw' 9-max Seat #6 is the button
Seat 1: /XMgGtJ7mcWfe5s7McY9kw ($24.60 in chips) 
Seat 2: GGVjFwYkbwsuyKljxyML4g ($22.75 in chips) 
Seat 3: imHPFFqvfHGzsBBWeGuy4w ($20.95 in chips) 
Seat 4: M/9j4wkHH9i1JM51vgi1VA ($38.60 in chips) 
Seat 5: z5GxcHlYz/GSz6W2uFiTtg ($24.30 in chips) 
Seat 6: aNpwfA31EREwO+ar4XzBCw ($25 in chips) 
Seat 7: vSkQm2EelzwRGDDQQk0Fqw ($5 in chips) 
Seat 8: 42xLFHn85WRGGaaUZTNvwA ($16 in chips) 
Seat 9: BODayQmPi2rEfae9e6hIlw ($25 in chips) 
vSkQm2EelzwRGDDQQk0Fqw: posts small blind $0.10
42xLFHn85WRGGaaUZTNvwA: posts big blind $0.25
*** HOLE CARDS ***
BODayQmPi2rEfae9e6hIlw: folds 
/XMgGtJ7mcWfe5s7McY9kw: folds 
GGVjFwYkbwsuyKljxyML4g: calls $0.25
imHPFFqvfHGzsBBWeGuy4w: folds 
M/9j4wkHH9i1JM51vgi1VA: folds 
z5GxcHlYz/GSz6W2uFiTtg: folds 
aNpwfA31EREwO+ar4XzBCw: folds 
vSkQm2EelzwRGDDQQk0Fqw: raises $1 to $1.25
42xLFHn85WRGGaaUZTNvwA: calls $1
GGVjFwYkbwsuyKljxyML4g: calls $1
*** FLOP *** [Qs 2s 4s]
vSkQm2EelzwRGDDQQk0Fqw: checks 
42xLFHn85WRGGaaUZTNvwA: bets $0.75
GGVjFwYkbwsuyKljxyML4g: calls $0.75
vSkQm2EelzwRGDDQQk0Fqw: folds 
*** TURN *** [Qs 2s 4s] [2h]
42xLFHn85WRGGaaUZTNvwA: checks 
GGVjFwYkbwsuyKljxyML4g: checks 
*** RIVER *** [Qs 2s 4s 2h] [As]
42xLFHn85WRGGaaUZTNvwA: bets $4
GGVjFwYkbwsuyKljxyML4g: calls $4
*** SHOW DOWN ***
42xLFHn85WRGGaaUZTNvwA: shows [9d Ts] (a flush, Ace high)
GGVjFwYkbwsuyKljxyML4g: shows [Js Tc] (a flush, Ace high - Jack higher)
GGVjFwYkbwsuyKljxyML4g collected $12.60 from pot
*** SUMMARY ***
Total pot $13.25 | Rake $0.65 
Board [Qs 2s 4s 2h As]
Seat 1: /XMgGtJ7mcWfe5s7McY9kw folded before Flop (didn't bet)
Seat 2: GGVjFwYkbwsuyKljxyML4g showed [Js Tc] and won ($12.60) with a flush, Ace high
Seat 3: imHPFFqvfHGzsBBWeGuy4w folded before Flop (didn't bet)
Seat 4: M/9j4wkHH9i1JM51vgi1VA folded before Flop (didn't bet)
Seat 5: z5GxcHlYz/GSz6W2uFiTtg folded before Flop (didn't bet)
Seat 6: aNpwfA31EREwO+ar4XzBCw (button) folded before Flop (didn't bet)
Seat 7: vSkQm2EelzwRGDDQQk0Fqw (small blind) folded on the Flop
Seat 8: 42xLFHn85WRGGaaUZTNvwA (big blind) showed [9d Ts] and lost with a flush, Ace high
Seat 9: BODayQmPi2rEfae9e6hIlw folded before Flop (didn't bet)




PokerStars Game #59939695382:  Hold'em No Limit ($0.10/$0.25) - 2009/07/01 0:46:31 ET
Table 'G26g8jde1eR+mmabeFeSlw' 9-max Seat #6 is the button
Seat 1: eygIcrabyU9hI2mw7NQsgg ($22.50 in chips) 
Seat 2: O2aLEhH7P83nWGvgV84KoA ($13.50 in chips) 
Seat 3: WKL8nUFr7TumC4EjLyqYzw ($5 in chips) 
Seat 4: 1Clf3cPrqoy/YgvWdWK1Xw ($10.25 in chips) 
Seat 5: hJ4uYjNmSZdjrKA8cjZqCA ($19.80 in chips) 
Seat 6: opOCI2p6kW0tINuVaAqmcQ ($25 in chips) 
Seat 7: nm4Dj/f+jJEwKVsUnKh73g ($28.60 in chips) 
Seat 8: 22dIObOuor/A+IKWkNoAlA ($5 in chips) 
Seat 9: VWUWpMLMj/Q1jRVpF7Aohw ($9.60 in chips) 
nm4Dj/f+jJEwKVsUnKh73g: posts small blind $0.10
22dIObOuor/A+IKWkNoAlA: posts big blind $0.25
*** HOLE CARDS ***
VWUWpMLMj/Q1jRVpF7Aohw: folds 
eygIcrabyU9hI2mw7NQsgg: folds 
O2aLEhH7P83nWGvgV84KoA: folds 
WKL8nUFr7TumC4EjLyqYzw: folds 
1Clf3cPrqoy/YgvWdWK1Xw: folds 
hJ4uYjNmSZdjrKA8cjZqCA: folds 
opOCI2p6kW0tINuVaAqmcQ: folds 
nm4Dj/f+jJEwKVsUnKh73g: folds 
Uncalled bet ($0.15) returned to 22dIObOuor/A+IKWkNoAlA
22dIObOuor/A+IKWkNoAlA collected $0.20 from pot
22dIObOuor/A+IKWkNoAlA: doesn't show hand 
*** SUMMARY ***
Total pot $0.20 | Rake $0 
Seat 1: eygIcrabyU9hI2mw7NQsgg folded before Flop (didn't bet)
Seat 2: O2aLEhH7P83nWGvgV84KoA folded before Flop (didn't bet)
Seat 3: WKL8nUFr7TumC4EjLyqYzw folded before Flop (didn't bet)
Seat 4: 1Clf3cPrqoy/YgvWdWK1Xw folded before Flop (didn't bet)
Seat 5: hJ4uYjNmSZdjrKA8cjZqCA folded before Flop (didn't bet)
Seat 6: opOCI2p6kW0tINuVaAqmcQ (button) folded before Flop (didn't bet)
Seat 7: nm4Dj/f+jJEwKVsUnKh73g (small blind) folded before Flop
Seat 8: 22dIObOuor/A+IKWkNoAlA (big blind) collected ($0.20)
Seat 9: VWUWpMLMj/Q1jRVpF7Aohw folded before Flop (didn't bet)




PokerStars Game #59939695332:  Hold'em No Limit ($0.10/$0.25) - 2009/07/01 0:46:31 ET
Table '8PD/MTROSMd6Y8mZeykbpg' 6-max Seat #3 is the button
Seat 1: 32YL2ZEp8NT4JB2RVM9euQ ($19.05 in chips) 
Seat 2: wAKC8C/zN0c8V5v13dm9mA ($23.20 in chips) 
Seat 3: EV5E02/xfaoDNHy7UQ195Q ($25.30 in chips) 
Seat 4: tTBLQIRkkVpjhASe6+jvXQ ($4.75 in chips) 
Seat 5: z3tQwy28dp5FykDJC/wzQw ($23.40 in chips) 
Seat 6: 096oPBXuIkGUyml0gVo5TA ($19.40 in chips) 
tTBLQIRkkVpjhASe6+jvXQ: posts small blind $0.10
z3tQwy28dp5FykDJC/wzQw: posts big blind $0.25
*** HOLE CARDS ***
z3tQwy28dp5FykDJC/wzQw said, "noob"
096oPBXuIkGUyml0gVo5TA: raises $0.75 to $1
32YL2ZEp8NT4JB2RVM9euQ: folds 
wAKC8C/zN0c8V5v13dm9mA: raises $1.75 to $2.75
EV5E02/xfaoDNHy7UQ195Q: folds 
tTBLQIRkkVpjhASe6+jvXQ: calls $2.65
z3tQwy28dp5FykDJC/wzQw: folds 
096oPBXuIkGUyml0gVo5TA: calls $1.75
*** FLOP *** [3s Qd 9d]
EV5E02/xfaoDNHy7UQ195Q said, "lol thank god i folded i had 10-3 haha"
tTBLQIRkkVpjhASe6+jvXQ: checks 
096oPBXuIkGUyml0gVo5TA: checks 
z3tQwy28dp5FykDJC/wzQw said, "loool"
wAKC8C/zN0c8V5v13dm9mA is disconnected 
wAKC8C/zN0c8V5v13dm9mA is connected 
wAKC8C/zN0c8V5v13dm9mA: bets $3.50
tTBLQIRkkVpjhASe6+jvXQ: folds 
096oPBXuIkGUyml0gVo5TA: calls $3.50
*** TURN *** [3s Qd 9d] [Th]
096oPBXuIkGUyml0gVo5TA: checks 
wAKC8C/zN0c8V5v13dm9mA: bets $5
096oPBXuIkGUyml0gVo5TA: folds 
Uncalled bet ($5) returned to wAKC8C/zN0c8V5v13dm9mA
wAKC8C/zN0c8V5v13dm9mA collected $14.75 from pot
*** SUMMARY ***
Total pot $15.50 | Rake $0.75 
Board [3s Qd 9d Th]
Seat 1: 32YL2ZEp8NT4JB2RVM9euQ folded before Flop (didn't bet)
Seat 2: wAKC8C/zN0c8V5v13dm9mA collected ($14.75)
Seat 3: EV5E02/xfaoDNHy7UQ195Q (button) folded before Flop (didn't bet)
Seat 4: tTBLQIRkkVpjhASe6+jvXQ (small blind) folded on the Flop
Seat 5: z3tQwy28dp5FykDJC/wzQw (big blind) folded before Flop
Seat 6: 096oPBXuIkGUyml0gVo5TA folded on the Turn




PokerStars Game #59939694766:  Hold'em No Limit ($0.10/$0.25) - 2009/07/01 0:46:31 ET
Table 'biAgO3TKQBU8XcrVAoU5TA' 6-max Seat #4 is the button
Seat 1: i48129QFpEQQ+UN4aNtmww ($14.40 in chips) 
Seat 2: 7qRk4YH4/k/08LgJSv7rBQ ($26.50 in chips) 
Seat 3: 7AHdX4G8gYtDJyNY+wK+6Q ($32.45 in chips) 
Seat 4: 2/AObG8G5tKFCPZ+CdivJQ ($9.05 in chips) 
Seat 5: 6DwBRH+xZ12AAZmeAg+aXw ($25 in chips) 
Seat 6: //i5P+6lSkIyZsqb+ojVQA ($13.70 in chips) 
6DwBRH+xZ12AAZmeAg+aXw: posts small blind $0.10
//i5P+6lSkIyZsqb+ojVQA: posts big blind $0.25
*** HOLE CARDS ***
i48129QFpEQQ+UN4aNtmww: calls $0.25
7qRk4YH4/k/08LgJSv7rBQ: folds 
7AHdX4G8gYtDJyNY+wK+6Q: calls $0.25
2/AObG8G5tKFCPZ+CdivJQ: folds 
6DwBRH+xZ12AAZmeAg+aXw: calls $0.15
//i5P+6lSkIyZsqb+ojVQA: checks 
*** FLOP *** [5d 3d 2h]
6DwBRH+xZ12AAZmeAg+aXw: checks 
//i5P+6lSkIyZsqb+ojVQA: bets $0.25
i48129QFpEQQ+UN4aNtmww: calls $0.25
7AHdX4G8gYtDJyNY+wK+6Q: calls $0.25
6DwBRH+xZ12AAZmeAg+aXw: calls $0.25
*** TURN *** [5d 3d 2h] [7s]
6DwBRH+xZ12AAZmeAg+aXw: checks 
//i5P+6lSkIyZsqb+ojVQA: checks 
i48129QFpEQQ+UN4aNtmww: checks 
7AHdX4G8gYtDJyNY+wK+6Q: bets $0.75
6DwBRH+xZ12AAZmeAg+aXw: calls $0.75
//i5P+6lSkIyZsqb+ojVQA: folds 
i48129QFpEQQ+UN4aNtmww: calls $0.75
*** RIVER *** [5d 3d 2h 7s] [7h]
6DwBRH+xZ12AAZmeAg+aXw: bets $2.25
i48129QFpEQQ+UN4aNtmww: folds 
7AHdX4G8gYtDJyNY+wK+6Q: raises $3.75 to $6
6DwBRH+xZ12AAZmeAg+aXw: calls $3.75
*** SHOW DOWN ***
7AHdX4G8gYtDJyNY+wK+6Q: shows [2d 2c] (a full house, Deuces full of Sevens)
6DwBRH+xZ12AAZmeAg+aXw: mucks hand 
7AHdX4G8gYtDJyNY+wK+6Q collected $15.45 from pot
*** SUMMARY ***
Total pot $16.25 | Rake $0.80 
Board [5d 3d 2h 7s 7h]
Seat 1: i48129QFpEQQ+UN4aNtmww folded on the River
Seat 2: 7qRk4YH4/k/08LgJSv7rBQ folded before Flop (didn't bet)
Seat 3: 7AHdX4G8gYtDJyNY+wK+6Q showed [2d 2c] and won ($15.45) with a full house, Deuces full of Sevens
Seat 4: 2/AObG8G5tKFCPZ+CdivJQ (button) folded before Flop (didn't bet)
Seat 5: 6DwBRH+xZ12AAZmeAg+aXw (small blind) mucked
Seat 6: //i5P+6lSkIyZsqb+ojVQA (big blind) folded on the Turn




PokerStars Game #59939695062:  Hold'em No Limit ($0.10/$0.25) - 2009/07/01 0:46:31 ET
Table 'NtEQAxCeIK2io1CGtW658g' 6-max Seat #5 is the button
Seat 1: lnOV7k25gyN7L5t5YKTgIg ($16.95 in chips) 
Seat 2: nc79pm0LZRdhncq55evVqA ($26.80 in chips) 
Seat 3: m2yWOKfAxqHoy5DDN87Ttw ($23.40 in chips) 
Seat 4: 8296 ($13.05 in chips) 
Seat 5: FStoHe64SQWqAsjya9pDkQ ($25 in chips) 
Seat 6: /gJNBeCkWL4o85/jvlZ4BA ($67.80 in chips) 
/gJNBeCkWL4o85/jvlZ4BA: posts small blind $0.10
lnOV7k25gyN7L5t5YKTgIg: posts big blind $0.25
*** HOLE CARDS ***
nc79pm0LZRdhncq55evVqA: folds 
m2yWOKfAxqHoy5DDN87Ttw: folds 
8296: calls $0.25
FStoHe64SQWqAsjya9pDkQ: raises $1 to $1.25
/gJNBeCkWL4o85/jvlZ4BA: folds 
lnOV7k25gyN7L5t5YKTgIg: folds 
8296: folds 
Uncalled bet ($1) returned to FStoHe64SQWqAsjya9pDkQ
FStoHe64SQWqAsjya9pDkQ collected $0.85 from pot
FStoHe64SQWqAsjya9pDkQ: doesn't show hand 
*** SUMMARY ***
Total pot $0.85 | Rake $0 
Seat 1: lnOV7k25gyN7L5t5YKTgIg (big blind) folded before Flop
Seat 2: nc79pm0LZRdhncq55evVqA folded before Flop (didn't bet)
Seat 3: m2yWOKfAxqHoy5DDN87Ttw folded before Flop (didn't bet)
Seat 4: 8296 folded before Flop
Seat 5: FStoHe64SQWqAsjya9pDkQ (button) collected ($0.85)
Seat 6: /gJNBeCkWL4o85/jvlZ4BA (small blind) folded before Flop




PokerStars Game #59939695464:  Hold'em No Limit ($0.10/$0.25) - 2009/07/01 0:46:32 ET
Table 'B3/JTS7usG3rxMfTbMiZuw' 6-max Seat #6 is the button
Seat 1: wAKC8C/zN0c8V5v13dm9mA ($31.85 in chips) 
Seat 2: 2gqWqkOq59pvtJKe4nS+rw ($22.65 in chips) 
Seat 3: PbMzPZIePKifKQZfKDkbIw ($25.35 in chips) 
Seat 4: kPCKvyB1yAABEgvF7OaG0g ($23.65 in chips) 
Seat 5: NhUN/JpAprdJeamFBgJH1w ($28.90 in chips) 
Seat 6: 6DwBRH+xZ12AAZmeAg+aXw ($25 in chips) 
wAKC8C/zN0c8V5v13dm9mA: posts small blind $0.10
2gqWqkOq59pvtJKe4nS+rw: posts big blind $0.25
*** HOLE CARDS ***
PbMzPZIePKifKQZfKDkbIw: folds 
kPCKvyB1yAABEgvF7OaG0g: calls $0.25
NhUN/JpAprdJeamFBgJH1w: folds 
6DwBRH+xZ12AAZmeAg+aXw: folds 
wAKC8C/zN0c8V5v13dm9mA: folds 
2gqWqkOq59pvtJKe4nS+rw: checks 
*** FLOP *** [Qs 5h 4c]
2gqWqkOq59pvtJKe4nS+rw: checks 
kPCKvyB1yAABEgvF7OaG0g: checks 
*** TURN *** [Qs 5h 4c] [Js]
2gqWqkOq59pvtJKe4nS+rw: checks 
kPCKvyB1yAABEgvF7OaG0g: bets $0.75
2gqWqkOq59pvtJKe4nS+rw: folds 
Uncalled bet ($0.75) returned to kPCKvyB1yAABEgvF7OaG0g
kPCKvyB1yAABEgvF7OaG0g collected $0.60 from pot
kPCKvyB1yAABEgvF7OaG0g: doesn't show hand 
*** SUMMARY ***
Total pot $0.60 | Rake $0 
Board [Qs 5h 4c Js]
Seat 1: wAKC8C/zN0c8V5v13dm9mA (small blind) folded before Flop
Seat 2: 2gqWqkOq59pvtJKe4nS+rw (big blind) folded on the Turn
Seat 3: PbMzPZIePKifKQZfKDkbIw folded before Flop (didn't bet)
Seat 4: kPCKvyB1yAABEgvF7OaG0g collected ($0.60)
Seat 5: NhUN/JpAprdJeamFBgJH1w folded before Flop (didn't bet)
Seat 6: 6DwBRH+xZ12AAZmeAg+aXw (button) folded before Flop (didn't bet)




PokerStars Game #59939695850:  Hold'em No Limit ($0.10/$0.25) - 2009/07/01 0:46:32 ET
Table 'oJpFwZj9+FUGHX90Un8s9Q' 6-max Seat #6 is the button
Seat 1: 6DwBRH+xZ12AAZmeAg+aXw ($26.40 in chips) 
Seat 2: IMmIhmfU3tqkaJABnD21Rg ($15.30 in chips) 
Seat 3: kyRaCIljYA6l33lSKQfNsg ($27.80 in chips) 
Seat 4: IX/nJvz3Mx/Ez6DgueFA4Q ($8.45 in chips) 
Seat 5: kG34n23qFQA3nzdOJTQ1dA ($24.30 in chips) 
Seat 6: Zijzy/UtPWzWVUo81HHVjQ ($40.10 in chips) 
6DwBRH+xZ12AAZmeAg+aXw: posts small blind $0.10
IMmIhmfU3tqkaJABnD21Rg: posts big blind $0.25
*** HOLE CARDS ***
kyRaCIljYA6l33lSKQfNsg: folds 
IX/nJvz3Mx/Ez6DgueFA4Q: calls $0.25
kG34n23qFQA3nzdOJTQ1dA: folds 
Zijzy/UtPWzWVUo81HHVjQ: folds 
6DwBRH+xZ12AAZmeAg+aXw: calls $0.15
IMmIhmfU3tqkaJABnD21Rg: checks 
*** FLOP *** [3d Qh 2s]
6DwBRH+xZ12AAZmeAg+aXw: checks 
IMmIhmfU3tqkaJABnD21Rg: checks 
IX/nJvz3Mx/Ez6DgueFA4Q: bets $0.75
6DwBRH+xZ12AAZmeAg+aXw: folds 
IMmIhmfU3tqkaJABnD21Rg: calls $0.75
*** TURN *** [3d Qh 2s] [8d]
IMmIhmfU3tqkaJABnD21Rg: checks 
IX/nJvz3Mx/Ez6DgueFA4Q: bets $0.75
IMmIhmfU3tqkaJABnD21Rg: folds 
Uncalled bet ($0.75) returned to IX/nJvz3Mx/Ez6DgueFA4Q
IX/nJvz3Mx/Ez6DgueFA4Q collected $2.15 from pot
*** SUMMARY ***
Total pot $2.25 | Rake $0.10 
Board [3d Qh 2s 8d]
Seat 1: 6DwBRH+xZ12AAZmeAg+aXw (small blind) folded on the Flop
Seat 2: IMmIhmfU3tqkaJABnD21Rg (big blind) folded on the Turn
Seat 3: kyRaCIljYA6l33lSKQfNsg folded before Flop (didn't bet)
Seat 4: IX/nJvz3Mx/Ez6DgueFA4Q collected ($2.15)
Seat 5: kG34n23qFQA3nzdOJTQ1dA folded before Flop (didn't bet)
Seat 6: Zijzy/UtPWzWVUo81HHVjQ (button) folded before Flop (didn't bet)




PokerStars Game #59939695506:  Hold'em No Limit ($0.10/$0.25) - 2009/07/01 0:46:32 ET
Table 'nRFAYu63wZNzrz/OBgzFTw' 9-max Seat #6 is the button
Seat 1: N6fYvIzQLKaydFLKQGtMlQ ($23.90 in chips) 
Seat 2: hJ4uYjNmSZdjrKA8cjZqCA ($19.20 in chips) 
Seat 4: OiV1PWZ3IkN29JlmCcnTwQ ($5.15 in chips) 
Seat 5: vKdukiQ4ktU4yJ0Xx3MKnA ($29.85 in chips) 
Seat 6: DnDcAdn9P0zGovMERigpFA ($25.25 in chips) 
Seat 8: amHgC+Q9cpfD/2w2yUtNbw ($9.50 in chips) 
dtZ84flFEi4Q+SGrHMJRDQ will be allowed to play after the button
amHgC+Q9cpfD/2w2yUtNbw: posts small blind $0.10
SXqVW4Q0evTUVZG6BbUNIA: is sitting out 
N6fYvIzQLKaydFLKQGtMlQ: posts big blind $0.25
W8cIfrCR+zA8pCNyIuHu8g: sits out 
*** HOLE CARDS ***
hJ4uYjNmSZdjrKA8cjZqCA: folds 
OiV1PWZ3IkN29JlmCcnTwQ: folds 
vKdukiQ4ktU4yJ0Xx3MKnA: folds 
DnDcAdn9P0zGovMERigpFA: folds 
amHgC+Q9cpfD/2w2yUtNbw: folds 
Uncalled bet ($0.15) returned to N6fYvIzQLKaydFLKQGtMlQ
N6fYvIzQLKaydFLKQGtMlQ collected $0.20 from pot
*** SUMMARY ***
Total pot $0.20 | Rake $0 
Seat 1: N6fYvIzQLKaydFLKQGtMlQ (big blind) collected ($0.20)
Seat 2: hJ4uYjNmSZdjrKA8cjZqCA folded before Flop (didn't bet)
Seat 4: OiV1PWZ3IkN29JlmCcnTwQ folded before Flop (didn't bet)
Seat 5: vKdukiQ4ktU4yJ0Xx3MKnA folded before Flop (didn't bet)
Seat 6: DnDcAdn9P0zGovMERigpFA (button) folded before Flop (didn't bet)
Seat 8: amHgC+Q9cpfD/2w2yUtNbw (small blind) folded before Flop




PokerStars Game #59939695722:  Hold'em No Limit ($0.10/$0.25) - 2009/07/01 0:46:32 ET
Table '+68ihX5Br1xgGorX6zsCBg' 9-max Seat #3 is the button
Seat 1: qwr38jl5txoR36M7G5qi4A ($7.50 in chips) 
Seat 3: DIBbjEYGs+TVdVgEB/4+3w ($22.40 in chips) 
Seat 5: AmFFUA8KSwLGIW6CfaP4JQ ($14.30 in chips) 
Seat 6: 8B/dhbQjIWe6ASCdgzktNQ ($25.85 in chips) 
Seat 7: LWN1wPrLH+695JIriXxDuw ($9.85 in chips) 
Seat 8: rUdM7gwmNCaxMNSb2CFPhQ ($13.15 in chips) 
AmFFUA8KSwLGIW6CfaP4JQ: posts small blind $0.10
8B/dhbQjIWe6ASCdgzktNQ: posts big blind $0.25
TeAfhXG1R60d8yPEHN3JiA: sits out 
*** HOLE CARDS ***
LWN1wPrLH+695JIriXxDuw: calls $0.25
rUdM7gwmNCaxMNSb2CFPhQ: folds 
AmFFUA8KSwLGIW6CfaP4JQ said, "t"
qwr38jl5txoR36M7G5qi4A: folds 
DIBbjEYGs+TVdVgEB/4+3w: folds 
AmFFUA8KSwLGIW6CfaP4JQ: calls $0.15
8B/dhbQjIWe6ASCdgzktNQ: checks 
*** FLOP *** [9s Ah 4c]
AmFFUA8KSwLGIW6CfaP4JQ: bets $0.25
8B/dhbQjIWe6ASCdgzktNQ: folds 
LWN1wPrLH+695JIriXxDuw: calls $0.25
*** TURN *** [9s Ah 4c] [8d]
AmFFUA8KSwLGIW6CfaP4JQ: bets $0.50
LWN1wPrLH+695JIriXxDuw: calls $0.50
*** RIVER *** [9s Ah 4c 8d] [8s]
AmFFUA8KSwLGIW6CfaP4JQ: checks 
LWN1wPrLH+695JIriXxDuw: checks 
*** SHOW DOWN ***
AmFFUA8KSwLGIW6CfaP4JQ: shows [Ad Qd] (two pair, Aces and Eights)
LWN1wPrLH+695JIriXxDuw: mucks hand 
AmFFUA8KSwLGIW6CfaP4JQ collected $2.15 from pot
*** SUMMARY ***
Total pot $2.25 | Rake $0.10 
Board [9s Ah 4c 8d 8s]
Seat 1: qwr38jl5txoR36M7G5qi4A folded before Flop (didn't bet)
Seat 3: DIBbjEYGs+TVdVgEB/4+3w (button) folded before Flop (didn't bet)
Seat 5: AmFFUA8KSwLGIW6CfaP4JQ (small blind) showed [Ad Qd] and won ($2.15) with two pair, Aces and Eights
Seat 6: 8B/dhbQjIWe6ASCdgzktNQ (big blind) folded on the Flop
Seat 7: LWN1wPrLH+695JIriXxDuw mucked
Seat 8: rUdM7gwmNCaxMNSb2CFPhQ folded before Flop (didn't bet)




PokerStars Game #59939695520:  Hold'em No Limit ($0.10/$0.25) - 2009/07/01 0:46:32 ET
Table 'GoBmKm3klK6VavJE4STfmQ' 9-max Seat #5 is the button
Seat 1: N6fYvIzQLKaydFLKQGtMlQ ($20.45 in chips) 
Seat 2: 1c/7DHPx5CDTmAfk8/bWeA ($15.75 in chips) 
Seat 3: 4awUyiDYTgylQKXZ9faBVA ($30.25 in chips) 
Seat 4: H5Se03ZqSX7tbULXur2MAg ($23.95 in chips) 
Seat 5: 8B/dhbQjIWe6ASCdgzktNQ ($25 in chips) 
Seat 6: S3QwXyGCcujfAwNubHpwbw ($4.90 in chips) 
Seat 7: s9a4d23HFxaL70yUWQ0/tQ ($20.40 in chips) 
Seat 8: cZ99hugmLBj9KhTlc8nCSw ($25 in chips) 
S3QwXyGCcujfAwNubHpwbw: posts small blind $0.10
s9a4d23HFxaL70yUWQ0/tQ: posts big blind $0.25
*** HOLE CARDS ***
cZ99hugmLBj9KhTlc8nCSw: folds 
N6fYvIzQLKaydFLKQGtMlQ: folds 
1c/7DHPx5CDTmAfk8/bWeA: folds 
4awUyiDYTgylQKXZ9faBVA: folds 
H5Se03ZqSX7tbULXur2MAg: folds 
8B/dhbQjIWe6ASCdgzktNQ: folds 
S3QwXyGCcujfAwNubHpwbw: calls $0.15
s9a4d23HFxaL70yUWQ0/tQ: checks 
*** FLOP *** [Td Kh Qh]
S3QwXyGCcujfAwNubHpwbw: checks 
s9a4d23HFxaL70yUWQ0/tQ: checks 
*** TURN *** [Td Kh Qh] [6h]
S3QwXyGCcujfAwNubHpwbw: checks 
s9a4d23HFxaL70yUWQ0/tQ: checks 
*** RIVER *** [Td Kh Qh 6h] [Jc]
S3QwXyGCcujfAwNubHpwbw: checks 
s9a4d23HFxaL70yUWQ0/tQ: checks 
*** SHOW DOWN ***
S3QwXyGCcujfAwNubHpwbw: shows [6c 2h] (a pair of Sixes)
s9a4d23HFxaL70yUWQ0/tQ: shows [Jh 5d] (a pair of Jacks)
s9a4d23HFxaL70yUWQ0/tQ collected $0.50 from pot
*** SUMMARY ***
Total pot $0.50 | Rake $0 
Board [Td Kh Qh 6h Jc]
Seat 1: N6fYvIzQLKaydFLKQGtMlQ folded before Flop (didn't bet)
Seat 2: 1c/7DHPx5CDTmAfk8/bWeA folded before Flop (didn't bet)
Seat 3: 4awUyiDYTgylQKXZ9faBVA folded before Flop (didn't bet)
Seat 4: H5Se03ZqSX7tbULXur2MAg folded before Flop (didn't bet)
Seat 5: 8B/dhbQjIWe6ASCdgzktNQ (button) folded before Flop (didn't bet)
Seat 6: S3QwXyGCcujfAwNubHpwbw (small blind) showed [6c 2h] and lost with a pair of Sixes
Seat 7: s9a4d23HFxaL70yUWQ0/tQ (big blind) showed [Jh 5d] and won ($0.50) with a pair of Jacks
Seat 8: cZ99hugmLBj9KhTlc8nCSw folded before Flop (didn't bet)




PokerStars Game #59939695854:  Hold'em No Limit ($0.10/$0.25) - 2009/07/01 0:46:32 ET
Table 'uFgIyfWPagvEVGEb86da7A' 9-max Seat #5 is the button
Seat 1: 5MgYq10OC5iGoxQFwlJVuw ($15 in chips) 
Seat 2: o3zvoO+PsqGti+1NZGNRrQ ($5.60 in chips) 
Seat 3: q4GZp0xt5Unxtq8PS32SAQ ($34.60 in chips) 
Seat 4: IGRfskE1v9H9Bn+fz8AgNQ ($25.75 in chips) 
Seat 5: V6p0jQ/RhUsqpHLmXvEX4Q ($12.35 in chips) 
Seat 6: zDrucyjVn5aeekNEc3cJrA ($34.05 in chips) 
Seat 8: MrPo4/ymXwg9lzPRybrXbA ($5 in chips) 
Seat 9: DnDcAdn9P0zGovMERigpFA ($25 in chips) 
zDrucyjVn5aeekNEc3cJrA: posts small blind $0.10
MrPo4/ymXwg9lzPRybrXbA: posts big blind $0.25
*** HOLE CARDS ***
DnDcAdn9P0zGovMERigpFA: folds 
5MgYq10OC5iGoxQFwlJVuw: folds 
o3zvoO+PsqGti+1NZGNRrQ: raises $0.50 to $0.75
q4GZp0xt5Unxtq8PS32SAQ: folds 
IGRfskE1v9H9Bn+fz8AgNQ: folds 
V6p0jQ/RhUsqpHLmXvEX4Q: raises $1.50 to $2.25
zDrucyjVn5aeekNEc3cJrA: folds 
MrPo4/ymXwg9lzPRybrXbA: folds 
o3zvoO+PsqGti+1NZGNRrQ: calls $1.50
*** FLOP *** [7c 6h Kh]
o3zvoO+PsqGti+1NZGNRrQ: checks 
V6p0jQ/RhUsqpHLmXvEX4Q: bets $2
o3zvoO+PsqGti+1NZGNRrQ: folds 
Uncalled bet ($2) returned to V6p0jQ/RhUsqpHLmXvEX4Q
V6p0jQ/RhUsqpHLmXvEX4Q collected $4.65 from pot
*** SUMMARY ***
Total pot $4.85 | Rake $0.20 
Board [7c 6h Kh]
Seat 1: 5MgYq10OC5iGoxQFwlJVuw folded before Flop (didn't bet)
Seat 2: o3zvoO+PsqGti+1NZGNRrQ folded on the Flop
Seat 3: q4GZp0xt5Unxtq8PS32SAQ folded before Flop (didn't bet)
Seat 4: IGRfskE1v9H9Bn+fz8AgNQ folded before Flop (didn't bet)
Seat 5: V6p0jQ/RhUsqpHLmXvEX4Q (button) collected ($4.65)
Seat 6: zDrucyjVn5aeekNEc3cJrA (small blind) folded before Flop
Seat 8: MrPo4/ymXwg9lzPRybrXbA (big blind) folded before Flop
Seat 9: DnDcAdn9P0zGovMERigpFA folded before Flop (didn't bet)




PokerStars Game #59939695916:  Hold'em No Limit ($0.10/$0.25) - 2009/07/01 0:46:32 ET
Table 'WEMI3Mtn7dGARDbgNrKibg' 9-max Seat #7 is the button
Seat 1: 7cv+9Zc9HIQHNvYsMfV3uA ($25 in chips) 
Seat 2: tYsOBqdU1+x+yFI7zHO7hQ ($46.20 in chips) 
Seat 3: jZaChyamGXWcP+qALPP5Jg ($29.45 in chips) 
Seat 4: yyG4svzOpC1A+sUP/scg6w ($7.25 in chips) 
Seat 6: VBHxUExRAMrbxUq/cVx9Gw ($4.65 in chips) 
Seat 7: DnDcAdn9P0zGovMERigpFA ($58.65 in chips) 
Seat 8: ghNKXUBl/H+t83JF079ZBA ($27.30 in chips) 
Seat 9: NTamLAiMZ86c5yM04t96LA ($56 in chips) 
ghNKXUBl/H+t83JF079ZBA: posts small blind $0.10
NTamLAiMZ86c5yM04t96LA: posts big blind $0.25
*** HOLE CARDS ***
7cv+9Zc9HIQHNvYsMfV3uA: folds 
tYsOBqdU1+x+yFI7zHO7hQ: folds 
jZaChyamGXWcP+qALPP5Jg: folds 
yyG4svzOpC1A+sUP/scg6w: folds 
VBHxUExRAMrbxUq/cVx9Gw: folds 
DnDcAdn9P0zGovMERigpFA: folds 
ghNKXUBl/H+t83JF079ZBA: folds 
Uncalled bet ($0.15) returned to NTamLAiMZ86c5yM04t96LA
NTamLAiMZ86c5yM04t96LA collected $0.20 from pot
NTamLAiMZ86c5yM04t96LA: doesn't show hand 
*** SUMMARY ***
Total pot $0.20 | Rake $0 
Seat 1: 7cv+9Zc9HIQHNvYsMfV3uA folded before Flop (didn't bet)
Seat 2: tYsOBqdU1+x+yFI7zHO7hQ folded before Flop (didn't bet)
Seat 3: jZaChyamGXWcP+qALPP5Jg folded before Flop (didn't bet)
Seat 4: yyG4svzOpC1A+sUP/scg6w folded before Flop (didn't bet)
Seat 6: VBHxUExRAMrbxUq/cVx9Gw folded before Flop (didn't bet)
Seat 7: DnDcAdn9P0zGovMERigpFA (button) folded before Flop (didn't bet)
Seat 8: ghNKXUBl/H+t83JF079ZBA (small blind) folded before Flop
Seat 9: NTamLAiMZ86c5yM04t96LA (big blind) collected ($0.20)




PokerStars Game #59939695948:  Hold'em No Limit ($0.10/$0.25) - 2009/07/01 0:46:32 ET
Table 'xmJKTGBeWCwutccj3YfupQ' 6-max Seat #2 is the button
Seat 2: BedjMfrlRfPgSq7CXpPAmg ($49.80 in chips) 
Seat 3: FStoHe64SQWqAsjya9pDkQ ($25.55 in chips) 
Seat 5: oBUDUfeUyCbZBsjxHZgSiw ($16.55 in chips) 
Seat 6: lYjWCpfCxX2kgcHY3v4Yow ($25.25 in chips) 
FStoHe64SQWqAsjya9pDkQ: posts small blind $0.10
oBUDUfeUyCbZBsjxHZgSiw: posts big blind $0.25
*** HOLE CARDS ***
lYjWCpfCxX2kgcHY3v4Yow: folds 
BedjMfrlRfPgSq7CXpPAmg: folds 
FStoHe64SQWqAsjya9pDkQ: folds 
Uncalled bet ($0.15) returned to oBUDUfeUyCbZBsjxHZgSiw
oBUDUfeUyCbZBsjxHZgSiw collected $0.20 from pot
*** SUMMARY ***
Total pot $0.20 | Rake $0 
Seat 2: BedjMfrlRfPgSq7CXpPAmg (button) folded before Flop (didn't bet)
Seat 3: FStoHe64SQWqAsjya9pDkQ (small blind) folded before Flop
Seat 5: oBUDUfeUyCbZBsjxHZgSiw (big blind) collected ($0.20)
Seat 6: lYjWCpfCxX2kgcHY3v4Yow folded before Flop (didn't bet)




PokerStars Game #59939695762:  Hold'em No Limit ($0.10/$0.25) - 2009/07/01 0:46:32 ET
Table 'u5gc8WdJbaPqEonQaM8rHA' 9-max Seat #4 is the button
Seat 1: rXm4QDVJt67H20lM6n6Z7Q ($8.35 in chips) 
Seat 4: 7Tiam59GaMYACH/my1qVuw ($24.65 in chips) 
Seat 5: 4y3ZJtAlW/aXjQX7SXyjrQ ($25.30 in chips) 
Seat 8: 9j9dK6T4bnFE4nxAg16ycg ($30.90 in chips) 
4y3ZJtAlW/aXjQX7SXyjrQ: posts small blind $0.10
9j9dK6T4bnFE4nxAg16ycg: posts big blind $0.25
r6hsffOo1iKmaPYKwAZmFw: sits out 
*** HOLE CARDS ***
rXm4QDVJt67H20lM6n6Z7Q: folds 
7Tiam59GaMYACH/my1qVuw: folds 
4y3ZJtAlW/aXjQX7SXyjrQ: raises $0.25 to $0.50
9j9dK6T4bnFE4nxAg16ycg: calls $0.25
*** FLOP *** [As Qd 2d]
4y3ZJtAlW/aXjQX7SXyjrQ: checks 
9j9dK6T4bnFE4nxAg16ycg: checks 
*** TURN *** [As Qd 2d] [Kd]
4y3ZJtAlW/aXjQX7SXyjrQ: checks 
9j9dK6T4bnFE4nxAg16ycg: checks 
*** RIVER *** [As Qd 2d Kd] [5d]
4y3ZJtAlW/aXjQX7SXyjrQ: checks 
9j9dK6T4bnFE4nxAg16ycg: bets $1
4y3ZJtAlW/aXjQX7SXyjrQ: folds 
Uncalled bet ($1) returned to 9j9dK6T4bnFE4nxAg16ycg
9j9dK6T4bnFE4nxAg16ycg collected $0.95 from pot
*** SUMMARY ***
Total pot $1 | Rake $0.05 
Board [As Qd 2d Kd 5d]
Seat 1: rXm4QDVJt67H20lM6n6Z7Q folded before Flop (didn't bet)
Seat 4: 7Tiam59GaMYACH/my1qVuw (button) folded before Flop (didn't bet)
Seat 5: 4y3ZJtAlW/aXjQX7SXyjrQ (small blind) folded on the River
Seat 8: 9j9dK6T4bnFE4nxAg16ycg (big blind) collected ($0.95)




PokerStars Game #59939695990:  Hold'em No Limit ($0.10/$0.25) - 2009/07/01 0:46:33 ET
Table 'sCop8wmj9zlSS2KJqk1QKQ' 9-max Seat #5 is the button
Seat 1: SXqVW4Q0evTUVZG6BbUNIA ($21.55 in chips) 
Seat 2: W4TLQcZ2TiM73eIgpIvlGg ($20.25 in chips) 
Seat 3: OwQek9i+x54ZA6dn6e8qhg ($15 in chips) 
Seat 4: KNrY0Y/j01dK9gZK7dx7QA ($14.55 in chips) 
Seat 5: sD+TKtt36XiiN6jqHiLwDA ($24.50 in chips) 
Seat 6: hZuGwtYmFKPmQ+v1wlmdfA ($47.35 in chips) 
Seat 7: Q2EDbF7VwaTslnRa/mhhHw ($5 in chips) 
Seat 9: tOdE7+08fkUzsTpCnhoPDA ($21.85 in chips) 
hZuGwtYmFKPmQ+v1wlmdfA: posts small blind $0.10
Q2EDbF7VwaTslnRa/mhhHw: posts big blind $0.25
opOCI2p6kW0tINuVaAqmcQ: sits out 
OwQek9i+x54ZA6dn6e8qhg: posts big blind $0.25
*** HOLE CARDS ***
tOdE7+08fkUzsTpCnhoPDA: calls $0.25
SXqVW4Q0evTUVZG6BbUNIA: calls $0.25
W4TLQcZ2TiM73eIgpIvlGg: folds 
OwQek9i+x54ZA6dn6e8qhg: checks 
KNrY0Y/j01dK9gZK7dx7QA: folds 
sD+TKtt36XiiN6jqHiLwDA: calls $0.25
hZuGwtYmFKPmQ+v1wlmdfA: calls $0.15
Q2EDbF7VwaTslnRa/mhhHw: checks 
*** FLOP *** [4h Ad 9h]
hZuGwtYmFKPmQ+v1wlmdfA: checks 
Q2EDbF7VwaTslnRa/mhhHw: checks 
tOdE7+08fkUzsTpCnhoPDA: checks 
SXqVW4Q0evTUVZG6BbUNIA: checks 
OwQek9i+x54ZA6dn6e8qhg: checks 
sD+TKtt36XiiN6jqHiLwDA: checks 
*** TURN *** [4h Ad 9h] [Qh]
hZuGwtYmFKPmQ+v1wlmdfA: checks 
Q2EDbF7VwaTslnRa/mhhHw: checks 
tOdE7+08fkUzsTpCnhoPDA: checks 
SXqVW4Q0evTUVZG6BbUNIA: checks 
OwQek9i+x54ZA6dn6e8qhg: checks 
sD+TKtt36XiiN6jqHiLwDA: checks 
*** RIVER *** [4h Ad 9h Qh] [4c]
hZuGwtYmFKPmQ+v1wlmdfA: checks 
Q2EDbF7VwaTslnRa/mhhHw: checks 
tOdE7+08fkUzsTpCnhoPDA: checks 
SXqVW4Q0evTUVZG6BbUNIA: checks 
OwQek9i+x54ZA6dn6e8qhg: checks 
sD+TKtt36XiiN6jqHiLwDA: checks 
*** SHOW DOWN ***
hZuGwtYmFKPmQ+v1wlmdfA: shows [Qc Ks] (two pair, Queens and Fours)
Q2EDbF7VwaTslnRa/mhhHw: mucks hand 
tOdE7+08fkUzsTpCnhoPDA: mucks hand 
SXqVW4Q0evTUVZG6BbUNIA: shows [Jd Qd] (two pair, Queens and Fours)
OwQek9i+x54ZA6dn6e8qhg: mucks hand 
sD+TKtt36XiiN6jqHiLwDA: mucks hand 
hZuGwtYmFKPmQ+v1wlmdfA collected $0.75 from pot
SXqVW4Q0evTUVZG6BbUNIA collected $0.70 from pot
*** SUMMARY ***
Total pot $1.50 | Rake $0.05 
Board [4h Ad 9h Qh 4c]
Seat 1: SXqVW4Q0evTUVZG6BbUNIA showed [Jd Qd] and won ($0.70) with two pair, Queens and Fours
Seat 2: W4TLQcZ2TiM73eIgpIvlGg folded before Flop (didn't bet)
Seat 3: OwQek9i+x54ZA6dn6e8qhg mucked
Seat 4: KNrY0Y/j01dK9gZK7dx7QA folded before Flop (didn't bet)
Seat 5: sD+TKtt36XiiN6jqHiLwDA (button) mucked
Seat 6: hZuGwtYmFKPmQ+v1wlmdfA (small blind) showed [Qc Ks] and won ($0.75) with two pair, Queens and Fours
Seat 7: Q2EDbF7VwaTslnRa/mhhHw (big blind) mucked
Seat 9: tOdE7+08fkUzsTpCnhoPDA mucked




PokerStars Game #59939696006:  Hold'em No Limit ($0.10/$0.25) - 2009/07/01 0:46:33 ET
Table '1zj0+miaIL9cvwnT/50pOA' 9-max Seat #2 is the button
Seat 1: spidnpwmoJ1L6yeNW7D5UA ($33 in chips) 
Seat 2: HPEB+AtKw1+C/cxU0o1ciw ($28.10 in chips) 
Seat 3: CYkY0dNBaYaKs8HVCVn3mQ ($6.25 in chips) 
Seat 4: 6esz1u5YivjsX0UoeMBm3w ($23.20 in chips) 
Seat 6: ydoFOVgzvZv9ZhuWu9rXAw ($5 in chips) 
Seat 7: 6oWOdVz2WG2azNuOj9rMgg ($14.20 in chips) 
Seat 8: HOiu48bZMhEZSoJa8mjiMw ($31.15 in chips) 
Seat 9: OiV1PWZ3IkN29JlmCcnTwQ ($5.25 in chips) 
CYkY0dNBaYaKs8HVCVn3mQ: posts small blind $0.10
6esz1u5YivjsX0UoeMBm3w: posts big blind $0.25
DbN2dZXDtMsRORFhREVeJA: sits out 
*** HOLE CARDS ***
ydoFOVgzvZv9ZhuWu9rXAw: folds 
6oWOdVz2WG2azNuOj9rMgg: folds 
HOiu48bZMhEZSoJa8mjiMw: calls $0.25
OiV1PWZ3IkN29JlmCcnTwQ: folds 
spidnpwmoJ1L6yeNW7D5UA: folds 
HPEB+AtKw1+C/cxU0o1ciw: folds 
CYkY0dNBaYaKs8HVCVn3mQ: calls $0.15
6esz1u5YivjsX0UoeMBm3w: checks 
*** FLOP *** [7s 5h 5c]
CYkY0dNBaYaKs8HVCVn3mQ: checks 
6esz1u5YivjsX0UoeMBm3w: bets $0.50
HOiu48bZMhEZSoJa8mjiMw: calls $0.50
CYkY0dNBaYaKs8HVCVn3mQ: folds 
*** TURN *** [7s 5h 5c] [Ks]
6esz1u5YivjsX0UoeMBm3w: checks 
HOiu48bZMhEZSoJa8mjiMw: checks 
*** RIVER *** [7s 5h 5c Ks] [4d]
6esz1u5YivjsX0UoeMBm3w: bets $1
HOiu48bZMhEZSoJa8mjiMw: raises $1.50 to $2.50
6esz1u5YivjsX0UoeMBm3w: calls $1.50
*** SHOW DOWN ***
HOiu48bZMhEZSoJa8mjiMw: shows [5s Ts] (three of a kind, Fives)
6esz1u5YivjsX0UoeMBm3w: mucks hand 
HOiu48bZMhEZSoJa8mjiMw collected $6.45 from pot
*** SUMMARY ***
Total pot $6.75 | Rake $0.30 
Board [7s 5h 5c Ks 4d]
Seat 1: spidnpwmoJ1L6yeNW7D5UA folded before Flop (didn't bet)
Seat 2: HPEB+AtKw1+C/cxU0o1ciw (button) folded before Flop (didn't bet)
Seat 3: CYkY0dNBaYaKs8HVCVn3mQ (small blind) folded on the Flop
Seat 4: 6esz1u5YivjsX0UoeMBm3w (big blind) mucked
Seat 6: ydoFOVgzvZv9ZhuWu9rXAw folded before Flop (didn't bet)
Seat 7: 6oWOdVz2WG2azNuOj9rMgg folded before Flop (didn't bet)
Seat 8: HOiu48bZMhEZSoJa8mjiMw showed [5s Ts] and won ($6.45) with three of a kind, Fives
Seat 9: OiV1PWZ3IkN29JlmCcnTwQ folded before Flop (didn't bet)




PokerStars Game #59939696038:  Hold'em No Limit ($0.10/$0.25) - 2009/07/01 0:46:33 ET
Table 'HQOv+27sJF7e8+zUsBlT2w' 9-max Seat #1 is the button
Seat 1: CbXUS6Z2rXZxL1AKduNtmQ ($25.75 in chips) 
Seat 2: MG90wfSJZnOejs/KD3vlQQ ($25.25 in chips) 
Seat 3: 18G4P1XstjNvItdGUITxgw ($29.45 in chips) 
Seat 4: kRW/Cdh6F1t40Vs43OFbYA ($16.85 in chips) 
Seat 5: nD+0ILJGeuYzreVIK9/wcA ($16.85 in chips) 
Seat 6: vZGoOTJLQLhkPj4I+LNGig ($30.25 in chips) 
Seat 7: GmzfAfxcxu1kGbPC+9LkVg ($24.05 in chips) 
Seat 8: RaXCy4DBrUrZSg4MF8FyDg ($13.55 in chips) 
Seat 9: gehe91e0IyVT0QU/XBkEyg ($25 in chips) 
MG90wfSJZnOejs/KD3vlQQ: posts small blind $0.10
18G4P1XstjNvItdGUITxgw: posts big blind $0.25
*** HOLE CARDS ***
kRW/Cdh6F1t40Vs43OFbYA: folds 
nD+0ILJGeuYzreVIK9/wcA: folds 
vZGoOTJLQLhkPj4I+LNGig: folds 
GmzfAfxcxu1kGbPC+9LkVg: calls $0.25
RaXCy4DBrUrZSg4MF8FyDg: calls $0.25
gehe91e0IyVT0QU/XBkEyg: folds 
CbXUS6Z2rXZxL1AKduNtmQ: folds 
MG90wfSJZnOejs/KD3vlQQ: calls $0.15
18G4P1XstjNvItdGUITxgw: checks 
*** FLOP *** [4s Ts 8d]
MG90wfSJZnOejs/KD3vlQQ: checks 
18G4P1XstjNvItdGUITxgw: checks 
GmzfAfxcxu1kGbPC+9LkVg: checks 
RaXCy4DBrUrZSg4MF8FyDg: bets $0.50
MG90wfSJZnOejs/KD3vlQQ: folds 
18G4P1XstjNvItdGUITxgw: folds 
GmzfAfxcxu1kGbPC+9LkVg: folds 
Uncalled bet ($0.50) returned to RaXCy4DBrUrZSg4MF8FyDg
RaXCy4DBrUrZSg4MF8FyDg collected $0.95 from pot
RaXCy4DBrUrZSg4MF8FyDg: doesn't show hand 
*** SUMMARY ***
Total pot $1 | Rake $0.05 
Board [4s Ts 8d]
Seat 1: CbXUS6Z2rXZxL1AKduNtmQ (button) folded before Flop (didn't bet)
Seat 2: MG90wfSJZnOejs/KD3vlQQ (small blind) folded on the Flop
Seat 3: 18G4P1XstjNvItdGUITxgw (big blind) folded on the Flop
Seat 4: kRW/Cdh6F1t40Vs43OFbYA folded before Flop (didn't bet)
Seat 5: nD+0ILJGeuYzreVIK9/wcA folded before Flop (didn't bet)
Seat 6: vZGoOTJLQLhkPj4I+LNGig folded before Flop (didn't bet)
Seat 7: GmzfAfxcxu1kGbPC+9LkVg folded on the Flop
Seat 8: RaXCy4DBrUrZSg4MF8FyDg collected ($0.95)
Seat 9: gehe91e0IyVT0QU/XBkEyg folded before Flop (didn't bet)




PokerStars Game #59939696186:  Hold'em No Limit ($0.10/$0.25) - 2009/07/01 0:46:33 ET
Table '63h13e5p7cWe02rClZ1CHw' 6-max Seat #6 is the button
Seat 1: 7VfhiFY533nbUKvyEthASw ($7.90 in chips) 
Seat 2: k9nHZTHt8hYhYRcW8NTb4g ($21 in chips) 
Seat 3: 9jSiy0meE9XJKkdIZwyTEQ ($34.25 in chips) 
Seat 4: myagrRAhs0mdgmh5GNqvCw ($4 in chips) 
Seat 5: bE34il0XYGjWPD5/vbkMaQ ($22.15 in chips) 
Seat 6: mfrkWA3PTeYPkbO6hi98Aw ($22.15 in chips) 
7VfhiFY533nbUKvyEthASw: posts small blind $0.10
k9nHZTHt8hYhYRcW8NTb4g: posts big blind $0.25
*** HOLE CARDS ***
9jSiy0meE9XJKkdIZwyTEQ: folds 
myagrRAhs0mdgmh5GNqvCw: folds 
bE34il0XYGjWPD5/vbkMaQ: calls $0.25
mfrkWA3PTeYPkbO6hi98Aw: folds 
7VfhiFY533nbUKvyEthASw: calls $0.15
k9nHZTHt8hYhYRcW8NTb4g: checks 
*** FLOP *** [3d Td 8h]
7VfhiFY533nbUKvyEthASw: checks 
k9nHZTHt8hYhYRcW8NTb4g: checks 
bE34il0XYGjWPD5/vbkMaQ: checks 
*** TURN *** [3d Td 8h] [Ts]
7VfhiFY533nbUKvyEthASw: checks 
k9nHZTHt8hYhYRcW8NTb4g: checks 
bE34il0XYGjWPD5/vbkMaQ: checks 
*** RIVER *** [3d Td 8h Ts] [Kd]
7VfhiFY533nbUKvyEthASw: checks 
k9nHZTHt8hYhYRcW8NTb4g: checks 
bE34il0XYGjWPD5/vbkMaQ: checks 
*** SHOW DOWN ***
7VfhiFY533nbUKvyEthASw: shows [9h 7s] (a pair of Tens)
k9nHZTHt8hYhYRcW8NTb4g: shows [6c Ad] (a pair of Tens - Ace kicker)
bE34il0XYGjWPD5/vbkMaQ: shows [2d 2s] (two pair, Tens and Deuces)
bE34il0XYGjWPD5/vbkMaQ collected $0.75 from pot
*** SUMMARY ***
Total pot $0.75 | Rake $0 
Board [3d Td 8h Ts Kd]
Seat 1: 7VfhiFY533nbUKvyEthASw (small blind) showed [9h 7s] and lost with a pair of Tens
Seat 2: k9nHZTHt8hYhYRcW8NTb4g (big blind) showed [6c Ad] and lost with a pair of Tens
Seat 3: 9jSiy0meE9XJKkdIZwyTEQ folded before Flop (didn't bet)
Seat 4: myagrRAhs0mdgmh5GNqvCw folded before Flop (didn't bet)
Seat 5: bE34il0XYGjWPD5/vbkMaQ showed [2d 2s] and won ($0.75) with two pair, Tens and Deuces
Seat 6: mfrkWA3PTeYPkbO6hi98Aw (button) folded before Flop (didn't bet)




PokerStars Game #59939696438:  Hold'em No Limit ($0.10/$0.25) - 2009/07/01 0:46:33 ET
Table 'fIMYcWwN4/aXFJvH5Z8Ymg' 6-max Seat #4 is the button
Seat 1: 64ZeDpsBsP594VsWmafRTQ ($8.20 in chips) 
Seat 2: vu2kzHaDtgr6NM7rdq0chA ($28.90 in chips) 
Seat 3: bWbV4MVB/vVpiES1Ut4hew ($46.25 in chips) 
Seat 4: 32YL2ZEp8NT4JB2RVM9euQ ($42.55 in chips) 
Seat 5: 9jSiy0meE9XJKkdIZwyTEQ ($31.80 in chips) 
Seat 6: jp34e617tIzV8tKIWmfAbA ($25.35 in chips) 
9jSiy0meE9XJKkdIZwyTEQ: posts small blind $0.10
jp34e617tIzV8tKIWmfAbA: posts big blind $0.25
*** HOLE CARDS ***
64ZeDpsBsP594VsWmafRTQ: folds 
vu2kzHaDtgr6NM7rdq0chA: folds 
bWbV4MVB/vVpiES1Ut4hew: folds 
32YL2ZEp8NT4JB2RVM9euQ: folds 
9jSiy0meE9XJKkdIZwyTEQ: raises $0.60 to $0.85
jp34e617tIzV8tKIWmfAbA: folds 
Uncalled bet ($0.60) returned to 9jSiy0meE9XJKkdIZwyTEQ
9jSiy0meE9XJKkdIZwyTEQ collected $0.50 from pot
9jSiy0meE9XJKkdIZwyTEQ: doesn't show hand 
*** SUMMARY ***
Total pot $0.50 | Rake $0 
Seat 1: 64ZeDpsBsP594VsWmafRTQ folded before Flop (didn't bet)
Seat 2: vu2kzHaDtgr6NM7rdq0chA folded before Flop (didn't bet)
Seat 3: bWbV4MVB/vVpiES1Ut4hew folded before Flop (didn't bet)
Seat 4: 32YL2ZEp8NT4JB2RVM9euQ (button) folded before Flop (didn't bet)
Seat 5: 9jSiy0meE9XJKkdIZwyTEQ (small blind) collected ($0.50)
Seat 6: jp34e617tIzV8tKIWmfAbA (big blind) folded before Flop




PokerStars Game #59939696166:  Hold'em No Limit ($0.10/$0.25) - 2009/07/01 0:46:33 ET
Table '9o8Yb3JpUqurD4pNVmOikQ' 6-max Seat #1 is the button
Seat 1: 5tB0F9NjPSUL4FzmzBMs2Q ($25.35 in chips) 
Seat 2: /gJNBeCkWL4o85/jvlZ4BA ($25 in chips) 
Seat 3: JgRqo1/2phbf7pab7N3BIQ ($13.90 in chips) 
Seat 5: E/9GotBXacjJ6UrYx7l+KQ ($5 in chips) 
Seat 6: k9vn40MOqqb+xF+7GZ6v2g ($33.80 in chips) 
/gJNBeCkWL4o85/jvlZ4BA: posts small blind $0.10
JgRqo1/2phbf7pab7N3BIQ: posts big blind $0.25
4kWQxGbT5FZ1dkPd1bE45Q: sits out 
E/9GotBXacjJ6UrYx7l+KQ: posts big blind $0.25
*** HOLE CARDS ***
E/9GotBXacjJ6UrYx7l+KQ: checks 
k9vn40MOqqb+xF+7GZ6v2g: calls $0.25
5tB0F9NjPSUL4FzmzBMs2Q: folds 
/gJNBeCkWL4o85/jvlZ4BA: calls $0.15
JgRqo1/2phbf7pab7N3BIQ: raises $0.50 to $0.75
E/9GotBXacjJ6UrYx7l+KQ: folds 
k9vn40MOqqb+xF+7GZ6v2g: folds 
/gJNBeCkWL4o85/jvlZ4BA: calls $0.50
*** FLOP *** [8h 2h 6h]
/gJNBeCkWL4o85/jvlZ4BA: checks 
JgRqo1/2phbf7pab7N3BIQ: bets $2
/gJNBeCkWL4o85/jvlZ4BA: folds 
Uncalled bet ($2) returned to JgRqo1/2phbf7pab7N3BIQ
JgRqo1/2phbf7pab7N3BIQ collected $1.90 from pot
*** SUMMARY ***
Total pot $2 | Rake $0.10 
Board [8h 2h 6h]
Seat 1: 5tB0F9NjPSUL4FzmzBMs2Q (button) folded before Flop (didn't bet)
Seat 2: /gJNBeCkWL4o85/jvlZ4BA (small blind) folded on the Flop
Seat 3: JgRqo1/2phbf7pab7N3BIQ (big blind) collected ($1.90)
Seat 5: E/9GotBXacjJ6UrYx7l+KQ folded before Flop
Seat 6: k9vn40MOqqb+xF+7GZ6v2g folded before Flop




PokerStars Game #59939697016:  Hold'em No Limit ($0.10/$0.25) - 2009/07/01 0:46:34 ET
Table 'L5GvbdQO5aCZJSE6pyQ8OA' 6-max Seat #1 is the button
Seat 1: FOcO5GvOP3rgvLGPLVkg5g ($31.85 in chips) 
Seat 2: LxehwDpTQ19ph4Qmc78+Pw ($12.90 in chips) 
Seat 3: awQwF96aCUBjOczgehY95A ($10.40 in chips) 
Seat 4: ErIN0JRL5srYjT6en1f8YQ ($34.25 in chips) 
Seat 6: v+QfkGiuj9bgtuNoVnDO8w ($35.80 in chips) 
LxehwDpTQ19ph4Qmc78+Pw: posts small blind $0.10
awQwF96aCUBjOczgehY95A: posts big blind $0.25
4kWQxGbT5FZ1dkPd1bE45Q: sits out 
*** HOLE CARDS ***
ErIN0JRL5srYjT6en1f8YQ: folds 
v+QfkGiuj9bgtuNoVnDO8w: raises $0.75 to $1
FOcO5GvOP3rgvLGPLVkg5g: folds 
LxehwDpTQ19ph4Qmc78+Pw: folds 
awQwF96aCUBjOczgehY95A: calls $0.75
*** FLOP *** [3c 4c 6c]
awQwF96aCUBjOczgehY95A: checks 
v+QfkGiuj9bgtuNoVnDO8w: bets $1.50
awQwF96aCUBjOczgehY95A: calls $1.50
*** TURN *** [3c 4c 6c] [Kh]
awQwF96aCUBjOczgehY95A: checks 
v+QfkGiuj9bgtuNoVnDO8w: bets $3.50
awQwF96aCUBjOczgehY95A: folds 
Uncalled bet ($3.50) returned to v+QfkGiuj9bgtuNoVnDO8w
v+QfkGiuj9bgtuNoVnDO8w collected $4.85 from pot
v+QfkGiuj9bgtuNoVnDO8w: doesn't show hand 
*** SUMMARY ***
Total pot $5.10 | Rake $0.25 
Board [3c 4c 6c Kh]
Seat 1: FOcO5GvOP3rgvLGPLVkg5g (button) folded before Flop (didn't bet)
Seat 2: LxehwDpTQ19ph4Qmc78+Pw (small blind) folded before Flop
Seat 3: awQwF96aCUBjOczgehY95A (big blind) folded on the Turn
Seat 4: ErIN0JRL5srYjT6en1f8YQ folded before Flop (didn't bet)
Seat 6: v+QfkGiuj9bgtuNoVnDO8w collected ($4.85)




PokerStars Game #59939696852:  Hold'em No Limit ($0.10/$0.25) - 2009/07/01 0:46:34 ET
Table 'gZetDqJh6q9A3mLO3ThCsAnc6OeGk/wtaWV+6N+kgnZQSeat #6 is the button
Seat 1: 1YCU970EVCcjs4GQP5Zt0g ($11.40 in chips) 
Seat 2: JFIAqU8lCZ0vWwEl4bdGsg ($25 in chips) 
Seat 4: eHsmIvAb2JREg4O6hNPnXg ($9.60 in chips) 
Seat 5: mfrkWA3PTeYPkbO6hi98Aw ($45.70 in chips) 
Seat 6: R1hR3/XSBdOHwcbSUJRJbg ($61.65 in chips) 
1YCU970EVCcjs4GQP5Zt0g: posts small blind $0.10
JFIAqU8lCZ0vWwEl4bdGsg: posts big blind $0.25
jp34e617tIzV8tKIWmfAbA: sits out 
*** HOLE CARDS ***
eHsmIvAb2JREg4O6hNPnXg: raises $0.75 to $1
mfrkWA3PTeYPkbO6hi98Aw: folds 
R1hR3/XSBdOHwcbSUJRJbg: folds 
1YCU970EVCcjs4GQP5Zt0g: folds 
JFIAqU8lCZ0vWwEl4bdGsg: folds 
Uncalled bet ($0.75) returned to eHsmIvAb2JREg4O6hNPnXg
eHsmIvAb2JREg4O6hNPnXg collected $0.60 from pot
*** SUMMARY ***
Total pot $0.60 | Rake $0 
Seat 1: 1YCU970EVCcjs4GQP5Zt0g (small blind) folded before Flop
Seat 2: JFIAqU8lCZ0vWwEl4bdGsg (big blind) folded before Flop
Seat 4: eHsmIvAb2JREg4O6hNPnXg collected ($0.60)
Seat 5: mfrkWA3PTeYPkbO6hi98Aw folded before Flop (didn't bet)
Seat 6: R1hR3/XSBdOHwcbSUJRJbg (button) folded before Flop (didn't bet)




PokerStars Game #59939696658:  Hold'em No Limit ($0.10/$0.25) - 2009/07/01 0:46:34 ET
Table '2VkNDXXsBj4bSZw/uK5atw' 6-max Seat #2 is the button
Seat 1: 7FmwVDcdEtxDpHmP4hOXsQ ($25.90 in chips) 
Seat 2: gqW2aBCmrIw65BvwjTFN6Q ($29.30 in chips) 
Seat 3: 8D0jr3B4e++Q/cTSnpHdzg ($15.45 in chips) 
Seat 4: yb6rnd48JuBccThV68VHAQ ($70.05 in chips) 
Seat 5: kyRaCIljYA6l33lSKQfNsg ($25 in chips) 
Seat 6: qGHGf/553gQnDoklMRe3tg ($24.90 in chips) 
8D0jr3B4e++Q/cTSnpHdzg: posts small blind $0.10
yb6rnd48JuBccThV68VHAQ: posts big blind $0.25
*** HOLE CARDS ***
kyRaCIljYA6l33lSKQfNsg: folds 
qGHGf/553gQnDoklMRe3tg: folds 
7FmwVDcdEtxDpHmP4hOXsQ: folds 
gqW2aBCmrIw65BvwjTFN6Q: raises $0.50 to $0.75
8D0jr3B4e++Q/cTSnpHdzg: folds 
yb6rnd48JuBccThV68VHAQ: folds 
Uncalled bet ($0.50) returned to gqW2aBCmrIw65BvwjTFN6Q
gqW2aBCmrIw65BvwjTFN6Q collected $0.60 from pot
gqW2aBCmrIw65BvwjTFN6Q: doesn't show hand 
*** SUMMARY ***
Total pot $0.60 | Rake $0 
Seat 1: 7FmwVDcdEtxDpHmP4hOXsQ folded before Flop (didn't bet)
Seat 2: gqW2aBCmrIw65BvwjTFN6Q (button) collected ($0.60)
Seat 3: 8D0jr3B4e++Q/cTSnpHdzg (small blind) folded before Flop
Seat 4: yb6rnd48JuBccThV68VHAQ (big blind) folded before Flop
Seat 5: kyRaCIljYA6l33lSKQfNsg folded before Flop (didn't bet)
Seat 6: qGHGf/553gQnDoklMRe3tg folded before Flop (didn't bet)




PokerStars Game #59939696856:  Hold'em No Limit ($0.10/$0.25) - 2009/07/01 0:46:34 ET
Table 'JUMeG5SzDyo9HufhgemQeA' 9-max Seat #1 is the button
Seat 1: N6fYvIzQLKaydFLKQGtMlQ ($25.30 in chips) 
Seat 3: IEvLSTIxhlti3EjZDarYnA ($28.10 in chips) 
Seat 4: 6OP8CZnSFyny18DZqWIYog ($2.70 in chips) 
Seat 5: TI/C5Q+DEl4fLR3AofwYdg ($16 in chips) 
Seat 6: wFCwdYKUXoQHhz8qeZuuAw ($24.45 in chips) 
Seat 7: aNpwfA31EREwO+ar4XzBCw ($29.30 in chips) 
Seat 8: zDrucyjVn5aeekNEc3cJrA ($36.85 in chips) 
Seat 9: V6p0jQ/RhUsqpHLmXvEX4Q ($12.35 in chips) 
IEvLSTIxhlti3EjZDarYnA: posts small blind $0.10
6OP8CZnSFyny18DZqWIYog: posts big blind $0.25
*** HOLE CARDS ***
TI/C5Q+DEl4fLR3AofwYdg: folds 
wFCwdYKUXoQHhz8qeZuuAw: folds 
aNpwfA31EREwO+ar4XzBCw: folds 
zDrucyjVn5aeekNEc3cJrA: folds 
V6p0jQ/RhUsqpHLmXvEX4Q: folds 
N6fYvIzQLKaydFLKQGtMlQ: folds 
IEvLSTIxhlti3EjZDarYnA: folds 
Uncalled bet ($0.15) returned to 6OP8CZnSFyny18DZqWIYog
6OP8CZnSFyny18DZqWIYog collected $0.20 from pot
6OP8CZnSFyny18DZqWIYog: doesn't show hand 
*** SUMMARY ***
Total pot $0.20 | Rake $0 
Seat 1: N6fYvIzQLKaydFLKQGtMlQ (button) folded before Flop (didn't bet)
Seat 3: IEvLSTIxhlti3EjZDarYnA (small blind) folded before Flop
Seat 4: 6OP8CZnSFyny18DZqWIYog (big blind) collected ($0.20)
Seat 5: TI/C5Q+DEl4fLR3AofwYdg folded before Flop (didn't bet)
Seat 6: wFCwdYKUXoQHhz8qeZuuAw folded before Flop (didn't bet)
Seat 7: aNpwfA31EREwO+ar4XzBCw folded before Flop (didn't bet)
Seat 8: zDrucyjVn5aeekNEc3cJrA folded before Flop (didn't bet)
Seat 9: V6p0jQ/RhUsqpHLmXvEX4Q folded before Flop (didn't bet)




PokerStars Game #59939697004:  Hold'em No Limit ($0.10/$0.25) - 2009/07/01 0:46:34 ET
Table 'nteM56rtr9SxLEblf0fvbw' 9-max Seat #8 is the button
Seat 1: H9KUl8cmpLgEpOVDA00bCg ($9.65 in chips) 
Seat 2: ljemhp25Zg+nlA9DLCIiUw ($25.20 in chips) 
Seat 4: cZ99hugmLBj9KhTlc8nCSw ($25.15 in chips) 
Seat 5: aJy680tKSaP5er559aSuGA ($5.20 in chips) 
Seat 6: LH8Esb23EO9V9GrKx+ymWQ ($6.50 in chips) 
Seat 7: dfNim92Z6XK1/h5SFW5vDg ($49.05 in chips) 
Seat 8: RJ/x9oZtt1RZLaJEQwZOxQ ($43.90 in chips) 
Seat 9: t2nb95S5EEFOEzNx9Itz0g ($6.30 in chips) 
t2nb95S5EEFOEzNx9Itz0g: posts small blind $0.10
H9KUl8cmpLgEpOVDA00bCg: posts big blind $0.25
6RiVTYll/5D8zICp0MRpKw: sits out 
*** HOLE CARDS ***
ljemhp25Zg+nlA9DLCIiUw: folds 
cZ99hugmLBj9KhTlc8nCSw: folds 
aJy680tKSaP5er559aSuGA: calls $0.25
LH8Esb23EO9V9GrKx+ymWQ: folds 
dfNim92Z6XK1/h5SFW5vDg: folds 
RJ/x9oZtt1RZLaJEQwZOxQ: folds 
t2nb95S5EEFOEzNx9Itz0g: folds 
H9KUl8cmpLgEpOVDA00bCg: checks 
*** FLOP *** [5s 6d 3s]
H9KUl8cmpLgEpOVDA00bCg: checks 
aJy680tKSaP5er559aSuGA: checks 
*** TURN *** [5s 6d 3s] [Kc]
H9KUl8cmpLgEpOVDA00bCg: checks 
aJy680tKSaP5er559aSuGA: checks 
*** RIVER *** [5s 6d 3s Kc] [8c]
H9KUl8cmpLgEpOVDA00bCg: checks 
aJy680tKSaP5er559aSuGA: checks 
*** SHOW DOWN ***
H9KUl8cmpLgEpOVDA00bCg: shows [Qd 5c] (a pair of Fives)
aJy680tKSaP5er559aSuGA: mucks hand 
H9KUl8cmpLgEpOVDA00bCg collected $0.60 from pot
*** SUMMARY ***
Total pot $0.60 | Rake $0 
Board [5s 6d 3s Kc 8c]
Seat 1: H9KUl8cmpLgEpOVDA00bCg (big blind) showed [Qd 5c] and won ($0.60) with a pair of Fives
Seat 2: ljemhp25Zg+nlA9DLCIiUw folded before Flop (didn't bet)
Seat 4: cZ99hugmLBj9KhTlc8nCSw folded before Flop (didn't bet)
Seat 5: aJy680tKSaP5er559aSuGA mucked
Seat 6: LH8Esb23EO9V9GrKx+ymWQ folded before Flop (didn't bet)
Seat 7: dfNim92Z6XK1/h5SFW5vDg folded before Flop (didn't bet)
Seat 8: RJ/x9oZtt1RZLaJEQwZOxQ (button) folded before Flop (didn't bet)
Seat 9: t2nb95S5EEFOEzNx9Itz0g (small blind) folded before Flop




PokerStars Game #59939697492:  Hold'em No Limit ($0.10/$0.25) - 2009/07/01 0:46:35 ET
Table 'WEMI3Mtn7dGARDbgNrKibgoG007Tb0LYbfANo6QWd16wx Seat #5 is the button
Seat 1: GEZ4LFjiwTFoPklBgpSnlw ($19.60 in chips) 
Seat 2: zDrucyjVn5aeekNEc3cJrA ($21.90 in chips) 
Seat 3: 56S3mA6Zs3pGR+0p0vUCtg ($24.90 in chips) 
Seat 4: oKO7b50N6TzXbPBr/mcrUA ($25 in chips) 
Seat 5: MIVCHqCqqlke0Lb0z7glcw ($24.30 in chips) 
Seat 7: sUVgUtgbfVx6JpvApozwhQ ($5.10 in chips) 
Seat 8: gehe91e0IyVT0QU/XBkEyg ($25 in chips) 
Seat 9: 86vbuhJsyH+nbEg5qpDLyQ ($25.70 in chips) 
sUVgUtgbfVx6JpvApozwhQ: posts small blind $0.10
gehe91e0IyVT0QU/XBkEyg: posts big blind $0.25
*** HOLE CARDS ***
86vbuhJsyH+nbEg5qpDLyQ: folds 
GEZ4LFjiwTFoPklBgpSnlw: raises $1 to $1.25
zDrucyjVn5aeekNEc3cJrA: folds 
56S3mA6Zs3pGR+0p0vUCtg: folds 
oKO7b50N6TzXbPBr/mcrUA: calls $1.25
MIVCHqCqqlke0Lb0z7glcw: folds 
sUVgUtgbfVx6JpvApozwhQ: folds 
gehe91e0IyVT0QU/XBkEyg: folds 
*** FLOP *** [Kh 4s 2s]
GEZ4LFjiwTFoPklBgpSnlw: checks 
oKO7b50N6TzXbPBr/mcrUA: bets $0.50
GEZ4LFjiwTFoPklBgpSnlw: calls $0.50
*** TURN *** [Kh 4s 2s] [Jc]
GEZ4LFjiwTFoPklBgpSnlw: checks 
oKO7b50N6TzXbPBr/mcrUA: bets $0.25
GEZ4LFjiwTFoPklBgpSnlw: raises $1 to $1.25
oKO7b50N6TzXbPBr/mcrUA: folds 
Uncalled bet ($1) returned to GEZ4LFjiwTFoPklBgpSnlw
GEZ4LFjiwTFoPklBgpSnlw collected $4.15 from pot
GEZ4LFjiwTFoPklBgpSnlw: doesn't show hand 
*** SUMMARY ***
Total pot $4.35 | Rake $0.20 
Board [Kh 4s 2s Jc]
Seat 1: GEZ4LFjiwTFoPklBgpSnlw collected ($4.15)
Seat 2: zDrucyjVn5aeekNEc3cJrA folded before Flop (didn't bet)
Seat 3: 56S3mA6Zs3pGR+0p0vUCtg folded before Flop (didn't bet)
Seat 4: oKO7b50N6TzXbPBr/mcrUA folded on the Turn
Seat 5: MIVCHqCqqlke0Lb0z7glcw (button) folded before Flop (didn't bet)
Seat 7: sUVgUtgbfVx6JpvApozwhQ (small blind) folded before Flop
Seat 8: gehe91e0IyVT0QU/XBkEyg (big blind) folded before Flop
Seat 9: 86vbuhJsyH+nbEg5qpDLyQ folded before Flop (didn't bet)




PokerStars Game #59939697680:  Hold'em No Limit ($0.10/$0.25) - 2009/07/01 0:46:35 ET
Table '8QBBaev+cI2i/r2H6ml/lg' 9-max Seat #6 is the button
Seat 4: ZoG0obuajzVjwgd7lNHjgg ($4 in chips) 
Seat 6: cxE+szmvEUe7vE+z2ozM2Q ($11 in chips) 
cxE+szmvEUe7vE+z2ozM2Q: posts small blind $0.10
ZoG0obuajzVjwgd7lNHjgg: posts big blind $0.25
*** HOLE CARDS ***
cxE+szmvEUe7vE+z2ozM2Q: calls $0.15
ZoG0obuajzVjwgd7lNHjgg: checks 
*** FLOP *** [Qh Jc 2d]
ZoG0obuajzVjwgd7lNHjgg: checks 
cxE+szmvEUe7vE+z2ozM2Q: checks 
*** TURN *** [Qh Jc 2d] [Ks]
ZoG0obuajzVjwgd7lNHjgg: checks 
cxE+szmvEUe7vE+z2ozM2Q: checks 
*** RIVER *** [Qh Jc 2d Ks] [Qd]
ZoG0obuajzVjwgd7lNHjgg: checks 
cxE+szmvEUe7vE+z2ozM2Q: bets $0.75
ZoG0obuajzVjwgd7lNHjgg: folds 
Uncalled bet ($0.75) returned to cxE+szmvEUe7vE+z2ozM2Q
cxE+szmvEUe7vE+z2ozM2Q collected $0.50 from pot
cxE+szmvEUe7vE+z2ozM2Q: doesn't show hand 
*** SUMMARY ***
Total pot $0.50 | Rake $0 
Board [Qh Jc 2d Ks Qd]
Seat 4: ZoG0obuajzVjwgd7lNHjgg (big blind) folded on the River
Seat 6: cxE+szmvEUe7vE+z2ozM2Q (button) (small blind) collected ($0.50)




PokerStars Game #59939697536:  Hold'em No Limit ($0.10/$0.25) - 2009/07/01 0:46:35 ET
Table 'gYBWJG3hEuJg6kphY0yhMg' 9-max Seat #7 is the button
Seat 1: s7Q6uNouhe7aE8JdFb9E+A ($25 in chips) 
Seat 2: z2SmIaQ3+5n/eY1BN5HgPg ($29.15 in chips) 
Seat 3: OkWGxhGhDA0lvNLGWmJxug ($5 in chips) 
Seat 4: V6p0jQ/RhUsqpHLmXvEX4Q ($12.10 in chips) 
Seat 5: +sbyWwIcFp9kP0bDtMegfQ ($24.30 in chips) 
Seat 6: 9AI+W5n0har4qZZPPHsjKg ($4.15 in chips) 
Seat 7: CvL9Ch1HYCVbTsfpNucitg ($4.65 in chips) 
Seat 8: j4q3p0lesp63b1gZDwLBZw ($5.35 in chips) 
Seat 9: DxA2S3LbITR502Wya4qTnw ($2.70 in chips) 
j4q3p0lesp63b1gZDwLBZw: posts small blind $0.10
DxA2S3LbITR502Wya4qTnw: posts big blind $0.25
*** HOLE CARDS ***
s7Q6uNouhe7aE8JdFb9E+A: folds 
z2SmIaQ3+5n/eY1BN5HgPg: folds 
OkWGxhGhDA0lvNLGWmJxug: calls $0.25
V6p0jQ/RhUsqpHLmXvEX4Q: raises $0.75 to $1
+sbyWwIcFp9kP0bDtMegfQ: folds 
9AI+W5n0har4qZZPPHsjKg: folds 
CvL9Ch1HYCVbTsfpNucitg: folds 
j4q3p0lesp63b1gZDwLBZw: folds 
DxA2S3LbITR502Wya4qTnw: folds 
OkWGxhGhDA0lvNLGWmJxug: calls $0.75
*** FLOP *** [Qh 2s 8d]
OkWGxhGhDA0lvNLGWmJxug: checks 
V6p0jQ/RhUsqpHLmXvEX4Q: bets $2
OkWGxhGhDA0lvNLGWmJxug: folds 
Uncalled bet ($2) returned to V6p0jQ/RhUsqpHLmXvEX4Q
V6p0jQ/RhUsqpHLmXvEX4Q collected $2.25 from pot
*** SUMMARY ***
Total pot $2.35 | Rake $0.10 
Board [Qh 2s 8d]
Seat 1: s7Q6uNouhe7aE8JdFb9E+A folded before Flop (didn't bet)
Seat 2: z2SmIaQ3+5n/eY1BN5HgPg folded before Flop (didn't bet)
Seat 3: OkWGxhGhDA0lvNLGWmJxug folded on the Flop
Seat 4: V6p0jQ/RhUsqpHLmXvEX4Q collected ($2.25)
Seat 5: +sbyWwIcFp9kP0bDtMegfQ folded before Flop (didn't bet)
Seat 6: 9AI+W5n0har4qZZPPHsjKg folded before Flop (didn't bet)
Seat 7: CvL9Ch1HYCVbTsfpNucitg (button) folded before Flop (didn't bet)
Seat 8: j4q3p0lesp63b1gZDwLBZw (small blind) folded before Flop
Seat 9: DxA2S3LbITR502Wya4qTnw (big blind) folded before Flop




PokerStars Game #59939697398:  Hold'em No Limit ($0.10/$0.25) - 2009/07/01 0:46:35 ET
Table 'Jz+kWRxWNGk9w24fdQEveA' 9-max Seat #3 is the button
Seat 2: ljemhp25Zg+nlA9DLCIiUw ($31.45 in chips) 
Seat 3: uwmAXQRjyA4iX5kaC15P9A ($4.65 in chips) 
Seat 4: HPEB+AtKw1+C/cxU0o1ciw ($24.20 in chips) 
Seat 5: DdPXdieucQ+n99u1n3A+rQ ($5 in chips) 
Seat 7: st9jtdNbm1W5GfBwRaCVqQ ($29.85 in chips) 
Seat 8: G7adEXZse2f4gqTWfn/C+Q ($11.65 in chips) 
HPEB+AtKw1+C/cxU0o1ciw: posts small blind $0.10
DdPXdieucQ+n99u1n3A+rQ: posts big blind $0.25
boms8cM+kQJF0xGLbvuFtg has returned
V6p0jQ/RhUsqpHLmXvEX4Q: sits out 
*** HOLE CARDS ***
st9jtdNbm1W5GfBwRaCVqQ: calls $0.25
G7adEXZse2f4gqTWfn/C+Q: folds 
ljemhp25Zg+nlA9DLCIiUw: folds 
uwmAXQRjyA4iX5kaC15P9A: folds 
HPEB+AtKw1+C/cxU0o1ciw: calls $0.15
DdPXdieucQ+n99u1n3A+rQ: checks 
*** FLOP *** [Kh 5s Jh]
HPEB+AtKw1+C/cxU0o1ciw: checks 
DdPXdieucQ+n99u1n3A+rQ: checks 
st9jtdNbm1W5GfBwRaCVqQ: bets $0.50
HPEB+AtKw1+C/cxU0o1ciw: folds 
DdPXdieucQ+n99u1n3A+rQ: folds 
Uncalled bet ($0.50) returned to st9jtdNbm1W5GfBwRaCVqQ
st9jtdNbm1W5GfBwRaCVqQ collected $0.75 from pot
st9jtdNbm1W5GfBwRaCVqQ: doesn't show hand 
*** SUMMARY ***
Total pot $0.75 | Rake $0 
Board [Kh 5s Jh]
Seat 2: ljemhp25Zg+nlA9DLCIiUw folded before Flop (didn't bet)
Seat 3: uwmAXQRjyA4iX5kaC15P9A (button) folded before Flop (didn't bet)
Seat 4: HPEB+AtKw1+C/cxU0o1ciw (small blind) folded on the Flop
Seat 5: DdPXdieucQ+n99u1n3A+rQ (big blind) folded on the Flop
Seat 7: st9jtdNbm1W5GfBwRaCVqQ collected ($0.75)
Seat 8: G7adEXZse2f4gqTWfn/C+Q folded before Flop (didn't bet)




PokerStars Game #59939697350:  Hold'em No Limit ($0.10/$0.25) - 2009/07/01 0:46:35 ET
Table 'luMgmRPIo47e7iXDlheIwA' 6-max Seat #4 is the button
Seat 1: z/jAqpWD9ifpbtEpwGyInw ($10.15 in chips) 
Seat 3: W6Y6au0wf7gRAlqJYgOezw ($12.80 in chips) 
Seat 4: n2OZezRXTtdzQt4SuIy8TQ ($22.50 in chips) 
Seat 5: zxeVQGaMKDsDzmSY+AInjA ($14.75 in chips) 
Seat 6: Zb8xGmbjS8ghABxs9n6huA ($15 in chips) 
zxeVQGaMKDsDzmSY+AInjA: posts small blind $0.10
Zb8xGmbjS8ghABxs9n6huA: posts big blind $0.25
hZJzYj+7+PvGu6ae1g//sQ: sits out 
*** HOLE CARDS ***
z/jAqpWD9ifpbtEpwGyInw: folds 
W6Y6au0wf7gRAlqJYgOezw: folds 
n2OZezRXTtdzQt4SuIy8TQ: raises $0.50 to $0.75
zxeVQGaMKDsDzmSY+AInjA: calls $0.65
Zb8xGmbjS8ghABxs9n6huA: calls $0.50
*** FLOP *** [Kh Jh Ad]
zxeVQGaMKDsDzmSY+AInjA: checks 
Zb8xGmbjS8ghABxs9n6huA: checks 
n2OZezRXTtdzQt4SuIy8TQ: checks 
*** TURN *** [Kh Jh Ad] [9d]
zxeVQGaMKDsDzmSY+AInjA: checks 
Zb8xGmbjS8ghABxs9n6huA: checks 
n2OZezRXTtdzQt4SuIy8TQ: bets $1.25
zxeVQGaMKDsDzmSY+AInjA: folds 
Zb8xGmbjS8ghABxs9n6huA: calls $1.25
*** RIVER *** [Kh Jh Ad 9d] [Th]
Zb8xGmbjS8ghABxs9n6huA: checks 
n2OZezRXTtdzQt4SuIy8TQ: bets $2.25
Zb8xGmbjS8ghABxs9n6huA: calls $2.25
*** SHOW DOWN ***
n2OZezRXTtdzQt4SuIy8TQ: shows [5d 5h] (a pair of Fives)
Zb8xGmbjS8ghABxs9n6huA: shows [Js Td] (two pair, Jacks and Tens)
Zb8xGmbjS8ghABxs9n6huA collected $8.80 from pot
*** SUMMARY ***
Total pot $9.25 | Rake $0.45 
Board [Kh Jh Ad 9d Th]
Seat 1: z/jAqpWD9ifpbtEpwGyInw folded before Flop (didn't bet)
Seat 3: W6Y6au0wf7gRAlqJYgOezw folded before Flop (didn't bet)
Seat 4: n2OZezRXTtdzQt4SuIy8TQ (button) showed [5d 5h] and lost with a pair of Fives
Seat 5: zxeVQGaMKDsDzmSY+AInjA (small blind) folded on the Turn
Seat 6: Zb8xGmbjS8ghABxs9n6huA (big blind) showed [Js Td] and won ($8.80) with two pair, Jacks and Tens




PokerStars Game #59939697646:  Hold'em No Limit ($0.10/$0.25) - 2009/07/01 0:46:35 ET
Table 'MJ1SB76A4qJrlEa+C5e/8w' 6-max Seat #2 is the button
Seat 2: UA5OsKS3VPaxa7uC8La/kA ($25 in chips) 
Seat 3: IrrSNlaIjHnZjG6E7LgmEg ($14.70 in chips) 
Seat 4: 6boOPJDTFiEyZD2WdW0kCA ($13.15 in chips) 
Seat 5: eHsmIvAb2JREg4O6hNPnXg ($13.65 in chips) 
Seat 6: JFIAqU8lCZ0vWwEl4bdGsg ($29.80 in chips) 
IrrSNlaIjHnZjG6E7LgmEg: posts small blind $0.10
King Erez100 is connected 
6boOPJDTFiEyZD2WdW0kCA: posts big blind $0.25
*** HOLE CARDS ***
eHsmIvAb2JREg4O6hNPnXg: raises $0.25 to $0.50
JFIAqU8lCZ0vWwEl4bdGsg: calls $0.50
UA5OsKS3VPaxa7uC8La/kA: folds 
IrrSNlaIjHnZjG6E7LgmEg: calls $0.40
6boOPJDTFiEyZD2WdW0kCA: calls $0.25
*** FLOP *** [6h Jc 9s]
IrrSNlaIjHnZjG6E7LgmEg: checks 
6boOPJDTFiEyZD2WdW0kCA: checks 
eHsmIvAb2JREg4O6hNPnXg: bets $1
JFIAqU8lCZ0vWwEl4bdGsg: folds 
IrrSNlaIjHnZjG6E7LgmEg: folds 
6boOPJDTFiEyZD2WdW0kCA: folds 
Uncalled bet ($1) returned to eHsmIvAb2JREg4O6hNPnXg
eHsmIvAb2JREg4O6hNPnXg collected $1.90 from pot
*** SUMMARY ***
Total pot $2 | Rake $0.10 
Board [6h Jc 9s]
Seat 2: UA5OsKS3VPaxa7uC8La/kA (button) folded before Flop (didn't bet)
Seat 3: IrrSNlaIjHnZjG6E7LgmEg (small blind) folded on the Flop
Seat 4: 6boOPJDTFiEyZD2WdW0kCA (big blind) folded on the Flop
Seat 5: eHsmIvAb2JREg4O6hNPnXg collected ($1.90)
Seat 6: JFIAqU8lCZ0vWwEl4bdGsg folded on the Flop




PokerStars Game #59939697476:  Hold'em No Limit ($0.10/$0.25) - 2009/07/01 0:46:35 ET
Table '/JJyyIstHfkT7t/bW+WXgg' 6-max Seat #3 is the button
Seat 1: wsP46AGpqDjHZQmlRHKa9g ($25.05 in chips) 
Seat 3: oc4ZGs0W+3RIg2yPyJw3ig ($25.50 in chips) 
Seat 4: ELW+DKizJhLK7k40PMkD2Q ($25 in chips) 
Seat 5: 2wkoolB4YxxVC2x99F9rcA ($31.65 in chips) 
Seat 6: d338A2rm6NtA1ECEZi4d2g ($16.15 in chips) 
ELW+DKizJhLK7k40PMkD2Q: posts small blind $0.10
2wkoolB4YxxVC2x99F9rcA: posts big blind $0.25
BYxjLnV1/LL0aZcTbfAOvw: sits out 
*** HOLE CARDS ***
2wkoolB4YxxVC2x99F9rcA said, "nf"
d338A2rm6NtA1ECEZi4d2g: folds 
wsP46AGpqDjHZQmlRHKa9g: folds 
oc4ZGs0W+3RIg2yPyJw3ig: raises $0.75 to $1
ELW+DKizJhLK7k40PMkD2Q: folds 
2wkoolB4YxxVC2x99F9rcA: folds 
Uncalled bet ($0.75) returned to oc4ZGs0W+3RIg2yPyJw3ig
oc4ZGs0W+3RIg2yPyJw3ig collected $0.60 from pot
*** SUMMARY ***
Total pot $0.60 | Rake $0 
Seat 1: wsP46AGpqDjHZQmlRHKa9g folded before Flop (didn't bet)
Seat 3: oc4ZGs0W+3RIg2yPyJw3ig (button) collected ($0.60)
Seat 4: ELW+DKizJhLK7k40PMkD2Q (small blind) folded before Flop
Seat 5: 2wkoolB4YxxVC2x99F9rcA (big blind) folded before Flop
Seat 6: d338A2rm6NtA1ECEZi4d2g folded before Flop (didn't bet)




PokerStars Game #59939697658:  Hold'em No Limit ($0.10/$0.25) - 2009/07/01 0:46:35 ET
Table 'JYkCJJ5Iv+Tu52jx2lpEcgT/iCKJXGphRN3xcdwfE/JQSeat #3 is the button
Seat 1: Yv4fucyyT28mjx8V5lxKJg ($30 in chips) 
Seat 2: hBMUlEpyU74r/fwDgIpXjQ ($35.25 in chips) 
Seat 3: Z5ZtGOON8kmSdSCll9Z3XA ($8 in chips) 
Seat 5: 6OVSxS1KoddUCYNkZ4hREw ($30.35 in chips) 
Seat 6: OiV1PWZ3IkN29JlmCcnTwQ ($4.65 in chips) 
Seat 7: N6fYvIzQLKaydFLKQGtMlQ ($22.30 in chips) 
Seat 9: H9KUl8cmpLgEpOVDA00bCg ($5.85 in chips) 
6OVSxS1KoddUCYNkZ4hREw: posts small blind $0.10
OiV1PWZ3IkN29JlmCcnTwQ: posts big blind $0.25
6RiVTYll/5D8zICp0MRpKw: sits out 
*** HOLE CARDS ***
N6fYvIzQLKaydFLKQGtMlQ: folds 
H9KUl8cmpLgEpOVDA00bCg: folds 
Yv4fucyyT28mjx8V5lxKJg: folds 
hBMUlEpyU74r/fwDgIpXjQ: raises $0.50 to $0.75
Z5ZtGOON8kmSdSCll9Z3XA: calls $0.75
6OVSxS1KoddUCYNkZ4hREw: raises $2.25 to $3
OiV1PWZ3IkN29JlmCcnTwQ: folds 
hBMUlEpyU74r/fwDgIpXjQ: calls $2.25
Z5ZtGOON8kmSdSCll9Z3XA: calls $2.25
*** FLOP *** [Th 3h 6s]
6OVSxS1KoddUCYNkZ4hREw: checks 
hBMUlEpyU74r/fwDgIpXjQ: bets $4
Z5ZtGOON8kmSdSCll9Z3XA: folds 
6OVSxS1KoddUCYNkZ4hREw: calls $4
*** TURN *** [Th 3h 6s] [8h]
6OVSxS1KoddUCYNkZ4hREw: checks 
Yv4fucyyT28mjx8V5lxKJg leaves the table
hBMUlEpyU74r/fwDgIpXjQ: bets $8
6OVSxS1KoddUCYNkZ4hREw: folds 
Uncalled bet ($8) returned to hBMUlEpyU74r/fwDgIpXjQ
hBMUlEpyU74r/fwDgIpXjQ collected $16.45 from pot
*** SUMMARY ***
Total pot $17.25 | Rake $0.80 
Board [Th 3h 6s 8h]
Seat 1: Yv4fucyyT28mjx8V5lxKJg folded before Flop (didn't bet)
Seat 2: hBMUlEpyU74r/fwDgIpXjQ collected ($16.45)
Seat 3: Z5ZtGOON8kmSdSCll9Z3XA (button) folded on the Flop
Seat 5: 6OVSxS1KoddUCYNkZ4hREw (small blind) folded on the Turn
Seat 6: OiV1PWZ3IkN29JlmCcnTwQ (big blind) folded before Flop
Seat 7: N6fYvIzQLKaydFLKQGtMlQ folded before Flop (didn't bet)
Seat 9: H9KUl8cmpLgEpOVDA00bCg folded before Flop (didn't bet)




PokerStars Game #59939697918:  Hold'em No Limit ($0.10/$0.25) - 2009/07/01 0:46:36 ET
Table '9SExUHslNkrPJ4XsrePaVw' 9-max Seat #1 is the button
Seat 1: qpbN+BUWX0f/ckQSmOcmkw ($7.25 in chips) 
Seat 3: jeKWRUkMaVn8rEUjnJKqpg ($31.65 in chips) 
Seat 4: dyNjB7p93gTjZ0RXn2HnJA ($21.50 in chips) 
Seat 6: DYB0aP91n+Rg/TIhycbaPQ ($7.95 in chips) 
Seat 7: 7cv+9Zc9HIQHNvYsMfV3uA ($25 in chips) 
Seat 8: t2nb95S5EEFOEzNx9Itz0g ($7.80 in chips) 
Seat 9: /THNzAxdv2lBxcf4XTj/0g ($15.10 in chips) 
jeKWRUkMaVn8rEUjnJKqpg: posts small blind $0.10
dyNjB7p93gTjZ0RXn2HnJA: posts big blind $0.25
ydoFOVgzvZv9ZhuWu9rXAw: sits out 
*** HOLE CARDS ***
DYB0aP91n+Rg/TIhycbaPQ: calls $0.25
7cv+9Zc9HIQHNvYsMfV3uA: folds 
t2nb95S5EEFOEzNx9Itz0g: folds 
/THNzAxdv2lBxcf4XTj/0g: calls $0.25
qpbN+BUWX0f/ckQSmOcmkw: folds 
jeKWRUkMaVn8rEUjnJKqpg: folds 
dyNjB7p93gTjZ0RXn2HnJA: checks 
*** FLOP *** [5d 9d Qc]
dyNjB7p93gTjZ0RXn2HnJA: checks 
DYB0aP91n+Rg/TIhycbaPQ: bets $0.25
/THNzAxdv2lBxcf4XTj/0g: calls $0.25
dyNjB7p93gTjZ0RXn2HnJA: calls $0.25
*** TURN *** [5d 9d Qc] [8c]
dyNjB7p93gTjZ0RXn2HnJA: checks 
DYB0aP91n+Rg/TIhycbaPQ: bets $0.25
/THNzAxdv2lBxcf4XTj/0g: raises $1 to $1.25
dyNjB7p93gTjZ0RXn2HnJA: folds 
DYB0aP91n+Rg/TIhycbaPQ: folds 
Uncalled bet ($1) returned to /THNzAxdv2lBxcf4XTj/0g
/THNzAxdv2lBxcf4XTj/0g collected $2 from pot
/THNzAxdv2lBxcf4XTj/0g: doesn't show hand 
*** SUMMARY ***
Total pot $2.10 | Rake $0.10 
Board [5d 9d Qc 8c]
Seat 1: qpbN+BUWX0f/ckQSmOcmkw (button) folded before Flop (didn't bet)
Seat 3: jeKWRUkMaVn8rEUjnJKqpg (small blind) folded before Flop
Seat 4: dyNjB7p93gTjZ0RXn2HnJA (big blind) folded on the Turn
Seat 6: DYB0aP91n+Rg/TIhycbaPQ folded on the Turn
Seat 7: 7cv+9Zc9HIQHNvYsMfV3uA folded before Flop (didn't bet)
Seat 8: t2nb95S5EEFOEzNx9Itz0g folded before Flop (didn't bet)
Seat 9: /THNzAxdv2lBxcf4XTj/0g collected ($2)




PokerStars Game #59939698232:  Hold'em No Limit ($0.10/$0.25) - 2009/07/01 0:46:36 ET
Table 'l8hUTjBTXBorNUR/tyvSLw' 9-max Seat #6 is the button
Seat 3: 6TWO15+WfJ5HfI8CbJ4a0w ($8.80 in chips) 
Seat 4: vPtFvcPtn/Afz0sucO1cmQ ($37.20 in chips) 
Seat 5: S7Ki0P+0AIGPuIfGJjW0gg ($15.35 in chips) 
Seat 6: nkD1GtC3+ft+4U3Od0H10A ($12.70 in chips) 
Seat 7: awxYB5n5W4JUl1V4Xsn26g ($4.40 in chips) 
Seat 8: kZJjw0YSgO2CZKraCg0v8g ($12.40 in chips) 
Seat 9: zDrucyjVn5aeekNEc3cJrA ($35.75 in chips) 
awxYB5n5W4JUl1V4Xsn26g: posts small blind $0.10
kZJjw0YSgO2CZKraCg0v8g: posts big blind $0.25
cZ99hugmLBj9KhTlc8nCSw: sits out 
*** HOLE CARDS ***
zDrucyjVn5aeekNEc3cJrA: folds 
6TWO15+WfJ5HfI8CbJ4a0w: folds 
vPtFvcPtn/Afz0sucO1cmQ: folds 
S7Ki0P+0AIGPuIfGJjW0gg: folds 
nkD1GtC3+ft+4U3Od0H10A: folds 
awxYB5n5W4JUl1V4Xsn26g: folds 
Uncalled bet ($0.15) returned to kZJjw0YSgO2CZKraCg0v8g
kZJjw0YSgO2CZKraCg0v8g collected $0.20 from pot
*** SUMMARY ***
Total pot $0.20 | Rake $0 
Seat 3: 6TWO15+WfJ5HfI8CbJ4a0w folded before Flop (didn't bet)
Seat 4: vPtFvcPtn/Afz0sucO1cmQ folded before Flop (didn't bet)
Seat 5: S7Ki0P+0AIGPuIfGJjW0gg folded before Flop (didn't bet)
Seat 6: nkD1GtC3+ft+4U3Od0H10A (button) folded before Flop (didn't bet)
Seat 7: awxYB5n5W4JUl1V4Xsn26g (small blind) folded before Flop
Seat 8: kZJjw0YSgO2CZKraCg0v8g (big blind) collected ($0.20)
Seat 9: zDrucyjVn5aeekNEc3cJrA folded before Flop (didn't bet)




PokerStars Game #59939698370:  Hold'em No Limit ($0.10/$0.25) - 2009/07/01 0:46:36 ET
Table '3lL16FBjWXTx3AjK5lMRww' 9-max Seat #4 is the button
Seat 1: fDGyaQz0cs2s4FOYxkbIHA ($15 in chips) 
Seat 3: QEbIGci+itdw+re8RM5fZA ($26.05 in chips) 
Seat 4: Z3a37Ry74FVl+CBZtAONiA ($11.40 in chips) 
Seat 5: M/9j4wkHH9i1JM51vgi1VA ($22.60 in chips) 
Seat 6: hBMUlEpyU74r/fwDgIpXjQ ($41.60 in chips) 
Seat 8: ljemhp25Zg+nlA9DLCIiUw ($24.75 in chips) 
Seat 9: b8t3jWrxzeEt9HtZtc9wUQ ($8.85 in chips) 
M/9j4wkHH9i1JM51vgi1VA: posts small blind $0.10
hBMUlEpyU74r/fwDgIpXjQ: posts big blind $0.25
6RiVTYll/5D8zICp0MRpKw: sits out 
*** HOLE CARDS ***
aGjnENGPM5z9UQkETl26TA joins the table at seat #2 
ljemhp25Zg+nlA9DLCIiUw: folds 
b8t3jWrxzeEt9HtZtc9wUQ: folds 
fDGyaQz0cs2s4FOYxkbIHA: raises $0.25 to $0.50
QEbIGci+itdw+re8RM5fZA: folds 
Z3a37Ry74FVl+CBZtAONiA: folds 
M/9j4wkHH9i1JM51vgi1VA: folds 
hBMUlEpyU74r/fwDgIpXjQ: folds 
Uncalled bet ($0.25) returned to fDGyaQz0cs2s4FOYxkbIHA
fDGyaQz0cs2s4FOYxkbIHA collected $0.60 from pot
fDGyaQz0cs2s4FOYxkbIHA: doesn't show hand 
*** SUMMARY ***
Total pot $0.60 | Rake $0 
Seat 1: fDGyaQz0cs2s4FOYxkbIHA collected ($0.60)
Seat 3: QEbIGci+itdw+re8RM5fZA folded before Flop (didn't bet)
Seat 4: Z3a37Ry74FVl+CBZtAONiA (button) folded before Flop (didn't bet)
Seat 5: M/9j4wkHH9i1JM51vgi1VA (small blind) folded before Flop
Seat 6: hBMUlEpyU74r/fwDgIpXjQ (big blind) folded before Flop
Seat 8: ljemhp25Zg+nlA9DLCIiUw folded before Flop (didn't bet)
Seat 9: b8t3jWrxzeEt9HtZtc9wUQ folded before Flop (didn't bet)




PokerStars Game #59939698302:  Hold'em No Limit ($0.10/$0.25) - 2009/07/01 0:46:36 ET
Table 'ROYvQOMwUrvL3SOiHYcrWg' 9-max Seat #6 is the button
Seat 2: hBMUlEpyU74r/fwDgIpXjQ ($46.75 in chips) 
Seat 4: SHegmCn8B0InbWE/zFlvOw ($23.70 in chips) 
Seat 5: jeKWRUkMaVn8rEUjnJKqpg ($25 in chips) 
Seat 6: OiV1PWZ3IkN29JlmCcnTwQ ($4.65 in chips) 
Seat 7: tYsOBqdU1+x+yFI7zHO7hQ ($28.55 in chips) 
Seat 8: biJWLZ27fafNeBI2oT1KJw ($19.85 in chips) 
Seat 9: yduPKWPzL8YlT5Zv/Nmrwg ($29.30 in chips) 
tYsOBqdU1+x+yFI7zHO7hQ: posts small blind $0.10
biJWLZ27fafNeBI2oT1KJw: posts big blind $0.25
*** HOLE CARDS ***
yduPKWPzL8YlT5Zv/Nmrwg: folds 
hBMUlEpyU74r/fwDgIpXjQ: folds 
SHegmCn8B0InbWE/zFlvOw: calls $0.25
jeKWRUkMaVn8rEUjnJKqpg: calls $0.25
OiV1PWZ3IkN29JlmCcnTwQ: folds 
tYsOBqdU1+x+yFI7zHO7hQ: folds 
biJWLZ27fafNeBI2oT1KJw: checks 
*** FLOP *** [Kd Jd As]
biJWLZ27fafNeBI2oT1KJw: checks 
SHegmCn8B0InbWE/zFlvOw: bets $0.25
jeKWRUkMaVn8rEUjnJKqpg: folds 
biJWLZ27fafNeBI2oT1KJw: folds 
Uncalled bet ($0.25) returned to SHegmCn8B0InbWE/zFlvOw
SHegmCn8B0InbWE/zFlvOw collected $0.85 from pot
*** SUMMARY ***
Total pot $0.85 | Rake $0 
Board [Kd Jd As]
Seat 2: hBMUlEpyU74r/fwDgIpXjQ folded before Flop (didn't bet)
Seat 4: SHegmCn8B0InbWE/zFlvOw collected ($0.85)
Seat 5: jeKWRUkMaVn8rEUjnJKqpg folded on the Flop
Seat 6: OiV1PWZ3IkN29JlmCcnTwQ (button) folded before Flop (didn't bet)
Seat 7: tYsOBqdU1+x+yFI7zHO7hQ (small blind) folded before Flop
Seat 8: biJWLZ27fafNeBI2oT1KJw (big blind) folded on the Flop
Seat 9: yduPKWPzL8YlT5Zv/Nmrwg folded before Flop (didn't bet)




PokerStars Game #59939697930:  Hold'em No Limit ($0.10/$0.25) - 2009/07/01 0:46:36 ET
Table 'G+4ZdyRoPjgaJY/jxSlZzQ' 9-max Seat #9 is the button
Seat 2: 4awUyiDYTgylQKXZ9faBVA ($34.45 in chips) 
Seat 3: opOCI2p6kW0tINuVaAqmcQ ($30.95 in chips) 
Seat 4: aGjnENGPM5z9UQkETl26TA ($15 in chips) 
Seat 5: s7Q6uNouhe7aE8JdFb9E+A ($26 in chips) 
Seat 6: gehe91e0IyVT0QU/XBkEyg ($27.80 in chips) 
Seat 8: 8GJHzzxiotOqC5gdtgpLoA ($8.10 in chips) 
Seat 9: AzTBzPGlrIHrrs1Q8oKcGA ($17.20 in chips) 
0Ui5PFTLvpoTRdxcc8BNSQ will be allowed to play after the button
4awUyiDYTgylQKXZ9faBVA: posts small blind $0.10
opOCI2p6kW0tINuVaAqmcQ: posts big blind $0.25
aGjnENGPM5z9UQkETl26TA: posts big blind $0.25
*** HOLE CARDS ***
aGjnENGPM5z9UQkETl26TA: checks 
s7Q6uNouhe7aE8JdFb9E+A: folds 
gehe91e0IyVT0QU/XBkEyg: folds 
8GJHzzxiotOqC5gdtgpLoA: folds 
AzTBzPGlrIHrrs1Q8oKcGA: folds 
4awUyiDYTgylQKXZ9faBVA: folds 
opOCI2p6kW0tINuVaAqmcQ: checks 
*** FLOP *** [8c 7h Td]
opOCI2p6kW0tINuVaAqmcQ: checks 
aGjnENGPM5z9UQkETl26TA: checks 
*** TURN *** [8c 7h Td] [Ts]
opOCI2p6kW0tINuVaAqmcQ: checks 
aGjnENGPM5z9UQkETl26TA: checks 
*** RIVER *** [8c 7h Td Ts] [5s]
opOCI2p6kW0tINuVaAqmcQ: checks 
ie4EwTMMFYxrCXcenJdzsw leaves the table
aGjnENGPM5z9UQkETl26TA: checks 
*** SHOW DOWN ***
opOCI2p6kW0tINuVaAqmcQ: shows [6h 6d] (two pair, Tens and Sixes)
aGjnENGPM5z9UQkETl26TA: mucks hand 
opOCI2p6kW0tINuVaAqmcQ collected $0.60 from pot
*** SUMMARY ***
Total pot $0.60 | Rake $0 
Board [8c 7h Td Ts 5s]
Seat 2: 4awUyiDYTgylQKXZ9faBVA (small blind) folded before Flop
Seat 3: opOCI2p6kW0tINuVaAqmcQ (big blind) showed [6h 6d] and won ($0.60) with two pair, Tens and Sixes
Seat 4: aGjnENGPM5z9UQkETl26TA mucked
Seat 5: s7Q6uNouhe7aE8JdFb9E+A folded before Flop (didn't bet)
Seat 6: gehe91e0IyVT0QU/XBkEyg folded before Flop (didn't bet)
Seat 8: 8GJHzzxiotOqC5gdtgpLoA folded before Flop (didn't bet)
Seat 9: AzTBzPGlrIHrrs1Q8oKcGA (button) folded before Flop (didn't bet)




PokerStars Game #59939698072:  Hold'em No Limit ($0.10/$0.25) - 2009/07/01 0:46:36 ET
Table 'QegsWX65l3n/K0A8XB78yg' 6-max Seat #5 is the button
Seat 1: 8ClCHtFXGNplITm+63KB+Q ($28.60 in chips) 
Seat 2: GC/9yVD59DUCX7hUI7gcLw ($32.55 in chips) 
Seat 3: 9jSiy0meE9XJKkdIZwyTEQ ($25.60 in chips) 
Seat 4: kyRaCIljYA6l33lSKQfNsg ($25.35 in chips) 
Seat 5: 4YSTu0Cdzpppe1lUgCZGCQ ($57.45 in chips) 
Seat 6: JE/wJXmjw3bpdmjwvh2pcg ($36.50 in chips) 
JE/wJXmjw3bpdmjwvh2pcg: posts small blind $0.10
8ClCHtFXGNplITm+63KB+Q: posts big blind $0.25
*** HOLE CARDS ***
GC/9yVD59DUCX7hUI7gcLw: folds 
9jSiy0meE9XJKkdIZwyTEQ: raises $0.60 to $0.85
kyRaCIljYA6l33lSKQfNsg: folds 
4YSTu0Cdzpppe1lUgCZGCQ: folds 
JE/wJXmjw3bpdmjwvh2pcg: calls $0.75
8ClCHtFXGNplITm+63KB+Q: folds 
*** FLOP *** [6h Th 8s]
JE/wJXmjw3bpdmjwvh2pcg: checks 
9jSiy0meE9XJKkdIZwyTEQ: bets $1.40
JE/wJXmjw3bpdmjwvh2pcg: folds 
Uncalled bet ($1.40) returned to 9jSiy0meE9XJKkdIZwyTEQ
9jSiy0meE9XJKkdIZwyTEQ collected $1.90 from pot
9jSiy0meE9XJKkdIZwyTEQ: doesn't show hand 
*** SUMMARY ***
Total pot $1.95 | Rake $0.05 
Board [6h Th 8s]
Seat 1: 8ClCHtFXGNplITm+63KB+Q (big blind) folded before Flop
Seat 2: GC/9yVD59DUCX7hUI7gcLw folded before Flop (didn't bet)
Seat 3: 9jSiy0meE9XJKkdIZwyTEQ collected ($1.90)
Seat 4: kyRaCIljYA6l33lSKQfNsg folded before Flop (didn't bet)
Seat 5: 4YSTu0Cdzpppe1lUgCZGCQ (button) folded before Flop (didn't bet)
Seat 6: JE/wJXmjw3bpdmjwvh2pcg (small blind) folded on the Flop




PokerStars Game #59939698140:  Hold'em No Limit ($0.10/$0.25) - 2009/07/01 0:46:36 ET
Table 'WY+lMaAoIdBZmwk27/RJCA' 6-max Seat #3 is the button
Seat 1: lYjWCpfCxX2kgcHY3v4Yow ($25.70 in chips) 
Seat 2: cPO/1/dTcZpLkQFm3jH3Rg ($26.85 in chips) 
Seat 3: 79Q62AM0VB++TQYiBlOYsA ($36.85 in chips) 
Seat 4: cGfAi40F+9odP4v0stvfiQ ($32.10 in chips) 
Seat 5: wKFJ513ucluNNiMlkXcDOQ ($25 in chips) 
Seat 6: I1TxPvWj8NfG8orglCinNA ($26 in chips) 
cGfAi40F+9odP4v0stvfiQ: posts small blind $0.10
wKFJ513ucluNNiMlkXcDOQ: posts big blind $0.25
*** HOLE CARDS ***
I1TxPvWj8NfG8orglCinNA: folds 
lYjWCpfCxX2kgcHY3v4Yow: folds 
cPO/1/dTcZpLkQFm3jH3Rg: folds 
79Q62AM0VB++TQYiBlOYsA: folds 
cGfAi40F+9odP4v0stvfiQ: calls $0.15
wKFJ513ucluNNiMlkXcDOQ: raises $0.85 to $1.10
cGfAi40F+9odP4v0stvfiQ: calls $0.85
*** FLOP *** [3d 9s Ks]
cGfAi40F+9odP4v0stvfiQ: checks 
wKFJ513ucluNNiMlkXcDOQ: checks 
*** TURN *** [3d 9s Ks] [Td]
cGfAi40F+9odP4v0stvfiQ: checks 
wKFJ513ucluNNiMlkXcDOQ: checks 
*** RIVER *** [3d 9s Ks Td] [2s]
cGfAi40F+9odP4v0stvfiQ: bets $1.25
wKFJ513ucluNNiMlkXcDOQ: folds 
Uncalled bet ($1.25) returned to cGfAi40F+9odP4v0stvfiQ
cGfAi40F+9odP4v0stvfiQ collected $2.10 from pot
*** SUMMARY ***
Total pot $2.20 | Rake $0.10 
Board [3d 9s Ks Td 2s]
Seat 1: lYjWCpfCxX2kgcHY3v4Yow folded before Flop (didn't bet)
Seat 2: cPO/1/dTcZpLkQFm3jH3Rg folded before Flop (didn't bet)
Seat 3: 79Q62AM0VB++TQYiBlOYsA (button) folded before Flop (didn't bet)
Seat 4: cGfAi40F+9odP4v0stvfiQ (small blind) collected ($2.10)
Seat 5: wKFJ513ucluNNiMlkXcDOQ (big blind) folded on the River
Seat 6: I1TxPvWj8NfG8orglCinNA folded before Flop (didn't bet)




PokerStars Game #59939698382:  Hold'em No Limit ($0.10/$0.25) - 2009/07/01 0:46:36 ET
Table 'aT31tt16YvQM/Ue69HPLpA' 9-max Seat #3 is the button
Seat 1: uYY6p3irj4hBN7IeHiNGSw ($34.75 in chips) 
Seat 3: tYsOBqdU1+x+yFI7zHO7hQ ($27.90 in chips) 
Seat 4: s7Q6uNouhe7aE8JdFb9E+A ($25 in chips) 
Seat 5: cvtKnIIaTx2+P/KlOK+tfQ ($11.15 in chips) 
Seat 6: 7cv+9Zc9HIQHNvYsMfV3uA ($41.75 in chips) 
Seat 7: s8SPJjToEJz2mPsHsMqL0A ($5 in chips) 
Seat 8: lrTLp1zpuCCs/e0pi2M8jw ($43.85 in chips) 
Seat 9: SXqVW4Q0evTUVZG6BbUNIA ($29.65 in chips) 
s7Q6uNouhe7aE8JdFb9E+A: posts small blind $0.10
cvtKnIIaTx2+P/KlOK+tfQ: posts big blind $0.25
CYkY0dNBaYaKs8HVCVn3mQ: sits out 
*** HOLE CARDS ***
7cv+9Zc9HIQHNvYsMfV3uA: folds 
s8SPJjToEJz2mPsHsMqL0A: calls $0.25
lrTLp1zpuCCs/e0pi2M8jw: folds 
SXqVW4Q0evTUVZG6BbUNIA: folds 
uYY6p3irj4hBN7IeHiNGSw: folds 
tYsOBqdU1+x+yFI7zHO7hQ: folds 
s7Q6uNouhe7aE8JdFb9E+A: folds 
cvtKnIIaTx2+P/KlOK+tfQ: checks 
*** FLOP *** [2d 8c Kh]
cvtKnIIaTx2+P/KlOK+tfQ: bets $0.75
s8SPJjToEJz2mPsHsMqL0A: folds 
Uncalled bet ($0.75) returned to cvtKnIIaTx2+P/KlOK+tfQ
cvtKnIIaTx2+P/KlOK+tfQ collected $0.60 from pot
*** SUMMARY ***
Total pot $0.60 | Rake $0 
Board [2d 8c Kh]
Seat 1: uYY6p3irj4hBN7IeHiNGSw folded before Flop (didn't bet)
Seat 3: tYsOBqdU1+x+yFI7zHO7hQ (button) folded before Flop (didn't bet)
Seat 4: s7Q6uNouhe7aE8JdFb9E+A (small blind) folded before Flop
Seat 5: cvtKnIIaTx2+P/KlOK+tfQ (big blind) collected ($0.60)
Seat 6: 7cv+9Zc9HIQHNvYsMfV3uA folded before Flop (didn't bet)
Seat 7: s8SPJjToEJz2mPsHsMqL0A folded on the Flop
Seat 8: lrTLp1zpuCCs/e0pi2M8jw folded before Flop (didn't bet)
Seat 9: SXqVW4Q0evTUVZG6BbUNIA folded before Flop (didn't bet)




PokerStars Game #59939698856:  Hold'em No Limit ($0.10/$0.25) - 2009/07/01 0:46:37 ET
Table 'LXz5SsUCyWcm+4JDJh466A' 9-max Seat #6 is the button
Seat 1: MG90wfSJZnOejs/KD3vlQQ ($24.20 in chips) 
Seat 2: H5Se03ZqSX7tbULXur2MAg ($24.15 in chips) 
Seat 3: Iu9xjReQYvxYiqQm8n6MXQ ($3.80 in chips) 
Seat 4: K0b5wNInj6hUGRr6yzKFtw ($25 in chips) 
Seat 5: Z5ZtGOON8kmSdSCll9Z3XA ($8 in chips) 
Seat 6: opOCI2p6kW0tINuVaAqmcQ ($25 in chips) 
Seat 7: EnNp9cILTCYQ95g+8MNFGw ($28.50 in chips) 
Seat 8: VlJdQJbqyBs3oxP5BIw7jA ($99.60 in chips) 
EnNp9cILTCYQ95g+8MNFGw: posts small blind $0.10
VlJdQJbqyBs3oxP5BIw7jA: posts big blind $0.25
dtZ84flFEi4Q+SGrHMJRDQ: sits out 
Z5ZtGOON8kmSdSCll9Z3XA: posts big blind $0.25
*** HOLE CARDS ***
MG90wfSJZnOejs/KD3vlQQ: folds 
H5Se03ZqSX7tbULXur2MAg: folds 
Iu9xjReQYvxYiqQm8n6MXQ: folds 
K0b5wNInj6hUGRr6yzKFtw: folds 
Z5ZtGOON8kmSdSCll9Z3XA: checks 
opOCI2p6kW0tINuVaAqmcQ: folds 
EnNp9cILTCYQ95g+8MNFGw: raises $0.25 to $0.50
VlJdQJbqyBs3oxP5BIw7jA: raises $1.75 to $2.25
Z5ZtGOON8kmSdSCll9Z3XA: folds 
EnNp9cILTCYQ95g+8MNFGw: calls $1.75
*** FLOP *** [Td 9s 3c]
EnNp9cILTCYQ95g+8MNFGw: checks 
VlJdQJbqyBs3oxP5BIw7jA: bets $3.50
EnNp9cILTCYQ95g+8MNFGw: calls $3.50
*** TURN *** [Td 9s 3c] [4s]
EnNp9cILTCYQ95g+8MNFGw: checks 
VlJdQJbqyBs3oxP5BIw7jA: bets $7
EnNp9cILTCYQ95g+8MNFGw: calls $7
*** RIVER *** [Td 9s 3c 4s] [3d]
EnNp9cILTCYQ95g+8MNFGw: checks 
VlJdQJbqyBs3oxP5BIw7jA: bets $86.85 and is all-in
EnNp9cILTCYQ95g+8MNFGw: folds 
Uncalled bet ($86.85) returned to VlJdQJbqyBs3oxP5BIw7jA
VlJdQJbqyBs3oxP5BIw7jA collected $24.50 from pot
VlJdQJbqyBs3oxP5BIw7jA: doesn't show hand 
*** SUMMARY ***
Total pot $25.75 | Rake $1.25 
Board [Td 9s 3c 4s 3d]
Seat 1: MG90wfSJZnOejs/KD3vlQQ folded before Flop (didn't bet)
Seat 2: H5Se03ZqSX7tbULXur2MAg folded before Flop (didn't bet)
Seat 3: Iu9xjReQYvxYiqQm8n6MXQ folded before Flop (didn't bet)
Seat 4: K0b5wNInj6hUGRr6yzKFtw folded before Flop (didn't bet)
Seat 5: Z5ZtGOON8kmSdSCll9Z3XA folded before Flop
Seat 6: opOCI2p6kW0tINuVaAqmcQ (button) folded before Flop (didn't bet)
Seat 7: EnNp9cILTCYQ95g+8MNFGw (small blind) folded on the River
Seat 8: VlJdQJbqyBs3oxP5BIw7jA (big blind) collected ($24.50)




PokerStars Game #59939699040:  Hold'em No Limit ($0.10/$0.25) - 2009/07/01 0:46:37 ET
Table 'pPgW4R3kdH26lLi1MnE92w' 9-max Seat #7 is the button
Seat 1: dPWIrImjP1yFagoUVDKR0Q ($5.65 in chips) 
Seat 2: cZ99hugmLBj9KhTlc8nCSw ($28.25 in chips) 
Seat 4: hBMUlEpyU74r/fwDgIpXjQ ($31.25 in chips) 
Seat 5: HPEB+AtKw1+C/cxU0o1ciw ($34.25 in chips) 
Seat 6: VllYilcih0t+gMD4GTRlgQ ($28.75 in chips) 
Seat 7: sD+TKtt36XiiN6jqHiLwDA ($24.65 in chips) 
Seat 8: aCVg6cCxQcqClhB9nq/p1w ($20.85 in chips) 
Seat 9: tcbEu7VzyHQ+0lh+skbQhQ ($18 in chips) 
aCVg6cCxQcqClhB9nq/p1w: posts small blind $0.10
tcbEu7VzyHQ+0lh+skbQhQ: posts big blind $0.25
nPydKI7KXtudhyCkYtLgZA: sits out 
*** HOLE CARDS ***
dPWIrImjP1yFagoUVDKR0Q: calls $0.25
cZ99hugmLBj9KhTlc8nCSw: folds 
hBMUlEpyU74r/fwDgIpXjQ: folds 
HPEB+AtKw1+C/cxU0o1ciw: folds 
VllYilcih0t+gMD4GTRlgQ: calls $0.25
sD+TKtt36XiiN6jqHiLwDA: folds 
aCVg6cCxQcqClhB9nq/p1w: calls $0.15
tcbEu7VzyHQ+0lh+skbQhQ: checks 
*** FLOP *** [7c As 6d]
aCVg6cCxQcqClhB9nq/p1w: bets $0.25
tcbEu7VzyHQ+0lh+skbQhQ: folds 
dPWIrImjP1yFagoUVDKR0Q: calls $0.25
VllYilcih0t+gMD4GTRlgQ: calls $0.25
*** TURN *** [7c As 6d] [7s]
aCVg6cCxQcqClhB9nq/p1w: bets $0.25
dPWIrImjP1yFagoUVDKR0Q: calls $0.25
VllYilcih0t+gMD4GTRlgQ: calls $0.25
*** RIVER *** [7c As 6d 7s] [5s]
aCVg6cCxQcqClhB9nq/p1w: bets $0.25
dPWIrImjP1yFagoUVDKR0Q: calls $0.25
VllYilcih0t+gMD4GTRlgQ: folds 
*** SHOW DOWN ***
aCVg6cCxQcqClhB9nq/p1w: shows [6s 8d] (two pair, Sevens and Sixes)
dPWIrImjP1yFagoUVDKR0Q: shows [Jd Ad] (two pair, Aces and Sevens)
dPWIrImjP1yFagoUVDKR0Q collected $2.90 from pot
*** SUMMARY ***
Total pot $3 | Rake $0.10 
Board [7c As 6d 7s 5s]
Seat 1: dPWIrImjP1yFagoUVDKR0Q showed [Jd Ad] and won ($2.90) with two pair, Aces and Sevens
Seat 2: cZ99hugmLBj9KhTlc8nCSw folded before Flop (didn't bet)
Seat 4: hBMUlEpyU74r/fwDgIpXjQ folded before Flop (didn't bet)
Seat 5: HPEB+AtKw1+C/cxU0o1ciw folded before Flop (didn't bet)
Seat 6: VllYilcih0t+gMD4GTRlgQ folded on the River
Seat 7: sD+TKtt36XiiN6jqHiLwDA (button) folded before Flop (didn't bet)
Seat 8: aCVg6cCxQcqClhB9nq/p1w (small blind) showed [6s 8d] and lost with two pair, Sevens and Sixes
Seat 9: tcbEu7VzyHQ+0lh+skbQhQ (big blind) folded on the Flop




PokerStars Game #59939698948:  Hold'em No Limit ($0.10/$0.25) - 2009/07/01 0:46:37 ET
Table 'SkaFM7xfUr/Nd+JFPb7f2w' 9-max Seat #1 is the button
Seat 1: CvL9Ch1HYCVbTsfpNucitg ($4.65 in chips) 
Seat 2: QEbIGci+itdw+re8RM5fZA ($28.05 in chips) 
Seat 3: 4oA316mXLIui1QY63GXBUg ($25 in chips) 
Seat 4: DIBbjEYGs+TVdVgEB/4+3w ($39.20 in chips) 
Seat 5: GftT+l+xjKzcY0rMiNZfPg ($8.65 in chips) 
Seat 6: PskTLlFIRHSp61inskRzVg ($7.60 in chips) 
Seat 7: 7wo6Sr7QG3Zo6BaBDV1BOw ($5.85 in chips) 
Seat 8: Lro4e37x4FUa5P3yzDjskw ($12.45 in chips) 
Seat 9: STkR8XvpjNv79OOMhrlh2w ($59.10 in chips) 
QEbIGci+itdw+re8RM5fZA: posts small blind $0.10
4oA316mXLIui1QY63GXBUg: posts big blind $0.25
*** HOLE CARDS ***
DIBbjEYGs+TVdVgEB/4+3w: folds 
GftT+l+xjKzcY0rMiNZfPg: raises $0.50 to $0.75
PskTLlFIRHSp61inskRzVg: folds 
7wo6Sr7QG3Zo6BaBDV1BOw: folds 
Lro4e37x4FUa5P3yzDjskw: folds 
STkR8XvpjNv79OOMhrlh2w: folds 
CvL9Ch1HYCVbTsfpNucitg: folds 
QEbIGci+itdw+re8RM5fZA: folds 
4oA316mXLIui1QY63GXBUg: folds 
Uncalled bet ($0.50) returned to GftT+l+xjKzcY0rMiNZfPg
GftT+l+xjKzcY0rMiNZfPg collected $0.60 from pot
GftT+l+xjKzcY0rMiNZfPg: doesn't show hand 
*** SUMMARY ***
Total pot $0.60 | Rake $0 
Seat 1: CvL9Ch1HYCVbTsfpNucitg (button) folded before Flop (didn't bet)
Seat 2: QEbIGci+itdw+re8RM5fZA (small blind) folded before Flop
Seat 3: 4oA316mXLIui1QY63GXBUg (big blind) folded before Flop
Seat 4: DIBbjEYGs+TVdVgEB/4+3w folded before Flop (didn't bet)
Seat 5: GftT+l+xjKzcY0rMiNZfPg collected ($0.60)
Seat 6: PskTLlFIRHSp61inskRzVg folded before Flop (didn't bet)
Seat 7: 7wo6Sr7QG3Zo6BaBDV1BOw folded before Flop (didn't bet)
Seat 8: Lro4e37x4FUa5P3yzDjskw folded before Flop (didn't bet)
Seat 9: STkR8XvpjNv79OOMhrlh2w folded before Flop (didn't bet)




PokerStars Game #59939698726:  Hold'em No Limit ($0.10/$0.25) - 2009/07/01 0:46:37 ET
Table 'nyTW9cVtYentc5V7xU/0jA' 6-max Seat #3 is the button
Seat 1: YfxPRDAWfqnGBhiIEdlTYg ($10.15 in chips) 
Seat 2: 7FmwVDcdEtxDpHmP4hOXsQ ($26.40 in chips) 
Seat 3: kG34n23qFQA3nzdOJTQ1dA ($26.70 in chips) 
Seat 4: NkB3D4eVHHXvB9Edaugc1Q ($15.30 in chips) 
Seat 5: BedjMfrlRfPgSq7CXpPAmg ($28.70 in chips) 
Seat 6: dQJByDqHOLbgqX/HobyAJA ($4.80 in chips) 
NkB3D4eVHHXvB9Edaugc1Q: posts small blind $0.10
BedjMfrlRfPgSq7CXpPAmg: posts big blind $0.25
*** HOLE CARDS ***
dQJByDqHOLbgqX/HobyAJA: calls $0.25
YfxPRDAWfqnGBhiIEdlTYg: calls $0.25
7FmwVDcdEtxDpHmP4hOXsQ: folds 
kG34n23qFQA3nzdOJTQ1dA: folds 
NkB3D4eVHHXvB9Edaugc1Q: calls $0.15
BedjMfrlRfPgSq7CXpPAmg: raises $0.75 to $1
dQJByDqHOLbgqX/HobyAJA: calls $0.75
YfxPRDAWfqnGBhiIEdlTYg: folds 
NkB3D4eVHHXvB9Edaugc1Q: folds 
*** FLOP *** [8h 6s 7s]
BedjMfrlRfPgSq7CXpPAmg: checks 
dQJByDqHOLbgqX/HobyAJA: checks 
*** TURN *** [8h 6s 7s] [Ad]
BedjMfrlRfPgSq7CXpPAmg: bets $1.45
dQJByDqHOLbgqX/HobyAJA: folds 
Uncalled bet ($1.45) returned to BedjMfrlRfPgSq7CXpPAmg
BedjMfrlRfPgSq7CXpPAmg collected $2.40 from pot
*** SUMMARY ***
Total pot $2.50 | Rake $0.10 
Board [8h 6s 7s Ad]
Seat 1: YfxPRDAWfqnGBhiIEdlTYg folded before Flop
Seat 2: 7FmwVDcdEtxDpHmP4hOXsQ folded before Flop (didn't bet)
Seat 3: kG34n23qFQA3nzdOJTQ1dA (button) folded before Flop (didn't bet)
Seat 4: NkB3D4eVHHXvB9Edaugc1Q (small blind) folded before Flop
Seat 5: BedjMfrlRfPgSq7CXpPAmg (big blind) collected ($2.40)
Seat 6: dQJByDqHOLbgqX/HobyAJA folded on the Turn




PokerStars Game #59939698674:  Hold'em No Limit ($0.10/$0.25) - 2009/07/01 0:46:37 ET
Table 'IUwZ/e0bDHZPgsIWx0RnNg' 6-max Seat #5 is the button
Seat 1: 8JTm/CXBn3+kuQgcUOgPkw ($24.75 in chips) 
Seat 2: mvFHK3pE7tCxJEqLjKC70Q ($30.35 in chips) 
Seat 3: dOX4wnYV2sEqvDbF+8KSCw ($25.70 in chips) 
Seat 4: IyZ9SVxKy7TJvRGFneWTMg ($29.65 in chips) 
Seat 5: wsP46AGpqDjHZQmlRHKa9g ($25.15 in chips) 
Seat 6: NhUN/JpAprdJeamFBgJH1w ($25 in chips) 
NhUN/JpAprdJeamFBgJH1w: posts small blind $0.10
8JTm/CXBn3+kuQgcUOgPkw: posts big blind $0.25
*** HOLE CARDS ***
mvFHK3pE7tCxJEqLjKC70Q: folds 
dOX4wnYV2sEqvDbF+8KSCw: raises $0.75 to $1
IyZ9SVxKy7TJvRGFneWTMg: folds 
wsP46AGpqDjHZQmlRHKa9g: folds 
NhUN/JpAprdJeamFBgJH1w: folds 
8JTm/CXBn3+kuQgcUOgPkw: folds 
Uncalled bet ($0.75) returned to dOX4wnYV2sEqvDbF+8KSCw
dOX4wnYV2sEqvDbF+8KSCw collected $0.60 from pot
dOX4wnYV2sEqvDbF+8KSCw: doesn't show hand 
*** SUMMARY ***
Total pot $0.60 | Rake $0 
Seat 1: 8JTm/CXBn3+kuQgcUOgPkw (big blind) folded before Flop
Seat 2: mvFHK3pE7tCxJEqLjKC70Q folded before Flop (didn't bet)
Seat 3: dOX4wnYV2sEqvDbF+8KSCw collected ($0.60)
Seat 4: IyZ9SVxKy7TJvRGFneWTMg folded before Flop (didn't bet)
Seat 5: wsP46AGpqDjHZQmlRHKa9g (button) folded before Flop (didn't bet)
Seat 6: NhUN/JpAprdJeamFBgJH1w (small blind) folded before Flop




PokerStars Game #59939698760:  Hold'em No Limit ($0.10/$0.25) - 2009/07/01 0:46:37 ET
Table 'FE/j6VqBY4j9Uq+VHURQCQ' 6-max Seat #3 is the button
Seat 1: wKFJ513ucluNNiMlkXcDOQ ($45.70 in chips) 
Seat 2: 3zD3qLXT1bEffAoWGnc7wg ($28.75 in chips) 
Seat 3: Zijzy/UtPWzWVUo81HHVjQ ($51.25 in chips) 
Seat 4: cPO/1/dTcZpLkQFm3jH3Rg ($25 in chips) 
Seat 5: wsP46AGpqDjHZQmlRHKa9g ($25 in chips) 
Seat 6: kARKwAmU6kWJfiSICTYhVw ($18.55 in chips) 
cPO/1/dTcZpLkQFm3jH3Rg: posts small blind $0.10
wsP46AGpqDjHZQmlRHKa9g: posts big blind $0.25
*** HOLE CARDS ***
kARKwAmU6kWJfiSICTYhVw: folds 
wKFJ513ucluNNiMlkXcDOQ: folds 
3zD3qLXT1bEffAoWGnc7wg: folds 
Zijzy/UtPWzWVUo81HHVjQ: folds 
kARKwAmU6kWJfiSICTYhVw leaves the table
cPO/1/dTcZpLkQFm3jH3Rg: folds 
Uncalled bet ($0.15) returned to wsP46AGpqDjHZQmlRHKa9g
wsP46AGpqDjHZQmlRHKa9g collected $0.20 from pot
*** SUMMARY ***
Total pot $0.20 | Rake $0 
Seat 1: wKFJ513ucluNNiMlkXcDOQ folded before Flop (didn't bet)
Seat 2: 3zD3qLXT1bEffAoWGnc7wg folded before Flop (didn't bet)
Seat 3: Zijzy/UtPWzWVUo81HHVjQ (button) folded before Flop (didn't bet)
Seat 4: cPO/1/dTcZpLkQFm3jH3Rg (small blind) folded before Flop
Seat 5: wsP46AGpqDjHZQmlRHKa9g (big blind) collected ($0.20)
Seat 6: kARKwAmU6kWJfiSICTYhVw folded before Flop (didn't bet)




PokerStars Game #59939698476:  Hold'em No Limit ($0.10/$0.25) - 2009/07/01 0:46:37 ET
Table 'zgAizkhIUPUrfr6LqN3ifw' 9-max Seat #1 is the button
Seat 1: st9jtdNbm1W5GfBwRaCVqQ ($24.90 in chips) 
Seat 2: s7Q6uNouhe7aE8JdFb9E+A ($26.95 in chips) 
Seat 5: DdPXdieucQ+n99u1n3A+rQ ($5.15 in chips) 
Seat 6: TeWJxSETzbXGiYKx0y+dtg ($25 in chips) 
Seat 7: 1S/fpm+f42V/6MNZre+ccg ($27.40 in chips) 
Seat 8: MIVCHqCqqlke0Lb0z7glcw ($23.55 in chips) 
Seat 9: 7cv+9Zc9HIQHNvYsMfV3uA ($25 in chips) 
s7Q6uNouhe7aE8JdFb9E+A: posts small blind $0.10
hZuGwtYmFKPmQ+v1wlmdfA: is sitting out 
DdPXdieucQ+n99u1n3A+rQ: posts big blind $0.25
hZuGwtYmFKPmQ+v1wlmdfA leaves the table
7cv+9Zc9HIQHNvYsMfV3uA: posts big blind $0.25
*** HOLE CARDS ***
TeWJxSETzbXGiYKx0y+dtg: folds 
1S/fpm+f42V/6MNZre+ccg: calls $0.25
MIVCHqCqqlke0Lb0z7glcw: calls $0.25
7cv+9Zc9HIQHNvYsMfV3uA: raises $1.50 to $1.75
st9jtdNbm1W5GfBwRaCVqQ: folds 
s7Q6uNouhe7aE8JdFb9E+A: folds 
DdPXdieucQ+n99u1n3A+rQ: folds 
sat420Man joins the table at seat #3 
1S/fpm+f42V/6MNZre+ccg: calls $1.50
MIVCHqCqqlke0Lb0z7glcw: folds 
*** FLOP *** [2d 8s 3h]
1S/fpm+f42V/6MNZre+ccg: checks 
7cv+9Zc9HIQHNvYsMfV3uA: bets $3
1S/fpm+f42V/6MNZre+ccg: folds 
Uncalled bet ($3) returned to 7cv+9Zc9HIQHNvYsMfV3uA
7cv+9Zc9HIQHNvYsMfV3uA collected $3.90 from pot
7cv+9Zc9HIQHNvYsMfV3uA: doesn't show hand 
*** SUMMARY ***
Total pot $4.10 | Rake $0.20 
Board [2d 8s 3h]
Seat 1: st9jtdNbm1W5GfBwRaCVqQ (button) folded before Flop (didn't bet)
Seat 2: s7Q6uNouhe7aE8JdFb9E+A (small blind) folded before Flop
Seat 5: DdPXdieucQ+n99u1n3A+rQ (big blind) folded before Flop
Seat 6: TeWJxSETzbXGiYKx0y+dtg folded before Flop (didn't bet)
Seat 7: 1S/fpm+f42V/6MNZre+ccg folded on the Flop
Seat 8: MIVCHqCqqlke0Lb0z7glcw folded before Flop
Seat 9: 7cv+9Zc9HIQHNvYsMfV3uA collected ($3.90)




PokerStars Game #59939698984:  Hold'em No Limit ($0.10/$0.25) - 2009/07/01 0:46:37 ET
Table 'zKwHJD0cmKNUure9qQTfFg' 6-max Seat #4 is the button
Seat 1: nwwpaieDRI0UPyVtChVHOg ($14.90 in chips) 
Seat 3: ljjhtb6FVPTx9AT9HNdtqg ($14.40 in chips) 
Seat 4: v+QfkGiuj9bgtuNoVnDO8w ($25 in chips) 
Seat 5: I1TxPvWj8NfG8orglCinNA ($29.55 in chips) 
Seat 6: fBpPyuxbg0NbTlQHEs38sA ($16.25 in chips) 
I1TxPvWj8NfG8orglCinNA: posts small blind $0.10
fBpPyuxbg0NbTlQHEs38sA: posts big blind $0.25
4kWQxGbT5FZ1dkPd1bE45Q: sits out 
*** HOLE CARDS ***
nwwpaieDRI0UPyVtChVHOg: folds 
ljjhtb6FVPTx9AT9HNdtqg: raises $0.50 to $0.75
v+QfkGiuj9bgtuNoVnDO8w: folds 
I1TxPvWj8NfG8orglCinNA: folds 
fBpPyuxbg0NbTlQHEs38sA: folds 
Uncalled bet ($0.50) returned to ljjhtb6FVPTx9AT9HNdtqg
ljjhtb6FVPTx9AT9HNdtqg collected $0.60 from pot
*** SUMMARY ***
Total pot $0.60 | Rake $0 
Seat 1: nwwpaieDRI0UPyVtChVHOg folded before Flop (didn't bet)
Seat 3: ljjhtb6FVPTx9AT9HNdtqg collected ($0.60)
Seat 4: v+QfkGiuj9bgtuNoVnDO8w (button) folded before Flop (didn't bet)
Seat 5: I1TxPvWj8NfG8orglCinNA (small blind) folded before Flop
Seat 6: fBpPyuxbg0NbTlQHEs38sA (big blind) folded before Flop




PokerStars Game #59939699174:  Hold'em No Limit ($0.10/$0.25) - 2009/07/01 0:46:38 ET
Table '3Ns9nuTkynfwbBfBXzg6ww' 6-max Seat #3 is the button
Seat 1: KDYsHh8K2SUXXDvLsAhbJQ ($8.90 in chips) 
Seat 3: HyXsCmHsOHAlL2pzZ9IYAg ($4.60 in chips) 
Seat 4: qGHGf/553gQnDoklMRe3tg ($22.25 in chips) 
Seat 5: kBQU/db00TVAMeomlhblPg ($16.85 in chips) 
Seat 6: ZZm/rg8aThjE+A2LiItuzA ($12.60 in chips) 
qGHGf/553gQnDoklMRe3tg: posts small blind $0.10
kBQU/db00TVAMeomlhblPg: posts big blind $0.25
zxeVQGaMKDsDzmSY+AInjA: sits out 
*** HOLE CARDS ***
ZZm/rg8aThjE+A2LiItuzA: folds 
KDYsHh8K2SUXXDvLsAhbJQ: calls $0.25
HyXsCmHsOHAlL2pzZ9IYAg: folds 
qGHGf/553gQnDoklMRe3tg: folds 
kBQU/db00TVAMeomlhblPg: checks 
*** FLOP *** [Tc Th Kd]
kBQU/db00TVAMeomlhblPg: bets $0.75
KDYsHh8K2SUXXDvLsAhbJQ: folds 
Uncalled bet ($0.75) returned to kBQU/db00TVAMeomlhblPg
kBQU/db00TVAMeomlhblPg collected $0.60 from pot
*** SUMMARY ***
Total pot $0.60 | Rake $0 
Board [Tc Th Kd]
Seat 1: KDYsHh8K2SUXXDvLsAhbJQ folded on the Flop
Seat 3: HyXsCmHsOHAlL2pzZ9IYAg (button) folded before Flop (didn't bet)
Seat 4: qGHGf/553gQnDoklMRe3tg (small blind) folded before Flop
Seat 5: kBQU/db00TVAMeomlhblPg (big blind) collected ($0.60)
Seat 6: ZZm/rg8aThjE+A2LiItuzA folded before Flop (didn't bet)




PokerStars Game #59939699698:  Hold'em No Limit ($0.10/$0.25) - 2009/07/01 0:46:38 ET
Table 'zW+7jPbOLCvlPu+dUGY5WQ' 6-max Seat #3 is the button
Seat 3: BedjMfrlRfPgSq7CXpPAmg ($63.30 in chips) 
Seat 5: SFmT9ZsVopnukjvAzrxTRg ($55.20 in chips) 
Seat 6: BiLBinPhgpKAYzLgKJVU5A ($21.80 in chips) 
SFmT9ZsVopnukjvAzrxTRg: posts small blind $0.10
BiLBinPhgpKAYzLgKJVU5A: posts big blind $0.25
*** HOLE CARDS ***
BedjMfrlRfPgSq7CXpPAmg: raises $0.75 to $1
SFmT9ZsVopnukjvAzrxTRg: folds 
BiLBinPhgpKAYzLgKJVU5A: folds 
Uncalled bet ($0.75) returned to BedjMfrlRfPgSq7CXpPAmg
BedjMfrlRfPgSq7CXpPAmg collected $0.60 from pot
*** SUMMARY ***
Total pot $0.60 | Rake $0 
Seat 3: BedjMfrlRfPgSq7CXpPAmg (button) collected ($0.60)
Seat 5: SFmT9ZsVopnukjvAzrxTRg (small blind) folded before Flop
Seat 6: BiLBinPhgpKAYzLgKJVU5A (big blind) folded before Flop




PokerStars Game #59939699466:  Hold'em No Limit ($0.10/$0.25) - 2009/07/01 0:46:38 ET
Table 'jxoHy9yJy0bbH/Qx73FoPA' 9-max Seat #6 is the button
Seat 1: jN7A9nKK4RYzhFj4MrekhA ($15.30 in chips) 
Seat 2: F7pnn6czNpHvRM55XcA2EA ($25.95 in chips) 
Seat 3: /DYYmfrw4B9z+N2z81dNtA ($18.55 in chips) 
Seat 4: RJ/x9oZtt1RZLaJEQwZOxQ ($26.55 in chips) 
Seat 6: tYsOBqdU1+x+yFI7zHO7hQ ($51.55 in chips) 
Seat 8: hBMUlEpyU74r/fwDgIpXjQ ($33.05 in chips) 
Seat 9: IG1d4tXnNA98OKRYYE3l+A ($53.95 in chips) 
hBMUlEpyU74r/fwDgIpXjQ: posts small blind $0.10
IG1d4tXnNA98OKRYYE3l+A: posts big blind $0.25
*** HOLE CARDS ***
jN7A9nKK4RYzhFj4MrekhA: folds 
F7pnn6czNpHvRM55XcA2EA: folds 
OlPJsgR4xypSg/w1z7Gyvw joins the table at seat #7 
/DYYmfrw4B9z+N2z81dNtA has timed out
/DYYmfrw4B9z+N2z81dNtA: folds 
/DYYmfrw4B9z+N2z81dNtA is sitting out
RJ/x9oZtt1RZLaJEQwZOxQ: folds 
tYsOBqdU1+x+yFI7zHO7hQ: raises $0.50 to $0.75
hBMUlEpyU74r/fwDgIpXjQ: folds 
/DYYmfrw4B9z+N2z81dNtA has returned
IG1d4tXnNA98OKRYYE3l+A: calls $0.50
*** FLOP *** [8d Qd 7s]
IG1d4tXnNA98OKRYYE3l+A: checks 
tYsOBqdU1+x+yFI7zHO7hQ: bets $1.25
IG1d4tXnNA98OKRYYE3l+A: calls $1.25
*** TURN *** [8d Qd 7s] [8h]
IG1d4tXnNA98OKRYYE3l+A: checks 
tYsOBqdU1+x+yFI7zHO7hQ: checks 
*** RIVER *** [8d Qd 7s 8h] [9s]
IG1d4tXnNA98OKRYYE3l+A: bets $1.50
tYsOBqdU1+x+yFI7zHO7hQ: folds 
Uncalled bet ($1.50) returned to IG1d4tXnNA98OKRYYE3l+A
IG1d4tXnNA98OKRYYE3l+A collected $3.90 from pot
*** SUMMARY ***
Total pot $4.10 | Rake $0.20 
Board [8d Qd 7s 8h 9s]
Seat 1: jN7A9nKK4RYzhFj4MrekhA folded before Flop (didn't bet)
Seat 2: F7pnn6czNpHvRM55XcA2EA folded before Flop (didn't bet)
Seat 3: /DYYmfrw4B9z+N2z81dNtA folded before Flop (didn't bet)
Seat 4: RJ/x9oZtt1RZLaJEQwZOxQ folded before Flop (didn't bet)
Seat 6: tYsOBqdU1+x+yFI7zHO7hQ (button) folded on the River
Seat 8: hBMUlEpyU74r/fwDgIpXjQ (small blind) folded before Flop
Seat 9: IG1d4tXnNA98OKRYYE3l+A (big blind) collected ($3.90)




PokerStars Game #59939699370:  Hold'em No Limit ($0.10/$0.25) - 2009/07/01 0:46:38 ET
Table 'GxdLtCpYxqT4aAbYqkEEpw' 6-max Seat #3 is the button
Seat 1: heEf/FkFGS9M1NmwH97YIA ($20.15 in chips) 
Seat 2: hADMNbkECXMb2C/C8R2Wlw ($25.35 in chips) 
Seat 3: 9jSiy0meE9XJKkdIZwyTEQ ($48.80 in chips) 
Seat 4: ErIN0JRL5srYjT6en1f8YQ ($29.90 in chips) 
Seat 5: q6WfTUAD9mowIP63ASq2Dg ($39.15 in chips) 
Seat 6: aogAb4Eienxztk8p2v9VVw ($24.15 in chips) 
ErIN0JRL5srYjT6en1f8YQ: posts small blind $0.10
q6WfTUAD9mowIP63ASq2Dg: posts big blind $0.25
*** HOLE CARDS ***
aogAb4Eienxztk8p2v9VVw: folds 
heEf/FkFGS9M1NmwH97YIA: folds 
hADMNbkECXMb2C/C8R2Wlw: folds 
9jSiy0meE9XJKkdIZwyTEQ: folds 
ErIN0JRL5srYjT6en1f8YQ: raises $0.50 to $0.75
q6WfTUAD9mowIP63ASq2Dg: calls $0.50
*** FLOP *** [5s 6s Jd]
ErIN0JRL5srYjT6en1f8YQ: bets $1.10
q6WfTUAD9mowIP63ASq2Dg: folds 
Uncalled bet ($1.10) returned to ErIN0JRL5srYjT6en1f8YQ
ErIN0JRL5srYjT6en1f8YQ collected $1.45 from pot
ErIN0JRL5srYjT6en1f8YQ: doesn't show hand 
*** SUMMARY ***
Total pot $1.50 | Rake $0.05 
Board [5s 6s Jd]
Seat 1: heEf/FkFGS9M1NmwH97YIA folded before Flop (didn't bet)
Seat 2: hADMNbkECXMb2C/C8R2Wlw folded before Flop (didn't bet)
Seat 3: 9jSiy0meE9XJKkdIZwyTEQ (button) folded before Flop (didn't bet)
Seat 4: ErIN0JRL5srYjT6en1f8YQ (small blind) collected ($1.45)
Seat 5: q6WfTUAD9mowIP63ASq2Dg (big blind) folded on the Flop
Seat 6: aogAb4Eienxztk8p2v9VVw folded before Flop (didn't bet)




PokerStars Game #59939699300:  Hold'em No Limit ($0.10/$0.25) - 2009/07/01 0:46:38 ET
Table 'eOXPe2c6mG7DOFKvMsZZfA' 6-max Seat #2 is the button
Seat 1: ShXPHWfjhfmAwLgDdm6bRQ ($14.20 in chips) 
Seat 2: ELW+DKizJhLK7k40PMkD2Q ($33.30 in chips) 
Seat 3: kReyZ6g6Fu3tQ0nyjDf9kA ($29.40 in chips) 
Seat 4: zHHLkD2sRljslKKeQv/ZQw ($42 in chips) 
Seat 5: NhUN/JpAprdJeamFBgJH1w ($25.35 in chips) 
Seat 6: wKFJ513ucluNNiMlkXcDOQ ($25 in chips) 
kReyZ6g6Fu3tQ0nyjDf9kA: posts small blind $0.10
zHHLkD2sRljslKKeQv/ZQw: posts big blind $0.25
*** HOLE CARDS ***
NhUN/JpAprdJeamFBgJH1w: folds 
wKFJ513ucluNNiMlkXcDOQ: raises $0.75 to $1
ShXPHWfjhfmAwLgDdm6bRQ: folds 
ELW+DKizJhLK7k40PMkD2Q: calls $1
kReyZ6g6Fu3tQ0nyjDf9kA: folds 
zHHLkD2sRljslKKeQv/ZQw: folds 
*** FLOP *** [3s Jd 5h]
wKFJ513ucluNNiMlkXcDOQ: bets $1.60
ELW+DKizJhLK7k40PMkD2Q: calls $1.60
*** TURN *** [3s Jd 5h] [3c]
wKFJ513ucluNNiMlkXcDOQ: checks 
ELW+DKizJhLK7k40PMkD2Q: bets $3.85
wKFJ513ucluNNiMlkXcDOQ: raises $9.15 to $13
ELW+DKizJhLK7k40PMkD2Q: calls $9.15
*** RIVER *** [3s Jd 5h 3c] [2d]
wKFJ513ucluNNiMlkXcDOQ: bets $9.40 and is all-in
ELW+DKizJhLK7k40PMkD2Q: calls $9.40
*** SHOW DOWN ***
wKFJ513ucluNNiMlkXcDOQ: shows [9c 9d] (two pair, Nines and Threes)
ELW+DKizJhLK7k40PMkD2Q: shows [Js 9s] (two pair, Jacks and Threes)
ELW+DKizJhLK7k40PMkD2Q collected $47.95 from pot
*** SUMMARY ***
Total pot $50.35 | Rake $2.40 
Board [3s Jd 5h 3c 2d]
Seat 1: ShXPHWfjhfmAwLgDdm6bRQ folded before Flop (didn't bet)
Seat 2: ELW+DKizJhLK7k40PMkD2Q (button) showed [Js 9s] and won ($47.95) with two pair, Jacks and Threes
Seat 3: kReyZ6g6Fu3tQ0nyjDf9kA (small blind) folded before Flop
Seat 4: zHHLkD2sRljslKKeQv/ZQw (big blind) folded before Flop
Seat 5: NhUN/JpAprdJeamFBgJH1w folded before Flop (didn't bet)
Seat 6: wKFJ513ucluNNiMlkXcDOQ showed [9c 9d] and lost with two pair, Nines and Threes




PokerStars Game #59939699688:  Hold'em No Limit ($0.10/$0.25) - 2009/07/01 0:46:38 ET
Table 'FuFyQHmlO/QqQp//rDRrPg' 6-max Seat #1 is the button
Seat 1: jp34e617tIzV8tKIWmfAbA ($25 in chips) 
Seat 2: 0DvgWV5o6c/jYqQCjm4Haw ($25.70 in chips) 
Seat 3: zsU1ijOyYEi+40wBKPEbmw ($8.90 in chips) 
Seat 4: Eznneya0vB6S+eXJdVleHA ($4.80 in chips) 
Seat 5: wAKC8C/zN0c8V5v13dm9mA ($26.15 in chips) 
Seat 6: 6DwBRH+xZ12AAZmeAg+aXw ($29.55 in chips) 
0DvgWV5o6c/jYqQCjm4Haw: posts small blind $0.10
zsU1ijOyYEi+40wBKPEbmw: posts big blind $0.25
*** HOLE CARDS ***
Eznneya0vB6S+eXJdVleHA: folds 
wAKC8C/zN0c8V5v13dm9mA: raises $0.75 to $1
6DwBRH+xZ12AAZmeAg+aXw: calls $1
jp34e617tIzV8tKIWmfAbA: folds 
0DvgWV5o6c/jYqQCjm4Haw: folds 
zsU1ijOyYEi+40wBKPEbmw: folds 
*** FLOP *** [Tc 9s 3c]
zsU1ijOyYEi+40wBKPEbmw leaves the table
wAKC8C/zN0c8V5v13dm9mA: checks 
6DwBRH+xZ12AAZmeAg+aXw: bets $1.50
wAKC8C/zN0c8V5v13dm9mA: folds 
Uncalled bet ($1.50) returned to 6DwBRH+xZ12AAZmeAg+aXw
6DwBRH+xZ12AAZmeAg+aXw collected $2.25 from pot
6DwBRH+xZ12AAZmeAg+aXw: doesn't show hand 
*** SUMMARY ***
Total pot $2.35 | Rake $0.10 
Board [Tc 9s 3c]
Seat 1: jp34e617tIzV8tKIWmfAbA (button) folded before Flop (didn't bet)
Seat 2: 0DvgWV5o6c/jYqQCjm4Haw (small blind) folded before Flop
Seat 3: zsU1ijOyYEi+40wBKPEbmw (big blind) folded before Flop
Seat 4: Eznneya0vB6S+eXJdVleHA folded before Flop (didn't bet)
Seat 5: wAKC8C/zN0c8V5v13dm9mA folded on the Flop
Seat 6: 6DwBRH+xZ12AAZmeAg+aXw collected ($2.25)




PokerStars Game #59939699178:  Hold'em No Limit ($0.10/$0.25) - 2009/07/01 0:46:38 ET
Table 'nlpa8xI95gAflovnFxB2yg' 6-max Seat #6 is the button
Seat 1: fZQg9veL7Dd/Z04ZTjC+wQ ($67.30 in chips) 
Seat 2: WrLI51S2iMb8GLMB83gGqA ($25 in chips) 
Seat 3: I1TxPvWj8NfG8orglCinNA ($26.40 in chips) 
Seat 4: 5xjU9nfIjn1MBxIJKZvS5w ($30.85 in chips) 
Seat 5: 6DwBRH+xZ12AAZmeAg+aXw ($25 in chips) 
Seat 6: FPlQHZog0ePFCETQ2KG4hQ ($25 in chips) 
fZQg9veL7Dd/Z04ZTjC+wQ: posts small blind $0.10
WrLI51S2iMb8GLMB83gGqA: posts big blind $0.25
*** HOLE CARDS ***
I1TxPvWj8NfG8orglCinNA: folds 
5xjU9nfIjn1MBxIJKZvS5w: calls $0.25
6DwBRH+xZ12AAZmeAg+aXw: raises $0.75 to $1
FPlQHZog0ePFCETQ2KG4hQ: folds 
fZQg9veL7Dd/Z04ZTjC+wQ: folds 
WrLI51S2iMb8GLMB83gGqA: folds 
5xjU9nfIjn1MBxIJKZvS5w: calls $0.75
*** FLOP *** [7s Ad 8s]
5xjU9nfIjn1MBxIJKZvS5w: checks 
6DwBRH+xZ12AAZmeAg+aXw: bets $1.50
5xjU9nfIjn1MBxIJKZvS5w: folds 
Uncalled bet ($1.50) returned to 6DwBRH+xZ12AAZmeAg+aXw
6DwBRH+xZ12AAZmeAg+aXw collected $2.25 from pot
6DwBRH+xZ12AAZmeAg+aXw: doesn't show hand 
*** SUMMARY ***
Total pot $2.35 | Rake $0.10 
Board [7s Ad 8s]
Seat 1: fZQg9veL7Dd/Z04ZTjC+wQ (small blind) folded before Flop
Seat 2: WrLI51S2iMb8GLMB83gGqA (big blind) folded before Flop
Seat 3: I1TxPvWj8NfG8orglCinNA folded before Flop (didn't bet)
Seat 4: 5xjU9nfIjn1MBxIJKZvS5w folded on the Flop
Seat 5: 6DwBRH+xZ12AAZmeAg+aXw collected ($2.25)
Seat 6: FPlQHZog0ePFCETQ2KG4hQ (button) folded before Flop (didn't bet)




PokerStars Game #59939699334:  Hold'em No Limit ($0.10/$0.25) - 2009/07/01 0:46:38 ET
Table 'nc6OeGk/wtaWV+6N+kgnZQ' 6-max Seat #5 is the button
Seat 1: 0/FYfBoKhINaqU/H5OSS1A ($1.25 in chips) 
Seat 2: 4vTIxEd0Qfkak22W0G6sTg ($12.90 in chips) 
Seat 3: 8f0dtuUGqDbgE6up1lQAlg ($20.55 in chips) 
Seat 4: UfU14XiqkyIQoIJy9COOsQ ($24.85 in chips) 
Seat 5: ymz+a8dgHSUFPooYplw7Ow ($24.25 in chips) 
Seat 6: Mch463E1dxQfVob352za6w ($25 in chips) 
Mch463E1dxQfVob352za6w: posts small blind $0.10
0/FYfBoKhINaqU/H5OSS1A: posts big blind $0.25
*** HOLE CARDS ***
4vTIxEd0Qfkak22W0G6sTg: raises $0.25 to $0.50
8f0dtuUGqDbgE6up1lQAlg: calls $0.50
UfU14XiqkyIQoIJy9COOsQ: calls $0.50
ymz+a8dgHSUFPooYplw7Ow: folds 
Mch463E1dxQfVob352za6w: raises $2 to $2.50
0/FYfBoKhINaqU/H5OSS1A: calls $1 and is all-in
4vTIxEd0Qfkak22W0G6sTg: calls $2
8f0dtuUGqDbgE6up1lQAlg: folds 
UfU14XiqkyIQoIJy9COOsQ: folds 
*** FLOP *** [8h 6c 8s]
Mch463E1dxQfVob352za6w: bets $4
4vTIxEd0Qfkak22W0G6sTg: raises $6.40 to $10.40 and is all-in
Mch463E1dxQfVob352za6w: calls $6.40
*** TURN *** [8h 6c 8s] [As]
*** RIVER *** [8h 6c 8s As] [6h]
*** SHOW DOWN ***
Mch463E1dxQfVob352za6w: shows [Ad Js] (two pair, Aces and Eights)
4vTIxEd0Qfkak22W0G6sTg: shows [8d Ah] (a full house, Eights full of Aces)
4vTIxEd0Qfkak22W0G6sTg collected $22.15 from side pot
0/FYfBoKhINaqU/H5OSS1A: mucks hand 
4vTIxEd0Qfkak22W0G6sTg collected $4.55 from main pot
*** SUMMARY ***
Total pot $28.05 Main pot $4.55. Side pot $22.15. | Rake $1.35 
Board [8h 6c 8s As 6h]
Seat 1: 0/FYfBoKhINaqU/H5OSS1A (big blind) mucked
Seat 2: 4vTIxEd0Qfkak22W0G6sTg showed [8d Ah] and won ($26.70) with a full house, Eights full of Aces
Seat 3: 8f0dtuUGqDbgE6up1lQAlg folded before Flop
Seat 4: UfU14XiqkyIQoIJy9COOsQ folded before Flop
Seat 5: ymz+a8dgHSUFPooYplw7Ow (button) folded before Flop (didn't bet)
Seat 6: Mch463E1dxQfVob352za6w (small blind) showed [Ad Js] and lost with two pair, Aces and Eights




PokerStars Game #59939699414:  Hold'em No Limit ($0.10/$0.25) - 2009/07/01 0:46:38 ET
Table 'BmUMTVcNATeov2rAGYU0Qg' 9-max Seat #5 is the button
Seat 2: jJnMGXoBXye+afMd0k0rUw ($14.55 in chips) 
Seat 3: hJ4uYjNmSZdjrKA8cjZqCA ($20.90 in chips) 
Seat 4: aNpwfA31EREwO+ar4XzBCw ($35.50 in chips) 
Seat 5: EBPuArucumZnjWoW71jHBg ($41.25 in chips) 
Seat 8: f/H6PsHRl4W1JyNsEDvPtg ($10 in chips) 
Seat 9: aCVg6cCxQcqClhB9nq/p1w ($25.35 in chips) 
BX9NgIrtlXh1K47KYMsMtQ will be allowed to play after the button
navalhad@ will be allowed to play after the button
f/H6PsHRl4W1JyNsEDvPtg: posts small blind $0.10
aCVg6cCxQcqClhB9nq/p1w: posts big blind $0.25
QEbIGci+itdw+re8RM5fZA: sits out 
*** HOLE CARDS ***
jJnMGXoBXye+afMd0k0rUw: calls $0.25
hJ4uYjNmSZdjrKA8cjZqCA: calls $0.25
aNpwfA31EREwO+ar4XzBCw: calls $0.25
EBPuArucumZnjWoW71jHBg: raises $0.75 to $1
f/H6PsHRl4W1JyNsEDvPtg: folds 
aCVg6cCxQcqClhB9nq/p1w: raises $1 to $2
jJnMGXoBXye+afMd0k0rUw: calls $1.75
hJ4uYjNmSZdjrKA8cjZqCA: folds 
aNpwfA31EREwO+ar4XzBCw: folds 
EBPuArucumZnjWoW71jHBg: calls $1
*** FLOP *** [Ah 2s 8s]
aCVg6cCxQcqClhB9nq/p1w: bets $0.25
jJnMGXoBXye+afMd0k0rUw: calls $0.25
EBPuArucumZnjWoW71jHBg: calls $0.25
*** TURN *** [Ah 2s 8s] [2h]
aCVg6cCxQcqClhB9nq/p1w: bets $3
jJnMGXoBXye+afMd0k0rUw: folds 
EBPuArucumZnjWoW71jHBg: calls $3
*** RIVER *** [Ah 2s 8s 2h] [Jc]
aCVg6cCxQcqClhB9nq/p1w: bets $3
EBPuArucumZnjWoW71jHBg: raises $5 to $8
aCVg6cCxQcqClhB9nq/p1w: calls $5
*** SHOW DOWN ***
EBPuArucumZnjWoW71jHBg: shows [Js Jh] (a full house, Jacks full of Deuces)
aCVg6cCxQcqClhB9nq/p1w: mucks hand 
EBPuArucumZnjWoW71jHBg collected $27.95 from pot
*** SUMMARY ***
Total pot $29.35 | Rake $1.40 
Board [Ah 2s 8s 2h Jc]
Seat 2: jJnMGXoBXye+afMd0k0rUw folded on the Turn
Seat 3: hJ4uYjNmSZdjrKA8cjZqCA folded before Flop
Seat 4: aNpwfA31EREwO+ar4XzBCw folded before Flop
Seat 5: EBPuArucumZnjWoW71jHBg (button) showed [Js Jh] and won ($27.95) with a full house, Jacks full of Deuces
Seat 8: f/H6PsHRl4W1JyNsEDvPtg (small blind) folded before Flop
Seat 9: aCVg6cCxQcqClhB9nq/p1w (big blind) mucked




PokerStars Game #59939699426:  Hold'em No Limit ($0.10/$0.25) - 2009/07/01 0:46:38 ET
Table 'P1IJQ2p3ACFySC35W1qwQw' 9-max Seat #8 is the button
Seat 1: hBMUlEpyU74r/fwDgIpXjQ ($25 in chips) 
Seat 2: E0iYnEVO2ho7dH3QcCjw7g ($20 in chips) 
Seat 4: LuckyShot



PokerStars Game #59939699636:  Hold'em No Limit ($0.10/$0.25) - 2009/07/01 0:46:38 ET
Table 'h3+tJ4Vtwq0R+eA8S73eZA' 9-max Seat #1 is the button
Seat 1: H5Se03ZqSX7tbULXur2MAg ($20.55 in chips) 
Seat 2: Th3FldXKQW6hWVVPahaoOQ ($27.15 in chips) 
Seat 3: crgjVDgmUqCw4RyLzbohWQ ($16.75 in chips) 
Seat 4: M2QO2DxB5Wawg2h8HSpnYA ($11.70 in chips) 
Seat 5: cZ99hugmLBj9KhTlc8nCSw ($31.45 in chips) 
Seat 6: TvIuLx9zUCE+9Li58iImOQ ($8.20 in chips) 
Seat 7: IIGtqtVGyvZR0ZMYMMPjeQ ($27.35 in chips) 
Seat 8: +2kMBNpY4nF1qNCRd8SJLA ($25.15 in chips) 
Seat 9: qwr38jl5txoR36M7G5qi4A ($7.90 in chips) 
Th3FldXKQW6hWVVPahaoOQ: posts small blind $0.10
crgjVDgmUqCw4RyLzbohWQ: posts big blind $0.25
*** HOLE CARDS ***
M2QO2DxB5Wawg2h8HSpnYA: folds 
cZ99hugmLBj9KhTlc8nCSw: folds 
TvIuLx9zUCE+9Li58iImOQ: calls $0.25
IIGtqtVGyvZR0ZMYMMPjeQ: folds 
+2kMBNpY4nF1qNCRd8SJLA: folds 
qwr38jl5txoR36M7G5qi4A: folds 
H5Se03ZqSX7tbULXur2MAg: folds 
Th3FldXKQW6hWVVPahaoOQ: folds 
crgjVDgmUqCw4RyLzbohWQ: checks 
*** FLOP *** [5s Kh 8h]
crgjVDgmUqCw4RyLzbohWQ: checks 
TvIuLx9zUCE+9Li58iImOQ: checks 
*** TURN *** [5s Kh 8h] [2h]
crgjVDgmUqCw4RyLzbohWQ: checks 
TvIuLx9zUCE+9Li58iImOQ: checks 
*** RIVER *** [5s Kh 8h 2h] [4h]
crgjVDgmUqCw4RyLzbohWQ: bets $0.25
TvIuLx9zUCE+9Li58iImOQ: calls $0.25
*** SHOW DOWN ***
crgjVDgmUqCw4RyLzbohWQ: shows [Ts Ad] (high card Ace)
TvIuLx9zUCE+9Li58iImOQ: shows [As Jc] (high card Ace - King+Jack kicker)
TvIuLx9zUCE+9Li58iImOQ collected $1.05 from pot
*** SUMMARY ***
Total pot $1.10 | Rake $0.05 
Board [5s Kh 8h 2h 4h]
Seat 1: H5Se03ZqSX7tbULXur2MAg (button) folded before Flop (didn't bet)
Seat 2: Th3FldXKQW6hWVVPahaoOQ (small blind) folded before Flop
Seat 3: crgjVDgmUqCw4RyLzbohWQ (big blind) showed [Ts Ad] and lost with high card Ace
Seat 4: M2QO2DxB5Wawg2h8HSpnYA folded before Flop (didn't bet)
Seat 5: cZ99hugmLBj9KhTlc8nCSw folded before Flop (didn't bet)
Seat 6: TvIuLx9zUCE+9Li58iImOQ showed [As Jc] and won ($1.05) with high card Ace
Seat 7: IIGtqtVGyvZR0ZMYMMPjeQ folded before Flop (didn't bet)
Seat 8: +2kMBNpY4nF1qNCRd8SJLA folded before Flop (didn't bet)
Seat 9: qwr38jl5txoR36M7G5qi4A folded before Flop (didn't bet)




PokerStars Game #59939699714:  Hold'em No Limit ($0.10/$0.25) - 2009/07/01 0:46:38 ET
Table '7eunnLa5p3aGsPrUrNnn/A' 9-max Seat #4 is the button
Seat 2: aJy680tKSaP5er559aSuGA ($11.90 in chips) 
Seat 3: E0iYnEVO2ho7dH3QcCjw7g ($20.30 in chips) 
Seat 4: opOCI2p6kW0tINuVaAqmcQ ($28.85 in chips) 
Seat 5: JLfmdpDbz2ljMNE7ICboMQ ($7.45 in chips) 
Seat 6: jx9kXw1SAZrvXp9Nerz8+Q ($16.10 in chips) 
Seat 7: sD+TKtt36XiiN6jqHiLwDA ($24.40 in chips) 
Seat 8: 1Clf3cPrqoy/YgvWdWK1Xw ($5 in chips) 
Seat 9: rUpvA02nErFvZ4yFbDR8XA ($20.20 in chips) 
JLfmdpDbz2ljMNE7ICboMQ: posts small blind $0.10
jx9kXw1SAZrvXp9Nerz8+Q: posts big blind $0.25
22dIObOuor/A+IKWkNoAlA: sits out 
*** HOLE CARDS ***
sD+TKtt36XiiN6jqHiLwDA: calls $0.25
1Clf3cPrqoy/YgvWdWK1Xw: folds 
rUpvA02nErFvZ4yFbDR8XA: folds 
aJy680tKSaP5er559aSuGA: folds 
E0iYnEVO2ho7dH3QcCjw7g: raises $0.75 to $1
opOCI2p6kW0tINuVaAqmcQ: calls $1
JLfmdpDbz2ljMNE7ICboMQ: folds 
jx9kXw1SAZrvXp9Nerz8+Q: folds 
sD+TKtt36XiiN6jqHiLwDA: calls $0.75
*** FLOP *** [7h 3h Ac]
sD+TKtt36XiiN6jqHiLwDA: checks 
E0iYnEVO2ho7dH3QcCjw7g: bets $2.25
opOCI2p6kW0tINuVaAqmcQ: folds 
sD+TKtt36XiiN6jqHiLwDA: folds 
Uncalled bet ($2.25) returned to E0iYnEVO2ho7dH3QcCjw7g
E0iYnEVO2ho7dH3QcCjw7g collected $3.20 from pot
*** SUMMARY ***
Total pot $3.35 | Rake $0.15 
Board [7h 3h Ac]
Seat 2: aJy680tKSaP5er559aSuGA folded before Flop (didn't bet)
Seat 3: E0iYnEVO2ho7dH3QcCjw7g collected ($3.20)
Seat 4: opOCI2p6kW0tINuVaAqmcQ (button) folded on the Flop
Seat 5: JLfmdpDbz2ljMNE7ICboMQ (small blind) folded before Flop
Seat 6: jx9kXw1SAZrvXp9Nerz8+Q (big blind) folded before Flop
Seat 7: sD+TKtt36XiiN6jqHiLwDA folded on the Flop
Seat 8: 1Clf3cPrqoy/YgvWdWK1Xw folded before Flop (didn't bet)
Seat 9: rUpvA02nErFvZ4yFbDR8XA folded before Flop (didn't bet)




PokerStars Game #59939699412:  Hold'em No Limit ($0.10/$0.25) - 2009/07/01 0:46:38 ET
Table 'Qr+t8WGovMECkBv+cV1lrg' 6-max Seat #5 is the button
Seat 2: 9h7TNZ1TDGRUJXA6rI+ZTw ($14.85 in chips) 
Seat 3: bjJnMpKgoF+vgHW2f1NCsg ($18.50 in chips) 
Seat 5: iwlxXocltgSdaBmusNXanQ ($23.90 in chips) 
Seat 6: j5NZbEJHsERuXjPHWqc1Nw ($13.25 in chips) 
j5NZbEJHsERuXjPHWqc1Nw: posts small blind $0.10
9h7TNZ1TDGRUJXA6rI+ZTw: posts big blind $0.25
1NNFfYMd5Hsphl/FYz9fNA: sits out 
*** HOLE CARDS ***
bjJnMpKgoF+vgHW2f1NCsg: calls $0.25
iwlxXocltgSdaBmusNXanQ: calls $0.25
j5NZbEJHsERuXjPHWqc1Nw: folds 
9h7TNZ1TDGRUJXA6rI+ZTw: checks 
*** FLOP *** [5d 5s Qh]
9h7TNZ1TDGRUJXA6rI+ZTw: checks 
bjJnMpKgoF+vgHW2f1NCsg: checks 
iwlxXocltgSdaBmusNXanQ: checks 
*** TURN *** [5d 5s Qh] [2h]
9h7TNZ1TDGRUJXA6rI+ZTw: bets $0.25
bjJnMpKgoF+vgHW2f1NCsg: calls $0.25
iwlxXocltgSdaBmusNXanQ: folds 
*** RIVER *** [5d 5s Qh 2h] [Ts]
9h7TNZ1TDGRUJXA6rI+ZTw: checks 
bjJnMpKgoF+vgHW2f1NCsg: checks 
*** SHOW DOWN ***
9h7TNZ1TDGRUJXA6rI+ZTw: shows [2d Qs] (two pair, Queens and Fives)
bjJnMpKgoF+vgHW2f1NCsg: mucks hand 
9h7TNZ1TDGRUJXA6rI+ZTw collected $1.30 from pot
*** SUMMARY ***
Total pot $1.35 | Rake $0.05 
Board [5d 5s Qh 2h Ts]
Seat 2: 9h7TNZ1TDGRUJXA6rI+ZTw (big blind) showed [2d Qs] and won ($1.30) with two pair, Queens and Fives
Seat 3: bjJnMpKgoF+vgHW2f1NCsg mucked
Seat 5: iwlxXocltgSdaBmusNXanQ (button) folded on the Turn
Seat 6: j5NZbEJHsERuXjPHWqc1Nw (small blind) folded before Flop




PokerStars Game #59939699786:  Hold'em No Limit ($0.10/$0.25) - 2009/07/01 0:46:39 ET
Table 'Yb2CyZosw7N3yRRVLhKnKg' 9-max Seat #4 is the button
Seat 1: lcT2xQLmuzNRe6+aWd6eww ($34.75 in chips) 
Seat 2: dmYlc+1cjwZMJ7wV+Z0rRg ($25.55 in chips) 
Seat 3: I8/fpJ2v6LsVf0kxqaVdMQ ($15.15 in chips) 
Seat 4: H5Se03ZqSX7tbULXur2MAg ($28.65 in chips) 
Seat 5: QUCO+kde5iROhmqVTzQ6KQ ($30.50 in chips) 
Seat 6: opOCI2p6kW0tINuVaAqmcQ ($28.60 in chips) 
Seat 7: OiV1PWZ3IkN29JlmCcnTwQ ($4.90 in chips) 
Seat 8: aJy680tKSaP5er559aSuGA ($22.15 in chips) 
Seat 9: ZUElLjBpTRwlrnB3Y2g8ew ($13.65 in chips) 
QUCO+kde5iROhmqVTzQ6KQ: posts small blind $0.10
opOCI2p6kW0tINuVaAqmcQ: posts big blind $0.25
*** HOLE CARDS ***
OiV1PWZ3IkN29JlmCcnTwQ: raises $0.75 to $1
aJy680tKSaP5er559aSuGA: calls $1
ZUElLjBpTRwlrnB3Y2g8ew: folds 
QUCO+kde5iROhmqVTzQ6KQ said, "donk...lol.... u been watching too much tv"
lcT2xQLmuzNRe6+aWd6eww: folds 
dmYlc+1cjwZMJ7wV+Z0rRg: calls $1
I8/fpJ2v6LsVf0kxqaVdMQ: folds 
H5Se03ZqSX7tbULXur2MAg: folds 
QUCO+kde5iROhmqVTzQ6KQ said, "u learn that from the travel channel?"
QUCO+kde5iROhmqVTzQ6KQ: folds 
opOCI2p6kW0tINuVaAqmcQ: calls $0.75
*** FLOP *** [9d 8d As]
opOCI2p6kW0tINuVaAqmcQ: checks 
OiV1PWZ3IkN29JlmCcnTwQ: checks 
aJy680tKSaP5er559aSuGA: checks 
dmYlc+1cjwZMJ7wV+Z0rRg: checks 
*** TURN *** [9d 8d As] [7c]
opOCI2p6kW0tINuVaAqmcQ: bets $3
lcT2xQLmuzNRe6+aWd6eww said, "no espn"
QUCO+kde5iROhmqVTzQ6KQ said, "love it...."
OiV1PWZ3IkN29JlmCcnTwQ: calls $3
aJy680tKSaP5er559aSuGA: folds 
dmYlc+1cjwZMJ7wV+Z0rRg: folds 
*** RIVER *** [9d 8d As 7c] [Th]
opOCI2p6kW0tINuVaAqmcQ: checks 
OiV1PWZ3IkN29JlmCcnTwQ: bets $0.90 and is all-in
lcT2xQLmuzNRe6+aWd6eww said, "u the az that tries to act like nice catch is a compliment"
opOCI2p6kW0tINuVaAqmcQ: calls $0.90
*** SHOW DOWN ***
OiV1PWZ3IkN29JlmCcnTwQ: shows [Ah Ad] (three of a kind, Aces)
opOCI2p6kW0tINuVaAqmcQ: mucks hand 
OiV1PWZ3IkN29JlmCcnTwQ collected $11.35 from pot
*** SUMMARY ***
Total pot $11.90 | Rake $0.55 
Board [9d 8d As 7c Th]
Seat 1: lcT2xQLmuzNRe6+aWd6eww folded before Flop (didn't bet)
Seat 2: dmYlc+1cjwZMJ7wV+Z0rRg folded on the Turn
Seat 3: I8/fpJ2v6LsVf0kxqaVdMQ folded before Flop (didn't bet)
Seat 4: H5Se03ZqSX7tbULXur2MAg (button) folded before Flop (didn't bet)
Seat 5: QUCO+kde5iROhmqVTzQ6KQ (small blind) folded before Flop
Seat 6: opOCI2p6kW0tINuVaAqmcQ (big blind) mucked
Seat 7: OiV1PWZ3IkN29JlmCcnTwQ showed [Ah Ad] and won ($11.35) with three of a kind, Aces
Seat 8: aJy680tKSaP5er559aSuGA folded on the Turn
Seat 9: ZUElLjBpTRwlrnB3Y2g8ew folded before Flop (didn't bet)




PokerStars Game #59939699930:  Hold'em No Limit ($0.10/$0.25) - 2009/07/01 0:46:39 ET
Table 'edvgY2YQ1I34euq4EVqGnA' 6-max Seat #3 is the button
Seat 1: mvFHK3pE7tCxJEqLjKC70Q ($19.40 in chips) 
Seat 2: Icq9naXohH/QOb/LOvZPZQ ($10 in chips) 
Seat 3: HjESR5/RHWT5gaSbIVQQ0Q ($17.75 in chips) 
Seat 4: JFIAqU8lCZ0vWwEl4bdGsg ($30.25 in chips) 
Seat 5: EE16Ua5b1HSsYej5zeXOlA ($31.85 in chips) 
Seat 6: kG34n23qFQA3nzdOJTQ1dA ($68.25 in chips) 
JFIAqU8lCZ0vWwEl4bdGsg: posts small blind $0.10
EE16Ua5b1HSsYej5zeXOlA: posts big blind $0.25
Icq9naXohH/QOb/LOvZPZQ is connected 
Icq9naXohH/QOb/LOvZPZQ: posts big blind $0.25
*** HOLE CARDS ***
kG34n23qFQA3nzdOJTQ1dA: folds 
mvFHK3pE7tCxJEqLjKC70Q: folds 
Icq9naXohH/QOb/LOvZPZQ: checks 
HjESR5/RHWT5gaSbIVQQ0Q: calls $0.25
JFIAqU8lCZ0vWwEl4bdGsg: folds 
EE16Ua5b1HSsYej5zeXOlA: checks 
*** FLOP *** [Qs 5d 4s]
EE16Ua5b1HSsYej5zeXOlA: checks 
Icq9naXohH/QOb/LOvZPZQ: checks 
HjESR5/RHWT5gaSbIVQQ0Q: bets $0.25
EE16Ua5b1HSsYej5zeXOlA: folds 
Icq9naXohH/QOb/LOvZPZQ: calls $0.25
*** TURN *** [Qs 5d 4s] [8s]
Icq9naXohH/QOb/LOvZPZQ: checks 
HjESR5/RHWT5gaSbIVQQ0Q is disconnected 
HjESR5/RHWT5gaSbIVQQ0Q is connected 
HjESR5/RHWT5gaSbIVQQ0Q: bets $0.50
Icq9naXohH/QOb/LOvZPZQ: calls $0.50
*** RIVER *** [Qs 5d 4s 8s] [Js]
Icq9naXohH/QOb/LOvZPZQ: bets $1.75
HjESR5/RHWT5gaSbIVQQ0Q: raises $5.25 to $7
Icq9naXohH/QOb/LOvZPZQ: raises $2 to $9 and is all-in
HjESR5/RHWT5gaSbIVQQ0Q: folds 
Uncalled bet ($2) returned to Icq9naXohH/QOb/LOvZPZQ
Icq9naXohH/QOb/LOvZPZQ collected $15.55 from pot
Icq9naXohH/QOb/LOvZPZQ: doesn't show hand 
*** SUMMARY ***
Total pot $16.35 | Rake $0.80 
Board [Qs 5d 4s 8s Js]
Seat 1: mvFHK3pE7tCxJEqLjKC70Q folded before Flop (didn't bet)
Seat 2: Icq9naXohH/QOb/LOvZPZQ collected ($15.55)
Seat 3: HjESR5/RHWT5gaSbIVQQ0Q (button) folded on the River
Seat 4: JFIAqU8lCZ0vWwEl4bdGsg (small blind) folded before Flop
Seat 5: EE16Ua5b1HSsYej5zeXOlA (big blind) folded on the Flop
Seat 6: kG34n23qFQA3nzdOJTQ1dA folded before Flop (didn't bet)




PokerStars Game #59939700258:  Hold'em No Limit ($0.10/$0.25) - 2009/07/01 0:46:39 ET
Table 'O6cwjhrMn9pfzx1Ngn5zkQ' 6-max Seat #3 is the button
Seat 1: k4mJ9nD/YOVTl8/kGW+U6w ($14.85 in chips) 
Seat 2: M6xK/VklCvdyyrmvzATlxQ ($12.50 in chips) 
Seat 3: EE16Ua5b1HSsYej5zeXOlA ($25.55 in chips) 
Seat 4: wKFJ513ucluNNiMlkXcDOQ ($32.20 in chips) 
Seat 5: niLn0xUVlqh8If80xRjzCA ($22.40 in chips) 
Seat 6: d0J1xuhsynEY81YHwAvJ5g ($27.45 in chips) 
wKFJ513ucluNNiMlkXcDOQ: posts small blind $0.10
niLn0xUVlqh8If80xRjzCA: posts big blind $0.25
*** HOLE CARDS ***
d0J1xuhsynEY81YHwAvJ5g: folds 
k4mJ9nD/YOVTl8/kGW+U6w: calls $0.25
M6xK/VklCvdyyrmvzATlxQ: folds 
EE16Ua5b1HSsYej5zeXOlA: folds 
wKFJ513ucluNNiMlkXcDOQ: raises $1.25 to $1.50
niLn0xUVlqh8If80xRjzCA: folds 
k4mJ9nD/YOVTl8/kGW+U6w: folds 
Uncalled bet ($1.25) returned to wKFJ513ucluNNiMlkXcDOQ
wKFJ513ucluNNiMlkXcDOQ collected $0.75 from pot
wKFJ513ucluNNiMlkXcDOQ: doesn't show hand 
*** SUMMARY ***
Total pot $0.75 | Rake $0 
Seat 1: k4mJ9nD/YOVTl8/kGW+U6w folded before Flop
Seat 2: M6xK/VklCvdyyrmvzATlxQ folded before Flop (didn't bet)
Seat 3: EE16Ua5b1HSsYej5zeXOlA (button) folded before Flop (didn't bet)
Seat 4: wKFJ513ucluNNiMlkXcDOQ (small blind) collected ($0.75)
Seat 5: niLn0xUVlqh8If80xRjzCA (big blind) folded before Flop
Seat 6: d0J1xuhsynEY81YHwAvJ5g folded before Flop (didn't bet)




PokerStars Game #59939699810:  Hold'em No Limit ($0.10/$0.25) - 2009/07/01 0:46:39 ET
Table 'KU/HrxqxwDz8HKEhYTZ6uw' 6-max Seat #5 is the button
Seat 1: gaPMxLGp9SOj4Lq6t+/0Ig ($27.15 in chips) 
Seat 2: kG34n23qFQA3nzdOJTQ1dA ($24.65 in chips) 
Seat 3: 3seg9SJ1y+HUPN0X0XKF5Q ($6.45 in chips) 
Seat 4: ozxrnSdjO4oiCJmh7+KoTA ($25 in chips) 
Seat 5: 4YSTu0Cdzpppe1lUgCZGCQ ($32.40 in chips) 
Seat 6: QIWnfLSqfMcoFfdDe5LZPg ($18.85 in chips) 
QIWnfLSqfMcoFfdDe5LZPg: posts small blind $0.10
gaPMxLGp9SOj4Lq6t+/0Ig: posts big blind $0.25
*** HOLE CARDS ***
kG34n23qFQA3nzdOJTQ1dA: folds 
3seg9SJ1y+HUPN0X0XKF5Q: raises $0.25 to $0.50
ozxrnSdjO4oiCJmh7+KoTA: folds 
4YSTu0Cdzpppe1lUgCZGCQ: calls $0.50
QIWnfLSqfMcoFfdDe5LZPg: folds 
gaPMxLGp9SOj4Lq6t+/0Ig: folds 
*** FLOP *** [6d 5c 5s]
3seg9SJ1y+HUPN0X0XKF5Q: checks 
4YSTu0Cdzpppe1lUgCZGCQ: bets $1.25
3seg9SJ1y+HUPN0X0XKF5Q: raises $1.25 to $2.50
4YSTu0Cdzpppe1lUgCZGCQ: raises $6.25 to $8.75
3seg9SJ1y+HUPN0X0XKF5Q: calls $3.45 and is all-in
Uncalled bet ($2.80) returned to 4YSTu0Cdzpppe1lUgCZGCQ
*** TURN *** [6d 5c 5s] [4d]
*** RIVER *** [6d 5c 5s 4d] [8s]
*** SHOW DOWN ***
3seg9SJ1y+HUPN0X0XKF5Q: shows [Qd Qs] (two pair, Queens and Fives)
4YSTu0Cdzpppe1lUgCZGCQ: shows [7s 7h] (a straight, Four to Eight)
4YSTu0Cdzpppe1lUgCZGCQ collected $12.60 from pot
*** SUMMARY ***
Total pot $13.25 | Rake $0.65 
Board [6d 5c 5s 4d 8s]
Seat 1: gaPMxLGp9SOj4Lq6t+/0Ig (big blind) folded before Flop
Seat 2: kG34n23qFQA3nzdOJTQ1dA folded before Flop (didn't bet)
Seat 3: 3seg9SJ1y+HUPN0X0XKF5Q showed [Qd Qs] and lost with two pair, Queens and Fives
Seat 4: ozxrnSdjO4oiCJmh7+KoTA folded before Flop (didn't bet)
Seat 5: 4YSTu0Cdzpppe1lUgCZGCQ (button) showed [7s 7h] and won ($12.60) with a straight, Four to Eight
Seat 6: QIWnfLSqfMcoFfdDe5LZPg (small blind) folded before Flop




PokerStars Game #59939700170:  Hold'em No Limit ($0.10/$0.25) - 2009/07/01 0:46:39 ET
Table 'xPn6TS/y/OWkX7Qa+MUuKA' 6-max Seat #2 is the button
Seat 1: JFIAqU8lCZ0vWwEl4bdGsg ($28.25 in chips) 
Seat 2: buyjetgNT1McXtdaP4zynA ($24.75 in chips) 
Seat 3: o08wk0F4gROLhZS04Iyl3w ($26.60 in chips) 
Seat 4: SS/yfeArhULzIcOPe8MdPg ($34.20 in chips) 
Seat 5: I1TxPvWj8NfG8orglCinNA ($38.90 in chips) 
Seat 6: oseFhpinoe+Zg4j5xyBjyQ ($53.70 in chips) 
o08wk0F4gROLhZS04Iyl3w: posts small blind $0.10
SS/yfeArhULzIcOPe8MdPg: posts big blind $0.25
*** HOLE CARDS ***
I1TxPvWj8NfG8orglCinNA: folds 
oseFhpinoe+Zg4j5xyBjyQ: calls $0.25
JFIAqU8lCZ0vWwEl4bdGsg: raises $1 to $1.25
buyjetgNT1McXtdaP4zynA: folds 
o08wk0F4gROLhZS04Iyl3w: folds 
SS/yfeArhULzIcOPe8MdPg: folds 
oseFhpinoe+Zg4j5xyBjyQ: folds 
Uncalled bet ($1) returned to JFIAqU8lCZ0vWwEl4bdGsg
JFIAqU8lCZ0vWwEl4bdGsg collected $0.85 from pot
JFIAqU8lCZ0vWwEl4bdGsg: doesn't show hand 
*** SUMMARY ***
Total pot $0.85 | Rake $0 
Seat 1: JFIAqU8lCZ0vWwEl4bdGsg collected ($0.85)
Seat 2: buyjetgNT1McXtdaP4zynA (button) folded before Flop (didn't bet)
Seat 3: o08wk0F4gROLhZS04Iyl3w (small blind) folded before Flop
Seat 4: SS/yfeArhULzIcOPe8MdPg (big blind) folded before Flop
Seat 5: I1TxPvWj8NfG8orglCinNA folded before Flop (didn't bet)
Seat 6: oseFhpinoe+Zg4j5xyBjyQ folded before Flop




PokerStars Game #59939700032:  Hold'em No Limit ($0.10/$0.25) - 2009/07/01 0:46:39 ET
Table 'ORSZkZqq+7Ja2PdeCFAytA' 9-max Seat #5 is the button
Seat 1: Gpa8cld5y0mdOomHJgHhlA ($4 in chips) 
Seat 4: PJJTm/ccITEBlwPReiBTwg ($9 in chips) 
Seat 5: fOv1xoqR8m9slwElVu7Y+A ($18.90 in chips) 
Gpa8cld5y0mdOomHJgHhlA: posts small blind $0.10
PJJTm/ccITEBlwPReiBTwg: posts big blind $0.25
*** HOLE CARDS ***
fOv1xoqR8m9slwElVu7Y+A: raises $0.25 to $0.50
Gpa8cld5y0mdOomHJgHhlA: folds 
PJJTm/ccITEBlwPReiBTwg: calls $0.25
*** FLOP *** [Js 4h Qs]
PJJTm/ccITEBlwPReiBTwg: bets $0.25
fOv1xoqR8m9slwElVu7Y+A: calls $0.25
*** TURN *** [Js 4h Qs] [Ts]
PJJTm/ccITEBlwPReiBTwg: bets $0.25
fOv1xoqR8m9slwElVu7Y+A: calls $0.25
*** RIVER *** [Js 4h Qs Ts] [7c]
PJJTm/ccITEBlwPReiBTwg: bets $0.50
fOv1xoqR8m9slwElVu7Y+A: folds 
Uncalled bet ($0.50) returned to PJJTm/ccITEBlwPReiBTwg
PJJTm/ccITEBlwPReiBTwg collected $2 from pot
*** SUMMARY ***
Total pot $2.10 | Rake $0.10 
Board [Js 4h Qs Ts 7c]
Seat 1: Gpa8cld5y0mdOomHJgHhlA (small blind) folded before Flop
Seat 4: PJJTm/ccITEBlwPReiBTwg (big blind) collected ($2)
Seat 5: fOv1xoqR8m9slwElVu7Y+A (button) folded on the River




PokerStars Game #59939699820:  Hold'em No Limit ($0.10/$0.25) - 2009/07/01 0:46:39 ET
Table 'fIrOIN3HoXM27ZpRwKa6oA' 6-max Seat #5 is the button
Seat 1: I1TxPvWj8NfG8orglCinNA ($38.50 in chips) 
Seat 2: 5tB0F9NjPSUL4FzmzBMs2Q ($39.65 in chips) 
Seat 3: eSKnWz2RD4rvwnvB+rFzIg ($25.35 in chips) 
Seat 5: 8ClCHtFXGNplITm+63KB+Q ($26.10 in chips) 
Seat 6: v+QfkGiuj9bgtuNoVnDO8w ($28.60 in chips) 
v+QfkGiuj9bgtuNoVnDO8w: posts small blind $0.10
I1TxPvWj8NfG8orglCinNA: posts big blind $0.25
*** HOLE CARDS ***
5tB0F9NjPSUL4FzmzBMs2Q: folds 
eSKnWz2RD4rvwnvB+rFzIg: folds 
8ClCHtFXGNplITm+63KB+Q: folds 
v+QfkGiuj9bgtuNoVnDO8w: folds 
Uncalled bet ($0.15) returned to I1TxPvWj8NfG8orglCinNA
I1TxPvWj8NfG8orglCinNA collected $0.20 from pot
I1TxPvWj8NfG8orglCinNA: doesn't show hand 
*** SUMMARY ***
Total pot $0.20 | Rake $0 
Seat 1: I1TxPvWj8NfG8orglCinNA (big blind) collected ($0.20)
Seat 2: 5tB0F9NjPSUL4FzmzBMs2Q folded before Flop (didn't bet)
Seat 3: eSKnWz2RD4rvwnvB+rFzIg folded before Flop (didn't bet)
Seat 5: 8ClCHtFXGNplITm+63KB+Q (button) folded before Flop (didn't bet)
Seat 6: v+QfkGiuj9bgtuNoVnDO8w (small blind) folded before Flop




PokerStars Game #59939700562:  Hold'em No Limit ($0.10/$0.25) - 2009/07/01 0:46:40 ET
Table 'xmJKTGBeWCwutccj3YfupQ' 6-max Seat #3 is the button
Seat 2: BedjMfrlRfPgSq7CXpPAmg ($49.80 in chips) 
Seat 3: FStoHe64SQWqAsjya9pDkQ ($25.45 in chips) 
Seat 5: oBUDUfeUyCbZBsjxHZgSiw ($16.65 in chips) 
oBUDUfeUyCbZBsjxHZgSiw: posts small blind $0.10
lYjWCpfCxX2kgcHY3v4Yow: is sitting out 
BedjMfrlRfPgSq7CXpPAmg: posts big blind $0.25
*** HOLE CARDS ***
lYjWCpfCxX2kgcHY3v4Yow leaves the table
FStoHe64SQWqAsjya9pDkQ: raises $0.50 to $0.75
oBUDUfeUyCbZBsjxHZgSiw: folds 
BedjMfrlRfPgSq7CXpPAmg: calls $0.50
*** FLOP *** [9s 3s Th]
BedjMfrlRfPgSq7CXpPAmg: checks 
FStoHe64SQWqAsjya9pDkQ: checks 
*** TURN *** [9s 3s Th] [Ad]
BedjMfrlRfPgSq7CXpPAmg: bets $0.95
FStoHe64SQWqAsjya9pDkQ: folds 
Uncalled bet ($0.95) returned to BedjMfrlRfPgSq7CXpPAmg
FStoHe64SQWqAsjya9pDkQ is sitting out
BedjMfrlRfPgSq7CXpPAmg collected $1.55 from pot
*** SUMMARY ***
Total pot $1.60 | Rake $0.05 
Board [9s 3s Th Ad]
Seat 2: BedjMfrlRfPgSq7CXpPAmg (big blind) collected ($1.55)
Seat 3: FStoHe64SQWqAsjya9pDkQ (button) folded on the Turn
Seat 5: oBUDUfeUyCbZBsjxHZgSiw (small blind) folded before Flop




PokerStars Game #59939700692:  Hold'em No Limit ($0.10/$0.25) - 2009/07/01 0:46:40 ET
Table 'pgrBYaOEx/BuqK5iAtlFzw' 9-max Seat #9 is the button
Seat 1: QsLvCwfSWqP+CfjwUnjpXQ ($29.65 in chips) 
Seat 2: hZuGwtYmFKPmQ+v1wlmdfA ($25 in chips) 
Seat 3: rNeDTnQfuSImIGLqvEu7DQ ($8.35 in chips) 
Seat 4: 6meFEBwAfXU5eLC35rA/sw ($6.05 in chips) 
Seat 5: BWzInv8o0kN1pJybv/VjpQ ($25 in chips) 
Seat 6: OqlfFV+MkgflYrm4Q6rLMA ($4.75 in chips) 
Seat 7: jXz58rvCgq0VjyVjUBf2mw ($24.65 in chips) 
Seat 8: cFmpjvcjNoVAEAIQIxWkYg ($25 in chips) 
Seat 9: CvL9Ch1HYCVbTsfpNucitg ($4.65 in chips) 
QsLvCwfSWqP+CfjwUnjpXQ: posts small blind $0.10
hZuGwtYmFKPmQ+v1wlmdfA: posts big blind $0.25
BWzInv8o0kN1pJybv/VjpQ: posts big blind $0.25
*** HOLE CARDS ***
rNeDTnQfuSImIGLqvEu7DQ: calls $0.25
6meFEBwAfXU5eLC35rA/sw: folds 
BWzInv8o0kN1pJybv/VjpQ: checks 
OqlfFV+MkgflYrm4Q6rLMA: raises $0.50 to $0.75
jXz58rvCgq0VjyVjUBf2mw: folds 
cFmpjvcjNoVAEAIQIxWkYg: folds 
CvL9Ch1HYCVbTsfpNucitg: folds 
QsLvCwfSWqP+CfjwUnjpXQ: calls $0.65
hZuGwtYmFKPmQ+v1wlmdfA: folds 
rNeDTnQfuSImIGLqvEu7DQ: calls $0.50
BWzInv8o0kN1pJybv/VjpQ: folds 
*** FLOP *** [6d 5c 6s]
QsLvCwfSWqP+CfjwUnjpXQ: checks 
rNeDTnQfuSImIGLqvEu7DQ: checks 
OqlfFV+MkgflYrm4Q6rLMA: bets $0.75
QsLvCwfSWqP+CfjwUnjpXQ: folds 
rNeDTnQfuSImIGLqvEu7DQ: calls $0.75
*** TURN *** [6d 5c 6s] [Qd]
rNeDTnQfuSImIGLqvEu7DQ: checks 
OqlfFV+MkgflYrm4Q6rLMA: bets $1.25
rNeDTnQfuSImIGLqvEu7DQ: calls $1.25
*** RIVER *** [6d 5c 6s Qd] [4h]
rNeDTnQfuSImIGLqvEu7DQ: bets $2.25
OqlfFV+MkgflYrm4Q6rLMA: folds 
Uncalled bet ($2.25) returned to rNeDTnQfuSImIGLqvEu7DQ
rNeDTnQfuSImIGLqvEu7DQ collected $6.45 from pot
rNeDTnQfuSImIGLqvEu7DQ: doesn't show hand 
*** SUMMARY ***
Total pot $6.75 | Rake $0.30 
Board [6d 5c 6s Qd 4h]
Seat 1: QsLvCwfSWqP+CfjwUnjpXQ (small blind) folded on the Flop
Seat 2: hZuGwtYmFKPmQ+v1wlmdfA (big blind) folded before Flop
Seat 3: rNeDTnQfuSImIGLqvEu7DQ collected ($6.45)
Seat 4: 6meFEBwAfXU5eLC35rA/sw folded before Flop (didn't bet)
Seat 5: BWzInv8o0kN1pJybv/VjpQ folded before Flop
Seat 6: OqlfFV+MkgflYrm4Q6rLMA folded on the River
Seat 7: jXz58rvCgq0VjyVjUBf2mw folded before Flop (didn't bet)
Seat 8: cFmpjvcjNoVAEAIQIxWkYg folded before Flop (didn't bet)
Seat 9: CvL9Ch1HYCVbTsfpNucitg (button) folded before Flop (didn't bet)




PokerStars Game #59939701052:  Hold'em No Limit ($0.10/$0.25) - 2009/07/01 0:46:41 ET
Table 'ouLhepGYovxB2x0QxH7cVg' 9-max Seat #7 is the button
Seat 1: ghNKXUBl/H+t83JF079ZBA ($30.35 in chips) 
Seat 2: r1Z5m4PwSI5ANp7qCE1OJw ($12.75 in chips) 
Seat 3: SkLOm0UugROBRt2EfMpOxQ ($23.75 in chips) 
Seat 4: a0Sx6GHY7ln2Ns2C97eXeA ($29.15 in chips) 
Seat 5: 18G4P1XstjNvItdGUITxgw ($25 in chips) 
Seat 6: r6hsffOo1iKmaPYKwAZmFw ($27.55 in chips) 
Seat 7: oHv2mIZJh3H0JR+WOZteZA ($22.90 in chips) 
Seat 8: opOCI2p6kW0tINuVaAqmcQ ($25 in chips) 
Seat 9: fIgGw0jPUR7labvJPaPbeg ($10.80 in chips) 
opOCI2p6kW0tINuVaAqmcQ: posts small blind $0.10
fIgGw0jPUR7labvJPaPbeg: posts big blind $0.25
*** HOLE CARDS ***
ghNKXUBl/H+t83JF079ZBA: folds 
r1Z5m4PwSI5ANp7qCE1OJw: folds 
SkLOm0UugROBRt2EfMpOxQ: raises $0.50 to $0.75
a0Sx6GHY7ln2Ns2C97eXeA: folds 
18G4P1XstjNvItdGUITxgw: folds 
r6hsffOo1iKmaPYKwAZmFw: folds 
oHv2mIZJh3H0JR+WOZteZA: calls $0.75
opOCI2p6kW0tINuVaAqmcQ: calls $0.65
fIgGw0jPUR7labvJPaPbeg: folds 
*** FLOP *** [9d 4c 5s]
opOCI2p6kW0tINuVaAqmcQ: checks 
SkLOm0UugROBRt2EfMpOxQ: bets $1.75
oHv2mIZJh3H0JR+WOZteZA: calls $1.75
opOCI2p6kW0tINuVaAqmcQ: calls $1.75
*** TURN *** [9d 4c 5s] [9h]
opOCI2p6kW0tINuVaAqmcQ: bets $3.50
SkLOm0UugROBRt2EfMpOxQ: folds 
oHv2mIZJh3H0JR+WOZteZA: folds 
Uncalled bet ($3.50) returned to opOCI2p6kW0tINuVaAqmcQ
opOCI2p6kW0tINuVaAqmcQ collected $7.40 from pot
*** SUMMARY ***
Total pot $7.75 | Rake $0.35 
Board [9d 4c 5s 9h]
Seat 1: ghNKXUBl/H+t83JF079ZBA folded before Flop (didn't bet)
Seat 2: r1Z5m4PwSI5ANp7qCE1OJw folded before Flop (didn't bet)
Seat 3: SkLOm0UugROBRt2EfMpOxQ folded on the Turn
Seat 4: a0Sx6GHY7ln2Ns2C97eXeA folded before Flop (didn't bet)
Seat 5: 18G4P1XstjNvItdGUITxgw folded before Flop (didn't bet)
Seat 6: r6hsffOo1iKmaPYKwAZmFw folded before Flop (didn't bet)
Seat 7: oHv2mIZJh3H0JR+WOZteZA (button) folded on the Turn
Seat 8: opOCI2p6kW0tINuVaAqmcQ (small blind) collected ($7.40)
Seat 9: fIgGw0jPUR7labvJPaPbeg (big blind) folded before Flop




PokerStars Game #59939700964:  Hold'em No Limit ($0.10/$0.25) - 2009/07/01 0:46:41 ET
Table '0w9m+UkNlGMNoPyQqzWk6A' 9-max Seat #2 is the button
Seat 2: tYsOBqdU1+x+yFI7zHO7hQ ($45.95 in chips) 
Seat 3: VWwtMkIjXloiX/RKh7RGWQ ($11.10 in chips) 
Seat 4: VBHxUExRAMrbxUq/cVx9Gw ($5 in chips) 
Seat 5: rPXwQUVloUl+qZm3CCtaJw ($16.50 in chips) 
Seat 6: sWBBy1WroEskLNyJzhkUag ($20.55 in chips) 
Seat 7: lrTLp1zpuCCs/e0pi2M8jw ($7.40 in chips) 
Seat 8: hPhp/RE3cJ5YGaQ2xOHXXg ($4.15 in chips) 
Seat 9: 56S3mA6Zs3pGR+0p0vUCtg ($27.80 in chips) 
VWwtMkIjXloiX/RKh7RGWQ: posts small blind $0.10
VBHxUExRAMrbxUq/cVx9Gw: posts big blind $0.25
DnDcAdn9P0zGovMERigpFA: sits out 
*** HOLE CARDS ***
rPXwQUVloUl+qZm3CCtaJw: folds 
sWBBy1WroEskLNyJzhkUag: folds 
lrTLp1zpuCCs/e0pi2M8jw: folds 
hPhp/RE3cJ5YGaQ2xOHXXg: folds 
56S3mA6Zs3pGR+0p0vUCtg: folds 
tYsOBqdU1+x+yFI7zHO7hQ: raises $0.50 to $0.75
VWwtMkIjXloiX/RKh7RGWQ: folds 
VBHxUExRAMrbxUq/cVx9Gw: raises $0.75 to $1.50
tYsOBqdU1+x+yFI7zHO7hQ: folds 
Uncalled bet ($0.75) returned to VBHxUExRAMrbxUq/cVx9Gw
VBHxUExRAMrbxUq/cVx9Gw collected $1.60 from pot
*** SUMMARY ***
Total pot $1.60 | Rake $0 
Seat 2: tYsOBqdU1+x+yFI7zHO7hQ (button) folded before Flop
Seat 3: VWwtMkIjXloiX/RKh7RGWQ (small blind) folded before Flop
Seat 4: VBHxUExRAMrbxUq/cVx9Gw (big blind) collected ($1.60)
Seat 5: rPXwQUVloUl+qZm3CCtaJw folded before Flop (didn't bet)
Seat 6: sWBBy1WroEskLNyJzhkUag folded before Flop (didn't bet)
Seat 7: lrTLp1zpuCCs/e0pi2M8jw folded before Flop (didn't bet)
Seat 8: hPhp/RE3cJ5YGaQ2xOHXXg folded before Flop (didn't bet)
Seat 9: 56S3mA6Zs3pGR+0p0vUCtg folded before Flop (didn't bet)




PokerStars Game #59939701128:  Hold'em No Limit ($0.10/$0.25) - 2009/07/01 0:46:41 ET
Table 'pAhiNHs/spaABQia+7gWNQ' 9-max Seat #4 is the button
Seat 1: /VQLorsEOrMfI+KamzNQEA ($5 in chips) 
Seat 2: vnCdP3GsLTKadDukKcJk/Q ($25 in chips) 
Seat 3: xEQxarad8/T4jJdpZy5LGw ($27 in chips) 
Seat 4: F7pnn6czNpHvRM55XcA2EA ($25 in chips) 
Seat 6: FinSxgTdEPV/yPQRl5uhmA ($49.95 in chips) 
Seat 7: 04UcDjK4SUEJctLqNtWFoQ ($9.40 in chips) 
Seat 8: vSkQm2EelzwRGDDQQk0Fqw ($24.90 in chips) 
FinSxgTdEPV/yPQRl5uhmA: posts small blind $0.10
04UcDjK4SUEJctLqNtWFoQ: posts big blind $0.25
vZGoOTJLQLhkPj4I+LNGig: sits out 
*** HOLE CARDS ***
OlPJsgR4xypSg/w1z7Gyvw joins the table at seat #5 
vSkQm2EelzwRGDDQQk0Fqw: folds 
/VQLorsEOrMfI+KamzNQEA: folds 
vnCdP3GsLTKadDukKcJk/Q: folds 
xEQxarad8/T4jJdpZy5LGw: folds 
F7pnn6czNpHvRM55XcA2EA: folds 
FinSxgTdEPV/yPQRl5uhmA: raises $0.50 to $0.75
04UcDjK4SUEJctLqNtWFoQ: folds 
Uncalled bet ($0.50) returned to FinSxgTdEPV/yPQRl5uhmA
FinSxgTdEPV/yPQRl5uhmA collected $0.50 from pot
FinSxgTdEPV/yPQRl5uhmA: doesn't show hand 
*** SUMMARY ***
Total pot $0.50 | Rake $0 
Seat 1: /VQLorsEOrMfI+KamzNQEA folded before Flop (didn't bet)
Seat 2: vnCdP3GsLTKadDukKcJk/Q folded before Flop (didn't bet)
Seat 3: xEQxarad8/T4jJdpZy5LGw folded before Flop (didn't bet)
Seat 4: F7pnn6czNpHvRM55XcA2EA (button) folded before Flop (didn't bet)
Seat 6: FinSxgTdEPV/yPQRl5uhmA (small blind) collected ($0.50)
Seat 7: 04UcDjK4SUEJctLqNtWFoQ (big blind) folded before Flop
Seat 8: vSkQm2EelzwRGDDQQk0Fqw folded before Flop (didn't bet)




PokerStars Game #59939701348:  Hold'em No Limit ($0.10/$0.25) - 2009/07/01 0:46:41 ET
Table '4UJB/UOZ5aepyF2v+hIoUg' 6-max Seat #5 is the button
Seat 1: Mch463E1dxQfVob352za6w ($25 in chips) 
Seat 2: TTpuqC1Ny2dgaNZLYg+ZXg ($9.75 in chips) 
Seat 3: dKMsTZMrd8Ire/Qysz7FAA ($4.55 in chips) 
Seat 4: UBrY0qLms3NqxITD3VvlAg ($17.50 in chips) 
Seat 5: hk8pxWcMqHKpvAKgXieLFw ($19.85 in chips) 
Seat 6: RP8Db3hfv5C09Dkfvq1lmw ($19.90 in chips) 
RP8Db3hfv5C09Dkfvq1lmw: posts small blind $0.10
Mch463E1dxQfVob352za6w: posts big blind $0.25
*** HOLE CARDS ***
TTpuqC1Ny2dgaNZLYg+ZXg: raises $0.75 to $1
dKMsTZMrd8Ire/Qysz7FAA: folds 
UBrY0qLms3NqxITD3VvlAg: folds 
hk8pxWcMqHKpvAKgXieLFw: calls $1
RP8Db3hfv5C09Dkfvq1lmw: calls $0.90
Mch463E1dxQfVob352za6w: folds 
*** FLOP *** [Ts Kd Jh]
RP8Db3hfv5C09Dkfvq1lmw: bets $0.50
TTpuqC1Ny2dgaNZLYg+ZXg: raises $2.50 to $3
hk8pxWcMqHKpvAKgXieLFw: folds 
RP8Db3hfv5C09Dkfvq1lmw: calls $2.50
*** TURN *** [Ts Kd Jh] [4s]
RP8Db3hfv5C09Dkfvq1lmw: checks 
TTpuqC1Ny2dgaNZLYg+ZXg: bets $5.75 and is all-in
RP8Db3hfv5C09Dkfvq1lmw: calls $5.75
*** RIVER *** [Ts Kd Jh 4s] [4d]
*** SHOW DOWN ***
RP8Db3hfv5C09Dkfvq1lmw: shows [Qc Js] (two pair, Jacks and Fours)
TTpuqC1Ny2dgaNZLYg+ZXg: mucks hand 
RP8Db3hfv5C09Dkfvq1lmw collected $19.75 from pot
*** SUMMARY ***
Total pot $20.75 | Rake $1 
Board [Ts Kd Jh 4s 4d]
Seat 1: Mch463E1dxQfVob352za6w (big blind) folded before Flop
Seat 2: TTpuqC1Ny2dgaNZLYg+ZXg mucked
Seat 3: dKMsTZMrd8Ire/Qysz7FAA folded before Flop (didn't bet)
Seat 4: UBrY0qLms3NqxITD3VvlAg folded before Flop (didn't bet)
Seat 5: hk8pxWcMqHKpvAKgXieLFw (button) folded on the Flop
Seat 6: RP8Db3hfv5C09Dkfvq1lmw (small blind) showed [Qc Js] and won ($19.75) with two pair, Jacks and Fours




PokerStars Game #59939701080:  Hold'em No Limit ($0.10/$0.25) - 2009/07/01 0:46:41 ET
Table 'VQNfcI8vTBCTvRfd3veTLQ' 6-max Seat #1 is the button
Seat 1: ymz+a8dgHSUFPooYplw7Ow ($24.55 in chips) 
Seat 2: KukIGupqqJCXA+Hp2bEFnA ($5.60 in chips) 
Seat 3: LtASJ9OlkqGrrUKGQlpGAw ($23.05 in chips) 
Seat 4: nc79pm0LZRdhncq55evVqA ($25 in chips) 
Seat 5: gX2vbKwS/8zZPENAWB7hxQ ($11.40 in chips) 
Seat 6: dlCLwmcvRShnuFDEVkdIEA ($12.25 in chips) 
KukIGupqqJCXA+Hp2bEFnA: posts small blind $0.10
LtASJ9OlkqGrrUKGQlpGAw: posts big blind $0.25
*** HOLE CARDS ***
nc79pm0LZRdhncq55evVqA: raises $0.75 to $1
gX2vbKwS/8zZPENAWB7hxQ: folds 
dlCLwmcvRShnuFDEVkdIEA: folds 
ymz+a8dgHSUFPooYplw7Ow: folds 
KukIGupqqJCXA+Hp2bEFnA: calls $0.90
LtASJ9OlkqGrrUKGQlpGAw: folds 
*** FLOP *** [Ah Kc Th]
KukIGupqqJCXA+Hp2bEFnA: bets $1.25
nc79pm0LZRdhncq55evVqA: folds 
Uncalled bet ($1.25) returned to KukIGupqqJCXA+Hp2bEFnA
KukIGupqqJCXA+Hp2bEFnA collected $2.15 from pot
*** SUMMARY ***
Total pot $2.25 | Rake $0.10 
Board [Ah Kc Th]
Seat 1: ymz+a8dgHSUFPooYplw7Ow (button) folded before Flop (didn't bet)
Seat 2: KukIGupqqJCXA+Hp2bEFnA (small blind) collected ($2.15)
Seat 3: LtASJ9OlkqGrrUKGQlpGAw (big blind) folded before Flop
Seat 4: nc79pm0LZRdhncq55evVqA folded on the Flop
Seat 5: gX2vbKwS/8zZPENAWB7hxQ folded before Flop (didn't bet)
Seat 6: dlCLwmcvRShnuFDEVkdIEA folded before Flop (didn't bet)




PokerStars Game #59939700952:  Hold'em No Limit ($0.10/$0.25) - 2009/07/01 0:46:41 ET
Table 'APEHQjIcZHDZUA4iOjju2g' 6-max Seat #5 is the button
Seat 1: eHsmIvAb2JREg4O6hNPnXg ($5.40 in chips) 
Seat 2: 3zD3qLXT1bEffAoWGnc7wg ($25 in chips) 
Seat 3: E7KSkgfIsmIsp0vLnmGFmA ($18 in chips) 
Seat 4: EqXTTLKUlDlz7yi6ziyyWA ($3.15 in chips) 
Seat 5: /xN6gc9+8Hew0HxaB6VIVg ($59.25 in chips) 
Seat 6: y7HCJfEmolBCFdi/0j5TRg ($44.45 in chips) 
y7HCJfEmolBCFdi/0j5TRg: posts small blind $0.10
eHsmIvAb2JREg4O6hNPnXg: posts big blind $0.25
*** HOLE CARDS ***
3zD3qLXT1bEffAoWGnc7wg: folds 
E7KSkgfIsmIsp0vLnmGFmA: folds 
EqXTTLKUlDlz7yi6ziyyWA: raises $0.75 to $1
/xN6gc9+8Hew0HxaB6VIVg: folds 
y7HCJfEmolBCFdi/0j5TRg: folds 
EqXTTLKUlDlz7yi6ziyyWA said, "you are the worst"
eHsmIvAb2JREg4O6hNPnXg: folds 
Uncalled bet ($0.75) returned to EqXTTLKUlDlz7yi6ziyyWA
EqXTTLKUlDlz7yi6ziyyWA collected $0.60 from pot
*** SUMMARY ***
Total pot $0.60 | Rake $0 
Seat 1: eHsmIvAb2JREg4O6hNPnXg (big blind) folded before Flop
Seat 2: 3zD3qLXT1bEffAoWGnc7wg folded before Flop (didn't bet)
Seat 3: E7KSkgfIsmIsp0vLnmGFmA folded before Flop (didn't bet)
Seat 4: EqXTTLKUlDlz7yi6ziyyWA collected ($0.60)
Seat 5: /xN6gc9+8Hew0HxaB6VIVg (button) folded before Flop (didn't bet)
Seat 6: y7HCJfEmolBCFdi/0j5TRg (small blind) folded before Flop




PokerStars Game #59939701780:  Hold'em No Limit ($0.10/$0.25) - 2009/07/01 0:46:42 ET
Table 'Do4nrTNDYpK3sQjwFxX+Og' 6-max Seat #6 is the button
Seat 1: 7JrQNOR9wRBxq9ijFhWieg ($29.70 in chips) 
Seat 2: tzMoGl9F0PUr5NibYueeSw ($44.40 in chips) 
Seat 3: TSmua8tGK3sTbwi0ynrW9Q ($32.80 in chips) 
Seat 4: df7bIV965hvGEDiUAs5cfQ ($14 in chips) 
Seat 5: Ew/TYPQIsbQ2X8nm5iAJBg ($30.80 in chips) 
Seat 6: eHsmIvAb2JREg4O6hNPnXg ($21.65 in chips) 
7JrQNOR9wRBxq9ijFhWieg: posts small blind $0.10
tzMoGl9F0PUr5NibYueeSw: posts big blind $0.25
*** HOLE CARDS ***
TSmua8tGK3sTbwi0ynrW9Q: folds 
df7bIV965hvGEDiUAs5cfQ: folds 
Ew/TYPQIsbQ2X8nm5iAJBg: folds 
eHsmIvAb2JREg4O6hNPnXg: raises $0.50 to $0.75
7JrQNOR9wRBxq9ijFhWieg: raises $1.75 to $2.50
tzMoGl9F0PUr5NibYueeSw: folds 
eHsmIvAb2JREg4O6hNPnXg: raises $2.50 to $5
7JrQNOR9wRBxq9ijFhWieg: folds 
Uncalled bet ($2.50) returned to eHsmIvAb2JREg4O6hNPnXg
eHsmIvAb2JREg4O6hNPnXg collected $5.25 from pot
*** SUMMARY ***
Total pot $5.25 | Rake $0 
Seat 1: 7JrQNOR9wRBxq9ijFhWieg (small blind) folded before Flop
Seat 2: tzMoGl9F0PUr5NibYueeSw (big blind) folded before Flop
Seat 3: TSmua8tGK3sTbwi0ynrW9Q folded before Flop (didn't bet)
Seat 4: df7bIV965hvGEDiUAs5cfQ folded before Flop (didn't bet)
Seat 5: Ew/TYPQIsbQ2X8nm5iAJBg folded before Flop (didn't bet)
Seat 6: eHsmIvAb2JREg4O6hNPnXg (button) collected ($5.25)




PokerStars Game #59939701890:  Hold'em No Limit ($0.10/$0.25) - 2009/07/01 0:46:42 ET
Table 'sgdCtiuCu2BDZhyDi6RzTA' 6-max Seat #5 is the button
Seat 1: 3zD3qLXT1bEffAoWGnc7wg ($28.85 in chips) 
Seat 2: R7AqtFtjtvane2IbChcU+w ($14.75 in chips) 
Seat 3: yzFNNFIfC89bBPwpFPx2ow ($16.50 in chips) 
Seat 4: rVKEgilmMX+EkKzDVvhmxA ($5.90 in chips) 
Seat 5: kD/Cb2UM93FAVgDMhEEb5g ($6.50 in chips) 
Seat 6: KODslGU8ikCYS0/29dUkhg ($11.10 in chips) 
KODslGU8ikCYS0/29dUkhg: posts small blind $0.10
3zD3qLXT1bEffAoWGnc7wg: posts big blind $0.25
*** HOLE CARDS ***
R7AqtFtjtvane2IbChcU+w: folds 
yzFNNFIfC89bBPwpFPx2ow: raises $0.75 to $1
rVKEgilmMX+EkKzDVvhmxA: folds 
kD/Cb2UM93FAVgDMhEEb5g: folds 
KODslGU8ikCYS0/29dUkhg: folds 
3zD3qLXT1bEffAoWGnc7wg: folds 
Uncalled bet ($0.75) returned to yzFNNFIfC89bBPwpFPx2ow
yzFNNFIfC89bBPwpFPx2ow collected $0.60 from pot
yzFNNFIfC89bBPwpFPx2ow: doesn't show hand 
*** SUMMARY ***
Total pot $0.60 | Rake $0 
Seat 1: 3zD3qLXT1bEffAoWGnc7wg (big blind) folded before Flop
Seat 2: R7AqtFtjtvane2IbChcU+w folded before Flop (didn't bet)
Seat 3: yzFNNFIfC89bBPwpFPx2ow collected ($0.60)
Seat 4: rVKEgilmMX+EkKzDVvhmxA folded before Flop (didn't bet)
Seat 5: kD/Cb2UM93FAVgDMhEEb5g (button) folded before Flop (didn't bet)
Seat 6: KODslGU8ikCYS0/29dUkhg (small blind) folded before Flop




PokerStars Game #59939701810:  Hold'em No Limit ($0.10/$0.25) - 2009/07/01 0:46:42 ET
Table 'bIGKmJgZehWJ+FAo8b85iw' 9-max Seat #4 is the button
Seat 1: yyG4svzOpC1A+sUP/scg6w ($9.35 in chips) 
Seat 3: TeWJxSETzbXGiYKx0y+dtg ($36.05 in chips) 
Seat 4: EJRVVUAJEYLdm1qbO8TzuQ ($8.30 in chips) 
Seat 5: PXXRcmL5z1Ibt+PO2FWHlA ($6.45 in chips) 
Seat 6: H5Se03ZqSX7tbULXur2MAg ($21.70 in chips) 
Seat 7: DdPXdieucQ+n99u1n3A+rQ ($11.45 in chips) 
Seat 8: +2kMBNpY4nF1qNCRd8SJLA ($25 in chips) 
Seat 9: aNpwfA31EREwO+ar4XzBCw ($25 in chips) 
PXXRcmL5z1Ibt+PO2FWHlA: posts small blind $0.10
H5Se03ZqSX7tbULXur2MAg: posts big blind $0.25
*** HOLE CARDS ***
DdPXdieucQ+n99u1n3A+rQ: folds 
+2kMBNpY4nF1qNCRd8SJLA: raises $0.75 to $1
aNpwfA31EREwO+ar4XzBCw: folds 
yyG4svzOpC1A+sUP/scg6w: folds 
TeWJxSETzbXGiYKx0y+dtg: folds 
EJRVVUAJEYLdm1qbO8TzuQ: folds 
PXXRcmL5z1Ibt+PO2FWHlA: folds 
H5Se03ZqSX7tbULXur2MAg: folds 
Uncalled bet ($0.75) returned to +2kMBNpY4nF1qNCRd8SJLA
+2kMBNpY4nF1qNCRd8SJLA collected $0.60 from pot
*** SUMMARY ***
Total pot $0.60 | Rake $0 
Seat 1: yyG4svzOpC1A+sUP/scg6w folded before Flop (didn't bet)
Seat 3: TeWJxSETzbXGiYKx0y+dtg folded before Flop (didn't bet)
Seat 4: EJRVVUAJEYLdm1qbO8TzuQ (button) folded before Flop (didn't bet)
Seat 5: PXXRcmL5z1Ibt+PO2FWHlA (small blind) folded before Flop
Seat 6: H5Se03ZqSX7tbULXur2MAg (big blind) folded before Flop
Seat 7: DdPXdieucQ+n99u1n3A+rQ folded before Flop (didn't bet)
Seat 8: +2kMBNpY4nF1qNCRd8SJLA collected ($0.60)
Seat 9: aNpwfA31EREwO+ar4XzBCw folded before Flop (didn't bet)




PokerStars Game #59939702116:  Hold'em No Limit ($0.10/$0.25) - 2009/07/01 0:46:42 ET
Table 'tErGGDyESv/0llKumVeZuQ' 9-max Seat #7 is the button
Seat 1: R3KkgiqTvuhazyCqaD9cZg ($11.75 in chips) 
Seat 3: CvL9Ch1HYCVbTsfpNucitg ($4.75 in chips) 
Seat 4: j1oAjkBBlFRUy+e+LF1vNQ ($7.75 in chips) 
Seat 5: le+pqvOEeS8Vvxt8ogLv/w ($10.90 in chips) 
Seat 6: zDrucyjVn5aeekNEc3cJrA ($29.50 in chips) 
Seat 7: s7Q6uNouhe7aE8JdFb9E+A ($25.30 in chips) 
Seat 8: Sv38qYH3jj8a8dddDi1aUA ($14.25 in chips) 
Seat 9: r284m4NA4rtNktI86R8/Yw ($13.55 in chips) 
Sv38qYH3jj8a8dddDi1aUA: posts small blind $0.10
r284m4NA4rtNktI86R8/Yw: posts big blind $0.25
V6p0jQ/RhUsqpHLmXvEX4Q: sits out 
*** HOLE CARDS ***
R3KkgiqTvuhazyCqaD9cZg: folds 
CvL9Ch1HYCVbTsfpNucitg: folds 
j1oAjkBBlFRUy+e+LF1vNQ: calls $0.25
le+pqvOEeS8Vvxt8ogLv/w: folds 
zDrucyjVn5aeekNEc3cJrA: calls $0.25
s7Q6uNouhe7aE8JdFb9E+A: folds 
Sv38qYH3jj8a8dddDi1aUA: folds 
r284m4NA4rtNktI86R8/Yw: checks 
*** FLOP *** [Ks 7c 5d]
r284m4NA4rtNktI86R8/Yw: checks 
j1oAjkBBlFRUy+e+LF1vNQ: bets $0.25
zDrucyjVn5aeekNEc3cJrA: folds 
r284m4NA4rtNktI86R8/Yw: folds 
Uncalled bet ($0.25) returned to j1oAjkBBlFRUy+e+LF1vNQ
j1oAjkBBlFRUy+e+LF1vNQ collected $0.85 from pot
j1oAjkBBlFRUy+e+LF1vNQ: doesn't show hand 
*** SUMMARY ***
Total pot $0.85 | Rake $0 
Board [Ks 7c 5d]
Seat 1: R3KkgiqTvuhazyCqaD9cZg folded before Flop (didn't bet)
Seat 3: CvL9Ch1HYCVbTsfpNucitg folded before Flop (didn't bet)
Seat 4: j1oAjkBBlFRUy+e+LF1vNQ collected ($0.85)
Seat 5: le+pqvOEeS8Vvxt8ogLv/w folded before Flop (didn't bet)
Seat 6: zDrucyjVn5aeekNEc3cJrA folded on the Flop
Seat 7: s7Q6uNouhe7aE8JdFb9E+A (button) folded before Flop (didn't bet)
Seat 8: Sv38qYH3jj8a8dddDi1aUA (small blind) folded before Flop
Seat 9: r284m4NA4rtNktI86R8/Yw (big blind) folded on the Flop




PokerStars Game #59939702148:  Hold'em No Limit ($0.10/$0.25) - 2009/07/01 0:46:42 ET
Table '/AhP8uWRzEEhOATYIdmn0A' 9-max Seat #4 is the button
Seat 1: +sbyWwIcFp9kP0bDtMegfQ ($23.40 in chips) 
Seat 2: nvWCCH1JBjMjQkSaXl2Mog ($17.05 in chips) 
Seat 3: vSkQm2EelzwRGDDQQk0Fqw ($4.65 in chips) 
Seat 4: +WMpj67YqG8ilNkg2JwXpw ($14.65 in chips) 
Seat 5: BEIBUu2pIflPrCL+Iks4CQ ($13.60 in chips) 
Seat 7: 4oA316mXLIui1QY63GXBUg ($29.90 in chips) 
Seat 8: CYkY0dNBaYaKs8HVCVn3mQ ($5.85 in chips) 
Seat 9: DIBbjEYGs+TVdVgEB/4+3w ($29.25 in chips) 
BEIBUu2pIflPrCL+Iks4CQ: posts small blind $0.10
4oA316mXLIui1QY63GXBUg: posts big blind $0.25
*** HOLE CARDS ***
CYkY0dNBaYaKs8HVCVn3mQ: folds 
DIBbjEYGs+TVdVgEB/4+3w: folds 
+sbyWwIcFp9kP0bDtMegfQ: folds 
nvWCCH1JBjMjQkSaXl2Mog: raises $0.50 to $0.75
vSkQm2EelzwRGDDQQk0Fqw: folds 
+WMpj67YqG8ilNkg2JwXpw: folds 
BEIBUu2pIflPrCL+Iks4CQ: folds 
4oA316mXLIui1QY63GXBUg: folds 
Uncalled bet ($0.50) returned to nvWCCH1JBjMjQkSaXl2Mog
nvWCCH1JBjMjQkSaXl2Mog collected $0.60 from pot
nvWCCH1JBjMjQkSaXl2Mog: doesn't show hand 
*** SUMMARY ***
Total pot $0.60 | Rake $0 
Seat 1: +sbyWwIcFp9kP0bDtMegfQ folded before Flop (didn't bet)
Seat 2: nvWCCH1JBjMjQkSaXl2Mog collected ($0.60)
Seat 3: vSkQm2EelzwRGDDQQk0Fqw folded before Flop (didn't bet)
Seat 4: +WMpj67YqG8ilNkg2JwXpw (button) folded before Flop (didn't bet)
Seat 5: BEIBUu2pIflPrCL+Iks4CQ (small blind) folded before Flop
Seat 7: 4oA316mXLIui1QY63GXBUg (big blind) folded before Flop
Seat 8: CYkY0dNBaYaKs8HVCVn3mQ folded before Flop (didn't bet)
Seat 9: DIBbjEYGs+TVdVgEB/4+3w folded before Flop (didn't bet)




PokerStars Game #59939702202:  Hold'em No Limit ($0.10/$0.25) - 2009/07/01 0:46:43 ET
Table 'sIHZ0lzLr4NGCaBUKhmYhAJj2eLzVCUVAGBmM+Og79iQax Seat #5 is the button
Seat 1: /XMgGtJ7mcWfe5s7McY9kw ($43.15 in chips) 
Seat 2: oMxwMC7+uAsJudeUN6aP0A ($22.30 in chips) 
Seat 3: HPEB+AtKw1+C/cxU0o1ciw ($22.95 in chips) 
Seat 4: aNpwfA31EREwO+ar4XzBCw ($46.70 in chips) 
Seat 5: UOx+/JnFB2Or6ZU9oasIlQ ($25 in chips) 
Seat 7: K0b5wNInj6hUGRr6yzKFtw ($32.05 in chips) 
Seat 8: 18G4P1XstjNvItdGUITxgw ($25 in chips) 
Seat 9: wU1LtrccnZo6PYKhlJ6ElQ ($36.35 in chips) 
K0b5wNInj6hUGRr6yzKFtw: posts small blind $0.10
18G4P1XstjNvItdGUITxgw: posts big blind $0.25
*** HOLE CARDS ***
wU1LtrccnZo6PYKhlJ6ElQ: raises $0.50 to $0.75
/XMgGtJ7mcWfe5s7McY9kw: folds 
oMxwMC7+uAsJudeUN6aP0A: folds 
HPEB+AtKw1+C/cxU0o1ciw: folds 
aNpwfA31EREwO+ar4XzBCw: folds 
UOx+/JnFB2Or6ZU9oasIlQ: folds 
K0b5wNInj6hUGRr6yzKFtw: folds 
18G4P1XstjNvItdGUITxgw: folds 
Uncalled bet ($0.50) returned to wU1LtrccnZo6PYKhlJ6ElQ
wU1LtrccnZo6PYKhlJ6ElQ collected $0.60 from pot
*** SUMMARY ***
Total pot $0.60 | Rake $0 
Seat 1: /XMgGtJ7mcWfe5s7McY9kw folded before Flop (didn't bet)
Seat 2: oMxwMC7+uAsJudeUN6aP0A folded before Flop (didn't bet)
Seat 3: HPEB+AtKw1+C/cxU0o1ciw folded before Flop (didn't bet)
Seat 4: aNpwfA31EREwO+ar4XzBCw folded before Flop (didn't bet)
Seat 5: UOx+/JnFB2Or6ZU9oasIlQ (button) folded before Flop (didn't bet)
Seat 7: K0b5wNInj6hUGRr6yzKFtw (small blind) folded before Flop
Seat 8: 18G4P1XstjNvItdGUITxgw (big blind) folded before Flop
Seat 9: wU1LtrccnZo6PYKhlJ6ElQ collected ($0.60)




PokerStars Game #59939702404:  Hold'em No Limit ($0.10/$0.25) - 2009/07/01 0:46:43 ET
Table 'ThBZ355rqvsb8UGb6ajbig' 9-max Seat #3 is the button
Seat 2: 4awUyiDYTgylQKXZ9faBVA ($28.90 in chips) 
Seat 3: LBrhQVB4w41YNd7kMYn/og ($8.60 in chips) 
Seat 4: GFNwOPqg/Zu4ZuokgGADNQ ($15.95 in chips) 
Seat 5: BX9NgIrtlXh1K47KYMsMtQ ($8.75 in chips) 
Seat 6: qwr38jl5txoR36M7G5qi4A ($7.50 in chips) 
Seat 7: t2nb95S5EEFOEzNx9Itz0g ($12.45 in chips) 
Seat 8: 6REZ3fl3I5Kaxoupd8cnLg ($28.70 in chips) 
Seat 9: 8B/dhbQjIWe6ASCdgzktNQ ($38.50 in chips) 
GFNwOPqg/Zu4ZuokgGADNQ: posts small blind $0.10
BX9NgIrtlXh1K47KYMsMtQ: posts big blind $0.25
cZ99hugmLBj9KhTlc8nCSw: sits out 
*** HOLE CARDS ***
qwr38jl5txoR36M7G5qi4A: folds 
t2nb95S5EEFOEzNx9Itz0g: folds 
6REZ3fl3I5Kaxoupd8cnLg: folds 
8B/dhbQjIWe6ASCdgzktNQ: folds 
4awUyiDYTgylQKXZ9faBVA: raises $0.75 to $1
LBrhQVB4w41YNd7kMYn/og: folds 
GFNwOPqg/Zu4ZuokgGADNQ: folds 
BX9NgIrtlXh1K47KYMsMtQ: folds 
Uncalled bet ($0.75) returned to 4awUyiDYTgylQKXZ9faBVA
4awUyiDYTgylQKXZ9faBVA collected $0.60 from pot
4awUyiDYTgylQKXZ9faBVA: doesn't show hand 
*** SUMMARY ***
Total pot $0.60 | Rake $0 
Seat 2: 4awUyiDYTgylQKXZ9faBVA collected ($0.60)
Seat 3: LBrhQVB4w41YNd7kMYn/og (button) folded before Flop (didn't bet)
Seat 4: GFNwOPqg/Zu4ZuokgGADNQ (small blind) folded before Flop
Seat 5: BX9NgIrtlXh1K47KYMsMtQ (big blind) folded before Flop
Seat 6: qwr38jl5txoR36M7G5qi4A folded before Flop (didn't bet)
Seat 7: t2nb95S5EEFOEzNx9Itz0g folded before Flop (didn't bet)
Seat 8: 6REZ3fl3I5Kaxoupd8cnLg folded before Flop (didn't bet)
Seat 9: 8B/dhbQjIWe6ASCdgzktNQ folded before Flop (didn't bet)




PokerStars Game #59939702738:  Hold'em No Limit ($0.10/$0.25) - 2009/07/01 0:46:43 ET
Table 'Ez9TB43XM4QgMDQkIW9DYw' 9-max Seat #1 is the button
Seat 1: YqWNLUj3exwMphJEDBi8Ug ($29.25 in chips) 
Seat 2: gtLY9BJ1dcPGyJ0NDNjaBg ($10.15 in chips) 
Seat 3: LorpmCSxb4uozpKwk8Awsg ($27.15 in chips) 
Seat 4: il+NK449FnwuQ8vyJ0Xn/g ($9 in chips) 
Seat 5: vZGoOTJLQLhkPj4I+LNGig ($25.70 in chips) 
Seat 6: 76o85YBHJ9veRYp2LPuluQ ($33.55 in chips) 
Seat 7: 18G4P1XstjNvItdGUITxgw ($25 in chips) 
Seat 8: +2kMBNpY4nF1qNCRd8SJLA ($25 in chips) 
Seat 9: QEbIGci+itdw+re8RM5fZA ($25 in chips) 
gtLY9BJ1dcPGyJ0NDNjaBg: posts small blind $0.10
LorpmCSxb4uozpKwk8Awsg: posts big blind $0.25
*** HOLE CARDS ***
il+NK449FnwuQ8vyJ0Xn/g: folds 
vZGoOTJLQLhkPj4I+LNGig: folds 
76o85YBHJ9veRYp2LPuluQ: raises $0.25 to $0.50
18G4P1XstjNvItdGUITxgw: folds 
+2kMBNpY4nF1qNCRd8SJLA: calls $0.50
QEbIGci+itdw+re8RM5fZA: folds 
YqWNLUj3exwMphJEDBi8Ug: calls $0.50
gtLY9BJ1dcPGyJ0NDNjaBg: folds 
LorpmCSxb4uozpKwk8Awsg: calls $0.25
*** FLOP *** [Ac 2s Qd]
LorpmCSxb4uozpKwk8Awsg: checks 
76o85YBHJ9veRYp2LPuluQ: bets $0.25
+2kMBNpY4nF1qNCRd8SJLA: raises $2.75 to $3
YqWNLUj3exwMphJEDBi8Ug: folds 
LorpmCSxb4uozpKwk8Awsg: folds 
76o85YBHJ9veRYp2LPuluQ: calls $2.75
*** TURN *** [Ac 2s Qd] [3c]
76o85YBHJ9veRYp2LPuluQ: checks 
+2kMBNpY4nF1qNCRd8SJLA: bets $5.50
76o85YBHJ9veRYp2LPuluQ: folds 
Uncalled bet ($5.50) returned to +2kMBNpY4nF1qNCRd8SJLA
+2kMBNpY4nF1qNCRd8SJLA collected $7.70 from pot
+2kMBNpY4nF1qNCRd8SJLA: doesn't show hand 
*** SUMMARY ***
Total pot $8.10 | Rake $0.40 
Board [Ac 2s Qd 3c]
Seat 1: YqWNLUj3exwMphJEDBi8Ug (button) folded on the Flop
Seat 2: gtLY9BJ1dcPGyJ0NDNjaBg (small blind) folded before Flop
Seat 3: LorpmCSxb4uozpKwk8Awsg (big blind) folded on the Flop
Seat 4: il+NK449FnwuQ8vyJ0Xn/g folded before Flop (didn't bet)
Seat 5: vZGoOTJLQLhkPj4I+LNGig folded before Flop (didn't bet)
Seat 6: 76o85YBHJ9veRYp2LPuluQ folded on the Turn
Seat 7: 18G4P1XstjNvItdGUITxgw folded before Flop (didn't bet)
Seat 8: +2kMBNpY4nF1qNCRd8SJLA collected ($7.70)
Seat 9: QEbIGci+itdw+re8RM5fZA folded before Flop (didn't bet)




PokerStars Game #59939702406:  Hold'em No Limit ($0.10/$0.25) - 2009/07/01 0:46:43 ET
Table '5SUMWYuPsGiOD0FY0QbgOw' 6-max Seat #3 is the button
Seat 1: pq78iqNUnoL9mPwPKXxOzg ($13.20 in chips) 
Seat 2: wKFJ513ucluNNiMlkXcDOQ ($25 in chips) 
Seat 3: JUE7yMMP0aN5jzhYbdqO6Q ($26.55 in chips) 
Seat 4: hln5cQA1YXs/ERC2LEyoSA ($11.20 in chips) 
Seat 5: v+QfkGiuj9bgtuNoVnDO8w ($29.65 in chips) 
Seat 6: jA7YMtfNUnAaebB7Lj74EA ($28 in chips) 
hln5cQA1YXs/ERC2LEyoSA: posts small blind $0.10
v+QfkGiuj9bgtuNoVnDO8w: posts big blind $0.25
*** HOLE CARDS ***
jA7YMtfNUnAaebB7Lj74EA: calls $0.25
pq78iqNUnoL9mPwPKXxOzg: folds 
wKFJ513ucluNNiMlkXcDOQ: folds 
JUE7yMMP0aN5jzhYbdqO6Q: raises $0.75 to $1
hln5cQA1YXs/ERC2LEyoSA: folds 
v+QfkGiuj9bgtuNoVnDO8w: folds 
jA7YMtfNUnAaebB7Lj74EA: calls $0.75
*** FLOP *** [Qs Qd Ks]
jA7YMtfNUnAaebB7Lj74EA: bets $1.50
JUE7yMMP0aN5jzhYbdqO6Q: calls $1.50
*** TURN *** [Qs Qd Ks] [9h]
jA7YMtfNUnAaebB7Lj74EA: bets $1.50
wKFJ513ucluNNiMlkXcDOQ leaves the table
JUE7yMMP0aN5jzhYbdqO6Q: folds 
Uncalled bet ($1.50) returned to jA7YMtfNUnAaebB7Lj74EA
jA7YMtfNUnAaebB7Lj74EA collected $5.10 from pot
jA7YMtfNUnAaebB7Lj74EA: doesn't show hand 
*** SUMMARY ***
Total pot $5.35 | Rake $0.25 
Board [Qs Qd Ks 9h]
Seat 1: pq78iqNUnoL9mPwPKXxOzg folded before Flop (didn't bet)
Seat 2: wKFJ513ucluNNiMlkXcDOQ folded before Flop (didn't bet)
Seat 3: JUE7yMMP0aN5jzhYbdqO6Q (button) folded on the Turn
Seat 4: hln5cQA1YXs/ERC2LEyoSA (small blind) folded before Flop
Seat 5: v+QfkGiuj9bgtuNoVnDO8w (big blind) folded before Flop
Seat 6: jA7YMtfNUnAaebB7Lj74EA collected ($5.10)




PokerStars Game #59939702314:  Hold'em No Limit ($0.10/$0.25) - 2009/07/01 0:46:43 ET
Table 'mNBkqbHtjDvzF6YU0ixV9Q' 9-max Seat #6 is the button
Seat 1: QsLvCwfSWqP+CfjwUnjpXQ ($16.35 in chips) 
Seat 4: NZlEzoTKHCxRJwJ71iDzeA ($5.75 in chips) 
Seat 6: Zb8xGmbjS8ghABxs9n6huA ($12 in chips) 
QsLvCwfSWqP+CfjwUnjpXQ: posts small blind $0.10
NZlEzoTKHCxRJwJ71iDzeA: posts big blind $0.25
*** HOLE CARDS ***
Zb8xGmbjS8ghABxs9n6huA: folds 
QsLvCwfSWqP+CfjwUnjpXQ: folds 
Uncalled bet ($0.15) returned to NZlEzoTKHCxRJwJ71iDzeA
NZlEzoTKHCxRJwJ71iDzeA collected $0.20 from pot
NZlEzoTKHCxRJwJ71iDzeA: doesn't show hand 
*** SUMMARY ***
Total pot $0.20 | Rake $0 
Seat 1: QsLvCwfSWqP+CfjwUnjpXQ (small blind) folded before Flop
Seat 4: NZlEzoTKHCxRJwJ71iDzeA (big blind) collected ($0.20)
Seat 6: Zb8xGmbjS8ghABxs9n6huA (button) folded before Flop (didn't bet)




PokerStars Game #59939703478:  Hold'em No Limit ($0.10/$0.25) - 2009/07/01 0:46:44 ET
Table '9lYs7ljXi6AgFAxYHlKLJw' 9-max Seat #2 is the button
Seat 1: K0b5wNInj6hUGRr6yzKFtw ($25 in chips) 
Seat 2: N6fYvIzQLKaydFLKQGtMlQ ($21.75 in chips) 
Seat 3: DnDcAdn9P0zGovMERigpFA ($25 in chips) 
Seat 4: UANt6y/SmDCY/jIxkBixcw ($30.35 in chips) 
Seat 5: dfNim92Z6XK1/h5SFW5vDg ($55.20 in chips) 
Seat 7: ghNKXUBl/H+t83JF079ZBA ($28.75 in chips) 
Seat 8: 8GJHzzxiotOqC5gdtgpLoA ($5.90 in chips) 
Seat 9: 18G4P1XstjNvItdGUITxgw ($36.15 in chips) 
DnDcAdn9P0zGovMERigpFA: posts small blind $0.10
UANt6y/SmDCY/jIxkBixcw: posts big blind $0.25
tYsOBqdU1+x+yFI7zHO7hQ: sits out 
*** HOLE CARDS ***
dfNim92Z6XK1/h5SFW5vDg: folds 
ghNKXUBl/H+t83JF079ZBA: folds 
8GJHzzxiotOqC5gdtgpLoA: folds 
18G4P1XstjNvItdGUITxgw: folds 
K0b5wNInj6hUGRr6yzKFtw: folds 
N6fYvIzQLKaydFLKQGtMlQ: folds 
DnDcAdn9P0zGovMERigpFA: folds 
Uncalled bet ($0.15) returned to UANt6y/SmDCY/jIxkBixcw
UANt6y/SmDCY/jIxkBixcw collected $0.20 from pot
UANt6y/SmDCY/jIxkBixcw: shows [3h Qh] (high card Queen)
*** SUMMARY ***
Total pot $0.20 | Rake $0 
Seat 1: K0b5wNInj6hUGRr6yzKFtw folded before Flop (didn't bet)
Seat 2: N6fYvIzQLKaydFLKQGtMlQ (button) folded before Flop (didn't bet)
Seat 3: DnDcAdn9P0zGovMERigpFA (small blind) folded before Flop
Seat 4: UANt6y/SmDCY/jIxkBixcw (big blind) collected ($0.20)
Seat 5: dfNim92Z6XK1/h5SFW5vDg folded before Flop (didn't bet)
Seat 7: ghNKXUBl/H+t83JF079ZBA folded before Flop (didn't bet)
Seat 8: 8GJHzzxiotOqC5gdtgpLoA folded before Flop (didn't bet)
Seat 9: 18G4P1XstjNvItdGUITxgw folded before Flop (didn't bet)




PokerStars Game #59939703466:  Hold'em No Limit ($0.10/$0.25) - 2009/07/01 0:46:44 ET
Table '972HGIb0tQN/zRIK4TABEw' 9-max Seat #9 is the button
Seat 1: fHr2+mGa0RFK3qrpZcVUAQ ($10.15 in chips) 
Seat 2: lc6GpYOW7MM4G+/65wMxXA ($14.50 in chips) 
Seat 3: W4TLQcZ2TiM73eIgpIvlGg ($23.90 in chips) 
Seat 4: BnWWUASA3YjU/ovKqaKNpA ($12.15 in chips) 
Seat 5: aY0AWwRTlmJDSHpDxE90Hg ($9.50 in chips) 
Seat 7: qS+jfnNoG75bT+uQ8CKhQA ($11.75 in chips) 
Seat 8: DIBbjEYGs+TVdVgEB/4+3w ($46.65 in chips) 
Seat 9: qUzFLsH4zPL5Zy77O+Qlbw ($2.35 in chips) 
fHr2+mGa0RFK3qrpZcVUAQ: posts small blind $0.10
lc6GpYOW7MM4G+/65wMxXA: posts big blind $0.25
rintinton: sits out 
*** HOLE CARDS ***
W4TLQcZ2TiM73eIgpIvlGg: folds 
BnWWUASA3YjU/ovKqaKNpA: calls $0.25
aY0AWwRTlmJDSHpDxE90Hg: calls $0.25
qS+jfnNoG75bT+uQ8CKhQA: folds 
DIBbjEYGs+TVdVgEB/4+3w: calls $0.25
qUzFLsH4zPL5Zy77O+Qlbw: calls $0.25
fHr2+mGa0RFK3qrpZcVUAQ: folds 
lc6GpYOW7MM4G+/65wMxXA: raises $0.25 to $0.50
BnWWUASA3YjU/ovKqaKNpA: calls $0.25
aY0AWwRTlmJDSHpDxE90Hg: calls $0.25
DIBbjEYGs+TVdVgEB/4+3w: calls $0.25
qUzFLsH4zPL5Zy77O+Qlbw: calls $0.25
*** FLOP *** [6h 9s 9d]
lc6GpYOW7MM4G+/65wMxXA: bets $1
BnWWUASA3YjU/ovKqaKNpA: calls $1
aY0AWwRTlmJDSHpDxE90Hg: folds 
DIBbjEYGs+TVdVgEB/4+3w: folds 
qUzFLsH4zPL5Zy77O+Qlbw: folds 
*** TURN *** [6h 9s 9d] [Jc]
lc6GpYOW7MM4G+/65wMxXA: bets $1
BnWWUASA3YjU/ovKqaKNpA: calls $1
*** RIVER *** [6h 9s 9d Jc] [8h]
lc6GpYOW7MM4G+/65wMxXA: bets $1.25
BnWWUASA3YjU/ovKqaKNpA: raises $1.25 to $2.50
lc6GpYOW7MM4G+/65wMxXA: calls $1.25
*** SHOW DOWN ***
BnWWUASA3YjU/ovKqaKNpA: shows [7h 9h] (three of a kind, Nines)
lc6GpYOW7MM4G+/65wMxXA: mucks hand 
BnWWUASA3YjU/ovKqaKNpA collected $11.05 from pot
*** SUMMARY ***
Total pot $11.60 | Rake $0.55 
Board [6h 9s 9d Jc 8h]
Seat 1: fHr2+mGa0RFK3qrpZcVUAQ (small blind) folded before Flop
Seat 2: lc6GpYOW7MM4G+/65wMxXA (big blind) mucked
Seat 3: W4TLQcZ2TiM73eIgpIvlGg folded before Flop (didn't bet)
Seat 4: BnWWUASA3YjU/ovKqaKNpA showed [7h 9h] and won ($11.05) with three of a kind, Nines
Seat 5: aY0AWwRTlmJDSHpDxE90Hg folded on the Flop
Seat 7: qS+jfnNoG75bT+uQ8CKhQA folded before Flop (didn't bet)
Seat 8: DIBbjEYGs+TVdVgEB/4+3w folded on the Flop
Seat 9: qUzFLsH4zPL5Zy77O+Qlbw (button) folded on the Flop




PokerStars Game #59939703360:  Hold'em No Limit ($0.10/$0.25) - 2009/07/01 0:46:44 ET
Table 'CBnRhp0d6E2+/NtM7Vbruw' 9-max Seat #3 is the button
Seat 1: WQe4GbiYBiPsb5WKFKkijQ ($11.40 in chips) 
Seat 2: DIBbjEYGs+TVdVgEB/4+3w ($35.55 in chips) 
Seat 3: aNpwfA31EREwO+ar4XzBCw ($27 in chips) 
Seat 4: FR1anYnrxOdUfdNDELZ4SQ ($18.85 in chips) 
Seat 5: R6nIVAjK7uhK3Hj0f85A+A ($26.90 in chips) 
Seat 6: PqvgxdSg9z5VmrWpbYuz+g ($22.95 in chips) 
Seat 8: MG90wfSJZnOejs/KD3vlQQ ($30.85 in chips) 
Seat 9: BHKu5wmAIC0UlfmA78se7A ($3.75 in chips) 
FR1anYnrxOdUfdNDELZ4SQ: posts small blind $0.10
R6nIVAjK7uhK3Hj0f85A+A: posts big blind $0.25
MrPo4/ymXwg9lzPRybrXbA: sits out 
*** HOLE CARDS ***
PqvgxdSg9z5VmrWpbYuz+g: calls $0.25
MG90wfSJZnOejs/KD3vlQQ: folds 
BHKu5wmAIC0UlfmA78se7A: folds 
WQe4GbiYBiPsb5WKFKkijQ: raises $0.25 to $0.50
DIBbjEYGs+TVdVgEB/4+3w: folds 
aNpwfA31EREwO+ar4XzBCw: raises $2 to $2.50
FR1anYnrxOdUfdNDELZ4SQ: folds 
R6nIVAjK7uhK3Hj0f85A+A: folds 
PqvgxdSg9z5VmrWpbYuz+g: folds 
WQe4GbiYBiPsb5WKFKkijQ: calls $2
*** FLOP *** [3d Ks 9s]
WQe4GbiYBiPsb5WKFKkijQ: bets $2
aNpwfA31EREwO+ar4XzBCw: raises $3.50 to $5.50
WQe4GbiYBiPsb5WKFKkijQ: raises $3.40 to $8.90 and is all-in
aNpwfA31EREwO+ar4XzBCw: calls $3.40
*** TURN *** [3d Ks 9s] [Qc]
*** RIVER *** [3d Ks 9s Qc] [6h]
*** SHOW DOWN ***
WQe4GbiYBiPsb5WKFKkijQ: shows [Ah Qh] (a pair of Queens)
aNpwfA31EREwO+ar4XzBCw: shows [Ad Kc] (a pair of Kings)
aNpwfA31EREwO+ar4XzBCw collected $22.25 from pot
*** SUMMARY ***
Total pot $23.40 | Rake $1.15 
Board [3d Ks 9s Qc 6h]
Seat 1: WQe4GbiYBiPsb5WKFKkijQ showed [Ah Qh] and lost with a pair of Queens
Seat 2: DIBbjEYGs+TVdVgEB/4+3w folded before Flop (didn't bet)
Seat 3: aNpwfA31EREwO+ar4XzBCw (button) showed [Ad Kc] and won ($22.25) with a pair of Kings
Seat 4: FR1anYnrxOdUfdNDELZ4SQ (small blind) folded before Flop
Seat 5: R6nIVAjK7uhK3Hj0f85A+A (big blind) folded before Flop
Seat 6: PqvgxdSg9z5VmrWpbYuz+g folded before Flop
Seat 8: MG90wfSJZnOejs/KD3vlQQ folded before Flop (didn't bet)
Seat 9: BHKu5wmAIC0UlfmA78se7A folded before Flop (didn't bet)




PokerStars Game #59939703880:  Hold'em No Limit ($0.10/$0.25) - 2009/07/01 0:46:45 ET
Table 'axb9RsG8Zj1A0LEukTeFrQ' 9-max Seat #8 is the button
Seat 1: qwr38jl5txoR36M7G5qi4A ($9.90 in chips) 
Seat 2: zDrucyjVn5aeekNEc3cJrA ($21.60 in chips) 
Seat 3: cZ99hugmLBj9KhTlc8nCSw ($27.65 in chips) 
Seat 4: TeWJxSETzbXGiYKx0y+dtg ($24.65 in chips) 
Seat 5: rLSSHKOHnb6yzVfDoQM/RA ($12.05 in chips) 
Seat 6: FSuhElWc38JXYToR0dwhjg ($15.60 in chips) 
Seat 8: CqwJk5Z2+vb2f9j1o7IjKQ ($27.40 in chips) 
Seat 9: qbQE8CifKB4+OEvNF/61Rw ($38.55 in chips) 
qbQE8CifKB4+OEvNF/61Rw: posts small blind $0.10
qwr38jl5txoR36M7G5qi4A: posts big blind $0.25
*** HOLE CARDS ***
CqwJk5Z2+vb2f9j1o7IjKQ said, "uahhuahuahu"
zDrucyjVn5aeekNEc3cJrA: folds 
CqwJk5Z2+vb2f9j1o7IjKQ said, "nice bad player donky"
qbQE8CifKB4+OEvNF/61Rw said, "hahahaha  yea  it was a BAD bet"
cZ99hugmLBj9KhTlc8nCSw: folds 
TeWJxSETzbXGiYKx0y+dtg: folds 
rLSSHKOHnb6yzVfDoQM/RA: folds 
FSuhElWc38JXYToR0dwhjg: folds 
CqwJk5Z2+vb2f9j1o7IjKQ: folds 
qbQE8CifKB4+OEvNF/61Rw: folds 
Uncalled bet ($0.15) returned to qwr38jl5txoR36M7G5qi4A
qwr38jl5txoR36M7G5qi4A collected $0.20 from pot
qwr38jl5txoR36M7G5qi4A: doesn't show hand 
*** SUMMARY ***
Total pot $0.20 | Rake $0 
Seat 1: qwr38jl5txoR36M7G5qi4A (big blind) collected ($0.20)
Seat 2: zDrucyjVn5aeekNEc3cJrA folded before Flop (didn't bet)
Seat 3: cZ99hugmLBj9KhTlc8nCSw folded before Flop (didn't bet)
Seat 4: TeWJxSETzbXGiYKx0y+dtg folded before Flop (didn't bet)
Seat 5: rLSSHKOHnb6yzVfDoQM/RA folded before Flop (didn't bet)
Seat 6: FSuhElWc38JXYToR0dwhjg folded before Flop (didn't bet)
Seat 8: CqwJk5Z2+vb2f9j1o7IjKQ (button) folded before Flop (didn't bet)
Seat 9: qbQE8CifKB4+OEvNF/61Rw (small blind) folded before Flop




PokerStars Game #59939703508:  Hold'em No Limit ($0.10/$0.25) - 2009/07/01 0:46:45 ET
Table 'isKy4XK8wJM0x735/D4hWA' 6-max Seat #2 is the button
Seat 1: 7FmwVDcdEtxDpHmP4hOXsQ ($25 in chips) 
Seat 2: WrLI51S2iMb8GLMB83gGqA ($25.50 in chips) 
Seat 3: jp34e617tIzV8tKIWmfAbA ($25 in chips) 
Seat 4: k9vn40MOqqb+xF+7GZ6v2g ($28.05 in chips) 
Seat 6: M6xK/VklCvdyyrmvzATlxQ ($17.25 in chips) 
jp34e617tIzV8tKIWmfAbA: posts small blind $0.10
k9vn40MOqqb+xF+7GZ6v2g: posts big blind $0.25
lquriepNQBhDV5P1SWHhnA: sits out 
*** HOLE CARDS ***
M6xK/VklCvdyyrmvzATlxQ: raises $0.50 to $0.75
7FmwVDcdEtxDpHmP4hOXsQ: folds 
WrLI51S2iMb8GLMB83gGqA: folds 
jp34e617tIzV8tKIWmfAbA: folds 
k9vn40MOqqb+xF+7GZ6v2g: folds 
Uncalled bet ($0.50) returned to M6xK/VklCvdyyrmvzATlxQ
M6xK/VklCvdyyrmvzATlxQ collected $0.60 from pot
*** SUMMARY ***
Total pot $0.60 | Rake $0 
Seat 1: 7FmwVDcdEtxDpHmP4hOXsQ folded before Flop (didn't bet)
Seat 2: WrLI51S2iMb8GLMB83gGqA (button) folded before Flop (didn't bet)
Seat 3: jp34e617tIzV8tKIWmfAbA (small blind) folded before Flop
Seat 4: k9vn40MOqqb+xF+7GZ6v2g (big blind) folded before Flop
Seat 6: M6xK/VklCvdyyrmvzATlxQ collected ($0.60)




PokerStars Game #59939703866:  Hold'em No Limit ($0.10/$0.25) - 2009/07/01 0:46:45 ET
Table 'NgexmgEDEzICBeSO7YCrKQ' 6-max Seat #2 is the button
Seat 1: oseFhpinoe+Zg4j5xyBjyQ ($70.75 in chips) 
Seat 2: 32YL2ZEp8NT4JB2RVM9euQ ($15.65 in chips) 
Seat 3: JFIAqU8lCZ0vWwEl4bdGsg ($26.30 in chips) 
Seat 4: xx+iYCDJhHJmNzrfeloyEg ($38.60 in chips) 
Seat 5: /MXkdT8TTs8Qp2LVTQNw6w ($46.90 in chips) 
Seat 6: k9nHZTHt8hYhYRcW8NTb4g ($9.90 in chips) 
JFIAqU8lCZ0vWwEl4bdGsg: posts small blind $0.10
xx+iYCDJhHJmNzrfeloyEg: posts big blind $0.25
*** HOLE CARDS ***
/MXkdT8TTs8Qp2LVTQNw6w: folds 
k9nHZTHt8hYhYRcW8NTb4g: calls $0.25
oseFhpinoe+Zg4j5xyBjyQ: calls $0.25
32YL2ZEp8NT4JB2RVM9euQ: folds 
JFIAqU8lCZ0vWwEl4bdGsg: raises $1.50 to $1.75
xx+iYCDJhHJmNzrfeloyEg said, "  When I have KK, WITHOUT FAIL, an ace flops."
xx+iYCDJhHJmNzrfeloyEg: folds 
k9nHZTHt8hYhYRcW8NTb4g: folds 
oseFhpinoe+Zg4j5xyBjyQ: folds 
Uncalled bet ($1.50) returned to JFIAqU8lCZ0vWwEl4bdGsg
JFIAqU8lCZ0vWwEl4bdGsg collected $1 from pot
JFIAqU8lCZ0vWwEl4bdGsg: doesn't show hand 
/MXkdT8TTs8Qp2LVTQNw6w said, "its great thast isnt it ;)"
*** SUMMARY ***
Total pot $1 | Rake $0 
Seat 1: oseFhpinoe+Zg4j5xyBjyQ folded before Flop
Seat 2: 32YL2ZEp8NT4JB2RVM9euQ (button) folded before Flop (didn't bet)
Seat 3: JFIAqU8lCZ0vWwEl4bdGsg (small blind) collected ($1)
Seat 4: xx+iYCDJhHJmNzrfeloyEg (big blind) folded before Flop
Seat 5: /MXkdT8TTs8Qp2LVTQNw6w folded before Flop (didn't bet)
Seat 6: k9nHZTHt8hYhYRcW8NTb4g folded before Flop




PokerStars Game #59939703764:  Hold'em No Limit ($0.10/$0.25) - 2009/07/01 0:46:45 ET
Table 'HzFR0rxmDAPu5GzYR0AlYg' 6-max Seat #5 is the button
Seat 1: v+QfkGiuj9bgtuNoVnDO8w ($25 in chips) 
Seat 2: UA5OsKS3VPaxa7uC8La/kA ($50.15 in chips) 
Seat 3: lfAPI6VglUPipZe8BpDaTA ($24.35 in chips) 
Seat 4: uy9x0X5l7O+IpGjLa77QgQ ($64.75 in chips) 
Seat 5: lquriepNQBhDV5P1SWHhnA ($25 in chips) 
Seat 6: jp34e617tIzV8tKIWmfAbA ($26.35 in chips) 
jp34e617tIzV8tKIWmfAbA: posts small blind $0.10
v+QfkGiuj9bgtuNoVnDO8w: posts big blind $0.25
*** HOLE CARDS ***
UA5OsKS3VPaxa7uC8La/kA: folds 
lfAPI6VglUPipZe8BpDaTA: folds 
uy9x0X5l7O+IpGjLa77QgQ: folds 
lquriepNQBhDV5P1SWHhnA: raises $0.50 to $0.75
jp34e617tIzV8tKIWmfAbA: folds 
v+QfkGiuj9bgtuNoVnDO8w: folds 
Uncalled bet ($0.50) returned to lquriepNQBhDV5P1SWHhnA
lquriepNQBhDV5P1SWHhnA collected $0.60 from pot
lquriepNQBhDV5P1SWHhnA: doesn't show hand 
*** SUMMARY ***
Total pot $0.60 | Rake $0 
Seat 1: v+QfkGiuj9bgtuNoVnDO8w (big blind) folded before Flop
Seat 2: UA5OsKS3VPaxa7uC8La/kA folded before Flop (didn't bet)
Seat 3: lfAPI6VglUPipZe8BpDaTA folded before Flop (didn't bet)
Seat 4: uy9x0X5l7O+IpGjLa77QgQ folded before Flop (didn't bet)
Seat 5: lquriepNQBhDV5P1SWHhnA (button) collected ($0.60)
Seat 6: jp34e617tIzV8tKIWmfAbA (small blind) folded before Flop




PokerStars Game #59939704652:  Hold'em No Limit ($0.10/$0.25) - 2009/07/01 0:46:46 ET
Table 'wPWRBZPJl1HAnysw7qRR0A' 6-max Seat #2 is the button
Seat 1: cPO/1/dTcZpLkQFm3jH3Rg ($49.25 in chips) 
Seat 2: 48oT5xFI+5CHUJlfoGrE4w ($7.95 in chips) 
Seat 3: gqW2aBCmrIw65BvwjTFN6Q ($26.90 in chips) 
Seat 4: kbpWbC+dJNBphHl1jtw7bw ($28.65 in chips) 
Seat 5: LtASJ9OlkqGrrUKGQlpGAw ($20.95 in chips) 
Seat 6: VLoE/jniCqHZuUkx8Esf6w ($24.80 in chips) 
gqW2aBCmrIw65BvwjTFN6Q: posts small blind $0.10
kbpWbC+dJNBphHl1jtw7bw: posts big blind $0.25
*** HOLE CARDS ***
LtASJ9OlkqGrrUKGQlpGAw: folds 
VLoE/jniCqHZuUkx8Esf6w: calls $0.25
cPO/1/dTcZpLkQFm3jH3Rg: raises $1.25 to $1.50
48oT5xFI+5CHUJlfoGrE4w: folds 
gqW2aBCmrIw65BvwjTFN6Q: folds 
kbpWbC+dJNBphHl1jtw7bw: folds 
VLoE/jniCqHZuUkx8Esf6w: calls $1.25
*** FLOP *** [5s 3h 6d]
VLoE/jniCqHZuUkx8Esf6w: bets $2.25
cPO/1/dTcZpLkQFm3jH3Rg: calls $2.25
*** TURN *** [5s 3h 6d] [9d]
VLoE/jniCqHZuUkx8Esf6w: bets $2.75
cPO/1/dTcZpLkQFm3jH3Rg: calls $2.75
*** RIVER *** [5s 3h 6d 9d] [9s]
VLoE/jniCqHZuUkx8Esf6w: bets $6
cPO/1/dTcZpLkQFm3jH3Rg: calls $6
*** SHOW DOWN ***
VLoE/jniCqHZuUkx8Esf6w: shows [Ac 9c] (three of a kind, Nines)
cPO/1/dTcZpLkQFm3jH3Rg: mucks hand 
VLoE/jniCqHZuUkx8Esf6w collected $24.15 from pot
*** SUMMARY ***
Total pot $25.35 | Rake $1.20 
Board [5s 3h 6d 9d 9s]
Seat 1: cPO/1/dTcZpLkQFm3jH3Rg mucked
Seat 2: 48oT5xFI+5CHUJlfoGrE4w (button) folded before Flop (didn't bet)
Seat 3: gqW2aBCmrIw65BvwjTFN6Q (small blind) folded before Flop
Seat 4: kbpWbC+dJNBphHl1jtw7bw (big blind) folded before Flop
Seat 5: LtASJ9OlkqGrrUKGQlpGAw folded before Flop (didn't bet)
Seat 6: VLoE/jniCqHZuUkx8Esf6w showed [Ac 9c] and won ($24.15) with three of a kind, Nines




PokerStars Game #59939704408:  Hold'em No Limit ($0.10/$0.25) - 2009/07/01 0:46:46 ET
Table 'sgB7AwZtVgDTf4fi8RwWFQ' 9-max Seat #9 is the button
Seat 1: QEbIGci+itdw+re8RM5fZA ($28.80 in chips) 
Seat 5: gGaFLzGESKP3Tj9N/K7QNA ($5.75 in chips) 
Seat 6: YEdelvffSYRP4EDNfFp4dA ($14.75 in chips) 
Seat 8: Nq5F1B22aaLLZ+D9HbzcGg ($24.90 in chips) 
Seat 9: MG90wfSJZnOejs/KD3vlQQ ($32.70 in chips) 
QEbIGci+itdw+re8RM5fZA: posts small blind $0.10
DnDcAdn9P0zGovMERigpFA: is sitting out 
DnDcAdn9P0zGovMERigpFA leaves the table
gGaFLzGESKP3Tj9N/K7QNA: posts big blind $0.25
*** HOLE CARDS ***
YEdelvffSYRP4EDNfFp4dA: raises $0.25 to $0.50
Nq5F1B22aaLLZ+D9HbzcGg: calls $0.50
MG90wfSJZnOejs/KD3vlQQ: folds 
QEbIGci+itdw+re8RM5fZA: folds 
gGaFLzGESKP3Tj9N/K7QNA: folds 
*** FLOP *** [Js Jc 2c]
YEdelvffSYRP4EDNfFp4dA: bets $0.25
Nq5F1B22aaLLZ+D9HbzcGg: calls $0.25
*** TURN *** [Js Jc 2c] [9c]
YEdelvffSYRP4EDNfFp4dA: bets $1
Nq5F1B22aaLLZ+D9HbzcGg: folds 
Uncalled bet ($1) returned to YEdelvffSYRP4EDNfFp4dA
YEdelvffSYRP4EDNfFp4dA collected $1.80 from pot
YEdelvffSYRP4EDNfFp4dA: doesn't show hand 
*** SUMMARY ***
Total pot $1.85 | Rake $0.05 
Board [Js Jc 2c 9c]
Seat 1: QEbIGci+itdw+re8RM5fZA (small blind) folded before Flop
Seat 5: gGaFLzGESKP3Tj9N/K7QNA (big blind) folded before Flop
Seat 6: YEdelvffSYRP4EDNfFp4dA collected ($1.80)
Seat 8: Nq5F1B22aaLLZ+D9HbzcGg folded on the Turn
Seat 9: MG90wfSJZnOejs/KD3vlQQ (button) folded before Flop (didn't bet)




PokerStars Game #59939704602:  Hold'em No Limit ($0.10/$0.25) - 2009/07/01 0:46:46 ET
Table 'ONP9SkU1SytzTLuNlKzIPw' 9-max Seat #1 is the button
Seat 1: s7Q6uNouhe7aE8JdFb9E+A ($33.60 in chips) 
Seat 2: sJNHTWcSlLHRCZ9+YRLLqA ($25.25 in chips) 
Seat 3: 4BZw8NrbfRfUJKKKd1c2vA ($9.40 in chips) 
Seat 5: lSeLm4BdnSMLtIli62qjAQ ($3.90 in chips) 
Seat 6: 6X6eofOkuCCdkJdReOpjUQ ($26.05 in chips) 
Seat 7: DiSvPC2iudwL5j9u6Huyww ($25.85 in chips) 
Seat 8: sUVgUtgbfVx6JpvApozwhQ ($12.80 in chips) 
Seat 9: yyG4svzOpC1A+sUP/scg6w ($7.15 in chips) 
sJNHTWcSlLHRCZ9+YRLLqA: posts small blind $0.10
4BZw8NrbfRfUJKKKd1c2vA: posts big blind $0.25
*** HOLE CARDS ***
rKgOH+UzKBirOiqIwBD9Nw has returned
lSeLm4BdnSMLtIli62qjAQ: folds 
rKgOH+UzKBirOiqIwBD9Nw leaves the table
6X6eofOkuCCdkJdReOpjUQ: calls $0.25
DiSvPC2iudwL5j9u6Huyww: folds 
sUVgUtgbfVx6JpvApozwhQ: folds 
yyG4svzOpC1A+sUP/scg6w: folds 
s7Q6uNouhe7aE8JdFb9E+A: folds 
sJNHTWcSlLHRCZ9+YRLLqA: folds 
qwr38jl5txoR36M7G5qi4A joins the table at seat #4 
4BZw8NrbfRfUJKKKd1c2vA: checks 
*** FLOP *** [3h 7s 5c]
4BZw8NrbfRfUJKKKd1c2vA: checks 
6X6eofOkuCCdkJdReOpjUQ: checks 
*** TURN *** [3h 7s 5c] [4d]
4BZw8NrbfRfUJKKKd1c2vA: checks 
6X6eofOkuCCdkJdReOpjUQ: bets $0.50
4BZw8NrbfRfUJKKKd1c2vA: calls $0.50
*** RIVER *** [3h 7s 5c 4d] [Tc]
4BZw8NrbfRfUJKKKd1c2vA: checks 
6X6eofOkuCCdkJdReOpjUQ: bets $1
4BZw8NrbfRfUJKKKd1c2vA: folds 
Uncalled bet ($1) returned to 6X6eofOkuCCdkJdReOpjUQ
6X6eofOkuCCdkJdReOpjUQ collected $1.55 from pot
6X6eofOkuCCdkJdReOpjUQ: doesn't show hand 
*** SUMMARY ***
Total pot $1.60 | Rake $0.05 
Board [3h 7s 5c 4d Tc]
Seat 1: s7Q6uNouhe7aE8JdFb9E+A (button) folded before Flop (didn't bet)
Seat 2: sJNHTWcSlLHRCZ9+YRLLqA (small blind) folded before Flop
Seat 3: 4BZw8NrbfRfUJKKKd1c2vA (big blind) folded on the River
Seat 5: lSeLm4BdnSMLtIli62qjAQ folded before Flop (didn't bet)
Seat 6: 6X6eofOkuCCdkJdReOpjUQ collected ($1.55)
Seat 7: DiSvPC2iudwL5j9u6Huyww folded before Flop (didn't bet)
Seat 8: sUVgUtgbfVx6JpvApozwhQ folded before Flop (didn't bet)
Seat 9: yyG4svzOpC1A+sUP/scg6w folded before Flop (didn't bet)




PokerStars Game #59939704480:  Hold'em No Limit ($0.10/$0.25) - 2009/07/01 0:46:46 ET
Table 'XX2OuOsa8/8AC+/mR/Az6g' 9-max Seat #7 is the button
Seat 1: 56S3mA6Zs3pGR+0p0vUCtg ($26.65 in chips) 
Seat 2: MIVCHqCqqlke0Lb0z7glcw ($23.80 in chips) 
Seat 3: 4f9D0JPPUArSbyY3vqNlXQ ($7.90 in chips) 
Seat 5: jXz58rvCgq0VjyVjUBf2mw ($25 in chips) 
Seat 6: gT0nY7XiR+2FA+B3F4h8HQ ($25.35 in chips) 
Seat 7: zDrucyjVn5aeekNEc3cJrA ($20.45 in chips) 
Seat 8: qwr38jl5txoR36M7G5qi4A ($7.50 in chips) 
Seat 9: 86vbuhJsyH+nbEg5qpDLyQ ($45.95 in chips) 
qwr38jl5txoR36M7G5qi4A: posts small blind $0.10
86vbuhJsyH+nbEg5qpDLyQ: posts big blind $0.25
*** HOLE CARDS ***
56S3mA6Zs3pGR+0p0vUCtg: raises $1 to $1.25
MIVCHqCqqlke0Lb0z7glcw: folds 
4f9D0JPPUArSbyY3vqNlXQ: folds 
jXz58rvCgq0VjyVjUBf2mw: calls $1.25
gT0nY7XiR+2FA+B3F4h8HQ: folds 
zDrucyjVn5aeekNEc3cJrA: folds 
qwr38jl5txoR36M7G5qi4A: folds 
86vbuhJsyH+nbEg5qpDLyQ: folds 
*** FLOP *** [3h Qd 3d]
56S3mA6Zs3pGR+0p0vUCtg: bets $1.50
jXz58rvCgq0VjyVjUBf2mw: folds 
Uncalled bet ($1.50) returned to 56S3mA6Zs3pGR+0p0vUCtg
56S3mA6Zs3pGR+0p0vUCtg collected $2.75 from pot
56S3mA6Zs3pGR+0p0vUCtg: doesn't show hand 
*** SUMMARY ***
Total pot $2.85 | Rake $0.10 
Board [3h Qd 3d]
Seat 1: 56S3mA6Zs3pGR+0p0vUCtg collected ($2.75)
Seat 2: MIVCHqCqqlke0Lb0z7glcw folded before Flop (didn't bet)
Seat 3: 4f9D0JPPUArSbyY3vqNlXQ folded before Flop (didn't bet)
Seat 5: jXz58rvCgq0VjyVjUBf2mw folded on the Flop
Seat 6: gT0nY7XiR+2FA+B3F4h8HQ folded before Flop (didn't bet)
Seat 7: zDrucyjVn5aeekNEc3cJrA (button) folded before Flop (didn't bet)
Seat 8: qwr38jl5txoR36M7G5qi4A (small blind) folded before Flop
Seat 9: 86vbuhJsyH+nbEg5qpDLyQ (big blind) folded before Flop




PokerStars Game #59939704568:  Hold'em No Limit ($0.10/$0.25) - 2009/07/01 0:46:46 ET
Table 'Utmw+yX+E/wdhNDIim90lQ' 9-max Seat #9 is the button
Seat 1: lwlnPm68QGGI/+pnAd4GAw ($58.85 in chips) 
Seat 2: iGMlK+EhUflPB6jKQd95Cg ($32.30 in chips) 
Seat 3: dfNim92Z6XK1/h5SFW5vDg ($25 in chips) 
Seat 4: ifYGvZDHQQ0aam4awTtHwA ($3.60 in chips) 
Seat 5: H9KUl8cmpLgEpOVDA00bCg ($5 in chips) 
Seat 6: OlPJsgR4xypSg/w1z7Gyvw ($19.65 in chips) 
Seat 7: CImUHesK+ZER4v/VCA9IUg ($64.20 in chips) 
Seat 8: DdPXdieucQ+n99u1n3A+rQ ($6.05 in chips) 
Seat 9: Th3FldXKQW6hWVVPahaoOQ ($27.15 in chips) 
lwlnPm68QGGI/+pnAd4GAw: posts small blind $0.10
iGMlK+EhUflPB6jKQd95Cg: posts big blind $0.25
*** HOLE CARDS ***
dfNim92Z6XK1/h5SFW5vDg: raises $0.75 to $1
ifYGvZDHQQ0aam4awTtHwA: calls $1
H9KUl8cmpLgEpOVDA00bCg: folds 
OlPJsgR4xypSg/w1z7Gyvw: folds 
CImUHesK+ZER4v/VCA9IUg is disconnected 
CImUHesK+ZER4v/VCA9IUg is connected 
CImUHesK+ZER4v/VCA9IUg: folds 
DdPXdieucQ+n99u1n3A+rQ: folds 
Th3FldXKQW6hWVVPahaoOQ: folds 
lwlnPm68QGGI/+pnAd4GAw: folds 
iGMlK+EhUflPB6jKQd95Cg: folds 
*** FLOP *** [5h 2c Js]
dfNim92Z6XK1/h5SFW5vDg: checks 
ifYGvZDHQQ0aam4awTtHwA: bets $0.25
dfNim92Z6XK1/h5SFW5vDg: folds 
Uncalled bet ($0.25) returned to ifYGvZDHQQ0aam4awTtHwA
ifYGvZDHQQ0aam4awTtHwA collected $2.25 from pot
*** SUMMARY ***
Total pot $2.35 | Rake $0.10 
Board [5h 2c Js]
Seat 1: lwlnPm68QGGI/+pnAd4GAw (small blind) folded before Flop
Seat 2: iGMlK+EhUflPB6jKQd95Cg (big blind) folded before Flop
Seat 3: dfNim92Z6XK1/h5SFW5vDg folded on the Flop
Seat 4: ifYGvZDHQQ0aam4awTtHwA collected ($2.25)
Seat 5: H9KUl8cmpLgEpOVDA00bCg folded before Flop (didn't bet)
Seat 6: OlPJsgR4xypSg/w1z7Gyvw folded before Flop (didn't bet)
Seat 7: CImUHesK+ZER4v/VCA9IUg folded before Flop (didn't bet)
Seat 8: DdPXdieucQ+n99u1n3A+rQ folded before Flop (didn't bet)
Seat 9: Th3FldXKQW6hWVVPahaoOQ (button) folded before Flop (didn't bet)




PokerStars Game #59939705100:  Hold'em No Limit ($0.10/$0.25) - 2009/07/01 0:46:47 ET
Table 'IfRHUn9gQQA9I/Z4tn+BoA' 9-max Seat #2 is the button
Seat 1: vSkQm2EelzwRGDDQQk0Fqw ($4.30 in chips) 
Seat 2: V6p0jQ/RhUsqpHLmXvEX4Q ($14.10 in chips) 
Seat 3: iAQDnrJCZVD1LzAGxTYegw ($25 in chips) 
Seat 4: QEbIGci+itdw+re8RM5fZA ($25 in chips) 
Seat 5: 10584482 ($16.75 in chips) 
Seat 6: UOjoGGQ58/uDS7V0xkjOrQ ($7 in chips) 
Seat 7: TeWJxSETzbXGiYKx0y+dtg ($36.30 in chips) 
Seat 8: cZ99hugmLBj9KhTlc8nCSw ($25 in chips) 
Seat 9: 7cv+9Zc9HIQHNvYsMfV3uA ($25 in chips) 
iAQDnrJCZVD1LzAGxTYegw: posts small blind $0.10
QEbIGci+itdw+re8RM5fZA: posts big blind $0.25
*** HOLE CARDS ***
10584482: folds 
UOjoGGQ58/uDS7V0xkjOrQ: calls $0.25
TeWJxSETzbXGiYKx0y+dtg: folds 
cZ99hugmLBj9KhTlc8nCSw: folds 
7cv+9Zc9HIQHNvYsMfV3uA: folds 
vSkQm2EelzwRGDDQQk0Fqw: raises $1 to $1.25
V6p0jQ/RhUsqpHLmXvEX4Q: folds 
iAQDnrJCZVD1LzAGxTYegw: folds 
QEbIGci+itdw+re8RM5fZA: raises $2.75 to $4
UOjoGGQ58/uDS7V0xkjOrQ: folds 
vSkQm2EelzwRGDDQQk0Fqw: raises $0.30 to $4.30 and is all-in
QEbIGci+itdw+re8RM5fZA: calls $0.30
*** FLOP *** [Tc 2h 6s]
*** TURN *** [Tc 2h 6s] [Qs]
*** RIVER *** [Tc 2h 6s Qs] [5s]
*** SHOW DOWN ***
QEbIGci+itdw+re8RM5fZA: shows [Kd Kh] (a pair of Kings)
vSkQm2EelzwRGDDQQk0Fqw: mucks hand 
QEbIGci+itdw+re8RM5fZA collected $8.55 from pot
*** SUMMARY ***
Total pot $8.95 | Rake $0.40 
Board [Tc 2h 6s Qs 5s]
Seat 1: vSkQm2EelzwRGDDQQk0Fqw mucked
Seat 2: V6p0jQ/RhUsqpHLmXvEX4Q (button) folded before Flop (didn't bet)
Seat 3: iAQDnrJCZVD1LzAGxTYegw (small blind) folded before Flop
Seat 4: QEbIGci+itdw+re8RM5fZA (big blind) showed [Kd Kh] and won ($8.55) with a pair of Kings
Seat 5: 10584482 folded before Flop (didn't bet)
Seat 6: UOjoGGQ58/uDS7V0xkjOrQ folded before Flop
Seat 7: TeWJxSETzbXGiYKx0y+dtg folded before Flop (didn't bet)
Seat 8: cZ99hugmLBj9KhTlc8nCSw folded before Flop (didn't bet)
Seat 9: 7cv+9Zc9HIQHNvYsMfV3uA folded before Flop (didn't bet)




PokerStars Game #59939704996:  Hold'em No Limit ($0.10/$0.25) - 2009/07/01 0:46:47 ET
Table 'aisAlB9GIV21BwfUW3+Nbg' 9-max Seat #4 is the button
Seat 1: H5Se03ZqSX7tbULXur2MAg ($30.30 in chips) 
Seat 2: 18G4P1XstjNvItdGUITxgw ($25 in chips) 
Seat 3: aaNpjkDAbOD7pVe8Z5CEgQ ($22.65 in chips) 
Seat 4: sD+TKtt36XiiN6jqHiLwDA ($24.50 in chips) 
Seat 5: ghNKXUBl/H+t83JF079ZBA ($25 in chips) 
Seat 6: 9gmYYQesalMrUjaF7nKfrQ ($7.60 in chips) 
Seat 7: sWBBy1WroEskLNyJzhkUag ($9.25 in chips) 
Seat 8: VWUWpMLMj/Q1jRVpF7Aohw ($14.30 in chips) 
Seat 9: OlPJsgR4xypSg/w1z7Gyvw ($28.30 in chips) 
ghNKXUBl/H+t83JF079ZBA: posts small blind $0.10
9gmYYQesalMrUjaF7nKfrQ: posts big blind $0.25
*** HOLE CARDS ***
sWBBy1WroEskLNyJzhkUag: folds 
VWUWpMLMj/Q1jRVpF7Aohw: folds 
OlPJsgR4xypSg/w1z7Gyvw: folds 
H5Se03ZqSX7tbULXur2MAg: folds 
18G4P1XstjNvItdGUITxgw: raises $0.50 to $0.75
aaNpjkDAbOD7pVe8Z5CEgQ: folds 
sD+TKtt36XiiN6jqHiLwDA: folds 
ghNKXUBl/H+t83JF079ZBA: folds 
9gmYYQesalMrUjaF7nKfrQ: folds 
Uncalled bet ($0.50) returned to 18G4P1XstjNvItdGUITxgw
18G4P1XstjNvItdGUITxgw collected $0.60 from pot
18G4P1XstjNvItdGUITxgw: doesn't show hand 
*** SUMMARY ***
Total pot $0.60 | Rake $0 
Seat 1: H5Se03ZqSX7tbULXur2MAg folded before Flop (didn't bet)
Seat 2: 18G4P1XstjNvItdGUITxgw collected ($0.60)
Seat 3: aaNpjkDAbOD7pVe8Z5CEgQ folded before Flop (didn't bet)
Seat 4: sD+TKtt36XiiN6jqHiLwDA (button) folded before Flop (didn't bet)
Seat 5: ghNKXUBl/H+t83JF079ZBA (small blind) folded before Flop
Seat 6: 9gmYYQesalMrUjaF7nKfrQ (big blind) folded before Flop
Seat 7: sWBBy1WroEskLNyJzhkUag folded before Flop (didn't bet)
Seat 8: VWUWpMLMj/Q1jRVpF7Aohw folded before Flop (didn't bet)
Seat 9: OlPJsgR4xypSg/w1z7Gyvw folded before Flop (didn't bet)




PokerStars Game #59939704974:  Hold'em No Limit ($0.10/$0.25) - 2009/07/01 0:46:47 ET
Table 'P2yJ+jwfNsBdF12fLKA6DQ' 9-max Seat #4 is the button
Seat 1: zDrucyjVn5aeekNEc3cJrA ($26.15 in chips) 
Seat 2: V6p0jQ/RhUsqpHLmXvEX4Q ($12.35 in chips) 
Seat 3: aNpwfA31EREwO+ar4XzBCw ($26.85 in chips) 
Seat 4: dfNim92Z6XK1/h5SFW5vDg ($25 in chips) 
Seat 5: KUcJLaHvrSlvGyIGqDQp9A ($15.45 in chips) 
Seat 7: 1/DuWziR8CXhWB71aPQd9Q ($9.65 in chips) 
Seat 8: LWN1wPrLH+695JIriXxDuw ($14.95 in chips) 
Seat 9: dN5zq7QdZCUe7NZFM6cECg ($26.30 in chips) 
KUcJLaHvrSlvGyIGqDQp9A: posts small blind $0.10
1/DuWziR8CXhWB71aPQd9Q: posts big blind $0.25
*** HOLE CARDS ***
LWN1wPrLH+695JIriXxDuw: folds 
dN5zq7QdZCUe7NZFM6cECg: raises $0.50 to $0.75
zDrucyjVn5aeekNEc3cJrA: folds 
V6p0jQ/RhUsqpHLmXvEX4Q: folds 
aNpwfA31EREwO+ar4XzBCw: calls $0.75
dfNim92Z6XK1/h5SFW5vDg: folds 
KUcJLaHvrSlvGyIGqDQp9A: folds 
1/DuWziR8CXhWB71aPQd9Q: folds 
*** FLOP *** [Ad 6d Kh]
dN5zq7QdZCUe7NZFM6cECg: bets $1.75
aNpwfA31EREwO+ar4XzBCw: folds 
Uncalled bet ($1.75) returned to dN5zq7QdZCUe7NZFM6cECg
dN5zq7QdZCUe7NZFM6cECg collected $1.80 from pot
dN5zq7QdZCUe7NZFM6cECg: doesn't show hand 
*** SUMMARY ***
Total pot $1.85 | Rake $0.05 
Board [Ad 6d Kh]
Seat 1: zDrucyjVn5aeekNEc3cJrA folded before Flop (didn't bet)
Seat 2: V6p0jQ/RhUsqpHLmXvEX4Q folded before Flop (didn't bet)
Seat 3: aNpwfA31EREwO+ar4XzBCw folded on the Flop
Seat 4: dfNim92Z6XK1/h5SFW5vDg (button) folded before Flop (didn't bet)
Seat 5: KUcJLaHvrSlvGyIGqDQp9A (small blind) folded before Flop
Seat 7: 1/DuWziR8CXhWB71aPQd9Q (big blind) folded before Flop
Seat 8: LWN1wPrLH+695JIriXxDuw folded before Flop (didn't bet)
Seat 9: dN5zq7QdZCUe7NZFM6cECg collected ($1.80)




PokerStars Game #59939705248:  Hold'em No Limit ($0.10/$0.25) - 2009/07/01 0:46:47 ET
Table '8qKBgCRnebT9/IvA6SmaPw' 9-max Seat #8 is the button
Seat 1: GTcLfsDTPqgfHyhY9FNDMw ($11.20 in chips) 
Seat 2: SXqVW4Q0evTUVZG6BbUNIA ($77.40 in chips) 
Seat 4: rXm4QDVJt67H20lM6n6Z7Q ($8 in chips) 
Seat 5: uJlzv9KL7hgCIqIS2ofoaw ($12.90 in chips) 
Seat 6: z5GxcHlYz/GSz6W2uFiTtg ($25.15 in chips) 
Seat 7: UbybWqarUDNRYlbnju2UUQ ($27.05 in chips) 
Seat 8: M2aiKD/Q1d8lySUIbBxeGg ($27.05 in chips) 
Seat 9: MOlR9YEgKTKLerVIDf8U7w ($47 in chips) 
MOlR9YEgKTKLerVIDf8U7w: posts small blind $0.10
GTcLfsDTPqgfHyhY9FNDMw: posts big blind $0.25
V6p0jQ/RhUsqpHLmXvEX4Q: sits out 
*** HOLE CARDS ***
SXqVW4Q0evTUVZG6BbUNIA: raises $0.50 to $0.75
rXm4QDVJt67H20lM6n6Z7Q: folds 
uJlzv9KL7hgCIqIS2ofoaw: folds 
z5GxcHlYz/GSz6W2uFiTtg: folds 
UbybWqarUDNRYlbnju2UUQ: folds 
M2aiKD/Q1d8lySUIbBxeGg: folds 
MOlR9YEgKTKLerVIDf8U7w: folds 
GTcLfsDTPqgfHyhY9FNDMw: folds 
Uncalled bet ($0.50) returned to SXqVW4Q0evTUVZG6BbUNIA
SXqVW4Q0evTUVZG6BbUNIA collected $0.60 from pot
SXqVW4Q0evTUVZG6BbUNIA: doesn't show hand 
*** SUMMARY ***
Total pot $0.60 | Rake $0 
Seat 1: GTcLfsDTPqgfHyhY9FNDMw (big blind) folded before Flop
Seat 2: SXqVW4Q0evTUVZG6BbUNIA collected ($0.60)
Seat 4: rXm4QDVJt67H20lM6n6Z7Q folded before Flop (didn't bet)
Seat 5: uJlzv9KL7hgCIqIS2ofoaw folded before Flop (didn't bet)
Seat 6: z5GxcHlYz/GSz6W2uFiTtg folded before Flop (didn't bet)
Seat 7: UbybWqarUDNRYlbnju2UUQ folded before Flop (didn't bet)
Seat 8: M2aiKD/Q1d8lySUIbBxeGg (button) folded before Flop (didn't bet)
Seat 9: MOlR9YEgKTKLerVIDf8U7w (small blind) folded before Flop




PokerStars Game #59939705324:  Hold'em No Limit ($0.10/$0.25) - 2009/07/01 0:46:47 ET
Table 'R5f24ws6hGXlbvjq9ej+1Q' 9-max Seat #5 is the button
Seat 5: YMlMWbkusacDBjx3A8lphw ($5.80 in chips) 
33y9+GmQ3J84RvZXcraRTw: is sitting out 
TeWJxSETzbXGiYKx0y+dtg: is sitting out 
YMlMWbkusacDBjx3A8lphw: posts small blind $0.10
Z5ZtGOON8kmSdSCll9Z3XA: is sitting out 
qwr38jl5txoR36M7G5qi4A: is sitting out 
Hand cancelled
*** SUMMARY ***
Seat 5: YMlMWbkusacDBjx3A8lphw (button) collected ($0)




PokerStars Game #59939705018:  Hold'em No Limit ($0.10/$0.25) - 2009/07/01 0:46:47 ET
Table 'dZNBGqFYSwfOVZvDJ4VjIQ' 6-max Seat #6 is the button
Seat 1: o08wk0F4gROLhZS04Iyl3w ($27.20 in chips) 
Seat 2: 3zD3qLXT1bEffAoWGnc7wg ($25 in chips) 
Seat 3: Mch463E1dxQfVob352za6w ($25.95 in chips) 
Seat 4: df01R5ThvHspD8FgKmaDvQ ($26.95 in chips) 
Seat 6: VbudEd0ZG+qPwMO9h+hjXw ($18.20 in chips) 
o08wk0F4gROLhZS04Iyl3w: posts small blind $0.10
3zD3qLXT1bEffAoWGnc7wg: posts big blind $0.25
pitty1199: sits out 
*** HOLE CARDS ***
Mch463E1dxQfVob352za6w: raises $0.50 to $0.75
df01R5ThvHspD8FgKmaDvQ: folds 
VbudEd0ZG+qPwMO9h+hjXw: raises $2 to $2.75
o08wk0F4gROLhZS04Iyl3w: folds 
3zD3qLXT1bEffAoWGnc7wg: folds 
Mch463E1dxQfVob352za6w: raises $23.20 to $25.95 and is all-in
VbudEd0ZG+qPwMO9h+hjXw: folds 
Uncalled bet ($23.20) returned to Mch463E1dxQfVob352za6w
Mch463E1dxQfVob352za6w collected $5.85 from pot
Mch463E1dxQfVob352za6w: doesn't show hand 
*** SUMMARY ***
Total pot $5.85 | Rake $0 
Seat 1: o08wk0F4gROLhZS04Iyl3w (small blind) folded before Flop
Seat 2: 3zD3qLXT1bEffAoWGnc7wg (big blind) folded before Flop
Seat 3: Mch463E1dxQfVob352za6w collected ($5.85)
Seat 4: df01R5ThvHspD8FgKmaDvQ folded before Flop (didn't bet)
Seat 6: VbudEd0ZG+qPwMO9h+hjXw (button) folded before Flop




PokerStars Game #59939704970:  Hold'em No Limit ($0.10/$0.25) - 2009/07/01 0:46:47 ET
Table 'vud0GB/ZlDCvUFhBFIaTlg' 9-max Seat #5 is the button
Seat 4: ss810etqPS9ni/HJIweF/g ($7.10 in chips) 
Seat 5: AwAabNdwDsTMb3aTomdOmg ($8.45 in chips) 
Seat 6: NDJWZaU2QihSadZB98k0tg ($24.75 in chips) 
Seat 8: Am29qRe4OYkVWs70NjNDBw ($6 in chips) 
Seat 9: ROo8kPnsdL612mO7wzI5Bg ($7.75 in chips) 
NDJWZaU2QihSadZB98k0tg: posts small blind $0.10
Am29qRe4OYkVWs70NjNDBw: posts big blind $0.25
DHobes12: sits out 
*** HOLE CARDS ***
ROo8kPnsdL612mO7wzI5Bg: folds 
ss810etqPS9ni/HJIweF/g: folds 
AwAabNdwDsTMb3aTomdOmg: calls $0.25
NDJWZaU2QihSadZB98k0tg: calls $0.15
Am29qRe4OYkVWs70NjNDBw: checks 
*** FLOP *** [Ad 8d Jd]
NDJWZaU2QihSadZB98k0tg: checks 
Am29qRe4OYkVWs70NjNDBw: checks 
AwAabNdwDsTMb3aTomdOmg: checks 
*** TURN *** [Ad 8d Jd] [2h]
NDJWZaU2QihSadZB98k0tg: bets $0.80
Am29qRe4OYkVWs70NjNDBw: folds 
DiSvPC2iudwL5j9u6Huyww joins the table at seat #1 
AwAabNdwDsTMb3aTomdOmg: folds 
Uncalled bet ($0.80) returned to NDJWZaU2QihSadZB98k0tg
NDJWZaU2QihSadZB98k0tg collected $0.75 from pot
*** SUMMARY ***
Total pot $0.75 | Rake $0 
Board [Ad 8d Jd 2h]
Seat 4: ss810etqPS9ni/HJIweF/g folded before Flop (didn't bet)
Seat 5: AwAabNdwDsTMb3aTomdOmg (button) folded on the Turn
Seat 6: NDJWZaU2QihSadZB98k0tg (small blind) collected ($0.75)
Seat 8: Am29qRe4OYkVWs70NjNDBw (big blind) folded on the Turn
Seat 9: ROo8kPnsdL612mO7wzI5Bg folded before Flop (didn't bet)




PokerStars Game #59939705272:  Hold'em No Limit ($0.10/$0.25) - 2009/07/01 0:46:47 ET
Table '2clPgY3+dETPD/8zjXZdFw' 6-max Seat #4 is the button
Seat 1: qllppsCmUqovlriIWCeM/g ($6.40 in chips) 
Seat 2: NzIFHwilc5zU7QhjDTgTZA ($4.55 in chips) 
Seat 3: 6pF9LtHn+EH0ChbOXzox9g ($6.05 in chips) 
Seat 4: 9KPR3sZ+CxRm7bQ8qxFzMQ ($6.90 in chips) 
Seat 5: sEQx9G5Cu8k1HNdQasxvUA ($60.90 in chips) 
Seat 6: Mch463E1dxQfVob352za6w ($25.95 in chips) 
sEQx9G5Cu8k1HNdQasxvUA: posts small blind $0.10
Mch463E1dxQfVob352za6w: posts big blind $0.25
*** HOLE CARDS ***
qllppsCmUqovlriIWCeM/g: folds 
NzIFHwilc5zU7QhjDTgTZA: raises $0.75 to $1
6pF9LtHn+EH0ChbOXzox9g: calls $1
9KPR3sZ+CxRm7bQ8qxFzMQ: folds 
sEQx9G5Cu8k1HNdQasxvUA: folds 
Mch463E1dxQfVob352za6w: folds 
*** FLOP *** [8d 2s 2h]
NzIFHwilc5zU7QhjDTgTZA: bets $1
6pF9LtHn+EH0ChbOXzox9g: raises $3.25 to $4.25
NzIFHwilc5zU7QhjDTgTZA: calls $2.55 and is all-in
Uncalled bet ($0.70) returned to 6pF9LtHn+EH0ChbOXzox9g
*** TURN *** [8d 2s 2h] [Kh]
*** RIVER *** [8d 2s 2h Kh] [6d]
*** SHOW DOWN ***
NzIFHwilc5zU7QhjDTgTZA: shows [Ah Ad] (two pair, Aces and Deuces)
6pF9LtHn+EH0ChbOXzox9g: mucks hand 
NzIFHwilc5zU7QhjDTgTZA collected $9 from pot
*** SUMMARY ***
Total pot $9.45 | Rake $0.45 
Board [8d 2s 2h Kh 6d]
Seat 1: qllppsCmUqovlriIWCeM/g folded before Flop (didn't bet)
Seat 2: NzIFHwilc5zU7QhjDTgTZA showed [Ah Ad] and won ($9) with two pair, Aces and Deuces
Seat 3: 6pF9LtHn+EH0ChbOXzox9g mucked
Seat 4: 9KPR3sZ+CxRm7bQ8qxFzMQ (button) folded before Flop (didn't bet)
Seat 5: sEQx9G5Cu8k1HNdQasxvUA (small blind) folded before Flop
Seat 6: Mch463E1dxQfVob352za6w (big blind) folded before Flop




PokerStars Game #59939704784:  Hold'em No Limit ($0.10/$0.25) - 2009/07/01 0:46:47 ET
Table 'zojWVNukhD2n8RTfHCOwwg' 9-max Seat #7 is the button
Seat 1: DIBbjEYGs+TVdVgEB/4+3w ($41.10 in chips) 
Seat 3: 1esmRaxnod+zAkE+7BtzMA ($15.60 in chips) 
Seat 6: 2xNcp4M2UG8Li2PMEnWcgA ($11.10 in chips) 
Seat 7: H5Se03ZqSX7tbULXur2MAg ($27.80 in chips) 
Seat 8: j4q3p0lesp63b1gZDwLBZw ($5 in chips) 
Seat 9: 4oA316mXLIui1QY63GXBUg ($25.25 in chips) 
j4q3p0lesp63b1gZDwLBZw: posts small blind $0.10
4oA316mXLIui1QY63GXBUg: posts big blind $0.25
V6p0jQ/RhUsqpHLmXvEX4Q: sits out 
*** HOLE CARDS ***
DIBbjEYGs+TVdVgEB/4+3w: folds 
1esmRaxnod+zAkE+7BtzMA: folds 
1esmRaxnod+zAkE+7BtzMA leaves the table
2xNcp4M2UG8Li2PMEnWcgA: folds 
H5Se03ZqSX7tbULXur2MAg: calls $0.25
j4q3p0lesp63b1gZDwLBZw: folds 
4oA316mXLIui1QY63GXBUg: checks 
*** FLOP *** [Ad Kd 9d]
4oA316mXLIui1QY63GXBUg: checks 
H5Se03ZqSX7tbULXur2MAg: bets $0.25
4oA316mXLIui1QY63GXBUg: folds 
Uncalled bet ($0.25) returned to H5Se03ZqSX7tbULXur2MAg
Vegaas has returned
H5Se03ZqSX7tbULXur2MAg collected $0.60 from pot
*** SUMMARY ***
Total pot $0.60 | Rake $0 
Board [Ad Kd 9d]
Seat 1: DIBbjEYGs+TVdVgEB/4+3w folded before Flop (didn't bet)
Seat 3: 1esmRaxnod+zAkE+7BtzMA folded before Flop (didn't bet)
Seat 6: 2xNcp4M2UG8Li2PMEnWcgA folded before Flop (didn't bet)
Seat 7: H5Se03ZqSX7tbULXur2MAg (button) collected ($0.60)
Seat 8: j4q3p0lesp63b1gZDwLBZw (small blind) folded before Flop
Seat 9: 4oA316mXLIui1QY63GXBUg (big blind) folded on the Flop




PokerStars Game #59939705792:  Hold'em No Limit ($0.10/$0.25) - 2009/07/01 0:46:48 ET
Table 'rO1I30HnuCPB0M8qEX1TCQ' 9-max Seat #9 is the button
Seat 4: spidnpwmoJ1L6yeNW7D5UA ($42.20 in chips) 
Seat 5: HVKi9hnDyvzObpL08/OarQ ($24.40 in chips) 
Seat 6: vO3QVRovWemcGMkm7ijAIA ($3.75 in chips) 
Seat 7: 4oA316mXLIui1QY63GXBUg ($30.25 in chips) 
Seat 8: DIBbjEYGs+TVdVgEB/4+3w ($36.50 in chips) 
Seat 9: PrviAnKmKklf+We6cR33cw ($29.65 in chips) 
gehe91e0IyVT0QU/XBkEyg will be allowed to play after the button
r6hk+kJqlyUpcApRLTHqnQ will be allowed to play after the button
spidnpwmoJ1L6yeNW7D5UA: posts small blind $0.10
HVKi9hnDyvzObpL08/OarQ: posts big blind $0.25
*** HOLE CARDS ***
vO3QVRovWemcGMkm7ijAIA: folds 
4oA316mXLIui1QY63GXBUg: folds 
DIBbjEYGs+TVdVgEB/4+3w: folds 
PrviAnKmKklf+We6cR33cw: calls $0.25
spidnpwmoJ1L6yeNW7D5UA: calls $0.15
HVKi9hnDyvzObpL08/OarQ: checks 
*** FLOP *** [Ah Jd Kd]
spidnpwmoJ1L6yeNW7D5UA: checks 
HVKi9hnDyvzObpL08/OarQ: checks 
PrviAnKmKklf+We6cR33cw: bets $0.25
spidnpwmoJ1L6yeNW7D5UA: folds 
HVKi9hnDyvzObpL08/OarQ: calls $0.25
*** TURN *** [Ah Jd Kd] [8h]
HVKi9hnDyvzObpL08/OarQ: checks 
33y9+GmQ3J84RvZXcraRTw leaves the table
PrviAnKmKklf+We6cR33cw: bets $1
HVKi9hnDyvzObpL08/OarQ: folds 
Uncalled bet ($1) returned to PrviAnKmKklf+We6cR33cw
PrviAnKmKklf+We6cR33cw collected $1.20 from pot
PrviAnKmKklf+We6cR33cw: doesn't show hand 
*** SUMMARY ***
Total pot $1.25 | Rake $0.05 
Board [Ah Jd Kd 8h]
Seat 4: spidnpwmoJ1L6yeNW7D5UA (small blind) folded on the Flop
Seat 5: HVKi9hnDyvzObpL08/OarQ (big blind) folded on the Turn
Seat 6: vO3QVRovWemcGMkm7ijAIA folded before Flop (didn't bet)
Seat 7: 4oA316mXLIui1QY63GXBUg folded before Flop (didn't bet)
Seat 8: DIBbjEYGs+TVdVgEB/4+3w folded before Flop (didn't bet)
Seat 9: PrviAnKmKklf+We6cR33cw (button) collected ($1.20)




PokerStars Game #59939705406:  Hold'em No Limit ($0.10/$0.25) - 2009/07/01 0:46:48 ET
Table 'wRXcD9iXgBbdvKhWmfnBnw' 6-max Seat #3 is the button
Seat 1: LGWRgaQNaDFSlUGk26f0Ig ($22.70 in chips) 
Seat 2: SS/yfeArhULzIcOPe8MdPg ($25 in chips) 
Seat 3: 6zbQpY/G44U1Xvj7DZex0A ($48.30 in chips) 
Seat 4: mfrkWA3PTeYPkbO6hi98Aw ($25 in chips) 
Seat 5: EE16Ua5b1HSsYej5zeXOlA ($25 in chips) 
mfrkWA3PTeYPkbO6hi98Aw: posts small blind $0.10
EE16Ua5b1HSsYej5zeXOlA: posts big blind $0.25
*** HOLE CARDS ***
LGWRgaQNaDFSlUGk26f0Ig: calls $0.25
SS/yfeArhULzIcOPe8MdPg: folds 
6zbQpY/G44U1Xvj7DZex0A: calls $0.25
mfrkWA3PTeYPkbO6hi98Aw: folds 
EE16Ua5b1HSsYej5zeXOlA: raises $1.25 to $1.50
LGWRgaQNaDFSlUGk26f0Ig: calls $1.25
6zbQpY/G44U1Xvj7DZex0A: folds 
*** FLOP *** [Js Ad 8d]
EE16Ua5b1HSsYej5zeXOlA: checks 
kancha_01 joins the table at seat #6 
LGWRgaQNaDFSlUGk26f0Ig: checks 
*** TURN *** [Js Ad 8d] [4s]
EE16Ua5b1HSsYej5zeXOlA: bets $2.55
LGWRgaQNaDFSlUGk26f0Ig: calls $2.55
*** RIVER *** [Js Ad 8d 4s] [5c]
EE16Ua5b1HSsYej5zeXOlA: bets $4.35
LGWRgaQNaDFSlUGk26f0Ig: folds 
Uncalled bet ($4.35) returned to EE16Ua5b1HSsYej5zeXOlA
EE16Ua5b1HSsYej5zeXOlA collected $8.05 from pot
EE16Ua5b1HSsYej5zeXOlA: doesn't show hand 
*** SUMMARY ***
Total pot $8.45 | Rake $0.40 
Board [Js Ad 8d 4s 5c]
Seat 1: LGWRgaQNaDFSlUGk26f0Ig folded on the River
Seat 2: SS/yfeArhULzIcOPe8MdPg folded before Flop (didn't bet)
Seat 3: 6zbQpY/G44U1Xvj7DZex0A (button) folded before Flop
Seat 4: mfrkWA3PTeYPkbO6hi98Aw (small blind) folded before Flop
Seat 5: EE16Ua5b1HSsYej5zeXOlA (big blind) collected ($8.05)




PokerStars Game #59939705930:  Hold'em No Limit ($0.10/$0.25) - 2009/07/01 0:46:48 ET
Table 'by7aHYEDnDd144EXOXa/jA' 9-max Seat #2 is the button
Seat 2: vSkQm2EelzwRGDDQQk0Fqw ($5.15 in chips) 
Seat 3: 1Clf3cPrqoy/YgvWdWK1Xw ($5.30 in chips) 
Seat 4: vZGoOTJLQLhkPj4I+LNGig ($47.40 in chips) 
Seat 5: yyG4svzOpC1A+sUP/scg6w ($7.15 in chips) 
Seat 6: DIBbjEYGs+TVdVgEB/4+3w ($30.85 in chips) 
Seat 8: s7Q6uNouhe7aE8JdFb9E+A ($25.25 in chips) 
Seat 9: K0b5wNInj6hUGRr6yzKFtw ($25.35 in chips) 
1Clf3cPrqoy/YgvWdWK1Xw: posts small blind $0.10
vZGoOTJLQLhkPj4I+LNGig: posts big blind $0.25
V6p0jQ/RhUsqpHLmXvEX4Q: sits out 
*** HOLE CARDS ***
yyG4svzOpC1A+sUP/scg6w: folds 
j4q3p0lesp63b1gZDwLBZw joins the table at seat #1 
DIBbjEYGs+TVdVgEB/4+3w: folds 
s7Q6uNouhe7aE8JdFb9E+A: raises $0.50 to $0.75
K0b5wNInj6hUGRr6yzKFtw: folds 
vSkQm2EelzwRGDDQQk0Fqw: folds 
1Clf3cPrqoy/YgvWdWK1Xw: folds 
vZGoOTJLQLhkPj4I+LNGig: folds 
Uncalled bet ($0.50) returned to s7Q6uNouhe7aE8JdFb9E+A
s7Q6uNouhe7aE8JdFb9E+A collected $0.60 from pot
s7Q6uNouhe7aE8JdFb9E+A: doesn't show hand 
*** SUMMARY ***
Total pot $0.60 | Rake $0 
Seat 2: vSkQm2EelzwRGDDQQk0Fqw (button) folded before Flop (didn't bet)
Seat 3: 1Clf3cPrqoy/YgvWdWK1Xw (small blind) folded before Flop
Seat 4: vZGoOTJLQLhkPj4I+LNGig (big blind) folded before Flop
Seat 5: yyG4svzOpC1A+sUP/scg6w folded before Flop (didn't bet)
Seat 6: DIBbjEYGs+TVdVgEB/4+3w folded before Flop (didn't bet)
Seat 8: s7Q6uNouhe7aE8JdFb9E+A collected ($0.60)
Seat 9: K0b5wNInj6hUGRr6yzKFtw folded before Flop (didn't bet)




PokerStars Game #59939705790:  Hold'em No Limit ($0.10/$0.25) - 2009/07/01 0:46:48 ET
Table 'C8mMnVmvkagwolEzTvh07A' 9-max Seat #5 is the button
Seat 1: t2nb95S5EEFOEzNx9Itz0g ($8.40 in chips) 
Seat 2: CbXUS6Z2rXZxL1AKduNtmQ ($30.10 in chips) 
Seat 3: Th3FldXKQW6hWVVPahaoOQ ($25 in chips) 
Seat 4: dfNim92Z6XK1/h5SFW5vDg ($25 in chips) 
Seat 5: iGMlK+EhUflPB6jKQd95Cg ($25.40 in chips) 
Seat 7: qmEgnPhQt24xdw/ZRVPLbA ($32.65 in chips) 
Seat 8: N6fYvIzQLKaydFLKQGtMlQ ($22.55 in chips) 
Seat 9: 4awUyiDYTgylQKXZ9faBVA ($25 in chips) 
qmEgnPhQt24xdw/ZRVPLbA: posts small blind $0.10
N6fYvIzQLKaydFLKQGtMlQ: posts big blind $0.25
*** HOLE CARDS ***
4awUyiDYTgylQKXZ9faBVA: raises $0.75 to $1
t2nb95S5EEFOEzNx9Itz0g: folds 
CbXUS6Z2rXZxL1AKduNtmQ: folds 
Th3FldXKQW6hWVVPahaoOQ: folds 
dfNim92Z6XK1/h5SFW5vDg: folds 
iGMlK+EhUflPB6jKQd95Cg: folds 
qmEgnPhQt24xdw/ZRVPLbA: calls $0.90
N6fYvIzQLKaydFLKQGtMlQ: folds 
*** FLOP *** [9s Th 7s]
qmEgnPhQt24xdw/ZRVPLbA: bets $1.25
4awUyiDYTgylQKXZ9faBVA: calls $1.25
*** TURN *** [9s Th 7s] [5c]
qmEgnPhQt24xdw/ZRVPLbA: bets $3.25
4awUyiDYTgylQKXZ9faBVA: folds 
Uncalled bet ($3.25) returned to qmEgnPhQt24xdw/ZRVPLbA
qmEgnPhQt24xdw/ZRVPLbA collected $4.55 from pot
qmEgnPhQt24xdw/ZRVPLbA: doesn't show hand 
*** SUMMARY ***
Total pot $4.75 | Rake $0.20 
Board [9s Th 7s 5c]
Seat 1: t2nb95S5EEFOEzNx9Itz0g folded before Flop (didn't bet)
Seat 2: CbXUS6Z2rXZxL1AKduNtmQ folded before Flop (didn't bet)
Seat 3: Th3FldXKQW6hWVVPahaoOQ folded before Flop (didn't bet)
Seat 4: dfNim92Z6XK1/h5SFW5vDg folded before Flop (didn't bet)
Seat 5: iGMlK+EhUflPB6jKQd95Cg (button) folded before Flop (didn't bet)
Seat 7: qmEgnPhQt24xdw/ZRVPLbA (small blind) collected ($4.55)
Seat 8: N6fYvIzQLKaydFLKQGtMlQ (big blind) folded before Flop
Seat 9: 4awUyiDYTgylQKXZ9faBVA folded on the Turn




PokerStars Game #59939705614:  Hold'em No Limit ($0.10/$0.25) - 2009/07/01 0:46:48 ET
Table 'sSe6q4YTb/iS19t2eCFdsA' 9-max Seat #5 is the button
Seat 1: 5z3YkZTfH2GjoLK+6X7z2w ($11.55 in chips) 
Seat 2: rUpvA02nErFvZ4yFbDR8XA ($25.60 in chips) 
Seat 3: hBMUlEpyU74r/fwDgIpXjQ ($25.70 in chips) 
Seat 5: qS+jfnNoG75bT+uQ8CKhQA ($14.50 in chips) 
Seat 6: tYsOBqdU1+x+yFI7zHO7hQ ($25.80 in chips) 
Seat 7: t70KGeRtR3naHSqKDixsUg ($13.05 in chips) 
Seat 8: jeKWRUkMaVn8rEUjnJKqpg ($27.40 in chips) 
Seat 9: 4oA316mXLIui1QY63GXBUg ($25.25 in chips) 
tYsOBqdU1+x+yFI7zHO7hQ: posts small blind $0.10
t70KGeRtR3naHSqKDixsUg: posts big blind $0.25
22dIObOuor/A+IKWkNoAlA: sits out 
*** HOLE CARDS ***
jeKWRUkMaVn8rEUjnJKqpg: calls $0.25
4oA316mXLIui1QY63GXBUg: folds 
5z3YkZTfH2GjoLK+6X7z2w: folds 
rUpvA02nErFvZ4yFbDR8XA: folds 
hBMUlEpyU74r/fwDgIpXjQ: raises $0.75 to $1
qS+jfnNoG75bT+uQ8CKhQA: calls $1
tYsOBqdU1+x+yFI7zHO7hQ: folds 
t70KGeRtR3naHSqKDixsUg: calls $0.75
jeKWRUkMaVn8rEUjnJKqpg: calls $0.75
*** FLOP *** [3h 9d 7d]
t70KGeRtR3naHSqKDixsUg: checks 
jeKWRUkMaVn8rEUjnJKqpg: bets $2
hBMUlEpyU74r/fwDgIpXjQ: folds 
qS+jfnNoG75bT+uQ8CKhQA: folds 
t70KGeRtR3naHSqKDixsUg: folds 
Uncalled bet ($2) returned to jeKWRUkMaVn8rEUjnJKqpg
jeKWRUkMaVn8rEUjnJKqpg collected $3.90 from pot
jeKWRUkMaVn8rEUjnJKqpg: doesn't show hand 
*** SUMMARY ***
Total pot $4.10 | Rake $0.20 
Board [3h 9d 7d]
Seat 1: 5z3YkZTfH2GjoLK+6X7z2w folded before Flop (didn't bet)
Seat 2: rUpvA02nErFvZ4yFbDR8XA folded before Flop (didn't bet)
Seat 3: hBMUlEpyU74r/fwDgIpXjQ folded on the Flop
Seat 5: qS+jfnNoG75bT+uQ8CKhQA (button) folded on the Flop
Seat 6: tYsOBqdU1+x+yFI7zHO7hQ (small blind) folded before Flop
Seat 7: t70KGeRtR3naHSqKDixsUg (big blind) folded on the Flop
Seat 8: jeKWRUkMaVn8rEUjnJKqpg collected ($3.90)
Seat 9: 4oA316mXLIui1QY63GXBUg folded before Flop (didn't bet)




PokerStars Game #59939705718:  Hold'em No Limit ($0.10/$0.25) - 2009/07/01 0:46:48 ET
Table 'GrYi0DZOHD1EvB+qiLExNw' 9-max Seat #1 is the button
Seat 1: 4awUyiDYTgylQKXZ9faBVA ($25 in chips) 
Seat 2: Th3FldXKQW6hWVVPahaoOQ ($27.20 in chips) 
Seat 3: 4oA316mXLIui1QY63GXBUg ($25 in chips) 
Seat 4: 0GQg6tdDMBDzY6FKumSo9w ($48.10 in chips) 
Seat 5: cZ99hugmLBj9KhTlc8nCSw ($47.40 in chips) 
Seat 6: H9KUl8cmpLgEpOVDA00bCg ($4.20 in chips) 
Seat 7: 1Clf3cPrqoy/YgvWdWK1Xw ($5.35 in chips) 
Seat 8: nalbG/4/1Z1wQjRDWV7b2w ($8.40 in chips) 
Seat 9: OiV1PWZ3IkN29JlmCcnTwQ ($5 in chips) 
Th3FldXKQW6hWVVPahaoOQ: posts small blind $0.10
4oA316mXLIui1QY63GXBUg: posts big blind $0.25
*** HOLE CARDS ***
0GQg6tdDMBDzY6FKumSo9w: calls $0.25
cZ99hugmLBj9KhTlc8nCSw has timed out
cZ99hugmLBj9KhTlc8nCSw: folds 
cZ99hugmLBj9KhTlc8nCSw is sitting out
H9KUl8cmpLgEpOVDA00bCg: folds 
1Clf3cPrqoy/YgvWdWK1Xw: folds 
nalbG/4/1Z1wQjRDWV7b2w: calls $0.25
cZ99hugmLBj9KhTlc8nCSw has returned
OiV1PWZ3IkN29JlmCcnTwQ: folds 
4awUyiDYTgylQKXZ9faBVA: folds 
Th3FldXKQW6hWVVPahaoOQ: folds 
4oA316mXLIui1QY63GXBUg: checks 
*** FLOP *** [Qs Tc 4d]
4oA316mXLIui1QY63GXBUg: checks 
0GQg6tdDMBDzY6FKumSo9w: checks 
nalbG/4/1Z1wQjRDWV7b2w: bets $0.75
4oA316mXLIui1QY63GXBUg: folds 
0GQg6tdDMBDzY6FKumSo9w: folds 
Uncalled bet ($0.75) returned to nalbG/4/1Z1wQjRDWV7b2w
nalbG/4/1Z1wQjRDWV7b2w collected $0.85 from pot
nalbG/4/1Z1wQjRDWV7b2w: doesn't show hand 
*** SUMMARY ***
Total pot $0.85 | Rake $0 
Board [Qs Tc 4d]
Seat 1: 4awUyiDYTgylQKXZ9faBVA (button) folded before Flop (didn't bet)
Seat 2: Th3FldXKQW6hWVVPahaoOQ (small blind) folded before Flop
Seat 3: 4oA316mXLIui1QY63GXBUg (big blind) folded on the Flop
Seat 4: 0GQg6tdDMBDzY6FKumSo9w folded on the Flop
Seat 5: cZ99hugmLBj9KhTlc8nCSw folded before Flop (didn't bet)
Seat 6: H9KUl8cmpLgEpOVDA00bCg folded before Flop (didn't bet)
Seat 7: 1Clf3cPrqoy/YgvWdWK1Xw folded before Flop (didn't bet)
Seat 8: nalbG/4/1Z1wQjRDWV7b2w collected ($0.85)
Seat 9: OiV1PWZ3IkN29JlmCcnTwQ folded before Flop (didn't bet)




PokerStars Game #59939705478:  Hold'em No Limit ($0.10/$0.25) - 2009/07/01 0:46:48 ET
Table 'dVzscin98UhGisTmV9BDcw' 9-max Seat #5 is the button
Seat 1: sBAwXpkpgyhyWbHIQcIJKA ($19.05 in chips) 
Seat 2: dfNim92Z6XK1/h5SFW5vDg ($28.80 in chips) 
Seat 3: 1Clf3cPrqoy/YgvWdWK1Xw ($5 in chips) 
Seat 4: aNpwfA31EREwO+ar4XzBCw ($25 in chips) 
Seat 5: 22dIObOuor/A+IKWkNoAlA ($5 in chips) 
Seat 6: hBMUlEpyU74r/fwDgIpXjQ ($28.10 in chips) 
Seat 7: nEg1b6MIksd/4x5eLY735g ($64.65 in chips) 
Seat 8: /vn2Qu2dvc9AMMq46Ae0jA ($6.55 in chips) 
Seat 9: OYa/ZJBO+suuezfWsUMhZw ($4.45 in chips) 
hBMUlEpyU74r/fwDgIpXjQ: posts small blind $0.10
nEg1b6MIksd/4x5eLY735g: posts big blind $0.25
*** HOLE CARDS ***
/vn2Qu2dvc9AMMq46Ae0jA: raises $0.50 to $0.75
OYa/ZJBO+suuezfWsUMhZw: folds 
sBAwXpkpgyhyWbHIQcIJKA: folds 
dfNim92Z6XK1/h5SFW5vDg: folds 
1Clf3cPrqoy/YgvWdWK1Xw: folds 
aNpwfA31EREwO+ar4XzBCw: folds 
22dIObOuor/A+IKWkNoAlA: folds 
hBMUlEpyU74r/fwDgIpXjQ: folds 
nEg1b6MIksd/4x5eLY735g: calls $0.50
*** FLOP *** [4s 4h 7h]
nEg1b6MIksd/4x5eLY735g: checks 
/vn2Qu2dvc9AMMq46Ae0jA: checks 
*** TURN *** [4s 4h 7h] [9s]
nEg1b6MIksd/4x5eLY735g: checks 
/vn2Qu2dvc9AMMq46Ae0jA: checks 
*** RIVER *** [4s 4h 7h 9s] [8c]
nEg1b6MIksd/4x5eLY735g: checks 
/vn2Qu2dvc9AMMq46Ae0jA: bets $1
nEg1b6MIksd/4x5eLY735g: folds 
Uncalled bet ($1) returned to /vn2Qu2dvc9AMMq46Ae0jA
/vn2Qu2dvc9AMMq46Ae0jA collected $1.55 from pot
*** SUMMARY ***
Total pot $1.60 | Rake $0.05 
Board [4s 4h 7h 9s 8c]
Seat 1: sBAwXpkpgyhyWbHIQcIJKA folded before Flop (didn't bet)
Seat 2: dfNim92Z6XK1/h5SFW5vDg folded before Flop (didn't bet)
Seat 3: 1Clf3cPrqoy/YgvWdWK1Xw folded before Flop (didn't bet)
Seat 4: aNpwfA31EREwO+ar4XzBCw folded before Flop (didn't bet)
Seat 5: 22dIObOuor/A+IKWkNoAlA (button) folded before Flop (didn't bet)
Seat 6: hBMUlEpyU74r/fwDgIpXjQ (small blind) folded before Flop
Seat 7: nEg1b6MIksd/4x5eLY735g (big blind) folded on the River
Seat 8: /vn2Qu2dvc9AMMq46Ae0jA collected ($1.55)
Seat 9: OYa/ZJBO+suuezfWsUMhZw folded before Flop (didn't bet)




PokerStars Game #59939706516:  Hold'em No Limit ($0.10/$0.25) - 2009/07/01 0:46:49 ET
Table '4ZbiE0ZYjzqmgu6+sO1prg' 9-max Seat #5 is the button
Seat 1: N6fYvIzQLKaydFLKQGtMlQ ($26.70 in chips) 
Seat 2: w31DkWCTQDVIzsHIrFRDxA ($8.40 in chips) 
Seat 3: HPEB+AtKw1+C/cxU0o1ciw ($26.65 in chips) 
Seat 4: Eb2mDXvZ4iY02krYdOYwMA ($32.95 in chips) 
Seat 5: COsrwJSFHQtxlUcrYtDQPQ ($25 in chips) 
Seat 6: rXm4QDVJt67H20lM6n6Z7Q ($8 in chips) 
Seat 7: 3RCAkueG3Vc13VpRStCB+w ($20 in chips) 
Seat 8: cZ99hugmLBj9KhTlc8nCSw ($25 in chips) 
rXm4QDVJt67H20lM6n6Z7Q: posts small blind $0.10
3RCAkueG3Vc13VpRStCB+w: posts big blind $0.25
*** HOLE CARDS ***
cZ99hugmLBj9KhTlc8nCSw: folds 
N6fYvIzQLKaydFLKQGtMlQ: folds 
w31DkWCTQDVIzsHIrFRDxA: folds 
HPEB+AtKw1+C/cxU0o1ciw: raises $0.75 to $1
Eb2mDXvZ4iY02krYdOYwMA: raises $1.50 to $2.50
COsrwJSFHQtxlUcrYtDQPQ: folds 
rXm4QDVJt67H20lM6n6Z7Q: folds 
3RCAkueG3Vc13VpRStCB+w: folds 
HPEB+AtKw1+C/cxU0o1ciw: calls $1.50
*** FLOP *** [4h 6s 9s]
HPEB+AtKw1+C/cxU0o1ciw: checks 
Eb2mDXvZ4iY02krYdOYwMA: bets $2.25
HPEB+AtKw1+C/cxU0o1ciw: calls $2.25
*** TURN *** [4h 6s 9s] [8h]
HPEB+AtKw1+C/cxU0o1ciw: checks 
Eb2mDXvZ4iY02krYdOYwMA: bets $5
HPEB+AtKw1+C/cxU0o1ciw: calls $5
*** RIVER *** [4h 6s 9s 8h] [4c]
HPEB+AtKw1+C/cxU0o1ciw: checks 
Eb2mDXvZ4iY02krYdOYwMA: checks 
*** SHOW DOWN ***
HPEB+AtKw1+C/cxU0o1ciw: shows [7h 6h] (two pair, Sixes and Fours)
Eb2mDXvZ4iY02krYdOYwMA: shows [Ac Ah] (two pair, Aces and Fours)
Eb2mDXvZ4iY02krYdOYwMA collected $18.90 from pot
*** SUMMARY ***
Total pot $19.85 | Rake $0.95 
Board [4h 6s 9s 8h 4c]
Seat 1: N6fYvIzQLKaydFLKQGtMlQ folded before Flop (didn't bet)
Seat 2: w31DkWCTQDVIzsHIrFRDxA folded before Flop (didn't bet)
Seat 3: HPEB+AtKw1+C/cxU0o1ciw showed [7h 6h] and lost with two pair, Sixes and Fours
Seat 4: Eb2mDXvZ4iY02krYdOYwMA showed [Ac Ah] and won ($18.90) with two pair, Aces and Fours
Seat 5: COsrwJSFHQtxlUcrYtDQPQ (button) folded before Flop (didn't bet)
Seat 6: rXm4QDVJt67H20lM6n6Z7Q (small blind) folded before Flop
Seat 7: 3RCAkueG3Vc13VpRStCB+w (big blind) folded before Flop
Seat 8: cZ99hugmLBj9KhTlc8nCSw folded before Flop (didn't bet)




PokerStars Game #59939706378:  Hold'em No Limit ($0.10/$0.25) - 2009/07/01 0:46:49 ET
Table 'nFlmVztKq1HJEWfxmdl15w' 9-max Seat #9 is the button
Seat 2: nPydKI7KXtudhyCkYtLgZA ($4.75 in chips) 
Seat 3: /XMgGtJ7mcWfe5s7McY9kw ($22 in chips) 
Seat 4: +5dSUwD+/k2ktlnutSMivw ($20.25 in chips) 
Seat 5: Tx6zQdk5Ozt9ObEBlU7jeg ($24.55 in chips) 
Seat 6: 4awUyiDYTgylQKXZ9faBVA ($29.25 in chips) 
Seat 7: Mm1VqYDg+pZQ8ufUXZHA1g ($10.65 in chips) 
Seat 8: +2kMBNpY4nF1qNCRd8SJLA ($26.35 in chips) 
Seat 9: LSrAei+fS8MYG9ie/GkG0Q ($15.40 in chips) 
cZ99hugmLBj9KhTlc8nCSw will be allowed to play after the button
nPydKI7KXtudhyCkYtLgZA: posts small blind $0.10
/XMgGtJ7mcWfe5s7McY9kw: posts big blind $0.25
*** HOLE CARDS ***
+5dSUwD+/k2ktlnutSMivw: calls $0.25
Tx6zQdk5Ozt9ObEBlU7jeg: folds 
4awUyiDYTgylQKXZ9faBVA: folds 
Mm1VqYDg+pZQ8ufUXZHA1g: calls $0.25
+2kMBNpY4nF1qNCRd8SJLA: raises $1.75 to $2
LSrAei+fS8MYG9ie/GkG0Q: folds 
nPydKI7KXtudhyCkYtLgZA: folds 
/XMgGtJ7mcWfe5s7McY9kw: folds 
+5dSUwD+/k2ktlnutSMivw: folds 
Mm1VqYDg+pZQ8ufUXZHA1g: calls $1.75
*** FLOP *** [Ac 8c 8s]
Mm1VqYDg+pZQ8ufUXZHA1g: checks 
+2kMBNpY4nF1qNCRd8SJLA: bets $3.75
Mm1VqYDg+pZQ8ufUXZHA1g: folds 
Uncalled bet ($3.75) returned to +2kMBNpY4nF1qNCRd8SJLA
+2kMBNpY4nF1qNCRd8SJLA collected $4.40 from pot
*** SUMMARY ***
Total pot $4.60 | Rake $0.20 
Board [Ac 8c 8s]
Seat 2: nPydKI7KXtudhyCkYtLgZA (small blind) folded before Flop
Seat 3: /XMgGtJ7mcWfe5s7McY9kw (big blind) folded before Flop
Seat 4: +5dSUwD+/k2ktlnutSMivw folded before Flop
Seat 5: Tx6zQdk5Ozt9ObEBlU7jeg folded before Flop (didn't bet)
Seat 6: 4awUyiDYTgylQKXZ9faBVA folded before Flop (didn't bet)
Seat 7: Mm1VqYDg+pZQ8ufUXZHA1g folded on the Flop
Seat 8: +2kMBNpY4nF1qNCRd8SJLA collected ($4.40)
Seat 9: LSrAei+fS8MYG9ie/GkG0Q (button) folded before Flop (didn't bet)




PokerStars Game #59939706628:  Hold'em No Limit ($0.10/$0.25) - 2009/07/01 0:46:49 ET
Table 'sm5gqEvXgLbkkE4dryW/5g' 6-max Seat #5 is the button
Seat 1: gaPMxLGp9SOj4Lq6t+/0Ig ($15.40 in chips) 
Seat 2: s13YXIlhF/j3TO0bSnT7bA ($18.45 in chips) 
Seat 4: BedjMfrlRfPgSq7CXpPAmg ($56.90 in chips) 
Seat 5: M+WmDyCD/ZMu/5t6/iH2kw ($68.20 in chips) 
Seat 6: wKFJ513ucluNNiMlkXcDOQ ($27.25 in chips) 
wKFJ513ucluNNiMlkXcDOQ: posts small blind $0.10
gaPMxLGp9SOj4Lq6t+/0Ig: posts big blind $0.25
I1TxPvWj8NfG8orglCinNA: sits out 
*** HOLE CARDS ***
s13YXIlhF/j3TO0bSnT7bA: calls $0.25
BedjMfrlRfPgSq7CXpPAmg: folds 
M+WmDyCD/ZMu/5t6/iH2kw: folds 
wKFJ513ucluNNiMlkXcDOQ: folds 
gaPMxLGp9SOj4Lq6t+/0Ig: checks 
*** FLOP *** [Jc Ad 3d]
gaPMxLGp9SOj4Lq6t+/0Ig: checks 
s13YXIlhF/j3TO0bSnT7bA: checks 
*** TURN *** [Jc Ad 3d] [9s]
gaPMxLGp9SOj4Lq6t+/0Ig: checks 
s13YXIlhF/j3TO0bSnT7bA: bets $0.25
gaPMxLGp9SOj4Lq6t+/0Ig: calls $0.25
*** RIVER *** [Jc Ad 3d 9s] [6d]
gaPMxLGp9SOj4Lq6t+/0Ig: checks 
s13YXIlhF/j3TO0bSnT7bA: checks 
*** SHOW DOWN ***
gaPMxLGp9SOj4Lq6t+/0Ig: shows [2h Js] (a pair of Jacks)
s13YXIlhF/j3TO0bSnT7bA: mucks hand 
gaPMxLGp9SOj4Lq6t+/0Ig collected $1.05 from pot
*** SUMMARY ***
Total pot $1.10 | Rake $0.05 
Board [Jc Ad 3d 9s 6d]
Seat 1: gaPMxLGp9SOj4Lq6t+/0Ig (big blind) showed [2h Js] and won ($1.05) with a pair of Jacks
Seat 2: s13YXIlhF/j3TO0bSnT7bA mucked
Seat 4: BedjMfrlRfPgSq7CXpPAmg folded before Flop (didn't bet)
Seat 5: M+WmDyCD/ZMu/5t6/iH2kw (button) folded before Flop (didn't bet)
Seat 6: wKFJ513ucluNNiMlkXcDOQ (small blind) folded before Flop




PokerStars Game #59939706812:  Hold'em No Limit ($0.10/$0.25) - 2009/07/01 0:46:50 ET
Table 'IIO2q2znuuAXmiZ2qFTcmgiHlyuN1lFZ6WTlMBiiMYXAx Seat #4 is the button
Seat 3: QGjA4xtpxSpgzm+HC+ps4w ($21.60 in chips) 
Seat 4: z5GxcHlYz/GSz6W2uFiTtg ($23.65 in chips) 
Seat 7: f4BMia+2fXTujHMlpcXcbA ($12.70 in chips) 
f4BMia+2fXTujHMlpcXcbA: posts small blind $0.10
TeWJxSETzbXGiYKx0y+dtg: is sitting out 
TeWJxSETzbXGiYKx0y+dtg leaves the table
R6nIVAjK7uhK3Hj0f85A+A: is sitting out 
QGjA4xtpxSpgzm+HC+ps4w: posts big blind $0.25
*** HOLE CARDS ***
z5GxcHlYz/GSz6W2uFiTtg: folds 
z5GxcHlYz/GSz6W2uFiTtg leaves the table
f4BMia+2fXTujHMlpcXcbA: calls $0.15
QGjA4xtpxSpgzm+HC+ps4w: checks 
*** FLOP *** [8s 7c 4h]
f4BMia+2fXTujHMlpcXcbA: checks 
QGjA4xtpxSpgzm+HC+ps4w: checks 
*** TURN *** [8s 7c 4h] [Kc]
f4BMia+2fXTujHMlpcXcbA: bets $0.50
QGjA4xtpxSpgzm+HC+ps4w: folds 
Uncalled bet ($0.50) returned to f4BMia+2fXTujHMlpcXcbA
f4BMia+2fXTujHMlpcXcbA collected $0.50 from pot
f4BMia+2fXTujHMlpcXcbA leaves the table
*** SUMMARY ***
Total pot $0.50 | Rake $0 
Board [8s 7c 4h Kc]
Seat 3: QGjA4xtpxSpgzm+HC+ps4w (big blind) folded on the Turn
Seat 4: z5GxcHlYz/GSz6W2uFiTtg (button) folded before Flop (didn't bet)
Seat 7: f4BMia+2fXTujHMlpcXcbA (small blind) collected ($0.50)




PokerStars Game #59939706822:  Hold'em No Limit ($0.10/$0.25) - 2009/07/01 0:46:50 ET
Table '+VTTYgQLH1awDHk+IAxqGg' 9-max Seat #3 is the button
Seat 1: s7Q6uNouhe7aE8JdFb9E+A ($25 in chips) 
Seat 2: 86vbuhJsyH+nbEg5qpDLyQ ($23.05 in chips) 
Seat 3: rSMoem/92WmnPjtw2tSQkA ($31.60 in chips) 
Seat 4: gE5rN2TDY1aXcZn/TOPeZw ($9.05 in chips) 
Seat 5: sD+TKtt36XiiN6jqHiLwDA ($38.60 in chips) 
Seat 7: W4TLQcZ2TiM73eIgpIvlGg ($26.20 in chips) 
Seat 9: CFZ+ACzShzC3naaIaOjbYQ ($8.10 in chips) 
gE5rN2TDY1aXcZn/TOPeZw: posts small blind $0.10
sD+TKtt36XiiN6jqHiLwDA: posts big blind $0.25
gehe91e0IyVT0QU/XBkEyg: sits out 
j4q3p0lesp63b1gZDwLBZw: sits out 
*** HOLE CARDS ***
W4TLQcZ2TiM73eIgpIvlGg: folds 
CFZ+ACzShzC3naaIaOjbYQ: folds 
s7Q6uNouhe7aE8JdFb9E+A: folds 
86vbuhJsyH+nbEg5qpDLyQ: folds 
rSMoem/92WmnPjtw2tSQkA: calls $0.25
gE5rN2TDY1aXcZn/TOPeZw: calls $0.15
sD+TKtt36XiiN6jqHiLwDA: checks 
*** FLOP *** [8d 6s Qc]
gE5rN2TDY1aXcZn/TOPeZw: checks 
sD+TKtt36XiiN6jqHiLwDA: checks 
rSMoem/92WmnPjtw2tSQkA: bets $0.75
gE5rN2TDY1aXcZn/TOPeZw: calls $0.75
sD+TKtt36XiiN6jqHiLwDA: folds 
*** TURN *** [8d 6s Qc] [5c]
gE5rN2TDY1aXcZn/TOPeZw: checks 
rSMoem/92WmnPjtw2tSQkA: checks 
*** RIVER *** [8d 6s Qc 5c] [9c]
gE5rN2TDY1aXcZn/TOPeZw: bets $1
rSMoem/92WmnPjtw2tSQkA: folds 
Uncalled bet ($1) returned to gE5rN2TDY1aXcZn/TOPeZw
gE5rN2TDY1aXcZn/TOPeZw collected $2.15 from pot
*** SUMMARY ***
Total pot $2.25 | Rake $0.10 
Board [8d 6s Qc 5c 9c]
Seat 1: s7Q6uNouhe7aE8JdFb9E+A folded before Flop (didn't bet)
Seat 2: 86vbuhJsyH+nbEg5qpDLyQ folded before Flop (didn't bet)
Seat 3: rSMoem/92WmnPjtw2tSQkA (button) folded on the River
Seat 4: gE5rN2TDY1aXcZn/TOPeZw (small blind) collected ($2.15)
Seat 5: sD+TKtt36XiiN6jqHiLwDA (big blind) folded on the Flop
Seat 7: W4TLQcZ2TiM73eIgpIvlGg folded before Flop (didn't bet)
Seat 9: CFZ+ACzShzC3naaIaOjbYQ folded before Flop (didn't bet)




PokerStars Game #59939707066:  Hold'em No Limit ($0.10/$0.25) - 2009/07/01 0:46:50 ET
Table 'Loy/olZ5qoDOSvX4UTujGg' 6-max Seat #3 is the button
Seat 1: yzFNNFIfC89bBPwpFPx2ow ($25 in chips) 
Seat 2: 5OssdLlobpBsQP4GLYbbZQ ($5.60 in chips) 
Seat 3: 32YL2ZEp8NT4JB2RVM9euQ ($19.95 in chips) 
Seat 4: /gJNBeCkWL4o85/jvlZ4BA ($26.85 in chips) 
Seat 5: 4YSTu0Cdzpppe1lUgCZGCQ ($62.35 in chips) 
Seat 6: 7FmwVDcdEtxDpHmP4hOXsQ ($52.35 in chips) 
/gJNBeCkWL4o85/jvlZ4BA: posts small blind $0.10
4YSTu0Cdzpppe1lUgCZGCQ: posts big blind $0.25
*** HOLE CARDS ***
7FmwVDcdEtxDpHmP4hOXsQ: folds 
yzFNNFIfC89bBPwpFPx2ow: folds 
5OssdLlobpBsQP4GLYbbZQ: folds 
32YL2ZEp8NT4JB2RVM9euQ: folds 
/gJNBeCkWL4o85/jvlZ4BA: folds 
Uncalled bet ($0.15) returned to 4YSTu0Cdzpppe1lUgCZGCQ
4YSTu0Cdzpppe1lUgCZGCQ collected $0.20 from pot
4YSTu0Cdzpppe1lUgCZGCQ: doesn't show hand 
*** SUMMARY ***
Total pot $0.20 | Rake $0 
Seat 1: yzFNNFIfC89bBPwpFPx2ow folded before Flop (didn't bet)
Seat 2: 5OssdLlobpBsQP4GLYbbZQ folded before Flop (didn't bet)
Seat 3: 32YL2ZEp8NT4JB2RVM9euQ (button) folded before Flop (didn't bet)
Seat 4: /gJNBeCkWL4o85/jvlZ4BA (small blind) folded before Flop
Seat 5: 4YSTu0Cdzpppe1lUgCZGCQ (big blind) collected ($0.20)
Seat 6: 7FmwVDcdEtxDpHmP4hOXsQ folded before Flop (didn't bet)




PokerStars Game #59939707170:  Hold'em No Limit ($0.10/$0.25) - 2009/07/01 0:46:50 ET
Table 'g+mPuNJBCHKE9ents7ZGtg' 6-max Seat #3 is the button
Seat 1: YaAEMJGY5tem39deCUQRNw ($24 in chips) 
Seat 2: fZQg9veL7Dd/Z04ZTjC+wQ ($30.35 in chips) 
Seat 3: 9jSiy0meE9XJKkdIZwyTEQ ($36.10 in chips) 
Seat 4: mfrkWA3PTeYPkbO6hi98Aw ($24.40 in chips) 
Seat 5: 32YL2ZEp8NT4JB2RVM9euQ ($15.65 in chips) 
Seat 6: MS2T205Bjud7PnNoANu4vQ ($46.30 in chips) 
mfrkWA3PTeYPkbO6hi98Aw: posts small blind $0.10
32YL2ZEp8NT4JB2RVM9euQ: posts big blind $0.25
*** HOLE CARDS ***
MS2T205Bjud7PnNoANu4vQ: raises $0.50 to $0.75
YaAEMJGY5tem39deCUQRNw: folds 
fZQg9veL7Dd/Z04ZTjC+wQ: folds 
9jSiy0meE9XJKkdIZwyTEQ: folds 
mfrkWA3PTeYPkbO6hi98Aw: folds 
32YL2ZEp8NT4JB2RVM9euQ: folds 
Uncalled bet ($0.50) returned to MS2T205Bjud7PnNoANu4vQ
MS2T205Bjud7PnNoANu4vQ collected $0.60 from pot
MS2T205Bjud7PnNoANu4vQ: doesn't show hand 
*** SUMMARY ***
Total pot $0.60 | Rake $0 
Seat 1: YaAEMJGY5tem39deCUQRNw folded before Flop (didn't bet)
Seat 2: fZQg9veL7Dd/Z04ZTjC+wQ folded before Flop (didn't bet)
Seat 3: 9jSiy0meE9XJKkdIZwyTEQ (button) folded before Flop (didn't bet)
Seat 4: mfrkWA3PTeYPkbO6hi98Aw (small blind) folded before Flop
Seat 5: 32YL2ZEp8NT4JB2RVM9euQ (big blind) folded before Flop
Seat 6: MS2T205Bjud7PnNoANu4vQ collected ($0.60)




PokerStars Game #59939707204:  Hold'em No Limit ($0.10/$0.25) - 2009/07/01 0:46:50 ET
Table 'ER5H84HUgJx7HyDLnELLeA' 6-max Seat #4 is the button
Seat 1: pjM/xh4+RG8zrxCobDgYDg ($16.70 in chips) 
Seat 2: nc79pm0LZRdhncq55evVqA ($48.50 in chips) 
Seat 3: BYxjLnV1/LL0aZcTbfAOvw ($25 in chips) 
Seat 4: tkRWn3WaJIfGmCXT2hPvJA ($18.40 in chips) 
Seat 5: mfrkWA3PTeYPkbO6hi98Aw ($25.35 in chips) 
Seat 6: 3zD3qLXT1bEffAoWGnc7wg ($30.85 in chips) 
mfrkWA3PTeYPkbO6hi98Aw: posts small blind $0.10
3zD3qLXT1bEffAoWGnc7wg: posts big blind $0.25
*** HOLE CARDS ***
pjM/xh4+RG8zrxCobDgYDg: folds 
nc79pm0LZRdhncq55evVqA: folds 
BYxjLnV1/LL0aZcTbfAOvw: folds 
tkRWn3WaJIfGmCXT2hPvJA: folds 
mfrkWA3PTeYPkbO6hi98Aw: folds 
Uncalled bet ($0.15) returned to 3zD3qLXT1bEffAoWGnc7wg
3zD3qLXT1bEffAoWGnc7wg collected $0.20 from pot
3zD3qLXT1bEffAoWGnc7wg: doesn't show hand 
*** SUMMARY ***
Total pot $0.20 | Rake $0 
Seat 1: pjM/xh4+RG8zrxCobDgYDg folded before Flop (didn't bet)
Seat 2: nc79pm0LZRdhncq55evVqA folded before Flop (didn't bet)
Seat 3: BYxjLnV1/LL0aZcTbfAOvw folded before Flop (didn't bet)
Seat 4: tkRWn3WaJIfGmCXT2hPvJA (button) folded before Flop (didn't bet)
Seat 5: mfrkWA3PTeYPkbO6hi98Aw (small blind) folded before Flop
Seat 6: 3zD3qLXT1bEffAoWGnc7wg (big blind) collected ($0.20)




PokerStars Game #59939707086:  Hold'em No Limit ($0.10/$0.25) - 2009/07/01 0:46:50 ET
Table '29D3eoQzK5kOAT0OIDS2uQ' 6-max Seat #6 is the button
Seat 1: kG34n23qFQA3nzdOJTQ1dA ($49.40 in chips) 
Seat 2: eSKnWz2RD4rvwnvB+rFzIg ($25 in chips) 
Seat 3: z3tQwy28dp5FykDJC/wzQw ($22.70 in chips) 
Seat 4: yzFNNFIfC89bBPwpFPx2ow ($25.65 in chips) 
Seat 5: Q3EMN7b0ie81AFWkDrhCjw ($34.15 in chips) 
Seat 6: bWbV4MVB/vVpiES1Ut4hew ($43.90 in chips) 
kG34n23qFQA3nzdOJTQ1dA: posts small blind $0.10
eSKnWz2RD4rvwnvB+rFzIg: posts big blind $0.25
*** HOLE CARDS ***
z3tQwy28dp5FykDJC/wzQw: folds 
yzFNNFIfC89bBPwpFPx2ow: raises $0.75 to $1
Q3EMN7b0ie81AFWkDrhCjw: folds 
bWbV4MVB/vVpiES1Ut4hew: folds 
kG34n23qFQA3nzdOJTQ1dA: folds 
eSKnWz2RD4rvwnvB+rFzIg: folds 
Uncalled bet ($0.75) returned to yzFNNFIfC89bBPwpFPx2ow
yzFNNFIfC89bBPwpFPx2ow collected $0.60 from pot
yzFNNFIfC89bBPwpFPx2ow: doesn't show hand 
*** SUMMARY ***
Total pot $0.60 | Rake $0 
Seat 1: kG34n23qFQA3nzdOJTQ1dA (small blind) folded before Flop
Seat 2: eSKnWz2RD4rvwnvB+rFzIg (big blind) folded before Flop
Seat 3: z3tQwy28dp5FykDJC/wzQw folded before Flop (didn't bet)
Seat 4: yzFNNFIfC89bBPwpFPx2ow collected ($0.60)
Seat 5: Q3EMN7b0ie81AFWkDrhCjw folded before Flop (didn't bet)
Seat 6: bWbV4MVB/vVpiES1Ut4hew (button) folded before Flop (didn't bet)




PokerStars Game #59939707292:  Hold'em No Limit ($0.10/$0.25) - 2009/07/01 0:46:50 ET
Table '/asc7VQ/OpF/oVJ3erB80w' 9-max Seat #7 is the button
Seat 1: OiV1PWZ3IkN29JlmCcnTwQ ($4.90 in chips) 
Seat 2: Th3FldXKQW6hWVVPahaoOQ ($25.45 in chips) 
Seat 3: ie4EwTMMFYxrCXcenJdzsw ($8.50 in chips) 
Seat 4: H9KUl8cmpLgEpOVDA00bCg ($5 in chips) 
Seat 5: 8B/dhbQjIWe6ASCdgzktNQ ($25 in chips) 
Seat 6: t2nb95S5EEFOEzNx9Itz0g ($3.80 in chips) 
Seat 7: M2QO2DxB5Wawg2h8HSpnYA ($11.65 in chips) 
Seat 8: T5Hk9oiIr+JDDMnEqwFCrw ($9.25 in chips) 
Seat 9: UkJraTKWQIqFeHOyHQ7afQ ($13.90 in chips) 
T5Hk9oiIr+JDDMnEqwFCrw: posts small blind $0.10
UkJraTKWQIqFeHOyHQ7afQ: posts big blind $0.25
*** HOLE CARDS ***
OiV1PWZ3IkN29JlmCcnTwQ: folds 
Th3FldXKQW6hWVVPahaoOQ: folds 
ie4EwTMMFYxrCXcenJdzsw: raises $0.75 to $1
H9KUl8cmpLgEpOVDA00bCg: folds 
8B/dhbQjIWe6ASCdgzktNQ: folds 
t2nb95S5EEFOEzNx9Itz0g: folds 
M2QO2DxB5Wawg2h8HSpnYA: folds 
T5Hk9oiIr+JDDMnEqwFCrw: folds 
UkJraTKWQIqFeHOyHQ7afQ: calls $0.75
*** FLOP *** [Qc Kd 5h]
UkJraTKWQIqFeHOyHQ7afQ: checks 
ie4EwTMMFYxrCXcenJdzsw: bets $1.50
UkJraTKWQIqFeHOyHQ7afQ: folds 
Uncalled bet ($1.50) returned to ie4EwTMMFYxrCXcenJdzsw
ie4EwTMMFYxrCXcenJdzsw collected $2 from pot
*** SUMMARY ***
Total pot $2.10 | Rake $0.10 
Board [Qc Kd 5h]
Seat 1: OiV1PWZ3IkN29JlmCcnTwQ folded before Flop (didn't bet)
Seat 2: Th3FldXKQW6hWVVPahaoOQ folded before Flop (didn't bet)
Seat 3: ie4EwTMMFYxrCXcenJdzsw collected ($2)
Seat 4: H9KUl8cmpLgEpOVDA00bCg folded before Flop (didn't bet)
Seat 5: 8B/dhbQjIWe6ASCdgzktNQ folded before Flop (didn't bet)
Seat 6: t2nb95S5EEFOEzNx9Itz0g folded before Flop (didn't bet)
Seat 7: M2QO2DxB5Wawg2h8HSpnYA (button) folded before Flop (didn't bet)
Seat 8: T5Hk9oiIr+JDDMnEqwFCrw (small blind) folded before Flop
Seat 9: UkJraTKWQIqFeHOyHQ7afQ (big blind) folded on the Flop




PokerStars Game #59939707134:  Hold'em No Limit ($0.10/$0.25) - 2009/07/01 0:46:50 ET
Table '52Meibn9NOL4XtVi1p2Upw' 9-max Seat #9 is the button
Seat 1: LSrAei+fS8MYG9ie/GkG0Q ($12.55 in chips) 
Seat 2: BEIBUu2pIflPrCL+Iks4CQ ($12.25 in chips) 
Seat 3: MzBvksetB8XYtCt0FExJMg ($11.25 in chips) 
Seat 4: rCaXm4/EwAgWqCiClpbsqQ ($11.25 in chips) 
Seat 5: 4oA316mXLIui1QY63GXBUg ($27.70 in chips) 
Seat 6: 1wKfgJ8xXIiuc8C6qjkxhg ($9.80 in chips) 
Seat 7: R3KkgiqTvuhazyCqaD9cZg ($10 in chips) 
Seat 8: eKma8Z98pP7H8m4CEt075w ($22.95 in chips) 
Seat 9: 8B/dhbQjIWe6ASCdgzktNQ ($27.25 in chips) 
LSrAei+fS8MYG9ie/GkG0Q: posts small blind $0.10
BEIBUu2pIflPrCL+Iks4CQ: posts big blind $0.25
*** HOLE CARDS ***
MzBvksetB8XYtCt0FExJMg: calls $0.25
rCaXm4/EwAgWqCiClpbsqQ: folds 
4oA316mXLIui1QY63GXBUg: folds 
1wKfgJ8xXIiuc8C6qjkxhg: folds 
R3KkgiqTvuhazyCqaD9cZg: calls $0.25
eKma8Z98pP7H8m4CEt075w: folds 
8B/dhbQjIWe6ASCdgzktNQ: folds 
LSrAei+fS8MYG9ie/GkG0Q: folds 
BEIBUu2pIflPrCL+Iks4CQ: checks 
*** FLOP *** [Kc 7s 5h]
BEIBUu2pIflPrCL+Iks4CQ: checks 
MzBvksetB8XYtCt0FExJMg: checks 
R3KkgiqTvuhazyCqaD9cZg: checks 
*** TURN *** [Kc 7s 5h] [As]
BEIBUu2pIflPrCL+Iks4CQ: checks 
MzBvksetB8XYtCt0FExJMg: checks 
R3KkgiqTvuhazyCqaD9cZg: checks 
*** RIVER *** [Kc 7s 5h As] [4c]
BEIBUu2pIflPrCL+Iks4CQ: checks 
MzBvksetB8XYtCt0FExJMg: checks 
R3KkgiqTvuhazyCqaD9cZg: checks 
*** SHOW DOWN ***
BEIBUu2pIflPrCL+Iks4CQ: shows [9s Ah] (a pair of Aces)
MzBvksetB8XYtCt0FExJMg: mucks hand 
R3KkgiqTvuhazyCqaD9cZg: mucks hand 
BEIBUu2pIflPrCL+Iks4CQ collected $0.85 from pot
*** SUMMARY ***
Total pot $0.85 | Rake $0 
Board [Kc 7s 5h As 4c]
Seat 1: LSrAei+fS8MYG9ie/GkG0Q (small blind) folded before Flop
Seat 2: BEIBUu2pIflPrCL+Iks4CQ (big blind) showed [9s Ah] and won ($0.85) with a pair of Aces
Seat 3: MzBvksetB8XYtCt0FExJMg mucked
Seat 4: rCaXm4/EwAgWqCiClpbsqQ folded before Flop (didn't bet)
Seat 5: 4oA316mXLIui1QY63GXBUg folded before Flop (didn't bet)
Seat 6: 1wKfgJ8xXIiuc8C6qjkxhg folded before Flop (didn't bet)
Seat 7: R3KkgiqTvuhazyCqaD9cZg mucked
Seat 8: eKma8Z98pP7H8m4CEt075w folded before Flop (didn't bet)
Seat 9: 8B/dhbQjIWe6ASCdgzktNQ (button) folded before Flop (didn't bet)




PokerStars Game #59939707264:  Hold'em No Limit ($0.10/$0.25) - 2009/07/01 0:46:50 ET
Table 'BdTkgy6SGkgNXul6irMoOw' 9-max Seat #5 is the button
Seat 1: Jd9JmKichu4pvsKjXEKNvA ($6.15 in chips) 
Seat 2: ljemhp25Zg+nlA9DLCIiUw ($38.45 in chips) 
Seat 3: RQ9/w/vIRUIpv009qodF2Q ($11.15 in chips) 
Seat 4: eygIcrabyU9hI2mw7NQsgg ($20.55 in chips) 
Seat 5: opOCI2p6kW0tINuVaAqmcQ ($25 in chips) 
Seat 6: STkR8XvpjNv79OOMhrlh2w ($25 in chips) 
Seat 7: b8t3jWrxzeEt9HtZtc9wUQ ($14.25 in chips) 
Seat 8: 8Y1YOndOSMx6Ei47RaGbrw ($14.80 in chips) 
Seat 9: 5dv9mRGKI/UifM58OINXVQ ($22.15 in chips) 
STkR8XvpjNv79OOMhrlh2w: posts small blind $0.10
b8t3jWrxzeEt9HtZtc9wUQ: posts big blind $0.25
*** HOLE CARDS ***
8Y1YOndOSMx6Ei47RaGbrw: calls $0.25
5dv9mRGKI/UifM58OINXVQ: calls $0.25
Jd9JmKichu4pvsKjXEKNvA: calls $0.25
ljemhp25Zg+nlA9DLCIiUw: folds 
RQ9/w/vIRUIpv009qodF2Q: calls $0.25
eygIcrabyU9hI2mw7NQsgg: folds 
opOCI2p6kW0tINuVaAqmcQ: calls $0.25
STkR8XvpjNv79OOMhrlh2w: calls $0.15
b8t3jWrxzeEt9HtZtc9wUQ: checks 
*** FLOP *** [3c 7h 2s]
STkR8XvpjNv79OOMhrlh2w: checks 
b8t3jWrxzeEt9HtZtc9wUQ: checks 
8Y1YOndOSMx6Ei47RaGbrw: checks 
5dv9mRGKI/UifM58OINXVQ: checks 
Jd9JmKichu4pvsKjXEKNvA: checks 
RQ9/w/vIRUIpv009qodF2Q: checks 
opOCI2p6kW0tINuVaAqmcQ: checks 
*** TURN *** [3c 7h 2s] [Th]
STkR8XvpjNv79OOMhrlh2w: checks 
b8t3jWrxzeEt9HtZtc9wUQ: checks 
8Y1YOndOSMx6Ei47RaGbrw: checks 
5dv9mRGKI/UifM58OINXVQ: checks 
Jd9JmKichu4pvsKjXEKNvA: checks 
RQ9/w/vIRUIpv009qodF2Q: checks 
opOCI2p6kW0tINuVaAqmcQ: checks 
*** RIVER *** [3c 7h 2s Th] [6c]
STkR8XvpjNv79OOMhrlh2w: checks 
b8t3jWrxzeEt9HtZtc9wUQ: checks 
8Y1YOndOSMx6Ei47RaGbrw: folds 
8Y1YOndOSMx6Ei47RaGbrw leaves the table
5dv9mRGKI/UifM58OINXVQ: checks 
Jd9JmKichu4pvsKjXEKNvA: checks 
RQ9/w/vIRUIpv009qodF2Q: checks 
opOCI2p6kW0tINuVaAqmcQ: checks 
*** SHOW DOWN ***
STkR8XvpjNv79OOMhrlh2w: shows [Ah 8h] (high card Ace)
b8t3jWrxzeEt9HtZtc9wUQ: shows [8s Td] (a pair of Tens)
5dv9mRGKI/UifM58OINXVQ: mucks hand 
Jd9JmKichu4pvsKjXEKNvA: mucks hand 
RQ9/w/vIRUIpv009qodF2Q: mucks hand 
opOCI2p6kW0tINuVaAqmcQ: mucks hand 
b8t3jWrxzeEt9HtZtc9wUQ collected $1.70 from pot
*** SUMMARY ***
Total pot $1.75 | Rake $0.05 
Board [3c 7h 2s Th 6c]
Seat 1: Jd9JmKichu4pvsKjXEKNvA mucked
Seat 2: ljemhp25Zg+nlA9DLCIiUw folded before Flop (didn't bet)
Seat 3: RQ9/w/vIRUIpv009qodF2Q mucked
Seat 4: eygIcrabyU9hI2mw7NQsgg folded before Flop (didn't bet)
Seat 5: opOCI2p6kW0tINuVaAqmcQ (button) mucked
Seat 6: STkR8XvpjNv79OOMhrlh2w (small blind) showed [Ah 8h] and lost with high card Ace
Seat 7: b8t3jWrxzeEt9HtZtc9wUQ (big blind) showed [8s Td] and won ($1.70) with a pair of Tens
Seat 8: 8Y1YOndOSMx6Ei47RaGbrw folded on the River
Seat 9: 5dv9mRGKI/UifM58OINXVQ mucked




PokerStars Game #59939707048:  Hold'em No Limit ($0.10/$0.25) - 2009/07/01 0:46:50 ET
Table 'xro+BVoe2Zuw1TYmz/McJQ' 9-max Seat #5 is the button
Seat 1: xEQxarad8/T4jJdpZy5LGw ($6.60 in chips) 
Seat 2: MXCztnYJ58KLHMztZvKrxA ($8.25 in chips) 
Seat 3: COsrwJSFHQtxlUcrYtDQPQ ($36.60 in chips) 
Seat 4: N2LVj3iImgnOoHVf8g0rIw ($26.25 in chips) 
Seat 5: 87Warq49WFhxNpfNtKRmcQ ($27.15 in chips) 
Seat 6: HPEB+AtKw1+C/cxU0o1ciw ($26 in chips) 
Seat 7: QEbIGci+itdw+re8RM5fZA ($25 in chips) 
Seat 8: ljemhp25Zg+nlA9DLCIiUw ($24.75 in chips) 
Seat 9: H5Se03ZqSX7tbULXur2MAg ($24.30 in chips) 
HPEB+AtKw1+C/cxU0o1ciw: posts small blind $0.10
QEbIGci+itdw+re8RM5fZA: posts big blind $0.25
*** HOLE CARDS ***
ljemhp25Zg+nlA9DLCIiUw: folds 
H5Se03ZqSX7tbULXur2MAg: folds 
xEQxarad8/T4jJdpZy5LGw: calls $0.25
MXCztnYJ58KLHMztZvKrxA: calls $0.25
COsrwJSFHQtxlUcrYtDQPQ: folds 
N2LVj3iImgnOoHVf8g0rIw: raises $0.50 to $0.75
87Warq49WFhxNpfNtKRmcQ: folds 
HPEB+AtKw1+C/cxU0o1ciw: folds 
QEbIGci+itdw+re8RM5fZA: folds 
xEQxarad8/T4jJdpZy5LGw: calls $0.50
MXCztnYJ58KLHMztZvKrxA: calls $0.50
*** FLOP *** [Kc 5s 3d]
xEQxarad8/T4jJdpZy5LGw: bets $0.50
MXCztnYJ58KLHMztZvKrxA: folds 
N2LVj3iImgnOoHVf8g0rIw: raises $0.50 to $1
xEQxarad8/T4jJdpZy5LGw: calls $0.50
*** TURN *** [Kc 5s 3d] [6h]
xEQxarad8/T4jJdpZy5LGw: checks 
N2LVj3iImgnOoHVf8g0rIw: checks 
*** RIVER *** [Kc 5s 3d 6h] [7h]
xEQxarad8/T4jJdpZy5LGw: checks 
N2LVj3iImgnOoHVf8g0rIw: checks 
*** SHOW DOWN ***
xEQxarad8/T4jJdpZy5LGw: shows [Js Jd] (a pair of Jacks)
N2LVj3iImgnOoHVf8g0rIw: mucks hand 
xEQxarad8/T4jJdpZy5LGw collected $4.40 from pot
*** SUMMARY ***
Total pot $4.60 | Rake $0.20 
Board [Kc 5s 3d 6h 7h]
Seat 1: xEQxarad8/T4jJdpZy5LGw showed [Js Jd] and won ($4.40) with a pair of Jacks
Seat 2: MXCztnYJ58KLHMztZvKrxA folded on the Flop
Seat 3: COsrwJSFHQtxlUcrYtDQPQ folded before Flop (didn't bet)
Seat 4: N2LVj3iImgnOoHVf8g0rIw mucked
Seat 5: 87Warq49WFhxNpfNtKRmcQ (button) folded before Flop (didn't bet)
Seat 6: HPEB+AtKw1+C/cxU0o1ciw (small blind) folded before Flop
Seat 7: QEbIGci+itdw+re8RM5fZA (big blind) folded before Flop
Seat 8: ljemhp25Zg+nlA9DLCIiUw folded before Flop (didn't bet)
Seat 9: H5Se03ZqSX7tbULXur2MAg folded before Flop (didn't bet)




PokerStars Game #59939707818:  Hold'em No Limit ($0.10/$0.25) - 2009/07/01 0:46:51 ET
Table 'ohAuixfiLOYDylNUG5mNUw' 9-max Seat #4 is the button
Seat 1: AtRN1hdV8HbL3X4XogDaLA ($38.55 in chips) 
Seat 2: yVwP/Nr5oXkAQp5dmdNUVQ ($25 in chips) 
Seat 3: HVKi9hnDyvzObpL08/OarQ ($25.90 in chips) 
Seat 4: jeKWRUkMaVn8rEUjnJKqpg ($25 in chips) 
Seat 5: wub1jsnHlpWmOX4uczVADA ($9.50 in chips) 
Seat 6: opOCI2p6kW0tINuVaAqmcQ ($25.60 in chips) 
Seat 8: ppMlNkhYgErlt4fuJO7ADA ($9.85 in chips) 
Seat 9: hIss79a4pu7GzJZepfgOpg ($25 in chips) 
wub1jsnHlpWmOX4uczVADA: posts small blind $0.10
opOCI2p6kW0tINuVaAqmcQ: posts big blind $0.25
aPRz/2GxbXANYpVsQO8pdQ: sits out 
*** HOLE CARDS ***
ppMlNkhYgErlt4fuJO7ADA: folds 
hIss79a4pu7GzJZepfgOpg: folds 
AtRN1hdV8HbL3X4XogDaLA: folds 
yVwP/Nr5oXkAQp5dmdNUVQ: folds 
HVKi9hnDyvzObpL08/OarQ: folds 
jeKWRUkMaVn8rEUjnJKqpg: calls $0.25
wub1jsnHlpWmOX4uczVADA: raises $0.50 to $0.75
opOCI2p6kW0tINuVaAqmcQ: folds 
jeKWRUkMaVn8rEUjnJKqpg: calls $0.50
*** FLOP *** [8c Td 9c]
wub1jsnHlpWmOX4uczVADA: checks 
jeKWRUkMaVn8rEUjnJKqpg: checks 
*** TURN *** [8c Td 9c] [6s]
wub1jsnHlpWmOX4uczVADA: checks 
jeKWRUkMaVn8rEUjnJKqpg: bets $1
wub1jsnHlpWmOX4uczVADA: folds 
Uncalled bet ($1) returned to jeKWRUkMaVn8rEUjnJKqpg
jeKWRUkMaVn8rEUjnJKqpg collected $1.70 from pot
jeKWRUkMaVn8rEUjnJKqpg: doesn't show hand 
*** SUMMARY ***
Total pot $1.75 | Rake $0.05 
Board [8c Td 9c 6s]
Seat 1: AtRN1hdV8HbL3X4XogDaLA folded before Flop (didn't bet)
Seat 2: yVwP/Nr5oXkAQp5dmdNUVQ folded before Flop (didn't bet)
Seat 3: HVKi9hnDyvzObpL08/OarQ folded before Flop (didn't bet)
Seat 4: jeKWRUkMaVn8rEUjnJKqpg (button) collected ($1.70)
Seat 5: wub1jsnHlpWmOX4uczVADA (small blind) folded on the Turn
Seat 6: opOCI2p6kW0tINuVaAqmcQ (big blind) folded before Flop
Seat 8: ppMlNkhYgErlt4fuJO7ADA folded before Flop (didn't bet)
Seat 9: hIss79a4pu7GzJZepfgOpg folded before Flop (didn't bet)




PokerStars Game #59939707952:  Hold'em No Limit ($0.10/$0.25) - 2009/07/01 0:46:51 ET
Table 'FgLmv9bi/fJP8ldfbTOpkg' 9-max Seat #9 is the button
Seat 1: opOCI2p6kW0tINuVaAqmcQ ($25.70 in chips) 
Seat 2: mpsfNtnMVDqQHTe92AhIdw ($28.60 in chips) 
Seat 4: WfS0TjI8FyLemNTOo1e9qA ($11.50 in chips) 
Seat 5: ucLrYHo2o2p/ZURC7/I6gQ ($14.75 in chips) 
Seat 6: oKO7b50N6TzXbPBr/mcrUA ($29 in chips) 
Seat 7: eFrBtVXGVoMq1UwCDg8Exg ($29.05 in chips) 
Seat 8: sJNHTWcSlLHRCZ9+YRLLqA ($25 in chips) 
Seat 9: ljemhp25Zg+nlA9DLCIiUw ($24.65 in chips) 
opOCI2p6kW0tINuVaAqmcQ: posts small blind $0.10
mpsfNtnMVDqQHTe92AhIdw: posts big blind $0.25
uJlzv9KL7hgCIqIS2ofoaw: sits out 
*** HOLE CARDS ***
WfS0TjI8FyLemNTOo1e9qA: raises $1 to $1.25
ucLrYHo2o2p/ZURC7/I6gQ: folds 
oKO7b50N6TzXbPBr/mcrUA has timed out
oKO7b50N6TzXbPBr/mcrUA: folds 
oKO7b50N6TzXbPBr/mcrUA is sitting out
eFrBtVXGVoMq1UwCDg8Exg: folds 
oKO7b50N6TzXbPBr/mcrUA has returned
sJNHTWcSlLHRCZ9+YRLLqA: folds 
ljemhp25Zg+nlA9DLCIiUw: folds 
opOCI2p6kW0tINuVaAqmcQ: folds 
mpsfNtnMVDqQHTe92AhIdw: folds 
Uncalled bet ($1) returned to WfS0TjI8FyLemNTOo1e9qA
WfS0TjI8FyLemNTOo1e9qA collected $0.60 from pot
*** SUMMARY ***
Total pot $0.60 | Rake $0 
Seat 1: opOCI2p6kW0tINuVaAqmcQ (small blind) folded before Flop
Seat 2: mpsfNtnMVDqQHTe92AhIdw (big blind) folded before Flop
Seat 4: WfS0TjI8FyLemNTOo1e9qA collected ($0.60)
Seat 5: ucLrYHo2o2p/ZURC7/I6gQ folded before Flop (didn't bet)
Seat 6: oKO7b50N6TzXbPBr/mcrUA folded before Flop (didn't bet)
Seat 7: eFrBtVXGVoMq1UwCDg8Exg folded before Flop (didn't bet)
Seat 8: sJNHTWcSlLHRCZ9+YRLLqA folded before Flop (didn't bet)
Seat 9: ljemhp25Zg+nlA9DLCIiUw (button) folded before Flop (didn't bet)




PokerStars Game #59939707662:  Hold'em No Limit ($0.10/$0.25) - 2009/07/01 0:46:51 ET
Table 'oZuNsbNJuUyQLGKzQ/4JFg' 6-max Seat #3 is the button
Seat 1: /hq3j+3FbArzS8nEzmqRuw ($12.70 in chips) 
Seat 2: UA5OsKS3VPaxa7uC8La/kA ($31 in chips) 
Seat 3: 8ClCHtFXGNplITm+63KB+Q ($33.45 in chips) 
Seat 4: pWN7DVB+VCCiq83kllzEtg ($15.60 in chips) 
Seat 5: IH5lT4+CuQFyy32Qf5ydDw ($15 in chips) 
Seat 6: 34ttqW62uIRrqINCCmLcsw ($21.15 in chips) 
pWN7DVB+VCCiq83kllzEtg: posts small blind $0.10
IH5lT4+CuQFyy32Qf5ydDw: posts big blind $0.25
*** HOLE CARDS ***
34ttqW62uIRrqINCCmLcsw: folds 
/hq3j+3FbArzS8nEzmqRuw: calls $0.25
UA5OsKS3VPaxa7uC8La/kA: folds 
8ClCHtFXGNplITm+63KB+Q: raises $0.75 to $1
pWN7DVB+VCCiq83kllzEtg: folds 
IH5lT4+CuQFyy32Qf5ydDw: folds 
/hq3j+3FbArzS8nEzmqRuw: calls $0.75
*** FLOP *** [Jc Qd 6s]
/hq3j+3FbArzS8nEzmqRuw: bets $1.50
8ClCHtFXGNplITm+63KB+Q: calls $1.50
*** TURN *** [Jc Qd 6s] [Kd]
/hq3j+3FbArzS8nEzmqRuw: bets $1
8ClCHtFXGNplITm+63KB+Q: calls $1
*** RIVER *** [Jc Qd 6s Kd] [2d]
/hq3j+3FbArzS8nEzmqRuw: bets $1
8ClCHtFXGNplITm+63KB+Q: calls $1
*** SHOW DOWN ***
/hq3j+3FbArzS8nEzmqRuw: shows [8c Jd] (a pair of Jacks)
8ClCHtFXGNplITm+63KB+Q: shows [Ts Qs] (a pair of Queens)
8ClCHtFXGNplITm+63KB+Q collected $8.90 from pot
*** SUMMARY ***
Total pot $9.35 | Rake $0.45 
Board [Jc Qd 6s Kd 2d]
Seat 1: /hq3j+3FbArzS8nEzmqRuw showed [8c Jd] and lost with a pair of Jacks
Seat 2: UA5OsKS3VPaxa7uC8La/kA folded before Flop (didn't bet)
Seat 3: 8ClCHtFXGNplITm+63KB+Q (button) showed [Ts Qs] and won ($8.90) with a pair of Queens
Seat 4: pWN7DVB+VCCiq83kllzEtg (small blind) folded before Flop
Seat 5: IH5lT4+CuQFyy32Qf5ydDw (big blind) folded before Flop
Seat 6: 34ttqW62uIRrqINCCmLcsw folded before Flop (didn't bet)




PokerStars Game #59939707870:  Hold'em No Limit ($0.10/$0.25) - 2009/07/01 0:46:51 ET
Table 'nRFAYu63wZNzrz/OBgzFTw' 9-max Seat #8 is the button
Seat 1: N6fYvIzQLKaydFLKQGtMlQ ($24 in chips) 
Seat 2: hJ4uYjNmSZdjrKA8cjZqCA ($19.20 in chips) 
Seat 4: OiV1PWZ3IkN29JlmCcnTwQ ($5.15 in chips) 
Seat 5: vKdukiQ4ktU4yJ0Xx3MKnA ($29.85 in chips) 
Seat 6: DnDcAdn9P0zGovMERigpFA ($25.25 in chips) 
Seat 7: dtZ84flFEi4Q+SGrHMJRDQ ($25 in chips) 
Seat 8: amHgC+Q9cpfD/2w2yUtNbw ($9.40 in chips) 
N6fYvIzQLKaydFLKQGtMlQ: posts small blind $0.10
hJ4uYjNmSZdjrKA8cjZqCA: posts big blind $0.25
W8cIfrCR+zA8pCNyIuHu8g: sits out 
dtZ84flFEi4Q+SGrHMJRDQ: posts big blind $0.25
*** HOLE CARDS ***
OiV1PWZ3IkN29JlmCcnTwQ: folds 
vKdukiQ4ktU4yJ0Xx3MKnA: folds 
DnDcAdn9P0zGovMERigpFA: folds 
dtZ84flFEi4Q+SGrHMJRDQ: checks 
amHgC+Q9cpfD/2w2yUtNbw: raises $0.75 to $1
N6fYvIzQLKaydFLKQGtMlQ: folds 
hJ4uYjNmSZdjrKA8cjZqCA: folds 
dtZ84flFEi4Q+SGrHMJRDQ: folds 
Uncalled bet ($0.75) returned to amHgC+Q9cpfD/2w2yUtNbw
amHgC+Q9cpfD/2w2yUtNbw collected $0.85 from pot
*** SUMMARY ***
Total pot $0.85 | Rake $0 
Seat 1: N6fYvIzQLKaydFLKQGtMlQ (small blind) folded before Flop
Seat 2: hJ4uYjNmSZdjrKA8cjZqCA (big blind) folded before Flop
Seat 4: OiV1PWZ3IkN29JlmCcnTwQ folded before Flop (didn't bet)
Seat 5: vKdukiQ4ktU4yJ0Xx3MKnA folded before Flop (didn't bet)
Seat 6: DnDcAdn9P0zGovMERigpFA folded before Flop (didn't bet)
Seat 7: dtZ84flFEi4Q+SGrHMJRDQ folded before Flop
Seat 8: amHgC+Q9cpfD/2w2yUtNbw (button) collected ($0.85)




PokerStars Game #59939707652:  Hold'em No Limit ($0.10/$0.25) - 2009/07/01 0:46:51 ET
Table '8kaMIn+aON/ferW89Go6Pw' 9-max Seat #2 is the button
Seat 2: jeKWRUkMaVn8rEUjnJKqpg ($26.80 in chips) 
Seat 3: 7cv+9Zc9HIQHNvYsMfV3uA ($28.30 in chips) 
Seat 4: KRWTiGM4xH+MkvPtJz4+SA ($45.55 in chips) 
Seat 5: hIss79a4pu7GzJZepfgOpg ($32.25 in chips) 
Seat 6: 1S/fpm+f42V/6MNZre+ccg ($25 in chips) 
Seat 7: HVKi9hnDyvzObpL08/OarQ ($24.60 in chips) 
Seat 8: Rjy74A2wdEiDWplMcUbA+w ($15 in chips) 
7cv+9Zc9HIQHNvYsMfV3uA: posts small blind $0.10
KRWTiGM4xH+MkvPtJz4+SA: posts big blind $0.25
Rjy74A2wdEiDWplMcUbA+w: posts big blind $0.25
*** HOLE CARDS ***
hIss79a4pu7GzJZepfgOpg: folds 
1S/fpm+f42V/6MNZre+ccg: folds 
HVKi9hnDyvzObpL08/OarQ: folds 
Rjy74A2wdEiDWplMcUbA+w: checks 
jeKWRUkMaVn8rEUjnJKqpg: folds 
7cv+9Zc9HIQHNvYsMfV3uA: folds 
KRWTiGM4xH+MkvPtJz4+SA: checks 
*** FLOP *** [Tc Td Ac]
KRWTiGM4xH+MkvPtJz4+SA: checks 
ottZQkg1UDWk85BtBzGJzg joins the table at seat #9 
Rjy74A2wdEiDWplMcUbA+w: checks 
*** TURN *** [Tc Td Ac] [2h]
KRWTiGM4xH+MkvPtJz4+SA: checks 
Rjy74A2wdEiDWplMcUbA+w: checks 
*** RIVER *** [Tc Td Ac 2h] [8h]
KRWTiGM4xH+MkvPtJz4+SA: checks 
Rjy74A2wdEiDWplMcUbA+w: bets $0.25
KRWTiGM4xH+MkvPtJz4+SA: folds 
Uncalled bet ($0.25) returned to Rjy74A2wdEiDWplMcUbA+w
Rjy74A2wdEiDWplMcUbA+w collected $0.60 from pot
*** SUMMARY ***
Total pot $0.60 | Rake $0 
Board [Tc Td Ac 2h 8h]
Seat 2: jeKWRUkMaVn8rEUjnJKqpg (button) folded before Flop (didn't bet)
Seat 3: 7cv+9Zc9HIQHNvYsMfV3uA (small blind) folded before Flop
Seat 4: KRWTiGM4xH+MkvPtJz4+SA (big blind) folded on the River
Seat 5: hIss79a4pu7GzJZepfgOpg folded before Flop (didn't bet)
Seat 6: 1S/fpm+f42V/6MNZre+ccg folded before Flop (didn't bet)
Seat 7: HVKi9hnDyvzObpL08/OarQ folded before Flop (didn't bet)
Seat 8: Rjy74A2wdEiDWplMcUbA+w collected ($0.60)




PokerStars Game #59939708576:  Hold'em No Limit ($0.10/$0.25) - 2009/07/01 0:46:52 ET
Table 'I0ZcuiUTeLuGYv26Nah7YA' 9-max Seat #4 is the button
Seat 1: iMiqaPr7dx84UF0wNUeh8A ($17.60 in chips) 
Seat 2: yzPZQFeaQTNf1YK3a0zRIw ($9 in chips) 
Seat 3: 1S/fpm+f42V/6MNZre+ccg ($29.55 in chips) 
Seat 4: 4awUyiDYTgylQKXZ9faBVA ($29.45 in chips) 
Seat 5: opOCI2p6kW0tINuVaAqmcQ ($42.90 in chips) 
Seat 6: JRV2PblFtPFz51l0Fwyz8g ($23.75 in chips) 
Seat 8: ijc1q+bpPQR12wxc0sWc4w ($18.40 in chips) 
opOCI2p6kW0tINuVaAqmcQ: posts small blind $0.10
JRV2PblFtPFz51l0Fwyz8g: posts big blind $0.25
RJ/x9oZtt1RZLaJEQwZOxQ: sits out 
6RiVTYll/5D8zICp0MRpKw: sits out 
*** HOLE CARDS ***
ijc1q+bpPQR12wxc0sWc4w: folds 
iMiqaPr7dx84UF0wNUeh8A: folds 
yzPZQFeaQTNf1YK3a0zRIw: folds 
1S/fpm+f42V/6MNZre+ccg: folds 
4awUyiDYTgylQKXZ9faBVA: raises $0.75 to $1
opOCI2p6kW0tINuVaAqmcQ: folds 
JRV2PblFtPFz51l0Fwyz8g: calls $0.75
*** FLOP *** [6d Ad 3h]
JRV2PblFtPFz51l0Fwyz8g: checks 
4awUyiDYTgylQKXZ9faBVA: bets $1.25
JRV2PblFtPFz51l0Fwyz8g: folds 
Uncalled bet ($1.25) returned to 4awUyiDYTgylQKXZ9faBVA
4awUyiDYTgylQKXZ9faBVA collected $2 from pot
4awUyiDYTgylQKXZ9faBVA: doesn't show hand 
*** SUMMARY ***
Total pot $2.10 | Rake $0.10 
Board [6d Ad 3h]
Seat 1: iMiqaPr7dx84UF0wNUeh8A folded before Flop (didn't bet)
Seat 2: yzPZQFeaQTNf1YK3a0zRIw folded before Flop (didn't bet)
Seat 3: 1S/fpm+f42V/6MNZre+ccg folded before Flop (didn't bet)
Seat 4: 4awUyiDYTgylQKXZ9faBVA (button) collected ($2)
Seat 5: opOCI2p6kW0tINuVaAqmcQ (small blind) folded before Flop
Seat 6: JRV2PblFtPFz51l0Fwyz8g (big blind) folded on the Flop
Seat 8: ijc1q+bpPQR12wxc0sWc4w folded before Flop (didn't bet)




PokerStars Game #59939708262:  Hold'em No Limit ($0.10/$0.25) - 2009/07/01 0:46:52 ET
Table 'IdXp6nyeW4FYaEK4qKCnwQ' 9-max Seat #5 is the button
Seat 2: HPEB+AtKw1+C/cxU0o1ciw ($28.10 in chips) 
Seat 4: IK3/w7XV7rd8mVIsuasjYA ($4.15 in chips) 
Seat 5: U41wNf6XauAiBOQaKu2ZIA ($6.90 in chips) 
Seat 6: qeHpnumzEthsYultSkNjCA ($6.50 in chips) 
Seat 9: JJH2Xc95hFewheF67vSv4Q ($21.15 in chips) 
qeHpnumzEthsYultSkNjCA: posts small blind $0.10
JJH2Xc95hFewheF67vSv4Q: posts big blind $0.25
*** HOLE CARDS ***
U41wNf6XauAiBOQaKu2ZIA said, "callin with that the hole way?"
U41wNf6XauAiBOQaKu2ZIA said, "ha"
HPEB+AtKw1+C/cxU0o1ciw: folds 
IK3/w7XV7rd8mVIsuasjYA: calls $0.25
U41wNf6XauAiBOQaKu2ZIA: calls $0.25
qeHpnumzEthsYultSkNjCA: calls $0.15
JJH2Xc95hFewheF67vSv4Q: checks 
*** FLOP *** [9s 2c 4s]
qeHpnumzEthsYultSkNjCA: bets $0.75
JJH2Xc95hFewheF67vSv4Q: calls $0.75
IK3/w7XV7rd8mVIsuasjYA: folds 
U41wNf6XauAiBOQaKu2ZIA: folds 
*** TURN *** [9s 2c 4s] [Th]
qeHpnumzEthsYultSkNjCA: bets $1
JJH2Xc95hFewheF67vSv4Q: calls $1
*** RIVER *** [9s 2c 4s Th] [Qc]
qeHpnumzEthsYultSkNjCA: bets $1
JJH2Xc95hFewheF67vSv4Q: calls $1
*** SHOW DOWN ***
qeHpnumzEthsYultSkNjCA: shows [9c 5h] (a pair of Nines)
JJH2Xc95hFewheF67vSv4Q: mucks hand 
qeHpnumzEthsYultSkNjCA collected $6.20 from pot
*** SUMMARY ***
Total pot $6.50 | Rake $0.30 
Board [9s 2c 4s Th Qc]
Seat 2: HPEB+AtKw1+C/cxU0o1ciw folded before Flop (didn't bet)
Seat 4: IK3/w7XV7rd8mVIsuasjYA folded on the Flop
Seat 5: U41wNf6XauAiBOQaKu2ZIA (button) folded on the Flop
Seat 6: qeHpnumzEthsYultSkNjCA (small blind) showed [9c 5h] and won ($6.20) with a pair of Nines
Seat 9: JJH2Xc95hFewheF67vSv4Q (big blind) mucked




PokerStars Game #59939708094:  Hold'em No Limit ($0.10/$0.25) - 2009/07/01 0:46:52 ET
Table 'nQC9LRg01NEuKFHF1nrDEw0XPo7K54oZIfG0xlNAcDRw-max Seat #3 is the button
Seat 1: Nj6/PdBvfG79w0yeIjPmmA ($13.70 in chips) 
Seat 2: cPO/1/dTcZpLkQFm3jH3Rg ($32.70 in chips) 
Seat 3: 6+g0Lb6vfRDZkElV8ieHyQ ($29.95 in chips) 
Seat 4: tLM9aw7T3kBEIhQEh1roOg ($8.45 in chips) 
Seat 5: kG34n23qFQA3nzdOJTQ1dA ($28.15 in chips) 
Seat 6: xQVFeVUDopz+akuEo2wXpQ ($45.15 in chips) 
tLM9aw7T3kBEIhQEh1roOg: posts small blind $0.10
kG34n23qFQA3nzdOJTQ1dA: posts big blind $0.25
*** HOLE CARDS ***
xQVFeVUDopz+akuEo2wXpQ: folds 
Nj6/PdBvfG79w0yeIjPmmA: folds 
cPO/1/dTcZpLkQFm3jH3Rg: folds 
6+g0Lb6vfRDZkElV8ieHyQ: folds 
tLM9aw7T3kBEIhQEh1roOg: calls $0.15
kG34n23qFQA3nzdOJTQ1dA: checks 
*** FLOP *** [2s 2d 3s]
tLM9aw7T3kBEIhQEh1roOg: checks 
kG34n23qFQA3nzdOJTQ1dA: checks 
*** TURN *** [2s 2d 3s] [5c]
tLM9aw7T3kBEIhQEh1roOg: bets $0.25
kG34n23qFQA3nzdOJTQ1dA: folds 
Uncalled bet ($0.25) returned to tLM9aw7T3kBEIhQEh1roOg
tLM9aw7T3kBEIhQEh1roOg collected $0.50 from pot
*** SUMMARY ***
Total pot $0.50 | Rake $0 
Board [2s 2d 3s 5c]
Seat 1: Nj6/PdBvfG79w0yeIjPmmA folded before Flop (didn't bet)
Seat 2: cPO/1/dTcZpLkQFm3jH3Rg folded before Flop (didn't bet)
Seat 3: 6+g0Lb6vfRDZkElV8ieHyQ (button) folded before Flop (didn't bet)
Seat 4: tLM9aw7T3kBEIhQEh1roOg (small blind) collected ($0.50)
Seat 5: kG34n23qFQA3nzdOJTQ1dA (big blind) folded on the Turn
Seat 6: xQVFeVUDopz+akuEo2wXpQ folded before Flop (didn't bet)




PokerStars Game #59939708534:  Hold'em No Limit ($0.10/$0.25) - 2009/07/01 0:46:52 ET
Table 'qryc9C/ELyQ3lubOaELNAQ' 6-max Seat #4 is the button
Seat 1: OZc6kkoTwtITj1ZfreJK1A ($25.85 in chips) 
Seat 2: qvQc9BHp2FhQjrltLiBN+w ($11.65 in chips) 
Seat 3: UXRtG8J9PoBZWTsNtqdoDA ($21.05 in chips) 
Seat 4: v+QfkGiuj9bgtuNoVnDO8w ($28.65 in chips) 
Seat 5: pV5UZbjsgam+HUQEd6G++w ($11.50 in chips) 
Seat 6: WrLI51S2iMb8GLMB83gGqA ($25 in chips) 
pV5UZbjsgam+HUQEd6G++w: posts small blind $0.10
WrLI51S2iMb8GLMB83gGqA: posts big blind $0.25
*** HOLE CARDS ***
OZc6kkoTwtITj1ZfreJK1A: folds 
qvQc9BHp2FhQjrltLiBN+w: calls $0.25
UXRtG8J9PoBZWTsNtqdoDA: folds 
v+QfkGiuj9bgtuNoVnDO8w: folds 
pV5UZbjsgam+HUQEd6G++w: folds 
WrLI51S2iMb8GLMB83gGqA: checks 
*** FLOP *** [9s 5h Jc]
WrLI51S2iMb8GLMB83gGqA: checks 
qvQc9BHp2FhQjrltLiBN+w: bets $0.50
WrLI51S2iMb8GLMB83gGqA: folds 
Uncalled bet ($0.50) returned to qvQc9BHp2FhQjrltLiBN+w
qvQc9BHp2FhQjrltLiBN+w collected $0.60 from pot
*** SUMMARY ***
Total pot $0.60 | Rake $0 
Board [9s 5h Jc]
Seat 1: OZc6kkoTwtITj1ZfreJK1A folded before Flop (didn't bet)
Seat 2: qvQc9BHp2FhQjrltLiBN+w collected ($0.60)
Seat 3: UXRtG8J9PoBZWTsNtqdoDA folded before Flop (didn't bet)
Seat 4: v+QfkGiuj9bgtuNoVnDO8w (button) folded before Flop (didn't bet)
Seat 5: pV5UZbjsgam+HUQEd6G++w (small blind) folded before Flop
Seat 6: WrLI51S2iMb8GLMB83gGqA (big blind) folded on the Flop




PokerStars Game #59939708424:  Hold'em No Limit ($0.10/$0.25) - 2009/07/01 0:46:52 ET
Table 'KRiZ8S/xwAYkA4EWSX89ow' 9-max Seat #6 is the button
Seat 1: CYkY0dNBaYaKs8HVCVn3mQ ($7.45 in chips) 
Seat 2: vZGoOTJLQLhkPj4I+LNGig ($54.75 in chips) 
Seat 3: /fionJv+b9tkuIj/KKbXYw ($21.75 in chips) 
Seat 4: COsrwJSFHQtxlUcrYtDQPQ ($28.30 in chips) 
Seat 5: t2nb95S5EEFOEzNx9Itz0g ($4.95 in chips) 
Seat 6: DdPXdieucQ+n99u1n3A+rQ ($5.60 in chips) 
Seat 7: cZ99hugmLBj9KhTlc8nCSw ($25 in chips) 
Seat 8: nEg1b6MIksd/4x5eLY735g ($25.60 in chips) 
cZ99hugmLBj9KhTlc8nCSw: posts small blind $0.10
nEg1b6MIksd/4x5eLY735g: posts big blind $0.25
+WMpj67YqG8ilNkg2JwXpw: sits out 
*** HOLE CARDS ***
CYkY0dNBaYaKs8HVCVn3mQ: folds 
vZGoOTJLQLhkPj4I+LNGig: folds 
/fionJv+b9tkuIj/KKbXYw: raises $0.25 to $0.50
COsrwJSFHQtxlUcrYtDQPQ: folds 
t2nb95S5EEFOEzNx9Itz0g: folds 
DdPXdieucQ+n99u1n3A+rQ: folds 
cZ99hugmLBj9KhTlc8nCSw: folds 
nEg1b6MIksd/4x5eLY735g: calls $0.25
*** FLOP *** [Kh 2s 4h]
nEg1b6MIksd/4x5eLY735g: checks 
/fionJv+b9tkuIj/KKbXYw: bets $0.75
nEg1b6MIksd/4x5eLY735g: raises $0.75 to $1.50
/fionJv+b9tkuIj/KKbXYw: raises $0.75 to $2.25
nEg1b6MIksd/4x5eLY735g: calls $0.75
*** TURN *** [Kh 2s 4h] [2h]
nEg1b6MIksd/4x5eLY735g: checks 
/fionJv+b9tkuIj/KKbXYw: bets $0.50
nEg1b6MIksd/4x5eLY735g: raises $0.50 to $1
/fionJv+b9tkuIj/KKbXYw: calls $0.50
*** RIVER *** [Kh 2s 4h 2h] [Kd]
nEg1b6MIksd/4x5eLY735g: checks 
/fionJv+b9tkuIj/KKbXYw: checks 
*** SHOW DOWN ***
nEg1b6MIksd/4x5eLY735g: shows [Jh 8h] (a flush, King high)
/fionJv+b9tkuIj/KKbXYw: mucks hand 
nEg1b6MIksd/4x5eLY735g collected $7.25 from pot
*** SUMMARY ***
Total pot $7.60 | Rake $0.35 
Board [Kh 2s 4h 2h Kd]
Seat 1: CYkY0dNBaYaKs8HVCVn3mQ folded before Flop (didn't bet)
Seat 2: vZGoOTJLQLhkPj4I+LNGig folded before Flop (didn't bet)
Seat 3: /fionJv+b9tkuIj/KKbXYw mucked
Seat 4: COsrwJSFHQtxlUcrYtDQPQ folded before Flop (didn't bet)
Seat 5: t2nb95S5EEFOEzNx9Itz0g folded before Flop (didn't bet)
Seat 6: DdPXdieucQ+n99u1n3A+rQ (button) folded before Flop (didn't bet)
Seat 7: cZ99hugmLBj9KhTlc8nCSw (small blind) folded before Flop
Seat 8: nEg1b6MIksd/4x5eLY735g (big blind) showed [Jh 8h] and won ($7.25) with a flush, King high




PokerStars Game #59939708324:  Hold'em No Limit ($0.10/$0.25) - 2009/07/01 0:46:52 ET
Table '3EebBlzq5yHSY2444L4zlg' 9-max Seat #7 is the button
Seat 1: 8B/dhbQjIWe6ASCdgzktNQ ($31.25 in chips) 
Seat 2: MIVCHqCqqlke0Lb0z7glcw ($24.35 in chips) 
Seat 3: IGbD5vKNhHe60dkdbjg/mw ($22.35 in chips) 
Seat 4: 1S/fpm+f42V/6MNZre+ccg ($25.10 in chips) 
Seat 5: 22Ph+hChb2fjC5+yk/mOew ($24.75 in chips) 
Seat 6: QEbIGci+itdw+re8RM5fZA ($27.80 in chips) 
Seat 7: DiSvPC2iudwL5j9u6Huyww ($27.55 in chips) 
Seat 8: j97ZRZFRWNUsBUL7hv78tA ($14.75 in chips) 
Seat 9: GTcLfsDTPqgfHyhY9FNDMw ($10.65 in chips) 
j97ZRZFRWNUsBUL7hv78tA: posts small blind $0.10
GTcLfsDTPqgfHyhY9FNDMw: posts big blind $0.25
*** HOLE CARDS ***
8B/dhbQjIWe6ASCdgzktNQ: raises $0.75 to $1
MIVCHqCqqlke0Lb0z7glcw: folds 
IGbD5vKNhHe60dkdbjg/mw: calls $1
1S/fpm+f42V/6MNZre+ccg: calls $1
22Ph+hChb2fjC5+yk/mOew: folds 
QEbIGci+itdw+re8RM5fZA: folds 
DiSvPC2iudwL5j9u6Huyww: folds 
j97ZRZFRWNUsBUL7hv78tA: folds 
GTcLfsDTPqgfHyhY9FNDMw: folds 
*** FLOP *** [Td 2h Qs]
8B/dhbQjIWe6ASCdgzktNQ: checks 
IGbD5vKNhHe60dkdbjg/mw: bets $1
1S/fpm+f42V/6MNZre+ccg: folds 
8B/dhbQjIWe6ASCdgzktNQ: folds 
Uncalled bet ($1) returned to IGbD5vKNhHe60dkdbjg/mw
IGbD5vKNhHe60dkdbjg/mw collected $3.20 from pot
*** SUMMARY ***
Total pot $3.35 | Rake $0.15 
Board [Td 2h Qs]
Seat 1: 8B/dhbQjIWe6ASCdgzktNQ folded on the Flop
Seat 2: MIVCHqCqqlke0Lb0z7glcw folded before Flop (didn't bet)
Seat 3: IGbD5vKNhHe60dkdbjg/mw collected ($3.20)
Seat 4: 1S/fpm+f42V/6MNZre+ccg folded on the Flop
Seat 5: 22Ph+hChb2fjC5+yk/mOew folded before Flop (didn't bet)
Seat 6: QEbIGci+itdw+re8RM5fZA folded before Flop (didn't bet)
Seat 7: DiSvPC2iudwL5j9u6Huyww (button) folded before Flop (didn't bet)
Seat 8: j97ZRZFRWNUsBUL7hv78tA (small blind) folded before Flop
Seat 9: GTcLfsDTPqgfHyhY9FNDMw (big blind) folded before Flop




PokerStars Game #59939708970:  Hold'em No Limit ($0.10/$0.25) - 2009/07/01 0:46:53 ET
Table 'zW+7jPbOLCvlPu+dUGY5WQ' 6-max Seat #6 is the button
Seat 5: SFmT9ZsVopnukjvAzrxTRg ($55.10 in chips) 
Seat 6: BiLBinPhgpKAYzLgKJVU5A ($21.55 in chips) 
BiLBinPhgpKAYzLgKJVU5A: posts small blind $0.10
BedjMfrlRfPgSq7CXpPAmg: is sitting out 
SFmT9ZsVopnukjvAzrxTRg: posts big blind $0.25
*** HOLE CARDS ***
BiLBinPhgpKAYzLgKJVU5A: raises $0.25 to $0.50
BedjMfrlRfPgSq7CXpPAmg leaves the table
SFmT9ZsVopnukjvAzrxTRg: folds 
Uncalled bet ($0.25) returned to BiLBinPhgpKAYzLgKJVU5A
BiLBinPhgpKAYzLgKJVU5A collected $0.50 from pot
*** SUMMARY ***
Total pot $0.50 | Rake $0 
Seat 5: SFmT9ZsVopnukjvAzrxTRg (big blind) folded before Flop
Seat 6: BiLBinPhgpKAYzLgKJVU5A (button) (small blind) collected ($0.50)




PokerStars Game #59939708840:  Hold'em No Limit ($0.10/$0.25) - 2009/07/01 0:46:53 ET
Table '5510FxlYzKi+U6MIpo8IPA' 6-max Seat #1 is the button
Seat 1: KM6ogk7SqyRlk3m9b0h+7A ($20.30 in chips) 
Seat 2: gqW2aBCmrIw65BvwjTFN6Q ($25 in chips) 
Seat 3: v+QfkGiuj9bgtuNoVnDO8w ($33.90 in chips) 
Seat 4: cPO/1/dTcZpLkQFm3jH3Rg ($27.20 in chips) 
Seat 5: 5E1iMY5xyboow7Xm0v7Idw ($7.80 in chips) 
Seat 6: SFmT9ZsVopnukjvAzrxTRg ($29.90 in chips) 
gqW2aBCmrIw65BvwjTFN6Q: posts small blind $0.10
v+QfkGiuj9bgtuNoVnDO8w: posts big blind $0.25
*** HOLE CARDS ***
cPO/1/dTcZpLkQFm3jH3Rg: folds 
5E1iMY5xyboow7Xm0v7Idw: folds 
5E1iMY5xyboow7Xm0v7Idw leaves the table
SFmT9ZsVopnukjvAzrxTRg: folds 
KM6ogk7SqyRlk3m9b0h+7A: raises $0.50 to $0.75
gqW2aBCmrIw65BvwjTFN6Q: folds 
v+QfkGiuj9bgtuNoVnDO8w: raises $2 to $2.75
KM6ogk7SqyRlk3m9b0h+7A: folds 
Uncalled bet ($2) returned to v+QfkGiuj9bgtuNoVnDO8w
v+QfkGiuj9bgtuNoVnDO8w collected $1.60 from pot
v+QfkGiuj9bgtuNoVnDO8w: doesn't show hand 
3AX4hJ3s02XVFGkQwPKh3w joins the table at seat #5 
*** SUMMARY ***
Total pot $1.60 | Rake $0 
Seat 1: KM6ogk7SqyRlk3m9b0h+7A (button) folded before Flop
Seat 2: gqW2aBCmrIw65BvwjTFN6Q (small blind) folded before Flop
Seat 3: v+QfkGiuj9bgtuNoVnDO8w (big blind) collected ($1.60)
Seat 4: cPO/1/dTcZpLkQFm3jH3Rg folded before Flop (didn't bet)
Seat 5: 5E1iMY5xyboow7Xm0v7Idw folded before Flop (didn't bet)
Seat 6: SFmT9ZsVopnukjvAzrxTRg folded before Flop (didn't bet)




PokerStars Game #59939709194:  Hold'em No Limit ($0.10/$0.25) - 2009/07/01 0:46:53 ET
Table '5VWnrlxdjwVfMWkVS2WE7A' 6-max Seat #6 is the button
Seat 1: BiLBinPhgpKAYzLgKJVU5A ($21.35 in chips) 
Seat 2: ELW+DKizJhLK7k40PMkD2Q ($28.95 in chips) 
Seat 3: cPO/1/dTcZpLkQFm3jH3Rg ($25 in chips) 
Seat 4: WZv4aSGl7ETtI/Z5BPKi7w ($32.50 in chips) 
Seat 5: JQZew0FjzS19kTjeNtrE+A ($41.95 in chips) 
Seat 6: LtASJ9OlkqGrrUKGQlpGAw ($16.40 in chips) 
BiLBinPhgpKAYzLgKJVU5A: posts small blind $0.10
ELW+DKizJhLK7k40PMkD2Q: posts big blind $0.25
*** HOLE CARDS ***
cPO/1/dTcZpLkQFm3jH3Rg: folds 
WZv4aSGl7ETtI/Z5BPKi7w: raises $0.25 to $0.50
JQZew0FjzS19kTjeNtrE+A: folds 
LtASJ9OlkqGrrUKGQlpGAw: calls $0.50
BiLBinPhgpKAYzLgKJVU5A: folds 
ELW+DKizJhLK7k40PMkD2Q: folds 
*** FLOP *** [Qd 9d 2s]
WZv4aSGl7ETtI/Z5BPKi7w: bets $0.75
LtASJ9OlkqGrrUKGQlpGAw: raises $1.75 to $2.50
WZv4aSGl7ETtI/Z5BPKi7w: calls $1.75
*** TURN *** [Qd 9d 2s] [Th]
WZv4aSGl7ETtI/Z5BPKi7w: checks 
LtASJ9OlkqGrrUKGQlpGAw: checks 
*** RIVER *** [Qd 9d 2s Th] [2c]
WZv4aSGl7ETtI/Z5BPKi7w: checks 
LtASJ9OlkqGrrUKGQlpGAw: checks 
*** SHOW DOWN ***
WZv4aSGl7ETtI/Z5BPKi7w: shows [Qh Kd] (two pair, Queens and Deuces)
LtASJ9OlkqGrrUKGQlpGAw: mucks hand 
WZv4aSGl7ETtI/Z5BPKi7w collected $6.05 from pot
*** SUMMARY ***
Total pot $6.35 | Rake $0.30 
Board [Qd 9d 2s Th 2c]
Seat 1: BiLBinPhgpKAYzLgKJVU5A (small blind) folded before Flop
Seat 2: ELW+DKizJhLK7k40PMkD2Q (big blind) folded before Flop
Seat 3: cPO/1/dTcZpLkQFm3jH3Rg folded before Flop (didn't bet)
Seat 4: WZv4aSGl7ETtI/Z5BPKi7w showed [Qh Kd] and won ($6.05) with two pair, Queens and Deuces
Seat 5: JQZew0FjzS19kTjeNtrE+A folded before Flop (didn't bet)
Seat 6: LtASJ9OlkqGrrUKGQlpGAw (button) mucked




PokerStars Game #59939708944:  Hold'em No Limit ($0.10/$0.25) - 2009/07/01 0:46:53 ET
Table 'HbNAGS1OJWQKyfk7UfrYyw' 9-max Seat #2 is the button
Seat 2: zE0IkNrJoJD964o4eqmCxQ ($10.90 in chips) 
Seat 3: DIBbjEYGs+TVdVgEB/4+3w ($29.45 in chips) 
Seat 6: W4TLQcZ2TiM73eIgpIvlGg ($26.10 in chips) 
Seat 7: JJH2Xc95hFewheF67vSv4Q ($16.25 in chips) 
Seat 8: fsTS8sDyZ7BxKQFEMv9xCg ($6.10 in chips) 
Seat 9: cFmpjvcjNoVAEAIQIxWkYg ($25 in chips) 
DIBbjEYGs+TVdVgEB/4+3w: posts small blind $0.10
mdalglish: is sitting out 
mdalglish leaves the table
YHeeiaUNFin/MUYZJuW1VA leaves the table
cu58S48zQeRuppc18okJLA: is sitting out 
W4TLQcZ2TiM73eIgpIvlGg: posts big blind $0.25
cFmpjvcjNoVAEAIQIxWkYg: posts big blind $0.25
*** HOLE CARDS ***
JJH2Xc95hFewheF67vSv4Q: raises $0.50 to $0.75
fsTS8sDyZ7BxKQFEMv9xCg: folds 
22dIObOuor/A+IKWkNoAlA joins the table at seat #4 
cFmpjvcjNoVAEAIQIxWkYg: folds 
zE0IkNrJoJD964o4eqmCxQ: folds 
cu58S48zQeRuppc18okJLA leaves the table
DIBbjEYGs+TVdVgEB/4+3w: folds 
W4TLQcZ2TiM73eIgpIvlGg: folds 
Uncalled bet ($0.50) returned to JJH2Xc95hFewheF67vSv4Q
JJH2Xc95hFewheF67vSv4Q collected $0.85 from pot
JJH2Xc95hFewheF67vSv4Q: doesn't show hand 
*** SUMMARY ***
Total pot $0.85 | Rake $0 
Seat 2: zE0IkNrJoJD964o4eqmCxQ (button) folded before Flop (didn't bet)
Seat 3: DIBbjEYGs+TVdVgEB/4+3w (small blind) folded before Flop
Seat 6: W4TLQcZ2TiM73eIgpIvlGg (big blind) folded before Flop
Seat 7: JJH2Xc95hFewheF67vSv4Q collected ($0.85)
Seat 8: fsTS8sDyZ7BxKQFEMv9xCg folded before Flop (didn't bet)
Seat 9: cFmpjvcjNoVAEAIQIxWkYg folded before Flop




PokerStars Game #59939708662:  Hold'em No Limit ($0.10/$0.25) - 2009/07/01 0:46:53 ET
Table 'M7d9IrgQUUFFy/SZ3ksLYg' 6-max Seat #2 is the button
Seat 1: cPO/1/dTcZpLkQFm3jH3Rg ($43.10 in chips) 
Seat 2: JE/wJXmjw3bpdmjwvh2pcg ($31.20 in chips) 
Seat 4: 7FmwVDcdEtxDpHmP4hOXsQ ($29.15 in chips) 
Seat 5: nc79pm0LZRdhncq55evVqA ($25 in chips) 
Seat 6: /gJNBeCkWL4o85/jvlZ4BA ($25 in chips) 
7FmwVDcdEtxDpHmP4hOXsQ: posts small blind $0.10
nc79pm0LZRdhncq55evVqA: posts big blind $0.25
*** HOLE CARDS ***
/gJNBeCkWL4o85/jvlZ4BA: folds 
cPO/1/dTcZpLkQFm3jH3Rg: folds 
JE/wJXmjw3bpdmjwvh2pcg: folds 
eHsmIvAb2JREg4O6hNPnXg leaves the table
7FmwVDcdEtxDpHmP4hOXsQ: raises $0.50 to $0.75
nc79pm0LZRdhncq55evVqA: folds 
Uncalled bet ($0.50) returned to 7FmwVDcdEtxDpHmP4hOXsQ
7FmwVDcdEtxDpHmP4hOXsQ collected $0.50 from pot
7FmwVDcdEtxDpHmP4hOXsQ: doesn't show hand 
*** SUMMARY ***
Total pot $0.50 | Rake $0 
Seat 1: cPO/1/dTcZpLkQFm3jH3Rg folded before Flop (didn't bet)
Seat 2: JE/wJXmjw3bpdmjwvh2pcg (button) folded before Flop (didn't bet)
Seat 4: 7FmwVDcdEtxDpHmP4hOXsQ (small blind) collected ($0.50)
Seat 5: nc79pm0LZRdhncq55evVqA (big blind) folded before Flop
Seat 6: /gJNBeCkWL4o85/jvlZ4BA folded before Flop (didn't bet)




PokerStars Game #59939708846:  Hold'em No Limit ($0.10/$0.25) - 2009/07/01 0:46:53 ET
Table 'QzXakDK7ZHNjgIpoUFGSKQ' 9-max Seat #4 is the button
Seat 1: vZGoOTJLQLhkPj4I+LNGig ($25 in chips) 
Seat 2: HVKi9hnDyvzObpL08/OarQ ($23.40 in chips) 
Seat 4: Yv4fucyyT28mjx8V5lxKJg ($22.55 in chips) 
Seat 5: 7Tiam59GaMYACH/my1qVuw ($25.55 in chips) 
Seat 6: c7sk/W5UhCTyhjXh5MT/eg ($12.05 in chips) 
Seat 7: zUPSsmVPAK0z0iGmEx7WbA ($9.70 in chips) 
Seat 9: vnCdP3GsLTKadDukKcJk/Q ($25.25 in chips) 
7Tiam59GaMYACH/my1qVuw: posts small blind $0.10
c7sk/W5UhCTyhjXh5MT/eg: posts big blind $0.25
*** HOLE CARDS ***
zUPSsmVPAK0z0iGmEx7WbA: calls $0.25
vnCdP3GsLTKadDukKcJk/Q: folds 
vZGoOTJLQLhkPj4I+LNGig: folds 
HVKi9hnDyvzObpL08/OarQ: folds 
Yv4fucyyT28mjx8V5lxKJg: folds 
Yv4fucyyT28mjx8V5lxKJg leaves the table
7Tiam59GaMYACH/my1qVuw: raises $0.75 to $1
c7sk/W5UhCTyhjXh5MT/eg: folds 
zUPSsmVPAK0z0iGmEx7WbA: calls $0.75
*** FLOP *** [5s As 2c]
7Tiam59GaMYACH/my1qVuw: checks 
zUPSsmVPAK0z0iGmEx7WbA: checks 
*** TURN *** [5s As 2c] [Th]
7Tiam59GaMYACH/my1qVuw: bets $0.75
zUPSsmVPAK0z0iGmEx7WbA: folds 
Uncalled bet ($0.75) returned to 7Tiam59GaMYACH/my1qVuw
7Tiam59GaMYACH/my1qVuw collected $2.15 from pot
*** SUMMARY ***
Total pot $2.25 | Rake $0.10 
Board [5s As 2c Th]
Seat 1: vZGoOTJLQLhkPj4I+LNGig folded before Flop (didn't bet)
Seat 2: HVKi9hnDyvzObpL08/OarQ folded before Flop (didn't bet)
Seat 4: Yv4fucyyT28mjx8V5lxKJg (button) folded before Flop (didn't bet)
Seat 5: 7Tiam59GaMYACH/my1qVuw (small blind) collected ($2.15)
Seat 6: c7sk/W5UhCTyhjXh5MT/eg (big blind) folded before Flop
Seat 7: zUPSsmVPAK0z0iGmEx7WbA folded on the Turn
Seat 9: vnCdP3GsLTKadDukKcJk/Q folded before Flop (didn't bet)




PokerStars Game #59939709102:  Hold'em No Limit ($0.10/$0.25) - 2009/07/01 0:46:53 ET
Table 'WEMI3Mtn7dGARDbgNrKibg' 9-max Seat #8 is the button
Seat 2: tYsOBqdU1+x+yFI7zHO7hQ ($46.20 in chips) 
Seat 3: jZaChyamGXWcP+qALPP5Jg ($29.45 in chips) 
Seat 4: yyG4svzOpC1A+sUP/scg6w ($7.25 in chips) 
Seat 6: VBHxUExRAMrbxUq/cVx9Gw ($4.65 in chips) 
Seat 7: DnDcAdn9P0zGovMERigpFA ($58.65 in chips) 
Seat 8: ghNKXUBl/H+t83JF079ZBA ($27.20 in chips) 
Seat 9: NTamLAiMZ86c5yM04t96LA ($56.10 in chips) 
NTamLAiMZ86c5yM04t96LA: posts small blind $0.10
7cv+9Zc9HIQHNvYsMfV3uA: is sitting out 
tYsOBqdU1+x+yFI7zHO7hQ: posts big blind $0.25
*** HOLE CARDS ***
jZaChyamGXWcP+qALPP5Jg: folds 
yyG4svzOpC1A+sUP/scg6w: folds 
VBHxUExRAMrbxUq/cVx9Gw: folds 
DnDcAdn9P0zGovMERigpFA: folds 
ghNKXUBl/H+t83JF079ZBA: folds 
NTamLAiMZ86c5yM04t96LA: folds 
Uncalled bet ($0.15) returned to tYsOBqdU1+x+yFI7zHO7hQ
tYsOBqdU1+x+yFI7zHO7hQ collected $0.20 from pot
tYsOBqdU1+x+yFI7zHO7hQ: doesn't show hand 
*** SUMMARY ***
Total pot $0.20 | Rake $0 
Seat 2: tYsOBqdU1+x+yFI7zHO7hQ (big blind) collected ($0.20)
Seat 3: jZaChyamGXWcP+qALPP5Jg folded before Flop (didn't bet)
Seat 4: yyG4svzOpC1A+sUP/scg6w folded before Flop (didn't bet)
Seat 6: VBHxUExRAMrbxUq/cVx9Gw folded before Flop (didn't bet)
Seat 7: DnDcAdn9P0zGovMERigpFA folded before Flop (didn't bet)
Seat 8: ghNKXUBl/H+t83JF079ZBA (button) folded before Flop (didn't bet)
Seat 9: NTamLAiMZ86c5yM04t96LA (small blind) folded before Flop




PokerStars Game #59939709912:  Hold'em No Limit ($0.10/$0.25) - 2009/07/01 0:46:54 ET
Table 'MiquQrQZJJq9ZtgRIp9HFQ' 6-max Seat #3 is the button
Seat 1: hM0MSDtq2ow7J40bSR04ig ($3.70 in chips) 
Seat 3: BYxjLnV1/LL0aZcTbfAOvw ($26.50 in chips) 
Seat 4: 0HIrwssk0FQvyKULzUTtlg ($20.65 in chips) 
Seat 5: 3zD3qLXT1bEffAoWGnc7wg ($25 in chips) 
Seat 6: X9oXZTg4PhZVR+ilX2OYbA ($10.30 in chips) 
0HIrwssk0FQvyKULzUTtlg: posts small blind $0.10
3zD3qLXT1bEffAoWGnc7wg: posts big blind $0.25
*** HOLE CARDS ***
dyEfLXFw5qVHSUcgOdOM2Q joins the table at seat #2 
X9oXZTg4PhZVR+ilX2OYbA: folds 
hM0MSDtq2ow7J40bSR04ig: folds 
BYxjLnV1/LL0aZcTbfAOvw: folds 
0HIrwssk0FQvyKULzUTtlg: folds 
Uncalled bet ($0.15) returned to 3zD3qLXT1bEffAoWGnc7wg
X9oXZTg4PhZVR+ilX2OYbA leaves the table
3zD3qLXT1bEffAoWGnc7wg collected $0.20 from pot
3zD3qLXT1bEffAoWGnc7wg: doesn't show hand 
*** SUMMARY ***
Total pot $0.20 | Rake $0 
Seat 1: hM0MSDtq2ow7J40bSR04ig folded before Flop (didn't bet)
Seat 3: BYxjLnV1/LL0aZcTbfAOvw (button) folded before Flop (didn't bet)
Seat 4: 0HIrwssk0FQvyKULzUTtlg (small blind) folded before Flop
Seat 5: 3zD3qLXT1bEffAoWGnc7wg (big blind) collected ($0.20)
Seat 6: X9oXZTg4PhZVR+ilX2OYbA folded before Flop (didn't bet)




PokerStars Game #59939710508:  Hold'em No Limit ($0.10/$0.25) - 2009/07/01 0:46:55 ET
Table 'IIO2q2znuuAXmiZ2qFTcmg' 6-max Seat #2 is the button
Seat 1: nwwpaieDRI0UPyVtChVHOg ($16.90 in chips) 
Seat 2: cS21pIxRHx5Gt42o7hPZzw ($15.35 in chips) 
Seat 3: hiTEr3yrERiQp3zHXRioVw ($41.30 in chips) 
Seat 4: 0HIrwssk0FQvyKULzUTtlg ($10.50 in chips) 
Seat 5: f9iRHw0d+kV7pbTYwF2+2g ($5.40 in chips) 
hiTEr3yrERiQp3zHXRioVw: posts small blind $0.10
0HIrwssk0FQvyKULzUTtlg: posts big blind $0.25
gqrr7lSWrQ1N8zKx8zZzvA: sits out 
*** HOLE CARDS ***
f9iRHw0d+kV7pbTYwF2+2g: folds 
nwwpaieDRI0UPyVtChVHOg: folds 
cS21pIxRHx5Gt42o7hPZzw: folds 
hiTEr3yrERiQp3zHXRioVw: folds 
Uncalled bet ($0.15) returned to 0HIrwssk0FQvyKULzUTtlg
0HIrwssk0FQvyKULzUTtlg collected $0.20 from pot
*** SUMMARY ***
Total pot $0.20 | Rake $0 
Seat 1: nwwpaieDRI0UPyVtChVHOg folded before Flop (didn't bet)
Seat 2: cS21pIxRHx5Gt42o7hPZzw (button) folded before Flop (didn't bet)
Seat 3: hiTEr3yrERiQp3zHXRioVw (small blind) folded before Flop
Seat 4: 0HIrwssk0FQvyKULzUTtlg (big blind) collected ($0.20)
Seat 5: f9iRHw0d+kV7pbTYwF2+2g folded before Flop (didn't bet)




PokerStars Game #59939710430:  Hold'em No Limit ($0.10/$0.25) - 2009/07/01 0:46:55 ET
Table 'mNBkqbHtjDvzF6YU0ixV9Q' 9-max Seat #1 is the button
Seat 1: QsLvCwfSWqP+CfjwUnjpXQ ($16.25 in chips) 
Seat 4: NZlEzoTKHCxRJwJ71iDzeA ($5.85 in chips) 
Seat 6: Zb8xGmbjS8ghABxs9n6huA ($12 in chips) 
NZlEzoTKHCxRJwJ71iDzeA: posts small blind $0.10
Zb8xGmbjS8ghABxs9n6huA: posts big blind $0.25
*** HOLE CARDS ***
QsLvCwfSWqP+CfjwUnjpXQ: folds 
NZlEzoTKHCxRJwJ71iDzeA: calls $0.15
Zb8xGmbjS8ghABxs9n6huA: checks 
*** FLOP *** [5h 8d Jh]
NZlEzoTKHCxRJwJ71iDzeA: bets $0.50
Zb8xGmbjS8ghABxs9n6huA: raises $0.50 to $1
NZlEzoTKHCxRJwJ71iDzeA: folds 
Uncalled bet ($0.50) returned to Zb8xGmbjS8ghABxs9n6huA
Zb8xGmbjS8ghABxs9n6huA collected $1.45 from pot
*** SUMMARY ***
Total pot $1.50 | Rake $0.05 
Board [5h 8d Jh]
Seat 1: QsLvCwfSWqP+CfjwUnjpXQ (button) folded before Flop (didn't bet)
Seat 4: NZlEzoTKHCxRJwJ71iDzeA (small blind) folded on the Flop
Seat 6: Zb8xGmbjS8ghABxs9n6huA (big blind) collected ($1.45)




PokerStars Game #59939710444:  Hold'em No Limit ($0.10/$0.25) - 2009/07/01 0:46:55 ET
Table '2VkNDXXsBj4bSZw/uK5atw' 6-max Seat #3 is the button
Seat 1: 7FmwVDcdEtxDpHmP4hOXsQ ($25.90 in chips) 
Seat 2: gqW2aBCmrIw65BvwjTFN6Q ($29.65 in chips) 
Seat 3: 8D0jr3B4e++Q/cTSnpHdzg ($15.35 in chips) 
Seat 4: yb6rnd48JuBccThV68VHAQ ($69.80 in chips) 
Seat 5: kyRaCIljYA6l33lSKQfNsg ($25 in chips) 
Seat 6: qGHGf/553gQnDoklMRe3tg ($24.90 in chips) 
yb6rnd48JuBccThV68VHAQ: posts small blind $0.10
kyRaCIljYA6l33lSKQfNsg: posts big blind $0.25
*** HOLE CARDS ***
qGHGf/553gQnDoklMRe3tg: folds 
7FmwVDcdEtxDpHmP4hOXsQ: folds 
gqW2aBCmrIw65BvwjTFN6Q: folds 
8D0jr3B4e++Q/cTSnpHdzg: folds 
yb6rnd48JuBccThV68VHAQ: calls $0.15
kyRaCIljYA6l33lSKQfNsg: raises $1 to $1.25
yb6rnd48JuBccThV68VHAQ: calls $1
*** FLOP *** [6d 2h 8d]
yb6rnd48JuBccThV68VHAQ: bets $1
kyRaCIljYA6l33lSKQfNsg: calls $1
*** TURN *** [6d 2h 8d] [2c]
yb6rnd48JuBccThV68VHAQ: bets $1
kyRaCIljYA6l33lSKQfNsg: raises $3 to $4
yb6rnd48JuBccThV68VHAQ: calls $3
*** RIVER *** [6d 2h 8d 2c] [4c]
yb6rnd48JuBccThV68VHAQ: bets $1.25
kyRaCIljYA6l33lSKQfNsg: raises $17.50 to $18.75 and is all-in
yb6rnd48JuBccThV68VHAQ: folds 
Uncalled bet ($17.50) returned to kyRaCIljYA6l33lSKQfNsg
kyRaCIljYA6l33lSKQfNsg collected $14.30 from pot
*** SUMMARY ***
Total pot $15 | Rake $0.70 
Board [6d 2h 8d 2c 4c]
Seat 1: 7FmwVDcdEtxDpHmP4hOXsQ folded before Flop (didn't bet)
Seat 2: gqW2aBCmrIw65BvwjTFN6Q folded before Flop (didn't bet)
Seat 3: 8D0jr3B4e++Q/cTSnpHdzg (button) folded before Flop (didn't bet)
Seat 4: yb6rnd48JuBccThV68VHAQ (small blind) folded on the River
Seat 5: kyRaCIljYA6l33lSKQfNsg (big blind) collected ($14.30)
Seat 6: qGHGf/553gQnDoklMRe3tg folded before Flop (didn't bet)




PokerStars Game #59939710208:  Hold'em No Limit ($0.10/$0.25) - 2009/07/01 0:46:55 ET
Table 'DhkrdW2UOy2PfjSW28Kq8w' 6-max Seat #1 is the button
Seat 1: vu2kzHaDtgr6NM7rdq0chA ($25 in chips) 
Seat 2: v+QfkGiuj9bgtuNoVnDO8w ($28.85 in chips) 
Seat 3: 66a/8+qw1AZLNh63FuclPA ($43.55 in chips) 
Seat 4: I1TxPvWj8NfG8orglCinNA ($25.25 in chips) 
Seat 5: SxIIgwXYLkwd6m3wLyPTCw ($47.50 in chips) 
Seat 6: SS/yfeArhULzIcOPe8MdPg ($27.25 in chips) 
v+QfkGiuj9bgtuNoVnDO8w: posts small blind $0.10
66a/8+qw1AZLNh63FuclPA: posts big blind $0.25
*** HOLE CARDS ***
I1TxPvWj8NfG8orglCinNA: folds 
SxIIgwXYLkwd6m3wLyPTCw: raises $0.50 to $0.75
SS/yfeArhULzIcOPe8MdPg: folds 
vu2kzHaDtgr6NM7rdq0chA: folds 
v+QfkGiuj9bgtuNoVnDO8w: folds 
66a/8+qw1AZLNh63FuclPA: calls $0.50
*** FLOP *** [Jc Ah 2d]
66a/8+qw1AZLNh63FuclPA: checks 
SxIIgwXYLkwd6m3wLyPTCw: bets $1.25
66a/8+qw1AZLNh63FuclPA: folds 
Uncalled bet ($1.25) returned to SxIIgwXYLkwd6m3wLyPTCw
SxIIgwXYLkwd6m3wLyPTCw collected $1.55 from pot
SxIIgwXYLkwd6m3wLyPTCw: doesn't show hand 
*** SUMMARY ***
Total pot $1.60 | Rake $0.05 
Board [Jc Ah 2d]
Seat 1: vu2kzHaDtgr6NM7rdq0chA (button) folded before Flop (didn't bet)
Seat 2: v+QfkGiuj9bgtuNoVnDO8w (small blind) folded before Flop
Seat 3: 66a/8+qw1AZLNh63FuclPA (big blind) folded on the Flop
Seat 4: I1TxPvWj8NfG8orglCinNA folded before Flop (didn't bet)
Seat 5: SxIIgwXYLkwd6m3wLyPTCw collected ($1.55)
Seat 6: SS/yfeArhULzIcOPe8MdPg folded before Flop (didn't bet)




PokerStars Game #59939710080:  Hold'em No Limit ($0.10/$0.25) - 2009/07/01 0:46:55 ET
Table 'NtEQAxCeIK2io1CGtW658g' 6-max Seat #6 is the button
Seat 1: lnOV7k25gyN7L5t5YKTgIg ($16.70 in chips) 
Seat 2: nc79pm0LZRdhncq55evVqA ($26.80 in chips) 
Seat 3: m2yWOKfAxqHoy5DDN87Ttw ($23.40 in chips) 
Seat 4: 8296 ($12.80 in chips) 
Seat 5: FStoHe64SQWqAsjya9pDkQ ($25.60 in chips) 
Seat 6: /gJNBeCkWL4o85/jvlZ4BA ($67.70 in chips) 
lnOV7k25gyN7L5t5YKTgIg: posts small blind $0.10
nc79pm0LZRdhncq55evVqA: posts big blind $0.25
*** HOLE CARDS ***
m2yWOKfAxqHoy5DDN87Ttw: folds 
8296: calls $0.25
FStoHe64SQWqAsjya9pDkQ: folds 
/gJNBeCkWL4o85/jvlZ4BA: folds 
lnOV7k25gyN7L5t5YKTgIg: calls $0.15
nc79pm0LZRdhncq55evVqA: checks 
*** FLOP *** [5s 4c 8c]
lnOV7k25gyN7L5t5YKTgIg: bets $0.50
nc79pm0LZRdhncq55evVqA: folds 
8296: calls $0.50
*** TURN *** [5s 4c 8c] [Qc]
lnOV7k25gyN7L5t5YKTgIg: checks 
8296: checks 
*** RIVER *** [5s 4c 8c Qc] [3h]
lnOV7k25gyN7L5t5YKTgIg: checks 
8296: checks 
*** SHOW DOWN ***
lnOV7k25gyN7L5t5YKTgIg: shows [5d 9d] (a pair of Fives)
8296: mucks hand 
lnOV7k25gyN7L5t5YKTgIg collected $1.70 from pot
*** SUMMARY ***
Total pot $1.75 | Rake $0.05 
Board [5s 4c 8c Qc 3h]
Seat 1: lnOV7k25gyN7L5t5YKTgIg (small blind) showed [5d 9d] and won ($1.70) with a pair of Fives
Seat 2: nc79pm0LZRdhncq55evVqA (big blind) folded on the Flop
Seat 3: m2yWOKfAxqHoy5DDN87Ttw folded before Flop (didn't bet)
Seat 4: 8296 mucked
Seat 5: FStoHe64SQWqAsjya9pDkQ folded before Flop (didn't bet)
Seat 6: /gJNBeCkWL4o85/jvlZ4BA (button) folded before Flop (didn't bet)




PokerStars Game #59939710068:  Hold'em No Limit ($0.10/$0.25) - 2009/07/01 0:46:55 ET
Table 'UVjmXTtsmlX1HxwwZ59akg' 9-max Seat #1 is the button
Seat 1: zDrucyjVn5aeekNEc3cJrA ($28.35 in chips) 
Seat 4: lesMFbAzECwhRvI2qQ9kkg ($5.20 in chips) 
zDrucyjVn5aeekNEc3cJrA: posts small blind $0.10
lesMFbAzECwhRvI2qQ9kkg: posts big blind $0.25
*** HOLE CARDS ***
zDrucyjVn5aeekNEc3cJrA: folds 
Uncalled bet ($0.15) returned to lesMFbAzECwhRvI2qQ9kkg
lesMFbAzECwhRvI2qQ9kkg collected $0.20 from pot
lesMFbAzECwhRvI2qQ9kkg: doesn't show hand 
RHUxTtZkMrryUUwjBqyF4Q joins the table at seat #9 
*** SUMMARY ***
Total pot $0.20 | Rake $0 
Seat 1: zDrucyjVn5aeekNEc3cJrA (button) (small blind) folded before Flop
Seat 4: lesMFbAzECwhRvI2qQ9kkg (big blind) collected ($0.20)




PokerStars Game #59939710454:  Hold'em No Limit ($0.10/$0.25) - 2009/07/01 0:46:55 ET
Table '8QBBaev+cI2i/r2H6ml/lg' 9-max Seat #4 is the button
Seat 4: ZoG0obuajzVjwgd7lNHjgg ($3.75 in chips) 
Seat 6: cxE+szmvEUe7vE+z2ozM2Q ($11.25 in chips) 
ZoG0obuajzVjwgd7lNHjgg: posts small blind $0.10
cxE+szmvEUe7vE+z2ozM2Q: posts big blind $0.25
*** HOLE CARDS ***
ZoG0obuajzVjwgd7lNHjgg: raises $0.75 to $1
cxE+szmvEUe7vE+z2ozM2Q: folds 
Uncalled bet ($0.75) returned to ZoG0obuajzVjwgd7lNHjgg
ZoG0obuajzVjwgd7lNHjgg collected $0.50 from pot
*** SUMMARY ***
Total pot $0.50 | Rake $0 
Seat 4: ZoG0obuajzVjwgd7lNHjgg (button) (small blind) collected ($0.50)
Seat 6: cxE+szmvEUe7vE+z2ozM2Q (big blind) folded before Flop




PokerStars Game #59939709980:  Hold'em No Limit ($0.10/$0.25) - 2009/07/01 0:46:55 ET
Table 'YYMg5qzxK1m9eGRo4SbxtQ' 9-max Seat #4 is the button
Seat 1: DiSvPC2iudwL5j9u6Huyww ($25 in chips) 
Seat 2: uH1RN27w9SKa7TpVR9EFrQ ($15.25 in chips) 
Seat 3: N6fYvIzQLKaydFLKQGtMlQ ($23.70 in chips) 
Seat 4: H8sSXb2KLK0U38tU9YITDw ($11.05 in chips) 
Seat 5: BEIBUu2pIflPrCL+Iks4CQ ($19.05 in chips) 
Seat 6: gehe91e0IyVT0QU/XBkEyg ($41.60 in chips) 
Seat 7: hPhp/RE3cJ5YGaQ2xOHXXg ($5.45 in chips) 
Seat 8: 18G4P1XstjNvItdGUITxgw ($26.40 in chips) 
Seat 9: +sbyWwIcFp9kP0bDtMegfQ ($36.55 in chips) 
BEIBUu2pIflPrCL+Iks4CQ: posts small blind $0.10
gehe91e0IyVT0QU/XBkEyg: posts big blind $0.25
*** HOLE CARDS ***
hPhp/RE3cJ5YGaQ2xOHXXg: folds 
18G4P1XstjNvItdGUITxgw: folds 
+sbyWwIcFp9kP0bDtMegfQ: folds 
DiSvPC2iudwL5j9u6Huyww: folds 
uH1RN27w9SKa7TpVR9EFrQ: folds 
N6fYvIzQLKaydFLKQGtMlQ: folds 
H8sSXb2KLK0U38tU9YITDw: calls $0.25
BEIBUu2pIflPrCL+Iks4CQ: folds 
gehe91e0IyVT0QU/XBkEyg: checks 
*** FLOP *** [8d 9c Ks]
gehe91e0IyVT0QU/XBkEyg: bets $0.50
H8sSXb2KLK0U38tU9YITDw: folds 
Uncalled bet ($0.50) returned to gehe91e0IyVT0QU/XBkEyg
gehe91e0IyVT0QU/XBkEyg collected $0.60 from pot
gehe91e0IyVT0QU/XBkEyg: doesn't show hand 
*** SUMMARY ***
Total pot $0.60 | Rake $0 
Board [8d 9c Ks]
Seat 1: DiSvPC2iudwL5j9u6Huyww folded before Flop (didn't bet)
Seat 2: uH1RN27w9SKa7TpVR9EFrQ folded before Flop (didn't bet)
Seat 3: N6fYvIzQLKaydFLKQGtMlQ folded before Flop (didn't bet)
Seat 4: H8sSXb2KLK0U38tU9YITDw (button) folded on the Flop
Seat 5: BEIBUu2pIflPrCL+Iks4CQ (small blind) folded before Flop
Seat 6: gehe91e0IyVT0QU/XBkEyg (big blind) collected ($0.60)
Seat 7: hPhp/RE3cJ5YGaQ2xOHXXg folded before Flop (didn't bet)
Seat 8: 18G4P1XstjNvItdGUITxgw folded before Flop (didn't bet)
Seat 9: +sbyWwIcFp9kP0bDtMegfQ folded before Flop (didn't bet)




PokerStars Game #59939710536:  Hold'em No Limit ($0.10/$0.25) - 2009/07/01 0:46:55 ET
Table 'h02LhQ7B/Zk4ETRxxHhGYA' 9-max Seat #3 is the button
Seat 1: sD+TKtt36XiiN6jqHiLwDA ($32.85 in chips) 
Seat 2: RJ/x9oZtt1RZLaJEQwZOxQ ($27.20 in chips) 
Seat 3: kqpa/IbqkUrwPb3hbA7/ww ($8.25 in chips) 
Seat 4: tYsOBqdU1+x+yFI7zHO7hQ ($37.95 in chips) 
Seat 5: cUxk0Jk4lrUQv9CJl0LPlg ($17.10 in chips) 
Seat 6: kN/irnQSdb8jibbN4f1O+Q ($19.30 in chips) 
Seat 7: rUpvA02nErFvZ4yFbDR8XA ($19.90 in chips) 
Seat 8: 7tW694tRVJnYdoa16Dw4RQ ($17.10 in chips) 
Seat 9: 1c/7DHPx5CDTmAfk8/bWeA ($15.90 in chips) 
tYsOBqdU1+x+yFI7zHO7hQ: posts small blind $0.10
cUxk0Jk4lrUQv9CJl0LPlg: posts big blind $0.25
*** HOLE CARDS ***
kN/irnQSdb8jibbN4f1O+Q: folds 
rUpvA02nErFvZ4yFbDR8XA: folds 
7tW694tRVJnYdoa16Dw4RQ: folds 
1c/7DHPx5CDTmAfk8/bWeA: folds 
sD+TKtt36XiiN6jqHiLwDA: calls $0.25
RJ/x9oZtt1RZLaJEQwZOxQ: folds 
kqpa/IbqkUrwPb3hbA7/ww: calls $0.25
tYsOBqdU1+x+yFI7zHO7hQ: folds 
cUxk0Jk4lrUQv9CJl0LPlg: checks 
*** FLOP *** [As 6d 9d]
cUxk0Jk4lrUQv9CJl0LPlg: checks 
sD+TKtt36XiiN6jqHiLwDA: bets $1
kqpa/IbqkUrwPb3hbA7/ww: calls $1
cUxk0Jk4lrUQv9CJl0LPlg: folds 
*** TURN *** [As 6d 9d] [6c]
sD+TKtt36XiiN6jqHiLwDA: bets $2
kqpa/IbqkUrwPb3hbA7/ww: calls $2
*** RIVER *** [As 6d 9d 6c] [Jd]
sD+TKtt36XiiN6jqHiLwDA: checks 
kqpa/IbqkUrwPb3hbA7/ww: bets $2.50
sD+TKtt36XiiN6jqHiLwDA: calls $2.50
*** SHOW DOWN ***
kqpa/IbqkUrwPb3hbA7/ww: shows [8d Qd] (a flush, Queen high)
sD+TKtt36XiiN6jqHiLwDA: mucks hand 
kqpa/IbqkUrwPb3hbA7/ww collected $11.30 from pot
*** SUMMARY ***
Total pot $11.85 | Rake $0.55 
Board [As 6d 9d 6c Jd]
Seat 1: sD+TKtt36XiiN6jqHiLwDA mucked
Seat 2: RJ/x9oZtt1RZLaJEQwZOxQ folded before Flop (didn't bet)
Seat 3: kqpa/IbqkUrwPb3hbA7/ww (button) showed [8d Qd] and won ($11.30) with a flush, Queen high
Seat 4: tYsOBqdU1+x+yFI7zHO7hQ (small blind) folded before Flop
Seat 5: cUxk0Jk4lrUQv9CJl0LPlg (big blind) folded on the Flop
Seat 6: kN/irnQSdb8jibbN4f1O+Q folded before Flop (didn't bet)
Seat 7: rUpvA02nErFvZ4yFbDR8XA folded before Flop (didn't bet)
Seat 8: 7tW694tRVJnYdoa16Dw4RQ folded before Flop (didn't bet)
Seat 9: 1c/7DHPx5CDTmAfk8/bWeA folded before Flop (didn't bet)




PokerStars Game #59939710518:  Hold'em No Limit ($0.10/$0.25) - 2009/07/01 0:46:55 ET
Table '50f2Xa1b1jp6cfdTAgXFIg' 9-max Seat #9 is the button
Seat 1: JwUqpgqGHS96sdpExhhEqw ($7.85 in chips) 
Seat 2: F7pnn6czNpHvRM55XcA2EA ($25 in chips) 
Seat 3: GQTWTgG7Ydy9q/vohVnKmQ ($25.35 in chips) 
Seat 4: ghNKXUBl/H+t83JF079ZBA ($28.50 in chips) 
Seat 5: OlPJsgR4xypSg/w1z7Gyvw ($52.25 in chips) 
Seat 6: Vl8zO7J9ZOnk8Og8eXFezg ($40.90 in chips) 
Seat 7: TeWJxSETzbXGiYKx0y+dtg ($25 in chips) 
Seat 8: jeKWRUkMaVn8rEUjnJKqpg ($27.65 in chips) 
Seat 9: gehe91e0IyVT0QU/XBkEyg ($27.55 in chips) 
JwUqpgqGHS96sdpExhhEqw: posts small blind $0.10
F7pnn6czNpHvRM55XcA2EA: posts big blind $0.25
*** HOLE CARDS ***
GQTWTgG7Ydy9q/vohVnKmQ: folds 
ghNKXUBl/H+t83JF079ZBA: folds 
OlPJsgR4xypSg/w1z7Gyvw: folds 
Vl8zO7J9ZOnk8Og8eXFezg: calls $0.25
TeWJxSETzbXGiYKx0y+dtg: folds 
jeKWRUkMaVn8rEUjnJKqpg: calls $0.25
gehe91e0IyVT0QU/XBkEyg: folds 
JwUqpgqGHS96sdpExhhEqw: calls $0.15
F7pnn6czNpHvRM55XcA2EA: checks 
*** FLOP *** [4c Js 5d]
JwUqpgqGHS96sdpExhhEqw: checks 
F7pnn6czNpHvRM55XcA2EA: checks 
Vl8zO7J9ZOnk8Og8eXFezg: checks 
jeKWRUkMaVn8rEUjnJKqpg: checks 
*** TURN *** [4c Js 5d] [2h]
JwUqpgqGHS96sdpExhhEqw: bets $1
F7pnn6czNpHvRM55XcA2EA: folds 
Vl8zO7J9ZOnk8Og8eXFezg: folds 
jeKWRUkMaVn8rEUjnJKqpg: folds 
Uncalled bet ($1) returned to JwUqpgqGHS96sdpExhhEqw
JwUqpgqGHS96sdpExhhEqw collected $0.95 from pot
*** SUMMARY ***
Total pot $1 | Rake $0.05 
Board [4c Js 5d 2h]
Seat 1: JwUqpgqGHS96sdpExhhEqw (small blind) collected ($0.95)
Seat 2: F7pnn6czNpHvRM55XcA2EA (big blind) folded on the Turn
Seat 3: GQTWTgG7Ydy9q/vohVnKmQ folded before Flop (didn't bet)
Seat 4: ghNKXUBl/H+t83JF079ZBA folded before Flop (didn't bet)
Seat 5: OlPJsgR4xypSg/w1z7Gyvw folded before Flop (didn't bet)
Seat 6: Vl8zO7J9ZOnk8Og8eXFezg folded on the Turn
Seat 7: TeWJxSETzbXGiYKx0y+dtg folded before Flop (didn't bet)
Seat 8: jeKWRUkMaVn8rEUjnJKqpg folded on the Turn
Seat 9: gehe91e0IyVT0QU/XBkEyg (button) folded before Flop (didn't bet)




PokerStars Game #59939710106:  Hold'em No Limit ($0.10/$0.25) - 2009/07/01 0:46:55 ET
Table 'R5qKG21jwFDYRcOht9qwqQ' 9-max Seat #2 is the button
Seat 1: OgISYvc5hA85YuDnsXCH+Q ($16.40 in chips) 
Seat 2: N6foVRyErHqcNmshkqextQ ($13.80 in chips) 
Seat 3: M2QO2DxB5Wawg2h8HSpnYA ($10.10 in chips) 
Seat 4: z5GxcHlYz/GSz6W2uFiTtg ($27.95 in chips) 
Seat 5: 8B/dhbQjIWe6ASCdgzktNQ ($25 in chips) 
Seat 7: HYQiVfBGJsg4smSubKCBmA ($27.90 in chips) 
Seat 8: tYsOBqdU1+x+yFI7zHO7hQ ($25.35 in chips) 
Seat 9: MG90wfSJZnOejs/KD3vlQQ ($25.65 in chips) 
M2QO2DxB5Wawg2h8HSpnYA: posts small blind $0.10
z5GxcHlYz/GSz6W2uFiTtg: posts big blind $0.25
*** HOLE CARDS ***
8B/dhbQjIWe6ASCdgzktNQ: folds 
HYQiVfBGJsg4smSubKCBmA: calls $0.25
tYsOBqdU1+x+yFI7zHO7hQ: folds 
MG90wfSJZnOejs/KD3vlQQ: folds 
OgISYvc5hA85YuDnsXCH+Q: calls $0.25
N6foVRyErHqcNmshkqextQ: folds 
M2QO2DxB5Wawg2h8HSpnYA: folds 
z5GxcHlYz/GSz6W2uFiTtg: checks 
*** FLOP *** [5s Kd Qh]
z5GxcHlYz/GSz6W2uFiTtg: checks 
HYQiVfBGJsg4smSubKCBmA: bets $0.50
OgISYvc5hA85YuDnsXCH+Q: folds 
z5GxcHlYz/GSz6W2uFiTtg: folds 
Uncalled bet ($0.50) returned to HYQiVfBGJsg4smSubKCBmA
HYQiVfBGJsg4smSubKCBmA collected $0.85 from pot
HYQiVfBGJsg4smSubKCBmA: doesn't show hand 
*** SUMMARY ***
Total pot $0.85 | Rake $0 
Board [5s Kd Qh]
Seat 1: OgISYvc5hA85YuDnsXCH+Q folded on the Flop
Seat 2: N6foVRyErHqcNmshkqextQ (button) folded before Flop (didn't bet)
Seat 3: M2QO2DxB5Wawg2h8HSpnYA (small blind) folded before Flop
Seat 4: z5GxcHlYz/GSz6W2uFiTtg (big blind) folded on the Flop
Seat 5: 8B/dhbQjIWe6ASCdgzktNQ folded before Flop (didn't bet)
Seat 7: HYQiVfBGJsg4smSubKCBmA collected ($0.85)
Seat 8: tYsOBqdU1+x+yFI7zHO7hQ folded before Flop (didn't bet)
Seat 9: MG90wfSJZnOejs/KD3vlQQ folded before Flop (didn't bet)




PokerStars Game #59939710988:  Hold'em No Limit ($0.10/$0.25) - 2009/07/01 0:46:56 ET
Table 'rtxA1Y01Nrq5VoyzTAuusQ' 9-max Seat #3 is the button
Seat 1: gAlaEiNZy/H/QuIVwzvHAQ ($10.55 in chips) 
Seat 2: xtpoxBFB+5CWL2iFqk9Zlg ($34.90 in chips) 
Seat 3: K9fS1IUr5GpiJG7VkJ7IbA ($37.15 in chips) 
Seat 5: HG/hVrkvCiG0erBa6RyLZA ($12.65 in chips) 
Seat 6: qccGLncfUaN00Few5HsgYg ($23.05 in chips) 
Seat 7: N6fYvIzQLKaydFLKQGtMlQ ($21.30 in chips) 
Seat 8: EUSBQy2KGzT65/CXiIu59Q ($31.70 in chips) 
Seat 9: HPEB+AtKw1+C/cxU0o1ciw ($24.25 in chips) 
lTfGgdGMRH+DZcKby2m9Nw will be allowed to play after the button
HG/hVrkvCiG0erBa6RyLZA: posts small blind $0.10
qccGLncfUaN00Few5HsgYg: posts big blind $0.25
*** HOLE CARDS ***
N6fYvIzQLKaydFLKQGtMlQ: folds 
EUSBQy2KGzT65/CXiIu59Q: folds 
HPEB+AtKw1+C/cxU0o1ciw: folds 
gAlaEiNZy/H/QuIVwzvHAQ: calls $0.25
xtpoxBFB+5CWL2iFqk9Zlg: folds 
K9fS1IUr5GpiJG7VkJ7IbA: calls $0.25
HG/hVrkvCiG0erBa6RyLZA: raises $1 to $1.25
qccGLncfUaN00Few5HsgYg: calls $1
gAlaEiNZy/H/QuIVwzvHAQ: calls $1
K9fS1IUr5GpiJG7VkJ7IbA: calls $1
*** FLOP *** [Ad 8h 2c]
HG/hVrkvCiG0erBa6RyLZA: bets $1
qccGLncfUaN00Few5HsgYg: folds 
gAlaEiNZy/H/QuIVwzvHAQ: folds 
K9fS1IUr5GpiJG7VkJ7IbA: folds 
Uncalled bet ($1) returned to HG/hVrkvCiG0erBa6RyLZA
HG/hVrkvCiG0erBa6RyLZA collected $4.75 from pot
*** SUMMARY ***
Total pot $5 | Rake $0.25 
Board [Ad 8h 2c]
Seat 1: gAlaEiNZy/H/QuIVwzvHAQ folded on the Flop
Seat 2: xtpoxBFB+5CWL2iFqk9Zlg folded before Flop (didn't bet)
Seat 3: K9fS1IUr5GpiJG7VkJ7IbA (button) folded on the Flop
Seat 5: HG/hVrkvCiG0erBa6RyLZA (small blind) collected ($4.75)
Seat 6: qccGLncfUaN00Few5HsgYg (big blind) folded on the Flop
Seat 7: N6fYvIzQLKaydFLKQGtMlQ folded before Flop (didn't bet)
Seat 8: EUSBQy2KGzT65/CXiIu59Q folded before Flop (didn't bet)
Seat 9: HPEB+AtKw1+C/cxU0o1ciw folded before Flop (didn't bet)




PokerStars Game #59939710636:  Hold'em No Limit ($0.10/$0.25) - 2009/07/01 0:46:56 ET
Table 'RPdw09/gGCIP4xFhDWJgXQ' 9-max Seat #7 is the button
Seat 1: aNpwfA31EREwO+ar4XzBCw ($25 in chips) 
Seat 2: Sd1tfhUq/M96GhXGv1hwFQ ($10.25 in chips) 
Seat 3: Qi+clOtyDiibLdH2/1Qy8g ($26 in chips) 
Seat 4: z5GxcHlYz/GSz6W2uFiTtg ($21.75 in chips) 
Seat 5: z0kymJfmEW9d8WGcY1n6OA ($9.80 in chips) 
Seat 6: monZeAwXUmIA1l84cUd2hw ($12.30 in chips) 
Seat 7: hIss79a4pu7GzJZepfgOpg ($25 in chips) 
Seat 8: MG90wfSJZnOejs/KD3vlQQ ($25 in chips) 
MG90wfSJZnOejs/KD3vlQQ: posts small blind $0.10
Yv4fucyyT28mjx8V5lxKJg: is sitting out 
Yv4fucyyT28mjx8V5lxKJg leaves the table
aNpwfA31EREwO+ar4XzBCw: posts big blind $0.25
*** HOLE CARDS ***
Sd1tfhUq/M96GhXGv1hwFQ: calls $0.25
Qi+clOtyDiibLdH2/1Qy8g: folds 
z5GxcHlYz/GSz6W2uFiTtg: folds 
z0kymJfmEW9d8WGcY1n6OA: folds 
monZeAwXUmIA1l84cUd2hw: folds 
hIss79a4pu7GzJZepfgOpg: folds 
MG90wfSJZnOejs/KD3vlQQ: calls $0.15
aNpwfA31EREwO+ar4XzBCw: checks 
*** FLOP *** [2c 6d 7h]
MG90wfSJZnOejs/KD3vlQQ: checks 
aNpwfA31EREwO+ar4XzBCw: checks 
Sd1tfhUq/M96GhXGv1hwFQ: checks 
*** TURN *** [2c 6d 7h] [6h]
MG90wfSJZnOejs/KD3vlQQ: checks 
aNpwfA31EREwO+ar4XzBCw: checks 
Sd1tfhUq/M96GhXGv1hwFQ: checks 
*** RIVER *** [2c 6d 7h 6h] [6s]
MG90wfSJZnOejs/KD3vlQQ: checks 
aNpwfA31EREwO+ar4XzBCw: checks 
mdalglish joins the table at seat #9 
Sd1tfhUq/M96GhXGv1hwFQ: checks 
*** SHOW DOWN ***
MG90wfSJZnOejs/KD3vlQQ: shows [Kd Th] (three of a kind, Sixes)
aNpwfA31EREwO+ar4XzBCw: mucks hand 
Sd1tfhUq/M96GhXGv1hwFQ: mucks hand 
MG90wfSJZnOejs/KD3vlQQ collected $0.75 from pot
*** SUMMARY ***
Total pot $0.75 | Rake $0 
Board [2c 6d 7h 6h 6s]
Seat 1: aNpwfA31EREwO+ar4XzBCw (big blind) mucked
Seat 2: Sd1tfhUq/M96GhXGv1hwFQ mucked
Seat 3: Qi+clOtyDiibLdH2/1Qy8g folded before Flop (didn't bet)
Seat 4: z5GxcHlYz/GSz6W2uFiTtg folded before Flop (didn't bet)
Seat 5: z0kymJfmEW9d8WGcY1n6OA folded before Flop (didn't bet)
Seat 6: monZeAwXUmIA1l84cUd2hw folded before Flop (didn't bet)
Seat 7: hIss79a4pu7GzJZepfgOpg (button) folded before Flop (didn't bet)
Seat 8: MG90wfSJZnOejs/KD3vlQQ (small blind) showed [Kd Th] and won ($0.75) with three of a kind, Sixes




PokerStars Game #59939710828:  Hold'em No Limit ($0.10/$0.25) - 2009/07/01 0:46:56 ET
Table 'b64Z+5XI1xkQzNfq4QHr3A' 6-max Seat #3 is the button
Seat 1: qccGLncfUaN00Few5HsgYg ($53.65 in chips) 
Seat 2: SS/yfeArhULzIcOPe8MdPg ($39.45 in chips) 
Seat 3: u/yN5P9f3KlATg6WLWNkBQ ($24.65 in chips) 
Seat 4: SxIIgwXYLkwd6m3wLyPTCw ($25 in chips) 
Seat 5: d0J1xuhsynEY81YHwAvJ5g ($33.25 in chips) 
Seat 6: 8ClCHtFXGNplITm+63KB+Q ($37.75 in chips) 
SxIIgwXYLkwd6m3wLyPTCw: posts small blind $0.10
d0J1xuhsynEY81YHwAvJ5g: posts big blind $0.25
*** HOLE CARDS ***
8ClCHtFXGNplITm+63KB+Q: folds 
qccGLncfUaN00Few5HsgYg: folds 
SS/yfeArhULzIcOPe8MdPg: raises $0.75 to $1
u/yN5P9f3KlATg6WLWNkBQ: calls $1
SxIIgwXYLkwd6m3wLyPTCw: folds 
d0J1xuhsynEY81YHwAvJ5g: folds 
*** FLOP *** [Jh Ah 2s]
SS/yfeArhULzIcOPe8MdPg: bets $1.50
u/yN5P9f3KlATg6WLWNkBQ: calls $1.50
*** TURN *** [Jh Ah 2s] [7c]
SS/yfeArhULzIcOPe8MdPg: bets $4.25
u/yN5P9f3KlATg6WLWNkBQ: raises $8.75 to $13
SS/yfeArhULzIcOPe8MdPg: folds 
Uncalled bet ($8.75) returned to u/yN5P9f3KlATg6WLWNkBQ
u/yN5P9f3KlATg6WLWNkBQ collected $13.20 from pot
u/yN5P9f3KlATg6WLWNkBQ: doesn't show hand 
*** SUMMARY ***
Total pot $13.85 | Rake $0.65 
Board [Jh Ah 2s 7c]
Seat 1: qccGLncfUaN00Few5HsgYg folded before Flop (didn't bet)
Seat 2: SS/yfeArhULzIcOPe8MdPg folded on the Turn
Seat 3: u/yN5P9f3KlATg6WLWNkBQ (button) collected ($13.20)
Seat 4: SxIIgwXYLkwd6m3wLyPTCw (small blind) folded before Flop
Seat 5: d0J1xuhsynEY81YHwAvJ5g (big blind) folded before Flop
Seat 6: 8ClCHtFXGNplITm+63KB+Q folded before Flop (didn't bet)




PokerStars Game #59939710896:  Hold'em No Limit ($0.10/$0.25) - 2009/07/01 0:46:56 ET
Table 'yRuHgMpxv4rPBXeM6HFESw' 6-max Seat #4 is the button
Seat 1: MkNgTuvyxpHXkeIm5JITHQ ($10.45 in chips) 
Seat 2: iwlxXocltgSdaBmusNXanQ ($15.80 in chips) 
Seat 3: zZ8zH49EwNs0mqgppOaL9g ($50.20 in chips) 
Seat 4: ypXnt+kzrF/5y8QN2rkt1A ($24.10 in chips) 
Seat 5: gaPMxLGp9SOj4Lq6t+/0Ig ($13.05 in chips) 
Seat 6: 4YSTu0Cdzpppe1lUgCZGCQ ($25 in chips) 
gaPMxLGp9SOj4Lq6t+/0Ig: posts small blind $0.10
4YSTu0Cdzpppe1lUgCZGCQ: posts big blind $0.25
*** HOLE CARDS ***
MkNgTuvyxpHXkeIm5JITHQ: folds 
iwlxXocltgSdaBmusNXanQ: folds 
zZ8zH49EwNs0mqgppOaL9g: raises $0.50 to $0.75
ypXnt+kzrF/5y8QN2rkt1A: calls $0.75
gaPMxLGp9SOj4Lq6t+/0Ig: folds 
4YSTu0Cdzpppe1lUgCZGCQ: folds 
*** FLOP *** [Ah Kc 9d]
zZ8zH49EwNs0mqgppOaL9g: checks 
ypXnt+kzrF/5y8QN2rkt1A: bets $0.50
zZ8zH49EwNs0mqgppOaL9g: calls $0.50
*** TURN *** [Ah Kc 9d] [7c]
zZ8zH49EwNs0mqgppOaL9g: bets $1.75
ypXnt+kzrF/5y8QN2rkt1A: calls $1.75
*** RIVER *** [Ah Kc 9d 7c] [8d]
zZ8zH49EwNs0mqgppOaL9g: checks 
ypXnt+kzrF/5y8QN2rkt1A: checks 
*** SHOW DOWN ***
zZ8zH49EwNs0mqgppOaL9g: shows [Kh Th] (a pair of Kings)
ypXnt+kzrF/5y8QN2rkt1A: shows [As 5h] (a pair of Aces)
ypXnt+kzrF/5y8QN2rkt1A collected $6.05 from pot
*** SUMMARY ***
Total pot $6.35 | Rake $0.30 
Board [Ah Kc 9d 7c 8d]
Seat 1: MkNgTuvyxpHXkeIm5JITHQ folded before Flop (didn't bet)
Seat 2: iwlxXocltgSdaBmusNXanQ folded before Flop (didn't bet)
Seat 3: zZ8zH49EwNs0mqgppOaL9g showed [Kh Th] and lost with a pair of Kings
Seat 4: ypXnt+kzrF/5y8QN2rkt1A (button) showed [As 5h] and won ($6.05) with a pair of Aces
Seat 5: gaPMxLGp9SOj4Lq6t+/0Ig (small blind) folded before Flop
Seat 6: 4YSTu0Cdzpppe1lUgCZGCQ (big blind) folded before Flop




PokerStars Game #59939711008:  Hold'em No Limit ($0.10/$0.25) - 2009/07/01 0:46:56 ET
Table 'M8kYidAX3ib7pLKW7edFLw' 6-max Seat #2 is the button
Seat 1: jp34e617tIzV8tKIWmfAbA ($25.25 in chips) 
Seat 2: 4kWQxGbT5FZ1dkPd1bE45Q ($38.60 in chips) 
Seat 3: q+Sip/IIcvzqgZt1pJAWTw ($9.10 in chips) 
Seat 4: /bjna2FTN7pPjqYGzmDE0Q ($24.65 in chips) 
Seat 5: bDKopKTvPi3W+PEnYUX3tg ($48.45 in chips) 
q+Sip/IIcvzqgZt1pJAWTw: posts small blind $0.10
/bjna2FTN7pPjqYGzmDE0Q: posts big blind $0.25
*** HOLE CARDS ***
bDKopKTvPi3W+PEnYUX3tg said, "cooler"
4kWQxGbT5FZ1dkPd1bE45Q said, "ul setup"
bDKopKTvPi3W+PEnYUX3tg: calls $0.25
jp34e617tIzV8tKIWmfAbA: folds 
4kWQxGbT5FZ1dkPd1bE45Q: folds 
q+Sip/IIcvzqgZt1pJAWTw: folds 
NqFoyDgzLwu4dOmSRXnFBA has returned
/bjna2FTN7pPjqYGzmDE0Q: checks 
*** FLOP *** [7h Ad Qd]
NqFoyDgzLwu4dOmSRXnFBA said, "nh"
/bjna2FTN7pPjqYGzmDE0Q: checks 
q+Sip/IIcvzqgZt1pJAWTw said, "i need aa"
bDKopKTvPi3W+PEnYUX3tg: bets $0.50
q+Sip/IIcvzqgZt1pJAWTw said, "or kk"
q+Sip/IIcvzqgZt1pJAWTw said, "lol"
/bjna2FTN7pPjqYGzmDE0Q: calls $0.50
*** TURN *** [7h Ad Qd] [Kd]
/bjna2FTN7pPjqYGzmDE0Q: checks 
bDKopKTvPi3W+PEnYUX3tg: checks 
*** RIVER *** [7h Ad Qd Kd] [8d]
/bjna2FTN7pPjqYGzmDE0Q: checks 
bDKopKTvPi3W+PEnYUX3tg: checks 
*** SHOW DOWN ***
/bjna2FTN7pPjqYGzmDE0Q: shows [Qh 2d] (a flush, Ace high)
bDKopKTvPi3W+PEnYUX3tg: mucks hand 
/bjna2FTN7pPjqYGzmDE0Q collected $1.55 from pot
*** SUMMARY ***
Total pot $1.60 | Rake $0.05 
Board [7h Ad Qd Kd 8d]
Seat 1: jp34e617tIzV8tKIWmfAbA folded before Flop (didn't bet)
Seat 2: 4kWQxGbT5FZ1dkPd1bE45Q (button) folded before Flop (didn't bet)
Seat 3: q+Sip/IIcvzqgZt1pJAWTw (small blind) folded before Flop
Seat 4: /bjna2FTN7pPjqYGzmDE0Q (big blind) showed [Qh 2d] and won ($1.55) with a flush, Ace high
Seat 5: bDKopKTvPi3W+PEnYUX3tg mucked




PokerStars Game #59939710920:  Hold'em No Limit ($0.10/$0.25) - 2009/07/01 0:46:56 ET
Table 'LG9H161ZAHDkOww+ih3Ptg' 6-max Seat #1 is the button
Seat 1: avl8CO/tc0F6eVSiB/KNRA ($25.60 in chips) 
Seat 2: 9jSiy0meE9XJKkdIZwyTEQ ($28.35 in chips) 
Seat 3: 5Evvx7UYqXTBuvIc/9s/hA ($15 in chips) 
Seat 4: 0C28L4/59aRNtHoBhqTcLg ($71.60 in chips) 
Seat 5: oseFhpinoe+Zg4j5xyBjyQ ($44.85 in chips) 
v8m8XHovI5tqEA9mvplDSw joins the table at seat #6 
9jSiy0meE9XJKkdIZwyTEQ: posts small blind $0.10
5Evvx7UYqXTBuvIc/9s/hA: posts big blind $0.25
*** HOLE CARDS ***
0C28L4/59aRNtHoBhqTcLg: folds 
oseFhpinoe+Zg4j5xyBjyQ: folds 
avl8CO/tc0F6eVSiB/KNRA: folds 
9jSiy0meE9XJKkdIZwyTEQ: raises $0.60 to $0.85
5Evvx7UYqXTBuvIc/9s/hA: calls $0.60
*** FLOP *** [8s 6s 5c]
9jSiy0meE9XJKkdIZwyTEQ: bets $1.20
5Evvx7UYqXTBuvIc/9s/hA: calls $1.20
*** TURN *** [8s 6s 5c] [4d]
9jSiy0meE9XJKkdIZwyTEQ: bets $2.50
5Evvx7UYqXTBuvIc/9s/hA: calls $2.50
*** RIVER *** [8s 6s 5c 4d] [4h]
9jSiy0meE9XJKkdIZwyTEQ: bets $4.80
5Evvx7UYqXTBuvIc/9s/hA: folds 
Uncalled bet ($4.80) returned to 9jSiy0meE9XJKkdIZwyTEQ
9jSiy0meE9XJKkdIZwyTEQ collected $8.70 from pot
9jSiy0meE9XJKkdIZwyTEQ: doesn't show hand 
*** SUMMARY ***
Total pot $9.10 | Rake $0.40 
Board [8s 6s 5c 4d 4h]
Seat 1: avl8CO/tc0F6eVSiB/KNRA (button) folded before Flop (didn't bet)
Seat 2: 9jSiy0meE9XJKkdIZwyTEQ (small blind) collected ($8.70)
Seat 3: 5Evvx7UYqXTBuvIc/9s/hA (big blind) folded on the River
Seat 4: 0C28L4/59aRNtHoBhqTcLg folded before Flop (didn't bet)
Seat 5: oseFhpinoe+Zg4j5xyBjyQ folded before Flop (didn't bet)




PokerStars Game #59939710664:  Hold'em No Limit ($0.10/$0.25) - 2009/07/01 0:46:56 ET
Table '3Ns9nuTkynfwbBfBXzg6ww' 6-max Seat #4 is the button
Seat 1: KDYsHh8K2SUXXDvLsAhbJQ ($8.65 in chips) 
Seat 3: HyXsCmHsOHAlL2pzZ9IYAg ($4.60 in chips) 
Seat 4: qGHGf/553gQnDoklMRe3tg ($22.15 in chips) 
Seat 5: kBQU/db00TVAMeomlhblPg ($17.20 in chips) 
Seat 6: ZZm/rg8aThjE+A2LiItuzA ($12.60 in chips) 
kBQU/db00TVAMeomlhblPg: posts small blind $0.10
ZZm/rg8aThjE+A2LiItuzA: posts big blind $0.25
zxeVQGaMKDsDzmSY+AInjA: sits out 
*** HOLE CARDS ***
KDYsHh8K2SUXXDvLsAhbJQ: calls $0.25
HyXsCmHsOHAlL2pzZ9IYAg: folds 
qGHGf/553gQnDoklMRe3tg: folds 
kBQU/db00TVAMeomlhblPg: calls $0.15
ZZm/rg8aThjE+A2LiItuzA: checks 
*** FLOP *** [Jd 8s 8c]
kBQU/db00TVAMeomlhblPg: bets $1.25
ZZm/rg8aThjE+A2LiItuzA: folds 
KDYsHh8K2SUXXDvLsAhbJQ: folds 
Uncalled bet ($1.25) returned to kBQU/db00TVAMeomlhblPg
kBQU/db00TVAMeomlhblPg collected $0.75 from pot
*** SUMMARY ***
Total pot $0.75 | Rake $0 
Board [Jd 8s 8c]
Seat 1: KDYsHh8K2SUXXDvLsAhbJQ folded on the Flop
Seat 3: HyXsCmHsOHAlL2pzZ9IYAg folded before Flop (didn't bet)
Seat 4: qGHGf/553gQnDoklMRe3tg (button) folded before Flop (didn't bet)
Seat 5: kBQU/db00TVAMeomlhblPg (small blind) collected ($0.75)
Seat 6: ZZm/rg8aThjE+A2LiItuzA (big blind) folded on the Flop




PokerStars Game #59939710592:  Hold'em No Limit ($0.10/$0.25) - 2009/07/01 0:46:56 ET
Table '8UiaYOdeBwzanG6w1SMeFg' 9-max Seat #5 is the button
Seat 2: 18G4P1XstjNvItdGUITxgw ($25 in chips) 
Seat 3: A7xJNkBMCQG6Zuocn2v8YQ ($16.65 in chips) 
Seat 4: H5Se03ZqSX7tbULXur2MAg ($28.75 in chips) 
Seat 5: UmzixCpC0bAc1lDEjgB3NQ ($18.85 in chips) 
Seat 6: N6fYvIzQLKaydFLKQGtMlQ ($23.05 in chips) 
Seat 7: E0iYnEVO2ho7dH3QcCjw7g ($22.40 in chips) 
Seat 8: hBMUlEpyU74r/fwDgIpXjQ ($53.40 in chips) 
N6fYvIzQLKaydFLKQGtMlQ: posts small blind $0.10
E0iYnEVO2ho7dH3QcCjw7g: posts big blind $0.25
K4All-In: sits out 
CYkY0dNBaYaKs8HVCVn3mQ: sits out 
*** HOLE CARDS ***
hBMUlEpyU74r/fwDgIpXjQ: folds 
18G4P1XstjNvItdGUITxgw: folds 
A7xJNkBMCQG6Zuocn2v8YQ: calls $0.25
H5Se03ZqSX7tbULXur2MAg: folds 
UmzixCpC0bAc1lDEjgB3NQ: calls $0.25
N6fYvIzQLKaydFLKQGtMlQ: calls $0.15
E0iYnEVO2ho7dH3QcCjw7g: checks 
*** FLOP *** [Qs 7h 6d]
N6fYvIzQLKaydFLKQGtMlQ: checks 
E0iYnEVO2ho7dH3QcCjw7g: checks 
A7xJNkBMCQG6Zuocn2v8YQ: checks 
UmzixCpC0bAc1lDEjgB3NQ: checks 
*** TURN *** [Qs 7h 6d] [Qh]
N6fYvIzQLKaydFLKQGtMlQ: checks 
E0iYnEVO2ho7dH3QcCjw7g: bets $0.75
A7xJNkBMCQG6Zuocn2v8YQ: folds 
UmzixCpC0bAc1lDEjgB3NQ: calls $0.75
N6fYvIzQLKaydFLKQGtMlQ: folds 
*** RIVER *** [Qs 7h 6d Qh] [6c]
E0iYnEVO2ho7dH3QcCjw7g: checks 
UmzixCpC0bAc1lDEjgB3NQ: bets $1.50
E0iYnEVO2ho7dH3QcCjw7g: calls $1.50
*** SHOW DOWN ***
UmzixCpC0bAc1lDEjgB3NQ: shows [As 7d] (two pair, Queens and Sevens)
E0iYnEVO2ho7dH3QcCjw7g: mucks hand 
UmzixCpC0bAc1lDEjgB3NQ collected $5.25 from pot
*** SUMMARY ***
Total pot $5.50 | Rake $0.25 
Board [Qs 7h 6d Qh 6c]
Seat 2: 18G4P1XstjNvItdGUITxgw folded before Flop (didn't bet)
Seat 3: A7xJNkBMCQG6Zuocn2v8YQ folded on the Turn
Seat 4: H5Se03ZqSX7tbULXur2MAg folded before Flop (didn't bet)
Seat 5: UmzixCpC0bAc1lDEjgB3NQ (button) showed [As 7d] and won ($5.25) with two pair, Queens and Sevens
Seat 6: N6fYvIzQLKaydFLKQGtMlQ (small blind) folded on the Turn
Seat 7: E0iYnEVO2ho7dH3QcCjw7g (big blind) mucked
Seat 8: hBMUlEpyU74r/fwDgIpXjQ folded before Flop (didn't bet)




PokerStars Game #59939711734:  Hold'em No Limit ($0.10/$0.25) - 2009/07/01 0:46:57 ET
Table '2O5CgfSkSwrr4PDrlZ1RLQ' 6-max Seat #1 is the button
Seat 1: kyRaCIljYA6l33lSKQfNsg ($46.75 in chips) 
Seat 2: /gJNBeCkWL4o85/jvlZ4BA ($49.90 in chips) 
Seat 3: yzFNNFIfC89bBPwpFPx2ow ($25 in chips) 
Seat 4: 4x9jCqgSw4272dnaIqnanw ($5.35 in chips) 
Seat 5: AMrBn4Vx9aAo/vv6WHLk6w ($4.60 in chips) 
/gJNBeCkWL4o85/jvlZ4BA: posts small blind $0.10
yzFNNFIfC89bBPwpFPx2ow: posts big blind $0.25
*** HOLE CARDS ***
4x9jCqgSw4272dnaIqnanw: calls $0.25
AMrBn4Vx9aAo/vv6WHLk6w: folds 
tj9xqoqQaDaFw7u1oyZrtA has returned
kyRaCIljYA6l33lSKQfNsg: folds 
/gJNBeCkWL4o85/jvlZ4BA: folds 
yzFNNFIfC89bBPwpFPx2ow: checks 
*** FLOP *** [Js 2d 4d]
yzFNNFIfC89bBPwpFPx2ow: bets $0.75
4x9jCqgSw4272dnaIqnanw: calls $0.75
*** TURN *** [Js 2d 4d] [Ad]
yzFNNFIfC89bBPwpFPx2ow: checks 
4x9jCqgSw4272dnaIqnanw: bets $4.35 and is all-in
yzFNNFIfC89bBPwpFPx2ow: calls $4.35
*** RIVER *** [Js 2d 4d Ad] [6s]
*** SHOW DOWN ***
yzFNNFIfC89bBPwpFPx2ow: shows [Jh Kh] (a pair of Jacks)
4x9jCqgSw4272dnaIqnanw: shows [As 2s] (two pair, Aces and Deuces)
4x9jCqgSw4272dnaIqnanw collected $10.30 from pot
*** SUMMARY ***
Total pot $10.80 | Rake $0.50 
Board [Js 2d 4d Ad 6s]
Seat 1: kyRaCIljYA6l33lSKQfNsg (button) folded before Flop (didn't bet)
Seat 2: /gJNBeCkWL4o85/jvlZ4BA (small blind) folded before Flop
Seat 3: yzFNNFIfC89bBPwpFPx2ow (big blind) showed [Jh Kh] and lost with a pair of Jacks
Seat 4: 4x9jCqgSw4272dnaIqnanw showed [As 2s] and won ($10.30) with two pair, Aces and Deuces
Seat 5: AMrBn4Vx9aAo/vv6WHLk6w folded before Flop (didn't bet)




PokerStars Game #59939711730:  Hold'em No Limit ($0.10/$0.25) - 2009/07/01 0:46:57 ET
Table 'nB7Q7zfNfy6ig6DB+rsgWQ' 6-max Seat #5 is the button
Seat 1: ACU3rO57RhDJfAgHTq2ocA ($4.90 in chips) 
Seat 2: g6kf+5FIgWH33PmH6ZecMQ ($15.25 in chips) 
Seat 3: p3NYOxYhkL7txPRSeXHDeg ($32.15 in chips) 
Seat 4: YZjG5I7FqwMKy06BKVBS7w ($7.95 in chips) 
Seat 5: X0/5h4o4LdHWlM7o/9shzg ($7.65 in chips) 
Seat 6: BYxjLnV1/LL0aZcTbfAOvw ($41.65 in chips) 
BYxjLnV1/LL0aZcTbfAOvw: posts small blind $0.10
ACU3rO57RhDJfAgHTq2ocA: posts big blind $0.25
*** HOLE CARDS ***
g6kf+5FIgWH33PmH6ZecMQ: calls $0.25
p3NYOxYhkL7txPRSeXHDeg: folds 
YZjG5I7FqwMKy06BKVBS7w: folds 
X0/5h4o4LdHWlM7o/9shzg: calls $0.25
BYxjLnV1/LL0aZcTbfAOvw: folds 
ACU3rO57RhDJfAgHTq2ocA: raises $0.50 to $0.75
g6kf+5FIgWH33PmH6ZecMQ: folds 
X0/5h4o4LdHWlM7o/9shzg: calls $0.50
*** FLOP *** [6s Ah 4c]
ACU3rO57RhDJfAgHTq2ocA: checks 
X0/5h4o4LdHWlM7o/9shzg: checks 
*** TURN *** [6s Ah 4c] [Jd]
ACU3rO57RhDJfAgHTq2ocA: bets $0.25
X0/5h4o4LdHWlM7o/9shzg: folds 
Uncalled bet ($0.25) returned to ACU3rO57RhDJfAgHTq2ocA
X0/5h4o4LdHWlM7o/9shzg is sitting out
ACU3rO57RhDJfAgHTq2ocA collected $1.80 from pot
*** SUMMARY ***
Total pot $1.85 | Rake $0.05 
Board [6s Ah 4c Jd]
Seat 1: ACU3rO57RhDJfAgHTq2ocA (big blind) collected ($1.80)
Seat 2: g6kf+5FIgWH33PmH6ZecMQ folded before Flop
Seat 3: p3NYOxYhkL7txPRSeXHDeg folded before Flop (didn't bet)
Seat 4: YZjG5I7FqwMKy06BKVBS7w folded before Flop (didn't bet)
Seat 5: X0/5h4o4LdHWlM7o/9shzg (button) folded on the Turn
Seat 6: BYxjLnV1/LL0aZcTbfAOvw (small blind) folded before Flop




PokerStars Game #59939711326:  Hold'em No Limit ($0.10/$0.25) - 2009/07/01 0:46:57 ET
Table '2AUmC2Rslg+QUbLfdgNdfg' 6-max Seat #3 is the button
Seat 1: lquriepNQBhDV5P1SWHhnA ($25 in chips) 
Seat 2: CCxAG7iPVlAv3brCqrGBEg ($13.40 in chips) 
Seat 3: iauW7L/+7qzAuHow7CD75Q ($7.70 in chips) 
Seat 4: B6R6e73iyJNddUtXtvYr3Q ($47.70 in chips) 
Seat 5: 8ClCHtFXGNplITm+63KB+Q ($26.15 in chips) 
Seat 6: BvTq4Tu0zBOsniW3eFCnkQ ($33.30 in chips) 
B6R6e73iyJNddUtXtvYr3Q: posts small blind $0.10
8ClCHtFXGNplITm+63KB+Q: posts big blind $0.25
*** HOLE CARDS ***
BvTq4Tu0zBOsniW3eFCnkQ: folds 
lquriepNQBhDV5P1SWHhnA: raises $0.50 to $0.75
CCxAG7iPVlAv3brCqrGBEg: folds 
iauW7L/+7qzAuHow7CD75Q: calls $0.75
B6R6e73iyJNddUtXtvYr3Q: folds 
8ClCHtFXGNplITm+63KB+Q: folds 
*** FLOP *** [2s 4h 4d]
lquriepNQBhDV5P1SWHhnA: checks 
iauW7L/+7qzAuHow7CD75Q: checks 
*** TURN *** [2s 4h 4d] [9d]
lquriepNQBhDV5P1SWHhnA: checks 
iauW7L/+7qzAuHow7CD75Q: checks 
*** RIVER *** [2s 4h 4d 9d] [2h]
lquriepNQBhDV5P1SWHhnA: checks 
iauW7L/+7qzAuHow7CD75Q: checks 
*** SHOW DOWN ***
lquriepNQBhDV5P1SWHhnA: shows [6s 7s] (two pair, Fours and Deuces)
iauW7L/+7qzAuHow7CD75Q: shows [Qs Js] (two pair, Fours and Deuces - Queen kicker)
iauW7L/+7qzAuHow7CD75Q collected $1.80 from pot
*** SUMMARY ***
Total pot $1.85 | Rake $0.05 
Board [2s 4h 4d 9d 2h]
Seat 1: lquriepNQBhDV5P1SWHhnA showed [6s 7s] and lost with two pair, Fours and Deuces
Seat 2: CCxAG7iPVlAv3brCqrGBEg folded before Flop (didn't bet)
Seat 3: iauW7L/+7qzAuHow7CD75Q (button) showed [Qs Js] and won ($1.80) with two pair, Fours and Deuces
Seat 4: B6R6e73iyJNddUtXtvYr3Q (small blind) folded before Flop
Seat 5: 8ClCHtFXGNplITm+63KB+Q (big blind) folded before Flop
Seat 6: BvTq4Tu0zBOsniW3eFCnkQ folded before Flop (didn't bet)




PokerStars Game #59939711518:  Hold'em No Limit ($0.10/$0.25) - 2009/07/01 0:46:57 ET
Table 'ShgkxBDL5IvR1qjzfRNc0A' 6-max Seat #4 is the button
Seat 1: /gJNBeCkWL4o85/jvlZ4BA ($25 in chips) 
Seat 2: mfrkWA3PTeYPkbO6hi98Aw ($35 in chips) 
Seat 3: JXSfL0FgBM1dIFwHP09Hnw ($33.50 in chips) 
Seat 4: kG34n23qFQA3nzdOJTQ1dA ($24.90 in chips) 
Seat 5: ferjiUxLWPNUKxvl8/xD/g ($48.60 in chips) 
Seat 6: 5tB0F9NjPSUL4FzmzBMs2Q ($27.70 in chips) 
ferjiUxLWPNUKxvl8/xD/g: posts small blind $0.10
5tB0F9NjPSUL4FzmzBMs2Q: posts big blind $0.25
*** HOLE CARDS ***
/gJNBeCkWL4o85/jvlZ4BA: folds 
mfrkWA3PTeYPkbO6hi98Aw: folds 
JXSfL0FgBM1dIFwHP09Hnw: folds 
kG34n23qFQA3nzdOJTQ1dA: folds 
ferjiUxLWPNUKxvl8/xD/g: raises $0.75 to $1
5tB0F9NjPSUL4FzmzBMs2Q: folds 
Uncalled bet ($0.75) returned to ferjiUxLWPNUKxvl8/xD/g
ferjiUxLWPNUKxvl8/xD/g collected $0.50 from pot
ferjiUxLWPNUKxvl8/xD/g: doesn't show hand 
*** SUMMARY ***
Total pot $0.50 | Rake $0 
Seat 1: /gJNBeCkWL4o85/jvlZ4BA folded before Flop (didn't bet)
Seat 2: mfrkWA3PTeYPkbO6hi98Aw folded before Flop (didn't bet)
Seat 3: JXSfL0FgBM1dIFwHP09Hnw folded before Flop (didn't bet)
Seat 4: kG34n23qFQA3nzdOJTQ1dA (button) folded before Flop (didn't bet)
Seat 5: ferjiUxLWPNUKxvl8/xD/g (small blind) collected ($0.50)
Seat 6: 5tB0F9NjPSUL4FzmzBMs2Q (big blind) folded before Flop




PokerStars Game #59939711148:  Hold'em No Limit ($0.10/$0.25) - 2009/07/01 0:46:57 ET
Table 'BpNkESDX1ip9c0K1hb5h7A' 6-max Seat #3 is the button
Seat 1: 9jSiy0meE9XJKkdIZwyTEQ ($28.90 in chips) 
Seat 2: gqW2aBCmrIw65BvwjTFN6Q ($25 in chips) 
Seat 3: cHhVLDikFlByGGN+CM3w/A ($27.95 in chips) 
Seat 4: x9VGscBU5oUWy8rQ+Ik80w ($25 in chips) 
Seat 5: QvTX2yGq3uKJiKPmns4TKQ ($75.95 in chips) 
Seat 6: iUgsn+WyKFjjVd+tj13R2w ($13 in chips) 
x9VGscBU5oUWy8rQ+Ik80w: posts small blind $0.10
QvTX2yGq3uKJiKPmns4TKQ: posts big blind $0.25
*** HOLE CARDS ***
iUgsn+WyKFjjVd+tj13R2w: calls $0.25
9jSiy0meE9XJKkdIZwyTEQ: folds 
gqW2aBCmrIw65BvwjTFN6Q: raises $1 to $1.25
cHhVLDikFlByGGN+CM3w/A: folds 
x9VGscBU5oUWy8rQ+Ik80w: folds 
QvTX2yGq3uKJiKPmns4TKQ: folds 
iUgsn+WyKFjjVd+tj13R2w: calls $1
*** FLOP *** [8s 4d Ad]
iUgsn+WyKFjjVd+tj13R2w: checks 
gqW2aBCmrIw65BvwjTFN6Q: bets $2
iUgsn+WyKFjjVd+tj13R2w: folds 
Uncalled bet ($2) returned to gqW2aBCmrIw65BvwjTFN6Q
gqW2aBCmrIw65BvwjTFN6Q collected $2.75 from pot
gqW2aBCmrIw65BvwjTFN6Q: doesn't show hand 
*** SUMMARY ***
Total pot $2.85 | Rake $0.10 
Board [8s 4d Ad]
Seat 1: 9jSiy0meE9XJKkdIZwyTEQ folded before Flop (didn't bet)
Seat 2: gqW2aBCmrIw65BvwjTFN6Q collected ($2.75)
Seat 3: cHhVLDikFlByGGN+CM3w/A (button) folded before Flop (didn't bet)
Seat 4: x9VGscBU5oUWy8rQ+Ik80w (small blind) folded before Flop
Seat 5: QvTX2yGq3uKJiKPmns4TKQ (big blind) folded before Flop
Seat 6: iUgsn+WyKFjjVd+tj13R2w folded on the Flop




PokerStars Game #59939711554:  Hold'em No Limit ($0.10/$0.25) - 2009/07/01 0:46:57 ET
Table 'fIMYcWwN4/aXFJvH5Z8Ymg' 6-max Seat #5 is the button
Seat 1: 64ZeDpsBsP594VsWmafRTQ ($8.20 in chips) 
Seat 2: vu2kzHaDtgr6NM7rdq0chA ($28.90 in chips) 
Seat 3: bWbV4MVB/vVpiES1Ut4hew ($46.25 in chips) 
Seat 4: 32YL2ZEp8NT4JB2RVM9euQ ($42.55 in chips) 
Seat 5: 9jSiy0meE9XJKkdIZwyTEQ ($32.05 in chips) 
Seat 6: jp34e617tIzV8tKIWmfAbA ($25.10 in chips) 
jp34e617tIzV8tKIWmfAbA: posts small blind $0.10
64ZeDpsBsP594VsWmafRTQ: posts big blind $0.25
*** HOLE CARDS ***
vu2kzHaDtgr6NM7rdq0chA: folds 
bWbV4MVB/vVpiES1Ut4hew: folds 
32YL2ZEp8NT4JB2RVM9euQ: folds 
9jSiy0meE9XJKkdIZwyTEQ: folds 
jp34e617tIzV8tKIWmfAbA: folds 
Uncalled bet ($0.15) returned to 64ZeDpsBsP594VsWmafRTQ
64ZeDpsBsP594VsWmafRTQ collected $0.20 from pot
*** SUMMARY ***
Total pot $0.20 | Rake $0 
Seat 1: 64ZeDpsBsP594VsWmafRTQ (big blind) collected ($0.20)
Seat 2: vu2kzHaDtgr6NM7rdq0chA folded before Flop (didn't bet)
Seat 3: bWbV4MVB/vVpiES1Ut4hew folded before Flop (didn't bet)
Seat 4: 32YL2ZEp8NT4JB2RVM9euQ folded before Flop (didn't bet)
Seat 5: 9jSiy0meE9XJKkdIZwyTEQ (button) folded before Flop (didn't bet)
Seat 6: jp34e617tIzV8tKIWmfAbA (small blind) folded before Flop




PokerStars Game #59939711772:  Hold'em No Limit ($0.10/$0.25) - 2009/07/01 0:46:57 ET
Table 'sDHjMRwfSiz7+NDdZLUiyA' 9-max Seat #6 is the button
Seat 1: N6fYvIzQLKaydFLKQGtMlQ ($24.40 in chips) 
Seat 2: ljemhp25Zg+nlA9DLCIiUw ($27.15 in chips) 
Seat 3: SGA1WpAnQxFdFAYyt362gQ ($15.30 in chips) 
Seat 4: v5jnQ1gfh9nLla3kMXG7Yg ($16.30 in chips) 
Seat 5: IGRfskE1v9H9Bn+fz8AgNQ ($26.30 in chips) 
Seat 6: DlXs37dlX3tb7o/7lYXQSw ($24.65 in chips) 
Seat 7: K0b5wNInj6hUGRr6yzKFtw ($28.65 in chips) 
Seat 8: 3hMkm4U5yTRrkGJkxfijaQ ($28.05 in chips) 
Seat 9: Xpyqpb+DURDWnyJ3xTEIFQ ($41.40 in chips) 
K0b5wNInj6hUGRr6yzKFtw: posts small blind $0.10
3hMkm4U5yTRrkGJkxfijaQ: posts big blind $0.25
*** HOLE CARDS ***
Xpyqpb+DURDWnyJ3xTEIFQ: raises $0.75 to $1
N6fYvIzQLKaydFLKQGtMlQ: folds 
ljemhp25Zg+nlA9DLCIiUw: folds 
SGA1WpAnQxFdFAYyt362gQ: folds 
v5jnQ1gfh9nLla3kMXG7Yg: folds 
IGRfskE1v9H9Bn+fz8AgNQ: folds 
DlXs37dlX3tb7o/7lYXQSw: folds 
K0b5wNInj6hUGRr6yzKFtw: folds 
3hMkm4U5yTRrkGJkxfijaQ: folds 
Uncalled bet ($0.75) returned to Xpyqpb+DURDWnyJ3xTEIFQ
Xpyqpb+DURDWnyJ3xTEIFQ collected $0.60 from pot
Xpyqpb+DURDWnyJ3xTEIFQ leaves the table
*** SUMMARY ***
Total pot $0.60 | Rake $0 
Seat 1: N6fYvIzQLKaydFLKQGtMlQ folded before Flop (didn't bet)
Seat 2: ljemhp25Zg+nlA9DLCIiUw folded before Flop (didn't bet)
Seat 3: SGA1WpAnQxFdFAYyt362gQ folded before Flop (didn't bet)
Seat 4: v5jnQ1gfh9nLla3kMXG7Yg folded before Flop (didn't bet)
Seat 5: IGRfskE1v9H9Bn+fz8AgNQ folded before Flop (didn't bet)
Seat 6: DlXs37dlX3tb7o/7lYXQSw (button) folded before Flop (didn't bet)
Seat 7: K0b5wNInj6hUGRr6yzKFtw (small blind) folded before Flop
Seat 8: 3hMkm4U5yTRrkGJkxfijaQ (big blind) folded before Flop
Seat 9: Xpyqpb+DURDWnyJ3xTEIFQ collected ($0.60)




PokerStars Game #59939712206:  Hold'em No Limit ($0.10/$0.25) - 2009/07/01 0:46:58 ET
Table 'AHkg4ChqzcMauBx6Qvz8Nw' 6-max Seat #6 is the button
Seat 1: 4kWQxGbT5FZ1dkPd1bE45Q ($25 in chips) 
Seat 2: /bjna2FTN7pPjqYGzmDE0Q ($23.90 in chips) 
Seat 3: wvIIdlbCgePONQwXjx9xzQ ($5.60 in chips) 
Seat 4: N7O9jUEx2YiQn1+yRYTHmw ($40.20 in chips) 
Seat 5: LtASJ9OlkqGrrUKGQlpGAw ($36.35 in chips) 
Seat 6: SFmT9ZsVopnukjvAzrxTRg ($53.85 in chips) 
4kWQxGbT5FZ1dkPd1bE45Q: posts small blind $0.10
/bjna2FTN7pPjqYGzmDE0Q: posts big blind $0.25
*** HOLE CARDS ***
wvIIdlbCgePONQwXjx9xzQ: folds 
N7O9jUEx2YiQn1+yRYTHmw: folds 
LtASJ9OlkqGrrUKGQlpGAw: folds 
SFmT9ZsVopnukjvAzrxTRg: raises $0.75 to $1
4kWQxGbT5FZ1dkPd1bE45Q: folds 
/bjna2FTN7pPjqYGzmDE0Q: folds 
Uncalled bet ($0.75) returned to SFmT9ZsVopnukjvAzrxTRg
SFmT9ZsVopnukjvAzrxTRg collected $0.60 from pot
SFmT9ZsVopnukjvAzrxTRg: doesn't show hand 
*** SUMMARY ***
Total pot $0.60 | Rake $0 
Seat 1: 4kWQxGbT5FZ1dkPd1bE45Q (small blind) folded before Flop
Seat 2: /bjna2FTN7pPjqYGzmDE0Q (big blind) folded before Flop
Seat 3: wvIIdlbCgePONQwXjx9xzQ folded before Flop (didn't bet)
Seat 4: N7O9jUEx2YiQn1+yRYTHmw folded before Flop (didn't bet)
Seat 5: LtASJ9OlkqGrrUKGQlpGAw folded before Flop (didn't bet)
Seat 6: SFmT9ZsVopnukjvAzrxTRg (button) collected ($0.60)




PokerStars Game #59939712268:  Hold'em No Limit ($0.10/$0.25) - 2009/07/01 0:46:58 ET
Table 'NfXsh0UQA+o/kO9acV3WxA' 9-max Seat #8 is the button
Seat 1: H5Se03ZqSX7tbULXur2MAg ($27.95 in chips) 
Seat 4: sQ6szDwWrE+LMh1p4dVexA ($16.75 in chips) 
Seat 5: 3RCAkueG3Vc13VpRStCB+w ($34.55 in chips) 
Seat 7: HPEB+AtKw1+C/cxU0o1ciw ($31.25 in chips) 
Seat 8: +sbyWwIcFp9kP0bDtMegfQ ($24.30 in chips) 
H5Se03ZqSX7tbULXur2MAg: posts small blind $0.10
sQ6szDwWrE+LMh1p4dVexA: posts big blind $0.25
*** HOLE CARDS ***
3RCAkueG3Vc13VpRStCB+w: folds 
HPEB+AtKw1+C/cxU0o1ciw: folds 
+sbyWwIcFp9kP0bDtMegfQ: raises $0.75 to $1
H5Se03ZqSX7tbULXur2MAg: folds 
sQ6szDwWrE+LMh1p4dVexA: folds 
Uncalled bet ($0.75) returned to +sbyWwIcFp9kP0bDtMegfQ
+sbyWwIcFp9kP0bDtMegfQ collected $0.60 from pot
*** SUMMARY ***
Total pot $0.60 | Rake $0 
Seat 1: H5Se03ZqSX7tbULXur2MAg (small blind) folded before Flop
Seat 4: sQ6szDwWrE+LMh1p4dVexA (big blind) folded before Flop
Seat 5: 3RCAkueG3Vc13VpRStCB+w folded before Flop (didn't bet)
Seat 7: HPEB+AtKw1+C/cxU0o1ciw folded before Flop (didn't bet)
Seat 8: +sbyWwIcFp9kP0bDtMegfQ (button) collected ($0.60)




PokerStars Game #59939711938:  Hold'em No Limit ($0.10/$0.25) - 2009/07/01 0:46:58 ET
Table 'SgI2Cobdjtkh0Fd0/eTTDg' 9-max Seat #7 is the button
Seat 1: NcPAt5YjVvDFEJTTgAVj8g ($15 in chips) 
Seat 2: 8B/dhbQjIWe6ASCdgzktNQ ($45.35 in chips) 
Seat 3: OiV1PWZ3IkN29JlmCcnTwQ ($4.55 in chips) 
Seat 4: 18G4P1XstjNvItdGUITxgw ($25 in chips) 
Seat 5: w/RUHfVzKTf7Bc19nucLpQ ($18.10 in chips) 
Seat 7: aJy680tKSaP5er559aSuGA ($16.50 in chips) 
Seat 9: cZ99hugmLBj9KhTlc8nCSw ($25 in chips) 
cZ99hugmLBj9KhTlc8nCSw: posts small blind $0.10
NcPAt5YjVvDFEJTTgAVj8g: posts big blind $0.25
6RiVTYll/5D8zICp0MRpKw: sits out 
*** HOLE CARDS ***
8B/dhbQjIWe6ASCdgzktNQ: folds 
OiV1PWZ3IkN29JlmCcnTwQ: folds 
18G4P1XstjNvItdGUITxgw: folds 
w/RUHfVzKTf7Bc19nucLpQ: folds 
aJy680tKSaP5er559aSuGA: folds 
cZ99hugmLBj9KhTlc8nCSw: folds 
Uncalled bet ($0.15) returned to NcPAt5YjVvDFEJTTgAVj8g
NcPAt5YjVvDFEJTTgAVj8g collected $0.20 from pot
*** SUMMARY ***
Total pot $0.20 | Rake $0 
Seat 1: NcPAt5YjVvDFEJTTgAVj8g (big blind) collected ($0.20)
Seat 2: 8B/dhbQjIWe6ASCdgzktNQ folded before Flop (didn't bet)
Seat 3: OiV1PWZ3IkN29JlmCcnTwQ folded before Flop (didn't bet)
Seat 4: 18G4P1XstjNvItdGUITxgw folded before Flop (didn't bet)
Seat 5: w/RUHfVzKTf7Bc19nucLpQ folded before Flop (didn't bet)
Seat 7: aJy680tKSaP5er559aSuGA (button) folded before Flop (didn't bet)
Seat 9: cZ99hugmLBj9KhTlc8nCSw (small blind) folded before Flop




PokerStars Game #59939712034:  Hold'em No Limit ($0.10/$0.25) - 2009/07/01 0:46:58 ET
Table 'i8VqsSY3xDtJ63IHleN8+A' 9-max Seat #7 is the button
Seat 1: D3XCkXRktDfPlSguxwfnRA ($14.90 in chips) 
Seat 2: SXqVW4Q0evTUVZG6BbUNIA ($46.50 in chips) 
Seat 3: HPEB+AtKw1+C/cxU0o1ciw ($55.85 in chips) 
Seat 4: G2offPrpnppc++nuXqs2JA ($14.65 in chips) 
Seat 5: DIBbjEYGs+TVdVgEB/4+3w ($25.05 in chips) 
Seat 7: j4q3p0lesp63b1gZDwLBZw ($5.25 in chips) 
Seat 9: vSkQm2EelzwRGDDQQk0Fqw ($7.55 in chips) 
vSkQm2EelzwRGDDQQk0Fqw: posts small blind $0.10
D3XCkXRktDfPlSguxwfnRA: posts big blind $0.25
*** HOLE CARDS ***
SXqVW4Q0evTUVZG6BbUNIA: raises $0.75 to $1
HPEB+AtKw1+C/cxU0o1ciw: folds 
G2offPrpnppc++nuXqs2JA: folds 
DIBbjEYGs+TVdVgEB/4+3w: folds 
j4q3p0lesp63b1gZDwLBZw: raises $1.75 to $2.75
vSkQm2EelzwRGDDQQk0Fqw: folds 
D3XCkXRktDfPlSguxwfnRA: folds 
SXqVW4Q0evTUVZG6BbUNIA: calls $1.75
*** FLOP *** [3d 2c 7s]
SXqVW4Q0evTUVZG6BbUNIA: bets $3
j4q3p0lesp63b1gZDwLBZw: calls $2.50 and is all-in
Uncalled bet ($0.50) returned to SXqVW4Q0evTUVZG6BbUNIA
*** TURN *** [3d 2c 7s] [4d]
*** RIVER *** [3d 2c 7s 4d] [5h]
*** SHOW DOWN ***
SXqVW4Q0evTUVZG6BbUNIA: shows [Th Td] (a pair of Tens)
j4q3p0lesp63b1gZDwLBZw: shows [Qc Qh] (a pair of Queens)
j4q3p0lesp63b1gZDwLBZw collected $10.35 from pot
*** SUMMARY ***
Total pot $10.85 | Rake $0.50 
Board [3d 2c 7s 4d 5h]
Seat 1: D3XCkXRktDfPlSguxwfnRA (big blind) folded before Flop
Seat 2: SXqVW4Q0evTUVZG6BbUNIA showed [Th Td] and lost with a pair of Tens
Seat 3: HPEB+AtKw1+C/cxU0o1ciw folded before Flop (didn't bet)
Seat 4: G2offPrpnppc++nuXqs2JA folded before Flop (didn't bet)
Seat 5: DIBbjEYGs+TVdVgEB/4+3w folded before Flop (didn't bet)
Seat 7: j4q3p0lesp63b1gZDwLBZw (button) showed [Qc Qh] and won ($10.35) with a pair of Queens
Seat 9: vSkQm2EelzwRGDDQQk0Fqw (small blind) folded before Flop




PokerStars Game #59939712598:  Hold'em No Limit ($0.10/$0.25) - 2009/07/01 0:46:59 ET
Table 'JPFXJXa5xBkjZ/W15BKqeQ' 9-max Seat #6 is the button
Seat 1: hPhp/RE3cJ5YGaQ2xOHXXg ($5.35 in chips) 
Seat 2: 1/f3/SJ8XpIW1Ek97d1xUw ($11.05 in chips) 
Seat 3: 56S3mA6Zs3pGR+0p0vUCtg ($26.80 in chips) 
Seat 4: VBHxUExRAMrbxUq/cVx9Gw ($5.25 in chips) 
Seat 5: cZ99hugmLBj9KhTlc8nCSw ($25.60 in chips) 
Seat 6: DdPXdieucQ+n99u1n3A+rQ ($5.10 in chips) 
Seat 8: zDrucyjVn5aeekNEc3cJrA ($22.25 in chips) 
zDrucyjVn5aeekNEc3cJrA: posts small blind $0.10
uH1RN27w9SKa7TpVR9EFrQ: is sitting out 
uH1RN27w9SKa7TpVR9EFrQ leaves the table
hPhp/RE3cJ5YGaQ2xOHXXg: posts big blind $0.25
*** HOLE CARDS ***
1/f3/SJ8XpIW1Ek97d1xUw: folds 
56S3mA6Zs3pGR+0p0vUCtg: folds 
VBHxUExRAMrbxUq/cVx9Gw: folds 
cZ99hugmLBj9KhTlc8nCSw: folds 
DdPXdieucQ+n99u1n3A+rQ: folds 
zDrucyjVn5aeekNEc3cJrA: folds 
Uncalled bet ($0.15) returned to hPhp/RE3cJ5YGaQ2xOHXXg
hPhp/RE3cJ5YGaQ2xOHXXg collected $0.20 from pot
hPhp/RE3cJ5YGaQ2xOHXXg: doesn't show hand 
*** SUMMARY ***
Total pot $0.20 | Rake $0 
Seat 1: hPhp/RE3cJ5YGaQ2xOHXXg (big blind) collected ($0.20)
Seat 2: 1/f3/SJ8XpIW1Ek97d1xUw folded before Flop (didn't bet)
Seat 3: 56S3mA6Zs3pGR+0p0vUCtg folded before Flop (didn't bet)
Seat 4: VBHxUExRAMrbxUq/cVx9Gw folded before Flop (didn't bet)
Seat 5: cZ99hugmLBj9KhTlc8nCSw folded before Flop (didn't bet)
Seat 6: DdPXdieucQ+n99u1n3A+rQ (button) folded before Flop (didn't bet)
Seat 8: zDrucyjVn5aeekNEc3cJrA (small blind) folded before Flop




PokerStars Game #59939712790:  Hold'em No Limit ($0.10/$0.25) - 2009/07/01 0:46:59 ET
Table 'z2yOdY2zyGWG1gh9WV9XtQ' 9-max Seat #6 is the button
Seat 1: k/tPF1MnFJtmPS14iqcejw ($29.60 in chips) 
Seat 2: s7Q6uNouhe7aE8JdFb9E+A ($25 in chips) 
Seat 4: BMTbQu92kfh1+tEQba3Flw ($15.80 in chips) 
Seat 5: DYB0aP91n+Rg/TIhycbaPQ ($15.45 in chips) 
Seat 6: vZGoOTJLQLhkPj4I+LNGig ($27.75 in chips) 
Seat 7: zDrucyjVn5aeekNEc3cJrA ($26.20 in chips) 
Seat 8: hIss79a4pu7GzJZepfgOpg ($26.25 in chips) 
zDrucyjVn5aeekNEc3cJrA: posts small blind $0.10
hIss79a4pu7GzJZepfgOpg: posts big blind $0.25
aPRz/2GxbXANYpVsQO8pdQ: sits out 
MIVCHqCqqlke0Lb0z7glcw: sits out 
*** HOLE CARDS ***
k/tPF1MnFJtmPS14iqcejw: folds 
s7Q6uNouhe7aE8JdFb9E+A: folds 
BMTbQu92kfh1+tEQba3Flw: folds 
DYB0aP91n+Rg/TIhycbaPQ: calls $0.25
vZGoOTJLQLhkPj4I+LNGig: folds 
zDrucyjVn5aeekNEc3cJrA: calls $0.15
hIss79a4pu7GzJZepfgOpg: checks 
*** FLOP *** [Ah Kc 2s]
zDrucyjVn5aeekNEc3cJrA: checks 
hIss79a4pu7GzJZepfgOpg: checks 
DYB0aP91n+Rg/TIhycbaPQ: bets $0.25
zDrucyjVn5aeekNEc3cJrA: folds 
hIss79a4pu7GzJZepfgOpg: folds 
Uncalled bet ($0.25) returned to DYB0aP91n+Rg/TIhycbaPQ
DYB0aP91n+Rg/TIhycbaPQ collected $0.75 from pot
DYB0aP91n+Rg/TIhycbaPQ: doesn't show hand 
*** SUMMARY ***
Total pot $0.75 | Rake $0 
Board [Ah Kc 2s]
Seat 1: k/tPF1MnFJtmPS14iqcejw folded before Flop (didn't bet)
Seat 2: s7Q6uNouhe7aE8JdFb9E+A folded before Flop (didn't bet)
Seat 4: BMTbQu92kfh1+tEQba3Flw folded before Flop (didn't bet)
Seat 5: DYB0aP91n+Rg/TIhycbaPQ collected ($0.75)
Seat 6: vZGoOTJLQLhkPj4I+LNGig (button) folded before Flop (didn't bet)
Seat 7: zDrucyjVn5aeekNEc3cJrA (small blind) folded on the Flop
Seat 8: hIss79a4pu7GzJZepfgOpg (big blind) folded on the Flop




PokerStars Game #59939713108:  Hold'em No Limit ($0.10/$0.25) - 2009/07/01 0:46:59 ET
Table '9iHhO6FyZVM8XpSc23TIgg' 6-max Seat #4 is the button
Seat 1: NhUN/JpAprdJeamFBgJH1w ($25 in chips) 
Seat 2: ErIN0JRL5srYjT6en1f8YQ ($30.80 in chips) 
Seat 4: cfJccEfyn6IkquPN08hFsA ($36.85 in chips) 
Seat 5: WmfI+HZXhME/HMG8E3/H2w ($31.10 in chips) 
Seat 6: WrLI51S2iMb8GLMB83gGqA ($25 in chips) 
WmfI+HZXhME/HMG8E3/H2w: posts small blind $0.10
WrLI51S2iMb8GLMB83gGqA: posts big blind $0.25
RYLaAIIwK9wxkPswt1yJYw: sits out 
*** HOLE CARDS ***
NhUN/JpAprdJeamFBgJH1w: folds 
ErIN0JRL5srYjT6en1f8YQ: folds 
cfJccEfyn6IkquPN08hFsA: folds 
WmfI+HZXhME/HMG8E3/H2w: raises $1 to $1.25
WrLI51S2iMb8GLMB83gGqA: calls $1
*** FLOP *** [Kc 7s 5h]
WmfI+HZXhME/HMG8E3/H2w: bets $1.25
WrLI51S2iMb8GLMB83gGqA: folds 
Uncalled bet ($1.25) returned to WmfI+HZXhME/HMG8E3/H2w
WmfI+HZXhME/HMG8E3/H2w collected $2.40 from pot
*** SUMMARY ***
Total pot $2.50 | Rake $0.10 
Board [Kc 7s 5h]
Seat 1: NhUN/JpAprdJeamFBgJH1w folded before Flop (didn't bet)
Seat 2: ErIN0JRL5srYjT6en1f8YQ folded before Flop (didn't bet)
Seat 4: cfJccEfyn6IkquPN08hFsA (button) folded before Flop (didn't bet)
Seat 5: WmfI+HZXhME/HMG8E3/H2w (small blind) collected ($2.40)
Seat 6: WrLI51S2iMb8GLMB83gGqA (big blind) folded on the Flop




PokerStars Game #59939712836:  Hold'em No Limit ($0.10/$0.25) - 2009/07/01 0:46:59 ET
Table 'fIrOIN3HoXM27ZpRwKa6oA' 6-max Seat #6 is the button
Seat 1: I1TxPvWj8NfG8orglCinNA ($38.60 in chips) 
Seat 2: 5tB0F9NjPSUL4FzmzBMs2Q ($39.65 in chips) 
Seat 3: eSKnWz2RD4rvwnvB+rFzIg ($25.35 in chips) 
Seat 5: 8ClCHtFXGNplITm+63KB+Q ($26.10 in chips) 
Seat 6: v+QfkGiuj9bgtuNoVnDO8w ($28.50 in chips) 
I1TxPvWj8NfG8orglCinNA: posts small blind $0.10
5tB0F9NjPSUL4FzmzBMs2Q: posts big blind $0.25
*** HOLE CARDS ***
eSKnWz2RD4rvwnvB+rFzIg: folds 
8ClCHtFXGNplITm+63KB+Q: folds 
v+QfkGiuj9bgtuNoVnDO8w: folds 
I1TxPvWj8NfG8orglCinNA: folds 
Uncalled bet ($0.15) returned to 5tB0F9NjPSUL4FzmzBMs2Q
5tB0F9NjPSUL4FzmzBMs2Q collected $0.20 from pot
5tB0F9NjPSUL4FzmzBMs2Q: doesn't show hand 
*** SUMMARY ***
Total pot $0.20 | Rake $0 
Seat 1: I1TxPvWj8NfG8orglCinNA (small blind) folded before Flop
Seat 2: 5tB0F9NjPSUL4FzmzBMs2Q (big blind) collected ($0.20)
Seat 3: eSKnWz2RD4rvwnvB+rFzIg folded before Flop (didn't bet)
Seat 5: 8ClCHtFXGNplITm+63KB+Q folded before Flop (didn't bet)
Seat 6: v+QfkGiuj9bgtuNoVnDO8w (button) folded before Flop (didn't bet)




PokerStars Game #59939712718:  Hold'em No Limit ($0.10/$0.25) - 2009/07/01 0:46:59 ET
Table 'a6FCGVBMPcT7J7BDN9q1zQ' 9-max Seat #7 is the button
Seat 1: s7Q6uNouhe7aE8JdFb9E+A ($44.10 in chips) 
Seat 2: h4ggJZYBXV0mEZzYPYKfeA ($34 in chips) 
Seat 3: hIss79a4pu7GzJZepfgOpg ($28.75 in chips) 
Seat 4: ydoFOVgzvZv9ZhuWu9rXAw ($5.50 in chips) 
Seat 5: dtZ84flFEi4Q+SGrHMJRDQ ($25 in chips) 
Seat 6: Z9AeOQX3yzuSvKAm/xyovg ($9.30 in chips) 
Seat 7: V0Yo5zRBVM8DYspLKafebg ($28.30 in chips) 
Seat 8: r6hsffOo1iKmaPYKwAZmFw ($49.85 in chips) 
Seat 9: WwcXelmo9g129XJixVb2NA ($15.85 in chips) 
r6hsffOo1iKmaPYKwAZmFw: posts small blind $0.10
WwcXelmo9g129XJixVb2NA: posts big blind $0.25
dtZ84flFEi4Q+SGrHMJRDQ: posts big blind $0.25
*** HOLE CARDS ***
s7Q6uNouhe7aE8JdFb9E+A: folds 
h4ggJZYBXV0mEZzYPYKfeA: folds 
hIss79a4pu7GzJZepfgOpg: folds 
ydoFOVgzvZv9ZhuWu9rXAw: folds 
dtZ84flFEi4Q+SGrHMJRDQ: checks 
Z9AeOQX3yzuSvKAm/xyovg: folds 
V0Yo5zRBVM8DYspLKafebg: calls $0.25
r6hsffOo1iKmaPYKwAZmFw: calls $0.15
WwcXelmo9g129XJixVb2NA: checks 
*** FLOP *** [2s 9c 8h]
r6hsffOo1iKmaPYKwAZmFw: checks 
WwcXelmo9g129XJixVb2NA: bets $0.25
dtZ84flFEi4Q+SGrHMJRDQ: folds 
V0Yo5zRBVM8DYspLKafebg: calls $0.25
r6hsffOo1iKmaPYKwAZmFw: calls $0.25
*** TURN *** [2s 9c 8h] [As]
r6hsffOo1iKmaPYKwAZmFw: bets $1.25
WwcXelmo9g129XJixVb2NA: folds 
V0Yo5zRBVM8DYspLKafebg: calls $1.25
*** RIVER *** [2s 9c 8h As] [8c]
r6hsffOo1iKmaPYKwAZmFw: bets $10
V0Yo5zRBVM8DYspLKafebg: folds 
Uncalled bet ($10) returned to r6hsffOo1iKmaPYKwAZmFw
r6hsffOo1iKmaPYKwAZmFw collected $4.05 from pot
r6hsffOo1iKmaPYKwAZmFw: doesn't show hand 
*** SUMMARY ***
Total pot $4.25 | Rake $0.20 
Board [2s 9c 8h As 8c]
Seat 1: s7Q6uNouhe7aE8JdFb9E+A folded before Flop (didn't bet)
Seat 2: h4ggJZYBXV0mEZzYPYKfeA folded before Flop (didn't bet)
Seat 3: hIss79a4pu7GzJZepfgOpg folded before Flop (didn't bet)
Seat 4: ydoFOVgzvZv9ZhuWu9rXAw folded before Flop (didn't bet)
Seat 5: dtZ84flFEi4Q+SGrHMJRDQ folded on the Flop
Seat 6: Z9AeOQX3yzuSvKAm/xyovg folded before Flop (didn't bet)
Seat 7: V0Yo5zRBVM8DYspLKafebg (button) folded on the River
Seat 8: r6hsffOo1iKmaPYKwAZmFw (small blind) collected ($4.05)
Seat 9: WwcXelmo9g129XJixVb2NA (big blind) folded on the Turn




PokerStars Game #59939712838:  Hold'em No Limit ($0.10/$0.25) - 2009/07/01 0:46:59 ET
Table 'AUM6O+mgQAaLDZKMQ/5/gA' 9-max Seat #1 is the button
Seat 1: Eyuoq9VsHg1Puw0nNzXTjg ($5.10 in chips) 
Seat 2: p0Q0llBV74kraoiHI/UzWA ($28.05 in chips) 
Seat 4: GIv32m/KBYU5WdIHUImuIg ($2.10 in chips) 
Seat 5: +2kMBNpY4nF1qNCRd8SJLA ($25 in chips) 
Seat 6: cFmpjvcjNoVAEAIQIxWkYg ($25 in chips) 
Seat 7: jXz58rvCgq0VjyVjUBf2mw ($25.90 in chips) 
Seat 8: zDrucyjVn5aeekNEc3cJrA ($24.30 in chips) 
Seat 9: er5m2fugFz72ZXh/4+gSDg ($24.65 in chips) 
p0Q0llBV74kraoiHI/UzWA: posts small blind $0.10
GIv32m/KBYU5WdIHUImuIg: posts big blind $0.25
*** HOLE CARDS ***
st9jtdNbm1W5GfBwRaCVqQ joins the table at seat #3 
+2kMBNpY4nF1qNCRd8SJLA: folds 
cFmpjvcjNoVAEAIQIxWkYg: folds 
jXz58rvCgq0VjyVjUBf2mw: folds 
zDrucyjVn5aeekNEc3cJrA: folds 
er5m2fugFz72ZXh/4+gSDg: raises $0.75 to $1
Eyuoq9VsHg1Puw0nNzXTjg: folds 
p0Q0llBV74kraoiHI/UzWA: folds 
GIv32m/KBYU5WdIHUImuIg: raises $1.10 to $2.10 and is all-in
er5m2fugFz72ZXh/4+gSDg: calls $1.10
*** FLOP *** [6h 4s 9h]
*** TURN *** [6h 4s 9h] [Kc]
*** RIVER *** [6h 4s 9h Kc] [3d]
*** SHOW DOWN ***
GIv32m/KBYU5WdIHUImuIg: shows [8s 9c] (a pair of Nines)
er5m2fugFz72ZXh/4+gSDg: shows [Kh As] (a pair of Kings)
er5m2fugFz72ZXh/4+gSDg collected $4.10 from pot
*** SUMMARY ***
Total pot $4.30 | Rake $0.20 
Board [6h 4s 9h Kc 3d]
Seat 1: Eyuoq9VsHg1Puw0nNzXTjg (button) folded before Flop (didn't bet)
Seat 2: p0Q0llBV74kraoiHI/UzWA (small blind) folded before Flop
Seat 4: GIv32m/KBYU5WdIHUImuIg (big blind) showed [8s 9c] and lost with a pair of Nines
Seat 5: +2kMBNpY4nF1qNCRd8SJLA folded before Flop (didn't bet)
Seat 6: cFmpjvcjNoVAEAIQIxWkYg folded before Flop (didn't bet)
Seat 7: jXz58rvCgq0VjyVjUBf2mw folded before Flop (didn't bet)
Seat 8: zDrucyjVn5aeekNEc3cJrA folded before Flop (didn't bet)
Seat 9: er5m2fugFz72ZXh/4+gSDg showed [Kh As] and won ($4.10) with a pair of Kings




PokerStars Game #59939713524:  Hold'em No Limit ($0.10/$0.25) - 2009/07/01 0:47:00 ET
Table 'zKwHJD0cmKNUure9qQTfFg' 6-max Seat #5 is the button
Seat 1: nwwpaieDRI0UPyVtChVHOg ($14.90 in chips) 
Seat 3: ljjhtb6FVPTx9AT9HNdtqg ($14.75 in chips) 
Seat 4: v+QfkGiuj9bgtuNoVnDO8w ($25 in chips) 
Seat 5: I1TxPvWj8NfG8orglCinNA ($29.45 in chips) 
Seat 6: fBpPyuxbg0NbTlQHEs38sA ($16 in chips) 
fBpPyuxbg0NbTlQHEs38sA: posts small blind $0.10
nwwpaieDRI0UPyVtChVHOg: posts big blind $0.25
4kWQxGbT5FZ1dkPd1bE45Q: sits out 
*** HOLE CARDS ***
ljjhtb6FVPTx9AT9HNdtqg: raises $0.50 to $0.75
v+QfkGiuj9bgtuNoVnDO8w: raises $2 to $2.75
I1TxPvWj8NfG8orglCinNA: folds 
fBpPyuxbg0NbTlQHEs38sA: folds 
nwwpaieDRI0UPyVtChVHOg: folds 
ljjhtb6FVPTx9AT9HNdtqg: folds 
Uncalled bet ($2) returned to v+QfkGiuj9bgtuNoVnDO8w
v+QfkGiuj9bgtuNoVnDO8w collected $1.85 from pot
v+QfkGiuj9bgtuNoVnDO8w: doesn't show hand 
*** SUMMARY ***
Total pot $1.85 | Rake $0 
Seat 1: nwwpaieDRI0UPyVtChVHOg (big blind) folded before Flop
Seat 3: ljjhtb6FVPTx9AT9HNdtqg folded before Flop
Seat 4: v+QfkGiuj9bgtuNoVnDO8w collected ($1.85)
Seat 5: I1TxPvWj8NfG8orglCinNA (button) folded before Flop (didn't bet)
Seat 6: fBpPyuxbg0NbTlQHEs38sA (small blind) folded before Flop




PokerStars Game #59939713252:  Hold'em No Limit ($0.10/$0.25) - 2009/07/01 0:47:00 ET
Table 'KEoOIegxPF91KooL2AelUA' 6-max Seat #1 is the button
Seat 1: wsP46AGpqDjHZQmlRHKa9g ($28.90 in chips) 
Seat 2: RYLaAIIwK9wxkPswt1yJYw ($26.60 in chips) 
Seat 3: zxeVQGaMKDsDzmSY+AInjA ($15 in chips) 
Seat 4: Vv37Oa9niKKVcR6Z7ceetw ($22.25 in chips) 
Seat 6: 1YgYdjcEYMhI41phJetI3w ($5 in chips) 
RYLaAIIwK9wxkPswt1yJYw: posts small blind $0.10
zxeVQGaMKDsDzmSY+AInjA: posts big blind $0.25
tburger7: sits out 
1YgYdjcEYMhI41phJetI3w: posts big blind $0.25
*** HOLE CARDS ***
Vv37Oa9niKKVcR6Z7ceetw: raises $1 to $1.25
1YgYdjcEYMhI41phJetI3w: folds 
wsP46AGpqDjHZQmlRHKa9g: raises $3 to $4.25
RYLaAIIwK9wxkPswt1yJYw: folds 
zxeVQGaMKDsDzmSY+AInjA: folds 
Vv37Oa9niKKVcR6Z7ceetw: folds 
Uncalled bet ($3) returned to wsP46AGpqDjHZQmlRHKa9g
wsP46AGpqDjHZQmlRHKa9g collected $3.10 from pot
*** SUMMARY ***
Total pot $3.10 | Rake $0 
Seat 1: wsP46AGpqDjHZQmlRHKa9g (button) collected ($3.10)
Seat 2: RYLaAIIwK9wxkPswt1yJYw (small blind) folded before Flop
Seat 3: zxeVQGaMKDsDzmSY+AInjA (big blind) folded before Flop
Seat 4: Vv37Oa9niKKVcR6Z7ceetw folded before Flop
Seat 6: 1YgYdjcEYMhI41phJetI3w folded before Flop




PokerStars Game #59939713774:  Hold'em No Limit ($0.10/$0.25) - 2009/07/01 0:47:00 ET
Table '9HJEqVOjSU5ECoVB4C4sgQ' 6-max Seat #6 is the button
Seat 1: SFmT9ZsVopnukjvAzrxTRg ($25 in chips) 
Seat 2: sEQx9G5Cu8k1HNdQasxvUA ($37.50 in chips) 
Seat 3: KM6ogk7SqyRlk3m9b0h+7A ($18.45 in chips) 
Seat 4: mfrkWA3PTeYPkbO6hi98Aw ($30.45 in chips) 
Seat 5: uH0CnA501RcgzNdK3N+BWw ($14.95 in chips) 
Seat 6: aOMbOQ6Ji1Gie6dYOurd5A ($7.90 in chips) 
SFmT9ZsVopnukjvAzrxTRg: posts small blind $0.10
sEQx9G5Cu8k1HNdQasxvUA: posts big blind $0.25
*** HOLE CARDS ***
KM6ogk7SqyRlk3m9b0h+7A: folds 
mfrkWA3PTeYPkbO6hi98Aw: folds 
uH0CnA501RcgzNdK3N+BWw: calls $0.25
aOMbOQ6Ji1Gie6dYOurd5A: calls $0.25
SFmT9ZsVopnukjvAzrxTRg: folds 
sEQx9G5Cu8k1HNdQasxvUA: raises $1.50 to $1.75
uH0CnA501RcgzNdK3N+BWw: folds 
aOMbOQ6Ji1Gie6dYOurd5A: calls $1.50
*** FLOP *** [2h Qc Jd]
sEQx9G5Cu8k1HNdQasxvUA: checks 
aOMbOQ6Ji1Gie6dYOurd5A: bets $6.15 and is all-in
sEQx9G5Cu8k1HNdQasxvUA: calls $6.15
*** TURN *** [2h Qc Jd] [5h]
*** RIVER *** [2h Qc Jd 5h] [9d]
*** SHOW DOWN ***
sEQx9G5Cu8k1HNdQasxvUA: shows [Jc As] (a pair of Jacks)
aOMbOQ6Ji1Gie6dYOurd5A: shows [9s Js] (two pair, Jacks and Nines)
aOMbOQ6Ji1Gie6dYOurd5A collected $15.35 from pot
*** SUMMARY ***
Total pot $16.15 | Rake $0.80 
Board [2h Qc Jd 5h 9d]
Seat 1: SFmT9ZsVopnukjvAzrxTRg (small blind) folded before Flop
Seat 2: sEQx9G5Cu8k1HNdQasxvUA (big blind) showed [Jc As] and lost with a pair of Jacks
Seat 3: KM6ogk7SqyRlk3m9b0h+7A folded before Flop (didn't bet)
Seat 4: mfrkWA3PTeYPkbO6hi98Aw folded before Flop (didn't bet)
Seat 5: uH0CnA501RcgzNdK3N+BWw folded before Flop
Seat 6: aOMbOQ6Ji1Gie6dYOurd5A (button) showed [9s Js] and won ($15.35) with two pair, Jacks and Nines




PokerStars Game #59939713170:  Hold'em No Limit ($0.10/$0.25) - 2009/07/01 0:47:00 ET
Table 'LLHSnYPAXNI1sFlwPBn1tA' 6-max Seat #5 is the button
Seat 1: tVZW8k4GP+PvZ1DjD/9StA ($22.70 in chips) 
Seat 2: oseFhpinoe+Zg4j5xyBjyQ ($22.45 in chips) 
Seat 3: JFIAqU8lCZ0vWwEl4bdGsg ($25 in chips) 
Seat 4: FPlQHZog0ePFCETQ2KG4hQ ($26.85 in chips) 
Seat 5: jXbd3O6QdeNWctmpAsTgHA ($14.10 in chips) 
Seat 6: PCh4iIHq9rXvWY/FeXc/Jg ($31.90 in chips) 
PCh4iIHq9rXvWY/FeXc/Jg: posts small blind $0.10
tVZW8k4GP+PvZ1DjD/9StA: posts big blind $0.25
*** HOLE CARDS ***
oseFhpinoe+Zg4j5xyBjyQ: folds 
JFIAqU8lCZ0vWwEl4bdGsg: folds 
FPlQHZog0ePFCETQ2KG4hQ: folds 
jXbd3O6QdeNWctmpAsTgHA: raises $0.50 to $0.75
PCh4iIHq9rXvWY/FeXc/Jg: folds 
tVZW8k4GP+PvZ1DjD/9StA: folds 
Uncalled bet ($0.50) returned to jXbd3O6QdeNWctmpAsTgHA
jXbd3O6QdeNWctmpAsTgHA collected $0.60 from pot
*** SUMMARY ***
Total pot $0.60 | Rake $0 
Seat 1: tVZW8k4GP+PvZ1DjD/9StA (big blind) folded before Flop
Seat 2: oseFhpinoe+Zg4j5xyBjyQ folded before Flop (didn't bet)
Seat 3: JFIAqU8lCZ0vWwEl4bdGsg folded before Flop (didn't bet)
Seat 4: FPlQHZog0ePFCETQ2KG4hQ folded before Flop (didn't bet)
Seat 5: jXbd3O6QdeNWctmpAsTgHA (button) collected ($0.60)
Seat 6: PCh4iIHq9rXvWY/FeXc/Jg (small blind) folded before Flop




PokerStars Game #59939714172:  Hold'em No Limit ($0.10/$0.25) - 2009/07/01 0:47:01 ET
Table 'mF3KHGMaTpaBZbtBoyfTeg' 6-max Seat #2 is the button
Seat 1: 0HAB2GdCAM7p7V00xueAVQ ($8.30 in chips) 
Seat 2: 4x9jCqgSw4272dnaIqnanw ($4 in chips) 
Seat 3: Hzrn9DZJegEZICufTNYkrg ($13.15 in chips) 
Seat 4: FYepjhAvF8ZdVCmqHIy+eQ ($25 in chips) 
Seat 5: sEQx9G5Cu8k1HNdQasxvUA ($40.50 in chips) 
Seat 6: kG34n23qFQA3nzdOJTQ1dA ($24.65 in chips) 
Hzrn9DZJegEZICufTNYkrg: posts small blind $0.10
FYepjhAvF8ZdVCmqHIy+eQ: posts big blind $0.25
*** HOLE CARDS ***
sEQx9G5Cu8k1HNdQasxvUA: calls $0.25
kG34n23qFQA3nzdOJTQ1dA: calls $0.25
0HAB2GdCAM7p7V00xueAVQ: folds 
4x9jCqgSw4272dnaIqnanw: calls $0.25
Hzrn9DZJegEZICufTNYkrg: folds 
FYepjhAvF8ZdVCmqHIy+eQ: checks 
*** FLOP *** [Js 7s 7h]
FYepjhAvF8ZdVCmqHIy+eQ: checks 
sEQx9G5Cu8k1HNdQasxvUA: bets $1
kG34n23qFQA3nzdOJTQ1dA: folds 
4x9jCqgSw4272dnaIqnanw: folds 
FYepjhAvF8ZdVCmqHIy+eQ: folds 
Uncalled bet ($1) returned to sEQx9G5Cu8k1HNdQasxvUA
sEQx9G5Cu8k1HNdQasxvUA collected $1.05 from pot
sEQx9G5Cu8k1HNdQasxvUA: doesn't show hand 
*** SUMMARY ***
Total pot $1.10 | Rake $0.05 
Board [Js 7s 7h]
Seat 1: 0HAB2GdCAM7p7V00xueAVQ folded before Flop (didn't bet)
Seat 2: 4x9jCqgSw4272dnaIqnanw (button) folded on the Flop
Seat 3: Hzrn9DZJegEZICufTNYkrg (small blind) folded before Flop
Seat 4: FYepjhAvF8ZdVCmqHIy+eQ (big blind) folded on the Flop
Seat 5: sEQx9G5Cu8k1HNdQasxvUA collected ($1.05)
Seat 6: kG34n23qFQA3nzdOJTQ1dA folded on the Flop




PokerStars Game #59939714174:  Hold'em No Limit ($0.10/$0.25) - 2009/07/01 0:47:01 ET
Table 'QegsWX65l3n/K0A8XB78yg' 6-max Seat #6 is the button
Seat 1: 8ClCHtFXGNplITm+63KB+Q ($28.35 in chips) 
Seat 2: GC/9yVD59DUCX7hUI7gcLw ($32.55 in chips) 
Seat 3: 9jSiy0meE9XJKkdIZwyTEQ ($26.65 in chips) 
Seat 4: kyRaCIljYA6l33lSKQfNsg ($25.35 in chips) 
Seat 5: 4YSTu0Cdzpppe1lUgCZGCQ ($57.45 in chips) 
Seat 6: JE/wJXmjw3bpdmjwvh2pcg ($35.65 in chips) 
8ClCHtFXGNplITm+63KB+Q: posts small blind $0.10
GC/9yVD59DUCX7hUI7gcLw: posts big blind $0.25
*** HOLE CARDS ***
9jSiy0meE9XJKkdIZwyTEQ: folds 
kyRaCIljYA6l33lSKQfNsg: raises $0.50 to $0.75
4YSTu0Cdzpppe1lUgCZGCQ: folds 
JE/wJXmjw3bpdmjwvh2pcg: folds 
8ClCHtFXGNplITm+63KB+Q: folds 
GC/9yVD59DUCX7hUI7gcLw: folds 
Uncalled bet ($0.50) returned to kyRaCIljYA6l33lSKQfNsg
kyRaCIljYA6l33lSKQfNsg collected $0.60 from pot
*** SUMMARY ***
Total pot $0.60 | Rake $0 
Seat 1: 8ClCHtFXGNplITm+63KB+Q (small blind) folded before Flop
Seat 2: GC/9yVD59DUCX7hUI7gcLw (big blind) folded before Flop
Seat 3: 9jSiy0meE9XJKkdIZwyTEQ folded before Flop (didn't bet)
Seat 4: kyRaCIljYA6l33lSKQfNsg collected ($0.60)
Seat 5: 4YSTu0Cdzpppe1lUgCZGCQ folded before Flop (didn't bet)
Seat 6: JE/wJXmjw3bpdmjwvh2pcg (button) folded before Flop (didn't bet)




PokerStars Game #59939714304:  Hold'em No Limit ($0.10/$0.25) - 2009/07/01 0:47:01 ET
Table 'Ok3oDLIsTc2+KxPcI0bAOA' 6-max Seat #5 is the button
Seat 1: agQm3ugZ3qSVYNgNu1ddeA ($26.90 in chips) 
Seat 2: oseFhpinoe+Zg4j5xyBjyQ ($31.35 in chips) 
Seat 3: I1TxPvWj8NfG8orglCinNA ($25 in chips) 
Seat 4: AelnLvAynaZZ+KfVuqHhag ($5 in chips) 
Seat 5: nc79pm0LZRdhncq55evVqA ($27.80 in chips) 
Seat 6: JFIAqU8lCZ0vWwEl4bdGsg ($42.15 in chips) 
JFIAqU8lCZ0vWwEl4bdGsg: posts small blind $0.10
agQm3ugZ3qSVYNgNu1ddeA: posts big blind $0.25
AelnLvAynaZZ+KfVuqHhag: posts big blind $0.25
*** HOLE CARDS ***
oseFhpinoe+Zg4j5xyBjyQ: folds 
I1TxPvWj8NfG8orglCinNA has timed out
I1TxPvWj8NfG8orglCinNA: folds 
I1TxPvWj8NfG8orglCinNA is sitting out
AelnLvAynaZZ+KfVuqHhag: raises $0.50 to $0.75
nc79pm0LZRdhncq55evVqA: folds 
JFIAqU8lCZ0vWwEl4bdGsg: folds 
I1TxPvWj8NfG8orglCinNA has returned
agQm3ugZ3qSVYNgNu1ddeA: folds 
Uncalled bet ($0.50) returned to AelnLvAynaZZ+KfVuqHhag
AelnLvAynaZZ+KfVuqHhag collected $0.60 from pot
AelnLvAynaZZ+KfVuqHhag: doesn't show hand 
*** SUMMARY ***
Total pot $0.60 | Rake $0 
Seat 1: agQm3ugZ3qSVYNgNu1ddeA (big blind) folded before Flop
Seat 2: oseFhpinoe+Zg4j5xyBjyQ folded before Flop (didn't bet)
Seat 3: I1TxPvWj8NfG8orglCinNA folded before Flop (didn't bet)
Seat 4: AelnLvAynaZZ+KfVuqHhag collected ($0.60)
Seat 5: nc79pm0LZRdhncq55evVqA (button) folded before Flop (didn't bet)
Seat 6: JFIAqU8lCZ0vWwEl4bdGsg (small blind) folded before Flop




PokerStars Game #59939714382:  Hold'em No Limit ($0.10/$0.25) - 2009/07/01 0:47:01 ET
Table 'sgdCtiuCu2BDZhyDi6RzTA' 6-max Seat #6 is the button
Seat 1: 3zD3qLXT1bEffAoWGnc7wg ($28.60 in chips) 
Seat 2: R7AqtFtjtvane2IbChcU+w ($14.75 in chips) 
Seat 3: yzFNNFIfC89bBPwpFPx2ow ($16.85 in chips) 
Seat 4: rVKEgilmMX+EkKzDVvhmxA ($5.90 in chips) 
Seat 5: kD/Cb2UM93FAVgDMhEEb5g ($6.50 in chips) 
Seat 6: KODslGU8ikCYS0/29dUkhg ($11 in chips) 
3zD3qLXT1bEffAoWGnc7wg: posts small blind $0.10
R7AqtFtjtvane2IbChcU+w: posts big blind $0.25
*** HOLE CARDS ***
yzFNNFIfC89bBPwpFPx2ow: folds 
rVKEgilmMX+EkKzDVvhmxA: folds 
kD/Cb2UM93FAVgDMhEEb5g: folds 
KODslGU8ikCYS0/29dUkhg: calls $0.25
3zD3qLXT1bEffAoWGnc7wg: calls $0.15
R7AqtFtjtvane2IbChcU+w: checks 
*** FLOP *** [2h Qs 7c]
3zD3qLXT1bEffAoWGnc7wg: checks 
R7AqtFtjtvane2IbChcU+w: checks 
KODslGU8ikCYS0/29dUkhg: checks 
*** TURN *** [2h Qs 7c] [4d]
3zD3qLXT1bEffAoWGnc7wg: checks 
R7AqtFtjtvane2IbChcU+w: checks 
KODslGU8ikCYS0/29dUkhg: checks 
*** RIVER *** [2h Qs 7c 4d] [4s]
3zD3qLXT1bEffAoWGnc7wg: checks 
R7AqtFtjtvane2IbChcU+w: checks 
KODslGU8ikCYS0/29dUkhg: bets $0.75
3zD3qLXT1bEffAoWGnc7wg: folds 
R7AqtFtjtvane2IbChcU+w: folds 
Uncalled bet ($0.75) returned to KODslGU8ikCYS0/29dUkhg
KODslGU8ikCYS0/29dUkhg collected $0.75 from pot
KODslGU8ikCYS0/29dUkhg: doesn't show hand 
*** SUMMARY ***
Total pot $0.75 | Rake $0 
Board [2h Qs 7c 4d 4s]
Seat 1: 3zD3qLXT1bEffAoWGnc7wg (small blind) folded on the River
Seat 2: R7AqtFtjtvane2IbChcU+w (big blind) folded on the River
Seat 3: yzFNNFIfC89bBPwpFPx2ow folded before Flop (didn't bet)
Seat 4: rVKEgilmMX+EkKzDVvhmxA folded before Flop (didn't bet)
Seat 5: kD/Cb2UM93FAVgDMhEEb5g folded before Flop (didn't bet)
Seat 6: KODslGU8ikCYS0/29dUkhg (button) collected ($0.75)




PokerStars Game #59939714302:  Hold'em No Limit ($0.10/$0.25) - 2009/07/01 0:47:01 ET
Table 'sJ4KpS2GE5Qrsu1/cFjJUw' 9-max Seat #8 is the button
Seat 1: QsLvCwfSWqP+CfjwUnjpXQ ($16.45 in chips) 
Seat 3: eDil7UzSZCjyh1VP6SVXJQ ($13.50 in chips) 
Seat 5: FZrgDbxAanC1xwZxXHJKVA ($5.55 in chips) 
Seat 6: OefE+Csvj5KR7ClGf3Hc2g ($4.15 in chips) 
Seat 7: e4TN7vqqXBH+vGq4fHdZ3A ($4.75 in chips) 
Seat 8: f8ixGbSVIs6Be0mH69ldVQ ($6.75 in chips) 
QsLvCwfSWqP+CfjwUnjpXQ: posts small blind $0.10
eDil7UzSZCjyh1VP6SVXJQ: posts big blind $0.25
*** HOLE CARDS ***
FZrgDbxAanC1xwZxXHJKVA: calls $0.25
OefE+Csvj5KR7ClGf3Hc2g: calls $0.25
e4TN7vqqXBH+vGq4fHdZ3A: folds 
f8ixGbSVIs6Be0mH69ldVQ: folds 
QsLvCwfSWqP+CfjwUnjpXQ: raises $0.75 to $1
eDil7UzSZCjyh1VP6SVXJQ: calls $0.75
FZrgDbxAanC1xwZxXHJKVA: folds 
OefE+Csvj5KR7ClGf3Hc2g: folds 
*** FLOP *** [Qd 5d Jd]
QsLvCwfSWqP+CfjwUnjpXQ: checks 
eDil7UzSZCjyh1VP6SVXJQ: bets $0.25
QsLvCwfSWqP+CfjwUnjpXQ: raises $1.25 to $1.50
eDil7UzSZCjyh1VP6SVXJQ: folds 
Uncalled bet ($1.25) returned to QsLvCwfSWqP+CfjwUnjpXQ
QsLvCwfSWqP+CfjwUnjpXQ collected $2.90 from pot
*** SUMMARY ***
Total pot $3 | Rake $0.10 
Board [Qd 5d Jd]
Seat 1: QsLvCwfSWqP+CfjwUnjpXQ (small blind) collected ($2.90)
Seat 3: eDil7UzSZCjyh1VP6SVXJQ (big blind) folded on the Flop
Seat 5: FZrgDbxAanC1xwZxXHJKVA folded before Flop
Seat 6: OefE+Csvj5KR7ClGf3Hc2g folded before Flop
Seat 7: e4TN7vqqXBH+vGq4fHdZ3A folded before Flop (didn't bet)
Seat 8: f8ixGbSVIs6Be0mH69ldVQ (button) folded before Flop (didn't bet)




PokerStars Game #59939715102:  Hold'em No Limit ($0.10/$0.25) - 2009/07/01 0:47:02 ET
Table 'fRxOyfaHXkWUDLv4eSxFew' 9-max Seat #9 is the button
Seat 1: 6RiVTYll/5D8zICp0MRpKw ($24.75 in chips) 
Seat 3: hBMUlEpyU74r/fwDgIpXjQ ($28.30 in chips) 
Seat 4: +WMpj67YqG8ilNkg2JwXpw ($15.95 in chips) 
Seat 6: N/O9ADKpmqB2ASZuqgodlw ($5.70 in chips) 
Seat 7: 7cv+9Zc9HIQHNvYsMfV3uA ($55.40 in chips) 
Seat 9: H5Se03ZqSX7tbULXur2MAg ($23.45 in chips) 
6RiVTYll/5D8zICp0MRpKw: posts small blind $0.10
TeWJxSETzbXGiYKx0y+dtg: is sitting out 
hBMUlEpyU74r/fwDgIpXjQ: posts big blind $0.25
*** HOLE CARDS ***
TeWJxSETzbXGiYKx0y+dtg leaves the table
+WMpj67YqG8ilNkg2JwXpw: folds 
N/O9ADKpmqB2ASZuqgodlw: folds 
7cv+9Zc9HIQHNvYsMfV3uA: folds 
H5Se03ZqSX7tbULXur2MAg: raises $0.50 to $0.75
6RiVTYll/5D8zICp0MRpKw: folds 
hBMUlEpyU74r/fwDgIpXjQ: folds 
Uncalled bet ($0.50) returned to H5Se03ZqSX7tbULXur2MAg
H5Se03ZqSX7tbULXur2MAg collected $0.60 from pot
*** SUMMARY ***
Total pot $0.60 | Rake $0 
Seat 1: 6RiVTYll/5D8zICp0MRpKw (small blind) folded before Flop
Seat 3: hBMUlEpyU74r/fwDgIpXjQ (big blind) folded before Flop
Seat 4: +WMpj67YqG8ilNkg2JwXpw folded before Flop (didn't bet)
Seat 6: N/O9ADKpmqB2ASZuqgodlw folded before Flop (didn't bet)
Seat 7: 7cv+9Zc9HIQHNvYsMfV3uA folded before Flop (didn't bet)
Seat 9: H5Se03ZqSX7tbULXur2MAg (button) collected ($0.60)




PokerStars Game #59939714872:  Hold'em No Limit ($0.10/$0.25) - 2009/07/01 0:47:02 ET
Table 'IRgQPZVA4+IaZZIQshgwyg' 6-max Seat #2 is the button
Seat 1: d0J1xuhsynEY81YHwAvJ5g ($25 in chips) 
Seat 2: 9jSiy0meE9XJKkdIZwyTEQ ($35.10 in chips) 
Seat 3: 8EEqTTh7T1q48sYDqbI2Xg ($29.20 in chips) 
Seat 4: PXXRy0uk7WED5BEf+ReJDQ ($13.25 in chips) 
Seat 5: PbMzPZIePKifKQZfKDkbIw ($27.95 in chips) 
8EEqTTh7T1q48sYDqbI2Xg: posts small blind $0.10
PXXRy0uk7WED5BEf+ReJDQ: posts big blind $0.25
*** HOLE CARDS ***
PbMzPZIePKifKQZfKDkbIw: folds 
d0J1xuhsynEY81YHwAvJ5g: folds 
9jSiy0meE9XJKkdIZwyTEQ: folds 
8EEqTTh7T1q48sYDqbI2Xg: calls $0.15
PXXRy0uk7WED5BEf+ReJDQ: checks 
*** FLOP *** [Ah 8s 6h]
8EEqTTh7T1q48sYDqbI2Xg: checks 
PXXRy0uk7WED5BEf+ReJDQ: checks 
*** TURN *** [Ah 8s 6h] [2d]
8EEqTTh7T1q48sYDqbI2Xg: checks 
PXXRy0uk7WED5BEf+ReJDQ: checks 
*** RIVER *** [Ah 8s 6h 2d] [Qc]
8EEqTTh7T1q48sYDqbI2Xg: checks 
PXXRy0uk7WED5BEf+ReJDQ: checks 
*** SHOW DOWN ***
8EEqTTh7T1q48sYDqbI2Xg: shows [Jh 7s] (high card Ace)
PXXRy0uk7WED5BEf+ReJDQ: mucks hand 
8EEqTTh7T1q48sYDqbI2Xg collected $0.50 from pot
XbIIdTtuN1xO7zurECHBTg joins the table at seat #6 
*** SUMMARY ***
Total pot $0.50 | Rake $0 
Board [Ah 8s 6h 2d Qc]
Seat 1: d0J1xuhsynEY81YHwAvJ5g folded before Flop (didn't bet)
Seat 2: 9jSiy0meE9XJKkdIZwyTEQ (button) folded before Flop (didn't bet)
Seat 3: 8EEqTTh7T1q48sYDqbI2Xg (small blind) showed [Jh 7s] and won ($0.50) with high card Ace
Seat 4: PXXRy0uk7WED5BEf+ReJDQ (big blind) mucked
Seat 5: PbMzPZIePKifKQZfKDkbIw folded before Flop (didn't bet)




PokerStars Game #59939714964:  Hold'em No Limit ($0.10/$0.25) - 2009/07/01 0:47:02 ET
Table 'MiquQrQZJJq9ZtgRIp9HFQ' 6-max Seat #4 is the button
Seat 1: hM0MSDtq2ow7J40bSR04ig ($3.70 in chips) 
Seat 2: dyEfLXFw5qVHSUcgOdOM2Q ($15 in chips) 
Seat 3: BYxjLnV1/LL0aZcTbfAOvw ($26.50 in chips) 
Seat 4: 0HIrwssk0FQvyKULzUTtlg ($20.55 in chips) 
Seat 5: 3zD3qLXT1bEffAoWGnc7wg ($25.10 in chips) 
3zD3qLXT1bEffAoWGnc7wg: posts small blind $0.10
hM0MSDtq2ow7J40bSR04ig: posts big blind $0.25
dyEfLXFw5qVHSUcgOdOM2Q: posts big blind $0.25
*** HOLE CARDS ***
dyEfLXFw5qVHSUcgOdOM2Q: checks 
BYxjLnV1/LL0aZcTbfAOvw: folds 
0HIrwssk0FQvyKULzUTtlg: folds 
3zD3qLXT1bEffAoWGnc7wg: folds 
hM0MSDtq2ow7J40bSR04ig: checks 
*** FLOP *** [Ad Kd Qs]
hM0MSDtq2ow7J40bSR04ig: checks 
dyEfLXFw5qVHSUcgOdOM2Q: checks 
*** TURN *** [Ad Kd Qs] [2h]
hM0MSDtq2ow7J40bSR04ig: checks 
dyEfLXFw5qVHSUcgOdOM2Q: bets $0.50
hM0MSDtq2ow7J40bSR04ig: folds 
Uncalled bet ($0.50) returned to dyEfLXFw5qVHSUcgOdOM2Q
dyEfLXFw5qVHSUcgOdOM2Q collected $0.60 from pot
JE/wJXmjw3bpdmjwvh2pcg joins the table at seat #6 
dyEfLXFw5qVHSUcgOdOM2Q: doesn't show hand 
*** SUMMARY ***
Total pot $0.60 | Rake $0 
Board [Ad Kd Qs 2h]
Seat 1: hM0MSDtq2ow7J40bSR04ig (big blind) folded on the Turn
Seat 2: dyEfLXFw5qVHSUcgOdOM2Q collected ($0.60)
Seat 3: BYxjLnV1/LL0aZcTbfAOvw folded before Flop (didn't bet)
Seat 4: 0HIrwssk0FQvyKULzUTtlg (button) folded before Flop (didn't bet)
Seat 5: 3zD3qLXT1bEffAoWGnc7wg (small blind) folded before Flop




PokerStars Game #59939714938:  Hold'em No Limit ($0.10/$0.25) - 2009/07/01 0:47:02 ET
Table '6ae4XiTo6B597KfSSMr8Cg' 9-max Seat #4 is the button
Seat 1: 49YfVBEOwzD3/FVw+dTTBQ ($11.10 in chips) 
Seat 2: 5s3p6yoJBNW438dsyKTP8g ($43.95 in chips) 
Seat 3: yyG4svzOpC1A+sUP/scg6w ($8.85 in chips) 
Seat 4: dfNim92Z6XK1/h5SFW5vDg ($48.40 in chips) 
Seat 6: DlXs37dlX3tb7o/7lYXQSw ($24.75 in chips) 
Seat 7: 18G4P1XstjNvItdGUITxgw ($25.35 in chips) 
Seat 8: F7pnn6czNpHvRM55XcA2EA ($25.60 in chips) 
Seat 9: E0iYnEVO2ho7dH3QcCjw7g ($37.10 in chips) 
DlXs37dlX3tb7o/7lYXQSw: posts small blind $0.10
18G4P1XstjNvItdGUITxgw: posts big blind $0.25
*** HOLE CARDS ***
F7pnn6czNpHvRM55XcA2EA: folds 
E0iYnEVO2ho7dH3QcCjw7g: folds 
49YfVBEOwzD3/FVw+dTTBQ: folds 
5s3p6yoJBNW438dsyKTP8g: folds 
yyG4svzOpC1A+sUP/scg6w: folds 
dfNim92Z6XK1/h5SFW5vDg: folds 
DlXs37dlX3tb7o/7lYXQSw: folds 
Uncalled bet ($0.15) returned to 18G4P1XstjNvItdGUITxgw
18G4P1XstjNvItdGUITxgw collected $0.20 from pot
18G4P1XstjNvItdGUITxgw: doesn't show hand 
*** SUMMARY ***
Total pot $0.20 | Rake $0 
Seat 1: 49YfVBEOwzD3/FVw+dTTBQ folded before Flop (didn't bet)
Seat 2: 5s3p6yoJBNW438dsyKTP8g folded before Flop (didn't bet)
Seat 3: yyG4svzOpC1A+sUP/scg6w folded before Flop (didn't bet)
Seat 4: dfNim92Z6XK1/h5SFW5vDg (button) folded before Flop (didn't bet)
Seat 6: DlXs37dlX3tb7o/7lYXQSw (small blind) folded before Flop
Seat 7: 18G4P1XstjNvItdGUITxgw (big blind) collected ($0.20)
Seat 8: F7pnn6czNpHvRM55XcA2EA folded before Flop (didn't bet)
Seat 9: E0iYnEVO2ho7dH3QcCjw7g folded before Flop (didn't bet)




PokerStars Game #59939714752:  Hold'em No Limit ($0.10/$0.25) - 2009/07/01 0:47:02 ET
Table 'KTZXQ4LREPjpS54R3DFTsw' 9-max Seat #7 is the button
Seat 1: dSjkBIV7Bv+ZCIWNBguf7w ($34 in chips) 
Seat 3: N6fYvIzQLKaydFLKQGtMlQ ($35.70 in chips) 
Seat 4: K0b5wNInj6hUGRr6yzKFtw ($25.15 in chips) 
Seat 5: HPEB+AtKw1+C/cxU0o1ciw ($31.25 in chips) 
Seat 6: 1q23ISSsSMhv2lHXBfj9/A ($23.50 in chips) 
Seat 7: yyG4svzOpC1A+sUP/scg6w ($8.05 in chips) 
Seat 8: wZluzulQ98aycXC12mG7qA ($6.05 in chips) 
Seat 9: V6p0jQ/RhUsqpHLmXvEX4Q ($12.35 in chips) 
wZluzulQ98aycXC12mG7qA: posts small blind $0.10
V6p0jQ/RhUsqpHLmXvEX4Q: posts big blind $0.25
*** HOLE CARDS ***
dSjkBIV7Bv+ZCIWNBguf7w: folds 
N6fYvIzQLKaydFLKQGtMlQ: folds 
K0b5wNInj6hUGRr6yzKFtw: folds 
HPEB+AtKw1+C/cxU0o1ciw: raises $0.75 to $1
1q23ISSsSMhv2lHXBfj9/A: folds 
yyG4svzOpC1A+sUP/scg6w: folds 
wZluzulQ98aycXC12mG7qA: folds 
V6p0jQ/RhUsqpHLmXvEX4Q: folds 
Uncalled bet ($0.75) returned to HPEB+AtKw1+C/cxU0o1ciw
HPEB+AtKw1+C/cxU0o1ciw collected $0.60 from pot
HPEB+AtKw1+C/cxU0o1ciw: doesn't show hand 
*** SUMMARY ***
Total pot $0.60 | Rake $0 
Seat 1: dSjkBIV7Bv+ZCIWNBguf7w folded before Flop (didn't bet)
Seat 3: N6fYvIzQLKaydFLKQGtMlQ folded before Flop (didn't bet)
Seat 4: K0b5wNInj6hUGRr6yzKFtw folded before Flop (didn't bet)
Seat 5: HPEB+AtKw1+C/cxU0o1ciw collected ($0.60)
Seat 6: 1q23ISSsSMhv2lHXBfj9/A folded before Flop (didn't bet)
Seat 7: yyG4svzOpC1A+sUP/scg6w (button) folded before Flop (didn't bet)
Seat 8: wZluzulQ98aycXC12mG7qA (small blind) folded before Flop
Seat 9: V6p0jQ/RhUsqpHLmXvEX4Q (big blind) folded before Flop




PokerStars Game #59939715116:  Hold'em No Limit ($0.10/$0.25) - 2009/07/01 0:47:02 ET
Table 'm+FQg/QP0VP1ZA3V62WtOg' 9-max Seat #2 is the button
Seat 1: qwr38jl5txoR36M7G5qi4A ($7.50 in chips) 
Seat 2: oKO7b50N6TzXbPBr/mcrUA ($30.30 in chips) 
Seat 3: 4oA316mXLIui1QY63GXBUg ($25 in chips) 
Seat 4: 86vbuhJsyH+nbEg5qpDLyQ ($25 in chips) 
Seat 5: DnDcAdn9P0zGovMERigpFA ($25 in chips) 
Seat 6: 0kGr2KqzSs4y4kVqyDiTag ($6.20 in chips) 
Seat 7: MIVCHqCqqlke0Lb0z7glcw ($25.90 in chips) 
Seat 9: ghNKXUBl/H+t83JF079ZBA ($25 in chips) 
4oA316mXLIui1QY63GXBUg: posts small blind $0.10
86vbuhJsyH+nbEg5qpDLyQ: posts big blind $0.25
4awUyiDYTgylQKXZ9faBVA: sits out 
*** HOLE CARDS ***
DnDcAdn9P0zGovMERigpFA: folds 
0kGr2KqzSs4y4kVqyDiTag: calls $0.25
MIVCHqCqqlke0Lb0z7glcw: folds 
ghNKXUBl/H+t83JF079ZBA: folds 
qwr38jl5txoR36M7G5qi4A: folds 
oKO7b50N6TzXbPBr/mcrUA: folds 
4oA316mXLIui1QY63GXBUg: calls $0.15
86vbuhJsyH+nbEg5qpDLyQ: checks 
*** FLOP *** [4c Kc Ah]
4oA316mXLIui1QY63GXBUg: checks 
86vbuhJsyH+nbEg5qpDLyQ: checks 
0kGr2KqzSs4y4kVqyDiTag: bets $0.25
4oA316mXLIui1QY63GXBUg: folds 
86vbuhJsyH+nbEg5qpDLyQ: folds 
Uncalled bet ($0.25) returned to 0kGr2KqzSs4y4kVqyDiTag
0kGr2KqzSs4y4kVqyDiTag collected $0.75 from pot
0kGr2KqzSs4y4kVqyDiTag: doesn't show hand 
*** SUMMARY ***
Total pot $0.75 | Rake $0 
Board [4c Kc Ah]
Seat 1: qwr38jl5txoR36M7G5qi4A folded before Flop (didn't bet)
Seat 2: oKO7b50N6TzXbPBr/mcrUA (button) folded before Flop (didn't bet)
Seat 3: 4oA316mXLIui1QY63GXBUg (small blind) folded on the Flop
Seat 4: 86vbuhJsyH+nbEg5qpDLyQ (big blind) folded on the Flop
Seat 5: DnDcAdn9P0zGovMERigpFA folded before Flop (didn't bet)
Seat 6: 0kGr2KqzSs4y4kVqyDiTag collected ($0.75)
Seat 7: MIVCHqCqqlke0Lb0z7glcw folded before Flop (didn't bet)
Seat 9: ghNKXUBl/H+t83JF079ZBA folded before Flop (didn't bet)




PokerStars Game #59939714862:  Hold'em No Limit ($0.10/$0.25) - 2009/07/01 0:47:02 ET
Table 'tANpk8z1C5o0Pq/hpYShHw' 9-max Seat #4 is the button
Seat 1: rQhYIYXSyH/IivYM1dlV5A ($23.15 in chips) 
Seat 2: og4yH4sZUZdC8jjgW8zPJQ ($10.25 in chips) 
Seat 3: zDrucyjVn5aeekNEc3cJrA ($20.25 in chips) 
Seat 4: dmQRblfPJL8cP867vJRZkg ($5.40 in chips) 
Seat 5: kWxV1qKcmWEussgWafGYNA ($50.10 in chips) 
Seat 6: kN0AWJG6biW8tHtuF+wTjA ($7.80 in chips) 
Seat 8: sPhk0wImgnCyx4aYrPXnHA ($14.20 in chips) 
Seat 9: gE5rN2TDY1aXcZn/TOPeZw ($13.55 in chips) 
kWxV1qKcmWEussgWafGYNA: posts small blind $0.10
kN0AWJG6biW8tHtuF+wTjA: posts big blind $0.25
aNpwfA31EREwO+ar4XzBCw: sits out 
*** HOLE CARDS ***
sPhk0wImgnCyx4aYrPXnHA: folds 
gE5rN2TDY1aXcZn/TOPeZw: folds 
rQhYIYXSyH/IivYM1dlV5A: folds 
og4yH4sZUZdC8jjgW8zPJQ: calls $0.25
zDrucyjVn5aeekNEc3cJrA: folds 
dmQRblfPJL8cP867vJRZkg: calls $0.25
kWxV1qKcmWEussgWafGYNA: calls $0.15
kN0AWJG6biW8tHtuF+wTjA: checks 
*** FLOP *** [Ks 2s 6c]
kWxV1qKcmWEussgWafGYNA: checks 
kN0AWJG6biW8tHtuF+wTjA: bets $0.50
og4yH4sZUZdC8jjgW8zPJQ: folds 
dmQRblfPJL8cP867vJRZkg: calls $0.50
kWxV1qKcmWEussgWafGYNA: folds 
*** TURN *** [Ks 2s 6c] [4c]
kN0AWJG6biW8tHtuF+wTjA: checks 
dmQRblfPJL8cP867vJRZkg: checks 
*** RIVER *** [Ks 2s 6c 4c] [Th]
kN0AWJG6biW8tHtuF+wTjA: checks 
dmQRblfPJL8cP867vJRZkg: checks 
*** SHOW DOWN ***
kN0AWJG6biW8tHtuF+wTjA: shows [2d 3s] (a pair of Deuces)
dmQRblfPJL8cP867vJRZkg: shows [7s 7h] (a pair of Sevens)
dmQRblfPJL8cP867vJRZkg collected $1.95 from pot
*** SUMMARY ***
Total pot $2 | Rake $0.05 
Board [Ks 2s 6c 4c Th]
Seat 1: rQhYIYXSyH/IivYM1dlV5A folded before Flop (didn't bet)
Seat 2: og4yH4sZUZdC8jjgW8zPJQ folded on the Flop
Seat 3: zDrucyjVn5aeekNEc3cJrA folded before Flop (didn't bet)
Seat 4: dmQRblfPJL8cP867vJRZkg (button) showed [7s 7h] and won ($1.95) with a pair of Sevens
Seat 5: kWxV1qKcmWEussgWafGYNA (small blind) folded on the Flop
Seat 6: kN0AWJG6biW8tHtuF+wTjA (big blind) showed [2d 3s] and lost with a pair of Deuces
Seat 8: sPhk0wImgnCyx4aYrPXnHA folded before Flop (didn't bet)
Seat 9: gE5rN2TDY1aXcZn/TOPeZw folded before Flop (didn't bet)




PokerStars Game #59939714646:  Hold'em No Limit ($0.10/$0.25) - 2009/07/01 0:47:02 ET
Table 'zW+7jPbOLCvlPu+dUGY5WQ' 6-max Seat #5 is the button
Seat 5: SFmT9ZsVopnukjvAzrxTRg ($54.85 in chips) 
MkNgTuvyxpHXkeIm5JITHQ joins the table at seat #2 
SFmT9ZsVopnukjvAzrxTRg: posts small blind $0.10
BiLBinPhgpKAYzLgKJVU5A: is sitting out 
Hand cancelled
*** SUMMARY ***
Seat 5: SFmT9ZsVopnukjvAzrxTRg (button) collected ($0)




PokerStars Game #59939715808:  Hold'em No Limit ($0.10/$0.25) - 2009/07/01 0:47:03 ET
Table 'JUMeG5SzDyo9HufhgemQeA' 9-max Seat #3 is the button
Seat 1: N6fYvIzQLKaydFLKQGtMlQ ($25.30 in chips) 
Seat 3: IEvLSTIxhlti3EjZDarYnA ($28 in chips) 
Seat 4: 6OP8CZnSFyny18DZqWIYog ($2.80 in chips) 
Seat 5: TI/C5Q+DEl4fLR3AofwYdg ($16 in chips) 
Seat 6: wFCwdYKUXoQHhz8qeZuuAw ($24.45 in chips) 
Seat 7: aNpwfA31EREwO+ar4XzBCw ($29.30 in chips) 
Seat 8: zDrucyjVn5aeekNEc3cJrA ($36.85 in chips) 
Seat 9: V6p0jQ/RhUsqpHLmXvEX4Q ($12.35 in chips) 
6OP8CZnSFyny18DZqWIYog: posts small blind $0.10
TI/C5Q+DEl4fLR3AofwYdg: posts big blind $0.25
*** HOLE CARDS ***
wFCwdYKUXoQHhz8qeZuuAw: folds 
aNpwfA31EREwO+ar4XzBCw: folds 
zDrucyjVn5aeekNEc3cJrA: folds 
wFCwdYKUXoQHhz8qeZuuAw is sitting out
V6p0jQ/RhUsqpHLmXvEX4Q: folds 
N6fYvIzQLKaydFLKQGtMlQ: folds 
IEvLSTIxhlti3EjZDarYnA: calls $0.25
6OP8CZnSFyny18DZqWIYog: raises $2.55 to $2.80 and is all-in
TI/C5Q+DEl4fLR3AofwYdg: folds 
IEvLSTIxhlti3EjZDarYnA: folds 
Uncalled bet ($2.55) returned to 6OP8CZnSFyny18DZqWIYog
6OP8CZnSFyny18DZqWIYog collected $0.75 from pot
*** SUMMARY ***
Total pot $0.75 | Rake $0 
Seat 1: N6fYvIzQLKaydFLKQGtMlQ folded before Flop (didn't bet)
Seat 3: IEvLSTIxhlti3EjZDarYnA (button) folded before Flop
Seat 4: 6OP8CZnSFyny18DZqWIYog (small blind) collected ($0.75)
Seat 5: TI/C5Q+DEl4fLR3AofwYdg (big blind) folded before Flop
Seat 6: wFCwdYKUXoQHhz8qeZuuAw folded before Flop (didn't bet)
Seat 7: aNpwfA31EREwO+ar4XzBCw folded before Flop (didn't bet)
Seat 8: zDrucyjVn5aeekNEc3cJrA folded before Flop (didn't bet)
Seat 9: V6p0jQ/RhUsqpHLmXvEX4Q folded before Flop (didn't bet)




PokerStars Game #59939715404:  Hold'em No Limit ($0.10/$0.25) - 2009/07/01 0:47:03 ET
Table 'djcjiEGabFQO0MNG6jEeJQ' 9-max Seat #7 is the button
Seat 1: K7bAhhMMJ/XcTmGaBZVfFQ ($24.40 in chips) 
Seat 3: 1S/fpm+f42V/6MNZre+ccg ($27.95 in chips) 
Seat 4: E6WojUZ5V/6opnfMNTSjXQ ($12.35 in chips) 
Seat 5: cZ99hugmLBj9KhTlc8nCSw ($40.95 in chips) 
Seat 6: aNpwfA31EREwO+ar4XzBCw ($59.20 in chips) 
Seat 7: 56S3mA6Zs3pGR+0p0vUCtg ($30.10 in chips) 
Seat 8: +sbyWwIcFp9kP0bDtMegfQ ($54.05 in chips) 
Seat 9: HPEB+AtKw1+C/cxU0o1ciw ($47.65 in chips) 
+sbyWwIcFp9kP0bDtMegfQ: posts small blind $0.10
HPEB+AtKw1+C/cxU0o1ciw: posts big blind $0.25
*** HOLE CARDS ***
K7bAhhMMJ/XcTmGaBZVfFQ: folds 
1S/fpm+f42V/6MNZre+ccg: folds 
E6WojUZ5V/6opnfMNTSjXQ: raises $1.75 to $2
cZ99hugmLBj9KhTlc8nCSw: folds 
aNpwfA31EREwO+ar4XzBCw: folds 
56S3mA6Zs3pGR+0p0vUCtg: folds 
+sbyWwIcFp9kP0bDtMegfQ: folds 
HPEB+AtKw1+C/cxU0o1ciw: folds 
Uncalled bet ($1.75) returned to E6WojUZ5V/6opnfMNTSjXQ
E6WojUZ5V/6opnfMNTSjXQ collected $0.60 from pot
E6WojUZ5V/6opnfMNTSjXQ: doesn't show hand 
*** SUMMARY ***
Total pot $0.60 | Rake $0 
Seat 1: K7bAhhMMJ/XcTmGaBZVfFQ folded before Flop (didn't bet)
Seat 3: 1S/fpm+f42V/6MNZre+ccg folded before Flop (didn't bet)
Seat 4: E6WojUZ5V/6opnfMNTSjXQ collected ($0.60)
Seat 5: cZ99hugmLBj9KhTlc8nCSw folded before Flop (didn't bet)
Seat 6: aNpwfA31EREwO+ar4XzBCw folded before Flop (didn't bet)
Seat 7: 56S3mA6Zs3pGR+0p0vUCtg (button) folded before Flop (didn't bet)
Seat 8: +sbyWwIcFp9kP0bDtMegfQ (small blind) folded before Flop
Seat 9: HPEB+AtKw1+C/cxU0o1ciw (big blind) folded before Flop




PokerStars Game #59939715150:  Hold'em No Limit ($0.10/$0.25) - 2009/07/01 0:47:03 ET
Table 'jItkp2PNTbH9Cf7gqsAF7g' 9-max Seat #1 is the button
Seat 1: OiV1PWZ3IkN29JlmCcnTwQ ($5.40 in chips) 
Seat 2: qwr38jl5txoR36M7G5qi4A ($7.50 in chips) 
Seat 3: E0iYnEVO2ho7dH3QcCjw7g ($23.10 in chips) 
Seat 4: GQTWTgG7Ydy9q/vohVnKmQ ($32.10 in chips) 
Seat 5: uH1RN27w9SKa7TpVR9EFrQ ($20.10 in chips) 
Seat 6: cZ99hugmLBj9KhTlc8nCSw ($59.10 in chips) 
Seat 7: st9jtdNbm1W5GfBwRaCVqQ ($20.35 in chips) 
Seat 8: t82lXIS9gxYmNHmDgWRFAQ ($10.20 in chips) 
Seat 9: dtZ84flFEi4Q+SGrHMJRDQ ($25 in chips) 
qwr38jl5txoR36M7G5qi4A: posts small blind $0.10
E0iYnEVO2ho7dH3QcCjw7g: posts big blind $0.25
dtZ84flFEi4Q+SGrHMJRDQ: posts big blind $0.25
*** HOLE CARDS ***
GQTWTgG7Ydy9q/vohVnKmQ: folds 
uH1RN27w9SKa7TpVR9EFrQ: folds 
cZ99hugmLBj9KhTlc8nCSw: folds 
st9jtdNbm1W5GfBwRaCVqQ: calls $0.25
t82lXIS9gxYmNHmDgWRFAQ: calls $0.25
dtZ84flFEi4Q+SGrHMJRDQ: checks 
OiV1PWZ3IkN29JlmCcnTwQ: folds 
qwr38jl5txoR36M7G5qi4A: folds 
E0iYnEVO2ho7dH3QcCjw7g: checks 
*** FLOP *** [Ad Ts 2d]
E0iYnEVO2ho7dH3QcCjw7g: checks 
st9jtdNbm1W5GfBwRaCVqQ: bets $0.50
t82lXIS9gxYmNHmDgWRFAQ: calls $0.50
dtZ84flFEi4Q+SGrHMJRDQ: folds 
E0iYnEVO2ho7dH3QcCjw7g: folds 
*** TURN *** [Ad Ts 2d] [4c]
st9jtdNbm1W5GfBwRaCVqQ: bets $1
t82lXIS9gxYmNHmDgWRFAQ: calls $1
*** RIVER *** [Ad Ts 2d 4c] [Th]
st9jtdNbm1W5GfBwRaCVqQ: checks 
t82lXIS9gxYmNHmDgWRFAQ: bets $2
st9jtdNbm1W5GfBwRaCVqQ: folds 
Uncalled bet ($2) returned to t82lXIS9gxYmNHmDgWRFAQ
t82lXIS9gxYmNHmDgWRFAQ collected $3.90 from pot
*** SUMMARY ***
Total pot $4.10 | Rake $0.20 
Board [Ad Ts 2d 4c Th]
Seat 1: OiV1PWZ3IkN29JlmCcnTwQ (button) folded before Flop (didn't bet)
Seat 2: qwr38jl5txoR36M7G5qi4A (small blind) folded before Flop
Seat 3: E0iYnEVO2ho7dH3QcCjw7g (big blind) folded on the Flop
Seat 4: GQTWTgG7Ydy9q/vohVnKmQ folded before Flop (didn't bet)
Seat 5: uH1RN27w9SKa7TpVR9EFrQ folded before Flop (didn't bet)
Seat 6: cZ99hugmLBj9KhTlc8nCSw folded before Flop (didn't bet)
Seat 7: st9jtdNbm1W5GfBwRaCVqQ folded on the River
Seat 8: t82lXIS9gxYmNHmDgWRFAQ collected ($3.90)
Seat 9: dtZ84flFEi4Q+SGrHMJRDQ folded on the Flop




PokerStars Game #59939715804:  Hold'em No Limit ($0.10/$0.25) - 2009/07/01 0:47:03 ET
Table 'Mef6A0EMopL6WaFO5/KO9g' 6-max Seat #3 is the button
Seat 1: ELW+DKizJhLK7k40PMkD2Q ($26.25 in chips) 
Seat 2: 8ClCHtFXGNplITm+63KB+Q ($31.60 in chips) 
Seat 3: Wq26opBLDGJe91GRJn2epg ($20.40 in chips) 
Seat 4: lquriepNQBhDV5P1SWHhnA ($25 in chips) 
Seat 5: WrLI51S2iMb8GLMB83gGqA ($35.90 in chips) 
Seat 6: jp34e617tIzV8tKIWmfAbA ($25.35 in chips) 
lquriepNQBhDV5P1SWHhnA: posts small blind $0.10
WrLI51S2iMb8GLMB83gGqA: posts big blind $0.25
*** HOLE CARDS ***
jp34e617tIzV8tKIWmfAbA: folds 
ELW+DKizJhLK7k40PMkD2Q: raises $0.75 to $1
8ClCHtFXGNplITm+63KB+Q: folds 
Wq26opBLDGJe91GRJn2epg: calls $1
lquriepNQBhDV5P1SWHhnA: folds 
WrLI51S2iMb8GLMB83gGqA: folds 
*** FLOP *** [3d 7s 2h]
ELW+DKizJhLK7k40PMkD2Q: checks 
Wq26opBLDGJe91GRJn2epg: bets $1
ELW+DKizJhLK7k40PMkD2Q: folds 
Uncalled bet ($1) returned to Wq26opBLDGJe91GRJn2epg
Wq26opBLDGJe91GRJn2epg collected $2.25 from pot
Wq26opBLDGJe91GRJn2epg: doesn't show hand 
*** SUMMARY ***
Total pot $2.35 | Rake $0.10 
Board [3d 7s 2h]
Seat 1: ELW+DKizJhLK7k40PMkD2Q folded on the Flop
Seat 2: 8ClCHtFXGNplITm+63KB+Q folded before Flop (didn't bet)
Seat 3: Wq26opBLDGJe91GRJn2epg (button) collected ($2.25)
Seat 4: lquriepNQBhDV5P1SWHhnA (small blind) folded before Flop
Seat 5: WrLI51S2iMb8GLMB83gGqA (big blind) folded before Flop
Seat 6: jp34e617tIzV8tKIWmfAbA folded before Flop (didn't bet)




PokerStars Game #59939715464:  Hold'em No Limit ($0.10/$0.25) - 2009/07/01 0:47:03 ET
Table 'a0kk1yz54EMczhut3KjrxQ' 6-max Seat #5 is the button
Seat 1: V3LJvbHVJHmOj2fd7zIDhA ($29.95 in chips) 
Seat 2: nc79pm0LZRdhncq55evVqA ($25 in chips) 
Seat 3: FabaCGPqGJLjRL48CMvjiQ ($19.20 in chips) 
Seat 4: FYepjhAvF8ZdVCmqHIy+eQ ($28.20 in chips) 
Seat 5: cPO/1/dTcZpLkQFm3jH3Rg ($27.40 in chips) 
Seat 6: DTzxFTXVrCqrpjq9B9Vg/g ($16.15 in chips) 
DTzxFTXVrCqrpjq9B9Vg/g: posts small blind $0.10
V3LJvbHVJHmOj2fd7zIDhA: posts big blind $0.25
*** HOLE CARDS ***
nc79pm0LZRdhncq55evVqA: folds 
FabaCGPqGJLjRL48CMvjiQ: folds 
FYepjhAvF8ZdVCmqHIy+eQ: folds 
cPO/1/dTcZpLkQFm3jH3Rg: folds 
DTzxFTXVrCqrpjq9B9Vg/g: calls $0.15
V3LJvbHVJHmOj2fd7zIDhA: checks 
*** FLOP *** [8h 3s As]
DTzxFTXVrCqrpjq9B9Vg/g: checks 
V3LJvbHVJHmOj2fd7zIDhA: checks 
*** TURN *** [8h 3s As] [Jd]
DTzxFTXVrCqrpjq9B9Vg/g: checks 
V3LJvbHVJHmOj2fd7zIDhA: checks 
*** RIVER *** [8h 3s As Jd] [Ts]
DTzxFTXVrCqrpjq9B9Vg/g: checks 
V3LJvbHVJHmOj2fd7zIDhA: checks 
*** SHOW DOWN ***
DTzxFTXVrCqrpjq9B9Vg/g: shows [2d 4d] (high card Ace)
V3LJvbHVJHmOj2fd7zIDhA: shows [9h 4c] (high card Ace - Jack+Ten+Nine kicker)
V3LJvbHVJHmOj2fd7zIDhA collected $0.50 from pot
*** SUMMARY ***
Total pot $0.50 | Rake $0 
Board [8h 3s As Jd Ts]
Seat 1: V3LJvbHVJHmOj2fd7zIDhA (big blind) showed [9h 4c] and won ($0.50) with high card Ace
Seat 2: nc79pm0LZRdhncq55evVqA folded before Flop (didn't bet)
Seat 3: FabaCGPqGJLjRL48CMvjiQ folded before Flop (didn't bet)
Seat 4: FYepjhAvF8ZdVCmqHIy+eQ folded before Flop (didn't bet)
Seat 5: cPO/1/dTcZpLkQFm3jH3Rg (button) folded before Flop (didn't bet)
Seat 6: DTzxFTXVrCqrpjq9B9Vg/g (small blind) showed [2d 4d] and lost with high card Ace




PokerStars Game #59939716266:  Hold'em No Limit ($0.10/$0.25) - 2009/07/01 0:47:04 ET
Table 'IUwZ/e0bDHZPgsIWx0RnNg' 6-max Seat #6 is the button
Seat 1: 8JTm/CXBn3+kuQgcUOgPkw ($24.50 in chips) 
Seat 2: mvFHK3pE7tCxJEqLjKC70Q ($30.35 in chips) 
Seat 3: dOX4wnYV2sEqvDbF+8KSCw ($26.05 in chips) 
Seat 4: IyZ9SVxKy7TJvRGFneWTMg ($29.65 in chips) 
Seat 5: wsP46AGpqDjHZQmlRHKa9g ($25.15 in chips) 
Seat 6: NhUN/JpAprdJeamFBgJH1w ($25 in chips) 
8JTm/CXBn3+kuQgcUOgPkw: posts small blind $0.10
mvFHK3pE7tCxJEqLjKC70Q: posts big blind $0.25
*** HOLE CARDS ***
dOX4wnYV2sEqvDbF+8KSCw: folds 
IyZ9SVxKy7TJvRGFneWTMg: folds 
wsP46AGpqDjHZQmlRHKa9g: folds 
NhUN/JpAprdJeamFBgJH1w: raises $0.75 to $1
8JTm/CXBn3+kuQgcUOgPkw: folds 
mvFHK3pE7tCxJEqLjKC70Q: folds 
Uncalled bet ($0.75) returned to NhUN/JpAprdJeamFBgJH1w
NhUN/JpAprdJeamFBgJH1w collected $0.60 from pot
NhUN/JpAprdJeamFBgJH1w: doesn't show hand 
*** SUMMARY ***
Total pot $0.60 | Rake $0 
Seat 1: 8JTm/CXBn3+kuQgcUOgPkw (small blind) folded before Flop
Seat 2: mvFHK3pE7tCxJEqLjKC70Q (big blind) folded before Flop
Seat 3: dOX4wnYV2sEqvDbF+8KSCw folded before Flop (didn't bet)
Seat 4: IyZ9SVxKy7TJvRGFneWTMg folded before Flop (didn't bet)
Seat 5: wsP46AGpqDjHZQmlRHKa9g folded before Flop (didn't bet)
Seat 6: NhUN/JpAprdJeamFBgJH1w (button) collected ($0.60)




PokerStars Game #59939715872:  Hold'em No Limit ($0.10/$0.25) - 2009/07/01 0:47:04 ET
Table 'tq5CvS0RUqGkuBK0XTzqqg' 6-max Seat #5 is the button
Seat 1: 39EF5EcifdyPS7v+EnfxLg ($15.55 in chips) 
Seat 2: mfrkWA3PTeYPkbO6hi98Aw ($68.85 in chips) 
Seat 3: PbMzPZIePKifKQZfKDkbIw ($28.30 in chips) 
Seat 4: W7FS+h5B+OhmwF+cTt3ZPQ ($18.60 in chips) 
Seat 5: qGHGf/553gQnDoklMRe3tg ($23.40 in chips) 
Seat 6: hOfhw8jxWiq14wXGL4Bh/Q ($15.25 in chips) 
hOfhw8jxWiq14wXGL4Bh/Q: posts small blind $0.10
39EF5EcifdyPS7v+EnfxLg: posts big blind $0.25
*** HOLE CARDS ***
mfrkWA3PTeYPkbO6hi98Aw: folds 
PbMzPZIePKifKQZfKDkbIw: folds 
W7FS+h5B+OhmwF+cTt3ZPQ: folds 
qGHGf/553gQnDoklMRe3tg: raises $0.75 to $1
hOfhw8jxWiq14wXGL4Bh/Q: folds 
39EF5EcifdyPS7v+EnfxLg: calls $0.75
*** FLOP *** [Ad 8h Jh]
39EF5EcifdyPS7v+EnfxLg: bets $1
qGHGf/553gQnDoklMRe3tg: calls $1
*** TURN *** [Ad 8h Jh] [4s]
39EF5EcifdyPS7v+EnfxLg: checks 
qGHGf/553gQnDoklMRe3tg: bets $2.50
39EF5EcifdyPS7v+EnfxLg: raises $2.50 to $5
qGHGf/553gQnDoklMRe3tg: calls $2.50
*** RIVER *** [Ad 8h Jh 4s] [6c]
39EF5EcifdyPS7v+EnfxLg: checks 
qGHGf/553gQnDoklMRe3tg: checks 
*** SHOW DOWN ***
39EF5EcifdyPS7v+EnfxLg: shows [9h Jd] (a pair of Jacks)
qGHGf/553gQnDoklMRe3tg: shows [Ts As] (a pair of Aces)
qGHGf/553gQnDoklMRe3tg collected $13.45 from pot
*** SUMMARY ***
Total pot $14.10 | Rake $0.65 
Board [Ad 8h Jh 4s 6c]
Seat 1: 39EF5EcifdyPS7v+EnfxLg (big blind) showed [9h Jd] and lost with a pair of Jacks
Seat 2: mfrkWA3PTeYPkbO6hi98Aw folded before Flop (didn't bet)
Seat 3: PbMzPZIePKifKQZfKDkbIw folded before Flop (didn't bet)
Seat 4: W7FS+h5B+OhmwF+cTt3ZPQ folded before Flop (didn't bet)
Seat 5: qGHGf/553gQnDoklMRe3tg (button) showed [Ts As] and won ($13.45) with a pair of Aces
Seat 6: hOfhw8jxWiq14wXGL4Bh/Q (small blind) folded before Flop




PokerStars Game #59939716068:  Hold'em No Limit ($0.10/$0.25) - 2009/07/01 0:47:04 ET
Table 'FE/j6VqBY4j9Uq+VHURQCQ' 6-max Seat #4 is the button
Seat 1: wKFJ513ucluNNiMlkXcDOQ ($45.70 in chips) 
Seat 2: 3zD3qLXT1bEffAoWGnc7wg ($28.75 in chips) 
Seat 3: Zijzy/UtPWzWVUo81HHVjQ ($51.25 in chips) 
Seat 4: cPO/1/dTcZpLkQFm3jH3Rg ($25 in chips) 
Seat 5: wsP46AGpqDjHZQmlRHKa9g ($25.10 in chips) 
wsP46AGpqDjHZQmlRHKa9g: posts small blind $0.10
wKFJ513ucluNNiMlkXcDOQ: posts big blind $0.25
*** HOLE CARDS ***
3zD3qLXT1bEffAoWGnc7wg: folds 
Zijzy/UtPWzWVUo81HHVjQ has timed out
Zijzy/UtPWzWVUo81HHVjQ: folds 
Zijzy/UtPWzWVUo81HHVjQ is sitting out
cPO/1/dTcZpLkQFm3jH3Rg: folds 
wsP46AGpqDjHZQmlRHKa9g: raises $0.50 to $0.75
Zijzy/UtPWzWVUo81HHVjQ has returned
wKFJ513ucluNNiMlkXcDOQ: raises $3.25 to $4
BYxjLnV1/LL0aZcTbfAOvw joins the table at seat #6 
wsP46AGpqDjHZQmlRHKa9g: folds 
Uncalled bet ($3.25) returned to wKFJ513ucluNNiMlkXcDOQ
wKFJ513ucluNNiMlkXcDOQ collected $1.50 from pot
wKFJ513ucluNNiMlkXcDOQ: doesn't show hand 
BYxjLnV1/LL0aZcTbfAOvw leaves the table
*** SUMMARY ***
Total pot $1.50 | Rake $0 
Seat 1: wKFJ513ucluNNiMlkXcDOQ (big blind) collected ($1.50)
Seat 2: 3zD3qLXT1bEffAoWGnc7wg folded before Flop (didn't bet)
Seat 3: Zijzy/UtPWzWVUo81HHVjQ folded before Flop (didn't bet)
Seat 4: cPO/1/dTcZpLkQFm3jH3Rg (button) folded before Flop (didn't bet)
Seat 5: wsP46AGpqDjHZQmlRHKa9g (small blind) folded before Flop




PokerStars Game #59939716086:  Hold'em No Limit ($0.10/$0.25) - 2009/07/01 0:47:04 ET
Table '/JJyyIstHfkT7t/bW+WXgg' 6-max Seat #4 is the button
Seat 1: wsP46AGpqDjHZQmlRHKa9g ($25.05 in chips) 
Seat 3: oc4ZGs0W+3RIg2yPyJw3ig ($25.85 in chips) 
Seat 4: ELW+DKizJhLK7k40PMkD2Q ($24.90 in chips) 
Seat 5: 2wkoolB4YxxVC2x99F9rcA ($31.40 in chips) 
Seat 6: d338A2rm6NtA1ECEZi4d2g ($16.15 in chips) 
2wkoolB4YxxVC2x99F9rcA: posts small blind $0.10
d338A2rm6NtA1ECEZi4d2g: posts big blind $0.25
BYxjLnV1/LL0aZcTbfAOvw: sits out 
*** HOLE CARDS ***
wsP46AGpqDjHZQmlRHKa9g: folds 
oc4ZGs0W+3RIg2yPyJw3ig: folds 
ELW+DKizJhLK7k40PMkD2Q: folds 
2wkoolB4YxxVC2x99F9rcA: raises $0.50 to $0.75
d338A2rm6NtA1ECEZi4d2g: calls $0.50
*** FLOP *** [2h Ts Ad]
2wkoolB4YxxVC2x99F9rcA: bets $1
d338A2rm6NtA1ECEZi4d2g: folds 
Uncalled bet ($1) returned to 2wkoolB4YxxVC2x99F9rcA
2wkoolB4YxxVC2x99F9rcA collected $1.45 from pot
2wkoolB4YxxVC2x99F9rcA: doesn't show hand 
*** SUMMARY ***
Total pot $1.50 | Rake $0.05 
Board [2h Ts Ad]
Seat 1: wsP46AGpqDjHZQmlRHKa9g folded before Flop (didn't bet)
Seat 3: oc4ZGs0W+3RIg2yPyJw3ig folded before Flop (didn't bet)
Seat 4: ELW+DKizJhLK7k40PMkD2Q (button) folded before Flop (didn't bet)
Seat 5: 2wkoolB4YxxVC2x99F9rcA (small blind) collected ($1.45)
Seat 6: d338A2rm6NtA1ECEZi4d2g (big blind) folded on the Flop




PokerStars Game #59939716382:  Hold'em No Limit ($0.10/$0.25) - 2009/07/01 0:47:04 ET
Table '52Meibn9NOL4XtVi1p2UpwpyZQRcpxhWj2y2cT/ydvwwx Seat #5 is the button
Seat 1: TeWJxSETzbXGiYKx0y+dtg ($26.60 in chips) 
Seat 2: Th3FldXKQW6hWVVPahaoOQ ($49.65 in chips) 
Seat 3: DgRMoUciGePff+edyvpt6g ($28.40 in chips) 
Seat 4: 8GJHzzxiotOqC5gdtgpLoA ($4.65 in chips) 
Seat 5: 4oA316mXLIui1QY63GXBUg ($25 in chips) 
Seat 6: 4awUyiDYTgylQKXZ9faBVA ($27.85 in chips) 
Seat 8: 18G4P1XstjNvItdGUITxgw ($25 in chips) 
4awUyiDYTgylQKXZ9faBVA: posts small blind $0.10
Xpyqpb+DURDWnyJ3xTEIFQ: is sitting out 
Xpyqpb+DURDWnyJ3xTEIFQ leaves the table
18G4P1XstjNvItdGUITxgw: posts big blind $0.25
*** HOLE CARDS ***
aPRz/2GxbXANYpVsQO8pdQ joins the table at seat #7 
TeWJxSETzbXGiYKx0y+dtg: folds 
Th3FldXKQW6hWVVPahaoOQ: folds 
DgRMoUciGePff+edyvpt6g: calls $0.25
8GJHzzxiotOqC5gdtgpLoA: folds 
4oA316mXLIui1QY63GXBUg: folds 
4awUyiDYTgylQKXZ9faBVA: folds 
18G4P1XstjNvItdGUITxgw: checks 
*** FLOP *** [Qh Tc 7d]
18G4P1XstjNvItdGUITxgw: checks 
DgRMoUciGePff+edyvpt6g: bets $0.50
18G4P1XstjNvItdGUITxgw: folds 
Uncalled bet ($0.50) returned to DgRMoUciGePff+edyvpt6g
DgRMoUciGePff+edyvpt6g collected $0.60 from pot
*** SUMMARY ***
Total pot $0.60 | Rake $0 
Board [Qh Tc 7d]
Seat 1: TeWJxSETzbXGiYKx0y+dtg folded before Flop (didn't bet)
Seat 2: Th3FldXKQW6hWVVPahaoOQ folded before Flop (didn't bet)
Seat 3: DgRMoUciGePff+edyvpt6g collected ($0.60)
Seat 4: 8GJHzzxiotOqC5gdtgpLoA folded before Flop (didn't bet)
Seat 5: 4oA316mXLIui1QY63GXBUg (button) folded before Flop (didn't bet)
Seat 6: 4awUyiDYTgylQKXZ9faBVA (small blind) folded before Flop
Seat 8: 18G4P1XstjNvItdGUITxgw (big blind) folded on the Flop




PokerStars Game #59939715828:  Hold'em No Limit ($0.10/$0.25) - 2009/07/01 0:47:04 ET
Table 'LwnjzXstPtSrqrV/oDpnXQ' 9-max Seat #1 is the button
Seat 1: sChhj/mp8dm+nGvBS5mOIA ($18.85 in chips) 
Seat 2: K7bAhhMMJ/XcTmGaBZVfFQ ($27.55 in chips) 
Seat 3: u+XLsbPQIcRvPRnS1bvZww ($13.10 in chips) 
Seat 4: nmvbguGv4wKulGg49bANbQ ($13.25 in chips) 
Seat 5: Th3FldXKQW6hWVVPahaoOQ ($29.15 in chips) 
Seat 6: ljemhp25Zg+nlA9DLCIiUw ($32.85 in chips) 
Seat 7: c/Dw/6HyqldTzIRodAIZmg ($13.40 in chips) 
Seat 8: h4ggJZYBXV0mEZzYPYKfeA ($31.95 in chips) 
Seat 9: N6fYvIzQLKaydFLKQGtMlQ ($24.05 in chips) 
K7bAhhMMJ/XcTmGaBZVfFQ: posts small blind $0.10
u+XLsbPQIcRvPRnS1bvZww: posts big blind $0.25
*** HOLE CARDS ***
nmvbguGv4wKulGg49bANbQ: calls $0.25
Th3FldXKQW6hWVVPahaoOQ: folds 
ljemhp25Zg+nlA9DLCIiUw: raises $0.75 to $1
c/Dw/6HyqldTzIRodAIZmg: folds 
h4ggJZYBXV0mEZzYPYKfeA: folds 
N6fYvIzQLKaydFLKQGtMlQ: folds 
sChhj/mp8dm+nGvBS5mOIA: folds 
K7bAhhMMJ/XcTmGaBZVfFQ: folds 
u+XLsbPQIcRvPRnS1bvZww: folds 
nmvbguGv4wKulGg49bANbQ: calls $0.75
*** FLOP *** [5h 6d 3d]
nmvbguGv4wKulGg49bANbQ: checks 
ljemhp25Zg+nlA9DLCIiUw: bets $1.50
nmvbguGv4wKulGg49bANbQ: folds 
Uncalled bet ($1.50) returned to ljemhp25Zg+nlA9DLCIiUw
ljemhp25Zg+nlA9DLCIiUw collected $2.25 from pot
ljemhp25Zg+nlA9DLCIiUw: doesn't show hand 
*** SUMMARY ***
Total pot $2.35 | Rake $0.10 
Board [5h 6d 3d]
Seat 1: sChhj/mp8dm+nGvBS5mOIA (button) folded before Flop (didn't bet)
Seat 2: K7bAhhMMJ/XcTmGaBZVfFQ (small blind) folded before Flop
Seat 3: u+XLsbPQIcRvPRnS1bvZww (big blind) folded before Flop
Seat 4: nmvbguGv4wKulGg49bANbQ folded on the Flop
Seat 5: Th3FldXKQW6hWVVPahaoOQ folded before Flop (didn't bet)
Seat 6: ljemhp25Zg+nlA9DLCIiUw collected ($2.25)
Seat 7: c/Dw/6HyqldTzIRodAIZmg folded before Flop (didn't bet)
Seat 8: h4ggJZYBXV0mEZzYPYKfeA folded before Flop (didn't bet)
Seat 9: N6fYvIzQLKaydFLKQGtMlQ folded before Flop (didn't bet)




PokerStars Game #59939716074:  Hold'em No Limit ($0.10/$0.25) - 2009/07/01 0:47:04 ET
Table 'GgmUtmhrYPRnhkqEEjD/Kw' 9-max Seat #1 is the button
Seat 1: vnCdP3GsLTKadDukKcJk/Q ($25 in chips) 
Seat 2: ghNKXUBl/H+t83JF079ZBA ($25 in chips) 
Seat 3: DZek9vrzBExLUFtbWml/Eg ($10.95 in chips) 
Seat 4: uwmAXQRjyA4iX5kaC15P9A ($5.05 in chips) 
Seat 5: bwPJBTOHVE6kEKZYLU4rlA ($17.80 in chips) 
Seat 6: 4Ax0vobe1rLVIGZmkFINGA ($14.70 in chips) 
Seat 7: YwDw9cMqkbMznFK77rru4A ($16 in chips) 
Seat 8: mKwW7JjB4GQW2YtoYgqIgw ($5.15 in chips) 
ghNKXUBl/H+t83JF079ZBA: posts small blind $0.10
DZek9vrzBExLUFtbWml/Eg: posts big blind $0.25
*** HOLE CARDS ***
uwmAXQRjyA4iX5kaC15P9A: folds 
bwPJBTOHVE6kEKZYLU4rlA: folds 
4Ax0vobe1rLVIGZmkFINGA: folds 
YwDw9cMqkbMznFK77rru4A: folds 
mKwW7JjB4GQW2YtoYgqIgw: calls $0.25
vnCdP3GsLTKadDukKcJk/Q: raises $1 to $1.25
ghNKXUBl/H+t83JF079ZBA: folds 
DZek9vrzBExLUFtbWml/Eg: folds 
mKwW7JjB4GQW2YtoYgqIgw: calls $1
*** FLOP *** [5s 4d 3h]
mKwW7JjB4GQW2YtoYgqIgw: checks 
vnCdP3GsLTKadDukKcJk/Q: bets $1.75
mKwW7JjB4GQW2YtoYgqIgw: calls $1.75
*** TURN *** [5s 4d 3h] [6s]
mKwW7JjB4GQW2YtoYgqIgw: checks 
vnCdP3GsLTKadDukKcJk/Q: checks 
*** RIVER *** [5s 4d 3h 6s] [Jd]
mKwW7JjB4GQW2YtoYgqIgw: bets $2.15 and is all-in
vnCdP3GsLTKadDukKcJk/Q: calls $2.15
*** SHOW DOWN ***
mKwW7JjB4GQW2YtoYgqIgw: shows [7s 8s] (a straight, Four to Eight)
vnCdP3GsLTKadDukKcJk/Q: mucks hand 
mKwW7JjB4GQW2YtoYgqIgw collected $10.15 from pot
*** SUMMARY ***
Total pot $10.65 | Rake $0.50 
Board [5s 4d 3h 6s Jd]
Seat 1: vnCdP3GsLTKadDukKcJk/Q (button) mucked
Seat 2: ghNKXUBl/H+t83JF079ZBA (small blind) folded before Flop
Seat 3: DZek9vrzBExLUFtbWml/Eg (big blind) folded before Flop
Seat 4: uwmAXQRjyA4iX5kaC15P9A folded before Flop (didn't bet)
Seat 5: bwPJBTOHVE6kEKZYLU4rlA folded before Flop (didn't bet)
Seat 6: 4Ax0vobe1rLVIGZmkFINGA folded before Flop (didn't bet)
Seat 7: YwDw9cMqkbMznFK77rru4A folded before Flop (didn't bet)
Seat 8: mKwW7JjB4GQW2YtoYgqIgw showed [7s 8s] and won ($10.15) with a straight, Four to Eight




PokerStars Game #59939716926:  Hold'em No Limit ($0.10/$0.25) - 2009/07/01 0:47:05 ET
Table 'WjNvuuSgTjm8jh0j9vcCgQ' 9-max Seat #3 is the button
Seat 1: NKymidkL3Kg3ILZPvtLSVg ($10.20 in chips) 
Seat 2: 9gmYYQesalMrUjaF7nKfrQ ($9.05 in chips) 
Seat 3: 8B/dhbQjIWe6ASCdgzktNQ ($25 in chips) 
Seat 4: Xbfvrzh7Jjg4vOZkdMSfbA ($10 in chips) 
Seat 6: S0s//NMht9qTAscBNd6CUA ($9.75 in chips) 
Seat 7: DdPXdieucQ+n99u1n3A+rQ ($5 in chips) 
Seat 8: ghNKXUBl/H+t83JF079ZBA ($29.25 in chips) 
Seat 9: zakeg0SqJYXCZcG4HxYSQQ ($13.05 in chips) 
Xbfvrzh7Jjg4vOZkdMSfbA: posts small blind $0.10
Qi+clOtyDiibLdH2/1Qy8g: is sitting out 
S0s//NMht9qTAscBNd6CUA: posts big blind $0.25
*** HOLE CARDS ***
Qi+clOtyDiibLdH2/1Qy8g leaves the table
DdPXdieucQ+n99u1n3A+rQ: raises $0.75 to $1
ghNKXUBl/H+t83JF079ZBA: folds 
zakeg0SqJYXCZcG4HxYSQQ: folds 
NKymidkL3Kg3ILZPvtLSVg: folds 
9gmYYQesalMrUjaF7nKfrQ: folds 
8B/dhbQjIWe6ASCdgzktNQ: folds 
Xbfvrzh7Jjg4vOZkdMSfbA: calls $0.90
S0s//NMht9qTAscBNd6CUA: calls $0.75
*** FLOP *** [9c 8s 5d]
Xbfvrzh7Jjg4vOZkdMSfbA: checks 
S0s//NMht9qTAscBNd6CUA: checks 
DdPXdieucQ+n99u1n3A+rQ: checks 
*** TURN *** [9c 8s 5d] [Jh]
Xbfvrzh7Jjg4vOZkdMSfbA: checks 
S0s//NMht9qTAscBNd6CUA: bets $1
DdPXdieucQ+n99u1n3A+rQ: folds 
Xbfvrzh7Jjg4vOZkdMSfbA: calls $1
*** RIVER *** [9c 8s 5d Jh] [8d]
Xbfvrzh7Jjg4vOZkdMSfbA: bets $1.75
S0s//NMht9qTAscBNd6CUA: calls $1.75
*** SHOW DOWN ***
Xbfvrzh7Jjg4vOZkdMSfbA: shows [Th 5h] (two pair, Eights and Fives)
S0s//NMht9qTAscBNd6CUA: shows [9d Jd] (two pair, Jacks and Nines)
S0s//NMht9qTAscBNd6CUA collected $8.10 from pot
*** SUMMARY ***
Total pot $8.50 | Rake $0.40 
Board [9c 8s 5d Jh 8d]
Seat 1: NKymidkL3Kg3ILZPvtLSVg folded before Flop (didn't bet)
Seat 2: 9gmYYQesalMrUjaF7nKfrQ folded before Flop (didn't bet)
Seat 3: 8B/dhbQjIWe6ASCdgzktNQ (button) folded before Flop (didn't bet)
Seat 4: Xbfvrzh7Jjg4vOZkdMSfbA (small blind) showed [Th 5h] and lost with two pair, Eights and Fives
Seat 6: S0s//NMht9qTAscBNd6CUA (big blind) showed [9d Jd] and won ($8.10) with two pair, Jacks and Nines
Seat 7: DdPXdieucQ+n99u1n3A+rQ folded on the Turn
Seat 8: ghNKXUBl/H+t83JF079ZBA folded before Flop (didn't bet)
Seat 9: zakeg0SqJYXCZcG4HxYSQQ folded before Flop (didn't bet)




PokerStars Game #59939716860:  Hold'em No Limit ($0.10/$0.25) - 2009/07/01 0:47:05 ET
Table 'z2yOdY2zyGWG1gh9WV9XtQdYNvO8G5kw5SRxb1Dljhog Seat #4 is the button
Seat 1: Z9AeOQX3yzuSvKAm/xyovg ($8.75 in chips) 
Seat 3: 1Cs1GyQcoM1omwY7XZ3uRg ($15.35 in chips) 
Seat 4: sD+TKtt36XiiN6jqHiLwDA ($25.70 in chips) 
Seat 5: W7XGvw6ngGVq2hFwXk8Myg ($16.35 in chips) 
Seat 6: 22dIObOuor/A+IKWkNoAlA ($5 in chips) 
Seat 7: DiSvPC2iudwL5j9u6Huyww ($41.05 in chips) 
Seat 8: 5hAPbqNrvJb8PtLiceXtlg6HoFYfVGBefsR5Vrz62qIw4.40 in chips) 
Seat 9: sUVgUtgbfVx6JpvApozwhQ ($5.25 in chips) 
W7XGvw6ngGVq2hFwXk8Myg: posts small blind $0.10
22dIObOuor/A+IKWkNoAlA: posts big blind $0.25
*** HOLE CARDS ***
vEBWvFD+KUWgDBKZKvA3SA leaves the table
DiSvPC2iudwL5j9u6Huyww: folds 
5hAPbqNrvJb8PtLiceXtlg6HoFYfVGBefsR5Vrz62qIwlls $0.25
sUVgUtgbfVx6JpvApozwhQ: folds 
Z9AeOQX3yzuSvKAm/xyovg: raises $0.75 to $1
1Cs1GyQcoM1omwY7XZ3uRg: calls $1
sD+TKtt36XiiN6jqHiLwDA: folds 
W7XGvw6ngGVq2hFwXk8Myg: calls $0.90
22dIObOuor/A+IKWkNoAlA: folds 
5hAPbqNrvJb8PtLiceXtlg6HoFYfVGBefsR5Vrz62qIwlls $0.75
*** FLOP *** [Qc 2s 6s]
W7XGvw6ngGVq2hFwXk8Myg: bets $1
5hAPbqNrvJb8PtLiceXtlg6HoFYfVGBefsR5Vrz62qIwlds 
Z9AeOQX3yzuSvKAm/xyovg: raises $6.75 to $7.75 and is all-in
1Cs1GyQcoM1omwY7XZ3uRg: folds 
W7XGvw6ngGVq2hFwXk8Myg: calls $6.75
*** TURN *** [Qc 2s 6s] [Tc]
pcolapoker joins the table at seat #2 
*** RIVER *** [Qc 2s 6s Tc] [3d]
*** SHOW DOWN ***
W7XGvw6ngGVq2hFwXk8Myg: shows [Kh Ks] (a pair of Kings)
Z9AeOQX3yzuSvKAm/xyovg: mucks hand 
W7XGvw6ngGVq2hFwXk8Myg collected $18.80 from pot
*** SUMMARY ***
Total pot $19.75 | Rake $0.95 
Board [Qc 2s 6s Tc 3d]
Seat 1: Z9AeOQX3yzuSvKAm/xyovg mucked
Seat 3: 1Cs1GyQcoM1omwY7XZ3uRg folded on the Flop
Seat 4: sD+TKtt36XiiN6jqHiLwDA (button) folded before Flop (didn't bet)
Seat 5: W7XGvw6ngGVq2hFwXk8Myg (small blind) showed [Kh Ks] and won ($18.80) with a pair of Kings
Seat 6: 22dIObOuor/A+IKWkNoAlA (big blind) folded before Flop
Seat 7: DiSvPC2iudwL5j9u6Huyww folded before Flop (didn't bet)
Seat 8: 5hAPbqNrvJb8PtLiceXtlg6HoFYfVGBefsR5Vrz62qIwded on the Flop
Seat 9: sUVgUtgbfVx6JpvApozwhQ folded before Flop (didn't bet)




PokerStars Game #59939716940:  Hold'em No Limit ($0.10/$0.25) - 2009/07/01 0:47:05 ET
Table 'SHi8+hK6i7E2dJ/3Agbyig' 6-max Seat #6 is the button
Seat 1: gPEN9Zp33YTm/mu9/SYP1w ($27 in chips) 
Seat 2: Zijzy/UtPWzWVUo81HHVjQ ($40.80 in chips) 
Seat 3: 2p/OXJK5bWQbcvYltdbSfg ($31.05 in chips) 
Seat 4: +KSG/hZ6NXRHDk1WHcV2+Q ($11.90 in chips) 
Seat 6: NVWCcUck2mqZMp/UrHDLKQ ($18.35 in chips) 
gPEN9Zp33YTm/mu9/SYP1w: posts small blind $0.10
Zijzy/UtPWzWVUo81HHVjQ: posts big blind $0.25
v8m8XHovI5tqEA9mvplDSw: sits out 
*** HOLE CARDS ***
2p/OXJK5bWQbcvYltdbSfg: calls $0.25
+KSG/hZ6NXRHDk1WHcV2+Q: calls $0.25
NVWCcUck2mqZMp/UrHDLKQ: calls $0.25
gPEN9Zp33YTm/mu9/SYP1w: calls $0.15
Zijzy/UtPWzWVUo81HHVjQ: checks 
*** FLOP *** [Qc 7d 9c]
gPEN9Zp33YTm/mu9/SYP1w: checks 
Zijzy/UtPWzWVUo81HHVjQ: checks 
2p/OXJK5bWQbcvYltdbSfg: bets $1
+KSG/hZ6NXRHDk1WHcV2+Q: folds 
NVWCcUck2mqZMp/UrHDLKQ: folds 
gPEN9Zp33YTm/mu9/SYP1w: calls $1
Zijzy/UtPWzWVUo81HHVjQ: folds 
*** TURN *** [Qc 7d 9c] [2d]
gPEN9Zp33YTm/mu9/SYP1w: checks 
2p/OXJK5bWQbcvYltdbSfg: checks 
*** RIVER *** [Qc 7d 9c 2d] [4c]
gPEN9Zp33YTm/mu9/SYP1w: checks 
2p/OXJK5bWQbcvYltdbSfg: checks 
*** SHOW DOWN ***
gPEN9Zp33YTm/mu9/SYP1w: shows [Td 6d] (high card Queen)
2p/OXJK5bWQbcvYltdbSfg: shows [As Qh] (a pair of Queens)
2p/OXJK5bWQbcvYltdbSfg collected $3.10 from pot
*** SUMMARY ***
Total pot $3.25 | Rake $0.15 
Board [Qc 7d 9c 2d 4c]
Seat 1: gPEN9Zp33YTm/mu9/SYP1w (small blind) showed [Td 6d] and lost with high card Queen
Seat 2: Zijzy/UtPWzWVUo81HHVjQ (big blind) folded on the Flop
Seat 3: 2p/OXJK5bWQbcvYltdbSfg showed [As Qh] and won ($3.10) with a pair of Queens
Seat 4: +KSG/hZ6NXRHDk1WHcV2+Q folded on the Flop
Seat 6: NVWCcUck2mqZMp/UrHDLKQ (button) folded on the Flop




PokerStars Game #59939716662:  Hold'em No Limit ($0.10/$0.25) - 2009/07/01 0:47:05 ET
Table 'mVdLgAdN9rGe6mMwSrDdGQ' 6-max Seat #5 is the button
Seat 1: qhK49WKJUNyD5vnZcIeQdg ($6.35 in chips) 
Seat 2: fSUx4e1vURbgXyDBEcRbAg ($4.35 in chips) 
Seat 3: kG34n23qFQA3nzdOJTQ1dA ($24.55 in chips) 
Seat 4: GJsS3gwVwlbyroaWrnjqJg ($24.65 in chips) 
Seat 5: oseFhpinoe+Zg4j5xyBjyQ ($54.80 in chips) 
Seat 6: Ew/TYPQIsbQ2X8nm5iAJBg ($36.50 in chips) 
Ew/TYPQIsbQ2X8nm5iAJBg: posts small blind $0.10
qhK49WKJUNyD5vnZcIeQdg: posts big blind $0.25
*** HOLE CARDS ***
fSUx4e1vURbgXyDBEcRbAg: folds 
kG34n23qFQA3nzdOJTQ1dA: folds 
GJsS3gwVwlbyroaWrnjqJg: folds 
oseFhpinoe+Zg4j5xyBjyQ: folds 
Ew/TYPQIsbQ2X8nm5iAJBg: folds 
Uncalled bet ($0.15) returned to qhK49WKJUNyD5vnZcIeQdg
qhK49WKJUNyD5vnZcIeQdg collected $0.20 from pot
*** SUMMARY ***
Total pot $0.20 | Rake $0 
Seat 1: qhK49WKJUNyD5vnZcIeQdg (big blind) collected ($0.20)
Seat 2: fSUx4e1vURbgXyDBEcRbAg folded before Flop (didn't bet)
Seat 3: kG34n23qFQA3nzdOJTQ1dA folded before Flop (didn't bet)
Seat 4: GJsS3gwVwlbyroaWrnjqJg folded before Flop (didn't bet)
Seat 5: oseFhpinoe+Zg4j5xyBjyQ (button) folded before Flop (didn't bet)
Seat 6: Ew/TYPQIsbQ2X8nm5iAJBg (small blind) folded before Flop




PokerStars Game #59939716736:  Hold'em No Limit ($0.10/$0.25) - 2009/07/01 0:47:05 ET
Table 'ER5H84HUgJx7HyDLnELLeA' 6-max Seat #5 is the button
Seat 1: pjM/xh4+RG8zrxCobDgYDg ($16.70 in chips) 
Seat 2: nc79pm0LZRdhncq55evVqA ($48.50 in chips) 
Seat 3: BYxjLnV1/LL0aZcTbfAOvw ($25 in chips) 
Seat 4: tkRWn3WaJIfGmCXT2hPvJA ($18.40 in chips) 
Seat 5: mfrkWA3PTeYPkbO6hi98Aw ($25.25 in chips) 
Seat 6: 3zD3qLXT1bEffAoWGnc7wg ($30.95 in chips) 
3zD3qLXT1bEffAoWGnc7wg: posts small blind $0.10
pjM/xh4+RG8zrxCobDgYDg: posts big blind $0.25
*** HOLE CARDS ***
nc79pm0LZRdhncq55evVqA: folds 
BYxjLnV1/LL0aZcTbfAOvw: folds 
tkRWn3WaJIfGmCXT2hPvJA: folds 
mfrkWA3PTeYPkbO6hi98Aw: folds 
3zD3qLXT1bEffAoWGnc7wg: folds 
Uncalled bet ($0.15) returned to pjM/xh4+RG8zrxCobDgYDg
pjM/xh4+RG8zrxCobDgYDg collected $0.20 from pot
*** SUMMARY ***
Total pot $0.20 | Rake $0 
Seat 1: pjM/xh4+RG8zrxCobDgYDg (big blind) collected ($0.20)
Seat 2: nc79pm0LZRdhncq55evVqA folded before Flop (didn't bet)
Seat 3: BYxjLnV1/LL0aZcTbfAOvw folded before Flop (didn't bet)
Seat 4: tkRWn3WaJIfGmCXT2hPvJA folded before Flop (didn't bet)
Seat 5: mfrkWA3PTeYPkbO6hi98Aw (button) folded before Flop (didn't bet)
Seat 6: 3zD3qLXT1bEffAoWGnc7wg (small blind) folded before Flop




PokerStars Game #59939716742:  Hold'em No Limit ($0.10/$0.25) - 2009/07/01 0:47:05 ET
Table 'isKy4XK8wJM0x735/D4hWA' 6-max Seat #3 is the button
Seat 1: 7FmwVDcdEtxDpHmP4hOXsQ ($25 in chips) 
Seat 2: WrLI51S2iMb8GLMB83gGqA ($25.50 in chips) 
Seat 3: jp34e617tIzV8tKIWmfAbA ($25 in chips) 
Seat 4: k9vn40MOqqb+xF+7GZ6v2g ($27.80 in chips) 
Seat 5: lquriepNQBhDV5P1SWHhnA ($25 in chips) 
Seat 6: M6xK/VklCvdyyrmvzATlxQ ($17.60 in chips) 
k9vn40MOqqb+xF+7GZ6v2g: posts small blind $0.10
lquriepNQBhDV5P1SWHhnA: posts big blind $0.25
*** HOLE CARDS ***
M6xK/VklCvdyyrmvzATlxQ: folds 
7FmwVDcdEtxDpHmP4hOXsQ: folds 
WrLI51S2iMb8GLMB83gGqA: folds 
jp34e617tIzV8tKIWmfAbA: folds 
k9vn40MOqqb+xF+7GZ6v2g: calls $0.15
lquriepNQBhDV5P1SWHhnA: checks 
*** FLOP *** [6c 2d Th]
k9vn40MOqqb+xF+7GZ6v2g: bets $0.50
lquriepNQBhDV5P1SWHhnA: folds 
Uncalled bet ($0.50) returned to k9vn40MOqqb+xF+7GZ6v2g
k9vn40MOqqb+xF+7GZ6v2g collected $0.50 from pot
*** SUMMARY ***
Total pot $0.50 | Rake $0 
Board [6c 2d Th]
Seat 1: 7FmwVDcdEtxDpHmP4hOXsQ folded before Flop (didn't bet)
Seat 2: WrLI51S2iMb8GLMB83gGqA folded before Flop (didn't bet)
Seat 3: jp34e617tIzV8tKIWmfAbA (button) folded before Flop (didn't bet)
Seat 4: k9vn40MOqqb+xF+7GZ6v2g (small blind) collected ($0.50)
Seat 5: lquriepNQBhDV5P1SWHhnA (big blind) folded on the Flop
Seat 6: M6xK/VklCvdyyrmvzATlxQ folded before Flop (didn't bet)




PokerStars Game #59939717032:  Hold'em No Limit ($0.10/$0.25) - 2009/07/01 0:47:05 ET
Table 'Xi38lWH8L2JHRAsKYVX8Qg' 6-max Seat #6 is the button
Seat 1: AqQ7DFpHkgIzTwDu+rClcg ($5.50 in chips) 
Seat 2: 7iL6KfkJTFbyWmnLYk4+AA ($31.70 in chips) 
Seat 3: 6DwBRH+xZ12AAZmeAg+aXw ($25 in chips) 
Seat 4: kG34n23qFQA3nzdOJTQ1dA ($25.80 in chips) 
Seat 5: 79ID/ub1Pt/mDpCprVmOoA ($25.75 in chips) 
Seat 6: aogAb4Eienxztk8p2v9VVw ($24.75 in chips) 
AqQ7DFpHkgIzTwDu+rClcg: posts small blind $0.10
7iL6KfkJTFbyWmnLYk4+AA: posts big blind $0.25
*** HOLE CARDS ***
6DwBRH+xZ12AAZmeAg+aXw: folds 
kG34n23qFQA3nzdOJTQ1dA: folds 
79ID/ub1Pt/mDpCprVmOoA: folds 
aogAb4Eienxztk8p2v9VVw: folds 
AqQ7DFpHkgIzTwDu+rClcg: folds 
Uncalled bet ($0.15) returned to 7iL6KfkJTFbyWmnLYk4+AA
7iL6KfkJTFbyWmnLYk4+AA collected $0.20 from pot
*** SUMMARY ***
Total pot $0.20 | Rake $0 
Seat 1: AqQ7DFpHkgIzTwDu+rClcg (small blind) folded before Flop
Seat 2: 7iL6KfkJTFbyWmnLYk4+AA (big blind) collected ($0.20)
Seat 3: 6DwBRH+xZ12AAZmeAg+aXw folded before Flop (didn't bet)
Seat 4: kG34n23qFQA3nzdOJTQ1dA folded before Flop (didn't bet)
Seat 5: 79ID/ub1Pt/mDpCprVmOoA folded before Flop (didn't bet)
Seat 6: aogAb4Eienxztk8p2v9VVw (button) folded before Flop (didn't bet)




PokerStars Game #59939716564:  Hold'em No Limit ($0.10/$0.25) - 2009/07/01 0:47:05 ET
Table 'o0CDOvKO/bn1WjeymDrXfA' 6-max Seat #6 is the button
Seat 1: 32YL2ZEp8NT4JB2RVM9euQ ($16 in chips) 
Seat 2: oc4ZGs0W+3RIg2yPyJw3ig ($31.95 in chips) 
Seat 3: EqXTTLKUlDlz7yi6ziyyWA ($25 in chips) 
Seat 4: NuqYPwTLZYQhxOoVK3Yqlw ($25.10 in chips) 
Seat 5: u/yN5P9f3KlATg6WLWNkBQ ($28 in chips) 
Seat 6: Bada343Si4xKu3fNXY99AA ($29.50 in chips) 
32YL2ZEp8NT4JB2RVM9euQ: posts small blind $0.10
oc4ZGs0W+3RIg2yPyJw3ig: posts big blind $0.25
*** HOLE CARDS ***
EqXTTLKUlDlz7yi6ziyyWA: raises $1.75 to $2
NuqYPwTLZYQhxOoVK3Yqlw: folds 
u/yN5P9f3KlATg6WLWNkBQ: folds 
Bada343Si4xKu3fNXY99AA: folds 
32YL2ZEp8NT4JB2RVM9euQ: calls $1.90
oc4ZGs0W+3RIg2yPyJw3ig: folds 
*** FLOP *** [9d Td 6s]
32YL2ZEp8NT4JB2RVM9euQ: checks 
EqXTTLKUlDlz7yi6ziyyWA: bets $3.25
32YL2ZEp8NT4JB2RVM9euQ: raises $3.25 to $6.50
EqXTTLKUlDlz7yi6ziyyWA: raises $3.25 to $9.75
32YL2ZEp8NT4JB2RVM9euQ: raises $4.25 to $14 and is all-in
EqXTTLKUlDlz7yi6ziyyWA: calls $4.25
*** TURN *** [9d Td 6s] [Qs]
*** RIVER *** [9d Td 6s Qs] [5s]
*** SHOW DOWN ***
32YL2ZEp8NT4JB2RVM9euQ: shows [6c 6d] (three of a kind, Sixes)
EqXTTLKUlDlz7yi6ziyyWA: mucks hand 
32YL2ZEp8NT4JB2RVM9euQ collected $30.65 from pot
*** SUMMARY ***
Total pot $32.25 | Rake $1.60 
Board [9d Td 6s Qs 5s]
Seat 1: 32YL2ZEp8NT4JB2RVM9euQ (small blind) showed [6c 6d] and won ($30.65) with three of a kind, Sixes
Seat 2: oc4ZGs0W+3RIg2yPyJw3ig (big blind) folded before Flop
Seat 3: EqXTTLKUlDlz7yi6ziyyWA mucked
Seat 4: NuqYPwTLZYQhxOoVK3Yqlw folded before Flop (didn't bet)
Seat 5: u/yN5P9f3KlATg6WLWNkBQ folded before Flop (didn't bet)
Seat 6: Bada343Si4xKu3fNXY99AA (button) folded before Flop (didn't bet)




PokerStars Game #59939716452:  Hold'em No Limit ($0.10/$0.25) - 2009/07/01 0:47:05 ET
Table 'APEHQjIcZHDZUA4iOjju2g' 6-max Seat #6 is the button
Seat 1: eHsmIvAb2JREg4O6hNPnXg ($5.15 in chips) 
Seat 2: 3zD3qLXT1bEffAoWGnc7wg ($25 in chips) 
Seat 3: E7KSkgfIsmIsp0vLnmGFmA ($18 in chips) 
Seat 4: EqXTTLKUlDlz7yi6ziyyWA ($3.50 in chips) 
Seat 5: /xN6gc9+8Hew0HxaB6VIVg ($59.25 in chips) 
Seat 6: y7HCJfEmolBCFdi/0j5TRg ($44.35 in chips) 
eHsmIvAb2JREg4O6hNPnXg: posts small blind $0.10
3zD3qLXT1bEffAoWGnc7wg: posts big blind $0.25
*** HOLE CARDS ***
E7KSkgfIsmIsp0vLnmGFmA: folds 
EqXTTLKUlDlz7yi6ziyyWA: calls $0.25
/xN6gc9+8Hew0HxaB6VIVg: calls $0.25
y7HCJfEmolBCFdi/0j5TRg: folds 
eHsmIvAb2JREg4O6hNPnXg: calls $0.15
3zD3qLXT1bEffAoWGnc7wg: checks 
*** FLOP *** [4h Jh 9c]
eHsmIvAb2JREg4O6hNPnXg: checks 
3zD3qLXT1bEffAoWGnc7wg: bets $0.75
EqXTTLKUlDlz7yi6ziyyWA: calls $0.75
/xN6gc9+8Hew0HxaB6VIVg: folds 
eHsmIvAb2JREg4O6hNPnXg: folds 
*** TURN *** [4h Jh 9c] [Ad]
3zD3qLXT1bEffAoWGnc7wg: bets $1.50
EqXTTLKUlDlz7yi6ziyyWA: folds 
Uncalled bet ($1.50) returned to 3zD3qLXT1bEffAoWGnc7wg
3zD3qLXT1bEffAoWGnc7wg collected $2.40 from pot
3zD3qLXT1bEffAoWGnc7wg: doesn't show hand 
*** SUMMARY ***
Total pot $2.50 | Rake $0.10 
Board [4h Jh 9c Ad]
Seat 1: eHsmIvAb2JREg4O6hNPnXg (small blind) folded on the Flop
Seat 2: 3zD3qLXT1bEffAoWGnc7wg (big blind) collected ($2.40)
Seat 3: E7KSkgfIsmIsp0vLnmGFmA folded before Flop (didn't bet)
Seat 4: EqXTTLKUlDlz7yi6ziyyWA folded on the Turn
Seat 5: /xN6gc9+8Hew0HxaB6VIVg folded on the Flop
Seat 6: y7HCJfEmolBCFdi/0j5TRg (button) folded before Flop (didn't bet)




PokerStars Game #59939717266:  Hold'em No Limit ($0.10/$0.25) - 2009/07/01 0:47:06 ET
Table 'O5NgMYt6EWbLBozZb3kseg' 6-max Seat #6 is the button
Seat 1: T2fEtpqj5ZyZAjEhNtsFAA ($56.25 in chips) 
Seat 2: VWbjqONyDvf8KegytgPLjQ ($57.75 in chips) 
Seat 3: dg3SMYXD7586yGx+LuFM0g ($19.15 in chips) 
Seat 4: aogAb4Eienxztk8p2v9VVw ($26.25 in chips) 
Seat 5: vu2kzHaDtgr6NM7rdq0chA ($75.05 in chips) 
Seat 6: k9vn40MOqqb+xF+7GZ6v2g ($25 in chips) 
T2fEtpqj5ZyZAjEhNtsFAA: posts small blind $0.10
VWbjqONyDvf8KegytgPLjQ: posts big blind $0.25
*** HOLE CARDS ***
dg3SMYXD7586yGx+LuFM0g: raises $1 to $1.25
aogAb4Eienxztk8p2v9VVw: folds 
vu2kzHaDtgr6NM7rdq0chA: folds 
k9vn40MOqqb+xF+7GZ6v2g: folds 
T2fEtpqj5ZyZAjEhNtsFAA: calls $1.15
VWbjqONyDvf8KegytgPLjQ: calls $1
*** FLOP *** [Td 2s Jd]
T2fEtpqj5ZyZAjEhNtsFAA: checks 
VWbjqONyDvf8KegytgPLjQ: checks 
dg3SMYXD7586yGx+LuFM0g: checks 
*** TURN *** [Td 2s Jd] [8s]
T2fEtpqj5ZyZAjEhNtsFAA: bets $1.50
VWbjqONyDvf8KegytgPLjQ: calls $1.50
dg3SMYXD7586yGx+LuFM0g: calls $1.50
*** RIVER *** [Td 2s Jd 8s] [Js]
T2fEtpqj5ZyZAjEhNtsFAA: bets $3.75
VWbjqONyDvf8KegytgPLjQ: folds 
dg3SMYXD7586yGx+LuFM0g: folds 
Uncalled bet ($3.75) returned to T2fEtpqj5ZyZAjEhNtsFAA
T2fEtpqj5ZyZAjEhNtsFAA collected $7.85 from pot
T2fEtpqj5ZyZAjEhNtsFAA: doesn't show hand 
*** SUMMARY ***
Total pot $8.25 | Rake $0.40 
Board [Td 2s Jd 8s Js]
Seat 1: T2fEtpqj5ZyZAjEhNtsFAA (small blind) collected ($7.85)
Seat 2: VWbjqONyDvf8KegytgPLjQ (big blind) folded on the River
Seat 3: dg3SMYXD7586yGx+LuFM0g folded on the River
Seat 4: aogAb4Eienxztk8p2v9VVw folded before Flop (didn't bet)
Seat 5: vu2kzHaDtgr6NM7rdq0chA folded before Flop (didn't bet)
Seat 6: k9vn40MOqqb+xF+7GZ6v2g (button) folded before Flop (didn't bet)




PokerStars Game #59939717624:  Hold'em No Limit ($0.10/$0.25) - 2009/07/01 0:47:06 ET
Table 'g+mPuNJBCHKE9ents7ZGtg' 6-max Seat #4 is the button
Seat 1: YaAEMJGY5tem39deCUQRNw ($24 in chips) 
Seat 2: fZQg9veL7Dd/Z04ZTjC+wQ ($30.35 in chips) 
Seat 3: 9jSiy0meE9XJKkdIZwyTEQ ($36.10 in chips) 
Seat 4: mfrkWA3PTeYPkbO6hi98Aw ($24.30 in chips) 
Seat 5: 32YL2ZEp8NT4JB2RVM9euQ ($15.40 in chips) 
Seat 6: MS2T205Bjud7PnNoANu4vQ ($46.65 in chips) 
32YL2ZEp8NT4JB2RVM9euQ: posts small blind $0.10
MS2T205Bjud7PnNoANu4vQ: posts big blind $0.25
*** HOLE CARDS ***
YaAEMJGY5tem39deCUQRNw: folds 
fZQg9veL7Dd/Z04ZTjC+wQ: folds 
9jSiy0meE9XJKkdIZwyTEQ: folds 
mfrkWA3PTeYPkbO6hi98Aw: folds 
32YL2ZEp8NT4JB2RVM9euQ: raises $0.75 to $1
MS2T205Bjud7PnNoANu4vQ: calls $0.75
*** FLOP *** [2d 8c Ac]
32YL2ZEp8NT4JB2RVM9euQ: checks 
MS2T205Bjud7PnNoANu4vQ: checks 
*** TURN *** [2d 8c Ac] [Jh]
32YL2ZEp8NT4JB2RVM9euQ: checks 
MS2T205Bjud7PnNoANu4vQ: checks 
*** RIVER *** [2d 8c Ac Jh] [8d]
32YL2ZEp8NT4JB2RVM9euQ: checks 
MS2T205Bjud7PnNoANu4vQ: checks 
*** SHOW DOWN ***
32YL2ZEp8NT4JB2RVM9euQ: shows [Ts Qd] (a pair of Eights)
MS2T205Bjud7PnNoANu4vQ: shows [2s 6s] (two pair, Eights and Deuces)
MS2T205Bjud7PnNoANu4vQ collected $1.90 from pot
*** SUMMARY ***
Total pot $2 | Rake $0.10 
Board [2d 8c Ac Jh 8d]
Seat 1: YaAEMJGY5tem39deCUQRNw folded before Flop (didn't bet)
Seat 2: fZQg9veL7Dd/Z04ZTjC+wQ folded before Flop (didn't bet)
Seat 3: 9jSiy0meE9XJKkdIZwyTEQ folded before Flop (didn't bet)
Seat 4: mfrkWA3PTeYPkbO6hi98Aw (button) folded before Flop (didn't bet)
Seat 5: 32YL2ZEp8NT4JB2RVM9euQ (small blind) showed [Ts Qd] and lost with a pair of Eights
Seat 6: MS2T205Bjud7PnNoANu4vQ (big blind) showed [2s 6s] and won ($1.90) with two pair, Eights and Deuces




PokerStars Game #59939717128:  Hold'em No Limit ($0.10/$0.25) - 2009/07/01 0:47:06 ET
Table '/VaaaFnlEJoYVomG9uxHkA' 9-max Seat #4 is the button
Seat 2: DIkeSkosO/tsUp9d2JVyTA ($9.25 in chips) 
Seat 3: 32P5dKDi4pEUiDHMQTV1uw ($23.50 in chips) 
Seat 4: j4q3p0lesp63b1gZDwLBZw ($5 in chips) 
Seat 5: LWN1wPrLH+695JIriXxDuw ($18.75 in chips) 
Seat 7: F7pnn6czNpHvRM55XcA2EA ($25 in chips) 
Seat 8: n9toqYXSLowQ/sWq842dEQ ($14.85 in chips) 
Seat 9: r1pFKMwWp74QwhfPWJOAyw ($9.75 in chips) 
LWN1wPrLH+695JIriXxDuw: posts small blind $0.10
5MgYq10OC5iGoxQFwlJVuw: is sitting out 
5MgYq10OC5iGoxQFwlJVuw leaves the table
F7pnn6czNpHvRM55XcA2EA: posts big blind $0.25
Th3FldXKQW6hWVVPahaoOQ: sits out 
*** HOLE CARDS ***
n9toqYXSLowQ/sWq842dEQ: folds 
r1pFKMwWp74QwhfPWJOAyw: folds 
Chevalier 19 joins the table at seat #6 
DIkeSkosO/tsUp9d2JVyTA: calls $0.25
32P5dKDi4pEUiDHMQTV1uw: calls $0.25
j4q3p0lesp63b1gZDwLBZw: folds 
LWN1wPrLH+695JIriXxDuw: folds 
F7pnn6czNpHvRM55XcA2EA: checks 
*** FLOP *** [7d Qc 2d]
F7pnn6czNpHvRM55XcA2EA: checks 
DIkeSkosO/tsUp9d2JVyTA: bets $0.25
32P5dKDi4pEUiDHMQTV1uw: raises $0.25 to $0.50
F7pnn6czNpHvRM55XcA2EA: folds 
DIkeSkosO/tsUp9d2JVyTA: calls $0.25
*** TURN *** [7d Qc 2d] [Tc]
DIkeSkosO/tsUp9d2JVyTA: checks 
32P5dKDi4pEUiDHMQTV1uw: bets $0.75
DIkeSkosO/tsUp9d2JVyTA: folds 
Uncalled bet ($0.75) returned to 32P5dKDi4pEUiDHMQTV1uw
32P5dKDi4pEUiDHMQTV1uw collected $1.80 from pot
32P5dKDi4pEUiDHMQTV1uw: doesn't show hand 
*** SUMMARY ***
Total pot $1.85 | Rake $0.05 
Board [7d Qc 2d Tc]
Seat 2: DIkeSkosO/tsUp9d2JVyTA folded on the Turn
Seat 3: 32P5dKDi4pEUiDHMQTV1uw collected ($1.80)
Seat 4: j4q3p0lesp63b1gZDwLBZw (button) folded before Flop (didn't bet)
Seat 5: LWN1wPrLH+695JIriXxDuw (small blind) folded before Flop
Seat 7: F7pnn6czNpHvRM55XcA2EA (big blind) folded on the Flop
Seat 8: n9toqYXSLowQ/sWq842dEQ folded before Flop (didn't bet)
Seat 9: r1pFKMwWp74QwhfPWJOAyw folded before Flop (didn't bet)




PokerStars Game #59939717580:  Hold'em No Limit ($0.10/$0.25) - 2009/07/01 0:47:06 ET
Table 'Is9eNmJA1KnBOw0lcVkxUQ' 9-max Seat #2 is the button
Seat 1: 56S3mA6Zs3pGR+0p0vUCtg ($38.35 in chips) 
Seat 2: VllYilcih0t+gMD4GTRlgQ ($29.15 in chips) 
Seat 3: zFrHk6ssFhTu+DiVzVXr+g ($10.10 in chips) 
Seat 4: cZ99hugmLBj9KhTlc8nCSw ($25 in chips) 
Seat 6: HapyJHxV6lc3eqoT7yWL2A ($45.40 in chips) 
Seat 7: aNpwfA31EREwO+ar4XzBCw ($25 in chips) 
Seat 8: 1b3eMBC7sPXgDX9IYcruKg ($2.90 in chips) 
Seat 9: 7wo6Sr7QG3Zo6BaBDV1BOw ($5 in chips) 
zFrHk6ssFhTu+DiVzVXr+g: posts small blind $0.10
cZ99hugmLBj9KhTlc8nCSw: posts big blind $0.25
V6p0jQ/RhUsqpHLmXvEX4Q: sits out 
*** HOLE CARDS ***
HapyJHxV6lc3eqoT7yWL2A: calls $0.25
aNpwfA31EREwO+ar4XzBCw: folds 
1b3eMBC7sPXgDX9IYcruKg: folds 
7wo6Sr7QG3Zo6BaBDV1BOw: folds 
56S3mA6Zs3pGR+0p0vUCtg: folds 
VllYilcih0t+gMD4GTRlgQ: folds 
zFrHk6ssFhTu+DiVzVXr+g: calls $0.15
cZ99hugmLBj9KhTlc8nCSw: checks 
*** FLOP *** [8s Jd 7d]
zFrHk6ssFhTu+DiVzVXr+g: checks 
cZ99hugmLBj9KhTlc8nCSw: checks 
HapyJHxV6lc3eqoT7yWL2A: checks 
*** TURN *** [8s Jd 7d] [3d]
zFrHk6ssFhTu+DiVzVXr+g: checks 
cZ99hugmLBj9KhTlc8nCSw: checks 
HapyJHxV6lc3eqoT7yWL2A: checks 
*** RIVER *** [8s Jd 7d 3d] [3c]
zFrHk6ssFhTu+DiVzVXr+g: checks 
cZ99hugmLBj9KhTlc8nCSw: checks 
HapyJHxV6lc3eqoT7yWL2A: checks 
*** SHOW DOWN ***
zFrHk6ssFhTu+DiVzVXr+g: shows [9c As] (a pair of Threes)
cZ99hugmLBj9KhTlc8nCSw: mucks hand 
HapyJHxV6lc3eqoT7yWL2A: shows [7h Qs] (two pair, Sevens and Threes)
HapyJHxV6lc3eqoT7yWL2A collected $0.75 from pot
*** SUMMARY ***
Total pot $0.75 | Rake $0 
Board [8s Jd 7d 3d 3c]
Seat 1: 56S3mA6Zs3pGR+0p0vUCtg folded before Flop (didn't bet)
Seat 2: VllYilcih0t+gMD4GTRlgQ (button) folded before Flop (didn't bet)
Seat 3: zFrHk6ssFhTu+DiVzVXr+g (small blind) showed [9c As] and lost with a pair of Threes
Seat 4: cZ99hugmLBj9KhTlc8nCSw (big blind) mucked
Seat 6: HapyJHxV6lc3eqoT7yWL2A showed [7h Qs] and won ($0.75) with two pair, Sevens and Threes
Seat 7: aNpwfA31EREwO+ar4XzBCw folded before Flop (didn't bet)
Seat 8: 1b3eMBC7sPXgDX9IYcruKg folded before Flop (didn't bet)
Seat 9: 7wo6Sr7QG3Zo6BaBDV1BOw folded before Flop (didn't bet)




PokerStars Game #59939717668:  Hold'em No Limit ($0.10/$0.25) - 2009/07/01 0:47:06 ET
Table 'Y9EhDWuqWWQFM9SelXAj5g' 9-max Seat #2 is the button
Seat 1: zDrucyjVn5aeekNEc3cJrA ($18.10 in chips) 
Seat 2: nEg1b6MIksd/4x5eLY735g ($38.75 in chips) 
Seat 3: CbXUS6Z2rXZxL1AKduNtmQ ($25 in chips) 
Seat 5: LY5GvFqMlE3xxbG85bDqlw ($8.60 in chips) 
Seat 6: STkR8XvpjNv79OOMhrlh2w ($28.95 in chips) 
Seat 7: aNpwfA31EREwO+ar4XzBCw ($30.25 in chips) 
Seat 8: XDxyajtqmdag0QPvwcOG7Q ($9.35 in chips) 
Seat 9: K7bAhhMMJ/XcTmGaBZVfFQ ($26.40 in chips) 
CbXUS6Z2rXZxL1AKduNtmQ: posts small blind $0.10
5MgYq10OC5iGoxQFwlJVuw: is sitting out 
5MgYq10OC5iGoxQFwlJVuw leaves the table
LY5GvFqMlE3xxbG85bDqlw: posts big blind $0.25
*** HOLE CARDS ***
STkR8XvpjNv79OOMhrlh2w: calls $0.25
aNpwfA31EREwO+ar4XzBCw: folds 
XDxyajtqmdag0QPvwcOG7Q: calls $0.25
K7bAhhMMJ/XcTmGaBZVfFQ: folds 
zDrucyjVn5aeekNEc3cJrA: calls $0.25
nEg1b6MIksd/4x5eLY735g: folds 
CbXUS6Z2rXZxL1AKduNtmQ: calls $0.15
LY5GvFqMlE3xxbG85bDqlw: checks 
*** FLOP *** [Kd Qd Qh]
V6p0jQ/RhUsqpHLmXvEX4Q joins the table at seat #4 
CbXUS6Z2rXZxL1AKduNtmQ: checks 
LY5GvFqMlE3xxbG85bDqlw: bets $0.25
STkR8XvpjNv79OOMhrlh2w: folds 
XDxyajtqmdag0QPvwcOG7Q: folds 
zDrucyjVn5aeekNEc3cJrA: calls $0.25
CbXUS6Z2rXZxL1AKduNtmQ: folds 
*** TURN *** [Kd Qd Qh] [7d]
LY5GvFqMlE3xxbG85bDqlw: checks 
zDrucyjVn5aeekNEc3cJrA: checks 
*** RIVER *** [Kd Qd Qh 7d] [Qc]
LY5GvFqMlE3xxbG85bDqlw: bets $0.50
zDrucyjVn5aeekNEc3cJrA: calls $0.50
*** SHOW DOWN ***
LY5GvFqMlE3xxbG85bDqlw: shows [2h 5h] (three of a kind, Queens)
zDrucyjVn5aeekNEc3cJrA: shows [Js Jc] (a full house, Queens full of Jacks)
zDrucyjVn5aeekNEc3cJrA collected $2.65 from pot
*** SUMMARY ***
Total pot $2.75 | Rake $0.10 
Board [Kd Qd Qh 7d Qc]
Seat 1: zDrucyjVn5aeekNEc3cJrA showed [Js Jc] and won ($2.65) with a full house, Queens full of Jacks
Seat 2: nEg1b6MIksd/4x5eLY735g (button) folded before Flop (didn't bet)
Seat 3: CbXUS6Z2rXZxL1AKduNtmQ (small blind) folded on the Flop
Seat 5: LY5GvFqMlE3xxbG85bDqlw (big blind) showed [2h 5h] and lost with three of a kind, Queens
Seat 6: STkR8XvpjNv79OOMhrlh2w folded on the Flop
Seat 7: aNpwfA31EREwO+ar4XzBCw folded before Flop (didn't bet)
Seat 8: XDxyajtqmdag0QPvwcOG7Q folded on the Flop
Seat 9: K7bAhhMMJ/XcTmGaBZVfFQ folded before Flop (didn't bet)




PokerStars Game #59939717408:  Hold'em No Limit ($0.10/$0.25) - 2009/07/01 0:47:06 ET
Table '8QBBaev+cI2i/r2H6ml/lg' 9-max Seat #6 is the button
Seat 4: ZoG0obuajzVjwgd7lNHjgg ($4 in chips) 
Seat 6: cxE+szmvEUe7vE+z2ozM2Q ($11 in chips) 
cxE+szmvEUe7vE+z2ozM2Q: posts small blind $0.10
ZoG0obuajzVjwgd7lNHjgg: posts big blind $0.25
*** HOLE CARDS ***
cxE+szmvEUe7vE+z2ozM2Q: folds 
Uncalled bet ($0.15) returned to ZoG0obuajzVjwgd7lNHjgg
ZoG0obuajzVjwgd7lNHjgg collected $0.20 from pot
*** SUMMARY ***
Total pot $0.20 | Rake $0 
Seat 4: ZoG0obuajzVjwgd7lNHjgg (big blind) collected ($0.20)
Seat 6: cxE+szmvEUe7vE+z2ozM2Q (button) (small blind) folded before Flop




PokerStars Game #59939717912:  Hold'em No Limit ($0.10/$0.25) - 2009/07/01 0:47:07 ET
Table '7/qMNloI0nSXWiX5Y1watA' 9-max Seat #9 is the button
Seat 1: lF4l0ujUfJ9uYJOg9Ch9/g ($42.85 in chips) 
Seat 2: 8B/dhbQjIWe6ASCdgzktNQ ($25.40 in chips) 
Seat 3: nEg1b6MIksd/4x5eLY735g ($42.70 in chips) 
Seat 4: 18G4P1XstjNvItdGUITxgw ($25 in chips) 
Seat 5: dfNim92Z6XK1/h5SFW5vDg ($41.05 in chips) 
Seat 6: vnCdP3GsLTKadDukKcJk/Q ($25 in chips) 
Seat 7: z5GxcHlYz/GSz6W2uFiTtg ($11.20 in chips) 
Seat 8: ljemhp25Zg+nlA9DLCIiUw ($24.45 in chips) 
Seat 9: aZgYUTCgC/6gwsjG/ryBrw ($25 in chips) 
lF4l0ujUfJ9uYJOg9Ch9/g: posts small blind $0.10
8B/dhbQjIWe6ASCdgzktNQ: posts big blind $0.25
*** HOLE CARDS ***
nEg1b6MIksd/4x5eLY735g: folds 
18G4P1XstjNvItdGUITxgw: raises $0.50 to $0.75
dfNim92Z6XK1/h5SFW5vDg: folds 
vnCdP3GsLTKadDukKcJk/Q: folds 
z5GxcHlYz/GSz6W2uFiTtg: folds 
ljemhp25Zg+nlA9DLCIiUw: folds 
aZgYUTCgC/6gwsjG/ryBrw: folds 
lF4l0ujUfJ9uYJOg9Ch9/g: calls $0.65
8B/dhbQjIWe6ASCdgzktNQ: folds 
*** FLOP *** [2c As 5s]
lF4l0ujUfJ9uYJOg9Ch9/g: checks 
18G4P1XstjNvItdGUITxgw: bets $0.75
lF4l0ujUfJ9uYJOg9Ch9/g: calls $0.75
*** TURN *** [2c As 5s] [Ks]
lF4l0ujUfJ9uYJOg9Ch9/g: checks 
18G4P1XstjNvItdGUITxgw: checks 
*** RIVER *** [2c As 5s Ks] [6s]
lF4l0ujUfJ9uYJOg9Ch9/g: bets $1
18G4P1XstjNvItdGUITxgw: calls $1
*** SHOW DOWN ***
lF4l0ujUfJ9uYJOg9Ch9/g: shows [7s 7d] (a flush, Ace high)
18G4P1XstjNvItdGUITxgw: mucks hand 
lF4l0ujUfJ9uYJOg9Ch9/g collected $5 from pot
*** SUMMARY ***
Total pot $5.25 | Rake $0.25 
Board [2c As 5s Ks 6s]
Seat 1: lF4l0ujUfJ9uYJOg9Ch9/g (small blind) showed [7s 7d] and won ($5) with a flush, Ace high
Seat 2: 8B/dhbQjIWe6ASCdgzktNQ (big blind) folded before Flop
Seat 3: nEg1b6MIksd/4x5eLY735g folded before Flop (didn't bet)
Seat 4: 18G4P1XstjNvItdGUITxgw mucked
Seat 5: dfNim92Z6XK1/h5SFW5vDg folded before Flop (didn't bet)
Seat 6: vnCdP3GsLTKadDukKcJk/Q folded before Flop (didn't bet)
Seat 7: z5GxcHlYz/GSz6W2uFiTtg folded before Flop (didn't bet)
Seat 8: ljemhp25Zg+nlA9DLCIiUw folded before Flop (didn't bet)
Seat 9: aZgYUTCgC/6gwsjG/ryBrw (button) folded before Flop (didn't bet)




PokerStars Game #59939717846:  Hold'em No Limit ($0.10/$0.25) - 2009/07/01 0:47:07 ET
Table 'KYX9dFNuOA9l2PV46IebqQ' 9-max Seat #7 is the button
Seat 1: s7Q6uNouhe7aE8JdFb9E+A ($27.40 in chips) 
Seat 3: f+H1PHwj9cNu4Y6FfvKwQQ ($29.35 in chips) 
Seat 4: SkLOm0UugROBRt2EfMpOxQ ($25.35 in chips) 
Seat 5: HQMjiff9S04k8kyC4fHVgw ($3.65 in chips) 
Seat 6: DiSvPC2iudwL5j9u6Huyww ($25 in chips) 
Seat 7: QOyn4M230Dsb5atoXgDy9A ($13.05 in chips) 
Seat 8: 4oA316mXLIui1QY63GXBUg ($25 in chips) 
Seat 9: W4TLQcZ2TiM73eIgpIvlGg ($34.90 in chips) 
4oA316mXLIui1QY63GXBUg: posts small blind $0.10
W4TLQcZ2TiM73eIgpIvlGg: posts big blind $0.25
MrPo4/ymXwg9lzPRybrXbA: sits out 
*** HOLE CARDS ***
s7Q6uNouhe7aE8JdFb9E+A: folds 
f+H1PHwj9cNu4Y6FfvKwQQ: folds 
SkLOm0UugROBRt2EfMpOxQ: folds 
HQMjiff9S04k8kyC4fHVgw: folds 
DiSvPC2iudwL5j9u6Huyww: raises $0.50 to $0.75
QOyn4M230Dsb5atoXgDy9A: calls $0.75
4oA316mXLIui1QY63GXBUg: folds 
W4TLQcZ2TiM73eIgpIvlGg: folds 
*** FLOP *** [7h 8h 3s]
DiSvPC2iudwL5j9u6Huyww: checks 
QOyn4M230Dsb5atoXgDy9A: checks 
*** TURN *** [7h 8h 3s] [8d]
DiSvPC2iudwL5j9u6Huyww: checks 
QOyn4M230Dsb5atoXgDy9A: checks 
*** RIVER *** [7h 8h 3s 8d] [Qh]
DiSvPC2iudwL5j9u6Huyww: bets $0.50
QOyn4M230Dsb5atoXgDy9A: calls $0.50
*** SHOW DOWN ***
DiSvPC2iudwL5j9u6Huyww: shows [Qc Ks] (two pair, Queens and Eights)
QOyn4M230Dsb5atoXgDy9A: mucks hand 
DiSvPC2iudwL5j9u6Huyww collected $2.75 from pot
*** SUMMARY ***
Total pot $2.85 | Rake $0.10 
Board [7h 8h 3s 8d Qh]
Seat 1: s7Q6uNouhe7aE8JdFb9E+A folded before Flop (didn't bet)
Seat 3: f+H1PHwj9cNu4Y6FfvKwQQ folded before Flop (didn't bet)
Seat 4: SkLOm0UugROBRt2EfMpOxQ folded before Flop (didn't bet)
Seat 5: HQMjiff9S04k8kyC4fHVgw folded before Flop (didn't bet)
Seat 6: DiSvPC2iudwL5j9u6Huyww showed [Qc Ks] and won ($2.75) with two pair, Queens and Eights
Seat 7: QOyn4M230Dsb5atoXgDy9A (button) mucked
Seat 8: 4oA316mXLIui1QY63GXBUg (small blind) folded before Flop
Seat 9: W4TLQcZ2TiM73eIgpIvlGg (big blind) folded before Flop




PokerStars Game #59939717954:  Hold'em No Limit ($0.10/$0.25) - 2009/07/01 0:47:07 ET
Table '+fuYjvJy9okLr23QyZtanA' 9-max Seat #4 is the button
Seat 1: s7Q6uNouhe7aE8JdFb9E+A ($25 in chips) 
Seat 4: H/l9NZvuOXwQIPOaVdj0rQ ($9.65 in chips) 
Seat 5: h48vKHbhkYz+3RYZCQ0tgA ($22.25 in chips) 
Seat 6: m8t4Jb/b1Fc5HHGe1uSZag ($6 in chips) 
h48vKHbhkYz+3RYZCQ0tgA: posts small blind $0.10
m8t4Jb/b1Fc5HHGe1uSZag: posts big blind $0.25
*** HOLE CARDS ***
s7Q6uNouhe7aE8JdFb9E+A: folds 
H/l9NZvuOXwQIPOaVdj0rQ: calls $0.25
h48vKHbhkYz+3RYZCQ0tgA: calls $0.15
m8t4Jb/b1Fc5HHGe1uSZag: raises $0.50 to $0.75
H/l9NZvuOXwQIPOaVdj0rQ: calls $0.50
h48vKHbhkYz+3RYZCQ0tgA: folds 
*** FLOP *** [5d 4s 8s]
m8t4Jb/b1Fc5HHGe1uSZag: checks 
H/l9NZvuOXwQIPOaVdj0rQ: bets $2.75
cFmpjvcjNoVAEAIQIxWkYg joins the table at seat #7 
m8t4Jb/b1Fc5HHGe1uSZag: folds 
Uncalled bet ($2.75) returned to H/l9NZvuOXwQIPOaVdj0rQ
H/l9NZvuOXwQIPOaVdj0rQ collected $1.70 from pot
H/l9NZvuOXwQIPOaVdj0rQ: doesn't show hand 
*** SUMMARY ***
Total pot $1.75 | Rake $0.05 
Board [5d 4s 8s]
Seat 1: s7Q6uNouhe7aE8JdFb9E+A folded before Flop (didn't bet)
Seat 4: H/l9NZvuOXwQIPOaVdj0rQ (button) collected ($1.70)
Seat 5: h48vKHbhkYz+3RYZCQ0tgA (small blind) folded before Flop
Seat 6: m8t4Jb/b1Fc5HHGe1uSZag (big blind) folded on the Flop




PokerStars Game #59939717932:  Hold'em No Limit ($0.10/$0.25) - 2009/07/01 0:47:07 ET
Table 'ORSZkZqq+7Ja2PdeCFAytA' 9-max Seat #1 is the button
Seat 1: Gpa8cld5y0mdOomHJgHhlA ($3.90 in chips) 
Seat 4: PJJTm/ccITEBlwPReiBTwg ($10 in chips) 
Seat 5: fOv1xoqR8m9slwElVu7Y+A ($17.90 in chips) 
PJJTm/ccITEBlwPReiBTwg: posts small blind $0.10
fOv1xoqR8m9slwElVu7Y+A: posts big blind $0.25
*** HOLE CARDS ***
Gpa8cld5y0mdOomHJgHhlA: calls $0.25
PJJTm/ccITEBlwPReiBTwg: calls $0.15
fOv1xoqR8m9slwElVu7Y+A: checks 
*** FLOP *** [9d 8c 8h]
PJJTm/ccITEBlwPReiBTwg: checks 
fOv1xoqR8m9slwElVu7Y+A: bets $0.25
Gpa8cld5y0mdOomHJgHhlA: calls $0.25
PJJTm/ccITEBlwPReiBTwg: folds 
*** TURN *** [9d 8c 8h] [5s]
hIss79a4pu7GzJZepfgOpg joins the table at seat #6 
fOv1xoqR8m9slwElVu7Y+A: bets $0.25
Gpa8cld5y0mdOomHJgHhlA: calls $0.25
*** RIVER *** [9d 8c 8h 5s] [Js]
fOv1xoqR8m9slwElVu7Y+A: bets $0.25
Gpa8cld5y0mdOomHJgHhlA: calls $0.25
*** SHOW DOWN ***
fOv1xoqR8m9slwElVu7Y+A: shows [9h Kd] (two pair, Nines and Eights)
Gpa8cld5y0mdOomHJgHhlA: mucks hand 
fOv1xoqR8m9slwElVu7Y+A collected $2.15 from pot
*** SUMMARY ***
Total pot $2.25 | Rake $0.10 
Board [9d 8c 8h 5s Js]
Seat 1: Gpa8cld5y0mdOomHJgHhlA (button) mucked
Seat 4: PJJTm/ccITEBlwPReiBTwg (small blind) folded on the Flop
Seat 5: fOv1xoqR8m9slwElVu7Y+A (big blind) showed [9h Kd] and won ($2.15) with two pair, Nines and Eights




PokerStars Game #59939718272:  Hold'em No Limit ($0.10/$0.25) - 2009/07/01 0:47:07 ET
Table '84TjTrgbsYZladOc4PWf4Q' 6-max Seat #6 is the button
Seat 1: 79ID/ub1Pt/mDpCprVmOoA ($29.75 in chips) 
Seat 2: RpaEX9P7BCvyfPRLiRNg0A ($15.35 in chips) 
Seat 3: Ar4vsUIUfJ7gbYh1c1m59g ($14.65 in chips) 
Seat 4: SxIIgwXYLkwd6m3wLyPTCw ($25 in chips) 
Seat 5: YaAEMJGY5tem39deCUQRNw ($26.70 in chips) 
Seat 6: 7qRk4YH4/k/08LgJSv7rBQ ($26.10 in chips) 
79ID/ub1Pt/mDpCprVmOoA: posts small blind $0.10
RpaEX9P7BCvyfPRLiRNg0A: posts big blind $0.25
*** HOLE CARDS ***
Ar4vsUIUfJ7gbYh1c1m59g: folds 
SxIIgwXYLkwd6m3wLyPTCw: folds 
YaAEMJGY5tem39deCUQRNw: raises $1 to $1.25
7qRk4YH4/k/08LgJSv7rBQ: folds 
79ID/ub1Pt/mDpCprVmOoA: folds 
RpaEX9P7BCvyfPRLiRNg0A: folds 
Uncalled bet ($1) returned to YaAEMJGY5tem39deCUQRNw
YaAEMJGY5tem39deCUQRNw collected $0.60 from pot
YaAEMJGY5tem39deCUQRNw: doesn't show hand 
*** SUMMARY ***
Total pot $0.60 | Rake $0 
Seat 1: 79ID/ub1Pt/mDpCprVmOoA (small blind) folded before Flop
Seat 2: RpaEX9P7BCvyfPRLiRNg0A (big blind) folded before Flop
Seat 3: Ar4vsUIUfJ7gbYh1c1m59g folded before Flop (didn't bet)
Seat 4: SxIIgwXYLkwd6m3wLyPTCw folded before Flop (didn't bet)
Seat 5: YaAEMJGY5tem39deCUQRNw collected ($0.60)
Seat 6: 7qRk4YH4/k/08LgJSv7rBQ (button) folded before Flop (didn't bet)




PokerStars Game #59939717856:  Hold'em No Limit ($0.10/$0.25) - 2009/07/01 0:47:07 ET
Table 'O6cwjhrMn9pfzx1Ngn5zkQ' 6-max Seat #4 is the button
Seat 1: k4mJ9nD/YOVTl8/kGW+U6w ($14.60 in chips) 
Seat 2: M6xK/VklCvdyyrmvzATlxQ ($12.50 in chips) 
Seat 3: EE16Ua5b1HSsYej5zeXOlA ($25.55 in chips) 
Seat 4: wKFJ513ucluNNiMlkXcDOQ ($32.70 in chips) 
Seat 5: niLn0xUVlqh8If80xRjzCA ($22.15 in chips) 
Seat 6: d0J1xuhsynEY81YHwAvJ5g ($27.45 in chips) 
niLn0xUVlqh8If80xRjzCA: posts small blind $0.10
d0J1xuhsynEY81YHwAvJ5g: posts big blind $0.25
*** HOLE CARDS ***
k4mJ9nD/YOVTl8/kGW+U6w: folds 
M6xK/VklCvdyyrmvzATlxQ: folds 
EE16Ua5b1HSsYej5zeXOlA: raises $0.50 to $0.75
wKFJ513ucluNNiMlkXcDOQ: folds 
niLn0xUVlqh8If80xRjzCA: folds 
d0J1xuhsynEY81YHwAvJ5g: folds 
Uncalled bet ($0.50) returned to EE16Ua5b1HSsYej5zeXOlA
EE16Ua5b1HSsYej5zeXOlA collected $0.60 from pot
EE16Ua5b1HSsYej5zeXOlA: doesn't show hand 
*** SUMMARY ***
Total pot $0.60 | Rake $0 
Seat 1: k4mJ9nD/YOVTl8/kGW+U6w folded before Flop (didn't bet)
Seat 2: M6xK/VklCvdyyrmvzATlxQ folded before Flop (didn't bet)
Seat 3: EE16Ua5b1HSsYej5zeXOlA collected ($0.60)
Seat 4: wKFJ513ucluNNiMlkXcDOQ (button) folded before Flop (didn't bet)
Seat 5: niLn0xUVlqh8If80xRjzCA (small blind) folded before Flop
Seat 6: d0J1xuhsynEY81YHwAvJ5g (big blind) folded before Flop




PokerStars Game #59939717958:  Hold'em No Limit ($0.10/$0.25) - 2009/07/01 0:47:07 ET
Table 'AchTjdLS1zBUbH3ZIx6f0w' 6-max Seat #6 is the button
Seat 1: IzVI+wIP7IS+d0sugIrOPQ ($24.25 in chips) 
Seat 2: kG34n23qFQA3nzdOJTQ1dA ($40.20 in chips) 
Seat 3: ehifenV36yVvJMnV63D3cg ($5.90 in chips) 
Seat 4: q6WfTUAD9mowIP63ASq2Dg ($30.70 in chips) 
Seat 5: oBUDUfeUyCbZBsjxHZgSiw ($36 in chips) 
Seat 6: 5tB0F9NjPSUL4FzmzBMs2Q ($25 in chips) 
IzVI+wIP7IS+d0sugIrOPQ: posts small blind $0.10
kG34n23qFQA3nzdOJTQ1dA: posts big blind $0.25
*** HOLE CARDS ***
ehifenV36yVvJMnV63D3cg: calls $0.25
q6WfTUAD9mowIP63ASq2Dg: folds 
oBUDUfeUyCbZBsjxHZgSiw: folds 
5tB0F9NjPSUL4FzmzBMs2Q: folds 
IzVI+wIP7IS+d0sugIrOPQ: calls $0.15
kG34n23qFQA3nzdOJTQ1dA: raises $1.25 to $1.50
ehifenV36yVvJMnV63D3cg: folds 
IzVI+wIP7IS+d0sugIrOPQ: folds 
Uncalled bet ($1.25) returned to kG34n23qFQA3nzdOJTQ1dA
kG34n23qFQA3nzdOJTQ1dA collected $0.75 from pot
*** SUMMARY ***
Total pot $0.75 | Rake $0 
Seat 1: IzVI+wIP7IS+d0sugIrOPQ (small blind) folded before Flop
Seat 2: kG34n23qFQA3nzdOJTQ1dA (big blind) collected ($0.75)
Seat 3: ehifenV36yVvJMnV63D3cg folded before Flop
Seat 4: q6WfTUAD9mowIP63ASq2Dg folded before Flop (didn't bet)
Seat 5: oBUDUfeUyCbZBsjxHZgSiw folded before Flop (didn't bet)
Seat 6: 5tB0F9NjPSUL4FzmzBMs2Q (button) folded before Flop (didn't bet)




PokerStars Game #59939718410:  Hold'em No Limit ($0.10/$0.25) - 2009/07/01 0:47:08 ET
Table 'rhQuIjJo0UQ7RRUlF9umHg' 6-max Seat #1 is the button
Seat 1: 5O3Hj9Qg0SqOyKEXoLpjPg ($59.15 in chips) 
Seat 2: Ew/TYPQIsbQ2X8nm5iAJBg ($51.25 in chips) 
Seat 3: nLE5Yo60EmSlJPyg0GgxXg ($13.15 in chips) 
Seat 4: buyjetgNT1McXtdaP4zynA ($18.70 in chips) 
Seat 5: 7qRk4YH4/k/08LgJSv7rBQ ($24.60 in chips) 
Seat 6: r284m4NA4rtNktI86R8/Yw ($12.05 in chips) 
Ew/TYPQIsbQ2X8nm5iAJBg: posts small blind $0.10
nLE5Yo60EmSlJPyg0GgxXg: posts big blind $0.25
*** HOLE CARDS ***
buyjetgNT1McXtdaP4zynA: calls $0.25
7qRk4YH4/k/08LgJSv7rBQ: folds 
r284m4NA4rtNktI86R8/Yw: folds 
5O3Hj9Qg0SqOyKEXoLpjPg: calls $0.25
Ew/TYPQIsbQ2X8nm5iAJBg: calls $0.15
nLE5Yo60EmSlJPyg0GgxXg: raises $2.25 to $2.50
buyjetgNT1McXtdaP4zynA: folds 
5O3Hj9Qg0SqOyKEXoLpjPg: folds 
Ew/TYPQIsbQ2X8nm5iAJBg: folds 
Uncalled bet ($2.25) returned to nLE5Yo60EmSlJPyg0GgxXg
nLE5Yo60EmSlJPyg0GgxXg collected $1 from pot
*** SUMMARY ***
Total pot $1 | Rake $0 
Seat 1: 5O3Hj9Qg0SqOyKEXoLpjPg (button) folded before Flop
Seat 2: Ew/TYPQIsbQ2X8nm5iAJBg (small blind) folded before Flop
Seat 3: nLE5Yo60EmSlJPyg0GgxXg (big blind) collected ($1)
Seat 4: buyjetgNT1McXtdaP4zynA folded before Flop
Seat 5: 7qRk4YH4/k/08LgJSv7rBQ folded before Flop (didn't bet)
Seat 6: r284m4NA4rtNktI86R8/Yw folded before Flop (didn't bet)




PokerStars Game #59939718604:  Hold'em No Limit ($0.10/$0.25) - 2009/07/01 0:47:08 ET
Table '5NipxzzFB2DffzDpddyQoQ' 6-max Seat #5 is the button
Seat 1: TslQs7AQSLbVtr4X8JOOOQ ($10.45 in chips) 
Seat 2: jxrNE4qd8KCOIqHjQcwCrA ($49.60 in chips) 
Seat 3: qGHGf/553gQnDoklMRe3tg ($48.80 in chips) 
Seat 4: Inq44d7PQ+8TbEKfPeuxVQ ($5.60 in chips) 
Seat 5: cS21pIxRHx5Gt42o7hPZzw ($5.90 in chips) 
Seat 6: lYjWCpfCxX2kgcHY3v4Yow ($26.30 in chips) 
lYjWCpfCxX2kgcHY3v4Yow: posts small blind $0.10
TslQs7AQSLbVtr4X8JOOOQ: posts big blind $0.25
*** HOLE CARDS ***
jxrNE4qd8KCOIqHjQcwCrA: folds 
qGHGf/553gQnDoklMRe3tg: folds 
Inq44d7PQ+8TbEKfPeuxVQ: folds 
cS21pIxRHx5Gt42o7hPZzw: calls $0.25
lYjWCpfCxX2kgcHY3v4Yow: folds 
TslQs7AQSLbVtr4X8JOOOQ: checks 
*** FLOP *** [Ad 3c 4c]
TslQs7AQSLbVtr4X8JOOOQ: checks 
cS21pIxRHx5Gt42o7hPZzw: checks 
*** TURN *** [Ad 3c 4c] [Kh]
TslQs7AQSLbVtr4X8JOOOQ: checks 
cS21pIxRHx5Gt42o7hPZzw: bets $0.50
TslQs7AQSLbVtr4X8JOOOQ: folds 
Uncalled bet ($0.50) returned to cS21pIxRHx5Gt42o7hPZzw
cS21pIxRHx5Gt42o7hPZzw collected $0.60 from pot
*** SUMMARY ***
Total pot $0.60 | Rake $0 
Board [Ad 3c 4c Kh]
Seat 1: TslQs7AQSLbVtr4X8JOOOQ (big blind) folded on the Turn
Seat 2: jxrNE4qd8KCOIqHjQcwCrA folded before Flop (didn't bet)
Seat 3: qGHGf/553gQnDoklMRe3tg folded before Flop (didn't bet)
Seat 4: Inq44d7PQ+8TbEKfPeuxVQ folded before Flop (didn't bet)
Seat 5: cS21pIxRHx5Gt42o7hPZzw (button) collected ($0.60)
Seat 6: lYjWCpfCxX2kgcHY3v4Yow (small blind) folded before Flop




PokerStars Game #59939718388:  Hold'em No Limit ($0.10/$0.25) - 2009/07/01 0:47:08 ET
Table 'UVjmXTtsmlX1HxwwZ59akg' 9-max Seat #1 is the button
Seat 1: zDrucyjVn5aeekNEc3cJrA ($28.25 in chips) 
Seat 4: lesMFbAzECwhRvI2qQ9kkg ($5.30 in chips) 
Seat 9: RHUxTtZkMrryUUwjBqyF4Q ($15 in chips) 
lesMFbAzECwhRvI2qQ9kkg: posts small blind $0.10
RHUxTtZkMrryUUwjBqyF4Q: posts big blind $0.25
*** HOLE CARDS ***
zDrucyjVn5aeekNEc3cJrA: folds 
Vegaas leaves the table
lesMFbAzECwhRvI2qQ9kkg: folds 
Uncalled bet ($0.15) returned to RHUxTtZkMrryUUwjBqyF4Q
RHUxTtZkMrryUUwjBqyF4Q collected $0.20 from pot
*** SUMMARY ***
Total pot $0.20 | Rake $0 
Seat 1: zDrucyjVn5aeekNEc3cJrA (button) folded before Flop (didn't bet)
Seat 4: lesMFbAzECwhRvI2qQ9kkg (small blind) folded before Flop
Seat 9: RHUxTtZkMrryUUwjBqyF4Q (big blind) collected ($0.20)




PokerStars Game #59939718834:  Hold'em No Limit ($0.10/$0.25) - 2009/07/01 0:47:08 ET
Table 'FuFyQHmlO/QqQp//rDRrPg' 6-max Seat #2 is the button
Seat 1: jp34e617tIzV8tKIWmfAbA ($25 in chips) 
Seat 2: 0DvgWV5o6c/jYqQCjm4Haw ($25.60 in chips) 
Seat 4: Eznneya0vB6S+eXJdVleHA ($4.80 in chips) 
Seat 5: wAKC8C/zN0c8V5v13dm9mA ($25.15 in chips) 
Seat 6: 6DwBRH+xZ12AAZmeAg+aXw ($30.80 in chips) 
Eznneya0vB6S+eXJdVleHA: posts small blind $0.10
wAKC8C/zN0c8V5v13dm9mA: posts big blind $0.25
*** HOLE CARDS ***
Rondel13245 joins the table at seat #3 
6DwBRH+xZ12AAZmeAg+aXw: folds 
jp34e617tIzV8tKIWmfAbA: raises $0.50 to $0.75
0DvgWV5o6c/jYqQCjm4Haw: folds 
Eznneya0vB6S+eXJdVleHA: folds 
wAKC8C/zN0c8V5v13dm9mA is disconnected 
wAKC8C/zN0c8V5v13dm9mA is connected 
wAKC8C/zN0c8V5v13dm9mA: folds 
Uncalled bet ($0.50) returned to jp34e617tIzV8tKIWmfAbA
jp34e617tIzV8tKIWmfAbA collected $0.60 from pot
*** SUMMARY ***
Total pot $0.60 | Rake $0 
Seat 1: jp34e617tIzV8tKIWmfAbA collected ($0.60)
Seat 2: 0DvgWV5o6c/jYqQCjm4Haw (button) folded before Flop (didn't bet)
Seat 4: Eznneya0vB6S+eXJdVleHA (small blind) folded before Flop
Seat 5: wAKC8C/zN0c8V5v13dm9mA (big blind) folded before Flop
Seat 6: 6DwBRH+xZ12AAZmeAg+aXw folded before Flop (didn't bet)




PokerStars Game #59939718558:  Hold'em No Limit ($0.10/$0.25) - 2009/07/01 0:47:08 ET
Table 'IIO2q2znuuAXmiZ2qFTcmg' 6-max Seat #3 is the button
Seat 1: nwwpaieDRI0UPyVtChVHOg ($16.90 in chips) 
Seat 2: cS21pIxRHx5Gt42o7hPZzw ($15.35 in chips) 
Seat 3: hiTEr3yrERiQp3zHXRioVw ($41.20 in chips) 
Seat 4: 0HIrwssk0FQvyKULzUTtlg ($10.60 in chips) 
Seat 5: f9iRHw0d+kV7pbTYwF2+2g ($5.40 in chips) 
0HIrwssk0FQvyKULzUTtlg: posts small blind $0.10
f9iRHw0d+kV7pbTYwF2+2g: posts big blind $0.25
gqrr7lSWrQ1N8zKx8zZzvA: sits out 
*** HOLE CARDS ***
nwwpaieDRI0UPyVtChVHOg: calls $0.25
cS21pIxRHx5Gt42o7hPZzw: folds 
hiTEr3yrERiQp3zHXRioVw: folds 
0HIrwssk0FQvyKULzUTtlg: raises $0.75 to $1
f9iRHw0d+kV7pbTYwF2+2g: folds 
nwwpaieDRI0UPyVtChVHOg: folds 
Uncalled bet ($0.75) returned to 0HIrwssk0FQvyKULzUTtlg
0HIrwssk0FQvyKULzUTtlg collected $0.75 from pot
*** SUMMARY ***
Total pot $0.75 | Rake $0 
Seat 1: nwwpaieDRI0UPyVtChVHOg folded before Flop
Seat 2: cS21pIxRHx5Gt42o7hPZzw folded before Flop (didn't bet)
Seat 3: hiTEr3yrERiQp3zHXRioVw (button) folded before Flop (didn't bet)
Seat 4: 0HIrwssk0FQvyKULzUTtlg (small blind) collected ($0.75)
Seat 5: f9iRHw0d+kV7pbTYwF2+2g (big blind) folded before Flop




PokerStars Game #59939718544:  Hold'em No Limit ($0.10/$0.25) - 2009/07/01 0:47:08 ET
Table 'dNYnr4D4id1jwnEU66Yowg' 9-max Seat #1 is the button
Seat 1: 41pZ+Uce9oq+8wmcVBXWIg ($19.75 in chips) 
Seat 2: +twYdIw+izmdFyX5TTFzjg ($16.05 in chips) 
Seat 4: d9fERE+24v0MqnylCrXchQ ($7.95 in chips) 
Seat 6: Lu6miJBtf3FVzUdzCWEtqQ ($17 in chips) 
Seat 8: sv2dZaqHRlfCDrW63Guhvg ($5.35 in chips) 
+twYdIw+izmdFyX5TTFzjg: posts small blind $0.10
d9fERE+24v0MqnylCrXchQ: posts big blind $0.25
*** HOLE CARDS ***
Lu6miJBtf3FVzUdzCWEtqQ: folds 
sv2dZaqHRlfCDrW63Guhvg: calls $0.25
41pZ+Uce9oq+8wmcVBXWIg: calls $0.25
+twYdIw+izmdFyX5TTFzjg: calls $0.15
d9fERE+24v0MqnylCrXchQ: checks 
*** FLOP *** [Tc Ts 6c]
+twYdIw+izmdFyX5TTFzjg: checks 
d9fERE+24v0MqnylCrXchQ: bets $0.25
sv2dZaqHRlfCDrW63Guhvg: folds 
41pZ+Uce9oq+8wmcVBXWIg: folds 
+twYdIw+izmdFyX5TTFzjg: folds 
Uncalled bet ($0.25) returned to d9fERE+24v0MqnylCrXchQ
d9fERE+24v0MqnylCrXchQ collected $0.95 from pot
*** SUMMARY ***
Total pot $1 | Rake $0.05 
Board [Tc Ts 6c]
Seat 1: 41pZ+Uce9oq+8wmcVBXWIg (button) folded on the Flop
Seat 2: +twYdIw+izmdFyX5TTFzjg (small blind) folded on the Flop
Seat 4: d9fERE+24v0MqnylCrXchQ (big blind) collected ($0.95)
Seat 6: Lu6miJBtf3FVzUdzCWEtqQ folded before Flop (didn't bet)
Seat 8: sv2dZaqHRlfCDrW63Guhvg folded on the Flop




PokerStars Game #59939718576:  Hold'em No Limit ($0.10/$0.25) - 2009/07/01 0:47:08 ET
Table 'ROYvQOMwUrvL3SOiHYcrWg' 9-max Seat #7 is the button
Seat 2: hBMUlEpyU74r/fwDgIpXjQ ($46.75 in chips) 
Seat 4: SHegmCn8B0InbWE/zFlvOw ($24.30 in chips) 
Seat 5: jeKWRUkMaVn8rEUjnJKqpg ($25 in chips) 
Seat 6: OiV1PWZ3IkN29JlmCcnTwQ ($4.65 in chips) 
Seat 7: tYsOBqdU1+x+yFI7zHO7hQ ($28.45 in chips) 
Seat 8: biJWLZ27fafNeBI2oT1KJw ($19.60 in chips) 
Seat 9: yduPKWPzL8YlT5Zv/Nmrwg ($29.30 in chips) 
biJWLZ27fafNeBI2oT1KJw: posts small blind $0.10
yduPKWPzL8YlT5Zv/Nmrwg: posts big blind $0.25
*** HOLE CARDS ***
7q7lZBfgmzjFr0jTNx4b6g leaves the table
hBMUlEpyU74r/fwDgIpXjQ: raises $1 to $1.25
22dIObOuor/A+IKWkNoAlA joins the table at seat #1 
SHegmCn8B0InbWE/zFlvOw has timed out
SHegmCn8B0InbWE/zFlvOw: folds 
SHegmCn8B0InbWE/zFlvOw is sitting out
jeKWRUkMaVn8rEUjnJKqpg: calls $1.25
SHegmCn8B0InbWE/zFlvOw has returned
OiV1PWZ3IkN29JlmCcnTwQ: folds 
tYsOBqdU1+x+yFI7zHO7hQ: folds 
biJWLZ27fafNeBI2oT1KJw: folds 
yduPKWPzL8YlT5Zv/Nmrwg: calls $1
*** FLOP *** [8d Qs Td]
yduPKWPzL8YlT5Zv/Nmrwg: checks 
hBMUlEpyU74r/fwDgIpXjQ: checks 
jeKWRUkMaVn8rEUjnJKqpg: checks 
*** TURN *** [8d Qs Td] [As]
yduPKWPzL8YlT5Zv/Nmrwg: checks 
hBMUlEpyU74r/fwDgIpXjQ: checks 
jeKWRUkMaVn8rEUjnJKqpg: checks 
*** RIVER *** [8d Qs Td As] [4c]
yduPKWPzL8YlT5Zv/Nmrwg: checks 
hBMUlEpyU74r/fwDgIpXjQ: checks 
jeKWRUkMaVn8rEUjnJKqpg: checks 
*** SHOW DOWN ***
yduPKWPzL8YlT5Zv/Nmrwg: shows [3d 3s] (a pair of Threes)
hBMUlEpyU74r/fwDgIpXjQ: shows [Jc Jd] (a pair of Jacks)
jeKWRUkMaVn8rEUjnJKqpg: shows [4d 4h] (three of a kind, Fours)
jeKWRUkMaVn8rEUjnJKqpg collected $3.70 from pot
*** SUMMARY ***
Total pot $3.85 | Rake $0.15 
Board [8d Qs Td As 4c]
Seat 2: hBMUlEpyU74r/fwDgIpXjQ showed [Jc Jd] and lost with a pair of Jacks
Seat 4: SHegmCn8B0InbWE/zFlvOw folded before Flop (didn't bet)
Seat 5: jeKWRUkMaVn8rEUjnJKqpg showed [4d 4h] and won ($3.70) with three of a kind, Fours
Seat 6: OiV1PWZ3IkN29JlmCcnTwQ folded before Flop (didn't bet)
Seat 7: tYsOBqdU1+x+yFI7zHO7hQ (button) folded before Flop (didn't bet)
Seat 8: biJWLZ27fafNeBI2oT1KJw (small blind) folded before Flop
Seat 9: yduPKWPzL8YlT5Zv/Nmrwg (big blind) showed [3d 3s] and lost with a pair of Threes




PokerStars Game #59939718302:  Hold'em No Limit ($0.10/$0.25) - 2009/07/01 0:47:08 ET
Table '0w9m+UkNlGMNoPyQqzWk6A' 9-max Seat #3 is the button
Seat 2: tYsOBqdU1+x+yFI7zHO7hQ ($45.20 in chips) 
Seat 3: VWwtMkIjXloiX/RKh7RGWQ ($11 in chips) 
Seat 4: VBHxUExRAMrbxUq/cVx9Gw ($5.85 in chips) 
Seat 5: rPXwQUVloUl+qZm3CCtaJw ($16.50 in chips) 
Seat 6: sWBBy1WroEskLNyJzhkUag ($20.55 in chips) 
Seat 7: lrTLp1zpuCCs/e0pi2M8jw ($7.40 in chips) 
Seat 8: hPhp/RE3cJ5YGaQ2xOHXXg ($4.15 in chips) 
Seat 9: 56S3mA6Zs3pGR+0p0vUCtg ($27.80 in chips) 
VBHxUExRAMrbxUq/cVx9Gw: posts small blind $0.10
rPXwQUVloUl+qZm3CCtaJw: posts big blind $0.25
DnDcAdn9P0zGovMERigpFA: sits out 
*** HOLE CARDS ***
sWBBy1WroEskLNyJzhkUag: folds 
lrTLp1zpuCCs/e0pi2M8jw: raises $1.25 to $1.50
hPhp/RE3cJ5YGaQ2xOHXXg: folds 
56S3mA6Zs3pGR+0p0vUCtg: folds 
tYsOBqdU1+x+yFI7zHO7hQ: folds 
VWwtMkIjXloiX/RKh7RGWQ: folds 
VBHxUExRAMrbxUq/cVx9Gw: folds 
rPXwQUVloUl+qZm3CCtaJw: folds 
Uncalled bet ($1.25) returned to lrTLp1zpuCCs/e0pi2M8jw
lrTLp1zpuCCs/e0pi2M8jw collected $0.60 from pot
lrTLp1zpuCCs/e0pi2M8jw: doesn't show hand 
*** SUMMARY ***
Total pot $0.60 | Rake $0 
Seat 2: tYsOBqdU1+x+yFI7zHO7hQ folded before Flop (didn't bet)
Seat 3: VWwtMkIjXloiX/RKh7RGWQ (button) folded before Flop (didn't bet)
Seat 4: VBHxUExRAMrbxUq/cVx9Gw (small blind) folded before Flop
Seat 5: rPXwQUVloUl+qZm3CCtaJw (big blind) folded before Flop
Seat 6: sWBBy1WroEskLNyJzhkUag folded before Flop (didn't bet)
Seat 7: lrTLp1zpuCCs/e0pi2M8jw collected ($0.60)
Seat 8: hPhp/RE3cJ5YGaQ2xOHXXg folded before Flop (didn't bet)
Seat 9: 56S3mA6Zs3pGR+0p0vUCtg folded before Flop (didn't bet)




PokerStars Game #59939718362:  Hold'em No Limit ($0.10/$0.25) - 2009/07/01 0:47:08 ET
Table 'G26g8jde1eR+mmabeFeSlw' 9-max Seat #7 is the button
Seat 1: eygIcrabyU9hI2mw7NQsgg ($22.50 in chips) 
Seat 2: O2aLEhH7P83nWGvgV84KoA ($13.50 in chips) 
Seat 3: WKL8nUFr7TumC4EjLyqYzw ($5 in chips) 
Seat 4: 1Clf3cPrqoy/YgvWdWK1Xw ($10.25 in chips) 
Seat 5: hJ4uYjNmSZdjrKA8cjZqCA ($19.80 in chips) 
Seat 6: opOCI2p6kW0tINuVaAqmcQ ($25 in chips) 
Seat 7: nm4Dj/f+jJEwKVsUnKh73g ($28.50 in chips) 
Seat 8: 22dIObOuor/A+IKWkNoAlA ($5.10 in chips) 
Seat 9: VWUWpMLMj/Q1jRVpF7Aohw ($9.60 in chips) 
22dIObOuor/A+IKWkNoAlA: posts small blind $0.10
VWUWpMLMj/Q1jRVpF7Aohw: posts big blind $0.25
*** HOLE CARDS ***
eygIcrabyU9hI2mw7NQsgg: folds 
O2aLEhH7P83nWGvgV84KoA: folds 
WKL8nUFr7TumC4EjLyqYzw: folds 
1Clf3cPrqoy/YgvWdWK1Xw: folds 
hJ4uYjNmSZdjrKA8cjZqCA: folds 
opOCI2p6kW0tINuVaAqmcQ: folds 
nm4Dj/f+jJEwKVsUnKh73g: folds 
22dIObOuor/A+IKWkNoAlA: folds 
Uncalled bet ($0.15) returned to VWUWpMLMj/Q1jRVpF7Aohw
VWUWpMLMj/Q1jRVpF7Aohw collected $0.20 from pot
*** SUMMARY ***
Total pot $0.20 | Rake $0 
Seat 1: eygIcrabyU9hI2mw7NQsgg folded before Flop (didn't bet)
Seat 2: O2aLEhH7P83nWGvgV84KoA folded before Flop (didn't bet)
Seat 3: WKL8nUFr7TumC4EjLyqYzw folded before Flop (didn't bet)
Seat 4: 1Clf3cPrqoy/YgvWdWK1Xw folded before Flop (didn't bet)
Seat 5: hJ4uYjNmSZdjrKA8cjZqCA folded before Flop (didn't bet)
Seat 6: opOCI2p6kW0tINuVaAqmcQ folded before Flop (didn't bet)
Seat 7: nm4Dj/f+jJEwKVsUnKh73g (button) folded before Flop (didn't bet)
Seat 8: 22dIObOuor/A+IKWkNoAlA (small blind) folded before Flop
Seat 9: VWUWpMLMj/Q1jRVpF7Aohw (big blind) collected ($0.20)




PokerStars Game #59939718974:  Hold'em No Limit ($0.10/$0.25) - 2009/07/01 0:47:09 ET
Table 'RUOqTfzbAVGS5x+J9aZMHA' 9-max Seat #8 is the button
Seat 1: KBBTLXGhPdPj+4X0QKMkcg ($10.55 in chips) 
Seat 2: Z5ZtGOON8kmSdSCll9Z3XA ($9.35 in chips) 
Seat 3: JtVGnq5doRa3PublncR+Yw ($24.75 in chips) 
Seat 4: K9Az8li/CO2TicltVWKamA ($10.40 in chips) 
Seat 5: opOCI2p6kW0tINuVaAqmcQ ($25 in chips) 
Seat 6: ljemhp25Zg+nlA9DLCIiUw ($40.15 in chips) 
Seat 7: HxDF4QSxC4z39D7teZpprQ ($6.15 in chips) 
Seat 8: 3RCAkueG3Vc13VpRStCB+w ($23.75 in chips) 
Seat 9: cZ99hugmLBj9KhTlc8nCSw ($25 in chips) 
cZ99hugmLBj9KhTlc8nCSw: posts small blind $0.10
KBBTLXGhPdPj+4X0QKMkcg: posts big blind $0.25
*** HOLE CARDS ***
Z5ZtGOON8kmSdSCll9Z3XA: folds 
JtVGnq5doRa3PublncR+Yw: raises $0.50 to $0.75
K9Az8li/CO2TicltVWKamA: folds 
opOCI2p6kW0tINuVaAqmcQ: folds 
ljemhp25Zg+nlA9DLCIiUw: folds 
HxDF4QSxC4z39D7teZpprQ: calls $0.75
3RCAkueG3Vc13VpRStCB+w: folds 
cZ99hugmLBj9KhTlc8nCSw: folds 
KBBTLXGhPdPj+4X0QKMkcg: calls $0.50
*** FLOP *** [Kc Ks 9c]
KBBTLXGhPdPj+4X0QKMkcg: bets $0.25
JtVGnq5doRa3PublncR+Yw: calls $0.25
HxDF4QSxC4z39D7teZpprQ: folds 
*** TURN *** [Kc Ks 9c] [Td]
KBBTLXGhPdPj+4X0QKMkcg: bets $0.25
JtVGnq5doRa3PublncR+Yw: calls $0.25
*** RIVER *** [Kc Ks 9c Td] [Ac]
KBBTLXGhPdPj+4X0QKMkcg: bets $2.25
JtVGnq5doRa3PublncR+Yw: folds 
Uncalled bet ($2.25) returned to KBBTLXGhPdPj+4X0QKMkcg
KBBTLXGhPdPj+4X0QKMkcg collected $3.20 from pot
KBBTLXGhPdPj+4X0QKMkcg: shows [3c Qc] (a flush, Ace high)
*** SUMMARY ***
Total pot $3.35 | Rake $0.15 
Board [Kc Ks 9c Td Ac]
Seat 1: KBBTLXGhPdPj+4X0QKMkcg (big blind) collected ($3.20)
Seat 2: Z5ZtGOON8kmSdSCll9Z3XA folded before Flop (didn't bet)
Seat 3: JtVGnq5doRa3PublncR+Yw folded on the River
Seat 4: K9Az8li/CO2TicltVWKamA folded before Flop (didn't bet)
Seat 5: opOCI2p6kW0tINuVaAqmcQ folded before Flop (didn't bet)
Seat 6: ljemhp25Zg+nlA9DLCIiUw folded before Flop (didn't bet)
Seat 7: HxDF4QSxC4z39D7teZpprQ folded on the Flop
Seat 8: 3RCAkueG3Vc13VpRStCB+w (button) folded before Flop (didn't bet)
Seat 9: cZ99hugmLBj9KhTlc8nCSw (small blind) folded before Flop




PokerStars Game #59939719258:  Hold'em No Limit ($0.10/$0.25) - 2009/07/01 0:47:09 ET
Table 'gnrUwXkIPE0C8xl6cB4Hyw' 9-max Seat #8 is the button
Seat 1: lwrOE80tuooHfIBx/4LUSw ($24.75 in chips) 
Seat 2: zVd+j+mjRjWkMTxR5u0Rbw ($6 in chips) 
Seat 3: s7Q6uNouhe7aE8JdFb9E+A ($25.35 in chips) 
Seat 4: vnCdP3GsLTKadDukKcJk/Q ($25.05 in chips) 
Seat 5: UU+SYM9uvNEpASN41+yAdA ($31.30 in chips) 
Seat 6: W4TLQcZ2TiM73eIgpIvlGg ($23 in chips) 
Seat 7: Z9AeOQX3yzuSvKAm/xyovg ($8.20 in chips) 
Seat 8: oUgIL46CfA9GCdIuN1TVSw ($23.70 in chips) 
Seat 9: F7pnn6czNpHvRM55XcA2EA ($25 in chips) 
F7pnn6czNpHvRM55XcA2EA: posts small blind $0.10
lwrOE80tuooHfIBx/4LUSw: posts big blind $0.25
*** HOLE CARDS ***
oUgIL46CfA9GCdIuN1TVSw said, "aw we split how cute"
zVd+j+mjRjWkMTxR5u0Rbw: calls $0.25
UU+SYM9uvNEpASN41+yAdA said, "lol"
s7Q6uNouhe7aE8JdFb9E+A: raises $0.75 to $1
vnCdP3GsLTKadDukKcJk/Q: folds 
UU+SYM9uvNEpASN41+yAdA: folds 
W4TLQcZ2TiM73eIgpIvlGg: folds 
Z9AeOQX3yzuSvKAm/xyovg: folds 
oUgIL46CfA9GCdIuN1TVSw: folds 
UU+SYM9uvNEpASN41+yAdA said, "you're killing me"
F7pnn6czNpHvRM55XcA2EA: folds 
oUgIL46CfA9GCdIuN1TVSw said, "am i now"
lwrOE80tuooHfIBx/4LUSw: folds 
UU+SYM9uvNEpASN41+yAdA said, "just shoot me"
zVd+j+mjRjWkMTxR5u0Rbw: calls $0.75
*** FLOP *** [8h 8c Kh]
zVd+j+mjRjWkMTxR5u0Rbw: bets $0.50
s7Q6uNouhe7aE8JdFb9E+A: folds 
Uncalled bet ($0.50) returned to zVd+j+mjRjWkMTxR5u0Rbw
zVd+j+mjRjWkMTxR5u0Rbw collected $2.25 from pot
zVd+j+mjRjWkMTxR5u0Rbw: doesn't show hand 
*** SUMMARY ***
Total pot $2.35 | Rake $0.10 
Board [8h 8c Kh]
Seat 1: lwrOE80tuooHfIBx/4LUSw (big blind) folded before Flop
Seat 2: zVd+j+mjRjWkMTxR5u0Rbw collected ($2.25)
Seat 3: s7Q6uNouhe7aE8JdFb9E+A folded on the Flop
Seat 4: vnCdP3GsLTKadDukKcJk/Q folded before Flop (didn't bet)
Seat 5: UU+SYM9uvNEpASN41+yAdA folded before Flop (didn't bet)
Seat 6: W4TLQcZ2TiM73eIgpIvlGg folded before Flop (didn't bet)
Seat 7: Z9AeOQX3yzuSvKAm/xyovg folded before Flop (didn't bet)
Seat 8: oUgIL46CfA9GCdIuN1TVSw (button) folded before Flop (didn't bet)
Seat 9: F7pnn6czNpHvRM55XcA2EA (small blind) folded before Flop




PokerStars Game #59939719196:  Hold'em No Limit ($0.10/$0.25) - 2009/07/01 0:47:09 ET
Table 'SkaFM7xfUr/Nd+JFPb7f2w' 9-max Seat #2 is the button
Seat 1: CvL9Ch1HYCVbTsfpNucitg ($4.65 in chips) 
Seat 2: QEbIGci+itdw+re8RM5fZA ($27.95 in chips) 
Seat 3: 4oA316mXLIui1QY63GXBUg ($25 in chips) 
Seat 4: DIBbjEYGs+TVdVgEB/4+3w ($39.20 in chips) 
Seat 5: GftT+l+xjKzcY0rMiNZfPg ($9 in chips) 
Seat 6: PskTLlFIRHSp61inskRzVg ($7.60 in chips) 
Seat 7: 7wo6Sr7QG3Zo6BaBDV1BOw ($5.85 in chips) 
Seat 8: Lro4e37x4FUa5P3yzDjskw ($12.45 in chips) 
Seat 9: STkR8XvpjNv79OOMhrlh2w ($59.10 in chips) 
4oA316mXLIui1QY63GXBUg: posts small blind $0.10
DIBbjEYGs+TVdVgEB/4+3w: posts big blind $0.25
*** HOLE CARDS ***
GftT+l+xjKzcY0rMiNZfPg: raises $0.50 to $0.75
PskTLlFIRHSp61inskRzVg: folds 
7wo6Sr7QG3Zo6BaBDV1BOw: folds 
Lro4e37x4FUa5P3yzDjskw: folds 
STkR8XvpjNv79OOMhrlh2w: folds 
CvL9Ch1HYCVbTsfpNucitg: folds 
PskTLlFIRHSp61inskRzVg leaves the table
QEbIGci+itdw+re8RM5fZA: folds 
4oA316mXLIui1QY63GXBUg: folds 
DIBbjEYGs+TVdVgEB/4+3w: folds 
Uncalled bet ($0.50) returned to GftT+l+xjKzcY0rMiNZfPg
22dIObOuor/A+IKWkNoAlA joins the table at seat #6 
GftT+l+xjKzcY0rMiNZfPg collected $0.60 from pot
GftT+l+xjKzcY0rMiNZfPg: doesn't show hand 
*** SUMMARY ***
Total pot $0.60 | Rake $0 
Seat 1: CvL9Ch1HYCVbTsfpNucitg folded before Flop (didn't bet)
Seat 2: QEbIGci+itdw+re8RM5fZA (button) folded before Flop (didn't bet)
Seat 3: 4oA316mXLIui1QY63GXBUg (small blind) folded before Flop
Seat 4: DIBbjEYGs+TVdVgEB/4+3w (big blind) folded before Flop
Seat 5: GftT+l+xjKzcY0rMiNZfPg collected ($0.60)
Seat 6: PskTLlFIRHSp61inskRzVg folded before Flop (didn't bet)
Seat 7: 7wo6Sr7QG3Zo6BaBDV1BOw folded before Flop (didn't bet)
Seat 8: Lro4e37x4FUa5P3yzDjskw folded before Flop (didn't bet)
Seat 9: STkR8XvpjNv79OOMhrlh2w folded before Flop (didn't bet)




PokerStars Game #59939719140:  Hold'em No Limit ($0.10/$0.25) - 2009/07/01 0:47:09 ET
Table 'l8hUTjBTXBorNUR/tyvSLw' 9-max Seat #7 is the button
Seat 3: 6TWO15+WfJ5HfI8CbJ4a0w ($8.80 in chips) 
Seat 4: vPtFvcPtn/Afz0sucO1cmQ ($37.20 in chips) 
Seat 5: S7Ki0P+0AIGPuIfGJjW0gg ($15.35 in chips) 
Seat 6: nkD1GtC3+ft+4U3Od0H10A ($12.70 in chips) 
Seat 7: awxYB5n5W4JUl1V4Xsn26g ($4.30 in chips) 
Seat 8: kZJjw0YSgO2CZKraCg0v8g ($12.50 in chips) 
Seat 9: zDrucyjVn5aeekNEc3cJrA ($35.75 in chips) 
kZJjw0YSgO2CZKraCg0v8g: posts small blind $0.10
zDrucyjVn5aeekNEc3cJrA: posts big blind $0.25
cZ99hugmLBj9KhTlc8nCSw: sits out 
*** HOLE CARDS ***
6TWO15+WfJ5HfI8CbJ4a0w: folds 
vPtFvcPtn/Afz0sucO1cmQ: folds 
S7Ki0P+0AIGPuIfGJjW0gg: folds 
nkD1GtC3+ft+4U3Od0H10A: folds 
awxYB5n5W4JUl1V4Xsn26g: folds 
kZJjw0YSgO2CZKraCg0v8g: raises $0.25 to $0.50
zDrucyjVn5aeekNEc3cJrA: folds 
Uncalled bet ($0.25) returned to kZJjw0YSgO2CZKraCg0v8g
kZJjw0YSgO2CZKraCg0v8g collected $0.50 from pot
*** SUMMARY ***
Total pot $0.50 | Rake $0 
Seat 3: 6TWO15+WfJ5HfI8CbJ4a0w folded before Flop (didn't bet)
Seat 4: vPtFvcPtn/Afz0sucO1cmQ folded before Flop (didn't bet)
Seat 5: S7Ki0P+0AIGPuIfGJjW0gg folded before Flop (didn't bet)
Seat 6: nkD1GtC3+ft+4U3Od0H10A folded before Flop (didn't bet)
Seat 7: awxYB5n5W4JUl1V4Xsn26g (button) folded before Flop (didn't bet)
Seat 8: kZJjw0YSgO2CZKraCg0v8g (small blind) collected ($0.50)
Seat 9: zDrucyjVn5aeekNEc3cJrA (big blind) folded before Flop




PokerStars Game #59939719480:  Hold'em No Limit ($0.10/$0.25) - 2009/07/01 0:47:09 ET
Table 'AJGgX1ZYM8d68SWMvaLttg' 6-max Seat #2 is the button
Seat 1: sT4sjqzVMH/fZHz0hkbIPw ($48.50 in chips) 
Seat 2: zHHLkD2sRljslKKeQv/ZQw ($28.10 in chips) 
Seat 3: 4x9jCqgSw4272dnaIqnanw ($6 in chips) 
Seat 4: Lz/GjRDgmgepqTR7qmS86w ($13.80 in chips) 
Seat 5: SFmT9ZsVopnukjvAzrxTRg ($25.75 in chips) 
Seat 6: UA5OsKS3VPaxa7uC8La/kA ($27.40 in chips) 
4x9jCqgSw4272dnaIqnanw: posts small blind $0.10
Lz/GjRDgmgepqTR7qmS86w: posts big blind $0.25
*** HOLE CARDS ***
SFmT9ZsVopnukjvAzrxTRg: folds 
UA5OsKS3VPaxa7uC8La/kA: folds 
sT4sjqzVMH/fZHz0hkbIPw: folds 
zHHLkD2sRljslKKeQv/ZQw: folds 
4x9jCqgSw4272dnaIqnanw: calls $0.15
Lz/GjRDgmgepqTR7qmS86w: raises $0.75 to $1
4x9jCqgSw4272dnaIqnanw: folds 
Uncalled bet ($0.75) returned to Lz/GjRDgmgepqTR7qmS86w
Lz/GjRDgmgepqTR7qmS86w collected $0.50 from pot
Lz/GjRDgmgepqTR7qmS86w: doesn't show hand 
*** SUMMARY ***
Total pot $0.50 | Rake $0 
Seat 1: sT4sjqzVMH/fZHz0hkbIPw folded before Flop (didn't bet)
Seat 2: zHHLkD2sRljslKKeQv/ZQw (button) folded before Flop (didn't bet)
Seat 3: 4x9jCqgSw4272dnaIqnanw (small blind) folded before Flop
Seat 4: Lz/GjRDgmgepqTR7qmS86w (big blind) collected ($0.50)
Seat 5: SFmT9ZsVopnukjvAzrxTRg folded before Flop (didn't bet)
Seat 6: UA5OsKS3VPaxa7uC8La/kA folded before Flop (didn't bet)




PokerStars Game #59939719618:  Hold'em No Limit ($0.10/$0.25) - 2009/07/01 0:47:10 ET
Table 'T/iCKJXGphRN3xcdwfE/JQ' 6-max Seat #6 is the button
Seat 1: zZ8zH49EwNs0mqgppOaL9g ($24.25 in chips) 
Seat 2: 6qsh9pnysDKJNhfFhFmKRQ ($13.95 in chips) 
Seat 3: R6AGToFJQOYVZAjC2jXEKw ($19.95 in chips) 
Seat 4: yzFNNFIfC89bBPwpFPx2ow ($57.80 in chips) 
Seat 5: DzdrMZ6l84e65/zfW+2bcA ($5.55 in chips) 
Seat 6: jKYGBgexhqKT13Xana4EHg ($13.95 in chips) 
zZ8zH49EwNs0mqgppOaL9g: posts small blind $0.10
6qsh9pnysDKJNhfFhFmKRQ: posts big blind $0.25
*** HOLE CARDS ***
R6AGToFJQOYVZAjC2jXEKw: folds 
yzFNNFIfC89bBPwpFPx2ow: folds 
DzdrMZ6l84e65/zfW+2bcA: folds 
jKYGBgexhqKT13Xana4EHg: calls $0.25
zZ8zH49EwNs0mqgppOaL9g: folds 
6qsh9pnysDKJNhfFhFmKRQ: checks 
*** FLOP *** [Js 3d 8c]
6qsh9pnysDKJNhfFhFmKRQ: bets $1
jKYGBgexhqKT13Xana4EHg: raises $1 to $2
6qsh9pnysDKJNhfFhFmKRQ: folds 
Uncalled bet ($1) returned to jKYGBgexhqKT13Xana4EHg
jKYGBgexhqKT13Xana4EHg collected $2.50 from pot
jKYGBgexhqKT13Xana4EHg: doesn't show hand 
*** SUMMARY ***
Total pot $2.60 | Rake $0.10 
Board [Js 3d 8c]
Seat 1: zZ8zH49EwNs0mqgppOaL9g (small blind) folded before Flop
Seat 2: 6qsh9pnysDKJNhfFhFmKRQ (big blind) folded on the Flop
Seat 3: R6AGToFJQOYVZAjC2jXEKw folded before Flop (didn't bet)
Seat 4: yzFNNFIfC89bBPwpFPx2ow folded before Flop (didn't bet)
Seat 5: DzdrMZ6l84e65/zfW+2bcA folded before Flop (didn't bet)
Seat 6: jKYGBgexhqKT13Xana4EHg (button) collected ($2.50)




PokerStars Game #59939719614:  Hold'em No Limit ($0.10/$0.25) - 2009/07/01 0:47:10 ET
Table 'gZetDqJh6q9A3mLO3ThCsAnc6OeGk/wtaWV+6N+kgnZQSeat #1 is the button
Seat 1: 1YCU970EVCcjs4GQP5Zt0g ($11.30 in chips) 
Seat 2: JFIAqU8lCZ0vWwEl4bdGsg ($25 in chips) 
Seat 3: jp34e617tIzV8tKIWmfAbA ($25 in chips) 
Seat 4: eHsmIvAb2JREg4O6hNPnXg ($9.95 in chips) 
Seat 5: mfrkWA3PTeYPkbO6hi98Aw ($45.70 in chips) 
Seat 6: R1hR3/XSBdOHwcbSUJRJbg ($61.65 in chips) 
JFIAqU8lCZ0vWwEl4bdGsg: posts small blind $0.10
jp34e617tIzV8tKIWmfAbA: posts big blind $0.25
*** HOLE CARDS ***
eHsmIvAb2JREg4O6hNPnXg: folds 
mfrkWA3PTeYPkbO6hi98Aw: folds 
R1hR3/XSBdOHwcbSUJRJbg: folds 
1YCU970EVCcjs4GQP5Zt0g: folds 
JFIAqU8lCZ0vWwEl4bdGsg: raises $0.60 to $0.85
jp34e617tIzV8tKIWmfAbA: folds 
Uncalled bet ($0.60) returned to JFIAqU8lCZ0vWwEl4bdGsg
JFIAqU8lCZ0vWwEl4bdGsg collected $0.50 from pot
JFIAqU8lCZ0vWwEl4bdGsg: doesn't show hand 
*** SUMMARY ***
Total pot $0.50 | Rake $0 
Seat 1: 1YCU970EVCcjs4GQP5Zt0g (button) folded before Flop (didn't bet)
Seat 2: JFIAqU8lCZ0vWwEl4bdGsg (small blind) collected ($0.50)
Seat 3: jp34e617tIzV8tKIWmfAbA (big blind) folded before Flop
Seat 4: eHsmIvAb2JREg4O6hNPnXg folded before Flop (didn't bet)
Seat 5: mfrkWA3PTeYPkbO6hi98Aw folded before Flop (didn't bet)
Seat 6: R1hR3/XSBdOHwcbSUJRJbg folded before Flop (didn't bet)




PokerStars Game #59939719944:  Hold'em No Limit ($0.10/$0.25) - 2009/07/01 0:47:10 ET
Table 'zJTgUqdWn7ojWWqV4pItEQ' 9-max Seat #7 is the button
Seat 1: CbXUS6Z2rXZxL1AKduNtmQ ($30.10 in chips) 
Seat 2: 7wo6Sr7QG3Zo6BaBDV1BOw ($3 in chips) 
Seat 6: cQQdn+v2h6ICJU1fq6mEyA ($25.95 in chips) 
Seat 7: 4oA316mXLIui1QY63GXBUg ($25 in chips) 
Seat 8: iG7VeTyBWf6wYNvZpbTcbw ($14.50 in chips) 
Seat 9: DnDcAdn9P0zGovMERigpFA ($25.25 in chips) 
iG7VeTyBWf6wYNvZpbTcbw: posts small blind $0.10
DnDcAdn9P0zGovMERigpFA: posts big blind $0.25
murdog71: sits out 
*** HOLE CARDS ***
CbXUS6Z2rXZxL1AKduNtmQ: folds 
7wo6Sr7QG3Zo6BaBDV1BOw: folds 
cQQdn+v2h6ICJU1fq6mEyA: calls $0.25
4oA316mXLIui1QY63GXBUg: folds 
iG7VeTyBWf6wYNvZpbTcbw: raises $0.75 to $1
DnDcAdn9P0zGovMERigpFA: folds 
cQQdn+v2h6ICJU1fq6mEyA: calls $0.75
*** FLOP *** [Qc 9s Jd]
iG7VeTyBWf6wYNvZpbTcbw: bets $1.25
cQQdn+v2h6ICJU1fq6mEyA: calls $1.25
*** TURN *** [Qc 9s Jd] [Qs]
iG7VeTyBWf6wYNvZpbTcbw: bets $1.75
cQQdn+v2h6ICJU1fq6mEyA: calls $1.75
*** RIVER *** [Qc 9s Jd Qs] [3c]
iG7VeTyBWf6wYNvZpbTcbw: bets $1.50
cQQdn+v2h6ICJU1fq6mEyA: raises $3.75 to $5.25
iG7VeTyBWf6wYNvZpbTcbw: calls $3.75
*** SHOW DOWN ***
cQQdn+v2h6ICJU1fq6mEyA: shows [4c Ac] (a pair of Queens)
iG7VeTyBWf6wYNvZpbTcbw: shows [Kc Js] (two pair, Queens and Jacks)
iG7VeTyBWf6wYNvZpbTcbw collected $17.85 from pot
*** SUMMARY ***
Total pot $18.75 | Rake $0.90 
Board [Qc 9s Jd Qs 3c]
Seat 1: CbXUS6Z2rXZxL1AKduNtmQ folded before Flop (didn't bet)
Seat 2: 7wo6Sr7QG3Zo6BaBDV1BOw folded before Flop (didn't bet)
Seat 6: cQQdn+v2h6ICJU1fq6mEyA showed [4c Ac] and lost with a pair of Queens
Seat 7: 4oA316mXLIui1QY63GXBUg (button) folded before Flop (didn't bet)
Seat 8: iG7VeTyBWf6wYNvZpbTcbw (small blind) showed [Kc Js] and won ($17.85) with two pair, Queens and Jacks
Seat 9: DnDcAdn9P0zGovMERigpFA (big blind) folded before Flop




PokerStars Game #59939719794:  Hold'em No Limit ($0.10/$0.25) - 2009/07/01 0:47:10 ET
Table '3lL16FBjWXTx3AjK5lMRww' 9-max Seat #5 is the button
Seat 1: fDGyaQz0cs2s4FOYxkbIHA ($15.35 in chips) 
Seat 2: aGjnENGPM5z9UQkETl26TA ($15 in chips) 
Seat 3: QEbIGci+itdw+re8RM5fZA ($26.05 in chips) 
Seat 4: Z3a37Ry74FVl+CBZtAONiA ($11.40 in chips) 
Seat 5: M/9j4wkHH9i1JM51vgi1VA ($22.50 in chips) 
Seat 6: hBMUlEpyU74r/fwDgIpXjQ ($41.35 in chips) 
Seat 7: 6RiVTYll/5D8zICp0MRpKw ($25 in chips) 
Seat 8: ljemhp25Zg+nlA9DLCIiUw ($24.75 in chips) 
Seat 9: b8t3jWrxzeEt9HtZtc9wUQ ($8.85 in chips) 
hBMUlEpyU74r/fwDgIpXjQ: posts small blind $0.10
6RiVTYll/5D8zICp0MRpKw: posts big blind $0.25
aGjnENGPM5z9UQkETl26TA: posts big blind $0.25
*** HOLE CARDS ***
ljemhp25Zg+nlA9DLCIiUw: calls $0.25
b8t3jWrxzeEt9HtZtc9wUQ: calls $0.25
fDGyaQz0cs2s4FOYxkbIHA: folds 
aGjnENGPM5z9UQkETl26TA: checks 
QEbIGci+itdw+re8RM5fZA: folds 
Z3a37Ry74FVl+CBZtAONiA: folds 
M/9j4wkHH9i1JM51vgi1VA: folds 
hBMUlEpyU74r/fwDgIpXjQ: folds 
6RiVTYll/5D8zICp0MRpKw: checks 
*** FLOP *** [3d Tc 2h]
6RiVTYll/5D8zICp0MRpKw: checks 
ljemhp25Zg+nlA9DLCIiUw: bets $0.85
b8t3jWrxzeEt9HtZtc9wUQ: folds 
aGjnENGPM5z9UQkETl26TA: folds 
6RiVTYll/5D8zICp0MRpKw: folds 
Uncalled bet ($0.85) returned to ljemhp25Zg+nlA9DLCIiUw
ljemhp25Zg+nlA9DLCIiUw collected $1.05 from pot
ljemhp25Zg+nlA9DLCIiUw: doesn't show hand 
*** SUMMARY ***
Total pot $1.10 | Rake $0.05 
Board [3d Tc 2h]
Seat 1: fDGyaQz0cs2s4FOYxkbIHA folded before Flop (didn't bet)
Seat 2: aGjnENGPM5z9UQkETl26TA folded on the Flop
Seat 3: QEbIGci+itdw+re8RM5fZA folded before Flop (didn't bet)
Seat 4: Z3a37Ry74FVl+CBZtAONiA folded before Flop (didn't bet)
Seat 5: M/9j4wkHH9i1JM51vgi1VA (button) folded before Flop (didn't bet)
Seat 6: hBMUlEpyU74r/fwDgIpXjQ (small blind) folded before Flop
Seat 7: 6RiVTYll/5D8zICp0MRpKw (big blind) folded on the Flop
Seat 8: ljemhp25Zg+nlA9DLCIiUw collected ($1.05)
Seat 9: b8t3jWrxzeEt9HtZtc9wUQ folded on the Flop




PokerStars Game #59939719886:  Hold'em No Limit ($0.10/$0.25) - 2009/07/01 0:47:10 ET
Table '3lS+sU5k6mwJCS2nFMmQ6Q' 9-max Seat #1 is the button
Seat 1: VWUWpMLMj/Q1jRVpF7Aohw ($12 in chips) 
Seat 2: 4oA316mXLIui1QY63GXBUg ($25 in chips) 
Seat 3: 1DXccE2UUK5DIRVGlOKnTA ($9.85 in chips) 
Seat 4: 8B/dhbQjIWe6ASCdgzktNQ ($44.90 in chips) 
Seat 6: hJ4uYjNmSZdjrKA8cjZqCA ($28.45 in chips) 
Seat 7: Th3FldXKQW6hWVVPahaoOQ ($26 in chips) 
Seat 8: SXqVW4Q0evTUVZG6BbUNIA ($21.35 in chips) 
Seat 9: 4awUyiDYTgylQKXZ9faBVA ($43.15 in chips) 
4oA316mXLIui1QY63GXBUg: posts small blind $0.10
1DXccE2UUK5DIRVGlOKnTA: posts big blind $0.25
*** HOLE CARDS ***
8B/dhbQjIWe6ASCdgzktNQ: folds 
LuckyShot



PokerStars Game #59939720726:  Hold'em No Limit ($0.10/$0.25) - 2009/07/01 0:47:11 ET
Table '0XPo7K54oZIfG0xlNAcDRw' 9-max Seat #5 is the button
Seat 1: opOCI2p6kW0tINuVaAqmcQ ($29.30 in chips) 
Seat 2: Jbrpc6KkvYcsiySJzLmFuA ($14.05 in chips) 
Seat 3: 6qsItdeWZoOL5be2e1RFng ($16.35 in chips) 
Seat 4: vOEICaqlJhPYytg64XnnkQ ($12.05 in chips) 
Seat 5: 8B/dhbQjIWe6ASCdgzktNQ ($40.25 in chips) 
Seat 6: 9gmYYQesalMrUjaF7nKfrQ ($9.45 in chips) 
Seat 7: tYsOBqdU1+x+yFI7zHO7hQ ($45.50 in chips) 
Seat 9: s7Q6uNouhe7aE8JdFb9E+A ($25 in chips) 
9gmYYQesalMrUjaF7nKfrQ: posts small blind $0.10
tYsOBqdU1+x+yFI7zHO7hQ: posts big blind $0.25
OiV1PWZ3IkN29JlmCcnTwQ: sits out 
*** HOLE CARDS ***
s7Q6uNouhe7aE8JdFb9E+A: folds 
opOCI2p6kW0tINuVaAqmcQ: folds 
Jbrpc6KkvYcsiySJzLmFuA: folds 
6qsItdeWZoOL5be2e1RFng: folds 
vOEICaqlJhPYytg64XnnkQ: folds 
8B/dhbQjIWe6ASCdgzktNQ: folds 
9gmYYQesalMrUjaF7nKfrQ: folds 
Uncalled bet ($0.15) returned to tYsOBqdU1+x+yFI7zHO7hQ
tYsOBqdU1+x+yFI7zHO7hQ collected $0.20 from pot
tYsOBqdU1+x+yFI7zHO7hQ: doesn't show hand 
*** SUMMARY ***
Total pot $0.20 | Rake $0 
Seat 1: opOCI2p6kW0tINuVaAqmcQ folded before Flop (didn't bet)
Seat 2: Jbrpc6KkvYcsiySJzLmFuA folded before Flop (didn't bet)
Seat 3: 6qsItdeWZoOL5be2e1RFng folded before Flop (didn't bet)
Seat 4: vOEICaqlJhPYytg64XnnkQ folded before Flop (didn't bet)
Seat 5: 8B/dhbQjIWe6ASCdgzktNQ (button) folded before Flop (didn't bet)
Seat 6: 9gmYYQesalMrUjaF7nKfrQ (small blind) folded before Flop
Seat 7: tYsOBqdU1+x+yFI7zHO7hQ (big blind) collected ($0.20)
Seat 9: s7Q6uNouhe7aE8JdFb9E+A folded before Flop (didn't bet)




PokerStars Game #59939720242:  Hold'em No Limit ($0.10/$0.25) - 2009/07/01 0:47:11 ET
Table 'rpIHGyt2QpgQc5bvptAvDQ' 9-max Seat #9 is the button
Seat 1: pIK8dHf+MqCSMpnx8j9HEw ($12.65 in chips) 
Seat 2: dtZ84flFEi4Q+SGrHMJRDQ ($25 in chips) 
Seat 3: RNWwL4ZL6E6nNwmoYWS4Ug ($7.50 in chips) 
Seat 4: ottZQkg1UDWk85BtBzGJzg ($15 in chips) 
Seat 5: F7uW1LiDD9vUDBtB+5gRDg ($25.30 in chips) 
Seat 6: gehe91e0IyVT0QU/XBkEyg ($42 in chips) 
Seat 7: SXqVW4Q0evTUVZG6BbUNIA ($29.25 in chips) 
Seat 8: tYsOBqdU1+x+yFI7zHO7hQ ($25 in chips) 
Seat 9: nm4Dj/f+jJEwKVsUnKh73g ($28.90 in chips) 
pIK8dHf+MqCSMpnx8j9HEw: posts small blind $0.10
dtZ84flFEi4Q+SGrHMJRDQ: posts big blind $0.25
*** HOLE CARDS ***
RNWwL4ZL6E6nNwmoYWS4Ug: folds 
ottZQkg1UDWk85BtBzGJzg: folds 
F7uW1LiDD9vUDBtB+5gRDg: calls $0.25
gehe91e0IyVT0QU/XBkEyg: folds 
SXqVW4Q0evTUVZG6BbUNIA: folds 
tYsOBqdU1+x+yFI7zHO7hQ: folds 
nm4Dj/f+jJEwKVsUnKh73g: folds 
pIK8dHf+MqCSMpnx8j9HEw: calls $0.15
dtZ84flFEi4Q+SGrHMJRDQ: raises $1 to $1.25
F7uW1LiDD9vUDBtB+5gRDg: calls $1
pIK8dHf+MqCSMpnx8j9HEw: folds 
*** FLOP *** [Ts 2s Ah]
dtZ84flFEi4Q+SGrHMJRDQ: bets $1
F7uW1LiDD9vUDBtB+5gRDg: folds 
Uncalled bet ($1) returned to dtZ84flFEi4Q+SGrHMJRDQ
dtZ84flFEi4Q+SGrHMJRDQ collected $2.65 from pot
dtZ84flFEi4Q+SGrHMJRDQ: doesn't show hand 
*** SUMMARY ***
Total pot $2.75 | Rake $0.10 
Board [Ts 2s Ah]
Seat 1: pIK8dHf+MqCSMpnx8j9HEw (small blind) folded before Flop
Seat 2: dtZ84flFEi4Q+SGrHMJRDQ (big blind) collected ($2.65)
Seat 3: RNWwL4ZL6E6nNwmoYWS4Ug folded before Flop (didn't bet)
Seat 4: ottZQkg1UDWk85BtBzGJzg folded before Flop (didn't bet)
Seat 5: F7uW1LiDD9vUDBtB+5gRDg folded on the Flop
Seat 6: gehe91e0IyVT0QU/XBkEyg folded before Flop (didn't bet)
Seat 7: SXqVW4Q0evTUVZG6BbUNIA folded before Flop (didn't bet)
Seat 8: tYsOBqdU1+x+yFI7zHO7hQ folded before Flop (didn't bet)
Seat 9: nm4Dj/f+jJEwKVsUnKh73g (button) folded before Flop (didn't bet)




PokerStars Game #59939720290:  Hold'em No Limit ($0.10/$0.25) - 2009/07/01 0:47:11 ET
Table 'Loy/olZ5qoDOSvX4UTujGg' 6-max Seat #4 is the button
Seat 1: yzFNNFIfC89bBPwpFPx2ow ($25 in chips) 
Seat 2: 5OssdLlobpBsQP4GLYbbZQ ($5.60 in chips) 
Seat 3: 32YL2ZEp8NT4JB2RVM9euQ ($19.95 in chips) 
Seat 4: /gJNBeCkWL4o85/jvlZ4BA ($26.75 in chips) 
Seat 5: 4YSTu0Cdzpppe1lUgCZGCQ ($62.45 in chips) 
Seat 6: 7FmwVDcdEtxDpHmP4hOXsQ ($52.35 in chips) 
4YSTu0Cdzpppe1lUgCZGCQ: posts small blind $0.10
7FmwVDcdEtxDpHmP4hOXsQ: posts big blind $0.25
*** HOLE CARDS ***
yzFNNFIfC89bBPwpFPx2ow: folds 
5OssdLlobpBsQP4GLYbbZQ: raises $0.75 to $1
32YL2ZEp8NT4JB2RVM9euQ: folds 
/gJNBeCkWL4o85/jvlZ4BA: folds 
4YSTu0Cdzpppe1lUgCZGCQ: folds 
7FmwVDcdEtxDpHmP4hOXsQ: folds 
Uncalled bet ($0.75) returned to 5OssdLlobpBsQP4GLYbbZQ
5OssdLlobpBsQP4GLYbbZQ collected $0.60 from pot
*** SUMMARY ***
Total pot $0.60 | Rake $0 
Seat 1: yzFNNFIfC89bBPwpFPx2ow folded before Flop (didn't bet)
Seat 2: 5OssdLlobpBsQP4GLYbbZQ collected ($0.60)
Seat 3: 32YL2ZEp8NT4JB2RVM9euQ folded before Flop (didn't bet)
Seat 4: /gJNBeCkWL4o85/jvlZ4BA (button) folded before Flop (didn't bet)
Seat 5: 4YSTu0Cdzpppe1lUgCZGCQ (small blind) folded before Flop
Seat 6: 7FmwVDcdEtxDpHmP4hOXsQ (big blind) folded before Flop




PokerStars Game #59939720824:  Hold'em No Limit ($0.10/$0.25) - 2009/07/01 0:47:12 ET
Table '4XGDnEByOol5up4aB2KbJw' 6-max Seat #1 is the button
Seat 1: kyRaCIljYA6l33lSKQfNsg ($26.50 in chips) 
Seat 2: SFmT9ZsVopnukjvAzrxTRg ($34.45 in chips) 
Seat 3: LtASJ9OlkqGrrUKGQlpGAw ($22.90 in chips) 
Seat 4: sjoibHX/s93+8Kwa5aB1dA ($28.10 in chips) 
Seat 5: Dh01+rohD2p9pXLYeBlC5Q ($17.30 in chips) 
Seat 6: ELW+DKizJhLK7k40PMkD2Q ($32.50 in chips) 
SFmT9ZsVopnukjvAzrxTRg: posts small blind $0.10
LtASJ9OlkqGrrUKGQlpGAw: posts big blind $0.25
*** HOLE CARDS ***
sjoibHX/s93+8Kwa5aB1dA: calls $0.25
Dh01+rohD2p9pXLYeBlC5Q: folds 
ELW+DKizJhLK7k40PMkD2Q: raises $0.75 to $1
kyRaCIljYA6l33lSKQfNsg: folds 
SFmT9ZsVopnukjvAzrxTRg: folds 
LtASJ9OlkqGrrUKGQlpGAw: folds 
sjoibHX/s93+8Kwa5aB1dA: folds 
Uncalled bet ($0.75) returned to ELW+DKizJhLK7k40PMkD2Q
ELW+DKizJhLK7k40PMkD2Q collected $0.85 from pot
*** SUMMARY ***
Total pot $0.85 | Rake $0 
Seat 1: kyRaCIljYA6l33lSKQfNsg (button) folded before Flop (didn't bet)
Seat 2: SFmT9ZsVopnukjvAzrxTRg (small blind) folded before Flop
Seat 3: LtASJ9OlkqGrrUKGQlpGAw (big blind) folded before Flop
Seat 4: sjoibHX/s93+8Kwa5aB1dA folded before Flop
Seat 5: Dh01+rohD2p9pXLYeBlC5Q folded before Flop (didn't bet)
Seat 6: ELW+DKizJhLK7k40PMkD2Q collected ($0.85)




PokerStars Game #59939720906:  Hold'em No Limit ($0.10/$0.25) - 2009/07/01 0:47:12 ET
Table 'oJpFwZj9+FUGHX90Un8s9Q' 6-max Seat #1 is the button
Seat 1: 6DwBRH+xZ12AAZmeAg+aXw ($26.15 in chips) 
Seat 2: IMmIhmfU3tqkaJABnD21Rg ($14.30 in chips) 
Seat 3: kyRaCIljYA6l33lSKQfNsg ($27.80 in chips) 
Seat 4: IX/nJvz3Mx/Ez6DgueFA4Q ($9.60 in chips) 
Seat 5: kG34n23qFQA3nzdOJTQ1dA ($24.30 in chips) 
Seat 6: Zijzy/UtPWzWVUo81HHVjQ ($40.10 in chips) 
IMmIhmfU3tqkaJABnD21Rg: posts small blind $0.10
kyRaCIljYA6l33lSKQfNsg: posts big blind $0.25
*** HOLE CARDS ***
IX/nJvz3Mx/Ez6DgueFA4Q: folds 
kG34n23qFQA3nzdOJTQ1dA: folds 
Zijzy/UtPWzWVUo81HHVjQ has timed out
Zijzy/UtPWzWVUo81HHVjQ: folds 
Zijzy/UtPWzWVUo81HHVjQ is sitting out
6DwBRH+xZ12AAZmeAg+aXw: folds 
IMmIhmfU3tqkaJABnD21Rg: raises $0.25 to $0.50
kyRaCIljYA6l33lSKQfNsg: folds 
Uncalled bet ($0.25) returned to IMmIhmfU3tqkaJABnD21Rg
IMmIhmfU3tqkaJABnD21Rg collected $0.50 from pot
IMmIhmfU3tqkaJABnD21Rg: doesn't show hand 
*** SUMMARY ***
Total pot $0.50 | Rake $0 
Seat 1: 6DwBRH+xZ12AAZmeAg+aXw (button) folded before Flop (didn't bet)
Seat 2: IMmIhmfU3tqkaJABnD21Rg (small blind) collected ($0.50)
Seat 3: kyRaCIljYA6l33lSKQfNsg (big blind) folded before Flop
Seat 4: IX/nJvz3Mx/Ez6DgueFA4Q folded before Flop (didn't bet)
Seat 5: kG34n23qFQA3nzdOJTQ1dA folded before Flop (didn't bet)
Seat 6: Zijzy/UtPWzWVUo81HHVjQ folded before Flop (didn't bet)




PokerStars Game #59939720890:  Hold'em No Limit ($0.10/$0.25) - 2009/07/01 0:47:12 ET
Table '4mnXP0EWt9mMZYzTIVDQ0w' 9-max Seat #7 is the button
Seat 1: PTFwg4rGxnfVvj2iP1OI2w ($11.50 in chips) 
Seat 2: j4q3p0lesp63b1gZDwLBZw ($6.85 in chips) 
Seat 4: E0iYnEVO2ho7dH3QcCjw7g ($24.65 in chips) 
Seat 5: sSN8Y0AlsBeidZXPKmwXSw ($24.90 in chips) 
Seat 6: n9toqYXSLowQ/sWq842dEQ ($8.90 in chips) 
Seat 7: s1y+qfkBnhgc67+X3ThjeA ($26.35 in chips) 
Seat 8: H9KUl8cmpLgEpOVDA00bCg ($4.05 in chips) 
H9KUl8cmpLgEpOVDA00bCg: posts small blind $0.10
wbCayoP+N6xpKgOfIqZsbA: is sitting out 
PTFwg4rGxnfVvj2iP1OI2w: posts big blind $0.25
ompa52: sits out 
*** HOLE CARDS ***
wbCayoP+N6xpKgOfIqZsbA said, "nh"
j4q3p0lesp63b1gZDwLBZw: folds 
E0iYnEVO2ho7dH3QcCjw7g: folds 
sSN8Y0AlsBeidZXPKmwXSw said, "ty sir"
wbCayoP+N6xpKgOfIqZsbA said, "nicely played...gg"
sSN8Y0AlsBeidZXPKmwXSw: raises $0.50 to $0.75
wbCayoP+N6xpKgOfIqZsbA said, "tc all"
n9toqYXSLowQ/sWq842dEQ: folds 
s1y+qfkBnhgc67+X3ThjeA: folds 
H9KUl8cmpLgEpOVDA00bCg: folds 
n9toqYXSLowQ/sWq842dEQ leaves the table
PTFwg4rGxnfVvj2iP1OI2w: calls $0.50
*** FLOP *** [4s Kh Qc]
s1y+qfkBnhgc67+X3ThjeA said, "u 2"
wbCayoP+N6xpKgOfIqZsbA leaves the table
PTFwg4rGxnfVvj2iP1OI2w: checks 
sSN8Y0AlsBeidZXPKmwXSw: bets $0.75
PTFwg4rGxnfVvj2iP1OI2w: calls $0.75
*** TURN *** [4s Kh Qc] [6s]
PTFwg4rGxnfVvj2iP1OI2w: checks 
sSN8Y0AlsBeidZXPKmwXSw: checks 
*** RIVER *** [4s Kh Qc 6s] [8h]
PTFwg4rGxnfVvj2iP1OI2w: checks 
sSN8Y0AlsBeidZXPKmwXSw: checks 
*** SHOW DOWN ***
PTFwg4rGxnfVvj2iP1OI2w: shows [Qh 9s] (a pair of Queens)
sSN8Y0AlsBeidZXPKmwXSw: shows [Js Ah] (high card Ace)
PTFwg4rGxnfVvj2iP1OI2w collected $2.95 from pot
*** SUMMARY ***
Total pot $3.10 | Rake $0.15 
Board [4s Kh Qc 6s 8h]
Seat 1: PTFwg4rGxnfVvj2iP1OI2w (big blind) showed [Qh 9s] and won ($2.95) with a pair of Queens
Seat 2: j4q3p0lesp63b1gZDwLBZw folded before Flop (didn't bet)
Seat 4: E0iYnEVO2ho7dH3QcCjw7g folded before Flop (didn't bet)
Seat 5: sSN8Y0AlsBeidZXPKmwXSw showed [Js Ah] and lost with high card Ace
Seat 6: n9toqYXSLowQ/sWq842dEQ folded before Flop (didn't bet)
Seat 7: s1y+qfkBnhgc67+X3ThjeA (button) folded before Flop (didn't bet)
Seat 8: H9KUl8cmpLgEpOVDA00bCg (small blind) folded before Flop




PokerStars Game #59939720762:  Hold'em No Limit ($0.10/$0.25) - 2009/07/01 0:47:12 ET
Table 'f9j+4UOgRPXbyNbQkZFm4w' 6-max Seat #5 is the button
Seat 1: BYxjLnV1/LL0aZcTbfAOvw ($25 in chips) 
Seat 3: wCBHaebpIJ2ZTqigoRi9DA ($20.60 in chips) 
Seat 4: hiTEr3yrERiQp3zHXRioVw ($26.80 in chips) 
Seat 5: 1lxYIAoJdZwAbzIkzWmSkw ($10.65 in chips) 
Seat 6: C84t1kUtjDF/zm38/Dpcng ($14.60 in chips) 
C84t1kUtjDF/zm38/Dpcng: posts small blind $0.10
BYxjLnV1/LL0aZcTbfAOvw: posts big blind $0.25
Zb8xGmbjS8ghABxs9n6huA: sits out 
*** HOLE CARDS ***
wCBHaebpIJ2ZTqigoRi9DA: raises $0.75 to $1
hiTEr3yrERiQp3zHXRioVw: folds 
1lxYIAoJdZwAbzIkzWmSkw: folds 
C84t1kUtjDF/zm38/Dpcng: folds 
BYxjLnV1/LL0aZcTbfAOvw: folds 
Uncalled bet ($0.75) returned to wCBHaebpIJ2ZTqigoRi9DA
wCBHaebpIJ2ZTqigoRi9DA collected $0.60 from pot
wCBHaebpIJ2ZTqigoRi9DA: doesn't show hand 
*** SUMMARY ***
Total pot $0.60 | Rake $0 
Seat 1: BYxjLnV1/LL0aZcTbfAOvw (big blind) folded before Flop
Seat 3: wCBHaebpIJ2ZTqigoRi9DA collected ($0.60)
Seat 4: hiTEr3yrERiQp3zHXRioVw folded before Flop (didn't bet)
Seat 5: 1lxYIAoJdZwAbzIkzWmSkw (button) folded before Flop (didn't bet)
Seat 6: C84t1kUtjDF/zm38/Dpcng (small blind) folded before Flop




PokerStars Game #59939720978:  Hold'em No Limit ($0.10/$0.25) - 2009/07/01 0:47:12 ET
Table 'xmJKTGBeWCwutccj3YfupQ' 6-max Seat #2 is the button
Seat 2: BedjMfrlRfPgSq7CXpPAmg ($50.60 in chips) 
Seat 5: oBUDUfeUyCbZBsjxHZgSiw ($16.55 in chips) 
BedjMfrlRfPgSq7CXpPAmg: posts small blind $0.10
oBUDUfeUyCbZBsjxHZgSiw: posts big blind $0.25
*** HOLE CARDS ***
FStoHe64SQWqAsjya9pDkQ leaves the table
BedjMfrlRfPgSq7CXpPAmg: raises $0.75 to $1
oBUDUfeUyCbZBsjxHZgSiw: folds 
Uncalled bet ($0.75) returned to BedjMfrlRfPgSq7CXpPAmg
BedjMfrlRfPgSq7CXpPAmg collected $0.50 from pot
*** SUMMARY ***
Total pot $0.50 | Rake $0 
Seat 2: BedjMfrlRfPgSq7CXpPAmg (button) (small blind) collected ($0.50)
Seat 5: oBUDUfeUyCbZBsjxHZgSiw (big blind) folded before Flop




PokerStars Game #59939721134:  Hold'em No Limit ($0.10/$0.25) - 2009/07/01 0:47:12 ET
Table '8QBBaev+cI2i/r2H6ml/lg' 9-max Seat #4 is the button
Seat 4: ZoG0obuajzVjwgd7lNHjgg ($4.10 in chips) 
Seat 6: cxE+szmvEUe7vE+z2ozM2Q ($10.90 in chips) 
ZoG0obuajzVjwgd7lNHjgg: posts small blind $0.10
cxE+szmvEUe7vE+z2ozM2Q: posts big blind $0.25
*** HOLE CARDS ***
ZoG0obuajzVjwgd7lNHjgg: calls $0.15
cxE+szmvEUe7vE+z2ozM2Q: checks 
*** FLOP *** [4h 7d 4d]
cxE+szmvEUe7vE+z2ozM2Q: checks 
ZoG0obuajzVjwgd7lNHjgg: bets $0.50
cxE+szmvEUe7vE+z2ozM2Q: folds 
Uncalled bet ($0.50) returned to ZoG0obuajzVjwgd7lNHjgg
ZoG0obuajzVjwgd7lNHjgg collected $0.50 from pot
*** SUMMARY ***
Total pot $0.50 | Rake $0 
Board [4h 7d 4d]
Seat 4: ZoG0obuajzVjwgd7lNHjgg (button) (small blind) collected ($0.50)
Seat 6: cxE+szmvEUe7vE+z2ozM2Q (big blind) folded on the Flop




PokerStars Game #59939720826:  Hold'em No Limit ($0.10/$0.25) - 2009/07/01 0:47:12 ET
Table 'P1IJQ2p3ACFySC35W1qwQw' 9-max Seat #9 is the button
Seat 1: hBMUlEpyU74r/fwDgIpXjQ ($25 in chips) 
Seat 2: E0iYnEVO2ho7dH3QcCjw7g ($20 in chips) 
Seat 4: LuckyShot



PokerStars Game #59939721274:  Hold'em No Limit ($0.10/$0.25) - 2009/07/01 0:47:12 ET
Table '8Z6T3ssCpo3VV849U4RgBw' 9-max Seat #7 is the button
Seat 1: 8dNQBtNvCvzVgSnmDgi/LA ($11.65 in chips) 
Seat 2: y2juVuWuW+u1THo3kosjLQ ($14.75 in chips) 
Seat 3: DdPXdieucQ+n99u1n3A+rQ ($4.90 in chips) 
Seat 4: swWFmLwqgpSU1P6HAmCGPw ($14.90 in chips) 
Seat 5: zDrucyjVn5aeekNEc3cJrA ($22.55 in chips) 
Seat 7: VBHxUExRAMrbxUq/cVx9Gw ($5.85 in chips) 
Seat 8: hPhp/RE3cJ5YGaQ2xOHXXg ($5 in chips) 
Seat 9: yfkbMbx4w7MXhQDFPxOq0A ($19.65 in chips) 
hPhp/RE3cJ5YGaQ2xOHXXg: posts small blind $0.10
yfkbMbx4w7MXhQDFPxOq0A: posts big blind $0.25
Mr_GlamoRouS: sits out 
*** HOLE CARDS ***
8dNQBtNvCvzVgSnmDgi/LA: folds 
y2juVuWuW+u1THo3kosjLQ: folds 
DdPXdieucQ+n99u1n3A+rQ: raises $0.75 to $1
swWFmLwqgpSU1P6HAmCGPw: folds 
zDrucyjVn5aeekNEc3cJrA: calls $1
VBHxUExRAMrbxUq/cVx9Gw: folds 
hPhp/RE3cJ5YGaQ2xOHXXg: folds 
yfkbMbx4w7MXhQDFPxOq0A: folds 
*** FLOP *** [8h 3s 5h]
DdPXdieucQ+n99u1n3A+rQ: bets $1.75
zDrucyjVn5aeekNEc3cJrA: calls $1.75
*** TURN *** [8h 3s 5h] [Qc]
DdPXdieucQ+n99u1n3A+rQ: bets $2.15 and is all-in
zDrucyjVn5aeekNEc3cJrA: calls $2.15
*** RIVER *** [8h 3s 5h Qc] [Ts]
*** SHOW DOWN ***
DdPXdieucQ+n99u1n3A+rQ: shows [Ac As] (a pair of Aces)
zDrucyjVn5aeekNEc3cJrA: mucks hand 
DdPXdieucQ+n99u1n3A+rQ collected $9.70 from pot
*** SUMMARY ***
Total pot $10.15 | Rake $0.45 
Board [8h 3s 5h Qc Ts]
Seat 1: 8dNQBtNvCvzVgSnmDgi/LA folded before Flop (didn't bet)
Seat 2: y2juVuWuW+u1THo3kosjLQ folded before Flop (didn't bet)
Seat 3: DdPXdieucQ+n99u1n3A+rQ showed [Ac As] and won ($9.70) with a pair of Aces
Seat 4: swWFmLwqgpSU1P6HAmCGPw folded before Flop (didn't bet)
Seat 5: zDrucyjVn5aeekNEc3cJrA mucked
Seat 7: VBHxUExRAMrbxUq/cVx9Gw (button) folded before Flop (didn't bet)
Seat 8: hPhp/RE3cJ5YGaQ2xOHXXg (small blind) folded before Flop
Seat 9: yfkbMbx4w7MXhQDFPxOq0A (big blind) folded before Flop




PokerStars Game #59939720850:  Hold'em No Limit ($0.10/$0.25) - 2009/07/01 0:47:12 ET
Table 'pAhiNHs/spaABQia+7gWNQ' 9-max Seat #6 is the button
Seat 1: /VQLorsEOrMfI+KamzNQEA ($5 in chips) 
Seat 2: vnCdP3GsLTKadDukKcJk/Q ($25 in chips) 
Seat 3: xEQxarad8/T4jJdpZy5LGw ($27 in chips) 
Seat 4: F7pnn6czNpHvRM55XcA2EA ($25 in chips) 
Seat 5: OlPJsgR4xypSg/w1z7Gyvw ($20 in chips) 
Seat 6: FinSxgTdEPV/yPQRl5uhmA ($50.20 in chips) 
Seat 7: 04UcDjK4SUEJctLqNtWFoQ ($9.15 in chips) 
Seat 9: vZGoOTJLQLhkPj4I+LNGig ($25 in chips) 
04UcDjK4SUEJctLqNtWFoQ: posts small blind $0.10
vSkQm2EelzwRGDDQQk0Fqw: is sitting out 
vSkQm2EelzwRGDDQQk0Fqw leaves the table
st9jtdNbm1W5GfBwRaCVqQ joins the table at seat #8 
st9jtdNbm1W5GfBwRaCVqQ is sitting out
vZGoOTJLQLhkPj4I+LNGig: posts big blind $0.25
OlPJsgR4xypSg/w1z7Gyvw: posts big blind $0.25
*** HOLE CARDS ***
/VQLorsEOrMfI+KamzNQEA: folds 
vnCdP3GsLTKadDukKcJk/Q: folds 
xEQxarad8/T4jJdpZy5LGw: calls $0.25
F7pnn6czNpHvRM55XcA2EA: folds 
OlPJsgR4xypSg/w1z7Gyvw: checks 
FinSxgTdEPV/yPQRl5uhmA: folds 
04UcDjK4SUEJctLqNtWFoQ: calls $0.15
vZGoOTJLQLhkPj4I+LNGig: checks 
*** FLOP *** [Tc Ac Js]
04UcDjK4SUEJctLqNtWFoQ: checks 
vZGoOTJLQLhkPj4I+LNGig: checks 
xEQxarad8/T4jJdpZy5LGw: bets $0.25
OlPJsgR4xypSg/w1z7Gyvw: folds 
04UcDjK4SUEJctLqNtWFoQ: calls $0.25
vZGoOTJLQLhkPj4I+LNGig: folds 
*** TURN *** [Tc Ac Js] [9h]
04UcDjK4SUEJctLqNtWFoQ: checks 
xEQxarad8/T4jJdpZy5LGw: checks 
*** RIVER *** [Tc Ac Js 9h] [7c]
04UcDjK4SUEJctLqNtWFoQ: bets $1.25
xEQxarad8/T4jJdpZy5LGw: folds 
Uncalled bet ($1.25) returned to 04UcDjK4SUEJctLqNtWFoQ
04UcDjK4SUEJctLqNtWFoQ collected $1.45 from pot
04UcDjK4SUEJctLqNtWFoQ: doesn't show hand 
*** SUMMARY ***
Total pot $1.50 | Rake $0.05 
Board [Tc Ac Js 9h 7c]
Seat 1: /VQLorsEOrMfI+KamzNQEA folded before Flop (didn't bet)
Seat 2: vnCdP3GsLTKadDukKcJk/Q folded before Flop (didn't bet)
Seat 3: xEQxarad8/T4jJdpZy5LGw folded on the River
Seat 4: F7pnn6czNpHvRM55XcA2EA folded before Flop (didn't bet)
Seat 5: OlPJsgR4xypSg/w1z7Gyvw folded on the Flop
Seat 6: FinSxgTdEPV/yPQRl5uhmA (button) folded before Flop (didn't bet)
Seat 7: 04UcDjK4SUEJctLqNtWFoQ (small blind) collected ($1.45)
Seat 9: vZGoOTJLQLhkPj4I+LNGig (big blind) folded on the Flop




PokerStars Game #59939721706:  Hold'em No Limit ($0.10/$0.25) - 2009/07/01 0:47:13 ET
Table 'sIHZ0lzLr4NGCaBUKhmYhAJj2eLzVCUVAGBmM+Og79iQax Seat #7 is the button
Seat 1: /XMgGtJ7mcWfe5s7McY9kw ($43.15 in chips) 
Seat 2: oMxwMC7+uAsJudeUN6aP0A ($22.30 in chips) 
Seat 3: HPEB+AtKw1+C/cxU0o1ciw ($22.95 in chips) 
Seat 4: aNpwfA31EREwO+ar4XzBCw ($46.70 in chips) 
Seat 5: UOx+/JnFB2Or6ZU9oasIlQ ($25 in chips) 
Seat 7: K0b5wNInj6hUGRr6yzKFtw ($31.95 in chips) 
Seat 8: 18G4P1XstjNvItdGUITxgw ($25 in chips) 
Seat 9: wU1LtrccnZo6PYKhlJ6ElQ ($36.70 in chips) 
18G4P1XstjNvItdGUITxgw: posts small blind $0.10
wU1LtrccnZo6PYKhlJ6ElQ: posts big blind $0.25
*** HOLE CARDS ***
/XMgGtJ7mcWfe5s7McY9kw: folds 
oMxwMC7+uAsJudeUN6aP0A: calls $0.25
HPEB+AtKw1+C/cxU0o1ciw: calls $0.25
aNpwfA31EREwO+ar4XzBCw: folds 
UOx+/JnFB2Or6ZU9oasIlQ: folds 
K0b5wNInj6hUGRr6yzKFtw: folds 
18G4P1XstjNvItdGUITxgw: folds 
wU1LtrccnZo6PYKhlJ6ElQ: checks 
*** FLOP *** [8s 3h 3s]
wU1LtrccnZo6PYKhlJ6ElQ: checks 
oMxwMC7+uAsJudeUN6aP0A: bets $0.50
HPEB+AtKw1+C/cxU0o1ciw: raises $0.75 to $1.25
wU1LtrccnZo6PYKhlJ6ElQ: folds 
oMxwMC7+uAsJudeUN6aP0A: folds 
Uncalled bet ($0.75) returned to HPEB+AtKw1+C/cxU0o1ciw
HPEB+AtKw1+C/cxU0o1ciw collected $1.80 from pot
HPEB+AtKw1+C/cxU0o1ciw: doesn't show hand 
*** SUMMARY ***
Total pot $1.85 | Rake $0.05 
Board [8s 3h 3s]
Seat 1: /XMgGtJ7mcWfe5s7McY9kw folded before Flop (didn't bet)
Seat 2: oMxwMC7+uAsJudeUN6aP0A folded on the Flop
Seat 3: HPEB+AtKw1+C/cxU0o1ciw collected ($1.80)
Seat 4: aNpwfA31EREwO+ar4XzBCw folded before Flop (didn't bet)
Seat 5: UOx+/JnFB2Or6ZU9oasIlQ folded before Flop (didn't bet)
Seat 7: K0b5wNInj6hUGRr6yzKFtw (button) folded before Flop (didn't bet)
Seat 8: 18G4P1XstjNvItdGUITxgw (small blind) folded before Flop
Seat 9: wU1LtrccnZo6PYKhlJ6ElQ (big blind) folded on the Flop




PokerStars Game #59939721480:  Hold'em No Limit ($0.10/$0.25) - 2009/07/01 0:47:13 ET
Table 'KAnP7XvDtlku47YfJwdOVw' 9-max Seat #4 is the button
Seat 1: sJNHTWcSlLHRCZ9+YRLLqA ($25 in chips) 
Seat 2: CYkY0dNBaYaKs8HVCVn3mQ ($15.10 in chips) 
Seat 3: 7qgCOBwxmRRmkppeMkqy0Q ($1.20 in chips) 
Seat 4: E2OrwPLjPzZjbllMp2olEw ($16.80 in chips) 
Seat 5: MG90wfSJZnOejs/KD3vlQQ ($30.95 in chips) 
Seat 6: z5GxcHlYz/GSz6W2uFiTtg ($24.70 in chips) 
Seat 7: Lro4e37x4FUa5P3yzDjskw ($9.90 in chips) 
Seat 8: 3fPCxL5JUJVUL3eETYhxQQ ($3.10 in chips) 
Seat 9: qwr38jl5txoR36M7G5qi4A ($18.20 in chips) 
MG90wfSJZnOejs/KD3vlQQ: posts small blind $0.10
z5GxcHlYz/GSz6W2uFiTtg: posts big blind $0.25
*** HOLE CARDS ***
Lro4e37x4FUa5P3yzDjskw: folds 
3fPCxL5JUJVUL3eETYhxQQ: calls $0.25
qwr38jl5txoR36M7G5qi4A: folds 
sJNHTWcSlLHRCZ9+YRLLqA: folds 
CYkY0dNBaYaKs8HVCVn3mQ: folds 
7qgCOBwxmRRmkppeMkqy0Q: folds 
E2OrwPLjPzZjbllMp2olEw: raises $0.25 to $0.50
MG90wfSJZnOejs/KD3vlQQ: folds 
z5GxcHlYz/GSz6W2uFiTtg: folds 
3fPCxL5JUJVUL3eETYhxQQ: calls $0.25
*** FLOP *** [9s Kd 5d]
3fPCxL5JUJVUL3eETYhxQQ: checks 
E2OrwPLjPzZjbllMp2olEw: checks 
*** TURN *** [9s Kd 5d] [Ad]
3fPCxL5JUJVUL3eETYhxQQ: checks 
E2OrwPLjPzZjbllMp2olEw: checks 
*** RIVER *** [9s Kd 5d Ad] [5c]
3fPCxL5JUJVUL3eETYhxQQ: checks 
E2OrwPLjPzZjbllMp2olEw: bets $1
3fPCxL5JUJVUL3eETYhxQQ: calls $1
*** SHOW DOWN ***
E2OrwPLjPzZjbllMp2olEw: shows [8d Ah] (two pair, Aces and Fives)
3fPCxL5JUJVUL3eETYhxQQ: mucks hand 
E2OrwPLjPzZjbllMp2olEw collected $3.20 from pot
*** SUMMARY ***
Total pot $3.35 | Rake $0.15 
Board [9s Kd 5d Ad 5c]
Seat 1: sJNHTWcSlLHRCZ9+YRLLqA folded before Flop (didn't bet)
Seat 2: CYkY0dNBaYaKs8HVCVn3mQ folded before Flop (didn't bet)
Seat 3: 7qgCOBwxmRRmkppeMkqy0Q folded before Flop (didn't bet)
Seat 4: E2OrwPLjPzZjbllMp2olEw (button) showed [8d Ah] and won ($3.20) with two pair, Aces and Fives
Seat 5: MG90wfSJZnOejs/KD3vlQQ (small blind) folded before Flop
Seat 6: z5GxcHlYz/GSz6W2uFiTtg (big blind) folded before Flop
Seat 7: Lro4e37x4FUa5P3yzDjskw folded before Flop (didn't bet)
Seat 8: 3fPCxL5JUJVUL3eETYhxQQ mucked
Seat 9: qwr38jl5txoR36M7G5qi4A folded before Flop (didn't bet)




PokerStars Game #59939721488:  Hold'em No Limit ($0.10/$0.25) - 2009/07/01 0:47:13 ET
Table '3KDMdm1sfxFsNKkjc/PnBg' 9-max Seat #6 is the button
Seat 2: rUpvA02nErFvZ4yFbDR8XA ($19.50 in chips) 
Seat 3: GftT+l+xjKzcY0rMiNZfPg ($20.75 in chips) 
Seat 4: 4xnojP+j2Tm8s9Bh7QC5+Q ($18.05 in chips) 
Seat 5: +2kMBNpY4nF1qNCRd8SJLA ($25.75 in chips) 
Seat 6: N1HHRe1nNMukTQB6qMn6Kw ($16.45 in chips) 
Seat 7: gehe91e0IyVT0QU/XBkEyg ($25 in chips) 
Seat 9: K0b5wNInj6hUGRr6yzKFtw ($31.70 in chips) 
gehe91e0IyVT0QU/XBkEyg: posts small blind $0.10
st9jtdNbm1W5GfBwRaCVqQ: is sitting out 
K0b5wNInj6hUGRr6yzKFtw: posts big blind $0.25
V6p0jQ/RhUsqpHLmXvEX4Q: sits out 
*** HOLE CARDS ***
rUpvA02nErFvZ4yFbDR8XA: calls $0.25
GftT+l+xjKzcY0rMiNZfPg: folds 
4xnojP+j2Tm8s9Bh7QC5+Q: raises $0.75 to $1
+2kMBNpY4nF1qNCRd8SJLA: folds 
N1HHRe1nNMukTQB6qMn6Kw: folds 
gehe91e0IyVT0QU/XBkEyg: folds 
K0b5wNInj6hUGRr6yzKFtw: calls $0.75
rUpvA02nErFvZ4yFbDR8XA: folds 
*** FLOP *** [Tc 7h 3c]
K0b5wNInj6hUGRr6yzKFtw: checks 
4xnojP+j2Tm8s9Bh7QC5+Q: bets $1
K0b5wNInj6hUGRr6yzKFtw: folds 
Uncalled bet ($1) returned to 4xnojP+j2Tm8s9Bh7QC5+Q
4xnojP+j2Tm8s9Bh7QC5+Q collected $2.25 from pot
4xnojP+j2Tm8s9Bh7QC5+Q: doesn't show hand 
*** SUMMARY ***
Total pot $2.35 | Rake $0.10 
Board [Tc 7h 3c]
Seat 2: rUpvA02nErFvZ4yFbDR8XA folded before Flop
Seat 3: GftT+l+xjKzcY0rMiNZfPg folded before Flop (didn't bet)
Seat 4: 4xnojP+j2Tm8s9Bh7QC5+Q collected ($2.25)
Seat 5: +2kMBNpY4nF1qNCRd8SJLA folded before Flop (didn't bet)
Seat 6: N1HHRe1nNMukTQB6qMn6Kw (button) folded before Flop (didn't bet)
Seat 7: gehe91e0IyVT0QU/XBkEyg (small blind) folded before Flop
Seat 9: K0b5wNInj6hUGRr6yzKFtw (big blind) folded on the Flop




PokerStars Game #59939722366:  Hold'em No Limit ($0.10/$0.25) - 2009/07/01 0:47:14 ET
Table '+UzantPJ4smVdrh+4GTu1w' 6-max Seat #5 is the button
Seat 1: 4jrz/IbtclK1xNH6lZqJNA ($25 in chips) 
Seat 2: tcbEu7VzyHQ+0lh+skbQhQ ($14.70 in chips) 
Seat 3: SS/yfeArhULzIcOPe8MdPg ($50.90 in chips) 
Seat 4: IGRfskE1v9H9Bn+fz8AgNQ ($21.80 in chips) 
Seat 5: cj4VBQya7HtVL2zCGd5jLQ ($21.90 in chips) 
Seat 6: BYxjLnV1/LL0aZcTbfAOvw ($48.40 in chips) 
BYxjLnV1/LL0aZcTbfAOvw: posts small blind $0.10
4jrz/IbtclK1xNH6lZqJNA: posts big blind $0.25
*** HOLE CARDS ***
tcbEu7VzyHQ+0lh+skbQhQ: folds 
SS/yfeArhULzIcOPe8MdPg: folds 
IGRfskE1v9H9Bn+fz8AgNQ: folds 
cj4VBQya7HtVL2zCGd5jLQ: folds 
BYxjLnV1/LL0aZcTbfAOvw: folds 
Uncalled bet ($0.15) returned to 4jrz/IbtclK1xNH6lZqJNA
4jrz/IbtclK1xNH6lZqJNA collected $0.20 from pot
4jrz/IbtclK1xNH6lZqJNA: doesn't show hand 
*** SUMMARY ***
Total pot $0.20 | Rake $0 
Seat 1: 4jrz/IbtclK1xNH6lZqJNA (big blind) collected ($0.20)
Seat 2: tcbEu7VzyHQ+0lh+skbQhQ folded before Flop (didn't bet)
Seat 3: SS/yfeArhULzIcOPe8MdPg folded before Flop (didn't bet)
Seat 4: IGRfskE1v9H9Bn+fz8AgNQ folded before Flop (didn't bet)
Seat 5: cj4VBQya7HtVL2zCGd5jLQ (button) folded before Flop (didn't bet)
Seat 6: BYxjLnV1/LL0aZcTbfAOvw (small blind) folded before Flop




PokerStars Game #59939722086:  Hold'em No Limit ($0.10/$0.25) - 2009/07/01 0:47:14 ET
Table 'HIOfhT0zga/KonFhIl6O3w' 9-max Seat #6 is the button
Seat 1: t2nb95S5EEFOEzNx9Itz0g ($5.85 in chips) 
Seat 2: er86weqXTpTB6/w2dKlYgA ($17 in chips) 
Seat 3: RxrlOCIHB/l30KL6EEws0g ($36.55 in chips) 
Seat 4: qwr38jl5txoR36M7G5qi4A ($7.50 in chips) 
Seat 5: K1MDeapSEyKyGPNZGOKfEg ($17.25 in chips) 
Seat 6: cZ99hugmLBj9KhTlc8nCSw ($25.95 in chips) 
Seat 7: H9KUl8cmpLgEpOVDA00bCg ($5.35 in chips) 
Seat 8: 3RCAkueG3Vc13VpRStCB+w ($25.85 in chips) 
Seat 9: dfNim92Z6XK1/h5SFW5vDg ($25 in chips) 
H9KUl8cmpLgEpOVDA00bCg: posts small blind $0.10
3RCAkueG3Vc13VpRStCB+w: posts big blind $0.25
*** HOLE CARDS ***
dfNim92Z6XK1/h5SFW5vDg: folds 
t2nb95S5EEFOEzNx9Itz0g: folds 
er86weqXTpTB6/w2dKlYgA: calls $0.25
RxrlOCIHB/l30KL6EEws0g: calls $0.25
qwr38jl5txoR36M7G5qi4A: folds 
K1MDeapSEyKyGPNZGOKfEg: folds 
cZ99hugmLBj9KhTlc8nCSw: folds 
H9KUl8cmpLgEpOVDA00bCg: calls $0.15
3RCAkueG3Vc13VpRStCB+w: checks 
*** FLOP *** [Qd 4h 7h]
H9KUl8cmpLgEpOVDA00bCg: checks 
3RCAkueG3Vc13VpRStCB+w: bets $0.75
er86weqXTpTB6/w2dKlYgA: calls $0.75
RxrlOCIHB/l30KL6EEws0g: folds 
H9KUl8cmpLgEpOVDA00bCg: folds 
*** TURN *** [Qd 4h 7h] [8c]
3RCAkueG3Vc13VpRStCB+w: bets $1.75
er86weqXTpTB6/w2dKlYgA: folds 
Uncalled bet ($1.75) returned to 3RCAkueG3Vc13VpRStCB+w
3RCAkueG3Vc13VpRStCB+w collected $2.40 from pot
3RCAkueG3Vc13VpRStCB+w: doesn't show hand 
*** SUMMARY ***
Total pot $2.50 | Rake $0.10 
Board [Qd 4h 7h 8c]
Seat 1: t2nb95S5EEFOEzNx9Itz0g folded before Flop (didn't bet)
Seat 2: er86weqXTpTB6/w2dKlYgA folded on the Turn
Seat 3: RxrlOCIHB/l30KL6EEws0g folded on the Flop
Seat 4: qwr38jl5txoR36M7G5qi4A folded before Flop (didn't bet)
Seat 5: K1MDeapSEyKyGPNZGOKfEg folded before Flop (didn't bet)
Seat 6: cZ99hugmLBj9KhTlc8nCSw (button) folded before Flop (didn't bet)
Seat 7: H9KUl8cmpLgEpOVDA00bCg (small blind) folded on the Flop
Seat 8: 3RCAkueG3Vc13VpRStCB+w (big blind) collected ($2.40)
Seat 9: dfNim92Z6XK1/h5SFW5vDg folded before Flop (didn't bet)




PokerStars Game #59939722486:  Hold'em No Limit ($0.10/$0.25) - 2009/07/01 0:47:14 ET
Table 'aT31tt16YvQM/Ue69HPLpA' 9-max Seat #4 is the button
Seat 1: uYY6p3irj4hBN7IeHiNGSw ($34.75 in chips) 
Seat 3: tYsOBqdU1+x+yFI7zHO7hQ ($27.90 in chips) 
Seat 4: s7Q6uNouhe7aE8JdFb9E+A ($25 in chips) 
Seat 5: cvtKnIIaTx2+P/KlOK+tfQ ($11.50 in chips) 
Seat 6: 7cv+9Zc9HIQHNvYsMfV3uA ($41.75 in chips) 
Seat 7: s8SPJjToEJz2mPsHsMqL0A ($4.75 in chips) 
Seat 8: lrTLp1zpuCCs/e0pi2M8jw ($43.85 in chips) 
Seat 9: SXqVW4Q0evTUVZG6BbUNIA ($29.65 in chips) 
cvtKnIIaTx2+P/KlOK+tfQ: posts small blind $0.10
7cv+9Zc9HIQHNvYsMfV3uA: posts big blind $0.25
CYkY0dNBaYaKs8HVCVn3mQ: sits out 
*** HOLE CARDS ***
s8SPJjToEJz2mPsHsMqL0A: folds 
lrTLp1zpuCCs/e0pi2M8jw: calls $0.25
SXqVW4Q0evTUVZG6BbUNIA: folds 
uYY6p3irj4hBN7IeHiNGSw: folds 
tYsOBqdU1+x+yFI7zHO7hQ: folds 
s7Q6uNouhe7aE8JdFb9E+A: folds 
cvtKnIIaTx2+P/KlOK+tfQ: calls $0.15
7cv+9Zc9HIQHNvYsMfV3uA: checks 
*** FLOP *** [9s Js Kh]
cvtKnIIaTx2+P/KlOK+tfQ: checks 
7cv+9Zc9HIQHNvYsMfV3uA: checks 
lrTLp1zpuCCs/e0pi2M8jw: checks 
*** TURN *** [9s Js Kh] [Jh]
cvtKnIIaTx2+P/KlOK+tfQ: checks 
7cv+9Zc9HIQHNvYsMfV3uA: checks 
lrTLp1zpuCCs/e0pi2M8jw: checks 
*** RIVER *** [9s Js Kh Jh] [2c]
cvtKnIIaTx2+P/KlOK+tfQ: checks 
7cv+9Zc9HIQHNvYsMfV3uA: checks 
lrTLp1zpuCCs/e0pi2M8jw: checks 
*** SHOW DOWN ***
cvtKnIIaTx2+P/KlOK+tfQ: shows [As 4d] (a pair of Jacks)
7cv+9Zc9HIQHNvYsMfV3uA: mucks hand 
lrTLp1zpuCCs/e0pi2M8jw: shows [3c 3d] (two pair, Jacks and Threes)
lrTLp1zpuCCs/e0pi2M8jw collected $0.75 from pot
*** SUMMARY ***
Total pot $0.75 | Rake $0 
Board [9s Js Kh Jh 2c]
Seat 1: uYY6p3irj4hBN7IeHiNGSw folded before Flop (didn't bet)
Seat 3: tYsOBqdU1+x+yFI7zHO7hQ folded before Flop (didn't bet)
Seat 4: s7Q6uNouhe7aE8JdFb9E+A (button) folded before Flop (didn't bet)
Seat 5: cvtKnIIaTx2+P/KlOK+tfQ (small blind) showed [As 4d] and lost with a pair of Jacks
Seat 6: 7cv+9Zc9HIQHNvYsMfV3uA (big blind) mucked
Seat 7: s8SPJjToEJz2mPsHsMqL0A folded before Flop (didn't bet)
Seat 8: lrTLp1zpuCCs/e0pi2M8jw showed [3c 3d] and won ($0.75) with two pair, Jacks and Threes
Seat 9: SXqVW4Q0evTUVZG6BbUNIA folded before Flop (didn't bet)




PokerStars Game #59939722248:  Hold'em No Limit ($0.10/$0.25) - 2009/07/01 0:47:14 ET
Table 'mdub7rJf3Z5tCT9s/+1+Wg' 9-max Seat #6 is the button
Seat 1: neWdS67T0XWLJXFjrqXj5g ($15.15 in chips) 
Seat 3: t2nb95S5EEFOEzNx9Itz0g ($4.65 in chips) 
Seat 4: fDGyaQz0cs2s4FOYxkbIHA ($14.65 in chips) 
Seat 5: dfNim92Z6XK1/h5SFW5vDg ($25.45 in chips) 
Seat 6: hAFbY0iBwr4mouozgvjZBg ($46.35 in chips) 
Seat 7: woe+9KKk+L3pZgMTuHcmog ($34.80 in chips) 
Seat 8: 22dIObOuor/A+IKWkNoAlA ($5 in chips) 
Seat 9: tYsOBqdU1+x+yFI7zHO7hQ ($36.40 in chips) 
woe+9KKk+L3pZgMTuHcmog: posts small blind $0.10
22dIObOuor/A+IKWkNoAlA: posts big blind $0.25
*** HOLE CARDS ***
tYsOBqdU1+x+yFI7zHO7hQ: folds 
neWdS67T0XWLJXFjrqXj5g: calls $0.25
t2nb95S5EEFOEzNx9Itz0g: folds 
fDGyaQz0cs2s4FOYxkbIHA: folds 
dfNim92Z6XK1/h5SFW5vDg: folds 
hAFbY0iBwr4mouozgvjZBg: raises $0.50 to $0.75
woe+9KKk+L3pZgMTuHcmog: calls $0.65
22dIObOuor/A+IKWkNoAlA: folds 
neWdS67T0XWLJXFjrqXj5g: calls $0.50
*** FLOP *** [5c 8d 3c]
woe+9KKk+L3pZgMTuHcmog: checks 
neWdS67T0XWLJXFjrqXj5g: bets $1
hAFbY0iBwr4mouozgvjZBg: folds 
woe+9KKk+L3pZgMTuHcmog: calls $1
*** TURN *** [5c 8d 3c] [9d]
woe+9KKk+L3pZgMTuHcmog: checks 
neWdS67T0XWLJXFjrqXj5g: checks 
*** RIVER *** [5c 8d 3c 9d] [Kd]
woe+9KKk+L3pZgMTuHcmog: checks 
neWdS67T0XWLJXFjrqXj5g: checks 
*** SHOW DOWN ***
woe+9KKk+L3pZgMTuHcmog: shows [8s Ad] (a pair of Eights)
neWdS67T0XWLJXFjrqXj5g: mucks hand 
woe+9KKk+L3pZgMTuHcmog collected $4.30 from pot
*** SUMMARY ***
Total pot $4.50 | Rake $0.20 
Board [5c 8d 3c 9d Kd]
Seat 1: neWdS67T0XWLJXFjrqXj5g mucked
Seat 3: t2nb95S5EEFOEzNx9Itz0g folded before Flop (didn't bet)
Seat 4: fDGyaQz0cs2s4FOYxkbIHA folded before Flop (didn't bet)
Seat 5: dfNim92Z6XK1/h5SFW5vDg folded before Flop (didn't bet)
Seat 6: hAFbY0iBwr4mouozgvjZBg (button) folded on the Flop
Seat 7: woe+9KKk+L3pZgMTuHcmog (small blind) showed [8s Ad] and won ($4.30) with a pair of Eights
Seat 8: 22dIObOuor/A+IKWkNoAlA (big blind) folded before Flop
Seat 9: tYsOBqdU1+x+yFI7zHO7hQ folded before Flop (didn't bet)




PokerStars Game #59939722936:  Hold'em No Limit ($0.10/$0.25) - 2009/07/01 0:47:15 ET
Table 'u5gc8WdJbaPqEonQaM8rHA' 9-max Seat #5 is the button
Seat 1: rXm4QDVJt67H20lM6n6Z7Q ($8.35 in chips) 
Seat 4: 7Tiam59GaMYACH/my1qVuw ($24.65 in chips) 
Seat 5: 4y3ZJtAlW/aXjQX7SXyjrQ ($24.80 in chips) 
Seat 8: 9j9dK6T4bnFE4nxAg16ycg ($31.35 in chips) 
9j9dK6T4bnFE4nxAg16ycg: posts small blind $0.10
rXm4QDVJt67H20lM6n6Z7Q: posts big blind $0.25
r6hsffOo1iKmaPYKwAZmFw: sits out 
*** HOLE CARDS ***
7Tiam59GaMYACH/my1qVuw: folds 
4y3ZJtAlW/aXjQX7SXyjrQ: folds 
9j9dK6T4bnFE4nxAg16ycg: calls $0.15
rXm4QDVJt67H20lM6n6Z7Q: checks 
*** FLOP *** [8d 3c 3s]
9j9dK6T4bnFE4nxAg16ycg: bets $0.75
rXm4QDVJt67H20lM6n6Z7Q: calls $0.75
*** TURN *** [8d 3c 3s] [Ah]
9j9dK6T4bnFE4nxAg16ycg: bets $1
rXm4QDVJt67H20lM6n6Z7Q: raises $1 to $2
9j9dK6T4bnFE4nxAg16ycg: calls $1
*** RIVER *** [8d 3c 3s Ah] [7d]
POISSARE has returned
9j9dK6T4bnFE4nxAg16ycg: bets $1.50
rXm4QDVJt67H20lM6n6Z7Q: raises $3.85 to $5.35 and is all-in
9j9dK6T4bnFE4nxAg16ycg: calls $3.85
*** SHOW DOWN ***
rXm4QDVJt67H20lM6n6Z7Q: shows [4c 3h] (three of a kind, Threes)
9j9dK6T4bnFE4nxAg16ycg: mucks hand 
rXm4QDVJt67H20lM6n6Z7Q collected $15.90 from pot
*** SUMMARY ***
Total pot $16.70 | Rake $0.80 
Board [8d 3c 3s Ah 7d]
Seat 1: rXm4QDVJt67H20lM6n6Z7Q (big blind) showed [4c 3h] and won ($15.90) with three of a kind, Threes
Seat 4: 7Tiam59GaMYACH/my1qVuw folded before Flop (didn't bet)
Seat 5: 4y3ZJtAlW/aXjQX7SXyjrQ (button) folded before Flop (didn't bet)
Seat 8: 9j9dK6T4bnFE4nxAg16ycg (small blind) mucked




PokerStars Game #59939722802:  Hold'em No Limit ($0.10/$0.25) - 2009/07/01 0:47:15 ET
Table 'oxYpQNT8OHNCvpMIFi7UoA' 9-max Seat #2 is the button
Seat 1: H5Se03ZqSX7tbULXur2MAg ($24.65 in chips) 
Seat 2: Ofo77cVa49gHqAMfHrrMbw ($12.25 in chips) 
Seat 3: DBWHFmM+iV/PrUG8xKBQ7w ($8.65 in chips) 
Seat 4: ghNKXUBl/H+t83JF079ZBA ($25 in chips) 
Seat 5: SXqVW4Q0evTUVZG6BbUNIA ($34.15 in chips) 
Seat 6: +2kMBNpY4nF1qNCRd8SJLA ($25 in chips) 
Seat 7: yyG4svzOpC1A+sUP/scg6w ($8.30 in chips) 
Seat 8: OlPJsgR4xypSg/w1z7Gyvw ($19.20 in chips) 
Seat 9: KK7jFoJo1TzDCPdsfpPjtw ($41.15 in chips) 
DBWHFmM+iV/PrUG8xKBQ7w: posts small blind $0.10
ghNKXUBl/H+t83JF079ZBA: posts big blind $0.25
*** HOLE CARDS ***
SXqVW4Q0evTUVZG6BbUNIA: folds 
+2kMBNpY4nF1qNCRd8SJLA: folds 
yyG4svzOpC1A+sUP/scg6w: calls $0.25
OlPJsgR4xypSg/w1z7Gyvw: folds 
KK7jFoJo1TzDCPdsfpPjtw: folds 
H5Se03ZqSX7tbULXur2MAg: folds 
Ofo77cVa49gHqAMfHrrMbw: folds 
DBWHFmM+iV/PrUG8xKBQ7w: calls $0.15
ghNKXUBl/H+t83JF079ZBA: checks 
*** FLOP *** [Kh Qs 8s]
DBWHFmM+iV/PrUG8xKBQ7w: checks 
ghNKXUBl/H+t83JF079ZBA: checks 
yyG4svzOpC1A+sUP/scg6w: checks 
*** TURN *** [Kh Qs 8s] [6h]
DBWHFmM+iV/PrUG8xKBQ7w: bets $0.50
ghNKXUBl/H+t83JF079ZBA: folds 
yyG4svzOpC1A+sUP/scg6w: calls $0.50
*** RIVER *** [Kh Qs 8s 6h] [Jd]
DBWHFmM+iV/PrUG8xKBQ7w: bets $1
yyG4svzOpC1A+sUP/scg6w: folds 
Uncalled bet ($1) returned to DBWHFmM+iV/PrUG8xKBQ7w
DBWHFmM+iV/PrUG8xKBQ7w collected $1.70 from pot
*** SUMMARY ***
Total pot $1.75 | Rake $0.05 
Board [Kh Qs 8s 6h Jd]
Seat 1: H5Se03ZqSX7tbULXur2MAg folded before Flop (didn't bet)
Seat 2: Ofo77cVa49gHqAMfHrrMbw (button) folded before Flop (didn't bet)
Seat 3: DBWHFmM+iV/PrUG8xKBQ7w (small blind) collected ($1.70)
Seat 4: ghNKXUBl/H+t83JF079ZBA (big blind) folded on the Turn
Seat 5: SXqVW4Q0evTUVZG6BbUNIA folded before Flop (didn't bet)
Seat 6: +2kMBNpY4nF1qNCRd8SJLA folded before Flop (didn't bet)
Seat 7: yyG4svzOpC1A+sUP/scg6w folded on the River
Seat 8: OlPJsgR4xypSg/w1z7Gyvw folded before Flop (didn't bet)
Seat 9: KK7jFoJo1TzDCPdsfpPjtw folded before Flop (didn't bet)




PokerStars Game #59939722636:  Hold'em No Limit ($0.10/$0.25) - 2009/07/01 0:47:15 ET
Table 'sIHZ0lzLr4NGCaBUKhmYhAr562aMIMs5kgo28FEU6lkAax Seat #1 is the button
Seat 1: vZGoOTJLQLhkPj4I+LNGig ($31.45 in chips) 
Seat 2: N8muFAHrFHW6elSMGuyVLQ ($14.50 in chips) 
Seat 3: vX2B+8jhZFyBctQ3P4IKEw ($10.25 in chips) 
Seat 4: XBq1lBzax7LjRqdJP2TqWg ($11.60 in chips) 
Seat 5: zDrucyjVn5aeekNEc3cJrA ($37.30 in chips) 
Seat 6: rCaXm4/EwAgWqCiClpbsqQ ($25 in chips) 
Seat 7: R6nIVAjK7uhK3Hj0f85A+A ($18.35 in chips) 
Seat 8: B6xHiX1SJkS0CUNCKDVwuQ ($30.40 in chips) 
Seat 9: W4TLQcZ2TiM73eIgpIvlGg ($25.50 in chips) 
N8muFAHrFHW6elSMGuyVLQ: posts small blind $0.10
vX2B+8jhZFyBctQ3P4IKEw: posts big blind $0.25
*** HOLE CARDS ***
XBq1lBzax7LjRqdJP2TqWg: folds 
zDrucyjVn5aeekNEc3cJrA: folds 
rCaXm4/EwAgWqCiClpbsqQ: calls $0.25
R6nIVAjK7uhK3Hj0f85A+A: folds 
B6xHiX1SJkS0CUNCKDVwuQ: raises $0.75 to $1
W4TLQcZ2TiM73eIgpIvlGg: folds 
vZGoOTJLQLhkPj4I+LNGig: folds 
N8muFAHrFHW6elSMGuyVLQ: calls $0.90
vX2B+8jhZFyBctQ3P4IKEw: folds 
rCaXm4/EwAgWqCiClpbsqQ: calls $0.75
*** FLOP *** [Qc 5c Ac]
N8muFAHrFHW6elSMGuyVLQ: checks 
rCaXm4/EwAgWqCiClpbsqQ: bets $1
B6xHiX1SJkS0CUNCKDVwuQ: calls $1
N8muFAHrFHW6elSMGuyVLQ: folds 
*** TURN *** [Qc 5c Ac] [Qd]
rCaXm4/EwAgWqCiClpbsqQ: bets $1
B6xHiX1SJkS0CUNCKDVwuQ: raises $2.25 to $3.25
rCaXm4/EwAgWqCiClpbsqQ: calls $2.25
*** RIVER *** [Qc 5c Ac Qd] [Jd]
rCaXm4/EwAgWqCiClpbsqQ: checks 
B6xHiX1SJkS0CUNCKDVwuQ: bets $4.75
rCaXm4/EwAgWqCiClpbsqQ: calls $4.75
*** SHOW DOWN ***
B6xHiX1SJkS0CUNCKDVwuQ: shows [Kc Ks] (two pair, Kings and Queens)
rCaXm4/EwAgWqCiClpbsqQ: shows [8h Qs] (three of a kind, Queens)
rCaXm4/EwAgWqCiClpbsqQ collected $20.25 from pot
*** SUMMARY ***
Total pot $21.25 | Rake $1 
Board [Qc 5c Ac Qd Jd]
Seat 1: vZGoOTJLQLhkPj4I+LNGig (button) folded before Flop (didn't bet)
Seat 2: N8muFAHrFHW6elSMGuyVLQ (small blind) folded on the Flop
Seat 3: vX2B+8jhZFyBctQ3P4IKEw (big blind) folded before Flop
Seat 4: XBq1lBzax7LjRqdJP2TqWg folded before Flop (didn't bet)
Seat 5: zDrucyjVn5aeekNEc3cJrA folded before Flop (didn't bet)
Seat 6: rCaXm4/EwAgWqCiClpbsqQ showed [8h Qs] and won ($20.25) with three of a kind, Queens
Seat 7: R6nIVAjK7uhK3Hj0f85A+A folded before Flop (didn't bet)
Seat 8: B6xHiX1SJkS0CUNCKDVwuQ showed [Kc Ks] and lost with two pair, Kings and Queens
Seat 9: W4TLQcZ2TiM73eIgpIvlGg folded before Flop (didn't bet)




PokerStars Game #59939723308:  Hold'em No Limit ($0.10/$0.25) - 2009/07/01 0:47:16 ET
Table '9lYs7ljXi6AgFAxYHlKLJw' 9-max Seat #3 is the button
Seat 1: K0b5wNInj6hUGRr6yzKFtw ($25 in chips) 
Seat 2: N6fYvIzQLKaydFLKQGtMlQ ($21.75 in chips) 
Seat 3: DnDcAdn9P0zGovMERigpFA ($25 in chips) 
Seat 4: UANt6y/SmDCY/jIxkBixcw ($30.45 in chips) 
Seat 5: dfNim92Z6XK1/h5SFW5vDg ($55.20 in chips) 
Seat 7: ghNKXUBl/H+t83JF079ZBA ($28.75 in chips) 
Seat 8: 8GJHzzxiotOqC5gdtgpLoA ($5.90 in chips) 
Seat 9: 18G4P1XstjNvItdGUITxgw ($36.15 in chips) 
UANt6y/SmDCY/jIxkBixcw: posts small blind $0.10
dfNim92Z6XK1/h5SFW5vDg: posts big blind $0.25
tYsOBqdU1+x+yFI7zHO7hQ: sits out 
*** HOLE CARDS ***
ghNKXUBl/H+t83JF079ZBA: raises $0.75 to $1
8GJHzzxiotOqC5gdtgpLoA: folds 
18G4P1XstjNvItdGUITxgw: folds 
K0b5wNInj6hUGRr6yzKFtw: folds 
N6fYvIzQLKaydFLKQGtMlQ: folds 
DnDcAdn9P0zGovMERigpFA: folds 
UANt6y/SmDCY/jIxkBixcw: folds 
dfNim92Z6XK1/h5SFW5vDg: folds 
Uncalled bet ($0.75) returned to ghNKXUBl/H+t83JF079ZBA
ghNKXUBl/H+t83JF079ZBA collected $0.60 from pot
ghNKXUBl/H+t83JF079ZBA: doesn't show hand 
*** SUMMARY ***
Total pot $0.60 | Rake $0 
Seat 1: K0b5wNInj6hUGRr6yzKFtw folded before Flop (didn't bet)
Seat 2: N6fYvIzQLKaydFLKQGtMlQ folded before Flop (didn't bet)
Seat 3: DnDcAdn9P0zGovMERigpFA (button) folded before Flop (didn't bet)
Seat 4: UANt6y/SmDCY/jIxkBixcw (small blind) folded before Flop
Seat 5: dfNim92Z6XK1/h5SFW5vDg (big blind) folded before Flop
Seat 7: ghNKXUBl/H+t83JF079ZBA collected ($0.60)
Seat 8: 8GJHzzxiotOqC5gdtgpLoA folded before Flop (didn't bet)
Seat 9: 18G4P1XstjNvItdGUITxgw folded before Flop (didn't bet)




PokerStars Game #59939723632:  Hold'em No Limit ($0.10/$0.25) - 2009/07/01 0:47:16 ET
Table 'SbSV5tlgLp0+/Z+13PW3Hg' 9-max Seat #4 is the button
Seat 2: zDrucyjVn5aeekNEc3cJrA ($19 in chips) 
Seat 3: s7Q6uNouhe7aE8JdFb9E+A ($25.50 in chips) 
Seat 4: NNZypfH1f/VIj3Skf/XIzg ($4.65 in chips) 
Seat 5: z5GxcHlYz/GSz6W2uFiTtg ($19.35 in chips) 
Seat 6: qwr38jl5txoR36M7G5qi4A ($7.90 in chips) 
Seat 7: j4q3p0lesp63b1gZDwLBZw ($6.35 in chips) 
Seat 8: 7cv+9Zc9HIQHNvYsMfV3uA ($26.95 in chips) 
Seat 9: rXm4QDVJt67H20lM6n6Z7Q ($18.50 in chips) 
z5GxcHlYz/GSz6W2uFiTtg: posts small blind $0.10
qwr38jl5txoR36M7G5qi4A: posts big blind $0.25
7milehigh3: sits out 
*** HOLE CARDS ***
j4q3p0lesp63b1gZDwLBZw: folds 
7cv+9Zc9HIQHNvYsMfV3uA: folds 
rXm4QDVJt67H20lM6n6Z7Q: folds 
zDrucyjVn5aeekNEc3cJrA: folds 
s7Q6uNouhe7aE8JdFb9E+A: raises $0.50 to $0.75
NNZypfH1f/VIj3Skf/XIzg: folds 
z5GxcHlYz/GSz6W2uFiTtg: folds 
qwr38jl5txoR36M7G5qi4A: folds 
Uncalled bet ($0.50) returned to s7Q6uNouhe7aE8JdFb9E+A
s7Q6uNouhe7aE8JdFb9E+A collected $0.60 from pot
s7Q6uNouhe7aE8JdFb9E+A: doesn't show hand 
*** SUMMARY ***
Total pot $0.60 | Rake $0 
Seat 2: zDrucyjVn5aeekNEc3cJrA folded before Flop (didn't bet)
Seat 3: s7Q6uNouhe7aE8JdFb9E+A collected ($0.60)
Seat 4: NNZypfH1f/VIj3Skf/XIzg (button) folded before Flop (didn't bet)
Seat 5: z5GxcHlYz/GSz6W2uFiTtg (small blind) folded before Flop
Seat 6: qwr38jl5txoR36M7G5qi4A (big blind) folded before Flop
Seat 7: j4q3p0lesp63b1gZDwLBZw folded before Flop (didn't bet)
Seat 8: 7cv+9Zc9HIQHNvYsMfV3uA folded before Flop (didn't bet)
Seat 9: rXm4QDVJt67H20lM6n6Z7Q folded before Flop (didn't bet)




PokerStars Game #59939723560:  Hold'em No Limit ($0.10/$0.25) - 2009/07/01 0:47:16 ET
Table 'tErGGDyESv/0llKumVeZuQ' 9-max Seat #8 is the button
Seat 1: R3KkgiqTvuhazyCqaD9cZg ($11.75 in chips) 
Seat 3: CvL9Ch1HYCVbTsfpNucitg ($4.75 in chips) 
Seat 4: j1oAjkBBlFRUy+e+LF1vNQ ($8.35 in chips) 
Seat 5: le+pqvOEeS8Vvxt8ogLv/w ($10.90 in chips) 
Seat 6: zDrucyjVn5aeekNEc3cJrA ($29.25 in chips) 
Seat 7: s7Q6uNouhe7aE8JdFb9E+A ($25.30 in chips) 
Seat 8: Sv38qYH3jj8a8dddDi1aUA ($14.15 in chips) 
Seat 9: r284m4NA4rtNktI86R8/Yw ($13.30 in chips) 
r284m4NA4rtNktI86R8/Yw: posts small blind $0.10
R3KkgiqTvuhazyCqaD9cZg: posts big blind $0.25
V6p0jQ/RhUsqpHLmXvEX4Q: sits out 
*** HOLE CARDS ***
CvL9Ch1HYCVbTsfpNucitg: folds 
j1oAjkBBlFRUy+e+LF1vNQ: calls $0.25
le+pqvOEeS8Vvxt8ogLv/w: raises $1.25 to $1.50
zDrucyjVn5aeekNEc3cJrA: folds 
s7Q6uNouhe7aE8JdFb9E+A: folds 
Sv38qYH3jj8a8dddDi1aUA: folds 
r284m4NA4rtNktI86R8/Yw: folds 
R3KkgiqTvuhazyCqaD9cZg: folds 
j1oAjkBBlFRUy+e+LF1vNQ: calls $1.25
*** FLOP *** [6c Kd 4d]
j1oAjkBBlFRUy+e+LF1vNQ: checks 
le+pqvOEeS8Vvxt8ogLv/w: bets $2.75
j1oAjkBBlFRUy+e+LF1vNQ: calls $2.75
*** TURN *** [6c Kd 4d] [4h]
j1oAjkBBlFRUy+e+LF1vNQ: checks 
le+pqvOEeS8Vvxt8ogLv/w: bets $6.65 and is all-in
j1oAjkBBlFRUy+e+LF1vNQ: calls $4.10 and is all-in
Uncalled bet ($2.55) returned to le+pqvOEeS8Vvxt8ogLv/w
*** RIVER *** [6c Kd 4d 4h] [3h]
*** SHOW DOWN ***
j1oAjkBBlFRUy+e+LF1vNQ: shows [Ah 6d] (two pair, Sixes and Fours)
le+pqvOEeS8Vvxt8ogLv/w: shows [Ad Kh] (two pair, Kings and Fours)
le+pqvOEeS8Vvxt8ogLv/w collected $16.25 from pot
j1oAjkBBlFRUy+e+LF1vNQ leaves the table
*** SUMMARY ***
Total pot $17.05 | Rake $0.80 
Board [6c Kd 4d 4h 3h]
Seat 1: R3KkgiqTvuhazyCqaD9cZg (big blind) folded before Flop
Seat 3: CvL9Ch1HYCVbTsfpNucitg folded before Flop (didn't bet)
Seat 4: j1oAjkBBlFRUy+e+LF1vNQ showed [Ah 6d] and lost with two pair, Sixes and Fours
Seat 5: le+pqvOEeS8Vvxt8ogLv/w showed [Ad Kh] and won ($16.25) with two pair, Kings and Fours
Seat 6: zDrucyjVn5aeekNEc3cJrA folded before Flop (didn't bet)
Seat 7: s7Q6uNouhe7aE8JdFb9E+A folded before Flop (didn't bet)
Seat 8: Sv38qYH3jj8a8dddDi1aUA (button) folded before Flop (didn't bet)
Seat 9: r284m4NA4rtNktI86R8/Yw (small blind) folded before Flop




PokerStars Game #59939723746:  Hold'em No Limit ($0.10/$0.25) - 2009/07/01 0:47:16 ET
Table 'hOE09W281uSob0XeJmUcRg' 6-max Seat #2 is the button
Seat 1: edio/rLJ06xeZOfLhoL3UA ($29.75 in chips) 
Seat 2: GJsS3gwVwlbyroaWrnjqJg ($25.40 in chips) 
Seat 3: ZnMMHE6UGPdJdhLIYgoXfw ($25.30 in chips) 
Seat 4: TslQs7AQSLbVtr4X8JOOOQ ($19.20 in chips) 
Seat 5: 66a/8+qw1AZLNh63FuclPA ($83.95 in chips) 
ZnMMHE6UGPdJdhLIYgoXfw: posts small blind $0.10
TslQs7AQSLbVtr4X8JOOOQ: posts big blind $0.25
*** HOLE CARDS ***
66a/8+qw1AZLNh63FuclPA: folds 
x4ZJ8E/TUrtoB7WiHcv8WA has returned
edio/rLJ06xeZOfLhoL3UA: raises $1 to $1.25
GJsS3gwVwlbyroaWrnjqJg: folds 
ZnMMHE6UGPdJdhLIYgoXfw: folds 
TslQs7AQSLbVtr4X8JOOOQ: folds 
Uncalled bet ($1) returned to edio/rLJ06xeZOfLhoL3UA
edio/rLJ06xeZOfLhoL3UA collected $0.60 from pot
edio/rLJ06xeZOfLhoL3UA: doesn't show hand 
*** SUMMARY ***
Total pot $0.60 | Rake $0 
Seat 1: edio/rLJ06xeZOfLhoL3UA collected ($0.60)
Seat 2: GJsS3gwVwlbyroaWrnjqJg (button) folded before Flop (didn't bet)
Seat 3: ZnMMHE6UGPdJdhLIYgoXfw (small blind) folded before Flop
Seat 4: TslQs7AQSLbVtr4X8JOOOQ (big blind) folded before Flop
Seat 5: 66a/8+qw1AZLNh63FuclPA folded before Flop (didn't bet)




PokerStars Game #59939724344:  Hold'em No Limit ($0.10/$0.25) - 2009/07/01 0:47:17 ET
Table '3Ns9nuTkynfwbBfBXzg6ww' 6-max Seat #5 is the button
Seat 1: KDYsHh8K2SUXXDvLsAhbJQ ($8.40 in chips) 
Seat 3: HyXsCmHsOHAlL2pzZ9IYAg ($4.60 in chips) 
Seat 4: qGHGf/553gQnDoklMRe3tg ($22.15 in chips) 
Seat 5: kBQU/db00TVAMeomlhblPg ($17.70 in chips) 
Seat 6: ZZm/rg8aThjE+A2LiItuzA ($12.35 in chips) 
ZZm/rg8aThjE+A2LiItuzA: posts small blind $0.10
KDYsHh8K2SUXXDvLsAhbJQ: posts big blind $0.25
zxeVQGaMKDsDzmSY+AInjA: sits out 
*** HOLE CARDS ***
HyXsCmHsOHAlL2pzZ9IYAg: raises $0.25 to $0.50
qGHGf/553gQnDoklMRe3tg: folds 
kBQU/db00TVAMeomlhblPg: calls $0.50
ZZm/rg8aThjE+A2LiItuzA: calls $0.40
KDYsHh8K2SUXXDvLsAhbJQ: calls $0.25
*** FLOP *** [5c 6c 2s]
ZZm/rg8aThjE+A2LiItuzA: checks 
KDYsHh8K2SUXXDvLsAhbJQ: bets $0.25
HyXsCmHsOHAlL2pzZ9IYAg: raises $0.75 to $1
kBQU/db00TVAMeomlhblPg: folds 
ZZm/rg8aThjE+A2LiItuzA: folds 
KDYsHh8K2SUXXDvLsAhbJQ: calls $0.75
*** TURN *** [5c 6c 2s] [8s]
KDYsHh8K2SUXXDvLsAhbJQ: bets $0.50
HyXsCmHsOHAlL2pzZ9IYAg: calls $0.50
*** RIVER *** [5c 6c 2s 8s] [Kd]
KDYsHh8K2SUXXDvLsAhbJQ: bets $1
HyXsCmHsOHAlL2pzZ9IYAg: raises $1 to $2
KDYsHh8K2SUXXDvLsAhbJQ: calls $1
*** SHOW DOWN ***
HyXsCmHsOHAlL2pzZ9IYAg: shows [5s Ks] (two pair, Kings and Fives)
KDYsHh8K2SUXXDvLsAhbJQ: shows [8h 8d] (three of a kind, Eights)
KDYsHh8K2SUXXDvLsAhbJQ collected $8.60 from pot
*** SUMMARY ***
Total pot $9 | Rake $0.40 
Board [5c 6c 2s 8s Kd]
Seat 1: KDYsHh8K2SUXXDvLsAhbJQ (big blind) showed [8h 8d] and won ($8.60) with three of a kind, Eights
Seat 3: HyXsCmHsOHAlL2pzZ9IYAg showed [5s Ks] and lost with two pair, Kings and Fives
Seat 4: qGHGf/553gQnDoklMRe3tg folded before Flop (didn't bet)
Seat 5: kBQU/db00TVAMeomlhblPg (button) folded on the Flop
Seat 6: ZZm/rg8aThjE+A2LiItuzA (small blind) folded on the Flop




PokerStars Game #59939723992:  Hold'em No Limit ($0.10/$0.25) - 2009/07/01 0:47:17 ET
Table 'WEMI3Mtn7dGARDbgNrKibg' 9-max Seat #9 is the button
Seat 2: tYsOBqdU1+x+yFI7zHO7hQ ($46.30 in chips) 
Seat 3: jZaChyamGXWcP+qALPP5Jg ($29.45 in chips) 
Seat 4: yyG4svzOpC1A+sUP/scg6w ($7.25 in chips) 
Seat 6: VBHxUExRAMrbxUq/cVx9Gw ($4.65 in chips) 
Seat 7: DnDcAdn9P0zGovMERigpFA ($58.65 in chips) 
Seat 8: ghNKXUBl/H+t83JF079ZBA ($27.20 in chips) 
Seat 9: NTamLAiMZ86c5yM04t96LA ($56 in chips) 
tYsOBqdU1+x+yFI7zHO7hQ: posts small blind $0.10
jZaChyamGXWcP+qALPP5Jg: posts big blind $0.25
*** HOLE CARDS ***
yyG4svzOpC1A+sUP/scg6w: folds 
VBHxUExRAMrbxUq/cVx9Gw: folds 
7cv+9Zc9HIQHNvYsMfV3uA leaves the table
DnDcAdn9P0zGovMERigpFA: folds 
ghNKXUBl/H+t83JF079ZBA: folds 
NTamLAiMZ86c5yM04t96LA: calls $0.25
tYsOBqdU1+x+yFI7zHO7hQ: folds 
DlXs37dlX3tb7o/7lYXQSw joins the table at seat #1 
jZaChyamGXWcP+qALPP5Jg: checks 
*** FLOP *** [7h 6s Kh]
jZaChyamGXWcP+qALPP5Jg: checks 
NTamLAiMZ86c5yM04t96LA: checks 
*** TURN *** [7h 6s Kh] [5d]
jZaChyamGXWcP+qALPP5Jg: checks 
NTamLAiMZ86c5yM04t96LA: checks 
*** RIVER *** [7h 6s Kh 5d] [As]
jZaChyamGXWcP+qALPP5Jg: checks 
NTamLAiMZ86c5yM04t96LA: bets $0.25
jZaChyamGXWcP+qALPP5Jg: folds 
Uncalled bet ($0.25) returned to NTamLAiMZ86c5yM04t96LA
NTamLAiMZ86c5yM04t96LA collected $0.60 from pot
NTamLAiMZ86c5yM04t96LA: doesn't show hand 
*** SUMMARY ***
Total pot $0.60 | Rake $0 
Board [7h 6s Kh 5d As]
Seat 2: tYsOBqdU1+x+yFI7zHO7hQ (small blind) folded before Flop
Seat 3: jZaChyamGXWcP+qALPP5Jg (big blind) folded on the River
Seat 4: yyG4svzOpC1A+sUP/scg6w folded before Flop (didn't bet)
Seat 6: VBHxUExRAMrbxUq/cVx9Gw folded before Flop (didn't bet)
Seat 7: DnDcAdn9P0zGovMERigpFA folded before Flop (didn't bet)
Seat 8: ghNKXUBl/H+t83JF079ZBA folded before Flop (didn't bet)
Seat 9: NTamLAiMZ86c5yM04t96LA (button) collected ($0.60)




PokerStars Game #59939724118:  Hold'em No Limit ($0.10/$0.25) - 2009/07/01 0:47:17 ET
Table 'nyTW9cVtYentc5V7xU/0jA' 6-max Seat #4 is the button
Seat 1: YfxPRDAWfqnGBhiIEdlTYg ($9.90 in chips) 
Seat 2: 7FmwVDcdEtxDpHmP4hOXsQ ($26.40 in chips) 
Seat 3: kG34n23qFQA3nzdOJTQ1dA ($26.70 in chips) 
Seat 4: NkB3D4eVHHXvB9Edaugc1Q ($15.05 in chips) 
Seat 5: BedjMfrlRfPgSq7CXpPAmg ($30.10 in chips) 
Seat 6: dQJByDqHOLbgqX/HobyAJA ($3.80 in chips) 
BedjMfrlRfPgSq7CXpPAmg: posts small blind $0.10
dQJByDqHOLbgqX/HobyAJA: posts big blind $0.25
*** HOLE CARDS ***
YfxPRDAWfqnGBhiIEdlTYg: folds 
7FmwVDcdEtxDpHmP4hOXsQ: folds 
kG34n23qFQA3nzdOJTQ1dA: folds 
NkB3D4eVHHXvB9Edaugc1Q: raises $0.50 to $0.75
BedjMfrlRfPgSq7CXpPAmg: folds 
dQJByDqHOLbgqX/HobyAJA: folds 
Uncalled bet ($0.50) returned to NkB3D4eVHHXvB9Edaugc1Q
NkB3D4eVHHXvB9Edaugc1Q collected $0.60 from pot
NkB3D4eVHHXvB9Edaugc1Q: doesn't show hand 
*** SUMMARY ***
Total pot $0.60 | Rake $0 
Seat 1: YfxPRDAWfqnGBhiIEdlTYg folded before Flop (didn't bet)
Seat 2: 7FmwVDcdEtxDpHmP4hOXsQ folded before Flop (didn't bet)
Seat 3: kG34n23qFQA3nzdOJTQ1dA folded before Flop (didn't bet)
Seat 4: NkB3D4eVHHXvB9Edaugc1Q (button) collected ($0.60)
Seat 5: BedjMfrlRfPgSq7CXpPAmg (small blind) folded before Flop
Seat 6: dQJByDqHOLbgqX/HobyAJA (big blind) folded before Flop




PokerStars Game #59939724238:  Hold'em No Limit ($0.10/$0.25) - 2009/07/01 0:47:17 ET
Table 'VQNfcI8vTBCTvRfd3veTLQ' 6-max Seat #2 is the button
Seat 1: ymz+a8dgHSUFPooYplw7Ow ($24.55 in chips) 
Seat 2: KukIGupqqJCXA+Hp2bEFnA ($6.75 in chips) 
Seat 3: LtASJ9OlkqGrrUKGQlpGAw ($22.80 in chips) 
Seat 4: nc79pm0LZRdhncq55evVqA ($25 in chips) 
Seat 5: gX2vbKwS/8zZPENAWB7hxQ ($11.40 in chips) 
Seat 6: dlCLwmcvRShnuFDEVkdIEA ($12.25 in chips) 
LtASJ9OlkqGrrUKGQlpGAw: posts small blind $0.10
nc79pm0LZRdhncq55evVqA: posts big blind $0.25
*** HOLE CARDS ***
gX2vbKwS/8zZPENAWB7hxQ: folds 
dlCLwmcvRShnuFDEVkdIEA: folds 
ymz+a8dgHSUFPooYplw7Ow: raises $0.75 to $1
KukIGupqqJCXA+Hp2bEFnA: folds 
LtASJ9OlkqGrrUKGQlpGAw: folds 
nc79pm0LZRdhncq55evVqA: folds 
Uncalled bet ($0.75) returned to ymz+a8dgHSUFPooYplw7Ow
ymz+a8dgHSUFPooYplw7Ow collected $0.60 from pot
ymz+a8dgHSUFPooYplw7Ow: doesn't show hand 
*** SUMMARY ***
Total pot $0.60 | Rake $0 
Seat 1: ymz+a8dgHSUFPooYplw7Ow collected ($0.60)
Seat 2: KukIGupqqJCXA+Hp2bEFnA (button) folded before Flop (didn't bet)
Seat 3: LtASJ9OlkqGrrUKGQlpGAw (small blind) folded before Flop
Seat 4: nc79pm0LZRdhncq55evVqA (big blind) folded before Flop
Seat 5: gX2vbKwS/8zZPENAWB7hxQ folded before Flop (didn't bet)
Seat 6: dlCLwmcvRShnuFDEVkdIEA folded before Flop (didn't bet)




PokerStars Game #59939724430:  Hold'em No Limit ($0.10/$0.25) - 2009/07/01 0:47:17 ET
Table '8qKBgCRnebT9/IvA6SmaPw' 9-max Seat #9 is the button
Seat 1: GTcLfsDTPqgfHyhY9FNDMw ($10.95 in chips) 
Seat 3: V6p0jQ/RhUsqpHLmXvEX4Q ($12.35 in chips) 
Seat 4: rXm4QDVJt67H20lM6n6Z7Q ($8 in chips) 
Seat 5: uJlzv9KL7hgCIqIS2ofoaw ($12.90 in chips) 
Seat 6: z5GxcHlYz/GSz6W2uFiTtg ($25.15 in chips) 
Seat 7: UbybWqarUDNRYlbnju2UUQ ($27.05 in chips) 
Seat 8: M2aiKD/Q1d8lySUIbBxeGg ($27.05 in chips) 
Seat 9: MOlR9YEgKTKLerVIDf8U7w ($46.90 in chips) 
GTcLfsDTPqgfHyhY9FNDMw: posts small blind $0.10
SXqVW4Q0evTUVZG6BbUNIA: is sitting out 
SXqVW4Q0evTUVZG6BbUNIA leaves the table
V6p0jQ/RhUsqpHLmXvEX4Q: posts big blind $0.25
*** HOLE CARDS ***
rXm4QDVJt67H20lM6n6Z7Q: folds 
uJlzv9KL7hgCIqIS2ofoaw: folds 
nPydKI7KXtudhyCkYtLgZA joins the table at seat #2 
z5GxcHlYz/GSz6W2uFiTtg: folds 
UbybWqarUDNRYlbnju2UUQ: folds 
M2aiKD/Q1d8lySUIbBxeGg: folds 
MOlR9YEgKTKLerVIDf8U7w: folds 
GTcLfsDTPqgfHyhY9FNDMw: calls $0.15
V6p0jQ/RhUsqpHLmXvEX4Q: checks 
*** FLOP *** [5h Ac 8c]
GTcLfsDTPqgfHyhY9FNDMw: checks 
V6p0jQ/RhUsqpHLmXvEX4Q: checks 
*** TURN *** [5h Ac 8c] [Ts]
GTcLfsDTPqgfHyhY9FNDMw: checks 
V6p0jQ/RhUsqpHLmXvEX4Q: checks 
*** RIVER *** [5h Ac 8c Ts] [9s]
GTcLfsDTPqgfHyhY9FNDMw: bets $0.50
V6p0jQ/RhUsqpHLmXvEX4Q: folds 
Uncalled bet ($0.50) returned to GTcLfsDTPqgfHyhY9FNDMw
GTcLfsDTPqgfHyhY9FNDMw collected $0.50 from pot
GTcLfsDTPqgfHyhY9FNDMw: doesn't show hand 
*** SUMMARY ***
Total pot $0.50 | Rake $0 
Board [5h Ac 8c Ts 9s]
Seat 1: GTcLfsDTPqgfHyhY9FNDMw (small blind) collected ($0.50)
Seat 3: V6p0jQ/RhUsqpHLmXvEX4Q (big blind) folded on the River
Seat 4: rXm4QDVJt67H20lM6n6Z7Q folded before Flop (didn't bet)
Seat 5: uJlzv9KL7hgCIqIS2ofoaw folded before Flop (didn't bet)
Seat 6: z5GxcHlYz/GSz6W2uFiTtg folded before Flop (didn't bet)
Seat 7: UbybWqarUDNRYlbnju2UUQ folded before Flop (didn't bet)
Seat 8: M2aiKD/Q1d8lySUIbBxeGg folded before Flop (didn't bet)
Seat 9: MOlR9YEgKTKLerVIDf8U7w (button) folded before Flop (didn't bet)




PokerStars Game #59939723912:  Hold'em No Limit ($0.10/$0.25) - 2009/07/01 0:47:17 ET
Table '4hfTdIVT/qPsJNfWXLsVIw' 9-max Seat #4 is the button
Seat 1: GbHFBbLqLGz0Pwn6CJeAuw ($24.35 in chips) 
Seat 2: NB5rKy+grn9jKcWXclZ7WA ($32.15 in chips) 
Seat 3: opOCI2p6kW0tINuVaAqmcQ ($26.15 in chips) 
Seat 4: OiV1PWZ3IkN29JlmCcnTwQ ($4.80 in chips) 
Seat 6: VWUWpMLMj/Q1jRVpF7Aohw ($9.50 in chips) 
Seat 7: z5GxcHlYz/GSz6W2uFiTtg ($29.50 in chips) 
Seat 8: jiyia7h6fmxBdWBkH9lH5A ($9.85 in chips) 
Seat 9: K5byIbXY6S+c1wAeHitZow ($12.05 in chips) 
dtZ84flFEi4Q+SGrHMJRDQ will be allowed to play after the button
VWUWpMLMj/Q1jRVpF7Aohw: posts small blind $0.10
z5GxcHlYz/GSz6W2uFiTtg: posts big blind $0.25
*** HOLE CARDS ***
jiyia7h6fmxBdWBkH9lH5A: calls $0.25
K5byIbXY6S+c1wAeHitZow: folds 
GbHFBbLqLGz0Pwn6CJeAuw: raises $0.25 to $0.50
NB5rKy+grn9jKcWXclZ7WA: folds 
opOCI2p6kW0tINuVaAqmcQ: folds 
OiV1PWZ3IkN29JlmCcnTwQ: raises $0.50 to $1
VWUWpMLMj/Q1jRVpF7Aohw: folds 
z5GxcHlYz/GSz6W2uFiTtg: folds 
jiyia7h6fmxBdWBkH9lH5A: calls $0.75
GbHFBbLqLGz0Pwn6CJeAuw: calls $0.50
*** FLOP *** [5d 8c Kh]
jiyia7h6fmxBdWBkH9lH5A: checks 
GbHFBbLqLGz0Pwn6CJeAuw: checks 
OiV1PWZ3IkN29JlmCcnTwQ: bets $1.50
jiyia7h6fmxBdWBkH9lH5A: calls $1.50
GbHFBbLqLGz0Pwn6CJeAuw: folds 
*** TURN *** [5d 8c Kh] [8d]
jiyia7h6fmxBdWBkH9lH5A: bets $1
OiV1PWZ3IkN29JlmCcnTwQ: raises $1.30 to $2.30 and is all-in
jiyia7h6fmxBdWBkH9lH5A: calls $1.30
*** RIVER *** [5d 8c Kh 8d] [2c]
*** SHOW DOWN ***
jiyia7h6fmxBdWBkH9lH5A: shows [8h Ah] (three of a kind, Eights)
OiV1PWZ3IkN29JlmCcnTwQ: mucks hand 
jiyia7h6fmxBdWBkH9lH5A collected $10.45 from pot
*** SUMMARY ***
Total pot $10.95 | Rake $0.50 
Board [5d 8c Kh 8d 2c]
Seat 1: GbHFBbLqLGz0Pwn6CJeAuw folded on the Flop
Seat 2: NB5rKy+grn9jKcWXclZ7WA folded before Flop (didn't bet)
Seat 3: opOCI2p6kW0tINuVaAqmcQ folded before Flop (didn't bet)
Seat 4: OiV1PWZ3IkN29JlmCcnTwQ (button) mucked
Seat 6: VWUWpMLMj/Q1jRVpF7Aohw (small blind) folded before Flop
Seat 7: z5GxcHlYz/GSz6W2uFiTtg (big blind) folded before Flop
Seat 8: jiyia7h6fmxBdWBkH9lH5A showed [8h Ah] and won ($10.45) with three of a kind, Eights
Seat 9: K5byIbXY6S+c1wAeHitZow folded before Flop (didn't bet)




PokerStars Game #59939723884:  Hold'em No Limit ($0.10/$0.25) - 2009/07/01 0:47:17 ET
Table '7eunnLa5p3aGsPrUrNnn/A' 9-max Seat #5 is the button
Seat 2: aJy680tKSaP5er559aSuGA ($11.90 in chips) 
Seat 3: E0iYnEVO2ho7dH3QcCjw7g ($22.50 in chips) 
Seat 4: opOCI2p6kW0tINuVaAqmcQ ($27.85 in chips) 
Seat 5: JLfmdpDbz2ljMNE7ICboMQ ($7.35 in chips) 
Seat 6: jx9kXw1SAZrvXp9Nerz8+Q ($15.85 in chips) 
Seat 7: sD+TKtt36XiiN6jqHiLwDA ($23.40 in chips) 
Seat 8: 1Clf3cPrqoy/YgvWdWK1Xw ($5 in chips) 
Seat 9: rUpvA02nErFvZ4yFbDR8XA ($20.20 in chips) 
jx9kXw1SAZrvXp9Nerz8+Q: posts small blind $0.10
sD+TKtt36XiiN6jqHiLwDA: posts big blind $0.25
22dIObOuor/A+IKWkNoAlA: sits out 
*** HOLE CARDS ***
1Clf3cPrqoy/YgvWdWK1Xw: folds 
rUpvA02nErFvZ4yFbDR8XA: folds 
aJy680tKSaP5er559aSuGA: folds 
E0iYnEVO2ho7dH3QcCjw7g: folds 
opOCI2p6kW0tINuVaAqmcQ: folds 
JLfmdpDbz2ljMNE7ICboMQ: calls $0.25
jx9kXw1SAZrvXp9Nerz8+Q: folds 
sD+TKtt36XiiN6jqHiLwDA: checks 
*** FLOP *** [9d 9s Jd]
sD+TKtt36XiiN6jqHiLwDA: checks 
JLfmdpDbz2ljMNE7ICboMQ: bets $0.50
sD+TKtt36XiiN6jqHiLwDA: folds 
Uncalled bet ($0.50) returned to JLfmdpDbz2ljMNE7ICboMQ
JLfmdpDbz2ljMNE7ICboMQ collected $0.60 from pot
*** SUMMARY ***
Total pot $0.60 | Rake $0 
Board [9d 9s Jd]
Seat 2: aJy680tKSaP5er559aSuGA folded before Flop (didn't bet)
Seat 3: E0iYnEVO2ho7dH3QcCjw7g folded before Flop (didn't bet)
Seat 4: opOCI2p6kW0tINuVaAqmcQ folded before Flop (didn't bet)
Seat 5: JLfmdpDbz2ljMNE7ICboMQ (button) collected ($0.60)
Seat 6: jx9kXw1SAZrvXp9Nerz8+Q (small blind) folded before Flop
Seat 7: sD+TKtt36XiiN6jqHiLwDA (big blind) folded on the Flop
Seat 8: 1Clf3cPrqoy/YgvWdWK1Xw folded before Flop (didn't bet)
Seat 9: rUpvA02nErFvZ4yFbDR8XA folded before Flop (didn't bet)




PokerStars Game #59939724624:  Hold'em No Limit ($0.10/$0.25) - 2009/07/01 0:47:18 ET
Table 'NtCSSONEf1zaJo3042tQug' 6-max Seat #1 is the button
Seat 1: pdS3fOhVgLVaTP0O0GlIvw ($6.90 in chips) 
Seat 2: nbv8IVGAEHbfjk01ulU6ow ($21.40 in chips) 
Seat 3: d0J1xuhsynEY81YHwAvJ5g ($28.95 in chips) 
Seat 4: dOX4wnYV2sEqvDbF+8KSCw ($25 in chips) 
Seat 5: l/t3k8+r77gRew8U2BJs4Q ($9 in chips) 
Seat 6: LxehwDpTQ19ph4Qmc78+Pw ($17.15 in chips) 
nbv8IVGAEHbfjk01ulU6ow: posts small blind $0.10
d0J1xuhsynEY81YHwAvJ5g: posts big blind $0.25
*** HOLE CARDS ***
dOX4wnYV2sEqvDbF+8KSCw: raises $0.75 to $1
l/t3k8+r77gRew8U2BJs4Q: folds 
LxehwDpTQ19ph4Qmc78+Pw: folds 
pdS3fOhVgLVaTP0O0GlIvw: calls $1
nbv8IVGAEHbfjk01ulU6ow: calls $0.90
d0J1xuhsynEY81YHwAvJ5g: folds 
*** FLOP *** [3c 4h 9d]
nbv8IVGAEHbfjk01ulU6ow: checks 
dOX4wnYV2sEqvDbF+8KSCw: checks 
pdS3fOhVgLVaTP0O0GlIvw: checks 
*** TURN *** [3c 4h 9d] [3s]
nbv8IVGAEHbfjk01ulU6ow: checks 
dOX4wnYV2sEqvDbF+8KSCw: bets $2
pdS3fOhVgLVaTP0O0GlIvw: folds 
nbv8IVGAEHbfjk01ulU6ow: folds 
Uncalled bet ($2) returned to dOX4wnYV2sEqvDbF+8KSCw
dOX4wnYV2sEqvDbF+8KSCw collected $3.10 from pot
dOX4wnYV2sEqvDbF+8KSCw: doesn't show hand 
*** SUMMARY ***
Total pot $3.25 | Rake $0.15 
Board [3c 4h 9d 3s]
Seat 1: pdS3fOhVgLVaTP0O0GlIvw (button) folded on the Turn
Seat 2: nbv8IVGAEHbfjk01ulU6ow (small blind) folded on the Turn
Seat 3: d0J1xuhsynEY81YHwAvJ5g (big blind) folded before Flop
Seat 4: dOX4wnYV2sEqvDbF+8KSCw collected ($3.10)
Seat 5: l/t3k8+r77gRew8U2BJs4Q folded before Flop (didn't bet)
Seat 6: LxehwDpTQ19ph4Qmc78+Pw folded before Flop (didn't bet)




PokerStars Game #59939725058:  Hold'em No Limit ($0.10/$0.25) - 2009/07/01 0:47:18 ET
Table 'Qk/910N2Yhg8u5vqTJk50Q' 9-max Seat #3 is the button
Seat 1: zDrucyjVn5aeekNEc3cJrA ($24.75 in chips) 
Seat 2: Th3FldXKQW6hWVVPahaoOQ ($37.70 in chips) 
Seat 3: ghNKXUBl/H+t83JF079ZBA ($25 in chips) 
Seat 5: 4oA316mXLIui1QY63GXBUg ($26.75 in chips) 
Seat 6: Uupj2MGlo48VpA/VyYrfrw ($7.15 in chips) 
Seat 8: H5Se03ZqSX7tbULXur2MAg ($25.50 in chips) 
Seat 9: M2QO2DxB5Wawg2h8HSpnYA ($18.55 in chips) 
4oA316mXLIui1QY63GXBUg: posts small blind $0.10
Uupj2MGlo48VpA/VyYrfrw: posts big blind $0.25
aNpwfA31EREwO+ar4XzBCw: sits out 
*** HOLE CARDS ***
H5Se03ZqSX7tbULXur2MAg: folds 
33y9+GmQ3J84RvZXcraRTw leaves the table
M2QO2DxB5Wawg2h8HSpnYA: folds 
zDrucyjVn5aeekNEc3cJrA: folds 
Th3FldXKQW6hWVVPahaoOQ: folds 
ghNKXUBl/H+t83JF079ZBA: folds 
4oA316mXLIui1QY63GXBUg: folds 
Uncalled bet ($0.15) returned to Uupj2MGlo48VpA/VyYrfrw
Uupj2MGlo48VpA/VyYrfrw collected $0.20 from pot
Uupj2MGlo48VpA/VyYrfrw: shows [Td 9c] (high card Ten)
*** SUMMARY ***
Total pot $0.20 | Rake $0 
Seat 1: zDrucyjVn5aeekNEc3cJrA folded before Flop (didn't bet)
Seat 2: Th3FldXKQW6hWVVPahaoOQ folded before Flop (didn't bet)
Seat 3: ghNKXUBl/H+t83JF079ZBA (button) folded before Flop (didn't bet)
Seat 5: 4oA316mXLIui1QY63GXBUg (small blind) folded before Flop
Seat 6: Uupj2MGlo48VpA/VyYrfrw (big blind) collected ($0.20)
Seat 8: H5Se03ZqSX7tbULXur2MAg folded before Flop (didn't bet)
Seat 9: M2QO2DxB5Wawg2h8HSpnYA folded before Flop (didn't bet)




PokerStars Game #59939725512:  Hold'em No Limit ($0.10/$0.25) - 2009/07/01 0:47:19 ET
Table 'Jz+kWRxWNGk9w24fdQEveA' 9-max Seat #4 is the button
Seat 2: ljemhp25Zg+nlA9DLCIiUw ($31.45 in chips) 
Seat 3: uwmAXQRjyA4iX5kaC15P9A ($4.65 in chips) 
Seat 4: HPEB+AtKw1+C/cxU0o1ciw ($23.95 in chips) 
Seat 5: DdPXdieucQ+n99u1n3A+rQ ($4.75 in chips) 
Seat 6: boms8cM+kQJF0xGLbvuFtg ($8.65 in chips) 
Seat 7: st9jtdNbm1W5GfBwRaCVqQ ($30.35 in chips) 
Seat 8: G7adEXZse2f4gqTWfn/C+Q ($11.65 in chips) 
DdPXdieucQ+n99u1n3A+rQ: posts small blind $0.10
boms8cM+kQJF0xGLbvuFtg: posts big blind $0.25
V6p0jQ/RhUsqpHLmXvEX4Q: sits out 
*** HOLE CARDS ***
st9jtdNbm1W5GfBwRaCVqQ: folds 
G7adEXZse2f4gqTWfn/C+Q: folds 
ljemhp25Zg+nlA9DLCIiUw: folds 
uwmAXQRjyA4iX5kaC15P9A: folds 
st9jtdNbm1W5GfBwRaCVqQ is sitting out
HPEB+AtKw1+C/cxU0o1ciw: folds 
DdPXdieucQ+n99u1n3A+rQ: raises $0.50 to $0.75
boms8cM+kQJF0xGLbvuFtg: calls $0.50
*** FLOP *** [As Qs 5c]
DdPXdieucQ+n99u1n3A+rQ: bets $1
boms8cM+kQJF0xGLbvuFtg: raises $6.90 to $7.90 and is all-in
DdPXdieucQ+n99u1n3A+rQ: calls $3 and is all-in
Uncalled bet ($3.90) returned to boms8cM+kQJF0xGLbvuFtg
*** TURN *** [As Qs 5c] [7s]
*** RIVER *** [As Qs 5c 7s] [Kc]
*** SHOW DOWN ***
DdPXdieucQ+n99u1n3A+rQ: shows [Qc Tc] (a pair of Queens)
boms8cM+kQJF0xGLbvuFtg: mucks hand 
DdPXdieucQ+n99u1n3A+rQ collected $9.05 from pot
*** SUMMARY ***
Total pot $9.50 | Rake $0.45 
Board [As Qs 5c 7s Kc]
Seat 2: ljemhp25Zg+nlA9DLCIiUw folded before Flop (didn't bet)
Seat 3: uwmAXQRjyA4iX5kaC15P9A folded before Flop (didn't bet)
Seat 4: HPEB+AtKw1+C/cxU0o1ciw (button) folded before Flop (didn't bet)
Seat 5: DdPXdieucQ+n99u1n3A+rQ (small blind) showed [Qc Tc] and won ($9.05) with a pair of Queens
Seat 6: boms8cM+kQJF0xGLbvuFtg (big blind) mucked
Seat 7: st9jtdNbm1W5GfBwRaCVqQ folded before Flop (didn't bet)
Seat 8: G7adEXZse2f4gqTWfn/C+Q folded before Flop (didn't bet)




PokerStars Game #59939725296:  Hold'em No Limit ($0.10/$0.25) - 2009/07/01 0:47:19 ET
Table 'M7d9IrgQUUFFy/SZ3ksLYg' 6-max Seat #4 is the button
Seat 1: cPO/1/dTcZpLkQFm3jH3Rg ($43.10 in chips) 
Seat 2: JE/wJXmjw3bpdmjwvh2pcg ($31.20 in chips) 
Seat 4: 7FmwVDcdEtxDpHmP4hOXsQ ($29.40 in chips) 
Seat 5: nc79pm0LZRdhncq55evVqA ($25 in chips) 
Seat 6: /gJNBeCkWL4o85/jvlZ4BA ($25 in chips) 
nc79pm0LZRdhncq55evVqA: posts small blind $0.10
/gJNBeCkWL4o85/jvlZ4BA: posts big blind $0.25
*** HOLE CARDS ***
DXgVFTcE3WofABsNJ5G/nw joins the table at seat #3 
cPO/1/dTcZpLkQFm3jH3Rg: folds 
JE/wJXmjw3bpdmjwvh2pcg: folds 
7FmwVDcdEtxDpHmP4hOXsQ: raises $0.50 to $0.75
nc79pm0LZRdhncq55evVqA: folds 
/gJNBeCkWL4o85/jvlZ4BA: folds 
Uncalled bet ($0.50) returned to 7FmwVDcdEtxDpHmP4hOXsQ
7FmwVDcdEtxDpHmP4hOXsQ collected $0.60 from pot
7FmwVDcdEtxDpHmP4hOXsQ: doesn't show hand 
*** SUMMARY ***
Total pot $0.60 | Rake $0 
Seat 1: cPO/1/dTcZpLkQFm3jH3Rg folded before Flop (didn't bet)
Seat 2: JE/wJXmjw3bpdmjwvh2pcg folded before Flop (didn't bet)
Seat 4: 7FmwVDcdEtxDpHmP4hOXsQ (button) collected ($0.60)
Seat 5: nc79pm0LZRdhncq55evVqA (small blind) folded before Flop
Seat 6: /gJNBeCkWL4o85/jvlZ4BA (big blind) folded before Flop




PokerStars Game #59939725622:  Hold'em No Limit ($0.10/$0.25) - 2009/07/01 0:47:19 ET
Table 'g6ryG70feTw9nNm+XJLuXw' 6-max Seat #4 is the button
Seat 1: v+QfkGiuj9bgtuNoVnDO8w ($26.40 in chips) 
Seat 2: SxIIgwXYLkwd6m3wLyPTCw ($26.45 in chips) 
Seat 3: /6h8PvAHQmfuMUZ8OUF6Xw ($18.65 in chips) 
Seat 4: GC/9yVD59DUCX7hUI7gcLw ($40 in chips) 
Seat 5: EE16Ua5b1HSsYej5zeXOlA ($31.20 in chips) 
EE16Ua5b1HSsYej5zeXOlA: posts small blind $0.10
v+QfkGiuj9bgtuNoVnDO8w: posts big blind $0.25
*** HOLE CARDS ***
SxIIgwXYLkwd6m3wLyPTCw: raises $0.50 to $0.75
/6h8PvAHQmfuMUZ8OUF6Xw: folds 
GC/9yVD59DUCX7hUI7gcLw: folds 
EE16Ua5b1HSsYej5zeXOlA: folds 
v+QfkGiuj9bgtuNoVnDO8w: raises $2 to $2.75
SxIIgwXYLkwd6m3wLyPTCw: folds 
Uncalled bet ($2) returned to v+QfkGiuj9bgtuNoVnDO8w
v+QfkGiuj9bgtuNoVnDO8w collected $1.60 from pot
v+QfkGiuj9bgtuNoVnDO8w: doesn't show hand 
*** SUMMARY ***
Total pot $1.60 | Rake $0 
Seat 1: v+QfkGiuj9bgtuNoVnDO8w (big blind) collected ($1.60)
Seat 2: SxIIgwXYLkwd6m3wLyPTCw folded before Flop
Seat 3: /6h8PvAHQmfuMUZ8OUF6Xw folded before Flop (didn't bet)
Seat 4: GC/9yVD59DUCX7hUI7gcLw (button) folded before Flop (didn't bet)
Seat 5: EE16Ua5b1HSsYej5zeXOlA (small blind) folded before Flop




PokerStars Game #59939725166:  Hold'em No Limit ($0.10/$0.25) - 2009/07/01 0:47:19 ET
Table 'vFZR6Kf2Th5xBXT9brGW6A' 6-max Seat #1 is the button
Seat 1: xRkU4+naLuz7dEZFbOn9cw ($29.25 in chips) 
Seat 3: wUwfsTnmpHcWa17qFlQr1Q ($5.35 in chips) 
Seat 4: 79ID/ub1Pt/mDpCprVmOoA ($25.40 in chips) 
Seat 5: NhUN/JpAprdJeamFBgJH1w ($31.65 in chips) 
Seat 6: d0J1xuhsynEY81YHwAvJ5g ($29.75 in chips) 
wUwfsTnmpHcWa17qFlQr1Q: posts small blind $0.10
79ID/ub1Pt/mDpCprVmOoA: posts big blind $0.25
*** HOLE CARDS ***
NhUN/JpAprdJeamFBgJH1w: folds 
d0J1xuhsynEY81YHwAvJ5g: folds 
xRkU4+naLuz7dEZFbOn9cw: folds 
wUwfsTnmpHcWa17qFlQr1Q: calls $0.15
79ID/ub1Pt/mDpCprVmOoA: checks 
*** FLOP *** [2c Td 2d]
wUwfsTnmpHcWa17qFlQr1Q: checks 
79ID/ub1Pt/mDpCprVmOoA: bets $0.50
wUwfsTnmpHcWa17qFlQr1Q: folds 
Uncalled bet ($0.50) returned to 79ID/ub1Pt/mDpCprVmOoA
79ID/ub1Pt/mDpCprVmOoA collected $0.50 from pot
79ID/ub1Pt/mDpCprVmOoA: doesn't show hand 
*** SUMMARY ***
Total pot $0.50 | Rake $0 
Board [2c Td 2d]
Seat 1: xRkU4+naLuz7dEZFbOn9cw (button) folded before Flop (didn't bet)
Seat 3: wUwfsTnmpHcWa17qFlQr1Q (small blind) folded on the Flop
Seat 4: 79ID/ub1Pt/mDpCprVmOoA (big blind) collected ($0.50)
Seat 5: NhUN/JpAprdJeamFBgJH1w folded before Flop (didn't bet)
Seat 6: d0J1xuhsynEY81YHwAvJ5g folded before Flop (didn't bet)




PokerStars Game #59939725300:  Hold'em No Limit ($0.10/$0.25) - 2009/07/01 0:47:19 ET
Table 'ER5H84HUgJx7HyDLnELLeA' 6-max Seat #6 is the button
Seat 1: pjM/xh4+RG8zrxCobDgYDg ($16.80 in chips) 
Seat 2: nc79pm0LZRdhncq55evVqA ($48.50 in chips) 
Seat 3: BYxjLnV1/LL0aZcTbfAOvw ($25 in chips) 
Seat 4: tkRWn3WaJIfGmCXT2hPvJA ($18.40 in chips) 
Seat 5: mfrkWA3PTeYPkbO6hi98Aw ($25.25 in chips) 
Seat 6: 3zD3qLXT1bEffAoWGnc7wg ($30.85 in chips) 
pjM/xh4+RG8zrxCobDgYDg: posts small blind $0.10
nc79pm0LZRdhncq55evVqA: posts big blind $0.25
*** HOLE CARDS ***
BYxjLnV1/LL0aZcTbfAOvw: folds 
tkRWn3WaJIfGmCXT2hPvJA: folds 
mfrkWA3PTeYPkbO6hi98Aw: folds 
3zD3qLXT1bEffAoWGnc7wg: folds 
pjM/xh4+RG8zrxCobDgYDg: folds 
Uncalled bet ($0.15) returned to nc79pm0LZRdhncq55evVqA
nc79pm0LZRdhncq55evVqA collected $0.20 from pot
nc79pm0LZRdhncq55evVqA: doesn't show hand 
*** SUMMARY ***
Total pot $0.20 | Rake $0 
Seat 1: pjM/xh4+RG8zrxCobDgYDg (small blind) folded before Flop
Seat 2: nc79pm0LZRdhncq55evVqA (big blind) collected ($0.20)
Seat 3: BYxjLnV1/LL0aZcTbfAOvw folded before Flop (didn't bet)
Seat 4: tkRWn3WaJIfGmCXT2hPvJA folded before Flop (didn't bet)
Seat 5: mfrkWA3PTeYPkbO6hi98Aw folded before Flop (didn't bet)
Seat 6: 3zD3qLXT1bEffAoWGnc7wg (button) folded before Flop (didn't bet)




PokerStars Game #59939725626:  Hold'em No Limit ($0.10/$0.25) - 2009/07/01 0:47:19 ET
Table 'MRfAiS/4JSfnUDlCcZo0wAhfHe8uKeSJMyWAjSdM7ROQx Seat #2 is the button
Seat 1: 48oT5xFI+5CHUJlfoGrE4w ($18.05 in chips) 
Seat 2: /gJNBeCkWL4o85/jvlZ4BA ($34.70 in chips) 
Seat 3: FYepjhAvF8ZdVCmqHIy+eQ ($44.90 in chips) 
Seat 4: Go8clNIDGP3feVvzBDG4pg ($12.65 in chips) 
Seat 5: qccGLncfUaN00Few5HsgYg ($29.35 in chips) 
Seat 6: VaDPspfGS2lnEkaGNrNqfg ($12.90 in chips) 
FYepjhAvF8ZdVCmqHIy+eQ: posts small blind $0.10
Go8clNIDGP3feVvzBDG4pg: posts big blind $0.25
*** HOLE CARDS ***
qccGLncfUaN00Few5HsgYg: raises $0.75 to $1
VaDPspfGS2lnEkaGNrNqfg: folds 
48oT5xFI+5CHUJlfoGrE4w: folds 
/gJNBeCkWL4o85/jvlZ4BA: folds 
FYepjhAvF8ZdVCmqHIy+eQ: folds 
Go8clNIDGP3feVvzBDG4pg: folds 
Uncalled bet ($0.75) returned to qccGLncfUaN00Few5HsgYg
qccGLncfUaN00Few5HsgYg collected $0.60 from pot
*** SUMMARY ***
Total pot $0.60 | Rake $0 
Seat 1: 48oT5xFI+5CHUJlfoGrE4w folded before Flop (didn't bet)
Seat 2: /gJNBeCkWL4o85/jvlZ4BA (button) folded before Flop (didn't bet)
Seat 3: FYepjhAvF8ZdVCmqHIy+eQ (small blind) folded before Flop
Seat 4: Go8clNIDGP3feVvzBDG4pg (big blind) folded before Flop
Seat 5: qccGLncfUaN00Few5HsgYg collected ($0.60)
Seat 6: VaDPspfGS2lnEkaGNrNqfg folded before Flop (didn't bet)




PokerStars Game #59939725392:  Hold'em No Limit ($0.10/$0.25) - 2009/07/01 0:47:19 ET
Table 'rjcb+nlE+0GuJ6lBhuCkkA' 6-max Seat #2 is the button
Seat 1: 9jSiy0meE9XJKkdIZwyTEQ ($27.80 in chips) 
Seat 2: lJphax9e7/+O/3YCKPJ0yQ ($10 in chips) 
Seat 3: 8ClCHtFXGNplITm+63KB+Q ($36.65 in chips) 
Seat 4: NzIFHwilc5zU7QhjDTgTZA ($5.60 in chips) 
Seat 5: GC/9yVD59DUCX7hUI7gcLw ($31.50 in chips) 
Seat 6: 0DvgWV5o6c/jYqQCjm4Haw ($33.30 in chips) 
8ClCHtFXGNplITm+63KB+Q: posts small blind $0.10
NzIFHwilc5zU7QhjDTgTZA: posts big blind $0.25
*** HOLE CARDS ***
GC/9yVD59DUCX7hUI7gcLw: folds 
0DvgWV5o6c/jYqQCjm4Haw: folds 
9jSiy0meE9XJKkdIZwyTEQ: folds 
lJphax9e7/+O/3YCKPJ0yQ: calls $0.25
8ClCHtFXGNplITm+63KB+Q: folds 
NzIFHwilc5zU7QhjDTgTZA: checks 
*** FLOP *** [As Qs Jc]
NzIFHwilc5zU7QhjDTgTZA: checks 
lJphax9e7/+O/3YCKPJ0yQ: bets $0.50
NzIFHwilc5zU7QhjDTgTZA: calls $0.50
*** TURN *** [As Qs Jc] [3h]
NzIFHwilc5zU7QhjDTgTZA: checks 
lJphax9e7/+O/3YCKPJ0yQ: checks 
*** RIVER *** [As Qs Jc 3h] [6d]
NzIFHwilc5zU7QhjDTgTZA: checks 
lJphax9e7/+O/3YCKPJ0yQ: checks 
*** SHOW DOWN ***
NzIFHwilc5zU7QhjDTgTZA: shows [Tc 9d] (high card Ace)
lJphax9e7/+O/3YCKPJ0yQ: shows [Ts 6h] (a pair of Sixes)
lJphax9e7/+O/3YCKPJ0yQ collected $1.55 from pot
*** SUMMARY ***
Total pot $1.60 | Rake $0.05 
Board [As Qs Jc 3h 6d]
Seat 1: 9jSiy0meE9XJKkdIZwyTEQ folded before Flop (didn't bet)
Seat 2: lJphax9e7/+O/3YCKPJ0yQ (button) showed [Ts 6h] and won ($1.55) with a pair of Sixes
Seat 3: 8ClCHtFXGNplITm+63KB+Q (small blind) folded before Flop
Seat 4: NzIFHwilc5zU7QhjDTgTZA (big blind) showed [Tc 9d] and lost with high card Ace
Seat 5: GC/9yVD59DUCX7hUI7gcLw folded before Flop (didn't bet)
Seat 6: 0DvgWV5o6c/jYqQCjm4Haw folded before Flop (didn't bet)




PokerStars Game #59939725490:  Hold'em No Limit ($0.10/$0.25) - 2009/07/01 0:47:19 ET
Table 'Xi38lWH8L2JHRAsKYVX8Qg' 6-max Seat #1 is the button
Seat 1: AqQ7DFpHkgIzTwDu+rClcg ($5.40 in chips) 
Seat 2: 7iL6KfkJTFbyWmnLYk4+AA ($31.80 in chips) 
Seat 3: 6DwBRH+xZ12AAZmeAg+aXw ($25 in chips) 
Seat 4: kG34n23qFQA3nzdOJTQ1dA ($25.80 in chips) 
Seat 5: 79ID/ub1Pt/mDpCprVmOoA ($25.75 in chips) 
Seat 6: aogAb4Eienxztk8p2v9VVw ($24.75 in chips) 
7iL6KfkJTFbyWmnLYk4+AA: posts small blind $0.10
6DwBRH+xZ12AAZmeAg+aXw: posts big blind $0.25
*** HOLE CARDS ***
kG34n23qFQA3nzdOJTQ1dA: folds 
79ID/ub1Pt/mDpCprVmOoA: folds 
aogAb4Eienxztk8p2v9VVw: folds 
AqQ7DFpHkgIzTwDu+rClcg: folds 
7iL6KfkJTFbyWmnLYk4+AA: calls $0.15
6DwBRH+xZ12AAZmeAg+aXw: checks 
*** FLOP *** [7h 7c Ks]
7iL6KfkJTFbyWmnLYk4+AA: bets $0.50
6DwBRH+xZ12AAZmeAg+aXw: folds 
Uncalled bet ($0.50) returned to 7iL6KfkJTFbyWmnLYk4+AA
7iL6KfkJTFbyWmnLYk4+AA collected $0.50 from pot
*** SUMMARY ***
Total pot $0.50 | Rake $0 
Board [7h 7c Ks]
Seat 1: AqQ7DFpHkgIzTwDu+rClcg (button) folded before Flop (didn't bet)
Seat 2: 7iL6KfkJTFbyWmnLYk4+AA (small blind) collected ($0.50)
Seat 3: 6DwBRH+xZ12AAZmeAg+aXw (big blind) folded on the Flop
Seat 4: kG34n23qFQA3nzdOJTQ1dA folded before Flop (didn't bet)
Seat 5: 79ID/ub1Pt/mDpCprVmOoA folded before Flop (didn't bet)
Seat 6: aogAb4Eienxztk8p2v9VVw folded before Flop (didn't bet)




PokerStars Game #59939725344:  Hold'em No Limit ($0.10/$0.25) - 2009/07/01 0:47:19 ET
Table 'BabJGL6tfXQp3leBGbYe8A' 9-max Seat #2 is the button
Seat 1: qwr38jl5txoR36M7G5qi4A ($7.50 in chips) 
Seat 2: G5EFgY1bi50mF1iH/+B4yQ ($10.20 in chips) 
Seat 3: Jdj7AsGFrlkCgDXeWK322A ($26.20 in chips) 
Seat 4: Yk91gygnxgAKPGHZ/jPVSw ($8.70 in chips) 
Seat 5: fKqW4kzqpoOv+YKE5kp3FA ($2.80 in chips) 
Seat 6: ELKIDQ6mBSQJr3wiHYHtvw ($6.90 in chips) 
Seat 8: TJEefy+0K5gBV+8LA5OK7Q ($25 in chips) 
Seat 9: xEQxarad8/T4jJdpZy5LGw ($10.10 in chips) 
Jdj7AsGFrlkCgDXeWK322A: posts small blind $0.10
Yk91gygnxgAKPGHZ/jPVSw: posts big blind $0.25
st9jtdNbm1W5GfBwRaCVqQ: sits out 
*** HOLE CARDS ***
fKqW4kzqpoOv+YKE5kp3FA: folds 
ELKIDQ6mBSQJr3wiHYHtvw: folds 
TJEefy+0K5gBV+8LA5OK7Q: folds 
xEQxarad8/T4jJdpZy5LGw: folds 
qwr38jl5txoR36M7G5qi4A: folds 
G5EFgY1bi50mF1iH/+B4yQ: folds 
Jdj7AsGFrlkCgDXeWK322A: folds 
Uncalled bet ($0.15) returned to Yk91gygnxgAKPGHZ/jPVSw
Yk91gygnxgAKPGHZ/jPVSw collected $0.20 from pot
*** SUMMARY ***
Total pot $0.20 | Rake $0 
Seat 1: qwr38jl5txoR36M7G5qi4A folded before Flop (didn't bet)
Seat 2: G5EFgY1bi50mF1iH/+B4yQ (button) folded before Flop (didn't bet)
Seat 3: Jdj7AsGFrlkCgDXeWK322A (small blind) folded before Flop
Seat 4: Yk91gygnxgAKPGHZ/jPVSw (big blind) collected ($0.20)
Seat 5: fKqW4kzqpoOv+YKE5kp3FA folded before Flop (didn't bet)
Seat 6: ELKIDQ6mBSQJr3wiHYHtvw folded before Flop (didn't bet)
Seat 8: TJEefy+0K5gBV+8LA5OK7Q folded before Flop (didn't bet)
Seat 9: xEQxarad8/T4jJdpZy5LGw folded before Flop (didn't bet)




PokerStars Game #59939725314:  Hold'em No Limit ($0.10/$0.25) - 2009/07/01 0:47:19 ET
Table 'ZiwAqg4o02gNro+JOAaFNg6wawJ+MkkvuC3coG6r+YhgSeat #3 is the button
Seat 2: tYsOBqdU1+x+yFI7zHO7hQ ($29.45 in chips) 
Seat 3: aNpwfA31EREwO+ar4XzBCw ($25 in chips) 
Seat 4: FJflwqC6fqOpM3j0q8Bptw ($24.10 in chips) 
Seat 5: 5hAPbqNrvJb8PtLiceXtlg6HoFYfVGBefsR5Vrz62qIw9.15 in chips) 
Seat 6: hBMUlEpyU74r/fwDgIpXjQ ($27.95 in chips) 
Seat 7: opOCI2p6kW0tINuVaAqmcQ ($25 in chips) 
Seat 8: CYkY0dNBaYaKs8HVCVn3mQ ($5 in chips) 
Seat 9: ljemhp25Zg+nlA9DLCIiUw ($24.65 in chips) 
FJflwqC6fqOpM3j0q8Bptw: posts small blind $0.10
5hAPbqNrvJb8PtLiceXtlg6HoFYfVGBefsR5Vrz62qIwsts big blind $0.25
6RiVTYll/5D8zICp0MRpKw: sits out 
*** HOLE CARDS ***
hBMUlEpyU74r/fwDgIpXjQ: folds 
opOCI2p6kW0tINuVaAqmcQ: folds 
CYkY0dNBaYaKs8HVCVn3mQ: folds 
ljemhp25Zg+nlA9DLCIiUw: folds 
tYsOBqdU1+x+yFI7zHO7hQ: raises $0.50 to $0.75
aNpwfA31EREwO+ar4XzBCw: calls $0.75
FJflwqC6fqOpM3j0q8Bptw: calls $0.65
5hAPbqNrvJb8PtLiceXtlg6HoFYfVGBefsR5Vrz62qIwlds 
*** FLOP *** [Qd 5d 3s]
FJflwqC6fqOpM3j0q8Bptw: checks 
tYsOBqdU1+x+yFI7zHO7hQ: bets $1.75
aNpwfA31EREwO+ar4XzBCw: folds 
FJflwqC6fqOpM3j0q8Bptw: folds 
Uncalled bet ($1.75) returned to tYsOBqdU1+x+yFI7zHO7hQ
tYsOBqdU1+x+yFI7zHO7hQ collected $2.40 from pot
tYsOBqdU1+x+yFI7zHO7hQ: doesn't show hand 
*** SUMMARY ***
Total pot $2.50 | Rake $0.10 
Board [Qd 5d 3s]
Seat 2: tYsOBqdU1+x+yFI7zHO7hQ collected ($2.40)
Seat 3: aNpwfA31EREwO+ar4XzBCw (button) folded on the Flop
Seat 4: FJflwqC6fqOpM3j0q8Bptw (small blind) folded on the Flop
Seat 5: 5hAPbqNrvJb8PtLiceXtlg6HoFYfVGBefsR5Vrz62qIwg blind) folded before Flop
Seat 6: hBMUlEpyU74r/fwDgIpXjQ folded before Flop (didn't bet)
Seat 7: opOCI2p6kW0tINuVaAqmcQ folded before Flop (didn't bet)
Seat 8: CYkY0dNBaYaKs8HVCVn3mQ folded before Flop (didn't bet)
Seat 9: ljemhp25Zg+nlA9DLCIiUw folded before Flop (didn't bet)




PokerStars Game #59939725666:  Hold'em No Limit ($0.10/$0.25) - 2009/07/01 0:47:19 ET
Table 'NfXsh0UQA+o/kO9acV3WxA' 9-max Seat #1 is the button
Seat 1: H5Se03ZqSX7tbULXur2MAg ($27.85 in chips) 
Seat 5: 3RCAkueG3Vc13VpRStCB+w ($34.55 in chips) 
Seat 7: HPEB+AtKw1+C/cxU0o1ciw ($31.25 in chips) 
Seat 8: +sbyWwIcFp9kP0bDtMegfQ ($24.65 in chips) 
sQ6szDwWrE+LMh1p4dVexA: is sitting out 
3RCAkueG3Vc13VpRStCB+w: posts small blind $0.10
HPEB+AtKw1+C/cxU0o1ciw: posts big blind $0.25
*** HOLE CARDS ***
+sbyWwIcFp9kP0bDtMegfQ: folds 
H5Se03ZqSX7tbULXur2MAg: folds 
H5Se03ZqSX7tbULXur2MAg leaves the table
3RCAkueG3Vc13VpRStCB+w: raises $0.50 to $0.75
HPEB+AtKw1+C/cxU0o1ciw: folds 
Uncalled bet ($0.50) returned to 3RCAkueG3Vc13VpRStCB+w
sQ6szDwWrE+LMh1p4dVexA leaves the table
3RCAkueG3Vc13VpRStCB+w collected $0.50 from pot
3RCAkueG3Vc13VpRStCB+w: doesn't show hand 
*** SUMMARY ***
Total pot $0.50 | Rake $0 
Seat 1: H5Se03ZqSX7tbULXur2MAg (button) folded before Flop (didn't bet)
Seat 5: 3RCAkueG3Vc13VpRStCB+w (small blind) collected ($0.50)
Seat 7: HPEB+AtKw1+C/cxU0o1ciw (big blind) folded before Flop
Seat 8: +sbyWwIcFp9kP0bDtMegfQ folded before Flop (didn't bet)




PokerStars Game #59939725780:  Hold'em No Limit ($0.10/$0.25) - 2009/07/01 0:47:20 ET
Table 'GoBmKm3klK6VavJE4STfmQ' 9-max Seat #6 is the button
Seat 1: N6fYvIzQLKaydFLKQGtMlQ ($20.45 in chips) 
Seat 2: 1c/7DHPx5CDTmAfk8/bWeA ($15.75 in chips) 
Seat 3: 4awUyiDYTgylQKXZ9faBVA ($30.25 in chips) 
Seat 4: H5Se03ZqSX7tbULXur2MAg ($23.95 in chips) 
Seat 5: 8B/dhbQjIWe6ASCdgzktNQ ($25 in chips) 
Seat 6: S3QwXyGCcujfAwNubHpwbw ($4.65 in chips) 
Seat 7: s9a4d23HFxaL70yUWQ0/tQ ($20.65 in chips) 
Seat 8: cZ99hugmLBj9KhTlc8nCSw ($25 in chips) 
s9a4d23HFxaL70yUWQ0/tQ: posts small blind $0.10
cZ99hugmLBj9KhTlc8nCSw: posts big blind $0.25
*** HOLE CARDS ***
N6fYvIzQLKaydFLKQGtMlQ: folds 
1c/7DHPx5CDTmAfk8/bWeA: folds 
4awUyiDYTgylQKXZ9faBVA: raises $0.75 to $1
H5Se03ZqSX7tbULXur2MAg: folds 
8B/dhbQjIWe6ASCdgzktNQ: folds 
S3QwXyGCcujfAwNubHpwbw: raises $0.75 to $1.75
s9a4d23HFxaL70yUWQ0/tQ: folds 
cZ99hugmLBj9KhTlc8nCSw: folds 
4awUyiDYTgylQKXZ9faBVA: calls $0.75
*** FLOP *** [Ah 6h 4c]
4awUyiDYTgylQKXZ9faBVA: bets $2
S3QwXyGCcujfAwNubHpwbw: calls $2
*** TURN *** [Ah 6h 4c] [8h]
4awUyiDYTgylQKXZ9faBVA: bets $1
S3QwXyGCcujfAwNubHpwbw: calls $0.90 and is all-in
Uncalled bet ($0.10) returned to 4awUyiDYTgylQKXZ9faBVA
*** RIVER *** [Ah 6h 4c 8h] [Th]
*** SHOW DOWN ***
4awUyiDYTgylQKXZ9faBVA: shows [Ac Jd] (a pair of Aces)
S3QwXyGCcujfAwNubHpwbw: shows [Qs Qd] (a pair of Queens)
4awUyiDYTgylQKXZ9faBVA collected $9.20 from pot
*** SUMMARY ***
Total pot $9.65 | Rake $0.45 
Board [Ah 6h 4c 8h Th]
Seat 1: N6fYvIzQLKaydFLKQGtMlQ folded before Flop (didn't bet)
Seat 2: 1c/7DHPx5CDTmAfk8/bWeA folded before Flop (didn't bet)
Seat 3: 4awUyiDYTgylQKXZ9faBVA showed [Ac Jd] and won ($9.20) with a pair of Aces
Seat 4: H5Se03ZqSX7tbULXur2MAg folded before Flop (didn't bet)
Seat 5: 8B/dhbQjIWe6ASCdgzktNQ folded before Flop (didn't bet)
Seat 6: S3QwXyGCcujfAwNubHpwbw (button) showed [Qs Qd] and lost with a pair of Queens
Seat 7: s9a4d23HFxaL70yUWQ0/tQ (small blind) folded before Flop
Seat 8: cZ99hugmLBj9KhTlc8nCSw (big blind) folded before Flop




PokerStars Game #59939726372:  Hold'em No Limit ($0.10/$0.25) - 2009/07/01 0:47:20 ET
Table 'Qr+t8WGovMECkBv+cV1lrg' 6-max Seat #6 is the button
Seat 2: 9h7TNZ1TDGRUJXA6rI+ZTw ($15.65 in chips) 
Seat 3: bjJnMpKgoF+vgHW2f1NCsg ($18 in chips) 
Seat 5: iwlxXocltgSdaBmusNXanQ ($23.65 in chips) 
Seat 6: j5NZbEJHsERuXjPHWqc1Nw ($13.15 in chips) 
9h7TNZ1TDGRUJXA6rI+ZTw: posts small blind $0.10
bjJnMpKgoF+vgHW2f1NCsg: posts big blind $0.25
1NNFfYMd5Hsphl/FYz9fNA: sits out 
*** HOLE CARDS ***
iwlxXocltgSdaBmusNXanQ: folds 
j5NZbEJHsERuXjPHWqc1Nw: calls $0.25
9h7TNZ1TDGRUJXA6rI+ZTw: folds 
bjJnMpKgoF+vgHW2f1NCsg: checks 
*** FLOP *** [Th As 6h]
bjJnMpKgoF+vgHW2f1NCsg: checks 
j5NZbEJHsERuXjPHWqc1Nw: bets $0.50
bjJnMpKgoF+vgHW2f1NCsg: folds 
Uncalled bet ($0.50) returned to j5NZbEJHsERuXjPHWqc1Nw
j5NZbEJHsERuXjPHWqc1Nw collected $0.60 from pot
*** SUMMARY ***
Total pot $0.60 | Rake $0 
Board [Th As 6h]
Seat 2: 9h7TNZ1TDGRUJXA6rI+ZTw (small blind) folded before Flop
Seat 3: bjJnMpKgoF+vgHW2f1NCsg (big blind) folded on the Flop
Seat 5: iwlxXocltgSdaBmusNXanQ folded before Flop (didn't bet)
Seat 6: j5NZbEJHsERuXjPHWqc1Nw (button) collected ($0.60)




PokerStars Game #59939725786:  Hold'em No Limit ($0.10/$0.25) - 2009/07/01 0:47:20 ET
Table 'zKwHJD0cmKNUure9qQTfFg' 6-max Seat #6 is the button
Seat 1: nwwpaieDRI0UPyVtChVHOg ($14.65 in chips) 
Seat 2: 4kWQxGbT5FZ1dkPd1bE45Q ($25 in chips) 
Seat 3: ljjhtb6FVPTx9AT9HNdtqg ($14 in chips) 
Seat 4: v+QfkGiuj9bgtuNoVnDO8w ($26.10 in chips) 
Seat 5: I1TxPvWj8NfG8orglCinNA ($29.45 in chips) 
Seat 6: fBpPyuxbg0NbTlQHEs38sA ($15.90 in chips) 
nwwpaieDRI0UPyVtChVHOg: posts small blind $0.10
4kWQxGbT5FZ1dkPd1bE45Q: posts big blind $0.25
*** HOLE CARDS ***
ljjhtb6FVPTx9AT9HNdtqg: folds 
v+QfkGiuj9bgtuNoVnDO8w: folds 
I1TxPvWj8NfG8orglCinNA: raises $0.75 to $1
fBpPyuxbg0NbTlQHEs38sA: calls $1
nwwpaieDRI0UPyVtChVHOg: folds 
4kWQxGbT5FZ1dkPd1bE45Q: folds 
*** FLOP *** [4c 5d 6h]
I1TxPvWj8NfG8orglCinNA: checks 
fBpPyuxbg0NbTlQHEs38sA: bets $1.75
I1TxPvWj8NfG8orglCinNA: calls $1.75
*** TURN *** [4c 5d 6h] [3d]
I1TxPvWj8NfG8orglCinNA: checks 
fBpPyuxbg0NbTlQHEs38sA: checks 
*** RIVER *** [4c 5d 6h 3d] [5c]
I1TxPvWj8NfG8orglCinNA: checks 
fBpPyuxbg0NbTlQHEs38sA: checks 
*** SHOW DOWN ***
I1TxPvWj8NfG8orglCinNA: shows [Tc Ah] (a pair of Fives)
fBpPyuxbg0NbTlQHEs38sA: mucks hand 
I1TxPvWj8NfG8orglCinNA collected $5.60 from pot
*** SUMMARY ***
Total pot $5.85 | Rake $0.25 
Board [4c 5d 6h 3d 5c]
Seat 1: nwwpaieDRI0UPyVtChVHOg (small blind) folded before Flop
Seat 2: 4kWQxGbT5FZ1dkPd1bE45Q (big blind) folded before Flop
Seat 3: ljjhtb6FVPTx9AT9HNdtqg folded before Flop (didn't bet)
Seat 4: v+QfkGiuj9bgtuNoVnDO8w folded before Flop (didn't bet)
Seat 5: I1TxPvWj8NfG8orglCinNA showed [Tc Ah] and won ($5.60) with a pair of Fives
Seat 6: fBpPyuxbg0NbTlQHEs38sA (button) mucked




PokerStars Game #59939726328:  Hold'em No Limit ($0.10/$0.25) - 2009/07/01 0:47:20 ET
Table '+198VWQSWBhYQOcizzuBkw' 6-max Seat #3 is the button
Seat 1: 9wWOoS2QEhCmOCt1GOwBKA ($5.20 in chips) 
Seat 2: R6AGToFJQOYVZAjC2jXEKw ($23.15 in chips) 
Seat 3: BYxjLnV1/LL0aZcTbfAOvw ($27.50 in chips) 
Seat 4: TgDsTeCdLQt8kWbL00ByRA ($32.60 in chips) 
Seat 5: LtASJ9OlkqGrrUKGQlpGAw ($29.70 in chips) 
Seat 6: 7qRk4YH4/k/08LgJSv7rBQ ($31.25 in chips) 
TgDsTeCdLQt8kWbL00ByRA: posts small blind $0.10
LtASJ9OlkqGrrUKGQlpGAw: posts big blind $0.25
*** HOLE CARDS ***
7qRk4YH4/k/08LgJSv7rBQ: raises $0.75 to $1
9wWOoS2QEhCmOCt1GOwBKA: folds 
R6AGToFJQOYVZAjC2jXEKw: folds 
BYxjLnV1/LL0aZcTbfAOvw: folds 
TgDsTeCdLQt8kWbL00ByRA: folds 
LtASJ9OlkqGrrUKGQlpGAw: folds 
Uncalled bet ($0.75) returned to 7qRk4YH4/k/08LgJSv7rBQ
7qRk4YH4/k/08LgJSv7rBQ collected $0.60 from pot
7qRk4YH4/k/08LgJSv7rBQ: doesn't show hand 
*** SUMMARY ***
Total pot $0.60 | Rake $0 
Seat 1: 9wWOoS2QEhCmOCt1GOwBKA folded before Flop (didn't bet)
Seat 2: R6AGToFJQOYVZAjC2jXEKw folded before Flop (didn't bet)
Seat 3: BYxjLnV1/LL0aZcTbfAOvw (button) folded before Flop (didn't bet)
Seat 4: TgDsTeCdLQt8kWbL00ByRA (small blind) folded before Flop
Seat 5: LtASJ9OlkqGrrUKGQlpGAw (big blind) folded before Flop
Seat 6: 7qRk4YH4/k/08LgJSv7rBQ collected ($0.60)




PokerStars Game #59939726170:  Hold'em No Limit ($0.10/$0.25) - 2009/07/01 0:47:20 ET
Table '9L7XfAwuM7XsXE8LIg2o5Q' 6-max Seat #2 is the button
Seat 1: H6XbZVba2aKDXlG0la0uow ($5.40 in chips) 
Seat 2: oseFhpinoe+Zg4j5xyBjyQ ($16.60 in chips) 
Seat 3: JRODJ0tkruzJ7hwOFO9ogg ($4.75 in chips) 
Seat 4: jp34e617tIzV8tKIWmfAbA ($26.40 in chips) 
Seat 5: OUv909q/YxsJgxpSlZxLJQ ($25 in chips) 
Seat 6: k9nHZTHt8hYhYRcW8NTb4g ($30.40 in chips) 
JRODJ0tkruzJ7hwOFO9ogg: posts small blind $0.10
jp34e617tIzV8tKIWmfAbA: posts big blind $0.25
*** HOLE CARDS ***
OUv909q/YxsJgxpSlZxLJQ: folds 
k9nHZTHt8hYhYRcW8NTb4g: folds 
H6XbZVba2aKDXlG0la0uow: folds 
oseFhpinoe+Zg4j5xyBjyQ: folds 
JRODJ0tkruzJ7hwOFO9ogg: folds 
Uncalled bet ($0.15) returned to jp34e617tIzV8tKIWmfAbA
jp34e617tIzV8tKIWmfAbA collected $0.20 from pot
*** SUMMARY ***
Total pot $0.20 | Rake $0 
Seat 1: H6XbZVba2aKDXlG0la0uow folded before Flop (didn't bet)
Seat 2: oseFhpinoe+Zg4j5xyBjyQ (button) folded before Flop (didn't bet)
Seat 3: JRODJ0tkruzJ7hwOFO9ogg (small blind) folded before Flop
Seat 4: jp34e617tIzV8tKIWmfAbA (big blind) collected ($0.20)
Seat 5: OUv909q/YxsJgxpSlZxLJQ folded before Flop (didn't bet)
Seat 6: k9nHZTHt8hYhYRcW8NTb4g folded before Flop (didn't bet)




PokerStars Game #59939726214:  Hold'em No Limit ($0.10/$0.25) - 2009/07/01 0:47:20 ET
Table 'AHkg4ChqzcMauBx6Qvz8Nw' 6-max Seat #1 is the button
Seat 1: 4kWQxGbT5FZ1dkPd1bE45Q ($25 in chips) 
Seat 2: /bjna2FTN7pPjqYGzmDE0Q ($23.65 in chips) 
Seat 3: wvIIdlbCgePONQwXjx9xzQ ($5.60 in chips) 
Seat 4: N7O9jUEx2YiQn1+yRYTHmw ($40.20 in chips) 
Seat 5: LtASJ9OlkqGrrUKGQlpGAw ($36.35 in chips) 
Seat 6: SFmT9ZsVopnukjvAzrxTRg ($54.20 in chips) 
/bjna2FTN7pPjqYGzmDE0Q: posts small blind $0.10
wvIIdlbCgePONQwXjx9xzQ: posts big blind $0.25
*** HOLE CARDS ***
N7O9jUEx2YiQn1+yRYTHmw: folds 
LtASJ9OlkqGrrUKGQlpGAw: folds 
SFmT9ZsVopnukjvAzrxTRg: folds 
4kWQxGbT5FZ1dkPd1bE45Q: raises $0.75 to $1
/bjna2FTN7pPjqYGzmDE0Q: folds 
wvIIdlbCgePONQwXjx9xzQ: folds 
Uncalled bet ($0.75) returned to 4kWQxGbT5FZ1dkPd1bE45Q
4kWQxGbT5FZ1dkPd1bE45Q collected $0.60 from pot
4kWQxGbT5FZ1dkPd1bE45Q: doesn't show hand 
*** SUMMARY ***
Total pot $0.60 | Rake $0 
Seat 1: 4kWQxGbT5FZ1dkPd1bE45Q (button) collected ($0.60)
Seat 2: /bjna2FTN7pPjqYGzmDE0Q (small blind) folded before Flop
Seat 3: wvIIdlbCgePONQwXjx9xzQ (big blind) folded before Flop
Seat 4: N7O9jUEx2YiQn1+yRYTHmw folded before Flop (didn't bet)
Seat 5: LtASJ9OlkqGrrUKGQlpGAw folded before Flop (didn't bet)
Seat 6: SFmT9ZsVopnukjvAzrxTRg folded before Flop (didn't bet)




PokerStars Game #59939726338:  Hold'em No Limit ($0.10/$0.25) - 2009/07/01 0:47:20 ET
Table 'qInMnOOn7vKcj4bU7zju7g' 9-max Seat #7 is the button
Seat 2: f/H6PsHRl4W1JyNsEDvPtg ($8.90 in chips) 
Seat 3: zDrucyjVn5aeekNEc3cJrA ($28.15 in chips) 
Seat 4: ZbKV588BRlpe7vF42jT9yg ($9.30 in chips) 
Seat 5: aNpwfA31EREwO+ar4XzBCw ($40.35 in chips) 
Seat 6: r1pFKMwWp74QwhfPWJOAyw ($9.75 in chips) 
Seat 7: 8B/dhbQjIWe6ASCdgzktNQ ($26.60 in chips) 
Seat 9: K7bAhhMMJ/XcTmGaBZVfFQ ($23.75 in chips) 
K7bAhhMMJ/XcTmGaBZVfFQ: posts small blind $0.10
f/H6PsHRl4W1JyNsEDvPtg: posts big blind $0.25
*** HOLE CARDS ***
zDrucyjVn5aeekNEc3cJrA: folds 
ZbKV588BRlpe7vF42jT9yg: calls $0.25
aNpwfA31EREwO+ar4XzBCw: folds 
r1pFKMwWp74QwhfPWJOAyw: raises $0.50 to $0.75
8B/dhbQjIWe6ASCdgzktNQ: calls $0.75
K7bAhhMMJ/XcTmGaBZVfFQ: folds 
f/H6PsHRl4W1JyNsEDvPtg: folds 
ZbKV588BRlpe7vF42jT9yg: calls $0.50
*** FLOP *** [4d 7d 5s]
ZbKV588BRlpe7vF42jT9yg: bets $1.75
r1pFKMwWp74QwhfPWJOAyw: folds 
8B/dhbQjIWe6ASCdgzktNQ: folds 
Uncalled bet ($1.75) returned to ZbKV588BRlpe7vF42jT9yg
ZbKV588BRlpe7vF42jT9yg collected $2.50 from pot
ZbKV588BRlpe7vF42jT9yg: doesn't show hand 
*** SUMMARY ***
Total pot $2.60 | Rake $0.10 
Board [4d 7d 5s]
Seat 2: f/H6PsHRl4W1JyNsEDvPtg (big blind) folded before Flop
Seat 3: zDrucyjVn5aeekNEc3cJrA folded before Flop (didn't bet)
Seat 4: ZbKV588BRlpe7vF42jT9yg collected ($2.50)
Seat 5: aNpwfA31EREwO+ar4XzBCw folded before Flop (didn't bet)
Seat 6: r1pFKMwWp74QwhfPWJOAyw folded on the Flop
Seat 7: 8B/dhbQjIWe6ASCdgzktNQ (button) folded on the Flop
Seat 9: K7bAhhMMJ/XcTmGaBZVfFQ (small blind) folded before Flop




PokerStars Game #59939726784:  Hold'em No Limit ($0.10/$0.25) - 2009/07/01 0:47:21 ET
Table 'YmPuuzhvRUvgdYcNs5kZKw' 9-max Seat #5 is the button
Seat 1: Qi+clOtyDiibLdH2/1Qy8g ($25.05 in chips) 
Seat 2: JtVGnq5doRa3PublncR+Yw ($24.75 in chips) 
Seat 4: N6fYvIzQLKaydFLKQGtMlQ ($24.40 in chips) 
Seat 5: CvL9Ch1HYCVbTsfpNucitg ($4.65 in chips) 
Seat 6: z5GxcHlYz/GSz6W2uFiTtg ($25.90 in chips) 
Seat 7: opOCI2p6kW0tINuVaAqmcQ ($25 in chips) 
Seat 8: IeNTEKD96WqM7qU1RpSvOQ ($12.80 in chips) 
z5GxcHlYz/GSz6W2uFiTtg: posts small blind $0.10
opOCI2p6kW0tINuVaAqmcQ: posts big blind $0.25
the bear NF: sits out 
*** HOLE CARDS ***
IeNTEKD96WqM7qU1RpSvOQ: calls $0.25
Qi+clOtyDiibLdH2/1Qy8g: folds 
JtVGnq5doRa3PublncR+Yw: calls $0.25
N6fYvIzQLKaydFLKQGtMlQ: folds 
CvL9Ch1HYCVbTsfpNucitg: folds 
z5GxcHlYz/GSz6W2uFiTtg: calls $0.15
opOCI2p6kW0tINuVaAqmcQ: checks 
*** FLOP *** [Th 8c 8h]
z5GxcHlYz/GSz6W2uFiTtg: checks 
opOCI2p6kW0tINuVaAqmcQ: checks 
IeNTEKD96WqM7qU1RpSvOQ: checks 
JtVGnq5doRa3PublncR+Yw: bets $0.75
z5GxcHlYz/GSz6W2uFiTtg: folds 
opOCI2p6kW0tINuVaAqmcQ: folds 
IeNTEKD96WqM7qU1RpSvOQ: folds 
Uncalled bet ($0.75) returned to JtVGnq5doRa3PublncR+Yw
JtVGnq5doRa3PublncR+Yw collected $0.95 from pot
*** SUMMARY ***
Total pot $1 | Rake $0.05 
Board [Th 8c 8h]
Seat 1: Qi+clOtyDiibLdH2/1Qy8g folded before Flop (didn't bet)
Seat 2: JtVGnq5doRa3PublncR+Yw collected ($0.95)
Seat 4: N6fYvIzQLKaydFLKQGtMlQ folded before Flop (didn't bet)
Seat 5: CvL9Ch1HYCVbTsfpNucitg (button) folded before Flop (didn't bet)
Seat 6: z5GxcHlYz/GSz6W2uFiTtg (small blind) folded on the Flop
Seat 7: opOCI2p6kW0tINuVaAqmcQ (big blind) folded on the Flop
Seat 8: IeNTEKD96WqM7qU1RpSvOQ folded on the Flop




PokerStars Game #59939726538:  Hold'em No Limit ($0.10/$0.25) - 2009/07/01 0:47:21 ET
Table 'hfHe8uKeSJMyWAjSdM7ROQ' 6-max Seat #6 is the button
Seat 1: eHsmIvAb2JREg4O6hNPnXg ($17.65 in chips) 
Seat 2: rnpAao581IcvQglpkpnkoQ ($5.05 in chips) 
Seat 3: og6TUWcndKo5oTDQjnQfjw ($38.40 in chips) 
Seat 4: iAfYkegiTr9eE85LoKmEgA ($6.95 in chips) 
Seat 5: euswrBD1XG0Q5hB1iGJBKQ ($19.20 in chips) 
Seat 6: SFmT9ZsVopnukjvAzrxTRg ($25 in chips) 
eHsmIvAb2JREg4O6hNPnXg: posts small blind $0.10
rnpAao581IcvQglpkpnkoQ: posts big blind $0.25
*** HOLE CARDS ***
og6TUWcndKo5oTDQjnQfjw: raises $0.50 to $0.75
iAfYkegiTr9eE85LoKmEgA: folds 
euswrBD1XG0Q5hB1iGJBKQ: raises $0.75 to $1.50
SFmT9ZsVopnukjvAzrxTRg: folds 
eHsmIvAb2JREg4O6hNPnXg: folds 
rnpAao581IcvQglpkpnkoQ: folds 
og6TUWcndKo5oTDQjnQfjw: calls $0.75
*** FLOP *** [Tc 3h 5d]
og6TUWcndKo5oTDQjnQfjw: checks 
euswrBD1XG0Q5hB1iGJBKQ: bets $1.75
og6TUWcndKo5oTDQjnQfjw: raises $3.75 to $5.50
euswrBD1XG0Q5hB1iGJBKQ: calls $3.75
*** TURN *** [Tc 3h 5d] [3d]
og6TUWcndKo5oTDQjnQfjw: bets $12.25
euswrBD1XG0Q5hB1iGJBKQ: calls $12.20 and is all-in
Uncalled bet ($0.05) returned to og6TUWcndKo5oTDQjnQfjw
*** RIVER *** [Tc 3h 5d 3d] [7c]
*** SHOW DOWN ***
og6TUWcndKo5oTDQjnQfjw: shows [9s Td] (two pair, Tens and Threes)
euswrBD1XG0Q5hB1iGJBKQ: shows [Kc Ts] (two pair, Tens and Threes - King kicker)
euswrBD1XG0Q5hB1iGJBKQ collected $36.85 from pot
*** SUMMARY ***
Total pot $38.75 | Rake $1.90 
Board [Tc 3h 5d 3d 7c]
Seat 1: eHsmIvAb2JREg4O6hNPnXg (small blind) folded before Flop
Seat 2: rnpAao581IcvQglpkpnkoQ (big blind) folded before Flop
Seat 3: og6TUWcndKo5oTDQjnQfjw showed [9s Td] and lost with two pair, Tens and Threes
Seat 4: iAfYkegiTr9eE85LoKmEgA folded before Flop (didn't bet)
Seat 5: euswrBD1XG0Q5hB1iGJBKQ showed [Kc Ts] and won ($36.85) with two pair, Tens and Threes
Seat 6: SFmT9ZsVopnukjvAzrxTRg (button) folded before Flop (didn't bet)




PokerStars Game #59939726942:  Hold'em No Limit ($0.10/$0.25) - 2009/07/01 0:47:21 ET
Table 'PCxB2W9H6ma8SwsZlImuOw' 9-max Seat #9 is the button
Seat 1: 5s3p6yoJBNW438dsyKTP8g ($30.50 in chips) 
Seat 2: wjH6l1gQaEfv+C45sAOwIQ ($37.80 in chips) 
Seat 3: opOCI2p6kW0tINuVaAqmcQ ($33.70 in chips) 
Seat 4: ydoFOVgzvZv9ZhuWu9rXAw ($4.90 in chips) 
Seat 5: h4ggJZYBXV0mEZzYPYKfeA ($23.35 in chips) 
Seat 6: E2c0EwJuNHUUdumOOgYQYA ($4.85 in chips) 
Seat 8: kk4O0+IswAtmyhr/WFvmCA ($8.35 in chips) 
Seat 9: 1q23ISSsSMhv2lHXBfj9/A ($26.60 in chips) 
5s3p6yoJBNW438dsyKTP8g: posts small blind $0.10
wjH6l1gQaEfv+C45sAOwIQ: posts big blind $0.25
22dIObOuor/A+IKWkNoAlA: sits out 
kk4O0+IswAtmyhr/WFvmCA: posts big blind $0.25
*** HOLE CARDS ***
opOCI2p6kW0tINuVaAqmcQ: folds 
ydoFOVgzvZv9ZhuWu9rXAw: folds 
h4ggJZYBXV0mEZzYPYKfeA: folds 
E2c0EwJuNHUUdumOOgYQYA: calls $0.25
kk4O0+IswAtmyhr/WFvmCA: checks 
1q23ISSsSMhv2lHXBfj9/A: folds 
5s3p6yoJBNW438dsyKTP8g: folds 
wjH6l1gQaEfv+C45sAOwIQ: raises $1 to $1.25
E2c0EwJuNHUUdumOOgYQYA: calls $1
kk4O0+IswAtmyhr/WFvmCA: folds 
*** FLOP *** [6d Js Ad]
wjH6l1gQaEfv+C45sAOwIQ: checks 
E2c0EwJuNHUUdumOOgYQYA: checks 
*** TURN *** [6d Js Ad] [2h]
wjH6l1gQaEfv+C45sAOwIQ: bets $0.50
E2c0EwJuNHUUdumOOgYQYA: folds 
Uncalled bet ($0.50) returned to wjH6l1gQaEfv+C45sAOwIQ
wjH6l1gQaEfv+C45sAOwIQ collected $2.75 from pot
wjH6l1gQaEfv+C45sAOwIQ: doesn't show hand 
*** SUMMARY ***
Total pot $2.85 | Rake $0.10 
Board [6d Js Ad 2h]
Seat 1: 5s3p6yoJBNW438dsyKTP8g (small blind) folded before Flop
Seat 2: wjH6l1gQaEfv+C45sAOwIQ (big blind) collected ($2.75)
Seat 3: opOCI2p6kW0tINuVaAqmcQ folded before Flop (didn't bet)
Seat 4: ydoFOVgzvZv9ZhuWu9rXAw folded before Flop (didn't bet)
Seat 5: h4ggJZYBXV0mEZzYPYKfeA folded before Flop (didn't bet)
Seat 6: E2c0EwJuNHUUdumOOgYQYA folded on the Turn
Seat 8: kk4O0+IswAtmyhr/WFvmCA folded before Flop
Seat 9: 1q23ISSsSMhv2lHXBfj9/A (button) folded before Flop (didn't bet)




PokerStars Game #59939727162:  Hold'em No Limit ($0.10/$0.25) - 2009/07/01 0:47:22 ET
Table 'Zi9/NqNs3XoL1eWhMCyZyg' 9-max Seat #4 is the button
Seat 1: opOCI2p6kW0tINuVaAqmcQ ($25 in chips) 
Seat 2: Th3FldXKQW6hWVVPahaoOQ ($29.20 in chips) 
Seat 3: rUpvA02nErFvZ4yFbDR8XA ($28.10 in chips) 
Seat 4: D3XCkXRktDfPlSguxwfnRA ($6.55 in chips) 
Seat 5: OiV1PWZ3IkN29JlmCcnTwQ ($4.75 in chips) 
Seat 6: b3P5tPsBbrP+aAO9+Ts/Nw ($37.10 in chips) 
Seat 7: qul+IMROTuFj45eWi2Tpvg ($55.45 in chips) 
Seat 9: tYsOBqdU1+x+yFI7zHO7hQ ($30.75 in chips) 
OiV1PWZ3IkN29JlmCcnTwQ: posts small blind $0.10
b3P5tPsBbrP+aAO9+Ts/Nw: posts big blind $0.25
MrPo4/ymXwg9lzPRybrXbA: sits out 
*** HOLE CARDS ***
qul+IMROTuFj45eWi2Tpvg: calls $0.25
tYsOBqdU1+x+yFI7zHO7hQ: raises $1 to $1.25
opOCI2p6kW0tINuVaAqmcQ: folds 
Th3FldXKQW6hWVVPahaoOQ: folds 
rUpvA02nErFvZ4yFbDR8XA: folds 
D3XCkXRktDfPlSguxwfnRA: folds 
OiV1PWZ3IkN29JlmCcnTwQ: folds 
b3P5tPsBbrP+aAO9+Ts/Nw: folds 
qul+IMROTuFj45eWi2Tpvg: calls $1
*** FLOP *** [5d Ts Jd]
qul+IMROTuFj45eWi2Tpvg: checks 
tYsOBqdU1+x+yFI7zHO7hQ: bets $2
qul+IMROTuFj45eWi2Tpvg: folds 
Uncalled bet ($2) returned to tYsOBqdU1+x+yFI7zHO7hQ
tYsOBqdU1+x+yFI7zHO7hQ collected $2.75 from pot
tYsOBqdU1+x+yFI7zHO7hQ: doesn't show hand 
*** SUMMARY ***
Total pot $2.85 | Rake $0.10 
Board [5d Ts Jd]
Seat 1: opOCI2p6kW0tINuVaAqmcQ folded before Flop (didn't bet)
Seat 2: Th3FldXKQW6hWVVPahaoOQ folded before Flop (didn't bet)
Seat 3: rUpvA02nErFvZ4yFbDR8XA folded before Flop (didn't bet)
Seat 4: D3XCkXRktDfPlSguxwfnRA (button) folded before Flop (didn't bet)
Seat 5: OiV1PWZ3IkN29JlmCcnTwQ (small blind) folded before Flop
Seat 6: b3P5tPsBbrP+aAO9+Ts/Nw (big blind) folded before Flop
Seat 7: qul+IMROTuFj45eWi2Tpvg folded on the Flop
Seat 9: tYsOBqdU1+x+yFI7zHO7hQ collected ($2.75)




PokerStars Game #59939727250:  Hold'em No Limit ($0.10/$0.25) - 2009/07/01 0:47:22 ET
Table 'Rv0EYnRU8WwZiwx0Zo3X3w' 9-max Seat #9 is the button
Seat 1: opOCI2p6kW0tINuVaAqmcQ ($52.70 in chips) 
Seat 2: Xpyqpb+DURDWnyJ3xTEIFQ ($28.75 in chips) 
Seat 3: STkR8XvpjNv79OOMhrlh2w ($25.60 in chips) 
Seat 4: IDkfbfxTm9KJ+DMyGVH8rw ($12.25 in chips) 
Seat 5: h4ggJZYBXV0mEZzYPYKfeA ($21.80 in chips) 
Seat 6: 5hAPbqNrvJb8PtLiceXtlg ($14.15 in chips) 
Seat 7: Th3FldXKQW6hWVVPahaoOQ ($38.50 in chips) 
Seat 8: 10vzP4r6ldwGLbYHKd9www ($16.65 in chips) 
Seat 9: r1pFKMwWp74QwhfPWJOAyw ($3.85 in chips) 
opOCI2p6kW0tINuVaAqmcQ: posts small blind $0.10
Xpyqpb+DURDWnyJ3xTEIFQ: posts big blind $0.25
*** HOLE CARDS ***
STkR8XvpjNv79OOMhrlh2w: folds 
IDkfbfxTm9KJ+DMyGVH8rw: raises $1 to $1.25
h4ggJZYBXV0mEZzYPYKfeA: folds 
5hAPbqNrvJb8PtLiceXtlg: folds 
Th3FldXKQW6hWVVPahaoOQ: folds 
10vzP4r6ldwGLbYHKd9www: folds 
r1pFKMwWp74QwhfPWJOAyw: folds 
opOCI2p6kW0tINuVaAqmcQ: folds 
Xpyqpb+DURDWnyJ3xTEIFQ: folds 
Uncalled bet ($1) returned to IDkfbfxTm9KJ+DMyGVH8rw
IDkfbfxTm9KJ+DMyGVH8rw collected $0.60 from pot
*** SUMMARY ***
Total pot $0.60 | Rake $0 
Seat 1: opOCI2p6kW0tINuVaAqmcQ (small blind) folded before Flop
Seat 2: Xpyqpb+DURDWnyJ3xTEIFQ (big blind) folded before Flop
Seat 3: STkR8XvpjNv79OOMhrlh2w folded before Flop (didn't bet)
Seat 4: IDkfbfxTm9KJ+DMyGVH8rw collected ($0.60)
Seat 5: h4ggJZYBXV0mEZzYPYKfeA folded before Flop (didn't bet)
Seat 6: 5hAPbqNrvJb8PtLiceXtlg folded before Flop (didn't bet)
Seat 7: Th3FldXKQW6hWVVPahaoOQ folded before Flop (didn't bet)
Seat 8: 10vzP4r6ldwGLbYHKd9www folded before Flop (didn't bet)
Seat 9: r1pFKMwWp74QwhfPWJOAyw (button) folded before Flop (didn't bet)




PokerStars Game #59939727532:  Hold'em No Limit ($0.10/$0.25) - 2009/07/01 0:47:22 ET
Table '0M5QEJGOThqZwQ/sjbjXYw' 6-max Seat #1 is the button
Seat 1: RVBrV53KVTJ2T2VL8ucnfw ($28.10 in chips) 
Seat 2: /gJNBeCkWL4o85/jvlZ4BA ($43.10 in chips) 
Seat 3: d0J1xuhsynEY81YHwAvJ5g ($25 in chips) 
Seat 4: fZQg9veL7Dd/Z04ZTjC+wQ ($25 in chips) 
Seat 5: ErIN0JRL5srYjT6en1f8YQ ($52.60 in chips) 
Seat 6: mYz11CHiw5KsDCRD5T7/jg ($58.65 in chips) 
/gJNBeCkWL4o85/jvlZ4BA: posts small blind $0.10
d0J1xuhsynEY81YHwAvJ5g: posts big blind $0.25
*** HOLE CARDS ***
fZQg9veL7Dd/Z04ZTjC+wQ: folds 
ErIN0JRL5srYjT6en1f8YQ: folds 
mYz11CHiw5KsDCRD5T7/jg: calls $0.25
RVBrV53KVTJ2T2VL8ucnfw: folds 
/gJNBeCkWL4o85/jvlZ4BA: calls $0.15
d0J1xuhsynEY81YHwAvJ5g: checks 
*** FLOP *** [Td As 8h]
/gJNBeCkWL4o85/jvlZ4BA: checks 
d0J1xuhsynEY81YHwAvJ5g: checks 
mYz11CHiw5KsDCRD5T7/jg: checks 
*** TURN *** [Td As 8h] [4c]
/gJNBeCkWL4o85/jvlZ4BA: checks 
d0J1xuhsynEY81YHwAvJ5g: checks 
mYz11CHiw5KsDCRD5T7/jg: bets $0.75
/gJNBeCkWL4o85/jvlZ4BA: folds 
d0J1xuhsynEY81YHwAvJ5g: folds 
Uncalled bet ($0.75) returned to mYz11CHiw5KsDCRD5T7/jg
mYz11CHiw5KsDCRD5T7/jg collected $0.75 from pot
*** SUMMARY ***
Total pot $0.75 | Rake $0 
Board [Td As 8h 4c]
Seat 1: RVBrV53KVTJ2T2VL8ucnfw (button) folded before Flop (didn't bet)
Seat 2: /gJNBeCkWL4o85/jvlZ4BA (small blind) folded on the Turn
Seat 3: d0J1xuhsynEY81YHwAvJ5g (big blind) folded on the Turn
Seat 4: fZQg9veL7Dd/Z04ZTjC+wQ folded before Flop (didn't bet)
Seat 5: ErIN0JRL5srYjT6en1f8YQ folded before Flop (didn't bet)
Seat 6: mYz11CHiw5KsDCRD5T7/jg collected ($0.75)




PokerStars Game #59939727270:  Hold'em No Limit ($0.10/$0.25) - 2009/07/01 0:47:22 ET
Table 'QegsWX65l3n/K0A8XB78yg' 6-max Seat #1 is the button
Seat 1: 8ClCHtFXGNplITm+63KB+Q ($28.25 in chips) 
Seat 2: GC/9yVD59DUCX7hUI7gcLw ($32.30 in chips) 
Seat 3: 9jSiy0meE9XJKkdIZwyTEQ ($26.65 in chips) 
Seat 4: kyRaCIljYA6l33lSKQfNsg ($25.70 in chips) 
Seat 5: 4YSTu0Cdzpppe1lUgCZGCQ ($57.45 in chips) 
Seat 6: JE/wJXmjw3bpdmjwvh2pcg ($35.65 in chips) 
GC/9yVD59DUCX7hUI7gcLw: posts small blind $0.10
9jSiy0meE9XJKkdIZwyTEQ: posts big blind $0.25
*** HOLE CARDS ***
kyRaCIljYA6l33lSKQfNsg: folds 
4YSTu0Cdzpppe1lUgCZGCQ: raises $0.75 to $1
JE/wJXmjw3bpdmjwvh2pcg: folds 
8ClCHtFXGNplITm+63KB+Q: folds 
GC/9yVD59DUCX7hUI7gcLw: folds 
9jSiy0meE9XJKkdIZwyTEQ: calls $0.75
*** FLOP *** [7s 8c Ts]
9jSiy0meE9XJKkdIZwyTEQ: checks 
4YSTu0Cdzpppe1lUgCZGCQ: bets $1.25
9jSiy0meE9XJKkdIZwyTEQ: folds 
Uncalled bet ($1.25) returned to 4YSTu0Cdzpppe1lUgCZGCQ
4YSTu0Cdzpppe1lUgCZGCQ collected $2 from pot
4YSTu0Cdzpppe1lUgCZGCQ: doesn't show hand 
*** SUMMARY ***
Total pot $2.10 | Rake $0.10 
Board [7s 8c Ts]
Seat 1: 8ClCHtFXGNplITm+63KB+Q (button) folded before Flop (didn't bet)
Seat 2: GC/9yVD59DUCX7hUI7gcLw (small blind) folded before Flop
Seat 3: 9jSiy0meE9XJKkdIZwyTEQ (big blind) folded on the Flop
Seat 4: kyRaCIljYA6l33lSKQfNsg folded before Flop (didn't bet)
Seat 5: 4YSTu0Cdzpppe1lUgCZGCQ collected ($2)
Seat 6: JE/wJXmjw3bpdmjwvh2pcg folded before Flop (didn't bet)




PokerStars Game #59939727790:  Hold'em No Limit ($0.10/$0.25) - 2009/07/01 0:47:23 ET
Table 'eOXPe2c6mG7DOFKvMsZZfA' 6-max Seat #3 is the button
Seat 1: ShXPHWfjhfmAwLgDdm6bRQ ($14.20 in chips) 
Seat 2: ELW+DKizJhLK7k40PMkD2Q ($56.25 in chips) 
Seat 3: kReyZ6g6Fu3tQ0nyjDf9kA ($29.30 in chips) 
Seat 4: zHHLkD2sRljslKKeQv/ZQw ($41.75 in chips) 
Seat 5: NhUN/JpAprdJeamFBgJH1w ($25.35 in chips) 
Seat 6: wKFJ513ucluNNiMlkXcDOQ ($25 in chips) 
zHHLkD2sRljslKKeQv/ZQw: posts small blind $0.10
NhUN/JpAprdJeamFBgJH1w: posts big blind $0.25
*** HOLE CARDS ***
wKFJ513ucluNNiMlkXcDOQ: folds 
ShXPHWfjhfmAwLgDdm6bRQ: calls $0.25
ELW+DKizJhLK7k40PMkD2Q: folds 
kReyZ6g6Fu3tQ0nyjDf9kA: folds 
wKFJ513ucluNNiMlkXcDOQ leaves the table
zHHLkD2sRljslKKeQv/ZQw: calls $0.15
NhUN/JpAprdJeamFBgJH1w: checks 
*** FLOP *** [2h Kc Jc]
zHHLkD2sRljslKKeQv/ZQw: checks 
NhUN/JpAprdJeamFBgJH1w: checks 
ShXPHWfjhfmAwLgDdm6bRQ: checks 
*** TURN *** [2h Kc Jc] [Ts]
zHHLkD2sRljslKKeQv/ZQw: checks 
NhUN/JpAprdJeamFBgJH1w: checks 
ShXPHWfjhfmAwLgDdm6bRQ: checks 
*** RIVER *** [2h Kc Jc Ts] [4s]
njVkfGYrPiXfq4zLcgfVuA joins the table at seat #6 
zHHLkD2sRljslKKeQv/ZQw: checks 
NhUN/JpAprdJeamFBgJH1w: checks 
ShXPHWfjhfmAwLgDdm6bRQ: checks 
*** SHOW DOWN ***
zHHLkD2sRljslKKeQv/ZQw: shows [9s 7c] (high card King)
NhUN/JpAprdJeamFBgJH1w: mucks hand 
ShXPHWfjhfmAwLgDdm6bRQ: shows [3s 3c] (a pair of Threes)
ShXPHWfjhfmAwLgDdm6bRQ collected $0.75 from pot
*** SUMMARY ***
Total pot $0.75 | Rake $0 
Board [2h Kc Jc Ts 4s]
Seat 1: ShXPHWfjhfmAwLgDdm6bRQ showed [3s 3c] and won ($0.75) with a pair of Threes
Seat 2: ELW+DKizJhLK7k40PMkD2Q folded before Flop (didn't bet)
Seat 3: kReyZ6g6Fu3tQ0nyjDf9kA (button) folded before Flop (didn't bet)
Seat 4: zHHLkD2sRljslKKeQv/ZQw (small blind) showed [9s 7c] and lost with high card King
Seat 5: NhUN/JpAprdJeamFBgJH1w (big blind) mucked
Seat 6: wKFJ513ucluNNiMlkXcDOQ folded before Flop (didn't bet)




PokerStars Game #59939727654:  Hold'em No Limit ($0.10/$0.25) - 2009/07/01 0:47:23 ET
Table 'nQC9LRg01NEuKFHF1nrDEw0XPo7K54oZIfG0xlNAcDRw-max Seat #4 is the button
Seat 1: Nj6/PdBvfG79w0yeIjPmmA ($13.70 in chips) 
Seat 2: cPO/1/dTcZpLkQFm3jH3Rg ($32.70 in chips) 
Seat 3: 6+g0Lb6vfRDZkElV8ieHyQ ($29.95 in chips) 
Seat 4: tLM9aw7T3kBEIhQEh1roOg ($8.70 in chips) 
Seat 5: kG34n23qFQA3nzdOJTQ1dA ($27.90 in chips) 
Seat 6: xQVFeVUDopz+akuEo2wXpQ ($45.15 in chips) 
kG34n23qFQA3nzdOJTQ1dA: posts small blind $0.10
xQVFeVUDopz+akuEo2wXpQ: posts big blind $0.25
*** HOLE CARDS ***
Nj6/PdBvfG79w0yeIjPmmA: calls $0.25
cPO/1/dTcZpLkQFm3jH3Rg: folds 
6+g0Lb6vfRDZkElV8ieHyQ: folds 
tLM9aw7T3kBEIhQEh1roOg: folds 
kG34n23qFQA3nzdOJTQ1dA: folds 
xQVFeVUDopz+akuEo2wXpQ: raises $1.25 to $1.50
Nj6/PdBvfG79w0yeIjPmmA: calls $1.25
*** FLOP *** [Ks 5c Ah]
xQVFeVUDopz+akuEo2wXpQ: checks 
Nj6/PdBvfG79w0yeIjPmmA: checks 
*** TURN *** [Ks 5c Ah] [8h]
xQVFeVUDopz+akuEo2wXpQ: bets $1.75
Nj6/PdBvfG79w0yeIjPmmA: calls $1.75
*** RIVER *** [Ks 5c Ah 8h] [Qh]
xQVFeVUDopz+akuEo2wXpQ: checks 
Nj6/PdBvfG79w0yeIjPmmA: checks 
*** SHOW DOWN ***
xQVFeVUDopz+akuEo2wXpQ: shows [Jc Js] (a pair of Jacks)
Nj6/PdBvfG79w0yeIjPmmA: mucks hand 
xQVFeVUDopz+akuEo2wXpQ collected $6.30 from pot
*** SUMMARY ***
Total pot $6.60 | Rake $0.30 
Board [Ks 5c Ah 8h Qh]
Seat 1: Nj6/PdBvfG79w0yeIjPmmA mucked
Seat 2: cPO/1/dTcZpLkQFm3jH3Rg folded before Flop (didn't bet)
Seat 3: 6+g0Lb6vfRDZkElV8ieHyQ folded before Flop (didn't bet)
Seat 4: tLM9aw7T3kBEIhQEh1roOg (button) folded before Flop (didn't bet)
Seat 5: kG34n23qFQA3nzdOJTQ1dA (small blind) folded before Flop
Seat 6: xQVFeVUDopz+akuEo2wXpQ (big blind) showed [Jc Js] and won ($6.30) with a pair of Jacks




PokerStars Game #59939727700:  Hold'em No Limit ($0.10/$0.25) - 2009/07/01 0:47:23 ET
Table 'HzFR0rxmDAPu5GzYR0AlYg' 6-max Seat #6 is the button
Seat 1: v+QfkGiuj9bgtuNoVnDO8w ($25 in chips) 
Seat 2: UA5OsKS3VPaxa7uC8La/kA ($50.15 in chips) 
Seat 3: lfAPI6VglUPipZe8BpDaTA ($24.35 in chips) 
Seat 4: uy9x0X5l7O+IpGjLa77QgQ ($64.75 in chips) 
Seat 5: lquriepNQBhDV5P1SWHhnA ($25.35 in chips) 
Seat 6: jp34e617tIzV8tKIWmfAbA ($26.25 in chips) 
v+QfkGiuj9bgtuNoVnDO8w: posts small blind $0.10
UA5OsKS3VPaxa7uC8La/kA: posts big blind $0.25
*** HOLE CARDS ***
lfAPI6VglUPipZe8BpDaTA: raises $0.25 to $0.50
uy9x0X5l7O+IpGjLa77QgQ: folds 
lquriepNQBhDV5P1SWHhnA: raises $0.50 to $1
jp34e617tIzV8tKIWmfAbA: folds 
v+QfkGiuj9bgtuNoVnDO8w: folds 
UA5OsKS3VPaxa7uC8La/kA: folds 
lfAPI6VglUPipZe8BpDaTA: calls $0.50
*** FLOP *** [Ah Kc Js]
lfAPI6VglUPipZe8BpDaTA: checks 
lquriepNQBhDV5P1SWHhnA: bets $1.25
lfAPI6VglUPipZe8BpDaTA: calls $1.25
*** TURN *** [Ah Kc Js] [6h]
lfAPI6VglUPipZe8BpDaTA: checks 
lquriepNQBhDV5P1SWHhnA: checks 
*** RIVER *** [Ah Kc Js 6h] [3c]
lfAPI6VglUPipZe8BpDaTA: checks 
lquriepNQBhDV5P1SWHhnA: checks 
*** SHOW DOWN ***
lfAPI6VglUPipZe8BpDaTA: shows [Td Th] (a pair of Tens)
lquriepNQBhDV5P1SWHhnA: shows [Ks Qh] (a pair of Kings)
lquriepNQBhDV5P1SWHhnA collected $4.65 from pot
*** SUMMARY ***
Total pot $4.85 | Rake $0.20 
Board [Ah Kc Js 6h 3c]
Seat 1: v+QfkGiuj9bgtuNoVnDO8w (small blind) folded before Flop
Seat 2: UA5OsKS3VPaxa7uC8La/kA (big blind) folded before Flop
Seat 3: lfAPI6VglUPipZe8BpDaTA showed [Td Th] and lost with a pair of Tens
Seat 4: uy9x0X5l7O+IpGjLa77QgQ folded before Flop (didn't bet)
Seat 5: lquriepNQBhDV5P1SWHhnA showed [Ks Qh] and won ($4.65) with a pair of Kings
Seat 6: jp34e617tIzV8tKIWmfAbA (button) folded before Flop (didn't bet)




PokerStars Game #59939727652:  Hold'em No Limit ($0.10/$0.25) - 2009/07/01 0:47:23 ET
Table '29D3eoQzK5kOAT0OIDS2uQ' 6-max Seat #1 is the button
Seat 1: kG34n23qFQA3nzdOJTQ1dA ($49.30 in chips) 
Seat 2: eSKnWz2RD4rvwnvB+rFzIg ($24.75 in chips) 
Seat 3: z3tQwy28dp5FykDJC/wzQw ($22.70 in chips) 
Seat 4: yzFNNFIfC89bBPwpFPx2ow ($26 in chips) 
Seat 5: Q3EMN7b0ie81AFWkDrhCjw ($34.15 in chips) 
Seat 6: bWbV4MVB/vVpiES1Ut4hew ($43.90 in chips) 
eSKnWz2RD4rvwnvB+rFzIg: posts small blind $0.10
z3tQwy28dp5FykDJC/wzQw: posts big blind $0.25
*** HOLE CARDS ***
yzFNNFIfC89bBPwpFPx2ow: folds 
Q3EMN7b0ie81AFWkDrhCjw: calls $0.25
bWbV4MVB/vVpiES1Ut4hew: folds 
kG34n23qFQA3nzdOJTQ1dA: folds 
eSKnWz2RD4rvwnvB+rFzIg: folds 
z3tQwy28dp5FykDJC/wzQw: checks 
*** FLOP *** [Ac 6s 6d]
z3tQwy28dp5FykDJC/wzQw: checks 
Q3EMN7b0ie81AFWkDrhCjw: bets $0.75
z3tQwy28dp5FykDJC/wzQw: folds 
Uncalled bet ($0.75) returned to Q3EMN7b0ie81AFWkDrhCjw
yzFNNFIfC89bBPwpFPx2ow leaves the table
Q3EMN7b0ie81AFWkDrhCjw collected $0.60 from pot
*** SUMMARY ***
Total pot $0.60 | Rake $0 
Board [Ac 6s 6d]
Seat 1: kG34n23qFQA3nzdOJTQ1dA (button) folded before Flop (didn't bet)
Seat 2: eSKnWz2RD4rvwnvB+rFzIg (small blind) folded before Flop
Seat 3: z3tQwy28dp5FykDJC/wzQw (big blind) folded on the Flop
Seat 4: yzFNNFIfC89bBPwpFPx2ow folded before Flop (didn't bet)
Seat 5: Q3EMN7b0ie81AFWkDrhCjw collected ($0.60)
Seat 6: bWbV4MVB/vVpiES1Ut4hew folded before Flop (didn't bet)




PokerStars Game #59939727818:  Hold'em No Limit ($0.10/$0.25) - 2009/07/01 0:47:23 ET
Table 'WY+lMaAoIdBZmwk27/RJCA' 6-max Seat #4 is the button
Seat 1: lYjWCpfCxX2kgcHY3v4Yow ($25.70 in chips) 
Seat 2: cPO/1/dTcZpLkQFm3jH3Rg ($26.85 in chips) 
Seat 3: 79Q62AM0VB++TQYiBlOYsA ($36.85 in chips) 
Seat 4: cGfAi40F+9odP4v0stvfiQ ($33.10 in chips) 
Seat 5: wKFJ513ucluNNiMlkXcDOQ ($25 in chips) 
Seat 6: I1TxPvWj8NfG8orglCinNA ($26 in chips) 
wKFJ513ucluNNiMlkXcDOQ: posts small blind $0.10
I1TxPvWj8NfG8orglCinNA: posts big blind $0.25
*** HOLE CARDS ***
lYjWCpfCxX2kgcHY3v4Yow: folds 
cPO/1/dTcZpLkQFm3jH3Rg: folds 
79Q62AM0VB++TQYiBlOYsA: folds 
cGfAi40F+9odP4v0stvfiQ: calls $0.25
wKFJ513ucluNNiMlkXcDOQ: folds 
I1TxPvWj8NfG8orglCinNA: checks 
*** FLOP *** [5d 9c 8s]
I1TxPvWj8NfG8orglCinNA: checks 
cGfAi40F+9odP4v0stvfiQ: checks 
*** TURN *** [5d 9c 8s] [4c]
I1TxPvWj8NfG8orglCinNA: checks 
cGfAi40F+9odP4v0stvfiQ: bets $0.75
I1TxPvWj8NfG8orglCinNA: folds 
Uncalled bet ($0.75) returned to cGfAi40F+9odP4v0stvfiQ
cGfAi40F+9odP4v0stvfiQ collected $0.60 from pot
*** SUMMARY ***
Total pot $0.60 | Rake $0 
Board [5d 9c 8s 4c]
Seat 1: lYjWCpfCxX2kgcHY3v4Yow folded before Flop (didn't bet)
Seat 2: cPO/1/dTcZpLkQFm3jH3Rg folded before Flop (didn't bet)
Seat 3: 79Q62AM0VB++TQYiBlOYsA folded before Flop (didn't bet)
Seat 4: cGfAi40F+9odP4v0stvfiQ (button) collected ($0.60)
Seat 5: wKFJ513ucluNNiMlkXcDOQ (small blind) folded before Flop
Seat 6: I1TxPvWj8NfG8orglCinNA (big blind) folded on the Turn




PokerStars Game #59939727724:  Hold'em No Limit ($0.10/$0.25) - 2009/07/01 0:47:23 ET
Table 'SgI2Cobdjtkh0Fd0/eTTDg' 9-max Seat #9 is the button
Seat 1: NcPAt5YjVvDFEJTTgAVj8g ($15.10 in chips) 
Seat 2: 8B/dhbQjIWe6ASCdgzktNQ ($45.35 in chips) 
Seat 3: OiV1PWZ3IkN29JlmCcnTwQ ($4.55 in chips) 
Seat 4: 18G4P1XstjNvItdGUITxgw ($25 in chips) 
Seat 5: w/RUHfVzKTf7Bc19nucLpQ ($18.10 in chips) 
Seat 7: aJy680tKSaP5er559aSuGA ($16.50 in chips) 
Seat 9: cZ99hugmLBj9KhTlc8nCSw ($25 in chips) 
NcPAt5YjVvDFEJTTgAVj8g: posts small blind $0.10
8B/dhbQjIWe6ASCdgzktNQ: posts big blind $0.25
6RiVTYll/5D8zICp0MRpKw: sits out 
*** HOLE CARDS ***
OiV1PWZ3IkN29JlmCcnTwQ: folds 
18G4P1XstjNvItdGUITxgw: folds 
w/RUHfVzKTf7Bc19nucLpQ: folds 
aJy680tKSaP5er559aSuGA: raises $0.50 to $0.75
cZ99hugmLBj9KhTlc8nCSw: folds 
NcPAt5YjVvDFEJTTgAVj8g: folds 
8B/dhbQjIWe6ASCdgzktNQ: folds 
Uncalled bet ($0.50) returned to aJy680tKSaP5er559aSuGA
aJy680tKSaP5er559aSuGA collected $0.60 from pot
*** SUMMARY ***
Total pot $0.60 | Rake $0 
Seat 1: NcPAt5YjVvDFEJTTgAVj8g (small blind) folded before Flop
Seat 2: 8B/dhbQjIWe6ASCdgzktNQ (big blind) folded before Flop
Seat 3: OiV1PWZ3IkN29JlmCcnTwQ folded before Flop (didn't bet)
Seat 4: 18G4P1XstjNvItdGUITxgw folded before Flop (didn't bet)
Seat 5: w/RUHfVzKTf7Bc19nucLpQ folded before Flop (didn't bet)
Seat 7: aJy680tKSaP5er559aSuGA collected ($0.60)
Seat 9: cZ99hugmLBj9KhTlc8nCSw (button) folded before Flop (didn't bet)




PokerStars Game #59939727620:  Hold'em No Limit ($0.10/$0.25) - 2009/07/01 0:47:23 ET
Table 'ThBZ355rqvsb8UGb6ajbig' 9-max Seat #4 is the button
Seat 2: 4awUyiDYTgylQKXZ9faBVA ($29.25 in chips) 
Seat 3: LBrhQVB4w41YNd7kMYn/og ($8.60 in chips) 
Seat 4: GFNwOPqg/Zu4ZuokgGADNQ ($15.85 in chips) 
Seat 5: BX9NgIrtlXh1K47KYMsMtQ ($8.50 in chips) 
Seat 6: qwr38jl5txoR36M7G5qi4A ($7.50 in chips) 
Seat 7: t2nb95S5EEFOEzNx9Itz0g ($12.45 in chips) 
Seat 8: 6REZ3fl3I5Kaxoupd8cnLg ($28.70 in chips) 
Seat 9: 8B/dhbQjIWe6ASCdgzktNQ ($38.50 in chips) 
BX9NgIrtlXh1K47KYMsMtQ: posts small blind $0.10
qwr38jl5txoR36M7G5qi4A: posts big blind $0.25
cZ99hugmLBj9KhTlc8nCSw: sits out 
*** HOLE CARDS ***
t2nb95S5EEFOEzNx9Itz0g: folds 
6REZ3fl3I5Kaxoupd8cnLg: folds 
8B/dhbQjIWe6ASCdgzktNQ: folds 
4awUyiDYTgylQKXZ9faBVA: raises $0.75 to $1
LBrhQVB4w41YNd7kMYn/og: folds 
GFNwOPqg/Zu4ZuokgGADNQ: calls $1
BX9NgIrtlXh1K47KYMsMtQ: folds 
qwr38jl5txoR36M7G5qi4A: folds 
*** FLOP *** [4c 7s Js]
4awUyiDYTgylQKXZ9faBVA: bets $1.25
GFNwOPqg/Zu4ZuokgGADNQ: calls $1.25
*** TURN *** [4c 7s Js] [8c]
4awUyiDYTgylQKXZ9faBVA: checks 
GFNwOPqg/Zu4ZuokgGADNQ: checks 
*** RIVER *** [4c 7s Js 8c] [Kd]
4awUyiDYTgylQKXZ9faBVA: bets $3
GFNwOPqg/Zu4ZuokgGADNQ: calls $3
*** SHOW DOWN ***
4awUyiDYTgylQKXZ9faBVA: shows [Kh Ts] (a pair of Kings)
GFNwOPqg/Zu4ZuokgGADNQ: mucks hand 
4awUyiDYTgylQKXZ9faBVA collected $10.35 from pot
*** SUMMARY ***
Total pot $10.85 | Rake $0.50 
Board [4c 7s Js 8c Kd]
Seat 2: 4awUyiDYTgylQKXZ9faBVA showed [Kh Ts] and won ($10.35) with a pair of Kings
Seat 3: LBrhQVB4w41YNd7kMYn/og folded before Flop (didn't bet)
Seat 4: GFNwOPqg/Zu4ZuokgGADNQ (button) mucked
Seat 5: BX9NgIrtlXh1K47KYMsMtQ (small blind) folded before Flop
Seat 6: qwr38jl5txoR36M7G5qi4A (big blind) folded before Flop
Seat 7: t2nb95S5EEFOEzNx9Itz0g folded before Flop (didn't bet)
Seat 8: 6REZ3fl3I5Kaxoupd8cnLg folded before Flop (didn't bet)
Seat 9: 8B/dhbQjIWe6ASCdgzktNQ folded before Flop (didn't bet)




PokerStars Game #59939728584:  Hold'em No Limit ($0.10/$0.25) - 2009/07/01 0:47:24 ET
Table 'U0hCzoS0KCJL+eoE054K4Q' 9-max Seat #9 is the button
Seat 1: CYkY0dNBaYaKs8HVCVn3mQ ($4.75 in chips) 
Seat 2: MG90wfSJZnOejs/KD3vlQQ ($27.30 in chips) 
Seat 3: u/r4MjA69AbvOh1qLp6Eig ($14 in chips) 
Seat 4: REZJH+hR80RwfrJtUNUJOw ($32.25 in chips) 
Seat 5: gN5V9qraLHmhKzjLHzt7qA ($16.20 in chips) 
Seat 7: NNZypfH1f/VIj3Skf/XIzg ($4.65 in chips) 
Seat 8: K0b5wNInj6hUGRr6yzKFtw ($25 in chips) 
Seat 9: X9HkgGdfFul8DB9rhTbyFw ($34.85 in chips) 
CYkY0dNBaYaKs8HVCVn3mQ: posts small blind $0.10
MG90wfSJZnOejs/KD3vlQQ: posts big blind $0.25
V6p0jQ/RhUsqpHLmXvEX4Q: sits out 
K0b5wNInj6hUGRr6yzKFtw: posts big blind $0.25
*** HOLE CARDS ***
u/r4MjA69AbvOh1qLp6Eig: raises $0.75 to $1
REZJH+hR80RwfrJtUNUJOw: folds 
gN5V9qraLHmhKzjLHzt7qA: calls $1
NNZypfH1f/VIj3Skf/XIzg: folds 
K0b5wNInj6hUGRr6yzKFtw: calls $0.75
X9HkgGdfFul8DB9rhTbyFw: folds 
CYkY0dNBaYaKs8HVCVn3mQ: folds 
MG90wfSJZnOejs/KD3vlQQ: calls $0.75
*** FLOP *** [8s Qd 3s]
MG90wfSJZnOejs/KD3vlQQ: checks 
u/r4MjA69AbvOh1qLp6Eig: checks 
gN5V9qraLHmhKzjLHzt7qA: checks 
K0b5wNInj6hUGRr6yzKFtw: bets $2.75
MG90wfSJZnOejs/KD3vlQQ: folds 
u/r4MjA69AbvOh1qLp6Eig: folds 
gN5V9qraLHmhKzjLHzt7qA: folds 
Uncalled bet ($2.75) returned to K0b5wNInj6hUGRr6yzKFtw
K0b5wNInj6hUGRr6yzKFtw collected $3.90 from pot
K0b5wNInj6hUGRr6yzKFtw: doesn't show hand 
*** SUMMARY ***
Total pot $4.10 | Rake $0.20 
Board [8s Qd 3s]
Seat 1: CYkY0dNBaYaKs8HVCVn3mQ (small blind) folded before Flop
Seat 2: MG90wfSJZnOejs/KD3vlQQ (big blind) folded on the Flop
Seat 3: u/r4MjA69AbvOh1qLp6Eig folded on the Flop
Seat 4: REZJH+hR80RwfrJtUNUJOw folded before Flop (didn't bet)
Seat 5: gN5V9qraLHmhKzjLHzt7qA folded on the Flop
Seat 7: NNZypfH1f/VIj3Skf/XIzg folded before Flop (didn't bet)
Seat 8: K0b5wNInj6hUGRr6yzKFtw collected ($3.90)
Seat 9: X9HkgGdfFul8DB9rhTbyFw (button) folded before Flop (didn't bet)




PokerStars Game #59939728846:  Hold'em No Limit ($0.10/$0.25) - 2009/07/01 0:47:24 ET
Table 'RuT55t7dqtns1CdLsutksg' 9-max Seat #5 is the button
Seat 1: N6WEabmk+J6IGeE7kub1QQ ($38.85 in chips) 
Seat 2: CYkY0dNBaYaKs8HVCVn3mQ ($5 in chips) 
Seat 3: xOx0qYgTfvbPkTa+GuX0WA ($16 in chips) 
Seat 4: MG90wfSJZnOejs/KD3vlQQ ($26.70 in chips) 
Seat 5: 0D3Q+hLxjPei/5wgaaYhZA ($9.65 in chips) 
Seat 6: CqwJk5Z2+vb2f9j1o7IjKQ ($13.60 in chips) 
Seat 7: 7wo6Sr7QG3Zo6BaBDV1BOw ($5 in chips) 
Seat 8: yyG4svzOpC1A+sUP/scg6w ($7.15 in chips) 
Seat 9: 42xLFHn85WRGGaaUZTNvwA ($5.55 in chips) 
CqwJk5Z2+vb2f9j1o7IjKQ: posts small blind $0.10
7wo6Sr7QG3Zo6BaBDV1BOw: posts big blind $0.25
*** HOLE CARDS ***
yyG4svzOpC1A+sUP/scg6w: folds 
42xLFHn85WRGGaaUZTNvwA: folds 
N6WEabmk+J6IGeE7kub1QQ: folds 
CYkY0dNBaYaKs8HVCVn3mQ: folds 
xOx0qYgTfvbPkTa+GuX0WA: calls $0.25
MG90wfSJZnOejs/KD3vlQQ: folds 
0D3Q+hLxjPei/5wgaaYhZA: raises $0.50 to $0.75
CqwJk5Z2+vb2f9j1o7IjKQ: folds 
7wo6Sr7QG3Zo6BaBDV1BOw: folds 
xOx0qYgTfvbPkTa+GuX0WA: calls $0.50
*** FLOP *** [5h Td 5s]
xOx0qYgTfvbPkTa+GuX0WA: checks 
0D3Q+hLxjPei/5wgaaYhZA: bets $0.75
xOx0qYgTfvbPkTa+GuX0WA: calls $0.75
*** TURN *** [5h Td 5s] [6s]
xOx0qYgTfvbPkTa+GuX0WA: checks 
0D3Q+hLxjPei/5wgaaYhZA: checks 
*** RIVER *** [5h Td 5s 6s] [4d]
xOx0qYgTfvbPkTa+GuX0WA: bets $2
0D3Q+hLxjPei/5wgaaYhZA: folds 
Uncalled bet ($2) returned to xOx0qYgTfvbPkTa+GuX0WA
xOx0qYgTfvbPkTa+GuX0WA collected $3.20 from pot
*** SUMMARY ***
Total pot $3.35 | Rake $0.15 
Board [5h Td 5s 6s 4d]
Seat 1: N6WEabmk+J6IGeE7kub1QQ folded before Flop (didn't bet)
Seat 2: CYkY0dNBaYaKs8HVCVn3mQ folded before Flop (didn't bet)
Seat 3: xOx0qYgTfvbPkTa+GuX0WA collected ($3.20)
Seat 4: MG90wfSJZnOejs/KD3vlQQ folded before Flop (didn't bet)
Seat 5: 0D3Q+hLxjPei/5wgaaYhZA (button) folded on the River
Seat 6: CqwJk5Z2+vb2f9j1o7IjKQ (small blind) folded before Flop
Seat 7: 7wo6Sr7QG3Zo6BaBDV1BOw (big blind) folded before Flop
Seat 8: yyG4svzOpC1A+sUP/scg6w folded before Flop (didn't bet)
Seat 9: 42xLFHn85WRGGaaUZTNvwA folded before Flop (didn't bet)




PokerStars Game #59939728776:  Hold'em No Limit ($0.10/$0.25) - 2009/07/01 0:47:24 ET
Table 'xkqAWQFDrFt4p81M8UsoNw' 9-max Seat #4 is the button
Seat 1: N6fYvIzQLKaydFLKQGtMlQ ($24.65 in chips) 
Seat 2: z5GxcHlYz/GSz6W2uFiTtg ($36.80 in chips) 
Seat 3: HEUqKs2EYYGGXJCepUdL0g ($5.65 in chips) 
Seat 4: gY+PO8PaVC7pBPH/9HSv6Q ($5.30 in chips) 
Seat 5: OiV1PWZ3IkN29JlmCcnTwQ ($4.75 in chips) 
Seat 7: MG90wfSJZnOejs/KD3vlQQ ($51.55 in chips) 
Seat 9: Wa7bjLwN7ptOQro84PxQGw ($4.50 in chips) 
OiV1PWZ3IkN29JlmCcnTwQ: posts small blind $0.10
MG90wfSJZnOejs/KD3vlQQ: posts big blind $0.25
s7Q6uNouhe7aE8JdFb9E+A: sits out 
*** HOLE CARDS ***
Wa7bjLwN7ptOQro84PxQGw: folds 
N6fYvIzQLKaydFLKQGtMlQ: raises $0.75 to $1
z5GxcHlYz/GSz6W2uFiTtg: folds 
6RiVTYll/5D8zICp0MRpKw joins the table at seat #6 
HEUqKs2EYYGGXJCepUdL0g: folds 
gY+PO8PaVC7pBPH/9HSv6Q: folds 
OiV1PWZ3IkN29JlmCcnTwQ: folds 
MG90wfSJZnOejs/KD3vlQQ: folds 
Uncalled bet ($0.75) returned to N6fYvIzQLKaydFLKQGtMlQ
N6fYvIzQLKaydFLKQGtMlQ collected $0.60 from pot
*** SUMMARY ***
Total pot $0.60 | Rake $0 
Seat 1: N6fYvIzQLKaydFLKQGtMlQ collected ($0.60)
Seat 2: z5GxcHlYz/GSz6W2uFiTtg folded before Flop (didn't bet)
Seat 3: HEUqKs2EYYGGXJCepUdL0g folded before Flop (didn't bet)
Seat 4: gY+PO8PaVC7pBPH/9HSv6Q (button) folded before Flop (didn't bet)
Seat 5: OiV1PWZ3IkN29JlmCcnTwQ (small blind) folded before Flop
Seat 7: MG90wfSJZnOejs/KD3vlQQ (big blind) folded before Flop
Seat 9: Wa7bjLwN7ptOQro84PxQGw folded before Flop (didn't bet)




PokerStars Game #59939728732:  Hold'em No Limit ($0.10/$0.25) - 2009/07/01 0:47:24 ET
Table 'TJS4XvvOjO3k7mH74HJw5g' 9-max Seat #8 is the button
Seat 1: SS+d2ix02WTTacMsjCk0OQ ($32.10 in chips) 
Seat 2: ghNKXUBl/H+t83JF079ZBA ($25 in chips) 
Seat 3: 8B/dhbQjIWe6ASCdgzktNQ ($35.70 in chips) 
Seat 5: NNZypfH1f/VIj3Skf/XIzg ($4.30 in chips) 
Seat 7: DiSvPC2iudwL5j9u6Huyww ($25 in chips) 
Seat 8: l9TiQshP7QOsNH6jZrL4Wg ($5.85 in chips) 
Seat 9: +sbyWwIcFp9kP0bDtMegfQ ($32 in chips) 
+sbyWwIcFp9kP0bDtMegfQ: posts small blind $0.10
SS+d2ix02WTTacMsjCk0OQ: posts big blind $0.25
qwr38jl5txoR36M7G5qi4A: sits out 
DnDcAdn9P0zGovMERigpFA: sits out 
*** HOLE CARDS ***
ghNKXUBl/H+t83JF079ZBA: raises $0.75 to $1
8B/dhbQjIWe6ASCdgzktNQ: folds 
NNZypfH1f/VIj3Skf/XIzg: folds 
DiSvPC2iudwL5j9u6Huyww: folds 
l9TiQshP7QOsNH6jZrL4Wg: folds 
+sbyWwIcFp9kP0bDtMegfQ: folds 
SS+d2ix02WTTacMsjCk0OQ: folds 
Uncalled bet ($0.75) returned to ghNKXUBl/H+t83JF079ZBA
ghNKXUBl/H+t83JF079ZBA collected $0.60 from pot
ghNKXUBl/H+t83JF079ZBA: doesn't show hand 
*** SUMMARY ***
Total pot $0.60 | Rake $0 
Seat 1: SS+d2ix02WTTacMsjCk0OQ (big blind) folded before Flop
Seat 2: ghNKXUBl/H+t83JF079ZBA collected ($0.60)
Seat 3: 8B/dhbQjIWe6ASCdgzktNQ folded before Flop (didn't bet)
Seat 5: NNZypfH1f/VIj3Skf/XIzg folded before Flop (didn't bet)
Seat 7: DiSvPC2iudwL5j9u6Huyww folded before Flop (didn't bet)
Seat 8: l9TiQshP7QOsNH6jZrL4Wg (button) folded before Flop (didn't bet)
Seat 9: +sbyWwIcFp9kP0bDtMegfQ (small blind) folded before Flop




PokerStars Game #59939729408:  Hold'em No Limit ($0.10/$0.25) - 2009/07/01 0:47:25 ET
Table 'IIO2q2znuuAXmiZ2qFTcmg' 6-max Seat #4 is the button
Seat 1: nwwpaieDRI0UPyVtChVHOg ($16.65 in chips) 
Seat 2: cS21pIxRHx5Gt42o7hPZzw ($15.35 in chips) 
Seat 3: hiTEr3yrERiQp3zHXRioVw ($41.20 in chips) 
Seat 4: 0HIrwssk0FQvyKULzUTtlg ($11.10 in chips) 
Seat 5: f9iRHw0d+kV7pbTYwF2+2g ($5.15 in chips) 
Seat 6: gqrr7lSWrQ1N8zKx8zZzvA ($10 in chips) 
f9iRHw0d+kV7pbTYwF2+2g: posts small blind $0.10
gqrr7lSWrQ1N8zKx8zZzvA: posts big blind $0.25
*** HOLE CARDS ***
nwwpaieDRI0UPyVtChVHOg: calls $0.25
cS21pIxRHx5Gt42o7hPZzw: folds 
hiTEr3yrERiQp3zHXRioVw: folds 
0HIrwssk0FQvyKULzUTtlg: folds 
f9iRHw0d+kV7pbTYwF2+2g: raises $0.75 to $1
gqrr7lSWrQ1N8zKx8zZzvA: calls $0.75
0HIrwssk0FQvyKULzUTtlg leaves the table
nwwpaieDRI0UPyVtChVHOg: folds 
*** FLOP *** [2s 6c 7h]
f9iRHw0d+kV7pbTYwF2+2g: bets $2.75
gqrr7lSWrQ1N8zKx8zZzvA: folds 
Uncalled bet ($2.75) returned to f9iRHw0d+kV7pbTYwF2+2g
Mxjust3 joins the table at seat #4 
f9iRHw0d+kV7pbTYwF2+2g collected $2.15 from pot
f9iRHw0d+kV7pbTYwF2+2g: doesn't show hand 
*** SUMMARY ***
Total pot $2.25 | Rake $0.10 
Board [2s 6c 7h]
Seat 1: nwwpaieDRI0UPyVtChVHOg folded before Flop
Seat 2: cS21pIxRHx5Gt42o7hPZzw folded before Flop (didn't bet)
Seat 3: hiTEr3yrERiQp3zHXRioVw folded before Flop (didn't bet)
Seat 4: 0HIrwssk0FQvyKULzUTtlg (button) folded before Flop (didn't bet)
Seat 5: f9iRHw0d+kV7pbTYwF2+2g (small blind) collected ($2.15)
Seat 6: gqrr7lSWrQ1N8zKx8zZzvA (big blind) folded on the Flop




PokerStars Game #59939729176:  Hold'em No Limit ($0.10/$0.25) - 2009/07/01 0:47:25 ET
Table '5510FxlYzKi+U6MIpo8IPA' 6-max Seat #2 is the button
Seat 1: KM6ogk7SqyRlk3m9b0h+7A ($19.55 in chips) 
Seat 2: gqW2aBCmrIw65BvwjTFN6Q ($25 in chips) 
Seat 3: v+QfkGiuj9bgtuNoVnDO8w ($34.75 in chips) 
Seat 4: cPO/1/dTcZpLkQFm3jH3Rg ($27.20 in chips) 
Seat 5: 3AX4hJ3s02XVFGkQwPKh3w ($15 in chips) 
Seat 6: SFmT9ZsVopnukjvAzrxTRg ($29.90 in chips) 
v+QfkGiuj9bgtuNoVnDO8w: posts small blind $0.10
cPO/1/dTcZpLkQFm3jH3Rg: posts big blind $0.25
3AX4hJ3s02XVFGkQwPKh3w: posts big blind $0.25
*** HOLE CARDS ***
3AX4hJ3s02XVFGkQwPKh3w: checks 
SFmT9ZsVopnukjvAzrxTRg: raises $1 to $1.25
KM6ogk7SqyRlk3m9b0h+7A: folds 
gqW2aBCmrIw65BvwjTFN6Q: folds 
v+QfkGiuj9bgtuNoVnDO8w: folds 
cPO/1/dTcZpLkQFm3jH3Rg: calls $1
3AX4hJ3s02XVFGkQwPKh3w: folds 
*** FLOP *** [8s 6c Qh]
cPO/1/dTcZpLkQFm3jH3Rg: checks 
SFmT9ZsVopnukjvAzrxTRg: bets $1.50
cPO/1/dTcZpLkQFm3jH3Rg: folds 
Uncalled bet ($1.50) returned to SFmT9ZsVopnukjvAzrxTRg
SFmT9ZsVopnukjvAzrxTRg collected $2.75 from pot
SFmT9ZsVopnukjvAzrxTRg: doesn't show hand 
*** SUMMARY ***
Total pot $2.85 | Rake $0.10 
Board [8s 6c Qh]
Seat 1: KM6ogk7SqyRlk3m9b0h+7A folded before Flop (didn't bet)
Seat 2: gqW2aBCmrIw65BvwjTFN6Q (button) folded before Flop (didn't bet)
Seat 3: v+QfkGiuj9bgtuNoVnDO8w (small blind) folded before Flop
Seat 4: cPO/1/dTcZpLkQFm3jH3Rg (big blind) folded on the Flop
Seat 5: 3AX4hJ3s02XVFGkQwPKh3w folded before Flop
Seat 6: SFmT9ZsVopnukjvAzrxTRg collected ($2.75)




PokerStars Game #59939729098:  Hold'em No Limit ($0.10/$0.25) - 2009/07/01 0:47:25 ET
Table 'srBTB98reCdD1TffxE6o7g' 6-max Seat #3 is the button
Seat 1: FEzezmgaiyVRh9sHKhd+9Q ($44.25 in chips) 
Seat 2: eSKnWz2RD4rvwnvB+rFzIg ($24.65 in chips) 
Seat 3: 4YSTu0Cdzpppe1lUgCZGCQ ($33.20 in chips) 
Seat 4: 6DwBRH+xZ12AAZmeAg+aXw ($26.95 in chips) 
Seat 5: n2OZezRXTtdzQt4SuIy8TQ ($36.50 in chips) 
Seat 6: gaPMxLGp9SOj4Lq6t+/0Ig ($11 in chips) 
6DwBRH+xZ12AAZmeAg+aXw: posts small blind $0.10
n2OZezRXTtdzQt4SuIy8TQ: posts big blind $0.25
*** HOLE CARDS ***
gaPMxLGp9SOj4Lq6t+/0Ig: folds 
FEzezmgaiyVRh9sHKhd+9Q: folds 
eSKnWz2RD4rvwnvB+rFzIg: folds 
4YSTu0Cdzpppe1lUgCZGCQ: folds 
6DwBRH+xZ12AAZmeAg+aXw: folds 
Uncalled bet ($0.15) returned to n2OZezRXTtdzQt4SuIy8TQ
n2OZezRXTtdzQt4SuIy8TQ collected $0.20 from pot
n2OZezRXTtdzQt4SuIy8TQ: doesn't show hand 
*** SUMMARY ***
Total pot $0.20 | Rake $0 
Seat 1: FEzezmgaiyVRh9sHKhd+9Q folded before Flop (didn't bet)
Seat 2: eSKnWz2RD4rvwnvB+rFzIg folded before Flop (didn't bet)
Seat 3: 4YSTu0Cdzpppe1lUgCZGCQ (button) folded before Flop (didn't bet)
Seat 4: 6DwBRH+xZ12AAZmeAg+aXw (small blind) folded before Flop
Seat 5: n2OZezRXTtdzQt4SuIy8TQ (big blind) collected ($0.20)
Seat 6: gaPMxLGp9SOj4Lq6t+/0Ig folded before Flop (didn't bet)




PokerStars Game #59939729092:  Hold'em No Limit ($0.10/$0.25) - 2009/07/01 0:47:25 ET
Table 'wixGE3Zge1qBdnpWijIl/w' 9-max Seat #3 is the button
Seat 1: 86vbuhJsyH+nbEg5qpDLyQ ($25.40 in chips) 
Seat 2: DnDcAdn9P0zGovMERigpFA ($25 in chips) 
Seat 3: DdPXdieucQ+n99u1n3A+rQ ($8.85 in chips) 
Seat 4: 4oA316mXLIui1QY63GXBUg ($25 in chips) 
Seat 5: MIVCHqCqqlke0Lb0z7glcw ($31.25 in chips) 
Seat 6: TlEYI/zXzaKGGsmuvWFd2A ($9.45 in chips) 
Seat 7: qIaaweMCAGmy9HZFT4r/6A ($58.70 in chips) 
Seat 8: hIss79a4pu7GzJZepfgOpg ($25 in chips) 
Seat 9: r6hsffOo1iKmaPYKwAZmFw ($25.85 in chips) 
4oA316mXLIui1QY63GXBUg: posts small blind $0.10
MIVCHqCqqlke0Lb0z7glcw: posts big blind $0.25
*** HOLE CARDS ***
TlEYI/zXzaKGGsmuvWFd2A: raises $1.25 to $1.50
qIaaweMCAGmy9HZFT4r/6A: folds 
hIss79a4pu7GzJZepfgOpg: folds 
r6hsffOo1iKmaPYKwAZmFw: folds 
86vbuhJsyH+nbEg5qpDLyQ: folds 
DnDcAdn9P0zGovMERigpFA: folds 
DdPXdieucQ+n99u1n3A+rQ: folds 
4oA316mXLIui1QY63GXBUg: folds 
MIVCHqCqqlke0Lb0z7glcw: folds 
Uncalled bet ($1.25) returned to TlEYI/zXzaKGGsmuvWFd2A
TlEYI/zXzaKGGsmuvWFd2A collected $0.60 from pot
TlEYI/zXzaKGGsmuvWFd2A: doesn't show hand 
*** SUMMARY ***
Total pot $0.60 | Rake $0 
Seat 1: 86vbuhJsyH+nbEg5qpDLyQ folded before Flop (didn't bet)
Seat 2: DnDcAdn9P0zGovMERigpFA folded before Flop (didn't bet)
Seat 3: DdPXdieucQ+n99u1n3A+rQ (button) folded before Flop (didn't bet)
Seat 4: 4oA316mXLIui1QY63GXBUg (small blind) folded before Flop
Seat 5: MIVCHqCqqlke0Lb0z7glcw (big blind) folded before Flop
Seat 6: TlEYI/zXzaKGGsmuvWFd2A collected ($0.60)
Seat 7: qIaaweMCAGmy9HZFT4r/6A folded before Flop (didn't bet)
Seat 8: hIss79a4pu7GzJZepfgOpg folded before Flop (didn't bet)
Seat 9: r6hsffOo1iKmaPYKwAZmFw folded before Flop (didn't bet)




PokerStars Game #59939729324:  Hold'em No Limit ($0.10/$0.25) - 2009/07/01 0:47:25 ET
Table '1zj0+miaIL9cvwnT/50pOA' 9-max Seat #3 is the button
Seat 1: spidnpwmoJ1L6yeNW7D5UA ($33 in chips) 
Seat 2: HPEB+AtKw1+C/cxU0o1ciw ($28.10 in chips) 
Seat 3: CYkY0dNBaYaKs8HVCVn3mQ ($6 in chips) 
Seat 4: 6esz1u5YivjsX0UoeMBm3w ($19.95 in chips) 
Seat 5: DbN2dZXDtMsRORFhREVeJA ($15 in chips) 
Seat 6: ydoFOVgzvZv9ZhuWu9rXAw ($5 in chips) 
Seat 7: 6oWOdVz2WG2azNuOj9rMgg ($14.20 in chips) 
Seat 8: HOiu48bZMhEZSoJa8mjiMw ($34.35 in chips) 
Seat 9: OiV1PWZ3IkN29JlmCcnTwQ ($5.25 in chips) 
6esz1u5YivjsX0UoeMBm3w: posts small blind $0.10
DbN2dZXDtMsRORFhREVeJA: posts big blind $0.25
*** HOLE CARDS ***
ydoFOVgzvZv9ZhuWu9rXAw: folds 
6oWOdVz2WG2azNuOj9rMgg: calls $0.25
HOiu48bZMhEZSoJa8mjiMw: folds 
OiV1PWZ3IkN29JlmCcnTwQ: folds 
spidnpwmoJ1L6yeNW7D5UA: folds 
HPEB+AtKw1+C/cxU0o1ciw: folds 
CYkY0dNBaYaKs8HVCVn3mQ: raises $0.75 to $1
6esz1u5YivjsX0UoeMBm3w: calls $0.90
DbN2dZXDtMsRORFhREVeJA: folds 
6oWOdVz2WG2azNuOj9rMgg: calls $0.75
*** FLOP *** [4s 8s Js]
6esz1u5YivjsX0UoeMBm3w: checks 
6oWOdVz2WG2azNuOj9rMgg: bets $0.25
CYkY0dNBaYaKs8HVCVn3mQ: folds 
6esz1u5YivjsX0UoeMBm3w: raises $0.25 to $0.50
6oWOdVz2WG2azNuOj9rMgg: raises $0.25 to $0.75
6esz1u5YivjsX0UoeMBm3w: raises $0.75 to $1.50
6oWOdVz2WG2azNuOj9rMgg: calls $0.75
*** TURN *** [4s 8s Js] [7h]
6esz1u5YivjsX0UoeMBm3w: bets $2.25
6oWOdVz2WG2azNuOj9rMgg: calls $2.25
*** RIVER *** [4s 8s Js 7h] [Jh]
6esz1u5YivjsX0UoeMBm3w: checks 
6oWOdVz2WG2azNuOj9rMgg: bets $9.45 and is all-in
6esz1u5YivjsX0UoeMBm3w: calls $9.45
*** SHOW DOWN ***
6oWOdVz2WG2azNuOj9rMgg: shows [9d 8c] (two pair, Jacks and Eights)
6esz1u5YivjsX0UoeMBm3w: shows [Ks 2s] (a flush, King high)
6esz1u5YivjsX0UoeMBm3w collected $28.20 from pot
*** SUMMARY ***
Total pot $29.65 | Rake $1.45 
Board [4s 8s Js 7h Jh]
Seat 1: spidnpwmoJ1L6yeNW7D5UA folded before Flop (didn't bet)
Seat 2: HPEB+AtKw1+C/cxU0o1ciw folded before Flop (didn't bet)
Seat 3: CYkY0dNBaYaKs8HVCVn3mQ (button) folded on the Flop
Seat 4: 6esz1u5YivjsX0UoeMBm3w (small blind) showed [Ks 2s] and won ($28.20) with a flush, King high
Seat 5: DbN2dZXDtMsRORFhREVeJA (big blind) folded before Flop
Seat 6: ydoFOVgzvZv9ZhuWu9rXAw folded before Flop (didn't bet)
Seat 7: 6oWOdVz2WG2azNuOj9rMgg showed [9d 8c] and lost with two pair, Jacks and Eights
Seat 8: HOiu48bZMhEZSoJa8mjiMw folded before Flop (didn't bet)
Seat 9: OiV1PWZ3IkN29JlmCcnTwQ folded before Flop (didn't bet)




PokerStars Game #59939729570:  Hold'em No Limit ($0.10/$0.25) - 2009/07/01 0:47:26 ET
Table '8QBBaev+cI2i/r2H6ml/lg' 9-max Seat #6 is the button
Seat 4: ZoG0obuajzVjwgd7lNHjgg ($4.35 in chips) 
Seat 6: cxE+szmvEUe7vE+z2ozM2Q ($10.65 in chips) 
cxE+szmvEUe7vE+z2ozM2Q: posts small blind $0.10
ZoG0obuajzVjwgd7lNHjgg: posts big blind $0.25
*** HOLE CARDS ***
cxE+szmvEUe7vE+z2ozM2Q: raises $0.25 to $0.50
ZoG0obuajzVjwgd7lNHjgg: calls $0.25
*** FLOP *** [Kd 5d 7d]
J+/gREJjzabbnYljjxEIRA joins the table at seat #1 
ZoG0obuajzVjwgd7lNHjgg: checks 
cxE+szmvEUe7vE+z2ozM2Q: bets $10.15 and is all-in
ZoG0obuajzVjwgd7lNHjgg: folds 
Uncalled bet ($10.15) returned to cxE+szmvEUe7vE+z2ozM2Q
cxE+szmvEUe7vE+z2ozM2Q collected $0.95 from pot
cxE+szmvEUe7vE+z2ozM2Q: doesn't show hand 
*** SUMMARY ***
Total pot $1 | Rake $0.05 
Board [Kd 5d 7d]
Seat 4: ZoG0obuajzVjwgd7lNHjgg (big blind) folded on the Flop
Seat 6: cxE+szmvEUe7vE+z2ozM2Q (button) (small blind) collected ($0.95)




PokerStars Game #59939729574:  Hold'em No Limit ($0.10/$0.25) - 2009/07/01 0:47:26 ET
Table 'iMiAw/kTZXopgYX4HI7sHg' 9-max Seat #6 is the button
Seat 2: qwr38jl5txoR36M7G5qi4A ($7.50 in chips) 
Seat 3: HPEB+AtKw1+C/cxU0o1ciw ($22.05 in chips) 
Seat 4: S+cUFPGjDERB8nh2Ub77Bg ($15 in chips) 
Seat 5: UG5jx0ZzlHKfc+tNQpQoMQ ($2.35 in chips) 
Seat 6: mdk0yKND3u0wCmRU4tNRFg ($27.95 in chips) 
Seat 7: aPRz/2GxbXANYpVsQO8pdQ ($24.75 in chips) 
Seat 8: gU2i78hKxj5RUUH6zCK9bA ($4 in chips) 
Seat 9: K36tHfxDQBx3OFpy0baDPA ($20.75 in chips) 
aPRz/2GxbXANYpVsQO8pdQ: posts small blind $0.10
gU2i78hKxj5RUUH6zCK9bA: posts big blind $0.25
1Clf3cPrqoy/YgvWdWK1Xw: sits out 
*** HOLE CARDS ***
K36tHfxDQBx3OFpy0baDPA: folds 
qwr38jl5txoR36M7G5qi4A: folds 
HPEB+AtKw1+C/cxU0o1ciw: folds 
S+cUFPGjDERB8nh2Ub77Bg: calls $0.25
UG5jx0ZzlHKfc+tNQpQoMQ: folds 
mdk0yKND3u0wCmRU4tNRFg: calls $0.25
aPRz/2GxbXANYpVsQO8pdQ: folds 
gU2i78hKxj5RUUH6zCK9bA: checks 
*** FLOP *** [Th 4s 9d]
gU2i78hKxj5RUUH6zCK9bA: checks 
S+cUFPGjDERB8nh2Ub77Bg: bets $0.25
mdk0yKND3u0wCmRU4tNRFg: folds 
gU2i78hKxj5RUUH6zCK9bA: folds 
Uncalled bet ($0.25) returned to S+cUFPGjDERB8nh2Ub77Bg
S+cUFPGjDERB8nh2Ub77Bg collected $0.85 from pot
S+cUFPGjDERB8nh2Ub77Bg: doesn't show hand 
*** SUMMARY ***
Total pot $0.85 | Rake $0 
Board [Th 4s 9d]
Seat 2: qwr38jl5txoR36M7G5qi4A folded before Flop (didn't bet)
Seat 3: HPEB+AtKw1+C/cxU0o1ciw folded before Flop (didn't bet)
Seat 4: S+cUFPGjDERB8nh2Ub77Bg collected ($0.85)
Seat 5: UG5jx0ZzlHKfc+tNQpQoMQ folded before Flop (didn't bet)
Seat 6: mdk0yKND3u0wCmRU4tNRFg (button) folded on the Flop
Seat 7: aPRz/2GxbXANYpVsQO8pdQ (small blind) folded before Flop
Seat 8: gU2i78hKxj5RUUH6zCK9bA (big blind) folded on the Flop
Seat 9: K36tHfxDQBx3OFpy0baDPA folded before Flop (didn't bet)




PokerStars Game #59939730112:  Hold'em No Limit ($0.10/$0.25) - 2009/07/01 0:47:26 ET
Table 'xmJKTGBeWCwutccj3YfupQ' 6-max Seat #5 is the button
Seat 5: oBUDUfeUyCbZBsjxHZgSiw ($16.30 in chips) 
oBUDUfeUyCbZBsjxHZgSiw: posts small blind $0.10
BedjMfrlRfPgSq7CXpPAmg: is sitting out 
Hand cancelled
*** SUMMARY ***
Seat 5: oBUDUfeUyCbZBsjxHZgSiw (button) collected ($0)




PokerStars Game #59939729724:  Hold'em No Limit ($0.10/$0.25) - 2009/07/01 0:47:26 ET
Table 'ShgkxBDL5IvR1qjzfRNc0A' 6-max Seat #5 is the button
Seat 1: /gJNBeCkWL4o85/jvlZ4BA ($25 in chips) 
Seat 2: mfrkWA3PTeYPkbO6hi98Aw ($35 in chips) 
Seat 3: JXSfL0FgBM1dIFwHP09Hnw ($33.50 in chips) 
Seat 4: kG34n23qFQA3nzdOJTQ1dA ($24.90 in chips) 
Seat 5: ferjiUxLWPNUKxvl8/xD/g ($48.85 in chips) 
Seat 6: 5tB0F9NjPSUL4FzmzBMs2Q ($27.45 in chips) 
5tB0F9NjPSUL4FzmzBMs2Q: posts small blind $0.10
/gJNBeCkWL4o85/jvlZ4BA: posts big blind $0.25
*** HOLE CARDS ***
mfrkWA3PTeYPkbO6hi98Aw: folds 
JXSfL0FgBM1dIFwHP09Hnw: folds 
kG34n23qFQA3nzdOJTQ1dA: folds 
ferjiUxLWPNUKxvl8/xD/g: folds 
5tB0F9NjPSUL4FzmzBMs2Q: folds 
Uncalled bet ($0.15) returned to /gJNBeCkWL4o85/jvlZ4BA
/gJNBeCkWL4o85/jvlZ4BA collected $0.20 from pot
*** SUMMARY ***
Total pot $0.20 | Rake $0 
Seat 1: /gJNBeCkWL4o85/jvlZ4BA (big blind) collected ($0.20)
Seat 2: mfrkWA3PTeYPkbO6hi98Aw folded before Flop (didn't bet)
Seat 3: JXSfL0FgBM1dIFwHP09Hnw folded before Flop (didn't bet)
Seat 4: kG34n23qFQA3nzdOJTQ1dA folded before Flop (didn't bet)
Seat 5: ferjiUxLWPNUKxvl8/xD/g (button) folded before Flop (didn't bet)
Seat 6: 5tB0F9NjPSUL4FzmzBMs2Q (small blind) folded before Flop




PokerStars Game #59939729928:  Hold'em No Limit ($0.10/$0.25) - 2009/07/01 0:47:26 ET
Table 'mF3KHGMaTpaBZbtBoyfTeg' 6-max Seat #3 is the button
Seat 1: 0HAB2GdCAM7p7V00xueAVQ ($8.30 in chips) 
Seat 2: 4x9jCqgSw4272dnaIqnanw ($3.75 in chips) 
Seat 3: Hzrn9DZJegEZICufTNYkrg ($13.05 in chips) 
Seat 4: FYepjhAvF8ZdVCmqHIy+eQ ($25 in chips) 
Seat 5: sEQx9G5Cu8k1HNdQasxvUA ($41.30 in chips) 
Seat 6: kG34n23qFQA3nzdOJTQ1dA ($24.40 in chips) 
FYepjhAvF8ZdVCmqHIy+eQ: posts small blind $0.10
sEQx9G5Cu8k1HNdQasxvUA: posts big blind $0.25
*** HOLE CARDS ***
kG34n23qFQA3nzdOJTQ1dA: folds 
0HAB2GdCAM7p7V00xueAVQ: folds 
4x9jCqgSw4272dnaIqnanw: folds 
Hzrn9DZJegEZICufTNYkrg: folds 
FYepjhAvF8ZdVCmqHIy+eQ: folds 
Uncalled bet ($0.15) returned to sEQx9G5Cu8k1HNdQasxvUA
sEQx9G5Cu8k1HNdQasxvUA collected $0.20 from pot
sEQx9G5Cu8k1HNdQasxvUA: doesn't show hand 
*** SUMMARY ***
Total pot $0.20 | Rake $0 
Seat 1: 0HAB2GdCAM7p7V00xueAVQ folded before Flop (didn't bet)
Seat 2: 4x9jCqgSw4272dnaIqnanw folded before Flop (didn't bet)
Seat 3: Hzrn9DZJegEZICufTNYkrg (button) folded before Flop (didn't bet)
Seat 4: FYepjhAvF8ZdVCmqHIy+eQ (small blind) folded before Flop
Seat 5: sEQx9G5Cu8k1HNdQasxvUA (big blind) collected ($0.20)
Seat 6: kG34n23qFQA3nzdOJTQ1dA folded before Flop (didn't bet)




PokerStars Game #59939729628:  Hold'em No Limit ($0.10/$0.25) - 2009/07/01 0:47:26 ET
Table 'nlpa8xI95gAflovnFxB2yg' 6-max Seat #1 is the button
Seat 1: fZQg9veL7Dd/Z04ZTjC+wQ ($67.20 in chips) 
Seat 2: WrLI51S2iMb8GLMB83gGqA ($25 in chips) 
Seat 3: I1TxPvWj8NfG8orglCinNA ($26.40 in chips) 
Seat 4: 5xjU9nfIjn1MBxIJKZvS5w ($29.85 in chips) 
Seat 5: 6DwBRH+xZ12AAZmeAg+aXw ($26.25 in chips) 
Seat 6: FPlQHZog0ePFCETQ2KG4hQ ($25 in chips) 
WrLI51S2iMb8GLMB83gGqA: posts small blind $0.10
I1TxPvWj8NfG8orglCinNA: posts big blind $0.25
*** HOLE CARDS ***
5xjU9nfIjn1MBxIJKZvS5w: calls $0.25
6DwBRH+xZ12AAZmeAg+aXw: folds 
FPlQHZog0ePFCETQ2KG4hQ: folds 
fZQg9veL7Dd/Z04ZTjC+wQ: raises $1 to $1.25
WrLI51S2iMb8GLMB83gGqA: folds 
I1TxPvWj8NfG8orglCinNA: folds 
5xjU9nfIjn1MBxIJKZvS5w: calls $1
*** FLOP *** [Ac 6c 5h]
5xjU9nfIjn1MBxIJKZvS5w: checks 
fZQg9veL7Dd/Z04ZTjC+wQ: checks 
*** TURN *** [Ac 6c 5h] [8h]
5xjU9nfIjn1MBxIJKZvS5w: bets $0.50
fZQg9veL7Dd/Z04ZTjC+wQ: raises $3.25 to $3.75
5xjU9nfIjn1MBxIJKZvS5w: calls $3.25
*** RIVER *** [Ac 6c 5h 8h] [6s]
5xjU9nfIjn1MBxIJKZvS5w: checks 
fZQg9veL7Dd/Z04ZTjC+wQ: checks 
*** SHOW DOWN ***
5xjU9nfIjn1MBxIJKZvS5w: shows [Ad Jh] (two pair, Aces and Sixes)
fZQg9veL7Dd/Z04ZTjC+wQ: mucks hand 
5xjU9nfIjn1MBxIJKZvS5w collected $9.85 from pot
*** SUMMARY ***
Total pot $10.35 | Rake $0.50 
Board [Ac 6c 5h 8h 6s]
Seat 1: fZQg9veL7Dd/Z04ZTjC+wQ (button) mucked
Seat 2: WrLI51S2iMb8GLMB83gGqA (small blind) folded before Flop
Seat 3: I1TxPvWj8NfG8orglCinNA (big blind) folded before Flop
Seat 4: 5xjU9nfIjn1MBxIJKZvS5w showed [Ad Jh] and won ($9.85) with two pair, Aces and Sixes
Seat 5: 6DwBRH+xZ12AAZmeAg+aXw folded before Flop (didn't bet)
Seat 6: FPlQHZog0ePFCETQ2KG4hQ folded before Flop (didn't bet)




PokerStars Game #59939730080:  Hold'em No Limit ($0.10/$0.25) - 2009/07/01 0:47:26 ET
Table '/XCUCUl3yW6tdTJQEhJKGw' 6-max Seat #2 is the button
Seat 1: p8J112JmNRnCwV2+NAEzCA ($19.75 in chips) 
Seat 2: 8ClCHtFXGNplITm+63KB+Q ($28.15 in chips) 
Seat 3: /gJNBeCkWL4o85/jvlZ4BA ($35.50 in chips) 
Seat 4: SFmT9ZsVopnukjvAzrxTRg ($25.35 in chips) 
Seat 5: rf9ho6cin0bk70nP86p3rQ ($15.20 in chips) 
Seat 6: armfxZhGxeZVZBYAQFuIJQ ($34.65 in chips) 
/gJNBeCkWL4o85/jvlZ4BA: posts small blind $0.10
SFmT9ZsVopnukjvAzrxTRg: posts big blind $0.25
*** HOLE CARDS ***
rf9ho6cin0bk70nP86p3rQ: calls $0.25
armfxZhGxeZVZBYAQFuIJQ: folds 
p8J112JmNRnCwV2+NAEzCA: folds 
8ClCHtFXGNplITm+63KB+Q: folds 
/gJNBeCkWL4o85/jvlZ4BA: raises $1 to $1.25
SFmT9ZsVopnukjvAzrxTRg: folds 
rf9ho6cin0bk70nP86p3rQ: folds 
Uncalled bet ($1) returned to /gJNBeCkWL4o85/jvlZ4BA
/gJNBeCkWL4o85/jvlZ4BA collected $0.75 from pot
*** SUMMARY ***
Total pot $0.75 | Rake $0 
Seat 1: p8J112JmNRnCwV2+NAEzCA folded before Flop (didn't bet)
Seat 2: 8ClCHtFXGNplITm+63KB+Q (button) folded before Flop (didn't bet)
Seat 3: /gJNBeCkWL4o85/jvlZ4BA (small blind) collected ($0.75)
Seat 4: SFmT9ZsVopnukjvAzrxTRg (big blind) folded before Flop
Seat 5: rf9ho6cin0bk70nP86p3rQ folded before Flop
Seat 6: armfxZhGxeZVZBYAQFuIJQ folded before Flop (didn't bet)




PokerStars Game #59939730554:  Hold'em No Limit ($0.10/$0.25) - 2009/07/01 0:47:27 ET
Table 'fIMYcWwN4/aXFJvH5Z8Ymg' 6-max Seat #6 is the button
Seat 1: 64ZeDpsBsP594VsWmafRTQ ($8.30 in chips) 
Seat 2: vu2kzHaDtgr6NM7rdq0chA ($28.90 in chips) 
Seat 3: bWbV4MVB/vVpiES1Ut4hew ($46.25 in chips) 
Seat 4: 32YL2ZEp8NT4JB2RVM9euQ ($42.55 in chips) 
Seat 5: 9jSiy0meE9XJKkdIZwyTEQ ($32.05 in chips) 
Seat 6: jp34e617tIzV8tKIWmfAbA ($25 in chips) 
64ZeDpsBsP594VsWmafRTQ: posts small blind $0.10
vu2kzHaDtgr6NM7rdq0chA: posts big blind $0.25
*** HOLE CARDS ***
bWbV4MVB/vVpiES1Ut4hew: raises $1 to $1.25
32YL2ZEp8NT4JB2RVM9euQ: folds 
9jSiy0meE9XJKkdIZwyTEQ: folds 
jp34e617tIzV8tKIWmfAbA: folds 
64ZeDpsBsP594VsWmafRTQ: folds 
vu2kzHaDtgr6NM7rdq0chA: folds 
Uncalled bet ($1) returned to bWbV4MVB/vVpiES1Ut4hew
bWbV4MVB/vVpiES1Ut4hew collected $0.60 from pot
*** SUMMARY ***
Total pot $0.60 | Rake $0 
Seat 1: 64ZeDpsBsP594VsWmafRTQ (small blind) folded before Flop
Seat 2: vu2kzHaDtgr6NM7rdq0chA (big blind) folded before Flop
Seat 3: bWbV4MVB/vVpiES1Ut4hew collected ($0.60)
Seat 4: 32YL2ZEp8NT4JB2RVM9euQ folded before Flop (didn't bet)
Seat 5: 9jSiy0meE9XJKkdIZwyTEQ folded before Flop (didn't bet)
Seat 6: jp34e617tIzV8tKIWmfAbA (button) folded before Flop (didn't bet)




PokerStars Game #59939730800:  Hold'em No Limit ($0.10/$0.25) - 2009/07/01 0:47:27 ET
Table 'bIGKmJgZehWJ+FAo8b85iw' 9-max Seat #5 is the button
Seat 1: yyG4svzOpC1A+sUP/scg6w ($9.35 in chips) 
Seat 3: TeWJxSETzbXGiYKx0y+dtg ($36.05 in chips) 
Seat 4: EJRVVUAJEYLdm1qbO8TzuQ ($8.30 in chips) 
Seat 5: PXXRcmL5z1Ibt+PO2FWHlA ($6.35 in chips) 
Seat 6: H5Se03ZqSX7tbULXur2MAg ($21.45 in chips) 
Seat 8: +2kMBNpY4nF1qNCRd8SJLA ($25.35 in chips) 
Seat 9: aNpwfA31EREwO+ar4XzBCw ($25 in chips) 
H5Se03ZqSX7tbULXur2MAg: posts small blind $0.10
DdPXdieucQ+n99u1n3A+rQ: is sitting out 
+2kMBNpY4nF1qNCRd8SJLA: posts big blind $0.25
*** HOLE CARDS ***
DdPXdieucQ+n99u1n3A+rQ leaves the table
aNpwfA31EREwO+ar4XzBCw: folds 
yyG4svzOpC1A+sUP/scg6w: folds 
TeWJxSETzbXGiYKx0y+dtg: folds 
EJRVVUAJEYLdm1qbO8TzuQ: calls $0.25
PXXRcmL5z1Ibt+PO2FWHlA: folds 
H5Se03ZqSX7tbULXur2MAg: folds 
+2kMBNpY4nF1qNCRd8SJLA: checks 
*** FLOP *** [2s 8s 4d]
+2kMBNpY4nF1qNCRd8SJLA: checks 
EJRVVUAJEYLdm1qbO8TzuQ: checks 
*** TURN *** [2s 8s 4d] [As]
+2kMBNpY4nF1qNCRd8SJLA: checks 
EJRVVUAJEYLdm1qbO8TzuQ: checks 
*** RIVER *** [2s 8s 4d As] [Jc]
+2kMBNpY4nF1qNCRd8SJLA: checks 
EJRVVUAJEYLdm1qbO8TzuQ: checks 
*** SHOW DOWN ***
+2kMBNpY4nF1qNCRd8SJLA: shows [Td 4h] (a pair of Fours)
EJRVVUAJEYLdm1qbO8TzuQ: mucks hand 
+2kMBNpY4nF1qNCRd8SJLA collected $0.60 from pot
*** SUMMARY ***
Total pot $0.60 | Rake $0 
Board [2s 8s 4d As Jc]
Seat 1: yyG4svzOpC1A+sUP/scg6w folded before Flop (didn't bet)
Seat 3: TeWJxSETzbXGiYKx0y+dtg folded before Flop (didn't bet)
Seat 4: EJRVVUAJEYLdm1qbO8TzuQ mucked
Seat 5: PXXRcmL5z1Ibt+PO2FWHlA (button) folded before Flop (didn't bet)
Seat 6: H5Se03ZqSX7tbULXur2MAg (small blind) folded before Flop
Seat 8: +2kMBNpY4nF1qNCRd8SJLA (big blind) showed [Td 4h] and won ($0.60) with a pair of Fours
Seat 9: aNpwfA31EREwO+ar4XzBCw folded before Flop (didn't bet)




PokerStars Game #59939730966:  Hold'em No Limit ($0.10/$0.25) - 2009/07/01 0:47:28 ET
Table 'JPFXJXa5xBkjZ/W15BKqeQ' 9-max Seat #8 is the button
Seat 1: hPhp/RE3cJ5YGaQ2xOHXXg ($5.45 in chips) 
Seat 2: 1/f3/SJ8XpIW1Ek97d1xUw ($11.05 in chips) 
Seat 3: 56S3mA6Zs3pGR+0p0vUCtg ($26.80 in chips) 
Seat 4: VBHxUExRAMrbxUq/cVx9Gw ($5.25 in chips) 
Seat 5: cZ99hugmLBj9KhTlc8nCSw ($25.60 in chips) 
Seat 6: DdPXdieucQ+n99u1n3A+rQ ($5.10 in chips) 
Seat 8: zDrucyjVn5aeekNEc3cJrA ($22.15 in chips) 
hPhp/RE3cJ5YGaQ2xOHXXg: posts small blind $0.10
1/f3/SJ8XpIW1Ek97d1xUw: posts big blind $0.25
*** HOLE CARDS ***
56S3mA6Zs3pGR+0p0vUCtg: folds 
VBHxUExRAMrbxUq/cVx9Gw: folds 
cZ99hugmLBj9KhTlc8nCSw: folds 
DdPXdieucQ+n99u1n3A+rQ: folds 
zDrucyjVn5aeekNEc3cJrA: folds 
hPhp/RE3cJ5YGaQ2xOHXXg: folds 
Uncalled bet ($0.15) returned to 1/f3/SJ8XpIW1Ek97d1xUw
GalacticKid joins the table at seat #9 
1/f3/SJ8XpIW1Ek97d1xUw collected $0.20 from pot
1/f3/SJ8XpIW1Ek97d1xUw: doesn't show hand 
*** SUMMARY ***
Total pot $0.20 | Rake $0 
Seat 1: hPhp/RE3cJ5YGaQ2xOHXXg (small blind) folded before Flop
Seat 2: 1/f3/SJ8XpIW1Ek97d1xUw (big blind) collected ($0.20)
Seat 3: 56S3mA6Zs3pGR+0p0vUCtg folded before Flop (didn't bet)
Seat 4: VBHxUExRAMrbxUq/cVx9Gw folded before Flop (didn't bet)
Seat 5: cZ99hugmLBj9KhTlc8nCSw folded before Flop (didn't bet)
Seat 6: DdPXdieucQ+n99u1n3A+rQ folded before Flop (didn't bet)
Seat 8: zDrucyjVn5aeekNEc3cJrA (button) folded before Flop (didn't bet)




PokerStars Game #59939731222:  Hold'em No Limit ($0.10/$0.25) - 2009/07/01 0:47:28 ET
Table 'nc6OeGk/wtaWV+6N+kgnZQ' 6-max Seat #6 is the button
Seat 2: 4vTIxEd0Qfkak22W0G6sTg ($26.70 in chips) 
Seat 3: 8f0dtuUGqDbgE6up1lQAlg ($20.05 in chips) 
Seat 4: UfU14XiqkyIQoIJy9COOsQ ($24.35 in chips) 
Seat 5: ymz+a8dgHSUFPooYplw7Ow ($24.25 in chips) 
Seat 6: Mch463E1dxQfVob352za6w ($25 in chips) 
4vTIxEd0Qfkak22W0G6sTg: posts small blind $0.10
8f0dtuUGqDbgE6up1lQAlg: posts big blind $0.25
*** HOLE CARDS ***
UfU14XiqkyIQoIJy9COOsQ: folds 
ymz+a8dgHSUFPooYplw7Ow: folds 
UfU14XiqkyIQoIJy9COOsQ leaves the table
Mch463E1dxQfVob352za6w: raises $0.50 to $0.75
0/FYfBoKhINaqU/H5OSS1A leaves the table
3zD3qLXT1bEffAoWGnc7wg joins the table at seat #4 
4vTIxEd0Qfkak22W0G6sTg: calls $0.65
8f0dtuUGqDbgE6up1lQAlg: folds 
*** FLOP *** [5h 4s 7d]
Mxjust3 joins the table at seat #1 
4vTIxEd0Qfkak22W0G6sTg: bets $0.50
Mch463E1dxQfVob352za6w: calls $0.50
*** TURN *** [5h 4s 7d] [2c]
4vTIxEd0Qfkak22W0G6sTg: bets $0.50
Mch463E1dxQfVob352za6w: calls $0.50
*** RIVER *** [5h 4s 7d 2c] [Ks]
4vTIxEd0Qfkak22W0G6sTg: checks 
Mch463E1dxQfVob352za6w: checks 
*** SHOW DOWN ***
4vTIxEd0Qfkak22W0G6sTg: shows [Qc Tc] (high card King)
Mch463E1dxQfVob352za6w: shows [6s 6c] (a pair of Sixes)
Mch463E1dxQfVob352za6w collected $3.60 from pot
*** SUMMARY ***
Total pot $3.75 | Rake $0.15 
Board [5h 4s 7d 2c Ks]
Seat 2: 4vTIxEd0Qfkak22W0G6sTg (small blind) showed [Qc Tc] and lost with high card King
Seat 3: 8f0dtuUGqDbgE6up1lQAlg (big blind) folded before Flop
Seat 4: UfU14XiqkyIQoIJy9COOsQ folded before Flop (didn't bet)
Seat 5: ymz+a8dgHSUFPooYplw7Ow folded before Flop (didn't bet)
Seat 6: Mch463E1dxQfVob352za6w (button) showed [6s 6c] and won ($3.60) with a pair of Sixes




PokerStars Game #59939731084:  Hold'em No Limit ($0.10/$0.25) - 2009/07/01 0:47:28 ET
Table 'mNBkqbHtjDvzF6YU0ixV9Q' 9-max Seat #4 is the button
Seat 1: QsLvCwfSWqP+CfjwUnjpXQ ($16.25 in chips) 
Seat 4: NZlEzoTKHCxRJwJ71iDzeA ($5.10 in chips) 
Seat 6: Zb8xGmbjS8ghABxs9n6huA ($12.70 in chips) 
Zb8xGmbjS8ghABxs9n6huA: posts small blind $0.10
QsLvCwfSWqP+CfjwUnjpXQ: posts big blind $0.25
*** HOLE CARDS ***
NZlEzoTKHCxRJwJ71iDzeA: calls $0.25
Zb8xGmbjS8ghABxs9n6huA: folds 
QsLvCwfSWqP+CfjwUnjpXQ: checks 
*** FLOP *** [6h 7c 2h]
QsLvCwfSWqP+CfjwUnjpXQ: checks 
NZlEzoTKHCxRJwJ71iDzeA: bets $0.50
QsLvCwfSWqP+CfjwUnjpXQ: folds 
Uncalled bet ($0.50) returned to NZlEzoTKHCxRJwJ71iDzeA
NZlEzoTKHCxRJwJ71iDzeA collected $0.60 from pot
NZlEzoTKHCxRJwJ71iDzeA: doesn't show hand 
*** SUMMARY ***
Total pot $0.60 | Rake $0 
Board [6h 7c 2h]
Seat 1: QsLvCwfSWqP+CfjwUnjpXQ (big blind) folded on the Flop
Seat 4: NZlEzoTKHCxRJwJ71iDzeA (button) collected ($0.60)
Seat 6: Zb8xGmbjS8ghABxs9n6huA (small blind) folded before Flop




PokerStars Game #59939731040:  Hold'em No Limit ($0.10/$0.25) - 2009/07/01 0:47:28 ET
Table 'fHv1Mk7ZbLjprZTGWKPiEQ' 6-max Seat #1 is the button
Seat 1: nrBtxp+MnBtUJ1AIhZxHkg ($23.45 in chips) 
Seat 2: f6TKWwdxmqfPaZe08T+mgg ($5.80 in chips) 
Seat 3: HyeBXe7tNOZjTdX/zI0BZQ ($23.05 in chips) 
Seat 4: TSmua8tGK3sTbwi0ynrW9Q ($51.90 in chips) 
Seat 5: edio/rLJ06xeZOfLhoL3UA ($19.65 in chips) 
Seat 6: AjG0X+rNtc2W08eph8oqpw ($8.60 in chips) 
f6TKWwdxmqfPaZe08T+mgg: posts small blind $0.10
HyeBXe7tNOZjTdX/zI0BZQ: posts big blind $0.25
*** HOLE CARDS ***
TSmua8tGK3sTbwi0ynrW9Q has timed out
TSmua8tGK3sTbwi0ynrW9Q: folds 
TSmua8tGK3sTbwi0ynrW9Q is sitting out
edio/rLJ06xeZOfLhoL3UA: raises $0.75 to $1
AjG0X+rNtc2W08eph8oqpw: folds 
nrBtxp+MnBtUJ1AIhZxHkg: folds 
TSmua8tGK3sTbwi0ynrW9Q has returned
f6TKWwdxmqfPaZe08T+mgg: folds 
HyeBXe7tNOZjTdX/zI0BZQ: calls $0.75
*** FLOP *** [Ks 2d 4s]
HyeBXe7tNOZjTdX/zI0BZQ: checks 
edio/rLJ06xeZOfLhoL3UA: bets $1.25
HyeBXe7tNOZjTdX/zI0BZQ: folds 
Uncalled bet ($1.25) returned to edio/rLJ06xeZOfLhoL3UA
edio/rLJ06xeZOfLhoL3UA collected $2 from pot
edio/rLJ06xeZOfLhoL3UA: doesn't show hand 
*** SUMMARY ***
Total pot $2.10 | Rake $0.10 
Board [Ks 2d 4s]
Seat 1: nrBtxp+MnBtUJ1AIhZxHkg (button) folded before Flop (didn't bet)
Seat 2: f6TKWwdxmqfPaZe08T+mgg (small blind) folded before Flop
Seat 3: HyeBXe7tNOZjTdX/zI0BZQ (big blind) folded on the Flop
Seat 4: TSmua8tGK3sTbwi0ynrW9Q folded before Flop (didn't bet)
Seat 5: edio/rLJ06xeZOfLhoL3UA collected ($2)
Seat 6: AjG0X+rNtc2W08eph8oqpw folded before Flop (didn't bet)




PokerStars Game #59939731006:  Hold'em No Limit ($0.10/$0.25) - 2009/07/01 0:47:28 ET
Table 'l57rayEpPtZotP9nqgSWBg' 6-max Seat #3 is the button
Seat 1: oseFhpinoe+Zg4j5xyBjyQ ($20.15 in chips) 
Seat 2: ErIN0JRL5srYjT6en1f8YQ ($24.20 in chips) 
Seat 3: sEQx9G5Cu8k1HNdQasxvUA ($40.15 in chips) 
Seat 4: NIALbunHAyYqmfMf7mrPhw ($6.35 in chips) 
Seat 5: TSmua8tGK3sTbwi0ynrW9Q ($60.10 in chips) 
Seat 6: IGRfskE1v9H9Bn+fz8AgNQ ($23.90 in chips) 
NIALbunHAyYqmfMf7mrPhw: posts small blind $0.10
TSmua8tGK3sTbwi0ynrW9Q: posts big blind $0.25
*** HOLE CARDS ***
IGRfskE1v9H9Bn+fz8AgNQ: calls $0.25
oseFhpinoe+Zg4j5xyBjyQ: folds 
ErIN0JRL5srYjT6en1f8YQ: raises $1.25 to $1.50
sEQx9G5Cu8k1HNdQasxvUA: folds 
NIALbunHAyYqmfMf7mrPhw: folds 
TSmua8tGK3sTbwi0ynrW9Q: folds 
IGRfskE1v9H9Bn+fz8AgNQ: folds 
Uncalled bet ($1.25) returned to ErIN0JRL5srYjT6en1f8YQ
ErIN0JRL5srYjT6en1f8YQ collected $0.85 from pot
ErIN0JRL5srYjT6en1f8YQ: doesn't show hand 
*** SUMMARY ***
Total pot $0.85 | Rake $0 
Seat 1: oseFhpinoe+Zg4j5xyBjyQ folded before Flop (didn't bet)
Seat 2: ErIN0JRL5srYjT6en1f8YQ collected ($0.85)
Seat 3: sEQx9G5Cu8k1HNdQasxvUA (button) folded before Flop (didn't bet)
Seat 4: NIALbunHAyYqmfMf7mrPhw (small blind) folded before Flop
Seat 5: TSmua8tGK3sTbwi0ynrW9Q (big blind) folded before Flop
Seat 6: IGRfskE1v9H9Bn+fz8AgNQ folded before Flop




PokerStars Game #59939730866:  Hold'em No Limit ($0.10/$0.25) - 2009/07/01 0:47:28 ET
Table '+UzantPJ4smVdrh+4GTu1w' 6-max Seat #6 is the button
Seat 1: 4jrz/IbtclK1xNH6lZqJNA ($25.10 in chips) 
Seat 2: tcbEu7VzyHQ+0lh+skbQhQ ($14.70 in chips) 
Seat 3: SS/yfeArhULzIcOPe8MdPg ($50.90 in chips) 
Seat 4: IGRfskE1v9H9Bn+fz8AgNQ ($21.80 in chips) 
Seat 5: cj4VBQya7HtVL2zCGd5jLQ ($21.90 in chips) 
Seat 6: BYxjLnV1/LL0aZcTbfAOvw ($48.30 in chips) 
4jrz/IbtclK1xNH6lZqJNA: posts small blind $0.10
tcbEu7VzyHQ+0lh+skbQhQ: posts big blind $0.25
*** HOLE CARDS ***
SS/yfeArhULzIcOPe8MdPg: folds 
IGRfskE1v9H9Bn+fz8AgNQ: calls $0.25
cj4VBQya7HtVL2zCGd5jLQ: folds 
BYxjLnV1/LL0aZcTbfAOvw: folds 
4jrz/IbtclK1xNH6lZqJNA: calls $0.15
tcbEu7VzyHQ+0lh+skbQhQ: checks 
*** FLOP *** [2s 2h 9h]
4jrz/IbtclK1xNH6lZqJNA: bets $0.50
tcbEu7VzyHQ+0lh+skbQhQ: raises $0.50 to $1
IGRfskE1v9H9Bn+fz8AgNQ: folds 
4jrz/IbtclK1xNH6lZqJNA: folds 
Uncalled bet ($0.50) returned to tcbEu7VzyHQ+0lh+skbQhQ
tcbEu7VzyHQ+0lh+skbQhQ collected $1.70 from pot
*** SUMMARY ***
Total pot $1.75 | Rake $0.05 
Board [2s 2h 9h]
Seat 1: 4jrz/IbtclK1xNH6lZqJNA (small blind) folded on the Flop
Seat 2: tcbEu7VzyHQ+0lh+skbQhQ (big blind) collected ($1.70)
Seat 3: SS/yfeArhULzIcOPe8MdPg folded before Flop (didn't bet)
Seat 4: IGRfskE1v9H9Bn+fz8AgNQ folded on the Flop
Seat 5: cj4VBQya7HtVL2zCGd5jLQ folded before Flop (didn't bet)
Seat 6: BYxjLnV1/LL0aZcTbfAOvw (button) folded before Flop (didn't bet)




PokerStars Game #59939731354:  Hold'em No Limit ($0.10/$0.25) - 2009/07/01 0:47:28 ET
Table 'qryc9C/ELyQ3lubOaELNAQ' 6-max Seat #5 is the button
Seat 1: OZc6kkoTwtITj1ZfreJK1A ($25.85 in chips) 
Seat 2: qvQc9BHp2FhQjrltLiBN+w ($12 in chips) 
Seat 3: UXRtG8J9PoBZWTsNtqdoDA ($21.05 in chips) 
Seat 4: v+QfkGiuj9bgtuNoVnDO8w ($28.65 in chips) 
Seat 5: pV5UZbjsgam+HUQEd6G++w ($11.40 in chips) 
Seat 6: WrLI51S2iMb8GLMB83gGqA ($25 in chips) 
WrLI51S2iMb8GLMB83gGqA: posts small blind $0.10
OZc6kkoTwtITj1ZfreJK1A: posts big blind $0.25
*** HOLE CARDS ***
qvQc9BHp2FhQjrltLiBN+w: folds 
UXRtG8J9PoBZWTsNtqdoDA: calls $0.25
v+QfkGiuj9bgtuNoVnDO8w: raises $1 to $1.25
pV5UZbjsgam+HUQEd6G++w: folds 
WrLI51S2iMb8GLMB83gGqA: folds 
OZc6kkoTwtITj1ZfreJK1A: folds 
UXRtG8J9PoBZWTsNtqdoDA: calls $1
*** FLOP *** [Jd 5c 3s]
UXRtG8J9PoBZWTsNtqdoDA: bets $2
v+QfkGiuj9bgtuNoVnDO8w: folds 
Uncalled bet ($2) returned to UXRtG8J9PoBZWTsNtqdoDA
UXRtG8J9PoBZWTsNtqdoDA collected $2.75 from pot
*** SUMMARY ***
Total pot $2.85 | Rake $0.10 
Board [Jd 5c 3s]
Seat 1: OZc6kkoTwtITj1ZfreJK1A (big blind) folded before Flop
Seat 2: qvQc9BHp2FhQjrltLiBN+w folded before Flop (didn't bet)
Seat 3: UXRtG8J9PoBZWTsNtqdoDA collected ($2.75)
Seat 4: v+QfkGiuj9bgtuNoVnDO8w folded on the Flop
Seat 5: pV5UZbjsgam+HUQEd6G++w (button) folded before Flop (didn't bet)
Seat 6: WrLI51S2iMb8GLMB83gGqA (small blind) folded before Flop




PokerStars Game #59939731082:  Hold'em No Limit ($0.10/$0.25) - 2009/07/01 0:47:28 ET
Table 'I0ZcuiUTeLuGYv26Nah7YA' 9-max Seat #5 is the button
Seat 1: iMiqaPr7dx84UF0wNUeh8A ($17.60 in chips) 
Seat 2: yzPZQFeaQTNf1YK3a0zRIw ($9 in chips) 
Seat 3: 1S/fpm+f42V/6MNZre+ccg ($29.55 in chips) 
Seat 4: 4awUyiDYTgylQKXZ9faBVA ($30.45 in chips) 
Seat 5: opOCI2p6kW0tINuVaAqmcQ ($42.80 in chips) 
Seat 6: JRV2PblFtPFz51l0Fwyz8g ($22.75 in chips) 
Seat 7: RJ/x9oZtt1RZLaJEQwZOxQ ($25 in chips) 
Seat 8: ijc1q+bpPQR12wxc0sWc4w ($18.40 in chips) 
JRV2PblFtPFz51l0Fwyz8g: posts small blind $0.10
RJ/x9oZtt1RZLaJEQwZOxQ: posts big blind $0.25
6RiVTYll/5D8zICp0MRpKw: sits out 
*** HOLE CARDS ***
ijc1q+bpPQR12wxc0sWc4w: raises $0.50 to $0.75
iMiqaPr7dx84UF0wNUeh8A: folds 
yzPZQFeaQTNf1YK3a0zRIw: calls $0.75
1S/fpm+f42V/6MNZre+ccg: folds 
4awUyiDYTgylQKXZ9faBVA: folds 
opOCI2p6kW0tINuVaAqmcQ: folds 
JRV2PblFtPFz51l0Fwyz8g: folds 
RJ/x9oZtt1RZLaJEQwZOxQ: folds 
*** FLOP *** [8c 8h Th]
ijc1q+bpPQR12wxc0sWc4w: bets $1.25
yzPZQFeaQTNf1YK3a0zRIw: folds 
Uncalled bet ($1.25) returned to ijc1q+bpPQR12wxc0sWc4w
ijc1q+bpPQR12wxc0sWc4w collected $1.80 from pot
*** SUMMARY ***
Total pot $1.85 | Rake $0.05 
Board [8c 8h Th]
Seat 1: iMiqaPr7dx84UF0wNUeh8A folded before Flop (didn't bet)
Seat 2: yzPZQFeaQTNf1YK3a0zRIw folded on the Flop
Seat 3: 1S/fpm+f42V/6MNZre+ccg folded before Flop (didn't bet)
Seat 4: 4awUyiDYTgylQKXZ9faBVA folded before Flop (didn't bet)
Seat 5: opOCI2p6kW0tINuVaAqmcQ (button) folded before Flop (didn't bet)
Seat 6: JRV2PblFtPFz51l0Fwyz8g (small blind) folded before Flop
Seat 7: RJ/x9oZtt1RZLaJEQwZOxQ (big blind) folded before Flop
Seat 8: ijc1q+bpPQR12wxc0sWc4w collected ($1.80)




PokerStars Game #59939730930:  Hold'em No Limit ($0.10/$0.25) - 2009/07/01 0:47:28 ET
Table 'aaXqTKUnxrX9DYXtxhWXxA' 6-max Seat #6 is the button
Seat 2: 1Zyw8DT57U6TzxWWRixa6Q ($10.45 in chips) 
Seat 3: cPO/1/dTcZpLkQFm3jH3Rg ($25 in chips) 
Seat 5: kyRaCIljYA6l33lSKQfNsg ($24.75 in chips) 
Seat 6: buyjetgNT1McXtdaP4zynA ($28.55 in chips) 
SFmT9ZsVopnukjvAzrxTRg will be allowed to play after the button
1Zyw8DT57U6TzxWWRixa6Q: posts small blind $0.10
cPO/1/dTcZpLkQFm3jH3Rg: posts big blind $0.25
v8m8XHovI5tqEA9mvplDSw: sits out 
*** HOLE CARDS ***
kyRaCIljYA6l33lSKQfNsg: folds 
buyjetgNT1McXtdaP4zynA: folds 
1Zyw8DT57U6TzxWWRixa6Q: calls $0.15
cPO/1/dTcZpLkQFm3jH3Rg: raises $1.25 to $1.50
1Zyw8DT57U6TzxWWRixa6Q: folds 
Uncalled bet ($1.25) returned to cPO/1/dTcZpLkQFm3jH3Rg
cPO/1/dTcZpLkQFm3jH3Rg collected $0.50 from pot
*** SUMMARY ***
Total pot $0.50 | Rake $0 
Seat 2: 1Zyw8DT57U6TzxWWRixa6Q (small blind) folded before Flop
Seat 3: cPO/1/dTcZpLkQFm3jH3Rg (big blind) collected ($0.50)
Seat 5: kyRaCIljYA6l33lSKQfNsg folded before Flop (didn't bet)
Seat 6: buyjetgNT1McXtdaP4zynA (button) folded before Flop (didn't bet)




PokerStars Game #59939730938:  Hold'em No Limit ($0.10/$0.25) - 2009/07/01 0:47:28 ET
Table 'x7YStLKc8hpt/pTgSetPKA' 9-max Seat #5 is the button
Seat 1: tYsOBqdU1+x+yFI7zHO7hQ ($25 in chips) 
Seat 2: z5GxcHlYz/GSz6W2uFiTtg ($34.65 in chips) 
Seat 3: S7Ki0P+0AIGPuIfGJjW0gg ($25.70 in chips) 
Seat 4: er5m2fugFz72ZXh/4+gSDg ($24.65 in chips) 
Seat 5: gxyie8xe6lDdpfG4quHtbw ($8.15 in chips) 
Seat 6: Yv4fucyyT28mjx8V5lxKJg ($33.55 in chips) 
Seat 7: dtZ84flFEi4Q+SGrHMJRDQ ($25 in chips) 
Seat 8: jeKWRUkMaVn8rEUjnJKqpg ($36.80 in chips) 
Seat 9: nm4Dj/f+jJEwKVsUnKh73g ($27.80 in chips) 
Yv4fucyyT28mjx8V5lxKJg: posts small blind $0.10
dtZ84flFEi4Q+SGrHMJRDQ: posts big blind $0.25
*** HOLE CARDS ***
jeKWRUkMaVn8rEUjnJKqpg: folds 
nm4Dj/f+jJEwKVsUnKh73g: calls $0.25
tYsOBqdU1+x+yFI7zHO7hQ: raises $1 to $1.25
z5GxcHlYz/GSz6W2uFiTtg: folds 
S7Ki0P+0AIGPuIfGJjW0gg: calls $1.25
er5m2fugFz72ZXh/4+gSDg: folds 
gxyie8xe6lDdpfG4quHtbw: folds 
Yv4fucyyT28mjx8V5lxKJg: folds 
dtZ84flFEi4Q+SGrHMJRDQ: folds 
nm4Dj/f+jJEwKVsUnKh73g: folds 
*** FLOP *** [Js As 9d]
Yv4fucyyT28mjx8V5lxKJg leaves the table
tYsOBqdU1+x+yFI7zHO7hQ: bets $2.25
S7Ki0P+0AIGPuIfGJjW0gg: raises $6.75 to $9
tYsOBqdU1+x+yFI7zHO7hQ: folds 
Uncalled bet ($6.75) returned to S7Ki0P+0AIGPuIfGJjW0gg
S7Ki0P+0AIGPuIfGJjW0gg collected $7.25 from pot
S7Ki0P+0AIGPuIfGJjW0gg: doesn't show hand 
*** SUMMARY ***
Total pot $7.60 | Rake $0.35 
Board [Js As 9d]
Seat 1: tYsOBqdU1+x+yFI7zHO7hQ folded on the Flop
Seat 2: z5GxcHlYz/GSz6W2uFiTtg folded before Flop (didn't bet)
Seat 3: S7Ki0P+0AIGPuIfGJjW0gg collected ($7.25)
Seat 4: er5m2fugFz72ZXh/4+gSDg folded before Flop (didn't bet)
Seat 5: gxyie8xe6lDdpfG4quHtbw (button) folded before Flop (didn't bet)
Seat 6: Yv4fucyyT28mjx8V5lxKJg (small blind) folded before Flop
Seat 7: dtZ84flFEi4Q+SGrHMJRDQ (big blind) folded before Flop
Seat 8: jeKWRUkMaVn8rEUjnJKqpg folded before Flop (didn't bet)
Seat 9: nm4Dj/f+jJEwKVsUnKh73g folded before Flop




PokerStars Game #59939731244:  Hold'em No Limit ($0.10/$0.25) - 2009/07/01 0:47:28 ET
Table 'G26g8jde1eR+mmabeFeSlw' 9-max Seat #8 is the button
Seat 1: eygIcrabyU9hI2mw7NQsgg ($22.50 in chips) 
Seat 2: O2aLEhH7P83nWGvgV84KoA ($13.50 in chips) 
Seat 3: WKL8nUFr7TumC4EjLyqYzw ($5 in chips) 
Seat 4: 1Clf3cPrqoy/YgvWdWK1Xw ($10.25 in chips) 
Seat 5: hJ4uYjNmSZdjrKA8cjZqCA ($19.80 in chips) 
Seat 6: opOCI2p6kW0tINuVaAqmcQ ($25 in chips) 
Seat 7: nm4Dj/f+jJEwKVsUnKh73g ($28.50 in chips) 
Seat 8: 22dIObOuor/A+IKWkNoAlA ($5 in chips) 
Seat 9: VWUWpMLMj/Q1jRVpF7Aohw ($9.70 in chips) 
VWUWpMLMj/Q1jRVpF7Aohw: posts small blind $0.10
eygIcrabyU9hI2mw7NQsgg: posts big blind $0.25
*** HOLE CARDS ***
O2aLEhH7P83nWGvgV84KoA: folds 
WKL8nUFr7TumC4EjLyqYzw: folds 
1Clf3cPrqoy/YgvWdWK1Xw has timed out
1Clf3cPrqoy/YgvWdWK1Xw: folds 
1Clf3cPrqoy/YgvWdWK1Xw is sitting out
hJ4uYjNmSZdjrKA8cjZqCA: calls $0.25
opOCI2p6kW0tINuVaAqmcQ: folds 
nm4Dj/f+jJEwKVsUnKh73g: folds 
22dIObOuor/A+IKWkNoAlA: folds 
VWUWpMLMj/Q1jRVpF7Aohw: calls $0.15
eygIcrabyU9hI2mw7NQsgg: checks 
*** FLOP *** [8c Kd 4c]
VWUWpMLMj/Q1jRVpF7Aohw: checks 
eygIcrabyU9hI2mw7NQsgg: checks 
hJ4uYjNmSZdjrKA8cjZqCA: checks 
*** TURN *** [8c Kd 4c] [Td]
VWUWpMLMj/Q1jRVpF7Aohw: checks 
eygIcrabyU9hI2mw7NQsgg: checks 
hJ4uYjNmSZdjrKA8cjZqCA: bets $0.50
VWUWpMLMj/Q1jRVpF7Aohw: folds 
eygIcrabyU9hI2mw7NQsgg: folds 
Uncalled bet ($0.50) returned to hJ4uYjNmSZdjrKA8cjZqCA
hJ4uYjNmSZdjrKA8cjZqCA collected $0.75 from pot
*** SUMMARY ***
Total pot $0.75 | Rake $0 
Board [8c Kd 4c Td]
Seat 1: eygIcrabyU9hI2mw7NQsgg (big blind) folded on the Turn
Seat 2: O2aLEhH7P83nWGvgV84KoA folded before Flop (didn't bet)
Seat 3: WKL8nUFr7TumC4EjLyqYzw folded before Flop (didn't bet)
Seat 4: 1Clf3cPrqoy/YgvWdWK1Xw folded before Flop (didn't bet)
Seat 5: hJ4uYjNmSZdjrKA8cjZqCA collected ($0.75)
Seat 6: opOCI2p6kW0tINuVaAqmcQ folded before Flop (didn't bet)
Seat 7: nm4Dj/f+jJEwKVsUnKh73g folded before Flop (didn't bet)
Seat 8: 22dIObOuor/A+IKWkNoAlA (button) folded before Flop (didn't bet)
Seat 9: VWUWpMLMj/Q1jRVpF7Aohw (small blind) folded on the Turn




PokerStars Game #59939731896:  Hold'em No Limit ($0.10/$0.25) - 2009/07/01 0:47:29 ET
Table '1LkLBsok91+aSWIELy/cyw' 6-max Seat #1 is the button
Seat 1: /gJNBeCkWL4o85/jvlZ4BA ($25 in chips) 
Seat 2: oseFhpinoe+Zg4j5xyBjyQ ($26.30 in chips) 
Seat 3: +yxuvzJHyIWsJ515X8zJTQ ($16.45 in chips) 
Seat 4: vEZ/HxVuyR6kaq0BtZoUgQ ($3.85 in chips) 
Seat 5: ICa62oT7HjNrT1FWqSNbjg ($13.90 in chips) 
Seat 6: MuW7Zf0FjOGlCuY3aIrlsA ($31.55 in chips) 
oseFhpinoe+Zg4j5xyBjyQ: posts small blind $0.10
+yxuvzJHyIWsJ515X8zJTQ: posts big blind $0.25
*** HOLE CARDS ***
vEZ/HxVuyR6kaq0BtZoUgQ: folds 
ICa62oT7HjNrT1FWqSNbjg: calls $0.25
MuW7Zf0FjOGlCuY3aIrlsA: raises $1 to $1.25
/gJNBeCkWL4o85/jvlZ4BA: folds 
oseFhpinoe+Zg4j5xyBjyQ: folds 
+yxuvzJHyIWsJ515X8zJTQ: folds 
ICa62oT7HjNrT1FWqSNbjg: calls $1
*** FLOP *** [8c 7d 6d]
ICa62oT7HjNrT1FWqSNbjg: checks 
MuW7Zf0FjOGlCuY3aIrlsA: bets $2
ICa62oT7HjNrT1FWqSNbjg: calls $2
*** TURN *** [8c 7d 6d] [5h]
ICa62oT7HjNrT1FWqSNbjg: checks 
MuW7Zf0FjOGlCuY3aIrlsA: checks 
*** RIVER *** [8c 7d 6d 5h] [Js]
ICa62oT7HjNrT1FWqSNbjg: checks 
MuW7Zf0FjOGlCuY3aIrlsA: checks 
*** SHOW DOWN ***
ICa62oT7HjNrT1FWqSNbjg: shows [Kc 8d] (a pair of Eights)
MuW7Zf0FjOGlCuY3aIrlsA: shows [As Ac] (a pair of Aces)
MuW7Zf0FjOGlCuY3aIrlsA collected $6.55 from pot
*** SUMMARY ***
Total pot $6.85 | Rake $0.30 
Board [8c 7d 6d 5h Js]
Seat 1: /gJNBeCkWL4o85/jvlZ4BA (button) folded before Flop (didn't bet)
Seat 2: oseFhpinoe+Zg4j5xyBjyQ (small blind) folded before Flop
Seat 3: +yxuvzJHyIWsJ515X8zJTQ (big blind) folded before Flop
Seat 4: vEZ/HxVuyR6kaq0BtZoUgQ folded before Flop (didn't bet)
Seat 5: ICa62oT7HjNrT1FWqSNbjg showed [Kc 8d] and lost with a pair of Eights
Seat 6: MuW7Zf0FjOGlCuY3aIrlsA showed [As Ac] and won ($6.55) with a pair of Aces




PokerStars Game #59939732132:  Hold'em No Limit ($0.10/$0.25) - 2009/07/01 0:47:29 ET
Table 'HbNAGS1OJWQKyfk7UfrYyw' 9-max Seat #3 is the button
Seat 2: zE0IkNrJoJD964o4eqmCxQ ($10.90 in chips) 
Seat 3: DIBbjEYGs+TVdVgEB/4+3w ($29.35 in chips) 
Seat 6: W4TLQcZ2TiM73eIgpIvlGg ($25.85 in chips) 
Seat 7: JJH2Xc95hFewheF67vSv4Q ($16.85 in chips) 
Seat 8: fsTS8sDyZ7BxKQFEMv9xCg ($6.10 in chips) 
Seat 9: cFmpjvcjNoVAEAIQIxWkYg ($25 in chips) 
22dIObOuor/A+IKWkNoAlA will be allowed to play after the button
W4TLQcZ2TiM73eIgpIvlGg: posts small blind $0.10
JJH2Xc95hFewheF67vSv4Q: posts big blind $0.25
*** HOLE CARDS ***
gehe91e0IyVT0QU/XBkEyg joins the table at seat #5 
fsTS8sDyZ7BxKQFEMv9xCg: folds 
cFmpjvcjNoVAEAIQIxWkYg: raises $0.25 to $0.50
zE0IkNrJoJD964o4eqmCxQ: folds 
DIBbjEYGs+TVdVgEB/4+3w: folds 
W4TLQcZ2TiM73eIgpIvlGg: folds 
JJH2Xc95hFewheF67vSv4Q: calls $0.25
*** FLOP *** [8c 9h Js]
JJH2Xc95hFewheF67vSv4Q: checks 
cFmpjvcjNoVAEAIQIxWkYg: bets $0.45
JJH2Xc95hFewheF67vSv4Q: calls $0.45
*** TURN *** [8c 9h Js] [Ac]
JJH2Xc95hFewheF67vSv4Q: checks 
cFmpjvcjNoVAEAIQIxWkYg: bets $0.50
JJH2Xc95hFewheF67vSv4Q: calls $0.50
*** RIVER *** [8c 9h Js Ac] [Kd]
JJH2Xc95hFewheF67vSv4Q: checks 
cFmpjvcjNoVAEAIQIxWkYg: checks 
*** SHOW DOWN ***
JJH2Xc95hFewheF67vSv4Q: shows [4h 8h] (a pair of Eights)
cFmpjvcjNoVAEAIQIxWkYg: shows [Th Jd] (a pair of Jacks)
cFmpjvcjNoVAEAIQIxWkYg collected $2.90 from pot
*** SUMMARY ***
Total pot $3 | Rake $0.10 
Board [8c 9h Js Ac Kd]
Seat 2: zE0IkNrJoJD964o4eqmCxQ folded before Flop (didn't bet)
Seat 3: DIBbjEYGs+TVdVgEB/4+3w (button) folded before Flop (didn't bet)
Seat 6: W4TLQcZ2TiM73eIgpIvlGg (small blind) folded before Flop
Seat 7: JJH2Xc95hFewheF67vSv4Q (big blind) showed [4h 8h] and lost with a pair of Eights
Seat 8: fsTS8sDyZ7BxKQFEMv9xCg folded before Flop (didn't bet)
Seat 9: cFmpjvcjNoVAEAIQIxWkYg showed [Th Jd] and won ($2.90) with a pair of Jacks




PokerStars Game #59939731744:  Hold'em No Limit ($0.10/$0.25) - 2009/07/01 0:47:29 ET
Table 'luMgmRPIo47e7iXDlheIwA' 6-max Seat #5 is the button
Seat 1: z/jAqpWD9ifpbtEpwGyInw ($10.15 in chips) 
Seat 3: W6Y6au0wf7gRAlqJYgOezw ($12.80 in chips) 
Seat 4: n2OZezRXTtdzQt4SuIy8TQ ($18.25 in chips) 
Seat 5: zxeVQGaMKDsDzmSY+AInjA ($14 in chips) 
Seat 6: Zb8xGmbjS8ghABxs9n6huA ($19.55 in chips) 
Zb8xGmbjS8ghABxs9n6huA: posts small blind $0.10
z/jAqpWD9ifpbtEpwGyInw: posts big blind $0.25
hZJzYj+7+PvGu6ae1g//sQ: sits out 
*** HOLE CARDS ***
W6Y6au0wf7gRAlqJYgOezw: folds 
n2OZezRXTtdzQt4SuIy8TQ: raises $0.75 to $1
zxeVQGaMKDsDzmSY+AInjA: folds 
Zb8xGmbjS8ghABxs9n6huA: folds 
z/jAqpWD9ifpbtEpwGyInw: folds 
Uncalled bet ($0.75) returned to n2OZezRXTtdzQt4SuIy8TQ
n2OZezRXTtdzQt4SuIy8TQ collected $0.60 from pot
*** SUMMARY ***
Total pot $0.60 | Rake $0 
Seat 1: z/jAqpWD9ifpbtEpwGyInw (big blind) folded before Flop
Seat 3: W6Y6au0wf7gRAlqJYgOezw folded before Flop (didn't bet)
Seat 4: n2OZezRXTtdzQt4SuIy8TQ collected ($0.60)
Seat 5: zxeVQGaMKDsDzmSY+AInjA (button) folded before Flop (didn't bet)
Seat 6: Zb8xGmbjS8ghABxs9n6huA (small blind) folded before Flop




PokerStars Game #59939732472:  Hold'em No Limit ($0.10/$0.25) - 2009/07/01 0:47:30 ET
Table 'sm5gqEvXgLbkkE4dryW/5g' 6-max Seat #6 is the button
Seat 1: gaPMxLGp9SOj4Lq6t+/0Ig ($15.95 in chips) 
Seat 2: s13YXIlhF/j3TO0bSnT7bA ($17.95 in chips) 
Seat 4: BedjMfrlRfPgSq7CXpPAmg ($56.90 in chips) 
Seat 5: M+WmDyCD/ZMu/5t6/iH2kw ($68.20 in chips) 
Seat 6: wKFJ513ucluNNiMlkXcDOQ ($27.15 in chips) 
gaPMxLGp9SOj4Lq6t+/0Ig: posts small blind $0.10
s13YXIlhF/j3TO0bSnT7bA: posts big blind $0.25
I1TxPvWj8NfG8orglCinNA: sits out 
*** HOLE CARDS ***
BedjMfrlRfPgSq7CXpPAmg: folds 
M+WmDyCD/ZMu/5t6/iH2kw: folds 
wKFJ513ucluNNiMlkXcDOQ: raises $0.75 to $1
gaPMxLGp9SOj4Lq6t+/0Ig: folds 
s13YXIlhF/j3TO0bSnT7bA: folds 
Uncalled bet ($0.75) returned to wKFJ513ucluNNiMlkXcDOQ
wKFJ513ucluNNiMlkXcDOQ collected $0.60 from pot
wKFJ513ucluNNiMlkXcDOQ: doesn't show hand 
*** SUMMARY ***
Total pot $0.60 | Rake $0 
Seat 1: gaPMxLGp9SOj4Lq6t+/0Ig (small blind) folded before Flop
Seat 2: s13YXIlhF/j3TO0bSnT7bA (big blind) folded before Flop
Seat 4: BedjMfrlRfPgSq7CXpPAmg folded before Flop (didn't bet)
Seat 5: M+WmDyCD/ZMu/5t6/iH2kw folded before Flop (didn't bet)
Seat 6: wKFJ513ucluNNiMlkXcDOQ (button) collected ($0.60)




PokerStars Game #59939732818:  Hold'em No Limit ($0.10/$0.25) - 2009/07/01 0:47:30 ET
Table 'vud0GB/ZlDCvUFhBFIaTlg' 9-max Seat #6 is the button
Seat 4: ss810etqPS9ni/HJIweF/g ($7.10 in chips) 
Seat 5: AwAabNdwDsTMb3aTomdOmg ($8.20 in chips) 
Seat 6: NDJWZaU2QihSadZB98k0tg ($25.25 in chips) 
Seat 8: Am29qRe4OYkVWs70NjNDBw ($5.75 in chips) 
Seat 9: ROo8kPnsdL612mO7wzI5Bg ($7.75 in chips) 
Am29qRe4OYkVWs70NjNDBw: posts small blind $0.10
ROo8kPnsdL612mO7wzI5Bg: posts big blind $0.25
DiSvPC2iudwL5j9u6Huyww: sits out 
DHobes12: sits out 
*** HOLE CARDS ***
ss810etqPS9ni/HJIweF/g: folds 
AwAabNdwDsTMb3aTomdOmg: calls $0.25
NDJWZaU2QihSadZB98k0tg: calls $0.25
Am29qRe4OYkVWs70NjNDBw: calls $0.15
ROo8kPnsdL612mO7wzI5Bg: checks 
*** FLOP *** [6h 3s 6s]
Am29qRe4OYkVWs70NjNDBw: checks 
ROo8kPnsdL612mO7wzI5Bg: bets $0.50
AwAabNdwDsTMb3aTomdOmg: folds 
NDJWZaU2QihSadZB98k0tg: folds 
NDJWZaU2QihSadZB98k0tg leaves the table
Am29qRe4OYkVWs70NjNDBw: folds 
Uncalled bet ($0.50) returned to ROo8kPnsdL612mO7wzI5Bg
ROo8kPnsdL612mO7wzI5Bg collected $0.95 from pot
*** SUMMARY ***
Total pot $1 | Rake $0.05 
Board [6h 3s 6s]
Seat 4: ss810etqPS9ni/HJIweF/g folded before Flop (didn't bet)
Seat 5: AwAabNdwDsTMb3aTomdOmg folded on the Flop
Seat 6: NDJWZaU2QihSadZB98k0tg (button) folded on the Flop
Seat 8: Am29qRe4OYkVWs70NjNDBw (small blind) folded on the Flop
Seat 9: ROo8kPnsdL612mO7wzI5Bg (big blind) collected ($0.95)




PokerStars Game #59939732644:  Hold'em No Limit ($0.10/$0.25) - 2009/07/01 0:47:30 ET
Table 'GxdLtCpYxqT4aAbYqkEEpw' 6-max Seat #4 is the button
Seat 1: heEf/FkFGS9M1NmwH97YIA ($20.15 in chips) 
Seat 2: hADMNbkECXMb2C/C8R2Wlw ($25.35 in chips) 
Seat 3: 9jSiy0meE9XJKkdIZwyTEQ ($48.80 in chips) 
Seat 4: ErIN0JRL5srYjT6en1f8YQ ($30.60 in chips) 
Seat 5: q6WfTUAD9mowIP63ASq2Dg ($38.40 in chips) 
Seat 6: aogAb4Eienxztk8p2v9VVw ($24.15 in chips) 
q6WfTUAD9mowIP63ASq2Dg: posts small blind $0.10
aogAb4Eienxztk8p2v9VVw: posts big blind $0.25
*** HOLE CARDS ***
heEf/FkFGS9M1NmwH97YIA: calls $0.25
hADMNbkECXMb2C/C8R2Wlw: raises $0.75 to $1
9jSiy0meE9XJKkdIZwyTEQ: folds 
ErIN0JRL5srYjT6en1f8YQ: folds 
q6WfTUAD9mowIP63ASq2Dg: folds 
aogAb4Eienxztk8p2v9VVw: folds 
heEf/FkFGS9M1NmwH97YIA: calls $0.75
*** FLOP *** [9h Ac 2h]
heEf/FkFGS9M1NmwH97YIA: checks 
hADMNbkECXMb2C/C8R2Wlw: bets $1.50
heEf/FkFGS9M1NmwH97YIA: folds 
Uncalled bet ($1.50) returned to hADMNbkECXMb2C/C8R2Wlw
hADMNbkECXMb2C/C8R2Wlw collected $2.25 from pot
hADMNbkECXMb2C/C8R2Wlw: doesn't show hand 
*** SUMMARY ***
Total pot $2.35 | Rake $0.10 
Board [9h Ac 2h]
Seat 1: heEf/FkFGS9M1NmwH97YIA folded on the Flop
Seat 2: hADMNbkECXMb2C/C8R2Wlw collected ($2.25)
Seat 3: 9jSiy0meE9XJKkdIZwyTEQ folded before Flop (didn't bet)
Seat 4: ErIN0JRL5srYjT6en1f8YQ (button) folded before Flop (didn't bet)
Seat 5: q6WfTUAD9mowIP63ASq2Dg (small blind) folded before Flop
Seat 6: aogAb4Eienxztk8p2v9VVw (big blind) folded before Flop




PokerStars Game #59939732250:  Hold'em No Limit ($0.10/$0.25) - 2009/07/01 0:47:30 ET
Table 'FgLmv9bi/fJP8ldfbTOpkg' 9-max Seat #1 is the button
Seat 1: opOCI2p6kW0tINuVaAqmcQ ($25.60 in chips) 
Seat 2: mpsfNtnMVDqQHTe92AhIdw ($28.35 in chips) 
Seat 3: uJlzv9KL7hgCIqIS2ofoaw ($10 in chips) 
Seat 4: WfS0TjI8FyLemNTOo1e9qA ($11.85 in chips) 
Seat 5: ucLrYHo2o2p/ZURC7/I6gQ ($14.75 in chips) 
Seat 6: oKO7b50N6TzXbPBr/mcrUA ($29 in chips) 
Seat 7: eFrBtVXGVoMq1UwCDg8Exg ($29.05 in chips) 
Seat 8: sJNHTWcSlLHRCZ9+YRLLqA ($25 in chips) 
Seat 9: ljemhp25Zg+nlA9DLCIiUw ($24.65 in chips) 
mpsfNtnMVDqQHTe92AhIdw: posts small blind $0.10
uJlzv9KL7hgCIqIS2ofoaw: posts big blind $0.25
*** HOLE CARDS ***
WfS0TjI8FyLemNTOo1e9qA: folds 
ucLrYHo2o2p/ZURC7/I6gQ: calls $0.25
WfS0TjI8FyLemNTOo1e9qA leaves the table
oKO7b50N6TzXbPBr/mcrUA: folds 
eFrBtVXGVoMq1UwCDg8Exg: folds 
sJNHTWcSlLHRCZ9+YRLLqA: folds 
ljemhp25Zg+nlA9DLCIiUw: folds 
opOCI2p6kW0tINuVaAqmcQ: folds 
mpsfNtnMVDqQHTe92AhIdw: folds 
uJlzv9KL7hgCIqIS2ofoaw: checks 
*** FLOP *** [2c 3h 4s]
MrPo4/ymXwg9lzPRybrXbA joins the table at seat #4 
uJlzv9KL7hgCIqIS2ofoaw: checks 
ucLrYHo2o2p/ZURC7/I6gQ: checks 
*** TURN *** [2c 3h 4s] [8c]
uJlzv9KL7hgCIqIS2ofoaw: checks 
ucLrYHo2o2p/ZURC7/I6gQ: bets $0.50
uJlzv9KL7hgCIqIS2ofoaw: folds 
Uncalled bet ($0.50) returned to ucLrYHo2o2p/ZURC7/I6gQ
ucLrYHo2o2p/ZURC7/I6gQ collected $0.60 from pot
*** SUMMARY ***
Total pot $0.60 | Rake $0 
Board [2c 3h 4s 8c]
Seat 1: opOCI2p6kW0tINuVaAqmcQ (button) folded before Flop (didn't bet)
Seat 2: mpsfNtnMVDqQHTe92AhIdw (small blind) folded before Flop
Seat 3: uJlzv9KL7hgCIqIS2ofoaw (big blind) folded on the Turn
Seat 4: WfS0TjI8FyLemNTOo1e9qA folded before Flop (didn't bet)
Seat 5: ucLrYHo2o2p/ZURC7/I6gQ collected ($0.60)
Seat 6: oKO7b50N6TzXbPBr/mcrUA folded before Flop (didn't bet)
Seat 7: eFrBtVXGVoMq1UwCDg8Exg folded before Flop (didn't bet)
Seat 8: sJNHTWcSlLHRCZ9+YRLLqA folded before Flop (didn't bet)
Seat 9: ljemhp25Zg+nlA9DLCIiUw folded before Flop (didn't bet)




PokerStars Game #59939732538:  Hold'em No Limit ($0.10/$0.25) - 2009/07/01 0:47:30 ET
Table 'P2yJ+jwfNsBdF12fLKA6DQ' 9-max Seat #5 is the button
Seat 1: zDrucyjVn5aeekNEc3cJrA ($26.15 in chips) 
Seat 2: V6p0jQ/RhUsqpHLmXvEX4Q ($12.35 in chips) 
Seat 3: aNpwfA31EREwO+ar4XzBCw ($26.10 in chips) 
Seat 4: dfNim92Z6XK1/h5SFW5vDg ($25 in chips) 
Seat 5: KUcJLaHvrSlvGyIGqDQp9A ($15.35 in chips) 
Seat 7: 1/DuWziR8CXhWB71aPQd9Q ($9.40 in chips) 
Seat 8: LWN1wPrLH+695JIriXxDuw ($14.95 in chips) 
Seat 9: dN5zq7QdZCUe7NZFM6cECg ($27.35 in chips) 
1/DuWziR8CXhWB71aPQd9Q: posts small blind $0.10
LWN1wPrLH+695JIriXxDuw: posts big blind $0.25
*** HOLE CARDS ***
dN5zq7QdZCUe7NZFM6cECg: raises $0.50 to $0.75
zDrucyjVn5aeekNEc3cJrA: folds 
V6p0jQ/RhUsqpHLmXvEX4Q: folds 
aNpwfA31EREwO+ar4XzBCw: folds 
dfNim92Z6XK1/h5SFW5vDg: folds 
KUcJLaHvrSlvGyIGqDQp9A: folds 
1/DuWziR8CXhWB71aPQd9Q: folds 
LWN1wPrLH+695JIriXxDuw: calls $0.50
*** FLOP *** [7d Td Kc]
LWN1wPrLH+695JIriXxDuw: bets $0.50
dN5zq7QdZCUe7NZFM6cECg: raises $2 to $2.50
LWN1wPrLH+695JIriXxDuw: calls $2
*** TURN *** [7d Td Kc] [Qc]
lucky_man09 joins the table at seat #6 
LWN1wPrLH+695JIriXxDuw: checks 
dN5zq7QdZCUe7NZFM6cECg: checks 
*** RIVER *** [7d Td Kc Qc] [Qd]
LWN1wPrLH+695JIriXxDuw: bets $1.25
dN5zq7QdZCUe7NZFM6cECg said, "nh"
dN5zq7QdZCUe7NZFM6cECg: folds 
Uncalled bet ($1.25) returned to LWN1wPrLH+695JIriXxDuw
LWN1wPrLH+695JIriXxDuw collected $6.30 from pot
LWN1wPrLH+695JIriXxDuw: doesn't show hand 
*** SUMMARY ***
Total pot $6.60 | Rake $0.30 
Board [7d Td Kc Qc Qd]
Seat 1: zDrucyjVn5aeekNEc3cJrA folded before Flop (didn't bet)
Seat 2: V6p0jQ/RhUsqpHLmXvEX4Q folded before Flop (didn't bet)
Seat 3: aNpwfA31EREwO+ar4XzBCw folded before Flop (didn't bet)
Seat 4: dfNim92Z6XK1/h5SFW5vDg folded before Flop (didn't bet)
Seat 5: KUcJLaHvrSlvGyIGqDQp9A (button) folded before Flop (didn't bet)
Seat 7: 1/DuWziR8CXhWB71aPQd9Q (small blind) folded before Flop
Seat 8: LWN1wPrLH+695JIriXxDuw (big blind) collected ($6.30)
Seat 9: dN5zq7QdZCUe7NZFM6cECg folded on the River




PokerStars Game #59939732696:  Hold'em No Limit ($0.10/$0.25) - 2009/07/01 0:47:30 ET
Table '0w9m+UkNlGMNoPyQqzWk6A' 9-max Seat #4 is the button
Seat 2: tYsOBqdU1+x+yFI7zHO7hQ ($45.20 in chips) 
Seat 3: VWwtMkIjXloiX/RKh7RGWQ ($11 in chips) 
Seat 4: VBHxUExRAMrbxUq/cVx9Gw ($5.75 in chips) 
Seat 5: rPXwQUVloUl+qZm3CCtaJw ($16.25 in chips) 
Seat 6: sWBBy1WroEskLNyJzhkUag ($20.55 in chips) 
Seat 7: lrTLp1zpuCCs/e0pi2M8jw ($7.75 in chips) 
Seat 8: hPhp/RE3cJ5YGaQ2xOHXXg ($4.15 in chips) 
Seat 9: 56S3mA6Zs3pGR+0p0vUCtg ($27.80 in chips) 
rPXwQUVloUl+qZm3CCtaJw: posts small blind $0.10
sWBBy1WroEskLNyJzhkUag: posts big blind $0.25
DnDcAdn9P0zGovMERigpFA: sits out 
*** HOLE CARDS ***
lrTLp1zpuCCs/e0pi2M8jw: folds 
hPhp/RE3cJ5YGaQ2xOHXXg: folds 
56S3mA6Zs3pGR+0p0vUCtg: folds 
tYsOBqdU1+x+yFI7zHO7hQ: folds 
VWwtMkIjXloiX/RKh7RGWQ: calls $0.25
VBHxUExRAMrbxUq/cVx9Gw: raises $1 to $1.25
rPXwQUVloUl+qZm3CCtaJw: calls $1.15
sWBBy1WroEskLNyJzhkUag: folds 
VWwtMkIjXloiX/RKh7RGWQ: folds 
*** FLOP *** [Jd 7d 8h]
rPXwQUVloUl+qZm3CCtaJw: checks 
VBHxUExRAMrbxUq/cVx9Gw: bets $2
rPXwQUVloUl+qZm3CCtaJw: calls $2
*** TURN *** [Jd 7d 8h] [3h]
rPXwQUVloUl+qZm3CCtaJw: checks 
VBHxUExRAMrbxUq/cVx9Gw: checks 
*** RIVER *** [Jd 7d 8h 3h] [Ah]
rPXwQUVloUl+qZm3CCtaJw: checks 
VBHxUExRAMrbxUq/cVx9Gw: bets $2.50 and is all-in
rPXwQUVloUl+qZm3CCtaJw: folds 
Uncalled bet ($2.50) returned to VBHxUExRAMrbxUq/cVx9Gw
VBHxUExRAMrbxUq/cVx9Gw collected $6.70 from pot
*** SUMMARY ***
Total pot $7 | Rake $0.30 
Board [Jd 7d 8h 3h Ah]
Seat 2: tYsOBqdU1+x+yFI7zHO7hQ folded before Flop (didn't bet)
Seat 3: VWwtMkIjXloiX/RKh7RGWQ folded before Flop
Seat 4: VBHxUExRAMrbxUq/cVx9Gw (button) collected ($6.70)
Seat 5: rPXwQUVloUl+qZm3CCtaJw (small blind) folded on the River
Seat 6: sWBBy1WroEskLNyJzhkUag (big blind) folded before Flop
Seat 7: lrTLp1zpuCCs/e0pi2M8jw folded before Flop (didn't bet)
Seat 8: hPhp/RE3cJ5YGaQ2xOHXXg folded before Flop (didn't bet)
Seat 9: 56S3mA6Zs3pGR+0p0vUCtg folded before Flop (didn't bet)




PokerStars Game #59939732810:  Hold'em No Limit ($0.10/$0.25) - 2009/07/01 0:47:30 ET
Table 'ykyWGjhNu7AvZXov27T4ew' 9-max Seat #9 is the button
Seat 2: MG90wfSJZnOejs/KD3vlQQ ($46.95 in chips) 
Seat 3: r1pFKMwWp74QwhfPWJOAyw ($6.20 in chips) 
Seat 4: hBMUlEpyU74r/fwDgIpXjQ ($25 in chips) 
Seat 5: lMysP2jE94oJvWGA6K5puw ($7 in chips) 
Seat 6: opOCI2p6kW0tINuVaAqmcQ ($25.55 in chips) 
Seat 7: CYkY0dNBaYaKs8HVCVn3mQ ($4.65 in chips) 
Seat 8: tYsOBqdU1+x+yFI7zHO7hQ ($35.50 in chips) 
Seat 9: nm4Dj/f+jJEwKVsUnKh73g ($24.25 in chips) 
roswell519 was removed from the table for failing to post
MG90wfSJZnOejs/KD3vlQQ: posts small blind $0.10
r1pFKMwWp74QwhfPWJOAyw: posts big blind $0.25
*** HOLE CARDS ***
hBMUlEpyU74r/fwDgIpXjQ: folds 
lMysP2jE94oJvWGA6K5puw: folds 
opOCI2p6kW0tINuVaAqmcQ: raises $0.50 to $0.75
CYkY0dNBaYaKs8HVCVn3mQ: folds 
tYsOBqdU1+x+yFI7zHO7hQ: folds 
nm4Dj/f+jJEwKVsUnKh73g: folds 
MG90wfSJZnOejs/KD3vlQQ: folds 
r1pFKMwWp74QwhfPWJOAyw: calls $0.50
*** FLOP *** [8d Th 5c]
r1pFKMwWp74QwhfPWJOAyw: checks 
W8cIfrCR+zA8pCNyIuHu8g joins the table at seat #1 
opOCI2p6kW0tINuVaAqmcQ: checks 
*** TURN *** [8d Th 5c] [9d]
r1pFKMwWp74QwhfPWJOAyw: bets $0.25
opOCI2p6kW0tINuVaAqmcQ: folds 
Uncalled bet ($0.25) returned to r1pFKMwWp74QwhfPWJOAyw
r1pFKMwWp74QwhfPWJOAyw collected $1.55 from pot
*** SUMMARY ***
Total pot $1.60 | Rake $0.05 
Board [8d Th 5c 9d]
Seat 2: MG90wfSJZnOejs/KD3vlQQ (small blind) folded before Flop
Seat 3: r1pFKMwWp74QwhfPWJOAyw (big blind) collected ($1.55)
Seat 4: hBMUlEpyU74r/fwDgIpXjQ folded before Flop (didn't bet)
Seat 5: lMysP2jE94oJvWGA6K5puw folded before Flop (didn't bet)
Seat 6: opOCI2p6kW0tINuVaAqmcQ folded on the Turn
Seat 7: CYkY0dNBaYaKs8HVCVn3mQ folded before Flop (didn't bet)
Seat 8: tYsOBqdU1+x+yFI7zHO7hQ folded before Flop (didn't bet)
Seat 9: nm4Dj/f+jJEwKVsUnKh73g (button) folded before Flop (didn't bet)




PokerStars Game #59939732608:  Hold'em No Limit ($0.10/$0.25) - 2009/07/01 0:47:30 ET
Table 'axb9RsG8Zj1A0LEukTeFrQ' 9-max Seat #9 is the button
Seat 1: qwr38jl5txoR36M7G5qi4A ($10 in chips) 
Seat 2: zDrucyjVn5aeekNEc3cJrA ($21.60 in chips) 
Seat 3: cZ99hugmLBj9KhTlc8nCSw ($27.65 in chips) 
Seat 4: TeWJxSETzbXGiYKx0y+dtg ($24.65 in chips) 
Seat 5: rLSSHKOHnb6yzVfDoQM/RA ($12.05 in chips) 
Seat 6: FSuhElWc38JXYToR0dwhjg ($15.60 in chips) 
Seat 8: CqwJk5Z2+vb2f9j1o7IjKQ ($27.40 in chips) 
Seat 9: qbQE8CifKB4+OEvNF/61Rw ($38.45 in chips) 
qwr38jl5txoR36M7G5qi4A: posts small blind $0.10
zDrucyjVn5aeekNEc3cJrA: posts big blind $0.25
*** HOLE CARDS ***
cZ99hugmLBj9KhTlc8nCSw: folds 
TeWJxSETzbXGiYKx0y+dtg: folds 
rLSSHKOHnb6yzVfDoQM/RA: folds 
FSuhElWc38JXYToR0dwhjg: folds 
CqwJk5Z2+vb2f9j1o7IjKQ: calls $0.25
qbQE8CifKB4+OEvNF/61Rw: folds 
qwr38jl5txoR36M7G5qi4A: folds 
zDrucyjVn5aeekNEc3cJrA: checks 
*** FLOP *** [6h 2d Tc]
zDrucyjVn5aeekNEc3cJrA: checks 
CqwJk5Z2+vb2f9j1o7IjKQ: bets $0.25
zDrucyjVn5aeekNEc3cJrA: folds 
Uncalled bet ($0.25) returned to CqwJk5Z2+vb2f9j1o7IjKQ
CqwJk5Z2+vb2f9j1o7IjKQ said, "his mother is a *****"
CqwJk5Z2+vb2f9j1o7IjKQ collected $0.60 from pot
*** SUMMARY ***
Total pot $0.60 | Rake $0 
Board [6h 2d Tc]
Seat 1: qwr38jl5txoR36M7G5qi4A (small blind) folded before Flop
Seat 2: zDrucyjVn5aeekNEc3cJrA (big blind) folded on the Flop
Seat 3: cZ99hugmLBj9KhTlc8nCSw folded before Flop (didn't bet)
Seat 4: TeWJxSETzbXGiYKx0y+dtg folded before Flop (didn't bet)
Seat 5: rLSSHKOHnb6yzVfDoQM/RA folded before Flop (didn't bet)
Seat 6: FSuhElWc38JXYToR0dwhjg folded before Flop (didn't bet)
Seat 8: CqwJk5Z2+vb2f9j1o7IjKQ collected ($0.60)
Seat 9: qbQE8CifKB4+OEvNF/61Rw (button) folded before Flop (didn't bet)




PokerStars Game #59939732366:  Hold'em No Limit ($0.10/$0.25) - 2009/07/01 0:47:30 ET
Table '1HT8bEDpLPhOXxmqMtzF8w' 9-max Seat #1 is the button
Seat 1: s7Q6uNouhe7aE8JdFb9E+A ($44.25 in chips) 
Seat 2: r6hsffOo1iKmaPYKwAZmFw ($31 in chips) 
Seat 3: UJbH2fMMSFUo/jbJteWjjQ ($4.25 in chips) 
Seat 5: +iRmxp/CsJ/zuqdUG3CXNw ($13.65 in chips) 
Seat 6: 4oA316mXLIui1QY63GXBUg ($25 in chips) 
Seat 7: DIBbjEYGs+TVdVgEB/4+3w ($29.85 in chips) 
Seat 8: ghNKXUBl/H+t83JF079ZBA ($25.50 in chips) 
Seat 9: 86vbuhJsyH+nbEg5qpDLyQ ($25 in chips) 
r6hsffOo1iKmaPYKwAZmFw: posts small blind $0.10
UJbH2fMMSFUo/jbJteWjjQ: posts big blind $0.25
*** HOLE CARDS ***
+iRmxp/CsJ/zuqdUG3CXNw: calls $0.25
4oA316mXLIui1QY63GXBUg: folds 
DIBbjEYGs+TVdVgEB/4+3w: folds 
ghNKXUBl/H+t83JF079ZBA: folds 
86vbuhJsyH+nbEg5qpDLyQ: folds 
s7Q6uNouhe7aE8JdFb9E+A: folds 
r6hsffOo1iKmaPYKwAZmFw: folds 
UJbH2fMMSFUo/jbJteWjjQ: checks 
*** FLOP *** [Ac 5s 7d]
UJbH2fMMSFUo/jbJteWjjQ: checks 
+iRmxp/CsJ/zuqdUG3CXNw: bets $0.75
UJbH2fMMSFUo/jbJteWjjQ: folds 
Uncalled bet ($0.75) returned to +iRmxp/CsJ/zuqdUG3CXNw
+iRmxp/CsJ/zuqdUG3CXNw collected $0.60 from pot
+iRmxp/CsJ/zuqdUG3CXNw: doesn't show hand 
*** SUMMARY ***
Total pot $0.60 | Rake $0 
Board [Ac 5s 7d]
Seat 1: s7Q6uNouhe7aE8JdFb9E+A (button) folded before Flop (didn't bet)
Seat 2: r6hsffOo1iKmaPYKwAZmFw (small blind) folded before Flop
Seat 3: UJbH2fMMSFUo/jbJteWjjQ (big blind) folded on the Flop
Seat 5: +iRmxp/CsJ/zuqdUG3CXNw collected ($0.60)
Seat 6: 4oA316mXLIui1QY63GXBUg folded before Flop (didn't bet)
Seat 7: DIBbjEYGs+TVdVgEB/4+3w folded before Flop (didn't bet)
Seat 8: ghNKXUBl/H+t83JF079ZBA folded before Flop (didn't bet)
Seat 9: 86vbuhJsyH+nbEg5qpDLyQ folded before Flop (didn't bet)




PokerStars Game #59939733066:  Hold'em No Limit ($0.10/$0.25) - 2009/07/01 0:47:31 ET
Table 'sDHjMRwfSiz7+NDdZLUiyA' 9-max Seat #7 is the button
Seat 1: N6fYvIzQLKaydFLKQGtMlQ ($24.40 in chips) 
Seat 2: ljemhp25Zg+nlA9DLCIiUw ($27.15 in chips) 
Seat 3: SGA1WpAnQxFdFAYyt362gQ ($15.30 in chips) 
Seat 4: v5jnQ1gfh9nLla3kMXG7Yg ($16.30 in chips) 
Seat 5: IGRfskE1v9H9Bn+fz8AgNQ ($26.30 in chips) 
Seat 6: DlXs37dlX3tb7o/7lYXQSw ($24.65 in chips) 
Seat 7: K0b5wNInj6hUGRr6yzKFtw ($28.55 in chips) 
Seat 8: 3hMkm4U5yTRrkGJkxfijaQ ($27.80 in chips) 
3hMkm4U5yTRrkGJkxfijaQ: posts small blind $0.10
N6fYvIzQLKaydFLKQGtMlQ: posts big blind $0.25
*** HOLE CARDS ***
TeWJxSETzbXGiYKx0y+dtg joins the table at seat #9 
ljemhp25Zg+nlA9DLCIiUw: folds 
SGA1WpAnQxFdFAYyt362gQ: calls $0.25
v5jnQ1gfh9nLla3kMXG7Yg: folds 
IGRfskE1v9H9Bn+fz8AgNQ: folds 
DlXs37dlX3tb7o/7lYXQSw: folds 
K0b5wNInj6hUGRr6yzKFtw: raises $1 to $1.25
3hMkm4U5yTRrkGJkxfijaQ: calls $1.15
N6fYvIzQLKaydFLKQGtMlQ: calls $1
SGA1WpAnQxFdFAYyt362gQ: folds 
*** FLOP *** [3s Td Qs]
3hMkm4U5yTRrkGJkxfijaQ: checks 
N6fYvIzQLKaydFLKQGtMlQ: checks 
K0b5wNInj6hUGRr6yzKFtw: bets $1.50
3hMkm4U5yTRrkGJkxfijaQ: folds 
N6fYvIzQLKaydFLKQGtMlQ: folds 
Uncalled bet ($1.50) returned to K0b5wNInj6hUGRr6yzKFtw
K0b5wNInj6hUGRr6yzKFtw collected $3.80 from pot
K0b5wNInj6hUGRr6yzKFtw: doesn't show hand 
*** SUMMARY ***
Total pot $4 | Rake $0.20 
Board [3s Td Qs]
Seat 1: N6fYvIzQLKaydFLKQGtMlQ (big blind) folded on the Flop
Seat 2: ljemhp25Zg+nlA9DLCIiUw folded before Flop (didn't bet)
Seat 3: SGA1WpAnQxFdFAYyt362gQ folded before Flop
Seat 4: v5jnQ1gfh9nLla3kMXG7Yg folded before Flop (didn't bet)
Seat 5: IGRfskE1v9H9Bn+fz8AgNQ folded before Flop (didn't bet)
Seat 6: DlXs37dlX3tb7o/7lYXQSw folded before Flop (didn't bet)
Seat 7: K0b5wNInj6hUGRr6yzKFtw (button) collected ($3.80)
Seat 8: 3hMkm4U5yTRrkGJkxfijaQ (small blind) folded on the Flop




PokerStars Game #59939733100:  Hold'em No Limit ($0.10/$0.25) - 2009/07/01 0:47:31 ET
Table 'XX2OuOsa8/8AC+/mR/Az6g' 9-max Seat #8 is the button
Seat 1: 56S3mA6Zs3pGR+0p0vUCtg ($28.15 in chips) 
Seat 2: MIVCHqCqqlke0Lb0z7glcw ($23.80 in chips) 
Seat 3: 4f9D0JPPUArSbyY3vqNlXQ ($7.90 in chips) 
Seat 5: jXz58rvCgq0VjyVjUBf2mw ($23.75 in chips) 
Seat 6: gT0nY7XiR+2FA+B3F4h8HQ ($25.35 in chips) 
Seat 7: zDrucyjVn5aeekNEc3cJrA ($20.45 in chips) 
Seat 8: qwr38jl5txoR36M7G5qi4A ($7.50 in chips) 
Seat 9: 86vbuhJsyH+nbEg5qpDLyQ ($45.70 in chips) 
86vbuhJsyH+nbEg5qpDLyQ: posts small blind $0.10
56S3mA6Zs3pGR+0p0vUCtg: posts big blind $0.25
*** HOLE CARDS ***
MIVCHqCqqlke0Lb0z7glcw: folds 
4f9D0JPPUArSbyY3vqNlXQ: calls $0.25
jXz58rvCgq0VjyVjUBf2mw: raises $1 to $1.25
gT0nY7XiR+2FA+B3F4h8HQ: folds 
zDrucyjVn5aeekNEc3cJrA: folds 
qwr38jl5txoR36M7G5qi4A: folds 
86vbuhJsyH+nbEg5qpDLyQ: folds 
56S3mA6Zs3pGR+0p0vUCtg: folds 
4f9D0JPPUArSbyY3vqNlXQ: calls $1
*** FLOP *** [9d 3c 3s]
4f9D0JPPUArSbyY3vqNlXQ: checks 
jXz58rvCgq0VjyVjUBf2mw: bets $1.50
4f9D0JPPUArSbyY3vqNlXQ: calls $1.50
*** TURN *** [9d 3c 3s] [Td]
4f9D0JPPUArSbyY3vqNlXQ: checks 
jXz58rvCgq0VjyVjUBf2mw: checks 
*** RIVER *** [9d 3c 3s Td] [8c]
4f9D0JPPUArSbyY3vqNlXQ: bets $0.25
jXz58rvCgq0VjyVjUBf2mw: calls $0.25
*** SHOW DOWN ***
4f9D0JPPUArSbyY3vqNlXQ: shows [5c Qc] (a pair of Threes)
jXz58rvCgq0VjyVjUBf2mw: shows [Kc Qd] (a pair of Threes - King kicker)
jXz58rvCgq0VjyVjUBf2mw collected $6.05 from pot
*** SUMMARY ***
Total pot $6.35 | Rake $0.30 
Board [9d 3c 3s Td 8c]
Seat 1: 56S3mA6Zs3pGR+0p0vUCtg (big blind) folded before Flop
Seat 2: MIVCHqCqqlke0Lb0z7glcw folded before Flop (didn't bet)
Seat 3: 4f9D0JPPUArSbyY3vqNlXQ showed [5c Qc] and lost with a pair of Threes
Seat 5: jXz58rvCgq0VjyVjUBf2mw showed [Kc Qd] and won ($6.05) with a pair of Threes
Seat 6: gT0nY7XiR+2FA+B3F4h8HQ folded before Flop (didn't bet)
Seat 7: zDrucyjVn5aeekNEc3cJrA folded before Flop (didn't bet)
Seat 8: qwr38jl5txoR36M7G5qi4A (button) folded before Flop (didn't bet)
Seat 9: 86vbuhJsyH+nbEg5qpDLyQ (small blind) folded before Flop




PokerStars Game #59939732978:  Hold'em No Limit ($0.10/$0.25) - 2009/07/01 0:47:31 ET
Table 'nteM56rtr9SxLEblf0fvbw' 9-max Seat #9 is the button
Seat 1: H9KUl8cmpLgEpOVDA00bCg ($10 in chips) 
Seat 2: ljemhp25Zg+nlA9DLCIiUw ($25.20 in chips) 
Seat 4: cZ99hugmLBj9KhTlc8nCSw ($25.15 in chips) 
Seat 5: aJy680tKSaP5er559aSuGA ($4.95 in chips) 
Seat 6: LH8Esb23EO9V9GrKx+ymWQ ($6.50 in chips) 
Seat 7: dfNim92Z6XK1/h5SFW5vDg ($49.05 in chips) 
Seat 8: RJ/x9oZtt1RZLaJEQwZOxQ ($43.90 in chips) 
Seat 9: t2nb95S5EEFOEzNx9Itz0g ($6.20 in chips) 
H9KUl8cmpLgEpOVDA00bCg: posts small blind $0.10
ljemhp25Zg+nlA9DLCIiUw: posts big blind $0.25
6RiVTYll/5D8zICp0MRpKw: sits out 
*** HOLE CARDS ***
cZ99hugmLBj9KhTlc8nCSw: folds 
aJy680tKSaP5er559aSuGA: folds 
LH8Esb23EO9V9GrKx+ymWQ: raises $0.50 to $0.75
dfNim92Z6XK1/h5SFW5vDg: folds 
RJ/x9oZtt1RZLaJEQwZOxQ: folds 
t2nb95S5EEFOEzNx9Itz0g: folds 
H9KUl8cmpLgEpOVDA00bCg: folds 
ljemhp25Zg+nlA9DLCIiUw: folds 
Uncalled bet ($0.50) returned to LH8Esb23EO9V9GrKx+ymWQ
LH8Esb23EO9V9GrKx+ymWQ collected $0.60 from pot
*** SUMMARY ***
Total pot $0.60 | Rake $0 
Seat 1: H9KUl8cmpLgEpOVDA00bCg (small blind) folded before Flop
Seat 2: ljemhp25Zg+nlA9DLCIiUw (big blind) folded before Flop
Seat 4: cZ99hugmLBj9KhTlc8nCSw folded before Flop (didn't bet)
Seat 5: aJy680tKSaP5er559aSuGA folded before Flop (didn't bet)
Seat 6: LH8Esb23EO9V9GrKx+ymWQ collected ($0.60)
Seat 7: dfNim92Z6XK1/h5SFW5vDg folded before Flop (didn't bet)
Seat 8: RJ/x9oZtt1RZLaJEQwZOxQ folded before Flop (didn't bet)
Seat 9: t2nb95S5EEFOEzNx9Itz0g (button) folded before Flop (didn't bet)




PokerStars Game #59939733052:  Hold'em No Limit ($0.10/$0.25) - 2009/07/01 0:47:31 ET
Table 'aisAlB9GIV21BwfUW3+Nbg' 9-max Seat #5 is the button
Seat 1: H5Se03ZqSX7tbULXur2MAg ($30.30 in chips) 
Seat 2: 18G4P1XstjNvItdGUITxgw ($25.35 in chips) 
Seat 3: aaNpjkDAbOD7pVe8Z5CEgQ ($22.65 in chips) 
Seat 4: sD+TKtt36XiiN6jqHiLwDA ($24.50 in chips) 
Seat 5: ghNKXUBl/H+t83JF079ZBA ($25 in chips) 
Seat 6: 9gmYYQesalMrUjaF7nKfrQ ($7.35 in chips) 
Seat 7: sWBBy1WroEskLNyJzhkUag ($9.25 in chips) 
Seat 8: VWUWpMLMj/Q1jRVpF7Aohw ($14.30 in chips) 
Seat 9: OlPJsgR4xypSg/w1z7Gyvw ($28.30 in chips) 
9gmYYQesalMrUjaF7nKfrQ: posts small blind $0.10
sWBBy1WroEskLNyJzhkUag: posts big blind $0.25
*** HOLE CARDS ***
VWUWpMLMj/Q1jRVpF7Aohw: folds 
OlPJsgR4xypSg/w1z7Gyvw: folds 
H5Se03ZqSX7tbULXur2MAg: folds 
18G4P1XstjNvItdGUITxgw: folds 
aaNpjkDAbOD7pVe8Z5CEgQ: folds 
sD+TKtt36XiiN6jqHiLwDA: folds 
ghNKXUBl/H+t83JF079ZBA: folds 
9gmYYQesalMrUjaF7nKfrQ: folds 
Uncalled bet ($0.15) returned to sWBBy1WroEskLNyJzhkUag
sWBBy1WroEskLNyJzhkUag collected $0.20 from pot
sWBBy1WroEskLNyJzhkUag: doesn't show hand 
*** SUMMARY ***
Total pot $0.20 | Rake $0 
Seat 1: H5Se03ZqSX7tbULXur2MAg folded before Flop (didn't bet)
Seat 2: 18G4P1XstjNvItdGUITxgw folded before Flop (didn't bet)
Seat 3: aaNpjkDAbOD7pVe8Z5CEgQ folded before Flop (didn't bet)
Seat 4: sD+TKtt36XiiN6jqHiLwDA folded before Flop (didn't bet)
Seat 5: ghNKXUBl/H+t83JF079ZBA (button) folded before Flop (didn't bet)
Seat 6: 9gmYYQesalMrUjaF7nKfrQ (small blind) folded before Flop
Seat 7: sWBBy1WroEskLNyJzhkUag (big blind) collected ($0.20)
Seat 8: VWUWpMLMj/Q1jRVpF7Aohw folded before Flop (didn't bet)
Seat 9: OlPJsgR4xypSg/w1z7Gyvw folded before Flop (didn't bet)




PokerStars Game #59939732958:  Hold'em No Limit ($0.10/$0.25) - 2009/07/01 0:47:31 ET
Table 'HQOv+27sJF7e8+zUsBlT2w' 9-max Seat #2 is the button
Seat 1: CbXUS6Z2rXZxL1AKduNtmQ ($25.75 in chips) 
Seat 2: MG90wfSJZnOejs/KD3vlQQ ($25 in chips) 
Seat 3: 18G4P1XstjNvItdGUITxgw ($29.20 in chips) 
Seat 4: kRW/Cdh6F1t40Vs43OFbYA ($16.85 in chips) 
Seat 5: nD+0ILJGeuYzreVIK9/wcA ($16.85 in chips) 
Seat 6: vZGoOTJLQLhkPj4I+LNGig ($30.25 in chips) 
Seat 7: GmzfAfxcxu1kGbPC+9LkVg ($23.80 in chips) 
Seat 8: RaXCy4DBrUrZSg4MF8FyDg ($14.25 in chips) 
Seat 9: gehe91e0IyVT0QU/XBkEyg ($25 in chips) 
18G4P1XstjNvItdGUITxgw: posts small blind $0.10
kRW/Cdh6F1t40Vs43OFbYA: posts big blind $0.25
*** HOLE CARDS ***
nD+0ILJGeuYzreVIK9/wcA: raises $0.50 to $0.75
vZGoOTJLQLhkPj4I+LNGig: folds 
GmzfAfxcxu1kGbPC+9LkVg: folds 
RaXCy4DBrUrZSg4MF8FyDg: folds 
gehe91e0IyVT0QU/XBkEyg: folds 
CbXUS6Z2rXZxL1AKduNtmQ: folds 
MG90wfSJZnOejs/KD3vlQQ: calls $0.75
18G4P1XstjNvItdGUITxgw: raises $0.50 to $1.25
kRW/Cdh6F1t40Vs43OFbYA: folds 
nD+0ILJGeuYzreVIK9/wcA: calls $0.50
MG90wfSJZnOejs/KD3vlQQ: calls $0.50
*** FLOP *** [2s 2d 4h]
18G4P1XstjNvItdGUITxgw: bets $2
nD+0ILJGeuYzreVIK9/wcA: folds 
MG90wfSJZnOejs/KD3vlQQ: folds 
Uncalled bet ($2) returned to 18G4P1XstjNvItdGUITxgw
18G4P1XstjNvItdGUITxgw collected $3.80 from pot
18G4P1XstjNvItdGUITxgw: doesn't show hand 
*** SUMMARY ***
Total pot $4 | Rake $0.20 
Board [2s 2d 4h]
Seat 1: CbXUS6Z2rXZxL1AKduNtmQ folded before Flop (didn't bet)
Seat 2: MG90wfSJZnOejs/KD3vlQQ (button) folded on the Flop
Seat 3: 18G4P1XstjNvItdGUITxgw (small blind) collected ($3.80)
Seat 4: kRW/Cdh6F1t40Vs43OFbYA (big blind) folded before Flop
Seat 5: nD+0ILJGeuYzreVIK9/wcA folded on the Flop
Seat 6: vZGoOTJLQLhkPj4I+LNGig folded before Flop (didn't bet)
Seat 7: GmzfAfxcxu1kGbPC+9LkVg folded before Flop (didn't bet)
Seat 8: RaXCy4DBrUrZSg4MF8FyDg folded before Flop (didn't bet)
Seat 9: gehe91e0IyVT0QU/XBkEyg folded before Flop (didn't bet)




PokerStars Game #59939732956:  Hold'em No Limit ($0.10/$0.25) - 2009/07/01 0:47:31 ET
Table 'B3/JTS7usG3rxMfTbMiZuw' 6-max Seat #1 is the button
Seat 1: wAKC8C/zN0c8V5v13dm9mA ($31.75 in chips) 
Seat 2: 2gqWqkOq59pvtJKe4nS+rw ($22.40 in chips) 
Seat 3: PbMzPZIePKifKQZfKDkbIw ($25.35 in chips) 
Seat 4: kPCKvyB1yAABEgvF7OaG0g ($24 in chips) 
Seat 5: NhUN/JpAprdJeamFBgJH1w ($28.90 in chips) 
Seat 6: 6DwBRH+xZ12AAZmeAg+aXw ($25 in chips) 
2gqWqkOq59pvtJKe4nS+rw: posts small blind $0.10
PbMzPZIePKifKQZfKDkbIw: posts big blind $0.25
*** HOLE CARDS ***
kPCKvyB1yAABEgvF7OaG0g: calls $0.25
NhUN/JpAprdJeamFBgJH1w: folds 
6DwBRH+xZ12AAZmeAg+aXw: folds 
wAKC8C/zN0c8V5v13dm9mA is disconnected 
wAKC8C/zN0c8V5v13dm9mA is connected 
wAKC8C/zN0c8V5v13dm9mA: folds 
2gqWqkOq59pvtJKe4nS+rw: folds 
PbMzPZIePKifKQZfKDkbIw: checks 
*** FLOP *** [2d 8h 8c]
PbMzPZIePKifKQZfKDkbIw: checks 
kPCKvyB1yAABEgvF7OaG0g: bets $0.75
PbMzPZIePKifKQZfKDkbIw: calls $0.75
*** TURN *** [2d 8h 8c] [7d]
PbMzPZIePKifKQZfKDkbIw: checks 
kPCKvyB1yAABEgvF7OaG0g: bets $2.50
PbMzPZIePKifKQZfKDkbIw: calls $2.50
*** RIVER *** [2d 8h 8c 7d] [8d]
PbMzPZIePKifKQZfKDkbIw: checks 
kPCKvyB1yAABEgvF7OaG0g: bets $8
PbMzPZIePKifKQZfKDkbIw: folds 
Uncalled bet ($8) returned to kPCKvyB1yAABEgvF7OaG0g
kPCKvyB1yAABEgvF7OaG0g collected $6.75 from pot
kPCKvyB1yAABEgvF7OaG0g: doesn't show hand 
*** SUMMARY ***
Total pot $7.10 | Rake $0.35 
Board [2d 8h 8c 7d 8d]
Seat 1: wAKC8C/zN0c8V5v13dm9mA (button) folded before Flop (didn't bet)
Seat 2: 2gqWqkOq59pvtJKe4nS+rw (small blind) folded before Flop
Seat 3: PbMzPZIePKifKQZfKDkbIw (big blind) folded on the River
Seat 4: kPCKvyB1yAABEgvF7OaG0g collected ($6.75)
Seat 5: NhUN/JpAprdJeamFBgJH1w folded before Flop (didn't bet)
Seat 6: 6DwBRH+xZ12AAZmeAg+aXw folded before Flop (didn't bet)




PokerStars Game #59939733240:  Hold'em No Limit ($0.10/$0.25) - 2009/07/01 0:47:31 ET
Table 'MRfAiS/4JSfnUDlCcZo0wAhfHe8uKeSJMyWAjSdM7ROQx Seat #3 is the button
Seat 1: 48oT5xFI+5CHUJlfoGrE4w ($18.05 in chips) 
Seat 2: /gJNBeCkWL4o85/jvlZ4BA ($34.70 in chips) 
Seat 3: FYepjhAvF8ZdVCmqHIy+eQ ($44.80 in chips) 
Seat 4: Go8clNIDGP3feVvzBDG4pg ($12.40 in chips) 
Seat 5: qccGLncfUaN00Few5HsgYg ($29.70 in chips) 
Seat 6: VaDPspfGS2lnEkaGNrNqfg ($12.90 in chips) 
Go8clNIDGP3feVvzBDG4pg: posts small blind $0.10
qccGLncfUaN00Few5HsgYg: posts big blind $0.25
*** HOLE CARDS ***
VaDPspfGS2lnEkaGNrNqfg: raises $0.50 to $0.75
48oT5xFI+5CHUJlfoGrE4w: folds 
/gJNBeCkWL4o85/jvlZ4BA: folds 
FYepjhAvF8ZdVCmqHIy+eQ: folds 
Go8clNIDGP3feVvzBDG4pg: folds 
qccGLncfUaN00Few5HsgYg: calls $0.50
*** FLOP *** [3c As 7c]
qccGLncfUaN00Few5HsgYg: checks 
VaDPspfGS2lnEkaGNrNqfg: bets $1.25
qccGLncfUaN00Few5HsgYg: folds 
Uncalled bet ($1.25) returned to VaDPspfGS2lnEkaGNrNqfg
VaDPspfGS2lnEkaGNrNqfg collected $1.55 from pot
VaDPspfGS2lnEkaGNrNqfg: doesn't show hand 
*** SUMMARY ***
Total pot $1.60 | Rake $0.05 
Board [3c As 7c]
Seat 1: 48oT5xFI+5CHUJlfoGrE4w folded before Flop (didn't bet)
Seat 2: /gJNBeCkWL4o85/jvlZ4BA folded before Flop (didn't bet)
Seat 3: FYepjhAvF8ZdVCmqHIy+eQ (button) folded before Flop (didn't bet)
Seat 4: Go8clNIDGP3feVvzBDG4pg (small blind) folded before Flop
Seat 5: qccGLncfUaN00Few5HsgYg (big blind) folded on the Flop
Seat 6: VaDPspfGS2lnEkaGNrNqfg collected ($1.55)




PokerStars Game #59939733208:  Hold'em No Limit ($0.10/$0.25) - 2009/07/01 0:47:31 ET
Table 'f9j+4UOgRPXbyNbQkZFm4w' 6-max Seat #6 is the button
Seat 1: BYxjLnV1/LL0aZcTbfAOvw ($25 in chips) 
Seat 2: Zb8xGmbjS8ghABxs9n6huA ($15 in chips) 
Seat 3: wCBHaebpIJ2ZTqigoRi9DA ($20.95 in chips) 
Seat 4: hiTEr3yrERiQp3zHXRioVw ($26.80 in chips) 
Seat 5: 1lxYIAoJdZwAbzIkzWmSkw ($10.65 in chips) 
Seat 6: C84t1kUtjDF/zm38/Dpcng ($14.50 in chips) 
BYxjLnV1/LL0aZcTbfAOvw: posts small blind $0.10
Zb8xGmbjS8ghABxs9n6huA: posts big blind $0.25
*** HOLE CARDS ***
wCBHaebpIJ2ZTqigoRi9DA: folds 
hiTEr3yrERiQp3zHXRioVw: folds 
1lxYIAoJdZwAbzIkzWmSkw: calls $0.25
C84t1kUtjDF/zm38/Dpcng: calls $0.25
wCBHaebpIJ2ZTqigoRi9DA leaves the table
BYxjLnV1/LL0aZcTbfAOvw: calls $0.15
Zb8xGmbjS8ghABxs9n6huA: checks 
*** FLOP *** [Ks 7c 9h]
BYxjLnV1/LL0aZcTbfAOvw: checks 
Zb8xGmbjS8ghABxs9n6huA: checks 
1lxYIAoJdZwAbzIkzWmSkw: checks 
ljjhtb6FVPTx9AT9HNdtqg joins the table at seat #3 
C84t1kUtjDF/zm38/Dpcng: bets $1
BYxjLnV1/LL0aZcTbfAOvw: folds 
Zb8xGmbjS8ghABxs9n6huA: folds 
1lxYIAoJdZwAbzIkzWmSkw: folds 
Uncalled bet ($1) returned to C84t1kUtjDF/zm38/Dpcng
C84t1kUtjDF/zm38/Dpcng collected $0.95 from pot
*** SUMMARY ***
Total pot $1 | Rake $0.05 
Board [Ks 7c 9h]
Seat 1: BYxjLnV1/LL0aZcTbfAOvw (small blind) folded on the Flop
Seat 2: Zb8xGmbjS8ghABxs9n6huA (big blind) folded on the Flop
Seat 3: wCBHaebpIJ2ZTqigoRi9DA folded before Flop (didn't bet)
Seat 4: hiTEr3yrERiQp3zHXRioVw folded before Flop (didn't bet)
Seat 5: 1lxYIAoJdZwAbzIkzWmSkw folded on the Flop
Seat 6: C84t1kUtjDF/zm38/Dpcng (button) collected ($0.95)




PokerStars Game #59939732854:  Hold'em No Limit ($0.10/$0.25) - 2009/07/01 0:47:31 ET
Table 'KU/HrxqxwDz8HKEhYTZ6uw' 6-max Seat #6 is the button
Seat 1: gaPMxLGp9SOj4Lq6t+/0Ig ($26.90 in chips) 
Seat 2: kG34n23qFQA3nzdOJTQ1dA ($24.65 in chips) 
Seat 4: ozxrnSdjO4oiCJmh7+KoTA ($25 in chips) 
Seat 5: 4YSTu0Cdzpppe1lUgCZGCQ ($38.55 in chips) 
Seat 6: QIWnfLSqfMcoFfdDe5LZPg ($18.75 in chips) 
gaPMxLGp9SOj4Lq6t+/0Ig: posts small blind $0.10
kG34n23qFQA3nzdOJTQ1dA: posts big blind $0.25
*** HOLE CARDS ***
3seg9SJ1y+HUPN0X0XKF5Q leaves the table
ozxrnSdjO4oiCJmh7+KoTA: folds 
4YSTu0Cdzpppe1lUgCZGCQ: raises $0.75 to $1
1jFObj6f7pP/FIdxrZFhyg joins the table at seat #3 
QIWnfLSqfMcoFfdDe5LZPg: folds 
gaPMxLGp9SOj4Lq6t+/0Ig: folds 
kG34n23qFQA3nzdOJTQ1dA: folds 
Uncalled bet ($0.75) returned to 4YSTu0Cdzpppe1lUgCZGCQ
4YSTu0Cdzpppe1lUgCZGCQ collected $0.60 from pot
4YSTu0Cdzpppe1lUgCZGCQ: doesn't show hand 
*** SUMMARY ***
Total pot $0.60 | Rake $0 
Seat 1: gaPMxLGp9SOj4Lq6t+/0Ig (small blind) folded before Flop
Seat 2: kG34n23qFQA3nzdOJTQ1dA (big blind) folded before Flop
Seat 4: ozxrnSdjO4oiCJmh7+KoTA folded before Flop (didn't bet)
Seat 5: 4YSTu0Cdzpppe1lUgCZGCQ collected ($0.60)
Seat 6: QIWnfLSqfMcoFfdDe5LZPg (button) folded before Flop (didn't bet)




PokerStars Game #59939732938:  Hold'em No Limit ($0.10/$0.25) - 2009/07/01 0:47:31 ET
Table 'IrJPyZ3JW2iIa+krdoSbJQ' 9-max Seat #4 is the button
Seat 1: 4+E2msto8r80F3SH2gctVA ($24.75 in chips) 
Seat 3: vZGoOTJLQLhkPj4I+LNGig ($25 in chips) 
Seat 4: DnDcAdn9P0zGovMERigpFA ($25 in chips) 
Seat 5: sUVgUtgbfVx6JpvApozwhQ ($6.35 in chips) 
Seat 6: +sbyWwIcFp9kP0bDtMegfQ ($24.65 in chips) 
Seat 7: uH1RN27w9SKa7TpVR9EFrQ ($22.45 in chips) 
Seat 8: VBHxUExRAMrbxUq/cVx9Gw ($5 in chips) 
sUVgUtgbfVx6JpvApozwhQ: posts small blind $0.10
+sbyWwIcFp9kP0bDtMegfQ: posts big blind $0.25
+WMpj67YqG8ilNkg2JwXpw: sits out 
Mr_GlamoRouS: sits out 
*** HOLE CARDS ***
uH1RN27w9SKa7TpVR9EFrQ: folds 
VBHxUExRAMrbxUq/cVx9Gw: folds 
4+E2msto8r80F3SH2gctVA: folds 
vZGoOTJLQLhkPj4I+LNGig: folds 
DnDcAdn9P0zGovMERigpFA: folds 
sUVgUtgbfVx6JpvApozwhQ: folds 
Uncalled bet ($0.15) returned to +sbyWwIcFp9kP0bDtMegfQ
+sbyWwIcFp9kP0bDtMegfQ collected $0.20 from pot
*** SUMMARY ***
Total pot $0.20 | Rake $0 
Seat 1: 4+E2msto8r80F3SH2gctVA folded before Flop (didn't bet)
Seat 3: vZGoOTJLQLhkPj4I+LNGig folded before Flop (didn't bet)
Seat 4: DnDcAdn9P0zGovMERigpFA (button) folded before Flop (didn't bet)
Seat 5: sUVgUtgbfVx6JpvApozwhQ (small blind) folded before Flop
Seat 6: +sbyWwIcFp9kP0bDtMegfQ (big blind) collected ($0.20)
Seat 7: uH1RN27w9SKa7TpVR9EFrQ folded before Flop (didn't bet)
Seat 8: VBHxUExRAMrbxUq/cVx9Gw folded before Flop (didn't bet)




PokerStars Game #59939734002:  Hold'em No Limit ($0.10/$0.25) - 2009/07/01 0:47:32 ET
Table 'by7aHYEDnDd144EXOXa/jA' 9-max Seat #3 is the button
Seat 2: vSkQm2EelzwRGDDQQk0Fqw ($5.15 in chips) 
Seat 3: 1Clf3cPrqoy/YgvWdWK1Xw ($5.20 in chips) 
Seat 4: vZGoOTJLQLhkPj4I+LNGig ($47.15 in chips) 
Seat 5: yyG4svzOpC1A+sUP/scg6w ($7.15 in chips) 
Seat 6: DIBbjEYGs+TVdVgEB/4+3w ($30.85 in chips) 
Seat 8: s7Q6uNouhe7aE8JdFb9E+A ($25.60 in chips) 
Seat 9: K0b5wNInj6hUGRr6yzKFtw ($25.35 in chips) 
vZGoOTJLQLhkPj4I+LNGig: posts small blind $0.10
yyG4svzOpC1A+sUP/scg6w: posts big blind $0.25
V6p0jQ/RhUsqpHLmXvEX4Q: sits out 
j4q3p0lesp63b1gZDwLBZw: sits out 
*** HOLE CARDS ***
DIBbjEYGs+TVdVgEB/4+3w: folds 
s7Q6uNouhe7aE8JdFb9E+A: folds 
K0b5wNInj6hUGRr6yzKFtw: folds 
vSkQm2EelzwRGDDQQk0Fqw: raises $0.75 to $1
1Clf3cPrqoy/YgvWdWK1Xw: folds 
vZGoOTJLQLhkPj4I+LNGig: folds 
yyG4svzOpC1A+sUP/scg6w: folds 
Uncalled bet ($0.75) returned to vSkQm2EelzwRGDDQQk0Fqw
vSkQm2EelzwRGDDQQk0Fqw collected $0.60 from pot
vSkQm2EelzwRGDDQQk0Fqw: doesn't show hand 
*** SUMMARY ***
Total pot $0.60 | Rake $0 
Seat 2: vSkQm2EelzwRGDDQQk0Fqw collected ($0.60)
Seat 3: 1Clf3cPrqoy/YgvWdWK1Xw (button) folded before Flop (didn't bet)
Seat 4: vZGoOTJLQLhkPj4I+LNGig (small blind) folded before Flop
Seat 5: yyG4svzOpC1A+sUP/scg6w (big blind) folded before Flop
Seat 6: DIBbjEYGs+TVdVgEB/4+3w folded before Flop (didn't bet)
Seat 8: s7Q6uNouhe7aE8JdFb9E+A folded before Flop (didn't bet)
Seat 9: K0b5wNInj6hUGRr6yzKFtw folded before Flop (didn't bet)




PokerStars Game #59939733468:  Hold'em No Limit ($0.10/$0.25) - 2009/07/01 0:47:32 ET
Table '+68ihX5Br1xgGorX6zsCBg' 9-max Seat #5 is the button
Seat 1: qwr38jl5txoR36M7G5qi4A ($7.50 in chips) 
Seat 2: TeAfhXG1R60d8yPEHN3JiA ($25 in chips) 
Seat 3: DIBbjEYGs+TVdVgEB/4+3w ($22.40 in chips) 
Seat 5: AmFFUA8KSwLGIW6CfaP4JQ ($15.45 in chips) 
Seat 6: 8B/dhbQjIWe6ASCdgzktNQ ($25.60 in chips) 
Seat 7: LWN1wPrLH+695JIriXxDuw ($8.85 in chips) 
Seat 8: rUdM7gwmNCaxMNSb2CFPhQ ($13.15 in chips) 
8B/dhbQjIWe6ASCdgzktNQ: posts small blind $0.10
LWN1wPrLH+695JIriXxDuw: posts big blind $0.25
TeAfhXG1R60d8yPEHN3JiA: posts big blind $0.25
*** HOLE CARDS ***
rUdM7gwmNCaxMNSb2CFPhQ: folds 
qwr38jl5txoR36M7G5qi4A: folds 
TeAfhXG1R60d8yPEHN3JiA: raises $0.25 to $0.50
DIBbjEYGs+TVdVgEB/4+3w: folds 
AmFFUA8KSwLGIW6CfaP4JQ: folds 
AmFFUA8KSwLGIW6CfaP4JQ leaves the table
8B/dhbQjIWe6ASCdgzktNQ: folds 
LWN1wPrLH+695JIriXxDuw: calls $0.25
*** FLOP *** [4s Jc Th]
LWN1wPrLH+695JIriXxDuw: bets $0.50
TeAfhXG1R60d8yPEHN3JiA: calls $0.50
*** TURN *** [4s Jc Th] [5c]
LWN1wPrLH+695JIriXxDuw: checks 
TeAfhXG1R60d8yPEHN3JiA: bets $0.25
LWN1wPrLH+695JIriXxDuw: calls $0.25
*** RIVER *** [4s Jc Th 5c] [8c]
LWN1wPrLH+695JIriXxDuw: checks 
TeAfhXG1R60d8yPEHN3JiA: bets $0.25
LWN1wPrLH+695JIriXxDuw: calls $0.25
*** SHOW DOWN ***
TeAfhXG1R60d8yPEHN3JiA: shows [7d 7h] (a pair of Sevens)
LWN1wPrLH+695JIriXxDuw: shows [Ts 9c] (a pair of Tens)
LWN1wPrLH+695JIriXxDuw collected $2.95 from pot
*** SUMMARY ***
Total pot $3.10 | Rake $0.15 
Board [4s Jc Th 5c 8c]
Seat 1: qwr38jl5txoR36M7G5qi4A folded before Flop (didn't bet)
Seat 2: TeAfhXG1R60d8yPEHN3JiA showed [7d 7h] and lost with a pair of Sevens
Seat 3: DIBbjEYGs+TVdVgEB/4+3w folded before Flop (didn't bet)
Seat 5: AmFFUA8KSwLGIW6CfaP4JQ (button) folded before Flop (didn't bet)
Seat 6: 8B/dhbQjIWe6ASCdgzktNQ (small blind) folded before Flop
Seat 7: LWN1wPrLH+695JIriXxDuw (big blind) showed [Ts 9c] and won ($2.95) with a pair of Tens
Seat 8: rUdM7gwmNCaxMNSb2CFPhQ folded before Flop (didn't bet)




PokerStars Game #59939733696:  Hold'em No Limit ($0.10/$0.25) - 2009/07/01 0:47:32 ET
Table 'dZNBGqFYSwfOVZvDJ4VjIQ' 6-max Seat #1 is the button
Seat 1: o08wk0F4gROLhZS04Iyl3w ($27.10 in chips) 
Seat 2: 3zD3qLXT1bEffAoWGnc7wg ($25 in chips) 
Seat 3: Mch463E1dxQfVob352za6w ($29.05 in chips) 
Seat 4: df01R5ThvHspD8FgKmaDvQ ($26.95 in chips) 
Seat 6: VbudEd0ZG+qPwMO9h+hjXw ($15.45 in chips) 
3zD3qLXT1bEffAoWGnc7wg: posts small blind $0.10
Mch463E1dxQfVob352za6w: posts big blind $0.25
pitty1199: sits out 
*** HOLE CARDS ***
df01R5ThvHspD8FgKmaDvQ: folds 
VbudEd0ZG+qPwMO9h+hjXw: calls $0.25
o08wk0F4gROLhZS04Iyl3w: raises $0.85 to $1.10
3zD3qLXT1bEffAoWGnc7wg: folds 
Mch463E1dxQfVob352za6w: folds 
VbudEd0ZG+qPwMO9h+hjXw: calls $0.85
*** FLOP *** [5c 6d Td]
VbudEd0ZG+qPwMO9h+hjXw: checks 
o08wk0F4gROLhZS04Iyl3w: bets $2
VbudEd0ZG+qPwMO9h+hjXw: calls $2
*** TURN *** [5c 6d Td] [7d]
VbudEd0ZG+qPwMO9h+hjXw: checks 
o08wk0F4gROLhZS04Iyl3w: checks 
*** RIVER *** [5c 6d Td 7d] [Ts]
VbudEd0ZG+qPwMO9h+hjXw: bets $12.35 and is all-in
o08wk0F4gROLhZS04Iyl3w: folds 
Uncalled bet ($12.35) returned to VbudEd0ZG+qPwMO9h+hjXw
VbudEd0ZG+qPwMO9h+hjXw collected $6.25 from pot
VbudEd0ZG+qPwMO9h+hjXw: doesn't show hand 
*** SUMMARY ***
Total pot $6.55 | Rake $0.30 
Board [5c 6d Td 7d Ts]
Seat 1: o08wk0F4gROLhZS04Iyl3w (button) folded on the River
Seat 2: 3zD3qLXT1bEffAoWGnc7wg (small blind) folded before Flop
Seat 3: Mch463E1dxQfVob352za6w (big blind) folded before Flop
Seat 4: df01R5ThvHspD8FgKmaDvQ folded before Flop (didn't bet)
Seat 6: VbudEd0ZG+qPwMO9h+hjXw collected ($6.25)




PokerStars Game #59939733608:  Hold'em No Limit ($0.10/$0.25) - 2009/07/01 0:47:32 ET
Table 'Loy/olZ5qoDOSvX4UTujGg' 6-max Seat #5 is the button
Seat 1: yzFNNFIfC89bBPwpFPx2ow ($25 in chips) 
Seat 2: 5OssdLlobpBsQP4GLYbbZQ ($5.95 in chips) 
Seat 3: 32YL2ZEp8NT4JB2RVM9euQ ($19.95 in chips) 
Seat 4: /gJNBeCkWL4o85/jvlZ4BA ($26.75 in chips) 
Seat 5: 4YSTu0Cdzpppe1lUgCZGCQ ($62.35 in chips) 
Seat 6: 7FmwVDcdEtxDpHmP4hOXsQ ($52.10 in chips) 
7FmwVDcdEtxDpHmP4hOXsQ: posts small blind $0.10
yzFNNFIfC89bBPwpFPx2ow: posts big blind $0.25
*** HOLE CARDS ***
5OssdLlobpBsQP4GLYbbZQ: folds 
32YL2ZEp8NT4JB2RVM9euQ has timed out
32YL2ZEp8NT4JB2RVM9euQ: folds 
32YL2ZEp8NT4JB2RVM9euQ is sitting out
32YL2ZEp8NT4JB2RVM9euQ has returned
/gJNBeCkWL4o85/jvlZ4BA: raises $0.75 to $1
4YSTu0Cdzpppe1lUgCZGCQ: folds 
7FmwVDcdEtxDpHmP4hOXsQ: folds 
yzFNNFIfC89bBPwpFPx2ow: folds 
Uncalled bet ($0.75) returned to /gJNBeCkWL4o85/jvlZ4BA
/gJNBeCkWL4o85/jvlZ4BA collected $0.60 from pot
*** SUMMARY ***
Total pot $0.60 | Rake $0 
Seat 1: yzFNNFIfC89bBPwpFPx2ow (big blind) folded before Flop
Seat 2: 5OssdLlobpBsQP4GLYbbZQ folded before Flop (didn't bet)
Seat 3: 32YL2ZEp8NT4JB2RVM9euQ folded before Flop (didn't bet)
Seat 4: /gJNBeCkWL4o85/jvlZ4BA collected ($0.60)
Seat 5: 4YSTu0Cdzpppe1lUgCZGCQ (button) folded before Flop (didn't bet)
Seat 6: 7FmwVDcdEtxDpHmP4hOXsQ (small blind) folded before Flop




PokerStars Game #59939733546:  Hold'em No Limit ($0.10/$0.25) - 2009/07/01 0:47:32 ET
Table 'AJGgX1ZYM8d68SWMvaLttg' 6-max Seat #3 is the button
Seat 1: sT4sjqzVMH/fZHz0hkbIPw ($48.50 in chips) 
Seat 2: zHHLkD2sRljslKKeQv/ZQw ($28.10 in chips) 
Seat 3: 4x9jCqgSw4272dnaIqnanw ($5.75 in chips) 
Seat 4: Lz/GjRDgmgepqTR7qmS86w ($14.05 in chips) 
Seat 5: SFmT9ZsVopnukjvAzrxTRg ($25.75 in chips) 
Seat 6: UA5OsKS3VPaxa7uC8La/kA ($27.40 in chips) 
Lz/GjRDgmgepqTR7qmS86w: posts small blind $0.10
SFmT9ZsVopnukjvAzrxTRg: posts big blind $0.25
*** HOLE CARDS ***
UA5OsKS3VPaxa7uC8La/kA: folds 
sT4sjqzVMH/fZHz0hkbIPw: folds 
zHHLkD2sRljslKKeQv/ZQw: folds 
4x9jCqgSw4272dnaIqnanw: raises $5.50 to $5.75 and is all-in
Lz/GjRDgmgepqTR7qmS86w: calls $5.65
SFmT9ZsVopnukjvAzrxTRg: folds 
*** FLOP *** [4s 6c Kh]
*** TURN *** [4s 6c Kh] [8c]
*** RIVER *** [4s 6c Kh 8c] [7d]
*** SHOW DOWN ***
Lz/GjRDgmgepqTR7qmS86w: shows [Ad 9s] (high card Ace)
4x9jCqgSw4272dnaIqnanw: shows [2s 2h] (a pair of Deuces)
4x9jCqgSw4272dnaIqnanw collected $11.20 from pot
*** SUMMARY ***
Total pot $11.75 | Rake $0.55 
Board [4s 6c Kh 8c 7d]
Seat 1: sT4sjqzVMH/fZHz0hkbIPw folded before Flop (didn't bet)
Seat 2: zHHLkD2sRljslKKeQv/ZQw folded before Flop (didn't bet)
Seat 3: 4x9jCqgSw4272dnaIqnanw (button) showed [2s 2h] and won ($11.20) with a pair of Deuces
Seat 4: Lz/GjRDgmgepqTR7qmS86w (small blind) showed [Ad 9s] and lost with high card Ace
Seat 5: SFmT9ZsVopnukjvAzrxTRg (big blind) folded before Flop
Seat 6: UA5OsKS3VPaxa7uC8La/kA folded before Flop (didn't bet)




PokerStars Game #59939734034:  Hold'em No Limit ($0.10/$0.25) - 2009/07/01 0:47:32 ET
Table 'Pz8SfAzhP5nvWTsJRAxoDg' 6-max Seat #2 is the button
Seat 1: buyjetgNT1McXtdaP4zynA ($40.95 in chips) 
Seat 2: zxeVQGaMKDsDzmSY+AInjA ($15.90 in chips) 
Seat 3: mfrkWA3PTeYPkbO6hi98Aw ($38.55 in chips) 
Seat 4: 9U9Vy/656QCEfKznJWteag ($12.75 in chips) 
Seat 5: FYepjhAvF8ZdVCmqHIy+eQ ($30.10 in chips) 
Seat 6: FStoHe64SQWqAsjya9pDkQ ($25.35 in chips) 
mfrkWA3PTeYPkbO6hi98Aw: posts small blind $0.10
9U9Vy/656QCEfKznJWteag: posts big blind $0.25
*** HOLE CARDS ***
FYepjhAvF8ZdVCmqHIy+eQ: folds 
FStoHe64SQWqAsjya9pDkQ: raises $0.50 to $0.75
buyjetgNT1McXtdaP4zynA: folds 
zxeVQGaMKDsDzmSY+AInjA: folds 
mfrkWA3PTeYPkbO6hi98Aw: folds 
9U9Vy/656QCEfKznJWteag: folds 
Uncalled bet ($0.50) returned to FStoHe64SQWqAsjya9pDkQ
FStoHe64SQWqAsjya9pDkQ collected $0.60 from pot
*** SUMMARY ***
Total pot $0.60 | Rake $0 
Seat 1: buyjetgNT1McXtdaP4zynA folded before Flop (didn't bet)
Seat 2: zxeVQGaMKDsDzmSY+AInjA (button) folded before Flop (didn't bet)
Seat 3: mfrkWA3PTeYPkbO6hi98Aw (small blind) folded before Flop
Seat 4: 9U9Vy/656QCEfKznJWteag (big blind) folded before Flop
Seat 5: FYepjhAvF8ZdVCmqHIy+eQ folded before Flop (didn't bet)
Seat 6: FStoHe64SQWqAsjya9pDkQ collected ($0.60)




PokerStars Game #59939733912:  Hold'em No Limit ($0.10/$0.25) - 2009/07/01 0:47:32 ET
Table '/asc7VQ/OpF/oVJ3erB80w' 9-max Seat #8 is the button
Seat 1: OiV1PWZ3IkN29JlmCcnTwQ ($4.90 in chips) 
Seat 2: Th3FldXKQW6hWVVPahaoOQ ($25.45 in chips) 
Seat 3: ie4EwTMMFYxrCXcenJdzsw ($9.50 in chips) 
Seat 4: H9KUl8cmpLgEpOVDA00bCg ($5 in chips) 
Seat 5: 8B/dhbQjIWe6ASCdgzktNQ ($25 in chips) 
Seat 6: t2nb95S5EEFOEzNx9Itz0g ($3.80 in chips) 
Seat 7: M2QO2DxB5Wawg2h8HSpnYA ($11.65 in chips) 
Seat 8: T5Hk9oiIr+JDDMnEqwFCrw ($9.15 in chips) 
Seat 9: UkJraTKWQIqFeHOyHQ7afQ ($12.90 in chips) 
UkJraTKWQIqFeHOyHQ7afQ: posts small blind $0.10
OiV1PWZ3IkN29JlmCcnTwQ: posts big blind $0.25
*** HOLE CARDS ***
Th3FldXKQW6hWVVPahaoOQ: folds 
ie4EwTMMFYxrCXcenJdzsw: folds 
H9KUl8cmpLgEpOVDA00bCg: folds 
8B/dhbQjIWe6ASCdgzktNQ: folds 
t2nb95S5EEFOEzNx9Itz0g: folds 
M2QO2DxB5Wawg2h8HSpnYA: folds 
T5Hk9oiIr+JDDMnEqwFCrw: calls $0.25
UkJraTKWQIqFeHOyHQ7afQ: calls $0.15
OiV1PWZ3IkN29JlmCcnTwQ: checks 
*** FLOP *** [Tc Qs 2d]
UkJraTKWQIqFeHOyHQ7afQ: checks 
OiV1PWZ3IkN29JlmCcnTwQ: checks 
T5Hk9oiIr+JDDMnEqwFCrw: checks 
*** TURN *** [Tc Qs 2d] [5d]
UkJraTKWQIqFeHOyHQ7afQ: checks 
OiV1PWZ3IkN29JlmCcnTwQ: checks 
T5Hk9oiIr+JDDMnEqwFCrw: bets $0.25
UkJraTKWQIqFeHOyHQ7afQ: folds 
OiV1PWZ3IkN29JlmCcnTwQ: folds 
Uncalled bet ($0.25) returned to T5Hk9oiIr+JDDMnEqwFCrw
T5Hk9oiIr+JDDMnEqwFCrw collected $0.75 from pot
*** SUMMARY ***
Total pot $0.75 | Rake $0 
Board [Tc Qs 2d 5d]
Seat 1: OiV1PWZ3IkN29JlmCcnTwQ (big blind) folded on the Turn
Seat 2: Th3FldXKQW6hWVVPahaoOQ folded before Flop (didn't bet)
Seat 3: ie4EwTMMFYxrCXcenJdzsw folded before Flop (didn't bet)
Seat 4: H9KUl8cmpLgEpOVDA00bCg folded before Flop (didn't bet)
Seat 5: 8B/dhbQjIWe6ASCdgzktNQ folded before Flop (didn't bet)
Seat 6: t2nb95S5EEFOEzNx9Itz0g folded before Flop (didn't bet)
Seat 7: M2QO2DxB5Wawg2h8HSpnYA folded before Flop (didn't bet)
Seat 8: T5Hk9oiIr+JDDMnEqwFCrw (button) collected ($0.75)
Seat 9: UkJraTKWQIqFeHOyHQ7afQ (small blind) folded on the Turn




PokerStars Game #59939733896:  Hold'em No Limit ($0.10/$0.25) - 2009/07/01 0:47:32 ET
Table '0XPo7K54oZIfG0xlNAcDRw' 9-max Seat #6 is the button
Seat 1: opOCI2p6kW0tINuVaAqmcQ ($29.30 in chips) 
Seat 2: Jbrpc6KkvYcsiySJzLmFuA ($14.05 in chips) 
Seat 3: 6qsItdeWZoOL5be2e1RFng ($16.35 in chips) 
Seat 4: vOEICaqlJhPYytg64XnnkQ ($12.05 in chips) 
Seat 5: 8B/dhbQjIWe6ASCdgzktNQ ($40.25 in chips) 
Seat 6: 9gmYYQesalMrUjaF7nKfrQ ($9.35 in chips) 
Seat 7: tYsOBqdU1+x+yFI7zHO7hQ ($45.60 in chips) 
Seat 8: OiV1PWZ3IkN29JlmCcnTwQ ($5 in chips) 
Seat 9: s7Q6uNouhe7aE8JdFb9E+A ($25 in chips) 
tYsOBqdU1+x+yFI7zHO7hQ: posts small blind $0.10
OiV1PWZ3IkN29JlmCcnTwQ: posts big blind $0.25
*** HOLE CARDS ***
s7Q6uNouhe7aE8JdFb9E+A: folds 
opOCI2p6kW0tINuVaAqmcQ: folds 
Jbrpc6KkvYcsiySJzLmFuA: folds 
6qsItdeWZoOL5be2e1RFng: calls $0.25
vOEICaqlJhPYytg64XnnkQ: folds 
8B/dhbQjIWe6ASCdgzktNQ: folds 
9gmYYQesalMrUjaF7nKfrQ: folds 
tYsOBqdU1+x+yFI7zHO7hQ: folds 
OiV1PWZ3IkN29JlmCcnTwQ: checks 
*** FLOP *** [3d 9d Jh]
OiV1PWZ3IkN29JlmCcnTwQ: checks 
6qsItdeWZoOL5be2e1RFng: bets $0.50
OiV1PWZ3IkN29JlmCcnTwQ: folds 
Uncalled bet ($0.50) returned to 6qsItdeWZoOL5be2e1RFng
6qsItdeWZoOL5be2e1RFng collected $0.60 from pot
*** SUMMARY ***
Total pot $0.60 | Rake $0 
Board [3d 9d Jh]
Seat 1: opOCI2p6kW0tINuVaAqmcQ folded before Flop (didn't bet)
Seat 2: Jbrpc6KkvYcsiySJzLmFuA folded before Flop (didn't bet)
Seat 3: 6qsItdeWZoOL5be2e1RFng collected ($0.60)
Seat 4: vOEICaqlJhPYytg64XnnkQ folded before Flop (didn't bet)
Seat 5: 8B/dhbQjIWe6ASCdgzktNQ folded before Flop (didn't bet)
Seat 6: 9gmYYQesalMrUjaF7nKfrQ (button) folded before Flop (didn't bet)
Seat 7: tYsOBqdU1+x+yFI7zHO7hQ (small blind) folded before Flop
Seat 8: OiV1PWZ3IkN29JlmCcnTwQ (big blind) folded on the Flop
Seat 9: s7Q6uNouhe7aE8JdFb9E+A folded before Flop (didn't bet)




PokerStars Game #59939733624:  Hold'em No Limit ($0.10/$0.25) - 2009/07/01 0:47:32 ET
Table '9SExUHslNkrPJ4XsrePaVw' 9-max Seat #3 is the button
Seat 1: qpbN+BUWX0f/ckQSmOcmkw ($7.25 in chips) 
Seat 3: jeKWRUkMaVn8rEUjnJKqpg ($31.55 in chips) 
Seat 4: dyNjB7p93gTjZ0RXn2HnJA ($21 in chips) 
Seat 5: ydoFOVgzvZv9ZhuWu9rXAw ($5 in chips) 
Seat 6: DYB0aP91n+Rg/TIhycbaPQ ($7.20 in chips) 
Seat 7: 7cv+9Zc9HIQHNvYsMfV3uA ($25 in chips) 
Seat 8: t2nb95S5EEFOEzNx9Itz0g ($7.80 in chips) 
Seat 9: /THNzAxdv2lBxcf4XTj/0g ($16.35 in chips) 
dyNjB7p93gTjZ0RXn2HnJA: posts small blind $0.10
ydoFOVgzvZv9ZhuWu9rXAw: posts big blind $0.25
*** HOLE CARDS ***
DYB0aP91n+Rg/TIhycbaPQ: calls $0.25
7cv+9Zc9HIQHNvYsMfV3uA: folds 
t2nb95S5EEFOEzNx9Itz0g: folds 
/THNzAxdv2lBxcf4XTj/0g: calls $0.25
qpbN+BUWX0f/ckQSmOcmkw: folds 
jeKWRUkMaVn8rEUjnJKqpg: folds 
dyNjB7p93gTjZ0RXn2HnJA: calls $0.15
ydoFOVgzvZv9ZhuWu9rXAw: checks 
*** FLOP *** [5c 5s Kh]
dyNjB7p93gTjZ0RXn2HnJA: checks 
ydoFOVgzvZv9ZhuWu9rXAw: checks 
DYB0aP91n+Rg/TIhycbaPQ: checks 
/THNzAxdv2lBxcf4XTj/0g: checks 
*** TURN *** [5c 5s Kh] [7d]
dyNjB7p93gTjZ0RXn2HnJA: checks 
ydoFOVgzvZv9ZhuWu9rXAw: checks 
DYB0aP91n+Rg/TIhycbaPQ: checks 
/THNzAxdv2lBxcf4XTj/0g: bets $0.75
dyNjB7p93gTjZ0RXn2HnJA: folds 
ydoFOVgzvZv9ZhuWu9rXAw: folds 
DYB0aP91n+Rg/TIhycbaPQ: folds 
Uncalled bet ($0.75) returned to /THNzAxdv2lBxcf4XTj/0g
/THNzAxdv2lBxcf4XTj/0g collected $0.95 from pot
/THNzAxdv2lBxcf4XTj/0g: doesn't show hand 
*** SUMMARY ***
Total pot $1 | Rake $0.05 
Board [5c 5s Kh 7d]
Seat 1: qpbN+BUWX0f/ckQSmOcmkw folded before Flop (didn't bet)
Seat 3: jeKWRUkMaVn8rEUjnJKqpg (button) folded before Flop (didn't bet)
Seat 4: dyNjB7p93gTjZ0RXn2HnJA (small blind) folded on the Turn
Seat 5: ydoFOVgzvZv9ZhuWu9rXAw (big blind) folded on the Turn
Seat 6: DYB0aP91n+Rg/TIhycbaPQ folded on the Turn
Seat 7: 7cv+9Zc9HIQHNvYsMfV3uA folded before Flop (didn't bet)
Seat 8: t2nb95S5EEFOEzNx9Itz0g folded before Flop (didn't bet)
Seat 9: /THNzAxdv2lBxcf4XTj/0g collected ($0.95)




PokerStars Game #59939734642:  Hold'em No Limit ($0.10/$0.25) - 2009/07/01 0:47:33 ET
Table 'nRFAYu63wZNzrz/OBgzFTw' 9-max Seat #1 is the button
Seat 1: N6fYvIzQLKaydFLKQGtMlQ ($23.90 in chips) 
Seat 2: hJ4uYjNmSZdjrKA8cjZqCA ($18.95 in chips) 
Seat 3: W8cIfrCR+zA8pCNyIuHu8g ($15 in chips) 
Seat 4: OiV1PWZ3IkN29JlmCcnTwQ ($5.15 in chips) 
Seat 5: vKdukiQ4ktU4yJ0Xx3MKnA ($29.85 in chips) 
Seat 6: DnDcAdn9P0zGovMERigpFA ($25.25 in chips) 
Seat 7: dtZ84flFEi4Q+SGrHMJRDQ ($25 in chips) 
Seat 8: amHgC+Q9cpfD/2w2yUtNbw ($10 in chips) 
hJ4uYjNmSZdjrKA8cjZqCA: posts small blind $0.10
W8cIfrCR+zA8pCNyIuHu8g: posts big blind $0.25
*** HOLE CARDS ***
OiV1PWZ3IkN29JlmCcnTwQ: folds 
vKdukiQ4ktU4yJ0Xx3MKnA: folds 
DnDcAdn9P0zGovMERigpFA: folds 
dtZ84flFEi4Q+SGrHMJRDQ: folds 
amHgC+Q9cpfD/2w2yUtNbw: folds 
N6fYvIzQLKaydFLKQGtMlQ: raises $1 to $1.25
hJ4uYjNmSZdjrKA8cjZqCA: calls $1.15
W8cIfrCR+zA8pCNyIuHu8g: folds 
*** FLOP *** [Qh Qs 2s]
hJ4uYjNmSZdjrKA8cjZqCA: checks 
N6fYvIzQLKaydFLKQGtMlQ: bets $2.50
hJ4uYjNmSZdjrKA8cjZqCA: calls $2.50
*** TURN *** [Qh Qs 2s] [7c]
hJ4uYjNmSZdjrKA8cjZqCA: checks 
N6fYvIzQLKaydFLKQGtMlQ: checks 
*** RIVER *** [Qh Qs 2s 7c] [Kh]
hJ4uYjNmSZdjrKA8cjZqCA: bets $7.50
N6fYvIzQLKaydFLKQGtMlQ: folds 
Uncalled bet ($7.50) returned to hJ4uYjNmSZdjrKA8cjZqCA
hJ4uYjNmSZdjrKA8cjZqCA collected $7.40 from pot
*** SUMMARY ***
Total pot $7.75 | Rake $0.35 
Board [Qh Qs 2s 7c Kh]
Seat 1: N6fYvIzQLKaydFLKQGtMlQ (button) folded on the River
Seat 2: hJ4uYjNmSZdjrKA8cjZqCA (small blind) collected ($7.40)
Seat 3: W8cIfrCR+zA8pCNyIuHu8g (big blind) folded before Flop
Seat 4: OiV1PWZ3IkN29JlmCcnTwQ folded before Flop (didn't bet)
Seat 5: vKdukiQ4ktU4yJ0Xx3MKnA folded before Flop (didn't bet)
Seat 6: DnDcAdn9P0zGovMERigpFA folded before Flop (didn't bet)
Seat 7: dtZ84flFEi4Q+SGrHMJRDQ folded before Flop (didn't bet)
Seat 8: amHgC+Q9cpfD/2w2yUtNbw folded before Flop (didn't bet)




PokerStars Game #59939734138:  Hold'em No Limit ($0.10/$0.25) - 2009/07/01 0:47:33 ET
Table 'uFgIyfWPagvEVGEb86da7A' 9-max Seat #6 is the button
Seat 1: 5MgYq10OC5iGoxQFwlJVuw ($15 in chips) 
Seat 2: o3zvoO+PsqGti+1NZGNRrQ ($3.35 in chips) 
Seat 3: q4GZp0xt5Unxtq8PS32SAQ ($34.60 in chips) 
Seat 4: IGRfskE1v9H9Bn+fz8AgNQ ($25.75 in chips) 
Seat 5: V6p0jQ/RhUsqpHLmXvEX4Q ($14.75 in chips) 
Seat 6: zDrucyjVn5aeekNEc3cJrA ($33.95 in chips) 
Seat 8: MrPo4/ymXwg9lzPRybrXbA ($4.75 in chips) 
Seat 9: DnDcAdn9P0zGovMERigpFA ($25 in chips) 
MrPo4/ymXwg9lzPRybrXbA: posts small blind $0.10
DnDcAdn9P0zGovMERigpFA: posts big blind $0.25
*** HOLE CARDS ***
5MgYq10OC5iGoxQFwlJVuw: folds 
o3zvoO+PsqGti+1NZGNRrQ: folds 
5MgYq10OC5iGoxQFwlJVuw leaves the table
q4GZp0xt5Unxtq8PS32SAQ: raises $0.75 to $1
IGRfskE1v9H9Bn+fz8AgNQ: folds 
V6p0jQ/RhUsqpHLmXvEX4Q: folds 
zDrucyjVn5aeekNEc3cJrA: folds 
MrPo4/ymXwg9lzPRybrXbA: folds 
DnDcAdn9P0zGovMERigpFA: folds 
Uncalled bet ($0.75) returned to q4GZp0xt5Unxtq8PS32SAQ
M2QO2DxB5Wawg2h8HSpnYA joins the table at seat #1 
q4GZp0xt5Unxtq8PS32SAQ collected $0.60 from pot
q4GZp0xt5Unxtq8PS32SAQ: doesn't show hand 
*** SUMMARY ***
Total pot $0.60 | Rake $0 
Seat 1: 5MgYq10OC5iGoxQFwlJVuw folded before Flop (didn't bet)
Seat 2: o3zvoO+PsqGti+1NZGNRrQ folded before Flop (didn't bet)
Seat 3: q4GZp0xt5Unxtq8PS32SAQ collected ($0.60)
Seat 4: IGRfskE1v9H9Bn+fz8AgNQ folded before Flop (didn't bet)
Seat 5: V6p0jQ/RhUsqpHLmXvEX4Q folded before Flop (didn't bet)
Seat 6: zDrucyjVn5aeekNEc3cJrA (button) folded before Flop (didn't bet)
Seat 8: MrPo4/ymXwg9lzPRybrXbA (small blind) folded before Flop
Seat 9: DnDcAdn9P0zGovMERigpFA (big blind) folded before Flop




PokerStars Game #59939734506:  Hold'em No Limit ($0.10/$0.25) - 2009/07/01 0:47:33 ET
Table '8kaMIn+aON/ferW89Go6Pw' 9-max Seat #3 is the button
Seat 2: jeKWRUkMaVn8rEUjnJKqpg ($26.80 in chips) 
Seat 3: 7cv+9Zc9HIQHNvYsMfV3uA ($28.20 in chips) 
Seat 4: KRWTiGM4xH+MkvPtJz4+SA ($45.30 in chips) 
Seat 5: hIss79a4pu7GzJZepfgOpg ($32.25 in chips) 
Seat 6: 1S/fpm+f42V/6MNZre+ccg ($25 in chips) 
Seat 7: HVKi9hnDyvzObpL08/OarQ ($24.60 in chips) 
Seat 8: Rjy74A2wdEiDWplMcUbA+w ($15.35 in chips) 
Seat 9: ottZQkg1UDWk85BtBzGJzg ($15 in chips) 
KRWTiGM4xH+MkvPtJz4+SA: posts small blind $0.10
hIss79a4pu7GzJZepfgOpg: posts big blind $0.25
ottZQkg1UDWk85BtBzGJzg: posts big blind $0.25
*** HOLE CARDS ***
6RiVTYll/5D8zICp0MRpKw joins the table at seat #1 
1S/fpm+f42V/6MNZre+ccg: folds 
HVKi9hnDyvzObpL08/OarQ: folds 
Rjy74A2wdEiDWplMcUbA+w: folds 
ottZQkg1UDWk85BtBzGJzg: checks 
jeKWRUkMaVn8rEUjnJKqpg: raises $0.75 to $1
7cv+9Zc9HIQHNvYsMfV3uA: folds 
KRWTiGM4xH+MkvPtJz4+SA: folds 
hIss79a4pu7GzJZepfgOpg: folds 
ottZQkg1UDWk85BtBzGJzg: folds 
Uncalled bet ($0.75) returned to jeKWRUkMaVn8rEUjnJKqpg
jeKWRUkMaVn8rEUjnJKqpg collected $0.85 from pot
jeKWRUkMaVn8rEUjnJKqpg: doesn't show hand 
*** SUMMARY ***
Total pot $0.85 | Rake $0 
Seat 2: jeKWRUkMaVn8rEUjnJKqpg collected ($0.85)
Seat 3: 7cv+9Zc9HIQHNvYsMfV3uA (button) folded before Flop (didn't bet)
Seat 4: KRWTiGM4xH+MkvPtJz4+SA (small blind) folded before Flop
Seat 5: hIss79a4pu7GzJZepfgOpg (big blind) folded before Flop
Seat 6: 1S/fpm+f42V/6MNZre+ccg folded before Flop (didn't bet)
Seat 7: HVKi9hnDyvzObpL08/OarQ folded before Flop (didn't bet)
Seat 8: Rjy74A2wdEiDWplMcUbA+w folded before Flop (didn't bet)
Seat 9: ottZQkg1UDWk85BtBzGJzg folded before Flop




PokerStars Game #59939734464:  Hold'em No Limit ($0.10/$0.25) - 2009/07/01 0:47:33 ET
Table 'v+LTGPWbrLum+Ggd4ef6lg' 9-max Seat #8 is the button
Seat 3: 3m6VfX7io8SA31qh1zCkgQ ($10 in chips) 
Seat 8: +sbyWwIcFp9kP0bDtMegfQ ($34.60 in chips) 
+sbyWwIcFp9kP0bDtMegfQ: posts small blind $0.10
3m6VfX7io8SA31qh1zCkgQ: posts big blind $0.25
*** HOLE CARDS ***
+sbyWwIcFp9kP0bDtMegfQ: calls $0.15
3m6VfX7io8SA31qh1zCkgQ: checks 
*** FLOP *** [Ks 6s 3d]
3m6VfX7io8SA31qh1zCkgQ: checks 
+sbyWwIcFp9kP0bDtMegfQ: bets $1
3m6VfX7io8SA31qh1zCkgQ: folds 
Uncalled bet ($1) returned to +sbyWwIcFp9kP0bDtMegfQ
+sbyWwIcFp9kP0bDtMegfQ collected $0.50 from pot
*** SUMMARY ***
Total pot $0.50 | Rake $0 
Board [Ks 6s 3d]
Seat 3: 3m6VfX7io8SA31qh1zCkgQ (big blind) folded on the Flop
Seat 8: +sbyWwIcFp9kP0bDtMegfQ (button) (small blind) collected ($0.50)




PokerStars Game #59939734738:  Hold'em No Limit ($0.10/$0.25) - 2009/07/01 0:47:33 ET
Table 'KKk6y4pAXeymxYcd0uZLqg' 9-max Seat #2 is the button
Seat 1: HPEB+AtKw1+C/cxU0o1ciw ($24.55 in chips) 
Seat 2: k55YB7uP2TAZEba6pnHYiA ($18.90 in chips) 
Seat 3: 4oA316mXLIui1QY63GXBUg ($26.85 in chips) 
Seat 4: GTcLfsDTPqgfHyhY9FNDMw ($15.50 in chips) 
Seat 5: U0VVxBdRWdhRNdbJ+Qky1A ($46.30 in chips) 
Seat 6: LWN1wPrLH+695JIriXxDuw ($10.75 in chips) 
Seat 7: R3KkgiqTvuhazyCqaD9cZg ($10 in chips) 
Seat 8: +2kMBNpY4nF1qNCRd8SJLA ($26.35 in chips) 
Seat 9: j4q3p0lesp63b1gZDwLBZw ($5 in chips) 
4oA316mXLIui1QY63GXBUg: posts small blind $0.10
GTcLfsDTPqgfHyhY9FNDMw: posts big blind $0.25
*** HOLE CARDS ***
U0VVxBdRWdhRNdbJ+Qky1A: raises $0.25 to $0.50
LWN1wPrLH+695JIriXxDuw: folds 
R3KkgiqTvuhazyCqaD9cZg: folds 
+2kMBNpY4nF1qNCRd8SJLA: folds 
j4q3p0lesp63b1gZDwLBZw: folds 
HPEB+AtKw1+C/cxU0o1ciw: folds 
k55YB7uP2TAZEba6pnHYiA: calls $0.50
4oA316mXLIui1QY63GXBUg: folds 
GTcLfsDTPqgfHyhY9FNDMw: folds 
*** FLOP *** [8d 6s Td]
U0VVxBdRWdhRNdbJ+Qky1A: bets $0.75
k55YB7uP2TAZEba6pnHYiA: calls $0.75
*** TURN *** [8d 6s Td] [5c]
U0VVxBdRWdhRNdbJ+Qky1A: bets $1
k55YB7uP2TAZEba6pnHYiA: folds 
Uncalled bet ($1) returned to U0VVxBdRWdhRNdbJ+Qky1A
U0VVxBdRWdhRNdbJ+Qky1A collected $2.75 from pot
*** SUMMARY ***
Total pot $2.85 | Rake $0.10 
Board [8d 6s Td 5c]
Seat 1: HPEB+AtKw1+C/cxU0o1ciw folded before Flop (didn't bet)
Seat 2: k55YB7uP2TAZEba6pnHYiA (button) folded on the Turn
Seat 3: 4oA316mXLIui1QY63GXBUg (small blind) folded before Flop
Seat 4: GTcLfsDTPqgfHyhY9FNDMw (big blind) folded before Flop
Seat 5: U0VVxBdRWdhRNdbJ+Qky1A collected ($2.75)
Seat 6: LWN1wPrLH+695JIriXxDuw folded before Flop (didn't bet)
Seat 7: R3KkgiqTvuhazyCqaD9cZg folded before Flop (didn't bet)
Seat 8: +2kMBNpY4nF1qNCRd8SJLA folded before Flop (didn't bet)
Seat 9: j4q3p0lesp63b1gZDwLBZw folded before Flop (didn't bet)




PokerStars Game #59939734530:  Hold'em No Limit ($0.10/$0.25) - 2009/07/01 0:47:33 ET
Table 'dVzscin98UhGisTmV9BDcw' 9-max Seat #6 is the button
Seat 1: sBAwXpkpgyhyWbHIQcIJKA ($19.05 in chips) 
Seat 2: dfNim92Z6XK1/h5SFW5vDg ($28.80 in chips) 
Seat 3: 1Clf3cPrqoy/YgvWdWK1Xw ($5 in chips) 
Seat 4: aNpwfA31EREwO+ar4XzBCw ($25 in chips) 
Seat 5: 22dIObOuor/A+IKWkNoAlA ($5 in chips) 
Seat 6: hBMUlEpyU74r/fwDgIpXjQ ($28 in chips) 
Seat 7: nEg1b6MIksd/4x5eLY735g ($63.90 in chips) 
Seat 8: /vn2Qu2dvc9AMMq46Ae0jA ($7.35 in chips) 
Seat 9: OYa/ZJBO+suuezfWsUMhZw ($4.45 in chips) 
nEg1b6MIksd/4x5eLY735g: posts small blind $0.10
/vn2Qu2dvc9AMMq46Ae0jA: posts big blind $0.25
*** HOLE CARDS ***
OYa/ZJBO+suuezfWsUMhZw: folds 
sBAwXpkpgyhyWbHIQcIJKA: folds 
dfNim92Z6XK1/h5SFW5vDg: folds 
1Clf3cPrqoy/YgvWdWK1Xw has timed out
1Clf3cPrqoy/YgvWdWK1Xw: folds 
1Clf3cPrqoy/YgvWdWK1Xw is sitting out
aNpwfA31EREwO+ar4XzBCw: folds 
22dIObOuor/A+IKWkNoAlA: folds 
hBMUlEpyU74r/fwDgIpXjQ: folds 
nEg1b6MIksd/4x5eLY735g: folds 
Uncalled bet ($0.15) returned to /vn2Qu2dvc9AMMq46Ae0jA
/vn2Qu2dvc9AMMq46Ae0jA collected $0.20 from pot
*** SUMMARY ***
Total pot $0.20 | Rake $0 
Seat 1: sBAwXpkpgyhyWbHIQcIJKA folded before Flop (didn't bet)
Seat 2: dfNim92Z6XK1/h5SFW5vDg folded before Flop (didn't bet)
Seat 3: 1Clf3cPrqoy/YgvWdWK1Xw folded before Flop (didn't bet)
Seat 4: aNpwfA31EREwO+ar4XzBCw folded before Flop (didn't bet)
Seat 5: 22dIObOuor/A+IKWkNoAlA folded before Flop (didn't bet)
Seat 6: hBMUlEpyU74r/fwDgIpXjQ (button) folded before Flop (didn't bet)
Seat 7: nEg1b6MIksd/4x5eLY735g (small blind) folded before Flop
Seat 8: /vn2Qu2dvc9AMMq46Ae0jA (big blind) collected ($0.20)
Seat 9: OYa/ZJBO+suuezfWsUMhZw folded before Flop (didn't bet)




PokerStars Game #59939734554:  Hold'em No Limit ($0.10/$0.25) - 2009/07/01 0:47:33 ET
Table 'nyTW9cVtYentc5V7xU/0jA' 6-max Seat #5 is the button
Seat 1: YfxPRDAWfqnGBhiIEdlTYg ($9.90 in chips) 
Seat 2: 7FmwVDcdEtxDpHmP4hOXsQ ($26.40 in chips) 
Seat 3: kG34n23qFQA3nzdOJTQ1dA ($26.70 in chips) 
Seat 4: NkB3D4eVHHXvB9Edaugc1Q ($15.40 in chips) 
Seat 5: BedjMfrlRfPgSq7CXpPAmg ($30 in chips) 
Seat 6: dQJByDqHOLbgqX/HobyAJA ($3.55 in chips) 
dQJByDqHOLbgqX/HobyAJA: posts small blind $0.10
YfxPRDAWfqnGBhiIEdlTYg: posts big blind $0.25
*** HOLE CARDS ***
7FmwVDcdEtxDpHmP4hOXsQ: folds 
kG34n23qFQA3nzdOJTQ1dA: folds 
NkB3D4eVHHXvB9Edaugc1Q: folds 
BedjMfrlRfPgSq7CXpPAmg: folds 
dQJByDqHOLbgqX/HobyAJA: folds 
Uncalled bet ($0.15) returned to YfxPRDAWfqnGBhiIEdlTYg
YfxPRDAWfqnGBhiIEdlTYg collected $0.20 from pot
*** SUMMARY ***
Total pot $0.20 | Rake $0 
Seat 1: YfxPRDAWfqnGBhiIEdlTYg (big blind) collected ($0.20)
Seat 2: 7FmwVDcdEtxDpHmP4hOXsQ folded before Flop (didn't bet)
Seat 3: kG34n23qFQA3nzdOJTQ1dA folded before Flop (didn't bet)
Seat 4: NkB3D4eVHHXvB9Edaugc1Q folded before Flop (didn't bet)
Seat 5: BedjMfrlRfPgSq7CXpPAmg (button) folded before Flop (didn't bet)
Seat 6: dQJByDqHOLbgqX/HobyAJA (small blind) folded before Flop




PokerStars Game #59939734736:  Hold'em No Limit ($0.10/$0.25) - 2009/07/01 0:47:33 ET
Table '9iHhO6FyZVM8XpSc23TIgg' 6-max Seat #5 is the button
Seat 1: NhUN/JpAprdJeamFBgJH1w ($25 in chips) 
Seat 2: ErIN0JRL5srYjT6en1f8YQ ($30.80 in chips) 
Seat 4: cfJccEfyn6IkquPN08hFsA ($36.85 in chips) 
Seat 5: WmfI+HZXhME/HMG8E3/H2w ($32.25 in chips) 
Seat 6: WrLI51S2iMb8GLMB83gGqA ($25 in chips) 
WrLI51S2iMb8GLMB83gGqA: posts small blind $0.10
NhUN/JpAprdJeamFBgJH1w: posts big blind $0.25
RYLaAIIwK9wxkPswt1yJYw: sits out 
*** HOLE CARDS ***
ErIN0JRL5srYjT6en1f8YQ: folds 
cfJccEfyn6IkquPN08hFsA: folds 
WmfI+HZXhME/HMG8E3/H2w: raises $0.50 to $0.75
WrLI51S2iMb8GLMB83gGqA: folds 
NhUN/JpAprdJeamFBgJH1w: folds 
Uncalled bet ($0.50) returned to WmfI+HZXhME/HMG8E3/H2w
WmfI+HZXhME/HMG8E3/H2w collected $0.60 from pot
*** SUMMARY ***
Total pot $0.60 | Rake $0 
Seat 1: NhUN/JpAprdJeamFBgJH1w (big blind) folded before Flop
Seat 2: ErIN0JRL5srYjT6en1f8YQ folded before Flop (didn't bet)
Seat 4: cfJccEfyn6IkquPN08hFsA folded before Flop (didn't bet)
Seat 5: WmfI+HZXhME/HMG8E3/H2w (button) collected ($0.60)
Seat 6: WrLI51S2iMb8GLMB83gGqA (small blind) folded before Flop




PokerStars Game #59939734142:  Hold'em No Limit ($0.10/$0.25) - 2009/07/01 0:47:33 ET
Table 'L5GvbdQO5aCZJSE6pyQ8OA' 6-max Seat #2 is the button
Seat 1: FOcO5GvOP3rgvLGPLVkg5g ($31.85 in chips) 
Seat 2: LxehwDpTQ19ph4Qmc78+Pw ($12.80 in chips) 
Seat 3: awQwF96aCUBjOczgehY95A ($7.90 in chips) 
Seat 4: ErIN0JRL5srYjT6en1f8YQ ($34.25 in chips) 
Seat 6: v+QfkGiuj9bgtuNoVnDO8w ($38.15 in chips) 
awQwF96aCUBjOczgehY95A: posts small blind $0.10
ErIN0JRL5srYjT6en1f8YQ: posts big blind $0.25
4kWQxGbT5FZ1dkPd1bE45Q: sits out 
*** HOLE CARDS ***
v+QfkGiuj9bgtuNoVnDO8w: folds 
FOcO5GvOP3rgvLGPLVkg5g: folds 
LxehwDpTQ19ph4Qmc78+Pw: folds 
awQwF96aCUBjOczgehY95A: calls $0.15
ErIN0JRL5srYjT6en1f8YQ: checks 
*** FLOP *** [2h 4c Td]
awQwF96aCUBjOczgehY95A: checks 
ErIN0JRL5srYjT6en1f8YQ: checks 
*** TURN *** [2h 4c Td] [5c]
awQwF96aCUBjOczgehY95A: checks 
ErIN0JRL5srYjT6en1f8YQ: checks 
*** RIVER *** [2h 4c Td 5c] [3h]
awQwF96aCUBjOczgehY95A: checks 
ErIN0JRL5srYjT6en1f8YQ: checks 
*** SHOW DOWN ***
awQwF96aCUBjOczgehY95A: shows [7h 9s] (high card Ten)
ErIN0JRL5srYjT6en1f8YQ: shows [2d Kh] (a pair of Deuces)
ErIN0JRL5srYjT6en1f8YQ collected $0.50 from pot
*** SUMMARY ***
Total pot $0.50 | Rake $0 
Board [2h 4c Td 5c 3h]
Seat 1: FOcO5GvOP3rgvLGPLVkg5g folded before Flop (didn't bet)
Seat 2: LxehwDpTQ19ph4Qmc78+Pw (button) folded before Flop (didn't bet)
Seat 3: awQwF96aCUBjOczgehY95A (small blind) showed [7h 9s] and lost with high card Ten
Seat 4: ErIN0JRL5srYjT6en1f8YQ (big blind) showed [2d Kh] and won ($0.50) with a pair of Deuces
Seat 6: v+QfkGiuj9bgtuNoVnDO8w folded before Flop (didn't bet)




PokerStars Game #59939734108:  Hold'em No Limit ($0.10/$0.25) - 2009/07/01 0:47:33 ET
Table 'ER5H84HUgJx7HyDLnELLeA' 6-max Seat #1 is the button
Seat 1: pjM/xh4+RG8zrxCobDgYDg ($16.70 in chips) 
Seat 2: nc79pm0LZRdhncq55evVqA ($48.60 in chips) 
Seat 4: tkRWn3WaJIfGmCXT2hPvJA ($18.40 in chips) 
Seat 5: mfrkWA3PTeYPkbO6hi98Aw ($25.25 in chips) 
Seat 6: 3zD3qLXT1bEffAoWGnc7wg ($30.85 in chips) 
nc79pm0LZRdhncq55evVqA: posts small blind $0.10
BYxjLnV1/LL0aZcTbfAOvw: is sitting out 
tkRWn3WaJIfGmCXT2hPvJA: posts big blind $0.25
*** HOLE CARDS ***
mfrkWA3PTeYPkbO6hi98Aw: raises $0.75 to $1
BYxjLnV1/LL0aZcTbfAOvw leaves the table
WrLI51S2iMb8GLMB83gGqA joins the table at seat #3 
3zD3qLXT1bEffAoWGnc7wg has timed out
3zD3qLXT1bEffAoWGnc7wg: folds 
3zD3qLXT1bEffAoWGnc7wg is sitting out
pjM/xh4+RG8zrxCobDgYDg: folds 
nc79pm0LZRdhncq55evVqA: folds 
3zD3qLXT1bEffAoWGnc7wg has returned
tkRWn3WaJIfGmCXT2hPvJA: folds 
Uncalled bet ($0.75) returned to mfrkWA3PTeYPkbO6hi98Aw
mfrkWA3PTeYPkbO6hi98Aw collected $0.60 from pot
mfrkWA3PTeYPkbO6hi98Aw: doesn't show hand 
*** SUMMARY ***
Total pot $0.60 | Rake $0 
Seat 1: pjM/xh4+RG8zrxCobDgYDg (button) folded before Flop (didn't bet)
Seat 2: nc79pm0LZRdhncq55evVqA (small blind) folded before Flop
Seat 4: tkRWn3WaJIfGmCXT2hPvJA (big blind) folded before Flop
Seat 5: mfrkWA3PTeYPkbO6hi98Aw collected ($0.60)
Seat 6: 3zD3qLXT1bEffAoWGnc7wg folded before Flop (didn't bet)




PokerStars Game #59939734864:  Hold'em No Limit ($0.10/$0.25) - 2009/07/01 0:47:34 ET
Table 'VuY5ej47Cy8nOI3Wogmhzw' 6-max Seat #3 is the button
Seat 1: aXzmR7FhrqQSWNNmNfbVnw ($18.10 in chips) 
Seat 3: s1D1gIXwINNo65XoAlN55g ($13.75 in chips) 
Seat 6: +v0nBUereMsRzYp2Knh/cQ ($21.05 in chips) 
Zb8xGmbjS8ghABxs9n6huA will be allowed to play after the button
eSKnWz2RD4rvwnvB+rFzIg will be allowed to play after the button
+v0nBUereMsRzYp2Knh/cQ: posts small blind $0.10
aXzmR7FhrqQSWNNmNfbVnw: posts big blind $0.25
*** HOLE CARDS ***
s1D1gIXwINNo65XoAlN55g: raises $0.50 to $0.75
+v0nBUereMsRzYp2Knh/cQ: calls $0.65
j0aDOn9Nft1HLTQvGu1UwA has returned
aXzmR7FhrqQSWNNmNfbVnw: folds 
*** FLOP *** [As 3h 5c]
+v0nBUereMsRzYp2Knh/cQ: checks 
s1D1gIXwINNo65XoAlN55g: bets $1
+v0nBUereMsRzYp2Knh/cQ: calls $1
*** TURN *** [As 3h 5c] [6s]
+v0nBUereMsRzYp2Knh/cQ: checks 
s1D1gIXwINNo65XoAlN55g: bets $1
+v0nBUereMsRzYp2Knh/cQ: calls $1
*** RIVER *** [As 3h 5c 6s] [Ks]
+v0nBUereMsRzYp2Knh/cQ: checks 
s1D1gIXwINNo65XoAlN55g: bets $1.25
+v0nBUereMsRzYp2Knh/cQ: calls $1.25
*** SHOW DOWN ***
s1D1gIXwINNo65XoAlN55g: shows [Ad Jh] (a pair of Aces)
+v0nBUereMsRzYp2Knh/cQ: mucks hand 
s1D1gIXwINNo65XoAlN55g collected $7.85 from pot
*** SUMMARY ***
Total pot $8.25 | Rake $0.40 
Board [As 3h 5c 6s Ks]
Seat 1: aXzmR7FhrqQSWNNmNfbVnw (big blind) folded before Flop
Seat 3: s1D1gIXwINNo65XoAlN55g (button) showed [Ad Jh] and won ($7.85) with a pair of Aces
Seat 6: +v0nBUereMsRzYp2Knh/cQ (small blind) mucked




PokerStars Game #59939734866:  Hold'em No Limit ($0.10/$0.25) - 2009/07/01 0:47:34 ET
Table '2AUmC2Rslg+QUbLfdgNdfg' 6-max Seat #4 is the button
Seat 1: lquriepNQBhDV5P1SWHhnA ($25 in chips) 
Seat 2: CCxAG7iPVlAv3brCqrGBEg ($13.40 in chips) 
Seat 3: iauW7L/+7qzAuHow7CD75Q ($8.75 in chips) 
Seat 4: B6R6e73iyJNddUtXtvYr3Q ($47.60 in chips) 
Seat 5: 8ClCHtFXGNplITm+63KB+Q ($25.90 in chips) 
Seat 6: BvTq4Tu0zBOsniW3eFCnkQ ($33.30 in chips) 
8ClCHtFXGNplITm+63KB+Q: posts small blind $0.10
BvTq4Tu0zBOsniW3eFCnkQ: posts big blind $0.25
*** HOLE CARDS ***
lquriepNQBhDV5P1SWHhnA: folds 
CCxAG7iPVlAv3brCqrGBEg: folds 
iauW7L/+7qzAuHow7CD75Q: calls $0.25
B6R6e73iyJNddUtXtvYr3Q: folds 
8ClCHtFXGNplITm+63KB+Q: folds 
BvTq4Tu0zBOsniW3eFCnkQ: checks 
*** FLOP *** [8s 7c 6c]
BvTq4Tu0zBOsniW3eFCnkQ: checks 
iauW7L/+7qzAuHow7CD75Q: checks 
*** TURN *** [8s 7c 6c] [6d]
BvTq4Tu0zBOsniW3eFCnkQ: checks 
iauW7L/+7qzAuHow7CD75Q: checks 
*** RIVER *** [8s 7c 6c 6d] [Ah]
BvTq4Tu0zBOsniW3eFCnkQ: checks 
iauW7L/+7qzAuHow7CD75Q: checks 
*** SHOW DOWN ***
BvTq4Tu0zBOsniW3eFCnkQ: shows [Qs 4c] (a pair of Sixes)
iauW7L/+7qzAuHow7CD75Q: shows [Kh Ts] (a pair of Sixes - Ace+King kicker)
iauW7L/+7qzAuHow7CD75Q collected $0.60 from pot
*** SUMMARY ***
Total pot $0.60 | Rake $0 
Board [8s 7c 6c 6d Ah]
Seat 1: lquriepNQBhDV5P1SWHhnA folded before Flop (didn't bet)
Seat 2: CCxAG7iPVlAv3brCqrGBEg folded before Flop (didn't bet)
Seat 3: iauW7L/+7qzAuHow7CD75Q showed [Kh Ts] and won ($0.60) with a pair of Sixes
Seat 4: B6R6e73iyJNddUtXtvYr3Q (button) folded before Flop (didn't bet)
Seat 5: 8ClCHtFXGNplITm+63KB+Q (small blind) folded before Flop
Seat 6: BvTq4Tu0zBOsniW3eFCnkQ (big blind) showed [Qs 4c] and lost with a pair of Sixes




PokerStars Game #59939734854:  Hold'em No Limit ($0.10/$0.25) - 2009/07/01 0:47:34 ET
Table 'IUwZ/e0bDHZPgsIWx0RnNg' 6-max Seat #1 is the button
Seat 1: 8JTm/CXBn3+kuQgcUOgPkw ($24.40 in chips) 
Seat 2: mvFHK3pE7tCxJEqLjKC70Q ($30.10 in chips) 
Seat 3: dOX4wnYV2sEqvDbF+8KSCw ($26.05 in chips) 
Seat 4: IyZ9SVxKy7TJvRGFneWTMg ($29.65 in chips) 
Seat 5: wsP46AGpqDjHZQmlRHKa9g ($25.15 in chips) 
Seat 6: NhUN/JpAprdJeamFBgJH1w ($25.35 in chips) 
mvFHK3pE7tCxJEqLjKC70Q: posts small blind $0.10
dOX4wnYV2sEqvDbF+8KSCw: posts big blind $0.25
*** HOLE CARDS ***
IyZ9SVxKy7TJvRGFneWTMg: folds 
wsP46AGpqDjHZQmlRHKa9g: folds 
NhUN/JpAprdJeamFBgJH1w: folds 
8JTm/CXBn3+kuQgcUOgPkw: folds 
mvFHK3pE7tCxJEqLjKC70Q: folds 
Uncalled bet ($0.15) returned to dOX4wnYV2sEqvDbF+8KSCw
dOX4wnYV2sEqvDbF+8KSCw collected $0.20 from pot
dOX4wnYV2sEqvDbF+8KSCw: doesn't show hand 
*** SUMMARY ***
Total pot $0.20 | Rake $0 
Seat 1: 8JTm/CXBn3+kuQgcUOgPkw (button) folded before Flop (didn't bet)
Seat 2: mvFHK3pE7tCxJEqLjKC70Q (small blind) folded before Flop
Seat 3: dOX4wnYV2sEqvDbF+8KSCw (big blind) collected ($0.20)
Seat 4: IyZ9SVxKy7TJvRGFneWTMg folded before Flop (didn't bet)
Seat 5: wsP46AGpqDjHZQmlRHKa9g folded before Flop (didn't bet)
Seat 6: NhUN/JpAprdJeamFBgJH1w folded before Flop (didn't bet)




PokerStars Game #59939735168:  Hold'em No Limit ($0.10/$0.25) - 2009/07/01 0:47:34 ET
Table 'oZuNsbNJuUyQLGKzQ/4JFg' 6-max Seat #4 is the button
Seat 1: /hq3j+3FbArzS8nEzmqRuw ($8.20 in chips) 
Seat 2: UA5OsKS3VPaxa7uC8La/kA ($31 in chips) 
Seat 3: 8ClCHtFXGNplITm+63KB+Q ($37.85 in chips) 
Seat 4: pWN7DVB+VCCiq83kllzEtg ($15.50 in chips) 
Seat 5: IH5lT4+CuQFyy32Qf5ydDw ($14.75 in chips) 
Seat 6: 34ttqW62uIRrqINCCmLcsw ($21.15 in chips) 
IH5lT4+CuQFyy32Qf5ydDw: posts small blind $0.10
34ttqW62uIRrqINCCmLcsw: posts big blind $0.25
*** HOLE CARDS ***
/hq3j+3FbArzS8nEzmqRuw: calls $0.25
UA5OsKS3VPaxa7uC8La/kA: folds 
8ClCHtFXGNplITm+63KB+Q: calls $0.25
pWN7DVB+VCCiq83kllzEtg: calls $0.25
IH5lT4+CuQFyy32Qf5ydDw: calls $0.15
34ttqW62uIRrqINCCmLcsw: checks 
*** FLOP *** [9c Ks 7s]
IH5lT4+CuQFyy32Qf5ydDw: checks 
34ttqW62uIRrqINCCmLcsw: checks 
/hq3j+3FbArzS8nEzmqRuw: checks 
8ClCHtFXGNplITm+63KB+Q: checks 
pWN7DVB+VCCiq83kllzEtg: bets $0.75
IH5lT4+CuQFyy32Qf5ydDw: folds 
34ttqW62uIRrqINCCmLcsw: folds 
/hq3j+3FbArzS8nEzmqRuw: folds 
8ClCHtFXGNplITm+63KB+Q: folds 
Uncalled bet ($0.75) returned to pWN7DVB+VCCiq83kllzEtg
pWN7DVB+VCCiq83kllzEtg collected $1.20 from pot
pWN7DVB+VCCiq83kllzEtg: doesn't show hand 
*** SUMMARY ***
Total pot $1.25 | Rake $0.05 
Board [9c Ks 7s]
Seat 1: /hq3j+3FbArzS8nEzmqRuw folded on the Flop
Seat 2: UA5OsKS3VPaxa7uC8La/kA folded before Flop (didn't bet)
Seat 3: 8ClCHtFXGNplITm+63KB+Q folded on the Flop
Seat 4: pWN7DVB+VCCiq83kllzEtg (button) collected ($1.20)
Seat 5: IH5lT4+CuQFyy32Qf5ydDw (small blind) folded on the Flop
Seat 6: 34ttqW62uIRrqINCCmLcsw (big blind) folded on the Flop




PokerStars Game #59939735334:  Hold'em No Limit ($0.10/$0.25) - 2009/07/01 0:47:34 ET
Table '4XGDnEByOol5up4aB2KbJw' 6-max Seat #2 is the button
Seat 1: kyRaCIljYA6l33lSKQfNsg ($26.50 in chips) 
Seat 2: SFmT9ZsVopnukjvAzrxTRg ($34.35 in chips) 
Seat 3: LtASJ9OlkqGrrUKGQlpGAw ($22.65 in chips) 
Seat 4: sjoibHX/s93+8Kwa5aB1dA ($27.85 in chips) 
Seat 5: Dh01+rohD2p9pXLYeBlC5Q ($17.30 in chips) 
Seat 6: ELW+DKizJhLK7k40PMkD2Q ($33.10 in chips) 
LtASJ9OlkqGrrUKGQlpGAw: posts small blind $0.10
sjoibHX/s93+8Kwa5aB1dA: posts big blind $0.25
*** HOLE CARDS ***
Dh01+rohD2p9pXLYeBlC5Q: folds 
ELW+DKizJhLK7k40PMkD2Q: folds 
kyRaCIljYA6l33lSKQfNsg: folds 
SFmT9ZsVopnukjvAzrxTRg: folds 
LtASJ9OlkqGrrUKGQlpGAw: folds 
Uncalled bet ($0.15) returned to sjoibHX/s93+8Kwa5aB1dA
sjoibHX/s93+8Kwa5aB1dA collected $0.20 from pot
*** SUMMARY ***
Total pot $0.20 | Rake $0 
Seat 1: kyRaCIljYA6l33lSKQfNsg folded before Flop (didn't bet)
Seat 2: SFmT9ZsVopnukjvAzrxTRg (button) folded before Flop (didn't bet)
Seat 3: LtASJ9OlkqGrrUKGQlpGAw (small blind) folded before Flop
Seat 4: sjoibHX/s93+8Kwa5aB1dA (big blind) collected ($0.20)
Seat 5: Dh01+rohD2p9pXLYeBlC5Q folded before Flop (didn't bet)
Seat 6: ELW+DKizJhLK7k40PMkD2Q folded before Flop (didn't bet)




PokerStars Game #59939734798:  Hold'em No Limit ($0.10/$0.25) - 2009/07/01 0:47:34 ET
Table 'BpNkESDX1ip9c0K1hb5h7A' 6-max Seat #4 is the button
Seat 1: 9jSiy0meE9XJKkdIZwyTEQ ($28.90 in chips) 
Seat 2: gqW2aBCmrIw65BvwjTFN6Q ($26.50 in chips) 
Seat 3: cHhVLDikFlByGGN+CM3w/A ($27.95 in chips) 
Seat 4: x9VGscBU5oUWy8rQ+Ik80w ($25 in chips) 
Seat 5: QvTX2yGq3uKJiKPmns4TKQ ($75.70 in chips) 
Seat 6: iUgsn+WyKFjjVd+tj13R2w ($11.75 in chips) 
QvTX2yGq3uKJiKPmns4TKQ: posts small blind $0.10
iUgsn+WyKFjjVd+tj13R2w: posts big blind $0.25
*** HOLE CARDS ***
9jSiy0meE9XJKkdIZwyTEQ: folds 
gqW2aBCmrIw65BvwjTFN6Q: folds 
cHhVLDikFlByGGN+CM3w/A: folds 
x9VGscBU5oUWy8rQ+Ik80w: folds 
QvTX2yGq3uKJiKPmns4TKQ: folds 
Uncalled bet ($0.15) returned to iUgsn+WyKFjjVd+tj13R2w
iUgsn+WyKFjjVd+tj13R2w collected $0.20 from pot
*** SUMMARY ***
Total pot $0.20 | Rake $0 
Seat 1: 9jSiy0meE9XJKkdIZwyTEQ folded before Flop (didn't bet)
Seat 2: gqW2aBCmrIw65BvwjTFN6Q folded before Flop (didn't bet)
Seat 3: cHhVLDikFlByGGN+CM3w/A folded before Flop (didn't bet)
Seat 4: x9VGscBU5oUWy8rQ+Ik80w (button) folded before Flop (didn't bet)
Seat 5: QvTX2yGq3uKJiKPmns4TKQ (small blind) folded before Flop
Seat 6: iUgsn+WyKFjjVd+tj13R2w (big blind) collected ($0.20)




PokerStars Game #59939735398:  Hold'em No Limit ($0.10/$0.25) - 2009/07/01 0:47:34 ET
Table 'K/f0NNaoGuhSz5DrzgVw7Q' 9-max Seat #4 is the button
Seat 1: sD+TKtt36XiiN6jqHiLwDA ($24.40 in chips) 
Seat 2: 18G4P1XstjNvItdGUITxgw ($25 in chips) 
Seat 3: VBHxUExRAMrbxUq/cVx9Gw ($5 in chips) 
Seat 4: 3L1qKVpA6QZjrddTpoh2zQ ($13.30 in chips) 
Seat 5: DnDcAdn9P0zGovMERigpFA ($30.50 in chips) 
Seat 6: 3PVK0IdMlq2fElkVzzr4bg ($17.60 in chips) 
Seat 7: st9jtdNbm1W5GfBwRaCVqQ ($28.25 in chips) 
Seat 8: E0iYnEVO2ho7dH3QcCjw7g ($19.65 in chips) 
Seat 9: B5Xu8WsfFPfBlsK3fbAtQQ ($7.70 in chips) 
DnDcAdn9P0zGovMERigpFA: posts small blind $0.10
3PVK0IdMlq2fElkVzzr4bg: posts big blind $0.25
*** HOLE CARDS ***
st9jtdNbm1W5GfBwRaCVqQ: folds 
E0iYnEVO2ho7dH3QcCjw7g: folds 
B5Xu8WsfFPfBlsK3fbAtQQ: calls $0.25
sD+TKtt36XiiN6jqHiLwDA: folds 
18G4P1XstjNvItdGUITxgw: folds 
VBHxUExRAMrbxUq/cVx9Gw: folds 
3L1qKVpA6QZjrddTpoh2zQ: folds 
DnDcAdn9P0zGovMERigpFA: folds 
3PVK0IdMlq2fElkVzzr4bg: checks 
*** FLOP *** [6c Ah Qs]
3PVK0IdMlq2fElkVzzr4bg: checks 
B5Xu8WsfFPfBlsK3fbAtQQ: bets $0.25
3PVK0IdMlq2fElkVzzr4bg: folds 
Uncalled bet ($0.25) returned to B5Xu8WsfFPfBlsK3fbAtQQ
B5Xu8WsfFPfBlsK3fbAtQQ collected $0.60 from pot
B5Xu8WsfFPfBlsK3fbAtQQ: doesn't show hand 
*** SUMMARY ***
Total pot $0.60 | Rake $0 
Board [6c Ah Qs]
Seat 1: sD+TKtt36XiiN6jqHiLwDA folded before Flop (didn't bet)
Seat 2: 18G4P1XstjNvItdGUITxgw folded before Flop (didn't bet)
Seat 3: VBHxUExRAMrbxUq/cVx9Gw folded before Flop (didn't bet)
Seat 4: 3L1qKVpA6QZjrddTpoh2zQ (button) folded before Flop (didn't bet)
Seat 5: DnDcAdn9P0zGovMERigpFA (small blind) folded before Flop
Seat 6: 3PVK0IdMlq2fElkVzzr4bg (big blind) folded on the Flop
Seat 7: st9jtdNbm1W5GfBwRaCVqQ folded before Flop (didn't bet)
Seat 8: E0iYnEVO2ho7dH3QcCjw7g folded before Flop (didn't bet)
Seat 9: B5Xu8WsfFPfBlsK3fbAtQQ collected ($0.60)




PokerStars Game #59939734936:  Hold'em No Limit ($0.10/$0.25) - 2009/07/01 0:47:34 ET
Table 'sSe6q4YTb/iS19t2eCFdsA' 9-max Seat #6 is the button
Seat 1: 5z3YkZTfH2GjoLK+6X7z2w ($11.55 in chips) 
Seat 2: rUpvA02nErFvZ4yFbDR8XA ($25.60 in chips) 
Seat 3: hBMUlEpyU74r/fwDgIpXjQ ($25 in chips) 
Seat 5: qS+jfnNoG75bT+uQ8CKhQA ($13.50 in chips) 
Seat 6: tYsOBqdU1+x+yFI7zHO7hQ ($25.70 in chips) 
Seat 7: t70KGeRtR3naHSqKDixsUg ($12.05 in chips) 
Seat 8: jeKWRUkMaVn8rEUjnJKqpg ($30.30 in chips) 
Seat 9: 4oA316mXLIui1QY63GXBUg ($25.25 in chips) 
t70KGeRtR3naHSqKDixsUg: posts small blind $0.10
jeKWRUkMaVn8rEUjnJKqpg: posts big blind $0.25
22dIObOuor/A+IKWkNoAlA: sits out 
*** HOLE CARDS ***
4oA316mXLIui1QY63GXBUg: folds 
5z3YkZTfH2GjoLK+6X7z2w: calls $0.25
rUpvA02nErFvZ4yFbDR8XA: folds 
hBMUlEpyU74r/fwDgIpXjQ: raises $0.75 to $1
qS+jfnNoG75bT+uQ8CKhQA: folds 
tYsOBqdU1+x+yFI7zHO7hQ: folds 
t70KGeRtR3naHSqKDixsUg: folds 
jeKWRUkMaVn8rEUjnJKqpg: folds 
5z3YkZTfH2GjoLK+6X7z2w: calls $0.75
*** FLOP *** [9c Kh Td]
5z3YkZTfH2GjoLK+6X7z2w: checks 
hBMUlEpyU74r/fwDgIpXjQ: checks 
*** TURN *** [9c Kh Td] [Jc]
5z3YkZTfH2GjoLK+6X7z2w: bets $0.75
hBMUlEpyU74r/fwDgIpXjQ: folds 
Uncalled bet ($0.75) returned to 5z3YkZTfH2GjoLK+6X7z2w
5z3YkZTfH2GjoLK+6X7z2w collected $2.25 from pot
5z3YkZTfH2GjoLK+6X7z2w: doesn't show hand 
*** SUMMARY ***
Total pot $2.35 | Rake $0.10 
Board [9c Kh Td Jc]
Seat 1: 5z3YkZTfH2GjoLK+6X7z2w collected ($2.25)
Seat 2: rUpvA02nErFvZ4yFbDR8XA folded before Flop (didn't bet)
Seat 3: hBMUlEpyU74r/fwDgIpXjQ folded on the Turn
Seat 5: qS+jfnNoG75bT+uQ8CKhQA folded before Flop (didn't bet)
Seat 6: tYsOBqdU1+x+yFI7zHO7hQ (button) folded before Flop (didn't bet)
Seat 7: t70KGeRtR3naHSqKDixsUg (small blind) folded before Flop
Seat 8: jeKWRUkMaVn8rEUjnJKqpg (big blind) folded before Flop
Seat 9: 4oA316mXLIui1QY63GXBUg folded before Flop (didn't bet)




PokerStars Game #59939735736:  Hold'em No Limit ($0.10/$0.25) - 2009/07/01 0:47:35 ET
Table '8TQqiBvztdoBMTFQQ4MYSA' 9-max Seat #2 is the button
Seat 1: LWN1wPrLH+695JIriXxDuw ($23.05 in chips) 
Seat 2: amD2PwT1xB7aC2k57sa7Ig ($22.90 in chips) 
Seat 3: DIBbjEYGs+TVdVgEB/4+3w ($24.90 in chips) 
Seat 4: EUMLvzDkECHBit+xa+uGjg ($22.35 in chips) 
Seat 5: vZGoOTJLQLhkPj4I+LNGig ($25 in chips) 
Seat 6: MIVCHqCqqlke0Lb0z7glcw ($37.60 in chips) 
Seat 7: STkR8XvpjNv79OOMhrlh2w ($25 in chips) 
Seat 9: SXqVW4Q0evTUVZG6BbUNIA ($42.30 in chips) 
DIBbjEYGs+TVdVgEB/4+3w: posts small blind $0.10
EUMLvzDkECHBit+xa+uGjg: posts big blind $0.25
V6p0jQ/RhUsqpHLmXvEX4Q: sits out 
*** HOLE CARDS ***
vZGoOTJLQLhkPj4I+LNGig: folds 
MIVCHqCqqlke0Lb0z7glcw: folds 
STkR8XvpjNv79OOMhrlh2w: folds 
SXqVW4Q0evTUVZG6BbUNIA: folds 
LWN1wPrLH+695JIriXxDuw: folds 
amD2PwT1xB7aC2k57sa7Ig: calls $0.25
DIBbjEYGs+TVdVgEB/4+3w: calls $0.15
EUMLvzDkECHBit+xa+uGjg: checks 
*** FLOP *** [2c 5s Jc]
DIBbjEYGs+TVdVgEB/4+3w: checks 
EUMLvzDkECHBit+xa+uGjg: bets $0.75
amD2PwT1xB7aC2k57sa7Ig: folds 
DIBbjEYGs+TVdVgEB/4+3w: folds 
Uncalled bet ($0.75) returned to EUMLvzDkECHBit+xa+uGjg
EUMLvzDkECHBit+xa+uGjg collected $0.75 from pot
*** SUMMARY ***
Total pot $0.75 | Rake $0 
Board [2c 5s Jc]
Seat 1: LWN1wPrLH+695JIriXxDuw folded before Flop (didn't bet)
Seat 2: amD2PwT1xB7aC2k57sa7Ig (button) folded on the Flop
Seat 3: DIBbjEYGs+TVdVgEB/4+3w (small blind) folded on the Flop
Seat 4: EUMLvzDkECHBit+xa+uGjg (big blind) collected ($0.75)
Seat 5: vZGoOTJLQLhkPj4I+LNGig folded before Flop (didn't bet)
Seat 6: MIVCHqCqqlke0Lb0z7glcw folded before Flop (didn't bet)
Seat 7: STkR8XvpjNv79OOMhrlh2w folded before Flop (didn't bet)
Seat 9: SXqVW4Q0evTUVZG6BbUNIA folded before Flop (didn't bet)




PokerStars Game #59939735550:  Hold'em No Limit ($0.10/$0.25) - 2009/07/01 0:47:35 ET
Table 'M8kYidAX3ib7pLKW7edFLw' 6-max Seat #3 is the button
Seat 1: jp34e617tIzV8tKIWmfAbA ($25.25 in chips) 
Seat 2: 4kWQxGbT5FZ1dkPd1bE45Q ($38.60 in chips) 
Seat 3: q+Sip/IIcvzqgZt1pJAWTw ($9 in chips) 
Seat 4: /bjna2FTN7pPjqYGzmDE0Q ($25.45 in chips) 
Seat 5: bDKopKTvPi3W+PEnYUX3tg ($47.70 in chips) 
Seat 6: NqFoyDgzLwu4dOmSRXnFBA ($10 in chips) 
/bjna2FTN7pPjqYGzmDE0Q: posts small blind $0.10
bDKopKTvPi3W+PEnYUX3tg: posts big blind $0.25
*** HOLE CARDS ***
NqFoyDgzLwu4dOmSRXnFBA said, "kk don't work"
bDKopKTvPi3W+PEnYUX3tg said, "thats funny"
NqFoyDgzLwu4dOmSRXnFBA: raises $0.75 to $1
jp34e617tIzV8tKIWmfAbA: folds 
4kWQxGbT5FZ1dkPd1bE45Q: folds 
q+Sip/IIcvzqgZt1pJAWTw: folds 
/bjna2FTN7pPjqYGzmDE0Q: folds 
bDKopKTvPi3W+PEnYUX3tg: folds 
Uncalled bet ($0.75) returned to NqFoyDgzLwu4dOmSRXnFBA
NqFoyDgzLwu4dOmSRXnFBA collected $0.60 from pot
NqFoyDgzLwu4dOmSRXnFBA: shows [9c 9h] (a pair of Nines)
*** SUMMARY ***
Total pot $0.60 | Rake $0 
Seat 1: jp34e617tIzV8tKIWmfAbA folded before Flop (didn't bet)
Seat 2: 4kWQxGbT5FZ1dkPd1bE45Q folded before Flop (didn't bet)
Seat 3: q+Sip/IIcvzqgZt1pJAWTw (button) folded before Flop (didn't bet)
Seat 4: /bjna2FTN7pPjqYGzmDE0Q (small blind) folded before Flop
Seat 5: bDKopKTvPi3W+PEnYUX3tg (big blind) folded before Flop
Seat 6: NqFoyDgzLwu4dOmSRXnFBA collected ($0.60)




PokerStars Game #59939735896:  Hold'em No Limit ($0.10/$0.25) - 2009/07/01 0:47:35 ET
Table 'LLHSnYPAXNI1sFlwPBn1tA' 6-max Seat #6 is the button
Seat 1: tVZW8k4GP+PvZ1DjD/9StA ($22.45 in chips) 
Seat 2: oseFhpinoe+Zg4j5xyBjyQ ($22.45 in chips) 
Seat 3: JFIAqU8lCZ0vWwEl4bdGsg ($25 in chips) 
Seat 4: FPlQHZog0ePFCETQ2KG4hQ ($26.85 in chips) 
Seat 5: jXbd3O6QdeNWctmpAsTgHA ($14.45 in chips) 
Seat 6: PCh4iIHq9rXvWY/FeXc/Jg ($31.80 in chips) 
tVZW8k4GP+PvZ1DjD/9StA: posts small blind $0.10
oseFhpinoe+Zg4j5xyBjyQ: posts big blind $0.25
*** HOLE CARDS ***
JFIAqU8lCZ0vWwEl4bdGsg: folds 
FPlQHZog0ePFCETQ2KG4hQ: folds 
jXbd3O6QdeNWctmpAsTgHA: folds 
PCh4iIHq9rXvWY/FeXc/Jg: folds 
tVZW8k4GP+PvZ1DjD/9StA: folds 
Uncalled bet ($0.15) returned to oseFhpinoe+Zg4j5xyBjyQ
oseFhpinoe+Zg4j5xyBjyQ collected $0.20 from pot
oseFhpinoe+Zg4j5xyBjyQ: doesn't show hand 
*** SUMMARY ***
Total pot $0.20 | Rake $0 
Seat 1: tVZW8k4GP+PvZ1DjD/9StA (small blind) folded before Flop
Seat 2: oseFhpinoe+Zg4j5xyBjyQ (big blind) collected ($0.20)
Seat 3: JFIAqU8lCZ0vWwEl4bdGsg folded before Flop (didn't bet)
Seat 4: FPlQHZog0ePFCETQ2KG4hQ folded before Flop (didn't bet)
Seat 5: jXbd3O6QdeNWctmpAsTgHA folded before Flop (didn't bet)
Seat 6: PCh4iIHq9rXvWY/FeXc/Jg (button) folded before Flop (didn't bet)




PokerStars Game #59939735898:  Hold'em No Limit ($0.10/$0.25) - 2009/07/01 0:47:35 ET
Table 'VQNfcI8vTBCTvRfd3veTLQ' 6-max Seat #3 is the button
Seat 1: ymz+a8dgHSUFPooYplw7Ow ($24.90 in chips) 
Seat 2: KukIGupqqJCXA+Hp2bEFnA ($6.75 in chips) 
Seat 3: LtASJ9OlkqGrrUKGQlpGAw ($22.70 in chips) 
Seat 4: nc79pm0LZRdhncq55evVqA ($25 in chips) 
Seat 5: gX2vbKwS/8zZPENAWB7hxQ ($11.40 in chips) 
Seat 6: dlCLwmcvRShnuFDEVkdIEA ($12.25 in chips) 
nc79pm0LZRdhncq55evVqA: posts small blind $0.10
gX2vbKwS/8zZPENAWB7hxQ: posts big blind $0.25
*** HOLE CARDS ***
dlCLwmcvRShnuFDEVkdIEA: calls $0.25
ymz+a8dgHSUFPooYplw7Ow: folds 
KukIGupqqJCXA+Hp2bEFnA: calls $0.25
LtASJ9OlkqGrrUKGQlpGAw: folds 
nc79pm0LZRdhncq55evVqA: folds 
gX2vbKwS/8zZPENAWB7hxQ: checks 
*** FLOP *** [Ts 7d 8s]
gX2vbKwS/8zZPENAWB7hxQ: checks 
dlCLwmcvRShnuFDEVkdIEA: bets $0.25
KukIGupqqJCXA+Hp2bEFnA: calls $0.25
gX2vbKwS/8zZPENAWB7hxQ: folds 
*** TURN *** [Ts 7d 8s] [2h]
dlCLwmcvRShnuFDEVkdIEA: checks 
KukIGupqqJCXA+Hp2bEFnA: checks 
*** RIVER *** [Ts 7d 8s 2h] [Qs]
dlCLwmcvRShnuFDEVkdIEA: checks 
KukIGupqqJCXA+Hp2bEFnA: bets $1
dlCLwmcvRShnuFDEVkdIEA: folds 
Uncalled bet ($1) returned to KukIGupqqJCXA+Hp2bEFnA
KukIGupqqJCXA+Hp2bEFnA collected $1.30 from pot
*** SUMMARY ***
Total pot $1.35 | Rake $0.05 
Board [Ts 7d 8s 2h Qs]
Seat 1: ymz+a8dgHSUFPooYplw7Ow folded before Flop (didn't bet)
Seat 2: KukIGupqqJCXA+Hp2bEFnA collected ($1.30)
Seat 3: LtASJ9OlkqGrrUKGQlpGAw (button) folded before Flop (didn't bet)
Seat 4: nc79pm0LZRdhncq55evVqA (small blind) folded before Flop
Seat 5: gX2vbKwS/8zZPENAWB7hxQ (big blind) folded on the Flop
Seat 6: dlCLwmcvRShnuFDEVkdIEA folded on the River




PokerStars Game #59939735678:  Hold'em No Limit ($0.10/$0.25) - 2009/07/01 0:47:35 ET
Table 'a0kk1yz54EMczhut3KjrxQ' 6-max Seat #6 is the button
Seat 1: V3LJvbHVJHmOj2fd7zIDhA ($30.20 in chips) 
Seat 2: nc79pm0LZRdhncq55evVqA ($25 in chips) 
Seat 3: FabaCGPqGJLjRL48CMvjiQ ($19.20 in chips) 
Seat 4: FYepjhAvF8ZdVCmqHIy+eQ ($28.20 in chips) 
Seat 5: cPO/1/dTcZpLkQFm3jH3Rg ($27.40 in chips) 
Seat 6: DTzxFTXVrCqrpjq9B9Vg/g ($15.90 in chips) 
V3LJvbHVJHmOj2fd7zIDhA: posts small blind $0.10
nc79pm0LZRdhncq55evVqA: posts big blind $0.25
*** HOLE CARDS ***
FabaCGPqGJLjRL48CMvjiQ: folds 
FYepjhAvF8ZdVCmqHIy+eQ: folds 
cPO/1/dTcZpLkQFm3jH3Rg: folds 
DTzxFTXVrCqrpjq9B9Vg/g: calls $0.25
V3LJvbHVJHmOj2fd7zIDhA: folds 
nc79pm0LZRdhncq55evVqA: checks 
*** FLOP *** [9d Ts 6h]
nc79pm0LZRdhncq55evVqA: checks 
DTzxFTXVrCqrpjq9B9Vg/g: checks 
*** TURN *** [9d Ts 6h] [4d]
nc79pm0LZRdhncq55evVqA: bets $0.50
DTzxFTXVrCqrpjq9B9Vg/g: calls $0.50
*** RIVER *** [9d Ts 6h 4d] [Jc]
nc79pm0LZRdhncq55evVqA: bets $1
DTzxFTXVrCqrpjq9B9Vg/g: raises $2 to $3
nc79pm0LZRdhncq55evVqA: calls $2
*** SHOW DOWN ***
DTzxFTXVrCqrpjq9B9Vg/g: shows [Qc Js] (a pair of Jacks)
nc79pm0LZRdhncq55evVqA: mucks hand 
DTzxFTXVrCqrpjq9B9Vg/g collected $7.25 from pot
*** SUMMARY ***
Total pot $7.60 | Rake $0.35 
Board [9d Ts 6h 4d Jc]
Seat 1: V3LJvbHVJHmOj2fd7zIDhA (small blind) folded before Flop
Seat 2: nc79pm0LZRdhncq55evVqA (big blind) mucked
Seat 3: FabaCGPqGJLjRL48CMvjiQ folded before Flop (didn't bet)
Seat 4: FYepjhAvF8ZdVCmqHIy+eQ folded before Flop (didn't bet)
Seat 5: cPO/1/dTcZpLkQFm3jH3Rg folded before Flop (didn't bet)
Seat 6: DTzxFTXVrCqrpjq9B9Vg/g (button) showed [Qc Js] and won ($7.25) with a pair of Jacks




PokerStars Game #59939735910:  Hold'em No Limit ($0.10/$0.25) - 2009/07/01 0:47:35 ET
Table 'fRxOyfaHXkWUDLv4eSxFew' 9-max Seat #1 is the button
Seat 1: 6RiVTYll/5D8zICp0MRpKw ($24.65 in chips) 
Seat 3: hBMUlEpyU74r/fwDgIpXjQ ($28.05 in chips) 
Seat 4: +WMpj67YqG8ilNkg2JwXpw ($15.95 in chips) 
Seat 6: N/O9ADKpmqB2ASZuqgodlw ($5.70 in chips) 
Seat 7: 7cv+9Zc9HIQHNvYsMfV3uA ($55.40 in chips) 
Seat 9: H5Se03ZqSX7tbULXur2MAg ($23.80 in chips) 
hBMUlEpyU74r/fwDgIpXjQ: posts small blind $0.10
+WMpj67YqG8ilNkg2JwXpw: posts big blind $0.25
*** HOLE CARDS ***
N/O9ADKpmqB2ASZuqgodlw: calls $0.25
7cv+9Zc9HIQHNvYsMfV3uA: raises $1 to $1.25
Edoas joins the table at seat #2 
H5Se03ZqSX7tbULXur2MAg: folds 
6RiVTYll/5D8zICp0MRpKw: folds 
hBMUlEpyU74r/fwDgIpXjQ: folds 
+WMpj67YqG8ilNkg2JwXpw: folds 
N/O9ADKpmqB2ASZuqgodlw: calls $1
*** FLOP *** [Qs Ad 7h]
N/O9ADKpmqB2ASZuqgodlw: bets $2.25
7cv+9Zc9HIQHNvYsMfV3uA: folds 
Uncalled bet ($2.25) returned to N/O9ADKpmqB2ASZuqgodlw
N/O9ADKpmqB2ASZuqgodlw collected $2.75 from pot
*** SUMMARY ***
Total pot $2.85 | Rake $0.10 
Board [Qs Ad 7h]
Seat 1: 6RiVTYll/5D8zICp0MRpKw (button) folded before Flop (didn't bet)
Seat 3: hBMUlEpyU74r/fwDgIpXjQ (small blind) folded before Flop
Seat 4: +WMpj67YqG8ilNkg2JwXpw (big blind) folded before Flop
Seat 6: N/O9ADKpmqB2ASZuqgodlw collected ($2.75)
Seat 7: 7cv+9Zc9HIQHNvYsMfV3uA folded on the Flop
Seat 9: H5Se03ZqSX7tbULXur2MAg folded before Flop (didn't bet)




PokerStars Game #59939735530:  Hold'em No Limit ($0.10/$0.25) - 2009/07/01 0:47:35 ET
Table 'KEoOIegxPF91KooL2AelUA' 6-max Seat #2 is the button
Seat 1: wsP46AGpqDjHZQmlRHKa9g ($30.75 in chips) 
Seat 2: RYLaAIIwK9wxkPswt1yJYw ($26.50 in chips) 
Seat 3: zxeVQGaMKDsDzmSY+AInjA ($14.75 in chips) 
Seat 4: Vv37Oa9niKKVcR6Z7ceetw ($21 in chips) 
Seat 6: 1YgYdjcEYMhI41phJetI3w ($4.75 in chips) 
zxeVQGaMKDsDzmSY+AInjA: posts small blind $0.10
Vv37Oa9niKKVcR6Z7ceetw: posts big blind $0.25
tburger7: sits out 
*** HOLE CARDS ***
1YgYdjcEYMhI41phJetI3w: calls $0.25
wsP46AGpqDjHZQmlRHKa9g: raises $0.50 to $0.75
RYLaAIIwK9wxkPswt1yJYw: folds 
zxeVQGaMKDsDzmSY+AInjA: folds 
Vv37Oa9niKKVcR6Z7ceetw: folds 
1YgYdjcEYMhI41phJetI3w: calls $0.50
*** FLOP *** [6h 5h 9s]
1YgYdjcEYMhI41phJetI3w: checks 
wsP46AGpqDjHZQmlRHKa9g: bets $1
1YgYdjcEYMhI41phJetI3w: raises $1 to $2
wsP46AGpqDjHZQmlRHKa9g: folds 
Uncalled bet ($1) returned to 1YgYdjcEYMhI41phJetI3w
1YgYdjcEYMhI41phJetI3w collected $3.70 from pot
*** SUMMARY ***
Total pot $3.85 | Rake $0.15 
Board [6h 5h 9s]
Seat 1: wsP46AGpqDjHZQmlRHKa9g folded on the Flop
Seat 2: RYLaAIIwK9wxkPswt1yJYw (button) folded before Flop (didn't bet)
Seat 3: zxeVQGaMKDsDzmSY+AInjA (small blind) folded before Flop
Seat 4: Vv37Oa9niKKVcR6Z7ceetw (big blind) folded before Flop
Seat 6: 1YgYdjcEYMhI41phJetI3w collected ($3.70)




PokerStars Game #59939736434:  Hold'em No Limit ($0.10/$0.25) - 2009/07/01 0:47:36 ET
Table 'MiquQrQZJJq9ZtgRIp9HFQ' 6-max Seat #5 is the button
Seat 1: hM0MSDtq2ow7J40bSR04ig ($3.45 in chips) 
Seat 2: dyEfLXFw5qVHSUcgOdOM2Q ($15.35 in chips) 
Seat 3: BYxjLnV1/LL0aZcTbfAOvw ($26.50 in chips) 
Seat 4: 0HIrwssk0FQvyKULzUTtlg ($20.55 in chips) 
Seat 5: 3zD3qLXT1bEffAoWGnc7wg ($25 in chips) 
JE/wJXmjw3bpdmjwvh2pcg will be allowed to play after the button
hM0MSDtq2ow7J40bSR04ig: posts small blind $0.10
dyEfLXFw5qVHSUcgOdOM2Q: posts big blind $0.25
*** HOLE CARDS ***
BYxjLnV1/LL0aZcTbfAOvw: folds 
0HIrwssk0FQvyKULzUTtlg: folds 
0HIrwssk0FQvyKULzUTtlg leaves the table
JE/wJXmjw3bpdmjwvh2pcg is sitting out
3zD3qLXT1bEffAoWGnc7wg: raises $0.50 to $0.75
JE/wJXmjw3bpdmjwvh2pcg leaves the table
hM0MSDtq2ow7J40bSR04ig: raises $0.50 to $1.25
dyEfLXFw5qVHSUcgOdOM2Q: folds 
3zD3qLXT1bEffAoWGnc7wg: calls $0.50
*** FLOP *** [Ad 2d 5c]
hM0MSDtq2ow7J40bSR04ig: checks 
3zD3qLXT1bEffAoWGnc7wg: checks 
*** TURN *** [Ad 2d 5c] [6c]
hM0MSDtq2ow7J40bSR04ig: bets $1
3zD3qLXT1bEffAoWGnc7wg: calls $1
*** RIVER *** [Ad 2d 5c 6c] [Ac]
hM0MSDtq2ow7J40bSR04ig: bets $1.20 and is all-in
3zD3qLXT1bEffAoWGnc7wg: folds 
Uncalled bet ($1.20) returned to hM0MSDtq2ow7J40bSR04ig
hM0MSDtq2ow7J40bSR04ig collected $4.55 from pot
*** SUMMARY ***
Total pot $4.75 | Rake $0.20 
Board [Ad 2d 5c 6c Ac]
Seat 1: hM0MSDtq2ow7J40bSR04ig (small blind) collected ($4.55)
Seat 2: dyEfLXFw5qVHSUcgOdOM2Q (big blind) folded before Flop
Seat 3: BYxjLnV1/LL0aZcTbfAOvw folded before Flop (didn't bet)
Seat 4: 0HIrwssk0FQvyKULzUTtlg folded before Flop (didn't bet)
Seat 5: 3zD3qLXT1bEffAoWGnc7wg (button) folded on the River




PokerStars Game #59939736430:  Hold'em No Limit ($0.10/$0.25) - 2009/07/01 0:47:36 ET
Table 'hg+KpirwreMnBAFQr/SEUA' 9-max Seat #6 is the button
Seat 1: H5Se03ZqSX7tbULXur2MAg ($24.10 in chips) 
Seat 2: OlPJsgR4xypSg/w1z7Gyvw ($18.05 in chips) 
Seat 3: N6fYvIzQLKaydFLKQGtMlQ ($29.95 in chips) 
Seat 4: 7Tiam59GaMYACH/my1qVuw ($24.75 in chips) 
Seat 5: +2kMBNpY4nF1qNCRd8SJLA ($25 in chips) 
Seat 6: dAohy+E9dUFBp6GlYFiOtQ ($25.15 in chips) 
Seat 7: iGiuurat0/9pnLDHRit8Bw ($9.75 in chips) 
Seat 8: HPEB+AtKw1+C/cxU0o1ciw ($25 in chips) 
iGiuurat0/9pnLDHRit8Bw: posts small blind $0.10
HPEB+AtKw1+C/cxU0o1ciw: posts big blind $0.25
mobyblastr: sits out 
*** HOLE CARDS ***
H5Se03ZqSX7tbULXur2MAg: folds 
OlPJsgR4xypSg/w1z7Gyvw: folds 
N6fYvIzQLKaydFLKQGtMlQ: folds 
7Tiam59GaMYACH/my1qVuw: raises $0.50 to $0.75
+2kMBNpY4nF1qNCRd8SJLA: folds 
dAohy+E9dUFBp6GlYFiOtQ: calls $0.75
iGiuurat0/9pnLDHRit8Bw: folds 
HPEB+AtKw1+C/cxU0o1ciw: calls $0.50
*** FLOP *** [8d 6h 4h]
HPEB+AtKw1+C/cxU0o1ciw: checks 
7Tiam59GaMYACH/my1qVuw: bets $1
dAohy+E9dUFBp6GlYFiOtQ: raises $1 to $2
HPEB+AtKw1+C/cxU0o1ciw: calls $2
7Tiam59GaMYACH/my1qVuw: calls $1
*** TURN *** [8d 6h 4h] [Js]
HPEB+AtKw1+C/cxU0o1ciw: checks 
7Tiam59GaMYACH/my1qVuw: checks 
mobyblastr leaves the table
dAohy+E9dUFBp6GlYFiOtQ: checks 
*** RIVER *** [8d 6h 4h Js] [Tc]
HPEB+AtKw1+C/cxU0o1ciw: checks 
7Tiam59GaMYACH/my1qVuw: checks 
dAohy+E9dUFBp6GlYFiOtQ: bets $22.40 and is all-in
HPEB+AtKw1+C/cxU0o1ciw: folds 
7Tiam59GaMYACH/my1qVuw: folds 
Uncalled bet ($22.40) returned to dAohy+E9dUFBp6GlYFiOtQ
dAohy+E9dUFBp6GlYFiOtQ collected $7.95 from pot
dAohy+E9dUFBp6GlYFiOtQ: doesn't show hand 
*** SUMMARY ***
Total pot $8.35 | Rake $0.40 
Board [8d 6h 4h Js Tc]
Seat 1: H5Se03ZqSX7tbULXur2MAg folded before Flop (didn't bet)
Seat 2: OlPJsgR4xypSg/w1z7Gyvw folded before Flop (didn't bet)
Seat 3: N6fYvIzQLKaydFLKQGtMlQ folded before Flop (didn't bet)
Seat 4: 7Tiam59GaMYACH/my1qVuw folded on the River
Seat 5: +2kMBNpY4nF1qNCRd8SJLA folded before Flop (didn't bet)
Seat 6: dAohy+E9dUFBp6GlYFiOtQ (button) collected ($7.95)
Seat 7: iGiuurat0/9pnLDHRit8Bw (small blind) folded before Flop
Seat 8: HPEB+AtKw1+C/cxU0o1ciw (big blind) folded on the River




PokerStars Game #59939736284:  Hold'em No Limit ($0.10/$0.25) - 2009/07/01 0:47:36 ET
Table 'djcjiEGabFQO0MNG6jEeJQ' 9-max Seat #8 is the button
Seat 1: K7bAhhMMJ/XcTmGaBZVfFQ ($24.40 in chips) 
Seat 3: 1S/fpm+f42V/6MNZre+ccg ($27.95 in chips) 
Seat 4: E6WojUZ5V/6opnfMNTSjXQ ($12.70 in chips) 
Seat 5: cZ99hugmLBj9KhTlc8nCSw ($40.95 in chips) 
Seat 6: aNpwfA31EREwO+ar4XzBCw ($59.20 in chips) 
Seat 7: 56S3mA6Zs3pGR+0p0vUCtg ($30.10 in chips) 
Seat 8: +sbyWwIcFp9kP0bDtMegfQ ($53.95 in chips) 
Seat 9: HPEB+AtKw1+C/cxU0o1ciw ($47.40 in chips) 
HPEB+AtKw1+C/cxU0o1ciw: posts small blind $0.10
K7bAhhMMJ/XcTmGaBZVfFQ: posts big blind $0.25
*** HOLE CARDS ***
1S/fpm+f42V/6MNZre+ccg: folds 
E6WojUZ5V/6opnfMNTSjXQ: calls $0.25
cZ99hugmLBj9KhTlc8nCSw: folds 
aNpwfA31EREwO+ar4XzBCw: folds 
56S3mA6Zs3pGR+0p0vUCtg: folds 
+sbyWwIcFp9kP0bDtMegfQ: folds 
HPEB+AtKw1+C/cxU0o1ciw: folds 
K7bAhhMMJ/XcTmGaBZVfFQ: checks 
*** FLOP *** [As 7h Td]
K7bAhhMMJ/XcTmGaBZVfFQ: checks 
E6WojUZ5V/6opnfMNTSjXQ: bets $0.75
K7bAhhMMJ/XcTmGaBZVfFQ: folds 
Uncalled bet ($0.75) returned to E6WojUZ5V/6opnfMNTSjXQ
E6WojUZ5V/6opnfMNTSjXQ collected $0.60 from pot
E6WojUZ5V/6opnfMNTSjXQ: doesn't show hand 
*** SUMMARY ***
Total pot $0.60 | Rake $0 
Board [As 7h Td]
Seat 1: K7bAhhMMJ/XcTmGaBZVfFQ (big blind) folded on the Flop
Seat 3: 1S/fpm+f42V/6MNZre+ccg folded before Flop (didn't bet)
Seat 4: E6WojUZ5V/6opnfMNTSjXQ collected ($0.60)
Seat 5: cZ99hugmLBj9KhTlc8nCSw folded before Flop (didn't bet)
Seat 6: aNpwfA31EREwO+ar4XzBCw folded before Flop (didn't bet)
Seat 7: 56S3mA6Zs3pGR+0p0vUCtg folded before Flop (didn't bet)
Seat 8: +sbyWwIcFp9kP0bDtMegfQ (button) folded before Flop (didn't bet)
Seat 9: HPEB+AtKw1+C/cxU0o1ciw (small blind) folded before Flop




PokerStars Game #59939736520:  Hold'em No Limit ($0.10/$0.25) - 2009/07/01 0:47:36 ET
Table 'zW+7jPbOLCvlPu+dUGY5WQ' 6-max Seat #2 is the button
Seat 2: MkNgTuvyxpHXkeIm5JITHQ ($10 in chips) 
Seat 3: A/hdSH6onjy+0fc+uvZ+LA ($5 in chips) 
MkNgTuvyxpHXkeIm5JITHQ: posts small blind $0.10
A/hdSH6onjy+0fc+uvZ+LA: posts big blind $0.25
*** HOLE CARDS ***
MkNgTuvyxpHXkeIm5JITHQ: calls $0.15
A/hdSH6onjy+0fc+uvZ+LA: checks 
*** FLOP *** [7s Ks Jh]
A/hdSH6onjy+0fc+uvZ+LA: checks 
MkNgTuvyxpHXkeIm5JITHQ: bets $0.50
A/hdSH6onjy+0fc+uvZ+LA: folds 
Uncalled bet ($0.50) returned to MkNgTuvyxpHXkeIm5JITHQ
UfU14XiqkyIQoIJy9COOsQ joins the table at seat #1 
MkNgTuvyxpHXkeIm5JITHQ collected $0.50 from pot
MkNgTuvyxpHXkeIm5JITHQ: doesn't show hand 
*** SUMMARY ***
Total pot $0.50 | Rake $0 
Board [7s Ks Jh]
Seat 2: MkNgTuvyxpHXkeIm5JITHQ (button) (small blind) collected ($0.50)
Seat 3: A/hdSH6onjy+0fc+uvZ+LA (big blind) folded on the Flop




PokerStars Game #59939736348:  Hold'em No Limit ($0.10/$0.25) - 2009/07/01 0:47:36 ET
Table '+giHa6FUL6U5/AZnCJEGvQ' 9-max Seat #1 is the button
Seat 1: kYgmoJdHhyWAdwXflGZuKA ($33.95 in chips) 
Seat 2: YN6/TiJBEQVW8LDMQA1vFQ ($8.55 in chips) 
Seat 3: DIBbjEYGs+TVdVgEB/4+3w ($26.75 in chips) 
Seat 4: ljemhp25Zg+nlA9DLCIiUw ($49.85 in chips) 
Seat 5: zDrucyjVn5aeekNEc3cJrA ($47.15 in chips) 
Seat 6: cZ99hugmLBj9KhTlc8nCSw ($25.85 in chips) 
Seat 7: TeWJxSETzbXGiYKx0y+dtg ($25 in chips) 
Seat 8: t2nb95S5EEFOEzNx9Itz0g ($2.10 in chips) 
Seat 9: qwr38jl5txoR36M7G5qi4A ($7.85 in chips) 
YN6/TiJBEQVW8LDMQA1vFQ: posts small blind $0.10
DIBbjEYGs+TVdVgEB/4+3w: posts big blind $0.25
*** HOLE CARDS ***
ljemhp25Zg+nlA9DLCIiUw: calls $0.25
zDrucyjVn5aeekNEc3cJrA: folds 
cZ99hugmLBj9KhTlc8nCSw: folds 
TeWJxSETzbXGiYKx0y+dtg: folds 
t2nb95S5EEFOEzNx9Itz0g: folds 
qwr38jl5txoR36M7G5qi4A: folds 
kYgmoJdHhyWAdwXflGZuKA: folds 
YN6/TiJBEQVW8LDMQA1vFQ: raises $0.25 to $0.50
DIBbjEYGs+TVdVgEB/4+3w: calls $0.25
ljemhp25Zg+nlA9DLCIiUw: calls $0.25
*** FLOP *** [5c Qs 7s]
YN6/TiJBEQVW8LDMQA1vFQ: bets $0.25
DIBbjEYGs+TVdVgEB/4+3w: calls $0.25
ljemhp25Zg+nlA9DLCIiUw: folds 
*** TURN *** [5c Qs 7s] [6d]
YN6/TiJBEQVW8LDMQA1vFQ: bets $0.25
DIBbjEYGs+TVdVgEB/4+3w: raises $1.25 to $1.50
YN6/TiJBEQVW8LDMQA1vFQ: calls $1.25
*** RIVER *** [5c Qs 7s 6d] [4h]
YN6/TiJBEQVW8LDMQA1vFQ: checks 
DIBbjEYGs+TVdVgEB/4+3w: bets $3
YN6/TiJBEQVW8LDMQA1vFQ: folds 
Uncalled bet ($3) returned to DIBbjEYGs+TVdVgEB/4+3w
DIBbjEYGs+TVdVgEB/4+3w collected $4.80 from pot
*** SUMMARY ***
Total pot $5 | Rake $0.20 
Board [5c Qs 7s 6d 4h]
Seat 1: kYgmoJdHhyWAdwXflGZuKA (button) folded before Flop (didn't bet)
Seat 2: YN6/TiJBEQVW8LDMQA1vFQ (small blind) folded on the River
Seat 3: DIBbjEYGs+TVdVgEB/4+3w (big blind) collected ($4.80)
Seat 4: ljemhp25Zg+nlA9DLCIiUw folded on the Flop
Seat 5: zDrucyjVn5aeekNEc3cJrA folded before Flop (didn't bet)
Seat 6: cZ99hugmLBj9KhTlc8nCSw folded before Flop (didn't bet)
Seat 7: TeWJxSETzbXGiYKx0y+dtg folded before Flop (didn't bet)
Seat 8: t2nb95S5EEFOEzNx9Itz0g folded before Flop (didn't bet)
Seat 9: qwr38jl5txoR36M7G5qi4A folded before Flop (didn't bet)




PokerStars Game #59939736720:  Hold'em No Limit ($0.10/$0.25) - 2009/07/01 0:47:37 ET
Table 'AchTjdLS1zBUbH3ZIx6f0w' 6-max Seat #1 is the button
Seat 1: IzVI+wIP7IS+d0sugIrOPQ ($24 in chips) 
Seat 2: kG34n23qFQA3nzdOJTQ1dA ($40.70 in chips) 
Seat 3: ehifenV36yVvJMnV63D3cg ($5.65 in chips) 
Seat 4: q6WfTUAD9mowIP63ASq2Dg ($30.70 in chips) 
Seat 5: oBUDUfeUyCbZBsjxHZgSiw ($36 in chips) 
Seat 6: 5tB0F9NjPSUL4FzmzBMs2Q ($25 in chips) 
kG34n23qFQA3nzdOJTQ1dA: posts small blind $0.10
ehifenV36yVvJMnV63D3cg: posts big blind $0.25
*** HOLE CARDS ***
q6WfTUAD9mowIP63ASq2Dg: folds 
oBUDUfeUyCbZBsjxHZgSiw: folds 
5tB0F9NjPSUL4FzmzBMs2Q: raises $0.75 to $1
IzVI+wIP7IS+d0sugIrOPQ: folds 
kG34n23qFQA3nzdOJTQ1dA: folds 
ehifenV36yVvJMnV63D3cg: folds 
Uncalled bet ($0.75) returned to 5tB0F9NjPSUL4FzmzBMs2Q
5tB0F9NjPSUL4FzmzBMs2Q collected $0.60 from pot
*** SUMMARY ***
Total pot $0.60 | Rake $0 
Seat 1: IzVI+wIP7IS+d0sugIrOPQ (button) folded before Flop (didn't bet)
Seat 2: kG34n23qFQA3nzdOJTQ1dA (small blind) folded before Flop
Seat 3: ehifenV36yVvJMnV63D3cg (big blind) folded before Flop
Seat 4: q6WfTUAD9mowIP63ASq2Dg folded before Flop (didn't bet)
Seat 5: oBUDUfeUyCbZBsjxHZgSiw folded before Flop (didn't bet)
Seat 6: 5tB0F9NjPSUL4FzmzBMs2Q collected ($0.60)




PokerStars Game #59939737716:  Hold'em No Limit ($0.10/$0.25) - 2009/07/01 0:47:38 ET
Table 'O6cwjhrMn9pfzx1Ngn5zkQ' 6-max Seat #5 is the button
Seat 1: k4mJ9nD/YOVTl8/kGW+U6w ($14.60 in chips) 
Seat 2: M6xK/VklCvdyyrmvzATlxQ ($12.50 in chips) 
Seat 3: EE16Ua5b1HSsYej5zeXOlA ($25.90 in chips) 
Seat 4: wKFJ513ucluNNiMlkXcDOQ ($32.70 in chips) 
Seat 5: niLn0xUVlqh8If80xRjzCA ($22.05 in chips) 
Seat 6: d0J1xuhsynEY81YHwAvJ5g ($27.20 in chips) 
d0J1xuhsynEY81YHwAvJ5g: posts small blind $0.10
k4mJ9nD/YOVTl8/kGW+U6w: posts big blind $0.25
*** HOLE CARDS ***
M6xK/VklCvdyyrmvzATlxQ: folds 
EE16Ua5b1HSsYej5zeXOlA: folds 
wKFJ513ucluNNiMlkXcDOQ: folds 
wKFJ513ucluNNiMlkXcDOQ leaves the table
niLn0xUVlqh8If80xRjzCA: calls $0.25
d0J1xuhsynEY81YHwAvJ5g: calls $0.15
k4mJ9nD/YOVTl8/kGW+U6w: checks 
*** FLOP *** [As 7s 2s]
d0J1xuhsynEY81YHwAvJ5g: checks 
FStoHe64SQWqAsjya9pDkQ joins the table at seat #4 
M6xK/VklCvdyyrmvzATlxQ leaves the table
k4mJ9nD/YOVTl8/kGW+U6w: checks 
niLn0xUVlqh8If80xRjzCA: checks 
*** TURN *** [As 7s 2s] [Th]
d0J1xuhsynEY81YHwAvJ5g: checks 
k4mJ9nD/YOVTl8/kGW+U6w: checks 
niLn0xUVlqh8If80xRjzCA: checks 
*** RIVER *** [As 7s 2s Th] [4h]
d0J1xuhsynEY81YHwAvJ5g: checks 
k4mJ9nD/YOVTl8/kGW+U6w: checks 
niLn0xUVlqh8If80xRjzCA: checks 
*** SHOW DOWN ***
d0J1xuhsynEY81YHwAvJ5g: shows [5h 7h] (a pair of Sevens)
k4mJ9nD/YOVTl8/kGW+U6w: mucks hand 
niLn0xUVlqh8If80xRjzCA: mucks hand 
d0J1xuhsynEY81YHwAvJ5g collected $0.75 from pot
*** SUMMARY ***
Total pot $0.75 | Rake $0 
Board [As 7s 2s Th 4h]
Seat 1: k4mJ9nD/YOVTl8/kGW+U6w (big blind) mucked
Seat 2: M6xK/VklCvdyyrmvzATlxQ folded before Flop (didn't bet)
Seat 3: EE16Ua5b1HSsYej5zeXOlA folded before Flop (didn't bet)
Seat 4: wKFJ513ucluNNiMlkXcDOQ folded before Flop (didn't bet)
Seat 5: niLn0xUVlqh8If80xRjzCA (button) mucked
Seat 6: d0J1xuhsynEY81YHwAvJ5g (small blind) showed [5h 7h] and won ($0.75) with a pair of Sevens




PokerStars Game #59939737474:  Hold'em No Limit ($0.10/$0.25) - 2009/07/01 0:47:38 ET
Table '6wawJ+MkkvuC3coG6r+Yhg' 6-max Seat #4 is the button
Seat 1: ELW+DKizJhLK7k40PMkD2Q ($32.50 in chips) 
Seat 2: LtASJ9OlkqGrrUKGQlpGAw ($26.05 in chips) 
Seat 3: KYBwVA7jgmSrbIEbEGElVg ($19.35 in chips) 
Seat 4: cS21pIxRHx5Gt42o7hPZzw ($11.15 in chips) 
Seat 5: A8uIskXJTblhVXWuYr+lkw ($3.95 in chips) 
Seat 6: oOGZlBAhqtG/HczLL/KLRQ ($21.10 in chips) 
A8uIskXJTblhVXWuYr+lkw: posts small blind $0.10
oOGZlBAhqtG/HczLL/KLRQ: posts big blind $0.25
*** HOLE CARDS ***
ELW+DKizJhLK7k40PMkD2Q: folds 
LtASJ9OlkqGrrUKGQlpGAw: folds 
KYBwVA7jgmSrbIEbEGElVg: folds 
cS21pIxRHx5Gt42o7hPZzw: folds 
A8uIskXJTblhVXWuYr+lkw: calls $0.15
oOGZlBAhqtG/HczLL/KLRQ: checks 
*** FLOP *** [8s Ks Ts]
A8uIskXJTblhVXWuYr+lkw: checks 
oOGZlBAhqtG/HczLL/KLRQ: checks 
*** TURN *** [8s Ks Ts] [2s]
A8uIskXJTblhVXWuYr+lkw: bets $0.25
oOGZlBAhqtG/HczLL/KLRQ: raises $0.25 to $0.50
A8uIskXJTblhVXWuYr+lkw: raises $0.25 to $0.75
oOGZlBAhqtG/HczLL/KLRQ: folds 
Uncalled bet ($0.25) returned to A8uIskXJTblhVXWuYr+lkw
A8uIskXJTblhVXWuYr+lkw collected $1.45 from pot
*** SUMMARY ***
Total pot $1.50 | Rake $0.05 
Board [8s Ks Ts 2s]
Seat 1: ELW+DKizJhLK7k40PMkD2Q folded before Flop (didn't bet)
Seat 2: LtASJ9OlkqGrrUKGQlpGAw folded before Flop (didn't bet)
Seat 3: KYBwVA7jgmSrbIEbEGElVg folded before Flop (didn't bet)
Seat 4: cS21pIxRHx5Gt42o7hPZzw (button) folded before Flop (didn't bet)
Seat 5: A8uIskXJTblhVXWuYr+lkw (small blind) collected ($1.45)
Seat 6: oOGZlBAhqtG/HczLL/KLRQ (big blind) folded on the Turn




PokerStars Game #59939737328:  Hold'em No Limit ($0.10/$0.25) - 2009/07/01 0:47:38 ET
Table 'vZfV/Uj0q8joA1du9sRJSg' 6-max Seat #2 is the button
Seat 1: OAmGQMdOxnvuBNHdADx0ew ($6.25 in chips) 
Seat 2: wMiE3yTbDJGOLOF9th7KPA ($13.05 in chips) 
Seat 3: QJ/0wT0pYdWbDuqo9eNJgQ ($5.10 in chips) 
Seat 4: v+QfkGiuj9bgtuNoVnDO8w ($25.60 in chips) 
Seat 5: FStoHe64SQWqAsjya9pDkQ ($25 in chips) 
Seat 6: 8ClCHtFXGNplITm+63KB+Q ($27.05 in chips) 
QJ/0wT0pYdWbDuqo9eNJgQ: posts small blind $0.10
v+QfkGiuj9bgtuNoVnDO8w: posts big blind $0.25
*** HOLE CARDS ***
FStoHe64SQWqAsjya9pDkQ: folds 
8ClCHtFXGNplITm+63KB+Q: folds 
OAmGQMdOxnvuBNHdADx0ew: calls $0.25
wMiE3yTbDJGOLOF9th7KPA: calls $0.25
QJ/0wT0pYdWbDuqo9eNJgQ: folds 
v+QfkGiuj9bgtuNoVnDO8w: checks 
*** FLOP *** [Kd Td Kc]
v+QfkGiuj9bgtuNoVnDO8w: checks 
OAmGQMdOxnvuBNHdADx0ew: checks 
wMiE3yTbDJGOLOF9th7KPA: bets $0.25
v+QfkGiuj9bgtuNoVnDO8w: folds 
OAmGQMdOxnvuBNHdADx0ew: folds 
Uncalled bet ($0.25) returned to wMiE3yTbDJGOLOF9th7KPA
wMiE3yTbDJGOLOF9th7KPA collected $0.85 from pot
wMiE3yTbDJGOLOF9th7KPA: doesn't show hand 
*** SUMMARY ***
Total pot $0.85 | Rake $0 
Board [Kd Td Kc]
Seat 1: OAmGQMdOxnvuBNHdADx0ew folded on the Flop
Seat 2: wMiE3yTbDJGOLOF9th7KPA (button) collected ($0.85)
Seat 3: QJ/0wT0pYdWbDuqo9eNJgQ (small blind) folded before Flop
Seat 4: v+QfkGiuj9bgtuNoVnDO8w (big blind) folded on the Flop
Seat 5: FStoHe64SQWqAsjya9pDkQ folded before Flop (didn't bet)
Seat 6: 8ClCHtFXGNplITm+63KB+Q folded before Flop (didn't bet)




PokerStars Game #59939737850:  Hold'em No Limit ($0.10/$0.25) - 2009/07/01 0:47:38 ET
Table 'IdXp6nyeW4FYaEK4qKCnwQ' 9-max Seat #6 is the button
Seat 2: HPEB+AtKw1+C/cxU0o1ciw ($28.10 in chips) 
Seat 4: IK3/w7XV7rd8mVIsuasjYA ($3.90 in chips) 
Seat 5: U41wNf6XauAiBOQaKu2ZIA ($6.65 in chips) 
Seat 6: qeHpnumzEthsYultSkNjCA ($9.70 in chips) 
Seat 9: JJH2Xc95hFewheF67vSv4Q ($18.15 in chips) 
JJH2Xc95hFewheF67vSv4Q: posts small blind $0.10
HPEB+AtKw1+C/cxU0o1ciw: posts big blind $0.25
*** HOLE CARDS ***
IK3/w7XV7rd8mVIsuasjYA: folds 
U41wNf6XauAiBOQaKu2ZIA: calls $0.25
qeHpnumzEthsYultSkNjCA: calls $0.25
JJH2Xc95hFewheF67vSv4Q: calls $0.15
HPEB+AtKw1+C/cxU0o1ciw: checks 
*** FLOP *** [Jc 6h Qc]
JJH2Xc95hFewheF67vSv4Q: checks 
HPEB+AtKw1+C/cxU0o1ciw: checks 
U41wNf6XauAiBOQaKu2ZIA: checks 
qeHpnumzEthsYultSkNjCA: checks 
*** TURN *** [Jc 6h Qc] [As]
JJH2Xc95hFewheF67vSv4Q: checks 
HPEB+AtKw1+C/cxU0o1ciw: checks 
U41wNf6XauAiBOQaKu2ZIA: checks 
qeHpnumzEthsYultSkNjCA: checks 
*** RIVER *** [Jc 6h Qc As] [Ah]
NDJWZaU2QihSadZB98k0tg joins the table at seat #3 
JJH2Xc95hFewheF67vSv4Q: folds 
HPEB+AtKw1+C/cxU0o1ciw: checks 
U41wNf6XauAiBOQaKu2ZIA: checks 
qeHpnumzEthsYultSkNjCA: checks 
*** SHOW DOWN ***
HPEB+AtKw1+C/cxU0o1ciw: shows [Kh Jh] (two pair, Aces and Jacks)
U41wNf6XauAiBOQaKu2ZIA: mucks hand 
qeHpnumzEthsYultSkNjCA: mucks hand 
HPEB+AtKw1+C/cxU0o1ciw collected $0.95 from pot
*** SUMMARY ***
Total pot $1 | Rake $0.05 
Board [Jc 6h Qc As Ah]
Seat 2: HPEB+AtKw1+C/cxU0o1ciw (big blind) showed [Kh Jh] and won ($0.95) with two pair, Aces and Jacks
Seat 4: IK3/w7XV7rd8mVIsuasjYA folded before Flop (didn't bet)
Seat 5: U41wNf6XauAiBOQaKu2ZIA mucked
Seat 6: qeHpnumzEthsYultSkNjCA (button) mucked
Seat 9: JJH2Xc95hFewheF67vSv4Q (small blind) folded on the River




PokerStars Game #59939737406:  Hold'em No Limit ($0.10/$0.25) - 2009/07/01 0:47:38 ET
Table '3lS+sU5k6mwJCS2nFMmQ6Q' 9-max Seat #2 is the button
Seat 1: VWUWpMLMj/Q1jRVpF7Aohw ($12 in chips) 
Seat 2: 4oA316mXLIui1QY63GXBUg ($25 in chips) 
Seat 3: 1DXccE2UUK5DIRVGlOKnTA ($9.95 in chips) 
Seat 4: 8B/dhbQjIWe6ASCdgzktNQ ($44.90 in chips) 
Seat 5: NcPAt5YjVvDFEJTTgAVj8g ($15 in chips) 
Seat 6: hJ4uYjNmSZdjrKA8cjZqCA ($28.45 in chips) 
Seat 7: Th3FldXKQW6hWVVPahaoOQ ($26 in chips) 
Seat 8: SXqVW4Q0evTUVZG6BbUNIA ($21.35 in chips) 
Seat 9: 4awUyiDYTgylQKXZ9faBVA ($43.15 in chips) 
1DXccE2UUK5DIRVGlOKnTA: posts small blind $0.10
8B/dhbQjIWe6ASCdgzktNQ: posts big blind $0.25
NcPAt5YjVvDFEJTTgAVj8g: posts big blind $0.25
*** HOLE CARDS ***
NcPAt5YjVvDFEJTTgAVj8g: checks 
hJ4uYjNmSZdjrKA8cjZqCA: folds 
Th3FldXKQW6hWVVPahaoOQ: folds 
SXqVW4Q0evTUVZG6BbUNIA: folds 
4awUyiDYTgylQKXZ9faBVA: folds 
VWUWpMLMj/Q1jRVpF7Aohw: folds 
4oA316mXLIui1QY63GXBUg: folds 
1DXccE2UUK5DIRVGlOKnTA: raises $0.75 to $1
8B/dhbQjIWe6ASCdgzktNQ: folds 
NcPAt5YjVvDFEJTTgAVj8g: folds 
Uncalled bet ($0.75) returned to 1DXccE2UUK5DIRVGlOKnTA
1DXccE2UUK5DIRVGlOKnTA collected $0.75 from pot
*** SUMMARY ***
Total pot $0.75 | Rake $0 
Seat 1: VWUWpMLMj/Q1jRVpF7Aohw folded before Flop (didn't bet)
Seat 2: 4oA316mXLIui1QY63GXBUg (button) folded before Flop (didn't bet)
Seat 3: 1DXccE2UUK5DIRVGlOKnTA (small blind) collected ($0.75)
Seat 4: 8B/dhbQjIWe6ASCdgzktNQ (big blind) folded before Flop
Seat 5: NcPAt5YjVvDFEJTTgAVj8g folded before Flop
Seat 6: hJ4uYjNmSZdjrKA8cjZqCA folded before Flop (didn't bet)
Seat 7: Th3FldXKQW6hWVVPahaoOQ folded before Flop (didn't bet)
Seat 8: SXqVW4Q0evTUVZG6BbUNIA folded before Flop (didn't bet)
Seat 9: 4awUyiDYTgylQKXZ9faBVA folded before Flop (didn't bet)




PokerStars Game #59939738212:  Hold'em No Limit ($0.10/$0.25) - 2009/07/01 0:47:39 ET
Table '3760QYRYyCWeXf0rLZ5S2g' 9-max Seat #2 is the button
Seat 2: zDrucyjVn5aeekNEc3cJrA ($20.45 in chips) 
Seat 9: CuSnLU1MIUBUa62c3DrAzg ($15 in chips) 
zDrucyjVn5aeekNEc3cJrA: posts small blind $0.10
CuSnLU1MIUBUa62c3DrAzg: posts big blind $0.25
*** HOLE CARDS ***
zDrucyjVn5aeekNEc3cJrA: calls $0.15
CuSnLU1MIUBUa62c3DrAzg: checks 
*** FLOP *** [Qs Kd 6c]
CuSnLU1MIUBUa62c3DrAzg: bets $0.25
zDrucyjVn5aeekNEc3cJrA: folds 
Uncalled bet ($0.25) returned to CuSnLU1MIUBUa62c3DrAzg
CuSnLU1MIUBUa62c3DrAzg collected $0.50 from pot
CuSnLU1MIUBUa62c3DrAzg: doesn't show hand 
*** SUMMARY ***
Total pot $0.50 | Rake $0 
Board [Qs Kd 6c]
Seat 2: zDrucyjVn5aeekNEc3cJrA (button) (small blind) folded on the Flop
Seat 9: CuSnLU1MIUBUa62c3DrAzg (big blind) collected ($0.50)




PokerStars Game #59939738110:  Hold'em No Limit ($0.10/$0.25) - 2009/07/01 0:47:39 ET
Table '/AhP8uWRzEEhOATYIdmn0A' 9-max Seat #5 is the button
Seat 1: +sbyWwIcFp9kP0bDtMegfQ ($23.40 in chips) 
Seat 2: nvWCCH1JBjMjQkSaXl2Mog ($17.40 in chips) 
Seat 3: vSkQm2EelzwRGDDQQk0Fqw ($4.65 in chips) 
Seat 4: +WMpj67YqG8ilNkg2JwXpw ($14.65 in chips) 
Seat 5: BEIBUu2pIflPrCL+Iks4CQ ($13.50 in chips) 
Seat 7: 4oA316mXLIui1QY63GXBUg ($29.65 in chips) 
Seat 8: CYkY0dNBaYaKs8HVCVn3mQ ($5.85 in chips) 
Seat 9: DIBbjEYGs+TVdVgEB/4+3w ($29.25 in chips) 
4oA316mXLIui1QY63GXBUg: posts small blind $0.10
CYkY0dNBaYaKs8HVCVn3mQ: posts big blind $0.25
*** HOLE CARDS ***
DIBbjEYGs+TVdVgEB/4+3w: folds 
+sbyWwIcFp9kP0bDtMegfQ: folds 
nvWCCH1JBjMjQkSaXl2Mog: folds 
vSkQm2EelzwRGDDQQk0Fqw: folds 
+WMpj67YqG8ilNkg2JwXpw: folds 
BEIBUu2pIflPrCL+Iks4CQ: folds 
4oA316mXLIui1QY63GXBUg: folds 
Uncalled bet ($0.15) returned to CYkY0dNBaYaKs8HVCVn3mQ
CYkY0dNBaYaKs8HVCVn3mQ collected $0.20 from pot
CYkY0dNBaYaKs8HVCVn3mQ: doesn't show hand 
*** SUMMARY ***
Total pot $0.20 | Rake $0 
Seat 1: +sbyWwIcFp9kP0bDtMegfQ folded before Flop (didn't bet)
Seat 2: nvWCCH1JBjMjQkSaXl2Mog folded before Flop (didn't bet)
Seat 3: vSkQm2EelzwRGDDQQk0Fqw folded before Flop (didn't bet)
Seat 4: +WMpj67YqG8ilNkg2JwXpw folded before Flop (didn't bet)
Seat 5: BEIBUu2pIflPrCL+Iks4CQ (button) folded before Flop (didn't bet)
Seat 7: 4oA316mXLIui1QY63GXBUg (small blind) folded before Flop
Seat 8: CYkY0dNBaYaKs8HVCVn3mQ (big blind) collected ($0.20)
Seat 9: DIBbjEYGs+TVdVgEB/4+3w folded before Flop (didn't bet)




PokerStars Game #59939738340:  Hold'em No Limit ($0.10/$0.25) - 2009/07/01 0:47:39 ET
Table 'nXVbUw6/HYwA6x21+IZ3XQ' 9-max Seat #6 is the button
Seat 1: zDrucyjVn5aeekNEc3cJrA ($23.05 in chips) 
Seat 4: GmQux9F6mgOHtI4C9bVTNQ ($5 in chips) 
Seat 5: M/9j4wkHH9i1JM51vgi1VA ($20.80 in chips) 
Seat 6: ljemhp25Zg+nlA9DLCIiUw ($23.10 in chips) 
Seat 7: IupaN0QS3TJoOSYaS7zF9w ($9.75 in chips) 
Seat 8: dfNim92Z6XK1/h5SFW5vDg ($25 in chips) 
Seat 9: rm0e8CshiGK8hjW46YcNqg ($32.50 in chips) 
IupaN0QS3TJoOSYaS7zF9w: posts small blind $0.10
dfNim92Z6XK1/h5SFW5vDg: posts big blind $0.25
*** HOLE CARDS ***
rm0e8CshiGK8hjW46YcNqg: folds 
zDrucyjVn5aeekNEc3cJrA: folds 
GmQux9F6mgOHtI4C9bVTNQ: folds 
M/9j4wkHH9i1JM51vgi1VA: folds 
ljemhp25Zg+nlA9DLCIiUw: folds 
IupaN0QS3TJoOSYaS7zF9w said, "i wanted mod69 again"
IupaN0QS3TJoOSYaS7zF9w: raises $0.50 to $0.75
dfNim92Z6XK1/h5SFW5vDg: folds 
Uncalled bet ($0.50) returned to IupaN0QS3TJoOSYaS7zF9w
IupaN0QS3TJoOSYaS7zF9w collected $0.50 from pot
IupaN0QS3TJoOSYaS7zF9w: doesn't show hand 
*** SUMMARY ***
Total pot $0.50 | Rake $0 
Seat 1: zDrucyjVn5aeekNEc3cJrA folded before Flop (didn't bet)
Seat 4: GmQux9F6mgOHtI4C9bVTNQ folded before Flop (didn't bet)
Seat 5: M/9j4wkHH9i1JM51vgi1VA folded before Flop (didn't bet)
Seat 6: ljemhp25Zg+nlA9DLCIiUw (button) folded before Flop (didn't bet)
Seat 7: IupaN0QS3TJoOSYaS7zF9w (small blind) collected ($0.50)
Seat 8: dfNim92Z6XK1/h5SFW5vDg (big blind) folded before Flop
Seat 9: rm0e8CshiGK8hjW46YcNqg folded before Flop (didn't bet)




PokerStars Game #59939738070:  Hold'em No Limit ($0.10/$0.25) - 2009/07/01 0:47:39 ET
Table 'mF3KHGMaTpaBZbtBoyfTeg' 6-max Seat #4 is the button
Seat 1: 0HAB2GdCAM7p7V00xueAVQ ($8.30 in chips) 
Seat 2: 4x9jCqgSw4272dnaIqnanw ($3.75 in chips) 
Seat 3: Hzrn9DZJegEZICufTNYkrg ($13.05 in chips) 
Seat 4: FYepjhAvF8ZdVCmqHIy+eQ ($25 in chips) 
Seat 5: sEQx9G5Cu8k1HNdQasxvUA ($41.40 in chips) 
Seat 6: kG34n23qFQA3nzdOJTQ1dA ($24.40 in chips) 
sEQx9G5Cu8k1HNdQasxvUA: posts small blind $0.10
kG34n23qFQA3nzdOJTQ1dA: posts big blind $0.25
*** HOLE CARDS ***
0HAB2GdCAM7p7V00xueAVQ: folds 
4x9jCqgSw4272dnaIqnanw: raises $3.50 to $3.75 and is all-in
Hzrn9DZJegEZICufTNYkrg: folds 
FYepjhAvF8ZdVCmqHIy+eQ: folds 
sEQx9G5Cu8k1HNdQasxvUA: folds 
kG34n23qFQA3nzdOJTQ1dA: folds 
Uncalled bet ($3.50) returned to 4x9jCqgSw4272dnaIqnanw
4x9jCqgSw4272dnaIqnanw collected $0.60 from pot
*** SUMMARY ***
Total pot $0.60 | Rake $0 
Seat 1: 0HAB2GdCAM7p7V00xueAVQ folded before Flop (didn't bet)
Seat 2: 4x9jCqgSw4272dnaIqnanw collected ($0.60)
Seat 3: Hzrn9DZJegEZICufTNYkrg folded before Flop (didn't bet)
Seat 4: FYepjhAvF8ZdVCmqHIy+eQ (button) folded before Flop (didn't bet)
Seat 5: sEQx9G5Cu8k1HNdQasxvUA (small blind) folded before Flop
Seat 6: kG34n23qFQA3nzdOJTQ1dA (big blind) folded before Flop




PokerStars Game #59939738014:  Hold'em No Limit ($0.10/$0.25) - 2009/07/01 0:47:39 ET
Table 'xPn6TS/y/OWkX7Qa+MUuKA' 6-max Seat #3 is the button
Seat 1: JFIAqU8lCZ0vWwEl4bdGsg ($28.85 in chips) 
Seat 2: buyjetgNT1McXtdaP4zynA ($24.75 in chips) 
Seat 3: o08wk0F4gROLhZS04Iyl3w ($26.50 in chips) 
Seat 4: SS/yfeArhULzIcOPe8MdPg ($33.95 in chips) 
Seat 5: I1TxPvWj8NfG8orglCinNA ($38.90 in chips) 
Seat 6: oseFhpinoe+Zg4j5xyBjyQ ($53.45 in chips) 
SS/yfeArhULzIcOPe8MdPg: posts small blind $0.10
I1TxPvWj8NfG8orglCinNA: posts big blind $0.25
*** HOLE CARDS ***
oseFhpinoe+Zg4j5xyBjyQ: folds 
JFIAqU8lCZ0vWwEl4bdGsg: raises $0.60 to $0.85
buyjetgNT1McXtdaP4zynA: calls $0.85
o08wk0F4gROLhZS04Iyl3w: folds 
SS/yfeArhULzIcOPe8MdPg: folds 
I1TxPvWj8NfG8orglCinNA: folds 
*** FLOP *** [9h 8h 3s]
JFIAqU8lCZ0vWwEl4bdGsg: bets $1.25
buyjetgNT1McXtdaP4zynA: calls $1.25
*** TURN *** [9h 8h 3s] [9s]
JFIAqU8lCZ0vWwEl4bdGsg: checks 
buyjetgNT1McXtdaP4zynA: bets $3
JFIAqU8lCZ0vWwEl4bdGsg: folds 
Uncalled bet ($3) returned to buyjetgNT1McXtdaP4zynA
buyjetgNT1McXtdaP4zynA collected $4.35 from pot
buyjetgNT1McXtdaP4zynA: doesn't show hand 
*** SUMMARY ***
Total pot $4.55 | Rake $0.20 
Board [9h 8h 3s 9s]
Seat 1: JFIAqU8lCZ0vWwEl4bdGsg folded on the Turn
Seat 2: buyjetgNT1McXtdaP4zynA collected ($4.35)
Seat 3: o08wk0F4gROLhZS04Iyl3w (button) folded before Flop (didn't bet)
Seat 4: SS/yfeArhULzIcOPe8MdPg (small blind) folded before Flop
Seat 5: I1TxPvWj8NfG8orglCinNA (big blind) folded before Flop
Seat 6: oseFhpinoe+Zg4j5xyBjyQ folded before Flop (didn't bet)




PokerStars Game #59939738396:  Hold'em No Limit ($0.10/$0.25) - 2009/07/01 0:47:39 ET
Table 'sgdCtiuCu2BDZhyDi6RzTA' 6-max Seat #1 is the button
Seat 1: 3zD3qLXT1bEffAoWGnc7wg ($28.35 in chips) 
Seat 2: R7AqtFtjtvane2IbChcU+w ($14.50 in chips) 
Seat 3: yzFNNFIfC89bBPwpFPx2ow ($16.85 in chips) 
Seat 4: rVKEgilmMX+EkKzDVvhmxA ($5.90 in chips) 
Seat 5: kD/Cb2UM93FAVgDMhEEb5g ($6.50 in chips) 
Seat 6: KODslGU8ikCYS0/29dUkhg ($11.50 in chips) 
R7AqtFtjtvane2IbChcU+w: posts small blind $0.10
yzFNNFIfC89bBPwpFPx2ow: posts big blind $0.25
*** HOLE CARDS ***
rVKEgilmMX+EkKzDVvhmxA: folds 
kD/Cb2UM93FAVgDMhEEb5g: raises $0.75 to $1
KODslGU8ikCYS0/29dUkhg: folds 
3zD3qLXT1bEffAoWGnc7wg: folds 
R7AqtFtjtvane2IbChcU+w: folds 
yzFNNFIfC89bBPwpFPx2ow: folds 
Uncalled bet ($0.75) returned to kD/Cb2UM93FAVgDMhEEb5g
kD/Cb2UM93FAVgDMhEEb5g collected $0.60 from pot
*** SUMMARY ***
Total pot $0.60 | Rake $0 
Seat 1: 3zD3qLXT1bEffAoWGnc7wg (button) folded before Flop (didn't bet)
Seat 2: R7AqtFtjtvane2IbChcU+w (small blind) folded before Flop
Seat 3: yzFNNFIfC89bBPwpFPx2ow (big blind) folded before Flop
Seat 4: rVKEgilmMX+EkKzDVvhmxA folded before Flop (didn't bet)
Seat 5: kD/Cb2UM93FAVgDMhEEb5g collected ($0.60)
Seat 6: KODslGU8ikCYS0/29dUkhg folded before Flop (didn't bet)




PokerStars Game #59939738762:  Hold'em No Limit ($0.10/$0.25) - 2009/07/01 0:47:40 ET
Table 'IRgQPZVA4+IaZZIQshgwyg' 6-max Seat #3 is the button
Seat 1: d0J1xuhsynEY81YHwAvJ5g ($25 in chips) 
Seat 2: 9jSiy0meE9XJKkdIZwyTEQ ($35.10 in chips) 
Seat 3: 8EEqTTh7T1q48sYDqbI2Xg ($29.45 in chips) 
Seat 4: PXXRy0uk7WED5BEf+ReJDQ ($13 in chips) 
Seat 5: PbMzPZIePKifKQZfKDkbIw ($27.95 in chips) 
Seat 6: XbIIdTtuN1xO7zurECHBTg ($11.75 in chips) 
PXXRy0uk7WED5BEf+ReJDQ: posts small blind $0.10
PbMzPZIePKifKQZfKDkbIw: posts big blind $0.25
XbIIdTtuN1xO7zurECHBTg: posts big blind $0.25
*** HOLE CARDS ***
XbIIdTtuN1xO7zurECHBTg: checks 
d0J1xuhsynEY81YHwAvJ5g: folds 
9jSiy0meE9XJKkdIZwyTEQ: folds 
8EEqTTh7T1q48sYDqbI2Xg: calls $0.25
PXXRy0uk7WED5BEf+ReJDQ: calls $0.15
PbMzPZIePKifKQZfKDkbIw: checks 
*** FLOP *** [7c Qh 5s]
PXXRy0uk7WED5BEf+ReJDQ: checks 
PbMzPZIePKifKQZfKDkbIw: bets $0.50
XbIIdTtuN1xO7zurECHBTg: folds 
8EEqTTh7T1q48sYDqbI2Xg: calls $0.50
PXXRy0uk7WED5BEf+ReJDQ: folds 
*** TURN *** [7c Qh 5s] [Jh]
PbMzPZIePKifKQZfKDkbIw: bets $2
8EEqTTh7T1q48sYDqbI2Xg: calls $2
*** RIVER *** [7c Qh 5s Jh] [5h]
PbMzPZIePKifKQZfKDkbIw: bets $2.50
8EEqTTh7T1q48sYDqbI2Xg: calls $2.50
*** SHOW DOWN ***
PbMzPZIePKifKQZfKDkbIw: shows [7s Qd] (two pair, Queens and Sevens)
8EEqTTh7T1q48sYDqbI2Xg: shows [Ad As] (two pair, Aces and Fives)
8EEqTTh7T1q48sYDqbI2Xg collected $10.50 from pot
*** SUMMARY ***
Total pot $11 | Rake $0.50 
Board [7c Qh 5s Jh 5h]
Seat 1: d0J1xuhsynEY81YHwAvJ5g folded before Flop (didn't bet)
Seat 2: 9jSiy0meE9XJKkdIZwyTEQ folded before Flop (didn't bet)
Seat 3: 8EEqTTh7T1q48sYDqbI2Xg (button) showed [Ad As] and won ($10.50) with two pair, Aces and Fives
Seat 4: PXXRy0uk7WED5BEf+ReJDQ (small blind) folded on the Flop
Seat 5: PbMzPZIePKifKQZfKDkbIw (big blind) showed [7s Qd] and lost with two pair, Queens and Sevens
Seat 6: XbIIdTtuN1xO7zurECHBTg folded on the Flop




PokerStars Game #59939739070:  Hold'em No Limit ($0.10/$0.25) - 2009/07/01 0:47:40 ET
Table 'fIrOIN3HoXM27ZpRwKa6oA' 6-max Seat #1 is the button
Seat 1: I1TxPvWj8NfG8orglCinNA ($38.50 in chips) 
Seat 2: 5tB0F9NjPSUL4FzmzBMs2Q ($39.75 in chips) 
Seat 3: eSKnWz2RD4rvwnvB+rFzIg ($25.35 in chips) 
Seat 5: 8ClCHtFXGNplITm+63KB+Q ($26.10 in chips) 
Seat 6: v+QfkGiuj9bgtuNoVnDO8w ($28.50 in chips) 
5tB0F9NjPSUL4FzmzBMs2Q: posts small blind $0.10
eSKnWz2RD4rvwnvB+rFzIg: posts big blind $0.25
*** HOLE CARDS ***
8ClCHtFXGNplITm+63KB+Q: folds 
v+QfkGiuj9bgtuNoVnDO8w: folds 
I1TxPvWj8NfG8orglCinNA: folds 
5tB0F9NjPSUL4FzmzBMs2Q: raises $0.75 to $1
eSKnWz2RD4rvwnvB+rFzIg: folds 
Uncalled bet ($0.75) returned to 5tB0F9NjPSUL4FzmzBMs2Q
5tB0F9NjPSUL4FzmzBMs2Q collected $0.50 from pot
5tB0F9NjPSUL4FzmzBMs2Q: doesn't show hand 
*** SUMMARY ***
Total pot $0.50 | Rake $0 
Seat 1: I1TxPvWj8NfG8orglCinNA (button) folded before Flop (didn't bet)
Seat 2: 5tB0F9NjPSUL4FzmzBMs2Q (small blind) collected ($0.50)
Seat 3: eSKnWz2RD4rvwnvB+rFzIg (big blind) folded before Flop
Seat 5: 8ClCHtFXGNplITm+63KB+Q folded before Flop (didn't bet)
Seat 6: v+QfkGiuj9bgtuNoVnDO8w folded before Flop (didn't bet)




PokerStars Game #59939739170:  Hold'em No Limit ($0.10/$0.25) - 2009/07/01 0:47:40 ET
Table 'dNYnr4D4id1jwnEU66Yowg' 9-max Seat #2 is the button
Seat 1: 41pZ+Uce9oq+8wmcVBXWIg ($19.50 in chips) 
Seat 2: +twYdIw+izmdFyX5TTFzjg ($15.80 in chips) 
Seat 4: d9fERE+24v0MqnylCrXchQ ($8.65 in chips) 
Seat 6: Lu6miJBtf3FVzUdzCWEtqQ ($17 in chips) 
Seat 8: sv2dZaqHRlfCDrW63Guhvg ($5.10 in chips) 
d9fERE+24v0MqnylCrXchQ: posts small blind $0.10
Lu6miJBtf3FVzUdzCWEtqQ: posts big blind $0.25
*** HOLE CARDS ***
sv2dZaqHRlfCDrW63Guhvg: folds 
41pZ+Uce9oq+8wmcVBXWIg: calls $0.25
+twYdIw+izmdFyX5TTFzjg: folds 
d9fERE+24v0MqnylCrXchQ: raises $0.25 to $0.50
Lu6miJBtf3FVzUdzCWEtqQ: calls $0.25
41pZ+Uce9oq+8wmcVBXWIg: calls $0.25
*** FLOP *** [5h 7d 8c]
d9fERE+24v0MqnylCrXchQ: checks 
hIss79a4pu7GzJZepfgOpg joins the table at seat #3 
Lu6miJBtf3FVzUdzCWEtqQ: checks 
DiSvPC2iudwL5j9u6Huyww joins the table at seat #7 
41pZ+Uce9oq+8wmcVBXWIg: checks 
*** TURN *** [5h 7d 8c] [Ah]
d9fERE+24v0MqnylCrXchQ: checks 
Lu6miJBtf3FVzUdzCWEtqQ: bets $1
41pZ+Uce9oq+8wmcVBXWIg: folds 
d9fERE+24v0MqnylCrXchQ: folds 
Uncalled bet ($1) returned to Lu6miJBtf3FVzUdzCWEtqQ
Lu6miJBtf3FVzUdzCWEtqQ collected $1.45 from pot
Lu6miJBtf3FVzUdzCWEtqQ: doesn't show hand 
*** SUMMARY ***
Total pot $1.50 | Rake $0.05 
Board [5h 7d 8c Ah]
Seat 1: 41pZ+Uce9oq+8wmcVBXWIg folded on the Turn
Seat 2: +twYdIw+izmdFyX5TTFzjg (button) folded before Flop (didn't bet)
Seat 4: d9fERE+24v0MqnylCrXchQ (small blind) folded on the Turn
Seat 6: Lu6miJBtf3FVzUdzCWEtqQ (big blind) collected ($1.45)
Seat 8: sv2dZaqHRlfCDrW63Guhvg folded before Flop (didn't bet)




PokerStars Game #59939738708:  Hold'em No Limit ($0.10/$0.25) - 2009/07/01 0:47:40 ET
Table 'CM/C/FZf3VHIp50RjmBucQ' 9-max Seat #8 is the button
Seat 1: 1Clf3cPrqoy/YgvWdWK1Xw ($5 in chips) 
Seat 2: 1S/fpm+f42V/6MNZre+ccg ($30.10 in chips) 
Seat 3: dfNim92Z6XK1/h5SFW5vDg ($29.40 in chips) 
Seat 4: jN7A9nKK4RYzhFj4MrekhA ($14 in chips) 
Seat 5: TeWJxSETzbXGiYKx0y+dtg ($38.30 in chips) 
Seat 6: Zo0U/uoOdOJx9sV/NiB2JA ($8.75 in chips) 
Seat 7: j4q3p0lesp63b1gZDwLBZw ($5 in chips) 
Seat 8: cZ99hugmLBj9KhTlc8nCSw ($25.80 in chips) 
1Clf3cPrqoy/YgvWdWK1Xw: posts small blind $0.10
1S/fpm+f42V/6MNZre+ccg: posts big blind $0.25
*** HOLE CARDS ***
dfNim92Z6XK1/h5SFW5vDg: folds 
jN7A9nKK4RYzhFj4MrekhA: folds 
TeWJxSETzbXGiYKx0y+dtg: folds 
Zo0U/uoOdOJx9sV/NiB2JA: calls $0.25
j4q3p0lesp63b1gZDwLBZw: folds 
cZ99hugmLBj9KhTlc8nCSw: folds 
USA Cobra joins the table at seat #9 
1Clf3cPrqoy/YgvWdWK1Xw: folds 
1S/fpm+f42V/6MNZre+ccg: checks 
*** FLOP *** [Jh Qh 2d]
1S/fpm+f42V/6MNZre+ccg: checks 
Zo0U/uoOdOJx9sV/NiB2JA: checks 
*** TURN *** [Jh Qh 2d] [Th]
1S/fpm+f42V/6MNZre+ccg: checks 
Zo0U/uoOdOJx9sV/NiB2JA: checks 
*** RIVER *** [Jh Qh 2d Th] [8h]
1S/fpm+f42V/6MNZre+ccg: checks 
Zo0U/uoOdOJx9sV/NiB2JA: bets $0.50
1S/fpm+f42V/6MNZre+ccg: folds 
Uncalled bet ($0.50) returned to Zo0U/uoOdOJx9sV/NiB2JA
Zo0U/uoOdOJx9sV/NiB2JA collected $0.60 from pot
Zo0U/uoOdOJx9sV/NiB2JA: doesn't show hand 
*** SUMMARY ***
Total pot $0.60 | Rake $0 
Board [Jh Qh 2d Th 8h]
Seat 1: 1Clf3cPrqoy/YgvWdWK1Xw (small blind) folded before Flop
Seat 2: 1S/fpm+f42V/6MNZre+ccg (big blind) folded on the River
Seat 3: dfNim92Z6XK1/h5SFW5vDg folded before Flop (didn't bet)
Seat 4: jN7A9nKK4RYzhFj4MrekhA folded before Flop (didn't bet)
Seat 5: TeWJxSETzbXGiYKx0y+dtg folded before Flop (didn't bet)
Seat 6: Zo0U/uoOdOJx9sV/NiB2JA collected ($0.60)
Seat 7: j4q3p0lesp63b1gZDwLBZw folded before Flop (didn't bet)
Seat 8: cZ99hugmLBj9KhTlc8nCSw (button) folded before Flop (didn't bet)




PokerStars Game #59939739576:  Hold'em No Limit ($0.10/$0.25) - 2009/07/01 0:47:41 ET
Table 'D1Yq70l0nNCyMV6DA42p+Q' 9-max Seat #5 is the button
Seat 1: z5GxcHlYz/GSz6W2uFiTtg ($21.15 in chips) 
Seat 2: OB0uLxxDeISeDjs0cxaocA ($27.25 in chips) 
Seat 3: j4q3p0lesp63b1gZDwLBZw ($5 in chips) 
Seat 4: VWUWpMLMj/Q1jRVpF7Aohw ($15 in chips) 
Seat 5: gehe91e0IyVT0QU/XBkEyg ($25 in chips) 
Seat 7: 9mw49/JQZ9pj0wFynA329g ($11.95 in chips) 
Seat 8: zDrucyjVn5aeekNEc3cJrA ($24.70 in chips) 
Seat 9: AzwEspKch0yAWegVxdcE9A ($4.75 in chips) 
Mr_GlamoRouS will be allowed to play after the button
9mw49/JQZ9pj0wFynA329g: posts small blind $0.10
zDrucyjVn5aeekNEc3cJrA: posts big blind $0.25
VWUWpMLMj/Q1jRVpF7Aohw: posts big blind $0.25
*** HOLE CARDS ***
AzwEspKch0yAWegVxdcE9A: folds 
z5GxcHlYz/GSz6W2uFiTtg: calls $0.25
OB0uLxxDeISeDjs0cxaocA: calls $0.25
j4q3p0lesp63b1gZDwLBZw: raises $4.75 to $5 and is all-in
VWUWpMLMj/Q1jRVpF7Aohw: folds 
gehe91e0IyVT0QU/XBkEyg: folds 
9mw49/JQZ9pj0wFynA329g: folds 
zDrucyjVn5aeekNEc3cJrA: folds 
z5GxcHlYz/GSz6W2uFiTtg: folds 
OB0uLxxDeISeDjs0cxaocA: folds 
Uncalled bet ($4.75) returned to j4q3p0lesp63b1gZDwLBZw
j4q3p0lesp63b1gZDwLBZw collected $1.35 from pot
j4q3p0lesp63b1gZDwLBZw: doesn't show hand 
*** SUMMARY ***
Total pot $1.35 | Rake $0 
Seat 1: z5GxcHlYz/GSz6W2uFiTtg folded before Flop
Seat 2: OB0uLxxDeISeDjs0cxaocA folded before Flop
Seat 3: j4q3p0lesp63b1gZDwLBZw collected ($1.35)
Seat 4: VWUWpMLMj/Q1jRVpF7Aohw folded before Flop
Seat 5: gehe91e0IyVT0QU/XBkEyg (button) folded before Flop (didn't bet)
Seat 7: 9mw49/JQZ9pj0wFynA329g (small blind) folded before Flop
Seat 8: zDrucyjVn5aeekNEc3cJrA (big blind) folded before Flop
Seat 9: AzwEspKch0yAWegVxdcE9A folded before Flop (didn't bet)




PokerStars Game #59939739510:  Hold'em No Limit ($0.10/$0.25) - 2009/07/01 0:47:41 ET
Table 'h02LhQ7B/Zk4ETRxxHhGYA' 9-max Seat #4 is the button
Seat 1: sD+TKtt36XiiN6jqHiLwDA ($27.10 in chips) 
Seat 2: RJ/x9oZtt1RZLaJEQwZOxQ ($27.20 in chips) 
Seat 3: kqpa/IbqkUrwPb3hbA7/ww ($13.80 in chips) 
Seat 4: tYsOBqdU1+x+yFI7zHO7hQ ($37.85 in chips) 
Seat 5: cUxk0Jk4lrUQv9CJl0LPlg ($16.85 in chips) 
Seat 6: kN/irnQSdb8jibbN4f1O+Q ($19.30 in chips) 
Seat 7: rUpvA02nErFvZ4yFbDR8XA ($19.90 in chips) 
Seat 8: 7tW694tRVJnYdoa16Dw4RQ ($17.10 in chips) 
Seat 9: 1c/7DHPx5CDTmAfk8/bWeA ($15.90 in chips) 
cUxk0Jk4lrUQv9CJl0LPlg: posts small blind $0.10
kN/irnQSdb8jibbN4f1O+Q: posts big blind $0.25
*** HOLE CARDS ***
rUpvA02nErFvZ4yFbDR8XA: folds 
7tW694tRVJnYdoa16Dw4RQ: folds 
1c/7DHPx5CDTmAfk8/bWeA: folds 
sD+TKtt36XiiN6jqHiLwDA: folds 
RJ/x9oZtt1RZLaJEQwZOxQ: calls $0.25
kqpa/IbqkUrwPb3hbA7/ww: folds 
tYsOBqdU1+x+yFI7zHO7hQ: folds 
cUxk0Jk4lrUQv9CJl0LPlg: folds 
kN/irnQSdb8jibbN4f1O+Q: checks 
*** FLOP *** [8c 4c 3s]
kN/irnQSdb8jibbN4f1O+Q: checks 
RJ/x9oZtt1RZLaJEQwZOxQ: bets $0.50
kN/irnQSdb8jibbN4f1O+Q: calls $0.50
*** TURN *** [8c 4c 3s] [Jh]
kN/irnQSdb8jibbN4f1O+Q: checks 
RJ/x9oZtt1RZLaJEQwZOxQ: checks 
*** RIVER *** [8c 4c 3s Jh] [9d]
kN/irnQSdb8jibbN4f1O+Q: checks 
RJ/x9oZtt1RZLaJEQwZOxQ: checks 
*** SHOW DOWN ***
kN/irnQSdb8jibbN4f1O+Q: shows [8d 2s] (a pair of Eights)
RJ/x9oZtt1RZLaJEQwZOxQ: mucks hand 
kN/irnQSdb8jibbN4f1O+Q collected $1.55 from pot
*** SUMMARY ***
Total pot $1.60 | Rake $0.05 
Board [8c 4c 3s Jh 9d]
Seat 1: sD+TKtt36XiiN6jqHiLwDA folded before Flop (didn't bet)
Seat 2: RJ/x9oZtt1RZLaJEQwZOxQ mucked
Seat 3: kqpa/IbqkUrwPb3hbA7/ww folded before Flop (didn't bet)
Seat 4: tYsOBqdU1+x+yFI7zHO7hQ (button) folded before Flop (didn't bet)
Seat 5: cUxk0Jk4lrUQv9CJl0LPlg (small blind) folded before Flop
Seat 6: kN/irnQSdb8jibbN4f1O+Q (big blind) showed [8d 2s] and won ($1.55) with a pair of Eights
Seat 7: rUpvA02nErFvZ4yFbDR8XA folded before Flop (didn't bet)
Seat 8: 7tW694tRVJnYdoa16Dw4RQ folded before Flop (didn't bet)
Seat 9: 1c/7DHPx5CDTmAfk8/bWeA folded before Flop (didn't bet)




PokerStars Game #59939739492:  Hold'em No Limit ($0.10/$0.25) - 2009/07/01 0:47:41 ET
Table '2O5CgfSkSwrr4PDrlZ1RLQ' 6-max Seat #2 is the button
Seat 1: kyRaCIljYA6l33lSKQfNsg ($46.75 in chips) 
Seat 2: /gJNBeCkWL4o85/jvlZ4BA ($49.80 in chips) 
Seat 3: yzFNNFIfC89bBPwpFPx2ow ($25 in chips) 
Seat 4: 4x9jCqgSw4272dnaIqnanw ($10.30 in chips) 
Seat 5: AMrBn4Vx9aAo/vv6WHLk6w ($4.60 in chips) 
Seat 6: tj9xqoqQaDaFw7u1oyZrtA ($35.95 in chips) 
yzFNNFIfC89bBPwpFPx2ow: posts small blind $0.10
4x9jCqgSw4272dnaIqnanw: posts big blind $0.25
*** HOLE CARDS ***
AMrBn4Vx9aAo/vv6WHLk6w: raises $0.50 to $0.75
tj9xqoqQaDaFw7u1oyZrtA: folds 
kyRaCIljYA6l33lSKQfNsg: folds 
/gJNBeCkWL4o85/jvlZ4BA: folds 
yzFNNFIfC89bBPwpFPx2ow: folds 
4x9jCqgSw4272dnaIqnanw: folds 
Uncalled bet ($0.50) returned to AMrBn4Vx9aAo/vv6WHLk6w
AMrBn4Vx9aAo/vv6WHLk6w collected $0.60 from pot
*** SUMMARY ***
Total pot $0.60 | Rake $0 
Seat 1: kyRaCIljYA6l33lSKQfNsg folded before Flop (didn't bet)
Seat 2: /gJNBeCkWL4o85/jvlZ4BA (button) folded before Flop (didn't bet)
Seat 3: yzFNNFIfC89bBPwpFPx2ow (small blind) folded before Flop
Seat 4: 4x9jCqgSw4272dnaIqnanw (big blind) folded before Flop
Seat 5: AMrBn4Vx9aAo/vv6WHLk6w collected ($0.60)
Seat 6: tj9xqoqQaDaFw7u1oyZrtA folded before Flop (didn't bet)




PokerStars Game #59939739400:  Hold'em No Limit ($0.10/$0.25) - 2009/07/01 0:47:41 ET
Table 'NgexmgEDEzICBeSO7YCrKQ' 6-max Seat #3 is the button
Seat 1: oseFhpinoe+Zg4j5xyBjyQ ($70.50 in chips) 
Seat 2: 32YL2ZEp8NT4JB2RVM9euQ ($15.65 in chips) 
Seat 3: JFIAqU8lCZ0vWwEl4bdGsg ($27.05 in chips) 
Seat 4: xx+iYCDJhHJmNzrfeloyEg ($38.35 in chips) 
Seat 5: /MXkdT8TTs8Qp2LVTQNw6w ($46.90 in chips) 
Seat 6: k9nHZTHt8hYhYRcW8NTb4g ($9.65 in chips) 
xx+iYCDJhHJmNzrfeloyEg: posts small blind $0.10
/MXkdT8TTs8Qp2LVTQNw6w: posts big blind $0.25
*** HOLE CARDS ***
k9nHZTHt8hYhYRcW8NTb4g: raises $0.50 to $0.75
oseFhpinoe+Zg4j5xyBjyQ: folds 
32YL2ZEp8NT4JB2RVM9euQ: folds 
JFIAqU8lCZ0vWwEl4bdGsg: folds 
xx+iYCDJhHJmNzrfeloyEg: calls $0.65
/MXkdT8TTs8Qp2LVTQNw6w: folds 
*** FLOP *** [9d 3h 3s]
xx+iYCDJhHJmNzrfeloyEg: bets $0.75
k9nHZTHt8hYhYRcW8NTb4g: calls $0.75
*** TURN *** [9d 3h 3s] [8d]
xx+iYCDJhHJmNzrfeloyEg: bets $2
k9nHZTHt8hYhYRcW8NTb4g: raises $6.15 to $8.15 and is all-in
xx+iYCDJhHJmNzrfeloyEg: folds 
Uncalled bet ($6.15) returned to k9nHZTHt8hYhYRcW8NTb4g
xx+iYCDJhHJmNzrfeloyEg said, "  And frequently, somebody already has 2 of them"
k9nHZTHt8hYhYRcW8NTb4g collected $6.90 from pot
k9nHZTHt8hYhYRcW8NTb4g: doesn't show hand 
*** SUMMARY ***
Total pot $7.25 | Rake $0.35 
Board [9d 3h 3s 8d]
Seat 1: oseFhpinoe+Zg4j5xyBjyQ folded before Flop (didn't bet)
Seat 2: 32YL2ZEp8NT4JB2RVM9euQ folded before Flop (didn't bet)
Seat 3: JFIAqU8lCZ0vWwEl4bdGsg (button) folded before Flop (didn't bet)
Seat 4: xx+iYCDJhHJmNzrfeloyEg (small blind) folded on the Turn
Seat 5: /MXkdT8TTs8Qp2LVTQNw6w (big blind) folded before Flop
Seat 6: k9nHZTHt8hYhYRcW8NTb4g collected ($6.90)




PokerStars Game #59939739836:  Hold'em No Limit ($0.10/$0.25) - 2009/07/01 0:47:41 ET
Table 'AHkg4ChqzcMauBx6Qvz8Nw' 6-max Seat #2 is the button
Seat 1: 4kWQxGbT5FZ1dkPd1bE45Q ($25.35 in chips) 
Seat 2: /bjna2FTN7pPjqYGzmDE0Q ($23.55 in chips) 
Seat 3: wvIIdlbCgePONQwXjx9xzQ ($5.35 in chips) 
Seat 4: N7O9jUEx2YiQn1+yRYTHmw ($40.20 in chips) 
Seat 5: LtASJ9OlkqGrrUKGQlpGAw ($36.35 in chips) 
Seat 6: SFmT9ZsVopnukjvAzrxTRg ($54.20 in chips) 
wvIIdlbCgePONQwXjx9xzQ: posts small blind $0.10
N7O9jUEx2YiQn1+yRYTHmw: posts big blind $0.25
*** HOLE CARDS ***
LtASJ9OlkqGrrUKGQlpGAw: folds 
SFmT9ZsVopnukjvAzrxTRg: folds 
4kWQxGbT5FZ1dkPd1bE45Q: folds 
/bjna2FTN7pPjqYGzmDE0Q: calls $0.25
wvIIdlbCgePONQwXjx9xzQ: calls $0.15
N7O9jUEx2YiQn1+yRYTHmw: checks 
*** FLOP *** [Kc Qc Ac]
wvIIdlbCgePONQwXjx9xzQ: checks 
N7O9jUEx2YiQn1+yRYTHmw: checks 
/bjna2FTN7pPjqYGzmDE0Q: bets $0.50
wvIIdlbCgePONQwXjx9xzQ: folds 
N7O9jUEx2YiQn1+yRYTHmw: calls $0.50
*** TURN *** [Kc Qc Ac] [9s]
N7O9jUEx2YiQn1+yRYTHmw: checks 
/bjna2FTN7pPjqYGzmDE0Q: checks 
*** RIVER *** [Kc Qc Ac 9s] [7c]
N7O9jUEx2YiQn1+yRYTHmw: bets $0.75
/bjna2FTN7pPjqYGzmDE0Q: calls $0.75
*** SHOW DOWN ***
N7O9jUEx2YiQn1+yRYTHmw: shows [Ks Jd] (a pair of Kings)
/bjna2FTN7pPjqYGzmDE0Q: shows [Tc Kd] (a flush, Ace high)
/bjna2FTN7pPjqYGzmDE0Q collected $3.10 from pot
*** SUMMARY ***
Total pot $3.25 | Rake $0.15 
Board [Kc Qc Ac 9s 7c]
Seat 1: 4kWQxGbT5FZ1dkPd1bE45Q folded before Flop (didn't bet)
Seat 2: /bjna2FTN7pPjqYGzmDE0Q (button) showed [Tc Kd] and won ($3.10) with a flush, Ace high
Seat 3: wvIIdlbCgePONQwXjx9xzQ (small blind) folded on the Flop
Seat 4: N7O9jUEx2YiQn1+yRYTHmw (big blind) showed [Ks Jd] and lost with a pair of Kings
Seat 5: LtASJ9OlkqGrrUKGQlpGAw folded before Flop (didn't bet)
Seat 6: SFmT9ZsVopnukjvAzrxTRg folded before Flop (didn't bet)




PokerStars Game #59939739714:  Hold'em No Limit ($0.10/$0.25) - 2009/07/01 0:47:41 ET
Table 'Mef6A0EMopL6WaFO5/KO9g' 6-max Seat #4 is the button
Seat 1: ELW+DKizJhLK7k40PMkD2Q ($25.25 in chips) 
Seat 2: 8ClCHtFXGNplITm+63KB+Q ($31.60 in chips) 
Seat 3: Wq26opBLDGJe91GRJn2epg ($21.65 in chips) 
Seat 4: lquriepNQBhDV5P1SWHhnA ($25 in chips) 
Seat 5: WrLI51S2iMb8GLMB83gGqA ($35.65 in chips) 
Seat 6: jp34e617tIzV8tKIWmfAbA ($25.35 in chips) 
WrLI51S2iMb8GLMB83gGqA: posts small blind $0.10
jp34e617tIzV8tKIWmfAbA: posts big blind $0.25
*** HOLE CARDS ***
ELW+DKizJhLK7k40PMkD2Q: folds 
8ClCHtFXGNplITm+63KB+Q: folds 
Wq26opBLDGJe91GRJn2epg: calls $0.25
lquriepNQBhDV5P1SWHhnA: folds 
WrLI51S2iMb8GLMB83gGqA: folds 
jp34e617tIzV8tKIWmfAbA: checks 
*** FLOP *** [4d 7c Jh]
jp34e617tIzV8tKIWmfAbA: checks 
Wq26opBLDGJe91GRJn2epg: bets $0.75
jp34e617tIzV8tKIWmfAbA: folds 
Uncalled bet ($0.75) returned to Wq26opBLDGJe91GRJn2epg
Wq26opBLDGJe91GRJn2epg collected $0.60 from pot
*** SUMMARY ***
Total pot $0.60 | Rake $0 
Board [4d 7c Jh]
Seat 1: ELW+DKizJhLK7k40PMkD2Q folded before Flop (didn't bet)
Seat 2: 8ClCHtFXGNplITm+63KB+Q folded before Flop (didn't bet)
Seat 3: Wq26opBLDGJe91GRJn2epg collected ($0.60)
Seat 4: lquriepNQBhDV5P1SWHhnA (button) folded before Flop (didn't bet)
Seat 5: WrLI51S2iMb8GLMB83gGqA (small blind) folded before Flop
Seat 6: jp34e617tIzV8tKIWmfAbA (big blind) folded on the Flop




PokerStars Game #59939740226:  Hold'em No Limit ($0.10/$0.25) - 2009/07/01 0:47:42 ET
Table '+198VWQSWBhYQOcizzuBkw' 6-max Seat #4 is the button
Seat 1: 9wWOoS2QEhCmOCt1GOwBKA ($5.20 in chips) 
Seat 2: R6AGToFJQOYVZAjC2jXEKw ($23.15 in chips) 
Seat 3: BYxjLnV1/LL0aZcTbfAOvw ($27.50 in chips) 
Seat 4: TgDsTeCdLQt8kWbL00ByRA ($32.50 in chips) 
Seat 5: LtASJ9OlkqGrrUKGQlpGAw ($29.45 in chips) 
Seat 6: 7qRk4YH4/k/08LgJSv7rBQ ($31.60 in chips) 
LtASJ9OlkqGrrUKGQlpGAw: posts small blind $0.10
7qRk4YH4/k/08LgJSv7rBQ: posts big blind $0.25
*** HOLE CARDS ***
9wWOoS2QEhCmOCt1GOwBKA: raises $0.25 to $0.50
R6AGToFJQOYVZAjC2jXEKw: calls $0.50
BYxjLnV1/LL0aZcTbfAOvw: folds 
TgDsTeCdLQt8kWbL00ByRA: calls $0.50
LtASJ9OlkqGrrUKGQlpGAw: folds 
7qRk4YH4/k/08LgJSv7rBQ: folds 
*** FLOP *** [9h 5d 2d]
9wWOoS2QEhCmOCt1GOwBKA: bets $0.50
R6AGToFJQOYVZAjC2jXEKw: calls $0.50
TgDsTeCdLQt8kWbL00ByRA: calls $0.50
*** TURN *** [9h 5d 2d] [4d]
9wWOoS2QEhCmOCt1GOwBKA: bets $0.25
R6AGToFJQOYVZAjC2jXEKw: calls $0.25
TgDsTeCdLQt8kWbL00ByRA: calls $0.25
*** RIVER *** [9h 5d 2d 4d] [Ad]
9wWOoS2QEhCmOCt1GOwBKA: bets $1
R6AGToFJQOYVZAjC2jXEKw: calls $1
TgDsTeCdLQt8kWbL00ByRA: folds 
*** SHOW DOWN ***
9wWOoS2QEhCmOCt1GOwBKA: shows [Qs Jd] (a flush, Ace high)
R6AGToFJQOYVZAjC2jXEKw: mucks hand 
9wWOoS2QEhCmOCt1GOwBKA collected $5.85 from pot
*** SUMMARY ***
Total pot $6.10 | Rake $0.25 
Board [9h 5d 2d 4d Ad]
Seat 1: 9wWOoS2QEhCmOCt1GOwBKA showed [Qs Jd] and won ($5.85) with a flush, Ace high
Seat 2: R6AGToFJQOYVZAjC2jXEKw mucked
Seat 3: BYxjLnV1/LL0aZcTbfAOvw folded before Flop (didn't bet)
Seat 4: TgDsTeCdLQt8kWbL00ByRA (button) folded on the River
Seat 5: LtASJ9OlkqGrrUKGQlpGAw (small blind) folded before Flop
Seat 6: 7qRk4YH4/k/08LgJSv7rBQ (big blind) folded before Flop




PokerStars Game #59939740462:  Hold'em No Limit ($0.10/$0.25) - 2009/07/01 0:47:42 ET
Table '9L7XfAwuM7XsXE8LIg2o5Q' 6-max Seat #3 is the button
Seat 1: H6XbZVba2aKDXlG0la0uow ($5.40 in chips) 
Seat 2: oseFhpinoe+Zg4j5xyBjyQ ($16.60 in chips) 
Seat 3: JRODJ0tkruzJ7hwOFO9ogg ($4.65 in chips) 
Seat 4: jp34e617tIzV8tKIWmfAbA ($26.50 in chips) 
Seat 5: OUv909q/YxsJgxpSlZxLJQ ($25 in chips) 
Seat 6: k9nHZTHt8hYhYRcW8NTb4g ($30.40 in chips) 
jp34e617tIzV8tKIWmfAbA: posts small blind $0.10
OUv909q/YxsJgxpSlZxLJQ: posts big blind $0.25
*** HOLE CARDS ***
k9nHZTHt8hYhYRcW8NTb4g: raises $0.50 to $0.75
H6XbZVba2aKDXlG0la0uow: raises $1.25 to $2
oseFhpinoe+Zg4j5xyBjyQ: folds 
JRODJ0tkruzJ7hwOFO9ogg: folds 
jp34e617tIzV8tKIWmfAbA: folds 
OUv909q/YxsJgxpSlZxLJQ: folds 
k9nHZTHt8hYhYRcW8NTb4g: raises $28.40 to $30.40 and is all-in
H6XbZVba2aKDXlG0la0uow: calls $3.40 and is all-in
Uncalled bet ($25) returned to k9nHZTHt8hYhYRcW8NTb4g
*** FLOP *** [Jc 7h 2s]
*** TURN *** [Jc 7h 2s] [6h]
*** RIVER *** [Jc 7h 2s 6h] [5d]
*** SHOW DOWN ***
k9nHZTHt8hYhYRcW8NTb4g: shows [8s 8d] (a pair of Eights)
H6XbZVba2aKDXlG0la0uow: shows [Jh Qc] (a pair of Jacks)
H6XbZVba2aKDXlG0la0uow collected $10.60 from pot
*** SUMMARY ***
Total pot $11.15 | Rake $0.55 
Board [Jc 7h 2s 6h 5d]
Seat 1: H6XbZVba2aKDXlG0la0uow showed [Jh Qc] and won ($10.60) with a pair of Jacks
Seat 2: oseFhpinoe+Zg4j5xyBjyQ folded before Flop (didn't bet)
Seat 3: JRODJ0tkruzJ7hwOFO9ogg (button) folded before Flop (didn't bet)
Seat 4: jp34e617tIzV8tKIWmfAbA (small blind) folded before Flop
Seat 5: OUv909q/YxsJgxpSlZxLJQ (big blind) folded before Flop
Seat 6: k9nHZTHt8hYhYRcW8NTb4g showed [8s 8d] and lost with a pair of Eights




PokerStars Game #59939740030:  Hold'em No Limit ($0.10/$0.25) - 2009/07/01 0:47:42 ET
Table 'NtEQAxCeIK2io1CGtW658g' 6-max Seat #1 is the button
Seat 1: lnOV7k25gyN7L5t5YKTgIg ($17.65 in chips) 
Seat 2: nc79pm0LZRdhncq55evVqA ($26.55 in chips) 
Seat 3: m2yWOKfAxqHoy5DDN87Ttw ($23.40 in chips) 
Seat 4: 8296 ($12.05 in chips) 
Seat 5: FStoHe64SQWqAsjya9pDkQ ($25.60 in chips) 
Seat 6: /gJNBeCkWL4o85/jvlZ4BA ($67.70 in chips) 
nc79pm0LZRdhncq55evVqA: posts small blind $0.10
m2yWOKfAxqHoy5DDN87Ttw: posts big blind $0.25
*** HOLE CARDS ***
8296: calls $0.25
FStoHe64SQWqAsjya9pDkQ: folds 
/gJNBeCkWL4o85/jvlZ4BA: folds 
lnOV7k25gyN7L5t5YKTgIg: folds 
nc79pm0LZRdhncq55evVqA: folds 
m2yWOKfAxqHoy5DDN87Ttw: checks 
*** FLOP *** [5h 8d Kc]
m2yWOKfAxqHoy5DDN87Ttw: checks 
8296: checks 
*** TURN *** [5h 8d Kc] [3d]
m2yWOKfAxqHoy5DDN87Ttw: bets $0.50
8296: calls $0.50
*** RIVER *** [5h 8d Kc 3d] [9d]
m2yWOKfAxqHoy5DDN87Ttw: bets $1
8296: folds 
Uncalled bet ($1) returned to m2yWOKfAxqHoy5DDN87Ttw
m2yWOKfAxqHoy5DDN87Ttw collected $1.55 from pot
m2yWOKfAxqHoy5DDN87Ttw: doesn't show hand 
*** SUMMARY ***
Total pot $1.60 | Rake $0.05 
Board [5h 8d Kc 3d 9d]
Seat 1: lnOV7k25gyN7L5t5YKTgIg (button) folded before Flop (didn't bet)
Seat 2: nc79pm0LZRdhncq55evVqA (small blind) folded before Flop
Seat 3: m2yWOKfAxqHoy5DDN87Ttw (big blind) collected ($1.55)
Seat 4: 8296 folded on the River
Seat 5: FStoHe64SQWqAsjya9pDkQ folded before Flop (didn't bet)
Seat 6: /gJNBeCkWL4o85/jvlZ4BA folded before Flop (didn't bet)




PokerStars Game #59939740404:  Hold'em No Limit ($0.10/$0.25) - 2009/07/01 0:47:42 ET
Table 'Xi38lWH8L2JHRAsKYVX8Qg' 6-max Seat #2 is the button
Seat 1: AqQ7DFpHkgIzTwDu+rClcg ($5.40 in chips) 
Seat 2: 7iL6KfkJTFbyWmnLYk4+AA ($32.05 in chips) 
Seat 3: 6DwBRH+xZ12AAZmeAg+aXw ($25 in chips) 
Seat 4: kG34n23qFQA3nzdOJTQ1dA ($25.80 in chips) 
Seat 5: 79ID/ub1Pt/mDpCprVmOoA ($25.75 in chips) 
Seat 6: aogAb4Eienxztk8p2v9VVw ($24.75 in chips) 
6DwBRH+xZ12AAZmeAg+aXw: posts small blind $0.10
kG34n23qFQA3nzdOJTQ1dA: posts big blind $0.25
*** HOLE CARDS ***
79ID/ub1Pt/mDpCprVmOoA: folds 
aogAb4Eienxztk8p2v9VVw: folds 
AqQ7DFpHkgIzTwDu+rClcg: raises $0.50 to $0.75
7iL6KfkJTFbyWmnLYk4+AA: calls $0.75
6DwBRH+xZ12AAZmeAg+aXw: folds 
kG34n23qFQA3nzdOJTQ1dA: folds 
*** FLOP *** [5h 9s 6c]
AqQ7DFpHkgIzTwDu+rClcg: bets $1.50
7iL6KfkJTFbyWmnLYk4+AA: calls $1.50
*** TURN *** [5h 9s 6c] [7c]
AqQ7DFpHkgIzTwDu+rClcg: checks 
7iL6KfkJTFbyWmnLYk4+AA: checks 
*** RIVER *** [5h 9s 6c 7c] [Ah]
AqQ7DFpHkgIzTwDu+rClcg: bets $3.15 and is all-in
7iL6KfkJTFbyWmnLYk4+AA: folds 
Uncalled bet ($3.15) returned to AqQ7DFpHkgIzTwDu+rClcg
AqQ7DFpHkgIzTwDu+rClcg collected $4.65 from pot
*** SUMMARY ***
Total pot $4.85 | Rake $0.20 
Board [5h 9s 6c 7c Ah]
Seat 1: AqQ7DFpHkgIzTwDu+rClcg collected ($4.65)
Seat 2: 7iL6KfkJTFbyWmnLYk4+AA (button) folded on the River
Seat 3: 6DwBRH+xZ12AAZmeAg+aXw (small blind) folded before Flop
Seat 4: kG34n23qFQA3nzdOJTQ1dA (big blind) folded before Flop
Seat 5: 79ID/ub1Pt/mDpCprVmOoA folded before Flop (didn't bet)
Seat 6: aogAb4Eienxztk8p2v9VVw folded before Flop (didn't bet)




PokerStars Game #59939740034:  Hold'em No Limit ($0.10/$0.25) - 2009/07/01 0:47:42 ET
Table 'vFZR6Kf2Th5xBXT9brGW6A' 6-max Seat #3 is the button
Seat 1: xRkU4+naLuz7dEZFbOn9cw ($29.25 in chips) 
Seat 3: wUwfsTnmpHcWa17qFlQr1Q ($5.10 in chips) 
Seat 4: 79ID/ub1Pt/mDpCprVmOoA ($25.65 in chips) 
Seat 5: NhUN/JpAprdJeamFBgJH1w ($31.65 in chips) 
Seat 6: d0J1xuhsynEY81YHwAvJ5g ($29.75 in chips) 
79ID/ub1Pt/mDpCprVmOoA: posts small blind $0.10
NhUN/JpAprdJeamFBgJH1w: posts big blind $0.25
*** HOLE CARDS ***
d0J1xuhsynEY81YHwAvJ5g: folds 
xRkU4+naLuz7dEZFbOn9cw: folds 
wUwfsTnmpHcWa17qFlQr1Q: folds 
79ID/ub1Pt/mDpCprVmOoA: raises $0.50 to $0.75
NhUN/JpAprdJeamFBgJH1w: calls $0.50
*** FLOP *** [9h 9s 8d]
79ID/ub1Pt/mDpCprVmOoA: bets $1
NhUN/JpAprdJeamFBgJH1w: calls $1
*** TURN *** [9h 9s 8d] [Kh]
79ID/ub1Pt/mDpCprVmOoA: checks 
NhUN/JpAprdJeamFBgJH1w: checks 
*** RIVER *** [9h 9s 8d Kh] [Kc]
79ID/ub1Pt/mDpCprVmOoA: bets $5
NhUN/JpAprdJeamFBgJH1w: calls $5
*** SHOW DOWN ***
79ID/ub1Pt/mDpCprVmOoA: shows [Kd Ad] (a full house, Kings full of Nines)
NhUN/JpAprdJeamFBgJH1w: mucks hand 
79ID/ub1Pt/mDpCprVmOoA collected $12.85 from pot
*** SUMMARY ***
Total pot $13.50 | Rake $0.65 
Board [9h 9s 8d Kh Kc]
Seat 1: xRkU4+naLuz7dEZFbOn9cw folded before Flop (didn't bet)
Seat 3: wUwfsTnmpHcWa17qFlQr1Q (button) folded before Flop (didn't bet)
Seat 4: 79ID/ub1Pt/mDpCprVmOoA (small blind) showed [Kd Ad] and won ($12.85) with a full house, Kings full of Nines
Seat 5: NhUN/JpAprdJeamFBgJH1w (big blind) mucked
Seat 6: d0J1xuhsynEY81YHwAvJ5g folded before Flop (didn't bet)




PokerStars Game #59939740198:  Hold'em No Limit ($0.10/$0.25) - 2009/07/01 0:47:42 ET
Table '/JJyyIstHfkT7t/bW+WXgg' 6-max Seat #5 is the button
Seat 1: wsP46AGpqDjHZQmlRHKa9g ($25.05 in chips) 
Seat 3: oc4ZGs0W+3RIg2yPyJw3ig ($25.85 in chips) 
Seat 4: ELW+DKizJhLK7k40PMkD2Q ($24.90 in chips) 
Seat 5: 2wkoolB4YxxVC2x99F9rcA ($32.10 in chips) 
Seat 6: d338A2rm6NtA1ECEZi4d2g ($15.40 in chips) 
d338A2rm6NtA1ECEZi4d2g: posts small blind $0.10
wsP46AGpqDjHZQmlRHKa9g: posts big blind $0.25
BYxjLnV1/LL0aZcTbfAOvw: sits out 
*** HOLE CARDS ***
oc4ZGs0W+3RIg2yPyJw3ig: folds 
ELW+DKizJhLK7k40PMkD2Q: folds 
2wkoolB4YxxVC2x99F9rcA: folds 
d338A2rm6NtA1ECEZi4d2g: folds 
Uncalled bet ($0.15) returned to wsP46AGpqDjHZQmlRHKa9g
wsP46AGpqDjHZQmlRHKa9g collected $0.20 from pot
*** SUMMARY ***
Total pot $0.20 | Rake $0 
Seat 1: wsP46AGpqDjHZQmlRHKa9g (big blind) collected ($0.20)
Seat 3: oc4ZGs0W+3RIg2yPyJw3ig folded before Flop (didn't bet)
Seat 4: ELW+DKizJhLK7k40PMkD2Q folded before Flop (didn't bet)
Seat 5: 2wkoolB4YxxVC2x99F9rcA (button) folded before Flop (didn't bet)
Seat 6: d338A2rm6NtA1ECEZi4d2g (small blind) folded before Flop




PokerStars Game #59939740132:  Hold'em No Limit ($0.10/$0.25) - 2009/07/01 0:47:42 ET
Table '8QBBaev+cI2i/r2H6ml/lg' 9-max Seat #4 is the button
Seat 4: ZoG0obuajzVjwgd7lNHjgg ($3.85 in chips) 
Seat 6: cxE+szmvEUe7vE+z2ozM2Q ($11.10 in chips) 
ZoG0obuajzVjwgd7lNHjgg: posts small blind $0.10
cxE+szmvEUe7vE+z2ozM2Q: posts big blind $0.25
*** HOLE CARDS ***
ZoG0obuajzVjwgd7lNHjgg: folds 
Uncalled bet ($0.15) returned to cxE+szmvEUe7vE+z2ozM2Q
cxE+szmvEUe7vE+z2ozM2Q collected $0.20 from pot
*** SUMMARY ***
Total pot $0.20 | Rake $0 
Seat 4: ZoG0obuajzVjwgd7lNHjgg (button) (small blind) folded before Flop
Seat 6: cxE+szmvEUe7vE+z2ozM2Q (big blind) collected ($0.20)




PokerStars Game #59939739932:  Hold'em No Limit ($0.10/$0.25) - 2009/07/01 0:47:42 ET
Table 'gYBWJG3hEuJg6kphY0yhMg' 9-max Seat #8 is the button
Seat 1: s7Q6uNouhe7aE8JdFb9E+A ($25 in chips) 
Seat 2: z2SmIaQ3+5n/eY1BN5HgPg ($29.15 in chips) 
Seat 3: OkWGxhGhDA0lvNLGWmJxug ($4 in chips) 
Seat 4: V6p0jQ/RhUsqpHLmXvEX4Q ($13.35 in chips) 
Seat 5: +sbyWwIcFp9kP0bDtMegfQ ($24.30 in chips) 
Seat 6: 9AI+W5n0har4qZZPPHsjKg ($4.15 in chips) 
Seat 7: CvL9Ch1HYCVbTsfpNucitg ($4.65 in chips) 
Seat 8: j4q3p0lesp63b1gZDwLBZw ($5.25 in chips) 
Seat 9: DxA2S3LbITR502Wya4qTnw ($2.45 in chips) 
DxA2S3LbITR502Wya4qTnw: posts small blind $0.10
s7Q6uNouhe7aE8JdFb9E+A: posts big blind $0.25
*** HOLE CARDS ***
z2SmIaQ3+5n/eY1BN5HgPg: folds 
OkWGxhGhDA0lvNLGWmJxug: folds 
V6p0jQ/RhUsqpHLmXvEX4Q: raises $0.75 to $1
+sbyWwIcFp9kP0bDtMegfQ: folds 
9AI+W5n0har4qZZPPHsjKg: folds 
CvL9Ch1HYCVbTsfpNucitg: folds 
j4q3p0lesp63b1gZDwLBZw: folds 
DxA2S3LbITR502Wya4qTnw: raises $1.45 to $2.45 and is all-in
s7Q6uNouhe7aE8JdFb9E+A: folds 
V6p0jQ/RhUsqpHLmXvEX4Q: calls $1.45
*** FLOP *** [Qh 8h 6h]
*** TURN *** [Qh 8h 6h] [3h]
*** RIVER *** [Qh 8h 6h 3h] [2s]
*** SHOW DOWN ***
DxA2S3LbITR502Wya4qTnw: shows [Jd Ah] (a flush, Ace high)
V6p0jQ/RhUsqpHLmXvEX4Q: mucks hand 
DxA2S3LbITR502Wya4qTnw collected $4.90 from pot
*** SUMMARY ***
Total pot $5.15 | Rake $0.25 
Board [Qh 8h 6h 3h 2s]
Seat 1: s7Q6uNouhe7aE8JdFb9E+A (big blind) folded before Flop
Seat 2: z2SmIaQ3+5n/eY1BN5HgPg folded before Flop (didn't bet)
Seat 3: OkWGxhGhDA0lvNLGWmJxug folded before Flop (didn't bet)
Seat 4: V6p0jQ/RhUsqpHLmXvEX4Q mucked
Seat 5: +sbyWwIcFp9kP0bDtMegfQ folded before Flop (didn't bet)
Seat 6: 9AI+W5n0har4qZZPPHsjKg folded before Flop (didn't bet)
Seat 7: CvL9Ch1HYCVbTsfpNucitg folded before Flop (didn't bet)
Seat 8: j4q3p0lesp63b1gZDwLBZw (button) folded before Flop (didn't bet)
Seat 9: DxA2S3LbITR502Wya4qTnw (small blind) showed [Jd Ah] and won ($4.90) with a flush, Ace high




PokerStars Game #59939739906:  Hold'em No Limit ($0.10/$0.25) - 2009/07/01 0:47:42 ET
Table 'ohAuixfiLOYDylNUG5mNUw' 9-max Seat #5 is the button
Seat 1: AtRN1hdV8HbL3X4XogDaLA ($38.55 in chips) 
Seat 2: yVwP/Nr5oXkAQp5dmdNUVQ ($25 in chips) 
Seat 3: HVKi9hnDyvzObpL08/OarQ ($25.90 in chips) 
Seat 4: jeKWRUkMaVn8rEUjnJKqpg ($25.95 in chips) 
Seat 5: wub1jsnHlpWmOX4uczVADA ($8.75 in chips) 
Seat 6: opOCI2p6kW0tINuVaAqmcQ ($25.35 in chips) 
Seat 7: aPRz/2GxbXANYpVsQO8pdQ ($25 in chips) 
Seat 8: ppMlNkhYgErlt4fuJO7ADA ($9.85 in chips) 
Seat 9: hIss79a4pu7GzJZepfgOpg ($25 in chips) 
opOCI2p6kW0tINuVaAqmcQ: posts small blind $0.10
aPRz/2GxbXANYpVsQO8pdQ: posts big blind $0.25
*** HOLE CARDS ***
ppMlNkhYgErlt4fuJO7ADA: folds 
hIss79a4pu7GzJZepfgOpg: folds 
AtRN1hdV8HbL3X4XogDaLA: raises $0.50 to $0.75
yVwP/Nr5oXkAQp5dmdNUVQ: calls $0.75
HVKi9hnDyvzObpL08/OarQ: folds 
jeKWRUkMaVn8rEUjnJKqpg: folds 
wub1jsnHlpWmOX4uczVADA: folds 
opOCI2p6kW0tINuVaAqmcQ: folds 
aPRz/2GxbXANYpVsQO8pdQ: calls $0.50
*** FLOP *** [2h 7h 8c]
aPRz/2GxbXANYpVsQO8pdQ: checks 
AtRN1hdV8HbL3X4XogDaLA: checks 
yVwP/Nr5oXkAQp5dmdNUVQ: checks 
*** TURN *** [2h 7h 8c] [5s]
aPRz/2GxbXANYpVsQO8pdQ: checks 
AtRN1hdV8HbL3X4XogDaLA: checks 
yVwP/Nr5oXkAQp5dmdNUVQ: checks 
*** RIVER *** [2h 7h 8c 5s] [8s]
aPRz/2GxbXANYpVsQO8pdQ: bets $1.25
AtRN1hdV8HbL3X4XogDaLA: calls $1.25
yVwP/Nr5oXkAQp5dmdNUVQ: folds 
*** SHOW DOWN ***
aPRz/2GxbXANYpVsQO8pdQ: shows [3s Qs] (a pair of Eights)
AtRN1hdV8HbL3X4XogDaLA: shows [Kc As] (a pair of Eights - Ace kicker)
AtRN1hdV8HbL3X4XogDaLA collected $4.65 from pot
*** SUMMARY ***
Total pot $4.85 | Rake $0.20 
Board [2h 7h 8c 5s 8s]
Seat 1: AtRN1hdV8HbL3X4XogDaLA showed [Kc As] and won ($4.65) with a pair of Eights
Seat 2: yVwP/Nr5oXkAQp5dmdNUVQ folded on the River
Seat 3: HVKi9hnDyvzObpL08/OarQ folded before Flop (didn't bet)
Seat 4: jeKWRUkMaVn8rEUjnJKqpg folded before Flop (didn't bet)
Seat 5: wub1jsnHlpWmOX4uczVADA (button) folded before Flop (didn't bet)
Seat 6: opOCI2p6kW0tINuVaAqmcQ (small blind) folded before Flop
Seat 7: aPRz/2GxbXANYpVsQO8pdQ (big blind) showed [3s Qs] and lost with a pair of Eights
Seat 8: ppMlNkhYgErlt4fuJO7ADA folded before Flop (didn't bet)
Seat 9: hIss79a4pu7GzJZepfgOpg folded before Flop (didn't bet)




PokerStars Game #59939740134:  Hold'em No Limit ($0.10/$0.25) - 2009/07/01 0:47:42 ET
Table 'Of/T60zpXg1GcjrZ7Lm//Q' 9-max Seat #8 is the button
Seat 1: Lro4e37x4FUa5P3yzDjskw ($15.30 in chips) 
Seat 2: hIss79a4pu7GzJZepfgOpg ($25 in chips) 
Seat 3: jeKWRUkMaVn8rEUjnJKqpg ($27.50 in chips) 
Seat 4: Czut6V7acIqUJrrobjKAZg ($17.40 in chips) 
Seat 6: tYsOBqdU1+x+yFI7zHO7hQ ($25.90 in chips) 
Seat 7: s7Q6uNouhe7aE8JdFb9E+A ($34.60 in chips) 
Seat 8: ghNKXUBl/H+t83JF079ZBA ($30.90 in chips) 
Seat 9: TeWJxSETzbXGiYKx0y+dtg ($24.50 in chips) 
TeWJxSETzbXGiYKx0y+dtg: posts small blind $0.10
Lro4e37x4FUa5P3yzDjskw: posts big blind $0.25
*** HOLE CARDS ***
hIss79a4pu7GzJZepfgOpg: folds 
jeKWRUkMaVn8rEUjnJKqpg: raises $0.75 to $1
Czut6V7acIqUJrrobjKAZg: folds 
tYsOBqdU1+x+yFI7zHO7hQ: folds 
s7Q6uNouhe7aE8JdFb9E+A: folds 
ghNKXUBl/H+t83JF079ZBA: folds 
TeWJxSETzbXGiYKx0y+dtg: folds 
Lro4e37x4FUa5P3yzDjskw: folds 
Uncalled bet ($0.75) returned to jeKWRUkMaVn8rEUjnJKqpg
jeKWRUkMaVn8rEUjnJKqpg collected $0.60 from pot
jeKWRUkMaVn8rEUjnJKqpg: doesn't show hand 
*** SUMMARY ***
Total pot $0.60 | Rake $0 
Seat 1: Lro4e37x4FUa5P3yzDjskw (big blind) folded before Flop
Seat 2: hIss79a4pu7GzJZepfgOpg folded before Flop (didn't bet)
Seat 3: jeKWRUkMaVn8rEUjnJKqpg collected ($0.60)
Seat 4: Czut6V7acIqUJrrobjKAZg folded before Flop (didn't bet)
Seat 6: tYsOBqdU1+x+yFI7zHO7hQ folded before Flop (didn't bet)
Seat 7: s7Q6uNouhe7aE8JdFb9E+A folded before Flop (didn't bet)
Seat 8: ghNKXUBl/H+t83JF079ZBA (button) folded before Flop (didn't bet)
Seat 9: TeWJxSETzbXGiYKx0y+dtg (small blind) folded before Flop




PokerStars Game #59939740774:  Hold'em No Limit ($0.10/$0.25) - 2009/07/01 0:47:43 ET
Table 'KTZXQ4LREPjpS54R3DFTsw' 9-max Seat #8 is the button
Seat 1: dSjkBIV7Bv+ZCIWNBguf7w ($34 in chips) 
Seat 3: N6fYvIzQLKaydFLKQGtMlQ ($35.70 in chips) 
Seat 4: K0b5wNInj6hUGRr6yzKFtw ($25.15 in chips) 
Seat 5: HPEB+AtKw1+C/cxU0o1ciw ($31.60 in chips) 
Seat 6: 1q23ISSsSMhv2lHXBfj9/A ($23.50 in chips) 
Seat 7: yyG4svzOpC1A+sUP/scg6w ($8.05 in chips) 
Seat 8: wZluzulQ98aycXC12mG7qA ($5.95 in chips) 
Seat 9: V6p0jQ/RhUsqpHLmXvEX4Q ($12.10 in chips) 
V6p0jQ/RhUsqpHLmXvEX4Q: posts small blind $0.10
dSjkBIV7Bv+ZCIWNBguf7w: posts big blind $0.25
*** HOLE CARDS ***
N6fYvIzQLKaydFLKQGtMlQ: folds 
K0b5wNInj6hUGRr6yzKFtw: folds 
HPEB+AtKw1+C/cxU0o1ciw: folds 
1q23ISSsSMhv2lHXBfj9/A: folds 
yyG4svzOpC1A+sUP/scg6w: folds 
wZluzulQ98aycXC12mG7qA: calls $0.25
V6p0jQ/RhUsqpHLmXvEX4Q: folds 
dSjkBIV7Bv+ZCIWNBguf7w: checks 
*** FLOP *** [3s Kd As]
dSjkBIV7Bv+ZCIWNBguf7w: checks 
wZluzulQ98aycXC12mG7qA: bets $0.25
dSjkBIV7Bv+ZCIWNBguf7w: folds 
Uncalled bet ($0.25) returned to wZluzulQ98aycXC12mG7qA
wZluzulQ98aycXC12mG7qA collected $0.60 from pot
wZluzulQ98aycXC12mG7qA: doesn't show hand 
*** SUMMARY ***
Total pot $0.60 | Rake $0 
Board [3s Kd As]
Seat 1: dSjkBIV7Bv+ZCIWNBguf7w (big blind) folded on the Flop
Seat 3: N6fYvIzQLKaydFLKQGtMlQ folded before Flop (didn't bet)
Seat 4: K0b5wNInj6hUGRr6yzKFtw folded before Flop (didn't bet)
Seat 5: HPEB+AtKw1+C/cxU0o1ciw folded before Flop (didn't bet)
Seat 6: 1q23ISSsSMhv2lHXBfj9/A folded before Flop (didn't bet)
Seat 7: yyG4svzOpC1A+sUP/scg6w folded before Flop (didn't bet)
Seat 8: wZluzulQ98aycXC12mG7qA (button) collected ($0.60)
Seat 9: V6p0jQ/RhUsqpHLmXvEX4Q (small blind) folded before Flop




PokerStars Game #59939741062:  Hold'em No Limit ($0.10/$0.25) - 2009/07/01 0:47:43 ET
Table 'Do4nrTNDYpK3sQjwFxX+Og' 6-max Seat #1 is the button
Seat 1: 7JrQNOR9wRBxq9ijFhWieg ($27.20 in chips) 
Seat 2: tzMoGl9F0PUr5NibYueeSw ($44.15 in chips) 
Seat 3: TSmua8tGK3sTbwi0ynrW9Q ($32.80 in chips) 
Seat 4: df7bIV965hvGEDiUAs5cfQ ($14 in chips) 
Seat 5: Ew/TYPQIsbQ2X8nm5iAJBg ($30.80 in chips) 
Seat 6: eHsmIvAb2JREg4O6hNPnXg ($24.40 in chips) 
tzMoGl9F0PUr5NibYueeSw: posts small blind $0.10
TSmua8tGK3sTbwi0ynrW9Q: posts big blind $0.25
*** HOLE CARDS ***
df7bIV965hvGEDiUAs5cfQ: calls $0.25
Ew/TYPQIsbQ2X8nm5iAJBg: raises $1.25 to $1.50
eHsmIvAb2JREg4O6hNPnXg: calls $1.50
7JrQNOR9wRBxq9ijFhWieg: folds 
7JrQNOR9wRBxq9ijFhWieg is sitting out
tzMoGl9F0PUr5NibYueeSw: folds 
TSmua8tGK3sTbwi0ynrW9Q: folds 
df7bIV965hvGEDiUAs5cfQ: raises $12.50 to $14 and is all-in
Ew/TYPQIsbQ2X8nm5iAJBg: folds 
eHsmIvAb2JREg4O6hNPnXg: folds 
Uncalled bet ($12.50) returned to df7bIV965hvGEDiUAs5cfQ
df7bIV965hvGEDiUAs5cfQ collected $4.85 from pot
*** SUMMARY ***
Total pot $4.85 | Rake $0 
Seat 1: 7JrQNOR9wRBxq9ijFhWieg (button) folded before Flop (didn't bet)
Seat 2: tzMoGl9F0PUr5NibYueeSw (small blind) folded before Flop
Seat 3: TSmua8tGK3sTbwi0ynrW9Q (big blind) folded before Flop
Seat 4: df7bIV965hvGEDiUAs5cfQ collected ($4.85)
Seat 5: Ew/TYPQIsbQ2X8nm5iAJBg folded before Flop
Seat 6: eHsmIvAb2JREg4O6hNPnXg folded before Flop




PokerStars Game #59939741252:  Hold'em No Limit ($0.10/$0.25) - 2009/07/01 0:47:44 ET
Table 'nyTW9cVtYentc5V7xU/0jA' 6-max Seat #6 is the button
Seat 1: YfxPRDAWfqnGBhiIEdlTYg ($10 in chips) 
Seat 2: 7FmwVDcdEtxDpHmP4hOXsQ ($26.40 in chips) 
Seat 3: kG34n23qFQA3nzdOJTQ1dA ($26.70 in chips) 
Seat 4: NkB3D4eVHHXvB9Edaugc1Q ($15.40 in chips) 
Seat 5: BedjMfrlRfPgSq7CXpPAmg ($30 in chips) 
Seat 6: dQJByDqHOLbgqX/HobyAJA ($3.45 in chips) 
YfxPRDAWfqnGBhiIEdlTYg: posts small blind $0.10
7FmwVDcdEtxDpHmP4hOXsQ: posts big blind $0.25
*** HOLE CARDS ***
kG34n23qFQA3nzdOJTQ1dA: folds 
NkB3D4eVHHXvB9Edaugc1Q: raises $0.25 to $0.50
BedjMfrlRfPgSq7CXpPAmg: calls $0.50
dQJByDqHOLbgqX/HobyAJA: folds 
YfxPRDAWfqnGBhiIEdlTYg: folds 
7FmwVDcdEtxDpHmP4hOXsQ: folds 
*** FLOP *** [Ad 7h Th]
NkB3D4eVHHXvB9Edaugc1Q: bets $0.25
BedjMfrlRfPgSq7CXpPAmg: calls $0.25
*** TURN *** [Ad 7h Th] [Ac]
NkB3D4eVHHXvB9Edaugc1Q: bets $0.25
BedjMfrlRfPgSq7CXpPAmg: calls $0.25
*** RIVER *** [Ad 7h Th Ac] [2c]
NkB3D4eVHHXvB9Edaugc1Q: bets $1.25
BedjMfrlRfPgSq7CXpPAmg: folds 
Uncalled bet ($1.25) returned to NkB3D4eVHHXvB9Edaugc1Q
NkB3D4eVHHXvB9Edaugc1Q collected $2.25 from pot
NkB3D4eVHHXvB9Edaugc1Q: doesn't show hand 
*** SUMMARY ***
Total pot $2.35 | Rake $0.10 
Board [Ad 7h Th Ac 2c]
Seat 1: YfxPRDAWfqnGBhiIEdlTYg (small blind) folded before Flop
Seat 2: 7FmwVDcdEtxDpHmP4hOXsQ (big blind) folded before Flop
Seat 3: kG34n23qFQA3nzdOJTQ1dA folded before Flop (didn't bet)
Seat 4: NkB3D4eVHHXvB9Edaugc1Q collected ($2.25)
Seat 5: BedjMfrlRfPgSq7CXpPAmg folded on the River
Seat 6: dQJByDqHOLbgqX/HobyAJA (button) folded before Flop (didn't bet)




PokerStars Game #59939741362:  Hold'em No Limit ($0.10/$0.25) - 2009/07/01 0:47:44 ET
Table '63h13e5p7cWe02rClZ1CHw' 6-max Seat #1 is the button
Seat 1: 7VfhiFY533nbUKvyEthASw ($7.65 in chips) 
Seat 2: k9nHZTHt8hYhYRcW8NTb4g ($20.75 in chips) 
Seat 3: 9jSiy0meE9XJKkdIZwyTEQ ($34.25 in chips) 
Seat 4: myagrRAhs0mdgmh5GNqvCw ($4 in chips) 
Seat 5: bE34il0XYGjWPD5/vbkMaQ ($22.65 in chips) 
Seat 6: mfrkWA3PTeYPkbO6hi98Aw ($22.15 in chips) 
k9nHZTHt8hYhYRcW8NTb4g: posts small blind $0.10
9jSiy0meE9XJKkdIZwyTEQ: posts big blind $0.25
*** HOLE CARDS ***
myagrRAhs0mdgmh5GNqvCw: folds 
bE34il0XYGjWPD5/vbkMaQ: folds 
mfrkWA3PTeYPkbO6hi98Aw: folds 
7VfhiFY533nbUKvyEthASw: folds 
k9nHZTHt8hYhYRcW8NTb4g: folds 
Uncalled bet ($0.15) returned to 9jSiy0meE9XJKkdIZwyTEQ
9jSiy0meE9XJKkdIZwyTEQ collected $0.20 from pot
9jSiy0meE9XJKkdIZwyTEQ: doesn't show hand 
*** SUMMARY ***
Total pot $0.20 | Rake $0 
Seat 1: 7VfhiFY533nbUKvyEthASw (button) folded before Flop (didn't bet)
Seat 2: k9nHZTHt8hYhYRcW8NTb4g (small blind) folded before Flop
Seat 3: 9jSiy0meE9XJKkdIZwyTEQ (big blind) collected ($0.20)
Seat 4: myagrRAhs0mdgmh5GNqvCw folded before Flop (didn't bet)
Seat 5: bE34il0XYGjWPD5/vbkMaQ folded before Flop (didn't bet)
Seat 6: mfrkWA3PTeYPkbO6hi98Aw folded before Flop (didn't bet)




PokerStars Game #59939741402:  Hold'em No Limit ($0.10/$0.25) - 2009/07/01 0:47:44 ET
Table 'ShgkxBDL5IvR1qjzfRNc0A' 6-max Seat #6 is the button
Seat 1: /gJNBeCkWL4o85/jvlZ4BA ($25.10 in chips) 
Seat 2: mfrkWA3PTeYPkbO6hi98Aw ($35 in chips) 
Seat 3: JXSfL0FgBM1dIFwHP09Hnw ($33.50 in chips) 
Seat 4: kG34n23qFQA3nzdOJTQ1dA ($24.90 in chips) 
Seat 5: ferjiUxLWPNUKxvl8/xD/g ($48.85 in chips) 
Seat 6: 5tB0F9NjPSUL4FzmzBMs2Q ($27.35 in chips) 
/gJNBeCkWL4o85/jvlZ4BA: posts small blind $0.10
mfrkWA3PTeYPkbO6hi98Aw: posts big blind $0.25
*** HOLE CARDS ***
JXSfL0FgBM1dIFwHP09Hnw: raises $0.50 to $0.75
kG34n23qFQA3nzdOJTQ1dA: folds 
ferjiUxLWPNUKxvl8/xD/g: folds 
5tB0F9NjPSUL4FzmzBMs2Q: folds 
/gJNBeCkWL4o85/jvlZ4BA: folds 
mfrkWA3PTeYPkbO6hi98Aw: folds 
Uncalled bet ($0.50) returned to JXSfL0FgBM1dIFwHP09Hnw
JXSfL0FgBM1dIFwHP09Hnw collected $0.60 from pot
JXSfL0FgBM1dIFwHP09Hnw: doesn't show hand 
*** SUMMARY ***
Total pot $0.60 | Rake $0 
Seat 1: /gJNBeCkWL4o85/jvlZ4BA (small blind) folded before Flop
Seat 2: mfrkWA3PTeYPkbO6hi98Aw (big blind) folded before Flop
Seat 3: JXSfL0FgBM1dIFwHP09Hnw collected ($0.60)
Seat 4: kG34n23qFQA3nzdOJTQ1dA folded before Flop (didn't bet)
Seat 5: ferjiUxLWPNUKxvl8/xD/g folded before Flop (didn't bet)
Seat 6: 5tB0F9NjPSUL4FzmzBMs2Q (button) folded before Flop (didn't bet)




PokerStars Game #59939741660:  Hold'em No Limit ($0.10/$0.25) - 2009/07/01 0:47:44 ET
Table 'fvoGXKLawfAadYn02raohg' 9-max Seat #5 is the button
Seat 1: DIBbjEYGs+TVdVgEB/4+3w ($39.50 in chips) 
Seat 2: Ud3KoJmky17jahFh5jxdNA ($13.20 in chips) 
Seat 3: aNpwfA31EREwO+ar4XzBCw ($31.35 in chips) 
Seat 4: uibjYTUZq0zsChpZ84TeGQ ($14.95 in chips) 
Seat 5: +2kMBNpY4nF1qNCRd8SJLA ($25 in chips) 
Seat 7: 18G4P1XstjNvItdGUITxgw ($25.20 in chips) 
Seat 8: 4GJMmHGKzu+gVtalqRy7dA ($12.85 in chips) 
Th3FldXKQW6hWVVPahaoOQ will be allowed to play after the button
18G4P1XstjNvItdGUITxgw: posts small blind $0.10
4GJMmHGKzu+gVtalqRy7dA: posts big blind $0.25
F7pnn6czNpHvRM55XcA2EA: sits out 
*** HOLE CARDS ***
DIBbjEYGs+TVdVgEB/4+3w: folds 
Ud3KoJmky17jahFh5jxdNA: calls $0.25
aNpwfA31EREwO+ar4XzBCw: folds 
uibjYTUZq0zsChpZ84TeGQ: folds 
+2kMBNpY4nF1qNCRd8SJLA: folds 
18G4P1XstjNvItdGUITxgw: calls $0.15
4GJMmHGKzu+gVtalqRy7dA: checks 
*** FLOP *** [5s Ts Kd]
18G4P1XstjNvItdGUITxgw: checks 
4GJMmHGKzu+gVtalqRy7dA: bets $1
Ud3KoJmky17jahFh5jxdNA: folds 
18G4P1XstjNvItdGUITxgw: folds 
Uncalled bet ($1) returned to 4GJMmHGKzu+gVtalqRy7dA
4GJMmHGKzu+gVtalqRy7dA collected $0.75 from pot
4GJMmHGKzu+gVtalqRy7dA: doesn't show hand 
*** SUMMARY ***
Total pot $0.75 | Rake $0 
Board [5s Ts Kd]
Seat 1: DIBbjEYGs+TVdVgEB/4+3w folded before Flop (didn't bet)
Seat 2: Ud3KoJmky17jahFh5jxdNA folded on the Flop
Seat 3: aNpwfA31EREwO+ar4XzBCw folded before Flop (didn't bet)
Seat 4: uibjYTUZq0zsChpZ84TeGQ folded before Flop (didn't bet)
Seat 5: +2kMBNpY4nF1qNCRd8SJLA (button) folded before Flop (didn't bet)
Seat 7: 18G4P1XstjNvItdGUITxgw (small blind) folded on the Flop
Seat 8: 4GJMmHGKzu+gVtalqRy7dA (big blind) collected ($0.75)




PokerStars Game #59939741180:  Hold'em No Limit ($0.10/$0.25) - 2009/07/01 0:47:44 ET
Table 'jz4TpuH+ag+0iNe2ZcxckQ' 9-max Seat #9 is the button
Seat 1: F7pnn6czNpHvRM55XcA2EA ($25 in chips) 
Seat 2: 18G4P1XstjNvItdGUITxgw ($37.45 in chips) 
Seat 4: k+2r6di6GXjNpAdrRkW9bA ($71.10 in chips) 
Seat 5: uJlzv9KL7hgCIqIS2ofoaw ($8.45 in chips) 
Seat 6: ymx/m/7IEqTY+OQPano2gg ($6.05 in chips) 
Seat 7: sJNHTWcSlLHRCZ9+YRLLqA ($25 in chips) 
Seat 8: DlXs37dlX3tb7o/7lYXQSw ($26.35 in chips) 
Seat 9: 8B/dhbQjIWe6ASCdgzktNQ ($25 in chips) 
F7pnn6czNpHvRM55XcA2EA: posts small blind $0.10
18G4P1XstjNvItdGUITxgw: posts big blind $0.25
*** HOLE CARDS ***
k+2r6di6GXjNpAdrRkW9bA: calls $0.25
uJlzv9KL7hgCIqIS2ofoaw: folds 
ymx/m/7IEqTY+OQPano2gg: folds 
sJNHTWcSlLHRCZ9+YRLLqA: folds 
DlXs37dlX3tb7o/7lYXQSw: raises $0.85 to $1.10
8B/dhbQjIWe6ASCdgzktNQ: calls $1.10
F7pnn6czNpHvRM55XcA2EA: raises $3.65 to $4.75
Z5NNIVvnhb2IJbLcI79WYQ leaves the table
18G4P1XstjNvItdGUITxgw: folds 
k+2r6di6GXjNpAdrRkW9bA: folds 
VBHxUExRAMrbxUq/cVx9Gw joins the table at seat #3 
DlXs37dlX3tb7o/7lYXQSw: folds 
8B/dhbQjIWe6ASCdgzktNQ: folds 
Uncalled bet ($3.65) returned to F7pnn6czNpHvRM55XcA2EA
F7pnn6czNpHvRM55XcA2EA collected $3.80 from pot
F7pnn6czNpHvRM55XcA2EA: doesn't show hand 
*** SUMMARY ***
Total pot $3.80 | Rake $0 
Seat 1: F7pnn6czNpHvRM55XcA2EA (small blind) collected ($3.80)
Seat 2: 18G4P1XstjNvItdGUITxgw (big blind) folded before Flop
Seat 4: k+2r6di6GXjNpAdrRkW9bA folded before Flop
Seat 5: uJlzv9KL7hgCIqIS2ofoaw folded before Flop (didn't bet)
Seat 6: ymx/m/7IEqTY+OQPano2gg folded before Flop (didn't bet)
Seat 7: sJNHTWcSlLHRCZ9+YRLLqA folded before Flop (didn't bet)
Seat 8: DlXs37dlX3tb7o/7lYXQSw folded before Flop
Seat 9: 8B/dhbQjIWe6ASCdgzktNQ (button) folded before Flop




PokerStars Game #59939742296:  Hold'em No Limit ($0.10/$0.25) - 2009/07/01 0:47:45 ET
Table 'l8hUTjBTXBorNUR/tyvSLw' 9-max Seat #8 is the button
Seat 1: cZ99hugmLBj9KhTlc8nCSw ($25 in chips) 
Seat 3: 6TWO15+WfJ5HfI8CbJ4a0w ($8.80 in chips) 
Seat 4: vPtFvcPtn/Afz0sucO1cmQ ($37.20 in chips) 
Seat 5: S7Ki0P+0AIGPuIfGJjW0gg ($15.35 in chips) 
Seat 6: nkD1GtC3+ft+4U3Od0H10A ($12.70 in chips) 
Seat 7: awxYB5n5W4JUl1V4Xsn26g ($4.30 in chips) 
Seat 8: kZJjw0YSgO2CZKraCg0v8g ($12.75 in chips) 
Seat 9: zDrucyjVn5aeekNEc3cJrA ($35.50 in chips) 
zDrucyjVn5aeekNEc3cJrA: posts small blind $0.10
cZ99hugmLBj9KhTlc8nCSw: posts big blind $0.25
*** HOLE CARDS ***
6TWO15+WfJ5HfI8CbJ4a0w: raises $0.25 to $0.50
vPtFvcPtn/Afz0sucO1cmQ: calls $0.50
S7Ki0P+0AIGPuIfGJjW0gg: folds 
nkD1GtC3+ft+4U3Od0H10A: calls $0.50
awxYB5n5W4JUl1V4Xsn26g: folds 
kZJjw0YSgO2CZKraCg0v8g: folds 
zDrucyjVn5aeekNEc3cJrA: folds 
cZ99hugmLBj9KhTlc8nCSw: folds 
*** FLOP *** [3s 6h Ts]
6TWO15+WfJ5HfI8CbJ4a0w: bets $1
vPtFvcPtn/Afz0sucO1cmQ: folds 
nkD1GtC3+ft+4U3Od0H10A: folds 
Uncalled bet ($1) returned to 6TWO15+WfJ5HfI8CbJ4a0w
6TWO15+WfJ5HfI8CbJ4a0w collected $1.80 from pot
6TWO15+WfJ5HfI8CbJ4a0w: doesn't show hand 
*** SUMMARY ***
Total pot $1.85 | Rake $0.05 
Board [3s 6h Ts]
Seat 1: cZ99hugmLBj9KhTlc8nCSw (big blind) folded before Flop
Seat 3: 6TWO15+WfJ5HfI8CbJ4a0w collected ($1.80)
Seat 4: vPtFvcPtn/Afz0sucO1cmQ folded on the Flop
Seat 5: S7Ki0P+0AIGPuIfGJjW0gg folded before Flop (didn't bet)
Seat 6: nkD1GtC3+ft+4U3Od0H10A folded on the Flop
Seat 7: awxYB5n5W4JUl1V4Xsn26g folded before Flop (didn't bet)
Seat 8: kZJjw0YSgO2CZKraCg0v8g (button) folded before Flop (didn't bet)
Seat 9: zDrucyjVn5aeekNEc3cJrA (small blind) folded before Flop




PokerStars Game #59939742208:  Hold'em No Limit ($0.10/$0.25) - 2009/07/01 0:47:45 ET
Table 'Rv0EYnRU8WwZiwx0Zo3X3w' 9-max Seat #1 is the button
Seat 1: opOCI2p6kW0tINuVaAqmcQ ($52.60 in chips) 
Seat 2: Xpyqpb+DURDWnyJ3xTEIFQ ($28.50 in chips) 
Seat 3: STkR8XvpjNv79OOMhrlh2w ($25.60 in chips) 
Seat 4: IDkfbfxTm9KJ+DMyGVH8rw ($12.60 in chips) 
Seat 5: h4ggJZYBXV0mEZzYPYKfeA ($21.80 in chips) 
Seat 6: 5hAPbqNrvJb8PtLiceXtlg ($14.15 in chips) 
Seat 7: Th3FldXKQW6hWVVPahaoOQ ($38.50 in chips) 
Seat 8: 10vzP4r6ldwGLbYHKd9www ($16.65 in chips) 
Seat 9: r1pFKMwWp74QwhfPWJOAyw ($3.85 in chips) 
Xpyqpb+DURDWnyJ3xTEIFQ: posts small blind $0.10
STkR8XvpjNv79OOMhrlh2w: posts big blind $0.25
*** HOLE CARDS ***
IDkfbfxTm9KJ+DMyGVH8rw: folds 
h4ggJZYBXV0mEZzYPYKfeA: raises $0.75 to $1
5hAPbqNrvJb8PtLiceXtlg: folds 
Th3FldXKQW6hWVVPahaoOQ: folds 
10vzP4r6ldwGLbYHKd9www: folds 
r1pFKMwWp74QwhfPWJOAyw: folds 
opOCI2p6kW0tINuVaAqmcQ: folds 
Xpyqpb+DURDWnyJ3xTEIFQ: folds 
STkR8XvpjNv79OOMhrlh2w: folds 
Uncalled bet ($0.75) returned to h4ggJZYBXV0mEZzYPYKfeA
Xpyqpb+DURDWnyJ3xTEIFQ leaves the table
h4ggJZYBXV0mEZzYPYKfeA collected $0.60 from pot
h4ggJZYBXV0mEZzYPYKfeA: doesn't show hand 
*** SUMMARY ***
Total pot $0.60 | Rake $0 
Seat 1: opOCI2p6kW0tINuVaAqmcQ (button) folded before Flop (didn't bet)
Seat 2: Xpyqpb+DURDWnyJ3xTEIFQ (small blind) folded before Flop
Seat 3: STkR8XvpjNv79OOMhrlh2w (big blind) folded before Flop
Seat 4: IDkfbfxTm9KJ+DMyGVH8rw folded before Flop (didn't bet)
Seat 5: h4ggJZYBXV0mEZzYPYKfeA collected ($0.60)
Seat 6: 5hAPbqNrvJb8PtLiceXtlg folded before Flop (didn't bet)
Seat 7: Th3FldXKQW6hWVVPahaoOQ folded before Flop (didn't bet)
Seat 8: 10vzP4r6ldwGLbYHKd9www folded before Flop (didn't bet)
Seat 9: r1pFKMwWp74QwhfPWJOAyw folded before Flop (didn't bet)




PokerStars Game #59939742212:  Hold'em No Limit ($0.10/$0.25) - 2009/07/01 0:47:45 ET
Table '6aL2C8IFwHHr6SG6RgXaow' 9-max Seat #4 is the button
Seat 1: Z9AeOQX3yzuSvKAm/xyovg ($15.45 in chips) 
Seat 2: +gMmKt3DaQng9M42CmxIZg ($19.70 in chips) 
Seat 3: aCVg6cCxQcqClhB9nq/p1w ($24.65 in chips) 
Seat 4: tAxW5XKyzLgVZEyECMLCGw ($5.40 in chips) 
Seat 5: wre31HfyzQGpIvID1istxw ($14.75 in chips) 
Seat 6: HxDF4QSxC4z39D7teZpprQ ($32.10 in chips) 
Seat 8: rQhYIYXSyH/IivYM1dlV5A ($17.50 in chips) 
wre31HfyzQGpIvID1istxw: posts small blind $0.10
HxDF4QSxC4z39D7teZpprQ: posts big blind $0.25
jakethereed: sits out 
*** HOLE CARDS ***
rQhYIYXSyH/IivYM1dlV5A: calls $0.25
Z9AeOQX3yzuSvKAm/xyovg: folds 
+gMmKt3DaQng9M42CmxIZg: folds 
aCVg6cCxQcqClhB9nq/p1w: folds 
tAxW5XKyzLgVZEyECMLCGw: calls $0.25
wre31HfyzQGpIvID1istxw: folds 
HxDF4QSxC4z39D7teZpprQ: checks 
*** FLOP *** [Jh 6d 8h]
HxDF4QSxC4z39D7teZpprQ: checks 
rQhYIYXSyH/IivYM1dlV5A said, "i had 99 and you?"
rQhYIYXSyH/IivYM1dlV5A: checks 
tAxW5XKyzLgVZEyECMLCGw: bets $1.50
HxDF4QSxC4z39D7teZpprQ: folds 
rQhYIYXSyH/IivYM1dlV5A: folds 
Uncalled bet ($1.50) returned to tAxW5XKyzLgVZEyECMLCGw
tAxW5XKyzLgVZEyECMLCGw collected $0.85 from pot
tAxW5XKyzLgVZEyECMLCGw: doesn't show hand 
*** SUMMARY ***
Total pot $0.85 | Rake $0 
Board [Jh 6d 8h]
Seat 1: Z9AeOQX3yzuSvKAm/xyovg folded before Flop (didn't bet)
Seat 2: +gMmKt3DaQng9M42CmxIZg folded before Flop (didn't bet)
Seat 3: aCVg6cCxQcqClhB9nq/p1w folded before Flop (didn't bet)
Seat 4: tAxW5XKyzLgVZEyECMLCGw (button) collected ($0.85)
Seat 5: wre31HfyzQGpIvID1istxw (small blind) folded before Flop
Seat 6: HxDF4QSxC4z39D7teZpprQ (big blind) folded on the Flop
Seat 8: rQhYIYXSyH/IivYM1dlV5A folded on the Flop




PokerStars Game #59939741920:  Hold'em No Limit ($0.10/$0.25) - 2009/07/01 0:47:45 ET
Table 'oJpFwZj9+FUGHX90Un8s9Q' 6-max Seat #2 is the button
Seat 1: 6DwBRH+xZ12AAZmeAg+aXw ($26.15 in chips) 
Seat 2: IMmIhmfU3tqkaJABnD21Rg ($14.55 in chips) 
Seat 3: kyRaCIljYA6l33lSKQfNsg ($27.55 in chips) 
Seat 4: IX/nJvz3Mx/Ez6DgueFA4Q ($9.60 in chips) 
Seat 5: kG34n23qFQA3nzdOJTQ1dA ($24.30 in chips) 
kyRaCIljYA6l33lSKQfNsg: posts small blind $0.10
IX/nJvz3Mx/Ez6DgueFA4Q: posts big blind $0.25
*** HOLE CARDS ***
kG34n23qFQA3nzdOJTQ1dA: folds 
6DwBRH+xZ12AAZmeAg+aXw: folds 
IMmIhmfU3tqkaJABnD21Rg: raises $0.25 to $0.50
kyRaCIljYA6l33lSKQfNsg: folds 
IX/nJvz3Mx/Ez6DgueFA4Q: calls $0.25
*** FLOP *** [5c 6c 2d]
IX/nJvz3Mx/Ez6DgueFA4Q: bets $1
IMmIhmfU3tqkaJABnD21Rg: folds 
Uncalled bet ($1) returned to IX/nJvz3Mx/Ez6DgueFA4Q
IX/nJvz3Mx/Ez6DgueFA4Q collected $1.05 from pot
IX/nJvz3Mx/Ez6DgueFA4Q: shows [Kc 5s] (a pair of Fives)
*** SUMMARY ***
Total pot $1.10 | Rake $0.05 
Board [5c 6c 2d]
Seat 1: 6DwBRH+xZ12AAZmeAg+aXw folded before Flop (didn't bet)
Seat 2: IMmIhmfU3tqkaJABnD21Rg (button) folded on the Flop
Seat 3: kyRaCIljYA6l33lSKQfNsg (small blind) folded before Flop
Seat 4: IX/nJvz3Mx/Ez6DgueFA4Q (big blind) collected ($1.05)
Seat 5: kG34n23qFQA3nzdOJTQ1dA folded before Flop (didn't bet)




PokerStars Game #59939741966:  Hold'em No Limit ($0.10/$0.25) - 2009/07/01 0:47:45 ET
Table 'srBTB98reCdD1TffxE6o7g' 6-max Seat #4 is the button
Seat 1: FEzezmgaiyVRh9sHKhd+9Q ($44.25 in chips) 
Seat 2: eSKnWz2RD4rvwnvB+rFzIg ($24.65 in chips) 
Seat 3: 4YSTu0Cdzpppe1lUgCZGCQ ($33.20 in chips) 
Seat 4: 6DwBRH+xZ12AAZmeAg+aXw ($26.85 in chips) 
Seat 5: n2OZezRXTtdzQt4SuIy8TQ ($36.60 in chips) 
Seat 6: gaPMxLGp9SOj4Lq6t+/0Ig ($11 in chips) 
n2OZezRXTtdzQt4SuIy8TQ: posts small blind $0.10
gaPMxLGp9SOj4Lq6t+/0Ig: posts big blind $0.25
*** HOLE CARDS ***
FEzezmgaiyVRh9sHKhd+9Q: folds 
eSKnWz2RD4rvwnvB+rFzIg: folds 
4YSTu0Cdzpppe1lUgCZGCQ: folds 
6DwBRH+xZ12AAZmeAg+aXw: folds 
n2OZezRXTtdzQt4SuIy8TQ: folds 
Uncalled bet ($0.15) returned to gaPMxLGp9SOj4Lq6t+/0Ig
gaPMxLGp9SOj4Lq6t+/0Ig collected $0.20 from pot
gaPMxLGp9SOj4Lq6t+/0Ig: doesn't show hand 
*** SUMMARY ***
Total pot $0.20 | Rake $0 
Seat 1: FEzezmgaiyVRh9sHKhd+9Q folded before Flop (didn't bet)
Seat 2: eSKnWz2RD4rvwnvB+rFzIg folded before Flop (didn't bet)
Seat 3: 4YSTu0Cdzpppe1lUgCZGCQ folded before Flop (didn't bet)
Seat 4: 6DwBRH+xZ12AAZmeAg+aXw (button) folded before Flop (didn't bet)
Seat 5: n2OZezRXTtdzQt4SuIy8TQ (small blind) folded before Flop
Seat 6: gaPMxLGp9SOj4Lq6t+/0Ig (big blind) collected ($0.20)




PokerStars Game #59939742198:  Hold'em No Limit ($0.10/$0.25) - 2009/07/01 0:47:45 ET
Table 'sm5gqEvXgLbkkE4dryW/5g' 6-max Seat #1 is the button
Seat 1: gaPMxLGp9SOj4Lq6t+/0Ig ($15.85 in chips) 
Seat 2: s13YXIlhF/j3TO0bSnT7bA ($17.70 in chips) 
Seat 3: I1TxPvWj8NfG8orglCinNA ($27.25 in chips) 
Seat 4: BedjMfrlRfPgSq7CXpPAmg ($56.90 in chips) 
Seat 5: M+WmDyCD/ZMu/5t6/iH2kw ($68.20 in chips) 
Seat 6: wKFJ513ucluNNiMlkXcDOQ ($27.50 in chips) 
s13YXIlhF/j3TO0bSnT7bA: posts small blind $0.10
I1TxPvWj8NfG8orglCinNA: posts big blind $0.25
*** HOLE CARDS ***
BedjMfrlRfPgSq7CXpPAmg: folds 
M+WmDyCD/ZMu/5t6/iH2kw: folds 
wKFJ513ucluNNiMlkXcDOQ: raises $0.75 to $1
gaPMxLGp9SOj4Lq6t+/0Ig: folds 
s13YXIlhF/j3TO0bSnT7bA: calls $0.90
I1TxPvWj8NfG8orglCinNA has timed out
I1TxPvWj8NfG8orglCinNA: folds 
*** FLOP *** [5h 4h 8s]
I1TxPvWj8NfG8orglCinNA is sitting out
I1TxPvWj8NfG8orglCinNA has returned
s13YXIlhF/j3TO0bSnT7bA: checks 
wKFJ513ucluNNiMlkXcDOQ: checks 
*** TURN *** [5h 4h 8s] [6d]
s13YXIlhF/j3TO0bSnT7bA: checks 
wKFJ513ucluNNiMlkXcDOQ: checks 
*** RIVER *** [5h 4h 8s 6d] [2c]
s13YXIlhF/j3TO0bSnT7bA: checks 
wKFJ513ucluNNiMlkXcDOQ: checks 
*** SHOW DOWN ***
s13YXIlhF/j3TO0bSnT7bA: shows [Ad Qs] (high card Ace)
wKFJ513ucluNNiMlkXcDOQ: mucks hand 
s13YXIlhF/j3TO0bSnT7bA collected $2.15 from pot
*** SUMMARY ***
Total pot $2.25 | Rake $0.10 
Board [5h 4h 8s 6d 2c]
Seat 1: gaPMxLGp9SOj4Lq6t+/0Ig (button) folded before Flop (didn't bet)
Seat 2: s13YXIlhF/j3TO0bSnT7bA (small blind) showed [Ad Qs] and won ($2.15) with high card Ace
Seat 3: I1TxPvWj8NfG8orglCinNA (big blind) folded before Flop
Seat 4: BedjMfrlRfPgSq7CXpPAmg folded before Flop (didn't bet)
Seat 5: M+WmDyCD/ZMu/5t6/iH2kw folded before Flop (didn't bet)
Seat 6: wKFJ513ucluNNiMlkXcDOQ mucked




PokerStars Game #59939741864:  Hold'em No Limit ($0.10/$0.25) - 2009/07/01 0:47:45 ET
Table 'zgAizkhIUPUrfr6LqN3ifw' 9-max Seat #2 is the button
Seat 1: st9jtdNbm1W5GfBwRaCVqQ ($24.90 in chips) 
Seat 2: s7Q6uNouhe7aE8JdFb9E+A ($26.85 in chips) 
Seat 5: DdPXdieucQ+n99u1n3A+rQ ($4.90 in chips) 
Seat 7: 1S/fpm+f42V/6MNZre+ccg ($25.65 in chips) 
Seat 8: MIVCHqCqqlke0Lb0z7glcw ($23.30 in chips) 
Seat 9: 7cv+9Zc9HIQHNvYsMfV3uA ($27.15 in chips) 
sat420Man will be allowed to play after the button
DdPXdieucQ+n99u1n3A+rQ: posts small blind $0.10
TeWJxSETzbXGiYKx0y+dtg: is sitting out 
1S/fpm+f42V/6MNZre+ccg: posts big blind $0.25
*** HOLE CARDS ***
TeWJxSETzbXGiYKx0y+dtg leaves the table
MIVCHqCqqlke0Lb0z7glcw: calls $0.25
7cv+9Zc9HIQHNvYsMfV3uA: calls $0.25
st9jtdNbm1W5GfBwRaCVqQ: folds 
s7Q6uNouhe7aE8JdFb9E+A: folds 
DdPXdieucQ+n99u1n3A+rQ: folds 
1S/fpm+f42V/6MNZre+ccg: checks 
*** FLOP *** [Qc 4c 7d]
1S/fpm+f42V/6MNZre+ccg: checks 
MIVCHqCqqlke0Lb0z7glcw: checks 
7cv+9Zc9HIQHNvYsMfV3uA: checks 
*** TURN *** [Qc 4c 7d] [5d]
1S/fpm+f42V/6MNZre+ccg: checks 
MIVCHqCqqlke0Lb0z7glcw: bets $0.50
7cv+9Zc9HIQHNvYsMfV3uA: folds 
1S/fpm+f42V/6MNZre+ccg: folds 
Uncalled bet ($0.50) returned to MIVCHqCqqlke0Lb0z7glcw
MIVCHqCqqlke0Lb0z7glcw collected $0.85 from pot
MIVCHqCqqlke0Lb0z7glcw: doesn't show hand 
*** SUMMARY ***
Total pot $0.85 | Rake $0 
Board [Qc 4c 7d 5d]
Seat 1: st9jtdNbm1W5GfBwRaCVqQ folded before Flop (didn't bet)
Seat 2: s7Q6uNouhe7aE8JdFb9E+A (button) folded before Flop (didn't bet)
Seat 5: DdPXdieucQ+n99u1n3A+rQ (small blind) folded before Flop
Seat 7: 1S/fpm+f42V/6MNZre+ccg (big blind) folded on the Turn
Seat 8: MIVCHqCqqlke0Lb0z7glcw collected ($0.85)
Seat 9: 7cv+9Zc9HIQHNvYsMfV3uA folded on the Turn




PokerStars Game #59939742426:  Hold'em No Limit ($0.10/$0.25) - 2009/07/01 0:47:46 ET
Table '/XCUCUl3yW6tdTJQEhJKGw' 6-max Seat #3 is the button
Seat 1: p8J112JmNRnCwV2+NAEzCA ($19.75 in chips) 
Seat 2: 8ClCHtFXGNplITm+63KB+Q ($28.15 in chips) 
Seat 3: /gJNBeCkWL4o85/jvlZ4BA ($36 in chips) 
Seat 4: SFmT9ZsVopnukjvAzrxTRg ($25.10 in chips) 
Seat 5: rf9ho6cin0bk70nP86p3rQ ($14.95 in chips) 
Seat 6: armfxZhGxeZVZBYAQFuIJQ ($34.65 in chips) 
SFmT9ZsVopnukjvAzrxTRg: posts small blind $0.10
rf9ho6cin0bk70nP86p3rQ: posts big blind $0.25
*** HOLE CARDS ***
armfxZhGxeZVZBYAQFuIJQ: folds 
p8J112JmNRnCwV2+NAEzCA: raises $0.25 to $0.50
8ClCHtFXGNplITm+63KB+Q: folds 
/gJNBeCkWL4o85/jvlZ4BA: folds 
SFmT9ZsVopnukjvAzrxTRg: folds 
rf9ho6cin0bk70nP86p3rQ: calls $0.25
*** FLOP *** [7d 2c Tc]
rf9ho6cin0bk70nP86p3rQ: checks 
p8J112JmNRnCwV2+NAEzCA: checks 
*** TURN *** [7d 2c Tc] [6c]
rf9ho6cin0bk70nP86p3rQ: checks 
p8J112JmNRnCwV2+NAEzCA: bets $1.45
rf9ho6cin0bk70nP86p3rQ: calls $1.45
*** RIVER *** [7d 2c Tc 6c] [Qh]
rf9ho6cin0bk70nP86p3rQ: checks 
p8J112JmNRnCwV2+NAEzCA: bets $3
rf9ho6cin0bk70nP86p3rQ: folds 
Uncalled bet ($3) returned to p8J112JmNRnCwV2+NAEzCA
p8J112JmNRnCwV2+NAEzCA collected $3.85 from pot
p8J112JmNRnCwV2+NAEzCA: doesn't show hand 
*** SUMMARY ***
Total pot $4 | Rake $0.15 
Board [7d 2c Tc 6c Qh]
Seat 1: p8J112JmNRnCwV2+NAEzCA collected ($3.85)
Seat 2: 8ClCHtFXGNplITm+63KB+Q folded before Flop (didn't bet)
Seat 3: /gJNBeCkWL4o85/jvlZ4BA (button) folded before Flop (didn't bet)
Seat 4: SFmT9ZsVopnukjvAzrxTRg (small blind) folded before Flop
Seat 5: rf9ho6cin0bk70nP86p3rQ (big blind) folded on the River
Seat 6: armfxZhGxeZVZBYAQFuIJQ folded before Flop (didn't bet)




PokerStars Game #59939742632:  Hold'em No Limit ($0.10/$0.25) - 2009/07/01 0:47:46 ET
Table 'BpNkESDX1ip9c0K1hb5h7A' 6-max Seat #5 is the button
Seat 1: 9jSiy0meE9XJKkdIZwyTEQ ($28.90 in chips) 
Seat 2: gqW2aBCmrIw65BvwjTFN6Q ($26.50 in chips) 
Seat 3: cHhVLDikFlByGGN+CM3w/A ($27.95 in chips) 
Seat 4: x9VGscBU5oUWy8rQ+Ik80w ($25 in chips) 
Seat 5: QvTX2yGq3uKJiKPmns4TKQ ($75.60 in chips) 
Seat 6: iUgsn+WyKFjjVd+tj13R2w ($11.85 in chips) 
iUgsn+WyKFjjVd+tj13R2w: posts small blind $0.10
9jSiy0meE9XJKkdIZwyTEQ: posts big blind $0.25
*** HOLE CARDS ***
gqW2aBCmrIw65BvwjTFN6Q: folds 
cHhVLDikFlByGGN+CM3w/A: raises $0.75 to $1
x9VGscBU5oUWy8rQ+Ik80w: folds 
QvTX2yGq3uKJiKPmns4TKQ: calls $1
iUgsn+WyKFjjVd+tj13R2w: calls $0.90
9jSiy0meE9XJKkdIZwyTEQ: folds 
*** FLOP *** [Qd 7d 3s]
iUgsn+WyKFjjVd+tj13R2w: checks 
cHhVLDikFlByGGN+CM3w/A: bets $2
QvTX2yGq3uKJiKPmns4TKQ: folds 
iUgsn+WyKFjjVd+tj13R2w: raises $2 to $4
cHhVLDikFlByGGN+CM3w/A: folds 
Uncalled bet ($2) returned to iUgsn+WyKFjjVd+tj13R2w
iUgsn+WyKFjjVd+tj13R2w collected $6.90 from pot
*** SUMMARY ***
Total pot $7.25 | Rake $0.35 
Board [Qd 7d 3s]
Seat 1: 9jSiy0meE9XJKkdIZwyTEQ (big blind) folded before Flop
Seat 2: gqW2aBCmrIw65BvwjTFN6Q folded before Flop (didn't bet)
Seat 3: cHhVLDikFlByGGN+CM3w/A folded on the Flop
Seat 4: x9VGscBU5oUWy8rQ+Ik80w folded before Flop (didn't bet)
Seat 5: QvTX2yGq3uKJiKPmns4TKQ (button) folded on the Flop
Seat 6: iUgsn+WyKFjjVd+tj13R2w (small blind) collected ($6.90)




PokerStars Game #59939742760:  Hold'em No Limit ($0.10/$0.25) - 2009/07/01 0:47:46 ET
Table 'yRuHgMpxv4rPBXeM6HFESw' 6-max Seat #5 is the button
Seat 1: MkNgTuvyxpHXkeIm5JITHQ ($10.45 in chips) 
Seat 2: iwlxXocltgSdaBmusNXanQ ($15.80 in chips) 
Seat 3: zZ8zH49EwNs0mqgppOaL9g ($47.20 in chips) 
Seat 4: ypXnt+kzrF/5y8QN2rkt1A ($27.15 in chips) 
Seat 5: gaPMxLGp9SOj4Lq6t+/0Ig ($12.95 in chips) 
Seat 6: 4YSTu0Cdzpppe1lUgCZGCQ ($25 in chips) 
4YSTu0Cdzpppe1lUgCZGCQ: posts small blind $0.10
MkNgTuvyxpHXkeIm5JITHQ: posts big blind $0.25
*** HOLE CARDS ***
iwlxXocltgSdaBmusNXanQ: folds 
zZ8zH49EwNs0mqgppOaL9g: folds 
ypXnt+kzrF/5y8QN2rkt1A: folds 
gaPMxLGp9SOj4Lq6t+/0Ig: folds 
4YSTu0Cdzpppe1lUgCZGCQ: folds 
Uncalled bet ($0.15) returned to MkNgTuvyxpHXkeIm5JITHQ
MkNgTuvyxpHXkeIm5JITHQ collected $0.20 from pot
MkNgTuvyxpHXkeIm5JITHQ: doesn't show hand 
*** SUMMARY ***
Total pot $0.20 | Rake $0 
Seat 1: MkNgTuvyxpHXkeIm5JITHQ (big blind) collected ($0.20)
Seat 2: iwlxXocltgSdaBmusNXanQ folded before Flop (didn't bet)
Seat 3: zZ8zH49EwNs0mqgppOaL9g folded before Flop (didn't bet)
Seat 4: ypXnt+kzrF/5y8QN2rkt1A folded before Flop (didn't bet)
Seat 5: gaPMxLGp9SOj4Lq6t+/0Ig (button) folded before Flop (didn't bet)
Seat 6: 4YSTu0Cdzpppe1lUgCZGCQ (small blind) folded before Flop




PokerStars Game #59939742494:  Hold'em No Limit ($0.10/$0.25) - 2009/07/01 0:47:46 ET
Table 'sJ4KpS2GE5Qrsu1/cFjJUw' 9-max Seat #1 is the button
Seat 1: QsLvCwfSWqP+CfjwUnjpXQ ($18.10 in chips) 
Seat 3: eDil7UzSZCjyh1VP6SVXJQ ($12.25 in chips) 
Seat 5: FZrgDbxAanC1xwZxXHJKVA ($5.30 in chips) 
Seat 6: OefE+Csvj5KR7ClGf3Hc2g ($3.90 in chips) 
Seat 7: e4TN7vqqXBH+vGq4fHdZ3A ($4.75 in chips) 
Seat 8: f8ixGbSVIs6Be0mH69ldVQ ($6.75 in chips) 
eDil7UzSZCjyh1VP6SVXJQ: posts small blind $0.10
FZrgDbxAanC1xwZxXHJKVA: posts big blind $0.25
*** HOLE CARDS ***
OefE+Csvj5KR7ClGf3Hc2g: folds 
e4TN7vqqXBH+vGq4fHdZ3A: folds 
f8ixGbSVIs6Be0mH69ldVQ: raises $0.50 to $0.75
QsLvCwfSWqP+CfjwUnjpXQ: folds 
eDil7UzSZCjyh1VP6SVXJQ: calls $0.65
FZrgDbxAanC1xwZxXHJKVA: folds 
*** FLOP *** [Ks Ad 7d]
eDil7UzSZCjyh1VP6SVXJQ: checks 
f8ixGbSVIs6Be0mH69ldVQ: checks 
*** TURN *** [Ks Ad 7d] [Qs]
eDil7UzSZCjyh1VP6SVXJQ: bets $0.25
f8ixGbSVIs6Be0mH69ldVQ: calls $0.25
*** RIVER *** [Ks Ad 7d Qs] [Kd]
eDil7UzSZCjyh1VP6SVXJQ: bets $0.25
f8ixGbSVIs6Be0mH69ldVQ: raises $0.50 to $0.75
eDil7UzSZCjyh1VP6SVXJQ: folds 
Uncalled bet ($0.50) returned to f8ixGbSVIs6Be0mH69ldVQ
f8ixGbSVIs6Be0mH69ldVQ collected $2.65 from pot
f8ixGbSVIs6Be0mH69ldVQ: doesn't show hand 
*** SUMMARY ***
Total pot $2.75 | Rake $0.10 
Board [Ks Ad 7d Qs Kd]
Seat 1: QsLvCwfSWqP+CfjwUnjpXQ (button) folded before Flop (didn't bet)
Seat 3: eDil7UzSZCjyh1VP6SVXJQ (small blind) folded on the River
Seat 5: FZrgDbxAanC1xwZxXHJKVA (big blind) folded before Flop
Seat 6: OefE+Csvj5KR7ClGf3Hc2g folded before Flop (didn't bet)
Seat 7: e4TN7vqqXBH+vGq4fHdZ3A folded before Flop (didn't bet)
Seat 8: f8ixGbSVIs6Be0mH69ldVQ collected ($2.65)




PokerStars Game #59939742418:  Hold'em No Limit ($0.10/$0.25) - 2009/07/01 0:47:46 ET
Table 'zojWVNukhD2n8RTfHCOwwg' 9-max Seat #8 is the button
Seat 1: DIBbjEYGs+TVdVgEB/4+3w ($41.10 in chips) 
Seat 6: 2xNcp4M2UG8Li2PMEnWcgA ($11.10 in chips) 
Seat 7: H5Se03ZqSX7tbULXur2MAg ($28.15 in chips) 
Seat 8: j4q3p0lesp63b1gZDwLBZw ($5 in chips) 
Seat 9: 4oA316mXLIui1QY63GXBUg ($25 in chips) 
4oA316mXLIui1QY63GXBUg: posts small blind $0.10
DIBbjEYGs+TVdVgEB/4+3w: posts big blind $0.25
V6p0jQ/RhUsqpHLmXvEX4Q: sits out 
Vegaas: sits out 
*** HOLE CARDS ***
2xNcp4M2UG8Li2PMEnWcgA: calls $0.25
H5Se03ZqSX7tbULXur2MAg: folds 
j4q3p0lesp63b1gZDwLBZw: folds 
4oA316mXLIui1QY63GXBUg: folds 
DIBbjEYGs+TVdVgEB/4+3w: checks 
*** FLOP *** [9s 8s 4d]
DIBbjEYGs+TVdVgEB/4+3w: checks 
2xNcp4M2UG8Li2PMEnWcgA: checks 
*** TURN *** [9s 8s 4d] [Kd]
DIBbjEYGs+TVdVgEB/4+3w: checks 
2xNcp4M2UG8Li2PMEnWcgA: checks 
*** RIVER *** [9s 8s 4d Kd] [6s]
DIBbjEYGs+TVdVgEB/4+3w: checks 
2xNcp4M2UG8Li2PMEnWcgA: checks 
*** SHOW DOWN ***
DIBbjEYGs+TVdVgEB/4+3w: shows [Qc 3h] (high card King)
2xNcp4M2UG8Li2PMEnWcgA: shows [Qs Kh] (a pair of Kings)
2xNcp4M2UG8Li2PMEnWcgA collected $0.60 from pot
*** SUMMARY ***
Total pot $0.60 | Rake $0 
Board [9s 8s 4d Kd 6s]
Seat 1: DIBbjEYGs+TVdVgEB/4+3w (big blind) showed [Qc 3h] and lost with high card King
Seat 6: 2xNcp4M2UG8Li2PMEnWcgA showed [Qs Kh] and won ($0.60) with a pair of Kings
Seat 7: H5Se03ZqSX7tbULXur2MAg folded before Flop (didn't bet)
Seat 8: j4q3p0lesp63b1gZDwLBZw (button) folded before Flop (didn't bet)
Seat 9: 4oA316mXLIui1QY63GXBUg (small blind) folded before Flop




PokerStars Game #59939742570:  Hold'em No Limit ($0.10/$0.25) - 2009/07/01 0:47:46 ET
Table 'NfXsh0UQA+o/kO9acV3WxA' 9-max Seat #5 is the button
Seat 5: 3RCAkueG3Vc13VpRStCB+w ($34.80 in chips) 
Seat 7: HPEB+AtKw1+C/cxU0o1ciw ($31 in chips) 
Seat 8: +sbyWwIcFp9kP0bDtMegfQ ($24.65 in chips) 
HPEB+AtKw1+C/cxU0o1ciw: posts small blind $0.10
+sbyWwIcFp9kP0bDtMegfQ: posts big blind $0.25
*** HOLE CARDS ***
3RCAkueG3Vc13VpRStCB+w: raises $0.50 to $0.75
HPEB+AtKw1+C/cxU0o1ciw: folds 
+sbyWwIcFp9kP0bDtMegfQ: folds 
Uncalled bet ($0.50) returned to 3RCAkueG3Vc13VpRStCB+w
3RCAkueG3Vc13VpRStCB+w collected $0.60 from pot
3RCAkueG3Vc13VpRStCB+w: doesn't show hand 
*** SUMMARY ***
Total pot $0.60 | Rake $0 
Seat 5: 3RCAkueG3Vc13VpRStCB+w (button) collected ($0.60)
Seat 7: HPEB+AtKw1+C/cxU0o1ciw (small blind) folded before Flop
Seat 8: +sbyWwIcFp9kP0bDtMegfQ (big blind) folded before Flop




PokerStars Game #59939742516:  Hold'em No Limit ($0.10/$0.25) - 2009/07/01 0:47:46 ET
Table 'yAHDCs33TIgw3ra63xuU2Q' 9-max Seat #1 is the button
Seat 1: 8B/dhbQjIWe6ASCdgzktNQ ($26.05 in chips) 
Seat 2: LBrhQVB4w41YNd7kMYn/og ($15.90 in chips) 
Seat 3: H9KUl8cmpLgEpOVDA00bCg ($4.90 in chips) 
Seat 4: rUdM7gwmNCaxMNSb2CFPhQ ($9.65 in chips) 
Seat 5: 4awUyiDYTgylQKXZ9faBVA ($25.50 in chips) 
Seat 6: Z5ZtGOON8kmSdSCll9Z3XA ($10.70 in chips) 
Seat 7: gYiMxTFOfUp1+zRgNLQmmQ ($26.20 in chips) 
Seat 8: tYsOBqdU1+x+yFI7zHO7hQ ($29.80 in chips) 
Seat 9: k+ydNCnnP3Hgwh0AnDYVrA ($11.90 in chips) 
LBrhQVB4w41YNd7kMYn/og: posts small blind $0.10
H9KUl8cmpLgEpOVDA00bCg: posts big blind $0.25
*** HOLE CARDS ***
rUdM7gwmNCaxMNSb2CFPhQ: calls $0.25
rUdM7gwmNCaxMNSb2CFPhQ said, "wwt"
4awUyiDYTgylQKXZ9faBVA: folds 
Z5ZtGOON8kmSdSCll9Z3XA: folds 
gYiMxTFOfUp1+zRgNLQmmQ: calls $0.25
tYsOBqdU1+x+yFI7zHO7hQ: folds 
k+ydNCnnP3Hgwh0AnDYVrA: folds 
8B/dhbQjIWe6ASCdgzktNQ: folds 
LBrhQVB4w41YNd7kMYn/og: calls $0.15
H9KUl8cmpLgEpOVDA00bCg: checks 
*** FLOP *** [Kh 7s Kc]
LBrhQVB4w41YNd7kMYn/og: checks 
H9KUl8cmpLgEpOVDA00bCg: checks 
rUdM7gwmNCaxMNSb2CFPhQ: checks 
gYiMxTFOfUp1+zRgNLQmmQ: checks 
*** TURN *** [Kh 7s Kc] [6s]
LBrhQVB4w41YNd7kMYn/og: checks 
H9KUl8cmpLgEpOVDA00bCg: checks 
rUdM7gwmNCaxMNSb2CFPhQ: checks 
gYiMxTFOfUp1+zRgNLQmmQ: checks 
*** RIVER *** [Kh 7s Kc 6s] [Ah]
LBrhQVB4w41YNd7kMYn/og: bets $0.50
H9KUl8cmpLgEpOVDA00bCg: folds 
rUdM7gwmNCaxMNSb2CFPhQ: folds 
gYiMxTFOfUp1+zRgNLQmmQ: calls $0.50
*** SHOW DOWN ***
LBrhQVB4w41YNd7kMYn/og: shows [Ad 2d] (two pair, Aces and Kings)
gYiMxTFOfUp1+zRgNLQmmQ: shows [Ac 2h] (two pair, Aces and Kings)
LBrhQVB4w41YNd7kMYn/og collected $1 from pot
gYiMxTFOfUp1+zRgNLQmmQ collected $0.95 from pot
*** SUMMARY ***
Total pot $2 | Rake $0.05 
Board [Kh 7s Kc 6s Ah]
Seat 1: 8B/dhbQjIWe6ASCdgzktNQ (button) folded before Flop (didn't bet)
Seat 2: LBrhQVB4w41YNd7kMYn/og (small blind) showed [Ad 2d] and won ($1) with two pair, Aces and Kings
Seat 3: H9KUl8cmpLgEpOVDA00bCg (big blind) folded on the River
Seat 4: rUdM7gwmNCaxMNSb2CFPhQ folded on the River
Seat 5: 4awUyiDYTgylQKXZ9faBVA folded before Flop (didn't bet)
Seat 6: Z5ZtGOON8kmSdSCll9Z3XA folded before Flop (didn't bet)
Seat 7: gYiMxTFOfUp1+zRgNLQmmQ showed [Ac 2h] and won ($0.95) with two pair, Aces and Kings
Seat 8: tYsOBqdU1+x+yFI7zHO7hQ folded before Flop (didn't bet)
Seat 9: k+ydNCnnP3Hgwh0AnDYVrA folded before Flop (didn't bet)




PokerStars Game #59939742940:  Hold'em No Limit ($0.10/$0.25) - 2009/07/01 0:47:46 ET
Table 'BabJGL6tfXQp3leBGbYe8A' 9-max Seat #3 is the button
Seat 1: qwr38jl5txoR36M7G5qi4A ($7.50 in chips) 
Seat 2: G5EFgY1bi50mF1iH/+B4yQ ($10.20 in chips) 
Seat 3: Jdj7AsGFrlkCgDXeWK322A ($26.10 in chips) 
Seat 4: Yk91gygnxgAKPGHZ/jPVSw ($8.80 in chips) 
Seat 5: fKqW4kzqpoOv+YKE5kp3FA ($2.80 in chips) 
Seat 6: ELKIDQ6mBSQJr3wiHYHtvw ($6.90 in chips) 
Seat 8: TJEefy+0K5gBV+8LA5OK7Q ($25 in chips) 
Seat 9: xEQxarad8/T4jJdpZy5LGw ($10.10 in chips) 
Yk91gygnxgAKPGHZ/jPVSw: posts small blind $0.10
fKqW4kzqpoOv+YKE5kp3FA: posts big blind $0.25
st9jtdNbm1W5GfBwRaCVqQ: sits out 
*** HOLE CARDS ***
ELKIDQ6mBSQJr3wiHYHtvw: folds 
TJEefy+0K5gBV+8LA5OK7Q: calls $0.25
xEQxarad8/T4jJdpZy5LGw: calls $0.25
qwr38jl5txoR36M7G5qi4A: folds 
G5EFgY1bi50mF1iH/+B4yQ: folds 
Jdj7AsGFrlkCgDXeWK322A: folds 
Yk91gygnxgAKPGHZ/jPVSw: calls $0.15
fKqW4kzqpoOv+YKE5kp3FA: checks 
*** FLOP *** [3h Ks 4s]
Yk91gygnxgAKPGHZ/jPVSw: bets $0.25
fKqW4kzqpoOv+YKE5kp3FA: folds 
TJEefy+0K5gBV+8LA5OK7Q: calls $0.25
xEQxarad8/T4jJdpZy5LGw: calls $0.25
*** TURN *** [3h Ks 4s] [7h]
Yk91gygnxgAKPGHZ/jPVSw: bets $0.25
TJEefy+0K5gBV+8LA5OK7Q: folds 
xEQxarad8/T4jJdpZy5LGw: folds 
Uncalled bet ($0.25) returned to Yk91gygnxgAKPGHZ/jPVSw
Yk91gygnxgAKPGHZ/jPVSw collected $1.70 from pot
Yk91gygnxgAKPGHZ/jPVSw: doesn't show hand 
*** SUMMARY ***
Total pot $1.75 | Rake $0.05 
Board [3h Ks 4s 7h]
Seat 1: qwr38jl5txoR36M7G5qi4A folded before Flop (didn't bet)
Seat 2: G5EFgY1bi50mF1iH/+B4yQ folded before Flop (didn't bet)
Seat 3: Jdj7AsGFrlkCgDXeWK322A (button) folded before Flop (didn't bet)
Seat 4: Yk91gygnxgAKPGHZ/jPVSw (small blind) collected ($1.70)
Seat 5: fKqW4kzqpoOv+YKE5kp3FA (big blind) folded on the Flop
Seat 6: ELKIDQ6mBSQJr3wiHYHtvw folded before Flop (didn't bet)
Seat 8: TJEefy+0K5gBV+8LA5OK7Q folded on the Turn
Seat 9: xEQxarad8/T4jJdpZy5LGw folded on the Turn




PokerStars Game #59939742854:  Hold'em No Limit ($0.10/$0.25) - 2009/07/01 0:47:46 ET
Table 'Qk/910N2Yhg8u5vqTJk50Q' 9-max Seat #5 is the button
Seat 1: zDrucyjVn5aeekNEc3cJrA ($24.75 in chips) 
Seat 2: Th3FldXKQW6hWVVPahaoOQ ($37.70 in chips) 
Seat 3: ghNKXUBl/H+t83JF079ZBA ($25 in chips) 
Seat 5: 4oA316mXLIui1QY63GXBUg ($26.65 in chips) 
Seat 6: Uupj2MGlo48VpA/VyYrfrw ($7.25 in chips) 
Seat 7: aNpwfA31EREwO+ar4XzBCw ($25 in chips) 
Seat 8: H5Se03ZqSX7tbULXur2MAg ($25.50 in chips) 
Seat 9: M2QO2DxB5Wawg2h8HSpnYA ($18.55 in chips) 
Uupj2MGlo48VpA/VyYrfrw: posts small blind $0.10
aNpwfA31EREwO+ar4XzBCw: posts big blind $0.25
*** HOLE CARDS ***
H5Se03ZqSX7tbULXur2MAg: folds 
Vegaas joins the table at seat #4 
M2QO2DxB5Wawg2h8HSpnYA: folds 
zDrucyjVn5aeekNEc3cJrA: calls $0.25
Th3FldXKQW6hWVVPahaoOQ: folds 
ghNKXUBl/H+t83JF079ZBA: folds 
4oA316mXLIui1QY63GXBUg: folds 
Uupj2MGlo48VpA/VyYrfrw: calls $0.15
aNpwfA31EREwO+ar4XzBCw: checks 
*** FLOP *** [5h 9s Tc]
Uupj2MGlo48VpA/VyYrfrw: bets $0.25
aNpwfA31EREwO+ar4XzBCw: folds 
zDrucyjVn5aeekNEc3cJrA: calls $0.25
*** TURN *** [5h 9s Tc] [Ts]
Uupj2MGlo48VpA/VyYrfrw: bets $1
zDrucyjVn5aeekNEc3cJrA: folds 
Uncalled bet ($1) returned to Uupj2MGlo48VpA/VyYrfrw
Uupj2MGlo48VpA/VyYrfrw collected $1.20 from pot
*** SUMMARY ***
Total pot $1.25 | Rake $0.05 
Board [5h 9s Tc Ts]
Seat 1: zDrucyjVn5aeekNEc3cJrA folded on the Turn
Seat 2: Th3FldXKQW6hWVVPahaoOQ folded before Flop (didn't bet)
Seat 3: ghNKXUBl/H+t83JF079ZBA folded before Flop (didn't bet)
Seat 5: 4oA316mXLIui1QY63GXBUg (button) folded before Flop (didn't bet)
Seat 6: Uupj2MGlo48VpA/VyYrfrw (small blind) collected ($1.20)
Seat 7: aNpwfA31EREwO+ar4XzBCw (big blind) folded on the Flop
Seat 8: H5Se03ZqSX7tbULXur2MAg folded before Flop (didn't bet)
Seat 9: M2QO2DxB5Wawg2h8HSpnYA folded before Flop (didn't bet)




PokerStars Game #59939742832:  Hold'em No Limit ($0.10/$0.25) - 2009/07/01 0:47:46 ET
Table 'rO1I30HnuCPB0M8qEX1TCQ' 9-max Seat #4 is the button
Seat 1: gehe91e0IyVT0QU/XBkEyg ($25 in chips) 
Seat 3: r6hk+kJqlyUpcApRLTHqnQ ($5 in chips) 
Seat 4: spidnpwmoJ1L6yeNW7D5UA ($41.95 in chips) 
Seat 5: HVKi9hnDyvzObpL08/OarQ ($23.90 in chips) 
Seat 6: vO3QVRovWemcGMkm7ijAIA ($3.75 in chips) 
Seat 7: 4oA316mXLIui1QY63GXBUg ($30.25 in chips) 
Seat 8: DIBbjEYGs+TVdVgEB/4+3w ($36.50 in chips) 
Seat 9: PrviAnKmKklf+We6cR33cw ($30.35 in chips) 
HVKi9hnDyvzObpL08/OarQ: posts small blind $0.10
vO3QVRovWemcGMkm7ijAIA: posts big blind $0.25
gehe91e0IyVT0QU/XBkEyg: posts big blind $0.25
r6hk+kJqlyUpcApRLTHqnQ: posts big blind $0.25
*** HOLE CARDS ***
4oA316mXLIui1QY63GXBUg: folds 
DIBbjEYGs+TVdVgEB/4+3w: folds 
PrviAnKmKklf+We6cR33cw: folds 
gehe91e0IyVT0QU/XBkEyg: checks 
r6hk+kJqlyUpcApRLTHqnQ: raises $0.75 to $1
spidnpwmoJ1L6yeNW7D5UA: calls $1
HVKi9hnDyvzObpL08/OarQ: folds 
vO3QVRovWemcGMkm7ijAIA: folds 
gehe91e0IyVT0QU/XBkEyg: folds 
*** FLOP *** [Qs 4s 3c]
r6hk+kJqlyUpcApRLTHqnQ: bets $0.75
spidnpwmoJ1L6yeNW7D5UA: calls $0.75
*** TURN *** [Qs 4s 3c] [5h]
r6hk+kJqlyUpcApRLTHqnQ: bets $0.75
spidnpwmoJ1L6yeNW7D5UA: calls $0.75
*** RIVER *** [Qs 4s 3c 5h] [4c]
r6hk+kJqlyUpcApRLTHqnQ: bets $0.75
spidnpwmoJ1L6yeNW7D5UA: folds 
Uncalled bet ($0.75) returned to r6hk+kJqlyUpcApRLTHqnQ
r6hk+kJqlyUpcApRLTHqnQ collected $5.35 from pot
*** SUMMARY ***
Total pot $5.60 | Rake $0.25 
Board [Qs 4s 3c 5h 4c]
Seat 1: gehe91e0IyVT0QU/XBkEyg folded before Flop
Seat 3: r6hk+kJqlyUpcApRLTHqnQ collected ($5.35)
Seat 4: spidnpwmoJ1L6yeNW7D5UA (button) folded on the River
Seat 5: HVKi9hnDyvzObpL08/OarQ (small blind) folded before Flop
Seat 6: vO3QVRovWemcGMkm7ijAIA (big blind) folded before Flop
Seat 7: 4oA316mXLIui1QY63GXBUg folded before Flop (didn't bet)
Seat 8: DIBbjEYGs+TVdVgEB/4+3w folded before Flop (didn't bet)
Seat 9: PrviAnKmKklf+We6cR33cw folded before Flop (didn't bet)




PokerStars Game #59939743536:  Hold'em No Limit ($0.10/$0.25) - 2009/07/01 0:47:47 ET
Table 'm+FQg/QP0VP1ZA3V62WtOg' 9-max Seat #3 is the button
Seat 1: qwr38jl5txoR36M7G5qi4A ($7.50 in chips) 
Seat 2: oKO7b50N6TzXbPBr/mcrUA ($30.30 in chips) 
Seat 3: 4oA316mXLIui1QY63GXBUg ($25 in chips) 
Seat 4: 86vbuhJsyH+nbEg5qpDLyQ ($24.75 in chips) 
Seat 5: DnDcAdn9P0zGovMERigpFA ($25 in chips) 
Seat 6: 0kGr2KqzSs4y4kVqyDiTag ($6.70 in chips) 
Seat 7: MIVCHqCqqlke0Lb0z7glcw ($25.90 in chips) 
Seat 9: ghNKXUBl/H+t83JF079ZBA ($25 in chips) 
86vbuhJsyH+nbEg5qpDLyQ: posts small blind $0.10
DnDcAdn9P0zGovMERigpFA: posts big blind $0.25
4awUyiDYTgylQKXZ9faBVA: sits out 
*** HOLE CARDS ***
0kGr2KqzSs4y4kVqyDiTag: calls $0.25
MIVCHqCqqlke0Lb0z7glcw: folds 
ghNKXUBl/H+t83JF079ZBA: folds 
qwr38jl5txoR36M7G5qi4A: folds 
oKO7b50N6TzXbPBr/mcrUA: folds 
4oA316mXLIui1QY63GXBUg: folds 
86vbuhJsyH+nbEg5qpDLyQ: calls $0.15
DnDcAdn9P0zGovMERigpFA: checks 
*** FLOP *** [9d Tc Ts]
86vbuhJsyH+nbEg5qpDLyQ: checks 
DnDcAdn9P0zGovMERigpFA: checks 
0kGr2KqzSs4y4kVqyDiTag: bets $0.50
86vbuhJsyH+nbEg5qpDLyQ: folds 
DnDcAdn9P0zGovMERigpFA: folds 
Uncalled bet ($0.50) returned to 0kGr2KqzSs4y4kVqyDiTag
0kGr2KqzSs4y4kVqyDiTag collected $0.75 from pot
0kGr2KqzSs4y4kVqyDiTag: doesn't show hand 
*** SUMMARY ***
Total pot $0.75 | Rake $0 
Board [9d Tc Ts]
Seat 1: qwr38jl5txoR36M7G5qi4A folded before Flop (didn't bet)
Seat 2: oKO7b50N6TzXbPBr/mcrUA folded before Flop (didn't bet)
Seat 3: 4oA316mXLIui1QY63GXBUg (button) folded before Flop (didn't bet)
Seat 4: 86vbuhJsyH+nbEg5qpDLyQ (small blind) folded on the Flop
Seat 5: DnDcAdn9P0zGovMERigpFA (big blind) folded on the Flop
Seat 6: 0kGr2KqzSs4y4kVqyDiTag collected ($0.75)
Seat 7: MIVCHqCqqlke0Lb0z7glcw folded before Flop (didn't bet)
Seat 9: ghNKXUBl/H+t83JF079ZBA folded before Flop (didn't bet)




PokerStars Game #59939743074:  Hold'em No Limit ($0.10/$0.25) - 2009/07/01 0:47:47 ET
Table 'SHi8+hK6i7E2dJ/3Agbyig' 6-max Seat #1 is the button
Seat 1: gPEN9Zp33YTm/mu9/SYP1w ($25.75 in chips) 
Seat 2: Zijzy/UtPWzWVUo81HHVjQ ($40.55 in chips) 
Seat 4: +KSG/hZ6NXRHDk1WHcV2+Q ($11.65 in chips) 
Seat 6: NVWCcUck2mqZMp/UrHDLKQ ($18.10 in chips) 
Zijzy/UtPWzWVUo81HHVjQ: posts small blind $0.10
2p/OXJK5bWQbcvYltdbSfg: is sitting out 
+KSG/hZ6NXRHDk1WHcV2+Q: posts big blind $0.25
v8m8XHovI5tqEA9mvplDSw: sits out 
*** HOLE CARDS ***
2p/OXJK5bWQbcvYltdbSfg leaves the table
NVWCcUck2mqZMp/UrHDLKQ: calls $0.25
gPEN9Zp33YTm/mu9/SYP1w: folds 
Zijzy/UtPWzWVUo81HHVjQ: folds 
+KSG/hZ6NXRHDk1WHcV2+Q: checks 
*** FLOP *** [Qc 8h 3s]
+KSG/hZ6NXRHDk1WHcV2+Q: checks 
NVWCcUck2mqZMp/UrHDLKQ: bets $0.50
DXgVFTcE3WofABsNJ5G/nw joins the table at seat #3 
+KSG/hZ6NXRHDk1WHcV2+Q: folds 
Uncalled bet ($0.50) returned to NVWCcUck2mqZMp/UrHDLKQ
NVWCcUck2mqZMp/UrHDLKQ collected $0.60 from pot
*** SUMMARY ***
Total pot $0.60 | Rake $0 
Board [Qc 8h 3s]
Seat 1: gPEN9Zp33YTm/mu9/SYP1w (button) folded before Flop (didn't bet)
Seat 2: Zijzy/UtPWzWVUo81HHVjQ (small blind) folded before Flop
Seat 4: +KSG/hZ6NXRHDk1WHcV2+Q (big blind) folded on the Flop
Seat 6: NVWCcUck2mqZMp/UrHDLKQ collected ($0.60)




PokerStars Game #59939743592:  Hold'em No Limit ($0.10/$0.25) - 2009/07/01 0:47:47 ET
Table 'h3+tJ4Vtwq0R+eA8S73eZA' 9-max Seat #2 is the button
Seat 1: H5Se03ZqSX7tbULXur2MAg ($20.55 in chips) 
Seat 2: Th3FldXKQW6hWVVPahaoOQ ($27.05 in chips) 
Seat 3: crgjVDgmUqCw4RyLzbohWQ ($16.25 in chips) 
Seat 4: M2QO2DxB5Wawg2h8HSpnYA ($11.70 in chips) 
Seat 5: cZ99hugmLBj9KhTlc8nCSw ($31.45 in chips) 
Seat 6: TvIuLx9zUCE+9Li58iImOQ ($8.75 in chips) 
Seat 7: IIGtqtVGyvZR0ZMYMMPjeQ ($27.35 in chips) 
Seat 8: +2kMBNpY4nF1qNCRd8SJLA ($25.15 in chips) 
Seat 9: qwr38jl5txoR36M7G5qi4A ($7.90 in chips) 
crgjVDgmUqCw4RyLzbohWQ: posts small blind $0.10
M2QO2DxB5Wawg2h8HSpnYA: posts big blind $0.25
*** HOLE CARDS ***
cZ99hugmLBj9KhTlc8nCSw: folds 
TvIuLx9zUCE+9Li58iImOQ: calls $0.25
IIGtqtVGyvZR0ZMYMMPjeQ: calls $0.25
+2kMBNpY4nF1qNCRd8SJLA: folds 
qwr38jl5txoR36M7G5qi4A: folds 
H5Se03ZqSX7tbULXur2MAg: folds 
Th3FldXKQW6hWVVPahaoOQ: raises $1.25 to $1.50
crgjVDgmUqCw4RyLzbohWQ: folds 
M2QO2DxB5Wawg2h8HSpnYA: folds 
TvIuLx9zUCE+9Li58iImOQ: folds 
IIGtqtVGyvZR0ZMYMMPjeQ: calls $1.25
*** FLOP *** [Ad 9d 4d]
IIGtqtVGyvZR0ZMYMMPjeQ: checks 
Th3FldXKQW6hWVVPahaoOQ: bets $1.75
IIGtqtVGyvZR0ZMYMMPjeQ: raises $1.75 to $3.50
Th3FldXKQW6hWVVPahaoOQ: folds 
Uncalled bet ($1.75) returned to IIGtqtVGyvZR0ZMYMMPjeQ
IIGtqtVGyvZR0ZMYMMPjeQ collected $6.80 from pot
IIGtqtVGyvZR0ZMYMMPjeQ: doesn't show hand 
*** SUMMARY ***
Total pot $7.10 | Rake $0.30 
Board [Ad 9d 4d]
Seat 1: H5Se03ZqSX7tbULXur2MAg folded before Flop (didn't bet)
Seat 2: Th3FldXKQW6hWVVPahaoOQ (button) folded on the Flop
Seat 3: crgjVDgmUqCw4RyLzbohWQ (small blind) folded before Flop
Seat 4: M2QO2DxB5Wawg2h8HSpnYA (big blind) folded before Flop
Seat 5: cZ99hugmLBj9KhTlc8nCSw folded before Flop (didn't bet)
Seat 6: TvIuLx9zUCE+9Li58iImOQ folded before Flop
Seat 7: IIGtqtVGyvZR0ZMYMMPjeQ collected ($6.80)
Seat 8: +2kMBNpY4nF1qNCRd8SJLA folded before Flop (didn't bet)
Seat 9: qwr38jl5txoR36M7G5qi4A folded before Flop (didn't bet)




PokerStars Game #59939743388:  Hold'em No Limit ($0.10/$0.25) - 2009/07/01 0:47:47 ET
Table 'GrYi0DZOHD1EvB+qiLExNw' 9-max Seat #2 is the button
Seat 1: 4awUyiDYTgylQKXZ9faBVA ($25 in chips) 
Seat 2: Th3FldXKQW6hWVVPahaoOQ ($27.10 in chips) 
Seat 3: 4oA316mXLIui1QY63GXBUg ($25 in chips) 
Seat 4: 0GQg6tdDMBDzY6FKumSo9w ($47.85 in chips) 
Seat 5: cZ99hugmLBj9KhTlc8nCSw ($47.40 in chips) 
Seat 6: H9KUl8cmpLgEpOVDA00bCg ($4.20 in chips) 
Seat 7: 1Clf3cPrqoy/YgvWdWK1Xw ($5.35 in chips) 
Seat 8: nalbG/4/1Z1wQjRDWV7b2w ($9 in chips) 
Seat 9: OiV1PWZ3IkN29JlmCcnTwQ ($5 in chips) 
4oA316mXLIui1QY63GXBUg: posts small blind $0.10
0GQg6tdDMBDzY6FKumSo9w: posts big blind $0.25
*** HOLE CARDS ***
cZ99hugmLBj9KhTlc8nCSw: folds 
H9KUl8cmpLgEpOVDA00bCg: folds 
1Clf3cPrqoy/YgvWdWK1Xw has timed out
1Clf3cPrqoy/YgvWdWK1Xw: folds 
1Clf3cPrqoy/YgvWdWK1Xw is sitting out
nalbG/4/1Z1wQjRDWV7b2w: raises $0.25 to $0.50
OiV1PWZ3IkN29JlmCcnTwQ: folds 
4awUyiDYTgylQKXZ9faBVA: folds 
Th3FldXKQW6hWVVPahaoOQ: folds 
4oA316mXLIui1QY63GXBUg: folds 
0GQg6tdDMBDzY6FKumSo9w: calls $0.25
*** FLOP *** [9c 7c 9d]
1Clf3cPrqoy/YgvWdWK1Xw has returned
0GQg6tdDMBDzY6FKumSo9w: checks 
nalbG/4/1Z1wQjRDWV7b2w: bets $0.50
0GQg6tdDMBDzY6FKumSo9w: calls $0.50
*** TURN *** [9c 7c 9d] [7s]
0GQg6tdDMBDzY6FKumSo9w: bets $0.50
nalbG/4/1Z1wQjRDWV7b2w: calls $0.50
*** RIVER *** [9c 7c 9d 7s] [Qd]
0GQg6tdDMBDzY6FKumSo9w: bets $1.25
nalbG/4/1Z1wQjRDWV7b2w: calls $1.25
*** SHOW DOWN ***
0GQg6tdDMBDzY6FKumSo9w: shows [Th Jd] (two pair, Nines and Sevens)
nalbG/4/1Z1wQjRDWV7b2w: shows [Ac 2c] (two pair, Nines and Sevens - Ace kicker)
nalbG/4/1Z1wQjRDWV7b2w collected $5.35 from pot
*** SUMMARY ***
Total pot $5.60 | Rake $0.25 
Board [9c 7c 9d 7s Qd]
Seat 1: 4awUyiDYTgylQKXZ9faBVA folded before Flop (didn't bet)
Seat 2: Th3FldXKQW6hWVVPahaoOQ (button) folded before Flop (didn't bet)
Seat 3: 4oA316mXLIui1QY63GXBUg (small blind) folded before Flop
Seat 4: 0GQg6tdDMBDzY6FKumSo9w (big blind) showed [Th Jd] and lost with two pair, Nines and Sevens
Seat 5: cZ99hugmLBj9KhTlc8nCSw folded before Flop (didn't bet)
Seat 6: H9KUl8cmpLgEpOVDA00bCg folded before Flop (didn't bet)
Seat 7: 1Clf3cPrqoy/YgvWdWK1Xw folded before Flop (didn't bet)
Seat 8: nalbG/4/1Z1wQjRDWV7b2w showed [Ac 2c] and won ($5.35) with two pair, Nines and Sevens
Seat 9: OiV1PWZ3IkN29JlmCcnTwQ folded before Flop (didn't bet)




PokerStars Game #59939743046:  Hold'em No Limit ($0.10/$0.25) - 2009/07/01 0:47:47 ET
Table 'UVjmXTtsmlX1HxwwZ59akg' 9-max Seat #4 is the button
Seat 1: zDrucyjVn5aeekNEc3cJrA ($28.25 in chips) 
Seat 4: lesMFbAzECwhRvI2qQ9kkg ($5.20 in chips) 
Seat 9: RHUxTtZkMrryUUwjBqyF4Q ($15.10 in chips) 
RHUxTtZkMrryUUwjBqyF4Q: posts small blind $0.10
zDrucyjVn5aeekNEc3cJrA: posts big blind $0.25
*** HOLE CARDS ***
lesMFbAzECwhRvI2qQ9kkg: raises $0.75 to $1
RHUxTtZkMrryUUwjBqyF4Q: folds 
zDrucyjVn5aeekNEc3cJrA: folds 
Uncalled bet ($0.75) returned to lesMFbAzECwhRvI2qQ9kkg
lesMFbAzECwhRvI2qQ9kkg collected $0.60 from pot
lesMFbAzECwhRvI2qQ9kkg: shows [Ks Ac] (high card Ace)
*** SUMMARY ***
Total pot $0.60 | Rake $0 
Seat 1: zDrucyjVn5aeekNEc3cJrA (big blind) folded before Flop
Seat 4: lesMFbAzECwhRvI2qQ9kkg (button) collected ($0.60)
Seat 9: RHUxTtZkMrryUUwjBqyF4Q (small blind) folded before Flop




PokerStars Game #59939743202:  Hold'em No Limit ($0.10/$0.25) - 2009/07/01 0:47:47 ET
Table 'P1IJQ2p3ACFySC35W1qwQw' 9-max Seat #1 is the button
Seat 1: hBMUlEpyU74r/fwDgIpXjQ ($25 in chips) 
Seat 2: E0iYnEVO2ho7dH3QcCjw7g ($19.75 in chips) 
Seat 3: BX9NgIrtlXh1K47KYMsMtQ ($10 in chips) 
Seat 4: LuckyShot



PokerStars Game #59939743088:  Hold'em No Limit ($0.10/$0.25) - 2009/07/01 0:47:47 ET
Table 'M7d9IrgQUUFFy/SZ3ksLYg' 6-max Seat #5 is the button
Seat 1: cPO/1/dTcZpLkQFm3jH3Rg ($43.10 in chips) 
Seat 2: JE/wJXmjw3bpdmjwvh2pcg ($31.20 in chips) 
Seat 4: 7FmwVDcdEtxDpHmP4hOXsQ ($29.75 in chips) 
Seat 5: nc79pm0LZRdhncq55evVqA ($25 in chips) 
Seat 6: /gJNBeCkWL4o85/jvlZ4BA ($25 in chips) 
/gJNBeCkWL4o85/jvlZ4BA: posts small blind $0.10
cPO/1/dTcZpLkQFm3jH3Rg: posts big blind $0.25
DXgVFTcE3WofABsNJ5G/nw: sits out 
*** HOLE CARDS ***
JE/wJXmjw3bpdmjwvh2pcg: folds 
7FmwVDcdEtxDpHmP4hOXsQ: folds 
DXgVFTcE3WofABsNJ5G/nw leaves the table
nc79pm0LZRdhncq55evVqA: raises $0.75 to $1
/gJNBeCkWL4o85/jvlZ4BA: folds 
cPO/1/dTcZpLkQFm3jH3Rg: raises $2.25 to $3.25
nc79pm0LZRdhncq55evVqA: folds 
Uncalled bet ($2.25) returned to cPO/1/dTcZpLkQFm3jH3Rg
cPO/1/dTcZpLkQFm3jH3Rg collected $2.10 from pot
*** SUMMARY ***
Total pot $2.10 | Rake $0 
Seat 1: cPO/1/dTcZpLkQFm3jH3Rg (big blind) collected ($2.10)
Seat 2: JE/wJXmjw3bpdmjwvh2pcg folded before Flop (didn't bet)
Seat 4: 7FmwVDcdEtxDpHmP4hOXsQ folded before Flop (didn't bet)
Seat 5: nc79pm0LZRdhncq55evVqA (button) folded before Flop
Seat 6: /gJNBeCkWL4o85/jvlZ4BA (small blind) folded before Flop




PokerStars Game #59939743326:  Hold'em No Limit ($0.10/$0.25) - 2009/07/01 0:47:47 ET
Table 'QzXakDK7ZHNjgIpoUFGSKQ' 9-max Seat #5 is the button
Seat 1: vZGoOTJLQLhkPj4I+LNGig ($25 in chips) 
Seat 2: HVKi9hnDyvzObpL08/OarQ ($23.40 in chips) 
Seat 5: 7Tiam59GaMYACH/my1qVuw ($26.70 in chips) 
Seat 6: c7sk/W5UhCTyhjXh5MT/eg ($11.80 in chips) 
Seat 9: vnCdP3GsLTKadDukKcJk/Q ($25.25 in chips) 
c7sk/W5UhCTyhjXh5MT/eg: posts small blind $0.10
zUPSsmVPAK0z0iGmEx7WbA: is sitting out 
vnCdP3GsLTKadDukKcJk/Q: posts big blind $0.25
*** HOLE CARDS ***
zUPSsmVPAK0z0iGmEx7WbA leaves the table
vZGoOTJLQLhkPj4I+LNGig: folds 
HVKi9hnDyvzObpL08/OarQ: folds 
7Tiam59GaMYACH/my1qVuw: raises $0.50 to $0.75
c7sk/W5UhCTyhjXh5MT/eg: folds 
vnCdP3GsLTKadDukKcJk/Q: folds 
Uncalled bet ($0.50) returned to 7Tiam59GaMYACH/my1qVuw
7Tiam59GaMYACH/my1qVuw collected $0.60 from pot
*** SUMMARY ***
Total pot $0.60 | Rake $0 
Seat 1: vZGoOTJLQLhkPj4I+LNGig folded before Flop (didn't bet)
Seat 2: HVKi9hnDyvzObpL08/OarQ folded before Flop (didn't bet)
Seat 5: 7Tiam59GaMYACH/my1qVuw (button) collected ($0.60)
Seat 6: c7sk/W5UhCTyhjXh5MT/eg (small blind) folded before Flop
Seat 9: vnCdP3GsLTKadDukKcJk/Q (big blind) folded before Flop




PokerStars Game #59939743062:  Hold'em No Limit ($0.10/$0.25) - 2009/07/01 0:47:47 ET
Table 'T/iCKJXGphRN3xcdwfE/JQ' 6-max Seat #1 is the button
Seat 1: zZ8zH49EwNs0mqgppOaL9g ($24.15 in chips) 
Seat 2: 6qsh9pnysDKJNhfFhFmKRQ ($12.70 in chips) 
Seat 3: R6AGToFJQOYVZAjC2jXEKw ($19.95 in chips) 
Seat 4: yzFNNFIfC89bBPwpFPx2ow ($57.80 in chips) 
Seat 5: DzdrMZ6l84e65/zfW+2bcA ($5.55 in chips) 
Seat 6: jKYGBgexhqKT13Xana4EHg ($15.20 in chips) 
6qsh9pnysDKJNhfFhFmKRQ: posts small blind $0.10
R6AGToFJQOYVZAjC2jXEKw: posts big blind $0.25
*** HOLE CARDS ***
yzFNNFIfC89bBPwpFPx2ow: folds 
yzFNNFIfC89bBPwpFPx2ow leaves the table
DzdrMZ6l84e65/zfW+2bcA: folds 
jKYGBgexhqKT13Xana4EHg: calls $0.25
zZ8zH49EwNs0mqgppOaL9g: folds 
6qsh9pnysDKJNhfFhFmKRQ: folds 
Mxjust3 joins the table at seat #4 
R6AGToFJQOYVZAjC2jXEKw: checks 
*** FLOP *** [Qc 9c Kh]
6qsh9pnysDKJNhfFhFmKRQ leaves the table
R6AGToFJQOYVZAjC2jXEKw: checks 
jKYGBgexhqKT13Xana4EHg: bets $0.75
R6AGToFJQOYVZAjC2jXEKw: folds 
Uncalled bet ($0.75) returned to jKYGBgexhqKT13Xana4EHg
jKYGBgexhqKT13Xana4EHg collected $0.60 from pot
*** SUMMARY ***
Total pot $0.60 | Rake $0 
Board [Qc 9c Kh]
Seat 1: zZ8zH49EwNs0mqgppOaL9g (button) folded before Flop (didn't bet)
Seat 2: 6qsh9pnysDKJNhfFhFmKRQ (small blind) folded before Flop
Seat 3: R6AGToFJQOYVZAjC2jXEKw (big blind) folded on the Flop
Seat 4: yzFNNFIfC89bBPwpFPx2ow folded before Flop (didn't bet)
Seat 5: DzdrMZ6l84e65/zfW+2bcA folded before Flop (didn't bet)
Seat 6: jKYGBgexhqKT13Xana4EHg collected ($0.60)




PokerStars Game #59939743308:  Hold'em No Limit ($0.10/$0.25) - 2009/07/01 0:47:47 ET
Table 'isKy4XK8wJM0x735/D4hWA' 6-max Seat #4 is the button
Seat 1: 7FmwVDcdEtxDpHmP4hOXsQ ($25 in chips) 
Seat 2: WrLI51S2iMb8GLMB83gGqA ($25.50 in chips) 
Seat 3: jp34e617tIzV8tKIWmfAbA ($25 in chips) 
Seat 4: k9vn40MOqqb+xF+7GZ6v2g ($28.05 in chips) 
Seat 5: lquriepNQBhDV5P1SWHhnA ($25 in chips) 
Seat 6: M6xK/VklCvdyyrmvzATlxQ ($17.60 in chips) 
lquriepNQBhDV5P1SWHhnA: posts small blind $0.10
M6xK/VklCvdyyrmvzATlxQ: posts big blind $0.25
*** HOLE CARDS ***
7FmwVDcdEtxDpHmP4hOXsQ: folds 
WrLI51S2iMb8GLMB83gGqA: folds 
jp34e617tIzV8tKIWmfAbA: folds 
k9vn40MOqqb+xF+7GZ6v2g: folds 
lquriepNQBhDV5P1SWHhnA: folds 
Uncalled bet ($0.15) returned to M6xK/VklCvdyyrmvzATlxQ
M6xK/VklCvdyyrmvzATlxQ collected $0.20 from pot
M6xK/VklCvdyyrmvzATlxQ: doesn't show hand 
*** SUMMARY ***
Total pot $0.20 | Rake $0 
Seat 1: 7FmwVDcdEtxDpHmP4hOXsQ folded before Flop (didn't bet)
Seat 2: WrLI51S2iMb8GLMB83gGqA folded before Flop (didn't bet)
Seat 3: jp34e617tIzV8tKIWmfAbA folded before Flop (didn't bet)
Seat 4: k9vn40MOqqb+xF+7GZ6v2g (button) folded before Flop (didn't bet)
Seat 5: lquriepNQBhDV5P1SWHhnA (small blind) folded before Flop
Seat 6: M6xK/VklCvdyyrmvzATlxQ (big blind) collected ($0.20)




PokerStars Game #59939743812:  Hold'em No Limit ($0.10/$0.25) - 2009/07/01 0:47:48 ET
Table 'ggwTHpIC5qhhHJSYjK1XCw' 6-max Seat #4 is the button
Seat 1: BYxjLnV1/LL0aZcTbfAOvw ($33.55 in chips) 
Seat 2: mBAp/L4XPhNEkNUlUTV4Iw ($18.30 in chips) 
Seat 3: SxIIgwXYLkwd6m3wLyPTCw ($25 in chips) 
Seat 4: JFIAqU8lCZ0vWwEl4bdGsg ($25 in chips) 
Seat 5: 6zbQpY/G44U1Xvj7DZex0A ($41.10 in chips) 
Seat 6: QOk5VUJeDqXaA3RlMSluGA ($30.75 in chips) 
6zbQpY/G44U1Xvj7DZex0A: posts small blind $0.10
QOk5VUJeDqXaA3RlMSluGA: posts big blind $0.25
*** HOLE CARDS ***
BYxjLnV1/LL0aZcTbfAOvw: folds 
mBAp/L4XPhNEkNUlUTV4Iw: calls $0.25
SxIIgwXYLkwd6m3wLyPTCw: folds 
JFIAqU8lCZ0vWwEl4bdGsg: folds 
6zbQpY/G44U1Xvj7DZex0A: calls $0.15
QOk5VUJeDqXaA3RlMSluGA: checks 
*** FLOP *** [Jd 6c Th]
6zbQpY/G44U1Xvj7DZex0A: checks 
QOk5VUJeDqXaA3RlMSluGA: bets $0.55
mBAp/L4XPhNEkNUlUTV4Iw: raises $0.55 to $1.10
BYxjLnV1/LL0aZcTbfAOvw leaves the table
6zbQpY/G44U1Xvj7DZex0A: folds 
QOk5VUJeDqXaA3RlMSluGA: calls $0.55
*** TURN *** [Jd 6c Th] [Qh]
QOk5VUJeDqXaA3RlMSluGA: checks 
volarimesh joins the table at seat #1 
mBAp/L4XPhNEkNUlUTV4Iw: bets $2
QOk5VUJeDqXaA3RlMSluGA: calls $2
*** RIVER *** [Jd 6c Th Qh] [3c]
QOk5VUJeDqXaA3RlMSluGA: checks 
mBAp/L4XPhNEkNUlUTV4Iw: bets $4.50
QOk5VUJeDqXaA3RlMSluGA: folds 
Uncalled bet ($4.50) returned to mBAp/L4XPhNEkNUlUTV4Iw
mBAp/L4XPhNEkNUlUTV4Iw collected $6.65 from pot
*** SUMMARY ***
Total pot $6.95 | Rake $0.30 
Board [Jd 6c Th Qh 3c]
Seat 1: BYxjLnV1/LL0aZcTbfAOvw folded before Flop (didn't bet)
Seat 2: mBAp/L4XPhNEkNUlUTV4Iw collected ($6.65)
Seat 3: SxIIgwXYLkwd6m3wLyPTCw folded before Flop (didn't bet)
Seat 4: JFIAqU8lCZ0vWwEl4bdGsg (button) folded before Flop (didn't bet)
Seat 5: 6zbQpY/G44U1Xvj7DZex0A (small blind) folded on the Flop
Seat 6: QOk5VUJeDqXaA3RlMSluGA (big blind) folded on the River




PokerStars Game #59939744140:  Hold'em No Limit ($0.10/$0.25) - 2009/07/01 0:47:48 ET
Table 'KU/HrxqxwDz8HKEhYTZ6uw' 6-max Seat #1 is the button
Seat 1: gaPMxLGp9SOj4Lq6t+/0Ig ($26.80 in chips) 
Seat 2: kG34n23qFQA3nzdOJTQ1dA ($24.40 in chips) 
Seat 3: 1jFObj6f7pP/FIdxrZFhyg ($25 in chips) 
Seat 4: ozxrnSdjO4oiCJmh7+KoTA ($25 in chips) 
Seat 5: 4YSTu0Cdzpppe1lUgCZGCQ ($38.90 in chips) 
Seat 6: QIWnfLSqfMcoFfdDe5LZPg ($18.75 in chips) 
kG34n23qFQA3nzdOJTQ1dA: posts small blind $0.10
1jFObj6f7pP/FIdxrZFhyg: posts big blind $0.25
*** HOLE CARDS ***
ozxrnSdjO4oiCJmh7+KoTA: folds 
4YSTu0Cdzpppe1lUgCZGCQ: folds 
QIWnfLSqfMcoFfdDe5LZPg: folds 
gaPMxLGp9SOj4Lq6t+/0Ig: raises $0.50 to $0.75
kG34n23qFQA3nzdOJTQ1dA: calls $0.65
1jFObj6f7pP/FIdxrZFhyg: calls $0.50
*** FLOP *** [Kc 5h 3c]
kG34n23qFQA3nzdOJTQ1dA: checks 
1jFObj6f7pP/FIdxrZFhyg: bets $1.25
gaPMxLGp9SOj4Lq6t+/0Ig: calls $1.25
kG34n23qFQA3nzdOJTQ1dA: calls $1.25
*** TURN *** [Kc 5h 3c] [6s]
kG34n23qFQA3nzdOJTQ1dA: checks 
1jFObj6f7pP/FIdxrZFhyg: bets $3.50
gaPMxLGp9SOj4Lq6t+/0Ig: calls $3.50
kG34n23qFQA3nzdOJTQ1dA: folds 
*** RIVER *** [Kc 5h 3c 6s] [8c]
1jFObj6f7pP/FIdxrZFhyg: checks 
gaPMxLGp9SOj4Lq6t+/0Ig: checks 
*** SHOW DOWN ***
1jFObj6f7pP/FIdxrZFhyg: shows [9h 4d] (high card King)
gaPMxLGp9SOj4Lq6t+/0Ig: shows [Qd Kh] (a pair of Kings)
gaPMxLGp9SOj4Lq6t+/0Ig collected $12.40 from pot
*** SUMMARY ***
Total pot $13 | Rake $0.60 
Board [Kc 5h 3c 6s 8c]
Seat 1: gaPMxLGp9SOj4Lq6t+/0Ig (button) showed [Qd Kh] and won ($12.40) with a pair of Kings
Seat 2: kG34n23qFQA3nzdOJTQ1dA (small blind) folded on the Turn
Seat 3: 1jFObj6f7pP/FIdxrZFhyg (big blind) showed [9h 4d] and lost with high card King
Seat 4: ozxrnSdjO4oiCJmh7+KoTA folded before Flop (didn't bet)
Seat 5: 4YSTu0Cdzpppe1lUgCZGCQ folded before Flop (didn't bet)
Seat 6: QIWnfLSqfMcoFfdDe5LZPg folded before Flop (didn't bet)




PokerStars Game #59939743844:  Hold'em No Limit ($0.10/$0.25) - 2009/07/01 0:47:48 ET
Table 'i8VqsSY3xDtJ63IHleN8+A' 9-max Seat #9 is the button
Seat 1: D3XCkXRktDfPlSguxwfnRA ($14.65 in chips) 
Seat 3: HPEB+AtKw1+C/cxU0o1ciw ($55.85 in chips) 
Seat 4: G2offPrpnppc++nuXqs2JA ($14.65 in chips) 
Seat 5: DIBbjEYGs+TVdVgEB/4+3w ($25.05 in chips) 
Seat 7: j4q3p0lesp63b1gZDwLBZw ($10.35 in chips) 
Seat 9: vSkQm2EelzwRGDDQQk0Fqw ($7.45 in chips) 
D3XCkXRktDfPlSguxwfnRA: posts small blind $0.10
SXqVW4Q0evTUVZG6BbUNIA: is sitting out 
HPEB+AtKw1+C/cxU0o1ciw: posts big blind $0.25
*** HOLE CARDS ***
SXqVW4Q0evTUVZG6BbUNIA leaves the table
G2offPrpnppc++nuXqs2JA: folds 
DIBbjEYGs+TVdVgEB/4+3w: folds 
j4q3p0lesp63b1gZDwLBZw: folds 
j4q3p0lesp63b1gZDwLBZw leaves the table
vSkQm2EelzwRGDDQQk0Fqw: folds 
D3XCkXRktDfPlSguxwfnRA: calls $0.15
HPEB+AtKw1+C/cxU0o1ciw: raises $0.75 to $1
D3XCkXRktDfPlSguxwfnRA: folds 
Uncalled bet ($0.75) returned to HPEB+AtKw1+C/cxU0o1ciw
HPEB+AtKw1+C/cxU0o1ciw collected $0.50 from pot
HPEB+AtKw1+C/cxU0o1ciw: doesn't show hand 
*** SUMMARY ***
Total pot $0.50 | Rake $0 
Seat 1: D3XCkXRktDfPlSguxwfnRA (small blind) folded before Flop
Seat 3: HPEB+AtKw1+C/cxU0o1ciw (big blind) collected ($0.50)
Seat 4: G2offPrpnppc++nuXqs2JA folded before Flop (didn't bet)
Seat 5: DIBbjEYGs+TVdVgEB/4+3w folded before Flop (didn't bet)
Seat 7: j4q3p0lesp63b1gZDwLBZw folded before Flop (didn't bet)
Seat 9: vSkQm2EelzwRGDDQQk0Fqw (button) folded before Flop (didn't bet)




PokerStars Game #59939743796:  Hold'em No Limit ($0.10/$0.25) - 2009/07/01 0:47:48 ET
Table 'RUOqTfzbAVGS5x+J9aZMHA' 9-max Seat #9 is the button
Seat 1: KBBTLXGhPdPj+4X0QKMkcg ($12.50 in chips) 
Seat 2: Z5ZtGOON8kmSdSCll9Z3XA ($9.35 in chips) 
Seat 3: JtVGnq5doRa3PublncR+Yw ($23.50 in chips) 
Seat 4: K9Az8li/CO2TicltVWKamA ($10.40 in chips) 
Seat 5: opOCI2p6kW0tINuVaAqmcQ ($25 in chips) 
Seat 6: ljemhp25Zg+nlA9DLCIiUw ($40.15 in chips) 
Seat 7: HxDF4QSxC4z39D7teZpprQ ($5.40 in chips) 
Seat 8: 3RCAkueG3Vc13VpRStCB+w ($23.75 in chips) 
Seat 9: cZ99hugmLBj9KhTlc8nCSw ($25 in chips) 
KBBTLXGhPdPj+4X0QKMkcg: posts small blind $0.10
Z5ZtGOON8kmSdSCll9Z3XA: posts big blind $0.25
*** HOLE CARDS ***
JtVGnq5doRa3PublncR+Yw: folds 
K9Az8li/CO2TicltVWKamA: raises $0.50 to $0.75
JtVGnq5doRa3PublncR+Yw said, "no **** ******"
opOCI2p6kW0tINuVaAqmcQ: folds 
ljemhp25Zg+nlA9DLCIiUw: folds 
HxDF4QSxC4z39D7teZpprQ: folds 
3RCAkueG3Vc13VpRStCB+w: folds 
cZ99hugmLBj9KhTlc8nCSw: folds 
KBBTLXGhPdPj+4X0QKMkcg: calls $0.65
Z5ZtGOON8kmSdSCll9Z3XA: folds 
*** FLOP *** [Tc 2h Th]
KBBTLXGhPdPj+4X0QKMkcg: bets $1
K9Az8li/CO2TicltVWKamA: folds 
Uncalled bet ($1) returned to KBBTLXGhPdPj+4X0QKMkcg
KBBTLXGhPdPj+4X0QKMkcg collected $1.70 from pot
*** SUMMARY ***
Total pot $1.75 | Rake $0.05 
Board [Tc 2h Th]
Seat 1: KBBTLXGhPdPj+4X0QKMkcg (small blind) collected ($1.70)
Seat 2: Z5ZtGOON8kmSdSCll9Z3XA (big blind) folded before Flop
Seat 3: JtVGnq5doRa3PublncR+Yw folded before Flop (didn't bet)
Seat 4: K9Az8li/CO2TicltVWKamA folded on the Flop
Seat 5: opOCI2p6kW0tINuVaAqmcQ folded before Flop (didn't bet)
Seat 6: ljemhp25Zg+nlA9DLCIiUw folded before Flop (didn't bet)
Seat 7: HxDF4QSxC4z39D7teZpprQ folded before Flop (didn't bet)
Seat 8: 3RCAkueG3Vc13VpRStCB+w folded before Flop (didn't bet)
Seat 9: cZ99hugmLBj9KhTlc8nCSw (button) folded before Flop (didn't bet)




PokerStars Game #59939743712:  Hold'em No Limit ($0.10/$0.25) - 2009/07/01 0:47:48 ET
Table 'ouLhepGYovxB2x0QxH7cVg' 9-max Seat #8 is the button
Seat 1: ghNKXUBl/H+t83JF079ZBA ($30.35 in chips) 
Seat 2: r1Z5m4PwSI5ANp7qCE1OJw ($12.75 in chips) 
Seat 3: SkLOm0UugROBRt2EfMpOxQ ($21.25 in chips) 
Seat 4: a0Sx6GHY7ln2Ns2C97eXeA ($29.15 in chips) 
Seat 5: 18G4P1XstjNvItdGUITxgw ($25 in chips) 
Seat 6: r6hsffOo1iKmaPYKwAZmFw ($27.55 in chips) 
Seat 7: oHv2mIZJh3H0JR+WOZteZA ($20.40 in chips) 
Seat 8: opOCI2p6kW0tINuVaAqmcQ ($29.90 in chips) 
Seat 9: fIgGw0jPUR7labvJPaPbeg ($10.55 in chips) 
fIgGw0jPUR7labvJPaPbeg: posts small blind $0.10
ghNKXUBl/H+t83JF079ZBA: posts big blind $0.25
*** HOLE CARDS ***
r1Z5m4PwSI5ANp7qCE1OJw: folds 
SkLOm0UugROBRt2EfMpOxQ: folds 
a0Sx6GHY7ln2Ns2C97eXeA: folds 
18G4P1XstjNvItdGUITxgw: folds 
r6hsffOo1iKmaPYKwAZmFw: raises $0.75 to $1
oHv2mIZJh3H0JR+WOZteZA: folds 
opOCI2p6kW0tINuVaAqmcQ: folds 
fIgGw0jPUR7labvJPaPbeg: folds 
ghNKXUBl/H+t83JF079ZBA: calls $0.75
*** FLOP *** [Kd Ah 9c]
ghNKXUBl/H+t83JF079ZBA: checks 
r6hsffOo1iKmaPYKwAZmFw: checks 
*** TURN *** [Kd Ah 9c] [Ks]
ghNKXUBl/H+t83JF079ZBA: bets $1
r6hsffOo1iKmaPYKwAZmFw: folds 
Uncalled bet ($1) returned to ghNKXUBl/H+t83JF079ZBA
ghNKXUBl/H+t83JF079ZBA collected $2 from pot
ghNKXUBl/H+t83JF079ZBA: doesn't show hand 
*** SUMMARY ***
Total pot $2.10 | Rake $0.10 
Board [Kd Ah 9c Ks]
Seat 1: ghNKXUBl/H+t83JF079ZBA (big blind) collected ($2)
Seat 2: r1Z5m4PwSI5ANp7qCE1OJw folded before Flop (didn't bet)
Seat 3: SkLOm0UugROBRt2EfMpOxQ folded before Flop (didn't bet)
Seat 4: a0Sx6GHY7ln2Ns2C97eXeA folded before Flop (didn't bet)
Seat 5: 18G4P1XstjNvItdGUITxgw folded before Flop (didn't bet)
Seat 6: r6hsffOo1iKmaPYKwAZmFw folded on the Turn
Seat 7: oHv2mIZJh3H0JR+WOZteZA folded before Flop (didn't bet)
Seat 8: opOCI2p6kW0tINuVaAqmcQ (button) folded before Flop (didn't bet)
Seat 9: fIgGw0jPUR7labvJPaPbeg (small blind) folded before Flop




PokerStars Game #59939743962:  Hold'em No Limit ($0.10/$0.25) - 2009/07/01 0:47:48 ET
Table 'nFlmVztKq1HJEWfxmdl15w' 9-max Seat #2 is the button
Seat 2: nPydKI7KXtudhyCkYtLgZA ($4.65 in chips) 
Seat 3: /XMgGtJ7mcWfe5s7McY9kw ($21.75 in chips) 
Seat 4: +5dSUwD+/k2ktlnutSMivw ($20 in chips) 
Seat 5: Tx6zQdk5Ozt9ObEBlU7jeg ($24.55 in chips) 
Seat 6: 4awUyiDYTgylQKXZ9faBVA ($29.25 in chips) 
Seat 7: Mm1VqYDg+pZQ8ufUXZHA1g ($8.65 in chips) 
Seat 8: +2kMBNpY4nF1qNCRd8SJLA ($28.75 in chips) 
Seat 9: LSrAei+fS8MYG9ie/GkG0Q ($15.40 in chips) 
/XMgGtJ7mcWfe5s7McY9kw: posts small blind $0.10
+5dSUwD+/k2ktlnutSMivw: posts big blind $0.25
cZ99hugmLBj9KhTlc8nCSw: sits out 
*** HOLE CARDS ***
Tx6zQdk5Ozt9ObEBlU7jeg: calls $0.25
4awUyiDYTgylQKXZ9faBVA: folds 
Mm1VqYDg+pZQ8ufUXZHA1g: calls $0.25
+2kMBNpY4nF1qNCRd8SJLA: folds 
LSrAei+fS8MYG9ie/GkG0Q: folds 
nPydKI7KXtudhyCkYtLgZA: folds 
/XMgGtJ7mcWfe5s7McY9kw: calls $0.15
+5dSUwD+/k2ktlnutSMivw: raises $1.50 to $1.75
Tx6zQdk5Ozt9ObEBlU7jeg: calls $1.50
Mm1VqYDg+pZQ8ufUXZHA1g: folds 
/XMgGtJ7mcWfe5s7McY9kw: calls $1.50
*** FLOP *** [8s 9s 8d]
/XMgGtJ7mcWfe5s7McY9kw: checks 
+5dSUwD+/k2ktlnutSMivw: bets $3
Tx6zQdk5Ozt9ObEBlU7jeg: calls $3
/XMgGtJ7mcWfe5s7McY9kw: folds 
*** TURN *** [8s 9s 8d] [3h]
+5dSUwD+/k2ktlnutSMivw: bets $6.25
Tx6zQdk5Ozt9ObEBlU7jeg: calls $6.25
*** RIVER *** [8s 9s 8d 3h] [Kd]
+5dSUwD+/k2ktlnutSMivw: bets $3.25
Tx6zQdk5Ozt9ObEBlU7jeg: raises $4.75 to $8
Tx6zQdk5Ozt9ObEBlU7jeg said, "greed..."
+5dSUwD+/k2ktlnutSMivw: calls $4.75
*** SHOW DOWN ***
Tx6zQdk5Ozt9ObEBlU7jeg: shows [9c 8c] (a full house, Eights full of Nines)
+5dSUwD+/k2ktlnutSMivw: mucks hand 
Tx6zQdk5Ozt9ObEBlU7jeg collected $38.10 from pot
*** SUMMARY ***
Total pot $40 | Rake $1.90 
Board [8s 9s 8d 3h Kd]
Seat 2: nPydKI7KXtudhyCkYtLgZA (button) folded before Flop (didn't bet)
Seat 3: /XMgGtJ7mcWfe5s7McY9kw (small blind) folded on the Flop
Seat 4: +5dSUwD+/k2ktlnutSMivw (big blind) mucked
Seat 5: Tx6zQdk5Ozt9ObEBlU7jeg showed [9c 8c] and won ($38.10) with a full house, Eights full of Nines
Seat 6: 4awUyiDYTgylQKXZ9faBVA folded before Flop (didn't bet)
Seat 7: Mm1VqYDg+pZQ8ufUXZHA1g folded before Flop
Seat 8: +2kMBNpY4nF1qNCRd8SJLA folded before Flop (didn't bet)
Seat 9: LSrAei+fS8MYG9ie/GkG0Q folded before Flop (didn't bet)




PokerStars Game #59939744398:  Hold'em No Limit ($0.10/$0.25) - 2009/07/01 0:47:49 ET
Table '5NipxzzFB2DffzDpddyQoQ' 6-max Seat #6 is the button
Seat 1: TslQs7AQSLbVtr4X8JOOOQ ($10.20 in chips) 
Seat 2: jxrNE4qd8KCOIqHjQcwCrA ($49.60 in chips) 
Seat 3: qGHGf/553gQnDoklMRe3tg ($48.80 in chips) 
Seat 4: Inq44d7PQ+8TbEKfPeuxVQ ($5.60 in chips) 
Seat 5: cS21pIxRHx5Gt42o7hPZzw ($6.25 in chips) 
Seat 6: lYjWCpfCxX2kgcHY3v4Yow ($26.20 in chips) 
TslQs7AQSLbVtr4X8JOOOQ: posts small blind $0.10
jxrNE4qd8KCOIqHjQcwCrA: posts big blind $0.25
*** HOLE CARDS ***
qGHGf/553gQnDoklMRe3tg: folds 
Inq44d7PQ+8TbEKfPeuxVQ: folds 
cS21pIxRHx5Gt42o7hPZzw: folds 
lYjWCpfCxX2kgcHY3v4Yow: folds 
TslQs7AQSLbVtr4X8JOOOQ: calls $0.15
jxrNE4qd8KCOIqHjQcwCrA: checks 
*** FLOP *** [As 5s 6d]
TslQs7AQSLbVtr4X8JOOOQ: checks 
jxrNE4qd8KCOIqHjQcwCrA: bets $0.50
TslQs7AQSLbVtr4X8JOOOQ: folds 
Uncalled bet ($0.50) returned to jxrNE4qd8KCOIqHjQcwCrA
jxrNE4qd8KCOIqHjQcwCrA collected $0.50 from pot
jxrNE4qd8KCOIqHjQcwCrA: doesn't show hand 
*** SUMMARY ***
Total pot $0.50 | Rake $0 
Board [As 5s 6d]
Seat 1: TslQs7AQSLbVtr4X8JOOOQ (small blind) folded on the Flop
Seat 2: jxrNE4qd8KCOIqHjQcwCrA (big blind) collected ($0.50)
Seat 3: qGHGf/553gQnDoklMRe3tg folded before Flop (didn't bet)
Seat 4: Inq44d7PQ+8TbEKfPeuxVQ folded before Flop (didn't bet)
Seat 5: cS21pIxRHx5Gt42o7hPZzw folded before Flop (didn't bet)
Seat 6: lYjWCpfCxX2kgcHY3v4Yow (button) folded before Flop (didn't bet)




PokerStars Game #59939744420:  Hold'em No Limit ($0.10/$0.25) - 2009/07/01 0:47:49 ET
Table 'biAgO3TKQBU8XcrVAoU5TA' 6-max Seat #5 is the button
Seat 1: i48129QFpEQQ+UN4aNtmww ($13.15 in chips) 
Seat 2: 7qRk4YH4/k/08LgJSv7rBQ ($26.50 in chips) 
Seat 3: 7AHdX4G8gYtDJyNY+wK+6Q ($40.65 in chips) 
Seat 4: 2/AObG8G5tKFCPZ+CdivJQ ($9.05 in chips) 
Seat 5: 6DwBRH+xZ12AAZmeAg+aXw ($25 in chips) 
Seat 6: //i5P+6lSkIyZsqb+ojVQA ($13.20 in chips) 
//i5P+6lSkIyZsqb+ojVQA: posts small blind $0.10
i48129QFpEQQ+UN4aNtmww: posts big blind $0.25
*** HOLE CARDS ***
7qRk4YH4/k/08LgJSv7rBQ: folds 
7AHdX4G8gYtDJyNY+wK+6Q: folds 
2/AObG8G5tKFCPZ+CdivJQ: folds 
6DwBRH+xZ12AAZmeAg+aXw: raises $0.50 to $0.75
//i5P+6lSkIyZsqb+ojVQA: calls $0.65
i48129QFpEQQ+UN4aNtmww: folds 
*** FLOP *** [Td Ts Jd]
//i5P+6lSkIyZsqb+ojVQA: checks 
6DwBRH+xZ12AAZmeAg+aXw: bets $1
//i5P+6lSkIyZsqb+ojVQA: calls $1
*** TURN *** [Td Ts Jd] [Js]
//i5P+6lSkIyZsqb+ojVQA: checks 
6DwBRH+xZ12AAZmeAg+aXw: checks 
*** RIVER *** [Td Ts Jd Js] [Qh]
//i5P+6lSkIyZsqb+ojVQA: checks 
6DwBRH+xZ12AAZmeAg+aXw: checks 
*** SHOW DOWN ***
//i5P+6lSkIyZsqb+ojVQA: shows [2s 2c] (two pair, Jacks and Tens)
6DwBRH+xZ12AAZmeAg+aXw: shows [7c 7h] (two pair, Jacks and Tens)
//i5P+6lSkIyZsqb+ojVQA collected $1.80 from pot
6DwBRH+xZ12AAZmeAg+aXw collected $1.80 from pot
*** SUMMARY ***
Total pot $3.75 | Rake $0.15 
Board [Td Ts Jd Js Qh]
Seat 1: i48129QFpEQQ+UN4aNtmww (big blind) folded before Flop
Seat 2: 7qRk4YH4/k/08LgJSv7rBQ folded before Flop (didn't bet)
Seat 3: 7AHdX4G8gYtDJyNY+wK+6Q folded before Flop (didn't bet)
Seat 4: 2/AObG8G5tKFCPZ+CdivJQ folded before Flop (didn't bet)
Seat 5: 6DwBRH+xZ12AAZmeAg+aXw (button) showed [7c 7h] and won ($1.80) with two pair, Jacks and Tens
Seat 6: //i5P+6lSkIyZsqb+ojVQA (small blind) showed [2s 2c] and won ($1.80) with two pair, Jacks and Tens




PokerStars Game #59939744852:  Hold'em No Limit ($0.10/$0.25) - 2009/07/01 0:47:49 ET
Table '9o8Yb3JpUqurD4pNVmOikQ' 6-max Seat #2 is the button
Seat 1: 5tB0F9NjPSUL4FzmzBMs2Q ($25.35 in chips) 
Seat 2: /gJNBeCkWL4o85/jvlZ4BA ($25 in chips) 
Seat 3: JgRqo1/2phbf7pab7N3BIQ ($15.05 in chips) 
Seat 4: 4kWQxGbT5FZ1dkPd1bE45Q ($25 in chips) 
Seat 5: E/9GotBXacjJ6UrYx7l+KQ ($4.75 in chips) 
Seat 6: k9vn40MOqqb+xF+7GZ6v2g ($33.55 in chips) 
JgRqo1/2phbf7pab7N3BIQ: posts small blind $0.10
4kWQxGbT5FZ1dkPd1bE45Q: posts big blind $0.25
*** HOLE CARDS ***
E/9GotBXacjJ6UrYx7l+KQ: raises $0.25 to $0.50
k9vn40MOqqb+xF+7GZ6v2g: folds 
5tB0F9NjPSUL4FzmzBMs2Q: folds 
/gJNBeCkWL4o85/jvlZ4BA: folds 
JgRqo1/2phbf7pab7N3BIQ: folds 
4kWQxGbT5FZ1dkPd1bE45Q: folds 
Uncalled bet ($0.25) returned to E/9GotBXacjJ6UrYx7l+KQ
E/9GotBXacjJ6UrYx7l+KQ collected $0.60 from pot
E/9GotBXacjJ6UrYx7l+KQ: doesn't show hand 
*** SUMMARY ***
Total pot $0.60 | Rake $0 
Seat 1: 5tB0F9NjPSUL4FzmzBMs2Q folded before Flop (didn't bet)
Seat 2: /gJNBeCkWL4o85/jvlZ4BA (button) folded before Flop (didn't bet)
Seat 3: JgRqo1/2phbf7pab7N3BIQ (small blind) folded before Flop
Seat 4: 4kWQxGbT5FZ1dkPd1bE45Q (big blind) folded before Flop
Seat 5: E/9GotBXacjJ6UrYx7l+KQ collected ($0.60)
Seat 6: k9vn40MOqqb+xF+7GZ6v2g folded before Flop (didn't bet)




PokerStars Game #59939744574:  Hold'em No Limit ($0.10/$0.25) - 2009/07/01 0:47:49 ET
Table 'mk323gviqdkOY5Aek/1EWg' 6-max Seat #6 is the button
Seat 1: e8w9qW2QMnrAqkudVQoHoA ($35.10 in chips) 
Seat 2: GC/9yVD59DUCX7hUI7gcLw ($25 in chips) 
Seat 3: aSrj4lVmn2owyQ1RbbOqxQ ($23.05 in chips) 
Seat 4: o08wk0F4gROLhZS04Iyl3w ($26.70 in chips) 
Seat 5: SFmT9ZsVopnukjvAzrxTRg ($60.70 in chips) 
Seat 6: KkXSr5xFjxLSD3wtAvT+WQ ($19.20 in chips) 
e8w9qW2QMnrAqkudVQoHoA: posts small blind $0.10
GC/9yVD59DUCX7hUI7gcLw: posts big blind $0.25
*** HOLE CARDS ***
aSrj4lVmn2owyQ1RbbOqxQ: folds 
o08wk0F4gROLhZS04Iyl3w: folds 
SFmT9ZsVopnukjvAzrxTRg: folds 
KkXSr5xFjxLSD3wtAvT+WQ: calls $0.25
e8w9qW2QMnrAqkudVQoHoA: calls $0.15
GC/9yVD59DUCX7hUI7gcLw: checks 
*** FLOP *** [Js As 5c]
e8w9qW2QMnrAqkudVQoHoA: checks 
GC/9yVD59DUCX7hUI7gcLw: checks 
KkXSr5xFjxLSD3wtAvT+WQ: checks 
*** TURN *** [Js As 5c] [9h]
e8w9qW2QMnrAqkudVQoHoA: bets $0.60
GC/9yVD59DUCX7hUI7gcLw: folds 
KkXSr5xFjxLSD3wtAvT+WQ: folds 
Uncalled bet ($0.60) returned to e8w9qW2QMnrAqkudVQoHoA
e8w9qW2QMnrAqkudVQoHoA collected $0.75 from pot
e8w9qW2QMnrAqkudVQoHoA: doesn't show hand 
*** SUMMARY ***
Total pot $0.75 | Rake $0 
Board [Js As 5c 9h]
Seat 1: e8w9qW2QMnrAqkudVQoHoA (small blind) collected ($0.75)
Seat 2: GC/9yVD59DUCX7hUI7gcLw (big blind) folded on the Turn
Seat 3: aSrj4lVmn2owyQ1RbbOqxQ folded before Flop (didn't bet)
Seat 4: o08wk0F4gROLhZS04Iyl3w folded before Flop (didn't bet)
Seat 5: SFmT9ZsVopnukjvAzrxTRg folded before Flop (didn't bet)
Seat 6: KkXSr5xFjxLSD3wtAvT+WQ (button) folded on the Turn




PokerStars Game #59939744788:  Hold'em No Limit ($0.10/$0.25) - 2009/07/01 0:47:49 ET
Table '5SUMWYuPsGiOD0FY0QbgOw' 6-max Seat #4 is the button
Seat 1: pq78iqNUnoL9mPwPKXxOzg ($13.20 in chips) 
Seat 3: JUE7yMMP0aN5jzhYbdqO6Q ($24.05 in chips) 
Seat 4: hln5cQA1YXs/ERC2LEyoSA ($11.10 in chips) 
Seat 5: v+QfkGiuj9bgtuNoVnDO8w ($29.40 in chips) 
Seat 6: jA7YMtfNUnAaebB7Lj74EA ($30.60 in chips) 
v+QfkGiuj9bgtuNoVnDO8w: posts small blind $0.10
jA7YMtfNUnAaebB7Lj74EA: posts big blind $0.25
*** HOLE CARDS ***
pq78iqNUnoL9mPwPKXxOzg: folds 
eldiablo333 joins the table at seat #2 
JUE7yMMP0aN5jzhYbdqO6Q: raises $0.75 to $1
hln5cQA1YXs/ERC2LEyoSA: calls $1
v+QfkGiuj9bgtuNoVnDO8w: folds 
jA7YMtfNUnAaebB7Lj74EA: raises $1 to $2
JUE7yMMP0aN5jzhYbdqO6Q: calls $1
hln5cQA1YXs/ERC2LEyoSA: calls $1
*** FLOP *** [4c 7d Qh]
jA7YMtfNUnAaebB7Lj74EA: checks 
JUE7yMMP0aN5jzhYbdqO6Q: bets $4.25
hln5cQA1YXs/ERC2LEyoSA: folds 
jA7YMtfNUnAaebB7Lj74EA: calls $4.25
*** TURN *** [4c 7d Qh] [Kc]
jA7YMtfNUnAaebB7Lj74EA: bets $5
JUE7yMMP0aN5jzhYbdqO6Q: folds 
Uncalled bet ($5) returned to jA7YMtfNUnAaebB7Lj74EA
jA7YMtfNUnAaebB7Lj74EA collected $13.90 from pot
*** SUMMARY ***
Total pot $14.60 | Rake $0.70 
Board [4c 7d Qh Kc]
Seat 1: pq78iqNUnoL9mPwPKXxOzg folded before Flop (didn't bet)
Seat 3: JUE7yMMP0aN5jzhYbdqO6Q folded on the Turn
Seat 4: hln5cQA1YXs/ERC2LEyoSA (button) folded on the Flop
Seat 5: v+QfkGiuj9bgtuNoVnDO8w (small blind) folded before Flop
Seat 6: jA7YMtfNUnAaebB7Lj74EA (big blind) collected ($13.90)




PokerStars Game #59939744746:  Hold'em No Limit ($0.10/$0.25) - 2009/07/01 0:47:49 ET
Table 'Qr+t8WGovMECkBv+cV1lrg' 6-max Seat #2 is the button
Seat 2: 9h7TNZ1TDGRUJXA6rI+ZTw ($15.55 in chips) 
Seat 3: bjJnMpKgoF+vgHW2f1NCsg ($17.75 in chips) 
Seat 4: 1NNFfYMd5Hsphl/FYz9fNA ($25 in chips) 
Seat 5: iwlxXocltgSdaBmusNXanQ ($23.65 in chips) 
Seat 6: j5NZbEJHsERuXjPHWqc1Nw ($13.50 in chips) 
bjJnMpKgoF+vgHW2f1NCsg: posts small blind $0.10
1NNFfYMd5Hsphl/FYz9fNA: posts big blind $0.25
*** HOLE CARDS ***
iwlxXocltgSdaBmusNXanQ: folds 
j5NZbEJHsERuXjPHWqc1Nw: calls $0.25
9h7TNZ1TDGRUJXA6rI+ZTw: folds 
bjJnMpKgoF+vgHW2f1NCsg: calls $0.15
1NNFfYMd5Hsphl/FYz9fNA: checks 
*** FLOP *** [7s 3h 8s]
bjJnMpKgoF+vgHW2f1NCsg: bets $1
1NNFfYMd5Hsphl/FYz9fNA: raises $1 to $2
j5NZbEJHsERuXjPHWqc1Nw: calls $2
bjJnMpKgoF+vgHW2f1NCsg: folds 
*** TURN *** [7s 3h 8s] [Kh]
1NNFfYMd5Hsphl/FYz9fNA: checks 
j5NZbEJHsERuXjPHWqc1Nw: bets $2
1NNFfYMd5Hsphl/FYz9fNA: folds 
Uncalled bet ($2) returned to j5NZbEJHsERuXjPHWqc1Nw
j5NZbEJHsERuXjPHWqc1Nw collected $5.50 from pot
*** SUMMARY ***
Total pot $5.75 | Rake $0.25 
Board [7s 3h 8s Kh]
Seat 2: 9h7TNZ1TDGRUJXA6rI+ZTw (button) folded before Flop (didn't bet)
Seat 3: bjJnMpKgoF+vgHW2f1NCsg (small blind) folded on the Flop
Seat 4: 1NNFfYMd5Hsphl/FYz9fNA (big blind) folded on the Turn
Seat 5: iwlxXocltgSdaBmusNXanQ folded before Flop (didn't bet)
Seat 6: j5NZbEJHsERuXjPHWqc1Nw collected ($5.50)




PokerStars Game #59939744536:  Hold'em No Limit ($0.10/$0.25) - 2009/07/01 0:47:49 ET
Table '3eK1r4Q4BSYFvsKkuTLpIA' 9-max Seat #9 is the button
Seat 1: qwr38jl5txoR36M7G5qi4A ($9 in chips) 
Seat 2: aNpwfA31EREwO+ar4XzBCw ($25 in chips) 
Seat 3: 56S3mA6Zs3pGR+0p0vUCtg ($25 in chips) 
Seat 4: S2iyN4Q7njjhguIuE5g1CQ ($24.70 in chips) 
Seat 7: GTcLfsDTPqgfHyhY9FNDMw ($7.65 in chips) 
Seat 8: Cni99AOp8W/F0ZWCuHNcIA ($10.15 in chips) 
Seat 9: +sbyWwIcFp9kP0bDtMegfQ ($37.40 in chips) 
qwr38jl5txoR36M7G5qi4A: posts small blind $0.10
aNpwfA31EREwO+ar4XzBCw: posts big blind $0.25
*** HOLE CARDS ***
56S3mA6Zs3pGR+0p0vUCtg: folds 
S2iyN4Q7njjhguIuE5g1CQ: calls $0.25
GTcLfsDTPqgfHyhY9FNDMw: folds 
Cni99AOp8W/F0ZWCuHNcIA: calls $0.25
+sbyWwIcFp9kP0bDtMegfQ: folds 
qwr38jl5txoR36M7G5qi4A: calls $0.15
aNpwfA31EREwO+ar4XzBCw: checks 
*** FLOP *** [Ts Jd 6s]
qwr38jl5txoR36M7G5qi4A: checks 
aNpwfA31EREwO+ar4XzBCw: checks 
S2iyN4Q7njjhguIuE5g1CQ: bets $0.50
Cni99AOp8W/F0ZWCuHNcIA: calls $0.50
qwr38jl5txoR36M7G5qi4A: calls $0.50
aNpwfA31EREwO+ar4XzBCw: folds 
*** TURN *** [Ts Jd 6s] [8h]
qwr38jl5txoR36M7G5qi4A: checks 
S2iyN4Q7njjhguIuE5g1CQ: bets $1
Cni99AOp8W/F0ZWCuHNcIA: calls $1
qwr38jl5txoR36M7G5qi4A: raises $1.50 to $2.50
S2iyN4Q7njjhguIuE5g1CQ: raises $1.50 to $4
Cni99AOp8W/F0ZWCuHNcIA: calls $3
qwr38jl5txoR36M7G5qi4A: raises $4.25 to $8.25 and is all-in
S2iyN4Q7njjhguIuE5g1CQ: calls $4.25
Cni99AOp8W/F0ZWCuHNcIA: calls $4.25
*** RIVER *** [Ts Jd 6s 8h] [5h]
S2iyN4Q7njjhguIuE5g1CQ: bets $2
Cni99AOp8W/F0ZWCuHNcIA: folds 
Uncalled bet ($2) returned to S2iyN4Q7njjhguIuE5g1CQ
*** SHOW DOWN ***
S2iyN4Q7njjhguIuE5g1CQ: shows [Js 7c] (a pair of Jacks)
qwr38jl5txoR36M7G5qi4A: shows [9s Qd] (a straight, Eight to Queen)
qwr38jl5txoR36M7G5qi4A collected $25.90 from pot
*** SUMMARY ***
Total pot $27.25 | Rake $1.35 
Board [Ts Jd 6s 8h 5h]
Seat 1: qwr38jl5txoR36M7G5qi4A (small blind) showed [9s Qd] and won ($25.90) with a straight, Eight to Queen
Seat 2: aNpwfA31EREwO+ar4XzBCw (big blind) folded on the Flop
Seat 3: 56S3mA6Zs3pGR+0p0vUCtg folded before Flop (didn't bet)
Seat 4: S2iyN4Q7njjhguIuE5g1CQ showed [Js 7c] and lost with a pair of Jacks
Seat 7: GTcLfsDTPqgfHyhY9FNDMw folded before Flop (didn't bet)
Seat 8: Cni99AOp8W/F0ZWCuHNcIA folded on the River
Seat 9: +sbyWwIcFp9kP0bDtMegfQ (button) folded before Flop (didn't bet)




PokerStars Game #59939745478:  Hold'em No Limit ($0.10/$0.25) - 2009/07/01 0:47:50 ET
Table 'MJ1SB76A4qJrlEa+C5e/8w' 6-max Seat #3 is the button
Seat 2: UA5OsKS3VPaxa7uC8La/kA ($25 in chips) 
Seat 3: IrrSNlaIjHnZjG6E7LgmEg ($14.20 in chips) 
Seat 4: 6boOPJDTFiEyZD2WdW0kCA ($12.65 in chips) 
Seat 5: eHsmIvAb2JREg4O6hNPnXg ($15.05 in chips) 
Seat 6: JFIAqU8lCZ0vWwEl4bdGsg ($29.30 in chips) 
6boOPJDTFiEyZD2WdW0kCA: posts small blind $0.10
eHsmIvAb2JREg4O6hNPnXg: posts big blind $0.25
*** HOLE CARDS ***
JFIAqU8lCZ0vWwEl4bdGsg: folds 
UA5OsKS3VPaxa7uC8La/kA: raises $0.50 to $0.75
IrrSNlaIjHnZjG6E7LgmEg: folds 
6boOPJDTFiEyZD2WdW0kCA: folds 
eHsmIvAb2JREg4O6hNPnXg: folds 
Uncalled bet ($0.50) returned to UA5OsKS3VPaxa7uC8La/kA
UA5OsKS3VPaxa7uC8La/kA collected $0.60 from pot
*** SUMMARY ***
Total pot $0.60 | Rake $0 
Seat 2: UA5OsKS3VPaxa7uC8La/kA collected ($0.60)
Seat 3: IrrSNlaIjHnZjG6E7LgmEg (button) folded before Flop (didn't bet)
Seat 4: 6boOPJDTFiEyZD2WdW0kCA (small blind) folded before Flop
Seat 5: eHsmIvAb2JREg4O6hNPnXg (big blind) folded before Flop
Seat 6: JFIAqU8lCZ0vWwEl4bdGsg folded before Flop (didn't bet)




PokerStars Game #59939745258:  Hold'em No Limit ($0.10/$0.25) - 2009/07/01 0:47:50 ET
Table 'zW+7jPbOLCvlPu+dUGY5WQ' 6-max Seat #2 is the button
Seat 1: UfU14XiqkyIQoIJy9COOsQ ($25 in chips) 
Seat 2: MkNgTuvyxpHXkeIm5JITHQ ($10.25 in chips) 
Seat 3: A/hdSH6onjy+0fc+uvZ+LA ($4.75 in chips) 
A/hdSH6onjy+0fc+uvZ+LA: posts small blind $0.10
UfU14XiqkyIQoIJy9COOsQ: posts big blind $0.25
*** HOLE CARDS ***
MkNgTuvyxpHXkeIm5JITHQ: raises $0.50 to $0.75
A/hdSH6onjy+0fc+uvZ+LA: folds 
UfU14XiqkyIQoIJy9COOsQ: calls $0.50
*** FLOP *** [5c Th 9h]
UfU14XiqkyIQoIJy9COOsQ: checks 
MkNgTuvyxpHXkeIm5JITHQ: bets $0.75
UfU14XiqkyIQoIJy9COOsQ: folds 
Uncalled bet ($0.75) returned to MkNgTuvyxpHXkeIm5JITHQ
MkNgTuvyxpHXkeIm5JITHQ collected $1.55 from pot
MkNgTuvyxpHXkeIm5JITHQ: doesn't show hand 
MkNgTuvyxpHXkeIm5JITHQ is sitting out
*** SUMMARY ***
Total pot $1.60 | Rake $0.05 
Board [5c Th 9h]
Seat 1: UfU14XiqkyIQoIJy9COOsQ (big blind) folded on the Flop
Seat 2: MkNgTuvyxpHXkeIm5JITHQ (button) collected ($1.55)
Seat 3: A/hdSH6onjy+0fc+uvZ+LA (small blind) folded before Flop




PokerStars Game #59939745090:  Hold'em No Limit ($0.10/$0.25) - 2009/07/01 0:47:50 ET
Table '8QBBaev+cI2i/r2H6ml/lg' 9-max Seat #4 is the button
Seat 1: J+/gREJjzabbnYljjxEIRA ($5 in chips) 
Seat 4: ZoG0obuajzVjwgd7lNHjgg ($3.75 in chips) 
Seat 6: cxE+szmvEUe7vE+z2ozM2Q ($11.20 in chips) 
cxE+szmvEUe7vE+z2ozM2Q: posts small blind $0.10
J+/gREJjzabbnYljjxEIRA: posts big blind $0.25
*** HOLE CARDS ***
ZoG0obuajzVjwgd7lNHjgg: folds 
cxE+szmvEUe7vE+z2ozM2Q: folds 
Uncalled bet ($0.15) returned to J+/gREJjzabbnYljjxEIRA
W4TLQcZ2TiM73eIgpIvlGg joins the table at seat #3 
J+/gREJjzabbnYljjxEIRA collected $0.20 from pot
*** SUMMARY ***
Total pot $0.20 | Rake $0 
Seat 1: J+/gREJjzabbnYljjxEIRA (big blind) collected ($0.20)
Seat 4: ZoG0obuajzVjwgd7lNHjgg (button) folded before Flop (didn't bet)
Seat 6: cxE+szmvEUe7vE+z2ozM2Q (small blind) folded before Flop




PokerStars Game #59939745444:  Hold'em No Limit ($0.10/$0.25) - 2009/07/01 0:47:50 ET
Table 'hOE09W281uSob0XeJmUcRg' 6-max Seat #3 is the button
Seat 1: edio/rLJ06xeZOfLhoL3UA ($30.10 in chips) 
Seat 2: GJsS3gwVwlbyroaWrnjqJg ($25.40 in chips) 
Seat 3: ZnMMHE6UGPdJdhLIYgoXfw ($25.20 in chips) 
Seat 4: TslQs7AQSLbVtr4X8JOOOQ ($18.95 in chips) 
Seat 5: 66a/8+qw1AZLNh63FuclPA ($83.95 in chips) 
Seat 6: x4ZJ8E/TUrtoB7WiHcv8WA ($7 in chips) 
TslQs7AQSLbVtr4X8JOOOQ: posts small blind $0.10
66a/8+qw1AZLNh63FuclPA: posts big blind $0.25
*** HOLE CARDS ***
x4ZJ8E/TUrtoB7WiHcv8WA: folds 
edio/rLJ06xeZOfLhoL3UA: raises $1 to $1.25
GJsS3gwVwlbyroaWrnjqJg: folds 
ZnMMHE6UGPdJdhLIYgoXfw: folds 
TslQs7AQSLbVtr4X8JOOOQ: folds 
66a/8+qw1AZLNh63FuclPA: folds 
Uncalled bet ($1) returned to edio/rLJ06xeZOfLhoL3UA
edio/rLJ06xeZOfLhoL3UA collected $0.60 from pot
edio/rLJ06xeZOfLhoL3UA: doesn't show hand 
*** SUMMARY ***
Total pot $0.60 | Rake $0 
Seat 1: edio/rLJ06xeZOfLhoL3UA collected ($0.60)
Seat 2: GJsS3gwVwlbyroaWrnjqJg folded before Flop (didn't bet)
Seat 3: ZnMMHE6UGPdJdhLIYgoXfw (button) folded before Flop (didn't bet)
Seat 4: TslQs7AQSLbVtr4X8JOOOQ (small blind) folded before Flop
Seat 5: 66a/8+qw1AZLNh63FuclPA (big blind) folded before Flop
Seat 6: x4ZJ8E/TUrtoB7WiHcv8WA folded before Flop (didn't bet)




PokerStars Game #59939745228:  Hold'em No Limit ($0.10/$0.25) - 2009/07/01 0:47:50 ET
Table '9HJEqVOjSU5ECoVB4C4sgQ' 6-max Seat #1 is the button
Seat 1: SFmT9ZsVopnukjvAzrxTRg ($25 in chips) 
Seat 2: sEQx9G5Cu8k1HNdQasxvUA ($29.60 in chips) 
Seat 3: KM6ogk7SqyRlk3m9b0h+7A ($18.45 in chips) 
Seat 4: mfrkWA3PTeYPkbO6hi98Aw ($30.45 in chips) 
Seat 5: uH0CnA501RcgzNdK3N+BWw ($14.70 in chips) 
Seat 6: aOMbOQ6Ji1Gie6dYOurd5A ($15.35 in chips) 
sEQx9G5Cu8k1HNdQasxvUA: posts small blind $0.10
KM6ogk7SqyRlk3m9b0h+7A: posts big blind $0.25
*** HOLE CARDS ***
mfrkWA3PTeYPkbO6hi98Aw: folds 
uH0CnA501RcgzNdK3N+BWw: calls $0.25
aOMbOQ6Ji1Gie6dYOurd5A: calls $0.25
SFmT9ZsVopnukjvAzrxTRg: folds 
sEQx9G5Cu8k1HNdQasxvUA: raises $1 to $1.25
KM6ogk7SqyRlk3m9b0h+7A: folds 
uH0CnA501RcgzNdK3N+BWw: folds 
aOMbOQ6Ji1Gie6dYOurd5A: calls $1
*** FLOP *** [7d Ah 9h]
sEQx9G5Cu8k1HNdQasxvUA: checks 
aOMbOQ6Ji1Gie6dYOurd5A: checks 
*** TURN *** [7d Ah 9h] [Th]
sEQx9G5Cu8k1HNdQasxvUA: bets $2
aOMbOQ6Ji1Gie6dYOurd5A: calls $2
*** RIVER *** [7d Ah 9h Th] [5s]
sEQx9G5Cu8k1HNdQasxvUA: bets $6.25
aOMbOQ6Ji1Gie6dYOurd5A: calls $6.25
*** SHOW DOWN ***
sEQx9G5Cu8k1HNdQasxvUA: shows [Jh Ad] (a pair of Aces)
aOMbOQ6Ji1Gie6dYOurd5A: shows [5h 7h] (a flush, Ace high)
aOMbOQ6Ji1Gie6dYOurd5A collected $18.55 from pot
*** SUMMARY ***
Total pot $19.50 | Rake $0.95 
Board [7d Ah 9h Th 5s]
Seat 1: SFmT9ZsVopnukjvAzrxTRg (button) folded before Flop (didn't bet)
Seat 2: sEQx9G5Cu8k1HNdQasxvUA (small blind) showed [Jh Ad] and lost with a pair of Aces
Seat 3: KM6ogk7SqyRlk3m9b0h+7A (big blind) folded before Flop
Seat 4: mfrkWA3PTeYPkbO6hi98Aw folded before Flop (didn't bet)
Seat 5: uH0CnA501RcgzNdK3N+BWw folded before Flop
Seat 6: aOMbOQ6Ji1Gie6dYOurd5A showed [5h 7h] and won ($18.55) with a flush, Ace high




PokerStars Game #59939745158:  Hold'em No Limit ($0.10/$0.25) - 2009/07/01 0:47:50 ET
Table 'SkaFM7xfUr/Nd+JFPb7f2w' 9-max Seat #3 is the button
Seat 1: CvL9Ch1HYCVbTsfpNucitg ($4.65 in chips) 
Seat 2: QEbIGci+itdw+re8RM5fZA ($27.95 in chips) 
Seat 3: 4oA316mXLIui1QY63GXBUg ($25 in chips) 
Seat 4: DIBbjEYGs+TVdVgEB/4+3w ($38.95 in chips) 
Seat 5: GftT+l+xjKzcY0rMiNZfPg ($9.35 in chips) 
Seat 7: 7wo6Sr7QG3Zo6BaBDV1BOw ($5.85 in chips) 
Seat 8: Lro4e37x4FUa5P3yzDjskw ($12.45 in chips) 
Seat 9: STkR8XvpjNv79OOMhrlh2w ($59.10 in chips) 
DIBbjEYGs+TVdVgEB/4+3w: posts small blind $0.10
GftT+l+xjKzcY0rMiNZfPg: posts big blind $0.25
22dIObOuor/A+IKWkNoAlA: sits out 
*** HOLE CARDS ***
7wo6Sr7QG3Zo6BaBDV1BOw: folds 
Lro4e37x4FUa5P3yzDjskw: folds 
STkR8XvpjNv79OOMhrlh2w: folds 
CvL9Ch1HYCVbTsfpNucitg: folds 
QEbIGci+itdw+re8RM5fZA: folds 
4oA316mXLIui1QY63GXBUg: raises $0.75 to $1
DIBbjEYGs+TVdVgEB/4+3w: folds 
GftT+l+xjKzcY0rMiNZfPg: calls $0.75
*** FLOP *** [3c 4c 6c]
GftT+l+xjKzcY0rMiNZfPg: checks 
4oA316mXLIui1QY63GXBUg: bets $1.50
GftT+l+xjKzcY0rMiNZfPg: calls $1.50
*** TURN *** [3c 4c 6c] [Td]
GftT+l+xjKzcY0rMiNZfPg: checks 
4oA316mXLIui1QY63GXBUg: bets $3
GftT+l+xjKzcY0rMiNZfPg: calls $3
*** RIVER *** [3c 4c 6c Td] [8s]
GftT+l+xjKzcY0rMiNZfPg: checks 
4oA316mXLIui1QY63GXBUg: bets $4.50
GftT+l+xjKzcY0rMiNZfPg: folds 
Uncalled bet ($4.50) returned to 4oA316mXLIui1QY63GXBUg
4oA316mXLIui1QY63GXBUg collected $10.60 from pot
4oA316mXLIui1QY63GXBUg: doesn't show hand 
*** SUMMARY ***
Total pot $11.10 | Rake $0.50 
Board [3c 4c 6c Td 8s]
Seat 1: CvL9Ch1HYCVbTsfpNucitg folded before Flop (didn't bet)
Seat 2: QEbIGci+itdw+re8RM5fZA folded before Flop (didn't bet)
Seat 3: 4oA316mXLIui1QY63GXBUg (button) collected ($10.60)
Seat 4: DIBbjEYGs+TVdVgEB/4+3w (small blind) folded before Flop
Seat 5: GftT+l+xjKzcY0rMiNZfPg (big blind) folded on the River
Seat 7: 7wo6Sr7QG3Zo6BaBDV1BOw folded before Flop (didn't bet)
Seat 8: Lro4e37x4FUa5P3yzDjskw folded before Flop (didn't bet)
Seat 9: STkR8XvpjNv79OOMhrlh2w folded before Flop (didn't bet)




PokerStars Game #59939745010:  Hold'em No Limit ($0.10/$0.25) - 2009/07/01 0:47:50 ET
Table 'WEMI3Mtn7dGARDbgNrKibg' 9-max Seat #2 is the button
Seat 1: DlXs37dlX3tb7o/7lYXQSw ($25 in chips) 
Seat 2: tYsOBqdU1+x+yFI7zHO7hQ ($46.20 in chips) 
Seat 3: jZaChyamGXWcP+qALPP5Jg ($29.20 in chips) 
Seat 4: yyG4svzOpC1A+sUP/scg6w ($7.25 in chips) 
Seat 6: VBHxUExRAMrbxUq/cVx9Gw ($4.65 in chips) 
Seat 7: DnDcAdn9P0zGovMERigpFA ($58.65 in chips) 
Seat 8: ghNKXUBl/H+t83JF079ZBA ($27.20 in chips) 
Seat 9: NTamLAiMZ86c5yM04t96LA ($56.35 in chips) 
jZaChyamGXWcP+qALPP5Jg: posts small blind $0.10
yyG4svzOpC1A+sUP/scg6w: posts big blind $0.25
DlXs37dlX3tb7o/7lYXQSw: posts big blind $0.25
*** HOLE CARDS ***
VBHxUExRAMrbxUq/cVx9Gw: folds 
DnDcAdn9P0zGovMERigpFA: folds 
ghNKXUBl/H+t83JF079ZBA: folds 
NTamLAiMZ86c5yM04t96LA: calls $0.25
DlXs37dlX3tb7o/7lYXQSw: checks 
tYsOBqdU1+x+yFI7zHO7hQ: folds 
jZaChyamGXWcP+qALPP5Jg: folds 
yyG4svzOpC1A+sUP/scg6w: checks 
*** FLOP *** [2h 4s 3h]
yyG4svzOpC1A+sUP/scg6w: bets $0.75
NTamLAiMZ86c5yM04t96LA: folds 
DlXs37dlX3tb7o/7lYXQSw: raises $1.75 to $2.50
yyG4svzOpC1A+sUP/scg6w: calls $1.75
*** TURN *** [2h 4s 3h] [2s]
yyG4svzOpC1A+sUP/scg6w: checks 
DlXs37dlX3tb7o/7lYXQSw: bets $5
yyG4svzOpC1A+sUP/scg6w: folds 
Uncalled bet ($5) returned to DlXs37dlX3tb7o/7lYXQSw
DlXs37dlX3tb7o/7lYXQSw collected $5.60 from pot
DlXs37dlX3tb7o/7lYXQSw: doesn't show hand 
*** SUMMARY ***
Total pot $5.85 | Rake $0.25 
Board [2h 4s 3h 2s]
Seat 1: DlXs37dlX3tb7o/7lYXQSw collected ($5.60)
Seat 2: tYsOBqdU1+x+yFI7zHO7hQ (button) folded before Flop (didn't bet)
Seat 3: jZaChyamGXWcP+qALPP5Jg (small blind) folded before Flop
Seat 4: yyG4svzOpC1A+sUP/scg6w (big blind) folded on the Turn
Seat 6: VBHxUExRAMrbxUq/cVx9Gw folded before Flop (didn't bet)
Seat 7: DnDcAdn9P0zGovMERigpFA folded before Flop (didn't bet)
Seat 8: ghNKXUBl/H+t83JF079ZBA folded before Flop (didn't bet)
Seat 9: NTamLAiMZ86c5yM04t96LA folded on the Flop




PokerStars Game #59939745270:  Hold'em No Limit ($0.10/$0.25) - 2009/07/01 0:47:50 ET
Table 'z2yOdY2zyGWG1gh9WV9XtQ' 9-max Seat #7 is the button
Seat 1: k/tPF1MnFJtmPS14iqcejw ($29.60 in chips) 
Seat 2: s7Q6uNouhe7aE8JdFb9E+A ($25 in chips) 
Seat 4: BMTbQu92kfh1+tEQba3Flw ($15.80 in chips) 
Seat 5: DYB0aP91n+Rg/TIhycbaPQ ($15.95 in chips) 
Seat 6: vZGoOTJLQLhkPj4I+LNGig ($27.75 in chips) 
Seat 7: zDrucyjVn5aeekNEc3cJrA ($25.95 in chips) 
Seat 8: hIss79a4pu7GzJZepfgOpg ($26 in chips) 
Seat 9: aPRz/2GxbXANYpVsQO8pdQ ($25 in chips) 
hIss79a4pu7GzJZepfgOpg: posts small blind $0.10
aPRz/2GxbXANYpVsQO8pdQ: posts big blind $0.25
MIVCHqCqqlke0Lb0z7glcw: sits out 
*** HOLE CARDS ***
k/tPF1MnFJtmPS14iqcejw: folds 
s7Q6uNouhe7aE8JdFb9E+A: folds 
BMTbQu92kfh1+tEQba3Flw: calls $0.25
DYB0aP91n+Rg/TIhycbaPQ: calls $0.25
vZGoOTJLQLhkPj4I+LNGig: folds 
zDrucyjVn5aeekNEc3cJrA: folds 
hIss79a4pu7GzJZepfgOpg: calls $0.15
aPRz/2GxbXANYpVsQO8pdQ: checks 
*** FLOP *** [Qs 8h Ac]
hIss79a4pu7GzJZepfgOpg: bets $0.50
aPRz/2GxbXANYpVsQO8pdQ: folds 
BMTbQu92kfh1+tEQba3Flw: calls $0.50
DYB0aP91n+Rg/TIhycbaPQ: folds 
*** TURN *** [Qs 8h Ac] [3c]
hIss79a4pu7GzJZepfgOpg: checks 
BMTbQu92kfh1+tEQba3Flw: bets $1
hIss79a4pu7GzJZepfgOpg: folds 
Uncalled bet ($1) returned to BMTbQu92kfh1+tEQba3Flw
BMTbQu92kfh1+tEQba3Flw collected $1.95 from pot
BMTbQu92kfh1+tEQba3Flw: doesn't show hand 
*** SUMMARY ***
Total pot $2 | Rake $0.05 
Board [Qs 8h Ac 3c]
Seat 1: k/tPF1MnFJtmPS14iqcejw folded before Flop (didn't bet)
Seat 2: s7Q6uNouhe7aE8JdFb9E+A folded before Flop (didn't bet)
Seat 4: BMTbQu92kfh1+tEQba3Flw collected ($1.95)
Seat 5: DYB0aP91n+Rg/TIhycbaPQ folded on the Flop
Seat 6: vZGoOTJLQLhkPj4I+LNGig folded before Flop (didn't bet)
Seat 7: zDrucyjVn5aeekNEc3cJrA (button) folded before Flop (didn't bet)
Seat 8: hIss79a4pu7GzJZepfgOpg (small blind) folded on the Turn
Seat 9: aPRz/2GxbXANYpVsQO8pdQ (big blind) folded on the Flop




PokerStars Game #59939745288:  Hold'em No Limit ($0.10/$0.25) - 2009/07/01 0:47:50 ET
Table '9lYs7ljXi6AgFAxYHlKLJw' 9-max Seat #4 is the button
Seat 1: K0b5wNInj6hUGRr6yzKFtw ($25 in chips) 
Seat 2: N6fYvIzQLKaydFLKQGtMlQ ($21.75 in chips) 
Seat 3: DnDcAdn9P0zGovMERigpFA ($25 in chips) 
Seat 4: UANt6y/SmDCY/jIxkBixcw ($30.35 in chips) 
Seat 5: dfNim92Z6XK1/h5SFW5vDg ($54.95 in chips) 
Seat 6: tYsOBqdU1+x+yFI7zHO7hQ ($25 in chips) 
Seat 7: ghNKXUBl/H+t83JF079ZBA ($29.10 in chips) 
Seat 8: 8GJHzzxiotOqC5gdtgpLoA ($5.90 in chips) 
Seat 9: 18G4P1XstjNvItdGUITxgw ($36.15 in chips) 
dfNim92Z6XK1/h5SFW5vDg: posts small blind $0.10
tYsOBqdU1+x+yFI7zHO7hQ: posts big blind $0.25
*** HOLE CARDS ***
ghNKXUBl/H+t83JF079ZBA: folds 
8GJHzzxiotOqC5gdtgpLoA: folds 
18G4P1XstjNvItdGUITxgw: folds 
K0b5wNInj6hUGRr6yzKFtw: folds 
N6fYvIzQLKaydFLKQGtMlQ: folds 
DnDcAdn9P0zGovMERigpFA: folds 
UANt6y/SmDCY/jIxkBixcw: raises $0.75 to $1
dfNim92Z6XK1/h5SFW5vDg: folds 
tYsOBqdU1+x+yFI7zHO7hQ: folds 
Uncalled bet ($0.75) returned to UANt6y/SmDCY/jIxkBixcw
UANt6y/SmDCY/jIxkBixcw collected $0.60 from pot
*** SUMMARY ***
Total pot $0.60 | Rake $0 
Seat 1: K0b5wNInj6hUGRr6yzKFtw folded before Flop (didn't bet)
Seat 2: N6fYvIzQLKaydFLKQGtMlQ folded before Flop (didn't bet)
Seat 3: DnDcAdn9P0zGovMERigpFA folded before Flop (didn't bet)
Seat 4: UANt6y/SmDCY/jIxkBixcw (button) collected ($0.60)
Seat 5: dfNim92Z6XK1/h5SFW5vDg (small blind) folded before Flop
Seat 6: tYsOBqdU1+x+yFI7zHO7hQ (big blind) folded before Flop
Seat 7: ghNKXUBl/H+t83JF079ZBA folded before Flop (didn't bet)
Seat 8: 8GJHzzxiotOqC5gdtgpLoA folded before Flop (didn't bet)
Seat 9: 18G4P1XstjNvItdGUITxgw folded before Flop (didn't bet)




PokerStars Game #59939745910:  Hold'em No Limit ($0.10/$0.25) - 2009/07/01 0:47:51 ET
Table '7eunnLa5p3aGsPrUrNnn/A' 9-max Seat #6 is the button
Seat 2: aJy680tKSaP5er559aSuGA ($11.90 in chips) 
Seat 3: E0iYnEVO2ho7dH3QcCjw7g ($22.50 in chips) 
Seat 4: opOCI2p6kW0tINuVaAqmcQ ($27.85 in chips) 
Seat 5: JLfmdpDbz2ljMNE7ICboMQ ($7.70 in chips) 
Seat 6: jx9kXw1SAZrvXp9Nerz8+Q ($15.75 in chips) 
Seat 7: sD+TKtt36XiiN6jqHiLwDA ($23.15 in chips) 
Seat 8: 1Clf3cPrqoy/YgvWdWK1Xw ($5 in chips) 
Seat 9: rUpvA02nErFvZ4yFbDR8XA ($20.20 in chips) 
sD+TKtt36XiiN6jqHiLwDA: posts small blind $0.10
1Clf3cPrqoy/YgvWdWK1Xw: posts big blind $0.25
22dIObOuor/A+IKWkNoAlA: sits out 
*** HOLE CARDS ***
rUpvA02nErFvZ4yFbDR8XA: folds 
aJy680tKSaP5er559aSuGA: calls $0.25
E0iYnEVO2ho7dH3QcCjw7g: raises $0.75 to $1
opOCI2p6kW0tINuVaAqmcQ: folds 
JLfmdpDbz2ljMNE7ICboMQ: folds 
jx9kXw1SAZrvXp9Nerz8+Q: folds 
sD+TKtt36XiiN6jqHiLwDA: folds 
1Clf3cPrqoy/YgvWdWK1Xw: folds 
aJy680tKSaP5er559aSuGA: calls $0.75
*** FLOP *** [8d 4d 2s]
aJy680tKSaP5er559aSuGA: checks 
E0iYnEVO2ho7dH3QcCjw7g: bets $1.75
aJy680tKSaP5er559aSuGA: folds 
Uncalled bet ($1.75) returned to E0iYnEVO2ho7dH3QcCjw7g
E0iYnEVO2ho7dH3QcCjw7g collected $2.25 from pot
*** SUMMARY ***
Total pot $2.35 | Rake $0.10 
Board [8d 4d 2s]
Seat 2: aJy680tKSaP5er559aSuGA folded on the Flop
Seat 3: E0iYnEVO2ho7dH3QcCjw7g collected ($2.25)
Seat 4: opOCI2p6kW0tINuVaAqmcQ folded before Flop (didn't bet)
Seat 5: JLfmdpDbz2ljMNE7ICboMQ folded before Flop (didn't bet)
Seat 6: jx9kXw1SAZrvXp9Nerz8+Q (button) folded before Flop (didn't bet)
Seat 7: sD+TKtt36XiiN6jqHiLwDA (small blind) folded before Flop
Seat 8: 1Clf3cPrqoy/YgvWdWK1Xw (big blind) folded before Flop
Seat 9: rUpvA02nErFvZ4yFbDR8XA folded before Flop (didn't bet)




PokerStars Game #59939745882:  Hold'em No Limit ($0.10/$0.25) - 2009/07/01 0:47:51 ET
Table 'Pz8SfAzhP5nvWTsJRAxoDg' 6-max Seat #3 is the button
Seat 1: buyjetgNT1McXtdaP4zynA ($40.95 in chips) 
Seat 2: zxeVQGaMKDsDzmSY+AInjA ($15.90 in chips) 
Seat 3: mfrkWA3PTeYPkbO6hi98Aw ($38.45 in chips) 
Seat 4: 9U9Vy/656QCEfKznJWteag ($12.50 in chips) 
Seat 5: FYepjhAvF8ZdVCmqHIy+eQ ($30.10 in chips) 
Seat 6: FStoHe64SQWqAsjya9pDkQ ($25.70 in chips) 
9U9Vy/656QCEfKznJWteag: posts small blind $0.10
FYepjhAvF8ZdVCmqHIy+eQ: posts big blind $0.25
*** HOLE CARDS ***
FStoHe64SQWqAsjya9pDkQ: folds 
buyjetgNT1McXtdaP4zynA: folds 
zxeVQGaMKDsDzmSY+AInjA: folds 
mfrkWA3PTeYPkbO6hi98Aw: folds 
9U9Vy/656QCEfKznJWteag: calls $0.15
FYepjhAvF8ZdVCmqHIy+eQ: checks 
*** FLOP *** [7h 5s Qh]
9U9Vy/656QCEfKznJWteag: bets $0.75
FYepjhAvF8ZdVCmqHIy+eQ: folds 
Uncalled bet ($0.75) returned to 9U9Vy/656QCEfKznJWteag
9U9Vy/656QCEfKznJWteag collected $0.50 from pot
*** SUMMARY ***
Total pot $0.50 | Rake $0 
Board [7h 5s Qh]
Seat 1: buyjetgNT1McXtdaP4zynA folded before Flop (didn't bet)
Seat 2: zxeVQGaMKDsDzmSY+AInjA folded before Flop (didn't bet)
Seat 3: mfrkWA3PTeYPkbO6hi98Aw (button) folded before Flop (didn't bet)
Seat 4: 9U9Vy/656QCEfKznJWteag (small blind) collected ($0.50)
Seat 5: FYepjhAvF8ZdVCmqHIy+eQ (big blind) folded on the Flop
Seat 6: FStoHe64SQWqAsjya9pDkQ folded before Flop (didn't bet)




PokerStars Game #59939746104:  Hold'em No Limit ($0.10/$0.25) - 2009/07/01 0:47:51 ET
Table 'mNBkqbHtjDvzF6YU0ixV9Q' 9-max Seat #6 is the button
Seat 1: QsLvCwfSWqP+CfjwUnjpXQ ($16 in chips) 
Seat 4: NZlEzoTKHCxRJwJ71iDzeA ($5.45 in chips) 
Seat 6: Zb8xGmbjS8ghABxs9n6huA ($12.60 in chips) 
QsLvCwfSWqP+CfjwUnjpXQ: posts small blind $0.10
NZlEzoTKHCxRJwJ71iDzeA: posts big blind $0.25
*** HOLE CARDS ***
Zb8xGmbjS8ghABxs9n6huA: folds 
Zb8xGmbjS8ghABxs9n6huA leaves the table
QsLvCwfSWqP+CfjwUnjpXQ: calls $0.15
NZlEzoTKHCxRJwJ71iDzeA: raises $0.25 to $0.50
QsLvCwfSWqP+CfjwUnjpXQ: calls $0.25
*** FLOP *** [9c Jc As]
QsLvCwfSWqP+CfjwUnjpXQ: checks 
NZlEzoTKHCxRJwJ71iDzeA: bets $0.50
QsLvCwfSWqP+CfjwUnjpXQ: folds 
Uncalled bet ($0.50) returned to NZlEzoTKHCxRJwJ71iDzeA
NZlEzoTKHCxRJwJ71iDzeA collected $0.95 from pot
*** SUMMARY ***
Total pot $1 | Rake $0.05 
Board [9c Jc As]
Seat 1: QsLvCwfSWqP+CfjwUnjpXQ (small blind) folded on the Flop
Seat 4: NZlEzoTKHCxRJwJ71iDzeA (big blind) collected ($0.95)
Seat 6: Zb8xGmbjS8ghABxs9n6huA (button) folded before Flop (didn't bet)




PokerStars Game #59939746242:  Hold'em No Limit ($0.10/$0.25) - 2009/07/01 0:47:52 ET
Table 'sgB7AwZtVgDTf4fi8RwWFQ' 9-max Seat #1 is the button
Seat 1: QEbIGci+itdw+re8RM5fZA ($28.70 in chips) 
Seat 5: gGaFLzGESKP3Tj9N/K7QNA ($5.50 in chips) 
Seat 6: YEdelvffSYRP4EDNfFp4dA ($15.80 in chips) 
Seat 8: Nq5F1B22aaLLZ+D9HbzcGg ($24.15 in chips) 
Seat 9: MG90wfSJZnOejs/KD3vlQQ ($32.70 in chips) 
gGaFLzGESKP3Tj9N/K7QNA: posts small blind $0.10
YEdelvffSYRP4EDNfFp4dA: posts big blind $0.25
*** HOLE CARDS ***
Nq5F1B22aaLLZ+D9HbzcGg: calls $0.25
MG90wfSJZnOejs/KD3vlQQ: folds 
QEbIGci+itdw+re8RM5fZA: folds 
gGaFLzGESKP3Tj9N/K7QNA: raises $0.25 to $0.50
YEdelvffSYRP4EDNfFp4dA: calls $0.25
Nq5F1B22aaLLZ+D9HbzcGg: calls $0.25
*** FLOP *** [8s 2c 3c]
gGaFLzGESKP3Tj9N/K7QNA: checks 
YEdelvffSYRP4EDNfFp4dA: checks 
Nq5F1B22aaLLZ+D9HbzcGg: bets $0.50
gGaFLzGESKP3Tj9N/K7QNA: calls $0.50
YEdelvffSYRP4EDNfFp4dA: folds 
*** TURN *** [8s 2c 3c] [8d]
gGaFLzGESKP3Tj9N/K7QNA: checks 
Nq5F1B22aaLLZ+D9HbzcGg: bets $0.75
gGaFLzGESKP3Tj9N/K7QNA: raises $1.75 to $2.50
Nq5F1B22aaLLZ+D9HbzcGg: calls $1.75
*** RIVER *** [8s 2c 3c 8d] [Jc]
gGaFLzGESKP3Tj9N/K7QNA: bets $2 and is all-in
Nq5F1B22aaLLZ+D9HbzcGg: calls $2
*** SHOW DOWN ***
gGaFLzGESKP3Tj9N/K7QNA: shows [8c 9c] (a flush, Jack high)
Nq5F1B22aaLLZ+D9HbzcGg: mucks hand 
gGaFLzGESKP3Tj9N/K7QNA collected $10.95 from pot
*** SUMMARY ***
Total pot $11.50 | Rake $0.55 
Board [8s 2c 3c 8d Jc]
Seat 1: QEbIGci+itdw+re8RM5fZA (button) folded before Flop (didn't bet)
Seat 5: gGaFLzGESKP3Tj9N/K7QNA (small blind) showed [8c 9c] and won ($10.95) with a flush, Jack high
Seat 6: YEdelvffSYRP4EDNfFp4dA (big blind) folded on the Flop
Seat 8: Nq5F1B22aaLLZ+D9HbzcGg mucked
Seat 9: MG90wfSJZnOejs/KD3vlQQ folded before Flop (didn't bet)




PokerStars Game #59939746730:  Hold'em No Limit ($0.10/$0.25) - 2009/07/01 0:47:52 ET
Table '0mmHveGuaIfIMQlNE1eqMg' 9-max Seat #2 is the button
Seat 2: rQhYIYXSyH/IivYM1dlV5A ($56.90 in chips) 
Seat 3: ghNKXUBl/H+t83JF079ZBA ($25.50 in chips) 
Seat 4: r0/CtYRRIJAbPQm4qsv8LQ ($34.65 in chips) 
Seat 5: cVVfy+hwCb/YzSIyUWhKEw ($30.30 in chips) 
Seat 6: Xo1w+VqEZh0bV5wYupnNYg ($12.90 in chips) 
Seat 8: jiyia7h6fmxBdWBkH9lH5A ($5.05 in chips) 
Seat 9: W4TLQcZ2TiM73eIgpIvlGg ($33.65 in chips) 
ghNKXUBl/H+t83JF079ZBA: posts small blind $0.10
r0/CtYRRIJAbPQm4qsv8LQ: posts big blind $0.25
1S/fpm+f42V/6MNZre+ccg: sits out 
*** HOLE CARDS ***
cVVfy+hwCb/YzSIyUWhKEw: folds 
Xo1w+VqEZh0bV5wYupnNYg: calls $0.25
jiyia7h6fmxBdWBkH9lH5A: folds 
W4TLQcZ2TiM73eIgpIvlGg: folds 
rQhYIYXSyH/IivYM1dlV5A: folds 
ghNKXUBl/H+t83JF079ZBA: folds 
r0/CtYRRIJAbPQm4qsv8LQ: checks 
*** FLOP *** [4h 6c Ts]
r0/CtYRRIJAbPQm4qsv8LQ: bets $0.50
Xo1w+VqEZh0bV5wYupnNYg: calls $0.50
*** TURN *** [4h 6c Ts] [2h]
r0/CtYRRIJAbPQm4qsv8LQ: checks 
Xo1w+VqEZh0bV5wYupnNYg: bets $0.25
r0/CtYRRIJAbPQm4qsv8LQ: calls $0.25
*** RIVER *** [4h 6c Ts 2h] [8c]
r0/CtYRRIJAbPQm4qsv8LQ: checks 
Xo1w+VqEZh0bV5wYupnNYg: bets $1
r0/CtYRRIJAbPQm4qsv8LQ: folds 
Uncalled bet ($1) returned to Xo1w+VqEZh0bV5wYupnNYg
Xo1w+VqEZh0bV5wYupnNYg collected $2 from pot
Xo1w+VqEZh0bV5wYupnNYg: shows [8s 8h] (three of a kind, Eights)
*** SUMMARY ***
Total pot $2.10 | Rake $0.10 
Board [4h 6c Ts 2h 8c]
Seat 2: rQhYIYXSyH/IivYM1dlV5A (button) folded before Flop (didn't bet)
Seat 3: ghNKXUBl/H+t83JF079ZBA (small blind) folded before Flop
Seat 4: r0/CtYRRIJAbPQm4qsv8LQ (big blind) folded on the River
Seat 5: cVVfy+hwCb/YzSIyUWhKEw folded before Flop (didn't bet)
Seat 6: Xo1w+VqEZh0bV5wYupnNYg collected ($2)
Seat 8: jiyia7h6fmxBdWBkH9lH5A folded before Flop (didn't bet)
Seat 9: W4TLQcZ2TiM73eIgpIvlGg folded before Flop (didn't bet)




PokerStars Game #59939746640:  Hold'em No Limit ($0.10/$0.25) - 2009/07/01 0:47:52 ET
Table 'mVdLgAdN9rGe6mMwSrDdGQ' 6-max Seat #6 is the button
Seat 1: qhK49WKJUNyD5vnZcIeQdg ($6.45 in chips) 
Seat 2: fSUx4e1vURbgXyDBEcRbAg ($4.35 in chips) 
Seat 3: kG34n23qFQA3nzdOJTQ1dA ($24.55 in chips) 
Seat 4: GJsS3gwVwlbyroaWrnjqJg ($24.65 in chips) 
Seat 5: oseFhpinoe+Zg4j5xyBjyQ ($54.80 in chips) 
Seat 6: Ew/TYPQIsbQ2X8nm5iAJBg ($36.40 in chips) 
qhK49WKJUNyD5vnZcIeQdg: posts small blind $0.10
fSUx4e1vURbgXyDBEcRbAg: posts big blind $0.25
*** HOLE CARDS ***
kG34n23qFQA3nzdOJTQ1dA: folds 
GJsS3gwVwlbyroaWrnjqJg: folds 
oseFhpinoe+Zg4j5xyBjyQ: folds 
Ew/TYPQIsbQ2X8nm5iAJBg: raises $0.75 to $1
qhK49WKJUNyD5vnZcIeQdg: folds 
fSUx4e1vURbgXyDBEcRbAg: folds 
Uncalled bet ($0.75) returned to Ew/TYPQIsbQ2X8nm5iAJBg
Ew/TYPQIsbQ2X8nm5iAJBg collected $0.60 from pot
Ew/TYPQIsbQ2X8nm5iAJBg: doesn't show hand 
*** SUMMARY ***
Total pot $0.60 | Rake $0 
Seat 1: qhK49WKJUNyD5vnZcIeQdg (small blind) folded before Flop
Seat 2: fSUx4e1vURbgXyDBEcRbAg (big blind) folded before Flop
Seat 3: kG34n23qFQA3nzdOJTQ1dA folded before Flop (didn't bet)
Seat 4: GJsS3gwVwlbyroaWrnjqJg folded before Flop (didn't bet)
Seat 5: oseFhpinoe+Zg4j5xyBjyQ folded before Flop (didn't bet)
Seat 6: Ew/TYPQIsbQ2X8nm5iAJBg (button) collected ($0.60)




PokerStars Game #59939747272:  Hold'em No Limit ($0.10/$0.25) - 2009/07/01 0:47:53 ET
Table 'rhQuIjJo0UQ7RRUlF9umHg' 6-max Seat #2 is the button
Seat 1: 5O3Hj9Qg0SqOyKEXoLpjPg ($58.90 in chips) 
Seat 2: Ew/TYPQIsbQ2X8nm5iAJBg ($51 in chips) 
Seat 3: nLE5Yo60EmSlJPyg0GgxXg ($13.90 in chips) 
Seat 4: buyjetgNT1McXtdaP4zynA ($18.45 in chips) 
Seat 5: 7qRk4YH4/k/08LgJSv7rBQ ($24.60 in chips) 
Seat 6: r284m4NA4rtNktI86R8/Yw ($12.05 in chips) 
nLE5Yo60EmSlJPyg0GgxXg: posts small blind $0.10
buyjetgNT1McXtdaP4zynA: posts big blind $0.25
*** HOLE CARDS ***
7qRk4YH4/k/08LgJSv7rBQ: folds 
r284m4NA4rtNktI86R8/Yw: folds 
5O3Hj9Qg0SqOyKEXoLpjPg: calls $0.25
Ew/TYPQIsbQ2X8nm5iAJBg: folds 
nLE5Yo60EmSlJPyg0GgxXg: calls $0.15
buyjetgNT1McXtdaP4zynA: checks 
*** FLOP *** [4h 8h Ac]
nLE5Yo60EmSlJPyg0GgxXg: checks 
buyjetgNT1McXtdaP4zynA: checks 
5O3Hj9Qg0SqOyKEXoLpjPg: checks 
*** TURN *** [4h 8h Ac] [Kd]
nLE5Yo60EmSlJPyg0GgxXg: checks 
buyjetgNT1McXtdaP4zynA: checks 
5O3Hj9Qg0SqOyKEXoLpjPg: bets $0.50
nLE5Yo60EmSlJPyg0GgxXg: calls $0.50
buyjetgNT1McXtdaP4zynA: folds 
*** RIVER *** [4h 8h Ac Kd] [Qd]
nLE5Yo60EmSlJPyg0GgxXg: bets $0.25
5O3Hj9Qg0SqOyKEXoLpjPg: calls $0.25
*** SHOW DOWN ***
nLE5Yo60EmSlJPyg0GgxXg: shows [3c Ks] (a pair of Kings)
5O3Hj9Qg0SqOyKEXoLpjPg: mucks hand 
nLE5Yo60EmSlJPyg0GgxXg collected $2.15 from pot
*** SUMMARY ***
Total pot $2.25 | Rake $0.10 
Board [4h 8h Ac Kd Qd]
Seat 1: 5O3Hj9Qg0SqOyKEXoLpjPg mucked
Seat 2: Ew/TYPQIsbQ2X8nm5iAJBg (button) folded before Flop (didn't bet)
Seat 3: nLE5Yo60EmSlJPyg0GgxXg (small blind) showed [3c Ks] and won ($2.15) with a pair of Kings
Seat 4: buyjetgNT1McXtdaP4zynA (big blind) folded on the Turn
Seat 5: 7qRk4YH4/k/08LgJSv7rBQ folded before Flop (didn't bet)
Seat 6: r284m4NA4rtNktI86R8/Yw folded before Flop (didn't bet)




PokerStars Game #59939746946:  Hold'em No Limit ($0.10/$0.25) - 2009/07/01 0:47:53 ET
Table 'C8mMnVmvkagwolEzTvh07A' 9-max Seat #7 is the button
Seat 1: t2nb95S5EEFOEzNx9Itz0g ($8.40 in chips) 
Seat 2: CbXUS6Z2rXZxL1AKduNtmQ ($30.10 in chips) 
Seat 3: Th3FldXKQW6hWVVPahaoOQ ($25 in chips) 
Seat 4: dfNim92Z6XK1/h5SFW5vDg ($25 in chips) 
Seat 5: iGMlK+EhUflPB6jKQd95Cg ($25.40 in chips) 
Seat 7: qmEgnPhQt24xdw/ZRVPLbA ($34.95 in chips) 
Seat 8: N6fYvIzQLKaydFLKQGtMlQ ($22.30 in chips) 
Seat 9: 4awUyiDYTgylQKXZ9faBVA ($25 in chips) 
N6fYvIzQLKaydFLKQGtMlQ: posts small blind $0.10
4awUyiDYTgylQKXZ9faBVA: posts big blind $0.25
*** HOLE CARDS ***
t2nb95S5EEFOEzNx9Itz0g: folds 
CbXUS6Z2rXZxL1AKduNtmQ: calls $0.25
Th3FldXKQW6hWVVPahaoOQ: folds 
dfNim92Z6XK1/h5SFW5vDg: folds 
iGMlK+EhUflPB6jKQd95Cg: folds 
qmEgnPhQt24xdw/ZRVPLbA: calls $0.25
N6fYvIzQLKaydFLKQGtMlQ: folds 
4awUyiDYTgylQKXZ9faBVA: checks 
*** FLOP *** [9d Ad 3c]
4awUyiDYTgylQKXZ9faBVA: checks 
CbXUS6Z2rXZxL1AKduNtmQ: bets $0.60
qmEgnPhQt24xdw/ZRVPLbA: folds 
4awUyiDYTgylQKXZ9faBVA: folds 
Uncalled bet ($0.60) returned to CbXUS6Z2rXZxL1AKduNtmQ
CbXUS6Z2rXZxL1AKduNtmQ collected $0.85 from pot
*** SUMMARY ***
Total pot $0.85 | Rake $0 
Board [9d Ad 3c]
Seat 1: t2nb95S5EEFOEzNx9Itz0g folded before Flop (didn't bet)
Seat 2: CbXUS6Z2rXZxL1AKduNtmQ collected ($0.85)
Seat 3: Th3FldXKQW6hWVVPahaoOQ folded before Flop (didn't bet)
Seat 4: dfNim92Z6XK1/h5SFW5vDg folded before Flop (didn't bet)
Seat 5: iGMlK+EhUflPB6jKQd95Cg folded before Flop (didn't bet)
Seat 7: qmEgnPhQt24xdw/ZRVPLbA (button) folded on the Flop
Seat 8: N6fYvIzQLKaydFLKQGtMlQ (small blind) folded before Flop
Seat 9: 4awUyiDYTgylQKXZ9faBVA (big blind) folded on the Flop




PokerStars Game #59939747024:  Hold'em No Limit ($0.10/$0.25) - 2009/07/01 0:47:53 ET
Table 'S6s+TmTlAjLHclBRvN5/fw' 9-max Seat #7 is the button
Seat 1: /XMgGtJ7mcWfe5s7McY9kw ($24.60 in chips) 
Seat 2: GGVjFwYkbwsuyKljxyML4g ($29.35 in chips) 
Seat 3: imHPFFqvfHGzsBBWeGuy4w ($20.95 in chips) 
Seat 4: M/9j4wkHH9i1JM51vgi1VA ($38.60 in chips) 
Seat 5: z5GxcHlYz/GSz6W2uFiTtg ($24.30 in chips) 
Seat 6: aNpwfA31EREwO+ar4XzBCw ($25 in chips) 
Seat 7: vSkQm2EelzwRGDDQQk0Fqw ($5 in chips) 
Seat 8: 42xLFHn85WRGGaaUZTNvwA ($10 in chips) 
Seat 9: BODayQmPi2rEfae9e6hIlw ($25 in chips) 
42xLFHn85WRGGaaUZTNvwA: posts small blind $0.10
BODayQmPi2rEfae9e6hIlw: posts big blind $0.25
*** HOLE CARDS ***
/XMgGtJ7mcWfe5s7McY9kw: folds 
GGVjFwYkbwsuyKljxyML4g: folds 
imHPFFqvfHGzsBBWeGuy4w: folds 
M/9j4wkHH9i1JM51vgi1VA: folds 
z5GxcHlYz/GSz6W2uFiTtg: folds 
aNpwfA31EREwO+ar4XzBCw: folds 
vSkQm2EelzwRGDDQQk0Fqw: folds 
42xLFHn85WRGGaaUZTNvwA: raises $0.50 to $0.75
BODayQmPi2rEfae9e6hIlw: calls $0.50
*** FLOP *** [Ah 6d 7c]
42xLFHn85WRGGaaUZTNvwA: checks 
BODayQmPi2rEfae9e6hIlw: checks 
*** TURN *** [Ah 6d 7c] [3h]
42xLFHn85WRGGaaUZTNvwA: bets $0.25
BODayQmPi2rEfae9e6hIlw: raises $1.25 to $1.50
42xLFHn85WRGGaaUZTNvwA: calls $1.25
*** RIVER *** [Ah 6d 7c 3h] [4c]
42xLFHn85WRGGaaUZTNvwA: checks 
BODayQmPi2rEfae9e6hIlw: checks 
*** SHOW DOWN ***
42xLFHn85WRGGaaUZTNvwA: shows [8s 3c] (a pair of Threes)
BODayQmPi2rEfae9e6hIlw: mucks hand 
42xLFHn85WRGGaaUZTNvwA collected $4.30 from pot
*** SUMMARY ***
Total pot $4.50 | Rake $0.20 
Board [Ah 6d 7c 3h 4c]
Seat 1: /XMgGtJ7mcWfe5s7McY9kw folded before Flop (didn't bet)
Seat 2: GGVjFwYkbwsuyKljxyML4g folded before Flop (didn't bet)
Seat 3: imHPFFqvfHGzsBBWeGuy4w folded before Flop (didn't bet)
Seat 4: M/9j4wkHH9i1JM51vgi1VA folded before Flop (didn't bet)
Seat 5: z5GxcHlYz/GSz6W2uFiTtg folded before Flop (didn't bet)
Seat 6: aNpwfA31EREwO+ar4XzBCw folded before Flop (didn't bet)
Seat 7: vSkQm2EelzwRGDDQQk0Fqw (button) folded before Flop (didn't bet)
Seat 8: 42xLFHn85WRGGaaUZTNvwA (small blind) showed [8s 3c] and won ($4.30) with a pair of Threes
Seat 9: BODayQmPi2rEfae9e6hIlw (big blind) mucked




PokerStars Game #59939747144:  Hold'em No Limit ($0.10/$0.25) - 2009/07/01 0:47:53 ET
Table 'YlRA05h9BJ1EhOUSNUjJdg' 9-max Seat #4 is the button
Seat 1: 5gHh6iDvZdEvYi59Pko1iA ($4 in chips) 
Seat 2: Y2GFAe+PT7xnUUtgqCNDFw ($5 in chips) 
Seat 3: C91Mv1usdi9Vq9ljlQVsug ($52.95 in chips) 
Seat 4: HPEB+AtKw1+C/cxU0o1ciw ($44.70 in chips) 
Seat 5: oKO7b50N6TzXbPBr/mcrUA ($24.40 in chips) 
Seat 6: QEbIGci+itdw+re8RM5fZA ($25 in chips) 
Seat 7: oVDuzcEt1umAPOB/u6ZH9g ($25.10 in chips) 
Seat 8: j4q3p0lesp63b1gZDwLBZw ($5 in chips) 
Seat 9: hBMUlEpyU74r/fwDgIpXjQ ($27.30 in chips) 
oKO7b50N6TzXbPBr/mcrUA: posts small blind $0.10
QEbIGci+itdw+re8RM5fZA: posts big blind $0.25
*** HOLE CARDS ***
oVDuzcEt1umAPOB/u6ZH9g: folds 
j4q3p0lesp63b1gZDwLBZw: folds 
oVDuzcEt1umAPOB/u6ZH9g is sitting out
oVDuzcEt1umAPOB/u6ZH9g has returned
hBMUlEpyU74r/fwDgIpXjQ: folds 
5gHh6iDvZdEvYi59Pko1iA: folds 
oVDuzcEt1umAPOB/u6ZH9g is sitting out
Y2GFAe+PT7xnUUtgqCNDFw: folds 
C91Mv1usdi9Vq9ljlQVsug: folds 
HPEB+AtKw1+C/cxU0o1ciw: folds 
oKO7b50N6TzXbPBr/mcrUA: folds 
Uncalled bet ($0.15) returned to QEbIGci+itdw+re8RM5fZA
QEbIGci+itdw+re8RM5fZA collected $0.20 from pot
QEbIGci+itdw+re8RM5fZA: doesn't show hand 
*** SUMMARY ***
Total pot $0.20 | Rake $0 
Seat 1: 5gHh6iDvZdEvYi59Pko1iA folded before Flop (didn't bet)
Seat 2: Y2GFAe+PT7xnUUtgqCNDFw folded before Flop (didn't bet)
Seat 3: C91Mv1usdi9Vq9ljlQVsug folded before Flop (didn't bet)
Seat 4: HPEB+AtKw1+C/cxU0o1ciw (button) folded before Flop (didn't bet)
Seat 5: oKO7b50N6TzXbPBr/mcrUA (small blind) folded before Flop
Seat 6: QEbIGci+itdw+re8RM5fZA (big blind) collected ($0.20)
Seat 7: oVDuzcEt1umAPOB/u6ZH9g folded before Flop (didn't bet)
Seat 8: j4q3p0lesp63b1gZDwLBZw folded before Flop (didn't bet)
Seat 9: hBMUlEpyU74r/fwDgIpXjQ folded before Flop (didn't bet)




PokerStars Game #59939747316:  Hold'em No Limit ($0.10/$0.25) - 2009/07/01 0:47:53 ET
Table 'rpIHGyt2QpgQc5bvptAvDQ' 9-max Seat #1 is the button
Seat 1: pIK8dHf+MqCSMpnx8j9HEw ($12.40 in chips) 
Seat 2: dtZ84flFEi4Q+SGrHMJRDQ ($26.40 in chips) 
Seat 3: RNWwL4ZL6E6nNwmoYWS4Ug ($7.50 in chips) 
Seat 4: ottZQkg1UDWk85BtBzGJzg ($15 in chips) 
Seat 5: F7uW1LiDD9vUDBtB+5gRDg ($24.05 in chips) 
Seat 6: gehe91e0IyVT0QU/XBkEyg ($42 in chips) 
Seat 7: SXqVW4Q0evTUVZG6BbUNIA ($29.25 in chips) 
Seat 8: tYsOBqdU1+x+yFI7zHO7hQ ($25 in chips) 
Seat 9: nm4Dj/f+jJEwKVsUnKh73g ($28.90 in chips) 
dtZ84flFEi4Q+SGrHMJRDQ: posts small blind $0.10
RNWwL4ZL6E6nNwmoYWS4Ug: posts big blind $0.25
*** HOLE CARDS ***
ottZQkg1UDWk85BtBzGJzg: calls $0.25
F7uW1LiDD9vUDBtB+5gRDg: calls $0.25
gehe91e0IyVT0QU/XBkEyg: raises $1 to $1.25
SXqVW4Q0evTUVZG6BbUNIA: folds 
tYsOBqdU1+x+yFI7zHO7hQ: folds 
nm4Dj/f+jJEwKVsUnKh73g: folds 
pIK8dHf+MqCSMpnx8j9HEw: folds 
dtZ84flFEi4Q+SGrHMJRDQ: folds 
RNWwL4ZL6E6nNwmoYWS4Ug: folds 
ottZQkg1UDWk85BtBzGJzg: calls $1
F7uW1LiDD9vUDBtB+5gRDg: calls $1
*** FLOP *** [5h 3c Jd]
ottZQkg1UDWk85BtBzGJzg: checks 
F7uW1LiDD9vUDBtB+5gRDg: checks 
gehe91e0IyVT0QU/XBkEyg: checks 
*** TURN *** [5h 3c Jd] [9d]
ottZQkg1UDWk85BtBzGJzg: checks 
F7uW1LiDD9vUDBtB+5gRDg: checks 
gehe91e0IyVT0QU/XBkEyg: checks 
*** RIVER *** [5h 3c Jd 9d] [5c]
ottZQkg1UDWk85BtBzGJzg: checks 
pIK8dHf+MqCSMpnx8j9HEw leaves the table
F7uW1LiDD9vUDBtB+5gRDg: checks 
gehe91e0IyVT0QU/XBkEyg: checks 
*** SHOW DOWN ***
ottZQkg1UDWk85BtBzGJzg: shows [8d 7d] (a pair of Fives)
F7uW1LiDD9vUDBtB+5gRDg: shows [Qs 4s] (a pair of Fives - Queen kicker)
gehe91e0IyVT0QU/XBkEyg: shows [Ah Kc] (a pair of Fives - Ace kicker)
gehe91e0IyVT0QU/XBkEyg collected $3.90 from pot
*** SUMMARY ***
Total pot $4.10 | Rake $0.20 
Board [5h 3c Jd 9d 5c]
Seat 1: pIK8dHf+MqCSMpnx8j9HEw (button) folded before Flop (didn't bet)
Seat 2: dtZ84flFEi4Q+SGrHMJRDQ (small blind) folded before Flop
Seat 3: RNWwL4ZL6E6nNwmoYWS4Ug (big blind) folded before Flop
Seat 4: ottZQkg1UDWk85BtBzGJzg showed [8d 7d] and lost with a pair of Fives
Seat 5: F7uW1LiDD9vUDBtB+5gRDg showed [Qs 4s] and lost with a pair of Fives
Seat 6: gehe91e0IyVT0QU/XBkEyg showed [Ah Kc] and won ($3.90) with a pair of Fives
Seat 7: SXqVW4Q0evTUVZG6BbUNIA folded before Flop (didn't bet)
Seat 8: tYsOBqdU1+x+yFI7zHO7hQ folded before Flop (didn't bet)
Seat 9: nm4Dj/f+jJEwKVsUnKh73g folded before Flop (didn't bet)




PokerStars Game #59939747512:  Hold'em No Limit ($0.10/$0.25) - 2009/07/01 0:47:54 ET
Table 'SbSV5tlgLp0+/Z+13PW3Hg' 9-max Seat #5 is the button
Seat 2: zDrucyjVn5aeekNEc3cJrA ($19 in chips) 
Seat 3: s7Q6uNouhe7aE8JdFb9E+A ($25.85 in chips) 
Seat 4: NNZypfH1f/VIj3Skf/XIzg ($4.65 in chips) 
Seat 5: z5GxcHlYz/GSz6W2uFiTtg ($19.25 in chips) 
Seat 6: qwr38jl5txoR36M7G5qi4A ($7.65 in chips) 
Seat 7: j4q3p0lesp63b1gZDwLBZw ($6.35 in chips) 
Seat 8: 7cv+9Zc9HIQHNvYsMfV3uA ($26.95 in chips) 
Seat 9: rXm4QDVJt67H20lM6n6Z7Q ($18.50 in chips) 
qwr38jl5txoR36M7G5qi4A: posts small blind $0.10
j4q3p0lesp63b1gZDwLBZw: posts big blind $0.25
7milehigh3: sits out 
*** HOLE CARDS ***
7cv+9Zc9HIQHNvYsMfV3uA: folds 
rXm4QDVJt67H20lM6n6Z7Q: raises $0.75 to $1
zDrucyjVn5aeekNEc3cJrA: folds 
s7Q6uNouhe7aE8JdFb9E+A: folds 
NNZypfH1f/VIj3Skf/XIzg: folds 
z5GxcHlYz/GSz6W2uFiTtg: folds 
qwr38jl5txoR36M7G5qi4A: folds 
j4q3p0lesp63b1gZDwLBZw: folds 
Uncalled bet ($0.75) returned to rXm4QDVJt67H20lM6n6Z7Q
rXm4QDVJt67H20lM6n6Z7Q collected $0.60 from pot
*** SUMMARY ***
Total pot $0.60 | Rake $0 
Seat 2: zDrucyjVn5aeekNEc3cJrA folded before Flop (didn't bet)
Seat 3: s7Q6uNouhe7aE8JdFb9E+A folded before Flop (didn't bet)
Seat 4: NNZypfH1f/VIj3Skf/XIzg folded before Flop (didn't bet)
Seat 5: z5GxcHlYz/GSz6W2uFiTtg (button) folded before Flop (didn't bet)
Seat 6: qwr38jl5txoR36M7G5qi4A (small blind) folded before Flop
Seat 7: j4q3p0lesp63b1gZDwLBZw (big blind) folded before Flop
Seat 8: 7cv+9Zc9HIQHNvYsMfV3uA folded before Flop (didn't bet)
Seat 9: rXm4QDVJt67H20lM6n6Z7Q collected ($0.60)




PokerStars Game #59939747586:  Hold'em No Limit ($0.10/$0.25) - 2009/07/01 0:47:54 ET
Table 'LLHSnYPAXNI1sFlwPBn1tA' 6-max Seat #1 is the button
Seat 1: tVZW8k4GP+PvZ1DjD/9StA ($22.35 in chips) 
Seat 2: oseFhpinoe+Zg4j5xyBjyQ ($22.55 in chips) 
Seat 4: FPlQHZog0ePFCETQ2KG4hQ ($26.85 in chips) 
Seat 5: jXbd3O6QdeNWctmpAsTgHA ($14.45 in chips) 
Seat 6: PCh4iIHq9rXvWY/FeXc/Jg ($31.80 in chips) 
oseFhpinoe+Zg4j5xyBjyQ: posts small blind $0.10
JFIAqU8lCZ0vWwEl4bdGsg: is sitting out 
FPlQHZog0ePFCETQ2KG4hQ: posts big blind $0.25
*** HOLE CARDS ***
jXbd3O6QdeNWctmpAsTgHA: calls $0.25
PCh4iIHq9rXvWY/FeXc/Jg: folds 
tVZW8k4GP+PvZ1DjD/9StA: calls $0.25
oseFhpinoe+Zg4j5xyBjyQ: folds 
FPlQHZog0ePFCETQ2KG4hQ: checks 
*** FLOP *** [2s Js 3h]
FPlQHZog0ePFCETQ2KG4hQ: checks 
jXbd3O6QdeNWctmpAsTgHA: checks 
tVZW8k4GP+PvZ1DjD/9StA: checks 
*** TURN *** [2s Js 3h] [Qc]
FPlQHZog0ePFCETQ2KG4hQ: bets $0.75
jXbd3O6QdeNWctmpAsTgHA: calls $0.75
tVZW8k4GP+PvZ1DjD/9StA: folds 
*** RIVER *** [2s Js 3h Qc] [2c]
FPlQHZog0ePFCETQ2KG4hQ: bets $1.25
jXbd3O6QdeNWctmpAsTgHA: calls $1.25
*** SHOW DOWN ***
FPlQHZog0ePFCETQ2KG4hQ: shows [Qh 3d] (two pair, Queens and Threes)
jXbd3O6QdeNWctmpAsTgHA: mucks hand 
FPlQHZog0ePFCETQ2KG4hQ collected $4.65 from pot
*** SUMMARY ***
Total pot $4.85 | Rake $0.20 
Board [2s Js 3h Qc 2c]
Seat 1: tVZW8k4GP+PvZ1DjD/9StA (button) folded on the Turn
Seat 2: oseFhpinoe+Zg4j5xyBjyQ (small blind) folded before Flop
Seat 4: FPlQHZog0ePFCETQ2KG4hQ (big blind) showed [Qh 3d] and won ($4.65) with two pair, Queens and Threes
Seat 5: jXbd3O6QdeNWctmpAsTgHA mucked
Seat 6: PCh4iIHq9rXvWY/FeXc/Jg folded before Flop (didn't bet)




PokerStars Game #59939748672:  Hold'em No Limit ($0.10/$0.25) - 2009/07/01 0:47:55 ET
Table 'SgI2Cobdjtkh0Fd0/eTTDg' 9-max Seat #1 is the button
Seat 1: NcPAt5YjVvDFEJTTgAVj8g ($15 in chips) 
Seat 2: 8B/dhbQjIWe6ASCdgzktNQ ($45.10 in chips) 
Seat 3: OiV1PWZ3IkN29JlmCcnTwQ ($4.55 in chips) 
Seat 4: 18G4P1XstjNvItdGUITxgw ($25 in chips) 
Seat 5: w/RUHfVzKTf7Bc19nucLpQ ($18.10 in chips) 
Seat 7: aJy680tKSaP5er559aSuGA ($16.85 in chips) 
Seat 9: cZ99hugmLBj9KhTlc8nCSw ($25 in chips) 
8B/dhbQjIWe6ASCdgzktNQ: posts small blind $0.10
OiV1PWZ3IkN29JlmCcnTwQ: posts big blind $0.25
6RiVTYll/5D8zICp0MRpKw: sits out 
*** HOLE CARDS ***
18G4P1XstjNvItdGUITxgw: folds 
w/RUHfVzKTf7Bc19nucLpQ: folds 
ie4EwTMMFYxrCXcenJdzsw leaves the table
aJy680tKSaP5er559aSuGA: folds 
cZ99hugmLBj9KhTlc8nCSw: folds 
NcPAt5YjVvDFEJTTgAVj8g: calls $0.25
8B/dhbQjIWe6ASCdgzktNQ: folds 
OiV1PWZ3IkN29JlmCcnTwQ: checks 
*** FLOP *** [3d 2c Ac]
OiV1PWZ3IkN29JlmCcnTwQ: checks 
NcPAt5YjVvDFEJTTgAVj8g: checks 
*** TURN *** [3d 2c Ac] [6s]
OiV1PWZ3IkN29JlmCcnTwQ: checks 
NcPAt5YjVvDFEJTTgAVj8g: bets $0.25
OiV1PWZ3IkN29JlmCcnTwQ: folds 
Uncalled bet ($0.25) returned to NcPAt5YjVvDFEJTTgAVj8g
NcPAt5YjVvDFEJTTgAVj8g collected $0.60 from pot
*** SUMMARY ***
Total pot $0.60 | Rake $0 
Board [3d 2c Ac 6s]
Seat 1: NcPAt5YjVvDFEJTTgAVj8g (button) collected ($0.60)
Seat 2: 8B/dhbQjIWe6ASCdgzktNQ (small blind) folded before Flop
Seat 3: OiV1PWZ3IkN29JlmCcnTwQ (big blind) folded on the Turn
Seat 4: 18G4P1XstjNvItdGUITxgw folded before Flop (didn't bet)
Seat 5: w/RUHfVzKTf7Bc19nucLpQ folded before Flop (didn't bet)
Seat 7: aJy680tKSaP5er559aSuGA folded before Flop (didn't bet)
Seat 9: cZ99hugmLBj9KhTlc8nCSw folded before Flop (didn't bet)




PokerStars Game #59939748660:  Hold'em No Limit ($0.10/$0.25) - 2009/07/01 0:47:55 ET
Table '5VWnrlxdjwVfMWkVS2WE7A' 6-max Seat #1 is the button
Seat 1: BiLBinPhgpKAYzLgKJVU5A ($21.25 in chips) 
Seat 2: ELW+DKizJhLK7k40PMkD2Q ($28.70 in chips) 
Seat 3: cPO/1/dTcZpLkQFm3jH3Rg ($25 in chips) 
Seat 4: WZv4aSGl7ETtI/Z5BPKi7w ($35.55 in chips) 
Seat 5: JQZew0FjzS19kTjeNtrE+A ($41.95 in chips) 
Seat 6: LtASJ9OlkqGrrUKGQlpGAw ($13.40 in chips) 
ELW+DKizJhLK7k40PMkD2Q: posts small blind $0.10
cPO/1/dTcZpLkQFm3jH3Rg: posts big blind $0.25
*** HOLE CARDS ***
WZv4aSGl7ETtI/Z5BPKi7w: folds 
JQZew0FjzS19kTjeNtrE+A: folds 
LtASJ9OlkqGrrUKGQlpGAw: folds 
BiLBinPhgpKAYzLgKJVU5A: calls $0.25
ELW+DKizJhLK7k40PMkD2Q: calls $0.15
cPO/1/dTcZpLkQFm3jH3Rg: raises $1.75 to $2
BiLBinPhgpKAYzLgKJVU5A: folds 
ELW+DKizJhLK7k40PMkD2Q: folds 
Uncalled bet ($1.75) returned to cPO/1/dTcZpLkQFm3jH3Rg
cPO/1/dTcZpLkQFm3jH3Rg collected $0.75 from pot
*** SUMMARY ***
Total pot $0.75 | Rake $0 
Seat 1: BiLBinPhgpKAYzLgKJVU5A (button) folded before Flop
Seat 2: ELW+DKizJhLK7k40PMkD2Q (small blind) folded before Flop
Seat 3: cPO/1/dTcZpLkQFm3jH3Rg (big blind) collected ($0.75)
Seat 4: WZv4aSGl7ETtI/Z5BPKi7w folded before Flop (didn't bet)
Seat 5: JQZew0FjzS19kTjeNtrE+A folded before Flop (didn't bet)
Seat 6: LtASJ9OlkqGrrUKGQlpGAw folded before Flop (didn't bet)




PokerStars Game #59939748482:  Hold'em No Limit ($0.10/$0.25) - 2009/07/01 0:47:55 ET
Table 'gZetDqJh6q9A3mLO3ThCsAnc6OeGk/wtaWV+6N+kgnZQSeat #2 is the button
Seat 1: 1YCU970EVCcjs4GQP5Zt0g ($11.30 in chips) 
Seat 2: JFIAqU8lCZ0vWwEl4bdGsg ($25.25 in chips) 
Seat 3: jp34e617tIzV8tKIWmfAbA ($25 in chips) 
Seat 4: eHsmIvAb2JREg4O6hNPnXg ($9.95 in chips) 
Seat 5: mfrkWA3PTeYPkbO6hi98Aw ($45.70 in chips) 
Seat 6: R1hR3/XSBdOHwcbSUJRJbg ($61.65 in chips) 
jp34e617tIzV8tKIWmfAbA: posts small blind $0.10
eHsmIvAb2JREg4O6hNPnXg: posts big blind $0.25
*** HOLE CARDS ***
mfrkWA3PTeYPkbO6hi98Aw: folds 
R1hR3/XSBdOHwcbSUJRJbg: folds 
1YCU970EVCcjs4GQP5Zt0g: folds 
JFIAqU8lCZ0vWwEl4bdGsg: raises $0.60 to $0.85
jp34e617tIzV8tKIWmfAbA: folds 
eHsmIvAb2JREg4O6hNPnXg: folds 
Uncalled bet ($0.60) returned to JFIAqU8lCZ0vWwEl4bdGsg
JFIAqU8lCZ0vWwEl4bdGsg collected $0.60 from pot
JFIAqU8lCZ0vWwEl4bdGsg: doesn't show hand 
*** SUMMARY ***
Total pot $0.60 | Rake $0 
Seat 1: 1YCU970EVCcjs4GQP5Zt0g folded before Flop (didn't bet)
Seat 2: JFIAqU8lCZ0vWwEl4bdGsg (button) collected ($0.60)
Seat 3: jp34e617tIzV8tKIWmfAbA (small blind) folded before Flop
Seat 4: eHsmIvAb2JREg4O6hNPnXg (big blind) folded before Flop
Seat 5: mfrkWA3PTeYPkbO6hi98Aw folded before Flop (didn't bet)
Seat 6: R1hR3/XSBdOHwcbSUJRJbg folded before Flop (didn't bet)




PokerStars Game #59939748662:  Hold'em No Limit ($0.10/$0.25) - 2009/07/01 0:47:55 ET
Table 'fIMYcWwN4/aXFJvH5Z8Ymg' 6-max Seat #1 is the button
Seat 1: 64ZeDpsBsP594VsWmafRTQ ($8.20 in chips) 
Seat 2: vu2kzHaDtgr6NM7rdq0chA ($28.65 in chips) 
Seat 3: bWbV4MVB/vVpiES1Ut4hew ($46.60 in chips) 
Seat 4: 32YL2ZEp8NT4JB2RVM9euQ ($42.55 in chips) 
Seat 5: 9jSiy0meE9XJKkdIZwyTEQ ($32.05 in chips) 
Seat 6: jp34e617tIzV8tKIWmfAbA ($25 in chips) 
vu2kzHaDtgr6NM7rdq0chA: posts small blind $0.10
bWbV4MVB/vVpiES1Ut4hew: posts big blind $0.25
*** HOLE CARDS ***
32YL2ZEp8NT4JB2RVM9euQ: folds 
9jSiy0meE9XJKkdIZwyTEQ: folds 
jp34e617tIzV8tKIWmfAbA: folds 
64ZeDpsBsP594VsWmafRTQ: raises $0.50 to $0.75
vu2kzHaDtgr6NM7rdq0chA: folds 
bWbV4MVB/vVpiES1Ut4hew: calls $0.50
*** FLOP *** [8c 5h 9d]
bWbV4MVB/vVpiES1Ut4hew: checks 
64ZeDpsBsP594VsWmafRTQ: bets $1.25
bWbV4MVB/vVpiES1Ut4hew: folds 
Uncalled bet ($1.25) returned to 64ZeDpsBsP594VsWmafRTQ
64ZeDpsBsP594VsWmafRTQ collected $1.55 from pot
*** SUMMARY ***
Total pot $1.60 | Rake $0.05 
Board [8c 5h 9d]
Seat 1: 64ZeDpsBsP594VsWmafRTQ (button) collected ($1.55)
Seat 2: vu2kzHaDtgr6NM7rdq0chA (small blind) folded before Flop
Seat 3: bWbV4MVB/vVpiES1Ut4hew (big blind) folded on the Flop
Seat 4: 32YL2ZEp8NT4JB2RVM9euQ folded before Flop (didn't bet)
Seat 5: 9jSiy0meE9XJKkdIZwyTEQ folded before Flop (didn't bet)
Seat 6: jp34e617tIzV8tKIWmfAbA folded before Flop (didn't bet)




PokerStars Game #59939748432:  Hold'em No Limit ($0.10/$0.25) - 2009/07/01 0:47:55 ET
Table 'JJzUs04lHpXg6nboT1/jeg' 6-max Seat #4 is the button
Seat 3: uUXdcVMNa05rfbntdvplfw ($55.70 in chips) 
Seat 4: nwwpaieDRI0UPyVtChVHOg ($32.90 in chips) 
Seat 5: Vr2XE7yYBdg3RZSURDAPEg ($16.85 in chips) 
Seat 6: sbFQMajC1QuRxa8Jly3usQ ($5.25 in chips) 
Vr2XE7yYBdg3RZSURDAPEg: posts small blind $0.10
sbFQMajC1QuRxa8Jly3usQ: posts big blind $0.25
4kWQxGbT5FZ1dkPd1bE45Q: sits out 
*** HOLE CARDS ***
uUXdcVMNa05rfbntdvplfw: folds 
nwwpaieDRI0UPyVtChVHOg: folds 
Vr2XE7yYBdg3RZSURDAPEg: calls $0.15
sbFQMajC1QuRxa8Jly3usQ: checks 
*** FLOP *** [5c Kd 6d]
uUXdcVMNa05rfbntdvplfw said, "ok..."
Vr2XE7yYBdg3RZSURDAPEg: checks 
sbFQMajC1QuRxa8Jly3usQ: bets $0.50
Vr2XE7yYBdg3RZSURDAPEg: folds 
Uncalled bet ($0.50) returned to sbFQMajC1QuRxa8Jly3usQ
sbFQMajC1QuRxa8Jly3usQ collected $0.50 from pot
*** SUMMARY ***
Total pot $0.50 | Rake $0 
Board [5c Kd 6d]
Seat 3: uUXdcVMNa05rfbntdvplfw folded before Flop (didn't bet)
Seat 4: nwwpaieDRI0UPyVtChVHOg (button) folded before Flop (didn't bet)
Seat 5: Vr2XE7yYBdg3RZSURDAPEg (small blind) folded on the Flop
Seat 6: sbFQMajC1QuRxa8Jly3usQ (big blind) collected ($0.50)




PokerStars Game #59939748782:  Hold'em No Limit ($0.10/$0.25) - 2009/07/01 0:47:56 ET
Table 'n8mNkPYbe1AIQEkioNesZA' 9-max Seat #8 is the button
Seat 1: /VQLorsEOrMfI+KamzNQEA ($2.40 in chips) 
Seat 2: QEbIGci+itdw+re8RM5fZA ($35 in chips) 
Seat 3: zDrucyjVn5aeekNEc3cJrA ($19.70 in chips) 
Seat 5: j5kXXioAn7mKbcDKt4UzMw ($20.75 in chips) 
Seat 6: HPEB+AtKw1+C/cxU0o1ciw ($37 in chips) 
Seat 7: BrlfhE2AlcawLAz+eF5BDg ($4.60 in chips) 
Seat 8: N6fYvIzQLKaydFLKQGtMlQ ($25.90 in chips) 
Seat 9: gehe91e0IyVT0QU/XBkEyg ($28.25 in chips) 
gehe91e0IyVT0QU/XBkEyg: posts small blind $0.10
/VQLorsEOrMfI+KamzNQEA: posts big blind $0.25
*** HOLE CARDS ***
QEbIGci+itdw+re8RM5fZA: folds 
zDrucyjVn5aeekNEc3cJrA: folds 
j5kXXioAn7mKbcDKt4UzMw: raises $0.25 to $0.50
HPEB+AtKw1+C/cxU0o1ciw: folds 
BrlfhE2AlcawLAz+eF5BDg: folds 
N6fYvIzQLKaydFLKQGtMlQ: folds 
gehe91e0IyVT0QU/XBkEyg: folds 
/VQLorsEOrMfI+KamzNQEA: calls $0.25
*** FLOP *** [5d 2d Jh]
/VQLorsEOrMfI+KamzNQEA: bets $1.90 and is all-in
j5kXXioAn7mKbcDKt4UzMw: calls $1.90
*** TURN *** [5d 2d Jh] [Kd]
*** RIVER *** [5d 2d Jh Kd] [6s]
*** SHOW DOWN ***
/VQLorsEOrMfI+KamzNQEA: shows [Jc 8h] (a pair of Jacks)
j5kXXioAn7mKbcDKt4UzMw: shows [Qs Qc] (a pair of Queens)
j5kXXioAn7mKbcDKt4UzMw collected $4.70 from pot
/VQLorsEOrMfI+KamzNQEA leaves the table
*** SUMMARY ***
Total pot $4.90 | Rake $0.20 
Board [5d 2d Jh Kd 6s]
Seat 1: /VQLorsEOrMfI+KamzNQEA (big blind) showed [Jc 8h] and lost with a pair of Jacks
Seat 2: QEbIGci+itdw+re8RM5fZA folded before Flop (didn't bet)
Seat 3: zDrucyjVn5aeekNEc3cJrA folded before Flop (didn't bet)
Seat 5: j5kXXioAn7mKbcDKt4UzMw showed [Qs Qc] and won ($4.70) with a pair of Queens
Seat 6: HPEB+AtKw1+C/cxU0o1ciw folded before Flop (didn't bet)
Seat 7: BrlfhE2AlcawLAz+eF5BDg folded before Flop (didn't bet)
Seat 8: N6fYvIzQLKaydFLKQGtMlQ (button) folded before Flop (didn't bet)
Seat 9: gehe91e0IyVT0QU/XBkEyg (small blind) folded before Flop




PokerStars Game #59939749162:  Hold'em No Limit ($0.10/$0.25) - 2009/07/01 0:47:56 ET
Table 'YYMg5qzxK1m9eGRo4SbxtQ' 9-max Seat #5 is the button
Seat 1: DiSvPC2iudwL5j9u6Huyww ($25 in chips) 
Seat 2: uH1RN27w9SKa7TpVR9EFrQ ($15.25 in chips) 
Seat 3: N6fYvIzQLKaydFLKQGtMlQ ($23.70 in chips) 
Seat 4: H8sSXb2KLK0U38tU9YITDw ($10.80 in chips) 
Seat 5: BEIBUu2pIflPrCL+Iks4CQ ($18.95 in chips) 
Seat 6: gehe91e0IyVT0QU/XBkEyg ($41.95 in chips) 
Seat 7: hPhp/RE3cJ5YGaQ2xOHXXg ($5.45 in chips) 
Seat 8: 18G4P1XstjNvItdGUITxgw ($26.40 in chips) 
Seat 9: +sbyWwIcFp9kP0bDtMegfQ ($36.55 in chips) 
gehe91e0IyVT0QU/XBkEyg: posts small blind $0.10
hPhp/RE3cJ5YGaQ2xOHXXg: posts big blind $0.25
*** HOLE CARDS ***
18G4P1XstjNvItdGUITxgw: folds 
+sbyWwIcFp9kP0bDtMegfQ: folds 
DiSvPC2iudwL5j9u6Huyww: folds 
uH1RN27w9SKa7TpVR9EFrQ: folds 
N6fYvIzQLKaydFLKQGtMlQ: folds 
H8sSXb2KLK0U38tU9YITDw: folds 
BEIBUu2pIflPrCL+Iks4CQ: folds 
gehe91e0IyVT0QU/XBkEyg: folds 
Uncalled bet ($0.15) returned to hPhp/RE3cJ5YGaQ2xOHXXg
hPhp/RE3cJ5YGaQ2xOHXXg collected $0.20 from pot
hPhp/RE3cJ5YGaQ2xOHXXg: doesn't show hand 
*** SUMMARY ***
Total pot $0.20 | Rake $0 
Seat 1: DiSvPC2iudwL5j9u6Huyww folded before Flop (didn't bet)
Seat 2: uH1RN27w9SKa7TpVR9EFrQ folded before Flop (didn't bet)
Seat 3: N6fYvIzQLKaydFLKQGtMlQ folded before Flop (didn't bet)
Seat 4: H8sSXb2KLK0U38tU9YITDw folded before Flop (didn't bet)
Seat 5: BEIBUu2pIflPrCL+Iks4CQ (button) folded before Flop (didn't bet)
Seat 6: gehe91e0IyVT0QU/XBkEyg (small blind) folded before Flop
Seat 7: hPhp/RE3cJ5YGaQ2xOHXXg (big blind) collected ($0.20)
Seat 8: 18G4P1XstjNvItdGUITxgw folded before Flop (didn't bet)
Seat 9: +sbyWwIcFp9kP0bDtMegfQ folded before Flop (didn't bet)




PokerStars Game #59939749214:  Hold'em No Limit ($0.10/$0.25) - 2009/07/01 0:47:56 ET
Table 'g6ryG70feTw9nNm+XJLuXw' 6-max Seat #5 is the button
Seat 1: v+QfkGiuj9bgtuNoVnDO8w ($27.25 in chips) 
Seat 2: SxIIgwXYLkwd6m3wLyPTCw ($25.70 in chips) 
Seat 3: /6h8PvAHQmfuMUZ8OUF6Xw ($18.65 in chips) 
Seat 4: GC/9yVD59DUCX7hUI7gcLw ($40 in chips) 
Seat 5: EE16Ua5b1HSsYej5zeXOlA ($31.10 in chips) 
hieutdoh300 was removed from the table for failing to post
v+QfkGiuj9bgtuNoVnDO8w: posts small blind $0.10
SxIIgwXYLkwd6m3wLyPTCw: posts big blind $0.25
*** HOLE CARDS ***
/6h8PvAHQmfuMUZ8OUF6Xw: folds 
GC/9yVD59DUCX7hUI7gcLw: raises $0.75 to $1
EE16Ua5b1HSsYej5zeXOlA: calls $1
v+QfkGiuj9bgtuNoVnDO8w: folds 
SxIIgwXYLkwd6m3wLyPTCw: folds 
*** FLOP *** [Kh Ts Qs]
GC/9yVD59DUCX7hUI7gcLw: bets $1.50
EE16Ua5b1HSsYej5zeXOlA: folds 
Uncalled bet ($1.50) returned to GC/9yVD59DUCX7hUI7gcLw
GC/9yVD59DUCX7hUI7gcLw collected $2.25 from pot
*** SUMMARY ***
Total pot $2.35 | Rake $0.10 
Board [Kh Ts Qs]
Seat 1: v+QfkGiuj9bgtuNoVnDO8w (small blind) folded before Flop
Seat 2: SxIIgwXYLkwd6m3wLyPTCw (big blind) folded before Flop
Seat 3: /6h8PvAHQmfuMUZ8OUF6Xw folded before Flop (didn't bet)
Seat 4: GC/9yVD59DUCX7hUI7gcLw collected ($2.25)
Seat 5: EE16Ua5b1HSsYej5zeXOlA (button) folded on the Flop




PokerStars Game #59939748812:  Hold'em No Limit ($0.10/$0.25) - 2009/07/01 0:47:56 ET
Table 'aaXqTKUnxrX9DYXtxhWXxA' 6-max Seat #2 is the button
Seat 2: 1Zyw8DT57U6TzxWWRixa6Q ($10.20 in chips) 
Seat 3: cPO/1/dTcZpLkQFm3jH3Rg ($25.25 in chips) 
Seat 4: v8m8XHovI5tqEA9mvplDSw ($25 in chips) 
Seat 5: kyRaCIljYA6l33lSKQfNsg ($24.75 in chips) 
Seat 6: buyjetgNT1McXtdaP4zynA ($28.55 in chips) 
cPO/1/dTcZpLkQFm3jH3Rg: posts small blind $0.10
v8m8XHovI5tqEA9mvplDSw: posts big blind $0.25
SFmT9ZsVopnukjvAzrxTRg: sits out 
*** HOLE CARDS ***
kyRaCIljYA6l33lSKQfNsg: raises $0.50 to $0.75
buyjetgNT1McXtdaP4zynA: calls $0.75
1Zyw8DT57U6TzxWWRixa6Q: folds 
cPO/1/dTcZpLkQFm3jH3Rg: folds 
v8m8XHovI5tqEA9mvplDSw: calls $0.50
*** FLOP *** [2c Td 4s]
v8m8XHovI5tqEA9mvplDSw: checks 
kyRaCIljYA6l33lSKQfNsg: checks 
buyjetgNT1McXtdaP4zynA: checks 
*** TURN *** [2c Td 4s] [Ad]
v8m8XHovI5tqEA9mvplDSw: checks 
kyRaCIljYA6l33lSKQfNsg: checks 
buyjetgNT1McXtdaP4zynA: bets $1.75
v8m8XHovI5tqEA9mvplDSw: folds 
kyRaCIljYA6l33lSKQfNsg: calls $1.75
*** RIVER *** [2c Td 4s Ad] [Ks]
kyRaCIljYA6l33lSKQfNsg: checks 
buyjetgNT1McXtdaP4zynA: bets $3.75
kyRaCIljYA6l33lSKQfNsg: folds 
Uncalled bet ($3.75) returned to buyjetgNT1McXtdaP4zynA
buyjetgNT1McXtdaP4zynA collected $5.60 from pot
*** SUMMARY ***
Total pot $5.85 | Rake $0.25 
Board [2c Td 4s Ad Ks]
Seat 2: 1Zyw8DT57U6TzxWWRixa6Q (button) folded before Flop (didn't bet)
Seat 3: cPO/1/dTcZpLkQFm3jH3Rg (small blind) folded before Flop
Seat 4: v8m8XHovI5tqEA9mvplDSw (big blind) folded on the Turn
Seat 5: kyRaCIljYA6l33lSKQfNsg folded on the River
Seat 6: buyjetgNT1McXtdaP4zynA collected ($5.60)




PokerStars Game #59939749148:  Hold'em No Limit ($0.10/$0.25) - 2009/07/01 0:47:56 ET
Table 'vud0GB/ZlDCvUFhBFIaTlg' 9-max Seat #8 is the button
Seat 1: DiSvPC2iudwL5j9u6Huyww ($25 in chips) 
Seat 4: ss810etqPS9ni/HJIweF/g ($7.10 in chips) 
Seat 5: AwAabNdwDsTMb3aTomdOmg ($7.95 in chips) 
Seat 8: Am29qRe4OYkVWs70NjNDBw ($5.50 in chips) 
Seat 9: ROo8kPnsdL612mO7wzI5Bg ($8.45 in chips) 
ROo8kPnsdL612mO7wzI5Bg: posts small blind $0.10
DiSvPC2iudwL5j9u6Huyww: posts big blind $0.25
DHobes12: sits out 
*** HOLE CARDS ***
ss810etqPS9ni/HJIweF/g: calls $0.25
AwAabNdwDsTMb3aTomdOmg: calls $0.25
Am29qRe4OYkVWs70NjNDBw: folds 
ROo8kPnsdL612mO7wzI5Bg: calls $0.15
DiSvPC2iudwL5j9u6Huyww: checks 
*** FLOP *** [2s 7h Ad]
ROo8kPnsdL612mO7wzI5Bg: checks 
DiSvPC2iudwL5j9u6Huyww: checks 
ss810etqPS9ni/HJIweF/g: checks 
AwAabNdwDsTMb3aTomdOmg: checks 
*** TURN *** [2s 7h Ad] [Jd]
ROo8kPnsdL612mO7wzI5Bg: checks 
DiSvPC2iudwL5j9u6Huyww: checks 
ss810etqPS9ni/HJIweF/g: bets $0.25
AwAabNdwDsTMb3aTomdOmg: folds 
ROo8kPnsdL612mO7wzI5Bg: folds 
DiSvPC2iudwL5j9u6Huyww: folds 
Uncalled bet ($0.25) returned to ss810etqPS9ni/HJIweF/g
ss810etqPS9ni/HJIweF/g collected $0.95 from pot
*** SUMMARY ***
Total pot $1 | Rake $0.05 
Board [2s 7h Ad Jd]
Seat 1: DiSvPC2iudwL5j9u6Huyww (big blind) folded on the Turn
Seat 4: ss810etqPS9ni/HJIweF/g collected ($0.95)
Seat 5: AwAabNdwDsTMb3aTomdOmg folded on the Turn
Seat 8: Am29qRe4OYkVWs70NjNDBw (button) folded before Flop (didn't bet)
Seat 9: ROo8kPnsdL612mO7wzI5Bg (small blind) folded on the Turn




PokerStars Game #59939749836:  Hold'em No Limit ($0.10/$0.25) - 2009/07/01 0:47:57 ET
Table 'ORSZkZqq+7Ja2PdeCFAytA' 9-max Seat #5 is the button
Seat 1: Gpa8cld5y0mdOomHJgHhlA ($2.40 in chips) 
Seat 5: fOv1xoqR8m9slwElVu7Y+A ($19.75 in chips) 
Seat 6: hIss79a4pu7GzJZepfgOpg ($25 in chips) 
hIss79a4pu7GzJZepfgOpg: posts small blind $0.10
Gpa8cld5y0mdOomHJgHhlA: posts big blind $0.25
*** HOLE CARDS ***
fOv1xoqR8m9slwElVu7Y+A: raises $0.25 to $0.50
hIss79a4pu7GzJZepfgOpg: folds 
Gpa8cld5y0mdOomHJgHhlA: calls $0.25
*** FLOP *** [Td 5d 3h]
Gpa8cld5y0mdOomHJgHhlA: bets $0.50
fOv1xoqR8m9slwElVu7Y+A: raises $0.50 to $1
Gpa8cld5y0mdOomHJgHhlA: raises $0.90 to $1.90 and is all-in
fOv1xoqR8m9slwElVu7Y+A: calls $0.90
*** TURN *** [Td 5d 3h] [5s]
*** RIVER *** [Td 5d 3h 5s] [Jc]
*** SHOW DOWN ***
Gpa8cld5y0mdOomHJgHhlA: shows [2c Jh] (two pair, Jacks and Fives)
fOv1xoqR8m9slwElVu7Y+A: mucks hand 
Gpa8cld5y0mdOomHJgHhlA collected $4.70 from pot
*** SUMMARY ***
Total pot $4.90 | Rake $0.20 
Board [Td 5d 3h 5s Jc]
Seat 1: Gpa8cld5y0mdOomHJgHhlA (big blind) showed [2c Jh] and won ($4.70) with two pair, Jacks and Fives
Seat 5: fOv1xoqR8m9slwElVu7Y+A (button) mucked
Seat 6: hIss79a4pu7GzJZepfgOpg (small blind) folded before Flop




PokerStars Game #59939749526:  Hold'em No Limit ($0.10/$0.25) - 2009/07/01 0:47:57 ET
Table 'luMgmRPIo47e7iXDlheIwA' 6-max Seat #6 is the button
Seat 1: z/jAqpWD9ifpbtEpwGyInw ($9.90 in chips) 
Seat 2: hZJzYj+7+PvGu6ae1g//sQ ($10 in chips) 
Seat 3: W6Y6au0wf7gRAlqJYgOezw ($12.80 in chips) 
Seat 4: n2OZezRXTtdzQt4SuIy8TQ ($18.60 in chips) 
Seat 5: zxeVQGaMKDsDzmSY+AInjA ($14 in chips) 
Seat 6: Zb8xGmbjS8ghABxs9n6huA ($19.45 in chips) 
z/jAqpWD9ifpbtEpwGyInw: posts small blind $0.10
hZJzYj+7+PvGu6ae1g//sQ: posts big blind $0.25
*** HOLE CARDS ***
W6Y6au0wf7gRAlqJYgOezw: folds 
n2OZezRXTtdzQt4SuIy8TQ: folds 
zxeVQGaMKDsDzmSY+AInjA: folds 
Zb8xGmbjS8ghABxs9n6huA: folds 
z/jAqpWD9ifpbtEpwGyInw: raises $0.25 to $0.50
hZJzYj+7+PvGu6ae1g//sQ: calls $0.25
*** FLOP *** [Td 8h Jd]
z/jAqpWD9ifpbtEpwGyInw: checks 
hZJzYj+7+PvGu6ae1g//sQ: bets $1
z/jAqpWD9ifpbtEpwGyInw: calls $1
*** TURN *** [Td 8h Jd] [6h]
z/jAqpWD9ifpbtEpwGyInw: checks 
hZJzYj+7+PvGu6ae1g//sQ: bets $1
z/jAqpWD9ifpbtEpwGyInw: calls $1
*** RIVER *** [Td 8h Jd 6h] [8c]
z/jAqpWD9ifpbtEpwGyInw: bets $7.40 and is all-in
hZJzYj+7+PvGu6ae1g//sQ: folds 
Uncalled bet ($7.40) returned to z/jAqpWD9ifpbtEpwGyInw
z/jAqpWD9ifpbtEpwGyInw collected $4.80 from pot
*** SUMMARY ***
Total pot $5 | Rake $0.20 
Board [Td 8h Jd 6h 8c]
Seat 1: z/jAqpWD9ifpbtEpwGyInw (small blind) collected ($4.80)
Seat 2: hZJzYj+7+PvGu6ae1g//sQ (big blind) folded on the River
Seat 3: W6Y6au0wf7gRAlqJYgOezw folded before Flop (didn't bet)
Seat 4: n2OZezRXTtdzQt4SuIy8TQ folded before Flop (didn't bet)
Seat 5: zxeVQGaMKDsDzmSY+AInjA folded before Flop (didn't bet)
Seat 6: Zb8xGmbjS8ghABxs9n6huA (button) folded before Flop (didn't bet)




PokerStars Game #59939749674:  Hold'em No Limit ($0.10/$0.25) - 2009/07/01 0:47:57 ET
Table 'i93c3z9RLowvuJTKA2F4Jg' 6-max Seat #2 is the button
Seat 1: tbSZq5LHglyHk61mH9eDBw ($23.35 in chips) 
Seat 2: TSmua8tGK3sTbwi0ynrW9Q ($25 in chips) 
Seat 3: tVIFo6yuan1xauX1WIjH2w ($13.60 in chips) 
Seat 4: o86X2Q5GEDU3uP9oj1iFZA ($27.20 in chips) 
Seat 5: lYjWCpfCxX2kgcHY3v4Yow ($32.35 in chips) 
Seat 6: aSrj4lVmn2owyQ1RbbOqxQ ($32.55 in chips) 
tVIFo6yuan1xauX1WIjH2w: posts small blind $0.10
o86X2Q5GEDU3uP9oj1iFZA: posts big blind $0.25
*** HOLE CARDS ***
lYjWCpfCxX2kgcHY3v4Yow: folds 
aSrj4lVmn2owyQ1RbbOqxQ: folds 
tbSZq5LHglyHk61mH9eDBw: calls $0.25
TSmua8tGK3sTbwi0ynrW9Q: folds 
tVIFo6yuan1xauX1WIjH2w: calls $0.15
o86X2Q5GEDU3uP9oj1iFZA: raises $0.75 to $1
tbSZq5LHglyHk61mH9eDBw: calls $0.75
tVIFo6yuan1xauX1WIjH2w: calls $0.75
*** FLOP *** [6s 7c As]
tVIFo6yuan1xauX1WIjH2w: checks 
o86X2Q5GEDU3uP9oj1iFZA: bets $2.50
tbSZq5LHglyHk61mH9eDBw: folds 
tVIFo6yuan1xauX1WIjH2w: calls $2.50
*** TURN *** [6s 7c As] [4c]
tVIFo6yuan1xauX1WIjH2w: checks 
o86X2Q5GEDU3uP9oj1iFZA: checks 
*** RIVER *** [6s 7c As 4c] [4s]
tVIFo6yuan1xauX1WIjH2w: bets $3.50
o86X2Q5GEDU3uP9oj1iFZA: folds 
Uncalled bet ($3.50) returned to tVIFo6yuan1xauX1WIjH2w
tVIFo6yuan1xauX1WIjH2w collected $7.65 from pot
tVIFo6yuan1xauX1WIjH2w: doesn't show hand 
*** SUMMARY ***
Total pot $8 | Rake $0.35 
Board [6s 7c As 4c 4s]
Seat 1: tbSZq5LHglyHk61mH9eDBw folded on the Flop
Seat 2: TSmua8tGK3sTbwi0ynrW9Q (button) folded before Flop (didn't bet)
Seat 3: tVIFo6yuan1xauX1WIjH2w (small blind) collected ($7.65)
Seat 4: o86X2Q5GEDU3uP9oj1iFZA (big blind) folded on the River
Seat 5: lYjWCpfCxX2kgcHY3v4Yow folded before Flop (didn't bet)
Seat 6: aSrj4lVmn2owyQ1RbbOqxQ folded before Flop (didn't bet)




PokerStars Game #59939749460:  Hold'em No Limit ($0.10/$0.25) - 2009/07/01 0:47:57 ET
Table 'APEHQjIcZHDZUA4iOjju2g' 6-max Seat #1 is the button
Seat 1: eHsmIvAb2JREg4O6hNPnXg ($4.90 in chips) 
Seat 2: 3zD3qLXT1bEffAoWGnc7wg ($26.40 in chips) 
Seat 3: E7KSkgfIsmIsp0vLnmGFmA ($18 in chips) 
Seat 4: EqXTTLKUlDlz7yi6ziyyWA ($2.50 in chips) 
Seat 5: /xN6gc9+8Hew0HxaB6VIVg ($59 in chips) 
Seat 6: y7HCJfEmolBCFdi/0j5TRg ($44.35 in chips) 
3zD3qLXT1bEffAoWGnc7wg: posts small blind $0.10
E7KSkgfIsmIsp0vLnmGFmA: posts big blind $0.25
*** HOLE CARDS ***
EqXTTLKUlDlz7yi6ziyyWA: folds 
/xN6gc9+8Hew0HxaB6VIVg: folds 
y7HCJfEmolBCFdi/0j5TRg: folds 
eHsmIvAb2JREg4O6hNPnXg: calls $0.25
3zD3qLXT1bEffAoWGnc7wg: calls $0.15
E7KSkgfIsmIsp0vLnmGFmA: checks 
*** FLOP *** [Js 6c Tc]
3zD3qLXT1bEffAoWGnc7wg: checks 
E7KSkgfIsmIsp0vLnmGFmA: bets $0.25
eHsmIvAb2JREg4O6hNPnXg: raises $0.25 to $0.50
3zD3qLXT1bEffAoWGnc7wg: folds 
E7KSkgfIsmIsp0vLnmGFmA: calls $0.25
*** TURN *** [Js 6c Tc] [6h]
E7KSkgfIsmIsp0vLnmGFmA: checks 
eHsmIvAb2JREg4O6hNPnXg: checks 
*** RIVER *** [Js 6c Tc 6h] [Qc]
E7KSkgfIsmIsp0vLnmGFmA: checks 
eHsmIvAb2JREg4O6hNPnXg: bets $0.75
E7KSkgfIsmIsp0vLnmGFmA: calls $0.75
*** SHOW DOWN ***
eHsmIvAb2JREg4O6hNPnXg: shows [Kc 8c] (a flush, King high)
E7KSkgfIsmIsp0vLnmGFmA: mucks hand 
eHsmIvAb2JREg4O6hNPnXg collected $3.10 from pot
*** SUMMARY ***
Total pot $3.25 | Rake $0.15 
Board [Js 6c Tc 6h Qc]
Seat 1: eHsmIvAb2JREg4O6hNPnXg (button) showed [Kc 8c] and won ($3.10) with a flush, King high
Seat 2: 3zD3qLXT1bEffAoWGnc7wg (small blind) folded on the Flop
Seat 3: E7KSkgfIsmIsp0vLnmGFmA (big blind) mucked
Seat 4: EqXTTLKUlDlz7yi6ziyyWA folded before Flop (didn't bet)
Seat 5: /xN6gc9+8Hew0HxaB6VIVg folded before Flop (didn't bet)
Seat 6: y7HCJfEmolBCFdi/0j5TRg folded before Flop (didn't bet)




PokerStars Game #59939749692:  Hold'em No Limit ($0.10/$0.25) - 2009/07/01 0:47:57 ET
Table 'ktio12Pyq06LsrFhIorSqA' 9-max Seat #9 is the button
Seat 1: OneeONzF0MoH0pEdcBndwA ($33 in chips) 
Seat 2: sX4bSd399rlGD2VqB7dh2Q ($11.90 in chips) 
Seat 3: 21oaELqROjaQrGRMDGa8pQ ($13.75 in chips) 
Seat 4: E0iYnEVO2ho7dH3QcCjw7g ($17.50 in chips) 
Seat 6: jQL6XIewylQ8MmZhhq2YFg ($39.85 in chips) 
Seat 7: XGCfQsxa6PfAg3kJtzUmww ($23.55 in chips) 
Seat 8: Z5y2J55JmfLYR6/DPAGHwQ ($14.55 in chips) 
Seat 9: 2Gn4w2tIKlLbK/3nwIeRYA ($7.75 in chips) 
OneeONzF0MoH0pEdcBndwA: posts small blind $0.10
sX4bSd399rlGD2VqB7dh2Q: posts big blind $0.25
*** HOLE CARDS ***
21oaELqROjaQrGRMDGa8pQ: folds 
21oaELqROjaQrGRMDGa8pQ leaves the table
E0iYnEVO2ho7dH3QcCjw7g: raises $0.50 to $0.75
jQL6XIewylQ8MmZhhq2YFg: folds 
XGCfQsxa6PfAg3kJtzUmww: folds 
Z5y2J55JmfLYR6/DPAGHwQ: folds 
2Gn4w2tIKlLbK/3nwIeRYA: calls $0.75
OneeONzF0MoH0pEdcBndwA: folds 
TeWJxSETzbXGiYKx0y+dtg joins the table at seat #3 
sX4bSd399rlGD2VqB7dh2Q: folds 
*** FLOP *** [8h Tc 9d]
E0iYnEVO2ho7dH3QcCjw7g: bets $0.75
2Gn4w2tIKlLbK/3nwIeRYA: calls $0.75
*** TURN *** [8h Tc 9d] [6d]
E0iYnEVO2ho7dH3QcCjw7g: bets $2.25
2Gn4w2tIKlLbK/3nwIeRYA: folds 
Uncalled bet ($2.25) returned to E0iYnEVO2ho7dH3QcCjw7g
E0iYnEVO2ho7dH3QcCjw7g collected $3.20 from pot
*** SUMMARY ***
Total pot $3.35 | Rake $0.15 
Board [8h Tc 9d 6d]
Seat 1: OneeONzF0MoH0pEdcBndwA (small blind) folded before Flop
Seat 2: sX4bSd399rlGD2VqB7dh2Q (big blind) folded before Flop
Seat 3: 21oaELqROjaQrGRMDGa8pQ folded before Flop (didn't bet)
Seat 4: E0iYnEVO2ho7dH3QcCjw7g collected ($3.20)
Seat 6: jQL6XIewylQ8MmZhhq2YFg folded before Flop (didn't bet)
Seat 7: XGCfQsxa6PfAg3kJtzUmww folded before Flop (didn't bet)
Seat 8: Z5y2J55JmfLYR6/DPAGHwQ folded before Flop (didn't bet)
Seat 9: 2Gn4w2tIKlLbK/3nwIeRYA (button) folded on the Turn




PokerStars Game #59939750002:  Hold'em No Limit ($0.10/$0.25) - 2009/07/01 0:47:57 ET
Table '8QBBaev+cI2i/r2H6ml/lg' 9-max Seat #6 is the button
Seat 1: J+/gREJjzabbnYljjxEIRA ($5.10 in chips) 
Seat 3: W4TLQcZ2TiM73eIgpIvlGg ($25 in chips) 
Seat 4: ZoG0obuajzVjwgd7lNHjgg ($3.75 in chips) 
Seat 6: cxE+szmvEUe7vE+z2ozM2Q ($11.10 in chips) 
J+/gREJjzabbnYljjxEIRA: posts small blind $0.10
W4TLQcZ2TiM73eIgpIvlGg: posts big blind $0.25
*** HOLE CARDS ***
ZoG0obuajzVjwgd7lNHjgg: folds 
cxE+szmvEUe7vE+z2ozM2Q: raises $0.25 to $0.50
J+/gREJjzabbnYljjxEIRA: calls $0.40
W4TLQcZ2TiM73eIgpIvlGg: calls $0.25
*** FLOP *** [9d Qd Kd]
J+/gREJjzabbnYljjxEIRA: checks 
W4TLQcZ2TiM73eIgpIvlGg: bets $1
cxE+szmvEUe7vE+z2ozM2Q: calls $1
J+/gREJjzabbnYljjxEIRA: calls $1
*** TURN *** [9d Qd Kd] [3d]
J+/gREJjzabbnYljjxEIRA: bets $1.25
W4TLQcZ2TiM73eIgpIvlGg: calls $1.25
cxE+szmvEUe7vE+z2ozM2Q: calls $1.25
*** RIVER *** [9d Qd Kd 3d] [7h]
J+/gREJjzabbnYljjxEIRA: bets $2
W4TLQcZ2TiM73eIgpIvlGg: calls $2
cxE+szmvEUe7vE+z2ozM2Q: raises $6.35 to $8.35 and is all-in
J+/gREJjzabbnYljjxEIRA: calls $0.35 and is all-in
W4TLQcZ2TiM73eIgpIvlGg: folds 
Uncalled bet ($6) returned to cxE+szmvEUe7vE+z2ozM2Q
*** SHOW DOWN ***
cxE+szmvEUe7vE+z2ozM2Q: shows [Ad 2c] (a flush, Ace high)
J+/gREJjzabbnYljjxEIRA: mucks hand 
cxE+szmvEUe7vE+z2ozM2Q collected $14.25 from pot
*** SUMMARY ***
Total pot $14.95 | Rake $0.70 
Board [9d Qd Kd 3d 7h]
Seat 1: J+/gREJjzabbnYljjxEIRA (small blind) mucked
Seat 3: W4TLQcZ2TiM73eIgpIvlGg (big blind) folded on the River
Seat 4: ZoG0obuajzVjwgd7lNHjgg folded before Flop (didn't bet)
Seat 6: cxE+szmvEUe7vE+z2ozM2Q (button) showed [Ad 2c] and won ($14.25) with a flush, Ace high




PokerStars Game #59939750050:  Hold'em No Limit ($0.10/$0.25) - 2009/07/01 0:47:58 ET
Table 'sIHZ0lzLr4NGCaBUKhmYhA' 6-max Seat #3 is the button
Seat 1: q6WfTUAD9mowIP63ASq2Dg ($40.70 in chips) 
Seat 2: 1xmHIWgZaOCqEMnW2GkFfw ($4.15 in chips) 
Seat 3: SxIIgwXYLkwd6m3wLyPTCw ($25 in chips) 
Seat 4: 4YSTu0Cdzpppe1lUgCZGCQ ($33.75 in chips) 
Seat 5: GJsS3gwVwlbyroaWrnjqJg ($25.40 in chips) 
Seat 6: 82p+w3EmUaFFHuwpSeGY1w ($15 in chips) 
4YSTu0Cdzpppe1lUgCZGCQ: posts small blind $0.10
GJsS3gwVwlbyroaWrnjqJg: posts big blind $0.25
82p+w3EmUaFFHuwpSeGY1w: posts big blind $0.25
*** HOLE CARDS ***
82p+w3EmUaFFHuwpSeGY1w: checks 
q6WfTUAD9mowIP63ASq2Dg: folds 
1xmHIWgZaOCqEMnW2GkFfw: folds 
SxIIgwXYLkwd6m3wLyPTCw: folds 
4YSTu0Cdzpppe1lUgCZGCQ: folds 
GJsS3gwVwlbyroaWrnjqJg: checks 
*** FLOP *** [4c Qd 8h]
GJsS3gwVwlbyroaWrnjqJg: checks 
82p+w3EmUaFFHuwpSeGY1w: bets $0.50
GJsS3gwVwlbyroaWrnjqJg: folds 
Uncalled bet ($0.50) returned to 82p+w3EmUaFFHuwpSeGY1w
82p+w3EmUaFFHuwpSeGY1w collected $0.60 from pot
82p+w3EmUaFFHuwpSeGY1w: doesn't show hand 
*** SUMMARY ***
Total pot $0.60 | Rake $0 
Board [4c Qd 8h]
Seat 1: q6WfTUAD9mowIP63ASq2Dg folded before Flop (didn't bet)
Seat 2: 1xmHIWgZaOCqEMnW2GkFfw folded before Flop (didn't bet)
Seat 3: SxIIgwXYLkwd6m3wLyPTCw (button) folded before Flop (didn't bet)
Seat 4: 4YSTu0Cdzpppe1lUgCZGCQ (small blind) folded before Flop
Seat 5: GJsS3gwVwlbyroaWrnjqJg (big blind) folded on the Flop
Seat 6: 82p+w3EmUaFFHuwpSeGY1w collected ($0.60)




PokerStars Game #59939750140:  Hold'em No Limit ($0.10/$0.25) - 2009/07/01 0:47:58 ET
Table 'M8kYidAX3ib7pLKW7edFLw' 6-max Seat #4 is the button
Seat 1: jp34e617tIzV8tKIWmfAbA ($25.25 in chips) 
Seat 2: 4kWQxGbT5FZ1dkPd1bE45Q ($38.60 in chips) 
Seat 3: q+Sip/IIcvzqgZt1pJAWTw ($9 in chips) 
Seat 4: /bjna2FTN7pPjqYGzmDE0Q ($25.35 in chips) 
Seat 5: bDKopKTvPi3W+PEnYUX3tg ($47.45 in chips) 
Seat 6: NqFoyDgzLwu4dOmSRXnFBA ($10.35 in chips) 
bDKopKTvPi3W+PEnYUX3tg: posts small blind $0.10
NqFoyDgzLwu4dOmSRXnFBA: posts big blind $0.25
*** HOLE CARDS ***
jp34e617tIzV8tKIWmfAbA: folds 
4kWQxGbT5FZ1dkPd1bE45Q: folds 
q+Sip/IIcvzqgZt1pJAWTw: calls $0.25
/bjna2FTN7pPjqYGzmDE0Q: calls $0.25
bDKopKTvPi3W+PEnYUX3tg: calls $0.15
NqFoyDgzLwu4dOmSRXnFBA: checks 
*** FLOP *** [6c 9c Kc]
bDKopKTvPi3W+PEnYUX3tg: checks 
NqFoyDgzLwu4dOmSRXnFBA: checks 
q+Sip/IIcvzqgZt1pJAWTw: bets $0.75
/bjna2FTN7pPjqYGzmDE0Q: folds 
bDKopKTvPi3W+PEnYUX3tg: folds 
NqFoyDgzLwu4dOmSRXnFBA: folds 
Uncalled bet ($0.75) returned to q+Sip/IIcvzqgZt1pJAWTw
q+Sip/IIcvzqgZt1pJAWTw collected $0.95 from pot
q+Sip/IIcvzqgZt1pJAWTw: shows [Ah 3h] (high card Ace)
*** SUMMARY ***
Total pot $1 | Rake $0.05 
Board [6c 9c Kc]
Seat 1: jp34e617tIzV8tKIWmfAbA folded before Flop (didn't bet)
Seat 2: 4kWQxGbT5FZ1dkPd1bE45Q folded before Flop (didn't bet)
Seat 3: q+Sip/IIcvzqgZt1pJAWTw collected ($0.95)
Seat 4: /bjna2FTN7pPjqYGzmDE0Q (button) folded on the Flop
Seat 5: bDKopKTvPi3W+PEnYUX3tg (small blind) folded on the Flop
Seat 6: NqFoyDgzLwu4dOmSRXnFBA (big blind) folded on the Flop




PokerStars Game #59939750198:  Hold'em No Limit ($0.10/$0.25) - 2009/07/01 0:47:58 ET
Table 'g+mPuNJBCHKE9ents7ZGtg' 6-max Seat #5 is the button
Seat 1: YaAEMJGY5tem39deCUQRNw ($24 in chips) 
Seat 2: fZQg9veL7Dd/Z04ZTjC+wQ ($30.35 in chips) 
Seat 3: 9jSiy0meE9XJKkdIZwyTEQ ($36.10 in chips) 
Seat 4: mfrkWA3PTeYPkbO6hi98Aw ($24.30 in chips) 
Seat 5: 32YL2ZEp8NT4JB2RVM9euQ ($14.40 in chips) 
Seat 6: MS2T205Bjud7PnNoANu4vQ ($47.55 in chips) 
MS2T205Bjud7PnNoANu4vQ: posts small blind $0.10
YaAEMJGY5tem39deCUQRNw: posts big blind $0.25
*** HOLE CARDS ***
fZQg9veL7Dd/Z04ZTjC+wQ: folds 
9jSiy0meE9XJKkdIZwyTEQ: folds 
mfrkWA3PTeYPkbO6hi98Aw: folds 
32YL2ZEp8NT4JB2RVM9euQ: folds 
MS2T205Bjud7PnNoANu4vQ: calls $0.15
YaAEMJGY5tem39deCUQRNw: checks 
*** FLOP *** [Jh Js Ad]
MS2T205Bjud7PnNoANu4vQ: bets $0.50
YaAEMJGY5tem39deCUQRNw: folds 
Uncalled bet ($0.50) returned to MS2T205Bjud7PnNoANu4vQ
MS2T205Bjud7PnNoANu4vQ collected $0.50 from pot
MS2T205Bjud7PnNoANu4vQ is sitting out
MS2T205Bjud7PnNoANu4vQ: doesn't show hand 
*** SUMMARY ***
Total pot $0.50 | Rake $0 
Board [Jh Js Ad]
Seat 1: YaAEMJGY5tem39deCUQRNw (big blind) folded on the Flop
Seat 2: fZQg9veL7Dd/Z04ZTjC+wQ folded before Flop (didn't bet)
Seat 3: 9jSiy0meE9XJKkdIZwyTEQ folded before Flop (didn't bet)
Seat 4: mfrkWA3PTeYPkbO6hi98Aw folded before Flop (didn't bet)
Seat 5: 32YL2ZEp8NT4JB2RVM9euQ (button) folded before Flop (didn't bet)
Seat 6: MS2T205Bjud7PnNoANu4vQ (small blind) collected ($0.50)




PokerStars Game #59939750162:  Hold'em No Limit ($0.10/$0.25) - 2009/07/01 0:47:58 ET
Table 'o0CDOvKO/bn1WjeymDrXfA' 6-max Seat #1 is the button
Seat 1: 32YL2ZEp8NT4JB2RVM9euQ ($30.65 in chips) 
Seat 2: oc4ZGs0W+3RIg2yPyJw3ig ($31.70 in chips) 
Seat 3: EqXTTLKUlDlz7yi6ziyyWA ($9 in chips) 
Seat 4: NuqYPwTLZYQhxOoVK3Yqlw ($25.10 in chips) 
Seat 5: u/yN5P9f3KlATg6WLWNkBQ ($28 in chips) 
Seat 6: Bada343Si4xKu3fNXY99AA ($29.50 in chips) 
oc4ZGs0W+3RIg2yPyJw3ig: posts small blind $0.10
EqXTTLKUlDlz7yi6ziyyWA: posts big blind $0.25
*** HOLE CARDS ***
NuqYPwTLZYQhxOoVK3Yqlw: folds 
u/yN5P9f3KlATg6WLWNkBQ: folds 
Bada343Si4xKu3fNXY99AA: calls $0.25
32YL2ZEp8NT4JB2RVM9euQ: raises $1 to $1.25
oc4ZGs0W+3RIg2yPyJw3ig: folds 
EqXTTLKUlDlz7yi6ziyyWA: raises $7.75 to $9 and is all-in
Bada343Si4xKu3fNXY99AA: folds 
32YL2ZEp8NT4JB2RVM9euQ: calls $7.75
*** FLOP *** [Ts 2d Js]
*** TURN *** [Ts 2d Js] [Td]
*** RIVER *** [Ts 2d Js Td] [7h]
*** SHOW DOWN ***
EqXTTLKUlDlz7yi6ziyyWA: shows [4s 6h] (a pair of Tens)
32YL2ZEp8NT4JB2RVM9euQ: shows [Ks Ac] (a pair of Tens - Ace kicker)
32YL2ZEp8NT4JB2RVM9euQ collected $17.45 from pot
EqXTTLKUlDlz7yi6ziyyWA leaves the table
*** SUMMARY ***
Total pot $18.35 | Rake $0.90 
Board [Ts 2d Js Td 7h]
Seat 1: 32YL2ZEp8NT4JB2RVM9euQ (button) showed [Ks Ac] and won ($17.45) with a pair of Tens
Seat 2: oc4ZGs0W+3RIg2yPyJw3ig (small blind) folded before Flop
Seat 3: EqXTTLKUlDlz7yi6ziyyWA (big blind) showed [4s 6h] and lost with a pair of Tens
Seat 4: NuqYPwTLZYQhxOoVK3Yqlw folded before Flop (didn't bet)
Seat 5: u/yN5P9f3KlATg6WLWNkBQ folded before Flop (didn't bet)
Seat 6: Bada343Si4xKu3fNXY99AA folded before Flop




PokerStars Game #59939750160:  Hold'em No Limit ($0.10/$0.25) - 2009/07/01 0:47:58 ET
Table '9iHhO6FyZVM8XpSc23TIgg' 6-max Seat #6 is the button
Seat 1: NhUN/JpAprdJeamFBgJH1w ($25 in chips) 
Seat 2: ErIN0JRL5srYjT6en1f8YQ ($30.80 in chips) 
Seat 4: cfJccEfyn6IkquPN08hFsA ($36.85 in chips) 
Seat 5: WmfI+HZXhME/HMG8E3/H2w ($32.60 in chips) 
Seat 6: WrLI51S2iMb8GLMB83gGqA ($25 in chips) 
NhUN/JpAprdJeamFBgJH1w: posts small blind $0.10
ErIN0JRL5srYjT6en1f8YQ: posts big blind $0.25
RYLaAIIwK9wxkPswt1yJYw: sits out 
*** HOLE CARDS ***
cfJccEfyn6IkquPN08hFsA: raises $0.75 to $1
WmfI+HZXhME/HMG8E3/H2w: calls $1
WrLI51S2iMb8GLMB83gGqA: folds 
NhUN/JpAprdJeamFBgJH1w: folds 
ErIN0JRL5srYjT6en1f8YQ: folds 
*** FLOP *** [Ts 9d Kh]
cfJccEfyn6IkquPN08hFsA: bets $1.50
WmfI+HZXhME/HMG8E3/H2w: calls $1.50
*** TURN *** [Ts 9d Kh] [2s]
cfJccEfyn6IkquPN08hFsA: checks 
WmfI+HZXhME/HMG8E3/H2w: bets $3.50
cfJccEfyn6IkquPN08hFsA: calls $3.50
*** RIVER *** [Ts 9d Kh 2s] [6s]
cfJccEfyn6IkquPN08hFsA: checks 
WmfI+HZXhME/HMG8E3/H2w: bets $6.25
cfJccEfyn6IkquPN08hFsA: raises $7.75 to $14
WmfI+HZXhME/HMG8E3/H2w: calls $7.75
*** SHOW DOWN ***
cfJccEfyn6IkquPN08hFsA: shows [5s 4s] (a flush, Ten high)
WmfI+HZXhME/HMG8E3/H2w: mucks hand 
cfJccEfyn6IkquPN08hFsA collected $38.40 from pot
*** SUMMARY ***
Total pot $40.35 | Rake $1.95 
Board [Ts 9d Kh 2s 6s]
Seat 1: NhUN/JpAprdJeamFBgJH1w (small blind) folded before Flop
Seat 2: ErIN0JRL5srYjT6en1f8YQ (big blind) folded before Flop
Seat 4: cfJccEfyn6IkquPN08hFsA showed [5s 4s] and won ($38.40) with a flush, Ten high
Seat 5: WmfI+HZXhME/HMG8E3/H2w mucked
Seat 6: WrLI51S2iMb8GLMB83gGqA (button) folded before Flop (didn't bet)




PokerStars Game #59939751016:  Hold'em No Limit ($0.10/$0.25) - 2009/07/01 0:47:59 ET
Table '29D3eoQzK5kOAT0OIDS2uQ' 6-max Seat #2 is the button
Seat 1: kG34n23qFQA3nzdOJTQ1dA ($49.30 in chips) 
Seat 2: eSKnWz2RD4rvwnvB+rFzIg ($24.65 in chips) 
Seat 3: z3tQwy28dp5FykDJC/wzQw ($22.45 in chips) 
Seat 5: Q3EMN7b0ie81AFWkDrhCjw ($34.50 in chips) 
Seat 6: bWbV4MVB/vVpiES1Ut4hew ($43.90 in chips) 
z3tQwy28dp5FykDJC/wzQw: posts small blind $0.10
Q3EMN7b0ie81AFWkDrhCjw: posts big blind $0.25
*** HOLE CARDS ***
bWbV4MVB/vVpiES1Ut4hew: folds 
kG34n23qFQA3nzdOJTQ1dA: folds 
eSKnWz2RD4rvwnvB+rFzIg: raises $0.50 to $0.75
z3tQwy28dp5FykDJC/wzQw: folds 
Q3EMN7b0ie81AFWkDrhCjw: calls $0.50
*** FLOP *** [Tc Js Ac]
Q3EMN7b0ie81AFWkDrhCjw: checks 
eSKnWz2RD4rvwnvB+rFzIg: bets $1.25
Q3EMN7b0ie81AFWkDrhCjw: raises $1.25 to $2.50
eSKnWz2RD4rvwnvB+rFzIg: raises $4.75 to $7.25
Q3EMN7b0ie81AFWkDrhCjw: raises $26.50 to $33.75 and is all-in
eSKnWz2RD4rvwnvB+rFzIg: calls $16.65 and is all-in
Uncalled bet ($9.85) returned to Q3EMN7b0ie81AFWkDrhCjw
*** TURN *** [Tc Js Ac] [4d]
*** RIVER *** [Tc Js Ac 4d] [4h]
*** SHOW DOWN ***
Q3EMN7b0ie81AFWkDrhCjw: shows [Ah Th] (two pair, Aces and Tens)
eSKnWz2RD4rvwnvB+rFzIg: shows [Kd Qc] (a straight, Ten to Ace)
eSKnWz2RD4rvwnvB+rFzIg collected $47.40 from pot
*** SUMMARY ***
Total pot $49.40 | Rake $2 
Board [Tc Js Ac 4d 4h]
Seat 1: kG34n23qFQA3nzdOJTQ1dA folded before Flop (didn't bet)
Seat 2: eSKnWz2RD4rvwnvB+rFzIg (button) showed [Kd Qc] and won ($47.40) with a straight, Ten to Ace
Seat 3: z3tQwy28dp5FykDJC/wzQw (small blind) folded before Flop
Seat 5: Q3EMN7b0ie81AFWkDrhCjw (big blind) showed [Ah Th] and lost with two pair, Aces and Tens
Seat 6: bWbV4MVB/vVpiES1Ut4hew folded before Flop (didn't bet)




PokerStars Game #59939751178:  Hold'em No Limit ($0.10/$0.25) - 2009/07/01 0:47:59 ET
Table '84TjTrgbsYZladOc4PWf4Q' 6-max Seat #1 is the button
Seat 1: 79ID/ub1Pt/mDpCprVmOoA ($29.65 in chips) 
Seat 2: RpaEX9P7BCvyfPRLiRNg0A ($15.10 in chips) 
Seat 3: Ar4vsUIUfJ7gbYh1c1m59g ($14.65 in chips) 
Seat 4: SxIIgwXYLkwd6m3wLyPTCw ($25 in chips) 
Seat 5: YaAEMJGY5tem39deCUQRNw ($27.05 in chips) 
Seat 6: 7qRk4YH4/k/08LgJSv7rBQ ($26.10 in chips) 
RpaEX9P7BCvyfPRLiRNg0A: posts small blind $0.10
Ar4vsUIUfJ7gbYh1c1m59g: posts big blind $0.25
*** HOLE CARDS ***
SxIIgwXYLkwd6m3wLyPTCw: raises $0.50 to $0.75
YaAEMJGY5tem39deCUQRNw: calls $0.75
7qRk4YH4/k/08LgJSv7rBQ: folds 
79ID/ub1Pt/mDpCprVmOoA: folds 
RpaEX9P7BCvyfPRLiRNg0A: folds 
Ar4vsUIUfJ7gbYh1c1m59g: folds 
*** FLOP *** [6h 5d Tc]
SxIIgwXYLkwd6m3wLyPTCw: bets $1.25
YaAEMJGY5tem39deCUQRNw: calls $1.25
*** TURN *** [6h 5d Tc] [4s]
SxIIgwXYLkwd6m3wLyPTCw: bets $3.25
YaAEMJGY5tem39deCUQRNw: folds 
Uncalled bet ($3.25) returned to SxIIgwXYLkwd6m3wLyPTCw
SxIIgwXYLkwd6m3wLyPTCw collected $4.15 from pot
SxIIgwXYLkwd6m3wLyPTCw: doesn't show hand 
*** SUMMARY ***
Total pot $4.35 | Rake $0.20 
Board [6h 5d Tc 4s]
Seat 1: 79ID/ub1Pt/mDpCprVmOoA (button) folded before Flop (didn't bet)
Seat 2: RpaEX9P7BCvyfPRLiRNg0A (small blind) folded before Flop
Seat 3: Ar4vsUIUfJ7gbYh1c1m59g (big blind) folded before Flop
Seat 4: SxIIgwXYLkwd6m3wLyPTCw collected ($4.15)
Seat 5: YaAEMJGY5tem39deCUQRNw folded on the Turn
Seat 6: 7qRk4YH4/k/08LgJSv7rBQ folded before Flop (didn't bet)




PokerStars Game #59939750896:  Hold'em No Limit ($0.10/$0.25) - 2009/07/01 0:47:59 ET
Table 'wPWRBZPJl1HAnysw7qRR0A' 6-max Seat #3 is the button
Seat 1: cPO/1/dTcZpLkQFm3jH3Rg ($36.75 in chips) 
Seat 2: 48oT5xFI+5CHUJlfoGrE4w ($7.95 in chips) 
Seat 3: gqW2aBCmrIw65BvwjTFN6Q ($26.80 in chips) 
Seat 4: kbpWbC+dJNBphHl1jtw7bw ($28.40 in chips) 
Seat 5: LtASJ9OlkqGrrUKGQlpGAw ($20.95 in chips) 
Seat 6: VLoE/jniCqHZuUkx8Esf6w ($36.45 in chips) 
kbpWbC+dJNBphHl1jtw7bw: posts small blind $0.10
LtASJ9OlkqGrrUKGQlpGAw: posts big blind $0.25
*** HOLE CARDS ***
VLoE/jniCqHZuUkx8Esf6w: calls $0.25
VLoE/jniCqHZuUkx8Esf6w said, "lol"
cPO/1/dTcZpLkQFm3jH3Rg: folds 
48oT5xFI+5CHUJlfoGrE4w: calls $0.25
gqW2aBCmrIw65BvwjTFN6Q: folds 
kbpWbC+dJNBphHl1jtw7bw: folds 
LtASJ9OlkqGrrUKGQlpGAw: checks 
*** FLOP *** [Tc 3c 8h]
LtASJ9OlkqGrrUKGQlpGAw: checks 
VLoE/jniCqHZuUkx8Esf6w: checks 
48oT5xFI+5CHUJlfoGrE4w: checks 
*** TURN *** [Tc 3c 8h] [Ks]
LtASJ9OlkqGrrUKGQlpGAw: checks 
VLoE/jniCqHZuUkx8Esf6w: checks 
48oT5xFI+5CHUJlfoGrE4w: checks 
*** RIVER *** [Tc 3c 8h Ks] [Jd]
LtASJ9OlkqGrrUKGQlpGAw: checks 
VLoE/jniCqHZuUkx8Esf6w: bets $1.25
48oT5xFI+5CHUJlfoGrE4w: folds 
LtASJ9OlkqGrrUKGQlpGAw: folds 
Uncalled bet ($1.25) returned to VLoE/jniCqHZuUkx8Esf6w
VLoE/jniCqHZuUkx8Esf6w collected $0.85 from pot
*** SUMMARY ***
Total pot $0.85 | Rake $0 
Board [Tc 3c 8h Ks Jd]
Seat 1: cPO/1/dTcZpLkQFm3jH3Rg folded before Flop (didn't bet)
Seat 2: 48oT5xFI+5CHUJlfoGrE4w folded on the River
Seat 3: gqW2aBCmrIw65BvwjTFN6Q (button) folded before Flop (didn't bet)
Seat 4: kbpWbC+dJNBphHl1jtw7bw (small blind) folded before Flop
Seat 5: LtASJ9OlkqGrrUKGQlpGAw (big blind) folded on the River
Seat 6: VLoE/jniCqHZuUkx8Esf6w collected ($0.85)




PokerStars Game #59939750882:  Hold'em No Limit ($0.10/$0.25) - 2009/07/01 0:47:59 ET
Table '4mnXP0EWt9mMZYzTIVDQ0w' 9-max Seat #8 is the button
Seat 1: PTFwg4rGxnfVvj2iP1OI2w ($12.95 in chips) 
Seat 2: j4q3p0lesp63b1gZDwLBZw ($6.85 in chips) 
Seat 4: E0iYnEVO2ho7dH3QcCjw7g ($24.65 in chips) 
Seat 5: sSN8Y0AlsBeidZXPKmwXSw ($23.40 in chips) 
Seat 7: s1y+qfkBnhgc67+X3ThjeA ($26.35 in chips) 
Seat 8: H9KUl8cmpLgEpOVDA00bCg ($5 in chips) 
PTFwg4rGxnfVvj2iP1OI2w: posts small blind $0.10
j4q3p0lesp63b1gZDwLBZw: posts big blind $0.25
ompa52: sits out 
*** HOLE CARDS ***
E0iYnEVO2ho7dH3QcCjw7g: folds 
sSN8Y0AlsBeidZXPKmwXSw: calls $0.25
s1y+qfkBnhgc67+X3ThjeA: folds 
H9KUl8cmpLgEpOVDA00bCg: folds 
SPRGBR joins the table at seat #6 
PTFwg4rGxnfVvj2iP1OI2w: calls $0.15
j4q3p0lesp63b1gZDwLBZw: checks 
*** FLOP *** [7h 8h Qc]
PTFwg4rGxnfVvj2iP1OI2w: checks 
j4q3p0lesp63b1gZDwLBZw: checks 
sSN8Y0AlsBeidZXPKmwXSw: bets $0.75
PTFwg4rGxnfVvj2iP1OI2w: folds 
j4q3p0lesp63b1gZDwLBZw: folds 
Uncalled bet ($0.75) returned to sSN8Y0AlsBeidZXPKmwXSw
sSN8Y0AlsBeidZXPKmwXSw collected $0.75 from pot
sSN8Y0AlsBeidZXPKmwXSw: doesn't show hand 
*** SUMMARY ***
Total pot $0.75 | Rake $0 
Board [7h 8h Qc]
Seat 1: PTFwg4rGxnfVvj2iP1OI2w (small blind) folded on the Flop
Seat 2: j4q3p0lesp63b1gZDwLBZw (big blind) folded on the Flop
Seat 4: E0iYnEVO2ho7dH3QcCjw7g folded before Flop (didn't bet)
Seat 5: sSN8Y0AlsBeidZXPKmwXSw collected ($0.75)
Seat 7: s1y+qfkBnhgc67+X3ThjeA folded before Flop (didn't bet)
Seat 8: H9KUl8cmpLgEpOVDA00bCg (button) folded before Flop (didn't bet)




PokerStars Game #59939750996:  Hold'em No Limit ($0.10/$0.25) - 2009/07/01 0:47:59 ET
Table '52Meibn9NOL4XtVi1p2Upw' 9-max Seat #1 is the button
Seat 1: LSrAei+fS8MYG9ie/GkG0Q ($12.45 in chips) 
Seat 2: BEIBUu2pIflPrCL+Iks4CQ ($12.85 in chips) 
Seat 3: MzBvksetB8XYtCt0FExJMg ($11 in chips) 
Seat 4: rCaXm4/EwAgWqCiClpbsqQ ($11.25 in chips) 
Seat 5: 4oA316mXLIui1QY63GXBUg ($27.70 in chips) 
Seat 6: 1wKfgJ8xXIiuc8C6qjkxhg ($9.80 in chips) 
Seat 7: R3KkgiqTvuhazyCqaD9cZg ($10 in chips) 
Seat 8: eKma8Z98pP7H8m4CEt075w ($22.95 in chips) 
Seat 9: 8B/dhbQjIWe6ASCdgzktNQ ($27.25 in chips) 
BEIBUu2pIflPrCL+Iks4CQ: posts small blind $0.10
MzBvksetB8XYtCt0FExJMg: posts big blind $0.25
*** HOLE CARDS ***
rCaXm4/EwAgWqCiClpbsqQ: calls $0.25
4oA316mXLIui1QY63GXBUg: folds 
1wKfgJ8xXIiuc8C6qjkxhg: folds 
R3KkgiqTvuhazyCqaD9cZg: folds 
eKma8Z98pP7H8m4CEt075w: calls $0.25
8B/dhbQjIWe6ASCdgzktNQ: raises $1.25 to $1.50
LSrAei+fS8MYG9ie/GkG0Q: folds 
BEIBUu2pIflPrCL+Iks4CQ: folds 
MzBvksetB8XYtCt0FExJMg: folds 
rCaXm4/EwAgWqCiClpbsqQ: calls $1.25
eKma8Z98pP7H8m4CEt075w: folds 
*** FLOP *** [Td 7d 2h]
rCaXm4/EwAgWqCiClpbsqQ: checks 
8B/dhbQjIWe6ASCdgzktNQ: checks 
*** TURN *** [Td 7d 2h] [Ac]
rCaXm4/EwAgWqCiClpbsqQ: bets $0.50
8B/dhbQjIWe6ASCdgzktNQ: raises $2.50 to $3
rCaXm4/EwAgWqCiClpbsqQ: folds 
Uncalled bet ($2.50) returned to 8B/dhbQjIWe6ASCdgzktNQ
8B/dhbQjIWe6ASCdgzktNQ collected $4.40 from pot
8B/dhbQjIWe6ASCdgzktNQ: doesn't show hand 
*** SUMMARY ***
Total pot $4.60 | Rake $0.20 
Board [Td 7d 2h Ac]
Seat 1: LSrAei+fS8MYG9ie/GkG0Q (button) folded before Flop (didn't bet)
Seat 2: BEIBUu2pIflPrCL+Iks4CQ (small blind) folded before Flop
Seat 3: MzBvksetB8XYtCt0FExJMg (big blind) folded before Flop
Seat 4: rCaXm4/EwAgWqCiClpbsqQ folded on the Turn
Seat 5: 4oA316mXLIui1QY63GXBUg folded before Flop (didn't bet)
Seat 6: 1wKfgJ8xXIiuc8C6qjkxhg folded before Flop (didn't bet)
Seat 7: R3KkgiqTvuhazyCqaD9cZg folded before Flop (didn't bet)
Seat 8: eKma8Z98pP7H8m4CEt075w folded before Flop
Seat 9: 8B/dhbQjIWe6ASCdgzktNQ collected ($4.40)




PokerStars Game #59939750786:  Hold'em No Limit ($0.10/$0.25) - 2009/07/01 0:47:59 ET
Table '50f2Xa1b1jp6cfdTAgXFIg' 9-max Seat #1 is the button
Seat 1: JwUqpgqGHS96sdpExhhEqw ($8.55 in chips) 
Seat 2: F7pnn6czNpHvRM55XcA2EA ($25 in chips) 
Seat 3: GQTWTgG7Ydy9q/vohVnKmQ ($25.35 in chips) 
Seat 4: ghNKXUBl/H+t83JF079ZBA ($28.50 in chips) 
Seat 5: OlPJsgR4xypSg/w1z7Gyvw ($52.25 in chips) 
Seat 6: Vl8zO7J9ZOnk8Og8eXFezg ($40.65 in chips) 
Seat 7: TeWJxSETzbXGiYKx0y+dtg ($25 in chips) 
Seat 8: jeKWRUkMaVn8rEUjnJKqpg ($27.40 in chips) 
Seat 9: gehe91e0IyVT0QU/XBkEyg ($27.55 in chips) 
F7pnn6czNpHvRM55XcA2EA: posts small blind $0.10
GQTWTgG7Ydy9q/vohVnKmQ: posts big blind $0.25
*** HOLE CARDS ***
ghNKXUBl/H+t83JF079ZBA: folds 
OlPJsgR4xypSg/w1z7Gyvw: folds 
Vl8zO7J9ZOnk8Og8eXFezg: calls $0.25
TeWJxSETzbXGiYKx0y+dtg: folds 
jeKWRUkMaVn8rEUjnJKqpg: raises $1.25 to $1.50
gehe91e0IyVT0QU/XBkEyg: folds 
JwUqpgqGHS96sdpExhhEqw: calls $1.50
F7pnn6czNpHvRM55XcA2EA: folds 
GQTWTgG7Ydy9q/vohVnKmQ: folds 
Vl8zO7J9ZOnk8Og8eXFezg: folds 
*** FLOP *** [3h 3c 6s]
jeKWRUkMaVn8rEUjnJKqpg: bets $2
JwUqpgqGHS96sdpExhhEqw: raises $5.05 to $7.05 and is all-in
jeKWRUkMaVn8rEUjnJKqpg: calls $5.05
*** TURN *** [3h 3c 6s] [6d]
*** RIVER *** [3h 3c 6s 6d] [8s]
*** SHOW DOWN ***
jeKWRUkMaVn8rEUjnJKqpg: shows [Qs Qc] (two pair, Queens and Sixes)
JwUqpgqGHS96sdpExhhEqw: mucks hand 
jeKWRUkMaVn8rEUjnJKqpg collected $16.85 from pot
*** SUMMARY ***
Total pot $17.70 | Rake $0.85 
Board [3h 3c 6s 6d 8s]
Seat 1: JwUqpgqGHS96sdpExhhEqw (button) mucked
Seat 2: F7pnn6czNpHvRM55XcA2EA (small blind) folded before Flop
Seat 3: GQTWTgG7Ydy9q/vohVnKmQ (big blind) folded before Flop
Seat 4: ghNKXUBl/H+t83JF079ZBA folded before Flop (didn't bet)
Seat 5: OlPJsgR4xypSg/w1z7Gyvw folded before Flop (didn't bet)
Seat 6: Vl8zO7J9ZOnk8Og8eXFezg folded before Flop
Seat 7: TeWJxSETzbXGiYKx0y+dtg folded before Flop (didn't bet)
Seat 8: jeKWRUkMaVn8rEUjnJKqpg showed [Qs Qc] and won ($16.85) with two pair, Queens and Sixes
Seat 9: gehe91e0IyVT0QU/XBkEyg folded before Flop (didn't bet)




PokerStars Game #59939750586:  Hold'em No Limit ($0.10/$0.25) - 2009/07/01 0:47:59 ET
Table 'IfRHUn9gQQA9I/Z4tn+BoA' 9-max Seat #3 is the button
Seat 1: vSkQm2EelzwRGDDQQk0Fqw ($5 in chips) 
Seat 2: V6p0jQ/RhUsqpHLmXvEX4Q ($14.10 in chips) 
Seat 3: iAQDnrJCZVD1LzAGxTYegw ($24.90 in chips) 
Seat 4: QEbIGci+itdw+re8RM5fZA ($29.25 in chips) 
Seat 5: 10584482 ($16.75 in chips) 
Seat 6: UOjoGGQ58/uDS7V0xkjOrQ ($6.75 in chips) 
Seat 7: TeWJxSETzbXGiYKx0y+dtg ($36.30 in chips) 
Seat 8: cZ99hugmLBj9KhTlc8nCSw ($25 in chips) 
Seat 9: 7cv+9Zc9HIQHNvYsMfV3uA ($25 in chips) 
QEbIGci+itdw+re8RM5fZA: posts small blind $0.10
10584482: posts big blind $0.25
*** HOLE CARDS ***
UOjoGGQ58/uDS7V0xkjOrQ: calls $0.25
TeWJxSETzbXGiYKx0y+dtg: folds 
cZ99hugmLBj9KhTlc8nCSw: folds 
7cv+9Zc9HIQHNvYsMfV3uA: raises $1 to $1.25
vSkQm2EelzwRGDDQQk0Fqw: folds 
V6p0jQ/RhUsqpHLmXvEX4Q: folds 
iAQDnrJCZVD1LzAGxTYegw: folds 
QEbIGci+itdw+re8RM5fZA: folds 
10584482: calls $1
UOjoGGQ58/uDS7V0xkjOrQ: calls $1
*** FLOP *** [Jh 4d 2h]
10584482: checks 
UOjoGGQ58/uDS7V0xkjOrQ: bets $1.25
7cv+9Zc9HIQHNvYsMfV3uA: raises $3.50 to $4.75
10584482: folds 
UOjoGGQ58/uDS7V0xkjOrQ: raises $0.75 to $5.50 and is all-in
7cv+9Zc9HIQHNvYsMfV3uA: calls $0.75
*** TURN *** [Jh 4d 2h] [4s]
*** RIVER *** [Jh 4d 2h 4s] [Qd]
*** SHOW DOWN ***
UOjoGGQ58/uDS7V0xkjOrQ: shows [2s Js] (two pair, Jacks and Fours)
7cv+9Zc9HIQHNvYsMfV3uA: shows [Ac Ad] (two pair, Aces and Fours)
7cv+9Zc9HIQHNvYsMfV3uA collected $14.15 from pot
*** SUMMARY ***
Total pot $14.85 | Rake $0.70 
Board [Jh 4d 2h 4s Qd]
Seat 1: vSkQm2EelzwRGDDQQk0Fqw folded before Flop (didn't bet)
Seat 2: V6p0jQ/RhUsqpHLmXvEX4Q folded before Flop (didn't bet)
Seat 3: iAQDnrJCZVD1LzAGxTYegw (button) folded before Flop (didn't bet)
Seat 4: QEbIGci+itdw+re8RM5fZA (small blind) folded before Flop
Seat 5: 10584482 (big blind) folded on the Flop
Seat 6: UOjoGGQ58/uDS7V0xkjOrQ showed [2s Js] and lost with two pair, Jacks and Fours
Seat 7: TeWJxSETzbXGiYKx0y+dtg folded before Flop (didn't bet)
Seat 8: cZ99hugmLBj9KhTlc8nCSw folded before Flop (didn't bet)
Seat 9: 7cv+9Zc9HIQHNvYsMfV3uA showed [Ac Ad] and won ($14.15) with two pair, Aces and Fours




PokerStars Game #59939750942:  Hold'em No Limit ($0.10/$0.25) - 2009/07/01 0:47:59 ET
Table 'aisAlB9GIV21BwfUW3+Nbg' 9-max Seat #6 is the button
Seat 1: H5Se03ZqSX7tbULXur2MAg ($30.30 in chips) 
Seat 2: 18G4P1XstjNvItdGUITxgw ($25.35 in chips) 
Seat 3: aaNpjkDAbOD7pVe8Z5CEgQ ($22.65 in chips) 
Seat 4: sD+TKtt36XiiN6jqHiLwDA ($24.50 in chips) 
Seat 5: ghNKXUBl/H+t83JF079ZBA ($25 in chips) 
Seat 6: 9gmYYQesalMrUjaF7nKfrQ ($7.25 in chips) 
Seat 7: sWBBy1WroEskLNyJzhkUag ($9.35 in chips) 
Seat 8: VWUWpMLMj/Q1jRVpF7Aohw ($14.30 in chips) 
Seat 9: OlPJsgR4xypSg/w1z7Gyvw ($28.30 in chips) 
sWBBy1WroEskLNyJzhkUag: posts small blind $0.10
VWUWpMLMj/Q1jRVpF7Aohw: posts big blind $0.25
*** HOLE CARDS ***
OlPJsgR4xypSg/w1z7Gyvw: folds 
H5Se03ZqSX7tbULXur2MAg: folds 
18G4P1XstjNvItdGUITxgw: folds 
aaNpjkDAbOD7pVe8Z5CEgQ: folds 
sD+TKtt36XiiN6jqHiLwDA: folds 
ghNKXUBl/H+t83JF079ZBA: folds 
9gmYYQesalMrUjaF7nKfrQ: folds 
sWBBy1WroEskLNyJzhkUag: raises $0.75 to $1
VWUWpMLMj/Q1jRVpF7Aohw: calls $0.75
*** FLOP *** [9c 7s 5c]
sWBBy1WroEskLNyJzhkUag: checks 
VWUWpMLMj/Q1jRVpF7Aohw: bets $1
sWBBy1WroEskLNyJzhkUag: raises $1.50 to $2.50
VWUWpMLMj/Q1jRVpF7Aohw: calls $1.50
*** TURN *** [9c 7s 5c] [Jh]
sWBBy1WroEskLNyJzhkUag: checks 
VWUWpMLMj/Q1jRVpF7Aohw: bets $3.25
sWBBy1WroEskLNyJzhkUag: folds 
Uncalled bet ($3.25) returned to VWUWpMLMj/Q1jRVpF7Aohw
VWUWpMLMj/Q1jRVpF7Aohw collected $6.70 from pot
*** SUMMARY ***
Total pot $7 | Rake $0.30 
Board [9c 7s 5c Jh]
Seat 1: H5Se03ZqSX7tbULXur2MAg folded before Flop (didn't bet)
Seat 2: 18G4P1XstjNvItdGUITxgw folded before Flop (didn't bet)
Seat 3: aaNpjkDAbOD7pVe8Z5CEgQ folded before Flop (didn't bet)
Seat 4: sD+TKtt36XiiN6jqHiLwDA folded before Flop (didn't bet)
Seat 5: ghNKXUBl/H+t83JF079ZBA folded before Flop (didn't bet)
Seat 6: 9gmYYQesalMrUjaF7nKfrQ (button) folded before Flop (didn't bet)
Seat 7: sWBBy1WroEskLNyJzhkUag (small blind) folded on the Turn
Seat 8: VWUWpMLMj/Q1jRVpF7Aohw (big blind) collected ($6.70)
Seat 9: OlPJsgR4xypSg/w1z7Gyvw folded before Flop (didn't bet)




PokerStars Game #59939751204:  Hold'em No Limit ($0.10/$0.25) - 2009/07/01 0:47:59 ET
Table 'Utmw+yX+E/wdhNDIim90lQ' 9-max Seat #1 is the button
Seat 1: lwlnPm68QGGI/+pnAd4GAw ($58.75 in chips) 
Seat 2: iGMlK+EhUflPB6jKQd95Cg ($32.05 in chips) 
Seat 3: dfNim92Z6XK1/h5SFW5vDg ($25 in chips) 
Seat 4: ifYGvZDHQQ0aam4awTtHwA ($4.85 in chips) 
Seat 5: H9KUl8cmpLgEpOVDA00bCg ($5 in chips) 
Seat 6: OlPJsgR4xypSg/w1z7Gyvw ($19.65 in chips) 
Seat 7: CImUHesK+ZER4v/VCA9IUg ($64.20 in chips) 
Seat 8: DdPXdieucQ+n99u1n3A+rQ ($6.05 in chips) 
Seat 9: Th3FldXKQW6hWVVPahaoOQ ($27.15 in chips) 
iGMlK+EhUflPB6jKQd95Cg: posts small blind $0.10
dfNim92Z6XK1/h5SFW5vDg: posts big blind $0.25
*** HOLE CARDS ***
ifYGvZDHQQ0aam4awTtHwA: calls $0.25
H9KUl8cmpLgEpOVDA00bCg: folds 
OlPJsgR4xypSg/w1z7Gyvw: folds 
CImUHesK+ZER4v/VCA9IUg: folds 
DdPXdieucQ+n99u1n3A+rQ: folds 
Th3FldXKQW6hWVVPahaoOQ: folds 
lwlnPm68QGGI/+pnAd4GAw: folds 
iGMlK+EhUflPB6jKQd95Cg: raises $1 to $1.25
dfNim92Z6XK1/h5SFW5vDg: folds 
ifYGvZDHQQ0aam4awTtHwA: calls $1
*** FLOP *** [Qh 5c 6h]
iGMlK+EhUflPB6jKQd95Cg: bets $2
ifYGvZDHQQ0aam4awTtHwA: calls $2
*** TURN *** [Qh 5c 6h] [7s]
iGMlK+EhUflPB6jKQd95Cg: bets $1.75
ifYGvZDHQQ0aam4awTtHwA: calls $1.60 and is all-in
Uncalled bet ($0.15) returned to iGMlK+EhUflPB6jKQd95Cg
*** RIVER *** [Qh 5c 6h 7s] [7d]
*** SHOW DOWN ***
iGMlK+EhUflPB6jKQd95Cg: shows [Ks Kc] (two pair, Kings and Sevens)
ifYGvZDHQQ0aam4awTtHwA: mucks hand 
iGMlK+EhUflPB6jKQd95Cg collected $9.50 from pot
*** SUMMARY ***
Total pot $9.95 | Rake $0.45 
Board [Qh 5c 6h 7s 7d]
Seat 1: lwlnPm68QGGI/+pnAd4GAw (button) folded before Flop (didn't bet)
Seat 2: iGMlK+EhUflPB6jKQd95Cg (small blind) showed [Ks Kc] and won ($9.50) with two pair, Kings and Sevens
Seat 3: dfNim92Z6XK1/h5SFW5vDg (big blind) folded before Flop
Seat 4: ifYGvZDHQQ0aam4awTtHwA mucked
Seat 5: H9KUl8cmpLgEpOVDA00bCg folded before Flop (didn't bet)
Seat 6: OlPJsgR4xypSg/w1z7Gyvw folded before Flop (didn't bet)
Seat 7: CImUHesK+ZER4v/VCA9IUg folded before Flop (didn't bet)
Seat 8: DdPXdieucQ+n99u1n3A+rQ folded before Flop (didn't bet)
Seat 9: Th3FldXKQW6hWVVPahaoOQ folded before Flop (didn't bet)




PokerStars Game #59939751846:  Hold'em No Limit ($0.10/$0.25) - 2009/07/01 0:48:00 ET
Table 'LwnjzXstPtSrqrV/oDpnXQ' 9-max Seat #2 is the button
Seat 1: sChhj/mp8dm+nGvBS5mOIA ($18.85 in chips) 
Seat 2: K7bAhhMMJ/XcTmGaBZVfFQ ($27.45 in chips) 
Seat 3: u+XLsbPQIcRvPRnS1bvZww ($12.85 in chips) 
Seat 4: nmvbguGv4wKulGg49bANbQ ($12.25 in chips) 
Seat 5: Th3FldXKQW6hWVVPahaoOQ ($29.15 in chips) 
Seat 6: ljemhp25Zg+nlA9DLCIiUw ($34.10 in chips) 
Seat 7: c/Dw/6HyqldTzIRodAIZmg ($13.40 in chips) 
Seat 8: h4ggJZYBXV0mEZzYPYKfeA ($31.95 in chips) 
Seat 9: N6fYvIzQLKaydFLKQGtMlQ ($24.05 in chips) 
u+XLsbPQIcRvPRnS1bvZww: posts small blind $0.10
nmvbguGv4wKulGg49bANbQ: posts big blind $0.25
*** HOLE CARDS ***
Th3FldXKQW6hWVVPahaoOQ: folds 
ljemhp25Zg+nlA9DLCIiUw: folds 
c/Dw/6HyqldTzIRodAIZmg: folds 
h4ggJZYBXV0mEZzYPYKfeA: folds 
N6fYvIzQLKaydFLKQGtMlQ: folds 
sChhj/mp8dm+nGvBS5mOIA: folds 
K7bAhhMMJ/XcTmGaBZVfFQ: folds 
u+XLsbPQIcRvPRnS1bvZww: calls $0.15
nmvbguGv4wKulGg49bANbQ: checks 
*** FLOP *** [6s Jh Kd]
u+XLsbPQIcRvPRnS1bvZww: checks 
nmvbguGv4wKulGg49bANbQ: checks 
*** TURN *** [6s Jh Kd] [4h]
u+XLsbPQIcRvPRnS1bvZww: checks 
nmvbguGv4wKulGg49bANbQ: checks 
*** RIVER *** [6s Jh Kd 4h] [5c]
u+XLsbPQIcRvPRnS1bvZww: bets $0.25
nmvbguGv4wKulGg49bANbQ: calls $0.25
*** SHOW DOWN ***
u+XLsbPQIcRvPRnS1bvZww: shows [8s 9s] (high card King)
nmvbguGv4wKulGg49bANbQ: shows [Ah 2c] (high card Ace)
nmvbguGv4wKulGg49bANbQ collected $0.95 from pot
*** SUMMARY ***
Total pot $1 | Rake $0.05 
Board [6s Jh Kd 4h 5c]
Seat 1: sChhj/mp8dm+nGvBS5mOIA folded before Flop (didn't bet)
Seat 2: K7bAhhMMJ/XcTmGaBZVfFQ (button) folded before Flop (didn't bet)
Seat 3: u+XLsbPQIcRvPRnS1bvZww (small blind) showed [8s 9s] and lost with high card King
Seat 4: nmvbguGv4wKulGg49bANbQ (big blind) showed [Ah 2c] and won ($0.95) with high card Ace
Seat 5: Th3FldXKQW6hWVVPahaoOQ folded before Flop (didn't bet)
Seat 6: ljemhp25Zg+nlA9DLCIiUw folded before Flop (didn't bet)
Seat 7: c/Dw/6HyqldTzIRodAIZmg folded before Flop (didn't bet)
Seat 8: h4ggJZYBXV0mEZzYPYKfeA folded before Flop (didn't bet)
Seat 9: N6fYvIzQLKaydFLKQGtMlQ folded before Flop (didn't bet)




PokerStars Game #59939751856:  Hold'em No Limit ($0.10/$0.25) - 2009/07/01 0:48:00 ET
Table 'rtxA1Y01Nrq5VoyzTAuusQ' 9-max Seat #5 is the button
Seat 1: gAlaEiNZy/H/QuIVwzvHAQ ($9.30 in chips) 
Seat 2: xtpoxBFB+5CWL2iFqk9Zlg ($34.90 in chips) 
Seat 3: K9fS1IUr5GpiJG7VkJ7IbA ($35.90 in chips) 
Seat 4: lTfGgdGMRH+DZcKby2m9Nw ($6 in chips) 
Seat 5: HG/hVrkvCiG0erBa6RyLZA ($16.15 in chips) 
Seat 6: qccGLncfUaN00Few5HsgYg ($21.80 in chips) 
Seat 7: N6fYvIzQLKaydFLKQGtMlQ ($21.30 in chips) 
Seat 8: EUSBQy2KGzT65/CXiIu59Q ($31.70 in chips) 
Seat 9: HPEB+AtKw1+C/cxU0o1ciw ($24.25 in chips) 
qccGLncfUaN00Few5HsgYg: posts small blind $0.10
N6fYvIzQLKaydFLKQGtMlQ: posts big blind $0.25
lTfGgdGMRH+DZcKby2m9Nw: posts big blind $0.25
*** HOLE CARDS ***
EUSBQy2KGzT65/CXiIu59Q: folds 
HPEB+AtKw1+C/cxU0o1ciw: folds 
gAlaEiNZy/H/QuIVwzvHAQ: folds 
xtpoxBFB+5CWL2iFqk9Zlg: folds 
K9fS1IUr5GpiJG7VkJ7IbA: raises $0.50 to $0.75
lTfGgdGMRH+DZcKby2m9Nw: folds 
HG/hVrkvCiG0erBa6RyLZA: calls $0.75
qccGLncfUaN00Few5HsgYg: calls $0.65
N6fYvIzQLKaydFLKQGtMlQ: folds 
*** FLOP *** [4d Ad 5c]
qccGLncfUaN00Few5HsgYg: bets $1
K9fS1IUr5GpiJG7VkJ7IbA: calls $1
HG/hVrkvCiG0erBa6RyLZA: folds 
*** TURN *** [4d Ad 5c] [Th]
qccGLncfUaN00Few5HsgYg: bets $3.50
K9fS1IUr5GpiJG7VkJ7IbA: calls $3.50
*** RIVER *** [4d Ad 5c Th] [7s]
qccGLncfUaN00Few5HsgYg: bets $16.55 and is all-in
K9fS1IUr5GpiJG7VkJ7IbA: calls $16.55
*** SHOW DOWN ***
qccGLncfUaN00Few5HsgYg: shows [4h 4c] (three of a kind, Fours)
K9fS1IUr5GpiJG7VkJ7IbA: mucks hand 
qccGLncfUaN00Few5HsgYg collected $42.65 from pot
*** SUMMARY ***
Total pot $44.85 | Rake $2.20 
Board [4d Ad 5c Th 7s]
Seat 1: gAlaEiNZy/H/QuIVwzvHAQ folded before Flop (didn't bet)
Seat 2: xtpoxBFB+5CWL2iFqk9Zlg folded before Flop (didn't bet)
Seat 3: K9fS1IUr5GpiJG7VkJ7IbA mucked
Seat 4: lTfGgdGMRH+DZcKby2m9Nw folded before Flop
Seat 5: HG/hVrkvCiG0erBa6RyLZA (button) folded on the Flop
Seat 6: qccGLncfUaN00Few5HsgYg (small blind) showed [4h 4c] and won ($42.65) with three of a kind, Fours
Seat 7: N6fYvIzQLKaydFLKQGtMlQ (big blind) folded before Flop
Seat 8: EUSBQy2KGzT65/CXiIu59Q folded before Flop (didn't bet)
Seat 9: HPEB+AtKw1+C/cxU0o1ciw folded before Flop (didn't bet)




PokerStars Game #59939751534:  Hold'em No Limit ($0.10/$0.25) - 2009/07/01 0:48:00 ET
Table '6ae4XiTo6B597KfSSMr8Cg' 9-max Seat #7 is the button
Seat 1: 49YfVBEOwzD3/FVw+dTTBQ ($11.10 in chips) 
Seat 2: 5s3p6yoJBNW438dsyKTP8g ($43.95 in chips) 
Seat 3: yyG4svzOpC1A+sUP/scg6w ($8.85 in chips) 
Seat 4: dfNim92Z6XK1/h5SFW5vDg ($48.40 in chips) 
Seat 6: DlXs37dlX3tb7o/7lYXQSw ($25 in chips) 
Seat 7: 18G4P1XstjNvItdGUITxgw ($25.35 in chips) 
Seat 8: F7pnn6czNpHvRM55XcA2EA ($25.35 in chips) 
Seat 9: E0iYnEVO2ho7dH3QcCjw7g ($37.10 in chips) 
F7pnn6czNpHvRM55XcA2EA: posts small blind $0.10
E0iYnEVO2ho7dH3QcCjw7g: posts big blind $0.25
*** HOLE CARDS ***
49YfVBEOwzD3/FVw+dTTBQ: folds 
5s3p6yoJBNW438dsyKTP8g: folds 
yyG4svzOpC1A+sUP/scg6w: folds 
dfNim92Z6XK1/h5SFW5vDg: folds 
DlXs37dlX3tb7o/7lYXQSw: folds 
18G4P1XstjNvItdGUITxgw: folds 
F7pnn6czNpHvRM55XcA2EA: raises $0.75 to $1
E0iYnEVO2ho7dH3QcCjw7g: folds 
Uncalled bet ($0.75) returned to F7pnn6czNpHvRM55XcA2EA
F7pnn6czNpHvRM55XcA2EA collected $0.50 from pot
F7pnn6czNpHvRM55XcA2EA: doesn't show hand 
*** SUMMARY ***
Total pot $0.50 | Rake $0 
Seat 1: 49YfVBEOwzD3/FVw+dTTBQ folded before Flop (didn't bet)
Seat 2: 5s3p6yoJBNW438dsyKTP8g folded before Flop (didn't bet)
Seat 3: yyG4svzOpC1A+sUP/scg6w folded before Flop (didn't bet)
Seat 4: dfNim92Z6XK1/h5SFW5vDg folded before Flop (didn't bet)
Seat 6: DlXs37dlX3tb7o/7lYXQSw folded before Flop (didn't bet)
Seat 7: 18G4P1XstjNvItdGUITxgw (button) folded before Flop (didn't bet)
Seat 8: F7pnn6czNpHvRM55XcA2EA (small blind) collected ($0.50)
Seat 9: E0iYnEVO2ho7dH3QcCjw7g (big blind) folded before Flop




PokerStars Game #59939751840:  Hold'em No Limit ($0.10/$0.25) - 2009/07/01 0:48:00 ET
Table 'KYX9dFNuOA9l2PV46IebqQ' 9-max Seat #8 is the button
Seat 1: s7Q6uNouhe7aE8JdFb9E+A ($27.40 in chips) 
Seat 3: f+H1PHwj9cNu4Y6FfvKwQQ ($29.35 in chips) 
Seat 4: SkLOm0UugROBRt2EfMpOxQ ($25.35 in chips) 
Seat 5: HQMjiff9S04k8kyC4fHVgw ($3.65 in chips) 
Seat 6: DiSvPC2iudwL5j9u6Huyww ($26.50 in chips) 
Seat 7: QOyn4M230Dsb5atoXgDy9A ($11.80 in chips) 
Seat 8: 4oA316mXLIui1QY63GXBUg ($25 in chips) 
Seat 9: W4TLQcZ2TiM73eIgpIvlGg ($34.65 in chips) 
W4TLQcZ2TiM73eIgpIvlGg: posts small blind $0.10
s7Q6uNouhe7aE8JdFb9E+A: posts big blind $0.25
MrPo4/ymXwg9lzPRybrXbA: sits out 
*** HOLE CARDS ***
f+H1PHwj9cNu4Y6FfvKwQQ: folds 
SkLOm0UugROBRt2EfMpOxQ: folds 
HQMjiff9S04k8kyC4fHVgw: folds 
DiSvPC2iudwL5j9u6Huyww: folds 
QOyn4M230Dsb5atoXgDy9A: calls $0.25
4oA316mXLIui1QY63GXBUg: folds 
W4TLQcZ2TiM73eIgpIvlGg: folds 
s7Q6uNouhe7aE8JdFb9E+A: raises $1.25 to $1.50
QOyn4M230Dsb5atoXgDy9A: calls $1.25
*** FLOP *** [5c Jd 4c]
s7Q6uNouhe7aE8JdFb9E+A has timed out
s7Q6uNouhe7aE8JdFb9E+A: checks 
QOyn4M230Dsb5atoXgDy9A: checks 
*** TURN *** [5c Jd 4c] [8c]
s7Q6uNouhe7aE8JdFb9E+A has timed out
s7Q6uNouhe7aE8JdFb9E+A: checks 
QOyn4M230Dsb5atoXgDy9A: checks 
*** RIVER *** [5c Jd 4c 8c] [Jh]
s7Q6uNouhe7aE8JdFb9E+A: checks 
QOyn4M230Dsb5atoXgDy9A: bets $0.50
s7Q6uNouhe7aE8JdFb9E+A: calls $0.50
*** SHOW DOWN ***
QOyn4M230Dsb5atoXgDy9A: shows [7s 9d] (a pair of Jacks)
s7Q6uNouhe7aE8JdFb9E+A: shows [Qd Ad] (a pair of Jacks - Ace kicker)
s7Q6uNouhe7aE8JdFb9E+A collected $3.95 from pot
*** SUMMARY ***
Total pot $4.10 | Rake $0.15 
Board [5c Jd 4c 8c Jh]
Seat 1: s7Q6uNouhe7aE8JdFb9E+A (big blind) showed [Qd Ad] and won ($3.95) with a pair of Jacks
Seat 3: f+H1PHwj9cNu4Y6FfvKwQQ folded before Flop (didn't bet)
Seat 4: SkLOm0UugROBRt2EfMpOxQ folded before Flop (didn't bet)
Seat 5: HQMjiff9S04k8kyC4fHVgw folded before Flop (didn't bet)
Seat 6: DiSvPC2iudwL5j9u6Huyww folded before Flop (didn't bet)
Seat 7: QOyn4M230Dsb5atoXgDy9A showed [7s 9d] and lost with a pair of Jacks
Seat 8: 4oA316mXLIui1QY63GXBUg (button) folded before Flop (didn't bet)
Seat 9: W4TLQcZ2TiM73eIgpIvlGg (small blind) folded before Flop




PokerStars Game #59939751366:  Hold'em No Limit ($0.10/$0.25) - 2009/07/01 0:48:00 ET
Table 'zhqgUUprOJ14VxKxPHcT/Q' 9-max Seat #9 is the button
Seat 2: GY095KWhBevJ1Ttvl8WseA ($16.20 in chips) 
Seat 3: G2offPrpnppc++nuXqs2JA ($17.25 in chips) 
Seat 4: EfeOSXE8Wc4WWEsgc3WzZg ($8.40 in chips) 
Seat 5: +sbyWwIcFp9kP0bDtMegfQ ($26.75 in chips) 
Seat 6: DIBbjEYGs+TVdVgEB/4+3w ($22.35 in chips) 
Seat 7: Ebzw1YytWRd/vXFjA8XReg ($24 in chips) 
Seat 8: amD2PwT1xB7aC2k57sa7Ig ($25 in chips) 
Seat 9: 4awUyiDYTgylQKXZ9faBVA ($34.35 in chips) 
22dIObOuor/A+IKWkNoAlA will be allowed to play after the button
GY095KWhBevJ1Ttvl8WseA: posts small blind $0.10
G2offPrpnppc++nuXqs2JA: posts big blind $0.25
*** HOLE CARDS ***
EfeOSXE8Wc4WWEsgc3WzZg: raises $0.75 to $1
+sbyWwIcFp9kP0bDtMegfQ: folds 
DIBbjEYGs+TVdVgEB/4+3w: folds 
Ebzw1YytWRd/vXFjA8XReg: folds 
amD2PwT1xB7aC2k57sa7Ig: raises $2.50 to $3.50
4awUyiDYTgylQKXZ9faBVA: folds 
GY095KWhBevJ1Ttvl8WseA: folds 
G2offPrpnppc++nuXqs2JA: folds 
EfeOSXE8Wc4WWEsgc3WzZg: calls $2.50
*** FLOP *** [7s 3s Jc]
EfeOSXE8Wc4WWEsgc3WzZg: checks 
amD2PwT1xB7aC2k57sa7Ig: bets $5
EfeOSXE8Wc4WWEsgc3WzZg: calls $4.90 and is all-in
Uncalled bet ($0.10) returned to amD2PwT1xB7aC2k57sa7Ig
*** TURN *** [7s 3s Jc] [6d]
*** RIVER *** [7s 3s Jc 6d] [8h]
*** SHOW DOWN ***
EfeOSXE8Wc4WWEsgc3WzZg: shows [Ad Tc] (high card Ace)
amD2PwT1xB7aC2k57sa7Ig: shows [Ks Kc] (a pair of Kings)
amD2PwT1xB7aC2k57sa7Ig collected $16.35 from pot
*** SUMMARY ***
Total pot $17.15 | Rake $0.80 
Board [7s 3s Jc 6d 8h]
Seat 2: GY095KWhBevJ1Ttvl8WseA (small blind) folded before Flop
Seat 3: G2offPrpnppc++nuXqs2JA (big blind) folded before Flop
Seat 4: EfeOSXE8Wc4WWEsgc3WzZg showed [Ad Tc] and lost with high card Ace
Seat 5: +sbyWwIcFp9kP0bDtMegfQ folded before Flop (didn't bet)
Seat 6: DIBbjEYGs+TVdVgEB/4+3w folded before Flop (didn't bet)
Seat 7: Ebzw1YytWRd/vXFjA8XReg folded before Flop (didn't bet)
Seat 8: amD2PwT1xB7aC2k57sa7Ig showed [Ks Kc] and won ($16.35) with a pair of Kings
Seat 9: 4awUyiDYTgylQKXZ9faBVA (button) folded before Flop (didn't bet)




PokerStars Game #59939751616:  Hold'em No Limit ($0.10/$0.25) - 2009/07/01 0:48:00 ET
Table 'FE/j6VqBY4j9Uq+VHURQCQ' 6-max Seat #5 is the button
Seat 2: 3zD3qLXT1bEffAoWGnc7wg ($28.75 in chips) 
Seat 3: Zijzy/UtPWzWVUo81HHVjQ ($51.25 in chips) 
Seat 4: cPO/1/dTcZpLkQFm3jH3Rg ($25 in chips) 
Seat 5: wsP46AGpqDjHZQmlRHKa9g ($25 in chips) 
wKFJ513ucluNNiMlkXcDOQ: is sitting out 
3zD3qLXT1bEffAoWGnc7wg: posts small blind $0.10
Zijzy/UtPWzWVUo81HHVjQ: posts big blind $0.25
*** HOLE CARDS ***
cPO/1/dTcZpLkQFm3jH3Rg: folds 
wKFJ513ucluNNiMlkXcDOQ leaves the table
wsP46AGpqDjHZQmlRHKa9g: raises $0.50 to $0.75
3seg9SJ1y+HUPN0X0XKF5Q joins the table at seat #1 
3zD3qLXT1bEffAoWGnc7wg: folds 
Zijzy/UtPWzWVUo81HHVjQ: folds 
Uncalled bet ($0.50) returned to wsP46AGpqDjHZQmlRHKa9g
wsP46AGpqDjHZQmlRHKa9g collected $0.60 from pot
*** SUMMARY ***
Total pot $0.60 | Rake $0 
Seat 2: 3zD3qLXT1bEffAoWGnc7wg (small blind) folded before Flop
Seat 3: Zijzy/UtPWzWVUo81HHVjQ (big blind) folded before Flop
Seat 4: cPO/1/dTcZpLkQFm3jH3Rg folded before Flop (didn't bet)
Seat 5: wsP46AGpqDjHZQmlRHKa9g (button) collected ($0.60)




PokerStars Game #59939751892:  Hold'em No Limit ($0.10/$0.25) - 2009/07/01 0:48:00 ET
Table 'AJGgX1ZYM8d68SWMvaLttg' 6-max Seat #4 is the button
Seat 1: sT4sjqzVMH/fZHz0hkbIPw ($48.50 in chips) 
Seat 2: zHHLkD2sRljslKKeQv/ZQw ($28.10 in chips) 
Seat 3: 4x9jCqgSw4272dnaIqnanw ($11.20 in chips) 
Seat 4: Lz/GjRDgmgepqTR7qmS86w ($8.30 in chips) 
Seat 5: SFmT9ZsVopnukjvAzrxTRg ($25.50 in chips) 
Seat 6: UA5OsKS3VPaxa7uC8La/kA ($27.40 in chips) 
SFmT9ZsVopnukjvAzrxTRg: posts small blind $0.10
UA5OsKS3VPaxa7uC8La/kA: posts big blind $0.25
*** HOLE CARDS ***
sT4sjqzVMH/fZHz0hkbIPw: folds 
zHHLkD2sRljslKKeQv/ZQw: calls $0.25
4x9jCqgSw4272dnaIqnanw: folds 
Lz/GjRDgmgepqTR7qmS86w: folds 
SFmT9ZsVopnukjvAzrxTRg: folds 
UA5OsKS3VPaxa7uC8La/kA: checks 
*** FLOP *** [5d Ts 6d]
UA5OsKS3VPaxa7uC8La/kA: checks 
zHHLkD2sRljslKKeQv/ZQw: checks 
*** TURN *** [5d Ts 6d] [5h]
UA5OsKS3VPaxa7uC8La/kA: checks 
zHHLkD2sRljslKKeQv/ZQw: bets $0.50
UA5OsKS3VPaxa7uC8La/kA: folds 
Uncalled bet ($0.50) returned to zHHLkD2sRljslKKeQv/ZQw
zHHLkD2sRljslKKeQv/ZQw collected $0.60 from pot
*** SUMMARY ***
Total pot $0.60 | Rake $0 
Board [5d Ts 6d 5h]
Seat 1: sT4sjqzVMH/fZHz0hkbIPw folded before Flop (didn't bet)
Seat 2: zHHLkD2sRljslKKeQv/ZQw collected ($0.60)
Seat 3: 4x9jCqgSw4272dnaIqnanw folded before Flop (didn't bet)
Seat 4: Lz/GjRDgmgepqTR7qmS86w (button) folded before Flop (didn't bet)
Seat 5: SFmT9ZsVopnukjvAzrxTRg (small blind) folded before Flop
Seat 6: UA5OsKS3VPaxa7uC8La/kA (big blind) folded on the Turn




PokerStars Game #59939751854:  Hold'em No Limit ($0.10/$0.25) - 2009/07/01 0:48:00 ET
Table '4XGDnEByOol5up4aB2KbJw' 6-max Seat #3 is the button
Seat 1: kyRaCIljYA6l33lSKQfNsg ($26.50 in chips) 
Seat 2: SFmT9ZsVopnukjvAzrxTRg ($34.35 in chips) 
Seat 3: LtASJ9OlkqGrrUKGQlpGAw ($22.55 in chips) 
Seat 4: sjoibHX/s93+8Kwa5aB1dA ($27.95 in chips) 
Seat 5: Dh01+rohD2p9pXLYeBlC5Q ($17.30 in chips) 
Seat 6: ELW+DKizJhLK7k40PMkD2Q ($33.10 in chips) 
sjoibHX/s93+8Kwa5aB1dA: posts small blind $0.10
Dh01+rohD2p9pXLYeBlC5Q: posts big blind $0.25
*** HOLE CARDS ***
ELW+DKizJhLK7k40PMkD2Q has timed out
ELW+DKizJhLK7k40PMkD2Q: folds 
ELW+DKizJhLK7k40PMkD2Q is sitting out
kyRaCIljYA6l33lSKQfNsg: raises $0.50 to $0.75
SFmT9ZsVopnukjvAzrxTRg: folds 
LtASJ9OlkqGrrUKGQlpGAw: folds 
sjoibHX/s93+8Kwa5aB1dA: folds 
Dh01+rohD2p9pXLYeBlC5Q: folds 
Uncalled bet ($0.50) returned to kyRaCIljYA6l33lSKQfNsg
kyRaCIljYA6l33lSKQfNsg collected $0.60 from pot
*** SUMMARY ***
Total pot $0.60 | Rake $0 
Seat 1: kyRaCIljYA6l33lSKQfNsg collected ($0.60)
Seat 2: SFmT9ZsVopnukjvAzrxTRg folded before Flop (didn't bet)
Seat 3: LtASJ9OlkqGrrUKGQlpGAw (button) folded before Flop (didn't bet)
Seat 4: sjoibHX/s93+8Kwa5aB1dA (small blind) folded before Flop
Seat 5: Dh01+rohD2p9pXLYeBlC5Q (big blind) folded before Flop
Seat 6: ELW+DKizJhLK7k40PMkD2Q folded before Flop (didn't bet)




PokerStars Game #59939751696:  Hold'em No Limit ($0.10/$0.25) - 2009/07/01 0:48:00 ET
Table 'O5NgMYt6EWbLBozZb3kseg' 6-max Seat #1 is the button
Seat 1: T2fEtpqj5ZyZAjEhNtsFAA ($61.35 in chips) 
Seat 2: VWbjqONyDvf8KegytgPLjQ ($55 in chips) 
Seat 3: dg3SMYXD7586yGx+LuFM0g ($16.40 in chips) 
Seat 4: aogAb4Eienxztk8p2v9VVw ($26.25 in chips) 
Seat 5: vu2kzHaDtgr6NM7rdq0chA ($75.05 in chips) 
Seat 6: k9vn40MOqqb+xF+7GZ6v2g ($25 in chips) 
VWbjqONyDvf8KegytgPLjQ: posts small blind $0.10
dg3SMYXD7586yGx+LuFM0g: posts big blind $0.25
*** HOLE CARDS ***
aogAb4Eienxztk8p2v9VVw: folds 
vu2kzHaDtgr6NM7rdq0chA: folds 
k9vn40MOqqb+xF+7GZ6v2g: raises $0.75 to $1
T2fEtpqj5ZyZAjEhNtsFAA: folds 
VWbjqONyDvf8KegytgPLjQ: calls $0.90
dg3SMYXD7586yGx+LuFM0g: calls $0.75
*** FLOP *** [Jh Kc Jd]
VWbjqONyDvf8KegytgPLjQ: checks 
dg3SMYXD7586yGx+LuFM0g: bets $2
k9vn40MOqqb+xF+7GZ6v2g: folds 
VWbjqONyDvf8KegytgPLjQ: folds 
Uncalled bet ($2) returned to dg3SMYXD7586yGx+LuFM0g
dg3SMYXD7586yGx+LuFM0g collected $2.85 from pot
dg3SMYXD7586yGx+LuFM0g: doesn't show hand 
*** SUMMARY ***
Total pot $3 | Rake $0.15 
Board [Jh Kc Jd]
Seat 1: T2fEtpqj5ZyZAjEhNtsFAA (button) folded before Flop (didn't bet)
Seat 2: VWbjqONyDvf8KegytgPLjQ (small blind) folded on the Flop
Seat 3: dg3SMYXD7586yGx+LuFM0g (big blind) collected ($2.85)
Seat 4: aogAb4Eienxztk8p2v9VVw folded before Flop (didn't bet)
Seat 5: vu2kzHaDtgr6NM7rdq0chA folded before Flop (didn't bet)
Seat 6: k9vn40MOqqb+xF+7GZ6v2g folded on the Flop




PokerStars Game #59939751600:  Hold'em No Limit ($0.10/$0.25) - 2009/07/01 0:48:00 ET
Table 'MRfAiS/4JSfnUDlCcZo0wAhfHe8uKeSJMyWAjSdM7ROQx Seat #4 is the button
Seat 1: 48oT5xFI+5CHUJlfoGrE4w ($18.05 in chips) 
Seat 2: /gJNBeCkWL4o85/jvlZ4BA ($34.70 in chips) 
Seat 3: FYepjhAvF8ZdVCmqHIy+eQ ($44.80 in chips) 
Seat 4: Go8clNIDGP3feVvzBDG4pg ($12.30 in chips) 
Seat 5: qccGLncfUaN00Few5HsgYg ($28.95 in chips) 
Seat 6: VaDPspfGS2lnEkaGNrNqfg ($13.70 in chips) 
qccGLncfUaN00Few5HsgYg: posts small blind $0.10
VaDPspfGS2lnEkaGNrNqfg: posts big blind $0.25
*** HOLE CARDS ***
48oT5xFI+5CHUJlfoGrE4w: folds 
/gJNBeCkWL4o85/jvlZ4BA: folds 
FYepjhAvF8ZdVCmqHIy+eQ: folds 
Go8clNIDGP3feVvzBDG4pg: folds 
qccGLncfUaN00Few5HsgYg: folds 
Uncalled bet ($0.15) returned to VaDPspfGS2lnEkaGNrNqfg
VaDPspfGS2lnEkaGNrNqfg collected $0.20 from pot
*** SUMMARY ***
Total pot $0.20 | Rake $0 
Seat 1: 48oT5xFI+5CHUJlfoGrE4w folded before Flop (didn't bet)
Seat 2: /gJNBeCkWL4o85/jvlZ4BA folded before Flop (didn't bet)
Seat 3: FYepjhAvF8ZdVCmqHIy+eQ folded before Flop (didn't bet)
Seat 4: Go8clNIDGP3feVvzBDG4pg (button) folded before Flop (didn't bet)
Seat 5: qccGLncfUaN00Few5HsgYg (small blind) folded before Flop
Seat 6: VaDPspfGS2lnEkaGNrNqfg (big blind) collected ($0.20)




PokerStars Game #59939751724:  Hold'em No Limit ($0.10/$0.25) - 2009/07/01 0:48:00 ET
Table 'nB7Q7zfNfy6ig6DB+rsgWQ' 6-max Seat #6 is the button
Seat 1: ACU3rO57RhDJfAgHTq2ocA ($5.95 in chips) 
Seat 2: g6kf+5FIgWH33PmH6ZecMQ ($15 in chips) 
Seat 3: p3NYOxYhkL7txPRSeXHDeg ($32.15 in chips) 
Seat 4: YZjG5I7FqwMKy06BKVBS7w ($7.95 in chips) 
Seat 6: BYxjLnV1/LL0aZcTbfAOvw ($41.55 in chips) 
ACU3rO57RhDJfAgHTq2ocA: posts small blind $0.10
g6kf+5FIgWH33PmH6ZecMQ: posts big blind $0.25
*** HOLE CARDS ***
p3NYOxYhkL7txPRSeXHDeg: calls $0.25
YZjG5I7FqwMKy06BKVBS7w: raises $0.75 to $1
BYxjLnV1/LL0aZcTbfAOvw: folds 
ACU3rO57RhDJfAgHTq2ocA: calls $0.90
g6kf+5FIgWH33PmH6ZecMQ: folds 
p3NYOxYhkL7txPRSeXHDeg: folds 
*** FLOP *** [Qd 3s 6d]
ACU3rO57RhDJfAgHTq2ocA: checks 
YZjG5I7FqwMKy06BKVBS7w: checks 
*** TURN *** [Qd 3s 6d] [4d]
ACU3rO57RhDJfAgHTq2ocA: checks 
YZjG5I7FqwMKy06BKVBS7w: checks 
*** RIVER *** [Qd 3s 6d 4d] [8d]
ACU3rO57RhDJfAgHTq2ocA: checks 
YZjG5I7FqwMKy06BKVBS7w: checks 
*** SHOW DOWN ***
ACU3rO57RhDJfAgHTq2ocA: shows [9c As] (high card Ace)
YZjG5I7FqwMKy06BKVBS7w: shows [Td Ac] (a flush, Queen high)
YZjG5I7FqwMKy06BKVBS7w collected $2.40 from pot
*** SUMMARY ***
Total pot $2.50 | Rake $0.10 
Board [Qd 3s 6d 4d 8d]
Seat 1: ACU3rO57RhDJfAgHTq2ocA (small blind) showed [9c As] and lost with high card Ace
Seat 2: g6kf+5FIgWH33PmH6ZecMQ (big blind) folded before Flop
Seat 3: p3NYOxYhkL7txPRSeXHDeg folded before Flop
Seat 4: YZjG5I7FqwMKy06BKVBS7w showed [Td Ac] and won ($2.40) with a flush, Queen high
Seat 6: BYxjLnV1/LL0aZcTbfAOvw (button) folded before Flop (didn't bet)




PokerStars Game #59939751292:  Hold'em No Limit ($0.10/$0.25) - 2009/07/01 0:48:00 ET
Table 'JUMeG5SzDyo9HufhgemQeA' 9-max Seat #4 is the button
Seat 1: N6fYvIzQLKaydFLKQGtMlQ ($25.30 in chips) 
Seat 3: IEvLSTIxhlti3EjZDarYnA ($27.75 in chips) 
Seat 4: 6OP8CZnSFyny18DZqWIYog ($3.30 in chips) 
Seat 5: TI/C5Q+DEl4fLR3AofwYdg ($15.75 in chips) 
Seat 7: aNpwfA31EREwO+ar4XzBCw ($29.30 in chips) 
Seat 8: zDrucyjVn5aeekNEc3cJrA ($36.85 in chips) 
Seat 9: V6p0jQ/RhUsqpHLmXvEX4Q ($12.35 in chips) 
TI/C5Q+DEl4fLR3AofwYdg: posts small blind $0.10
aNpwfA31EREwO+ar4XzBCw: posts big blind $0.25
*** HOLE CARDS ***
zDrucyjVn5aeekNEc3cJrA: folds 
V6p0jQ/RhUsqpHLmXvEX4Q: folds 
N6fYvIzQLKaydFLKQGtMlQ: folds 
IEvLSTIxhlti3EjZDarYnA: raises $0.50 to $0.75
6OP8CZnSFyny18DZqWIYog: folds 
TI/C5Q+DEl4fLR3AofwYdg: raises $1.90 to $2.65
aNpwfA31EREwO+ar4XzBCw: folds 
IEvLSTIxhlti3EjZDarYnA: folds 
Uncalled bet ($1.90) returned to TI/C5Q+DEl4fLR3AofwYdg
TI/C5Q+DEl4fLR3AofwYdg collected $1.75 from pot
TI/C5Q+DEl4fLR3AofwYdg: doesn't show hand 
*** SUMMARY ***
Total pot $1.75 | Rake $0 
Seat 1: N6fYvIzQLKaydFLKQGtMlQ folded before Flop (didn't bet)
Seat 3: IEvLSTIxhlti3EjZDarYnA folded before Flop
Seat 4: 6OP8CZnSFyny18DZqWIYog (button) folded before Flop (didn't bet)
Seat 5: TI/C5Q+DEl4fLR3AofwYdg (small blind) collected ($1.75)
Seat 7: aNpwfA31EREwO+ar4XzBCw (big blind) folded before Flop
Seat 8: zDrucyjVn5aeekNEc3cJrA folded before Flop (didn't bet)
Seat 9: V6p0jQ/RhUsqpHLmXvEX4Q folded before Flop (didn't bet)




PokerStars Game #59939751548:  Hold'em No Limit ($0.10/$0.25) - 2009/07/01 0:48:00 ET
Table '52Meibn9NOL4XtVi1p2UpwpyZQRcpxhWj2y2cT/ydvwwx Seat #6 is the button
Seat 1: TeWJxSETzbXGiYKx0y+dtg ($26.60 in chips) 
Seat 2: Th3FldXKQW6hWVVPahaoOQ ($49.65 in chips) 
Seat 3: DgRMoUciGePff+edyvpt6g ($28.75 in chips) 
Seat 4: 8GJHzzxiotOqC5gdtgpLoA ($4.65 in chips) 
Seat 5: 4oA316mXLIui1QY63GXBUg ($25 in chips) 
Seat 6: 4awUyiDYTgylQKXZ9faBVA ($27.75 in chips) 
Seat 8: 18G4P1XstjNvItdGUITxgw ($25 in chips) 
aPRz/2GxbXANYpVsQO8pdQ will be allowed to play after the button
18G4P1XstjNvItdGUITxgw: posts small blind $0.10
TeWJxSETzbXGiYKx0y+dtg: posts big blind $0.25
*** HOLE CARDS ***
Th3FldXKQW6hWVVPahaoOQ: folds 
DgRMoUciGePff+edyvpt6g: calls $0.25
8GJHzzxiotOqC5gdtgpLoA: folds 
4oA316mXLIui1QY63GXBUg: folds 
4awUyiDYTgylQKXZ9faBVA: raises $1 to $1.25
18G4P1XstjNvItdGUITxgw: folds 
TeWJxSETzbXGiYKx0y+dtg: folds 
DgRMoUciGePff+edyvpt6g: calls $1
*** FLOP *** [4c 6s Kh]
DgRMoUciGePff+edyvpt6g: checks 
4awUyiDYTgylQKXZ9faBVA: checks 
*** TURN *** [4c 6s Kh] [9c]
DgRMoUciGePff+edyvpt6g: checks 
4awUyiDYTgylQKXZ9faBVA: bets $2
DgRMoUciGePff+edyvpt6g: folds 
Uncalled bet ($2) returned to 4awUyiDYTgylQKXZ9faBVA
4awUyiDYTgylQKXZ9faBVA collected $2.75 from pot
4awUyiDYTgylQKXZ9faBVA: doesn't show hand 
*** SUMMARY ***
Total pot $2.85 | Rake $0.10 
Board [4c 6s Kh 9c]
Seat 1: TeWJxSETzbXGiYKx0y+dtg (big blind) folded before Flop
Seat 2: Th3FldXKQW6hWVVPahaoOQ folded before Flop (didn't bet)
Seat 3: DgRMoUciGePff+edyvpt6g folded on the Turn
Seat 4: 8GJHzzxiotOqC5gdtgpLoA folded before Flop (didn't bet)
Seat 5: 4oA316mXLIui1QY63GXBUg folded before Flop (didn't bet)
Seat 6: 4awUyiDYTgylQKXZ9faBVA (button) collected ($2.75)
Seat 8: 18G4P1XstjNvItdGUITxgw (small blind) folded before Flop




PokerStars Game #59939752490:  Hold'em No Limit ($0.10/$0.25) - 2009/07/01 0:48:01 ET
Table 'IIO2q2znuuAXmiZ2qFTcmg' 6-max Seat #5 is the button
Seat 1: nwwpaieDRI0UPyVtChVHOg ($16.40 in chips) 
Seat 2: cS21pIxRHx5Gt42o7hPZzw ($15.35 in chips) 
Seat 3: hiTEr3yrERiQp3zHXRioVw ($41.20 in chips) 
Seat 5: f9iRHw0d+kV7pbTYwF2+2g ($6.30 in chips) 
Seat 6: gqrr7lSWrQ1N8zKx8zZzvA ($9 in chips) 
gqrr7lSWrQ1N8zKx8zZzvA: posts small blind $0.10
nwwpaieDRI0UPyVtChVHOg: posts big blind $0.25
Mxjust3: sits out 
*** HOLE CARDS ***
cS21pIxRHx5Gt42o7hPZzw: raises $0.75 to $1
hiTEr3yrERiQp3zHXRioVw: folds 
f9iRHw0d+kV7pbTYwF2+2g: calls $1
gqrr7lSWrQ1N8zKx8zZzvA: folds 
nwwpaieDRI0UPyVtChVHOg: folds 
*** FLOP *** [6c Qh Tc]
cS21pIxRHx5Gt42o7hPZzw: bets $1.25
f9iRHw0d+kV7pbTYwF2+2g: raises $4.05 to $5.30 and is all-in
cS21pIxRHx5Gt42o7hPZzw: calls $4.05
*** TURN *** [6c Qh Tc] [6d]
*** RIVER *** [6c Qh Tc 6d] [Td]
*** SHOW DOWN ***
cS21pIxRHx5Gt42o7hPZzw: shows [Ah Kc] (two pair, Tens and Sixes)
f9iRHw0d+kV7pbTYwF2+2g: shows [Jd Qc] (two pair, Queens and Tens)
f9iRHw0d+kV7pbTYwF2+2g collected $12.35 from pot
*** SUMMARY ***
Total pot $12.95 | Rake $0.60 
Board [6c Qh Tc 6d Td]
Seat 1: nwwpaieDRI0UPyVtChVHOg (big blind) folded before Flop
Seat 2: cS21pIxRHx5Gt42o7hPZzw showed [Ah Kc] and lost with two pair, Tens and Sixes
Seat 3: hiTEr3yrERiQp3zHXRioVw folded before Flop (didn't bet)
Seat 5: f9iRHw0d+kV7pbTYwF2+2g (button) showed [Jd Qc] and won ($12.35) with two pair, Queens and Tens
Seat 6: gqrr7lSWrQ1N8zKx8zZzvA (small blind) folded before Flop




PokerStars Game #59939752194:  Hold'em No Limit ($0.10/$0.25) - 2009/07/01 0:48:01 ET
Table 'mF3KHGMaTpaBZbtBoyfTeg' 6-max Seat #5 is the button
Seat 1: 0HAB2GdCAM7p7V00xueAVQ ($8.30 in chips) 
Seat 2: 4x9jCqgSw4272dnaIqnanw ($4.10 in chips) 
Seat 3: Hzrn9DZJegEZICufTNYkrg ($13.05 in chips) 
Seat 4: FYepjhAvF8ZdVCmqHIy+eQ ($25 in chips) 
Seat 5: sEQx9G5Cu8k1HNdQasxvUA ($41.30 in chips) 
Seat 6: kG34n23qFQA3nzdOJTQ1dA ($24.15 in chips) 
kG34n23qFQA3nzdOJTQ1dA: posts small blind $0.10
0HAB2GdCAM7p7V00xueAVQ: posts big blind $0.25
*** HOLE CARDS ***
4x9jCqgSw4272dnaIqnanw: folds 
Hzrn9DZJegEZICufTNYkrg: calls $0.25
FYepjhAvF8ZdVCmqHIy+eQ: folds 
sEQx9G5Cu8k1HNdQasxvUA: folds 
kG34n23qFQA3nzdOJTQ1dA: folds 
0HAB2GdCAM7p7V00xueAVQ: raises $0.50 to $0.75
Hzrn9DZJegEZICufTNYkrg: calls $0.50
*** FLOP *** [3s 4s 3c]
0HAB2GdCAM7p7V00xueAVQ: bets $0.75
Hzrn9DZJegEZICufTNYkrg: folds 
Uncalled bet ($0.75) returned to 0HAB2GdCAM7p7V00xueAVQ
0HAB2GdCAM7p7V00xueAVQ collected $1.55 from pot
*** SUMMARY ***
Total pot $1.60 | Rake $0.05 
Board [3s 4s 3c]
Seat 1: 0HAB2GdCAM7p7V00xueAVQ (big blind) collected ($1.55)
Seat 2: 4x9jCqgSw4272dnaIqnanw folded before Flop (didn't bet)
Seat 3: Hzrn9DZJegEZICufTNYkrg folded on the Flop
Seat 4: FYepjhAvF8ZdVCmqHIy+eQ folded before Flop (didn't bet)
Seat 5: sEQx9G5Cu8k1HNdQasxvUA (button) folded before Flop (didn't bet)
Seat 6: kG34n23qFQA3nzdOJTQ1dA (small blind) folded before Flop




PokerStars Game #59939751970:  Hold'em No Limit ($0.10/$0.25) - 2009/07/01 0:48:01 ET
Table 'sgdCtiuCu2BDZhyDi6RzTA' 6-max Seat #2 is the button
Seat 1: 3zD3qLXT1bEffAoWGnc7wg ($28.35 in chips) 
Seat 2: R7AqtFtjtvane2IbChcU+w ($14.40 in chips) 
Seat 3: yzFNNFIfC89bBPwpFPx2ow ($16.60 in chips) 
Seat 4: rVKEgilmMX+EkKzDVvhmxA ($5.90 in chips) 
Seat 5: kD/Cb2UM93FAVgDMhEEb5g ($6.85 in chips) 
Seat 6: KODslGU8ikCYS0/29dUkhg ($11.50 in chips) 
yzFNNFIfC89bBPwpFPx2ow: posts small blind $0.10
rVKEgilmMX+EkKzDVvhmxA: posts big blind $0.25
*** HOLE CARDS ***
kD/Cb2UM93FAVgDMhEEb5g: folds 
KODslGU8ikCYS0/29dUkhg: calls $0.25
3zD3qLXT1bEffAoWGnc7wg: folds 
R7AqtFtjtvane2IbChcU+w: folds 
yzFNNFIfC89bBPwpFPx2ow: calls $0.15
rVKEgilmMX+EkKzDVvhmxA: checks 
*** FLOP *** [Kh Ts Qs]
yzFNNFIfC89bBPwpFPx2ow: checks 
rVKEgilmMX+EkKzDVvhmxA: checks 
KODslGU8ikCYS0/29dUkhg: checks 
*** TURN *** [Kh Ts Qs] [4s]
yzFNNFIfC89bBPwpFPx2ow: bets $0.75
rVKEgilmMX+EkKzDVvhmxA: folds 
KODslGU8ikCYS0/29dUkhg: folds 
Uncalled bet ($0.75) returned to yzFNNFIfC89bBPwpFPx2ow
yzFNNFIfC89bBPwpFPx2ow collected $0.75 from pot
yzFNNFIfC89bBPwpFPx2ow: doesn't show hand 
*** SUMMARY ***
Total pot $0.75 | Rake $0 
Board [Kh Ts Qs 4s]
Seat 1: 3zD3qLXT1bEffAoWGnc7wg folded before Flop (didn't bet)
Seat 2: R7AqtFtjtvane2IbChcU+w (button) folded before Flop (didn't bet)
Seat 3: yzFNNFIfC89bBPwpFPx2ow (small blind) collected ($0.75)
Seat 4: rVKEgilmMX+EkKzDVvhmxA (big blind) folded on the Turn
Seat 5: kD/Cb2UM93FAVgDMhEEb5g folded before Flop (didn't bet)
Seat 6: KODslGU8ikCYS0/29dUkhg folded on the Turn




PokerStars Game #59939752122:  Hold'em No Limit ($0.10/$0.25) - 2009/07/01 0:48:01 ET
Table '2clPgY3+dETPD/8zjXZdFw' 6-max Seat #5 is the button
Seat 1: qllppsCmUqovlriIWCeM/g ($6.40 in chips) 
Seat 2: NzIFHwilc5zU7QhjDTgTZA ($9 in chips) 
Seat 3: 6pF9LtHn+EH0ChbOXzox9g ($1.50 in chips) 
Seat 4: 9KPR3sZ+CxRm7bQ8qxFzMQ ($6.90 in chips) 
Seat 5: sEQx9G5Cu8k1HNdQasxvUA ($60.80 in chips) 
Seat 6: Mch463E1dxQfVob352za6w ($25.70 in chips) 
Mch463E1dxQfVob352za6w: posts small blind $0.10
qllppsCmUqovlriIWCeM/g: posts big blind $0.25
*** HOLE CARDS ***
NzIFHwilc5zU7QhjDTgTZA has timed out
NzIFHwilc5zU7QhjDTgTZA: folds 
NzIFHwilc5zU7QhjDTgTZA is sitting out
6pF9LtHn+EH0ChbOXzox9g: calls $0.25
9KPR3sZ+CxRm7bQ8qxFzMQ: calls $0.25
NzIFHwilc5zU7QhjDTgTZA has returned
sEQx9G5Cu8k1HNdQasxvUA has timed out
sEQx9G5Cu8k1HNdQasxvUA: folds 
sEQx9G5Cu8k1HNdQasxvUA is sitting out
Mch463E1dxQfVob352za6w: folds 
qllppsCmUqovlriIWCeM/g: checks 
*** FLOP *** [7h 3c 3s]
qllppsCmUqovlriIWCeM/g: checks 
6pF9LtHn+EH0ChbOXzox9g: checks 
9KPR3sZ+CxRm7bQ8qxFzMQ: bets $0.25
qllppsCmUqovlriIWCeM/g: calls $0.25
6pF9LtHn+EH0ChbOXzox9g: folds 
*** TURN *** [7h 3c 3s] [Jc]
qllppsCmUqovlriIWCeM/g: checks 
9KPR3sZ+CxRm7bQ8qxFzMQ: bets $0.50
qllppsCmUqovlriIWCeM/g: calls $0.50
*** RIVER *** [7h 3c 3s Jc] [9d]
qllppsCmUqovlriIWCeM/g: bets $1.25
9KPR3sZ+CxRm7bQ8qxFzMQ: calls $1.25
*** SHOW DOWN ***
qllppsCmUqovlriIWCeM/g: shows [3h 8c] (three of a kind, Threes)
9KPR3sZ+CxRm7bQ8qxFzMQ: mucks hand 
qllppsCmUqovlriIWCeM/g collected $4.65 from pot
*** SUMMARY ***
Total pot $4.85 | Rake $0.20 
Board [7h 3c 3s Jc 9d]
Seat 1: qllppsCmUqovlriIWCeM/g (big blind) showed [3h 8c] and won ($4.65) with three of a kind, Threes
Seat 2: NzIFHwilc5zU7QhjDTgTZA folded before Flop (didn't bet)
Seat 3: 6pF9LtHn+EH0ChbOXzox9g folded on the Flop
Seat 4: 9KPR3sZ+CxRm7bQ8qxFzMQ mucked
Seat 5: sEQx9G5Cu8k1HNdQasxvUA (button) folded before Flop (didn't bet)
Seat 6: Mch463E1dxQfVob352za6w (small blind) folded before Flop




PokerStars Game #59939752476:  Hold'em No Limit ($0.10/$0.25) - 2009/07/01 0:48:01 ET
Table 'xkqAWQFDrFt4p81M8UsoNw' 9-max Seat #5 is the button
Seat 1: N6fYvIzQLKaydFLKQGtMlQ ($25 in chips) 
Seat 2: z5GxcHlYz/GSz6W2uFiTtg ($36.80 in chips) 
Seat 3: HEUqKs2EYYGGXJCepUdL0g ($5.65 in chips) 
Seat 4: gY+PO8PaVC7pBPH/9HSv6Q ($5.30 in chips) 
Seat 5: OiV1PWZ3IkN29JlmCcnTwQ ($4.65 in chips) 
Seat 7: MG90wfSJZnOejs/KD3vlQQ ($51.30 in chips) 
Seat 8: s7Q6uNouhe7aE8JdFb9E+A ($27.90 in chips) 
Seat 9: Wa7bjLwN7ptOQro84PxQGw ($4.50 in chips) 
6RiVTYll/5D8zICp0MRpKw will be allowed to play after the button
MG90wfSJZnOejs/KD3vlQQ: posts small blind $0.10
s7Q6uNouhe7aE8JdFb9E+A: posts big blind $0.25
*** HOLE CARDS ***
Wa7bjLwN7ptOQro84PxQGw: calls $0.25
N6fYvIzQLKaydFLKQGtMlQ: folds 
z5GxcHlYz/GSz6W2uFiTtg: calls $0.25
HEUqKs2EYYGGXJCepUdL0g: folds 
gY+PO8PaVC7pBPH/9HSv6Q: folds 
OiV1PWZ3IkN29JlmCcnTwQ: folds 
MG90wfSJZnOejs/KD3vlQQ: calls $0.15
s7Q6uNouhe7aE8JdFb9E+A has timed out
s7Q6uNouhe7aE8JdFb9E+A: checks 
*** FLOP *** [3s 4c 5h]
MG90wfSJZnOejs/KD3vlQQ: checks 
s7Q6uNouhe7aE8JdFb9E+A: checks 
Wa7bjLwN7ptOQro84PxQGw: bets $1
z5GxcHlYz/GSz6W2uFiTtg: folds 
MG90wfSJZnOejs/KD3vlQQ: folds 
s7Q6uNouhe7aE8JdFb9E+A: folds 
Uncalled bet ($1) returned to Wa7bjLwN7ptOQro84PxQGw
Wa7bjLwN7ptOQro84PxQGw collected $0.95 from pot
*** SUMMARY ***
Total pot $1 | Rake $0.05 
Board [3s 4c 5h]
Seat 1: N6fYvIzQLKaydFLKQGtMlQ folded before Flop (didn't bet)
Seat 2: z5GxcHlYz/GSz6W2uFiTtg folded on the Flop
Seat 3: HEUqKs2EYYGGXJCepUdL0g folded before Flop (didn't bet)
Seat 4: gY+PO8PaVC7pBPH/9HSv6Q folded before Flop (didn't bet)
Seat 5: OiV1PWZ3IkN29JlmCcnTwQ (button) folded before Flop (didn't bet)
Seat 7: MG90wfSJZnOejs/KD3vlQQ (small blind) folded on the Flop
Seat 8: s7Q6uNouhe7aE8JdFb9E+A (big blind) folded on the Flop
Seat 9: Wa7bjLwN7ptOQro84PxQGw collected ($0.95)




PokerStars Game #59939752288:  Hold'em No Limit ($0.10/$0.25) - 2009/07/01 0:48:01 ET
Table 'pPgW4R3kdH26lLi1MnE92w' 9-max Seat #8 is the button
Seat 1: dPWIrImjP1yFagoUVDKR0Q ($7.55 in chips) 
Seat 2: cZ99hugmLBj9KhTlc8nCSw ($28.25 in chips) 
Seat 4: hBMUlEpyU74r/fwDgIpXjQ ($31.25 in chips) 
Seat 5: HPEB+AtKw1+C/cxU0o1ciw ($34.25 in chips) 
Seat 6: VllYilcih0t+gMD4GTRlgQ ($28 in chips) 
Seat 7: sD+TKtt36XiiN6jqHiLwDA ($24.65 in chips) 
Seat 8: aCVg6cCxQcqClhB9nq/p1w ($19.85 in chips) 
Seat 9: tcbEu7VzyHQ+0lh+skbQhQ ($17.75 in chips) 
tcbEu7VzyHQ+0lh+skbQhQ: posts small blind $0.10
dPWIrImjP1yFagoUVDKR0Q: posts big blind $0.25
nPydKI7KXtudhyCkYtLgZA: sits out 
*** HOLE CARDS ***
cZ99hugmLBj9KhTlc8nCSw: folds 
hBMUlEpyU74r/fwDgIpXjQ: folds 
HPEB+AtKw1+C/cxU0o1ciw: folds 
VllYilcih0t+gMD4GTRlgQ: raises $0.50 to $0.75
sD+TKtt36XiiN6jqHiLwDA: folds 
aCVg6cCxQcqClhB9nq/p1w: folds 
tcbEu7VzyHQ+0lh+skbQhQ: folds 
dPWIrImjP1yFagoUVDKR0Q: folds 
Uncalled bet ($0.50) returned to VllYilcih0t+gMD4GTRlgQ
VllYilcih0t+gMD4GTRlgQ collected $0.60 from pot
VllYilcih0t+gMD4GTRlgQ: doesn't show hand 
*** SUMMARY ***
Total pot $0.60 | Rake $0 
Seat 1: dPWIrImjP1yFagoUVDKR0Q (big blind) folded before Flop
Seat 2: cZ99hugmLBj9KhTlc8nCSw folded before Flop (didn't bet)
Seat 4: hBMUlEpyU74r/fwDgIpXjQ folded before Flop (didn't bet)
Seat 5: HPEB+AtKw1+C/cxU0o1ciw folded before Flop (didn't bet)
Seat 6: VllYilcih0t+gMD4GTRlgQ collected ($0.60)
Seat 7: sD+TKtt36XiiN6jqHiLwDA folded before Flop (didn't bet)
Seat 8: aCVg6cCxQcqClhB9nq/p1w (button) folded before Flop (didn't bet)
Seat 9: tcbEu7VzyHQ+0lh+skbQhQ (small blind) folded before Flop




PokerStars Game #59939752310:  Hold'em No Limit ($0.10/$0.25) - 2009/07/01 0:48:01 ET
Table '3EebBlzq5yHSY2444L4zlg' 9-max Seat #8 is the button
Seat 1: 8B/dhbQjIWe6ASCdgzktNQ ($30.25 in chips) 
Seat 2: MIVCHqCqqlke0Lb0z7glcw ($24.35 in chips) 
Seat 3: IGbD5vKNhHe60dkdbjg/mw ($24.55 in chips) 
Seat 4: 1S/fpm+f42V/6MNZre+ccg ($25 in chips) 
Seat 5: 22Ph+hChb2fjC5+yk/mOew ($24.75 in chips) 
Seat 6: QEbIGci+itdw+re8RM5fZA ($27.80 in chips) 
Seat 7: DiSvPC2iudwL5j9u6Huyww ($27.55 in chips) 
Seat 8: j97ZRZFRWNUsBUL7hv78tA ($14.65 in chips) 
Seat 9: GTcLfsDTPqgfHyhY9FNDMw ($10.40 in chips) 
GTcLfsDTPqgfHyhY9FNDMw: posts small blind $0.10
8B/dhbQjIWe6ASCdgzktNQ: posts big blind $0.25
*** HOLE CARDS ***
MIVCHqCqqlke0Lb0z7glcw: folds 
IGbD5vKNhHe60dkdbjg/mw: calls $0.25
1S/fpm+f42V/6MNZre+ccg: folds 
22Ph+hChb2fjC5+yk/mOew: folds 
QEbIGci+itdw+re8RM5fZA: folds 
DiSvPC2iudwL5j9u6Huyww: folds 
j97ZRZFRWNUsBUL7hv78tA: folds 
GTcLfsDTPqgfHyhY9FNDMw: folds 
8B/dhbQjIWe6ASCdgzktNQ: checks 
*** FLOP *** [As 2c Ts]
8B/dhbQjIWe6ASCdgzktNQ: checks 
IGbD5vKNhHe60dkdbjg/mw: bets $0.50
8B/dhbQjIWe6ASCdgzktNQ: folds 
Uncalled bet ($0.50) returned to IGbD5vKNhHe60dkdbjg/mw
IGbD5vKNhHe60dkdbjg/mw collected $0.60 from pot
*** SUMMARY ***
Total pot $0.60 | Rake $0 
Board [As 2c Ts]
Seat 1: 8B/dhbQjIWe6ASCdgzktNQ (big blind) folded on the Flop
Seat 2: MIVCHqCqqlke0Lb0z7glcw folded before Flop (didn't bet)
Seat 3: IGbD5vKNhHe60dkdbjg/mw collected ($0.60)
Seat 4: 1S/fpm+f42V/6MNZre+ccg folded before Flop (didn't bet)
Seat 5: 22Ph+hChb2fjC5+yk/mOew folded before Flop (didn't bet)
Seat 6: QEbIGci+itdw+re8RM5fZA folded before Flop (didn't bet)
Seat 7: DiSvPC2iudwL5j9u6Huyww folded before Flop (didn't bet)
Seat 8: j97ZRZFRWNUsBUL7hv78tA (button) folded before Flop (didn't bet)
Seat 9: GTcLfsDTPqgfHyhY9FNDMw (small blind) folded before Flop




PokerStars Game #59939752868:  Hold'em No Limit ($0.10/$0.25) - 2009/07/01 0:48:02 ET
Table 'nteM56rtr9SxLEblf0fvbw' 9-max Seat #1 is the button
Seat 1: H9KUl8cmpLgEpOVDA00bCg ($9.90 in chips) 
Seat 2: ljemhp25Zg+nlA9DLCIiUw ($24.95 in chips) 
Seat 3: 6RiVTYll/5D8zICp0MRpKw ($25 in chips) 
Seat 4: cZ99hugmLBj9KhTlc8nCSw ($25.15 in chips) 
Seat 5: aJy680tKSaP5er559aSuGA ($4.95 in chips) 
Seat 6: LH8Esb23EO9V9GrKx+ymWQ ($6.85 in chips) 
Seat 7: dfNim92Z6XK1/h5SFW5vDg ($49.05 in chips) 
Seat 8: RJ/x9oZtt1RZLaJEQwZOxQ ($43.90 in chips) 
Seat 9: t2nb95S5EEFOEzNx9Itz0g ($6.20 in chips) 
ljemhp25Zg+nlA9DLCIiUw: posts small blind $0.10
6RiVTYll/5D8zICp0MRpKw: posts big blind $0.25
*** HOLE CARDS ***
cZ99hugmLBj9KhTlc8nCSw: folds 
aJy680tKSaP5er559aSuGA: folds 
LH8Esb23EO9V9GrKx+ymWQ: calls $0.25
dfNim92Z6XK1/h5SFW5vDg: folds 
RJ/x9oZtt1RZLaJEQwZOxQ: folds 
t2nb95S5EEFOEzNx9Itz0g: folds 
H9KUl8cmpLgEpOVDA00bCg: raises $1 to $1.25
ljemhp25Zg+nlA9DLCIiUw: folds 
6RiVTYll/5D8zICp0MRpKw: folds 
LH8Esb23EO9V9GrKx+ymWQ: folds 
Uncalled bet ($1) returned to H9KUl8cmpLgEpOVDA00bCg
H9KUl8cmpLgEpOVDA00bCg collected $0.85 from pot
*** SUMMARY ***
Total pot $0.85 | Rake $0 
Seat 1: H9KUl8cmpLgEpOVDA00bCg (button) collected ($0.85)
Seat 2: ljemhp25Zg+nlA9DLCIiUw (small blind) folded before Flop
Seat 3: 6RiVTYll/5D8zICp0MRpKw (big blind) folded before Flop
Seat 4: cZ99hugmLBj9KhTlc8nCSw folded before Flop (didn't bet)
Seat 5: aJy680tKSaP5er559aSuGA folded before Flop (didn't bet)
Seat 6: LH8Esb23EO9V9GrKx+ymWQ folded before Flop
Seat 7: dfNim92Z6XK1/h5SFW5vDg folded before Flop (didn't bet)
Seat 8: RJ/x9oZtt1RZLaJEQwZOxQ folded before Flop (didn't bet)
Seat 9: t2nb95S5EEFOEzNx9Itz0g folded before Flop (didn't bet)




PokerStars Game #59939753006:  Hold'em No Limit ($0.10/$0.25) - 2009/07/01 0:48:02 ET
Table '+VTTYgQLH1awDHk+IAxqGg' 9-max Seat #4 is the button
Seat 1: s7Q6uNouhe7aE8JdFb9E+A ($25 in chips) 
Seat 2: 86vbuhJsyH+nbEg5qpDLyQ ($23.05 in chips) 
Seat 3: rSMoem/92WmnPjtw2tSQkA ($30.60 in chips) 
Seat 4: gE5rN2TDY1aXcZn/TOPeZw ($10.20 in chips) 
Seat 5: sD+TKtt36XiiN6jqHiLwDA ($38.35 in chips) 
Seat 6: gehe91e0IyVT0QU/XBkEyg ($25 in chips) 
Seat 7: W4TLQcZ2TiM73eIgpIvlGg ($26.20 in chips) 
Seat 9: CFZ+ACzShzC3naaIaOjbYQ ($8.10 in chips) 
sD+TKtt36XiiN6jqHiLwDA: posts small blind $0.10
gehe91e0IyVT0QU/XBkEyg: posts big blind $0.25
j4q3p0lesp63b1gZDwLBZw: sits out 
*** HOLE CARDS ***
W4TLQcZ2TiM73eIgpIvlGg: raises $0.75 to $1
CFZ+ACzShzC3naaIaOjbYQ: folds 
s7Q6uNouhe7aE8JdFb9E+A: folds 
86vbuhJsyH+nbEg5qpDLyQ: folds 
rSMoem/92WmnPjtw2tSQkA: folds 
gE5rN2TDY1aXcZn/TOPeZw: folds 
sD+TKtt36XiiN6jqHiLwDA: folds 
gehe91e0IyVT0QU/XBkEyg: folds 
Uncalled bet ($0.75) returned to W4TLQcZ2TiM73eIgpIvlGg
W4TLQcZ2TiM73eIgpIvlGg collected $0.60 from pot
*** SUMMARY ***
Total pot $0.60 | Rake $0 
Seat 1: s7Q6uNouhe7aE8JdFb9E+A folded before Flop (didn't bet)
Seat 2: 86vbuhJsyH+nbEg5qpDLyQ folded before Flop (didn't bet)
Seat 3: rSMoem/92WmnPjtw2tSQkA folded before Flop (didn't bet)
Seat 4: gE5rN2TDY1aXcZn/TOPeZw (button) folded before Flop (didn't bet)
Seat 5: sD+TKtt36XiiN6jqHiLwDA (small blind) folded before Flop
Seat 6: gehe91e0IyVT0QU/XBkEyg (big blind) folded before Flop
Seat 7: W4TLQcZ2TiM73eIgpIvlGg collected ($0.60)
Seat 9: CFZ+ACzShzC3naaIaOjbYQ folded before Flop (didn't bet)




PokerStars Game #59939752838:  Hold'em No Limit ($0.10/$0.25) - 2009/07/01 0:48:02 ET
Table 'eOXPe2c6mG7DOFKvMsZZfA' 6-max Seat #4 is the button
Seat 1: ShXPHWfjhfmAwLgDdm6bRQ ($14.70 in chips) 
Seat 2: ELW+DKizJhLK7k40PMkD2Q ($56.25 in chips) 
Seat 3: kReyZ6g6Fu3tQ0nyjDf9kA ($29.30 in chips) 
Seat 4: zHHLkD2sRljslKKeQv/ZQw ($41.50 in chips) 
Seat 5: NhUN/JpAprdJeamFBgJH1w ($25.10 in chips) 
Seat 6: njVkfGYrPiXfq4zLcgfVuA ($12 in chips) 
NhUN/JpAprdJeamFBgJH1w: posts small blind $0.10
njVkfGYrPiXfq4zLcgfVuA: posts big blind $0.25
*** HOLE CARDS ***
ShXPHWfjhfmAwLgDdm6bRQ: folds 
ELW+DKizJhLK7k40PMkD2Q has timed out
ELW+DKizJhLK7k40PMkD2Q: folds 
ELW+DKizJhLK7k40PMkD2Q is sitting out
kReyZ6g6Fu3tQ0nyjDf9kA: folds 
zHHLkD2sRljslKKeQv/ZQw: calls $0.25
NhUN/JpAprdJeamFBgJH1w: folds 
ELW+DKizJhLK7k40PMkD2Q has returned
njVkfGYrPiXfq4zLcgfVuA: raises $0.75 to $1
zHHLkD2sRljslKKeQv/ZQw: calls $0.75
*** FLOP *** [4d As 8s]
njVkfGYrPiXfq4zLcgfVuA: bets $0.75
zHHLkD2sRljslKKeQv/ZQw: folds 
Uncalled bet ($0.75) returned to njVkfGYrPiXfq4zLcgfVuA
njVkfGYrPiXfq4zLcgfVuA collected $2 from pot
njVkfGYrPiXfq4zLcgfVuA: doesn't show hand 
*** SUMMARY ***
Total pot $2.10 | Rake $0.10 
Board [4d As 8s]
Seat 1: ShXPHWfjhfmAwLgDdm6bRQ folded before Flop (didn't bet)
Seat 2: ELW+DKizJhLK7k40PMkD2Q folded before Flop (didn't bet)
Seat 3: kReyZ6g6Fu3tQ0nyjDf9kA folded before Flop (didn't bet)
Seat 4: zHHLkD2sRljslKKeQv/ZQw (button) folded on the Flop
Seat 5: NhUN/JpAprdJeamFBgJH1w (small blind) folded before Flop
Seat 6: njVkfGYrPiXfq4zLcgfVuA (big blind) collected ($2)




PokerStars Game #59939752790:  Hold'em No Limit ($0.10/$0.25) - 2009/07/01 0:48:02 ET
Table 'IrJPyZ3JW2iIa+krdoSbJQ' 9-max Seat #5 is the button
Seat 1: 4+E2msto8r80F3SH2gctVA ($24.75 in chips) 
Seat 3: vZGoOTJLQLhkPj4I+LNGig ($25 in chips) 
Seat 4: DnDcAdn9P0zGovMERigpFA ($25 in chips) 
Seat 5: sUVgUtgbfVx6JpvApozwhQ ($6.25 in chips) 
Seat 6: +sbyWwIcFp9kP0bDtMegfQ ($24.75 in chips) 
Seat 8: VBHxUExRAMrbxUq/cVx9Gw ($5 in chips) 
+sbyWwIcFp9kP0bDtMegfQ: posts small blind $0.10
uH1RN27w9SKa7TpVR9EFrQ: is sitting out 
uH1RN27w9SKa7TpVR9EFrQ leaves the table
VBHxUExRAMrbxUq/cVx9Gw: posts big blind $0.25
+WMpj67YqG8ilNkg2JwXpw: sits out 
Mr_GlamoRouS: sits out 
*** HOLE CARDS ***
4+E2msto8r80F3SH2gctVA: folds 
vZGoOTJLQLhkPj4I+LNGig: folds 
DnDcAdn9P0zGovMERigpFA: folds 
sUVgUtgbfVx6JpvApozwhQ: folds 
+sbyWwIcFp9kP0bDtMegfQ: folds 
Uncalled bet ($0.15) returned to VBHxUExRAMrbxUq/cVx9Gw
VBHxUExRAMrbxUq/cVx9Gw collected $0.20 from pot
*** SUMMARY ***
Total pot $0.20 | Rake $0 
Seat 1: 4+E2msto8r80F3SH2gctVA folded before Flop (didn't bet)
Seat 3: vZGoOTJLQLhkPj4I+LNGig folded before Flop (didn't bet)
Seat 4: DnDcAdn9P0zGovMERigpFA folded before Flop (didn't bet)
Seat 5: sUVgUtgbfVx6JpvApozwhQ (button) folded before Flop (didn't bet)
Seat 6: +sbyWwIcFp9kP0bDtMegfQ (small blind) folded before Flop
Seat 8: VBHxUExRAMrbxUq/cVx9Gw (big blind) collected ($0.20)




