PokerStars Game #59939336522:  Hold'em No Limit ($0.10/$0.25) - 2009/07/01 0:37:16 ET
Table 'GoBmKm3klK6VavJE4STfmQ' 9-max Seat #4 is the button
Seat 1: N6fYvIzQLKaydFLKQGtMlQ ($23.55 in chips) 
Seat 2: 1c/7DHPx5CDTmAfk8/bWeA ($15 in chips) 
Seat 3: 4awUyiDYTgylQKXZ9faBVA ($26.40 in chips) 
Seat 4: H5Se03ZqSX7tbULXur2MAg ($24.30 in chips) 
Seat 5: 8B/dhbQjIWe6ASCdgzktNQ ($25.30 in chips) 
Seat 6: S3QwXyGCcujfAwNubHpwbw ($6.25 in chips) 
Seat 7: s9a4d23HFxaL70yUWQ0/tQ ($21.05 in chips) 
Seat 8: cZ99hugmLBj9KhTlc8nCSw ($25.35 in chips) 
Seat 9: 1K6QGyJP9P9xmRac2fH4OQ ($47 in chips) 
8B/dhbQjIWe6ASCdgzktNQ: posts small blind $0.10
S3QwXyGCcujfAwNubHpwbw: posts big blind $0.25
*** HOLE CARDS ***
s9a4d23HFxaL70yUWQ0/tQ: calls $0.25
cZ99hugmLBj9KhTlc8nCSw: folds 
1K6QGyJP9P9xmRac2fH4OQ: folds 
N6fYvIzQLKaydFLKQGtMlQ: folds 
1c/7DHPx5CDTmAfk8/bWeA: folds 
4awUyiDYTgylQKXZ9faBVA: folds 
H5Se03ZqSX7tbULXur2MAg: folds 
8B/dhbQjIWe6ASCdgzktNQ: folds 
S3QwXyGCcujfAwNubHpwbw: checks 
*** FLOP *** [Kd Qs Qc]
S3QwXyGCcujfAwNubHpwbw: checks 
s9a4d23HFxaL70yUWQ0/tQ: checks 
*** TURN *** [Kd Qs Qc] [3s]
S3QwXyGCcujfAwNubHpwbw: checks 
s9a4d23HFxaL70yUWQ0/tQ: checks 
*** RIVER *** [Kd Qs Qc 3s] [Td]
S3QwXyGCcujfAwNubHpwbw: bets $0.25
s9a4d23HFxaL70yUWQ0/tQ: calls $0.25
*** SHOW DOWN ***
S3QwXyGCcujfAwNubHpwbw: shows [Th 8s] (two pair, Queens and Tens)
s9a4d23HFxaL70yUWQ0/tQ: mucks hand 
S3QwXyGCcujfAwNubHpwbw collected $1.05 from pot
*** SUMMARY ***
Total pot $1.10 | Rake $0.05 
Board [Kd Qs Qc 3s Td]
Seat 1: N6fYvIzQLKaydFLKQGtMlQ folded before Flop (didn't bet)
Seat 2: 1c/7DHPx5CDTmAfk8/bWeA folded before Flop (didn't bet)
Seat 3: 4awUyiDYTgylQKXZ9faBVA folded before Flop (didn't bet)
Seat 4: H5Se03ZqSX7tbULXur2MAg (button) folded before Flop (didn't bet)
Seat 5: 8B/dhbQjIWe6ASCdgzktNQ (small blind) folded before Flop
Seat 6: S3QwXyGCcujfAwNubHpwbw (big blind) showed [Th 8s] and won ($1.05) with two pair, Queens and Tens
Seat 7: s9a4d23HFxaL70yUWQ0/tQ mucked
Seat 8: cZ99hugmLBj9KhTlc8nCSw folded before Flop (didn't bet)
Seat 9: 1K6QGyJP9P9xmRac2fH4OQ folded before Flop (didn't bet)




PokerStars Game #59939336364:  Hold'em No Limit ($0.10/$0.25) - 2009/07/01 0:37:16 ET
Table 'FgLmv9bi/fJP8ldfbTOpkg' 9-max Seat #9 is the button
Seat 1: opOCI2p6kW0tINuVaAqmcQ ($25 in chips) 
Seat 2: mpsfNtnMVDqQHTe92AhIdw ($19.30 in chips) 
Seat 3: JxpnpCmvRAcrEUy7mq1iAg ($6.50 in chips) 
Seat 4: WfS0TjI8FyLemNTOo1e9qA ($10.95 in chips) 
Seat 5: D4MF24Gh/tTI6FprZlrQTg ($25.10 in chips) 
Seat 6: oKO7b50N6TzXbPBr/mcrUA ($32.70 in chips) 
Seat 7: eFrBtVXGVoMq1UwCDg8Exg ($24.65 in chips) 
Seat 8: sJNHTWcSlLHRCZ9+YRLLqA ($25 in chips) 
Seat 9: Th3FldXKQW6hWVVPahaoOQ ($25 in chips) 
opOCI2p6kW0tINuVaAqmcQ: posts small blind $0.10
mpsfNtnMVDqQHTe92AhIdw: posts big blind $0.25
*** HOLE CARDS ***
JxpnpCmvRAcrEUy7mq1iAg: folds 
WfS0TjI8FyLemNTOo1e9qA: folds 
D4MF24Gh/tTI6FprZlrQTg: folds 
oKO7b50N6TzXbPBr/mcrUA: folds 
eFrBtVXGVoMq1UwCDg8Exg: folds 
sJNHTWcSlLHRCZ9+YRLLqA: folds 
Th3FldXKQW6hWVVPahaoOQ: folds 
opOCI2p6kW0tINuVaAqmcQ: folds 
Uncalled bet ($0.15) returned to mpsfNtnMVDqQHTe92AhIdw
mpsfNtnMVDqQHTe92AhIdw collected $0.20 from pot
*** SUMMARY ***
Total pot $0.20 | Rake $0 
Seat 1: opOCI2p6kW0tINuVaAqmcQ (small blind) folded before Flop
Seat 2: mpsfNtnMVDqQHTe92AhIdw (big blind) collected ($0.20)
Seat 3: JxpnpCmvRAcrEUy7mq1iAg folded before Flop (didn't bet)
Seat 4: WfS0TjI8FyLemNTOo1e9qA folded before Flop (didn't bet)
Seat 5: D4MF24Gh/tTI6FprZlrQTg folded before Flop (didn't bet)
Seat 6: oKO7b50N6TzXbPBr/mcrUA folded before Flop (didn't bet)
Seat 7: eFrBtVXGVoMq1UwCDg8Exg folded before Flop (didn't bet)
Seat 8: sJNHTWcSlLHRCZ9+YRLLqA folded before Flop (didn't bet)
Seat 9: Th3FldXKQW6hWVVPahaoOQ (button) folded before Flop (didn't bet)




PokerStars Game #59939336846:  Hold'em No Limit ($0.10/$0.25) - 2009/07/01 0:37:16 ET
Table 'IrJPyZ3JW2iIa+krdoSbJQ' 9-max Seat #8 is the button
Seat 1: 4+E2msto8r80F3SH2gctVA ($25.10 in chips) 
Seat 2: DdPXdieucQ+n99u1n3A+rQ ($5.05 in chips) 
Seat 3: vZGoOTJLQLhkPj4I+LNGig ($25 in chips) 
Seat 4: DnDcAdn9P0zGovMERigpFA ($25 in chips) 
Seat 5: sUVgUtgbfVx6JpvApozwhQ ($5.05 in chips) 
Seat 6: +sbyWwIcFp9kP0bDtMegfQ ($23.95 in chips) 
Seat 7: uH1RN27w9SKa7TpVR9EFrQ ($27.90 in chips) 
Seat 8: VBHxUExRAMrbxUq/cVx9Gw ($5 in chips) 
Seat 9: SXqVW4Q0evTUVZG6BbUNIA ($29.40 in chips) 
SXqVW4Q0evTUVZG6BbUNIA: posts small blind $0.10
4+E2msto8r80F3SH2gctVA: posts big blind $0.25
*** HOLE CARDS ***
DdPXdieucQ+n99u1n3A+rQ: folds 
vZGoOTJLQLhkPj4I+LNGig: folds 
DnDcAdn9P0zGovMERigpFA: folds 
sUVgUtgbfVx6JpvApozwhQ: folds 
+sbyWwIcFp9kP0bDtMegfQ: raises $0.75 to $1
uH1RN27w9SKa7TpVR9EFrQ: folds 
VBHxUExRAMrbxUq/cVx9Gw: folds 
SXqVW4Q0evTUVZG6BbUNIA: folds 
4+E2msto8r80F3SH2gctVA: folds 
Uncalled bet ($0.75) returned to +sbyWwIcFp9kP0bDtMegfQ
+sbyWwIcFp9kP0bDtMegfQ collected $0.60 from pot
*** SUMMARY ***
Total pot $0.60 | Rake $0 
Seat 1: 4+E2msto8r80F3SH2gctVA (big blind) folded before Flop
Seat 2: DdPXdieucQ+n99u1n3A+rQ folded before Flop (didn't bet)
Seat 3: vZGoOTJLQLhkPj4I+LNGig folded before Flop (didn't bet)
Seat 4: DnDcAdn9P0zGovMERigpFA folded before Flop (didn't bet)
Seat 5: sUVgUtgbfVx6JpvApozwhQ folded before Flop (didn't bet)
Seat 6: +sbyWwIcFp9kP0bDtMegfQ collected ($0.60)
Seat 7: uH1RN27w9SKa7TpVR9EFrQ folded before Flop (didn't bet)
Seat 8: VBHxUExRAMrbxUq/cVx9Gw (button) folded before Flop (didn't bet)
Seat 9: SXqVW4Q0evTUVZG6BbUNIA (small blind) folded before Flop




PokerStars Game #59939336658:  Hold'em No Limit ($0.10/$0.25) - 2009/07/01 0:37:16 ET
Table 'BpNkESDX1ip9c0K1hb5h7A' 6-max Seat #4 is the button
Seat 1: 9jSiy0meE9XJKkdIZwyTEQ ($29.10 in chips) 
Seat 3: cHhVLDikFlByGGN+CM3w/A ($26.15 in chips) 
Seat 4: tbhYGxTClzdFLMcTtjvJhg ($49.20 in chips) 
Seat 5: QvTX2yGq3uKJiKPmns4TKQ ($73.50 in chips) 
Seat 6: iUgsn+WyKFjjVd+tj13R2w ($4.25 in chips) 
QvTX2yGq3uKJiKPmns4TKQ: posts small blind $0.10
iUgsn+WyKFjjVd+tj13R2w: posts big blind $0.25
*** HOLE CARDS ***
9jSiy0meE9XJKkdIZwyTEQ: folds 
cHhVLDikFlByGGN+CM3w/A: raises $0.50 to $0.75
tbhYGxTClzdFLMcTtjvJhg: folds 
QvTX2yGq3uKJiKPmns4TKQ: folds 
iUgsn+WyKFjjVd+tj13R2w: calls $0.50
*** FLOP *** [2h 7c Kd]
iUgsn+WyKFjjVd+tj13R2w: checks 
cHhVLDikFlByGGN+CM3w/A: bets $0.80
iUgsn+WyKFjjVd+tj13R2w: folds 
Uncalled bet ($0.80) returned to cHhVLDikFlByGGN+CM3w/A
cHhVLDikFlByGGN+CM3w/A collected $1.55 from pot
cHhVLDikFlByGGN+CM3w/A: doesn't show hand 
*** SUMMARY ***
Total pot $1.60 | Rake $0.05 
Board [2h 7c Kd]
Seat 1: 9jSiy0meE9XJKkdIZwyTEQ folded before Flop (didn't bet)
Seat 3: cHhVLDikFlByGGN+CM3w/A collected ($1.55)
Seat 4: tbhYGxTClzdFLMcTtjvJhg (button) folded before Flop (didn't bet)
Seat 5: QvTX2yGq3uKJiKPmns4TKQ (small blind) folded before Flop
Seat 6: iUgsn+WyKFjjVd+tj13R2w (big blind) folded on the Flop




PokerStars Game #59939336774:  Hold'em No Limit ($0.10/$0.25) - 2009/07/01 0:37:16 ET
Table 'MRfAiS/4JSfnUDlCcZo0wAhfHe8uKeSJMyWAjSdM7ROQx Seat #2 is the button
Seat 1: 32YL2ZEp8NT4JB2RVM9euQ ($34.45 in chips) 
Seat 2: /gJNBeCkWL4o85/jvlZ4BA ($38.35 in chips) 
Seat 3: FYepjhAvF8ZdVCmqHIy+eQ ($50 in chips) 
Seat 5: qccGLncfUaN00Few5HsgYg ($26.50 in chips) 
Seat 6: VaDPspfGS2lnEkaGNrNqfg ($10 in chips) 
FYepjhAvF8ZdVCmqHIy+eQ: posts small blind $0.10
qccGLncfUaN00Few5HsgYg: posts big blind $0.25
*** HOLE CARDS ***
VaDPspfGS2lnEkaGNrNqfg: folds 
32YL2ZEp8NT4JB2RVM9euQ: folds 
/gJNBeCkWL4o85/jvlZ4BA: raises $0.75 to $1
FYepjhAvF8ZdVCmqHIy+eQ: calls $0.90
qccGLncfUaN00Few5HsgYg: calls $0.75
*** FLOP *** [2h 9c 6h]
FYepjhAvF8ZdVCmqHIy+eQ: checks 
qccGLncfUaN00Few5HsgYg: checks 
/gJNBeCkWL4o85/jvlZ4BA: checks 
*** TURN *** [2h 9c 6h] [Qh]
FYepjhAvF8ZdVCmqHIy+eQ: checks 
qccGLncfUaN00Few5HsgYg: checks 
Go8clNIDGP3feVvzBDG4pg joins the table at seat #4 
/gJNBeCkWL4o85/jvlZ4BA: checks 
*** RIVER *** [2h 9c 6h Qh] [Tc]
FYepjhAvF8ZdVCmqHIy+eQ: checks 
qccGLncfUaN00Few5HsgYg: checks 
/gJNBeCkWL4o85/jvlZ4BA: checks 
*** SHOW DOWN ***
FYepjhAvF8ZdVCmqHIy+eQ: shows [5c 5d] (a pair of Fives)
qccGLncfUaN00Few5HsgYg: shows [Js Td] (a pair of Tens)
/gJNBeCkWL4o85/jvlZ4BA: mucks hand 
qccGLncfUaN00Few5HsgYg collected $2.85 from pot
*** SUMMARY ***
Total pot $3 | Rake $0.15 
Board [2h 9c 6h Qh Tc]
Seat 1: 32YL2ZEp8NT4JB2RVM9euQ folded before Flop (didn't bet)
Seat 2: /gJNBeCkWL4o85/jvlZ4BA (button) mucked
Seat 3: FYepjhAvF8ZdVCmqHIy+eQ (small blind) showed [5c 5d] and lost with a pair of Fives
Seat 5: qccGLncfUaN00Few5HsgYg (big blind) showed [Js Td] and won ($2.85) with a pair of Tens
Seat 6: VaDPspfGS2lnEkaGNrNqfg folded before Flop (didn't bet)




PokerStars Game #59939336368:  Hold'em No Limit ($0.10/$0.25) - 2009/07/01 0:37:16 ET
Table 'gZetDqJh6q9A3mLO3ThCsAnc6OeGk/wtaWV+6N+kgnZQSeat #6 is the button
Seat 1: 1YCU970EVCcjs4GQP5Zt0g ($22.15 in chips) 
Seat 3: wKFJ513ucluNNiMlkXcDOQ ($28.75 in chips) 
Seat 4: eHsmIvAb2JREg4O6hNPnXg ($9.30 in chips) 
Seat 5: mfrkWA3PTeYPkbO6hi98Aw ($44.40 in chips) 
Seat 6: R1hR3/XSBdOHwcbSUJRJbg ($26.55 in chips) 
1YCU970EVCcjs4GQP5Zt0g: posts small blind $0.10
wKFJ513ucluNNiMlkXcDOQ: posts big blind $0.25
*** HOLE CARDS ***
eHsmIvAb2JREg4O6hNPnXg: folds 
mfrkWA3PTeYPkbO6hi98Aw: raises $0.75 to $1
R1hR3/XSBdOHwcbSUJRJbg: folds 
1YCU970EVCcjs4GQP5Zt0g: calls $0.90
wKFJ513ucluNNiMlkXcDOQ: calls $0.75
*** FLOP *** [Td Jh 4d]
1YCU970EVCcjs4GQP5Zt0g: bets $1.75
wKFJ513ucluNNiMlkXcDOQ: raises $4.25 to $6
mfrkWA3PTeYPkbO6hi98Aw: folds 
1YCU970EVCcjs4GQP5Zt0g: folds 
Uncalled bet ($4.25) returned to wKFJ513ucluNNiMlkXcDOQ
wKFJ513ucluNNiMlkXcDOQ collected $6.20 from pot
wKFJ513ucluNNiMlkXcDOQ: doesn't show hand 
*** SUMMARY ***
Total pot $6.50 | Rake $0.30 
Board [Td Jh 4d]
Seat 1: 1YCU970EVCcjs4GQP5Zt0g (small blind) folded on the Flop
Seat 3: wKFJ513ucluNNiMlkXcDOQ (big blind) collected ($6.20)
Seat 4: eHsmIvAb2JREg4O6hNPnXg folded before Flop (didn't bet)
Seat 5: mfrkWA3PTeYPkbO6hi98Aw folded on the Flop
Seat 6: R1hR3/XSBdOHwcbSUJRJbg (button) folded before Flop (didn't bet)




PokerStars Game #59939337470:  Hold'em No Limit ($0.10/$0.25) - 2009/07/01 0:37:17 ET
Table 'nFlmVztKq1HJEWfxmdl15w' 9-max Seat #9 is the button
Seat 1: COsrwJSFHQtxlUcrYtDQPQ ($25 in chips) 
Seat 3: /XMgGtJ7mcWfe5s7McY9kw ($21.05 in chips) 
Seat 4: +5dSUwD+/k2ktlnutSMivw ($21.65 in chips) 
Seat 5: Tx6zQdk5Ozt9ObEBlU7jeg ($20.60 in chips) 
Seat 6: 4awUyiDYTgylQKXZ9faBVA ($29.25 in chips) 
Seat 7: Mm1VqYDg+pZQ8ufUXZHA1g ($11.05 in chips) 
Seat 9: LSrAei+fS8MYG9ie/GkG0Q ($12.25 in chips) 
COsrwJSFHQtxlUcrYtDQPQ: posts small blind $0.10
q9qPRjJC40e/Q9yuT+glwQ: is sitting out 
/XMgGtJ7mcWfe5s7McY9kw: posts big blind $0.25
+2kMBNpY4nF1qNCRd8SJLA: sits out 
*** HOLE CARDS ***
+5dSUwD+/k2ktlnutSMivw: folds 
Tx6zQdk5Ozt9ObEBlU7jeg: folds 
4awUyiDYTgylQKXZ9faBVA: raises $0.75 to $1
Mm1VqYDg+pZQ8ufUXZHA1g: folds 
LSrAei+fS8MYG9ie/GkG0Q: folds 
COsrwJSFHQtxlUcrYtDQPQ: folds 
/XMgGtJ7mcWfe5s7McY9kw: folds 
Uncalled bet ($0.75) returned to 4awUyiDYTgylQKXZ9faBVA
4awUyiDYTgylQKXZ9faBVA collected $0.60 from pot
4awUyiDYTgylQKXZ9faBVA: doesn't show hand 
*** SUMMARY ***
Total pot $0.60 | Rake $0 
Seat 1: COsrwJSFHQtxlUcrYtDQPQ (small blind) folded before Flop
Seat 3: /XMgGtJ7mcWfe5s7McY9kw (big blind) folded before Flop
Seat 4: +5dSUwD+/k2ktlnutSMivw folded before Flop (didn't bet)
Seat 5: Tx6zQdk5Ozt9ObEBlU7jeg folded before Flop (didn't bet)
Seat 6: 4awUyiDYTgylQKXZ9faBVA collected ($0.60)
Seat 7: Mm1VqYDg+pZQ8ufUXZHA1g folded before Flop (didn't bet)
Seat 9: LSrAei+fS8MYG9ie/GkG0Q (button) folded before Flop (didn't bet)




PokerStars Game #59939336988:  Hold'em No Limit ($0.10/$0.25) - 2009/07/01 0:37:17 ET
Table 'OvOqQoL/QnXuXuQjXo2hIQ' 9-max Seat #4 is the button
Seat 3: uJlzv9KL7hgCIqIS2ofoaw ($11.20 in chips) 
Seat 4: e8solDZU6VFefGEm0DJbUg ($10.80 in chips) 
Seat 5: sJNHTWcSlLHRCZ9+YRLLqA ($29.05 in chips) 
Seat 6: MIVCHqCqqlke0Lb0z7glcw ($47 in chips) 
Seat 7: aNpwfA31EREwO+ar4XzBCw ($27.15 in chips) 
Seat 8: 42xLFHn85WRGGaaUZTNvwA ($10.70 in chips) 
Seat 9: VWUWpMLMj/Q1jRVpF7Aohw ($14.60 in chips) 
sJNHTWcSlLHRCZ9+YRLLqA: posts small blind $0.10
MIVCHqCqqlke0Lb0z7glcw: posts big blind $0.25
*** HOLE CARDS ***
aNpwfA31EREwO+ar4XzBCw: folds 
42xLFHn85WRGGaaUZTNvwA: raises $0.75 to $1
VWUWpMLMj/Q1jRVpF7Aohw: folds 
uJlzv9KL7hgCIqIS2ofoaw: folds 
e8solDZU6VFefGEm0DJbUg: folds 
sJNHTWcSlLHRCZ9+YRLLqA: folds 
MIVCHqCqqlke0Lb0z7glcw: folds 
Uncalled bet ($0.75) returned to 42xLFHn85WRGGaaUZTNvwA
42xLFHn85WRGGaaUZTNvwA collected $0.60 from pot
42xLFHn85WRGGaaUZTNvwA: doesn't show hand 
*** SUMMARY ***
Total pot $0.60 | Rake $0 
Seat 3: uJlzv9KL7hgCIqIS2ofoaw folded before Flop (didn't bet)
Seat 4: e8solDZU6VFefGEm0DJbUg (button) folded before Flop (didn't bet)
Seat 5: sJNHTWcSlLHRCZ9+YRLLqA (small blind) folded before Flop
Seat 6: MIVCHqCqqlke0Lb0z7glcw (big blind) folded before Flop
Seat 7: aNpwfA31EREwO+ar4XzBCw folded before Flop (didn't bet)
Seat 8: 42xLFHn85WRGGaaUZTNvwA collected ($0.60)
Seat 9: VWUWpMLMj/Q1jRVpF7Aohw folded before Flop (didn't bet)




PokerStars Game #59939337560:  Hold'em No Limit ($0.10/$0.25) - 2009/07/01 0:37:17 ET
Table '2AUmC2Rslg+QUbLfdgNdfg' 6-max Seat #1 is the button
Seat 1: lgP2sg9oZJsNSXCt7tbwRg ($16.60 in chips) 
Seat 2: CCxAG7iPVlAv3brCqrGBEg ($14.85 in chips) 
Seat 3: iauW7L/+7qzAuHow7CD75Q ($6.30 in chips) 
Seat 4: B6R6e73iyJNddUtXtvYr3Q ($47.95 in chips) 
Seat 5: 8ClCHtFXGNplITm+63KB+Q ($24.30 in chips) 
Seat 6: BvTq4Tu0zBOsniW3eFCnkQ ($30.55 in chips) 
CCxAG7iPVlAv3brCqrGBEg: posts small blind $0.10
iauW7L/+7qzAuHow7CD75Q: posts big blind $0.25
*** HOLE CARDS ***
B6R6e73iyJNddUtXtvYr3Q: folds 
8ClCHtFXGNplITm+63KB+Q: raises $0.75 to $1
BvTq4Tu0zBOsniW3eFCnkQ: raises $2.50 to $3.50
lgP2sg9oZJsNSXCt7tbwRg: folds 
CCxAG7iPVlAv3brCqrGBEg: folds 
iauW7L/+7qzAuHow7CD75Q: folds 
8ClCHtFXGNplITm+63KB+Q: folds 
Uncalled bet ($2.50) returned to BvTq4Tu0zBOsniW3eFCnkQ
BvTq4Tu0zBOsniW3eFCnkQ collected $2.35 from pot
BvTq4Tu0zBOsniW3eFCnkQ: doesn't show hand 
*** SUMMARY ***
Total pot $2.35 | Rake $0 
Seat 1: lgP2sg9oZJsNSXCt7tbwRg (button) folded before Flop (didn't bet)
Seat 2: CCxAG7iPVlAv3brCqrGBEg (small blind) folded before Flop
Seat 3: iauW7L/+7qzAuHow7CD75Q (big blind) folded before Flop
Seat 4: B6R6e73iyJNddUtXtvYr3Q folded before Flop (didn't bet)
Seat 5: 8ClCHtFXGNplITm+63KB+Q folded before Flop
Seat 6: BvTq4Tu0zBOsniW3eFCnkQ collected ($2.35)




PokerStars Game #59939337372:  Hold'em No Limit ($0.10/$0.25) - 2009/07/01 0:37:17 ET
Table '/XCUCUl3yW6tdTJQEhJKGw' 6-max Seat #3 is the button
Seat 1: p8J112JmNRnCwV2+NAEzCA ($15.30 in chips) 
Seat 2: 8ClCHtFXGNplITm+63KB+Q ($27.25 in chips) 
Seat 3: /gJNBeCkWL4o85/jvlZ4BA ($35.60 in chips) 
Seat 4: SFmT9ZsVopnukjvAzrxTRg ($25.10 in chips) 
Seat 5: 3rlIjSrvbZoI2IILbnetnA ($25.35 in chips) 
Seat 6: armfxZhGxeZVZBYAQFuIJQ ($36.45 in chips) 
SFmT9ZsVopnukjvAzrxTRg: posts small blind $0.10
3rlIjSrvbZoI2IILbnetnA: posts big blind $0.25
*** HOLE CARDS ***
armfxZhGxeZVZBYAQFuIJQ: raises $0.50 to $0.75
p8J112JmNRnCwV2+NAEzCA: folds 
8ClCHtFXGNplITm+63KB+Q: folds 
/gJNBeCkWL4o85/jvlZ4BA: folds 
SFmT9ZsVopnukjvAzrxTRg: folds 
3rlIjSrvbZoI2IILbnetnA: folds 
Uncalled bet ($0.50) returned to armfxZhGxeZVZBYAQFuIJQ
armfxZhGxeZVZBYAQFuIJQ collected $0.60 from pot
armfxZhGxeZVZBYAQFuIJQ: doesn't show hand 
*** SUMMARY ***
Total pot $0.60 | Rake $0 
Seat 1: p8J112JmNRnCwV2+NAEzCA folded before Flop (didn't bet)
Seat 2: 8ClCHtFXGNplITm+63KB+Q folded before Flop (didn't bet)
Seat 3: /gJNBeCkWL4o85/jvlZ4BA (button) folded before Flop (didn't bet)
Seat 4: SFmT9ZsVopnukjvAzrxTRg (small blind) folded before Flop
Seat 5: 3rlIjSrvbZoI2IILbnetnA (big blind) folded before Flop
Seat 6: armfxZhGxeZVZBYAQFuIJQ collected ($0.60)




PokerStars Game #59939337482:  Hold'em No Limit ($0.10/$0.25) - 2009/07/01 0:37:17 ET
Table 'wPWRBZPJl1HAnysw7qRR0A' 6-max Seat #1 is the button
Seat 1: cPO/1/dTcZpLkQFm3jH3Rg ($49 in chips) 
Seat 2: 48oT5xFI+5CHUJlfoGrE4w ($6.65 in chips) 
Seat 3: rPToQDbLWB+dKnz7fcQSIg ($6.45 in chips) 
Seat 4: kbpWbC+dJNBphHl1jtw7bw ($17 in chips) 
Seat 5: LtASJ9OlkqGrrUKGQlpGAw ($22.30 in chips) 
Seat 6: VLoE/jniCqHZuUkx8Esf6w ($29.80 in chips) 
48oT5xFI+5CHUJlfoGrE4w: posts small blind $0.10
rPToQDbLWB+dKnz7fcQSIg: posts big blind $0.25
*** HOLE CARDS ***
kbpWbC+dJNBphHl1jtw7bw: folds 
LtASJ9OlkqGrrUKGQlpGAw has timed out
LtASJ9OlkqGrrUKGQlpGAw: folds 
LtASJ9OlkqGrrUKGQlpGAw is sitting out
VLoE/jniCqHZuUkx8Esf6w: calls $0.25
LtASJ9OlkqGrrUKGQlpGAw has returned
cPO/1/dTcZpLkQFm3jH3Rg: raises $1.25 to $1.50
48oT5xFI+5CHUJlfoGrE4w: folds 
rPToQDbLWB+dKnz7fcQSIg: folds 
VLoE/jniCqHZuUkx8Esf6w: folds 
Uncalled bet ($1.25) returned to cPO/1/dTcZpLkQFm3jH3Rg
cPO/1/dTcZpLkQFm3jH3Rg collected $0.85 from pot
*** SUMMARY ***
Total pot $0.85 | Rake $0 
Seat 1: cPO/1/dTcZpLkQFm3jH3Rg (button) collected ($0.85)
Seat 2: 48oT5xFI+5CHUJlfoGrE4w (small blind) folded before Flop
Seat 3: rPToQDbLWB+dKnz7fcQSIg (big blind) folded before Flop
Seat 4: kbpWbC+dJNBphHl1jtw7bw folded before Flop (didn't bet)
Seat 5: LtASJ9OlkqGrrUKGQlpGAw folded before Flop (didn't bet)
Seat 6: VLoE/jniCqHZuUkx8Esf6w folded before Flop




PokerStars Game #59939337598:  Hold'em No Limit ($0.10/$0.25) - 2009/07/01 0:37:17 ET
Table 'vud0GB/ZlDCvUFhBFIaTlg' 9-max Seat #8 is the button
Seat 7: RzaVufWfW9CTnVYR7/Ge+w ($3.70 in chips) 
Seat 8: 7cv+9Zc9HIQHNvYsMfV3uA ($31.20 in chips) 
7cv+9Zc9HIQHNvYsMfV3uA: posts small blind $0.10
RzaVufWfW9CTnVYR7/Ge+w: posts big blind $0.25
*** HOLE CARDS ***
7cv+9Zc9HIQHNvYsMfV3uA: raises $0.50 to $0.75
RzaVufWfW9CTnVYR7/Ge+w: folds 
Uncalled bet ($0.50) returned to 7cv+9Zc9HIQHNvYsMfV3uA
7cv+9Zc9HIQHNvYsMfV3uA collected $0.50 from pot
7cv+9Zc9HIQHNvYsMfV3uA: doesn't show hand 
*** SUMMARY ***
Total pot $0.50 | Rake $0 
Seat 7: RzaVufWfW9CTnVYR7/Ge+w (big blind) folded before Flop
Seat 8: 7cv+9Zc9HIQHNvYsMfV3uA (button) (small blind) collected ($0.50)




PokerStars Game #59939337524:  Hold'em No Limit ($0.10/$0.25) - 2009/07/01 0:37:17 ET
Table 'JYkCJJ5Iv+Tu52jx2lpEcgT/iCKJXGphRN3xcdwfE/JQSeat #5 is the button
Seat 1: Yv4fucyyT28mjx8V5lxKJg ($26.25 in chips) 
Seat 2: hBMUlEpyU74r/fwDgIpXjQ ($35.25 in chips) 
Seat 3: Z5ZtGOON8kmSdSCll9Z3XA ($7.25 in chips) 
Seat 4: +C3eP/ysyROWbEXJFPswVA ($24.05 in chips) 
Seat 5: 6OVSxS1KoddUCYNkZ4hREw ($28.60 in chips) 
Seat 6: OiV1PWZ3IkN29JlmCcnTwQ ($4.50 in chips) 
Seat 7: N6fYvIzQLKaydFLKQGtMlQ ($24.75 in chips) 
Seat 8: COsrwJSFHQtxlUcrYtDQPQ ($25 in chips) 
Seat 9: H9KUl8cmpLgEpOVDA00bCg ($5.50 in chips) 
OiV1PWZ3IkN29JlmCcnTwQ: posts small blind $0.10
N6fYvIzQLKaydFLKQGtMlQ: posts big blind $0.25
*** HOLE CARDS ***
COsrwJSFHQtxlUcrYtDQPQ: folds 
H9KUl8cmpLgEpOVDA00bCg: folds 
Yv4fucyyT28mjx8V5lxKJg: folds 
hBMUlEpyU74r/fwDgIpXjQ: raises $0.75 to $1
Z5ZtGOON8kmSdSCll9Z3XA: folds 
+C3eP/ysyROWbEXJFPswVA: folds 
6OVSxS1KoddUCYNkZ4hREw: folds 
OiV1PWZ3IkN29JlmCcnTwQ: folds 
N6fYvIzQLKaydFLKQGtMlQ: folds 
Uncalled bet ($0.75) returned to hBMUlEpyU74r/fwDgIpXjQ
hBMUlEpyU74r/fwDgIpXjQ collected $0.60 from pot
hBMUlEpyU74r/fwDgIpXjQ: doesn't show hand 
*** SUMMARY ***
Total pot $0.60 | Rake $0 
Seat 1: Yv4fucyyT28mjx8V5lxKJg folded before Flop (didn't bet)
Seat 2: hBMUlEpyU74r/fwDgIpXjQ collected ($0.60)
Seat 3: Z5ZtGOON8kmSdSCll9Z3XA folded before Flop (didn't bet)
Seat 4: +C3eP/ysyROWbEXJFPswVA folded before Flop (didn't bet)
Seat 5: 6OVSxS1KoddUCYNkZ4hREw (button) folded before Flop (didn't bet)
Seat 6: OiV1PWZ3IkN29JlmCcnTwQ (small blind) folded before Flop
Seat 7: N6fYvIzQLKaydFLKQGtMlQ (big blind) folded before Flop
Seat 8: COsrwJSFHQtxlUcrYtDQPQ folded before Flop (didn't bet)
Seat 9: H9KUl8cmpLgEpOVDA00bCg folded before Flop (didn't bet)




PokerStars Game #59939337270:  Hold'em No Limit ($0.10/$0.25) - 2009/07/01 0:37:17 ET
Table 'HIOfhT0zga/KonFhIl6O3w' 9-max Seat #4 is the button
Seat 1: t2nb95S5EEFOEzNx9Itz0g ($6.20 in chips) 
Seat 2: er86weqXTpTB6/w2dKlYgA ($16.45 in chips) 
Seat 3: RxrlOCIHB/l30KL6EEws0g ($36.80 in chips) 
Seat 4: qwr38jl5txoR36M7G5qi4A ($7.75 in chips) 
Seat 5: K1MDeapSEyKyGPNZGOKfEg ($13.75 in chips) 
Seat 6: cZ99hugmLBj9KhTlc8nCSw ($26.05 in chips) 
Seat 7: H9KUl8cmpLgEpOVDA00bCg ($5.60 in chips) 
Seat 8: 3RCAkueG3Vc13VpRStCB+w ($26.35 in chips) 
Seat 9: dfNim92Z6XK1/h5SFW5vDg ($25 in chips) 
K1MDeapSEyKyGPNZGOKfEg: posts small blind $0.10
cZ99hugmLBj9KhTlc8nCSw: posts big blind $0.25
*** HOLE CARDS ***
H9KUl8cmpLgEpOVDA00bCg: folds 
3RCAkueG3Vc13VpRStCB+w: folds 
dfNim92Z6XK1/h5SFW5vDg: folds 
t2nb95S5EEFOEzNx9Itz0g: folds 
er86weqXTpTB6/w2dKlYgA: folds 
RxrlOCIHB/l30KL6EEws0g: raises $0.50 to $0.75
qwr38jl5txoR36M7G5qi4A: folds 
K1MDeapSEyKyGPNZGOKfEg: folds 
cZ99hugmLBj9KhTlc8nCSw: folds 
Uncalled bet ($0.50) returned to RxrlOCIHB/l30KL6EEws0g
RxrlOCIHB/l30KL6EEws0g collected $0.60 from pot
RxrlOCIHB/l30KL6EEws0g: doesn't show hand 
*** SUMMARY ***
Total pot $0.60 | Rake $0 
Seat 1: t2nb95S5EEFOEzNx9Itz0g folded before Flop (didn't bet)
Seat 2: er86weqXTpTB6/w2dKlYgA folded before Flop (didn't bet)
Seat 3: RxrlOCIHB/l30KL6EEws0g collected ($0.60)
Seat 4: qwr38jl5txoR36M7G5qi4A (button) folded before Flop (didn't bet)
Seat 5: K1MDeapSEyKyGPNZGOKfEg (small blind) folded before Flop
Seat 6: cZ99hugmLBj9KhTlc8nCSw (big blind) folded before Flop
Seat 7: H9KUl8cmpLgEpOVDA00bCg folded before Flop (didn't bet)
Seat 8: 3RCAkueG3Vc13VpRStCB+w folded before Flop (didn't bet)
Seat 9: dfNim92Z6XK1/h5SFW5vDg folded before Flop (didn't bet)




PokerStars Game #59939337442:  Hold'em No Limit ($0.10/$0.25) - 2009/07/01 0:37:17 ET
Table 'R5qKG21jwFDYRcOht9qwqQ' 9-max Seat #8 is the button
Seat 1: OgISYvc5hA85YuDnsXCH+Q ($16.25 in chips) 
Seat 3: M2QO2DxB5Wawg2h8HSpnYA ($10 in chips) 
Seat 4: z5GxcHlYz/GSz6W2uFiTtg ($25.40 in chips) 
Seat 5: 8B/dhbQjIWe6ASCdgzktNQ ($25 in chips) 
Seat 6: sUVgUtgbfVx6JpvApozwhQ ($11.10 in chips) 
Seat 7: HYQiVfBGJsg4smSubKCBmA ($28.75 in chips) 
Seat 8: tYsOBqdU1+x+yFI7zHO7hQ ($25 in chips) 
Seat 9: MG90wfSJZnOejs/KD3vlQQ ($25 in chips) 
MG90wfSJZnOejs/KD3vlQQ: posts small blind $0.10
OgISYvc5hA85YuDnsXCH+Q: posts big blind $0.25
*** HOLE CARDS ***
M2QO2DxB5Wawg2h8HSpnYA: folds 
z5GxcHlYz/GSz6W2uFiTtg: folds 
8B/dhbQjIWe6ASCdgzktNQ: folds 
sUVgUtgbfVx6JpvApozwhQ: folds 
HYQiVfBGJsg4smSubKCBmA: folds 
tYsOBqdU1+x+yFI7zHO7hQ: raises $0.50 to $0.75
MG90wfSJZnOejs/KD3vlQQ: raises $1.65 to $2.40
OgISYvc5hA85YuDnsXCH+Q: folds 
tYsOBqdU1+x+yFI7zHO7hQ: folds 
Uncalled bet ($1.65) returned to MG90wfSJZnOejs/KD3vlQQ
N6foVRyErHqcNmshkqextQ joins the table at seat #2 
MG90wfSJZnOejs/KD3vlQQ collected $1.75 from pot
*** SUMMARY ***
Total pot $1.75 | Rake $0 
Seat 1: OgISYvc5hA85YuDnsXCH+Q (big blind) folded before Flop
Seat 3: M2QO2DxB5Wawg2h8HSpnYA folded before Flop (didn't bet)
Seat 4: z5GxcHlYz/GSz6W2uFiTtg folded before Flop (didn't bet)
Seat 5: 8B/dhbQjIWe6ASCdgzktNQ folded before Flop (didn't bet)
Seat 6: sUVgUtgbfVx6JpvApozwhQ folded before Flop (didn't bet)
Seat 7: HYQiVfBGJsg4smSubKCBmA folded before Flop (didn't bet)
Seat 8: tYsOBqdU1+x+yFI7zHO7hQ (button) folded before Flop
Seat 9: MG90wfSJZnOejs/KD3vlQQ (small blind) collected ($1.75)




PokerStars Game #59939337618:  Hold'em No Limit ($0.10/$0.25) - 2009/07/01 0:37:17 ET
Table 'gHbubGDeVSkmB4vFiqIN3Q' 6-max Seat #3 is the button
Seat 1: kG34n23qFQA3nzdOJTQ1dA ($25.55 in chips) 
Seat 2: 8LzEWRhg4wk8Jh9CqDhH3Q ($3.30 in chips) 
Seat 3: DDSdUri0VKbNEouF/1bdsg ($6.95 in chips) 
Seat 4: v+QfkGiuj9bgtuNoVnDO8w ($32.60 in chips) 
v+QfkGiuj9bgtuNoVnDO8w: posts small blind $0.10
eRAISER_92: is sitting out 
kG34n23qFQA3nzdOJTQ1dA: posts big blind $0.25
*** HOLE CARDS ***
8LzEWRhg4wk8Jh9CqDhH3Q: folds 
eRAISER_92 leaves the table
DDSdUri0VKbNEouF/1bdsg: calls $0.25
v+QfkGiuj9bgtuNoVnDO8w: folds 
kG34n23qFQA3nzdOJTQ1dA: checks 
*** FLOP *** [7c 9c 7d]
kG34n23qFQA3nzdOJTQ1dA: checks 
DDSdUri0VKbNEouF/1bdsg: checks 
*** TURN *** [7c 9c 7d] [5d]
kG34n23qFQA3nzdOJTQ1dA: bets $0.50
DDSdUri0VKbNEouF/1bdsg: calls $0.50
*** RIVER *** [7c 9c 7d 5d] [3s]
kG34n23qFQA3nzdOJTQ1dA: bets $1.25
DDSdUri0VKbNEouF/1bdsg: folds 
Uncalled bet ($1.25) returned to kG34n23qFQA3nzdOJTQ1dA
kG34n23qFQA3nzdOJTQ1dA collected $1.55 from pot
*** SUMMARY ***
Total pot $1.60 | Rake $0.05 
Board [7c 9c 7d 5d 3s]
Seat 1: kG34n23qFQA3nzdOJTQ1dA (big blind) collected ($1.55)
Seat 2: 8LzEWRhg4wk8Jh9CqDhH3Q folded before Flop (didn't bet)
Seat 3: DDSdUri0VKbNEouF/1bdsg (button) folded on the River
Seat 4: v+QfkGiuj9bgtuNoVnDO8w (small blind) folded before Flop




PokerStars Game #59939338032:  Hold'em No Limit ($0.10/$0.25) - 2009/07/01 0:37:18 ET
Table '9lYs7ljXi6AgFAxYHlKLJw' 9-max Seat #6 is the button
Seat 2: N6fYvIzQLKaydFLKQGtMlQ ($21.40 in chips) 
Seat 3: DnDcAdn9P0zGovMERigpFA ($27.85 in chips) 
Seat 4: UANt6y/SmDCY/jIxkBixcw ($30 in chips) 
Seat 5: dfNim92Z6XK1/h5SFW5vDg ($56.55 in chips) 
Seat 6: JtVGnq5doRa3PublncR+Yw ($19.50 in chips) 
Seat 7: ghNKXUBl/H+t83JF079ZBA ($30.20 in chips) 
Seat 8: Do7fcCjAx0vINJYUXuFoyA ($20.35 in chips) 
Seat 9: 18G4P1XstjNvItdGUITxgw ($26.65 in chips) 
ghNKXUBl/H+t83JF079ZBA: posts small blind $0.10
Do7fcCjAx0vINJYUXuFoyA: posts big blind $0.25
*** HOLE CARDS ***
18G4P1XstjNvItdGUITxgw: folds 
N6fYvIzQLKaydFLKQGtMlQ: folds 
DnDcAdn9P0zGovMERigpFA: folds 
UANt6y/SmDCY/jIxkBixcw: folds 
dfNim92Z6XK1/h5SFW5vDg: raises $0.75 to $1
JtVGnq5doRa3PublncR+Yw: folds 
ghNKXUBl/H+t83JF079ZBA: folds 
Do7fcCjAx0vINJYUXuFoyA: calls $0.75
*** FLOP *** [Qd Jd 6s]
Do7fcCjAx0vINJYUXuFoyA: checks 
dfNim92Z6XK1/h5SFW5vDg: checks 
*** TURN *** [Qd Jd 6s] [6c]
Do7fcCjAx0vINJYUXuFoyA: bets $2
dfNim92Z6XK1/h5SFW5vDg: folds 
Uncalled bet ($2) returned to Do7fcCjAx0vINJYUXuFoyA
Do7fcCjAx0vINJYUXuFoyA collected $2 from pot
*** SUMMARY ***
Total pot $2.10 | Rake $0.10 
Board [Qd Jd 6s 6c]
Seat 2: N6fYvIzQLKaydFLKQGtMlQ folded before Flop (didn't bet)
Seat 3: DnDcAdn9P0zGovMERigpFA folded before Flop (didn't bet)
Seat 4: UANt6y/SmDCY/jIxkBixcw folded before Flop (didn't bet)
Seat 5: dfNim92Z6XK1/h5SFW5vDg folded on the Turn
Seat 6: JtVGnq5doRa3PublncR+Yw (button) folded before Flop (didn't bet)
Seat 7: ghNKXUBl/H+t83JF079ZBA (small blind) folded before Flop
Seat 8: Do7fcCjAx0vINJYUXuFoyA (big blind) collected ($2)
Seat 9: 18G4P1XstjNvItdGUITxgw folded before Flop (didn't bet)




PokerStars Game #59939338026:  Hold'em No Limit ($0.10/$0.25) - 2009/07/01 0:37:18 ET
Table 'SkaFM7xfUr/Nd+JFPb7f2w' 9-max Seat #8 is the button
Seat 2: QEbIGci+itdw+re8RM5fZA ($28.65 in chips) 
Seat 3: 4oA316mXLIui1QY63GXBUg ($25 in chips) 
Seat 4: DIBbjEYGs+TVdVgEB/4+3w ($39.20 in chips) 
Seat 5: GftT+l+xjKzcY0rMiNZfPg ($9.05 in chips) 
Seat 6: PskTLlFIRHSp61inskRzVg ($7.50 in chips) 
Seat 7: 7wo6Sr7QG3Zo6BaBDV1BOw ($5 in chips) 
Seat 8: Lro4e37x4FUa5P3yzDjskw ($10.85 in chips) 
Seat 9: STkR8XvpjNv79OOMhrlh2w ($59.55 in chips) 
STkR8XvpjNv79OOMhrlh2w: posts small blind $0.10
6LFELL8V3NTpb0xg7AOyEg: is sitting out 
QEbIGci+itdw+re8RM5fZA: posts big blind $0.25
*** HOLE CARDS ***
4oA316mXLIui1QY63GXBUg: folds 
6LFELL8V3NTpb0xg7AOyEg leaves the table
DIBbjEYGs+TVdVgEB/4+3w: folds 
GftT+l+xjKzcY0rMiNZfPg: folds 
PskTLlFIRHSp61inskRzVg: raises $0.75 to $1
7wo6Sr7QG3Zo6BaBDV1BOw: folds 
Lro4e37x4FUa5P3yzDjskw: folds 
STkR8XvpjNv79OOMhrlh2w: folds 
QEbIGci+itdw+re8RM5fZA: folds 
Uncalled bet ($0.75) returned to PskTLlFIRHSp61inskRzVg
PskTLlFIRHSp61inskRzVg collected $0.60 from pot
*** SUMMARY ***
Total pot $0.60 | Rake $0 
Seat 2: QEbIGci+itdw+re8RM5fZA (big blind) folded before Flop
Seat 3: 4oA316mXLIui1QY63GXBUg folded before Flop (didn't bet)
Seat 4: DIBbjEYGs+TVdVgEB/4+3w folded before Flop (didn't bet)
Seat 5: GftT+l+xjKzcY0rMiNZfPg folded before Flop (didn't bet)
Seat 6: PskTLlFIRHSp61inskRzVg collected ($0.60)
Seat 7: 7wo6Sr7QG3Zo6BaBDV1BOw folded before Flop (didn't bet)
Seat 8: Lro4e37x4FUa5P3yzDjskw (button) folded before Flop (didn't bet)
Seat 9: STkR8XvpjNv79OOMhrlh2w (small blind) folded before Flop




PokerStars Game #59939337994:  Hold'em No Limit ($0.10/$0.25) - 2009/07/01 0:37:18 ET
Table 'HQOv+27sJF7e8+zUsBlT2w' 9-max Seat #2 is the button
Seat 1: CbXUS6Z2rXZxL1AKduNtmQ ($26.25 in chips) 
Seat 2: MG90wfSJZnOejs/KD3vlQQ ($25 in chips) 
Seat 3: 18G4P1XstjNvItdGUITxgw ($28.20 in chips) 
Seat 4: kRW/Cdh6F1t40Vs43OFbYA ($17 in chips) 
Seat 5: aPRz/2GxbXANYpVsQO8pdQ ($30.30 in chips) 
Seat 6: vZGoOTJLQLhkPj4I+LNGig ($33.60 in chips) 
Seat 7: GmzfAfxcxu1kGbPC+9LkVg ($24.65 in chips) 
Seat 8: RaXCy4DBrUrZSg4MF8FyDg ($12.25 in chips) 
Seat 9: gehe91e0IyVT0QU/XBkEyg ($25 in chips) 
18G4P1XstjNvItdGUITxgw: posts small blind $0.10
kRW/Cdh6F1t40Vs43OFbYA: posts big blind $0.25
*** HOLE CARDS ***
aPRz/2GxbXANYpVsQO8pdQ: folds 
aPRz/2GxbXANYpVsQO8pdQ leaves the table
vZGoOTJLQLhkPj4I+LNGig: raises $0.75 to $1
GmzfAfxcxu1kGbPC+9LkVg: folds 
RaXCy4DBrUrZSg4MF8FyDg: folds 
gehe91e0IyVT0QU/XBkEyg: folds 
nD+0ILJGeuYzreVIK9/wcA joins the table at seat #5 
CbXUS6Z2rXZxL1AKduNtmQ: folds 
MG90wfSJZnOejs/KD3vlQQ: folds 
18G4P1XstjNvItdGUITxgw: raises $7 to $8
kRW/Cdh6F1t40Vs43OFbYA: folds 
vZGoOTJLQLhkPj4I+LNGig: folds 
Uncalled bet ($7) returned to 18G4P1XstjNvItdGUITxgw
18G4P1XstjNvItdGUITxgw collected $2.25 from pot
18G4P1XstjNvItdGUITxgw: doesn't show hand 
*** SUMMARY ***
Total pot $2.25 | Rake $0 
Seat 1: CbXUS6Z2rXZxL1AKduNtmQ folded before Flop (didn't bet)
Seat 2: MG90wfSJZnOejs/KD3vlQQ (button) folded before Flop (didn't bet)
Seat 3: 18G4P1XstjNvItdGUITxgw (small blind) collected ($2.25)
Seat 4: kRW/Cdh6F1t40Vs43OFbYA (big blind) folded before Flop
Seat 5: aPRz/2GxbXANYpVsQO8pdQ folded before Flop (didn't bet)
Seat 6: vZGoOTJLQLhkPj4I+LNGig folded before Flop
Seat 7: GmzfAfxcxu1kGbPC+9LkVg folded before Flop (didn't bet)
Seat 8: RaXCy4DBrUrZSg4MF8FyDg folded before Flop (didn't bet)
Seat 9: gehe91e0IyVT0QU/XBkEyg folded before Flop (didn't bet)




PokerStars Game #59939337628:  Hold'em No Limit ($0.10/$0.25) - 2009/07/01 0:37:18 ET
Table 'ohAuixfiLOYDylNUG5mNUw' 9-max Seat #5 is the button
Seat 1: AtRN1hdV8HbL3X4XogDaLA ($33 in chips) 
Seat 3: HVKi9hnDyvzObpL08/OarQ ($26.60 in chips) 
Seat 4: jeKWRUkMaVn8rEUjnJKqpg ($25 in chips) 
Seat 5: Z5ZtGOON8kmSdSCll9Z3XA ($16.60 in chips) 
Seat 7: WdsZPRB5ooUPinQdaX0QrA ($4.45 in chips) 
Seat 8: ppMlNkhYgErlt4fuJO7ADA ($14.45 in chips) 
Seat 9: hIss79a4pu7GzJZepfgOpg ($25 in chips) 
opOCI2p6kW0tINuVaAqmcQ will be allowed to play after the button
WdsZPRB5ooUPinQdaX0QrA: posts small blind $0.10
ppMlNkhYgErlt4fuJO7ADA: posts big blind $0.25
*** HOLE CARDS ***
hIss79a4pu7GzJZepfgOpg: raises $0.75 to $1
AtRN1hdV8HbL3X4XogDaLA: folds 
HVKi9hnDyvzObpL08/OarQ: folds 
jeKWRUkMaVn8rEUjnJKqpg: folds 
Z5ZtGOON8kmSdSCll9Z3XA: folds 
WdsZPRB5ooUPinQdaX0QrA: folds 
ppMlNkhYgErlt4fuJO7ADA: calls $0.75
*** FLOP *** [As 9s Qs]
ppMlNkhYgErlt4fuJO7ADA: checks 
hIss79a4pu7GzJZepfgOpg: bets $1.50
ppMlNkhYgErlt4fuJO7ADA: folds 
Uncalled bet ($1.50) returned to hIss79a4pu7GzJZepfgOpg
hIss79a4pu7GzJZepfgOpg collected $2 from pot
hIss79a4pu7GzJZepfgOpg: doesn't show hand 
*** SUMMARY ***
Total pot $2.10 | Rake $0.10 
Board [As 9s Qs]
Seat 1: AtRN1hdV8HbL3X4XogDaLA folded before Flop (didn't bet)
Seat 3: HVKi9hnDyvzObpL08/OarQ folded before Flop (didn't bet)
Seat 4: jeKWRUkMaVn8rEUjnJKqpg folded before Flop (didn't bet)
Seat 5: Z5ZtGOON8kmSdSCll9Z3XA (button) folded before Flop (didn't bet)
Seat 7: WdsZPRB5ooUPinQdaX0QrA (small blind) folded before Flop
Seat 8: ppMlNkhYgErlt4fuJO7ADA (big blind) folded on the Flop
Seat 9: hIss79a4pu7GzJZepfgOpg collected ($2)




PokerStars Game #59939337766:  Hold'em No Limit ($0.10/$0.25) - 2009/07/01 0:37:18 ET
Table 'FuFyQHmlO/QqQp//rDRrPg' 6-max Seat #3 is the button
Seat 1: 4re+a1K56DcbV7DyVX/FMw ($16.50 in chips) 
Seat 3: uoOTv6ecGYEhLPY44ZTW+A ($11.60 in chips) 
Seat 4: Eznneya0vB6S+eXJdVleHA ($7.90 in chips) 
Seat 5: wAKC8C/zN0c8V5v13dm9mA ($25.35 in chips) 
Seat 6: Euh3U8PK9KVQP5CQdDjkeQ ($21.15 in chips) 
Eznneya0vB6S+eXJdVleHA: posts small blind $0.10
Eznneya0vB6S+eXJdVleHA said, "that was shocking play"
wAKC8C/zN0c8V5v13dm9mA: posts big blind $0.25
*** HOLE CARDS ***
Euh3U8PK9KVQP5CQdDjkeQ: folds 
4re+a1K56DcbV7DyVX/FMw: calls $0.25
uoOTv6ecGYEhLPY44ZTW+A: calls $0.25
Eznneya0vB6S+eXJdVleHA: calls $0.15
wAKC8C/zN0c8V5v13dm9mA: checks 
*** FLOP *** [8c 7s 2h]
Eznneya0vB6S+eXJdVleHA: bets $0.60
wAKC8C/zN0c8V5v13dm9mA: folds 
4re+a1K56DcbV7DyVX/FMw: calls $0.60
uoOTv6ecGYEhLPY44ZTW+A: folds 
*** TURN *** [8c 7s 2h] [Ts]
Eznneya0vB6S+eXJdVleHA: bets $0.55
4re+a1K56DcbV7DyVX/FMw: calls $0.55
*** RIVER *** [8c 7s 2h Ts] [3s]
Eznneya0vB6S+eXJdVleHA: bets $0.50
4re+a1K56DcbV7DyVX/FMw: folds 
Uncalled bet ($0.50) returned to Eznneya0vB6S+eXJdVleHA
Eznneya0vB6S+eXJdVleHA collected $3.15 from pot
*** SUMMARY ***
Total pot $3.30 | Rake $0.15 
Board [8c 7s 2h Ts 3s]
Seat 1: 4re+a1K56DcbV7DyVX/FMw folded on the River
Seat 3: uoOTv6ecGYEhLPY44ZTW+A (button) folded on the Flop
Seat 4: Eznneya0vB6S+eXJdVleHA (small blind) collected ($3.15)
Seat 5: wAKC8C/zN0c8V5v13dm9mA (big blind) folded on the Flop
Seat 6: Euh3U8PK9KVQP5CQdDjkeQ folded before Flop (didn't bet)




PokerStars Game #59939338398:  Hold'em No Limit ($0.10/$0.25) - 2009/07/01 0:37:19 ET
Table 'IUwZ/e0bDHZPgsIWx0RnNg' 6-max Seat #3 is the button
Seat 1: e/sRoTSNz0xhPew+OAQGIg ($4.65 in chips) 
Seat 2: mvFHK3pE7tCxJEqLjKC70Q ($24.65 in chips) 
Seat 3: dOX4wnYV2sEqvDbF+8KSCw ($25 in chips) 
Seat 4: IyZ9SVxKy7TJvRGFneWTMg ($27.85 in chips) 
Seat 5: wsP46AGpqDjHZQmlRHKa9g ($26.60 in chips) 
IyZ9SVxKy7TJvRGFneWTMg: posts small blind $0.10
wsP46AGpqDjHZQmlRHKa9g: posts big blind $0.25
NhUN/JpAprdJeamFBgJH1w: sits out 
*** HOLE CARDS ***
e/sRoTSNz0xhPew+OAQGIg said, "you need it more then i do whitey"
e/sRoTSNz0xhPew+OAQGIg: calls $0.25
mvFHK3pE7tCxJEqLjKC70Q: folds 
e/sRoTSNz0xhPew+OAQGIg said, ";0"
dOX4wnYV2sEqvDbF+8KSCw: raises $0.75 to $1
IyZ9SVxKy7TJvRGFneWTMg: folds 
wsP46AGpqDjHZQmlRHKa9g: folds 
e/sRoTSNz0xhPew+OAQGIg: calls $0.75
*** FLOP *** [8s 9s 6c]
e/sRoTSNz0xhPew+OAQGIg: bets $3.65 and is all-in
IyZ9SVxKy7TJvRGFneWTMg said, "rich are ya?"
dOX4wnYV2sEqvDbF+8KSCw: calls $3.65
*** TURN *** [8s 9s 6c] [9h]
*** RIVER *** [8s 9s 6c 9h] [5h]
*** SHOW DOWN ***
e/sRoTSNz0xhPew+OAQGIg: shows [9c Ah] (three of a kind, Nines)
dOX4wnYV2sEqvDbF+8KSCw: shows [6s 7s] (a straight, Five to Nine)
dOX4wnYV2sEqvDbF+8KSCw collected $9.20 from pot
*** SUMMARY ***
Total pot $9.65 | Rake $0.45 
Board [8s 9s 6c 9h 5h]
Seat 1: e/sRoTSNz0xhPew+OAQGIg showed [9c Ah] and lost with three of a kind, Nines
Seat 2: mvFHK3pE7tCxJEqLjKC70Q folded before Flop (didn't bet)
Seat 3: dOX4wnYV2sEqvDbF+8KSCw (button) showed [6s 7s] and won ($9.20) with a straight, Five to Nine
Seat 4: IyZ9SVxKy7TJvRGFneWTMg (small blind) folded before Flop
Seat 5: wsP46AGpqDjHZQmlRHKa9g (big blind) folded before Flop




PokerStars Game #59939338602:  Hold'em No Limit ($0.10/$0.25) - 2009/07/01 0:37:19 ET
Table 'nlpa8xI95gAflovnFxB2yg' 6-max Seat #4 is the button
Seat 1: fZQg9veL7Dd/Z04ZTjC+wQ ($66.80 in chips) 
Seat 2: PIOdknsVyjKUwfiImc3zwg ($33.20 in chips) 
Seat 3: I1TxPvWj8NfG8orglCinNA ($25 in chips) 
Seat 4: 5xjU9nfIjn1MBxIJKZvS5w ($28.85 in chips) 
Seat 6: FPlQHZog0ePFCETQ2KG4hQ ($26.35 in chips) 
FPlQHZog0ePFCETQ2KG4hQ: posts small blind $0.10
fZQg9veL7Dd/Z04ZTjC+wQ: posts big blind $0.25
*** HOLE CARDS ***
PIOdknsVyjKUwfiImc3zwg: folds 
I1TxPvWj8NfG8orglCinNA: folds 
5xjU9nfIjn1MBxIJKZvS5w: calls $0.25
FPlQHZog0ePFCETQ2KG4hQ: folds 
fZQg9veL7Dd/Z04ZTjC+wQ: checks 
*** FLOP *** [2h 9c 4d]
HotTillt joins the table at seat #5 
fZQg9veL7Dd/Z04ZTjC+wQ: checks 
5xjU9nfIjn1MBxIJKZvS5w: checks 
*** TURN *** [2h 9c 4d] [Td]
fZQg9veL7Dd/Z04ZTjC+wQ: checks 
5xjU9nfIjn1MBxIJKZvS5w: bets $0.25
fZQg9veL7Dd/Z04ZTjC+wQ: calls $0.25
*** RIVER *** [2h 9c 4d Td] [3c]
fZQg9veL7Dd/Z04ZTjC+wQ: checks 
5xjU9nfIjn1MBxIJKZvS5w: bets $0.50
fZQg9veL7Dd/Z04ZTjC+wQ: calls $0.50
*** SHOW DOWN ***
5xjU9nfIjn1MBxIJKZvS5w: shows [Ts Jc] (a pair of Tens)
fZQg9veL7Dd/Z04ZTjC+wQ: mucks hand 
5xjU9nfIjn1MBxIJKZvS5w collected $2 from pot
*** SUMMARY ***
Total pot $2.10 | Rake $0.10 
Board [2h 9c 4d Td 3c]
Seat 1: fZQg9veL7Dd/Z04ZTjC+wQ (big blind) mucked
Seat 2: PIOdknsVyjKUwfiImc3zwg folded before Flop (didn't bet)
Seat 3: I1TxPvWj8NfG8orglCinNA folded before Flop (didn't bet)
Seat 4: 5xjU9nfIjn1MBxIJKZvS5w (button) showed [Ts Jc] and won ($2) with a pair of Tens
Seat 6: FPlQHZog0ePFCETQ2KG4hQ (small blind) folded before Flop




PokerStars Game #59939338896:  Hold'em No Limit ($0.10/$0.25) - 2009/07/01 0:37:19 ET
Table 'eOXPe2c6mG7DOFKvMsZZfA' 6-max Seat #6 is the button
Seat 2: ELW+DKizJhLK7k40PMkD2Q ($32.85 in chips) 
Seat 3: kReyZ6g6Fu3tQ0nyjDf9kA ($14.85 in chips) 
Seat 6: wKFJ513ucluNNiMlkXcDOQ ($40.90 in chips) 
ELW+DKizJhLK7k40PMkD2Q: posts small blind $0.10
kReyZ6g6Fu3tQ0nyjDf9kA: posts big blind $0.25
NhUN/JpAprdJeamFBgJH1w: sits out 
*** HOLE CARDS ***
wKFJ513ucluNNiMlkXcDOQ: raises $0.75 to $1
ELW+DKizJhLK7k40PMkD2Q: folds 
kReyZ6g6Fu3tQ0nyjDf9kA: calls $0.75
*** FLOP *** [6d Kh 8c]
kReyZ6g6Fu3tQ0nyjDf9kA: checks 
wKFJ513ucluNNiMlkXcDOQ: bets $1.25
kReyZ6g6Fu3tQ0nyjDf9kA: folds 
Uncalled bet ($1.25) returned to wKFJ513ucluNNiMlkXcDOQ
wKFJ513ucluNNiMlkXcDOQ collected $2 from pot
wKFJ513ucluNNiMlkXcDOQ: doesn't show hand 
*** SUMMARY ***
Total pot $2.10 | Rake $0.10 
Board [6d Kh 8c]
Seat 2: ELW+DKizJhLK7k40PMkD2Q (small blind) folded before Flop
Seat 3: kReyZ6g6Fu3tQ0nyjDf9kA (big blind) folded on the Flop
Seat 6: wKFJ513ucluNNiMlkXcDOQ (button) collected ($2)




PokerStars Game #59939338342:  Hold'em No Limit ($0.10/$0.25) - 2009/07/01 0:37:19 ET
Table 'O6cwjhrMn9pfzx1Ngn5zkQ' 6-max Seat #4 is the button
Seat 1: k4mJ9nD/YOVTl8/kGW+U6w ($14.30 in chips) 
Seat 2: M6xK/VklCvdyyrmvzATlxQ ($13.30 in chips) 
Seat 3: EE16Ua5b1HSsYej5zeXOlA ($25 in chips) 
Seat 4: wKFJ513ucluNNiMlkXcDOQ ($30.50 in chips) 
Seat 5: niLn0xUVlqh8If80xRjzCA ($21.05 in chips) 
Seat 6: d0J1xuhsynEY81YHwAvJ5g ($28.40 in chips) 
niLn0xUVlqh8If80xRjzCA: posts small blind $0.10
d0J1xuhsynEY81YHwAvJ5g: posts big blind $0.25
*** HOLE CARDS ***
k4mJ9nD/YOVTl8/kGW+U6w: calls $0.25
M6xK/VklCvdyyrmvzATlxQ: folds 
EE16Ua5b1HSsYej5zeXOlA: raises $1 to $1.25
wKFJ513ucluNNiMlkXcDOQ: folds 
niLn0xUVlqh8If80xRjzCA: calls $1.15
d0J1xuhsynEY81YHwAvJ5g: calls $1
k4mJ9nD/YOVTl8/kGW+U6w: folds 
*** FLOP *** [9d Tc Ks]
niLn0xUVlqh8If80xRjzCA: bets $1.50
d0J1xuhsynEY81YHwAvJ5g: folds 
EE16Ua5b1HSsYej5zeXOlA: calls $1.50
*** TURN *** [9d Tc Ks] [6c]
niLn0xUVlqh8If80xRjzCA: bets $3
EE16Ua5b1HSsYej5zeXOlA: folds 
Uncalled bet ($3) returned to niLn0xUVlqh8If80xRjzCA
niLn0xUVlqh8If80xRjzCA collected $6.70 from pot
niLn0xUVlqh8If80xRjzCA: doesn't show hand 
*** SUMMARY ***
Total pot $7 | Rake $0.30 
Board [9d Tc Ks 6c]
Seat 1: k4mJ9nD/YOVTl8/kGW+U6w folded before Flop
Seat 2: M6xK/VklCvdyyrmvzATlxQ folded before Flop (didn't bet)
Seat 3: EE16Ua5b1HSsYej5zeXOlA folded on the Turn
Seat 4: wKFJ513ucluNNiMlkXcDOQ (button) folded before Flop (didn't bet)
Seat 5: niLn0xUVlqh8If80xRjzCA (small blind) collected ($6.70)
Seat 6: d0J1xuhsynEY81YHwAvJ5g (big blind) folded on the Flop




PokerStars Game #59939338740:  Hold'em No Limit ($0.10/$0.25) - 2009/07/01 0:37:19 ET
Table '9HJEqVOjSU5ECoVB4C4sgQ' 6-max Seat #3 is the button
Seat 1: EyMmRrAOlNpDOWLqSYRZdw ($26.25 in chips) 
Seat 2: sEQx9G5Cu8k1HNdQasxvUA ($34.85 in chips) 
Seat 3: KM6ogk7SqyRlk3m9b0h+7A ($12.25 in chips) 
Seat 4: mfrkWA3PTeYPkbO6hi98Aw ($34.50 in chips) 
Seat 5: memV5jkoAdGrnRy3Q9PM7w ($25.40 in chips) 
Seat 6: aOMbOQ6Ji1Gie6dYOurd5A ($18.35 in chips) 
mfrkWA3PTeYPkbO6hi98Aw: posts small blind $0.10
memV5jkoAdGrnRy3Q9PM7w: posts big blind $0.25
*** HOLE CARDS ***
aOMbOQ6Ji1Gie6dYOurd5A: calls $0.25
EyMmRrAOlNpDOWLqSYRZdw: folds 
sEQx9G5Cu8k1HNdQasxvUA: raises $0.75 to $1
KM6ogk7SqyRlk3m9b0h+7A: folds 
mfrkWA3PTeYPkbO6hi98Aw: folds 
memV5jkoAdGrnRy3Q9PM7w: folds 
aOMbOQ6Ji1Gie6dYOurd5A: calls $0.75
*** FLOP *** [8s 5c 7h]
memV5jkoAdGrnRy3Q9PM7w leaves the table
aOMbOQ6Ji1Gie6dYOurd5A: checks 
sEQx9G5Cu8k1HNdQasxvUA: bets $1.50
aOMbOQ6Ji1Gie6dYOurd5A: folds 
Uncalled bet ($1.50) returned to sEQx9G5Cu8k1HNdQasxvUA
sEQx9G5Cu8k1HNdQasxvUA collected $2.25 from pot
sEQx9G5Cu8k1HNdQasxvUA: doesn't show hand 
*** SUMMARY ***
Total pot $2.35 | Rake $0.10 
Board [8s 5c 7h]
Seat 1: EyMmRrAOlNpDOWLqSYRZdw folded before Flop (didn't bet)
Seat 2: sEQx9G5Cu8k1HNdQasxvUA collected ($2.25)
Seat 3: KM6ogk7SqyRlk3m9b0h+7A (button) folded before Flop (didn't bet)
Seat 4: mfrkWA3PTeYPkbO6hi98Aw (small blind) folded before Flop
Seat 5: memV5jkoAdGrnRy3Q9PM7w (big blind) folded before Flop
Seat 6: aOMbOQ6Ji1Gie6dYOurd5A folded on the Flop




PokerStars Game #59939338800:  Hold'em No Limit ($0.10/$0.25) - 2009/07/01 0:37:19 ET
Table 'WY+lMaAoIdBZmwk27/RJCA' 6-max Seat #2 is the button
Seat 1: lYjWCpfCxX2kgcHY3v4Yow ($25 in chips) 
Seat 2: cPO/1/dTcZpLkQFm3jH3Rg ($25.05 in chips) 
Seat 3: 79Q62AM0VB++TQYiBlOYsA ($38.30 in chips) 
Seat 4: cGfAi40F+9odP4v0stvfiQ ($27.45 in chips) 
Seat 5: wKFJ513ucluNNiMlkXcDOQ ($29.70 in chips) 
Seat 6: I1TxPvWj8NfG8orglCinNA ($25.70 in chips) 
79Q62AM0VB++TQYiBlOYsA: posts small blind $0.10
cGfAi40F+9odP4v0stvfiQ: posts big blind $0.25
*** HOLE CARDS ***
wKFJ513ucluNNiMlkXcDOQ: folds 
I1TxPvWj8NfG8orglCinNA: folds 
lYjWCpfCxX2kgcHY3v4Yow: folds 
cPO/1/dTcZpLkQFm3jH3Rg: folds 
79Q62AM0VB++TQYiBlOYsA: calls $0.15
cGfAi40F+9odP4v0stvfiQ: checks 
*** FLOP *** [Kd 7c 3c]
79Q62AM0VB++TQYiBlOYsA: checks 
cGfAi40F+9odP4v0stvfiQ: bets $0.75
79Q62AM0VB++TQYiBlOYsA: folds 
Uncalled bet ($0.75) returned to cGfAi40F+9odP4v0stvfiQ
cGfAi40F+9odP4v0stvfiQ collected $0.50 from pot
cGfAi40F+9odP4v0stvfiQ: doesn't show hand 
*** SUMMARY ***
Total pot $0.50 | Rake $0 
Board [Kd 7c 3c]
Seat 1: lYjWCpfCxX2kgcHY3v4Yow folded before Flop (didn't bet)
Seat 2: cPO/1/dTcZpLkQFm3jH3Rg (button) folded before Flop (didn't bet)
Seat 3: 79Q62AM0VB++TQYiBlOYsA (small blind) folded on the Flop
Seat 4: cGfAi40F+9odP4v0stvfiQ (big blind) collected ($0.50)
Seat 5: wKFJ513ucluNNiMlkXcDOQ folded before Flop (didn't bet)
Seat 6: I1TxPvWj8NfG8orglCinNA folded before Flop (didn't bet)




PokerStars Game #59939338808:  Hold'em No Limit ($0.10/$0.25) - 2009/07/01 0:37:19 ET
Table '6aL2C8IFwHHr6SG6RgXaow' 9-max Seat #8 is the button
Seat 1: Sjvu/AyhGzlfEB01PPkxSw ($1 in chips) 
Seat 2: +gMmKt3DaQng9M42CmxIZg ($24.65 in chips) 
Seat 6: HxDF4QSxC4z39D7teZpprQ ($34.65 in chips) 
Seat 7: rPToQDbLWB+dKnz7fcQSIg ($10.40 in chips) 
Seat 8: rQhYIYXSyH/IivYM1dlV5A ($12.75 in chips) 
Seat 9: yduPKWPzL8YlT5Zv/Nmrwg ($16.40 in chips) 
yduPKWPzL8YlT5Zv/Nmrwg: posts small blind $0.10
Sjvu/AyhGzlfEB01PPkxSw: posts big blind $0.25
wre31HfyzQGpIvID1istxw: sits out 
*** HOLE CARDS ***
+gMmKt3DaQng9M42CmxIZg: folds 
HxDF4QSxC4z39D7teZpprQ: calls $0.25
rPToQDbLWB+dKnz7fcQSIg: folds 
rQhYIYXSyH/IivYM1dlV5A: raises $0.50 to $0.75
yduPKWPzL8YlT5Zv/Nmrwg: calls $0.65
Sjvu/AyhGzlfEB01PPkxSw: folds 
HxDF4QSxC4z39D7teZpprQ: calls $0.50
*** FLOP *** [Jd 3h 4d]
Sjvu/AyhGzlfEB01PPkxSw leaves the table
yduPKWPzL8YlT5Zv/Nmrwg: checks 
HxDF4QSxC4z39D7teZpprQ: checks 
rQhYIYXSyH/IivYM1dlV5A: bets $2
yduPKWPzL8YlT5Zv/Nmrwg: folds 
HxDF4QSxC4z39D7teZpprQ: folds 
Uncalled bet ($2) returned to rQhYIYXSyH/IivYM1dlV5A
rQhYIYXSyH/IivYM1dlV5A collected $2.40 from pot
*** SUMMARY ***
Total pot $2.50 | Rake $0.10 
Board [Jd 3h 4d]
Seat 1: Sjvu/AyhGzlfEB01PPkxSw (big blind) folded before Flop
Seat 2: +gMmKt3DaQng9M42CmxIZg folded before Flop (didn't bet)
Seat 6: HxDF4QSxC4z39D7teZpprQ folded on the Flop
Seat 7: rPToQDbLWB+dKnz7fcQSIg folded before Flop (didn't bet)
Seat 8: rQhYIYXSyH/IivYM1dlV5A (button) collected ($2.40)
Seat 9: yduPKWPzL8YlT5Zv/Nmrwg (small blind) folded on the Flop




PokerStars Game #59939338346:  Hold'em No Limit ($0.10/$0.25) - 2009/07/01 0:37:19 ET
Table 'nRFAYu63wZNzrz/OBgzFTw' 9-max Seat #3 is the button
Seat 2: hJ4uYjNmSZdjrKA8cjZqCA ($20.70 in chips) 
Seat 3: EfRs3ibIxn+c9JDErwwNCg ($25.25 in chips) 
Seat 4: OiV1PWZ3IkN29JlmCcnTwQ ($5 in chips) 
Seat 5: vKdukiQ4ktU4yJ0Xx3MKnA ($15 in chips) 
Seat 6: DnDcAdn9P0zGovMERigpFA ($25.25 in chips) 
Seat 7: COsrwJSFHQtxlUcrYtDQPQ ($26.95 in chips) 
Seat 8: rhWCqDS9OBh/IoXY29BGMw ($19.55 in chips) 
Seat 9: SXqVW4Q0evTUVZG6BbUNIA ($33.50 in chips) 
OiV1PWZ3IkN29JlmCcnTwQ: posts small blind $0.10
vKdukiQ4ktU4yJ0Xx3MKnA: posts big blind $0.25
N6fYvIzQLKaydFLKQGtMlQ: sits out 
*** HOLE CARDS ***
DnDcAdn9P0zGovMERigpFA: folds 
COsrwJSFHQtxlUcrYtDQPQ: folds 
rhWCqDS9OBh/IoXY29BGMw: folds 
SXqVW4Q0evTUVZG6BbUNIA: folds 
hJ4uYjNmSZdjrKA8cjZqCA: calls $0.25
EfRs3ibIxn+c9JDErwwNCg: raises $0.75 to $1
OiV1PWZ3IkN29JlmCcnTwQ: folds 
vKdukiQ4ktU4yJ0Xx3MKnA: calls $0.75
hJ4uYjNmSZdjrKA8cjZqCA: folds 
*** FLOP *** [7d 5d 2h]
vKdukiQ4ktU4yJ0Xx3MKnA: checks 
EfRs3ibIxn+c9JDErwwNCg: bets $1.25
vKdukiQ4ktU4yJ0Xx3MKnA: raises $3 to $4.25
EfRs3ibIxn+c9JDErwwNCg: calls $3
*** TURN *** [7d 5d 2h] [6c]
vKdukiQ4ktU4yJ0Xx3MKnA: bets $9.75 and is all-in
EfRs3ibIxn+c9JDErwwNCg: calls $9.75
*** RIVER *** [7d 5d 2h 6c] [Ac]
*** SHOW DOWN ***
vKdukiQ4ktU4yJ0Xx3MKnA: shows [5s 7s] (two pair, Sevens and Fives)
EfRs3ibIxn+c9JDErwwNCg: mucks hand 
vKdukiQ4ktU4yJ0Xx3MKnA collected $28.90 from pot
*** SUMMARY ***
Total pot $30.35 | Rake $1.45 
Board [7d 5d 2h 6c Ac]
Seat 2: hJ4uYjNmSZdjrKA8cjZqCA folded before Flop
Seat 3: EfRs3ibIxn+c9JDErwwNCg (button) mucked
Seat 4: OiV1PWZ3IkN29JlmCcnTwQ (small blind) folded before Flop
Seat 5: vKdukiQ4ktU4yJ0Xx3MKnA (big blind) showed [5s 7s] and won ($28.90) with two pair, Sevens and Fives
Seat 6: DnDcAdn9P0zGovMERigpFA folded before Flop (didn't bet)
Seat 7: COsrwJSFHQtxlUcrYtDQPQ folded before Flop (didn't bet)
Seat 8: rhWCqDS9OBh/IoXY29BGMw folded before Flop (didn't bet)
Seat 9: SXqVW4Q0evTUVZG6BbUNIA folded before Flop (didn't bet)




PokerStars Game #59939338770:  Hold'em No Limit ($0.10/$0.25) - 2009/07/01 0:37:19 ET
Table '3lS+sU5k6mwJCS2nFMmQ6Q' 9-max Seat #2 is the button
Seat 1: VWUWpMLMj/Q1jRVpF7Aohw ($13 in chips) 
Seat 2: 4oA316mXLIui1QY63GXBUg ($25.75 in chips) 
Seat 3: 1DXccE2UUK5DIRVGlOKnTA ($9.75 in chips) 
Seat 4: 8B/dhbQjIWe6ASCdgzktNQ ($44.75 in chips) 
Seat 5: H9KUl8cmpLgEpOVDA00bCg ($7.50 in chips) 
Seat 6: hJ4uYjNmSZdjrKA8cjZqCA ($20.10 in chips) 
Seat 8: SXqVW4Q0evTUVZG6BbUNIA ($21.85 in chips) 
Seat 9: 4awUyiDYTgylQKXZ9faBVA ($35.40 in chips) 
1DXccE2UUK5DIRVGlOKnTA: posts small blind $0.10
8B/dhbQjIWe6ASCdgzktNQ: posts big blind $0.25
Th3FldXKQW6hWVVPahaoOQ: sits out 
*** HOLE CARDS ***
H9KUl8cmpLgEpOVDA00bCg: folds 
hJ4uYjNmSZdjrKA8cjZqCA: folds 
H9KUl8cmpLgEpOVDA00bCg leaves the table
SXqVW4Q0evTUVZG6BbUNIA: folds 
4awUyiDYTgylQKXZ9faBVA: folds 
VWUWpMLMj/Q1jRVpF7Aohw: folds 
4oA316mXLIui1QY63GXBUg: folds 
1DXccE2UUK5DIRVGlOKnTA: calls $0.15
8B/dhbQjIWe6ASCdgzktNQ: checks 
*** FLOP *** [Jh 2s 3s]
1DXccE2UUK5DIRVGlOKnTA: checks 
8B/dhbQjIWe6ASCdgzktNQ: checks 
*** TURN *** [Jh 2s 3s] [4s]
LuckyShot



PokerStars Game #59939339540:  Hold'em No Limit ($0.10/$0.25) - 2009/07/01 0:37:20 ET
Table 'fHv1Mk7ZbLjprZTGWKPiEQ' 6-max Seat #6 is the button
Seat 1: nrBtxp+MnBtUJ1AIhZxHkg ($27.65 in chips) 
Seat 3: HyeBXe7tNOZjTdX/zI0BZQ ($14.75 in chips) 
Seat 4: TSmua8tGK3sTbwi0ynrW9Q ($50.50 in chips) 
Seat 6: AjG0X+rNtc2W08eph8oqpw ($9.30 in chips) 
nrBtxp+MnBtUJ1AIhZxHkg: posts small blind $0.10
HyeBXe7tNOZjTdX/zI0BZQ: posts big blind $0.25
*** HOLE CARDS ***
TSmua8tGK3sTbwi0ynrW9Q: raises $0.75 to $1
AjG0X+rNtc2W08eph8oqpw: folds 
nrBtxp+MnBtUJ1AIhZxHkg: calls $0.90
HyeBXe7tNOZjTdX/zI0BZQ: folds 
*** FLOP *** [6c 9s 5c]
nrBtxp+MnBtUJ1AIhZxHkg: checks 
TSmua8tGK3sTbwi0ynrW9Q: bets $1.50
nrBtxp+MnBtUJ1AIhZxHkg: calls $1.50
*** TURN *** [6c 9s 5c] [9d]
nrBtxp+MnBtUJ1AIhZxHkg: checks 
TSmua8tGK3sTbwi0ynrW9Q: checks 
*** RIVER *** [6c 9s 5c 9d] [Kh]
edio/rLJ06xeZOfLhoL3UA joins the table at seat #5 
nrBtxp+MnBtUJ1AIhZxHkg: bets $1
TSmua8tGK3sTbwi0ynrW9Q: calls $1
*** SHOW DOWN ***
nrBtxp+MnBtUJ1AIhZxHkg: shows [7d Kd] (two pair, Kings and Nines)
TSmua8tGK3sTbwi0ynrW9Q: mucks hand 
nrBtxp+MnBtUJ1AIhZxHkg collected $6.90 from pot
*** SUMMARY ***
Total pot $7.25 | Rake $0.35 
Board [6c 9s 5c 9d Kh]
Seat 1: nrBtxp+MnBtUJ1AIhZxHkg (small blind) showed [7d Kd] and won ($6.90) with two pair, Kings and Nines
Seat 3: HyeBXe7tNOZjTdX/zI0BZQ (big blind) folded before Flop
Seat 4: TSmua8tGK3sTbwi0ynrW9Q mucked
Seat 6: AjG0X+rNtc2W08eph8oqpw (button) folded before Flop (didn't bet)




PokerStars Game #59939339456:  Hold'em No Limit ($0.10/$0.25) - 2009/07/01 0:37:20 ET
Table 'K/f0NNaoGuhSz5DrzgVw7Q' 9-max Seat #3 is the button
Seat 1: hPhp/RE3cJ5YGaQ2xOHXXg ($10.45 in chips) 
Seat 2: 18G4P1XstjNvItdGUITxgw ($25 in chips) 
Seat 3: VBHxUExRAMrbxUq/cVx9Gw ($5.25 in chips) 
Seat 4: 3L1qKVpA6QZjrddTpoh2zQ ($12.65 in chips) 
Seat 5: DnDcAdn9P0zGovMERigpFA ($25 in chips) 
Seat 6: 3PVK0IdMlq2fElkVzzr4bg ($19.25 in chips) 
Seat 7: st9jtdNbm1W5GfBwRaCVqQ ($22.80 in chips) 
Seat 8: E0iYnEVO2ho7dH3QcCjw7g ($17.30 in chips) 
Seat 9: B5Xu8WsfFPfBlsK3fbAtQQ ($12.45 in chips) 
3L1qKVpA6QZjrddTpoh2zQ: posts small blind $0.10
DnDcAdn9P0zGovMERigpFA: posts big blind $0.25
*** HOLE CARDS ***
3PVK0IdMlq2fElkVzzr4bg: calls $0.25
st9jtdNbm1W5GfBwRaCVqQ: folds 
E0iYnEVO2ho7dH3QcCjw7g: folds 
B5Xu8WsfFPfBlsK3fbAtQQ: folds 
hPhp/RE3cJ5YGaQ2xOHXXg has timed out
hPhp/RE3cJ5YGaQ2xOHXXg: folds 
hPhp/RE3cJ5YGaQ2xOHXXg is sitting out
18G4P1XstjNvItdGUITxgw: folds 
VBHxUExRAMrbxUq/cVx9Gw: folds 
3L1qKVpA6QZjrddTpoh2zQ: calls $0.15
DnDcAdn9P0zGovMERigpFA: checks 
*** FLOP *** [Ah 5s 8d]
3L1qKVpA6QZjrddTpoh2zQ: checks 
DnDcAdn9P0zGovMERigpFA: bets $0.50
3PVK0IdMlq2fElkVzzr4bg: folds 
3L1qKVpA6QZjrddTpoh2zQ: folds 
Uncalled bet ($0.50) returned to DnDcAdn9P0zGovMERigpFA
DnDcAdn9P0zGovMERigpFA collected $0.75 from pot
DnDcAdn9P0zGovMERigpFA: doesn't show hand 
*** SUMMARY ***
Total pot $0.75 | Rake $0 
Board [Ah 5s 8d]
Seat 1: hPhp/RE3cJ5YGaQ2xOHXXg folded before Flop (didn't bet)
Seat 2: 18G4P1XstjNvItdGUITxgw folded before Flop (didn't bet)
Seat 3: VBHxUExRAMrbxUq/cVx9Gw (button) folded before Flop (didn't bet)
Seat 4: 3L1qKVpA6QZjrddTpoh2zQ (small blind) folded on the Flop
Seat 5: DnDcAdn9P0zGovMERigpFA (big blind) collected ($0.75)
Seat 6: 3PVK0IdMlq2fElkVzzr4bg folded on the Flop
Seat 7: st9jtdNbm1W5GfBwRaCVqQ folded before Flop (didn't bet)
Seat 8: E0iYnEVO2ho7dH3QcCjw7g folded before Flop (didn't bet)
Seat 9: B5Xu8WsfFPfBlsK3fbAtQQ folded before Flop (didn't bet)




PokerStars Game #59939339620:  Hold'em No Limit ($0.10/$0.25) - 2009/07/01 0:37:20 ET
Table '3lL16FBjWXTx3AjK5lMRwwgkdjhbH1jaE3hwhPRIKMiQx Seat #7 is the button
Seat 1: fDGyaQz0cs2s4FOYxkbIHA ($8.15 in chips) 
Seat 2: YK2fIgjF+Z0ARwKKcGh1fw ($17.30 in chips) 
Seat 3: QEbIGci+itdw+re8RM5fZA ($26.25 in chips) 
Seat 4: ZWU9RNYtjmm4cElg1I0F4w ($61.95 in chips) 
Seat 5: M/9j4wkHH9i1JM51vgi1VA ($24.30 in chips) 
Seat 6: hBMUlEpyU74r/fwDgIpXjQ ($38.75 in chips) 
Seat 7: JxpnpCmvRAcrEUy7mq1iAg ($5.40 in chips) 
Seat 8: ljemhp25Zg+nlA9DLCIiUw ($24.40 in chips) 
Seat 9: b8t3jWrxzeEt9HtZtc9wUQ ($10.60 in chips) 
ljemhp25Zg+nlA9DLCIiUw: posts small blind $0.10
b8t3jWrxzeEt9HtZtc9wUQ: posts big blind $0.25
*** HOLE CARDS ***
fDGyaQz0cs2s4FOYxkbIHA: folds 
YK2fIgjF+Z0ARwKKcGh1fw: folds 
QEbIGci+itdw+re8RM5fZA: folds 
ZWU9RNYtjmm4cElg1I0F4w: folds 
M/9j4wkHH9i1JM51vgi1VA: calls $0.25
hBMUlEpyU74r/fwDgIpXjQ: raises $0.75 to $1
JxpnpCmvRAcrEUy7mq1iAg: folds 
ljemhp25Zg+nlA9DLCIiUw: folds 
b8t3jWrxzeEt9HtZtc9wUQ: folds 
M/9j4wkHH9i1JM51vgi1VA: calls $0.75
*** FLOP *** [4d 2h Qs]
M/9j4wkHH9i1JM51vgi1VA: checks 
hBMUlEpyU74r/fwDgIpXjQ: bets $1.50
M/9j4wkHH9i1JM51vgi1VA: calls $1.50
*** TURN *** [4d 2h Qs] [Tc]
M/9j4wkHH9i1JM51vgi1VA: checks 
hBMUlEpyU74r/fwDgIpXjQ: checks 
*** RIVER *** [4d 2h Qs Tc] [Jh]
M/9j4wkHH9i1JM51vgi1VA: checks 
hBMUlEpyU74r/fwDgIpXjQ: checks 
*** SHOW DOWN ***
M/9j4wkHH9i1JM51vgi1VA: shows [4s 5s] (a pair of Fours)
hBMUlEpyU74r/fwDgIpXjQ: shows [8s 8c] (a pair of Eights)
hBMUlEpyU74r/fwDgIpXjQ collected $5.10 from pot
*** SUMMARY ***
Total pot $5.35 | Rake $0.25 
Board [4d 2h Qs Tc Jh]
Seat 1: fDGyaQz0cs2s4FOYxkbIHA folded before Flop (didn't bet)
Seat 2: YK2fIgjF+Z0ARwKKcGh1fw folded before Flop (didn't bet)
Seat 3: QEbIGci+itdw+re8RM5fZA folded before Flop (didn't bet)
Seat 4: ZWU9RNYtjmm4cElg1I0F4w folded before Flop (didn't bet)
Seat 5: M/9j4wkHH9i1JM51vgi1VA showed [4s 5s] and lost with a pair of Fours
Seat 6: hBMUlEpyU74r/fwDgIpXjQ showed [8s 8c] and won ($5.10) with a pair of Eights
Seat 7: JxpnpCmvRAcrEUy7mq1iAg (button) folded before Flop (didn't bet)
Seat 8: ljemhp25Zg+nlA9DLCIiUw (small blind) folded before Flop
Seat 9: b8t3jWrxzeEt9HtZtc9wUQ (big blind) folded before Flop




PokerStars Game #59939338964:  Hold'em No Limit ($0.10/$0.25) - 2009/07/01 0:37:20 ET
Table '5VWnrlxdjwVfMWkVS2WE7A' 6-max Seat #6 is the button
Seat 1: BiLBinPhgpKAYzLgKJVU5A ($19.95 in chips) 
Seat 2: ELW+DKizJhLK7k40PMkD2Q ($25 in chips) 
Seat 3: cPO/1/dTcZpLkQFm3jH3Rg ($25.25 in chips) 
Seat 4: WZv4aSGl7ETtI/Z5BPKi7w ($35.10 in chips) 
Seat 5: JQZew0FjzS19kTjeNtrE+A ($41.30 in chips) 
Seat 6: LtASJ9OlkqGrrUKGQlpGAw ($20.75 in chips) 
BiLBinPhgpKAYzLgKJVU5A: posts small blind $0.10
ELW+DKizJhLK7k40PMkD2Q: posts big blind $0.25
*** HOLE CARDS ***
cPO/1/dTcZpLkQFm3jH3Rg: folds 
WZv4aSGl7ETtI/Z5BPKi7w: folds 
JQZew0FjzS19kTjeNtrE+A: calls $0.25
LtASJ9OlkqGrrUKGQlpGAw: folds 
BiLBinPhgpKAYzLgKJVU5A: raises $0.50 to $0.75
ELW+DKizJhLK7k40PMkD2Q: folds 
JQZew0FjzS19kTjeNtrE+A: calls $0.50
*** FLOP *** [2s 5c 5d]
BiLBinPhgpKAYzLgKJVU5A: bets $1.25
JQZew0FjzS19kTjeNtrE+A: folds 
Uncalled bet ($1.25) returned to BiLBinPhgpKAYzLgKJVU5A
BiLBinPhgpKAYzLgKJVU5A collected $1.70 from pot
BiLBinPhgpKAYzLgKJVU5A: doesn't show hand 
*** SUMMARY ***
Total pot $1.75 | Rake $0.05 
Board [2s 5c 5d]
Seat 1: BiLBinPhgpKAYzLgKJVU5A (small blind) collected ($1.70)
Seat 2: ELW+DKizJhLK7k40PMkD2Q (big blind) folded before Flop
Seat 3: cPO/1/dTcZpLkQFm3jH3Rg folded before Flop (didn't bet)
Seat 4: WZv4aSGl7ETtI/Z5BPKi7w folded before Flop (didn't bet)
Seat 5: JQZew0FjzS19kTjeNtrE+A folded on the Flop
Seat 6: LtASJ9OlkqGrrUKGQlpGAw (button) folded before Flop (didn't bet)




PokerStars Game #59939339426:  Hold'em No Limit ($0.10/$0.25) - 2009/07/01 0:37:20 ET
Table 'QegsWX65l3n/K0A8XB78yg' 6-max Seat #5 is the button
Seat 1: 8ClCHtFXGNplITm+63KB+Q ($29.65 in chips) 
Seat 2: GC/9yVD59DUCX7hUI7gcLw ($28.70 in chips) 
Seat 3: 9jSiy0meE9XJKkdIZwyTEQ ($25 in chips) 
Seat 4: kyRaCIljYA6l33lSKQfNsg ($25 in chips) 
Seat 5: 4YSTu0Cdzpppe1lUgCZGCQ ($57.45 in chips) 
Seat 6: JE/wJXmjw3bpdmjwvh2pcg ($39.40 in chips) 
JE/wJXmjw3bpdmjwvh2pcg: posts small blind $0.10
8ClCHtFXGNplITm+63KB+Q: posts big blind $0.25
*** HOLE CARDS ***
GC/9yVD59DUCX7hUI7gcLw: folds 
9jSiy0meE9XJKkdIZwyTEQ: folds 
kyRaCIljYA6l33lSKQfNsg: folds 
4YSTu0Cdzpppe1lUgCZGCQ: raises $0.75 to $1
JE/wJXmjw3bpdmjwvh2pcg: calls $0.90
8ClCHtFXGNplITm+63KB+Q: folds 
*** FLOP *** [4h 5d 4c]
JE/wJXmjw3bpdmjwvh2pcg: checks 
4YSTu0Cdzpppe1lUgCZGCQ: bets $1.25
JE/wJXmjw3bpdmjwvh2pcg: calls $1.25
*** TURN *** [4h 5d 4c] [As]
JE/wJXmjw3bpdmjwvh2pcg: checks 
4YSTu0Cdzpppe1lUgCZGCQ: bets $2.75
JE/wJXmjw3bpdmjwvh2pcg: folds 
Uncalled bet ($2.75) returned to 4YSTu0Cdzpppe1lUgCZGCQ
4YSTu0Cdzpppe1lUgCZGCQ collected $4.55 from pot
4YSTu0Cdzpppe1lUgCZGCQ: doesn't show hand 
*** SUMMARY ***
Total pot $4.75 | Rake $0.20 
Board [4h 5d 4c As]
Seat 1: 8ClCHtFXGNplITm+63KB+Q (big blind) folded before Flop
Seat 2: GC/9yVD59DUCX7hUI7gcLw folded before Flop (didn't bet)
Seat 3: 9jSiy0meE9XJKkdIZwyTEQ folded before Flop (didn't bet)
Seat 4: kyRaCIljYA6l33lSKQfNsg folded before Flop (didn't bet)
Seat 5: 4YSTu0Cdzpppe1lUgCZGCQ (button) collected ($4.55)
Seat 6: JE/wJXmjw3bpdmjwvh2pcg (small blind) folded on the Turn




PokerStars Game #59939339436:  Hold'em No Limit ($0.10/$0.25) - 2009/07/01 0:37:20 ET
Table '9iHhO6FyZVM8XpSc23TIgg' 6-max Seat #4 is the button
Seat 2: ErIN0JRL5srYjT6en1f8YQ ($23.85 in chips) 
Seat 3: EXTSABh+qTpWWrIkxl3wXg ($44 in chips) 
Seat 4: cfJccEfyn6IkquPN08hFsA ($33.55 in chips) 
Seat 5: WmfI+HZXhME/HMG8E3/H2w ($15.50 in chips) 
Seat 6: 5z4PIVM9IyDWfUi+/MMdTA ($24.30 in chips) 
WmfI+HZXhME/HMG8E3/H2w: posts small blind $0.10
5z4PIVM9IyDWfUi+/MMdTA: posts big blind $0.25
NhUN/JpAprdJeamFBgJH1w: sits out 
*** HOLE CARDS ***
ErIN0JRL5srYjT6en1f8YQ: folds 
EXTSABh+qTpWWrIkxl3wXg: folds 
cfJccEfyn6IkquPN08hFsA: folds 
WmfI+HZXhME/HMG8E3/H2w: folds 
Uncalled bet ($0.15) returned to 5z4PIVM9IyDWfUi+/MMdTA
5z4PIVM9IyDWfUi+/MMdTA said, "i don't think soo eh"
5z4PIVM9IyDWfUi+/MMdTA collected $0.20 from pot
*** SUMMARY ***
Total pot $0.20 | Rake $0 
Seat 2: ErIN0JRL5srYjT6en1f8YQ folded before Flop (didn't bet)
Seat 3: EXTSABh+qTpWWrIkxl3wXg folded before Flop (didn't bet)
Seat 4: cfJccEfyn6IkquPN08hFsA (button) folded before Flop (didn't bet)
Seat 5: WmfI+HZXhME/HMG8E3/H2w (small blind) folded before Flop
Seat 6: 5z4PIVM9IyDWfUi+/MMdTA (big blind) collected ($0.20)




PokerStars Game #59939339428:  Hold'em No Limit ($0.10/$0.25) - 2009/07/01 0:37:20 ET
Table 'FE/j6VqBY4j9Uq+VHURQCQ' 6-max Seat #6 is the button
Seat 1: wKFJ513ucluNNiMlkXcDOQ ($42.85 in chips) 
Seat 2: gh0Jkra5bJ5RFIDWbx9zqA ($13.70 in chips) 
Seat 3: Zijzy/UtPWzWVUo81HHVjQ ($50.10 in chips) 
Seat 5: wsP46AGpqDjHZQmlRHKa9g ($25 in chips) 
Seat 6: kARKwAmU6kWJfiSICTYhVw ($14.35 in chips) 
wKFJ513ucluNNiMlkXcDOQ: posts small blind $0.10
gh0Jkra5bJ5RFIDWbx9zqA: posts big blind $0.25
*** HOLE CARDS ***
Zijzy/UtPWzWVUo81HHVjQ: folds 
wsP46AGpqDjHZQmlRHKa9g: folds 
kARKwAmU6kWJfiSICTYhVw: folds 
wKFJ513ucluNNiMlkXcDOQ: raises $0.75 to $1
gh0Jkra5bJ5RFIDWbx9zqA: calls $0.75
*** FLOP *** [Td 5c Kh]
Raimi77 leaves the table
wKFJ513ucluNNiMlkXcDOQ: bets $1.25
gh0Jkra5bJ5RFIDWbx9zqA: folds 
Uncalled bet ($1.25) returned to wKFJ513ucluNNiMlkXcDOQ
wKFJ513ucluNNiMlkXcDOQ collected $1.90 from pot
wKFJ513ucluNNiMlkXcDOQ: doesn't show hand 
*** SUMMARY ***
Total pot $2 | Rake $0.10 
Board [Td 5c Kh]
Seat 1: wKFJ513ucluNNiMlkXcDOQ (small blind) collected ($1.90)
Seat 2: gh0Jkra5bJ5RFIDWbx9zqA (big blind) folded on the Flop
Seat 3: Zijzy/UtPWzWVUo81HHVjQ folded before Flop (didn't bet)
Seat 5: wsP46AGpqDjHZQmlRHKa9g folded before Flop (didn't bet)
Seat 6: kARKwAmU6kWJfiSICTYhVw (button) folded before Flop (didn't bet)




PokerStars Game #59939339414:  Hold'em No Limit ($0.10/$0.25) - 2009/07/01 0:37:20 ET
Table '9L7XfAwuM7XsXE8LIg2o5Q' 6-max Seat #6 is the button
Seat 1: H6XbZVba2aKDXlG0la0uow ($8.40 in chips) 
Seat 2: oseFhpinoe+Zg4j5xyBjyQ ($6.75 in chips) 
Seat 3: 9StOHp+Y1T0K13JdgS2oQQ ($7.10 in chips) 
Seat 4: xBOVv8xEXtymVpAA5ZajSw ($82.50 in chips) 
Seat 6: k9nHZTHt8hYhYRcW8NTb4g ($29.45 in chips) 
H6XbZVba2aKDXlG0la0uow: posts small blind $0.10
oseFhpinoe+Zg4j5xyBjyQ: posts big blind $0.25
xBOVv8xEXtymVpAA5ZajSw: posts small & big blinds $0.35
*** HOLE CARDS ***
9StOHp+Y1T0K13JdgS2oQQ: folds 
xBOVv8xEXtymVpAA5ZajSw: checks 
k9nHZTHt8hYhYRcW8NTb4g: folds 
raina1977 joins the table at seat #5 
H6XbZVba2aKDXlG0la0uow: calls $0.15
oseFhpinoe+Zg4j5xyBjyQ: checks 
*** FLOP *** [As 7c Jd]
raina1977 is sitting out
H6XbZVba2aKDXlG0la0uow: checks 
oseFhpinoe+Zg4j5xyBjyQ: checks 
xBOVv8xEXtymVpAA5ZajSw: checks 
*** TURN *** [As 7c Jd] [5d]
H6XbZVba2aKDXlG0la0uow: bets $0.50
oseFhpinoe+Zg4j5xyBjyQ: folds 
xBOVv8xEXtymVpAA5ZajSw: folds 
Uncalled bet ($0.50) returned to H6XbZVba2aKDXlG0la0uow
H6XbZVba2aKDXlG0la0uow collected $0.85 from pot
H6XbZVba2aKDXlG0la0uow: doesn't show hand 
*** SUMMARY ***
Total pot $0.85 | Rake $0 
Board [As 7c Jd 5d]
Seat 1: H6XbZVba2aKDXlG0la0uow (small blind) collected ($0.85)
Seat 2: oseFhpinoe+Zg4j5xyBjyQ (big blind) folded on the Turn
Seat 3: 9StOHp+Y1T0K13JdgS2oQQ folded before Flop (didn't bet)
Seat 4: xBOVv8xEXtymVpAA5ZajSw folded on the Turn
Seat 6: k9nHZTHt8hYhYRcW8NTb4g (button) folded before Flop (didn't bet)




PokerStars Game #59939339286:  Hold'em No Limit ($0.10/$0.25) - 2009/07/01 0:37:20 ET
Table 'oJpFwZj9+FUGHX90Un8s9Q' 6-max Seat #2 is the button
Seat 2: IMmIhmfU3tqkaJABnD21Rg ($14.95 in chips) 
Seat 3: kyRaCIljYA6l33lSKQfNsg ($24.90 in chips) 
Seat 4: IX/nJvz3Mx/Ez6DgueFA4Q ($6.05 in chips) 
Seat 5: bFCQ8w9iGuXFtr1amBV30Q ($29 in chips) 
Seat 6: Zijzy/UtPWzWVUo81HHVjQ ($43.10 in chips) 
kyRaCIljYA6l33lSKQfNsg: posts small blind $0.10
IX/nJvz3Mx/Ez6DgueFA4Q: posts big blind $0.25
bkBfOBmBcZKg8k/zXu9rWQ: sits out 
*** HOLE CARDS ***
bFCQ8w9iGuXFtr1amBV30Q: folds 
Zijzy/UtPWzWVUo81HHVjQ: raises $0.50 to $0.75
IMmIhmfU3tqkaJABnD21Rg: folds 
kyRaCIljYA6l33lSKQfNsg: calls $0.65
IX/nJvz3Mx/Ez6DgueFA4Q: folds 
*** FLOP *** [4s 5h 6d]
kyRaCIljYA6l33lSKQfNsg: checks 
bFCQ8w9iGuXFtr1amBV30Q leaves the table
Zijzy/UtPWzWVUo81HHVjQ: bets $0.90
kyRaCIljYA6l33lSKQfNsg: raises $2.10 to $3
Zijzy/UtPWzWVUo81HHVjQ: folds 
Uncalled bet ($2.10) returned to kyRaCIljYA6l33lSKQfNsg
kyRaCIljYA6l33lSKQfNsg collected $3.40 from pot
*** SUMMARY ***
Total pot $3.55 | Rake $0.15 
Board [4s 5h 6d]
Seat 2: IMmIhmfU3tqkaJABnD21Rg (button) folded before Flop (didn't bet)
Seat 3: kyRaCIljYA6l33lSKQfNsg (small blind) collected ($3.40)
Seat 4: IX/nJvz3Mx/Ez6DgueFA4Q (big blind) folded before Flop
Seat 5: bFCQ8w9iGuXFtr1amBV30Q folded before Flop (didn't bet)
Seat 6: Zijzy/UtPWzWVUo81HHVjQ folded on the Flop




PokerStars Game #59939339238:  Hold'em No Limit ($0.10/$0.25) - 2009/07/01 0:37:20 ET
Table 'vZfV/Uj0q8joA1du9sRJSg' 6-max Seat #4 is the button
Seat 2: wMiE3yTbDJGOLOF9th7KPA ($13.20 in chips) 
Seat 3: QJ/0wT0pYdWbDuqo9eNJgQ ($5.40 in chips) 
Seat 4: v+QfkGiuj9bgtuNoVnDO8w ($25 in chips) 
Seat 5: FStoHe64SQWqAsjya9pDkQ ($25.35 in chips) 
Seat 6: 8ClCHtFXGNplITm+63KB+Q ($25.70 in chips) 
FStoHe64SQWqAsjya9pDkQ: posts small blind $0.10
8ClCHtFXGNplITm+63KB+Q: posts big blind $0.25
OAmGQMdOxnvuBNHdADx0ew is disconnected 
OAmGQMdOxnvuBNHdADx0ew is connected 
OAmGQMdOxnvuBNHdADx0ew: sits out 
*** HOLE CARDS ***
wMiE3yTbDJGOLOF9th7KPA: calls $0.25
QJ/0wT0pYdWbDuqo9eNJgQ: calls $0.25
v+QfkGiuj9bgtuNoVnDO8w: folds 
FStoHe64SQWqAsjya9pDkQ: folds 
8ClCHtFXGNplITm+63KB+Q: checks 
*** FLOP *** [9c Kd 6d]
8ClCHtFXGNplITm+63KB+Q: bets $0.50
wMiE3yTbDJGOLOF9th7KPA: folds 
QJ/0wT0pYdWbDuqo9eNJgQ: folds 
Uncalled bet ($0.50) returned to 8ClCHtFXGNplITm+63KB+Q
8ClCHtFXGNplITm+63KB+Q collected $0.85 from pot
8ClCHtFXGNplITm+63KB+Q: doesn't show hand 
*** SUMMARY ***
Total pot $0.85 | Rake $0 
Board [9c Kd 6d]
Seat 2: wMiE3yTbDJGOLOF9th7KPA folded on the Flop
Seat 3: QJ/0wT0pYdWbDuqo9eNJgQ folded on the Flop
Seat 4: v+QfkGiuj9bgtuNoVnDO8w (button) folded before Flop (didn't bet)
Seat 5: FStoHe64SQWqAsjya9pDkQ (small blind) folded before Flop
Seat 6: 8ClCHtFXGNplITm+63KB+Q (big blind) collected ($0.85)




PokerStars Game #59939339308:  Hold'em No Limit ($0.10/$0.25) - 2009/07/01 0:37:20 ET
Table 'AUM6O+mgQAaLDZKMQ/5/gA' 9-max Seat #5 is the button
Seat 1: Eyuoq9VsHg1Puw0nNzXTjg ($7.95 in chips) 
Seat 2: Z6wpvS2oSLLp92XbOQ7clQ ($10.35 in chips) 
Seat 3: 3m6VfX7io8SA31qh1zCkgQ ($9.30 in chips) 
Seat 4: GIv32m/KBYU5WdIHUImuIg ($6.10 in chips) 
Seat 5: +2kMBNpY4nF1qNCRd8SJLA ($25 in chips) 
Eyuoq9VsHg1Puw0nNzXTjg: posts small blind $0.10
Z6wpvS2oSLLp92XbOQ7clQ: posts big blind $0.25
GIv32m/KBYU5WdIHUImuIg: posts big blind $0.25
*** HOLE CARDS ***
3m6VfX7io8SA31qh1zCkgQ: folds 
GIv32m/KBYU5WdIHUImuIg: checks 
+2kMBNpY4nF1qNCRd8SJLA: folds 
Eyuoq9VsHg1Puw0nNzXTjg: calls $0.15
Z6wpvS2oSLLp92XbOQ7clQ: checks 
*** FLOP *** [7s 3s Tc]
Eyuoq9VsHg1Puw0nNzXTjg: checks 
Z6wpvS2oSLLp92XbOQ7clQ: checks 
GIv32m/KBYU5WdIHUImuIg: checks 
*** TURN *** [7s 3s Tc] [4d]
Eyuoq9VsHg1Puw0nNzXTjg: checks 
Z6wpvS2oSLLp92XbOQ7clQ: checks 
GIv32m/KBYU5WdIHUImuIg: checks 
*** RIVER *** [7s 3s Tc 4d] [Ks]
Eyuoq9VsHg1Puw0nNzXTjg: bets $0.75
Z6wpvS2oSLLp92XbOQ7clQ: folds 
GIv32m/KBYU5WdIHUImuIg: calls $0.75
*** SHOW DOWN ***
Eyuoq9VsHg1Puw0nNzXTjg: shows [Kd Qh] (a pair of Kings)
Z6wpvS2oSLLp92XbOQ7clQ leaves the table
GIv32m/KBYU5WdIHUImuIg: mucks hand 
Eyuoq9VsHg1Puw0nNzXTjg collected $2.15 from pot
*** SUMMARY ***
Total pot $2.25 | Rake $0.10 
Board [7s 3s Tc 4d Ks]
Seat 1: Eyuoq9VsHg1Puw0nNzXTjg (small blind) showed [Kd Qh] and won ($2.15) with a pair of Kings
Seat 2: Z6wpvS2oSLLp92XbOQ7clQ (big blind) folded on the River
Seat 3: 3m6VfX7io8SA31qh1zCkgQ folded before Flop (didn't bet)
Seat 4: GIv32m/KBYU5WdIHUImuIg mucked
Seat 5: +2kMBNpY4nF1qNCRd8SJLA (button) folded before Flop (didn't bet)




PokerStars Game #59939340210:  Hold'em No Limit ($0.10/$0.25) - 2009/07/01 0:37:21 ET
Table '2O5CgfSkSwrr4PDrlZ1RLQ' 6-max Seat #3 is the button
Seat 1: kyRaCIljYA6l33lSKQfNsg ($47.25 in chips) 
Seat 2: /gJNBeCkWL4o85/jvlZ4BA ($49.10 in chips) 
Seat 3: yzFNNFIfC89bBPwpFPx2ow ($25 in chips) 
Seat 4: 4x9jCqgSw4272dnaIqnanw ($5.20 in chips) 
Seat 5: AMrBn4Vx9aAo/vv6WHLk6w ($4.50 in chips) 
Seat 6: wqphQtauX5Qn7WRJZS1flA ($65.70 in chips) 
4x9jCqgSw4272dnaIqnanw: posts small blind $0.10
AMrBn4Vx9aAo/vv6WHLk6w: posts big blind $0.25
*** HOLE CARDS ***
wqphQtauX5Qn7WRJZS1flA: folds 
kyRaCIljYA6l33lSKQfNsg: folds 
/gJNBeCkWL4o85/jvlZ4BA: folds 
yzFNNFIfC89bBPwpFPx2ow: folds 
4x9jCqgSw4272dnaIqnanw: raises $4.95 to $5.20 and is all-in
AMrBn4Vx9aAo/vv6WHLk6w: calls $4.25 and is all-in
Uncalled bet ($0.70) returned to 4x9jCqgSw4272dnaIqnanw
*** FLOP *** [Td Jd 9d]
*** TURN *** [Td Jd 9d] [Ad]
*** RIVER *** [Td Jd 9d Ad] [6d]
*** SHOW DOWN ***
4x9jCqgSw4272dnaIqnanw: shows [7d Ah] (a flush, Ace high)
AMrBn4Vx9aAo/vv6WHLk6w: mucks hand 
4x9jCqgSw4272dnaIqnanw collected $8.55 from pot
*** SUMMARY ***
Total pot $9 | Rake $0.45 
Board [Td Jd 9d Ad 6d]
Seat 1: kyRaCIljYA6l33lSKQfNsg folded before Flop (didn't bet)
Seat 2: /gJNBeCkWL4o85/jvlZ4BA folded before Flop (didn't bet)
Seat 3: yzFNNFIfC89bBPwpFPx2ow (button) folded before Flop (didn't bet)
Seat 4: 4x9jCqgSw4272dnaIqnanw (small blind) showed [7d Ah] and won ($8.55) with a flush, Ace high
Seat 5: AMrBn4Vx9aAo/vv6WHLk6w (big blind) mucked
Seat 6: wqphQtauX5Qn7WRJZS1flA folded before Flop (didn't bet)




PokerStars Game #59939339778:  Hold'em No Limit ($0.10/$0.25) - 2009/07/01 0:37:21 ET
Table '8qKBgCRnebT9/IvA6SmaPw' 9-max Seat #8 is the button
Seat 1: GTcLfsDTPqgfHyhY9FNDMw ($12.10 in chips) 
Seat 2: SXqVW4Q0evTUVZG6BbUNIA ($76.90 in chips) 
Seat 3: 6P8bD/60Ol/baOjOb199qA ($12.25 in chips) 
Seat 4: rXm4QDVJt67H20lM6n6Z7Q ($8 in chips) 
Seat 5: uJlzv9KL7hgCIqIS2ofoaw ($14.65 in chips) 
Seat 6: z5GxcHlYz/GSz6W2uFiTtg ($23.80 in chips) 
Seat 7: UbybWqarUDNRYlbnju2UUQ ($19.50 in chips) 
Seat 8: M2aiKD/Q1d8lySUIbBxeGg ($36.40 in chips) 
Seat 9: MOlR9YEgKTKLerVIDf8U7w ($34.35 in chips) 
MOlR9YEgKTKLerVIDf8U7w: posts small blind $0.10
GTcLfsDTPqgfHyhY9FNDMw: posts big blind $0.25
*** HOLE CARDS ***
SXqVW4Q0evTUVZG6BbUNIA: folds 
6P8bD/60Ol/baOjOb199qA: raises $0.75 to $1
rXm4QDVJt67H20lM6n6Z7Q: folds 
uJlzv9KL7hgCIqIS2ofoaw: folds 
z5GxcHlYz/GSz6W2uFiTtg: folds 
UbybWqarUDNRYlbnju2UUQ: folds 
M2aiKD/Q1d8lySUIbBxeGg: folds 
MOlR9YEgKTKLerVIDf8U7w: folds 
GTcLfsDTPqgfHyhY9FNDMw: folds 
Uncalled bet ($0.75) returned to 6P8bD/60Ol/baOjOb199qA
6P8bD/60Ol/baOjOb199qA collected $0.60 from pot
*** SUMMARY ***
Total pot $0.60 | Rake $0 
Seat 1: GTcLfsDTPqgfHyhY9FNDMw (big blind) folded before Flop
Seat 2: SXqVW4Q0evTUVZG6BbUNIA folded before Flop (didn't bet)
Seat 3: 6P8bD/60Ol/baOjOb199qA collected ($0.60)
Seat 4: rXm4QDVJt67H20lM6n6Z7Q folded before Flop (didn't bet)
Seat 5: uJlzv9KL7hgCIqIS2ofoaw folded before Flop (didn't bet)
Seat 6: z5GxcHlYz/GSz6W2uFiTtg folded before Flop (didn't bet)
Seat 7: UbybWqarUDNRYlbnju2UUQ folded before Flop (didn't bet)
Seat 8: M2aiKD/Q1d8lySUIbBxeGg (button) folded before Flop (didn't bet)
Seat 9: MOlR9YEgKTKLerVIDf8U7w (small blind) folded before Flop




PokerStars Game #59939340738:  Hold'em No Limit ($0.10/$0.25) - 2009/07/01 0:37:22 ET
Table 'KYX9dFNuOA9l2PV46IebqQ' 9-max Seat #5 is the button
Seat 1: s7Q6uNouhe7aE8JdFb9E+A ($27.40 in chips) 
Seat 2: r6hsffOo1iKmaPYKwAZmFw ($25 in chips) 
Seat 3: f+H1PHwj9cNu4Y6FfvKwQQ ($18.35 in chips) 
Seat 4: SkLOm0UugROBRt2EfMpOxQ ($35.70 in chips) 
Seat 5: HQMjiff9S04k8kyC4fHVgw ($2.55 in chips) 
Seat 6: DiSvPC2iudwL5j9u6Huyww ($25 in chips) 
Seat 7: kmJc9NmBNbE55/AnUDL6/w ($3.50 in chips) 
Seat 8: 4oA316mXLIui1QY63GXBUg ($25.15 in chips) 
Seat 9: W4TLQcZ2TiM73eIgpIvlGg ($33.30 in chips) 
DiSvPC2iudwL5j9u6Huyww: posts small blind $0.10
kmJc9NmBNbE55/AnUDL6/w: posts big blind $0.25
*** HOLE CARDS ***
4oA316mXLIui1QY63GXBUg: folds 
W4TLQcZ2TiM73eIgpIvlGg: folds 
s7Q6uNouhe7aE8JdFb9E+A: folds 
r6hsffOo1iKmaPYKwAZmFw: folds 
f+H1PHwj9cNu4Y6FfvKwQQ: folds 
SkLOm0UugROBRt2EfMpOxQ: folds 
HQMjiff9S04k8kyC4fHVgw: folds 
DiSvPC2iudwL5j9u6Huyww: folds 
Uncalled bet ($0.15) returned to kmJc9NmBNbE55/AnUDL6/w
kmJc9NmBNbE55/AnUDL6/w collected $0.20 from pot
kmJc9NmBNbE55/AnUDL6/w: doesn't show hand 
*** SUMMARY ***
Total pot $0.20 | Rake $0 
Seat 1: s7Q6uNouhe7aE8JdFb9E+A folded before Flop (didn't bet)
Seat 2: r6hsffOo1iKmaPYKwAZmFw folded before Flop (didn't bet)
Seat 3: f+H1PHwj9cNu4Y6FfvKwQQ folded before Flop (didn't bet)
Seat 4: SkLOm0UugROBRt2EfMpOxQ folded before Flop (didn't bet)
Seat 5: HQMjiff9S04k8kyC4fHVgw (button) folded before Flop (didn't bet)
Seat 6: DiSvPC2iudwL5j9u6Huyww (small blind) folded before Flop
Seat 7: kmJc9NmBNbE55/AnUDL6/w (big blind) collected ($0.20)
Seat 8: 4oA316mXLIui1QY63GXBUg folded before Flop (didn't bet)
Seat 9: W4TLQcZ2TiM73eIgpIvlGg folded before Flop (didn't bet)




PokerStars Game #59939340418:  Hold'em No Limit ($0.10/$0.25) - 2009/07/01 0:37:22 ET
Table 'm+FQg/QP0VP1ZA3V62WtOg' 9-max Seat #2 is the button
Seat 1: IK3/w7XV7rd8mVIsuasjYA ($3.40 in chips) 
Seat 2: oKO7b50N6TzXbPBr/mcrUA ($25.20 in chips) 
Seat 3: 4oA316mXLIui1QY63GXBUg ($25 in chips) 
Seat 4: 86vbuhJsyH+nbEg5qpDLyQ ($25 in chips) 
Seat 6: 0kGr2KqzSs4y4kVqyDiTag ($15.25 in chips) 
Seat 7: Xt367jg1prYX1onqNvit0Q ($18.55 in chips) 
Seat 8: tZEGwCRajq0AFS6z46uW9w ($14.70 in chips) 
Seat 9: ghNKXUBl/H+t83JF079ZBA ($25 in chips) 
4oA316mXLIui1QY63GXBUg: posts small blind $0.10
86vbuhJsyH+nbEg5qpDLyQ: posts big blind $0.25
DnDcAdn9P0zGovMERigpFA: sits out 
*** HOLE CARDS ***
0kGr2KqzSs4y4kVqyDiTag: folds 
Xt367jg1prYX1onqNvit0Q: calls $0.25
tZEGwCRajq0AFS6z46uW9w: raises $0.50 to $0.75
ghNKXUBl/H+t83JF079ZBA: folds 
IK3/w7XV7rd8mVIsuasjYA: folds 
oKO7b50N6TzXbPBr/mcrUA: folds 
4oA316mXLIui1QY63GXBUg: folds 
86vbuhJsyH+nbEg5qpDLyQ: folds 
Xt367jg1prYX1onqNvit0Q: calls $0.50
*** FLOP *** [4d Qs 3h]
Xt367jg1prYX1onqNvit0Q: checks 
tZEGwCRajq0AFS6z46uW9w: bets $1.75
Xt367jg1prYX1onqNvit0Q: folds 
Uncalled bet ($1.75) returned to tZEGwCRajq0AFS6z46uW9w
tZEGwCRajq0AFS6z46uW9w collected $1.80 from pot
*** SUMMARY ***
Total pot $1.85 | Rake $0.05 
Board [4d Qs 3h]
Seat 1: IK3/w7XV7rd8mVIsuasjYA folded before Flop (didn't bet)
Seat 2: oKO7b50N6TzXbPBr/mcrUA (button) folded before Flop (didn't bet)
Seat 3: 4oA316mXLIui1QY63GXBUg (small blind) folded before Flop
Seat 4: 86vbuhJsyH+nbEg5qpDLyQ (big blind) folded before Flop
Seat 6: 0kGr2KqzSs4y4kVqyDiTag folded before Flop (didn't bet)
Seat 7: Xt367jg1prYX1onqNvit0Q folded on the Flop
Seat 8: tZEGwCRajq0AFS6z46uW9w collected ($1.80)
Seat 9: ghNKXUBl/H+t83JF079ZBA folded before Flop (didn't bet)




PokerStars Game #59939340900:  Hold'em No Limit ($0.10/$0.25) - 2009/07/01 0:37:22 ET
Table 'tANpk8z1C5o0Pq/hpYShHw' 9-max Seat #6 is the button
Seat 2: og4yH4sZUZdC8jjgW8zPJQ ($7.30 in chips) 
Seat 3: zDrucyjVn5aeekNEc3cJrA ($21.25 in chips) 
Seat 4: dmQRblfPJL8cP867vJRZkg ($9.50 in chips) 
Seat 5: kWxV1qKcmWEussgWafGYNA ($45.50 in chips) 
Seat 6: Vp8EaqUO6YyqsnwsLR8SNQ ($9.05 in chips) 
Seat 7: sv2dZaqHRlfCDrW63Guhvg ($5.40 in chips) 
Seat 8: sPhk0wImgnCyx4aYrPXnHA ($24.75 in chips) 
Seat 9: gE5rN2TDY1aXcZn/TOPeZw ($15.90 in chips) 
sv2dZaqHRlfCDrW63Guhvg: posts small blind $0.10
sPhk0wImgnCyx4aYrPXnHA: posts big blind $0.25
rQhYIYXSyH/IivYM1dlV5A: sits out 
*** HOLE CARDS ***
gE5rN2TDY1aXcZn/TOPeZw: calls $0.25
og4yH4sZUZdC8jjgW8zPJQ: calls $0.25
zDrucyjVn5aeekNEc3cJrA: folds 
dmQRblfPJL8cP867vJRZkg: calls $0.25
kWxV1qKcmWEussgWafGYNA: folds 
Vp8EaqUO6YyqsnwsLR8SNQ: calls $0.25
sv2dZaqHRlfCDrW63Guhvg: calls $0.15
sPhk0wImgnCyx4aYrPXnHA: checks 
*** FLOP *** [6d Qd Kd]
sv2dZaqHRlfCDrW63Guhvg: bets $0.25
sPhk0wImgnCyx4aYrPXnHA: folds 
gE5rN2TDY1aXcZn/TOPeZw: raises $0.50 to $0.75
og4yH4sZUZdC8jjgW8zPJQ: folds 
dmQRblfPJL8cP867vJRZkg: calls $0.75
Vp8EaqUO6YyqsnwsLR8SNQ: calls $0.75
sv2dZaqHRlfCDrW63Guhvg: folds 
*** TURN *** [6d Qd Kd] [2s]
gE5rN2TDY1aXcZn/TOPeZw: bets $1
dmQRblfPJL8cP867vJRZkg: calls $1
Vp8EaqUO6YyqsnwsLR8SNQ: calls $1
*** RIVER *** [6d Qd Kd 2s] [8d]
gE5rN2TDY1aXcZn/TOPeZw: checks 
dmQRblfPJL8cP867vJRZkg: checks 
Vp8EaqUO6YyqsnwsLR8SNQ: bets $3.25
gE5rN2TDY1aXcZn/TOPeZw: folds 
dmQRblfPJL8cP867vJRZkg: folds 
Uncalled bet ($3.25) returned to Vp8EaqUO6YyqsnwsLR8SNQ
Vp8EaqUO6YyqsnwsLR8SNQ collected $6.70 from pot
Vp8EaqUO6YyqsnwsLR8SNQ: doesn't show hand 
*** SUMMARY ***
Total pot $7 | Rake $0.30 
Board [6d Qd Kd 2s 8d]
Seat 2: og4yH4sZUZdC8jjgW8zPJQ folded on the Flop
Seat 3: zDrucyjVn5aeekNEc3cJrA folded before Flop (didn't bet)
Seat 4: dmQRblfPJL8cP867vJRZkg folded on the River
Seat 5: kWxV1qKcmWEussgWafGYNA folded before Flop (didn't bet)
Seat 6: Vp8EaqUO6YyqsnwsLR8SNQ (button) collected ($6.70)
Seat 7: sv2dZaqHRlfCDrW63Guhvg (small blind) folded on the Flop
Seat 8: sPhk0wImgnCyx4aYrPXnHA (big blind) folded on the Flop
Seat 9: gE5rN2TDY1aXcZn/TOPeZw folded on the River




PokerStars Game #59939340640:  Hold'em No Limit ($0.10/$0.25) - 2009/07/01 0:37:22 ET
Table '7eunnLa5p3aGsPrUrNnn/A' 9-max Seat #1 is the button
Seat 1: Ml2bY77EHbM51ZWD7dnIWg ($30 in chips) 
Seat 2: aJy680tKSaP5er559aSuGA ($12.75 in chips) 
Seat 3: E0iYnEVO2ho7dH3QcCjw7g ($19.55 in chips) 
Seat 4: opOCI2p6kW0tINuVaAqmcQ ($30.70 in chips) 
Seat 5: JLfmdpDbz2ljMNE7ICboMQ ($8.05 in chips) 
Seat 6: jx9kXw1SAZrvXp9Nerz8+Q ($17.45 in chips) 
Seat 8: 1Clf3cPrqoy/YgvWdWK1Xw ($5 in chips) 
Seat 9: rUpvA02nErFvZ4yFbDR8XA ($21.05 in chips) 
aJy680tKSaP5er559aSuGA: posts small blind $0.10
E0iYnEVO2ho7dH3QcCjw7g: posts big blind $0.25
*** HOLE CARDS ***
opOCI2p6kW0tINuVaAqmcQ: folds 
JLfmdpDbz2ljMNE7ICboMQ: folds 
jx9kXw1SAZrvXp9Nerz8+Q: raises $0.50 to $0.75
1Clf3cPrqoy/YgvWdWK1Xw: folds 
rUpvA02nErFvZ4yFbDR8XA: folds 
Ml2bY77EHbM51ZWD7dnIWg: folds 
aJy680tKSaP5er559aSuGA: calls $0.65
E0iYnEVO2ho7dH3QcCjw7g: folds 
*** FLOP *** [Jc 9h Qc]
aJy680tKSaP5er559aSuGA: bets $0.75
jx9kXw1SAZrvXp9Nerz8+Q: raises $1.25 to $2
aJy680tKSaP5er559aSuGA: calls $1.25
*** TURN *** [Jc 9h Qc] [8h]
aJy680tKSaP5er559aSuGA: checks 
jx9kXw1SAZrvXp9Nerz8+Q: bets $2.50
aJy680tKSaP5er559aSuGA: raises $7.50 to $10 and is all-in
jx9kXw1SAZrvXp9Nerz8+Q: calls $7.50
*** RIVER *** [Jc 9h Qc 8h] [5s]
*** SHOW DOWN ***
aJy680tKSaP5er559aSuGA: shows [Td Tc] (a straight, Eight to Queen)
jx9kXw1SAZrvXp9Nerz8+Q: shows [Jd Ts] (a straight, Eight to Queen)
aJy680tKSaP5er559aSuGA collected $12.25 from pot
jx9kXw1SAZrvXp9Nerz8+Q collected $12.25 from pot
*** SUMMARY ***
Total pot $25.75 | Rake $1.25 
Board [Jc 9h Qc 8h 5s]
Seat 1: Ml2bY77EHbM51ZWD7dnIWg (button) folded before Flop (didn't bet)
Seat 2: aJy680tKSaP5er559aSuGA (small blind) showed [Td Tc] and won ($12.25) with a straight, Eight to Queen
Seat 3: E0iYnEVO2ho7dH3QcCjw7g (big blind) folded before Flop
Seat 4: opOCI2p6kW0tINuVaAqmcQ folded before Flop (didn't bet)
Seat 5: JLfmdpDbz2ljMNE7ICboMQ folded before Flop (didn't bet)
Seat 6: jx9kXw1SAZrvXp9Nerz8+Q showed [Jd Ts] and won ($12.25) with a straight, Eight to Queen
Seat 8: 1Clf3cPrqoy/YgvWdWK1Xw folded before Flop (didn't bet)
Seat 9: rUpvA02nErFvZ4yFbDR8XA folded before Flop (didn't bet)




PokerStars Game #59939340888:  Hold'em No Limit ($0.10/$0.25) - 2009/07/01 0:37:22 ET
Table 'KU/HrxqxwDz8HKEhYTZ6uw' 6-max Seat #5 is the button
Seat 1: gaPMxLGp9SOj4Lq6t+/0Ig ($13.70 in chips) 
Seat 2: kG34n23qFQA3nzdOJTQ1dA ($25 in chips) 
Seat 3: 3seg9SJ1y+HUPN0X0XKF5Q ($12.70 in chips) 
Seat 4: +yxuvzJHyIWsJ515X8zJTQ ($14 in chips) 
Seat 5: 4YSTu0Cdzpppe1lUgCZGCQ ($36.20 in chips) 
Seat 6: QIWnfLSqfMcoFfdDe5LZPg ($10.35 in chips) 
QIWnfLSqfMcoFfdDe5LZPg: posts small blind $0.10
gaPMxLGp9SOj4Lq6t+/0Ig: posts big blind $0.25
+yxuvzJHyIWsJ515X8zJTQ: posts big blind $0.25
*** HOLE CARDS ***
kG34n23qFQA3nzdOJTQ1dA: folds 
3seg9SJ1y+HUPN0X0XKF5Q: calls $0.25
+yxuvzJHyIWsJ515X8zJTQ: raises $0.50 to $0.75
4YSTu0Cdzpppe1lUgCZGCQ: calls $0.75
QIWnfLSqfMcoFfdDe5LZPg: calls $0.65
gaPMxLGp9SOj4Lq6t+/0Ig: raises $4.25 to $5
3seg9SJ1y+HUPN0X0XKF5Q: folds 
+yxuvzJHyIWsJ515X8zJTQ: calls $4.25
4YSTu0Cdzpppe1lUgCZGCQ: folds 
QIWnfLSqfMcoFfdDe5LZPg: folds 
*** FLOP *** [9c Jc 5s]
gaPMxLGp9SOj4Lq6t+/0Ig: bets $8.70 and is all-in
+yxuvzJHyIWsJ515X8zJTQ: calls $8.70
*** TURN *** [9c Jc 5s] [2h]
*** RIVER *** [9c Jc 5s 2h] [Ts]
*** SHOW DOWN ***
gaPMxLGp9SOj4Lq6t+/0Ig: shows [Qs Qh] (a pair of Queens)
+yxuvzJHyIWsJ515X8zJTQ: mucks hand 
gaPMxLGp9SOj4Lq6t+/0Ig collected $27.75 from pot
*** SUMMARY ***
Total pot $29.15 | Rake $1.40 
Board [9c Jc 5s 2h Ts]
Seat 1: gaPMxLGp9SOj4Lq6t+/0Ig (big blind) showed [Qs Qh] and won ($27.75) with a pair of Queens
Seat 2: kG34n23qFQA3nzdOJTQ1dA folded before Flop (didn't bet)
Seat 3: 3seg9SJ1y+HUPN0X0XKF5Q folded before Flop
Seat 4: +yxuvzJHyIWsJ515X8zJTQ mucked
Seat 5: 4YSTu0Cdzpppe1lUgCZGCQ (button) folded before Flop
Seat 6: QIWnfLSqfMcoFfdDe5LZPg (small blind) folded before Flop




PokerStars Game #59939340574:  Hold'em No Limit ($0.10/$0.25) - 2009/07/01 0:37:22 ET
Table 'o0CDOvKO/bn1WjeymDrXfA' 6-max Seat #4 is the button
Seat 1: 32YL2ZEp8NT4JB2RVM9euQ ($16.35 in chips) 
Seat 2: oc4ZGs0W+3RIg2yPyJw3ig ($24.75 in chips) 
Seat 3: EqXTTLKUlDlz7yi6ziyyWA ($9.65 in chips) 
Seat 4: WvQKBeYmHv0ZkY7uzfWAAw ($13.90 in chips) 
Seat 5: u/yN5P9f3KlATg6WLWNkBQ ($29.35 in chips) 
Seat 6: Bada343Si4xKu3fNXY99AA ($21.30 in chips) 
u/yN5P9f3KlATg6WLWNkBQ: posts small blind $0.10
Bada343Si4xKu3fNXY99AA: posts big blind $0.25
*** HOLE CARDS ***
32YL2ZEp8NT4JB2RVM9euQ: folds 
oc4ZGs0W+3RIg2yPyJw3ig: folds 
EqXTTLKUlDlz7yi6ziyyWA: raises $1.50 to $1.75
WvQKBeYmHv0ZkY7uzfWAAw has timed out
WvQKBeYmHv0ZkY7uzfWAAw: folds 
WvQKBeYmHv0ZkY7uzfWAAw is sitting out
u/yN5P9f3KlATg6WLWNkBQ: folds 
Bada343Si4xKu3fNXY99AA: folds 
Uncalled bet ($1.50) returned to EqXTTLKUlDlz7yi6ziyyWA
WvQKBeYmHv0ZkY7uzfWAAw has returned
EqXTTLKUlDlz7yi6ziyyWA collected $0.60 from pot
*** SUMMARY ***
Total pot $0.60 | Rake $0 
Seat 1: 32YL2ZEp8NT4JB2RVM9euQ folded before Flop (didn't bet)
Seat 2: oc4ZGs0W+3RIg2yPyJw3ig folded before Flop (didn't bet)
Seat 3: EqXTTLKUlDlz7yi6ziyyWA collected ($0.60)
Seat 4: WvQKBeYmHv0ZkY7uzfWAAw (button) folded before Flop (didn't bet)
Seat 5: u/yN5P9f3KlATg6WLWNkBQ (small blind) folded before Flop
Seat 6: Bada343Si4xKu3fNXY99AA (big blind) folded before Flop




PokerStars Game #59939340344:  Hold'em No Limit ($0.10/$0.25) - 2009/07/01 0:37:22 ET
Table '9o8Yb3JpUqurD4pNVmOikQ' 6-max Seat #5 is the button
Seat 1: 5tB0F9NjPSUL4FzmzBMs2Q ($25 in chips) 
Seat 2: /gJNBeCkWL4o85/jvlZ4BA ($25.35 in chips) 
Seat 3: JgRqo1/2phbf7pab7N3BIQ ($8.75 in chips) 
Seat 4: YaAEMJGY5tem39deCUQRNw ($41.30 in chips) 
Seat 5: q9qPRjJC40e/Q9yuT+glwQ ($33.80 in chips) 
Seat 6: k9vn40MOqqb+xF+7GZ6v2g ($25.25 in chips) 
k9vn40MOqqb+xF+7GZ6v2g: posts small blind $0.10
5tB0F9NjPSUL4FzmzBMs2Q: posts big blind $0.25
*** HOLE CARDS ***
/gJNBeCkWL4o85/jvlZ4BA: folds 
JgRqo1/2phbf7pab7N3BIQ: calls $0.25
YaAEMJGY5tem39deCUQRNw: folds 
q9qPRjJC40e/Q9yuT+glwQ: folds 
k9vn40MOqqb+xF+7GZ6v2g: raises $1.50 to $1.75
5tB0F9NjPSUL4FzmzBMs2Q: calls $1.50
JgRqo1/2phbf7pab7N3BIQ: folds 
*** FLOP *** [6d 5s 6c]
k9vn40MOqqb+xF+7GZ6v2g: bets $4
5tB0F9NjPSUL4FzmzBMs2Q: raises $4.95 to $8.95
k9vn40MOqqb+xF+7GZ6v2g: raises $14.55 to $23.50 and is all-in
5tB0F9NjPSUL4FzmzBMs2Q: folds 
Uncalled bet ($14.55) returned to k9vn40MOqqb+xF+7GZ6v2g
k9vn40MOqqb+xF+7GZ6v2g collected $20.60 from pot
*** SUMMARY ***
Total pot $21.65 | Rake $1.05 
Board [6d 5s 6c]
Seat 1: 5tB0F9NjPSUL4FzmzBMs2Q (big blind) folded on the Flop
Seat 2: /gJNBeCkWL4o85/jvlZ4BA folded before Flop (didn't bet)
Seat 3: JgRqo1/2phbf7pab7N3BIQ folded before Flop
Seat 4: YaAEMJGY5tem39deCUQRNw folded before Flop (didn't bet)
Seat 5: q9qPRjJC40e/Q9yuT+glwQ (button) folded before Flop (didn't bet)
Seat 6: k9vn40MOqqb+xF+7GZ6v2g (small blind) collected ($20.60)




PokerStars Game #59939340362:  Hold'em No Limit ($0.10/$0.25) - 2009/07/01 0:37:22 ET
Table 'APEHQjIcZHDZUA4iOjju2g' 6-max Seat #6 is the button
Seat 1: eHsmIvAb2JREg4O6hNPnXg ($8.70 in chips) 
Seat 2: 3zD3qLXT1bEffAoWGnc7wg ($25 in chips) 
Seat 3: E7KSkgfIsmIsp0vLnmGFmA ($16.25 in chips) 
Seat 4: EqXTTLKUlDlz7yi6ziyyWA ($31.75 in chips) 
Seat 5: /xN6gc9+8Hew0HxaB6VIVg ($32.10 in chips) 
Seat 6: y7HCJfEmolBCFdi/0j5TRg ($45.05 in chips) 
eHsmIvAb2JREg4O6hNPnXg: posts small blind $0.10
3zD3qLXT1bEffAoWGnc7wg: posts big blind $0.25
*** HOLE CARDS ***
E7KSkgfIsmIsp0vLnmGFmA has timed out
E7KSkgfIsmIsp0vLnmGFmA: folds 
E7KSkgfIsmIsp0vLnmGFmA is sitting out
EqXTTLKUlDlz7yi6ziyyWA: folds 
/xN6gc9+8Hew0HxaB6VIVg: folds 
y7HCJfEmolBCFdi/0j5TRg: folds 
eHsmIvAb2JREg4O6hNPnXg: folds 
Uncalled bet ($0.15) returned to 3zD3qLXT1bEffAoWGnc7wg
3zD3qLXT1bEffAoWGnc7wg collected $0.20 from pot
3zD3qLXT1bEffAoWGnc7wg: doesn't show hand 
*** SUMMARY ***
Total pot $0.20 | Rake $0 
Seat 1: eHsmIvAb2JREg4O6hNPnXg (small blind) folded before Flop
Seat 2: 3zD3qLXT1bEffAoWGnc7wg (big blind) collected ($0.20)
Seat 3: E7KSkgfIsmIsp0vLnmGFmA folded before Flop (didn't bet)
Seat 4: EqXTTLKUlDlz7yi6ziyyWA folded before Flop (didn't bet)
Seat 5: /xN6gc9+8Hew0HxaB6VIVg folded before Flop (didn't bet)
Seat 6: y7HCJfEmolBCFdi/0j5TRg (button) folded before Flop (didn't bet)




PokerStars Game #59939340376:  Hold'em No Limit ($0.10/$0.25) - 2009/07/01 0:37:22 ET
Table '6ae4XiTo6B597KfSSMr8Cg' 9-max Seat #9 is the button
Seat 1: 49YfVBEOwzD3/FVw+dTTBQ ($6.50 in chips) 
Seat 2: 5s3p6yoJBNW438dsyKTP8g ($45.25 in chips) 
Seat 4: dfNim92Z6XK1/h5SFW5vDg ($49.10 in chips) 
Seat 5: 1K6QGyJP9P9xmRac2fH4OQ ($25 in chips) 
Seat 7: 18G4P1XstjNvItdGUITxgw ($25.25 in chips) 
Seat 9: E0iYnEVO2ho7dH3QcCjw7g ($34.70 in chips) 
49YfVBEOwzD3/FVw+dTTBQ: posts small blind $0.10
5s3p6yoJBNW438dsyKTP8g: posts big blind $0.25
yyG4svzOpC1A+sUP/scg6w: sits out 
DlXs37dlX3tb7o/7lYXQSw: sits out 
*** HOLE CARDS ***
dfNim92Z6XK1/h5SFW5vDg: folds 
1K6QGyJP9P9xmRac2fH4OQ: folds 
CyrsTheGreat leaves the table
18G4P1XstjNvItdGUITxgw: folds 
E0iYnEVO2ho7dH3QcCjw7g: folds 
49YfVBEOwzD3/FVw+dTTBQ: folds 
Uncalled bet ($0.15) returned to 5s3p6yoJBNW438dsyKTP8g
5s3p6yoJBNW438dsyKTP8g collected $0.20 from pot
5s3p6yoJBNW438dsyKTP8g: doesn't show hand 
*** SUMMARY ***
Total pot $0.20 | Rake $0 
Seat 1: 49YfVBEOwzD3/FVw+dTTBQ (small blind) folded before Flop
Seat 2: 5s3p6yoJBNW438dsyKTP8g (big blind) collected ($0.20)
Seat 4: dfNim92Z6XK1/h5SFW5vDg folded before Flop (didn't bet)
Seat 5: 1K6QGyJP9P9xmRac2fH4OQ folded before Flop (didn't bet)
Seat 7: 18G4P1XstjNvItdGUITxgw folded before Flop (didn't bet)
Seat 9: E0iYnEVO2ho7dH3QcCjw7g (button) folded before Flop (didn't bet)




PokerStars Game #59939341030:  Hold'em No Limit ($0.10/$0.25) - 2009/07/01 0:37:23 ET
Table '63h13e5p7cWe02rClZ1CHw' 6-max Seat #1 is the button
Seat 1: 7VfhiFY533nbUKvyEthASw ($10 in chips) 
Seat 2: k9nHZTHt8hYhYRcW8NTb4g ($14.75 in chips) 
Seat 3: 9jSiy0meE9XJKkdIZwyTEQ ($33.90 in chips) 
Seat 4: myagrRAhs0mdgmh5GNqvCw ($6.45 in chips) 
Seat 5: bE34il0XYGjWPD5/vbkMaQ ($12.25 in chips) 
Seat 6: mfrkWA3PTeYPkbO6hi98Aw ($35.10 in chips) 
k9nHZTHt8hYhYRcW8NTb4g: posts small blind $0.10
9jSiy0meE9XJKkdIZwyTEQ: posts big blind $0.25
*** HOLE CARDS ***
myagrRAhs0mdgmh5GNqvCw: folds 
bE34il0XYGjWPD5/vbkMaQ: folds 
mfrkWA3PTeYPkbO6hi98Aw: folds 
7VfhiFY533nbUKvyEthASw: folds 
k9nHZTHt8hYhYRcW8NTb4g: folds 
Uncalled bet ($0.15) returned to 9jSiy0meE9XJKkdIZwyTEQ
9jSiy0meE9XJKkdIZwyTEQ collected $0.20 from pot
9jSiy0meE9XJKkdIZwyTEQ: doesn't show hand 
*** SUMMARY ***
Total pot $0.20 | Rake $0 
Seat 1: 7VfhiFY533nbUKvyEthASw (button) folded before Flop (didn't bet)
Seat 2: k9nHZTHt8hYhYRcW8NTb4g (small blind) folded before Flop
Seat 3: 9jSiy0meE9XJKkdIZwyTEQ (big blind) collected ($0.20)
Seat 4: myagrRAhs0mdgmh5GNqvCw folded before Flop (didn't bet)
Seat 5: bE34il0XYGjWPD5/vbkMaQ folded before Flop (didn't bet)
Seat 6: mfrkWA3PTeYPkbO6hi98Aw folded before Flop (didn't bet)




PokerStars Game #59939341576:  Hold'em No Limit ($0.10/$0.25) - 2009/07/01 0:37:23 ET
Table '+UzantPJ4smVdrh+4GTu1w' 6-max Seat #6 is the button
Seat 1: 3Bm6SLY1pwRvi98HLQUkvg ($3.75 in chips) 
Seat 2: tcbEu7VzyHQ+0lh+skbQhQ ($15 in chips) 
Seat 3: SS/yfeArhULzIcOPe8MdPg ($51.50 in chips) 
Seat 4: 0/dGyX46wFQuMZwX3LgPxg ($4.65 in chips) 
Seat 5: cj4VBQya7HtVL2zCGd5jLQ ($15.10 in chips) 
Seat 6: BYxjLnV1/LL0aZcTbfAOvw ($48.05 in chips) 
3Bm6SLY1pwRvi98HLQUkvg: posts small blind $0.10
tcbEu7VzyHQ+0lh+skbQhQ: posts big blind $0.25
*** HOLE CARDS ***
SS/yfeArhULzIcOPe8MdPg: folds 
0/dGyX46wFQuMZwX3LgPxg: raises $0.50 to $0.75
cj4VBQya7HtVL2zCGd5jLQ: folds 
BYxjLnV1/LL0aZcTbfAOvw: folds 
3Bm6SLY1pwRvi98HLQUkvg: folds 
tcbEu7VzyHQ+0lh+skbQhQ: calls $0.50
*** FLOP *** [7c 4s Th]
tcbEu7VzyHQ+0lh+skbQhQ: bets $0.75
0/dGyX46wFQuMZwX3LgPxg: raises $1 to $1.75
tcbEu7VzyHQ+0lh+skbQhQ: raises $1 to $2.75
0/dGyX46wFQuMZwX3LgPxg: raises $1.15 to $3.90 and is all-in
tcbEu7VzyHQ+0lh+skbQhQ: calls $1.15
*** TURN *** [7c 4s Th] [5c]
*** RIVER *** [7c 4s Th 5c] [3h]
*** SHOW DOWN ***
tcbEu7VzyHQ+0lh+skbQhQ: shows [9s 8d] (high card Ten)
0/dGyX46wFQuMZwX3LgPxg: shows [Td Ad] (a pair of Tens)
0/dGyX46wFQuMZwX3LgPxg collected $8.95 from pot
*** SUMMARY ***
Total pot $9.40 | Rake $0.45 
Board [7c 4s Th 5c 3h]
Seat 1: 3Bm6SLY1pwRvi98HLQUkvg (small blind) folded before Flop
Seat 2: tcbEu7VzyHQ+0lh+skbQhQ (big blind) showed [9s 8d] and lost with high card Ten
Seat 3: SS/yfeArhULzIcOPe8MdPg folded before Flop (didn't bet)
Seat 4: 0/dGyX46wFQuMZwX3LgPxg showed [Td Ad] and won ($8.95) with a pair of Tens
Seat 5: cj4VBQya7HtVL2zCGd5jLQ folded before Flop (didn't bet)
Seat 6: BYxjLnV1/LL0aZcTbfAOvw (button) folded before Flop (didn't bet)




PokerStars Game #59939341328:  Hold'em No Limit ($0.10/$0.25) - 2009/07/01 0:37:23 ET
Table 'u5gc8WdJbaPqEonQaM8rHA' 9-max Seat #2 is the button
Seat 1: rXm4QDVJt67H20lM6n6Z7Q ($8.50 in chips) 
Seat 2: YcYxPZXJR8KffyXgr1BkHw ($22.30 in chips) 
Seat 3: gehe91e0IyVT0QU/XBkEyg ($25 in chips) 
Seat 4: QBNV6v6f+1ZHoaKcQDTWog ($35.40 in chips) 
Seat 5: CYkY0dNBaYaKs8HVCVn3mQ ($5 in chips) 
Seat 6: iPe2eRZr++z/LEfORn3WBQ ($16.95 in chips) 
gehe91e0IyVT0QU/XBkEyg: posts small blind $0.10
QBNV6v6f+1ZHoaKcQDTWog: posts big blind $0.25
*** HOLE CARDS ***
CYkY0dNBaYaKs8HVCVn3mQ: folds 
iPe2eRZr++z/LEfORn3WBQ: folds 
rXm4QDVJt67H20lM6n6Z7Q: folds 
YcYxPZXJR8KffyXgr1BkHw: calls $0.25
gehe91e0IyVT0QU/XBkEyg: folds 
QBNV6v6f+1ZHoaKcQDTWog: checks 
*** FLOP *** [Th Qc 6h]
gehe91e0IyVT0QU/XBkEyg leaves the table
QBNV6v6f+1ZHoaKcQDTWog: checks 
YcYxPZXJR8KffyXgr1BkHw: bets $0.75
QBNV6v6f+1ZHoaKcQDTWog: calls $0.75
*** TURN *** [Th Qc 6h] [4c]
QBNV6v6f+1ZHoaKcQDTWog: bets $0.75
YcYxPZXJR8KffyXgr1BkHw: calls $0.75
*** RIVER *** [Th Qc 6h 4c] [Jc]
QBNV6v6f+1ZHoaKcQDTWog: bets $1.50
YcYxPZXJR8KffyXgr1BkHw: raises $2.50 to $4
QBNV6v6f+1ZHoaKcQDTWog: calls $2.50
*** SHOW DOWN ***
YcYxPZXJR8KffyXgr1BkHw: shows [9c 8h] (a straight, Eight to Queen)
QBNV6v6f+1ZHoaKcQDTWog: mucks hand 
YcYxPZXJR8KffyXgr1BkHw collected $11.05 from pot
*** SUMMARY ***
Total pot $11.60 | Rake $0.55 
Board [Th Qc 6h 4c Jc]
Seat 1: rXm4QDVJt67H20lM6n6Z7Q folded before Flop (didn't bet)
Seat 2: YcYxPZXJR8KffyXgr1BkHw (button) showed [9c 8h] and won ($11.05) with a straight, Eight to Queen
Seat 3: gehe91e0IyVT0QU/XBkEyg (small blind) folded before Flop
Seat 4: QBNV6v6f+1ZHoaKcQDTWog (big blind) mucked
Seat 5: CYkY0dNBaYaKs8HVCVn3mQ folded before Flop (didn't bet)
Seat 6: iPe2eRZr++z/LEfORn3WBQ folded before Flop (didn't bet)




PokerStars Game #59939341298:  Hold'em No Limit ($0.10/$0.25) - 2009/07/01 0:37:23 ET
Table '8QBBaev+cI2i/r2H6ml/lg' 9-max Seat #4 is the button
Seat 2: tYsOBqdU1+x+yFI7zHO7hQ ($25 in chips) 
Seat 4: ZoG0obuajzVjwgd7lNHjgg ($5 in chips) 
Seat 5: j4q3p0lesp63b1gZDwLBZw ($5 in chips) 
Seat 6: E0iYnEVO2ho7dH3QcCjw7g ($28.50 in chips) 
Seat 8: JxpnpCmvRAcrEUy7mq1iAg ($5 in chips) 
Seat 9: Ml2bY77EHbM51ZWD7dnIWg ($2.30 in chips) 
j4q3p0lesp63b1gZDwLBZw: posts small blind $0.10
E0iYnEVO2ho7dH3QcCjw7g: posts big blind $0.25
*** HOLE CARDS ***
JxpnpCmvRAcrEUy7mq1iAg: folds 
Ml2bY77EHbM51ZWD7dnIWg: folds 
tYsOBqdU1+x+yFI7zHO7hQ: folds 
ZoG0obuajzVjwgd7lNHjgg: folds 
j4q3p0lesp63b1gZDwLBZw: folds 
Uncalled bet ($0.15) returned to E0iYnEVO2ho7dH3QcCjw7g
E0iYnEVO2ho7dH3QcCjw7g collected $0.20 from pot
*** SUMMARY ***
Total pot $0.20 | Rake $0 
Seat 2: tYsOBqdU1+x+yFI7zHO7hQ folded before Flop (didn't bet)
Seat 4: ZoG0obuajzVjwgd7lNHjgg (button) folded before Flop (didn't bet)
Seat 5: j4q3p0lesp63b1gZDwLBZw (small blind) folded before Flop
Seat 6: E0iYnEVO2ho7dH3QcCjw7g (big blind) collected ($0.20)
Seat 8: JxpnpCmvRAcrEUy7mq1iAg folded before Flop (didn't bet)
Seat 9: Ml2bY77EHbM51ZWD7dnIWg folded before Flop (didn't bet)




PokerStars Game #59939341092:  Hold'em No Limit ($0.10/$0.25) - 2009/07/01 0:37:23 ET
Table 'B3/JTS7usG3rxMfTbMiZuw' 6-max Seat #6 is the button
Seat 1: wAKC8C/zN0c8V5v13dm9mA ($30 in chips) 
Seat 2: 2gqWqkOq59pvtJKe4nS+rw ($36.90 in chips) 
Seat 4: kPCKvyB1yAABEgvF7OaG0g ($22.40 in chips) 
Seat 5: NhUN/JpAprdJeamFBgJH1w ($26.50 in chips) 
Seat 6: AGMIbXefZrMZ8QjfyCknDw ($10.10 in chips) 
wAKC8C/zN0c8V5v13dm9mA: posts small blind $0.10
2gqWqkOq59pvtJKe4nS+rw: posts big blind $0.25
PbMzPZIePKifKQZfKDkbIw: sits out 
*** HOLE CARDS ***
kPCKvyB1yAABEgvF7OaG0g: folds 
NhUN/JpAprdJeamFBgJH1w: folds 
AGMIbXefZrMZ8QjfyCknDw: folds 
wAKC8C/zN0c8V5v13dm9mA: folds 
Uncalled bet ($0.15) returned to 2gqWqkOq59pvtJKe4nS+rw
2gqWqkOq59pvtJKe4nS+rw collected $0.20 from pot
2gqWqkOq59pvtJKe4nS+rw: doesn't show hand 
*** SUMMARY ***
Total pot $0.20 | Rake $0 
Seat 1: wAKC8C/zN0c8V5v13dm9mA (small blind) folded before Flop
Seat 2: 2gqWqkOq59pvtJKe4nS+rw (big blind) collected ($0.20)
Seat 4: kPCKvyB1yAABEgvF7OaG0g folded before Flop (didn't bet)
Seat 5: NhUN/JpAprdJeamFBgJH1w folded before Flop (didn't bet)
Seat 6: AGMIbXefZrMZ8QjfyCknDw (button) folded before Flop (didn't bet)




PokerStars Game #59939342172:  Hold'em No Limit ($0.10/$0.25) - 2009/07/01 0:37:24 ET
Table 'AHkg4ChqzcMauBx6Qvz8Nw' 6-max Seat #3 is the button
Seat 2: /bjna2FTN7pPjqYGzmDE0Q ($24.35 in chips) 
Seat 3: PIOdknsVyjKUwfiImc3zwg ($25.90 in chips) 
Seat 4: N7O9jUEx2YiQn1+yRYTHmw ($25.95 in chips) 
Seat 5: LtASJ9OlkqGrrUKGQlpGAw ($34.55 in chips) 
Seat 6: SFmT9ZsVopnukjvAzrxTRg ($53.40 in chips) 
N7O9jUEx2YiQn1+yRYTHmw: posts small blind $0.10
LtASJ9OlkqGrrUKGQlpGAw: posts big blind $0.25
*** HOLE CARDS ***
SFmT9ZsVopnukjvAzrxTRg: folds 
/bjna2FTN7pPjqYGzmDE0Q: folds 
PIOdknsVyjKUwfiImc3zwg: folds 
N7O9jUEx2YiQn1+yRYTHmw: calls $0.15
LtASJ9OlkqGrrUKGQlpGAw: checks 
*** FLOP *** [6c 4d Kc]
N7O9jUEx2YiQn1+yRYTHmw: checks 
LtASJ9OlkqGrrUKGQlpGAw: bets $0.25
N7O9jUEx2YiQn1+yRYTHmw: folds 
Uncalled bet ($0.25) returned to LtASJ9OlkqGrrUKGQlpGAw
LtASJ9OlkqGrrUKGQlpGAw collected $0.50 from pot
LtASJ9OlkqGrrUKGQlpGAw: doesn't show hand 
*** SUMMARY ***
Total pot $0.50 | Rake $0 
Board [6c 4d Kc]
Seat 2: /bjna2FTN7pPjqYGzmDE0Q folded before Flop (didn't bet)
Seat 3: PIOdknsVyjKUwfiImc3zwg (button) folded before Flop (didn't bet)
Seat 4: N7O9jUEx2YiQn1+yRYTHmw (small blind) folded on the Flop
Seat 5: LtASJ9OlkqGrrUKGQlpGAw (big blind) collected ($0.50)
Seat 6: SFmT9ZsVopnukjvAzrxTRg folded before Flop (didn't bet)




PokerStars Game #59939341938:  Hold'em No Limit ($0.10/$0.25) - 2009/07/01 0:37:24 ET
Table 'KEoOIegxPF91KooL2AelUA' 6-max Seat #1 is the button
Seat 1: wsP46AGpqDjHZQmlRHKa9g ($25.80 in chips) 
Seat 4: Vv37Oa9niKKVcR6Z7ceetw ($22.20 in chips) 
Seat 5: 2NLC44AHHKHEUooUQFYV+Q ($17.25 in chips) 
Vv37Oa9niKKVcR6Z7ceetw: posts small blind $0.10
2NLC44AHHKHEUooUQFYV+Q: posts big blind $0.25
*** HOLE CARDS ***
wsP46AGpqDjHZQmlRHKa9g: raises $0.50 to $0.75
Vv37Oa9niKKVcR6Z7ceetw: folds 
2NLC44AHHKHEUooUQFYV+Q: calls $0.50
*** FLOP *** [8c 2d 7d]
2NLC44AHHKHEUooUQFYV+Q: checks 
wsP46AGpqDjHZQmlRHKa9g: checks 
*** TURN *** [8c 2d 7d] [Kd]
2NLC44AHHKHEUooUQFYV+Q: checks 
wsP46AGpqDjHZQmlRHKa9g: bets $0.75
2NLC44AHHKHEUooUQFYV+Q: calls $0.75
*** RIVER *** [8c 2d 7d Kd] [6d]
2NLC44AHHKHEUooUQFYV+Q: checks 
Vv37Oa9niKKVcR6Z7ceetw said, "i know that idiot"
wsP46AGpqDjHZQmlRHKa9g: bets $1
Vv37Oa9niKKVcR6Z7ceetw said, "but stupid allin bet"
2NLC44AHHKHEUooUQFYV+Q: folds 
Uncalled bet ($1) returned to wsP46AGpqDjHZQmlRHKa9g
wsP46AGpqDjHZQmlRHKa9g collected $2.95 from pot
*** SUMMARY ***
Total pot $3.10 | Rake $0.15 
Board [8c 2d 7d Kd 6d]
Seat 1: wsP46AGpqDjHZQmlRHKa9g (button) collected ($2.95)
Seat 4: Vv37Oa9niKKVcR6Z7ceetw (small blind) folded before Flop
Seat 5: 2NLC44AHHKHEUooUQFYV+Q (big blind) folded on the River




PokerStars Game #59939342164:  Hold'em No Limit ($0.10/$0.25) - 2009/07/01 0:37:24 ET
Table 'bIGKmJgZehWJ+FAo8b85iw' 9-max Seat #5 is the button
Seat 2: Ut3g/kEEdCCbe/gbWrHnDg ($21.50 in chips) 
Seat 3: TeWJxSETzbXGiYKx0y+dtg ($36.40 in chips) 
Seat 4: EJRVVUAJEYLdm1qbO8TzuQ ($15.65 in chips) 
Seat 5: 7wo6Sr7QG3Zo6BaBDV1BOw ($6.80 in chips) 
Seat 6: H5Se03ZqSX7tbULXur2MAg ($22.05 in chips) 
Seat 7: DdPXdieucQ+n99u1n3A+rQ ($5 in chips) 
Seat 9: aNpwfA31EREwO+ar4XzBCw ($25 in chips) 
H5Se03ZqSX7tbULXur2MAg: posts small blind $0.10
DdPXdieucQ+n99u1n3A+rQ: posts big blind $0.25
+2kMBNpY4nF1qNCRd8SJLA: sits out 
yyG4svzOpC1A+sUP/scg6w: sits out 
*** HOLE CARDS ***
aNpwfA31EREwO+ar4XzBCw: folds 
Ut3g/kEEdCCbe/gbWrHnDg: folds 
TeWJxSETzbXGiYKx0y+dtg: folds 
EJRVVUAJEYLdm1qbO8TzuQ: folds 
7wo6Sr7QG3Zo6BaBDV1BOw: folds 
H5Se03ZqSX7tbULXur2MAg: folds 
Uncalled bet ($0.15) returned to DdPXdieucQ+n99u1n3A+rQ
DdPXdieucQ+n99u1n3A+rQ collected $0.20 from pot
DdPXdieucQ+n99u1n3A+rQ: doesn't show hand 
*** SUMMARY ***
Total pot $0.20 | Rake $0 
Seat 2: Ut3g/kEEdCCbe/gbWrHnDg folded before Flop (didn't bet)
Seat 3: TeWJxSETzbXGiYKx0y+dtg folded before Flop (didn't bet)
Seat 4: EJRVVUAJEYLdm1qbO8TzuQ folded before Flop (didn't bet)
Seat 5: 7wo6Sr7QG3Zo6BaBDV1BOw (button) folded before Flop (didn't bet)
Seat 6: H5Se03ZqSX7tbULXur2MAg (small blind) folded before Flop
Seat 7: DdPXdieucQ+n99u1n3A+rQ (big blind) collected ($0.20)
Seat 9: aNpwfA31EREwO+ar4XzBCw folded before Flop (didn't bet)




PokerStars Game #59939342106:  Hold'em No Limit ($0.10/$0.25) - 2009/07/01 0:37:24 ET
Table 'GxdLtCpYxqT4aAbYqkEEpw' 6-max Seat #6 is the button
Seat 1: heEf/FkFGS9M1NmwH97YIA ($41.35 in chips) 
Seat 2: hADMNbkECXMb2C/C8R2Wlw ($23.15 in chips) 
Seat 3: 9jSiy0meE9XJKkdIZwyTEQ ($33.90 in chips) 
Seat 4: ErIN0JRL5srYjT6en1f8YQ ($24.55 in chips) 
Seat 5: q6WfTUAD9mowIP63ASq2Dg ($41.10 in chips) 
Seat 6: aogAb4Eienxztk8p2v9VVw ($26.40 in chips) 
heEf/FkFGS9M1NmwH97YIA: posts small blind $0.10
hADMNbkECXMb2C/C8R2Wlw: posts big blind $0.25
*** HOLE CARDS ***
9jSiy0meE9XJKkdIZwyTEQ: folds 
ErIN0JRL5srYjT6en1f8YQ: folds 
q6WfTUAD9mowIP63ASq2Dg: folds 
aogAb4Eienxztk8p2v9VVw: raises $0.75 to $1
heEf/FkFGS9M1NmwH97YIA: folds 
hADMNbkECXMb2C/C8R2Wlw: folds 
Uncalled bet ($0.75) returned to aogAb4Eienxztk8p2v9VVw
aogAb4Eienxztk8p2v9VVw collected $0.60 from pot
aogAb4Eienxztk8p2v9VVw: doesn't show hand 
*** SUMMARY ***
Total pot $0.60 | Rake $0 
Seat 1: heEf/FkFGS9M1NmwH97YIA (small blind) folded before Flop
Seat 2: hADMNbkECXMb2C/C8R2Wlw (big blind) folded before Flop
Seat 3: 9jSiy0meE9XJKkdIZwyTEQ folded before Flop (didn't bet)
Seat 4: ErIN0JRL5srYjT6en1f8YQ folded before Flop (didn't bet)
Seat 5: q6WfTUAD9mowIP63ASq2Dg folded before Flop (didn't bet)
Seat 6: aogAb4Eienxztk8p2v9VVw (button) collected ($0.60)




PokerStars Game #59939341982:  Hold'em No Limit ($0.10/$0.25) - 2009/07/01 0:37:24 ET
Table 'LwnjzXstPtSrqrV/oDpnXQ' 9-max Seat #9 is the button
Seat 1: sChhj/mp8dm+nGvBS5mOIA ($16.80 in chips) 
Seat 2: K7bAhhMMJ/XcTmGaBZVfFQ ($28.85 in chips) 
Seat 3: u+XLsbPQIcRvPRnS1bvZww ($11.60 in chips) 
Seat 4: nmvbguGv4wKulGg49bANbQ ($15.50 in chips) 
Seat 6: ljemhp25Zg+nlA9DLCIiUw ($31.90 in chips) 
Seat 7: 0Cloefb0wF+uyUT5B/TK8w ($12.45 in chips) 
Seat 8: h4ggJZYBXV0mEZzYPYKfeA ($31.85 in chips) 
Seat 9: N6fYvIzQLKaydFLKQGtMlQ ($24.65 in chips) 
sChhj/mp8dm+nGvBS5mOIA: posts small blind $0.10
K7bAhhMMJ/XcTmGaBZVfFQ: posts big blind $0.25
Th3FldXKQW6hWVVPahaoOQ: sits out 
*** HOLE CARDS ***
u+XLsbPQIcRvPRnS1bvZww: calls $0.25
nmvbguGv4wKulGg49bANbQ: folds 
ljemhp25Zg+nlA9DLCIiUw: calls $0.25
0Cloefb0wF+uyUT5B/TK8w: folds 
h4ggJZYBXV0mEZzYPYKfeA: calls $0.25
N6fYvIzQLKaydFLKQGtMlQ: folds 
sChhj/mp8dm+nGvBS5mOIA: calls $0.15
K7bAhhMMJ/XcTmGaBZVfFQ: checks 
*** FLOP *** [7d 8d 4s]
sChhj/mp8dm+nGvBS5mOIA: checks 
0Cloefb0wF+uyUT5B/TK8w leaves the table
K7bAhhMMJ/XcTmGaBZVfFQ: checks 
u+XLsbPQIcRvPRnS1bvZww: checks 
ljemhp25Zg+nlA9DLCIiUw: checks 
h4ggJZYBXV0mEZzYPYKfeA: bets $1
sChhj/mp8dm+nGvBS5mOIA: folds 
K7bAhhMMJ/XcTmGaBZVfFQ: folds 
u+XLsbPQIcRvPRnS1bvZww: folds 
ljemhp25Zg+nlA9DLCIiUw: folds 
Uncalled bet ($1) returned to h4ggJZYBXV0mEZzYPYKfeA
h4ggJZYBXV0mEZzYPYKfeA collected $1.20 from pot
h4ggJZYBXV0mEZzYPYKfeA: doesn't show hand 
*** SUMMARY ***
Total pot $1.25 | Rake $0.05 
Board [7d 8d 4s]
Seat 1: sChhj/mp8dm+nGvBS5mOIA (small blind) folded on the Flop
Seat 2: K7bAhhMMJ/XcTmGaBZVfFQ (big blind) folded on the Flop
Seat 3: u+XLsbPQIcRvPRnS1bvZww folded on the Flop
Seat 4: nmvbguGv4wKulGg49bANbQ folded before Flop (didn't bet)
Seat 6: ljemhp25Zg+nlA9DLCIiUw folded on the Flop
Seat 7: 0Cloefb0wF+uyUT5B/TK8w folded before Flop (didn't bet)
Seat 8: h4ggJZYBXV0mEZzYPYKfeA collected ($1.20)
Seat 9: N6fYvIzQLKaydFLKQGtMlQ (button) folded before Flop (didn't bet)




PokerStars Game #59939341724:  Hold'em No Limit ($0.10/$0.25) - 2009/07/01 0:37:24 ET
Table 'ROYvQOMwUrvL3SOiHYcrWg' 9-max Seat #9 is the button
Seat 1: 7q7lZBfgmzjFr0jTNx4b6g ($15.65 in chips) 
Seat 2: hBMUlEpyU74r/fwDgIpXjQ ($49.20 in chips) 
Seat 3: CYkY0dNBaYaKs8HVCVn3mQ ($7.05 in chips) 
Seat 4: SHegmCn8B0InbWE/zFlvOw ($31.30 in chips) 
Seat 5: jeKWRUkMaVn8rEUjnJKqpg ($25 in chips) 
Seat 6: ZWU9RNYtjmm4cElg1I0F4w ($31.85 in chips) 
Seat 7: tYsOBqdU1+x+yFI7zHO7hQ ($26.25 in chips) 
Seat 9: H361Owx55YUAYmPZdz+Hzg ($3.55 in chips) 
7q7lZBfgmzjFr0jTNx4b6g: posts small blind $0.10
hBMUlEpyU74r/fwDgIpXjQ: posts big blind $0.25
*** HOLE CARDS ***
CYkY0dNBaYaKs8HVCVn3mQ: folds 
SHegmCn8B0InbWE/zFlvOw: calls $0.25
jeKWRUkMaVn8rEUjnJKqpg: raises $0.75 to $1
ZWU9RNYtjmm4cElg1I0F4w: folds 
tYsOBqdU1+x+yFI7zHO7hQ: folds 
H361Owx55YUAYmPZdz+Hzg: calls $1
7q7lZBfgmzjFr0jTNx4b6g: calls $0.90
hBMUlEpyU74r/fwDgIpXjQ: folds 
SHegmCn8B0InbWE/zFlvOw: calls $0.75
*** FLOP *** [Qs 7d Ks]
7q7lZBfgmzjFr0jTNx4b6g: checks 
SHegmCn8B0InbWE/zFlvOw: bets $0.75
jeKWRUkMaVn8rEUjnJKqpg: raises $1.25 to $2
ModestZL joins the table at seat #8 
H361Owx55YUAYmPZdz+Hzg: calls $2
7q7lZBfgmzjFr0jTNx4b6g: raises $4.50 to $6.50
SHegmCn8B0InbWE/zFlvOw: folds 
jeKWRUkMaVn8rEUjnJKqpg: folds 
H361Owx55YUAYmPZdz+Hzg: calls $0.55 and is all-in
Uncalled bet ($3.95) returned to 7q7lZBfgmzjFr0jTNx4b6g
*** TURN *** [Qs 7d Ks] [5c]
*** RIVER *** [Qs 7d Ks 5c] [Js]
*** SHOW DOWN ***
7q7lZBfgmzjFr0jTNx4b6g: shows [7s 7h] (three of a kind, Sevens)
H361Owx55YUAYmPZdz+Hzg: shows [Qd Qc] (three of a kind, Queens)
H361Owx55YUAYmPZdz+Hzg collected $11.55 from pot
*** SUMMARY ***
Total pot $12.10 | Rake $0.55 
Board [Qs 7d Ks 5c Js]
Seat 1: 7q7lZBfgmzjFr0jTNx4b6g (small blind) showed [7s 7h] and lost with three of a kind, Sevens
Seat 2: hBMUlEpyU74r/fwDgIpXjQ (big blind) folded before Flop
Seat 3: CYkY0dNBaYaKs8HVCVn3mQ folded before Flop (didn't bet)
Seat 4: SHegmCn8B0InbWE/zFlvOw folded on the Flop
Seat 5: jeKWRUkMaVn8rEUjnJKqpg folded on the Flop
Seat 6: ZWU9RNYtjmm4cElg1I0F4w folded before Flop (didn't bet)
Seat 7: tYsOBqdU1+x+yFI7zHO7hQ folded before Flop (didn't bet)
Seat 9: H361Owx55YUAYmPZdz+Hzg (button) showed [Qd Qc] and won ($11.55) with three of a kind, Queens




PokerStars Game #59939342736:  Hold'em No Limit ($0.10/$0.25) - 2009/07/01 0:37:25 ET
Table 'sgB7AwZtVgDTf4fi8RwWFQ' 9-max Seat #2 is the button
Seat 1: QEbIGci+itdw+re8RM5fZA ($25 in chips) 
Seat 2: DnDcAdn9P0zGovMERigpFA ($32 in chips) 
Seat 3: OlPJsgR4xypSg/w1z7Gyvw ($19.85 in chips) 
Seat 5: gPFzi0PLRAvfKu2GYwa1VA ($16.90 in chips) 
Seat 6: 1q23ISSsSMhv2lHXBfj9/A ($23.75 in chips) 
Seat 7: j4q3p0lesp63b1gZDwLBZw ($5 in chips) 
Seat 8: Nq5F1B22aaLLZ+D9HbzcGg ($26.65 in chips) 
Seat 9: MG90wfSJZnOejs/KD3vlQQ ($32.60 in chips) 
OlPJsgR4xypSg/w1z7Gyvw: posts small blind $0.10
kymssang4: is sitting out 
kymssang4 leaves the table
gPFzi0PLRAvfKu2GYwa1VA: posts big blind $0.25
*** HOLE CARDS ***
1q23ISSsSMhv2lHXBfj9/A: folds 
j4q3p0lesp63b1gZDwLBZw: raises $0.75 to $1
Nq5F1B22aaLLZ+D9HbzcGg: raises $4 to $5
MG90wfSJZnOejs/KD3vlQQ: folds 
QEbIGci+itdw+re8RM5fZA: folds 
DnDcAdn9P0zGovMERigpFA: folds 
OlPJsgR4xypSg/w1z7Gyvw: folds 
gPFzi0PLRAvfKu2GYwa1VA: folds 
j4q3p0lesp63b1gZDwLBZw: calls $4 and is all-in
*** FLOP *** [8h 6s 2d]
*** TURN *** [8h 6s 2d] [7h]
*** RIVER *** [8h 6s 2d 7h] [4s]
*** SHOW DOWN ***
j4q3p0lesp63b1gZDwLBZw: shows [Ad Ah] (a pair of Aces)
Nq5F1B22aaLLZ+D9HbzcGg: mucks hand 
j4q3p0lesp63b1gZDwLBZw collected $9.85 from pot
*** SUMMARY ***
Total pot $10.35 | Rake $0.50 
Board [8h 6s 2d 7h 4s]
Seat 1: QEbIGci+itdw+re8RM5fZA folded before Flop (didn't bet)
Seat 2: DnDcAdn9P0zGovMERigpFA (button) folded before Flop (didn't bet)
Seat 3: OlPJsgR4xypSg/w1z7Gyvw (small blind) folded before Flop
Seat 5: gPFzi0PLRAvfKu2GYwa1VA (big blind) folded before Flop
Seat 6: 1q23ISSsSMhv2lHXBfj9/A folded before Flop (didn't bet)
Seat 7: j4q3p0lesp63b1gZDwLBZw showed [Ad Ah] and won ($9.85) with a pair of Aces
Seat 8: Nq5F1B22aaLLZ+D9HbzcGg mucked
Seat 9: MG90wfSJZnOejs/KD3vlQQ folded before Flop (didn't bet)




PokerStars Game #59939342776:  Hold'em No Limit ($0.10/$0.25) - 2009/07/01 0:37:25 ET
Table 'MiquQrQZJJq9ZtgRIp9HFQ' 6-max Seat #1 is the button
Seat 1: hM0MSDtq2ow7J40bSR04ig ($7.90 in chips) 
Seat 2: DMQLAmut/l19xN5STQndFg ($4.50 in chips) 
Seat 4: 0HIrwssk0FQvyKULzUTtlg ($16.80 in chips) 
Seat 5: LXN9U+5F+9if/ead2+w1nw ($43.65 in chips) 
DMQLAmut/l19xN5STQndFg: posts small blind $0.10
q9qPRjJC40e/Q9yuT+glwQ: is sitting out 
0HIrwssk0FQvyKULzUTtlg: posts big blind $0.25
X9oXZTg4PhZVR+ilX2OYbA: sits out 
*** HOLE CARDS ***
LXN9U+5F+9if/ead2+w1nw: raises $0.50 to $0.75
hM0MSDtq2ow7J40bSR04ig: folds 
DMQLAmut/l19xN5STQndFg: calls $0.65
0HIrwssk0FQvyKULzUTtlg: folds 
*** FLOP *** [9c 5c 7s]
DMQLAmut/l19xN5STQndFg: checks 
LXN9U+5F+9if/ead2+w1nw: bets $1.50
DMQLAmut/l19xN5STQndFg: folds 
Uncalled bet ($1.50) returned to LXN9U+5F+9if/ead2+w1nw
LXN9U+5F+9if/ead2+w1nw collected $1.70 from pot
LXN9U+5F+9if/ead2+w1nw: doesn't show hand 
*** SUMMARY ***
Total pot $1.75 | Rake $0.05 
Board [9c 5c 7s]
Seat 1: hM0MSDtq2ow7J40bSR04ig (button) folded before Flop (didn't bet)
Seat 2: DMQLAmut/l19xN5STQndFg (small blind) folded on the Flop
Seat 4: 0HIrwssk0FQvyKULzUTtlg (big blind) folded before Flop
Seat 5: LXN9U+5F+9if/ead2+w1nw collected ($1.70)




PokerStars Game #59939342556:  Hold'em No Limit ($0.10/$0.25) - 2009/07/01 0:37:25 ET
Table 'aisAlB9GIV21BwfUW3+Nbg' 9-max Seat #4 is the button
Seat 1: H5Se03ZqSX7tbULXur2MAg ($22.70 in chips) 
Seat 2: 18G4P1XstjNvItdGUITxgw ($25 in chips) 
Seat 3: aaNpjkDAbOD7pVe8Z5CEgQ ($23.90 in chips) 
Seat 4: Z9AeOQX3yzuSvKAm/xyovg ($10 in chips) 
Seat 5: ghNKXUBl/H+t83JF079ZBA ($25.10 in chips) 
Seat 6: 9gmYYQesalMrUjaF7nKfrQ ($10 in chips) 
Seat 7: sWBBy1WroEskLNyJzhkUag ($13.75 in chips) 
Seat 8: VWUWpMLMj/Q1jRVpF7Aohw ($14.40 in chips) 
Seat 9: OlPJsgR4xypSg/w1z7Gyvw ($28.80 in chips) 
ghNKXUBl/H+t83JF079ZBA: posts small blind $0.10
9gmYYQesalMrUjaF7nKfrQ: posts big blind $0.25
*** HOLE CARDS ***
sWBBy1WroEskLNyJzhkUag: folds 
VWUWpMLMj/Q1jRVpF7Aohw: folds 
OlPJsgR4xypSg/w1z7Gyvw: raises $0.75 to $1
H5Se03ZqSX7tbULXur2MAg: folds 
18G4P1XstjNvItdGUITxgw: folds 
aaNpjkDAbOD7pVe8Z5CEgQ: folds 
Z9AeOQX3yzuSvKAm/xyovg: folds 
ghNKXUBl/H+t83JF079ZBA: folds 
9gmYYQesalMrUjaF7nKfrQ: folds 
Uncalled bet ($0.75) returned to OlPJsgR4xypSg/w1z7Gyvw
OlPJsgR4xypSg/w1z7Gyvw collected $0.60 from pot
*** SUMMARY ***
Total pot $0.60 | Rake $0 
Seat 1: H5Se03ZqSX7tbULXur2MAg folded before Flop (didn't bet)
Seat 2: 18G4P1XstjNvItdGUITxgw folded before Flop (didn't bet)
Seat 3: aaNpjkDAbOD7pVe8Z5CEgQ folded before Flop (didn't bet)
Seat 4: Z9AeOQX3yzuSvKAm/xyovg (button) folded before Flop (didn't bet)
Seat 5: ghNKXUBl/H+t83JF079ZBA (small blind) folded before Flop
Seat 6: 9gmYYQesalMrUjaF7nKfrQ (big blind) folded before Flop
Seat 7: sWBBy1WroEskLNyJzhkUag folded before Flop (didn't bet)
Seat 8: VWUWpMLMj/Q1jRVpF7Aohw folded before Flop (didn't bet)
Seat 9: OlPJsgR4xypSg/w1z7Gyvw collected ($0.60)




PokerStars Game #59939342426:  Hold'em No Limit ($0.10/$0.25) - 2009/07/01 0:37:25 ET
Table '8Z6T3ssCpo3VV849U4RgBw' 9-max Seat #5 is the button
Seat 1: 8dNQBtNvCvzVgSnmDgi/LA ($12 in chips) 
Seat 2: st9jtdNbm1W5GfBwRaCVqQ ($25.80 in chips) 
Seat 3: DdPXdieucQ+n99u1n3A+rQ ($3.95 in chips) 
Seat 4: swWFmLwqgpSU1P6HAmCGPw ($16.20 in chips) 
Seat 5: zDrucyjVn5aeekNEc3cJrA ($23.55 in chips) 
Seat 6: SXqVW4Q0evTUVZG6BbUNIA ($33.15 in chips) 
Seat 7: VBHxUExRAMrbxUq/cVx9Gw ($5.50 in chips) 
Seat 8: hPhp/RE3cJ5YGaQ2xOHXXg ($5.25 in chips) 
Seat 9: yfkbMbx4w7MXhQDFPxOq0A ($12.05 in chips) 
SXqVW4Q0evTUVZG6BbUNIA: posts small blind $0.10
VBHxUExRAMrbxUq/cVx9Gw: posts big blind $0.25
*** HOLE CARDS ***
hPhp/RE3cJ5YGaQ2xOHXXg: folds 
yfkbMbx4w7MXhQDFPxOq0A: folds 
8dNQBtNvCvzVgSnmDgi/LA: folds 
st9jtdNbm1W5GfBwRaCVqQ: folds 
DdPXdieucQ+n99u1n3A+rQ: folds 
swWFmLwqgpSU1P6HAmCGPw: calls $0.25
zDrucyjVn5aeekNEc3cJrA: folds 
SXqVW4Q0evTUVZG6BbUNIA: folds 
VBHxUExRAMrbxUq/cVx9Gw: checks 
*** FLOP *** [Ah 4d Jd]
VBHxUExRAMrbxUq/cVx9Gw: checks 
swWFmLwqgpSU1P6HAmCGPw: checks 
*** TURN *** [Ah 4d Jd] [2c]
VBHxUExRAMrbxUq/cVx9Gw: bets $0.50
swWFmLwqgpSU1P6HAmCGPw: calls $0.50
*** RIVER *** [Ah 4d Jd 2c] [Jh]
VBHxUExRAMrbxUq/cVx9Gw: checks 
swWFmLwqgpSU1P6HAmCGPw: checks 
*** SHOW DOWN ***
VBHxUExRAMrbxUq/cVx9Gw: shows [6h 7s] (a pair of Jacks)
swWFmLwqgpSU1P6HAmCGPw: shows [Qd Qh] (two pair, Queens and Jacks)
swWFmLwqgpSU1P6HAmCGPw collected $1.55 from pot
*** SUMMARY ***
Total pot $1.60 | Rake $0.05 
Board [Ah 4d Jd 2c Jh]
Seat 1: 8dNQBtNvCvzVgSnmDgi/LA folded before Flop (didn't bet)
Seat 2: st9jtdNbm1W5GfBwRaCVqQ folded before Flop (didn't bet)
Seat 3: DdPXdieucQ+n99u1n3A+rQ folded before Flop (didn't bet)
Seat 4: swWFmLwqgpSU1P6HAmCGPw showed [Qd Qh] and won ($1.55) with two pair, Queens and Jacks
Seat 5: zDrucyjVn5aeekNEc3cJrA (button) folded before Flop (didn't bet)
Seat 6: SXqVW4Q0evTUVZG6BbUNIA (small blind) folded before Flop
Seat 7: VBHxUExRAMrbxUq/cVx9Gw (big blind) showed [6h 7s] and lost with a pair of Jacks
Seat 8: hPhp/RE3cJ5YGaQ2xOHXXg folded before Flop (didn't bet)
Seat 9: yfkbMbx4w7MXhQDFPxOq0A folded before Flop (didn't bet)




PokerStars Game #59939342840:  Hold'em No Limit ($0.10/$0.25) - 2009/07/01 0:37:25 ET
Table 'PCxB2W9H6ma8SwsZlImuOw' 9-max Seat #6 is the button
Seat 1: 5s3p6yoJBNW438dsyKTP8g ($32 in chips) 
Seat 2: wjH6l1gQaEfv+C45sAOwIQ ($32.20 in chips) 
Seat 3: opOCI2p6kW0tINuVaAqmcQ ($29.15 in chips) 
Seat 4: ydoFOVgzvZv9ZhuWu9rXAw ($5 in chips) 
Seat 5: h4ggJZYBXV0mEZzYPYKfeA ($23.95 in chips) 
Seat 6: E2c0EwJuNHUUdumOOgYQYA ($6.80 in chips) 
Seat 7: EfRs3ibIxn+c9JDErwwNCg ($25.35 in chips) 
Seat 8: Hdb9b2QXBH2f6YwkTgMKdQ ($4.25 in chips) 
Seat 9: LWN1wPrLH+695JIriXxDuw ($6.65 in chips) 
EfRs3ibIxn+c9JDErwwNCg: posts small blind $0.10
Hdb9b2QXBH2f6YwkTgMKdQ: posts big blind $0.25
*** HOLE CARDS ***
LWN1wPrLH+695JIriXxDuw: folds 
5s3p6yoJBNW438dsyKTP8g: folds 
wjH6l1gQaEfv+C45sAOwIQ: folds 
opOCI2p6kW0tINuVaAqmcQ: folds 
ydoFOVgzvZv9ZhuWu9rXAw: folds 
h4ggJZYBXV0mEZzYPYKfeA: folds 
E2c0EwJuNHUUdumOOgYQYA: calls $0.25
EfRs3ibIxn+c9JDErwwNCg: calls $0.15
Hdb9b2QXBH2f6YwkTgMKdQ: checks 
*** FLOP *** [5h 2s 4h]
EfRs3ibIxn+c9JDErwwNCg: checks 
Hdb9b2QXBH2f6YwkTgMKdQ: checks 
E2c0EwJuNHUUdumOOgYQYA: checks 
*** TURN *** [5h 2s 4h] [Ac]
EfRs3ibIxn+c9JDErwwNCg: checks 
Hdb9b2QXBH2f6YwkTgMKdQ: checks 
E2c0EwJuNHUUdumOOgYQYA: checks 
*** RIVER *** [5h 2s 4h Ac] [6d]
EfRs3ibIxn+c9JDErwwNCg: checks 
Hdb9b2QXBH2f6YwkTgMKdQ: checks 
E2c0EwJuNHUUdumOOgYQYA: checks 
*** SHOW DOWN ***
EfRs3ibIxn+c9JDErwwNCg: shows [Jd 8d] (high card Ace)
Hdb9b2QXBH2f6YwkTgMKdQ: shows [Qs 7d] (high card Ace - Queen kicker)
E2c0EwJuNHUUdumOOgYQYA: shows [8h Qh] (high card Ace - Queen+Eight kicker)
E2c0EwJuNHUUdumOOgYQYA collected $0.75 from pot
*** SUMMARY ***
Total pot $0.75 | Rake $0 
Board [5h 2s 4h Ac 6d]
Seat 1: 5s3p6yoJBNW438dsyKTP8g folded before Flop (didn't bet)
Seat 2: wjH6l1gQaEfv+C45sAOwIQ folded before Flop (didn't bet)
Seat 3: opOCI2p6kW0tINuVaAqmcQ folded before Flop (didn't bet)
Seat 4: ydoFOVgzvZv9ZhuWu9rXAw folded before Flop (didn't bet)
Seat 5: h4ggJZYBXV0mEZzYPYKfeA folded before Flop (didn't bet)
Seat 6: E2c0EwJuNHUUdumOOgYQYA (button) showed [8h Qh] and won ($0.75) with high card Ace
Seat 7: EfRs3ibIxn+c9JDErwwNCg (small blind) showed [Jd 8d] and lost with high card Ace
Seat 8: Hdb9b2QXBH2f6YwkTgMKdQ (big blind) showed [Qs 7d] and lost with high card Ace
Seat 9: LWN1wPrLH+695JIriXxDuw folded before Flop (didn't bet)




PokerStars Game #59939342304:  Hold'em No Limit ($0.10/$0.25) - 2009/07/01 0:37:25 ET
Table 'ONP9SkU1SytzTLuNlKzIPw' 9-max Seat #7 is the button
Seat 1: s7Q6uNouhe7aE8JdFb9E+A ($35.05 in chips) 
Seat 2: sJNHTWcSlLHRCZ9+YRLLqA ($25.25 in chips) 
Seat 4: rKgOH+UzKBirOiqIwBD9Nw ($14.15 in chips) 
Seat 5: lSeLm4BdnSMLtIli62qjAQ ($5 in chips) 
Seat 7: DiSvPC2iudwL5j9u6Huyww ($26.20 in chips) 
Seat 8: sUVgUtgbfVx6JpvApozwhQ ($5 in chips) 
sUVgUtgbfVx6JpvApozwhQ: posts small blind $0.10
s7Q6uNouhe7aE8JdFb9E+A: posts big blind $0.25
lSeLm4BdnSMLtIli62qjAQ: posts big blind $0.25
*** HOLE CARDS ***
sJNHTWcSlLHRCZ9+YRLLqA: raises $1.20 to $1.45
rKgOH+UzKBirOiqIwBD9Nw: folds 
lSeLm4BdnSMLtIli62qjAQ: folds 
DiSvPC2iudwL5j9u6Huyww: folds 
4BZw8NrbfRfUJKKKd1c2vA joins the table at seat #3 
sUVgUtgbfVx6JpvApozwhQ: folds 
6X6eofOkuCCdkJdReOpjUQ joins the table at seat #6 
s7Q6uNouhe7aE8JdFb9E+A: folds 
Uncalled bet ($1.20) returned to sJNHTWcSlLHRCZ9+YRLLqA
sJNHTWcSlLHRCZ9+YRLLqA collected $0.85 from pot
sJNHTWcSlLHRCZ9+YRLLqA: doesn't show hand 
*** SUMMARY ***
Total pot $0.85 | Rake $0 
Seat 1: s7Q6uNouhe7aE8JdFb9E+A (big blind) folded before Flop
Seat 2: sJNHTWcSlLHRCZ9+YRLLqA collected ($0.85)
Seat 4: rKgOH+UzKBirOiqIwBD9Nw folded before Flop (didn't bet)
Seat 5: lSeLm4BdnSMLtIli62qjAQ folded before Flop
Seat 7: DiSvPC2iudwL5j9u6Huyww (button) folded before Flop (didn't bet)
Seat 8: sUVgUtgbfVx6JpvApozwhQ (small blind) folded before Flop




PokerStars Game #59939342272:  Hold'em No Limit ($0.10/$0.25) - 2009/07/01 0:37:25 ET
Table 'DhkrdW2UOy2PfjSW28Kq8w' 6-max Seat #2 is the button
Seat 1: vu2kzHaDtgr6NM7rdq0chA ($32.25 in chips) 
Seat 2: v+QfkGiuj9bgtuNoVnDO8w ($25 in chips) 
Seat 3: 66a/8+qw1AZLNh63FuclPA ($44.65 in chips) 
Seat 4: I1TxPvWj8NfG8orglCinNA ($26.30 in chips) 
Seat 5: SxIIgwXYLkwd6m3wLyPTCw ($25 in chips) 
Seat 6: SS/yfeArhULzIcOPe8MdPg ($25.85 in chips) 
66a/8+qw1AZLNh63FuclPA: posts small blind $0.10
I1TxPvWj8NfG8orglCinNA: posts big blind $0.25
*** HOLE CARDS ***
SxIIgwXYLkwd6m3wLyPTCw: raises $0.50 to $0.75
SS/yfeArhULzIcOPe8MdPg: folds 
vu2kzHaDtgr6NM7rdq0chA: calls $0.75
v+QfkGiuj9bgtuNoVnDO8w: folds 
66a/8+qw1AZLNh63FuclPA: folds 
I1TxPvWj8NfG8orglCinNA: folds 
*** FLOP *** [Th Kd Js]
SxIIgwXYLkwd6m3wLyPTCw: bets $1.25
vu2kzHaDtgr6NM7rdq0chA: calls $1.25
*** TURN *** [Th Kd Js] [8s]
SxIIgwXYLkwd6m3wLyPTCw: bets $3
vu2kzHaDtgr6NM7rdq0chA: raises $4 to $7
SxIIgwXYLkwd6m3wLyPTCw: raises $16 to $23 and is all-in
vu2kzHaDtgr6NM7rdq0chA: calls $16
*** RIVER *** [Th Kd Js 8s] [Ts]
*** SHOW DOWN ***
SxIIgwXYLkwd6m3wLyPTCw: shows [Td Ks] (a full house, Tens full of Kings)
vu2kzHaDtgr6NM7rdq0chA: mucks hand 
SxIIgwXYLkwd6m3wLyPTCw collected $47.85 from pot
*** SUMMARY ***
Total pot $50.35 | Rake $2.50 
Board [Th Kd Js 8s Ts]
Seat 1: vu2kzHaDtgr6NM7rdq0chA mucked
Seat 2: v+QfkGiuj9bgtuNoVnDO8w (button) folded before Flop (didn't bet)
Seat 3: 66a/8+qw1AZLNh63FuclPA (small blind) folded before Flop
Seat 4: I1TxPvWj8NfG8orglCinNA (big blind) folded before Flop
Seat 5: SxIIgwXYLkwd6m3wLyPTCw showed [Td Ks] and won ($47.85) with a full house, Tens full of Kings
Seat 6: SS/yfeArhULzIcOPe8MdPg folded before Flop (didn't bet)




PokerStars Game #59939342394:  Hold'em No Limit ($0.10/$0.25) - 2009/07/01 0:37:25 ET
Table 'biAgO3TKQBU8XcrVAoU5TA' 6-max Seat #1 is the button
Seat 1: PIOdknsVyjKUwfiImc3zwg ($28.10 in chips) 
Seat 2: 7qRk4YH4/k/08LgJSv7rBQ ($24.75 in chips) 
Seat 3: 7AHdX4G8gYtDJyNY+wK+6Q ($29 in chips) 
Seat 4: 2/AObG8G5tKFCPZ+CdivJQ ($13.30 in chips) 
Seat 5: p6AVxoPtCVlAcAcaYyxvkQ ($19.70 in chips) 
Seat 6: //i5P+6lSkIyZsqb+ojVQA ($13.65 in chips) 
7qRk4YH4/k/08LgJSv7rBQ: posts small blind $0.10
7AHdX4G8gYtDJyNY+wK+6Q: posts big blind $0.25
*** HOLE CARDS ***
2/AObG8G5tKFCPZ+CdivJQ: folds 
p6AVxoPtCVlAcAcaYyxvkQ: raises $0.25 to $0.50
//i5P+6lSkIyZsqb+ojVQA: folds 
PIOdknsVyjKUwfiImc3zwg: folds 
7qRk4YH4/k/08LgJSv7rBQ: folds 
7AHdX4G8gYtDJyNY+wK+6Q: folds 
Uncalled bet ($0.25) returned to p6AVxoPtCVlAcAcaYyxvkQ
p6AVxoPtCVlAcAcaYyxvkQ collected $0.60 from pot
p6AVxoPtCVlAcAcaYyxvkQ: doesn't show hand 
*** SUMMARY ***
Total pot $0.60 | Rake $0 
Seat 1: PIOdknsVyjKUwfiImc3zwg (button) folded before Flop (didn't bet)
Seat 2: 7qRk4YH4/k/08LgJSv7rBQ (small blind) folded before Flop
Seat 3: 7AHdX4G8gYtDJyNY+wK+6Q (big blind) folded before Flop
Seat 4: 2/AObG8G5tKFCPZ+CdivJQ folded before Flop (didn't bet)
Seat 5: p6AVxoPtCVlAcAcaYyxvkQ collected ($0.60)
Seat 6: //i5P+6lSkIyZsqb+ojVQA folded before Flop (didn't bet)




PokerStars Game #59939342886:  Hold'em No Limit ($0.10/$0.25) - 2009/07/01 0:37:25 ET
Table 'fRxOyfaHXkWUDLv4eSxFew' 9-max Seat #2 is the button
Seat 2: TeWJxSETzbXGiYKx0y+dtg ($24.30 in chips) 
Seat 3: hBMUlEpyU74r/fwDgIpXjQ ($25.45 in chips) 
Seat 4: aCVg6cCxQcqClhB9nq/p1w ($52.60 in chips) 
Seat 6: N/O9ADKpmqB2ASZuqgodlw ($5.40 in chips) 
Seat 7: 7cv+9Zc9HIQHNvYsMfV3uA ($54.40 in chips) 
Seat 8: 1K6QGyJP9P9xmRac2fH4OQ ($25 in chips) 
Seat 9: H5Se03ZqSX7tbULXur2MAg ($24.05 in chips) 
hBMUlEpyU74r/fwDgIpXjQ: posts small blind $0.10
aCVg6cCxQcqClhB9nq/p1w: posts big blind $0.25
OlPJsgR4xypSg/w1z7Gyvw: sits out 
*** HOLE CARDS ***
N/O9ADKpmqB2ASZuqgodlw: calls $0.25
7cv+9Zc9HIQHNvYsMfV3uA: folds 
1K6QGyJP9P9xmRac2fH4OQ: folds 
H5Se03ZqSX7tbULXur2MAg: calls $0.25
TeWJxSETzbXGiYKx0y+dtg: folds 
hBMUlEpyU74r/fwDgIpXjQ: calls $0.15
aCVg6cCxQcqClhB9nq/p1w: checks 
*** FLOP *** [Qc As 9c]
hBMUlEpyU74r/fwDgIpXjQ: checks 
aCVg6cCxQcqClhB9nq/p1w: bets $0.25
N/O9ADKpmqB2ASZuqgodlw: calls $0.25
H5Se03ZqSX7tbULXur2MAg: folds 
hBMUlEpyU74r/fwDgIpXjQ: folds 
*** TURN *** [Qc As 9c] [Th]
aCVg6cCxQcqClhB9nq/p1w: bets $0.25
N/O9ADKpmqB2ASZuqgodlw: calls $0.25
*** RIVER *** [Qc As 9c Th] [7d]
aCVg6cCxQcqClhB9nq/p1w: bets $0.25
N/O9ADKpmqB2ASZuqgodlw: raises $1.75 to $2
aCVg6cCxQcqClhB9nq/p1w: folds 
Uncalled bet ($1.75) returned to N/O9ADKpmqB2ASZuqgodlw
N/O9ADKpmqB2ASZuqgodlw collected $2.40 from pot
*** SUMMARY ***
Total pot $2.50 | Rake $0.10 
Board [Qc As 9c Th 7d]
Seat 2: TeWJxSETzbXGiYKx0y+dtg (button) folded before Flop (didn't bet)
Seat 3: hBMUlEpyU74r/fwDgIpXjQ (small blind) folded on the Flop
Seat 4: aCVg6cCxQcqClhB9nq/p1w (big blind) folded on the River
Seat 6: N/O9ADKpmqB2ASZuqgodlw collected ($2.40)
Seat 7: 7cv+9Zc9HIQHNvYsMfV3uA folded before Flop (didn't bet)
Seat 8: 1K6QGyJP9P9xmRac2fH4OQ folded before Flop (didn't bet)
Seat 9: H5Se03ZqSX7tbULXur2MAg folded on the Flop




PokerStars Game #59939342622:  Hold'em No Limit ($0.10/$0.25) - 2009/07/01 0:37:25 ET
Table 'sJ4KpS2GE5Qrsu1/cFjJUw' 9-max Seat #5 is the button
Seat 3: eDil7UzSZCjyh1VP6SVXJQ ($6.75 in chips) 
Seat 5: Yv4fucyyT28mjx8V5lxKJg ($22.90 in chips) 
Seat 8: f8ixGbSVIs6Be0mH69ldVQ ($14.95 in chips) 
f8ixGbSVIs6Be0mH69ldVQ: posts small blind $0.10
eDil7UzSZCjyh1VP6SVXJQ: posts big blind $0.25
*** HOLE CARDS ***
Yv4fucyyT28mjx8V5lxKJg: folds 
Yv4fucyyT28mjx8V5lxKJg leaves the table
f8ixGbSVIs6Be0mH69ldVQ: calls $0.15
eDil7UzSZCjyh1VP6SVXJQ: checks 
*** FLOP *** [Td 9h Ks]
f8ixGbSVIs6Be0mH69ldVQ: checks 
eDil7UzSZCjyh1VP6SVXJQ: checks 
*** TURN *** [Td 9h Ks] [8h]
f8ixGbSVIs6Be0mH69ldVQ: bets $0.25
eDil7UzSZCjyh1VP6SVXJQ: calls $0.25
*** RIVER *** [Td 9h Ks 8h] [3c]
f8ixGbSVIs6Be0mH69ldVQ: checks 
eDil7UzSZCjyh1VP6SVXJQ: checks 
*** SHOW DOWN ***
f8ixGbSVIs6Be0mH69ldVQ: shows [5d 9d] (a pair of Nines)
QsLvCwfSWqP+CfjwUnjpXQ joins the table at seat #1 
eDil7UzSZCjyh1VP6SVXJQ: mucks hand 
f8ixGbSVIs6Be0mH69ldVQ collected $0.95 from pot
*** SUMMARY ***
Total pot $1 | Rake $0.05 
Board [Td 9h Ks 8h 3c]
Seat 3: eDil7UzSZCjyh1VP6SVXJQ (big blind) mucked
Seat 5: Yv4fucyyT28mjx8V5lxKJg (button) folded before Flop (didn't bet)
Seat 8: f8ixGbSVIs6Be0mH69ldVQ (small blind) showed [5d 9d] and won ($0.95) with a pair of Nines




PokerStars Game #59939342912:  Hold'em No Limit ($0.10/$0.25) - 2009/07/01 0:37:26 ET
Table 'vFZR6Kf2Th5xBXT9brGW6A' 6-max Seat #6 is the button
Seat 1: xRkU4+naLuz7dEZFbOn9cw ($35.40 in chips) 
Seat 2: REnO5xiZ66YabxDXq2ncvA ($50.65 in chips) 
Seat 4: 79ID/ub1Pt/mDpCprVmOoA ($25.35 in chips) 
Seat 5: NhUN/JpAprdJeamFBgJH1w ($25.35 in chips) 
Seat 6: d0J1xuhsynEY81YHwAvJ5g ($25 in chips) 
xRkU4+naLuz7dEZFbOn9cw: posts small blind $0.10
REnO5xiZ66YabxDXq2ncvA: posts big blind $0.25
*** HOLE CARDS ***
79ID/ub1Pt/mDpCprVmOoA: raises $0.50 to $0.75
NhUN/JpAprdJeamFBgJH1w: folds 
d0J1xuhsynEY81YHwAvJ5g: folds 
xRkU4+naLuz7dEZFbOn9cw: folds 
REnO5xiZ66YabxDXq2ncvA: calls $0.50
*** FLOP *** [Qh Kc As]
REnO5xiZ66YabxDXq2ncvA: checks 
79ID/ub1Pt/mDpCprVmOoA: checks 
*** TURN *** [Qh Kc As] [9c]
REnO5xiZ66YabxDXq2ncvA: checks 
79ID/ub1Pt/mDpCprVmOoA: checks 
*** RIVER *** [Qh Kc As 9c] [7c]
REnO5xiZ66YabxDXq2ncvA: checks 
79ID/ub1Pt/mDpCprVmOoA: checks 
*** SHOW DOWN ***
REnO5xiZ66YabxDXq2ncvA: shows [2h Kh] (a pair of Kings)
79ID/ub1Pt/mDpCprVmOoA: mucks hand 
REnO5xiZ66YabxDXq2ncvA collected $1.55 from pot
*** SUMMARY ***
Total pot $1.60 | Rake $0.05 
Board [Qh Kc As 9c 7c]
Seat 1: xRkU4+naLuz7dEZFbOn9cw (small blind) folded before Flop
Seat 2: REnO5xiZ66YabxDXq2ncvA (big blind) showed [2h Kh] and won ($1.55) with a pair of Kings
Seat 4: 79ID/ub1Pt/mDpCprVmOoA mucked
Seat 5: NhUN/JpAprdJeamFBgJH1w folded before Flop (didn't bet)
Seat 6: d0J1xuhsynEY81YHwAvJ5g (button) folded before Flop (didn't bet)




PokerStars Game #59939343420:  Hold'em No Limit ($0.10/$0.25) - 2009/07/01 0:37:26 ET
Table 'nteM56rtr9SxLEblf0fvbw' 9-max Seat #8 is the button
Seat 1: H9KUl8cmpLgEpOVDA00bCg ($5 in chips) 
Seat 2: ljemhp25Zg+nlA9DLCIiUw ($25.95 in chips) 
Seat 4: cZ99hugmLBj9KhTlc8nCSw ($25.15 in chips) 
Seat 5: aJy680tKSaP5er559aSuGA ($10.45 in chips) 
Seat 7: dfNim92Z6XK1/h5SFW5vDg ($44.30 in chips) 
Seat 8: RJ/x9oZtt1RZLaJEQwZOxQ ($44.15 in chips) 
Seat 9: t2nb95S5EEFOEzNx9Itz0g ($7 in chips) 
t2nb95S5EEFOEzNx9Itz0g: posts small blind $0.10
H9KUl8cmpLgEpOVDA00bCg: posts big blind $0.25
*** HOLE CARDS ***
ljemhp25Zg+nlA9DLCIiUw: raises $0.50 to $0.75
cZ99hugmLBj9KhTlc8nCSw: folds 
aJy680tKSaP5er559aSuGA: folds 
dfNim92Z6XK1/h5SFW5vDg: folds 
RJ/x9oZtt1RZLaJEQwZOxQ: folds 
t2nb95S5EEFOEzNx9Itz0g: folds 
H9KUl8cmpLgEpOVDA00bCg: folds 
Uncalled bet ($0.50) returned to ljemhp25Zg+nlA9DLCIiUw
ljemhp25Zg+nlA9DLCIiUw collected $0.60 from pot
ljemhp25Zg+nlA9DLCIiUw: doesn't show hand 
*** SUMMARY ***
Total pot $0.60 | Rake $0 
Seat 1: H9KUl8cmpLgEpOVDA00bCg (big blind) folded before Flop
Seat 2: ljemhp25Zg+nlA9DLCIiUw collected ($0.60)
Seat 4: cZ99hugmLBj9KhTlc8nCSw folded before Flop (didn't bet)
Seat 5: aJy680tKSaP5er559aSuGA folded before Flop (didn't bet)
Seat 7: dfNim92Z6XK1/h5SFW5vDg folded before Flop (didn't bet)
Seat 8: RJ/x9oZtt1RZLaJEQwZOxQ (button) folded before Flop (didn't bet)
Seat 9: t2nb95S5EEFOEzNx9Itz0g (small blind) folded before Flop




PokerStars Game #59939343326:  Hold'em No Limit ($0.10/$0.25) - 2009/07/01 0:37:26 ET
Table '+fuYjvJy9okLr23QyZtanA' 9-max Seat #1 is the button
Seat 1: s7Q6uNouhe7aE8JdFb9E+A ($29.05 in chips) 
Seat 4: H/l9NZvuOXwQIPOaVdj0rQ ($11.30 in chips) 
s7Q6uNouhe7aE8JdFb9E+A: posts small blind $0.10
H/l9NZvuOXwQIPOaVdj0rQ: posts big blind $0.25
*** HOLE CARDS ***
s7Q6uNouhe7aE8JdFb9E+A: raises $0.25 to $0.50
H/l9NZvuOXwQIPOaVdj0rQ: calls $0.25
*** FLOP *** [Kd 3d 8s]
H/l9NZvuOXwQIPOaVdj0rQ: checks 
s7Q6uNouhe7aE8JdFb9E+A: bets $0.65
H/l9NZvuOXwQIPOaVdj0rQ: folds 
Uncalled bet ($0.65) returned to s7Q6uNouhe7aE8JdFb9E+A
s7Q6uNouhe7aE8JdFb9E+A collected $0.95 from pot
s7Q6uNouhe7aE8JdFb9E+A: doesn't show hand 
*** SUMMARY ***
Total pot $1 | Rake $0.05 
Board [Kd 3d 8s]
Seat 1: s7Q6uNouhe7aE8JdFb9E+A (button) (small blind) collected ($0.95)
Seat 4: H/l9NZvuOXwQIPOaVdj0rQ (big blind) folded on the Flop




PokerStars Game #59939342932:  Hold'em No Limit ($0.10/$0.25) - 2009/07/01 0:37:26 ET
Table 'wixGE3Zge1qBdnpWijIl/w' 9-max Seat #9 is the button
Seat 1: EcWpc/mcsCWBGKsSdZaXbA ($24.75 in chips) 
Seat 2: vbD+Kd6m/X3hUBBcGpUKjA ($8.45 in chips) 
Seat 3: DdPXdieucQ+n99u1n3A+rQ ($5 in chips) 
Seat 4: 4oA316mXLIui1QY63GXBUg ($25 in chips) 
Seat 5: MIVCHqCqqlke0Lb0z7glcw ($27.05 in chips) 
Seat 6: TlEYI/zXzaKGGsmuvWFd2A ($17.45 in chips) 
Seat 7: qIaaweMCAGmy9HZFT4r/6A ($54.60 in chips) 
Seat 8: hIss79a4pu7GzJZepfgOpg ($25 in chips) 
Seat 9: r6hsffOo1iKmaPYKwAZmFw ($25.15 in chips) 
EcWpc/mcsCWBGKsSdZaXbA: posts small blind $0.10
vbD+Kd6m/X3hUBBcGpUKjA: posts big blind $0.25
*** HOLE CARDS ***
DdPXdieucQ+n99u1n3A+rQ: folds 
4oA316mXLIui1QY63GXBUg: folds 
MIVCHqCqqlke0Lb0z7glcw: folds 
TlEYI/zXzaKGGsmuvWFd2A: folds 
qIaaweMCAGmy9HZFT4r/6A: raises $0.25 to $0.50
hIss79a4pu7GzJZepfgOpg: folds 
r6hsffOo1iKmaPYKwAZmFw: folds 
EcWpc/mcsCWBGKsSdZaXbA: folds 
vbD+Kd6m/X3hUBBcGpUKjA: calls $0.25
*** FLOP *** [7d Tc 4h]
vbD+Kd6m/X3hUBBcGpUKjA: checks 
qIaaweMCAGmy9HZFT4r/6A: checks 
*** TURN *** [7d Tc 4h] [Ah]
vbD+Kd6m/X3hUBBcGpUKjA: checks 
qIaaweMCAGmy9HZFT4r/6A: checks 
*** RIVER *** [7d Tc 4h Ah] [5s]
vbD+Kd6m/X3hUBBcGpUKjA: checks 
qIaaweMCAGmy9HZFT4r/6A: bets $1
vbD+Kd6m/X3hUBBcGpUKjA: folds 
Uncalled bet ($1) returned to qIaaweMCAGmy9HZFT4r/6A
qIaaweMCAGmy9HZFT4r/6A collected $1.05 from pot
qIaaweMCAGmy9HZFT4r/6A: doesn't show hand 
*** SUMMARY ***
Total pot $1.10 | Rake $0.05 
Board [7d Tc 4h Ah 5s]
Seat 1: EcWpc/mcsCWBGKsSdZaXbA (small blind) folded before Flop
Seat 2: vbD+Kd6m/X3hUBBcGpUKjA (big blind) folded on the River
Seat 3: DdPXdieucQ+n99u1n3A+rQ folded before Flop (didn't bet)
Seat 4: 4oA316mXLIui1QY63GXBUg folded before Flop (didn't bet)
Seat 5: MIVCHqCqqlke0Lb0z7glcw folded before Flop (didn't bet)
Seat 6: TlEYI/zXzaKGGsmuvWFd2A folded before Flop (didn't bet)
Seat 7: qIaaweMCAGmy9HZFT4r/6A collected ($1.05)
Seat 8: hIss79a4pu7GzJZepfgOpg folded before Flop (didn't bet)
Seat 9: r6hsffOo1iKmaPYKwAZmFw (button) folded before Flop (didn't bet)




PokerStars Game #59939342938:  Hold'em No Limit ($0.10/$0.25) - 2009/07/01 0:37:26 ET
Table 'rO1I30HnuCPB0M8qEX1TCQ' 9-max Seat #9 is the button
Seat 1: P32tOtZSz+L5ekobAPq2DA ($4.20 in chips) 
Seat 2: 33y9+GmQ3J84RvZXcraRTw ($22.05 in chips) 
Seat 3: 8Waresd9ixnijISc3GUypg ($12.70 in chips) 
Seat 4: spidnpwmoJ1L6yeNW7D5UA ($24.75 in chips) 
Seat 5: HVKi9hnDyvzObpL08/OarQ ($24.75 in chips) 
Seat 6: 6LFELL8V3NTpb0xg7AOyEg ($16.35 in chips) 
Seat 7: 4oA316mXLIui1QY63GXBUg ($30.75 in chips) 
Seat 8: DIBbjEYGs+TVdVgEB/4+3w ($37 in chips) 
Seat 9: PrviAnKmKklf+We6cR33cw ($30.75 in chips) 
P32tOtZSz+L5ekobAPq2DA: posts small blind $0.10
33y9+GmQ3J84RvZXcraRTw: posts big blind $0.25
*** HOLE CARDS ***
8Waresd9ixnijISc3GUypg: raises $0.50 to $0.75
spidnpwmoJ1L6yeNW7D5UA: calls $0.75
HVKi9hnDyvzObpL08/OarQ: folds 
6LFELL8V3NTpb0xg7AOyEg: folds 
4oA316mXLIui1QY63GXBUg: folds 
DIBbjEYGs+TVdVgEB/4+3w: folds 
PrviAnKmKklf+We6cR33cw: folds 
P32tOtZSz+L5ekobAPq2DA: folds 
33y9+GmQ3J84RvZXcraRTw: calls $0.50
*** FLOP *** [Ts Ks 6d]
33y9+GmQ3J84RvZXcraRTw: checks 
8Waresd9ixnijISc3GUypg: bets $0.75
spidnpwmoJ1L6yeNW7D5UA: folds 
33y9+GmQ3J84RvZXcraRTw: folds 
Uncalled bet ($0.75) returned to 8Waresd9ixnijISc3GUypg
8Waresd9ixnijISc3GUypg collected $2.25 from pot
8Waresd9ixnijISc3GUypg: doesn't show hand 
*** SUMMARY ***
Total pot $2.35 | Rake $0.10 
Board [Ts Ks 6d]
Seat 1: P32tOtZSz+L5ekobAPq2DA (small blind) folded before Flop
Seat 2: 33y9+GmQ3J84RvZXcraRTw (big blind) folded on the Flop
Seat 3: 8Waresd9ixnijISc3GUypg collected ($2.25)
Seat 4: spidnpwmoJ1L6yeNW7D5UA folded on the Flop
Seat 5: HVKi9hnDyvzObpL08/OarQ folded before Flop (didn't bet)
Seat 6: 6LFELL8V3NTpb0xg7AOyEg folded before Flop (didn't bet)
Seat 7: 4oA316mXLIui1QY63GXBUg folded before Flop (didn't bet)
Seat 8: DIBbjEYGs+TVdVgEB/4+3w folded before Flop (didn't bet)
Seat 9: PrviAnKmKklf+We6cR33cw (button) folded before Flop (didn't bet)




PokerStars Game #59939343742:  Hold'em No Limit ($0.10/$0.25) - 2009/07/01 0:37:27 ET
Table 'gYBWJG3hEuJg6kphY0yhMg' 9-max Seat #8 is the button
Seat 1: s7Q6uNouhe7aE8JdFb9E+A ($25.60 in chips) 
Seat 2: z2SmIaQ3+5n/eY1BN5HgPg ($12.50 in chips) 
Seat 3: OkWGxhGhDA0lvNLGWmJxug ($9.10 in chips) 
Seat 4: Djvxz2YXy0NdYfTgO6Iunw ($5.50 in chips) 
Seat 5: +sbyWwIcFp9kP0bDtMegfQ ($24.55 in chips) 
Seat 6: 9AI+W5n0har4qZZPPHsjKg ($4.65 in chips) 
Seat 7: xqvFhQD+76TQUT0AVOUMAg ($28 in chips) 
Seat 8: vEUoHYHDD7ub+fv3nZfhVw ($14.15 in chips) 
Seat 9: DxA2S3LbITR502Wya4qTnw ($2.55 in chips) 
DxA2S3LbITR502Wya4qTnw: posts small blind $0.10
s7Q6uNouhe7aE8JdFb9E+A: posts big blind $0.25
*** HOLE CARDS ***
z2SmIaQ3+5n/eY1BN5HgPg: folds 
OkWGxhGhDA0lvNLGWmJxug: raises $0.50 to $0.75
Djvxz2YXy0NdYfTgO6Iunw: folds 
+sbyWwIcFp9kP0bDtMegfQ: folds 
9AI+W5n0har4qZZPPHsjKg: folds 
xqvFhQD+76TQUT0AVOUMAg: folds 
vEUoHYHDD7ub+fv3nZfhVw: folds 
DxA2S3LbITR502Wya4qTnw: folds 
s7Q6uNouhe7aE8JdFb9E+A: folds 
Uncalled bet ($0.50) returned to OkWGxhGhDA0lvNLGWmJxug
OkWGxhGhDA0lvNLGWmJxug collected $0.60 from pot
OkWGxhGhDA0lvNLGWmJxug: shows [Qd As] (high card Ace)
*** SUMMARY ***
Total pot $0.60 | Rake $0 
Seat 1: s7Q6uNouhe7aE8JdFb9E+A (big blind) folded before Flop
Seat 2: z2SmIaQ3+5n/eY1BN5HgPg folded before Flop (didn't bet)
Seat 3: OkWGxhGhDA0lvNLGWmJxug collected ($0.60)
Seat 4: Djvxz2YXy0NdYfTgO6Iunw folded before Flop (didn't bet)
Seat 5: +sbyWwIcFp9kP0bDtMegfQ folded before Flop (didn't bet)
Seat 6: 9AI+W5n0har4qZZPPHsjKg folded before Flop (didn't bet)
Seat 7: xqvFhQD+76TQUT0AVOUMAg folded before Flop (didn't bet)
Seat 8: vEUoHYHDD7ub+fv3nZfhVw (button) folded before Flop (didn't bet)
Seat 9: DxA2S3LbITR502Wya4qTnw (small blind) folded before Flop




PokerStars Game #59939343714:  Hold'em No Limit ($0.10/$0.25) - 2009/07/01 0:37:27 ET
Table '50f2Xa1b1jp6cfdTAgXFIg' 9-max Seat #5 is the button
Seat 1: JwUqpgqGHS96sdpExhhEqw ($8.60 in chips) 
Seat 2: OfGfQFPcghysTDljS9GQSQ ($18.50 in chips) 
Seat 3: aZHZRdpOTHSm1zLmzd6+ww ($25 in chips) 
Seat 4: ghNKXUBl/H+t83JF079ZBA ($25.25 in chips) 
Seat 5: OlPJsgR4xypSg/w1z7Gyvw ($55.75 in chips) 
Seat 6: Vl8zO7J9ZOnk8Og8eXFezg ($40.50 in chips) 
Seat 7: TeWJxSETzbXGiYKx0y+dtg ($25 in chips) 
Seat 8: jeKWRUkMaVn8rEUjnJKqpg ($25.35 in chips) 
Seat 9: gehe91e0IyVT0QU/XBkEyg ($25 in chips) 
Vl8zO7J9ZOnk8Og8eXFezg: posts small blind $0.10
TeWJxSETzbXGiYKx0y+dtg: posts big blind $0.25
*** HOLE CARDS ***
jeKWRUkMaVn8rEUjnJKqpg: folds 
gehe91e0IyVT0QU/XBkEyg: folds 
JwUqpgqGHS96sdpExhhEqw: folds 
OfGfQFPcghysTDljS9GQSQ: folds 
aZHZRdpOTHSm1zLmzd6+ww: calls $0.25
ghNKXUBl/H+t83JF079ZBA: calls $0.25
OlPJsgR4xypSg/w1z7Gyvw: folds 
Vl8zO7J9ZOnk8Og8eXFezg: folds 
TeWJxSETzbXGiYKx0y+dtg: checks 
*** FLOP *** [8s 2h Kd]
TeWJxSETzbXGiYKx0y+dtg: checks 
aZHZRdpOTHSm1zLmzd6+ww: checks 
ghNKXUBl/H+t83JF079ZBA: bets $0.60
TeWJxSETzbXGiYKx0y+dtg: folds 
aZHZRdpOTHSm1zLmzd6+ww: folds 
Uncalled bet ($0.60) returned to ghNKXUBl/H+t83JF079ZBA
ghNKXUBl/H+t83JF079ZBA collected $0.85 from pot
*** SUMMARY ***
Total pot $0.85 | Rake $0 
Board [8s 2h Kd]
Seat 1: JwUqpgqGHS96sdpExhhEqw folded before Flop (didn't bet)
Seat 2: OfGfQFPcghysTDljS9GQSQ folded before Flop (didn't bet)
Seat 3: aZHZRdpOTHSm1zLmzd6+ww folded on the Flop
Seat 4: ghNKXUBl/H+t83JF079ZBA collected ($0.85)
Seat 5: OlPJsgR4xypSg/w1z7Gyvw (button) folded before Flop (didn't bet)
Seat 6: Vl8zO7J9ZOnk8Og8eXFezg (small blind) folded before Flop
Seat 7: TeWJxSETzbXGiYKx0y+dtg (big blind) folded on the Flop
Seat 8: jeKWRUkMaVn8rEUjnJKqpg folded before Flop (didn't bet)
Seat 9: gehe91e0IyVT0QU/XBkEyg folded before Flop (didn't bet)




PokerStars Game #59939344086:  Hold'em No Limit ($0.10/$0.25) - 2009/07/01 0:37:27 ET
Table 'yAHDCs33TIgw3ra63xuU2Q' 9-max Seat #5 is the button
Seat 1: 8B/dhbQjIWe6ASCdgzktNQ ($26.15 in chips) 
Seat 2: LBrhQVB4w41YNd7kMYn/og ($19.35 in chips) 
Seat 3: H9KUl8cmpLgEpOVDA00bCg ($4.30 in chips) 
Seat 4: rUdM7gwmNCaxMNSb2CFPhQ ($11 in chips) 
Seat 5: 4awUyiDYTgylQKXZ9faBVA ($25 in chips) 
Seat 6: cjelr2AqqD7It1Q2TXfgTQ ($6.15 in chips) 
Seat 7: OiV1PWZ3IkN29JlmCcnTwQ ($4.55 in chips) 
Seat 8: tYsOBqdU1+x+yFI7zHO7hQ ($28.10 in chips) 
Seat 9: k+ydNCnnP3Hgwh0AnDYVrA ($5.85 in chips) 
cjelr2AqqD7It1Q2TXfgTQ: posts small blind $0.10
OiV1PWZ3IkN29JlmCcnTwQ: posts big blind $0.25
*** HOLE CARDS ***
tYsOBqdU1+x+yFI7zHO7hQ: folds 
k+ydNCnnP3Hgwh0AnDYVrA: calls $0.25
8B/dhbQjIWe6ASCdgzktNQ: folds 
LBrhQVB4w41YNd7kMYn/og: folds 
H9KUl8cmpLgEpOVDA00bCg: folds 
rUdM7gwmNCaxMNSb2CFPhQ: folds 
4awUyiDYTgylQKXZ9faBVA: raises $1 to $1.25
cjelr2AqqD7It1Q2TXfgTQ: calls $1.15
OiV1PWZ3IkN29JlmCcnTwQ: folds 
k+ydNCnnP3Hgwh0AnDYVrA: calls $1
*** FLOP *** [Qd As Tc]
cjelr2AqqD7It1Q2TXfgTQ: bets $0.50
k+ydNCnnP3Hgwh0AnDYVrA: raises $0.50 to $1
4awUyiDYTgylQKXZ9faBVA: folds 
cjelr2AqqD7It1Q2TXfgTQ: folds 
Uncalled bet ($0.50) returned to k+ydNCnnP3Hgwh0AnDYVrA
k+ydNCnnP3Hgwh0AnDYVrA collected $4.80 from pot
k+ydNCnnP3Hgwh0AnDYVrA: doesn't show hand 
*** SUMMARY ***
Total pot $5 | Rake $0.20 
Board [Qd As Tc]
Seat 1: 8B/dhbQjIWe6ASCdgzktNQ folded before Flop (didn't bet)
Seat 2: LBrhQVB4w41YNd7kMYn/og folded before Flop (didn't bet)
Seat 3: H9KUl8cmpLgEpOVDA00bCg folded before Flop (didn't bet)
Seat 4: rUdM7gwmNCaxMNSb2CFPhQ folded before Flop (didn't bet)
Seat 5: 4awUyiDYTgylQKXZ9faBVA (button) folded on the Flop
Seat 6: cjelr2AqqD7It1Q2TXfgTQ (small blind) folded on the Flop
Seat 7: OiV1PWZ3IkN29JlmCcnTwQ (big blind) folded before Flop
Seat 8: tYsOBqdU1+x+yFI7zHO7hQ folded before Flop (didn't bet)
Seat 9: k+ydNCnnP3Hgwh0AnDYVrA collected ($4.80)




PokerStars Game #59939343820:  Hold'em No Limit ($0.10/$0.25) - 2009/07/01 0:37:27 ET
Table 'sIHZ0lzLr4NGCaBUKhmYhA' 6-max Seat #5 is the button
Seat 1: q6WfTUAD9mowIP63ASq2Dg ($34.20 in chips) 
Seat 2: 1xmHIWgZaOCqEMnW2GkFfw ($11 in chips) 
Seat 3: SxIIgwXYLkwd6m3wLyPTCw ($25 in chips) 
Seat 4: 4YSTu0Cdzpppe1lUgCZGCQ ($33.90 in chips) 
Seat 5: q9qPRjJC40e/Q9yuT+glwQ ($25.85 in chips) 
q6WfTUAD9mowIP63ASq2Dg: posts small blind $0.10
1xmHIWgZaOCqEMnW2GkFfw: posts big blind $0.25
*** HOLE CARDS ***
SxIIgwXYLkwd6m3wLyPTCw: folds 
4YSTu0Cdzpppe1lUgCZGCQ: folds 
q9qPRjJC40e/Q9yuT+glwQ: folds 
q6WfTUAD9mowIP63ASq2Dg: folds 
Uncalled bet ($0.15) returned to 1xmHIWgZaOCqEMnW2GkFfw
1xmHIWgZaOCqEMnW2GkFfw collected $0.20 from pot
1xmHIWgZaOCqEMnW2GkFfw: doesn't show hand 
*** SUMMARY ***
Total pot $0.20 | Rake $0 
Seat 1: q6WfTUAD9mowIP63ASq2Dg (small blind) folded before Flop
Seat 2: 1xmHIWgZaOCqEMnW2GkFfw (big blind) collected ($0.20)
Seat 3: SxIIgwXYLkwd6m3wLyPTCw folded before Flop (didn't bet)
Seat 4: 4YSTu0Cdzpppe1lUgCZGCQ folded before Flop (didn't bet)
Seat 5: q9qPRjJC40e/Q9yuT+glwQ (button) folded before Flop (didn't bet)




PokerStars Game #59939343926:  Hold'em No Limit ($0.10/$0.25) - 2009/07/01 0:37:27 ET
Table 'luMgmRPIo47e7iXDlheIwA' 6-max Seat #2 is the button
Seat 2: 4YSTu0Cdzpppe1lUgCZGCQ ($41.95 in chips) 
Seat 4: n2OZezRXTtdzQt4SuIy8TQ ($19.30 in chips) 
Seat 5: kG34n23qFQA3nzdOJTQ1dA ($47.25 in chips) 
n2OZezRXTtdzQt4SuIy8TQ: posts small blind $0.10
kG34n23qFQA3nzdOJTQ1dA: posts big blind $0.25
*** HOLE CARDS ***
4YSTu0Cdzpppe1lUgCZGCQ: folds 
n2OZezRXTtdzQt4SuIy8TQ: raises $0.75 to $1
kG34n23qFQA3nzdOJTQ1dA: folds 
Uncalled bet ($0.75) returned to n2OZezRXTtdzQt4SuIy8TQ
n2OZezRXTtdzQt4SuIy8TQ collected $0.50 from pot
*** SUMMARY ***
Total pot $0.50 | Rake $0 
Seat 2: 4YSTu0Cdzpppe1lUgCZGCQ (button) folded before Flop (didn't bet)
Seat 4: n2OZezRXTtdzQt4SuIy8TQ (small blind) collected ($0.50)
Seat 5: kG34n23qFQA3nzdOJTQ1dA (big blind) folded before Flop




PokerStars Game #59939343978:  Hold'em No Limit ($0.10/$0.25) - 2009/07/01 0:37:27 ET
Table 'P2yJ+jwfNsBdF12fLKA6DQ' 9-max Seat #3 is the button
Seat 1: zDrucyjVn5aeekNEc3cJrA ($26.25 in chips) 
Seat 2: A1WO60C/QOiRxQuPxxQ/Qw ($22.80 in chips) 
Seat 3: aNpwfA31EREwO+ar4XzBCw ($26.85 in chips) 
Seat 4: dfNim92Z6XK1/h5SFW5vDg ($25.10 in chips) 
Seat 5: KUcJLaHvrSlvGyIGqDQp9A ($9.55 in chips) 
Seat 8: LWN1wPrLH+695JIriXxDuw ($4.20 in chips) 
dfNim92Z6XK1/h5SFW5vDg: posts small blind $0.10
KUcJLaHvrSlvGyIGqDQp9A: posts big blind $0.25
tIIUJycKjdqE3z/SXWAEwA: sits out 
guerita69: sits out 
*** HOLE CARDS ***
LWN1wPrLH+695JIriXxDuw: folds 
Jurq55Mpn9JwRMif6CgVxw has returned
zDrucyjVn5aeekNEc3cJrA: folds 
A1WO60C/QOiRxQuPxxQ/Qw: folds 
aNpwfA31EREwO+ar4XzBCw: raises $0.75 to $1
dfNim92Z6XK1/h5SFW5vDg: folds 
KUcJLaHvrSlvGyIGqDQp9A: folds 
Uncalled bet ($0.75) returned to aNpwfA31EREwO+ar4XzBCw
aNpwfA31EREwO+ar4XzBCw collected $0.60 from pot
aNpwfA31EREwO+ar4XzBCw: doesn't show hand 
*** SUMMARY ***
Total pot $0.60 | Rake $0 
Seat 1: zDrucyjVn5aeekNEc3cJrA folded before Flop (didn't bet)
Seat 2: A1WO60C/QOiRxQuPxxQ/Qw folded before Flop (didn't bet)
Seat 3: aNpwfA31EREwO+ar4XzBCw (button) collected ($0.60)
Seat 4: dfNim92Z6XK1/h5SFW5vDg (small blind) folded before Flop
Seat 5: KUcJLaHvrSlvGyIGqDQp9A (big blind) folded before Flop
Seat 8: LWN1wPrLH+695JIriXxDuw folded before Flop (didn't bet)




PokerStars Game #59939343610:  Hold'em No Limit ($0.10/$0.25) - 2009/07/01 0:37:27 ET
Table 'qryc9C/ELyQ3lubOaELNAQ' 6-max Seat #1 is the button
Seat 1: OZc6kkoTwtITj1ZfreJK1A ($21.50 in chips) 
Seat 2: qvQc9BHp2FhQjrltLiBN+w ($15.15 in chips) 
Seat 3: UXRtG8J9PoBZWTsNtqdoDA ($25 in chips) 
Seat 4: v+QfkGiuj9bgtuNoVnDO8w ($29.45 in chips) 
Seat 5: pV5UZbjsgam+HUQEd6G++w ($8.25 in chips) 
Seat 6: t2RfOOoa56xW0ZHJC0+5JQ ($9.05 in chips) 
qvQc9BHp2FhQjrltLiBN+w: posts small blind $0.10
UXRtG8J9PoBZWTsNtqdoDA: posts big blind $0.25
*** HOLE CARDS ***
v+QfkGiuj9bgtuNoVnDO8w: folds 
pV5UZbjsgam+HUQEd6G++w: folds 
t2RfOOoa56xW0ZHJC0+5JQ: folds 
OZc6kkoTwtITj1ZfreJK1A: calls $0.25
qvQc9BHp2FhQjrltLiBN+w: calls $0.15
UXRtG8J9PoBZWTsNtqdoDA: checks 
*** FLOP *** [7d 6s Tc]
qvQc9BHp2FhQjrltLiBN+w: checks 
UXRtG8J9PoBZWTsNtqdoDA: bets $0.75
OZc6kkoTwtITj1ZfreJK1A: folds 
qvQc9BHp2FhQjrltLiBN+w: folds 
Uncalled bet ($0.75) returned to UXRtG8J9PoBZWTsNtqdoDA
UXRtG8J9PoBZWTsNtqdoDA collected $0.75 from pot
*** SUMMARY ***
Total pot $0.75 | Rake $0 
Board [7d 6s Tc]
Seat 1: OZc6kkoTwtITj1ZfreJK1A (button) folded on the Flop
Seat 2: qvQc9BHp2FhQjrltLiBN+w (small blind) folded on the Flop
Seat 3: UXRtG8J9PoBZWTsNtqdoDA (big blind) collected ($0.75)
Seat 4: v+QfkGiuj9bgtuNoVnDO8w folded before Flop (didn't bet)
Seat 5: pV5UZbjsgam+HUQEd6G++w folded before Flop (didn't bet)
Seat 6: t2RfOOoa56xW0ZHJC0+5JQ folded before Flop (didn't bet)




PokerStars Game #59939344764:  Hold'em No Limit ($0.10/$0.25) - 2009/07/01 0:37:28 ET
Table 'srBTB98reCdD1TffxE6o7g' 6-max Seat #3 is the button
Seat 1: FEzezmgaiyVRh9sHKhd+9Q ($42.15 in chips) 
Seat 2: YaAEMJGY5tem39deCUQRNw ($61.35 in chips) 
Seat 3: 4YSTu0Cdzpppe1lUgCZGCQ ($35.50 in chips) 
Seat 4: nGcD53mEekM1riwMpyBSXw ($6.05 in chips) 
Seat 5: n2OZezRXTtdzQt4SuIy8TQ ($19.85 in chips) 
Seat 6: gaPMxLGp9SOj4Lq6t+/0Ig ($16.10 in chips) 
nGcD53mEekM1riwMpyBSXw: posts small blind $0.10
n2OZezRXTtdzQt4SuIy8TQ: posts big blind $0.25
*** HOLE CARDS ***
gaPMxLGp9SOj4Lq6t+/0Ig: calls $0.25
FEzezmgaiyVRh9sHKhd+9Q: raises $0.75 to $1
YaAEMJGY5tem39deCUQRNw: folds 
4YSTu0Cdzpppe1lUgCZGCQ: folds 
nGcD53mEekM1riwMpyBSXw: calls $0.90
n2OZezRXTtdzQt4SuIy8TQ: folds 
gaPMxLGp9SOj4Lq6t+/0Ig: calls $0.75
*** FLOP *** [3d 9h 6h]
nGcD53mEekM1riwMpyBSXw: checks 
gaPMxLGp9SOj4Lq6t+/0Ig: checks 
FEzezmgaiyVRh9sHKhd+9Q: bets $1.25
nGcD53mEekM1riwMpyBSXw: folds 
gaPMxLGp9SOj4Lq6t+/0Ig: folds 
Uncalled bet ($1.25) returned to FEzezmgaiyVRh9sHKhd+9Q
FEzezmgaiyVRh9sHKhd+9Q collected $3.10 from pot
FEzezmgaiyVRh9sHKhd+9Q: doesn't show hand 
*** SUMMARY ***
Total pot $3.25 | Rake $0.15 
Board [3d 9h 6h]
Seat 1: FEzezmgaiyVRh9sHKhd+9Q collected ($3.10)
Seat 2: YaAEMJGY5tem39deCUQRNw folded before Flop (didn't bet)
Seat 3: 4YSTu0Cdzpppe1lUgCZGCQ (button) folded before Flop (didn't bet)
Seat 4: nGcD53mEekM1riwMpyBSXw (small blind) folded on the Flop
Seat 5: n2OZezRXTtdzQt4SuIy8TQ (big blind) folded before Flop
Seat 6: gaPMxLGp9SOj4Lq6t+/0Ig folded on the Flop




PokerStars Game #59939344386:  Hold'em No Limit ($0.10/$0.25) - 2009/07/01 0:37:28 ET
Table 'NtEQAxCeIK2io1CGtW658g' 6-max Seat #5 is the button
Seat 1: lnOV7k25gyN7L5t5YKTgIg ($20.85 in chips) 
Seat 2: nc79pm0LZRdhncq55evVqA ($25.05 in chips) 
Seat 3: ELW+DKizJhLK7k40PMkD2Q ($55.80 in chips) 
Seat 4: 8296 ($13.10 in chips) 
Seat 5: FStoHe64SQWqAsjya9pDkQ ($25.10 in chips) 
Seat 6: /gJNBeCkWL4o85/jvlZ4BA ($63.20 in chips) 
/gJNBeCkWL4o85/jvlZ4BA: posts small blind $0.10
lnOV7k25gyN7L5t5YKTgIg: posts big blind $0.25
*** HOLE CARDS ***
nc79pm0LZRdhncq55evVqA: raises $0.75 to $1
ELW+DKizJhLK7k40PMkD2Q: folds 
8296: folds 
FStoHe64SQWqAsjya9pDkQ: raises $3 to $4
/gJNBeCkWL4o85/jvlZ4BA: folds 
lnOV7k25gyN7L5t5YKTgIg: folds 
ELW+DKizJhLK7k40PMkD2Q leaves the table
nc79pm0LZRdhncq55evVqA: folds 
Uncalled bet ($3) returned to FStoHe64SQWqAsjya9pDkQ
FStoHe64SQWqAsjya9pDkQ collected $2.35 from pot
FStoHe64SQWqAsjya9pDkQ: doesn't show hand 
*** SUMMARY ***
Total pot $2.35 | Rake $0 
Seat 1: lnOV7k25gyN7L5t5YKTgIg (big blind) folded before Flop
Seat 2: nc79pm0LZRdhncq55evVqA folded before Flop
Seat 3: ELW+DKizJhLK7k40PMkD2Q folded before Flop (didn't bet)
Seat 4: 8296 folded before Flop (didn't bet)
Seat 5: FStoHe64SQWqAsjya9pDkQ (button) collected ($2.35)
Seat 6: /gJNBeCkWL4o85/jvlZ4BA (small blind) folded before Flop




PokerStars Game #59939344582:  Hold'em No Limit ($0.10/$0.25) - 2009/07/01 0:37:28 ET
Table 'I0ZcuiUTeLuGYv26Nah7YA' 9-max Seat #4 is the button
Seat 1: iMiqaPr7dx84UF0wNUeh8A ($20.55 in chips) 
Seat 2: zE0IkNrJoJD964o4eqmCxQ ($6.05 in chips) 
Seat 3: 1S/fpm+f42V/6MNZre+ccg ($27.95 in chips) 
Seat 4: 4awUyiDYTgylQKXZ9faBVA ($29.55 in chips) 
Seat 5: opOCI2p6kW0tINuVaAqmcQ ($45.10 in chips) 
Seat 7: JxpnpCmvRAcrEUy7mq1iAg ($5.65 in chips) 
Seat 9: 2mQl0jr5DPlr6jqhvCq8Xw ($4.20 in chips) 
opOCI2p6kW0tINuVaAqmcQ: posts small blind $0.10
JxpnpCmvRAcrEUy7mq1iAg: posts big blind $0.25
*** HOLE CARDS ***
2mQl0jr5DPlr6jqhvCq8Xw: folds 
iMiqaPr7dx84UF0wNUeh8A: folds 
zE0IkNrJoJD964o4eqmCxQ: folds 
1S/fpm+f42V/6MNZre+ccg: folds 
4awUyiDYTgylQKXZ9faBVA: raises $0.75 to $1
opOCI2p6kW0tINuVaAqmcQ: folds 
JxpnpCmvRAcrEUy7mq1iAg: folds 
Uncalled bet ($0.75) returned to 4awUyiDYTgylQKXZ9faBVA
4awUyiDYTgylQKXZ9faBVA collected $0.60 from pot
4awUyiDYTgylQKXZ9faBVA: doesn't show hand 
*** SUMMARY ***
Total pot $0.60 | Rake $0 
Seat 1: iMiqaPr7dx84UF0wNUeh8A folded before Flop (didn't bet)
Seat 2: zE0IkNrJoJD964o4eqmCxQ folded before Flop (didn't bet)
Seat 3: 1S/fpm+f42V/6MNZre+ccg folded before Flop (didn't bet)
Seat 4: 4awUyiDYTgylQKXZ9faBVA (button) collected ($0.60)
Seat 5: opOCI2p6kW0tINuVaAqmcQ (small blind) folded before Flop
Seat 7: JxpnpCmvRAcrEUy7mq1iAg (big blind) folded before Flop
Seat 9: 2mQl0jr5DPlr6jqhvCq8Xw folded before Flop (didn't bet)




PokerStars Game #59939344664:  Hold'em No Limit ($0.10/$0.25) - 2009/07/01 0:37:28 ET
Table 'iHlyuN1lFZ6WTlMBiiMYXAIIO2q2znuuAXmiZ2qFTcmgx Seat #6 is the button
Seat 2: R6nIVAjK7uhK3Hj0f85A+A ($29.45 in chips) 
Seat 3: QGjA4xtpxSpgzm+HC+ps4w ($22.20 in chips) 
Seat 4: z5GxcHlYz/GSz6W2uFiTtg ($24 in chips) 
Seat 5: 6LFELL8V3NTpb0xg7AOyEg ($11.90 in chips) 
Seat 6: M2QO2DxB5Wawg2h8HSpnYA ($11.80 in chips) 
Seat 7: gehe91e0IyVT0QU/XBkEyg ($33.60 in chips) 
Seat 8: TeWJxSETzbXGiYKx0y+dtg ($24.30 in chips) 
Seat 9: PqvgxdSg9z5VmrWpbYuz+g ($25 in chips) 
gehe91e0IyVT0QU/XBkEyg: posts small blind $0.10
TeWJxSETzbXGiYKx0y+dtg: posts big blind $0.25
*** HOLE CARDS ***
PqvgxdSg9z5VmrWpbYuz+g: folds 
R6nIVAjK7uhK3Hj0f85A+A: folds 
QGjA4xtpxSpgzm+HC+ps4w: calls $0.25
z5GxcHlYz/GSz6W2uFiTtg: folds 
6LFELL8V3NTpb0xg7AOyEg: folds 
M2QO2DxB5Wawg2h8HSpnYA: folds 
gehe91e0IyVT0QU/XBkEyg: folds 
TeWJxSETzbXGiYKx0y+dtg: checks 
*** FLOP *** [8s Qh As]
TeWJxSETzbXGiYKx0y+dtg: checks 
QGjA4xtpxSpgzm+HC+ps4w: checks 
*** TURN *** [8s Qh As] [6s]
TeWJxSETzbXGiYKx0y+dtg: checks 
QGjA4xtpxSpgzm+HC+ps4w: checks 
*** RIVER *** [8s Qh As 6s] [Jd]
TeWJxSETzbXGiYKx0y+dtg: checks 
QGjA4xtpxSpgzm+HC+ps4w: checks 
*** SHOW DOWN ***
TeWJxSETzbXGiYKx0y+dtg: shows [Jh 6d] (two pair, Jacks and Sixes)
QGjA4xtpxSpgzm+HC+ps4w: mucks hand 
TeWJxSETzbXGiYKx0y+dtg collected $0.60 from pot
*** SUMMARY ***
Total pot $0.60 | Rake $0 
Board [8s Qh As 6s Jd]
Seat 2: R6nIVAjK7uhK3Hj0f85A+A folded before Flop (didn't bet)
Seat 3: QGjA4xtpxSpgzm+HC+ps4w mucked
Seat 4: z5GxcHlYz/GSz6W2uFiTtg folded before Flop (didn't bet)
Seat 5: 6LFELL8V3NTpb0xg7AOyEg folded before Flop (didn't bet)
Seat 6: M2QO2DxB5Wawg2h8HSpnYA (button) folded before Flop (didn't bet)
Seat 7: gehe91e0IyVT0QU/XBkEyg (small blind) folded before Flop
Seat 8: TeWJxSETzbXGiYKx0y+dtg (big blind) showed [Jh 6d] and won ($0.60) with two pair, Jacks and Sixes
Seat 9: PqvgxdSg9z5VmrWpbYuz+g folded before Flop (didn't bet)




PokerStars Game #59939345184:  Hold'em No Limit ($0.10/$0.25) - 2009/07/01 0:37:29 ET
Table 'aT31tt16YvQM/Ue69HPLpA' 9-max Seat #3 is the button
Seat 1: uYY6p3irj4hBN7IeHiNGSw ($25 in chips) 
Seat 3: tYsOBqdU1+x+yFI7zHO7hQ ($26.65 in chips) 
Seat 4: s7Q6uNouhe7aE8JdFb9E+A ($25 in chips) 
Seat 5: cvtKnIIaTx2+P/KlOK+tfQ ($8.70 in chips) 
Seat 6: 7cv+9Zc9HIQHNvYsMfV3uA ($44.50 in chips) 
Seat 7: s8SPJjToEJz2mPsHsMqL0A ($4 in chips) 
Seat 8: lrTLp1zpuCCs/e0pi2M8jw ($45.35 in chips) 
Seat 9: SXqVW4Q0evTUVZG6BbUNIA ($30.75 in chips) 
s7Q6uNouhe7aE8JdFb9E+A: posts small blind $0.10
cvtKnIIaTx2+P/KlOK+tfQ: posts big blind $0.25
uYY6p3irj4hBN7IeHiNGSw: posts big blind $0.25
CYkY0dNBaYaKs8HVCVn3mQ: sits out 
*** HOLE CARDS ***
7cv+9Zc9HIQHNvYsMfV3uA: folds 
s8SPJjToEJz2mPsHsMqL0A: folds 
lrTLp1zpuCCs/e0pi2M8jw: calls $0.25
SXqVW4Q0evTUVZG6BbUNIA: folds 
uYY6p3irj4hBN7IeHiNGSw: checks 
tYsOBqdU1+x+yFI7zHO7hQ: folds 
s7Q6uNouhe7aE8JdFb9E+A: folds 
cvtKnIIaTx2+P/KlOK+tfQ: raises $1 to $1.25
lrTLp1zpuCCs/e0pi2M8jw: folds 
uYY6p3irj4hBN7IeHiNGSw: folds 
Uncalled bet ($1) returned to cvtKnIIaTx2+P/KlOK+tfQ
cvtKnIIaTx2+P/KlOK+tfQ collected $0.85 from pot
*** SUMMARY ***
Total pot $0.85 | Rake $0 
Seat 1: uYY6p3irj4hBN7IeHiNGSw folded before Flop
Seat 3: tYsOBqdU1+x+yFI7zHO7hQ (button) folded before Flop (didn't bet)
Seat 4: s7Q6uNouhe7aE8JdFb9E+A (small blind) folded before Flop
Seat 5: cvtKnIIaTx2+P/KlOK+tfQ (big blind) collected ($0.85)
Seat 6: 7cv+9Zc9HIQHNvYsMfV3uA folded before Flop (didn't bet)
Seat 7: s8SPJjToEJz2mPsHsMqL0A folded before Flop (didn't bet)
Seat 8: lrTLp1zpuCCs/e0pi2M8jw folded before Flop
Seat 9: SXqVW4Q0evTUVZG6BbUNIA folded before Flop (didn't bet)




PokerStars Game #59939345134:  Hold'em No Limit ($0.10/$0.25) - 2009/07/01 0:37:29 ET
Table '/asc7VQ/OpF/oVJ3erB80w' 9-max Seat #4 is the button
Seat 1: OiV1PWZ3IkN29JlmCcnTwQ ($4.70 in chips) 
Seat 2: Th3FldXKQW6hWVVPahaoOQ ($25 in chips) 
Seat 3: ie4EwTMMFYxrCXcenJdzsw ($6.10 in chips) 
Seat 4: H9KUl8cmpLgEpOVDA00bCg ($5.25 in chips) 
Seat 5: 8B/dhbQjIWe6ASCdgzktNQ ($25.35 in chips) 
Seat 6: t2nb95S5EEFOEzNx9Itz0g ($3.95 in chips) 
Seat 7: M2QO2DxB5Wawg2h8HSpnYA ($10.50 in chips) 
Seat 8: T5Hk9oiIr+JDDMnEqwFCrw ($7.05 in chips) 
Seat 9: UkJraTKWQIqFeHOyHQ7afQ ($14.90 in chips) 
8B/dhbQjIWe6ASCdgzktNQ: posts small blind $0.10
t2nb95S5EEFOEzNx9Itz0g: posts big blind $0.25
*** HOLE CARDS ***
M2QO2DxB5Wawg2h8HSpnYA: folds 
T5Hk9oiIr+JDDMnEqwFCrw: folds 
UkJraTKWQIqFeHOyHQ7afQ: folds 
OiV1PWZ3IkN29JlmCcnTwQ: folds 
Th3FldXKQW6hWVVPahaoOQ: folds 
ie4EwTMMFYxrCXcenJdzsw: raises $0.50 to $0.75
H9KUl8cmpLgEpOVDA00bCg: folds 
8B/dhbQjIWe6ASCdgzktNQ: folds 
t2nb95S5EEFOEzNx9Itz0g: folds 
Uncalled bet ($0.50) returned to ie4EwTMMFYxrCXcenJdzsw
ie4EwTMMFYxrCXcenJdzsw collected $0.60 from pot
*** SUMMARY ***
Total pot $0.60 | Rake $0 
Seat 1: OiV1PWZ3IkN29JlmCcnTwQ folded before Flop (didn't bet)
Seat 2: Th3FldXKQW6hWVVPahaoOQ folded before Flop (didn't bet)
Seat 3: ie4EwTMMFYxrCXcenJdzsw collected ($0.60)
Seat 4: H9KUl8cmpLgEpOVDA00bCg (button) folded before Flop (didn't bet)
Seat 5: 8B/dhbQjIWe6ASCdgzktNQ (small blind) folded before Flop
Seat 6: t2nb95S5EEFOEzNx9Itz0g (big blind) folded before Flop
Seat 7: M2QO2DxB5Wawg2h8HSpnYA folded before Flop (didn't bet)
Seat 8: T5Hk9oiIr+JDDMnEqwFCrw folded before Flop (didn't bet)
Seat 9: UkJraTKWQIqFeHOyHQ7afQ folded before Flop (didn't bet)




PokerStars Game #59939345312:  Hold'em No Limit ($0.10/$0.25) - 2009/07/01 0:37:29 ET
Table 'S6s+TmTlAjLHclBRvN5/fw' 9-max Seat #5 is the button
Seat 1: /XMgGtJ7mcWfe5s7McY9kw ($24.65 in chips) 
Seat 2: GGVjFwYkbwsuyKljxyML4g ($12.50 in chips) 
Seat 3: imHPFFqvfHGzsBBWeGuy4w ($20.60 in chips) 
Seat 4: M/9j4wkHH9i1JM51vgi1VA ($38.95 in chips) 
Seat 5: z5GxcHlYz/GSz6W2uFiTtg ($25 in chips) 
Seat 6: aNpwfA31EREwO+ar4XzBCw ($25.80 in chips) 
Seat 7: vSkQm2EelzwRGDDQQk0Fqw ($6 in chips) 
Seat 8: MC7/fevFfNbuDTx/uhUC4w ($13.90 in chips) 
Seat 9: BODayQmPi2rEfae9e6hIlw ($27.30 in chips) 
aNpwfA31EREwO+ar4XzBCw: posts small blind $0.10
vSkQm2EelzwRGDDQQk0Fqw: posts big blind $0.25
*** HOLE CARDS ***
MC7/fevFfNbuDTx/uhUC4w: folds 
BODayQmPi2rEfae9e6hIlw: folds 
/XMgGtJ7mcWfe5s7McY9kw: folds 
GGVjFwYkbwsuyKljxyML4g: folds 
imHPFFqvfHGzsBBWeGuy4w: raises $0.50 to $0.75
M/9j4wkHH9i1JM51vgi1VA: folds 
z5GxcHlYz/GSz6W2uFiTtg: folds 
aNpwfA31EREwO+ar4XzBCw: folds 
vSkQm2EelzwRGDDQQk0Fqw: folds 
Uncalled bet ($0.50) returned to imHPFFqvfHGzsBBWeGuy4w
imHPFFqvfHGzsBBWeGuy4w collected $0.60 from pot
imHPFFqvfHGzsBBWeGuy4w: doesn't show hand 
*** SUMMARY ***
Total pot $0.60 | Rake $0 
Seat 1: /XMgGtJ7mcWfe5s7McY9kw folded before Flop (didn't bet)
Seat 2: GGVjFwYkbwsuyKljxyML4g folded before Flop (didn't bet)
Seat 3: imHPFFqvfHGzsBBWeGuy4w collected ($0.60)
Seat 4: M/9j4wkHH9i1JM51vgi1VA folded before Flop (didn't bet)
Seat 5: z5GxcHlYz/GSz6W2uFiTtg (button) folded before Flop (didn't bet)
Seat 6: aNpwfA31EREwO+ar4XzBCw (small blind) folded before Flop
Seat 7: vSkQm2EelzwRGDDQQk0Fqw (big blind) folded before Flop
Seat 8: MC7/fevFfNbuDTx/uhUC4w folded before Flop (didn't bet)
Seat 9: BODayQmPi2rEfae9e6hIlw folded before Flop (didn't bet)




PokerStars Game #59939345154:  Hold'em No Limit ($0.10/$0.25) - 2009/07/01 0:37:29 ET
Table 'R5f24ws6hGXlbvjq9ej+1Q' 9-max Seat #8 is the button
Seat 1: TeWJxSETzbXGiYKx0y+dtg ($26.30 in chips) 
Seat 2: 8lk6dG3H7iS/67/biw/vcQ ($27.30 in chips) 
Seat 3: gehe91e0IyVT0QU/XBkEyg ($25.10 in chips) 
Seat 4: jM9ExRdqCqq2e6TjpOBoRw ($17.95 in chips) 
Seat 5: YMlMWbkusacDBjx3A8lphw ($5 in chips) 
Seat 6: hPhp/RE3cJ5YGaQ2xOHXXg ($9.95 in chips) 
Seat 7: Z5ZtGOON8kmSdSCll9Z3XA ($8.35 in chips) 
Seat 8: qwr38jl5txoR36M7G5qi4A ($7.60 in chips) 
Seat 9: 33y9+GmQ3J84RvZXcraRTw ($27.75 in chips) 
33y9+GmQ3J84RvZXcraRTw: posts small blind $0.10
TeWJxSETzbXGiYKx0y+dtg: posts big blind $0.25
*** HOLE CARDS ***
8lk6dG3H7iS/67/biw/vcQ: folds 
gehe91e0IyVT0QU/XBkEyg: folds 
jM9ExRdqCqq2e6TjpOBoRw: folds 
YMlMWbkusacDBjx3A8lphw: folds 
hPhp/RE3cJ5YGaQ2xOHXXg: folds 
Z5ZtGOON8kmSdSCll9Z3XA: folds 
qwr38jl5txoR36M7G5qi4A: folds 
33y9+GmQ3J84RvZXcraRTw: folds 
Uncalled bet ($0.15) returned to TeWJxSETzbXGiYKx0y+dtg
TeWJxSETzbXGiYKx0y+dtg collected $0.20 from pot
TeWJxSETzbXGiYKx0y+dtg: doesn't show hand 
*** SUMMARY ***
Total pot $0.20 | Rake $0 
Seat 1: TeWJxSETzbXGiYKx0y+dtg (big blind) collected ($0.20)
Seat 2: 8lk6dG3H7iS/67/biw/vcQ folded before Flop (didn't bet)
Seat 3: gehe91e0IyVT0QU/XBkEyg folded before Flop (didn't bet)
Seat 4: jM9ExRdqCqq2e6TjpOBoRw folded before Flop (didn't bet)
Seat 5: YMlMWbkusacDBjx3A8lphw folded before Flop (didn't bet)
Seat 6: hPhp/RE3cJ5YGaQ2xOHXXg folded before Flop (didn't bet)
Seat 7: Z5ZtGOON8kmSdSCll9Z3XA folded before Flop (didn't bet)
Seat 8: qwr38jl5txoR36M7G5qi4A (button) folded before Flop (didn't bet)
Seat 9: 33y9+GmQ3J84RvZXcraRTw (small blind) folded before Flop




PokerStars Game #59939344922:  Hold'em No Limit ($0.10/$0.25) - 2009/07/01 0:37:29 ET
Table 'Is9eNmJA1KnBOw0lcVkxUQ' 9-max Seat #2 is the button
Seat 1: 56S3mA6Zs3pGR+0p0vUCtg ($36.80 in chips) 
Seat 2: VllYilcih0t+gMD4GTRlgQ ($40.40 in chips) 
Seat 3: zFrHk6ssFhTu+DiVzVXr+g ($15.95 in chips) 
Seat 4: cZ99hugmLBj9KhTlc8nCSw ($25 in chips) 
Seat 6: HapyJHxV6lc3eqoT7yWL2A ($24.85 in chips) 
Seat 7: aNpwfA31EREwO+ar4XzBCw ($25 in chips) 
Seat 8: 1b3eMBC7sPXgDX9IYcruKg ($3.90 in chips) 
zFrHk6ssFhTu+DiVzVXr+g: posts small blind $0.10
cZ99hugmLBj9KhTlc8nCSw: posts big blind $0.25
*** HOLE CARDS ***
HapyJHxV6lc3eqoT7yWL2A: folds 
aNpwfA31EREwO+ar4XzBCw: folds 
d9fERE+24v0MqnylCrXchQ joins the table at seat #5 
1b3eMBC7sPXgDX9IYcruKg: raises $3.65 to $3.90 and is all-in
56S3mA6Zs3pGR+0p0vUCtg: folds 
VllYilcih0t+gMD4GTRlgQ: folds 
zFrHk6ssFhTu+DiVzVXr+g: folds 
cZ99hugmLBj9KhTlc8nCSw: folds 
Uncalled bet ($3.65) returned to 1b3eMBC7sPXgDX9IYcruKg
1b3eMBC7sPXgDX9IYcruKg collected $0.60 from pot
1b3eMBC7sPXgDX9IYcruKg: doesn't show hand 
*** SUMMARY ***
Total pot $0.60 | Rake $0 
Seat 1: 56S3mA6Zs3pGR+0p0vUCtg folded before Flop (didn't bet)
Seat 2: VllYilcih0t+gMD4GTRlgQ (button) folded before Flop (didn't bet)
Seat 3: zFrHk6ssFhTu+DiVzVXr+g (small blind) folded before Flop
Seat 4: cZ99hugmLBj9KhTlc8nCSw (big blind) folded before Flop
Seat 6: HapyJHxV6lc3eqoT7yWL2A folded before Flop (didn't bet)
Seat 7: aNpwfA31EREwO+ar4XzBCw folded before Flop (didn't bet)
Seat 8: 1b3eMBC7sPXgDX9IYcruKg collected ($0.60)




PokerStars Game #59939345156:  Hold'em No Limit ($0.10/$0.25) - 2009/07/01 0:37:29 ET
Table 'IIO2q2znuuAXmiZ2qFTcmg' 6-max Seat #2 is the button
Seat 1: nwwpaieDRI0UPyVtChVHOg ($17.50 in chips) 
Seat 2: cS21pIxRHx5Gt42o7hPZzw ($15.35 in chips) 
Seat 3: hiTEr3yrERiQp3zHXRioVw ($14.05 in chips) 
Seat 4: 0HIrwssk0FQvyKULzUTtlg ($12.50 in chips) 
Seat 5: f9iRHw0d+kV7pbTYwF2+2g ($16.30 in chips) 
hiTEr3yrERiQp3zHXRioVw: posts small blind $0.10
0HIrwssk0FQvyKULzUTtlg: posts big blind $0.25
*** HOLE CARDS ***
f9iRHw0d+kV7pbTYwF2+2g: calls $0.25
nwwpaieDRI0UPyVtChVHOg: folds 
cS21pIxRHx5Gt42o7hPZzw: calls $0.25
hiTEr3yrERiQp3zHXRioVw: calls $0.15
0HIrwssk0FQvyKULzUTtlg: checks 
*** FLOP *** [8h 2c 8c]
hiTEr3yrERiQp3zHXRioVw: checks 
0HIrwssk0FQvyKULzUTtlg: checks 
f9iRHw0d+kV7pbTYwF2+2g: checks 
cS21pIxRHx5Gt42o7hPZzw: checks 
*** TURN *** [8h 2c 8c] [7c]
hiTEr3yrERiQp3zHXRioVw: bets $0.50
0HIrwssk0FQvyKULzUTtlg: folds 
f9iRHw0d+kV7pbTYwF2+2g: folds 
cS21pIxRHx5Gt42o7hPZzw: folds 
Uncalled bet ($0.50) returned to hiTEr3yrERiQp3zHXRioVw
hiTEr3yrERiQp3zHXRioVw collected $0.95 from pot
hiTEr3yrERiQp3zHXRioVw: doesn't show hand 
*** SUMMARY ***
Total pot $1 | Rake $0.05 
Board [8h 2c 8c 7c]
Seat 1: nwwpaieDRI0UPyVtChVHOg folded before Flop (didn't bet)
Seat 2: cS21pIxRHx5Gt42o7hPZzw (button) folded on the Turn
Seat 3: hiTEr3yrERiQp3zHXRioVw (small blind) collected ($0.95)
Seat 4: 0HIrwssk0FQvyKULzUTtlg (big blind) folded on the Turn
Seat 5: f9iRHw0d+kV7pbTYwF2+2g folded on the Turn




PokerStars Game #59939345382:  Hold'em No Limit ($0.10/$0.25) - 2009/07/01 0:37:29 ET
Table 'yRuHgMpxv4rPBXeM6HFESw' 6-max Seat #6 is the button
Seat 2: iwlxXocltgSdaBmusNXanQ ($17.05 in chips) 
Seat 3: zZ8zH49EwNs0mqgppOaL9g ($50.90 in chips) 
Seat 4: ypXnt+kzrF/5y8QN2rkt1A ($14.85 in chips) 
Seat 5: gaPMxLGp9SOj4Lq6t+/0Ig ($14.75 in chips) 
Seat 6: 4YSTu0Cdzpppe1lUgCZGCQ ($25 in chips) 
iwlxXocltgSdaBmusNXanQ: posts small blind $0.10
zZ8zH49EwNs0mqgppOaL9g: posts big blind $0.25
*** HOLE CARDS ***
ypXnt+kzrF/5y8QN2rkt1A: raises $0.50 to $0.75
gaPMxLGp9SOj4Lq6t+/0Ig: folds 
4YSTu0Cdzpppe1lUgCZGCQ: calls $0.75
iwlxXocltgSdaBmusNXanQ: folds 
zZ8zH49EwNs0mqgppOaL9g: folds 
*** FLOP *** [6c 2s Jh]
ypXnt+kzrF/5y8QN2rkt1A: bets $1
4YSTu0Cdzpppe1lUgCZGCQ: calls $1
*** TURN *** [6c 2s Jh] [Tc]
ypXnt+kzrF/5y8QN2rkt1A: bets $1
4YSTu0Cdzpppe1lUgCZGCQ: calls $1
*** RIVER *** [6c 2s Jh Tc] [Ks]
ypXnt+kzrF/5y8QN2rkt1A: bets $2.25
4YSTu0Cdzpppe1lUgCZGCQ: folds 
Uncalled bet ($2.25) returned to ypXnt+kzrF/5y8QN2rkt1A
ypXnt+kzrF/5y8QN2rkt1A collected $5.60 from pot
ypXnt+kzrF/5y8QN2rkt1A: doesn't show hand 
*** SUMMARY ***
Total pot $5.85 | Rake $0.25 
Board [6c 2s Jh Tc Ks]
Seat 2: iwlxXocltgSdaBmusNXanQ (small blind) folded before Flop
Seat 3: zZ8zH49EwNs0mqgppOaL9g (big blind) folded before Flop
Seat 4: ypXnt+kzrF/5y8QN2rkt1A collected ($5.60)
Seat 5: gaPMxLGp9SOj4Lq6t+/0Ig folded before Flop (didn't bet)
Seat 6: 4YSTu0Cdzpppe1lUgCZGCQ (button) folded on the River




PokerStars Game #59939345268:  Hold'em No Limit ($0.10/$0.25) - 2009/07/01 0:37:29 ET
Table '+198VWQSWBhYQOcizzuBkw' 6-max Seat #2 is the button
Seat 1: GM93mEv/GkWPhKJ25MExaw ($1.70 in chips) 
Seat 2: R6AGToFJQOYVZAjC2jXEKw ($29.40 in chips) 
Seat 3: BYxjLnV1/LL0aZcTbfAOvw ($27.35 in chips) 
Seat 4: TgDsTeCdLQt8kWbL00ByRA ($27.60 in chips) 
Seat 5: LtASJ9OlkqGrrUKGQlpGAw ($30.80 in chips) 
Seat 6: 7qRk4YH4/k/08LgJSv7rBQ ($30.05 in chips) 
BYxjLnV1/LL0aZcTbfAOvw: posts small blind $0.10
TgDsTeCdLQt8kWbL00ByRA: posts big blind $0.25
*** HOLE CARDS ***
LtASJ9OlkqGrrUKGQlpGAw: folds 
7qRk4YH4/k/08LgJSv7rBQ: folds 
GM93mEv/GkWPhKJ25MExaw has timed out
GM93mEv/GkWPhKJ25MExaw: folds 
GM93mEv/GkWPhKJ25MExaw is sitting out
R6AGToFJQOYVZAjC2jXEKw: folds 
BYxjLnV1/LL0aZcTbfAOvw: folds 
Uncalled bet ($0.15) returned to TgDsTeCdLQt8kWbL00ByRA
TgDsTeCdLQt8kWbL00ByRA collected $0.20 from pot
*** SUMMARY ***
Total pot $0.20 | Rake $0 
Seat 1: GM93mEv/GkWPhKJ25MExaw folded before Flop (didn't bet)
Seat 2: R6AGToFJQOYVZAjC2jXEKw (button) folded before Flop (didn't bet)
Seat 3: BYxjLnV1/LL0aZcTbfAOvw (small blind) folded before Flop
Seat 4: TgDsTeCdLQt8kWbL00ByRA (big blind) collected ($0.20)
Seat 5: LtASJ9OlkqGrrUKGQlpGAw folded before Flop (didn't bet)
Seat 6: 7qRk4YH4/k/08LgJSv7rBQ folded before Flop (didn't bet)




PokerStars Game #59939345208:  Hold'em No Limit ($0.10/$0.25) - 2009/07/01 0:37:29 ET
Table 'zW+7jPbOLCvlPu+dUGY5WQ' 6-max Seat #3 is the button
Seat 1: JE/wJXmjw3bpdmjwvh2pcg ($24.65 in chips) 
Seat 2: m/Xj2OoEbtQwxafkW0taNw ($16.90 in chips) 
Seat 3: BedjMfrlRfPgSq7CXpPAmg ($51.95 in chips) 
Seat 4: Qv4VzEkN09uD11sjKv02Ig ($33.30 in chips) 
Seat 5: SFmT9ZsVopnukjvAzrxTRg ($52.05 in chips) 
Seat 6: BiLBinPhgpKAYzLgKJVU5A ($21.95 in chips) 
Qv4VzEkN09uD11sjKv02Ig: posts small blind $0.10
SFmT9ZsVopnukjvAzrxTRg: posts big blind $0.25
*** HOLE CARDS ***
BiLBinPhgpKAYzLgKJVU5A: folds 
JE/wJXmjw3bpdmjwvh2pcg: folds 
m/Xj2OoEbtQwxafkW0taNw: raises $0.25 to $0.50
BedjMfrlRfPgSq7CXpPAmg: folds 
Qv4VzEkN09uD11sjKv02Ig: calls $0.40
SFmT9ZsVopnukjvAzrxTRg: folds 
*** FLOP *** [Th 2s Qh]
Qv4VzEkN09uD11sjKv02Ig: checks 
m/Xj2OoEbtQwxafkW0taNw: bets $0.25
Qv4VzEkN09uD11sjKv02Ig: calls $0.25
*** TURN *** [Th 2s Qh] [2h]
Qv4VzEkN09uD11sjKv02Ig: checks 
m/Xj2OoEbtQwxafkW0taNw: bets $0.75
Qv4VzEkN09uD11sjKv02Ig: folds 
Uncalled bet ($0.75) returned to m/Xj2OoEbtQwxafkW0taNw
m/Xj2OoEbtQwxafkW0taNw collected $1.70 from pot
*** SUMMARY ***
Total pot $1.75 | Rake $0.05 
Board [Th 2s Qh 2h]
Seat 1: JE/wJXmjw3bpdmjwvh2pcg folded before Flop (didn't bet)
Seat 2: m/Xj2OoEbtQwxafkW0taNw collected ($1.70)
Seat 3: BedjMfrlRfPgSq7CXpPAmg (button) folded before Flop (didn't bet)
Seat 4: Qv4VzEkN09uD11sjKv02Ig (small blind) folded on the Turn
Seat 5: SFmT9ZsVopnukjvAzrxTRg (big blind) folded before Flop
Seat 6: BiLBinPhgpKAYzLgKJVU5A folded before Flop (didn't bet)




PokerStars Game #59939345158:  Hold'em No Limit ($0.10/$0.25) - 2009/07/01 0:37:29 ET
Table 'U0hCzoS0KCJL+eoE054K4Q' 9-max Seat #5 is the button
Seat 2: MG90wfSJZnOejs/KD3vlQQ ($25 in chips) 
Seat 4: REZJH+hR80RwfrJtUNUJOw ($28.70 in chips) 
Seat 5: gN5V9qraLHmhKzjLHzt7qA ($15 in chips) 
Seat 7: NNZypfH1f/VIj3Skf/XIzg ($3.25 in chips) 
Seat 8: Xpyqpb+DURDWnyJ3xTEIFQ ($26.95 in chips) 
Seat 9: X9HkgGdfFul8DB9rhTbyFw ($37.70 in chips) 
NNZypfH1f/VIj3Skf/XIzg: posts small blind $0.10
Xpyqpb+DURDWnyJ3xTEIFQ: posts big blind $0.25
*** HOLE CARDS ***
X9HkgGdfFul8DB9rhTbyFw: folds 
MG90wfSJZnOejs/KD3vlQQ: folds 
REZJH+hR80RwfrJtUNUJOw: folds 
gN5V9qraLHmhKzjLHzt7qA: folds 
NNZypfH1f/VIj3Skf/XIzg: folds 
Uncalled bet ($0.15) returned to Xpyqpb+DURDWnyJ3xTEIFQ
Xpyqpb+DURDWnyJ3xTEIFQ collected $0.20 from pot
*** SUMMARY ***
Total pot $0.20 | Rake $0 
Seat 2: MG90wfSJZnOejs/KD3vlQQ folded before Flop (didn't bet)
Seat 4: REZJH+hR80RwfrJtUNUJOw folded before Flop (didn't bet)
Seat 5: gN5V9qraLHmhKzjLHzt7qA (button) folded before Flop (didn't bet)
Seat 7: NNZypfH1f/VIj3Skf/XIzg (small blind) folded before Flop
Seat 8: Xpyqpb+DURDWnyJ3xTEIFQ (big blind) collected ($0.20)
Seat 9: X9HkgGdfFul8DB9rhTbyFw folded before Flop (didn't bet)




PokerStars Game #59939345682:  Hold'em No Limit ($0.10/$0.25) - 2009/07/01 0:37:30 ET
Table 'xPn6TS/y/OWkX7Qa+MUuKA' 6-max Seat #1 is the button
Seat 1: JFIAqU8lCZ0vWwEl4bdGsg ($25 in chips) 
Seat 2: buyjetgNT1McXtdaP4zynA ($21 in chips) 
Seat 3: o08wk0F4gROLhZS04Iyl3w ($26.70 in chips) 
Seat 4: SS/yfeArhULzIcOPe8MdPg ($28.35 in chips) 
Seat 5: I1TxPvWj8NfG8orglCinNA ($39.40 in chips) 
Seat 6: oseFhpinoe+Zg4j5xyBjyQ ($55.05 in chips) 
buyjetgNT1McXtdaP4zynA: posts small blind $0.10
o08wk0F4gROLhZS04Iyl3w: posts big blind $0.25
*** HOLE CARDS ***
SS/yfeArhULzIcOPe8MdPg: folds 
I1TxPvWj8NfG8orglCinNA: folds 
oseFhpinoe+Zg4j5xyBjyQ has timed out
oseFhpinoe+Zg4j5xyBjyQ: folds 
oseFhpinoe+Zg4j5xyBjyQ is sitting out
oseFhpinoe+Zg4j5xyBjyQ has returned
JFIAqU8lCZ0vWwEl4bdGsg: raises $0.60 to $0.85
buyjetgNT1McXtdaP4zynA: calls $0.75
o08wk0F4gROLhZS04Iyl3w: folds 
*** FLOP *** [Qd 7c 6s]
buyjetgNT1McXtdaP4zynA: checks 
JFIAqU8lCZ0vWwEl4bdGsg: bets $1.25
buyjetgNT1McXtdaP4zynA: folds 
Uncalled bet ($1.25) returned to JFIAqU8lCZ0vWwEl4bdGsg
JFIAqU8lCZ0vWwEl4bdGsg collected $1.90 from pot
JFIAqU8lCZ0vWwEl4bdGsg: doesn't show hand 
*** SUMMARY ***
Total pot $1.95 | Rake $0.05 
Board [Qd 7c 6s]
Seat 1: JFIAqU8lCZ0vWwEl4bdGsg (button) collected ($1.90)
Seat 2: buyjetgNT1McXtdaP4zynA (small blind) folded on the Flop
Seat 3: o08wk0F4gROLhZS04Iyl3w (big blind) folded before Flop
Seat 4: SS/yfeArhULzIcOPe8MdPg folded before Flop (didn't bet)
Seat 5: I1TxPvWj8NfG8orglCinNA folded before Flop (didn't bet)
Seat 6: oseFhpinoe+Zg4j5xyBjyQ folded before Flop (didn't bet)




PokerStars Game #59939345668:  Hold'em No Limit ($0.10/$0.25) - 2009/07/01 0:37:30 ET
Table 'by7aHYEDnDd144EXOXa/jA' 9-max Seat #1 is the button
Seat 1: zU1DfKpyUFgAuyEO9JqLHg ($8.85 in chips) 
Seat 2: vSkQm2EelzwRGDDQQk0Fqw ($5 in chips) 
Seat 3: 1Clf3cPrqoy/YgvWdWK1Xw ($5.90 in chips) 
Seat 4: vZGoOTJLQLhkPj4I+LNGig ($47.90 in chips) 
Seat 6: DIBbjEYGs+TVdVgEB/4+3w ($22.10 in chips) 
Seat 7: tWA6Uowb3ysfJYO6d8AUqw ($10.40 in chips) 
Seat 8: s7Q6uNouhe7aE8JdFb9E+A ($25.60 in chips) 
vSkQm2EelzwRGDDQQk0Fqw: posts small blind $0.10
1Clf3cPrqoy/YgvWdWK1Xw: posts big blind $0.25
yyG4svzOpC1A+sUP/scg6w: sits out 
*** HOLE CARDS ***
vZGoOTJLQLhkPj4I+LNGig: folds 
DIBbjEYGs+TVdVgEB/4+3w: calls $0.25
tWA6Uowb3ysfJYO6d8AUqw: folds 
s7Q6uNouhe7aE8JdFb9E+A: folds 
zU1DfKpyUFgAuyEO9JqLHg: folds 
vSkQm2EelzwRGDDQQk0Fqw: folds 
1Clf3cPrqoy/YgvWdWK1Xw: checks 
*** FLOP *** [Ts 7s 8c]
1Clf3cPrqoy/YgvWdWK1Xw: checks 
DIBbjEYGs+TVdVgEB/4+3w: bets $0.50
1Clf3cPrqoy/YgvWdWK1Xw: folds 
Uncalled bet ($0.50) returned to DIBbjEYGs+TVdVgEB/4+3w
DIBbjEYGs+TVdVgEB/4+3w collected $0.60 from pot
*** SUMMARY ***
Total pot $0.60 | Rake $0 
Board [Ts 7s 8c]
Seat 1: zU1DfKpyUFgAuyEO9JqLHg (button) folded before Flop (didn't bet)
Seat 2: vSkQm2EelzwRGDDQQk0Fqw (small blind) folded before Flop
Seat 3: 1Clf3cPrqoy/YgvWdWK1Xw (big blind) folded on the Flop
Seat 4: vZGoOTJLQLhkPj4I+LNGig folded before Flop (didn't bet)
Seat 6: DIBbjEYGs+TVdVgEB/4+3w collected ($0.60)
Seat 7: tWA6Uowb3ysfJYO6d8AUqw folded before Flop (didn't bet)
Seat 8: s7Q6uNouhe7aE8JdFb9E+A folded before Flop (didn't bet)




PokerStars Game #59939346014:  Hold'em No Limit ($0.10/$0.25) - 2009/07/01 0:37:30 ET
Table 'yZgGBnUGXVCcEJdcqes8tw' 9-max Seat #4 is the button
Seat 1: SXqVW4Q0evTUVZG6BbUNIA ($24.05 in chips) 
Seat 2: MG90wfSJZnOejs/KD3vlQQ ($25 in chips) 
Seat 3: z5GxcHlYz/GSz6W2uFiTtg ($26.65 in chips) 
Seat 4: opOCI2p6kW0tINuVaAqmcQ ($25 in chips) 
Seat 5: IGz29GAFM1DpSdXX+wXg3g ($15.60 in chips) 
Seat 6: H9i0g723A2AKb4nSMXqMPQ ($20.30 in chips) 
Seat 7: eC8Pn1D6Y2pct8o62nQfvQ ($28.40 in chips) 
Seat 8: dmYlc+1cjwZMJ7wV+Z0rRg ($24.90 in chips) 
Seat 9: M/9j4wkHH9i1JM51vgi1VA ($31.60 in chips) 
IGz29GAFM1DpSdXX+wXg3g: posts small blind $0.10
H9i0g723A2AKb4nSMXqMPQ: posts big blind $0.25
*** HOLE CARDS ***
eC8Pn1D6Y2pct8o62nQfvQ: folds 
dmYlc+1cjwZMJ7wV+Z0rRg: folds 
M/9j4wkHH9i1JM51vgi1VA: calls $0.25
SXqVW4Q0evTUVZG6BbUNIA: folds 
MG90wfSJZnOejs/KD3vlQQ: folds 
z5GxcHlYz/GSz6W2uFiTtg: folds 
opOCI2p6kW0tINuVaAqmcQ: folds 
IGz29GAFM1DpSdXX+wXg3g: calls $0.15
H9i0g723A2AKb4nSMXqMPQ: checks 
*** FLOP *** [Th Qd Qs]
IGz29GAFM1DpSdXX+wXg3g: checks 
H9i0g723A2AKb4nSMXqMPQ: checks 
M/9j4wkHH9i1JM51vgi1VA: checks 
*** TURN *** [Th Qd Qs] [3s]
IGz29GAFM1DpSdXX+wXg3g: checks 
H9i0g723A2AKb4nSMXqMPQ: checks 
M/9j4wkHH9i1JM51vgi1VA: checks 
*** RIVER *** [Th Qd Qs 3s] [Kh]
IGz29GAFM1DpSdXX+wXg3g: bets $0.50
H9i0g723A2AKb4nSMXqMPQ: folds 
M/9j4wkHH9i1JM51vgi1VA: folds 
Uncalled bet ($0.50) returned to IGz29GAFM1DpSdXX+wXg3g
IGz29GAFM1DpSdXX+wXg3g collected $0.75 from pot
IGz29GAFM1DpSdXX+wXg3g: doesn't show hand 
*** SUMMARY ***
Total pot $0.75 | Rake $0 
Board [Th Qd Qs 3s Kh]
Seat 1: SXqVW4Q0evTUVZG6BbUNIA folded before Flop (didn't bet)
Seat 2: MG90wfSJZnOejs/KD3vlQQ folded before Flop (didn't bet)
Seat 3: z5GxcHlYz/GSz6W2uFiTtg folded before Flop (didn't bet)
Seat 4: opOCI2p6kW0tINuVaAqmcQ (button) folded before Flop (didn't bet)
Seat 5: IGz29GAFM1DpSdXX+wXg3g (small blind) collected ($0.75)
Seat 6: H9i0g723A2AKb4nSMXqMPQ (big blind) folded on the River
Seat 7: eC8Pn1D6Y2pct8o62nQfvQ folded before Flop (didn't bet)
Seat 8: dmYlc+1cjwZMJ7wV+Z0rRg folded before Flop (didn't bet)
Seat 9: M/9j4wkHH9i1JM51vgi1VA folded on the River




PokerStars Game #59939345608:  Hold'em No Limit ($0.10/$0.25) - 2009/07/01 0:37:30 ET
Table 'BabJGL6tfXQp3leBGbYe8A' 9-max Seat #9 is the button
Seat 1: QsLvCwfSWqP+CfjwUnjpXQ ($23.65 in chips) 
Seat 2: G5EFgY1bi50mF1iH/+B4yQ ($4.50 in chips) 
Seat 3: Jdj7AsGFrlkCgDXeWK322A ($24.25 in chips) 
Seat 4: Yk91gygnxgAKPGHZ/jPVSw ($9.70 in chips) 
Seat 5: fKqW4kzqpoOv+YKE5kp3FA ($5.50 in chips) 
Seat 6: ELKIDQ6mBSQJr3wiHYHtvw ($4.25 in chips) 
Seat 7: PS2bAPjvHsF4E9tIyk0xBg ($6.20 in chips) 
Seat 9: xEQxarad8/T4jJdpZy5LGw ($10.55 in chips) 
QsLvCwfSWqP+CfjwUnjpXQ: posts small blind $0.10
G5EFgY1bi50mF1iH/+B4yQ: posts big blind $0.25
TJEefy+0K5gBV+8LA5OK7Q: sits out 
*** HOLE CARDS ***
Jdj7AsGFrlkCgDXeWK322A: folds 
Yk91gygnxgAKPGHZ/jPVSw: calls $0.25
fKqW4kzqpoOv+YKE5kp3FA: calls $0.25
ELKIDQ6mBSQJr3wiHYHtvw: calls $0.25
PS2bAPjvHsF4E9tIyk0xBg: folds 
xEQxarad8/T4jJdpZy5LGw: calls $0.25
QsLvCwfSWqP+CfjwUnjpXQ: calls $0.15
G5EFgY1bi50mF1iH/+B4yQ: checks 
*** FLOP *** [As 9c 9h]
QsLvCwfSWqP+CfjwUnjpXQ: checks 
G5EFgY1bi50mF1iH/+B4yQ: checks 
Yk91gygnxgAKPGHZ/jPVSw: checks 
fKqW4kzqpoOv+YKE5kp3FA: checks 
ELKIDQ6mBSQJr3wiHYHtvw: bets $0.25
xEQxarad8/T4jJdpZy5LGw: folds 
QsLvCwfSWqP+CfjwUnjpXQ: folds 
G5EFgY1bi50mF1iH/+B4yQ: calls $0.25
QsLvCwfSWqP+CfjwUnjpXQ leaves the table
Yk91gygnxgAKPGHZ/jPVSw: folds 
fKqW4kzqpoOv+YKE5kp3FA: calls $0.25
*** TURN *** [As 9c 9h] [Qc]
G5EFgY1bi50mF1iH/+B4yQ: checks 
fKqW4kzqpoOv+YKE5kp3FA: checks 
ELKIDQ6mBSQJr3wiHYHtvw: bets $1
G5EFgY1bi50mF1iH/+B4yQ: calls $1
fKqW4kzqpoOv+YKE5kp3FA: calls $1
*** RIVER *** [As 9c 9h Qc] [Qs]
G5EFgY1bi50mF1iH/+B4yQ: checks 
qwr38jl5txoR36M7G5qi4A joins the table at seat #1 
fKqW4kzqpoOv+YKE5kp3FA: checks 
ELKIDQ6mBSQJr3wiHYHtvw: checks 
*** SHOW DOWN ***
G5EFgY1bi50mF1iH/+B4yQ: shows [Ts Ks] (two pair, Queens and Nines)
fKqW4kzqpoOv+YKE5kp3FA: shows [7s 7h] (two pair, Queens and Nines)
ELKIDQ6mBSQJr3wiHYHtvw: shows [6c Ad] (two pair, Aces and Queens)
ELKIDQ6mBSQJr3wiHYHtvw collected $5 from pot
*** SUMMARY ***
Total pot $5.25 | Rake $0.25 
Board [As 9c 9h Qc Qs]
Seat 1: QsLvCwfSWqP+CfjwUnjpXQ (small blind) folded on the Flop
Seat 2: G5EFgY1bi50mF1iH/+B4yQ (big blind) showed [Ts Ks] and lost with two pair, Queens and Nines
Seat 3: Jdj7AsGFrlkCgDXeWK322A folded before Flop (didn't bet)
Seat 4: Yk91gygnxgAKPGHZ/jPVSw folded on the Flop
Seat 5: fKqW4kzqpoOv+YKE5kp3FA showed [7s 7h] and lost with two pair, Queens and Nines
Seat 6: ELKIDQ6mBSQJr3wiHYHtvw showed [6c Ad] and won ($5) with two pair, Aces and Queens
Seat 7: PS2bAPjvHsF4E9tIyk0xBg folded before Flop (didn't bet)
Seat 9: xEQxarad8/T4jJdpZy5LGw (button) folded on the Flop




PokerStars Game #59939345768:  Hold'em No Limit ($0.10/$0.25) - 2009/07/01 0:37:30 ET
Table 'Mef6A0EMopL6WaFO5/KO9g' 6-max Seat #6 is the button
Seat 1: ELW+DKizJhLK7k40PMkD2Q ($30.10 in chips) 
Seat 2: 8ClCHtFXGNplITm+63KB+Q ($33.85 in chips) 
Seat 4: pisIQ6Ztya1lC0kTtGSTHw ($58.50 in chips) 
Seat 6: BYxjLnV1/LL0aZcTbfAOvw ($25 in chips) 
ELW+DKizJhLK7k40PMkD2Q: posts small blind $0.10
8ClCHtFXGNplITm+63KB+Q: posts big blind $0.25
WrLI51S2iMb8GLMB83gGqA: sits out 
*** HOLE CARDS ***
pisIQ6Ztya1lC0kTtGSTHw: calls $0.25
BYxjLnV1/LL0aZcTbfAOvw: folds 
ELW+DKizJhLK7k40PMkD2Q: folds 
8ClCHtFXGNplITm+63KB+Q: checks 
*** FLOP *** [Th 8h 9d]
8ClCHtFXGNplITm+63KB+Q: checks 
pisIQ6Ztya1lC0kTtGSTHw: bets $0.50
8ClCHtFXGNplITm+63KB+Q: folds 
Uncalled bet ($0.50) returned to pisIQ6Ztya1lC0kTtGSTHw
pisIQ6Ztya1lC0kTtGSTHw collected $0.60 from pot
pisIQ6Ztya1lC0kTtGSTHw: doesn't show hand 
*** SUMMARY ***
Total pot $0.60 | Rake $0 
Board [Th 8h 9d]
Seat 1: ELW+DKizJhLK7k40PMkD2Q (small blind) folded before Flop
Seat 2: 8ClCHtFXGNplITm+63KB+Q (big blind) folded on the Flop
Seat 4: pisIQ6Ztya1lC0kTtGSTHw collected ($0.60)
Seat 6: BYxjLnV1/LL0aZcTbfAOvw (button) folded before Flop (didn't bet)




PokerStars Game #59939346128:  Hold'em No Limit ($0.10/$0.25) - 2009/07/01 0:37:31 ET
Table 'Rv0EYnRU8WwZiwx0Zo3X3w' 9-max Seat #6 is the button
Seat 1: opOCI2p6kW0tINuVaAqmcQ ($48.15 in chips) 
Seat 2: Xpyqpb+DURDWnyJ3xTEIFQ ($39.90 in chips) 
Seat 3: STkR8XvpjNv79OOMhrlh2w ($25 in chips) 
Seat 4: IDkfbfxTm9KJ+DMyGVH8rw ($12.30 in chips) 
Seat 5: h4ggJZYBXV0mEZzYPYKfeA ($20.85 in chips) 
Seat 6: 5hAPbqNrvJb8PtLiceXtlg ($4.65 in chips) 
Seat 7: Th3FldXKQW6hWVVPahaoOQ ($32.65 in chips) 
Seat 9: r1pFKMwWp74QwhfPWJOAyw ($6.35 in chips) 
Th3FldXKQW6hWVVPahaoOQ: posts small blind $0.10
JxpnpCmvRAcrEUy7mq1iAg: is sitting out 
r1pFKMwWp74QwhfPWJOAyw: posts big blind $0.25
*** HOLE CARDS ***
JxpnpCmvRAcrEUy7mq1iAg leaves the table
opOCI2p6kW0tINuVaAqmcQ: folds 
Xpyqpb+DURDWnyJ3xTEIFQ: folds 
STkR8XvpjNv79OOMhrlh2w: folds 
IDkfbfxTm9KJ+DMyGVH8rw: calls $0.25
h4ggJZYBXV0mEZzYPYKfeA: folds 
5hAPbqNrvJb8PtLiceXtlg: folds 
Th3FldXKQW6hWVVPahaoOQ: folds 
r1pFKMwWp74QwhfPWJOAyw: checks 
*** FLOP *** [7c 3s Jc]
r1pFKMwWp74QwhfPWJOAyw: checks 
IDkfbfxTm9KJ+DMyGVH8rw: checks 
*** TURN *** [7c 3s Jc] [3d]
r1pFKMwWp74QwhfPWJOAyw: bets $0.25
IDkfbfxTm9KJ+DMyGVH8rw: folds 
Uncalled bet ($0.25) returned to r1pFKMwWp74QwhfPWJOAyw
r1pFKMwWp74QwhfPWJOAyw collected $0.60 from pot
*** SUMMARY ***
Total pot $0.60 | Rake $0 
Board [7c 3s Jc 3d]
Seat 1: opOCI2p6kW0tINuVaAqmcQ folded before Flop (didn't bet)
Seat 2: Xpyqpb+DURDWnyJ3xTEIFQ folded before Flop (didn't bet)
Seat 3: STkR8XvpjNv79OOMhrlh2w folded before Flop (didn't bet)
Seat 4: IDkfbfxTm9KJ+DMyGVH8rw folded on the Turn
Seat 5: h4ggJZYBXV0mEZzYPYKfeA folded before Flop (didn't bet)
Seat 6: 5hAPbqNrvJb8PtLiceXtlg (button) folded before Flop (didn't bet)
Seat 7: Th3FldXKQW6hWVVPahaoOQ (small blind) folded before Flop
Seat 9: r1pFKMwWp74QwhfPWJOAyw (big blind) collected ($0.60)




PokerStars Game #59939346126:  Hold'em No Limit ($0.10/$0.25) - 2009/07/01 0:37:31 ET
Table 'nQC9LRg01NEuKFHF1nrDEw0XPo7K54oZIfG0xlNAcDRw-max Seat #6 is the button
Seat 1: Nj6/PdBvfG79w0yeIjPmmA ($12.40 in chips) 
Seat 2: cPO/1/dTcZpLkQFm3jH3Rg ($32.40 in chips) 
Seat 3: 6+g0Lb6vfRDZkElV8ieHyQ ($29.95 in chips) 
Seat 4: tLM9aw7T3kBEIhQEh1roOg ($6.65 in chips) 
Seat 5: kG34n23qFQA3nzdOJTQ1dA ($28.60 in chips) 
Seat 6: xQVFeVUDopz+akuEo2wXpQ ($48.60 in chips) 
Nj6/PdBvfG79w0yeIjPmmA: posts small blind $0.10
cPO/1/dTcZpLkQFm3jH3Rg: posts big blind $0.25
*** HOLE CARDS ***
6+g0Lb6vfRDZkElV8ieHyQ: folds 
tLM9aw7T3kBEIhQEh1roOg: calls $0.25
kG34n23qFQA3nzdOJTQ1dA: folds 
xQVFeVUDopz+akuEo2wXpQ: folds 
Nj6/PdBvfG79w0yeIjPmmA: folds 
cPO/1/dTcZpLkQFm3jH3Rg: checks 
*** FLOP *** [Kc Qs 5h]
cPO/1/dTcZpLkQFm3jH3Rg: checks 
tLM9aw7T3kBEIhQEh1roOg: bets $0.25
cPO/1/dTcZpLkQFm3jH3Rg: folds 
Uncalled bet ($0.25) returned to tLM9aw7T3kBEIhQEh1roOg
6+g0Lb6vfRDZkElV8ieHyQ is sitting out
tLM9aw7T3kBEIhQEh1roOg collected $0.60 from pot
*** SUMMARY ***
Total pot $0.60 | Rake $0 
Board [Kc Qs 5h]
Seat 1: Nj6/PdBvfG79w0yeIjPmmA (small blind) folded before Flop
Seat 2: cPO/1/dTcZpLkQFm3jH3Rg (big blind) folded on the Flop
Seat 3: 6+g0Lb6vfRDZkElV8ieHyQ folded before Flop (didn't bet)
Seat 4: tLM9aw7T3kBEIhQEh1roOg collected ($0.60)
Seat 5: kG34n23qFQA3nzdOJTQ1dA folded before Flop (didn't bet)
Seat 6: xQVFeVUDopz+akuEo2wXpQ (button) folded before Flop (didn't bet)




PokerStars Game #59939346560:  Hold'em No Limit ($0.10/$0.25) - 2009/07/01 0:37:31 ET
Table 'sm5gqEvXgLbkkE4dryW/5g' 6-max Seat #4 is the button
Seat 1: gaPMxLGp9SOj4Lq6t+/0Ig ($13.80 in chips) 
Seat 2: s13YXIlhF/j3TO0bSnT7bA ($9.95 in chips) 
Seat 3: I1TxPvWj8NfG8orglCinNA ($25.35 in chips) 
Seat 4: BedjMfrlRfPgSq7CXpPAmg ($57.65 in chips) 
Seat 5: M+WmDyCD/ZMu/5t6/iH2kw ($77.75 in chips) 
Seat 6: wKFJ513ucluNNiMlkXcDOQ ($28.30 in chips) 
M+WmDyCD/ZMu/5t6/iH2kw: posts small blind $0.10
wKFJ513ucluNNiMlkXcDOQ: posts big blind $0.25
*** HOLE CARDS ***
gaPMxLGp9SOj4Lq6t+/0Ig: calls $0.25
s13YXIlhF/j3TO0bSnT7bA: calls $0.25
I1TxPvWj8NfG8orglCinNA: folds 
BedjMfrlRfPgSq7CXpPAmg: folds 
M+WmDyCD/ZMu/5t6/iH2kw: calls $0.15
wKFJ513ucluNNiMlkXcDOQ: checks 
*** FLOP *** [4s 7h Qh]
M+WmDyCD/ZMu/5t6/iH2kw: bets $1
wKFJ513ucluNNiMlkXcDOQ: folds 
gaPMxLGp9SOj4Lq6t+/0Ig: folds 
s13YXIlhF/j3TO0bSnT7bA: calls $1
*** TURN *** [4s 7h Qh] [8c]
M+WmDyCD/ZMu/5t6/iH2kw: bets $2
s13YXIlhF/j3TO0bSnT7bA: calls $2
*** RIVER *** [4s 7h Qh 8c] [Kd]
M+WmDyCD/ZMu/5t6/iH2kw: checks 
s13YXIlhF/j3TO0bSnT7bA: checks 
*** SHOW DOWN ***
M+WmDyCD/ZMu/5t6/iH2kw: shows [6h Ah] (high card Ace)
s13YXIlhF/j3TO0bSnT7bA: shows [Qc Ac] (a pair of Queens)
s13YXIlhF/j3TO0bSnT7bA collected $6.70 from pot
*** SUMMARY ***
Total pot $7 | Rake $0.30 
Board [4s 7h Qh 8c Kd]
Seat 1: gaPMxLGp9SOj4Lq6t+/0Ig folded on the Flop
Seat 2: s13YXIlhF/j3TO0bSnT7bA showed [Qc Ac] and won ($6.70) with a pair of Queens
Seat 3: I1TxPvWj8NfG8orglCinNA folded before Flop (didn't bet)
Seat 4: BedjMfrlRfPgSq7CXpPAmg (button) folded before Flop (didn't bet)
Seat 5: M+WmDyCD/ZMu/5t6/iH2kw (small blind) showed [6h Ah] and lost with high card Ace
Seat 6: wKFJ513ucluNNiMlkXcDOQ (big blind) folded on the Flop




PokerStars Game #59939346512:  Hold'em No Limit ($0.10/$0.25) - 2009/07/01 0:37:31 ET
Table 'SHi8+hK6i7E2dJ/3Agbyig' 6-max Seat #2 is the button
Seat 1: gPEN9Zp33YTm/mu9/SYP1w ($28.55 in chips) 
Seat 2: Zijzy/UtPWzWVUo81HHVjQ ($44.80 in chips) 
Seat 3: 2p/OXJK5bWQbcvYltdbSfg ($28.40 in chips) 
Seat 4: +KSG/hZ6NXRHDk1WHcV2+Q ($9.65 in chips) 
Seat 5: T5wrp/d5jarm+SxNy8OQAg ($18.75 in chips) 
Seat 6: NVWCcUck2mqZMp/UrHDLKQ ($12 in chips) 
2p/OXJK5bWQbcvYltdbSfg: posts small blind $0.10
+KSG/hZ6NXRHDk1WHcV2+Q: posts big blind $0.25
*** HOLE CARDS ***
T5wrp/d5jarm+SxNy8OQAg: calls $0.25
NVWCcUck2mqZMp/UrHDLKQ: folds 
gPEN9Zp33YTm/mu9/SYP1w: folds 
Zijzy/UtPWzWVUo81HHVjQ: raises $0.50 to $0.75
2p/OXJK5bWQbcvYltdbSfg: folds 
+KSG/hZ6NXRHDk1WHcV2+Q: calls $0.50
T5wrp/d5jarm+SxNy8OQAg: folds 
*** FLOP *** [2h 6d 8d]
+KSG/hZ6NXRHDk1WHcV2+Q: checks 
Zijzy/UtPWzWVUo81HHVjQ: bets $0.90
+KSG/hZ6NXRHDk1WHcV2+Q: raises $8 to $8.90 and is all-in
Zijzy/UtPWzWVUo81HHVjQ: folds 
Uncalled bet ($8) returned to +KSG/hZ6NXRHDk1WHcV2+Q
+KSG/hZ6NXRHDk1WHcV2+Q collected $3.50 from pot
*** SUMMARY ***
Total pot $3.65 | Rake $0.15 
Board [2h 6d 8d]
Seat 1: gPEN9Zp33YTm/mu9/SYP1w folded before Flop (didn't bet)
Seat 2: Zijzy/UtPWzWVUo81HHVjQ (button) folded on the Flop
Seat 3: 2p/OXJK5bWQbcvYltdbSfg (small blind) folded before Flop
Seat 4: +KSG/hZ6NXRHDk1WHcV2+Q (big blind) collected ($3.50)
Seat 5: T5wrp/d5jarm+SxNy8OQAg folded before Flop
Seat 6: NVWCcUck2mqZMp/UrHDLKQ folded before Flop (didn't bet)




PokerStars Game #59939347036:  Hold'em No Limit ($0.10/$0.25) - 2009/07/01 0:37:32 ET
Table 'IRgQPZVA4+IaZZIQshgwyg' 6-max Seat #2 is the button
Seat 1: d0J1xuhsynEY81YHwAvJ5g ($25 in chips) 
Seat 2: 9jSiy0meE9XJKkdIZwyTEQ ($34.35 in chips) 
Seat 3: 8EEqTTh7T1q48sYDqbI2Xg ($28.55 in chips) 
Seat 4: PXXRy0uk7WED5BEf+ReJDQ ($14.65 in chips) 
Seat 5: PbMzPZIePKifKQZfKDkbIw ($26.05 in chips) 
Seat 6: qo39V8/pMxxofM2aciLSWQ ($38.20 in chips) 
8EEqTTh7T1q48sYDqbI2Xg: posts small blind $0.10
PXXRy0uk7WED5BEf+ReJDQ: posts big blind $0.25
*** HOLE CARDS ***
PbMzPZIePKifKQZfKDkbIw: folds 
qo39V8/pMxxofM2aciLSWQ: folds 
d0J1xuhsynEY81YHwAvJ5g: raises $0.75 to $1
9jSiy0meE9XJKkdIZwyTEQ: folds 
8EEqTTh7T1q48sYDqbI2Xg: folds 
PXXRy0uk7WED5BEf+ReJDQ: folds 
Uncalled bet ($0.75) returned to d0J1xuhsynEY81YHwAvJ5g
d0J1xuhsynEY81YHwAvJ5g collected $0.60 from pot
d0J1xuhsynEY81YHwAvJ5g: doesn't show hand 
*** SUMMARY ***
Total pot $0.60 | Rake $0 
Seat 1: d0J1xuhsynEY81YHwAvJ5g collected ($0.60)
Seat 2: 9jSiy0meE9XJKkdIZwyTEQ (button) folded before Flop (didn't bet)
Seat 3: 8EEqTTh7T1q48sYDqbI2Xg (small blind) folded before Flop
Seat 4: PXXRy0uk7WED5BEf+ReJDQ (big blind) folded before Flop
Seat 5: PbMzPZIePKifKQZfKDkbIw folded before Flop (didn't bet)
Seat 6: qo39V8/pMxxofM2aciLSWQ folded before Flop (didn't bet)




PokerStars Game #59939346820:  Hold'em No Limit ($0.10/$0.25) - 2009/07/01 0:37:32 ET
Table 'b64Z+5XI1xkQzNfq4QHr3A' 6-max Seat #4 is the button
Seat 1: qccGLncfUaN00Few5HsgYg ($50.45 in chips) 
Seat 2: SS/yfeArhULzIcOPe8MdPg ($34.75 in chips) 
Seat 4: SxIIgwXYLkwd6m3wLyPTCw ($25 in chips) 
Seat 5: d0J1xuhsynEY81YHwAvJ5g ($33.50 in chips) 
Seat 6: 8ClCHtFXGNplITm+63KB+Q ($38.20 in chips) 
d0J1xuhsynEY81YHwAvJ5g: posts small blind $0.10
8ClCHtFXGNplITm+63KB+Q: posts big blind $0.25
*** HOLE CARDS ***
qccGLncfUaN00Few5HsgYg: folds 
SS/yfeArhULzIcOPe8MdPg: folds 
SxIIgwXYLkwd6m3wLyPTCw: folds 
d0J1xuhsynEY81YHwAvJ5g: calls $0.15
8ClCHtFXGNplITm+63KB+Q: checks 
*** FLOP *** [Jc Ks As]
d0J1xuhsynEY81YHwAvJ5g: checks 
8ClCHtFXGNplITm+63KB+Q: bets $0.50
d0J1xuhsynEY81YHwAvJ5g: folds 
Uncalled bet ($0.50) returned to 8ClCHtFXGNplITm+63KB+Q
8ClCHtFXGNplITm+63KB+Q collected $0.50 from pot
8ClCHtFXGNplITm+63KB+Q: doesn't show hand 
*** SUMMARY ***
Total pot $0.50 | Rake $0 
Board [Jc Ks As]
Seat 1: qccGLncfUaN00Few5HsgYg folded before Flop (didn't bet)
Seat 2: SS/yfeArhULzIcOPe8MdPg folded before Flop (didn't bet)
Seat 4: SxIIgwXYLkwd6m3wLyPTCw (button) folded before Flop (didn't bet)
Seat 5: d0J1xuhsynEY81YHwAvJ5g (small blind) folded on the Flop
Seat 6: 8ClCHtFXGNplITm+63KB+Q (big blind) collected ($0.50)




PokerStars Game #59939347058:  Hold'em No Limit ($0.10/$0.25) - 2009/07/01 0:37:32 ET
Table 'VuY5ej47Cy8nOI3Wogmhzw' 6-max Seat #3 is the button
Seat 1: PUTXJX6bVODW3ITgBX0GuQ ($15.60 in chips) 
Seat 3: 0n9nsjvz4GIG4IyVHT0JVw ($6.10 in chips) 
Seat 4: FC6tJ9EOiutXO8hnpR4VgQ ($3.40 in chips) 
FC6tJ9EOiutXO8hnpR4VgQ: posts small blind $0.10
PUTXJX6bVODW3ITgBX0GuQ: posts big blind $0.25
*** HOLE CARDS ***
0n9nsjvz4GIG4IyVHT0JVw: calls $0.25
FC6tJ9EOiutXO8hnpR4VgQ: folds 
PUTXJX6bVODW3ITgBX0GuQ: checks 
*** FLOP *** [9s Td 4c]
PUTXJX6bVODW3ITgBX0GuQ: checks 
0n9nsjvz4GIG4IyVHT0JVw: checks 
*** TURN *** [9s Td 4c] [Qc]
PUTXJX6bVODW3ITgBX0GuQ: checks 
0n9nsjvz4GIG4IyVHT0JVw: checks 
*** RIVER *** [9s Td 4c Qc] [Jd]
PUTXJX6bVODW3ITgBX0GuQ: checks 
0n9nsjvz4GIG4IyVHT0JVw: checks 
*** SHOW DOWN ***
PUTXJX6bVODW3ITgBX0GuQ: shows [6d 7s] (high card Queen)
0n9nsjvz4GIG4IyVHT0JVw: shows [2h Ad] (high card Ace)
0n9nsjvz4GIG4IyVHT0JVw collected $0.60 from pot
*** SUMMARY ***
Total pot $0.60 | Rake $0 
Board [9s Td 4c Qc Jd]
Seat 1: PUTXJX6bVODW3ITgBX0GuQ (big blind) showed [6d 7s] and lost with high card Queen
Seat 3: 0n9nsjvz4GIG4IyVHT0JVw (button) showed [2h Ad] and won ($0.60) with high card Ace
Seat 4: FC6tJ9EOiutXO8hnpR4VgQ (small blind) folded before Flop




PokerStars Game #59939346996:  Hold'em No Limit ($0.10/$0.25) - 2009/07/01 0:37:32 ET
Table 'ZiwAqg4o02gNro+JOAaFNg6wawJ+MkkvuC3coG6r+YhgSeat #8 is the button
Seat 1: j4q3p0lesp63b1gZDwLBZw ($5 in chips) 
Seat 2: tYsOBqdU1+x+yFI7zHO7hQ ($29.75 in chips) 
Seat 3: aNpwfA31EREwO+ar4XzBCw ($25 in chips) 
Seat 4: FJflwqC6fqOpM3j0q8Bptw ($19.40 in chips) 
Seat 6: hBMUlEpyU74r/fwDgIpXjQ ($27.60 in chips) 
Seat 7: ZWU9RNYtjmm4cElg1I0F4w ($27.20 in chips) 
Seat 8: CYkY0dNBaYaKs8HVCVn3mQ ($5 in chips) 
Seat 9: ljemhp25Zg+nlA9DLCIiUw ($24.75 in chips) 
ljemhp25Zg+nlA9DLCIiUw: posts small blind $0.10
j4q3p0lesp63b1gZDwLBZw: posts big blind $0.25
5hAPbqNrvJb8PtLiceXtlg6HoFYfVGBefsR5Vrz62qIwts out 
*** HOLE CARDS ***
tYsOBqdU1+x+yFI7zHO7hQ: folds 
aNpwfA31EREwO+ar4XzBCw: folds 
FJflwqC6fqOpM3j0q8Bptw: folds 
hBMUlEpyU74r/fwDgIpXjQ: raises $0.50 to $0.75
ZWU9RNYtjmm4cElg1I0F4w: folds 
CYkY0dNBaYaKs8HVCVn3mQ: folds 
ljemhp25Zg+nlA9DLCIiUw: folds 
j4q3p0lesp63b1gZDwLBZw: folds 
Uncalled bet ($0.50) returned to hBMUlEpyU74r/fwDgIpXjQ
hBMUlEpyU74r/fwDgIpXjQ collected $0.60 from pot
hBMUlEpyU74r/fwDgIpXjQ: doesn't show hand 
*** SUMMARY ***
Total pot $0.60 | Rake $0 
Seat 1: j4q3p0lesp63b1gZDwLBZw (big blind) folded before Flop
Seat 2: tYsOBqdU1+x+yFI7zHO7hQ folded before Flop (didn't bet)
Seat 3: aNpwfA31EREwO+ar4XzBCw folded before Flop (didn't bet)
Seat 4: FJflwqC6fqOpM3j0q8Bptw folded before Flop (didn't bet)
Seat 6: hBMUlEpyU74r/fwDgIpXjQ collected ($0.60)
Seat 7: ZWU9RNYtjmm4cElg1I0F4w folded before Flop (didn't bet)
Seat 8: CYkY0dNBaYaKs8HVCVn3mQ (button) folded before Flop (didn't bet)
Seat 9: ljemhp25Zg+nlA9DLCIiUw (small blind) folded before Flop




PokerStars Game #59939347002:  Hold'em No Limit ($0.10/$0.25) - 2009/07/01 0:37:32 ET
Table 'A1MqSL0j9xG0S/68IwXqhw' 6-max Seat #2 is the button
Seat 1: DXgVFTcE3WofABsNJ5G/nw ($16.35 in chips) 
Seat 2: /6h8PvAHQmfuMUZ8OUF6Xw ($16.35 in chips) 
Seat 3: kG34n23qFQA3nzdOJTQ1dA ($33.60 in chips) 
Seat 6: df01R5ThvHspD8FgKmaDvQ ($34.95 in chips) 
kG34n23qFQA3nzdOJTQ1dA: posts small blind $0.10
q9qPRjJC40e/Q9yuT+glwQ: is sitting out 
df01R5ThvHspD8FgKmaDvQ: posts big blind $0.25
*** HOLE CARDS ***
DXgVFTcE3WofABsNJ5G/nw: folds 
/6h8PvAHQmfuMUZ8OUF6Xw: calls $0.25
kG34n23qFQA3nzdOJTQ1dA: calls $0.15
DXgVFTcE3WofABsNJ5G/nw leaves the table
df01R5ThvHspD8FgKmaDvQ: checks 
*** FLOP *** [8h 2h 4s]
kG34n23qFQA3nzdOJTQ1dA: checks 
df01R5ThvHspD8FgKmaDvQ: checks 
/6h8PvAHQmfuMUZ8OUF6Xw: checks 
*** TURN *** [8h 2h 4s] [2s]
kG34n23qFQA3nzdOJTQ1dA: checks 
df01R5ThvHspD8FgKmaDvQ: checks 
/6h8PvAHQmfuMUZ8OUF6Xw: bets $0.55
kG34n23qFQA3nzdOJTQ1dA: folds 
df01R5ThvHspD8FgKmaDvQ: folds 
Uncalled bet ($0.55) returned to /6h8PvAHQmfuMUZ8OUF6Xw
/6h8PvAHQmfuMUZ8OUF6Xw collected $0.75 from pot
/6h8PvAHQmfuMUZ8OUF6Xw: doesn't show hand 
*** SUMMARY ***
Total pot $0.75 | Rake $0 
Board [8h 2h 4s 2s]
Seat 1: DXgVFTcE3WofABsNJ5G/nw folded before Flop (didn't bet)
Seat 2: /6h8PvAHQmfuMUZ8OUF6Xw (button) collected ($0.75)
Seat 3: kG34n23qFQA3nzdOJTQ1dA (small blind) folded on the Turn
Seat 6: df01R5ThvHspD8FgKmaDvQ (big blind) folded on the Turn




PokerStars Game #59939347222:  Hold'em No Limit ($0.10/$0.25) - 2009/07/01 0:37:32 ET
Table 'vud0GB/ZlDCvUFhBFIaTlg' 9-max Seat #7 is the button
Seat 7: RzaVufWfW9CTnVYR7/Ge+w ($3.45 in chips) 
Seat 8: 7cv+9Zc9HIQHNvYsMfV3uA ($31.45 in chips) 
RzaVufWfW9CTnVYR7/Ge+w: posts small blind $0.10
7cv+9Zc9HIQHNvYsMfV3uA: posts big blind $0.25
*** HOLE CARDS ***
RzaVufWfW9CTnVYR7/Ge+w: calls $0.15
7cv+9Zc9HIQHNvYsMfV3uA: checks 
*** FLOP *** [3s 7d Ad]
7cv+9Zc9HIQHNvYsMfV3uA: checks 
RzaVufWfW9CTnVYR7/Ge+w: bets $0.25
7cv+9Zc9HIQHNvYsMfV3uA: folds 
Uncalled bet ($0.25) returned to RzaVufWfW9CTnVYR7/Ge+w
7cv+9Zc9HIQHNvYsMfV3uA leaves the table
RzaVufWfW9CTnVYR7/Ge+w collected $0.50 from pot
RzaVufWfW9CTnVYR7/Ge+w: doesn't show hand 
*** SUMMARY ***
Total pot $0.50 | Rake $0 
Board [3s 7d Ad]
Seat 7: RzaVufWfW9CTnVYR7/Ge+w (button) (small blind) collected ($0.50)
Seat 8: 7cv+9Zc9HIQHNvYsMfV3uA (big blind) folded on the Flop




PokerStars Game #59939347056:  Hold'em No Limit ($0.10/$0.25) - 2009/07/01 0:37:32 ET
Table 'G+4ZdyRoPjgaJY/jxSlZzQ' 9-max Seat #3 is the button
Seat 1: 0Ui5PFTLvpoTRdxcc8BNSQ ($33.95 in chips) 
Seat 2: 4awUyiDYTgylQKXZ9faBVA ($36.05 in chips) 
Seat 3: opOCI2p6kW0tINuVaAqmcQ ($28.95 in chips) 
Seat 4: yindad6WXRlkjbK12URYkA ($9.50 in chips) 
Seat 5: s7Q6uNouhe7aE8JdFb9E+A ($26.60 in chips) 
Seat 6: gehe91e0IyVT0QU/XBkEyg ($25 in chips) 
Seat 7: ie4EwTMMFYxrCXcenJdzsw ($8.35 in chips) 
Seat 8: jXz58rvCgq0VjyVjUBf2mw ($39.05 in chips) 
Seat 9: AzTBzPGlrIHrrs1Q8oKcGA ($18.05 in chips) 
yindad6WXRlkjbK12URYkA: posts small blind $0.10
s7Q6uNouhe7aE8JdFb9E+A: posts big blind $0.25
*** HOLE CARDS ***
gehe91e0IyVT0QU/XBkEyg: folds 
ie4EwTMMFYxrCXcenJdzsw: folds 
jXz58rvCgq0VjyVjUBf2mw: folds 
AzTBzPGlrIHrrs1Q8oKcGA: folds 
0Ui5PFTLvpoTRdxcc8BNSQ: calls $0.25
4awUyiDYTgylQKXZ9faBVA: folds 
opOCI2p6kW0tINuVaAqmcQ: folds 
yindad6WXRlkjbK12URYkA: calls $0.15
s7Q6uNouhe7aE8JdFb9E+A: checks 
*** FLOP *** [6h 3s 5s]
yindad6WXRlkjbK12URYkA: checks 
s7Q6uNouhe7aE8JdFb9E+A: checks 
0Ui5PFTLvpoTRdxcc8BNSQ: checks 
*** TURN *** [6h 3s 5s] [2d]
yindad6WXRlkjbK12URYkA: bets $0.75
s7Q6uNouhe7aE8JdFb9E+A: folds 
0Ui5PFTLvpoTRdxcc8BNSQ: folds 
Uncalled bet ($0.75) returned to yindad6WXRlkjbK12URYkA
yindad6WXRlkjbK12URYkA collected $0.75 from pot
*** SUMMARY ***
Total pot $0.75 | Rake $0 
Board [6h 3s 5s 2d]
Seat 1: 0Ui5PFTLvpoTRdxcc8BNSQ folded on the Turn
Seat 2: 4awUyiDYTgylQKXZ9faBVA folded before Flop (didn't bet)
Seat 3: opOCI2p6kW0tINuVaAqmcQ (button) folded before Flop (didn't bet)
Seat 4: yindad6WXRlkjbK12URYkA (small blind) collected ($0.75)
Seat 5: s7Q6uNouhe7aE8JdFb9E+A (big blind) folded on the Turn
Seat 6: gehe91e0IyVT0QU/XBkEyg folded before Flop (didn't bet)
Seat 7: ie4EwTMMFYxrCXcenJdzsw folded before Flop (didn't bet)
Seat 8: jXz58rvCgq0VjyVjUBf2mw folded before Flop (didn't bet)
Seat 9: AzTBzPGlrIHrrs1Q8oKcGA folded before Flop (didn't bet)




PokerStars Game #59939347714:  Hold'em No Limit ($0.10/$0.25) - 2009/07/01 0:37:33 ET
Table 'Qk/910N2Yhg8u5vqTJk50Q' 9-max Seat #3 is the button
Seat 1: zDrucyjVn5aeekNEc3cJrA ($25.25 in chips) 
Seat 2: Th3FldXKQW6hWVVPahaoOQ ($33.20 in chips) 
Seat 3: ghNKXUBl/H+t83JF079ZBA ($25 in chips) 
Seat 4: 33y9+GmQ3J84RvZXcraRTw ($21.70 in chips) 
Seat 5: 4oA316mXLIui1QY63GXBUg ($27.10 in chips) 
Seat 6: st9jtdNbm1W5GfBwRaCVqQ ($33.95 in chips) 
Seat 7: Wem/MTN+sc9vH/UZeT5YLQ ($9.65 in chips) 
Seat 8: H5Se03ZqSX7tbULXur2MAg ($25.10 in chips) 
Seat 9: M2QO2DxB5Wawg2h8HSpnYA ($10 in chips) 
33y9+GmQ3J84RvZXcraRTw: posts small blind $0.10
4oA316mXLIui1QY63GXBUg: posts big blind $0.25
*** HOLE CARDS ***
st9jtdNbm1W5GfBwRaCVqQ: folds 
Wem/MTN+sc9vH/UZeT5YLQ: folds 
H5Se03ZqSX7tbULXur2MAg: folds 
M2QO2DxB5Wawg2h8HSpnYA: folds 
zDrucyjVn5aeekNEc3cJrA: folds 
Th3FldXKQW6hWVVPahaoOQ: folds 
ghNKXUBl/H+t83JF079ZBA: folds 
33y9+GmQ3J84RvZXcraRTw: calls $0.15
4oA316mXLIui1QY63GXBUg: checks 
*** FLOP *** [Td 5c 2s]
33y9+GmQ3J84RvZXcraRTw: checks 
4oA316mXLIui1QY63GXBUg: bets $0.50
33y9+GmQ3J84RvZXcraRTw: folds 
Uncalled bet ($0.50) returned to 4oA316mXLIui1QY63GXBUg
4oA316mXLIui1QY63GXBUg collected $0.50 from pot
4oA316mXLIui1QY63GXBUg: doesn't show hand 
*** SUMMARY ***
Total pot $0.50 | Rake $0 
Board [Td 5c 2s]
Seat 1: zDrucyjVn5aeekNEc3cJrA folded before Flop (didn't bet)
Seat 2: Th3FldXKQW6hWVVPahaoOQ folded before Flop (didn't bet)
Seat 3: ghNKXUBl/H+t83JF079ZBA (button) folded before Flop (didn't bet)
Seat 4: 33y9+GmQ3J84RvZXcraRTw (small blind) folded on the Flop
Seat 5: 4oA316mXLIui1QY63GXBUg (big blind) collected ($0.50)
Seat 6: st9jtdNbm1W5GfBwRaCVqQ folded before Flop (didn't bet)
Seat 7: Wem/MTN+sc9vH/UZeT5YLQ folded before Flop (didn't bet)
Seat 8: H5Se03ZqSX7tbULXur2MAg folded before Flop (didn't bet)
Seat 9: M2QO2DxB5Wawg2h8HSpnYA folded before Flop (didn't bet)




PokerStars Game #59939347872:  Hold'em No Limit ($0.10/$0.25) - 2009/07/01 0:37:33 ET
Table '3eK1r4Q4BSYFvsKkuTLpIA' 9-max Seat #7 is the button
Seat 1: qwr38jl5txoR36M7G5qi4A ($7.75 in chips) 
Seat 2: 7QzbjWT00wQpau1iqvUmMA ($5 in chips) 
Seat 3: 56S3mA6Zs3pGR+0p0vUCtg ($33.55 in chips) 
Seat 4: S2iyN4Q7njjhguIuE5g1CQ ($23.20 in chips) 
Seat 5: 1K6QGyJP9P9xmRac2fH4OQ ($32.90 in chips) 
Seat 6: +HvCCmsGSQeatf+GZ9zk8Q ($18.75 in chips) 
Seat 7: GTcLfsDTPqgfHyhY9FNDMw ($6.65 in chips) 
Seat 8: Cni99AOp8W/F0ZWCuHNcIA ($12.15 in chips) 
Seat 9: +sbyWwIcFp9kP0bDtMegfQ ($38.10 in chips) 
Cni99AOp8W/F0ZWCuHNcIA: posts small blind $0.10
+sbyWwIcFp9kP0bDtMegfQ: posts big blind $0.25
*** HOLE CARDS ***
qwr38jl5txoR36M7G5qi4A: folds 
7QzbjWT00wQpau1iqvUmMA: folds 
56S3mA6Zs3pGR+0p0vUCtg: folds 
S2iyN4Q7njjhguIuE5g1CQ: folds 
1K6QGyJP9P9xmRac2fH4OQ: raises $0.75 to $1
+HvCCmsGSQeatf+GZ9zk8Q: folds 
GTcLfsDTPqgfHyhY9FNDMw: raises $2.75 to $3.75
Cni99AOp8W/F0ZWCuHNcIA: folds 
+sbyWwIcFp9kP0bDtMegfQ: folds 
1K6QGyJP9P9xmRac2fH4OQ: folds 
Uncalled bet ($2.75) returned to GTcLfsDTPqgfHyhY9FNDMw
GTcLfsDTPqgfHyhY9FNDMw collected $2.35 from pot
GTcLfsDTPqgfHyhY9FNDMw: doesn't show hand 
*** SUMMARY ***
Total pot $2.35 | Rake $0 
Seat 1: qwr38jl5txoR36M7G5qi4A folded before Flop (didn't bet)
Seat 2: 7QzbjWT00wQpau1iqvUmMA folded before Flop (didn't bet)
Seat 3: 56S3mA6Zs3pGR+0p0vUCtg folded before Flop (didn't bet)
Seat 4: S2iyN4Q7njjhguIuE5g1CQ folded before Flop (didn't bet)
Seat 5: 1K6QGyJP9P9xmRac2fH4OQ folded before Flop
Seat 6: +HvCCmsGSQeatf+GZ9zk8Q folded before Flop (didn't bet)
Seat 7: GTcLfsDTPqgfHyhY9FNDMw (button) collected ($2.35)
Seat 8: Cni99AOp8W/F0ZWCuHNcIA (small blind) folded before Flop
Seat 9: +sbyWwIcFp9kP0bDtMegfQ (big blind) folded before Flop




PokerStars Game #59939347840:  Hold'em No Limit ($0.10/$0.25) - 2009/07/01 0:37:33 ET
Table 'axb9RsG8Zj1A0LEukTeFrQ' 9-max Seat #8 is the button
Seat 1: qwr38jl5txoR36M7G5qi4A ($9.50 in chips) 
Seat 2: zDrucyjVn5aeekNEc3cJrA ($23.20 in chips) 
Seat 3: cZ99hugmLBj9KhTlc8nCSw ($28 in chips) 
Seat 4: TeWJxSETzbXGiYKx0y+dtg ($25 in chips) 
Seat 5: rLSSHKOHnb6yzVfDoQM/RA ($12.80 in chips) 
Seat 6: FSuhElWc38JXYToR0dwhjg ($17.20 in chips) 
Seat 7: 1K6QGyJP9P9xmRac2fH4OQ ($30.70 in chips) 
Seat 8: CqwJk5Z2+vb2f9j1o7IjKQ ($28.30 in chips) 
Seat 9: qbQE8CifKB4+OEvNF/61Rw ($36.25 in chips) 
qbQE8CifKB4+OEvNF/61Rw: posts small blind $0.10
qwr38jl5txoR36M7G5qi4A: posts big blind $0.25
*** HOLE CARDS ***
zDrucyjVn5aeekNEc3cJrA: folds 
cZ99hugmLBj9KhTlc8nCSw: folds 
TeWJxSETzbXGiYKx0y+dtg: folds 
rLSSHKOHnb6yzVfDoQM/RA: calls $0.25
FSuhElWc38JXYToR0dwhjg: folds 
1K6QGyJP9P9xmRac2fH4OQ: folds 
CqwJk5Z2+vb2f9j1o7IjKQ: folds 
qbQE8CifKB4+OEvNF/61Rw: calls $0.15
qwr38jl5txoR36M7G5qi4A: checks 
*** FLOP *** [9s 2s 4d]
qbQE8CifKB4+OEvNF/61Rw: checks 
qwr38jl5txoR36M7G5qi4A: bets $0.75
rLSSHKOHnb6yzVfDoQM/RA: folds 
qbQE8CifKB4+OEvNF/61Rw: folds 
Uncalled bet ($0.75) returned to qwr38jl5txoR36M7G5qi4A
qwr38jl5txoR36M7G5qi4A collected $0.75 from pot
qwr38jl5txoR36M7G5qi4A: doesn't show hand 
*** SUMMARY ***
Total pot $0.75 | Rake $0 
Board [9s 2s 4d]
Seat 1: qwr38jl5txoR36M7G5qi4A (big blind) collected ($0.75)
Seat 2: zDrucyjVn5aeekNEc3cJrA folded before Flop (didn't bet)
Seat 3: cZ99hugmLBj9KhTlc8nCSw folded before Flop (didn't bet)
Seat 4: TeWJxSETzbXGiYKx0y+dtg folded before Flop (didn't bet)
Seat 5: rLSSHKOHnb6yzVfDoQM/RA folded on the Flop
Seat 6: FSuhElWc38JXYToR0dwhjg folded before Flop (didn't bet)
Seat 7: 1K6QGyJP9P9xmRac2fH4OQ folded before Flop (didn't bet)
Seat 8: CqwJk5Z2+vb2f9j1o7IjKQ (button) folded before Flop (didn't bet)
Seat 9: qbQE8CifKB4+OEvNF/61Rw (small blind) folded on the Flop




PokerStars Game #59939347942:  Hold'em No Limit ($0.10/$0.25) - 2009/07/01 0:37:33 ET
Table 'RuT55t7dqtns1CdLsutksg' 9-max Seat #2 is the button
Seat 1: N6WEabmk+J6IGeE7kub1QQ ($36.55 in chips) 
Seat 2: CYkY0dNBaYaKs8HVCVn3mQ ($5.90 in chips) 
Seat 3: xOx0qYgTfvbPkTa+GuX0WA ($17.10 in chips) 
Seat 4: MG90wfSJZnOejs/KD3vlQQ ($25.75 in chips) 
Seat 5: 0D3Q+hLxjPei/5wgaaYhZA ($6.40 in chips) 
Seat 6: CqwJk5Z2+vb2f9j1o7IjKQ ($13.50 in chips) 
Seat 7: Il5IBomZPnY0uD8k+rlPyw ($18.90 in chips) 
Seat 9: oAO88RFrn7cbQFHZt8VrkA ($35.65 in chips) 
xOx0qYgTfvbPkTa+GuX0WA: posts small blind $0.10
MG90wfSJZnOejs/KD3vlQQ: posts big blind $0.25
yyG4svzOpC1A+sUP/scg6w: sits out 
*** HOLE CARDS ***
0D3Q+hLxjPei/5wgaaYhZA: folds 
CqwJk5Z2+vb2f9j1o7IjKQ: folds 
Il5IBomZPnY0uD8k+rlPyw: folds 
oAO88RFrn7cbQFHZt8VrkA: folds 
N6WEabmk+J6IGeE7kub1QQ: folds 
CYkY0dNBaYaKs8HVCVn3mQ: folds 
xOx0qYgTfvbPkTa+GuX0WA: folds 
Uncalled bet ($0.15) returned to MG90wfSJZnOejs/KD3vlQQ
MG90wfSJZnOejs/KD3vlQQ collected $0.20 from pot
MG90wfSJZnOejs/KD3vlQQ: doesn't show hand 
*** SUMMARY ***
Total pot $0.20 | Rake $0 
Seat 1: N6WEabmk+J6IGeE7kub1QQ folded before Flop (didn't bet)
Seat 2: CYkY0dNBaYaKs8HVCVn3mQ (button) folded before Flop (didn't bet)
Seat 3: xOx0qYgTfvbPkTa+GuX0WA (small blind) folded before Flop
Seat 4: MG90wfSJZnOejs/KD3vlQQ (big blind) collected ($0.20)
Seat 5: 0D3Q+hLxjPei/5wgaaYhZA folded before Flop (didn't bet)
Seat 6: CqwJk5Z2+vb2f9j1o7IjKQ folded before Flop (didn't bet)
Seat 7: Il5IBomZPnY0uD8k+rlPyw folded before Flop (didn't bet)
Seat 9: oAO88RFrn7cbQFHZt8VrkA folded before Flop (didn't bet)




PokerStars Game #59939347808:  Hold'em No Limit ($0.10/$0.25) - 2009/07/01 0:37:33 ET
Table '+68ihX5Br1xgGorX6zsCBg' 9-max Seat #1 is the button
Seat 1: qwr38jl5txoR36M7G5qi4A ($8.40 in chips) 
Seat 2: 3PjJjazzeHcM4mbFeXmZBg ($8.35 in chips) 
Seat 3: DIBbjEYGs+TVdVgEB/4+3w ($25.75 in chips) 
Seat 5: AmFFUA8KSwLGIW6CfaP4JQ ($12.15 in chips) 
Seat 6: 8B/dhbQjIWe6ASCdgzktNQ ($25.25 in chips) 
Seat 7: LWN1wPrLH+695JIriXxDuw ($9.05 in chips) 
Seat 8: rUdM7gwmNCaxMNSb2CFPhQ ($12.85 in chips) 
Seat 9: 3wk6bqORFdwo0pZ1g2+Kqw ($21.15 in chips) 
3PjJjazzeHcM4mbFeXmZBg: posts small blind $0.10
DIBbjEYGs+TVdVgEB/4+3w: posts big blind $0.25
*** HOLE CARDS ***
AmFFUA8KSwLGIW6CfaP4JQ: folds 
8B/dhbQjIWe6ASCdgzktNQ: folds 
LWN1wPrLH+695JIriXxDuw: folds 
rUdM7gwmNCaxMNSb2CFPhQ: calls $0.25
STkR8XvpjNv79OOMhrlh2w joins the table at seat #4 
3wk6bqORFdwo0pZ1g2+Kqw: folds 
qwr38jl5txoR36M7G5qi4A: folds 
3PjJjazzeHcM4mbFeXmZBg: folds 
DIBbjEYGs+TVdVgEB/4+3w: checks 
*** FLOP *** [Kh 2h Js]
DIBbjEYGs+TVdVgEB/4+3w: checks 
rUdM7gwmNCaxMNSb2CFPhQ: bets $0.50
DIBbjEYGs+TVdVgEB/4+3w: folds 
Uncalled bet ($0.50) returned to rUdM7gwmNCaxMNSb2CFPhQ
rUdM7gwmNCaxMNSb2CFPhQ collected $0.60 from pot
rUdM7gwmNCaxMNSb2CFPhQ: doesn't show hand 
*** SUMMARY ***
Total pot $0.60 | Rake $0 
Board [Kh 2h Js]
Seat 1: qwr38jl5txoR36M7G5qi4A (button) folded before Flop (didn't bet)
Seat 2: 3PjJjazzeHcM4mbFeXmZBg (small blind) folded before Flop
Seat 3: DIBbjEYGs+TVdVgEB/4+3w (big blind) folded on the Flop
Seat 5: AmFFUA8KSwLGIW6CfaP4JQ folded before Flop (didn't bet)
Seat 6: 8B/dhbQjIWe6ASCdgzktNQ folded before Flop (didn't bet)
Seat 7: LWN1wPrLH+695JIriXxDuw folded before Flop (didn't bet)
Seat 8: rUdM7gwmNCaxMNSb2CFPhQ collected ($0.60)
Seat 9: 3wk6bqORFdwo0pZ1g2+Kqw folded before Flop (didn't bet)




PokerStars Game #59939347422:  Hold'em No Limit ($0.10/$0.25) - 2009/07/01 0:37:33 ET
Table '9iHhO6FyZVM8XpSc23TIgg' 6-max Seat #5 is the button
Seat 1: NhUN/JpAprdJeamFBgJH1w ($25 in chips) 
Seat 2: ErIN0JRL5srYjT6en1f8YQ ($23.85 in chips) 
Seat 3: EXTSABh+qTpWWrIkxl3wXg ($44 in chips) 
Seat 4: cfJccEfyn6IkquPN08hFsA ($33.55 in chips) 
Seat 5: WmfI+HZXhME/HMG8E3/H2w ($15.40 in chips) 
Seat 6: 5z4PIVM9IyDWfUi+/MMdTA ($24.40 in chips) 
5z4PIVM9IyDWfUi+/MMdTA: posts small blind $0.10
NhUN/JpAprdJeamFBgJH1w: posts big blind $0.25
*** HOLE CARDS ***
ErIN0JRL5srYjT6en1f8YQ: folds 
EXTSABh+qTpWWrIkxl3wXg: folds 
cfJccEfyn6IkquPN08hFsA: folds 
WmfI+HZXhME/HMG8E3/H2w: raises $0.50 to $0.75
5z4PIVM9IyDWfUi+/MMdTA: folds 
NhUN/JpAprdJeamFBgJH1w: folds 
Uncalled bet ($0.50) returned to WmfI+HZXhME/HMG8E3/H2w
WmfI+HZXhME/HMG8E3/H2w collected $0.60 from pot
*** SUMMARY ***
Total pot $0.60 | Rake $0 
Seat 1: NhUN/JpAprdJeamFBgJH1w (big blind) folded before Flop
Seat 2: ErIN0JRL5srYjT6en1f8YQ folded before Flop (didn't bet)
Seat 3: EXTSABh+qTpWWrIkxl3wXg folded before Flop (didn't bet)
Seat 4: cfJccEfyn6IkquPN08hFsA folded before Flop (didn't bet)
Seat 5: WmfI+HZXhME/HMG8E3/H2w (button) collected ($0.60)
Seat 6: 5z4PIVM9IyDWfUi+/MMdTA (small blind) folded before Flop




PokerStars Game #59939348408:  Hold'em No Limit ($0.10/$0.25) - 2009/07/01 0:37:34 ET
Table '/XCUCUl3yW6tdTJQEhJKGw' 6-max Seat #4 is the button
Seat 1: p8J112JmNRnCwV2+NAEzCA ($15.30 in chips) 
Seat 2: 8ClCHtFXGNplITm+63KB+Q ($27.25 in chips) 
Seat 3: /gJNBeCkWL4o85/jvlZ4BA ($35.60 in chips) 
Seat 4: SFmT9ZsVopnukjvAzrxTRg ($25 in chips) 
Seat 5: 3rlIjSrvbZoI2IILbnetnA ($25.10 in chips) 
Seat 6: armfxZhGxeZVZBYAQFuIJQ ($36.80 in chips) 
3rlIjSrvbZoI2IILbnetnA: posts small blind $0.10
armfxZhGxeZVZBYAQFuIJQ: posts big blind $0.25
*** HOLE CARDS ***
p8J112JmNRnCwV2+NAEzCA: folds 
8ClCHtFXGNplITm+63KB+Q: folds 
/gJNBeCkWL4o85/jvlZ4BA: folds 
SFmT9ZsVopnukjvAzrxTRg: folds 
3rlIjSrvbZoI2IILbnetnA: calls $0.15
armfxZhGxeZVZBYAQFuIJQ: checks 
*** FLOP *** [Jc 7s 4c]
3rlIjSrvbZoI2IILbnetnA: checks 
armfxZhGxeZVZBYAQFuIJQ: checks 
*** TURN *** [Jc 7s 4c] [Jh]
3rlIjSrvbZoI2IILbnetnA: checks 
armfxZhGxeZVZBYAQFuIJQ: checks 
*** RIVER *** [Jc 7s 4c Jh] [Qd]
3rlIjSrvbZoI2IILbnetnA: checks 
armfxZhGxeZVZBYAQFuIJQ: checks 
*** SHOW DOWN ***
3rlIjSrvbZoI2IILbnetnA: shows [Td 9d] (a pair of Jacks)
armfxZhGxeZVZBYAQFuIJQ: mucks hand 
3rlIjSrvbZoI2IILbnetnA collected $0.50 from pot
*** SUMMARY ***
Total pot $0.50 | Rake $0 
Board [Jc 7s 4c Jh Qd]
Seat 1: p8J112JmNRnCwV2+NAEzCA folded before Flop (didn't bet)
Seat 2: 8ClCHtFXGNplITm+63KB+Q folded before Flop (didn't bet)
Seat 3: /gJNBeCkWL4o85/jvlZ4BA folded before Flop (didn't bet)
Seat 4: SFmT9ZsVopnukjvAzrxTRg (button) folded before Flop (didn't bet)
Seat 5: 3rlIjSrvbZoI2IILbnetnA (small blind) showed [Td 9d] and won ($0.50) with a pair of Jacks
Seat 6: armfxZhGxeZVZBYAQFuIJQ (big blind) mucked




PokerStars Game #59939348572:  Hold'em No Limit ($0.10/$0.25) - 2009/07/01 0:37:34 ET
Table 'CM/C/FZf3VHIp50RjmBucQ' 9-max Seat #3 is the button
Seat 1: 1Clf3cPrqoy/YgvWdWK1Xw ($5 in chips) 
Seat 2: 1S/fpm+f42V/6MNZre+ccg ($28.10 in chips) 
Seat 3: dfNim92Z6XK1/h5SFW5vDg ($29.40 in chips) 
Seat 4: oXv2YWrxjhmEfQAgUx964Q ($25.30 in chips) 
Seat 5: TeWJxSETzbXGiYKx0y+dtg ($35.30 in chips) 
Seat 6: 4awUyiDYTgylQKXZ9faBVA ($29.80 in chips) 
Seat 7: QBNV6v6f+1ZHoaKcQDTWog ($28.55 in chips) 
Seat 8: cZ99hugmLBj9KhTlc8nCSw ($26.40 in chips) 
Seat 9: Yv4fucyyT28mjx8V5lxKJg ($21.50 in chips) 
oXv2YWrxjhmEfQAgUx964Q: posts small blind $0.10
TeWJxSETzbXGiYKx0y+dtg: posts big blind $0.25
*** HOLE CARDS ***
4awUyiDYTgylQKXZ9faBVA: folds 
QBNV6v6f+1ZHoaKcQDTWog: folds 
cZ99hugmLBj9KhTlc8nCSw: folds 
Yv4fucyyT28mjx8V5lxKJg: folds 
1Clf3cPrqoy/YgvWdWK1Xw: folds 
1S/fpm+f42V/6MNZre+ccg: folds 
dfNim92Z6XK1/h5SFW5vDg: folds 
oXv2YWrxjhmEfQAgUx964Q: calls $0.15
TeWJxSETzbXGiYKx0y+dtg: checks 
*** FLOP *** [Kh 9h Tc]
oXv2YWrxjhmEfQAgUx964Q: checks 
TeWJxSETzbXGiYKx0y+dtg: checks 
*** TURN *** [Kh 9h Tc] [6s]
oXv2YWrxjhmEfQAgUx964Q: checks 
TeWJxSETzbXGiYKx0y+dtg: bets $0.50
oXv2YWrxjhmEfQAgUx964Q: calls $0.50
*** RIVER *** [Kh 9h Tc 6s] [3c]
oXv2YWrxjhmEfQAgUx964Q: checks 
TeWJxSETzbXGiYKx0y+dtg: bets $1
oXv2YWrxjhmEfQAgUx964Q: calls $1
*** SHOW DOWN ***
TeWJxSETzbXGiYKx0y+dtg: shows [7s 8d] (a straight, Six to Ten)
oXv2YWrxjhmEfQAgUx964Q: mucks hand 
TeWJxSETzbXGiYKx0y+dtg collected $3.35 from pot
*** SUMMARY ***
Total pot $3.50 | Rake $0.15 
Board [Kh 9h Tc 6s 3c]
Seat 1: 1Clf3cPrqoy/YgvWdWK1Xw folded before Flop (didn't bet)
Seat 2: 1S/fpm+f42V/6MNZre+ccg folded before Flop (didn't bet)
Seat 3: dfNim92Z6XK1/h5SFW5vDg (button) folded before Flop (didn't bet)
Seat 4: oXv2YWrxjhmEfQAgUx964Q (small blind) mucked
Seat 5: TeWJxSETzbXGiYKx0y+dtg (big blind) showed [7s 8d] and won ($3.35) with a straight, Six to Ten
Seat 6: 4awUyiDYTgylQKXZ9faBVA folded before Flop (didn't bet)
Seat 7: QBNV6v6f+1ZHoaKcQDTWog folded before Flop (didn't bet)
Seat 8: cZ99hugmLBj9KhTlc8nCSw folded before Flop (didn't bet)
Seat 9: Yv4fucyyT28mjx8V5lxKJg folded before Flop (didn't bet)




PokerStars Game #59939348892:  Hold'em No Limit ($0.10/$0.25) - 2009/07/01 0:37:35 ET
Table 'ouLhepGYovxB2x0QxH7cVg' 9-max Seat #6 is the button
Seat 1: ghNKXUBl/H+t83JF079ZBA ($30.70 in chips) 
Seat 2: r1Z5m4PwSI5ANp7qCE1OJw ($14.35 in chips) 
Seat 3: SkLOm0UugROBRt2EfMpOxQ ($24.25 in chips) 
Seat 4: a0Sx6GHY7ln2Ns2C97eXeA ($26.90 in chips) 
Seat 5: 18G4P1XstjNvItdGUITxgw ($25 in chips) 
Seat 6: r6hsffOo1iKmaPYKwAZmFw ($26.30 in chips) 
Seat 7: oHv2mIZJh3H0JR+WOZteZA ($19 in chips) 
Seat 8: opOCI2p6kW0tINuVaAqmcQ ($25.35 in chips) 
Seat 9: fIgGw0jPUR7labvJPaPbeg ($12.45 in chips) 
oHv2mIZJh3H0JR+WOZteZA: posts small blind $0.10
opOCI2p6kW0tINuVaAqmcQ: posts big blind $0.25
*** HOLE CARDS ***
fIgGw0jPUR7labvJPaPbeg: folds 
ghNKXUBl/H+t83JF079ZBA: folds 
r1Z5m4PwSI5ANp7qCE1OJw: folds 
SkLOm0UugROBRt2EfMpOxQ: folds 
a0Sx6GHY7ln2Ns2C97eXeA: folds 
18G4P1XstjNvItdGUITxgw: folds 
r6hsffOo1iKmaPYKwAZmFw: raises $0.75 to $1
oHv2mIZJh3H0JR+WOZteZA: calls $0.90
opOCI2p6kW0tINuVaAqmcQ: folds 
*** FLOP *** [6h 5h Jc]
oHv2mIZJh3H0JR+WOZteZA: bets $1.50
r6hsffOo1iKmaPYKwAZmFw: folds 
Uncalled bet ($1.50) returned to oHv2mIZJh3H0JR+WOZteZA
oHv2mIZJh3H0JR+WOZteZA collected $2.15 from pot
oHv2mIZJh3H0JR+WOZteZA: doesn't show hand 
*** SUMMARY ***
Total pot $2.25 | Rake $0.10 
Board [6h 5h Jc]
Seat 1: ghNKXUBl/H+t83JF079ZBA folded before Flop (didn't bet)
Seat 2: r1Z5m4PwSI5ANp7qCE1OJw folded before Flop (didn't bet)
Seat 3: SkLOm0UugROBRt2EfMpOxQ folded before Flop (didn't bet)
Seat 4: a0Sx6GHY7ln2Ns2C97eXeA folded before Flop (didn't bet)
Seat 5: 18G4P1XstjNvItdGUITxgw folded before Flop (didn't bet)
Seat 6: r6hsffOo1iKmaPYKwAZmFw (button) folded on the Flop
Seat 7: oHv2mIZJh3H0JR+WOZteZA (small blind) collected ($2.15)
Seat 8: opOCI2p6kW0tINuVaAqmcQ (big blind) folded before Flop
Seat 9: fIgGw0jPUR7labvJPaPbeg folded before Flop (didn't bet)




PokerStars Game #59939349300:  Hold'em No Limit ($0.10/$0.25) - 2009/07/01 0:37:35 ET
Table 'mF3KHGMaTpaBZbtBoyfTeg' 6-max Seat #2 is the button
Seat 1: 0HAB2GdCAM7p7V00xueAVQ ($10.30 in chips) 
Seat 2: 4x9jCqgSw4272dnaIqnanw ($3.35 in chips) 
Seat 3: Hzrn9DZJegEZICufTNYkrg ($14.85 in chips) 
Seat 4: FYepjhAvF8ZdVCmqHIy+eQ ($25.45 in chips) 
Seat 5: sEQx9G5Cu8k1HNdQasxvUA ($28.55 in chips) 
Hzrn9DZJegEZICufTNYkrg: posts small blind $0.10
FYepjhAvF8ZdVCmqHIy+eQ: posts big blind $0.25
*** HOLE CARDS ***
sEQx9G5Cu8k1HNdQasxvUA: folds 
0HAB2GdCAM7p7V00xueAVQ: calls $0.25
4x9jCqgSw4272dnaIqnanw: folds 
Hzrn9DZJegEZICufTNYkrg: folds 
FYepjhAvF8ZdVCmqHIy+eQ: checks 
*** FLOP *** [8s 4c 9c]
FYepjhAvF8ZdVCmqHIy+eQ: checks 
0HAB2GdCAM7p7V00xueAVQ: bets $0.25
FYepjhAvF8ZdVCmqHIy+eQ: calls $0.25
*** TURN *** [8s 4c 9c] [Jh]
FYepjhAvF8ZdVCmqHIy+eQ: bets $0.25
0HAB2GdCAM7p7V00xueAVQ: folds 
Uncalled bet ($0.25) returned to FYepjhAvF8ZdVCmqHIy+eQ
FYepjhAvF8ZdVCmqHIy+eQ collected $1.05 from pot
FYepjhAvF8ZdVCmqHIy+eQ: doesn't show hand 
*** SUMMARY ***
Total pot $1.10 | Rake $0.05 
Board [8s 4c 9c Jh]
Seat 1: 0HAB2GdCAM7p7V00xueAVQ folded on the Turn
Seat 2: 4x9jCqgSw4272dnaIqnanw (button) folded before Flop (didn't bet)
Seat 3: Hzrn9DZJegEZICufTNYkrg (small blind) folded before Flop
Seat 4: FYepjhAvF8ZdVCmqHIy+eQ (big blind) collected ($1.05)
Seat 5: sEQx9G5Cu8k1HNdQasxvUA folded before Flop (didn't bet)




PokerStars Game #59939349240:  Hold'em No Limit ($0.10/$0.25) - 2009/07/01 0:37:35 ET
Table '5NipxzzFB2DffzDpddyQoQ' 6-max Seat #3 is the button
Seat 2: jxrNE4qd8KCOIqHjQcwCrA ($40.80 in chips) 
Seat 3: qGHGf/553gQnDoklMRe3tg ($46.90 in chips) 
Seat 4: Inq44d7PQ+8TbEKfPeuxVQ ($7.20 in chips) 
Seat 5: cS21pIxRHx5Gt42o7hPZzw ($12.65 in chips) 
Seat 6: lYjWCpfCxX2kgcHY3v4Yow ($26.25 in chips) 
Inq44d7PQ+8TbEKfPeuxVQ: posts small blind $0.10
cS21pIxRHx5Gt42o7hPZzw: posts big blind $0.25
TslQs7AQSLbVtr4X8JOOOQ: sits out 
*** HOLE CARDS ***
lYjWCpfCxX2kgcHY3v4Yow: raises $0.60 to $0.85
jxrNE4qd8KCOIqHjQcwCrA: folds 
qGHGf/553gQnDoklMRe3tg: folds 
Inq44d7PQ+8TbEKfPeuxVQ: calls $0.75
cS21pIxRHx5Gt42o7hPZzw: folds 
*** FLOP *** [2c Jd 8h]
Inq44d7PQ+8TbEKfPeuxVQ: checks 
lYjWCpfCxX2kgcHY3v4Yow: bets $1
Inq44d7PQ+8TbEKfPeuxVQ: folds 
Uncalled bet ($1) returned to lYjWCpfCxX2kgcHY3v4Yow
lYjWCpfCxX2kgcHY3v4Yow collected $1.90 from pot
lYjWCpfCxX2kgcHY3v4Yow: doesn't show hand 
*** SUMMARY ***
Total pot $1.95 | Rake $0.05 
Board [2c Jd 8h]
Seat 2: jxrNE4qd8KCOIqHjQcwCrA folded before Flop (didn't bet)
Seat 3: qGHGf/553gQnDoklMRe3tg (button) folded before Flop (didn't bet)
Seat 4: Inq44d7PQ+8TbEKfPeuxVQ (small blind) folded on the Flop
Seat 5: cS21pIxRHx5Gt42o7hPZzw (big blind) folded before Flop
Seat 6: lYjWCpfCxX2kgcHY3v4Yow collected ($1.90)




PokerStars Game #59939349154:  Hold'em No Limit ($0.10/$0.25) - 2009/07/01 0:37:35 ET
Table 'Qr+t8WGovMECkBv+cV1lrg' 6-max Seat #1 is the button
Seat 1: wFKQltIqUcrrkvre6g+fyw ($33.40 in chips) 
Seat 2: i48129QFpEQQ+UN4aNtmww ($5.40 in chips) 
Seat 3: bjJnMpKgoF+vgHW2f1NCsg ($17.70 in chips) 
Seat 4: 3rlIjSrvbZoI2IILbnetnA ($25 in chips) 
Seat 6: j5NZbEJHsERuXjPHWqc1Nw ($21.50 in chips) 
i48129QFpEQQ+UN4aNtmww: posts small blind $0.10
bjJnMpKgoF+vgHW2f1NCsg: posts big blind $0.25
iwlxXocltgSdaBmusNXanQ: sits out 
*** HOLE CARDS ***
3rlIjSrvbZoI2IILbnetnA: calls $0.25
j5NZbEJHsERuXjPHWqc1Nw: calls $0.25
wFKQltIqUcrrkvre6g+fyw: raises $1 to $1.25
i48129QFpEQQ+UN4aNtmww: folds 
bjJnMpKgoF+vgHW2f1NCsg: folds 
3rlIjSrvbZoI2IILbnetnA: folds 
j5NZbEJHsERuXjPHWqc1Nw: folds 
Uncalled bet ($1) returned to wFKQltIqUcrrkvre6g+fyw
wFKQltIqUcrrkvre6g+fyw collected $1.10 from pot
wFKQltIqUcrrkvre6g+fyw: doesn't show hand 
*** SUMMARY ***
Total pot $1.10 | Rake $0 
Seat 1: wFKQltIqUcrrkvre6g+fyw (button) collected ($1.10)
Seat 2: i48129QFpEQQ+UN4aNtmww (small blind) folded before Flop
Seat 3: bjJnMpKgoF+vgHW2f1NCsg (big blind) folded before Flop
Seat 4: 3rlIjSrvbZoI2IILbnetnA folded before Flop
Seat 6: j5NZbEJHsERuXjPHWqc1Nw folded before Flop




PokerStars Game #59939348776:  Hold'em No Limit ($0.10/$0.25) - 2009/07/01 0:37:35 ET
Table 'QzXakDK7ZHNjgIpoUFGSKQ' 9-max Seat #8 is the button
Seat 1: vZGoOTJLQLhkPj4I+LNGig ($25 in chips) 
Seat 2: HVKi9hnDyvzObpL08/OarQ ($23.80 in chips) 
Seat 3: E4pjUoTJmJNmancGXn1nSw ($18.40 in chips) 
Seat 4: Yv4fucyyT28mjx8V5lxKJg ($24.25 in chips) 
Seat 6: c7sk/W5UhCTyhjXh5MT/eg ($11.25 in chips) 
Seat 7: zUPSsmVPAK0z0iGmEx7WbA ($10.30 in chips) 
Seat 8: HXf7T9U74NXM5C+iMg8Cbg ($4.50 in chips) 
vZGoOTJLQLhkPj4I+LNGig: posts small blind $0.10
HVKi9hnDyvzObpL08/OarQ: posts big blind $0.25
*** HOLE CARDS ***
E4pjUoTJmJNmancGXn1nSw: calls $0.25
Yv4fucyyT28mjx8V5lxKJg: folds 
c7sk/W5UhCTyhjXh5MT/eg: folds 
zUPSsmVPAK0z0iGmEx7WbA: raises $0.25 to $0.50
HXf7T9U74NXM5C+iMg8Cbg: folds 
vZGoOTJLQLhkPj4I+LNGig: folds 
HVKi9hnDyvzObpL08/OarQ: calls $0.25
E4pjUoTJmJNmancGXn1nSw: calls $0.25
*** FLOP *** [5s 8h Kd]
HVKi9hnDyvzObpL08/OarQ: checks 
E4pjUoTJmJNmancGXn1nSw: checks 
mdalglish joins the table at seat #9 
mdalglish leaves the table
zUPSsmVPAK0z0iGmEx7WbA: checks 
*** TURN *** [5s 8h Kd] [6s]
HVKi9hnDyvzObpL08/OarQ: checks 
NAP/FpFXsTsBxjDijlVzEg has returned
E4pjUoTJmJNmancGXn1nSw: checks 
zUPSsmVPAK0z0iGmEx7WbA: checks 
*** RIVER *** [5s 8h Kd 6s] [3d]
HVKi9hnDyvzObpL08/OarQ: checks 
E4pjUoTJmJNmancGXn1nSw: checks 
zUPSsmVPAK0z0iGmEx7WbA: checks 
*** SHOW DOWN ***
HVKi9hnDyvzObpL08/OarQ: shows [Ts Qs] (high card King)
E4pjUoTJmJNmancGXn1nSw: shows [4c 4h] (a pair of Fours)
zUPSsmVPAK0z0iGmEx7WbA: mucks hand 
E4pjUoTJmJNmancGXn1nSw collected $1.55 from pot
*** SUMMARY ***
Total pot $1.60 | Rake $0.05 
Board [5s 8h Kd 6s 3d]
Seat 1: vZGoOTJLQLhkPj4I+LNGig (small blind) folded before Flop
Seat 2: HVKi9hnDyvzObpL08/OarQ (big blind) showed [Ts Qs] and lost with high card King
Seat 3: E4pjUoTJmJNmancGXn1nSw showed [4c 4h] and won ($1.55) with a pair of Fours
Seat 4: Yv4fucyyT28mjx8V5lxKJg folded before Flop (didn't bet)
Seat 6: c7sk/W5UhCTyhjXh5MT/eg folded before Flop (didn't bet)
Seat 7: zUPSsmVPAK0z0iGmEx7WbA mucked
Seat 8: HXf7T9U74NXM5C+iMg8Cbg (button) folded before Flop (didn't bet)




PokerStars Game #59939349536:  Hold'em No Limit ($0.10/$0.25) - 2009/07/01 0:37:36 ET
Table 'AchTjdLS1zBUbH3ZIx6f0w' 6-max Seat #2 is the button
Seat 1: IzVI+wIP7IS+d0sugIrOPQ ($27.55 in chips) 
Seat 2: kG34n23qFQA3nzdOJTQ1dA ($40.55 in chips) 
Seat 3: ehifenV36yVvJMnV63D3cg ($4 in chips) 
Seat 4: q6WfTUAD9mowIP63ASq2Dg ($26.05 in chips) 
Seat 5: oBUDUfeUyCbZBsjxHZgSiw ($34.15 in chips) 
ehifenV36yVvJMnV63D3cg: posts small blind $0.10
q6WfTUAD9mowIP63ASq2Dg: posts big blind $0.25
5tB0F9NjPSUL4FzmzBMs2Q: sits out 
*** HOLE CARDS ***
oBUDUfeUyCbZBsjxHZgSiw: folds 
IzVI+wIP7IS+d0sugIrOPQ: raises $0.50 to $0.75
kG34n23qFQA3nzdOJTQ1dA: folds 
ehifenV36yVvJMnV63D3cg: raises $0.50 to $1.25
q6WfTUAD9mowIP63ASq2Dg: folds 
IzVI+wIP7IS+d0sugIrOPQ: calls $0.50
*** FLOP *** [2d 4c 7c]
ehifenV36yVvJMnV63D3cg: bets $2
IzVI+wIP7IS+d0sugIrOPQ: folds 
Uncalled bet ($2) returned to ehifenV36yVvJMnV63D3cg
ehifenV36yVvJMnV63D3cg collected $2.65 from pot
ehifenV36yVvJMnV63D3cg: doesn't show hand 
*** SUMMARY ***
Total pot $2.75 | Rake $0.10 
Board [2d 4c 7c]
Seat 1: IzVI+wIP7IS+d0sugIrOPQ folded on the Flop
Seat 2: kG34n23qFQA3nzdOJTQ1dA (button) folded before Flop (didn't bet)
Seat 3: ehifenV36yVvJMnV63D3cg (small blind) collected ($2.65)
Seat 4: q6WfTUAD9mowIP63ASq2Dg (big blind) folded before Flop
Seat 5: oBUDUfeUyCbZBsjxHZgSiw folded before Flop (didn't bet)




PokerStars Game #59939349618:  Hold'em No Limit ($0.10/$0.25) - 2009/07/01 0:37:36 ET
Table 'luMgmRPIo47e7iXDlheIwA' 6-max Seat #4 is the button
Seat 2: 4YSTu0Cdzpppe1lUgCZGCQ ($41.95 in chips) 
Seat 4: n2OZezRXTtdzQt4SuIy8TQ ($19.55 in chips) 
Seat 5: kG34n23qFQA3nzdOJTQ1dA ($47 in chips) 
kG34n23qFQA3nzdOJTQ1dA: posts small blind $0.10
4YSTu0Cdzpppe1lUgCZGCQ: posts big blind $0.25
*** HOLE CARDS ***
n2OZezRXTtdzQt4SuIy8TQ: raises $0.75 to $1
kG34n23qFQA3nzdOJTQ1dA: folds 
4YSTu0Cdzpppe1lUgCZGCQ: folds 
Uncalled bet ($0.75) returned to n2OZezRXTtdzQt4SuIy8TQ
n2OZezRXTtdzQt4SuIy8TQ collected $0.60 from pot
*** SUMMARY ***
Total pot $0.60 | Rake $0 
Seat 2: 4YSTu0Cdzpppe1lUgCZGCQ (big blind) folded before Flop
Seat 4: n2OZezRXTtdzQt4SuIy8TQ (button) collected ($0.60)
Seat 5: kG34n23qFQA3nzdOJTQ1dA (small blind) folded before Flop




PokerStars Game #59939349974:  Hold'em No Limit ($0.10/$0.25) - 2009/07/01 0:37:36 ET
Table 'nyTW9cVtYentc5V7xU/0jA' 6-max Seat #5 is the button
Seat 1: YfxPRDAWfqnGBhiIEdlTYg ($6.30 in chips) 
Seat 2: 7FmwVDcdEtxDpHmP4hOXsQ ($25 in chips) 
Seat 3: kG34n23qFQA3nzdOJTQ1dA ($24.90 in chips) 
Seat 4: r6u7MWSXF30/khcTYkrG9Q ($37.60 in chips) 
Seat 5: BedjMfrlRfPgSq7CXpPAmg ($25 in chips) 
Seat 6: dQJByDqHOLbgqX/HobyAJA ($6.05 in chips) 
dQJByDqHOLbgqX/HobyAJA: posts small blind $0.10
YfxPRDAWfqnGBhiIEdlTYg: posts big blind $0.25
*** HOLE CARDS ***
7FmwVDcdEtxDpHmP4hOXsQ: raises $0.50 to $0.75
kG34n23qFQA3nzdOJTQ1dA: folds 
r6u7MWSXF30/khcTYkrG9Q: folds 
BedjMfrlRfPgSq7CXpPAmg: folds 
dQJByDqHOLbgqX/HobyAJA: raises $5.30 to $6.05 and is all-in
YfxPRDAWfqnGBhiIEdlTYg: folds 
7FmwVDcdEtxDpHmP4hOXsQ: folds 
Uncalled bet ($5.30) returned to dQJByDqHOLbgqX/HobyAJA
dQJByDqHOLbgqX/HobyAJA collected $1.75 from pot
*** SUMMARY ***
Total pot $1.75 | Rake $0 
Seat 1: YfxPRDAWfqnGBhiIEdlTYg (big blind) folded before Flop
Seat 2: 7FmwVDcdEtxDpHmP4hOXsQ folded before Flop
Seat 3: kG34n23qFQA3nzdOJTQ1dA folded before Flop (didn't bet)
Seat 4: r6u7MWSXF30/khcTYkrG9Q folded before Flop (didn't bet)
Seat 5: BedjMfrlRfPgSq7CXpPAmg (button) folded before Flop (didn't bet)
Seat 6: dQJByDqHOLbgqX/HobyAJA (small blind) collected ($1.75)




PokerStars Game #59939349724:  Hold'em No Limit ($0.10/$0.25) - 2009/07/01 0:37:36 ET
Table 'Ok3oDLIsTc2+KxPcI0bAOA' 6-max Seat #4 is the button
Seat 1: agQm3ugZ3qSVYNgNu1ddeA ($27.95 in chips) 
Seat 2: oseFhpinoe+Zg4j5xyBjyQ ($29.55 in chips) 
Seat 3: I1TxPvWj8NfG8orglCinNA ($25 in chips) 
Seat 4: WMiAkibyLuLJ32VI20myug ($14.05 in chips) 
Seat 5: nc79pm0LZRdhncq55evVqA ($28 in chips) 
Seat 6: JFIAqU8lCZ0vWwEl4bdGsg ($26.85 in chips) 
nc79pm0LZRdhncq55evVqA: posts small blind $0.10
JFIAqU8lCZ0vWwEl4bdGsg: posts big blind $0.25
*** HOLE CARDS ***
agQm3ugZ3qSVYNgNu1ddeA: folds 
oseFhpinoe+Zg4j5xyBjyQ: folds 
I1TxPvWj8NfG8orglCinNA: folds 
WMiAkibyLuLJ32VI20myug: calls $0.25
nc79pm0LZRdhncq55evVqA: folds 
JFIAqU8lCZ0vWwEl4bdGsg: checks 
*** FLOP *** [3s 4d 3d]
JFIAqU8lCZ0vWwEl4bdGsg: checks 
WMiAkibyLuLJ32VI20myug: bets $0.75
JFIAqU8lCZ0vWwEl4bdGsg: calls $0.75
*** TURN *** [3s 4d 3d] [7c]
JFIAqU8lCZ0vWwEl4bdGsg: bets $1
WMiAkibyLuLJ32VI20myug: calls $1
*** RIVER *** [3s 4d 3d 7c] [Qs]
JFIAqU8lCZ0vWwEl4bdGsg: bets $7
WMiAkibyLuLJ32VI20myug: folds 
Uncalled bet ($7) returned to JFIAqU8lCZ0vWwEl4bdGsg
JFIAqU8lCZ0vWwEl4bdGsg collected $3.90 from pot
JFIAqU8lCZ0vWwEl4bdGsg: doesn't show hand 
*** SUMMARY ***
Total pot $4.10 | Rake $0.20 
Board [3s 4d 3d 7c Qs]
Seat 1: agQm3ugZ3qSVYNgNu1ddeA folded before Flop (didn't bet)
Seat 2: oseFhpinoe+Zg4j5xyBjyQ folded before Flop (didn't bet)
Seat 3: I1TxPvWj8NfG8orglCinNA folded before Flop (didn't bet)
Seat 4: WMiAkibyLuLJ32VI20myug (button) folded on the River
Seat 5: nc79pm0LZRdhncq55evVqA (small blind) folded before Flop
Seat 6: JFIAqU8lCZ0vWwEl4bdGsg (big blind) collected ($3.90)




PokerStars Game #59939349358:  Hold'em No Limit ($0.10/$0.25) - 2009/07/01 0:37:36 ET
Table 'Xi38lWH8L2JHRAsKYVX8Qg' 6-max Seat #6 is the button
Seat 1: AqQ7DFpHkgIzTwDu+rClcg ($6.05 in chips) 
Seat 2: YjCHRUY3WJtHMnkcRxvmug ($36.20 in chips) 
Seat 3: hFvl367f+GnfQv2riJlsTA ($11.65 in chips) 
Seat 4: d0J1xuhsynEY81YHwAvJ5g ($25 in chips) 
Seat 5: 9KPR3sZ+CxRm7bQ8qxFzMQ ($11.70 in chips) 
Seat 6: aogAb4Eienxztk8p2v9VVw ($23.10 in chips) 
AqQ7DFpHkgIzTwDu+rClcg: posts small blind $0.10
YjCHRUY3WJtHMnkcRxvmug: posts big blind $0.25
*** HOLE CARDS ***
hFvl367f+GnfQv2riJlsTA: folds 
d0J1xuhsynEY81YHwAvJ5g: folds 
9KPR3sZ+CxRm7bQ8qxFzMQ: folds 
aogAb4Eienxztk8p2v9VVw: folds 
AqQ7DFpHkgIzTwDu+rClcg: calls $0.15
YjCHRUY3WJtHMnkcRxvmug: checks 
*** FLOP *** [Ts 8c Td]
AqQ7DFpHkgIzTwDu+rClcg: bets $0.25
YjCHRUY3WJtHMnkcRxvmug: calls $0.25
*** TURN *** [Ts 8c Td] [Ah]
AqQ7DFpHkgIzTwDu+rClcg: checks 
YjCHRUY3WJtHMnkcRxvmug: checks 
*** RIVER *** [Ts 8c Td Ah] [6c]
AqQ7DFpHkgIzTwDu+rClcg: checks 
YjCHRUY3WJtHMnkcRxvmug: checks 
*** SHOW DOWN ***
AqQ7DFpHkgIzTwDu+rClcg: shows [9d 5d] (a pair of Tens)
YjCHRUY3WJtHMnkcRxvmug: shows [6d 2s] (two pair, Tens and Sixes)
YjCHRUY3WJtHMnkcRxvmug collected $0.95 from pot
*** SUMMARY ***
Total pot $1 | Rake $0.05 
Board [Ts 8c Td Ah 6c]
Seat 1: AqQ7DFpHkgIzTwDu+rClcg (small blind) showed [9d 5d] and lost with a pair of Tens
Seat 2: YjCHRUY3WJtHMnkcRxvmug (big blind) showed [6d 2s] and won ($0.95) with two pair, Tens and Sixes
Seat 3: hFvl367f+GnfQv2riJlsTA folded before Flop (didn't bet)
Seat 4: d0J1xuhsynEY81YHwAvJ5g folded before Flop (didn't bet)
Seat 5: 9KPR3sZ+CxRm7bQ8qxFzMQ folded before Flop (didn't bet)
Seat 6: aogAb4Eienxztk8p2v9VVw (button) folded before Flop (didn't bet)




PokerStars Game #59939349650:  Hold'em No Limit ($0.10/$0.25) - 2009/07/01 0:37:36 ET
Table 'BdTkgy6SGkgNXul6irMoOw' 9-max Seat #9 is the button
Seat 2: ljemhp25Zg+nlA9DLCIiUw ($24.55 in chips) 
Seat 3: tYsOBqdU1+x+yFI7zHO7hQ ($25.90 in chips) 
Seat 4: eygIcrabyU9hI2mw7NQsgg ($23.65 in chips) 
Seat 5: opOCI2p6kW0tINuVaAqmcQ ($25 in chips) 
Seat 6: XlP4n7rTkDteN8BWl//wvg ($38 in chips) 
Seat 9: 5dv9mRGKI/UifM58OINXVQ ($18.85 in chips) 
ljemhp25Zg+nlA9DLCIiUw: posts small blind $0.10
tYsOBqdU1+x+yFI7zHO7hQ: posts big blind $0.25
*** HOLE CARDS ***
eygIcrabyU9hI2mw7NQsgg: folds 
opOCI2p6kW0tINuVaAqmcQ: raises $0.50 to $0.75
XlP4n7rTkDteN8BWl//wvg: folds 
5dv9mRGKI/UifM58OINXVQ: calls $0.75
ljemhp25Zg+nlA9DLCIiUw: folds 
tYsOBqdU1+x+yFI7zHO7hQ: folds 
*** FLOP *** [Kd Ah Ac]
opOCI2p6kW0tINuVaAqmcQ: checks 
5dv9mRGKI/UifM58OINXVQ: checks 
*** TURN *** [Kd Ah Ac] [As]
opOCI2p6kW0tINuVaAqmcQ: checks 
5dv9mRGKI/UifM58OINXVQ: checks 
*** RIVER *** [Kd Ah Ac As] [6h]
opOCI2p6kW0tINuVaAqmcQ: checks 
5dv9mRGKI/UifM58OINXVQ: checks 
*** SHOW DOWN ***
opOCI2p6kW0tINuVaAqmcQ: shows [Jh Th] (three of a kind, Aces)
5dv9mRGKI/UifM58OINXVQ: shows [Qc 7c] (three of a kind, Aces - King+Queen kicker)
5dv9mRGKI/UifM58OINXVQ collected $1.80 from pot
*** SUMMARY ***
Total pot $1.85 | Rake $0.05 
Board [Kd Ah Ac As 6h]
Seat 2: ljemhp25Zg+nlA9DLCIiUw (small blind) folded before Flop
Seat 3: tYsOBqdU1+x+yFI7zHO7hQ (big blind) folded before Flop
Seat 4: eygIcrabyU9hI2mw7NQsgg folded before Flop (didn't bet)
Seat 5: opOCI2p6kW0tINuVaAqmcQ showed [Jh Th] and lost with three of a kind, Aces
Seat 6: XlP4n7rTkDteN8BWl//wvg folded before Flop (didn't bet)
Seat 9: 5dv9mRGKI/UifM58OINXVQ (button) showed [Qc 7c] and won ($1.80) with three of a kind, Aces




PokerStars Game #59939349454:  Hold'em No Limit ($0.10/$0.25) - 2009/07/01 0:37:36 ET
Table 'GgmUtmhrYPRnhkqEEjD/Kw' 9-max Seat #4 is the button
Seat 1: HapyJHxV6lc3eqoT7yWL2A ($2.40 in chips) 
Seat 2: ghNKXUBl/H+t83JF079ZBA ($25 in chips) 
Seat 3: DZek9vrzBExLUFtbWml/Eg ($10.70 in chips) 
Seat 4: uwmAXQRjyA4iX5kaC15P9A ($6.15 in chips) 
Seat 5: lwrOE80tuooHfIBx/4LUSw ($30.85 in chips) 
Seat 6: 4Ax0vobe1rLVIGZmkFINGA ($14.65 in chips) 
Seat 7: YwDw9cMqkbMznFK77rru4A ($8.90 in chips) 
Seat 8: mKwW7JjB4GQW2YtoYgqIgw ($12.45 in chips) 
lwrOE80tuooHfIBx/4LUSw: posts small blind $0.10
4Ax0vobe1rLVIGZmkFINGA: posts big blind $0.25
*** HOLE CARDS ***
YwDw9cMqkbMznFK77rru4A: folds 
mKwW7JjB4GQW2YtoYgqIgw: folds 
HapyJHxV6lc3eqoT7yWL2A: folds 
ghNKXUBl/H+t83JF079ZBA: folds 
DZek9vrzBExLUFtbWml/Eg: raises $10.45 to $10.70 and is all-in
uwmAXQRjyA4iX5kaC15P9A: folds 
lwrOE80tuooHfIBx/4LUSw: folds 
4Ax0vobe1rLVIGZmkFINGA: folds 
Uncalled bet ($10.45) returned to DZek9vrzBExLUFtbWml/Eg
DZek9vrzBExLUFtbWml/Eg collected $0.60 from pot
DZek9vrzBExLUFtbWml/Eg: doesn't show hand 
*** SUMMARY ***
Total pot $0.60 | Rake $0 
Seat 1: HapyJHxV6lc3eqoT7yWL2A folded before Flop (didn't bet)
Seat 2: ghNKXUBl/H+t83JF079ZBA folded before Flop (didn't bet)
Seat 3: DZek9vrzBExLUFtbWml/Eg collected ($0.60)
Seat 4: uwmAXQRjyA4iX5kaC15P9A (button) folded before Flop (didn't bet)
Seat 5: lwrOE80tuooHfIBx/4LUSw (small blind) folded before Flop
Seat 6: 4Ax0vobe1rLVIGZmkFINGA (big blind) folded before Flop
Seat 7: YwDw9cMqkbMznFK77rru4A folded before Flop (didn't bet)
Seat 8: mKwW7JjB4GQW2YtoYgqIgw folded before Flop (didn't bet)




PokerStars Game #59939350290:  Hold'em No Limit ($0.10/$0.25) - 2009/07/01 0:37:37 ET
Table 'h02LhQ7B/Zk4ETRxxHhGYA' 9-max Seat #7 is the button
Seat 2: RJ/x9oZtt1RZLaJEQwZOxQ ($28.30 in chips) 
Seat 3: JxpnpCmvRAcrEUy7mq1iAg ($5 in chips) 
Seat 4: tYsOBqdU1+x+yFI7zHO7hQ ($38.55 in chips) 
Seat 5: cUxk0Jk4lrUQv9CJl0LPlg ($16.95 in chips) 
Seat 6: kN/irnQSdb8jibbN4f1O+Q ($16.20 in chips) 
Seat 7: rUpvA02nErFvZ4yFbDR8XA ($19.45 in chips) 
Seat 8: 7tW694tRVJnYdoa16Dw4RQ ($25.55 in chips) 
Seat 9: 1c/7DHPx5CDTmAfk8/bWeA ($14.65 in chips) 
7tW694tRVJnYdoa16Dw4RQ: posts small blind $0.10
1c/7DHPx5CDTmAfk8/bWeA: posts big blind $0.25
sD+TKtt36XiiN6jqHiLwDA: sits out 
*** HOLE CARDS ***
RJ/x9oZtt1RZLaJEQwZOxQ: folds 
JxpnpCmvRAcrEUy7mq1iAg: folds 
tYsOBqdU1+x+yFI7zHO7hQ: folds 
cUxk0Jk4lrUQv9CJl0LPlg: folds 
kN/irnQSdb8jibbN4f1O+Q: raises $0.50 to $0.75
rUpvA02nErFvZ4yFbDR8XA: folds 
7tW694tRVJnYdoa16Dw4RQ: folds 
1c/7DHPx5CDTmAfk8/bWeA: folds 
Uncalled bet ($0.50) returned to kN/irnQSdb8jibbN4f1O+Q
kN/irnQSdb8jibbN4f1O+Q collected $0.60 from pot
*** SUMMARY ***
Total pot $0.60 | Rake $0 
Seat 2: RJ/x9oZtt1RZLaJEQwZOxQ folded before Flop (didn't bet)
Seat 3: JxpnpCmvRAcrEUy7mq1iAg folded before Flop (didn't bet)
Seat 4: tYsOBqdU1+x+yFI7zHO7hQ folded before Flop (didn't bet)
Seat 5: cUxk0Jk4lrUQv9CJl0LPlg folded before Flop (didn't bet)
Seat 6: kN/irnQSdb8jibbN4f1O+Q collected ($0.60)
Seat 7: rUpvA02nErFvZ4yFbDR8XA (button) folded before Flop (didn't bet)
Seat 8: 7tW694tRVJnYdoa16Dw4RQ (small blind) folded before Flop
Seat 9: 1c/7DHPx5CDTmAfk8/bWeA (big blind) folded before Flop




PokerStars Game #59939350438:  Hold'em No Limit ($0.10/$0.25) - 2009/07/01 0:37:37 ET
Table 'dZNBGqFYSwfOVZvDJ4VjIQ' 6-max Seat #3 is the button
Seat 1: r0DiH4bZf5vkenb8ncDb3w ($12.25 in chips) 
Seat 2: NPueG39V6nKvDRuvBJ4U7g ($18.10 in chips) 
Seat 3: Qd4gQJ1hjQcU9/uDqd6Nlw ($11.75 in chips) 
Seat 4: W5I5z3jwvPiCAfmQzAaAFA ($4.10 in chips) 
Seat 5: hZJzYj+7+PvGu6ae1g//sQ ($6.75 in chips) 
Seat 6: yJgjVkWgiJ8vdWZjcUod2A ($10.35 in chips) 
W5I5z3jwvPiCAfmQzAaAFA: posts small blind $0.10
hZJzYj+7+PvGu6ae1g//sQ: posts big blind $0.25
NPueG39V6nKvDRuvBJ4U7g: posts big blind $0.25
*** HOLE CARDS ***
yJgjVkWgiJ8vdWZjcUod2A: folds 
r0DiH4bZf5vkenb8ncDb3w: folds 
yJgjVkWgiJ8vdWZjcUod2A leaves the table
NPueG39V6nKvDRuvBJ4U7g: checks 
Qd4gQJ1hjQcU9/uDqd6Nlw: calls $0.25
W5I5z3jwvPiCAfmQzAaAFA: raises $0.75 to $1
hZJzYj+7+PvGu6ae1g//sQ: calls $0.75
NPueG39V6nKvDRuvBJ4U7g: calls $0.75
Qd4gQJ1hjQcU9/uDqd6Nlw: folds 
*** FLOP *** [9h Ts 2h]
W5I5z3jwvPiCAfmQzAaAFA: bets $3.10 and is all-in
hZJzYj+7+PvGu6ae1g//sQ: calls $3.10
NPueG39V6nKvDRuvBJ4U7g: folds 
*** TURN *** [9h Ts 2h] [Kc]
*** RIVER *** [9h Ts 2h Kc] [4h]
*** SHOW DOWN ***
W5I5z3jwvPiCAfmQzAaAFA: shows [Qs Qd] (a pair of Queens)
hZJzYj+7+PvGu6ae1g//sQ: shows [Kh 9s] (two pair, Kings and Nines)
hZJzYj+7+PvGu6ae1g//sQ collected $9 from pot
*** SUMMARY ***
Total pot $9.45 | Rake $0.45 
Board [9h Ts 2h Kc 4h]
Seat 1: r0DiH4bZf5vkenb8ncDb3w folded before Flop (didn't bet)
Seat 2: NPueG39V6nKvDRuvBJ4U7g folded on the Flop
Seat 3: Qd4gQJ1hjQcU9/uDqd6Nlw (button) folded before Flop
Seat 4: W5I5z3jwvPiCAfmQzAaAFA (small blind) showed [Qs Qd] and lost with a pair of Queens
Seat 5: hZJzYj+7+PvGu6ae1g//sQ (big blind) showed [Kh 9s] and won ($9) with two pair, Kings and Nines
Seat 6: yJgjVkWgiJ8vdWZjcUod2A folded before Flop (didn't bet)




PokerStars Game #59939350308:  Hold'em No Limit ($0.10/$0.25) - 2009/07/01 0:37:37 ET
Table 'gkdjhbH1jaE3hwhPRIKMiQ' 6-max Seat #4 is the button
Seat 2: 1NNFfYMd5Hsphl/FYz9fNA ($32.85 in chips) 
Seat 3: uUXdcVMNa05rfbntdvplfw ($8.25 in chips) 
Seat 4: 7uqewvdd5+KjmM7wl58k+w ($16.05 in chips) 
Seat 5: Ew/TYPQIsbQ2X8nm5iAJBg ($27.35 in chips) 
Seat 6: wqphQtauX5Qn7WRJZS1flA ($26 in chips) 
Ew/TYPQIsbQ2X8nm5iAJBg: posts small blind $0.10
wqphQtauX5Qn7WRJZS1flA: posts big blind $0.25
nc79pm0LZRdhncq55evVqA: sits out 
*** HOLE CARDS ***
1NNFfYMd5Hsphl/FYz9fNA: folds 
uUXdcVMNa05rfbntdvplfw: raises $1 to $1.25
7uqewvdd5+KjmM7wl58k+w: folds 
Ew/TYPQIsbQ2X8nm5iAJBg: folds 
wqphQtauX5Qn7WRJZS1flA: folds 
Uncalled bet ($1) returned to uUXdcVMNa05rfbntdvplfw
uUXdcVMNa05rfbntdvplfw collected $0.60 from pot
uUXdcVMNa05rfbntdvplfw: shows [As 9c] (high card Ace)
*** SUMMARY ***
Total pot $0.60 | Rake $0 
Seat 2: 1NNFfYMd5Hsphl/FYz9fNA folded before Flop (didn't bet)
Seat 3: uUXdcVMNa05rfbntdvplfw collected ($0.60)
Seat 4: 7uqewvdd5+KjmM7wl58k+w (button) folded before Flop (didn't bet)
Seat 5: Ew/TYPQIsbQ2X8nm5iAJBg (small blind) folded before Flop
Seat 6: wqphQtauX5Qn7WRJZS1flA (big blind) folded before Flop




PokerStars Game #59939350158:  Hold'em No Limit ($0.10/$0.25) - 2009/07/01 0:37:37 ET
Table 'tErGGDyESv/0llKumVeZuQ' 9-max Seat #7 is the button
Seat 2: fnmp9YBEeLxBFinW2Sx+pg ($9.60 in chips) 
Seat 4: j1oAjkBBlFRUy+e+LF1vNQ ($4 in chips) 
Seat 5: le+pqvOEeS8Vvxt8ogLv/w ($12 in chips) 
Seat 6: zDrucyjVn5aeekNEc3cJrA ($29.50 in chips) 
Seat 7: s7Q6uNouhe7aE8JdFb9E+A ($25.65 in chips) 
Seat 8: Sv38qYH3jj8a8dddDi1aUA ($14.75 in chips) 
Seat 9: r284m4NA4rtNktI86R8/Yw ($15.80 in chips) 
Sv38qYH3jj8a8dddDi1aUA: posts small blind $0.10
r284m4NA4rtNktI86R8/Yw: posts big blind $0.25
R3KkgiqTvuhazyCqaD9cZg: sits out 
*** HOLE CARDS ***
fnmp9YBEeLxBFinW2Sx+pg: folds 
j1oAjkBBlFRUy+e+LF1vNQ: calls $0.25
le+pqvOEeS8Vvxt8ogLv/w is disconnected 
le+pqvOEeS8Vvxt8ogLv/w has timed out while disconnected
le+pqvOEeS8Vvxt8ogLv/w: folds 
le+pqvOEeS8Vvxt8ogLv/w is sitting out
zDrucyjVn5aeekNEc3cJrA: calls $0.25
s7Q6uNouhe7aE8JdFb9E+A: folds 
Sv38qYH3jj8a8dddDi1aUA: calls $0.15
r284m4NA4rtNktI86R8/Yw: checks 
*** FLOP *** [8d 3d Td]
Sv38qYH3jj8a8dddDi1aUA: checks 
r284m4NA4rtNktI86R8/Yw: checks 
j1oAjkBBlFRUy+e+LF1vNQ: bets $0.25
zDrucyjVn5aeekNEc3cJrA: folds 
Sv38qYH3jj8a8dddDi1aUA: folds 
r284m4NA4rtNktI86R8/Yw: folds 
Uncalled bet ($0.25) returned to j1oAjkBBlFRUy+e+LF1vNQ
le+pqvOEeS8Vvxt8ogLv/w is connected 
j1oAjkBBlFRUy+e+LF1vNQ collected $0.95 from pot
j1oAjkBBlFRUy+e+LF1vNQ: doesn't show hand 
*** SUMMARY ***
Total pot $1 | Rake $0.05 
Board [8d 3d Td]
Seat 2: fnmp9YBEeLxBFinW2Sx+pg folded before Flop (didn't bet)
Seat 4: j1oAjkBBlFRUy+e+LF1vNQ collected ($0.95)
Seat 5: le+pqvOEeS8Vvxt8ogLv/w folded before Flop (didn't bet)
Seat 6: zDrucyjVn5aeekNEc3cJrA folded on the Flop
Seat 7: s7Q6uNouhe7aE8JdFb9E+A (button) folded before Flop (didn't bet)
Seat 8: Sv38qYH3jj8a8dddDi1aUA (small blind) folded on the Flop
Seat 9: r284m4NA4rtNktI86R8/Yw (big blind) folded on the Flop




PokerStars Game #59939350796:  Hold'em No Limit ($0.10/$0.25) - 2009/07/01 0:37:38 ET
Table 'sIHZ0lzLr4NGCaBUKhmYhAr562aMIMs5kgo28FEU6lkAax Seat #2 is the button
Seat 1: vZGoOTJLQLhkPj4I+LNGig ($25 in chips) 
Seat 2: 1iFGmD6SKW+FaWr752n3kA ($11.35 in chips) 
Seat 3: vX2B+8jhZFyBctQ3P4IKEw ($8.65 in chips) 
Seat 4: XBq1lBzax7LjRqdJP2TqWg ($12.95 in chips) 
Seat 5: zDrucyjVn5aeekNEc3cJrA ($36.80 in chips) 
Seat 7: R6nIVAjK7uhK3Hj0f85A+A ($18.70 in chips) 
Seat 9: W4TLQcZ2TiM73eIgpIvlGg ($26.10 in chips) 
vX2B+8jhZFyBctQ3P4IKEw: posts small blind $0.10
XBq1lBzax7LjRqdJP2TqWg: posts big blind $0.25
rCaXm4/EwAgWqCiClpbsqQ: sits out 
*** HOLE CARDS ***
zDrucyjVn5aeekNEc3cJrA: folds 
R6nIVAjK7uhK3Hj0f85A+A: folds 
W4TLQcZ2TiM73eIgpIvlGg: folds 
vZGoOTJLQLhkPj4I+LNGig: folds 
1iFGmD6SKW+FaWr752n3kA: folds 
1iFGmD6SKW+FaWr752n3kA leaves the table
vX2B+8jhZFyBctQ3P4IKEw: calls $0.15
XBq1lBzax7LjRqdJP2TqWg: checks 
*** FLOP *** [Kc 4h 8c]
vX2B+8jhZFyBctQ3P4IKEw: checks 
XBq1lBzax7LjRqdJP2TqWg: checks 
*** TURN *** [Kc 4h 8c] [Qd]
vX2B+8jhZFyBctQ3P4IKEw: checks 
XBq1lBzax7LjRqdJP2TqWg: bets $0.25
vX2B+8jhZFyBctQ3P4IKEw: folds 
Uncalled bet ($0.25) returned to XBq1lBzax7LjRqdJP2TqWg
XBq1lBzax7LjRqdJP2TqWg collected $0.50 from pot
N8muFAHrFHW6elSMGuyVLQ joins the table at seat #2 
XBq1lBzax7LjRqdJP2TqWg: shows [Ad Kd] (a pair of Kings)
*** SUMMARY ***
Total pot $0.50 | Rake $0 
Board [Kc 4h 8c Qd]
Seat 1: vZGoOTJLQLhkPj4I+LNGig folded before Flop (didn't bet)
Seat 2: 1iFGmD6SKW+FaWr752n3kA (button) folded before Flop (didn't bet)
Seat 3: vX2B+8jhZFyBctQ3P4IKEw (small blind) folded on the Turn
Seat 4: XBq1lBzax7LjRqdJP2TqWg (big blind) collected ($0.50)
Seat 5: zDrucyjVn5aeekNEc3cJrA folded before Flop (didn't bet)
Seat 7: R6nIVAjK7uhK3Hj0f85A+A folded before Flop (didn't bet)
Seat 9: W4TLQcZ2TiM73eIgpIvlGg folded before Flop (didn't bet)




PokerStars Game #59939350838:  Hold'em No Limit ($0.10/$0.25) - 2009/07/01 0:37:38 ET
Table '3Ns9nuTkynfwbBfBXzg6ww' 6-max Seat #5 is the button
Seat 3: 6PDO6dptGq0XLL8zHWIhgw ($49.20 in chips) 
Seat 4: kyRaCIljYA6l33lSKQfNsg ($31.75 in chips) 
Seat 5: kBQU/db00TVAMeomlhblPg ($15 in chips) 
Seat 6: L0urJVMuBFQrIOdoz+7XLw ($32.85 in chips) 
L0urJVMuBFQrIOdoz+7XLw: posts small blind $0.10
RYLaAIIwK9wxkPswt1yJYw: is sitting out 
6PDO6dptGq0XLL8zHWIhgw: posts big blind $0.25
*** HOLE CARDS ***
kyRaCIljYA6l33lSKQfNsg: folds 
RYLaAIIwK9wxkPswt1yJYw leaves the table
kBQU/db00TVAMeomlhblPg: folds 
L0urJVMuBFQrIOdoz+7XLw: folds 
Uncalled bet ($0.15) returned to 6PDO6dptGq0XLL8zHWIhgw
6PDO6dptGq0XLL8zHWIhgw collected $0.20 from pot
*** SUMMARY ***
Total pot $0.20 | Rake $0 
Seat 3: 6PDO6dptGq0XLL8zHWIhgw (big blind) collected ($0.20)
Seat 4: kyRaCIljYA6l33lSKQfNsg folded before Flop (didn't bet)
Seat 5: kBQU/db00TVAMeomlhblPg (button) folded before Flop (didn't bet)
Seat 6: L0urJVMuBFQrIOdoz+7XLw (small blind) folded before Flop




PokerStars Game #59939351904:  Hold'em No Limit ($0.10/$0.25) - 2009/07/01 0:37:39 ET
Table 'GrYi0DZOHD1EvB+qiLExNw' 9-max Seat #1 is the button
Seat 1: 4awUyiDYTgylQKXZ9faBVA ($44.40 in chips) 
Seat 2: Th3FldXKQW6hWVVPahaoOQ ($26.40 in chips) 
Seat 3: 4oA316mXLIui1QY63GXBUg ($25 in chips) 
Seat 5: cZ99hugmLBj9KhTlc8nCSw ($48.85 in chips) 
Seat 6: H9KUl8cmpLgEpOVDA00bCg ($4.55 in chips) 
Seat 7: 1Clf3cPrqoy/YgvWdWK1Xw ($5.25 in chips) 
Seat 8: nalbG/4/1Z1wQjRDWV7b2w ($4.20 in chips) 
Seat 9: st9jtdNbm1W5GfBwRaCVqQ ($24.75 in chips) 
Th3FldXKQW6hWVVPahaoOQ: posts small blind $0.10
4oA316mXLIui1QY63GXBUg: posts big blind $0.25
*** HOLE CARDS ***
cZ99hugmLBj9KhTlc8nCSw: folds 
H9KUl8cmpLgEpOVDA00bCg: folds 
1Clf3cPrqoy/YgvWdWK1Xw: folds 
nalbG/4/1Z1wQjRDWV7b2w: raises $3.95 to $4.20 and is all-in
st9jtdNbm1W5GfBwRaCVqQ: folds 
4awUyiDYTgylQKXZ9faBVA: folds 
Th3FldXKQW6hWVVPahaoOQ: folds 
4oA316mXLIui1QY63GXBUg: folds 
Uncalled bet ($3.95) returned to nalbG/4/1Z1wQjRDWV7b2w
nalbG/4/1Z1wQjRDWV7b2w collected $0.60 from pot
nalbG/4/1Z1wQjRDWV7b2w: doesn't show hand 
*** SUMMARY ***
Total pot $0.60 | Rake $0 
Seat 1: 4awUyiDYTgylQKXZ9faBVA (button) folded before Flop (didn't bet)
Seat 2: Th3FldXKQW6hWVVPahaoOQ (small blind) folded before Flop
Seat 3: 4oA316mXLIui1QY63GXBUg (big blind) folded before Flop
Seat 5: cZ99hugmLBj9KhTlc8nCSw folded before Flop (didn't bet)
Seat 6: H9KUl8cmpLgEpOVDA00bCg folded before Flop (didn't bet)
Seat 7: 1Clf3cPrqoy/YgvWdWK1Xw folded before Flop (didn't bet)
Seat 8: nalbG/4/1Z1wQjRDWV7b2w collected ($0.60)
Seat 9: st9jtdNbm1W5GfBwRaCVqQ folded before Flop (didn't bet)




PokerStars Game #59939351290:  Hold'em No Limit ($0.10/$0.25) - 2009/07/01 0:37:39 ET
Table '3EebBlzq5yHSY2444L4zlg' 9-max Seat #6 is the button
Seat 1: 8B/dhbQjIWe6ASCdgzktNQ ($33.45 in chips) 
Seat 2: MIVCHqCqqlke0Lb0z7glcw ($25.60 in chips) 
Seat 3: IGbD5vKNhHe60dkdbjg/mw ($29.10 in chips) 
Seat 4: 1S/fpm+f42V/6MNZre+ccg ($25.45 in chips) 
Seat 5: 22Ph+hChb2fjC5+yk/mOew ($15 in chips) 
Seat 6: QEbIGci+itdw+re8RM5fZA ($27.55 in chips) 
Seat 7: DiSvPC2iudwL5j9u6Huyww ($29 in chips) 
Seat 8: Qi+clOtyDiibLdH2/1Qy8g ($28.20 in chips) 
Seat 9: GTcLfsDTPqgfHyhY9FNDMw ($10.20 in chips) 
DiSvPC2iudwL5j9u6Huyww: posts small blind $0.10
Qi+clOtyDiibLdH2/1Qy8g: posts big blind $0.25
22Ph+hChb2fjC5+yk/mOew: posts big blind $0.25
*** HOLE CARDS ***
GTcLfsDTPqgfHyhY9FNDMw: folds 
8B/dhbQjIWe6ASCdgzktNQ: folds 
MIVCHqCqqlke0Lb0z7glcw: folds 
IGbD5vKNhHe60dkdbjg/mw: folds 
1S/fpm+f42V/6MNZre+ccg: folds 
22Ph+hChb2fjC5+yk/mOew: checks 
QEbIGci+itdw+re8RM5fZA: raises $0.75 to $1
DiSvPC2iudwL5j9u6Huyww: folds 
Qi+clOtyDiibLdH2/1Qy8g: folds 
22Ph+hChb2fjC5+yk/mOew: folds 
Uncalled bet ($0.75) returned to QEbIGci+itdw+re8RM5fZA
QEbIGci+itdw+re8RM5fZA collected $0.85 from pot
QEbIGci+itdw+re8RM5fZA: doesn't show hand 
*** SUMMARY ***
Total pot $0.85 | Rake $0 
Seat 1: 8B/dhbQjIWe6ASCdgzktNQ folded before Flop (didn't bet)
Seat 2: MIVCHqCqqlke0Lb0z7glcw folded before Flop (didn't bet)
Seat 3: IGbD5vKNhHe60dkdbjg/mw folded before Flop (didn't bet)
Seat 4: 1S/fpm+f42V/6MNZre+ccg folded before Flop (didn't bet)
Seat 5: 22Ph+hChb2fjC5+yk/mOew folded before Flop
Seat 6: QEbIGci+itdw+re8RM5fZA (button) collected ($0.85)
Seat 7: DiSvPC2iudwL5j9u6Huyww (small blind) folded before Flop
Seat 8: Qi+clOtyDiibLdH2/1Qy8g (big blind) folded before Flop
Seat 9: GTcLfsDTPqgfHyhY9FNDMw folded before Flop (didn't bet)




PokerStars Game #59939351790:  Hold'em No Limit ($0.10/$0.25) - 2009/07/01 0:37:39 ET
Table '6ae4XiTo6B597KfSSMr8Cg' 9-max Seat #1 is the button
Seat 1: 49YfVBEOwzD3/FVw+dTTBQ ($6.40 in chips) 
Seat 2: 5s3p6yoJBNW438dsyKTP8g ($45.35 in chips) 
Seat 3: yyG4svzOpC1A+sUP/scg6w ($7.50 in chips) 
Seat 4: dfNim92Z6XK1/h5SFW5vDg ($49.10 in chips) 
Seat 5: 1K6QGyJP9P9xmRac2fH4OQ ($25 in chips) 
Seat 7: 18G4P1XstjNvItdGUITxgw ($25.25 in chips) 
Seat 9: E0iYnEVO2ho7dH3QcCjw7g ($34.70 in chips) 
5s3p6yoJBNW438dsyKTP8g: posts small blind $0.10
yyG4svzOpC1A+sUP/scg6w: posts big blind $0.25
DlXs37dlX3tb7o/7lYXQSw: sits out 
*** HOLE CARDS ***
lacross84 joins the table at seat #8 
dfNim92Z6XK1/h5SFW5vDg: folds 
1K6QGyJP9P9xmRac2fH4OQ: folds 
18G4P1XstjNvItdGUITxgw: folds 
E0iYnEVO2ho7dH3QcCjw7g: folds 
49YfVBEOwzD3/FVw+dTTBQ: calls $0.25
5s3p6yoJBNW438dsyKTP8g: folds 
yyG4svzOpC1A+sUP/scg6w: checks 
*** FLOP *** [9h Kc 3h]
yyG4svzOpC1A+sUP/scg6w: checks 
49YfVBEOwzD3/FVw+dTTBQ: checks 
*** TURN *** [9h Kc 3h] [2s]
yyG4svzOpC1A+sUP/scg6w: checks 
49YfVBEOwzD3/FVw+dTTBQ: checks 
*** RIVER *** [9h Kc 3h 2s] [Kh]
yyG4svzOpC1A+sUP/scg6w: checks 
49YfVBEOwzD3/FVw+dTTBQ: bets $0.50
yyG4svzOpC1A+sUP/scg6w: calls $0.50
*** SHOW DOWN ***
49YfVBEOwzD3/FVw+dTTBQ: shows [Qc 8c] (a pair of Kings)
yyG4svzOpC1A+sUP/scg6w: shows [3d 7s] (two pair, Kings and Threes)
yyG4svzOpC1A+sUP/scg6w collected $1.55 from pot
*** SUMMARY ***
Total pot $1.60 | Rake $0.05 
Board [9h Kc 3h 2s Kh]
Seat 1: 49YfVBEOwzD3/FVw+dTTBQ (button) showed [Qc 8c] and lost with a pair of Kings
Seat 2: 5s3p6yoJBNW438dsyKTP8g (small blind) folded before Flop
Seat 3: yyG4svzOpC1A+sUP/scg6w (big blind) showed [3d 7s] and won ($1.55) with two pair, Kings and Threes
Seat 4: dfNim92Z6XK1/h5SFW5vDg folded before Flop (didn't bet)
Seat 5: 1K6QGyJP9P9xmRac2fH4OQ folded before Flop (didn't bet)
Seat 7: 18G4P1XstjNvItdGUITxgw folded before Flop (didn't bet)
Seat 9: E0iYnEVO2ho7dH3QcCjw7g folded before Flop (didn't bet)




PokerStars Game #59939351454:  Hold'em No Limit ($0.10/$0.25) - 2009/07/01 0:37:39 ET
Table 'oxYpQNT8OHNCvpMIFi7UoA' 9-max Seat #1 is the button
Seat 1: H5Se03ZqSX7tbULXur2MAg ($18.80 in chips) 
Seat 2: Ofo77cVa49gHqAMfHrrMbw ($12.70 in chips) 
Seat 4: ghNKXUBl/H+t83JF079ZBA ($25 in chips) 
Seat 5: SXqVW4Q0evTUVZG6BbUNIA ($34.15 in chips) 
Seat 6: +2kMBNpY4nF1qNCRd8SJLA ($25 in chips) 
Seat 8: OlPJsgR4xypSg/w1z7Gyvw ($19.10 in chips) 
Seat 9: KK7jFoJo1TzDCPdsfpPjtw ($23.50 in chips) 
Ofo77cVa49gHqAMfHrrMbw: posts small blind $0.10
OfGfQFPcghysTDljS9GQSQ: is sitting out 
ghNKXUBl/H+t83JF079ZBA: posts big blind $0.25
OfGfQFPcghysTDljS9GQSQ leaves the table
yyG4svzOpC1A+sUP/scg6w: sits out 
*** HOLE CARDS ***
SXqVW4Q0evTUVZG6BbUNIA: folds 
+2kMBNpY4nF1qNCRd8SJLA: folds 
OlPJsgR4xypSg/w1z7Gyvw: folds 
KK7jFoJo1TzDCPdsfpPjtw: raises $0.75 to $1
H5Se03ZqSX7tbULXur2MAg: calls $1
Ofo77cVa49gHqAMfHrrMbw: folds 
ghNKXUBl/H+t83JF079ZBA: folds 
*** FLOP *** [7d 7s Ts]
Belzer74 joins the table at seat #3 
KK7jFoJo1TzDCPdsfpPjtw: bets $1.50
H5Se03ZqSX7tbULXur2MAg: calls $1.50
*** TURN *** [7d 7s Ts] [9s]
KK7jFoJo1TzDCPdsfpPjtw: bets $1.50
H5Se03ZqSX7tbULXur2MAg: calls $1.50
*** RIVER *** [7d 7s Ts 9s] [Ah]
KK7jFoJo1TzDCPdsfpPjtw: bets $5.50
H5Se03ZqSX7tbULXur2MAg: raises $9.30 to $14.80 and is all-in
KK7jFoJo1TzDCPdsfpPjtw: calls $9.30
*** SHOW DOWN ***
H5Se03ZqSX7tbULXur2MAg: shows [Js As] (a flush, Ace high)
KK7jFoJo1TzDCPdsfpPjtw: shows [9d 9h] (a full house, Nines full of Sevens)
KK7jFoJo1TzDCPdsfpPjtw collected $36.10 from pot
*** SUMMARY ***
Total pot $37.95 | Rake $1.85 
Board [7d 7s Ts 9s Ah]
Seat 1: H5Se03ZqSX7tbULXur2MAg (button) showed [Js As] and lost with a flush, Ace high
Seat 2: Ofo77cVa49gHqAMfHrrMbw (small blind) folded before Flop
Seat 4: ghNKXUBl/H+t83JF079ZBA (big blind) folded before Flop
Seat 5: SXqVW4Q0evTUVZG6BbUNIA folded before Flop (didn't bet)
Seat 6: +2kMBNpY4nF1qNCRd8SJLA folded before Flop (didn't bet)
Seat 8: OlPJsgR4xypSg/w1z7Gyvw folded before Flop (didn't bet)
Seat 9: KK7jFoJo1TzDCPdsfpPjtw showed [9d 9h] and won ($36.10) with a full house, Nines full of Sevens




PokerStars Game #59939351828:  Hold'em No Limit ($0.10/$0.25) - 2009/07/01 0:37:39 ET
Table 'Pz8SfAzhP5nvWTsJRAxoDg' 6-max Seat #5 is the button
Seat 1: buyjetgNT1McXtdaP4zynA ($41.65 in chips) 
Seat 2: RYLaAIIwK9wxkPswt1yJYw ($23.65 in chips) 
Seat 3: mfrkWA3PTeYPkbO6hi98Aw ($30.85 in chips) 
Seat 5: FYepjhAvF8ZdVCmqHIy+eQ ($30.30 in chips) 
Seat 6: FStoHe64SQWqAsjya9pDkQ ($25 in chips) 
FStoHe64SQWqAsjya9pDkQ: posts small blind $0.10
buyjetgNT1McXtdaP4zynA: posts big blind $0.25
*** HOLE CARDS ***
RYLaAIIwK9wxkPswt1yJYw: calls $0.25
mfrkWA3PTeYPkbO6hi98Aw: folds 
FYepjhAvF8ZdVCmqHIy+eQ: folds 
FStoHe64SQWqAsjya9pDkQ: raises $1 to $1.25
buyjetgNT1McXtdaP4zynA: folds 
RYLaAIIwK9wxkPswt1yJYw: folds 
Uncalled bet ($1) returned to FStoHe64SQWqAsjya9pDkQ
FStoHe64SQWqAsjya9pDkQ collected $0.75 from pot
FStoHe64SQWqAsjya9pDkQ: doesn't show hand 
*** SUMMARY ***
Total pot $0.75 | Rake $0 
Seat 1: buyjetgNT1McXtdaP4zynA (big blind) folded before Flop
Seat 2: RYLaAIIwK9wxkPswt1yJYw folded before Flop
Seat 3: mfrkWA3PTeYPkbO6hi98Aw folded before Flop (didn't bet)
Seat 5: FYepjhAvF8ZdVCmqHIy+eQ (button) folded before Flop (didn't bet)
Seat 6: FStoHe64SQWqAsjya9pDkQ (small blind) collected ($0.75)




PokerStars Game #59939351836:  Hold'em No Limit ($0.10/$0.25) - 2009/07/01 0:37:39 ET
Table 'Loy/olZ5qoDOSvX4UTujGg' 6-max Seat #3 is the button
Seat 1: yzFNNFIfC89bBPwpFPx2ow ($28.85 in chips) 
Seat 2: MkNgTuvyxpHXkeIm5JITHQ ($12.15 in chips) 
Seat 3: 32YL2ZEp8NT4JB2RVM9euQ ($15.65 in chips) 
Seat 4: /gJNBeCkWL4o85/jvlZ4BA ($27.20 in chips) 
Seat 5: 4YSTu0Cdzpppe1lUgCZGCQ ($35.50 in chips) 
Seat 6: 7FmwVDcdEtxDpHmP4hOXsQ ($53.05 in chips) 
/gJNBeCkWL4o85/jvlZ4BA: posts small blind $0.10
4YSTu0Cdzpppe1lUgCZGCQ: posts big blind $0.25
*** HOLE CARDS ***
7FmwVDcdEtxDpHmP4hOXsQ: folds 
yzFNNFIfC89bBPwpFPx2ow: folds 
MkNgTuvyxpHXkeIm5JITHQ: raises $0.50 to $0.75
32YL2ZEp8NT4JB2RVM9euQ: folds 
/gJNBeCkWL4o85/jvlZ4BA: folds 
4YSTu0Cdzpppe1lUgCZGCQ: folds 
Uncalled bet ($0.50) returned to MkNgTuvyxpHXkeIm5JITHQ
MkNgTuvyxpHXkeIm5JITHQ collected $0.60 from pot
MkNgTuvyxpHXkeIm5JITHQ: doesn't show hand 
*** SUMMARY ***
Total pot $0.60 | Rake $0 
Seat 1: yzFNNFIfC89bBPwpFPx2ow folded before Flop (didn't bet)
Seat 2: MkNgTuvyxpHXkeIm5JITHQ collected ($0.60)
Seat 3: 32YL2ZEp8NT4JB2RVM9euQ (button) folded before Flop (didn't bet)
Seat 4: /gJNBeCkWL4o85/jvlZ4BA (small blind) folded before Flop
Seat 5: 4YSTu0Cdzpppe1lUgCZGCQ (big blind) folded before Flop
Seat 6: 7FmwVDcdEtxDpHmP4hOXsQ folded before Flop (didn't bet)




PokerStars Game #59939351230:  Hold'em No Limit ($0.10/$0.25) - 2009/07/01 0:37:39 ET
Table 'a0kk1yz54EMczhut3KjrxQ' 6-max Seat #1 is the button
Seat 1: V3LJvbHVJHmOj2fd7zIDhA ($29.50 in chips) 
Seat 2: nc79pm0LZRdhncq55evVqA ($25 in chips) 
Seat 3: FabaCGPqGJLjRL48CMvjiQ ($20.30 in chips) 
Seat 4: FYepjhAvF8ZdVCmqHIy+eQ ($27.05 in chips) 
Seat 5: cPO/1/dTcZpLkQFm3jH3Rg ($25 in chips) 
Seat 6: DTzxFTXVrCqrpjq9B9Vg/g ($14.75 in chips) 
nc79pm0LZRdhncq55evVqA: posts small blind $0.10
FabaCGPqGJLjRL48CMvjiQ: posts big blind $0.25
*** HOLE CARDS ***
FYepjhAvF8ZdVCmqHIy+eQ: folds 
cPO/1/dTcZpLkQFm3jH3Rg: folds 
DTzxFTXVrCqrpjq9B9Vg/g: folds 
V3LJvbHVJHmOj2fd7zIDhA: calls $0.25
nc79pm0LZRdhncq55evVqA: raises $1 to $1.25
FabaCGPqGJLjRL48CMvjiQ: calls $1
V3LJvbHVJHmOj2fd7zIDhA: folds 
*** FLOP *** [4s 8c 5c]
nc79pm0LZRdhncq55evVqA: bets $2
FabaCGPqGJLjRL48CMvjiQ: raises $2 to $4
nc79pm0LZRdhncq55evVqA: folds 
Uncalled bet ($2) returned to FabaCGPqGJLjRL48CMvjiQ
FabaCGPqGJLjRL48CMvjiQ collected $6.45 from pot
*** SUMMARY ***
Total pot $6.75 | Rake $0.30 
Board [4s 8c 5c]
Seat 1: V3LJvbHVJHmOj2fd7zIDhA (button) folded before Flop
Seat 2: nc79pm0LZRdhncq55evVqA (small blind) folded on the Flop
Seat 3: FabaCGPqGJLjRL48CMvjiQ (big blind) collected ($6.45)
Seat 4: FYepjhAvF8ZdVCmqHIy+eQ folded before Flop (didn't bet)
Seat 5: cPO/1/dTcZpLkQFm3jH3Rg folded before Flop (didn't bet)
Seat 6: DTzxFTXVrCqrpjq9B9Vg/g folded before Flop (didn't bet)




PokerStars Game #59939352212:  Hold'em No Limit ($0.10/$0.25) - 2009/07/01 0:37:40 ET
Table '63h13e5p7cWe02rClZ1CHw' 6-max Seat #2 is the button
Seat 1: 7VfhiFY533nbUKvyEthASw ($10 in chips) 
Seat 2: k9nHZTHt8hYhYRcW8NTb4g ($14.65 in chips) 
Seat 3: 9jSiy0meE9XJKkdIZwyTEQ ($34 in chips) 
Seat 4: myagrRAhs0mdgmh5GNqvCw ($6.45 in chips) 
Seat 5: bE34il0XYGjWPD5/vbkMaQ ($12.25 in chips) 
Seat 6: mfrkWA3PTeYPkbO6hi98Aw ($35.10 in chips) 
9jSiy0meE9XJKkdIZwyTEQ: posts small blind $0.10
myagrRAhs0mdgmh5GNqvCw: posts big blind $0.25
*** HOLE CARDS ***
bE34il0XYGjWPD5/vbkMaQ has timed out
bE34il0XYGjWPD5/vbkMaQ: folds 
bE34il0XYGjWPD5/vbkMaQ is sitting out
bE34il0XYGjWPD5/vbkMaQ has returned
mfrkWA3PTeYPkbO6hi98Aw: folds 
7VfhiFY533nbUKvyEthASw: folds 
k9nHZTHt8hYhYRcW8NTb4g: folds 
9jSiy0meE9XJKkdIZwyTEQ: raises $0.60 to $0.85
myagrRAhs0mdgmh5GNqvCw: folds 
Uncalled bet ($0.60) returned to 9jSiy0meE9XJKkdIZwyTEQ
9jSiy0meE9XJKkdIZwyTEQ collected $0.50 from pot
9jSiy0meE9XJKkdIZwyTEQ: doesn't show hand 
*** SUMMARY ***
Total pot $0.50 | Rake $0 
Seat 1: 7VfhiFY533nbUKvyEthASw folded before Flop (didn't bet)
Seat 2: k9nHZTHt8hYhYRcW8NTb4g (button) folded before Flop (didn't bet)
Seat 3: 9jSiy0meE9XJKkdIZwyTEQ (small blind) collected ($0.50)
Seat 4: myagrRAhs0mdgmh5GNqvCw (big blind) folded before Flop
Seat 5: bE34il0XYGjWPD5/vbkMaQ folded before Flop (didn't bet)
Seat 6: mfrkWA3PTeYPkbO6hi98Aw folded before Flop (didn't bet)




PokerStars Game #59939352218:  Hold'em No Limit ($0.10/$0.25) - 2009/07/01 0:37:40 ET
Table '8QBBaev+cI2i/r2H6ml/lg' 9-max Seat #5 is the button
Seat 2: tYsOBqdU1+x+yFI7zHO7hQ ($25 in chips) 
Seat 4: ZoG0obuajzVjwgd7lNHjgg ($5 in chips) 
Seat 5: j4q3p0lesp63b1gZDwLBZw ($5 in chips) 
Seat 6: E0iYnEVO2ho7dH3QcCjw7g ($28.60 in chips) 
Seat 9: Ml2bY77EHbM51ZWD7dnIWg ($2.30 in chips) 
E0iYnEVO2ho7dH3QcCjw7g: posts small blind $0.10
JxpnpCmvRAcrEUy7mq1iAg: is sitting out 
Ml2bY77EHbM51ZWD7dnIWg: posts big blind $0.25
*** HOLE CARDS ***
tYsOBqdU1+x+yFI7zHO7hQ: folds 
JxpnpCmvRAcrEUy7mq1iAg leaves the table
ZoG0obuajzVjwgd7lNHjgg: raises $0.50 to $0.75
j4q3p0lesp63b1gZDwLBZw: folds 
E0iYnEVO2ho7dH3QcCjw7g: folds 
Ml2bY77EHbM51ZWD7dnIWg: folds 
Uncalled bet ($0.50) returned to ZoG0obuajzVjwgd7lNHjgg
ZoG0obuajzVjwgd7lNHjgg collected $0.60 from pot
*** SUMMARY ***
Total pot $0.60 | Rake $0 
Seat 2: tYsOBqdU1+x+yFI7zHO7hQ folded before Flop (didn't bet)
Seat 4: ZoG0obuajzVjwgd7lNHjgg collected ($0.60)
Seat 5: j4q3p0lesp63b1gZDwLBZw (button) folded before Flop (didn't bet)
Seat 6: E0iYnEVO2ho7dH3QcCjw7g (small blind) folded before Flop
Seat 9: Ml2bY77EHbM51ZWD7dnIWg (big blind) folded before Flop




PokerStars Game #59939352450:  Hold'em No Limit ($0.10/$0.25) - 2009/07/01 0:37:40 ET
Table '6wawJ+MkkvuC3coG6r+Yhg' 6-max Seat #4 is the button
Seat 1: ELW+DKizJhLK7k40PMkD2Q ($23.15 in chips) 
Seat 3: KYBwVA7jgmSrbIEbEGElVg ($18.35 in chips) 
Seat 4: cS21pIxRHx5Gt42o7hPZzw ($12.40 in chips) 
ELW+DKizJhLK7k40PMkD2Q: posts small blind $0.10
KYBwVA7jgmSrbIEbEGElVg: posts big blind $0.25
*** HOLE CARDS ***
cS21pIxRHx5Gt42o7hPZzw: raises $0.75 to $1
ELW+DKizJhLK7k40PMkD2Q: calls $0.90
A8uIskXJTblhVXWuYr+lkw joins the table at seat #5 
KYBwVA7jgmSrbIEbEGElVg: calls $0.75
*** FLOP *** [9s Ac 9d]
LtASJ9OlkqGrrUKGQlpGAw has returned
ELW+DKizJhLK7k40PMkD2Q: checks 
KYBwVA7jgmSrbIEbEGElVg: bets $1
cS21pIxRHx5Gt42o7hPZzw: folds 
ELW+DKizJhLK7k40PMkD2Q: folds 
Uncalled bet ($1) returned to KYBwVA7jgmSrbIEbEGElVg
KYBwVA7jgmSrbIEbEGElVg collected $2.85 from pot
*** SUMMARY ***
Total pot $3 | Rake $0.15 
Board [9s Ac 9d]
Seat 1: ELW+DKizJhLK7k40PMkD2Q (small blind) folded on the Flop
Seat 3: KYBwVA7jgmSrbIEbEGElVg (big blind) collected ($2.85)
Seat 4: cS21pIxRHx5Gt42o7hPZzw (button) folded on the Flop




PokerStars Game #59939352358:  Hold'em No Limit ($0.10/$0.25) - 2009/07/01 0:37:40 ET
Table 'l8hUTjBTXBorNUR/tyvSLw' 9-max Seat #7 is the button
Seat 1: q9qPRjJC40e/Q9yuT+glwQ ($28.10 in chips) 
Seat 2: ZeR3hkj1gVv9J4yPCmRrjA ($50.85 in chips) 
Seat 3: 6TWO15+WfJ5HfI8CbJ4a0w ($8.50 in chips) 
Seat 4: vPtFvcPtn/Afz0sucO1cmQ ($32.35 in chips) 
Seat 5: S7Ki0P+0AIGPuIfGJjW0gg ($13.60 in chips) 
Seat 6: nkD1GtC3+ft+4U3Od0H10A ($18.95 in chips) 
Seat 7: awxYB5n5W4JUl1V4Xsn26g ($4.65 in chips) 
Seat 8: kZJjw0YSgO2CZKraCg0v8g ($12.75 in chips) 
Seat 9: zDrucyjVn5aeekNEc3cJrA ($36.10 in chips) 
kZJjw0YSgO2CZKraCg0v8g: posts small blind $0.10
zDrucyjVn5aeekNEc3cJrA: posts big blind $0.25
*** HOLE CARDS ***
q9qPRjJC40e/Q9yuT+glwQ: folds 
ZeR3hkj1gVv9J4yPCmRrjA: folds 
6TWO15+WfJ5HfI8CbJ4a0w: folds 
vPtFvcPtn/Afz0sucO1cmQ: calls $0.25
S7Ki0P+0AIGPuIfGJjW0gg: folds 
nkD1GtC3+ft+4U3Od0H10A: raises $0.75 to $1
awxYB5n5W4JUl1V4Xsn26g: folds 
kZJjw0YSgO2CZKraCg0v8g: folds 
awxYB5n5W4JUl1V4Xsn26g said, "lame *** cards"
zDrucyjVn5aeekNEc3cJrA: folds 
vPtFvcPtn/Afz0sucO1cmQ: calls $0.75
*** FLOP *** [3s Jc Qd]
vPtFvcPtn/Afz0sucO1cmQ: bets $0.50
nkD1GtC3+ft+4U3Od0H10A: calls $0.50
*** TURN *** [3s Jc Qd] [8c]
vPtFvcPtn/Afz0sucO1cmQ: bets $0.50
nkD1GtC3+ft+4U3Od0H10A: calls $0.50
*** RIVER *** [3s Jc Qd 8c] [Qc]
vPtFvcPtn/Afz0sucO1cmQ: bets $1
nkD1GtC3+ft+4U3Od0H10A: raises $1.75 to $2.75
vPtFvcPtn/Afz0sucO1cmQ: calls $1.75
*** SHOW DOWN ***
nkD1GtC3+ft+4U3Od0H10A: shows [Ts Qh] (three of a kind, Queens)
vPtFvcPtn/Afz0sucO1cmQ: shows [Qs Ks] (three of a kind, Queens - King kicker)
vPtFvcPtn/Afz0sucO1cmQ collected $9.40 from pot
*** SUMMARY ***
Total pot $9.85 | Rake $0.45 
Board [3s Jc Qd 8c Qc]
Seat 1: q9qPRjJC40e/Q9yuT+glwQ folded before Flop (didn't bet)
Seat 2: ZeR3hkj1gVv9J4yPCmRrjA folded before Flop (didn't bet)
Seat 3: 6TWO15+WfJ5HfI8CbJ4a0w folded before Flop (didn't bet)
Seat 4: vPtFvcPtn/Afz0sucO1cmQ showed [Qs Ks] and won ($9.40) with three of a kind, Queens
Seat 5: S7Ki0P+0AIGPuIfGJjW0gg folded before Flop (didn't bet)
Seat 6: nkD1GtC3+ft+4U3Od0H10A showed [Ts Qh] and lost with three of a kind, Queens
Seat 7: awxYB5n5W4JUl1V4Xsn26g (button) folded before Flop (didn't bet)
Seat 8: kZJjw0YSgO2CZKraCg0v8g (small blind) folded before Flop
Seat 9: zDrucyjVn5aeekNEc3cJrA (big blind) folded before Flop




PokerStars Game #59939352374:  Hold'em No Limit ($0.10/$0.25) - 2009/07/01 0:37:40 ET
Table '7/qMNloI0nSXWiX5Y1watA' 9-max Seat #7 is the button
Seat 1: lF4l0ujUfJ9uYJOg9Ch9/g ($45.70 in chips) 
Seat 2: 8B/dhbQjIWe6ASCdgzktNQ ($25.75 in chips) 
Seat 3: nEg1b6MIksd/4x5eLY735g ($40.10 in chips) 
Seat 4: 18G4P1XstjNvItdGUITxgw ($25 in chips) 
Seat 5: dfNim92Z6XK1/h5SFW5vDg ($32.85 in chips) 
Seat 6: /rRB5qE14E0X2mwkBd4RUA ($14.45 in chips) 
Seat 7: z5GxcHlYz/GSz6W2uFiTtg ($11.45 in chips) 
Seat 8: ljemhp25Zg+nlA9DLCIiUw ($24.25 in chips) 
ljemhp25Zg+nlA9DLCIiUw: posts small blind $0.10
jmac4333: is sitting out 
lF4l0ujUfJ9uYJOg9Ch9/g: posts big blind $0.25
*** HOLE CARDS ***
jmac4333 leaves the table
8B/dhbQjIWe6ASCdgzktNQ: folds 
nEg1b6MIksd/4x5eLY735g: folds 
aPRz/2GxbXANYpVsQO8pdQ joins the table at seat #9 
18G4P1XstjNvItdGUITxgw: folds 
dfNim92Z6XK1/h5SFW5vDg: folds 
/rRB5qE14E0X2mwkBd4RUA: calls $0.25
z5GxcHlYz/GSz6W2uFiTtg: calls $0.25
ljemhp25Zg+nlA9DLCIiUw: folds 
lF4l0ujUfJ9uYJOg9Ch9/g: checks 
*** FLOP *** [5s 9s 7s]
lF4l0ujUfJ9uYJOg9Ch9/g: checks 
/rRB5qE14E0X2mwkBd4RUA: checks 
z5GxcHlYz/GSz6W2uFiTtg: checks 
*** TURN *** [5s 9s 7s] [4h]
lF4l0ujUfJ9uYJOg9Ch9/g: checks 
/rRB5qE14E0X2mwkBd4RUA: bets $0.25
z5GxcHlYz/GSz6W2uFiTtg: folds 
lF4l0ujUfJ9uYJOg9Ch9/g: calls $0.25
*** RIVER *** [5s 9s 7s 4h] [3h]
lF4l0ujUfJ9uYJOg9Ch9/g: checks 
/rRB5qE14E0X2mwkBd4RUA: bets $0.75
lF4l0ujUfJ9uYJOg9Ch9/g: folds 
Uncalled bet ($0.75) returned to /rRB5qE14E0X2mwkBd4RUA
/rRB5qE14E0X2mwkBd4RUA collected $1.30 from pot
*** SUMMARY ***
Total pot $1.35 | Rake $0.05 
Board [5s 9s 7s 4h 3h]
Seat 1: lF4l0ujUfJ9uYJOg9Ch9/g (big blind) folded on the River
Seat 2: 8B/dhbQjIWe6ASCdgzktNQ folded before Flop (didn't bet)
Seat 3: nEg1b6MIksd/4x5eLY735g folded before Flop (didn't bet)
Seat 4: 18G4P1XstjNvItdGUITxgw folded before Flop (didn't bet)
Seat 5: dfNim92Z6XK1/h5SFW5vDg folded before Flop (didn't bet)
Seat 6: /rRB5qE14E0X2mwkBd4RUA collected ($1.30)
Seat 7: z5GxcHlYz/GSz6W2uFiTtg (button) folded on the Turn
Seat 8: ljemhp25Zg+nlA9DLCIiUw (small blind) folded before Flop




PokerStars Game #59939352376:  Hold'em No Limit ($0.10/$0.25) - 2009/07/01 0:37:40 ET
Table 'eOXPe2c6mG7DOFKvMsZZfA' 6-max Seat #2 is the button
Seat 2: ELW+DKizJhLK7k40PMkD2Q ($32.75 in chips) 
Seat 3: kReyZ6g6Fu3tQ0nyjDf9kA ($13.85 in chips) 
Seat 5: NhUN/JpAprdJeamFBgJH1w ($25 in chips) 
Seat 6: wKFJ513ucluNNiMlkXcDOQ ($41.90 in chips) 
kReyZ6g6Fu3tQ0nyjDf9kA: posts small blind $0.10
NhUN/JpAprdJeamFBgJH1w: posts big blind $0.25
*** HOLE CARDS ***
wKFJ513ucluNNiMlkXcDOQ: folds 
ELW+DKizJhLK7k40PMkD2Q: folds 
kReyZ6g6Fu3tQ0nyjDf9kA: calls $0.15
NhUN/JpAprdJeamFBgJH1w: checks 
*** FLOP *** [4s 5d 4c]
kReyZ6g6Fu3tQ0nyjDf9kA: checks 
ShXPHWfjhfmAwLgDdm6bRQ has returned
NhUN/JpAprdJeamFBgJH1w: bets $0.50
kReyZ6g6Fu3tQ0nyjDf9kA: calls $0.50
*** TURN *** [4s 5d 4c] [Jh]
zHHLkD2sRljslKKeQv/ZQw has returned
kReyZ6g6Fu3tQ0nyjDf9kA: bets $0.75
NhUN/JpAprdJeamFBgJH1w: folds 
Uncalled bet ($0.75) returned to kReyZ6g6Fu3tQ0nyjDf9kA
kReyZ6g6Fu3tQ0nyjDf9kA collected $1.45 from pot
kReyZ6g6Fu3tQ0nyjDf9kA: doesn't show hand 
*** SUMMARY ***
Total pot $1.50 | Rake $0.05 
Board [4s 5d 4c Jh]
Seat 2: ELW+DKizJhLK7k40PMkD2Q (button) folded before Flop (didn't bet)
Seat 3: kReyZ6g6Fu3tQ0nyjDf9kA (small blind) collected ($1.45)
Seat 5: NhUN/JpAprdJeamFBgJH1w (big blind) folded on the Turn
Seat 6: wKFJ513ucluNNiMlkXcDOQ folded before Flop (didn't bet)




PokerStars Game #59939353140:  Hold'em No Limit ($0.10/$0.25) - 2009/07/01 0:37:41 ET
Table '3760QYRYyCWeXf0rLZ5S2g' 9-max Seat #6 is the button
Seat 1: COsrwJSFHQtxlUcrYtDQPQ ($25.35 in chips) 
Seat 2: zDrucyjVn5aeekNEc3cJrA ($21.20 in chips) 
Seat 3: aLYacoAY3e5d/M5ToF8Ujw ($20.70 in chips) 
Seat 5: MG90wfSJZnOejs/KD3vlQQ ($27.10 in chips) 
Seat 6: DnDcAdn9P0zGovMERigpFA ($47.05 in chips) 
Seat 7: FRGMo8unilbMjBi6pw9++A ($33.70 in chips) 
Seat 8: nl78vdCYaG2sN+td5Z33sA ($8 in chips) 
Seat 9: aNpwfA31EREwO+ar4XzBCw ($25 in chips) 
FRGMo8unilbMjBi6pw9++A: posts small blind $0.10
nl78vdCYaG2sN+td5Z33sA: posts big blind $0.25
*** HOLE CARDS ***
aNpwfA31EREwO+ar4XzBCw: folds 
COsrwJSFHQtxlUcrYtDQPQ: folds 
zDrucyjVn5aeekNEc3cJrA: folds 
aLYacoAY3e5d/M5ToF8Ujw: folds 
MG90wfSJZnOejs/KD3vlQQ: raises $0.50 to $0.75
DnDcAdn9P0zGovMERigpFA: folds 
FRGMo8unilbMjBi6pw9++A: folds 
nl78vdCYaG2sN+td5Z33sA: folds 
Uncalled bet ($0.50) returned to MG90wfSJZnOejs/KD3vlQQ
FRGMo8unilbMjBi6pw9++A leaves the table
MG90wfSJZnOejs/KD3vlQQ collected $0.60 from pot
MG90wfSJZnOejs/KD3vlQQ: doesn't show hand 
*** SUMMARY ***
Total pot $0.60 | Rake $0 
Seat 1: COsrwJSFHQtxlUcrYtDQPQ folded before Flop (didn't bet)
Seat 2: zDrucyjVn5aeekNEc3cJrA folded before Flop (didn't bet)
Seat 3: aLYacoAY3e5d/M5ToF8Ujw folded before Flop (didn't bet)
Seat 5: MG90wfSJZnOejs/KD3vlQQ collected ($0.60)
Seat 6: DnDcAdn9P0zGovMERigpFA (button) folded before Flop (didn't bet)
Seat 7: FRGMo8unilbMjBi6pw9++A (small blind) folded before Flop
Seat 8: nl78vdCYaG2sN+td5Z33sA (big blind) folded before Flop
Seat 9: aNpwfA31EREwO+ar4XzBCw folded before Flop (didn't bet)




PokerStars Game #59939352978:  Hold'em No Limit ($0.10/$0.25) - 2009/07/01 0:37:41 ET
Table 'AJGgX1ZYM8d68SWMvaLttg' 6-max Seat #6 is the button
Seat 2: zHHLkD2sRljslKKeQv/ZQw ($32.75 in chips) 
Seat 3: 4x9jCqgSw4272dnaIqnanw ($4.60 in chips) 
Seat 4: Lz/GjRDgmgepqTR7qmS86w ($18.70 in chips) 
Seat 5: SFmT9ZsVopnukjvAzrxTRg ($28.95 in chips) 
Seat 6: UA5OsKS3VPaxa7uC8La/kA ($31.25 in chips) 
zHHLkD2sRljslKKeQv/ZQw: posts small blind $0.10
4x9jCqgSw4272dnaIqnanw: posts big blind $0.25
*** HOLE CARDS ***
Lz/GjRDgmgepqTR7qmS86w: folds 
SFmT9ZsVopnukjvAzrxTRg: folds 
UA5OsKS3VPaxa7uC8La/kA: folds 
zHHLkD2sRljslKKeQv/ZQw: folds 
Uncalled bet ($0.15) returned to 4x9jCqgSw4272dnaIqnanw
4x9jCqgSw4272dnaIqnanw collected $0.20 from pot
*** SUMMARY ***
Total pot $0.20 | Rake $0 
Seat 2: zHHLkD2sRljslKKeQv/ZQw (small blind) folded before Flop
Seat 3: 4x9jCqgSw4272dnaIqnanw (big blind) collected ($0.20)
Seat 4: Lz/GjRDgmgepqTR7qmS86w folded before Flop (didn't bet)
Seat 5: SFmT9ZsVopnukjvAzrxTRg folded before Flop (didn't bet)
Seat 6: UA5OsKS3VPaxa7uC8La/kA (button) folded before Flop (didn't bet)




PokerStars Game #59939352692:  Hold'em No Limit ($0.10/$0.25) - 2009/07/01 0:37:41 ET
Table 'ohAuixfiLOYDylNUG5mNUw' 9-max Seat #7 is the button
Seat 1: AtRN1hdV8HbL3X4XogDaLA ($33 in chips) 
Seat 3: HVKi9hnDyvzObpL08/OarQ ($26.60 in chips) 
Seat 4: jeKWRUkMaVn8rEUjnJKqpg ($25 in chips) 
Seat 5: Z5ZtGOON8kmSdSCll9Z3XA ($16.60 in chips) 
Seat 7: WdsZPRB5ooUPinQdaX0QrA ($4.35 in chips) 
Seat 8: ppMlNkhYgErlt4fuJO7ADA ($13.45 in chips) 
Seat 9: hIss79a4pu7GzJZepfgOpg ($26 in chips) 
ppMlNkhYgErlt4fuJO7ADA: posts small blind $0.10
hIss79a4pu7GzJZepfgOpg: posts big blind $0.25
opOCI2p6kW0tINuVaAqmcQ: sits out 
*** HOLE CARDS ***
AtRN1hdV8HbL3X4XogDaLA: folds 
HVKi9hnDyvzObpL08/OarQ: folds 
jeKWRUkMaVn8rEUjnJKqpg: folds 
Z5ZtGOON8kmSdSCll9Z3XA: folds 
WdsZPRB5ooUPinQdaX0QrA: calls $0.25
ppMlNkhYgErlt4fuJO7ADA: calls $0.15
hIss79a4pu7GzJZepfgOpg: checks 
*** FLOP *** [6c Js 8d]
ppMlNkhYgErlt4fuJO7ADA: checks 
hIss79a4pu7GzJZepfgOpg: checks 
WdsZPRB5ooUPinQdaX0QrA: checks 
*** TURN *** [6c Js 8d] [2c]
ppMlNkhYgErlt4fuJO7ADA: checks 
hIss79a4pu7GzJZepfgOpg: checks 
WdsZPRB5ooUPinQdaX0QrA: checks 
*** RIVER *** [6c Js 8d 2c] [6s]
ppMlNkhYgErlt4fuJO7ADA: checks 
hIss79a4pu7GzJZepfgOpg: checks 
WdsZPRB5ooUPinQdaX0QrA: checks 
*** SHOW DOWN ***
ppMlNkhYgErlt4fuJO7ADA: shows [Qs 9s] (a pair of Sixes)
hIss79a4pu7GzJZepfgOpg: mucks hand 
WdsZPRB5ooUPinQdaX0QrA: shows [Ad 7h] (a pair of Sixes - Ace kicker)
WdsZPRB5ooUPinQdaX0QrA collected $0.75 from pot
*** SUMMARY ***
Total pot $0.75 | Rake $0 
Board [6c Js 8d 2c 6s]
Seat 1: AtRN1hdV8HbL3X4XogDaLA folded before Flop (didn't bet)
Seat 3: HVKi9hnDyvzObpL08/OarQ folded before Flop (didn't bet)
Seat 4: jeKWRUkMaVn8rEUjnJKqpg folded before Flop (didn't bet)
Seat 5: Z5ZtGOON8kmSdSCll9Z3XA folded before Flop (didn't bet)
Seat 7: WdsZPRB5ooUPinQdaX0QrA (button) showed [Ad 7h] and won ($0.75) with a pair of Sixes
Seat 8: ppMlNkhYgErlt4fuJO7ADA (small blind) showed [Qs 9s] and lost with a pair of Sixes
Seat 9: hIss79a4pu7GzJZepfgOpg (big blind) mucked




PokerStars Game #59939352794:  Hold'em No Limit ($0.10/$0.25) - 2009/07/01 0:37:41 ET
Table 'ShgkxBDL5IvR1qjzfRNc0A' 6-max Seat #3 is the button
Seat 1: /gJNBeCkWL4o85/jvlZ4BA ($25 in chips) 
Seat 2: mfrkWA3PTeYPkbO6hi98Aw ($38.85 in chips) 
Seat 3: JXSfL0FgBM1dIFwHP09Hnw ($25 in chips) 
Seat 4: kG34n23qFQA3nzdOJTQ1dA ($24.85 in chips) 
Seat 5: ferjiUxLWPNUKxvl8/xD/g ($42.90 in chips) 
Seat 6: 5tB0F9NjPSUL4FzmzBMs2Q ($30.55 in chips) 
kG34n23qFQA3nzdOJTQ1dA: posts small blind $0.10
ferjiUxLWPNUKxvl8/xD/g: posts big blind $0.25
*** HOLE CARDS ***
5tB0F9NjPSUL4FzmzBMs2Q: folds 
/gJNBeCkWL4o85/jvlZ4BA: folds 
mfrkWA3PTeYPkbO6hi98Aw: folds 
JXSfL0FgBM1dIFwHP09Hnw: folds 
kG34n23qFQA3nzdOJTQ1dA: folds 
Uncalled bet ($0.15) returned to ferjiUxLWPNUKxvl8/xD/g
ferjiUxLWPNUKxvl8/xD/g collected $0.20 from pot
ferjiUxLWPNUKxvl8/xD/g: doesn't show hand 
*** SUMMARY ***
Total pot $0.20 | Rake $0 
Seat 1: /gJNBeCkWL4o85/jvlZ4BA folded before Flop (didn't bet)
Seat 2: mfrkWA3PTeYPkbO6hi98Aw folded before Flop (didn't bet)
Seat 3: JXSfL0FgBM1dIFwHP09Hnw (button) folded before Flop (didn't bet)
Seat 4: kG34n23qFQA3nzdOJTQ1dA (small blind) folded before Flop
Seat 5: ferjiUxLWPNUKxvl8/xD/g (big blind) collected ($0.20)
Seat 6: 5tB0F9NjPSUL4FzmzBMs2Q folded before Flop (didn't bet)




PokerStars Game #59939353324:  Hold'em No Limit ($0.10/$0.25) - 2009/07/01 0:37:42 ET
Table 'edvgY2YQ1I34euq4EVqGnA' 6-max Seat #4 is the button
Seat 1: mvFHK3pE7tCxJEqLjKC70Q ($26.65 in chips) 
Seat 2: 0vuFCuW1P8y6cFZZvuXNPg ($12.10 in chips) 
Seat 3: HjESR5/RHWT5gaSbIVQQ0Q ($21.10 in chips) 
Seat 4: JFIAqU8lCZ0vWwEl4bdGsg ($26.80 in chips) 
Seat 5: EE16Ua5b1HSsYej5zeXOlA ($25.10 in chips) 
Seat 6: kG34n23qFQA3nzdOJTQ1dA ($68.95 in chips) 
EE16Ua5b1HSsYej5zeXOlA: posts small blind $0.10
kG34n23qFQA3nzdOJTQ1dA: posts big blind $0.25
*** HOLE CARDS ***
mvFHK3pE7tCxJEqLjKC70Q: folds 
0vuFCuW1P8y6cFZZvuXNPg: raises $0.50 to $0.75
HjESR5/RHWT5gaSbIVQQ0Q: folds 
JFIAqU8lCZ0vWwEl4bdGsg: folds 
EE16Ua5b1HSsYej5zeXOlA: folds 
kG34n23qFQA3nzdOJTQ1dA: folds 
Uncalled bet ($0.50) returned to 0vuFCuW1P8y6cFZZvuXNPg
0vuFCuW1P8y6cFZZvuXNPg collected $0.60 from pot
*** SUMMARY ***
Total pot $0.60 | Rake $0 
Seat 1: mvFHK3pE7tCxJEqLjKC70Q folded before Flop (didn't bet)
Seat 2: 0vuFCuW1P8y6cFZZvuXNPg collected ($0.60)
Seat 3: HjESR5/RHWT5gaSbIVQQ0Q folded before Flop (didn't bet)
Seat 4: JFIAqU8lCZ0vWwEl4bdGsg (button) folded before Flop (didn't bet)
Seat 5: EE16Ua5b1HSsYej5zeXOlA (small blind) folded before Flop
Seat 6: kG34n23qFQA3nzdOJTQ1dA (big blind) folded before Flop




PokerStars Game #59939353680:  Hold'em No Limit ($0.10/$0.25) - 2009/07/01 0:37:42 ET
Table '4ZbiE0ZYjzqmgu6+sO1prg' 9-max Seat #6 is the button
Seat 1: N6fYvIzQLKaydFLKQGtMlQ ($25.90 in chips) 
Seat 2: w31DkWCTQDVIzsHIrFRDxA ($14.65 in chips) 
Seat 3: HPEB+AtKw1+C/cxU0o1ciw ($23.80 in chips) 
Seat 4: Eb2mDXvZ4iY02krYdOYwMA ($27.40 in chips) 
Seat 5: COsrwJSFHQtxlUcrYtDQPQ ($32.70 in chips) 
Seat 6: rXm4QDVJt67H20lM6n6Z7Q ($7.90 in chips) 
Seat 7: 3RCAkueG3Vc13VpRStCB+w ($21.15 in chips) 
Seat 8: cZ99hugmLBj9KhTlc8nCSw ($29.20 in chips) 
Seat 9: 1K6QGyJP9P9xmRac2fH4OQ ($38.10 in chips) 
3RCAkueG3Vc13VpRStCB+w: posts small blind $0.10
cZ99hugmLBj9KhTlc8nCSw: posts big blind $0.25
*** HOLE CARDS ***
1K6QGyJP9P9xmRac2fH4OQ: raises $0.75 to $1
N6fYvIzQLKaydFLKQGtMlQ: folds 
w31DkWCTQDVIzsHIrFRDxA: calls $1
HPEB+AtKw1+C/cxU0o1ciw: folds 
Eb2mDXvZ4iY02krYdOYwMA: calls $1
COsrwJSFHQtxlUcrYtDQPQ: calls $1
rXm4QDVJt67H20lM6n6Z7Q: folds 
3RCAkueG3Vc13VpRStCB+w: folds 
cZ99hugmLBj9KhTlc8nCSw: calls $0.75
*** FLOP *** [Ah 6h Jh]
cZ99hugmLBj9KhTlc8nCSw: checks 
1K6QGyJP9P9xmRac2fH4OQ: bets $4.10
w31DkWCTQDVIzsHIrFRDxA: folds 
Eb2mDXvZ4iY02krYdOYwMA: folds 
COsrwJSFHQtxlUcrYtDQPQ: calls $4.10
cZ99hugmLBj9KhTlc8nCSw: raises $7.40 to $11.50
1K6QGyJP9P9xmRac2fH4OQ: raises $25.60 to $37.10 and is all-in
COsrwJSFHQtxlUcrYtDQPQ: calls $27.60 and is all-in
cZ99hugmLBj9KhTlc8nCSw: calls $16.70 and is all-in
Uncalled bet ($5.40) returned to 1K6QGyJP9P9xmRac2fH4OQ
*** TURN *** [Ah 6h Jh] [4h]
*** RIVER *** [Ah 6h Jh 4h] [Jc]
*** SHOW DOWN ***
1K6QGyJP9P9xmRac2fH4OQ: shows [As Ac] (a full house, Aces full of Jacks)
COsrwJSFHQtxlUcrYtDQPQ: mucks hand 
1K6QGyJP9P9xmRac2fH4OQ collected $7 from side pot
COsrwJSFHQtxlUcrYtDQPQ said, "FFS"
cZ99hugmLBj9KhTlc8nCSw: mucks hand 
1K6QGyJP9P9xmRac2fH4OQ collected $86.70 from main pot
*** SUMMARY ***
Total pot $96.70 Main pot $86.70. Side pot $7. | Rake $3 
Board [Ah 6h Jh 4h Jc]
Seat 1: N6fYvIzQLKaydFLKQGtMlQ folded before Flop (didn't bet)
Seat 2: w31DkWCTQDVIzsHIrFRDxA folded on the Flop
Seat 3: HPEB+AtKw1+C/cxU0o1ciw folded before Flop (didn't bet)
Seat 4: Eb2mDXvZ4iY02krYdOYwMA folded on the Flop
Seat 5: COsrwJSFHQtxlUcrYtDQPQ mucked
Seat 6: rXm4QDVJt67H20lM6n6Z7Q (button) folded before Flop (didn't bet)
Seat 7: 3RCAkueG3Vc13VpRStCB+w (small blind) folded before Flop
Seat 8: cZ99hugmLBj9KhTlc8nCSw (big blind) mucked
Seat 9: 1K6QGyJP9P9xmRac2fH4OQ showed [As Ac] and won ($93.70) with a full house, Aces full of Jacks




PokerStars Game #59939354410:  Hold'em No Limit ($0.10/$0.25) - 2009/07/01 0:37:43 ET
Table 'FBhJjLqab11/gKu8nyB/tw' 9-max Seat #2 is the button
Seat 1: +sbyWwIcFp9kP0bDtMegfQ ($22.05 in chips) 
Seat 2: 1pwQJV/Xr0GWPRefx/78VQ ($2.30 in chips) 
Seat 3: uy9x0X5l7O+IpGjLa77QgQ ($31.40 in chips) 
Seat 4: OTC1Bh+DhK778Qnsj6D8+A ($25 in chips) 
Seat 5: vZGoOTJLQLhkPj4I+LNGig ($45.25 in chips) 
Seat 6: QrNgXJWFdS+POsPJcil4aA ($20.10 in chips) 
Seat 7: 5Fj9JGGxQT7Djr6AyIiBVA ($19.85 in chips) 
Seat 8: 9lE3Zc4pjmKpQK8rDF1aaQ ($15.50 in chips) 
Seat 9: BEIBUu2pIflPrCL+Iks4CQ ($12.15 in chips) 
uy9x0X5l7O+IpGjLa77QgQ: posts small blind $0.10
OTC1Bh+DhK778Qnsj6D8+A: posts big blind $0.25
*** HOLE CARDS ***
vZGoOTJLQLhkPj4I+LNGig: folds 
QrNgXJWFdS+POsPJcil4aA: calls $0.25
5Fj9JGGxQT7Djr6AyIiBVA: calls $0.25
9lE3Zc4pjmKpQK8rDF1aaQ: folds 
BEIBUu2pIflPrCL+Iks4CQ: folds 
+sbyWwIcFp9kP0bDtMegfQ: calls $0.25
1pwQJV/Xr0GWPRefx/78VQ: calls $0.25
uy9x0X5l7O+IpGjLa77QgQ: calls $0.15
OTC1Bh+DhK778Qnsj6D8+A: checks 
*** FLOP *** [7c 3c Jd]
uy9x0X5l7O+IpGjLa77QgQ: checks 
OTC1Bh+DhK778Qnsj6D8+A: checks 
QrNgXJWFdS+POsPJcil4aA: checks 
5Fj9JGGxQT7Djr6AyIiBVA: bets $1.25
+sbyWwIcFp9kP0bDtMegfQ: folds 
1pwQJV/Xr0GWPRefx/78VQ: folds 
uy9x0X5l7O+IpGjLa77QgQ: calls $1.25
OTC1Bh+DhK778Qnsj6D8+A: folds 
QrNgXJWFdS+POsPJcil4aA: folds 
*** TURN *** [7c 3c Jd] [3d]
uy9x0X5l7O+IpGjLa77QgQ: bets $3
5Fj9JGGxQT7Djr6AyIiBVA: calls $3
*** RIVER *** [7c 3c Jd 3d] [6s]
uy9x0X5l7O+IpGjLa77QgQ: checks 
5Fj9JGGxQT7Djr6AyIiBVA: checks 
*** SHOW DOWN ***
uy9x0X5l7O+IpGjLa77QgQ: shows [Th Jh] (two pair, Jacks and Threes)
5Fj9JGGxQT7Djr6AyIiBVA: shows [Jc Ac] (two pair, Jacks and Threes - Ace kicker)
5Fj9JGGxQT7Djr6AyIiBVA collected $9.55 from pot
*** SUMMARY ***
Total pot $10 | Rake $0.45 
Board [7c 3c Jd 3d 6s]
Seat 1: +sbyWwIcFp9kP0bDtMegfQ folded on the Flop
Seat 2: 1pwQJV/Xr0GWPRefx/78VQ (button) folded on the Flop
Seat 3: uy9x0X5l7O+IpGjLa77QgQ (small blind) showed [Th Jh] and lost with two pair, Jacks and Threes
Seat 4: OTC1Bh+DhK778Qnsj6D8+A (big blind) folded on the Flop
Seat 5: vZGoOTJLQLhkPj4I+LNGig folded before Flop (didn't bet)
Seat 6: QrNgXJWFdS+POsPJcil4aA folded on the Flop
Seat 7: 5Fj9JGGxQT7Djr6AyIiBVA showed [Jc Ac] and won ($9.55) with two pair, Jacks and Threes
Seat 8: 9lE3Zc4pjmKpQK8rDF1aaQ folded before Flop (didn't bet)
Seat 9: BEIBUu2pIflPrCL+Iks4CQ folded before Flop (didn't bet)




PokerStars Game #59939353878:  Hold'em No Limit ($0.10/$0.25) - 2009/07/01 0:37:43 ET
Table 'dVzscin98UhGisTmV9BDcw' 9-max Seat #2 is the button
Seat 1: sBAwXpkpgyhyWbHIQcIJKA ($19.45 in chips) 
Seat 2: dfNim92Z6XK1/h5SFW5vDg ($29.15 in chips) 
Seat 3: 1Clf3cPrqoy/YgvWdWK1Xw ($5.35 in chips) 
Seat 4: aNpwfA31EREwO+ar4XzBCw ($25 in chips) 
Seat 5: ZMRQOoxoJ7Alx96gZhP2EQ ($60.70 in chips) 
Seat 6: hBMUlEpyU74r/fwDgIpXjQ ($25.25 in chips) 
Seat 7: nEg1b6MIksd/4x5eLY735g ($67.15 in chips) 
Seat 8: /vn2Qu2dvc9AMMq46Ae0jA ($5.70 in chips) 
Seat 9: OYa/ZJBO+suuezfWsUMhZw ($6.65 in chips) 
1Clf3cPrqoy/YgvWdWK1Xw: posts small blind $0.10
aNpwfA31EREwO+ar4XzBCw: posts big blind $0.25
*** HOLE CARDS ***
ZMRQOoxoJ7Alx96gZhP2EQ: calls $0.25
hBMUlEpyU74r/fwDgIpXjQ: folds 
nEg1b6MIksd/4x5eLY735g: folds 
/vn2Qu2dvc9AMMq46Ae0jA: folds 
OYa/ZJBO+suuezfWsUMhZw: folds 
sBAwXpkpgyhyWbHIQcIJKA: folds 
dfNim92Z6XK1/h5SFW5vDg: folds 
1Clf3cPrqoy/YgvWdWK1Xw: folds 
aNpwfA31EREwO+ar4XzBCw: checks 
*** FLOP *** [6s Ah Ac]
aNpwfA31EREwO+ar4XzBCw: checks 
ZMRQOoxoJ7Alx96gZhP2EQ: checks 
*** TURN *** [6s Ah Ac] [2s]
aNpwfA31EREwO+ar4XzBCw: bets $0.50
ZMRQOoxoJ7Alx96gZhP2EQ: folds 
Uncalled bet ($0.50) returned to aNpwfA31EREwO+ar4XzBCw
aNpwfA31EREwO+ar4XzBCw collected $0.60 from pot
aNpwfA31EREwO+ar4XzBCw: doesn't show hand 
*** SUMMARY ***
Total pot $0.60 | Rake $0 
Board [6s Ah Ac 2s]
Seat 1: sBAwXpkpgyhyWbHIQcIJKA folded before Flop (didn't bet)
Seat 2: dfNim92Z6XK1/h5SFW5vDg (button) folded before Flop (didn't bet)
Seat 3: 1Clf3cPrqoy/YgvWdWK1Xw (small blind) folded before Flop
Seat 4: aNpwfA31EREwO+ar4XzBCw (big blind) collected ($0.60)
Seat 5: ZMRQOoxoJ7Alx96gZhP2EQ folded on the Turn
Seat 6: hBMUlEpyU74r/fwDgIpXjQ folded before Flop (didn't bet)
Seat 7: nEg1b6MIksd/4x5eLY735g folded before Flop (didn't bet)
Seat 8: /vn2Qu2dvc9AMMq46Ae0jA folded before Flop (didn't bet)
Seat 9: OYa/ZJBO+suuezfWsUMhZw folded before Flop (didn't bet)




PokerStars Game #59939354028:  Hold'em No Limit ($0.10/$0.25) - 2009/07/01 0:37:43 ET
Table 'VQNfcI8vTBCTvRfd3veTLQ' 6-max Seat #1 is the button
Seat 1: ymz+a8dgHSUFPooYplw7Ow ($24 in chips) 
Seat 2: KukIGupqqJCXA+Hp2bEFnA ($6.80 in chips) 
Seat 3: LtASJ9OlkqGrrUKGQlpGAw ($23.90 in chips) 
Seat 4: nc79pm0LZRdhncq55evVqA ($26.15 in chips) 
Seat 5: gX2vbKwS/8zZPENAWB7hxQ ($6.85 in chips) 
Seat 6: dlCLwmcvRShnuFDEVkdIEA ($14.60 in chips) 
KukIGupqqJCXA+Hp2bEFnA: posts small blind $0.10
LtASJ9OlkqGrrUKGQlpGAw: posts big blind $0.25
*** HOLE CARDS ***
nc79pm0LZRdhncq55evVqA: folds 
gX2vbKwS/8zZPENAWB7hxQ: raises $0.25 to $0.50
dlCLwmcvRShnuFDEVkdIEA: folds 
ymz+a8dgHSUFPooYplw7Ow: calls $0.50
KukIGupqqJCXA+Hp2bEFnA: folds 
LtASJ9OlkqGrrUKGQlpGAw: folds 
*** FLOP *** [5h 3d 8h]
gX2vbKwS/8zZPENAWB7hxQ: bets $0.75
ymz+a8dgHSUFPooYplw7Ow: folds 
Uncalled bet ($0.75) returned to gX2vbKwS/8zZPENAWB7hxQ
gX2vbKwS/8zZPENAWB7hxQ collected $1.30 from pot
*** SUMMARY ***
Total pot $1.35 | Rake $0.05 
Board [5h 3d 8h]
Seat 1: ymz+a8dgHSUFPooYplw7Ow (button) folded on the Flop
Seat 2: KukIGupqqJCXA+Hp2bEFnA (small blind) folded before Flop
Seat 3: LtASJ9OlkqGrrUKGQlpGAw (big blind) folded before Flop
Seat 4: nc79pm0LZRdhncq55evVqA folded before Flop (didn't bet)
Seat 5: gX2vbKwS/8zZPENAWB7hxQ collected ($1.30)
Seat 6: dlCLwmcvRShnuFDEVkdIEA folded before Flop (didn't bet)




PokerStars Game #59939354472:  Hold'em No Limit ($0.10/$0.25) - 2009/07/01 0:37:43 ET
Table 'biAgO3TKQBU8XcrVAoU5TA' 6-max Seat #2 is the button
Seat 1: PIOdknsVyjKUwfiImc3zwg ($28.10 in chips) 
Seat 2: 7qRk4YH4/k/08LgJSv7rBQ ($24.65 in chips) 
Seat 3: 7AHdX4G8gYtDJyNY+wK+6Q ($28.75 in chips) 
Seat 4: 2/AObG8G5tKFCPZ+CdivJQ ($13.30 in chips) 
Seat 5: p6AVxoPtCVlAcAcaYyxvkQ ($20.05 in chips) 
Seat 6: //i5P+6lSkIyZsqb+ojVQA ($13.65 in chips) 
7AHdX4G8gYtDJyNY+wK+6Q: posts small blind $0.10
2/AObG8G5tKFCPZ+CdivJQ: posts big blind $0.25
*** HOLE CARDS ***
p6AVxoPtCVlAcAcaYyxvkQ: folds 
//i5P+6lSkIyZsqb+ojVQA: raises $0.25 to $0.50
p6AVxoPtCVlAcAcaYyxvkQ is sitting out
PIOdknsVyjKUwfiImc3zwg: calls $0.50
7qRk4YH4/k/08LgJSv7rBQ: folds 
7AHdX4G8gYtDJyNY+wK+6Q: calls $0.40
2/AObG8G5tKFCPZ+CdivJQ: calls $0.25
*** FLOP *** [5s 3s 9h]
7AHdX4G8gYtDJyNY+wK+6Q: checks 
2/AObG8G5tKFCPZ+CdivJQ: checks 
//i5P+6lSkIyZsqb+ojVQA: checks 
PIOdknsVyjKUwfiImc3zwg: checks 
*** TURN *** [5s 3s 9h] [6s]
7AHdX4G8gYtDJyNY+wK+6Q: bets $0.50
2/AObG8G5tKFCPZ+CdivJQ: folds 
p6AVxoPtCVlAcAcaYyxvkQ leaves the table
//i5P+6lSkIyZsqb+ojVQA: calls $0.50
PIOdknsVyjKUwfiImc3zwg: folds 
*** RIVER *** [5s 3s 9h 6s] [8s]
7AHdX4G8gYtDJyNY+wK+6Q: bets $2.25
//i5P+6lSkIyZsqb+ojVQA: folds 
Uncalled bet ($2.25) returned to 7AHdX4G8gYtDJyNY+wK+6Q
7AHdX4G8gYtDJyNY+wK+6Q collected $2.90 from pot
7AHdX4G8gYtDJyNY+wK+6Q: doesn't show hand 
*** SUMMARY ***
Total pot $3 | Rake $0.10 
Board [5s 3s 9h 6s 8s]
Seat 1: PIOdknsVyjKUwfiImc3zwg folded on the Turn
Seat 2: 7qRk4YH4/k/08LgJSv7rBQ (button) folded before Flop (didn't bet)
Seat 3: 7AHdX4G8gYtDJyNY+wK+6Q (small blind) collected ($2.90)
Seat 4: 2/AObG8G5tKFCPZ+CdivJQ (big blind) folded on the Turn
Seat 5: p6AVxoPtCVlAcAcaYyxvkQ folded before Flop (didn't bet)
Seat 6: //i5P+6lSkIyZsqb+ojVQA folded on the River




PokerStars Game #59939354362:  Hold'em No Limit ($0.10/$0.25) - 2009/07/01 0:37:43 ET
Table 'RUOqTfzbAVGS5x+J9aZMHA' 9-max Seat #4 is the button
Seat 1: KBBTLXGhPdPj+4X0QKMkcg ($8.90 in chips) 
Seat 2: Z5ZtGOON8kmSdSCll9Z3XA ($6.70 in chips) 
Seat 4: 18G4P1XstjNvItdGUITxgw ($27.95 in chips) 
Seat 5: opOCI2p6kW0tINuVaAqmcQ ($25 in chips) 
Seat 6: ljemhp25Zg+nlA9DLCIiUw ($33.80 in chips) 
Seat 7: ZWU9RNYtjmm4cElg1I0F4w ($47.80 in chips) 
Seat 8: 3RCAkueG3Vc13VpRStCB+w ($32.35 in chips) 
opOCI2p6kW0tINuVaAqmcQ: posts small blind $0.10
ljemhp25Zg+nlA9DLCIiUw: posts big blind $0.25
*** HOLE CARDS ***
ZWU9RNYtjmm4cElg1I0F4w: folds 
3RCAkueG3Vc13VpRStCB+w: folds 
KBBTLXGhPdPj+4X0QKMkcg: calls $0.25
Z5ZtGOON8kmSdSCll9Z3XA: folds 
18G4P1XstjNvItdGUITxgw: raises $0.50 to $0.75
opOCI2p6kW0tINuVaAqmcQ: folds 
ljemhp25Zg+nlA9DLCIiUw: folds 
KBBTLXGhPdPj+4X0QKMkcg: calls $0.50
*** FLOP *** [4c 5c Ah]
KBBTLXGhPdPj+4X0QKMkcg: checks 
18G4P1XstjNvItdGUITxgw: bets $0.75
KBBTLXGhPdPj+4X0QKMkcg: folds 
Uncalled bet ($0.75) returned to 18G4P1XstjNvItdGUITxgw
18G4P1XstjNvItdGUITxgw collected $1.80 from pot
18G4P1XstjNvItdGUITxgw: doesn't show hand 
*** SUMMARY ***
Total pot $1.85 | Rake $0.05 
Board [4c 5c Ah]
Seat 1: KBBTLXGhPdPj+4X0QKMkcg folded on the Flop
Seat 2: Z5ZtGOON8kmSdSCll9Z3XA folded before Flop (didn't bet)
Seat 4: 18G4P1XstjNvItdGUITxgw (button) collected ($1.80)
Seat 5: opOCI2p6kW0tINuVaAqmcQ (small blind) folded before Flop
Seat 6: ljemhp25Zg+nlA9DLCIiUw (big blind) folded before Flop
Seat 7: ZWU9RNYtjmm4cElg1I0F4w folded before Flop (didn't bet)
Seat 8: 3RCAkueG3Vc13VpRStCB+w folded before Flop (didn't bet)




PokerStars Game #59939354376:  Hold'em No Limit ($0.10/$0.25) - 2009/07/01 0:37:43 ET
Table 'ORSZkZqq+7Ja2PdeCFAytA' 9-max Seat #2 is the button
Seat 1: Gpa8cld5y0mdOomHJgHhlA ($10.90 in chips) 
Seat 2: yduPKWPzL8YlT5Zv/Nmrwg ($23.40 in chips) 
Seat 4: b8t3jWrxzeEt9HtZtc9wUQ ($13.40 in chips) 
Seat 5: tYsOBqdU1+x+yFI7zHO7hQ ($31.65 in chips) 
Seat 7: ZoG0obuajzVjwgd7lNHjgg ($22 in chips) 
Seat 8: opOCI2p6kW0tINuVaAqmcQ ($40.20 in chips) 
Seat 9: VBHxUExRAMrbxUq/cVx9Gw ($5 in chips) 
nm4Dj/f+jJEwKVsUnKh73g will be allowed to play after the button
b8t3jWrxzeEt9HtZtc9wUQ: posts small blind $0.10
tYsOBqdU1+x+yFI7zHO7hQ: posts big blind $0.25
*** HOLE CARDS ***
MC7/fevFfNbuDTx/uhUC4w leaves the table
ZoG0obuajzVjwgd7lNHjgg: folds 
opOCI2p6kW0tINuVaAqmcQ: raises $0.50 to $0.75
VBHxUExRAMrbxUq/cVx9Gw: folds 
Gpa8cld5y0mdOomHJgHhlA: folds 
yduPKWPzL8YlT5Zv/Nmrwg: calls $0.75
b8t3jWrxzeEt9HtZtc9wUQ: calls $0.65
tYsOBqdU1+x+yFI7zHO7hQ: folds 
*** FLOP *** [Qd Jd 2d]
b8t3jWrxzeEt9HtZtc9wUQ: checks 
opOCI2p6kW0tINuVaAqmcQ: checks 
yduPKWPzL8YlT5Zv/Nmrwg: bets $1.75
b8t3jWrxzeEt9HtZtc9wUQ: calls $1.75
opOCI2p6kW0tINuVaAqmcQ: folds 
*** TURN *** [Qd Jd 2d] [Th]
b8t3jWrxzeEt9HtZtc9wUQ: checks 
yduPKWPzL8YlT5Zv/Nmrwg: bets $3.75
b8t3jWrxzeEt9HtZtc9wUQ: calls $3.75
*** RIVER *** [Qd Jd 2d Th] [Ah]
b8t3jWrxzeEt9HtZtc9wUQ: bets $7.15 and is all-in
yduPKWPzL8YlT5Zv/Nmrwg: calls $7.15
*** SHOW DOWN ***
b8t3jWrxzeEt9HtZtc9wUQ: shows [5d Ad] (a flush, Ace high)
yduPKWPzL8YlT5Zv/Nmrwg: mucks hand 
b8t3jWrxzeEt9HtZtc9wUQ collected $26.45 from pot
*** SUMMARY ***
Total pot $27.80 | Rake $1.35 
Board [Qd Jd 2d Th Ah]
Seat 1: Gpa8cld5y0mdOomHJgHhlA folded before Flop (didn't bet)
Seat 2: yduPKWPzL8YlT5Zv/Nmrwg (button) mucked
Seat 4: b8t3jWrxzeEt9HtZtc9wUQ (small blind) showed [5d Ad] and won ($26.45) with a flush, Ace high
Seat 5: tYsOBqdU1+x+yFI7zHO7hQ (big blind) folded before Flop
Seat 7: ZoG0obuajzVjwgd7lNHjgg folded before Flop (didn't bet)
Seat 8: opOCI2p6kW0tINuVaAqmcQ folded on the Flop
Seat 9: VBHxUExRAMrbxUq/cVx9Gw folded before Flop (didn't bet)




PokerStars Game #59939354032:  Hold'em No Limit ($0.10/$0.25) - 2009/07/01 0:37:43 ET
Table 'HzFR0rxmDAPu5GzYR0AlYg' 6-max Seat #5 is the button
Seat 1: v+QfkGiuj9bgtuNoVnDO8w ($25 in chips) 
Seat 2: UA5OsKS3VPaxa7uC8La/kA ($52.95 in chips) 
Seat 3: lfAPI6VglUPipZe8BpDaTA ($24.85 in chips) 
Seat 4: uy9x0X5l7O+IpGjLa77QgQ ($53.30 in chips) 
Seat 5: I1TxPvWj8NfG8orglCinNA ($28.60 in chips) 
v+QfkGiuj9bgtuNoVnDO8w: posts small blind $0.10
UA5OsKS3VPaxa7uC8La/kA: posts big blind $0.25
*** HOLE CARDS ***
lfAPI6VglUPipZe8BpDaTA: folds 
uy9x0X5l7O+IpGjLa77QgQ: raises $0.75 to $1
mike czar said, "how do u insta call that? seriously"
I1TxPvWj8NfG8orglCinNA: raises $2 to $3
v+QfkGiuj9bgtuNoVnDO8w: folds 
UA5OsKS3VPaxa7uC8La/kA: folds 
uy9x0X5l7O+IpGjLa77QgQ said, "Read you right..sorry"
uy9x0X5l7O+IpGjLa77QgQ: calls $2
*** FLOP *** [8d 5c Tc]
uy9x0X5l7O+IpGjLa77QgQ: checks 
mike czar said, "how did u read it?"
I1TxPvWj8NfG8orglCinNA: bets $4.50
uy9x0X5l7O+IpGjLa77QgQ: calls $4.50
*** TURN *** [8d 5c Tc] [5h]
uy9x0X5l7O+IpGjLa77QgQ: checks 
I1TxPvWj8NfG8orglCinNA: checks 
*** RIVER *** [8d 5c Tc 5h] [3c]
uy9x0X5l7O+IpGjLa77QgQ: checks 
I1TxPvWj8NfG8orglCinNA: checks 
*** SHOW DOWN ***
uy9x0X5l7O+IpGjLa77QgQ: shows [Kc Kd] (two pair, Kings and Fives)
I1TxPvWj8NfG8orglCinNA: mucks hand 
uy9x0X5l7O+IpGjLa77QgQ collected $14.60 from pot
*** SUMMARY ***
Total pot $15.35 | Rake $0.75 
Board [8d 5c Tc 5h 3c]
Seat 1: v+QfkGiuj9bgtuNoVnDO8w (small blind) folded before Flop
Seat 2: UA5OsKS3VPaxa7uC8La/kA (big blind) folded before Flop
Seat 3: lfAPI6VglUPipZe8BpDaTA folded before Flop (didn't bet)
Seat 4: uy9x0X5l7O+IpGjLa77QgQ showed [Kc Kd] and won ($14.60) with two pair, Kings and Fives
Seat 5: I1TxPvWj8NfG8orglCinNA (button) mucked




PokerStars Game #59939354488:  Hold'em No Limit ($0.10/$0.25) - 2009/07/01 0:37:43 ET
Table 'MJ1SB76A4qJrlEa+C5e/8w' 6-max Seat #3 is the button
Seat 1: zhr8yRTAgNkeOmGK2mwJvg ($26.10 in chips) 
Seat 2: UA5OsKS3VPaxa7uC8La/kA ($26.80 in chips) 
Seat 3: IrrSNlaIjHnZjG6E7LgmEg ($16.30 in chips) 
Seat 5: eHsmIvAb2JREg4O6hNPnXg ($10.10 in chips) 
Seat 6: JFIAqU8lCZ0vWwEl4bdGsg ($25 in chips) 
eHsmIvAb2JREg4O6hNPnXg: posts small blind $0.10
JFIAqU8lCZ0vWwEl4bdGsg: posts big blind $0.25
*** HOLE CARDS ***
zhr8yRTAgNkeOmGK2mwJvg: folds 
zhr8yRTAgNkeOmGK2mwJvg is sitting out
UA5OsKS3VPaxa7uC8La/kA: folds 
IrrSNlaIjHnZjG6E7LgmEg: raises $0.50 to $0.75
eHsmIvAb2JREg4O6hNPnXg: folds 
JFIAqU8lCZ0vWwEl4bdGsg: folds 
Uncalled bet ($0.50) returned to IrrSNlaIjHnZjG6E7LgmEg
IrrSNlaIjHnZjG6E7LgmEg collected $0.60 from pot
IrrSNlaIjHnZjG6E7LgmEg: doesn't show hand 
*** SUMMARY ***
Total pot $0.60 | Rake $0 
Seat 1: zhr8yRTAgNkeOmGK2mwJvg folded before Flop (didn't bet)
Seat 2: UA5OsKS3VPaxa7uC8La/kA folded before Flop (didn't bet)
Seat 3: IrrSNlaIjHnZjG6E7LgmEg (button) collected ($0.60)
Seat 5: eHsmIvAb2JREg4O6hNPnXg (small blind) folded before Flop
Seat 6: JFIAqU8lCZ0vWwEl4bdGsg (big blind) folded before Flop




PokerStars Game #59939355026:  Hold'em No Limit ($0.10/$0.25) - 2009/07/01 0:37:44 ET
Table 'ER5H84HUgJx7HyDLnELLeA' 6-max Seat #5 is the button
Seat 1: pjM/xh4+RG8zrxCobDgYDg ($15.50 in chips) 
Seat 2: nc79pm0LZRdhncq55evVqA ($48.85 in chips) 
Seat 3: 2j+7KACUO5iqZ/NSvIH3vg ($5.90 in chips) 
Seat 4: tkRWn3WaJIfGmCXT2hPvJA ($18.80 in chips) 
Seat 5: mfrkWA3PTeYPkbO6hi98Aw ($23.40 in chips) 
pjM/xh4+RG8zrxCobDgYDg: posts small blind $0.10
nc79pm0LZRdhncq55evVqA: posts big blind $0.25
*** HOLE CARDS ***
2j+7KACUO5iqZ/NSvIH3vg: calls $0.25
ConnorDogg leaves the table
tkRWn3WaJIfGmCXT2hPvJA: folds 
mfrkWA3PTeYPkbO6hi98Aw: folds 
pjM/xh4+RG8zrxCobDgYDg: calls $0.15
nc79pm0LZRdhncq55evVqA: checks 
*** FLOP *** [Qc Jc 5c]
pjM/xh4+RG8zrxCobDgYDg: checks 
nc79pm0LZRdhncq55evVqA: checks 
FONMraB4GCHzDwDcfciKyw joins the table at seat #6 
2j+7KACUO5iqZ/NSvIH3vg: checks 
*** TURN *** [Qc Jc 5c] [8d]
pjM/xh4+RG8zrxCobDgYDg: checks 
nc79pm0LZRdhncq55evVqA: checks 
2j+7KACUO5iqZ/NSvIH3vg: bets $0.25
pjM/xh4+RG8zrxCobDgYDg: folds 
nc79pm0LZRdhncq55evVqA: folds 
Uncalled bet ($0.25) returned to 2j+7KACUO5iqZ/NSvIH3vg
2j+7KACUO5iqZ/NSvIH3vg collected $0.75 from pot
*** SUMMARY ***
Total pot $0.75 | Rake $0 
Board [Qc Jc 5c 8d]
Seat 1: pjM/xh4+RG8zrxCobDgYDg (small blind) folded on the Turn
Seat 2: nc79pm0LZRdhncq55evVqA (big blind) folded on the Turn
Seat 3: 2j+7KACUO5iqZ/NSvIH3vg collected ($0.75)
Seat 4: tkRWn3WaJIfGmCXT2hPvJA folded before Flop (didn't bet)
Seat 5: mfrkWA3PTeYPkbO6hi98Aw (button) folded before Flop (didn't bet)




PokerStars Game #59939354824:  Hold'em No Limit ($0.10/$0.25) - 2009/07/01 0:37:44 ET
Table 'nB7Q7zfNfy6ig6DB+rsgWQ' 6-max Seat #6 is the button
Seat 1: ACU3rO57RhDJfAgHTq2ocA ($4.60 in chips) 
Seat 2: g6kf+5FIgWH33PmH6ZecMQ ($14.50 in chips) 
Seat 3: p3NYOxYhkL7txPRSeXHDeg ($35.10 in chips) 
Seat 4: YZjG5I7FqwMKy06BKVBS7w ($10.80 in chips) 
Seat 5: X0/5h4o4LdHWlM7o/9shzg ($6.80 in chips) 
Seat 6: BYxjLnV1/LL0aZcTbfAOvw ($38.40 in chips) 
ACU3rO57RhDJfAgHTq2ocA: posts small blind $0.10
g6kf+5FIgWH33PmH6ZecMQ: posts big blind $0.25
*** HOLE CARDS ***
p3NYOxYhkL7txPRSeXHDeg: folds 
YZjG5I7FqwMKy06BKVBS7w: folds 
X0/5h4o4LdHWlM7o/9shzg: calls $0.25
BYxjLnV1/LL0aZcTbfAOvw: folds 
ACU3rO57RhDJfAgHTq2ocA: calls $0.15
g6kf+5FIgWH33PmH6ZecMQ: checks 
*** FLOP *** [7d Ts 3c]
ACU3rO57RhDJfAgHTq2ocA: checks 
g6kf+5FIgWH33PmH6ZecMQ: checks 
X0/5h4o4LdHWlM7o/9shzg: checks 
*** TURN *** [7d Ts 3c] [Qh]
ACU3rO57RhDJfAgHTq2ocA: checks 
g6kf+5FIgWH33PmH6ZecMQ: checks 
X0/5h4o4LdHWlM7o/9shzg: checks 
*** RIVER *** [7d Ts 3c Qh] [5c]
ACU3rO57RhDJfAgHTq2ocA: checks 
g6kf+5FIgWH33PmH6ZecMQ: checks 
X0/5h4o4LdHWlM7o/9shzg: bets $1
ACU3rO57RhDJfAgHTq2ocA: folds 
g6kf+5FIgWH33PmH6ZecMQ: folds 
Uncalled bet ($1) returned to X0/5h4o4LdHWlM7o/9shzg
X0/5h4o4LdHWlM7o/9shzg collected $0.75 from pot
X0/5h4o4LdHWlM7o/9shzg: doesn't show hand 
*** SUMMARY ***
Total pot $0.75 | Rake $0 
Board [7d Ts 3c Qh 5c]
Seat 1: ACU3rO57RhDJfAgHTq2ocA (small blind) folded on the River
Seat 2: g6kf+5FIgWH33PmH6ZecMQ (big blind) folded on the River
Seat 3: p3NYOxYhkL7txPRSeXHDeg folded before Flop (didn't bet)
Seat 4: YZjG5I7FqwMKy06BKVBS7w folded before Flop (didn't bet)
Seat 5: X0/5h4o4LdHWlM7o/9shzg collected ($0.75)
Seat 6: BYxjLnV1/LL0aZcTbfAOvw (button) folded before Flop (didn't bet)




PokerStars Game #59939354598:  Hold'em No Limit ($0.10/$0.25) - 2009/07/01 0:37:44 ET
Table 'oZuNsbNJuUyQLGKzQ/4JFg' 6-max Seat #6 is the button
Seat 1: /hq3j+3FbArzS8nEzmqRuw ($5.50 in chips) 
Seat 2: UA5OsKS3VPaxa7uC8La/kA ($32.10 in chips) 
Seat 3: 8ClCHtFXGNplITm+63KB+Q ($37.75 in chips) 
Seat 4: pWN7DVB+VCCiq83kllzEtg ($10.40 in chips) 
Seat 5: IH5lT4+CuQFyy32Qf5ydDw ($13.90 in chips) 
Seat 6: 34ttqW62uIRrqINCCmLcsw ($21.40 in chips) 
/hq3j+3FbArzS8nEzmqRuw: posts small blind $0.10
UA5OsKS3VPaxa7uC8La/kA: posts big blind $0.25
*** HOLE CARDS ***
8ClCHtFXGNplITm+63KB+Q: folds 
pWN7DVB+VCCiq83kllzEtg: folds 
IH5lT4+CuQFyy32Qf5ydDw: calls $0.25
34ttqW62uIRrqINCCmLcsw: folds 
/hq3j+3FbArzS8nEzmqRuw: calls $0.15
UA5OsKS3VPaxa7uC8La/kA: checks 
*** FLOP *** [8c Qs 2h]
/hq3j+3FbArzS8nEzmqRuw: bets $0.50
UA5OsKS3VPaxa7uC8La/kA: calls $0.50
IH5lT4+CuQFyy32Qf5ydDw: folds 
*** TURN *** [8c Qs 2h] [Tc]
/hq3j+3FbArzS8nEzmqRuw: bets $1
UA5OsKS3VPaxa7uC8La/kA: calls $1
*** RIVER *** [8c Qs 2h Tc] [Jc]
/hq3j+3FbArzS8nEzmqRuw: checks 
UA5OsKS3VPaxa7uC8La/kA: checks 
*** SHOW DOWN ***
/hq3j+3FbArzS8nEzmqRuw: shows [6c Ac] (a flush, Ace high)
UA5OsKS3VPaxa7uC8La/kA: mucks hand 
/hq3j+3FbArzS8nEzmqRuw collected $3.60 from pot
*** SUMMARY ***
Total pot $3.75 | Rake $0.15 
Board [8c Qs 2h Tc Jc]
Seat 1: /hq3j+3FbArzS8nEzmqRuw (small blind) showed [6c Ac] and won ($3.60) with a flush, Ace high
Seat 2: UA5OsKS3VPaxa7uC8La/kA (big blind) mucked
Seat 3: 8ClCHtFXGNplITm+63KB+Q folded before Flop (didn't bet)
Seat 4: pWN7DVB+VCCiq83kllzEtg folded before Flop (didn't bet)
Seat 5: IH5lT4+CuQFyy32Qf5ydDw folded on the Flop
Seat 6: 34ttqW62uIRrqINCCmLcsw (button) folded before Flop (didn't bet)




PokerStars Game #59939354602:  Hold'em No Limit ($0.10/$0.25) - 2009/07/01 0:37:44 ET
Table 'LLHSnYPAXNI1sFlwPBn1tA' 6-max Seat #4 is the button
Seat 1: tVZW8k4GP+PvZ1DjD/9StA ($10.90 in chips) 
Seat 2: oseFhpinoe+Zg4j5xyBjyQ ($24.55 in chips) 
Seat 3: JFIAqU8lCZ0vWwEl4bdGsg ($28.15 in chips) 
Seat 4: FPlQHZog0ePFCETQ2KG4hQ ($26.20 in chips) 
Seat 5: jXbd3O6QdeNWctmpAsTgHA ($14.50 in chips) 
Seat 6: PCh4iIHq9rXvWY/FeXc/Jg ($32.35 in chips) 
jXbd3O6QdeNWctmpAsTgHA: posts small blind $0.10
PCh4iIHq9rXvWY/FeXc/Jg: posts big blind $0.25
*** HOLE CARDS ***
tVZW8k4GP+PvZ1DjD/9StA: folds 
oseFhpinoe+Zg4j5xyBjyQ: folds 
JFIAqU8lCZ0vWwEl4bdGsg: folds 
FPlQHZog0ePFCETQ2KG4hQ: raises $0.75 to $1
jXbd3O6QdeNWctmpAsTgHA: folds 
PCh4iIHq9rXvWY/FeXc/Jg: calls $0.75
*** FLOP *** [9h 5h Qs]
PCh4iIHq9rXvWY/FeXc/Jg: checks 
FPlQHZog0ePFCETQ2KG4hQ: bets $1.50
PCh4iIHq9rXvWY/FeXc/Jg: folds 
Uncalled bet ($1.50) returned to FPlQHZog0ePFCETQ2KG4hQ
FPlQHZog0ePFCETQ2KG4hQ collected $2 from pot
*** SUMMARY ***
Total pot $2.10 | Rake $0.10 
Board [9h 5h Qs]
Seat 1: tVZW8k4GP+PvZ1DjD/9StA folded before Flop (didn't bet)
Seat 2: oseFhpinoe+Zg4j5xyBjyQ folded before Flop (didn't bet)
Seat 3: JFIAqU8lCZ0vWwEl4bdGsg folded before Flop (didn't bet)
Seat 4: FPlQHZog0ePFCETQ2KG4hQ (button) collected ($2)
Seat 5: jXbd3O6QdeNWctmpAsTgHA (small blind) folded before Flop
Seat 6: PCh4iIHq9rXvWY/FeXc/Jg (big blind) folded on the Flop




PokerStars Game #59939355092:  Hold'em No Limit ($0.10/$0.25) - 2009/07/01 0:37:44 ET
Table 'oG007Tb0LYbfANo6QWd16wWEMI3Mtn7dGARDbgNrKibgx Seat #5 is the button
Seat 1: GEZ4LFjiwTFoPklBgpSnlw ($18.55 in chips) 
Seat 2: zDrucyjVn5aeekNEc3cJrA ($23 in chips) 
Seat 3: 56S3mA6Zs3pGR+0p0vUCtg ($24.65 in chips) 
Seat 4: oKO7b50N6TzXbPBr/mcrUA ($25.70 in chips) 
Seat 5: MIVCHqCqqlke0Lb0z7glcw ($24.65 in chips) 
Seat 6: lxVahNAs/pc3YeLt9PSgbg ($19.25 in chips) 
Seat 7: sUVgUtgbfVx6JpvApozwhQ ($5 in chips) 
Seat 8: 0b9BiwFeJrba87+xtIuQxg ($4.10 in chips) 
Seat 9: 86vbuhJsyH+nbEg5qpDLyQ ($24.65 in chips) 
lxVahNAs/pc3YeLt9PSgbg: posts small blind $0.10
sUVgUtgbfVx6JpvApozwhQ: posts big blind $0.25
*** HOLE CARDS ***
0b9BiwFeJrba87+xtIuQxg: calls $0.25
86vbuhJsyH+nbEg5qpDLyQ: folds 
GEZ4LFjiwTFoPklBgpSnlw: folds 
zDrucyjVn5aeekNEc3cJrA: folds 
56S3mA6Zs3pGR+0p0vUCtg: folds 
oKO7b50N6TzXbPBr/mcrUA: calls $0.25
MIVCHqCqqlke0Lb0z7glcw: folds 
lxVahNAs/pc3YeLt9PSgbg: calls $0.15
sUVgUtgbfVx6JpvApozwhQ: checks 
*** FLOP *** [6d 8h Ad]
lxVahNAs/pc3YeLt9PSgbg: checks 
sUVgUtgbfVx6JpvApozwhQ: checks 
0b9BiwFeJrba87+xtIuQxg: bets $3.85 and is all-in
oKO7b50N6TzXbPBr/mcrUA: calls $3.85
lxVahNAs/pc3YeLt9PSgbg: folds 
sUVgUtgbfVx6JpvApozwhQ: folds 
*** TURN *** [6d 8h Ad] [2d]
*** RIVER *** [6d 8h Ad 2d] [Qs]
*** SHOW DOWN ***
0b9BiwFeJrba87+xtIuQxg: shows [5d Ac] (a pair of Aces)
oKO7b50N6TzXbPBr/mcrUA: mucks hand 
0b9BiwFeJrba87+xtIuQxg collected $8.30 from pot
*** SUMMARY ***
Total pot $8.70 | Rake $0.40 
Board [6d 8h Ad 2d Qs]
Seat 1: GEZ4LFjiwTFoPklBgpSnlw folded before Flop (didn't bet)
Seat 2: zDrucyjVn5aeekNEc3cJrA folded before Flop (didn't bet)
Seat 3: 56S3mA6Zs3pGR+0p0vUCtg folded before Flop (didn't bet)
Seat 4: oKO7b50N6TzXbPBr/mcrUA mucked
Seat 5: MIVCHqCqqlke0Lb0z7glcw (button) folded before Flop (didn't bet)
Seat 6: lxVahNAs/pc3YeLt9PSgbg (small blind) folded on the Flop
Seat 7: sUVgUtgbfVx6JpvApozwhQ (big blind) folded on the Flop
Seat 8: 0b9BiwFeJrba87+xtIuQxg showed [5d Ac] and won ($8.30) with a pair of Aces
Seat 9: 86vbuhJsyH+nbEg5qpDLyQ folded before Flop (didn't bet)




PokerStars Game #59939355188:  Hold'em No Limit ($0.10/$0.25) - 2009/07/01 0:37:45 ET
Table '1zj0+miaIL9cvwnT/50pOA' 9-max Seat #7 is the button
Seat 1: spidnpwmoJ1L6yeNW7D5UA ($27.10 in chips) 
Seat 2: HPEB+AtKw1+C/cxU0o1ciw ($28.45 in chips) 
Seat 3: CYkY0dNBaYaKs8HVCVn3mQ ($5.85 in chips) 
Seat 4: 6esz1u5YivjsX0UoeMBm3w ($17.90 in chips) 
Seat 5: JxpnpCmvRAcrEUy7mq1iAg ($5.70 in chips) 
Seat 6: ydoFOVgzvZv9ZhuWu9rXAw ($4.80 in chips) 
Seat 7: 6oWOdVz2WG2azNuOj9rMgg ($16.45 in chips) 
Seat 8: HOiu48bZMhEZSoJa8mjiMw ($35.65 in chips) 
Seat 9: OiV1PWZ3IkN29JlmCcnTwQ ($5.25 in chips) 
HOiu48bZMhEZSoJa8mjiMw: posts small blind $0.10
OiV1PWZ3IkN29JlmCcnTwQ: posts big blind $0.25
*** HOLE CARDS ***
spidnpwmoJ1L6yeNW7D5UA: folds 
HPEB+AtKw1+C/cxU0o1ciw: folds 
CYkY0dNBaYaKs8HVCVn3mQ: folds 
6esz1u5YivjsX0UoeMBm3w: folds 
JxpnpCmvRAcrEUy7mq1iAg: folds 
ydoFOVgzvZv9ZhuWu9rXAw: folds 
6oWOdVz2WG2azNuOj9rMgg: folds 
HOiu48bZMhEZSoJa8mjiMw: folds 
Uncalled bet ($0.15) returned to OiV1PWZ3IkN29JlmCcnTwQ
OiV1PWZ3IkN29JlmCcnTwQ collected $0.20 from pot
OiV1PWZ3IkN29JlmCcnTwQ: doesn't show hand 
*** SUMMARY ***
Total pot $0.20 | Rake $0 
Seat 1: spidnpwmoJ1L6yeNW7D5UA folded before Flop (didn't bet)
Seat 2: HPEB+AtKw1+C/cxU0o1ciw folded before Flop (didn't bet)
Seat 3: CYkY0dNBaYaKs8HVCVn3mQ folded before Flop (didn't bet)
Seat 4: 6esz1u5YivjsX0UoeMBm3w folded before Flop (didn't bet)
Seat 5: JxpnpCmvRAcrEUy7mq1iAg folded before Flop (didn't bet)
Seat 6: ydoFOVgzvZv9ZhuWu9rXAw folded before Flop (didn't bet)
Seat 7: 6oWOdVz2WG2azNuOj9rMgg (button) folded before Flop (didn't bet)
Seat 8: HOiu48bZMhEZSoJa8mjiMw (small blind) folded before Flop
Seat 9: OiV1PWZ3IkN29JlmCcnTwQ (big blind) collected ($0.20)




PokerStars Game #59939355636:  Hold'em No Limit ($0.10/$0.25) - 2009/07/01 0:37:45 ET
Table '1HT8bEDpLPhOXxmqMtzF8w' 9-max Seat #1 is the button
Seat 1: s7Q6uNouhe7aE8JdFb9E+A ($26.20 in chips) 
Seat 2: r6hsffOo1iKmaPYKwAZmFw ($28.75 in chips) 
Seat 3: UJbH2fMMSFUo/jbJteWjjQ ($5.10 in chips) 
Seat 4: Hlc+zGHlRwk7JHfQklkT2g ($8.55 in chips) 
Seat 5: +iRmxp/CsJ/zuqdUG3CXNw ($6.70 in chips) 
Seat 6: 4oA316mXLIui1QY63GXBUg ($25 in chips) 
Seat 7: DIBbjEYGs+TVdVgEB/4+3w ($30.60 in chips) 
Seat 8: ghNKXUBl/H+t83JF079ZBA ($25 in chips) 
Seat 9: 86vbuhJsyH+nbEg5qpDLyQ ($24.40 in chips) 
r6hsffOo1iKmaPYKwAZmFw: posts small blind $0.10
UJbH2fMMSFUo/jbJteWjjQ: posts big blind $0.25
*** HOLE CARDS ***
Hlc+zGHlRwk7JHfQklkT2g: calls $0.25
+iRmxp/CsJ/zuqdUG3CXNw: folds 
4oA316mXLIui1QY63GXBUg: folds 
DIBbjEYGs+TVdVgEB/4+3w: folds 
ghNKXUBl/H+t83JF079ZBA: folds 
86vbuhJsyH+nbEg5qpDLyQ: raises $0.75 to $1
s7Q6uNouhe7aE8JdFb9E+A: folds 
r6hsffOo1iKmaPYKwAZmFw: raises $2.25 to $3.25
UJbH2fMMSFUo/jbJteWjjQ: folds 
Hlc+zGHlRwk7JHfQklkT2g: folds 
86vbuhJsyH+nbEg5qpDLyQ: calls $2.25
*** FLOP *** [Ks 6s 7d]
r6hsffOo1iKmaPYKwAZmFw: bets $4
86vbuhJsyH+nbEg5qpDLyQ: folds 
Uncalled bet ($4) returned to r6hsffOo1iKmaPYKwAZmFw
r6hsffOo1iKmaPYKwAZmFw collected $6.65 from pot
r6hsffOo1iKmaPYKwAZmFw: doesn't show hand 
*** SUMMARY ***
Total pot $7 | Rake $0.35 
Board [Ks 6s 7d]
Seat 1: s7Q6uNouhe7aE8JdFb9E+A (button) folded before Flop (didn't bet)
Seat 2: r6hsffOo1iKmaPYKwAZmFw (small blind) collected ($6.65)
Seat 3: UJbH2fMMSFUo/jbJteWjjQ (big blind) folded before Flop
Seat 4: Hlc+zGHlRwk7JHfQklkT2g folded before Flop
Seat 5: +iRmxp/CsJ/zuqdUG3CXNw folded before Flop (didn't bet)
Seat 6: 4oA316mXLIui1QY63GXBUg folded before Flop (didn't bet)
Seat 7: DIBbjEYGs+TVdVgEB/4+3w folded before Flop (didn't bet)
Seat 8: ghNKXUBl/H+t83JF079ZBA folded before Flop (didn't bet)
Seat 9: 86vbuhJsyH+nbEg5qpDLyQ folded on the Flop




PokerStars Game #59939355436:  Hold'em No Limit ($0.10/$0.25) - 2009/07/01 0:37:45 ET
Table 'YlRA05h9BJ1EhOUSNUjJdg' 9-max Seat #5 is the button
Seat 2: Y2GFAe+PT7xnUUtgqCNDFw ($15.15 in chips) 
Seat 3: C91Mv1usdi9Vq9ljlQVsug ($54.55 in chips) 
Seat 4: HPEB+AtKw1+C/cxU0o1ciw ($30.70 in chips) 
Seat 5: oKO7b50N6TzXbPBr/mcrUA ($24.05 in chips) 
Seat 6: GMMsoUkaAAY5/vm1Kmh9pA ($16.20 in chips) 
Seat 7: oVDuzcEt1umAPOB/u6ZH9g ($26.70 in chips) 
Seat 8: j4q3p0lesp63b1gZDwLBZw ($5 in chips) 
Seat 9: hBMUlEpyU74r/fwDgIpXjQ ($25 in chips) 
GMMsoUkaAAY5/vm1Kmh9pA: posts small blind $0.10
oVDuzcEt1umAPOB/u6ZH9g: posts big blind $0.25
*** HOLE CARDS ***
j4q3p0lesp63b1gZDwLBZw: folds 
hBMUlEpyU74r/fwDgIpXjQ: folds 
Y2GFAe+PT7xnUUtgqCNDFw: calls $0.25
5gHh6iDvZdEvYi59Pko1iA joins the table at seat #1 
C91Mv1usdi9Vq9ljlQVsug: calls $0.25
HPEB+AtKw1+C/cxU0o1ciw: folds 
oKO7b50N6TzXbPBr/mcrUA: folds 
GMMsoUkaAAY5/vm1Kmh9pA: calls $0.15
oVDuzcEt1umAPOB/u6ZH9g: checks 
*** FLOP *** [3s As Kd]
GMMsoUkaAAY5/vm1Kmh9pA: checks 
oVDuzcEt1umAPOB/u6ZH9g: bets $0.50
Y2GFAe+PT7xnUUtgqCNDFw: raises $0.50 to $1
C91Mv1usdi9Vq9ljlQVsug: folds 
GMMsoUkaAAY5/vm1Kmh9pA: folds 
oVDuzcEt1umAPOB/u6ZH9g: calls $0.50
*** TURN *** [3s As Kd] [Ac]
oVDuzcEt1umAPOB/u6ZH9g: checks 
Y2GFAe+PT7xnUUtgqCNDFw: checks 
*** RIVER *** [3s As Kd Ac] [9s]
oVDuzcEt1umAPOB/u6ZH9g: checks 
Y2GFAe+PT7xnUUtgqCNDFw: bets $1
oVDuzcEt1umAPOB/u6ZH9g: folds 
Uncalled bet ($1) returned to Y2GFAe+PT7xnUUtgqCNDFw
Y2GFAe+PT7xnUUtgqCNDFw collected $2.90 from pot
Y2GFAe+PT7xnUUtgqCNDFw: doesn't show hand 
*** SUMMARY ***
Total pot $3 | Rake $0.10 
Board [3s As Kd Ac 9s]
Seat 2: Y2GFAe+PT7xnUUtgqCNDFw collected ($2.90)
Seat 3: C91Mv1usdi9Vq9ljlQVsug folded on the Flop
Seat 4: HPEB+AtKw1+C/cxU0o1ciw folded before Flop (didn't bet)
Seat 5: oKO7b50N6TzXbPBr/mcrUA (button) folded before Flop (didn't bet)
Seat 6: GMMsoUkaAAY5/vm1Kmh9pA (small blind) folded on the Flop
Seat 7: oVDuzcEt1umAPOB/u6ZH9g (big blind) folded on the River
Seat 8: j4q3p0lesp63b1gZDwLBZw folded before Flop (didn't bet)
Seat 9: hBMUlEpyU74r/fwDgIpXjQ folded before Flop (didn't bet)




PokerStars Game #59939355478:  Hold'em No Limit ($0.10/$0.25) - 2009/07/01 0:37:45 ET
Table '8TQqiBvztdoBMTFQQ4MYSA' 9-max Seat #4 is the button
Seat 1: LWN1wPrLH+695JIriXxDuw ($22.85 in chips) 
Seat 2: amD2PwT1xB7aC2k57sa7Ig ($22.70 in chips) 
Seat 3: DIBbjEYGs+TVdVgEB/4+3w ($25.40 in chips) 
Seat 4: EUMLvzDkECHBit+xa+uGjg ($14.95 in chips) 
Seat 5: vZGoOTJLQLhkPj4I+LNGig ($25 in chips) 
Seat 6: MIVCHqCqqlke0Lb0z7glcw ($37.95 in chips) 
Seat 8: 33a0y3nYwUhzkf9PNzg4/Q ($6.10 in chips) 
Seat 9: SXqVW4Q0evTUVZG6BbUNIA ($42.20 in chips) 
vZGoOTJLQLhkPj4I+LNGig: posts small blind $0.10
MIVCHqCqqlke0Lb0z7glcw: posts big blind $0.25
STkR8XvpjNv79OOMhrlh2w: sits out 
*** HOLE CARDS ***
33a0y3nYwUhzkf9PNzg4/Q: calls $0.25
SXqVW4Q0evTUVZG6BbUNIA: folds 
LWN1wPrLH+695JIriXxDuw: folds 
amD2PwT1xB7aC2k57sa7Ig: folds 
DIBbjEYGs+TVdVgEB/4+3w: calls $0.25
EUMLvzDkECHBit+xa+uGjg: calls $0.25
vZGoOTJLQLhkPj4I+LNGig: calls $0.15
MIVCHqCqqlke0Lb0z7glcw: checks 
*** FLOP *** [3h Jd 6d]
vZGoOTJLQLhkPj4I+LNGig: checks 
MIVCHqCqqlke0Lb0z7glcw: checks 
33a0y3nYwUhzkf9PNzg4/Q: checks 
DIBbjEYGs+TVdVgEB/4+3w: checks 
EUMLvzDkECHBit+xa+uGjg: checks 
*** TURN *** [3h Jd 6d] [8c]
vZGoOTJLQLhkPj4I+LNGig: checks 
MIVCHqCqqlke0Lb0z7glcw: checks 
33a0y3nYwUhzkf9PNzg4/Q: bets $0.25
DIBbjEYGs+TVdVgEB/4+3w: folds 
EUMLvzDkECHBit+xa+uGjg: calls $0.25
vZGoOTJLQLhkPj4I+LNGig: folds 
MIVCHqCqqlke0Lb0z7glcw: folds 
*** RIVER *** [3h Jd 6d 8c] [Qs]
33a0y3nYwUhzkf9PNzg4/Q: bets $0.50
EUMLvzDkECHBit+xa+uGjg: folds 
Uncalled bet ($0.50) returned to 33a0y3nYwUhzkf9PNzg4/Q
33a0y3nYwUhzkf9PNzg4/Q collected $1.70 from pot
33a0y3nYwUhzkf9PNzg4/Q: doesn't show hand 
*** SUMMARY ***
Total pot $1.75 | Rake $0.05 
Board [3h Jd 6d 8c Qs]
Seat 1: LWN1wPrLH+695JIriXxDuw folded before Flop (didn't bet)
Seat 2: amD2PwT1xB7aC2k57sa7Ig folded before Flop (didn't bet)
Seat 3: DIBbjEYGs+TVdVgEB/4+3w folded on the Turn
Seat 4: EUMLvzDkECHBit+xa+uGjg (button) folded on the River
Seat 5: vZGoOTJLQLhkPj4I+LNGig (small blind) folded on the Turn
Seat 6: MIVCHqCqqlke0Lb0z7glcw (big blind) folded on the Turn
Seat 8: 33a0y3nYwUhzkf9PNzg4/Q collected ($1.70)
Seat 9: SXqVW4Q0evTUVZG6BbUNIA folded before Flop (didn't bet)




PokerStars Game #59939355164:  Hold'em No Limit ($0.10/$0.25) - 2009/07/01 0:37:45 ET
Table 'isKy4XK8wJM0x735/D4hWA' 6-max Seat #5 is the button
Seat 1: 7FmwVDcdEtxDpHmP4hOXsQ ($26.20 in chips) 
Seat 3: 8ClCHtFXGNplITm+63KB+Q ($24.65 in chips) 
Seat 5: zlYHXTtJ5tcx9kwK2h5n9A ($19.70 in chips) 
Seat 6: M6xK/VklCvdyyrmvzATlxQ ($13.25 in chips) 
M6xK/VklCvdyyrmvzATlxQ: posts small blind $0.10
7FmwVDcdEtxDpHmP4hOXsQ: posts big blind $0.25
*** HOLE CARDS ***
8ClCHtFXGNplITm+63KB+Q: folds 
zlYHXTtJ5tcx9kwK2h5n9A: folds 
M6xK/VklCvdyyrmvzATlxQ: raises $0.50 to $0.75
7FmwVDcdEtxDpHmP4hOXsQ: folds 
Uncalled bet ($0.50) returned to M6xK/VklCvdyyrmvzATlxQ
M6xK/VklCvdyyrmvzATlxQ collected $0.50 from pot
*** SUMMARY ***
Total pot $0.50 | Rake $0 
Seat 1: 7FmwVDcdEtxDpHmP4hOXsQ (big blind) folded before Flop
Seat 3: 8ClCHtFXGNplITm+63KB+Q folded before Flop (didn't bet)
Seat 5: zlYHXTtJ5tcx9kwK2h5n9A (button) folded before Flop (didn't bet)
Seat 6: M6xK/VklCvdyyrmvzATlxQ (small blind) collected ($0.50)




PokerStars Game #59939355620:  Hold'em No Limit ($0.10/$0.25) - 2009/07/01 0:37:45 ET
Table 'v+LTGPWbrLum+Ggd4ef6lg' 9-max Seat #9 is the button
Seat 4: gGaFLzGESKP3Tj9N/K7QNA ($18.30 in chips) 
Seat 5: eJDZmZbsxdLJcAv2PolkwA ($15 in chips) 
Seat 7: YEdelvffSYRP4EDNfFp4dA ($14.10 in chips) 
Seat 8: +sbyWwIcFp9kP0bDtMegfQ ($28.65 in chips) 
Seat 9: cFmpjvcjNoVAEAIQIxWkYg ($25 in chips) 
gGaFLzGESKP3Tj9N/K7QNA: posts small blind $0.10
eJDZmZbsxdLJcAv2PolkwA: posts big blind $0.25
*** HOLE CARDS ***
YEdelvffSYRP4EDNfFp4dA: calls $0.25
+sbyWwIcFp9kP0bDtMegfQ: folds 
cFmpjvcjNoVAEAIQIxWkYg: calls $0.25
gGaFLzGESKP3Tj9N/K7QNA: calls $0.15
eJDZmZbsxdLJcAv2PolkwA: checks 
*** FLOP *** [Ah 7h Ts]
gGaFLzGESKP3Tj9N/K7QNA: bets $0.25
Lefty1794 leaves the table
MIVCHqCqqlke0Lb0z7glcw joins the table at seat #1 
eJDZmZbsxdLJcAv2PolkwA: folds 
YEdelvffSYRP4EDNfFp4dA: calls $0.25
cFmpjvcjNoVAEAIQIxWkYg: calls $0.25
*** TURN *** [Ah 7h Ts] [Jh]
gGaFLzGESKP3Tj9N/K7QNA: checks 
YEdelvffSYRP4EDNfFp4dA: checks 
cFmpjvcjNoVAEAIQIxWkYg: checks 
*** RIVER *** [Ah 7h Ts Jh] [Qc]
gGaFLzGESKP3Tj9N/K7QNA: bets $0.75
YEdelvffSYRP4EDNfFp4dA: folds 
cFmpjvcjNoVAEAIQIxWkYg: folds 
Uncalled bet ($0.75) returned to gGaFLzGESKP3Tj9N/K7QNA
gGaFLzGESKP3Tj9N/K7QNA collected $1.70 from pot
*** SUMMARY ***
Total pot $1.75 | Rake $0.05 
Board [Ah 7h Ts Jh Qc]
Seat 4: gGaFLzGESKP3Tj9N/K7QNA (small blind) collected ($1.70)
Seat 5: eJDZmZbsxdLJcAv2PolkwA (big blind) folded on the Flop
Seat 7: YEdelvffSYRP4EDNfFp4dA folded on the River
Seat 8: +sbyWwIcFp9kP0bDtMegfQ folded before Flop (didn't bet)
Seat 9: cFmpjvcjNoVAEAIQIxWkYg (button) folded on the River




PokerStars Game #59939355802:  Hold'em No Limit ($0.10/$0.25) - 2009/07/01 0:37:46 ET
Table 'LXz5SsUCyWcm+4JDJh466A' 9-max Seat #7 is the button
Seat 1: MG90wfSJZnOejs/KD3vlQQ ($23.60 in chips) 
Seat 2: H5Se03ZqSX7tbULXur2MAg ($23.55 in chips) 
Seat 5: OiV1PWZ3IkN29JlmCcnTwQ ($5.10 in chips) 
Seat 6: opOCI2p6kW0tINuVaAqmcQ ($25 in chips) 
Seat 7: EnNp9cILTCYQ95g+8MNFGw ($29.75 in chips) 
Seat 8: VlJdQJbqyBs3oxP5BIw7jA ($96.05 in chips) 
Seat 9: 2N94FgK4Y2izKFIB+wJOjw ($11.25 in chips) 
VlJdQJbqyBs3oxP5BIw7jA: posts small blind $0.10
2N94FgK4Y2izKFIB+wJOjw: posts big blind $0.25
diablo4good: sits out 
*** HOLE CARDS ***
MG90wfSJZnOejs/KD3vlQQ: folds 
H5Se03ZqSX7tbULXur2MAg: raises $0.50 to $0.75
OiV1PWZ3IkN29JlmCcnTwQ: folds 
opOCI2p6kW0tINuVaAqmcQ: folds 
EnNp9cILTCYQ95g+8MNFGw: folds 
VlJdQJbqyBs3oxP5BIw7jA: calls $0.65
2N94FgK4Y2izKFIB+wJOjw: folds 
*** FLOP *** [Ad 2d 9s]
VlJdQJbqyBs3oxP5BIw7jA: checks 
H5Se03ZqSX7tbULXur2MAg: bets $1.25
VlJdQJbqyBs3oxP5BIw7jA: folds 
Uncalled bet ($1.25) returned to H5Se03ZqSX7tbULXur2MAg
H5Se03ZqSX7tbULXur2MAg collected $1.70 from pot
*** SUMMARY ***
Total pot $1.75 | Rake $0.05 
Board [Ad 2d 9s]
Seat 1: MG90wfSJZnOejs/KD3vlQQ folded before Flop (didn't bet)
Seat 2: H5Se03ZqSX7tbULXur2MAg collected ($1.70)
Seat 5: OiV1PWZ3IkN29JlmCcnTwQ folded before Flop (didn't bet)
Seat 6: opOCI2p6kW0tINuVaAqmcQ folded before Flop (didn't bet)
Seat 7: EnNp9cILTCYQ95g+8MNFGw (button) folded before Flop (didn't bet)
Seat 8: VlJdQJbqyBs3oxP5BIw7jA (small blind) folded on the Flop
Seat 9: 2N94FgK4Y2izKFIB+wJOjw (big blind) folded before Flop




PokerStars Game #59939356360:  Hold'em No Limit ($0.10/$0.25) - 2009/07/01 0:37:46 ET
Table 'GxdLtCpYxqT4aAbYqkEEpw' 6-max Seat #1 is the button
Seat 1: heEf/FkFGS9M1NmwH97YIA ($41.25 in chips) 
Seat 2: hADMNbkECXMb2C/C8R2Wlw ($22.90 in chips) 
Seat 3: 9jSiy0meE9XJKkdIZwyTEQ ($33.90 in chips) 
Seat 4: ErIN0JRL5srYjT6en1f8YQ ($24.55 in chips) 
Seat 5: q6WfTUAD9mowIP63ASq2Dg ($41.10 in chips) 
Seat 6: aogAb4Eienxztk8p2v9VVw ($26.75 in chips) 
hADMNbkECXMb2C/C8R2Wlw: posts small blind $0.10
9jSiy0meE9XJKkdIZwyTEQ: posts big blind $0.25
*** HOLE CARDS ***
ErIN0JRL5srYjT6en1f8YQ: folds 
q6WfTUAD9mowIP63ASq2Dg: folds 
aogAb4Eienxztk8p2v9VVw: folds 
heEf/FkFGS9M1NmwH97YIA: raises $0.25 to $0.50
hADMNbkECXMb2C/C8R2Wlw: folds 
9jSiy0meE9XJKkdIZwyTEQ: folds 
Uncalled bet ($0.25) returned to heEf/FkFGS9M1NmwH97YIA
heEf/FkFGS9M1NmwH97YIA collected $0.60 from pot
heEf/FkFGS9M1NmwH97YIA: doesn't show hand 
*** SUMMARY ***
Total pot $0.60 | Rake $0 
Seat 1: heEf/FkFGS9M1NmwH97YIA (button) collected ($0.60)
Seat 2: hADMNbkECXMb2C/C8R2Wlw (small blind) folded before Flop
Seat 3: 9jSiy0meE9XJKkdIZwyTEQ (big blind) folded before Flop
Seat 4: ErIN0JRL5srYjT6en1f8YQ folded before Flop (didn't bet)
Seat 5: q6WfTUAD9mowIP63ASq2Dg folded before Flop (didn't bet)
Seat 6: aogAb4Eienxztk8p2v9VVw folded before Flop (didn't bet)




PokerStars Game #59939356372:  Hold'em No Limit ($0.10/$0.25) - 2009/07/01 0:37:46 ET
Table 'B3/JTS7usG3rxMfTbMiZuw' 6-max Seat #1 is the button
Seat 1: wAKC8C/zN0c8V5v13dm9mA ($29.90 in chips) 
Seat 2: 2gqWqkOq59pvtJKe4nS+rw ($37 in chips) 
Seat 3: PbMzPZIePKifKQZfKDkbIw ($25 in chips) 
Seat 4: kPCKvyB1yAABEgvF7OaG0g ($22.40 in chips) 
Seat 5: NhUN/JpAprdJeamFBgJH1w ($26.50 in chips) 
Seat 6: AGMIbXefZrMZ8QjfyCknDw ($10.10 in chips) 
2gqWqkOq59pvtJKe4nS+rw: posts small blind $0.10
PbMzPZIePKifKQZfKDkbIw: posts big blind $0.25
*** HOLE CARDS ***
kPCKvyB1yAABEgvF7OaG0g: calls $0.25
NhUN/JpAprdJeamFBgJH1w: folds 
AGMIbXefZrMZ8QjfyCknDw: raises $0.75 to $1
wAKC8C/zN0c8V5v13dm9mA: folds 
2gqWqkOq59pvtJKe4nS+rw: raises $2.35 to $3.35
PbMzPZIePKifKQZfKDkbIw: folds 
kPCKvyB1yAABEgvF7OaG0g: folds 
AGMIbXefZrMZ8QjfyCknDw: raises $6.75 to $10.10 and is all-in
2gqWqkOq59pvtJKe4nS+rw: calls $6.75
*** FLOP *** [3h Qc 6c]
*** TURN *** [3h Qc 6c] [2c]
*** RIVER *** [3h Qc 6c 2c] [Ac]
*** SHOW DOWN ***
2gqWqkOq59pvtJKe4nS+rw: shows [Qh Qd] (three of a kind, Queens)
AGMIbXefZrMZ8QjfyCknDw: shows [Kc Kh] (a flush, Ace high)
AGMIbXefZrMZ8QjfyCknDw collected $19.70 from pot
2gqWqkOq59pvtJKe4nS+rw said, "eewwwwwwwwwwwwww"
*** SUMMARY ***
Total pot $20.70 | Rake $1 
Board [3h Qc 6c 2c Ac]
Seat 1: wAKC8C/zN0c8V5v13dm9mA (button) folded before Flop (didn't bet)
Seat 2: 2gqWqkOq59pvtJKe4nS+rw (small blind) showed [Qh Qd] and lost with three of a kind, Queens
Seat 3: PbMzPZIePKifKQZfKDkbIw (big blind) folded before Flop
Seat 4: kPCKvyB1yAABEgvF7OaG0g folded before Flop
Seat 5: NhUN/JpAprdJeamFBgJH1w folded before Flop (didn't bet)
Seat 6: AGMIbXefZrMZ8QjfyCknDw showed [Kc Kh] and won ($19.70) with a flush, Ace high




PokerStars Game #59939356308:  Hold'em No Limit ($0.10/$0.25) - 2009/07/01 0:37:46 ET
Table '5SUMWYuPsGiOD0FY0QbgOw' 6-max Seat #4 is the button
Seat 1: pq78iqNUnoL9mPwPKXxOzg ($14.65 in chips) 
Seat 2: wKFJ513ucluNNiMlkXcDOQ ($27.30 in chips) 
Seat 3: JUE7yMMP0aN5jzhYbdqO6Q ($27.90 in chips) 
Seat 4: hln5cQA1YXs/ERC2LEyoSA ($15.50 in chips) 
Seat 5: v+QfkGiuj9bgtuNoVnDO8w ($27.30 in chips) 
Seat 6: jA7YMtfNUnAaebB7Lj74EA ($22.50 in chips) 
v+QfkGiuj9bgtuNoVnDO8w: posts small blind $0.10
jA7YMtfNUnAaebB7Lj74EA: posts big blind $0.25
*** HOLE CARDS ***
pq78iqNUnoL9mPwPKXxOzg: folds 
wKFJ513ucluNNiMlkXcDOQ: raises $0.75 to $1
JUE7yMMP0aN5jzhYbdqO6Q: folds 
hln5cQA1YXs/ERC2LEyoSA: calls $1
v+QfkGiuj9bgtuNoVnDO8w: folds 
jA7YMtfNUnAaebB7Lj74EA: raises $1 to $2
wKFJ513ucluNNiMlkXcDOQ: calls $1
hln5cQA1YXs/ERC2LEyoSA: calls $1
*** FLOP *** [3d 6s 3s]
jA7YMtfNUnAaebB7Lj74EA: bets $1.50
wKFJ513ucluNNiMlkXcDOQ: folds 
hln5cQA1YXs/ERC2LEyoSA: calls $1.50
*** TURN *** [3d 6s 3s] [Kc]
jA7YMtfNUnAaebB7Lj74EA: bets $2.50
hln5cQA1YXs/ERC2LEyoSA: calls $2.50
*** RIVER *** [3d 6s 3s Kc] [Ad]
jA7YMtfNUnAaebB7Lj74EA: bets $9.50
hln5cQA1YXs/ERC2LEyoSA: folds 
Uncalled bet ($9.50) returned to jA7YMtfNUnAaebB7Lj74EA
jA7YMtfNUnAaebB7Lj74EA collected $13.45 from pot
*** SUMMARY ***
Total pot $14.10 | Rake $0.65 
Board [3d 6s 3s Kc Ad]
Seat 1: pq78iqNUnoL9mPwPKXxOzg folded before Flop (didn't bet)
Seat 2: wKFJ513ucluNNiMlkXcDOQ folded on the Flop
Seat 3: JUE7yMMP0aN5jzhYbdqO6Q folded before Flop (didn't bet)
Seat 4: hln5cQA1YXs/ERC2LEyoSA (button) folded on the River
Seat 5: v+QfkGiuj9bgtuNoVnDO8w (small blind) folded before Flop
Seat 6: jA7YMtfNUnAaebB7Lj74EA (big blind) collected ($13.45)




PokerStars Game #59939355962:  Hold'em No Limit ($0.10/$0.25) - 2009/07/01 0:37:46 ET
Table 'djcjiEGabFQO0MNG6jEeJQ' 9-max Seat #7 is the button
Seat 1: K7bAhhMMJ/XcTmGaBZVfFQ ($23.80 in chips) 
Seat 2: 1K6QGyJP9P9xmRac2fH4OQ ($26.60 in chips) 
Seat 3: 1S/fpm+f42V/6MNZre+ccg ($27 in chips) 
Seat 4: Z7GF1yA2ZTKm8gR4H8XDhg ($15.80 in chips) 
Seat 5: cZ99hugmLBj9KhTlc8nCSw ($37.15 in chips) 
Seat 6: aNpwfA31EREwO+ar4XzBCw ($59.55 in chips) 
Seat 7: 56S3mA6Zs3pGR+0p0vUCtg ($30.45 in chips) 
Seat 8: +sbyWwIcFp9kP0bDtMegfQ ($45.45 in chips) 
Seat 9: HPEB+AtKw1+C/cxU0o1ciw ($48 in chips) 
+sbyWwIcFp9kP0bDtMegfQ: posts small blind $0.10
HPEB+AtKw1+C/cxU0o1ciw: posts big blind $0.25
*** HOLE CARDS ***
K7bAhhMMJ/XcTmGaBZVfFQ: folds 
1K6QGyJP9P9xmRac2fH4OQ: folds 
1S/fpm+f42V/6MNZre+ccg: raises $0.50 to $0.75
Z7GF1yA2ZTKm8gR4H8XDhg: folds 
cZ99hugmLBj9KhTlc8nCSw: folds 
aNpwfA31EREwO+ar4XzBCw: folds 
56S3mA6Zs3pGR+0p0vUCtg: folds 
+sbyWwIcFp9kP0bDtMegfQ: folds 
HPEB+AtKw1+C/cxU0o1ciw: folds 
Uncalled bet ($0.50) returned to 1S/fpm+f42V/6MNZre+ccg
1S/fpm+f42V/6MNZre+ccg collected $0.60 from pot
1S/fpm+f42V/6MNZre+ccg: doesn't show hand 
*** SUMMARY ***
Total pot $0.60 | Rake $0 
Seat 1: K7bAhhMMJ/XcTmGaBZVfFQ folded before Flop (didn't bet)
Seat 2: 1K6QGyJP9P9xmRac2fH4OQ folded before Flop (didn't bet)
Seat 3: 1S/fpm+f42V/6MNZre+ccg collected ($0.60)
Seat 4: Z7GF1yA2ZTKm8gR4H8XDhg folded before Flop (didn't bet)
Seat 5: cZ99hugmLBj9KhTlc8nCSw folded before Flop (didn't bet)
Seat 6: aNpwfA31EREwO+ar4XzBCw folded before Flop (didn't bet)
Seat 7: 56S3mA6Zs3pGR+0p0vUCtg (button) folded before Flop (didn't bet)
Seat 8: +sbyWwIcFp9kP0bDtMegfQ (small blind) folded before Flop
Seat 9: HPEB+AtKw1+C/cxU0o1ciw (big blind) folded before Flop




PokerStars Game #59939356552:  Hold'em No Limit ($0.10/$0.25) - 2009/07/01 0:37:47 ET
Table 'KKk6y4pAXeymxYcd0uZLqg' 9-max Seat #7 is the button
Seat 1: HPEB+AtKw1+C/cxU0o1ciw ($24.90 in chips) 
Seat 2: H9KUl8cmpLgEpOVDA00bCg ($6.95 in chips) 
Seat 3: 4oA316mXLIui1QY63GXBUg ($25 in chips) 
Seat 4: GTcLfsDTPqgfHyhY9FNDMw ($14.45 in chips) 
Seat 5: U0VVxBdRWdhRNdbJ+Qky1A ($46.10 in chips) 
Seat 6: LWN1wPrLH+695JIriXxDuw ($11.85 in chips) 
Seat 7: R3KkgiqTvuhazyCqaD9cZg ($10 in chips) 
Seat 8: +2kMBNpY4nF1qNCRd8SJLA ($25 in chips) 
Seat 9: j4q3p0lesp63b1gZDwLBZw ($5.25 in chips) 
+2kMBNpY4nF1qNCRd8SJLA: posts small blind $0.10
j4q3p0lesp63b1gZDwLBZw: posts big blind $0.25
*** HOLE CARDS ***
HPEB+AtKw1+C/cxU0o1ciw: folds 
H9KUl8cmpLgEpOVDA00bCg: folds 
4oA316mXLIui1QY63GXBUg: folds 
GTcLfsDTPqgfHyhY9FNDMw: folds 
U0VVxBdRWdhRNdbJ+Qky1A: folds 
LWN1wPrLH+695JIriXxDuw: folds 
R3KkgiqTvuhazyCqaD9cZg: calls $0.25
+2kMBNpY4nF1qNCRd8SJLA: calls $0.15
j4q3p0lesp63b1gZDwLBZw: checks 
*** FLOP *** [3h 9s 8d]
+2kMBNpY4nF1qNCRd8SJLA: bets $0.50
j4q3p0lesp63b1gZDwLBZw: folds 
R3KkgiqTvuhazyCqaD9cZg: folds 
Uncalled bet ($0.50) returned to +2kMBNpY4nF1qNCRd8SJLA
+2kMBNpY4nF1qNCRd8SJLA collected $0.75 from pot
*** SUMMARY ***
Total pot $0.75 | Rake $0 
Board [3h 9s 8d]
Seat 1: HPEB+AtKw1+C/cxU0o1ciw folded before Flop (didn't bet)
Seat 2: H9KUl8cmpLgEpOVDA00bCg folded before Flop (didn't bet)
Seat 3: 4oA316mXLIui1QY63GXBUg folded before Flop (didn't bet)
Seat 4: GTcLfsDTPqgfHyhY9FNDMw folded before Flop (didn't bet)
Seat 5: U0VVxBdRWdhRNdbJ+Qky1A folded before Flop (didn't bet)
Seat 6: LWN1wPrLH+695JIriXxDuw folded before Flop (didn't bet)
Seat 7: R3KkgiqTvuhazyCqaD9cZg (button) folded on the Flop
Seat 8: +2kMBNpY4nF1qNCRd8SJLA (small blind) collected ($0.75)
Seat 9: j4q3p0lesp63b1gZDwLBZw (big blind) folded on the Flop




PokerStars Game #59939356600:  Hold'em No Limit ($0.10/$0.25) - 2009/07/01 0:37:47 ET
Table 'MQJMxKDF6VYBWIKv7VfCog' 9-max Seat #2 is the button
Seat 1: cZ99hugmLBj9KhTlc8nCSw ($25.80 in chips) 
Seat 2: JxpnpCmvRAcrEUy7mq1iAg ($5.20 in chips) 
Seat 3: EfRs3ibIxn+c9JDErwwNCg ($26.30 in chips) 
Seat 4: JtVGnq5doRa3PublncR+Yw ($23.75 in chips) 
Seat 5: RJ/x9oZtt1RZLaJEQwZOxQ ($25.95 in chips) 
Seat 6: ydoFOVgzvZv9ZhuWu9rXAw ($5 in chips) 
Seat 7: dfNim92Z6XK1/h5SFW5vDg ($55.30 in chips) 
Seat 8: Z9AeOQX3yzuSvKAm/xyovg ($9.65 in chips) 
Seat 9: 1S/fpm+f42V/6MNZre+ccg ($34.10 in chips) 
EfRs3ibIxn+c9JDErwwNCg: posts small blind $0.10
JtVGnq5doRa3PublncR+Yw: posts big blind $0.25
*** HOLE CARDS ***
RJ/x9oZtt1RZLaJEQwZOxQ: folds 
ydoFOVgzvZv9ZhuWu9rXAw: folds 
dfNim92Z6XK1/h5SFW5vDg: folds 
Z9AeOQX3yzuSvKAm/xyovg: folds 
1S/fpm+f42V/6MNZre+ccg: folds 
cZ99hugmLBj9KhTlc8nCSw: folds 
JxpnpCmvRAcrEUy7mq1iAg: folds 
EfRs3ibIxn+c9JDErwwNCg: calls $0.15
JtVGnq5doRa3PublncR+Yw: checks 
*** FLOP *** [5d 8d 2c]
EfRs3ibIxn+c9JDErwwNCg: checks 
JtVGnq5doRa3PublncR+Yw: bets $0.25
EfRs3ibIxn+c9JDErwwNCg: folds 
Uncalled bet ($0.25) returned to JtVGnq5doRa3PublncR+Yw
JtVGnq5doRa3PublncR+Yw collected $0.50 from pot
*** SUMMARY ***
Total pot $0.50 | Rake $0 
Board [5d 8d 2c]
Seat 1: cZ99hugmLBj9KhTlc8nCSw folded before Flop (didn't bet)
Seat 2: JxpnpCmvRAcrEUy7mq1iAg (button) folded before Flop (didn't bet)
Seat 3: EfRs3ibIxn+c9JDErwwNCg (small blind) folded on the Flop
Seat 4: JtVGnq5doRa3PublncR+Yw (big blind) collected ($0.50)
Seat 5: RJ/x9oZtt1RZLaJEQwZOxQ folded before Flop (didn't bet)
Seat 6: ydoFOVgzvZv9ZhuWu9rXAw folded before Flop (didn't bet)
Seat 7: dfNim92Z6XK1/h5SFW5vDg folded before Flop (didn't bet)
Seat 8: Z9AeOQX3yzuSvKAm/xyovg folded before Flop (didn't bet)
Seat 9: 1S/fpm+f42V/6MNZre+ccg folded before Flop (didn't bet)




PokerStars Game #59939356966:  Hold'em No Limit ($0.10/$0.25) - 2009/07/01 0:37:47 ET
Table 'sSe6q4YTb/iS19t2eCFdsA' 9-max Seat #2 is the button
Seat 1: 5z3YkZTfH2GjoLK+6X7z2w ($11.55 in chips) 
Seat 2: rUpvA02nErFvZ4yFbDR8XA ($28.35 in chips) 
Seat 3: hBMUlEpyU74r/fwDgIpXjQ ($26.30 in chips) 
Seat 4: SXqVW4Q0evTUVZG6BbUNIA ($16.20 in chips) 
Seat 5: qS+jfnNoG75bT+uQ8CKhQA ($7.95 in chips) 
Seat 6: tYsOBqdU1+x+yFI7zHO7hQ ($26.40 in chips) 
Seat 7: t70KGeRtR3naHSqKDixsUg ($12.55 in chips) 
Seat 8: jeKWRUkMaVn8rEUjnJKqpg ($29.65 in chips) 
Seat 9: 4oA316mXLIui1QY63GXBUg ($26.60 in chips) 
hBMUlEpyU74r/fwDgIpXjQ: posts small blind $0.10
SXqVW4Q0evTUVZG6BbUNIA: posts big blind $0.25
*** HOLE CARDS ***
qS+jfnNoG75bT+uQ8CKhQA: folds 
tYsOBqdU1+x+yFI7zHO7hQ: folds 
t70KGeRtR3naHSqKDixsUg: calls $0.25
jeKWRUkMaVn8rEUjnJKqpg: raises $0.75 to $1
4oA316mXLIui1QY63GXBUg: folds 
5z3YkZTfH2GjoLK+6X7z2w: folds 
rUpvA02nErFvZ4yFbDR8XA: folds 
hBMUlEpyU74r/fwDgIpXjQ: folds 
SXqVW4Q0evTUVZG6BbUNIA: folds 
t70KGeRtR3naHSqKDixsUg: calls $0.75
*** FLOP *** [7c Ks 8d]
t70KGeRtR3naHSqKDixsUg: checks 
jeKWRUkMaVn8rEUjnJKqpg: checks 
*** TURN *** [7c Ks 8d] [3s]
t70KGeRtR3naHSqKDixsUg: bets $0.25
jeKWRUkMaVn8rEUjnJKqpg: calls $0.25
*** RIVER *** [7c Ks 8d 3s] [6h]
t70KGeRtR3naHSqKDixsUg: checks 
jeKWRUkMaVn8rEUjnJKqpg: checks 
*** SHOW DOWN ***
t70KGeRtR3naHSqKDixsUg: shows [Tc 9c] (a straight, Six to Ten)
jeKWRUkMaVn8rEUjnJKqpg: mucks hand 
t70KGeRtR3naHSqKDixsUg collected $2.75 from pot
*** SUMMARY ***
Total pot $2.85 | Rake $0.10 
Board [7c Ks 8d 3s 6h]
Seat 1: 5z3YkZTfH2GjoLK+6X7z2w folded before Flop (didn't bet)
Seat 2: rUpvA02nErFvZ4yFbDR8XA (button) folded before Flop (didn't bet)
Seat 3: hBMUlEpyU74r/fwDgIpXjQ (small blind) folded before Flop
Seat 4: SXqVW4Q0evTUVZG6BbUNIA (big blind) folded before Flop
Seat 5: qS+jfnNoG75bT+uQ8CKhQA folded before Flop (didn't bet)
Seat 6: tYsOBqdU1+x+yFI7zHO7hQ folded before Flop (didn't bet)
Seat 7: t70KGeRtR3naHSqKDixsUg showed [Tc 9c] and won ($2.75) with a straight, Six to Ten
Seat 8: jeKWRUkMaVn8rEUjnJKqpg mucked
Seat 9: 4oA316mXLIui1QY63GXBUg folded before Flop (didn't bet)




PokerStars Game #59939356644:  Hold'em No Limit ($0.10/$0.25) - 2009/07/01 0:37:47 ET
Table 'IfRHUn9gQQA9I/Z4tn+BoA' 9-max Seat #1 is the button
Seat 1: vSkQm2EelzwRGDDQQk0Fqw ($4.65 in chips) 
Seat 2: zgWbKMp0/btzsnVbQWKXww ($16.40 in chips) 
Seat 3: iAQDnrJCZVD1LzAGxTYegw ($26.60 in chips) 
Seat 4: QEbIGci+itdw+re8RM5fZA ($25 in chips) 
Seat 5: 10584482 ($14.85 in chips) 
Seat 6: UOjoGGQ58/uDS7V0xkjOrQ ($8.55 in chips) 
Seat 7: TeWJxSETzbXGiYKx0y+dtg ($24.90 in chips) 
Seat 8: cZ99hugmLBj9KhTlc8nCSw ($25 in chips) 
zgWbKMp0/btzsnVbQWKXww: posts small blind $0.10
iAQDnrJCZVD1LzAGxTYegw: posts big blind $0.25
*** HOLE CARDS ***
QEbIGci+itdw+re8RM5fZA: folds 
10584482: folds 
UOjoGGQ58/uDS7V0xkjOrQ: calls $0.25
7cv+9Zc9HIQHNvYsMfV3uA joins the table at seat #9 
TeWJxSETzbXGiYKx0y+dtg: raises $1 to $1.25
cZ99hugmLBj9KhTlc8nCSw: folds 
vSkQm2EelzwRGDDQQk0Fqw: folds 
zgWbKMp0/btzsnVbQWKXww: folds 
iAQDnrJCZVD1LzAGxTYegw: folds 
UOjoGGQ58/uDS7V0xkjOrQ: folds 
Uncalled bet ($1) returned to TeWJxSETzbXGiYKx0y+dtg
TeWJxSETzbXGiYKx0y+dtg collected $0.85 from pot
TeWJxSETzbXGiYKx0y+dtg: doesn't show hand 
*** SUMMARY ***
Total pot $0.85 | Rake $0 
Seat 1: vSkQm2EelzwRGDDQQk0Fqw (button) folded before Flop (didn't bet)
Seat 2: zgWbKMp0/btzsnVbQWKXww (small blind) folded before Flop
Seat 3: iAQDnrJCZVD1LzAGxTYegw (big blind) folded before Flop
Seat 4: QEbIGci+itdw+re8RM5fZA folded before Flop (didn't bet)
Seat 5: 10584482 folded before Flop (didn't bet)
Seat 6: UOjoGGQ58/uDS7V0xkjOrQ folded before Flop
Seat 7: TeWJxSETzbXGiYKx0y+dtg collected ($0.85)
Seat 8: cZ99hugmLBj9KhTlc8nCSw folded before Flop (didn't bet)




PokerStars Game #59939356918:  Hold'em No Limit ($0.10/$0.25) - 2009/07/01 0:37:47 ET
Table '3KDMdm1sfxFsNKkjc/PnBg' 9-max Seat #3 is the button
Seat 2: rUpvA02nErFvZ4yFbDR8XA ($20.35 in chips) 
Seat 3: GftT+l+xjKzcY0rMiNZfPg ($28.05 in chips) 
Seat 4: 4xnojP+j2Tm8s9Bh7QC5+Q ($10.80 in chips) 
Seat 5: +2kMBNpY4nF1qNCRd8SJLA ($25 in chips) 
Seat 6: N1HHRe1nNMukTQB6qMn6Kw ($17.25 in chips) 
Seat 7: gehe91e0IyVT0QU/XBkEyg ($25 in chips) 
Seat 8: st9jtdNbm1W5GfBwRaCVqQ ($26.30 in chips) 
4xnojP+j2Tm8s9Bh7QC5+Q: posts small blind $0.10
+2kMBNpY4nF1qNCRd8SJLA: posts big blind $0.25
N1HHRe1nNMukTQB6qMn6Kw: posts small blind $0.10
*** HOLE CARDS ***
N1HHRe1nNMukTQB6qMn6Kw: folds 
gehe91e0IyVT0QU/XBkEyg: folds 
st9jtdNbm1W5GfBwRaCVqQ: raises $0.75 to $1
rUpvA02nErFvZ4yFbDR8XA: folds 
GftT+l+xjKzcY0rMiNZfPg: folds 
4xnojP+j2Tm8s9Bh7QC5+Q: folds 
+2kMBNpY4nF1qNCRd8SJLA: calls $0.75
*** FLOP *** [2h Td 2d]
+2kMBNpY4nF1qNCRd8SJLA: checks 
st9jtdNbm1W5GfBwRaCVqQ: bets $1.65
+2kMBNpY4nF1qNCRd8SJLA: folds 
Uncalled bet ($1.65) returned to st9jtdNbm1W5GfBwRaCVqQ
st9jtdNbm1W5GfBwRaCVqQ collected $2.10 from pot
st9jtdNbm1W5GfBwRaCVqQ: doesn't show hand 
GQTWTgG7Ydy9q/vohVnKmQ has returned
*** SUMMARY ***
Total pot $2.20 | Rake $0.10 
Board [2h Td 2d]
Seat 2: rUpvA02nErFvZ4yFbDR8XA folded before Flop (didn't bet)
Seat 3: GftT+l+xjKzcY0rMiNZfPg (button) folded before Flop (didn't bet)
Seat 4: 4xnojP+j2Tm8s9Bh7QC5+Q (small blind) folded before Flop
Seat 5: +2kMBNpY4nF1qNCRd8SJLA (big blind) folded on the Flop
Seat 6: N1HHRe1nNMukTQB6qMn6Kw folded before Flop
Seat 7: gehe91e0IyVT0QU/XBkEyg folded before Flop (didn't bet)
Seat 8: st9jtdNbm1W5GfBwRaCVqQ collected ($2.10)




PokerStars Game #59939357076:  Hold'em No Limit ($0.10/$0.25) - 2009/07/01 0:37:47 ET
Table 'ykyWGjhNu7AvZXov27T4ew' 9-max Seat #5 is the button
Seat 2: MG90wfSJZnOejs/KD3vlQQ ($25.35 in chips) 
Seat 3: r1pFKMwWp74QwhfPWJOAyw ($6.05 in chips) 
Seat 4: hBMUlEpyU74r/fwDgIpXjQ ($25.80 in chips) 
Seat 5: lMysP2jE94oJvWGA6K5puw ($7.75 in chips) 
Seat 6: opOCI2p6kW0tINuVaAqmcQ ($25 in chips) 
Seat 8: tYsOBqdU1+x+yFI7zHO7hQ ($31.95 in chips) 
Seat 9: Yv4fucyyT28mjx8V5lxKJg ($24.65 in chips) 
opOCI2p6kW0tINuVaAqmcQ: posts small blind $0.10
mod bot: is sitting out 
tYsOBqdU1+x+yFI7zHO7hQ: posts big blind $0.25
*** HOLE CARDS ***
mod bot leaves the table
Yv4fucyyT28mjx8V5lxKJg: folds 
MG90wfSJZnOejs/KD3vlQQ: folds 
r1pFKMwWp74QwhfPWJOAyw: folds 
hBMUlEpyU74r/fwDgIpXjQ: folds 
lMysP2jE94oJvWGA6K5puw: folds 
opOCI2p6kW0tINuVaAqmcQ: folds 
Uncalled bet ($0.15) returned to tYsOBqdU1+x+yFI7zHO7hQ
tYsOBqdU1+x+yFI7zHO7hQ collected $0.20 from pot
tYsOBqdU1+x+yFI7zHO7hQ: doesn't show hand 
*** SUMMARY ***
Total pot $0.20 | Rake $0 
Seat 2: MG90wfSJZnOejs/KD3vlQQ folded before Flop (didn't bet)
Seat 3: r1pFKMwWp74QwhfPWJOAyw folded before Flop (didn't bet)
Seat 4: hBMUlEpyU74r/fwDgIpXjQ folded before Flop (didn't bet)
Seat 5: lMysP2jE94oJvWGA6K5puw (button) folded before Flop (didn't bet)
Seat 6: opOCI2p6kW0tINuVaAqmcQ (small blind) folded before Flop
Seat 8: tYsOBqdU1+x+yFI7zHO7hQ (big blind) collected ($0.20)
Seat 9: Yv4fucyyT28mjx8V5lxKJg folded before Flop (didn't bet)




PokerStars Game #59939356858:  Hold'em No Limit ($0.10/$0.25) - 2009/07/01 0:37:47 ET
Table 'nFlmVztKq1HJEWfxmdl15w' 9-max Seat #1 is the button
Seat 1: COsrwJSFHQtxlUcrYtDQPQ ($25 in chips) 
Seat 3: /XMgGtJ7mcWfe5s7McY9kw ($20.80 in chips) 
Seat 4: +5dSUwD+/k2ktlnutSMivw ($21.65 in chips) 
Seat 5: Tx6zQdk5Ozt9ObEBlU7jeg ($20.60 in chips) 
Seat 6: 4awUyiDYTgylQKXZ9faBVA ($29.60 in chips) 
Seat 7: Mm1VqYDg+pZQ8ufUXZHA1g ($11.05 in chips) 
Seat 9: LSrAei+fS8MYG9ie/GkG0Q ($12.25 in chips) 
/XMgGtJ7mcWfe5s7McY9kw: posts small blind $0.10
+5dSUwD+/k2ktlnutSMivw: posts big blind $0.25
+2kMBNpY4nF1qNCRd8SJLA: sits out 
*** HOLE CARDS ***
Tx6zQdk5Ozt9ObEBlU7jeg: folds 
4awUyiDYTgylQKXZ9faBVA: folds 
Mm1VqYDg+pZQ8ufUXZHA1g: calls $0.25
LSrAei+fS8MYG9ie/GkG0Q: calls $0.25
COsrwJSFHQtxlUcrYtDQPQ: calls $0.25
/XMgGtJ7mcWfe5s7McY9kw: calls $0.15
+5dSUwD+/k2ktlnutSMivw: checks 
*** FLOP *** [Ac 8h 2c]
/XMgGtJ7mcWfe5s7McY9kw: checks 
+5dSUwD+/k2ktlnutSMivw: checks 
Mm1VqYDg+pZQ8ufUXZHA1g: checks 
LSrAei+fS8MYG9ie/GkG0Q: bets $1
COsrwJSFHQtxlUcrYtDQPQ: calls $1
/XMgGtJ7mcWfe5s7McY9kw: calls $1
+5dSUwD+/k2ktlnutSMivw: folds 
Mm1VqYDg+pZQ8ufUXZHA1g: calls $1
*** TURN *** [Ac 8h 2c] [Ts]
/XMgGtJ7mcWfe5s7McY9kw: checks 
Mm1VqYDg+pZQ8ufUXZHA1g: checks 
LSrAei+fS8MYG9ie/GkG0Q: bets $5
COsrwJSFHQtxlUcrYtDQPQ: folds 
/XMgGtJ7mcWfe5s7McY9kw: folds 
Mm1VqYDg+pZQ8ufUXZHA1g: folds 
Uncalled bet ($5) returned to LSrAei+fS8MYG9ie/GkG0Q
LSrAei+fS8MYG9ie/GkG0Q collected $5 from pot
LSrAei+fS8MYG9ie/GkG0Q: doesn't show hand 
*** SUMMARY ***
Total pot $5.25 | Rake $0.25 
Board [Ac 8h 2c Ts]
Seat 1: COsrwJSFHQtxlUcrYtDQPQ (button) folded on the Turn
Seat 3: /XMgGtJ7mcWfe5s7McY9kw (small blind) folded on the Turn
Seat 4: +5dSUwD+/k2ktlnutSMivw (big blind) folded on the Flop
Seat 5: Tx6zQdk5Ozt9ObEBlU7jeg folded before Flop (didn't bet)
Seat 6: 4awUyiDYTgylQKXZ9faBVA folded before Flop (didn't bet)
Seat 7: Mm1VqYDg+pZQ8ufUXZHA1g folded on the Turn
Seat 9: LSrAei+fS8MYG9ie/GkG0Q collected ($5)




PokerStars Game #59939357058:  Hold'em No Limit ($0.10/$0.25) - 2009/07/01 0:37:47 ET
Table 'ThBZ355rqvsb8UGb6ajbig' 9-max Seat #7 is the button
Seat 2: 4awUyiDYTgylQKXZ9faBVA ($27.75 in chips) 
Seat 3: LBrhQVB4w41YNd7kMYn/og ($9.95 in chips) 
Seat 4: GFNwOPqg/Zu4ZuokgGADNQ ($8.10 in chips) 
Seat 5: ljO8CPts14fBjr9/qK0Enw ($29.45 in chips) 
Seat 6: qwr38jl5txoR36M7G5qi4A ($7.50 in chips) 
Seat 7: t2nb95S5EEFOEzNx9Itz0g ($12.95 in chips) 
Seat 9: 8B/dhbQjIWe6ASCdgzktNQ ($28.85 in chips) 
6REZ3fl3I5Kaxoupd8cnLg will be allowed to play after the button
8B/dhbQjIWe6ASCdgzktNQ: posts small blind $0.10
TeWJxSETzbXGiYKx0y+dtg: is sitting out 
4awUyiDYTgylQKXZ9faBVA: posts big blind $0.25
*** HOLE CARDS ***
LBrhQVB4w41YNd7kMYn/og: folds 
GFNwOPqg/Zu4ZuokgGADNQ: folds 
ljO8CPts14fBjr9/qK0Enw: raises $0.75 to $1
qwr38jl5txoR36M7G5qi4A: folds 
t2nb95S5EEFOEzNx9Itz0g: folds 
8B/dhbQjIWe6ASCdgzktNQ: folds 
4awUyiDYTgylQKXZ9faBVA: raises $2.50 to $3.50
ljO8CPts14fBjr9/qK0Enw: calls $2.50
*** FLOP *** [6d 9c 4c]
4awUyiDYTgylQKXZ9faBVA: bets $3.50
ljO8CPts14fBjr9/qK0Enw: raises $20.75 to $24.25
4awUyiDYTgylQKXZ9faBVA: folds 
Uncalled bet ($20.75) returned to ljO8CPts14fBjr9/qK0Enw
ljO8CPts14fBjr9/qK0Enw collected $13.45 from pot
*** SUMMARY ***
Total pot $14.10 | Rake $0.65 
Board [6d 9c 4c]
Seat 2: 4awUyiDYTgylQKXZ9faBVA (big blind) folded on the Flop
Seat 3: LBrhQVB4w41YNd7kMYn/og folded before Flop (didn't bet)
Seat 4: GFNwOPqg/Zu4ZuokgGADNQ folded before Flop (didn't bet)
Seat 5: ljO8CPts14fBjr9/qK0Enw collected ($13.45)
Seat 6: qwr38jl5txoR36M7G5qi4A folded before Flop (didn't bet)
Seat 7: t2nb95S5EEFOEzNx9Itz0g (button) folded before Flop (didn't bet)
Seat 9: 8B/dhbQjIWe6ASCdgzktNQ (small blind) folded before Flop




PokerStars Game #59939357028:  Hold'em No Limit ($0.10/$0.25) - 2009/07/01 0:37:47 ET
Table 'APEHQjIcZHDZUA4iOjju2g' 6-max Seat #1 is the button
Seat 1: eHsmIvAb2JREg4O6hNPnXg ($8.60 in chips) 
Seat 2: 3zD3qLXT1bEffAoWGnc7wg ($25.10 in chips) 
Seat 4: EqXTTLKUlDlz7yi6ziyyWA ($31.75 in chips) 
Seat 5: /xN6gc9+8Hew0HxaB6VIVg ($32.10 in chips) 
Seat 6: y7HCJfEmolBCFdi/0j5TRg ($45.05 in chips) 
3zD3qLXT1bEffAoWGnc7wg: posts small blind $0.10
EqXTTLKUlDlz7yi6ziyyWA: posts big blind $0.25
*** HOLE CARDS ***
/xN6gc9+8Hew0HxaB6VIVg: folds 
y7HCJfEmolBCFdi/0j5TRg: folds 
eHsmIvAb2JREg4O6hNPnXg: folds 
3zD3qLXT1bEffAoWGnc7wg: calls $0.15
EqXTTLKUlDlz7yi6ziyyWA: checks 
*** FLOP *** [Kd 4d 2h]
E7KSkgfIsmIsp0vLnmGFmA has returned
3zD3qLXT1bEffAoWGnc7wg: checks 
EqXTTLKUlDlz7yi6ziyyWA: bets $0.25
3zD3qLXT1bEffAoWGnc7wg: folds 
Uncalled bet ($0.25) returned to EqXTTLKUlDlz7yi6ziyyWA
EqXTTLKUlDlz7yi6ziyyWA collected $0.50 from pot
*** SUMMARY ***
Total pot $0.50 | Rake $0 
Board [Kd 4d 2h]
Seat 1: eHsmIvAb2JREg4O6hNPnXg (button) folded before Flop (didn't bet)
Seat 2: 3zD3qLXT1bEffAoWGnc7wg (small blind) folded on the Flop
Seat 4: EqXTTLKUlDlz7yi6ziyyWA (big blind) collected ($0.50)
Seat 5: /xN6gc9+8Hew0HxaB6VIVg folded before Flop (didn't bet)
Seat 6: y7HCJfEmolBCFdi/0j5TRg folded before Flop (didn't bet)




PokerStars Game #59939357674:  Hold'em No Limit ($0.10/$0.25) - 2009/07/01 0:37:48 ET
Table 'luMgmRPIo47e7iXDlheIwA' 6-max Seat #5 is the button
Seat 2: 4YSTu0Cdzpppe1lUgCZGCQ ($41.70 in chips) 
Seat 4: n2OZezRXTtdzQt4SuIy8TQ ($19.90 in chips) 
Seat 5: kG34n23qFQA3nzdOJTQ1dA ($46.90 in chips) 
4YSTu0Cdzpppe1lUgCZGCQ: posts small blind $0.10
n2OZezRXTtdzQt4SuIy8TQ: posts big blind $0.25
*** HOLE CARDS ***
kG34n23qFQA3nzdOJTQ1dA: folds 
4YSTu0Cdzpppe1lUgCZGCQ: raises $0.75 to $1
n2OZezRXTtdzQt4SuIy8TQ: calls $0.75
*** FLOP *** [5h 3h 3d]
4YSTu0Cdzpppe1lUgCZGCQ: bets $1.25
n2OZezRXTtdzQt4SuIy8TQ: calls $1.25
*** TURN *** [5h 3h 3d] [Kc]
m2yWOKfAxqHoy5DDN87Ttw has returned
4YSTu0Cdzpppe1lUgCZGCQ: bets $3
n2OZezRXTtdzQt4SuIy8TQ: folds 
Uncalled bet ($3) returned to 4YSTu0Cdzpppe1lUgCZGCQ
4YSTu0Cdzpppe1lUgCZGCQ collected $4.30 from pot
4YSTu0Cdzpppe1lUgCZGCQ: doesn't show hand 
*** SUMMARY ***
Total pot $4.50 | Rake $0.20 
Board [5h 3h 3d Kc]
Seat 2: 4YSTu0Cdzpppe1lUgCZGCQ (small blind) collected ($4.30)
Seat 4: n2OZezRXTtdzQt4SuIy8TQ (big blind) folded on the Turn
Seat 5: kG34n23qFQA3nzdOJTQ1dA (button) folded before Flop (didn't bet)




PokerStars Game #59939357494:  Hold'em No Limit ($0.10/$0.25) - 2009/07/01 0:37:48 ET
Table 'dNYnr4D4id1jwnEU66Yowg' 9-max Seat #5 is the button
Seat 1: pVm3TmLFzWLZgQF7aghAfw ($47.20 in chips) 
Seat 2: t2nb95S5EEFOEzNx9Itz0g ($4.95 in chips) 
Seat 5: k+2r6di6GXjNpAdrRkW9bA ($23.20 in chips) 
Seat 6: kqpa/IbqkUrwPb3hbA7/ww ($8.60 in chips) 
Seat 7: hBMUlEpyU74r/fwDgIpXjQ ($25.60 in chips) 
Seat 8: opOCI2p6kW0tINuVaAqmcQ ($25 in chips) 
kqpa/IbqkUrwPb3hbA7/ww: posts small blind $0.10
hBMUlEpyU74r/fwDgIpXjQ: posts big blind $0.25
*** HOLE CARDS ***
ZWU9RNYtjmm4cElg1I0F4w leaves the table
opOCI2p6kW0tINuVaAqmcQ: folds 
pVm3TmLFzWLZgQF7aghAfw: raises $0.50 to $0.75
t2nb95S5EEFOEzNx9Itz0g: folds 
k+2r6di6GXjNpAdrRkW9bA: folds 
kqpa/IbqkUrwPb3hbA7/ww: folds 
hBMUlEpyU74r/fwDgIpXjQ: folds 
Uncalled bet ($0.50) returned to pVm3TmLFzWLZgQF7aghAfw
pVm3TmLFzWLZgQF7aghAfw collected $0.60 from pot
*** SUMMARY ***
Total pot $0.60 | Rake $0 
Seat 1: pVm3TmLFzWLZgQF7aghAfw collected ($0.60)
Seat 2: t2nb95S5EEFOEzNx9Itz0g folded before Flop (didn't bet)
Seat 5: k+2r6di6GXjNpAdrRkW9bA (button) folded before Flop (didn't bet)
Seat 6: kqpa/IbqkUrwPb3hbA7/ww (small blind) folded before Flop
Seat 7: hBMUlEpyU74r/fwDgIpXjQ (big blind) folded before Flop
Seat 8: opOCI2p6kW0tINuVaAqmcQ folded before Flop (didn't bet)




PokerStars Game #59939357462:  Hold'em No Limit ($0.10/$0.25) - 2009/07/01 0:37:48 ET
Table 'M8kYidAX3ib7pLKW7edFLw' 6-max Seat #2 is the button
Seat 1: 4YSTu0Cdzpppe1lUgCZGCQ ($40.25 in chips) 
Seat 2: sbFQMajC1QuRxa8Jly3usQ ($23.35 in chips) 
Seat 4: /bjna2FTN7pPjqYGzmDE0Q ($23.15 in chips) 
Seat 5: bDKopKTvPi3W+PEnYUX3tg ($28.30 in chips) 
/bjna2FTN7pPjqYGzmDE0Q: posts small blind $0.10
bDKopKTvPi3W+PEnYUX3tg: posts big blind $0.25
*** HOLE CARDS ***
4YSTu0Cdzpppe1lUgCZGCQ: folds 
sbFQMajC1QuRxa8Jly3usQ: calls $0.25
/bjna2FTN7pPjqYGzmDE0Q: folds 
bDKopKTvPi3W+PEnYUX3tg: checks 
*** FLOP *** [8d 2h 3s]
bDKopKTvPi3W+PEnYUX3tg: checks 
sbFQMajC1QuRxa8Jly3usQ: bets $0.75
bDKopKTvPi3W+PEnYUX3tg: folds 
Uncalled bet ($0.75) returned to sbFQMajC1QuRxa8Jly3usQ
sbFQMajC1QuRxa8Jly3usQ collected $0.60 from pot
*** SUMMARY ***
Total pot $0.60 | Rake $0 
Board [8d 2h 3s]
Seat 1: 4YSTu0Cdzpppe1lUgCZGCQ folded before Flop (didn't bet)
Seat 2: sbFQMajC1QuRxa8Jly3usQ (button) collected ($0.60)
Seat 4: /bjna2FTN7pPjqYGzmDE0Q (small blind) folded before Flop
Seat 5: bDKopKTvPi3W+PEnYUX3tg (big blind) folded on the Flop




PokerStars Game #59939357132:  Hold'em No Limit ($0.10/$0.25) - 2009/07/01 0:37:48 ET
Table 'SbSV5tlgLp0+/Z+13PW3Hg' 9-max Seat #2 is the button
Seat 1: NAP/FpFXsTsBxjDijlVzEg ($43.40 in chips) 
Seat 2: zDrucyjVn5aeekNEc3cJrA ($20.30 in chips) 
Seat 3: s7Q6uNouhe7aE8JdFb9E+A ($25 in chips) 
Seat 4: NNZypfH1f/VIj3Skf/XIzg ($5 in chips) 
Seat 5: z5GxcHlYz/GSz6W2uFiTtg ($19.60 in chips) 
Seat 6: qwr38jl5txoR36M7G5qi4A ($8.25 in chips) 
Seat 7: j4q3p0lesp63b1gZDwLBZw ($6.35 in chips) 
Seat 8: 7cv+9Zc9HIQHNvYsMfV3uA ($25.50 in chips) 
Seat 9: rXm4QDVJt67H20lM6n6Z7Q ($9.55 in chips) 
s7Q6uNouhe7aE8JdFb9E+A: posts small blind $0.10
NNZypfH1f/VIj3Skf/XIzg: posts big blind $0.25
*** HOLE CARDS ***
z5GxcHlYz/GSz6W2uFiTtg: folds 
qwr38jl5txoR36M7G5qi4A: folds 
j4q3p0lesp63b1gZDwLBZw: folds 
7cv+9Zc9HIQHNvYsMfV3uA: folds 
rXm4QDVJt67H20lM6n6Z7Q: calls $0.25
NAP/FpFXsTsBxjDijlVzEg: folds 
NAP/FpFXsTsBxjDijlVzEg is sitting out
zDrucyjVn5aeekNEc3cJrA: calls $0.25
s7Q6uNouhe7aE8JdFb9E+A: folds 
NNZypfH1f/VIj3Skf/XIzg: checks 
*** FLOP *** [Qs 4d 7d]
NNZypfH1f/VIj3Skf/XIzg: checks 
rXm4QDVJt67H20lM6n6Z7Q: bets $0.50
zDrucyjVn5aeekNEc3cJrA: raises $0.75 to $1.25
NNZypfH1f/VIj3Skf/XIzg: folds 
rXm4QDVJt67H20lM6n6Z7Q: calls $0.75
*** TURN *** [Qs 4d 7d] [Qh]
rXm4QDVJt67H20lM6n6Z7Q: checks 
zDrucyjVn5aeekNEc3cJrA: bets $5.25
NAP/FpFXsTsBxjDijlVzEg has returned
rXm4QDVJt67H20lM6n6Z7Q: raises $2.80 to $8.05 and is all-in
zDrucyjVn5aeekNEc3cJrA: calls $2.80
*** RIVER *** [Qs 4d 7d Qh] [Kc]
*** SHOW DOWN ***
rXm4QDVJt67H20lM6n6Z7Q: shows [Kh Qd] (a full house, Queens full of Kings)
zDrucyjVn5aeekNEc3cJrA: mucks hand 
rXm4QDVJt67H20lM6n6Z7Q collected $18.50 from pot
*** SUMMARY ***
Total pot $19.45 | Rake $0.95 
Board [Qs 4d 7d Qh Kc]
Seat 1: NAP/FpFXsTsBxjDijlVzEg folded before Flop (didn't bet)
Seat 2: zDrucyjVn5aeekNEc3cJrA (button) mucked
Seat 3: s7Q6uNouhe7aE8JdFb9E+A (small blind) folded before Flop
Seat 4: NNZypfH1f/VIj3Skf/XIzg (big blind) folded on the Flop
Seat 5: z5GxcHlYz/GSz6W2uFiTtg folded before Flop (didn't bet)
Seat 6: qwr38jl5txoR36M7G5qi4A folded before Flop (didn't bet)
Seat 7: j4q3p0lesp63b1gZDwLBZw folded before Flop (didn't bet)
Seat 8: 7cv+9Zc9HIQHNvYsMfV3uA folded before Flop (didn't bet)
Seat 9: rXm4QDVJt67H20lM6n6Z7Q showed [Kh Qd] and won ($18.50) with a full house, Queens full of Kings




PokerStars Game #59939357614:  Hold'em No Limit ($0.10/$0.25) - 2009/07/01 0:37:48 ET
Table 'TJS4XvvOjO3k7mH74HJw5g' 9-max Seat #9 is the button
Seat 1: SS+d2ix02WTTacMsjCk0OQ ($24.40 in chips) 
Seat 2: ghNKXUBl/H+t83JF079ZBA ($25 in chips) 
Seat 3: L6etP3czFOcyn5+af0s61Q ($6.50 in chips) 
Seat 4: Y+IdmmKAoWu2irRi3Jpr4Q ($18 in chips) 
Seat 5: NNZypfH1f/VIj3Skf/XIzg ($4.65 in chips) 
Seat 6: cFmpjvcjNoVAEAIQIxWkYg ($25 in chips) 
Seat 7: DiSvPC2iudwL5j9u6Huyww ($25 in chips) 
Seat 8: l9TiQshP7QOsNH6jZrL4Wg ($3.80 in chips) 
Seat 9: +sbyWwIcFp9kP0bDtMegfQ ($32.25 in chips) 
SS+d2ix02WTTacMsjCk0OQ: posts small blind $0.10
ghNKXUBl/H+t83JF079ZBA: posts big blind $0.25
*** HOLE CARDS ***
L6etP3czFOcyn5+af0s61Q: folds 
L6etP3czFOcyn5+af0s61Q leaves the table
Y+IdmmKAoWu2irRi3Jpr4Q: calls $0.25
8B/dhbQjIWe6ASCdgzktNQ joins the table at seat #3 
NNZypfH1f/VIj3Skf/XIzg: folds 
cFmpjvcjNoVAEAIQIxWkYg: folds 
DiSvPC2iudwL5j9u6Huyww: folds 
l9TiQshP7QOsNH6jZrL4Wg: calls $0.25
+sbyWwIcFp9kP0bDtMegfQ: folds 
SS+d2ix02WTTacMsjCk0OQ: calls $0.15
ghNKXUBl/H+t83JF079ZBA: checks 
*** FLOP *** [2c 9d 8s]
SS+d2ix02WTTacMsjCk0OQ: bets $0.75
ghNKXUBl/H+t83JF079ZBA: folds 
Y+IdmmKAoWu2irRi3Jpr4Q: folds 
l9TiQshP7QOsNH6jZrL4Wg: folds 
Uncalled bet ($0.75) returned to SS+d2ix02WTTacMsjCk0OQ
SS+d2ix02WTTacMsjCk0OQ collected $0.95 from pot
SS+d2ix02WTTacMsjCk0OQ: doesn't show hand 
*** SUMMARY ***
Total pot $1 | Rake $0.05 
Board [2c 9d 8s]
Seat 1: SS+d2ix02WTTacMsjCk0OQ (small blind) collected ($0.95)
Seat 2: ghNKXUBl/H+t83JF079ZBA (big blind) folded on the Flop
Seat 3: L6etP3czFOcyn5+af0s61Q folded before Flop (didn't bet)
Seat 4: Y+IdmmKAoWu2irRi3Jpr4Q folded on the Flop
Seat 5: NNZypfH1f/VIj3Skf/XIzg folded before Flop (didn't bet)
Seat 6: cFmpjvcjNoVAEAIQIxWkYg folded before Flop (didn't bet)
Seat 7: DiSvPC2iudwL5j9u6Huyww folded before Flop (didn't bet)
Seat 8: l9TiQshP7QOsNH6jZrL4Wg folded on the Flop
Seat 9: +sbyWwIcFp9kP0bDtMegfQ (button) folded before Flop (didn't bet)




PokerStars Game #59939357706:  Hold'em No Limit ($0.10/$0.25) - 2009/07/01 0:37:49 ET
Table 'sJ4KpS2GE5Qrsu1/cFjJUw' 9-max Seat #3 is the button
Seat 3: eDil7UzSZCjyh1VP6SVXJQ ($6.25 in chips) 
Seat 8: f8ixGbSVIs6Be0mH69ldVQ ($15.40 in chips) 
QsLvCwfSWqP+CfjwUnjpXQ will be allowed to play after the button
eDil7UzSZCjyh1VP6SVXJQ: posts small blind $0.10
f8ixGbSVIs6Be0mH69ldVQ: posts big blind $0.25
*** HOLE CARDS ***
eDil7UzSZCjyh1VP6SVXJQ: calls $0.15
f8ixGbSVIs6Be0mH69ldVQ: checks 
*** FLOP *** [Tc 5c 4d]
f8ixGbSVIs6Be0mH69ldVQ: bets $0.25
eDil7UzSZCjyh1VP6SVXJQ: calls $0.25
*** TURN *** [Tc 5c 4d] [Jc]
f8ixGbSVIs6Be0mH69ldVQ: checks 
eDil7UzSZCjyh1VP6SVXJQ: bets $0.25
f8ixGbSVIs6Be0mH69ldVQ: folds 
Uncalled bet ($0.25) returned to eDil7UzSZCjyh1VP6SVXJQ
eDil7UzSZCjyh1VP6SVXJQ collected $0.95 from pot
eDil7UzSZCjyh1VP6SVXJQ: doesn't show hand 
*** SUMMARY ***
Total pot $1 | Rake $0.05 
Board [Tc 5c 4d Jc]
Seat 3: eDil7UzSZCjyh1VP6SVXJQ (button) (small blind) collected ($0.95)
Seat 8: f8ixGbSVIs6Be0mH69ldVQ (big blind) folded on the Turn




PokerStars Game #59939358154:  Hold'em No Limit ($0.10/$0.25) - 2009/07/01 0:37:49 ET
Table 'pgrBYaOEx/BuqK5iAtlFzw' 9-max Seat #3 is the button
Seat 3: bfSq6LBw0UvxeM5yfuWC7w ($17.50 in chips) 
Seat 5: efYVL4adq0ufQFnZCpL5Tw ($3.25 in chips) 
bfSq6LBw0UvxeM5yfuWC7w: posts small blind $0.10
efYVL4adq0ufQFnZCpL5Tw: posts big blind $0.25
*** HOLE CARDS ***
bfSq6LBw0UvxeM5yfuWC7w: raises $0.75 to $1
efYVL4adq0ufQFnZCpL5Tw: calls $0.75
*** FLOP *** [4d 2c 7h]
efYVL4adq0ufQFnZCpL5Tw: bets $2.25 and is all-in
bfSq6LBw0UvxeM5yfuWC7w: calls $2.25
*** TURN *** [4d 2c 7h] [Ac]
*** RIVER *** [4d 2c 7h Ac] [7s]
*** SHOW DOWN ***
efYVL4adq0ufQFnZCpL5Tw: shows [4c Jd] (two pair, Sevens and Fours)
bfSq6LBw0UvxeM5yfuWC7w: mucks hand 
efYVL4adq0ufQFnZCpL5Tw collected $6.20 from pot
*** SUMMARY ***
Total pot $6.50 | Rake $0.30 
Board [4d 2c 7h Ac 7s]
Seat 3: bfSq6LBw0UvxeM5yfuWC7w (button) (small blind) mucked
Seat 5: efYVL4adq0ufQFnZCpL5Tw (big blind) showed [4c Jd] and won ($6.20) with two pair, Sevens and Fours




PokerStars Game #59939358134:  Hold'em No Limit ($0.10/$0.25) - 2009/07/01 0:37:49 ET
Table 'YmPuuzhvRUvgdYcNs5kZKw' 9-max Seat #1 is the button
Seat 1: Qi+clOtyDiibLdH2/1Qy8g ($24.60 in chips) 
Seat 2: Z5ZtGOON8kmSdSCll9Z3XA ($17.50 in chips) 
Seat 3: uLP/lYn7oKq9xCChBXsXxw ($25 in chips) 
Seat 4: JxpnpCmvRAcrEUy7mq1iAg ($5 in chips) 
Seat 5: ZwMqa2mn2qu4W4PkN7J+xg ($27.85 in chips) 
Seat 6: z5GxcHlYz/GSz6W2uFiTtg ($22.30 in chips) 
Seat 7: opOCI2p6kW0tINuVaAqmcQ ($25.15 in chips) 
Seat 8: IeNTEKD96WqM7qU1RpSvOQ ($10.75 in chips) 
Seat 9: 5IeCaraAnS03/jUIjZQAig ($8.85 in chips) 
Z5ZtGOON8kmSdSCll9Z3XA: posts small blind $0.10
uLP/lYn7oKq9xCChBXsXxw: posts big blind $0.25
*** HOLE CARDS ***
JxpnpCmvRAcrEUy7mq1iAg: folds 
ZwMqa2mn2qu4W4PkN7J+xg: folds 
z5GxcHlYz/GSz6W2uFiTtg: calls $0.25
opOCI2p6kW0tINuVaAqmcQ: folds 
IeNTEKD96WqM7qU1RpSvOQ: calls $0.25
5IeCaraAnS03/jUIjZQAig: calls $0.25
Qi+clOtyDiibLdH2/1Qy8g: folds 
Z5ZtGOON8kmSdSCll9Z3XA: calls $0.15
uLP/lYn7oKq9xCChBXsXxw: checks 
*** FLOP *** [6c 5s 3s]
Z5ZtGOON8kmSdSCll9Z3XA: checks 
uLP/lYn7oKq9xCChBXsXxw: checks 
z5GxcHlYz/GSz6W2uFiTtg: checks 
IeNTEKD96WqM7qU1RpSvOQ: bets $0.25
5IeCaraAnS03/jUIjZQAig: calls $0.25
Z5ZtGOON8kmSdSCll9Z3XA: calls $0.25
uLP/lYn7oKq9xCChBXsXxw: folds 
z5GxcHlYz/GSz6W2uFiTtg: folds 
*** TURN *** [6c 5s 3s] [5c]
Z5ZtGOON8kmSdSCll9Z3XA: checks 
IeNTEKD96WqM7qU1RpSvOQ: checks 
5IeCaraAnS03/jUIjZQAig: bets $0.50
Z5ZtGOON8kmSdSCll9Z3XA: folds 
IeNTEKD96WqM7qU1RpSvOQ: calls $0.50
*** RIVER *** [6c 5s 3s 5c] [Tc]
IeNTEKD96WqM7qU1RpSvOQ: bets $1
5IeCaraAnS03/jUIjZQAig: calls $1
*** SHOW DOWN ***
IeNTEKD96WqM7qU1RpSvOQ: shows [6s 6h] (a full house, Sixes full of Fives)
5IeCaraAnS03/jUIjZQAig: mucks hand 
IeNTEKD96WqM7qU1RpSvOQ collected $4.80 from pot
*** SUMMARY ***
Total pot $5 | Rake $0.20 
Board [6c 5s 3s 5c Tc]
Seat 1: Qi+clOtyDiibLdH2/1Qy8g (button) folded before Flop (didn't bet)
Seat 2: Z5ZtGOON8kmSdSCll9Z3XA (small blind) folded on the Turn
Seat 3: uLP/lYn7oKq9xCChBXsXxw (big blind) folded on the Flop
Seat 4: JxpnpCmvRAcrEUy7mq1iAg folded before Flop (didn't bet)
Seat 5: ZwMqa2mn2qu4W4PkN7J+xg folded before Flop (didn't bet)
Seat 6: z5GxcHlYz/GSz6W2uFiTtg folded on the Flop
Seat 7: opOCI2p6kW0tINuVaAqmcQ folded before Flop (didn't bet)
Seat 8: IeNTEKD96WqM7qU1RpSvOQ showed [6s 6h] and won ($4.80) with a full house, Sixes full of Fives
Seat 9: 5IeCaraAnS03/jUIjZQAig mucked




PokerStars Game #59939358156:  Hold'em No Limit ($0.10/$0.25) - 2009/07/01 0:37:49 ET
Table 'XX2OuOsa8/8AC+/mR/Az6g' 9-max Seat #5 is the button
Seat 1: 56S3mA6Zs3pGR+0p0vUCtg ($25 in chips) 
Seat 2: MIVCHqCqqlke0Lb0z7glcw ($24.65 in chips) 
Seat 3: PJJTm/ccITEBlwPReiBTwg ($13.15 in chips) 
Seat 4: uLP/lYn7oKq9xCChBXsXxw ($25 in chips) 
Seat 5: jXz58rvCgq0VjyVjUBf2mw ($24.05 in chips) 
Seat 6: gT0nY7XiR+2FA+B3F4h8HQ ($25.45 in chips) 
Seat 7: zDrucyjVn5aeekNEc3cJrA ($21.20 in chips) 
Seat 8: cFmpjvcjNoVAEAIQIxWkYg ($25 in chips) 
Seat 9: 86vbuhJsyH+nbEg5qpDLyQ ($42.25 in chips) 
gT0nY7XiR+2FA+B3F4h8HQ: posts small blind $0.10
zDrucyjVn5aeekNEc3cJrA: posts big blind $0.25
uLP/lYn7oKq9xCChBXsXxw: posts big blind $0.25
*** HOLE CARDS ***
cFmpjvcjNoVAEAIQIxWkYg: folds 
86vbuhJsyH+nbEg5qpDLyQ: calls $0.25
56S3mA6Zs3pGR+0p0vUCtg: folds 
MIVCHqCqqlke0Lb0z7glcw: folds 
PJJTm/ccITEBlwPReiBTwg: calls $0.25
uLP/lYn7oKq9xCChBXsXxw: checks 
jXz58rvCgq0VjyVjUBf2mw: folds 
gT0nY7XiR+2FA+B3F4h8HQ: folds 
zDrucyjVn5aeekNEc3cJrA: checks 
*** FLOP *** [Td 3h 2s]
zDrucyjVn5aeekNEc3cJrA: checks 
86vbuhJsyH+nbEg5qpDLyQ: bets $0.75
PJJTm/ccITEBlwPReiBTwg: folds 
uLP/lYn7oKq9xCChBXsXxw: folds 
zDrucyjVn5aeekNEc3cJrA: folds 
Uncalled bet ($0.75) returned to 86vbuhJsyH+nbEg5qpDLyQ
86vbuhJsyH+nbEg5qpDLyQ collected $1.05 from pot
86vbuhJsyH+nbEg5qpDLyQ: doesn't show hand 
*** SUMMARY ***
Total pot $1.10 | Rake $0.05 
Board [Td 3h 2s]
Seat 1: 56S3mA6Zs3pGR+0p0vUCtg folded before Flop (didn't bet)
Seat 2: MIVCHqCqqlke0Lb0z7glcw folded before Flop (didn't bet)
Seat 3: PJJTm/ccITEBlwPReiBTwg folded on the Flop
Seat 4: uLP/lYn7oKq9xCChBXsXxw folded on the Flop
Seat 5: jXz58rvCgq0VjyVjUBf2mw (button) folded before Flop (didn't bet)
Seat 6: gT0nY7XiR+2FA+B3F4h8HQ (small blind) folded before Flop
Seat 7: zDrucyjVn5aeekNEc3cJrA (big blind) folded on the Flop
Seat 8: cFmpjvcjNoVAEAIQIxWkYg folded before Flop (didn't bet)
Seat 9: 86vbuhJsyH+nbEg5qpDLyQ collected ($1.05)




PokerStars Game #59939357718:  Hold'em No Limit ($0.10/$0.25) - 2009/07/01 0:37:49 ET
Table '2AUmC2Rslg+QUbLfdgNdfg' 6-max Seat #2 is the button
Seat 1: lgP2sg9oZJsNSXCt7tbwRg ($16.60 in chips) 
Seat 2: CCxAG7iPVlAv3brCqrGBEg ($14.75 in chips) 
Seat 3: iauW7L/+7qzAuHow7CD75Q ($6.05 in chips) 
Seat 4: B6R6e73iyJNddUtXtvYr3Q ($47.95 in chips) 
Seat 5: 8ClCHtFXGNplITm+63KB+Q ($23.30 in chips) 
Seat 6: BvTq4Tu0zBOsniW3eFCnkQ ($31.90 in chips) 
iauW7L/+7qzAuHow7CD75Q: posts small blind $0.10
B6R6e73iyJNddUtXtvYr3Q: posts big blind $0.25
*** HOLE CARDS ***
8ClCHtFXGNplITm+63KB+Q: folds 
BvTq4Tu0zBOsniW3eFCnkQ: folds 
lgP2sg9oZJsNSXCt7tbwRg: folds 
CCxAG7iPVlAv3brCqrGBEg: folds 
iauW7L/+7qzAuHow7CD75Q: folds 
Uncalled bet ($0.15) returned to B6R6e73iyJNddUtXtvYr3Q
B6R6e73iyJNddUtXtvYr3Q collected $0.20 from pot
B6R6e73iyJNddUtXtvYr3Q: doesn't show hand 
*** SUMMARY ***
Total pot $0.20 | Rake $0 
Seat 1: lgP2sg9oZJsNSXCt7tbwRg folded before Flop (didn't bet)
Seat 2: CCxAG7iPVlAv3brCqrGBEg (button) folded before Flop (didn't bet)
Seat 3: iauW7L/+7qzAuHow7CD75Q (small blind) folded before Flop
Seat 4: B6R6e73iyJNddUtXtvYr3Q (big blind) collected ($0.20)
Seat 5: 8ClCHtFXGNplITm+63KB+Q folded before Flop (didn't bet)
Seat 6: BvTq4Tu0zBOsniW3eFCnkQ folded before Flop (didn't bet)




PokerStars Game #59939357748:  Hold'em No Limit ($0.10/$0.25) - 2009/07/01 0:37:49 ET
Table 'NtCSSONEf1zaJo3042tQug' 6-max Seat #2 is the button
Seat 1: pdS3fOhVgLVaTP0O0GlIvw ($7.60 in chips) 
Seat 2: nbv8IVGAEHbfjk01ulU6ow ($19.20 in chips) 
Seat 3: d0J1xuhsynEY81YHwAvJ5g ($25 in chips) 
Seat 4: dOX4wnYV2sEqvDbF+8KSCw ($25.50 in chips) 
Seat 6: LxehwDpTQ19ph4Qmc78+Pw ($23.80 in chips) 
d0J1xuhsynEY81YHwAvJ5g: posts small blind $0.10
dOX4wnYV2sEqvDbF+8KSCw: posts big blind $0.25
*** HOLE CARDS ***
LxehwDpTQ19ph4Qmc78+Pw: calls $0.25
pdS3fOhVgLVaTP0O0GlIvw: calls $0.25
nbv8IVGAEHbfjk01ulU6ow: folds 
d0J1xuhsynEY81YHwAvJ5g: calls $0.15
l/t3k8+r77gRew8U2BJs4Q has returned
dOX4wnYV2sEqvDbF+8KSCw: checks 
*** FLOP *** [8s 3d 8h]
d0J1xuhsynEY81YHwAvJ5g: checks 
dOX4wnYV2sEqvDbF+8KSCw: checks 
LxehwDpTQ19ph4Qmc78+Pw: checks 
pdS3fOhVgLVaTP0O0GlIvw: bets $0.25
d0J1xuhsynEY81YHwAvJ5g: folds 
dOX4wnYV2sEqvDbF+8KSCw: folds 
LxehwDpTQ19ph4Qmc78+Pw: folds 
Uncalled bet ($0.25) returned to pdS3fOhVgLVaTP0O0GlIvw
pdS3fOhVgLVaTP0O0GlIvw collected $0.95 from pot
*** SUMMARY ***
Total pot $1 | Rake $0.05 
Board [8s 3d 8h]
Seat 1: pdS3fOhVgLVaTP0O0GlIvw collected ($0.95)
Seat 2: nbv8IVGAEHbfjk01ulU6ow (button) folded before Flop (didn't bet)
Seat 3: d0J1xuhsynEY81YHwAvJ5g (small blind) folded on the Flop
Seat 4: dOX4wnYV2sEqvDbF+8KSCw (big blind) folded on the Flop
Seat 6: LxehwDpTQ19ph4Qmc78+Pw folded on the Flop




PokerStars Game #59939357978:  Hold'em No Limit ($0.10/$0.25) - 2009/07/01 0:37:49 ET
Table 'nteM56rtr9SxLEblf0fvbw' 9-max Seat #9 is the button
Seat 1: H9KUl8cmpLgEpOVDA00bCg ($4.75 in chips) 
Seat 2: ljemhp25Zg+nlA9DLCIiUw ($26.30 in chips) 
Seat 4: cZ99hugmLBj9KhTlc8nCSw ($25.15 in chips) 
Seat 5: aJy680tKSaP5er559aSuGA ($10.45 in chips) 
Seat 7: dfNim92Z6XK1/h5SFW5vDg ($44.30 in chips) 
Seat 8: RJ/x9oZtt1RZLaJEQwZOxQ ($44.15 in chips) 
Seat 9: t2nb95S5EEFOEzNx9Itz0g ($6.90 in chips) 
H9KUl8cmpLgEpOVDA00bCg: posts small blind $0.10
ljemhp25Zg+nlA9DLCIiUw: posts big blind $0.25
*** HOLE CARDS ***
cZ99hugmLBj9KhTlc8nCSw: folds 
aJy680tKSaP5er559aSuGA: folds 
dfNim92Z6XK1/h5SFW5vDg: folds 
RJ/x9oZtt1RZLaJEQwZOxQ: folds 
t2nb95S5EEFOEzNx9Itz0g: folds 
H9KUl8cmpLgEpOVDA00bCg: raises $0.75 to $1
ljemhp25Zg+nlA9DLCIiUw: folds 
Uncalled bet ($0.75) returned to H9KUl8cmpLgEpOVDA00bCg
H9KUl8cmpLgEpOVDA00bCg collected $0.50 from pot
*** SUMMARY ***
Total pot $0.50 | Rake $0 
Seat 1: H9KUl8cmpLgEpOVDA00bCg (small blind) collected ($0.50)
Seat 2: ljemhp25Zg+nlA9DLCIiUw (big blind) folded before Flop
Seat 4: cZ99hugmLBj9KhTlc8nCSw folded before Flop (didn't bet)
Seat 5: aJy680tKSaP5er559aSuGA folded before Flop (didn't bet)
Seat 7: dfNim92Z6XK1/h5SFW5vDg folded before Flop (didn't bet)
Seat 8: RJ/x9oZtt1RZLaJEQwZOxQ folded before Flop (didn't bet)
Seat 9: t2nb95S5EEFOEzNx9Itz0g (button) folded before Flop (didn't bet)




PokerStars Game #59939358706:  Hold'em No Limit ($0.10/$0.25) - 2009/07/01 0:37:50 ET
Table 'BpNkESDX1ip9c0K1hb5h7A' 6-max Seat #5 is the button
Seat 1: 9jSiy0meE9XJKkdIZwyTEQ ($29.10 in chips) 
Seat 3: cHhVLDikFlByGGN+CM3w/A ($26.95 in chips) 
Seat 4: tbhYGxTClzdFLMcTtjvJhg ($49.20 in chips) 
Seat 5: QvTX2yGq3uKJiKPmns4TKQ ($73.40 in chips) 
Seat 6: iUgsn+WyKFjjVd+tj13R2w ($3.50 in chips) 
iUgsn+WyKFjjVd+tj13R2w: posts small blind $0.10
9jSiy0meE9XJKkdIZwyTEQ: posts big blind $0.25
*** HOLE CARDS ***
cHhVLDikFlByGGN+CM3w/A: raises $0.50 to $0.75
tbhYGxTClzdFLMcTtjvJhg: folds 
QvTX2yGq3uKJiKPmns4TKQ: folds 
iUgsn+WyKFjjVd+tj13R2w: folds 
9jSiy0meE9XJKkdIZwyTEQ: folds 
Uncalled bet ($0.50) returned to cHhVLDikFlByGGN+CM3w/A
cHhVLDikFlByGGN+CM3w/A collected $0.60 from pot
cHhVLDikFlByGGN+CM3w/A: doesn't show hand 
*** SUMMARY ***
Total pot $0.60 | Rake $0 
Seat 1: 9jSiy0meE9XJKkdIZwyTEQ (big blind) folded before Flop
Seat 3: cHhVLDikFlByGGN+CM3w/A collected ($0.60)
Seat 4: tbhYGxTClzdFLMcTtjvJhg folded before Flop (didn't bet)
Seat 5: QvTX2yGq3uKJiKPmns4TKQ (button) folded before Flop (didn't bet)
Seat 6: iUgsn+WyKFjjVd+tj13R2w (small blind) folded before Flop




PokerStars Game #59939358648:  Hold'em No Limit ($0.10/$0.25) - 2009/07/01 0:37:50 ET
Table 'zKwHJD0cmKNUure9qQTfFg' 6-max Seat #2 is the button
Seat 1: zsU1ijOyYEi+40wBKPEbmw ($22.70 in chips) 
Seat 2: XwQK8xvCADxp0bUmji+Zyg ($19.95 in chips) 
Seat 3: N7x3NAOGB0YpNXK0ejtQ1Q ($12.05 in chips) 
Seat 4: v+QfkGiuj9bgtuNoVnDO8w ($25 in chips) 
Seat 5: I1TxPvWj8NfG8orglCinNA ($25.30 in chips) 
Seat 6: BvTq4Tu0zBOsniW3eFCnkQ ($28.75 in chips) 
N7x3NAOGB0YpNXK0ejtQ1Q: posts small blind $0.10
v+QfkGiuj9bgtuNoVnDO8w: posts big blind $0.25
*** HOLE CARDS ***
I1TxPvWj8NfG8orglCinNA: folds 
BvTq4Tu0zBOsniW3eFCnkQ: folds 
zsU1ijOyYEi+40wBKPEbmw: raises $0.50 to $0.75
XwQK8xvCADxp0bUmji+Zyg: raises $0.50 to $1.25
N7x3NAOGB0YpNXK0ejtQ1Q: calls $1.15
v+QfkGiuj9bgtuNoVnDO8w: folds 
zsU1ijOyYEi+40wBKPEbmw: calls $0.50
*** FLOP *** [6d 5c Th]
N7x3NAOGB0YpNXK0ejtQ1Q: bets $3
zsU1ijOyYEi+40wBKPEbmw: folds 
XwQK8xvCADxp0bUmji+Zyg: raises $3 to $6
N7x3NAOGB0YpNXK0ejtQ1Q: raises $4.80 to $10.80 and is all-in
XwQK8xvCADxp0bUmji+Zyg: calls $4.80
*** TURN *** [6d 5c Th] [Ad]
*** RIVER *** [6d 5c Th Ad] [8h]
*** SHOW DOWN ***
N7x3NAOGB0YpNXK0ejtQ1Q: shows [5h 8d] (two pair, Eights and Fives)
XwQK8xvCADxp0bUmji+Zyg: shows [5s 5d] (three of a kind, Fives)
XwQK8xvCADxp0bUmji+Zyg collected $24.35 from pot
*** SUMMARY ***
Total pot $25.60 | Rake $1.25 
Board [6d 5c Th Ad 8h]
Seat 1: zsU1ijOyYEi+40wBKPEbmw folded on the Flop
Seat 2: XwQK8xvCADxp0bUmji+Zyg (button) showed [5s 5d] and won ($24.35) with three of a kind, Fives
Seat 3: N7x3NAOGB0YpNXK0ejtQ1Q (small blind) showed [5h 8d] and lost with two pair, Eights and Fives
Seat 4: v+QfkGiuj9bgtuNoVnDO8w (big blind) folded before Flop
Seat 5: I1TxPvWj8NfG8orglCinNA folded before Flop (didn't bet)
Seat 6: BvTq4Tu0zBOsniW3eFCnkQ folded before Flop (didn't bet)




PokerStars Game #59939358696:  Hold'em No Limit ($0.10/$0.25) - 2009/07/01 0:37:50 ET
Table 'BmUMTVcNATeov2rAGYU0Qg' 9-max Seat #5 is the button
Seat 1: v5jnQ1gfh9nLla3kMXG7Yg ($4.75 in chips) 
Seat 2: jJnMGXoBXye+afMd0k0rUw ($5.90 in chips) 
Seat 3: hJ4uYjNmSZdjrKA8cjZqCA ($21.45 in chips) 
Seat 4: aNpwfA31EREwO+ar4XzBCw ($35.85 in chips) 
Seat 5: EBPuArucumZnjWoW71jHBg ($22.70 in chips) 
Seat 6: JxpnpCmvRAcrEUy7mq1iAg ($6 in chips) 
Seat 7: zWJ/yHAvi0TtCR9RMsJosQ ($55.95 in chips) 
Seat 8: f/H6PsHRl4W1JyNsEDvPtg ($14.75 in chips) 
Seat 9: ZWU9RNYtjmm4cElg1I0F4w ($57 in chips) 
JxpnpCmvRAcrEUy7mq1iAg: posts small blind $0.10
zWJ/yHAvi0TtCR9RMsJosQ: posts big blind $0.25
*** HOLE CARDS ***
f/H6PsHRl4W1JyNsEDvPtg: calls $0.25
ZWU9RNYtjmm4cElg1I0F4w: folds 
v5jnQ1gfh9nLla3kMXG7Yg: folds 
jJnMGXoBXye+afMd0k0rUw: raises $0.75 to $1
hJ4uYjNmSZdjrKA8cjZqCA: folds 
aNpwfA31EREwO+ar4XzBCw: folds 
EBPuArucumZnjWoW71jHBg: calls $1
JxpnpCmvRAcrEUy7mq1iAg: folds 
zWJ/yHAvi0TtCR9RMsJosQ: folds 
f/H6PsHRl4W1JyNsEDvPtg: folds 
*** FLOP *** [7h 7s Jd]
jJnMGXoBXye+afMd0k0rUw: checks 
EBPuArucumZnjWoW71jHBg: checks 
*** TURN *** [7h 7s Jd] [9s]
jJnMGXoBXye+afMd0k0rUw: checks 
EBPuArucumZnjWoW71jHBg: bets $1.50
jJnMGXoBXye+afMd0k0rUw: calls $1.50
*** RIVER *** [7h 7s Jd 9s] [2s]
jJnMGXoBXye+afMd0k0rUw: checks 
EBPuArucumZnjWoW71jHBg: bets $2.25
jJnMGXoBXye+afMd0k0rUw: raises $1.15 to $3.40 and is all-in
EBPuArucumZnjWoW71jHBg: calls $1.15
*** SHOW DOWN ***
jJnMGXoBXye+afMd0k0rUw: shows [Jh Jc] (a full house, Jacks full of Sevens)
EBPuArucumZnjWoW71jHBg: mucks hand 
jJnMGXoBXye+afMd0k0rUw collected $11.80 from pot
*** SUMMARY ***
Total pot $12.40 | Rake $0.60 
Board [7h 7s Jd 9s 2s]
Seat 1: v5jnQ1gfh9nLla3kMXG7Yg folded before Flop (didn't bet)
Seat 2: jJnMGXoBXye+afMd0k0rUw showed [Jh Jc] and won ($11.80) with a full house, Jacks full of Sevens
Seat 3: hJ4uYjNmSZdjrKA8cjZqCA folded before Flop (didn't bet)
Seat 4: aNpwfA31EREwO+ar4XzBCw folded before Flop (didn't bet)
Seat 5: EBPuArucumZnjWoW71jHBg (button) mucked
Seat 6: JxpnpCmvRAcrEUy7mq1iAg (small blind) folded before Flop
Seat 7: zWJ/yHAvi0TtCR9RMsJosQ (big blind) folded before Flop
Seat 8: f/H6PsHRl4W1JyNsEDvPtg folded before Flop
Seat 9: ZWU9RNYtjmm4cElg1I0F4w folded before Flop (didn't bet)




PokerStars Game #59939358928:  Hold'em No Limit ($0.10/$0.25) - 2009/07/01 0:37:50 ET
Table 'jxoHy9yJy0bbH/Qx73FoPA' 9-max Seat #4 is the button
Seat 1: jN7A9nKK4RYzhFj4MrekhA ($14.75 in chips) 
Seat 3: /DYYmfrw4B9z+N2z81dNtA ($20.70 in chips) 
Seat 4: RJ/x9oZtt1RZLaJEQwZOxQ ($28.15 in chips) 
Seat 5: vO3QVRovWemcGMkm7ijAIA ($4.40 in chips) 
Seat 6: tYsOBqdU1+x+yFI7zHO7hQ ($52.25 in chips) 
Seat 7: HhlCy99+up/IQbbuxF6uXg ($8 in chips) 
Seat 8: hBMUlEpyU74r/fwDgIpXjQ ($30.60 in chips) 
Seat 9: IG1d4tXnNA98OKRYYE3l+A ($46.15 in chips) 
vO3QVRovWemcGMkm7ijAIA: posts small blind $0.10
tYsOBqdU1+x+yFI7zHO7hQ: posts big blind $0.25
*** HOLE CARDS ***
HhlCy99+up/IQbbuxF6uXg: raises $0.50 to $0.75
lacross84 joins the table at seat #2 
hBMUlEpyU74r/fwDgIpXjQ: folds 
IG1d4tXnNA98OKRYYE3l+A: calls $0.75
jN7A9nKK4RYzhFj4MrekhA: folds 
/DYYmfrw4B9z+N2z81dNtA: folds 
RJ/x9oZtt1RZLaJEQwZOxQ: calls $0.75
vO3QVRovWemcGMkm7ijAIA: folds 
tYsOBqdU1+x+yFI7zHO7hQ: folds 
*** FLOP *** [8d Jd 6d]
HhlCy99+up/IQbbuxF6uXg: bets $1
IG1d4tXnNA98OKRYYE3l+A: raises $1 to $2
RJ/x9oZtt1RZLaJEQwZOxQ: folds 
HhlCy99+up/IQbbuxF6uXg: calls $1
*** TURN *** [8d Jd 6d] [Ts]
HhlCy99+up/IQbbuxF6uXg: bets $2
IG1d4tXnNA98OKRYYE3l+A: raises $2 to $4
HhlCy99+up/IQbbuxF6uXg: raises $1.25 to $5.25 and is all-in
IG1d4tXnNA98OKRYYE3l+A: calls $1.25
*** RIVER *** [8d Jd 6d Ts] [3d]
*** SHOW DOWN ***
HhlCy99+up/IQbbuxF6uXg: shows [Js Jh] (three of a kind, Jacks)
IG1d4tXnNA98OKRYYE3l+A: shows [Ad 9d] (a flush, Ace high)
IG1d4tXnNA98OKRYYE3l+A collected $16.30 from pot
*** SUMMARY ***
Total pot $17.10 | Rake $0.80 
Board [8d Jd 6d Ts 3d]
Seat 1: jN7A9nKK4RYzhFj4MrekhA folded before Flop (didn't bet)
Seat 3: /DYYmfrw4B9z+N2z81dNtA folded before Flop (didn't bet)
Seat 4: RJ/x9oZtt1RZLaJEQwZOxQ (button) folded on the Flop
Seat 5: vO3QVRovWemcGMkm7ijAIA (small blind) folded before Flop
Seat 6: tYsOBqdU1+x+yFI7zHO7hQ (big blind) folded before Flop
Seat 7: HhlCy99+up/IQbbuxF6uXg showed [Js Jh] and lost with three of a kind, Jacks
Seat 8: hBMUlEpyU74r/fwDgIpXjQ folded before Flop (didn't bet)
Seat 9: IG1d4tXnNA98OKRYYE3l+A showed [Ad 9d] and won ($16.30) with a flush, Ace high




PokerStars Game #59939358842:  Hold'em No Limit ($0.10/$0.25) - 2009/07/01 0:37:50 ET
Table 'hOE09W281uSob0XeJmUcRg' 6-max Seat #5 is the button
Seat 3: W6Y6au0wf7gRAlqJYgOezw ($19 in chips) 
Seat 4: TslQs7AQSLbVtr4X8JOOOQ ($20.05 in chips) 
Seat 5: 66a/8+qw1AZLNh63FuclPA ($92.45 in chips) 
Seat 6: x4ZJ8E/TUrtoB7WiHcv8WA ($10.25 in chips) 
x4ZJ8E/TUrtoB7WiHcv8WA: posts small blind $0.10
W6Y6au0wf7gRAlqJYgOezw: posts big blind $0.25
*** HOLE CARDS ***
TslQs7AQSLbVtr4X8JOOOQ: folds 
66a/8+qw1AZLNh63FuclPA: raises $0.50 to $0.75
x4ZJ8E/TUrtoB7WiHcv8WA: folds 
W6Y6au0wf7gRAlqJYgOezw: calls $0.50
*** FLOP *** [9c Ad Kd]
W6Y6au0wf7gRAlqJYgOezw: checks 
edio/rLJ06xeZOfLhoL3UA joins the table at seat #1 
66a/8+qw1AZLNh63FuclPA: bets $1.25
W6Y6au0wf7gRAlqJYgOezw: raises $2.75 to $4
66a/8+qw1AZLNh63FuclPA: calls $2.75
*** TURN *** [9c Ad Kd] [6c]
W6Y6au0wf7gRAlqJYgOezw: bets $5
66a/8+qw1AZLNh63FuclPA: raises $34.75 to $39.75
W6Y6au0wf7gRAlqJYgOezw: folds 
Uncalled bet ($34.75) returned to 66a/8+qw1AZLNh63FuclPA
W6Y6au0wf7gRAlqJYgOezw leaves the table
66a/8+qw1AZLNh63FuclPA collected $18.65 from pot
66a/8+qw1AZLNh63FuclPA: doesn't show hand 
*** SUMMARY ***
Total pot $19.60 | Rake $0.95 
Board [9c Ad Kd 6c]
Seat 3: W6Y6au0wf7gRAlqJYgOezw (big blind) folded on the Turn
Seat 4: TslQs7AQSLbVtr4X8JOOOQ folded before Flop (didn't bet)
Seat 5: 66a/8+qw1AZLNh63FuclPA (button) collected ($18.65)
Seat 6: x4ZJ8E/TUrtoB7WiHcv8WA (small blind) folded before Flop




PokerStars Game #59939359000:  Hold'em No Limit ($0.10/$0.25) - 2009/07/01 0:37:51 ET
Table 'xkqAWQFDrFt4p81M8UsoNw' 9-max Seat #6 is the button
Seat 2: z5GxcHlYz/GSz6W2uFiTtg ($34.55 in chips) 
Seat 3: HEUqKs2EYYGGXJCepUdL0g ($7.60 in chips) 
Seat 4: gY+PO8PaVC7pBPH/9HSv6Q ($4.25 in chips) 
Seat 5: OiV1PWZ3IkN29JlmCcnTwQ ($4.55 in chips) 
Seat 6: Yv4fucyyT28mjx8V5lxKJg ($23.90 in chips) 
Seat 7: MG90wfSJZnOejs/KD3vlQQ ($48.15 in chips) 
Seat 8: s7Q6uNouhe7aE8JdFb9E+A ($28.25 in chips) 
Seat 9: Wa7bjLwN7ptOQro84PxQGw ($5.10 in chips) 
MG90wfSJZnOejs/KD3vlQQ: posts small blind $0.10
s7Q6uNouhe7aE8JdFb9E+A: posts big blind $0.25
*** HOLE CARDS ***
Wa7bjLwN7ptOQro84PxQGw: folds 
z5GxcHlYz/GSz6W2uFiTtg: folds 
HEUqKs2EYYGGXJCepUdL0g: folds 
gY+PO8PaVC7pBPH/9HSv6Q: raises $0.75 to $1
OiV1PWZ3IkN29JlmCcnTwQ: folds 
Yv4fucyyT28mjx8V5lxKJg: folds 
MG90wfSJZnOejs/KD3vlQQ: folds 
s7Q6uNouhe7aE8JdFb9E+A: folds 
Uncalled bet ($0.75) returned to gY+PO8PaVC7pBPH/9HSv6Q
gY+PO8PaVC7pBPH/9HSv6Q collected $0.60 from pot
*** SUMMARY ***
Total pot $0.60 | Rake $0 
Seat 2: z5GxcHlYz/GSz6W2uFiTtg folded before Flop (didn't bet)
Seat 3: HEUqKs2EYYGGXJCepUdL0g folded before Flop (didn't bet)
Seat 4: gY+PO8PaVC7pBPH/9HSv6Q collected ($0.60)
Seat 5: OiV1PWZ3IkN29JlmCcnTwQ folded before Flop (didn't bet)
Seat 6: Yv4fucyyT28mjx8V5lxKJg (button) folded before Flop (didn't bet)
Seat 7: MG90wfSJZnOejs/KD3vlQQ (small blind) folded before Flop
Seat 8: s7Q6uNouhe7aE8JdFb9E+A (big blind) folded before Flop
Seat 9: Wa7bjLwN7ptOQro84PxQGw folded before Flop (didn't bet)




PokerStars Game #59939359684:  Hold'em No Limit ($0.10/$0.25) - 2009/07/01 0:37:51 ET
Table 'sIHZ0lzLr4NGCaBUKhmYhAJj2eLzVCUVAGBmM+Og79iQax Seat #6 is the button
Seat 1: /XMgGtJ7mcWfe5s7McY9kw ($43.25 in chips) 
Seat 2: oMxwMC7+uAsJudeUN6aP0A ($12.90 in chips) 
Seat 3: HPEB+AtKw1+C/cxU0o1ciw ($24.05 in chips) 
Seat 4: aNpwfA31EREwO+ar4XzBCw ($47.05 in chips) 
Seat 5: UOx+/JnFB2Or6ZU9oasIlQ ($22.90 in chips) 
Seat 6: ZeR3hkj1gVv9J4yPCmRrjA ($32.25 in chips) 
Seat 8: 16Yp3bX9mgiQWREpX0V1Ag ($9.40 in chips) 
Seat 9: wU1LtrccnZo6PYKhlJ6ElQ ($29.60 in chips) 
16Yp3bX9mgiQWREpX0V1Ag: posts small blind $0.10
wU1LtrccnZo6PYKhlJ6ElQ: posts big blind $0.25
*** HOLE CARDS ***
oMxwMC7+uAsJudeUN6aP0A said, "nh"
/XMgGtJ7mcWfe5s7McY9kw: calls $0.25
oMxwMC7+uAsJudeUN6aP0A: calls $0.25
HPEB+AtKw1+C/cxU0o1ciw: folds 
aNpwfA31EREwO+ar4XzBCw: folds 
UOx+/JnFB2Or6ZU9oasIlQ: calls $0.25
ZeR3hkj1gVv9J4yPCmRrjA: calls $0.25
16Yp3bX9mgiQWREpX0V1Ag: calls $0.15
wU1LtrccnZo6PYKhlJ6ElQ: checks 
*** FLOP *** [Ah Jh 7d]
16Yp3bX9mgiQWREpX0V1Ag: bets $0.75
wU1LtrccnZo6PYKhlJ6ElQ: calls $0.75
/XMgGtJ7mcWfe5s7McY9kw: calls $0.75
oMxwMC7+uAsJudeUN6aP0A: folds 
UOx+/JnFB2Or6ZU9oasIlQ: folds 
ZeR3hkj1gVv9J4yPCmRrjA: folds 
*** TURN *** [Ah Jh 7d] [Qh]
16Yp3bX9mgiQWREpX0V1Ag: bets $1
wU1LtrccnZo6PYKhlJ6ElQ: calls $1
/XMgGtJ7mcWfe5s7McY9kw: folds 
*** RIVER *** [Ah Jh 7d Qh] [9c]
16Yp3bX9mgiQWREpX0V1Ag: bets $1.25
wU1LtrccnZo6PYKhlJ6ElQ: raises $2.50 to $3.75
16Yp3bX9mgiQWREpX0V1Ag: calls $2.50
*** SHOW DOWN ***
wU1LtrccnZo6PYKhlJ6ElQ: shows [Kh Th] (a Royal Flush)
16Yp3bX9mgiQWREpX0V1Ag: mucks hand 
wU1LtrccnZo6PYKhlJ6ElQ collected $12.60 from pot
*** SUMMARY ***
Total pot $13.25 | Rake $0.65 
Board [Ah Jh 7d Qh 9c]
Seat 1: /XMgGtJ7mcWfe5s7McY9kw folded on the Turn
Seat 2: oMxwMC7+uAsJudeUN6aP0A folded on the Flop
Seat 3: HPEB+AtKw1+C/cxU0o1ciw folded before Flop (didn't bet)
Seat 4: aNpwfA31EREwO+ar4XzBCw folded before Flop (didn't bet)
Seat 5: UOx+/JnFB2Or6ZU9oasIlQ folded on the Flop
Seat 6: ZeR3hkj1gVv9J4yPCmRrjA (button) folded on the Flop
Seat 8: 16Yp3bX9mgiQWREpX0V1Ag (small blind) mucked
Seat 9: wU1LtrccnZo6PYKhlJ6ElQ (big blind) showed [Kh Th] and won ($12.60) with a Royal Flush




PokerStars Game #59939359388:  Hold'em No Limit ($0.10/$0.25) - 2009/07/01 0:37:51 ET
Table '4hfTdIVT/qPsJNfWXLsVIw' 9-max Seat #1 is the button
Seat 1: GbHFBbLqLGz0Pwn6CJeAuw ($25.20 in chips) 
Seat 2: NB5rKy+grn9jKcWXclZ7WA ($33.50 in chips) 
Seat 3: opOCI2p6kW0tINuVaAqmcQ ($25.15 in chips) 
Seat 4: OiV1PWZ3IkN29JlmCcnTwQ ($4.90 in chips) 
Seat 6: VWUWpMLMj/Q1jRVpF7Aohw ($8.70 in chips) 
Seat 7: z5GxcHlYz/GSz6W2uFiTtg ($32.15 in chips) 
Seat 8: EfRs3ibIxn+c9JDErwwNCg ($31.65 in chips) 
Seat 9: K5byIbXY6S+c1wAeHitZow ($12.60 in chips) 
NB5rKy+grn9jKcWXclZ7WA: posts small blind $0.10
opOCI2p6kW0tINuVaAqmcQ: posts big blind $0.25
*** HOLE CARDS ***
OiV1PWZ3IkN29JlmCcnTwQ: folds 
VWUWpMLMj/Q1jRVpF7Aohw: folds 
z5GxcHlYz/GSz6W2uFiTtg: calls $0.25
EfRs3ibIxn+c9JDErwwNCg: folds 
K5byIbXY6S+c1wAeHitZow: calls $0.25
GbHFBbLqLGz0Pwn6CJeAuw: calls $0.25
NB5rKy+grn9jKcWXclZ7WA: folds 
opOCI2p6kW0tINuVaAqmcQ: checks 
*** FLOP *** [Qd 5d 7c]
opOCI2p6kW0tINuVaAqmcQ: checks 
z5GxcHlYz/GSz6W2uFiTtg: checks 
K5byIbXY6S+c1wAeHitZow: bets $0.25
GbHFBbLqLGz0Pwn6CJeAuw: calls $0.25
opOCI2p6kW0tINuVaAqmcQ: calls $0.25
z5GxcHlYz/GSz6W2uFiTtg: folds 
*** TURN *** [Qd 5d 7c] [2d]
opOCI2p6kW0tINuVaAqmcQ: checks 
K5byIbXY6S+c1wAeHitZow: bets $0.25
GbHFBbLqLGz0Pwn6CJeAuw: calls $0.25
opOCI2p6kW0tINuVaAqmcQ: calls $0.25
*** RIVER *** [Qd 5d 7c 2d] [Td]
IBond007 joins the table at seat #5 
opOCI2p6kW0tINuVaAqmcQ: checks 
K5byIbXY6S+c1wAeHitZow: checks 
GbHFBbLqLGz0Pwn6CJeAuw: checks 
*** SHOW DOWN ***
opOCI2p6kW0tINuVaAqmcQ: shows [9d 9s] (a flush, Queen high)
K5byIbXY6S+c1wAeHitZow: mucks hand 
GbHFBbLqLGz0Pwn6CJeAuw: mucks hand 
opOCI2p6kW0tINuVaAqmcQ collected $2.50 from pot
*** SUMMARY ***
Total pot $2.60 | Rake $0.10 
Board [Qd 5d 7c 2d Td]
Seat 1: GbHFBbLqLGz0Pwn6CJeAuw (button) mucked
Seat 2: NB5rKy+grn9jKcWXclZ7WA (small blind) folded before Flop
Seat 3: opOCI2p6kW0tINuVaAqmcQ (big blind) showed [9d 9s] and won ($2.50) with a flush, Queen high
Seat 4: OiV1PWZ3IkN29JlmCcnTwQ folded before Flop (didn't bet)
Seat 6: VWUWpMLMj/Q1jRVpF7Aohw folded before Flop (didn't bet)
Seat 7: z5GxcHlYz/GSz6W2uFiTtg folded on the Flop
Seat 8: EfRs3ibIxn+c9JDErwwNCg folded before Flop (didn't bet)
Seat 9: K5byIbXY6S+c1wAeHitZow mucked




PokerStars Game #59939359396:  Hold'em No Limit ($0.10/$0.25) - 2009/07/01 0:37:51 ET
Table 'Utmw+yX+E/wdhNDIim90lQ' 9-max Seat #1 is the button
Seat 1: lwlnPm68QGGI/+pnAd4GAw ($50.25 in chips) 
Seat 2: iGMlK+EhUflPB6jKQd95Cg ($25.30 in chips) 
Seat 3: dfNim92Z6XK1/h5SFW5vDg ($25 in chips) 
Seat 4: ifYGvZDHQQ0aam4awTtHwA ($13.70 in chips) 
Seat 5: H9KUl8cmpLgEpOVDA00bCg ($4.30 in chips) 
Seat 6: /67o0BjW8sY1ZxYt7/6StQ ($13.60 in chips) 
Seat 7: CImUHesK+ZER4v/VCA9IUg ($64.80 in chips) 
Seat 8: DdPXdieucQ+n99u1n3A+rQ ($4.90 in chips) 
Seat 9: Th3FldXKQW6hWVVPahaoOQ ($28.75 in chips) 
iGMlK+EhUflPB6jKQd95Cg: posts small blind $0.10
dfNim92Z6XK1/h5SFW5vDg: posts big blind $0.25
*** HOLE CARDS ***
ifYGvZDHQQ0aam4awTtHwA: raises $1 to $1.25
H9KUl8cmpLgEpOVDA00bCg: folds 
/67o0BjW8sY1ZxYt7/6StQ: folds 
CImUHesK+ZER4v/VCA9IUg: folds 
DdPXdieucQ+n99u1n3A+rQ: folds 
Th3FldXKQW6hWVVPahaoOQ: calls $1.25
lwlnPm68QGGI/+pnAd4GAw: folds 
iGMlK+EhUflPB6jKQd95Cg: folds 
dfNim92Z6XK1/h5SFW5vDg: folds 
*** FLOP *** [4s As 7d]
ifYGvZDHQQ0aam4awTtHwA: bets $0.75
Th3FldXKQW6hWVVPahaoOQ: folds 
Uncalled bet ($0.75) returned to ifYGvZDHQQ0aam4awTtHwA
ifYGvZDHQQ0aam4awTtHwA collected $2.75 from pot
*** SUMMARY ***
Total pot $2.85 | Rake $0.10 
Board [4s As 7d]
Seat 1: lwlnPm68QGGI/+pnAd4GAw (button) folded before Flop (didn't bet)
Seat 2: iGMlK+EhUflPB6jKQd95Cg (small blind) folded before Flop
Seat 3: dfNim92Z6XK1/h5SFW5vDg (big blind) folded before Flop
Seat 4: ifYGvZDHQQ0aam4awTtHwA collected ($2.75)
Seat 5: H9KUl8cmpLgEpOVDA00bCg folded before Flop (didn't bet)
Seat 6: /67o0BjW8sY1ZxYt7/6StQ folded before Flop (didn't bet)
Seat 7: CImUHesK+ZER4v/VCA9IUg folded before Flop (didn't bet)
Seat 8: DdPXdieucQ+n99u1n3A+rQ folded before Flop (didn't bet)
Seat 9: Th3FldXKQW6hWVVPahaoOQ folded on the Flop




PokerStars Game #59939359192:  Hold'em No Limit ($0.10/$0.25) - 2009/07/01 0:37:51 ET
Table '5510FxlYzKi+U6MIpo8IPA' 6-max Seat #4 is the button
Seat 1: KM6ogk7SqyRlk3m9b0h+7A ($18.55 in chips) 
Seat 2: DC32yoMFAClimBnPIND2eA ($28.30 in chips) 
Seat 3: v+QfkGiuj9bgtuNoVnDO8w ($26.20 in chips) 
Seat 4: cPO/1/dTcZpLkQFm3jH3Rg ($29.40 in chips) 
Seat 5: 5E1iMY5xyboow7Xm0v7Idw ($13.40 in chips) 
Seat 6: SFmT9ZsVopnukjvAzrxTRg ($30.45 in chips) 
5E1iMY5xyboow7Xm0v7Idw: posts small blind $0.10
SFmT9ZsVopnukjvAzrxTRg: posts big blind $0.25
*** HOLE CARDS ***
KM6ogk7SqyRlk3m9b0h+7A: raises $0.50 to $0.75
DC32yoMFAClimBnPIND2eA: folds 
v+QfkGiuj9bgtuNoVnDO8w: folds 
cPO/1/dTcZpLkQFm3jH3Rg: folds 
5E1iMY5xyboow7Xm0v7Idw: folds 
SFmT9ZsVopnukjvAzrxTRg: folds 
Uncalled bet ($0.50) returned to KM6ogk7SqyRlk3m9b0h+7A
KM6ogk7SqyRlk3m9b0h+7A collected $0.60 from pot
KM6ogk7SqyRlk3m9b0h+7A: doesn't show hand 
*** SUMMARY ***
Total pot $0.60 | Rake $0 
Seat 1: KM6ogk7SqyRlk3m9b0h+7A collected ($0.60)
Seat 2: DC32yoMFAClimBnPIND2eA folded before Flop (didn't bet)
Seat 3: v+QfkGiuj9bgtuNoVnDO8w folded before Flop (didn't bet)
Seat 4: cPO/1/dTcZpLkQFm3jH3Rg (button) folded before Flop (didn't bet)
Seat 5: 5E1iMY5xyboow7Xm0v7Idw (small blind) folded before Flop
Seat 6: SFmT9ZsVopnukjvAzrxTRg (big blind) folded before Flop




PokerStars Game #59939359316:  Hold'em No Limit ($0.10/$0.25) - 2009/07/01 0:37:51 ET
Table 'vZfV/Uj0q8joA1du9sRJSg' 6-max Seat #5 is the button
Seat 1: OAmGQMdOxnvuBNHdADx0ew ($8 in chips) 
Seat 2: wMiE3yTbDJGOLOF9th7KPA ($12.95 in chips) 
Seat 3: QJ/0wT0pYdWbDuqo9eNJgQ ($5.15 in chips) 
Seat 4: v+QfkGiuj9bgtuNoVnDO8w ($25 in chips) 
Seat 5: FStoHe64SQWqAsjya9pDkQ ($25.25 in chips) 
Seat 6: 8ClCHtFXGNplITm+63KB+Q ($26.30 in chips) 
8ClCHtFXGNplITm+63KB+Q: posts small blind $0.10
OAmGQMdOxnvuBNHdADx0ew: posts big blind $0.25
*** HOLE CARDS ***
wMiE3yTbDJGOLOF9th7KPA: calls $0.25
QJ/0wT0pYdWbDuqo9eNJgQ: raises $0.75 to $1
v+QfkGiuj9bgtuNoVnDO8w: folds 
FStoHe64SQWqAsjya9pDkQ: folds 
8ClCHtFXGNplITm+63KB+Q: folds 
OAmGQMdOxnvuBNHdADx0ew: calls $0.75
wMiE3yTbDJGOLOF9th7KPA: folds 
*** FLOP *** [Ks 9h Td]
OAmGQMdOxnvuBNHdADx0ew: checks 
QJ/0wT0pYdWbDuqo9eNJgQ: bets $1
OAmGQMdOxnvuBNHdADx0ew: folds 
Uncalled bet ($1) returned to QJ/0wT0pYdWbDuqo9eNJgQ
QJ/0wT0pYdWbDuqo9eNJgQ collected $2.25 from pot
QJ/0wT0pYdWbDuqo9eNJgQ: doesn't show hand 
*** SUMMARY ***
Total pot $2.35 | Rake $0.10 
Board [Ks 9h Td]
Seat 1: OAmGQMdOxnvuBNHdADx0ew (big blind) folded on the Flop
Seat 2: wMiE3yTbDJGOLOF9th7KPA folded before Flop
Seat 3: QJ/0wT0pYdWbDuqo9eNJgQ collected ($2.25)
Seat 4: v+QfkGiuj9bgtuNoVnDO8w folded before Flop (didn't bet)
Seat 5: FStoHe64SQWqAsjya9pDkQ (button) folded before Flop (didn't bet)
Seat 6: 8ClCHtFXGNplITm+63KB+Q (small blind) folded before Flop




PokerStars Game #59939359566:  Hold'em No Limit ($0.10/$0.25) - 2009/07/01 0:37:51 ET
Table 'T/iCKJXGphRN3xcdwfE/JQ' 6-max Seat #2 is the button
Seat 1: zZ8zH49EwNs0mqgppOaL9g ($25 in chips) 
Seat 2: FHilMb2i2DbUCc9lplszog ($21.45 in chips) 
Seat 3: R6AGToFJQOYVZAjC2jXEKw ($25.95 in chips) 
Seat 4: yzFNNFIfC89bBPwpFPx2ow ($38.35 in chips) 
Seat 6: jKYGBgexhqKT13Xana4EHg ($11.55 in chips) 
R6AGToFJQOYVZAjC2jXEKw: posts small blind $0.10
yzFNNFIfC89bBPwpFPx2ow: posts big blind $0.25
*** HOLE CARDS ***
jKYGBgexhqKT13Xana4EHg: calls $0.25
zZ8zH49EwNs0mqgppOaL9g: raises $0.75 to $1
FHilMb2i2DbUCc9lplszog: raises $1.50 to $2.50
R6AGToFJQOYVZAjC2jXEKw: folds 
yzFNNFIfC89bBPwpFPx2ow: folds 
jKYGBgexhqKT13Xana4EHg: folds 
zZ8zH49EwNs0mqgppOaL9g: folds 
Uncalled bet ($1.50) returned to FHilMb2i2DbUCc9lplszog
FHilMb2i2DbUCc9lplszog collected $2.60 from pot
*** SUMMARY ***
Total pot $2.60 | Rake $0 
Seat 1: zZ8zH49EwNs0mqgppOaL9g folded before Flop
Seat 2: FHilMb2i2DbUCc9lplszog (button) collected ($2.60)
Seat 3: R6AGToFJQOYVZAjC2jXEKw (small blind) folded before Flop
Seat 4: yzFNNFIfC89bBPwpFPx2ow (big blind) folded before Flop
Seat 6: jKYGBgexhqKT13Xana4EHg folded before Flop




PokerStars Game #59939359370:  Hold'em No Limit ($0.10/$0.25) - 2009/07/01 0:37:51 ET
Table 'FE/j6VqBY4j9Uq+VHURQCQ' 6-max Seat #1 is the button
Seat 1: wKFJ513ucluNNiMlkXcDOQ ($43.75 in chips) 
Seat 2: gh0Jkra5bJ5RFIDWbx9zqA ($12.70 in chips) 
Seat 3: Zijzy/UtPWzWVUo81HHVjQ ($50.10 in chips) 
Seat 5: wsP46AGpqDjHZQmlRHKa9g ($25 in chips) 
Seat 6: kARKwAmU6kWJfiSICTYhVw ($14.35 in chips) 
gh0Jkra5bJ5RFIDWbx9zqA: posts small blind $0.10
Zijzy/UtPWzWVUo81HHVjQ: posts big blind $0.25
*** HOLE CARDS ***
wsP46AGpqDjHZQmlRHKa9g: folds 
kARKwAmU6kWJfiSICTYhVw: folds 
wKFJ513ucluNNiMlkXcDOQ: raises $0.75 to $1
gh0Jkra5bJ5RFIDWbx9zqA: folds 
cPO/1/dTcZpLkQFm3jH3Rg joins the table at seat #4 
Zijzy/UtPWzWVUo81HHVjQ: folds 
Uncalled bet ($0.75) returned to wKFJ513ucluNNiMlkXcDOQ
wKFJ513ucluNNiMlkXcDOQ collected $0.60 from pot
wKFJ513ucluNNiMlkXcDOQ: doesn't show hand 
*** SUMMARY ***
Total pot $0.60 | Rake $0 
Seat 1: wKFJ513ucluNNiMlkXcDOQ (button) collected ($0.60)
Seat 2: gh0Jkra5bJ5RFIDWbx9zqA (small blind) folded before Flop
Seat 3: Zijzy/UtPWzWVUo81HHVjQ (big blind) folded before Flop
Seat 5: wsP46AGpqDjHZQmlRHKa9g folded before Flop (didn't bet)
Seat 6: kARKwAmU6kWJfiSICTYhVw folded before Flop (didn't bet)




PokerStars Game #59939359442:  Hold'em No Limit ($0.10/$0.25) - 2009/07/01 0:37:51 ET
Table 'sgdCtiuCu2BDZhyDi6RzTA' 6-max Seat #2 is the button
Seat 2: FONMraB4GCHzDwDcfciKyw ($25 in chips) 
Seat 3: yzFNNFIfC89bBPwpFPx2ow ($15.45 in chips) 
Seat 4: rVKEgilmMX+EkKzDVvhmxA ($6.75 in chips) 
Seat 5: kD/Cb2UM93FAVgDMhEEb5g ($12.95 in chips) 
Seat 6: KODslGU8ikCYS0/29dUkhg ($8.10 in chips) 
yzFNNFIfC89bBPwpFPx2ow: posts small blind $0.10
rVKEgilmMX+EkKzDVvhmxA: posts big blind $0.25
3zD3qLXT1bEffAoWGnc7wg: sits out 
*** HOLE CARDS ***
kD/Cb2UM93FAVgDMhEEb5g: folds 
KODslGU8ikCYS0/29dUkhg: folds 
FONMraB4GCHzDwDcfciKyw: folds 
yzFNNFIfC89bBPwpFPx2ow: folds 
Uncalled bet ($0.15) returned to rVKEgilmMX+EkKzDVvhmxA
rVKEgilmMX+EkKzDVvhmxA collected $0.20 from pot
*** SUMMARY ***
Total pot $0.20 | Rake $0 
Seat 2: FONMraB4GCHzDwDcfciKyw (button) folded before Flop (didn't bet)
Seat 3: yzFNNFIfC89bBPwpFPx2ow (small blind) folded before Flop
Seat 4: rVKEgilmMX+EkKzDVvhmxA (big blind) collected ($0.20)
Seat 5: kD/Cb2UM93FAVgDMhEEb5g folded before Flop (didn't bet)
Seat 6: KODslGU8ikCYS0/29dUkhg folded before Flop (didn't bet)




PokerStars Game #59939359078:  Hold'em No Limit ($0.10/$0.25) - 2009/07/01 0:37:51 ET
Table 'OvOqQoL/QnXuXuQjXo2hIQ' 9-max Seat #5 is the button
Seat 3: uJlzv9KL7hgCIqIS2ofoaw ($11.20 in chips) 
Seat 4: e8solDZU6VFefGEm0DJbUg ($10.80 in chips) 
Seat 5: sJNHTWcSlLHRCZ9+YRLLqA ($28.95 in chips) 
Seat 6: MIVCHqCqqlke0Lb0z7glcw ($46.75 in chips) 
Seat 7: aNpwfA31EREwO+ar4XzBCw ($27.15 in chips) 
Seat 8: 42xLFHn85WRGGaaUZTNvwA ($11.05 in chips) 
Seat 9: VWUWpMLMj/Q1jRVpF7Aohw ($14.60 in chips) 
MIVCHqCqqlke0Lb0z7glcw: posts small blind $0.10
aNpwfA31EREwO+ar4XzBCw: posts big blind $0.25
*** HOLE CARDS ***
42xLFHn85WRGGaaUZTNvwA: folds 
VWUWpMLMj/Q1jRVpF7Aohw: folds 
uJlzv9KL7hgCIqIS2ofoaw: folds 
e8solDZU6VFefGEm0DJbUg: raises $0.25 to $0.50
sJNHTWcSlLHRCZ9+YRLLqA: folds 
MIVCHqCqqlke0Lb0z7glcw: folds 
aNpwfA31EREwO+ar4XzBCw: folds 
Uncalled bet ($0.25) returned to e8solDZU6VFefGEm0DJbUg
e8solDZU6VFefGEm0DJbUg collected $0.60 from pot
e8solDZU6VFefGEm0DJbUg: doesn't show hand 
*** SUMMARY ***
Total pot $0.60 | Rake $0 
Seat 3: uJlzv9KL7hgCIqIS2ofoaw folded before Flop (didn't bet)
Seat 4: e8solDZU6VFefGEm0DJbUg collected ($0.60)
Seat 5: sJNHTWcSlLHRCZ9+YRLLqA (button) folded before Flop (didn't bet)
Seat 6: MIVCHqCqqlke0Lb0z7glcw (small blind) folded before Flop
Seat 7: aNpwfA31EREwO+ar4XzBCw (big blind) folded before Flop
Seat 8: 42xLFHn85WRGGaaUZTNvwA folded before Flop (didn't bet)
Seat 9: VWUWpMLMj/Q1jRVpF7Aohw folded before Flop (didn't bet)




PokerStars Game #59939359266:  Hold'em No Limit ($0.10/$0.25) - 2009/07/01 0:37:51 ET
Table 'IdXp6nyeW4FYaEK4qKCnwQ' 9-max Seat #3 is the button
Seat 1: oZXtkl8jsN0rrT7D/pQTHA ($13.75 in chips) 
Seat 2: HPEB+AtKw1+C/cxU0o1ciw ($28.90 in chips) 
Seat 3: jiyia7h6fmxBdWBkH9lH5A ($4.55 in chips) 
Seat 6: 1K6QGyJP9P9xmRac2fH4OQ ($34.05 in chips) 
Seat 7: CYkY0dNBaYaKs8HVCVn3mQ ($6.65 in chips) 
Seat 8: cZ99hugmLBj9KhTlc8nCSw ($25 in chips) 
Seat 9: 4dd+rKHhaMiTl5LEkADvQQ ($4.90 in chips) 
1K6QGyJP9P9xmRac2fH4OQ: posts small blind $0.10
CYkY0dNBaYaKs8HVCVn3mQ: posts big blind $0.25
*** HOLE CARDS ***
cZ99hugmLBj9KhTlc8nCSw: folds 
4dd+rKHhaMiTl5LEkADvQQ: folds 
oZXtkl8jsN0rrT7D/pQTHA: folds 
HPEB+AtKw1+C/cxU0o1ciw: folds 
jiyia7h6fmxBdWBkH9lH5A: calls $0.25
1K6QGyJP9P9xmRac2fH4OQ: calls $0.15
CYkY0dNBaYaKs8HVCVn3mQ: checks 
*** FLOP *** [3d 4s Jh]
1K6QGyJP9P9xmRac2fH4OQ: bets $0.60
CYkY0dNBaYaKs8HVCVn3mQ: folds 
jiyia7h6fmxBdWBkH9lH5A: calls $0.60
*** TURN *** [3d 4s Jh] [Qh]
1K6QGyJP9P9xmRac2fH4OQ: checks 
jiyia7h6fmxBdWBkH9lH5A: checks 
*** RIVER *** [3d 4s Jh Qh] [Td]
1K6QGyJP9P9xmRac2fH4OQ: checks 
jiyia7h6fmxBdWBkH9lH5A: checks 
*** SHOW DOWN ***
1K6QGyJP9P9xmRac2fH4OQ: shows [Js 8s] (a pair of Jacks)
jiyia7h6fmxBdWBkH9lH5A: mucks hand 
1K6QGyJP9P9xmRac2fH4OQ collected $1.90 from pot
*** SUMMARY ***
Total pot $1.95 | Rake $0.05 
Board [3d 4s Jh Qh Td]
Seat 1: oZXtkl8jsN0rrT7D/pQTHA folded before Flop (didn't bet)
Seat 2: HPEB+AtKw1+C/cxU0o1ciw folded before Flop (didn't bet)
Seat 3: jiyia7h6fmxBdWBkH9lH5A (button) mucked
Seat 6: 1K6QGyJP9P9xmRac2fH4OQ (small blind) showed [Js 8s] and won ($1.90) with a pair of Jacks
Seat 7: CYkY0dNBaYaKs8HVCVn3mQ (big blind) folded on the Flop
Seat 8: cZ99hugmLBj9KhTlc8nCSw folded before Flop (didn't bet)
Seat 9: 4dd+rKHhaMiTl5LEkADvQQ folded before Flop (didn't bet)




PokerStars Game #59939359318:  Hold'em No Limit ($0.10/$0.25) - 2009/07/01 0:37:51 ET
Table 'I0ZcuiUTeLuGYv26Nah7YA' 9-max Seat #5 is the button
Seat 1: iMiqaPr7dx84UF0wNUeh8A ($20.55 in chips) 
Seat 2: zE0IkNrJoJD964o4eqmCxQ ($6.05 in chips) 
Seat 3: 1S/fpm+f42V/6MNZre+ccg ($27.95 in chips) 
Seat 4: 4awUyiDYTgylQKXZ9faBVA ($29.90 in chips) 
Seat 5: opOCI2p6kW0tINuVaAqmcQ ($45 in chips) 
Seat 7: JxpnpCmvRAcrEUy7mq1iAg ($5.40 in chips) 
Seat 9: 2mQl0jr5DPlr6jqhvCq8Xw ($4.20 in chips) 
JxpnpCmvRAcrEUy7mq1iAg: posts small blind $0.10
2mQl0jr5DPlr6jqhvCq8Xw: posts big blind $0.25
*** HOLE CARDS ***
iMiqaPr7dx84UF0wNUeh8A: folds 
zE0IkNrJoJD964o4eqmCxQ: folds 
1S/fpm+f42V/6MNZre+ccg: folds 
4awUyiDYTgylQKXZ9faBVA: raises $0.75 to $1
opOCI2p6kW0tINuVaAqmcQ: folds 
JxpnpCmvRAcrEUy7mq1iAg: folds 
2mQl0jr5DPlr6jqhvCq8Xw: folds 
Uncalled bet ($0.75) returned to 4awUyiDYTgylQKXZ9faBVA
4awUyiDYTgylQKXZ9faBVA collected $0.60 from pot
4awUyiDYTgylQKXZ9faBVA: doesn't show hand 
*** SUMMARY ***
Total pot $0.60 | Rake $0 
Seat 1: iMiqaPr7dx84UF0wNUeh8A folded before Flop (didn't bet)
Seat 2: zE0IkNrJoJD964o4eqmCxQ folded before Flop (didn't bet)
Seat 3: 1S/fpm+f42V/6MNZre+ccg folded before Flop (didn't bet)
Seat 4: 4awUyiDYTgylQKXZ9faBVA collected ($0.60)
Seat 5: opOCI2p6kW0tINuVaAqmcQ (button) folded before Flop (didn't bet)
Seat 7: JxpnpCmvRAcrEUy7mq1iAg (small blind) folded before Flop
Seat 9: 2mQl0jr5DPlr6jqhvCq8Xw (big blind) folded before Flop




PokerStars Game #59939359812:  Hold'em No Limit ($0.10/$0.25) - 2009/07/01 0:37:52 ET
Table 'D1Yq70l0nNCyMV6DA42p+Q' 9-max Seat #2 is the button
Seat 1: z5GxcHlYz/GSz6W2uFiTtg ($13.35 in chips) 
Seat 2: OB0uLxxDeISeDjs0cxaocA ($32 in chips) 
Seat 3: j4q3p0lesp63b1gZDwLBZw ($5 in chips) 
Seat 5: gehe91e0IyVT0QU/XBkEyg ($26.05 in chips) 
Seat 7: 9mw49/JQZ9pj0wFynA329g ($14.95 in chips) 
Seat 8: zDrucyjVn5aeekNEc3cJrA ($22.95 in chips) 
Seat 9: 3PjJjazzeHcM4mbFeXmZBg ($2.90 in chips) 
j4q3p0lesp63b1gZDwLBZw: posts small blind $0.10
42xLFHn85WRGGaaUZTNvwA: is sitting out 
gehe91e0IyVT0QU/XBkEyg: posts big blind $0.25
MgMavn/DzTzqKgHTZMsVSw: sits out 
*** HOLE CARDS ***
9mw49/JQZ9pj0wFynA329g: calls $0.25
42xLFHn85WRGGaaUZTNvwA leaves the table
zDrucyjVn5aeekNEc3cJrA: folds 
3PjJjazzeHcM4mbFeXmZBg: folds 
z5GxcHlYz/GSz6W2uFiTtg: calls $0.25
OB0uLxxDeISeDjs0cxaocA: calls $0.25
j4q3p0lesp63b1gZDwLBZw: folds 
gehe91e0IyVT0QU/XBkEyg: checks 
*** FLOP *** [5c 9c Tc]
gehe91e0IyVT0QU/XBkEyg: checks 
9mw49/JQZ9pj0wFynA329g: checks 
z5GxcHlYz/GSz6W2uFiTtg: bets $0.50
OB0uLxxDeISeDjs0cxaocA: calls $0.50
gehe91e0IyVT0QU/XBkEyg: folds 
9mw49/JQZ9pj0wFynA329g: folds 
*** TURN *** [5c 9c Tc] [Ad]
z5GxcHlYz/GSz6W2uFiTtg: bets $1.50
OB0uLxxDeISeDjs0cxaocA: folds 
Uncalled bet ($1.50) returned to z5GxcHlYz/GSz6W2uFiTtg
z5GxcHlYz/GSz6W2uFiTtg collected $2 from pot
*** SUMMARY ***
Total pot $2.10 | Rake $0.10 
Board [5c 9c Tc Ad]
Seat 1: z5GxcHlYz/GSz6W2uFiTtg collected ($2)
Seat 2: OB0uLxxDeISeDjs0cxaocA (button) folded on the Turn
Seat 3: j4q3p0lesp63b1gZDwLBZw (small blind) folded before Flop
Seat 5: gehe91e0IyVT0QU/XBkEyg (big blind) folded on the Flop
Seat 7: 9mw49/JQZ9pj0wFynA329g folded on the Flop
Seat 8: zDrucyjVn5aeekNEc3cJrA folded before Flop (didn't bet)
Seat 9: 3PjJjazzeHcM4mbFeXmZBg folded before Flop (didn't bet)




PokerStars Game #59939359854:  Hold'em No Limit ($0.10/$0.25) - 2009/07/01 0:37:52 ET
Table 'sIHZ0lzLr4NGCaBUKhmYhA' 6-max Seat #1 is the button
Seat 1: q6WfTUAD9mowIP63ASq2Dg ($34.10 in chips) 
Seat 2: 1xmHIWgZaOCqEMnW2GkFfw ($11.10 in chips) 
Seat 3: SxIIgwXYLkwd6m3wLyPTCw ($25 in chips) 
Seat 4: 4YSTu0Cdzpppe1lUgCZGCQ ($33.90 in chips) 
Seat 5: q9qPRjJC40e/Q9yuT+glwQ ($25.85 in chips) 
1xmHIWgZaOCqEMnW2GkFfw: posts small blind $0.10
SxIIgwXYLkwd6m3wLyPTCw: posts big blind $0.25
*** HOLE CARDS ***
4YSTu0Cdzpppe1lUgCZGCQ: folds 
q9qPRjJC40e/Q9yuT+glwQ: folds 
q6WfTUAD9mowIP63ASq2Dg: folds 
q9qPRjJC40e/Q9yuT+glwQ is sitting out
1xmHIWgZaOCqEMnW2GkFfw: calls $0.15
SxIIgwXYLkwd6m3wLyPTCw: raises $0.75 to $1
1xmHIWgZaOCqEMnW2GkFfw: folds 
Uncalled bet ($0.75) returned to SxIIgwXYLkwd6m3wLyPTCw
SxIIgwXYLkwd6m3wLyPTCw collected $0.50 from pot
SxIIgwXYLkwd6m3wLyPTCw: doesn't show hand 
*** SUMMARY ***
Total pot $0.50 | Rake $0 
Seat 1: q6WfTUAD9mowIP63ASq2Dg (button) folded before Flop (didn't bet)
Seat 2: 1xmHIWgZaOCqEMnW2GkFfw (small blind) folded before Flop
Seat 3: SxIIgwXYLkwd6m3wLyPTCw (big blind) collected ($0.50)
Seat 4: 4YSTu0Cdzpppe1lUgCZGCQ folded before Flop (didn't bet)
Seat 5: q9qPRjJC40e/Q9yuT+glwQ folded before Flop (didn't bet)




PokerStars Game #59939360136:  Hold'em No Limit ($0.10/$0.25) - 2009/07/01 0:37:52 ET
Table 'NtEQAxCeIK2io1CGtW658g' 6-max Seat #6 is the button
Seat 1: lnOV7k25gyN7L5t5YKTgIg ($20.60 in chips) 
Seat 2: nc79pm0LZRdhncq55evVqA ($25 in chips) 
Seat 4: 8296 ($13.10 in chips) 
Seat 5: FStoHe64SQWqAsjya9pDkQ ($26.45 in chips) 
Seat 6: /gJNBeCkWL4o85/jvlZ4BA ($63.10 in chips) 
lnOV7k25gyN7L5t5YKTgIg: posts small blind $0.10
nc79pm0LZRdhncq55evVqA: posts big blind $0.25
*** HOLE CARDS ***
8296: folds 
FStoHe64SQWqAsjya9pDkQ: raises $0.50 to $0.75
/gJNBeCkWL4o85/jvlZ4BA: calls $0.75
lnOV7k25gyN7L5t5YKTgIg: folds 
nc79pm0LZRdhncq55evVqA: folds 
*** FLOP *** [5c 6s 7c]
FStoHe64SQWqAsjya9pDkQ: bets $1.25
/gJNBeCkWL4o85/jvlZ4BA: folds 
Uncalled bet ($1.25) returned to FStoHe64SQWqAsjya9pDkQ
FStoHe64SQWqAsjya9pDkQ collected $1.80 from pot
FStoHe64SQWqAsjya9pDkQ: doesn't show hand 
*** SUMMARY ***
Total pot $1.85 | Rake $0.05 
Board [5c 6s 7c]
Seat 1: lnOV7k25gyN7L5t5YKTgIg (small blind) folded before Flop
Seat 2: nc79pm0LZRdhncq55evVqA (big blind) folded before Flop
Seat 4: 8296 folded before Flop (didn't bet)
Seat 5: FStoHe64SQWqAsjya9pDkQ collected ($1.80)
Seat 6: /gJNBeCkWL4o85/jvlZ4BA (button) folded on the Flop




PokerStars Game #59939359888:  Hold'em No Limit ($0.10/$0.25) - 2009/07/01 0:37:52 ET
Table '9iHhO6FyZVM8XpSc23TIgg' 6-max Seat #6 is the button
Seat 1: NhUN/JpAprdJeamFBgJH1w ($25 in chips) 
Seat 2: ErIN0JRL5srYjT6en1f8YQ ($23.85 in chips) 
Seat 3: EXTSABh+qTpWWrIkxl3wXg ($44 in chips) 
Seat 4: cfJccEfyn6IkquPN08hFsA ($33.55 in chips) 
Seat 5: WmfI+HZXhME/HMG8E3/H2w ($15.75 in chips) 
Seat 6: 5z4PIVM9IyDWfUi+/MMdTA ($24.30 in chips) 
NhUN/JpAprdJeamFBgJH1w: posts small blind $0.10
ErIN0JRL5srYjT6en1f8YQ: posts big blind $0.25
*** HOLE CARDS ***
EXTSABh+qTpWWrIkxl3wXg: folds 
cfJccEfyn6IkquPN08hFsA: folds 
WmfI+HZXhME/HMG8E3/H2w: calls $0.25
5z4PIVM9IyDWfUi+/MMdTA: calls $0.25
NhUN/JpAprdJeamFBgJH1w: calls $0.15
ErIN0JRL5srYjT6en1f8YQ: checks 
*** FLOP *** [Jh 6c Qd]
NhUN/JpAprdJeamFBgJH1w: checks 
ErIN0JRL5srYjT6en1f8YQ: checks 
WmfI+HZXhME/HMG8E3/H2w: checks 
5z4PIVM9IyDWfUi+/MMdTA: bets $0.75
NhUN/JpAprdJeamFBgJH1w: folds 
ErIN0JRL5srYjT6en1f8YQ: folds 
WmfI+HZXhME/HMG8E3/H2w: folds 
Uncalled bet ($0.75) returned to 5z4PIVM9IyDWfUi+/MMdTA
5z4PIVM9IyDWfUi+/MMdTA collected $0.95 from pot
*** SUMMARY ***
Total pot $1 | Rake $0.05 
Board [Jh 6c Qd]
Seat 1: NhUN/JpAprdJeamFBgJH1w (small blind) folded on the Flop
Seat 2: ErIN0JRL5srYjT6en1f8YQ (big blind) folded on the Flop
Seat 3: EXTSABh+qTpWWrIkxl3wXg folded before Flop (didn't bet)
Seat 4: cfJccEfyn6IkquPN08hFsA folded before Flop (didn't bet)
Seat 5: WmfI+HZXhME/HMG8E3/H2w folded on the Flop
Seat 6: 5z4PIVM9IyDWfUi+/MMdTA (button) collected ($0.95)




PokerStars Game #59939360382:  Hold'em No Limit ($0.10/$0.25) - 2009/07/01 0:37:52 ET
Table 'rjcb+nlE+0GuJ6lBhuCkkA' 6-max Seat #1 is the button
Seat 1: 9jSiy0meE9XJKkdIZwyTEQ ($26.05 in chips) 
Seat 2: d9ecz4Yhx6qRKe5k+fUWdw ($18.80 in chips) 
Seat 3: 8ClCHtFXGNplITm+63KB+Q ($25 in chips) 
Seat 4: NzIFHwilc5zU7QhjDTgTZA ($14.45 in chips) 
Seat 5: GC/9yVD59DUCX7hUI7gcLw ($43.25 in chips) 
Seat 6: 0DvgWV5o6c/jYqQCjm4Haw ($26.70 in chips) 
d9ecz4Yhx6qRKe5k+fUWdw: posts small blind $0.10
8ClCHtFXGNplITm+63KB+Q: posts big blind $0.25
*** HOLE CARDS ***
NzIFHwilc5zU7QhjDTgTZA: raises $0.25 to $0.50
GC/9yVD59DUCX7hUI7gcLw: folds 
0DvgWV5o6c/jYqQCjm4Haw: folds 
9jSiy0meE9XJKkdIZwyTEQ: folds 
d9ecz4Yhx6qRKe5k+fUWdw: folds 
8ClCHtFXGNplITm+63KB+Q: folds 
Uncalled bet ($0.25) returned to NzIFHwilc5zU7QhjDTgTZA
NzIFHwilc5zU7QhjDTgTZA collected $0.60 from pot
*** SUMMARY ***
Total pot $0.60 | Rake $0 
Seat 1: 9jSiy0meE9XJKkdIZwyTEQ (button) folded before Flop (didn't bet)
Seat 2: d9ecz4Yhx6qRKe5k+fUWdw (small blind) folded before Flop
Seat 3: 8ClCHtFXGNplITm+63KB+Q (big blind) folded before Flop
Seat 4: NzIFHwilc5zU7QhjDTgTZA collected ($0.60)
Seat 5: GC/9yVD59DUCX7hUI7gcLw folded before Flop (didn't bet)
Seat 6: 0DvgWV5o6c/jYqQCjm4Haw folded before Flop (didn't bet)




PokerStars Game #59939359982:  Hold'em No Limit ($0.10/$0.25) - 2009/07/01 0:37:52 ET
Table 'WY+lMaAoIdBZmwk27/RJCA' 6-max Seat #3 is the button
Seat 1: lYjWCpfCxX2kgcHY3v4Yow ($25 in chips) 
Seat 2: cPO/1/dTcZpLkQFm3jH3Rg ($25.05 in chips) 
Seat 3: 79Q62AM0VB++TQYiBlOYsA ($38.05 in chips) 
Seat 4: cGfAi40F+9odP4v0stvfiQ ($27.70 in chips) 
Seat 5: wKFJ513ucluNNiMlkXcDOQ ($29.70 in chips) 
Seat 6: I1TxPvWj8NfG8orglCinNA ($25.70 in chips) 
cGfAi40F+9odP4v0stvfiQ: posts small blind $0.10
wKFJ513ucluNNiMlkXcDOQ: posts big blind $0.25
*** HOLE CARDS ***
I1TxPvWj8NfG8orglCinNA has timed out
I1TxPvWj8NfG8orglCinNA: folds 
I1TxPvWj8NfG8orglCinNA is sitting out
lYjWCpfCxX2kgcHY3v4Yow: folds 
I1TxPvWj8NfG8orglCinNA has returned
cPO/1/dTcZpLkQFm3jH3Rg: folds 
79Q62AM0VB++TQYiBlOYsA: folds 
cGfAi40F+9odP4v0stvfiQ: calls $0.15
wKFJ513ucluNNiMlkXcDOQ: checks 
*** FLOP *** [5c Ad 4h]
cGfAi40F+9odP4v0stvfiQ: checks 
wKFJ513ucluNNiMlkXcDOQ: checks 
*** TURN *** [5c Ad 4h] [3h]
cGfAi40F+9odP4v0stvfiQ: checks 
wKFJ513ucluNNiMlkXcDOQ: checks 
*** RIVER *** [5c Ad 4h 3h] [7c]
cGfAi40F+9odP4v0stvfiQ: bets $0.75
wKFJ513ucluNNiMlkXcDOQ: folds 
Uncalled bet ($0.75) returned to cGfAi40F+9odP4v0stvfiQ
cGfAi40F+9odP4v0stvfiQ collected $0.50 from pot
cGfAi40F+9odP4v0stvfiQ: doesn't show hand 
*** SUMMARY ***
Total pot $0.50 | Rake $0 
Board [5c Ad 4h 3h 7c]
Seat 1: lYjWCpfCxX2kgcHY3v4Yow folded before Flop (didn't bet)
Seat 2: cPO/1/dTcZpLkQFm3jH3Rg folded before Flop (didn't bet)
Seat 3: 79Q62AM0VB++TQYiBlOYsA (button) folded before Flop (didn't bet)
Seat 4: cGfAi40F+9odP4v0stvfiQ (small blind) collected ($0.50)
Seat 5: wKFJ513ucluNNiMlkXcDOQ (big blind) folded on the River
Seat 6: I1TxPvWj8NfG8orglCinNA folded before Flop (didn't bet)




PokerStars Game #59939360214:  Hold'em No Limit ($0.10/$0.25) - 2009/07/01 0:37:52 ET
Table '6aL2C8IFwHHr6SG6RgXaow' 9-max Seat #9 is the button
Seat 2: +gMmKt3DaQng9M42CmxIZg ($24.65 in chips) 
Seat 5: wre31HfyzQGpIvID1istxw ($15 in chips) 
Seat 6: HxDF4QSxC4z39D7teZpprQ ($33.90 in chips) 
Seat 7: rPToQDbLWB+dKnz7fcQSIg ($10.40 in chips) 
Seat 8: rQhYIYXSyH/IivYM1dlV5A ($14.40 in chips) 
Seat 9: yduPKWPzL8YlT5Zv/Nmrwg ($15.65 in chips) 
+gMmKt3DaQng9M42CmxIZg: posts small blind $0.10
wre31HfyzQGpIvID1istxw: posts big blind $0.25
*** HOLE CARDS ***
HxDF4QSxC4z39D7teZpprQ: folds 
rPToQDbLWB+dKnz7fcQSIg: folds 
rQhYIYXSyH/IivYM1dlV5A: folds 
yduPKWPzL8YlT5Zv/Nmrwg: folds 
+gMmKt3DaQng9M42CmxIZg: folds 
Uncalled bet ($0.15) returned to wre31HfyzQGpIvID1istxw
wre31HfyzQGpIvID1istxw collected $0.20 from pot
*** SUMMARY ***
Total pot $0.20 | Rake $0 
Seat 2: +gMmKt3DaQng9M42CmxIZg (small blind) folded before Flop
Seat 5: wre31HfyzQGpIvID1istxw (big blind) collected ($0.20)
Seat 6: HxDF4QSxC4z39D7teZpprQ folded before Flop (didn't bet)
Seat 7: rPToQDbLWB+dKnz7fcQSIg folded before Flop (didn't bet)
Seat 8: rQhYIYXSyH/IivYM1dlV5A folded before Flop (didn't bet)
Seat 9: yduPKWPzL8YlT5Zv/Nmrwg (button) folded before Flop (didn't bet)




PokerStars Game #59939359864:  Hold'em No Limit ($0.10/$0.25) - 2009/07/01 0:37:52 ET
Table 'KYX9dFNuOA9l2PV46IebqQ' 9-max Seat #6 is the button
Seat 1: s7Q6uNouhe7aE8JdFb9E+A ($27.40 in chips) 
Seat 2: r6hsffOo1iKmaPYKwAZmFw ($25 in chips) 
Seat 3: f+H1PHwj9cNu4Y6FfvKwQQ ($18.35 in chips) 
Seat 4: SkLOm0UugROBRt2EfMpOxQ ($35.70 in chips) 
Seat 5: HQMjiff9S04k8kyC4fHVgw ($2.55 in chips) 
Seat 6: DiSvPC2iudwL5j9u6Huyww ($25 in chips) 
Seat 7: kmJc9NmBNbE55/AnUDL6/w ($3.60 in chips) 
Seat 8: 4oA316mXLIui1QY63GXBUg ($25.15 in chips) 
Seat 9: W4TLQcZ2TiM73eIgpIvlGg ($33.30 in chips) 
kmJc9NmBNbE55/AnUDL6/w: posts small blind $0.10
4oA316mXLIui1QY63GXBUg: posts big blind $0.25
*** HOLE CARDS ***
W4TLQcZ2TiM73eIgpIvlGg: folds 
s7Q6uNouhe7aE8JdFb9E+A: folds 
r6hsffOo1iKmaPYKwAZmFw: folds 
f+H1PHwj9cNu4Y6FfvKwQQ: folds 
SkLOm0UugROBRt2EfMpOxQ: folds 
HQMjiff9S04k8kyC4fHVgw: folds 
DiSvPC2iudwL5j9u6Huyww: raises $0.75 to $1
kmJc9NmBNbE55/AnUDL6/w: folds 
4oA316mXLIui1QY63GXBUg: folds 
Uncalled bet ($0.75) returned to DiSvPC2iudwL5j9u6Huyww
DiSvPC2iudwL5j9u6Huyww collected $0.60 from pot
DiSvPC2iudwL5j9u6Huyww: doesn't show hand 
*** SUMMARY ***
Total pot $0.60 | Rake $0 
Seat 1: s7Q6uNouhe7aE8JdFb9E+A folded before Flop (didn't bet)
Seat 2: r6hsffOo1iKmaPYKwAZmFw folded before Flop (didn't bet)
Seat 3: f+H1PHwj9cNu4Y6FfvKwQQ folded before Flop (didn't bet)
Seat 4: SkLOm0UugROBRt2EfMpOxQ folded before Flop (didn't bet)
Seat 5: HQMjiff9S04k8kyC4fHVgw folded before Flop (didn't bet)
Seat 6: DiSvPC2iudwL5j9u6Huyww (button) collected ($0.60)
Seat 7: kmJc9NmBNbE55/AnUDL6/w (small blind) folded before Flop
Seat 8: 4oA316mXLIui1QY63GXBUg (big blind) folded before Flop
Seat 9: W4TLQcZ2TiM73eIgpIvlGg folded before Flop (didn't bet)




PokerStars Game #59939359772:  Hold'em No Limit ($0.10/$0.25) - 2009/07/01 0:37:52 ET
Table 'qInMnOOn7vKcj4bU7zju7g' 9-max Seat #5 is the button
Seat 1: 3PjJjazzeHcM4mbFeXmZBg ($3.55 in chips) 
Seat 2: f/H6PsHRl4W1JyNsEDvPtg ($15 in chips) 
Seat 3: zDrucyjVn5aeekNEc3cJrA ($28.15 in chips) 
Seat 4: ZbKV588BRlpe7vF42jT9yg ($9.80 in chips) 
Seat 5: aNpwfA31EREwO+ar4XzBCw ($34.80 in chips) 
Seat 6: r1pFKMwWp74QwhfPWJOAyw ($4.50 in chips) 
Seat 7: 8B/dhbQjIWe6ASCdgzktNQ ($26.95 in chips) 
Seat 9: K7bAhhMMJ/XcTmGaBZVfFQ ($24.25 in chips) 
r1pFKMwWp74QwhfPWJOAyw: posts small blind $0.10
8B/dhbQjIWe6ASCdgzktNQ: posts big blind $0.25
f/H6PsHRl4W1JyNsEDvPtg: posts big blind $0.25
*** HOLE CARDS ***
K7bAhhMMJ/XcTmGaBZVfFQ: folds 
3PjJjazzeHcM4mbFeXmZBg: folds 
f/H6PsHRl4W1JyNsEDvPtg: checks 
zDrucyjVn5aeekNEc3cJrA: folds 
ZbKV588BRlpe7vF42jT9yg: folds 
aNpwfA31EREwO+ar4XzBCw: folds 
r1pFKMwWp74QwhfPWJOAyw: calls $0.15
8B/dhbQjIWe6ASCdgzktNQ: checks 
*** FLOP *** [9s 5h Td]
r1pFKMwWp74QwhfPWJOAyw: checks 
8B/dhbQjIWe6ASCdgzktNQ: bets $0.50
f/H6PsHRl4W1JyNsEDvPtg: folds 
r1pFKMwWp74QwhfPWJOAyw: folds 
Uncalled bet ($0.50) returned to 8B/dhbQjIWe6ASCdgzktNQ
8B/dhbQjIWe6ASCdgzktNQ collected $0.75 from pot
8B/dhbQjIWe6ASCdgzktNQ: doesn't show hand 
*** SUMMARY ***
Total pot $0.75 | Rake $0 
Board [9s 5h Td]
Seat 1: 3PjJjazzeHcM4mbFeXmZBg folded before Flop (didn't bet)
Seat 2: f/H6PsHRl4W1JyNsEDvPtg folded on the Flop
Seat 3: zDrucyjVn5aeekNEc3cJrA folded before Flop (didn't bet)
Seat 4: ZbKV588BRlpe7vF42jT9yg folded before Flop (didn't bet)
Seat 5: aNpwfA31EREwO+ar4XzBCw (button) folded before Flop (didn't bet)
Seat 6: r1pFKMwWp74QwhfPWJOAyw (small blind) folded on the Flop
Seat 7: 8B/dhbQjIWe6ASCdgzktNQ (big blind) collected ($0.75)
Seat 9: K7bAhhMMJ/XcTmGaBZVfFQ folded before Flop (didn't bet)




PokerStars Game #59939361044:  Hold'em No Limit ($0.10/$0.25) - 2009/07/01 0:37:53 ET
Table 'sCop8wmj9zlSS2KJqk1QKQ' 9-max Seat #3 is the button
Seat 1: SXqVW4Q0evTUVZG6BbUNIA ($21.90 in chips) 
Seat 2: W4TLQcZ2TiM73eIgpIvlGg ($22.45 in chips) 
Seat 3: 6TWO15+WfJ5HfI8CbJ4a0w ($3.10 in chips) 
Seat 4: KNrY0Y/j01dK9gZK7dx7QA ($14.75 in chips) 
Seat 6: hZuGwtYmFKPmQ+v1wlmdfA ($35.95 in chips) 
Seat 7: 4dd+rKHhaMiTl5LEkADvQQ ($4.65 in chips) 
Seat 8: NNZypfH1f/VIj3Skf/XIzg ($5 in chips) 
Seat 9: tOdE7+08fkUzsTpCnhoPDA ($22.70 in chips) 
KNrY0Y/j01dK9gZK7dx7QA: posts small blind $0.10
7QzbjWT00wQpau1iqvUmMA: is sitting out 
hZuGwtYmFKPmQ+v1wlmdfA: posts big blind $0.25
*** HOLE CARDS ***
7QzbjWT00wQpau1iqvUmMA leaves the table
4dd+rKHhaMiTl5LEkADvQQ: folds 
NNZypfH1f/VIj3Skf/XIzg: folds 
tOdE7+08fkUzsTpCnhoPDA: folds 
SXqVW4Q0evTUVZG6BbUNIA: folds 
W4TLQcZ2TiM73eIgpIvlGg: raises $0.50 to $0.75
6TWO15+WfJ5HfI8CbJ4a0w: folds 
sD+TKtt36XiiN6jqHiLwDA joins the table at seat #5 
KNrY0Y/j01dK9gZK7dx7QA: folds 
hZuGwtYmFKPmQ+v1wlmdfA: folds 
Uncalled bet ($0.50) returned to W4TLQcZ2TiM73eIgpIvlGg
W4TLQcZ2TiM73eIgpIvlGg collected $0.60 from pot
*** SUMMARY ***
Total pot $0.60 | Rake $0 
Seat 1: SXqVW4Q0evTUVZG6BbUNIA folded before Flop (didn't bet)
Seat 2: W4TLQcZ2TiM73eIgpIvlGg collected ($0.60)
Seat 3: 6TWO15+WfJ5HfI8CbJ4a0w (button) folded before Flop (didn't bet)
Seat 4: KNrY0Y/j01dK9gZK7dx7QA (small blind) folded before Flop
Seat 6: hZuGwtYmFKPmQ+v1wlmdfA (big blind) folded before Flop
Seat 7: 4dd+rKHhaMiTl5LEkADvQQ folded before Flop (didn't bet)
Seat 8: NNZypfH1f/VIj3Skf/XIzg folded before Flop (didn't bet)
Seat 9: tOdE7+08fkUzsTpCnhoPDA folded before Flop (didn't bet)




PokerStars Game #59939360582:  Hold'em No Limit ($0.10/$0.25) - 2009/07/01 0:37:53 ET
Table 'FgLmv9bi/fJP8ldfbTOpkg' 9-max Seat #1 is the button
Seat 1: opOCI2p6kW0tINuVaAqmcQ ($25 in chips) 
Seat 2: mpsfNtnMVDqQHTe92AhIdw ($19.40 in chips) 
Seat 4: WfS0TjI8FyLemNTOo1e9qA ($10.95 in chips) 
Seat 5: D4MF24Gh/tTI6FprZlrQTg ($25.10 in chips) 
Seat 6: oKO7b50N6TzXbPBr/mcrUA ($32.70 in chips) 
Seat 7: eFrBtVXGVoMq1UwCDg8Exg ($24.65 in chips) 
Seat 8: sJNHTWcSlLHRCZ9+YRLLqA ($25 in chips) 
Seat 9: Th3FldXKQW6hWVVPahaoOQ ($25 in chips) 
mpsfNtnMVDqQHTe92AhIdw: posts small blind $0.10
JxpnpCmvRAcrEUy7mq1iAg: is sitting out 
WfS0TjI8FyLemNTOo1e9qA: posts big blind $0.25
*** HOLE CARDS ***
JxpnpCmvRAcrEUy7mq1iAg leaves the table
D4MF24Gh/tTI6FprZlrQTg: folds 
D4MF24Gh/tTI6FprZlrQTg leaves the table
oKO7b50N6TzXbPBr/mcrUA: folds 
eFrBtVXGVoMq1UwCDg8Exg: folds 
sJNHTWcSlLHRCZ9+YRLLqA: folds 
Th3FldXKQW6hWVVPahaoOQ: folds 
opOCI2p6kW0tINuVaAqmcQ: folds 
mpsfNtnMVDqQHTe92AhIdw: raises $0.50 to $0.75
WfS0TjI8FyLemNTOo1e9qA: calls $0.50
*** FLOP *** [6c Qd Qc]
mpsfNtnMVDqQHTe92AhIdw: checks 
WfS0TjI8FyLemNTOo1e9qA: checks 
*** TURN *** [6c Qd Qc] [4s]
mpsfNtnMVDqQHTe92AhIdw: checks 
WfS0TjI8FyLemNTOo1e9qA: checks 
*** RIVER *** [6c Qd Qc 4s] [5s]
mpsfNtnMVDqQHTe92AhIdw: checks 
WfS0TjI8FyLemNTOo1e9qA: bets $1
mpsfNtnMVDqQHTe92AhIdw: folds 
Uncalled bet ($1) returned to WfS0TjI8FyLemNTOo1e9qA
WfS0TjI8FyLemNTOo1e9qA collected $1.45 from pot
*** SUMMARY ***
Total pot $1.50 | Rake $0.05 
Board [6c Qd Qc 4s 5s]
Seat 1: opOCI2p6kW0tINuVaAqmcQ (button) folded before Flop (didn't bet)
Seat 2: mpsfNtnMVDqQHTe92AhIdw (small blind) folded on the River
Seat 4: WfS0TjI8FyLemNTOo1e9qA (big blind) collected ($1.45)
Seat 5: D4MF24Gh/tTI6FprZlrQTg folded before Flop (didn't bet)
Seat 6: oKO7b50N6TzXbPBr/mcrUA folded before Flop (didn't bet)
Seat 7: eFrBtVXGVoMq1UwCDg8Exg folded before Flop (didn't bet)
Seat 8: sJNHTWcSlLHRCZ9+YRLLqA folded before Flop (didn't bet)
Seat 9: Th3FldXKQW6hWVVPahaoOQ folded before Flop (didn't bet)




PokerStars Game #59939360682:  Hold'em No Limit ($0.10/$0.25) - 2009/07/01 0:37:53 ET
Table '2clPgY3+dETPD/8zjXZdFw' 6-max Seat #3 is the button
Seat 2: NzIFHwilc5zU7QhjDTgTZA ($5.90 in chips) 
Seat 3: 6pF9LtHn+EH0ChbOXzox9g ($4.20 in chips) 
6pF9LtHn+EH0ChbOXzox9g: posts small blind $0.10
NzIFHwilc5zU7QhjDTgTZA: posts big blind $0.25
*** HOLE CARDS ***
6pF9LtHn+EH0ChbOXzox9g: folds 
Uncalled bet ($0.15) returned to NzIFHwilc5zU7QhjDTgTZA
NzIFHwilc5zU7QhjDTgTZA collected $0.20 from pot
*** SUMMARY ***
Total pot $0.20 | Rake $0 
Seat 2: NzIFHwilc5zU7QhjDTgTZA (big blind) collected ($0.20)
Seat 3: 6pF9LtHn+EH0ChbOXzox9g (button) (small blind) folded before Flop




PokerStars Game #59939361060:  Hold'em No Limit ($0.10/$0.25) - 2009/07/01 0:37:53 ET
Table 'jz4TpuH+ag+0iNe2ZcxckQ' 9-max Seat #7 is the button
Seat 1: xw6ysR8BJ8Nvn+ibEf2G9w ($6.25 in chips) 
Seat 2: 18G4P1XstjNvItdGUITxgw ($29.80 in chips) 
Seat 3: Z5NNIVvnhb2IJbLcI79WYQ ($2.80 in chips) 
Seat 4: k+2r6di6GXjNpAdrRkW9bA ($63.20 in chips) 
Seat 5: uJlzv9KL7hgCIqIS2ofoaw ($8.80 in chips) 
Seat 6: ymx/m/7IEqTY+OQPano2gg ($10.70 in chips) 
Seat 7: sJNHTWcSlLHRCZ9+YRLLqA ($25 in chips) 
Seat 8: J3kDdqAF7vHwmQ3VsAbsdA ($78.40 in chips) 
Seat 9: 8B/dhbQjIWe6ASCdgzktNQ ($25 in chips) 
J3kDdqAF7vHwmQ3VsAbsdA: posts small blind $0.10
8B/dhbQjIWe6ASCdgzktNQ: posts big blind $0.25
*** HOLE CARDS ***
xw6ysR8BJ8Nvn+ibEf2G9w: calls $0.25
18G4P1XstjNvItdGUITxgw: folds 
Z5NNIVvnhb2IJbLcI79WYQ: calls $0.25
k+2r6di6GXjNpAdrRkW9bA: folds 
uJlzv9KL7hgCIqIS2ofoaw: folds 
ymx/m/7IEqTY+OQPano2gg: folds 
sJNHTWcSlLHRCZ9+YRLLqA: folds 
J3kDdqAF7vHwmQ3VsAbsdA: calls $0.15
8B/dhbQjIWe6ASCdgzktNQ: checks 
*** FLOP *** [5h Qh 8d]
J3kDdqAF7vHwmQ3VsAbsdA: checks 
8B/dhbQjIWe6ASCdgzktNQ: checks 
xw6ysR8BJ8Nvn+ibEf2G9w: checks 
Z5NNIVvnhb2IJbLcI79WYQ: bets $0.50
J3kDdqAF7vHwmQ3VsAbsdA: folds 
8B/dhbQjIWe6ASCdgzktNQ: folds 
xw6ysR8BJ8Nvn+ibEf2G9w: folds 
Uncalled bet ($0.50) returned to Z5NNIVvnhb2IJbLcI79WYQ
Z5NNIVvnhb2IJbLcI79WYQ collected $0.95 from pot
*** SUMMARY ***
Total pot $1 | Rake $0.05 
Board [5h Qh 8d]
Seat 1: xw6ysR8BJ8Nvn+ibEf2G9w folded on the Flop
Seat 2: 18G4P1XstjNvItdGUITxgw folded before Flop (didn't bet)
Seat 3: Z5NNIVvnhb2IJbLcI79WYQ collected ($0.95)
Seat 4: k+2r6di6GXjNpAdrRkW9bA folded before Flop (didn't bet)
Seat 5: uJlzv9KL7hgCIqIS2ofoaw folded before Flop (didn't bet)
Seat 6: ymx/m/7IEqTY+OQPano2gg folded before Flop (didn't bet)
Seat 7: sJNHTWcSlLHRCZ9+YRLLqA (button) folded before Flop (didn't bet)
Seat 8: J3kDdqAF7vHwmQ3VsAbsdA (small blind) folded on the Flop
Seat 9: 8B/dhbQjIWe6ASCdgzktNQ (big blind) folded on the Flop




PokerStars Game #59939360564:  Hold'em No Limit ($0.10/$0.25) - 2009/07/01 0:37:53 ET
Table 'IrJPyZ3JW2iIa+krdoSbJQ' 9-max Seat #9 is the button
Seat 1: 4+E2msto8r80F3SH2gctVA ($24.85 in chips) 
Seat 2: DdPXdieucQ+n99u1n3A+rQ ($5.05 in chips) 
Seat 3: vZGoOTJLQLhkPj4I+LNGig ($25 in chips) 
Seat 4: DnDcAdn9P0zGovMERigpFA ($25 in chips) 
Seat 5: sUVgUtgbfVx6JpvApozwhQ ($5.05 in chips) 
Seat 6: +sbyWwIcFp9kP0bDtMegfQ ($24.30 in chips) 
Seat 7: uH1RN27w9SKa7TpVR9EFrQ ($27.90 in chips) 
Seat 8: VBHxUExRAMrbxUq/cVx9Gw ($5 in chips) 
Seat 9: SXqVW4Q0evTUVZG6BbUNIA ($29.30 in chips) 
4+E2msto8r80F3SH2gctVA: posts small blind $0.10
DdPXdieucQ+n99u1n3A+rQ: posts big blind $0.25
*** HOLE CARDS ***
vZGoOTJLQLhkPj4I+LNGig: folds 
DnDcAdn9P0zGovMERigpFA: folds 
sUVgUtgbfVx6JpvApozwhQ: raises $0.50 to $0.75
+sbyWwIcFp9kP0bDtMegfQ: folds 
uH1RN27w9SKa7TpVR9EFrQ: folds 
VBHxUExRAMrbxUq/cVx9Gw: folds 
SXqVW4Q0evTUVZG6BbUNIA: folds 
4+E2msto8r80F3SH2gctVA: folds 
DdPXdieucQ+n99u1n3A+rQ: folds 
Uncalled bet ($0.50) returned to sUVgUtgbfVx6JpvApozwhQ
sUVgUtgbfVx6JpvApozwhQ collected $0.60 from pot
sUVgUtgbfVx6JpvApozwhQ: doesn't show hand 
*** SUMMARY ***
Total pot $0.60 | Rake $0 
Seat 1: 4+E2msto8r80F3SH2gctVA (small blind) folded before Flop
Seat 2: DdPXdieucQ+n99u1n3A+rQ (big blind) folded before Flop
Seat 3: vZGoOTJLQLhkPj4I+LNGig folded before Flop (didn't bet)
Seat 4: DnDcAdn9P0zGovMERigpFA folded before Flop (didn't bet)
Seat 5: sUVgUtgbfVx6JpvApozwhQ collected ($0.60)
Seat 6: +sbyWwIcFp9kP0bDtMegfQ folded before Flop (didn't bet)
Seat 7: uH1RN27w9SKa7TpVR9EFrQ folded before Flop (didn't bet)
Seat 8: VBHxUExRAMrbxUq/cVx9Gw folded before Flop (didn't bet)
Seat 9: SXqVW4Q0evTUVZG6BbUNIA (button) folded before Flop (didn't bet)




PokerStars Game #59939360642:  Hold'em No Limit ($0.10/$0.25) - 2009/07/01 0:37:53 ET
Table 'iMiAw/kTZXopgYX4HI7sHg' 9-max Seat #6 is the button
Seat 1: 6LFELL8V3NTpb0xg7AOyEg ($22.15 in chips) 
Seat 2: QBNV6v6f+1ZHoaKcQDTWog ($20.20 in chips) 
Seat 3: HPEB+AtKw1+C/cxU0o1ciw ($22.55 in chips) 
Seat 4: S+cUFPGjDERB8nh2Ub77Bg ($12.60 in chips) 
Seat 5: UG5jx0ZzlHKfc+tNQpQoMQ ($1.90 in chips) 
Seat 6: mdk0yKND3u0wCmRU4tNRFg ($28.80 in chips) 
Seat 7: aPRz/2GxbXANYpVsQO8pdQ ($24.75 in chips) 
Seat 8: gU2i78hKxj5RUUH6zCK9bA ($6.75 in chips) 
Seat 9: K36tHfxDQBx3OFpy0baDPA ($16.90 in chips) 
aPRz/2GxbXANYpVsQO8pdQ: posts small blind $0.10
gU2i78hKxj5RUUH6zCK9bA: posts big blind $0.25
*** HOLE CARDS ***
K36tHfxDQBx3OFpy0baDPA: calls $0.25
6LFELL8V3NTpb0xg7AOyEg: folds 
QBNV6v6f+1ZHoaKcQDTWog: calls $0.25
HPEB+AtKw1+C/cxU0o1ciw: folds 
S+cUFPGjDERB8nh2Ub77Bg: folds 
UG5jx0ZzlHKfc+tNQpQoMQ: folds 
mdk0yKND3u0wCmRU4tNRFg: folds 
aPRz/2GxbXANYpVsQO8pdQ: calls $0.15
gU2i78hKxj5RUUH6zCK9bA: checks 
*** FLOP *** [5h 7s 3c]
aPRz/2GxbXANYpVsQO8pdQ: checks 
gU2i78hKxj5RUUH6zCK9bA: checks 
K36tHfxDQBx3OFpy0baDPA: bets $0.25
QBNV6v6f+1ZHoaKcQDTWog: calls $0.25
aPRz/2GxbXANYpVsQO8pdQ: folds 
gU2i78hKxj5RUUH6zCK9bA: folds 
*** TURN *** [5h 7s 3c] [Ac]
K36tHfxDQBx3OFpy0baDPA: checks 
QBNV6v6f+1ZHoaKcQDTWog: bets $0.50
K36tHfxDQBx3OFpy0baDPA: calls $0.50
*** RIVER *** [5h 7s 3c Ac] [3d]
K36tHfxDQBx3OFpy0baDPA: bets $1
QBNV6v6f+1ZHoaKcQDTWog: calls $1
*** SHOW DOWN ***
K36tHfxDQBx3OFpy0baDPA: shows [Ks Ah] (two pair, Aces and Threes)
QBNV6v6f+1ZHoaKcQDTWog: mucks hand 
K36tHfxDQBx3OFpy0baDPA collected $4.30 from pot
*** SUMMARY ***
Total pot $4.50 | Rake $0.20 
Board [5h 7s 3c Ac 3d]
Seat 1: 6LFELL8V3NTpb0xg7AOyEg folded before Flop (didn't bet)
Seat 2: QBNV6v6f+1ZHoaKcQDTWog mucked
Seat 3: HPEB+AtKw1+C/cxU0o1ciw folded before Flop (didn't bet)
Seat 4: S+cUFPGjDERB8nh2Ub77Bg folded before Flop (didn't bet)
Seat 5: UG5jx0ZzlHKfc+tNQpQoMQ folded before Flop (didn't bet)
Seat 6: mdk0yKND3u0wCmRU4tNRFg (button) folded before Flop (didn't bet)
Seat 7: aPRz/2GxbXANYpVsQO8pdQ (small blind) folded on the Flop
Seat 8: gU2i78hKxj5RUUH6zCK9bA (big blind) folded on the Flop
Seat 9: K36tHfxDQBx3OFpy0baDPA showed [Ks Ah] and won ($4.30) with two pair, Aces and Threes




PokerStars Game #59939360594:  Hold'em No Limit ($0.10/$0.25) - 2009/07/01 0:37:53 ET
Table 'U0hCzoS0KCJL+eoE054K4Q' 9-max Seat #7 is the button
Seat 2: MG90wfSJZnOejs/KD3vlQQ ($25 in chips) 
Seat 4: REZJH+hR80RwfrJtUNUJOw ($28.70 in chips) 
Seat 5: gN5V9qraLHmhKzjLHzt7qA ($15 in chips) 
Seat 7: NNZypfH1f/VIj3Skf/XIzg ($5 in chips) 
Seat 8: Xpyqpb+DURDWnyJ3xTEIFQ ($27.05 in chips) 
Seat 9: X9HkgGdfFul8DB9rhTbyFw ($37.70 in chips) 
Xpyqpb+DURDWnyJ3xTEIFQ: posts small blind $0.10
X9HkgGdfFul8DB9rhTbyFw: posts big blind $0.25
*** HOLE CARDS ***
MG90wfSJZnOejs/KD3vlQQ: folds 
REZJH+hR80RwfrJtUNUJOw: folds 
gN5V9qraLHmhKzjLHzt7qA: calls $0.25
NNZypfH1f/VIj3Skf/XIzg: folds 
Xpyqpb+DURDWnyJ3xTEIFQ: calls $0.15
X9HkgGdfFul8DB9rhTbyFw: checks 
*** FLOP *** [6h 2c 2h]
Xpyqpb+DURDWnyJ3xTEIFQ: checks 
X9HkgGdfFul8DB9rhTbyFw: checks 
gN5V9qraLHmhKzjLHzt7qA: checks 
*** TURN *** [6h 2c 2h] [2s]
Xpyqpb+DURDWnyJ3xTEIFQ: checks 
X9HkgGdfFul8DB9rhTbyFw: checks 
gN5V9qraLHmhKzjLHzt7qA: bets $0.25
Xpyqpb+DURDWnyJ3xTEIFQ: folds 
X9HkgGdfFul8DB9rhTbyFw: folds 
Uncalled bet ($0.25) returned to gN5V9qraLHmhKzjLHzt7qA
gN5V9qraLHmhKzjLHzt7qA collected $0.75 from pot
gN5V9qraLHmhKzjLHzt7qA: doesn't show hand 
*** SUMMARY ***
Total pot $0.75 | Rake $0 
Board [6h 2c 2h 2s]
Seat 2: MG90wfSJZnOejs/KD3vlQQ folded before Flop (didn't bet)
Seat 4: REZJH+hR80RwfrJtUNUJOw folded before Flop (didn't bet)
Seat 5: gN5V9qraLHmhKzjLHzt7qA collected ($0.75)
Seat 7: NNZypfH1f/VIj3Skf/XIzg (button) folded before Flop (didn't bet)
Seat 8: Xpyqpb+DURDWnyJ3xTEIFQ (small blind) folded on the Turn
Seat 9: X9HkgGdfFul8DB9rhTbyFw (big blind) folded on the Turn




PokerStars Game #59939360942:  Hold'em No Limit ($0.10/$0.25) - 2009/07/01 0:37:53 ET
Table 'HbNAGS1OJWQKyfk7UfrYyw' 9-max Seat #1 is the button
Seat 1: YHeeiaUNFin/MUYZJuW1VA ($11.05 in chips) 
Seat 2: Jt0gcXubHx3//kZT9X5jGQ ($22.80 in chips) 
Seat 3: DIBbjEYGs+TVdVgEB/4+3w ($30.55 in chips) 
Seat 5: cu58S48zQeRuppc18okJLA ($14.65 in chips) 
Seat 6: W4TLQcZ2TiM73eIgpIvlGg ($24.75 in chips) 
Seat 9: 8IJfEa/AAO04NtzGHO9CFQ ($20 in chips) 
Jt0gcXubHx3//kZT9X5jGQ: posts small blind $0.10
DIBbjEYGs+TVdVgEB/4+3w: posts big blind $0.25
TonyG267 leaves the table
8IJfEa/AAO04NtzGHO9CFQ: posts big blind $0.25
*** HOLE CARDS ***
cu58S48zQeRuppc18okJLA: folds 
W4TLQcZ2TiM73eIgpIvlGg: folds 
8IJfEa/AAO04NtzGHO9CFQ: checks 
YHeeiaUNFin/MUYZJuW1VA: raises $0.25 to $0.50
Jt0gcXubHx3//kZT9X5jGQ: raises $0.25 to $0.75
DIBbjEYGs+TVdVgEB/4+3w: folds 
8IJfEa/AAO04NtzGHO9CFQ: calls $0.50
YHeeiaUNFin/MUYZJuW1VA: calls $0.25
*** FLOP *** [2c Td 9d]
Jt0gcXubHx3//kZT9X5jGQ: bets $0.75
8IJfEa/AAO04NtzGHO9CFQ: calls $0.75
YHeeiaUNFin/MUYZJuW1VA: folds 
*** TURN *** [2c Td 9d] [Kc]
Jt0gcXubHx3//kZT9X5jGQ: bets $0.75
8IJfEa/AAO04NtzGHO9CFQ: raises $0.75 to $1.50
Jt0gcXubHx3//kZT9X5jGQ: raises $1.75 to $3.25
8IJfEa/AAO04NtzGHO9CFQ: calls $1.75
*** RIVER *** [2c Td 9d Kc] [7s]
Jt0gcXubHx3//kZT9X5jGQ: bets $15.25
8IJfEa/AAO04NtzGHO9CFQ: folds 
Uncalled bet ($15.25) returned to Jt0gcXubHx3//kZT9X5jGQ
Jt0gcXubHx3//kZT9X5jGQ collected $10 from pot
Jt0gcXubHx3//kZT9X5jGQ: doesn't show hand 
*** SUMMARY ***
Total pot $10.50 | Rake $0.50 
Board [2c Td 9d Kc 7s]
Seat 1: YHeeiaUNFin/MUYZJuW1VA (button) folded on the Flop
Seat 2: Jt0gcXubHx3//kZT9X5jGQ (small blind) collected ($10)
Seat 3: DIBbjEYGs+TVdVgEB/4+3w (big blind) folded before Flop
Seat 5: cu58S48zQeRuppc18okJLA folded before Flop (didn't bet)
Seat 6: W4TLQcZ2TiM73eIgpIvlGg folded before Flop (didn't bet)
Seat 9: 8IJfEa/AAO04NtzGHO9CFQ folded on the River




PokerStars Game #59939360468:  Hold'em No Limit ($0.10/$0.25) - 2009/07/01 0:37:53 ET
Table 'fIMYcWwN4/aXFJvH5Z8Ymg' 6-max Seat #5 is the button
Seat 1: 64ZeDpsBsP594VsWmafRTQ ($16.95 in chips) 
Seat 2: vu2kzHaDtgr6NM7rdq0chA ($25.80 in chips) 
Seat 3: bWbV4MVB/vVpiES1Ut4hew ($56.50 in chips) 
Seat 4: 32YL2ZEp8NT4JB2RVM9euQ ($30.80 in chips) 
Seat 5: 9jSiy0meE9XJKkdIZwyTEQ ($29.75 in chips) 
64ZeDpsBsP594VsWmafRTQ: posts small blind $0.10
vu2kzHaDtgr6NM7rdq0chA: posts big blind $0.25
*** HOLE CARDS ***
bWbV4MVB/vVpiES1Ut4hew: raises $0.25 to $0.50
32YL2ZEp8NT4JB2RVM9euQ: raises $1 to $1.50
9jSiy0meE9XJKkdIZwyTEQ: folds 
64ZeDpsBsP594VsWmafRTQ: folds 
vu2kzHaDtgr6NM7rdq0chA: folds 
bWbV4MVB/vVpiES1Ut4hew: raises $1 to $2.50
32YL2ZEp8NT4JB2RVM9euQ: calls $1
*** FLOP *** [Ks 6h 9s]
bWbV4MVB/vVpiES1Ut4hew: bets $4
32YL2ZEp8NT4JB2RVM9euQ: calls $4
*** TURN *** [Ks 6h 9s] [Td]
bWbV4MVB/vVpiES1Ut4hew: checks 
32YL2ZEp8NT4JB2RVM9euQ: bets $3.75
bWbV4MVB/vVpiES1Ut4hew: calls $3.75
*** RIVER *** [Ks 6h 9s Td] [8h]
bWbV4MVB/vVpiES1Ut4hew: checks 
32YL2ZEp8NT4JB2RVM9euQ: bets $6.75
bWbV4MVB/vVpiES1Ut4hew: folds 
Uncalled bet ($6.75) returned to 32YL2ZEp8NT4JB2RVM9euQ
32YL2ZEp8NT4JB2RVM9euQ collected $19.85 from pot
32YL2ZEp8NT4JB2RVM9euQ: doesn't show hand 
*** SUMMARY ***
Total pot $20.85 | Rake $1 
Board [Ks 6h 9s Td 8h]
Seat 1: 64ZeDpsBsP594VsWmafRTQ (small blind) folded before Flop
Seat 2: vu2kzHaDtgr6NM7rdq0chA (big blind) folded before Flop
Seat 3: bWbV4MVB/vVpiES1Ut4hew folded on the River
Seat 4: 32YL2ZEp8NT4JB2RVM9euQ collected ($19.85)
Seat 5: 9jSiy0meE9XJKkdIZwyTEQ (button) folded before Flop (didn't bet)




PokerStars Game #59939361622:  Hold'em No Limit ($0.10/$0.25) - 2009/07/01 0:37:54 ET
Table 'aaXqTKUnxrX9DYXtxhWXxA' 6-max Seat #2 is the button
Seat 1: njVkfGYrPiXfq4zLcgfVuA ($12.40 in chips) 
Seat 2: 1Zyw8DT57U6TzxWWRixa6Q ($14.05 in chips) 
Seat 3: cPO/1/dTcZpLkQFm3jH3Rg ($25 in chips) 
Seat 4: 4YSTu0Cdzpppe1lUgCZGCQ ($36.30 in chips) 
Seat 5: kyRaCIljYA6l33lSKQfNsg ($25.25 in chips) 
Seat 6: buyjetgNT1McXtdaP4zynA ($23.60 in chips) 
cPO/1/dTcZpLkQFm3jH3Rg: posts small blind $0.10
4YSTu0Cdzpppe1lUgCZGCQ: posts big blind $0.25
njVkfGYrPiXfq4zLcgfVuA: posts big blind $0.25
*** HOLE CARDS ***
kyRaCIljYA6l33lSKQfNsg: folds 
buyjetgNT1McXtdaP4zynA: folds 
njVkfGYrPiXfq4zLcgfVuA: checks 
1Zyw8DT57U6TzxWWRixa6Q: calls $0.25
cPO/1/dTcZpLkQFm3jH3Rg: folds 
4YSTu0Cdzpppe1lUgCZGCQ: checks 
*** FLOP *** [Tc 5c Ah]
4YSTu0Cdzpppe1lUgCZGCQ: checks 
njVkfGYrPiXfq4zLcgfVuA: checks 
1Zyw8DT57U6TzxWWRixa6Q: checks 
*** TURN *** [Tc 5c Ah] [3c]
4YSTu0Cdzpppe1lUgCZGCQ: bets $1
njVkfGYrPiXfq4zLcgfVuA: folds 
1Zyw8DT57U6TzxWWRixa6Q: calls $1
*** RIVER *** [Tc 5c Ah 3c] [8c]
4YSTu0Cdzpppe1lUgCZGCQ: checks 
1Zyw8DT57U6TzxWWRixa6Q: checks 
*** SHOW DOWN ***
4YSTu0Cdzpppe1lUgCZGCQ: shows [4c Qc] (a flush, Queen high)
1Zyw8DT57U6TzxWWRixa6Q: mucks hand 
4YSTu0Cdzpppe1lUgCZGCQ collected $2.75 from pot
*** SUMMARY ***
Total pot $2.85 | Rake $0.10 
Board [Tc 5c Ah 3c 8c]
Seat 1: njVkfGYrPiXfq4zLcgfVuA folded on the Turn
Seat 2: 1Zyw8DT57U6TzxWWRixa6Q (button) mucked
Seat 3: cPO/1/dTcZpLkQFm3jH3Rg (small blind) folded before Flop
Seat 4: 4YSTu0Cdzpppe1lUgCZGCQ (big blind) showed [4c Qc] and won ($2.75) with a flush, Queen high
Seat 5: kyRaCIljYA6l33lSKQfNsg folded before Flop (didn't bet)
Seat 6: buyjetgNT1McXtdaP4zynA folded before Flop (didn't bet)




PokerStars Game #59939361704:  Hold'em No Limit ($0.10/$0.25) - 2009/07/01 0:37:54 ET
Table 'sDHjMRwfSiz7+NDdZLUiyA' 9-max Seat #1 is the button
Seat 1: N6fYvIzQLKaydFLKQGtMlQ ($25.90 in chips) 
Seat 2: ljemhp25Zg+nlA9DLCIiUw ($27.60 in chips) 
Seat 4: v5jnQ1gfh9nLla3kMXG7Yg ($8.15 in chips) 
Seat 6: wvlPJBB0PtYkfeeSRDaIvQ ($26.15 in chips) 
Seat 8: 3hMkm4U5yTRrkGJkxfijaQ ($39.20 in chips) 
Seat 9: Xpyqpb+DURDWnyJ3xTEIFQ ($38.25 in chips) 
ljemhp25Zg+nlA9DLCIiUw: posts small blind $0.10
v5jnQ1gfh9nLla3kMXG7Yg: posts big blind $0.25
*** HOLE CARDS ***
wvlPJBB0PtYkfeeSRDaIvQ: folds 
3hMkm4U5yTRrkGJkxfijaQ: calls $0.25
Xpyqpb+DURDWnyJ3xTEIFQ: folds 
N6fYvIzQLKaydFLKQGtMlQ: folds 
wvlPJBB0PtYkfeeSRDaIvQ leaves the table
ljemhp25Zg+nlA9DLCIiUw: folds 
v5jnQ1gfh9nLla3kMXG7Yg: checks 
*** FLOP *** [Qs 7h 2h]
v5jnQ1gfh9nLla3kMXG7Yg: checks 
3hMkm4U5yTRrkGJkxfijaQ: checks 
*** TURN *** [Qs 7h 2h] [5c]
v5jnQ1gfh9nLla3kMXG7Yg: checks 
3hMkm4U5yTRrkGJkxfijaQ: checks 
*** RIVER *** [Qs 7h 2h 5c] [Jd]
v5jnQ1gfh9nLla3kMXG7Yg: checks 
3hMkm4U5yTRrkGJkxfijaQ: checks 
*** SHOW DOWN ***
v5jnQ1gfh9nLla3kMXG7Yg: shows [Kh Ks] (a pair of Kings)
3hMkm4U5yTRrkGJkxfijaQ: mucks hand 
v5jnQ1gfh9nLla3kMXG7Yg collected $0.60 from pot
*** SUMMARY ***
Total pot $0.60 | Rake $0 
Board [Qs 7h 2h 5c Jd]
Seat 1: N6fYvIzQLKaydFLKQGtMlQ (button) folded before Flop (didn't bet)
Seat 2: ljemhp25Zg+nlA9DLCIiUw (small blind) folded before Flop
Seat 4: v5jnQ1gfh9nLla3kMXG7Yg (big blind) showed [Kh Ks] and won ($0.60) with a pair of Kings
Seat 6: wvlPJBB0PtYkfeeSRDaIvQ folded before Flop (didn't bet)
Seat 8: 3hMkm4U5yTRrkGJkxfijaQ mucked
Seat 9: Xpyqpb+DURDWnyJ3xTEIFQ folded before Flop (didn't bet)




PokerStars Game #59939361408:  Hold'em No Limit ($0.10/$0.25) - 2009/07/01 0:37:54 ET
Table 'G26g8jde1eR+mmabeFeSlw' 9-max Seat #6 is the button
Seat 1: eygIcrabyU9hI2mw7NQsgg ($22 in chips) 
Seat 2: O2aLEhH7P83nWGvgV84KoA ($14.15 in chips) 
Seat 3: WKL8nUFr7TumC4EjLyqYzw ($4.80 in chips) 
Seat 4: 1Clf3cPrqoy/YgvWdWK1Xw ($5 in chips) 
Seat 5: hJ4uYjNmSZdjrKA8cjZqCA ($19.25 in chips) 
Seat 6: opOCI2p6kW0tINuVaAqmcQ ($25 in chips) 
Seat 7: nm4Dj/f+jJEwKVsUnKh73g ($26.60 in chips) 
Seat 8: G+6mJ0LVzvA9qwETH4Ostw ($25.55 in chips) 
Seat 9: VWUWpMLMj/Q1jRVpF7Aohw ($12.25 in chips) 
nm4Dj/f+jJEwKVsUnKh73g: posts small blind $0.10
G+6mJ0LVzvA9qwETH4Ostw: posts big blind $0.25
*** HOLE CARDS ***
VWUWpMLMj/Q1jRVpF7Aohw: folds 
eygIcrabyU9hI2mw7NQsgg: folds 
O2aLEhH7P83nWGvgV84KoA: folds 
WKL8nUFr7TumC4EjLyqYzw: folds 
1Clf3cPrqoy/YgvWdWK1Xw: folds 
hJ4uYjNmSZdjrKA8cjZqCA: calls $0.25
opOCI2p6kW0tINuVaAqmcQ: folds 
nm4Dj/f+jJEwKVsUnKh73g: folds 
G+6mJ0LVzvA9qwETH4Ostw: checks 
*** FLOP *** [Qh Kh Ah]
G+6mJ0LVzvA9qwETH4Ostw: bets $0.50
hJ4uYjNmSZdjrKA8cjZqCA: folds 
Uncalled bet ($0.50) returned to G+6mJ0LVzvA9qwETH4Ostw
G+6mJ0LVzvA9qwETH4Ostw collected $0.60 from pot
*** SUMMARY ***
Total pot $0.60 | Rake $0 
Board [Qh Kh Ah]
Seat 1: eygIcrabyU9hI2mw7NQsgg folded before Flop (didn't bet)
Seat 2: O2aLEhH7P83nWGvgV84KoA folded before Flop (didn't bet)
Seat 3: WKL8nUFr7TumC4EjLyqYzw folded before Flop (didn't bet)
Seat 4: 1Clf3cPrqoy/YgvWdWK1Xw folded before Flop (didn't bet)
Seat 5: hJ4uYjNmSZdjrKA8cjZqCA folded on the Flop
Seat 6: opOCI2p6kW0tINuVaAqmcQ (button) folded before Flop (didn't bet)
Seat 7: nm4Dj/f+jJEwKVsUnKh73g (small blind) folded before Flop
Seat 8: G+6mJ0LVzvA9qwETH4Ostw (big blind) collected ($0.60)
Seat 9: VWUWpMLMj/Q1jRVpF7Aohw folded before Flop (didn't bet)




PokerStars Game #59939361362:  Hold'em No Limit ($0.10/$0.25) - 2009/07/01 0:37:54 ET
Table 'Jz+kWRxWNGk9w24fdQEveA' 9-max Seat #6 is the button
Seat 1: 1K6QGyJP9P9xmRac2fH4OQ ($25.80 in chips) 
Seat 2: ljemhp25Zg+nlA9DLCIiUw ($28.90 in chips) 
Seat 4: HPEB+AtKw1+C/cxU0o1ciw ($24.45 in chips) 
Seat 5: DdPXdieucQ+n99u1n3A+rQ ($5 in chips) 
Seat 6: boms8cM+kQJF0xGLbvuFtg ($10.15 in chips) 
Seat 7: st9jtdNbm1W5GfBwRaCVqQ ($31.60 in chips) 
Seat 8: G7adEXZse2f4gqTWfn/C+Q ($11.80 in chips) 
Seat 9: z7SDvPqXQA6iOv0833Gpig ($12.20 in chips) 
st9jtdNbm1W5GfBwRaCVqQ: posts small blind $0.10
G7adEXZse2f4gqTWfn/C+Q: posts big blind $0.25
*** HOLE CARDS ***
z7SDvPqXQA6iOv0833Gpig: folds 
1K6QGyJP9P9xmRac2fH4OQ: folds 
ljemhp25Zg+nlA9DLCIiUw: folds 
HPEB+AtKw1+C/cxU0o1ciw: folds 
DdPXdieucQ+n99u1n3A+rQ: folds 
boms8cM+kQJF0xGLbvuFtg: calls $0.25
st9jtdNbm1W5GfBwRaCVqQ: calls $0.15
G7adEXZse2f4gqTWfn/C+Q: checks 
*** FLOP *** [Ts Qs 2h]
st9jtdNbm1W5GfBwRaCVqQ: checks 
G7adEXZse2f4gqTWfn/C+Q: checks 
boms8cM+kQJF0xGLbvuFtg: bets $1
st9jtdNbm1W5GfBwRaCVqQ: folds 
G7adEXZse2f4gqTWfn/C+Q: folds 
Uncalled bet ($1) returned to boms8cM+kQJF0xGLbvuFtg
boms8cM+kQJF0xGLbvuFtg collected $0.75 from pot
boms8cM+kQJF0xGLbvuFtg: doesn't show hand 
*** SUMMARY ***
Total pot $0.75 | Rake $0 
Board [Ts Qs 2h]
Seat 1: 1K6QGyJP9P9xmRac2fH4OQ folded before Flop (didn't bet)
Seat 2: ljemhp25Zg+nlA9DLCIiUw folded before Flop (didn't bet)
Seat 4: HPEB+AtKw1+C/cxU0o1ciw folded before Flop (didn't bet)
Seat 5: DdPXdieucQ+n99u1n3A+rQ folded before Flop (didn't bet)
Seat 6: boms8cM+kQJF0xGLbvuFtg (button) collected ($0.75)
Seat 7: st9jtdNbm1W5GfBwRaCVqQ (small blind) folded on the Flop
Seat 8: G7adEXZse2f4gqTWfn/C+Q (big blind) folded on the Flop
Seat 9: z7SDvPqXQA6iOv0833Gpig folded before Flop (didn't bet)




PokerStars Game #59939362310:  Hold'em No Limit ($0.10/$0.25) - 2009/07/01 0:37:55 ET
Table 'HIOfhT0zga/KonFhIl6O3w' 9-max Seat #5 is the button
Seat 1: t2nb95S5EEFOEzNx9Itz0g ($6.20 in chips) 
Seat 2: er86weqXTpTB6/w2dKlYgA ($16.45 in chips) 
Seat 3: RxrlOCIHB/l30KL6EEws0g ($37.15 in chips) 
Seat 4: qwr38jl5txoR36M7G5qi4A ($7.75 in chips) 
Seat 5: K1MDeapSEyKyGPNZGOKfEg ($13.65 in chips) 
Seat 6: cZ99hugmLBj9KhTlc8nCSw ($25.80 in chips) 
Seat 7: H9KUl8cmpLgEpOVDA00bCg ($5.60 in chips) 
Seat 8: 3RCAkueG3Vc13VpRStCB+w ($26.35 in chips) 
Seat 9: dfNim92Z6XK1/h5SFW5vDg ($25 in chips) 
cZ99hugmLBj9KhTlc8nCSw: posts small blind $0.10
H9KUl8cmpLgEpOVDA00bCg: posts big blind $0.25
*** HOLE CARDS ***
3RCAkueG3Vc13VpRStCB+w: folds 
dfNim92Z6XK1/h5SFW5vDg: folds 
t2nb95S5EEFOEzNx9Itz0g: folds 
er86weqXTpTB6/w2dKlYgA: folds 
RxrlOCIHB/l30KL6EEws0g: folds 
qwr38jl5txoR36M7G5qi4A: raises $0.25 to $0.50
K1MDeapSEyKyGPNZGOKfEg: folds 
cZ99hugmLBj9KhTlc8nCSw: folds 
H9KUl8cmpLgEpOVDA00bCg: folds 
Uncalled bet ($0.25) returned to qwr38jl5txoR36M7G5qi4A
qwr38jl5txoR36M7G5qi4A collected $0.60 from pot
qwr38jl5txoR36M7G5qi4A: doesn't show hand 
*** SUMMARY ***
Total pot $0.60 | Rake $0 
Seat 1: t2nb95S5EEFOEzNx9Itz0g folded before Flop (didn't bet)
Seat 2: er86weqXTpTB6/w2dKlYgA folded before Flop (didn't bet)
Seat 3: RxrlOCIHB/l30KL6EEws0g folded before Flop (didn't bet)
Seat 4: qwr38jl5txoR36M7G5qi4A collected ($0.60)
Seat 5: K1MDeapSEyKyGPNZGOKfEg (button) folded before Flop (didn't bet)
Seat 6: cZ99hugmLBj9KhTlc8nCSw (small blind) folded before Flop
Seat 7: H9KUl8cmpLgEpOVDA00bCg (big blind) folded before Flop
Seat 8: 3RCAkueG3Vc13VpRStCB+w folded before Flop (didn't bet)
Seat 9: dfNim92Z6XK1/h5SFW5vDg folded before Flop (didn't bet)




PokerStars Game #59939362396:  Hold'em No Limit ($0.10/$0.25) - 2009/07/01 0:37:55 ET
Table 'R5f24ws6hGXlbvjq9ej+1Q' 9-max Seat #9 is the button
Seat 1: TeWJxSETzbXGiYKx0y+dtg ($26.40 in chips) 
Seat 2: 8lk6dG3H7iS/67/biw/vcQ ($27.30 in chips) 
Seat 3: gehe91e0IyVT0QU/XBkEyg ($25.10 in chips) 
Seat 4: jM9ExRdqCqq2e6TjpOBoRw ($17.95 in chips) 
Seat 5: YMlMWbkusacDBjx3A8lphw ($5 in chips) 
Seat 6: hPhp/RE3cJ5YGaQ2xOHXXg ($9.95 in chips) 
Seat 7: Z5ZtGOON8kmSdSCll9Z3XA ($8.35 in chips) 
Seat 8: qwr38jl5txoR36M7G5qi4A ($7.60 in chips) 
Seat 9: 33y9+GmQ3J84RvZXcraRTw ($27.65 in chips) 
TeWJxSETzbXGiYKx0y+dtg: posts small blind $0.10
8lk6dG3H7iS/67/biw/vcQ: posts big blind $0.25
*** HOLE CARDS ***
gehe91e0IyVT0QU/XBkEyg has timed out
gehe91e0IyVT0QU/XBkEyg: folds 
gehe91e0IyVT0QU/XBkEyg is sitting out
jM9ExRdqCqq2e6TjpOBoRw: raises $0.25 to $0.50
YMlMWbkusacDBjx3A8lphw: raises $0.75 to $1.25
hPhp/RE3cJ5YGaQ2xOHXXg: folds 
Z5ZtGOON8kmSdSCll9Z3XA: folds 
qwr38jl5txoR36M7G5qi4A: folds 
33y9+GmQ3J84RvZXcraRTw: folds 
TeWJxSETzbXGiYKx0y+dtg: folds 
8lk6dG3H7iS/67/biw/vcQ: folds 
jM9ExRdqCqq2e6TjpOBoRw: calls $0.75
*** FLOP *** [Qh Js Jh]
jM9ExRdqCqq2e6TjpOBoRw: checks 
YMlMWbkusacDBjx3A8lphw: bets $3.75 and is all-in
jM9ExRdqCqq2e6TjpOBoRw: folds 
Uncalled bet ($3.75) returned to YMlMWbkusacDBjx3A8lphw
YMlMWbkusacDBjx3A8lphw collected $2.75 from pot
YMlMWbkusacDBjx3A8lphw: doesn't show hand 
*** SUMMARY ***
Total pot $2.85 | Rake $0.10 
Board [Qh Js Jh]
Seat 1: TeWJxSETzbXGiYKx0y+dtg (small blind) folded before Flop
Seat 2: 8lk6dG3H7iS/67/biw/vcQ (big blind) folded before Flop
Seat 3: gehe91e0IyVT0QU/XBkEyg folded before Flop (didn't bet)
Seat 4: jM9ExRdqCqq2e6TjpOBoRw folded on the Flop
Seat 5: YMlMWbkusacDBjx3A8lphw collected ($2.75)
Seat 6: hPhp/RE3cJ5YGaQ2xOHXXg folded before Flop (didn't bet)
Seat 7: Z5ZtGOON8kmSdSCll9Z3XA folded before Flop (didn't bet)
Seat 8: qwr38jl5txoR36M7G5qi4A folded before Flop (didn't bet)
Seat 9: 33y9+GmQ3J84RvZXcraRTw (button) folded before Flop (didn't bet)




PokerStars Game #59939362372:  Hold'em No Limit ($0.10/$0.25) - 2009/07/01 0:37:55 ET
Table 'Y9EhDWuqWWQFM9SelXAj5g' 9-max Seat #2 is the button
Seat 1: zDrucyjVn5aeekNEc3cJrA ($19.70 in chips) 
Seat 2: nEg1b6MIksd/4x5eLY735g ($40.10 in chips) 
Seat 3: CbXUS6Z2rXZxL1AKduNtmQ ($25 in chips) 
Seat 4: 5MgYq10OC5iGoxQFwlJVuw ($15.40 in chips) 
Seat 5: LY5GvFqMlE3xxbG85bDqlw ($10.75 in chips) 
Seat 6: STkR8XvpjNv79OOMhrlh2w ($25 in chips) 
Seat 7: aNpwfA31EREwO+ar4XzBCw ($30.60 in chips) 
Seat 8: XDxyajtqmdag0QPvwcOG7Q ($7.45 in chips) 
Seat 9: K7bAhhMMJ/XcTmGaBZVfFQ ($25.40 in chips) 
CbXUS6Z2rXZxL1AKduNtmQ: posts small blind $0.10
5MgYq10OC5iGoxQFwlJVuw: posts big blind $0.25
*** HOLE CARDS ***
LY5GvFqMlE3xxbG85bDqlw: raises $1.25 to $1.50
STkR8XvpjNv79OOMhrlh2w: folds 
aNpwfA31EREwO+ar4XzBCw: folds 
XDxyajtqmdag0QPvwcOG7Q: calls $1.50
K7bAhhMMJ/XcTmGaBZVfFQ: folds 
zDrucyjVn5aeekNEc3cJrA: folds 
nEg1b6MIksd/4x5eLY735g: folds 
CbXUS6Z2rXZxL1AKduNtmQ: folds 
5MgYq10OC5iGoxQFwlJVuw: folds 
*** FLOP *** [7s 8c 5h]
LY5GvFqMlE3xxbG85bDqlw: bets $0.25
XDxyajtqmdag0QPvwcOG7Q: calls $0.25
*** TURN *** [7s 8c 5h] [Th]
LY5GvFqMlE3xxbG85bDqlw: bets $0.25
XDxyajtqmdag0QPvwcOG7Q: calls $0.25
*** RIVER *** [7s 8c 5h Th] [Ts]
LY5GvFqMlE3xxbG85bDqlw: bets $0.25
XDxyajtqmdag0QPvwcOG7Q: calls $0.25
*** SHOW DOWN ***
LY5GvFqMlE3xxbG85bDqlw: shows [Kd Jh] (a pair of Tens)
XDxyajtqmdag0QPvwcOG7Q: shows [2c 2s] (two pair, Tens and Deuces)
XDxyajtqmdag0QPvwcOG7Q collected $4.65 from pot
*** SUMMARY ***
Total pot $4.85 | Rake $0.20 
Board [7s 8c 5h Th Ts]
Seat 1: zDrucyjVn5aeekNEc3cJrA folded before Flop (didn't bet)
Seat 2: nEg1b6MIksd/4x5eLY735g (button) folded before Flop (didn't bet)
Seat 3: CbXUS6Z2rXZxL1AKduNtmQ (small blind) folded before Flop
Seat 4: 5MgYq10OC5iGoxQFwlJVuw (big blind) folded before Flop
Seat 5: LY5GvFqMlE3xxbG85bDqlw showed [Kd Jh] and lost with a pair of Tens
Seat 6: STkR8XvpjNv79OOMhrlh2w folded before Flop (didn't bet)
Seat 7: aNpwfA31EREwO+ar4XzBCw folded before Flop (didn't bet)
Seat 8: XDxyajtqmdag0QPvwcOG7Q showed [2c 2s] and won ($4.65) with two pair, Tens and Deuces
Seat 9: K7bAhhMMJ/XcTmGaBZVfFQ folded before Flop (didn't bet)




PokerStars Game #59939362090:  Hold'em No Limit ($0.10/$0.25) - 2009/07/01 0:37:55 ET
Table 'g+mPuNJBCHKE9ents7ZGtg' 6-max Seat #1 is the button
Seat 1: rlqzz6sTpiZGIiNuqy7QUA ($34.85 in chips) 
Seat 2: fZQg9veL7Dd/Z04ZTjC+wQ ($29.85 in chips) 
Seat 3: 9jSiy0meE9XJKkdIZwyTEQ ($25.60 in chips) 
Seat 4: mfrkWA3PTeYPkbO6hi98Aw ($27 in chips) 
Seat 5: vEZ/HxVuyR6kaq0BtZoUgQ ($14.05 in chips) 
Seat 6: MS2T205Bjud7PnNoANu4vQ ($50.60 in chips) 
fZQg9veL7Dd/Z04ZTjC+wQ: posts small blind $0.10
9jSiy0meE9XJKkdIZwyTEQ: posts big blind $0.25
*** HOLE CARDS ***
mfrkWA3PTeYPkbO6hi98Aw: folds 
vEZ/HxVuyR6kaq0BtZoUgQ: folds 
MS2T205Bjud7PnNoANu4vQ: folds 
rlqzz6sTpiZGIiNuqy7QUA: calls $0.25
fZQg9veL7Dd/Z04ZTjC+wQ: calls $0.15
9jSiy0meE9XJKkdIZwyTEQ: checks 
*** FLOP *** [Qs 7h 9d]
fZQg9veL7Dd/Z04ZTjC+wQ: bets $0.50
9jSiy0meE9XJKkdIZwyTEQ: folds 
rlqzz6sTpiZGIiNuqy7QUA: folds 
Uncalled bet ($0.50) returned to fZQg9veL7Dd/Z04ZTjC+wQ
fZQg9veL7Dd/Z04ZTjC+wQ collected $0.75 from pot
fZQg9veL7Dd/Z04ZTjC+wQ: doesn't show hand 
*** SUMMARY ***
Total pot $0.75 | Rake $0 
Board [Qs 7h 9d]
Seat 1: rlqzz6sTpiZGIiNuqy7QUA (button) folded on the Flop
Seat 2: fZQg9veL7Dd/Z04ZTjC+wQ (small blind) collected ($0.75)
Seat 3: 9jSiy0meE9XJKkdIZwyTEQ (big blind) folded on the Flop
Seat 4: mfrkWA3PTeYPkbO6hi98Aw folded before Flop (didn't bet)
Seat 5: vEZ/HxVuyR6kaq0BtZoUgQ folded before Flop (didn't bet)
Seat 6: MS2T205Bjud7PnNoANu4vQ folded before Flop (didn't bet)




PokerStars Game #59939361784:  Hold'em No Limit ($0.10/$0.25) - 2009/07/01 0:37:55 ET
Table 'gkdjhbH1jaE3hwhPRIKMiQ' 6-max Seat #5 is the button
Seat 1: nc79pm0LZRdhncq55evVqA ($25 in chips) 
Seat 2: 1NNFfYMd5Hsphl/FYz9fNA ($32.85 in chips) 
Seat 3: uUXdcVMNa05rfbntdvplfw ($8.60 in chips) 
Seat 4: 7uqewvdd5+KjmM7wl58k+w ($16.05 in chips) 
Seat 5: Ew/TYPQIsbQ2X8nm5iAJBg ($27.25 in chips) 
Seat 6: wqphQtauX5Qn7WRJZS1flA ($25.75 in chips) 
wqphQtauX5Qn7WRJZS1flA: posts small blind $0.10
nc79pm0LZRdhncq55evVqA: posts big blind $0.25
*** HOLE CARDS ***
1NNFfYMd5Hsphl/FYz9fNA: folds 
uUXdcVMNa05rfbntdvplfw: calls $0.25
7uqewvdd5+KjmM7wl58k+w: raises $0.25 to $0.50
Ew/TYPQIsbQ2X8nm5iAJBg: calls $0.50
wqphQtauX5Qn7WRJZS1flA: folds 
nc79pm0LZRdhncq55evVqA: folds 
uUXdcVMNa05rfbntdvplfw: calls $0.25
*** FLOP *** [7d 9d Ad]
uUXdcVMNa05rfbntdvplfw: checks 
7uqewvdd5+KjmM7wl58k+w: checks 
Ew/TYPQIsbQ2X8nm5iAJBg: checks 
*** TURN *** [7d 9d Ad] [Td]
uUXdcVMNa05rfbntdvplfw: checks 
7uqewvdd5+KjmM7wl58k+w: bets $0.25
Ew/TYPQIsbQ2X8nm5iAJBg: folds 
uUXdcVMNa05rfbntdvplfw: raises $0.75 to $1
7uqewvdd5+KjmM7wl58k+w: folds 
Uncalled bet ($0.75) returned to uUXdcVMNa05rfbntdvplfw
uUXdcVMNa05rfbntdvplfw collected $2.25 from pot
*** SUMMARY ***
Total pot $2.35 | Rake $0.10 
Board [7d 9d Ad Td]
Seat 1: nc79pm0LZRdhncq55evVqA (big blind) folded before Flop
Seat 2: 1NNFfYMd5Hsphl/FYz9fNA folded before Flop (didn't bet)
Seat 3: uUXdcVMNa05rfbntdvplfw collected ($2.25)
Seat 4: 7uqewvdd5+KjmM7wl58k+w folded on the Turn
Seat 5: Ew/TYPQIsbQ2X8nm5iAJBg (button) folded on the Turn
Seat 6: wqphQtauX5Qn7WRJZS1flA (small blind) folded before Flop




PokerStars Game #59939362516:  Hold'em No Limit ($0.10/$0.25) - 2009/07/01 0:37:56 ET
Table 'wPWRBZPJl1HAnysw7qRR0A' 6-max Seat #2 is the button
Seat 1: cPO/1/dTcZpLkQFm3jH3Rg ($49.60 in chips) 
Seat 2: 48oT5xFI+5CHUJlfoGrE4w ($6.55 in chips) 
Seat 3: rPToQDbLWB+dKnz7fcQSIg ($6.20 in chips) 
Seat 4: kbpWbC+dJNBphHl1jtw7bw ($17 in chips) 
Seat 5: LtASJ9OlkqGrrUKGQlpGAw ($22.30 in chips) 
Seat 6: VLoE/jniCqHZuUkx8Esf6w ($29.55 in chips) 
rPToQDbLWB+dKnz7fcQSIg: posts small blind $0.10
kbpWbC+dJNBphHl1jtw7bw: posts big blind $0.25
*** HOLE CARDS ***
LtASJ9OlkqGrrUKGQlpGAw: folds 
VLoE/jniCqHZuUkx8Esf6w: folds 
cPO/1/dTcZpLkQFm3jH3Rg: folds 
48oT5xFI+5CHUJlfoGrE4w: folds 
rPToQDbLWB+dKnz7fcQSIg: calls $0.15
kbpWbC+dJNBphHl1jtw7bw: raises $0.75 to $1
rPToQDbLWB+dKnz7fcQSIg: calls $0.75
*** FLOP *** [6s 7s Td]
rPToQDbLWB+dKnz7fcQSIg: bets $1
kbpWbC+dJNBphHl1jtw7bw: calls $1
*** TURN *** [6s 7s Td] [Kh]
rPToQDbLWB+dKnz7fcQSIg: bets $4.20 and is all-in
kbpWbC+dJNBphHl1jtw7bw: folds 
Uncalled bet ($4.20) returned to rPToQDbLWB+dKnz7fcQSIg
rPToQDbLWB+dKnz7fcQSIg collected $3.85 from pot
*** SUMMARY ***
Total pot $4 | Rake $0.15 
Board [6s 7s Td Kh]
Seat 1: cPO/1/dTcZpLkQFm3jH3Rg folded before Flop (didn't bet)
Seat 2: 48oT5xFI+5CHUJlfoGrE4w (button) folded before Flop (didn't bet)
Seat 3: rPToQDbLWB+dKnz7fcQSIg (small blind) collected ($3.85)
Seat 4: kbpWbC+dJNBphHl1jtw7bw (big blind) folded on the Turn
Seat 5: LtASJ9OlkqGrrUKGQlpGAw folded before Flop (didn't bet)
Seat 6: VLoE/jniCqHZuUkx8Esf6w folded before Flop (didn't bet)




PokerStars Game #59939362678:  Hold'em No Limit ($0.10/$0.25) - 2009/07/01 0:37:56 ET
Table 'AJGgX1ZYM8d68SWMvaLttg' 6-max Seat #2 is the button
Seat 2: zHHLkD2sRljslKKeQv/ZQw ($32.65 in chips) 
Seat 3: 4x9jCqgSw4272dnaIqnanw ($4.70 in chips) 
Seat 4: Lz/GjRDgmgepqTR7qmS86w ($18.70 in chips) 
Seat 5: SFmT9ZsVopnukjvAzrxTRg ($28.95 in chips) 
Seat 6: UA5OsKS3VPaxa7uC8La/kA ($31.25 in chips) 
4x9jCqgSw4272dnaIqnanw: posts small blind $0.10
Lz/GjRDgmgepqTR7qmS86w: posts big blind $0.25
*** HOLE CARDS ***
SFmT9ZsVopnukjvAzrxTRg: folds 
UA5OsKS3VPaxa7uC8La/kA: folds 
zHHLkD2sRljslKKeQv/ZQw: calls $0.25
4x9jCqgSw4272dnaIqnanw: raises $4.45 to $4.70 and is all-in
Lz/GjRDgmgepqTR7qmS86w: folds 
sT4sjqzVMH/fZHz0hkbIPw has returned
zHHLkD2sRljslKKeQv/ZQw: folds 
Uncalled bet ($4.45) returned to 4x9jCqgSw4272dnaIqnanw
4x9jCqgSw4272dnaIqnanw collected $0.75 from pot
*** SUMMARY ***
Total pot $0.75 | Rake $0 
Seat 2: zHHLkD2sRljslKKeQv/ZQw (button) folded before Flop
Seat 3: 4x9jCqgSw4272dnaIqnanw (small blind) collected ($0.75)
Seat 4: Lz/GjRDgmgepqTR7qmS86w (big blind) folded before Flop
Seat 5: SFmT9ZsVopnukjvAzrxTRg folded before Flop (didn't bet)
Seat 6: UA5OsKS3VPaxa7uC8La/kA folded before Flop (didn't bet)




PokerStars Game #59939362778:  Hold'em No Limit ($0.10/$0.25) - 2009/07/01 0:37:56 ET
Table 'VuY5ej47Cy8nOI3Wogmhzw' 6-max Seat #4 is the button
Seat 1: PUTXJX6bVODW3ITgBX0GuQ ($15.35 in chips) 
Seat 3: 0n9nsjvz4GIG4IyVHT0JVw ($6.45 in chips) 
Seat 4: FC6tJ9EOiutXO8hnpR4VgQ ($3.30 in chips) 
PUTXJX6bVODW3ITgBX0GuQ: posts small blind $0.10
0n9nsjvz4GIG4IyVHT0JVw: posts big blind $0.25
*** HOLE CARDS ***
FC6tJ9EOiutXO8hnpR4VgQ: folds 
PUTXJX6bVODW3ITgBX0GuQ: calls $0.15
0n9nsjvz4GIG4IyVHT0JVw: checks 
*** FLOP *** [8d 4c 2h]
PUTXJX6bVODW3ITgBX0GuQ: checks 
0n9nsjvz4GIG4IyVHT0JVw: bets $0.50
PUTXJX6bVODW3ITgBX0GuQ: folds 
Uncalled bet ($0.50) returned to 0n9nsjvz4GIG4IyVHT0JVw
+v0nBUereMsRzYp2Knh/cQ joins the table at seat #6 
0n9nsjvz4GIG4IyVHT0JVw collected $0.50 from pot
0n9nsjvz4GIG4IyVHT0JVw: doesn't show hand 
*** SUMMARY ***
Total pot $0.50 | Rake $0 
Board [8d 4c 2h]
Seat 1: PUTXJX6bVODW3ITgBX0GuQ (small blind) folded on the Flop
Seat 3: 0n9nsjvz4GIG4IyVHT0JVw (big blind) collected ($0.50)
Seat 4: FC6tJ9EOiutXO8hnpR4VgQ (button) folded before Flop (didn't bet)




PokerStars Game #59939362502:  Hold'em No Limit ($0.10/$0.25) - 2009/07/01 0:37:56 ET
Table '+fuYjvJy9okLr23QyZtanA' 9-max Seat #4 is the button
Seat 1: s7Q6uNouhe7aE8JdFb9E+A ($29.50 in chips) 
Seat 4: H/l9NZvuOXwQIPOaVdj0rQ ($10.80 in chips) 
H/l9NZvuOXwQIPOaVdj0rQ: posts small blind $0.10
s7Q6uNouhe7aE8JdFb9E+A: posts big blind $0.25
*** HOLE CARDS ***
H/l9NZvuOXwQIPOaVdj0rQ: calls $0.15
s7Q6uNouhe7aE8JdFb9E+A: checks 
*** FLOP *** [4h 4c 7h]
s7Q6uNouhe7aE8JdFb9E+A: bets $0.50
H/l9NZvuOXwQIPOaVdj0rQ: calls $0.50
*** TURN *** [4h 4c 7h] [9d]
s7Q6uNouhe7aE8JdFb9E+A: bets $1.50
H/l9NZvuOXwQIPOaVdj0rQ: folds 
Uncalled bet ($1.50) returned to s7Q6uNouhe7aE8JdFb9E+A
s7Q6uNouhe7aE8JdFb9E+A collected $1.45 from pot
s7Q6uNouhe7aE8JdFb9E+A: doesn't show hand 
*** SUMMARY ***
Total pot $1.50 | Rake $0.05 
Board [4h 4c 7h 9d]
Seat 1: s7Q6uNouhe7aE8JdFb9E+A (big blind) collected ($1.45)
Seat 4: H/l9NZvuOXwQIPOaVdj0rQ (button) (small blind) folded on the Turn




PokerStars Game #59939362888:  Hold'em No Limit ($0.10/$0.25) - 2009/07/01 0:37:56 ET
Table 'bIGKmJgZehWJ+FAo8b85iw' 9-max Seat #6 is the button
Seat 2: Ut3g/kEEdCCbe/gbWrHnDg ($21.50 in chips) 
Seat 3: TeWJxSETzbXGiYKx0y+dtg ($36.40 in chips) 
Seat 4: EJRVVUAJEYLdm1qbO8TzuQ ($15.65 in chips) 
Seat 5: 7wo6Sr7QG3Zo6BaBDV1BOw ($6.80 in chips) 
Seat 6: H5Se03ZqSX7tbULXur2MAg ($21.95 in chips) 
Seat 7: DdPXdieucQ+n99u1n3A+rQ ($5.10 in chips) 
Seat 8: +2kMBNpY4nF1qNCRd8SJLA ($25 in chips) 
Seat 9: aNpwfA31EREwO+ar4XzBCw ($25 in chips) 
DdPXdieucQ+n99u1n3A+rQ: posts small blind $0.10
+2kMBNpY4nF1qNCRd8SJLA: posts big blind $0.25
yyG4svzOpC1A+sUP/scg6w: sits out 
*** HOLE CARDS ***
aNpwfA31EREwO+ar4XzBCw: folds 
Ut3g/kEEdCCbe/gbWrHnDg: folds 
TeWJxSETzbXGiYKx0y+dtg: folds 
EJRVVUAJEYLdm1qbO8TzuQ: calls $0.25
7wo6Sr7QG3Zo6BaBDV1BOw: folds 
H5Se03ZqSX7tbULXur2MAg: folds 
DdPXdieucQ+n99u1n3A+rQ: raises $1 to $1.25
+2kMBNpY4nF1qNCRd8SJLA: folds 
EJRVVUAJEYLdm1qbO8TzuQ: calls $1
*** FLOP *** [6s 5d 6d]
DdPXdieucQ+n99u1n3A+rQ: bets $1.50
EJRVVUAJEYLdm1qbO8TzuQ: raises $2.50 to $4
DdPXdieucQ+n99u1n3A+rQ: calls $2.35 and is all-in
Uncalled bet ($0.15) returned to EJRVVUAJEYLdm1qbO8TzuQ
*** TURN *** [6s 5d 6d] [Kh]
*** RIVER *** [6s 5d 6d Kh] [3s]
*** SHOW DOWN ***
DdPXdieucQ+n99u1n3A+rQ: shows [Kd Qs] (two pair, Kings and Sixes)
EJRVVUAJEYLdm1qbO8TzuQ: mucks hand 
DdPXdieucQ+n99u1n3A+rQ collected $9.95 from pot
*** SUMMARY ***
Total pot $10.45 | Rake $0.50 
Board [6s 5d 6d Kh 3s]
Seat 2: Ut3g/kEEdCCbe/gbWrHnDg folded before Flop (didn't bet)
Seat 3: TeWJxSETzbXGiYKx0y+dtg folded before Flop (didn't bet)
Seat 4: EJRVVUAJEYLdm1qbO8TzuQ mucked
Seat 5: 7wo6Sr7QG3Zo6BaBDV1BOw folded before Flop (didn't bet)
Seat 6: H5Se03ZqSX7tbULXur2MAg (button) folded before Flop (didn't bet)
Seat 7: DdPXdieucQ+n99u1n3A+rQ (small blind) showed [Kd Qs] and won ($9.95) with two pair, Kings and Sixes
Seat 8: +2kMBNpY4nF1qNCRd8SJLA (big blind) folded before Flop
Seat 9: aNpwfA31EREwO+ar4XzBCw folded before Flop (didn't bet)




PokerStars Game #59939363000:  Hold'em No Limit ($0.10/$0.25) - 2009/07/01 0:37:56 ET
Table 'SgI2Cobdjtkh0Fd0/eTTDg' 9-max Seat #3 is the button
Seat 1: JRfCWETUoKaEo7sf/Jy3Kg ($26.90 in chips) 
Seat 2: 8B/dhbQjIWe6ASCdgzktNQ ($42.20 in chips) 
Seat 3: OiV1PWZ3IkN29JlmCcnTwQ ($4.90 in chips) 
Seat 4: 18G4P1XstjNvItdGUITxgw ($25.10 in chips) 
Seat 5: w/RUHfVzKTf7Bc19nucLpQ ($9.65 in chips) 
Seat 6: f8ewQKsexlXbhtBqiLFb8A ($6.70 in chips) 
Seat 7: aJy680tKSaP5er559aSuGA ($22.95 in chips) 
Seat 9: cZ99hugmLBj9KhTlc8nCSw ($25.90 in chips) 
18G4P1XstjNvItdGUITxgw: posts small blind $0.10
w/RUHfVzKTf7Bc19nucLpQ: posts big blind $0.25
*** HOLE CARDS ***
f8ewQKsexlXbhtBqiLFb8A: calls $0.25
aJy680tKSaP5er559aSuGA: calls $0.25
cZ99hugmLBj9KhTlc8nCSw: folds 
JRfCWETUoKaEo7sf/Jy3Kg: calls $0.25
8B/dhbQjIWe6ASCdgzktNQ: folds 
OiV1PWZ3IkN29JlmCcnTwQ: folds 
18G4P1XstjNvItdGUITxgw: calls $0.15
w/RUHfVzKTf7Bc19nucLpQ: raises $0.50 to $0.75
f8ewQKsexlXbhtBqiLFb8A: raises $0.75 to $1.50
aJy680tKSaP5er559aSuGA: folds 
JRfCWETUoKaEo7sf/Jy3Kg: calls $1.25
18G4P1XstjNvItdGUITxgw: folds 
w/RUHfVzKTf7Bc19nucLpQ: calls $0.75
*** FLOP *** [9h Qs 4h]
w/RUHfVzKTf7Bc19nucLpQ: checks 
f8ewQKsexlXbhtBqiLFb8A: bets $5.20 and is all-in
JRfCWETUoKaEo7sf/Jy3Kg: folds 
w/RUHfVzKTf7Bc19nucLpQ: folds 
Uncalled bet ($5.20) returned to f8ewQKsexlXbhtBqiLFb8A
f8ewQKsexlXbhtBqiLFb8A collected $4.75 from pot
f8ewQKsexlXbhtBqiLFb8A: doesn't show hand 
*** SUMMARY ***
Total pot $5 | Rake $0.25 
Board [9h Qs 4h]
Seat 1: JRfCWETUoKaEo7sf/Jy3Kg folded on the Flop
Seat 2: 8B/dhbQjIWe6ASCdgzktNQ folded before Flop (didn't bet)
Seat 3: OiV1PWZ3IkN29JlmCcnTwQ (button) folded before Flop (didn't bet)
Seat 4: 18G4P1XstjNvItdGUITxgw (small blind) folded before Flop
Seat 5: w/RUHfVzKTf7Bc19nucLpQ (big blind) folded on the Flop
Seat 6: f8ewQKsexlXbhtBqiLFb8A collected ($4.75)
Seat 7: aJy680tKSaP5er559aSuGA folded before Flop
Seat 9: cZ99hugmLBj9KhTlc8nCSw folded before Flop (didn't bet)




PokerStars Game #59939362856:  Hold'em No Limit ($0.10/$0.25) - 2009/07/01 0:37:56 ET
Table 'gHbubGDeVSkmB4vFiqIN3Q' 6-max Seat #4 is the button
Seat 1: kG34n23qFQA3nzdOJTQ1dA ($26.35 in chips) 
Seat 2: 8LzEWRhg4wk8Jh9CqDhH3Q ($3.30 in chips) 
Seat 3: DDSdUri0VKbNEouF/1bdsg ($6.20 in chips) 
Seat 4: v+QfkGiuj9bgtuNoVnDO8w ($32.50 in chips) 
kG34n23qFQA3nzdOJTQ1dA: posts small blind $0.10
8LzEWRhg4wk8Jh9CqDhH3Q: posts big blind $0.25
*** HOLE CARDS ***
DDSdUri0VKbNEouF/1bdsg: folds 
wvIIdlbCgePONQwXjx9xzQ joins the table at seat #6 
v+QfkGiuj9bgtuNoVnDO8w: folds 
kG34n23qFQA3nzdOJTQ1dA: folds 
Uncalled bet ($0.15) returned to 8LzEWRhg4wk8Jh9CqDhH3Q
8LzEWRhg4wk8Jh9CqDhH3Q collected $0.20 from pot
8LzEWRhg4wk8Jh9CqDhH3Q: doesn't show hand 
*** SUMMARY ***
Total pot $0.20 | Rake $0 
Seat 1: kG34n23qFQA3nzdOJTQ1dA (small blind) folded before Flop
Seat 2: 8LzEWRhg4wk8Jh9CqDhH3Q (big blind) collected ($0.20)
Seat 3: DDSdUri0VKbNEouF/1bdsg folded before Flop (didn't bet)
Seat 4: v+QfkGiuj9bgtuNoVnDO8w (button) folded before Flop (didn't bet)




PokerStars Game #59939362608:  Hold'em No Limit ($0.10/$0.25) - 2009/07/01 0:37:56 ET
Table '3Ns9nuTkynfwbBfBXzg6ww' 6-max Seat #6 is the button
Seat 3: 6PDO6dptGq0XLL8zHWIhgw ($49.30 in chips) 
Seat 4: kyRaCIljYA6l33lSKQfNsg ($31.75 in chips) 
Seat 5: kBQU/db00TVAMeomlhblPg ($15 in chips) 
Seat 6: L0urJVMuBFQrIOdoz+7XLw ($32.75 in chips) 
6PDO6dptGq0XLL8zHWIhgw: posts small blind $0.10
kyRaCIljYA6l33lSKQfNsg: posts big blind $0.25
*** HOLE CARDS ***
kBQU/db00TVAMeomlhblPg: folds 
L0urJVMuBFQrIOdoz+7XLw: folds 
6PDO6dptGq0XLL8zHWIhgw: folds 
Uncalled bet ($0.15) returned to kyRaCIljYA6l33lSKQfNsg
kyRaCIljYA6l33lSKQfNsg collected $0.20 from pot
*** SUMMARY ***
Total pot $0.20 | Rake $0 
Seat 3: 6PDO6dptGq0XLL8zHWIhgw (small blind) folded before Flop
Seat 4: kyRaCIljYA6l33lSKQfNsg (big blind) collected ($0.20)
Seat 5: kBQU/db00TVAMeomlhblPg folded before Flop (didn't bet)
Seat 6: L0urJVMuBFQrIOdoz+7XLw (button) folded before Flop (didn't bet)




PokerStars Game #59939363332:  Hold'em No Limit ($0.10/$0.25) - 2009/07/01 0:37:57 ET
Table '4mnXP0EWt9mMZYzTIVDQ0w' 9-max Seat #4 is the button
Seat 1: PTFwg4rGxnfVvj2iP1OI2w ($16.60 in chips) 
Seat 2: j4q3p0lesp63b1gZDwLBZw ($5 in chips) 
Seat 4: E0iYnEVO2ho7dH3QcCjw7g ($20.45 in chips) 
Seat 5: sSN8Y0AlsBeidZXPKmwXSw ($11.50 in chips) 
Seat 6: n9toqYXSLowQ/sWq842dEQ ($12.75 in chips) 
Seat 7: s1y+qfkBnhgc67+X3ThjeA ($24.90 in chips) 
Seat 8: H9KUl8cmpLgEpOVDA00bCg ($4.65 in chips) 
Seat 9: wbCayoP+N6xpKgOfIqZsbA ($22.20 in chips) 
sSN8Y0AlsBeidZXPKmwXSw: posts small blind $0.10
n9toqYXSLowQ/sWq842dEQ: posts big blind $0.25
*** HOLE CARDS ***
s1y+qfkBnhgc67+X3ThjeA: folds 
H9KUl8cmpLgEpOVDA00bCg: folds 
wbCayoP+N6xpKgOfIqZsbA: folds 
PTFwg4rGxnfVvj2iP1OI2w: folds 
j4q3p0lesp63b1gZDwLBZw: folds 
E0iYnEVO2ho7dH3QcCjw7g: folds 
sSN8Y0AlsBeidZXPKmwXSw: raises $0.50 to $0.75
n9toqYXSLowQ/sWq842dEQ: calls $0.50
*** FLOP *** [8c 8h Ts]
sSN8Y0AlsBeidZXPKmwXSw: checks 
n9toqYXSLowQ/sWq842dEQ: bets $0.75
sSN8Y0AlsBeidZXPKmwXSw: raises $1.50 to $2.25
n9toqYXSLowQ/sWq842dEQ: folds 
Uncalled bet ($1.50) returned to sSN8Y0AlsBeidZXPKmwXSw
sSN8Y0AlsBeidZXPKmwXSw collected $2.90 from pot
sSN8Y0AlsBeidZXPKmwXSw: doesn't show hand 
*** SUMMARY ***
Total pot $3 | Rake $0.10 
Board [8c 8h Ts]
Seat 1: PTFwg4rGxnfVvj2iP1OI2w folded before Flop (didn't bet)
Seat 2: j4q3p0lesp63b1gZDwLBZw folded before Flop (didn't bet)
Seat 4: E0iYnEVO2ho7dH3QcCjw7g (button) folded before Flop (didn't bet)
Seat 5: sSN8Y0AlsBeidZXPKmwXSw (small blind) collected ($2.90)
Seat 6: n9toqYXSLowQ/sWq842dEQ (big blind) folded on the Flop
Seat 7: s1y+qfkBnhgc67+X3ThjeA folded before Flop (didn't bet)
Seat 8: H9KUl8cmpLgEpOVDA00bCg folded before Flop (didn't bet)
Seat 9: wbCayoP+N6xpKgOfIqZsbA folded before Flop (didn't bet)




PokerStars Game #59939363260:  Hold'em No Limit ($0.10/$0.25) - 2009/07/01 0:37:57 ET
Table 'JYkCJJ5Iv+Tu52jx2lpEcgT/iCKJXGphRN3xcdwfE/JQSeat #6 is the button
Seat 1: Yv4fucyyT28mjx8V5lxKJg ($26.25 in chips) 
Seat 2: hBMUlEpyU74r/fwDgIpXjQ ($35.60 in chips) 
Seat 3: Z5ZtGOON8kmSdSCll9Z3XA ($7.25 in chips) 
Seat 4: +C3eP/ysyROWbEXJFPswVA ($24.05 in chips) 
Seat 5: 6OVSxS1KoddUCYNkZ4hREw ($28.60 in chips) 
Seat 6: OiV1PWZ3IkN29JlmCcnTwQ ($5 in chips) 
Seat 7: N6fYvIzQLKaydFLKQGtMlQ ($24.50 in chips) 
Seat 8: COsrwJSFHQtxlUcrYtDQPQ ($25 in chips) 
Seat 9: H9KUl8cmpLgEpOVDA00bCg ($5.50 in chips) 
N6fYvIzQLKaydFLKQGtMlQ: posts small blind $0.10
COsrwJSFHQtxlUcrYtDQPQ: posts big blind $0.25
*** HOLE CARDS ***
H9KUl8cmpLgEpOVDA00bCg: folds 
Yv4fucyyT28mjx8V5lxKJg: raises $0.75 to $1
hBMUlEpyU74r/fwDgIpXjQ: folds 
Z5ZtGOON8kmSdSCll9Z3XA: folds 
+C3eP/ysyROWbEXJFPswVA: folds 
6OVSxS1KoddUCYNkZ4hREw: folds 
OiV1PWZ3IkN29JlmCcnTwQ: folds 
N6fYvIzQLKaydFLKQGtMlQ: folds 
COsrwJSFHQtxlUcrYtDQPQ: calls $0.75
*** FLOP *** [Kd Ts 8s]
COsrwJSFHQtxlUcrYtDQPQ: checks 
Yv4fucyyT28mjx8V5lxKJg: bets $0.75
COsrwJSFHQtxlUcrYtDQPQ: folds 
Uncalled bet ($0.75) returned to Yv4fucyyT28mjx8V5lxKJg
Yv4fucyyT28mjx8V5lxKJg collected $2 from pot
Yv4fucyyT28mjx8V5lxKJg: doesn't show hand 
*** SUMMARY ***
Total pot $2.10 | Rake $0.10 
Board [Kd Ts 8s]
Seat 1: Yv4fucyyT28mjx8V5lxKJg collected ($2)
Seat 2: hBMUlEpyU74r/fwDgIpXjQ folded before Flop (didn't bet)
Seat 3: Z5ZtGOON8kmSdSCll9Z3XA folded before Flop (didn't bet)
Seat 4: +C3eP/ysyROWbEXJFPswVA folded before Flop (didn't bet)
Seat 5: 6OVSxS1KoddUCYNkZ4hREw folded before Flop (didn't bet)
Seat 6: OiV1PWZ3IkN29JlmCcnTwQ (button) folded before Flop (didn't bet)
Seat 7: N6fYvIzQLKaydFLKQGtMlQ (small blind) folded before Flop
Seat 8: COsrwJSFHQtxlUcrYtDQPQ (big blind) folded on the Flop
Seat 9: H9KUl8cmpLgEpOVDA00bCg folded before Flop (didn't bet)




PokerStars Game #59939363370:  Hold'em No Limit ($0.10/$0.25) - 2009/07/01 0:37:57 ET
Table '8kaMIn+aON/ferW89Go6Pw' 9-max Seat #3 is the button
Seat 1: st9jtdNbm1W5GfBwRaCVqQ ($23.50 in chips) 
Seat 2: jeKWRUkMaVn8rEUjnJKqpg ($25 in chips) 
Seat 3: 7cv+9Zc9HIQHNvYsMfV3uA ($27.95 in chips) 
Seat 4: KRWTiGM4xH+MkvPtJz4+SA ($48 in chips) 
Seat 5: hIss79a4pu7GzJZepfgOpg ($30 in chips) 
Seat 6: 1S/fpm+f42V/6MNZre+ccg ($25 in chips) 
Seat 7: HVKi9hnDyvzObpL08/OarQ ($22.25 in chips) 
Seat 8: VbudEd0ZG+qPwMO9h+hjXw ($26.55 in chips) 
Seat 9: DiSvPC2iudwL5j9u6Huyww ($25 in chips) 
KRWTiGM4xH+MkvPtJz4+SA: posts small blind $0.10
hIss79a4pu7GzJZepfgOpg: posts big blind $0.25
*** HOLE CARDS ***
1S/fpm+f42V/6MNZre+ccg: folds 
HVKi9hnDyvzObpL08/OarQ: folds 
VbudEd0ZG+qPwMO9h+hjXw: folds 
DiSvPC2iudwL5j9u6Huyww: raises $0.75 to $1
st9jtdNbm1W5GfBwRaCVqQ: folds 
jeKWRUkMaVn8rEUjnJKqpg: folds 
7cv+9Zc9HIQHNvYsMfV3uA: folds 
KRWTiGM4xH+MkvPtJz4+SA: folds 
hIss79a4pu7GzJZepfgOpg: folds 
Uncalled bet ($0.75) returned to DiSvPC2iudwL5j9u6Huyww
DiSvPC2iudwL5j9u6Huyww collected $0.60 from pot
DiSvPC2iudwL5j9u6Huyww: doesn't show hand 
*** SUMMARY ***
Total pot $0.60 | Rake $0 
Seat 1: st9jtdNbm1W5GfBwRaCVqQ folded before Flop (didn't bet)
Seat 2: jeKWRUkMaVn8rEUjnJKqpg folded before Flop (didn't bet)
Seat 3: 7cv+9Zc9HIQHNvYsMfV3uA (button) folded before Flop (didn't bet)
Seat 4: KRWTiGM4xH+MkvPtJz4+SA (small blind) folded before Flop
Seat 5: hIss79a4pu7GzJZepfgOpg (big blind) folded before Flop
Seat 6: 1S/fpm+f42V/6MNZre+ccg folded before Flop (didn't bet)
Seat 7: HVKi9hnDyvzObpL08/OarQ folded before Flop (didn't bet)
Seat 8: VbudEd0ZG+qPwMO9h+hjXw folded before Flop (didn't bet)
Seat 9: DiSvPC2iudwL5j9u6Huyww collected ($0.60)




PokerStars Game #59939364338:  Hold'em No Limit ($0.10/$0.25) - 2009/07/01 0:37:58 ET
Table 'JUMeG5SzDyo9HufhgemQeA' 9-max Seat #4 is the button
Seat 1: N6fYvIzQLKaydFLKQGtMlQ ($24.65 in chips) 
Seat 2: ZeR3hkj1gVv9J4yPCmRrjA ($28.70 in chips) 
Seat 3: IEvLSTIxhlti3EjZDarYnA ($29.45 in chips) 
Seat 4: 6OP8CZnSFyny18DZqWIYog ($3.45 in chips) 
Seat 5: FRGMo8unilbMjBi6pw9++A ($26.35 in chips) 
Seat 6: wFCwdYKUXoQHhz8qeZuuAw ($24.70 in chips) 
Seat 7: aNpwfA31EREwO+ar4XzBCw ($29.40 in chips) 
Seat 8: zDrucyjVn5aeekNEc3cJrA ($37.20 in chips) 
streetbum41 leaves the table
FRGMo8unilbMjBi6pw9++A: posts small blind $0.10
wFCwdYKUXoQHhz8qeZuuAw: posts big blind $0.25
*** HOLE CARDS ***
aNpwfA31EREwO+ar4XzBCw: folds 
xiximaris joins the table at seat #9 
zDrucyjVn5aeekNEc3cJrA: folds 
N6fYvIzQLKaydFLKQGtMlQ: folds 
ZeR3hkj1gVv9J4yPCmRrjA: raises $0.50 to $0.75
IEvLSTIxhlti3EjZDarYnA: folds 
6OP8CZnSFyny18DZqWIYog: calls $0.75
FRGMo8unilbMjBi6pw9++A: folds 
wFCwdYKUXoQHhz8qeZuuAw: folds 
*** FLOP *** [2c Kh Qc]
FRGMo8unilbMjBi6pw9++A leaves the table
ZeR3hkj1gVv9J4yPCmRrjA: bets $1.25
6OP8CZnSFyny18DZqWIYog: folds 
Uncalled bet ($1.25) returned to ZeR3hkj1gVv9J4yPCmRrjA
ZeR3hkj1gVv9J4yPCmRrjA collected $1.80 from pot
TI/C5Q+DEl4fLR3AofwYdg joins the table at seat #5 
*** SUMMARY ***
Total pot $1.85 | Rake $0.05 
Board [2c Kh Qc]
Seat 1: N6fYvIzQLKaydFLKQGtMlQ folded before Flop (didn't bet)
Seat 2: ZeR3hkj1gVv9J4yPCmRrjA collected ($1.80)
Seat 3: IEvLSTIxhlti3EjZDarYnA folded before Flop (didn't bet)
Seat 4: 6OP8CZnSFyny18DZqWIYog (button) folded on the Flop
Seat 5: FRGMo8unilbMjBi6pw9++A (small blind) folded before Flop
Seat 6: wFCwdYKUXoQHhz8qeZuuAw (big blind) folded before Flop
Seat 7: aNpwfA31EREwO+ar4XzBCw folded before Flop (didn't bet)
Seat 8: zDrucyjVn5aeekNEc3cJrA folded before Flop (didn't bet)




PokerStars Game #59939364112:  Hold'em No Limit ($0.10/$0.25) - 2009/07/01 0:37:58 ET
Table 'ZEXL6Wh4qA4Afx8NnoBBAA' 6-max Seat #1 is the button
Seat 1: qo39V8/pMxxofM2aciLSWQ ($92.65 in chips) 
Seat 4: fZQg9veL7Dd/Z04ZTjC+wQ ($33.50 in chips) 
Seat 6: 3rZnxe2K3O+xcVdF94i8lA ($17.10 in chips) 
fZQg9veL7Dd/Z04ZTjC+wQ: posts small blind $0.10
3rZnxe2K3O+xcVdF94i8lA: posts big blind $0.25
*** HOLE CARDS ***
qo39V8/pMxxofM2aciLSWQ: folds 
fZQg9veL7Dd/Z04ZTjC+wQ: folds 
Uncalled bet ($0.15) returned to 3rZnxe2K3O+xcVdF94i8lA
3rZnxe2K3O+xcVdF94i8lA collected $0.20 from pot
*** SUMMARY ***
Total pot $0.20 | Rake $0 
Seat 1: qo39V8/pMxxofM2aciLSWQ (button) folded before Flop (didn't bet)
Seat 4: fZQg9veL7Dd/Z04ZTjC+wQ (small blind) folded before Flop
Seat 6: 3rZnxe2K3O+xcVdF94i8lA (big blind) collected ($0.20)




PokerStars Game #59939364314:  Hold'em No Limit ($0.10/$0.25) - 2009/07/01 0:37:58 ET
Table '2O5CgfSkSwrr4PDrlZ1RLQ' 6-max Seat #4 is the button
Seat 1: kyRaCIljYA6l33lSKQfNsg ($47.25 in chips) 
Seat 2: /gJNBeCkWL4o85/jvlZ4BA ($49.10 in chips) 
Seat 3: yzFNNFIfC89bBPwpFPx2ow ($25 in chips) 
Seat 4: 4x9jCqgSw4272dnaIqnanw ($9.25 in chips) 
Seat 6: wqphQtauX5Qn7WRJZS1flA ($65.70 in chips) 
wqphQtauX5Qn7WRJZS1flA: posts small blind $0.10
kyRaCIljYA6l33lSKQfNsg: posts big blind $0.25
*** HOLE CARDS ***
/gJNBeCkWL4o85/jvlZ4BA: folds 
yzFNNFIfC89bBPwpFPx2ow: folds 
4x9jCqgSw4272dnaIqnanw: folds 
AMrBn4Vx9aAo/vv6WHLk6w has returned
wqphQtauX5Qn7WRJZS1flA: folds 
Uncalled bet ($0.15) returned to kyRaCIljYA6l33lSKQfNsg
kyRaCIljYA6l33lSKQfNsg collected $0.20 from pot
*** SUMMARY ***
Total pot $0.20 | Rake $0 
Seat 1: kyRaCIljYA6l33lSKQfNsg (big blind) collected ($0.20)
Seat 2: /gJNBeCkWL4o85/jvlZ4BA folded before Flop (didn't bet)
Seat 3: yzFNNFIfC89bBPwpFPx2ow folded before Flop (didn't bet)
Seat 4: 4x9jCqgSw4272dnaIqnanw (button) folded before Flop (didn't bet)
Seat 6: wqphQtauX5Qn7WRJZS1flA (small blind) folded before Flop




PokerStars Game #59939364046:  Hold'em No Limit ($0.10/$0.25) - 2009/07/01 0:37:58 ET
Table 'hfHe8uKeSJMyWAjSdM7ROQ' 6-max Seat #2 is the button
Seat 1: eHsmIvAb2JREg4O6hNPnXg ($20.75 in chips) 
Seat 2: rnpAao581IcvQglpkpnkoQ ($7.30 in chips) 
Seat 3: og6TUWcndKo5oTDQjnQfjw ($26.70 in chips) 
Seat 4: iAfYkegiTr9eE85LoKmEgA ($7.95 in chips) 
Seat 5: euswrBD1XG0Q5hB1iGJBKQ ($24.80 in chips) 
og6TUWcndKo5oTDQjnQfjw: posts small blind $0.10
iAfYkegiTr9eE85LoKmEgA: posts big blind $0.25
SFmT9ZsVopnukjvAzrxTRg: sits out 
*** HOLE CARDS ***
euswrBD1XG0Q5hB1iGJBKQ: folds 
eHsmIvAb2JREg4O6hNPnXg: folds 
rnpAao581IcvQglpkpnkoQ: folds 
og6TUWcndKo5oTDQjnQfjw: raises $0.50 to $0.75
iAfYkegiTr9eE85LoKmEgA: folds 
Uncalled bet ($0.50) returned to og6TUWcndKo5oTDQjnQfjw
og6TUWcndKo5oTDQjnQfjw collected $0.50 from pot
og6TUWcndKo5oTDQjnQfjw: doesn't show hand 
*** SUMMARY ***
Total pot $0.50 | Rake $0 
Seat 1: eHsmIvAb2JREg4O6hNPnXg folded before Flop (didn't bet)
Seat 2: rnpAao581IcvQglpkpnkoQ (button) folded before Flop (didn't bet)
Seat 3: og6TUWcndKo5oTDQjnQfjw (small blind) collected ($0.50)
Seat 4: iAfYkegiTr9eE85LoKmEgA (big blind) folded before Flop
Seat 5: euswrBD1XG0Q5hB1iGJBKQ folded before Flop (didn't bet)




PokerStars Game #59939364216:  Hold'em No Limit ($0.10/$0.25) - 2009/07/01 0:37:58 ET
Table 'f9j+4UOgRPXbyNbQkZFm4w' 6-max Seat #1 is the button
Seat 1: trN/oHqTTbPw5MNuKrOpLw ($30.85 in chips) 
Seat 2: VHBox3ZuV+/MP3dz2hFEBQ ($5.35 in chips) 
Seat 3: wCBHaebpIJ2ZTqigoRi9DA ($16.30 in chips) 
Seat 4: hiTEr3yrERiQp3zHXRioVw ($22.10 in chips) 
Seat 5: 1lxYIAoJdZwAbzIkzWmSkw ($10 in chips) 
VHBox3ZuV+/MP3dz2hFEBQ: posts small blind $0.10
wCBHaebpIJ2ZTqigoRi9DA: posts big blind $0.25
*** HOLE CARDS ***
hiTEr3yrERiQp3zHXRioVw: folds 
1lxYIAoJdZwAbzIkzWmSkw: calls $0.25
trN/oHqTTbPw5MNuKrOpLw: folds 
VHBox3ZuV+/MP3dz2hFEBQ: calls $0.15
wCBHaebpIJ2ZTqigoRi9DA: raises $1.50 to $1.75
1lxYIAoJdZwAbzIkzWmSkw: folds 
VHBox3ZuV+/MP3dz2hFEBQ: folds 
Uncalled bet ($1.50) returned to wCBHaebpIJ2ZTqigoRi9DA
wCBHaebpIJ2ZTqigoRi9DA collected $0.75 from pot
wCBHaebpIJ2ZTqigoRi9DA: doesn't show hand 
*** SUMMARY ***
Total pot $0.75 | Rake $0 
Seat 1: trN/oHqTTbPw5MNuKrOpLw (button) folded before Flop (didn't bet)
Seat 2: VHBox3ZuV+/MP3dz2hFEBQ (small blind) folded before Flop
Seat 3: wCBHaebpIJ2ZTqigoRi9DA (big blind) collected ($0.75)
Seat 4: hiTEr3yrERiQp3zHXRioVw folded before Flop (didn't bet)
Seat 5: 1lxYIAoJdZwAbzIkzWmSkw folded before Flop




PokerStars Game #59939364230:  Hold'em No Limit ($0.10/$0.25) - 2009/07/01 0:37:58 ET
Table 'zW+7jPbOLCvlPu+dUGY5WQ' 6-max Seat #4 is the button
Seat 1: JE/wJXmjw3bpdmjwvh2pcg ($24.65 in chips) 
Seat 2: m/Xj2OoEbtQwxafkW0taNw ($17.85 in chips) 
Seat 3: BedjMfrlRfPgSq7CXpPAmg ($51.95 in chips) 
Seat 4: Qv4VzEkN09uD11sjKv02Ig ($32.55 in chips) 
Seat 5: SFmT9ZsVopnukjvAzrxTRg ($51.80 in chips) 
Seat 6: BiLBinPhgpKAYzLgKJVU5A ($21.95 in chips) 
SFmT9ZsVopnukjvAzrxTRg: posts small blind $0.10
BiLBinPhgpKAYzLgKJVU5A: posts big blind $0.25
*** HOLE CARDS ***
JE/wJXmjw3bpdmjwvh2pcg: folds 
m/Xj2OoEbtQwxafkW0taNw: raises $0.25 to $0.50
BedjMfrlRfPgSq7CXpPAmg: raises $1 to $1.50
Qv4VzEkN09uD11sjKv02Ig: folds 
SFmT9ZsVopnukjvAzrxTRg: folds 
BiLBinPhgpKAYzLgKJVU5A: folds 
m/Xj2OoEbtQwxafkW0taNw: calls $1
*** FLOP *** [3h 6c Ah]
m/Xj2OoEbtQwxafkW0taNw: checks 
BedjMfrlRfPgSq7CXpPAmg: checks 
*** TURN *** [3h 6c Ah] [Qc]
m/Xj2OoEbtQwxafkW0taNw: bets $0.75
BedjMfrlRfPgSq7CXpPAmg: raises $2.85 to $3.60
m/Xj2OoEbtQwxafkW0taNw: calls $2.85
*** RIVER *** [3h 6c Ah Qc] [3d]
m/Xj2OoEbtQwxafkW0taNw: checks 
BedjMfrlRfPgSq7CXpPAmg: bets $8
m/Xj2OoEbtQwxafkW0taNw: calls $8
*** SHOW DOWN ***
BedjMfrlRfPgSq7CXpPAmg: shows [Qd Qh] (a full house, Queens full of Threes)
m/Xj2OoEbtQwxafkW0taNw: mucks hand 
BedjMfrlRfPgSq7CXpPAmg collected $25.25 from pot
*** SUMMARY ***
Total pot $26.55 | Rake $1.30 
Board [3h 6c Ah Qc 3d]
Seat 1: JE/wJXmjw3bpdmjwvh2pcg folded before Flop (didn't bet)
Seat 2: m/Xj2OoEbtQwxafkW0taNw mucked
Seat 3: BedjMfrlRfPgSq7CXpPAmg showed [Qd Qh] and won ($25.25) with a full house, Queens full of Threes
Seat 4: Qv4VzEkN09uD11sjKv02Ig (button) folded before Flop (didn't bet)
Seat 5: SFmT9ZsVopnukjvAzrxTRg (small blind) folded before Flop
Seat 6: BiLBinPhgpKAYzLgKJVU5A (big blind) folded before Flop




PokerStars Game #59939364078:  Hold'em No Limit ($0.10/$0.25) - 2009/07/01 0:37:58 ET
Table 'IRgQPZVA4+IaZZIQshgwyg' 6-max Seat #3 is the button
Seat 1: d0J1xuhsynEY81YHwAvJ5g ($25.35 in chips) 
Seat 2: 9jSiy0meE9XJKkdIZwyTEQ ($34.35 in chips) 
Seat 3: 8EEqTTh7T1q48sYDqbI2Xg ($28.45 in chips) 
Seat 4: PXXRy0uk7WED5BEf+ReJDQ ($14.40 in chips) 
Seat 5: PbMzPZIePKifKQZfKDkbIw ($26.05 in chips) 
Seat 6: qo39V8/pMxxofM2aciLSWQ ($38.20 in chips) 
PXXRy0uk7WED5BEf+ReJDQ: posts small blind $0.10
PbMzPZIePKifKQZfKDkbIw: posts big blind $0.25
*** HOLE CARDS ***
qo39V8/pMxxofM2aciLSWQ: folds 
d0J1xuhsynEY81YHwAvJ5g: folds 
9jSiy0meE9XJKkdIZwyTEQ: folds 
8EEqTTh7T1q48sYDqbI2Xg: calls $0.25
PXXRy0uk7WED5BEf+ReJDQ: calls $0.15
PbMzPZIePKifKQZfKDkbIw: raises $1 to $1.25
8EEqTTh7T1q48sYDqbI2Xg: calls $1
PXXRy0uk7WED5BEf+ReJDQ: folds 
*** FLOP *** [Kh 2h 5h]
PbMzPZIePKifKQZfKDkbIw: bets $1.75
8EEqTTh7T1q48sYDqbI2Xg: folds 
Uncalled bet ($1.75) returned to PbMzPZIePKifKQZfKDkbIw
PbMzPZIePKifKQZfKDkbIw collected $2.65 from pot
PbMzPZIePKifKQZfKDkbIw: doesn't show hand 
*** SUMMARY ***
Total pot $2.75 | Rake $0.10 
Board [Kh 2h 5h]
Seat 1: d0J1xuhsynEY81YHwAvJ5g folded before Flop (didn't bet)
Seat 2: 9jSiy0meE9XJKkdIZwyTEQ folded before Flop (didn't bet)
Seat 3: 8EEqTTh7T1q48sYDqbI2Xg (button) folded on the Flop
Seat 4: PXXRy0uk7WED5BEf+ReJDQ (small blind) folded before Flop
Seat 5: PbMzPZIePKifKQZfKDkbIw (big blind) collected ($2.65)
Seat 6: qo39V8/pMxxofM2aciLSWQ folded before Flop (didn't bet)




PokerStars Game #59939364702:  Hold'em No Limit ($0.10/$0.25) - 2009/07/01 0:37:59 ET
Table 'ggwTHpIC5qhhHJSYjK1XCw' 6-max Seat #6 is the button
Seat 1: BYxjLnV1/LL0aZcTbfAOvw ($31.60 in chips) 
Seat 2: mBAp/L4XPhNEkNUlUTV4Iw ($16.40 in chips) 
Seat 3: SxIIgwXYLkwd6m3wLyPTCw ($25 in chips) 
Seat 4: JFIAqU8lCZ0vWwEl4bdGsg ($25.75 in chips) 
Seat 5: 6zbQpY/G44U1Xvj7DZex0A ($12.60 in chips) 
Seat 6: QOk5VUJeDqXaA3RlMSluGA ($16.80 in chips) 
BYxjLnV1/LL0aZcTbfAOvw: posts small blind $0.10
mBAp/L4XPhNEkNUlUTV4Iw: posts big blind $0.25
*** HOLE CARDS ***
SxIIgwXYLkwd6m3wLyPTCw: folds 
JFIAqU8lCZ0vWwEl4bdGsg: folds 
6zbQpY/G44U1Xvj7DZex0A: raises $0.25 to $0.50
QOk5VUJeDqXaA3RlMSluGA: calls $0.50
BYxjLnV1/LL0aZcTbfAOvw: folds 
mBAp/L4XPhNEkNUlUTV4Iw: folds 
*** FLOP *** [9d Jc Ks]
6zbQpY/G44U1Xvj7DZex0A: checks 
QOk5VUJeDqXaA3RlMSluGA: bets $0.90
6zbQpY/G44U1Xvj7DZex0A: folds 
Uncalled bet ($0.90) returned to QOk5VUJeDqXaA3RlMSluGA
QOk5VUJeDqXaA3RlMSluGA collected $1.30 from pot
*** SUMMARY ***
Total pot $1.35 | Rake $0.05 
Board [9d Jc Ks]
Seat 1: BYxjLnV1/LL0aZcTbfAOvw (small blind) folded before Flop
Seat 2: mBAp/L4XPhNEkNUlUTV4Iw (big blind) folded before Flop
Seat 3: SxIIgwXYLkwd6m3wLyPTCw folded before Flop (didn't bet)
Seat 4: JFIAqU8lCZ0vWwEl4bdGsg folded before Flop (didn't bet)
Seat 5: 6zbQpY/G44U1Xvj7DZex0A folded on the Flop
Seat 6: QOk5VUJeDqXaA3RlMSluGA (button) collected ($1.30)




PokerStars Game #59939365096:  Hold'em No Limit ($0.10/$0.25) - 2009/07/01 0:37:59 ET
Table 'edvgY2YQ1I34euq4EVqGnA' 6-max Seat #5 is the button
Seat 1: mvFHK3pE7tCxJEqLjKC70Q ($26.65 in chips) 
Seat 2: 0vuFCuW1P8y6cFZZvuXNPg ($12.45 in chips) 
Seat 3: HjESR5/RHWT5gaSbIVQQ0Q ($21.10 in chips) 
Seat 4: JFIAqU8lCZ0vWwEl4bdGsg ($26.80 in chips) 
Seat 5: EE16Ua5b1HSsYej5zeXOlA ($25 in chips) 
Seat 6: kG34n23qFQA3nzdOJTQ1dA ($68.70 in chips) 
kG34n23qFQA3nzdOJTQ1dA: posts small blind $0.10
mvFHK3pE7tCxJEqLjKC70Q: posts big blind $0.25
*** HOLE CARDS ***
0vuFCuW1P8y6cFZZvuXNPg: calls $0.25
HjESR5/RHWT5gaSbIVQQ0Q: folds 
JFIAqU8lCZ0vWwEl4bdGsg: folds 
EE16Ua5b1HSsYej5zeXOlA: raises $1 to $1.25
kG34n23qFQA3nzdOJTQ1dA: folds 
mvFHK3pE7tCxJEqLjKC70Q: folds 
0vuFCuW1P8y6cFZZvuXNPg: folds 
Uncalled bet ($1) returned to EE16Ua5b1HSsYej5zeXOlA
EE16Ua5b1HSsYej5zeXOlA collected $0.85 from pot
EE16Ua5b1HSsYej5zeXOlA: doesn't show hand 
*** SUMMARY ***
Total pot $0.85 | Rake $0 
Seat 1: mvFHK3pE7tCxJEqLjKC70Q (big blind) folded before Flop
Seat 2: 0vuFCuW1P8y6cFZZvuXNPg folded before Flop
Seat 3: HjESR5/RHWT5gaSbIVQQ0Q folded before Flop (didn't bet)
Seat 4: JFIAqU8lCZ0vWwEl4bdGsg folded before Flop (didn't bet)
Seat 5: EE16Ua5b1HSsYej5zeXOlA (button) collected ($0.85)
Seat 6: kG34n23qFQA3nzdOJTQ1dA (small blind) folded before Flop




PokerStars Game #59939364982:  Hold'em No Limit ($0.10/$0.25) - 2009/07/01 0:37:59 ET
Table '5VWnrlxdjwVfMWkVS2WE7A' 6-max Seat #1 is the button
Seat 1: BiLBinPhgpKAYzLgKJVU5A ($20.90 in chips) 
Seat 2: ELW+DKizJhLK7k40PMkD2Q ($24.75 in chips) 
Seat 3: cPO/1/dTcZpLkQFm3jH3Rg ($25.25 in chips) 
Seat 4: WZv4aSGl7ETtI/Z5BPKi7w ($35.10 in chips) 
Seat 5: JQZew0FjzS19kTjeNtrE+A ($40.55 in chips) 
Seat 6: LtASJ9OlkqGrrUKGQlpGAw ($20.75 in chips) 
ELW+DKizJhLK7k40PMkD2Q: posts small blind $0.10
cPO/1/dTcZpLkQFm3jH3Rg: posts big blind $0.25
*** HOLE CARDS ***
WZv4aSGl7ETtI/Z5BPKi7w: calls $0.25
JQZew0FjzS19kTjeNtrE+A: folds 
LtASJ9OlkqGrrUKGQlpGAw: folds 
BiLBinPhgpKAYzLgKJVU5A: raises $0.50 to $0.75
ELW+DKizJhLK7k40PMkD2Q: folds 
cPO/1/dTcZpLkQFm3jH3Rg: folds 
WZv4aSGl7ETtI/Z5BPKi7w: calls $0.50
*** FLOP *** [Ks Kd 7s]
WZv4aSGl7ETtI/Z5BPKi7w: checks 
BiLBinPhgpKAYzLgKJVU5A: bets $1.25
WZv4aSGl7ETtI/Z5BPKi7w: folds 
Uncalled bet ($1.25) returned to BiLBinPhgpKAYzLgKJVU5A
BiLBinPhgpKAYzLgKJVU5A collected $1.80 from pot
BiLBinPhgpKAYzLgKJVU5A: doesn't show hand 
*** SUMMARY ***
Total pot $1.85 | Rake $0.05 
Board [Ks Kd 7s]
Seat 1: BiLBinPhgpKAYzLgKJVU5A (button) collected ($1.80)
Seat 2: ELW+DKizJhLK7k40PMkD2Q (small blind) folded before Flop
Seat 3: cPO/1/dTcZpLkQFm3jH3Rg (big blind) folded before Flop
Seat 4: WZv4aSGl7ETtI/Z5BPKi7w folded on the Flop
Seat 5: JQZew0FjzS19kTjeNtrE+A folded before Flop (didn't bet)
Seat 6: LtASJ9OlkqGrrUKGQlpGAw folded before Flop (didn't bet)




PokerStars Game #59939364658:  Hold'em No Limit ($0.10/$0.25) - 2009/07/01 0:37:59 ET
Table 'qryc9C/ELyQ3lubOaELNAQ' 6-max Seat #2 is the button
Seat 1: OZc6kkoTwtITj1ZfreJK1A ($21.25 in chips) 
Seat 2: qvQc9BHp2FhQjrltLiBN+w ($14.90 in chips) 
Seat 3: UXRtG8J9PoBZWTsNtqdoDA ($25.50 in chips) 
Seat 4: v+QfkGiuj9bgtuNoVnDO8w ($29.45 in chips) 
Seat 5: pV5UZbjsgam+HUQEd6G++w ($8.25 in chips) 
Seat 6: t2RfOOoa56xW0ZHJC0+5JQ ($9.05 in chips) 
UXRtG8J9PoBZWTsNtqdoDA: posts small blind $0.10
v+QfkGiuj9bgtuNoVnDO8w: posts big blind $0.25
*** HOLE CARDS ***
pV5UZbjsgam+HUQEd6G++w: folds 
t2RfOOoa56xW0ZHJC0+5JQ: folds 
OZc6kkoTwtITj1ZfreJK1A: folds 
qvQc9BHp2FhQjrltLiBN+w: calls $0.25
UXRtG8J9PoBZWTsNtqdoDA: calls $0.15
v+QfkGiuj9bgtuNoVnDO8w: checks 
*** FLOP *** [3d Qd Qh]
UXRtG8J9PoBZWTsNtqdoDA: checks 
v+QfkGiuj9bgtuNoVnDO8w: checks 
qvQc9BHp2FhQjrltLiBN+w: checks 
*** TURN *** [3d Qd Qh] [Kc]
UXRtG8J9PoBZWTsNtqdoDA: checks 
v+QfkGiuj9bgtuNoVnDO8w: checks 
qvQc9BHp2FhQjrltLiBN+w: checks 
*** RIVER *** [3d Qd Qh Kc] [6c]
UXRtG8J9PoBZWTsNtqdoDA: checks 
v+QfkGiuj9bgtuNoVnDO8w: checks 
qvQc9BHp2FhQjrltLiBN+w: checks 
*** SHOW DOWN ***
UXRtG8J9PoBZWTsNtqdoDA: shows [9s 7c] (a pair of Queens)
v+QfkGiuj9bgtuNoVnDO8w: shows [6h 2h] (two pair, Queens and Sixes)
qvQc9BHp2FhQjrltLiBN+w: mucks hand 
v+QfkGiuj9bgtuNoVnDO8w collected $0.75 from pot
*** SUMMARY ***
Total pot $0.75 | Rake $0 
Board [3d Qd Qh Kc 6c]
Seat 1: OZc6kkoTwtITj1ZfreJK1A folded before Flop (didn't bet)
Seat 2: qvQc9BHp2FhQjrltLiBN+w (button) mucked
Seat 3: UXRtG8J9PoBZWTsNtqdoDA (small blind) showed [9s 7c] and lost with a pair of Queens
Seat 4: v+QfkGiuj9bgtuNoVnDO8w (big blind) showed [6h 2h] and won ($0.75) with two pair, Queens and Sixes
Seat 5: pV5UZbjsgam+HUQEd6G++w folded before Flop (didn't bet)
Seat 6: t2RfOOoa56xW0ZHJC0+5JQ folded before Flop (didn't bet)




PokerStars Game #59939365084:  Hold'em No Limit ($0.10/$0.25) - 2009/07/01 0:37:59 ET
Table 'AHkg4ChqzcMauBx6Qvz8Nw' 6-max Seat #4 is the button
Seat 2: /bjna2FTN7pPjqYGzmDE0Q ($24.35 in chips) 
Seat 3: PIOdknsVyjKUwfiImc3zwg ($25.90 in chips) 
Seat 4: N7O9jUEx2YiQn1+yRYTHmw ($25.70 in chips) 
Seat 5: LtASJ9OlkqGrrUKGQlpGAw ($34.80 in chips) 
Seat 6: SFmT9ZsVopnukjvAzrxTRg ($53.40 in chips) 
LtASJ9OlkqGrrUKGQlpGAw: posts small blind $0.10
SFmT9ZsVopnukjvAzrxTRg: posts big blind $0.25
*** HOLE CARDS ***
/bjna2FTN7pPjqYGzmDE0Q: folds 
PIOdknsVyjKUwfiImc3zwg: folds 
N7O9jUEx2YiQn1+yRYTHmw: folds 
LtASJ9OlkqGrrUKGQlpGAw: folds 
Uncalled bet ($0.15) returned to SFmT9ZsVopnukjvAzrxTRg
SFmT9ZsVopnukjvAzrxTRg collected $0.20 from pot
SFmT9ZsVopnukjvAzrxTRg: doesn't show hand 
*** SUMMARY ***
Total pot $0.20 | Rake $0 
Seat 2: /bjna2FTN7pPjqYGzmDE0Q folded before Flop (didn't bet)
Seat 3: PIOdknsVyjKUwfiImc3zwg folded before Flop (didn't bet)
Seat 4: N7O9jUEx2YiQn1+yRYTHmw (button) folded before Flop (didn't bet)
Seat 5: LtASJ9OlkqGrrUKGQlpGAw (small blind) folded before Flop
Seat 6: SFmT9ZsVopnukjvAzrxTRg (big blind) collected ($0.20)




PokerStars Game #59939364858:  Hold'em No Limit ($0.10/$0.25) - 2009/07/01 0:37:59 ET
Table 'dYNvO8G5kw5SRxb1Dljhogz2yOdY2zyGWG1gh9WV9XtQ Seat #1 is the button
Seat 1: Z3dcuTANgdUb/J4unoGPFQ ($16.85 in chips) 
Seat 3: 1Cs1GyQcoM1omwY7XZ3uRg ($15.60 in chips) 
Seat 5: W7XGvw6ngGVq2hFwXk8Myg ($14.75 in chips) 
Seat 6: uH1RN27w9SKa7TpVR9EFrQ ($20.20 in chips) 
Seat 7: DiSvPC2iudwL5j9u6Huyww ($25.50 in chips) 
Seat 8: 5hAPbqNrvJb8PtLiceXtlg6HoFYfVGBefsR5Vrz62qIw4.75 in chips) 
Seat 9: sUVgUtgbfVx6JpvApozwhQ ($5 in chips) 
vEBWvFD+KUWgDBKZKvA3SA will be allowed to play after the button
1Cs1GyQcoM1omwY7XZ3uRg: posts small blind $0.10
W7XGvw6ngGVq2hFwXk8Myg: posts big blind $0.25
*** HOLE CARDS ***
uH1RN27w9SKa7TpVR9EFrQ: folds 
DiSvPC2iudwL5j9u6Huyww: folds 
5hAPbqNrvJb8PtLiceXtlg6HoFYfVGBefsR5Vrz62qIwlds 
sD+TKtt36XiiN6jqHiLwDA joins the table at seat #4 
sUVgUtgbfVx6JpvApozwhQ: folds 
Z3dcuTANgdUb/J4unoGPFQ: calls $0.25
1Cs1GyQcoM1omwY7XZ3uRg: calls $0.15
W7XGvw6ngGVq2hFwXk8Myg: checks 
*** FLOP *** [2c 3s 9d]
1Cs1GyQcoM1omwY7XZ3uRg: checks 
W7XGvw6ngGVq2hFwXk8Myg: checks 
Z3dcuTANgdUb/J4unoGPFQ: checks 
*** TURN *** [2c 3s 9d] [Qs]
1Cs1GyQcoM1omwY7XZ3uRg: checks 
W7XGvw6ngGVq2hFwXk8Myg: checks 
Z3dcuTANgdUb/J4unoGPFQ: checks 
*** RIVER *** [2c 3s 9d Qs] [4d]
1Cs1GyQcoM1omwY7XZ3uRg: checks 
W7XGvw6ngGVq2hFwXk8Myg: bets $0.25
Z3dcuTANgdUb/J4unoGPFQ: calls $0.25
1Cs1GyQcoM1omwY7XZ3uRg: folds 
*** SHOW DOWN ***
W7XGvw6ngGVq2hFwXk8Myg: shows [Qc Th] (a pair of Queens)
Z3dcuTANgdUb/J4unoGPFQ: mucks hand 
W7XGvw6ngGVq2hFwXk8Myg collected $1.20 from pot
*** SUMMARY ***
Total pot $1.25 | Rake $0.05 
Board [2c 3s 9d Qs 4d]
Seat 1: Z3dcuTANgdUb/J4unoGPFQ (button) mucked
Seat 3: 1Cs1GyQcoM1omwY7XZ3uRg (small blind) folded on the River
Seat 5: W7XGvw6ngGVq2hFwXk8Myg (big blind) showed [Qc Th] and won ($1.20) with a pair of Queens
Seat 6: uH1RN27w9SKa7TpVR9EFrQ folded before Flop (didn't bet)
Seat 7: DiSvPC2iudwL5j9u6Huyww folded before Flop (didn't bet)
Seat 8: 5hAPbqNrvJb8PtLiceXtlg6HoFYfVGBefsR5Vrz62qIwded before Flop (didn't bet)
Seat 9: sUVgUtgbfVx6JpvApozwhQ folded before Flop (didn't bet)




PokerStars Game #59939364450:  Hold'em No Limit ($0.10/$0.25) - 2009/07/01 0:37:59 ET
Table '8qKBgCRnebT9/IvA6SmaPw' 9-max Seat #9 is the button
Seat 1: GTcLfsDTPqgfHyhY9FNDMw ($11.85 in chips) 
Seat 2: SXqVW4Q0evTUVZG6BbUNIA ($76.90 in chips) 
Seat 3: 6P8bD/60Ol/baOjOb199qA ($12.60 in chips) 
Seat 4: rXm4QDVJt67H20lM6n6Z7Q ($8 in chips) 
Seat 5: uJlzv9KL7hgCIqIS2ofoaw ($14.65 in chips) 
Seat 6: z5GxcHlYz/GSz6W2uFiTtg ($23.80 in chips) 
Seat 7: UbybWqarUDNRYlbnju2UUQ ($19.50 in chips) 
Seat 8: M2aiKD/Q1d8lySUIbBxeGg ($36.40 in chips) 
Seat 9: MOlR9YEgKTKLerVIDf8U7w ($34.25 in chips) 
GTcLfsDTPqgfHyhY9FNDMw: posts small blind $0.10
SXqVW4Q0evTUVZG6BbUNIA: posts big blind $0.25
*** HOLE CARDS ***
6P8bD/60Ol/baOjOb199qA: calls $0.25
rXm4QDVJt67H20lM6n6Z7Q: calls $0.25
uJlzv9KL7hgCIqIS2ofoaw: raises $0.75 to $1
z5GxcHlYz/GSz6W2uFiTtg: folds 
UbybWqarUDNRYlbnju2UUQ: folds 
M2aiKD/Q1d8lySUIbBxeGg: folds 
MOlR9YEgKTKLerVIDf8U7w: calls $1
GTcLfsDTPqgfHyhY9FNDMw: calls $0.90
SXqVW4Q0evTUVZG6BbUNIA: folds 
6P8bD/60Ol/baOjOb199qA: calls $0.75
rXm4QDVJt67H20lM6n6Z7Q: calls $0.75
*** FLOP *** [6h Qc Kc]
GTcLfsDTPqgfHyhY9FNDMw: checks 
6P8bD/60Ol/baOjOb199qA: bets $0.75
rXm4QDVJt67H20lM6n6Z7Q: folds 
uJlzv9KL7hgCIqIS2ofoaw: folds 
MOlR9YEgKTKLerVIDf8U7w: calls $0.75
GTcLfsDTPqgfHyhY9FNDMw: folds 
*** TURN *** [6h Qc Kc] [Ts]
6P8bD/60Ol/baOjOb199qA: bets $1.50
MOlR9YEgKTKLerVIDf8U7w: raises $3 to $4.50
6P8bD/60Ol/baOjOb199qA: calls $3
*** RIVER *** [6h Qc Kc Ts] [2c]
6P8bD/60Ol/baOjOb199qA: checks 
MOlR9YEgKTKLerVIDf8U7w: bets $6.50
6P8bD/60Ol/baOjOb199qA: calls $6.35 and is all-in
Uncalled bet ($0.15) returned to MOlR9YEgKTKLerVIDf8U7w
*** SHOW DOWN ***
MOlR9YEgKTKLerVIDf8U7w: shows [Jh As] (a straight, Ten to Ace)
6P8bD/60Ol/baOjOb199qA: mucks hand 
MOlR9YEgKTKLerVIDf8U7w collected $27.10 from pot
*** SUMMARY ***
Total pot $28.45 | Rake $1.35 
Board [6h Qc Kc Ts 2c]
Seat 1: GTcLfsDTPqgfHyhY9FNDMw (small blind) folded on the Flop
Seat 2: SXqVW4Q0evTUVZG6BbUNIA (big blind) folded before Flop
Seat 3: 6P8bD/60Ol/baOjOb199qA mucked
Seat 4: rXm4QDVJt67H20lM6n6Z7Q folded on the Flop
Seat 5: uJlzv9KL7hgCIqIS2ofoaw folded on the Flop
Seat 6: z5GxcHlYz/GSz6W2uFiTtg folded before Flop (didn't bet)
Seat 7: UbybWqarUDNRYlbnju2UUQ folded before Flop (didn't bet)
Seat 8: M2aiKD/Q1d8lySUIbBxeGg folded before Flop (didn't bet)
Seat 9: MOlR9YEgKTKLerVIDf8U7w (button) showed [Jh As] and won ($27.10) with a straight, Ten to Ace




PokerStars Game #59939365444:  Hold'em No Limit ($0.10/$0.25) - 2009/07/01 0:38:00 ET
Table 'MiquQrQZJJq9ZtgRIp9HFQ' 6-max Seat #2 is the button
Seat 1: hM0MSDtq2ow7J40bSR04ig ($7.90 in chips) 
Seat 2: DMQLAmut/l19xN5STQndFg ($3.75 in chips) 
Seat 4: 0HIrwssk0FQvyKULzUTtlg ($16.55 in chips) 
Seat 5: LXN9U+5F+9if/ead2+w1nw ($44.60 in chips) 
0HIrwssk0FQvyKULzUTtlg: posts small blind $0.10
LXN9U+5F+9if/ead2+w1nw: posts big blind $0.25
X9oXZTg4PhZVR+ilX2OYbA: sits out 
*** HOLE CARDS ***
hM0MSDtq2ow7J40bSR04ig: calls $0.25
DMQLAmut/l19xN5STQndFg: folds 
0HIrwssk0FQvyKULzUTtlg: folds 
LXN9U+5F+9if/ead2+w1nw: checks 
*** FLOP *** [5c 9d 9h]
LXN9U+5F+9if/ead2+w1nw: checks 
hM0MSDtq2ow7J40bSR04ig: bets $0.25
LXN9U+5F+9if/ead2+w1nw: folds 
Uncalled bet ($0.25) returned to hM0MSDtq2ow7J40bSR04ig
hM0MSDtq2ow7J40bSR04ig collected $0.60 from pot
*** SUMMARY ***
Total pot $0.60 | Rake $0 
Board [5c 9d 9h]
Seat 1: hM0MSDtq2ow7J40bSR04ig collected ($0.60)
Seat 2: DMQLAmut/l19xN5STQndFg (button) folded before Flop (didn't bet)
Seat 4: 0HIrwssk0FQvyKULzUTtlg (small blind) folded before Flop
Seat 5: LXN9U+5F+9if/ead2+w1nw (big blind) folded on the Flop




PokerStars Game #59939365150:  Hold'em No Limit ($0.10/$0.25) - 2009/07/01 0:38:00 ET
Table 'Pz8SfAzhP5nvWTsJRAxoDg' 6-max Seat #6 is the button
Seat 1: buyjetgNT1McXtdaP4zynA ($41.40 in chips) 
Seat 2: RYLaAIIwK9wxkPswt1yJYw ($23.40 in chips) 
Seat 3: mfrkWA3PTeYPkbO6hi98Aw ($30.85 in chips) 
Seat 5: FYepjhAvF8ZdVCmqHIy+eQ ($30.30 in chips) 
Seat 6: FStoHe64SQWqAsjya9pDkQ ($25.50 in chips) 
buyjetgNT1McXtdaP4zynA: posts small blind $0.10
RYLaAIIwK9wxkPswt1yJYw: posts big blind $0.25
*** HOLE CARDS ***
9U9Vy/656QCEfKznJWteag joins the table at seat #4 
mfrkWA3PTeYPkbO6hi98Aw: folds 
FYepjhAvF8ZdVCmqHIy+eQ: folds 
FStoHe64SQWqAsjya9pDkQ: folds 
buyjetgNT1McXtdaP4zynA: raises $0.50 to $0.75
RYLaAIIwK9wxkPswt1yJYw: folds 
Uncalled bet ($0.50) returned to buyjetgNT1McXtdaP4zynA
buyjetgNT1McXtdaP4zynA collected $0.50 from pot
*** SUMMARY ***
Total pot $0.50 | Rake $0 
Seat 1: buyjetgNT1McXtdaP4zynA (small blind) collected ($0.50)
Seat 2: RYLaAIIwK9wxkPswt1yJYw (big blind) folded before Flop
Seat 3: mfrkWA3PTeYPkbO6hi98Aw folded before Flop (didn't bet)
Seat 5: FYepjhAvF8ZdVCmqHIy+eQ folded before Flop (didn't bet)
Seat 6: FStoHe64SQWqAsjya9pDkQ (button) folded before Flop (didn't bet)




PokerStars Game #59939365344:  Hold'em No Limit ($0.10/$0.25) - 2009/07/01 0:38:00 ET
Table 'tq5CvS0RUqGkuBK0XTzqqg' 6-max Seat #4 is the button
Seat 1: 39EF5EcifdyPS7v+EnfxLg ($26.65 in chips) 
Seat 2: mfrkWA3PTeYPkbO6hi98Aw ($57.45 in chips) 
Seat 4: W7FS+h5B+OhmwF+cTt3ZPQ ($13.75 in chips) 
Seat 5: qGHGf/553gQnDoklMRe3tg ($28.65 in chips) 
Seat 6: hOfhw8jxWiq14wXGL4Bh/Q ($15 in chips) 
qGHGf/553gQnDoklMRe3tg: posts small blind $0.10
hOfhw8jxWiq14wXGL4Bh/Q: posts big blind $0.25
PbMzPZIePKifKQZfKDkbIw: sits out 
*** HOLE CARDS ***
39EF5EcifdyPS7v+EnfxLg: folds 
mfrkWA3PTeYPkbO6hi98Aw: folds 
W7FS+h5B+OhmwF+cTt3ZPQ: raises $0.50 to $0.75
qGHGf/553gQnDoklMRe3tg: calls $0.65
hOfhw8jxWiq14wXGL4Bh/Q: folds 
*** FLOP *** [5c 6h 5d]
qGHGf/553gQnDoklMRe3tg: checks 
W7FS+h5B+OhmwF+cTt3ZPQ: bets $0.75
qGHGf/553gQnDoklMRe3tg: folds 
Uncalled bet ($0.75) returned to W7FS+h5B+OhmwF+cTt3ZPQ
W7FS+h5B+OhmwF+cTt3ZPQ collected $1.70 from pot
*** SUMMARY ***
Total pot $1.75 | Rake $0.05 
Board [5c 6h 5d]
Seat 1: 39EF5EcifdyPS7v+EnfxLg folded before Flop (didn't bet)
Seat 2: mfrkWA3PTeYPkbO6hi98Aw folded before Flop (didn't bet)
Seat 4: W7FS+h5B+OhmwF+cTt3ZPQ (button) collected ($1.70)
Seat 5: qGHGf/553gQnDoklMRe3tg (small blind) folded on the Flop
Seat 6: hOfhw8jxWiq14wXGL4Bh/Q (big blind) folded before Flop




PokerStars Game #59939365158:  Hold'em No Limit ($0.10/$0.25) - 2009/07/01 0:38:00 ET
Table '8QBBaev+cI2i/r2H6ml/lg' 9-max Seat #6 is the button
Seat 2: tYsOBqdU1+x+yFI7zHO7hQ ($25 in chips) 
Seat 4: ZoG0obuajzVjwgd7lNHjgg ($5.35 in chips) 
Seat 5: j4q3p0lesp63b1gZDwLBZw ($5 in chips) 
Seat 6: E0iYnEVO2ho7dH3QcCjw7g ($28.50 in chips) 
Seat 9: Ml2bY77EHbM51ZWD7dnIWg ($2.05 in chips) 
Ml2bY77EHbM51ZWD7dnIWg: posts small blind $0.10
tYsOBqdU1+x+yFI7zHO7hQ: posts big blind $0.25
*** HOLE CARDS ***
ZoG0obuajzVjwgd7lNHjgg: raises $0.50 to $0.75
j4q3p0lesp63b1gZDwLBZw: folds 
E0iYnEVO2ho7dH3QcCjw7g: calls $0.75
Ml2bY77EHbM51ZWD7dnIWg: folds 
ZWU9RNYtjmm4cElg1I0F4w leaves the table
tYsOBqdU1+x+yFI7zHO7hQ: folds 
*** FLOP *** [9h Td 9c]
ZoG0obuajzVjwgd7lNHjgg: bets $0.75
E0iYnEVO2ho7dH3QcCjw7g: calls $0.75
*** TURN *** [9h Td 9c] [6s]
ZoG0obuajzVjwgd7lNHjgg: checks 
E0iYnEVO2ho7dH3QcCjw7g: checks 
*** RIVER *** [9h Td 9c 6s] [7h]
ZoG0obuajzVjwgd7lNHjgg: checks 
E0iYnEVO2ho7dH3QcCjw7g: bets $2.50
ZoG0obuajzVjwgd7lNHjgg: calls $2.50
*** SHOW DOWN ***
E0iYnEVO2ho7dH3QcCjw7g: shows [6h 6c] (a full house, Sixes full of Nines)
ZoG0obuajzVjwgd7lNHjgg: mucks hand 
E0iYnEVO2ho7dH3QcCjw7g collected $7.95 from pot
*** SUMMARY ***
Total pot $8.35 | Rake $0.40 
Board [9h Td 9c 6s 7h]
Seat 2: tYsOBqdU1+x+yFI7zHO7hQ (big blind) folded before Flop
Seat 4: ZoG0obuajzVjwgd7lNHjgg mucked
Seat 5: j4q3p0lesp63b1gZDwLBZw folded before Flop (didn't bet)
Seat 6: E0iYnEVO2ho7dH3QcCjw7g (button) showed [6h 6c] and won ($7.95) with a full house, Sixes full of Nines
Seat 9: Ml2bY77EHbM51ZWD7dnIWg (small blind) folded before Flop




PokerStars Game #59939365398:  Hold'em No Limit ($0.10/$0.25) - 2009/07/01 0:38:00 ET
Table '6wawJ+MkkvuC3coG6r+Yhg' 6-max Seat #1 is the button
Seat 1: ELW+DKizJhLK7k40PMkD2Q ($25 in chips) 
Seat 3: KYBwVA7jgmSrbIEbEGElVg ($20.20 in chips) 
Seat 4: cS21pIxRHx5Gt42o7hPZzw ($11.40 in chips) 
LtASJ9OlkqGrrUKGQlpGAw will be allowed to play after the button
KYBwVA7jgmSrbIEbEGElVg: posts small blind $0.10
cS21pIxRHx5Gt42o7hPZzw: posts big blind $0.25
A8uIskXJTblhVXWuYr+lkw: sits out 
*** HOLE CARDS ***
ELW+DKizJhLK7k40PMkD2Q: folds 
KYBwVA7jgmSrbIEbEGElVg: calls $0.15
cS21pIxRHx5Gt42o7hPZzw: checks 
*** FLOP *** [4c Jc Td]
KYBwVA7jgmSrbIEbEGElVg: bets $0.50
cS21pIxRHx5Gt42o7hPZzw: folds 
Uncalled bet ($0.50) returned to KYBwVA7jgmSrbIEbEGElVg
KYBwVA7jgmSrbIEbEGElVg collected $0.50 from pot
*** SUMMARY ***
Total pot $0.50 | Rake $0 
Board [4c Jc Td]
Seat 1: ELW+DKizJhLK7k40PMkD2Q (button) folded before Flop (didn't bet)
Seat 3: KYBwVA7jgmSrbIEbEGElVg (small blind) collected ($0.50)
Seat 4: cS21pIxRHx5Gt42o7hPZzw (big blind) folded on the Flop




PokerStars Game #59939365640:  Hold'em No Limit ($0.10/$0.25) - 2009/07/01 0:38:00 ET
Table 'NgexmgEDEzICBeSO7YCrKQ' 6-max Seat #3 is the button
Seat 1: oseFhpinoe+Zg4j5xyBjyQ ($70.75 in chips) 
Seat 2: 32YL2ZEp8NT4JB2RVM9euQ ($16 in chips) 
Seat 3: JFIAqU8lCZ0vWwEl4bdGsg ($26.90 in chips) 
Seat 4: xx+iYCDJhHJmNzrfeloyEg ($36.95 in chips) 
Seat 5: /MXkdT8TTs8Qp2LVTQNw6w ($47.35 in chips) 
Seat 6: k9nHZTHt8hYhYRcW8NTb4g ($10.65 in chips) 
xx+iYCDJhHJmNzrfeloyEg: posts small blind $0.10
/MXkdT8TTs8Qp2LVTQNw6w: posts big blind $0.25
*** HOLE CARDS ***
k9nHZTHt8hYhYRcW8NTb4g: folds 
oseFhpinoe+Zg4j5xyBjyQ: calls $0.25
32YL2ZEp8NT4JB2RVM9euQ: folds 
JFIAqU8lCZ0vWwEl4bdGsg: folds 
xx+iYCDJhHJmNzrfeloyEg said, "  7,8 suited is my favorite hand."
xx+iYCDJhHJmNzrfeloyEg: folds 
/MXkdT8TTs8Qp2LVTQNw6w: checks 
*** FLOP *** [3c Td 2d]
/MXkdT8TTs8Qp2LVTQNw6w said, "duly noted"
/MXkdT8TTs8Qp2LVTQNw6w: checks 
oseFhpinoe+Zg4j5xyBjyQ: bets $0.50
/MXkdT8TTs8Qp2LVTQNw6w: folds 
Uncalled bet ($0.50) returned to oseFhpinoe+Zg4j5xyBjyQ
oseFhpinoe+Zg4j5xyBjyQ collected $0.60 from pot
oseFhpinoe+Zg4j5xyBjyQ: doesn't show hand 
*** SUMMARY ***
Total pot $0.60 | Rake $0 
Board [3c Td 2d]
Seat 1: oseFhpinoe+Zg4j5xyBjyQ collected ($0.60)
Seat 2: 32YL2ZEp8NT4JB2RVM9euQ folded before Flop (didn't bet)
Seat 3: JFIAqU8lCZ0vWwEl4bdGsg (button) folded before Flop (didn't bet)
Seat 4: xx+iYCDJhHJmNzrfeloyEg (small blind) folded before Flop
Seat 5: /MXkdT8TTs8Qp2LVTQNw6w (big blind) folded on the Flop
Seat 6: k9nHZTHt8hYhYRcW8NTb4g folded before Flop (didn't bet)




PokerStars Game #59939365236:  Hold'em No Limit ($0.10/$0.25) - 2009/07/01 0:38:00 ET
Table 'mk323gviqdkOY5Aek/1EWg' 6-max Seat #5 is the button
Seat 1: e8w9qW2QMnrAqkudVQoHoA ($23.10 in chips) 
Seat 2: GC/9yVD59DUCX7hUI7gcLw ($26.80 in chips) 
Seat 3: aSrj4lVmn2owyQ1RbbOqxQ ($23.40 in chips) 
Seat 4: o08wk0F4gROLhZS04Iyl3w ($28.05 in chips) 
Seat 5: SFmT9ZsVopnukjvAzrxTRg ($61.55 in chips) 
Seat 6: KkXSr5xFjxLSD3wtAvT+WQ ($19.10 in chips) 
KkXSr5xFjxLSD3wtAvT+WQ: posts small blind $0.10
e8w9qW2QMnrAqkudVQoHoA: posts big blind $0.25
*** HOLE CARDS ***
GC/9yVD59DUCX7hUI7gcLw: folds 
aSrj4lVmn2owyQ1RbbOqxQ: folds 
o08wk0F4gROLhZS04Iyl3w: raises $0.60 to $0.85
SFmT9ZsVopnukjvAzrxTRg: folds 
KkXSr5xFjxLSD3wtAvT+WQ: calls $0.75
e8w9qW2QMnrAqkudVQoHoA: folds 
*** FLOP *** [3h 7h 4c]
KkXSr5xFjxLSD3wtAvT+WQ: checks 
o08wk0F4gROLhZS04Iyl3w: bets $25
KkXSr5xFjxLSD3wtAvT+WQ: folds 
Uncalled bet ($25) returned to o08wk0F4gROLhZS04Iyl3w
o08wk0F4gROLhZS04Iyl3w collected $1.90 from pot
*** SUMMARY ***
Total pot $1.95 | Rake $0.05 
Board [3h 7h 4c]
Seat 1: e8w9qW2QMnrAqkudVQoHoA (big blind) folded before Flop
Seat 2: GC/9yVD59DUCX7hUI7gcLw folded before Flop (didn't bet)
Seat 3: aSrj4lVmn2owyQ1RbbOqxQ folded before Flop (didn't bet)
Seat 4: o08wk0F4gROLhZS04Iyl3w collected ($1.90)
Seat 5: SFmT9ZsVopnukjvAzrxTRg (button) folded before Flop (didn't bet)
Seat 6: KkXSr5xFjxLSD3wtAvT+WQ (small blind) folded on the Flop




PokerStars Game #59939366160:  Hold'em No Limit ($0.10/$0.25) - 2009/07/01 0:38:01 ET
Table 'KEoOIegxPF91KooL2AelUA' 6-max Seat #4 is the button
Seat 1: wsP46AGpqDjHZQmlRHKa9g ($27.25 in chips) 
Seat 4: Vv37Oa9niKKVcR6Z7ceetw ($22.10 in chips) 
Seat 5: 2NLC44AHHKHEUooUQFYV+Q ($15.75 in chips) 
2NLC44AHHKHEUooUQFYV+Q: posts small blind $0.10
wsP46AGpqDjHZQmlRHKa9g: posts big blind $0.25
*** HOLE CARDS ***
Vv37Oa9niKKVcR6Z7ceetw said, "i had pair"
Vv37Oa9niKKVcR6Z7ceetw: raises $0.50 to $0.75
2NLC44AHHKHEUooUQFYV+Q: folds 
wsP46AGpqDjHZQmlRHKa9g: folds 
Uncalled bet ($0.50) returned to Vv37Oa9niKKVcR6Z7ceetw
Vv37Oa9niKKVcR6Z7ceetw collected $0.60 from pot
Vv37Oa9niKKVcR6Z7ceetw: doesn't show hand 
*** SUMMARY ***
Total pot $0.60 | Rake $0 
Seat 1: wsP46AGpqDjHZQmlRHKa9g (big blind) folded before Flop
Seat 4: Vv37Oa9niKKVcR6Z7ceetw (button) collected ($0.60)
Seat 5: 2NLC44AHHKHEUooUQFYV+Q (small blind) folded before Flop




PokerStars Game #59939366072:  Hold'em No Limit ($0.10/$0.25) - 2009/07/01 0:38:01 ET
Table 'Qr+t8WGovMECkBv+cV1lrg' 6-max Seat #2 is the button
Seat 1: wFKQltIqUcrrkvre6g+fyw ($34.25 in chips) 
Seat 2: i48129QFpEQQ+UN4aNtmww ($5.30 in chips) 
Seat 3: bjJnMpKgoF+vgHW2f1NCsg ($17.45 in chips) 
Seat 4: 3rlIjSrvbZoI2IILbnetnA ($25 in chips) 
Seat 6: j5NZbEJHsERuXjPHWqc1Nw ($21.25 in chips) 
bjJnMpKgoF+vgHW2f1NCsg: posts small blind $0.10
3rlIjSrvbZoI2IILbnetnA: posts big blind $0.25
iwlxXocltgSdaBmusNXanQ: sits out 
*** HOLE CARDS ***
j5NZbEJHsERuXjPHWqc1Nw: calls $0.25
wFKQltIqUcrrkvre6g+fyw: folds 
i48129QFpEQQ+UN4aNtmww: folds 
bjJnMpKgoF+vgHW2f1NCsg: calls $0.15
3rlIjSrvbZoI2IILbnetnA: raises $0.75 to $1
j5NZbEJHsERuXjPHWqc1Nw: folds 
bjJnMpKgoF+vgHW2f1NCsg: folds 
Uncalled bet ($0.75) returned to 3rlIjSrvbZoI2IILbnetnA
3rlIjSrvbZoI2IILbnetnA collected $0.75 from pot
*** SUMMARY ***
Total pot $0.75 | Rake $0 
Seat 1: wFKQltIqUcrrkvre6g+fyw folded before Flop (didn't bet)
Seat 2: i48129QFpEQQ+UN4aNtmww (button) folded before Flop (didn't bet)
Seat 3: bjJnMpKgoF+vgHW2f1NCsg (small blind) folded before Flop
Seat 4: 3rlIjSrvbZoI2IILbnetnA (big blind) collected ($0.75)
Seat 6: j5NZbEJHsERuXjPHWqc1Nw folded before Flop




PokerStars Game #59939366054:  Hold'em No Limit ($0.10/$0.25) - 2009/07/01 0:38:01 ET
Table 'UVjmXTtsmlX1HxwwZ59akg' 9-max Seat #1 is the button
Seat 1: zDrucyjVn5aeekNEc3cJrA ($27.30 in chips) 
Seat 2: COsrwJSFHQtxlUcrYtDQPQ ($27.35 in chips) 
Seat 3: N6fYvIzQLKaydFLKQGtMlQ ($25 in chips) 
Seat 4: aNpwfA31EREwO+ar4XzBCw ($25.35 in chips) 
Seat 6: DnDcAdn9P0zGovMERigpFA ($33.75 in chips) 
Seat 8: 1MicVRr41LapJvzzk3i8Tw ($11.35 in chips) 
Seat 9: CwVLsIXxfYxktnIIDbafCw ($14.15 in chips) 
COsrwJSFHQtxlUcrYtDQPQ: posts small blind $0.10
N6fYvIzQLKaydFLKQGtMlQ: posts big blind $0.25
*** HOLE CARDS ***
aNpwfA31EREwO+ar4XzBCw: folds 
DnDcAdn9P0zGovMERigpFA: folds 
CwVLsIXxfYxktnIIDbafCw said, "I guess that's what they mean if they say 'Caught with your pants down', huh?"
1MicVRr41LapJvzzk3i8Tw: raises $0.50 to $0.75
CwVLsIXxfYxktnIIDbafCw: folds 
zDrucyjVn5aeekNEc3cJrA: folds 
COsrwJSFHQtxlUcrYtDQPQ: folds 
N6fYvIzQLKaydFLKQGtMlQ: folds 
Uncalled bet ($0.50) returned to 1MicVRr41LapJvzzk3i8Tw
1MicVRr41LapJvzzk3i8Tw collected $0.60 from pot
1MicVRr41LapJvzzk3i8Tw: doesn't show hand 
*** SUMMARY ***
Total pot $0.60 | Rake $0 
Seat 1: zDrucyjVn5aeekNEc3cJrA (button) folded before Flop (didn't bet)
Seat 2: COsrwJSFHQtxlUcrYtDQPQ (small blind) folded before Flop
Seat 3: N6fYvIzQLKaydFLKQGtMlQ (big blind) folded before Flop
Seat 4: aNpwfA31EREwO+ar4XzBCw folded before Flop (didn't bet)
Seat 6: DnDcAdn9P0zGovMERigpFA folded before Flop (didn't bet)
Seat 8: 1MicVRr41LapJvzzk3i8Tw collected ($0.60)
Seat 9: CwVLsIXxfYxktnIIDbafCw folded before Flop (didn't bet)




PokerStars Game #59939366386:  Hold'em No Limit ($0.10/$0.25) - 2009/07/01 0:38:01 ET
Table 'KKcpZYT1qeSWLmZFp9A4KA' 9-max Seat #8 is the button
Seat 2: vZGoOTJLQLhkPj4I+LNGig ($26.25 in chips) 
Seat 3: j4q3p0lesp63b1gZDwLBZw ($5 in chips) 
Seat 4: jXz58rvCgq0VjyVjUBf2mw ($25 in chips) 
Seat 5: CbXUS6Z2rXZxL1AKduNtmQ ($34.25 in chips) 
Seat 6: 4awUyiDYTgylQKXZ9faBVA ($39.70 in chips) 
Seat 7: QEbIGci+itdw+re8RM5fZA ($26.45 in chips) 
Seat 8: CBv6rfZ34K2gts8YbQ4waw ($30.45 in chips) 
LWN1wPrLH+695JIriXxDuw: is sitting out 
LWN1wPrLH+695JIriXxDuw leaves the table
vZGoOTJLQLhkPj4I+LNGig: posts small blind $0.10
j4q3p0lesp63b1gZDwLBZw: posts big blind $0.25
*** HOLE CARDS ***
jXz58rvCgq0VjyVjUBf2mw: raises $0.75 to $1
CbXUS6Z2rXZxL1AKduNtmQ: folds 
4awUyiDYTgylQKXZ9faBVA: folds 
QEbIGci+itdw+re8RM5fZA: folds 
CBv6rfZ34K2gts8YbQ4waw: folds 
vZGoOTJLQLhkPj4I+LNGig: folds 
j4q3p0lesp63b1gZDwLBZw: raises $4 to $5 and is all-in
jXz58rvCgq0VjyVjUBf2mw: calls $4
*** FLOP *** [Jd 4s Th]
*** TURN *** [Jd 4s Th] [Td]
*** RIVER *** [Jd 4s Th Td] [5c]
*** SHOW DOWN ***
j4q3p0lesp63b1gZDwLBZw: shows [As Kc] (a pair of Tens)
jXz58rvCgq0VjyVjUBf2mw: shows [Jh Js] (a full house, Jacks full of Tens)
jXz58rvCgq0VjyVjUBf2mw collected $9.60 from pot
*** SUMMARY ***
Total pot $10.10 | Rake $0.50 
Board [Jd 4s Th Td 5c]
Seat 2: vZGoOTJLQLhkPj4I+LNGig (small blind) folded before Flop
Seat 3: j4q3p0lesp63b1gZDwLBZw (big blind) showed [As Kc] and lost with a pair of Tens
Seat 4: jXz58rvCgq0VjyVjUBf2mw showed [Jh Js] and won ($9.60) with a full house, Jacks full of Tens
Seat 5: CbXUS6Z2rXZxL1AKduNtmQ folded before Flop (didn't bet)
Seat 6: 4awUyiDYTgylQKXZ9faBVA folded before Flop (didn't bet)
Seat 7: QEbIGci+itdw+re8RM5fZA folded before Flop (didn't bet)
Seat 8: CBv6rfZ34K2gts8YbQ4waw (button) folded before Flop (didn't bet)




PokerStars Game #59939365980:  Hold'em No Limit ($0.10/$0.25) - 2009/07/01 0:38:01 ET
Table 'zojWVNukhD2n8RTfHCOwwg' 9-max Seat #3 is the button
Seat 1: DIBbjEYGs+TVdVgEB/4+3w ($41.45 in chips) 
Seat 2: ZeR3hkj1gVv9J4yPCmRrjA ($25 in chips) 
Seat 3: 1esmRaxnod+zAkE+7BtzMA ($16.20 in chips) 
Seat 4: Pb7qJqn2QUbp+oYBNQxyyA ($25.75 in chips) 
Seat 6: 2xNcp4M2UG8Li2PMEnWcgA ($12.80 in chips) 
Seat 7: H5Se03ZqSX7tbULXur2MAg ($27.30 in chips) 
Seat 8: j4q3p0lesp63b1gZDwLBZw ($5 in chips) 
Seat 9: 4oA316mXLIui1QY63GXBUg ($25 in chips) 
Pb7qJqn2QUbp+oYBNQxyyA: posts small blind $0.10
2xNcp4M2UG8Li2PMEnWcgA: posts big blind $0.25
*** HOLE CARDS ***
H5Se03ZqSX7tbULXur2MAg: folds 
j4q3p0lesp63b1gZDwLBZw: folds 
4oA316mXLIui1QY63GXBUg: folds 
DIBbjEYGs+TVdVgEB/4+3w: folds 
ZeR3hkj1gVv9J4yPCmRrjA: calls $0.25
1esmRaxnod+zAkE+7BtzMA: folds 
Pb7qJqn2QUbp+oYBNQxyyA: folds 
2xNcp4M2UG8Li2PMEnWcgA: checks 
*** FLOP *** [Ac Td Ks]
2xNcp4M2UG8Li2PMEnWcgA: checks 
ZeR3hkj1gVv9J4yPCmRrjA: bets $0.50
2xNcp4M2UG8Li2PMEnWcgA: calls $0.50
*** TURN *** [Ac Td Ks] [8d]
2xNcp4M2UG8Li2PMEnWcgA: checks 
ZeR3hkj1gVv9J4yPCmRrjA: bets $1.75
2xNcp4M2UG8Li2PMEnWcgA: calls $1.75
*** RIVER *** [Ac Td Ks 8d] [7c]
2xNcp4M2UG8Li2PMEnWcgA: checks 
ZeR3hkj1gVv9J4yPCmRrjA: bets $4.75
2xNcp4M2UG8Li2PMEnWcgA: folds 
Uncalled bet ($4.75) returned to ZeR3hkj1gVv9J4yPCmRrjA
ZeR3hkj1gVv9J4yPCmRrjA collected $4.85 from pot
*** SUMMARY ***
Total pot $5.10 | Rake $0.25 
Board [Ac Td Ks 8d 7c]
Seat 1: DIBbjEYGs+TVdVgEB/4+3w folded before Flop (didn't bet)
Seat 2: ZeR3hkj1gVv9J4yPCmRrjA collected ($4.85)
Seat 3: 1esmRaxnod+zAkE+7BtzMA (button) folded before Flop (didn't bet)
Seat 4: Pb7qJqn2QUbp+oYBNQxyyA (small blind) folded before Flop
Seat 6: 2xNcp4M2UG8Li2PMEnWcgA (big blind) folded on the River
Seat 7: H5Se03ZqSX7tbULXur2MAg folded before Flop (didn't bet)
Seat 8: j4q3p0lesp63b1gZDwLBZw folded before Flop (didn't bet)
Seat 9: 4oA316mXLIui1QY63GXBUg folded before Flop (didn't bet)




PokerStars Game #59939365974:  Hold'em No Limit ($0.10/$0.25) - 2009/07/01 0:38:01 ET
Table 'Is9eNmJA1KnBOw0lcVkxUQ' 9-max Seat #3 is the button
Seat 1: 56S3mA6Zs3pGR+0p0vUCtg ($36.80 in chips) 
Seat 2: VllYilcih0t+gMD4GTRlgQ ($40.40 in chips) 
Seat 3: zFrHk6ssFhTu+DiVzVXr+g ($15.85 in chips) 
Seat 4: cZ99hugmLBj9KhTlc8nCSw ($25 in chips) 
Seat 5: d9fERE+24v0MqnylCrXchQ ($5 in chips) 
Seat 6: HapyJHxV6lc3eqoT7yWL2A ($24.85 in chips) 
Seat 7: aNpwfA31EREwO+ar4XzBCw ($25 in chips) 
Seat 8: 1b3eMBC7sPXgDX9IYcruKg ($4.25 in chips) 
cZ99hugmLBj9KhTlc8nCSw: posts small blind $0.10
d9fERE+24v0MqnylCrXchQ: posts big blind $0.25
*** HOLE CARDS ***
HapyJHxV6lc3eqoT7yWL2A: calls $0.25
aNpwfA31EREwO+ar4XzBCw: folds 
1b3eMBC7sPXgDX9IYcruKg: calls $0.25
56S3mA6Zs3pGR+0p0vUCtg: folds 
VllYilcih0t+gMD4GTRlgQ: folds 
zFrHk6ssFhTu+DiVzVXr+g: folds 
cZ99hugmLBj9KhTlc8nCSw: folds 
d9fERE+24v0MqnylCrXchQ: raises $0.50 to $0.75
HapyJHxV6lc3eqoT7yWL2A: calls $0.50
1b3eMBC7sPXgDX9IYcruKg: calls $0.50
*** FLOP *** [7c 4d Ah]
d9fERE+24v0MqnylCrXchQ: checks 
HapyJHxV6lc3eqoT7yWL2A: checks 
7wo6Sr7QG3Zo6BaBDV1BOw joins the table at seat #9 
1b3eMBC7sPXgDX9IYcruKg: bets $0.50
d9fERE+24v0MqnylCrXchQ: calls $0.50
HapyJHxV6lc3eqoT7yWL2A: folds 
*** TURN *** [7c 4d Ah] [5c]
d9fERE+24v0MqnylCrXchQ: checks 
1b3eMBC7sPXgDX9IYcruKg: checks 
*** RIVER *** [7c 4d Ah 5c] [5s]
d9fERE+24v0MqnylCrXchQ: bets $0.75
1b3eMBC7sPXgDX9IYcruKg: calls $0.75
*** SHOW DOWN ***
d9fERE+24v0MqnylCrXchQ: shows [Kc Th] (a pair of Fives)
1b3eMBC7sPXgDX9IYcruKg: shows [6h As] (two pair, Aces and Fives)
1b3eMBC7sPXgDX9IYcruKg collected $4.65 from pot
*** SUMMARY ***
Total pot $4.85 | Rake $0.20 
Board [7c 4d Ah 5c 5s]
Seat 1: 56S3mA6Zs3pGR+0p0vUCtg folded before Flop (didn't bet)
Seat 2: VllYilcih0t+gMD4GTRlgQ folded before Flop (didn't bet)
Seat 3: zFrHk6ssFhTu+DiVzVXr+g (button) folded before Flop (didn't bet)
Seat 4: cZ99hugmLBj9KhTlc8nCSw (small blind) folded before Flop
Seat 5: d9fERE+24v0MqnylCrXchQ (big blind) showed [Kc Th] and lost with a pair of Fives
Seat 6: HapyJHxV6lc3eqoT7yWL2A folded on the Flop
Seat 7: aNpwfA31EREwO+ar4XzBCw folded before Flop (didn't bet)
Seat 8: 1b3eMBC7sPXgDX9IYcruKg showed [6h As] and won ($4.65) with two pair, Aces and Fives




PokerStars Game #59939366126:  Hold'em No Limit ($0.10/$0.25) - 2009/07/01 0:38:01 ET
Table 'h02LhQ7B/Zk4ETRxxHhGYA' 9-max Seat #8 is the button
Seat 1: sD+TKtt36XiiN6jqHiLwDA ($25 in chips) 
Seat 2: RJ/x9oZtt1RZLaJEQwZOxQ ($28.30 in chips) 
Seat 3: JxpnpCmvRAcrEUy7mq1iAg ($5 in chips) 
Seat 4: tYsOBqdU1+x+yFI7zHO7hQ ($38.55 in chips) 
Seat 5: cUxk0Jk4lrUQv9CJl0LPlg ($16.95 in chips) 
Seat 6: kN/irnQSdb8jibbN4f1O+Q ($16.55 in chips) 
Seat 7: rUpvA02nErFvZ4yFbDR8XA ($19.45 in chips) 
Seat 8: 7tW694tRVJnYdoa16Dw4RQ ($25.45 in chips) 
Seat 9: 1c/7DHPx5CDTmAfk8/bWeA ($14.40 in chips) 
1c/7DHPx5CDTmAfk8/bWeA: posts small blind $0.10
sD+TKtt36XiiN6jqHiLwDA: posts big blind $0.25
*** HOLE CARDS ***
RJ/x9oZtt1RZLaJEQwZOxQ: folds 
JxpnpCmvRAcrEUy7mq1iAg: raises $0.50 to $0.75
tYsOBqdU1+x+yFI7zHO7hQ: folds 
cUxk0Jk4lrUQv9CJl0LPlg: folds 
kN/irnQSdb8jibbN4f1O+Q: folds 
rUpvA02nErFvZ4yFbDR8XA: folds 
7tW694tRVJnYdoa16Dw4RQ: folds 
1c/7DHPx5CDTmAfk8/bWeA: folds 
sD+TKtt36XiiN6jqHiLwDA: folds 
Uncalled bet ($0.50) returned to JxpnpCmvRAcrEUy7mq1iAg
JxpnpCmvRAcrEUy7mq1iAg collected $0.60 from pot
JxpnpCmvRAcrEUy7mq1iAg: doesn't show hand 
*** SUMMARY ***
Total pot $0.60 | Rake $0 
Seat 1: sD+TKtt36XiiN6jqHiLwDA (big blind) folded before Flop
Seat 2: RJ/x9oZtt1RZLaJEQwZOxQ folded before Flop (didn't bet)
Seat 3: JxpnpCmvRAcrEUy7mq1iAg collected ($0.60)
Seat 4: tYsOBqdU1+x+yFI7zHO7hQ folded before Flop (didn't bet)
Seat 5: cUxk0Jk4lrUQv9CJl0LPlg folded before Flop (didn't bet)
Seat 6: kN/irnQSdb8jibbN4f1O+Q folded before Flop (didn't bet)
Seat 7: rUpvA02nErFvZ4yFbDR8XA folded before Flop (didn't bet)
Seat 8: 7tW694tRVJnYdoa16Dw4RQ (button) folded before Flop (didn't bet)
Seat 9: 1c/7DHPx5CDTmAfk8/bWeA (small blind) folded before Flop




PokerStars Game #59939366154:  Hold'em No Limit ($0.10/$0.25) - 2009/07/01 0:38:01 ET
Table 'mdub7rJf3Z5tCT9s/+1+Wg' 9-max Seat #4 is the button
Seat 1: neWdS67T0XWLJXFjrqXj5g ($15.75 in chips) 
Seat 2: vSkQm2EelzwRGDDQQk0Fqw ($4.65 in chips) 
Seat 3: t2nb95S5EEFOEzNx9Itz0g ($6.30 in chips) 
Seat 4: fDGyaQz0cs2s4FOYxkbIHA ($4.55 in chips) 
Seat 5: dfNim92Z6XK1/h5SFW5vDg ($25 in chips) 
Seat 6: hAFbY0iBwr4mouozgvjZBg ($47.60 in chips) 
Seat 7: woe+9KKk+L3pZgMTuHcmog ($26 in chips) 
Seat 8: cZ99hugmLBj9KhTlc8nCSw ($25 in chips) 
Seat 9: tYsOBqdU1+x+yFI7zHO7hQ ($36.75 in chips) 
dfNim92Z6XK1/h5SFW5vDg: posts small blind $0.10
hAFbY0iBwr4mouozgvjZBg: posts big blind $0.25
*** HOLE CARDS ***
woe+9KKk+L3pZgMTuHcmog: folds 
cZ99hugmLBj9KhTlc8nCSw: folds 
tYsOBqdU1+x+yFI7zHO7hQ: folds 
neWdS67T0XWLJXFjrqXj5g: folds 
vSkQm2EelzwRGDDQQk0Fqw: folds 
t2nb95S5EEFOEzNx9Itz0g: folds 
fDGyaQz0cs2s4FOYxkbIHA: folds 
dfNim92Z6XK1/h5SFW5vDg: folds 
Uncalled bet ($0.15) returned to hAFbY0iBwr4mouozgvjZBg
hAFbY0iBwr4mouozgvjZBg collected $0.20 from pot
hAFbY0iBwr4mouozgvjZBg: shows [Ks Ad] (high card Ace)
*** SUMMARY ***
Total pot $0.20 | Rake $0 
Seat 1: neWdS67T0XWLJXFjrqXj5g folded before Flop (didn't bet)
Seat 2: vSkQm2EelzwRGDDQQk0Fqw folded before Flop (didn't bet)
Seat 3: t2nb95S5EEFOEzNx9Itz0g folded before Flop (didn't bet)
Seat 4: fDGyaQz0cs2s4FOYxkbIHA (button) folded before Flop (didn't bet)
Seat 5: dfNim92Z6XK1/h5SFW5vDg (small blind) folded before Flop
Seat 6: hAFbY0iBwr4mouozgvjZBg (big blind) collected ($0.20)
Seat 7: woe+9KKk+L3pZgMTuHcmog folded before Flop (didn't bet)
Seat 8: cZ99hugmLBj9KhTlc8nCSw folded before Flop (didn't bet)
Seat 9: tYsOBqdU1+x+yFI7zHO7hQ folded before Flop (didn't bet)




PokerStars Game #59939366958:  Hold'em No Limit ($0.10/$0.25) - 2009/07/01 0:38:02 ET
Table '2clPgY3+dETPD/8zjXZdFw' 6-max Seat #2 is the button
Seat 2: NzIFHwilc5zU7QhjDTgTZA ($6 in chips) 
Seat 3: 6pF9LtHn+EH0ChbOXzox9g ($4.10 in chips) 
NzIFHwilc5zU7QhjDTgTZA: posts small blind $0.10
6pF9LtHn+EH0ChbOXzox9g: posts big blind $0.25
*** HOLE CARDS ***
NzIFHwilc5zU7QhjDTgTZA: raises $0.25 to $0.50
6pF9LtHn+EH0ChbOXzox9g: folds 
Uncalled bet ($0.25) returned to NzIFHwilc5zU7QhjDTgTZA
qllppsCmUqovlriIWCeM/g joins the table at seat #1 
NzIFHwilc5zU7QhjDTgTZA collected $0.50 from pot
*** SUMMARY ***
Total pot $0.50 | Rake $0 
Seat 2: NzIFHwilc5zU7QhjDTgTZA (button) (small blind) collected ($0.50)
Seat 3: 6pF9LtHn+EH0ChbOXzox9g (big blind) folded before Flop




PokerStars Game #59939366562:  Hold'em No Limit ($0.10/$0.25) - 2009/07/01 0:38:02 ET
Table 'aisAlB9GIV21BwfUW3+Nbg' 9-max Seat #5 is the button
Seat 1: H5Se03ZqSX7tbULXur2MAg ($22.70 in chips) 
Seat 2: 18G4P1XstjNvItdGUITxgw ($25 in chips) 
Seat 3: aaNpjkDAbOD7pVe8Z5CEgQ ($23.90 in chips) 
Seat 4: Z9AeOQX3yzuSvKAm/xyovg ($10 in chips) 
Seat 5: ghNKXUBl/H+t83JF079ZBA ($25 in chips) 
Seat 6: 9gmYYQesalMrUjaF7nKfrQ ($9.75 in chips) 
Seat 7: sWBBy1WroEskLNyJzhkUag ($13.75 in chips) 
Seat 8: VWUWpMLMj/Q1jRVpF7Aohw ($14.40 in chips) 
Seat 9: OlPJsgR4xypSg/w1z7Gyvw ($29.15 in chips) 
9gmYYQesalMrUjaF7nKfrQ: posts small blind $0.10
sWBBy1WroEskLNyJzhkUag: posts big blind $0.25
*** HOLE CARDS ***
VWUWpMLMj/Q1jRVpF7Aohw: folds 
OlPJsgR4xypSg/w1z7Gyvw: folds 
H5Se03ZqSX7tbULXur2MAg: folds 
18G4P1XstjNvItdGUITxgw: folds 
aaNpjkDAbOD7pVe8Z5CEgQ: calls $0.25
Z9AeOQX3yzuSvKAm/xyovg: folds 
ghNKXUBl/H+t83JF079ZBA: folds 
9gmYYQesalMrUjaF7nKfrQ: folds 
sWBBy1WroEskLNyJzhkUag: checks 
*** FLOP *** [Qc 8d 5d]
sWBBy1WroEskLNyJzhkUag: checks 
aaNpjkDAbOD7pVe8Z5CEgQ: checks 
*** TURN *** [Qc 8d 5d] [2s]
sWBBy1WroEskLNyJzhkUag: checks 
aaNpjkDAbOD7pVe8Z5CEgQ: bets $0.75
sWBBy1WroEskLNyJzhkUag: folds 
Uncalled bet ($0.75) returned to aaNpjkDAbOD7pVe8Z5CEgQ
aaNpjkDAbOD7pVe8Z5CEgQ collected $0.60 from pot
*** SUMMARY ***
Total pot $0.60 | Rake $0 
Board [Qc 8d 5d 2s]
Seat 1: H5Se03ZqSX7tbULXur2MAg folded before Flop (didn't bet)
Seat 2: 18G4P1XstjNvItdGUITxgw folded before Flop (didn't bet)
Seat 3: aaNpjkDAbOD7pVe8Z5CEgQ collected ($0.60)
Seat 4: Z9AeOQX3yzuSvKAm/xyovg folded before Flop (didn't bet)
Seat 5: ghNKXUBl/H+t83JF079ZBA (button) folded before Flop (didn't bet)
Seat 6: 9gmYYQesalMrUjaF7nKfrQ (small blind) folded before Flop
Seat 7: sWBBy1WroEskLNyJzhkUag (big blind) folded on the Turn
Seat 8: VWUWpMLMj/Q1jRVpF7Aohw folded before Flop (didn't bet)
Seat 9: OlPJsgR4xypSg/w1z7Gyvw folded before Flop (didn't bet)




PokerStars Game #59939366664:  Hold'em No Limit ($0.10/$0.25) - 2009/07/01 0:38:02 ET
Table 'KRiZ8S/xwAYkA4EWSX89ow' 9-max Seat #6 is the button
Seat 1: CYkY0dNBaYaKs8HVCVn3mQ ($5.35 in chips) 
Seat 2: vZGoOTJLQLhkPj4I+LNGig ($53.45 in chips) 
Seat 3: /fionJv+b9tkuIj/KKbXYw ($25.95 in chips) 
Seat 4: COsrwJSFHQtxlUcrYtDQPQ ($26.85 in chips) 
Seat 5: t2nb95S5EEFOEzNx9Itz0g ($5.30 in chips) 
Seat 6: DdPXdieucQ+n99u1n3A+rQ ($5.60 in chips) 
Seat 7: cZ99hugmLBj9KhTlc8nCSw ($25 in chips) 
Seat 8: nEg1b6MIksd/4x5eLY735g ($25.95 in chips) 
Seat 9: EcWpc/mcsCWBGKsSdZaXbA ($24.05 in chips) 
cZ99hugmLBj9KhTlc8nCSw: posts small blind $0.10
nEg1b6MIksd/4x5eLY735g: posts big blind $0.25
*** HOLE CARDS ***
EcWpc/mcsCWBGKsSdZaXbA: folds 
CYkY0dNBaYaKs8HVCVn3mQ: folds 
vZGoOTJLQLhkPj4I+LNGig: folds 
/fionJv+b9tkuIj/KKbXYw: folds 
COsrwJSFHQtxlUcrYtDQPQ: raises $0.55 to $0.80
t2nb95S5EEFOEzNx9Itz0g: folds 
DdPXdieucQ+n99u1n3A+rQ: folds 
cZ99hugmLBj9KhTlc8nCSw: folds 
nEg1b6MIksd/4x5eLY735g: folds 
Uncalled bet ($0.55) returned to COsrwJSFHQtxlUcrYtDQPQ
COsrwJSFHQtxlUcrYtDQPQ collected $0.60 from pot
COsrwJSFHQtxlUcrYtDQPQ: doesn't show hand 
*** SUMMARY ***
Total pot $0.60 | Rake $0 
Seat 1: CYkY0dNBaYaKs8HVCVn3mQ folded before Flop (didn't bet)
Seat 2: vZGoOTJLQLhkPj4I+LNGig folded before Flop (didn't bet)
Seat 3: /fionJv+b9tkuIj/KKbXYw folded before Flop (didn't bet)
Seat 4: COsrwJSFHQtxlUcrYtDQPQ collected ($0.60)
Seat 5: t2nb95S5EEFOEzNx9Itz0g folded before Flop (didn't bet)
Seat 6: DdPXdieucQ+n99u1n3A+rQ (button) folded before Flop (didn't bet)
Seat 7: cZ99hugmLBj9KhTlc8nCSw (small blind) folded before Flop
Seat 8: nEg1b6MIksd/4x5eLY735g (big blind) folded before Flop
Seat 9: EcWpc/mcsCWBGKsSdZaXbA folded before Flop (didn't bet)




PokerStars Game #59939366940:  Hold'em No Limit ($0.10/$0.25) - 2009/07/01 0:38:02 ET
Table 'ONP9SkU1SytzTLuNlKzIPw' 9-max Seat #8 is the button
Seat 1: s7Q6uNouhe7aE8JdFb9E+A ($34.80 in chips) 
Seat 2: sJNHTWcSlLHRCZ9+YRLLqA ($25.85 in chips) 
Seat 3: 4BZw8NrbfRfUJKKKd1c2vA ($10 in chips) 
Seat 4: rKgOH+UzKBirOiqIwBD9Nw ($14.15 in chips) 
Seat 5: lSeLm4BdnSMLtIli62qjAQ ($4.75 in chips) 
Seat 6: 6X6eofOkuCCdkJdReOpjUQ ($15 in chips) 
Seat 7: DiSvPC2iudwL5j9u6Huyww ($26.20 in chips) 
Seat 8: sUVgUtgbfVx6JpvApozwhQ ($5 in chips) 
s7Q6uNouhe7aE8JdFb9E+A: posts small blind $0.10
sJNHTWcSlLHRCZ9+YRLLqA: posts big blind $0.25
4BZw8NrbfRfUJKKKd1c2vA: posts big blind $0.25
6X6eofOkuCCdkJdReOpjUQ: posts big blind $0.25
*** HOLE CARDS ***
yyG4svzOpC1A+sUP/scg6w joins the table at seat #9 
4BZw8NrbfRfUJKKKd1c2vA: checks 
rKgOH+UzKBirOiqIwBD9Nw: calls $0.25
lSeLm4BdnSMLtIli62qjAQ: folds 
6X6eofOkuCCdkJdReOpjUQ: checks 
DiSvPC2iudwL5j9u6Huyww: folds 
sUVgUtgbfVx6JpvApozwhQ: folds 
s7Q6uNouhe7aE8JdFb9E+A: folds 
sJNHTWcSlLHRCZ9+YRLLqA: checks 
*** FLOP *** [Ac Th 6c]
sJNHTWcSlLHRCZ9+YRLLqA: checks 
4BZw8NrbfRfUJKKKd1c2vA: checks 
rKgOH+UzKBirOiqIwBD9Nw: bets $0.25
6X6eofOkuCCdkJdReOpjUQ: raises $0.25 to $0.50
sJNHTWcSlLHRCZ9+YRLLqA: folds 
4BZw8NrbfRfUJKKKd1c2vA: folds 
rKgOH+UzKBirOiqIwBD9Nw: calls $0.25
*** TURN *** [Ac Th 6c] [2c]
rKgOH+UzKBirOiqIwBD9Nw: checks 
6X6eofOkuCCdkJdReOpjUQ: bets $1
rKgOH+UzKBirOiqIwBD9Nw: folds 
Uncalled bet ($1) returned to 6X6eofOkuCCdkJdReOpjUQ
6X6eofOkuCCdkJdReOpjUQ collected $2 from pot
6X6eofOkuCCdkJdReOpjUQ: doesn't show hand 
*** SUMMARY ***
Total pot $2.10 | Rake $0.10 
Board [Ac Th 6c 2c]
Seat 1: s7Q6uNouhe7aE8JdFb9E+A (small blind) folded before Flop
Seat 2: sJNHTWcSlLHRCZ9+YRLLqA (big blind) folded on the Flop
Seat 3: 4BZw8NrbfRfUJKKKd1c2vA folded on the Flop
Seat 4: rKgOH+UzKBirOiqIwBD9Nw folded on the Turn
Seat 5: lSeLm4BdnSMLtIli62qjAQ folded before Flop (didn't bet)
Seat 6: 6X6eofOkuCCdkJdReOpjUQ collected ($2)
Seat 7: DiSvPC2iudwL5j9u6Huyww folded before Flop (didn't bet)
Seat 8: sUVgUtgbfVx6JpvApozwhQ (button) folded before Flop (didn't bet)




PokerStars Game #59939366552:  Hold'em No Limit ($0.10/$0.25) - 2009/07/01 0:38:02 ET
Table '4XGDnEByOol5up4aB2KbJw' 6-max Seat #4 is the button
Seat 2: SFmT9ZsVopnukjvAzrxTRg ($26.25 in chips) 
Seat 3: LtASJ9OlkqGrrUKGQlpGAw ($23.60 in chips) 
Seat 4: sjoibHX/s93+8Kwa5aB1dA ($28.10 in chips) 
Seat 5: Dh01+rohD2p9pXLYeBlC5Q ($15.75 in chips) 
Seat 6: ELW+DKizJhLK7k40PMkD2Q ($30.70 in chips) 
Dh01+rohD2p9pXLYeBlC5Q: posts small blind $0.10
ELW+DKizJhLK7k40PMkD2Q: posts big blind $0.25
*** HOLE CARDS ***
kyRaCIljYA6l33lSKQfNsg has returned
SFmT9ZsVopnukjvAzrxTRg: folds 
LtASJ9OlkqGrrUKGQlpGAw: folds 
sjoibHX/s93+8Kwa5aB1dA: calls $0.25
Dh01+rohD2p9pXLYeBlC5Q: calls $0.15
ELW+DKizJhLK7k40PMkD2Q: raises $0.75 to $1
sjoibHX/s93+8Kwa5aB1dA: folds 
Dh01+rohD2p9pXLYeBlC5Q: calls $0.75
*** FLOP *** [8c 3h Jh]
Dh01+rohD2p9pXLYeBlC5Q: checks 
ELW+DKizJhLK7k40PMkD2Q: bets $1.50
Dh01+rohD2p9pXLYeBlC5Q: calls $1.50
*** TURN *** [8c 3h Jh] [8s]
Dh01+rohD2p9pXLYeBlC5Q: checks 
ELW+DKizJhLK7k40PMkD2Q: checks 
*** RIVER *** [8c 3h Jh 8s] [Qh]
Dh01+rohD2p9pXLYeBlC5Q: bets $3.50
ELW+DKizJhLK7k40PMkD2Q: folds 
Uncalled bet ($3.50) returned to Dh01+rohD2p9pXLYeBlC5Q
Dh01+rohD2p9pXLYeBlC5Q collected $5 from pot
*** SUMMARY ***
Total pot $5.25 | Rake $0.25 
Board [8c 3h Jh 8s Qh]
Seat 2: SFmT9ZsVopnukjvAzrxTRg folded before Flop (didn't bet)
Seat 3: LtASJ9OlkqGrrUKGQlpGAw folded before Flop (didn't bet)
Seat 4: sjoibHX/s93+8Kwa5aB1dA (button) folded before Flop
Seat 5: Dh01+rohD2p9pXLYeBlC5Q (small blind) collected ($5)
Seat 6: ELW+DKizJhLK7k40PMkD2Q (big blind) folded on the River




PokerStars Game #59939366698:  Hold'em No Limit ($0.10/$0.25) - 2009/07/01 0:38:02 ET
Table 'g6ryG70feTw9nNm+XJLuXw' 6-max Seat #4 is the button
Seat 1: v+QfkGiuj9bgtuNoVnDO8w ($29.30 in chips) 
Seat 2: SxIIgwXYLkwd6m3wLyPTCw ($25.60 in chips) 
Seat 3: 8f0dtuUGqDbgE6up1lQAlg ($13.60 in chips) 
Seat 4: GC/9yVD59DUCX7hUI7gcLw ($37.10 in chips) 
Seat 5: EE16Ua5b1HSsYej5zeXOlA ($25 in chips) 
EE16Ua5b1HSsYej5zeXOlA: posts small blind $0.10
v+QfkGiuj9bgtuNoVnDO8w: posts big blind $0.25
*** HOLE CARDS ***
SxIIgwXYLkwd6m3wLyPTCw: folds 
8f0dtuUGqDbgE6up1lQAlg: folds 
8f0dtuUGqDbgE6up1lQAlg leaves the table
GC/9yVD59DUCX7hUI7gcLw: folds 
EE16Ua5b1HSsYej5zeXOlA: raises $0.60 to $0.85
v+QfkGiuj9bgtuNoVnDO8w: folds 
Uncalled bet ($0.60) returned to EE16Ua5b1HSsYej5zeXOlA
EE16Ua5b1HSsYej5zeXOlA collected $0.50 from pot
EE16Ua5b1HSsYej5zeXOlA: doesn't show hand 
*** SUMMARY ***
Total pot $0.50 | Rake $0 
Seat 1: v+QfkGiuj9bgtuNoVnDO8w (big blind) folded before Flop
Seat 2: SxIIgwXYLkwd6m3wLyPTCw folded before Flop (didn't bet)
Seat 3: 8f0dtuUGqDbgE6up1lQAlg folded before Flop (didn't bet)
Seat 4: GC/9yVD59DUCX7hUI7gcLw (button) folded before Flop (didn't bet)
Seat 5: EE16Ua5b1HSsYej5zeXOlA (small blind) collected ($0.50)




PokerStars Game #59939366756:  Hold'em No Limit ($0.10/$0.25) - 2009/07/01 0:38:02 ET
Table 'oJpFwZj9+FUGHX90Un8s9Q' 6-max Seat #3 is the button
Seat 1: bkBfOBmBcZKg8k/zXu9rWQ ($5 in chips) 
Seat 2: IMmIhmfU3tqkaJABnD21Rg ($14.95 in chips) 
Seat 3: kyRaCIljYA6l33lSKQfNsg ($26.65 in chips) 
Seat 4: IX/nJvz3Mx/Ez6DgueFA4Q ($5.80 in chips) 
Seat 6: Zijzy/UtPWzWVUo81HHVjQ ($41.45 in chips) 
IX/nJvz3Mx/Ez6DgueFA4Q: posts small blind $0.10
Zijzy/UtPWzWVUo81HHVjQ: posts big blind $0.25
bkBfOBmBcZKg8k/zXu9rWQ: posts big blind $0.25
*** HOLE CARDS ***
bkBfOBmBcZKg8k/zXu9rWQ: checks 
IMmIhmfU3tqkaJABnD21Rg: folds 
kyRaCIljYA6l33lSKQfNsg: folds 
IX/nJvz3Mx/Ez6DgueFA4Q: calls $0.15
Zijzy/UtPWzWVUo81HHVjQ: checks 
*** FLOP *** [5c Th Jc]
IX/nJvz3Mx/Ez6DgueFA4Q: bets $1
kG34n23qFQA3nzdOJTQ1dA joins the table at seat #5 
Zijzy/UtPWzWVUo81HHVjQ: calls $1
bkBfOBmBcZKg8k/zXu9rWQ: folds 
*** TURN *** [5c Th Jc] [7c]
IX/nJvz3Mx/Ez6DgueFA4Q: bets $4.55 and is all-in
Zijzy/UtPWzWVUo81HHVjQ: folds 
Uncalled bet ($4.55) returned to IX/nJvz3Mx/Ez6DgueFA4Q
IX/nJvz3Mx/Ez6DgueFA4Q collected $2.65 from pot
IX/nJvz3Mx/Ez6DgueFA4Q: shows [8s 9d] (a straight, Seven to Jack)
*** SUMMARY ***
Total pot $2.75 | Rake $0.10 
Board [5c Th Jc 7c]
Seat 1: bkBfOBmBcZKg8k/zXu9rWQ folded on the Flop
Seat 2: IMmIhmfU3tqkaJABnD21Rg folded before Flop (didn't bet)
Seat 3: kyRaCIljYA6l33lSKQfNsg (button) folded before Flop (didn't bet)
Seat 4: IX/nJvz3Mx/Ez6DgueFA4Q (small blind) collected ($2.65)
Seat 6: Zijzy/UtPWzWVUo81HHVjQ (big blind) folded on the Turn




PokerStars Game #59939366700:  Hold'em No Limit ($0.10/$0.25) - 2009/07/01 0:38:02 ET
Table 'nyTW9cVtYentc5V7xU/0jA' 6-max Seat #6 is the button
Seat 1: YfxPRDAWfqnGBhiIEdlTYg ($6.05 in chips) 
Seat 2: 7FmwVDcdEtxDpHmP4hOXsQ ($25 in chips) 
Seat 3: kG34n23qFQA3nzdOJTQ1dA ($24.90 in chips) 
Seat 4: r6u7MWSXF30/khcTYkrG9Q ($37.60 in chips) 
Seat 5: BedjMfrlRfPgSq7CXpPAmg ($25 in chips) 
Seat 6: dQJByDqHOLbgqX/HobyAJA ($7.05 in chips) 
YfxPRDAWfqnGBhiIEdlTYg: posts small blind $0.10
7FmwVDcdEtxDpHmP4hOXsQ: posts big blind $0.25
*** HOLE CARDS ***
kG34n23qFQA3nzdOJTQ1dA: folds 
r6u7MWSXF30/khcTYkrG9Q: raises $0.50 to $0.75
BedjMfrlRfPgSq7CXpPAmg: folds 
dQJByDqHOLbgqX/HobyAJA: folds 
YfxPRDAWfqnGBhiIEdlTYg: calls $0.65
7FmwVDcdEtxDpHmP4hOXsQ: calls $0.50
*** FLOP *** [3s 5c 6s]
YfxPRDAWfqnGBhiIEdlTYg: checks 
7FmwVDcdEtxDpHmP4hOXsQ: checks 
r6u7MWSXF30/khcTYkrG9Q: checks 
*** TURN *** [3s 5c 6s] [2s]
YfxPRDAWfqnGBhiIEdlTYg: bets $5.30 and is all-in
7FmwVDcdEtxDpHmP4hOXsQ: calls $5.30
r6u7MWSXF30/khcTYkrG9Q: folds 
*** RIVER *** [3s 5c 6s 2s] [Ks]
*** SHOW DOWN ***
YfxPRDAWfqnGBhiIEdlTYg: shows [5h As] (a flush, Ace high)
7FmwVDcdEtxDpHmP4hOXsQ: mucks hand 
YfxPRDAWfqnGBhiIEdlTYg collected $12.25 from pot
*** SUMMARY ***
Total pot $12.85 | Rake $0.60 
Board [3s 5c 6s 2s Ks]
Seat 1: YfxPRDAWfqnGBhiIEdlTYg (small blind) showed [5h As] and won ($12.25) with a flush, Ace high
Seat 2: 7FmwVDcdEtxDpHmP4hOXsQ (big blind) mucked
Seat 3: kG34n23qFQA3nzdOJTQ1dA folded before Flop (didn't bet)
Seat 4: r6u7MWSXF30/khcTYkrG9Q folded on the Turn
Seat 5: BedjMfrlRfPgSq7CXpPAmg folded before Flop (didn't bet)
Seat 6: dQJByDqHOLbgqX/HobyAJA (button) folded before Flop (didn't bet)




PokerStars Game #59939366604:  Hold'em No Limit ($0.10/$0.25) - 2009/07/01 0:38:02 ET
Table '2AUmC2Rslg+QUbLfdgNdfg' 6-max Seat #3 is the button
Seat 1: lgP2sg9oZJsNSXCt7tbwRg ($16.60 in chips) 
Seat 2: CCxAG7iPVlAv3brCqrGBEg ($14.75 in chips) 
Seat 3: iauW7L/+7qzAuHow7CD75Q ($5.95 in chips) 
Seat 4: B6R6e73iyJNddUtXtvYr3Q ($48.05 in chips) 
Seat 5: 8ClCHtFXGNplITm+63KB+Q ($23.30 in chips) 
Seat 6: BvTq4Tu0zBOsniW3eFCnkQ ($31.90 in chips) 
B6R6e73iyJNddUtXtvYr3Q: posts small blind $0.10
8ClCHtFXGNplITm+63KB+Q: posts big blind $0.25
*** HOLE CARDS ***
BvTq4Tu0zBOsniW3eFCnkQ: raises $0.75 to $1
lgP2sg9oZJsNSXCt7tbwRg: folds 
CCxAG7iPVlAv3brCqrGBEg: folds 
iauW7L/+7qzAuHow7CD75Q: calls $1
B6R6e73iyJNddUtXtvYr3Q: folds 
8ClCHtFXGNplITm+63KB+Q: folds 
*** FLOP *** [Ac Kd 5h]
BvTq4Tu0zBOsniW3eFCnkQ: bets $1.75
iauW7L/+7qzAuHow7CD75Q: folds 
Uncalled bet ($1.75) returned to BvTq4Tu0zBOsniW3eFCnkQ
BvTq4Tu0zBOsniW3eFCnkQ collected $2.25 from pot
BvTq4Tu0zBOsniW3eFCnkQ: doesn't show hand 
*** SUMMARY ***
Total pot $2.35 | Rake $0.10 
Board [Ac Kd 5h]
Seat 1: lgP2sg9oZJsNSXCt7tbwRg folded before Flop (didn't bet)
Seat 2: CCxAG7iPVlAv3brCqrGBEg folded before Flop (didn't bet)
Seat 3: iauW7L/+7qzAuHow7CD75Q (button) folded on the Flop
Seat 4: B6R6e73iyJNddUtXtvYr3Q (small blind) folded before Flop
Seat 5: 8ClCHtFXGNplITm+63KB+Q (big blind) folded before Flop
Seat 6: BvTq4Tu0zBOsniW3eFCnkQ collected ($2.25)




PokerStars Game #59939367222:  Hold'em No Limit ($0.10/$0.25) - 2009/07/01 0:38:03 ET
Table 'O5NgMYt6EWbLBozZb3kseg' 6-max Seat #4 is the button
Seat 1: T2fEtpqj5ZyZAjEhNtsFAA ($22.40 in chips) 
Seat 2: VWbjqONyDvf8KegytgPLjQ ($62.40 in chips) 
Seat 3: dg3SMYXD7586yGx+LuFM0g ($15.85 in chips) 
Seat 4: aogAb4Eienxztk8p2v9VVw ($24.65 in chips) 
Seat 5: vu2kzHaDtgr6NM7rdq0chA ($45.60 in chips) 
Seat 6: k9vn40MOqqb+xF+7GZ6v2g ($23.20 in chips) 
vu2kzHaDtgr6NM7rdq0chA: posts small blind $0.10
k9vn40MOqqb+xF+7GZ6v2g: posts big blind $0.25
*** HOLE CARDS ***
T2fEtpqj5ZyZAjEhNtsFAA: calls $0.25
VWbjqONyDvf8KegytgPLjQ: raises $0.75 to $1
dg3SMYXD7586yGx+LuFM0g: calls $1
aogAb4Eienxztk8p2v9VVw: calls $1
vu2kzHaDtgr6NM7rdq0chA: folds 
k9vn40MOqqb+xF+7GZ6v2g: folds 
T2fEtpqj5ZyZAjEhNtsFAA: calls $0.75
*** FLOP *** [4h Qh Jd]
T2fEtpqj5ZyZAjEhNtsFAA: checks 
VWbjqONyDvf8KegytgPLjQ: checks 
dg3SMYXD7586yGx+LuFM0g: bets $14.85 and is all-in
aogAb4Eienxztk8p2v9VVw: folds 
T2fEtpqj5ZyZAjEhNtsFAA: calls $14.85
VWbjqONyDvf8KegytgPLjQ: folds 
*** TURN *** [4h Qh Jd] [4c]
*** RIVER *** [4h Qh Jd 4c] [Kh]
*** SHOW DOWN ***
T2fEtpqj5ZyZAjEhNtsFAA: shows [Kd Qd] (two pair, Kings and Queens)
dg3SMYXD7586yGx+LuFM0g: mucks hand 
T2fEtpqj5ZyZAjEhNtsFAA collected $32.40 from pot
*** SUMMARY ***
Total pot $34.05 | Rake $1.65 
Board [4h Qh Jd 4c Kh]
Seat 1: T2fEtpqj5ZyZAjEhNtsFAA showed [Kd Qd] and won ($32.40) with two pair, Kings and Queens
Seat 2: VWbjqONyDvf8KegytgPLjQ folded on the Flop
Seat 3: dg3SMYXD7586yGx+LuFM0g mucked
Seat 4: aogAb4Eienxztk8p2v9VVw (button) folded on the Flop
Seat 5: vu2kzHaDtgr6NM7rdq0chA (small blind) folded before Flop
Seat 6: k9vn40MOqqb+xF+7GZ6v2g (big blind) folded before Flop




PokerStars Game #59939367562:  Hold'em No Limit ($0.10/$0.25) - 2009/07/01 0:38:03 ET
Table 'sgdCtiuCu2BDZhyDi6RzTA' 6-max Seat #3 is the button
Seat 2: FONMraB4GCHzDwDcfciKyw ($25 in chips) 
Seat 3: yzFNNFIfC89bBPwpFPx2ow ($15.35 in chips) 
Seat 4: rVKEgilmMX+EkKzDVvhmxA ($6.85 in chips) 
Seat 5: kD/Cb2UM93FAVgDMhEEb5g ($12.95 in chips) 
Seat 6: KODslGU8ikCYS0/29dUkhg ($8.10 in chips) 
rVKEgilmMX+EkKzDVvhmxA: posts small blind $0.10
kD/Cb2UM93FAVgDMhEEb5g: posts big blind $0.25
3zD3qLXT1bEffAoWGnc7wg: sits out 
*** HOLE CARDS ***
KODslGU8ikCYS0/29dUkhg: calls $0.25
FONMraB4GCHzDwDcfciKyw: folds 
yzFNNFIfC89bBPwpFPx2ow: folds 
rVKEgilmMX+EkKzDVvhmxA: folds 
kD/Cb2UM93FAVgDMhEEb5g: checks 
*** FLOP *** [Qc Ad Qs]
kD/Cb2UM93FAVgDMhEEb5g: checks 
KODslGU8ikCYS0/29dUkhg: bets $0.50
kD/Cb2UM93FAVgDMhEEb5g: calls $0.50
*** TURN *** [Qc Ad Qs] [6d]
kD/Cb2UM93FAVgDMhEEb5g: checks 
KODslGU8ikCYS0/29dUkhg: checks 
*** RIVER *** [Qc Ad Qs 6d] [Jd]
kD/Cb2UM93FAVgDMhEEb5g: bets $0.50
KODslGU8ikCYS0/29dUkhg: folds 
Uncalled bet ($0.50) returned to kD/Cb2UM93FAVgDMhEEb5g
kD/Cb2UM93FAVgDMhEEb5g collected $1.55 from pot
*** SUMMARY ***
Total pot $1.60 | Rake $0.05 
Board [Qc Ad Qs 6d Jd]
Seat 2: FONMraB4GCHzDwDcfciKyw folded before Flop (didn't bet)
Seat 3: yzFNNFIfC89bBPwpFPx2ow (button) folded before Flop (didn't bet)
Seat 4: rVKEgilmMX+EkKzDVvhmxA (small blind) folded before Flop
Seat 5: kD/Cb2UM93FAVgDMhEEb5g (big blind) collected ($1.55)
Seat 6: KODslGU8ikCYS0/29dUkhg folded on the River




PokerStars Game #59939367292:  Hold'em No Limit ($0.10/$0.25) - 2009/07/01 0:38:03 ET
Table '8UiaYOdeBwzanG6w1SMeFg' 9-max Seat #6 is the button
Seat 1: JxpnpCmvRAcrEUy7mq1iAg ($5 in chips) 
Seat 2: 18G4P1XstjNvItdGUITxgw ($25 in chips) 
Seat 3: A7xJNkBMCQG6Zuocn2v8YQ ($14.60 in chips) 
Seat 4: H5Se03ZqSX7tbULXur2MAg ($30.10 in chips) 
Seat 5: UmzixCpC0bAc1lDEjgB3NQ ($19.30 in chips) 
Seat 6: N6fYvIzQLKaydFLKQGtMlQ ($23.30 in chips) 
Seat 7: E0iYnEVO2ho7dH3QcCjw7g ($26.85 in chips) 
Seat 8: hBMUlEpyU74r/fwDgIpXjQ ($49.20 in chips) 
Seat 9: ux2QXCjHQkbhR6RxT0Abnw ($22.15 in chips) 
E0iYnEVO2ho7dH3QcCjw7g: posts small blind $0.10
hBMUlEpyU74r/fwDgIpXjQ: posts big blind $0.25
*** HOLE CARDS ***
ux2QXCjHQkbhR6RxT0Abnw: calls $0.25
JxpnpCmvRAcrEUy7mq1iAg: folds 
18G4P1XstjNvItdGUITxgw: folds 
A7xJNkBMCQG6Zuocn2v8YQ: folds 
H5Se03ZqSX7tbULXur2MAg: calls $0.25
UmzixCpC0bAc1lDEjgB3NQ: folds 
N6fYvIzQLKaydFLKQGtMlQ: folds 
E0iYnEVO2ho7dH3QcCjw7g: folds 
hBMUlEpyU74r/fwDgIpXjQ: raises $1 to $1.25
ux2QXCjHQkbhR6RxT0Abnw: calls $1
H5Se03ZqSX7tbULXur2MAg: folds 
*** FLOP *** [2d 4d 8d]
hBMUlEpyU74r/fwDgIpXjQ: checks 
ux2QXCjHQkbhR6RxT0Abnw: bets $2
hBMUlEpyU74r/fwDgIpXjQ: folds 
Uncalled bet ($2) returned to ux2QXCjHQkbhR6RxT0Abnw
ux2QXCjHQkbhR6RxT0Abnw collected $2.75 from pot
*** SUMMARY ***
Total pot $2.85 | Rake $0.10 
Board [2d 4d 8d]
Seat 1: JxpnpCmvRAcrEUy7mq1iAg folded before Flop (didn't bet)
Seat 2: 18G4P1XstjNvItdGUITxgw folded before Flop (didn't bet)
Seat 3: A7xJNkBMCQG6Zuocn2v8YQ folded before Flop (didn't bet)
Seat 4: H5Se03ZqSX7tbULXur2MAg folded before Flop
Seat 5: UmzixCpC0bAc1lDEjgB3NQ folded before Flop (didn't bet)
Seat 6: N6fYvIzQLKaydFLKQGtMlQ (button) folded before Flop (didn't bet)
Seat 7: E0iYnEVO2ho7dH3QcCjw7g (small blind) folded before Flop
Seat 8: hBMUlEpyU74r/fwDgIpXjQ (big blind) folded on the Flop
Seat 9: ux2QXCjHQkbhR6RxT0Abnw collected ($2.75)




PokerStars Game #59939367224:  Hold'em No Limit ($0.10/$0.25) - 2009/07/01 0:38:03 ET
Table 'HQOv+27sJF7e8+zUsBlT2w' 9-max Seat #3 is the button
Seat 1: CbXUS6Z2rXZxL1AKduNtmQ ($26.25 in chips) 
Seat 2: MG90wfSJZnOejs/KD3vlQQ ($25 in chips) 
Seat 3: 18G4P1XstjNvItdGUITxgw ($29.45 in chips) 
Seat 4: kRW/Cdh6F1t40Vs43OFbYA ($16.75 in chips) 
Seat 5: nD+0ILJGeuYzreVIK9/wcA ($15 in chips) 
Seat 6: vZGoOTJLQLhkPj4I+LNGig ($32.60 in chips) 
Seat 7: GmzfAfxcxu1kGbPC+9LkVg ($24.65 in chips) 
Seat 8: RaXCy4DBrUrZSg4MF8FyDg ($12.25 in chips) 
Seat 9: gehe91e0IyVT0QU/XBkEyg ($25 in chips) 
kRW/Cdh6F1t40Vs43OFbYA: posts small blind $0.10
nD+0ILJGeuYzreVIK9/wcA: posts big blind $0.25
*** HOLE CARDS ***
vZGoOTJLQLhkPj4I+LNGig: folds 
GmzfAfxcxu1kGbPC+9LkVg: folds 
RaXCy4DBrUrZSg4MF8FyDg: folds 
gehe91e0IyVT0QU/XBkEyg: folds 
CbXUS6Z2rXZxL1AKduNtmQ: folds 
MG90wfSJZnOejs/KD3vlQQ: folds 
18G4P1XstjNvItdGUITxgw: folds 
kRW/Cdh6F1t40Vs43OFbYA: calls $0.15
nD+0ILJGeuYzreVIK9/wcA: checks 
*** FLOP *** [7c 8h 9c]
kRW/Cdh6F1t40Vs43OFbYA: checks 
nD+0ILJGeuYzreVIK9/wcA: bets $0.25
kRW/Cdh6F1t40Vs43OFbYA: folds 
Uncalled bet ($0.25) returned to nD+0ILJGeuYzreVIK9/wcA
nD+0ILJGeuYzreVIK9/wcA collected $0.50 from pot
nD+0ILJGeuYzreVIK9/wcA: doesn't show hand 
*** SUMMARY ***
Total pot $0.50 | Rake $0 
Board [7c 8h 9c]
Seat 1: CbXUS6Z2rXZxL1AKduNtmQ folded before Flop (didn't bet)
Seat 2: MG90wfSJZnOejs/KD3vlQQ folded before Flop (didn't bet)
Seat 3: 18G4P1XstjNvItdGUITxgw (button) folded before Flop (didn't bet)
Seat 4: kRW/Cdh6F1t40Vs43OFbYA (small blind) folded on the Flop
Seat 5: nD+0ILJGeuYzreVIK9/wcA (big blind) collected ($0.50)
Seat 6: vZGoOTJLQLhkPj4I+LNGig folded before Flop (didn't bet)
Seat 7: GmzfAfxcxu1kGbPC+9LkVg folded before Flop (didn't bet)
Seat 8: RaXCy4DBrUrZSg4MF8FyDg folded before Flop (didn't bet)
Seat 9: gehe91e0IyVT0QU/XBkEyg folded before Flop (didn't bet)




PokerStars Game #59939367730:  Hold'em No Limit ($0.10/$0.25) - 2009/07/01 0:38:04 ET
Table 'mF3KHGMaTpaBZbtBoyfTeg' 6-max Seat #3 is the button
Seat 1: 0HAB2GdCAM7p7V00xueAVQ ($9.80 in chips) 
Seat 2: 4x9jCqgSw4272dnaIqnanw ($3.35 in chips) 
Seat 3: Hzrn9DZJegEZICufTNYkrg ($14.75 in chips) 
Seat 4: FYepjhAvF8ZdVCmqHIy+eQ ($26 in chips) 
Seat 5: sEQx9G5Cu8k1HNdQasxvUA ($28.55 in chips) 
FYepjhAvF8ZdVCmqHIy+eQ: posts small blind $0.10
sEQx9G5Cu8k1HNdQasxvUA: posts big blind $0.25
*** HOLE CARDS ***
0HAB2GdCAM7p7V00xueAVQ: calls $0.25
4x9jCqgSw4272dnaIqnanw: raises $3.10 to $3.35 and is all-in
Hzrn9DZJegEZICufTNYkrg: folds 
FYepjhAvF8ZdVCmqHIy+eQ: folds 
sEQx9G5Cu8k1HNdQasxvUA: folds 
0HAB2GdCAM7p7V00xueAVQ: folds 
Uncalled bet ($3.10) returned to 4x9jCqgSw4272dnaIqnanw
4x9jCqgSw4272dnaIqnanw collected $0.85 from pot
*** SUMMARY ***
Total pot $0.85 | Rake $0 
Seat 1: 0HAB2GdCAM7p7V00xueAVQ folded before Flop
Seat 2: 4x9jCqgSw4272dnaIqnanw collected ($0.85)
Seat 3: Hzrn9DZJegEZICufTNYkrg (button) folded before Flop (didn't bet)
Seat 4: FYepjhAvF8ZdVCmqHIy+eQ (small blind) folded before Flop
Seat 5: sEQx9G5Cu8k1HNdQasxvUA (big blind) folded before Flop




PokerStars Game #59939367884:  Hold'em No Limit ($0.10/$0.25) - 2009/07/01 0:38:04 ET
Table 'KTZXQ4LREPjpS54R3DFTsw' 9-max Seat #9 is the button
Seat 1: dSjkBIV7Bv+ZCIWNBguf7w ($21.60 in chips) 
Seat 2: hQgb9iRlpctfdl51mltYlw ($29.35 in chips) 
Seat 3: N6fYvIzQLKaydFLKQGtMlQ ($37.45 in chips) 
Seat 5: HPEB+AtKw1+C/cxU0o1ciw ($31.60 in chips) 
Seat 6: 1q23ISSsSMhv2lHXBfj9/A ($24.75 in chips) 
Seat 8: s++YekTPLdOGgNR0tlMkdA ($9.45 in chips) 
Seat 9: E4pjUoTJmJNmancGXn1nSw ($18.25 in chips) 
dSjkBIV7Bv+ZCIWNBguf7w: posts small blind $0.10
hQgb9iRlpctfdl51mltYlw: posts big blind $0.25
yyG4svzOpC1A+sUP/scg6w: sits out 
*** HOLE CARDS ***
N6fYvIzQLKaydFLKQGtMlQ: folds 
HPEB+AtKw1+C/cxU0o1ciw: folds 
1q23ISSsSMhv2lHXBfj9/A: raises $0.25 to $0.50
s++YekTPLdOGgNR0tlMkdA: folds 
E4pjUoTJmJNmancGXn1nSw: folds 
dSjkBIV7Bv+ZCIWNBguf7w: raises $0.25 to $0.75
hQgb9iRlpctfdl51mltYlw: folds 
1q23ISSsSMhv2lHXBfj9/A: calls $0.25
*** FLOP *** [5d 4h 8s]
dSjkBIV7Bv+ZCIWNBguf7w: checks 
1q23ISSsSMhv2lHXBfj9/A: checks 
*** TURN *** [5d 4h 8s] [Jc]
dSjkBIV7Bv+ZCIWNBguf7w: bets $0.50
1q23ISSsSMhv2lHXBfj9/A: calls $0.50
*** RIVER *** [5d 4h 8s Jc] [4d]
dSjkBIV7Bv+ZCIWNBguf7w: bets $2.50
1q23ISSsSMhv2lHXBfj9/A: folds 
Uncalled bet ($2.50) returned to dSjkBIV7Bv+ZCIWNBguf7w
dSjkBIV7Bv+ZCIWNBguf7w collected $2.65 from pot
*** SUMMARY ***
Total pot $2.75 | Rake $0.10 
Board [5d 4h 8s Jc 4d]
Seat 1: dSjkBIV7Bv+ZCIWNBguf7w (small blind) collected ($2.65)
Seat 2: hQgb9iRlpctfdl51mltYlw (big blind) folded before Flop
Seat 3: N6fYvIzQLKaydFLKQGtMlQ folded before Flop (didn't bet)
Seat 5: HPEB+AtKw1+C/cxU0o1ciw folded before Flop (didn't bet)
Seat 6: 1q23ISSsSMhv2lHXBfj9/A folded on the River
Seat 8: s++YekTPLdOGgNR0tlMkdA folded before Flop (didn't bet)
Seat 9: E4pjUoTJmJNmancGXn1nSw (button) folded before Flop (didn't bet)




PokerStars Game #59939368062:  Hold'em No Limit ($0.10/$0.25) - 2009/07/01 0:38:04 ET
Table 'Zi9/NqNs3XoL1eWhMCyZyg' 9-max Seat #7 is the button
Seat 2: Th3FldXKQW6hWVVPahaoOQ ($30.80 in chips) 
Seat 3: rUpvA02nErFvZ4yFbDR8XA ($22 in chips) 
Seat 4: D3XCkXRktDfPlSguxwfnRA ($13.35 in chips) 
Seat 5: OiV1PWZ3IkN29JlmCcnTwQ ($4.65 in chips) 
Seat 6: b3P5tPsBbrP+aAO9+Ts/Nw ($37.85 in chips) 
Seat 7: qul+IMROTuFj45eWi2Tpvg ($48.30 in chips) 
Seat 9: tYsOBqdU1+x+yFI7zHO7hQ ($30.85 in chips) 
tYsOBqdU1+x+yFI7zHO7hQ: posts small blind $0.10
JxpnpCmvRAcrEUy7mq1iAg: is sitting out 
Th3FldXKQW6hWVVPahaoOQ: posts big blind $0.25
*** HOLE CARDS ***
JxpnpCmvRAcrEUy7mq1iAg leaves the table
rUpvA02nErFvZ4yFbDR8XA: folds 
D3XCkXRktDfPlSguxwfnRA: folds 
OiV1PWZ3IkN29JlmCcnTwQ: folds 
b3P5tPsBbrP+aAO9+Ts/Nw: folds 
opOCI2p6kW0tINuVaAqmcQ joins the table at seat #1 
qul+IMROTuFj45eWi2Tpvg: calls $0.25
tYsOBqdU1+x+yFI7zHO7hQ: folds 
Th3FldXKQW6hWVVPahaoOQ: checks 
*** FLOP *** [Kh 8h Qs]
Th3FldXKQW6hWVVPahaoOQ: bets $0.50
qul+IMROTuFj45eWi2Tpvg: folds 
Uncalled bet ($0.50) returned to Th3FldXKQW6hWVVPahaoOQ
Th3FldXKQW6hWVVPahaoOQ collected $0.60 from pot
Th3FldXKQW6hWVVPahaoOQ: doesn't show hand 
*** SUMMARY ***
Total pot $0.60 | Rake $0 
Board [Kh 8h Qs]
Seat 2: Th3FldXKQW6hWVVPahaoOQ (big blind) collected ($0.60)
Seat 3: rUpvA02nErFvZ4yFbDR8XA folded before Flop (didn't bet)
Seat 4: D3XCkXRktDfPlSguxwfnRA folded before Flop (didn't bet)
Seat 5: OiV1PWZ3IkN29JlmCcnTwQ folded before Flop (didn't bet)
Seat 6: b3P5tPsBbrP+aAO9+Ts/Nw folded before Flop (didn't bet)
Seat 7: qul+IMROTuFj45eWi2Tpvg (button) folded on the Flop
Seat 9: tYsOBqdU1+x+yFI7zHO7hQ (small blind) folded before Flop




PokerStars Game #599393682968296old'em No Limit ($0.10/$0.25) - 2009/07/01 0:38:04 ET
Table 'Do4nrTNDYpK3sQjwFxX+Og' 6-max Seat #6 is the button
Seat 1: 7JrQNOR9wRBxq9ijFhWieg ($25 in chips) 
Seat 2: tzMoGl9F0PUr5NibYueeSw ($46.15 in chips) 
Seat 3: TSmua8tGK3sTbwi0ynrW9Q ($32.15 in chips) 
Seat 4: df7bIV965hvGEDiUAs5cfQ ($18.25 in chips) 
Seat 5: Ew/TYPQIsbQ2X8nm5iAJBg ($29.75 in chips) 
Seat 6: eHsmIvAb2JREg4O6hNPnXg ($22.95 in chips) 
7JrQNOR9wRBxq9ijFhWieg: posts small blind $0.10
tzMoGl9F0PUr5NibYueeSw: posts big blind $0.25
*** HOLE CARDS ***
TSmua8tGK3sTbwi0ynrW9Q: folds 
df7bIV965hvGEDiUAs5cfQ: raises $0.50 to $0.75
Ew/TYPQIsbQ2X8nm5iAJBg: folds 
eHsmIvAb2JREg4O6hNPnXg: calls $0.75
7JrQNOR9wRBxq9ijFhWieg: folds 
tzMoGl9F0PUr5NibYueeSw: calls $0.50
*** FLOP *** [Qs 5h Jh]
tzMoGl9F0PUr5NibYueeSw: checks 
df7bIV965hvGEDiUAs5cfQ: checks 
eHsmIvAb2JREg4O6hNPnXg: checks 
*** TURN *** [Qs 5h Jh] [6c]
tzMoGl9F0PUr5NibYueeSw: checks 
df7bIV965hvGEDiUAs5cfQ: checks 
eHsmIvAb2JREg4O6hNPnXg: bets $0.50
tzMoGl9F0PUr5NibYueeSw: folds 
df7bIV965hvGEDiUAs5cfQ: folds 
Uncalled bet ($0.50) returned to eHsmIvAb2JREg4O6hNPnXg
eHsmIvAb2JREg4O6hNPnXg collected $2.25 from pot
*** SUMMARY ***
Total pot $2.35 | Rake $0.10 
Board [Qs 5h Jh 6c]
Seat 1: 7JrQNOR9wRBxq9ijFhWieg (small blind) folded before Flop
Seat 2: tzMoGl9F0PUr5NibYueeSw (big blind) folded on the Turn
Seat 3: TSmua8tGK3sTbwi0ynrW9Q folded before Flop (didn't bet)
Seat 4: df7bIV965hvGEDiUAs5cfQ folded on the Turn
Seat 5: Ew/TYPQIsbQ2X8nm5iAJBg folded before Flop (didn't bet)
Seat 6: eHsmIvAb2JREg4O6hNPnXg (button) collected ($2.25)




PokerStars Game #59939368728:  Hold'em No Limit ($0.10/$0.25) - 2009/07/01 0:38:05 ET
Table '+198VWQSWBhYQOcizzuBkw' 6-max Seat #3 is the button
Seat 2: R6AGToFJQOYVZAjC2jXEKw ($29.40 in chips) 
Seat 3: BYxjLnV1/LL0aZcTbfAOvw ($27.25 in chips) 
Seat 4: TgDsTeCdLQt8kWbL00ByRA ($27.70 in chips) 
Seat 5: LtASJ9OlkqGrrUKGQlpGAw ($30.80 in chips) 
Seat 6: 7qRk4YH4/k/08LgJSv7rBQ ($30.05 in chips) 
TgDsTeCdLQt8kWbL00ByRA: posts small blind $0.10
LtASJ9OlkqGrrUKGQlpGAw: posts big blind $0.25
*** HOLE CARDS ***
7qRk4YH4/k/08LgJSv7rBQ: raises $0.75 to $1
R6AGToFJQOYVZAjC2jXEKw: folds 
BYxjLnV1/LL0aZcTbfAOvw: folds 
TgDsTeCdLQt8kWbL00ByRA: folds 
LtASJ9OlkqGrrUKGQlpGAw: folds 
Uncalled bet ($0.75) returned to 7qRk4YH4/k/08LgJSv7rBQ
GM93mEv/GkWPhKJ25MExaw leaves the table
7qRk4YH4/k/08LgJSv7rBQ collected $0.60 from pot
7qRk4YH4/k/08LgJSv7rBQ: doesn't show hand 
*** SUMMARY ***
Total pot $0.60 | Rake $0 
Seat 2: R6AGToFJQOYVZAjC2jXEKw folded before Flop (didn't bet)
Seat 3: BYxjLnV1/LL0aZcTbfAOvw (button) folded before Flop (didn't bet)
Seat 4: TgDsTeCdLQt8kWbL00ByRA (small blind) folded before Flop
Seat 5: LtASJ9OlkqGrrUKGQlpGAw (big blind) folded before Flop
Seat 6: 7qRk4YH4/k/08LgJSv7rBQ collected ($0.60)




PokerStars Game #59939368958:  Hold'em No Limit ($0.10/$0.25) - 2009/07/01 0:38:05 ET
Table 'wRXcD9iXgBbdvKhWmfnBnw' 6-max Seat #2 is the button
Seat 1: LGWRgaQNaDFSlUGk26f0Ig ($19.45 in chips) 
Seat 2: SS/yfeArhULzIcOPe8MdPg ($25.60 in chips) 
Seat 3: 6zbQpY/G44U1Xvj7DZex0A ($19.80 in chips) 
Seat 4: mfrkWA3PTeYPkbO6hi98Aw ($26.40 in chips) 
Seat 6: Euh3U8PK9KVQP5CQdDjkeQ ($12.70 in chips) 
6zbQpY/G44U1Xvj7DZex0A: posts small blind $0.10
mfrkWA3PTeYPkbO6hi98Aw: posts big blind $0.25
EE16Ua5b1HSsYej5zeXOlA: sits out 
*** HOLE CARDS ***
Euh3U8PK9KVQP5CQdDjkeQ: raises $0.75 to $1
LGWRgaQNaDFSlUGk26f0Ig: folds 
SS/yfeArhULzIcOPe8MdPg: folds 
6zbQpY/G44U1Xvj7DZex0A: folds 
mfrkWA3PTeYPkbO6hi98Aw: folds 
Uncalled bet ($0.75) returned to Euh3U8PK9KVQP5CQdDjkeQ
Euh3U8PK9KVQP5CQdDjkeQ collected $0.60 from pot
Euh3U8PK9KVQP5CQdDjkeQ: doesn't show hand 
*** SUMMARY ***
Total pot $0.60 | Rake $0 
Seat 1: LGWRgaQNaDFSlUGk26f0Ig folded before Flop (didn't bet)
Seat 2: SS/yfeArhULzIcOPe8MdPg (button) folded before Flop (didn't bet)
Seat 3: 6zbQpY/G44U1Xvj7DZex0A (small blind) folded before Flop
Seat 4: mfrkWA3PTeYPkbO6hi98Aw (big blind) folded before Flop
Seat 6: Euh3U8PK9KVQP5CQdDjkeQ collected ($0.60)




PokerStars Game #59939368506:  Hold'em No Limit ($0.10/$0.25) - 2009/07/01 0:38:05 ET
Table 'A1MqSL0j9xG0S/68IwXqhw' 6-max Seat #3 is the button
Seat 2: /6h8PvAHQmfuMUZ8OUF6Xw ($16.85 in chips) 
Seat 3: kG34n23qFQA3nzdOJTQ1dA ($33.35 in chips) 
Seat 6: df01R5ThvHspD8FgKmaDvQ ($34.70 in chips) 
df01R5ThvHspD8FgKmaDvQ: posts small blind $0.10
/6h8PvAHQmfuMUZ8OUF6Xw: posts big blind $0.25
*** HOLE CARDS ***
kG34n23qFQA3nzdOJTQ1dA: folds 
kG34n23qFQA3nzdOJTQ1dA leaves the table
df01R5ThvHspD8FgKmaDvQ: raises $0.50 to $0.75
/6h8PvAHQmfuMUZ8OUF6Xw: folds 
Uncalled bet ($0.50) returned to df01R5ThvHspD8FgKmaDvQ
df01R5ThvHspD8FgKmaDvQ collected $0.50 from pot
*** SUMMARY ***
Total pot $0.50 | Rake $0 
Seat 2: /6h8PvAHQmfuMUZ8OUF6Xw (big blind) folded before Flop
Seat 3: kG34n23qFQA3nzdOJTQ1dA (button) folded before Flop (didn't bet)
Seat 6: df01R5ThvHspD8FgKmaDvQ (small blind) collected ($0.50)




PokerStars Game #59939368488:  Hold'em No Limit ($0.10/$0.25) - 2009/07/01 0:38:05 ET
Table 'ZiwAqg4o02gNro+JOAaFNg6wawJ+MkkvuC3coG6r+YhgSeat #9 is the button
Seat 1: j4q3p0lesp63b1gZDwLBZw ($5 in chips) 
Seat 2: tYsOBqdU1+x+yFI7zHO7hQ ($29.75 in chips) 
Seat 3: aNpwfA31EREwO+ar4XzBCw ($25 in chips) 
Seat 4: FJflwqC6fqOpM3j0q8Bptw ($19.40 in chips) 
Seat 6: hBMUlEpyU74r/fwDgIpXjQ ($27.95 in chips) 
Seat 7: ZWU9RNYtjmm4cElg1I0F4w ($27.20 in chips) 
Seat 8: CYkY0dNBaYaKs8HVCVn3mQ ($5 in chips) 
Seat 9: ljemhp25Zg+nlA9DLCIiUw ($24.65 in chips) 
j4q3p0lesp63b1gZDwLBZw: posts small blind $0.10
tYsOBqdU1+x+yFI7zHO7hQ: posts big blind $0.25
5hAPbqNrvJb8PtLiceXtlg6HoFYfVGBefsR5Vrz62qIwts out 
*** HOLE CARDS ***
aNpwfA31EREwO+ar4XzBCw: folds 
FJflwqC6fqOpM3j0q8Bptw: calls $0.25
hBMUlEpyU74r/fwDgIpXjQ: folds 
ZWU9RNYtjmm4cElg1I0F4w: folds 
CYkY0dNBaYaKs8HVCVn3mQ: folds 
ljemhp25Zg+nlA9DLCIiUw: folds 
j4q3p0lesp63b1gZDwLBZw: folds 
tYsOBqdU1+x+yFI7zHO7hQ: checks 
*** FLOP *** [Qd 8c 9s]
tYsOBqdU1+x+yFI7zHO7hQ: checks 
FJflwqC6fqOpM3j0q8Bptw has timed out
FJflwqC6fqOpM3j0q8Bptw: checks 
*** TURN *** [Qd 8c 9s] [2s]
tYsOBqdU1+x+yFI7zHO7hQ: checks 
FJflwqC6fqOpM3j0q8Bptw: bets $0.25
tYsOBqdU1+x+yFI7zHO7hQ: calls $0.25
*** RIVER *** [Qd 8c 9s 2s] [9h]
tYsOBqdU1+x+yFI7zHO7hQ: bets $1
FJflwqC6fqOpM3j0q8Bptw: calls $1
*** SHOW DOWN ***
tYsOBqdU1+x+yFI7zHO7hQ: shows [9d 2c] (a full house, Nines full of Deuces)
FJflwqC6fqOpM3j0q8Bptw: mucks hand 
tYsOBqdU1+x+yFI7zHO7hQ collected $2.95 from pot
*** SUMMARY ***
Total pot $3.10 | Rake $0.15 
Board [Qd 8c 9s 2s 9h]
Seat 1: j4q3p0lesp63b1gZDwLBZw (small blind) folded before Flop
Seat 2: tYsOBqdU1+x+yFI7zHO7hQ (big blind) showed [9d 2c] and won ($2.95) with a full house, Nines full of Deuces
Seat 3: aNpwfA31EREwO+ar4XzBCw folded before Flop (didn't bet)
Seat 4: FJflwqC6fqOpM3j0q8Bptw mucked
Seat 6: hBMUlEpyU74r/fwDgIpXjQ folded before Flop (didn't bet)
Seat 7: ZWU9RNYtjmm4cElg1I0F4w folded before Flop (didn't bet)
Seat 8: CYkY0dNBaYaKs8HVCVn3mQ folded before Flop (didn't bet)
Seat 9: ljemhp25Zg+nlA9DLCIiUw (button) folded before Flop (didn't bet)




PokerStars Game #59939369506:  Hold'em No Limit ($0.10/$0.25) - 2009/07/01 0:38:06 ET
Table 'RuT55t7dqtns1CdLsutksg' 9-max Seat #3 is the button
Seat 1: N6WEabmk+J6IGeE7kub1QQ ($36.55 in chips) 
Seat 2: CYkY0dNBaYaKs8HVCVn3mQ ($5.90 in chips) 
Seat 3: xOx0qYgTfvbPkTa+GuX0WA ($17 in chips) 
Seat 4: MG90wfSJZnOejs/KD3vlQQ ($25.85 in chips) 
Seat 5: 0D3Q+hLxjPei/5wgaaYhZA ($6.40 in chips) 
Seat 6: CqwJk5Z2+vb2f9j1o7IjKQ ($13.50 in chips) 
Seat 7: Il5IBomZPnY0uD8k+rlPyw ($18.90 in chips) 
Seat 9: oAO88RFrn7cbQFHZt8VrkA ($35.65 in chips) 
MG90wfSJZnOejs/KD3vlQQ: posts small blind $0.10
0D3Q+hLxjPei/5wgaaYhZA: posts big blind $0.25
yyG4svzOpC1A+sUP/scg6w: sits out 
*** HOLE CARDS ***
CqwJk5Z2+vb2f9j1o7IjKQ: calls $0.25
Il5IBomZPnY0uD8k+rlPyw: folds 
oAO88RFrn7cbQFHZt8VrkA: folds 
N6WEabmk+J6IGeE7kub1QQ: calls $0.25
CYkY0dNBaYaKs8HVCVn3mQ: folds 
xOx0qYgTfvbPkTa+GuX0WA: calls $0.25
MG90wfSJZnOejs/KD3vlQQ: folds 
0D3Q+hLxjPei/5wgaaYhZA: checks 
*** FLOP *** [Kh 8s 7c]
0D3Q+hLxjPei/5wgaaYhZA: bets $0.50
CqwJk5Z2+vb2f9j1o7IjKQ: calls $0.50
N6WEabmk+J6IGeE7kub1QQ: calls $0.50
xOx0qYgTfvbPkTa+GuX0WA: folds 
*** TURN *** [Kh 8s 7c] [5c]
0D3Q+hLxjPei/5wgaaYhZA: bets $0.75
CqwJk5Z2+vb2f9j1o7IjKQ: calls $0.75
N6WEabmk+J6IGeE7kub1QQ: calls $0.75
*** RIVER *** [Kh 8s 7c 5c] [2h]
0D3Q+hLxjPei/5wgaaYhZA: bets $0.75
CqwJk5Z2+vb2f9j1o7IjKQ: calls $0.75
N6WEabmk+J6IGeE7kub1QQ: calls $0.75
*** SHOW DOWN ***
0D3Q+hLxjPei/5wgaaYhZA: shows [8c 9h] (a pair of Eights)
CqwJk5Z2+vb2f9j1o7IjKQ: mucks hand 
N6WEabmk+J6IGeE7kub1QQ: shows [Jd Kd] (a pair of Kings)
N6WEabmk+J6IGeE7kub1QQ collected $6.80 from pot
*** SUMMARY ***
Total pot $7.10 | Rake $0.30 
Board [Kh 8s 7c 5c 2h]
Seat 1: N6WEabmk+J6IGeE7kub1QQ showed [Jd Kd] and won ($6.80) with a pair of Kings
Seat 2: CYkY0dNBaYaKs8HVCVn3mQ folded before Flop (didn't bet)
Seat 3: xOx0qYgTfvbPkTa+GuX0WA (button) folded on the Flop
Seat 4: MG90wfSJZnOejs/KD3vlQQ (small blind) folded before Flop
Seat 5: 0D3Q+hLxjPei/5wgaaYhZA (big blind) showed [8c 9h] and lost with a pair of Eights
Seat 6: CqwJk5Z2+vb2f9j1o7IjKQ mucked
Seat 7: Il5IBomZPnY0uD8k+rlPyw folded before Flop (didn't bet)
Seat 9: oAO88RFrn7cbQFHZt8VrkA folded before Flop (didn't bet)




PokerStars Game #59939369410:  Hold'em No Limit ($0.10/$0.25) - 2009/07/01 0:38:06 ET
Table 'MJ1SB76A4qJrlEa+C5e/8w' 6-max Seat #5 is the button
Seat 2: UA5OsKS3VPaxa7uC8La/kA ($26.80 in chips) 
Seat 3: IrrSNlaIjHnZjG6E7LgmEg ($16.65 in chips) 
Seat 5: eHsmIvAb2JREg4O6hNPnXg ($10 in chips) 
Seat 6: JFIAqU8lCZ0vWwEl4bdGsg ($25 in chips) 
JFIAqU8lCZ0vWwEl4bdGsg: posts small blind $0.10
UA5OsKS3VPaxa7uC8La/kA: posts big blind $0.25
*** HOLE CARDS ***
IrrSNlaIjHnZjG6E7LgmEg: folds 
eHsmIvAb2JREg4O6hNPnXg: folds 
JFIAqU8lCZ0vWwEl4bdGsg: raises $0.60 to $0.85
UA5OsKS3VPaxa7uC8La/kA: calls $0.60
*** FLOP *** [9s 7s Qc]
6boOPJDTFiEyZD2WdW0kCA joins the table at seat #4 
JFIAqU8lCZ0vWwEl4bdGsg: checks 
UA5OsKS3VPaxa7uC8La/kA: bets $1
JFIAqU8lCZ0vWwEl4bdGsg: folds 
Uncalled bet ($1) returned to UA5OsKS3VPaxa7uC8La/kA
UA5OsKS3VPaxa7uC8La/kA collected $1.65 from pot
*** SUMMARY ***
Total pot $1.70 | Rake $0.05 
Board [9s 7s Qc]
Seat 2: UA5OsKS3VPaxa7uC8La/kA (big blind) collected ($1.65)
Seat 3: IrrSNlaIjHnZjG6E7LgmEg folded before Flop (didn't bet)
Seat 5: eHsmIvAb2JREg4O6hNPnXg (button) folded before Flop (didn't bet)
Seat 6: JFIAqU8lCZ0vWwEl4bdGsg (small blind) folded on the Flop




PokerStars Game #59939369330:  Hold'em No Limit ($0.10/$0.25) - 2009/07/01 0:38:06 ET
Table '3Ns9nuTkynfwbBfBXzg6ww' 6-max Seat #3 is the button
Seat 3: 6PDO6dptGq0XLL8zHWIhgw ($49.20 in chips) 
Seat 4: kyRaCIljYA6l33lSKQfNsg ($31.85 in chips) 
Seat 5: kBQU/db00TVAMeomlhblPg ($15 in chips) 
Seat 6: L0urJVMuBFQrIOdoz+7XLw ($32.75 in chips) 
kyRaCIljYA6l33lSKQfNsg: posts small blind $0.10
kBQU/db00TVAMeomlhblPg: posts big blind $0.25
*** HOLE CARDS ***
L0urJVMuBFQrIOdoz+7XLw: folds 
6PDO6dptGq0XLL8zHWIhgw: folds 
kyRaCIljYA6l33lSKQfNsg: folds 
Uncalled bet ($0.15) returned to kBQU/db00TVAMeomlhblPg
L0urJVMuBFQrIOdoz+7XLw leaves the table
kBQU/db00TVAMeomlhblPg collected $0.20 from pot
*** SUMMARY ***
Total pot $0.20 | Rake $0 
Seat 3: 6PDO6dptGq0XLL8zHWIhgw (button) folded before Flop (didn't bet)
Seat 4: kyRaCIljYA6l33lSKQfNsg (small blind) folded before Flop
Seat 5: kBQU/db00TVAMeomlhblPg (big blind) collected ($0.20)
Seat 6: L0urJVMuBFQrIOdoz+7XLw folded before Flop (didn't bet)




PokerStars Game #59939369210:  Hold'em No Limit ($0.10/$0.25) - 2009/07/01 0:38:06 ET
Table 'GoBmKm3klK6VavJE4STfmQ' 9-max Seat #5 is the button
Seat 1: N6fYvIzQLKaydFLKQGtMlQ ($23.55 in chips) 
Seat 2: 1c/7DHPx5CDTmAfk8/bWeA ($15 in chips) 
Seat 3: 4awUyiDYTgylQKXZ9faBVA ($26.40 in chips) 
Seat 4: H5Se03ZqSX7tbULXur2MAg ($24.30 in chips) 
Seat 5: 8B/dhbQjIWe6ASCdgzktNQ ($25.20 in chips) 
Seat 6: S3QwXyGCcujfAwNubHpwbw ($6.80 in chips) 
Seat 7: s9a4d23HFxaL70yUWQ0/tQ ($20.55 in chips) 
Seat 8: cZ99hugmLBj9KhTlc8nCSw ($25.35 in chips) 
Seat 9: 1K6QGyJP9P9xmRac2fH4OQ ($47 in chips) 
S3QwXyGCcujfAwNubHpwbw: posts small blind $0.10
s9a4d23HFxaL70yUWQ0/tQ: posts big blind $0.25
*** HOLE CARDS ***
cZ99hugmLBj9KhTlc8nCSw: folds 
1K6QGyJP9P9xmRac2fH4OQ: folds 
N6fYvIzQLKaydFLKQGtMlQ: folds 
1c/7DHPx5CDTmAfk8/bWeA: folds 
4awUyiDYTgylQKXZ9faBVA: folds 
H5Se03ZqSX7tbULXur2MAg: folds 
8B/dhbQjIWe6ASCdgzktNQ: folds 
S3QwXyGCcujfAwNubHpwbw: calls $0.15
s9a4d23HFxaL70yUWQ0/tQ: checks 
*** FLOP *** [8d Ts 6c]
S3QwXyGCcujfAwNubHpwbw: checks 
s9a4d23HFxaL70yUWQ0/tQ: bets $0.50
S3QwXyGCcujfAwNubHpwbw: calls $0.50
*** TURN *** [8d Ts 6c] [Js]
S3QwXyGCcujfAwNubHpwbw: checks 
s9a4d23HFxaL70yUWQ0/tQ: checks 
*** RIVER *** [8d Ts 6c Js] [3c]
S3QwXyGCcujfAwNubHpwbw: checks 
s9a4d23HFxaL70yUWQ0/tQ: checks 
*** SHOW DOWN ***
S3QwXyGCcujfAwNubHpwbw: shows [4d 6h] (a pair of Sixes)
s9a4d23HFxaL70yUWQ0/tQ: shows [Td Ks] (a pair of Tens)
s9a4d23HFxaL70yUWQ0/tQ collected $1.45 from pot
*** SUMMARY ***
Total pot $1.50 | Rake $0.05 
Board [8d Ts 6c Js 3c]
Seat 1: N6fYvIzQLKaydFLKQGtMlQ folded before Flop (didn't bet)
Seat 2: 1c/7DHPx5CDTmAfk8/bWeA folded before Flop (didn't bet)
Seat 3: 4awUyiDYTgylQKXZ9faBVA folded before Flop (didn't bet)
Seat 4: H5Se03ZqSX7tbULXur2MAg folded before Flop (didn't bet)
Seat 5: 8B/dhbQjIWe6ASCdgzktNQ (button) folded before Flop (didn't bet)
Seat 6: S3QwXyGCcujfAwNubHpwbw (small blind) showed [4d 6h] and lost with a pair of Sixes
Seat 7: s9a4d23HFxaL70yUWQ0/tQ (big blind) showed [Td Ks] and won ($1.45) with a pair of Tens
Seat 8: cZ99hugmLBj9KhTlc8nCSw folded before Flop (didn't bet)
Seat 9: 1K6QGyJP9P9xmRac2fH4OQ folded before Flop (didn't bet)




PokerStars Game #59939369668:  Hold'em No Limit ($0.10/$0.25) - 2009/07/01 0:38:06 ET
Table 'R5qKG21jwFDYRcOht9qwqQ' 9-max Seat #9 is the button
Seat 1: OgISYvc5hA85YuDnsXCH+Q ($16 in chips) 
Seat 2: N6foVRyErHqcNmshkqextQ ($15 in chips) 
Seat 3: M2QO2DxB5Wawg2h8HSpnYA ($10 in chips) 
Seat 4: z5GxcHlYz/GSz6W2uFiTtg ($25.40 in chips) 
Seat 5: 8B/dhbQjIWe6ASCdgzktNQ ($25 in chips) 
Seat 6: sUVgUtgbfVx6JpvApozwhQ ($11.10 in chips) 
Seat 7: HYQiVfBGJsg4smSubKCBmA ($28.75 in chips) 
Seat 8: tYsOBqdU1+x+yFI7zHO7hQ ($25 in chips) 
Seat 9: MG90wfSJZnOejs/KD3vlQQ ($26 in chips) 
OgISYvc5hA85YuDnsXCH+Q: posts small blind $0.10
N6foVRyErHqcNmshkqextQ: posts big blind $0.25
*** HOLE CARDS ***
M2QO2DxB5Wawg2h8HSpnYA: folds 
z5GxcHlYz/GSz6W2uFiTtg: folds 
8B/dhbQjIWe6ASCdgzktNQ: folds 
sUVgUtgbfVx6JpvApozwhQ: folds 
HYQiVfBGJsg4smSubKCBmA: calls $0.25
tYsOBqdU1+x+yFI7zHO7hQ: folds 
MG90wfSJZnOejs/KD3vlQQ: folds 
OgISYvc5hA85YuDnsXCH+Q: calls $0.15
N6foVRyErHqcNmshkqextQ: checks 
*** FLOP *** [4h 6h 3h]
OgISYvc5hA85YuDnsXCH+Q: checks 
N6foVRyErHqcNmshkqextQ: checks 
HYQiVfBGJsg4smSubKCBmA: checks 
*** TURN *** [4h 6h 3h] [9h]
OgISYvc5hA85YuDnsXCH+Q: checks 
N6foVRyErHqcNmshkqextQ: bets $0.50
HYQiVfBGJsg4smSubKCBmA: folds 
OgISYvc5hA85YuDnsXCH+Q: folds 
Uncalled bet ($0.50) returned to N6foVRyErHqcNmshkqextQ
N6foVRyErHqcNmshkqextQ collected $0.75 from pot
N6foVRyErHqcNmshkqextQ: doesn't show hand 
*** SUMMARY ***
Total pot $0.75 | Rake $0 
Board [4h 6h 3h 9h]
Seat 1: OgISYvc5hA85YuDnsXCH+Q (small blind) folded on the Turn
Seat 2: N6foVRyErHqcNmshkqextQ (big blind) collected ($0.75)
Seat 3: M2QO2DxB5Wawg2h8HSpnYA folded before Flop (didn't bet)
Seat 4: z5GxcHlYz/GSz6W2uFiTtg folded before Flop (didn't bet)
Seat 5: 8B/dhbQjIWe6ASCdgzktNQ folded before Flop (didn't bet)
Seat 6: sUVgUtgbfVx6JpvApozwhQ folded before Flop (didn't bet)
Seat 7: HYQiVfBGJsg4smSubKCBmA folded on the Turn
Seat 8: tYsOBqdU1+x+yFI7zHO7hQ folded before Flop (didn't bet)
Seat 9: MG90wfSJZnOejs/KD3vlQQ (button) folded before Flop (didn't bet)




PokerStars Game #59939369374:  Hold'em No Limit ($0.10/$0.25) - 2009/07/01 0:38:06 ET
Table '9HJEqVOjSU5ECoVB4C4sgQ' 6-max Seat #4 is the button
Seat 1: EyMmRrAOlNpDOWLqSYRZdw ($26.25 in chips) 
Seat 2: sEQx9G5Cu8k1HNdQasxvUA ($36.10 in chips) 
Seat 3: KM6ogk7SqyRlk3m9b0h+7A ($12.25 in chips) 
Seat 4: mfrkWA3PTeYPkbO6hi98Aw ($34.40 in chips) 
Seat 6: aOMbOQ6Ji1Gie6dYOurd5A ($17.35 in chips) 
aOMbOQ6Ji1Gie6dYOurd5A: posts small blind $0.10
EyMmRrAOlNpDOWLqSYRZdw: posts big blind $0.25
*** HOLE CARDS ***
sEQx9G5Cu8k1HNdQasxvUA: folds 
KM6ogk7SqyRlk3m9b0h+7A: folds 
mfrkWA3PTeYPkbO6hi98Aw: folds 
aOMbOQ6Ji1Gie6dYOurd5A: calls $0.15
EyMmRrAOlNpDOWLqSYRZdw: checks 
*** FLOP *** [Ks 2c Qc]
aOMbOQ6Ji1Gie6dYOurd5A: checks 
EyMmRrAOlNpDOWLqSYRZdw: checks 
*** TURN *** [Ks 2c Qc] [7c]
aOMbOQ6Ji1Gie6dYOurd5A: checks 
EyMmRrAOlNpDOWLqSYRZdw: bets $0.50
aOMbOQ6Ji1Gie6dYOurd5A: raises $0.50 to $1
EyMmRrAOlNpDOWLqSYRZdw: calls $0.50
*** RIVER *** [Ks 2c Qc 7c] [9h]
aOMbOQ6Ji1Gie6dYOurd5A: bets $2
ymz+a8dgHSUFPooYplw7Ow joins the table at seat #5 
EyMmRrAOlNpDOWLqSYRZdw: calls $2
*** SHOW DOWN ***
aOMbOQ6Ji1Gie6dYOurd5A: shows [Kd Kc] (three of a kind, Kings)
EyMmRrAOlNpDOWLqSYRZdw: shows [6c 9c] (a flush, Queen high)
EyMmRrAOlNpDOWLqSYRZdw collected $6.20 from pot
*** SUMMARY ***
Total pot $6.50 | Rake $0.30 
Board [Ks 2c Qc 7c 9h]
Seat 1: EyMmRrAOlNpDOWLqSYRZdw (big blind) showed [6c 9c] and won ($6.20) with a flush, Queen high
Seat 2: sEQx9G5Cu8k1HNdQasxvUA folded before Flop (didn't bet)
Seat 3: KM6ogk7SqyRlk3m9b0h+7A folded before Flop (didn't bet)
Seat 4: mfrkWA3PTeYPkbO6hi98Aw (button) folded before Flop (didn't bet)
Seat 6: aOMbOQ6Ji1Gie6dYOurd5A (small blind) showed [Kd Kc] and lost with three of a kind, Kings




PokerStars Game #59939369250:  Hold'em No Limit ($0.10/$0.25) - 2009/07/01 0:38:06 ET
Table '+UzantPJ4smVdrh+4GTu1w' 6-max Seat #1 is the button
Seat 1: 3Bm6SLY1pwRvi98HLQUkvg ($3.65 in chips) 
Seat 2: tcbEu7VzyHQ+0lh+skbQhQ ($10.35 in chips) 
Seat 3: SS/yfeArhULzIcOPe8MdPg ($51.50 in chips) 
Seat 4: 0/dGyX46wFQuMZwX3LgPxg ($8.95 in chips) 
Seat 5: cj4VBQya7HtVL2zCGd5jLQ ($15.10 in chips) 
Seat 6: BYxjLnV1/LL0aZcTbfAOvw ($48.05 in chips) 
tcbEu7VzyHQ+0lh+skbQhQ: posts small blind $0.10
SS/yfeArhULzIcOPe8MdPg: posts big blind $0.25
*** HOLE CARDS ***
0/dGyX46wFQuMZwX3LgPxg: raises $0.50 to $0.75
cj4VBQya7HtVL2zCGd5jLQ: folds 
BYxjLnV1/LL0aZcTbfAOvw: folds 
3Bm6SLY1pwRvi98HLQUkvg: folds 
tcbEu7VzyHQ+0lh+skbQhQ: folds 
SS/yfeArhULzIcOPe8MdPg: folds 
Uncalled bet ($0.50) returned to 0/dGyX46wFQuMZwX3LgPxg
0/dGyX46wFQuMZwX3LgPxg collected $0.60 from pot
*** SUMMARY ***
Total pot $0.60 | Rake $0 
Seat 1: 3Bm6SLY1pwRvi98HLQUkvg (button) folded before Flop (didn't bet)
Seat 2: tcbEu7VzyHQ+0lh+skbQhQ (small blind) folded before Flop
Seat 3: SS/yfeArhULzIcOPe8MdPg (big blind) folded before Flop
Seat 4: 0/dGyX46wFQuMZwX3LgPxg collected ($0.60)
Seat 5: cj4VBQya7HtVL2zCGd5jLQ folded before Flop (didn't bet)
Seat 6: BYxjLnV1/LL0aZcTbfAOvw folded before Flop (didn't bet)




PokerStars Game #59939369828:  Hold'em No Limit ($0.10/$0.25) - 2009/07/01 0:38:07 ET
Table 'ShgkxBDL5IvR1qjzfRNc0A' 6-max Seat #4 is the button
Seat 1: /gJNBeCkWL4o85/jvlZ4BA ($25 in chips) 
Seat 2: mfrkWA3PTeYPkbO6hi98Aw ($38.85 in chips) 
Seat 3: JXSfL0FgBM1dIFwHP09Hnw ($25 in chips) 
Seat 4: kG34n23qFQA3nzdOJTQ1dA ($24.75 in chips) 
Seat 5: ferjiUxLWPNUKxvl8/xD/g ($43 in chips) 
Seat 6: 5tB0F9NjPSUL4FzmzBMs2Q ($30.55 in chips) 
ferjiUxLWPNUKxvl8/xD/g: posts small blind $0.10
5tB0F9NjPSUL4FzmzBMs2Q: posts big blind $0.25
*** HOLE CARDS ***
/gJNBeCkWL4o85/jvlZ4BA: folds 
mfrkWA3PTeYPkbO6hi98Aw: folds 
JXSfL0FgBM1dIFwHP09Hnw: folds 
kG34n23qFQA3nzdOJTQ1dA: folds 
ferjiUxLWPNUKxvl8/xD/g: raises $0.75 to $1
5tB0F9NjPSUL4FzmzBMs2Q: folds 
Uncalled bet ($0.75) returned to ferjiUxLWPNUKxvl8/xD/g
ferjiUxLWPNUKxvl8/xD/g collected $0.50 from pot
ferjiUxLWPNUKxvl8/xD/g: doesn't show hand 
*** SUMMARY ***
Total pot $0.50 | Rake $0 
Seat 1: /gJNBeCkWL4o85/jvlZ4BA folded before Flop (didn't bet)
Seat 2: mfrkWA3PTeYPkbO6hi98Aw folded before Flop (didn't bet)
Seat 3: JXSfL0FgBM1dIFwHP09Hnw folded before Flop (didn't bet)
Seat 4: kG34n23qFQA3nzdOJTQ1dA (button) folded before Flop (didn't bet)
Seat 5: ferjiUxLWPNUKxvl8/xD/g (small blind) collected ($0.50)
Seat 6: 5tB0F9NjPSUL4FzmzBMs2Q (big blind) folded before Flop




PokerStars Game #59939370222:  Hold'em No Limit ($0.10/$0.25) - 2009/07/01 0:38:07 ET
Table 'VQNfcI8vTBCTvRfd3veTLQ' 6-max Seat #2 is the button
Seat 1: ymz+a8dgHSUFPooYplw7Ow ($23.50 in chips) 
Seat 2: KukIGupqqJCXA+Hp2bEFnA ($6.70 in chips) 
Seat 3: LtASJ9OlkqGrrUKGQlpGAw ($23.65 in chips) 
Seat 4: nc79pm0LZRdhncq55evVqA ($26.15 in chips) 
Seat 5: gX2vbKwS/8zZPENAWB7hxQ ($7.65 in chips) 
Seat 6: dlCLwmcvRShnuFDEVkdIEA ($14.60 in chips) 
LtASJ9OlkqGrrUKGQlpGAw: posts small blind $0.10
nc79pm0LZRdhncq55evVqA: posts big blind $0.25
*** HOLE CARDS ***
gX2vbKwS/8zZPENAWB7hxQ: folds 
dlCLwmcvRShnuFDEVkdIEA: calls $0.25
ymz+a8dgHSUFPooYplw7Ow: folds 
KukIGupqqJCXA+Hp2bEFnA: folds 
LtASJ9OlkqGrrUKGQlpGAw: calls $0.15
nc79pm0LZRdhncq55evVqA: checks 
*** FLOP *** [3h 5s Ts]
LtASJ9OlkqGrrUKGQlpGAw: checks 
nc79pm0LZRdhncq55evVqA: checks 
dlCLwmcvRShnuFDEVkdIEA: checks 
*** TURN *** [3h 5s Ts] [9h]
LtASJ9OlkqGrrUKGQlpGAw: checks 
nc79pm0LZRdhncq55evVqA: checks 
dlCLwmcvRShnuFDEVkdIEA: checks 
*** RIVER *** [3h 5s Ts 9h] [6s]
LtASJ9OlkqGrrUKGQlpGAw: checks 
nc79pm0LZRdhncq55evVqA: checks 
dlCLwmcvRShnuFDEVkdIEA: checks 
*** SHOW DOWN ***
LtASJ9OlkqGrrUKGQlpGAw: shows [Ah Kd] (high card Ace)
nc79pm0LZRdhncq55evVqA: shows [8h 3d] (a pair of Threes)
dlCLwmcvRShnuFDEVkdIEA: shows [4s 4c] (a pair of Fours)
dlCLwmcvRShnuFDEVkdIEA collected $0.75 from pot
*** SUMMARY ***
Total pot $0.75 | Rake $0 
Board [3h 5s Ts 9h 6s]
Seat 1: ymz+a8dgHSUFPooYplw7Ow folded before Flop (didn't bet)
Seat 2: KukIGupqqJCXA+Hp2bEFnA (button) folded before Flop (didn't bet)
Seat 3: LtASJ9OlkqGrrUKGQlpGAw (small blind) showed [Ah Kd] and lost with high card Ace
Seat 4: nc79pm0LZRdhncq55evVqA (big blind) showed [8h 3d] and lost with a pair of Threes
Seat 5: gX2vbKwS/8zZPENAWB7hxQ folded before Flop (didn't bet)
Seat 6: dlCLwmcvRShnuFDEVkdIEA showed [4s 4c] and won ($0.75) with a pair of Fours




PokerStars Game #59939369696:  Hold'em No Limit ($0.10/$0.25) - 2009/07/01 0:38:07 ET
Table 'Xi38lWH8L2JHRAsKYVX8Qg' 6-max Seat #1 is the button
Seat 1: AqQ7DFpHkgIzTwDu+rClcg ($5.55 in chips) 
Seat 2: YjCHRUY3WJtHMnkcRxvmug ($36.65 in chips) 
Seat 3: hFvl367f+GnfQv2riJlsTA ($11.65 in chips) 
Seat 4: d0J1xuhsynEY81YHwAvJ5g ($25 in chips) 
Seat 5: 9KPR3sZ+CxRm7bQ8qxFzMQ ($11.70 in chips) 
Seat 6: aogAb4Eienxztk8p2v9VVw ($23.10 in chips) 
YjCHRUY3WJtHMnkcRxvmug: posts small blind $0.10
hFvl367f+GnfQv2riJlsTA: posts big blind $0.25
*** HOLE CARDS ***
d0J1xuhsynEY81YHwAvJ5g: folds 
9KPR3sZ+CxRm7bQ8qxFzMQ: folds 
aogAb4Eienxztk8p2v9VVw: folds 
AqQ7DFpHkgIzTwDu+rClcg: folds 
YjCHRUY3WJtHMnkcRxvmug: raises $0.25 to $0.50
hFvl367f+GnfQv2riJlsTA: folds 
Uncalled bet ($0.25) returned to YjCHRUY3WJtHMnkcRxvmug
YjCHRUY3WJtHMnkcRxvmug collected $0.50 from pot
*** SUMMARY ***
Total pot $0.50 | Rake $0 
Seat 1: AqQ7DFpHkgIzTwDu+rClcg (button) folded before Flop (didn't bet)
Seat 2: YjCHRUY3WJtHMnkcRxvmug (small blind) collected ($0.50)
Seat 3: hFvl367f+GnfQv2riJlsTA (big blind) folded before Flop
Seat 4: d0J1xuhsynEY81YHwAvJ5g folded before Flop (didn't bet)
Seat 5: 9KPR3sZ+CxRm7bQ8qxFzMQ folded before Flop (didn't bet)
Seat 6: aogAb4Eienxztk8p2v9VVw folded before Flop (didn't bet)




PokerStars Game #59939369790:  Hold'em No Limit ($0.10/$0.25) - 2009/07/01 0:38:07 ET
Table 'AchTjdLS1zBUbH3ZIx6f0w' 6-max Seat #3 is the button
Seat 1: IzVI+wIP7IS+d0sugIrOPQ ($26.30 in chips) 
Seat 2: kG34n23qFQA3nzdOJTQ1dA ($40.55 in chips) 
Seat 3: ehifenV36yVvJMnV63D3cg ($5.40 in chips) 
Seat 4: q6WfTUAD9mowIP63ASq2Dg ($25.80 in chips) 
Seat 5: oBUDUfeUyCbZBsjxHZgSiw ($34.15 in chips) 
q6WfTUAD9mowIP63ASq2Dg: posts small blind $0.10
oBUDUfeUyCbZBsjxHZgSiw: posts big blind $0.25
5tB0F9NjPSUL4FzmzBMs2Q: sits out 
*** HOLE CARDS ***
IzVI+wIP7IS+d0sugIrOPQ: folds 
kG34n23qFQA3nzdOJTQ1dA: folds 
ehifenV36yVvJMnV63D3cg: folds 
q6WfTUAD9mowIP63ASq2Dg: folds 
Uncalled bet ($0.15) returned to oBUDUfeUyCbZBsjxHZgSiw
oBUDUfeUyCbZBsjxHZgSiw collected $0.20 from pot
*** SUMMARY ***
Total pot $0.20 | Rake $0 
Seat 1: IzVI+wIP7IS+d0sugIrOPQ folded before Flop (didn't bet)
Seat 2: kG34n23qFQA3nzdOJTQ1dA folded before Flop (didn't bet)
Seat 3: ehifenV36yVvJMnV63D3cg (button) folded before Flop (didn't bet)
Seat 4: q6WfTUAD9mowIP63ASq2Dg (small blind) folded before Flop
Seat 5: oBUDUfeUyCbZBsjxHZgSiw (big blind) collected ($0.20)




PokerStars Game #59939370288:  Hold'em No Limit ($0.10/$0.25) - 2009/07/01 0:38:07 ET
Table 'APEHQjIcZHDZUA4iOjju2g' 6-max Seat #2 is the button
Seat 1: eHsmIvAb2JREg4O6hNPnXg ($8.60 in chips) 
Seat 2: 3zD3qLXT1bEffAoWGnc7wg ($25 in chips) 
Seat 4: EqXTTLKUlDlz7yi6ziyyWA ($32 in chips) 
Seat 5: /xN6gc9+8Hew0HxaB6VIVg ($32.10 in chips) 
Seat 6: y7HCJfEmolBCFdi/0j5TRg ($45.05 in chips) 
E7KSkgfIsmIsp0vLnmGFmA will be allowed to play after the button
EqXTTLKUlDlz7yi6ziyyWA: posts small blind $0.10
/xN6gc9+8Hew0HxaB6VIVg: posts big blind $0.25
*** HOLE CARDS ***
y7HCJfEmolBCFdi/0j5TRg: folds 
eHsmIvAb2JREg4O6hNPnXg: folds 
3zD3qLXT1bEffAoWGnc7wg: folds 
EqXTTLKUlDlz7yi6ziyyWA: calls $0.15
/xN6gc9+8Hew0HxaB6VIVg: checks 
*** FLOP *** [4s Qh Jc]
EqXTTLKUlDlz7yi6ziyyWA: checks 
/xN6gc9+8Hew0HxaB6VIVg: checks 
*** TURN *** [4s Qh Jc] [7c]
EqXTTLKUlDlz7yi6ziyyWA: bets $0.50
/xN6gc9+8Hew0HxaB6VIVg: folds 
Uncalled bet ($0.50) returned to EqXTTLKUlDlz7yi6ziyyWA
EqXTTLKUlDlz7yi6ziyyWA collected $0.50 from pot
EqXTTLKUlDlz7yi6ziyyWA: doesn't show hand 
*** SUMMARY ***
Total pot $0.50 | Rake $0 
Board [4s Qh Jc 7c]
Seat 1: eHsmIvAb2JREg4O6hNPnXg folded before Flop (didn't bet)
Seat 2: 3zD3qLXT1bEffAoWGnc7wg (button) folded before Flop (didn't bet)
Seat 4: EqXTTLKUlDlz7yi6ziyyWA (small blind) collected ($0.50)
Seat 5: /xN6gc9+8Hew0HxaB6VIVg (big blind) folded on the Turn
Seat 6: y7HCJfEmolBCFdi/0j5TRg folded before Flop (didn't bet)




PokerStars Game #59939369904:  Hold'em No Limit ($0.10/$0.25) - 2009/07/01 0:38:07 ET
Table 'vud0GB/ZlDCvUFhBFIaTlg' 9-max Seat #5 is the button
Seat 5: AwAabNdwDsTMb3aTomdOmg ($5 in chips) 
Seat 7: RzaVufWfW9CTnVYR7/Ge+w ($3.70 in chips) 
AwAabNdwDsTMb3aTomdOmg: posts small blind $0.10
RzaVufWfW9CTnVYR7/Ge+w: posts big blind $0.25
*** HOLE CARDS ***
AwAabNdwDsTMb3aTomdOmg: calls $0.15
RzaVufWfW9CTnVYR7/Ge+w: checks 
*** FLOP *** [2c Jh 5d]
RzaVufWfW9CTnVYR7/Ge+w: bets $0.25
AwAabNdwDsTMb3aTomdOmg: calls $0.25
*** TURN *** [2c Jh 5d] [9d]
ie4EwTMMFYxrCXcenJdzsw leaves the table
RzaVufWfW9CTnVYR7/Ge+w: checks 
AwAabNdwDsTMb3aTomdOmg: bets $0.25
RzaVufWfW9CTnVYR7/Ge+w: folds 
Uncalled bet ($0.25) returned to AwAabNdwDsTMb3aTomdOmg
AwAabNdwDsTMb3aTomdOmg collected $0.95 from pot
*** SUMMARY ***
Total pot $1 | Rake $0.05 
Board [2c Jh 5d 9d]
Seat 5: AwAabNdwDsTMb3aTomdOmg (button) (small blind) collected ($0.95)
Seat 7: RzaVufWfW9CTnVYR7/Ge+w (big blind) folded on the Turn




PokerStars Game #59939369718:  Hold'em No Limit ($0.10/$0.25) - 2009/07/01 0:38:07 ET
Table '52Meibn9NOL4XtVi1p2Upw' 9-max Seat #9 is the button
Seat 1: LSrAei+fS8MYG9ie/GkG0Q ($15.20 in chips) 
Seat 2: BEIBUu2pIflPrCL+Iks4CQ ($12.60 in chips) 
Seat 3: MzBvksetB8XYtCt0FExJMg ($15.25 in chips) 
Seat 4: rCaXm4/EwAgWqCiClpbsqQ ($9 in chips) 
Seat 5: 4oA316mXLIui1QY63GXBUg ($27.10 in chips) 
Seat 6: 1wKfgJ8xXIiuc8C6qjkxhg ($3 in chips) 
Seat 7: R3KkgiqTvuhazyCqaD9cZg ($10 in chips) 
Seat 8: eKma8Z98pP7H8m4CEt075w ($23.10 in chips) 
Seat 9: 8B/dhbQjIWe6ASCdgzktNQ ($30.10 in chips) 
LSrAei+fS8MYG9ie/GkG0Q: posts small blind $0.10
BEIBUu2pIflPrCL+Iks4CQ: posts big blind $0.25
R3KkgiqTvuhazyCqaD9cZg: posts big blind $0.25
*** HOLE CARDS ***
MzBvksetB8XYtCt0FExJMg: folds 
rCaXm4/EwAgWqCiClpbsqQ: folds 
4oA316mXLIui1QY63GXBUg: folds 
1wKfgJ8xXIiuc8C6qjkxhg: folds 
R3KkgiqTvuhazyCqaD9cZg: checks 
eKma8Z98pP7H8m4CEt075w: folds 
8B/dhbQjIWe6ASCdgzktNQ: folds 
LSrAei+fS8MYG9ie/GkG0Q: calls $0.15
BEIBUu2pIflPrCL+Iks4CQ: checks 
*** FLOP *** [Kc 7s 7d]
LSrAei+fS8MYG9ie/GkG0Q: checks 
BEIBUu2pIflPrCL+Iks4CQ: checks 
R3KkgiqTvuhazyCqaD9cZg: checks 
*** TURN *** [Kc 7s 7d] [Ad]
LSrAei+fS8MYG9ie/GkG0Q: bets $0.50
BEIBUu2pIflPrCL+Iks4CQ: folds 
R3KkgiqTvuhazyCqaD9cZg: folds 
Uncalled bet ($0.50) returned to LSrAei+fS8MYG9ie/GkG0Q
LSrAei+fS8MYG9ie/GkG0Q collected $0.75 from pot
LSrAei+fS8MYG9ie/GkG0Q: doesn't show hand 
*** SUMMARY ***
Total pot $0.75 | Rake $0 
Board [Kc 7s 7d Ad]
Seat 1: LSrAei+fS8MYG9ie/GkG0Q (small blind) collected ($0.75)
Seat 2: BEIBUu2pIflPrCL+Iks4CQ (big blind) folded on the Turn
Seat 3: MzBvksetB8XYtCt0FExJMg folded before Flop (didn't bet)
Seat 4: rCaXm4/EwAgWqCiClpbsqQ folded before Flop (didn't bet)
Seat 5: 4oA316mXLIui1QY63GXBUg folded before Flop (didn't bet)
Seat 6: 1wKfgJ8xXIiuc8C6qjkxhg folded before Flop (didn't bet)
Seat 7: R3KkgiqTvuhazyCqaD9cZg folded on the Turn
Seat 8: eKma8Z98pP7H8m4CEt075w folded before Flop (didn't bet)
Seat 9: 8B/dhbQjIWe6ASCdgzktNQ (button) folded before Flop (didn't bet)




PokerStars Game #59939370272:  Hold'em No Limit ($0.10/$0.25) - 2009/07/01 0:38:07 ET
Table 'gHbubGDeVSkmB4vFiqIN3Q' 6-max Seat #1 is the button
Seat 1: kG34n23qFQA3nzdOJTQ1dA ($26.25 in chips) 
Seat 2: 8LzEWRhg4wk8Jh9CqDhH3Q ($3.40 in chips) 
Seat 3: DDSdUri0VKbNEouF/1bdsg ($6.20 in chips) 
Seat 4: v+QfkGiuj9bgtuNoVnDO8w ($32.50 in chips) 
8LzEWRhg4wk8Jh9CqDhH3Q: posts small blind $0.10
DDSdUri0VKbNEouF/1bdsg: posts big blind $0.25
wvIIdlbCgePONQwXjx9xzQ: sits out 
*** HOLE CARDS ***
v+QfkGiuj9bgtuNoVnDO8w: folds 
kG34n23qFQA3nzdOJTQ1dA: folds 
8LzEWRhg4wk8Jh9CqDhH3Q: raises $0.50 to $0.75
DDSdUri0VKbNEouF/1bdsg: folds 
Uncalled bet ($0.50) returned to 8LzEWRhg4wk8Jh9CqDhH3Q
8LzEWRhg4wk8Jh9CqDhH3Q collected $0.50 from pot
8LzEWRhg4wk8Jh9CqDhH3Q: doesn't show hand 
*** SUMMARY ***
Total pot $0.50 | Rake $0 
Seat 1: kG34n23qFQA3nzdOJTQ1dA (button) folded before Flop (didn't bet)
Seat 2: 8LzEWRhg4wk8Jh9CqDhH3Q (small blind) collected ($0.50)
Seat 3: DDSdUri0VKbNEouF/1bdsg (big blind) folded before Flop
Seat 4: v+QfkGiuj9bgtuNoVnDO8w folded before Flop (didn't bet)




PokerStars Game #59939370106:  Hold'em No Limit ($0.10/$0.25) - 2009/07/01 0:38:07 ET
Table 'dZNBGqFYSwfOVZvDJ4VjIQ' 6-max Seat #5 is the button
Seat 1: r0DiH4bZf5vkenb8ncDb3w ($12.25 in chips) 
Seat 2: NPueG39V6nKvDRuvBJ4U7g ($17.10 in chips) 
Seat 3: Qd4gQJ1hjQcU9/uDqd6Nlw ($11.50 in chips) 
Seat 5: hZJzYj+7+PvGu6ae1g//sQ ($11.65 in chips) 
r0DiH4bZf5vkenb8ncDb3w: posts small blind $0.10
NPueG39V6nKvDRuvBJ4U7g: posts big blind $0.25
*** HOLE CARDS ***
Qd4gQJ1hjQcU9/uDqd6Nlw: calls $0.25
hZJzYj+7+PvGu6ae1g//sQ: calls $0.25
W5I5z3jwvPiCAfmQzAaAFA leaves the table
r0DiH4bZf5vkenb8ncDb3w: calls $0.15
NPueG39V6nKvDRuvBJ4U7g: checks 
*** FLOP *** [Kd 2h 8c]
r0DiH4bZf5vkenb8ncDb3w: checks 
NPueG39V6nKvDRuvBJ4U7g: checks 
Qd4gQJ1hjQcU9/uDqd6Nlw: bets $0.25
hZJzYj+7+PvGu6ae1g//sQ: folds 
r0DiH4bZf5vkenb8ncDb3w: folds 
NPueG39V6nKvDRuvBJ4U7g: folds 
Uncalled bet ($0.25) returned to Qd4gQJ1hjQcU9/uDqd6Nlw
Qd4gQJ1hjQcU9/uDqd6Nlw collected $0.95 from pot
Qd4gQJ1hjQcU9/uDqd6Nlw: doesn't show hand 
*** SUMMARY ***
Total pot $1 | Rake $0.05 
Board [Kd 2h 8c]
Seat 1: r0DiH4bZf5vkenb8ncDb3w (small blind) folded on the Flop
Seat 2: NPueG39V6nKvDRuvBJ4U7g (big blind) folded on the Flop
Seat 3: Qd4gQJ1hjQcU9/uDqd6Nlw collected ($0.95)
Seat 5: hZJzYj+7+PvGu6ae1g//sQ (button) folded on the Flop




PokerStars Game #59939370056:  Hold'em No Limit ($0.10/$0.25) - 2009/07/01 0:38:07 ET
Table 'isKy4XK8wJM0x735/D4hWA' 6-max Seat #6 is the button
Seat 1: 7FmwVDcdEtxDpHmP4hOXsQ ($25.95 in chips) 
Seat 3: 8ClCHtFXGNplITm+63KB+Q ($24.65 in chips) 
Seat 5: zlYHXTtJ5tcx9kwK2h5n9A ($19.70 in chips) 
Seat 6: M6xK/VklCvdyyrmvzATlxQ ($13.50 in chips) 
7FmwVDcdEtxDpHmP4hOXsQ: posts small blind $0.10
8ClCHtFXGNplITm+63KB+Q: posts big blind $0.25
*** HOLE CARDS ***
zlYHXTtJ5tcx9kwK2h5n9A: raises $0.50 to $0.75
M6xK/VklCvdyyrmvzATlxQ: folds 
7FmwVDcdEtxDpHmP4hOXsQ: folds 
8ClCHtFXGNplITm+63KB+Q: raises $1.75 to $2.50
zlYHXTtJ5tcx9kwK2h5n9A: calls $1.75
*** FLOP *** [5h 5d 3d]
8ClCHtFXGNplITm+63KB+Q: bets $2
zlYHXTtJ5tcx9kwK2h5n9A: raises $14.50 to $16.50
8ClCHtFXGNplITm+63KB+Q: calls $14.50
*** TURN *** [5h 5d 3d] [2s]
8ClCHtFXGNplITm+63KB+Q: bets $1.50
zlYHXTtJ5tcx9kwK2h5n9A: calls $0.70 and is all-in
Uncalled bet ($0.80) returned to 8ClCHtFXGNplITm+63KB+Q
*** RIVER *** [5h 5d 3d 2s] [9s]
*** SHOW DOWN ***
8ClCHtFXGNplITm+63KB+Q: shows [Ad Kd] (a pair of Fives)
zlYHXTtJ5tcx9kwK2h5n9A: shows [9h 9c] (a full house, Nines full of Fives)
zlYHXTtJ5tcx9kwK2h5n9A collected $37.65 from pot
*** SUMMARY ***
Total pot $39.50 | Rake $1.85 
Board [5h 5d 3d 2s 9s]
Seat 1: 7FmwVDcdEtxDpHmP4hOXsQ (small blind) folded before Flop
Seat 3: 8ClCHtFXGNplITm+63KB+Q (big blind) showed [Ad Kd] and lost with a pair of Fives
Seat 5: zlYHXTtJ5tcx9kwK2h5n9A showed [9h 9c] and won ($37.65) with a full house, Nines full of Fives
Seat 6: M6xK/VklCvdyyrmvzATlxQ (button) folded before Flop (didn't bet)




PokerStars Game #59939369836:  Hold'em No Limit ($0.10/$0.25) - 2009/07/01 0:38:07 ET
Table 'Mef6A0EMopL6WaFO5/KO9g' 6-max Seat #1 is the button
Seat 1: ELW+DKizJhLK7k40PMkD2Q ($30 in chips) 
Seat 2: 8ClCHtFXGNplITm+63KB+Q ($33.60 in chips) 
Seat 4: pisIQ6Ztya1lC0kTtGSTHw ($58.85 in chips) 
Seat 6: BYxjLnV1/LL0aZcTbfAOvw ($25 in chips) 
8ClCHtFXGNplITm+63KB+Q: posts small blind $0.10
pisIQ6Ztya1lC0kTtGSTHw: posts big blind $0.25
WrLI51S2iMb8GLMB83gGqA: sits out 
*** HOLE CARDS ***
BYxjLnV1/LL0aZcTbfAOvw: folds 
ELW+DKizJhLK7k40PMkD2Q: folds 
8ClCHtFXGNplITm+63KB+Q: folds 
Uncalled bet ($0.15) returned to pisIQ6Ztya1lC0kTtGSTHw
pisIQ6Ztya1lC0kTtGSTHw collected $0.20 from pot
pisIQ6Ztya1lC0kTtGSTHw: doesn't show hand 
*** SUMMARY ***
Total pot $0.20 | Rake $0 
Seat 1: ELW+DKizJhLK7k40PMkD2Q (button) folded before Flop (didn't bet)
Seat 2: 8ClCHtFXGNplITm+63KB+Q (small blind) folded before Flop
Seat 4: pisIQ6Ztya1lC0kTtGSTHw (big blind) collected ($0.20)
Seat 6: BYxjLnV1/LL0aZcTbfAOvw folded before Flop (didn't bet)




PokerStars Game #59939370402:  Hold'em No Limit ($0.10/$0.25) - 2009/07/01 0:38:08 ET
Table '9SExUHslNkrPJ4XsrePaVw' 9-max Seat #2 is the button
Seat 1: qpbN+BUWX0f/ckQSmOcmkw ($8.40 in chips) 
Seat 2: ie4EwTMMFYxrCXcenJdzsw ($4.75 in chips) 
Seat 3: jeKWRUkMaVn8rEUjnJKqpg ($25 in chips) 
Seat 4: dyNjB7p93gTjZ0RXn2HnJA ($13.20 in chips) 
Seat 5: FZrgDbxAanC1xwZxXHJKVA ($13.50 in chips) 
Seat 6: DYB0aP91n+Rg/TIhycbaPQ ($14.20 in chips) 
Seat 8: t2nb95S5EEFOEzNx9Itz0g ($8.30 in chips) 
Seat 9: /THNzAxdv2lBxcf4XTj/0g ($8.15 in chips) 
jeKWRUkMaVn8rEUjnJKqpg: posts small blind $0.10
dyNjB7p93gTjZ0RXn2HnJA: posts big blind $0.25
7cv+9Zc9HIQHNvYsMfV3uA: sits out 
*** HOLE CARDS ***
FZrgDbxAanC1xwZxXHJKVA: folds 
DYB0aP91n+Rg/TIhycbaPQ: folds 
t2nb95S5EEFOEzNx9Itz0g: folds 
/THNzAxdv2lBxcf4XTj/0g: raises $0.75 to $1
qpbN+BUWX0f/ckQSmOcmkw: folds 
ie4EwTMMFYxrCXcenJdzsw: folds 
jeKWRUkMaVn8rEUjnJKqpg: calls $0.90
dyNjB7p93gTjZ0RXn2HnJA: folds 
*** FLOP *** [5d Ts 9d]
jeKWRUkMaVn8rEUjnJKqpg: checks 
/THNzAxdv2lBxcf4XTj/0g: bets $2.75
jeKWRUkMaVn8rEUjnJKqpg: raises $21.25 to $24 and is all-in
/THNzAxdv2lBxcf4XTj/0g: calls $4.40 and is all-in
Uncalled bet ($16.85) returned to jeKWRUkMaVn8rEUjnJKqpg
*** TURN *** [5d Ts 9d] [4h]
*** RIVER *** [5d Ts 9d 4h] [3h]
*** SHOW DOWN ***
jeKWRUkMaVn8rEUjnJKqpg: shows [Qc Jc] (high card Queen)
/THNzAxdv2lBxcf4XTj/0g: shows [Ah Ad] (a pair of Aces)
/THNzAxdv2lBxcf4XTj/0g collected $15.75 from pot
*** SUMMARY ***
Total pot $16.55 | Rake $0.80 
Board [5d Ts 9d 4h 3h]
Seat 1: qpbN+BUWX0f/ckQSmOcmkw folded before Flop (didn't bet)
Seat 2: ie4EwTMMFYxrCXcenJdzsw (button) folded before Flop (didn't bet)
Seat 3: jeKWRUkMaVn8rEUjnJKqpg (small blind) showed [Qc Jc] and lost with high card Queen
Seat 4: dyNjB7p93gTjZ0RXn2HnJA (big blind) folded before Flop
Seat 5: FZrgDbxAanC1xwZxXHJKVA folded before Flop (didn't bet)
Seat 6: DYB0aP91n+Rg/TIhycbaPQ folded before Flop (didn't bet)
Seat 8: t2nb95S5EEFOEzNx9Itz0g folded before Flop (didn't bet)
Seat 9: /THNzAxdv2lBxcf4XTj/0g showed [Ah Ad] and won ($15.75) with a pair of Aces




PokerStars Game #59939370452:  Hold'em No Limit ($0.10/$0.25) - 2009/07/01 0:38:08 ET
Table 'a6FCGVBMPcT7J7BDN9q1zQ' 9-max Seat #6 is the button
Seat 1: s7Q6uNouhe7aE8JdFb9E+A ($43.35 in chips) 
Seat 2: h4ggJZYBXV0mEZzYPYKfeA ($34.85 in chips) 
Seat 3: hIss79a4pu7GzJZepfgOpg ($25 in chips) 
Seat 5: JJk2ZoH7BSGLAgqFUL5pMg ($3.40 in chips) 
Seat 6: Z9AeOQX3yzuSvKAm/xyovg ($9.65 in chips) 
Seat 7: V0Yo5zRBVM8DYspLKafebg ($22.10 in chips) 
Seat 8: r6hsffOo1iKmaPYKwAZmFw ($51.70 in chips) 
Seat 9: WwcXelmo9g129XJixVb2NA ($14.75 in chips) 
V0Yo5zRBVM8DYspLKafebg: posts small blind $0.10
r6hsffOo1iKmaPYKwAZmFw: posts big blind $0.25
ydoFOVgzvZv9ZhuWu9rXAw: sits out 
*** HOLE CARDS ***
WwcXelmo9g129XJixVb2NA: folds 
s7Q6uNouhe7aE8JdFb9E+A: folds 
h4ggJZYBXV0mEZzYPYKfeA: folds 
hIss79a4pu7GzJZepfgOpg: raises $0.50 to $0.75
JJk2ZoH7BSGLAgqFUL5pMg: folds 
Z9AeOQX3yzuSvKAm/xyovg: folds 
V0Yo5zRBVM8DYspLKafebg: calls $0.65
r6hsffOo1iKmaPYKwAZmFw: folds 
*** FLOP *** [As 7c Ts]
V0Yo5zRBVM8DYspLKafebg: checks 
hIss79a4pu7GzJZepfgOpg: checks 
*** TURN *** [As 7c Ts] [9h]
V0Yo5zRBVM8DYspLKafebg: bets $1.50
hIss79a4pu7GzJZepfgOpg: folds 
Uncalled bet ($1.50) returned to V0Yo5zRBVM8DYspLKafebg
V0Yo5zRBVM8DYspLKafebg collected $1.70 from pot
*** SUMMARY ***
Total pot $1.75 | Rake $0.05 
Board [As 7c Ts 9h]
Seat 1: s7Q6uNouhe7aE8JdFb9E+A folded before Flop (didn't bet)
Seat 2: h4ggJZYBXV0mEZzYPYKfeA folded before Flop (didn't bet)
Seat 3: hIss79a4pu7GzJZepfgOpg folded on the Turn
Seat 5: JJk2ZoH7BSGLAgqFUL5pMg folded before Flop (didn't bet)
Seat 6: Z9AeOQX3yzuSvKAm/xyovg (button) folded before Flop (didn't bet)
Seat 7: V0Yo5zRBVM8DYspLKafebg (small blind) collected ($1.70)
Seat 8: r6hsffOo1iKmaPYKwAZmFw (big blind) folded before Flop
Seat 9: WwcXelmo9g129XJixVb2NA folded before Flop (didn't bet)




PokerStars Game #59939370702:  Hold'em No Limit ($0.10/$0.25) - 2009/07/01 0:38:08 ET
Table 'gYBWJG3hEuJg6kphY0yhMg' 9-max Seat #9 is the button
Seat 1: s7Q6uNouhe7aE8JdFb9E+A ($25.35 in chips) 
Seat 2: z2SmIaQ3+5n/eY1BN5HgPg ($12.50 in chips) 
Seat 3: OkWGxhGhDA0lvNLGWmJxug ($9.45 in chips) 
Seat 4: Djvxz2YXy0NdYfTgO6Iunw ($5.50 in chips) 
Seat 5: +sbyWwIcFp9kP0bDtMegfQ ($24.55 in chips) 
Seat 6: 9AI+W5n0har4qZZPPHsjKg ($4.65 in chips) 
Seat 7: xqvFhQD+76TQUT0AVOUMAg ($28 in chips) 
Seat 8: vEUoHYHDD7ub+fv3nZfhVw ($14.15 in chips) 
Seat 9: DxA2S3LbITR502Wya4qTnw ($2.45 in chips) 
s7Q6uNouhe7aE8JdFb9E+A: posts small blind $0.10
z2SmIaQ3+5n/eY1BN5HgPg: posts big blind $0.25
*** HOLE CARDS ***
OkWGxhGhDA0lvNLGWmJxug: calls $0.25
Djvxz2YXy0NdYfTgO6Iunw: raises $0.50 to $0.75
+sbyWwIcFp9kP0bDtMegfQ: folds 
9AI+W5n0har4qZZPPHsjKg: folds 
xqvFhQD+76TQUT0AVOUMAg: folds 
vEUoHYHDD7ub+fv3nZfhVw: folds 
DxA2S3LbITR502Wya4qTnw: folds 
xqvFhQD+76TQUT0AVOUMAg said, "hey Game u live in FL"
s7Q6uNouhe7aE8JdFb9E+A: folds 
z2SmIaQ3+5n/eY1BN5HgPg: raises $4.75 to $5.50
OkWGxhGhDA0lvNLGWmJxug: folds 
Djvxz2YXy0NdYfTgO6Iunw: calls $4.75 and is all-in
*** FLOP *** [9c 2c 9s]
*** TURN *** [9c 2c 9s] [7s]
*** RIVER *** [9c 2c 9s 7s] [4s]
*** SHOW DOWN ***
z2SmIaQ3+5n/eY1BN5HgPg: shows [5d 5c] (two pair, Nines and Fives)
Djvxz2YXy0NdYfTgO6Iunw: mucks hand 
Djvxz2YXy0NdYfTgO6Iunw leaves the table
z2SmIaQ3+5n/eY1BN5HgPg collected $10.80 from pot
*** SUMMARY ***
Total pot $11.35 | Rake $0.55 
Board [9c 2c 9s 7s 4s]
Seat 1: s7Q6uNouhe7aE8JdFb9E+A (small blind) folded before Flop
Seat 2: z2SmIaQ3+5n/eY1BN5HgPg (big blind) showed [5d 5c] and won ($10.80) with two pair, Nines and Fives
Seat 3: OkWGxhGhDA0lvNLGWmJxug folded before Flop
Seat 4: Djvxz2YXy0NdYfTgO6Iunw mucked
Seat 5: +sbyWwIcFp9kP0bDtMegfQ folded before Flop (didn't bet)
Seat 6: 9AI+W5n0har4qZZPPHsjKg folded before Flop (didn't bet)
Seat 7: xqvFhQD+76TQUT0AVOUMAg folded before Flop (didn't bet)
Seat 8: vEUoHYHDD7ub+fv3nZfhVw folded before Flop (didn't bet)
Seat 9: DxA2S3LbITR502Wya4qTnw (button) folded before Flop (didn't bet)




PokerStars Game #59939370696:  Hold'em No Limit ($0.10/$0.25) - 2009/07/01 0:38:08 ET
Table 'S6s+TmTlAjLHclBRvN5/fw' 9-max Seat #6 is the button
Seat 1: /XMgGtJ7mcWfe5s7McY9kw ($24.65 in chips) 
Seat 2: GGVjFwYkbwsuyKljxyML4g ($12.50 in chips) 
Seat 3: imHPFFqvfHGzsBBWeGuy4w ($20.95 in chips) 
Seat 4: M/9j4wkHH9i1JM51vgi1VA ($38.95 in chips) 
Seat 5: z5GxcHlYz/GSz6W2uFiTtg ($25 in chips) 
Seat 6: aNpwfA31EREwO+ar4XzBCw ($25.70 in chips) 
Seat 7: vSkQm2EelzwRGDDQQk0Fqw ($5.75 in chips) 
Seat 8: MC7/fevFfNbuDTx/uhUC4w ($13.90 in chips) 
Seat 9: BODayQmPi2rEfae9e6hIlw ($27.30 in chips) 
vSkQm2EelzwRGDDQQk0Fqw: posts small blind $0.10
MC7/fevFfNbuDTx/uhUC4w: posts big blind $0.25
*** HOLE CARDS ***
BODayQmPi2rEfae9e6hIlw: raises $0.25 to $0.50
/XMgGtJ7mcWfe5s7McY9kw: folds 
GGVjFwYkbwsuyKljxyML4g: folds 
imHPFFqvfHGzsBBWeGuy4w: folds 
M/9j4wkHH9i1JM51vgi1VA: folds 
z5GxcHlYz/GSz6W2uFiTtg: folds 
aNpwfA31EREwO+ar4XzBCw: calls $0.50
vSkQm2EelzwRGDDQQk0Fqw: folds 
MC7/fevFfNbuDTx/uhUC4w: folds 
*** FLOP *** [2c Ts As]
MC7/fevFfNbuDTx/uhUC4w leaves the table
BODayQmPi2rEfae9e6hIlw: bets $1
aNpwfA31EREwO+ar4XzBCw: folds 
Uncalled bet ($1) returned to BODayQmPi2rEfae9e6hIlw
BODayQmPi2rEfae9e6hIlw collected $1.30 from pot
BODayQmPi2rEfae9e6hIlw: doesn't show hand 
*** SUMMARY ***
Total pot $1.35 | Rake $0.05 
Board [2c Ts As]
Seat 1: /XMgGtJ7mcWfe5s7McY9kw folded before Flop (didn't bet)
Seat 2: GGVjFwYkbwsuyKljxyML4g folded before Flop (didn't bet)
Seat 3: imHPFFqvfHGzsBBWeGuy4w folded before Flop (didn't bet)
Seat 4: M/9j4wkHH9i1JM51vgi1VA folded before Flop (didn't bet)
Seat 5: z5GxcHlYz/GSz6W2uFiTtg folded before Flop (didn't bet)
Seat 6: aNpwfA31EREwO+ar4XzBCw (button) folded on the Flop
Seat 7: vSkQm2EelzwRGDDQQk0Fqw (small blind) folded before Flop
Seat 8: MC7/fevFfNbuDTx/uhUC4w (big blind) folded before Flop
Seat 9: BODayQmPi2rEfae9e6hIlw collected ($1.30)




PokerStars Game #59939370448:  Hold'em No Limit ($0.10/$0.25) - 2009/07/01 0:38:08 ET
Table 'BpNkESDX1ip9c0K1hb5h7A' 6-max Seat #6 is the button
Seat 1: 9jSiy0meE9XJKkdIZwyTEQ ($28.85 in chips) 
Seat 3: cHhVLDikFlByGGN+CM3w/A ($27.30 in chips) 
Seat 4: tbhYGxTClzdFLMcTtjvJhg ($49.20 in chips) 
Seat 5: QvTX2yGq3uKJiKPmns4TKQ ($73.40 in chips) 
Seat 6: iUgsn+WyKFjjVd+tj13R2w ($3.40 in chips) 
9jSiy0meE9XJKkdIZwyTEQ: posts small blind $0.10
cHhVLDikFlByGGN+CM3w/A: posts big blind $0.25
*** HOLE CARDS ***
tbhYGxTClzdFLMcTtjvJhg: folds 
QvTX2yGq3uKJiKPmns4TKQ: folds 
iUgsn+WyKFjjVd+tj13R2w: calls $0.25
9jSiy0meE9XJKkdIZwyTEQ: folds 
cHhVLDikFlByGGN+CM3w/A: raises $1.25 to $1.50
iUgsn+WyKFjjVd+tj13R2w: folds 
Uncalled bet ($1.25) returned to cHhVLDikFlByGGN+CM3w/A
cHhVLDikFlByGGN+CM3w/A collected $0.60 from pot
cHhVLDikFlByGGN+CM3w/A: doesn't show hand 
*** SUMMARY ***
Total pot $0.60 | Rake $0 
Seat 1: 9jSiy0meE9XJKkdIZwyTEQ (small blind) folded before Flop
Seat 3: cHhVLDikFlByGGN+CM3w/A (big blind) collected ($0.60)
Seat 4: tbhYGxTClzdFLMcTtjvJhg folded before Flop (didn't bet)
Seat 5: QvTX2yGq3uKJiKPmns4TKQ folded before Flop (didn't bet)
Seat 6: iUgsn+WyKFjjVd+tj13R2w (button) folded before Flop




PokerStars Game #59939370398:  Hold'em No Limit ($0.10/$0.25) - 2009/07/01 0:38:08 ET
Table 'zgAizkhIUPUrfr6LqN3ifw' 9-max Seat #8 is the button
Seat 1: st9jtdNbm1W5GfBwRaCVqQ ($23 in chips) 
Seat 2: s7Q6uNouhe7aE8JdFb9E+A ($26.25 in chips) 
Seat 3: hZuGwtYmFKPmQ+v1wlmdfA ($23.10 in chips) 
Seat 4: ad+ybh3lXaKiRqZV/fHKiw ($30.20 in chips) 
Seat 7: 1S/fpm+f42V/6MNZre+ccg ($25 in chips) 
Seat 8: MIVCHqCqqlke0Lb0z7glcw ($24.15 in chips) 
Seat 9: SXqVW4Q0evTUVZG6BbUNIA ($27.80 in chips) 
SXqVW4Q0evTUVZG6BbUNIA: posts small blind $0.10
st9jtdNbm1W5GfBwRaCVqQ: posts big blind $0.25
DdPXdieucQ+n99u1n3A+rQ: sits out 
TeWJxSETzbXGiYKx0y+dtg: sits out 
*** HOLE CARDS ***
s7Q6uNouhe7aE8JdFb9E+A: folds 
hZuGwtYmFKPmQ+v1wlmdfA: folds 
ad+ybh3lXaKiRqZV/fHKiw has timed out
ad+ybh3lXaKiRqZV/fHKiw: folds 
ad+ybh3lXaKiRqZV/fHKiw is sitting out
1S/fpm+f42V/6MNZre+ccg: folds 
MIVCHqCqqlke0Lb0z7glcw: folds 
SXqVW4Q0evTUVZG6BbUNIA: raises $0.50 to $0.75
st9jtdNbm1W5GfBwRaCVqQ: calls $0.50
*** FLOP *** [6c Jh Kh]
SXqVW4Q0evTUVZG6BbUNIA: checks 
st9jtdNbm1W5GfBwRaCVqQ: checks 
*** TURN *** [6c Jh Kh] [7s]
SXqVW4Q0evTUVZG6BbUNIA: bets $1
st9jtdNbm1W5GfBwRaCVqQ: raises $1.50 to $2.50
SXqVW4Q0evTUVZG6BbUNIA: raises $2.50 to $5
st9jtdNbm1W5GfBwRaCVqQ: raises $7 to $12
SXqVW4Q0evTUVZG6BbUNIA: raises $15.05 to $27.05 and is all-in
st9jtdNbm1W5GfBwRaCVqQ: folds 
Uncalled bet ($15.05) returned to SXqVW4Q0evTUVZG6BbUNIA
SXqVW4Q0evTUVZG6BbUNIA collected $24.25 from pot
SXqVW4Q0evTUVZG6BbUNIA: doesn't show hand 
*** SUMMARY ***
Total pot $25.50 | Rake $1.25 
Board [6c Jh Kh 7s]
Seat 1: st9jtdNbm1W5GfBwRaCVqQ (big blind) folded on the Turn
Seat 2: s7Q6uNouhe7aE8JdFb9E+A folded before Flop (didn't bet)
Seat 3: hZuGwtYmFKPmQ+v1wlmdfA folded before Flop (didn't bet)
Seat 4: ad+ybh3lXaKiRqZV/fHKiw folded before Flop (didn't bet)
Seat 7: 1S/fpm+f42V/6MNZre+ccg folded before Flop (didn't bet)
Seat 8: MIVCHqCqqlke0Lb0z7glcw (button) folded before Flop (didn't bet)
Seat 9: SXqVW4Q0evTUVZG6BbUNIA (small blind) collected ($24.25)




PokerStars Game #59939370400:  Hold'em No Limit ($0.10/$0.25) - 2009/07/01 0:38:08 ET
Table '5510FxlYzKi+U6MIpo8IPA' 6-max Seat #5 is the button
Seat 1: KM6ogk7SqyRlk3m9b0h+7A ($18.90 in chips) 
Seat 2: DC32yoMFAClimBnPIND2eA ($28.30 in chips) 
Seat 3: v+QfkGiuj9bgtuNoVnDO8w ($26.20 in chips) 
Seat 4: cPO/1/dTcZpLkQFm3jH3Rg ($29.40 in chips) 
Seat 5: 5E1iMY5xyboow7Xm0v7Idw ($13.30 in chips) 
Seat 6: SFmT9ZsVopnukjvAzrxTRg ($30.20 in chips) 
SFmT9ZsVopnukjvAzrxTRg: posts small blind $0.10
KM6ogk7SqyRlk3m9b0h+7A: posts big blind $0.25
*** HOLE CARDS ***
DC32yoMFAClimBnPIND2eA: folds 
DC32yoMFAClimBnPIND2eA leaves the table
v+QfkGiuj9bgtuNoVnDO8w: folds 
cPO/1/dTcZpLkQFm3jH3Rg: folds 
5E1iMY5xyboow7Xm0v7Idw: calls $0.25
SFmT9ZsVopnukjvAzrxTRg: folds 
KM6ogk7SqyRlk3m9b0h+7A: checks 
*** FLOP *** [Kd Ah 3h]
KM6ogk7SqyRlk3m9b0h+7A: checks 
5E1iMY5xyboow7Xm0v7Idw: bets $0.50
KM6ogk7SqyRlk3m9b0h+7A: folds 
Uncalled bet ($0.50) returned to 5E1iMY5xyboow7Xm0v7Idw
5E1iMY5xyboow7Xm0v7Idw collected $0.60 from pot
*** SUMMARY ***
Total pot $0.60 | Rake $0 
Board [Kd Ah 3h]
Seat 1: KM6ogk7SqyRlk3m9b0h+7A (big blind) folded on the Flop
Seat 2: DC32yoMFAClimBnPIND2eA folded before Flop (didn't bet)
Seat 3: v+QfkGiuj9bgtuNoVnDO8w folded before Flop (didn't bet)
Seat 4: cPO/1/dTcZpLkQFm3jH3Rg folded before Flop (didn't bet)
Seat 5: 5E1iMY5xyboow7Xm0v7Idw (button) collected ($0.60)
Seat 6: SFmT9ZsVopnukjvAzrxTRg (small blind) folded before Flop




PokerStars Game #59939370476:  Hold'em No Limit ($0.10/$0.25) - 2009/07/01 0:38:08 ET
Table '6aL2C8IFwHHr6SG6RgXaow' 9-max Seat #2 is the button
Seat 2: +gMmKt3DaQng9M42CmxIZg ($24.55 in chips) 
Seat 5: wre31HfyzQGpIvID1istxw ($15.10 in chips) 
Seat 6: HxDF4QSxC4z39D7teZpprQ ($33.90 in chips) 
Seat 7: rPToQDbLWB+dKnz7fcQSIg ($10.40 in chips) 
Seat 8: rQhYIYXSyH/IivYM1dlV5A ($14.40 in chips) 
Seat 9: yduPKWPzL8YlT5Zv/Nmrwg ($15.65 in chips) 
wre31HfyzQGpIvID1istxw: posts small blind $0.10
HxDF4QSxC4z39D7teZpprQ: posts big blind $0.25
*** HOLE CARDS ***
rPToQDbLWB+dKnz7fcQSIg: folds 
rQhYIYXSyH/IivYM1dlV5A: folds 
yduPKWPzL8YlT5Zv/Nmrwg: raises $0.50 to $0.75
+gMmKt3DaQng9M42CmxIZg: folds 
wre31HfyzQGpIvID1istxw: calls $0.65
HxDF4QSxC4z39D7teZpprQ: calls $0.50
*** FLOP *** [5s Qd 5d]
wre31HfyzQGpIvID1istxw: checks 
HxDF4QSxC4z39D7teZpprQ: checks 
yduPKWPzL8YlT5Zv/Nmrwg: bets $1.50
wre31HfyzQGpIvID1istxw: folds 
HxDF4QSxC4z39D7teZpprQ: folds 
Uncalled bet ($1.50) returned to yduPKWPzL8YlT5Zv/Nmrwg
yduPKWPzL8YlT5Zv/Nmrwg collected $2.15 from pot
*** SUMMARY ***
Total pot $2.25 | Rake $0.10 
Board [5s Qd 5d]
Seat 2: +gMmKt3DaQng9M42CmxIZg (button) folded before Flop (didn't bet)
Seat 5: wre31HfyzQGpIvID1istxw (small blind) folded on the Flop
Seat 6: HxDF4QSxC4z39D7teZpprQ (big blind) folded on the Flop
Seat 7: rPToQDbLWB+dKnz7fcQSIg folded before Flop (didn't bet)
Seat 8: rQhYIYXSyH/IivYM1dlV5A folded before Flop (didn't bet)
Seat 9: yduPKWPzL8YlT5Zv/Nmrwg collected ($2.15)




PokerStars Game #59939371186:  Hold'em No Limit ($0.10/$0.25) - 2009/07/01 0:38:09 ET
Table 'fIrOIN3HoXM27ZpRwKa6oA' 6-max Seat #1 is the button
Seat 1: I1TxPvWj8NfG8orglCinNA ($38.85 in chips) 
Seat 2: 5tB0F9NjPSUL4FzmzBMs2Q ($35.90 in chips) 
Seat 3: OElpcjPk5wP6xlAUngsAmg ($5.75 in chips) 
Seat 4: PEUgcMc+CzvN+vLwu5DsLQ ($1.25 in chips) 
Seat 5: 8ClCHtFXGNplITm+63KB+Q ($27.15 in chips) 
Seat 6: v+QfkGiuj9bgtuNoVnDO8w ($30.05 in chips) 
5tB0F9NjPSUL4FzmzBMs2Q: posts small blind $0.10
OElpcjPk5wP6xlAUngsAmg: posts big blind $0.25
*** HOLE CARDS ***
PEUgcMc+CzvN+vLwu5DsLQ: raises $1 to $1.25 and is all-in
8ClCHtFXGNplITm+63KB+Q: folds 
v+QfkGiuj9bgtuNoVnDO8w: folds 
I1TxPvWj8NfG8orglCinNA: folds 
5tB0F9NjPSUL4FzmzBMs2Q: folds 
OElpcjPk5wP6xlAUngsAmg: folds 
Uncalled bet ($1) returned to PEUgcMc+CzvN+vLwu5DsLQ
PEUgcMc+CzvN+vLwu5DsLQ collected $0.60 from pot
PEUgcMc+CzvN+vLwu5DsLQ: doesn't show hand 
*** SUMMARY ***
Total pot $0.60 | Rake $0 
Seat 1: I1TxPvWj8NfG8orglCinNA (button) folded before Flop (didn't bet)
Seat 2: 5tB0F9NjPSUL4FzmzBMs2Q (small blind) folded before Flop
Seat 3: OElpcjPk5wP6xlAUngsAmg (big blind) folded before Flop
Seat 4: PEUgcMc+CzvN+vLwu5DsLQ collected ($0.60)
Seat 5: 8ClCHtFXGNplITm+63KB+Q folded before Flop (didn't bet)
Seat 6: v+QfkGiuj9bgtuNoVnDO8w folded before Flop (didn't bet)




PokerStars Game #59939371316:  Hold'em No Limit ($0.10/$0.25) - 2009/07/01 0:38:09 ET
Table 'WjNvuuSgTjm8jh0j9vcCgQ' 9-max Seat #6 is the button
Seat 3: 8B/dhbQjIWe6ASCdgzktNQ ($25 in chips) 
Seat 4: 3PjJjazzeHcM4mbFeXmZBg ($20.20 in chips) 
Seat 5: Qi+clOtyDiibLdH2/1Qy8g ($17.75 in chips) 
Seat 6: GvhQYMvt1tDska5vKhXkFA ($30.10 in chips) 
Seat 7: DdPXdieucQ+n99u1n3A+rQ ($4.75 in chips) 
Seat 8: ghNKXUBl/H+t83JF079ZBA ($25 in chips) 
Seat 9: DiSvPC2iudwL5j9u6Huyww ($29.70 in chips) 
DdPXdieucQ+n99u1n3A+rQ: posts small blind $0.10
ghNKXUBl/H+t83JF079ZBA: posts big blind $0.25
NKymidkL3Kg3ILZPvtLSVg: sits out 
9gmYYQesalMrUjaF7nKfrQ: sits out 
*** HOLE CARDS ***
DiSvPC2iudwL5j9u6Huyww: folds 
8B/dhbQjIWe6ASCdgzktNQ: folds 
3PjJjazzeHcM4mbFeXmZBg: folds 
Qi+clOtyDiibLdH2/1Qy8g: raises $0.50 to $0.75
GvhQYMvt1tDska5vKhXkFA: folds 
DdPXdieucQ+n99u1n3A+rQ: folds 
ghNKXUBl/H+t83JF079ZBA: folds 
Uncalled bet ($0.50) returned to Qi+clOtyDiibLdH2/1Qy8g
Qi+clOtyDiibLdH2/1Qy8g collected $0.60 from pot
Qi+clOtyDiibLdH2/1Qy8g: doesn't show hand 
*** SUMMARY ***
Total pot $0.60 | Rake $0 
Seat 3: 8B/dhbQjIWe6ASCdgzktNQ folded before Flop (didn't bet)
Seat 4: 3PjJjazzeHcM4mbFeXmZBg folded before Flop (didn't bet)
Seat 5: Qi+clOtyDiibLdH2/1Qy8g collected ($0.60)
Seat 6: GvhQYMvt1tDska5vKhXkFA (button) folded before Flop (didn't bet)
Seat 7: DdPXdieucQ+n99u1n3A+rQ (small blind) folded before Flop
Seat 8: ghNKXUBl/H+t83JF079ZBA (big blind) folded before Flop
Seat 9: DiSvPC2iudwL5j9u6Huyww folded before Flop (didn't bet)




PokerStars Game #59939371064:  Hold'em No Limit ($0.10/$0.25) - 2009/07/01 0:38:09 ET
Table 'nteM56rtr9SxLEblf0fvbw' 9-max Seat #1 is the button
Seat 1: H9KUl8cmpLgEpOVDA00bCg ($5 in chips) 
Seat 2: ljemhp25Zg+nlA9DLCIiUw ($26.05 in chips) 
Seat 4: cZ99hugmLBj9KhTlc8nCSw ($25.15 in chips) 
Seat 5: aJy680tKSaP5er559aSuGA ($10.45 in chips) 
Seat 7: dfNim92Z6XK1/h5SFW5vDg ($44.30 in chips) 
Seat 8: RJ/x9oZtt1RZLaJEQwZOxQ ($44.15 in chips) 
Seat 9: t2nb95S5EEFOEzNx9Itz0g ($6.90 in chips) 
ljemhp25Zg+nlA9DLCIiUw: posts small blind $0.10
cZ99hugmLBj9KhTlc8nCSw: posts big blind $0.25
*** HOLE CARDS ***
aJy680tKSaP5er559aSuGA: folds 
ZWU9RNYtjmm4cElg1I0F4w leaves the table
dfNim92Z6XK1/h5SFW5vDg: folds 
RJ/x9oZtt1RZLaJEQwZOxQ: folds 
t2nb95S5EEFOEzNx9Itz0g: folds 
H9KUl8cmpLgEpOVDA00bCg: folds 
ljemhp25Zg+nlA9DLCIiUw: folds 
Uncalled bet ($0.15) returned to cZ99hugmLBj9KhTlc8nCSw
cZ99hugmLBj9KhTlc8nCSw collected $0.20 from pot
LuckyShot



PokerStars Game #59939371450:  Hold'em No Limit ($0.10/$0.25) - 2009/07/01 0:38:09 ET
Table 'Of/T60zpXg1GcjrZ7Lm//Q' 9-max Seat #4 is the button
Seat 1: Lro4e37x4FUa5P3yzDjskw ($7.45 in chips) 
Seat 2: hIss79a4pu7GzJZepfgOpg ($25.45 in chips) 
Seat 3: jeKWRUkMaVn8rEUjnJKqpg ($25 in chips) 
Seat 4: Czut6V7acIqUJrrobjKAZg ($25.05 in chips) 
Seat 5: 18G4P1XstjNvItdGUITxgw ($25 in chips) 
Seat 6: tYsOBqdU1+x+yFI7zHO7hQ ($26.10 in chips) 
Seat 7: s7Q6uNouhe7aE8JdFb9E+A ($34.25 in chips) 
Seat 8: ghNKXUBl/H+t83JF079ZBA ($29 in chips) 
Seat 9: TeWJxSETzbXGiYKx0y+dtg ($24.65 in chips) 
18G4P1XstjNvItdGUITxgw: posts small blind $0.10
tYsOBqdU1+x+yFI7zHO7hQ: posts big blind $0.25
*** HOLE CARDS ***
s7Q6uNouhe7aE8JdFb9E+A: folds 
ghNKXUBl/H+t83JF079ZBA: folds 
TeWJxSETzbXGiYKx0y+dtg: folds 
Lro4e37x4FUa5P3yzDjskw: calls $0.25
hIss79a4pu7GzJZepfgOpg: folds 
jeKWRUkMaVn8rEUjnJKqpg: folds 
Czut6V7acIqUJrrobjKAZg: folds 
18G4P1XstjNvItdGUITxgw: folds 
tYsOBqdU1+x+yFI7zHO7hQ: checks 
*** FLOP *** [8h 6h Ah]
tYsOBqdU1+x+yFI7zHO7hQ: checks 
Lro4e37x4FUa5P3yzDjskw: bets $0.50
tYsOBqdU1+x+yFI7zHO7hQ: folds 
Uncalled bet ($0.50) returned to Lro4e37x4FUa5P3yzDjskw
Lro4e37x4FUa5P3yzDjskw collected $0.60 from pot
*** SUMMARY ***
Total pot $0.60 | Rake $0 
Board [8h 6h Ah]
Seat 1: Lro4e37x4FUa5P3yzDjskw collected ($0.60)
Seat 2: hIss79a4pu7GzJZepfgOpg folded before Flop (didn't bet)
Seat 3: jeKWRUkMaVn8rEUjnJKqpg folded before Flop (didn't bet)
Seat 4: Czut6V7acIqUJrrobjKAZg (button) folded before Flop (didn't bet)
Seat 5: 18G4P1XstjNvItdGUITxgw (small blind) folded before Flop
Seat 6: tYsOBqdU1+x+yFI7zHO7hQ (big blind) folded on the Flop
Seat 7: s7Q6uNouhe7aE8JdFb9E+A folded before Flop (didn't bet)
Seat 8: ghNKXUBl/H+t83JF079ZBA folded before Flop (didn't bet)
Seat 9: TeWJxSETzbXGiYKx0y+dtg folded before Flop (didn't bet)




PokerStars Game #59939371584:  Hold'em No Limit ($0.10/$0.25) - 2009/07/01 0:38:09 ET
Table 'i8VqsSY3xDtJ63IHleN8+A' 9-max Seat #7 is the button
Seat 1: D3XCkXRktDfPlSguxwfnRA ($15.55 in chips) 
Seat 2: SXqVW4Q0evTUVZG6BbUNIA ($47 in chips) 
Seat 3: HPEB+AtKw1+C/cxU0o1ciw ($56.20 in chips) 
Seat 4: G2offPrpnppc++nuXqs2JA ($14.55 in chips) 
Seat 5: DIBbjEYGs+TVdVgEB/4+3w ($24.90 in chips) 
Seat 6: Xpyqpb+DURDWnyJ3xTEIFQ ($24.75 in chips) 
Seat 7: j4q3p0lesp63b1gZDwLBZw ($6 in chips) 
Seat 8: 5MgYq10OC5iGoxQFwlJVuw ($12.80 in chips) 
Seat 9: vSkQm2EelzwRGDDQQk0Fqw ($6.60 in chips) 
5MgYq10OC5iGoxQFwlJVuw: posts small blind $0.10
vSkQm2EelzwRGDDQQk0Fqw: posts big blind $0.25
*** HOLE CARDS ***
D3XCkXRktDfPlSguxwfnRA: calls $0.25
SXqVW4Q0evTUVZG6BbUNIA: folds 
HPEB+AtKw1+C/cxU0o1ciw: folds 
G2offPrpnppc++nuXqs2JA: raises $0.75 to $1
DIBbjEYGs+TVdVgEB/4+3w: folds 
Xpyqpb+DURDWnyJ3xTEIFQ: folds 
j4q3p0lesp63b1gZDwLBZw: folds 
5MgYq10OC5iGoxQFwlJVuw: folds 
vSkQm2EelzwRGDDQQk0Fqw: folds 
D3XCkXRktDfPlSguxwfnRA: folds 
Uncalled bet ($0.75) returned to G2offPrpnppc++nuXqs2JA
G2offPrpnppc++nuXqs2JA collected $0.85 from pot
*** SUMMARY ***
Total pot $0.85 | Rake $0 
Seat 1: D3XCkXRktDfPlSguxwfnRA folded before Flop
Seat 2: SXqVW4Q0evTUVZG6BbUNIA folded before Flop (didn't bet)
Seat 3: HPEB+AtKw1+C/cxU0o1ciw folded before Flop (didn't bet)
Seat 4: G2offPrpnppc++nuXqs2JA collected ($0.85)
Seat 5: DIBbjEYGs+TVdVgEB/4+3w folded before Flop (didn't bet)
Seat 6: Xpyqpb+DURDWnyJ3xTEIFQ folded before Flop (didn't bet)
Seat 7: j4q3p0lesp63b1gZDwLBZw (button) folded before Flop (didn't bet)
Seat 8: 5MgYq10OC5iGoxQFwlJVuw (small blind) folded before Flop
Seat 9: vSkQm2EelzwRGDDQQk0Fqw (big blind) folded before Flop




PokerStars Game #59939372246:  Hold'em No Limit ($0.10/$0.25) - 2009/07/01 0:38:10 ET
Table '+VTTYgQLH1awDHk+IAxqGg' 9-max Seat #1 is the button
Seat 1: s7Q6uNouhe7aE8JdFb9E+A ($25.60 in chips) 
Seat 2: 86vbuhJsyH+nbEg5qpDLyQ ($24.75 in chips) 
Seat 3: rSMoem/92WmnPjtw2tSQkA ($18.85 in chips) 
Seat 4: gE5rN2TDY1aXcZn/TOPeZw ($10.20 in chips) 
Seat 5: yK+pRpUZrQ4FOJcfjJy1eg ($7.10 in chips) 
Seat 6: gAlaEiNZy/H/QuIVwzvHAQ ($16.10 in chips) 
Seat 7: W4TLQcZ2TiM73eIgpIvlGg ($26.55 in chips) 
Seat 8: rg+23WZbUM/1tFGv4XhYYA ($6 in chips) 
Seat 9: CFZ+ACzShzC3naaIaOjbYQ ($9.15 in chips) 
86vbuhJsyH+nbEg5qpDLyQ: posts small blind $0.10
rSMoem/92WmnPjtw2tSQkA: posts big blind $0.25
*** HOLE CARDS ***
gE5rN2TDY1aXcZn/TOPeZw: folds 
yK+pRpUZrQ4FOJcfjJy1eg: calls $0.25
gAlaEiNZy/H/QuIVwzvHAQ: folds 
W4TLQcZ2TiM73eIgpIvlGg: folds 
rg+23WZbUM/1tFGv4XhYYA: raises $0.25 to $0.50
CFZ+ACzShzC3naaIaOjbYQ: calls $0.50
s7Q6uNouhe7aE8JdFb9E+A: folds 
86vbuhJsyH+nbEg5qpDLyQ: folds 
rSMoem/92WmnPjtw2tSQkA: calls $0.25
yK+pRpUZrQ4FOJcfjJy1eg: calls $0.25
*** FLOP *** [5h Jh 6h]
rSMoem/92WmnPjtw2tSQkA: checks 
yK+pRpUZrQ4FOJcfjJy1eg: bets $0.75
rg+23WZbUM/1tFGv4XhYYA: calls $0.75
CFZ+ACzShzC3naaIaOjbYQ: calls $0.75
rSMoem/92WmnPjtw2tSQkA: calls $0.75
*** TURN *** [5h Jh 6h] [8s]
rSMoem/92WmnPjtw2tSQkA: bets $5.25
yK+pRpUZrQ4FOJcfjJy1eg: folds 
rg+23WZbUM/1tFGv4XhYYA: folds 
CFZ+ACzShzC3naaIaOjbYQ: folds 
Uncalled bet ($5.25) returned to rSMoem/92WmnPjtw2tSQkA
rSMoem/92WmnPjtw2tSQkA collected $4.85 from pot
*** SUMMARY ***
Total pot $5.10 | Rake $0.25 
Board [5h Jh 6h 8s]
Seat 1: s7Q6uNouhe7aE8JdFb9E+A (button) folded before Flop (didn't bet)
Seat 2: 86vbuhJsyH+nbEg5qpDLyQ (small blind) folded before Flop
Seat 3: rSMoem/92WmnPjtw2tSQkA (big blind) collected ($4.85)
Seat 4: gE5rN2TDY1aXcZn/TOPeZw folded before Flop (didn't bet)
Seat 5: yK+pRpUZrQ4FOJcfjJy1eg folded on the Turn
Seat 6: gAlaEiNZy/H/QuIVwzvHAQ folded before Flop (didn't bet)
Seat 7: W4TLQcZ2TiM73eIgpIvlGg folded before Flop (didn't bet)
Seat 8: rg+23WZbUM/1tFGv4XhYYA folded on the Turn
Seat 9: CFZ+ACzShzC3naaIaOjbYQ folded on the Turn




PokerStars Game #59939371758:  Hold'em No Limit ($0.10/$0.25) - 2009/07/01 0:38:10 ET
Table '972HGIb0tQN/zRIK4TABEw' 9-max Seat #8 is the button
Seat 1: fHr2+mGa0RFK3qrpZcVUAQ ($9.50 in chips) 
Seat 2: lc6GpYOW7MM4G+/65wMxXA ($14.75 in chips) 
Seat 3: W4TLQcZ2TiM73eIgpIvlGg ($24.40 in chips) 
Seat 4: BnWWUASA3YjU/ovKqaKNpA ($7.25 in chips) 
Seat 5: oFwaTjy3ok/+qFghsrcGvg ($9.10 in chips) 
Seat 7: qS+jfnNoG75bT+uQ8CKhQA ($15 in chips) 
Seat 8: DIBbjEYGs+TVdVgEB/4+3w ($47.25 in chips) 
Seat 9: qUzFLsH4zPL5Zy77O+Qlbw ($3.10 in chips) 
qUzFLsH4zPL5Zy77O+Qlbw: posts small blind $0.10
fHr2+mGa0RFK3qrpZcVUAQ: posts big blind $0.25
qS+jfnNoG75bT+uQ8CKhQA: posts big blind $0.25
*** HOLE CARDS ***
lc6GpYOW7MM4G+/65wMxXA: folds 
W4TLQcZ2TiM73eIgpIvlGg: folds 
BnWWUASA3YjU/ovKqaKNpA: calls $0.25
oFwaTjy3ok/+qFghsrcGvg: folds 
qS+jfnNoG75bT+uQ8CKhQA: checks 
DIBbjEYGs+TVdVgEB/4+3w: calls $0.25
qUzFLsH4zPL5Zy77O+Qlbw: calls $0.15
fHr2+mGa0RFK3qrpZcVUAQ: raises $1.75 to $2
BnWWUASA3YjU/ovKqaKNpA: folds 
qS+jfnNoG75bT+uQ8CKhQA: folds 
DIBbjEYGs+TVdVgEB/4+3w: folds 
qUzFLsH4zPL5Zy77O+Qlbw: folds 
Uncalled bet ($1.75) returned to fHr2+mGa0RFK3qrpZcVUAQ
fHr2+mGa0RFK3qrpZcVUAQ collected $1.25 from pot
*** SUMMARY ***
Total pot $1.25 | Rake $0 
Seat 1: fHr2+mGa0RFK3qrpZcVUAQ (big blind) collected ($1.25)
Seat 2: lc6GpYOW7MM4G+/65wMxXA folded before Flop (didn't bet)
Seat 3: W4TLQcZ2TiM73eIgpIvlGg folded before Flop (didn't bet)
Seat 4: BnWWUASA3YjU/ovKqaKNpA folded before Flop
Seat 5: oFwaTjy3ok/+qFghsrcGvg folded before Flop (didn't bet)
Seat 7: qS+jfnNoG75bT+uQ8CKhQA folded before Flop
Seat 8: DIBbjEYGs+TVdVgEB/4+3w (button) folded before Flop
Seat 9: qUzFLsH4zPL5Zy77O+Qlbw (small blind) folded before Flop




PokerStars Game #59939372104:  Hold'em No Limit ($0.10/$0.25) - 2009/07/01 0:38:10 ET
Table 'GrYi0DZOHD1EvB+qiLExNw' 9-max Seat #2 is the button
Seat 1: 4awUyiDYTgylQKXZ9faBVA ($44.40 in chips) 
Seat 2: Th3FldXKQW6hWVVPahaoOQ ($26.30 in chips) 
Seat 3: 4oA316mXLIui1QY63GXBUg ($25 in chips) 
Seat 5: cZ99hugmLBj9KhTlc8nCSw ($48.85 in chips) 
Seat 6: H9KUl8cmpLgEpOVDA00bCg ($4.55 in chips) 
Seat 7: 1Clf3cPrqoy/YgvWdWK1Xw ($5.25 in chips) 
Seat 8: nalbG/4/1Z1wQjRDWV7b2w ($4.55 in chips) 
Seat 9: st9jtdNbm1W5GfBwRaCVqQ ($24.75 in chips) 
4oA316mXLIui1QY63GXBUg: posts small blind $0.10
cZ99hugmLBj9KhTlc8nCSw: posts big blind $0.25
*** HOLE CARDS ***
H9KUl8cmpLgEpOVDA00bCg: folds 
1Clf3cPrqoy/YgvWdWK1Xw: folds 
nalbG/4/1Z1wQjRDWV7b2w: raises $4.30 to $4.55 and is all-in
st9jtdNbm1W5GfBwRaCVqQ: folds 
4awUyiDYTgylQKXZ9faBVA: calls $4.55
Th3FldXKQW6hWVVPahaoOQ: folds 
4oA316mXLIui1QY63GXBUg: folds 
cZ99hugmLBj9KhTlc8nCSw: folds 
*** FLOP *** [Kd 8s Ts]
*** TURN *** [Kd 8s Ts] [8d]
*** RIVER *** [Kd 8s Ts 8d] [7d]
*** SHOW DOWN ***
nalbG/4/1Z1wQjRDWV7b2w: shows [Js Tc] (two pair, Tens and Eights)
4awUyiDYTgylQKXZ9faBVA: shows [Kh Qs] (two pair, Kings and Eights)
4awUyiDYTgylQKXZ9faBVA collected $9 from pot
*** SUMMARY ***
Total pot $9.45 | Rake $0.45 
Board [Kd 8s Ts 8d 7d]
Seat 1: 4awUyiDYTgylQKXZ9faBVA showed [Kh Qs] and won ($9) with two pair, Kings and Eights
Seat 2: Th3FldXKQW6hWVVPahaoOQ (button) folded before Flop (didn't bet)
Seat 3: 4oA316mXLIui1QY63GXBUg (small blind) folded before Flop
Seat 5: cZ99hugmLBj9KhTlc8nCSw (big blind) folded before Flop
Seat 6: H9KUl8cmpLgEpOVDA00bCg folded before Flop (didn't bet)
Seat 7: 1Clf3cPrqoy/YgvWdWK1Xw folded before Flop (didn't bet)
Seat 8: nalbG/4/1Z1wQjRDWV7b2w showed [Js Tc] and lost with two pair, Tens and Eights
Seat 9: st9jtdNbm1W5GfBwRaCVqQ folded before Flop (didn't bet)




PokerStars Game #59939372116:  Hold'em No Limit ($0.10/$0.25) - 2009/07/01 0:38:10 ET
Table 'SkaFM7xfUr/Nd+JFPb7f2w' 9-max Seat #9 is the button
Seat 2: QEbIGci+itdw+re8RM5fZA ($28.40 in chips) 
Seat 3: 4oA316mXLIui1QY63GXBUg ($25 in chips) 
Seat 4: DIBbjEYGs+TVdVgEB/4+3w ($39.20 in chips) 
Seat 5: GftT+l+xjKzcY0rMiNZfPg ($9.05 in chips) 
Seat 6: PskTLlFIRHSp61inskRzVg ($7.85 in chips) 
Seat 7: 7wo6Sr7QG3Zo6BaBDV1BOw ($5 in chips) 
Seat 8: Lro4e37x4FUa5P3yzDjskw ($10.85 in chips) 
Seat 9: STkR8XvpjNv79OOMhrlh2w ($59.45 in chips) 
QEbIGci+itdw+re8RM5fZA: posts small blind $0.10
4oA316mXLIui1QY63GXBUg: posts big blind $0.25
*** HOLE CARDS ***
DIBbjEYGs+TVdVgEB/4+3w: folds 
GftT+l+xjKzcY0rMiNZfPg: raises $0.50 to $0.75
PskTLlFIRHSp61inskRzVg: calls $0.75
7wo6Sr7QG3Zo6BaBDV1BOw: folds 
Lro4e37x4FUa5P3yzDjskw: folds 
STkR8XvpjNv79OOMhrlh2w: folds 
QEbIGci+itdw+re8RM5fZA: folds 
4oA316mXLIui1QY63GXBUg: calls $0.50
*** FLOP *** [8s 5d Ad]
4oA316mXLIui1QY63GXBUg: checks 
GftT+l+xjKzcY0rMiNZfPg: bets $0.75
PskTLlFIRHSp61inskRzVg: folds 
4oA316mXLIui1QY63GXBUg: folds 
Uncalled bet ($0.75) returned to GftT+l+xjKzcY0rMiNZfPg
GftT+l+xjKzcY0rMiNZfPg collected $2.25 from pot
GftT+l+xjKzcY0rMiNZfPg: shows [Kc Kd] (a pair of Kings)
*** SUMMARY ***
Total pot $2.35 | Rake $0.10 
Board [8s 5d Ad]
Seat 2: QEbIGci+itdw+re8RM5fZA (small blind) folded before Flop
Seat 3: 4oA316mXLIui1QY63GXBUg (big blind) folded on the Flop
Seat 4: DIBbjEYGs+TVdVgEB/4+3w folded before Flop (didn't bet)
Seat 5: GftT+l+xjKzcY0rMiNZfPg collected ($2.25)
Seat 6: PskTLlFIRHSp61inskRzVg folded on the Flop
Seat 7: 7wo6Sr7QG3Zo6BaBDV1BOw folded before Flop (didn't bet)
Seat 8: Lro4e37x4FUa5P3yzDjskw folded before Flop (didn't bet)
Seat 9: STkR8XvpjNv79OOMhrlh2w (button) folded before Flop (didn't bet)




PokerStars Game #59939371738:  Hold'em No Limit ($0.10/$0.25) - 2009/07/01 0:38:10 ET
Table 'I0ZcuiUTeLuGYv26Nah7YA' 9-max Seat #7 is the button
Seat 1: iMiqaPr7dx84UF0wNUeh8A ($20.55 in chips) 
Seat 2: zE0IkNrJoJD964o4eqmCxQ ($6.05 in chips) 
Seat 3: 1S/fpm+f42V/6MNZre+ccg ($27.95 in chips) 
Seat 4: 4awUyiDYTgylQKXZ9faBVA ($30.25 in chips) 
Seat 5: opOCI2p6kW0tINuVaAqmcQ ($45 in chips) 
Seat 7: JxpnpCmvRAcrEUy7mq1iAg ($5.30 in chips) 
Seat 9: 2mQl0jr5DPlr6jqhvCq8Xw ($3.95 in chips) 
2mQl0jr5DPlr6jqhvCq8Xw: posts small blind $0.10
iMiqaPr7dx84UF0wNUeh8A: posts big blind $0.25
*** HOLE CARDS ***
JRV2PblFtPFz51l0Fwyz8g joins the table at seat #6 
zE0IkNrJoJD964o4eqmCxQ: folds 
1S/fpm+f42V/6MNZre+ccg: folds 
4awUyiDYTgylQKXZ9faBVA: folds 
opOCI2p6kW0tINuVaAqmcQ: folds 
JxpnpCmvRAcrEUy7mq1iAg: raises $0.50 to $0.75
2mQl0jr5DPlr6jqhvCq8Xw: folds 
ijc1q+bpPQR12wxc0sWc4w joins the table at seat #8 
iMiqaPr7dx84UF0wNUeh8A: calls $0.50
*** FLOP *** [8d 5c Qh]
iMiqaPr7dx84UF0wNUeh8A: checks 
JxpnpCmvRAcrEUy7mq1iAg: checks 
*** TURN *** [8d 5c Qh] [2s]
iMiqaPr7dx84UF0wNUeh8A: checks 
JxpnpCmvRAcrEUy7mq1iAg: checks 
*** RIVER *** [8d 5c Qh 2s] [4h]
iMiqaPr7dx84UF0wNUeh8A: checks 
JxpnpCmvRAcrEUy7mq1iAg: checks 
*** SHOW DOWN ***
iMiqaPr7dx84UF0wNUeh8A: shows [Ac 2c] (a pair of Deuces)
JxpnpCmvRAcrEUy7mq1iAg: shows [3c 3s] (a pair of Threes)
JxpnpCmvRAcrEUy7mq1iAg collected $1.55 from pot
*** SUMMARY ***
Total pot $1.60 | Rake $0.05 
Board [8d 5c Qh 2s 4h]
Seat 1: iMiqaPr7dx84UF0wNUeh8A (big blind) showed [Ac 2c] and lost with a pair of Deuces
Seat 2: zE0IkNrJoJD964o4eqmCxQ folded before Flop (didn't bet)
Seat 3: 1S/fpm+f42V/6MNZre+ccg folded before Flop (didn't bet)
Seat 4: 4awUyiDYTgylQKXZ9faBVA folded before Flop (didn't bet)
Seat 5: opOCI2p6kW0tINuVaAqmcQ folded before Flop (didn't bet)
Seat 7: JxpnpCmvRAcrEUy7mq1iAg (button) showed [3c 3s] and won ($1.55) with a pair of Threes
Seat 9: 2mQl0jr5DPlr6jqhvCq8Xw (small blind) folded before Flop




PokerStars Game #59939371836:  Hold'em No Limit ($0.10/$0.25) - 2009/07/01 0:38:10 ET
Table 'IUwZ/e0bDHZPgsIWx0RnNg' 6-max Seat #4 is the button
Seat 2: mvFHK3pE7tCxJEqLjKC70Q ($24.65 in chips) 
Seat 3: dOX4wnYV2sEqvDbF+8KSCw ($29.55 in chips) 
Seat 4: IyZ9SVxKy7TJvRGFneWTMg ($27.75 in chips) 
Seat 5: wsP46AGpqDjHZQmlRHKa9g ($26.35 in chips) 
Seat 6: NhUN/JpAprdJeamFBgJH1w ($25 in chips) 
wsP46AGpqDjHZQmlRHKa9g: posts small blind $0.10
NhUN/JpAprdJeamFBgJH1w: posts big blind $0.25
*** HOLE CARDS ***
mvFHK3pE7tCxJEqLjKC70Q: folds 
e/sRoTSNz0xhPew+OAQGIg said, "jjust not broke"
dOX4wnYV2sEqvDbF+8KSCw: raises $0.75 to $1
e/sRoTSNz0xhPew+OAQGIg leaves the table
IyZ9SVxKy7TJvRGFneWTMg: folds 
wsP46AGpqDjHZQmlRHKa9g: folds 
NhUN/JpAprdJeamFBgJH1w: folds 
Uncalled bet ($0.75) returned to dOX4wnYV2sEqvDbF+8KSCw
dOX4wnYV2sEqvDbF+8KSCw collected $0.60 from pot
dOX4wnYV2sEqvDbF+8KSCw: doesn't show hand 
IyZ9SVxKy7TJvRGFneWTMg said, "ya okay"
*** SUMMARY ***
Total pot $0.60 | Rake $0 
Seat 2: mvFHK3pE7tCxJEqLjKC70Q folded before Flop (didn't bet)
Seat 3: dOX4wnYV2sEqvDbF+8KSCw collected ($0.60)
Seat 4: IyZ9SVxKy7TJvRGFneWTMg (button) folded before Flop (didn't bet)
Seat 5: wsP46AGpqDjHZQmlRHKa9g (small blind) folded before Flop
Seat 6: NhUN/JpAprdJeamFBgJH1w (big blind) folded before Flop




PokerStars Game #59939371902:  Hold'em No Limit ($0.10/$0.25) - 2009/07/01 0:38:10 ET
Table '/JJyyIstHfkT7t/bW+WXgg' 6-max Seat #2 is the button
Seat 1: wsP46AGpqDjHZQmlRHKa9g ($26.15 in chips) 
Seat 2: eRDLpytVTPI4rY3iortMSw ($11.25 in chips) 
Seat 3: oc4ZGs0W+3RIg2yPyJw3ig ($26.10 in chips) 
Seat 4: ELW+DKizJhLK7k40PMkD2Q ($24.75 in chips) 
Seat 6: d338A2rm6NtA1ECEZi4d2g ($16.50 in chips) 
oc4ZGs0W+3RIg2yPyJw3ig: posts small blind $0.10
ELW+DKizJhLK7k40PMkD2Q: posts big blind $0.25
2wkoolB4YxxVC2x99F9rcA: sits out 
*** HOLE CARDS ***
d338A2rm6NtA1ECEZi4d2g: folds 
wsP46AGpqDjHZQmlRHKa9g: folds 
eRDLpytVTPI4rY3iortMSw: calls $0.25
oc4ZGs0W+3RIg2yPyJw3ig: calls $0.15
ELW+DKizJhLK7k40PMkD2Q: raises $0.75 to $1
eRDLpytVTPI4rY3iortMSw: calls $0.75
oc4ZGs0W+3RIg2yPyJw3ig: folds 
*** FLOP *** [8c Kh 5s]
ELW+DKizJhLK7k40PMkD2Q: bets $1.50
eRDLpytVTPI4rY3iortMSw: folds 
Uncalled bet ($1.50) returned to ELW+DKizJhLK7k40PMkD2Q
ELW+DKizJhLK7k40PMkD2Q collected $2.15 from pot
*** SUMMARY ***
Total pot $2.25 | Rake $0.10 
Board [8c Kh 5s]
Seat 1: wsP46AGpqDjHZQmlRHKa9g folded before Flop (didn't bet)
Seat 2: eRDLpytVTPI4rY3iortMSw (button) folded on the Flop
Seat 3: oc4ZGs0W+3RIg2yPyJw3ig (small blind) folded before Flop
Seat 4: ELW+DKizJhLK7k40PMkD2Q (big blind) collected ($2.15)
Seat 6: d338A2rm6NtA1ECEZi4d2g folded before Flop (didn't bet)




PokerStars Game #59939372384:  Hold'em No Limit ($0.10/$0.25) - 2009/07/01 0:38:11 ET
Table 'MRfAiS/4JSfnUDlCcZo0wAhfHe8uKeSJMyWAjSdM7ROQx Seat #3 is the button
Seat 1: 32YL2ZEp8NT4JB2RVM9euQ ($34.45 in chips) 
Seat 2: /gJNBeCkWL4o85/jvlZ4BA ($37.35 in chips) 
Seat 3: FYepjhAvF8ZdVCmqHIy+eQ ($49 in chips) 
Seat 5: qccGLncfUaN00Few5HsgYg ($28.35 in chips) 
Seat 6: VaDPspfGS2lnEkaGNrNqfg ($10 in chips) 
Go8clNIDGP3feVvzBDG4pg will be allowed to play after the button
qccGLncfUaN00Few5HsgYg: posts small blind $0.10
VaDPspfGS2lnEkaGNrNqfg: posts big blind $0.25
*** HOLE CARDS ***
32YL2ZEp8NT4JB2RVM9euQ: folds 
/gJNBeCkWL4o85/jvlZ4BA: folds 
FYepjhAvF8ZdVCmqHIy+eQ: folds 
qccGLncfUaN00Few5HsgYg: folds 
Uncalled bet ($0.15) returned to VaDPspfGS2lnEkaGNrNqfg
VaDPspfGS2lnEkaGNrNqfg collected $0.20 from pot
*** SUMMARY ***
Total pot $0.20 | Rake $0 
Seat 1: 32YL2ZEp8NT4JB2RVM9euQ folded before Flop (didn't bet)
Seat 2: /gJNBeCkWL4o85/jvlZ4BA folded before Flop (didn't bet)
Seat 3: FYepjhAvF8ZdVCmqHIy+eQ (button) folded before Flop (didn't bet)
Seat 5: qccGLncfUaN00Few5HsgYg (small blind) folded before Flop
Seat 6: VaDPspfGS2lnEkaGNrNqfg (big blind) collected ($0.20)




PokerStars Game #59939372640:  Hold'em No Limit ($0.10/$0.25) - 2009/07/01 0:38:11 ET
Table 'gZetDqJh6q9A3mLO3ThCsAnc6OeGk/wtaWV+6N+kgnZQSeat #1 is the button
Seat 1: 1YCU970EVCcjs4GQP5Zt0g ($19.40 in chips) 
Seat 3: wKFJ513ucluNNiMlkXcDOQ ($32.20 in chips) 
Seat 4: eHsmIvAb2JREg4O6hNPnXg ($9.30 in chips) 
Seat 5: mfrkWA3PTeYPkbO6hi98Aw ($43.40 in chips) 
Seat 6: R1hR3/XSBdOHwcbSUJRJbg ($26.55 in chips) 
wKFJ513ucluNNiMlkXcDOQ: posts small blind $0.10
eHsmIvAb2JREg4O6hNPnXg: posts big blind $0.25
*** HOLE CARDS ***
mfrkWA3PTeYPkbO6hi98Aw: folds 
R1hR3/XSBdOHwcbSUJRJbg: folds 
1YCU970EVCcjs4GQP5Zt0g: folds 
wKFJ513ucluNNiMlkXcDOQ: folds 
Uncalled bet ($0.15) returned to eHsmIvAb2JREg4O6hNPnXg
eHsmIvAb2JREg4O6hNPnXg collected $0.20 from pot
eHsmIvAb2JREg4O6hNPnXg: doesn't show hand 
*** SUMMARY ***
Total pot $0.20 | Rake $0 
Seat 1: 1YCU970EVCcjs4GQP5Zt0g (button) folded before Flop (didn't bet)
Seat 3: wKFJ513ucluNNiMlkXcDOQ (small blind) folded before Flop
Seat 4: eHsmIvAb2JREg4O6hNPnXg (big blind) collected ($0.20)
Seat 5: mfrkWA3PTeYPkbO6hi98Aw folded before Flop (didn't bet)
Seat 6: R1hR3/XSBdOHwcbSUJRJbg folded before Flop (didn't bet)




PokerStars Game #59939372756:  Hold'em No Limit ($0.10/$0.25) - 2009/07/01 0:38:11 ET
Table 'GxdLtCpYxqT4aAbYqkEEpw' 6-max Seat #2 is the button
Seat 1: heEf/FkFGS9M1NmwH97YIA ($41.60 in chips) 
Seat 2: hADMNbkECXMb2C/C8R2Wlw ($22.80 in chips) 
Seat 3: 9jSiy0meE9XJKkdIZwyTEQ ($33.65 in chips) 
Seat 4: ErIN0JRL5srYjT6en1f8YQ ($24.55 in chips) 
Seat 5: q6WfTUAD9mowIP63ASq2Dg ($41.10 in chips) 
Seat 6: aogAb4Eienxztk8p2v9VVw ($26.75 in chips) 
9jSiy0meE9XJKkdIZwyTEQ: posts small blind $0.10
ErIN0JRL5srYjT6en1f8YQ: posts big blind $0.25
*** HOLE CARDS ***
q6WfTUAD9mowIP63ASq2Dg: folds 
aogAb4Eienxztk8p2v9VVw: folds 
heEf/FkFGS9M1NmwH97YIA: folds 
hADMNbkECXMb2C/C8R2Wlw: raises $0.55 to $0.80
9jSiy0meE9XJKkdIZwyTEQ: folds 
ErIN0JRL5srYjT6en1f8YQ: folds 
Uncalled bet ($0.55) returned to hADMNbkECXMb2C/C8R2Wlw
hADMNbkECXMb2C/C8R2Wlw collected $0.60 from pot
hADMNbkECXMb2C/C8R2Wlw: doesn't show hand 
*** SUMMARY ***
Total pot $0.60 | Rake $0 
Seat 1: heEf/FkFGS9M1NmwH97YIA folded before Flop (didn't bet)
Seat 2: hADMNbkECXMb2C/C8R2Wlw (button) collected ($0.60)
Seat 3: 9jSiy0meE9XJKkdIZwyTEQ (small blind) folded before Flop
Seat 4: ErIN0JRL5srYjT6en1f8YQ (big blind) folded before Flop
Seat 5: q6WfTUAD9mowIP63ASq2Dg folded before Flop (didn't bet)
Seat 6: aogAb4Eienxztk8p2v9VVw folded before Flop (didn't bet)




PokerStars Game #59939372606:  Hold'em No Limit ($0.10/$0.25) - 2009/07/01 0:38:11 ET
Table 'Loy/olZ5qoDOSvX4UTujGg' 6-max Seat #4 is the button
Seat 1: yzFNNFIfC89bBPwpFPx2ow ($28.85 in chips) 
Seat 2: MkNgTuvyxpHXkeIm5JITHQ ($12.50 in chips) 
Seat 3: 32YL2ZEp8NT4JB2RVM9euQ ($15.65 in chips) 
Seat 4: /gJNBeCkWL4o85/jvlZ4BA ($27.10 in chips) 
Seat 5: 4YSTu0Cdzpppe1lUgCZGCQ ($35.25 in chips) 
Seat 6: 7FmwVDcdEtxDpHmP4hOXsQ ($53.05 in chips) 
4YSTu0Cdzpppe1lUgCZGCQ: posts small blind $0.10
7FmwVDcdEtxDpHmP4hOXsQ: posts big blind $0.25
*** HOLE CARDS ***
yzFNNFIfC89bBPwpFPx2ow: folds 
MkNgTuvyxpHXkeIm5JITHQ: raises $0.75 to $1
32YL2ZEp8NT4JB2RVM9euQ: folds 
/gJNBeCkWL4o85/jvlZ4BA: folds 
4YSTu0Cdzpppe1lUgCZGCQ: folds 
7FmwVDcdEtxDpHmP4hOXsQ: folds 
Uncalled bet ($0.75) returned to MkNgTuvyxpHXkeIm5JITHQ
MkNgTuvyxpHXkeIm5JITHQ collected $0.60 from pot
MkNgTuvyxpHXkeIm5JITHQ: doesn't show hand 
*** SUMMARY ***
Total pot $0.60 | Rake $0 
Seat 1: yzFNNFIfC89bBPwpFPx2ow folded before Flop (didn't bet)
Seat 2: MkNgTuvyxpHXkeIm5JITHQ collected ($0.60)
Seat 3: 32YL2ZEp8NT4JB2RVM9euQ folded before Flop (didn't bet)
Seat 4: /gJNBeCkWL4o85/jvlZ4BA (button) folded before Flop (didn't bet)
Seat 5: 4YSTu0Cdzpppe1lUgCZGCQ (small blind) folded before Flop
Seat 6: 7FmwVDcdEtxDpHmP4hOXsQ (big blind) folded before Flop




PokerStars Game #59939372912:  Hold'em No Limit ($0.10/$0.25) - 2009/07/01 0:38:11 ET
Table 'n8mNkPYbe1AIQEkioNesZA' 9-max Seat #3 is the button
Seat 1: /VQLorsEOrMfI+KamzNQEA ($2.40 in chips) 
Seat 2: QEbIGci+itdw+re8RM5fZA ($35 in chips) 
Seat 3: zDrucyjVn5aeekNEc3cJrA ($19.70 in chips) 
Seat 4: ZeR3hkj1gVv9J4yPCmRrjA ($27.95 in chips) 
Seat 5: j5kXXioAn7mKbcDKt4UzMw ($14.25 in chips) 
Seat 6: HPEB+AtKw1+C/cxU0o1ciw ($38.55 in chips) 
Seat 7: BrlfhE2AlcawLAz+eF5BDg ($5.10 in chips) 
Seat 8: N6fYvIzQLKaydFLKQGtMlQ ($27.40 in chips) 
Seat 9: gehe91e0IyVT0QU/XBkEyg ($30.90 in chips) 
ZeR3hkj1gVv9J4yPCmRrjA: posts small blind $0.10
j5kXXioAn7mKbcDKt4UzMw: posts big blind $0.25
*** HOLE CARDS ***
HPEB+AtKw1+C/cxU0o1ciw: folds 
BrlfhE2AlcawLAz+eF5BDg: folds 
N6fYvIzQLKaydFLKQGtMlQ: folds 
gehe91e0IyVT0QU/XBkEyg: raises $0.75 to $1
/VQLorsEOrMfI+KamzNQEA: folds 
QEbIGci+itdw+re8RM5fZA: folds 
zDrucyjVn5aeekNEc3cJrA: folds 
ZeR3hkj1gVv9J4yPCmRrjA: folds 
j5kXXioAn7mKbcDKt4UzMw: folds 
Uncalled bet ($0.75) returned to gehe91e0IyVT0QU/XBkEyg
gehe91e0IyVT0QU/XBkEyg collected $0.60 from pot
*** SUMMARY ***
Total pot $0.60 | Rake $0 
Seat 1: /VQLorsEOrMfI+KamzNQEA folded before Flop (didn't bet)
Seat 2: QEbIGci+itdw+re8RM5fZA folded before Flop (didn't bet)
Seat 3: zDrucyjVn5aeekNEc3cJrA (button) folded before Flop (didn't bet)
Seat 4: ZeR3hkj1gVv9J4yPCmRrjA (small blind) folded before Flop
Seat 5: j5kXXioAn7mKbcDKt4UzMw (big blind) folded before Flop
Seat 6: HPEB+AtKw1+C/cxU0o1ciw folded before Flop (didn't bet)
Seat 7: BrlfhE2AlcawLAz+eF5BDg folded before Flop (didn't bet)
Seat 8: N6fYvIzQLKaydFLKQGtMlQ folded before Flop (didn't bet)
Seat 9: gehe91e0IyVT0QU/XBkEyg collected ($0.60)




PokerStars Game #59939372776:  Hold'em No Limit ($0.10/$0.25) - 2009/07/01 0:38:11 ET
Table '1zj0+miaIL9cvwnT/50pOA' 9-max Seat #8 is the button
Seat 1: spidnpwmoJ1L6yeNW7D5UA ($27.10 in chips) 
Seat 2: HPEB+AtKw1+C/cxU0o1ciw ($28.45 in chips) 
Seat 3: CYkY0dNBaYaKs8HVCVn3mQ ($5.85 in chips) 
Seat 4: 6esz1u5YivjsX0UoeMBm3w ($17.90 in chips) 
Seat 5: JxpnpCmvRAcrEUy7mq1iAg ($5.70 in chips) 
Seat 6: ydoFOVgzvZv9ZhuWu9rXAw ($4.80 in chips) 
Seat 7: 6oWOdVz2WG2azNuOj9rMgg ($16.45 in chips) 
Seat 8: HOiu48bZMhEZSoJa8mjiMw ($35.55 in chips) 
Seat 9: OiV1PWZ3IkN29JlmCcnTwQ ($5.35 in chips) 
OiV1PWZ3IkN29JlmCcnTwQ: posts small blind $0.10
spidnpwmoJ1L6yeNW7D5UA: posts big blind $0.25
*** HOLE CARDS ***
HPEB+AtKw1+C/cxU0o1ciw: folds 
CYkY0dNBaYaKs8HVCVn3mQ: folds 
6esz1u5YivjsX0UoeMBm3w: raises $0.50 to $0.75
JxpnpCmvRAcrEUy7mq1iAg: folds 
ydoFOVgzvZv9ZhuWu9rXAw: folds 
6oWOdVz2WG2azNuOj9rMgg: folds 
HOiu48bZMhEZSoJa8mjiMw: calls $0.75
OiV1PWZ3IkN29JlmCcnTwQ: folds 
spidnpwmoJ1L6yeNW7D5UA: calls $0.50
*** FLOP *** [Ah 2d Qh]
spidnpwmoJ1L6yeNW7D5UA: checks 
6esz1u5YivjsX0UoeMBm3w: bets $0.75
HOiu48bZMhEZSoJa8mjiMw: calls $0.75
spidnpwmoJ1L6yeNW7D5UA: calls $0.75
*** TURN *** [Ah 2d Qh] [Ks]
spidnpwmoJ1L6yeNW7D5UA: checks 
6esz1u5YivjsX0UoeMBm3w: bets $1.50
HOiu48bZMhEZSoJa8mjiMw: calls $1.50
spidnpwmoJ1L6yeNW7D5UA: folds 
*** RIVER *** [Ah 2d Qh Ks] [Jc]
6esz1u5YivjsX0UoeMBm3w: bets $4.25
HOiu48bZMhEZSoJa8mjiMw: folds 
Uncalled bet ($4.25) returned to 6esz1u5YivjsX0UoeMBm3w
6esz1u5YivjsX0UoeMBm3w collected $7.25 from pot
6esz1u5YivjsX0UoeMBm3w: doesn't show hand 
*** SUMMARY ***
Total pot $7.60 | Rake $0.35 
Board [Ah 2d Qh Ks Jc]
Seat 1: spidnpwmoJ1L6yeNW7D5UA (big blind) folded on the Turn
Seat 2: HPEB+AtKw1+C/cxU0o1ciw folded before Flop (didn't bet)
Seat 3: CYkY0dNBaYaKs8HVCVn3mQ folded before Flop (didn't bet)
Seat 4: 6esz1u5YivjsX0UoeMBm3w collected ($7.25)
Seat 5: JxpnpCmvRAcrEUy7mq1iAg folded before Flop (didn't bet)
Seat 6: ydoFOVgzvZv9ZhuWu9rXAw folded before Flop (didn't bet)
Seat 7: 6oWOdVz2WG2azNuOj9rMgg folded before Flop (didn't bet)
Seat 8: HOiu48bZMhEZSoJa8mjiMw (button) folded on the River
Seat 9: OiV1PWZ3IkN29JlmCcnTwQ (small blind) folded before Flop




PokerStars Game #59939373460:  Hold'em No Limit ($0.10/$0.25) - 2009/07/01 0:38:12 ET
Table 'rtxA1Y01Nrq5VoyzTAuusQ' 9-max Seat #3 is the button
Seat 1: wfJUJWKI2zkvL7Vp7kqggA ($10 in chips) 
Seat 2: xtpoxBFB+5CWL2iFqk9Zlg ($35.10 in chips) 
Seat 3: K9fS1IUr5GpiJG7VkJ7IbA ($10.40 in chips) 
Seat 4: JxpnpCmvRAcrEUy7mq1iAg ($5 in chips) 
Seat 5: HG/hVrkvCiG0erBa6RyLZA ($15.75 in chips) 
Seat 6: qccGLncfUaN00Few5HsgYg ($24.65 in chips) 
Seat 7: N6fYvIzQLKaydFLKQGtMlQ ($24.30 in chips) 
Seat 8: EUSBQy2KGzT65/CXiIu59Q ($40.40 in chips) 
Seat 9: HPEB+AtKw1+C/cxU0o1ciw ($24.60 in chips) 
JxpnpCmvRAcrEUy7mq1iAg: posts small blind $0.10
HG/hVrkvCiG0erBa6RyLZA: posts big blind $0.25
*** HOLE CARDS ***
qccGLncfUaN00Few5HsgYg: folds 
N6fYvIzQLKaydFLKQGtMlQ: folds 
EUSBQy2KGzT65/CXiIu59Q: folds 
HPEB+AtKw1+C/cxU0o1ciw: folds 
wfJUJWKI2zkvL7Vp7kqggA: folds 
xtpoxBFB+5CWL2iFqk9Zlg: folds 
K9fS1IUr5GpiJG7VkJ7IbA: raises $0.25 to $0.50
JxpnpCmvRAcrEUy7mq1iAg: folds 
HG/hVrkvCiG0erBa6RyLZA: calls $0.25
*** FLOP *** [9s 4d 3c]
HG/hVrkvCiG0erBa6RyLZA: bets $0.75
K9fS1IUr5GpiJG7VkJ7IbA: calls $0.75
*** TURN *** [9s 4d 3c] [2d]
HG/hVrkvCiG0erBa6RyLZA: bets $0.75
K9fS1IUr5GpiJG7VkJ7IbA: calls $0.75
*** RIVER *** [9s 4d 3c 2d] [Th]
HG/hVrkvCiG0erBa6RyLZA: checks 
K9fS1IUr5GpiJG7VkJ7IbA: bets $1.25
HG/hVrkvCiG0erBa6RyLZA: folds 
Uncalled bet ($1.25) returned to K9fS1IUr5GpiJG7VkJ7IbA
K9fS1IUr5GpiJG7VkJ7IbA collected $3.90 from pot
*** SUMMARY ***
Total pot $4.10 | Rake $0.20 
Board [9s 4d 3c 2d Th]
Seat 1: wfJUJWKI2zkvL7Vp7kqggA folded before Flop (didn't bet)
Seat 2: xtpoxBFB+5CWL2iFqk9Zlg folded before Flop (didn't bet)
Seat 3: K9fS1IUr5GpiJG7VkJ7IbA (button) collected ($3.90)
Seat 4: JxpnpCmvRAcrEUy7mq1iAg (small blind) folded before Flop
Seat 5: HG/hVrkvCiG0erBa6RyLZA (big blind) folded on the River
Seat 6: qccGLncfUaN00Few5HsgYg folded before Flop (didn't bet)
Seat 7: N6fYvIzQLKaydFLKQGtMlQ folded before Flop (didn't bet)
Seat 8: EUSBQy2KGzT65/CXiIu59Q folded before Flop (didn't bet)
Seat 9: HPEB+AtKw1+C/cxU0o1ciw folded before Flop (didn't bet)




PokerStars Game #59939373224:  Hold'em No Limit ($0.10/$0.25) - 2009/07/01 0:38:12 ET
Table 'C8mMnVmvkagwolEzTvh07A' 9-max Seat #5 is the button
Seat 1: t2nb95S5EEFOEzNx9Itz0g ($6.35 in chips) 
Seat 2: CbXUS6Z2rXZxL1AKduNtmQ ($26.05 in chips) 
Seat 3: Th3FldXKQW6hWVVPahaoOQ ($25.35 in chips) 
Seat 4: dfNim92Z6XK1/h5SFW5vDg ($25 in chips) 
Seat 5: iGMlK+EhUflPB6jKQd95Cg ($25 in chips) 
Seat 6: QBNV6v6f+1ZHoaKcQDTWog ($28.35 in chips) 
Seat 8: N6fYvIzQLKaydFLKQGtMlQ ($22.90 in chips) 
Seat 9: 4awUyiDYTgylQKXZ9faBVA ($27.35 in chips) 
QBNV6v6f+1ZHoaKcQDTWog: posts small blind $0.10
N6fYvIzQLKaydFLKQGtMlQ: posts big blind $0.25
*** HOLE CARDS ***
4awUyiDYTgylQKXZ9faBVA: folds 
t2nb95S5EEFOEzNx9Itz0g: calls $0.25
CbXUS6Z2rXZxL1AKduNtmQ: raises $0.75 to $1
Th3FldXKQW6hWVVPahaoOQ: folds 
dfNim92Z6XK1/h5SFW5vDg: folds 
iGMlK+EhUflPB6jKQd95Cg: calls $1
QBNV6v6f+1ZHoaKcQDTWog: calls $0.90
N6fYvIzQLKaydFLKQGtMlQ: folds 
t2nb95S5EEFOEzNx9Itz0g: calls $0.75
*** FLOP *** [Th Jc 2s]
QBNV6v6f+1ZHoaKcQDTWog: checks 
t2nb95S5EEFOEzNx9Itz0g: checks 
CbXUS6Z2rXZxL1AKduNtmQ: bets $4
iGMlK+EhUflPB6jKQd95Cg: folds 
QBNV6v6f+1ZHoaKcQDTWog: folds 
t2nb95S5EEFOEzNx9Itz0g: folds 
Uncalled bet ($4) returned to CbXUS6Z2rXZxL1AKduNtmQ
CbXUS6Z2rXZxL1AKduNtmQ collected $4.05 from pot
*** SUMMARY ***
Total pot $4.25 | Rake $0.20 
Board [Th Jc 2s]
Seat 1: t2nb95S5EEFOEzNx9Itz0g folded on the Flop
Seat 2: CbXUS6Z2rXZxL1AKduNtmQ collected ($4.05)
Seat 3: Th3FldXKQW6hWVVPahaoOQ folded before Flop (didn't bet)
Seat 4: dfNim92Z6XK1/h5SFW5vDg folded before Flop (didn't bet)
Seat 5: iGMlK+EhUflPB6jKQd95Cg (button) folded on the Flop
Seat 6: QBNV6v6f+1ZHoaKcQDTWog (small blind) folded on the Flop
Seat 8: N6fYvIzQLKaydFLKQGtMlQ (big blind) folded before Flop
Seat 9: 4awUyiDYTgylQKXZ9faBVA folded before Flop (didn't bet)




PokerStars Game #59939373542:  Hold'em No Limit ($0.10/$0.25) - 2009/07/01 0:38:12 ET
Table 'JJzUs04lHpXg6nboT1/jeg' 6-max Seat #2 is the button
Seat 2: ymz+a8dgHSUFPooYplw7Ow ($32.90 in chips) 
Seat 4: nwwpaieDRI0UPyVtChVHOg ($36.80 in chips) 
Seat 5: Vr2XE7yYBdg3RZSURDAPEg ($24.90 in chips) 
Seat 6: qlSMvybgHy3Sa2mdf7Mw/A ($15.10 in chips) 
nwwpaieDRI0UPyVtChVHOg: posts small blind $0.10
Vr2XE7yYBdg3RZSURDAPEg: posts big blind $0.25
*** HOLE CARDS ***
qlSMvybgHy3Sa2mdf7Mw/A: calls $0.25
ymz+a8dgHSUFPooYplw7Ow: folds 
nwwpaieDRI0UPyVtChVHOg: calls $0.15
Vr2XE7yYBdg3RZSURDAPEg: raises $0.50 to $0.75
qlSMvybgHy3Sa2mdf7Mw/A: calls $0.50
nwwpaieDRI0UPyVtChVHOg: folds 
*** FLOP *** [Jh 3h 5h]
ymz+a8dgHSUFPooYplw7Ow leaves the table
Vr2XE7yYBdg3RZSURDAPEg: checks 
qlSMvybgHy3Sa2mdf7Mw/A: bets $0.25
Vr2XE7yYBdg3RZSURDAPEg: folds 
Uncalled bet ($0.25) returned to qlSMvybgHy3Sa2mdf7Mw/A
qlSMvybgHy3Sa2mdf7Mw/A collected $1.70 from pot
*** SUMMARY ***
Total pot $1.75 | Rake $0.05 
Board [Jh 3h 5h]
Seat 2: ymz+a8dgHSUFPooYplw7Ow (button) folded before Flop (didn't bet)
Seat 4: nwwpaieDRI0UPyVtChVHOg (small blind) folded before Flop
Seat 5: Vr2XE7yYBdg3RZSURDAPEg (big blind) folded on the Flop
Seat 6: qlSMvybgHy3Sa2mdf7Mw/A collected ($1.70)




PokerStars Game #59939373094:  Hold'em No Limit ($0.10/$0.25) - 2009/07/01 0:38:12 ET
Table 'rhQuIjJo0UQ7RRUlF9umHg' 6-max Seat #3 is the button
Seat 1: 5O3Hj9Qg0SqOyKEXoLpjPg ($32.55 in chips) 
Seat 2: Ew/TYPQIsbQ2X8nm5iAJBg ($24.30 in chips) 
Seat 3: nLE5Yo60EmSlJPyg0GgxXg ($20.75 in chips) 
Seat 4: buyjetgNT1McXtdaP4zynA ($23.50 in chips) 
Seat 5: 7qRk4YH4/k/08LgJSv7rBQ ($25 in chips) 
Seat 6: r284m4NA4rtNktI86R8/Yw ($11.55 in chips) 
buyjetgNT1McXtdaP4zynA: posts small blind $0.10
7qRk4YH4/k/08LgJSv7rBQ: posts big blind $0.25
*** HOLE CARDS ***
r284m4NA4rtNktI86R8/Yw: calls $0.25
5O3Hj9Qg0SqOyKEXoLpjPg: calls $0.25
Ew/TYPQIsbQ2X8nm5iAJBg: calls $0.25
nLE5Yo60EmSlJPyg0GgxXg: raises $1.25 to $1.50
buyjetgNT1McXtdaP4zynA: folds 
7qRk4YH4/k/08LgJSv7rBQ: folds 
r284m4NA4rtNktI86R8/Yw: folds 
5O3Hj9Qg0SqOyKEXoLpjPg: calls $1.25
Ew/TYPQIsbQ2X8nm5iAJBg: calls $1.25
*** FLOP *** [2h 4h Qh]
5O3Hj9Qg0SqOyKEXoLpjPg: checks 
Ew/TYPQIsbQ2X8nm5iAJBg: checks 
nLE5Yo60EmSlJPyg0GgxXg: bets $2.25
5O3Hj9Qg0SqOyKEXoLpjPg: raises $13.50 to $15.75
Ew/TYPQIsbQ2X8nm5iAJBg: raises $7.05 to $22.80 and is all-in
nLE5Yo60EmSlJPyg0GgxXg: folds 
5O3Hj9Qg0SqOyKEXoLpjPg: calls $7.05
*** TURN *** [2h 4h Qh] [2d]
*** RIVER *** [2h 4h Qh 2d] [5h]
*** SHOW DOWN ***
5O3Hj9Qg0SqOyKEXoLpjPg: shows [9h Th] (a flush, Queen high)
Ew/TYPQIsbQ2X8nm5iAJBg: mucks hand 
5O3Hj9Qg0SqOyKEXoLpjPg collected $50.35 from pot
*** SUMMARY ***
Total pot $52.95 | Rake $2.60 
Board [2h 4h Qh 2d 5h]
Seat 1: 5O3Hj9Qg0SqOyKEXoLpjPg showed [9h Th] and won ($50.35) with a flush, Queen high
Seat 2: Ew/TYPQIsbQ2X8nm5iAJBg mucked
Seat 3: nLE5Yo60EmSlJPyg0GgxXg (button) folded on the Flop
Seat 4: buyjetgNT1McXtdaP4zynA (small blind) folded before Flop
Seat 5: 7qRk4YH4/k/08LgJSv7rBQ (big blind) folded before Flop
Seat 6: r284m4NA4rtNktI86R8/Yw folded before Flop




PokerStars Game #59939373302:  Hold'em No Limit ($0.10/$0.25) - 2009/07/01 0:38:12 ET
Table 'FE/j6VqBY4j9Uq+VHURQCQ' 6-max Seat #2 is the button
Seat 1: wKFJ513ucluNNiMlkXcDOQ ($44.10 in chips) 
Seat 2: gh0Jkra5bJ5RFIDWbx9zqA ($12.60 in chips) 
Seat 3: Zijzy/UtPWzWVUo81HHVjQ ($49.85 in chips) 
Seat 4: cPO/1/dTcZpLkQFm3jH3Rg ($25 in chips) 
Seat 5: wsP46AGpqDjHZQmlRHKa9g ($25 in chips) 
Seat 6: kARKwAmU6kWJfiSICTYhVw ($14.35 in chips) 
Zijzy/UtPWzWVUo81HHVjQ: posts small blind $0.10
cPO/1/dTcZpLkQFm3jH3Rg: posts big blind $0.25
*** HOLE CARDS ***
wsP46AGpqDjHZQmlRHKa9g: folds 
kARKwAmU6kWJfiSICTYhVw: folds 
wKFJ513ucluNNiMlkXcDOQ: folds 
gh0Jkra5bJ5RFIDWbx9zqA: folds 
Zijzy/UtPWzWVUo81HHVjQ: folds 
Uncalled bet ($0.15) returned to cPO/1/dTcZpLkQFm3jH3Rg
cPO/1/dTcZpLkQFm3jH3Rg collected $0.20 from pot
*** SUMMARY ***
Total pot $0.20 | Rake $0 
Seat 1: wKFJ513ucluNNiMlkXcDOQ folded before Flop (didn't bet)
Seat 2: gh0Jkra5bJ5RFIDWbx9zqA (button) folded before Flop (didn't bet)
Seat 3: Zijzy/UtPWzWVUo81HHVjQ (small blind) folded before Flop
Seat 4: cPO/1/dTcZpLkQFm3jH3Rg (big blind) collected ($0.20)
Seat 5: wsP46AGpqDjHZQmlRHKa9g folded before Flop (didn't bet)
Seat 6: kARKwAmU6kWJfiSICTYhVw folded before Flop (didn't bet)




PokerStars Game #59939373494:  Hold'em No Limit ($0.10/$0.25) - 2009/07/01 0:38:12 ET
Table '29D3eoQzK5kOAT0OIDS2uQ' 6-max Seat #3 is the button
Seat 1: kG34n23qFQA3nzdOJTQ1dA ($51.65 in chips) 
Seat 2: tbhYGxTClzdFLMcTtjvJhg ($44.45 in chips) 
Seat 3: z3tQwy28dp5FykDJC/wzQw ($19.35 in chips) 
Seat 4: yzFNNFIfC89bBPwpFPx2ow ($27.20 in chips) 
Seat 5: Q3EMN7b0ie81AFWkDrhCjw ($33.60 in chips) 
Seat 6: bWbV4MVB/vVpiES1Ut4hew ($43.95 in chips) 
yzFNNFIfC89bBPwpFPx2ow: posts small blind $0.10
Q3EMN7b0ie81AFWkDrhCjw: posts big blind $0.25
*** HOLE CARDS ***
bWbV4MVB/vVpiES1Ut4hew: folds 
kG34n23qFQA3nzdOJTQ1dA: folds 
tbhYGxTClzdFLMcTtjvJhg: calls $0.25
z3tQwy28dp5FykDJC/wzQw: folds 
yzFNNFIfC89bBPwpFPx2ow: folds 
Q3EMN7b0ie81AFWkDrhCjw: checks 
*** FLOP *** [9s 4h 8d]
Q3EMN7b0ie81AFWkDrhCjw: checks 
tbhYGxTClzdFLMcTtjvJhg: checks 
*** TURN *** [9s 4h 8d] [8h]
Q3EMN7b0ie81AFWkDrhCjw: bets $0.50
tbhYGxTClzdFLMcTtjvJhg: folds 
Uncalled bet ($0.50) returned to Q3EMN7b0ie81AFWkDrhCjw
Q3EMN7b0ie81AFWkDrhCjw collected $0.60 from pot
*** SUMMARY ***
Total pot $0.60 | Rake $0 
Board [9s 4h 8d 8h]
Seat 1: kG34n23qFQA3nzdOJTQ1dA folded before Flop (didn't bet)
Seat 2: tbhYGxTClzdFLMcTtjvJhg folded on the Turn
Seat 3: z3tQwy28dp5FykDJC/wzQw (button) folded before Flop (didn't bet)
Seat 4: yzFNNFIfC89bBPwpFPx2ow (small blind) folded before Flop
Seat 5: Q3EMN7b0ie81AFWkDrhCjw (big blind) collected ($0.60)
Seat 6: bWbV4MVB/vVpiES1Ut4hew folded before Flop (didn't bet)




PokerStars Game #59939373488:  Hold'em No Limit ($0.10/$0.25) - 2009/07/01 0:38:12 ET
Table 'rjcb+nlE+0GuJ6lBhuCkkA' 6-max Seat #2 is the button
Seat 1: 9jSiy0meE9XJKkdIZwyTEQ ($26.05 in chips) 
Seat 2: d9ecz4Yhx6qRKe5k+fUWdw ($18.70 in chips) 
Seat 3: 8ClCHtFXGNplITm+63KB+Q ($24.75 in chips) 
Seat 4: NzIFHwilc5zU7QhjDTgTZA ($14.80 in chips) 
Seat 5: GC/9yVD59DUCX7hUI7gcLw ($43.25 in chips) 
Seat 6: 0DvgWV5o6c/jYqQCjm4Haw ($26.70 in chips) 
8ClCHtFXGNplITm+63KB+Q: posts small blind $0.10
NzIFHwilc5zU7QhjDTgTZA: posts big blind $0.25
*** HOLE CARDS ***
GC/9yVD59DUCX7hUI7gcLw: folds 
0DvgWV5o6c/jYqQCjm4Haw: folds 
9jSiy0meE9XJKkdIZwyTEQ: folds 
d9ecz4Yhx6qRKe5k+fUWdw: raises $0.75 to $1
8ClCHtFXGNplITm+63KB+Q: folds 
NzIFHwilc5zU7QhjDTgTZA: calls $0.75
*** FLOP *** [Qd 7c 5d]
NzIFHwilc5zU7QhjDTgTZA: checks 
d9ecz4Yhx6qRKe5k+fUWdw: checks 
*** TURN *** [Qd 7c 5d] [3s]
NzIFHwilc5zU7QhjDTgTZA: checks 
d9ecz4Yhx6qRKe5k+fUWdw: checks 
*** RIVER *** [Qd 7c 5d 3s] [8d]
NzIFHwilc5zU7QhjDTgTZA: checks 
d9ecz4Yhx6qRKe5k+fUWdw: checks 
*** SHOW DOWN ***
NzIFHwilc5zU7QhjDTgTZA: shows [As 9s] (high card Ace)
d9ecz4Yhx6qRKe5k+fUWdw: shows [7d 6h] (a pair of Sevens)
d9ecz4Yhx6qRKe5k+fUWdw collected $2 from pot
*** SUMMARY ***
Total pot $2.10 | Rake $0.10 
Board [Qd 7c 5d 3s 8d]
Seat 1: 9jSiy0meE9XJKkdIZwyTEQ folded before Flop (didn't bet)
Seat 2: d9ecz4Yhx6qRKe5k+fUWdw (button) showed [7d 6h] and won ($2) with a pair of Sevens
Seat 3: 8ClCHtFXGNplITm+63KB+Q (small blind) folded before Flop
Seat 4: NzIFHwilc5zU7QhjDTgTZA (big blind) showed [As 9s] and lost with high card Ace
Seat 5: GC/9yVD59DUCX7hUI7gcLw folded before Flop (didn't bet)
Seat 6: 0DvgWV5o6c/jYqQCjm4Haw folded before Flop (didn't bet)




PokerStars Game #59939373596:  Hold'em No Limit ($0.10/$0.25) - 2009/07/01 0:38:12 ET
Table 'KEoOIegxPF91KooL2AelUA' 6-max Seat #5 is the button
Seat 1: wsP46AGpqDjHZQmlRHKa9g ($27 in chips) 
Seat 4: Vv37Oa9niKKVcR6Z7ceetw ($22.45 in chips) 
Seat 5: 2NLC44AHHKHEUooUQFYV+Q ($15.65 in chips) 
wsP46AGpqDjHZQmlRHKa9g: posts small blind $0.10
Vv37Oa9niKKVcR6Z7ceetw: posts big blind $0.25
*** HOLE CARDS ***
2NLC44AHHKHEUooUQFYV+Q: calls $0.25
wsP46AGpqDjHZQmlRHKa9g: folds 
Vv37Oa9niKKVcR6Z7ceetw: checks 
*** FLOP *** [Qc 2s Jh]
Vv37Oa9niKKVcR6Z7ceetw: checks 
2NLC44AHHKHEUooUQFYV+Q said, "me too only"
2NLC44AHHKHEUooUQFYV+Q: bets $0.25
Vv37Oa9niKKVcR6Z7ceetw: folds 
Uncalled bet ($0.25) returned to 2NLC44AHHKHEUooUQFYV+Q
2NLC44AHHKHEUooUQFYV+Q collected $0.60 from pot
2NLC44AHHKHEUooUQFYV+Q: doesn't show hand 
*** SUMMARY ***
Total pot $0.60 | Rake $0 
Board [Qc 2s Jh]
Seat 1: wsP46AGpqDjHZQmlRHKa9g (small blind) folded before Flop
Seat 4: Vv37Oa9niKKVcR6Z7ceetw (big blind) folded on the Flop
Seat 5: 2NLC44AHHKHEUooUQFYV+Q (button) collected ($0.60)




PokerStars Game #59939373490:  Hold'em No Limit ($0.10/$0.25) - 2009/07/01 0:38:12 ET
Table 'sJ4KpS2GE5Qrsu1/cFjJUw' 9-max Seat #3 is the button
Seat 1: QsLvCwfSWqP+CfjwUnjpXQ ($15 in chips) 
Seat 3: eDil7UzSZCjyh1VP6SVXJQ ($6.70 in chips) 
Seat 8: f8ixGbSVIs6Be0mH69ldVQ ($14.90 in chips) 
f8ixGbSVIs6Be0mH69ldVQ: posts small blind $0.10
QsLvCwfSWqP+CfjwUnjpXQ: posts big blind $0.25
*** HOLE CARDS ***
eDil7UzSZCjyh1VP6SVXJQ: folds 
f8ixGbSVIs6Be0mH69ldVQ: calls $0.15
QsLvCwfSWqP+CfjwUnjpXQ: checks 
*** FLOP *** [Ac 5d 4s]
f8ixGbSVIs6Be0mH69ldVQ: checks 
QsLvCwfSWqP+CfjwUnjpXQ: checks 
*** TURN *** [Ac 5d 4s] [5h]
f8ixGbSVIs6Be0mH69ldVQ: bets $0.25
QsLvCwfSWqP+CfjwUnjpXQ: calls $0.25
*** RIVER *** [Ac 5d 4s 5h] [As]
f8ixGbSVIs6Be0mH69ldVQ: checks 
QsLvCwfSWqP+CfjwUnjpXQ: checks 
*** SHOW DOWN ***
f8ixGbSVIs6Be0mH69ldVQ: shows [5s 9s] (a full house, Fives full of Aces)
QsLvCwfSWqP+CfjwUnjpXQ: mucks hand 
f8ixGbSVIs6Be0mH69ldVQ collected $0.95 from pot
*** SUMMARY ***
Total pot $1 | Rake $0.05 
Board [Ac 5d 4s 5h As]
Seat 1: QsLvCwfSWqP+CfjwUnjpXQ (big blind) mucked
Seat 3: eDil7UzSZCjyh1VP6SVXJQ (button) folded before Flop (didn't bet)
Seat 8: f8ixGbSVIs6Be0mH69ldVQ (small blind) showed [5s 9s] and won ($0.95) with a full house, Fives full of Aces




PokerStars Game #59939373874:  Hold'em No Limit ($0.10/$0.25) - 2009/07/01 0:38:13 ET
Table '2VkNDXXsBj4bSZw/uK5atw' 6-max Seat #5 is the button
Seat 1: 7FmwVDcdEtxDpHmP4hOXsQ ($26.75 in chips) 
Seat 3: xBOVv8xEXtymVpAA5ZajSw ($38.15 in chips) 
Seat 4: yb6rnd48JuBccThV68VHAQ ($67.40 in chips) 
Seat 5: kyRaCIljYA6l33lSKQfNsg ($20.60 in chips) 
Seat 6: qGHGf/553gQnDoklMRe3tg ($25.75 in chips) 
qGHGf/553gQnDoklMRe3tg: posts small blind $0.10
7FmwVDcdEtxDpHmP4hOXsQ: posts big blind $0.25
*** HOLE CARDS ***
xBOVv8xEXtymVpAA5ZajSw: folds 
yb6rnd48JuBccThV68VHAQ: calls $0.25
kyRaCIljYA6l33lSKQfNsg: folds 
qGHGf/553gQnDoklMRe3tg: folds 
7FmwVDcdEtxDpHmP4hOXsQ: checks 
*** FLOP *** [8d Td 7h]
7FmwVDcdEtxDpHmP4hOXsQ: checks 
yb6rnd48JuBccThV68VHAQ: bets $0.50
7FmwVDcdEtxDpHmP4hOXsQ: folds 
Uncalled bet ($0.50) returned to yb6rnd48JuBccThV68VHAQ
yb6rnd48JuBccThV68VHAQ collected $0.60 from pot
yb6rnd48JuBccThV68VHAQ: doesn't show hand 
*** SUMMARY ***
Total pot $0.60 | Rake $0 
Board [8d Td 7h]
Seat 1: 7FmwVDcdEtxDpHmP4hOXsQ (big blind) folded on the Flop
Seat 3: xBOVv8xEXtymVpAA5ZajSw folded before Flop (didn't bet)
Seat 4: yb6rnd48JuBccThV68VHAQ collected ($0.60)
Seat 5: kyRaCIljYA6l33lSKQfNsg (button) folded before Flop (didn't bet)
Seat 6: qGHGf/553gQnDoklMRe3tg (small blind) folded before Flop




PokerStars Game #59939373904:  Hold'em No Limit ($0.10/$0.25) - 2009/07/01 0:38:13 ET
Table 'AHkg4ChqzcMauBx6Qvz8Nw' 6-max Seat #5 is the button
Seat 2: /bjna2FTN7pPjqYGzmDE0Q ($24.35 in chips) 
Seat 3: PIOdknsVyjKUwfiImc3zwg ($25.90 in chips) 
Seat 4: N7O9jUEx2YiQn1+yRYTHmw ($25.70 in chips) 
Seat 5: LtASJ9OlkqGrrUKGQlpGAw ($34.70 in chips) 
Seat 6: SFmT9ZsVopnukjvAzrxTRg ($53.50 in chips) 
SFmT9ZsVopnukjvAzrxTRg: posts small blind $0.10
/bjna2FTN7pPjqYGzmDE0Q: posts big blind $0.25
*** HOLE CARDS ***
PIOdknsVyjKUwfiImc3zwg: raises $0.75 to $1
N7O9jUEx2YiQn1+yRYTHmw: folds 
LtASJ9OlkqGrrUKGQlpGAw: folds 
SFmT9ZsVopnukjvAzrxTRg: folds 
/bjna2FTN7pPjqYGzmDE0Q: folds 
Uncalled bet ($0.75) returned to PIOdknsVyjKUwfiImc3zwg
PIOdknsVyjKUwfiImc3zwg collected $0.60 from pot
*** SUMMARY ***
Total pot $0.60 | Rake $0 
Seat 2: /bjna2FTN7pPjqYGzmDE0Q (big blind) folded before Flop
Seat 3: PIOdknsVyjKUwfiImc3zwg collected ($0.60)
Seat 4: N7O9jUEx2YiQn1+yRYTHmw folded before Flop (didn't bet)
Seat 5: LtASJ9OlkqGrrUKGQlpGAw (button) folded before Flop (didn't bet)
Seat 6: SFmT9ZsVopnukjvAzrxTRg (small blind) folded before Flop




PokerStars Game #59939374064:  Hold'em No Limit ($0.10/$0.25) - 2009/07/01 0:38:13 ET
Table '63h13e5p7cWe02rClZ1CHw' 6-max Seat #3 is the button
Seat 1: 7VfhiFY533nbUKvyEthASw ($10 in chips) 
Seat 2: k9nHZTHt8hYhYRcW8NTb4g ($14.65 in chips) 
Seat 3: 9jSiy0meE9XJKkdIZwyTEQ ($34.25 in chips) 
Seat 4: myagrRAhs0mdgmh5GNqvCw ($6.20 in chips) 
Seat 5: bE34il0XYGjWPD5/vbkMaQ ($12.25 in chips) 
Seat 6: mfrkWA3PTeYPkbO6hi98Aw ($35.10 in chips) 
myagrRAhs0mdgmh5GNqvCw: posts small blind $0.10
bE34il0XYGjWPD5/vbkMaQ: posts big blind $0.25
*** HOLE CARDS ***
mfrkWA3PTeYPkbO6hi98Aw: folds 
7VfhiFY533nbUKvyEthASw: calls $0.25
k9nHZTHt8hYhYRcW8NTb4g: raises $0.50 to $0.75
9jSiy0meE9XJKkdIZwyTEQ: folds 
myagrRAhs0mdgmh5GNqvCw: folds 
bE34il0XYGjWPD5/vbkMaQ: folds 
7VfhiFY533nbUKvyEthASw: calls $0.50
*** FLOP *** [4c Tc As]
7VfhiFY533nbUKvyEthASw: checks 
k9nHZTHt8hYhYRcW8NTb4g: bets $0.75
7VfhiFY533nbUKvyEthASw: calls $0.75
*** TURN *** [4c Tc As] [6c]
7VfhiFY533nbUKvyEthASw: checks 
k9nHZTHt8hYhYRcW8NTb4g: checks 
*** RIVER *** [4c Tc As 6c] [9d]
7VfhiFY533nbUKvyEthASw: checks 
k9nHZTHt8hYhYRcW8NTb4g: bets $1.25
7VfhiFY533nbUKvyEthASw: raises $1.75 to $3
k9nHZTHt8hYhYRcW8NTb4g: calls $1.75
*** SHOW DOWN ***
7VfhiFY533nbUKvyEthASw: shows [Ad Ah] (three of a kind, Aces)
k9nHZTHt8hYhYRcW8NTb4g: mucks hand 
7VfhiFY533nbUKvyEthASw collected $8.90 from pot
*** SUMMARY ***
Total pot $9.35 | Rake $0.45 
Board [4c Tc As 6c 9d]
Seat 1: 7VfhiFY533nbUKvyEthASw showed [Ad Ah] and won ($8.90) with three of a kind, Aces
Seat 2: k9nHZTHt8hYhYRcW8NTb4g mucked
Seat 3: 9jSiy0meE9XJKkdIZwyTEQ (button) folded before Flop (didn't bet)
Seat 4: myagrRAhs0mdgmh5GNqvCw (small blind) folded before Flop
Seat 5: bE34il0XYGjWPD5/vbkMaQ (big blind) folded before Flop
Seat 6: mfrkWA3PTeYPkbO6hi98Aw folded before Flop (didn't bet)




PokerStars Game #59939374046:  Hold'em No Limit ($0.10/$0.25) - 2009/07/01 0:38:13 ET
Table 'QegsWX65l3n/K0A8XB78yg' 6-max Seat #6 is the button
Seat 1: 8ClCHtFXGNplITm+63KB+Q ($29.40 in chips) 
Seat 2: GC/9yVD59DUCX7hUI7gcLw ($28.70 in chips) 
Seat 3: 9jSiy0meE9XJKkdIZwyTEQ ($25 in chips) 
Seat 4: kyRaCIljYA6l33lSKQfNsg ($25 in chips) 
Seat 5: 4YSTu0Cdzpppe1lUgCZGCQ ($59.75 in chips) 
Seat 6: JE/wJXmjw3bpdmjwvh2pcg ($37.15 in chips) 
8ClCHtFXGNplITm+63KB+Q: posts small blind $0.10
GC/9yVD59DUCX7hUI7gcLw: posts big blind $0.25
*** HOLE CARDS ***
9jSiy0meE9XJKkdIZwyTEQ: folds 
kyRaCIljYA6l33lSKQfNsg: folds 
4YSTu0Cdzpppe1lUgCZGCQ: folds 
JE/wJXmjw3bpdmjwvh2pcg: raises $1 to $1.25
8ClCHtFXGNplITm+63KB+Q: folds 
GC/9yVD59DUCX7hUI7gcLw: folds 
Uncalled bet ($1) returned to JE/wJXmjw3bpdmjwvh2pcg
JE/wJXmjw3bpdmjwvh2pcg collected $0.60 from pot
JE/wJXmjw3bpdmjwvh2pcg: doesn't show hand 
*** SUMMARY ***
Total pot $0.60 | Rake $0 
Seat 1: 8ClCHtFXGNplITm+63KB+Q (small blind) folded before Flop
Seat 2: GC/9yVD59DUCX7hUI7gcLw (big blind) folded before Flop
Seat 3: 9jSiy0meE9XJKkdIZwyTEQ folded before Flop (didn't bet)
Seat 4: kyRaCIljYA6l33lSKQfNsg folded before Flop (didn't bet)
Seat 5: 4YSTu0Cdzpppe1lUgCZGCQ folded before Flop (didn't bet)
Seat 6: JE/wJXmjw3bpdmjwvh2pcg (button) collected ($0.60)




PokerStars Game #59939374056:  Hold'em No Limit ($0.10/$0.25) - 2009/07/01 0:38:13 ET
Table 'o0CDOvKO/bn1WjeymDrXfA' 6-max Seat #5 is the button
Seat 1: 32YL2ZEp8NT4JB2RVM9euQ ($16.35 in chips) 
Seat 2: oc4ZGs0W+3RIg2yPyJw3ig ($24.75 in chips) 
Seat 3: EqXTTLKUlDlz7yi6ziyyWA ($10 in chips) 
Seat 4: WvQKBeYmHv0ZkY7uzfWAAw ($13.90 in chips) 
Seat 5: u/yN5P9f3KlATg6WLWNkBQ ($29.25 in chips) 
Seat 6: Bada343Si4xKu3fNXY99AA ($21.05 in chips) 
Bada343Si4xKu3fNXY99AA: posts small blind $0.10
32YL2ZEp8NT4JB2RVM9euQ: posts big blind $0.25
*** HOLE CARDS ***
oc4ZGs0W+3RIg2yPyJw3ig: folds 
EqXTTLKUlDlz7yi6ziyyWA: folds 
WvQKBeYmHv0ZkY7uzfWAAw: folds 
u/yN5P9f3KlATg6WLWNkBQ: raises $1 to $1.25
Bada343Si4xKu3fNXY99AA: folds 
32YL2ZEp8NT4JB2RVM9euQ: folds 
Uncalled bet ($1) returned to u/yN5P9f3KlATg6WLWNkBQ
u/yN5P9f3KlATg6WLWNkBQ collected $0.60 from pot
u/yN5P9f3KlATg6WLWNkBQ: doesn't show hand 
*** SUMMARY ***
Total pot $0.60 | Rake $0 
Seat 1: 32YL2ZEp8NT4JB2RVM9euQ (big blind) folded before Flop
Seat 2: oc4ZGs0W+3RIg2yPyJw3ig folded before Flop (didn't bet)
Seat 3: EqXTTLKUlDlz7yi6ziyyWA folded before Flop (didn't bet)
Seat 4: WvQKBeYmHv0ZkY7uzfWAAw folded before Flop (didn't bet)
Seat 5: u/yN5P9f3KlATg6WLWNkBQ (button) collected ($0.60)
Seat 6: Bada343Si4xKu3fNXY99AA (small blind) folded before Flop




PokerStars Game #59939373946:  Hold'em No Limit ($0.10/$0.25) - 2009/07/01 0:38:13 ET
Table 'x7YStLKc8hpt/pTgSetPKA' 9-max Seat #9 is the button
Seat 2: z5GxcHlYz/GSz6W2uFiTtg ($36.35 in chips) 
Seat 5: gxyie8xe6lDdpfG4quHtbw ($15.30 in chips) 
Seat 6: Yv4fucyyT28mjx8V5lxKJg ($31.80 in chips) 
Seat 7: +8FtfKCFr23+6O39P+U45Q ($28.90 in chips) 
Seat 8: jeKWRUkMaVn8rEUjnJKqpg ($33.90 in chips) 
Seat 9: nm4Dj/f+jJEwKVsUnKh73g ($22.50 in chips) 
z5GxcHlYz/GSz6W2uFiTtg: posts small blind $0.10
gxyie8xe6lDdpfG4quHtbw: posts big blind $0.25
*** HOLE CARDS ***
Yv4fucyyT28mjx8V5lxKJg: raises $0.75 to $1
+8FtfKCFr23+6O39P+U45Q: folds 
jeKWRUkMaVn8rEUjnJKqpg: folds 
nm4Dj/f+jJEwKVsUnKh73g: folds 
z5GxcHlYz/GSz6W2uFiTtg: folds 
gxyie8xe6lDdpfG4quHtbw: folds 
Uncalled bet ($0.75) returned to Yv4fucyyT28mjx8V5lxKJg
Yv4fucyyT28mjx8V5lxKJg collected $0.60 from pot
Yv4fucyyT28mjx8V5lxKJg: doesn't show hand 
*** SUMMARY ***
Total pot $0.60 | Rake $0 
Seat 2: z5GxcHlYz/GSz6W2uFiTtg (small blind) folded before Flop
Seat 5: gxyie8xe6lDdpfG4quHtbw (big blind) folded before Flop
Seat 6: Yv4fucyyT28mjx8V5lxKJg collected ($0.60)
Seat 7: +8FtfKCFr23+6O39P+U45Q folded before Flop (didn't bet)
Seat 8: jeKWRUkMaVn8rEUjnJKqpg folded before Flop (didn't bet)
Seat 9: nm4Dj/f+jJEwKVsUnKh73g (button) folded before Flop (didn't bet)




PokerStars Game #59939374080:  Hold'em No Limit ($0.10/$0.25) - 2009/07/01 0:38:13 ET
Table 'aT31tt16YvQM/Ue69HPLpA' 9-max Seat #4 is the button
Seat 1: uYY6p3irj4hBN7IeHiNGSw ($24.75 in chips) 
Seat 3: tYsOBqdU1+x+yFI7zHO7hQ ($26.65 in chips) 
Seat 4: s7Q6uNouhe7aE8JdFb9E+A ($25 in chips) 
Seat 5: cvtKnIIaTx2+P/KlOK+tfQ ($9.30 in chips) 
Seat 6: 7cv+9Zc9HIQHNvYsMfV3uA ($44.50 in chips) 
Seat 7: s8SPJjToEJz2mPsHsMqL0A ($4 in chips) 
Seat 8: lrTLp1zpuCCs/e0pi2M8jw ($45.10 in chips) 
Seat 9: SXqVW4Q0evTUVZG6BbUNIA ($30.75 in chips) 
cvtKnIIaTx2+P/KlOK+tfQ: posts small blind $0.10
7cv+9Zc9HIQHNvYsMfV3uA: posts big blind $0.25
CYkY0dNBaYaKs8HVCVn3mQ: sits out 
*** HOLE CARDS ***
s8SPJjToEJz2mPsHsMqL0A: calls $0.25
lrTLp1zpuCCs/e0pi2M8jw: calls $0.25
SXqVW4Q0evTUVZG6BbUNIA: folds 
uYY6p3irj4hBN7IeHiNGSw: folds 
tYsOBqdU1+x+yFI7zHO7hQ: folds 
s7Q6uNouhe7aE8JdFb9E+A: folds 
cvtKnIIaTx2+P/KlOK+tfQ: calls $0.15
7cv+9Zc9HIQHNvYsMfV3uA: checks 
*** FLOP *** [6c 8s 3c]
cvtKnIIaTx2+P/KlOK+tfQ: checks 
7cv+9Zc9HIQHNvYsMfV3uA: bets $0.75
s8SPJjToEJz2mPsHsMqL0A: calls $0.75
lrTLp1zpuCCs/e0pi2M8jw: folds 
cvtKnIIaTx2+P/KlOK+tfQ: folds 
*** TURN *** [6c 8s 3c] [Ad]
7cv+9Zc9HIQHNvYsMfV3uA: checks 
s8SPJjToEJz2mPsHsMqL0A: checks 
*** RIVER *** [6c 8s 3c Ad] [Kd]
7cv+9Zc9HIQHNvYsMfV3uA: checks 
s8SPJjToEJz2mPsHsMqL0A: checks 
*** SHOW DOWN ***
7cv+9Zc9HIQHNvYsMfV3uA: shows [9c 7h] (high card Ace)
s8SPJjToEJz2mPsHsMqL0A: shows [6h 5c] (a pair of Sixes)
s8SPJjToEJz2mPsHsMqL0A collected $2.40 from pot
*** SUMMARY ***
Total pot $2.50 | Rake $0.10 
Board [6c 8s 3c Ad Kd]
Seat 1: uYY6p3irj4hBN7IeHiNGSw folded before Flop (didn't bet)
Seat 3: tYsOBqdU1+x+yFI7zHO7hQ folded before Flop (didn't bet)
Seat 4: s7Q6uNouhe7aE8JdFb9E+A (button) folded before Flop (didn't bet)
Seat 5: cvtKnIIaTx2+P/KlOK+tfQ (small blind) folded on the Flop
Seat 6: 7cv+9Zc9HIQHNvYsMfV3uA (big blind) showed [9c 7h] and lost with high card Ace
Seat 7: s8SPJjToEJz2mPsHsMqL0A showed [6h 5c] and won ($2.40) with a pair of Sixes
Seat 8: lrTLp1zpuCCs/e0pi2M8jw folded on the Flop
Seat 9: SXqVW4Q0evTUVZG6BbUNIA folded before Flop (didn't bet)




PokerStars Game #59939373998:  Hold'em No Limit ($0.10/$0.25) - 2009/07/01 0:38:13 ET
Table '7eunnLa5p3aGsPrUrNnn/A' 9-max Seat #2 is the button
Seat 1: Ml2bY77EHbM51ZWD7dnIWg ($30 in chips) 
Seat 2: aJy680tKSaP5er559aSuGA ($12.25 in chips) 
Seat 3: E0iYnEVO2ho7dH3QcCjw7g ($19.30 in chips) 
Seat 4: opOCI2p6kW0tINuVaAqmcQ ($30.70 in chips) 
Seat 5: JLfmdpDbz2ljMNE7ICboMQ ($8.05 in chips) 
Seat 6: jx9kXw1SAZrvXp9Nerz8+Q ($16.95 in chips) 
Seat 8: 1Clf3cPrqoy/YgvWdWK1Xw ($5 in chips) 
Seat 9: rUpvA02nErFvZ4yFbDR8XA ($21.05 in chips) 
E0iYnEVO2ho7dH3QcCjw7g: posts small blind $0.10
opOCI2p6kW0tINuVaAqmcQ: posts big blind $0.25
*** HOLE CARDS ***
JLfmdpDbz2ljMNE7ICboMQ: folds 
jx9kXw1SAZrvXp9Nerz8+Q: folds 
1Clf3cPrqoy/YgvWdWK1Xw: folds 
rUpvA02nErFvZ4yFbDR8XA: folds 
Ml2bY77EHbM51ZWD7dnIWg: folds 
aJy680tKSaP5er559aSuGA: folds 
E0iYnEVO2ho7dH3QcCjw7g: folds 
Uncalled bet ($0.15) returned to opOCI2p6kW0tINuVaAqmcQ
opOCI2p6kW0tINuVaAqmcQ collected $0.20 from pot
*** SUMMARY ***
Total pot $0.20 | Rake $0 
Seat 1: Ml2bY77EHbM51ZWD7dnIWg folded before Flop (didn't bet)
Seat 2: aJy680tKSaP5er559aSuGA (button) folded before Flop (didn't bet)
Seat 3: E0iYnEVO2ho7dH3QcCjw7g (small blind) folded before Flop
Seat 4: opOCI2p6kW0tINuVaAqmcQ (big blind) collected ($0.20)
Seat 5: JLfmdpDbz2ljMNE7ICboMQ folded before Flop (didn't bet)
Seat 6: jx9kXw1SAZrvXp9Nerz8+Q folded before Flop (didn't bet)
Seat 8: 1Clf3cPrqoy/YgvWdWK1Xw folded before Flop (didn't bet)
Seat 9: rUpvA02nErFvZ4yFbDR8XA folded before Flop (didn't bet)




PokerStars Game #59939374042:  Hold'em No Limit ($0.10/$0.25) - 2009/07/01 0:38:13 ET
Table '0M5QEJGOThqZwQ/sjbjXYw' 6-max Seat #6 is the button
Seat 1: RVBrV53KVTJ2T2VL8ucnfw ($24.65 in chips) 
Seat 2: /gJNBeCkWL4o85/jvlZ4BA ($42.20 in chips) 
Seat 5: ErIN0JRL5srYjT6en1f8YQ ($24.70 in chips) 
Seat 6: mYz11CHiw5KsDCRD5T7/jg ($59.85 in chips) 
RVBrV53KVTJ2T2VL8ucnfw: posts small blind $0.10
/gJNBeCkWL4o85/jvlZ4BA: posts big blind $0.25
fZQg9veL7Dd/Z04ZTjC+wQ: sits out 
*** HOLE CARDS ***
ErIN0JRL5srYjT6en1f8YQ: raises $0.75 to $1
mYz11CHiw5KsDCRD5T7/jg: folds 
RVBrV53KVTJ2T2VL8ucnfw: folds 
/gJNBeCkWL4o85/jvlZ4BA: calls $0.75
*** FLOP *** [6h Ks As]
/gJNBeCkWL4o85/jvlZ4BA: checks 
ErIN0JRL5srYjT6en1f8YQ: bets $1.25
/gJNBeCkWL4o85/jvlZ4BA: calls $1.25
*** TURN *** [6h Ks As] [4c]
/gJNBeCkWL4o85/jvlZ4BA: checks 
ErIN0JRL5srYjT6en1f8YQ: bets $2.25
/gJNBeCkWL4o85/jvlZ4BA: folds 
Uncalled bet ($2.25) returned to ErIN0JRL5srYjT6en1f8YQ
ErIN0JRL5srYjT6en1f8YQ collected $4.40 from pot
ErIN0JRL5srYjT6en1f8YQ: doesn't show hand 
*** SUMMARY ***
Total pot $4.60 | Rake $0.20 
Board [6h Ks As 4c]
Seat 1: RVBrV53KVTJ2T2VL8ucnfw (small blind) folded before Flop
Seat 2: /gJNBeCkWL4o85/jvlZ4BA (big blind) folded on the Turn
Seat 5: ErIN0JRL5srYjT6en1f8YQ collected ($4.40)
Seat 6: mYz11CHiw5KsDCRD5T7/jg (button) folded before Flop (didn't bet)




PokerStars Game #59939373974:  Hold'em No Limit ($0.10/$0.25) - 2009/07/01 0:38:13 ET
Table '/asc7VQ/OpF/oVJ3erB80w' 9-max Seat #5 is the button
Seat 1: OiV1PWZ3IkN29JlmCcnTwQ ($4.70 in chips) 
Seat 2: Th3FldXKQW6hWVVPahaoOQ ($25 in chips) 
Seat 3: ie4EwTMMFYxrCXcenJdzsw ($6.45 in chips) 
Seat 4: H9KUl8cmpLgEpOVDA00bCg ($5.25 in chips) 
Seat 5: 8B/dhbQjIWe6ASCdgzktNQ ($25.25 in chips) 
Seat 6: t2nb95S5EEFOEzNx9Itz0g ($3.70 in chips) 
Seat 7: M2QO2DxB5Wawg2h8HSpnYA ($10.50 in chips) 
Seat 8: T5Hk9oiIr+JDDMnEqwFCrw ($7.05 in chips) 
Seat 9: UkJraTKWQIqFeHOyHQ7afQ ($14.90 in chips) 
t2nb95S5EEFOEzNx9Itz0g: posts small blind $0.10
M2QO2DxB5Wawg2h8HSpnYA: posts big blind $0.25
*** HOLE CARDS ***
T5Hk9oiIr+JDDMnEqwFCrw: folds 
UkJraTKWQIqFeHOyHQ7afQ: folds 
OiV1PWZ3IkN29JlmCcnTwQ: folds 
Th3FldXKQW6hWVVPahaoOQ: raises $0.50 to $0.75
ie4EwTMMFYxrCXcenJdzsw: folds 
H9KUl8cmpLgEpOVDA00bCg: folds 
8B/dhbQjIWe6ASCdgzktNQ: folds 
t2nb95S5EEFOEzNx9Itz0g: folds 
M2QO2DxB5Wawg2h8HSpnYA: calls $0.50
*** FLOP *** [8c 8d Ks]
M2QO2DxB5Wawg2h8HSpnYA: checks 
Th3FldXKQW6hWVVPahaoOQ: bets $1
M2QO2DxB5Wawg2h8HSpnYA: folds 
Uncalled bet ($1) returned to Th3FldXKQW6hWVVPahaoOQ
Th3FldXKQW6hWVVPahaoOQ collected $1.55 from pot
Th3FldXKQW6hWVVPahaoOQ: doesn't show hand 
*** SUMMARY ***
Total pot $1.60 | Rake $0.05 
Board [8c 8d Ks]
Seat 1: OiV1PWZ3IkN29JlmCcnTwQ folded before Flop (didn't bet)
Seat 2: Th3FldXKQW6hWVVPahaoOQ collected ($1.55)
Seat 3: ie4EwTMMFYxrCXcenJdzsw folded before Flop (didn't bet)
Seat 4: H9KUl8cmpLgEpOVDA00bCg folded before Flop (didn't bet)
Seat 5: 8B/dhbQjIWe6ASCdgzktNQ (button) folded before Flop (didn't bet)
Seat 6: t2nb95S5EEFOEzNx9Itz0g (small blind) folded before Flop
Seat 7: M2QO2DxB5Wawg2h8HSpnYA (big blind) folded on the Flop
Seat 8: T5Hk9oiIr+JDDMnEqwFCrw folded before Flop (didn't bet)
Seat 9: UkJraTKWQIqFeHOyHQ7afQ folded before Flop (didn't bet)




PokerStars Game #59939373880:  Hold'em No Limit ($0.10/$0.25) - 2009/07/01 0:38:13 ET
Table '0XPo7K54oZIfG0xlNAcDRw' 9-max Seat #3 is the button
Seat 1: opOCI2p6kW0tINuVaAqmcQ ($29.65 in chips) 
Seat 2: Jbrpc6KkvYcsiySJzLmFuA ($15.40 in chips) 
Seat 3: 6qsItdeWZoOL5be2e1RFng ($11.50 in chips) 
Seat 4: vOEICaqlJhPYytg64XnnkQ ($13.35 in chips) 
Seat 5: 8B/dhbQjIWe6ASCdgzktNQ ($40.35 in chips) 
Seat 6: 9gmYYQesalMrUjaF7nKfrQ ($9.75 in chips) 
Seat 7: tYsOBqdU1+x+yFI7zHO7hQ ($45.85 in chips) 
Seat 8: 1Clf3cPrqoy/YgvWdWK1Xw ($6.25 in chips) 
Seat 9: s7Q6uNouhe7aE8JdFb9E+A ($25 in chips) 
vOEICaqlJhPYytg64XnnkQ: posts small blind $0.10
8B/dhbQjIWe6ASCdgzktNQ: posts big blind $0.25
*** HOLE CARDS ***
9gmYYQesalMrUjaF7nKfrQ: raises $0.50 to $0.75
tYsOBqdU1+x+yFI7zHO7hQ: folds 
1Clf3cPrqoy/YgvWdWK1Xw: folds 
s7Q6uNouhe7aE8JdFb9E+A: folds 
opOCI2p6kW0tINuVaAqmcQ: folds 
Jbrpc6KkvYcsiySJzLmFuA: folds 
6qsItdeWZoOL5be2e1RFng: folds 
vOEICaqlJhPYytg64XnnkQ: calls $0.65
8B/dhbQjIWe6ASCdgzktNQ: folds 
*** FLOP *** [Js 6h Qc]
vOEICaqlJhPYytg64XnnkQ: checks 
9gmYYQesalMrUjaF7nKfrQ: bets $0.50
vOEICaqlJhPYytg64XnnkQ: folds 
Uncalled bet ($0.50) returned to 9gmYYQesalMrUjaF7nKfrQ
9gmYYQesalMrUjaF7nKfrQ collected $1.70 from pot
9gmYYQesalMrUjaF7nKfrQ: doesn't show hand 
*** SUMMARY ***
Total pot $1.75 | Rake $0.05 
Board [Js 6h Qc]
Seat 1: opOCI2p6kW0tINuVaAqmcQ folded before Flop (didn't bet)
Seat 2: Jbrpc6KkvYcsiySJzLmFuA folded before Flop (didn't bet)
Seat 3: 6qsItdeWZoOL5be2e1RFng (button) folded before Flop (didn't bet)
Seat 4: vOEICaqlJhPYytg64XnnkQ (small blind) folded on the Flop
Seat 5: 8B/dhbQjIWe6ASCdgzktNQ (big blind) folded before Flop
Seat 6: 9gmYYQesalMrUjaF7nKfrQ collected ($1.70)
Seat 7: tYsOBqdU1+x+yFI7zHO7hQ folded before Flop (didn't bet)
Seat 8: 1Clf3cPrqoy/YgvWdWK1Xw folded before Flop (didn't bet)
Seat 9: s7Q6uNouhe7aE8JdFb9E+A folded before Flop (didn't bet)




PokerStars Game #59939374794:  Hold'em No Limit ($0.10/$0.25) - 2009/07/01 0:38:14 ET
Table 'iHlyuN1lFZ6WTlMBiiMYXAIIO2q2znuuAXmiZ2qFTcmgx Seat #7 is the button
Seat 2: R6nIVAjK7uhK3Hj0f85A+A ($29.45 in chips) 
Seat 3: QGjA4xtpxSpgzm+HC+ps4w ($21.95 in chips) 
Seat 4: z5GxcHlYz/GSz6W2uFiTtg ($24 in chips) 
Seat 5: 6LFELL8V3NTpb0xg7AOyEg ($11.90 in chips) 
Seat 6: M2QO2DxB5Wawg2h8HSpnYA ($11.80 in chips) 
Seat 7: gehe91e0IyVT0QU/XBkEyg ($33.50 in chips) 
Seat 8: TeWJxSETzbXGiYKx0y+dtg ($24.65 in chips) 
Seat 9: PqvgxdSg9z5VmrWpbYuz+g ($25 in chips) 
TeWJxSETzbXGiYKx0y+dtg: posts small blind $0.10
PqvgxdSg9z5VmrWpbYuz+g: posts big blind $0.25
*** HOLE CARDS ***
R6nIVAjK7uhK3Hj0f85A+A: folds 
QGjA4xtpxSpgzm+HC+ps4w: calls $0.25
z5GxcHlYz/GSz6W2uFiTtg: folds 
6LFELL8V3NTpb0xg7AOyEg: folds 
M2QO2DxB5Wawg2h8HSpnYA: folds 
gehe91e0IyVT0QU/XBkEyg: folds 
TeWJxSETzbXGiYKx0y+dtg: folds 
PqvgxdSg9z5VmrWpbYuz+g: checks 
*** FLOP *** [Kd 4h 8d]
PqvgxdSg9z5VmrWpbYuz+g: checks 
QGjA4xtpxSpgzm+HC+ps4w: checks 
*** TURN *** [Kd 4h 8d] [Qc]
PqvgxdSg9z5VmrWpbYuz+g: checks 
QGjA4xtpxSpgzm+HC+ps4w: bets $0.25
PqvgxdSg9z5VmrWpbYuz+g: calls $0.25
*** RIVER *** [Kd 4h 8d Qc] [5s]
PqvgxdSg9z5VmrWpbYuz+g: checks 
QGjA4xtpxSpgzm+HC+ps4w: checks 
*** SHOW DOWN ***
PqvgxdSg9z5VmrWpbYuz+g: shows [6d 6h] (a pair of Sixes)
QGjA4xtpxSpgzm+HC+ps4w: shows [Jd Jh] (a pair of Jacks)
QGjA4xtpxSpgzm+HC+ps4w collected $1.05 from pot
*** SUMMARY ***
Total pot $1.10 | Rake $0.05 
Board [Kd 4h 8d Qc 5s]
Seat 2: R6nIVAjK7uhK3Hj0f85A+A folded before Flop (didn't bet)
Seat 3: QGjA4xtpxSpgzm+HC+ps4w showed [Jd Jh] and won ($1.05) with a pair of Jacks
Seat 4: z5GxcHlYz/GSz6W2uFiTtg folded before Flop (didn't bet)
Seat 5: 6LFELL8V3NTpb0xg7AOyEg folded before Flop (didn't bet)
Seat 6: M2QO2DxB5Wawg2h8HSpnYA folded before Flop (didn't bet)
Seat 7: gehe91e0IyVT0QU/XBkEyg (button) folded before Flop (didn't bet)
Seat 8: TeWJxSETzbXGiYKx0y+dtg (small blind) folded before Flop
Seat 9: PqvgxdSg9z5VmrWpbYuz+g (big blind) showed [6d 6h] and lost with a pair of Sixes




PokerStars Game #59939374886:  Hold'em No Limit ($0.10/$0.25) - 2009/07/01 0:38:14 ET
Table 'pPgW4R3kdH26lLi1MnE92w' 9-max Seat #5 is the button
Seat 1: dPWIrImjP1yFagoUVDKR0Q ($9.40 in chips) 
Seat 2: cZ99hugmLBj9KhTlc8nCSw ($28.60 in chips) 
Seat 3: og+56SuM1LUF/5l/Qtaw4Q ($10.40 in chips) 
Seat 4: hBMUlEpyU74r/fwDgIpXjQ ($31.15 in chips) 
Seat 5: HPEB+AtKw1+C/cxU0o1ciw ($34.35 in chips) 
Seat 6: Z9AeOQX3yzuSvKAm/xyovg ($12.15 in chips) 
Seat 8: aCVg6cCxQcqClhB9nq/p1w ($19.60 in chips) 
Seat 9: tcbEu7VzyHQ+0lh+skbQhQ ($18.50 in chips) 
Z9AeOQX3yzuSvKAm/xyovg: posts small blind $0.10
7wo6Sr7QG3Zo6BaBDV1BOw: is sitting out 
aCVg6cCxQcqClhB9nq/p1w: posts big blind $0.25
*** HOLE CARDS ***
7wo6Sr7QG3Zo6BaBDV1BOw leaves the table
tcbEu7VzyHQ+0lh+skbQhQ: folds 
dPWIrImjP1yFagoUVDKR0Q: folds 
cZ99hugmLBj9KhTlc8nCSw: folds 
og+56SuM1LUF/5l/Qtaw4Q: raises $0.50 to $0.75
hBMUlEpyU74r/fwDgIpXjQ: folds 
HPEB+AtKw1+C/cxU0o1ciw: folds 
Z9AeOQX3yzuSvKAm/xyovg: folds 
aCVg6cCxQcqClhB9nq/p1w: folds 
Uncalled bet ($0.50) returned to og+56SuM1LUF/5l/Qtaw4Q
og+56SuM1LUF/5l/Qtaw4Q collected $0.60 from pot
*** SUMMARY ***
Total pot $0.60 | Rake $0 
Seat 1: dPWIrImjP1yFagoUVDKR0Q folded before Flop (didn't bet)
Seat 2: cZ99hugmLBj9KhTlc8nCSw folded before Flop (didn't bet)
Seat 3: og+56SuM1LUF/5l/Qtaw4Q collected ($0.60)
Seat 4: hBMUlEpyU74r/fwDgIpXjQ folded before Flop (didn't bet)
Seat 5: HPEB+AtKw1+C/cxU0o1ciw (button) folded before Flop (didn't bet)
Seat 6: Z9AeOQX3yzuSvKAm/xyovg (small blind) folded before Flop
Seat 8: aCVg6cCxQcqClhB9nq/p1w (big blind) folded before Flop
Seat 9: tcbEu7VzyHQ+0lh+skbQhQ folded before Flop (didn't bet)




PokerStars Game #59939374738:  Hold'em No Limit ($0.10/$0.25) - 2009/07/01 0:38:14 ET
Table 'WEMI3Mtn7dGARDbgNrKibg' 9-max Seat #4 is the button
Seat 2: tYsOBqdU1+x+yFI7zHO7hQ ($25 in chips) 
Seat 3: jZaChyamGXWcP+qALPP5Jg ($25 in chips) 
Seat 4: weRKhk7fsNpLvkjCucC/eQ ($20.90 in chips) 
Seat 5: st9jtdNbm1W5GfBwRaCVqQ ($24 in chips) 
Seat 6: VBHxUExRAMrbxUq/cVx9Gw ($5 in chips) 
Seat 7: DnDcAdn9P0zGovMERigpFA ($59 in chips) 
Seat 8: ghNKXUBl/H+t83JF079ZBA ($27.30 in chips) 
Seat 9: NTamLAiMZ86c5yM04t96LA ($58.20 in chips) 
st9jtdNbm1W5GfBwRaCVqQ: posts small blind $0.10
VBHxUExRAMrbxUq/cVx9Gw: posts big blind $0.25
7cv+9Zc9HIQHNvYsMfV3uA: sits out 
*** HOLE CARDS ***
DnDcAdn9P0zGovMERigpFA: folds 
ghNKXUBl/H+t83JF079ZBA: folds 
NTamLAiMZ86c5yM04t96LA: calls $0.25
tYsOBqdU1+x+yFI7zHO7hQ: raises $1 to $1.25
jZaChyamGXWcP+qALPP5Jg: folds 
weRKhk7fsNpLvkjCucC/eQ: folds 
st9jtdNbm1W5GfBwRaCVqQ: folds 
VBHxUExRAMrbxUq/cVx9Gw: folds 
NTamLAiMZ86c5yM04t96LA: calls $1
*** FLOP *** [Qc 3s 7s]
NTamLAiMZ86c5yM04t96LA: checks 
tYsOBqdU1+x+yFI7zHO7hQ: bets $2
NTamLAiMZ86c5yM04t96LA: folds 
Uncalled bet ($2) returned to tYsOBqdU1+x+yFI7zHO7hQ
tYsOBqdU1+x+yFI7zHO7hQ collected $2.75 from pot
tYsOBqdU1+x+yFI7zHO7hQ: doesn't show hand 
*** SUMMARY ***
Total pot $2.85 | Rake $0.10 
Board [Qc 3s 7s]
Seat 2: tYsOBqdU1+x+yFI7zHO7hQ collected ($2.75)
Seat 3: jZaChyamGXWcP+qALPP5Jg folded before Flop (didn't bet)
Seat 4: weRKhk7fsNpLvkjCucC/eQ (button) folded before Flop (didn't bet)
Seat 5: st9jtdNbm1W5GfBwRaCVqQ (small blind) folded before Flop
Seat 6: VBHxUExRAMrbxUq/cVx9Gw (big blind) folded before Flop
Seat 7: DnDcAdn9P0zGovMERigpFA folded before Flop (didn't bet)
Seat 8: ghNKXUBl/H+t83JF079ZBA folded before Flop (didn't bet)
Seat 9: NTamLAiMZ86c5yM04t96LA folded on the Flop




PokerStars Game #59939374476:  Hold'em No Limit ($0.10/$0.25) - 2009/07/01 0:38:14 ET
Table 'M8kYidAX3ib7pLKW7edFLw' 6-max Seat #4 is the button
Seat 1: 4YSTu0Cdzpppe1lUgCZGCQ ($40.25 in chips) 
Seat 2: sbFQMajC1QuRxa8Jly3usQ ($23.70 in chips) 
Seat 4: /bjna2FTN7pPjqYGzmDE0Q ($23.05 in chips) 
Seat 5: bDKopKTvPi3W+PEnYUX3tg ($28.05 in chips) 
bDKopKTvPi3W+PEnYUX3tg: posts small blind $0.10
4YSTu0Cdzpppe1lUgCZGCQ: posts big blind $0.25
*** HOLE CARDS ***
sbFQMajC1QuRxa8Jly3usQ: raises $0.50 to $0.75
/bjna2FTN7pPjqYGzmDE0Q: folds 
bDKopKTvPi3W+PEnYUX3tg: folds 
4YSTu0Cdzpppe1lUgCZGCQ: folds 
Uncalled bet ($0.50) returned to sbFQMajC1QuRxa8Jly3usQ
sbFQMajC1QuRxa8Jly3usQ collected $0.60 from pot
*** SUMMARY ***
Total pot $0.60 | Rake $0 
Seat 1: 4YSTu0Cdzpppe1lUgCZGCQ (big blind) folded before Flop
Seat 2: sbFQMajC1QuRxa8Jly3usQ collected ($0.60)
Seat 4: /bjna2FTN7pPjqYGzmDE0Q (button) folded before Flop (didn't bet)
Seat 5: bDKopKTvPi3W+PEnYUX3tg (small blind) folded before Flop




PokerStars Game #59939374366:  Hold'em No Limit ($0.10/$0.25) - 2009/07/01 0:38:14 ET
Table '2O5CgfSkSwrr4PDrlZ1RLQ' 6-max Seat #6 is the button
Seat 1: kyRaCIljYA6l33lSKQfNsg ($47.35 in chips) 
Seat 2: /gJNBeCkWL4o85/jvlZ4BA ($49.10 in chips) 
Seat 3: yzFNNFIfC89bBPwpFPx2ow ($25 in chips) 
Seat 4: 4x9jCqgSw4272dnaIqnanw ($9.25 in chips) 
Seat 5: AMrBn4Vx9aAo/vv6WHLk6w ($5 in chips) 
Seat 6: wqphQtauX5Qn7WRJZS1flA ($65.60 in chips) 
kyRaCIljYA6l33lSKQfNsg: posts small blind $0.10
/gJNBeCkWL4o85/jvlZ4BA: posts big blind $0.25
AMrBn4Vx9aAo/vv6WHLk6w: posts small blind $0.10
*** HOLE CARDS ***
yzFNNFIfC89bBPwpFPx2ow: folds 
4x9jCqgSw4272dnaIqnanw: folds 
AMrBn4Vx9aAo/vv6WHLk6w: folds 
wqphQtauX5Qn7WRJZS1flA: raises $0.50 to $0.75
kyRaCIljYA6l33lSKQfNsg: folds 
/gJNBeCkWL4o85/jvlZ4BA: calls $0.50
*** FLOP *** [Kh 3d Jc]
/gJNBeCkWL4o85/jvlZ4BA: bets $1.25
wqphQtauX5Qn7WRJZS1flA: folds 
Uncalled bet ($1.25) returned to /gJNBeCkWL4o85/jvlZ4BA
wqphQtauX5Qn7WRJZS1flA leaves the table
/gJNBeCkWL4o85/jvlZ4BA collected $1.65 from pot
*** SUMMARY ***
Total pot $1.70 | Rake $0.05 
Board [Kh 3d Jc]
Seat 1: kyRaCIljYA6l33lSKQfNsg (small blind) folded before Flop
Seat 2: /gJNBeCkWL4o85/jvlZ4BA (big blind) collected ($1.65)
Seat 3: yzFNNFIfC89bBPwpFPx2ow folded before Flop (didn't bet)
Seat 4: 4x9jCqgSw4272dnaIqnanw folded before Flop (didn't bet)
Seat 5: AMrBn4Vx9aAo/vv6WHLk6w folded before Flop
Seat 6: wqphQtauX5Qn7WRJZS1flA (button) folded on the Flop




PokerStars Game #59939374638:  Hold'em No Limit ($0.10/$0.25) - 2009/07/01 0:38:14 ET
Table 'dNYnr4D4id1jwnEU66Yowg' 9-max Seat #6 is the button
Seat 1: pVm3TmLFzWLZgQF7aghAfw ($47.55 in chips) 
Seat 2: t2nb95S5EEFOEzNx9Itz0g ($4.95 in chips) 
Seat 5: k+2r6di6GXjNpAdrRkW9bA ($23.20 in chips) 
Seat 6: kqpa/IbqkUrwPb3hbA7/ww ($8.50 in chips) 
Seat 7: hBMUlEpyU74r/fwDgIpXjQ ($25.35 in chips) 
Seat 8: opOCI2p6kW0tINuVaAqmcQ ($25 in chips) 
hBMUlEpyU74r/fwDgIpXjQ: posts small blind $0.10
opOCI2p6kW0tINuVaAqmcQ: posts big blind $0.25
*** HOLE CARDS ***
pVm3TmLFzWLZgQF7aghAfw: folds 
t2nb95S5EEFOEzNx9Itz0g: folds 
k+2r6di6GXjNpAdrRkW9bA: folds 
kqpa/IbqkUrwPb3hbA7/ww: folds 
pVm3TmLFzWLZgQF7aghAfw leaves the table
hBMUlEpyU74r/fwDgIpXjQ: folds 
Uncalled bet ($0.15) returned to opOCI2p6kW0tINuVaAqmcQ
hBMUlEpyU74r/fwDgIpXjQ leaves the table
opOCI2p6kW0tINuVaAqmcQ collected $0.20 from pot
opOCI2p6kW0tINuVaAqmcQ: doesn't show hand 
*** SUMMARY ***
Total pot $0.20 | Rake $0 
Seat 1: pVm3TmLFzWLZgQF7aghAfw folded before Flop (didn't bet)
Seat 2: t2nb95S5EEFOEzNx9Itz0g folded before Flop (didn't bet)
Seat 5: k+2r6di6GXjNpAdrRkW9bA folded before Flop (didn't bet)
Seat 6: kqpa/IbqkUrwPb3hbA7/ww (button) folded before Flop (didn't bet)
Seat 7: hBMUlEpyU74r/fwDgIpXjQ (small blind) folded before Flop
Seat 8: opOCI2p6kW0tINuVaAqmcQ (big blind) collected ($0.20)




PokerStars Game #59939374788:  Hold'em No Limit ($0.10/$0.25) - 2009/07/01 0:38:14 ET
Table 'nQC9LRg01NEuKFHF1nrDEw0XPo7K54oZIfG0xlNAcDRw-max Seat #1 is the button
Seat 1: Nj6/PdBvfG79w0yeIjPmmA ($12.30 in chips) 
Seat 2: cPO/1/dTcZpLkQFm3jH3Rg ($32.15 in chips) 
Seat 4: tLM9aw7T3kBEIhQEh1roOg ($7 in chips) 
Seat 5: kG34n23qFQA3nzdOJTQ1dA ($28.60 in chips) 
Seat 6: xQVFeVUDopz+akuEo2wXpQ ($48.60 in chips) 
cPO/1/dTcZpLkQFm3jH3Rg: posts small blind $0.10
tLM9aw7T3kBEIhQEh1roOg: posts big blind $0.25
*** HOLE CARDS ***
kG34n23qFQA3nzdOJTQ1dA: folds 
xQVFeVUDopz+akuEo2wXpQ: calls $0.25
Nj6/PdBvfG79w0yeIjPmmA: calls $0.25
cPO/1/dTcZpLkQFm3jH3Rg: folds 
tLM9aw7T3kBEIhQEh1roOg: checks 
*** FLOP *** [7h Jd 3d]
tLM9aw7T3kBEIhQEh1roOg: bets $0.25
xQVFeVUDopz+akuEo2wXpQ: calls $0.25
Nj6/PdBvfG79w0yeIjPmmA: raises $0.25 to $0.50
tLM9aw7T3kBEIhQEh1roOg: folds 
xQVFeVUDopz+akuEo2wXpQ: calls $0.25
*** TURN *** [7h Jd 3d] [6h]
xQVFeVUDopz+akuEo2wXpQ: checks 
Nj6/PdBvfG79w0yeIjPmmA: bets $1.25
xQVFeVUDopz+akuEo2wXpQ: calls $1.25
*** RIVER *** [7h Jd 3d 6h] [Ts]
xQVFeVUDopz+akuEo2wXpQ: checks 
Nj6/PdBvfG79w0yeIjPmmA: checks 
*** SHOW DOWN ***
xQVFeVUDopz+akuEo2wXpQ: shows [Js 5s] (a pair of Jacks)
Nj6/PdBvfG79w0yeIjPmmA: shows [8c Jc] (a pair of Jacks - Ten+Eight kicker)
Nj6/PdBvfG79w0yeIjPmmA collected $4.40 from pot
*** SUMMARY ***
Total pot $4.60 | Rake $0.20 
Board [7h Jd 3d 6h Ts]
Seat 1: Nj6/PdBvfG79w0yeIjPmmA (button) showed [8c Jc] and won ($4.40) with a pair of Jacks
Seat 2: cPO/1/dTcZpLkQFm3jH3Rg (small blind) folded before Flop
Seat 4: tLM9aw7T3kBEIhQEh1roOg (big blind) folded on the Flop
Seat 5: kG34n23qFQA3nzdOJTQ1dA folded before Flop (didn't bet)
Seat 6: xQVFeVUDopz+akuEo2wXpQ showed [Js 5s] and lost with a pair of Jacks




PokerStars Game #59939375104:  Hold'em No Limit ($0.10/$0.25) - 2009/07/01 0:38:15 ET
Table 'T/iCKJXGphRN3xcdwfE/JQ' 6-max Seat #3 is the button
Seat 1: zZ8zH49EwNs0mqgppOaL9g ($24 in chips) 
Seat 2: FHilMb2i2DbUCc9lplszog ($23.05 in chips) 
Seat 3: R6AGToFJQOYVZAjC2jXEKw ($25.85 in chips) 
Seat 4: yzFNNFIfC89bBPwpFPx2ow ($38.10 in chips) 
Seat 6: jKYGBgexhqKT13Xana4EHg ($11.30 in chips) 
yzFNNFIfC89bBPwpFPx2ow: posts small blind $0.10
jKYGBgexhqKT13Xana4EHg: posts big blind $0.25
*** HOLE CARDS ***
zZ8zH49EwNs0mqgppOaL9g: folds 
FHilMb2i2DbUCc9lplszog: raises $0.25 to $0.50
R6AGToFJQOYVZAjC2jXEKw: folds 
yzFNNFIfC89bBPwpFPx2ow: calls $0.40
jKYGBgexhqKT13Xana4EHg: calls $0.25
*** FLOP *** [9d Tc 6h]
yzFNNFIfC89bBPwpFPx2ow: bets $1.25
jKYGBgexhqKT13Xana4EHg: folds 
FHilMb2i2DbUCc9lplszog: calls $1.25
*** TURN *** [9d Tc 6h] [Qc]
yzFNNFIfC89bBPwpFPx2ow: checks 
FHilMb2i2DbUCc9lplszog: bets $2.25
yzFNNFIfC89bBPwpFPx2ow: calls $2.25
*** RIVER *** [9d Tc 6h Qc] [3d]
yzFNNFIfC89bBPwpFPx2ow: checks 
FHilMb2i2DbUCc9lplszog: bets $4.50
yzFNNFIfC89bBPwpFPx2ow: calls $4.50
*** SHOW DOWN ***
FHilMb2i2DbUCc9lplszog: shows [7c 5h] (high card Queen)
yzFNNFIfC89bBPwpFPx2ow: shows [9h Ac] (a pair of Nines)
yzFNNFIfC89bBPwpFPx2ow collected $16.65 from pot
*** SUMMARY ***
Total pot $17.50 | Rake $0.85 
Board [9d Tc 6h Qc 3d]
Seat 1: zZ8zH49EwNs0mqgppOaL9g folded before Flop (didn't bet)
Seat 2: FHilMb2i2DbUCc9lplszog showed [7c 5h] and lost with high card Queen
Seat 3: R6AGToFJQOYVZAjC2jXEKw (button) folded before Flop (didn't bet)
Seat 4: yzFNNFIfC89bBPwpFPx2ow (small blind) showed [9h Ac] and won ($16.65) with a pair of Nines
Seat 6: jKYGBgexhqKT13Xana4EHg (big blind) folded on the Flop




PokerStars Game #59939374972:  Hold'em No Limit ($0.10/$0.25) - 2009/07/01 0:38:15 ET
Table 'IIO2q2znuuAXmiZ2qFTcmg' 6-max Seat #3 is the button
Seat 1: nwwpaieDRI0UPyVtChVHOg ($17.50 in chips) 
Seat 2: cS21pIxRHx5Gt42o7hPZzw ($15.10 in chips) 
Seat 3: hiTEr3yrERiQp3zHXRioVw ($14.75 in chips) 
Seat 4: 0HIrwssk0FQvyKULzUTtlg ($12.25 in chips) 
Seat 5: f9iRHw0d+kV7pbTYwF2+2g ($16.05 in chips) 
0HIrwssk0FQvyKULzUTtlg: posts small blind $0.10
f9iRHw0d+kV7pbTYwF2+2g: posts big blind $0.25
*** HOLE CARDS ***
nwwpaieDRI0UPyVtChVHOg: folds 
cS21pIxRHx5Gt42o7hPZzw: calls $0.25
hiTEr3yrERiQp3zHXRioVw: folds 
0HIrwssk0FQvyKULzUTtlg: calls $0.15
f9iRHw0d+kV7pbTYwF2+2g: raises $0.75 to $1
cS21pIxRHx5Gt42o7hPZzw: calls $0.75
0HIrwssk0FQvyKULzUTtlg: calls $0.75
*** FLOP *** [9s 2h Kh]
0HIrwssk0FQvyKULzUTtlg: checks 
f9iRHw0d+kV7pbTYwF2+2g: checks 
cS21pIxRHx5Gt42o7hPZzw: checks 
*** TURN *** [9s 2h Kh] [2s]
0HIrwssk0FQvyKULzUTtlg: checks 
f9iRHw0d+kV7pbTYwF2+2g: checks 
cS21pIxRHx5Gt42o7hPZzw: checks 
*** RIVER *** [9s 2h Kh 2s] [5s]
0HIrwssk0FQvyKULzUTtlg: checks 
f9iRHw0d+kV7pbTYwF2+2g: checks 
cS21pIxRHx5Gt42o7hPZzw: checks 
*** SHOW DOWN ***
0HIrwssk0FQvyKULzUTtlg: shows [8c Qc] (a pair of Deuces)
f9iRHw0d+kV7pbTYwF2+2g: shows [Jc Ah] (a pair of Deuces - Ace kicker)
cS21pIxRHx5Gt42o7hPZzw: mucks hand 
f9iRHw0d+kV7pbTYwF2+2g collected $2.85 from pot
*** SUMMARY ***
Total pot $3 | Rake $0.15 
Board [9s 2h Kh 2s 5s]
Seat 1: nwwpaieDRI0UPyVtChVHOg folded before Flop (didn't bet)
Seat 2: cS21pIxRHx5Gt42o7hPZzw mucked
Seat 3: hiTEr3yrERiQp3zHXRioVw (button) folded before Flop (didn't bet)
Seat 4: 0HIrwssk0FQvyKULzUTtlg (small blind) showed [8c Qc] and lost with a pair of Deuces
Seat 5: f9iRHw0d+kV7pbTYwF2+2g (big blind) showed [Jc Ah] and won ($2.85) with a pair of Deuces




PokerStars Game #59939375530:  Hold'em No Limit ($0.10/$0.25) - 2009/07/01 0:38:15 ET
Table 'ZEXL6Wh4qA4Afx8NnoBBAA' 6-max Seat #4 is the button
Seat 1: qo39V8/pMxxofM2aciLSWQ ($92.65 in chips) 
Seat 4: fZQg9veL7Dd/Z04ZTjC+wQ ($33.40 in chips) 
Seat 6: 3rZnxe2K3O+xcVdF94i8lA ($17.20 in chips) 
3rZnxe2K3O+xcVdF94i8lA: posts small blind $0.10
qo39V8/pMxxofM2aciLSWQ: posts big blind $0.25
*** HOLE CARDS ***
fZQg9veL7Dd/Z04ZTjC+wQ: raises $0.75 to $1
3rZnxe2K3O+xcVdF94i8lA: calls $0.90
qo39V8/pMxxofM2aciLSWQ: calls $0.75
*** FLOP *** [3c Ks 6h]
3rZnxe2K3O+xcVdF94i8lA: bets $0.75
qo39V8/pMxxofM2aciLSWQ: raises $1.75 to $2.50
fZQg9veL7Dd/Z04ZTjC+wQ: folds 
3rZnxe2K3O+xcVdF94i8lA: folds 
Uncalled bet ($1.75) returned to qo39V8/pMxxofM2aciLSWQ
qo39V8/pMxxofM2aciLSWQ collected $4.30 from pot
*** SUMMARY ***
Total pot $4.50 | Rake $0.20 
Board [3c Ks 6h]
Seat 1: qo39V8/pMxxofM2aciLSWQ (big blind) collected ($4.30)
Seat 4: fZQg9veL7Dd/Z04ZTjC+wQ (button) folded on the Flop
Seat 6: 3rZnxe2K3O+xcVdF94i8lA (small blind) folded on the Flop




PokerStars Game #59939375500:  Hold'em No Limit ($0.10/$0.25) - 2009/07/01 0:38:15 ET
Table '3Ns9nuTkynfwbBfBXzg6ww' 6-max Seat #4 is the button
Seat 3: 6PDO6dptGq0XLL8zHWIhgw ($49.20 in chips) 
Seat 4: kyRaCIljYA6l33lSKQfNsg ($31.75 in chips) 
Seat 5: kBQU/db00TVAMeomlhblPg ($15.10 in chips) 
kBQU/db00TVAMeomlhblPg: posts small blind $0.10
6PDO6dptGq0XLL8zHWIhgw: posts big blind $0.25
*** HOLE CARDS ***
kyRaCIljYA6l33lSKQfNsg: folds 
kBQU/db00TVAMeomlhblPg: raises $0.75 to $1
6PDO6dptGq0XLL8zHWIhgw: calls $0.75
*** FLOP *** [9c Qc 3h]
kBQU/db00TVAMeomlhblPg: bets $1.50
6PDO6dptGq0XLL8zHWIhgw: folds 
Uncalled bet ($1.50) returned to kBQU/db00TVAMeomlhblPg
kBQU/db00TVAMeomlhblPg collected $1.90 from pot
*** SUMMARY ***
Total pot $2 | Rake $0.10 
Board [9c Qc 3h]
Seat 3: 6PDO6dptGq0XLL8zHWIhgw (big blind) folded on the Flop
Seat 4: kyRaCIljYA6l33lSKQfNsg (button) folded before Flop (didn't bet)
Seat 5: kBQU/db00TVAMeomlhblPg (small blind) collected ($1.90)




PokerStars Game #59939374950:  Hold'em No Limit ($0.10/$0.25) - 2009/07/01 0:38:15 ET
Table 'KAnP7XvDtlku47YfJwdOVw' 9-max Seat #7 is the button
Seat 1: sJNHTWcSlLHRCZ9+YRLLqA ($33.55 in chips) 
Seat 2: CYkY0dNBaYaKs8HVCVn3mQ ($5 in chips) 
Seat 3: 7qgCOBwxmRRmkppeMkqy0Q ($7.40 in chips) 
Seat 5: MG90wfSJZnOejs/KD3vlQQ ($31.20 in chips) 
Seat 6: z5GxcHlYz/GSz6W2uFiTtg ($26.20 in chips) 
Seat 7: Lro4e37x4FUa5P3yzDjskw ($9.90 in chips) 
Seat 8: 3fPCxL5JUJVUL3eETYhxQQ ($9.15 in chips) 
Seat 9: qwr38jl5txoR36M7G5qi4A ($8.85 in chips) 
3fPCxL5JUJVUL3eETYhxQQ: posts small blind $0.10
qwr38jl5txoR36M7G5qi4A: posts big blind $0.25
IrishMike123: sits out 
*** HOLE CARDS ***
sJNHTWcSlLHRCZ9+YRLLqA: folds 
CYkY0dNBaYaKs8HVCVn3mQ: folds 
7qgCOBwxmRRmkppeMkqy0Q: folds 
MG90wfSJZnOejs/KD3vlQQ: folds 
z5GxcHlYz/GSz6W2uFiTtg: calls $0.25
Lro4e37x4FUa5P3yzDjskw: folds 
3fPCxL5JUJVUL3eETYhxQQ: calls $0.15
qwr38jl5txoR36M7G5qi4A: checks 
*** FLOP *** [9d 8c Ah]
3fPCxL5JUJVUL3eETYhxQQ: checks 
qwr38jl5txoR36M7G5qi4A: checks 
z5GxcHlYz/GSz6W2uFiTtg: bets $0.50
3fPCxL5JUJVUL3eETYhxQQ: folds 
qwr38jl5txoR36M7G5qi4A: folds 
Uncalled bet ($0.50) returned to z5GxcHlYz/GSz6W2uFiTtg
z5GxcHlYz/GSz6W2uFiTtg collected $0.75 from pot
*** SUMMARY ***
Total pot $0.75 | Rake $0 
Board [9d 8c Ah]
Seat 1: sJNHTWcSlLHRCZ9+YRLLqA folded before Flop (didn't bet)
Seat 2: CYkY0dNBaYaKs8HVCVn3mQ folded before Flop (didn't bet)
Seat 3: 7qgCOBwxmRRmkppeMkqy0Q folded before Flop (didn't bet)
Seat 5: MG90wfSJZnOejs/KD3vlQQ folded before Flop (didn't bet)
Seat 6: z5GxcHlYz/GSz6W2uFiTtg collected ($0.75)
Seat 7: Lro4e37x4FUa5P3yzDjskw (button) folded before Flop (didn't bet)
Seat 8: 3fPCxL5JUJVUL3eETYhxQQ (small blind) folded on the Flop
Seat 9: qwr38jl5txoR36M7G5qi4A (big blind) folded on the Flop




PokerStars Game #59939375388:  Hold'em No Limit ($0.10/$0.25) - 2009/07/01 0:38:15 ET
Table 'A1MqSL0j9xG0S/68IwXqhw' 6-max Seat #2 is the button
Seat 2: /6h8PvAHQmfuMUZ8OUF6Xw ($16.60 in chips) 
Seat 6: df01R5ThvHspD8FgKmaDvQ ($34.95 in chips) 
/6h8PvAHQmfuMUZ8OUF6Xw: posts small blind $0.10
df01R5ThvHspD8FgKmaDvQ: posts big blind $0.25
*** HOLE CARDS ***
/6h8PvAHQmfuMUZ8OUF6Xw: calls $0.15
df01R5ThvHspD8FgKmaDvQ: checks 
*** FLOP *** [Jd 7d 2h]
df01R5ThvHspD8FgKmaDvQ: bets $0.25
/6h8PvAHQmfuMUZ8OUF6Xw: folds 
Uncalled bet ($0.25) returned to df01R5ThvHspD8FgKmaDvQ
/6h8PvAHQmfuMUZ8OUF6Xw leaves the table
df01R5ThvHspD8FgKmaDvQ collected $0.50 from pot
df01R5ThvHspD8FgKmaDvQ is sitting out
*** SUMMARY ***
Total pot $0.50 | Rake $0 
Board [Jd 7d 2h]
Seat 2: /6h8PvAHQmfuMUZ8OUF6Xw (button) (small blind) folded on the Flop
Seat 6: df01R5ThvHspD8FgKmaDvQ (big blind) collected ($0.50)




PokerStars Game #59939375790:  Hold'em No Limit ($0.10/$0.25) - 2009/07/01 0:38:16 ET
Table 'nXVbUw6/HYwA6x21+IZ3XQ' 9-max Seat #6 is the button
Seat 1: zDrucyjVn5aeekNEc3cJrA ($23.65 in chips) 
Seat 2: 1K6QGyJP9P9xmRac2fH4OQ ($29.80 in chips) 
Seat 3: Vhpns1oAZs77VUIptmuKDw ($40.45 in chips) 
Seat 4: GmQux9F6mgOHtI4C9bVTNQ ($5 in chips) 
Seat 5: M/9j4wkHH9i1JM51vgi1VA ($20.80 in chips) 
Seat 6: ljemhp25Zg+nlA9DLCIiUw ($23.60 in chips) 
Seat 7: IupaN0QS3TJoOSYaS7zF9w ($8.30 in chips) 
Seat 8: dfNim92Z6XK1/h5SFW5vDg ($25 in chips) 
Seat 9: rm0e8CshiGK8hjW46YcNqg ($29.70 in chips) 
IupaN0QS3TJoOSYaS7zF9w: posts small blind $0.10
dfNim92Z6XK1/h5SFW5vDg: posts big blind $0.25
*** HOLE CARDS ***
rm0e8CshiGK8hjW46YcNqg: calls $0.25
zDrucyjVn5aeekNEc3cJrA: folds 
GmQux9F6mgOHtI4C9bVTNQ said, "Gold Coast isn't so hot, but next to the Rio.  and really cheap."
1K6QGyJP9P9xmRac2fH4OQ: folds 
Vhpns1oAZs77VUIptmuKDw: raises $0.50 to $0.75
GmQux9F6mgOHtI4C9bVTNQ: folds 
M/9j4wkHH9i1JM51vgi1VA: folds 
GmQux9F6mgOHtI4C9bVTNQ said, "i just hope i don't get crabs"
ljemhp25Zg+nlA9DLCIiUw: folds 
IupaN0QS3TJoOSYaS7zF9w: folds 
dfNim92Z6XK1/h5SFW5vDg: folds 
rm0e8CshiGK8hjW46YcNqg: folds 
Uncalled bet ($0.50) returned to Vhpns1oAZs77VUIptmuKDw
Vhpns1oAZs77VUIptmuKDw collected $0.85 from pot
IupaN0QS3TJoOSYaS7zF9w said, "well that cuts down on cab fair too"
*** SUMMARY ***
Total pot $0.85 | Rake $0 
Seat 1: zDrucyjVn5aeekNEc3cJrA folded before Flop (didn't bet)
Seat 2: 1K6QGyJP9P9xmRac2fH4OQ folded before Flop (didn't bet)
Seat 3: Vhpns1oAZs77VUIptmuKDw collected ($0.85)
Seat 4: GmQux9F6mgOHtI4C9bVTNQ folded before Flop (didn't bet)
Seat 5: M/9j4wkHH9i1JM51vgi1VA folded before Flop (didn't bet)
Seat 6: ljemhp25Zg+nlA9DLCIiUw (button) folded before Flop (didn't bet)
Seat 7: IupaN0QS3TJoOSYaS7zF9w (small blind) folded before Flop
Seat 8: dfNim92Z6XK1/h5SFW5vDg (big blind) folded before Flop
Seat 9: rm0e8CshiGK8hjW46YcNqg folded before Flop




PokerStars Game #59939375994:  Hold'em No Limit ($0.10/$0.25) - 2009/07/01 0:38:16 ET
Table '50f2Xa1b1jp6cfdTAgXFIg' 9-max Seat #6 is the button
Seat 1: JwUqpgqGHS96sdpExhhEqw ($8.60 in chips) 
Seat 2: OfGfQFPcghysTDljS9GQSQ ($18.50 in chips) 
Seat 3: aZHZRdpOTHSm1zLmzd6+ww ($24.75 in chips) 
Seat 4: ghNKXUBl/H+t83JF079ZBA ($25.85 in chips) 
Seat 5: OlPJsgR4xypSg/w1z7Gyvw ($55.75 in chips) 
Seat 6: Vl8zO7J9ZOnk8Og8eXFezg ($40.40 in chips) 
Seat 7: TeWJxSETzbXGiYKx0y+dtg ($24.75 in chips) 
Seat 8: jeKWRUkMaVn8rEUjnJKqpg ($25.35 in chips) 
Seat 9: gehe91e0IyVT0QU/XBkEyg ($25 in chips) 
TeWJxSETzbXGiYKx0y+dtg: posts small blind $0.10
jeKWRUkMaVn8rEUjnJKqpg: posts big blind $0.25
*** HOLE CARDS ***
gehe91e0IyVT0QU/XBkEyg: folds 
JwUqpgqGHS96sdpExhhEqw: folds 
OfGfQFPcghysTDljS9GQSQ: calls $0.25
aZHZRdpOTHSm1zLmzd6+ww: calls $0.25
ghNKXUBl/H+t83JF079ZBA: calls $0.25
OlPJsgR4xypSg/w1z7Gyvw: folds 
Vl8zO7J9ZOnk8Og8eXFezg: folds 
TeWJxSETzbXGiYKx0y+dtg: calls $0.15
jeKWRUkMaVn8rEUjnJKqpg: raises $1 to $1.25
OfGfQFPcghysTDljS9GQSQ: folds 
aZHZRdpOTHSm1zLmzd6+ww: calls $1
ghNKXUBl/H+t83JF079ZBA: calls $1
TeWJxSETzbXGiYKx0y+dtg: calls $1
*** FLOP *** [5h 3d 6c]
TeWJxSETzbXGiYKx0y+dtg: checks 
jeKWRUkMaVn8rEUjnJKqpg: checks 
aZHZRdpOTHSm1zLmzd6+ww: checks 
ghNKXUBl/H+t83JF079ZBA: bets $3
TeWJxSETzbXGiYKx0y+dtg: folds 
jeKWRUkMaVn8rEUjnJKqpg: folds 
aZHZRdpOTHSm1zLmzd6+ww: folds 
Uncalled bet ($3) returned to ghNKXUBl/H+t83JF079ZBA
ghNKXUBl/H+t83JF079ZBA collected $5 from pot
ghNKXUBl/H+t83JF079ZBA: doesn't show hand 
*** SUMMARY ***
Total pot $5.25 | Rake $0.25 
Board [5h 3d 6c]
Seat 1: JwUqpgqGHS96sdpExhhEqw folded before Flop (didn't bet)
Seat 2: OfGfQFPcghysTDljS9GQSQ folded before Flop
Seat 3: aZHZRdpOTHSm1zLmzd6+ww folded on the Flop
Seat 4: ghNKXUBl/H+t83JF079ZBA collected ($5)
Seat 5: OlPJsgR4xypSg/w1z7Gyvw folded before Flop (didn't bet)
Seat 6: Vl8zO7J9ZOnk8Og8eXFezg (button) folded before Flop (didn't bet)
Seat 7: TeWJxSETzbXGiYKx0y+dtg (small blind) folded on the Flop
Seat 8: jeKWRUkMaVn8rEUjnJKqpg (big blind) folded on the Flop
Seat 9: gehe91e0IyVT0QU/XBkEyg folded before Flop (didn't bet)




PokerStars Game #59939375840:  Hold'em No Limit ($0.10/$0.25) - 2009/07/01 0:38:16 ET
Table '6wawJ+MkkvuC3coG6r+Yhg' 6-max Seat #3 is the button
Seat 1: ELW+DKizJhLK7k40PMkD2Q ($25 in chips) 
Seat 3: KYBwVA7jgmSrbIEbEGElVg ($20.45 in chips) 
Seat 4: cS21pIxRHx5Gt42o7hPZzw ($11.15 in chips) 
Seat 5: A8uIskXJTblhVXWuYr+lkw ($15 in chips) 
cS21pIxRHx5Gt42o7hPZzw: posts small blind $0.10
A8uIskXJTblhVXWuYr+lkw: posts big blind $0.25
LtASJ9OlkqGrrUKGQlpGAw: sits out 
*** HOLE CARDS ***
ELW+DKizJhLK7k40PMkD2Q: folds 
KYBwVA7jgmSrbIEbEGElVg: calls $0.25
cS21pIxRHx5Gt42o7hPZzw: calls $0.15
A8uIskXJTblhVXWuYr+lkw: checks 
*** FLOP *** [4h 5c 8s]
cS21pIxRHx5Gt42o7hPZzw: checks 
A8uIskXJTblhVXWuYr+lkw: checks 
KYBwVA7jgmSrbIEbEGElVg: checks 
*** TURN *** [4h 5c 8s] [Jc]
cS21pIxRHx5Gt42o7hPZzw: bets $0.50
A8uIskXJTblhVXWuYr+lkw: folds 
KYBwVA7jgmSrbIEbEGElVg: calls $0.50
*** RIVER *** [4h 5c 8s Jc] [7h]
cS21pIxRHx5Gt42o7hPZzw: bets $0.75
KYBwVA7jgmSrbIEbEGElVg: calls $0.75
*** SHOW DOWN ***
cS21pIxRHx5Gt42o7hPZzw: shows [7d 8h] (two pair, Eights and Sevens)
KYBwVA7jgmSrbIEbEGElVg: mucks hand 
cS21pIxRHx5Gt42o7hPZzw collected $3.10 from pot
*** SUMMARY ***
Total pot $3.25 | Rake $0.15 
Board [4h 5c 8s Jc 7h]
Seat 1: ELW+DKizJhLK7k40PMkD2Q folded before Flop (didn't bet)
Seat 3: KYBwVA7jgmSrbIEbEGElVg (button) mucked
Seat 4: cS21pIxRHx5Gt42o7hPZzw (small blind) showed [7d 8h] and won ($3.10) with two pair, Eights and Sevens
Seat 5: A8uIskXJTblhVXWuYr+lkw (big blind) folded on the Turn




PokerStars Game #59939376064:  Hold'em No Limit ($0.10/$0.25) - 2009/07/01 0:38:16 ET
Table 'LG9H161ZAHDkOww+ih3Ptg' 6-max Seat #2 is the button
Seat 1: avl8CO/tc0F6eVSiB/KNRA ($25 in chips) 
Seat 2: 9jSiy0meE9XJKkdIZwyTEQ ($30.45 in chips) 
Seat 3: sT4sjqzVMH/fZHz0hkbIPw ($35.05 in chips) 
Seat 4: 0C28L4/59aRNtHoBhqTcLg ($35.05 in chips) 
Seat 5: oseFhpinoe+Zg4j5xyBjyQ ($43.90 in chips) 
sT4sjqzVMH/fZHz0hkbIPw: posts small blind $0.10
0C28L4/59aRNtHoBhqTcLg: posts big blind $0.25
avl8CO/tc0F6eVSiB/KNRA: posts big blind $0.25
*** HOLE CARDS ***
oseFhpinoe+Zg4j5xyBjyQ: folds 
avl8CO/tc0F6eVSiB/KNRA: checks 
9jSiy0meE9XJKkdIZwyTEQ: raises $1.25 to $1.50
sT4sjqzVMH/fZHz0hkbIPw: calls $1.40
0C28L4/59aRNtHoBhqTcLg: folds 
avl8CO/tc0F6eVSiB/KNRA: folds 
*** FLOP *** [Js Kc Jd]
sT4sjqzVMH/fZHz0hkbIPw: bets $2.75
9jSiy0meE9XJKkdIZwyTEQ: folds 
Uncalled bet ($2.75) returned to sT4sjqzVMH/fZHz0hkbIPw
sT4sjqzVMH/fZHz0hkbIPw collected $3.35 from pot
sT4sjqzVMH/fZHz0hkbIPw: doesn't show hand 
*** SUMMARY ***
Total pot $3.50 | Rake $0.15 
Board [Js Kc Jd]
Seat 1: avl8CO/tc0F6eVSiB/KNRA folded before Flop
Seat 2: 9jSiy0meE9XJKkdIZwyTEQ (button) folded on the Flop
Seat 3: sT4sjqzVMH/fZHz0hkbIPw (small blind) collected ($3.35)
Seat 4: 0C28L4/59aRNtHoBhqTcLg (big blind) folded before Flop
Seat 5: oseFhpinoe+Zg4j5xyBjyQ folded before Flop (didn't bet)




PokerStars Game #59939376122:  Hold'em No Limit ($0.10/$0.25) - 2009/07/01 0:38:16 ET
Table 'vFZR6Kf2Th5xBXT9brGW6A' 6-max Seat #1 is the button
Seat 1: xRkU4+naLuz7dEZFbOn9cw ($35.30 in chips) 
Seat 2: REnO5xiZ66YabxDXq2ncvA ($51.45 in chips) 
Seat 4: 79ID/ub1Pt/mDpCprVmOoA ($25 in chips) 
Seat 5: NhUN/JpAprdJeamFBgJH1w ($25.35 in chips) 
Seat 6: d0J1xuhsynEY81YHwAvJ5g ($25 in chips) 
REnO5xiZ66YabxDXq2ncvA: posts small blind $0.10
79ID/ub1Pt/mDpCprVmOoA: posts big blind $0.25
*** HOLE CARDS ***
NhUN/JpAprdJeamFBgJH1w: folds 
d0J1xuhsynEY81YHwAvJ5g: folds 
xRkU4+naLuz7dEZFbOn9cw: folds 
REnO5xiZ66YabxDXq2ncvA: raises $0.75 to $1
79ID/ub1Pt/mDpCprVmOoA: folds 
Uncalled bet ($0.75) returned to REnO5xiZ66YabxDXq2ncvA
REnO5xiZ66YabxDXq2ncvA collected $0.50 from pot
*** SUMMARY ***
Total pot $0.50 | Rake $0 
Seat 1: xRkU4+naLuz7dEZFbOn9cw (button) folded before Flop (didn't bet)
Seat 2: REnO5xiZ66YabxDXq2ncvA (small blind) collected ($0.50)
Seat 4: 79ID/ub1Pt/mDpCprVmOoA (big blind) folded before Flop
Seat 5: NhUN/JpAprdJeamFBgJH1w folded before Flop (didn't bet)
Seat 6: d0J1xuhsynEY81YHwAvJ5g folded before Flop (didn't bet)




PokerStars Game #59939376148:  Hold'em No Limit ($0.10/$0.25) - 2009/07/01 0:38:16 ET
Table 'yRuHgMpxv4rPBXeM6HFESw' 6-max Seat #2 is the button
Seat 2: iwlxXocltgSdaBmusNXanQ ($16.95 in chips) 
Seat 3: zZ8zH49EwNs0mqgppOaL9g ($50.65 in chips) 
Seat 4: ypXnt+kzrF/5y8QN2rkt1A ($17.70 in chips) 
Seat 5: gaPMxLGp9SOj4Lq6t+/0Ig ($14.75 in chips) 
Seat 6: 4YSTu0Cdzpppe1lUgCZGCQ ($25 in chips) 
zZ8zH49EwNs0mqgppOaL9g: posts small blind $0.10
ypXnt+kzrF/5y8QN2rkt1A: posts big blind $0.25
*** HOLE CARDS ***
gaPMxLGp9SOj4Lq6t+/0Ig: folds 
4YSTu0Cdzpppe1lUgCZGCQ: folds 
iwlxXocltgSdaBmusNXanQ: raises $0.50 to $0.75
zZ8zH49EwNs0mqgppOaL9g: folds 
ypXnt+kzrF/5y8QN2rkt1A: calls $0.50
*** FLOP *** [Kh 2d 9c]
ypXnt+kzrF/5y8QN2rkt1A: bets $0.25
iwlxXocltgSdaBmusNXanQ: calls $0.25
*** TURN *** [Kh 2d 9c] [8s]
ypXnt+kzrF/5y8QN2rkt1A: bets $0.50
iwlxXocltgSdaBmusNXanQ: calls $0.50
*** RIVER *** [Kh 2d 9c 8s] [2s]
ypXnt+kzrF/5y8QN2rkt1A: bets $0.75
iwlxXocltgSdaBmusNXanQ: folds 
Uncalled bet ($0.75) returned to ypXnt+kzrF/5y8QN2rkt1A
ypXnt+kzrF/5y8QN2rkt1A collected $2.95 from pot
*** SUMMARY ***
Total pot $3.10 | Rake $0.15 
Board [Kh 2d 9c 8s 2s]
Seat 2: iwlxXocltgSdaBmusNXanQ (button) folded on the River
Seat 3: zZ8zH49EwNs0mqgppOaL9g (small blind) folded before Flop
Seat 4: ypXnt+kzrF/5y8QN2rkt1A (big blind) collected ($2.95)
Seat 5: gaPMxLGp9SOj4Lq6t+/0Ig folded before Flop (didn't bet)
Seat 6: 4YSTu0Cdzpppe1lUgCZGCQ folded before Flop (didn't bet)




PokerStars Game #59939375814:  Hold'em No Limit ($0.10/$0.25) - 2009/07/01 0:38:16 ET
Table 'LwnjzXstPtSrqrV/oDpnXQ' 9-max Seat #1 is the button
Seat 1: sChhj/mp8dm+nGvBS5mOIA ($16.55 in chips) 
Seat 2: K7bAhhMMJ/XcTmGaBZVfFQ ($28.60 in chips) 
Seat 3: u+XLsbPQIcRvPRnS1bvZww ($11.35 in chips) 
Seat 4: nmvbguGv4wKulGg49bANbQ ($15.50 in chips) 
Seat 6: ljemhp25Zg+nlA9DLCIiUw ($31.65 in chips) 
Seat 8: h4ggJZYBXV0mEZzYPYKfeA ($32.80 in chips) 
Seat 9: N6fYvIzQLKaydFLKQGtMlQ ($24.65 in chips) 
K7bAhhMMJ/XcTmGaBZVfFQ: posts small blind $0.10
u+XLsbPQIcRvPRnS1bvZww: posts big blind $0.25
Th3FldXKQW6hWVVPahaoOQ: sits out 
*** HOLE CARDS ***
nmvbguGv4wKulGg49bANbQ: calls $0.25
ljemhp25Zg+nlA9DLCIiUw: calls $0.25
h4ggJZYBXV0mEZzYPYKfeA: folds 
N6fYvIzQLKaydFLKQGtMlQ: calls $0.25
sChhj/mp8dm+nGvBS5mOIA: calls $0.25
K7bAhhMMJ/XcTmGaBZVfFQ: calls $0.15
u+XLsbPQIcRvPRnS1bvZww: checks 
*** FLOP *** [8h As 3d]
K7bAhhMMJ/XcTmGaBZVfFQ: checks 
u+XLsbPQIcRvPRnS1bvZww: checks 
nmvbguGv4wKulGg49bANbQ: bets $0.50
ljemhp25Zg+nlA9DLCIiUw: folds 
N6fYvIzQLKaydFLKQGtMlQ: folds 
sChhj/mp8dm+nGvBS5mOIA: calls $0.50
K7bAhhMMJ/XcTmGaBZVfFQ: folds 
u+XLsbPQIcRvPRnS1bvZww: folds 
*** TURN *** [8h As 3d] [5s]
nmvbguGv4wKulGg49bANbQ: bets $0.50
sChhj/mp8dm+nGvBS5mOIA: calls $0.50
*** RIVER *** [8h As 3d 5s] [7c]
nmvbguGv4wKulGg49bANbQ: bets $0.50
sChhj/mp8dm+nGvBS5mOIA: calls $0.50
*** SHOW DOWN ***
nmvbguGv4wKulGg49bANbQ: shows [Jd Jh] (a pair of Jacks)
sChhj/mp8dm+nGvBS5mOIA: shows [Ts Ac] (a pair of Aces)
sChhj/mp8dm+nGvBS5mOIA collected $4.30 from pot
*** SUMMARY ***
Total pot $4.50 | Rake $0.20 
Board [8h As 3d 5s 7c]
Seat 1: sChhj/mp8dm+nGvBS5mOIA (button) showed [Ts Ac] and won ($4.30) with a pair of Aces
Seat 2: K7bAhhMMJ/XcTmGaBZVfFQ (small blind) folded on the Flop
Seat 3: u+XLsbPQIcRvPRnS1bvZww (big blind) folded on the Flop
Seat 4: nmvbguGv4wKulGg49bANbQ showed [Jd Jh] and lost with a pair of Jacks
Seat 6: ljemhp25Zg+nlA9DLCIiUw folded on the Flop
Seat 8: h4ggJZYBXV0mEZzYPYKfeA folded before Flop (didn't bet)
Seat 9: N6fYvIzQLKaydFLKQGtMlQ folded on the Flop




PokerStars Game #59939376480:  Hold'em No Limit ($0.10/$0.25) - 2009/07/01 0:38:17 ET
Table 'srBTB98reCdD1TffxE6o7g' 6-max Seat #4 is the button
Seat 1: FEzezmgaiyVRh9sHKhd+9Q ($44.25 in chips) 
Seat 2: YaAEMJGY5tem39deCUQRNw ($61.35 in chips) 
Seat 3: 4YSTu0Cdzpppe1lUgCZGCQ ($35.50 in chips) 
Seat 4: nGcD53mEekM1riwMpyBSXw ($5.05 in chips) 
Seat 5: n2OZezRXTtdzQt4SuIy8TQ ($19.60 in chips) 
Seat 6: gaPMxLGp9SOj4Lq6t+/0Ig ($15.10 in chips) 
n2OZezRXTtdzQt4SuIy8TQ: posts small blind $0.10
gaPMxLGp9SOj4Lq6t+/0Ig: posts big blind $0.25
*** HOLE CARDS ***
FEzezmgaiyVRh9sHKhd+9Q: folds 
YaAEMJGY5tem39deCUQRNw: folds 
4YSTu0Cdzpppe1lUgCZGCQ: raises $0.75 to $1
nGcD53mEekM1riwMpyBSXw: folds 
n2OZezRXTtdzQt4SuIy8TQ: calls $0.90
gaPMxLGp9SOj4Lq6t+/0Ig: folds 
*** FLOP *** [5d Qd 9c]
n2OZezRXTtdzQt4SuIy8TQ: checks 
4YSTu0Cdzpppe1lUgCZGCQ: bets $1.50
n2OZezRXTtdzQt4SuIy8TQ: folds 
Uncalled bet ($1.50) returned to 4YSTu0Cdzpppe1lUgCZGCQ
4YSTu0Cdzpppe1lUgCZGCQ collected $2.15 from pot
4YSTu0Cdzpppe1lUgCZGCQ: doesn't show hand 
*** SUMMARY ***
Total pot $2.25 | Rake $0.10 
Board [5d Qd 9c]
Seat 1: FEzezmgaiyVRh9sHKhd+9Q folded before Flop (didn't bet)
Seat 2: YaAEMJGY5tem39deCUQRNw folded before Flop (didn't bet)
Seat 3: 4YSTu0Cdzpppe1lUgCZGCQ collected ($2.15)
Seat 4: nGcD53mEekM1riwMpyBSXw (button) folded before Flop (didn't bet)
Seat 5: n2OZezRXTtdzQt4SuIy8TQ (small blind) folded on the Flop
Seat 6: gaPMxLGp9SOj4Lq6t+/0Ig (big blind) folded before Flop




PokerStars Game #59939376486:  Hold'em No Limit ($0.10/$0.25) - 2009/07/01 0:38:17 ET
Table 'P2yJ+jwfNsBdF12fLKA6DQ' 9-max Seat #4 is the button
Seat 1: zDrucyjVn5aeekNEc3cJrA ($26.25 in chips) 
Seat 2: A1WO60C/QOiRxQuPxxQ/Qw ($22.80 in chips) 
Seat 3: aNpwfA31EREwO+ar4XzBCw ($27.20 in chips) 
Seat 4: dfNim92Z6XK1/h5SFW5vDg ($25 in chips) 
Seat 5: KUcJLaHvrSlvGyIGqDQp9A ($9.30 in chips) 
Seat 6: tIIUJycKjdqE3z/SXWAEwA ($5.15 in chips) 
Seat 8: LWN1wPrLH+695JIriXxDuw ($4.20 in chips) 
Seat 9: Jurq55Mpn9JwRMif6CgVxw ($9.45 in chips) 
KUcJLaHvrSlvGyIGqDQp9A: posts small blind $0.10
tIIUJycKjdqE3z/SXWAEwA: posts big blind $0.25
guerita69: sits out 
*** HOLE CARDS ***
LWN1wPrLH+695JIriXxDuw: folds 
Jurq55Mpn9JwRMif6CgVxw: calls $0.25
zDrucyjVn5aeekNEc3cJrA: folds 
A1WO60C/QOiRxQuPxxQ/Qw: folds 
aNpwfA31EREwO+ar4XzBCw: folds 
dfNim92Z6XK1/h5SFW5vDg: calls $0.25
KUcJLaHvrSlvGyIGqDQp9A: calls $0.15
tIIUJycKjdqE3z/SXWAEwA: checks 
*** FLOP *** [2c 5h Ad]
KUcJLaHvrSlvGyIGqDQp9A: bets $0.25
tIIUJycKjdqE3z/SXWAEwA: calls $0.25
Jurq55Mpn9JwRMif6CgVxw: raises $0.50 to $0.75
dfNim92Z6XK1/h5SFW5vDg: folds 
KUcJLaHvrSlvGyIGqDQp9A: calls $0.50
tIIUJycKjdqE3z/SXWAEwA: calls $0.50
*** TURN *** [2c 5h Ad] [Qh]
KUcJLaHvrSlvGyIGqDQp9A: checks 
tIIUJycKjdqE3z/SXWAEwA: checks 
Jurq55Mpn9JwRMif6CgVxw: bets $0.75
KUcJLaHvrSlvGyIGqDQp9A: raises $1.25 to $2
tIIUJycKjdqE3z/SXWAEwA: folds 
Jurq55Mpn9JwRMif6CgVxw: calls $1.25
*** RIVER *** [2c 5h Ad Qh] [7h]
KUcJLaHvrSlvGyIGqDQp9A: bets $3
Jurq55Mpn9JwRMif6CgVxw: calls $3
*** SHOW DOWN ***
KUcJLaHvrSlvGyIGqDQp9A: shows [4s 3d] (a straight, Ace to Five)
Jurq55Mpn9JwRMif6CgVxw: mucks hand 
KUcJLaHvrSlvGyIGqDQp9A collected $12.65 from pot
*** SUMMARY ***
Total pot $13.25 | Rake $0.60 
Board [2c 5h Ad Qh 7h]
Seat 1: zDrucyjVn5aeekNEc3cJrA folded before Flop (didn't bet)
Seat 2: A1WO60C/QOiRxQuPxxQ/Qw folded before Flop (didn't bet)
Seat 3: aNpwfA31EREwO+ar4XzBCw folded before Flop (didn't bet)
Seat 4: dfNim92Z6XK1/h5SFW5vDg (button) folded on the Flop
Seat 5: KUcJLaHvrSlvGyIGqDQp9A (small blind) showed [4s 3d] and won ($12.65) with a straight, Ace to Five
Seat 6: tIIUJycKjdqE3z/SXWAEwA (big blind) folded on the Turn
Seat 8: LWN1wPrLH+695JIriXxDuw folded before Flop (didn't bet)
Seat 9: Jurq55Mpn9JwRMif6CgVxw mucked




PokerStars Game #59939376538:  Hold'em No Limit ($0.10/$0.25) - 2009/07/01 0:38:17 ET
Table '0mmHveGuaIfIMQlNE1eqMg' 9-max Seat #8 is the button
Seat 1: 7QzbjWT00wQpau1iqvUmMA ($5 in chips) 
Seat 2: rQhYIYXSyH/IivYM1dlV5A ($52.40 in chips) 
Seat 3: ghNKXUBl/H+t83JF079ZBA ($26.40 in chips) 
Seat 4: r0/CtYRRIJAbPQm4qsv8LQ ($35.50 in chips) 
Seat 5: cVVfy+hwCb/YzSIyUWhKEw ($33 in chips) 
Seat 6: Xo1w+VqEZh0bV5wYupnNYg ($25.65 in chips) 
Seat 8: jiyia7h6fmxBdWBkH9lH5A ($2.95 in chips) 
Seat 9: W4TLQcZ2TiM73eIgpIvlGg ($25 in chips) 
W4TLQcZ2TiM73eIgpIvlGg: posts small blind $0.10
7QzbjWT00wQpau1iqvUmMA: posts big blind $0.25
*** HOLE CARDS ***
rQhYIYXSyH/IivYM1dlV5A: folds 
ghNKXUBl/H+t83JF079ZBA: folds 
r0/CtYRRIJAbPQm4qsv8LQ: folds 
cVVfy+hwCb/YzSIyUWhKEw: folds 
Xo1w+VqEZh0bV5wYupnNYg: raises $0.25 to $0.50
jiyia7h6fmxBdWBkH9lH5A: folds 
W4TLQcZ2TiM73eIgpIvlGg: raises $1 to $1.50
7QzbjWT00wQpau1iqvUmMA: folds 
Xo1w+VqEZh0bV5wYupnNYg: raises $1 to $2.50
W4TLQcZ2TiM73eIgpIvlGg: calls $1
*** FLOP *** [Ts 2d Jh]
W4TLQcZ2TiM73eIgpIvlGg: checks 
Xo1w+VqEZh0bV5wYupnNYg: bets $3
W4TLQcZ2TiM73eIgpIvlGg: calls $3
*** TURN *** [Ts 2d Jh] [Jd]
W4TLQcZ2TiM73eIgpIvlGg: checks 
Xo1w+VqEZh0bV5wYupnNYg: bets $0.25
W4TLQcZ2TiM73eIgpIvlGg: calls $0.25
*** RIVER *** [Ts 2d Jh Jd] [3h]
W4TLQcZ2TiM73eIgpIvlGg: bets $4.50
Xo1w+VqEZh0bV5wYupnNYg: calls $4.50
*** SHOW DOWN ***
W4TLQcZ2TiM73eIgpIvlGg: shows [Jc Js] (four of a kind, Jacks)
Xo1w+VqEZh0bV5wYupnNYg: shows [Ah Ac] (two pair, Aces and Jacks)
W4TLQcZ2TiM73eIgpIvlGg collected $19.75 from pot
*** SUMMARY ***
Total pot $20.75 | Rake $1 
Board [Ts 2d Jh Jd 3h]
Seat 1: 7QzbjWT00wQpau1iqvUmMA (big blind) folded before Flop
Seat 2: rQhYIYXSyH/IivYM1dlV5A folded before Flop (didn't bet)
Seat 3: ghNKXUBl/H+t83JF079ZBA folded before Flop (didn't bet)
Seat 4: r0/CtYRRIJAbPQm4qsv8LQ folded before Flop (didn't bet)
Seat 5: cVVfy+hwCb/YzSIyUWhKEw folded before Flop (didn't bet)
Seat 6: Xo1w+VqEZh0bV5wYupnNYg showed [Ah Ac] and lost with two pair, Aces and Jacks
Seat 8: jiyia7h6fmxBdWBkH9lH5A (button) folded before Flop (didn't bet)
Seat 9: W4TLQcZ2TiM73eIgpIvlGg (small blind) showed [Jc Js] and won ($19.75) with four of a kind, Jacks




PokerStars Game #59939376780:  Hold'em No Limit ($0.10/$0.25) - 2009/07/01 0:38:17 ET
Table 'sCop8wmj9zlSS2KJqk1QKQ' 9-max Seat #4 is the button
Seat 1: SXqVW4Q0evTUVZG6BbUNIA ($21.90 in chips) 
Seat 2: W4TLQcZ2TiM73eIgpIvlGg ($22.80 in chips) 
Seat 3: 6TWO15+WfJ5HfI8CbJ4a0w ($3.10 in chips) 
Seat 4: KNrY0Y/j01dK9gZK7dx7QA ($14.65 in chips) 
Seat 6: hZuGwtYmFKPmQ+v1wlmdfA ($35.70 in chips) 
Seat 7: 4dd+rKHhaMiTl5LEkADvQQ ($4.65 in chips) 
Seat 8: NNZypfH1f/VIj3Skf/XIzg ($5 in chips) 
Seat 9: tOdE7+08fkUzsTpCnhoPDA ($22.70 in chips) 
sD+TKtt36XiiN6jqHiLwDA will be allowed to play after the button
hZuGwtYmFKPmQ+v1wlmdfA: posts small blind $0.10
4dd+rKHhaMiTl5LEkADvQQ: posts big blind $0.25
*** HOLE CARDS ***
NNZypfH1f/VIj3Skf/XIzg: calls $0.25
tOdE7+08fkUzsTpCnhoPDA: calls $0.25
SXqVW4Q0evTUVZG6BbUNIA: folds 
W4TLQcZ2TiM73eIgpIvlGg: folds 
6TWO15+WfJ5HfI8CbJ4a0w: calls $0.25
KNrY0Y/j01dK9gZK7dx7QA: calls $0.25
hZuGwtYmFKPmQ+v1wlmdfA: calls $0.15
4dd+rKHhaMiTl5LEkADvQQ: checks 
*** FLOP *** [6d Jc Kh]
hZuGwtYmFKPmQ+v1wlmdfA: checks 
4dd+rKHhaMiTl5LEkADvQQ: checks 
NNZypfH1f/VIj3Skf/XIzg: checks 
tOdE7+08fkUzsTpCnhoPDA: checks 
6TWO15+WfJ5HfI8CbJ4a0w: bets $0.50
KNrY0Y/j01dK9gZK7dx7QA: folds 
hZuGwtYmFKPmQ+v1wlmdfA: folds 
4dd+rKHhaMiTl5LEkADvQQ: folds 
NNZypfH1f/VIj3Skf/XIzg: folds 
tOdE7+08fkUzsTpCnhoPDA: folds 
Uncalled bet ($0.50) returned to 6TWO15+WfJ5HfI8CbJ4a0w
6TWO15+WfJ5HfI8CbJ4a0w collected $1.45 from pot
6TWO15+WfJ5HfI8CbJ4a0w: doesn't show hand 
*** SUMMARY ***
Total pot $1.50 | Rake $0.05 
Board [6d Jc Kh]
Seat 1: SXqVW4Q0evTUVZG6BbUNIA folded before Flop (didn't bet)
Seat 2: W4TLQcZ2TiM73eIgpIvlGg folded before Flop (didn't bet)
Seat 3: 6TWO15+WfJ5HfI8CbJ4a0w collected ($1.45)
Seat 4: KNrY0Y/j01dK9gZK7dx7QA (button) folded on the Flop
Seat 6: hZuGwtYmFKPmQ+v1wlmdfA (small blind) folded on the Flop
Seat 7: 4dd+rKHhaMiTl5LEkADvQQ (big blind) folded on the Flop
Seat 8: NNZypfH1f/VIj3Skf/XIzg folded on the Flop
Seat 9: tOdE7+08fkUzsTpCnhoPDA folded on the Flop




PokerStars Game #59939376722:  Hold'em No Limit ($0.10/$0.25) - 2009/07/01 0:38:17 ET
Table 'IfRHUn9gQQA9I/Z4tn+BoA' 9-max Seat #2 is the button
Seat 1: vSkQm2EelzwRGDDQQk0Fqw ($4.65 in chips) 
Seat 2: zgWbKMp0/btzsnVbQWKXww ($16.30 in chips) 
Seat 3: iAQDnrJCZVD1LzAGxTYegw ($26.35 in chips) 
Seat 4: QEbIGci+itdw+re8RM5fZA ($25 in chips) 
Seat 5: 10584482 ($14.85 in chips) 
Seat 6: UOjoGGQ58/uDS7V0xkjOrQ ($8.30 in chips) 
Seat 7: TeWJxSETzbXGiYKx0y+dtg ($25.50 in chips) 
Seat 8: cZ99hugmLBj9KhTlc8nCSw ($25 in chips) 
iAQDnrJCZVD1LzAGxTYegw: posts small blind $0.10
QEbIGci+itdw+re8RM5fZA: posts big blind $0.25
7cv+9Zc9HIQHNvYsMfV3uA: sits out 
*** HOLE CARDS ***
10584482: folds 
UOjoGGQ58/uDS7V0xkjOrQ: folds 
TeWJxSETzbXGiYKx0y+dtg: raises $0.50 to $0.75
cZ99hugmLBj9KhTlc8nCSw: folds 
vSkQm2EelzwRGDDQQk0Fqw: folds 
zgWbKMp0/btzsnVbQWKXww: folds 
iAQDnrJCZVD1LzAGxTYegw: folds 
QEbIGci+itdw+re8RM5fZA: folds 
Uncalled bet ($0.50) returned to TeWJxSETzbXGiYKx0y+dtg
TeWJxSETzbXGiYKx0y+dtg collected $0.60 from pot
TeWJxSETzbXGiYKx0y+dtg: doesn't show hand 
*** SUMMARY ***
Total pot $0.60 | Rake $0 
Seat 1: vSkQm2EelzwRGDDQQk0Fqw folded before Flop (didn't bet)
Seat 2: zgWbKMp0/btzsnVbQWKXww (button) folded before Flop (didn't bet)
Seat 3: iAQDnrJCZVD1LzAGxTYegw (small blind) folded before Flop
Seat 4: QEbIGci+itdw+re8RM5fZA (big blind) folded before Flop
Seat 5: 10584482 folded before Flop (didn't bet)
Seat 6: UOjoGGQ58/uDS7V0xkjOrQ folded before Flop (didn't bet)
Seat 7: TeWJxSETzbXGiYKx0y+dtg collected ($0.60)
Seat 8: cZ99hugmLBj9KhTlc8nCSw folded before Flop (didn't bet)




PokerStars Game #59939376420:  Hold'em No Limit ($0.10/$0.25) - 2009/07/01 0:38:17 ET
Table 'Rv0EYnRU8WwZiwx0Zo3X3w' 9-max Seat #7 is the button
Seat 1: opOCI2p6kW0tINuVaAqmcQ ($48.15 in chips) 
Seat 2: Xpyqpb+DURDWnyJ3xTEIFQ ($39.90 in chips) 
Seat 3: STkR8XvpjNv79OOMhrlh2w ($25 in chips) 
Seat 4: IDkfbfxTm9KJ+DMyGVH8rw ($12.05 in chips) 
Seat 5: h4ggJZYBXV0mEZzYPYKfeA ($20.85 in chips) 
Seat 6: 5hAPbqNrvJb8PtLiceXtlg ($4.65 in chips) 
Seat 7: Th3FldXKQW6hWVVPahaoOQ ($32.55 in chips) 
Seat 9: r1pFKMwWp74QwhfPWJOAyw ($6.70 in chips) 
r1pFKMwWp74QwhfPWJOAyw: posts small blind $0.10
opOCI2p6kW0tINuVaAqmcQ: posts big blind $0.25
*** HOLE CARDS ***
Xpyqpb+DURDWnyJ3xTEIFQ: folds 
STkR8XvpjNv79OOMhrlh2w: folds 
IDkfbfxTm9KJ+DMyGVH8rw: folds 
h4ggJZYBXV0mEZzYPYKfeA: folds 
5hAPbqNrvJb8PtLiceXtlg: folds 
Th3FldXKQW6hWVVPahaoOQ: folds 
r1pFKMwWp74QwhfPWJOAyw: folds 
Uncalled bet ($0.15) returned to opOCI2p6kW0tINuVaAqmcQ
opOCI2p6kW0tINuVaAqmcQ collected $0.20 from pot
opOCI2p6kW0tINuVaAqmcQ: doesn't show hand 
*** SUMMARY ***
Total pot $0.20 | Rake $0 
Seat 1: opOCI2p6kW0tINuVaAqmcQ (big blind) collected ($0.20)
Seat 2: Xpyqpb+DURDWnyJ3xTEIFQ folded before Flop (didn't bet)
Seat 3: STkR8XvpjNv79OOMhrlh2w folded before Flop (didn't bet)
Seat 4: IDkfbfxTm9KJ+DMyGVH8rw folded before Flop (didn't bet)
Seat 5: h4ggJZYBXV0mEZzYPYKfeA folded before Flop (didn't bet)
Seat 6: 5hAPbqNrvJb8PtLiceXtlg folded before Flop (didn't bet)
Seat 7: Th3FldXKQW6hWVVPahaoOQ (button) folded before Flop (didn't bet)
Seat 9: r1pFKMwWp74QwhfPWJOAyw (small blind) folded before Flop




PokerStars Game #59939376336:  Hold'em No Limit ($0.10/$0.25) - 2009/07/01 0:38:17 ET
Table 'MQJMxKDF6VYBWIKv7VfCog' 9-max Seat #3 is the button
Seat 1: cZ99hugmLBj9KhTlc8nCSw ($25.80 in chips) 
Seat 2: JxpnpCmvRAcrEUy7mq1iAg ($5.20 in chips) 
Seat 3: EfRs3ibIxn+c9JDErwwNCg ($26.05 in chips) 
Seat 4: JtVGnq5doRa3PublncR+Yw ($24 in chips) 
Seat 5: RJ/x9oZtt1RZLaJEQwZOxQ ($25.95 in chips) 
Seat 6: ydoFOVgzvZv9ZhuWu9rXAw ($5 in chips) 
Seat 7: dfNim92Z6XK1/h5SFW5vDg ($55.30 in chips) 
Seat 8: Z9AeOQX3yzuSvKAm/xyovg ($9.65 in chips) 
Seat 9: 1S/fpm+f42V/6MNZre+ccg ($34.10 in chips) 
JtVGnq5doRa3PublncR+Yw: posts small blind $0.10
RJ/x9oZtt1RZLaJEQwZOxQ: posts big blind $0.25
*** HOLE CARDS ***
ydoFOVgzvZv9ZhuWu9rXAw: folds 
dfNim92Z6XK1/h5SFW5vDg: folds 
Z9AeOQX3yzuSvKAm/xyovg: folds 
1S/fpm+f42V/6MNZre+ccg: folds 
cZ99hugmLBj9KhTlc8nCSw: folds 
JxpnpCmvRAcrEUy7mq1iAg: folds 
EfRs3ibIxn+c9JDErwwNCg: folds 
JtVGnq5doRa3PublncR+Yw: calls $0.15
RJ/x9oZtt1RZLaJEQwZOxQ: checks 
*** FLOP *** [5h 4c 8h]
JtVGnq5doRa3PublncR+Yw: bets $0.25
RJ/x9oZtt1RZLaJEQwZOxQ: folds 
Uncalled bet ($0.25) returned to JtVGnq5doRa3PublncR+Yw
JtVGnq5doRa3PublncR+Yw collected $0.50 from pot
*** SUMMARY ***
Total pot $0.50 | Rake $0 
Board [5h 4c 8h]
Seat 1: cZ99hugmLBj9KhTlc8nCSw folded before Flop (didn't bet)
Seat 2: JxpnpCmvRAcrEUy7mq1iAg folded before Flop (didn't bet)
Seat 3: EfRs3ibIxn+c9JDErwwNCg (button) folded before Flop (didn't bet)
Seat 4: JtVGnq5doRa3PublncR+Yw (small blind) collected ($0.50)
Seat 5: RJ/x9oZtt1RZLaJEQwZOxQ (big blind) folded on the Flop
Seat 6: ydoFOVgzvZv9ZhuWu9rXAw folded before Flop (didn't bet)
Seat 7: dfNim92Z6XK1/h5SFW5vDg folded before Flop (didn't bet)
Seat 8: Z9AeOQX3yzuSvKAm/xyovg folded before Flop (didn't bet)
Seat 9: 1S/fpm+f42V/6MNZre+ccg folded before Flop (didn't bet)




PokerStars Game #59939376744:  Hold'em No Limit ($0.10/$0.25) - 2009/07/01 0:38:17 ET
Table '3lL16FBjWXTx3AjK5lMRwwgkdjhbH1jaE3hwhPRIKMiQx Seat #8 is the button
Seat 1: fDGyaQz0cs2s4FOYxkbIHA ($8.15 in chips) 
Seat 2: YK2fIgjF+Z0ARwKKcGh1fw ($17.30 in chips) 
Seat 3: QEbIGci+itdw+re8RM5fZA ($26.25 in chips) 
Seat 4: ZWU9RNYtjmm4cElg1I0F4w ($61.95 in chips) 
Seat 5: M/9j4wkHH9i1JM51vgi1VA ($21.80 in chips) 
Seat 6: hBMUlEpyU74r/fwDgIpXjQ ($41.35 in chips) 
Seat 7: JxpnpCmvRAcrEUy7mq1iAg ($5.40 in chips) 
Seat 8: ljemhp25Zg+nlA9DLCIiUw ($24.30 in chips) 
Seat 9: b8t3jWrxzeEt9HtZtc9wUQ ($10.35 in chips) 
b8t3jWrxzeEt9HtZtc9wUQ: posts small blind $0.10
fDGyaQz0cs2s4FOYxkbIHA: posts big blind $0.25
*** HOLE CARDS ***
YK2fIgjF+Z0ARwKKcGh1fw: calls $0.25
QEbIGci+itdw+re8RM5fZA: folds 
ZWU9RNYtjmm4cElg1I0F4w: folds 
M/9j4wkHH9i1JM51vgi1VA: folds 
hBMUlEpyU74r/fwDgIpXjQ: folds 
JxpnpCmvRAcrEUy7mq1iAg: folds 
ljemhp25Zg+nlA9DLCIiUw: raises $0.75 to $1
b8t3jWrxzeEt9HtZtc9wUQ: folds 
fDGyaQz0cs2s4FOYxkbIHA: folds 
YK2fIgjF+Z0ARwKKcGh1fw: calls $0.75
*** FLOP *** [7h Ac 5d]
YK2fIgjF+Z0ARwKKcGh1fw: checks 
ljemhp25Zg+nlA9DLCIiUw: checks 
*** TURN *** [7h Ac 5d] [Kh]
YK2fIgjF+Z0ARwKKcGh1fw: checks 
ljemhp25Zg+nlA9DLCIiUw: checks 
*** RIVER *** [7h Ac 5d Kh] [2s]
YK2fIgjF+Z0ARwKKcGh1fw: bets $0.75
ljemhp25Zg+nlA9DLCIiUw: folds 
Uncalled bet ($0.75) returned to YK2fIgjF+Z0ARwKKcGh1fw
YK2fIgjF+Z0ARwKKcGh1fw collected $2.25 from pot
YK2fIgjF+Z0ARwKKcGh1fw: doesn't show hand 
*** SUMMARY ***
Total pot $2.35 | Rake $0.10 
Board [7h Ac 5d Kh 2s]
Seat 1: fDGyaQz0cs2s4FOYxkbIHA (big blind) folded before Flop
Seat 2: YK2fIgjF+Z0ARwKKcGh1fw collected ($2.25)
Seat 3: QEbIGci+itdw+re8RM5fZA folded before Flop (didn't bet)
Seat 4: ZWU9RNYtjmm4cElg1I0F4w folded before Flop (didn't bet)
Seat 5: M/9j4wkHH9i1JM51vgi1VA folded before Flop (didn't bet)
Seat 6: hBMUlEpyU74r/fwDgIpXjQ folded before Flop (didn't bet)
Seat 7: JxpnpCmvRAcrEUy7mq1iAg folded before Flop (didn't bet)
Seat 8: ljemhp25Zg+nlA9DLCIiUw (button) folded on the River
Seat 9: b8t3jWrxzeEt9HtZtc9wUQ (small blind) folded before Flop




PokerStars Game #59939377266:  Hold'em No Limit ($0.10/$0.25) - 2009/07/01 0:38:18 ET
Table 'wixGE3Zge1qBdnpWijIl/w' 9-max Seat #1 is the button
Seat 1: EcWpc/mcsCWBGKsSdZaXbA ($24.65 in chips) 
Seat 2: vbD+Kd6m/X3hUBBcGpUKjA ($7.95 in chips) 
Seat 3: DdPXdieucQ+n99u1n3A+rQ ($5 in chips) 
Seat 4: 4oA316mXLIui1QY63GXBUg ($25 in chips) 
Seat 5: MIVCHqCqqlke0Lb0z7glcw ($27.05 in chips) 
Seat 6: TlEYI/zXzaKGGsmuvWFd2A ($17.45 in chips) 
Seat 7: qIaaweMCAGmy9HZFT4r/6A ($55.15 in chips) 
Seat 8: hIss79a4pu7GzJZepfgOpg ($25 in chips) 
Seat 9: r6hsffOo1iKmaPYKwAZmFw ($25.15 in chips) 
vbD+Kd6m/X3hUBBcGpUKjA: posts small blind $0.10
DdPXdieucQ+n99u1n3A+rQ: posts big blind $0.25
*** HOLE CARDS ***
4oA316mXLIui1QY63GXBUg: folds 
MIVCHqCqqlke0Lb0z7glcw: folds 
TlEYI/zXzaKGGsmuvWFd2A: folds 
qIaaweMCAGmy9HZFT4r/6A is disconnected 
qIaaweMCAGmy9HZFT4r/6A is connected 
qIaaweMCAGmy9HZFT4r/6A: calls $0.25
hIss79a4pu7GzJZepfgOpg: folds 
r6hsffOo1iKmaPYKwAZmFw: raises $1 to $1.25
EcWpc/mcsCWBGKsSdZaXbA: folds 
vbD+Kd6m/X3hUBBcGpUKjA: folds 
DdPXdieucQ+n99u1n3A+rQ: folds 
qIaaweMCAGmy9HZFT4r/6A: folds 
Uncalled bet ($1) returned to r6hsffOo1iKmaPYKwAZmFw
r6hsffOo1iKmaPYKwAZmFw collected $0.85 from pot
r6hsffOo1iKmaPYKwAZmFw: doesn't show hand 
*** SUMMARY ***
Total pot $0.85 | Rake $0 
Seat 1: EcWpc/mcsCWBGKsSdZaXbA (button) folded before Flop (didn't bet)
Seat 2: vbD+Kd6m/X3hUBBcGpUKjA (small blind) folded before Flop
Seat 3: DdPXdieucQ+n99u1n3A+rQ (big blind) folded before Flop
Seat 4: 4oA316mXLIui1QY63GXBUg folded before Flop (didn't bet)
Seat 5: MIVCHqCqqlke0Lb0z7glcw folded before Flop (didn't bet)
Seat 6: TlEYI/zXzaKGGsmuvWFd2A folded before Flop (didn't bet)
Seat 7: qIaaweMCAGmy9HZFT4r/6A folded before Flop
Seat 8: hIss79a4pu7GzJZepfgOpg folded before Flop (didn't bet)
Seat 9: r6hsffOo1iKmaPYKwAZmFw collected ($0.85)




PokerStars Game #59939377116:  Hold'em No Limit ($0.10/$0.25) - 2009/07/01 0:38:18 ET
Table 'dVzscin98UhGisTmV9BDcw' 9-max Seat #3 is the button
Seat 1: sBAwXpkpgyhyWbHIQcIJKA ($19.45 in chips) 
Seat 2: dfNim92Z6XK1/h5SFW5vDg ($29.15 in chips) 
Seat 3: 1Clf3cPrqoy/YgvWdWK1Xw ($5.25 in chips) 
Seat 4: aNpwfA31EREwO+ar4XzBCw ($25.35 in chips) 
Seat 5: ZMRQOoxoJ7Alx96gZhP2EQ ($60.45 in chips) 
Seat 6: hBMUlEpyU74r/fwDgIpXjQ ($25.25 in chips) 
Seat 7: nEg1b6MIksd/4x5eLY735g ($67.15 in chips) 
Seat 8: /vn2Qu2dvc9AMMq46Ae0jA ($5.70 in chips) 
Seat 9: OYa/ZJBO+suuezfWsUMhZw ($6.65 in chips) 
aNpwfA31EREwO+ar4XzBCw: posts small blind $0.10
ZMRQOoxoJ7Alx96gZhP2EQ: posts big blind $0.25
*** HOLE CARDS ***
hBMUlEpyU74r/fwDgIpXjQ: folds 
nEg1b6MIksd/4x5eLY735g: raises $0.60 to $0.85
/vn2Qu2dvc9AMMq46Ae0jA: folds 
OYa/ZJBO+suuezfWsUMhZw: calls $0.85
sBAwXpkpgyhyWbHIQcIJKA: folds 
dfNim92Z6XK1/h5SFW5vDg: folds 
1Clf3cPrqoy/YgvWdWK1Xw: folds 
aNpwfA31EREwO+ar4XzBCw: folds 
ZMRQOoxoJ7Alx96gZhP2EQ: calls $0.60
*** FLOP *** [8d 7c Kh]
ZMRQOoxoJ7Alx96gZhP2EQ: checks 
nEg1b6MIksd/4x5eLY735g: checks 
OYa/ZJBO+suuezfWsUMhZw: checks 
*** TURN *** [8d 7c Kh] [8c]
ZMRQOoxoJ7Alx96gZhP2EQ: bets $1.50
nEg1b6MIksd/4x5eLY735g: calls $1.50
OYa/ZJBO+suuezfWsUMhZw: folds 
*** RIVER *** [8d 7c Kh 8c] [As]
ZMRQOoxoJ7Alx96gZhP2EQ: bets $2.25
nEg1b6MIksd/4x5eLY735g: calls $2.25
*** SHOW DOWN ***
ZMRQOoxoJ7Alx96gZhP2EQ: shows [Jh Ah] (two pair, Aces and Eights)
nEg1b6MIksd/4x5eLY735g: mucks hand 
ZMRQOoxoJ7Alx96gZhP2EQ collected $9.70 from pot
*** SUMMARY ***
Total pot $10.15 | Rake $0.45 
Board [8d 7c Kh 8c As]
Seat 1: sBAwXpkpgyhyWbHIQcIJKA folded before Flop (didn't bet)
Seat 2: dfNim92Z6XK1/h5SFW5vDg folded before Flop (didn't bet)
Seat 3: 1Clf3cPrqoy/YgvWdWK1Xw (button) folded before Flop (didn't bet)
Seat 4: aNpwfA31EREwO+ar4XzBCw (small blind) folded before Flop
Seat 5: ZMRQOoxoJ7Alx96gZhP2EQ (big blind) showed [Jh Ah] and won ($9.70) with two pair, Aces and Eights
Seat 6: hBMUlEpyU74r/fwDgIpXjQ folded before Flop (didn't bet)
Seat 7: nEg1b6MIksd/4x5eLY735g mucked
Seat 8: /vn2Qu2dvc9AMMq46Ae0jA folded before Flop (didn't bet)
Seat 9: OYa/ZJBO+suuezfWsUMhZw folded on the Turn




PokerStars Game #59939377402:  Hold'em No Limit ($0.10/$0.25) - 2009/07/01 0:38:18 ET
Table '/VaaaFnlEJoYVomG9uxHkA' 9-max Seat #5 is the button
Seat 1: awQwF96aCUBjOczgehY95A ($21.80 in chips) 
Seat 2: DIkeSkosO/tsUp9d2JVyTA ($13.10 in chips) 
Seat 3: 32P5dKDi4pEUiDHMQTV1uw ($23.25 in chips) 
Seat 4: j4q3p0lesp63b1gZDwLBZw ($5 in chips) 
Seat 5: LWN1wPrLH+695JIriXxDuw ($12.60 in chips) 
Seat 6: 5MgYq10OC5iGoxQFwlJVuw ($14.55 in chips) 
Seat 7: PjjWswkn2akmg6ArntxvuA ($34.80 in chips) 
Seat 9: r1pFKMwWp74QwhfPWJOAyw ($5 in chips) 
5MgYq10OC5iGoxQFwlJVuw: posts small blind $0.10
PjjWswkn2akmg6ArntxvuA: posts big blind $0.25
*** HOLE CARDS ***
r1pFKMwWp74QwhfPWJOAyw: raises $0.50 to $0.75
awQwF96aCUBjOczgehY95A: folds 
n9toqYXSLowQ/sWq842dEQ has returned
DIkeSkosO/tsUp9d2JVyTA: folds 
32P5dKDi4pEUiDHMQTV1uw: folds 
awQwF96aCUBjOczgehY95A is sitting out
j4q3p0lesp63b1gZDwLBZw: folds 
LWN1wPrLH+695JIriXxDuw: folds 
5MgYq10OC5iGoxQFwlJVuw: folds 
PjjWswkn2akmg6ArntxvuA: calls $0.50
*** FLOP *** [8h 4c 6s]
PjjWswkn2akmg6ArntxvuA: checks 
r1pFKMwWp74QwhfPWJOAyw: bets $0.50
PjjWswkn2akmg6ArntxvuA: folds 
Uncalled bet ($0.50) returned to r1pFKMwWp74QwhfPWJOAyw
r1pFKMwWp74QwhfPWJOAyw collected $1.55 from pot
*** SUMMARY ***
Total pot $1.60 | Rake $0.05 
Board [8h 4c 6s]
Seat 1: awQwF96aCUBjOczgehY95A folded before Flop (didn't bet)
Seat 2: DIkeSkosO/tsUp9d2JVyTA folded before Flop (didn't bet)
Seat 3: 32P5dKDi4pEUiDHMQTV1uw folded before Flop (didn't bet)
Seat 4: j4q3p0lesp63b1gZDwLBZw folded before Flop (didn't bet)
Seat 5: LWN1wPrLH+695JIriXxDuw (button) folded before Flop (didn't bet)
Seat 6: 5MgYq10OC5iGoxQFwlJVuw (small blind) folded before Flop
Seat 7: PjjWswkn2akmg6ArntxvuA (big blind) folded on the Flop
Seat 9: r1pFKMwWp74QwhfPWJOAyw collected ($1.55)




PokerStars Game #59939377454:  Hold'em No Limit ($0.10/$0.25) - 2009/07/01 0:38:18 ET
Table 'eOXPe2c6mG7DOFKvMsZZfA' 6-max Seat #3 is the button
Seat 2: ELW+DKizJhLK7k40PMkD2Q ($32.75 in chips) 
Seat 3: kReyZ6g6Fu3tQ0nyjDf9kA ($14.55 in chips) 
Seat 5: NhUN/JpAprdJeamFBgJH1w ($25 in chips) 
Seat 6: wKFJ513ucluNNiMlkXcDOQ ($41.90 in chips) 
zHHLkD2sRljslKKeQv/ZQw will be allowed to play after the button
NhUN/JpAprdJeamFBgJH1w: posts small blind $0.10
wKFJ513ucluNNiMlkXcDOQ: posts big blind $0.25
ShXPHWfjhfmAwLgDdm6bRQ: sits out 
*** HOLE CARDS ***
ELW+DKizJhLK7k40PMkD2Q: raises $0.75 to $1
kReyZ6g6Fu3tQ0nyjDf9kA: folds 
NhUN/JpAprdJeamFBgJH1w: folds 
wKFJ513ucluNNiMlkXcDOQ: folds 
Uncalled bet ($0.75) returned to ELW+DKizJhLK7k40PMkD2Q
ELW+DKizJhLK7k40PMkD2Q collected $0.60 from pot
*** SUMMARY ***
Total pot $0.60 | Rake $0 
Seat 2: ELW+DKizJhLK7k40PMkD2Q collected ($0.60)
Seat 3: kReyZ6g6Fu3tQ0nyjDf9kA (button) folded before Flop (didn't bet)
Seat 5: NhUN/JpAprdJeamFBgJH1w (small blind) folded before Flop
Seat 6: wKFJ513ucluNNiMlkXcDOQ (big blind) folded before Flop




PokerStars Game #59939377404:  Hold'em No Limit ($0.10/$0.25) - 2009/07/01 0:38:18 ET
Table 'ykyWGjhNu7AvZXov27T4ew' 9-max Seat #6 is the button
Seat 2: MG90wfSJZnOejs/KD3vlQQ ($25.35 in chips) 
Seat 3: r1pFKMwWp74QwhfPWJOAyw ($6.05 in chips) 
Seat 4: hBMUlEpyU74r/fwDgIpXjQ ($25.80 in chips) 
Seat 5: lMysP2jE94oJvWGA6K5puw ($7.75 in chips) 
Seat 6: opOCI2p6kW0tINuVaAqmcQ ($25 in chips) 
Seat 8: tYsOBqdU1+x+yFI7zHO7hQ ($32.05 in chips) 
Seat 9: Yv4fucyyT28mjx8V5lxKJg ($24.65 in chips) 
tYsOBqdU1+x+yFI7zHO7hQ: posts small blind $0.10
Yv4fucyyT28mjx8V5lxKJg: posts big blind $0.25
*** HOLE CARDS ***
MG90wfSJZnOejs/KD3vlQQ: folds 
r1pFKMwWp74QwhfPWJOAyw: raises $0.25 to $0.50
hBMUlEpyU74r/fwDgIpXjQ: folds 
lMysP2jE94oJvWGA6K5puw: folds 
opOCI2p6kW0tINuVaAqmcQ: folds 
tYsOBqdU1+x+yFI7zHO7hQ: folds 
Yv4fucyyT28mjx8V5lxKJg: raises $3 to $3.50
r1pFKMwWp74QwhfPWJOAyw: folds 
Uncalled bet ($3) returned to Yv4fucyyT28mjx8V5lxKJg
Yv4fucyyT28mjx8V5lxKJg collected $1.10 from pot
Yv4fucyyT28mjx8V5lxKJg: doesn't show hand 
*** SUMMARY ***
Total pot $1.10 | Rake $0 
Seat 2: MG90wfSJZnOejs/KD3vlQQ folded before Flop (didn't bet)
Seat 3: r1pFKMwWp74QwhfPWJOAyw folded before Flop
Seat 4: hBMUlEpyU74r/fwDgIpXjQ folded before Flop (didn't bet)
Seat 5: lMysP2jE94oJvWGA6K5puw folded before Flop (didn't bet)
Seat 6: opOCI2p6kW0tINuVaAqmcQ (button) folded before Flop (didn't bet)
Seat 8: tYsOBqdU1+x+yFI7zHO7hQ (small blind) folded before Flop
Seat 9: Yv4fucyyT28mjx8V5lxKJg (big blind) collected ($1.10)




PokerStars Game #59939377170:  Hold'em No Limit ($0.10/$0.25) - 2009/07/01 0:38:18 ET
Table '+198VWQSWBhYQOcizzuBkw' 6-max Seat #4 is the button
Seat 2: R6AGToFJQOYVZAjC2jXEKw ($29.40 in chips) 
Seat 3: BYxjLnV1/LL0aZcTbfAOvw ($27.25 in chips) 
Seat 4: TgDsTeCdLQt8kWbL00ByRA ($27.60 in chips) 
Seat 5: LtASJ9OlkqGrrUKGQlpGAw ($30.55 in chips) 
Seat 6: 7qRk4YH4/k/08LgJSv7rBQ ($30.40 in chips) 
LtASJ9OlkqGrrUKGQlpGAw: posts small blind $0.10
7qRk4YH4/k/08LgJSv7rBQ: posts big blind $0.25
*** HOLE CARDS ***
R6AGToFJQOYVZAjC2jXEKw: folds 
BYxjLnV1/LL0aZcTbfAOvw: folds 
TgDsTeCdLQt8kWbL00ByRA: folds 
LtASJ9OlkqGrrUKGQlpGAw: calls $0.15
7qRk4YH4/k/08LgJSv7rBQ: raises $0.75 to $1
LtASJ9OlkqGrrUKGQlpGAw: folds 
Uncalled bet ($0.75) returned to 7qRk4YH4/k/08LgJSv7rBQ
7qRk4YH4/k/08LgJSv7rBQ collected $0.50 from pot
7qRk4YH4/k/08LgJSv7rBQ: doesn't show hand 
*** SUMMARY ***
Total pot $0.50 | Rake $0 
Seat 2: R6AGToFJQOYVZAjC2jXEKw folded before Flop (didn't bet)
Seat 3: BYxjLnV1/LL0aZcTbfAOvw folded before Flop (didn't bet)
Seat 4: TgDsTeCdLQt8kWbL00ByRA (button) folded before Flop (didn't bet)
Seat 5: LtASJ9OlkqGrrUKGQlpGAw (small blind) folded before Flop
Seat 6: 7qRk4YH4/k/08LgJSv7rBQ (big blind) collected ($0.50)




PokerStars Game #59939378074:  Hold'em No Limit ($0.10/$0.25) - 2009/07/01 0:38:19 ET
Table 'ohAuixfiLOYDylNUG5mNUw' 9-max Seat #8 is the button
Seat 1: AtRN1hdV8HbL3X4XogDaLA ($33 in chips) 
Seat 3: HVKi9hnDyvzObpL08/OarQ ($26.60 in chips) 
Seat 4: jeKWRUkMaVn8rEUjnJKqpg ($25 in chips) 
Seat 5: Z5ZtGOON8kmSdSCll9Z3XA ($16.60 in chips) 
Seat 7: WdsZPRB5ooUPinQdaX0QrA ($4.85 in chips) 
Seat 8: ppMlNkhYgErlt4fuJO7ADA ($13.20 in chips) 
Seat 9: hIss79a4pu7GzJZepfgOpg ($25.75 in chips) 
hIss79a4pu7GzJZepfgOpg: posts small blind $0.10
AtRN1hdV8HbL3X4XogDaLA: posts big blind $0.25
opOCI2p6kW0tINuVaAqmcQ: sits out 
*** HOLE CARDS ***
HVKi9hnDyvzObpL08/OarQ: folds 
jeKWRUkMaVn8rEUjnJKqpg: folds 
Z5ZtGOON8kmSdSCll9Z3XA: folds 
WdsZPRB5ooUPinQdaX0QrA: calls $0.25
ppMlNkhYgErlt4fuJO7ADA: folds 
hIss79a4pu7GzJZepfgOpg: folds 
AtRN1hdV8HbL3X4XogDaLA: checks 
*** FLOP *** [Ad 6s 7c]
AtRN1hdV8HbL3X4XogDaLA: checks 
WdsZPRB5ooUPinQdaX0QrA: bets $0.25
AtRN1hdV8HbL3X4XogDaLA: calls $0.25
*** TURN *** [Ad 6s 7c] [Td]
AtRN1hdV8HbL3X4XogDaLA: bets $0.25
WdsZPRB5ooUPinQdaX0QrA: raises $1 to $1.25
AtRN1hdV8HbL3X4XogDaLA: calls $1
*** RIVER *** [Ad 6s 7c Td] [3s]
AtRN1hdV8HbL3X4XogDaLA: checks 
WdsZPRB5ooUPinQdaX0QrA: bets $3.10 and is all-in
AtRN1hdV8HbL3X4XogDaLA: folds 
Uncalled bet ($3.10) returned to WdsZPRB5ooUPinQdaX0QrA
WdsZPRB5ooUPinQdaX0QrA collected $3.45 from pot
WdsZPRB5ooUPinQdaX0QrA: doesn't show hand 
*** SUMMARY ***
Total pot $3.60 | Rake $0.15 
Board [Ad 6s 7c Td 3s]
Seat 1: AtRN1hdV8HbL3X4XogDaLA (big blind) folded on the River
Seat 3: HVKi9hnDyvzObpL08/OarQ folded before Flop (didn't bet)
Seat 4: jeKWRUkMaVn8rEUjnJKqpg folded before Flop (didn't bet)
Seat 5: Z5ZtGOON8kmSdSCll9Z3XA folded before Flop (didn't bet)
Seat 7: WdsZPRB5ooUPinQdaX0QrA collected ($3.45)
Seat 8: ppMlNkhYgErlt4fuJO7ADA (button) folded before Flop (didn't bet)
Seat 9: hIss79a4pu7GzJZepfgOpg (small blind) folded before Flop




PokerStars Game #59939377932:  Hold'em No Limit ($0.10/$0.25) - 2009/07/01 0:38:19 ET
Table 'pAhiNHs/spaABQia+7gWNQ' 9-max Seat #3 is the button
Seat 1: /VQLorsEOrMfI+KamzNQEA ($4.70 in chips) 
Seat 3: xEQxarad8/T4jJdpZy5LGw ($8.90 in chips) 
Seat 5: /vn2Qu2dvc9AMMq46Ae0jA ($10.40 in chips) 
Seat 6: FinSxgTdEPV/yPQRl5uhmA ($49.95 in chips) 
Seat 7: 04UcDjK4SUEJctLqNtWFoQ ($8.75 in chips) 
Seat 8: vSkQm2EelzwRGDDQQk0Fqw ($14.05 in chips) 
Seat 9: /67o0BjW8sY1ZxYt7/6StQ ($13.40 in chips) 
lacross84 will be allowed to play after the button
/vn2Qu2dvc9AMMq46Ae0jA: posts small blind $0.10
FinSxgTdEPV/yPQRl5uhmA: posts big blind $0.25
hvydiesel: sits out 
*** HOLE CARDS ***
04UcDjK4SUEJctLqNtWFoQ: calls $0.25
vSkQm2EelzwRGDDQQk0Fqw: folds 
/67o0BjW8sY1ZxYt7/6StQ: folds 
/VQLorsEOrMfI+KamzNQEA: folds 
xEQxarad8/T4jJdpZy5LGw: folds 
/vn2Qu2dvc9AMMq46Ae0jA: calls $0.15
FinSxgTdEPV/yPQRl5uhmA: checks 
*** FLOP *** [Jd 8d 3s]
/vn2Qu2dvc9AMMq46Ae0jA: checks 
FinSxgTdEPV/yPQRl5uhmA: checks 
04UcDjK4SUEJctLqNtWFoQ: checks 
*** TURN *** [Jd 8d 3s] [Jc]
/vn2Qu2dvc9AMMq46Ae0jA: checks 
FinSxgTdEPV/yPQRl5uhmA: checks 
04UcDjK4SUEJctLqNtWFoQ: bets $0.75
/vn2Qu2dvc9AMMq46Ae0jA: folds 
FinSxgTdEPV/yPQRl5uhmA: folds 
Uncalled bet ($0.75) returned to 04UcDjK4SUEJctLqNtWFoQ
04UcDjK4SUEJctLqNtWFoQ collected $0.75 from pot
04UcDjK4SUEJctLqNtWFoQ: doesn't show hand 
*** SUMMARY ***
Total pot $0.75 | Rake $0 
Board [Jd 8d 3s Jc]
Seat 1: /VQLorsEOrMfI+KamzNQEA folded before Flop (didn't bet)
Seat 3: xEQxarad8/T4jJdpZy5LGw (button) folded before Flop (didn't bet)
Seat 5: /vn2Qu2dvc9AMMq46Ae0jA (small blind) folded on the Turn
Seat 6: FinSxgTdEPV/yPQRl5uhmA (big blind) folded on the Turn
Seat 7: 04UcDjK4SUEJctLqNtWFoQ collected ($0.75)
Seat 8: vSkQm2EelzwRGDDQQk0Fqw folded before Flop (didn't bet)
Seat 9: /67o0BjW8sY1ZxYt7/6StQ folded before Flop (didn't bet)




PokerStars Game #59939377912:  Hold'em No Limit ($0.10/$0.25) - 2009/07/01 0:38:19 ET
Table '/AhP8uWRzEEhOATYIdmn0A' 9-max Seat #2 is the button
Seat 1: +sbyWwIcFp9kP0bDtMegfQ ($23.75 in chips) 
Seat 2: nvWCCH1JBjMjQkSaXl2Mog ($16.60 in chips) 
Seat 3: vSkQm2EelzwRGDDQQk0Fqw ($4.75 in chips) 
Seat 5: BEIBUu2pIflPrCL+Iks4CQ ($13.50 in chips) 
Seat 6: 1K6QGyJP9P9xmRac2fH4OQ ($25 in chips) 
Seat 7: 4oA316mXLIui1QY63GXBUg ($25 in chips) 
Seat 9: DIBbjEYGs+TVdVgEB/4+3w ($29.25 in chips) 
vSkQm2EelzwRGDDQQk0Fqw: posts small blind $0.10
st9jtdNbm1W5GfBwRaCVqQ: is sitting out 
BEIBUu2pIflPrCL+Iks4CQ: posts big blind $0.25
CYkY0dNBaYaKs8HVCVn3mQ: sits out 
*** HOLE CARDS ***
st9jtdNbm1W5GfBwRaCVqQ leaves the table
1K6QGyJP9P9xmRac2fH4OQ: folds 
4oA316mXLIui1QY63GXBUg: folds 
DIBbjEYGs+TVdVgEB/4+3w: folds 
+sbyWwIcFp9kP0bDtMegfQ: folds 
nvWCCH1JBjMjQkSaXl2Mog: calls $0.25
vSkQm2EelzwRGDDQQk0Fqw: folds 
BEIBUu2pIflPrCL+Iks4CQ: checks 
*** FLOP *** [6c Qc 7h]
BEIBUu2pIflPrCL+Iks4CQ: checks 
nvWCCH1JBjMjQkSaXl2Mog: bets $0.50
BEIBUu2pIflPrCL+Iks4CQ: folds 
Uncalled bet ($0.50) returned to nvWCCH1JBjMjQkSaXl2Mog
nvWCCH1JBjMjQkSaXl2Mog collected $0.60 from pot
nvWCCH1JBjMjQkSaXl2Mog: doesn't show hand 
*** SUMMARY ***
Total pot $0.60 | Rake $0 
Board [6c Qc 7h]
Seat 1: +sbyWwIcFp9kP0bDtMegfQ folded before Flop (didn't bet)
Seat 2: nvWCCH1JBjMjQkSaXl2Mog (button) collected ($0.60)
Seat 3: vSkQm2EelzwRGDDQQk0Fqw (small blind) folded before Flop
Seat 5: BEIBUu2pIflPrCL+Iks4CQ (big blind) folded on the Flop
Seat 6: 1K6QGyJP9P9xmRac2fH4OQ folded before Flop (didn't bet)
Seat 7: 4oA316mXLIui1QY63GXBUg folded before Flop (didn't bet)
Seat 9: DIBbjEYGs+TVdVgEB/4+3w folded before Flop (didn't bet)




PokerStars Game #59939377822:  Hold'em No Limit ($0.10/$0.25) - 2009/07/01 0:38:19 ET
Table '9lYs7ljXi6AgFAxYHlKLJw' 9-max Seat #7 is the button
Seat 2: N6fYvIzQLKaydFLKQGtMlQ ($21.40 in chips) 
Seat 3: DnDcAdn9P0zGovMERigpFA ($27.85 in chips) 
Seat 4: UANt6y/SmDCY/jIxkBixcw ($30 in chips) 
Seat 5: dfNim92Z6XK1/h5SFW5vDg ($55.55 in chips) 
Seat 6: JtVGnq5doRa3PublncR+Yw ($19.50 in chips) 
Seat 7: ghNKXUBl/H+t83JF079ZBA ($30.10 in chips) 
Seat 8: Do7fcCjAx0vINJYUXuFoyA ($21.35 in chips) 
Seat 9: 18G4P1XstjNvItdGUITxgw ($26.65 in chips) 
Do7fcCjAx0vINJYUXuFoyA: posts small blind $0.10
18G4P1XstjNvItdGUITxgw: posts big blind $0.25
*** HOLE CARDS ***
N6fYvIzQLKaydFLKQGtMlQ: folds 
DnDcAdn9P0zGovMERigpFA: folds 
UANt6y/SmDCY/jIxkBixcw: folds 
dfNim92Z6XK1/h5SFW5vDg: folds 
JtVGnq5doRa3PublncR+Yw: calls $0.25
ghNKXUBl/H+t83JF079ZBA: folds 
Do7fcCjAx0vINJYUXuFoyA: calls $0.15
18G4P1XstjNvItdGUITxgw: checks 
*** FLOP *** [5d 8h Ac]
Do7fcCjAx0vINJYUXuFoyA: checks 
18G4P1XstjNvItdGUITxgw: checks 
JtVGnq5doRa3PublncR+Yw: bets $0.50
Do7fcCjAx0vINJYUXuFoyA: calls $0.50
18G4P1XstjNvItdGUITxgw: folds 
*** TURN *** [5d 8h Ac] [4d]
Do7fcCjAx0vINJYUXuFoyA: checks 
JtVGnq5doRa3PublncR+Yw: checks 
*** RIVER *** [5d 8h Ac 4d] [Kh]
Do7fcCjAx0vINJYUXuFoyA: checks 
JtVGnq5doRa3PublncR+Yw: bets $0.75
Do7fcCjAx0vINJYUXuFoyA: folds 
Uncalled bet ($0.75) returned to JtVGnq5doRa3PublncR+Yw
JtVGnq5doRa3PublncR+Yw collected $1.70 from pot
*** SUMMARY ***
Total pot $1.75 | Rake $0.05 
Board [5d 8h Ac 4d Kh]
Seat 2: N6fYvIzQLKaydFLKQGtMlQ folded before Flop (didn't bet)
Seat 3: DnDcAdn9P0zGovMERigpFA folded before Flop (didn't bet)
Seat 4: UANt6y/SmDCY/jIxkBixcw folded before Flop (didn't bet)
Seat 5: dfNim92Z6XK1/h5SFW5vDg folded before Flop (didn't bet)
Seat 6: JtVGnq5doRa3PublncR+Yw collected ($1.70)
Seat 7: ghNKXUBl/H+t83JF079ZBA (button) folded before Flop (didn't bet)
Seat 8: Do7fcCjAx0vINJYUXuFoyA (small blind) folded on the River
Seat 9: 18G4P1XstjNvItdGUITxgw (big blind) folded on the Flop




PokerStars Game #59939378066:  Hold'em No Limit ($0.10/$0.25) - 2009/07/01 0:38:19 ET
Table 'AUM6O+mgQAaLDZKMQ/5/gA' 9-max Seat #1 is the button
Seat 1: Eyuoq9VsHg1Puw0nNzXTjg ($9.10 in chips) 
Seat 3: 3m6VfX7io8SA31qh1zCkgQ ($9.30 in chips) 
Seat 4: GIv32m/KBYU5WdIHUImuIg ($5.10 in chips) 
Seat 5: +2kMBNpY4nF1qNCRd8SJLA ($25 in chips) 
3m6VfX7io8SA31qh1zCkgQ: posts small blind $0.10
GIv32m/KBYU5WdIHUImuIg: posts big blind $0.25
*** HOLE CARDS ***
+2kMBNpY4nF1qNCRd8SJLA: raises $0.75 to $1
Eyuoq9VsHg1Puw0nNzXTjg: calls $1
3m6VfX7io8SA31qh1zCkgQ: calls $0.90
GIv32m/KBYU5WdIHUImuIg: folds 
*** FLOP *** [Qh 9h 7s]
3m6VfX7io8SA31qh1zCkgQ: checks 
+2kMBNpY4nF1qNCRd8SJLA: checks 
Eyuoq9VsHg1Puw0nNzXTjg: bets $1.50
3m6VfX7io8SA31qh1zCkgQ: calls $1.50
+2kMBNpY4nF1qNCRd8SJLA: folds 
*** TURN *** [Qh 9h 7s] [6c]
3m6VfX7io8SA31qh1zCkgQ: bets $6.80 and is all-in
p0Q0llBV74kraoiHI/UzWA joins the table at seat #2 
Eyuoq9VsHg1Puw0nNzXTjg: folds 
Uncalled bet ($6.80) returned to 3m6VfX7io8SA31qh1zCkgQ
3m6VfX7io8SA31qh1zCkgQ collected $5.95 from pot
3m6VfX7io8SA31qh1zCkgQ: doesn't show hand 
*** SUMMARY ***
Total pot $6.25 | Rake $0.30 
Board [Qh 9h 7s 6c]
Seat 1: Eyuoq9VsHg1Puw0nNzXTjg (button) folded on the Turn
Seat 3: 3m6VfX7io8SA31qh1zCkgQ (small blind) collected ($5.95)
Seat 4: GIv32m/KBYU5WdIHUImuIg (big blind) folded before Flop
Seat 5: +2kMBNpY4nF1qNCRd8SJLA folded on the Flop




PokerStars Game #59939378686:  Hold'em No Limit ($0.10/$0.25) - 2009/07/01 0:38:20 ET
Table 'nc6OeGk/wtaWV+6N+kgnZQ' 6-max Seat #1 is the button
Seat 1: 0/FYfBoKhINaqU/H5OSS1A ($5 in chips) 
Seat 6: yJgjVkWgiJ8vdWZjcUod2A ($5 in chips) 
0/FYfBoKhINaqU/H5OSS1A: posts small blind $0.10
yJgjVkWgiJ8vdWZjcUod2A: posts big blind $0.25
*** HOLE CARDS ***
0/FYfBoKhINaqU/H5OSS1A: calls $0.15
yJgjVkWgiJ8vdWZjcUod2A: checks 
*** FLOP *** [3s 7h 8h]
8f0dtuUGqDbgE6up1lQAlg joins the table at seat #3 
yJgjVkWgiJ8vdWZjcUod2A: checks 
8f0dtuUGqDbgE6up1lQAlg is sitting out
0/FYfBoKhINaqU/H5OSS1A: checks 
*** TURN *** [3s 7h 8h] [9d]
8f0dtuUGqDbgE6up1lQAlg has returned
yJgjVkWgiJ8vdWZjcUod2A: checks 
0/FYfBoKhINaqU/H5OSS1A: bets $0.25
yJgjVkWgiJ8vdWZjcUod2A: calls $0.25
*** RIVER *** [3s 7h 8h 9d] [9s]
yJgjVkWgiJ8vdWZjcUod2A: bets $0.50
0/FYfBoKhINaqU/H5OSS1A: raises $1.50 to $2
yJgjVkWgiJ8vdWZjcUod2A: folds 
Uncalled bet ($1.50) returned to 0/FYfBoKhINaqU/H5OSS1A
0/FYfBoKhINaqU/H5OSS1A collected $1.95 from pot
*** SUMMARY ***
Total pot $2 | Rake $0.05 
Board [3s 7h 8h 9d 9s]
Seat 1: 0/FYfBoKhINaqU/H5OSS1A (button) (small blind) collected ($1.95)
Seat 6: yJgjVkWgiJ8vdWZjcUod2A (big blind) folded on the River




PokerStars Game #59939378580:  Hold'em No Limit ($0.10/$0.25) - 2009/07/01 0:38:20 ET
Table 'h02LhQ7B/Zk4ETRxxHhGYA' 9-max Seat #9 is the button
Seat 1: sD+TKtt36XiiN6jqHiLwDA ($24.75 in chips) 
Seat 2: RJ/x9oZtt1RZLaJEQwZOxQ ($28.30 in chips) 
Seat 3: JxpnpCmvRAcrEUy7mq1iAg ($5.35 in chips) 
Seat 4: tYsOBqdU1+x+yFI7zHO7hQ ($38.55 in chips) 
Seat 5: cUxk0Jk4lrUQv9CJl0LPlg ($16.95 in chips) 
Seat 6: kN/irnQSdb8jibbN4f1O+Q ($16.55 in chips) 
Seat 7: rUpvA02nErFvZ4yFbDR8XA ($19.45 in chips) 
Seat 8: 7tW694tRVJnYdoa16Dw4RQ ($25.45 in chips) 
Seat 9: 1c/7DHPx5CDTmAfk8/bWeA ($14.30 in chips) 
sD+TKtt36XiiN6jqHiLwDA: posts small blind $0.10
RJ/x9oZtt1RZLaJEQwZOxQ: posts big blind $0.25
*** HOLE CARDS ***
JxpnpCmvRAcrEUy7mq1iAg: folds 
tYsOBqdU1+x+yFI7zHO7hQ: folds 
cUxk0Jk4lrUQv9CJl0LPlg: folds 
kN/irnQSdb8jibbN4f1O+Q: raises $0.50 to $0.75
rUpvA02nErFvZ4yFbDR8XA: folds 
7tW694tRVJnYdoa16Dw4RQ: folds 
1c/7DHPx5CDTmAfk8/bWeA: folds 
sD+TKtt36XiiN6jqHiLwDA: folds 
RJ/x9oZtt1RZLaJEQwZOxQ: folds 
Uncalled bet ($0.50) returned to kN/irnQSdb8jibbN4f1O+Q
kN/irnQSdb8jibbN4f1O+Q collected $0.60 from pot
*** SUMMARY ***
Total pot $0.60 | Rake $0 
Seat 1: sD+TKtt36XiiN6jqHiLwDA (small blind) folded before Flop
Seat 2: RJ/x9oZtt1RZLaJEQwZOxQ (big blind) folded before Flop
Seat 3: JxpnpCmvRAcrEUy7mq1iAg folded before Flop (didn't bet)
Seat 4: tYsOBqdU1+x+yFI7zHO7hQ folded before Flop (didn't bet)
Seat 5: cUxk0Jk4lrUQv9CJl0LPlg folded before Flop (didn't bet)
Seat 6: kN/irnQSdb8jibbN4f1O+Q collected ($0.60)
Seat 7: rUpvA02nErFvZ4yFbDR8XA folded before Flop (didn't bet)
Seat 8: 7tW694tRVJnYdoa16Dw4RQ folded before Flop (didn't bet)
Seat 9: 1c/7DHPx5CDTmAfk8/bWeA (button) folded before Flop (didn't bet)




PokerStars Game #59939378126:  Hold'em No Limit ($0.10/$0.25) - 2009/07/01 0:38:20 ET
Table 'm+FQg/QP0VP1ZA3V62WtOg' 9-max Seat #3 is the button
Seat 1: IK3/w7XV7rd8mVIsuasjYA ($3.40 in chips) 
Seat 2: oKO7b50N6TzXbPBr/mcrUA ($25.20 in chips) 
Seat 3: 4oA316mXLIui1QY63GXBUg ($25 in chips) 
Seat 4: 86vbuhJsyH+nbEg5qpDLyQ ($24.75 in chips) 
Seat 5: DnDcAdn9P0zGovMERigpFA ($25 in chips) 
Seat 6: 0kGr2KqzSs4y4kVqyDiTag ($15.25 in chips) 
Seat 7: Xt367jg1prYX1onqNvit0Q ($17.80 in chips) 
Seat 8: tZEGwCRajq0AFS6z46uW9w ($15.75 in chips) 
Seat 9: ghNKXUBl/H+t83JF079ZBA ($25 in chips) 
86vbuhJsyH+nbEg5qpDLyQ: posts small blind $0.10
DnDcAdn9P0zGovMERigpFA: posts big blind $0.25
*** HOLE CARDS ***
0kGr2KqzSs4y4kVqyDiTag: folds 
Xt367jg1prYX1onqNvit0Q: folds 
tZEGwCRajq0AFS6z46uW9w: folds 
ghNKXUBl/H+t83JF079ZBA: folds 
IK3/w7XV7rd8mVIsuasjYA: folds 
oKO7b50N6TzXbPBr/mcrUA: folds 
4oA316mXLIui1QY63GXBUg: folds 
86vbuhJsyH+nbEg5qpDLyQ: raises $0.50 to $0.75
DnDcAdn9P0zGovMERigpFA: folds 
Uncalled bet ($0.50) returned to 86vbuhJsyH+nbEg5qpDLyQ
86vbuhJsyH+nbEg5qpDLyQ collected $0.50 from pot
*** SUMMARY ***
Total pot $0.50 | Rake $0 
Seat 1: IK3/w7XV7rd8mVIsuasjYA folded before Flop (didn't bet)
Seat 2: oKO7b50N6TzXbPBr/mcrUA folded before Flop (didn't bet)
Seat 3: 4oA316mXLIui1QY63GXBUg (button) folded before Flop (didn't bet)
Seat 4: 86vbuhJsyH+nbEg5qpDLyQ (small blind) collected ($0.50)
Seat 5: DnDcAdn9P0zGovMERigpFA (big blind) folded before Flop
Seat 6: 0kGr2KqzSs4y4kVqyDiTag folded before Flop (didn't bet)
Seat 7: Xt367jg1prYX1onqNvit0Q folded before Flop (didn't bet)
Seat 8: tZEGwCRajq0AFS6z46uW9w folded before Flop (didn't bet)
Seat 9: ghNKXUBl/H+t83JF079ZBA folded before Flop (didn't bet)




PokerStars Game #59939378254:  Hold'em No Limit ($0.10/$0.25) - 2009/07/01 0:38:20 ET
Table 'yAHDCs33TIgw3ra63xuU2Q' 9-max Seat #6 is the button
Seat 1: 8B/dhbQjIWe6ASCdgzktNQ ($26.15 in chips) 
Seat 2: LBrhQVB4w41YNd7kMYn/og ($19.35 in chips) 
Seat 3: H9KUl8cmpLgEpOVDA00bCg ($4.30 in chips) 
Seat 4: rUdM7gwmNCaxMNSb2CFPhQ ($11 in chips) 
Seat 5: 4awUyiDYTgylQKXZ9faBVA ($25 in chips) 
Seat 6: cjelr2AqqD7It1Q2TXfgTQ ($4.40 in chips) 
Seat 7: OiV1PWZ3IkN29JlmCcnTwQ ($5 in chips) 
Seat 8: tYsOBqdU1+x+yFI7zHO7hQ ($28.10 in chips) 
Seat 9: k+ydNCnnP3Hgwh0AnDYVrA ($8.90 in chips) 
OiV1PWZ3IkN29JlmCcnTwQ: posts small blind $0.10
tYsOBqdU1+x+yFI7zHO7hQ: posts big blind $0.25
*** HOLE CARDS ***
k+ydNCnnP3Hgwh0AnDYVrA: calls $0.25
8B/dhbQjIWe6ASCdgzktNQ: folds 
LBrhQVB4w41YNd7kMYn/og: folds 
H9KUl8cmpLgEpOVDA00bCg: folds 
rUdM7gwmNCaxMNSb2CFPhQ: folds 
4awUyiDYTgylQKXZ9faBVA: raises $1 to $1.25
cjelr2AqqD7It1Q2TXfgTQ: calls $1.25
OiV1PWZ3IkN29JlmCcnTwQ: folds 
tYsOBqdU1+x+yFI7zHO7hQ: folds 
k+ydNCnnP3Hgwh0AnDYVrA: calls $1
*** FLOP *** [Kc 2d 6h]
k+ydNCnnP3Hgwh0AnDYVrA: bets $1
4awUyiDYTgylQKXZ9faBVA: folds 
4awUyiDYTgylQKXZ9faBVA is sitting out
cjelr2AqqD7It1Q2TXfgTQ: calls $1
*** TURN *** [Kc 2d 6h] [Qh]
4awUyiDYTgylQKXZ9faBVA has returned
k+ydNCnnP3Hgwh0AnDYVrA: bets $2
cjelr2AqqD7It1Q2TXfgTQ: raises $0.15 to $2.15 and is all-in
k+ydNCnnP3Hgwh0AnDYVrA: calls $0.15
*** RIVER *** [Kc 2d 6h Qh] [6s]
*** SHOW DOWN ***
k+ydNCnnP3Hgwh0AnDYVrA: shows [Ah Kd] (two pair, Kings and Sixes)
cjelr2AqqD7It1Q2TXfgTQ: mucks hand 
k+ydNCnnP3Hgwh0AnDYVrA collected $9.90 from pot
*** SUMMARY ***
Total pot $10.40 | Rake $0.50 
Board [Kc 2d 6h Qh 6s]
Seat 1: 8B/dhbQjIWe6ASCdgzktNQ folded before Flop (didn't bet)
Seat 2: LBrhQVB4w41YNd7kMYn/og folded before Flop (didn't bet)
Seat 3: H9KUl8cmpLgEpOVDA00bCg folded before Flop (didn't bet)
Seat 4: rUdM7gwmNCaxMNSb2CFPhQ folded before Flop (didn't bet)
Seat 5: 4awUyiDYTgylQKXZ9faBVA folded on the Flop
Seat 6: cjelr2AqqD7It1Q2TXfgTQ (button) mucked
Seat 7: OiV1PWZ3IkN29JlmCcnTwQ (small blind) folded before Flop
Seat 8: tYsOBqdU1+x+yFI7zHO7hQ (big blind) folded before Flop
Seat 9: k+ydNCnnP3Hgwh0AnDYVrA showed [Ah Kd] and won ($9.90) with two pair, Kings and Sixes




PokerStars Game #59939378358:  Hold'em No Limit ($0.10/$0.25) - 2009/07/01 0:38:20 ET
Table '3EebBlzq5yHSY2444L4zlg' 9-max Seat #7 is the button
Seat 1: 8B/dhbQjIWe6ASCdgzktNQ ($33.45 in chips) 
Seat 2: MIVCHqCqqlke0Lb0z7glcw ($25.60 in chips) 
Seat 3: IGbD5vKNhHe60dkdbjg/mw ($29.10 in chips) 
Seat 4: 1S/fpm+f42V/6MNZre+ccg ($25.45 in chips) 
Seat 5: 22Ph+hChb2fjC5+yk/mOew ($14.75 in chips) 
Seat 6: QEbIGci+itdw+re8RM5fZA ($28.15 in chips) 
Seat 7: DiSvPC2iudwL5j9u6Huyww ($28.90 in chips) 
Seat 8: Qi+clOtyDiibLdH2/1Qy8g ($27.95 in chips) 
Seat 9: GTcLfsDTPqgfHyhY9FNDMw ($10.20 in chips) 
Qi+clOtyDiibLdH2/1Qy8g: posts small blind $0.10
GTcLfsDTPqgfHyhY9FNDMw: posts big blind $0.25
*** HOLE CARDS ***
8B/dhbQjIWe6ASCdgzktNQ: folds 
MIVCHqCqqlke0Lb0z7glcw: folds 
IGbD5vKNhHe60dkdbjg/mw: folds 
1S/fpm+f42V/6MNZre+ccg: folds 
22Ph+hChb2fjC5+yk/mOew: folds 
QEbIGci+itdw+re8RM5fZA: folds 
DiSvPC2iudwL5j9u6Huyww: folds 
Qi+clOtyDiibLdH2/1Qy8g: folds 
Uncalled bet ($0.15) returned to GTcLfsDTPqgfHyhY9FNDMw
GTcLfsDTPqgfHyhY9FNDMw collected $0.20 from pot
GTcLfsDTPqgfHyhY9FNDMw: doesn't show hand 
*** SUMMARY ***
Total pot $0.20 | Rake $0 
Seat 1: 8B/dhbQjIWe6ASCdgzktNQ folded before Flop (didn't bet)
Seat 2: MIVCHqCqqlke0Lb0z7glcw folded before Flop (didn't bet)
Seat 3: IGbD5vKNhHe60dkdbjg/mw folded before Flop (didn't bet)
Seat 4: 1S/fpm+f42V/6MNZre+ccg folded before Flop (didn't bet)
Seat 5: 22Ph+hChb2fjC5+yk/mOew folded before Flop (didn't bet)
Seat 6: QEbIGci+itdw+re8RM5fZA folded before Flop (didn't bet)
Seat 7: DiSvPC2iudwL5j9u6Huyww (button) folded before Flop (didn't bet)
Seat 8: Qi+clOtyDiibLdH2/1Qy8g (small blind) folded before Flop
Seat 9: GTcLfsDTPqgfHyhY9FNDMw (big blind) collected ($0.20)




PokerStars Game #59939378258:  Hold'em No Limit ($0.10/$0.25) - 2009/07/01 0:38:20 ET
Table '8kaMIn+aON/ferW89Go6Pw' 9-max Seat #4 is the button
Seat 1: st9jtdNbm1W5GfBwRaCVqQ ($23.50 in chips) 
Seat 2: jeKWRUkMaVn8rEUjnJKqpg ($25 in chips) 
Seat 3: 7cv+9Zc9HIQHNvYsMfV3uA ($27.95 in chips) 
Seat 4: KRWTiGM4xH+MkvPtJz4+SA ($47.90 in chips) 
Seat 5: hIss79a4pu7GzJZepfgOpg ($29.75 in chips) 
Seat 6: 1S/fpm+f42V/6MNZre+ccg ($25 in chips) 
Seat 7: HVKi9hnDyvzObpL08/OarQ ($22.25 in chips) 
Seat 8: VbudEd0ZG+qPwMO9h+hjXw ($26.55 in chips) 
Seat 9: DiSvPC2iudwL5j9u6Huyww ($25.35 in chips) 
hIss79a4pu7GzJZepfgOpg: posts small blind $0.10
1S/fpm+f42V/6MNZre+ccg: posts big blind $0.25
*** HOLE CARDS ***
HVKi9hnDyvzObpL08/OarQ: folds 
VbudEd0ZG+qPwMO9h+hjXw: folds 
VbudEd0ZG+qPwMO9h+hjXw leaves the table
DiSvPC2iudwL5j9u6Huyww: folds 
st9jtdNbm1W5GfBwRaCVqQ: folds 
jeKWRUkMaVn8rEUjnJKqpg: folds 
7cv+9Zc9HIQHNvYsMfV3uA: folds 
KRWTiGM4xH+MkvPtJz4+SA: folds 
hIss79a4pu7GzJZepfgOpg: raises $0.50 to $0.75
1S/fpm+f42V/6MNZre+ccg: calls $0.50
*** FLOP *** [9d 5h 6c]
hIss79a4pu7GzJZepfgOpg: bets $1
1S/fpm+f42V/6MNZre+ccg: calls $1
*** TURN *** [9d 5h 6c] [4s]
hIss79a4pu7GzJZepfgOpg: bets $2
1S/fpm+f42V/6MNZre+ccg: folds 
Uncalled bet ($2) returned to hIss79a4pu7GzJZepfgOpg
hIss79a4pu7GzJZepfgOpg collected $3.35 from pot
hIss79a4pu7GzJZepfgOpg: doesn't show hand 
*** SUMMARY ***
Total pot $3.50 | Rake $0.15 
Board [9d 5h 6c 4s]
Seat 1: st9jtdNbm1W5GfBwRaCVqQ folded before Flop (didn't bet)
Seat 2: jeKWRUkMaVn8rEUjnJKqpg folded before Flop (didn't bet)
Seat 3: 7cv+9Zc9HIQHNvYsMfV3uA folded before Flop (didn't bet)
Seat 4: KRWTiGM4xH+MkvPtJz4+SA (button) folded before Flop (didn't bet)
Seat 5: hIss79a4pu7GzJZepfgOpg (small blind) collected ($3.35)
Seat 6: 1S/fpm+f42V/6MNZre+ccg (big blind) folded on the Turn
Seat 7: HVKi9hnDyvzObpL08/OarQ folded before Flop (didn't bet)
Seat 8: VbudEd0ZG+qPwMO9h+hjXw folded before Flop (didn't bet)
Seat 9: DiSvPC2iudwL5j9u6Huyww folded before Flop (didn't bet)




PokerStars Game #59939378276:  Hold'em No Limit ($0.10/$0.25) - 2009/07/01 0:38:20 ET
Table 'AJGgX1ZYM8d68SWMvaLttg' 6-max Seat #3 is the button
Seat 1: sT4sjqzVMH/fZHz0hkbIPw ($35 in chips) 
Seat 2: zHHLkD2sRljslKKeQv/ZQw ($32.40 in chips) 
Seat 3: 4x9jCqgSw4272dnaIqnanw ($5.20 in chips) 
Seat 4: Lz/GjRDgmgepqTR7qmS86w ($18.45 in chips) 
Seat 5: SFmT9ZsVopnukjvAzrxTRg ($28.95 in chips) 
Seat 6: UA5OsKS3VPaxa7uC8La/kA ($31.25 in chips) 
Lz/GjRDgmgepqTR7qmS86w: posts small blind $0.10
SFmT9ZsVopnukjvAzrxTRg: posts big blind $0.25
sT4sjqzVMH/fZHz0hkbIPw: posts small & big blinds $0.35
*** HOLE CARDS ***
UA5OsKS3VPaxa7uC8La/kA: folds 
sT4sjqzVMH/fZHz0hkbIPw: checks 
zHHLkD2sRljslKKeQv/ZQw: raises $1 to $1.25
4x9jCqgSw4272dnaIqnanw: folds 
Lz/GjRDgmgepqTR7qmS86w: folds 
SFmT9ZsVopnukjvAzrxTRg: folds 
sT4sjqzVMH/fZHz0hkbIPw: folds 
Uncalled bet ($1) returned to zHHLkD2sRljslKKeQv/ZQw
zHHLkD2sRljslKKeQv/ZQw collected $0.95 from pot
*** SUMMARY ***
Total pot $0.95 | Rake $0 
Seat 1: sT4sjqzVMH/fZHz0hkbIPw folded before Flop
Seat 2: zHHLkD2sRljslKKeQv/ZQw collected ($0.95)
Seat 3: 4x9jCqgSw4272dnaIqnanw (button) folded before Flop (didn't bet)
Seat 4: Lz/GjRDgmgepqTR7qmS86w (small blind) folded before Flop
Seat 5: SFmT9ZsVopnukjvAzrxTRg (big blind) folded before Flop
Seat 6: UA5OsKS3VPaxa7uC8La/kA folded before Flop (didn't bet)




PokerStars Game #59939379158:  Hold'em No Limit ($0.10/$0.25) - 2009/07/01 0:38:21 ET
Table 'a0kk1yz54EMczhut3KjrxQ' 6-max Seat #2 is the button
Seat 1: V3LJvbHVJHmOj2fd7zIDhA ($29.25 in chips) 
Seat 2: nc79pm0LZRdhncq55evVqA ($25 in chips) 
Seat 3: FabaCGPqGJLjRL48CMvjiQ ($23.50 in chips) 
Seat 4: FYepjhAvF8ZdVCmqHIy+eQ ($27.05 in chips) 
Seat 5: cPO/1/dTcZpLkQFm3jH3Rg ($25 in chips) 
Seat 6: DTzxFTXVrCqrpjq9B9Vg/g ($14.75 in chips) 
FabaCGPqGJLjRL48CMvjiQ: posts small blind $0.10
FYepjhAvF8ZdVCmqHIy+eQ: posts big blind $0.25
*** HOLE CARDS ***
cPO/1/dTcZpLkQFm3jH3Rg: folds 
DTzxFTXVrCqrpjq9B9Vg/g: folds 
V3LJvbHVJHmOj2fd7zIDhA: folds 
nc79pm0LZRdhncq55evVqA: folds 
FabaCGPqGJLjRL48CMvjiQ: calls $0.15
FYepjhAvF8ZdVCmqHIy+eQ: checks 
*** FLOP *** [9c 6d Th]
FabaCGPqGJLjRL48CMvjiQ: bets $0.25
FYepjhAvF8ZdVCmqHIy+eQ: folds 
Uncalled bet ($0.25) returned to FabaCGPqGJLjRL48CMvjiQ
FabaCGPqGJLjRL48CMvjiQ collected $0.50 from pot
*** SUMMARY ***
Total pot $0.50 | Rake $0 
Board [9c 6d Th]
Seat 1: V3LJvbHVJHmOj2fd7zIDhA folded before Flop (didn't bet)
Seat 2: nc79pm0LZRdhncq55evVqA (button) folded before Flop (didn't bet)
Seat 3: FabaCGPqGJLjRL48CMvjiQ (small blind) collected ($0.50)
Seat 4: FYepjhAvF8ZdVCmqHIy+eQ (big blind) folded on the Flop
Seat 5: cPO/1/dTcZpLkQFm3jH3Rg folded before Flop (didn't bet)
Seat 6: DTzxFTXVrCqrpjq9B9Vg/g folded before Flop (didn't bet)




PokerStars Game #59939379280:  Hold'em No Limit ($0.10/$0.25) - 2009/07/01 0:38:21 ET
Table 'WEMI3Mtn7dGARDbgNrKibgQvLFJzpzymuOsaaRYi+8fgx Seat #3 is the button
Seat 2: R6nIVAjK7uhK3Hj0f85A+A ($22.90 in chips) 
Seat 3: W+vSAd2K80ck4uMklFb1OA ($6.95 in chips) 
Seat 4: MIVCHqCqqlke0Lb0z7glcw ($21.60 in chips) 
Seat 5: MG90wfSJZnOejs/KD3vlQQ ($25.60 in chips) 
Seat 6: /bZlLwyIh+PmlqdCRwfoTg ($11.75 in chips) 
Seat 7: rQhYIYXSyH/IivYM1dlV5A ($16.65 in chips) 
MIVCHqCqqlke0Lb0z7glcw: posts small blind $0.10
MG90wfSJZnOejs/KD3vlQQ: posts big blind $0.25
*** HOLE CARDS ***
/bZlLwyIh+PmlqdCRwfoTg: folds 
rQhYIYXSyH/IivYM1dlV5A: calls $0.25
R6nIVAjK7uhK3Hj0f85A+A: calls $0.25
W+vSAd2K80ck4uMklFb1OA: calls $0.25
MIVCHqCqqlke0Lb0z7glcw: folds 
MG90wfSJZnOejs/KD3vlQQ: checks 
*** FLOP *** [3c Ts 4s]
MG90wfSJZnOejs/KD3vlQQ: checks 
rQhYIYXSyH/IivYM1dlV5A: checks 
R6nIVAjK7uhK3Hj0f85A+A: bets $0.85
W+vSAd2K80ck4uMklFb1OA: folds 
MG90wfSJZnOejs/KD3vlQQ: folds 
rQhYIYXSyH/IivYM1dlV5A: folds 
Uncalled bet ($0.85) returned to R6nIVAjK7uhK3Hj0f85A+A
R6nIVAjK7uhK3Hj0f85A+A collected $1.05 from pot
R6nIVAjK7uhK3Hj0f85A+A: doesn't show hand 
*** SUMMARY ***
Total pot $1.10 | Rake $0.05 
Board [3c Ts 4s]
Seat 2: R6nIVAjK7uhK3Hj0f85A+A collected ($1.05)
Seat 3: W+vSAd2K80ck4uMklFb1OA (button) folded on the Flop
Seat 4: MIVCHqCqqlke0Lb0z7glcw (small blind) folded before Flop
Seat 5: MG90wfSJZnOejs/KD3vlQQ (big blind) folded on the Flop
Seat 6: /bZlLwyIh+PmlqdCRwfoTg folded before Flop (didn't bet)
Seat 7: rQhYIYXSyH/IivYM1dlV5A folded on the Flop




PokerStars Game #59939379044:  Hold'em No Limit ($0.10/$0.25) - 2009/07/01 0:38:21 ET
Table 'M7d9IrgQUUFFy/SZ3ksLYg' 6-max Seat #3 is the button
Seat 1: cPO/1/dTcZpLkQFm3jH3Rg ($34.55 in chips) 
Seat 2: JE/wJXmjw3bpdmjwvh2pcg ($25 in chips) 
Seat 3: eHsmIvAb2JREg4O6hNPnXg ($15.60 in chips) 
Seat 4: 7FmwVDcdEtxDpHmP4hOXsQ ($30 in chips) 
Seat 6: /gJNBeCkWL4o85/jvlZ4BA ($25 in chips) 
7FmwVDcdEtxDpHmP4hOXsQ: posts small blind $0.10
/gJNBeCkWL4o85/jvlZ4BA: posts big blind $0.25
*** HOLE CARDS ***
cPO/1/dTcZpLkQFm3jH3Rg: folds 
JE/wJXmjw3bpdmjwvh2pcg: raises $1 to $1.25
eHsmIvAb2JREg4O6hNPnXg: folds 
7FmwVDcdEtxDpHmP4hOXsQ: folds 
/gJNBeCkWL4o85/jvlZ4BA: folds 
Uncalled bet ($1) returned to JE/wJXmjw3bpdmjwvh2pcg
JE/wJXmjw3bpdmjwvh2pcg collected $0.60 from pot
JE/wJXmjw3bpdmjwvh2pcg: doesn't show hand 
*** SUMMARY ***
Total pot $0.60 | Rake $0 
Seat 1: cPO/1/dTcZpLkQFm3jH3Rg folded before Flop (didn't bet)
Seat 2: JE/wJXmjw3bpdmjwvh2pcg collected ($0.60)
Seat 3: eHsmIvAb2JREg4O6hNPnXg (button) folded before Flop (didn't bet)
Seat 4: 7FmwVDcdEtxDpHmP4hOXsQ (small blind) folded before Flop
Seat 6: /gJNBeCkWL4o85/jvlZ4BA (big blind) folded before Flop




PokerStars Game #59939378756:  Hold'em No Limit ($0.10/$0.25) - 2009/07/01 0:38:21 ET
Table 'Pz8SfAzhP5nvWTsJRAxoDg' 6-max Seat #1 is the button
Seat 1: buyjetgNT1McXtdaP4zynA ($41.65 in chips) 
Seat 2: RYLaAIIwK9wxkPswt1yJYw ($23.15 in chips) 
Seat 3: mfrkWA3PTeYPkbO6hi98Aw ($30.85 in chips) 
Seat 5: FYepjhAvF8ZdVCmqHIy+eQ ($30.30 in chips) 
Seat 6: FStoHe64SQWqAsjya9pDkQ ($25.50 in chips) 
RYLaAIIwK9wxkPswt1yJYw: posts small blind $0.10
mfrkWA3PTeYPkbO6hi98Aw: posts big blind $0.25
9U9Vy/656QCEfKznJWteag: sits out 
*** HOLE CARDS ***
FYepjhAvF8ZdVCmqHIy+eQ: folds 
FStoHe64SQWqAsjya9pDkQ: raises $0.50 to $0.75
buyjetgNT1McXtdaP4zynA: calls $0.75
RYLaAIIwK9wxkPswt1yJYw: folds 
mfrkWA3PTeYPkbO6hi98Aw: folds 
*** FLOP *** [7d 5d 5s]
FStoHe64SQWqAsjya9pDkQ: bets $1.25
buyjetgNT1McXtdaP4zynA: raises $1.75 to $3
FStoHe64SQWqAsjya9pDkQ: folds 
Uncalled bet ($1.75) returned to buyjetgNT1McXtdaP4zynA
buyjetgNT1McXtdaP4zynA collected $4.15 from pot
*** SUMMARY ***
Total pot $4.35 | Rake $0.20 
Board [7d 5d 5s]
Seat 1: buyjetgNT1McXtdaP4zynA (button) collected ($4.15)
Seat 2: RYLaAIIwK9wxkPswt1yJYw (small blind) folded before Flop
Seat 3: mfrkWA3PTeYPkbO6hi98Aw (big blind) folded before Flop
Seat 5: FYepjhAvF8ZdVCmqHIy+eQ folded before Flop (didn't bet)
Seat 6: FStoHe64SQWqAsjya9pDkQ folded on the Flop




PokerStars Game #59939378820:  Hold'em No Limit ($0.10/$0.25) - 2009/07/01 0:38:21 ET
Table 'MiquQrQZJJq9ZtgRIp9HFQ' 6-max Seat #4 is the button
Seat 1: hM0MSDtq2ow7J40bSR04ig ($8.25 in chips) 
Seat 2: DMQLAmut/l19xN5STQndFg ($3.75 in chips) 
Seat 4: 0HIrwssk0FQvyKULzUTtlg ($16.45 in chips) 
Seat 5: LXN9U+5F+9if/ead2+w1nw ($44.35 in chips) 
Seat 6: X9oXZTg4PhZVR+ilX2OYbA ($15 in chips) 
LXN9U+5F+9if/ead2+w1nw: posts small blind $0.10
X9oXZTg4PhZVR+ilX2OYbA: posts big blind $0.25
*** HOLE CARDS ***
hM0MSDtq2ow7J40bSR04ig: folds 
DMQLAmut/l19xN5STQndFg: calls $0.25
0HIrwssk0FQvyKULzUTtlg: folds 
LXN9U+5F+9if/ead2+w1nw: calls $0.15
X9oXZTg4PhZVR+ilX2OYbA: checks 
*** FLOP *** [6h 3s 4d]
LXN9U+5F+9if/ead2+w1nw: checks 
X9oXZTg4PhZVR+ilX2OYbA: checks 
DMQLAmut/l19xN5STQndFg: bets $1
LXN9U+5F+9if/ead2+w1nw: folds 
X9oXZTg4PhZVR+ilX2OYbA: folds 
Uncalled bet ($1) returned to DMQLAmut/l19xN5STQndFg
DMQLAmut/l19xN5STQndFg collected $0.75 from pot
DMQLAmut/l19xN5STQndFg: doesn't show hand 
*** SUMMARY ***
Total pot $0.75 | Rake $0 
Board [6h 3s 4d]
Seat 1: hM0MSDtq2ow7J40bSR04ig folded before Flop (didn't bet)
Seat 2: DMQLAmut/l19xN5STQndFg collected ($0.75)
Seat 4: 0HIrwssk0FQvyKULzUTtlg (button) folded before Flop (didn't bet)
Seat 5: LXN9U+5F+9if/ead2+w1nw (small blind) folded on the Flop
Seat 6: X9oXZTg4PhZVR+ilX2OYbA (big blind) folded on the Flop




PokerStars Game #59939379716:  Hold'em No Limit ($0.10/$0.25) - 2009/07/01 0:38:22 ET
Table '5NipxzzFB2DffzDpddyQoQ' 6-max Seat #4 is the button
Seat 2: jxrNE4qd8KCOIqHjQcwCrA ($40.80 in chips) 
Seat 3: qGHGf/553gQnDoklMRe3tg ($46.90 in chips) 
Seat 4: Inq44d7PQ+8TbEKfPeuxVQ ($6.35 in chips) 
Seat 5: cS21pIxRHx5Gt42o7hPZzw ($12.40 in chips) 
Seat 6: lYjWCpfCxX2kgcHY3v4Yow ($27.30 in chips) 
cS21pIxRHx5Gt42o7hPZzw: posts small blind $0.10
lYjWCpfCxX2kgcHY3v4Yow: posts big blind $0.25
TslQs7AQSLbVtr4X8JOOOQ: sits out 
*** HOLE CARDS ***
jxrNE4qd8KCOIqHjQcwCrA: folds 
qGHGf/553gQnDoklMRe3tg: folds 
Inq44d7PQ+8TbEKfPeuxVQ: folds 
cS21pIxRHx5Gt42o7hPZzw: folds 
Uncalled bet ($0.15) returned to lYjWCpfCxX2kgcHY3v4Yow
lYjWCpfCxX2kgcHY3v4Yow collected $0.20 from pot
lYjWCpfCxX2kgcHY3v4Yow: doesn't show hand 
*** SUMMARY ***
Total pot $0.20 | Rake $0 
Seat 2: jxrNE4qd8KCOIqHjQcwCrA folded before Flop (didn't bet)
Seat 3: qGHGf/553gQnDoklMRe3tg folded before Flop (didn't bet)
Seat 4: Inq44d7PQ+8TbEKfPeuxVQ (button) folded before Flop (didn't bet)
Seat 5: cS21pIxRHx5Gt42o7hPZzw (small blind) folded before Flop
Seat 6: lYjWCpfCxX2kgcHY3v4Yow (big blind) collected ($0.20)




PokerStars Game #59939379846:  Hold'em No Limit ($0.10/$0.25) - 2009/07/01 0:38:22 ET
Table '+UzantPJ4smVdrh+4GTu1w' 6-max Seat #2 is the button
Seat 1: 3Bm6SLY1pwRvi98HLQUkvg ($3.65 in chips) 
Seat 2: tcbEu7VzyHQ+0lh+skbQhQ ($10.25 in chips) 
Seat 3: SS/yfeArhULzIcOPe8MdPg ($51.25 in chips) 
Seat 4: 0/dGyX46wFQuMZwX3LgPxg ($9.30 in chips) 
Seat 5: cj4VBQya7HtVL2zCGd5jLQ ($15.10 in chips) 
Seat 6: BYxjLnV1/LL0aZcTbfAOvw ($48.05 in chips) 
SS/yfeArhULzIcOPe8MdPg: posts small blind $0.10
0/dGyX46wFQuMZwX3LgPxg: posts big blind $0.25
*** HOLE CARDS ***
cj4VBQya7HtVL2zCGd5jLQ: folds 
BYxjLnV1/LL0aZcTbfAOvw: raises $0.75 to $1
3Bm6SLY1pwRvi98HLQUkvg: folds 
tcbEu7VzyHQ+0lh+skbQhQ: folds 
SS/yfeArhULzIcOPe8MdPg: folds 
0/dGyX46wFQuMZwX3LgPxg: folds 
Uncalled bet ($0.75) returned to BYxjLnV1/LL0aZcTbfAOvw
BYxjLnV1/LL0aZcTbfAOvw collected $0.60 from pot
BYxjLnV1/LL0aZcTbfAOvw: doesn't show hand 
*** SUMMARY ***
Total pot $0.60 | Rake $0 
Seat 1: 3Bm6SLY1pwRvi98HLQUkvg folded before Flop (didn't bet)
Seat 2: tcbEu7VzyHQ+0lh+skbQhQ (button) folded before Flop (didn't bet)
Seat 3: SS/yfeArhULzIcOPe8MdPg (small blind) folded before Flop
Seat 4: 0/dGyX46wFQuMZwX3LgPxg (big blind) folded before Flop
Seat 5: cj4VBQya7HtVL2zCGd5jLQ folded before Flop (didn't bet)
Seat 6: BYxjLnV1/LL0aZcTbfAOvw collected ($0.60)




PokerStars Game #59939379398:  Hold'em No Limit ($0.10/$0.25) - 2009/07/01 0:38:22 ET
Table 'RUOqTfzbAVGS5x+J9aZMHA' 9-max Seat #5 is the button
Seat 1: KBBTLXGhPdPj+4X0QKMkcg ($8.15 in chips) 
Seat 2: Z5ZtGOON8kmSdSCll9Z3XA ($6.70 in chips) 
Seat 4: 18G4P1XstjNvItdGUITxgw ($29 in chips) 
Seat 5: opOCI2p6kW0tINuVaAqmcQ ($25 in chips) 
Seat 6: ljemhp25Zg+nlA9DLCIiUw ($33.55 in chips) 
Seat 8: 3RCAkueG3Vc13VpRStCB+w ($32.35 in chips) 
ljemhp25Zg+nlA9DLCIiUw: posts small blind $0.10
ZWU9RNYtjmm4cElg1I0F4w: is sitting out 
3RCAkueG3Vc13VpRStCB+w: posts big blind $0.25
*** HOLE CARDS ***
KBBTLXGhPdPj+4X0QKMkcg: calls $0.25
Z5ZtGOON8kmSdSCll9Z3XA: folds 
ZWU9RNYtjmm4cElg1I0F4w leaves the table
18G4P1XstjNvItdGUITxgw: folds 
opOCI2p6kW0tINuVaAqmcQ: folds 
ljemhp25Zg+nlA9DLCIiUw: folds 
3RCAkueG3Vc13VpRStCB+w: checks 
*** FLOP *** [7c 6h 3h]
3RCAkueG3Vc13VpRStCB+w: bets $0.50
KBBTLXGhPdPj+4X0QKMkcg: raises $2.50 to $3
3RCAkueG3Vc13VpRStCB+w: raises $14 to $17
KBBTLXGhPdPj+4X0QKMkcg: calls $4.90 and is all-in
Uncalled bet ($9.10) returned to 3RCAkueG3Vc13VpRStCB+w
*** TURN *** [7c 6h 3h] [2s]
*** RIVER *** [7c 6h 3h 2s] [Qd]
*** SHOW DOWN ***
3RCAkueG3Vc13VpRStCB+w: shows [4h 7d] (a pair of Sevens)
KBBTLXGhPdPj+4X0QKMkcg: shows [Jc Jh] (a pair of Jacks)
KBBTLXGhPdPj+4X0QKMkcg collected $15.60 from pot
*** SUMMARY ***
Total pot $16.40 | Rake $0.80 
Board [7c 6h 3h 2s Qd]
Seat 1: KBBTLXGhPdPj+4X0QKMkcg showed [Jc Jh] and won ($15.60) with a pair of Jacks
Seat 2: Z5ZtGOON8kmSdSCll9Z3XA folded before Flop (didn't bet)
Seat 4: 18G4P1XstjNvItdGUITxgw folded before Flop (didn't bet)
Seat 5: opOCI2p6kW0tINuVaAqmcQ (button) folded before Flop (didn't bet)
Seat 6: ljemhp25Zg+nlA9DLCIiUw (small blind) folded before Flop
Seat 8: 3RCAkueG3Vc13VpRStCB+w (big blind) showed [4h 7d] and lost with a pair of Sevens




PokerStars Game #59939379516:  Hold'em No Limit ($0.10/$0.25) - 2009/07/01 0:38:22 ET
Table 'pgrBYaOEx/BuqK5iAtlFzw' 9-max Seat #5 is the button
Seat 3: bfSq6LBw0UvxeM5yfuWC7w ($14.25 in chips) 
Seat 5: efYVL4adq0ufQFnZCpL5Tw ($6.20 in chips) 
efYVL4adq0ufQFnZCpL5Tw: posts small blind $0.10
bfSq6LBw0UvxeM5yfuWC7w: posts big blind $0.25
*** HOLE CARDS ***
efYVL4adq0ufQFnZCpL5Tw: calls $0.15
bfSq6LBw0UvxeM5yfuWC7w: checks 
*** FLOP *** [7h Jc 2c]
bfSq6LBw0UvxeM5yfuWC7w: bets $0.25
efYVL4adq0ufQFnZCpL5Tw: calls $0.25
*** TURN *** [7h Jc 2c] [2h]
bfSq6LBw0UvxeM5yfuWC7w: bets $0.25
efYVL4adq0ufQFnZCpL5Tw: calls $0.25
*** RIVER *** [7h Jc 2c 2h] [8h]
bfSq6LBw0UvxeM5yfuWC7w: bets $0.25
efYVL4adq0ufQFnZCpL5Tw: calls $0.25
*** SHOW DOWN ***
bfSq6LBw0UvxeM5yfuWC7w: shows [5s 7d] (two pair, Sevens and Deuces)
efYVL4adq0ufQFnZCpL5Tw: mucks hand 
bfSq6LBw0UvxeM5yfuWC7w collected $1.95 from pot
*** SUMMARY ***
Total pot $2 | Rake $0.05 
Board [7h Jc 2c 2h 8h]
Seat 3: bfSq6LBw0UvxeM5yfuWC7w (big blind) showed [5s 7d] and won ($1.95) with two pair, Sevens and Deuces
Seat 5: efYVL4adq0ufQFnZCpL5Tw (button) (small blind) mucked




PokerStars Game #59939380648:  Hold'em No Limit ($0.10/$0.25) - 2009/07/01 0:38:23 ET
Table '0w9m+UkNlGMNoPyQqzWk6A' 9-max Seat #3 is the button
Seat 1: 28AHlgXlrYLdiBUJNBoqWA ($27.55 in chips) 
Seat 2: tYsOBqdU1+x+yFI7zHO7hQ ($31.35 in chips) 
Seat 3: VWwtMkIjXloiX/RKh7RGWQ ($5.65 in chips) 
Seat 4: noz/U+++KxL5MIp6+wWstg ($16.20 in chips) 
Seat 5: rPXwQUVloUl+qZm3CCtaJw ($17.35 in chips) 
Seat 6: sWBBy1WroEskLNyJzhkUag ($16.50 in chips) 
Seat 7: lrTLp1zpuCCs/e0pi2M8jw ($12.65 in chips) 
Seat 9: 56S3mA6Zs3pGR+0p0vUCtg ($24.95 in chips) 
noz/U+++KxL5MIp6+wWstg: posts small blind $0.10
rPXwQUVloUl+qZm3CCtaJw: posts big blind $0.25
*** HOLE CARDS ***
hPhp/RE3cJ5YGaQ2xOHXXg has returned
sWBBy1WroEskLNyJzhkUag: folds 
lrTLp1zpuCCs/e0pi2M8jw: folds 
56S3mA6Zs3pGR+0p0vUCtg: folds 
28AHlgXlrYLdiBUJNBoqWA: calls $0.25
tYsOBqdU1+x+yFI7zHO7hQ: folds 
VWwtMkIjXloiX/RKh7RGWQ: calls $0.25
noz/U+++KxL5MIp6+wWstg: folds 
rPXwQUVloUl+qZm3CCtaJw: checks 
*** FLOP *** [5c Kd 2d]
rPXwQUVloUl+qZm3CCtaJw: checks 
28AHlgXlrYLdiBUJNBoqWA: checks 
VWwtMkIjXloiX/RKh7RGWQ: bets $0.50
rPXwQUVloUl+qZm3CCtaJw: folds 
28AHlgXlrYLdiBUJNBoqWA: calls $0.50
*** TURN *** [5c Kd 2d] [Qc]
28AHlgXlrYLdiBUJNBoqWA: checks 
VWwtMkIjXloiX/RKh7RGWQ: checks 
*** RIVER *** [5c Kd 2d Qc] [Td]
28AHlgXlrYLdiBUJNBoqWA: bets $1.75
VWwtMkIjXloiX/RKh7RGWQ: calls $1.75
*** SHOW DOWN ***
28AHlgXlrYLdiBUJNBoqWA: shows [3c Ad] (high card Ace)
VWwtMkIjXloiX/RKh7RGWQ: shows [8d 5d] (a flush, King high)
VWwtMkIjXloiX/RKh7RGWQ collected $5.10 from pot
*** SUMMARY ***
Total pot $5.35 | Rake $0.25 
Board [5c Kd 2d Qc Td]
Seat 1: 28AHlgXlrYLdiBUJNBoqWA showed [3c Ad] and lost with high card Ace
Seat 2: tYsOBqdU1+x+yFI7zHO7hQ folded before Flop (didn't bet)
Seat 3: VWwtMkIjXloiX/RKh7RGWQ (button) showed [8d 5d] and won ($5.10) with a flush, King high
Seat 4: noz/U+++KxL5MIp6+wWstg (small blind) folded before Flop
Seat 5: rPXwQUVloUl+qZm3CCtaJw (big blind) folded on the Flop
Seat 6: sWBBy1WroEskLNyJzhkUag folded before Flop (didn't bet)
Seat 7: lrTLp1zpuCCs/e0pi2M8jw folded before Flop (didn't bet)
Seat 9: 56S3mA6Zs3pGR+0p0vUCtg folded before Flop (didn't bet)




PokerStars Game #59939380256:  Hold'em No Limit ($0.10/$0.25) - 2009/07/01 0:38:23 ET
Table 'Yb2CyZosw7N3yRRVLhKnKg' 9-max Seat #2 is the button
Seat 1: lcT2xQLmuzNRe6+aWd6eww ($32.15 in chips) 
Seat 2: dmYlc+1cjwZMJ7wV+Z0rRg ($25.55 in chips) 
Seat 4: H5Se03ZqSX7tbULXur2MAg ($19.90 in chips) 
Seat 5: QUCO+kde5iROhmqVTzQ6KQ ($37.60 in chips) 
Seat 6: opOCI2p6kW0tINuVaAqmcQ ($25.90 in chips) 
Seat 7: OiV1PWZ3IkN29JlmCcnTwQ ($4.65 in chips) 
Seat 8: aJy680tKSaP5er559aSuGA ($22.50 in chips) 
Seat 9: aCVg6cCxQcqClhB9nq/p1w ($9.45 in chips) 
H5Se03ZqSX7tbULXur2MAg: posts small blind $0.10
QUCO+kde5iROhmqVTzQ6KQ: posts big blind $0.25
*** HOLE CARDS ***
opOCI2p6kW0tINuVaAqmcQ: folds 
OiV1PWZ3IkN29JlmCcnTwQ: folds 
aJy680tKSaP5er559aSuGA: folds 
aCVg6cCxQcqClhB9nq/p1w: folds 
lcT2xQLmuzNRe6+aWd6eww: folds 
dmYlc+1cjwZMJ7wV+Z0rRg: raises $0.50 to $0.75
H5Se03ZqSX7tbULXur2MAg: folds 
QUCO+kde5iROhmqVTzQ6KQ: folds 
Uncalled bet ($0.50) returned to dmYlc+1cjwZMJ7wV+Z0rRg
dmYlc+1cjwZMJ7wV+Z0rRg collected $0.60 from pot
dmYlc+1cjwZMJ7wV+Z0rRg: doesn't show hand 
*** SUMMARY ***
Total pot $0.60 | Rake $0 
Seat 1: lcT2xQLmuzNRe6+aWd6eww folded before Flop (didn't bet)
Seat 2: dmYlc+1cjwZMJ7wV+Z0rRg (button) collected ($0.60)
Seat 4: H5Se03ZqSX7tbULXur2MAg (small blind) folded before Flop
Seat 5: QUCO+kde5iROhmqVTzQ6KQ (big blind) folded before Flop
Seat 6: opOCI2p6kW0tINuVaAqmcQ folded before Flop (didn't bet)
Seat 7: OiV1PWZ3IkN29JlmCcnTwQ folded before Flop (didn't bet)
Seat 8: aJy680tKSaP5er559aSuGA folded before Flop (didn't bet)
Seat 9: aCVg6cCxQcqClhB9nq/p1w folded before Flop (didn't bet)




PokerStars Game #59939380492:  Hold'em No Limit ($0.10/$0.25) - 2009/07/01 0:38:23 ET
Table 'SHi8+hK6i7E2dJ/3Agbyig' 6-max Seat #3 is the button
Seat 1: gPEN9Zp33YTm/mu9/SYP1w ($28.55 in chips) 
Seat 2: Zijzy/UtPWzWVUo81HHVjQ ($43.15 in chips) 
Seat 3: 2p/OXJK5bWQbcvYltdbSfg ($28.30 in chips) 
Seat 4: +KSG/hZ6NXRHDk1WHcV2+Q ($11.50 in chips) 
Seat 5: T5wrp/d5jarm+SxNy8OQAg ($18.50 in chips) 
Seat 6: NVWCcUck2mqZMp/UrHDLKQ ($12 in chips) 
+KSG/hZ6NXRHDk1WHcV2+Q: posts small blind $0.10
T5wrp/d5jarm+SxNy8OQAg: posts big blind $0.25
*** HOLE CARDS ***
NVWCcUck2mqZMp/UrHDLKQ: folds 
gPEN9Zp33YTm/mu9/SYP1w: calls $0.25
Zijzy/UtPWzWVUo81HHVjQ: folds 
2p/OXJK5bWQbcvYltdbSfg: folds 
+KSG/hZ6NXRHDk1WHcV2+Q: raises $0.75 to $1
T5wrp/d5jarm+SxNy8OQAg: folds 
gPEN9Zp33YTm/mu9/SYP1w: calls $0.75
*** FLOP *** [9s 4h Jc]
+KSG/hZ6NXRHDk1WHcV2+Q: checks 
gPEN9Zp33YTm/mu9/SYP1w: checks 
*** TURN *** [9s 4h Jc] [Ad]
+KSG/hZ6NXRHDk1WHcV2+Q: bets $0.75
gPEN9Zp33YTm/mu9/SYP1w: calls $0.75
*** RIVER *** [9s 4h Jc Ad] [3d]
+KSG/hZ6NXRHDk1WHcV2+Q: bets $2
gPEN9Zp33YTm/mu9/SYP1w: calls $2
*** SHOW DOWN ***
+KSG/hZ6NXRHDk1WHcV2+Q: shows [Jd Js] (three of a kind, Jacks)
gPEN9Zp33YTm/mu9/SYP1w: mucks hand 
+KSG/hZ6NXRHDk1WHcV2+Q collected $7.40 from pot
*** SUMMARY ***
Total pot $7.75 | Rake $0.35 
Board [9s 4h Jc Ad 3d]
Seat 1: gPEN9Zp33YTm/mu9/SYP1w mucked
Seat 2: Zijzy/UtPWzWVUo81HHVjQ folded before Flop (didn't bet)
Seat 3: 2p/OXJK5bWQbcvYltdbSfg (button) folded before Flop (didn't bet)
Seat 4: +KSG/hZ6NXRHDk1WHcV2+Q (small blind) showed [Jd Js] and won ($7.40) with three of a kind, Jacks
Seat 5: T5wrp/d5jarm+SxNy8OQAg (big blind) folded before Flop
Seat 6: NVWCcUck2mqZMp/UrHDLKQ folded before Flop (didn't bet)




PokerStars Game #59939380234:  Hold'em No Limit ($0.10/$0.25) - 2009/07/01 0:38:23 ET
Table 'OvOqQoL/QnXuXuQjXo2hIQ' 9-max Seat #6 is the button
Seat 3: uJlzv9KL7hgCIqIS2ofoaw ($11.20 in chips) 
Seat 4: e8solDZU6VFefGEm0DJbUg ($11.15 in chips) 
Seat 5: sJNHTWcSlLHRCZ9+YRLLqA ($28.95 in chips) 
Seat 6: MIVCHqCqqlke0Lb0z7glcw ($46.65 in chips) 
Seat 7: aNpwfA31EREwO+ar4XzBCw ($26.90 in chips) 
Seat 9: VWUWpMLMj/Q1jRVpF7Aohw ($14.60 in chips) 
aNpwfA31EREwO+ar4XzBCw: posts small blind $0.10
42xLFHn85WRGGaaUZTNvwA: is sitting out 
VWUWpMLMj/Q1jRVpF7Aohw: posts big blind $0.25
*** HOLE CARDS ***
uJlzv9KL7hgCIqIS2ofoaw: folds 
42xLFHn85WRGGaaUZTNvwA leaves the table
e8solDZU6VFefGEm0DJbUg: folds 
sJNHTWcSlLHRCZ9+YRLLqA: folds 
MIVCHqCqqlke0Lb0z7glcw: folds 
aNpwfA31EREwO+ar4XzBCw: folds 
Uncalled bet ($0.15) returned to VWUWpMLMj/Q1jRVpF7Aohw
VWUWpMLMj/Q1jRVpF7Aohw collected $0.20 from pot
VWUWpMLMj/Q1jRVpF7Aohw: doesn't show hand 
*** SUMMARY ***
Total pot $0.20 | Rake $0 
Seat 3: uJlzv9KL7hgCIqIS2ofoaw folded before Flop (didn't bet)
Seat 4: e8solDZU6VFefGEm0DJbUg folded before Flop (didn't bet)
Seat 5: sJNHTWcSlLHRCZ9+YRLLqA folded before Flop (didn't bet)
Seat 6: MIVCHqCqqlke0Lb0z7glcw (button) folded before Flop (didn't bet)
Seat 7: aNpwfA31EREwO+ar4XzBCw (small blind) folded before Flop
Seat 9: VWUWpMLMj/Q1jRVpF7Aohw (big blind) collected ($0.20)




PokerStars Game #59939380496:  Hold'em No Limit ($0.10/$0.25) - 2009/07/01 0:38:23 ET
Table '2clPgY3+dETPD/8zjXZdFw' 6-max Seat #2 is the button
Seat 1: qllppsCmUqovlriIWCeM/g ($5 in chips) 
Seat 2: NzIFHwilc5zU7QhjDTgTZA ($6.25 in chips) 
Seat 3: 6pF9LtHn+EH0ChbOXzox9g ($3.85 in chips) 
6pF9LtHn+EH0ChbOXzox9g: posts small blind $0.10
qllppsCmUqovlriIWCeM/g: posts big blind $0.25
*** HOLE CARDS ***
NzIFHwilc5zU7QhjDTgTZA: calls $0.25
6pF9LtHn+EH0ChbOXzox9g: raises $0.75 to $1
qllppsCmUqovlriIWCeM/g: folds 
NzIFHwilc5zU7QhjDTgTZA: folds 
Uncalled bet ($0.75) returned to 6pF9LtHn+EH0ChbOXzox9g
6pF9LtHn+EH0ChbOXzox9g collected $0.75 from pot
6pF9LtHn+EH0ChbOXzox9g: doesn't show hand 
*** SUMMARY ***
Total pot $0.75 | Rake $0 
Seat 1: qllppsCmUqovlriIWCeM/g (big blind) folded before Flop
Seat 2: NzIFHwilc5zU7QhjDTgTZA (button) folded before Flop
Seat 3: 6pF9LtHn+EH0ChbOXzox9g (small blind) collected ($0.75)




PokerStars Game #59939380806:  Hold'em No Limit ($0.10/$0.25) - 2009/07/01 0:38:24 ET
Table 'mVdLgAdN9rGe6mMwSrDdGQ' 6-max Seat #1 is the button
Seat 1: 1tFjlBNp9g4Qjfo0vKlSzw ($13.15 in chips) 
Seat 2: fSUx4e1vURbgXyDBEcRbAg ($1.75 in chips) 
Seat 3: kG34n23qFQA3nzdOJTQ1dA ($24.65 in chips) 
Seat 5: oseFhpinoe+Zg4j5xyBjyQ ($56.95 in chips) 
Seat 6: Ew/TYPQIsbQ2X8nm5iAJBg ($24.65 in chips) 
fSUx4e1vURbgXyDBEcRbAg: posts small blind $0.10
kG34n23qFQA3nzdOJTQ1dA: posts big blind $0.25
*** HOLE CARDS ***
oseFhpinoe+Zg4j5xyBjyQ: folds 
Ew/TYPQIsbQ2X8nm5iAJBg: folds 
1tFjlBNp9g4Qjfo0vKlSzw: folds 
fSUx4e1vURbgXyDBEcRbAg: calls $0.15
kG34n23qFQA3nzdOJTQ1dA: checks 
*** FLOP *** [6d 9h 2h]
fSUx4e1vURbgXyDBEcRbAg: bets $1.25
kG34n23qFQA3nzdOJTQ1dA: folds 
Uncalled bet ($1.25) returned to fSUx4e1vURbgXyDBEcRbAg
fSUx4e1vURbgXyDBEcRbAg collected $0.50 from pot
*** SUMMARY ***
Total pot $0.50 | Rake $0 
Board [6d 9h 2h]
Seat 1: 1tFjlBNp9g4Qjfo0vKlSzw (button) folded before Flop (didn't bet)
Seat 2: fSUx4e1vURbgXyDBEcRbAg (small blind) collected ($0.50)
Seat 3: kG34n23qFQA3nzdOJTQ1dA (big blind) folded on the Flop
Seat 5: oseFhpinoe+Zg4j5xyBjyQ folded before Flop (didn't bet)
Seat 6: Ew/TYPQIsbQ2X8nm5iAJBg folded before Flop (didn't bet)




PokerStars Game #59939380984:  Hold'em No Limit ($0.10/$0.25) - 2009/07/01 0:38:24 ET
Table '1LkLBsok91+aSWIELy/cyw' 6-max Seat #4 is the button
Seat 1: /gJNBeCkWL4o85/jvlZ4BA ($26 in chips) 
Seat 2: oseFhpinoe+Zg4j5xyBjyQ ($25.95 in chips) 
Seat 3: wUwfsTnmpHcWa17qFlQr1Q ($5.20 in chips) 
Seat 4: vEZ/HxVuyR6kaq0BtZoUgQ ($13.85 in chips) 
Seat 5: trN/oHqTTbPw5MNuKrOpLw ($30.05 in chips) 
Seat 6: MuW7Zf0FjOGlCuY3aIrlsA ($23.60 in chips) 
trN/oHqTTbPw5MNuKrOpLw: posts small blind $0.10
MuW7Zf0FjOGlCuY3aIrlsA: posts big blind $0.25
*** HOLE CARDS ***
/gJNBeCkWL4o85/jvlZ4BA: folds 
oseFhpinoe+Zg4j5xyBjyQ: folds 
wUwfsTnmpHcWa17qFlQr1Q: calls $0.25
vEZ/HxVuyR6kaq0BtZoUgQ: folds 
trN/oHqTTbPw5MNuKrOpLw: calls $0.15
MuW7Zf0FjOGlCuY3aIrlsA: checks 
*** FLOP *** [Js Jc Kc]
trN/oHqTTbPw5MNuKrOpLw: checks 
MuW7Zf0FjOGlCuY3aIrlsA: checks 
wUwfsTnmpHcWa17qFlQr1Q: bets $0.75
trN/oHqTTbPw5MNuKrOpLw: folds 
MuW7Zf0FjOGlCuY3aIrlsA: folds 
Uncalled bet ($0.75) returned to wUwfsTnmpHcWa17qFlQr1Q
wUwfsTnmpHcWa17qFlQr1Q collected $0.75 from pot
wUwfsTnmpHcWa17qFlQr1Q: doesn't show hand 
*** SUMMARY ***
Total pot $0.75 | Rake $0 
Board [Js Jc Kc]
Seat 1: /gJNBeCkWL4o85/jvlZ4BA folded before Flop (didn't bet)
Seat 2: oseFhpinoe+Zg4j5xyBjyQ folded before Flop (didn't bet)
Seat 3: wUwfsTnmpHcWa17qFlQr1Q collected ($0.75)
Seat 4: vEZ/HxVuyR6kaq0BtZoUgQ (button) folded before Flop (didn't bet)
Seat 5: trN/oHqTTbPw5MNuKrOpLw (small blind) folded on the Flop
Seat 6: MuW7Zf0FjOGlCuY3aIrlsA (big blind) folded on the Flop




PokerStars Game #59939380868:  Hold'em No Limit ($0.10/$0.25) - 2009/07/01 0:38:24 ET
Table 'xmJKTGBeWCwutccj3YfupQ' 6-max Seat #5 is the button
Seat 1: sVbkVl4OznxBCfi66UB9vw ($60.45 in chips) 
Seat 2: BedjMfrlRfPgSq7CXpPAmg ($48.80 in chips) 
Seat 3: FStoHe64SQWqAsjya9pDkQ ($25.65 in chips) 
Seat 4: uWjhTVMpuIroxXcmD3Okug ($41.90 in chips) 
Seat 5: oBUDUfeUyCbZBsjxHZgSiw ($15.90 in chips) 
Seat 6: lYjWCpfCxX2kgcHY3v4Yow ($26.10 in chips) 
lYjWCpfCxX2kgcHY3v4Yow: posts small blind $0.10
sVbkVl4OznxBCfi66UB9vw: posts big blind $0.25
*** HOLE CARDS ***
BedjMfrlRfPgSq7CXpPAmg: folds 
FStoHe64SQWqAsjya9pDkQ: raises $0.50 to $0.75
uWjhTVMpuIroxXcmD3Okug: folds 
sVbkVl4OznxBCfi66UB9vw said, "ty"
oBUDUfeUyCbZBsjxHZgSiw: calls $0.75
lYjWCpfCxX2kgcHY3v4Yow: folds 
sVbkVl4OznxBCfi66UB9vw: folds 
*** FLOP *** [Ks 6h 5s]
uWjhTVMpuIroxXcmD3Okug said, "wanted to fold so bad but something funny was going on from the get go"
FStoHe64SQWqAsjya9pDkQ: bets $1.25
oBUDUfeUyCbZBsjxHZgSiw: calls $1.25
*** TURN *** [Ks 6h 5s] [Qh]
uWjhTVMpuIroxXcmD3Okug said, "punishment i suppose"
FStoHe64SQWqAsjya9pDkQ: checks 
oBUDUfeUyCbZBsjxHZgSiw: bets $2
FStoHe64SQWqAsjya9pDkQ: folds 
Uncalled bet ($2) returned to oBUDUfeUyCbZBsjxHZgSiw
oBUDUfeUyCbZBsjxHZgSiw collected $4.15 from pot
*** SUMMARY ***
Total pot $4.35 | Rake $0.20 
Board [Ks 6h 5s Qh]
Seat 1: sVbkVl4OznxBCfi66UB9vw (big blind) folded before Flop
Seat 2: BedjMfrlRfPgSq7CXpPAmg folded before Flop (didn't bet)
Seat 3: FStoHe64SQWqAsjya9pDkQ folded on the Turn
Seat 4: uWjhTVMpuIroxXcmD3Okug folded before Flop (didn't bet)
Seat 5: oBUDUfeUyCbZBsjxHZgSiw (button) collected ($4.15)
Seat 6: lYjWCpfCxX2kgcHY3v4Yow (small blind) folded before Flop




PokerStars Game #59939381148:  Hold'em No Limit ($0.10/$0.25) - 2009/07/01 0:38:24 ET
Table 'K/f0NNaoGuhSz5DrzgVw7Q' 9-max Seat #4 is the button
Seat 2: 18G4P1XstjNvItdGUITxgw ($25 in chips) 
Seat 3: VBHxUExRAMrbxUq/cVx9Gw ($5.25 in chips) 
Seat 4: 3L1qKVpA6QZjrddTpoh2zQ ($12.40 in chips) 
Seat 5: DnDcAdn9P0zGovMERigpFA ($25.50 in chips) 
Seat 6: 3PVK0IdMlq2fElkVzzr4bg ($19 in chips) 
Seat 7: st9jtdNbm1W5GfBwRaCVqQ ($22.80 in chips) 
Seat 8: E0iYnEVO2ho7dH3QcCjw7g ($20 in chips) 
Seat 9: B5Xu8WsfFPfBlsK3fbAtQQ ($12.45 in chips) 
DnDcAdn9P0zGovMERigpFA: posts small blind $0.10
3PVK0IdMlq2fElkVzzr4bg: posts big blind $0.25
*** HOLE CARDS ***
st9jtdNbm1W5GfBwRaCVqQ: folds 
E0iYnEVO2ho7dH3QcCjw7g: folds 
B5Xu8WsfFPfBlsK3fbAtQQ: calls $0.25
18G4P1XstjNvItdGUITxgw: folds 
VBHxUExRAMrbxUq/cVx9Gw: folds 
3L1qKVpA6QZjrddTpoh2zQ: raises $0.50 to $0.75
DnDcAdn9P0zGovMERigpFA: folds 
3PVK0IdMlq2fElkVzzr4bg: calls $0.50
B5Xu8WsfFPfBlsK3fbAtQQ: calls $0.50
*** FLOP *** [4d Qc Td]
3PVK0IdMlq2fElkVzzr4bg: checks 
B5Xu8WsfFPfBlsK3fbAtQQ: checks 
hPhp/RE3cJ5YGaQ2xOHXXg leaves the table
3L1qKVpA6QZjrddTpoh2zQ: bets $1.50
3PVK0IdMlq2fElkVzzr4bg: calls $1.50
B5Xu8WsfFPfBlsK3fbAtQQ: folds 
*** TURN *** [4d Qc Td] [Ks]
sD+TKtt36XiiN6jqHiLwDA joins the table at seat #1 
3PVK0IdMlq2fElkVzzr4bg: checks 
3L1qKVpA6QZjrddTpoh2zQ: bets $3.50
3PVK0IdMlq2fElkVzzr4bg: folds 
Uncalled bet ($3.50) returned to 3L1qKVpA6QZjrddTpoh2zQ
3L1qKVpA6QZjrddTpoh2zQ collected $5.10 from pot
3L1qKVpA6QZjrddTpoh2zQ: doesn't show hand 
*** SUMMARY ***
Total pot $5.35 | Rake $0.25 
Board [4d Qc Td Ks]
Seat 2: 18G4P1XstjNvItdGUITxgw folded before Flop (didn't bet)
Seat 3: VBHxUExRAMrbxUq/cVx9Gw folded before Flop (didn't bet)
Seat 4: 3L1qKVpA6QZjrddTpoh2zQ (button) collected ($5.10)
Seat 5: DnDcAdn9P0zGovMERigpFA (small blind) folded before Flop
Seat 6: 3PVK0IdMlq2fElkVzzr4bg (big blind) folded on the Turn
Seat 7: st9jtdNbm1W5GfBwRaCVqQ folded before Flop (didn't bet)
Seat 8: E0iYnEVO2ho7dH3QcCjw7g folded before Flop (didn't bet)
Seat 9: B5Xu8WsfFPfBlsK3fbAtQQ folded on the Flop




PokerStars Game #59939381256:  Hold'em No Limit ($0.10/$0.25) - 2009/07/01 0:38:24 ET
Table 'Ez9TB43XM4QgMDQkIW9DYw' 9-max Seat #2 is the button
Seat 1: YqWNLUj3exwMphJEDBi8Ug ($26.25 in chips) 
Seat 2: gtLY9BJ1dcPGyJ0NDNjaBg ($10.40 in chips) 
Seat 3: LorpmCSxb4uozpKwk8Awsg ($27.90 in chips) 
Seat 4: il+NK449FnwuQ8vyJ0Xn/g ($9.75 in chips) 
Seat 5: vZGoOTJLQLhkPj4I+LNGig ($25.60 in chips) 
Seat 6: 76o85YBHJ9veRYp2LPuluQ ($32.55 in chips) 
Seat 7: 18G4P1XstjNvItdGUITxgw ($25 in chips) 
Seat 9: QEbIGci+itdw+re8RM5fZA ($25 in chips) 
LorpmCSxb4uozpKwk8Awsg: posts small blind $0.10
il+NK449FnwuQ8vyJ0Xn/g: posts big blind $0.25
+2kMBNpY4nF1qNCRd8SJLA: sits out 
*** HOLE CARDS ***
vZGoOTJLQLhkPj4I+LNGig: folds 
76o85YBHJ9veRYp2LPuluQ: raises $0.25 to $0.50
18G4P1XstjNvItdGUITxgw: folds 
QEbIGci+itdw+re8RM5fZA: folds 
YqWNLUj3exwMphJEDBi8Ug: calls $0.50
gtLY9BJ1dcPGyJ0NDNjaBg: folds 
LorpmCSxb4uozpKwk8Awsg: calls $0.40
il+NK449FnwuQ8vyJ0Xn/g: calls $0.25
*** FLOP *** [Qc Js 5d]
LorpmCSxb4uozpKwk8Awsg: checks 
il+NK449FnwuQ8vyJ0Xn/g: checks 
76o85YBHJ9veRYp2LPuluQ: bets $0.25
YqWNLUj3exwMphJEDBi8Ug: calls $0.25
LorpmCSxb4uozpKwk8Awsg: calls $0.25
il+NK449FnwuQ8vyJ0Xn/g: folds 
*** TURN *** [Qc Js 5d] [8h]
LorpmCSxb4uozpKwk8Awsg: checks 
76o85YBHJ9veRYp2LPuluQ: bets $0.50
YqWNLUj3exwMphJEDBi8Ug: raises $1 to $1.50
LorpmCSxb4uozpKwk8Awsg: folds 
76o85YBHJ9veRYp2LPuluQ: calls $1
*** RIVER *** [Qc Js 5d 8h] [2c]
76o85YBHJ9veRYp2LPuluQ: checks 
YqWNLUj3exwMphJEDBi8Ug: bets $2.50
76o85YBHJ9veRYp2LPuluQ: folds 
Uncalled bet ($2.50) returned to YqWNLUj3exwMphJEDBi8Ug
YqWNLUj3exwMphJEDBi8Ug collected $5.50 from pot
YqWNLUj3exwMphJEDBi8Ug: doesn't show hand 
*** SUMMARY ***
Total pot $5.75 | Rake $0.25 
Board [Qc Js 5d 8h 2c]
Seat 1: YqWNLUj3exwMphJEDBi8Ug collected ($5.50)
Seat 2: gtLY9BJ1dcPGyJ0NDNjaBg (button) folded before Flop (didn't bet)
Seat 3: LorpmCSxb4uozpKwk8Awsg (small blind) folded on the Turn
Seat 4: il+NK449FnwuQ8vyJ0Xn/g (big blind) folded on the Flop
Seat 5: vZGoOTJLQLhkPj4I+LNGig folded before Flop (didn't bet)
Seat 6: 76o85YBHJ9veRYp2LPuluQ folded on the River
Seat 7: 18G4P1XstjNvItdGUITxgw folded before Flop (didn't bet)
Seat 9: QEbIGci+itdw+re8RM5fZA folded before Flop (didn't bet)




PokerStars Game #59939381058:  Hold'em No Limit ($0.10/$0.25) - 2009/07/01 0:38:24 ET
Table 'xro+BVoe2Zuw1TYmz/McJQ' 9-max Seat #7 is the button
Seat 1: xEQxarad8/T4jJdpZy5LGw ($7.70 in chips) 
Seat 2: MXCztnYJ58KLHMztZvKrxA ($12.65 in chips) 
Seat 3: COsrwJSFHQtxlUcrYtDQPQ ($39.45 in chips) 
Seat 4: N2LVj3iImgnOoHVf8g0rIw ($18.50 in chips) 
Seat 5: 87Warq49WFhxNpfNtKRmcQ ($28.25 in chips) 
Seat 6: HPEB+AtKw1+C/cxU0o1ciw ($24.55 in chips) 
Seat 7: QEbIGci+itdw+re8RM5fZA ($25 in chips) 
Seat 8: ljemhp25Zg+nlA9DLCIiUw ($19.90 in chips) 
Seat 9: H5Se03ZqSX7tbULXur2MAg ($24.65 in chips) 
ljemhp25Zg+nlA9DLCIiUw: posts small blind $0.10
H5Se03ZqSX7tbULXur2MAg: posts big blind $0.25
*** HOLE CARDS ***
xEQxarad8/T4jJdpZy5LGw: folds 
MXCztnYJ58KLHMztZvKrxA: folds 
COsrwJSFHQtxlUcrYtDQPQ: folds 
N2LVj3iImgnOoHVf8g0rIw: raises $0.50 to $0.75
87Warq49WFhxNpfNtKRmcQ: folds 
HPEB+AtKw1+C/cxU0o1ciw: folds 
QEbIGci+itdw+re8RM5fZA: folds 
ljemhp25Zg+nlA9DLCIiUw: folds 
H5Se03ZqSX7tbULXur2MAg: folds 
Uncalled bet ($0.50) returned to N2LVj3iImgnOoHVf8g0rIw
N2LVj3iImgnOoHVf8g0rIw collected $0.60 from pot
*** SUMMARY ***
Total pot $0.60 | Rake $0 
Seat 1: xEQxarad8/T4jJdpZy5LGw folded before Flop (didn't bet)
Seat 2: MXCztnYJ58KLHMztZvKrxA folded before Flop (didn't bet)
Seat 3: COsrwJSFHQtxlUcrYtDQPQ folded before Flop (didn't bet)
Seat 4: N2LVj3iImgnOoHVf8g0rIw collected ($0.60)
Seat 5: 87Warq49WFhxNpfNtKRmcQ folded before Flop (didn't bet)
Seat 6: HPEB+AtKw1+C/cxU0o1ciw folded before Flop (didn't bet)
Seat 7: QEbIGci+itdw+re8RM5fZA (button) folded before Flop (didn't bet)
Seat 8: ljemhp25Zg+nlA9DLCIiUw (small blind) folded before Flop
Seat 9: H5Se03ZqSX7tbULXur2MAg (big blind) folded before Flop




PokerStars Game #59939381472:  Hold'em No Limit ($0.10/$0.25) - 2009/07/01 0:38:25 ET
Table 'hg+KpirwreMnBAFQr/SEUA' 9-max Seat #5 is the button
Seat 1: H5Se03ZqSX7tbULXur2MAg ($24.10 in chips) 
Seat 2: OlPJsgR4xypSg/w1z7Gyvw ($18.40 in chips) 
Seat 3: N6fYvIzQLKaydFLKQGtMlQ ($24.65 in chips) 
Seat 4: GGSFATxBXI5pXwoMMI70zg ($5.45 in chips) 
Seat 5: +2kMBNpY4nF1qNCRd8SJLA ($25 in chips) 
Seat 6: dAohy+E9dUFBp6GlYFiOtQ ($24.70 in chips) 
Seat 7: EcWpc/mcsCWBGKsSdZaXbA ($23.80 in chips) 
Seat 8: HPEB+AtKw1+C/cxU0o1ciw ($25 in chips) 
Seat 9: Il5IBomZPnY0uD8k+rlPyw ($47.90 in chips) 
dAohy+E9dUFBp6GlYFiOtQ: posts small blind $0.10
EcWpc/mcsCWBGKsSdZaXbA: posts big blind $0.25
*** HOLE CARDS ***
HPEB+AtKw1+C/cxU0o1ciw: folds 
Il5IBomZPnY0uD8k+rlPyw: folds 
H5Se03ZqSX7tbULXur2MAg: raises $0.50 to $0.75
OlPJsgR4xypSg/w1z7Gyvw: folds 
N6fYvIzQLKaydFLKQGtMlQ: folds 
GGSFATxBXI5pXwoMMI70zg: folds 
+2kMBNpY4nF1qNCRd8SJLA: folds 
dAohy+E9dUFBp6GlYFiOtQ: folds 
EcWpc/mcsCWBGKsSdZaXbA: folds 
Uncalled bet ($0.50) returned to H5Se03ZqSX7tbULXur2MAg
H5Se03ZqSX7tbULXur2MAg collected $0.60 from pot
H5Se03ZqSX7tbULXur2MAg: doesn't show hand 
*** SUMMARY ***
Total pot $0.60 | Rake $0 
Seat 1: H5Se03ZqSX7tbULXur2MAg collected ($0.60)
Seat 2: OlPJsgR4xypSg/w1z7Gyvw folded before Flop (didn't bet)
Seat 3: N6fYvIzQLKaydFLKQGtMlQ folded before Flop (didn't bet)
Seat 4: GGSFATxBXI5pXwoMMI70zg folded before Flop (didn't bet)
Seat 5: +2kMBNpY4nF1qNCRd8SJLA (button) folded before Flop (didn't bet)
Seat 6: dAohy+E9dUFBp6GlYFiOtQ (small blind) folded before Flop
Seat 7: EcWpc/mcsCWBGKsSdZaXbA (big blind) folded before Flop
Seat 8: HPEB+AtKw1+C/cxU0o1ciw folded before Flop (didn't bet)
Seat 9: Il5IBomZPnY0uD8k+rlPyw folded before Flop (didn't bet)




PokerStars Game #59939381470:  Hold'em No Limit ($0.10/$0.25) - 2009/07/01 0:38:25 ET
Table 'HIOfhT0zga/KonFhIl6O3w' 9-max Seat #6 is the button
Seat 1: t2nb95S5EEFOEzNx9Itz0g ($6.20 in chips) 
Seat 2: er86weqXTpTB6/w2dKlYgA ($16.45 in chips) 
Seat 3: RxrlOCIHB/l30KL6EEws0g ($37.15 in chips) 
Seat 4: qwr38jl5txoR36M7G5qi4A ($8.10 in chips) 
Seat 5: K1MDeapSEyKyGPNZGOKfEg ($13.65 in chips) 
Seat 6: cZ99hugmLBj9KhTlc8nCSw ($25.70 in chips) 
Seat 7: H9KUl8cmpLgEpOVDA00bCg ($5.35 in chips) 
Seat 8: 3RCAkueG3Vc13VpRStCB+w ($26.35 in chips) 
Seat 9: dfNim92Z6XK1/h5SFW5vDg ($25 in chips) 
H9KUl8cmpLgEpOVDA00bCg: posts small blind $0.10
3RCAkueG3Vc13VpRStCB+w: posts big blind $0.25
*** HOLE CARDS ***
dfNim92Z6XK1/h5SFW5vDg: folds 
t2nb95S5EEFOEzNx9Itz0g: folds 
er86weqXTpTB6/w2dKlYgA: folds 
RxrlOCIHB/l30KL6EEws0g: folds 
qwr38jl5txoR36M7G5qi4A: folds 
K1MDeapSEyKyGPNZGOKfEg: calls $0.25
cZ99hugmLBj9KhTlc8nCSw: folds 
H9KUl8cmpLgEpOVDA00bCg: folds 
3RCAkueG3Vc13VpRStCB+w: checks 
*** FLOP *** [4s 9h 2s]
3RCAkueG3Vc13VpRStCB+w: checks 
K1MDeapSEyKyGPNZGOKfEg: checks 
*** TURN *** [4s 9h 2s] [Ad]
3RCAkueG3Vc13VpRStCB+w: checks 
K1MDeapSEyKyGPNZGOKfEg: checks 
*** RIVER *** [4s 9h 2s Ad] [8d]
3RCAkueG3Vc13VpRStCB+w: bets $0.50
K1MDeapSEyKyGPNZGOKfEg: calls $0.50
*** SHOW DOWN ***
3RCAkueG3Vc13VpRStCB+w: shows [8c Kh] (a pair of Eights)
K1MDeapSEyKyGPNZGOKfEg: shows [Ah Qs] (a pair of Aces)
K1MDeapSEyKyGPNZGOKfEg collected $1.55 from pot
*** SUMMARY ***
Total pot $1.60 | Rake $0.05 
Board [4s 9h 2s Ad 8d]
Seat 1: t2nb95S5EEFOEzNx9Itz0g folded before Flop (didn't bet)
Seat 2: er86weqXTpTB6/w2dKlYgA folded before Flop (didn't bet)
Seat 3: RxrlOCIHB/l30KL6EEws0g folded before Flop (didn't bet)
Seat 4: qwr38jl5txoR36M7G5qi4A folded before Flop (didn't bet)
Seat 5: K1MDeapSEyKyGPNZGOKfEg showed [Ah Qs] and won ($1.55) with a pair of Aces
Seat 6: cZ99hugmLBj9KhTlc8nCSw (button) folded before Flop (didn't bet)
Seat 7: H9KUl8cmpLgEpOVDA00bCg (small blind) folded before Flop
Seat 8: 3RCAkueG3Vc13VpRStCB+w (big blind) showed [8c Kh] and lost with a pair of Eights
Seat 9: dfNim92Z6XK1/h5SFW5vDg folded before Flop (didn't bet)




PokerStars Game #59939381898:  Hold'em No Limit ($0.10/$0.25) - 2009/07/01 0:38:25 ET
Table 'mdub7rJf3Z5tCT9s/+1+Wg' 9-max Seat #5 is the button
Seat 1: neWdS67T0XWLJXFjrqXj5g ($15.75 in chips) 
Seat 2: vSkQm2EelzwRGDDQQk0Fqw ($4.65 in chips) 
Seat 3: t2nb95S5EEFOEzNx9Itz0g ($6.30 in chips) 
Seat 4: fDGyaQz0cs2s4FOYxkbIHA ($4.55 in chips) 
Seat 5: dfNim92Z6XK1/h5SFW5vDg ($25 in chips) 
Seat 6: hAFbY0iBwr4mouozgvjZBg ($47.70 in chips) 
Seat 7: woe+9KKk+L3pZgMTuHcmog ($26 in chips) 
Seat 8: cZ99hugmLBj9KhTlc8nCSw ($25 in chips) 
Seat 9: tYsOBqdU1+x+yFI7zHO7hQ ($36.75 in chips) 
hAFbY0iBwr4mouozgvjZBg: posts small blind $0.10
woe+9KKk+L3pZgMTuHcmog: posts big blind $0.25
*** HOLE CARDS ***
cZ99hugmLBj9KhTlc8nCSw: folds 
tYsOBqdU1+x+yFI7zHO7hQ: folds 
neWdS67T0XWLJXFjrqXj5g: folds 
vSkQm2EelzwRGDDQQk0Fqw: folds 
t2nb95S5EEFOEzNx9Itz0g: raises $0.50 to $0.75
fDGyaQz0cs2s4FOYxkbIHA: folds 
dfNim92Z6XK1/h5SFW5vDg: folds 
hAFbY0iBwr4mouozgvjZBg: folds 
woe+9KKk+L3pZgMTuHcmog: calls $0.50
*** FLOP *** [Tc 7d 7s]
woe+9KKk+L3pZgMTuHcmog: checks 
t2nb95S5EEFOEzNx9Itz0g: bets $1.50
woe+9KKk+L3pZgMTuHcmog: calls $1.50
*** TURN *** [Tc 7d 7s] [8h]
woe+9KKk+L3pZgMTuHcmog: checks 
t2nb95S5EEFOEzNx9Itz0g: bets $4.05 and is all-in
woe+9KKk+L3pZgMTuHcmog: calls $4.05
*** RIVER *** [Tc 7d 7s 8h] [Jc]
*** SHOW DOWN ***
woe+9KKk+L3pZgMTuHcmog: shows [4c 7c] (three of a kind, Sevens)
t2nb95S5EEFOEzNx9Itz0g: mucks hand 
woe+9KKk+L3pZgMTuHcmog collected $12.10 from pot
*** SUMMARY ***
Total pot $12.70 | Rake $0.60 
Board [Tc 7d 7s 8h Jc]
Seat 1: neWdS67T0XWLJXFjrqXj5g folded before Flop (didn't bet)
Seat 2: vSkQm2EelzwRGDDQQk0Fqw folded before Flop (didn't bet)
Seat 3: t2nb95S5EEFOEzNx9Itz0g mucked
Seat 4: fDGyaQz0cs2s4FOYxkbIHA folded before Flop (didn't bet)
Seat 5: dfNim92Z6XK1/h5SFW5vDg (button) folded before Flop (didn't bet)
Seat 6: hAFbY0iBwr4mouozgvjZBg (small blind) folded before Flop
Seat 7: woe+9KKk+L3pZgMTuHcmog (big blind) showed [4c 7c] and won ($12.10) with three of a kind, Sevens
Seat 8: cZ99hugmLBj9KhTlc8nCSw folded before Flop (didn't bet)
Seat 9: tYsOBqdU1+x+yFI7zHO7hQ folded before Flop (didn't bet)




PokerStars Game #59939381468:  Hold'em No Limit ($0.10/$0.25) - 2009/07/01 0:38:25 ET
Table 'jItkp2PNTbH9Cf7gqsAF7g' 9-max Seat #7 is the button
Seat 1: oMId4udwsHQHc0MOjQyi9w ($14.70 in chips) 
Seat 2: qwr38jl5txoR36M7G5qi4A ($7.50 in chips) 
Seat 3: E0iYnEVO2ho7dH3QcCjw7g ($24.35 in chips) 
Seat 5: uH1RN27w9SKa7TpVR9EFrQ ($19.30 in chips) 
Seat 6: cZ99hugmLBj9KhTlc8nCSw ($58.60 in chips) 
Seat 7: st9jtdNbm1W5GfBwRaCVqQ ($21.75 in chips) 
Seat 8: t82lXIS9gxYmNHmDgWRFAQ ($11.95 in chips) 
Seat 9: H9KUl8cmpLgEpOVDA00bCg ($5 in chips) 
t82lXIS9gxYmNHmDgWRFAQ: posts small blind $0.10
H9KUl8cmpLgEpOVDA00bCg: posts big blind $0.25
*** HOLE CARDS ***
oMId4udwsHQHc0MOjQyi9w: folds 
oMId4udwsHQHc0MOjQyi9w leaves the table
qwr38jl5txoR36M7G5qi4A: folds 
OiV1PWZ3IkN29JlmCcnTwQ joins the table at seat #1 
E0iYnEVO2ho7dH3QcCjw7g: folds 
uH1RN27w9SKa7TpVR9EFrQ: calls $0.25
cZ99hugmLBj9KhTlc8nCSw: folds 
st9jtdNbm1W5GfBwRaCVqQ: calls $0.25
t82lXIS9gxYmNHmDgWRFAQ: folds 
H9KUl8cmpLgEpOVDA00bCg: checks 
*** FLOP *** [Ks 3c 3s]
H9KUl8cmpLgEpOVDA00bCg: checks 
uH1RN27w9SKa7TpVR9EFrQ: checks 
st9jtdNbm1W5GfBwRaCVqQ: checks 
*** TURN *** [Ks 3c 3s] [8h]
GQTWTgG7Ydy9q/vohVnKmQ has returned
H9KUl8cmpLgEpOVDA00bCg: bets $0.50
uH1RN27w9SKa7TpVR9EFrQ: calls $0.50
st9jtdNbm1W5GfBwRaCVqQ: folds 
*** RIVER *** [Ks 3c 3s 8h] [Td]
H9KUl8cmpLgEpOVDA00bCg: bets $0.75
uH1RN27w9SKa7TpVR9EFrQ: calls $0.75
*** SHOW DOWN ***
H9KUl8cmpLgEpOVDA00bCg: shows [4c Kd] (two pair, Kings and Threes)
uH1RN27w9SKa7TpVR9EFrQ: mucks hand 
H9KUl8cmpLgEpOVDA00bCg collected $3.20 from pot
*** SUMMARY ***
Total pot $3.35 | Rake $0.15 
Board [Ks 3c 3s 8h Td]
Seat 1: oMId4udwsHQHc0MOjQyi9w folded before Flop (didn't bet)
Seat 2: qwr38jl5txoR36M7G5qi4A folded before Flop (didn't bet)
Seat 3: E0iYnEVO2ho7dH3QcCjw7g folded before Flop (didn't bet)
Seat 5: uH1RN27w9SKa7TpVR9EFrQ mucked
Seat 6: cZ99hugmLBj9KhTlc8nCSw folded before Flop (didn't bet)
Seat 7: st9jtdNbm1W5GfBwRaCVqQ (button) folded on the Turn
Seat 8: t82lXIS9gxYmNHmDgWRFAQ (small blind) folded before Flop
Seat 9: H9KUl8cmpLgEpOVDA00bCg (big blind) showed [4c Kd] and won ($3.20) with two pair, Kings and Threes




PokerStars Game #59939381482:  Hold'em No Limit ($0.10/$0.25) - 2009/07/01 0:38:25 ET
Table 'xkqAWQFDrFt4p81M8UsoNw' 9-max Seat #7 is the button
Seat 2: z5GxcHlYz/GSz6W2uFiTtg ($34.55 in chips) 
Seat 3: HEUqKs2EYYGGXJCepUdL0g ($7.60 in chips) 
Seat 4: gY+PO8PaVC7pBPH/9HSv6Q ($4.60 in chips) 
Seat 5: OiV1PWZ3IkN29JlmCcnTwQ ($4.55 in chips) 
Seat 6: Yv4fucyyT28mjx8V5lxKJg ($23.90 in chips) 
Seat 7: MG90wfSJZnOejs/KD3vlQQ ($48.05 in chips) 
Seat 8: s7Q6uNouhe7aE8JdFb9E+A ($28 in chips) 
Seat 9: Wa7bjLwN7ptOQro84PxQGw ($5.10 in chips) 
s7Q6uNouhe7aE8JdFb9E+A: posts small blind $0.10
Wa7bjLwN7ptOQro84PxQGw: posts big blind $0.25
*** HOLE CARDS ***
z5GxcHlYz/GSz6W2uFiTtg: folds 
HEUqKs2EYYGGXJCepUdL0g: folds 
gY+PO8PaVC7pBPH/9HSv6Q: folds 
OiV1PWZ3IkN29JlmCcnTwQ: folds 
Yv4fucyyT28mjx8V5lxKJg: raises $1 to $1.25
MG90wfSJZnOejs/KD3vlQQ: folds 
s7Q6uNouhe7aE8JdFb9E+A: folds 
Wa7bjLwN7ptOQro84PxQGw: folds 
Uncalled bet ($1) returned to Yv4fucyyT28mjx8V5lxKJg
Yv4fucyyT28mjx8V5lxKJg collected $0.60 from pot
Yv4fucyyT28mjx8V5lxKJg: doesn't show hand 
*** SUMMARY ***
Total pot $0.60 | Rake $0 
Seat 2: z5GxcHlYz/GSz6W2uFiTtg folded before Flop (didn't bet)
Seat 3: HEUqKs2EYYGGXJCepUdL0g folded before Flop (didn't bet)
Seat 4: gY+PO8PaVC7pBPH/9HSv6Q folded before Flop (didn't bet)
Seat 5: OiV1PWZ3IkN29JlmCcnTwQ folded before Flop (didn't bet)
Seat 6: Yv4fucyyT28mjx8V5lxKJg collected ($0.60)
Seat 7: MG90wfSJZnOejs/KD3vlQQ (button) folded before Flop (didn't bet)
Seat 8: s7Q6uNouhe7aE8JdFb9E+A (small blind) folded before Flop
Seat 9: Wa7bjLwN7ptOQro84PxQGw (big blind) folded before Flop




PokerStars Game #59939381624:  Hold'em No Limit ($0.10/$0.25) - 2009/07/01 0:38:25 ET
Table 'oZuNsbNJuUyQLGKzQ/4JFg' 6-max Seat #1 is the button
Seat 1: /hq3j+3FbArzS8nEzmqRuw ($7.35 in chips) 
Seat 2: UA5OsKS3VPaxa7uC8La/kA ($30.35 in chips) 
Seat 3: 8ClCHtFXGNplITm+63KB+Q ($37.75 in chips) 
Seat 4: pWN7DVB+VCCiq83kllzEtg ($10.40 in chips) 
Seat 5: IH5lT4+CuQFyy32Qf5ydDw ($13.65 in chips) 
Seat 6: 34ttqW62uIRrqINCCmLcsw ($21.40 in chips) 
UA5OsKS3VPaxa7uC8La/kA: posts small blind $0.10
8ClCHtFXGNplITm+63KB+Q: posts big blind $0.25
*** HOLE CARDS ***
pWN7DVB+VCCiq83kllzEtg: calls $0.25
IH5lT4+CuQFyy32Qf5ydDw: folds 
34ttqW62uIRrqINCCmLcsw: folds 
/hq3j+3FbArzS8nEzmqRuw: folds 
UA5OsKS3VPaxa7uC8La/kA: folds 
8ClCHtFXGNplITm+63KB+Q: checks 
*** FLOP *** [8h Kh 2h]
8ClCHtFXGNplITm+63KB+Q: checks 
pWN7DVB+VCCiq83kllzEtg: bets $0.25
IH5lT4+CuQFyy32Qf5ydDw said, "total fishing"
8ClCHtFXGNplITm+63KB+Q: folds 
Uncalled bet ($0.25) returned to pWN7DVB+VCCiq83kllzEtg
pWN7DVB+VCCiq83kllzEtg collected $0.60 from pot
pWN7DVB+VCCiq83kllzEtg: doesn't show hand 
*** SUMMARY ***
Total pot $0.60 | Rake $0 
Board [8h Kh 2h]
Seat 1: /hq3j+3FbArzS8nEzmqRuw (button) folded before Flop (didn't bet)
Seat 2: UA5OsKS3VPaxa7uC8La/kA (small blind) folded before Flop
Seat 3: 8ClCHtFXGNplITm+63KB+Q (big blind) folded on the Flop
Seat 4: pWN7DVB+VCCiq83kllzEtg collected ($0.60)
Seat 5: IH5lT4+CuQFyy32Qf5ydDw folded before Flop (didn't bet)
Seat 6: 34ttqW62uIRrqINCCmLcsw folded before Flop (didn't bet)




PokerStars Game #59939381578:  Hold'em No Limit ($0.10/$0.25) - 2009/07/01 0:38:25 ET
Table 'mF3KHGMaTpaBZbtBoyfTeg' 6-max Seat #4 is the button
Seat 1: 0HAB2GdCAM7p7V00xueAVQ ($9.55 in chips) 
Seat 2: 4x9jCqgSw4272dnaIqnanw ($3.95 in chips) 
Seat 3: Hzrn9DZJegEZICufTNYkrg ($14.75 in chips) 
Seat 4: FYepjhAvF8ZdVCmqHIy+eQ ($25.90 in chips) 
Seat 5: sEQx9G5Cu8k1HNdQasxvUA ($28.30 in chips) 
sEQx9G5Cu8k1HNdQasxvUA: posts small blind $0.10
0HAB2GdCAM7p7V00xueAVQ: posts big blind $0.25
*** HOLE CARDS ***
4x9jCqgSw4272dnaIqnanw: folds 
Hzrn9DZJegEZICufTNYkrg: folds 
FYepjhAvF8ZdVCmqHIy+eQ: folds 
sEQx9G5Cu8k1HNdQasxvUA: calls $0.15
0HAB2GdCAM7p7V00xueAVQ: raises $0.50 to $0.75
sEQx9G5Cu8k1HNdQasxvUA: folds 
Uncalled bet ($0.50) returned to 0HAB2GdCAM7p7V00xueAVQ
0HAB2GdCAM7p7V00xueAVQ collected $0.50 from pot
0HAB2GdCAM7p7V00xueAVQ: doesn't show hand 
*** SUMMARY ***
Total pot $0.50 | Rake $0 
Seat 1: 0HAB2GdCAM7p7V00xueAVQ (big blind) collected ($0.50)
Seat 2: 4x9jCqgSw4272dnaIqnanw folded before Flop (didn't bet)
Seat 3: Hzrn9DZJegEZICufTNYkrg folded before Flop (didn't bet)
Seat 4: FYepjhAvF8ZdVCmqHIy+eQ (button) folded before Flop (didn't bet)
Seat 5: sEQx9G5Cu8k1HNdQasxvUA (small blind) folded before Flop




PokerStars Game #59939381718:  Hold'em No Limit ($0.10/$0.25) - 2009/07/01 0:38:25 ET
Table 'hfHe8uKeSJMyWAjSdM7ROQ' 6-max Seat #3 is the button
Seat 1: eHsmIvAb2JREg4O6hNPnXg ($20.75 in chips) 
Seat 2: rnpAao581IcvQglpkpnkoQ ($7.30 in chips) 
Seat 3: og6TUWcndKo5oTDQjnQfjw ($26.95 in chips) 
Seat 4: iAfYkegiTr9eE85LoKmEgA ($7.70 in chips) 
Seat 5: euswrBD1XG0Q5hB1iGJBKQ ($24.80 in chips) 
iAfYkegiTr9eE85LoKmEgA: posts small blind $0.10
euswrBD1XG0Q5hB1iGJBKQ: posts big blind $0.25
SFmT9ZsVopnukjvAzrxTRg: sits out 
*** HOLE CARDS ***
eHsmIvAb2JREg4O6hNPnXg: folds 
rnpAao581IcvQglpkpnkoQ: calls $0.25
og6TUWcndKo5oTDQjnQfjw: raises $1 to $1.25
iAfYkegiTr9eE85LoKmEgA: folds 
euswrBD1XG0Q5hB1iGJBKQ: folds 
rnpAao581IcvQglpkpnkoQ: folds 
Uncalled bet ($1) returned to og6TUWcndKo5oTDQjnQfjw
og6TUWcndKo5oTDQjnQfjw collected $0.85 from pot
og6TUWcndKo5oTDQjnQfjw: doesn't show hand 
*** SUMMARY ***
Total pot $0.85 | Rake $0 
Seat 1: eHsmIvAb2JREg4O6hNPnXg folded before Flop (didn't bet)
Seat 2: rnpAao581IcvQglpkpnkoQ folded before Flop
Seat 3: og6TUWcndKo5oTDQjnQfjw (button) collected ($0.85)
Seat 4: iAfYkegiTr9eE85LoKmEgA (small blind) folded before Flop
Seat 5: euswrBD1XG0Q5hB1iGJBKQ (big blind) folded before Flop




PokerStars Game #59939381876:  Hold'em No Limit ($0.10/$0.25) - 2009/07/01 0:38:25 ET
Table 'MRfAiS/4JSfnUDlCcZo0wAhfHe8uKeSJMyWAjSdM7ROQx Seat #5 is the button
Seat 2: /gJNBeCkWL4o85/jvlZ4BA ($37.35 in chips) 
Seat 3: FYepjhAvF8ZdVCmqHIy+eQ ($49 in chips) 
Seat 4: Go8clNIDGP3feVvzBDG4pg ($20 in chips) 
Seat 5: qccGLncfUaN00Few5HsgYg ($28.25 in chips) 
Seat 6: VaDPspfGS2lnEkaGNrNqfg ($10.10 in chips) 
VaDPspfGS2lnEkaGNrNqfg: posts small blind $0.10
32YL2ZEp8NT4JB2RVM9euQ: is sitting out 
/gJNBeCkWL4o85/jvlZ4BA: posts big blind $0.25
Go8clNIDGP3feVvzBDG4pg: posts big blind $0.25
*** HOLE CARDS ***
32YL2ZEp8NT4JB2RVM9euQ has returned
FYepjhAvF8ZdVCmqHIy+eQ: folds 
Go8clNIDGP3feVvzBDG4pg: checks 
qccGLncfUaN00Few5HsgYg: folds 
VaDPspfGS2lnEkaGNrNqfg: folds 
/gJNBeCkWL4o85/jvlZ4BA: checks 
*** FLOP *** [4c Qs Ad]
/gJNBeCkWL4o85/jvlZ4BA: bets $0.75
Go8clNIDGP3feVvzBDG4pg: folds 
Uncalled bet ($0.75) returned to /gJNBeCkWL4o85/jvlZ4BA
/gJNBeCkWL4o85/jvlZ4BA collected $0.60 from pot
*** SUMMARY ***
Total pot $0.60 | Rake $0 
Board [4c Qs Ad]
Seat 2: /gJNBeCkWL4o85/jvlZ4BA (big blind) collected ($0.60)
Seat 3: FYepjhAvF8ZdVCmqHIy+eQ folded before Flop (didn't bet)
Seat 4: Go8clNIDGP3feVvzBDG4pg folded on the Flop
Seat 5: qccGLncfUaN00Few5HsgYg (button) folded before Flop (didn't bet)
Seat 6: VaDPspfGS2lnEkaGNrNqfg (small blind) folded before Flop




PokerStars Game #59939381366:  Hold'em No Limit ($0.10/$0.25) - 2009/07/01 0:38:25 ET
Table 'NtEQAxCeIK2io1CGtW658g' 6-max Seat #1 is the button
Seat 1: lnOV7k25gyN7L5t5YKTgIg ($20.50 in chips) 
Seat 2: nc79pm0LZRdhncq55evVqA ($25 in chips) 
Seat 4: 8296 ($13.10 in chips) 
Seat 5: FStoHe64SQWqAsjya9pDkQ ($27.50 in chips) 
Seat 6: /gJNBeCkWL4o85/jvlZ4BA ($62.35 in chips) 
nc79pm0LZRdhncq55evVqA: posts small blind $0.10
8296: posts big blind $0.25
*** HOLE CARDS ***
FStoHe64SQWqAsjya9pDkQ: folds 
/gJNBeCkWL4o85/jvlZ4BA: folds 
lnOV7k25gyN7L5t5YKTgIg: folds 
nc79pm0LZRdhncq55evVqA: raises $0.75 to $1
8296: calls $0.75
*** FLOP *** [Js 9s Qh]
nc79pm0LZRdhncq55evVqA: bets $1.25
8296: folds 
Uncalled bet ($1.25) returned to nc79pm0LZRdhncq55evVqA
nc79pm0LZRdhncq55evVqA collected $1.90 from pot
nc79pm0LZRdhncq55evVqA: doesn't show hand 
*** SUMMARY ***
Total pot $2 | Rake $0.10 
Board [Js 9s Qh]
Seat 1: lnOV7k25gyN7L5t5YKTgIg (button) folded before Flop (didn't bet)
Seat 2: nc79pm0LZRdhncq55evVqA (small blind) collected ($1.90)
Seat 4: 8296 (big blind) folded on the Flop
Seat 5: FStoHe64SQWqAsjya9pDkQ folded before Flop (didn't bet)
Seat 6: /gJNBeCkWL4o85/jvlZ4BA folded before Flop (didn't bet)




PokerStars Game #59939381930:  Hold'em No Limit ($0.10/$0.25) - 2009/07/01 0:38:25 ET
Table 'Mef6A0EMopL6WaFO5/KO9g' 6-max Seat #2 is the button
Seat 1: ELW+DKizJhLK7k40PMkD2Q ($30 in chips) 
Seat 2: 8ClCHtFXGNplITm+63KB+Q ($33.50 in chips) 
Seat 4: pisIQ6Ztya1lC0kTtGSTHw ($58.95 in chips) 
Seat 5: WrLI51S2iMb8GLMB83gGqA ($29.05 in chips) 
Seat 6: BYxjLnV1/LL0aZcTbfAOvw ($25 in chips) 
pisIQ6Ztya1lC0kTtGSTHw: posts small blind $0.10
WrLI51S2iMb8GLMB83gGqA: posts big blind $0.25
*** HOLE CARDS ***
BYxjLnV1/LL0aZcTbfAOvw: folds 
ELW+DKizJhLK7k40PMkD2Q: folds 
8ClCHtFXGNplITm+63KB+Q: folds 
pisIQ6Ztya1lC0kTtGSTHw: calls $0.15
WrLI51S2iMb8GLMB83gGqA: checks 
*** FLOP *** [6d Td 9c]
pisIQ6Ztya1lC0kTtGSTHw: checks 
WrLI51S2iMb8GLMB83gGqA: bets $0.50
pisIQ6Ztya1lC0kTtGSTHw: folds 
Uncalled bet ($0.50) returned to WrLI51S2iMb8GLMB83gGqA
WrLI51S2iMb8GLMB83gGqA collected $0.50 from pot
WrLI51S2iMb8GLMB83gGqA: doesn't show hand 
*** SUMMARY ***
Total pot $0.50 | Rake $0 
Board [6d Td 9c]
Seat 1: ELW+DKizJhLK7k40PMkD2Q folded before Flop (didn't bet)
Seat 2: 8ClCHtFXGNplITm+63KB+Q (button) folded before Flop (didn't bet)
Seat 4: pisIQ6Ztya1lC0kTtGSTHw (small blind) folded on the Flop
Seat 5: WrLI51S2iMb8GLMB83gGqA (big blind) collected ($0.50)
Seat 6: BYxjLnV1/LL0aZcTbfAOvw folded before Flop (didn't bet)




PokerStars Game #59939381690:  Hold'em No Limit ($0.10/$0.25) - 2009/07/01 0:38:25 ET
Table 'luMgmRPIo47e7iXDlheIwA' 6-max Seat #2 is the button
Seat 2: 4YSTu0Cdzpppe1lUgCZGCQ ($43.75 in chips) 
Seat 4: n2OZezRXTtdzQt4SuIy8TQ ($17.65 in chips) 
Seat 5: kG34n23qFQA3nzdOJTQ1dA ($46.90 in chips) 
n2OZezRXTtdzQt4SuIy8TQ: posts small blind $0.10
kG34n23qFQA3nzdOJTQ1dA: posts big blind $0.25
m2yWOKfAxqHoy5DDN87Ttw: sits out 
*** HOLE CARDS ***
m2yWOKfAxqHoy5DDN87Ttw leaves the table
4YSTu0Cdzpppe1lUgCZGCQ: raises $0.75 to $1
n2OZezRXTtdzQt4SuIy8TQ: raises $1.75 to $2.75
kG34n23qFQA3nzdOJTQ1dA: folds 
4YSTu0Cdzpppe1lUgCZGCQ: raises $6.25 to $9
n2OZezRXTtdzQt4SuIy8TQ: calls $6.25
*** FLOP *** [Ah Qc Qs]
n2OZezRXTtdzQt4SuIy8TQ: bets $8.65 and is all-in
W6Y6au0wf7gRAlqJYgOezw joins the table at seat #3 
4YSTu0Cdzpppe1lUgCZGCQ: folds 
Uncalled bet ($8.65) returned to n2OZezRXTtdzQt4SuIy8TQ
n2OZezRXTtdzQt4SuIy8TQ collected $17.35 from pot
*** SUMMARY ***
Total pot $18.25 | Rake $0.90 
Board [Ah Qc Qs]
Seat 2: 4YSTu0Cdzpppe1lUgCZGCQ (button) folded on the Flop
Seat 4: n2OZezRXTtdzQt4SuIy8TQ (small blind) collected ($17.35)
Seat 5: kG34n23qFQA3nzdOJTQ1dA (big blind) folded before Flop




PokerStars Game #59939381640:  Hold'em No Limit ($0.10/$0.25) - 2009/07/01 0:38:25 ET
Table 'l57rayEpPtZotP9nqgSWBg' 6-max Seat #3 is the button
Seat 1: oseFhpinoe+Zg4j5xyBjyQ ($20.75 in chips) 
Seat 3: sEQx9G5Cu8k1HNdQasxvUA ($39.20 in chips) 
Seat 5: TSmua8tGK3sTbwi0ynrW9Q ($60.15 in chips) 
NIALbunHAyYqmfMf7mrPhw will be allowed to play after the button
TSmua8tGK3sTbwi0ynrW9Q: posts small blind $0.10
oseFhpinoe+Zg4j5xyBjyQ: posts big blind $0.25
ErIN0JRL5srYjT6en1f8YQ: sits out 
*** HOLE CARDS ***
sEQx9G5Cu8k1HNdQasxvUA: raises $0.50 to $0.75
TSmua8tGK3sTbwi0ynrW9Q: calls $0.65
oseFhpinoe+Zg4j5xyBjyQ: folds 
*** FLOP *** [Ac 5d Jc]
tjhousyomama joins the table at seat #6 
TSmua8tGK3sTbwi0ynrW9Q: checks 
sEQx9G5Cu8k1HNdQasxvUA: bets $1
TSmua8tGK3sTbwi0ynrW9Q: folds 
Uncalled bet ($1) returned to sEQx9G5Cu8k1HNdQasxvUA
sEQx9G5Cu8k1HNdQasxvUA collected $1.70 from pot
sEQx9G5Cu8k1HNdQasxvUA: doesn't show hand 
*** SUMMARY ***
Total pot $1.75 | Rake $0.05 
Board [Ac 5d Jc]
Seat 1: oseFhpinoe+Zg4j5xyBjyQ (big blind) folded before Flop
Seat 3: sEQx9G5Cu8k1HNdQasxvUA (button) collected ($1.70)
Seat 5: TSmua8tGK3sTbwi0ynrW9Q (small blind) folded on the Flop




PokerStars Game #59939382598:  Hold'em No Limit ($0.10/$0.25) - 2009/07/01 0:38:26 ET
Table 'ER5H84HUgJx7HyDLnELLeA' 6-max Seat #1 is the button
Seat 1: pjM/xh4+RG8zrxCobDgYDg ($15.25 in chips) 
Seat 2: nc79pm0LZRdhncq55evVqA ($48.60 in chips) 
Seat 3: 2j+7KACUO5iqZ/NSvIH3vg ($6.40 in chips) 
Seat 4: tkRWn3WaJIfGmCXT2hPvJA ($18.80 in chips) 
Seat 5: mfrkWA3PTeYPkbO6hi98Aw ($23.40 in chips) 
nc79pm0LZRdhncq55evVqA: posts small blind $0.10
2j+7KACUO5iqZ/NSvIH3vg: posts big blind $0.25
FONMraB4GCHzDwDcfciKyw: sits out 
*** HOLE CARDS ***
tkRWn3WaJIfGmCXT2hPvJA: calls $0.25
mfrkWA3PTeYPkbO6hi98Aw: folds 
pjM/xh4+RG8zrxCobDgYDg: raises $0.75 to $1
nc79pm0LZRdhncq55evVqA: folds 
2j+7KACUO5iqZ/NSvIH3vg: folds 
tkRWn3WaJIfGmCXT2hPvJA: folds 
Uncalled bet ($0.75) returned to pjM/xh4+RG8zrxCobDgYDg
pjM/xh4+RG8zrxCobDgYDg collected $0.85 from pot
pjM/xh4+RG8zrxCobDgYDg: doesn't show hand 
*** SUMMARY ***
Total pot $0.85 | Rake $0 
Seat 1: pjM/xh4+RG8zrxCobDgYDg (button) collected ($0.85)
Seat 2: nc79pm0LZRdhncq55evVqA (small blind) folded before Flop
Seat 3: 2j+7KACUO5iqZ/NSvIH3vg (big blind) folded before Flop
Seat 4: tkRWn3WaJIfGmCXT2hPvJA folded before Flop
Seat 5: mfrkWA3PTeYPkbO6hi98Aw folded before Flop (didn't bet)




PokerStars Game #59939382458:  Hold'em No Limit ($0.10/$0.25) - 2009/07/01 0:38:26 ET
Table 'f9j+4UOgRPXbyNbQkZFm4w' 6-max Seat #2 is the button
Seat 1: trN/oHqTTbPw5MNuKrOpLw ($30.85 in chips) 
Seat 2: VHBox3ZuV+/MP3dz2hFEBQ ($5.10 in chips) 
Seat 3: wCBHaebpIJ2ZTqigoRi9DA ($16.80 in chips) 
Seat 4: hiTEr3yrERiQp3zHXRioVw ($22.10 in chips) 
Seat 5: 1lxYIAoJdZwAbzIkzWmSkw ($9.75 in chips) 
wCBHaebpIJ2ZTqigoRi9DA: posts small blind $0.10
hiTEr3yrERiQp3zHXRioVw: posts big blind $0.25
*** HOLE CARDS ***
C84t1kUtjDF/zm38/Dpcng joins the table at seat #6 
1lxYIAoJdZwAbzIkzWmSkw: calls $0.25
trN/oHqTTbPw5MNuKrOpLw: folds 
VHBox3ZuV+/MP3dz2hFEBQ: folds 
wCBHaebpIJ2ZTqigoRi9DA: raises $0.50 to $0.75
hiTEr3yrERiQp3zHXRioVw: folds 
1lxYIAoJdZwAbzIkzWmSkw: calls $0.50
*** FLOP *** [Js Ah 7c]
wCBHaebpIJ2ZTqigoRi9DA: bets $1.50
1lxYIAoJdZwAbzIkzWmSkw: folds 
Uncalled bet ($1.50) returned to wCBHaebpIJ2ZTqigoRi9DA
wCBHaebpIJ2ZTqigoRi9DA collected $1.70 from pot
wCBHaebpIJ2ZTqigoRi9DA: doesn't show hand 
*** SUMMARY ***
Total pot $1.75 | Rake $0.05 
Board [Js Ah 7c]
Seat 1: trN/oHqTTbPw5MNuKrOpLw folded before Flop (didn't bet)
Seat 2: VHBox3ZuV+/MP3dz2hFEBQ (button) folded before Flop (didn't bet)
Seat 3: wCBHaebpIJ2ZTqigoRi9DA (small blind) collected ($1.70)
Seat 4: hiTEr3yrERiQp3zHXRioVw (big blind) folded before Flop
Seat 5: 1lxYIAoJdZwAbzIkzWmSkw folded on the Flop




PokerStars Game #59939382564:  Hold'em No Limit ($0.10/$0.25) - 2009/07/01 0:38:26 ET
Table 'edvgY2YQ1I34euq4EVqGnA' 6-max Seat #6 is the button
Seat 1: mvFHK3pE7tCxJEqLjKC70Q ($26.40 in chips) 
Seat 2: 0vuFCuW1P8y6cFZZvuXNPg ($12.20 in chips) 
Seat 3: HjESR5/RHWT5gaSbIVQQ0Q ($21.10 in chips) 
Seat 4: JFIAqU8lCZ0vWwEl4bdGsg ($26.80 in chips) 
Seat 5: EE16Ua5b1HSsYej5zeXOlA ($25.60 in chips) 
Seat 6: kG34n23qFQA3nzdOJTQ1dA ($68.60 in chips) 
mvFHK3pE7tCxJEqLjKC70Q: posts small blind $0.10
0vuFCuW1P8y6cFZZvuXNPg: posts big blind $0.25
*** HOLE CARDS ***
HjESR5/RHWT5gaSbIVQQ0Q: calls $0.25
JFIAqU8lCZ0vWwEl4bdGsg: raises $1.25 to $1.50
EE16Ua5b1HSsYej5zeXOlA: folds 
kG34n23qFQA3nzdOJTQ1dA: folds 
mvFHK3pE7tCxJEqLjKC70Q: folds 
0vuFCuW1P8y6cFZZvuXNPg: folds 
HjESR5/RHWT5gaSbIVQQ0Q: calls $1.25
*** FLOP *** [6d 8c 8d]
HjESR5/RHWT5gaSbIVQQ0Q: checks 
JFIAqU8lCZ0vWwEl4bdGsg: checks 
*** TURN *** [6d 8c 8d] [Js]
HjESR5/RHWT5gaSbIVQQ0Q: bets $0.50
JFIAqU8lCZ0vWwEl4bdGsg: calls $0.50
*** RIVER *** [6d 8c 8d Js] [5c]
HjESR5/RHWT5gaSbIVQQ0Q: bets $1
JFIAqU8lCZ0vWwEl4bdGsg: raises $3.25 to $4.25
HjESR5/RHWT5gaSbIVQQ0Q: folds 
Uncalled bet ($3.25) returned to JFIAqU8lCZ0vWwEl4bdGsg
JFIAqU8lCZ0vWwEl4bdGsg collected $6.05 from pot
JFIAqU8lCZ0vWwEl4bdGsg: doesn't show hand 
*** SUMMARY ***
Total pot $6.35 | Rake $0.30 
Board [6d 8c 8d Js 5c]
Seat 1: mvFHK3pE7tCxJEqLjKC70Q (small blind) folded before Flop
Seat 2: 0vuFCuW1P8y6cFZZvuXNPg (big blind) folded before Flop
Seat 3: HjESR5/RHWT5gaSbIVQQ0Q folded on the River
Seat 4: JFIAqU8lCZ0vWwEl4bdGsg collected ($6.05)
Seat 5: EE16Ua5b1HSsYej5zeXOlA folded before Flop (didn't bet)
Seat 6: kG34n23qFQA3nzdOJTQ1dA (button) folded before Flop (didn't bet)




PokerStars Game #59939382600:  Hold'em No Limit ($0.10/$0.25) - 2009/07/01 0:38:26 ET
Table 'g+mPuNJBCHKE9ents7ZGtg' 6-max Seat #2 is the button
Seat 1: rlqzz6sTpiZGIiNuqy7QUA ($34.60 in chips) 
Seat 2: fZQg9veL7Dd/Z04ZTjC+wQ ($30.35 in chips) 
Seat 3: 9jSiy0meE9XJKkdIZwyTEQ ($25.35 in chips) 
Seat 4: mfrkWA3PTeYPkbO6hi98Aw ($27 in chips) 
Seat 5: vEZ/HxVuyR6kaq0BtZoUgQ ($14.05 in chips) 
Seat 6: MS2T205Bjud7PnNoANu4vQ ($50.60 in chips) 
9jSiy0meE9XJKkdIZwyTEQ: posts small blind $0.10
mfrkWA3PTeYPkbO6hi98Aw: posts big blind $0.25
*** HOLE CARDS ***
vEZ/HxVuyR6kaq0BtZoUgQ: folds 
MS2T205Bjud7PnNoANu4vQ: folds 
rlqzz6sTpiZGIiNuqy7QUA: folds 
fZQg9veL7Dd/Z04ZTjC+wQ: folds 
9jSiy0meE9XJKkdIZwyTEQ: folds 
Uncalled bet ($0.15) returned to mfrkWA3PTeYPkbO6hi98Aw
mfrkWA3PTeYPkbO6hi98Aw collected $0.20 from pot
mfrkWA3PTeYPkbO6hi98Aw: doesn't show hand 
*** SUMMARY ***
Total pot $0.20 | Rake $0 
Seat 1: rlqzz6sTpiZGIiNuqy7QUA folded before Flop (didn't bet)
Seat 2: fZQg9veL7Dd/Z04ZTjC+wQ (button) folded before Flop (didn't bet)
Seat 3: 9jSiy0meE9XJKkdIZwyTEQ (small blind) folded before Flop
Seat 4: mfrkWA3PTeYPkbO6hi98Aw (big blind) collected ($0.20)
Seat 5: vEZ/HxVuyR6kaq0BtZoUgQ folded before Flop (didn't bet)
Seat 6: MS2T205Bjud7PnNoANu4vQ folded before Flop (didn't bet)




PokerStars Game #59939382478:  Hold'em No Limit ($0.10/$0.25) - 2009/07/01 0:38:26 ET
Table 'sm5gqEvXgLbkkE4dryW/5g' 6-max Seat #5 is the button
Seat 1: gaPMxLGp9SOj4Lq6t+/0Ig ($13.55 in chips) 
Seat 2: s13YXIlhF/j3TO0bSnT7bA ($13.40 in chips) 
Seat 3: I1TxPvWj8NfG8orglCinNA ($25.35 in chips) 
Seat 4: BedjMfrlRfPgSq7CXpPAmg ($57.65 in chips) 
Seat 5: M+WmDyCD/ZMu/5t6/iH2kw ($74.50 in chips) 
Seat 6: wKFJ513ucluNNiMlkXcDOQ ($28.05 in chips) 
wKFJ513ucluNNiMlkXcDOQ: posts small blind $0.10
gaPMxLGp9SOj4Lq6t+/0Ig: posts big blind $0.25
*** HOLE CARDS ***
s13YXIlhF/j3TO0bSnT7bA: folds 
I1TxPvWj8NfG8orglCinNA: folds 
BedjMfrlRfPgSq7CXpPAmg: folds 
M+WmDyCD/ZMu/5t6/iH2kw: calls $0.25
wKFJ513ucluNNiMlkXcDOQ: folds 
gaPMxLGp9SOj4Lq6t+/0Ig: checks 
*** FLOP *** [3c 7c 2s]
gaPMxLGp9SOj4Lq6t+/0Ig: bets $0.50
M+WmDyCD/ZMu/5t6/iH2kw: calls $0.50
*** TURN *** [3c 7c 2s] [Jh]
gaPMxLGp9SOj4Lq6t+/0Ig: bets $1.25
M+WmDyCD/ZMu/5t6/iH2kw: folds 
Uncalled bet ($1.25) returned to gaPMxLGp9SOj4Lq6t+/0Ig
gaPMxLGp9SOj4Lq6t+/0Ig collected $1.55 from pot
gaPMxLGp9SOj4Lq6t+/0Ig: doesn't show hand 
*** SUMMARY ***
Total pot $1.60 | Rake $0.05 
Board [3c 7c 2s Jh]
Seat 1: gaPMxLGp9SOj4Lq6t+/0Ig (big blind) collected ($1.55)
Seat 2: s13YXIlhF/j3TO0bSnT7bA folded before Flop (didn't bet)
Seat 3: I1TxPvWj8NfG8orglCinNA folded before Flop (didn't bet)
Seat 4: BedjMfrlRfPgSq7CXpPAmg folded before Flop (didn't bet)
Seat 5: M+WmDyCD/ZMu/5t6/iH2kw (button) folded on the Turn
Seat 6: wKFJ513ucluNNiMlkXcDOQ (small blind) folded before Flop




PokerStars Game #59939382418:  Hold'em No Limit ($0.10/$0.25) - 2009/07/01 0:38:26 ET
Table 'VuY5ej47Cy8nOI3Wogmhzw' 6-max Seat #1 is the button
Seat 1: PUTXJX6bVODW3ITgBX0GuQ ($15.10 in chips) 
Seat 3: 0n9nsjvz4GIG4IyVHT0JVw ($6.70 in chips) 
Seat 4: FC6tJ9EOiutXO8hnpR4VgQ ($3.30 in chips) 
Seat 6: +v0nBUereMsRzYp2Knh/cQ ($10 in chips) 
0n9nsjvz4GIG4IyVHT0JVw: posts small blind $0.10
FC6tJ9EOiutXO8hnpR4VgQ: posts big blind $0.25
+v0nBUereMsRzYp2Knh/cQ: posts big blind $0.25
*** HOLE CARDS ***
+v0nBUereMsRzYp2Knh/cQ: checks 
PUTXJX6bVODW3ITgBX0GuQ: folds 
0n9nsjvz4GIG4IyVHT0JVw: folds 
FC6tJ9EOiutXO8hnpR4VgQ: checks 
*** FLOP *** [6d 9c 9d]
FC6tJ9EOiutXO8hnpR4VgQ: checks 
+v0nBUereMsRzYp2Knh/cQ: checks 
*** TURN *** [6d 9c 9d] [3d]
FC6tJ9EOiutXO8hnpR4VgQ: bets $0.25
+v0nBUereMsRzYp2Knh/cQ: calls $0.25
*** RIVER *** [6d 9c 9d 3d] [6c]
FC6tJ9EOiutXO8hnpR4VgQ: checks 
+v0nBUereMsRzYp2Knh/cQ: checks 
*** SHOW DOWN ***
FC6tJ9EOiutXO8hnpR4VgQ: shows [2h 3s] (two pair, Nines and Sixes)
+v0nBUereMsRzYp2Knh/cQ: shows [Ac 7c] (two pair, Nines and Sixes - Ace kicker)
+v0nBUereMsRzYp2Knh/cQ collected $1.05 from pot
*** SUMMARY ***
Total pot $1.10 | Rake $0.05 
Board [6d 9c 9d 3d 6c]
Seat 1: PUTXJX6bVODW3ITgBX0GuQ (button) folded before Flop (didn't bet)
Seat 3: 0n9nsjvz4GIG4IyVHT0JVw (small blind) folded before Flop
Seat 4: FC6tJ9EOiutXO8hnpR4VgQ (big blind) showed [2h 3s] and lost with two pair, Nines and Sixes
Seat 6: +v0nBUereMsRzYp2Knh/cQ showed [Ac 7c] and won ($1.05) with two pair, Nines and Sixes




PokerStars Game #59939382568:  Hold'em No Limit ($0.10/$0.25) - 2009/07/01 0:38:26 ET
Table '3eK1r4Q4BSYFvsKkuTLpIA' 9-max Seat #8 is the button
Seat 1: qwr38jl5txoR36M7G5qi4A ($7.75 in chips) 
Seat 2: 7QzbjWT00wQpau1iqvUmMA ($5 in chips) 
Seat 3: 56S3mA6Zs3pGR+0p0vUCtg ($33.55 in chips) 
Seat 4: S2iyN4Q7njjhguIuE5g1CQ ($23.20 in chips) 
Seat 5: 1K6QGyJP9P9xmRac2fH4OQ ($31.90 in chips) 
Seat 6: +HvCCmsGSQeatf+GZ9zk8Q ($18.75 in chips) 
Seat 7: GTcLfsDTPqgfHyhY9FNDMw ($8 in chips) 
Seat 8: Cni99AOp8W/F0ZWCuHNcIA ($12.05 in chips) 
Seat 9: +sbyWwIcFp9kP0bDtMegfQ ($37.85 in chips) 
+sbyWwIcFp9kP0bDtMegfQ: posts small blind $0.10
qwr38jl5txoR36M7G5qi4A: posts big blind $0.25
*** HOLE CARDS ***
7QzbjWT00wQpau1iqvUmMA: folds 
56S3mA6Zs3pGR+0p0vUCtg: folds 
S2iyN4Q7njjhguIuE5g1CQ: folds 
1K6QGyJP9P9xmRac2fH4OQ: folds 
+HvCCmsGSQeatf+GZ9zk8Q: folds 
GTcLfsDTPqgfHyhY9FNDMw: folds 
Cni99AOp8W/F0ZWCuHNcIA: folds 
+sbyWwIcFp9kP0bDtMegfQ: folds 
Uncalled bet ($0.15) returned to qwr38jl5txoR36M7G5qi4A
qwr38jl5txoR36M7G5qi4A collected $0.20 from pot
qwr38jl5txoR36M7G5qi4A: doesn't show hand 
*** SUMMARY ***
Total pot $0.20 | Rake $0 
Seat 1: qwr38jl5txoR36M7G5qi4A (big blind) collected ($0.20)
Seat 2: 7QzbjWT00wQpau1iqvUmMA folded before Flop (didn't bet)
Seat 3: 56S3mA6Zs3pGR+0p0vUCtg folded before Flop (didn't bet)
Seat 4: S2iyN4Q7njjhguIuE5g1CQ folded before Flop (didn't bet)
Seat 5: 1K6QGyJP9P9xmRac2fH4OQ folded before Flop (didn't bet)
Seat 6: +HvCCmsGSQeatf+GZ9zk8Q folded before Flop (didn't bet)
Seat 7: GTcLfsDTPqgfHyhY9FNDMw folded before Flop (didn't bet)
Seat 8: Cni99AOp8W/F0ZWCuHNcIA (button) folded before Flop (didn't bet)
Seat 9: +sbyWwIcFp9kP0bDtMegfQ (small blind) folded before Flop




PokerStars Game #59939382176:  Hold'em No Limit ($0.10/$0.25) - 2009/07/01 0:38:26 ET
Table 'KYX9dFNuOA9l2PV46IebqQ' 9-max Seat #7 is the button
Seat 1: s7Q6uNouhe7aE8JdFb9E+A ($27.40 in chips) 
Seat 2: r6hsffOo1iKmaPYKwAZmFw ($25 in chips) 
Seat 3: f+H1PHwj9cNu4Y6FfvKwQQ ($18.35 in chips) 
Seat 4: SkLOm0UugROBRt2EfMpOxQ ($35.70 in chips) 
Seat 5: HQMjiff9S04k8kyC4fHVgw ($2.55 in chips) 
Seat 6: DiSvPC2iudwL5j9u6Huyww ($25.35 in chips) 
Seat 7: kmJc9NmBNbE55/AnUDL6/w ($3.50 in chips) 
Seat 8: 4oA316mXLIui1QY63GXBUg ($25 in chips) 
Seat 9: W4TLQcZ2TiM73eIgpIvlGg ($33.30 in chips) 
4oA316mXLIui1QY63GXBUg: posts small blind $0.10
W4TLQcZ2TiM73eIgpIvlGg: posts big blind $0.25
*** HOLE CARDS ***
s7Q6uNouhe7aE8JdFb9E+A: folds 
r6hsffOo1iKmaPYKwAZmFw: folds 
f+H1PHwj9cNu4Y6FfvKwQQ: folds 
SkLOm0UugROBRt2EfMpOxQ: folds 
HQMjiff9S04k8kyC4fHVgw: folds 
DiSvPC2iudwL5j9u6Huyww: folds 
kmJc9NmBNbE55/AnUDL6/w: calls $0.25
4oA316mXLIui1QY63GXBUg: folds 
W4TLQcZ2TiM73eIgpIvlGg: checks 
*** FLOP *** [6s Ks 5h]
W4TLQcZ2TiM73eIgpIvlGg: checks 
kmJc9NmBNbE55/AnUDL6/w: checks 
*** TURN *** [6s Ks 5h] [8s]
W4TLQcZ2TiM73eIgpIvlGg: checks 
kmJc9NmBNbE55/AnUDL6/w: bets $1
W4TLQcZ2TiM73eIgpIvlGg: folds 
Uncalled bet ($1) returned to kmJc9NmBNbE55/AnUDL6/w
kmJc9NmBNbE55/AnUDL6/w collected $0.60 from pot
kmJc9NmBNbE55/AnUDL6/w: doesn't show hand 
*** SUMMARY ***
Total pot $0.60 | Rake $0 
Board [6s Ks 5h 8s]
Seat 1: s7Q6uNouhe7aE8JdFb9E+A folded before Flop (didn't bet)
Seat 2: r6hsffOo1iKmaPYKwAZmFw folded before Flop (didn't bet)
Seat 3: f+H1PHwj9cNu4Y6FfvKwQQ folded before Flop (didn't bet)
Seat 4: SkLOm0UugROBRt2EfMpOxQ folded before Flop (didn't bet)
Seat 5: HQMjiff9S04k8kyC4fHVgw folded before Flop (didn't bet)
Seat 6: DiSvPC2iudwL5j9u6Huyww folded before Flop (didn't bet)
Seat 7: kmJc9NmBNbE55/AnUDL6/w (button) collected ($0.60)
Seat 8: 4oA316mXLIui1QY63GXBUg (small blind) folded before Flop
Seat 9: W4TLQcZ2TiM73eIgpIvlGg (big blind) folded on the Turn




PokerStars Game #59939382928:  Hold'em No Limit ($0.10/$0.25) - 2009/07/01 0:38:27 ET
Table '+fuYjvJy9okLr23QyZtanA' 9-max Seat #1 is the button
Seat 1: s7Q6uNouhe7aE8JdFb9E+A ($30.20 in chips) 
Seat 4: H/l9NZvuOXwQIPOaVdj0rQ ($10.05 in chips) 
s7Q6uNouhe7aE8JdFb9E+A: posts small blind $0.10
H/l9NZvuOXwQIPOaVdj0rQ: posts big blind $0.25
*** HOLE CARDS ***
s7Q6uNouhe7aE8JdFb9E+A: raises $0.50 to $0.75
H/l9NZvuOXwQIPOaVdj0rQ: calls $0.50
*** FLOP *** [As Ts 5c]
H/l9NZvuOXwQIPOaVdj0rQ: checks 
s7Q6uNouhe7aE8JdFb9E+A: bets $1
H/l9NZvuOXwQIPOaVdj0rQ: folds 
Uncalled bet ($1) returned to s7Q6uNouhe7aE8JdFb9E+A
s7Q6uNouhe7aE8JdFb9E+A collected $1.45 from pot
s7Q6uNouhe7aE8JdFb9E+A: doesn't show hand 
*** SUMMARY ***
Total pot $1.50 | Rake $0.05 
Board [As Ts 5c]
Seat 1: s7Q6uNouhe7aE8JdFb9E+A (button) (small blind) collected ($1.45)
Seat 4: H/l9NZvuOXwQIPOaVdj0rQ (big blind) folded on the Flop




PokerStars Game #59939382792:  Hold'em No Limit ($0.10/$0.25) - 2009/07/01 0:38:27 ET
Table 'nRFAYu63wZNzrz/OBgzFTw' 9-max Seat #4 is the button
Seat 2: hJ4uYjNmSZdjrKA8cjZqCA ($20.45 in chips) 
Seat 3: EfRs3ibIxn+c9JDErwwNCg ($25 in chips) 
Seat 4: OiV1PWZ3IkN29JlmCcnTwQ ($4.90 in chips) 
Seat 5: vKdukiQ4ktU4yJ0Xx3MKnA ($28.90 in chips) 
Seat 6: DnDcAdn9P0zGovMERigpFA ($25.25 in chips) 
Seat 7: COsrwJSFHQtxlUcrYtDQPQ ($26.95 in chips) 
Seat 8: rhWCqDS9OBh/IoXY29BGMw ($19.55 in chips) 
Seat 9: SXqVW4Q0evTUVZG6BbUNIA ($33.50 in chips) 
vKdukiQ4ktU4yJ0Xx3MKnA: posts small blind $0.10
DnDcAdn9P0zGovMERigpFA: posts big blind $0.25
N6fYvIzQLKaydFLKQGtMlQ: sits out 
*** HOLE CARDS ***
COsrwJSFHQtxlUcrYtDQPQ: folds 
rhWCqDS9OBh/IoXY29BGMw: folds 
SXqVW4Q0evTUVZG6BbUNIA: folds 
hJ4uYjNmSZdjrKA8cjZqCA: calls $0.25
EfRs3ibIxn+c9JDErwwNCg: folds 
OiV1PWZ3IkN29JlmCcnTwQ: raises $1 to $1.25
vKdukiQ4ktU4yJ0Xx3MKnA: folds 
DnDcAdn9P0zGovMERigpFA: folds 
hJ4uYjNmSZdjrKA8cjZqCA: folds 
Uncalled bet ($1) returned to OiV1PWZ3IkN29JlmCcnTwQ
OiV1PWZ3IkN29JlmCcnTwQ collected $0.85 from pot
OiV1PWZ3IkN29JlmCcnTwQ: doesn't show hand 
*** SUMMARY ***
Total pot $0.85 | Rake $0 
Seat 2: hJ4uYjNmSZdjrKA8cjZqCA folded before Flop
Seat 3: EfRs3ibIxn+c9JDErwwNCg folded before Flop (didn't bet)
Seat 4: OiV1PWZ3IkN29JlmCcnTwQ (button) collected ($0.85)
Seat 5: vKdukiQ4ktU4yJ0Xx3MKnA (small blind) folded before Flop
Seat 6: DnDcAdn9P0zGovMERigpFA (big blind) folded before Flop
Seat 7: COsrwJSFHQtxlUcrYtDQPQ folded before Flop (didn't bet)
Seat 8: rhWCqDS9OBh/IoXY29BGMw folded before Flop (didn't bet)
Seat 9: SXqVW4Q0evTUVZG6BbUNIA folded before Flop (didn't bet)




PokerStars Game #59939382652:  Hold'em No Limit ($0.10/$0.25) - 2009/07/01 0:38:27 ET
Table 'NfXsh0UQA+o/kO9acV3WxA' 9-max Seat #4 is the button
Seat 1: H5Se03ZqSX7tbULXur2MAg ($24.30 in chips) 
Seat 2: 5/P8XWKnr8tBG9c+iHgFNA ($23.65 in chips) 
Seat 3: 1K6QGyJP9P9xmRac2fH4OQ ($37.45 in chips) 
Seat 4: sQ6szDwWrE+LMh1p4dVexA ($17.10 in chips) 
Seat 5: 3RCAkueG3Vc13VpRStCB+w ($36.50 in chips) 
Seat 6: jMfnkiGgGZI43Vhowb6MpA ($12.90 in chips) 
Seat 7: HPEB+AtKw1+C/cxU0o1ciw ($31.95 in chips) 
Seat 9: MgMavn/DzTzqKgHTZMsVSw ($25 in chips) 
3RCAkueG3Vc13VpRStCB+w: posts small blind $0.10
jMfnkiGgGZI43Vhowb6MpA: posts big blind $0.25
+sbyWwIcFp9kP0bDtMegfQ: sits out 
*** HOLE CARDS ***
HPEB+AtKw1+C/cxU0o1ciw: folds 
MgMavn/DzTzqKgHTZMsVSw: folds 
H5Se03ZqSX7tbULXur2MAg: folds 
5/P8XWKnr8tBG9c+iHgFNA: calls $0.25
1K6QGyJP9P9xmRac2fH4OQ: folds 
sQ6szDwWrE+LMh1p4dVexA: folds 
3RCAkueG3Vc13VpRStCB+w: folds 
jMfnkiGgGZI43Vhowb6MpA: checks 
*** FLOP *** [Kc 8h Qs]
jMfnkiGgGZI43Vhowb6MpA: checks 
5/P8XWKnr8tBG9c+iHgFNA: bets $0.50
jMfnkiGgGZI43Vhowb6MpA: folds 
Uncalled bet ($0.50) returned to 5/P8XWKnr8tBG9c+iHgFNA
5/P8XWKnr8tBG9c+iHgFNA collected $0.60 from pot
5/P8XWKnr8tBG9c+iHgFNA: doesn't show hand 
*** SUMMARY ***
Total pot $0.60 | Rake $0 
Board [Kc 8h Qs]
Seat 1: H5Se03ZqSX7tbULXur2MAg folded before Flop (didn't bet)
Seat 2: 5/P8XWKnr8tBG9c+iHgFNA collected ($0.60)
Seat 3: 1K6QGyJP9P9xmRac2fH4OQ folded before Flop (didn't bet)
Seat 4: sQ6szDwWrE+LMh1p4dVexA (button) folded before Flop (didn't bet)
Seat 5: 3RCAkueG3Vc13VpRStCB+w (small blind) folded before Flop
Seat 6: jMfnkiGgGZI43Vhowb6MpA (big blind) folded on the Flop
Seat 7: HPEB+AtKw1+C/cxU0o1ciw folded before Flop (didn't bet)
Seat 9: MgMavn/DzTzqKgHTZMsVSw folded before Flop (didn't bet)




PokerStars Game #59939382872:  Hold'em No Limit ($0.10/$0.25) - 2009/07/01 0:38:27 ET
Table 'AHkg4ChqzcMauBx6Qvz8Nw' 6-max Seat #6 is the button
Seat 2: /bjna2FTN7pPjqYGzmDE0Q ($24.10 in chips) 
Seat 4: N7O9jUEx2YiQn1+yRYTHmw ($25.70 in chips) 
Seat 5: LtASJ9OlkqGrrUKGQlpGAw ($34.70 in chips) 
Seat 6: SFmT9ZsVopnukjvAzrxTRg ($53.40 in chips) 
yonicha was removed from the table for failing to post
/bjna2FTN7pPjqYGzmDE0Q: posts small blind $0.10
PIOdknsVyjKUwfiImc3zwg: is sitting out 
PIOdknsVyjKUwfiImc3zwg leaves the table
N7O9jUEx2YiQn1+yRYTHmw: posts big blind $0.25
*** HOLE CARDS ***
LtASJ9OlkqGrrUKGQlpGAw: folds 
SFmT9ZsVopnukjvAzrxTRg: folds 
/bjna2FTN7pPjqYGzmDE0Q: folds 
Uncalled bet ($0.15) returned to N7O9jUEx2YiQn1+yRYTHmw
N7O9jUEx2YiQn1+yRYTHmw collected $0.20 from pot
N7O9jUEx2YiQn1+yRYTHmw: doesn't show hand 
*** SUMMARY ***
Total pot $0.20 | Rake $0 
Seat 2: /bjna2FTN7pPjqYGzmDE0Q (small blind) folded before Flop
Seat 4: N7O9jUEx2YiQn1+yRYTHmw (big blind) collected ($0.20)
Seat 5: LtASJ9OlkqGrrUKGQlpGAw folded before Flop (didn't bet)
Seat 6: SFmT9ZsVopnukjvAzrxTRg (button) folded before Flop (didn't bet)




PokerStars Game #59939382734:  Hold'em No Limit ($0.10/$0.25) - 2009/07/01 0:38:27 ET
Table 'gHbubGDeVSkmB4vFiqIN3Q' 6-max Seat #2 is the button
Seat 1: kG34n23qFQA3nzdOJTQ1dA ($26.25 in chips) 
Seat 2: 8LzEWRhg4wk8Jh9CqDhH3Q ($3.65 in chips) 
Seat 3: DDSdUri0VKbNEouF/1bdsg ($5.95 in chips) 
Seat 4: v+QfkGiuj9bgtuNoVnDO8w ($32.50 in chips) 
DDSdUri0VKbNEouF/1bdsg: posts small blind $0.10
v+QfkGiuj9bgtuNoVnDO8w: posts big blind $0.25
wvIIdlbCgePONQwXjx9xzQ: sits out 
*** HOLE CARDS ***
kG34n23qFQA3nzdOJTQ1dA: folds 
8LzEWRhg4wk8Jh9CqDhH3Q: calls $0.25
DDSdUri0VKbNEouF/1bdsg: folds 
v+QfkGiuj9bgtuNoVnDO8w: checks 
*** FLOP *** [3c Js 9c]
v+QfkGiuj9bgtuNoVnDO8w: checks 
8LzEWRhg4wk8Jh9CqDhH3Q: checks 
*** TURN *** [3c Js 9c] [8d]
v+QfkGiuj9bgtuNoVnDO8w: checks 
8LzEWRhg4wk8Jh9CqDhH3Q: checks 
*** RIVER *** [3c Js 9c 8d] [2d]
v+QfkGiuj9bgtuNoVnDO8w: checks 
8LzEWRhg4wk8Jh9CqDhH3Q: checks 
*** SHOW DOWN ***
v+QfkGiuj9bgtuNoVnDO8w: shows [8s 5c] (a pair of Eights)
8LzEWRhg4wk8Jh9CqDhH3Q: mucks hand 
DDSdUri0VKbNEouF/1bdsg leaves the table
v+QfkGiuj9bgtuNoVnDO8w collected $0.60 from pot
*** SUMMARY ***
Total pot $0.60 | Rake $0 
Board [3c Js 9c 8d 2d]
Seat 1: kG34n23qFQA3nzdOJTQ1dA folded before Flop (didn't bet)
Seat 2: 8LzEWRhg4wk8Jh9CqDhH3Q (button) mucked
Seat 3: DDSdUri0VKbNEouF/1bdsg (small blind) folded before Flop
Seat 4: v+QfkGiuj9bgtuNoVnDO8w (big blind) showed [8s 5c] and won ($0.60) with a pair of Eights




PokerStars Game #59939383958:  Hold'em No Limit ($0.10/$0.25) - 2009/07/01 0:38:28 ET
Table 'Qk/910N2Yhg8u5vqTJk50Q' 9-max Seat #4 is the button
Seat 1: zDrucyjVn5aeekNEc3cJrA ($25.25 in chips) 
Seat 2: Th3FldXKQW6hWVVPahaoOQ ($33.20 in chips) 
Seat 3: ghNKXUBl/H+t83JF079ZBA ($25 in chips) 
Seat 4: 33y9+GmQ3J84RvZXcraRTw ($21.45 in chips) 
Seat 5: 4oA316mXLIui1QY63GXBUg ($27.35 in chips) 
Seat 7: Wem/MTN+sc9vH/UZeT5YLQ ($9.65 in chips) 
Seat 8: H5Se03ZqSX7tbULXur2MAg ($25.10 in chips) 
Seat 9: M2QO2DxB5Wawg2h8HSpnYA ($10 in chips) 
4oA316mXLIui1QY63GXBUg: posts small blind $0.10
st9jtdNbm1W5GfBwRaCVqQ: is sitting out 
st9jtdNbm1W5GfBwRaCVqQ leaves the table
Wem/MTN+sc9vH/UZeT5YLQ: posts big blind $0.25
*** HOLE CARDS ***
H5Se03ZqSX7tbULXur2MAg: folds 
M2QO2DxB5Wawg2h8HSpnYA: folds 
zDrucyjVn5aeekNEc3cJrA: folds 
Th3FldXKQW6hWVVPahaoOQ: folds 
ghNKXUBl/H+t83JF079ZBA: folds 
33y9+GmQ3J84RvZXcraRTw: folds 
4oA316mXLIui1QY63GXBUg: folds 
Uncalled bet ($0.15) returned to Wem/MTN+sc9vH/UZeT5YLQ
Wem/MTN+sc9vH/UZeT5YLQ collected $0.20 from pot
Wem/MTN+sc9vH/UZeT5YLQ: doesn't show hand 
SteveSupreme joins the table at seat #6 
*** SUMMARY ***
Total pot $0.20 | Rake $0 
Seat 1: zDrucyjVn5aeekNEc3cJrA folded before Flop (didn't bet)
Seat 2: Th3FldXKQW6hWVVPahaoOQ folded before Flop (didn't bet)
Seat 3: ghNKXUBl/H+t83JF079ZBA folded before Flop (didn't bet)
Seat 4: 33y9+GmQ3J84RvZXcraRTw (button) folded before Flop (didn't bet)
Seat 5: 4oA316mXLIui1QY63GXBUg (small blind) folded before Flop
Seat 7: Wem/MTN+sc9vH/UZeT5YLQ (big blind) collected ($0.20)
Seat 8: H5Se03ZqSX7tbULXur2MAg folded before Flop (didn't bet)
Seat 9: M2QO2DxB5Wawg2h8HSpnYA folded before Flop (didn't bet)




PokerStars Game #59939383928:  Hold'em No Limit ($0.10/$0.25) - 2009/07/01 0:38:28 ET
Table 'nteM56rtr9SxLEblf0fvbw' 9-max Seat #2 is the button
Seat 1: H9KUl8cmpLgEpOVDA00bCg ($5 in chips) 
Seat 2: ljemhp25Zg+nlA9DLCIiUw ($25.95 in chips) 
Seat 4: cZ99hugmLBj9KhTlc8nCSw ($25.25 in chips) 
Seat 5: aJy680tKSaP5er559aSuGA ($10.45 in chips) 
Seat 6: LuckyShot



PokerStars Game #59939383308:  Hold'em No Limit ($0.10/$0.25) - 2009/07/01 0:38:28 ET
Table 'Xi38lWH8L2JHRAsKYVX8Qg' 6-max Seat #2 is the button
Seat 1: AqQ7DFpHkgIzTwDu+rClcg ($5.55 in chips) 
Seat 2: YjCHRUY3WJtHMnkcRxvmug ($36.90 in chips) 
Seat 3: hFvl367f+GnfQv2riJlsTA ($11.40 in chips) 
Seat 4: d0J1xuhsynEY81YHwAvJ5g ($25 in chips) 
Seat 5: 9KPR3sZ+CxRm7bQ8qxFzMQ ($11.70 in chips) 
Seat 6: aogAb4Eienxztk8p2v9VVw ($23.10 in chips) 
hFvl367f+GnfQv2riJlsTA: posts small blind $0.10
d0J1xuhsynEY81YHwAvJ5g: posts big blind $0.25
*** HOLE CARDS ***
9KPR3sZ+CxRm7bQ8qxFzMQ: folds 
9KPR3sZ+CxRm7bQ8qxFzMQ leaves the table
aogAb4Eienxztk8p2v9VVw: raises $0.75 to $1
AqQ7DFpHkgIzTwDu+rClcg: calls $1
YjCHRUY3WJtHMnkcRxvmug: folds 
hFvl367f+GnfQv2riJlsTA: folds 
d0J1xuhsynEY81YHwAvJ5g: folds 
*** FLOP *** [7h Js 9s]
aogAb4Eienxztk8p2v9VVw: bets $1.50
AqQ7DFpHkgIzTwDu+rClcg: folds 
Uncalled bet ($1.50) returned to aogAb4Eienxztk8p2v9VVw
aogAb4Eienxztk8p2v9VVw collected $2.25 from pot
aogAb4Eienxztk8p2v9VVw: doesn't show hand 
*** SUMMARY ***
Total pot $2.35 | Rake $0.10 
Board [7h Js 9s]
Seat 1: AqQ7DFpHkgIzTwDu+rClcg folded on the Flop
Seat 2: YjCHRUY3WJtHMnkcRxvmug (button) folded before Flop (didn't bet)
Seat 3: hFvl367f+GnfQv2riJlsTA (small blind) folded before Flop
Seat 4: d0J1xuhsynEY81YHwAvJ5g (big blind) folded before Flop
Seat 5: 9KPR3sZ+CxRm7bQ8qxFzMQ folded before Flop (didn't bet)
Seat 6: aogAb4Eienxztk8p2v9VVw collected ($2.25)




PokerStars Game #59939383902:  Hold'em No Limit ($0.10/$0.25) - 2009/07/01 0:38:28 ET
Table 'AchTjdLS1zBUbH3ZIx6f0w' 6-max Seat #4 is the button
Seat 1: IzVI+wIP7IS+d0sugIrOPQ ($26.30 in chips) 
Seat 2: kG34n23qFQA3nzdOJTQ1dA ($40.55 in chips) 
Seat 3: ehifenV36yVvJMnV63D3cg ($5.40 in chips) 
Seat 4: q6WfTUAD9mowIP63ASq2Dg ($25.70 in chips) 
Seat 5: oBUDUfeUyCbZBsjxHZgSiw ($34.25 in chips) 
Seat 6: 5tB0F9NjPSUL4FzmzBMs2Q ($25 in chips) 
oBUDUfeUyCbZBsjxHZgSiw: posts small blind $0.10
5tB0F9NjPSUL4FzmzBMs2Q: posts big blind $0.25
*** HOLE CARDS ***
IzVI+wIP7IS+d0sugIrOPQ: folds 
kG34n23qFQA3nzdOJTQ1dA: folds 
ehifenV36yVvJMnV63D3cg: raises $0.25 to $0.50
q6WfTUAD9mowIP63ASq2Dg: folds 
oBUDUfeUyCbZBsjxHZgSiw: calls $0.40
5tB0F9NjPSUL4FzmzBMs2Q: folds 
*** FLOP *** [5c Ac Jc]
oBUDUfeUyCbZBsjxHZgSiw: checks 
ehifenV36yVvJMnV63D3cg: bets $0.25
oBUDUfeUyCbZBsjxHZgSiw: folds 
Uncalled bet ($0.25) returned to ehifenV36yVvJMnV63D3cg
ehifenV36yVvJMnV63D3cg collected $1.20 from pot
ehifenV36yVvJMnV63D3cg: doesn't show hand 
*** SUMMARY ***
Total pot $1.25 | Rake $0.05 
Board [5c Ac Jc]
Seat 1: IzVI+wIP7IS+d0sugIrOPQ folded before Flop (didn't bet)
Seat 2: kG34n23qFQA3nzdOJTQ1dA folded before Flop (didn't bet)
Seat 3: ehifenV36yVvJMnV63D3cg collected ($1.20)
Seat 4: q6WfTUAD9mowIP63ASq2Dg (button) folded before Flop (didn't bet)
Seat 5: oBUDUfeUyCbZBsjxHZgSiw (small blind) folded on the Flop
Seat 6: 5tB0F9NjPSUL4FzmzBMs2Q (big blind) folded before Flop




PokerStars Game #59939383484:  Hold'em No Limit ($0.10/$0.25) - 2009/07/01 0:38:28 ET
Table 'wRXcD9iXgBbdvKhWmfnBnw' 6-max Seat #3 is the button
Seat 1: LGWRgaQNaDFSlUGk26f0Ig ($19.45 in chips) 
Seat 2: SS/yfeArhULzIcOPe8MdPg ($25.60 in chips) 
Seat 3: 6zbQpY/G44U1Xvj7DZex0A ($19.70 in chips) 
Seat 4: mfrkWA3PTeYPkbO6hi98Aw ($26.15 in chips) 
Seat 5: EE16Ua5b1HSsYej5zeXOlA ($25 in chips) 
Seat 6: Euh3U8PK9KVQP5CQdDjkeQ ($13.05 in chips) 
mfrkWA3PTeYPkbO6hi98Aw: posts small blind $0.10
EE16Ua5b1HSsYej5zeXOlA: posts big blind $0.25
*** HOLE CARDS ***
Euh3U8PK9KVQP5CQdDjkeQ: folds 
LGWRgaQNaDFSlUGk26f0Ig: folds 
SS/yfeArhULzIcOPe8MdPg: raises $0.75 to $1
6zbQpY/G44U1Xvj7DZex0A: folds 
mfrkWA3PTeYPkbO6hi98Aw: folds 
EE16Ua5b1HSsYej5zeXOlA: calls $0.75
*** FLOP *** [Ts 6d 9s]
EE16Ua5b1HSsYej5zeXOlA: checks 
SS/yfeArhULzIcOPe8MdPg: bets $1.50
EE16Ua5b1HSsYej5zeXOlA: raises $2.75 to $4.25
Euh3U8PK9KVQP5CQdDjkeQ leaves the table
SS/yfeArhULzIcOPe8MdPg: calls $2.75
*** TURN *** [Ts 6d 9s] [3s]
EE16Ua5b1HSsYej5zeXOlA: bets $7.15
SS/yfeArhULzIcOPe8MdPg: folds 
Uncalled bet ($7.15) returned to EE16Ua5b1HSsYej5zeXOlA
SS/yfeArhULzIcOPe8MdPg said, "nh"
EE16Ua5b1HSsYej5zeXOlA collected $10.10 from pot
EE16Ua5b1HSsYej5zeXOlA: doesn't show hand 
*** SUMMARY ***
Total pot $10.60 | Rake $0.50 
Board [Ts 6d 9s 3s]
Seat 1: LGWRgaQNaDFSlUGk26f0Ig folded before Flop (didn't bet)
Seat 2: SS/yfeArhULzIcOPe8MdPg folded on the Turn
Seat 3: 6zbQpY/G44U1Xvj7DZex0A (button) folded before Flop (didn't bet)
Seat 4: mfrkWA3PTeYPkbO6hi98Aw (small blind) folded before Flop
Seat 5: EE16Ua5b1HSsYej5zeXOlA (big blind) collected ($10.10)
Seat 6: Euh3U8PK9KVQP5CQdDjkeQ folded before Flop (didn't bet)




PokerStars Game #59939383592:  Hold'em No Limit ($0.10/$0.25) - 2009/07/01 0:38:28 ET
Table 'x7YStLKc8hpt/pTgSetPKA' 9-max Seat #2 is the button
Seat 2: z5GxcHlYz/GSz6W2uFiTtg ($36.25 in chips) 
Seat 5: gxyie8xe6lDdpfG4quHtbw ($15.05 in chips) 
Seat 6: Yv4fucyyT28mjx8V5lxKJg ($32.15 in chips) 
Seat 7: +8FtfKCFr23+6O39P+U45Q ($28.90 in chips) 
Seat 8: jeKWRUkMaVn8rEUjnJKqpg ($33.90 in chips) 
Seat 9: nm4Dj/f+jJEwKVsUnKh73g ($22.50 in chips) 
gxyie8xe6lDdpfG4quHtbw: posts small blind $0.10
Yv4fucyyT28mjx8V5lxKJg: posts big blind $0.25
*** HOLE CARDS ***
+8FtfKCFr23+6O39P+U45Q: calls $0.25
jeKWRUkMaVn8rEUjnJKqpg: calls $0.25
nm4Dj/f+jJEwKVsUnKh73g: calls $0.25
z5GxcHlYz/GSz6W2uFiTtg: folds 
gxyie8xe6lDdpfG4quHtbw: calls $0.15
Yv4fucyyT28mjx8V5lxKJg: checks 
*** FLOP *** [Ad 9h 8h]
gxyie8xe6lDdpfG4quHtbw: checks 
Yv4fucyyT28mjx8V5lxKJg: checks 
+8FtfKCFr23+6O39P+U45Q: bets $1
jeKWRUkMaVn8rEUjnJKqpg: folds 
nm4Dj/f+jJEwKVsUnKh73g: folds 
gxyie8xe6lDdpfG4quHtbw: folds 
Yv4fucyyT28mjx8V5lxKJg: folds 
Uncalled bet ($1) returned to +8FtfKCFr23+6O39P+U45Q
S7Ki0P+0AIGPuIfGJjW0gg joins the table at seat #3 
+8FtfKCFr23+6O39P+U45Q collected $1.20 from pot
+8FtfKCFr23+6O39P+U45Q: doesn't show hand 
*** SUMMARY ***
Total pot $1.25 | Rake $0.05 
Board [Ad 9h 8h]
Seat 2: z5GxcHlYz/GSz6W2uFiTtg (button) folded before Flop (didn't bet)
Seat 5: gxyie8xe6lDdpfG4quHtbw (small blind) folded on the Flop
Seat 6: Yv4fucyyT28mjx8V5lxKJg (big blind) folded on the Flop
Seat 7: +8FtfKCFr23+6O39P+U45Q collected ($1.20)
Seat 8: jeKWRUkMaVn8rEUjnJKqpg folded on the Flop
Seat 9: nm4Dj/f+jJEwKVsUnKh73g folded on the Flop




PokerStars Game #59939383348:  Hold'em No Limit ($0.10/$0.25) - 2009/07/01 0:38:28 ET
Table 'BpNkESDX1ip9c0K1hb5h7A' 6-max Seat #1 is the button
Seat 1: 9jSiy0meE9XJKkdIZwyTEQ ($28.75 in chips) 
Seat 3: cHhVLDikFlByGGN+CM3w/A ($27.65 in chips) 
Seat 4: tbhYGxTClzdFLMcTtjvJhg ($49.20 in chips) 
Seat 5: QvTX2yGq3uKJiKPmns4TKQ ($73.40 in chips) 
Seat 6: iUgsn+WyKFjjVd+tj13R2w ($3.15 in chips) 
cHhVLDikFlByGGN+CM3w/A: posts small blind $0.10
tbhYGxTClzdFLMcTtjvJhg: posts big blind $0.25
*** HOLE CARDS ***
QvTX2yGq3uKJiKPmns4TKQ: raises $0.50 to $0.75
iUgsn+WyKFjjVd+tj13R2w: calls $0.75
9jSiy0meE9XJKkdIZwyTEQ: folds 
cHhVLDikFlByGGN+CM3w/A: raises $2.25 to $3
tbhYGxTClzdFLMcTtjvJhg: folds 
QvTX2yGq3uKJiKPmns4TKQ: folds 
iUgsn+WyKFjjVd+tj13R2w: raises $0.15 to $3.15 and is all-in
cHhVLDikFlByGGN+CM3w/A: calls $0.15
*** FLOP *** [3h Ts Th]
*** TURN *** [3h Ts Th] [4d]
*** RIVER *** [3h Ts Th 4d] [3c]
*** SHOW DOWN ***
cHhVLDikFlByGGN+CM3w/A: shows [Qd Kc] (two pair, Tens and Threes)
iUgsn+WyKFjjVd+tj13R2w: shows [Jd Ac] (two pair, Tens and Threes - Ace kicker)
iUgsn+WyKFjjVd+tj13R2w collected $6.95 from pot
*** SUMMARY ***
Total pot $7.30 | Rake $0.35 
Board [3h Ts Th 4d 3c]
Seat 1: 9jSiy0meE9XJKkdIZwyTEQ (button) folded before Flop (didn't bet)
Seat 3: cHhVLDikFlByGGN+CM3w/A (small blind) showed [Qd Kc] and lost with two pair, Tens and Threes
Seat 4: tbhYGxTClzdFLMcTtjvJhg (big blind) folded before Flop
Seat 5: QvTX2yGq3uKJiKPmns4TKQ folded before Flop
Seat 6: iUgsn+WyKFjjVd+tj13R2w showed [Jd Ac] and won ($6.95) with two pair, Tens and Threes




PokerStars Game #59939383424:  Hold'em No Limit ($0.10/$0.25) - 2009/07/01 0:38:28 ET
Table 'ROYvQOMwUrvL3SOiHYcrWg' 9-max Seat #1 is the button
Seat 1: 7q7lZBfgmzjFr0jTNx4b6g ($12.10 in chips) 
Seat 2: hBMUlEpyU74r/fwDgIpXjQ ($48.95 in chips) 
Seat 4: SHegmCn8B0InbWE/zFlvOw ($29.55 in chips) 
Seat 5: jeKWRUkMaVn8rEUjnJKqpg ($25 in chips) 
Seat 6: ZWU9RNYtjmm4cElg1I0F4w ($31.85 in chips) 
Seat 7: tYsOBqdU1+x+yFI7zHO7hQ ($26.25 in chips) 
Seat 9: H361Owx55YUAYmPZdz+Hzg ($11.55 in chips) 
hBMUlEpyU74r/fwDgIpXjQ: posts small blind $0.10
CYkY0dNBaYaKs8HVCVn3mQ: is sitting out 
SHegmCn8B0InbWE/zFlvOw: posts big blind $0.25
ModestZL: sits out 
*** HOLE CARDS ***
CYkY0dNBaYaKs8HVCVn3mQ has returned
jeKWRUkMaVn8rEUjnJKqpg: folds 
CYkY0dNBaYaKs8HVCVn3mQ is sitting out
ZWU9RNYtjmm4cElg1I0F4w: raises $0.50 to $0.75
tYsOBqdU1+x+yFI7zHO7hQ: folds 
H361Owx55YUAYmPZdz+Hzg: folds 
H361Owx55YUAYmPZdz+Hzg said, "hell yeah"
7q7lZBfgmzjFr0jTNx4b6g: calls $0.75
hBMUlEpyU74r/fwDgIpXjQ: folds 
SHegmCn8B0InbWE/zFlvOw: calls $0.50
*** FLOP *** [4s Qh 7h]
SHegmCn8B0InbWE/zFlvOw: checks 
ZWU9RNYtjmm4cElg1I0F4w: bets $1.60
7q7lZBfgmzjFr0jTNx4b6g: folds 
SHegmCn8B0InbWE/zFlvOw: folds 
Uncalled bet ($1.60) returned to ZWU9RNYtjmm4cElg1I0F4w
ZWU9RNYtjmm4cElg1I0F4w collected $2.25 from pot
ZWU9RNYtjmm4cElg1I0F4w: doesn't show hand 
*** SUMMARY ***
Total pot $2.35 | Rake $0.10 
Board [4s Qh 7h]
Seat 1: 7q7lZBfgmzjFr0jTNx4b6g (button) folded on the Flop
Seat 2: hBMUlEpyU74r/fwDgIpXjQ (small blind) folded before Flop
Seat 4: SHegmCn8B0InbWE/zFlvOw (big blind) folded on the Flop
Seat 5: jeKWRUkMaVn8rEUjnJKqpg folded before Flop (didn't bet)
Seat 6: ZWU9RNYtjmm4cElg1I0F4w collected ($2.25)
Seat 7: tYsOBqdU1+x+yFI7zHO7hQ folded before Flop (didn't bet)
Seat 9: H361Owx55YUAYmPZdz+Hzg folded before Flop (didn't bet)




PokerStars Game #59939384362:  Hold'em No Limit ($0.10/$0.25) - 2009/07/01 0:38:29 ET
Table '9iHhO6FyZVM8XpSc23TIgg' 6-max Seat #1 is the button
Seat 1: NhUN/JpAprdJeamFBgJH1w ($25 in chips) 
Seat 2: ErIN0JRL5srYjT6en1f8YQ ($23.60 in chips) 
Seat 3: EXTSABh+qTpWWrIkxl3wXg ($44 in chips) 
Seat 4: cfJccEfyn6IkquPN08hFsA ($33.55 in chips) 
Seat 5: WmfI+HZXhME/HMG8E3/H2w ($15.50 in chips) 
Seat 6: 5z4PIVM9IyDWfUi+/MMdTA ($25 in chips) 
ErIN0JRL5srYjT6en1f8YQ: posts small blind $0.10
EXTSABh+qTpWWrIkxl3wXg: posts big blind $0.25
*** HOLE CARDS ***
cfJccEfyn6IkquPN08hFsA: folds 
WmfI+HZXhME/HMG8E3/H2w: calls $0.25
5z4PIVM9IyDWfUi+/MMdTA: calls $0.25
NhUN/JpAprdJeamFBgJH1w: folds 
ErIN0JRL5srYjT6en1f8YQ: raises $1.25 to $1.50
EXTSABh+qTpWWrIkxl3wXg: folds 
WmfI+HZXhME/HMG8E3/H2w: calls $1.25
5z4PIVM9IyDWfUi+/MMdTA: calls $1.25
*** FLOP *** [9d 2h 9c]
ErIN0JRL5srYjT6en1f8YQ: bets $2
WmfI+HZXhME/HMG8E3/H2w: folds 
5z4PIVM9IyDWfUi+/MMdTA: calls $2
*** TURN *** [9d 2h 9c] [5s]
5z4PIVM9IyDWfUi+/MMdTA said, "im calling you all the way"
ErIN0JRL5srYjT6en1f8YQ: bets $4
5z4PIVM9IyDWfUi+/MMdTA: calls $4
*** RIVER *** [9d 2h 9c 5s] [Ks]
ErIN0JRL5srYjT6en1f8YQ: bets $16.10 and is all-in
5z4PIVM9IyDWfUi+/MMdTA said, "oops not here   you got lucky here"
5z4PIVM9IyDWfUi+/MMdTA: folds 
Uncalled bet ($16.10) returned to ErIN0JRL5srYjT6en1f8YQ
ErIN0JRL5srYjT6en1f8YQ collected $15.95 from pot
ErIN0JRL5srYjT6en1f8YQ: doesn't show hand 
*** SUMMARY ***
Total pot $16.75 | Rake $0.80 
Board [9d 2h 9c 5s Ks]
Seat 1: NhUN/JpAprdJeamFBgJH1w (button) folded before Flop (didn't bet)
Seat 2: ErIN0JRL5srYjT6en1f8YQ (small blind) collected ($15.95)
Seat 3: EXTSABh+qTpWWrIkxl3wXg (big blind) folded before Flop
Seat 4: cfJccEfyn6IkquPN08hFsA folded before Flop (didn't bet)
Seat 5: WmfI+HZXhME/HMG8E3/H2w folded on the Flop
Seat 6: 5z4PIVM9IyDWfUi+/MMdTA folded on the River




PokerStars Game #59939384578:  Hold'em No Limit ($0.10/$0.25) - 2009/07/01 0:38:29 ET
Table 'L5GvbdQO5aCZJSE6pyQ8OA' 6-max Seat #6 is the button
Seat 1: FOcO5GvOP3rgvLGPLVkg5g ($30.45 in chips) 
Seat 2: LxehwDpTQ19ph4Qmc78+Pw ($19.15 in chips) 
Seat 3: wKFJ513ucluNNiMlkXcDOQ ($25 in chips) 
Seat 4: ErIN0JRL5srYjT6en1f8YQ ($25 in chips) 
Seat 5: I60CfDZDrpMTu9pHHz8TFA ($68.85 in chips) 
Seat 6: v+QfkGiuj9bgtuNoVnDO8w ($35.25 in chips) 
FOcO5GvOP3rgvLGPLVkg5g: posts small blind $0.10
LxehwDpTQ19ph4Qmc78+Pw: posts big blind $0.25
*** HOLE CARDS ***
wKFJ513ucluNNiMlkXcDOQ: folds 
ErIN0JRL5srYjT6en1f8YQ: folds 
I60CfDZDrpMTu9pHHz8TFA: folds 
v+QfkGiuj9bgtuNoVnDO8w: folds 
FOcO5GvOP3rgvLGPLVkg5g: folds 
Uncalled bet ($0.15) returned to LxehwDpTQ19ph4Qmc78+Pw
LxehwDpTQ19ph4Qmc78+Pw collected $0.20 from pot
LxehwDpTQ19ph4Qmc78+Pw: doesn't show hand 
*** SUMMARY ***
Total pot $0.20 | Rake $0 
Seat 1: FOcO5GvOP3rgvLGPLVkg5g (small blind) folded before Flop
Seat 2: LxehwDpTQ19ph4Qmc78+Pw (big blind) collected ($0.20)
Seat 3: wKFJ513ucluNNiMlkXcDOQ folded before Flop (didn't bet)
Seat 4: ErIN0JRL5srYjT6en1f8YQ folded before Flop (didn't bet)
Seat 5: I60CfDZDrpMTu9pHHz8TFA folded before Flop (didn't bet)
Seat 6: v+QfkGiuj9bgtuNoVnDO8w (button) folded before Flop (didn't bet)




PokerStars Game #59939384422:  Hold'em No Limit ($0.10/$0.25) - 2009/07/01 0:38:29 ET
Table 'dNYnr4D4id1jwnEU66Yowg' 9-max Seat #8 is the button
Seat 2: t2nb95S5EEFOEzNx9Itz0g ($4.95 in chips) 
Seat 5: k+2r6di6GXjNpAdrRkW9bA ($23.20 in chips) 
Seat 6: kqpa/IbqkUrwPb3hbA7/ww ($8.50 in chips) 
Seat 8: opOCI2p6kW0tINuVaAqmcQ ($25.10 in chips) 
t2nb95S5EEFOEzNx9Itz0g: posts small blind $0.10
k+2r6di6GXjNpAdrRkW9bA: posts big blind $0.25
*** HOLE CARDS ***
kqpa/IbqkUrwPb3hbA7/ww: calls $0.25
opOCI2p6kW0tINuVaAqmcQ: folds 
opOCI2p6kW0tINuVaAqmcQ leaves the table
t2nb95S5EEFOEzNx9Itz0g: calls $0.15
k+2r6di6GXjNpAdrRkW9bA: checks 
*** FLOP *** [3h Ad 5h]
t2nb95S5EEFOEzNx9Itz0g: checks 
k+2r6di6GXjNpAdrRkW9bA: bets $0.50
kqpa/IbqkUrwPb3hbA7/ww: calls $0.50
t2nb95S5EEFOEzNx9Itz0g: calls $0.50
*** TURN *** [3h Ad 5h] [Qd]
t2nb95S5EEFOEzNx9Itz0g: checks 
k+2r6di6GXjNpAdrRkW9bA: checks 
kqpa/IbqkUrwPb3hbA7/ww: checks 
*** RIVER *** [3h Ad 5h Qd] [6h]
t2nb95S5EEFOEzNx9Itz0g: bets $0.75
k+2r6di6GXjNpAdrRkW9bA: folds 
kqpa/IbqkUrwPb3hbA7/ww: folds 
Uncalled bet ($0.75) returned to t2nb95S5EEFOEzNx9Itz0g
t2nb95S5EEFOEzNx9Itz0g collected $2.15 from pot
t2nb95S5EEFOEzNx9Itz0g: doesn't show hand 
*** SUMMARY ***
Total pot $2.25 | Rake $0.10 
Board [3h Ad 5h Qd 6h]
Seat 2: t2nb95S5EEFOEzNx9Itz0g (small blind) collected ($2.15)
Seat 5: k+2r6di6GXjNpAdrRkW9bA (big blind) folded on the River
Seat 6: kqpa/IbqkUrwPb3hbA7/ww folded on the River
Seat 8: opOCI2p6kW0tINuVaAqmcQ (button) folded before Flop (didn't bet)




PokerStars Game #59939384198:  Hold'em No Limit ($0.10/$0.25) - 2009/07/01 0:38:29 ET
Table 'P1IJQ2p3ACFySC35W1qwQw' 9-max Seat #9 is the button
Seat 2: E0iYnEVO2ho7dH3QcCjw7g ($13.45 in chips) 
Seat 3: Ml2bY77EHbM51ZWD7dnIWg ($11.60 in chips) 
Seat 4: LuckyShot



PokerStars Game #59939384296:  Hold'em No Limit ($0.10/$0.25) - 2009/07/01 0:38:29 ET
Table 'YYMg5qzxK1m9eGRo4SbxtQ' 9-max Seat #3 is the button
Seat 1: DiSvPC2iudwL5j9u6Huyww ($25 in chips) 
Seat 2: uH1RN27w9SKa7TpVR9EFrQ ($13.55 in chips) 
Seat 3: N6fYvIzQLKaydFLKQGtMlQ ($24.05 in chips) 
Seat 4: H8sSXb2KLK0U38tU9YITDw ($11 in chips) 
Seat 5: BEIBUu2pIflPrCL+Iks4CQ ($19.65 in chips) 
Seat 6: gehe91e0IyVT0QU/XBkEyg ($41.95 in chips) 
Seat 7: hPhp/RE3cJ5YGaQ2xOHXXg ($4.30 in chips) 
Seat 8: 18G4P1XstjNvItdGUITxgw ($26.05 in chips) 
Seat 9: +sbyWwIcFp9kP0bDtMegfQ ($37.90 in chips) 
H8sSXb2KLK0U38tU9YITDw: posts small blind $0.10
BEIBUu2pIflPrCL+Iks4CQ: posts big blind $0.25
*** HOLE CARDS ***
gehe91e0IyVT0QU/XBkEyg: folds 
hPhp/RE3cJ5YGaQ2xOHXXg: folds 
18G4P1XstjNvItdGUITxgw: folds 
+sbyWwIcFp9kP0bDtMegfQ: raises $0.75 to $1
DiSvPC2iudwL5j9u6Huyww: folds 
uH1RN27w9SKa7TpVR9EFrQ: raises $2 to $3
N6fYvIzQLKaydFLKQGtMlQ: folds 
H8sSXb2KLK0U38tU9YITDw: folds 
BEIBUu2pIflPrCL+Iks4CQ: folds 
+sbyWwIcFp9kP0bDtMegfQ: folds 
Uncalled bet ($2) returned to uH1RN27w9SKa7TpVR9EFrQ
uH1RN27w9SKa7TpVR9EFrQ collected $2.35 from pot
uH1RN27w9SKa7TpVR9EFrQ: doesn't show hand 
*** SUMMARY ***
Total pot $2.35 | Rake $0 
Seat 1: DiSvPC2iudwL5j9u6Huyww folded before Flop (didn't bet)
Seat 2: uH1RN27w9SKa7TpVR9EFrQ collected ($2.35)
Seat 3: N6fYvIzQLKaydFLKQGtMlQ (button) folded before Flop (didn't bet)
Seat 4: H8sSXb2KLK0U38tU9YITDw (small blind) folded before Flop
Seat 5: BEIBUu2pIflPrCL+Iks4CQ (big blind) folded before Flop
Seat 6: gehe91e0IyVT0QU/XBkEyg folded before Flop (didn't bet)
Seat 7: hPhp/RE3cJ5YGaQ2xOHXXg folded before Flop (didn't bet)
Seat 8: 18G4P1XstjNvItdGUITxgw folded before Flop (didn't bet)
Seat 9: +sbyWwIcFp9kP0bDtMegfQ folded before Flop




PokerStars Game #59939385096:  Hold'em No Limit ($0.10/$0.25) - 2009/07/01 0:38:30 ET
Table 'PCxB2W9H6ma8SwsZlImuOw' 9-max Seat #7 is the button
Seat 1: 5s3p6yoJBNW438dsyKTP8g ($32 in chips) 
Seat 2: wjH6l1gQaEfv+C45sAOwIQ ($32.20 in chips) 
Seat 3: opOCI2p6kW0tINuVaAqmcQ ($29.15 in chips) 
Seat 4: ydoFOVgzvZv9ZhuWu9rXAw ($5 in chips) 
Seat 5: h4ggJZYBXV0mEZzYPYKfeA ($23.95 in chips) 
Seat 6: E2c0EwJuNHUUdumOOgYQYA ($7.30 in chips) 
Seat 7: EfRs3ibIxn+c9JDErwwNCg ($25.10 in chips) 
Seat 8: Hdb9b2QXBH2f6YwkTgMKdQ ($4 in chips) 
Seat 9: LWN1wPrLH+695JIriXxDuw ($10 in chips) 
Hdb9b2QXBH2f6YwkTgMKdQ: posts small blind $0.10
LWN1wPrLH+695JIriXxDuw: posts big blind $0.25
*** HOLE CARDS ***
5s3p6yoJBNW438dsyKTP8g: folds 
wjH6l1gQaEfv+C45sAOwIQ: folds 
opOCI2p6kW0tINuVaAqmcQ: raises $0.50 to $0.75
ydoFOVgzvZv9ZhuWu9rXAw: folds 
h4ggJZYBXV0mEZzYPYKfeA: folds 
E2c0EwJuNHUUdumOOgYQYA: folds 
EfRs3ibIxn+c9JDErwwNCg: folds 
Hdb9b2QXBH2f6YwkTgMKdQ: folds 
LWN1wPrLH+695JIriXxDuw: folds 
Uncalled bet ($0.50) returned to opOCI2p6kW0tINuVaAqmcQ
opOCI2p6kW0tINuVaAqmcQ collected $0.60 from pot
opOCI2p6kW0tINuVaAqmcQ: doesn't show hand 
*** SUMMARY ***
Total pot $0.60 | Rake $0 
Seat 1: 5s3p6yoJBNW438dsyKTP8g folded before Flop (didn't bet)
Seat 2: wjH6l1gQaEfv+C45sAOwIQ folded before Flop (didn't bet)
Seat 3: opOCI2p6kW0tINuVaAqmcQ collected ($0.60)
Seat 4: ydoFOVgzvZv9ZhuWu9rXAw folded before Flop (didn't bet)
Seat 5: h4ggJZYBXV0mEZzYPYKfeA folded before Flop (didn't bet)
Seat 6: E2c0EwJuNHUUdumOOgYQYA folded before Flop (didn't bet)
Seat 7: EfRs3ibIxn+c9JDErwwNCg (button) folded before Flop (didn't bet)
Seat 8: Hdb9b2QXBH2f6YwkTgMKdQ (small blind) folded before Flop
Seat 9: LWN1wPrLH+695JIriXxDuw (big blind) folded before Flop




PokerStars Game #59939384884:  Hold'em No Limit ($0.10/$0.25) - 2009/07/01 0:38:30 ET
Table 'NtCSSONEf1zaJo3042tQug' 6-max Seat #3 is the button
Seat 1: pdS3fOhVgLVaTP0O0GlIvw ($8.30 in chips) 
Seat 2: nbv8IVGAEHbfjk01ulU6ow ($19.20 in chips) 
Seat 3: d0J1xuhsynEY81YHwAvJ5g ($25 in chips) 
Seat 4: dOX4wnYV2sEqvDbF+8KSCw ($25.25 in chips) 
Seat 5: l/t3k8+r77gRew8U2BJs4Q ($5 in chips) 
Seat 6: LxehwDpTQ19ph4Qmc78+Pw ($23.55 in chips) 
dOX4wnYV2sEqvDbF+8KSCw: posts small blind $0.10
l/t3k8+r77gRew8U2BJs4Q: posts big blind $0.25
*** HOLE CARDS ***
LxehwDpTQ19ph4Qmc78+Pw: raises $0.50 to $0.75
pdS3fOhVgLVaTP0O0GlIvw: folds 
nbv8IVGAEHbfjk01ulU6ow: folds 
d0J1xuhsynEY81YHwAvJ5g: folds 
dOX4wnYV2sEqvDbF+8KSCw: folds 
l/t3k8+r77gRew8U2BJs4Q: calls $0.50
*** FLOP *** [2d 2s 6d]
l/t3k8+r77gRew8U2BJs4Q: checks 
LxehwDpTQ19ph4Qmc78+Pw: bets $0.75
l/t3k8+r77gRew8U2BJs4Q: calls $0.75
*** TURN *** [2d 2s 6d] [9s]
l/t3k8+r77gRew8U2BJs4Q: checks 
LxehwDpTQ19ph4Qmc78+Pw: bets $1.50
l/t3k8+r77gRew8U2BJs4Q: folds 
Uncalled bet ($1.50) returned to LxehwDpTQ19ph4Qmc78+Pw
LxehwDpTQ19ph4Qmc78+Pw collected $2.95 from pot
LxehwDpTQ19ph4Qmc78+Pw: doesn't show hand 
*** SUMMARY ***
Total pot $3.10 | Rake $0.15 
Board [2d 2s 6d 9s]
Seat 1: pdS3fOhVgLVaTP0O0GlIvw folded before Flop (didn't bet)
Seat 2: nbv8IVGAEHbfjk01ulU6ow folded before Flop (didn't bet)
Seat 3: d0J1xuhsynEY81YHwAvJ5g (button) folded before Flop (didn't bet)
Seat 4: dOX4wnYV2sEqvDbF+8KSCw (small blind) folded before Flop
Seat 5: l/t3k8+r77gRew8U2BJs4Q (big blind) folded on the Turn
Seat 6: LxehwDpTQ19ph4Qmc78+Pw collected ($2.95)




PokerStars Game #59939384954:  Hold'em No Limit ($0.10/$0.25) - 2009/07/01 0:38:30 ET
Table 'Qr+t8WGovMECkBv+cV1lrg' 6-max Seat #3 is the button
Seat 1: wFKQltIqUcrrkvre6g+fyw ($34.25 in chips) 
Seat 2: i48129QFpEQQ+UN4aNtmww ($5.30 in chips) 
Seat 3: bjJnMpKgoF+vgHW2f1NCsg ($17.20 in chips) 
Seat 4: 3rlIjSrvbZoI2IILbnetnA ($25.50 in chips) 
Seat 5: iwlxXocltgSdaBmusNXanQ ($15 in chips) 
Seat 6: j5NZbEJHsERuXjPHWqc1Nw ($21 in chips) 
3rlIjSrvbZoI2IILbnetnA: posts small blind $0.10
iwlxXocltgSdaBmusNXanQ: posts big blind $0.25
*** HOLE CARDS ***
j5NZbEJHsERuXjPHWqc1Nw: folds 
wFKQltIqUcrrkvre6g+fyw: folds 
i48129QFpEQQ+UN4aNtmww: folds 
bjJnMpKgoF+vgHW2f1NCsg: calls $0.25
3rlIjSrvbZoI2IILbnetnA: folds 
iwlxXocltgSdaBmusNXanQ: checks 
*** FLOP *** [8s 9s 4c]
iwlxXocltgSdaBmusNXanQ: checks 
bjJnMpKgoF+vgHW2f1NCsg: bets $0.75
iwlxXocltgSdaBmusNXanQ: folds 
Uncalled bet ($0.75) returned to bjJnMpKgoF+vgHW2f1NCsg
bjJnMpKgoF+vgHW2f1NCsg collected $0.60 from pot
*** SUMMARY ***
Total pot $0.60 | Rake $0 
Board [8s 9s 4c]
Seat 1: wFKQltIqUcrrkvre6g+fyw folded before Flop (didn't bet)
Seat 2: i48129QFpEQQ+UN4aNtmww folded before Flop (didn't bet)
Seat 3: bjJnMpKgoF+vgHW2f1NCsg (button) collected ($0.60)
Seat 4: 3rlIjSrvbZoI2IILbnetnA (small blind) folded before Flop
Seat 5: iwlxXocltgSdaBmusNXanQ (big blind) folded on the Flop
Seat 6: j5NZbEJHsERuXjPHWqc1Nw folded before Flop (didn't bet)




PokerStars Game #59939385262:  Hold'em No Limit ($0.10/$0.25) - 2009/07/01 0:38:30 ET
Table 'fHv1Mk7ZbLjprZTGWKPiEQ' 6-max Seat #1 is the button
Seat 1: nrBtxp+MnBtUJ1AIhZxHkg ($31.05 in chips) 
Seat 3: HyeBXe7tNOZjTdX/zI0BZQ ($14.50 in chips) 
Seat 4: TSmua8tGK3sTbwi0ynrW9Q ($47 in chips) 
Seat 5: edio/rLJ06xeZOfLhoL3UA ($15 in chips) 
Seat 6: AjG0X+rNtc2W08eph8oqpw ($9.30 in chips) 
HyeBXe7tNOZjTdX/zI0BZQ: posts small blind $0.10
TSmua8tGK3sTbwi0ynrW9Q: posts big blind $0.25
edio/rLJ06xeZOfLhoL3UA: posts big blind $0.25
*** HOLE CARDS ***
edio/rLJ06xeZOfLhoL3UA: raises $1 to $1.25
AjG0X+rNtc2W08eph8oqpw: folds 
nrBtxp+MnBtUJ1AIhZxHkg: folds 
HyeBXe7tNOZjTdX/zI0BZQ: calls $1.15
TSmua8tGK3sTbwi0ynrW9Q: folds 
*** FLOP *** [Qd 7d 9c]
HyeBXe7tNOZjTdX/zI0BZQ: checks 
edio/rLJ06xeZOfLhoL3UA: bets $1.75
HyeBXe7tNOZjTdX/zI0BZQ: raises $1.75 to $3.50
edio/rLJ06xeZOfLhoL3UA: calls $1.75
*** TURN *** [Qd 7d 9c] [4s]
HyeBXe7tNOZjTdX/zI0BZQ: bets $4
GINNAL-RASTA joins the table at seat #2 
edio/rLJ06xeZOfLhoL3UA: raises $6.25 to $10.25 and is all-in
HyeBXe7tNOZjTdX/zI0BZQ: calls $5.75 and is all-in
Uncalled bet ($0.50) returned to edio/rLJ06xeZOfLhoL3UA
*** RIVER *** [Qd 7d 9c 4s] [Ts]
*** SHOW DOWN ***
HyeBXe7tNOZjTdX/zI0BZQ: shows [Qh Ks] (a pair of Queens)
edio/rLJ06xeZOfLhoL3UA: shows [As Ac] (a pair of Aces)
edio/rLJ06xeZOfLhoL3UA collected $27.85 from pot
*** SUMMARY ***
Total pot $29.25 | Rake $1.40 
Board [Qd 7d 9c 4s Ts]
Seat 1: nrBtxp+MnBtUJ1AIhZxHkg (button) folded before Flop (didn't bet)
Seat 3: HyeBXe7tNOZjTdX/zI0BZQ (small blind) showed [Qh Ks] and lost with a pair of Queens
Seat 4: TSmua8tGK3sTbwi0ynrW9Q (big blind) folded before Flop
Seat 5: edio/rLJ06xeZOfLhoL3UA showed [As Ac] and won ($27.85) with a pair of Aces
Seat 6: AjG0X+rNtc2W08eph8oqpw folded before Flop (didn't bet)




PokerStars Game #59939385682:  Hold'em No Limit ($0.10/$0.25) - 2009/07/01 0:38:31 ET
Table 'tq5CvS0RUqGkuBK0XTzqqg' 6-max Seat #5 is the button
Seat 1: 39EF5EcifdyPS7v+EnfxLg ($26.65 in chips) 
Seat 2: mfrkWA3PTeYPkbO6hi98Aw ($57.45 in chips) 
Seat 4: W7FS+h5B+OhmwF+cTt3ZPQ ($14.70 in chips) 
Seat 5: qGHGf/553gQnDoklMRe3tg ($27.90 in chips) 
Seat 6: hOfhw8jxWiq14wXGL4Bh/Q ($14.75 in chips) 
hOfhw8jxWiq14wXGL4Bh/Q: posts small blind $0.10
39EF5EcifdyPS7v+EnfxLg: posts big blind $0.25
PbMzPZIePKifKQZfKDkbIw: sits out 
*** HOLE CARDS ***
mfrkWA3PTeYPkbO6hi98Aw: raises $0.75 to $1
W7FS+h5B+OhmwF+cTt3ZPQ: folds 
qGHGf/553gQnDoklMRe3tg: calls $1
hOfhw8jxWiq14wXGL4Bh/Q: folds 
39EF5EcifdyPS7v+EnfxLg: folds 
*** FLOP *** [2s 5s Qc]
mfrkWA3PTeYPkbO6hi98Aw: bets $1.75
qGHGf/553gQnDoklMRe3tg: calls $1.75
*** TURN *** [2s 5s Qc] [9c]
mfrkWA3PTeYPkbO6hi98Aw: bets $5
qGHGf/553gQnDoklMRe3tg: calls $5
*** RIVER *** [2s 5s Qc 9c] [Ah]
mfrkWA3PTeYPkbO6hi98Aw: bets $10
qGHGf/553gQnDoklMRe3tg: folds 
Uncalled bet ($10) returned to mfrkWA3PTeYPkbO6hi98Aw
mfrkWA3PTeYPkbO6hi98Aw collected $15.10 from pot
mfrkWA3PTeYPkbO6hi98Aw: doesn't show hand 
*** SUMMARY ***
Total pot $15.85 | Rake $0.75 
Board [2s 5s Qc 9c Ah]
Seat 1: 39EF5EcifdyPS7v+EnfxLg (big blind) folded before Flop
Seat 2: mfrkWA3PTeYPkbO6hi98Aw collected ($15.10)
Seat 4: W7FS+h5B+OhmwF+cTt3ZPQ folded before Flop (didn't bet)
Seat 5: qGHGf/553gQnDoklMRe3tg (button) folded on the River
Seat 6: hOfhw8jxWiq14wXGL4Bh/Q (small blind) folded before Flop




PokerStars Game #59939385542:  Hold'em No Limit ($0.10/$0.25) - 2009/07/01 0:38:31 ET
Table 'zJTgUqdWn7ojWWqV4pItEQ' 9-max Seat #7 is the button
Seat 1: CbXUS6Z2rXZxL1AKduNtmQ ($30.45 in chips) 
Seat 2: 7wo6Sr7QG3Zo6BaBDV1BOw ($6.50 in chips) 
Seat 3: 2N94FgK4Y2izKFIB+wJOjw ($18.40 in chips) 
Seat 4: ZeR3hkj1gVv9J4yPCmRrjA ($33.50 in chips) 
Seat 6: cQQdn+v2h6ICJU1fq6mEyA ($24.15 in chips) 
Seat 7: 4oA316mXLIui1QY63GXBUg ($25 in chips) 
Seat 9: DnDcAdn9P0zGovMERigpFA ($25.35 in chips) 
DnDcAdn9P0zGovMERigpFA: posts small blind $0.10
CbXUS6Z2rXZxL1AKduNtmQ: posts big blind $0.25
*** HOLE CARDS ***
7wo6Sr7QG3Zo6BaBDV1BOw: folds 
2N94FgK4Y2izKFIB+wJOjw: calls $0.25
ZeR3hkj1gVv9J4yPCmRrjA: folds 
cQQdn+v2h6ICJU1fq6mEyA: folds 
4oA316mXLIui1QY63GXBUg: folds 
DnDcAdn9P0zGovMERigpFA: folds 
CbXUS6Z2rXZxL1AKduNtmQ: checks 
*** FLOP *** [Ac Kh 6h]
CbXUS6Z2rXZxL1AKduNtmQ: checks 
2N94FgK4Y2izKFIB+wJOjw: checks 
*** TURN *** [Ac Kh 6h] [Qd]
CbXUS6Z2rXZxL1AKduNtmQ: checks 
2N94FgK4Y2izKFIB+wJOjw: bets $0.25
CbXUS6Z2rXZxL1AKduNtmQ: calls $0.25
*** RIVER *** [Ac Kh 6h Qd] [Th]
CbXUS6Z2rXZxL1AKduNtmQ: bets $1
2N94FgK4Y2izKFIB+wJOjw: calls $1
*** SHOW DOWN ***
CbXUS6Z2rXZxL1AKduNtmQ: shows [Jc 3d] (a straight, Ten to Ace)
2N94FgK4Y2izKFIB+wJOjw: shows [Ks Jd] (a straight, Ten to Ace)
CbXUS6Z2rXZxL1AKduNtmQ collected $1.50 from pot
2N94FgK4Y2izKFIB+wJOjw collected $1.45 from pot
murdog71 joins the table at seat #5 
*** SUMMARY ***
Total pot $3.10 | Rake $0.15 
Board [Ac Kh 6h Qd Th]
Seat 1: CbXUS6Z2rXZxL1AKduNtmQ (big blind) showed [Jc 3d] and won ($1.50) with a straight, Ten to Ace
Seat 2: 7wo6Sr7QG3Zo6BaBDV1BOw folded before Flop (didn't bet)
Seat 3: 2N94FgK4Y2izKFIB+wJOjw showed [Ks Jd] and won ($1.45) with a straight, Ten to Ace
Seat 4: ZeR3hkj1gVv9J4yPCmRrjA folded before Flop (didn't bet)
Seat 6: cQQdn+v2h6ICJU1fq6mEyA folded before Flop (didn't bet)
Seat 7: 4oA316mXLIui1QY63GXBUg (button) folded before Flop (didn't bet)
Seat 9: DnDcAdn9P0zGovMERigpFA (small blind) folded before Flop




PokerStars Game #59939385752:  Hold'em No Limit ($0.10/$0.25) - 2009/07/01 0:38:31 ET
Table 'KU/HrxqxwDz8HKEhYTZ6uw' 6-max Seat #6 is the button
Seat 1: gaPMxLGp9SOj4Lq6t+/0Ig ($27.75 in chips) 
Seat 2: kG34n23qFQA3nzdOJTQ1dA ($25 in chips) 
Seat 3: 3seg9SJ1y+HUPN0X0XKF5Q ($12.45 in chips) 
Seat 4: +yxuvzJHyIWsJ515X8zJTQ ($0.30 in chips) 
Seat 5: 4YSTu0Cdzpppe1lUgCZGCQ ($35.45 in chips) 
Seat 6: QIWnfLSqfMcoFfdDe5LZPg ($9.60 in chips) 
gaPMxLGp9SOj4Lq6t+/0Ig: posts small blind $0.10
kG34n23qFQA3nzdOJTQ1dA: posts big blind $0.25
*** HOLE CARDS ***
3seg9SJ1y+HUPN0X0XKF5Q: calls $0.25
+yxuvzJHyIWsJ515X8zJTQ: calls $0.25
4YSTu0Cdzpppe1lUgCZGCQ: folds 
QIWnfLSqfMcoFfdDe5LZPg: calls $0.25
gaPMxLGp9SOj4Lq6t+/0Ig: folds 
kG34n23qFQA3nzdOJTQ1dA: checks 
*** FLOP *** [6s Qh 7c]
kG34n23qFQA3nzdOJTQ1dA: checks 
3seg9SJ1y+HUPN0X0XKF5Q: checks 
+yxuvzJHyIWsJ515X8zJTQ: bets $0.05 and is all-in
QIWnfLSqfMcoFfdDe5LZPg: raises $0.45 to $0.50
kG34n23qFQA3nzdOJTQ1dA: folds 
3seg9SJ1y+HUPN0X0XKF5Q: folds 
Uncalled bet ($0.45) returned to QIWnfLSqfMcoFfdDe5LZPg
*** TURN *** [6s Qh 7c] [3s]
*** RIVER *** [6s Qh 7c 3s] [9s]
*** SHOW DOWN ***
+yxuvzJHyIWsJ515X8zJTQ: shows [4s 5d] (a straight, Three to Seven)
QIWnfLSqfMcoFfdDe5LZPg: mucks hand 
+yxuvzJHyIWsJ515X8zJTQ collected $1.15 from pot
*** SUMMARY ***
Total pot $1.20 | Rake $0.05 
Board [6s Qh 7c 3s 9s]
Seat 1: gaPMxLGp9SOj4Lq6t+/0Ig (small blind) folded before Flop
Seat 2: kG34n23qFQA3nzdOJTQ1dA (big blind) folded on the Flop
Seat 3: 3seg9SJ1y+HUPN0X0XKF5Q folded on the Flop
Seat 4: +yxuvzJHyIWsJ515X8zJTQ showed [4s 5d] and won ($1.15) with a straight, Three to Seven
Seat 5: 4YSTu0Cdzpppe1lUgCZGCQ folded before Flop (didn't bet)
Seat 6: QIWnfLSqfMcoFfdDe5LZPg (button) mucked




PokerStars Game #59939385970:  Hold'em No Limit ($0.10/$0.25) - 2009/07/01 0:38:31 ET
Table '/XCUCUl3yW6tdTJQEhJKGw' 6-max Seat #5 is the button
Seat 1: p8J112JmNRnCwV2+NAEzCA ($15.30 in chips) 
Seat 2: 8ClCHtFXGNplITm+63KB+Q ($27.25 in chips) 
Seat 3: /gJNBeCkWL4o85/jvlZ4BA ($35.60 in chips) 
Seat 4: SFmT9ZsVopnukjvAzrxTRg ($25 in chips) 
Seat 5: 3rlIjSrvbZoI2IILbnetnA ($25.35 in chips) 
Seat 6: armfxZhGxeZVZBYAQFuIJQ ($36.55 in chips) 
armfxZhGxeZVZBYAQFuIJQ: posts small blind $0.10
p8J112JmNRnCwV2+NAEzCA: posts big blind $0.25
*** HOLE CARDS ***
8ClCHtFXGNplITm+63KB+Q: folds 
/gJNBeCkWL4o85/jvlZ4BA: folds 
SFmT9ZsVopnukjvAzrxTRg: folds 
3rlIjSrvbZoI2IILbnetnA: folds 
armfxZhGxeZVZBYAQFuIJQ: folds 
Uncalled bet ($0.15) returned to p8J112JmNRnCwV2+NAEzCA
p8J112JmNRnCwV2+NAEzCA collected $0.20 from pot
p8J112JmNRnCwV2+NAEzCA: doesn't show hand 
*** SUMMARY ***
Total pot $0.20 | Rake $0 
Seat 1: p8J112JmNRnCwV2+NAEzCA (big blind) collected ($0.20)
Seat 2: 8ClCHtFXGNplITm+63KB+Q folded before Flop (didn't bet)
Seat 3: /gJNBeCkWL4o85/jvlZ4BA folded before Flop (didn't bet)
Seat 4: SFmT9ZsVopnukjvAzrxTRg folded before Flop (didn't bet)
Seat 5: 3rlIjSrvbZoI2IILbnetnA (button) folded before Flop (didn't bet)
Seat 6: armfxZhGxeZVZBYAQFuIJQ (small blind) folded before Flop




PokerStars Game #59939385906:  Hold'em No Limit ($0.10/$0.25) - 2009/07/01 0:38:31 ET
Table 'uFgIyfWPagvEVGEb86da7A' 9-max Seat #5 is the button
Seat 2: o3zvoO+PsqGti+1NZGNRrQ ($6.85 in chips) 
Seat 3: q4GZp0xt5Unxtq8PS32SAQ ($35.10 in chips) 
Seat 5: Qi+clOtyDiibLdH2/1Qy8g ($17.30 in chips) 
Seat 6: zDrucyjVn5aeekNEc3cJrA ($23.80 in chips) 
Seat 8: MzxZJee3eU6Q0wg0XTfZew ($10.20 in chips) 
Seat 9: DnDcAdn9P0zGovMERigpFA ($25 in chips) 
zDrucyjVn5aeekNEc3cJrA: posts small blind $0.10
MzxZJee3eU6Q0wg0XTfZew: posts big blind $0.25
5MgYq10OC5iGoxQFwlJVuw: sits out 
o3zvoO+PsqGti+1NZGNRrQ: posts big blind $0.25
*** HOLE CARDS ***
DnDcAdn9P0zGovMERigpFA: folds 
o3zvoO+PsqGti+1NZGNRrQ: checks 
q4GZp0xt5Unxtq8PS32SAQ: raises $0.60 to $0.85
Qi+clOtyDiibLdH2/1Qy8g: folds 
tjhousyomama joins the table at seat #4 
zDrucyjVn5aeekNEc3cJrA: folds 
MzxZJee3eU6Q0wg0XTfZew: folds 
o3zvoO+PsqGti+1NZGNRrQ: folds 
Uncalled bet ($0.60) returned to q4GZp0xt5Unxtq8PS32SAQ
q4GZp0xt5Unxtq8PS32SAQ collected $0.85 from pot
q4GZp0xt5Unxtq8PS32SAQ: doesn't show hand 
*** SUMMARY ***
Total pot $0.85 | Rake $0 
Seat 2: o3zvoO+PsqGti+1NZGNRrQ folded before Flop
Seat 3: q4GZp0xt5Unxtq8PS32SAQ collected ($0.85)
Seat 5: Qi+clOtyDiibLdH2/1Qy8g (button) folded before Flop (didn't bet)
Seat 6: zDrucyjVn5aeekNEc3cJrA (small blind) folded before Flop
Seat 8: MzxZJee3eU6Q0wg0XTfZew (big blind) folded before Flop
Seat 9: DnDcAdn9P0zGovMERigpFA folded before Flop (didn't bet)




PokerStars Game #59939385902:  Hold'em No Limit ($0.10/$0.25) - 2009/07/01 0:38:31 ET
Table 'djcjiEGabFQO0MNG6jEeJQ' 9-max Seat #8 is the button
Seat 1: K7bAhhMMJ/XcTmGaBZVfFQ ($23.80 in chips) 
Seat 2: 1K6QGyJP9P9xmRac2fH4OQ ($26.60 in chips) 
Seat 3: 1S/fpm+f42V/6MNZre+ccg ($27.35 in chips) 
Seat 4: Z7GF1yA2ZTKm8gR4H8XDhg ($15.80 in chips) 
Seat 5: cZ99hugmLBj9KhTlc8nCSw ($37.15 in chips) 
Seat 6: aNpwfA31EREwO+ar4XzBCw ($59.55 in chips) 
Seat 7: 56S3mA6Zs3pGR+0p0vUCtg ($30.45 in chips) 
Seat 8: +sbyWwIcFp9kP0bDtMegfQ ($45.35 in chips) 
Seat 9: HPEB+AtKw1+C/cxU0o1ciw ($47.75 in chips) 
HPEB+AtKw1+C/cxU0o1ciw: posts small blind $0.10
K7bAhhMMJ/XcTmGaBZVfFQ: posts big blind $0.25
*** HOLE CARDS ***
1K6QGyJP9P9xmRac2fH4OQ: folds 
1S/fpm+f42V/6MNZre+ccg: folds 
Z7GF1yA2ZTKm8gR4H8XDhg: folds 
cZ99hugmLBj9KhTlc8nCSw: folds 
aNpwfA31EREwO+ar4XzBCw: folds 
56S3mA6Zs3pGR+0p0vUCtg: folds 
+sbyWwIcFp9kP0bDtMegfQ: folds 
HPEB+AtKw1+C/cxU0o1ciw: folds 
Uncalled bet ($0.15) returned to K7bAhhMMJ/XcTmGaBZVfFQ
K7bAhhMMJ/XcTmGaBZVfFQ collected $0.20 from pot
K7bAhhMMJ/XcTmGaBZVfFQ: doesn't show hand 
*** SUMMARY ***
Total pot $0.20 | Rake $0 
Seat 1: K7bAhhMMJ/XcTmGaBZVfFQ (big blind) collected ($0.20)
Seat 2: 1K6QGyJP9P9xmRac2fH4OQ folded before Flop (didn't bet)
Seat 3: 1S/fpm+f42V/6MNZre+ccg folded before Flop (didn't bet)
Seat 4: Z7GF1yA2ZTKm8gR4H8XDhg folded before Flop (didn't bet)
Seat 5: cZ99hugmLBj9KhTlc8nCSw folded before Flop (didn't bet)
Seat 6: aNpwfA31EREwO+ar4XzBCw folded before Flop (didn't bet)
Seat 7: 56S3mA6Zs3pGR+0p0vUCtg folded before Flop (didn't bet)
Seat 8: +sbyWwIcFp9kP0bDtMegfQ (button) folded before Flop (didn't bet)
Seat 9: HPEB+AtKw1+C/cxU0o1ciw (small blind) folded before Flop




PokerStars Game #59939385924:  Hold'em No Limit ($0.10/$0.25) - 2009/07/01 0:38:31 ET
Table 'g6ryG70feTw9nNm+XJLuXw' 6-max Seat #5 is the button
Seat 1: v+QfkGiuj9bgtuNoVnDO8w ($29.05 in chips) 
Seat 2: SxIIgwXYLkwd6m3wLyPTCw ($25.60 in chips) 
Seat 4: GC/9yVD59DUCX7hUI7gcLw ($37.10 in chips) 
Seat 5: EE16Ua5b1HSsYej5zeXOlA ($25.25 in chips) 
v+QfkGiuj9bgtuNoVnDO8w: posts small blind $0.10
SxIIgwXYLkwd6m3wLyPTCw: posts big blind $0.25
*** HOLE CARDS ***
GC/9yVD59DUCX7hUI7gcLw: folds 
EE16Ua5b1HSsYej5zeXOlA: raises $0.50 to $0.75
v+QfkGiuj9bgtuNoVnDO8w: folds 
/6h8PvAHQmfuMUZ8OUF6Xw joins the table at seat #3 
SxIIgwXYLkwd6m3wLyPTCw: folds 
Uncalled bet ($0.50) returned to EE16Ua5b1HSsYej5zeXOlA
EE16Ua5b1HSsYej5zeXOlA collected $0.60 from pot
EE16Ua5b1HSsYej5zeXOlA: doesn't show hand 
*** SUMMARY ***
Total pot $0.60 | Rake $0 
Seat 1: v+QfkGiuj9bgtuNoVnDO8w (small blind) folded before Flop
Seat 2: SxIIgwXYLkwd6m3wLyPTCw (big blind) folded before Flop
Seat 4: GC/9yVD59DUCX7hUI7gcLw folded before Flop (didn't bet)
Seat 5: EE16Ua5b1HSsYej5zeXOlA (button) collected ($0.60)




PokerStars Game #59939386402:  Hold'em No Limit ($0.10/$0.25) - 2009/07/01 0:38:32 ET
Table 'CM/C/FZf3VHIp50RjmBucQ' 9-max Seat #4 is the button
Seat 1: 1Clf3cPrqoy/YgvWdWK1Xw ($5 in chips) 
Seat 2: 1S/fpm+f42V/6MNZre+ccg ($28.10 in chips) 
Seat 3: dfNim92Z6XK1/h5SFW5vDg ($29.40 in chips) 
Seat 4: oXv2YWrxjhmEfQAgUx964Q ($23.55 in chips) 
Seat 5: TeWJxSETzbXGiYKx0y+dtg ($36.90 in chips) 
Seat 6: 4awUyiDYTgylQKXZ9faBVA ($29.80 in chips) 
Seat 7: QBNV6v6f+1ZHoaKcQDTWog ($28.55 in chips) 
Seat 8: cZ99hugmLBj9KhTlc8nCSw ($26.40 in chips) 
Seat 9: Yv4fucyyT28mjx8V5lxKJg ($21.50 in chips) 
TeWJxSETzbXGiYKx0y+dtg: posts small blind $0.10
4awUyiDYTgylQKXZ9faBVA: posts big blind $0.25
*** HOLE CARDS ***
QBNV6v6f+1ZHoaKcQDTWog: folds 
cZ99hugmLBj9KhTlc8nCSw: raises $0.50 to $0.75
Yv4fucyyT28mjx8V5lxKJg: folds 
1Clf3cPrqoy/YgvWdWK1Xw: folds 
1S/fpm+f42V/6MNZre+ccg: folds 
dfNim92Z6XK1/h5SFW5vDg: folds 
oXv2YWrxjhmEfQAgUx964Q: folds 
TeWJxSETzbXGiYKx0y+dtg: folds 
4awUyiDYTgylQKXZ9faBVA: folds 
Uncalled bet ($0.50) returned to cZ99hugmLBj9KhTlc8nCSw
cZ99hugmLBj9KhTlc8nCSw collected $0.60 from pot
cZ99hugmLBj9KhTlc8nCSw: doesn't show hand 
*** SUMMARY ***
Total pot $0.60 | Rake $0 
Seat 1: 1Clf3cPrqoy/YgvWdWK1Xw folded before Flop (didn't bet)
Seat 2: 1S/fpm+f42V/6MNZre+ccg folded before Flop (didn't bet)
Seat 3: dfNim92Z6XK1/h5SFW5vDg folded before Flop (didn't bet)
Seat 4: oXv2YWrxjhmEfQAgUx964Q (button) folded before Flop (didn't bet)
Seat 5: TeWJxSETzbXGiYKx0y+dtg (small blind) folded before Flop
Seat 6: 4awUyiDYTgylQKXZ9faBVA (big blind) folded before Flop
Seat 7: QBNV6v6f+1ZHoaKcQDTWog folded before Flop (didn't bet)
Seat 8: cZ99hugmLBj9KhTlc8nCSw collected ($0.60)
Seat 9: Yv4fucyyT28mjx8V5lxKJg folded before Flop (didn't bet)




PokerStars Game #59939386136:  Hold'em No Limit ($0.10/$0.25) - 2009/07/01 0:38:32 ET
Table 'KKk6y4pAXeymxYcd0uZLqg' 9-max Seat #8 is the button
Seat 1: HPEB+AtKw1+C/cxU0o1ciw ($24.90 in chips) 
Seat 2: H9KUl8cmpLgEpOVDA00bCg ($6.95 in chips) 
Seat 3: 4oA316mXLIui1QY63GXBUg ($25 in chips) 
Seat 4: GTcLfsDTPqgfHyhY9FNDMw ($14.45 in chips) 
Seat 5: U0VVxBdRWdhRNdbJ+Qky1A ($46.10 in chips) 
Seat 6: LWN1wPrLH+695JIriXxDuw ($11.85 in chips) 
Seat 7: R3KkgiqTvuhazyCqaD9cZg ($10 in chips) 
Seat 8: +2kMBNpY4nF1qNCRd8SJLA ($25.50 in chips) 
Seat 9: j4q3p0lesp63b1gZDwLBZw ($5 in chips) 
j4q3p0lesp63b1gZDwLBZw: posts small blind $0.10
HPEB+AtKw1+C/cxU0o1ciw: posts big blind $0.25
*** HOLE CARDS ***
H9KUl8cmpLgEpOVDA00bCg: folds 
4oA316mXLIui1QY63GXBUg: folds 
H9KUl8cmpLgEpOVDA00bCg leaves the table
GTcLfsDTPqgfHyhY9FNDMw: folds 
U0VVxBdRWdhRNdbJ+Qky1A: folds 
LWN1wPrLH+695JIriXxDuw: calls $0.25
R3KkgiqTvuhazyCqaD9cZg: folds 
+2kMBNpY4nF1qNCRd8SJLA: raises $1 to $1.25
j4q3p0lesp63b1gZDwLBZw: folds 
HPEB+AtKw1+C/cxU0o1ciw: folds 
LWN1wPrLH+695JIriXxDuw: folds 
Uncalled bet ($1) returned to +2kMBNpY4nF1qNCRd8SJLA
+2kMBNpY4nF1qNCRd8SJLA collected $0.85 from pot
+2kMBNpY4nF1qNCRd8SJLA: doesn't show hand 
*** SUMMARY ***
Total pot $0.85 | Rake $0 
Seat 1: HPEB+AtKw1+C/cxU0o1ciw (big blind) folded before Flop
Seat 2: H9KUl8cmpLgEpOVDA00bCg folded before Flop (didn't bet)
Seat 3: 4oA316mXLIui1QY63GXBUg folded before Flop (didn't bet)
Seat 4: GTcLfsDTPqgfHyhY9FNDMw folded before Flop (didn't bet)
Seat 5: U0VVxBdRWdhRNdbJ+Qky1A folded before Flop (didn't bet)
Seat 6: LWN1wPrLH+695JIriXxDuw folded before Flop
Seat 7: R3KkgiqTvuhazyCqaD9cZg folded before Flop (didn't bet)
Seat 8: +2kMBNpY4nF1qNCRd8SJLA (button) collected ($0.85)
Seat 9: j4q3p0lesp63b1gZDwLBZw (small blind) folded before Flop




PokerStars Game #59939386470:  Hold'em No Limit ($0.10/$0.25) - 2009/07/01 0:38:32 ET
Table 'FE/j6VqBY4j9Uq+VHURQCQ' 6-max Seat #3 is the button
Seat 1: wKFJ513ucluNNiMlkXcDOQ ($44.10 in chips) 
Seat 2: gh0Jkra5bJ5RFIDWbx9zqA ($12.60 in chips) 
Seat 3: Zijzy/UtPWzWVUo81HHVjQ ($49.75 in chips) 
Seat 4: cPO/1/dTcZpLkQFm3jH3Rg ($25.10 in chips) 
Seat 5: wsP46AGpqDjHZQmlRHKa9g ($25 in chips) 
Seat 6: kARKwAmU6kWJfiSICTYhVw ($14.35 in chips) 
cPO/1/dTcZpLkQFm3jH3Rg: posts small blind $0.10
wsP46AGpqDjHZQmlRHKa9g: posts big blind $0.25
*** HOLE CARDS ***
kARKwAmU6kWJfiSICTYhVw: folds 
wKFJ513ucluNNiMlkXcDOQ: folds 
gh0Jkra5bJ5RFIDWbx9zqA: folds 
Zijzy/UtPWzWVUo81HHVjQ: folds 
cPO/1/dTcZpLkQFm3jH3Rg: folds 
Uncalled bet ($0.15) returned to wsP46AGpqDjHZQmlRHKa9g
wsP46AGpqDjHZQmlRHKa9g collected $0.20 from pot
*** SUMMARY ***
Total pot $0.20 | Rake $0 
Seat 1: wKFJ513ucluNNiMlkXcDOQ folded before Flop (didn't bet)
Seat 2: gh0Jkra5bJ5RFIDWbx9zqA folded before Flop (didn't bet)
Seat 3: Zijzy/UtPWzWVUo81HHVjQ (button) folded before Flop (didn't bet)
Seat 4: cPO/1/dTcZpLkQFm3jH3Rg (small blind) folded before Flop
Seat 5: wsP46AGpqDjHZQmlRHKa9g (big blind) collected ($0.20)
Seat 6: kARKwAmU6kWJfiSICTYhVw folded before Flop (didn't bet)




PokerStars Game #59939386354:  Hold'em No Limit ($0.10/$0.25) - 2009/07/01 0:38:32 ET
Table 'APEHQjIcZHDZUA4iOjju2g' 6-max Seat #4 is the button
Seat 1: eHsmIvAb2JREg4O6hNPnXg ($8.60 in chips) 
Seat 2: 3zD3qLXT1bEffAoWGnc7wg ($25 in chips) 
Seat 3: E7KSkgfIsmIsp0vLnmGFmA ($16.25 in chips) 
Seat 4: EqXTTLKUlDlz7yi6ziyyWA ($32.25 in chips) 
Seat 5: /xN6gc9+8Hew0HxaB6VIVg ($31.85 in chips) 
Seat 6: y7HCJfEmolBCFdi/0j5TRg ($45.05 in chips) 
/xN6gc9+8Hew0HxaB6VIVg: posts small blind $0.10
y7HCJfEmolBCFdi/0j5TRg: posts big blind $0.25
E7KSkgfIsmIsp0vLnmGFmA: posts small & big blinds $0.35
*** HOLE CARDS ***
eHsmIvAb2JREg4O6hNPnXg: calls $0.25
3zD3qLXT1bEffAoWGnc7wg: folds 
E7KSkgfIsmIsp0vLnmGFmA: raises $0.25 to $0.50
EqXTTLKUlDlz7yi6ziyyWA: raises $2.25 to $2.75
/xN6gc9+8Hew0HxaB6VIVg: folds 
y7HCJfEmolBCFdi/0j5TRg: folds 
eHsmIvAb2JREg4O6hNPnXg: folds 
E7KSkgfIsmIsp0vLnmGFmA: calls $2.25
*** FLOP *** [3c 5h 4h]
E7KSkgfIsmIsp0vLnmGFmA: checks 
EqXTTLKUlDlz7yi6ziyyWA: bets $5.75
E7KSkgfIsmIsp0vLnmGFmA: folds 
Uncalled bet ($5.75) returned to EqXTTLKUlDlz7yi6ziyyWA
EqXTTLKUlDlz7yi6ziyyWA collected $5.90 from pot
EqXTTLKUlDlz7yi6ziyyWA: doesn't show hand 
*** SUMMARY ***
Total pot $6.20 | Rake $0.30 
Board [3c 5h 4h]
Seat 1: eHsmIvAb2JREg4O6hNPnXg folded before Flop
Seat 2: 3zD3qLXT1bEffAoWGnc7wg folded before Flop (didn't bet)
Seat 3: E7KSkgfIsmIsp0vLnmGFmA folded on the Flop
Seat 4: EqXTTLKUlDlz7yi6ziyyWA (button) collected ($5.90)
Seat 5: /xN6gc9+8Hew0HxaB6VIVg (small blind) folded before Flop
Seat 6: y7HCJfEmolBCFdi/0j5TRg (big blind) folded before Flop




PokerStars Game #59939386344:  Hold'em No Limit ($0.10/$0.25) - 2009/07/01 0:38:32 ET
Table 'fIrOIN3HoXM27ZpRwKa6oA' 6-max Seat #2 is the button
Seat 1: I1TxPvWj8NfG8orglCinNA ($38.85 in chips) 
Seat 2: 5tB0F9NjPSUL4FzmzBMs2Q ($35.80 in chips) 
Seat 3: OElpcjPk5wP6xlAUngsAmg ($5.50 in chips) 
Seat 4: PEUgcMc+CzvN+vLwu5DsLQ ($1.60 in chips) 
Seat 5: 8ClCHtFXGNplITm+63KB+Q ($27.15 in chips) 
Seat 6: v+QfkGiuj9bgtuNoVnDO8w ($30.05 in chips) 
OElpcjPk5wP6xlAUngsAmg: posts small blind $0.10
PEUgcMc+CzvN+vLwu5DsLQ: posts big blind $0.25
*** HOLE CARDS ***
8ClCHtFXGNplITm+63KB+Q: folds 
v+QfkGiuj9bgtuNoVnDO8w: folds 
I1TxPvWj8NfG8orglCinNA: folds 
5tB0F9NjPSUL4FzmzBMs2Q: folds 
OElpcjPk5wP6xlAUngsAmg: calls $0.15
PEUgcMc+CzvN+vLwu5DsLQ: checks 
*** FLOP *** [9c 8s 5d]
OElpcjPk5wP6xlAUngsAmg: checks 
PEUgcMc+CzvN+vLwu5DsLQ: bets $1.35 and is all-in
OElpcjPk5wP6xlAUngsAmg: calls $1.35
*** TURN *** [9c 8s 5d] [9s]
*** RIVER *** [9c 8s 5d 9s] [Jh]
*** SHOW DOWN ***
OElpcjPk5wP6xlAUngsAmg: shows [Kh Kc] (two pair, Kings and Nines)
PEUgcMc+CzvN+vLwu5DsLQ: shows [9h 3d] (three of a kind, Nines)
PEUgcMc+CzvN+vLwu5DsLQ collected $3.05 from pot
*** SUMMARY ***
Total pot $3.20 | Rake $0.15 
Board [9c 8s 5d 9s Jh]
Seat 1: I1TxPvWj8NfG8orglCinNA folded before Flop (didn't bet)
Seat 2: 5tB0F9NjPSUL4FzmzBMs2Q (button) folded before Flop (didn't bet)
Seat 3: OElpcjPk5wP6xlAUngsAmg (small blind) showed [Kh Kc] and lost with two pair, Kings and Nines
Seat 4: PEUgcMc+CzvN+vLwu5DsLQ (big blind) showed [9h 3d] and won ($3.05) with three of a kind, Nines
Seat 5: 8ClCHtFXGNplITm+63KB+Q folded before Flop (didn't bet)
Seat 6: v+QfkGiuj9bgtuNoVnDO8w folded before Flop (didn't bet)




PokerStars Game #59939386530:  Hold'em No Limit ($0.10/$0.25) - 2009/07/01 0:38:32 ET
Table 'by7aHYEDnDd144EXOXa/jA' 9-max Seat #2 is the button
Seat 1: zU1DfKpyUFgAuyEO9JqLHg ($8.85 in chips) 
Seat 2: vSkQm2EelzwRGDDQQk0Fqw ($4.90 in chips) 
Seat 3: 1Clf3cPrqoy/YgvWdWK1Xw ($5.65 in chips) 
Seat 4: vZGoOTJLQLhkPj4I+LNGig ($47.90 in chips) 
Seat 6: DIBbjEYGs+TVdVgEB/4+3w ($22.45 in chips) 
Seat 7: tWA6Uowb3ysfJYO6d8AUqw ($10.40 in chips) 
Seat 8: s7Q6uNouhe7aE8JdFb9E+A ($25.60 in chips) 
1Clf3cPrqoy/YgvWdWK1Xw: posts small blind $0.10
vZGoOTJLQLhkPj4I+LNGig: posts big blind $0.25
yyG4svzOpC1A+sUP/scg6w: sits out 
*** HOLE CARDS ***
DIBbjEYGs+TVdVgEB/4+3w: calls $0.25
tWA6Uowb3ysfJYO6d8AUqw: folds 
s7Q6uNouhe7aE8JdFb9E+A: folds 
zU1DfKpyUFgAuyEO9JqLHg: folds 
vSkQm2EelzwRGDDQQk0Fqw: folds 
1Clf3cPrqoy/YgvWdWK1Xw: folds 
vZGoOTJLQLhkPj4I+LNGig: checks 
*** FLOP *** [8s Tc 4c]
vZGoOTJLQLhkPj4I+LNGig: checks 
DIBbjEYGs+TVdVgEB/4+3w: bets $0.50
vZGoOTJLQLhkPj4I+LNGig: calls $0.50
*** TURN *** [8s Tc 4c] [8c]
vZGoOTJLQLhkPj4I+LNGig: checks 
DIBbjEYGs+TVdVgEB/4+3w: bets $1
vZGoOTJLQLhkPj4I+LNGig: folds 
Uncalled bet ($1) returned to DIBbjEYGs+TVdVgEB/4+3w
DIBbjEYGs+TVdVgEB/4+3w collected $1.55 from pot
*** SUMMARY ***
Total pot $1.60 | Rake $0.05 
Board [8s Tc 4c 8c]
Seat 1: zU1DfKpyUFgAuyEO9JqLHg folded before Flop (didn't bet)
Seat 2: vSkQm2EelzwRGDDQQk0Fqw (button) folded before Flop (didn't bet)
Seat 3: 1Clf3cPrqoy/YgvWdWK1Xw (small blind) folded before Flop
Seat 4: vZGoOTJLQLhkPj4I+LNGig (big blind) folded on the Turn
Seat 6: DIBbjEYGs+TVdVgEB/4+3w collected ($1.55)
Seat 7: tWA6Uowb3ysfJYO6d8AUqw folded before Flop (didn't bet)
Seat 8: s7Q6uNouhe7aE8JdFb9E+A folded before Flop (didn't bet)




PokerStars Game #59939386140:  Hold'em No Limit ($0.10/$0.25) - 2009/07/01 0:38:32 ET
Table 'IUwZ/e0bDHZPgsIWx0RnNg' 6-max Seat #5 is the button
Seat 2: mvFHK3pE7tCxJEqLjKC70Q ($24.65 in chips) 
Seat 3: dOX4wnYV2sEqvDbF+8KSCw ($29.90 in chips) 
Seat 4: IyZ9SVxKy7TJvRGFneWTMg ($27.75 in chips) 
Seat 5: wsP46AGpqDjHZQmlRHKa9g ($26.25 in chips) 
Seat 6: NhUN/JpAprdJeamFBgJH1w ($25 in chips) 
NhUN/JpAprdJeamFBgJH1w: posts small blind $0.10
mvFHK3pE7tCxJEqLjKC70Q: posts big blind $0.25
*** HOLE CARDS ***
dOX4wnYV2sEqvDbF+8KSCw: folds 
IyZ9SVxKy7TJvRGFneWTMg: calls $0.25
wsP46AGpqDjHZQmlRHKa9g: raises $1 to $1.25
NhUN/JpAprdJeamFBgJH1w: folds 
mvFHK3pE7tCxJEqLjKC70Q: folds 
IyZ9SVxKy7TJvRGFneWTMg: calls $1
*** FLOP *** [Tc 4s 3h]
IyZ9SVxKy7TJvRGFneWTMg: checks 
TriplePickle joins the table at seat #1 
wsP46AGpqDjHZQmlRHKa9g: checks 
*** TURN *** [Tc 4s 3h] [Js]
IyZ9SVxKy7TJvRGFneWTMg: checks 
wsP46AGpqDjHZQmlRHKa9g: bets $1.25
IyZ9SVxKy7TJvRGFneWTMg: calls $1.25
*** RIVER *** [Tc 4s 3h Js] [6h]
IyZ9SVxKy7TJvRGFneWTMg: checks 
wsP46AGpqDjHZQmlRHKa9g: checks 
*** SHOW DOWN ***
IyZ9SVxKy7TJvRGFneWTMg: shows [8s Ts] (a pair of Tens)
wsP46AGpqDjHZQmlRHKa9g: mucks hand 
IyZ9SVxKy7TJvRGFneWTMg collected $5.10 from pot
*** SUMMARY ***
Total pot $5.35 | Rake $0.25 
Board [Tc 4s 3h Js 6h]
Seat 2: mvFHK3pE7tCxJEqLjKC70Q (big blind) folded before Flop
Seat 3: dOX4wnYV2sEqvDbF+8KSCw folded before Flop (didn't bet)
Seat 4: IyZ9SVxKy7TJvRGFneWTMg showed [8s Ts] and won ($5.10) with a pair of Tens
Seat 5: wsP46AGpqDjHZQmlRHKa9g (button) mucked
Seat 6: NhUN/JpAprdJeamFBgJH1w (small blind) folded before Flop




PokerStars Game #59939386032:  Hold'em No Limit ($0.10/$0.25) - 2009/07/01 0:38:32 ET
Table 'KEoOIegxPF91KooL2AelUA' 6-max Seat #1 is the button
Seat 1: wsP46AGpqDjHZQmlRHKa9g ($26.90 in chips) 
Seat 4: Vv37Oa9niKKVcR6Z7ceetw ($22.20 in chips) 
Seat 5: 2NLC44AHHKHEUooUQFYV+Q ($16 in chips) 
Vv37Oa9niKKVcR6Z7ceetw: posts small blind $0.10
2NLC44AHHKHEUooUQFYV+Q: posts big blind $0.25
*** HOLE CARDS ***
wsP46AGpqDjHZQmlRHKa9g: folds 
Vv37Oa9niKKVcR6Z7ceetw said, "yeah QQ or similar"
Vv37Oa9niKKVcR6Z7ceetw: raises $0.50 to $0.75
2NLC44AHHKHEUooUQFYV+Q: folds 
Uncalled bet ($0.50) returned to Vv37Oa9niKKVcR6Z7ceetw
Vv37Oa9niKKVcR6Z7ceetw collected $0.50 from pot
Vv37Oa9niKKVcR6Z7ceetw: doesn't show hand 
*** SUMMARY ***
Total pot $0.50 | Rake $0 
Seat 1: wsP46AGpqDjHZQmlRHKa9g (button) folded before Flop (didn't bet)
Seat 4: Vv37Oa9niKKVcR6Z7ceetw (small blind) collected ($0.50)
Seat 5: 2NLC44AHHKHEUooUQFYV+Q (big blind) folded before Flop




PokerStars Game #59939386732:  Hold'em No Limit ($0.10/$0.25) - 2009/07/01 0:38:33 ET
Table 'eOXPe2c6mG7DOFKvMsZZfA' 6-max Seat #5 is the button
Seat 1: ShXPHWfjhfmAwLgDdm6bRQ ($8 in chips) 
Seat 2: ELW+DKizJhLK7k40PMkD2Q ($33.10 in chips) 
Seat 3: kReyZ6g6Fu3tQ0nyjDf9kA ($14.55 in chips) 
Seat 4: zHHLkD2sRljslKKeQv/ZQw ($43.05 in chips) 
Seat 5: NhUN/JpAprdJeamFBgJH1w ($25 in chips) 
Seat 6: wKFJ513ucluNNiMlkXcDOQ ($41.65 in chips) 
wKFJ513ucluNNiMlkXcDOQ: posts small blind $0.10
ShXPHWfjhfmAwLgDdm6bRQ: posts big blind $0.25
zHHLkD2sRljslKKeQv/ZQw: posts small & big blinds $0.35
*** HOLE CARDS ***
ELW+DKizJhLK7k40PMkD2Q: folds 
kReyZ6g6Fu3tQ0nyjDf9kA: folds 
zHHLkD2sRljslKKeQv/ZQw: checks 
NhUN/JpAprdJeamFBgJH1w: folds 
wKFJ513ucluNNiMlkXcDOQ: folds 
ShXPHWfjhfmAwLgDdm6bRQ: checks 
*** FLOP *** [3c Kd 3s]
ShXPHWfjhfmAwLgDdm6bRQ: checks 
zHHLkD2sRljslKKeQv/ZQw: bets $1
ShXPHWfjhfmAwLgDdm6bRQ: folds 
Uncalled bet ($1) returned to zHHLkD2sRljslKKeQv/ZQw
zHHLkD2sRljslKKeQv/ZQw collected $0.70 from pot
*** SUMMARY ***
Total pot $0.70 | Rake $0 
Board [3c Kd 3s]
Seat 1: ShXPHWfjhfmAwLgDdm6bRQ (big blind) folded on the Flop
Seat 2: ELW+DKizJhLK7k40PMkD2Q folded before Flop (didn't bet)
Seat 3: kReyZ6g6Fu3tQ0nyjDf9kA folded before Flop (didn't bet)
Seat 4: zHHLkD2sRljslKKeQv/ZQw collected ($0.70)
Seat 5: NhUN/JpAprdJeamFBgJH1w (button) folded before Flop (didn't bet)
Seat 6: wKFJ513ucluNNiMlkXcDOQ (small blind) folded before Flop




PokerStars Game #59939386984:  Hold'em No Limit ($0.10/$0.25) - 2009/07/01 0:38:33 ET
Table 'Utmw+yX+E/wdhNDIim90lQ' 9-max Seat #2 is the button
Seat 1: lwlnPm68QGGI/+pnAd4GAw ($50.25 in chips) 
Seat 2: iGMlK+EhUflPB6jKQd95Cg ($25.20 in chips) 
Seat 3: dfNim92Z6XK1/h5SFW5vDg ($25 in chips) 
Seat 4: ifYGvZDHQQ0aam4awTtHwA ($15.20 in chips) 
Seat 5: H9KUl8cmpLgEpOVDA00bCg ($4.30 in chips) 
Seat 6: /67o0BjW8sY1ZxYt7/6StQ ($13.60 in chips) 
Seat 7: CImUHesK+ZER4v/VCA9IUg ($64.80 in chips) 
Seat 8: DdPXdieucQ+n99u1n3A+rQ ($4.90 in chips) 
Seat 9: Th3FldXKQW6hWVVPahaoOQ ($27.50 in chips) 
dfNim92Z6XK1/h5SFW5vDg: posts small blind $0.10
ifYGvZDHQQ0aam4awTtHwA: posts big blind $0.25
*** HOLE CARDS ***
H9KUl8cmpLgEpOVDA00bCg: folds 
/67o0BjW8sY1ZxYt7/6StQ: folds 
CImUHesK+ZER4v/VCA9IUg: folds 
DdPXdieucQ+n99u1n3A+rQ: folds 
Th3FldXKQW6hWVVPahaoOQ: folds 
lwlnPm68QGGI/+pnAd4GAw: raises $1.25 to $1.50
iGMlK+EhUflPB6jKQd95Cg: folds 
dfNim92Z6XK1/h5SFW5vDg: folds 
ifYGvZDHQQ0aam4awTtHwA: calls $1.25
*** FLOP *** [3c 2h 9s]
ifYGvZDHQQ0aam4awTtHwA: bets $1
lwlnPm68QGGI/+pnAd4GAw: raises $3 to $4
ifYGvZDHQQ0aam4awTtHwA: calls $3
*** TURN *** [3c 2h 9s] [Kh]
ifYGvZDHQQ0aam4awTtHwA: bets $1.75
lwlnPm68QGGI/+pnAd4GAw: calls $1.75
*** RIVER *** [3c 2h 9s Kh] [3s]
ifYGvZDHQQ0aam4awTtHwA: bets $3.50
lwlnPm68QGGI/+pnAd4GAw: calls $3.50
*** SHOW DOWN ***
ifYGvZDHQQ0aam4awTtHwA: shows [Qd Js] (a pair of Threes)
lwlnPm68QGGI/+pnAd4GAw: shows [Jh Jd] (two pair, Jacks and Threes)
lwlnPm68QGGI/+pnAd4GAw collected $20.60 from pot
*** SUMMARY ***
Total pot $21.60 | Rake $1 
Board [3c 2h 9s Kh 3s]
Seat 1: lwlnPm68QGGI/+pnAd4GAw showed [Jh Jd] and won ($20.60) with two pair, Jacks and Threes
Seat 2: iGMlK+EhUflPB6jKQd95Cg (button) folded before Flop (didn't bet)
Seat 3: dfNim92Z6XK1/h5SFW5vDg (small blind) folded before Flop
Seat 4: ifYGvZDHQQ0aam4awTtHwA (big blind) showed [Qd Js] and lost with a pair of Threes
Seat 5: H9KUl8cmpLgEpOVDA00bCg folded before Flop (didn't bet)
Seat 6: /67o0BjW8sY1ZxYt7/6StQ folded before Flop (didn't bet)
Seat 7: CImUHesK+ZER4v/VCA9IUg folded before Flop (didn't bet)
Seat 8: DdPXdieucQ+n99u1n3A+rQ folded before Flop (didn't bet)
Seat 9: Th3FldXKQW6hWVVPahaoOQ folded before Flop (didn't bet)




PokerStars Game #59939386888:  Hold'em No Limit ($0.10/$0.25) - 2009/07/01 0:38:33 ET
Table 'rO1I30HnuCPB0M8qEX1TCQ' 9-max Seat #1 is the button
Seat 1: P32tOtZSz+L5ekobAPq2DA ($4.10 in chips) 
Seat 2: 33y9+GmQ3J84RvZXcraRTw ($21.30 in chips) 
Seat 3: 8Waresd9ixnijISc3GUypg ($14.20 in chips) 
Seat 4: spidnpwmoJ1L6yeNW7D5UA ($24 in chips) 
Seat 5: HVKi9hnDyvzObpL08/OarQ ($24.75 in chips) 
Seat 6: 6LFELL8V3NTpb0xg7AOyEg ($16.35 in chips) 
Seat 7: 4oA316mXLIui1QY63GXBUg ($30.75 in chips) 
Seat 8: DIBbjEYGs+TVdVgEB/4+3w ($37 in chips) 
Seat 9: PrviAnKmKklf+We6cR33cw ($30.75 in chips) 
33y9+GmQ3J84RvZXcraRTw: posts small blind $0.10
8Waresd9ixnijISc3GUypg: posts big blind $0.25
*** HOLE CARDS ***
spidnpwmoJ1L6yeNW7D5UA: folds 
HVKi9hnDyvzObpL08/OarQ: folds 
6LFELL8V3NTpb0xg7AOyEg: calls $0.25
4oA316mXLIui1QY63GXBUg: folds 
DIBbjEYGs+TVdVgEB/4+3w: folds 
PrviAnKmKklf+We6cR33cw: calls $0.25
P32tOtZSz+L5ekobAPq2DA: folds 
33y9+GmQ3J84RvZXcraRTw: calls $0.15
8Waresd9ixnijISc3GUypg: checks 
*** FLOP *** [Th 8h 7c]
33y9+GmQ3J84RvZXcraRTw: checks 
8Waresd9ixnijISc3GUypg: bets $0.50
6LFELL8V3NTpb0xg7AOyEg: calls $0.50
PrviAnKmKklf+We6cR33cw: folds 
33y9+GmQ3J84RvZXcraRTw: folds 
*** TURN *** [Th 8h 7c] [Qh]
8Waresd9ixnijISc3GUypg: bets $0.50
6LFELL8V3NTpb0xg7AOyEg: calls $0.50
*** RIVER *** [Th 8h 7c Qh] [3h]
8Waresd9ixnijISc3GUypg: bets $0.50
6LFELL8V3NTpb0xg7AOyEg: raises $0.50 to $1
8Waresd9ixnijISc3GUypg: folds 
Uncalled bet ($0.50) returned to 6LFELL8V3NTpb0xg7AOyEg
6LFELL8V3NTpb0xg7AOyEg collected $3.85 from pot
6LFELL8V3NTpb0xg7AOyEg: doesn't show hand 
*** SUMMARY ***
Total pot $4 | Rake $0.15 
Board [Th 8h 7c Qh 3h]
Seat 1: P32tOtZSz+L5ekobAPq2DA (button) folded before Flop (didn't bet)
Seat 2: 33y9+GmQ3J84RvZXcraRTw (small blind) folded on the Flop
Seat 3: 8Waresd9ixnijISc3GUypg (big blind) folded on the River
Seat 4: spidnpwmoJ1L6yeNW7D5UA folded before Flop (didn't bet)
Seat 5: HVKi9hnDyvzObpL08/OarQ folded before Flop (didn't bet)
Seat 6: 6LFELL8V3NTpb0xg7AOyEg collected ($3.85)
Seat 7: 4oA316mXLIui1QY63GXBUg folded before Flop (didn't bet)
Seat 8: DIBbjEYGs+TVdVgEB/4+3w folded before Flop (didn't bet)
Seat 9: PrviAnKmKklf+We6cR33cw folded on the Flop




PokerStars Game #59939386824:  Hold'em No Limit ($0.10/$0.25) - 2009/07/01 0:38:33 ET
Table 'ouLhepGYovxB2x0QxH7cVg' 9-max Seat #7 is the button
Seat 1: ghNKXUBl/H+t83JF079ZBA ($30.70 in chips) 
Seat 2: r1Z5m4PwSI5ANp7qCE1OJw ($14.35 in chips) 
Seat 3: SkLOm0UugROBRt2EfMpOxQ ($24.25 in chips) 
Seat 4: a0Sx6GHY7ln2Ns2C97eXeA ($26.90 in chips) 
Seat 5: 18G4P1XstjNvItdGUITxgw ($25 in chips) 
Seat 6: r6hsffOo1iKmaPYKwAZmFw ($25.30 in chips) 
Seat 7: oHv2mIZJh3H0JR+WOZteZA ($20.15 in chips) 
Seat 8: opOCI2p6kW0tINuVaAqmcQ ($25.10 in chips) 
Seat 9: fIgGw0jPUR7labvJPaPbeg ($12.45 in chips) 
opOCI2p6kW0tINuVaAqmcQ: posts small blind $0.10
fIgGw0jPUR7labvJPaPbeg: posts big blind $0.25
*** HOLE CARDS ***
ghNKXUBl/H+t83JF079ZBA: folds 
r1Z5m4PwSI5ANp7qCE1OJw: folds 
SkLOm0UugROBRt2EfMpOxQ: folds 
a0Sx6GHY7ln2Ns2C97eXeA: folds 
18G4P1XstjNvItdGUITxgw: folds 
r6hsffOo1iKmaPYKwAZmFw: folds 
oHv2mIZJh3H0JR+WOZteZA: folds 
opOCI2p6kW0tINuVaAqmcQ: raises $0.25 to $0.50
fIgGw0jPUR7labvJPaPbeg: calls $0.25
*** FLOP *** [5h 4s 3h]
opOCI2p6kW0tINuVaAqmcQ: checks 
fIgGw0jPUR7labvJPaPbeg: bets $0.50
opOCI2p6kW0tINuVaAqmcQ: calls $0.50
*** TURN *** [5h 4s 3h] [Td]
opOCI2p6kW0tINuVaAqmcQ: checks 
fIgGw0jPUR7labvJPaPbeg: bets $1
opOCI2p6kW0tINuVaAqmcQ: calls $1
*** RIVER *** [5h 4s 3h Td] [6s]
opOCI2p6kW0tINuVaAqmcQ: checks 
fIgGw0jPUR7labvJPaPbeg: bets $2.25
opOCI2p6kW0tINuVaAqmcQ: folds 
Uncalled bet ($2.25) returned to fIgGw0jPUR7labvJPaPbeg
fIgGw0jPUR7labvJPaPbeg collected $3.85 from pot
*** SUMMARY ***
Total pot $4 | Rake $0.15 
Board [5h 4s 3h Td 6s]
Seat 1: ghNKXUBl/H+t83JF079ZBA folded before Flop (didn't bet)
Seat 2: r1Z5m4PwSI5ANp7qCE1OJw folded before Flop (didn't bet)
Seat 3: SkLOm0UugROBRt2EfMpOxQ folded before Flop (didn't bet)
Seat 4: a0Sx6GHY7ln2Ns2C97eXeA folded before Flop (didn't bet)
Seat 5: 18G4P1XstjNvItdGUITxgw folded before Flop (didn't bet)
Seat 6: r6hsffOo1iKmaPYKwAZmFw folded before Flop (didn't bet)
Seat 7: oHv2mIZJh3H0JR+WOZteZA (button) folded before Flop (didn't bet)
Seat 8: opOCI2p6kW0tINuVaAqmcQ (small blind) folded on the River
Seat 9: fIgGw0jPUR7labvJPaPbeg (big blind) collected ($3.85)




PokerStars Game #59939387884:  Hold'em No Limit ($0.10/$0.25) - 2009/07/01 0:38:34 ET
Table 'sSe6q4YTb/iS19t2eCFdsA' 9-max Seat #3 is the button
Seat 1: 5z3YkZTfH2GjoLK+6X7z2w ($11.55 in chips) 
Seat 2: rUpvA02nErFvZ4yFbDR8XA ($28.35 in chips) 
Seat 3: hBMUlEpyU74r/fwDgIpXjQ ($26.20 in chips) 
Seat 4: SXqVW4Q0evTUVZG6BbUNIA ($15.95 in chips) 
Seat 5: qS+jfnNoG75bT+uQ8CKhQA ($7.95 in chips) 
Seat 6: tYsOBqdU1+x+yFI7zHO7hQ ($26.40 in chips) 
Seat 7: t70KGeRtR3naHSqKDixsUg ($14.05 in chips) 
Seat 8: jeKWRUkMaVn8rEUjnJKqpg ($28.40 in chips) 
Seat 9: 4oA316mXLIui1QY63GXBUg ($26.60 in chips) 
SXqVW4Q0evTUVZG6BbUNIA: posts small blind $0.10
qS+jfnNoG75bT+uQ8CKhQA: posts big blind $0.25
*** HOLE CARDS ***
tYsOBqdU1+x+yFI7zHO7hQ: folds 
t70KGeRtR3naHSqKDixsUg: folds 
jeKWRUkMaVn8rEUjnJKqpg: calls $0.25
4oA316mXLIui1QY63GXBUg: calls $0.25
5z3YkZTfH2GjoLK+6X7z2w: folds 
rUpvA02nErFvZ4yFbDR8XA: calls $0.25
hBMUlEpyU74r/fwDgIpXjQ: folds 
SXqVW4Q0evTUVZG6BbUNIA: folds 
qS+jfnNoG75bT+uQ8CKhQA: raises $0.75 to $1
jeKWRUkMaVn8rEUjnJKqpg: calls $0.75
4oA316mXLIui1QY63GXBUg: calls $0.75
rUpvA02nErFvZ4yFbDR8XA: folds 
*** FLOP *** [Ks Qs Qd]
qS+jfnNoG75bT+uQ8CKhQA: checks 
jeKWRUkMaVn8rEUjnJKqpg: checks 
4oA316mXLIui1QY63GXBUg: checks 
*** TURN *** [Ks Qs Qd] [5d]
qS+jfnNoG75bT+uQ8CKhQA: bets $2.25
jeKWRUkMaVn8rEUjnJKqpg: folds 
4oA316mXLIui1QY63GXBUg: folds 
Uncalled bet ($2.25) returned to qS+jfnNoG75bT+uQ8CKhQA
qS+jfnNoG75bT+uQ8CKhQA collected $3.20 from pot
*** SUMMARY ***
Total pot $3.35 | Rake $0.15 
Board [Ks Qs Qd 5d]
Seat 1: 5z3YkZTfH2GjoLK+6X7z2w folded before Flop (didn't bet)
Seat 2: rUpvA02nErFvZ4yFbDR8XA folded before Flop
Seat 3: hBMUlEpyU74r/fwDgIpXjQ (button) folded before Flop (didn't bet)
Seat 4: SXqVW4Q0evTUVZG6BbUNIA (small blind) folded before Flop
Seat 5: qS+jfnNoG75bT+uQ8CKhQA (big blind) collected ($3.20)
Seat 6: tYsOBqdU1+x+yFI7zHO7hQ folded before Flop (didn't bet)
Seat 7: t70KGeRtR3naHSqKDixsUg folded before Flop (didn't bet)
Seat 8: jeKWRUkMaVn8rEUjnJKqpg folded on the Turn
Seat 9: 4oA316mXLIui1QY63GXBUg folded on the Turn




PokerStars Game #59939387552:  Hold'em No Limit ($0.10/$0.25) - 2009/07/01 0:38:34 ET
Table '2AUmC2Rslg+QUbLfdgNdfg' 6-max Seat #4 is the button
Seat 1: lgP2sg9oZJsNSXCt7tbwRg ($16.60 in chips) 
Seat 2: CCxAG7iPVlAv3brCqrGBEg ($14.75 in chips) 
Seat 3: iauW7L/+7qzAuHow7CD75Q ($4.95 in chips) 
Seat 4: B6R6e73iyJNddUtXtvYr3Q ($47.95 in chips) 
Seat 5: 8ClCHtFXGNplITm+63KB+Q ($23.05 in chips) 
Seat 6: BvTq4Tu0zBOsniW3eFCnkQ ($33.15 in chips) 
8ClCHtFXGNplITm+63KB+Q: posts small blind $0.10
BvTq4Tu0zBOsniW3eFCnkQ: posts big blind $0.25
*** HOLE CARDS ***
lgP2sg9oZJsNSXCt7tbwRg: folds 
CCxAG7iPVlAv3brCqrGBEg: folds 
iauW7L/+7qzAuHow7CD75Q: raises $1 to $1.25
B6R6e73iyJNddUtXtvYr3Q: folds 
8ClCHtFXGNplITm+63KB+Q: folds 
BvTq4Tu0zBOsniW3eFCnkQ: folds 
Uncalled bet ($1) returned to iauW7L/+7qzAuHow7CD75Q
iauW7L/+7qzAuHow7CD75Q collected $0.60 from pot
iauW7L/+7qzAuHow7CD75Q: doesn't show hand 
*** SUMMARY ***
Total pot $0.60 | Rake $0 
Seat 1: lgP2sg9oZJsNSXCt7tbwRg folded before Flop (didn't bet)
Seat 2: CCxAG7iPVlAv3brCqrGBEg folded before Flop (didn't bet)
Seat 3: iauW7L/+7qzAuHow7CD75Q collected ($0.60)
Seat 4: B6R6e73iyJNddUtXtvYr3Q (button) folded before Flop (didn't bet)
Seat 5: 8ClCHtFXGNplITm+63KB+Q (small blind) folded before Flop
Seat 6: BvTq4Tu0zBOsniW3eFCnkQ (big blind) folded before Flop




PokerStars Game #59939387414:  Hold'em No Limit ($0.10/$0.25) - 2009/07/01 0:38:34 ET
Table 'FuFyQHmlO/QqQp//rDRrPg' 6-max Seat #4 is the button
Seat 1: 4re+a1K56DcbV7DyVX/FMw ($15.10 in chips) 
Seat 3: uoOTv6ecGYEhLPY44ZTW+A ($11.35 in chips) 
Seat 4: Eznneya0vB6S+eXJdVleHA ($9.65 in chips) 
Seat 5: wAKC8C/zN0c8V5v13dm9mA ($25.10 in chips) 
Seat 6: Euh3U8PK9KVQP5CQdDjkeQ ($21.15 in chips) 
wAKC8C/zN0c8V5v13dm9mA: posts small blind $0.10
Euh3U8PK9KVQP5CQdDjkeQ: posts big blind $0.25
*** HOLE CARDS ***
4re+a1K56DcbV7DyVX/FMw: calls $0.25
uoOTv6ecGYEhLPY44ZTW+A: folds 
Eznneya0vB6S+eXJdVleHA: folds 
wAKC8C/zN0c8V5v13dm9mA: folds 
Euh3U8PK9KVQP5CQdDjkeQ: checks 
*** FLOP *** [7s 6h 8s]
Euh3U8PK9KVQP5CQdDjkeQ: checks 
4re+a1K56DcbV7DyVX/FMw: bets $0.50
0DvgWV5o6c/jYqQCjm4Haw joins the table at seat #2 
Euh3U8PK9KVQP5CQdDjkeQ: folds 
Uncalled bet ($0.50) returned to 4re+a1K56DcbV7DyVX/FMw
4re+a1K56DcbV7DyVX/FMw collected $0.60 from pot
4re+a1K56DcbV7DyVX/FMw: doesn't show hand 
*** SUMMARY ***
Total pot $0.60 | Rake $0 
Board [7s 6h 8s]
Seat 1: 4re+a1K56DcbV7DyVX/FMw collected ($0.60)
Seat 3: uoOTv6ecGYEhLPY44ZTW+A folded before Flop (didn't bet)
Seat 4: Eznneya0vB6S+eXJdVleHA (button) folded before Flop (didn't bet)
Seat 5: wAKC8C/zN0c8V5v13dm9mA (small blind) folded before Flop
Seat 6: Euh3U8PK9KVQP5CQdDjkeQ (big blind) folded on the Flop




PokerStars Game #59939387614:  Hold'em No Limit ($0.10/$0.25) - 2009/07/01 0:38:34 ET
Table '3760QYRYyCWeXf0rLZ5S2g' 9-max Seat #8 is the button
Seat 1: COsrwJSFHQtxlUcrYtDQPQ ($25.35 in chips) 
Seat 2: zDrucyjVn5aeekNEc3cJrA ($21.20 in chips) 
Seat 3: aLYacoAY3e5d/M5ToF8Ujw ($20.70 in chips) 
Seat 5: MG90wfSJZnOejs/KD3vlQQ ($27.45 in chips) 
Seat 6: DnDcAdn9P0zGovMERigpFA ($47.05 in chips) 
Seat 8: nl78vdCYaG2sN+td5Z33sA ($7.75 in chips) 
Seat 9: aNpwfA31EREwO+ar4XzBCw ($25 in chips) 
aNpwfA31EREwO+ar4XzBCw: posts small blind $0.10
COsrwJSFHQtxlUcrYtDQPQ: posts big blind $0.25
*** HOLE CARDS ***
zDrucyjVn5aeekNEc3cJrA: folds 
aLYacoAY3e5d/M5ToF8Ujw: folds 
MG90wfSJZnOejs/KD3vlQQ: raises $0.50 to $0.75
DnDcAdn9P0zGovMERigpFA: folds 
nl78vdCYaG2sN+td5Z33sA: folds 
aNpwfA31EREwO+ar4XzBCw: folds 
COsrwJSFHQtxlUcrYtDQPQ: folds 
Uncalled bet ($0.50) returned to MG90wfSJZnOejs/KD3vlQQ
MG90wfSJZnOejs/KD3vlQQ collected $0.60 from pot
MG90wfSJZnOejs/KD3vlQQ: doesn't show hand 
*** SUMMARY ***
Total pot $0.60 | Rake $0 
Seat 1: COsrwJSFHQtxlUcrYtDQPQ (big blind) folded before Flop
Seat 2: zDrucyjVn5aeekNEc3cJrA folded before Flop (didn't bet)
Seat 3: aLYacoAY3e5d/M5ToF8Ujw folded before Flop (didn't bet)
Seat 5: MG90wfSJZnOejs/KD3vlQQ collected ($0.60)
Seat 6: DnDcAdn9P0zGovMERigpFA folded before Flop (didn't bet)
Seat 8: nl78vdCYaG2sN+td5Z33sA (button) folded before Flop (didn't bet)
Seat 9: aNpwfA31EREwO+ar4XzBCw (small blind) folded before Flop




PokerStars Game #59939388516:  Hold'em No Limit ($0.10/$0.25) - 2009/07/01 0:38:35 ET
Table 'BdTkgy6SGkgNXul6irMoOw' 9-max Seat #2 is the button
Seat 2: ljemhp25Zg+nlA9DLCIiUw ($24.45 in chips) 
Seat 4: eygIcrabyU9hI2mw7NQsgg ($23.65 in chips) 
Seat 5: opOCI2p6kW0tINuVaAqmcQ ($25 in chips) 
Seat 6: XlP4n7rTkDteN8BWl//wvg ($38 in chips) 
Seat 9: 5dv9mRGKI/UifM58OINXVQ ($19.90 in chips) 
tYsOBqdU1+x+yFI7zHO7hQ: is sitting out 
eygIcrabyU9hI2mw7NQsgg: posts small blind $0.10
opOCI2p6kW0tINuVaAqmcQ: posts big blind $0.25
*** HOLE CARDS ***
XlP4n7rTkDteN8BWl//wvg: folds 
5dv9mRGKI/UifM58OINXVQ: folds 
tYsOBqdU1+x+yFI7zHO7hQ leaves the table
ljemhp25Zg+nlA9DLCIiUw: folds 
eygIcrabyU9hI2mw7NQsgg: folds 
Uncalled bet ($0.15) returned to opOCI2p6kW0tINuVaAqmcQ
opOCI2p6kW0tINuVaAqmcQ collected $0.20 from pot
opOCI2p6kW0tINuVaAqmcQ: doesn't show hand 
*** SUMMARY ***
Total pot $0.20 | Rake $0 
Seat 2: ljemhp25Zg+nlA9DLCIiUw (button) folded before Flop (didn't bet)
Seat 4: eygIcrabyU9hI2mw7NQsgg (small blind) folded before Flop
Seat 5: opOCI2p6kW0tINuVaAqmcQ (big blind) collected ($0.20)
Seat 6: XlP4n7rTkDteN8BWl//wvg folded before Flop (didn't bet)
Seat 9: 5dv9mRGKI/UifM58OINXVQ folded before Flop (didn't bet)




PokerStars Game #59939388434:  Hold'em No Limit ($0.10/$0.25) - 2009/07/01 0:38:35 ET
Table 'JJzUs04lHpXg6nboT1/jeg' 6-max Seat #4 is the button
Seat 4: nwwpaieDRI0UPyVtChVHOg ($36.55 in chips) 
Seat 5: Vr2XE7yYBdg3RZSURDAPEg ($24.15 in chips) 
Seat 6: qlSMvybgHy3Sa2mdf7Mw/A ($16.05 in chips) 
Vr2XE7yYBdg3RZSURDAPEg: posts small blind $0.10
qlSMvybgHy3Sa2mdf7Mw/A: posts big blind $0.25
*** HOLE CARDS ***
nwwpaieDRI0UPyVtChVHOg: folds 
Vr2XE7yYBdg3RZSURDAPEg: folds 
Uncalled bet ($0.15) returned to qlSMvybgHy3Sa2mdf7Mw/A
qlSMvybgHy3Sa2mdf7Mw/A collected $0.20 from pot
*** SUMMARY ***
Total pot $0.20 | Rake $0 
Seat 4: nwwpaieDRI0UPyVtChVHOg (button) folded before Flop (didn't bet)
Seat 5: Vr2XE7yYBdg3RZSURDAPEg (small blind) folded before Flop
Seat 6: qlSMvybgHy3Sa2mdf7Mw/A (big blind) collected ($0.20)




PokerStars Game #59939388264:  Hold'em No Limit ($0.10/$0.25) - 2009/07/01 0:38:35 ET
Table 'Loy/olZ5qoDOSvX4UTujGg' 6-max Seat #5 is the button
Seat 1: yzFNNFIfC89bBPwpFPx2ow ($28.85 in chips) 
Seat 2: MkNgTuvyxpHXkeIm5JITHQ ($12.85 in chips) 
Seat 3: 32YL2ZEp8NT4JB2RVM9euQ ($15.65 in chips) 
Seat 4: /gJNBeCkWL4o85/jvlZ4BA ($27.10 in chips) 
Seat 5: 4YSTu0Cdzpppe1lUgCZGCQ ($35.15 in chips) 
Seat 6: 7FmwVDcdEtxDpHmP4hOXsQ ($52.80 in chips) 
7FmwVDcdEtxDpHmP4hOXsQ: posts small blind $0.10
yzFNNFIfC89bBPwpFPx2ow: posts big blind $0.25
*** HOLE CARDS ***
MkNgTuvyxpHXkeIm5JITHQ: folds 
MkNgTuvyxpHXkeIm5JITHQ is sitting out
MkNgTuvyxpHXkeIm5JITHQ leaves the table
32YL2ZEp8NT4JB2RVM9euQ has timed out
32YL2ZEp8NT4JB2RVM9euQ: folds 
32YL2ZEp8NT4JB2RVM9euQ is sitting out
/gJNBeCkWL4o85/jvlZ4BA: raises $0.75 to $1
4YSTu0Cdzpppe1lUgCZGCQ: folds 
7FmwVDcdEtxDpHmP4hOXsQ: folds 
32YL2ZEp8NT4JB2RVM9euQ has returned
yzFNNFIfC89bBPwpFPx2ow: folds 
Uncalled bet ($0.75) returned to /gJNBeCkWL4o85/jvlZ4BA
/gJNBeCkWL4o85/jvlZ4BA collected $0.60 from pot
*** SUMMARY ***
Total pot $0.60 | Rake $0 
Seat 1: yzFNNFIfC89bBPwpFPx2ow (big blind) folded before Flop
Seat 2: MkNgTuvyxpHXkeIm5JITHQ folded before Flop (didn't bet)
Seat 3: 32YL2ZEp8NT4JB2RVM9euQ folded before Flop (didn't bet)
Seat 4: /gJNBeCkWL4o85/jvlZ4BA collected ($0.60)
Seat 5: 4YSTu0Cdzpppe1lUgCZGCQ (button) folded before Flop (didn't bet)
Seat 6: 7FmwVDcdEtxDpHmP4hOXsQ (small blind) folded before Flop




PokerStars Game #59939388168:  Hold'em No Limit ($0.10/$0.25) - 2009/07/01 0:38:35 ET
Table 'sIHZ0lzLr4NGCaBUKhmYhA' 6-max Seat #2 is the button
Seat 1: q6WfTUAD9mowIP63ASq2Dg ($34.10 in chips) 
Seat 2: 1xmHIWgZaOCqEMnW2GkFfw ($10.85 in chips) 
Seat 3: SxIIgwXYLkwd6m3wLyPTCw ($25.25 in chips) 
Seat 4: 4YSTu0Cdzpppe1lUgCZGCQ ($33.90 in chips) 
SxIIgwXYLkwd6m3wLyPTCw: posts small blind $0.10
4YSTu0Cdzpppe1lUgCZGCQ: posts big blind $0.25
*** HOLE CARDS ***
q6WfTUAD9mowIP63ASq2Dg: raises $0.50 to $0.75
1xmHIWgZaOCqEMnW2GkFfw: folds 
SxIIgwXYLkwd6m3wLyPTCw: folds 
4YSTu0Cdzpppe1lUgCZGCQ: folds 
Uncalled bet ($0.50) returned to q6WfTUAD9mowIP63ASq2Dg
q6WfTUAD9mowIP63ASq2Dg collected $0.60 from pot
*** SUMMARY ***
Total pot $0.60 | Rake $0 
Seat 1: q6WfTUAD9mowIP63ASq2Dg collected ($0.60)
Seat 2: 1xmHIWgZaOCqEMnW2GkFfw (button) folded before Flop (didn't bet)
Seat 3: SxIIgwXYLkwd6m3wLyPTCw (small blind) folded before Flop
Seat 4: 4YSTu0Cdzpppe1lUgCZGCQ (big blind) folded before Flop




PokerStars Game #59939388438:  Hold'em No Limit ($0.10/$0.25) - 2009/07/01 0:38:35 ET
Table 'AHkg4ChqzcMauBx6Qvz8Nw' 6-max Seat #2 is the button
Seat 2: /bjna2FTN7pPjqYGzmDE0Q ($24 in chips) 
Seat 4: N7O9jUEx2YiQn1+yRYTHmw ($25.80 in chips) 
Seat 5: LtASJ9OlkqGrrUKGQlpGAw ($34.70 in chips) 
Seat 6: SFmT9ZsVopnukjvAzrxTRg ($53.40 in chips) 
N7O9jUEx2YiQn1+yRYTHmw: posts small blind $0.10
LtASJ9OlkqGrrUKGQlpGAw: posts big blind $0.25
*** HOLE CARDS ***
SFmT9ZsVopnukjvAzrxTRg: folds 
/bjna2FTN7pPjqYGzmDE0Q: raises $0.45 to $0.70
N7O9jUEx2YiQn1+yRYTHmw: calls $0.60
LtASJ9OlkqGrrUKGQlpGAw: calls $0.45
*** FLOP *** [Td Qh 7d]
N7O9jUEx2YiQn1+yRYTHmw: checks 
LtASJ9OlkqGrrUKGQlpGAw: checks 
Zi4SmoY9XJ0iI6ixiSZaWQ joins the table at seat #3 
/bjna2FTN7pPjqYGzmDE0Q: bets $1.25
N7O9jUEx2YiQn1+yRYTHmw: folds 
LtASJ9OlkqGrrUKGQlpGAw: raises $2.50 to $3.75
/bjna2FTN7pPjqYGzmDE0Q: folds 
Uncalled bet ($2.50) returned to LtASJ9OlkqGrrUKGQlpGAw
LtASJ9OlkqGrrUKGQlpGAw collected $4.40 from pot
LtASJ9OlkqGrrUKGQlpGAw: doesn't show hand 
*** SUMMARY ***
Total pot $4.60 | Rake $0.20 
Board [Td Qh 7d]
Seat 2: /bjna2FTN7pPjqYGzmDE0Q (button) folded on the Flop
Seat 4: N7O9jUEx2YiQn1+yRYTHmw (small blind) folded on the Flop
Seat 5: LtASJ9OlkqGrrUKGQlpGAw (big blind) collected ($4.40)
Seat 6: SFmT9ZsVopnukjvAzrxTRg folded before Flop (didn't bet)




PokerStars Game #59939389066:  Hold'em No Limit ($0.10/$0.25) - 2009/07/01 0:38:36 ET
Table 'dZNBGqFYSwfOVZvDJ4VjIQ' 6-max Seat #1 is the button
Seat 1: r0DiH4bZf5vkenb8ncDb3w ($12 in chips) 
Seat 2: NPueG39V6nKvDRuvBJ4U7g ($16.85 in chips) 
Seat 3: Qd4gQJ1hjQcU9/uDqd6Nlw ($12.20 in chips) 
Seat 5: hZJzYj+7+PvGu6ae1g//sQ ($11.40 in chips) 
NPueG39V6nKvDRuvBJ4U7g: posts small blind $0.10
Qd4gQJ1hjQcU9/uDqd6Nlw: posts big blind $0.25
*** HOLE CARDS ***
hZJzYj+7+PvGu6ae1g//sQ: folds 
r0DiH4bZf5vkenb8ncDb3w: folds 
NPueG39V6nKvDRuvBJ4U7g: calls $0.15
Qd4gQJ1hjQcU9/uDqd6Nlw: checks 
*** FLOP *** [7h Js 9s]
VbudEd0ZG+qPwMO9h+hjXw joins the table at seat #6 
NPueG39V6nKvDRuvBJ4U7g: bets $0.50
Qd4gQJ1hjQcU9/uDqd6Nlw: folds 
Uncalled bet ($0.50) returned to NPueG39V6nKvDRuvBJ4U7g
NPueG39V6nKvDRuvBJ4U7g collected $0.50 from pot
*** SUMMARY ***
Total pot $0.50 | Rake $0 
Board [7h Js 9s]
Seat 1: r0DiH4bZf5vkenb8ncDb3w (button) folded before Flop (didn't bet)
Seat 2: NPueG39V6nKvDRuvBJ4U7g (small blind) collected ($0.50)
Seat 3: Qd4gQJ1hjQcU9/uDqd6Nlw (big blind) folded on the Flop
Seat 5: hZJzYj+7+PvGu6ae1g//sQ folded before Flop (didn't bet)




PokerStars Game #59939389008:  Hold'em No Limit ($0.10/$0.25) - 2009/07/01 0:38:36 ET
Table '3lS+sU5k6mwJCS2nFMmQ6Q' 9-max Seat #3 is the button
Seat 1: VWUWpMLMj/Q1jRVpF7Aohw ($13 in chips) 
Seat 2: 4oA316mXLIui1QY63GXBUg ($25.75 in chips) 
Seat 3: 1DXccE2UUK5DIRVGlOKnTA ($9.50 in chips) 
Seat 4: 8B/dhbQjIWe6ASCdgzktNQ ($45 in chips) 
Seat 5: LuckyShot



PokerStars Game #59939389058:  Hold'em No Limit ($0.10/$0.25) - 2009/07/01 0:38:36 ET
Table '6ae4XiTo6B597KfSSMr8Cg' 9-max Seat #2 is the button
Seat 1: 49YfVBEOwzD3/FVw+dTTBQ ($5.65 in chips) 
Seat 2: 5s3p6yoJBNW438dsyKTP8g ($45.25 in chips) 
Seat 3: yyG4svzOpC1A+sUP/scg6w ($8.30 in chips) 
Seat 4: dfNim92Z6XK1/h5SFW5vDg ($49.10 in chips) 
Seat 5: 1K6QGyJP9P9xmRac2fH4OQ ($25 in chips) 
Seat 7: 18G4P1XstjNvItdGUITxgw ($25.25 in chips) 
Seat 9: E0iYnEVO2ho7dH3QcCjw7g ($34.70 in chips) 
yyG4svzOpC1A+sUP/scg6w: posts small blind $0.10
dfNim92Z6XK1/h5SFW5vDg: posts big blind $0.25
DlXs37dlX3tb7o/7lYXQSw: sits out 
lacross84: sits out 
*** HOLE CARDS ***
1K6QGyJP9P9xmRac2fH4OQ: folds 
18G4P1XstjNvItdGUITxgw: folds 
E0iYnEVO2ho7dH3QcCjw7g: folds 
49YfVBEOwzD3/FVw+dTTBQ: folds 
5s3p6yoJBNW438dsyKTP8g: calls $0.25
yyG4svzOpC1A+sUP/scg6w: calls $0.15
dfNim92Z6XK1/h5SFW5vDg: checks 
*** FLOP *** [7h Ts Kd]
yyG4svzOpC1A+sUP/scg6w: checks 
dfNim92Z6XK1/h5SFW5vDg: checks 
5s3p6yoJBNW438dsyKTP8g: checks 
*** TURN *** [7h Ts Kd] [Jc]
yyG4svzOpC1A+sUP/scg6w: checks 
dfNim92Z6XK1/h5SFW5vDg: checks 
5s3p6yoJBNW438dsyKTP8g: checks 
*** RIVER *** [7h Ts Kd Jc] [Kc]
yyG4svzOpC1A+sUP/scg6w: checks 
dfNim92Z6XK1/h5SFW5vDg: checks 
5s3p6yoJBNW438dsyKTP8g: checks 
*** SHOW DOWN ***
yyG4svzOpC1A+sUP/scg6w: shows [8c 8s] (two pair, Kings and Eights)
dfNim92Z6XK1/h5SFW5vDg: mucks hand 
5s3p6yoJBNW438dsyKTP8g: shows [9s Th] (two pair, Kings and Tens)
5s3p6yoJBNW438dsyKTP8g collected $0.75 from pot
*** SUMMARY ***
Total pot $0.75 | Rake $0 
Board [7h Ts Kd Jc Kc]
Seat 1: 49YfVBEOwzD3/FVw+dTTBQ folded before Flop (didn't bet)
Seat 2: 5s3p6yoJBNW438dsyKTP8g (button) showed [9s Th] and won ($0.75) with two pair, Kings and Tens
Seat 3: yyG4svzOpC1A+sUP/scg6w (small blind) showed [8c 8s] and lost with two pair, Kings and Eights
Seat 4: dfNim92Z6XK1/h5SFW5vDg (big blind) mucked
Seat 5: 1K6QGyJP9P9xmRac2fH4OQ folded before Flop (didn't bet)
Seat 7: 18G4P1XstjNvItdGUITxgw folded before Flop (didn't bet)
Seat 9: E0iYnEVO2ho7dH3QcCjw7g folded before Flop (didn't bet)




PokerStars Game #59939389642:  Hold'em No Limit ($0.10/$0.25) - 2009/07/01 0:38:37 ET
Table 'b64Z+5XI1xkQzNfq4QHr3A' 6-max Seat #5 is the button
Seat 1: qccGLncfUaN00Few5HsgYg ($50.45 in chips) 
Seat 2: SS/yfeArhULzIcOPe8MdPg ($34.75 in chips) 
Seat 4: SxIIgwXYLkwd6m3wLyPTCw ($25 in chips) 
Seat 5: d0J1xuhsynEY81YHwAvJ5g ($33.25 in chips) 
Seat 6: 8ClCHtFXGNplITm+63KB+Q ($38.45 in chips) 
8ClCHtFXGNplITm+63KB+Q: posts small blind $0.10
qccGLncfUaN00Few5HsgYg: posts big blind $0.25
*** HOLE CARDS ***
SS/yfeArhULzIcOPe8MdPg: folds 
SxIIgwXYLkwd6m3wLyPTCw: folds 
d0J1xuhsynEY81YHwAvJ5g: folds 
u/yN5P9f3KlATg6WLWNkBQ joins the table at seat #3 
8ClCHtFXGNplITm+63KB+Q: folds 
Uncalled bet ($0.15) returned to qccGLncfUaN00Few5HsgYg
qccGLncfUaN00Few5HsgYg collected $0.20 from pot
*** SUMMARY ***
Total pot $0.20 | Rake $0 
Seat 1: qccGLncfUaN00Few5HsgYg (big blind) collected ($0.20)
Seat 2: SS/yfeArhULzIcOPe8MdPg folded before Flop (didn't bet)
Seat 4: SxIIgwXYLkwd6m3wLyPTCw folded before Flop (didn't bet)
Seat 5: d0J1xuhsynEY81YHwAvJ5g (button) folded before Flop (didn't bet)
Seat 6: 8ClCHtFXGNplITm+63KB+Q (small blind) folded before Flop




PokerStars Game #59939389268:  Hold'em No Limit ($0.10/$0.25) - 2009/07/01 0:38:37 ET
Table 'biAgO3TKQBU8XcrVAoU5TA' 6-max Seat #3 is the button
Seat 1: PIOdknsVyjKUwfiImc3zwg ($27.60 in chips) 
Seat 2: 7qRk4YH4/k/08LgJSv7rBQ ($24.65 in chips) 
Seat 3: 7AHdX4G8gYtDJyNY+wK+6Q ($30.65 in chips) 
Seat 4: 2/AObG8G5tKFCPZ+CdivJQ ($12.80 in chips) 
Seat 6: //i5P+6lSkIyZsqb+ojVQA ($12.65 in chips) 
2/AObG8G5tKFCPZ+CdivJQ: posts small blind $0.10
//i5P+6lSkIyZsqb+ojVQA: posts big blind $0.25
*** HOLE CARDS ***
PIOdknsVyjKUwfiImc3zwg: folds 
7qRk4YH4/k/08LgJSv7rBQ: folds 
7AHdX4G8gYtDJyNY+wK+6Q: folds 
2/AObG8G5tKFCPZ+CdivJQ: calls $0.15
//i5P+6lSkIyZsqb+ojVQA: raises $0.25 to $0.50
PIOdknsVyjKUwfiImc3zwg leaves the table
2/AObG8G5tKFCPZ+CdivJQ: calls $0.25
*** FLOP *** [7s 8c 6s]
2/AObG8G5tKFCPZ+CdivJQ: checks 
//i5P+6lSkIyZsqb+ojVQA: bets $0.50
2/AObG8G5tKFCPZ+CdivJQ: calls $0.50
*** TURN *** [7s 8c 6s] [2d]
2/AObG8G5tKFCPZ+CdivJQ: checks 
//i5P+6lSkIyZsqb+ojVQA: bets $0.75
2/AObG8G5tKFCPZ+CdivJQ: calls $0.75
*** RIVER *** [7s 8c 6s 2d] [2h]
2/AObG8G5tKFCPZ+CdivJQ: checks 
//i5P+6lSkIyZsqb+ojVQA: bets $1.25
2/AObG8G5tKFCPZ+CdivJQ: folds 
Uncalled bet ($1.25) returned to //i5P+6lSkIyZsqb+ojVQA
//i5P+6lSkIyZsqb+ojVQA collected $3.35 from pot
//i5P+6lSkIyZsqb+ojVQA: doesn't show hand 
*** SUMMARY ***
Total pot $3.50 | Rake $0.15 
Board [7s 8c 6s 2d 2h]
Seat 1: PIOdknsVyjKUwfiImc3zwg folded before Flop (didn't bet)
Seat 2: 7qRk4YH4/k/08LgJSv7rBQ folded before Flop (didn't bet)
Seat 3: 7AHdX4G8gYtDJyNY+wK+6Q (button) folded before Flop (didn't bet)
Seat 4: 2/AObG8G5tKFCPZ+CdivJQ (small blind) folded on the River
Seat 6: //i5P+6lSkIyZsqb+ojVQA (big blind) collected ($3.35)




PokerStars Game #59939389440:  Hold'em No Limit ($0.10/$0.25) - 2009/07/01 0:38:37 ET
Table 'gZetDqJh6q9A3mLO3ThCsAnc6OeGk/wtaWV+6N+kgnZQSeat #3 is the button
Seat 1: 1YCU970EVCcjs4GQP5Zt0g ($19.40 in chips) 
Seat 3: wKFJ513ucluNNiMlkXcDOQ ($32.10 in chips) 
Seat 4: eHsmIvAb2JREg4O6hNPnXg ($9.40 in chips) 
Seat 5: mfrkWA3PTeYPkbO6hi98Aw ($43.40 in chips) 
Seat 6: R1hR3/XSBdOHwcbSUJRJbg ($26.55 in chips) 
eHsmIvAb2JREg4O6hNPnXg: posts small blind $0.10
mfrkWA3PTeYPkbO6hi98Aw: posts big blind $0.25
*** HOLE CARDS ***
R1hR3/XSBdOHwcbSUJRJbg: raises $0.50 to $0.75
1YCU970EVCcjs4GQP5Zt0g: folds 
wKFJ513ucluNNiMlkXcDOQ: folds 
eHsmIvAb2JREg4O6hNPnXg: calls $0.65
mfrkWA3PTeYPkbO6hi98Aw: calls $0.50
*** FLOP *** [7h 9h Ac]
eHsmIvAb2JREg4O6hNPnXg: checks 
mfrkWA3PTeYPkbO6hi98Aw: checks 
R1hR3/XSBdOHwcbSUJRJbg: bets $1.75
eHsmIvAb2JREg4O6hNPnXg: folds 
mfrkWA3PTeYPkbO6hi98Aw: calls $1.75
*** TURN *** [7h 9h Ac] [Ah]
mfrkWA3PTeYPkbO6hi98Aw: checks 
JFIAqU8lCZ0vWwEl4bdGsg joins the table at seat #2 
R1hR3/XSBdOHwcbSUJRJbg: bets $2.75
mfrkWA3PTeYPkbO6hi98Aw: calls $2.75
*** RIVER *** [7h 9h Ac Ah] [4h]
mfrkWA3PTeYPkbO6hi98Aw: checks 
R1hR3/XSBdOHwcbSUJRJbg: bets $6
mfrkWA3PTeYPkbO6hi98Aw: folds 
Uncalled bet ($6) returned to R1hR3/XSBdOHwcbSUJRJbg
R1hR3/XSBdOHwcbSUJRJbg collected $10.70 from pot
R1hR3/XSBdOHwcbSUJRJbg: doesn't show hand 
*** SUMMARY ***
Total pot $11.25 | Rake $0.55 
Board [7h 9h Ac Ah 4h]
Seat 1: 1YCU970EVCcjs4GQP5Zt0g folded before Flop (didn't bet)
Seat 3: wKFJ513ucluNNiMlkXcDOQ (button) folded before Flop (didn't bet)
Seat 4: eHsmIvAb2JREg4O6hNPnXg (small blind) folded on the Flop
Seat 5: mfrkWA3PTeYPkbO6hi98Aw (big blind) folded on the River
Seat 6: R1hR3/XSBdOHwcbSUJRJbg collected ($10.70)




PokerStars Game #59939389518:  Hold'em No Limit ($0.10/$0.25) - 2009/07/01 0:38:37 ET
Table 'sDHjMRwfSiz7+NDdZLUiyA' 9-max Seat #2 is the button
Seat 1: N6fYvIzQLKaydFLKQGtMlQ ($25.90 in chips) 
Seat 2: ljemhp25Zg+nlA9DLCIiUw ($27.50 in chips) 
Seat 4: v5jnQ1gfh9nLla3kMXG7Yg ($8.50 in chips) 
Seat 8: 3hMkm4U5yTRrkGJkxfijaQ ($38.95 in chips) 
Seat 9: Xpyqpb+DURDWnyJ3xTEIFQ ($38.25 in chips) 
v5jnQ1gfh9nLla3kMXG7Yg: posts small blind $0.10
3hMkm4U5yTRrkGJkxfijaQ: posts big blind $0.25
*** HOLE CARDS ***
Xpyqpb+DURDWnyJ3xTEIFQ: folds 
N6fYvIzQLKaydFLKQGtMlQ: folds 
ljemhp25Zg+nlA9DLCIiUw: folds 
v5jnQ1gfh9nLla3kMXG7Yg: calls $0.15
3hMkm4U5yTRrkGJkxfijaQ: checks 
*** FLOP *** [Qc Kd 9h]
v5jnQ1gfh9nLla3kMXG7Yg: checks 
3hMkm4U5yTRrkGJkxfijaQ: checks 
*** TURN *** [Qc Kd 9h] [6c]
v5jnQ1gfh9nLla3kMXG7Yg: checks 
3hMkm4U5yTRrkGJkxfijaQ: checks 
*** RIVER *** [Qc Kd 9h 6c] [Tc]
v5jnQ1gfh9nLla3kMXG7Yg: checks 
3hMkm4U5yTRrkGJkxfijaQ: bets $1
v5jnQ1gfh9nLla3kMXG7Yg: raises $7.25 to $8.25 and is all-in
3hMkm4U5yTRrkGJkxfijaQ: calls $7.25
*** SHOW DOWN ***
v5jnQ1gfh9nLla3kMXG7Yg: shows [Ac Js] (a straight, Ten to Ace)
3hMkm4U5yTRrkGJkxfijaQ: mucks hand 
v5jnQ1gfh9nLla3kMXG7Yg collected $16.15 from pot
*** SUMMARY ***
Total pot $17 | Rake $0.85 
Board [Qc Kd 9h 6c Tc]
Seat 1: N6fYvIzQLKaydFLKQGtMlQ folded before Flop (didn't bet)
Seat 2: ljemhp25Zg+nlA9DLCIiUw (button) folded before Flop (didn't bet)
Seat 4: v5jnQ1gfh9nLla3kMXG7Yg (small blind) showed [Ac Js] and won ($16.15) with a straight, Ten to Ace
Seat 8: 3hMkm4U5yTRrkGJkxfijaQ (big blind) mucked
Seat 9: Xpyqpb+DURDWnyJ3xTEIFQ folded before Flop (didn't bet)




PokerStars Game #59939389382:  Hold'em No Limit ($0.10/$0.25) - 2009/07/01 0:38:37 ET
Table 'u5gc8WdJbaPqEonQaM8rHA' 9-max Seat #4 is the button
Seat 1: rXm4QDVJt67H20lM6n6Z7Q ($8.50 in chips) 
Seat 2: YcYxPZXJR8KffyXgr1BkHw ($27.60 in chips) 
Seat 4: QBNV6v6f+1ZHoaKcQDTWog ($29.65 in chips) 
Seat 5: CYkY0dNBaYaKs8HVCVn3mQ ($5 in chips) 
Seat 6: iPe2eRZr++z/LEfORn3WBQ ($16.95 in chips) 
CYkY0dNBaYaKs8HVCVn3mQ: posts small blind $0.10
iPe2eRZr++z/LEfORn3WBQ: posts big blind $0.25
*** HOLE CARDS ***
rXm4QDVJt67H20lM6n6Z7Q: folds 
YcYxPZXJR8KffyXgr1BkHw: folds 
QBNV6v6f+1ZHoaKcQDTWog: calls $0.25
CYkY0dNBaYaKs8HVCVn3mQ: folds 
iPe2eRZr++z/LEfORn3WBQ: checks 
*** FLOP *** [3c 9d As]
CYkY0dNBaYaKs8HVCVn3mQ leaves the table
iPe2eRZr++z/LEfORn3WBQ: checks 
QBNV6v6f+1ZHoaKcQDTWog: bets $0.50
iPe2eRZr++z/LEfORn3WBQ: folds 
Uncalled bet ($0.50) returned to QBNV6v6f+1ZHoaKcQDTWog
QBNV6v6f+1ZHoaKcQDTWog collected $0.60 from pot
QBNV6v6f+1ZHoaKcQDTWog: doesn't show hand 
*** SUMMARY ***
Total pot $0.60 | Rake $0 
Board [3c 9d As]
Seat 1: rXm4QDVJt67H20lM6n6Z7Q folded before Flop (didn't bet)
Seat 2: YcYxPZXJR8KffyXgr1BkHw folded before Flop (didn't bet)
Seat 4: QBNV6v6f+1ZHoaKcQDTWog (button) collected ($0.60)
Seat 5: CYkY0dNBaYaKs8HVCVn3mQ (small blind) folded before Flop
Seat 6: iPe2eRZr++z/LEfORn3WBQ (big blind) folded on the Flop




PokerStars Game #59939389748:  Hold'em No Limit ($0.10/$0.25) - 2009/07/01 0:38:37 ET
Table 'ShgkxBDL5IvR1qjzfRNc0A' 6-max Seat #5 is the button
Seat 1: /gJNBeCkWL4o85/jvlZ4BA ($25 in chips) 
Seat 2: mfrkWA3PTeYPkbO6hi98Aw ($38.85 in chips) 
Seat 3: JXSfL0FgBM1dIFwHP09Hnw ($25 in chips) 
Seat 4: kG34n23qFQA3nzdOJTQ1dA ($24.75 in chips) 
Seat 5: ferjiUxLWPNUKxvl8/xD/g ($43.25 in chips) 
Seat 6: 5tB0F9NjPSUL4FzmzBMs2Q ($30.30 in chips) 
5tB0F9NjPSUL4FzmzBMs2Q: posts small blind $0.10
/gJNBeCkWL4o85/jvlZ4BA: posts big blind $0.25
*** HOLE CARDS ***
mfrkWA3PTeYPkbO6hi98Aw: folds 
JXSfL0FgBM1dIFwHP09Hnw: raises $0.50 to $0.75
kG34n23qFQA3nzdOJTQ1dA: folds 
ferjiUxLWPNUKxvl8/xD/g: calls $0.75
5tB0F9NjPSUL4FzmzBMs2Q: folds 
/gJNBeCkWL4o85/jvlZ4BA: folds 
*** FLOP *** [7s 4c 3s]
JXSfL0FgBM1dIFwHP09Hnw: checks 
ferjiUxLWPNUKxvl8/xD/g: checks 
*** TURN *** [7s 4c 3s] [Ah]
JXSfL0FgBM1dIFwHP09Hnw: checks 
ferjiUxLWPNUKxvl8/xD/g: bets $1.25
JXSfL0FgBM1dIFwHP09Hnw: folds 
Uncalled bet ($1.25) returned to ferjiUxLWPNUKxvl8/xD/g
ferjiUxLWPNUKxvl8/xD/g collected $1.80 from pot
ferjiUxLWPNUKxvl8/xD/g: doesn't show hand 
*** SUMMARY ***
Total pot $1.85 | Rake $0.05 
Board [7s 4c 3s Ah]
Seat 1: /gJNBeCkWL4o85/jvlZ4BA (big blind) folded before Flop
Seat 2: mfrkWA3PTeYPkbO6hi98Aw folded before Flop (didn't bet)
Seat 3: JXSfL0FgBM1dIFwHP09Hnw folded on the Turn
Seat 4: kG34n23qFQA3nzdOJTQ1dA folded before Flop (didn't bet)
Seat 5: ferjiUxLWPNUKxvl8/xD/g (button) collected ($1.80)
Seat 6: 5tB0F9NjPSUL4FzmzBMs2Q (small blind) folded before Flop




PokerStars Game #59939389624:  Hold'em No Limit ($0.10/$0.25) - 2009/07/01 0:38:37 ET
Table '+UzantPJ4smVdrh+4GTu1w' 6-max Seat #3 is the button
Seat 1: 3Bm6SLY1pwRvi98HLQUkvg ($3.65 in chips) 
Seat 2: tcbEu7VzyHQ+0lh+skbQhQ ($10.25 in chips) 
Seat 3: SS/yfeArhULzIcOPe8MdPg ($51.15 in chips) 
Seat 4: 0/dGyX46wFQuMZwX3LgPxg ($9.05 in chips) 
Seat 5: cj4VBQya7HtVL2zCGd5jLQ ($15.10 in chips) 
Seat 6: BYxjLnV1/LL0aZcTbfAOvw ($48.40 in chips) 
0/dGyX46wFQuMZwX3LgPxg: posts small blind $0.10
cj4VBQya7HtVL2zCGd5jLQ: posts big blind $0.25
*** HOLE CARDS ***
BYxjLnV1/LL0aZcTbfAOvw: folds 
3Bm6SLY1pwRvi98HLQUkvg: folds 
tcbEu7VzyHQ+0lh+skbQhQ: folds 
SS/yfeArhULzIcOPe8MdPg: folds 
0/dGyX46wFQuMZwX3LgPxg: folds 
Uncalled bet ($0.15) returned to cj4VBQya7HtVL2zCGd5jLQ
cj4VBQya7HtVL2zCGd5jLQ collected $0.20 from pot
*** SUMMARY ***
Total pot $0.20 | Rake $0 
Seat 1: 3Bm6SLY1pwRvi98HLQUkvg folded before Flop (didn't bet)
Seat 2: tcbEu7VzyHQ+0lh+skbQhQ folded before Flop (didn't bet)
Seat 3: SS/yfeArhULzIcOPe8MdPg (button) folded before Flop (didn't bet)
Seat 4: 0/dGyX46wFQuMZwX3LgPxg (small blind) folded before Flop
Seat 5: cj4VBQya7HtVL2zCGd5jLQ (big blind) collected ($0.20)
Seat 6: BYxjLnV1/LL0aZcTbfAOvw folded before Flop (didn't bet)




PokerStars Game #59939389286:  Hold'em No Limit ($0.10/$0.25) - 2009/07/01 0:38:37 ET
Table 'h3+tJ4Vtwq0R+eA8S73eZA' 9-max Seat #3 is the button
Seat 1: H5Se03ZqSX7tbULXur2MAg ($20.90 in chips) 
Seat 2: Th3FldXKQW6hWVVPahaoOQ ($27.40 in chips) 
Seat 3: crgjVDgmUqCw4RyLzbohWQ ($17 in chips) 
Seat 4: M2QO2DxB5Wawg2h8HSpnYA ($12.05 in chips) 
Seat 5: cZ99hugmLBj9KhTlc8nCSw ($31.80 in chips) 
Seat 6: TvIuLx9zUCE+9Li58iImOQ ($6.95 in chips) 
Seat 7: IIGtqtVGyvZR0ZMYMMPjeQ ($26.65 in chips) 
Seat 8: zWJ/yHAvi0TtCR9RMsJosQ ($24.75 in chips) 
Seat 9: qwr38jl5txoR36M7G5qi4A ($8.05 in chips) 
M2QO2DxB5Wawg2h8HSpnYA: posts small blind $0.10
cZ99hugmLBj9KhTlc8nCSw: posts big blind $0.25
*** HOLE CARDS ***
TvIuLx9zUCE+9Li58iImOQ: folds 
IIGtqtVGyvZR0ZMYMMPjeQ: raises $0.75 to $1
zWJ/yHAvi0TtCR9RMsJosQ: folds 
qwr38jl5txoR36M7G5qi4A: folds 
H5Se03ZqSX7tbULXur2MAg: folds 
Th3FldXKQW6hWVVPahaoOQ: folds 
crgjVDgmUqCw4RyLzbohWQ: folds 
M2QO2DxB5Wawg2h8HSpnYA: folds 
cZ99hugmLBj9KhTlc8nCSw: folds 
Uncalled bet ($0.75) returned to IIGtqtVGyvZR0ZMYMMPjeQ
IIGtqtVGyvZR0ZMYMMPjeQ collected $0.60 from pot
*** SUMMARY ***
Total pot $0.60 | Rake $0 
Seat 1: H5Se03ZqSX7tbULXur2MAg folded before Flop (didn't bet)
Seat 2: Th3FldXKQW6hWVVPahaoOQ folded before Flop (didn't bet)
Seat 3: crgjVDgmUqCw4RyLzbohWQ (button) folded before Flop (didn't bet)
Seat 4: M2QO2DxB5Wawg2h8HSpnYA (small blind) folded before Flop
Seat 5: cZ99hugmLBj9KhTlc8nCSw (big blind) folded before Flop
Seat 6: TvIuLx9zUCE+9Li58iImOQ folded before Flop (didn't bet)
Seat 7: IIGtqtVGyvZR0ZMYMMPjeQ collected ($0.60)
Seat 8: zWJ/yHAvi0TtCR9RMsJosQ folded before Flop (didn't bet)
Seat 9: qwr38jl5txoR36M7G5qi4A folded before Flop (didn't bet)




PokerStars Game #59939389320:  Hold'em No Limit ($0.10/$0.25) - 2009/07/01 0:38:37 ET
Table '+68ihX5Br1xgGorX6zsCBg' 9-max Seat #2 is the button
Seat 1: qwr38jl5txoR36M7G5qi4A ($8.40 in chips) 
Seat 2: 3PjJjazzeHcM4mbFeXmZBg ($8.25 in chips) 
Seat 3: DIBbjEYGs+TVdVgEB/4+3w ($25.50 in chips) 
Seat 4: STkR8XvpjNv79OOMhrlh2w ($25 in chips) 
Seat 5: AmFFUA8KSwLGIW6CfaP4JQ ($12.15 in chips) 
Seat 6: 8B/dhbQjIWe6ASCdgzktNQ ($25.25 in chips) 
Seat 7: LWN1wPrLH+695JIriXxDuw ($9.05 in chips) 
Seat 8: rUdM7gwmNCaxMNSb2CFPhQ ($13.20 in chips) 
Seat 9: 3wk6bqORFdwo0pZ1g2+Kqw ($21.15 in chips) 
DIBbjEYGs+TVdVgEB/4+3w: posts small blind $0.10
STkR8XvpjNv79OOMhrlh2w: posts big blind $0.25
*** HOLE CARDS ***
AmFFUA8KSwLGIW6CfaP4JQ: folds 
8B/dhbQjIWe6ASCdgzktNQ: folds 
LWN1wPrLH+695JIriXxDuw: folds 
rUdM7gwmNCaxMNSb2CFPhQ: folds 
3wk6bqORFdwo0pZ1g2+Kqw: folds 
qwr38jl5txoR36M7G5qi4A: folds 
3PjJjazzeHcM4mbFeXmZBg: raises $0.75 to $1
DIBbjEYGs+TVdVgEB/4+3w: folds 
STkR8XvpjNv79OOMhrlh2w: folds 
Uncalled bet ($0.75) returned to 3PjJjazzeHcM4mbFeXmZBg
3PjJjazzeHcM4mbFeXmZBg collected $0.60 from pot
*** SUMMARY ***
Total pot $0.60 | Rake $0 
Seat 1: qwr38jl5txoR36M7G5qi4A folded before Flop (didn't bet)
Seat 2: 3PjJjazzeHcM4mbFeXmZBg (button) collected ($0.60)
Seat 3: DIBbjEYGs+TVdVgEB/4+3w (small blind) folded before Flop
Seat 4: STkR8XvpjNv79OOMhrlh2w (big blind) folded before Flop
Seat 5: AmFFUA8KSwLGIW6CfaP4JQ folded before Flop (didn't bet)
Seat 6: 8B/dhbQjIWe6ASCdgzktNQ folded before Flop (didn't bet)
Seat 7: LWN1wPrLH+695JIriXxDuw folded before Flop (didn't bet)
Seat 8: rUdM7gwmNCaxMNSb2CFPhQ folded before Flop (didn't bet)
Seat 9: 3wk6bqORFdwo0pZ1g2+Kqw folded before Flop (didn't bet)




PokerStars Game #59939389914:  Hold'em No Limit ($0.10/$0.25) - 2009/07/01 0:38:39 ET
Table 'vud0GB/ZlDCvUFhBFIaTlg' 9-max Seat #7 is the button
Seat 5: AwAabNdwDsTMb3aTomdOmg ($5.45 in chips) 
Seat 7: RzaVufWfW9CTnVYR7/Ge+w ($3.20 in chips) 
RzaVufWfW9CTnVYR7/Ge+w: posts small blind $0.10
AwAabNdwDsTMb3aTomdOmg: posts big blind $0.25
*** HOLE CARDS ***
RzaVufWfW9CTnVYR7/Ge+w: raises $0.25 to $0.50
AwAabNdwDsTMb3aTomdOmg: calls $0.25
*** FLOP *** [Td Th As]
AwAabNdwDsTMb3aTomdOmg: bets $0.25
RzaVufWfW9CTnVYR7/Ge+w: calls $0.25
*** TURN *** [Td Th As] [Kc]
AwAabNdwDsTMb3aTomdOmg: bets $0.25
RzaVufWfW9CTnVYR7/Ge+w: raises $0.25 to $0.50
AwAabNdwDsTMb3aTomdOmg: raises $0.25 to $0.75
RzaVufWfW9CTnVYR7/Ge+w: calls $0.25
*** RIVER *** [Td Th As Kc] [6c]
AwAabNdwDsTMb3aTomdOmg: bets $1.75
RzaVufWfW9CTnVYR7/Ge+w: calls $1.70 and is all-in
Uncalled bet ($0.05) returned to AwAabNdwDsTMb3aTomdOmg
*** SHOW DOWN ***
AwAabNdwDsTMb3aTomdOmg: shows [5h Kh] (two pair, Kings and Tens)
RzaVufWfW9CTnVYR7/Ge+w: shows [Kd Jh] (two pair, Kings and Tens)
AwAabNdwDsTMb3aTomdOmg collected $3.05 from pot
RzaVufWfW9CTnVYR7/Ge+w collected $3.05 from pot
*** SUMMARY ***
Total pot $6.40 | Rake $0.30 
Board [Td Th As Kc 6c]
Seat 5: AwAabNdwDsTMb3aTomdOmg (big blind) showed [5h Kh] and won ($3.05) with two pair, Kings and Tens
Seat 7: RzaVufWfW9CTnVYR7/Ge+w (button) (small blind) showed [Kd Jh] and won ($3.05) with two pair, Kings and Tens




PokerStars Game #59939390390:  Hold'em No Limit ($0.10/$0.25) - 2009/07/01 0:38:39 ET
Table 'yZgGBnUGXVCcEJdcqes8tw' 9-max Seat #5 is the button
Seat 1: SXqVW4Q0evTUVZG6BbUNIA ($24.05 in chips) 
Seat 2: MG90wfSJZnOejs/KD3vlQQ ($25 in chips) 
Seat 3: z5GxcHlYz/GSz6W2uFiTtg ($26.65 in chips) 
Seat 4: opOCI2p6kW0tINuVaAqmcQ ($25 in chips) 
Seat 5: IGz29GAFM1DpSdXX+wXg3g ($16.10 in chips) 
Seat 6: H9i0g723A2AKb4nSMXqMPQ ($20.05 in chips) 
Seat 7: eC8Pn1D6Y2pct8o62nQfvQ ($28.40 in chips) 
Seat 8: dmYlc+1cjwZMJ7wV+Z0rRg ($24.90 in chips) 
Seat 9: M/9j4wkHH9i1JM51vgi1VA ($31.35 in chips) 
H9i0g723A2AKb4nSMXqMPQ: posts small blind $0.10
eC8Pn1D6Y2pct8o62nQfvQ: posts big blind $0.25
*** HOLE CARDS ***
dmYlc+1cjwZMJ7wV+Z0rRg: folds 
M/9j4wkHH9i1JM51vgi1VA: folds 
SXqVW4Q0evTUVZG6BbUNIA: folds 
MG90wfSJZnOejs/KD3vlQQ: folds 
z5GxcHlYz/GSz6W2uFiTtg: folds 
opOCI2p6kW0tINuVaAqmcQ: raises $0.50 to $0.75
IGz29GAFM1DpSdXX+wXg3g: folds 
H9i0g723A2AKb4nSMXqMPQ: folds 
eC8Pn1D6Y2pct8o62nQfvQ: folds 
Uncalled bet ($0.50) returned to opOCI2p6kW0tINuVaAqmcQ
opOCI2p6kW0tINuVaAqmcQ collected $0.60 from pot
opOCI2p6kW0tINuVaAqmcQ: doesn't show hand 
*** SUMMARY ***
Total pot $0.60 | Rake $0 
Seat 1: SXqVW4Q0evTUVZG6BbUNIA folded before Flop (didn't bet)
Seat 2: MG90wfSJZnOejs/KD3vlQQ folded before Flop (didn't bet)
Seat 3: z5GxcHlYz/GSz6W2uFiTtg folded before Flop (didn't bet)
Seat 4: opOCI2p6kW0tINuVaAqmcQ collected ($0.60)
Seat 5: IGz29GAFM1DpSdXX+wXg3g (button) folded before Flop (didn't bet)
Seat 6: H9i0g723A2AKb4nSMXqMPQ (small blind) folded before Flop
Seat 7: eC8Pn1D6Y2pct8o62nQfvQ (big blind) folded before Flop
Seat 8: dmYlc+1cjwZMJ7wV+Z0rRg folded before Flop (didn't bet)
Seat 9: M/9j4wkHH9i1JM51vgi1VA folded before Flop (didn't bet)




PokerStars Game #59939390132:  Hold'em No Limit ($0.10/$0.25) - 2009/07/01 0:38:39 ET
Table 'rpIHGyt2QpgQc5bvptAvDQ' 9-max Seat #1 is the button
Seat 1: pIK8dHf+MqCSMpnx8j9HEw ($9.80 in chips) 
Seat 2: Xpyqpb+DURDWnyJ3xTEIFQ ($26.20 in chips) 
Seat 3: RNWwL4ZL6E6nNwmoYWS4Ug ($13.50 in chips) 
Seat 4: ottZQkg1UDWk85BtBzGJzg ($13.40 in chips) 
Seat 5: F7uW1LiDD9vUDBtB+5gRDg ($14.15 in chips) 
Seat 6: gehe91e0IyVT0QU/XBkEyg ($39.35 in chips) 
Seat 7: SXqVW4Q0evTUVZG6BbUNIA ($37.35 in chips) 
Seat 8: tYsOBqdU1+x+yFI7zHO7hQ ($25 in chips) 
Seat 9: nm4Dj/f+jJEwKVsUnKh73g ($20.75 in chips) 
Xpyqpb+DURDWnyJ3xTEIFQ: posts small blind $0.10
RNWwL4ZL6E6nNwmoYWS4Ug: posts big blind $0.25
*** HOLE CARDS ***
ottZQkg1UDWk85BtBzGJzg: folds 
F7uW1LiDD9vUDBtB+5gRDg: folds 
gehe91e0IyVT0QU/XBkEyg: folds 
SXqVW4Q0evTUVZG6BbUNIA: raises $0.75 to $1
tYsOBqdU1+x+yFI7zHO7hQ: folds 
nm4Dj/f+jJEwKVsUnKh73g: folds 
pIK8dHf+MqCSMpnx8j9HEw: calls $1
Xpyqpb+DURDWnyJ3xTEIFQ: folds 
RNWwL4ZL6E6nNwmoYWS4Ug: folds 
*** FLOP *** [7h 2h 5d]
SXqVW4Q0evTUVZG6BbUNIA: bets $2
pIK8dHf+MqCSMpnx8j9HEw: calls $2
*** TURN *** [7h 2h 5d] [4d]
SXqVW4Q0evTUVZG6BbUNIA: bets $4
pIK8dHf+MqCSMpnx8j9HEw: calls $4
*** RIVER *** [7h 2h 5d 4d] [6s]
SXqVW4Q0evTUVZG6BbUNIA: checks 
pIK8dHf+MqCSMpnx8j9HEw: bets $0.75
SXqVW4Q0evTUVZG6BbUNIA: calls $0.75
*** SHOW DOWN ***
pIK8dHf+MqCSMpnx8j9HEw: shows [2d 8d] (a straight, Four to Eight)
SXqVW4Q0evTUVZG6BbUNIA: mucks hand 
pIK8dHf+MqCSMpnx8j9HEw collected $15.10 from pot
*** SUMMARY ***
Total pot $15.85 | Rake $0.75 
Board [7h 2h 5d 4d 6s]
Seat 1: pIK8dHf+MqCSMpnx8j9HEw (button) showed [2d 8d] and won ($15.10) with a straight, Four to Eight
Seat 2: Xpyqpb+DURDWnyJ3xTEIFQ (small blind) folded before Flop
Seat 3: RNWwL4ZL6E6nNwmoYWS4Ug (big blind) folded before Flop
Seat 4: ottZQkg1UDWk85BtBzGJzg folded before Flop (didn't bet)
Seat 5: F7uW1LiDD9vUDBtB+5gRDg folded before Flop (didn't bet)
Seat 6: gehe91e0IyVT0QU/XBkEyg folded before Flop (didn't bet)
Seat 7: SXqVW4Q0evTUVZG6BbUNIA mucked
Seat 8: tYsOBqdU1+x+yFI7zHO7hQ folded before Flop (didn't bet)
Seat 9: nm4Dj/f+jJEwKVsUnKh73g folded before Flop (didn't bet)




PokerStars Game #59939390416:  Hold'em No Limit ($0.10/$0.25) - 2009/07/01 0:38:39 ET
Table 'G26g8jde1eR+mmabeFeSlw' 9-max Seat #7 is the button
Seat 1: eygIcrabyU9hI2mw7NQsgg ($22 in chips) 
Seat 2: O2aLEhH7P83nWGvgV84KoA ($14.15 in chips) 
Seat 3: WKL8nUFr7TumC4EjLyqYzw ($4.80 in chips) 
Seat 4: 1Clf3cPrqoy/YgvWdWK1Xw ($5 in chips) 
Seat 5: hJ4uYjNmSZdjrKA8cjZqCA ($19 in chips) 
Seat 6: opOCI2p6kW0tINuVaAqmcQ ($25 in chips) 
Seat 7: nm4Dj/f+jJEwKVsUnKh73g ($26.50 in chips) 
Seat 8: G+6mJ0LVzvA9qwETH4Ostw ($25.90 in chips) 
Seat 9: VWUWpMLMj/Q1jRVpF7Aohw ($12.25 in chips) 
G+6mJ0LVzvA9qwETH4Ostw: posts small blind $0.10
VWUWpMLMj/Q1jRVpF7Aohw: posts big blind $0.25
*** HOLE CARDS ***
eygIcrabyU9hI2mw7NQsgg: folds 
O2aLEhH7P83nWGvgV84KoA: folds 
WKL8nUFr7TumC4EjLyqYzw: calls $0.25
1Clf3cPrqoy/YgvWdWK1Xw: folds 
hJ4uYjNmSZdjrKA8cjZqCA: folds 
opOCI2p6kW0tINuVaAqmcQ: folds 
nm4Dj/f+jJEwKVsUnKh73g: calls $0.25
G+6mJ0LVzvA9qwETH4Ostw: calls $0.15
VWUWpMLMj/Q1jRVpF7Aohw: checks 
*** FLOP *** [Ad Tc 7h]
G+6mJ0LVzvA9qwETH4Ostw: checks 
VWUWpMLMj/Q1jRVpF7Aohw: checks 
WKL8nUFr7TumC4EjLyqYzw: bets $0.50
nm4Dj/f+jJEwKVsUnKh73g: folds 
G+6mJ0LVzvA9qwETH4Ostw: folds 
VWUWpMLMj/Q1jRVpF7Aohw: folds 
Uncalled bet ($0.50) returned to WKL8nUFr7TumC4EjLyqYzw
WKL8nUFr7TumC4EjLyqYzw collected $0.95 from pot
*** SUMMARY ***
Total pot $1 | Rake $0.05 
Board [Ad Tc 7h]
Seat 1: eygIcrabyU9hI2mw7NQsgg folded before Flop (didn't bet)
Seat 2: O2aLEhH7P83nWGvgV84KoA folded before Flop (didn't bet)
Seat 3: WKL8nUFr7TumC4EjLyqYzw collected ($0.95)
Seat 4: 1Clf3cPrqoy/YgvWdWK1Xw folded before Flop (didn't bet)
Seat 5: hJ4uYjNmSZdjrKA8cjZqCA folded before Flop (didn't bet)
Seat 6: opOCI2p6kW0tINuVaAqmcQ folded before Flop (didn't bet)
Seat 7: nm4Dj/f+jJEwKVsUnKh73g (button) folded on the Flop
Seat 8: G+6mJ0LVzvA9qwETH4Ostw (small blind) folded on the Flop
Seat 9: VWUWpMLMj/Q1jRVpF7Aohw (big blind) folded on the Flop




PokerStars Game #59939391212:  Hold'em No Limit ($0.10/$0.25) - 2009/07/01 0:38:39 ET
Table '+giHa6FUL6U5/AZnCJEGvQ' 9-max Seat #3 is the button
Seat 1: kYgmoJdHhyWAdwXflGZuKA ($35.45 in chips) 
Seat 2: YN6/TiJBEQVW8LDMQA1vFQ ($9.10 in chips) 
Seat 3: DIBbjEYGs+TVdVgEB/4+3w ($24.15 in chips) 
Seat 4: ljemhp25Zg+nlA9DLCIiUw ($50.45 in chips) 
Seat 5: zDrucyjVn5aeekNEc3cJrA ($46.90 in chips) 
Seat 6: cZ99hugmLBj9KhTlc8nCSw ($25 in chips) 
Seat 7: TeWJxSETzbXGiYKx0y+dtg ($24.55 in chips) 
Seat 8: t2nb95S5EEFOEzNx9Itz0g ($2.60 in chips) 
Seat 9: qwr38jl5txoR36M7G5qi4A ($7.50 in chips) 
ljemhp25Zg+nlA9DLCIiUw: posts small blind $0.10
zDrucyjVn5aeekNEc3cJrA: posts big blind $0.25
*** HOLE CARDS ***
cZ99hugmLBj9KhTlc8nCSw: folds 
TeWJxSETzbXGiYKx0y+dtg: folds 
t2nb95S5EEFOEzNx9Itz0g: folds 
qwr38jl5txoR36M7G5qi4A: folds 
kYgmoJdHhyWAdwXflGZuKA: folds 
YN6/TiJBEQVW8LDMQA1vFQ: calls $0.25
DIBbjEYGs+TVdVgEB/4+3w: folds 
ljemhp25Zg+nlA9DLCIiUw: folds 
zDrucyjVn5aeekNEc3cJrA: checks 
*** FLOP *** [4h Qs 4c]
zDrucyjVn5aeekNEc3cJrA: bets $1.75
YN6/TiJBEQVW8LDMQA1vFQ: folds 
Uncalled bet ($1.75) returned to zDrucyjVn5aeekNEc3cJrA
zDrucyjVn5aeekNEc3cJrA collected $0.60 from pot
*** SUMMARY ***
Total pot $0.60 | Rake $0 
Board [4h Qs 4c]
Seat 1: kYgmoJdHhyWAdwXflGZuKA folded before Flop (didn't bet)
Seat 2: YN6/TiJBEQVW8LDMQA1vFQ folded on the Flop
Seat 3: DIBbjEYGs+TVdVgEB/4+3w (button) folded before Flop (didn't bet)
Seat 4: ljemhp25Zg+nlA9DLCIiUw (small blind) folded before Flop
Seat 5: zDrucyjVn5aeekNEc3cJrA (big blind) collected ($0.60)
Seat 6: cZ99hugmLBj9KhTlc8nCSw folded before Flop (didn't bet)
Seat 7: TeWJxSETzbXGiYKx0y+dtg folded before Flop (didn't bet)
Seat 8: t2nb95S5EEFOEzNx9Itz0g folded before Flop (didn't bet)
Seat 9: qwr38jl5txoR36M7G5qi4A folded before Flop (didn't bet)




PokerStars Game #59939390256:  Hold'em No Limit ($0.10/$0.25) - 2009/07/01 0:38:39 ET
Table 'IRgQPZVA4+IaZZIQshgwyg' 6-max Seat #4 is the button
Seat 1: d0J1xuhsynEY81YHwAvJ5g ($25.35 in chips) 
Seat 2: 9jSiy0meE9XJKkdIZwyTEQ ($34.35 in chips) 
Seat 3: 8EEqTTh7T1q48sYDqbI2Xg ($27.20 in chips) 
Seat 4: PXXRy0uk7WED5BEf+ReJDQ ($14.15 in chips) 
Seat 5: PbMzPZIePKifKQZfKDkbIw ($27.45 in chips) 
Seat 6: qo39V8/pMxxofM2aciLSWQ ($38.20 in chips) 
PbMzPZIePKifKQZfKDkbIw: posts small blind $0.10
qo39V8/pMxxofM2aciLSWQ: posts big blind $0.25
*** HOLE CARDS ***
d0J1xuhsynEY81YHwAvJ5g: folds 
9jSiy0meE9XJKkdIZwyTEQ: raises $0.60 to $0.85
8EEqTTh7T1q48sYDqbI2Xg: calls $0.85
PXXRy0uk7WED5BEf+ReJDQ: folds 
PbMzPZIePKifKQZfKDkbIw: folds 
qo39V8/pMxxofM2aciLSWQ: folds 
*** FLOP *** [3d 3c 8c]
9jSiy0meE9XJKkdIZwyTEQ: bets $1.50
8EEqTTh7T1q48sYDqbI2Xg: folds 
Uncalled bet ($1.50) returned to 9jSiy0meE9XJKkdIZwyTEQ
9jSiy0meE9XJKkdIZwyTEQ collected $1.95 from pot
9jSiy0meE9XJKkdIZwyTEQ: doesn't show hand 
*** SUMMARY ***
Total pot $2.05 | Rake $0.10 
Board [3d 3c 8c]
Seat 1: d0J1xuhsynEY81YHwAvJ5g folded before Flop (didn't bet)
Seat 2: 9jSiy0meE9XJKkdIZwyTEQ collected ($1.95)
Seat 3: 8EEqTTh7T1q48sYDqbI2Xg folded on the Flop
Seat 4: PXXRy0uk7WED5BEf+ReJDQ (button) folded before Flop (didn't bet)
Seat 5: PbMzPZIePKifKQZfKDkbIw (small blind) folded before Flop
Seat 6: qo39V8/pMxxofM2aciLSWQ (big blind) folded before Flop




PokerStars Game #59939391122:  Hold'em No Limit ($0.10/$0.25) - 2009/07/01 0:38:39 ET
Table 'vFZR6Kf2Th5xBXT9brGW6A' 6-max Seat #2 is the button
Seat 1: xRkU4+naLuz7dEZFbOn9cw ($35.30 in chips) 
Seat 2: REnO5xiZ66YabxDXq2ncvA ($51.70 in chips) 
Seat 4: 79ID/ub1Pt/mDpCprVmOoA ($25 in chips) 
Seat 5: NhUN/JpAprdJeamFBgJH1w ($25.35 in chips) 
Seat 6: d0J1xuhsynEY81YHwAvJ5g ($25 in chips) 
79ID/ub1Pt/mDpCprVmOoA: posts small blind $0.10
NhUN/JpAprdJeamFBgJH1w: posts big blind $0.25
*** HOLE CARDS ***
d0J1xuhsynEY81YHwAvJ5g: folds 
xRkU4+naLuz7dEZFbOn9cw: folds 
REnO5xiZ66YabxDXq2ncvA: folds 
79ID/ub1Pt/mDpCprVmOoA: folds 
Uncalled bet ($0.15) returned to NhUN/JpAprdJeamFBgJH1w
NhUN/JpAprdJeamFBgJH1w collected $0.20 from pot
NhUN/JpAprdJeamFBgJH1w: doesn't show hand 
*** SUMMARY ***
Total pot $0.20 | Rake $0 
Seat 1: xRkU4+naLuz7dEZFbOn9cw folded before Flop (didn't bet)
Seat 2: REnO5xiZ66YabxDXq2ncvA (button) folded before Flop (didn't bet)
Seat 4: 79ID/ub1Pt/mDpCprVmOoA (small blind) folded before Flop
Seat 5: NhUN/JpAprdJeamFBgJH1w (big blind) collected ($0.20)
Seat 6: d0J1xuhsynEY81YHwAvJ5g folded before Flop (didn't bet)




PokerStars Game #59939391660:  Hold'em No Limit ($0.10/$0.25) - 2009/07/01 0:38:40 ET
Table 'o0CDOvKO/bn1WjeymDrXfA' 6-max Seat #6 is the button
Seat 1: 32YL2ZEp8NT4JB2RVM9euQ ($16.10 in chips) 
Seat 2: oc4ZGs0W+3RIg2yPyJw3ig ($24.75 in chips) 
Seat 3: EqXTTLKUlDlz7yi6ziyyWA ($10 in chips) 
Seat 4: WvQKBeYmHv0ZkY7uzfWAAw ($13.90 in chips) 
Seat 5: u/yN5P9f3KlATg6WLWNkBQ ($29.60 in chips) 
Seat 6: Bada343Si4xKu3fNXY99AA ($20.95 in chips) 
32YL2ZEp8NT4JB2RVM9euQ: posts small blind $0.10
oc4ZGs0W+3RIg2yPyJw3ig: posts big blind $0.25
*** HOLE CARDS ***
EqXTTLKUlDlz7yi6ziyyWA: calls $0.25
WvQKBeYmHv0ZkY7uzfWAAw: raises $0.50 to $0.75
u/yN5P9f3KlATg6WLWNkBQ: folds 
Bada343Si4xKu3fNXY99AA: folds 
32YL2ZEp8NT4JB2RVM9euQ: folds 
oc4ZGs0W+3RIg2yPyJw3ig: calls $0.50
EqXTTLKUlDlz7yi6ziyyWA: calls $0.50
*** FLOP *** [5h Td Js]
oc4ZGs0W+3RIg2yPyJw3ig: checks 
EqXTTLKUlDlz7yi6ziyyWA: checks 
WvQKBeYmHv0ZkY7uzfWAAw: bets $1
oc4ZGs0W+3RIg2yPyJw3ig: calls $1
EqXTTLKUlDlz7yi6ziyyWA: folds 
*** TURN *** [5h Td Js] [2h]
oc4ZGs0W+3RIg2yPyJw3ig: checks 
WvQKBeYmHv0ZkY7uzfWAAw: bets $1.75
oc4ZGs0W+3RIg2yPyJw3ig: calls $1.75
*** RIVER *** [5h Td Js 2h] [5c]
oc4ZGs0W+3RIg2yPyJw3ig: checks 
WvQKBeYmHv0ZkY7uzfWAAw: bets $2.50
oc4ZGs0W+3RIg2yPyJw3ig: calls $2.50
*** SHOW DOWN ***
WvQKBeYmHv0ZkY7uzfWAAw: shows [Kc 9h] (a pair of Fives)
oc4ZGs0W+3RIg2yPyJw3ig: shows [Jc As] (two pair, Jacks and Fives)
oc4ZGs0W+3RIg2yPyJw3ig collected $12.25 from pot
*** SUMMARY ***
Total pot $12.85 | Rake $0.60 
Board [5h Td Js 2h 5c]
Seat 1: 32YL2ZEp8NT4JB2RVM9euQ (small blind) folded before Flop
Seat 2: oc4ZGs0W+3RIg2yPyJw3ig (big blind) showed [Jc As] and won ($12.25) with two pair, Jacks and Fives
Seat 3: EqXTTLKUlDlz7yi6ziyyWA folded on the Flop
Seat 4: WvQKBeYmHv0ZkY7uzfWAAw showed [Kc 9h] and lost with a pair of Fives
Seat 5: u/yN5P9f3KlATg6WLWNkBQ folded before Flop (didn't bet)
Seat 6: Bada343Si4xKu3fNXY99AA (button) folded before Flop (didn't bet)




PokerStars Game #59939391834:  Hold'em No Limit ($0.10/$0.25) - 2009/07/01 0:38:40 ET
Table 'JYkCJJ5Iv+Tu52jx2lpEcgT/iCKJXGphRN3xcdwfE/JQSeat #7 is the button
Seat 1: Yv4fucyyT28mjx8V5lxKJg ($27.25 in chips) 
Seat 2: hBMUlEpyU74r/fwDgIpXjQ ($35.60 in chips) 
Seat 3: Z5ZtGOON8kmSdSCll9Z3XA ($7.25 in chips) 
Seat 4: +C3eP/ysyROWbEXJFPswVA ($24.05 in chips) 
Seat 5: 6OVSxS1KoddUCYNkZ4hREw ($28.60 in chips) 
Seat 6: OiV1PWZ3IkN29JlmCcnTwQ ($5 in chips) 
Seat 7: N6fYvIzQLKaydFLKQGtMlQ ($24.40 in chips) 
Seat 8: COsrwJSFHQtxlUcrYtDQPQ ($25 in chips) 
Seat 9: H9KUl8cmpLgEpOVDA00bCg ($5.50 in chips) 
COsrwJSFHQtxlUcrYtDQPQ: posts small blind $0.10
H9KUl8cmpLgEpOVDA00bCg: posts big blind $0.25
*** HOLE CARDS ***
Yv4fucyyT28mjx8V5lxKJg: folds 
hBMUlEpyU74r/fwDgIpXjQ: folds 
Z5ZtGOON8kmSdSCll9Z3XA: folds 
+C3eP/ysyROWbEXJFPswVA is disconnected 
+C3eP/ysyROWbEXJFPswVA has timed out while disconnected
+C3eP/ysyROWbEXJFPswVA: folds 
+C3eP/ysyROWbEXJFPswVA is sitting out
6OVSxS1KoddUCYNkZ4hREw: folds 
OiV1PWZ3IkN29JlmCcnTwQ: folds 
N6fYvIzQLKaydFLKQGtMlQ: calls $0.25
COsrwJSFHQtxlUcrYtDQPQ: calls $0.15
H9KUl8cmpLgEpOVDA00bCg: checks 
*** FLOP *** [8s 3c Th]
COsrwJSFHQtxlUcrYtDQPQ: checks 
H9KUl8cmpLgEpOVDA00bCg: checks 
N6fYvIzQLKaydFLKQGtMlQ: bets $0.75
COsrwJSFHQtxlUcrYtDQPQ: folds 
H9KUl8cmpLgEpOVDA00bCg: folds 
Uncalled bet ($0.75) returned to N6fYvIzQLKaydFLKQGtMlQ
N6fYvIzQLKaydFLKQGtMlQ collected $0.75 from pot
*** SUMMARY ***
Total pot $0.75 | Rake $0 
Board [8s 3c Th]
Seat 1: Yv4fucyyT28mjx8V5lxKJg folded before Flop (didn't bet)
Seat 2: hBMUlEpyU74r/fwDgIpXjQ folded before Flop (didn't bet)
Seat 3: Z5ZtGOON8kmSdSCll9Z3XA folded before Flop (didn't bet)
Seat 4: +C3eP/ysyROWbEXJFPswVA folded before Flop (didn't bet)
Seat 5: 6OVSxS1KoddUCYNkZ4hREw folded before Flop (didn't bet)
Seat 6: OiV1PWZ3IkN29JlmCcnTwQ folded before Flop (didn't bet)
Seat 7: N6fYvIzQLKaydFLKQGtMlQ (button) collected ($0.75)
Seat 8: COsrwJSFHQtxlUcrYtDQPQ (small blind) folded on the Flop
Seat 9: H9KUl8cmpLgEpOVDA00bCg (big blind) folded on the Flop




PokerStars Game #59939391806:  Hold'em No Limit ($0.10/$0.25) - 2009/07/01 0:38:40 ET
Table 'M8kYidAX3ib7pLKW7edFLw' 6-max Seat #5 is the button
Seat 1: 4YSTu0Cdzpppe1lUgCZGCQ ($40 in chips) 
Seat 2: sbFQMajC1QuRxa8Jly3usQ ($24.05 in chips) 
Seat 4: /bjna2FTN7pPjqYGzmDE0Q ($23.05 in chips) 
Seat 5: bDKopKTvPi3W+PEnYUX3tg ($27.95 in chips) 
4YSTu0Cdzpppe1lUgCZGCQ: posts small blind $0.10
sbFQMajC1QuRxa8Jly3usQ: posts big blind $0.25
*** HOLE CARDS ***
/bjna2FTN7pPjqYGzmDE0Q: raises $0.45 to $0.70
bDKopKTvPi3W+PEnYUX3tg: folds 
4YSTu0Cdzpppe1lUgCZGCQ: folds 
sbFQMajC1QuRxa8Jly3usQ: folds 
Uncalled bet ($0.45) returned to /bjna2FTN7pPjqYGzmDE0Q
/bjna2FTN7pPjqYGzmDE0Q collected $0.60 from pot
/bjna2FTN7pPjqYGzmDE0Q: doesn't show hand 
*** SUMMARY ***
Total pot $0.60 | Rake $0 
Seat 1: 4YSTu0Cdzpppe1lUgCZGCQ (small blind) folded before Flop
Seat 2: sbFQMajC1QuRxa8Jly3usQ (big blind) folded before Flop
Seat 4: /bjna2FTN7pPjqYGzmDE0Q collected ($0.60)
Seat 5: bDKopKTvPi3W+PEnYUX3tg (button) folded before Flop (didn't bet)




PokerStars Game #59939391284:  Hold'em No Limit ($0.10/$0.25) - 2009/07/01 0:38:40 ET
Table 'nlpa8xI95gAflovnFxB2yg' 6-max Seat #6 is the button
Seat 1: fZQg9veL7Dd/Z04ZTjC+wQ ($65.80 in chips) 
Seat 3: I1TxPvWj8NfG8orglCinNA ($25 in chips) 
Seat 4: 5xjU9nfIjn1MBxIJKZvS5w ($29.85 in chips) 
Seat 6: FPlQHZog0ePFCETQ2KG4hQ ($26.25 in chips) 
fZQg9veL7Dd/Z04ZTjC+wQ: posts small blind $0.10
PIOdknsVyjKUwfiImc3zwg: is sitting out 
I1TxPvWj8NfG8orglCinNA: posts big blind $0.25
PIOdknsVyjKUwfiImc3zwg leaves the table
HotTillt: sits out 
*** HOLE CARDS ***
5xjU9nfIjn1MBxIJKZvS5w: calls $0.25
FPlQHZog0ePFCETQ2KG4hQ: folds 
WrLI51S2iMb8GLMB83gGqA joins the table at seat #2 
fZQg9veL7Dd/Z04ZTjC+wQ: folds 
I1TxPvWj8NfG8orglCinNA: checks 
*** FLOP *** [9s 8d Jc]
I1TxPvWj8NfG8orglCinNA: checks 
5xjU9nfIjn1MBxIJKZvS5w: checks 
*** TURN *** [9s 8d Jc] [Kh]
I1TxPvWj8NfG8orglCinNA: checks 
5xjU9nfIjn1MBxIJKZvS5w: bets $0.25
I1TxPvWj8NfG8orglCinNA: folds 
Uncalled bet ($0.25) returned to 5xjU9nfIjn1MBxIJKZvS5w
5xjU9nfIjn1MBxIJKZvS5w collected $0.60 from pot
5xjU9nfIjn1MBxIJKZvS5w: doesn't show hand 
*** SUMMARY ***
Total pot $0.60 | Rake $0 
Board [9s 8d Jc Kh]
Seat 1: fZQg9veL7Dd/Z04ZTjC+wQ (small blind) folded before Flop
Seat 3: I1TxPvWj8NfG8orglCinNA (big blind) folded on the Turn
Seat 4: 5xjU9nfIjn1MBxIJKZvS5w collected ($0.60)
Seat 6: FPlQHZog0ePFCETQ2KG4hQ (button) folded before Flop (didn't bet)




PokerStars Game #59939392172:  Hold'em No Limit ($0.10/$0.25) - 2009/07/01 0:38:41 ET
Table '8Z6T3ssCpo3VV849U4RgBw' 9-max Seat #6 is the button
Seat 1: 8dNQBtNvCvzVgSnmDgi/LA ($12 in chips) 
Seat 2: st9jtdNbm1W5GfBwRaCVqQ ($25.80 in chips) 
Seat 3: DdPXdieucQ+n99u1n3A+rQ ($3.95 in chips) 
Seat 4: swWFmLwqgpSU1P6HAmCGPw ($17 in chips) 
Seat 5: zDrucyjVn5aeekNEc3cJrA ($23.55 in chips) 
Seat 6: SXqVW4Q0evTUVZG6BbUNIA ($33.05 in chips) 
Seat 7: VBHxUExRAMrbxUq/cVx9Gw ($4.75 in chips) 
Seat 8: hPhp/RE3cJ5YGaQ2xOHXXg ($5.25 in chips) 
Seat 9: yfkbMbx4w7MXhQDFPxOq0A ($12.05 in chips) 
VBHxUExRAMrbxUq/cVx9Gw: posts small blind $0.10
hPhp/RE3cJ5YGaQ2xOHXXg: posts big blind $0.25
*** HOLE CARDS ***
yfkbMbx4w7MXhQDFPxOq0A: calls $0.25
8dNQBtNvCvzVgSnmDgi/LA: folds 
st9jtdNbm1W5GfBwRaCVqQ: folds 
DdPXdieucQ+n99u1n3A+rQ: folds 
swWFmLwqgpSU1P6HAmCGPw: calls $0.25
zDrucyjVn5aeekNEc3cJrA: folds 
SXqVW4Q0evTUVZG6BbUNIA: folds 
VBHxUExRAMrbxUq/cVx9Gw: folds 
hPhp/RE3cJ5YGaQ2xOHXXg: checks 
*** FLOP *** [9s 8c 5d]
hPhp/RE3cJ5YGaQ2xOHXXg: checks 
yfkbMbx4w7MXhQDFPxOq0A: bets $0.50
swWFmLwqgpSU1P6HAmCGPw: folds 
hPhp/RE3cJ5YGaQ2xOHXXg: folds 
Uncalled bet ($0.50) returned to yfkbMbx4w7MXhQDFPxOq0A
yfkbMbx4w7MXhQDFPxOq0A collected $0.85 from pot
*** SUMMARY ***
Total pot $0.85 | Rake $0 
Board [9s 8c 5d]
Seat 1: 8dNQBtNvCvzVgSnmDgi/LA folded before Flop (didn't bet)
Seat 2: st9jtdNbm1W5GfBwRaCVqQ folded before Flop (didn't bet)
Seat 3: DdPXdieucQ+n99u1n3A+rQ folded before Flop (didn't bet)
Seat 4: swWFmLwqgpSU1P6HAmCGPw folded on the Flop
Seat 5: zDrucyjVn5aeekNEc3cJrA folded before Flop (didn't bet)
Seat 6: SXqVW4Q0evTUVZG6BbUNIA (button) folded before Flop (didn't bet)
Seat 7: VBHxUExRAMrbxUq/cVx9Gw (small blind) folded before Flop
Seat 8: hPhp/RE3cJ5YGaQ2xOHXXg (big blind) folded on the Flop
Seat 9: yfkbMbx4w7MXhQDFPxOq0A collected ($0.85)




PokerStars Game #59939392176:  Hold'em No Limit ($0.10/$0.25) - 2009/07/01 0:38:41 ET
Table 'GxdLtCpYxqT4aAbYqkEEpw' 6-max Seat #3 is the button
Seat 1: heEf/FkFGS9M1NmwH97YIA ($41.60 in chips) 
Seat 2: hADMNbkECXMb2C/C8R2Wlw ($23.15 in chips) 
Seat 3: 9jSiy0meE9XJKkdIZwyTEQ ($33.55 in chips) 
Seat 4: ErIN0JRL5srYjT6en1f8YQ ($24.30 in chips) 
Seat 5: q6WfTUAD9mowIP63ASq2Dg ($41.10 in chips) 
Seat 6: aogAb4Eienxztk8p2v9VVw ($26.75 in chips) 
ErIN0JRL5srYjT6en1f8YQ: posts small blind $0.10
q6WfTUAD9mowIP63ASq2Dg: posts big blind $0.25
*** HOLE CARDS ***
aogAb4Eienxztk8p2v9VVw: folds 
heEf/FkFGS9M1NmwH97YIA: calls $0.25
hADMNbkECXMb2C/C8R2Wlw: folds 
9jSiy0meE9XJKkdIZwyTEQ: folds 
ErIN0JRL5srYjT6en1f8YQ: folds 
q6WfTUAD9mowIP63ASq2Dg: checks 
*** FLOP *** [Jd 5d 9d]
q6WfTUAD9mowIP63ASq2Dg: checks 
heEf/FkFGS9M1NmwH97YIA: bets $0.25
q6WfTUAD9mowIP63ASq2Dg: folds 
Uncalled bet ($0.25) returned to heEf/FkFGS9M1NmwH97YIA
heEf/FkFGS9M1NmwH97YIA collected $0.60 from pot
heEf/FkFGS9M1NmwH97YIA: doesn't show hand 
*** SUMMARY ***
Total pot $0.60 | Rake $0 
Board [Jd 5d 9d]
Seat 1: heEf/FkFGS9M1NmwH97YIA collected ($0.60)
Seat 2: hADMNbkECXMb2C/C8R2Wlw folded before Flop (didn't bet)
Seat 3: 9jSiy0meE9XJKkdIZwyTEQ (button) folded before Flop (didn't bet)
Seat 4: ErIN0JRL5srYjT6en1f8YQ (small blind) folded before Flop
Seat 5: q6WfTUAD9mowIP63ASq2Dg (big blind) folded on the Flop
Seat 6: aogAb4Eienxztk8p2v9VVw folded before Flop (didn't bet)




PokerStars Game #59939391974:  Hold'em No Limit ($0.10/$0.25) - 2009/07/01 0:38:41 ET
Table '5VWnrlxdjwVfMWkVS2WE7A' 6-max Seat #2 is the button
Seat 1: BiLBinPhgpKAYzLgKJVU5A ($21.95 in chips) 
Seat 2: ELW+DKizJhLK7k40PMkD2Q ($24.65 in chips) 
Seat 3: cPO/1/dTcZpLkQFm3jH3Rg ($25 in chips) 
Seat 4: WZv4aSGl7ETtI/Z5BPKi7w ($34.35 in chips) 
Seat 5: JQZew0FjzS19kTjeNtrE+A ($40.55 in chips) 
Seat 6: LtASJ9OlkqGrrUKGQlpGAw ($20.75 in chips) 
cPO/1/dTcZpLkQFm3jH3Rg: posts small blind $0.10
WZv4aSGl7ETtI/Z5BPKi7w: posts big blind $0.25
*** HOLE CARDS ***
JQZew0FjzS19kTjeNtrE+A: calls $0.25
LtASJ9OlkqGrrUKGQlpGAw: folds 
BiLBinPhgpKAYzLgKJVU5A: folds 
ELW+DKizJhLK7k40PMkD2Q: folds 
cPO/1/dTcZpLkQFm3jH3Rg: folds 
WZv4aSGl7ETtI/Z5BPKi7w: checks 
*** FLOP *** [8s Ad 2c]
WZv4aSGl7ETtI/Z5BPKi7w: checks 
JQZew0FjzS19kTjeNtrE+A: bets $0.50
WZv4aSGl7ETtI/Z5BPKi7w: calls $0.50
*** TURN *** [8s Ad 2c] [Ts]
WZv4aSGl7ETtI/Z5BPKi7w: checks 
JQZew0FjzS19kTjeNtrE+A: bets $1
WZv4aSGl7ETtI/Z5BPKi7w: raises $1 to $2
JQZew0FjzS19kTjeNtrE+A: calls $1
*** RIVER *** [8s Ad 2c Ts] [4d]
WZv4aSGl7ETtI/Z5BPKi7w: checks 
JQZew0FjzS19kTjeNtrE+A: bets $2.75
WZv4aSGl7ETtI/Z5BPKi7w: calls $2.75
*** SHOW DOWN ***
JQZew0FjzS19kTjeNtrE+A: shows [8d Td] (two pair, Tens and Eights)
WZv4aSGl7ETtI/Z5BPKi7w: mucks hand 
JQZew0FjzS19kTjeNtrE+A collected $10.60 from pot
*** SUMMARY ***
Total pot $11.10 | Rake $0.50 
Board [8s Ad 2c Ts 4d]
Seat 1: BiLBinPhgpKAYzLgKJVU5A folded before Flop (didn't bet)
Seat 2: ELW+DKizJhLK7k40PMkD2Q (button) folded before Flop (didn't bet)
Seat 3: cPO/1/dTcZpLkQFm3jH3Rg (small blind) folded before Flop
Seat 4: WZv4aSGl7ETtI/Z5BPKi7w (big blind) mucked
Seat 5: JQZew0FjzS19kTjeNtrE+A showed [8d Td] and won ($10.60) with two pair, Tens and Eights
Seat 6: LtASJ9OlkqGrrUKGQlpGAw folded before Flop (didn't bet)




PokerStars Game #59939392534:  Hold'em No Limit ($0.10/$0.25) - 2009/07/01 0:38:41 ET
Table 'VQNfcI8vTBCTvRfd3veTLQ' 6-max Seat #3 is the button
Seat 1: ymz+a8dgHSUFPooYplw7Ow ($23.50 in chips) 
Seat 2: KukIGupqqJCXA+Hp2bEFnA ($6.70 in chips) 
Seat 3: LtASJ9OlkqGrrUKGQlpGAw ($23.40 in chips) 
Seat 4: nc79pm0LZRdhncq55evVqA ($25.90 in chips) 
Seat 5: gX2vbKwS/8zZPENAWB7hxQ ($7.65 in chips) 
Seat 6: dlCLwmcvRShnuFDEVkdIEA ($15.10 in chips) 
nc79pm0LZRdhncq55evVqA: posts small blind $0.10
gX2vbKwS/8zZPENAWB7hxQ: posts big blind $0.25
*** HOLE CARDS ***
dlCLwmcvRShnuFDEVkdIEA: folds 
ymz+a8dgHSUFPooYplw7Ow: folds 
KukIGupqqJCXA+Hp2bEFnA: folds 
LtASJ9OlkqGrrUKGQlpGAw: folds 
nc79pm0LZRdhncq55evVqA: folds 
Uncalled bet ($0.15) returned to gX2vbKwS/8zZPENAWB7hxQ
gX2vbKwS/8zZPENAWB7hxQ collected $0.20 from pot
*** SUMMARY ***
Total pot $0.20 | Rake $0 
Seat 1: ymz+a8dgHSUFPooYplw7Ow folded before Flop (didn't bet)
Seat 2: KukIGupqqJCXA+Hp2bEFnA folded before Flop (didn't bet)
Seat 3: LtASJ9OlkqGrrUKGQlpGAw (button) folded before Flop (didn't bet)
Seat 4: nc79pm0LZRdhncq55evVqA (small blind) folded before Flop
Seat 5: gX2vbKwS/8zZPENAWB7hxQ (big blind) collected ($0.20)
Seat 6: dlCLwmcvRShnuFDEVkdIEA folded before Flop (didn't bet)




PokerStars Game #59939392304:  Hold'em No Limit ($0.10/$0.25) - 2009/07/01 0:38:41 ET
Table 'a0kk1yz54EMczhut3KjrxQ' 6-max Seat #3 is the button
Seat 1: V3LJvbHVJHmOj2fd7zIDhA ($29.25 in chips) 
Seat 2: nc79pm0LZRdhncq55evVqA ($25 in chips) 
Seat 3: FabaCGPqGJLjRL48CMvjiQ ($23.75 in chips) 
Seat 4: FYepjhAvF8ZdVCmqHIy+eQ ($26.80 in chips) 
Seat 5: cPO/1/dTcZpLkQFm3jH3Rg ($25 in chips) 
Seat 6: DTzxFTXVrCqrpjq9B9Vg/g ($14.75 in chips) 
FYepjhAvF8ZdVCmqHIy+eQ: posts small blind $0.10
cPO/1/dTcZpLkQFm3jH3Rg: posts big blind $0.25
*** HOLE CARDS ***
DTzxFTXVrCqrpjq9B9Vg/g: calls $0.25
V3LJvbHVJHmOj2fd7zIDhA: folds 
nc79pm0LZRdhncq55evVqA: folds 
FabaCGPqGJLjRL48CMvjiQ: calls $0.25
FYepjhAvF8ZdVCmqHIy+eQ: folds 
cPO/1/dTcZpLkQFm3jH3Rg: checks 
*** FLOP *** [8c Th Tc]
cPO/1/dTcZpLkQFm3jH3Rg: checks 
DTzxFTXVrCqrpjq9B9Vg/g: checks 
FabaCGPqGJLjRL48CMvjiQ: checks 
*** TURN *** [8c Th Tc] [Jc]
cPO/1/dTcZpLkQFm3jH3Rg: checks 
DTzxFTXVrCqrpjq9B9Vg/g: checks 
FabaCGPqGJLjRL48CMvjiQ: checks 
*** RIVER *** [8c Th Tc Jc] [9h]
cPO/1/dTcZpLkQFm3jH3Rg: checks 
DTzxFTXVrCqrpjq9B9Vg/g: bets $2.25
FabaCGPqGJLjRL48CMvjiQ: folds 
cPO/1/dTcZpLkQFm3jH3Rg: folds 
Uncalled bet ($2.25) returned to DTzxFTXVrCqrpjq9B9Vg/g
DTzxFTXVrCqrpjq9B9Vg/g collected $0.85 from pot
*** SUMMARY ***
Total pot $0.85 | Rake $0 
Board [8c Th Tc Jc 9h]
Seat 1: V3LJvbHVJHmOj2fd7zIDhA folded before Flop (didn't bet)
Seat 2: nc79pm0LZRdhncq55evVqA folded before Flop (didn't bet)
Seat 3: FabaCGPqGJLjRL48CMvjiQ (button) folded on the River
Seat 4: FYepjhAvF8ZdVCmqHIy+eQ (small blind) folded before Flop
Seat 5: cPO/1/dTcZpLkQFm3jH3Rg (big blind) folded on the River
Seat 6: DTzxFTXVrCqrpjq9B9Vg/g collected ($0.85)




PokerStars Game #59939392542:  Hold'em No Limit ($0.10/$0.25) - 2009/07/01 0:38:41 ET
Table '+198VWQSWBhYQOcizzuBkw' 6-max Seat #5 is the button
Seat 2: R6AGToFJQOYVZAjC2jXEKw ($29.40 in chips) 
Seat 3: BYxjLnV1/LL0aZcTbfAOvw ($27.25 in chips) 
Seat 4: TgDsTeCdLQt8kWbL00ByRA ($27.60 in chips) 
Seat 5: LtASJ9OlkqGrrUKGQlpGAw ($30.30 in chips) 
Seat 6: 7qRk4YH4/k/08LgJSv7rBQ ($30.65 in chips) 
7qRk4YH4/k/08LgJSv7rBQ: posts small blind $0.10
R6AGToFJQOYVZAjC2jXEKw: posts big blind $0.25
*** HOLE CARDS ***
BYxjLnV1/LL0aZcTbfAOvw: raises $0.75 to $1
TgDsTeCdLQt8kWbL00ByRA: folds 
LtASJ9OlkqGrrUKGQlpGAw: folds 
7qRk4YH4/k/08LgJSv7rBQ: folds 
R6AGToFJQOYVZAjC2jXEKw: folds 
Uncalled bet ($0.75) returned to BYxjLnV1/LL0aZcTbfAOvw
BYxjLnV1/LL0aZcTbfAOvw collected $0.60 from pot
BYxjLnV1/LL0aZcTbfAOvw: doesn't show hand 
*** SUMMARY ***
Total pot $0.60 | Rake $0 
Seat 2: R6AGToFJQOYVZAjC2jXEKw (big blind) folded before Flop
Seat 3: BYxjLnV1/LL0aZcTbfAOvw collected ($0.60)
Seat 4: TgDsTeCdLQt8kWbL00ByRA folded before Flop (didn't bet)
Seat 5: LtASJ9OlkqGrrUKGQlpGAw (button) folded before Flop (didn't bet)
Seat 6: 7qRk4YH4/k/08LgJSv7rBQ (small blind) folded before Flop




PokerStars Game #59939392168:  Hold'em No Limit ($0.10/$0.25) - 2009/07/01 0:38:41 ET
Table '9L7XfAwuM7XsXE8LIg2o5Q' 6-max Seat #1 is the button
Seat 1: H6XbZVba2aKDXlG0la0uow ($9 in chips) 
Seat 2: oseFhpinoe+Zg4j5xyBjyQ ($6.50 in chips) 
Seat 3: 9StOHp+Y1T0K13JdgS2oQQ ($7.10 in chips) 
Seat 4: xBOVv8xEXtymVpAA5ZajSw ($82.15 in chips) 
Seat 6: k9nHZTHt8hYhYRcW8NTb4g ($29.45 in chips) 
oseFhpinoe+Zg4j5xyBjyQ: posts small blind $0.10
9StOHp+Y1T0K13JdgS2oQQ: posts big blind $0.25
*** HOLE CARDS ***
xBOVv8xEXtymVpAA5ZajSw: folds 
k9nHZTHt8hYhYRcW8NTb4g: folds 
H6XbZVba2aKDXlG0la0uow: raises $0.75 to $1
oseFhpinoe+Zg4j5xyBjyQ: folds 
9StOHp+Y1T0K13JdgS2oQQ: folds 
Uncalled bet ($0.75) returned to H6XbZVba2aKDXlG0la0uow
H6XbZVba2aKDXlG0la0uow collected $0.60 from pot
H6XbZVba2aKDXlG0la0uow: doesn't show hand 
*** SUMMARY ***
Total pot $0.60 | Rake $0 
Seat 1: H6XbZVba2aKDXlG0la0uow (button) collected ($0.60)
Seat 2: oseFhpinoe+Zg4j5xyBjyQ (small blind) folded before Flop
Seat 3: 9StOHp+Y1T0K13JdgS2oQQ (big blind) folded before Flop
Seat 4: xBOVv8xEXtymVpAA5ZajSw folded before Flop (didn't bet)
Seat 6: k9nHZTHt8hYhYRcW8NTb4g folded before Flop (didn't bet)




PokerStars Game #59939392174:  Hold'em No Limit ($0.10/$0.25) - 2009/07/01 0:38:41 ET
Table 'CBnRhp0d6E2+/NtM7Vbruw' 9-max Seat #4 is the button
Seat 2: DIBbjEYGs+TVdVgEB/4+3w ($36.15 in chips) 
Seat 4: FR1anYnrxOdUfdNDELZ4SQ ($19.50 in chips) 
Seat 5: R6nIVAjK7uhK3Hj0f85A+A ($23.30 in chips) 
Seat 7: 40uIA6odSc6GeRu392xZTA ($32.20 in chips) 
Seat 8: MG90wfSJZnOejs/KD3vlQQ ($36.05 in chips) 
R6nIVAjK7uhK3Hj0f85A+A: posts small blind $0.10
40uIA6odSc6GeRu392xZTA: posts big blind $0.25
BHKu5wmAIC0UlfmA78se7A: sits out 
*** HOLE CARDS ***
MG90wfSJZnOejs/KD3vlQQ: folds 
WQe4GbiYBiPsb5WKFKkijQ has returned
DIBbjEYGs+TVdVgEB/4+3w: folds 
FR1anYnrxOdUfdNDELZ4SQ: folds 
R6nIVAjK7uhK3Hj0f85A+A: raises $0.50 to $0.75
40uIA6odSc6GeRu392xZTA: folds 
Uncalled bet ($0.50) returned to R6nIVAjK7uhK3Hj0f85A+A
R6nIVAjK7uhK3Hj0f85A+A collected $0.50 from pot
R6nIVAjK7uhK3Hj0f85A+A: doesn't show hand 
*** SUMMARY ***
Total pot $0.50 | Rake $0 
Seat 2: DIBbjEYGs+TVdVgEB/4+3w folded before Flop (didn't bet)
Seat 4: FR1anYnrxOdUfdNDELZ4SQ (button) folded before Flop (didn't bet)
Seat 5: R6nIVAjK7uhK3Hj0f85A+A (small blind) collected ($0.50)
Seat 7: 40uIA6odSc6GeRu392xZTA (big blind) folded before Flop
Seat 8: MG90wfSJZnOejs/KD3vlQQ folded before Flop (didn't bet)




PokerStars Game #59939391996:  Hold'em No Limit ($0.10/$0.25) - 2009/07/01 0:38:41 ET
Table 'LXz5SsUCyWcm+4JDJh466A' 9-max Seat #8 is the button
Seat 1: MG90wfSJZnOejs/KD3vlQQ ($23.60 in chips) 
Seat 2: H5Se03ZqSX7tbULXur2MAg ($24.50 in chips) 
Seat 5: OiV1PWZ3IkN29JlmCcnTwQ ($5.10 in chips) 
Seat 6: opOCI2p6kW0tINuVaAqmcQ ($25 in chips) 
Seat 7: EnNp9cILTCYQ95g+8MNFGw ($29.75 in chips) 
Seat 8: VlJdQJbqyBs3oxP5BIw7jA ($95.30 in chips) 
Seat 9: 2N94FgK4Y2izKFIB+wJOjw ($11 in chips) 
2N94FgK4Y2izKFIB+wJOjw: posts small blind $0.10
MG90wfSJZnOejs/KD3vlQQ: posts big blind $0.25
diablo4good: sits out 
*** HOLE CARDS ***
H5Se03ZqSX7tbULXur2MAg: folds 
OiV1PWZ3IkN29JlmCcnTwQ: folds 
opOCI2p6kW0tINuVaAqmcQ: raises $0.50 to $0.75
EnNp9cILTCYQ95g+8MNFGw: folds 
VlJdQJbqyBs3oxP5BIw7jA: calls $0.75
2N94FgK4Y2izKFIB+wJOjw: calls $0.65
MG90wfSJZnOejs/KD3vlQQ: folds 
*** FLOP *** [Kc 7s Qc]
2N94FgK4Y2izKFIB+wJOjw: checks 
opOCI2p6kW0tINuVaAqmcQ: checks 
VlJdQJbqyBs3oxP5BIw7jA: checks 
*** TURN *** [Kc 7s Qc] [Qd]
2N94FgK4Y2izKFIB+wJOjw: checks 
opOCI2p6kW0tINuVaAqmcQ: checks 
VlJdQJbqyBs3oxP5BIw7jA: checks 
*** RIVER *** [Kc 7s Qc Qd] [As]
2N94FgK4Y2izKFIB+wJOjw: checks 
opOCI2p6kW0tINuVaAqmcQ: bets $2
VlJdQJbqyBs3oxP5BIw7jA: raises $4 to $6
2N94FgK4Y2izKFIB+wJOjw: folds 
opOCI2p6kW0tINuVaAqmcQ: calls $4
*** SHOW DOWN ***
VlJdQJbqyBs3oxP5BIw7jA: shows [Ts Jh] (a straight, Ten to Ace)
opOCI2p6kW0tINuVaAqmcQ: shows [Jd Td] (a straight, Ten to Ace)
opOCI2p6kW0tINuVaAqmcQ collected $6.90 from pot
VlJdQJbqyBs3oxP5BIw7jA collected $6.90 from pot
*** SUMMARY ***
Total pot $14.50 | Rake $0.70 
Board [Kc 7s Qc Qd As]
Seat 1: MG90wfSJZnOejs/KD3vlQQ (big blind) folded before Flop
Seat 2: H5Se03ZqSX7tbULXur2MAg folded before Flop (didn't bet)
Seat 5: OiV1PWZ3IkN29JlmCcnTwQ folded before Flop (didn't bet)
Seat 6: opOCI2p6kW0tINuVaAqmcQ showed [Jd Td] and won ($6.90) with a straight, Ten to Ace
Seat 7: EnNp9cILTCYQ95g+8MNFGw folded before Flop (didn't bet)
Seat 8: VlJdQJbqyBs3oxP5BIw7jA (button) showed [Ts Jh] and won ($6.90) with a straight, Ten to Ace
Seat 9: 2N94FgK4Y2izKFIB+wJOjw (small blind) folded on the River




PokerStars Game #59939393112:  Hold'em No Limit ($0.10/$0.25) - 2009/07/01 0:38:42 ET
Table 'sIHZ0lzLr4NGCaBUKhmYhAr562aMIMs5kgo28FEU6lkAax Seat #3 is the button
Seat 1: vZGoOTJLQLhkPj4I+LNGig ($25 in chips) 
Seat 2: N8muFAHrFHW6elSMGuyVLQ ($15 in chips) 
Seat 3: vX2B+8jhZFyBctQ3P4IKEw ($8.40 in chips) 
Seat 4: XBq1lBzax7LjRqdJP2TqWg ($13.20 in chips) 
Seat 5: zDrucyjVn5aeekNEc3cJrA ($36.80 in chips) 
Seat 7: R6nIVAjK7uhK3Hj0f85A+A ($18.70 in chips) 
Seat 9: W4TLQcZ2TiM73eIgpIvlGg ($26.10 in chips) 
XBq1lBzax7LjRqdJP2TqWg: posts small blind $0.10
zDrucyjVn5aeekNEc3cJrA: posts big blind $0.25
rCaXm4/EwAgWqCiClpbsqQ: sits out 
N8muFAHrFHW6elSMGuyVLQ: posts big blind $0.25
*** HOLE CARDS ***
R6nIVAjK7uhK3Hj0f85A+A: folds 
jk21 joins the table at seat #8 
W4TLQcZ2TiM73eIgpIvlGg: folds 
vZGoOTJLQLhkPj4I+LNGig: folds 
N8muFAHrFHW6elSMGuyVLQ: checks 
vX2B+8jhZFyBctQ3P4IKEw: calls $0.25
XBq1lBzax7LjRqdJP2TqWg: folds 
zDrucyjVn5aeekNEc3cJrA: raises $1 to $1.25
N8muFAHrFHW6elSMGuyVLQ: folds 
vX2B+8jhZFyBctQ3P4IKEw: folds 
Uncalled bet ($1) returned to zDrucyjVn5aeekNEc3cJrA
zDrucyjVn5aeekNEc3cJrA collected $0.85 from pot
*** SUMMARY ***
Total pot $0.85 | Rake $0 
Seat 1: vZGoOTJLQLhkPj4I+LNGig folded before Flop (didn't bet)
Seat 2: N8muFAHrFHW6elSMGuyVLQ folded before Flop
Seat 3: vX2B+8jhZFyBctQ3P4IKEw (button) folded before Flop
Seat 4: XBq1lBzax7LjRqdJP2TqWg (small blind) folded before Flop
Seat 5: zDrucyjVn5aeekNEc3cJrA (big blind) collected ($0.85)
Seat 7: R6nIVAjK7uhK3Hj0f85A+A folded before Flop (didn't bet)
Seat 9: W4TLQcZ2TiM73eIgpIvlGg folded before Flop (didn't bet)




PokerStars Game #59939393036:  Hold'em No Limit ($0.10/$0.25) - 2009/07/01 0:38:42 ET
Table '3Ns9nuTkynfwbBfBXzg6ww' 6-max Seat #5 is the button
Seat 3: 6PDO6dptGq0XLL8zHWIhgw ($48.20 in chips) 
Seat 4: kyRaCIljYA6l33lSKQfNsg ($31.75 in chips) 
Seat 5: kBQU/db00TVAMeomlhblPg ($16 in chips) 
6PDO6dptGq0XLL8zHWIhgw: posts small blind $0.10
kyRaCIljYA6l33lSKQfNsg: posts big blind $0.25
*** HOLE CARDS ***
kBQU/db00TVAMeomlhblPg: raises $0.75 to $1
6PDO6dptGq0XLL8zHWIhgw: folds 
kyRaCIljYA6l33lSKQfNsg: raises $1.75 to $2.75
kBQU/db00TVAMeomlhblPg: calls $1.75
*** FLOP *** [Td 5d Ac]
kyRaCIljYA6l33lSKQfNsg: bets $4
kBQU/db00TVAMeomlhblPg: raises $4 to $8
kyRaCIljYA6l33lSKQfNsg: folds 
Uncalled bet ($4) returned to kBQU/db00TVAMeomlhblPg
kBQU/db00TVAMeomlhblPg collected $12.95 from pot
*** SUMMARY ***
Total pot $13.60 | Rake $0.65 
Board [Td 5d Ac]
Seat 3: 6PDO6dptGq0XLL8zHWIhgw (small blind) folded before Flop
Seat 4: kyRaCIljYA6l33lSKQfNsg (big blind) folded on the Flop
Seat 5: kBQU/db00TVAMeomlhblPg (button) collected ($12.95)




PokerStars Game #59939392978:  Hold'em No Limit ($0.10/$0.25) - 2009/07/01 0:38:42 ET
Table 'Do4nrTNDYpK3sQjwFxX+Og' 6-max Seat #1 is the button
Seat 1: 7JrQNOR9wRBxq9ijFhWieg ($25 in chips) 
Seat 2: tzMoGl9F0PUr5NibYueeSw ($45.40 in chips) 
Seat 3: TSmua8tGK3sTbwi0ynrW9Q ($32.15 in chips) 
Seat 4: df7bIV965hvGEDiUAs5cfQ ($17.50 in chips) 
Seat 5: Ew/TYPQIsbQ2X8nm5iAJBg ($29.75 in chips) 
Seat 6: eHsmIvAb2JREg4O6hNPnXg ($24.45 in chips) 
tzMoGl9F0PUr5NibYueeSw: posts small blind $0.10
TSmua8tGK3sTbwi0ynrW9Q: posts big blind $0.25
*** HOLE CARDS ***
df7bIV965hvGEDiUAs5cfQ: folds 
Ew/TYPQIsbQ2X8nm5iAJBg: folds 
eHsmIvAb2JREg4O6hNPnXg: folds 
7JrQNOR9wRBxq9ijFhWieg: raises $0.25 to $0.50
tzMoGl9F0PUr5NibYueeSw: calls $0.40
TSmua8tGK3sTbwi0ynrW9Q: folds 
*** FLOP *** [Tc 8h As]
tzMoGl9F0PUr5NibYueeSw: checks 
7JrQNOR9wRBxq9ijFhWieg: bets $1
tzMoGl9F0PUr5NibYueeSw: folds 
Uncalled bet ($1) returned to 7JrQNOR9wRBxq9ijFhWieg
7JrQNOR9wRBxq9ijFhWieg collected $1.20 from pot
7JrQNOR9wRBxq9ijFhWieg: doesn't show hand 
*** SUMMARY ***
Total pot $1.25 | Rake $0.05 
Board [Tc 8h As]
Seat 1: 7JrQNOR9wRBxq9ijFhWieg (button) collected ($1.20)
Seat 2: tzMoGl9F0PUr5NibYueeSw (small blind) folded on the Flop
Seat 3: TSmua8tGK3sTbwi0ynrW9Q (big blind) folded before Flop
Seat 4: df7bIV965hvGEDiUAs5cfQ folded before Flop (didn't bet)
Seat 5: Ew/TYPQIsbQ2X8nm5iAJBg folded before Flop (didn't bet)
Seat 6: eHsmIvAb2JREg4O6hNPnXg folded before Flop (didn't bet)




PokerStars Game #59939392666:  Hold'em No Limit ($0.10/$0.25) - 2009/07/01 0:38:42 ET
Table 'nyTW9cVtYentc5V7xU/0jA' 6-max Seat #1 is the button
Seat 1: YfxPRDAWfqnGBhiIEdlTYg ($12.25 in chips) 
Seat 2: 7FmwVDcdEtxDpHmP4hOXsQ ($25 in chips) 
Seat 3: kG34n23qFQA3nzdOJTQ1dA ($24.90 in chips) 
Seat 4: r6u7MWSXF30/khcTYkrG9Q ($36.85 in chips) 
Seat 5: BedjMfrlRfPgSq7CXpPAmg ($25 in chips) 
Seat 6: dQJByDqHOLbgqX/HobyAJA ($7.05 in chips) 
7FmwVDcdEtxDpHmP4hOXsQ: posts small blind $0.10
kG34n23qFQA3nzdOJTQ1dA: posts big blind $0.25
*** HOLE CARDS ***
r6u7MWSXF30/khcTYkrG9Q: folds 
BedjMfrlRfPgSq7CXpPAmg: folds 
dQJByDqHOLbgqX/HobyAJA: calls $0.25
YfxPRDAWfqnGBhiIEdlTYg: calls $0.25
7FmwVDcdEtxDpHmP4hOXsQ: calls $0.15
kG34n23qFQA3nzdOJTQ1dA: checks 
*** FLOP *** [Js Td Qh]
7FmwVDcdEtxDpHmP4hOXsQ: checks 
kG34n23qFQA3nzdOJTQ1dA: checks 
dQJByDqHOLbgqX/HobyAJA: bets $1
YfxPRDAWfqnGBhiIEdlTYg: folds 
7FmwVDcdEtxDpHmP4hOXsQ: folds 
kG34n23qFQA3nzdOJTQ1dA: folds 
Uncalled bet ($1) returned to dQJByDqHOLbgqX/HobyAJA
dQJByDqHOLbgqX/HobyAJA collected $0.95 from pot
*** SUMMARY ***
Total pot $1 | Rake $0.05 
Board [Js Td Qh]
Seat 1: YfxPRDAWfqnGBhiIEdlTYg (button) folded on the Flop
Seat 2: 7FmwVDcdEtxDpHmP4hOXsQ (small blind) folded on the Flop
Seat 3: kG34n23qFQA3nzdOJTQ1dA (big blind) folded on the Flop
Seat 4: r6u7MWSXF30/khcTYkrG9Q folded before Flop (didn't bet)
Seat 5: BedjMfrlRfPgSq7CXpPAmg folded before Flop (didn't bet)
Seat 6: dQJByDqHOLbgqX/HobyAJA collected ($0.95)




PokerStars Game #59939393022:  Hold'em No Limit ($0.10/$0.25) - 2009/07/01 0:38:42 ET
Table 'B3/JTS7usG3rxMfTbMiZuw' 6-max Seat #2 is the button
Seat 1: wAKC8C/zN0c8V5v13dm9mA ($29.90 in chips) 
Seat 2: 2gqWqkOq59pvtJKe4nS+rw ($26.90 in chips) 
Seat 3: PbMzPZIePKifKQZfKDkbIw ($25 in chips) 
Seat 4: kPCKvyB1yAABEgvF7OaG0g ($22.15 in chips) 
Seat 5: NhUN/JpAprdJeamFBgJH1w ($26.50 in chips) 
Seat 6: AGMIbXefZrMZ8QjfyCknDw ($19.70 in chips) 
PbMzPZIePKifKQZfKDkbIw: posts small blind $0.10
kPCKvyB1yAABEgvF7OaG0g: posts big blind $0.25
*** HOLE CARDS ***
NhUN/JpAprdJeamFBgJH1w: folds 
AGMIbXefZrMZ8QjfyCknDw: folds 
wAKC8C/zN0c8V5v13dm9mA: folds 
2gqWqkOq59pvtJKe4nS+rw: raises $0.75 to $1
PbMzPZIePKifKQZfKDkbIw: folds 
kPCKvyB1yAABEgvF7OaG0g: raises $0.75 to $1.75
2gqWqkOq59pvtJKe4nS+rw: calls $0.75
*** FLOP *** [2c Ad Jc]
kPCKvyB1yAABEgvF7OaG0g: checks 
AGMIbXefZrMZ8QjfyCknDw said, "was the best hand preflop- but a crappy way to lose"
2gqWqkOq59pvtJKe4nS+rw: bets $2
kPCKvyB1yAABEgvF7OaG0g: calls $2
*** TURN *** [2c Ad Jc] [Kc]
AGMIbXefZrMZ8QjfyCknDw said, "after a set"
kPCKvyB1yAABEgvF7OaG0g: bets $18.40 and is all-in
2gqWqkOq59pvtJKe4nS+rw said, "mmmmmmm"
2gqWqkOq59pvtJKe4nS+rw: folds 
Uncalled bet ($18.40) returned to kPCKvyB1yAABEgvF7OaG0g
kPCKvyB1yAABEgvF7OaG0g collected $7.25 from pot
kPCKvyB1yAABEgvF7OaG0g: doesn't show hand 
*** SUMMARY ***
Total pot $7.60 | Rake $0.35 
Board [2c Ad Jc Kc]
Seat 1: wAKC8C/zN0c8V5v13dm9mA folded before Flop (didn't bet)
Seat 2: 2gqWqkOq59pvtJKe4nS+rw (button) folded on the Turn
Seat 3: PbMzPZIePKifKQZfKDkbIw (small blind) folded before Flop
Seat 4: kPCKvyB1yAABEgvF7OaG0g (big blind) collected ($7.25)
Seat 5: NhUN/JpAprdJeamFBgJH1w folded before Flop (didn't bet)
Seat 6: AGMIbXefZrMZ8QjfyCknDw folded before Flop (didn't bet)




PokerStars Game #59939392838:  Hold'em No Limit ($0.10/$0.25) - 2009/07/01 0:38:42 ET
Table 'g+mPuNJBCHKE9ents7ZGtg' 6-max Seat #3 is the button
Seat 1: rlqzz6sTpiZGIiNuqy7QUA ($34.60 in chips) 
Seat 2: fZQg9veL7Dd/Z04ZTjC+wQ ($30.35 in chips) 
Seat 3: 9jSiy0meE9XJKkdIZwyTEQ ($25.25 in chips) 
Seat 4: mfrkWA3PTeYPkbO6hi98Aw ($27.10 in chips) 
Seat 5: vEZ/HxVuyR6kaq0BtZoUgQ ($14.05 in chips) 
Seat 6: MS2T205Bjud7PnNoANu4vQ ($50.60 in chips) 
mfrkWA3PTeYPkbO6hi98Aw: posts small blind $0.10
vEZ/HxVuyR6kaq0BtZoUgQ: posts big blind $0.25
*** HOLE CARDS ***
MS2T205Bjud7PnNoANu4vQ: raises $0.50 to $0.75
rlqzz6sTpiZGIiNuqy7QUA: raises $1 to $1.75
fZQg9veL7Dd/Z04ZTjC+wQ: folds 
9jSiy0meE9XJKkdIZwyTEQ: folds 
mfrkWA3PTeYPkbO6hi98Aw: folds 
vEZ/HxVuyR6kaq0BtZoUgQ: folds 
MS2T205Bjud7PnNoANu4vQ: calls $1
*** FLOP *** [Ks Qs 7d]
vEZ/HxVuyR6kaq0BtZoUgQ leaves the table
MS2T205Bjud7PnNoANu4vQ: checks 
rlqzz6sTpiZGIiNuqy7QUA: bets $2.25
MS2T205Bjud7PnNoANu4vQ: folds 
Uncalled bet ($2.25) returned to rlqzz6sTpiZGIiNuqy7QUA
rlqzz6sTpiZGIiNuqy7QUA collected $3.70 from pot
*** SUMMARY ***
Total pot $3.85 | Rake $0.15 
Board [Ks Qs 7d]
Seat 1: rlqzz6sTpiZGIiNuqy7QUA collected ($3.70)
Seat 2: fZQg9veL7Dd/Z04ZTjC+wQ folded before Flop (didn't bet)
Seat 3: 9jSiy0meE9XJKkdIZwyTEQ (button) folded before Flop (didn't bet)
Seat 4: mfrkWA3PTeYPkbO6hi98Aw (small blind) folded before Flop
Seat 5: vEZ/HxVuyR6kaq0BtZoUgQ (big blind) folded before Flop
Seat 6: MS2T205Bjud7PnNoANu4vQ folded on the Flop




PokerStars Game #59939392650:  Hold'em No Limit ($0.10/$0.25) - 2009/07/01 0:38:42 ET
Table 'QegsWX65l3n/K0A8XB78yg' 6-max Seat #1 is the button
Seat 1: 8ClCHtFXGNplITm+63KB+Q ($29.30 in chips) 
Seat 2: GC/9yVD59DUCX7hUI7gcLw ($28.45 in chips) 
Seat 3: 9jSiy0meE9XJKkdIZwyTEQ ($25 in chips) 
Seat 4: kyRaCIljYA6l33lSKQfNsg ($25 in chips) 
Seat 5: 4YSTu0Cdzpppe1lUgCZGCQ ($59.75 in chips) 
Seat 6: JE/wJXmjw3bpdmjwvh2pcg ($37.50 in chips) 
GC/9yVD59DUCX7hUI7gcLw: posts small blind $0.10
9jSiy0meE9XJKkdIZwyTEQ: posts big blind $0.25
*** HOLE CARDS ***
kyRaCIljYA6l33lSKQfNsg: folds 
4YSTu0Cdzpppe1lUgCZGCQ: raises $0.75 to $1
JE/wJXmjw3bpdmjwvh2pcg: folds 
8ClCHtFXGNplITm+63KB+Q: folds 
GC/9yVD59DUCX7hUI7gcLw: raises $2.50 to $3.50
9jSiy0meE9XJKkdIZwyTEQ: folds 
4YSTu0Cdzpppe1lUgCZGCQ: calls $2.50
*** FLOP *** [9d 5d 4d]
GC/9yVD59DUCX7hUI7gcLw: bets $4.25
4YSTu0Cdzpppe1lUgCZGCQ: folds 
Uncalled bet ($4.25) returned to GC/9yVD59DUCX7hUI7gcLw
GC/9yVD59DUCX7hUI7gcLw collected $6.90 from pot
*** SUMMARY ***
Total pot $7.25 | Rake $0.35 
Board [9d 5d 4d]
Seat 1: 8ClCHtFXGNplITm+63KB+Q (button) folded before Flop (didn't bet)
Seat 2: GC/9yVD59DUCX7hUI7gcLw (small blind) collected ($6.90)
Seat 3: 9jSiy0meE9XJKkdIZwyTEQ (big blind) folded before Flop
Seat 4: kyRaCIljYA6l33lSKQfNsg folded before Flop (didn't bet)
Seat 5: 4YSTu0Cdzpppe1lUgCZGCQ folded on the Flop
Seat 6: JE/wJXmjw3bpdmjwvh2pcg folded before Flop (didn't bet)




PokerStars Game #59939392920:  Hold'em No Limit ($0.10/$0.25) - 2009/07/01 0:38:42 ET
Table '29D3eoQzK5kOAT0OIDS2uQ' 6-max Seat #4 is the button
Seat 1: kG34n23qFQA3nzdOJTQ1dA ($51.65 in chips) 
Seat 2: tbhYGxTClzdFLMcTtjvJhg ($44.20 in chips) 
Seat 3: z3tQwy28dp5FykDJC/wzQw ($19.35 in chips) 
Seat 4: yzFNNFIfC89bBPwpFPx2ow ($27.10 in chips) 
Seat 5: Q3EMN7b0ie81AFWkDrhCjw ($33.95 in chips) 
Seat 6: bWbV4MVB/vVpiES1Ut4hew ($43.95 in chips) 
Q3EMN7b0ie81AFWkDrhCjw: posts small blind $0.10
bWbV4MVB/vVpiES1Ut4hew: posts big blind $0.25
*** HOLE CARDS ***
kG34n23qFQA3nzdOJTQ1dA: folds 
tbhYGxTClzdFLMcTtjvJhg: folds 
z3tQwy28dp5FykDJC/wzQw: folds 
yzFNNFIfC89bBPwpFPx2ow: folds 
Q3EMN7b0ie81AFWkDrhCjw: calls $0.15
bWbV4MVB/vVpiES1Ut4hew: checks 
*** FLOP *** [Js 2d 6s]
Q3EMN7b0ie81AFWkDrhCjw: checks 
bWbV4MVB/vVpiES1Ut4hew: bets $0.50
Q3EMN7b0ie81AFWkDrhCjw: folds 
Uncalled bet ($0.50) returned to bWbV4MVB/vVpiES1Ut4hew
bWbV4MVB/vVpiES1Ut4hew collected $0.50 from pot
*** SUMMARY ***
Total pot $0.50 | Rake $0 
Board [Js 2d 6s]
Seat 1: kG34n23qFQA3nzdOJTQ1dA folded before Flop (didn't bet)
Seat 2: tbhYGxTClzdFLMcTtjvJhg folded before Flop (didn't bet)
Seat 3: z3tQwy28dp5FykDJC/wzQw folded before Flop (didn't bet)
Seat 4: yzFNNFIfC89bBPwpFPx2ow (button) folded before Flop (didn't bet)
Seat 5: Q3EMN7b0ie81AFWkDrhCjw (small blind) folded on the Flop
Seat 6: bWbV4MVB/vVpiES1Ut4hew (big blind) collected ($0.50)




PokerStars Game #59939392848:  Hold'em No Limit ($0.10/$0.25) - 2009/07/01 0:38:42 ET
Table 'gkdjhbH1jaE3hwhPRIKMiQ' 6-max Seat #6 is the button
Seat 1: nc79pm0LZRdhncq55evVqA ($25 in chips) 
Seat 2: 1NNFfYMd5Hsphl/FYz9fNA ($32.85 in chips) 
Seat 3: uUXdcVMNa05rfbntdvplfw ($10.10 in chips) 
Seat 4: 7uqewvdd5+KjmM7wl58k+w ($15.30 in chips) 
Seat 5: Ew/TYPQIsbQ2X8nm5iAJBg ($26.75 in chips) 
Seat 6: wqphQtauX5Qn7WRJZS1flA ($25.65 in chips) 
nc79pm0LZRdhncq55evVqA: posts small blind $0.10
1NNFfYMd5Hsphl/FYz9fNA: posts big blind $0.25
*** HOLE CARDS ***
uUXdcVMNa05rfbntdvplfw: folds 
uUXdcVMNa05rfbntdvplfw leaves the table
7uqewvdd5+KjmM7wl58k+w: folds 
Ew/TYPQIsbQ2X8nm5iAJBg: folds 
wqphQtauX5Qn7WRJZS1flA: raises $0.50 to $0.75
nc79pm0LZRdhncq55evVqA: folds 
1NNFfYMd5Hsphl/FYz9fNA: folds 
Uncalled bet ($0.50) returned to wqphQtauX5Qn7WRJZS1flA
wqphQtauX5Qn7WRJZS1flA collected $0.60 from pot
wqphQtauX5Qn7WRJZS1flA: doesn't show hand 
*** SUMMARY ***
Total pot $0.60 | Rake $0 
Seat 1: nc79pm0LZRdhncq55evVqA (small blind) folded before Flop
Seat 2: 1NNFfYMd5Hsphl/FYz9fNA (big blind) folded before Flop
Seat 3: uUXdcVMNa05rfbntdvplfw folded before Flop (didn't bet)
Seat 4: 7uqewvdd5+KjmM7wl58k+w folded before Flop (didn't bet)
Seat 5: Ew/TYPQIsbQ2X8nm5iAJBg folded before Flop (didn't bet)
Seat 6: wqphQtauX5Qn7WRJZS1flA (button) collected ($0.60)




PokerStars Game #59939393100:  Hold'em No Limit ($0.10/$0.25) - 2009/07/01 0:38:42 ET
Table '6aL2C8IFwHHr6SG6RgXaow' 9-max Seat #5 is the button
Seat 2: +gMmKt3DaQng9M42CmxIZg ($24.55 in chips) 
Seat 5: wre31HfyzQGpIvID1istxw ($14.35 in chips) 
Seat 6: HxDF4QSxC4z39D7teZpprQ ($33.15 in chips) 
Seat 7: rPToQDbLWB+dKnz7fcQSIg ($10.40 in chips) 
Seat 8: rQhYIYXSyH/IivYM1dlV5A ($14.40 in chips) 
Seat 9: yduPKWPzL8YlT5Zv/Nmrwg ($17.05 in chips) 
HxDF4QSxC4z39D7teZpprQ: posts small blind $0.10
rPToQDbLWB+dKnz7fcQSIg: posts big blind $0.25
*** HOLE CARDS ***
rQhYIYXSyH/IivYM1dlV5A: folds 
yduPKWPzL8YlT5Zv/Nmrwg: folds 
+gMmKt3DaQng9M42CmxIZg: folds 
wre31HfyzQGpIvID1istxw: folds 
HxDF4QSxC4z39D7teZpprQ: raises $0.75 to $1
rPToQDbLWB+dKnz7fcQSIg: folds 
Uncalled bet ($0.75) returned to HxDF4QSxC4z39D7teZpprQ
HxDF4QSxC4z39D7teZpprQ collected $0.50 from pot
*** SUMMARY ***
Total pot $0.50 | Rake $0 
Seat 2: +gMmKt3DaQng9M42CmxIZg folded before Flop (didn't bet)
Seat 5: wre31HfyzQGpIvID1istxw (button) folded before Flop (didn't bet)
Seat 6: HxDF4QSxC4z39D7teZpprQ (small blind) collected ($0.50)
Seat 7: rPToQDbLWB+dKnz7fcQSIg (big blind) folded before Flop
Seat 8: rQhYIYXSyH/IivYM1dlV5A folded before Flop (didn't bet)
Seat 9: yduPKWPzL8YlT5Zv/Nmrwg folded before Flop (didn't bet)




PokerStars Game #59939393114:  Hold'em No Limit ($0.10/$0.25) - 2009/07/01 0:38:42 ET
Table 'JJzUs04lHpXg6nboT1/jeg' 6-max Seat #5 is the button
Seat 4: nwwpaieDRI0UPyVtChVHOg ($36.55 in chips) 
Seat 5: Vr2XE7yYBdg3RZSURDAPEg ($24.05 in chips) 
qlSMvybgHy3Sa2mdf7Mw/A: is sitting out 
qlSMvybgHy3Sa2mdf7Mw/A leaves the table
Vr2XE7yYBdg3RZSURDAPEg: posts small blind $0.10
nwwpaieDRI0UPyVtChVHOg: posts big blind $0.25
*** HOLE CARDS ***
Vr2XE7yYBdg3RZSURDAPEg: calls $0.15
nwwpaieDRI0UPyVtChVHOg: checks 
*** FLOP *** [4h 8c 7c]
nwwpaieDRI0UPyVtChVHOg: bets $0.50
Vr2XE7yYBdg3RZSURDAPEg: folds 
Uncalled bet ($0.50) returned to nwwpaieDRI0UPyVtChVHOg
nwwpaieDRI0UPyVtChVHOg collected $0.50 from pot
nwwpaieDRI0UPyVtChVHOg: doesn't show hand 
*** SUMMARY ***
Total pot $0.50 | Rake $0 
Board [4h 8c 7c]
Seat 4: nwwpaieDRI0UPyVtChVHOg (big blind) collected ($0.50)
Seat 5: Vr2XE7yYBdg3RZSURDAPEg (button) (small blind) folded on the Flop




PokerStars Game #59939392580:  Hold'em No Limit ($0.10/$0.25) - 2009/07/01 0:38:42 ET
Table 'MQJMxKDF6VYBWIKv7VfCog' 9-max Seat #4 is the button
Seat 1: cZ99hugmLBj9KhTlc8nCSw ($25.80 in chips) 
Seat 2: JxpnpCmvRAcrEUy7mq1iAg ($5.20 in chips) 
Seat 3: EfRs3ibIxn+c9JDErwwNCg ($26.05 in chips) 
Seat 4: JtVGnq5doRa3PublncR+Yw ($24.25 in chips) 
Seat 5: RJ/x9oZtt1RZLaJEQwZOxQ ($25.70 in chips) 
Seat 6: ydoFOVgzvZv9ZhuWu9rXAw ($5 in chips) 
Seat 7: dfNim92Z6XK1/h5SFW5vDg ($55.30 in chips) 
Seat 8: Z9AeOQX3yzuSvKAm/xyovg ($9.65 in chips) 
Seat 9: 1S/fpm+f42V/6MNZre+ccg ($34.10 in chips) 
RJ/x9oZtt1RZLaJEQwZOxQ: posts small blind $0.10
ydoFOVgzvZv9ZhuWu9rXAw: posts big blind $0.25
*** HOLE CARDS ***
dfNim92Z6XK1/h5SFW5vDg: raises $0.75 to $1
Z9AeOQX3yzuSvKAm/xyovg: folds 
1S/fpm+f42V/6MNZre+ccg: calls $1
cZ99hugmLBj9KhTlc8nCSw: folds 
JxpnpCmvRAcrEUy7mq1iAg: folds 
EfRs3ibIxn+c9JDErwwNCg: folds 
JtVGnq5doRa3PublncR+Yw: folds 
RJ/x9oZtt1RZLaJEQwZOxQ: folds 
ydoFOVgzvZv9ZhuWu9rXAw: folds 
*** FLOP *** [Ah 8s 4c]
dfNim92Z6XK1/h5SFW5vDg: bets $1
1S/fpm+f42V/6MNZre+ccg: calls $1
*** TURN *** [Ah 8s 4c] [Tc]
dfNim92Z6XK1/h5SFW5vDg: checks 
1S/fpm+f42V/6MNZre+ccg: bets $2.75
dfNim92Z6XK1/h5SFW5vDg: folds 
Uncalled bet ($2.75) returned to 1S/fpm+f42V/6MNZre+ccg
1S/fpm+f42V/6MNZre+ccg collected $4.15 from pot
1S/fpm+f42V/6MNZre+ccg: doesn't show hand 
*** SUMMARY ***
Total pot $4.35 | Rake $0.20 
Board [Ah 8s 4c Tc]
Seat 1: cZ99hugmLBj9KhTlc8nCSw folded before Flop (didn't bet)
Seat 2: JxpnpCmvRAcrEUy7mq1iAg folded before Flop (didn't bet)
Seat 3: EfRs3ibIxn+c9JDErwwNCg folded before Flop (didn't bet)
Seat 4: JtVGnq5doRa3PublncR+Yw (button) folded before Flop (didn't bet)
Seat 5: RJ/x9oZtt1RZLaJEQwZOxQ (small blind) folded before Flop
Seat 6: ydoFOVgzvZv9ZhuWu9rXAw (big blind) folded before Flop
Seat 7: dfNim92Z6XK1/h5SFW5vDg folded on the Turn
Seat 8: Z9AeOQX3yzuSvKAm/xyovg folded before Flop (didn't bet)
Seat 9: 1S/fpm+f42V/6MNZre+ccg collected ($4.15)




PokerStars Game #59939393048:  Hold'em No Limit ($0.10/$0.25) - 2009/07/01 0:38:42 ET
Table 'JUMeG5SzDyo9HufhgemQeA' 9-max Seat #6 is the button
Seat 1: N6fYvIzQLKaydFLKQGtMlQ ($24.65 in chips) 
Seat 2: ZeR3hkj1gVv9J4yPCmRrjA ($29.75 in chips) 
Seat 3: IEvLSTIxhlti3EjZDarYnA ($29.45 in chips) 
Seat 4: 6OP8CZnSFyny18DZqWIYog ($2.70 in chips) 
Seat 5: TI/C5Q+DEl4fLR3AofwYdg ($15 in chips) 
Seat 6: wFCwdYKUXoQHhz8qeZuuAw ($24.45 in chips) 
Seat 7: aNpwfA31EREwO+ar4XzBCw ($29.40 in chips) 
Seat 8: zDrucyjVn5aeekNEc3cJrA ($37.20 in chips) 
aNpwfA31EREwO+ar4XzBCw: posts small blind $0.10
zDrucyjVn5aeekNEc3cJrA: posts big blind $0.25
xiximaris: sits out 
TI/C5Q+DEl4fLR3AofwYdg: posts big blind $0.25
*** HOLE CARDS ***
N6fYvIzQLKaydFLKQGtMlQ: folds 
ZeR3hkj1gVv9J4yPCmRrjA: folds 
IEvLSTIxhlti3EjZDarYnA: folds 
6OP8CZnSFyny18DZqWIYog: folds 
TI/C5Q+DEl4fLR3AofwYdg: checks 
wFCwdYKUXoQHhz8qeZuuAw: folds 
aNpwfA31EREwO+ar4XzBCw: folds 
zDrucyjVn5aeekNEc3cJrA: checks 
*** FLOP *** [Kh 2d Ts]
zDrucyjVn5aeekNEc3cJrA: checks 
TI/C5Q+DEl4fLR3AofwYdg: bets $0.50
zDrucyjVn5aeekNEc3cJrA: folds 
Uncalled bet ($0.50) returned to TI/C5Q+DEl4fLR3AofwYdg
TI/C5Q+DEl4fLR3AofwYdg collected $0.60 from pot
TI/C5Q+DEl4fLR3AofwYdg: doesn't show hand 
*** SUMMARY ***
Total pot $0.60 | Rake $0 
Board [Kh 2d Ts]
Seat 1: N6fYvIzQLKaydFLKQGtMlQ folded before Flop (didn't bet)
Seat 2: ZeR3hkj1gVv9J4yPCmRrjA folded before Flop (didn't bet)
Seat 3: IEvLSTIxhlti3EjZDarYnA folded before Flop (didn't bet)
Seat 4: 6OP8CZnSFyny18DZqWIYog folded before Flop (didn't bet)
Seat 5: TI/C5Q+DEl4fLR3AofwYdg collected ($0.60)
Seat 6: wFCwdYKUXoQHhz8qeZuuAw (button) folded before Flop (didn't bet)
Seat 7: aNpwfA31EREwO+ar4XzBCw (small blind) folded before Flop
Seat 8: zDrucyjVn5aeekNEc3cJrA (big blind) folded on the Flop




PokerStars Game #59939392862:  Hold'em No Limit ($0.10/$0.25) - 2009/07/01 0:38:42 ET
Table 'pPgW4R3kdH26lLi1MnE92w' 9-max Seat #6 is the button
Seat 1: dPWIrImjP1yFagoUVDKR0Q ($9.40 in chips) 
Seat 2: cZ99hugmLBj9KhTlc8nCSw ($28.60 in chips) 
Seat 3: og+56SuM1LUF/5l/Qtaw4Q ($10.75 in chips) 
Seat 4: hBMUlEpyU74r/fwDgIpXjQ ($31.15 in chips) 
Seat 5: HPEB+AtKw1+C/cxU0o1ciw ($34.35 in chips) 
Seat 6: Z9AeOQX3yzuSvKAm/xyovg ($12.05 in chips) 
Seat 8: aCVg6cCxQcqClhB9nq/p1w ($19.35 in chips) 
Seat 9: tcbEu7VzyHQ+0lh+skbQhQ ($18.50 in chips) 
aCVg6cCxQcqClhB9nq/p1w: posts small blind $0.10
tcbEu7VzyHQ+0lh+skbQhQ: posts big blind $0.25
*** HOLE CARDS ***
sD+TKtt36XiiN6jqHiLwDA joins the table at seat #7 
dPWIrImjP1yFagoUVDKR0Q: calls $0.25
cZ99hugmLBj9KhTlc8nCSw: folds 
og+56SuM1LUF/5l/Qtaw4Q: raises $0.50 to $0.75
hBMUlEpyU74r/fwDgIpXjQ: folds 
HPEB+AtKw1+C/cxU0o1ciw: folds 
Z9AeOQX3yzuSvKAm/xyovg: folds 
aCVg6cCxQcqClhB9nq/p1w: folds 
tcbEu7VzyHQ+0lh+skbQhQ: folds 
Z9AeOQX3yzuSvKAm/xyovg leaves the table
dPWIrImjP1yFagoUVDKR0Q: calls $0.50
*** FLOP *** [4s 2c 6s]
dPWIrImjP1yFagoUVDKR0Q: checks 
og+56SuM1LUF/5l/Qtaw4Q: checks 
*** TURN *** [4s 2c 6s] [8c]
dPWIrImjP1yFagoUVDKR0Q: checks 
og+56SuM1LUF/5l/Qtaw4Q: bets $1
dPWIrImjP1yFagoUVDKR0Q: folds 
Uncalled bet ($1) returned to og+56SuM1LUF/5l/Qtaw4Q
og+56SuM1LUF/5l/Qtaw4Q collected $1.80 from pot
*** SUMMARY ***
Total pot $1.85 | Rake $0.05 
Board [4s 2c 6s 8c]
Seat 1: dPWIrImjP1yFagoUVDKR0Q folded on the Turn
Seat 2: cZ99hugmLBj9KhTlc8nCSw folded before Flop (didn't bet)
Seat 3: og+56SuM1LUF/5l/Qtaw4Q collected ($1.80)
Seat 4: hBMUlEpyU74r/fwDgIpXjQ folded before Flop (didn't bet)
Seat 5: HPEB+AtKw1+C/cxU0o1ciw folded before Flop (didn't bet)
Seat 6: Z9AeOQX3yzuSvKAm/xyovg (button) folded before Flop (didn't bet)
Seat 8: aCVg6cCxQcqClhB9nq/p1w (small blind) folded before Flop
Seat 9: tcbEu7VzyHQ+0lh+skbQhQ (big blind) folded before Flop




PokerStars Game #59939392924:  Hold'em No Limit ($0.10/$0.25) - 2009/07/01 0:38:42 ET
Table 'XX2OuOsa8/8AC+/mR/Az6g' 9-max Seat #6 is the button
Seat 1: 56S3mA6Zs3pGR+0p0vUCtg ($25 in chips) 
Seat 2: MIVCHqCqqlke0Lb0z7glcw ($24.65 in chips) 
Seat 3: PJJTm/ccITEBlwPReiBTwg ($12.90 in chips) 
Seat 4: uLP/lYn7oKq9xCChBXsXxw ($24.75 in chips) 
Seat 5: jXz58rvCgq0VjyVjUBf2mw ($24.05 in chips) 
Seat 6: gT0nY7XiR+2FA+B3F4h8HQ ($25.35 in chips) 
Seat 7: zDrucyjVn5aeekNEc3cJrA ($20.95 in chips) 
Seat 9: 86vbuhJsyH+nbEg5qpDLyQ ($43.05 in chips) 
zDrucyjVn5aeekNEc3cJrA: posts small blind $0.10
cFmpjvcjNoVAEAIQIxWkYg: is sitting out 
86vbuhJsyH+nbEg5qpDLyQ: posts big blind $0.25
*** HOLE CARDS ***
cFmpjvcjNoVAEAIQIxWkYg leaves the table
56S3mA6Zs3pGR+0p0vUCtg: folds 
MIVCHqCqqlke0Lb0z7glcw: folds 
PJJTm/ccITEBlwPReiBTwg: calls $0.25
uLP/lYn7oKq9xCChBXsXxw: folds 
jXz58rvCgq0VjyVjUBf2mw: folds 
gT0nY7XiR+2FA+B3F4h8HQ: folds 
qwr38jl5txoR36M7G5qi4A joins the table at seat #8 
zDrucyjVn5aeekNEc3cJrA: calls $0.15
86vbuhJsyH+nbEg5qpDLyQ: checks 
*** FLOP *** [Th Ad 5d]
zDrucyjVn5aeekNEc3cJrA: checks 
86vbuhJsyH+nbEg5qpDLyQ: bets $0.25
PJJTm/ccITEBlwPReiBTwg: folds 
zDrucyjVn5aeekNEc3cJrA: folds 
Uncalled bet ($0.25) returned to 86vbuhJsyH+nbEg5qpDLyQ
86vbuhJsyH+nbEg5qpDLyQ collected $0.75 from pot
86vbuhJsyH+nbEg5qpDLyQ: doesn't show hand 
*** SUMMARY ***
Total pot $0.75 | Rake $0 
Board [Th Ad 5d]
Seat 1: 56S3mA6Zs3pGR+0p0vUCtg folded before Flop (didn't bet)
Seat 2: MIVCHqCqqlke0Lb0z7glcw folded before Flop (didn't bet)
Seat 3: PJJTm/ccITEBlwPReiBTwg folded on the Flop
Seat 4: uLP/lYn7oKq9xCChBXsXxw folded before Flop (didn't bet)
Seat 5: jXz58rvCgq0VjyVjUBf2mw folded before Flop (didn't bet)
Seat 6: gT0nY7XiR+2FA+B3F4h8HQ (button) folded before Flop (didn't bet)
Seat 7: zDrucyjVn5aeekNEc3cJrA (small blind) folded on the Flop
Seat 9: 86vbuhJsyH+nbEg5qpDLyQ (big blind) collected ($0.75)




PokerStars Game #59939393658:  Hold'em No Limit ($0.10/$0.25) - 2009/07/01 0:38:43 ET
Table 'G+4ZdyRoPjgaJY/jxSlZzQ' 9-max Seat #4 is the button
Seat 1: 0Ui5PFTLvpoTRdxcc8BNSQ ($33.70 in chips) 
Seat 2: 4awUyiDYTgylQKXZ9faBVA ($36.05 in chips) 
Seat 3: opOCI2p6kW0tINuVaAqmcQ ($28.95 in chips) 
Seat 4: yindad6WXRlkjbK12URYkA ($10 in chips) 
Seat 5: s7Q6uNouhe7aE8JdFb9E+A ($26.35 in chips) 
Seat 6: gehe91e0IyVT0QU/XBkEyg ($25 in chips) 
Seat 7: ie4EwTMMFYxrCXcenJdzsw ($8.35 in chips) 
Seat 8: jXz58rvCgq0VjyVjUBf2mw ($39.05 in chips) 
Seat 9: AzTBzPGlrIHrrs1Q8oKcGA ($18.05 in chips) 
s7Q6uNouhe7aE8JdFb9E+A: posts small blind $0.10
gehe91e0IyVT0QU/XBkEyg: posts big blind $0.25
*** HOLE CARDS ***
ie4EwTMMFYxrCXcenJdzsw: folds 
jXz58rvCgq0VjyVjUBf2mw: folds 
AzTBzPGlrIHrrs1Q8oKcGA: folds 
0Ui5PFTLvpoTRdxcc8BNSQ: calls $0.25
4awUyiDYTgylQKXZ9faBVA: folds 
opOCI2p6kW0tINuVaAqmcQ: folds 
yindad6WXRlkjbK12URYkA: folds 
s7Q6uNouhe7aE8JdFb9E+A: folds 
gehe91e0IyVT0QU/XBkEyg: checks 
*** FLOP *** [Th Qh 2d]
gehe91e0IyVT0QU/XBkEyg: checks 
0Ui5PFTLvpoTRdxcc8BNSQ: checks 
*** TURN *** [Th Qh 2d] [7c]
gehe91e0IyVT0QU/XBkEyg: checks 
0Ui5PFTLvpoTRdxcc8BNSQ: checks 
*** RIVER *** [Th Qh 2d 7c] [Qd]
gehe91e0IyVT0QU/XBkEyg: checks 
0Ui5PFTLvpoTRdxcc8BNSQ: checks 
*** SHOW DOWN ***
gehe91e0IyVT0QU/XBkEyg: shows [3h 6s] (a pair of Queens)
0Ui5PFTLvpoTRdxcc8BNSQ: shows [9h Ks] (a pair of Queens - King kicker)
0Ui5PFTLvpoTRdxcc8BNSQ collected $0.60 from pot
*** SUMMARY ***
Total pot $0.60 | Rake $0 
Board [Th Qh 2d 7c Qd]
Seat 1: 0Ui5PFTLvpoTRdxcc8BNSQ showed [9h Ks] and won ($0.60) with a pair of Queens
Seat 2: 4awUyiDYTgylQKXZ9faBVA folded before Flop (didn't bet)
Seat 3: opOCI2p6kW0tINuVaAqmcQ folded before Flop (didn't bet)
Seat 4: yindad6WXRlkjbK12URYkA (button) folded before Flop (didn't bet)
Seat 5: s7Q6uNouhe7aE8JdFb9E+A (small blind) folded before Flop
Seat 6: gehe91e0IyVT0QU/XBkEyg (big blind) showed [3h 6s] and lost with a pair of Queens
Seat 7: ie4EwTMMFYxrCXcenJdzsw folded before Flop (didn't bet)
Seat 8: jXz58rvCgq0VjyVjUBf2mw folded before Flop (didn't bet)
Seat 9: AzTBzPGlrIHrrs1Q8oKcGA folded before Flop (didn't bet)




PokerStars Game #59939393378:  Hold'em No Limit ($0.10/$0.25) - 2009/07/01 0:38:43 ET
Table 'AJGgX1ZYM8d68SWMvaLttg' 6-max Seat #4 is the button
Seat 1: sT4sjqzVMH/fZHz0hkbIPw ($34.65 in chips) 
Seat 2: zHHLkD2sRljslKKeQv/ZQw ($33.10 in chips) 
Seat 3: 4x9jCqgSw4272dnaIqnanw ($5.20 in chips) 
Seat 4: Lz/GjRDgmgepqTR7qmS86w ($18.35 in chips) 
Seat 5: SFmT9ZsVopnukjvAzrxTRg ($28.70 in chips) 
Seat 6: UA5OsKS3VPaxa7uC8La/kA ($31.25 in chips) 
SFmT9ZsVopnukjvAzrxTRg: posts small blind $0.10
UA5OsKS3VPaxa7uC8La/kA: posts big blind $0.25
*** HOLE CARDS ***
sT4sjqzVMH/fZHz0hkbIPw: calls $0.25
zHHLkD2sRljslKKeQv/ZQw: folds 
4x9jCqgSw4272dnaIqnanw: calls $0.25
Lz/GjRDgmgepqTR7qmS86w: folds 
SFmT9ZsVopnukjvAzrxTRg: folds 
UA5OsKS3VPaxa7uC8La/kA: checks 
*** FLOP *** [Ad Kc Jd]
UA5OsKS3VPaxa7uC8La/kA: checks 
sT4sjqzVMH/fZHz0hkbIPw: bets $0.75
4x9jCqgSw4272dnaIqnanw: calls $0.75
UA5OsKS3VPaxa7uC8La/kA: folds 
*** TURN *** [Ad Kc Jd] [2h]
sT4sjqzVMH/fZHz0hkbIPw: bets $1
4x9jCqgSw4272dnaIqnanw: calls $1
*** RIVER *** [Ad Kc Jd 2h] [Td]
sT4sjqzVMH/fZHz0hkbIPw: checks 
4x9jCqgSw4272dnaIqnanw: bets $1.50
sT4sjqzVMH/fZHz0hkbIPw: folds 
Uncalled bet ($1.50) returned to 4x9jCqgSw4272dnaIqnanw
4x9jCqgSw4272dnaIqnanw collected $4.15 from pot
*** SUMMARY ***
Total pot $4.35 | Rake $0.20 
Board [Ad Kc Jd 2h Td]
Seat 1: sT4sjqzVMH/fZHz0hkbIPw folded on the River
Seat 2: zHHLkD2sRljslKKeQv/ZQw folded before Flop (didn't bet)
Seat 3: 4x9jCqgSw4272dnaIqnanw collected ($4.15)
Seat 4: Lz/GjRDgmgepqTR7qmS86w (button) folded before Flop (didn't bet)
Seat 5: SFmT9ZsVopnukjvAzrxTRg (small blind) folded before Flop
Seat 6: UA5OsKS3VPaxa7uC8La/kA (big blind) folded on the Flop




PokerStars Game #59939393716:  Hold'em No Limit ($0.10/$0.25) - 2009/07/01 0:38:43 ET
Table 'O6cwjhrMn9pfzx1Ngn5zkQ' 6-max Seat #5 is the button
Seat 1: k4mJ9nD/YOVTl8/kGW+U6w ($14.05 in chips) 
Seat 2: M6xK/VklCvdyyrmvzATlxQ ($13.30 in chips) 
Seat 3: EE16Ua5b1HSsYej5zeXOlA ($25 in chips) 
Seat 4: wKFJ513ucluNNiMlkXcDOQ ($30.50 in chips) 
Seat 5: niLn0xUVlqh8If80xRjzCA ($25 in chips) 
Seat 6: d0J1xuhsynEY81YHwAvJ5g ($27.15 in chips) 
d0J1xuhsynEY81YHwAvJ5g: posts small blind $0.10
k4mJ9nD/YOVTl8/kGW+U6w: posts big blind $0.25
*** HOLE CARDS ***
M6xK/VklCvdyyrmvzATlxQ: folds 
EE16Ua5b1HSsYej5zeXOlA: folds 
wKFJ513ucluNNiMlkXcDOQ: raises $0.75 to $1
niLn0xUVlqh8If80xRjzCA: calls $1
d0J1xuhsynEY81YHwAvJ5g: folds 
k4mJ9nD/YOVTl8/kGW+U6w: folds 
*** FLOP *** [5c 9c 4h]
wKFJ513ucluNNiMlkXcDOQ: checks 
niLn0xUVlqh8If80xRjzCA: checks 
*** TURN *** [5c 9c 4h] [Jd]
wKFJ513ucluNNiMlkXcDOQ: checks 
niLn0xUVlqh8If80xRjzCA: checks 
*** RIVER *** [5c 9c 4h Jd] [8c]
wKFJ513ucluNNiMlkXcDOQ: checks 
niLn0xUVlqh8If80xRjzCA: checks 
*** SHOW DOWN ***
wKFJ513ucluNNiMlkXcDOQ: shows [8h 7h] (a pair of Eights)
niLn0xUVlqh8If80xRjzCA: mucks hand 
wKFJ513ucluNNiMlkXcDOQ collected $2.25 from pot
*** SUMMARY ***
Total pot $2.35 | Rake $0.10 
Board [5c 9c 4h Jd 8c]
Seat 1: k4mJ9nD/YOVTl8/kGW+U6w (big blind) folded before Flop
Seat 2: M6xK/VklCvdyyrmvzATlxQ folded before Flop (didn't bet)
Seat 3: EE16Ua5b1HSsYej5zeXOlA folded before Flop (didn't bet)
Seat 4: wKFJ513ucluNNiMlkXcDOQ showed [8h 7h] and won ($2.25) with a pair of Eights
Seat 5: niLn0xUVlqh8If80xRjzCA (button) mucked
Seat 6: d0J1xuhsynEY81YHwAvJ5g (small blind) folded before Flop




PokerStars Game #59939393712:  Hold'em No Limit ($0.10/$0.25) - 2009/07/01 0:38:43 ET
Table 'Ok3oDLIsTc2+KxPcI0bAOA' 6-max Seat #5 is the button
Seat 1: agQm3ugZ3qSVYNgNu1ddeA ($27.95 in chips) 
Seat 2: oseFhpinoe+Zg4j5xyBjyQ ($29.55 in chips) 
Seat 3: I1TxPvWj8NfG8orglCinNA ($25 in chips) 
Seat 4: WMiAkibyLuLJ32VI20myug ($12.05 in chips) 
Seat 5: nc79pm0LZRdhncq55evVqA ($27.90 in chips) 
Seat 6: JFIAqU8lCZ0vWwEl4bdGsg ($28.75 in chips) 
JFIAqU8lCZ0vWwEl4bdGsg: posts small blind $0.10
agQm3ugZ3qSVYNgNu1ddeA: posts big blind $0.25
*** HOLE CARDS ***
oseFhpinoe+Zg4j5xyBjyQ: folds 
I1TxPvWj8NfG8orglCinNA: folds 
WMiAkibyLuLJ32VI20myug: folds 
nc79pm0LZRdhncq55evVqA: raises $0.75 to $1
JFIAqU8lCZ0vWwEl4bdGsg: folds 
agQm3ugZ3qSVYNgNu1ddeA: folds 
Uncalled bet ($0.75) returned to nc79pm0LZRdhncq55evVqA
nc79pm0LZRdhncq55evVqA collected $0.60 from pot
nc79pm0LZRdhncq55evVqA: doesn't show hand 
*** SUMMARY ***
Total pot $0.60 | Rake $0 
Seat 1: agQm3ugZ3qSVYNgNu1ddeA (big blind) folded before Flop
Seat 2: oseFhpinoe+Zg4j5xyBjyQ folded before Flop (didn't bet)
Seat 3: I1TxPvWj8NfG8orglCinNA folded before Flop (didn't bet)
Seat 4: WMiAkibyLuLJ32VI20myug folded before Flop (didn't bet)
Seat 5: nc79pm0LZRdhncq55evVqA (button) collected ($0.60)
Seat 6: JFIAqU8lCZ0vWwEl4bdGsg (small blind) folded before Flop




PokerStars Game #59939393778:  Hold'em No Limit ($0.10/$0.25) - 2009/07/01 0:38:43 ET
Table '5510FxlYzKi+U6MIpo8IPA' 6-max Seat #6 is the button
Seat 1: KM6ogk7SqyRlk3m9b0h+7A ($18.65 in chips) 
Seat 3: v+QfkGiuj9bgtuNoVnDO8w ($26.20 in chips) 
Seat 4: cPO/1/dTcZpLkQFm3jH3Rg ($29.40 in chips) 
Seat 5: 5E1iMY5xyboow7Xm0v7Idw ($13.65 in chips) 
Seat 6: SFmT9ZsVopnukjvAzrxTRg ($30.10 in chips) 
KM6ogk7SqyRlk3m9b0h+7A: posts small blind $0.10
v+QfkGiuj9bgtuNoVnDO8w: posts big blind $0.25
*** HOLE CARDS ***
cPO/1/dTcZpLkQFm3jH3Rg: folds 
5E1iMY5xyboow7Xm0v7Idw has timed out
5E1iMY5xyboow7Xm0v7Idw: folds 
5E1iMY5xyboow7Xm0v7Idw is sitting out
5E1iMY5xyboow7Xm0v7Idw has returned
SFmT9ZsVopnukjvAzrxTRg: raises $0.75 to $1
KM6ogk7SqyRlk3m9b0h+7A: raises $2 to $3
v+QfkGiuj9bgtuNoVnDO8w: folds 
SFmT9ZsVopnukjvAzrxTRg: folds 
Uncalled bet ($2) returned to KM6ogk7SqyRlk3m9b0h+7A
KM6ogk7SqyRlk3m9b0h+7A collected $2.25 from pot
*** SUMMARY ***
Total pot $2.25 | Rake $0 
Seat 1: KM6ogk7SqyRlk3m9b0h+7A (small blind) collected ($2.25)
Seat 3: v+QfkGiuj9bgtuNoVnDO8w (big blind) folded before Flop
Seat 4: cPO/1/dTcZpLkQFm3jH3Rg folded before Flop (didn't bet)
Seat 5: 5E1iMY5xyboow7Xm0v7Idw folded before Flop (didn't bet)
Seat 6: SFmT9ZsVopnukjvAzrxTRg (button) folded before Flop




PokerStars Game #59939393536:  Hold'em No Limit ($0.10/$0.25) - 2009/07/01 0:38:43 ET
Table '9HJEqVOjSU5ECoVB4C4sgQ' 6-max Seat #6 is the button
Seat 1: EyMmRrAOlNpDOWLqSYRZdw ($29.20 in chips) 
Seat 2: sEQx9G5Cu8k1HNdQasxvUA ($36.10 in chips) 
Seat 3: KM6ogk7SqyRlk3m9b0h+7A ($12.25 in chips) 
Seat 4: mfrkWA3PTeYPkbO6hi98Aw ($34.40 in chips) 
Seat 6: aOMbOQ6Ji1Gie6dYOurd5A ($14.10 in chips) 
EyMmRrAOlNpDOWLqSYRZdw: posts small blind $0.10
sEQx9G5Cu8k1HNdQasxvUA: posts big blind $0.25
ymz+a8dgHSUFPooYplw7Ow: sits out 
*** HOLE CARDS ***
KM6ogk7SqyRlk3m9b0h+7A: calls $0.25
mfrkWA3PTeYPkbO6hi98Aw: folds 
aOMbOQ6Ji1Gie6dYOurd5A: folds 
EyMmRrAOlNpDOWLqSYRZdw: calls $0.15
sEQx9G5Cu8k1HNdQasxvUA: checks 
*** FLOP *** [3c Kh 9h]
EyMmRrAOlNpDOWLqSYRZdw: bets $0.50
sEQx9G5Cu8k1HNdQasxvUA: folds 
KM6ogk7SqyRlk3m9b0h+7A: raises $1 to $1.50
EyMmRrAOlNpDOWLqSYRZdw: calls $1
*** TURN *** [3c Kh 9h] [As]
EyMmRrAOlNpDOWLqSYRZdw: checks 
KM6ogk7SqyRlk3m9b0h+7A: bets $2
EyMmRrAOlNpDOWLqSYRZdw: folds 
Uncalled bet ($2) returned to KM6ogk7SqyRlk3m9b0h+7A
KM6ogk7SqyRlk3m9b0h+7A collected $3.60 from pot
*** SUMMARY ***
Total pot $3.75 | Rake $0.15 
Board [3c Kh 9h As]
Seat 1: EyMmRrAOlNpDOWLqSYRZdw (small blind) folded on the Turn
Seat 2: sEQx9G5Cu8k1HNdQasxvUA (big blind) folded on the Flop
Seat 3: KM6ogk7SqyRlk3m9b0h+7A collected ($3.60)
Seat 4: mfrkWA3PTeYPkbO6hi98Aw folded before Flop (didn't bet)
Seat 6: aOMbOQ6Ji1Gie6dYOurd5A (button) folded before Flop (didn't bet)




PokerStars Game #59939393484:  Hold'em No Limit ($0.10/$0.25) - 2009/07/01 0:38:43 ET
Table 'sgdCtiuCu2BDZhyDi6RzTA' 6-max Seat #4 is the button
Seat 2: FONMraB4GCHzDwDcfciKyw ($25 in chips) 
Seat 3: yzFNNFIfC89bBPwpFPx2ow ($15.35 in chips) 
Seat 4: rVKEgilmMX+EkKzDVvhmxA ($6.75 in chips) 
Seat 5: kD/Cb2UM93FAVgDMhEEb5g ($13.75 in chips) 
Seat 6: KODslGU8ikCYS0/29dUkhg ($7.35 in chips) 
kD/Cb2UM93FAVgDMhEEb5g: posts small blind $0.10
KODslGU8ikCYS0/29dUkhg: posts big blind $0.25
3zD3qLXT1bEffAoWGnc7wg: sits out 
*** HOLE CARDS ***
FONMraB4GCHzDwDcfciKyw: folds 
yzFNNFIfC89bBPwpFPx2ow: folds 
rVKEgilmMX+EkKzDVvhmxA: calls $0.25
kD/Cb2UM93FAVgDMhEEb5g: calls $0.15
KODslGU8ikCYS0/29dUkhg: checks 
*** FLOP *** [7s 7h 7c]
kD/Cb2UM93FAVgDMhEEb5g: checks 
KODslGU8ikCYS0/29dUkhg: checks 
rVKEgilmMX+EkKzDVvhmxA: bets $0.50
kD/Cb2UM93FAVgDMhEEb5g: calls $0.50
KODslGU8ikCYS0/29dUkhg: folds 
*** TURN *** [7s 7h 7c] [8c]
kD/Cb2UM93FAVgDMhEEb5g: checks 
rVKEgilmMX+EkKzDVvhmxA: checks 
*** RIVER *** [7s 7h 7c 8c] [Tc]
kD/Cb2UM93FAVgDMhEEb5g: bets $0.50
rVKEgilmMX+EkKzDVvhmxA: calls $0.50
*** SHOW DOWN ***
kD/Cb2UM93FAVgDMhEEb5g: shows [2c As] (three of a kind, Sevens)
rVKEgilmMX+EkKzDVvhmxA: shows [Ac Th] (a full house, Sevens full of Tens)
rVKEgilmMX+EkKzDVvhmxA collected $2.65 from pot
*** SUMMARY ***
Total pot $2.75 | Rake $0.10 
Board [7s 7h 7c 8c Tc]
Seat 2: FONMraB4GCHzDwDcfciKyw folded before Flop (didn't bet)
Seat 3: yzFNNFIfC89bBPwpFPx2ow folded before Flop (didn't bet)
Seat 4: rVKEgilmMX+EkKzDVvhmxA (button) showed [Ac Th] and won ($2.65) with a full house, Sevens full of Tens
Seat 5: kD/Cb2UM93FAVgDMhEEb5g (small blind) showed [2c As] and lost with three of a kind, Sevens
Seat 6: KODslGU8ikCYS0/29dUkhg (big blind) folded on the Flop




PokerStars Game #59939393790:  Hold'em No Limit ($0.10/$0.25) - 2009/07/01 0:38:43 ET
Table 'GrYi0DZOHD1EvB+qiLExNw' 9-max Seat #3 is the button
Seat 1: 4awUyiDYTgylQKXZ9faBVA ($48.85 in chips) 
Seat 2: Th3FldXKQW6hWVVPahaoOQ ($26.30 in chips) 
Seat 3: 4oA316mXLIui1QY63GXBUg ($25 in chips) 
Seat 5: cZ99hugmLBj9KhTlc8nCSw ($48.60 in chips) 
Seat 6: H9KUl8cmpLgEpOVDA00bCg ($4.55 in chips) 
Seat 7: 1Clf3cPrqoy/YgvWdWK1Xw ($5.25 in chips) 
Seat 9: st9jtdNbm1W5GfBwRaCVqQ ($24.75 in chips) 
cZ99hugmLBj9KhTlc8nCSw: posts small blind $0.10
H9KUl8cmpLgEpOVDA00bCg: posts big blind $0.25
*** HOLE CARDS ***
1Clf3cPrqoy/YgvWdWK1Xw: folds 
st9jtdNbm1W5GfBwRaCVqQ: folds 
4awUyiDYTgylQKXZ9faBVA: folds 
0GQg6tdDMBDzY6FKumSo9w has returned
Th3FldXKQW6hWVVPahaoOQ: raises $0.75 to $1
4oA316mXLIui1QY63GXBUg: folds 
cZ99hugmLBj9KhTlc8nCSw: folds 
H9KUl8cmpLgEpOVDA00bCg: folds 
Uncalled bet ($0.75) returned to Th3FldXKQW6hWVVPahaoOQ
Th3FldXKQW6hWVVPahaoOQ collected $0.60 from pot
Th3FldXKQW6hWVVPahaoOQ: doesn't show hand 
*** SUMMARY ***
Total pot $0.60 | Rake $0 
Seat 1: 4awUyiDYTgylQKXZ9faBVA folded before Flop (didn't bet)
Seat 2: Th3FldXKQW6hWVVPahaoOQ collected ($0.60)
Seat 3: 4oA316mXLIui1QY63GXBUg (button) folded before Flop (didn't bet)
Seat 5: cZ99hugmLBj9KhTlc8nCSw (small blind) folded before Flop
Seat 6: H9KUl8cmpLgEpOVDA00bCg (big blind) folded before Flop
Seat 7: 1Clf3cPrqoy/YgvWdWK1Xw folded before Flop (didn't bet)
Seat 9: st9jtdNbm1W5GfBwRaCVqQ folded before Flop (didn't bet)




PokerStars Game #59939394248:  Hold'em No Limit ($0.10/$0.25) - 2009/07/01 0:38:44 ET
Table 'WY+lMaAoIdBZmwk27/RJCA' 6-max Seat #4 is the button
Seat 1: lYjWCpfCxX2kgcHY3v4Yow ($25 in chips) 
Seat 2: cPO/1/dTcZpLkQFm3jH3Rg ($25.05 in chips) 
Seat 3: 79Q62AM0VB++TQYiBlOYsA ($38.05 in chips) 
Seat 4: cGfAi40F+9odP4v0stvfiQ ($27.95 in chips) 
Seat 5: wKFJ513ucluNNiMlkXcDOQ ($29.45 in chips) 
Seat 6: I1TxPvWj8NfG8orglCinNA ($25.70 in chips) 
wKFJ513ucluNNiMlkXcDOQ: posts small blind $0.10
I1TxPvWj8NfG8orglCinNA: posts big blind $0.25
*** HOLE CARDS ***
lYjWCpfCxX2kgcHY3v4Yow: folds 
cPO/1/dTcZpLkQFm3jH3Rg: folds 
79Q62AM0VB++TQYiBlOYsA: folds 
cGfAi40F+9odP4v0stvfiQ: calls $0.25
wKFJ513ucluNNiMlkXcDOQ: folds 
I1TxPvWj8NfG8orglCinNA: checks 
*** FLOP *** [7c 9h Ah]
I1TxPvWj8NfG8orglCinNA: checks 
cGfAi40F+9odP4v0stvfiQ: checks 
*** TURN *** [7c 9h Ah] [Kd]
I1TxPvWj8NfG8orglCinNA: checks 
cGfAi40F+9odP4v0stvfiQ: bets $0.75
I1TxPvWj8NfG8orglCinNA: calls $0.75
*** RIVER *** [7c 9h Ah Kd] [2c]
I1TxPvWj8NfG8orglCinNA: checks 
cGfAi40F+9odP4v0stvfiQ: bets $1
I1TxPvWj8NfG8orglCinNA: calls $1
*** SHOW DOWN ***
cGfAi40F+9odP4v0stvfiQ: shows [2s 6s] (a pair of Deuces)
I1TxPvWj8NfG8orglCinNA: shows [Js Ks] (a pair of Kings)
I1TxPvWj8NfG8orglCinNA collected $3.90 from pot
*** SUMMARY ***
Total pot $4.10 | Rake $0.20 
Board [7c 9h Ah Kd 2c]
Seat 1: lYjWCpfCxX2kgcHY3v4Yow folded before Flop (didn't bet)
Seat 2: cPO/1/dTcZpLkQFm3jH3Rg folded before Flop (didn't bet)
Seat 3: 79Q62AM0VB++TQYiBlOYsA folded before Flop (didn't bet)
Seat 4: cGfAi40F+9odP4v0stvfiQ (button) showed [2s 6s] and lost with a pair of Deuces
Seat 5: wKFJ513ucluNNiMlkXcDOQ (small blind) folded before Flop
Seat 6: I1TxPvWj8NfG8orglCinNA (big blind) showed [Js Ks] and won ($3.90) with a pair of Kings




PokerStars Game #59939393938:  Hold'em No Limit ($0.10/$0.25) - 2009/07/01 0:38:44 ET
Table 'OvOqQoL/QnXuXuQjXo2hIQ' 9-max Seat #7 is the button
Seat 3: uJlzv9KL7hgCIqIS2ofoaw ($11.20 in chips) 
Seat 4: e8solDZU6VFefGEm0DJbUg ($11.15 in chips) 
Seat 5: sJNHTWcSlLHRCZ9+YRLLqA ($28.95 in chips) 
Seat 6: MIVCHqCqqlke0Lb0z7glcw ($46.65 in chips) 
Seat 7: aNpwfA31EREwO+ar4XzBCw ($26.80 in chips) 
Seat 9: VWUWpMLMj/Q1jRVpF7Aohw ($14.70 in chips) 
VWUWpMLMj/Q1jRVpF7Aohw: posts small blind $0.10
uJlzv9KL7hgCIqIS2ofoaw: posts big blind $0.25
*** HOLE CARDS ***
e8solDZU6VFefGEm0DJbUg: raises $0.25 to $0.50
sJNHTWcSlLHRCZ9+YRLLqA: folds 
MIVCHqCqqlke0Lb0z7glcw: folds 
aNpwfA31EREwO+ar4XzBCw: folds 
VWUWpMLMj/Q1jRVpF7Aohw: folds 
Xbfvrzh7Jjg4vOZkdMSfbA has returned
uJlzv9KL7hgCIqIS2ofoaw: folds 
Uncalled bet ($0.25) returned to e8solDZU6VFefGEm0DJbUg
e8solDZU6VFefGEm0DJbUg collected $0.60 from pot
e8solDZU6VFefGEm0DJbUg: doesn't show hand 
*** SUMMARY ***
Total pot $0.60 | Rake $0 
Seat 3: uJlzv9KL7hgCIqIS2ofoaw (big blind) folded before Flop
Seat 4: e8solDZU6VFefGEm0DJbUg collected ($0.60)
Seat 5: sJNHTWcSlLHRCZ9+YRLLqA folded before Flop (didn't bet)
Seat 6: MIVCHqCqqlke0Lb0z7glcw folded before Flop (didn't bet)
Seat 7: aNpwfA31EREwO+ar4XzBCw (button) folded before Flop (didn't bet)
Seat 9: VWUWpMLMj/Q1jRVpF7Aohw (small blind) folded before Flop




PokerStars Game #59939394846:  Hold'em No Limit ($0.10/$0.25) - 2009/07/01 0:38:45 ET
Table 'wPWRBZPJl1HAnysw7qRR0A' 6-max Seat #3 is the button
Seat 1: cPO/1/dTcZpLkQFm3jH3Rg ($49.60 in chips) 
Seat 2: 48oT5xFI+5CHUJlfoGrE4w ($6.55 in chips) 
Seat 3: rPToQDbLWB+dKnz7fcQSIg ($8.05 in chips) 
Seat 4: kbpWbC+dJNBphHl1jtw7bw ($15 in chips) 
Seat 5: LtASJ9OlkqGrrUKGQlpGAw ($22.30 in chips) 
Seat 6: VLoE/jniCqHZuUkx8Esf6w ($29.55 in chips) 
kbpWbC+dJNBphHl1jtw7bw: posts small blind $0.10
LtASJ9OlkqGrrUKGQlpGAw: posts big blind $0.25
*** HOLE CARDS ***
VLoE/jniCqHZuUkx8Esf6w: calls $0.25
cPO/1/dTcZpLkQFm3jH3Rg: folds 
48oT5xFI+5CHUJlfoGrE4w: folds 
rPToQDbLWB+dKnz7fcQSIg: raises $1 to $1.25
kbpWbC+dJNBphHl1jtw7bw: calls $1.15
LtASJ9OlkqGrrUKGQlpGAw: folds 
VLoE/jniCqHZuUkx8Esf6w: calls $1
*** FLOP *** [6c 8c 9c]
kbpWbC+dJNBphHl1jtw7bw: checks 
VLoE/jniCqHZuUkx8Esf6w: checks 
rPToQDbLWB+dKnz7fcQSIg: bets $3
kbpWbC+dJNBphHl1jtw7bw: calls $3
VLoE/jniCqHZuUkx8Esf6w: folds 
*** TURN *** [6c 8c 9c] [Ts]
kbpWbC+dJNBphHl1jtw7bw: checks 
rPToQDbLWB+dKnz7fcQSIg: bets $3.80 and is all-in
kbpWbC+dJNBphHl1jtw7bw: calls $3.80
*** RIVER *** [6c 8c 9c Ts] [Th]
*** SHOW DOWN ***
kbpWbC+dJNBphHl1jtw7bw: shows [Ad Tc] (three of a kind, Tens)
rPToQDbLWB+dKnz7fcQSIg: mucks hand 
kbpWbC+dJNBphHl1jtw7bw collected $16.75 from pot
*** SUMMARY ***
Total pot $17.60 | Rake $0.85 
Board [6c 8c 9c Ts Th]
Seat 1: cPO/1/dTcZpLkQFm3jH3Rg folded before Flop (didn't bet)
Seat 2: 48oT5xFI+5CHUJlfoGrE4w folded before Flop (didn't bet)
Seat 3: rPToQDbLWB+dKnz7fcQSIg (button) mucked
Seat 4: kbpWbC+dJNBphHl1jtw7bw (small blind) showed [Ad Tc] and won ($16.75) with three of a kind, Tens
Seat 5: LtASJ9OlkqGrrUKGQlpGAw (big blind) folded before Flop
Seat 6: VLoE/jniCqHZuUkx8Esf6w folded on the Flop




PokerStars Game #59939394630:  Hold'em No Limit ($0.10/$0.25) - 2009/07/01 0:38:45 ET
Table 'pgrBYaOEx/BuqK5iAtlFzw' 9-max Seat #3 is the button
Seat 3: bfSq6LBw0UvxeM5yfuWC7w ($15.20 in chips) 
Seat 5: efYVL4adq0ufQFnZCpL5Tw ($5.20 in chips) 
bfSq6LBw0UvxeM5yfuWC7w: posts small blind $0.10
efYVL4adq0ufQFnZCpL5Tw: posts big blind $0.25
*** HOLE CARDS ***
bfSq6LBw0UvxeM5yfuWC7w: folds 
Uncalled bet ($0.15) returned to efYVL4adq0ufQFnZCpL5Tw
efYVL4adq0ufQFnZCpL5Tw collected $0.20 from pot
*** SUMMARY ***
Total pot $0.20 | Rake $0 
Seat 3: bfSq6LBw0UvxeM5yfuWC7w (button) (small blind) folded before Flop
Seat 5: efYVL4adq0ufQFnZCpL5Tw (big blind) collected ($0.20)




PokerStars Game #59939394566:  Hold'em No Limit ($0.10/$0.25) - 2009/07/01 0:38:45 ET
Table 'sgB7AwZtVgDTf4fi8RwWFQ' 9-max Seat #3 is the button
Seat 1: QEbIGci+itdw+re8RM5fZA ($25 in chips) 
Seat 2: DnDcAdn9P0zGovMERigpFA ($32 in chips) 
Seat 3: OlPJsgR4xypSg/w1z7Gyvw ($19.75 in chips) 
Seat 5: gPFzi0PLRAvfKu2GYwa1VA ($16.65 in chips) 
Seat 6: 1q23ISSsSMhv2lHXBfj9/A ($23.75 in chips) 
Seat 7: j4q3p0lesp63b1gZDwLBZw ($9.85 in chips) 
Seat 8: Nq5F1B22aaLLZ+D9HbzcGg ($21.65 in chips) 
Seat 9: MG90wfSJZnOejs/KD3vlQQ ($32.60 in chips) 
gPFzi0PLRAvfKu2GYwa1VA: posts small blind $0.10
1q23ISSsSMhv2lHXBfj9/A: posts big blind $0.25
*** HOLE CARDS ***
j4q3p0lesp63b1gZDwLBZw: folds 
Nq5F1B22aaLLZ+D9HbzcGg: folds 
MG90wfSJZnOejs/KD3vlQQ: folds 
QEbIGci+itdw+re8RM5fZA: folds 
j4q3p0lesp63b1gZDwLBZw leaves the table
DnDcAdn9P0zGovMERigpFA: folds 
OlPJsgR4xypSg/w1z7Gyvw: raises $0.50 to $0.75
gPFzi0PLRAvfKu2GYwa1VA: folds 
1q23ISSsSMhv2lHXBfj9/A: folds 
Uncalled bet ($0.50) returned to OlPJsgR4xypSg/w1z7Gyvw
OlPJsgR4xypSg/w1z7Gyvw collected $0.60 from pot
*** SUMMARY ***
Total pot $0.60 | Rake $0 
Seat 1: QEbIGci+itdw+re8RM5fZA folded before Flop (didn't bet)
Seat 2: DnDcAdn9P0zGovMERigpFA folded before Flop (didn't bet)
Seat 3: OlPJsgR4xypSg/w1z7Gyvw (button) collected ($0.60)
Seat 5: gPFzi0PLRAvfKu2GYwa1VA (small blind) folded before Flop
Seat 6: 1q23ISSsSMhv2lHXBfj9/A (big blind) folded before Flop
Seat 7: j4q3p0lesp63b1gZDwLBZw folded before Flop (didn't bet)
Seat 8: Nq5F1B22aaLLZ+D9HbzcGg folded before Flop (didn't bet)
Seat 9: MG90wfSJZnOejs/KD3vlQQ folded before Flop (didn't bet)




PokerStars Game #59939394938:  Hold'em No Limit ($0.10/$0.25) - 2009/07/01 0:38:45 ET
Table '7eunnLa5p3aGsPrUrNnn/A' 9-max Seat #3 is the button
Seat 1: Ml2bY77EHbM51ZWD7dnIWg ($30 in chips) 
Seat 2: aJy680tKSaP5er559aSuGA ($12.25 in chips) 
Seat 3: E0iYnEVO2ho7dH3QcCjw7g ($19.20 in chips) 
Seat 4: opOCI2p6kW0tINuVaAqmcQ ($30.80 in chips) 
Seat 5: JLfmdpDbz2ljMNE7ICboMQ ($8.05 in chips) 
Seat 6: jx9kXw1SAZrvXp9Nerz8+Q ($16.95 in chips) 
Seat 8: 1Clf3cPrqoy/YgvWdWK1Xw ($5 in chips) 
Seat 9: rUpvA02nErFvZ4yFbDR8XA ($21.05 in chips) 
opOCI2p6kW0tINuVaAqmcQ: posts small blind $0.10
JLfmdpDbz2ljMNE7ICboMQ: posts big blind $0.25
*** HOLE CARDS ***
jx9kXw1SAZrvXp9Nerz8+Q: folds 
1Clf3cPrqoy/YgvWdWK1Xw: folds 
rUpvA02nErFvZ4yFbDR8XA: folds 
Ml2bY77EHbM51ZWD7dnIWg: calls $0.25
aJy680tKSaP5er559aSuGA: folds 
E0iYnEVO2ho7dH3QcCjw7g: calls $0.25
opOCI2p6kW0tINuVaAqmcQ: folds 
JLfmdpDbz2ljMNE7ICboMQ: checks 
*** FLOP *** [3h Kc Tc]
JLfmdpDbz2ljMNE7ICboMQ: checks 
Ml2bY77EHbM51ZWD7dnIWg: checks 
E0iYnEVO2ho7dH3QcCjw7g: bets $0.75
JLfmdpDbz2ljMNE7ICboMQ: folds 
Ml2bY77EHbM51ZWD7dnIWg: folds 
Uncalled bet ($0.75) returned to E0iYnEVO2ho7dH3QcCjw7g
E0iYnEVO2ho7dH3QcCjw7g collected $0.85 from pot
*** SUMMARY ***
Total pot $0.85 | Rake $0 
Board [3h Kc Tc]
Seat 1: Ml2bY77EHbM51ZWD7dnIWg folded on the Flop
Seat 2: aJy680tKSaP5er559aSuGA folded before Flop (didn't bet)
Seat 3: E0iYnEVO2ho7dH3QcCjw7g (button) collected ($0.85)
Seat 4: opOCI2p6kW0tINuVaAqmcQ (small blind) folded before Flop
Seat 5: JLfmdpDbz2ljMNE7ICboMQ (big blind) folded on the Flop
Seat 6: jx9kXw1SAZrvXp9Nerz8+Q folded before Flop (didn't bet)
Seat 8: 1Clf3cPrqoy/YgvWdWK1Xw folded before Flop (didn't bet)
Seat 9: rUpvA02nErFvZ4yFbDR8XA folded before Flop (didn't bet)




PokerStars Game #59939395252:  Hold'em No Limit ($0.10/$0.25) - 2009/07/01 0:38:46 ET
Table 'Of/T60zpXg1GcjrZ7Lm//Q' 9-max Seat #5 is the button
Seat 1: Lro4e37x4FUa5P3yzDjskw ($7.80 in chips) 
Seat 2: hIss79a4pu7GzJZepfgOpg ($25.45 in chips) 
Seat 3: jeKWRUkMaVn8rEUjnJKqpg ($25 in chips) 
Seat 4: Czut6V7acIqUJrrobjKAZg ($25.05 in chips) 
Seat 5: 18G4P1XstjNvItdGUITxgw ($25 in chips) 
Seat 6: tYsOBqdU1+x+yFI7zHO7hQ ($25.85 in chips) 
Seat 7: s7Q6uNouhe7aE8JdFb9E+A ($34.25 in chips) 
Seat 8: ghNKXUBl/H+t83JF079ZBA ($29 in chips) 
Seat 9: TeWJxSETzbXGiYKx0y+dtg ($24.65 in chips) 
tYsOBqdU1+x+yFI7zHO7hQ: posts small blind $0.10
s7Q6uNouhe7aE8JdFb9E+A: posts big blind $0.25
*** HOLE CARDS ***
ghNKXUBl/H+t83JF079ZBA: folds 
TeWJxSETzbXGiYKx0y+dtg: folds 
Lro4e37x4FUa5P3yzDjskw: folds 
hIss79a4pu7GzJZepfgOpg: folds 
jeKWRUkMaVn8rEUjnJKqpg: folds 
Czut6V7acIqUJrrobjKAZg: folds 
18G4P1XstjNvItdGUITxgw: folds 
tYsOBqdU1+x+yFI7zHO7hQ: folds 
Uncalled bet ($0.15) returned to s7Q6uNouhe7aE8JdFb9E+A
s7Q6uNouhe7aE8JdFb9E+A collected $0.20 from pot
s7Q6uNouhe7aE8JdFb9E+A: doesn't show hand 
*** SUMMARY ***
Total pot $0.20 | Rake $0 
Seat 1: Lro4e37x4FUa5P3yzDjskw folded before Flop (didn't bet)
Seat 2: hIss79a4pu7GzJZepfgOpg folded before Flop (didn't bet)
Seat 3: jeKWRUkMaVn8rEUjnJKqpg folded before Flop (didn't bet)
Seat 4: Czut6V7acIqUJrrobjKAZg folded before Flop (didn't bet)
Seat 5: 18G4P1XstjNvItdGUITxgw (button) folded before Flop (didn't bet)
Seat 6: tYsOBqdU1+x+yFI7zHO7hQ (small blind) folded before Flop
Seat 7: s7Q6uNouhe7aE8JdFb9E+A (big blind) collected ($0.20)
Seat 8: ghNKXUBl/H+t83JF079ZBA folded before Flop (didn't bet)
Seat 9: TeWJxSETzbXGiYKx0y+dtg folded before Flop (didn't bet)




PokerStars Game #59939395250:  Hold'em No Limit ($0.10/$0.25) - 2009/07/01 0:38:46 ET
Table '5NipxzzFB2DffzDpddyQoQ' 6-max Seat #5 is the button
Seat 1: TslQs7AQSLbVtr4X8JOOOQ ($15 in chips) 
Seat 2: jxrNE4qd8KCOIqHjQcwCrA ($40.80 in chips) 
Seat 3: qGHGf/553gQnDoklMRe3tg ($46.90 in chips) 
Seat 4: Inq44d7PQ+8TbEKfPeuxVQ ($6.35 in chips) 
Seat 5: cS21pIxRHx5Gt42o7hPZzw ($12.30 in chips) 
Seat 6: lYjWCpfCxX2kgcHY3v4Yow ($27.40 in chips) 
lYjWCpfCxX2kgcHY3v4Yow: posts small blind $0.10
TslQs7AQSLbVtr4X8JOOOQ: posts big blind $0.25
*** HOLE CARDS ***
jxrNE4qd8KCOIqHjQcwCrA: folds 
qGHGf/553gQnDoklMRe3tg: folds 
Inq44d7PQ+8TbEKfPeuxVQ: folds 
cS21pIxRHx5Gt42o7hPZzw: folds 
lYjWCpfCxX2kgcHY3v4Yow: folds 
Uncalled bet ($0.15) returned to TslQs7AQSLbVtr4X8JOOOQ
TslQs7AQSLbVtr4X8JOOOQ collected $0.20 from pot
*** SUMMARY ***
Total pot $0.20 | Rake $0 
Seat 1: TslQs7AQSLbVtr4X8JOOOQ (big blind) collected ($0.20)
Seat 2: jxrNE4qd8KCOIqHjQcwCrA folded before Flop (didn't bet)
Seat 3: qGHGf/553gQnDoklMRe3tg folded before Flop (didn't bet)
Seat 4: Inq44d7PQ+8TbEKfPeuxVQ folded before Flop (didn't bet)
Seat 5: cS21pIxRHx5Gt42o7hPZzw (button) folded before Flop (didn't bet)
Seat 6: lYjWCpfCxX2kgcHY3v4Yow (small blind) folded before Flop




PokerStars Game #59939395556:  Hold'em No Limit ($0.10/$0.25) - 2009/07/01 0:38:47 ET
Table 'U0hCzoS0KCJL+eoE054K4Q' 9-max Seat #8 is the button
Seat 2: MG90wfSJZnOejs/KD3vlQQ ($25 in chips) 
Seat 4: REZJH+hR80RwfrJtUNUJOw ($28.70 in chips) 
Seat 5: gN5V9qraLHmhKzjLHzt7qA ($15.50 in chips) 
Seat 7: NNZypfH1f/VIj3Skf/XIzg ($5 in chips) 
Seat 8: Xpyqpb+DURDWnyJ3xTEIFQ ($26.80 in chips) 
Seat 9: X9HkgGdfFul8DB9rhTbyFw ($37.45 in chips) 
X9HkgGdfFul8DB9rhTbyFw: posts small blind $0.10
MG90wfSJZnOejs/KD3vlQQ: posts big blind $0.25
*** HOLE CARDS ***
REZJH+hR80RwfrJtUNUJOw: folds 
gN5V9qraLHmhKzjLHzt7qA: calls $0.25
NNZypfH1f/VIj3Skf/XIzg: folds 
Xpyqpb+DURDWnyJ3xTEIFQ: folds 
X9HkgGdfFul8DB9rhTbyFw: folds 
u/r4MjA69AbvOh1qLp6Eig joins the table at seat #3 
MG90wfSJZnOejs/KD3vlQQ: checks 
*** FLOP *** [8h 6s Td]
MG90wfSJZnOejs/KD3vlQQ: checks 
gN5V9qraLHmhKzjLHzt7qA: checks 
*** TURN *** [8h 6s Td] [5s]
CYkY0dNBaYaKs8HVCVn3mQ joins the table at seat #1 
MG90wfSJZnOejs/KD3vlQQ: checks 
gN5V9qraLHmhKzjLHzt7qA: bets $0.25
MG90wfSJZnOejs/KD3vlQQ: folds 
Uncalled bet ($0.25) returned to gN5V9qraLHmhKzjLHzt7qA
gN5V9qraLHmhKzjLHzt7qA collected $0.60 from pot
gN5V9qraLHmhKzjLHzt7qA: doesn't show hand 
*** SUMMARY ***
Total pot $0.60 | Rake $0 
Board [8h 6s Td 5s]
Seat 2: MG90wfSJZnOejs/KD3vlQQ (big blind) folded on the Turn
Seat 4: REZJH+hR80RwfrJtUNUJOw folded before Flop (didn't bet)
Seat 5: gN5V9qraLHmhKzjLHzt7qA collected ($0.60)
Seat 7: NNZypfH1f/VIj3Skf/XIzg folded before Flop (didn't bet)
Seat 8: Xpyqpb+DURDWnyJ3xTEIFQ (button) folded before Flop (didn't bet)
Seat 9: X9HkgGdfFul8DB9rhTbyFw (small blind) folded before Flop




PokerStars Game #59939395652:  Hold'em No Limit ($0.10/$0.25) - 2009/07/01 0:38:47 ET
Table 'zhqgUUprOJ14VxKxPHcT/Q' 9-max Seat #8 is the button
Seat 3: G2offPrpnppc++nuXqs2JA ($17.25 in chips) 
Seat 4: EfeOSXE8Wc4WWEsgc3WzZg ($8.55 in chips) 
Seat 5: +sbyWwIcFp9kP0bDtMegfQ ($26.40 in chips) 
Seat 6: DIBbjEYGs+TVdVgEB/4+3w ($23.10 in chips) 
Seat 8: amD2PwT1xB7aC2k57sa7Ig ($29.20 in chips) 
Seat 9: 4awUyiDYTgylQKXZ9faBVA ($35.85 in chips) 
4awUyiDYTgylQKXZ9faBVA: posts small blind $0.10
q9qPRjJC40e/Q9yuT+glwQ: is sitting out 
G2offPrpnppc++nuXqs2JA: posts big blind $0.25
aPRz/2GxbXANYpVsQO8pdQ: sits out 
*** HOLE CARDS ***
EfeOSXE8Wc4WWEsgc3WzZg: folds 
+sbyWwIcFp9kP0bDtMegfQ: raises $0.75 to $1
DIBbjEYGs+TVdVgEB/4+3w: folds 
amD2PwT1xB7aC2k57sa7Ig: folds 
4awUyiDYTgylQKXZ9faBVA: folds 
G2offPrpnppc++nuXqs2JA: folds 
Uncalled bet ($0.75) returned to +sbyWwIcFp9kP0bDtMegfQ
+sbyWwIcFp9kP0bDtMegfQ collected $0.60 from pot
+sbyWwIcFp9kP0bDtMegfQ: doesn't show hand 
*** SUMMARY ***
Total pot $0.60 | Rake $0 
Seat 3: G2offPrpnppc++nuXqs2JA (big blind) folded before Flop
Seat 4: EfeOSXE8Wc4WWEsgc3WzZg folded before Flop (didn't bet)
Seat 5: +sbyWwIcFp9kP0bDtMegfQ collected ($0.60)
Seat 6: DIBbjEYGs+TVdVgEB/4+3w folded before Flop (didn't bet)
Seat 8: amD2PwT1xB7aC2k57sa7Ig (button) folded before Flop (didn't bet)
Seat 9: 4awUyiDYTgylQKXZ9faBVA (small blind) folded before Flop




PokerStars Game #59939395366:  Hold'em No Limit ($0.10/$0.25) - 2009/07/01 0:38:47 ET
Table 'ykyWGjhNu7AvZXov27T4ew' 9-max Seat #8 is the button
Seat 2: MG90wfSJZnOejs/KD3vlQQ ($25.35 in chips) 
Seat 3: r1pFKMwWp74QwhfPWJOAyw ($5.55 in chips) 
Seat 4: hBMUlEpyU74r/fwDgIpXjQ ($25.80 in chips) 
Seat 5: lMysP2jE94oJvWGA6K5puw ($7.75 in chips) 
Seat 6: opOCI2p6kW0tINuVaAqmcQ ($25 in chips) 
Seat 8: tYsOBqdU1+x+yFI7zHO7hQ ($31.95 in chips) 
Seat 9: Yv4fucyyT28mjx8V5lxKJg ($25.25 in chips) 
Yv4fucyyT28mjx8V5lxKJg: posts small blind $0.10
MG90wfSJZnOejs/KD3vlQQ: posts big blind $0.25
*** HOLE CARDS ***
r1pFKMwWp74QwhfPWJOAyw: folds 
hBMUlEpyU74r/fwDgIpXjQ: folds 
lMysP2jE94oJvWGA6K5puw: folds 
opOCI2p6kW0tINuVaAqmcQ: folds 
tYsOBqdU1+x+yFI7zHO7hQ: raises $0.50 to $0.75
Yv4fucyyT28mjx8V5lxKJg: folds 
MG90wfSJZnOejs/KD3vlQQ: folds 
Uncalled bet ($0.50) returned to tYsOBqdU1+x+yFI7zHO7hQ
CYkY0dNBaYaKs8HVCVn3mQ joins the table at seat #7 
tYsOBqdU1+x+yFI7zHO7hQ collected $0.60 from pot
tYsOBqdU1+x+yFI7zHO7hQ: doesn't show hand 
*** SUMMARY ***
Total pot $0.60 | Rake $0 
Seat 2: MG90wfSJZnOejs/KD3vlQQ (big blind) folded before Flop
Seat 3: r1pFKMwWp74QwhfPWJOAyw folded before Flop (didn't bet)
Seat 4: hBMUlEpyU74r/fwDgIpXjQ folded before Flop (didn't bet)
Seat 5: lMysP2jE94oJvWGA6K5puw folded before Flop (didn't bet)
Seat 6: opOCI2p6kW0tINuVaAqmcQ folded before Flop (didn't bet)
Seat 8: tYsOBqdU1+x+yFI7zHO7hQ (button) collected ($0.60)
Seat 9: Yv4fucyyT28mjx8V5lxKJg (small blind) folded before Flop




PokerStars Game #59939395418:  Hold'em No Limit ($0.10/$0.25) - 2009/07/01 0:38:47 ET
Table 'FgLmv9bi/fJP8ldfbTOpkg' 9-max Seat #2 is the button
Seat 1: opOCI2p6kW0tINuVaAqmcQ ($25 in chips) 
Seat 2: mpsfNtnMVDqQHTe92AhIdw ($18.65 in chips) 
Seat 4: WfS0TjI8FyLemNTOo1e9qA ($11.65 in chips) 
Seat 6: oKO7b50N6TzXbPBr/mcrUA ($32.70 in chips) 
Seat 7: eFrBtVXGVoMq1UwCDg8Exg ($24.65 in chips) 
Seat 8: sJNHTWcSlLHRCZ9+YRLLqA ($25 in chips) 
Seat 9: Th3FldXKQW6hWVVPahaoOQ ($25 in chips) 
WfS0TjI8FyLemNTOo1e9qA: posts small blind $0.10
oKO7b50N6TzXbPBr/mcrUA: posts big blind $0.25
*** HOLE CARDS ***
eFrBtVXGVoMq1UwCDg8Exg: calls $0.25
sJNHTWcSlLHRCZ9+YRLLqA: raises $0.95 to $1.20
Th3FldXKQW6hWVVPahaoOQ: folds 
opOCI2p6kW0tINuVaAqmcQ: folds 
mpsfNtnMVDqQHTe92AhIdw: folds 
WfS0TjI8FyLemNTOo1e9qA: calls $1.10
oKO7b50N6TzXbPBr/mcrUA: folds 
eFrBtVXGVoMq1UwCDg8Exg: calls $0.95
*** FLOP *** [8d 6d 3d]
WfS0TjI8FyLemNTOo1e9qA: checks 
eFrBtVXGVoMq1UwCDg8Exg: checks 
sJNHTWcSlLHRCZ9+YRLLqA: bets $3.70
WfS0TjI8FyLemNTOo1e9qA: raises $3.70 to $7.40
eFrBtVXGVoMq1UwCDg8Exg: folds 
sJNHTWcSlLHRCZ9+YRLLqA: raises $14.70 to $22.10
WfS0TjI8FyLemNTOo1e9qA: calls $3.05 and is all-in
Uncalled bet ($11.65) returned to sJNHTWcSlLHRCZ9+YRLLqA
*** TURN *** [8d 6d 3d] [7d]
*** RIVER *** [8d 6d 3d 7d] [Qs]
*** SHOW DOWN ***
WfS0TjI8FyLemNTOo1e9qA: shows [As Jd] (a flush, Jack high)
sJNHTWcSlLHRCZ9+YRLLqA: mucks hand 
WfS0TjI8FyLemNTOo1e9qA collected $23.55 from pot
*** SUMMARY ***
Total pot $24.75 | Rake $1.20 
Board [8d 6d 3d 7d Qs]
Seat 1: opOCI2p6kW0tINuVaAqmcQ folded before Flop (didn't bet)
Seat 2: mpsfNtnMVDqQHTe92AhIdw (button) folded before Flop (didn't bet)
Seat 4: WfS0TjI8FyLemNTOo1e9qA (small blind) showed [As Jd] and won ($23.55) with a flush, Jack high
Seat 6: oKO7b50N6TzXbPBr/mcrUA (big blind) folded before Flop
Seat 7: eFrBtVXGVoMq1UwCDg8Exg folded on the Flop
Seat 8: sJNHTWcSlLHRCZ9+YRLLqA mucked
Seat 9: Th3FldXKQW6hWVVPahaoOQ folded before Flop (didn't bet)




PokerStars Game #59939396108:  Hold'em No Limit ($0.10/$0.25) - 2009/07/01 0:38:47 ET
Table 'zKwHJD0cmKNUure9qQTfFg' 6-max Seat #4 is the button
Seat 1: zsU1ijOyYEi+40wBKPEbmw ($21.45 in chips) 
Seat 2: XwQK8xvCADxp0bUmji+Zyg ($32.25 in chips) 
Seat 4: v+QfkGiuj9bgtuNoVnDO8w ($25 in chips) 
Seat 5: I1TxPvWj8NfG8orglCinNA ($25.30 in chips) 
Seat 6: BvTq4Tu0zBOsniW3eFCnkQ ($28.75 in chips) 
I1TxPvWj8NfG8orglCinNA: posts small blind $0.10
BvTq4Tu0zBOsniW3eFCnkQ: posts big blind $0.25
*** HOLE CARDS ***
zsU1ijOyYEi+40wBKPEbmw: calls $0.25
XwQK8xvCADxp0bUmji+Zyg: folds 
v+QfkGiuj9bgtuNoVnDO8w: folds 
N7x3NAOGB0YpNXK0ejtQ1Q said, "4 5s out there"
I1TxPvWj8NfG8orglCinNA: folds 
BvTq4Tu0zBOsniW3eFCnkQ: checks 
*** FLOP *** [7d Ac Jh]
BvTq4Tu0zBOsniW3eFCnkQ: checks 
zsU1ijOyYEi+40wBKPEbmw: bets $0.50
BvTq4Tu0zBOsniW3eFCnkQ: folds 
Uncalled bet ($0.50) returned to zsU1ijOyYEi+40wBKPEbmw
zsU1ijOyYEi+40wBKPEbmw collected $0.60 from pot
*** SUMMARY ***
Total pot $0.60 | Rake $0 
Board [7d Ac Jh]
Seat 1: zsU1ijOyYEi+40wBKPEbmw collected ($0.60)
Seat 2: XwQK8xvCADxp0bUmji+Zyg folded before Flop (didn't bet)
Seat 4: v+QfkGiuj9bgtuNoVnDO8w (button) folded before Flop (didn't bet)
Seat 5: I1TxPvWj8NfG8orglCinNA (small blind) folded before Flop
Seat 6: BvTq4Tu0zBOsniW3eFCnkQ (big blind) folded on the Flop




PokerStars Game #59939396082:  Hold'em No Limit ($0.10/$0.25) - 2009/07/01 0:38:47 ET
Table 'mF3KHGMaTpaBZbtBoyfTeg' 6-max Seat #5 is the button
Seat 1: 0HAB2GdCAM7p7V00xueAVQ ($9.80 in chips) 
Seat 2: 4x9jCqgSw4272dnaIqnanw ($3.95 in chips) 
Seat 3: Hzrn9DZJegEZICufTNYkrg ($14.75 in chips) 
Seat 4: FYepjhAvF8ZdVCmqHIy+eQ ($25.90 in chips) 
Seat 5: sEQx9G5Cu8k1HNdQasxvUA ($28.05 in chips) 
0HAB2GdCAM7p7V00xueAVQ: posts small blind $0.10
4x9jCqgSw4272dnaIqnanw: posts big blind $0.25
*** HOLE CARDS ***
Hzrn9DZJegEZICufTNYkrg: folds 
FYepjhAvF8ZdVCmqHIy+eQ: folds 
sEQx9G5Cu8k1HNdQasxvUA: folds 
0HAB2GdCAM7p7V00xueAVQ: raises $0.25 to $0.50
4x9jCqgSw4272dnaIqnanw: calls $0.25
*** FLOP *** [Qs Tc 9s]
0HAB2GdCAM7p7V00xueAVQ: checks 
4x9jCqgSw4272dnaIqnanw: bets $3.45 and is all-in
0HAB2GdCAM7p7V00xueAVQ: folds 
Uncalled bet ($3.45) returned to 4x9jCqgSw4272dnaIqnanw
4x9jCqgSw4272dnaIqnanw collected $0.95 from pot
*** SUMMARY ***
Total pot $1 | Rake $0.05 
Board [Qs Tc 9s]
Seat 1: 0HAB2GdCAM7p7V00xueAVQ (small blind) folded on the Flop
Seat 2: 4x9jCqgSw4272dnaIqnanw (big blind) collected ($0.95)
Seat 3: Hzrn9DZJegEZICufTNYkrg folded before Flop (didn't bet)
Seat 4: FYepjhAvF8ZdVCmqHIy+eQ folded before Flop (didn't bet)
Seat 5: sEQx9G5Cu8k1HNdQasxvUA (button) folded before Flop (didn't bet)




PokerStars Game #59939396016:  Hold'em No Limit ($0.10/$0.25) - 2009/07/01 0:38:47 ET
Table 'KEoOIegxPF91KooL2AelUA' 6-max Seat #4 is the button
Seat 1: wsP46AGpqDjHZQmlRHKa9g ($26.90 in chips) 
Seat 4: Vv37Oa9niKKVcR6Z7ceetw ($22.45 in chips) 
Seat 5: 2NLC44AHHKHEUooUQFYV+Q ($15.75 in chips) 
2NLC44AHHKHEUooUQFYV+Q: posts small blind $0.10
wsP46AGpqDjHZQmlRHKa9g: posts big blind $0.25
*** HOLE CARDS ***
Vv37Oa9niKKVcR6Z7ceetw: folds 
2NLC44AHHKHEUooUQFYV+Q: raises $0.50 to $0.75
wsP46AGpqDjHZQmlRHKa9g: calls $0.50
*** FLOP *** [7d Qs 8c]
2NLC44AHHKHEUooUQFYV+Q: bets $1
wsP46AGpqDjHZQmlRHKa9g: calls $1
*** TURN *** [7d Qs 8c] [9s]
2NLC44AHHKHEUooUQFYV+Q: bets $1
wsP46AGpqDjHZQmlRHKa9g: calls $1
*** RIVER *** [7d Qs 8c 9s] [Td]
Vv37Oa9niKKVcR6Z7ceetw said, "JJ maybe"
2NLC44AHHKHEUooUQFYV+Q: checks 
wsP46AGpqDjHZQmlRHKa9g: bets $2.50
2NLC44AHHKHEUooUQFYV+Q: folds 
Uncalled bet ($2.50) returned to wsP46AGpqDjHZQmlRHKa9g
2NLC44AHHKHEUooUQFYV+Q said, "kings"
wsP46AGpqDjHZQmlRHKa9g collected $5.25 from pot
*** SUMMARY ***
Total pot $5.50 | Rake $0.25 
Board [7d Qs 8c 9s Td]
Seat 1: wsP46AGpqDjHZQmlRHKa9g (big blind) collected ($5.25)
Seat 4: Vv37Oa9niKKVcR6Z7ceetw (button) folded before Flop (didn't bet)
Seat 5: 2NLC44AHHKHEUooUQFYV+Q (small blind) folded on the River




PokerStars Game #59939395602:  Hold'em No Limit ($0.10/$0.25) - 2009/07/01 0:38:47 ET
Table 'sJ4KpS2GE5Qrsu1/cFjJUw' 9-max Seat #1 is the button
Seat 1: QsLvCwfSWqP+CfjwUnjpXQ ($14.40 in chips) 
Seat 3: eDil7UzSZCjyh1VP6SVXJQ ($6.80 in chips) 
Seat 8: f8ixGbSVIs6Be0mH69ldVQ ($15.35 in chips) 
eDil7UzSZCjyh1VP6SVXJQ: posts small blind $0.10
f8ixGbSVIs6Be0mH69ldVQ: posts big blind $0.25
*** HOLE CARDS ***
QsLvCwfSWqP+CfjwUnjpXQ: folds 
eDil7UzSZCjyh1VP6SVXJQ: calls $0.15
f8ixGbSVIs6Be0mH69ldVQ: checks 
*** FLOP *** [Ac Jh 3d]
danno12345 joins the table at seat #4 
eDil7UzSZCjyh1VP6SVXJQ: bets $0.25
f8ixGbSVIs6Be0mH69ldVQ: folds 
Uncalled bet ($0.25) returned to eDil7UzSZCjyh1VP6SVXJQ
eDil7UzSZCjyh1VP6SVXJQ collected $0.50 from pot
eDil7UzSZCjyh1VP6SVXJQ: doesn't show hand 
*** SUMMARY ***
Total pot $0.50 | Rake $0 
Board [Ac Jh 3d]
Seat 1: QsLvCwfSWqP+CfjwUnjpXQ (button) folded before Flop (didn't bet)
Seat 3: eDil7UzSZCjyh1VP6SVXJQ (small blind) collected ($0.50)
Seat 8: f8ixGbSVIs6Be0mH69ldVQ (big blind) folded on the Flop




PokerStars Game #59939396054:  Hold'em No Limit ($0.10/$0.25) - 2009/07/01 0:38:47 ET
Table 'JPFXJXa5xBkjZ/W15BKqeQ' 9-max Seat #6 is the button
Seat 1: hPhp/RE3cJ5YGaQ2xOHXXg ($5 in chips) 
Seat 2: 1/f3/SJ8XpIW1Ek97d1xUw ($5.50 in chips) 
Seat 3: 56S3mA6Zs3pGR+0p0vUCtg ($27.15 in chips) 
Seat 4: VBHxUExRAMrbxUq/cVx9Gw ($5.60 in chips) 
Seat 5: cZ99hugmLBj9KhTlc8nCSw ($25.95 in chips) 
Seat 6: DdPXdieucQ+n99u1n3A+rQ ($4.30 in chips) 
Seat 7: zf2/dINEhk9pCZwJGJLcHw ($14.10 in chips) 
Seat 8: zDrucyjVn5aeekNEc3cJrA ($23.35 in chips) 
Seat 9: uH1RN27w9SKa7TpVR9EFrQ ($15.05 in chips) 
zf2/dINEhk9pCZwJGJLcHw: posts small blind $0.10
zDrucyjVn5aeekNEc3cJrA: posts big blind $0.25
*** HOLE CARDS ***
uH1RN27w9SKa7TpVR9EFrQ: folds 
hPhp/RE3cJ5YGaQ2xOHXXg: folds 
1/f3/SJ8XpIW1Ek97d1xUw: folds 
56S3mA6Zs3pGR+0p0vUCtg: folds 
VBHxUExRAMrbxUq/cVx9Gw: folds 
cZ99hugmLBj9KhTlc8nCSw: folds 
DdPXdieucQ+n99u1n3A+rQ: folds 
zf2/dINEhk9pCZwJGJLcHw: calls $0.15
zDrucyjVn5aeekNEc3cJrA: checks 
*** FLOP *** [7d 2h 5d]
zf2/dINEhk9pCZwJGJLcHw: bets $0.25
zDrucyjVn5aeekNEc3cJrA: folds 
Uncalled bet ($0.25) returned to zf2/dINEhk9pCZwJGJLcHw
zf2/dINEhk9pCZwJGJLcHw collected $0.50 from pot
zf2/dINEhk9pCZwJGJLcHw: doesn't show hand 
*** SUMMARY ***
Total pot $0.50 | Rake $0 
Board [7d 2h 5d]
Seat 1: hPhp/RE3cJ5YGaQ2xOHXXg folded before Flop (didn't bet)
Seat 2: 1/f3/SJ8XpIW1Ek97d1xUw folded before Flop (didn't bet)
Seat 3: 56S3mA6Zs3pGR+0p0vUCtg folded before Flop (didn't bet)
Seat 4: VBHxUExRAMrbxUq/cVx9Gw folded before Flop (didn't bet)
Seat 5: cZ99hugmLBj9KhTlc8nCSw folded before Flop (didn't bet)
Seat 6: DdPXdieucQ+n99u1n3A+rQ (button) folded before Flop (didn't bet)
Seat 7: zf2/dINEhk9pCZwJGJLcHw (small blind) collected ($0.50)
Seat 8: zDrucyjVn5aeekNEc3cJrA (big blind) folded on the Flop
Seat 9: uH1RN27w9SKa7TpVR9EFrQ folded before Flop (didn't bet)




PokerStars Game #59939396106:  Hold'em No Limit ($0.10/$0.25) - 2009/07/01 0:38:47 ET
Table 'ThBZ355rqvsb8UGb6ajbig' 9-max Seat #9 is the button
Seat 2: 4awUyiDYTgylQKXZ9faBVA ($25 in chips) 
Seat 3: LBrhQVB4w41YNd7kMYn/og ($9.95 in chips) 
Seat 4: GFNwOPqg/Zu4ZuokgGADNQ ($8.10 in chips) 
Seat 5: ljO8CPts14fBjr9/qK0Enw ($35.90 in chips) 
Seat 6: qwr38jl5txoR36M7G5qi4A ($7.50 in chips) 
Seat 7: t2nb95S5EEFOEzNx9Itz0g ($12.95 in chips) 
Seat 8: 6REZ3fl3I5Kaxoupd8cnLg ($15 in chips) 
Seat 9: 8B/dhbQjIWe6ASCdgzktNQ ($28.75 in chips) 
4awUyiDYTgylQKXZ9faBVA: posts small blind $0.10
LBrhQVB4w41YNd7kMYn/og: posts big blind $0.25
6REZ3fl3I5Kaxoupd8cnLg: posts big blind $0.25
*** HOLE CARDS ***
GFNwOPqg/Zu4ZuokgGADNQ: raises $1.75 to $2
ljO8CPts14fBjr9/qK0Enw: calls $2
qwr38jl5txoR36M7G5qi4A: folds 
t2nb95S5EEFOEzNx9Itz0g: folds 
6REZ3fl3I5Kaxoupd8cnLg: folds 
8B/dhbQjIWe6ASCdgzktNQ: folds 
4awUyiDYTgylQKXZ9faBVA: folds 
LBrhQVB4w41YNd7kMYn/og: folds 
*** FLOP *** [2c 7c 7s]
GFNwOPqg/Zu4ZuokgGADNQ: bets $6.10 and is all-in
ljO8CPts14fBjr9/qK0Enw: calls $6.10
*** TURN *** [2c 7c 7s] [2d]
*** RIVER *** [2c 7c 7s 2d] [8h]
*** SHOW DOWN ***
GFNwOPqg/Zu4ZuokgGADNQ: shows [Qc Qs] (two pair, Queens and Sevens)
ljO8CPts14fBjr9/qK0Enw: mucks hand 
GFNwOPqg/Zu4ZuokgGADNQ collected $16 from pot
*** SUMMARY ***
Total pot $16.80 | Rake $0.80 
Board [2c 7c 7s 2d 8h]
Seat 2: 4awUyiDYTgylQKXZ9faBVA (small blind) folded before Flop
Seat 3: LBrhQVB4w41YNd7kMYn/og (big blind) folded before Flop
Seat 4: GFNwOPqg/Zu4ZuokgGADNQ showed [Qc Qs] and won ($16) with two pair, Queens and Sevens
Seat 5: ljO8CPts14fBjr9/qK0Enw mucked
Seat 6: qwr38jl5txoR36M7G5qi4A folded before Flop (didn't bet)
Seat 7: t2nb95S5EEFOEzNx9Itz0g folded before Flop (didn't bet)
Seat 8: 6REZ3fl3I5Kaxoupd8cnLg folded before Flop
Seat 9: 8B/dhbQjIWe6ASCdgzktNQ (button) folded before Flop (didn't bet)




PokerStars Game #59939396924:  Hold'em No Limit ($0.10/$0.25) - 2009/07/01 0:38:48 ET
Table 'jxoHy9yJy0bbH/Qx73FoPA' 9-max Seat #5 is the button
Seat 1: jN7A9nKK4RYzhFj4MrekhA ($14.75 in chips) 
Seat 3: /DYYmfrw4B9z+N2z81dNtA ($20.70 in chips) 
Seat 4: RJ/x9oZtt1RZLaJEQwZOxQ ($27.40 in chips) 
Seat 5: vO3QVRovWemcGMkm7ijAIA ($4.30 in chips) 
Seat 6: tYsOBqdU1+x+yFI7zHO7hQ ($52 in chips) 
Seat 7: HhlCy99+up/IQbbuxF6uXg ($8 in chips) 
Seat 8: hBMUlEpyU74r/fwDgIpXjQ ($30.60 in chips) 
Seat 9: IG1d4tXnNA98OKRYYE3l+A ($54.45 in chips) 
tYsOBqdU1+x+yFI7zHO7hQ: posts small blind $0.10
HhlCy99+up/IQbbuxF6uXg: posts big blind $0.25
lacross84: sits out 
*** HOLE CARDS ***
hBMUlEpyU74r/fwDgIpXjQ: folds 
IG1d4tXnNA98OKRYYE3l+A: folds 
jN7A9nKK4RYzhFj4MrekhA: raises $1 to $1.25
/DYYmfrw4B9z+N2z81dNtA: folds 
RJ/x9oZtt1RZLaJEQwZOxQ: folds 
vO3QVRovWemcGMkm7ijAIA: folds 
tYsOBqdU1+x+yFI7zHO7hQ: folds 
HhlCy99+up/IQbbuxF6uXg: folds 
Uncalled bet ($1) returned to jN7A9nKK4RYzhFj4MrekhA
jN7A9nKK4RYzhFj4MrekhA collected $0.60 from pot
jN7A9nKK4RYzhFj4MrekhA: doesn't show hand 
*** SUMMARY ***
Total pot $0.60 | Rake $0 
Seat 1: jN7A9nKK4RYzhFj4MrekhA collected ($0.60)
Seat 3: /DYYmfrw4B9z+N2z81dNtA folded before Flop (didn't bet)
Seat 4: RJ/x9oZtt1RZLaJEQwZOxQ folded before Flop (didn't bet)
Seat 5: vO3QVRovWemcGMkm7ijAIA (button) folded before Flop (didn't bet)
Seat 6: tYsOBqdU1+x+yFI7zHO7hQ (small blind) folded before Flop
Seat 7: HhlCy99+up/IQbbuxF6uXg (big blind) folded before Flop
Seat 8: hBMUlEpyU74r/fwDgIpXjQ folded before Flop (didn't bet)
Seat 9: IG1d4tXnNA98OKRYYE3l+A folded before Flop (didn't bet)




PokerStars Game #59939396776:  Hold'em No Limit ($0.10/$0.25) - 2009/07/01 0:38:48 ET
Table 'TJS4XvvOjO3k7mH74HJw5g' 9-max Seat #1 is the button
Seat 1: SS+d2ix02WTTacMsjCk0OQ ($25.10 in chips) 
Seat 2: ghNKXUBl/H+t83JF079ZBA ($25 in chips) 
Seat 3: 8B/dhbQjIWe6ASCdgzktNQ ($25 in chips) 
Seat 4: Y+IdmmKAoWu2irRi3Jpr4Q ($17.75 in chips) 
Seat 5: NNZypfH1f/VIj3Skf/XIzg ($4.65 in chips) 
Seat 6: cFmpjvcjNoVAEAIQIxWkYg ($25 in chips) 
Seat 7: DiSvPC2iudwL5j9u6Huyww ($25 in chips) 
Seat 8: l9TiQshP7QOsNH6jZrL4Wg ($3.55 in chips) 
Seat 9: +sbyWwIcFp9kP0bDtMegfQ ($32.25 in chips) 
ghNKXUBl/H+t83JF079ZBA: posts small blind $0.10
8B/dhbQjIWe6ASCdgzktNQ: posts big blind $0.25
*** HOLE CARDS ***
Y+IdmmKAoWu2irRi3Jpr4Q: calls $0.25
NNZypfH1f/VIj3Skf/XIzg: folds 
cFmpjvcjNoVAEAIQIxWkYg: folds 
DiSvPC2iudwL5j9u6Huyww: raises $1 to $1.25
l9TiQshP7QOsNH6jZrL4Wg: folds 
+sbyWwIcFp9kP0bDtMegfQ: folds 
SS+d2ix02WTTacMsjCk0OQ: folds 
ghNKXUBl/H+t83JF079ZBA: folds 
8B/dhbQjIWe6ASCdgzktNQ: folds 
Y+IdmmKAoWu2irRi3Jpr4Q: calls $1
*** FLOP *** [3h 2c 6c]
Y+IdmmKAoWu2irRi3Jpr4Q: bets $1
DiSvPC2iudwL5j9u6Huyww: calls $1
*** TURN *** [3h 2c 6c] [4s]
Y+IdmmKAoWu2irRi3Jpr4Q: bets $2
DiSvPC2iudwL5j9u6Huyww: calls $2
*** RIVER *** [3h 2c 6c 4s] [5c]
Y+IdmmKAoWu2irRi3Jpr4Q: bets $3
DiSvPC2iudwL5j9u6Huyww: calls $3
*** SHOW DOWN ***
Y+IdmmKAoWu2irRi3Jpr4Q: shows [Qc Kh] (a straight, Deuce to Six)
DiSvPC2iudwL5j9u6Huyww: shows [Jd Js] (a straight, Deuce to Six)
Y+IdmmKAoWu2irRi3Jpr4Q collected $7.10 from pot
DiSvPC2iudwL5j9u6Huyww collected $7.05 from pot
*** SUMMARY ***
Total pot $14.85 | Rake $0.70 
Board [3h 2c 6c 4s 5c]
Seat 1: SS+d2ix02WTTacMsjCk0OQ (button) folded before Flop (didn't bet)
Seat 2: ghNKXUBl/H+t83JF079ZBA (small blind) folded before Flop
Seat 3: 8B/dhbQjIWe6ASCdgzktNQ (big blind) folded before Flop
Seat 4: Y+IdmmKAoWu2irRi3Jpr4Q showed [Qc Kh] and won ($7.10) with a straight, Deuce to Six
Seat 5: NNZypfH1f/VIj3Skf/XIzg folded before Flop (didn't bet)
Seat 6: cFmpjvcjNoVAEAIQIxWkYg folded before Flop (didn't bet)
Seat 7: DiSvPC2iudwL5j9u6Huyww showed [Jd Js] and won ($7.05) with a straight, Deuce to Six
Seat 8: l9TiQshP7QOsNH6jZrL4Wg folded before Flop (didn't bet)
Seat 9: +sbyWwIcFp9kP0bDtMegfQ folded before Flop (didn't bet)




PokerStars Game #59939396446:  Hold'em No Limit ($0.10/$0.25) - 2009/07/01 0:38:48 ET
Table 'IrJPyZ3JW2iIa+krdoSbJQ' 9-max Seat #1 is the button
Seat 1: 4+E2msto8r80F3SH2gctVA ($24.75 in chips) 
Seat 2: DdPXdieucQ+n99u1n3A+rQ ($4.80 in chips) 
Seat 3: vZGoOTJLQLhkPj4I+LNGig ($25 in chips) 
Seat 4: DnDcAdn9P0zGovMERigpFA ($25 in chips) 
Seat 5: sUVgUtgbfVx6JpvApozwhQ ($5.40 in chips) 
Seat 6: +sbyWwIcFp9kP0bDtMegfQ ($24.30 in chips) 
Seat 7: uH1RN27w9SKa7TpVR9EFrQ ($27.90 in chips) 
Seat 8: VBHxUExRAMrbxUq/cVx9Gw ($5 in chips) 
Seat 9: SXqVW4Q0evTUVZG6BbUNIA ($29.30 in chips) 
DdPXdieucQ+n99u1n3A+rQ: posts small blind $0.10
vZGoOTJLQLhkPj4I+LNGig: posts big blind $0.25
*** HOLE CARDS ***
DnDcAdn9P0zGovMERigpFA: folds 
sUVgUtgbfVx6JpvApozwhQ: folds 
+sbyWwIcFp9kP0bDtMegfQ: folds 
uH1RN27w9SKa7TpVR9EFrQ: folds 
VBHxUExRAMrbxUq/cVx9Gw: folds 
SXqVW4Q0evTUVZG6BbUNIA: folds 
4+E2msto8r80F3SH2gctVA: raises $0.75 to $1
DdPXdieucQ+n99u1n3A+rQ: folds 
vZGoOTJLQLhkPj4I+LNGig: folds 
Uncalled bet ($0.75) returned to 4+E2msto8r80F3SH2gctVA
4+E2msto8r80F3SH2gctVA collected $0.60 from pot
4+E2msto8r80F3SH2gctVA: doesn't show hand 
*** SUMMARY ***
Total pot $0.60 | Rake $0 
Seat 1: 4+E2msto8r80F3SH2gctVA (button) collected ($0.60)
Seat 2: DdPXdieucQ+n99u1n3A+rQ (small blind) folded before Flop
Seat 3: vZGoOTJLQLhkPj4I+LNGig (big blind) folded before Flop
Seat 4: DnDcAdn9P0zGovMERigpFA folded before Flop (didn't bet)
Seat 5: sUVgUtgbfVx6JpvApozwhQ folded before Flop (didn't bet)
Seat 6: +sbyWwIcFp9kP0bDtMegfQ folded before Flop (didn't bet)
Seat 7: uH1RN27w9SKa7TpVR9EFrQ folded before Flop (didn't bet)
Seat 8: VBHxUExRAMrbxUq/cVx9Gw folded before Flop (didn't bet)
Seat 9: SXqVW4Q0evTUVZG6BbUNIA folded before Flop (didn't bet)




PokerStars Game #59939396854:  Hold'em No Limit ($0.10/$0.25) - 2009/07/01 0:38:48 ET
Table '2clPgY3+dETPD/8zjXZdFw' 6-max Seat #3 is the button
Seat 1: qllppsCmUqovlriIWCeM/g ($4.75 in chips) 
Seat 2: NzIFHwilc5zU7QhjDTgTZA ($6 in chips) 
Seat 3: 6pF9LtHn+EH0ChbOXzox9g ($4.35 in chips) 
qllppsCmUqovlriIWCeM/g: posts small blind $0.10
NzIFHwilc5zU7QhjDTgTZA: posts big blind $0.25
*** HOLE CARDS ***
6pF9LtHn+EH0ChbOXzox9g: calls $0.25
qllppsCmUqovlriIWCeM/g: calls $0.15
9KPR3sZ+CxRm7bQ8qxFzMQ joins the table at seat #4 
NzIFHwilc5zU7QhjDTgTZA: checks 
*** FLOP *** [9d 4d 7h]
qllppsCmUqovlriIWCeM/g: bets $0.75
NzIFHwilc5zU7QhjDTgTZA: calls $0.75
6pF9LtHn+EH0ChbOXzox9g: calls $0.75
*** TURN *** [9d 4d 7h] [Js]
qllppsCmUqovlriIWCeM/g: bets $1.75
NzIFHwilc5zU7QhjDTgTZA: calls $1.75
6pF9LtHn+EH0ChbOXzox9g: calls $1.75
*** RIVER *** [9d 4d 7h Js] [Ac]
qllppsCmUqovlriIWCeM/g: checks 
NzIFHwilc5zU7QhjDTgTZA: bets $1.50
6pF9LtHn+EH0ChbOXzox9g: raises $0.10 to $1.60 and is all-in
qllppsCmUqovlriIWCeM/g: folds 
NzIFHwilc5zU7QhjDTgTZA: calls $0.10
*** SHOW DOWN ***
6pF9LtHn+EH0ChbOXzox9g: shows [Td 7d] (a pair of Sevens)
NzIFHwilc5zU7QhjDTgTZA: shows [7c Ts] (a pair of Sevens)
NzIFHwilc5zU7QhjDTgTZA collected $5.45 from pot
6pF9LtHn+EH0ChbOXzox9g collected $5.45 from pot
*** SUMMARY ***
Total pot $11.45 | Rake $0.55 
Board [9d 4d 7h Js Ac]
Seat 1: qllppsCmUqovlriIWCeM/g (small blind) folded on the River
Seat 2: NzIFHwilc5zU7QhjDTgTZA (big blind) showed [7c Ts] and won ($5.45) with a pair of Sevens
Seat 3: 6pF9LtHn+EH0ChbOXzox9g (button) showed [Td 7d] and won ($5.45) with a pair of Sevens




PokerStars Game #59939396836:  Hold'em No Limit ($0.10/$0.25) - 2009/07/01 0:38:48 ET
Table '5SUMWYuPsGiOD0FY0QbgOw' 6-max Seat #5 is the button
Seat 1: pq78iqNUnoL9mPwPKXxOzg ($14.65 in chips) 
Seat 2: wKFJ513ucluNNiMlkXcDOQ ($25.30 in chips) 
Seat 3: JUE7yMMP0aN5jzhYbdqO6Q ($27.90 in chips) 
Seat 4: hln5cQA1YXs/ERC2LEyoSA ($9.50 in chips) 
Seat 5: v+QfkGiuj9bgtuNoVnDO8w ($27.20 in chips) 
Seat 6: jA7YMtfNUnAaebB7Lj74EA ($29.95 in chips) 
jA7YMtfNUnAaebB7Lj74EA: posts small blind $0.10
pq78iqNUnoL9mPwPKXxOzg: posts big blind $0.25
*** HOLE CARDS ***
wKFJ513ucluNNiMlkXcDOQ: folds 
JUE7yMMP0aN5jzhYbdqO6Q: folds 
hln5cQA1YXs/ERC2LEyoSA: calls $0.25
v+QfkGiuj9bgtuNoVnDO8w: raises $1 to $1.25
jA7YMtfNUnAaebB7Lj74EA: folds 
pq78iqNUnoL9mPwPKXxOzg: folds 
hln5cQA1YXs/ERC2LEyoSA: calls $1
*** FLOP *** [9d 4c Ts]
hln5cQA1YXs/ERC2LEyoSA: checks 
v+QfkGiuj9bgtuNoVnDO8w: bets $2.25
hln5cQA1YXs/ERC2LEyoSA: folds 
Uncalled bet ($2.25) returned to v+QfkGiuj9bgtuNoVnDO8w
v+QfkGiuj9bgtuNoVnDO8w collected $2.75 from pot
v+QfkGiuj9bgtuNoVnDO8w: doesn't show hand 
*** SUMMARY ***
Total pot $2.85 | Rake $0.10 
Board [9d 4c Ts]
Seat 1: pq78iqNUnoL9mPwPKXxOzg (big blind) folded before Flop
Seat 2: wKFJ513ucluNNiMlkXcDOQ folded before Flop (didn't bet)
Seat 3: JUE7yMMP0aN5jzhYbdqO6Q folded before Flop (didn't bet)
Seat 4: hln5cQA1YXs/ERC2LEyoSA folded on the Flop
Seat 5: v+QfkGiuj9bgtuNoVnDO8w (button) collected ($2.75)
Seat 6: jA7YMtfNUnAaebB7Lj74EA (small blind) folded before Flop




PokerStars Game #59939396806:  Hold'em No Limit ($0.10/$0.25) - 2009/07/01 0:38:48 ET
Table 'ggwTHpIC5qhhHJSYjK1XCw' 6-max Seat #1 is the button
Seat 1: BYxjLnV1/LL0aZcTbfAOvw ($31.50 in chips) 
Seat 2: mBAp/L4XPhNEkNUlUTV4Iw ($16.15 in chips) 
Seat 3: SxIIgwXYLkwd6m3wLyPTCw ($25 in chips) 
Seat 4: JFIAqU8lCZ0vWwEl4bdGsg ($25.75 in chips) 
Seat 5: 6zbQpY/G44U1Xvj7DZex0A ($12.10 in chips) 
Seat 6: QOk5VUJeDqXaA3RlMSluGA ($17.60 in chips) 
mBAp/L4XPhNEkNUlUTV4Iw: posts small blind $0.10
SxIIgwXYLkwd6m3wLyPTCw: posts big blind $0.25
*** HOLE CARDS ***
JFIAqU8lCZ0vWwEl4bdGsg: folds 
6zbQpY/G44U1Xvj7DZex0A: raises $0.25 to $0.50
QOk5VUJeDqXaA3RlMSluGA: folds 
BYxjLnV1/LL0aZcTbfAOvw: folds 
mBAp/L4XPhNEkNUlUTV4Iw: folds 
SxIIgwXYLkwd6m3wLyPTCw: folds 
Uncalled bet ($0.25) returned to 6zbQpY/G44U1Xvj7DZex0A
6zbQpY/G44U1Xvj7DZex0A collected $0.60 from pot
*** SUMMARY ***
Total pot $0.60 | Rake $0 
Seat 1: BYxjLnV1/LL0aZcTbfAOvw (button) folded before Flop (didn't bet)
Seat 2: mBAp/L4XPhNEkNUlUTV4Iw (small blind) folded before Flop
Seat 3: SxIIgwXYLkwd6m3wLyPTCw (big blind) folded before Flop
Seat 4: JFIAqU8lCZ0vWwEl4bdGsg folded before Flop (didn't bet)
Seat 5: 6zbQpY/G44U1Xvj7DZex0A collected ($0.60)
Seat 6: QOk5VUJeDqXaA3RlMSluGA folded before Flop (didn't bet)




PokerStars Game #59939396780:  Hold'em No Limit ($0.10/$0.25) - 2009/07/01 0:38:48 ET
Table 'zW+7jPbOLCvlPu+dUGY5WQ' 6-max Seat #5 is the button
Seat 1: JE/wJXmjw3bpdmjwvh2pcg ($24.65 in chips) 
Seat 2: m/Xj2OoEbtQwxafkW0taNw ($4.75 in chips) 
Seat 3: BedjMfrlRfPgSq7CXpPAmg ($64.10 in chips) 
Seat 4: Qv4VzEkN09uD11sjKv02Ig ($32.55 in chips) 
Seat 5: SFmT9ZsVopnukjvAzrxTRg ($51.70 in chips) 
Seat 6: BiLBinPhgpKAYzLgKJVU5A ($21.70 in chips) 
BiLBinPhgpKAYzLgKJVU5A: posts small blind $0.10
JE/wJXmjw3bpdmjwvh2pcg: posts big blind $0.25
*** HOLE CARDS ***
BiLBinPhgpKAYzLgKJVU5A said, "nh"
m/Xj2OoEbtQwxafkW0taNw: raises $4.50 to $4.75 and is all-in
BedjMfrlRfPgSq7CXpPAmg: folds 
Qv4VzEkN09uD11sjKv02Ig: calls $4.75
SFmT9ZsVopnukjvAzrxTRg: folds 
BiLBinPhgpKAYzLgKJVU5A: folds 
JE/wJXmjw3bpdmjwvh2pcg: folds 
*** FLOP *** [5c 6d Th]
*** TURN *** [5c 6d Th] [4s]
*** RIVER *** [5c 6d Th 4s] [Kc]
*** SHOW DOWN ***
m/Xj2OoEbtQwxafkW0taNw: shows [8d As] (high card Ace)
Qv4VzEkN09uD11sjKv02Ig: shows [5d Ah] (a pair of Fives)
Qv4VzEkN09uD11sjKv02Ig collected $9.40 from pot
*** SUMMARY ***
Total pot $9.85 | Rake $0.45 
Board [5c 6d Th 4s Kc]
Seat 1: JE/wJXmjw3bpdmjwvh2pcg (big blind) folded before Flop
Seat 2: m/Xj2OoEbtQwxafkW0taNw showed [8d As] and lost with high card Ace
Seat 3: BedjMfrlRfPgSq7CXpPAmg folded before Flop (didn't bet)
Seat 4: Qv4VzEkN09uD11sjKv02Ig showed [5d Ah] and won ($9.40) with a pair of Fives
Seat 5: SFmT9ZsVopnukjvAzrxTRg (button) folded before Flop (didn't bet)
Seat 6: BiLBinPhgpKAYzLgKJVU5A (small blind) folded before Flop




PokerStars Game #59939396916:  Hold'em No Limit ($0.10/$0.25) - 2009/07/01 0:38:48 ET
Table '/XCUCUl3yW6tdTJQEhJKGw' 6-max Seat #6 is the button
Seat 1: p8J112JmNRnCwV2+NAEzCA ($15.40 in chips) 
Seat 2: 8ClCHtFXGNplITm+63KB+Q ($27.25 in chips) 
Seat 3: /gJNBeCkWL4o85/jvlZ4BA ($35.60 in chips) 
Seat 4: SFmT9ZsVopnukjvAzrxTRg ($25 in chips) 
Seat 5: 3rlIjSrvbZoI2IILbnetnA ($25.35 in chips) 
Seat 6: armfxZhGxeZVZBYAQFuIJQ ($36.45 in chips) 
p8J112JmNRnCwV2+NAEzCA: posts small blind $0.10
8ClCHtFXGNplITm+63KB+Q: posts big blind $0.25
*** HOLE CARDS ***
/gJNBeCkWL4o85/jvlZ4BA: folds 
SFmT9ZsVopnukjvAzrxTRg: folds 
3rlIjSrvbZoI2IILbnetnA: calls $0.25
armfxZhGxeZVZBYAQFuIJQ: folds 
p8J112JmNRnCwV2+NAEzCA: folds 
8ClCHtFXGNplITm+63KB+Q: checks 
*** FLOP *** [5s Jc Qh]
8ClCHtFXGNplITm+63KB+Q: checks 
3rlIjSrvbZoI2IILbnetnA: checks 
*** TURN *** [5s Jc Qh] [8s]
8ClCHtFXGNplITm+63KB+Q: bets $0.50
3rlIjSrvbZoI2IILbnetnA: calls $0.50
*** RIVER *** [5s Jc Qh 8s] [Ts]
8ClCHtFXGNplITm+63KB+Q: bets $1
3rlIjSrvbZoI2IILbnetnA: folds 
Uncalled bet ($1) returned to 8ClCHtFXGNplITm+63KB+Q
8ClCHtFXGNplITm+63KB+Q collected $1.55 from pot
8ClCHtFXGNplITm+63KB+Q: doesn't show hand 
*** SUMMARY ***
Total pot $1.60 | Rake $0.05 
Board [5s Jc Qh 8s Ts]
Seat 1: p8J112JmNRnCwV2+NAEzCA (small blind) folded before Flop
Seat 2: 8ClCHtFXGNplITm+63KB+Q (big blind) collected ($1.55)
Seat 3: /gJNBeCkWL4o85/jvlZ4BA folded before Flop (didn't bet)
Seat 4: SFmT9ZsVopnukjvAzrxTRg folded before Flop (didn't bet)
Seat 5: 3rlIjSrvbZoI2IILbnetnA folded on the River
Seat 6: armfxZhGxeZVZBYAQFuIJQ (button) folded before Flop (didn't bet)




PokerStars Game #59939396868:  Hold'em No Limit ($0.10/$0.25) - 2009/07/01 0:38:48 ET
Table 'Pz8SfAzhP5nvWTsJRAxoDg' 6-max Seat #2 is the button
Seat 1: buyjetgNT1McXtdaP4zynA ($43.80 in chips) 
Seat 2: RYLaAIIwK9wxkPswt1yJYw ($23.05 in chips) 
Seat 3: mfrkWA3PTeYPkbO6hi98Aw ($30.60 in chips) 
Seat 4: 9U9Vy/656QCEfKznJWteag ($17 in chips) 
Seat 5: FYepjhAvF8ZdVCmqHIy+eQ ($30.30 in chips) 
Seat 6: FStoHe64SQWqAsjya9pDkQ ($25 in chips) 
mfrkWA3PTeYPkbO6hi98Aw: posts small blind $0.10
9U9Vy/656QCEfKznJWteag: posts big blind $0.25
*** HOLE CARDS ***
FYepjhAvF8ZdVCmqHIy+eQ: folds 
FStoHe64SQWqAsjya9pDkQ: folds 
buyjetgNT1McXtdaP4zynA: raises $0.75 to $1
RYLaAIIwK9wxkPswt1yJYw: folds 
mfrkWA3PTeYPkbO6hi98Aw: folds 
9U9Vy/656QCEfKznJWteag: folds 
Uncalled bet ($0.75) returned to buyjetgNT1McXtdaP4zynA
buyjetgNT1McXtdaP4zynA collected $0.60 from pot
buyjetgNT1McXtdaP4zynA: doesn't show hand 
*** SUMMARY ***
Total pot $0.60 | Rake $0 
Seat 1: buyjetgNT1McXtdaP4zynA collected ($0.60)
Seat 2: RYLaAIIwK9wxkPswt1yJYw (button) folded before Flop (didn't bet)
Seat 3: mfrkWA3PTeYPkbO6hi98Aw (small blind) folded before Flop
Seat 4: 9U9Vy/656QCEfKznJWteag (big blind) folded before Flop
Seat 5: FYepjhAvF8ZdVCmqHIy+eQ folded before Flop (didn't bet)
Seat 6: FStoHe64SQWqAsjya9pDkQ folded before Flop (didn't bet)




PokerStars Game #59939397246:  Hold'em No Limit ($0.10/$0.25) - 2009/07/01 0:38:49 ET
Table 'L5GvbdQO5aCZJSE6pyQ8OA' 6-max Seat #1 is the button
Seat 1: FOcO5GvOP3rgvLGPLVkg5g ($30.35 in chips) 
Seat 2: LxehwDpTQ19ph4Qmc78+Pw ($19.25 in chips) 
Seat 3: wKFJ513ucluNNiMlkXcDOQ ($25 in chips) 
Seat 4: ErIN0JRL5srYjT6en1f8YQ ($25 in chips) 
Seat 5: I60CfDZDrpMTu9pHHz8TFA ($68.85 in chips) 
Seat 6: v+QfkGiuj9bgtuNoVnDO8w ($35.25 in chips) 
LxehwDpTQ19ph4Qmc78+Pw: posts small blind $0.10
wKFJ513ucluNNiMlkXcDOQ: posts big blind $0.25
*** HOLE CARDS ***
ErIN0JRL5srYjT6en1f8YQ: folds 
I60CfDZDrpMTu9pHHz8TFA: raises $0.50 to $0.75
v+QfkGiuj9bgtuNoVnDO8w: folds 
FOcO5GvOP3rgvLGPLVkg5g: folds 
LxehwDpTQ19ph4Qmc78+Pw: calls $0.65
wKFJ513ucluNNiMlkXcDOQ: calls $0.50
*** FLOP *** [Ts 4s 6h]
LxehwDpTQ19ph4Qmc78+Pw: checks 
wKFJ513ucluNNiMlkXcDOQ: checks 
I60CfDZDrpMTu9pHHz8TFA: checks 
*** TURN *** [Ts 4s 6h] [Ac]
LxehwDpTQ19ph4Qmc78+Pw: bets $1
wKFJ513ucluNNiMlkXcDOQ: folds 
I60CfDZDrpMTu9pHHz8TFA: folds 
Uncalled bet ($1) returned to LxehwDpTQ19ph4Qmc78+Pw
LxehwDpTQ19ph4Qmc78+Pw collected $2.15 from pot
LxehwDpTQ19ph4Qmc78+Pw: doesn't show hand 
*** SUMMARY ***
Total pot $2.25 | Rake $0.10 
Board [Ts 4s 6h Ac]
Seat 1: FOcO5GvOP3rgvLGPLVkg5g (button) folded before Flop (didn't bet)
Seat 2: LxehwDpTQ19ph4Qmc78+Pw (small blind) collected ($2.15)
Seat 3: wKFJ513ucluNNiMlkXcDOQ (big blind) folded on the Turn
Seat 4: ErIN0JRL5srYjT6en1f8YQ folded before Flop (didn't bet)
Seat 5: I60CfDZDrpMTu9pHHz8TFA folded on the Turn
Seat 6: v+QfkGiuj9bgtuNoVnDO8w folded before Flop (didn't bet)




PokerStars Game #59939397274:  Hold'em No Limit ($0.10/$0.25) - 2009/07/01 0:38:49 ET
Table 'oZuNsbNJuUyQLGKzQ/4JFg' 6-max Seat #2 is the button
Seat 1: /hq3j+3FbArzS8nEzmqRuw ($7.35 in chips) 
Seat 2: UA5OsKS3VPaxa7uC8La/kA ($30.25 in chips) 
Seat 3: 8ClCHtFXGNplITm+63KB+Q ($37.50 in chips) 
Seat 4: pWN7DVB+VCCiq83kllzEtg ($10.75 in chips) 
Seat 5: IH5lT4+CuQFyy32Qf5ydDw ($13.65 in chips) 
Seat 6: 34ttqW62uIRrqINCCmLcsw ($21.40 in chips) 
8ClCHtFXGNplITm+63KB+Q: posts small blind $0.10
pWN7DVB+VCCiq83kllzEtg: posts big blind $0.25
*** HOLE CARDS ***
IH5lT4+CuQFyy32Qf5ydDw: folds 
34ttqW62uIRrqINCCmLcsw: calls $0.25
/hq3j+3FbArzS8nEzmqRuw: folds 
UA5OsKS3VPaxa7uC8La/kA: folds 
8ClCHtFXGNplITm+63KB+Q: folds 
pWN7DVB+VCCiq83kllzEtg: checks 
*** FLOP *** [Jc Jh 7c]
pWN7DVB+VCCiq83kllzEtg: checks 
34ttqW62uIRrqINCCmLcsw: checks 
*** TURN *** [Jc Jh 7c] [Kc]
pWN7DVB+VCCiq83kllzEtg: checks 
34ttqW62uIRrqINCCmLcsw: checks 
*** RIVER *** [Jc Jh 7c Kc] [9c]
pWN7DVB+VCCiq83kllzEtg: checks 
34ttqW62uIRrqINCCmLcsw: checks 
*** SHOW DOWN ***
pWN7DVB+VCCiq83kllzEtg: shows [3c 8c] (a flush, King high)
34ttqW62uIRrqINCCmLcsw: mucks hand 
pWN7DVB+VCCiq83kllzEtg collected $0.60 from pot
*** SUMMARY ***
Total pot $0.60 | Rake $0 
Board [Jc Jh 7c Kc 9c]
Seat 1: /hq3j+3FbArzS8nEzmqRuw folded before Flop (didn't bet)
Seat 2: UA5OsKS3VPaxa7uC8La/kA (button) folded before Flop (didn't bet)
Seat 3: 8ClCHtFXGNplITm+63KB+Q (small blind) folded before Flop
Seat 4: pWN7DVB+VCCiq83kllzEtg (big blind) showed [3c 8c] and won ($0.60) with a flush, King high
Seat 5: IH5lT4+CuQFyy32Qf5ydDw folded before Flop (didn't bet)
Seat 6: 34ttqW62uIRrqINCCmLcsw mucked




PokerStars Game #59939397186:  Hold'em No Limit ($0.10/$0.25) - 2009/07/01 0:38:49 ET
Table '+UzantPJ4smVdrh+4GTu1w' 6-max Seat #4 is the button
Seat 1: 3Bm6SLY1pwRvi98HLQUkvg ($3.65 in chips) 
Seat 2: tcbEu7VzyHQ+0lh+skbQhQ ($10.25 in chips) 
Seat 3: SS/yfeArhULzIcOPe8MdPg ($51.15 in chips) 
Seat 4: 0/dGyX46wFQuMZwX3LgPxg ($8.95 in chips) 
Seat 5: cj4VBQya7HtVL2zCGd5jLQ ($15.20 in chips) 
Seat 6: BYxjLnV1/LL0aZcTbfAOvw ($48.40 in chips) 
cj4VBQya7HtVL2zCGd5jLQ: posts small blind $0.10
BYxjLnV1/LL0aZcTbfAOvw: posts big blind $0.25
*** HOLE CARDS ***
3Bm6SLY1pwRvi98HLQUkvg: calls $0.25
tcbEu7VzyHQ+0lh+skbQhQ: folds 
SS/yfeArhULzIcOPe8MdPg: folds 
0/dGyX46wFQuMZwX3LgPxg: folds 
cj4VBQya7HtVL2zCGd5jLQ: calls $0.15
0/dGyX46wFQuMZwX3LgPxg leaves the table
BYxjLnV1/LL0aZcTbfAOvw: checks 
*** FLOP *** [5c 6c 7c]
cj4VBQya7HtVL2zCGd5jLQ: checks 
BYxjLnV1/LL0aZcTbfAOvw: checks 
3Bm6SLY1pwRvi98HLQUkvg: bets $0.50
cj4VBQya7HtVL2zCGd5jLQ: calls $0.50
BYxjLnV1/LL0aZcTbfAOvw: folds 
*** TURN *** [5c 6c 7c] [7h]
cj4VBQya7HtVL2zCGd5jLQ: checks 
3Bm6SLY1pwRvi98HLQUkvg: bets $0.75
cj4VBQya7HtVL2zCGd5jLQ: calls $0.75
*** RIVER *** [5c 6c 7c 7h] [As]
cj4VBQya7HtVL2zCGd5jLQ: checks 
tjhousyomama joins the table at seat #4 
3Bm6SLY1pwRvi98HLQUkvg: checks 
*** SHOW DOWN ***
cj4VBQya7HtVL2zCGd5jLQ: shows [Ad 4c] (two pair, Aces and Sevens)
3Bm6SLY1pwRvi98HLQUkvg: mucks hand 
cj4VBQya7HtVL2zCGd5jLQ collected $3.10 from pot
*** SUMMARY ***
Total pot $3.25 | Rake $0.15 
Board [5c 6c 7c 7h As]
Seat 1: 3Bm6SLY1pwRvi98HLQUkvg mucked
Seat 2: tcbEu7VzyHQ+0lh+skbQhQ folded before Flop (didn't bet)
Seat 3: SS/yfeArhULzIcOPe8MdPg folded before Flop (didn't bet)
Seat 4: 0/dGyX46wFQuMZwX3LgPxg (button) folded before Flop (didn't bet)
Seat 5: cj4VBQya7HtVL2zCGd5jLQ (small blind) showed [Ad 4c] and won ($3.10) with two pair, Aces and Sevens
Seat 6: BYxjLnV1/LL0aZcTbfAOvw (big blind) folded on the Flop




PokerStars Game #59939397004:  Hold'em No Limit ($0.10/$0.25) - 2009/07/01 0:38:49 ET
Table 'vZfV/Uj0q8joA1du9sRJSg' 6-max Seat #6 is the button
Seat 1: OAmGQMdOxnvuBNHdADx0ew ($7 in chips) 
Seat 2: wMiE3yTbDJGOLOF9th7KPA ($12.70 in chips) 
Seat 3: QJ/0wT0pYdWbDuqo9eNJgQ ($6.40 in chips) 
Seat 4: v+QfkGiuj9bgtuNoVnDO8w ($25 in chips) 
Seat 5: FStoHe64SQWqAsjya9pDkQ ($25.25 in chips) 
Seat 6: 8ClCHtFXGNplITm+63KB+Q ($26.20 in chips) 
OAmGQMdOxnvuBNHdADx0ew: posts small blind $0.10
wMiE3yTbDJGOLOF9th7KPA: posts big blind $0.25
*** HOLE CARDS ***
QJ/0wT0pYdWbDuqo9eNJgQ: calls $0.25
v+QfkGiuj9bgtuNoVnDO8w: folds 
FStoHe64SQWqAsjya9pDkQ: folds 
8ClCHtFXGNplITm+63KB+Q: folds 
OAmGQMdOxnvuBNHdADx0ew is disconnected 
OAmGQMdOxnvuBNHdADx0ew is connected 
OAmGQMdOxnvuBNHdADx0ew: calls $0.15
wMiE3yTbDJGOLOF9th7KPA: checks 
*** FLOP *** [Js Ks Td]
OAmGQMdOxnvuBNHdADx0ew: checks 
wMiE3yTbDJGOLOF9th7KPA: checks 
QJ/0wT0pYdWbDuqo9eNJgQ: bets $0.25
OAmGQMdOxnvuBNHdADx0ew: calls $0.25
wMiE3yTbDJGOLOF9th7KPA: calls $0.25
*** TURN *** [Js Ks Td] [7h]
OAmGQMdOxnvuBNHdADx0ew: checks 
wMiE3yTbDJGOLOF9th7KPA: checks 
QJ/0wT0pYdWbDuqo9eNJgQ: bets $0.50
OAmGQMdOxnvuBNHdADx0ew: calls $0.50
wMiE3yTbDJGOLOF9th7KPA: calls $0.50
*** RIVER *** [Js Ks Td 7h] [9d]
OAmGQMdOxnvuBNHdADx0ew: checks 
wMiE3yTbDJGOLOF9th7KPA: checks 
QJ/0wT0pYdWbDuqo9eNJgQ: bets $2.25
OAmGQMdOxnvuBNHdADx0ew: folds 
wMiE3yTbDJGOLOF9th7KPA: folds 
Uncalled bet ($2.25) returned to QJ/0wT0pYdWbDuqo9eNJgQ
QJ/0wT0pYdWbDuqo9eNJgQ collected $2.90 from pot
QJ/0wT0pYdWbDuqo9eNJgQ: doesn't show hand 
*** SUMMARY ***
Total pot $3 | Rake $0.10 
Board [Js Ks Td 7h 9d]
Seat 1: OAmGQMdOxnvuBNHdADx0ew (small blind) folded on the River
Seat 2: wMiE3yTbDJGOLOF9th7KPA (big blind) folded on the River
Seat 3: QJ/0wT0pYdWbDuqo9eNJgQ collected ($2.90)
Seat 4: v+QfkGiuj9bgtuNoVnDO8w folded before Flop (didn't bet)
Seat 5: FStoHe64SQWqAsjya9pDkQ folded before Flop (didn't bet)
Seat 6: 8ClCHtFXGNplITm+63KB+Q (button) folded before Flop (didn't bet)




PokerStars Game #59939397224:  Hold'em No Limit ($0.10/$0.25) - 2009/07/01 0:38:49 ET
Table 'MiquQrQZJJq9ZtgRIp9HFQ' 6-max Seat #5 is the button
Seat 1: hM0MSDtq2ow7J40bSR04ig ($8.25 in chips) 
Seat 2: DMQLAmut/l19xN5STQndFg ($4.25 in chips) 
Seat 4: 0HIrwssk0FQvyKULzUTtlg ($16.45 in chips) 
Seat 5: LXN9U+5F+9if/ead2+w1nw ($44.10 in chips) 
Seat 6: X9oXZTg4PhZVR+ilX2OYbA ($14.75 in chips) 
X9oXZTg4PhZVR+ilX2OYbA: posts small blind $0.10
hM0MSDtq2ow7J40bSR04ig: posts big blind $0.25
*** HOLE CARDS ***
DMQLAmut/l19xN5STQndFg: folds 
0HIrwssk0FQvyKULzUTtlg: raises $0.75 to $1
LXN9U+5F+9if/ead2+w1nw: folds 
X9oXZTg4PhZVR+ilX2OYbA: folds 
hM0MSDtq2ow7J40bSR04ig: folds 
Uncalled bet ($0.75) returned to 0HIrwssk0FQvyKULzUTtlg
0HIrwssk0FQvyKULzUTtlg collected $0.60 from pot
*** SUMMARY ***
Total pot $0.60 | Rake $0 
Seat 1: hM0MSDtq2ow7J40bSR04ig (big blind) folded before Flop
Seat 2: DMQLAmut/l19xN5STQndFg folded before Flop (didn't bet)
Seat 4: 0HIrwssk0FQvyKULzUTtlg collected ($0.60)
Seat 5: LXN9U+5F+9if/ead2+w1nw (button) folded before Flop (didn't bet)
Seat 6: X9oXZTg4PhZVR+ilX2OYbA (small blind) folded before Flop




PokerStars Game #59939397180:  Hold'em No Limit ($0.10/$0.25) - 2009/07/01 0:38:49 ET
Table 'ORSZkZqq+7Ja2PdeCFAytA' 9-max Seat #4 is the button
Seat 1: Gpa8cld5y0mdOomHJgHhlA ($10.90 in chips) 
Seat 2: yduPKWPzL8YlT5Zv/Nmrwg ($10 in chips) 
Seat 3: nm4Dj/f+jJEwKVsUnKh73g ($25 in chips) 
Seat 4: b8t3jWrxzeEt9HtZtc9wUQ ($26.45 in chips) 
Seat 5: tYsOBqdU1+x+yFI7zHO7hQ ($31.40 in chips) 
Seat 8: opOCI2p6kW0tINuVaAqmcQ ($39.45 in chips) 
Seat 9: VBHxUExRAMrbxUq/cVx9Gw ($5 in chips) 
tYsOBqdU1+x+yFI7zHO7hQ: posts small blind $0.10
ZoG0obuajzVjwgd7lNHjgg: is sitting out 
opOCI2p6kW0tINuVaAqmcQ: posts big blind $0.25
nm4Dj/f+jJEwKVsUnKh73g: posts big blind $0.25
*** HOLE CARDS ***
VBHxUExRAMrbxUq/cVx9Gw: raises $1 to $1.25
Gpa8cld5y0mdOomHJgHhlA: folds 
yduPKWPzL8YlT5Zv/Nmrwg: folds 
nm4Dj/f+jJEwKVsUnKh73g: folds 
b8t3jWrxzeEt9HtZtc9wUQ: folds 
tYsOBqdU1+x+yFI7zHO7hQ: folds 
opOCI2p6kW0tINuVaAqmcQ: folds 
Uncalled bet ($1) returned to VBHxUExRAMrbxUq/cVx9Gw
VBHxUExRAMrbxUq/cVx9Gw collected $0.85 from pot
*** SUMMARY ***
Total pot $0.85 | Rake $0 
Seat 1: Gpa8cld5y0mdOomHJgHhlA folded before Flop (didn't bet)
Seat 2: yduPKWPzL8YlT5Zv/Nmrwg folded before Flop (didn't bet)
Seat 3: nm4Dj/f+jJEwKVsUnKh73g folded before Flop
Seat 4: b8t3jWrxzeEt9HtZtc9wUQ (button) folded before Flop (didn't bet)
Seat 5: tYsOBqdU1+x+yFI7zHO7hQ (small blind) folded before Flop
Seat 8: opOCI2p6kW0tINuVaAqmcQ (big blind) folded before Flop
Seat 9: VBHxUExRAMrbxUq/cVx9Gw collected ($0.85)




PokerStars Game #59939396998:  Hold'em No Limit ($0.10/$0.25) - 2009/07/01 0:38:49 ET
Table 'RPdw09/gGCIP4xFhDWJgXQ' 9-max Seat #9 is the button
Seat 1: aNpwfA31EREwO+ar4XzBCw ($25 in chips) 
Seat 2: Sd1tfhUq/M96GhXGv1hwFQ ($11 in chips) 
Seat 3: Qi+clOtyDiibLdH2/1Qy8g ($26.35 in chips) 
Seat 4: z5GxcHlYz/GSz6W2uFiTtg ($22.35 in chips) 
Seat 5: z0kymJfmEW9d8WGcY1n6OA ($2.50 in chips) 
Seat 6: monZeAwXUmIA1l84cUd2hw ($19.30 in chips) 
Seat 7: hIss79a4pu7GzJZepfgOpg ($25 in chips) 
Seat 8: MG90wfSJZnOejs/KD3vlQQ ($25 in chips) 
Seat 9: Yv4fucyyT28mjx8V5lxKJg ($47.35 in chips) 
aNpwfA31EREwO+ar4XzBCw: posts small blind $0.10
Sd1tfhUq/M96GhXGv1hwFQ: posts big blind $0.25
*** HOLE CARDS ***
Qi+clOtyDiibLdH2/1Qy8g: folds 
z5GxcHlYz/GSz6W2uFiTtg: calls $0.25
z0kymJfmEW9d8WGcY1n6OA: folds 
monZeAwXUmIA1l84cUd2hw: calls $0.25
hIss79a4pu7GzJZepfgOpg: folds 
MG90wfSJZnOejs/KD3vlQQ: folds 
Yv4fucyyT28mjx8V5lxKJg: raises $1 to $1.25
aNpwfA31EREwO+ar4XzBCw: folds 
Sd1tfhUq/M96GhXGv1hwFQ: folds 
z5GxcHlYz/GSz6W2uFiTtg: folds 
monZeAwXUmIA1l84cUd2hw: folds 
Uncalled bet ($1) returned to Yv4fucyyT28mjx8V5lxKJg
Yv4fucyyT28mjx8V5lxKJg collected $1.10 from pot
Yv4fucyyT28mjx8V5lxKJg: doesn't show hand 
*** SUMMARY ***
Total pot $1.10 | Rake $0 
Seat 1: aNpwfA31EREwO+ar4XzBCw (small blind) folded before Flop
Seat 2: Sd1tfhUq/M96GhXGv1hwFQ (big blind) folded before Flop
Seat 3: Qi+clOtyDiibLdH2/1Qy8g folded before Flop (didn't bet)
Seat 4: z5GxcHlYz/GSz6W2uFiTtg folded before Flop
Seat 5: z0kymJfmEW9d8WGcY1n6OA folded before Flop (didn't bet)
Seat 6: monZeAwXUmIA1l84cUd2hw folded before Flop
Seat 7: hIss79a4pu7GzJZepfgOpg folded before Flop (didn't bet)
Seat 8: MG90wfSJZnOejs/KD3vlQQ folded before Flop (didn't bet)
Seat 9: Yv4fucyyT28mjx8V5lxKJg (button) collected ($1.10)




PokerStars Game #59939397200:  Hold'em No Limit ($0.10/$0.25) - 2009/07/01 0:38:49 ET
Table 'Yb2CyZosw7N3yRRVLhKnKg' 9-max Seat #4 is the button
Seat 1: lcT2xQLmuzNRe6+aWd6eww ($32.15 in chips) 
Seat 2: dmYlc+1cjwZMJ7wV+Z0rRg ($25.90 in chips) 
Seat 4: H5Se03ZqSX7tbULXur2MAg ($19.80 in chips) 
Seat 5: QUCO+kde5iROhmqVTzQ6KQ ($37.35 in chips) 
Seat 6: opOCI2p6kW0tINuVaAqmcQ ($25.90 in chips) 
Seat 7: OiV1PWZ3IkN29JlmCcnTwQ ($4.65 in chips) 
Seat 8: aJy680tKSaP5er559aSuGA ($22.50 in chips) 
Seat 9: aCVg6cCxQcqClhB9nq/p1w ($9.45 in chips) 
QUCO+kde5iROhmqVTzQ6KQ: posts small blind $0.10
opOCI2p6kW0tINuVaAqmcQ: posts big blind $0.25
*** HOLE CARDS ***
OiV1PWZ3IkN29JlmCcnTwQ: folds 
aJy680tKSaP5er559aSuGA: folds 
aCVg6cCxQcqClhB9nq/p1w: raises $0.50 to $0.75
lcT2xQLmuzNRe6+aWd6eww: folds 
dmYlc+1cjwZMJ7wV+Z0rRg: folds 
H5Se03ZqSX7tbULXur2MAg: folds 
QUCO+kde5iROhmqVTzQ6KQ: folds 
opOCI2p6kW0tINuVaAqmcQ: folds 
Uncalled bet ($0.50) returned to aCVg6cCxQcqClhB9nq/p1w
aCVg6cCxQcqClhB9nq/p1w collected $0.60 from pot
*** SUMMARY ***
Total pot $0.60 | Rake $0 
Seat 1: lcT2xQLmuzNRe6+aWd6eww folded before Flop (didn't bet)
Seat 2: dmYlc+1cjwZMJ7wV+Z0rRg folded before Flop (didn't bet)
Seat 4: H5Se03ZqSX7tbULXur2MAg (button) folded before Flop (didn't bet)
Seat 5: QUCO+kde5iROhmqVTzQ6KQ (small blind) folded before Flop
Seat 6: opOCI2p6kW0tINuVaAqmcQ (big blind) folded before Flop
Seat 7: OiV1PWZ3IkN29JlmCcnTwQ folded before Flop (didn't bet)
Seat 8: aJy680tKSaP5er559aSuGA folded before Flop (didn't bet)
Seat 9: aCVg6cCxQcqClhB9nq/p1w collected ($0.60)




PokerStars Game #59939396982:  Hold'em No Limit ($0.10/$0.25) - 2009/07/01 0:38:49 ET
Table 'Rv0EYnRU8WwZiwx0Zo3X3w' 9-max Seat #9 is the button
Seat 1: opOCI2p6kW0tINuVaAqmcQ ($48.25 in chips) 
Seat 2: Xpyqpb+DURDWnyJ3xTEIFQ ($39.90 in chips) 
Seat 3: STkR8XvpjNv79OOMhrlh2w ($25 in chips) 
Seat 4: IDkfbfxTm9KJ+DMyGVH8rw ($12.05 in chips) 
Seat 5: h4ggJZYBXV0mEZzYPYKfeA ($20.85 in chips) 
Seat 6: 5hAPbqNrvJb8PtLiceXtlg ($4.65 in chips) 
Seat 7: Th3FldXKQW6hWVVPahaoOQ ($32.55 in chips) 
Seat 9: r1pFKMwWp74QwhfPWJOAyw ($6.60 in chips) 
opOCI2p6kW0tINuVaAqmcQ: posts small blind $0.10
Xpyqpb+DURDWnyJ3xTEIFQ: posts big blind $0.25
*** HOLE CARDS ***
STkR8XvpjNv79OOMhrlh2w: folds 
IDkfbfxTm9KJ+DMyGVH8rw: folds 
h4ggJZYBXV0mEZzYPYKfeA: folds 
5hAPbqNrvJb8PtLiceXtlg: folds 
Th3FldXKQW6hWVVPahaoOQ: raises $0.75 to $1
r1pFKMwWp74QwhfPWJOAyw: folds 
opOCI2p6kW0tINuVaAqmcQ: calls $0.90
Xpyqpb+DURDWnyJ3xTEIFQ: calls $0.75
*** FLOP *** [Jd 2c Ts]
opOCI2p6kW0tINuVaAqmcQ: checks 
Xpyqpb+DURDWnyJ3xTEIFQ: checks 
Th3FldXKQW6hWVVPahaoOQ: bets $1.50
opOCI2p6kW0tINuVaAqmcQ: folds 
Xpyqpb+DURDWnyJ3xTEIFQ: calls $1.50
*** TURN *** [Jd 2c Ts] [2h]
Xpyqpb+DURDWnyJ3xTEIFQ: checks 
Th3FldXKQW6hWVVPahaoOQ: bets $3
Xpyqpb+DURDWnyJ3xTEIFQ: calls $3
*** RIVER *** [Jd 2c Ts 2h] [7c]
Xpyqpb+DURDWnyJ3xTEIFQ: checks 
Th3FldXKQW6hWVVPahaoOQ: bets $7
Xpyqpb+DURDWnyJ3xTEIFQ: folds 
Uncalled bet ($7) returned to Th3FldXKQW6hWVVPahaoOQ
Th3FldXKQW6hWVVPahaoOQ collected $11.45 from pot
Th3FldXKQW6hWVVPahaoOQ: doesn't show hand 
*** SUMMARY ***
Total pot $12 | Rake $0.55 
Board [Jd 2c Ts 2h 7c]
Seat 1: opOCI2p6kW0tINuVaAqmcQ (small blind) folded on the Flop
Seat 2: Xpyqpb+DURDWnyJ3xTEIFQ (big blind) folded on the River
Seat 3: STkR8XvpjNv79OOMhrlh2w folded before Flop (didn't bet)
Seat 4: IDkfbfxTm9KJ+DMyGVH8rw folded before Flop (didn't bet)
Seat 5: h4ggJZYBXV0mEZzYPYKfeA folded before Flop (didn't bet)
Seat 6: 5hAPbqNrvJb8PtLiceXtlg folded before Flop (didn't bet)
Seat 7: Th3FldXKQW6hWVVPahaoOQ collected ($11.45)
Seat 9: r1pFKMwWp74QwhfPWJOAyw (button) folded before Flop (didn't bet)




PokerStars Game #59939397848:  Hold'em No Limit ($0.10/$0.25) - 2009/07/01 0:38:50 ET
Table 'nXVbUw6/HYwA6x21+IZ3XQ' 9-max Seat #7 is the button
Seat 1: zDrucyjVn5aeekNEc3cJrA ($23.65 in chips) 
Seat 2: 1K6QGyJP9P9xmRac2fH4OQ ($29.80 in chips) 
Seat 3: Vhpns1oAZs77VUIptmuKDw ($41.05 in chips) 
Seat 4: GmQux9F6mgOHtI4C9bVTNQ ($5 in chips) 
Seat 5: M/9j4wkHH9i1JM51vgi1VA ($20.80 in chips) 
Seat 6: ljemhp25Zg+nlA9DLCIiUw ($23.60 in chips) 
Seat 7: IupaN0QS3TJoOSYaS7zF9w ($8.20 in chips) 
Seat 8: dfNim92Z6XK1/h5SFW5vDg ($25 in chips) 
Seat 9: rm0e8CshiGK8hjW46YcNqg ($29.45 in chips) 
dfNim92Z6XK1/h5SFW5vDg: posts small blind $0.10
rm0e8CshiGK8hjW46YcNqg: posts big blind $0.25
*** HOLE CARDS ***
rm0e8CshiGK8hjW46YcNqg said, "Canada has its own day?"
zDrucyjVn5aeekNEc3cJrA: calls $0.25
rm0e8CshiGK8hjW46YcNqg said, "america has like ten days"
GmQux9F6mgOHtI4C9bVTNQ said, "Canadian Girls gone wild tomorrow."
1K6QGyJP9P9xmRac2fH4OQ: folds 
Vhpns1oAZs77VUIptmuKDw: calls $0.25
GmQux9F6mgOHtI4C9bVTNQ: folds 
M/9j4wkHH9i1JM51vgi1VA: folds 
Vhpns1oAZs77VUIptmuKDw said, "actually its past midnight, its canada day today"
IupaN0QS3TJoOSYaS7zF9w said, "how does Canada have a day when it never fought for its freedom"
ljemhp25Zg+nlA9DLCIiUw: folds 
IupaN0QS3TJoOSYaS7zF9w: folds 
dfNim92Z6XK1/h5SFW5vDg: calls $0.15
Vhpns1oAZs77VUIptmuKDw said, "im here and i don't understand it either"
rm0e8CshiGK8hjW46YcNqg said, "it did fight for freedom"
GmQux9F6mgOHtI4C9bVTNQ said, "We fought the Chinese"
Vhpns1oAZs77VUIptmuKDw said, "**** canada"
rm0e8CshiGK8hjW46YcNqg said, "it just lost"
rm0e8CshiGK8hjW46YcNqg: checks 
*** FLOP *** [8s 9s Jd]
dfNim92Z6XK1/h5SFW5vDg: checks 
GmQux9F6mgOHtI4C9bVTNQ said, "they came over before Alaska existed."
rm0e8CshiGK8hjW46YcNqg: bets $3.25
GmQux9F6mgOHtI4C9bVTNQ said, "on the land bridge."
rm0e8CshiGK8hjW46YcNqg said, "overbet"
IupaN0QS3TJoOSYaS7zF9w said, "China doesnt even Border Alaska"
zDrucyjVn5aeekNEc3cJrA: folds 
IupaN0QS3TJoOSYaS7zF9w said, "thats Russia"
rm0e8CshiGK8hjW46YcNqg said, "lol"
Vhpns1oAZs77VUIptmuKDw: folds 
dfNim92Z6XK1/h5SFW5vDg: folds 
Uncalled bet ($3.25) returned to rm0e8CshiGK8hjW46YcNqg
rm0e8CshiGK8hjW46YcNqg collected $0.95 from pot
rm0e8CshiGK8hjW46YcNqg said, "BUT RUSSIA BORDERS CHINA"
*** SUMMARY ***
Total pot $1 | Rake $0.05 
Board [8s 9s Jd]
Seat 1: zDrucyjVn5aeekNEc3cJrA folded on the Flop
Seat 2: 1K6QGyJP9P9xmRac2fH4OQ folded before Flop (didn't bet)
Seat 3: Vhpns1oAZs77VUIptmuKDw folded on the Flop
Seat 4: GmQux9F6mgOHtI4C9bVTNQ folded before Flop (didn't bet)
Seat 5: M/9j4wkHH9i1JM51vgi1VA folded before Flop (didn't bet)
Seat 6: ljemhp25Zg+nlA9DLCIiUw folded before Flop (didn't bet)
Seat 7: IupaN0QS3TJoOSYaS7zF9w (button) folded before Flop (didn't bet)
Seat 8: dfNim92Z6XK1/h5SFW5vDg (small blind) folded on the Flop
Seat 9: rm0e8CshiGK8hjW46YcNqg (big blind) collected ($0.95)




PokerStars Game #59939398022:  Hold'em No Limit ($0.10/$0.25) - 2009/07/01 0:38:50 ET
Table 'axb9RsG8Zj1A0LEukTeFrQ' 9-max Seat #9 is the button
Seat 1: qwr38jl5txoR36M7G5qi4A ($10 in chips) 
Seat 2: zDrucyjVn5aeekNEc3cJrA ($23.20 in chips) 
Seat 3: cZ99hugmLBj9KhTlc8nCSw ($28 in chips) 
Seat 4: TeWJxSETzbXGiYKx0y+dtg ($25 in chips) 
Seat 5: rLSSHKOHnb6yzVfDoQM/RA ($12.55 in chips) 
Seat 6: FSuhElWc38JXYToR0dwhjg ($17.20 in chips) 
Seat 7: 1K6QGyJP9P9xmRac2fH4OQ ($30.70 in chips) 
Seat 8: CqwJk5Z2+vb2f9j1o7IjKQ ($28.30 in chips) 
Seat 9: qbQE8CifKB4+OEvNF/61Rw ($36 in chips) 
qwr38jl5txoR36M7G5qi4A: posts small blind $0.10
zDrucyjVn5aeekNEc3cJrA: posts big blind $0.25
*** HOLE CARDS ***
cZ99hugmLBj9KhTlc8nCSw: folds 
TeWJxSETzbXGiYKx0y+dtg: folds 
rLSSHKOHnb6yzVfDoQM/RA: folds 
FSuhElWc38JXYToR0dwhjg: calls $0.25
1K6QGyJP9P9xmRac2fH4OQ: raises $1 to $1.25
CqwJk5Z2+vb2f9j1o7IjKQ: folds 
qbQE8CifKB4+OEvNF/61Rw: folds 
qwr38jl5txoR36M7G5qi4A: folds 
zDrucyjVn5aeekNEc3cJrA: folds 
FSuhElWc38JXYToR0dwhjg: calls $1
*** FLOP *** [8s 4h 8c]
FSuhElWc38JXYToR0dwhjg: checks 
1K6QGyJP9P9xmRac2fH4OQ: bets $1.90
FSuhElWc38JXYToR0dwhjg: folds 
Uncalled bet ($1.90) returned to 1K6QGyJP9P9xmRac2fH4OQ
1K6QGyJP9P9xmRac2fH4OQ collected $2.75 from pot
1K6QGyJP9P9xmRac2fH4OQ: doesn't show hand 
*** SUMMARY ***
Total pot $2.85 | Rake $0.10 
Board [8s 4h 8c]
Seat 1: qwr38jl5txoR36M7G5qi4A (small blind) folded before Flop
Seat 2: zDrucyjVn5aeekNEc3cJrA (big blind) folded before Flop
Seat 3: cZ99hugmLBj9KhTlc8nCSw folded before Flop (didn't bet)
Seat 4: TeWJxSETzbXGiYKx0y+dtg folded before Flop (didn't bet)
Seat 5: rLSSHKOHnb6yzVfDoQM/RA folded before Flop (didn't bet)
Seat 6: FSuhElWc38JXYToR0dwhjg folded on the Flop
Seat 7: 1K6QGyJP9P9xmRac2fH4OQ collected ($2.75)
Seat 8: CqwJk5Z2+vb2f9j1o7IjKQ folded before Flop (didn't bet)
Seat 9: qbQE8CifKB4+OEvNF/61Rw (button) folded before Flop (didn't bet)




PokerStars Game #59939397982:  Hold'em No Limit ($0.10/$0.25) - 2009/07/01 0:38:50 ET
Table 'UVjmXTtsmlX1HxwwZ59akg' 9-max Seat #2 is the button
Seat 1: zDrucyjVn5aeekNEc3cJrA ($27.30 in chips) 
Seat 2: COsrwJSFHQtxlUcrYtDQPQ ($27.25 in chips) 
Seat 3: N6fYvIzQLKaydFLKQGtMlQ ($24.75 in chips) 
Seat 4: aNpwfA31EREwO+ar4XzBCw ($25.35 in chips) 
Seat 6: DnDcAdn9P0zGovMERigpFA ($33.75 in chips) 
Seat 8: 1MicVRr41LapJvzzk3i8Tw ($11.70 in chips) 
Seat 9: CwVLsIXxfYxktnIIDbafCw ($14.15 in chips) 
N6fYvIzQLKaydFLKQGtMlQ: posts small blind $0.10
aNpwfA31EREwO+ar4XzBCw: posts big blind $0.25
*** HOLE CARDS ***
DnDcAdn9P0zGovMERigpFA: raises $0.75 to $1
1MicVRr41LapJvzzk3i8Tw: folds 
CwVLsIXxfYxktnIIDbafCw: folds 
zDrucyjVn5aeekNEc3cJrA: folds 
COsrwJSFHQtxlUcrYtDQPQ: folds 
N6fYvIzQLKaydFLKQGtMlQ: folds 
aNpwfA31EREwO+ar4XzBCw: folds 
Uncalled bet ($0.75) returned to DnDcAdn9P0zGovMERigpFA
DnDcAdn9P0zGovMERigpFA collected $0.60 from pot
DnDcAdn9P0zGovMERigpFA: doesn't show hand 
*** SUMMARY ***
Total pot $0.60 | Rake $0 
Seat 1: zDrucyjVn5aeekNEc3cJrA folded before Flop (didn't bet)
Seat 2: COsrwJSFHQtxlUcrYtDQPQ (button) folded before Flop (didn't bet)
Seat 3: N6fYvIzQLKaydFLKQGtMlQ (small blind) folded before Flop
Seat 4: aNpwfA31EREwO+ar4XzBCw (big blind) folded before Flop
Seat 6: DnDcAdn9P0zGovMERigpFA collected ($0.60)
Seat 8: 1MicVRr41LapJvzzk3i8Tw folded before Flop (didn't bet)
Seat 9: CwVLsIXxfYxktnIIDbafCw folded before Flop (didn't bet)




PokerStars Game #59939397822:  Hold'em No Limit ($0.10/$0.25) - 2009/07/01 0:38:50 ET
Table 'fRxOyfaHXkWUDLv4eSxFew' 9-max Seat #3 is the button
Seat 2: TeWJxSETzbXGiYKx0y+dtg ($24.30 in chips) 
Seat 3: hBMUlEpyU74r/fwDgIpXjQ ($25.20 in chips) 
Seat 4: aCVg6cCxQcqClhB9nq/p1w ($51.60 in chips) 
Seat 6: N/O9ADKpmqB2ASZuqgodlw ($6.80 in chips) 
Seat 7: 7cv+9Zc9HIQHNvYsMfV3uA ($54.40 in chips) 
Seat 8: 1K6QGyJP9P9xmRac2fH4OQ ($25 in chips) 
Seat 9: H5Se03ZqSX7tbULXur2MAg ($23.80 in chips) 
aCVg6cCxQcqClhB9nq/p1w: posts small blind $0.10
N/O9ADKpmqB2ASZuqgodlw: posts big blind $0.25
OlPJsgR4xypSg/w1z7Gyvw: sits out 
*** HOLE CARDS ***
7cv+9Zc9HIQHNvYsMfV3uA: folds 
1K6QGyJP9P9xmRac2fH4OQ: folds 
H5Se03ZqSX7tbULXur2MAg: folds 
TeWJxSETzbXGiYKx0y+dtg: folds 
hBMUlEpyU74r/fwDgIpXjQ: folds 
aCVg6cCxQcqClhB9nq/p1w: folds 
Uncalled bet ($0.15) returned to N/O9ADKpmqB2ASZuqgodlw
N/O9ADKpmqB2ASZuqgodlw collected $0.20 from pot
*** SUMMARY ***
Total pot $0.20 | Rake $0 
Seat 2: TeWJxSETzbXGiYKx0y+dtg folded before Flop (didn't bet)
Seat 3: hBMUlEpyU74r/fwDgIpXjQ (button) folded before Flop (didn't bet)
Seat 4: aCVg6cCxQcqClhB9nq/p1w (small blind) folded before Flop
Seat 6: N/O9ADKpmqB2ASZuqgodlw (big blind) collected ($0.20)
Seat 7: 7cv+9Zc9HIQHNvYsMfV3uA folded before Flop (didn't bet)
Seat 8: 1K6QGyJP9P9xmRac2fH4OQ folded before Flop (didn't bet)
Seat 9: H5Se03ZqSX7tbULXur2MAg folded before Flop (didn't bet)




PokerStars Game #59939398210:  Hold'em No Limit ($0.10/$0.25) - 2009/07/01 0:38:50 ET
Table '2O5CgfSkSwrr4PDrlZ1RLQ' 6-max Seat #1 is the button
Seat 1: kyRaCIljYA6l33lSKQfNsg ($47.25 in chips) 
Seat 2: /gJNBeCkWL4o85/jvlZ4BA ($50 in chips) 
Seat 3: yzFNNFIfC89bBPwpFPx2ow ($25 in chips) 
Seat 4: 4x9jCqgSw4272dnaIqnanw ($9.25 in chips) 
Seat 5: AMrBn4Vx9aAo/vv6WHLk6w ($4.90 in chips) 
/gJNBeCkWL4o85/jvlZ4BA: posts small blind $0.10
yzFNNFIfC89bBPwpFPx2ow: posts big blind $0.25
*** HOLE CARDS ***
4x9jCqgSw4272dnaIqnanw: folds 
AMrBn4Vx9aAo/vv6WHLk6w: calls $0.25
kyRaCIljYA6l33lSKQfNsg: folds 
/gJNBeCkWL4o85/jvlZ4BA: calls $0.15
Pdog104 joins the table at seat #6 
yzFNNFIfC89bBPwpFPx2ow: checks 
*** FLOP *** [Td Qh 4h]
/gJNBeCkWL4o85/jvlZ4BA: checks 
yzFNNFIfC89bBPwpFPx2ow: checks 
AMrBn4Vx9aAo/vv6WHLk6w: checks 
*** TURN *** [Td Qh 4h] [2d]
/gJNBeCkWL4o85/jvlZ4BA: checks 
yzFNNFIfC89bBPwpFPx2ow: checks 
AMrBn4Vx9aAo/vv6WHLk6w: bets $0.50
/gJNBeCkWL4o85/jvlZ4BA: folds 
yzFNNFIfC89bBPwpFPx2ow: folds 
Uncalled bet ($0.50) returned to AMrBn4Vx9aAo/vv6WHLk6w
AMrBn4Vx9aAo/vv6WHLk6w collected $0.75 from pot
*** SUMMARY ***
Total pot $0.75 | Rake $0 
Board [Td Qh 4h 2d]
Seat 1: kyRaCIljYA6l33lSKQfNsg (button) folded before Flop (didn't bet)
Seat 2: /gJNBeCkWL4o85/jvlZ4BA (small blind) folded on the Turn
Seat 3: yzFNNFIfC89bBPwpFPx2ow (big blind) folded on the Turn
Seat 4: 4x9jCqgSw4272dnaIqnanw folded before Flop (didn't bet)
Seat 5: AMrBn4Vx9aAo/vv6WHLk6w collected ($0.75)




PokerStars Game #59939398010:  Hold'em No Limit ($0.10/$0.25) - 2009/07/01 0:38:50 ET
Table 'oJpFwZj9+FUGHX90Un8s9Q' 6-max Seat #4 is the button
Seat 1: bkBfOBmBcZKg8k/zXu9rWQ ($4.75 in chips) 
Seat 2: IMmIhmfU3tqkaJABnD21Rg ($14.95 in chips) 
Seat 3: kyRaCIljYA6l33lSKQfNsg ($26.65 in chips) 
Seat 4: IX/nJvz3Mx/Ez6DgueFA4Q ($7.20 in chips) 
Seat 6: Zijzy/UtPWzWVUo81HHVjQ ($40.20 in chips) 
kG34n23qFQA3nzdOJTQ1dA will be allowed to play after the button
Zijzy/UtPWzWVUo81HHVjQ: posts small blind $0.10
bkBfOBmBcZKg8k/zXu9rWQ: posts big blind $0.25
*** HOLE CARDS ***
IMmIhmfU3tqkaJABnD21Rg: raises $0.25 to $0.50
kyRaCIljYA6l33lSKQfNsg: folds 
IX/nJvz3Mx/Ez6DgueFA4Q: folds 
IX/nJvz3Mx/Ez6DgueFA4Q said, "helloooo?"
IX/nJvz3Mx/Ez6DgueFA4Q said, "helloooooooo?"
Zijzy/UtPWzWVUo81HHVjQ has timed out
Zijzy/UtPWzWVUo81HHVjQ: folds 
Zijzy/UtPWzWVUo81HHVjQ is sitting out
bkBfOBmBcZKg8k/zXu9rWQ: calls $0.25
*** FLOP *** [7h Ts Jh]
Zijzy/UtPWzWVUo81HHVjQ has returned
IX/nJvz3Mx/Ez6DgueFA4Q said, "what  had too peee?"
bkBfOBmBcZKg8k/zXu9rWQ: bets $0.25
IMmIhmfU3tqkaJABnD21Rg: calls $0.25
*** TURN *** [7h Ts Jh] [2s]
bkBfOBmBcZKg8k/zXu9rWQ: bets $4 and is all-in
IMmIhmfU3tqkaJABnD21Rg: calls $4
*** RIVER *** [7h Ts Jh 2s] [6d]
*** SHOW DOWN ***
bkBfOBmBcZKg8k/zXu9rWQ: shows [Jd 8s] (a pair of Jacks)
IMmIhmfU3tqkaJABnD21Rg: shows [7s 7c] (three of a kind, Sevens)
IMmIhmfU3tqkaJABnD21Rg collected $9.15 from pot
*** SUMMARY ***
Total pot $9.60 | Rake $0.45 
Board [7h Ts Jh 2s 6d]
Seat 1: bkBfOBmBcZKg8k/zXu9rWQ (big blind) showed [Jd 8s] and lost with a pair of Jacks
Seat 2: IMmIhmfU3tqkaJABnD21Rg showed [7s 7c] and won ($9.15) with three of a kind, Sevens
Seat 3: kyRaCIljYA6l33lSKQfNsg folded before Flop (didn't bet)
Seat 4: IX/nJvz3Mx/Ez6DgueFA4Q (button) folded before Flop (didn't bet)
Seat 6: Zijzy/UtPWzWVUo81HHVjQ (small blind) folded before Flop




PokerStars Game #59939397748:  Hold'em No Limit ($0.10/$0.25) - 2009/07/01 0:38:50 ET
Table 'BdTkgy6SGkgNXul6irMoOw' 9-max Seat #4 is the button
Seat 2: ljemhp25Zg+nlA9DLCIiUw ($24.45 in chips) 
Seat 4: eygIcrabyU9hI2mw7NQsgg ($23.55 in chips) 
Seat 5: opOCI2p6kW0tINuVaAqmcQ ($25.10 in chips) 
Seat 6: XlP4n7rTkDteN8BWl//wvg ($38 in chips) 
Seat 9: 5dv9mRGKI/UifM58OINXVQ ($19.90 in chips) 
opOCI2p6kW0tINuVaAqmcQ: posts small blind $0.10
XlP4n7rTkDteN8BWl//wvg: posts big blind $0.25
*** HOLE CARDS ***
5dv9mRGKI/UifM58OINXVQ: calls $0.25
ljemhp25Zg+nlA9DLCIiUw: raises $0.75 to $1
eygIcrabyU9hI2mw7NQsgg: folds 
opOCI2p6kW0tINuVaAqmcQ: folds 
XlP4n7rTkDteN8BWl//wvg: calls $0.75
margio1 joins the table at seat #1 
5dv9mRGKI/UifM58OINXVQ: calls $0.75
*** FLOP *** [2c Qs Jd]
XlP4n7rTkDteN8BWl//wvg: checks 
5dv9mRGKI/UifM58OINXVQ: checks 
ljemhp25Zg+nlA9DLCIiUw: bets $2.25
XlP4n7rTkDteN8BWl//wvg: calls $2.25
5dv9mRGKI/UifM58OINXVQ: folds 
*** TURN *** [2c Qs Jd] [Ac]
XlP4n7rTkDteN8BWl//wvg: checks 
ljemhp25Zg+nlA9DLCIiUw: bets $4
XlP4n7rTkDteN8BWl//wvg: calls $4
*** RIVER *** [2c Qs Jd Ac] [6d]
XlP4n7rTkDteN8BWl//wvg: checks 
ljemhp25Zg+nlA9DLCIiUw: bets $8
XlP4n7rTkDteN8BWl//wvg: calls $8
*** SHOW DOWN ***
ljemhp25Zg+nlA9DLCIiUw: shows [Qc Ad] (two pair, Aces and Queens)
XlP4n7rTkDteN8BWl//wvg: mucks hand 
ljemhp25Zg+nlA9DLCIiUw collected $30.10 from pot
*** SUMMARY ***
Total pot $31.60 | Rake $1.50 
Board [2c Qs Jd Ac 6d]
Seat 2: ljemhp25Zg+nlA9DLCIiUw showed [Qc Ad] and won ($30.10) with two pair, Aces and Queens
Seat 4: eygIcrabyU9hI2mw7NQsgg (button) folded before Flop (didn't bet)
Seat 5: opOCI2p6kW0tINuVaAqmcQ (small blind) folded before Flop
Seat 6: XlP4n7rTkDteN8BWl//wvg (big blind) mucked
Seat 9: 5dv9mRGKI/UifM58OINXVQ folded on the Flop




PokerStars Game #59939397930:  Hold'em No Limit ($0.10/$0.25) - 2009/07/01 0:38:50 ET
Table '8QBBaev+cI2i/r2H6ml/lg' 9-max Seat #9 is the button
Seat 2: tYsOBqdU1+x+yFI7zHO7hQ ($25 in chips) 
Seat 4: ZoG0obuajzVjwgd7lNHjgg ($1.35 in chips) 
Seat 5: j4q3p0lesp63b1gZDwLBZw ($5 in chips) 
Seat 6: E0iYnEVO2ho7dH3QcCjw7g ($32.45 in chips) 
Seat 9: Ml2bY77EHbM51ZWD7dnIWg ($1.95 in chips) 
tYsOBqdU1+x+yFI7zHO7hQ: posts small blind $0.10
ZoG0obuajzVjwgd7lNHjgg: posts big blind $0.25
*** HOLE CARDS ***
j4q3p0lesp63b1gZDwLBZw: folds 
E0iYnEVO2ho7dH3QcCjw7g: folds 
Ml2bY77EHbM51ZWD7dnIWg: folds 
E0iYnEVO2ho7dH3QcCjw7g leaves the table
tYsOBqdU1+x+yFI7zHO7hQ: folds 
Uncalled bet ($0.15) returned to ZoG0obuajzVjwgd7lNHjgg
ZoG0obuajzVjwgd7lNHjgg collected $0.20 from pot
*** SUMMARY ***
Total pot $0.20 | Rake $0 
Seat 2: tYsOBqdU1+x+yFI7zHO7hQ (small blind) folded before Flop
Seat 4: ZoG0obuajzVjwgd7lNHjgg (big blind) collected ($0.20)
Seat 5: j4q3p0lesp63b1gZDwLBZw folded before Flop (didn't bet)
Seat 6: E0iYnEVO2ho7dH3QcCjw7g folded before Flop (didn't bet)
Seat 9: Ml2bY77EHbM51ZWD7dnIWg (button) folded before Flop (didn't bet)




PokerStars Game #59939397976:  Hold'em No Limit ($0.10/$0.25) - 2009/07/01 0:38:50 ET
Table 'mk323gviqdkOY5Aek/1EWg' 6-max Seat #6 is the button
Seat 1: e8w9qW2QMnrAqkudVQoHoA ($22.85 in chips) 
Seat 2: GC/9yVD59DUCX7hUI7gcLw ($26.80 in chips) 
Seat 3: aSrj4lVmn2owyQ1RbbOqxQ ($23.40 in chips) 
Seat 4: o08wk0F4gROLhZS04Iyl3w ($29.10 in chips) 
Seat 5: SFmT9ZsVopnukjvAzrxTRg ($61.55 in chips) 
Seat 6: KkXSr5xFjxLSD3wtAvT+WQ ($18.25 in chips) 
e8w9qW2QMnrAqkudVQoHoA: posts small blind $0.10
GC/9yVD59DUCX7hUI7gcLw: posts big blind $0.25
*** HOLE CARDS ***
aSrj4lVmn2owyQ1RbbOqxQ: folds 
o08wk0F4gROLhZS04Iyl3w: folds 
SFmT9ZsVopnukjvAzrxTRg: folds 
KkXSr5xFjxLSD3wtAvT+WQ: folds 
e8w9qW2QMnrAqkudVQoHoA: raises $0.50 to $0.75
GC/9yVD59DUCX7hUI7gcLw: raises $2.25 to $3
e8w9qW2QMnrAqkudVQoHoA: raises $7 to $10
GC/9yVD59DUCX7hUI7gcLw: folds 
Uncalled bet ($7) returned to e8w9qW2QMnrAqkudVQoHoA
e8w9qW2QMnrAqkudVQoHoA collected $6 from pot
e8w9qW2QMnrAqkudVQoHoA: doesn't show hand 
*** SUMMARY ***
Total pot $6 | Rake $0 
Seat 1: e8w9qW2QMnrAqkudVQoHoA (small blind) collected ($6)
Seat 2: GC/9yVD59DUCX7hUI7gcLw (big blind) folded before Flop
Seat 3: aSrj4lVmn2owyQ1RbbOqxQ folded before Flop (didn't bet)
Seat 4: o08wk0F4gROLhZS04Iyl3w folded before Flop (didn't bet)
Seat 5: SFmT9ZsVopnukjvAzrxTRg folded before Flop (didn't bet)
Seat 6: KkXSr5xFjxLSD3wtAvT+WQ (button) folded before Flop (didn't bet)




PokerStars Game #59939398784:  Hold'em No Limit ($0.10/$0.25) - 2009/07/01 0:38:51 ET
Table 'xPn6TS/y/OWkX7Qa+MUuKA' 6-max Seat #2 is the button
Seat 1: JFIAqU8lCZ0vWwEl4bdGsg ($26.05 in chips) 
Seat 2: buyjetgNT1McXtdaP4zynA ($20.15 in chips) 
Seat 3: o08wk0F4gROLhZS04Iyl3w ($26.45 in chips) 
Seat 4: SS/yfeArhULzIcOPe8MdPg ($28.35 in chips) 
Seat 5: I1TxPvWj8NfG8orglCinNA ($39.40 in chips) 
Seat 6: oseFhpinoe+Zg4j5xyBjyQ ($55.05 in chips) 
o08wk0F4gROLhZS04Iyl3w: posts small blind $0.10
SS/yfeArhULzIcOPe8MdPg: posts big blind $0.25
*** HOLE CARDS ***
I1TxPvWj8NfG8orglCinNA: folds 
oseFhpinoe+Zg4j5xyBjyQ: folds 
JFIAqU8lCZ0vWwEl4bdGsg: raises $0.60 to $0.85
buyjetgNT1McXtdaP4zynA: folds 
o08wk0F4gROLhZS04Iyl3w: folds 
SS/yfeArhULzIcOPe8MdPg: folds 
Uncalled bet ($0.60) returned to JFIAqU8lCZ0vWwEl4bdGsg
JFIAqU8lCZ0vWwEl4bdGsg collected $0.60 from pot
JFIAqU8lCZ0vWwEl4bdGsg: doesn't show hand 
*** SUMMARY ***
Total pot $0.60 | Rake $0 
Seat 1: JFIAqU8lCZ0vWwEl4bdGsg collected ($0.60)
Seat 2: buyjetgNT1McXtdaP4zynA (button) folded before Flop (didn't bet)
Seat 3: o08wk0F4gROLhZS04Iyl3w (small blind) folded before Flop
Seat 4: SS/yfeArhULzIcOPe8MdPg (big blind) folded before Flop
Seat 5: I1TxPvWj8NfG8orglCinNA folded before Flop (didn't bet)
Seat 6: oseFhpinoe+Zg4j5xyBjyQ folded before Flop (didn't bet)




PokerStars Game #59939398680:  Hold'em No Limit ($0.10/$0.25) - 2009/07/01 0:38:51 ET
Table 'NtEQAxCeIK2io1CGtW658g' 6-max Seat #2 is the button
Seat 1: lnOV7k25gyN7L5t5YKTgIg ($20.50 in chips) 
Seat 2: nc79pm0LZRdhncq55evVqA ($25.90 in chips) 
Seat 4: 8296 ($12.10 in chips) 
Seat 5: FStoHe64SQWqAsjya9pDkQ ($27.50 in chips) 
Seat 6: /gJNBeCkWL4o85/jvlZ4BA ($62.35 in chips) 
m2yWOKfAxqHoy5DDN87Ttw joins the table at seat #3 
8296: posts small blind $0.10
FStoHe64SQWqAsjya9pDkQ: posts big blind $0.25
*** HOLE CARDS ***
/gJNBeCkWL4o85/jvlZ4BA: folds 
lnOV7k25gyN7L5t5YKTgIg: folds 
nc79pm0LZRdhncq55evVqA: folds 
8296: folds 
Uncalled bet ($0.15) returned to FStoHe64SQWqAsjya9pDkQ
FStoHe64SQWqAsjya9pDkQ collected $0.20 from pot
*** SUMMARY ***
Total pot $0.20 | Rake $0 
Seat 1: lnOV7k25gyN7L5t5YKTgIg folded before Flop (didn't bet)
Seat 2: nc79pm0LZRdhncq55evVqA (button) folded before Flop (didn't bet)
Seat 4: 8296 (small blind) folded before Flop
Seat 5: FStoHe64SQWqAsjya9pDkQ (big blind) collected ($0.20)
Seat 6: /gJNBeCkWL4o85/jvlZ4BA folded before Flop (didn't bet)




PokerStars Game #59939398922:  Hold'em No Limit ($0.10/$0.25) - 2009/07/01 0:38:52 ET
Table 'IIO2q2znuuAXmiZ2qFTcmg' 6-max Seat #4 is the button
Seat 1: nwwpaieDRI0UPyVtChVHOg ($17.50 in chips) 
Seat 2: cS21pIxRHx5Gt42o7hPZzw ($14.10 in chips) 
Seat 3: hiTEr3yrERiQp3zHXRioVw ($14.75 in chips) 
Seat 4: 0HIrwssk0FQvyKULzUTtlg ($11.25 in chips) 
Seat 5: f9iRHw0d+kV7pbTYwF2+2g ($17.90 in chips) 
f9iRHw0d+kV7pbTYwF2+2g: posts small blind $0.10
nwwpaieDRI0UPyVtChVHOg: posts big blind $0.25
*** HOLE CARDS ***
cS21pIxRHx5Gt42o7hPZzw: raises $0.75 to $1
hiTEr3yrERiQp3zHXRioVw: folds 
0HIrwssk0FQvyKULzUTtlg: folds 
f9iRHw0d+kV7pbTYwF2+2g: folds 
nwwpaieDRI0UPyVtChVHOg: folds 
Uncalled bet ($0.75) returned to cS21pIxRHx5Gt42o7hPZzw
cS21pIxRHx5Gt42o7hPZzw collected $0.60 from pot
*** SUMMARY ***
Total pot $0.60 | Rake $0 
Seat 1: nwwpaieDRI0UPyVtChVHOg (big blind) folded before Flop
Seat 2: cS21pIxRHx5Gt42o7hPZzw collected ($0.60)
Seat 3: hiTEr3yrERiQp3zHXRioVw folded before Flop (didn't bet)
Seat 4: 0HIrwssk0FQvyKULzUTtlg (button) folded before Flop (didn't bet)
Seat 5: f9iRHw0d+kV7pbTYwF2+2g (small blind) folded before Flop




PokerStars Game #59939399152:  Hold'em No Limit ($0.10/$0.25) - 2009/07/01 0:38:52 ET
Table 'WjNvuuSgTjm8jh0j9vcCgQ' 9-max Seat #7 is the button
Seat 3: 8B/dhbQjIWe6ASCdgzktNQ ($25 in chips) 
Seat 4: 3PjJjazzeHcM4mbFeXmZBg ($20.20 in chips) 
Seat 5: Qi+clOtyDiibLdH2/1Qy8g ($18.10 in chips) 
Seat 6: GvhQYMvt1tDska5vKhXkFA ($30.10 in chips) 
Seat 7: DdPXdieucQ+n99u1n3A+rQ ($4.65 in chips) 
Seat 8: ghNKXUBl/H+t83JF079ZBA ($25 in chips) 
Seat 9: DiSvPC2iudwL5j9u6Huyww ($29.70 in chips) 
ghNKXUBl/H+t83JF079ZBA: posts small blind $0.10
DiSvPC2iudwL5j9u6Huyww: posts big blind $0.25
NKymidkL3Kg3ILZPvtLSVg: sits out 
9gmYYQesalMrUjaF7nKfrQ: sits out 
*** HOLE CARDS ***
8B/dhbQjIWe6ASCdgzktNQ: folds 
3PjJjazzeHcM4mbFeXmZBg: folds 
Qi+clOtyDiibLdH2/1Qy8g: folds 
GvhQYMvt1tDska5vKhXkFA: folds 
DdPXdieucQ+n99u1n3A+rQ: folds 
ghNKXUBl/H+t83JF079ZBA: folds 
Uncalled bet ($0.15) returned to DiSvPC2iudwL5j9u6Huyww
DiSvPC2iudwL5j9u6Huyww collected $0.20 from pot
GvhQYMvt1tDska5vKhXkFA leaves the table
DiSvPC2iudwL5j9u6Huyww: doesn't show hand 
*** SUMMARY ***
Total pot $0.20 | Rake $0 
Seat 3: 8B/dhbQjIWe6ASCdgzktNQ folded before Flop (didn't bet)
Seat 4: 3PjJjazzeHcM4mbFeXmZBg folded before Flop (didn't bet)
Seat 5: Qi+clOtyDiibLdH2/1Qy8g folded before Flop (didn't bet)
Seat 6: GvhQYMvt1tDska5vKhXkFA folded before Flop (didn't bet)
Seat 7: DdPXdieucQ+n99u1n3A+rQ (button) folded before Flop (didn't bet)
Seat 8: ghNKXUBl/H+t83JF079ZBA (small blind) folded before Flop
Seat 9: DiSvPC2iudwL5j9u6Huyww (big blind) collected ($0.20)




PokerStars Game #59939399344:  Hold'em No Limit ($0.10/$0.25) - 2009/07/01 0:38:52 ET
Table '3KDMdm1sfxFsNKkjc/PnBg' 9-max Seat #4 is the button
Seat 1: GQTWTgG7Ydy9q/vohVnKmQ ($24 in chips) 
Seat 2: rUpvA02nErFvZ4yFbDR8XA ($20.35 in chips) 
Seat 3: GftT+l+xjKzcY0rMiNZfPg ($28.05 in chips) 
Seat 4: 4xnojP+j2Tm8s9Bh7QC5+Q ($10.70 in chips) 
Seat 5: +2kMBNpY4nF1qNCRd8SJLA ($25 in chips) 
Seat 6: N1HHRe1nNMukTQB6qMn6Kw ($17.15 in chips) 
Seat 7: gehe91e0IyVT0QU/XBkEyg ($25 in chips) 
Seat 8: st9jtdNbm1W5GfBwRaCVqQ ($27.40 in chips) 
+2kMBNpY4nF1qNCRd8SJLA: posts small blind $0.10
N1HHRe1nNMukTQB6qMn6Kw: posts big blind $0.25
GQTWTgG7Ydy9q/vohVnKmQ: posts big blind $0.25
*** HOLE CARDS ***
gehe91e0IyVT0QU/XBkEyg: calls $0.25
st9jtdNbm1W5GfBwRaCVqQ: folds 
GQTWTgG7Ydy9q/vohVnKmQ: checks 
rUpvA02nErFvZ4yFbDR8XA: folds 
GftT+l+xjKzcY0rMiNZfPg: raises $0.50 to $0.75
4xnojP+j2Tm8s9Bh7QC5+Q: calls $0.75
+2kMBNpY4nF1qNCRd8SJLA: folds 
N1HHRe1nNMukTQB6qMn6Kw: folds 
gehe91e0IyVT0QU/XBkEyg: calls $0.50
GQTWTgG7Ydy9q/vohVnKmQ: folds 
*** FLOP *** [3d 2h Ks]
gehe91e0IyVT0QU/XBkEyg: checks 
GftT+l+xjKzcY0rMiNZfPg: checks 
4xnojP+j2Tm8s9Bh7QC5+Q: bets $2
gehe91e0IyVT0QU/XBkEyg: folds 
GftT+l+xjKzcY0rMiNZfPg: folds 
Uncalled bet ($2) returned to 4xnojP+j2Tm8s9Bh7QC5+Q
4xnojP+j2Tm8s9Bh7QC5+Q collected $2.75 from pot
4xnojP+j2Tm8s9Bh7QC5+Q: doesn't show hand 
*** SUMMARY ***
Total pot $2.85 | Rake $0.10 
Board [3d 2h Ks]
Seat 1: GQTWTgG7Ydy9q/vohVnKmQ folded before Flop
Seat 2: rUpvA02nErFvZ4yFbDR8XA folded before Flop (didn't bet)
Seat 3: GftT+l+xjKzcY0rMiNZfPg folded on the Flop
Seat 4: 4xnojP+j2Tm8s9Bh7QC5+Q (button) collected ($2.75)
Seat 5: +2kMBNpY4nF1qNCRd8SJLA (small blind) folded before Flop
Seat 6: N1HHRe1nNMukTQB6qMn6Kw (big blind) folded before Flop
Seat 7: gehe91e0IyVT0QU/XBkEyg folded on the Flop
Seat 8: st9jtdNbm1W5GfBwRaCVqQ folded before Flop (didn't bet)




PokerStars Game #59939399462:  Hold'em No Limit ($0.10/$0.25) - 2009/07/01 0:38:52 ET
Table 'h02LhQ7B/Zk4ETRxxHhGYA' 9-max Seat #1 is the button
Seat 1: sD+TKtt36XiiN6jqHiLwDA ($24.65 in chips) 
Seat 2: RJ/x9oZtt1RZLaJEQwZOxQ ($28.05 in chips) 
Seat 4: tYsOBqdU1+x+yFI7zHO7hQ ($38.55 in chips) 
Seat 5: cUxk0Jk4lrUQv9CJl0LPlg ($16.95 in chips) 
Seat 6: kN/irnQSdb8jibbN4f1O+Q ($16.90 in chips) 
Seat 7: rUpvA02nErFvZ4yFbDR8XA ($19.45 in chips) 
Seat 8: 7tW694tRVJnYdoa16Dw4RQ ($25.45 in chips) 
Seat 9: 1c/7DHPx5CDTmAfk8/bWeA ($14.30 in chips) 
RJ/x9oZtt1RZLaJEQwZOxQ: posts small blind $0.10
JxpnpCmvRAcrEUy7mq1iAg: is sitting out 
tYsOBqdU1+x+yFI7zHO7hQ: posts big blind $0.25
*** HOLE CARDS ***
cUxk0Jk4lrUQv9CJl0LPlg: folds 
kN/irnQSdb8jibbN4f1O+Q: calls $0.25
JxpnpCmvRAcrEUy7mq1iAg leaves the table
rUpvA02nErFvZ4yFbDR8XA: folds 
7tW694tRVJnYdoa16Dw4RQ: folds 
1c/7DHPx5CDTmAfk8/bWeA: folds 
sD+TKtt36XiiN6jqHiLwDA: raises $0.75 to $1
RJ/x9oZtt1RZLaJEQwZOxQ: folds 
tYsOBqdU1+x+yFI7zHO7hQ: folds 
kN/irnQSdb8jibbN4f1O+Q: calls $0.75
*** FLOP *** [Tc Th 7h]
kN/irnQSdb8jibbN4f1O+Q: checks 
sD+TKtt36XiiN6jqHiLwDA: checks 
*** TURN *** [Tc Th 7h] [6c]
kN/irnQSdb8jibbN4f1O+Q: checks 
sD+TKtt36XiiN6jqHiLwDA: bets $1.25
kN/irnQSdb8jibbN4f1O+Q: calls $1.25
*** RIVER *** [Tc Th 7h 6c] [2c]
kN/irnQSdb8jibbN4f1O+Q: checks 
sD+TKtt36XiiN6jqHiLwDA: checks 
*** SHOW DOWN ***
kN/irnQSdb8jibbN4f1O+Q: shows [3d 3s] (two pair, Tens and Threes)
sD+TKtt36XiiN6jqHiLwDA: mucks hand 
kN/irnQSdb8jibbN4f1O+Q collected $4.65 from pot
*** SUMMARY ***
Total pot $4.85 | Rake $0.20 
Board [Tc Th 7h 6c 2c]
Seat 1: sD+TKtt36XiiN6jqHiLwDA (button) mucked
Seat 2: RJ/x9oZtt1RZLaJEQwZOxQ (small blind) folded before Flop
Seat 4: tYsOBqdU1+x+yFI7zHO7hQ (big blind) folded before Flop
Seat 5: cUxk0Jk4lrUQv9CJl0LPlg folded before Flop (didn't bet)
Seat 6: kN/irnQSdb8jibbN4f1O+Q showed [3d 3s] and won ($4.65) with two pair, Tens and Threes
Seat 7: rUpvA02nErFvZ4yFbDR8XA folded before Flop (didn't bet)
Seat 8: 7tW694tRVJnYdoa16Dw4RQ folded before Flop (didn't bet)
Seat 9: 1c/7DHPx5CDTmAfk8/bWeA folded before Flop (didn't bet)




PokerStars Game #59939399282:  Hold'em No Limit ($0.10/$0.25) - 2009/07/01 0:38:52 ET
Table 'S6s+TmTlAjLHclBRvN5/fw' 9-max Seat #7 is the button
Seat 1: /XMgGtJ7mcWfe5s7McY9kw ($24.65 in chips) 
Seat 2: GGVjFwYkbwsuyKljxyML4g ($12.50 in chips) 
Seat 3: imHPFFqvfHGzsBBWeGuy4w ($20.95 in chips) 
Seat 4: M/9j4wkHH9i1JM51vgi1VA ($38.95 in chips) 
Seat 5: z5GxcHlYz/GSz6W2uFiTtg ($25 in chips) 
Seat 6: aNpwfA31EREwO+ar4XzBCw ($25.20 in chips) 
Seat 7: vSkQm2EelzwRGDDQQk0Fqw ($5.65 in chips) 
Seat 9: BODayQmPi2rEfae9e6hIlw ($28.10 in chips) 
BODayQmPi2rEfae9e6hIlw: posts small blind $0.10
/XMgGtJ7mcWfe5s7McY9kw: posts big blind $0.25
*** HOLE CARDS ***
GGVjFwYkbwsuyKljxyML4g: folds 
imHPFFqvfHGzsBBWeGuy4w: folds 
M/9j4wkHH9i1JM51vgi1VA: folds 
z5GxcHlYz/GSz6W2uFiTtg: calls $0.25
aNpwfA31EREwO+ar4XzBCw: folds 
vSkQm2EelzwRGDDQQk0Fqw: folds 
BODayQmPi2rEfae9e6hIlw: folds 
/XMgGtJ7mcWfe5s7McY9kw: checks 
*** FLOP *** [Kd Td Kh]
/XMgGtJ7mcWfe5s7McY9kw: checks 
z5GxcHlYz/GSz6W2uFiTtg: checks 
*** TURN *** [Kd Td Kh] [Qd]
/XMgGtJ7mcWfe5s7McY9kw: checks 
z5GxcHlYz/GSz6W2uFiTtg: checks 
*** RIVER *** [Kd Td Kh Qd] [Th]
/XMgGtJ7mcWfe5s7McY9kw: checks 
z5GxcHlYz/GSz6W2uFiTtg: checks 
*** SHOW DOWN ***
/XMgGtJ7mcWfe5s7McY9kw: shows [5h 3s] (two pair, Kings and Tens)
z5GxcHlYz/GSz6W2uFiTtg: shows [7s 8d] (two pair, Kings and Tens)
/XMgGtJ7mcWfe5s7McY9kw collected $0.30 from pot
z5GxcHlYz/GSz6W2uFiTtg collected $0.30 from pot
*** SUMMARY ***
Total pot $0.60 | Rake $0 
Board [Kd Td Kh Qd Th]
Seat 1: /XMgGtJ7mcWfe5s7McY9kw (big blind) showed [5h 3s] and won ($0.30) with two pair, Kings and Tens
Seat 2: GGVjFwYkbwsuyKljxyML4g folded before Flop (didn't bet)
Seat 3: imHPFFqvfHGzsBBWeGuy4w folded before Flop (didn't bet)
Seat 4: M/9j4wkHH9i1JM51vgi1VA folded before Flop (didn't bet)
Seat 5: z5GxcHlYz/GSz6W2uFiTtg showed [7s 8d] and won ($0.30) with two pair, Kings and Tens
Seat 6: aNpwfA31EREwO+ar4XzBCw folded before Flop (didn't bet)
Seat 7: vSkQm2EelzwRGDDQQk0Fqw (button) folded before Flop (didn't bet)
Seat 9: BODayQmPi2rEfae9e6hIlw (small blind) folded before Flop




PokerStars Game #59939398986:  Hold'em No Limit ($0.10/$0.25) - 2009/07/01 0:38:52 ET
Table 'VuY5ej47Cy8nOI3Wogmhzw' 6-max Seat #3 is the button
Seat 1: PUTXJX6bVODW3ITgBX0GuQ ($15.10 in chips) 
Seat 3: 0n9nsjvz4GIG4IyVHT0JVw ($6.60 in chips) 
Seat 4: FC6tJ9EOiutXO8hnpR4VgQ ($2.80 in chips) 
Seat 6: +v0nBUereMsRzYp2Knh/cQ ($10.55 in chips) 
FC6tJ9EOiutXO8hnpR4VgQ: posts small blind $0.10
+v0nBUereMsRzYp2Knh/cQ: posts big blind $0.25
*** HOLE CARDS ***
PUTXJX6bVODW3ITgBX0GuQ: folds 
0n9nsjvz4GIG4IyVHT0JVw: calls $0.25
FC6tJ9EOiutXO8hnpR4VgQ: raises $0.75 to $1
+v0nBUereMsRzYp2Knh/cQ: folds 
0n9nsjvz4GIG4IyVHT0JVw: calls $0.75
*** FLOP *** [Th Kd 3h]
FC6tJ9EOiutXO8hnpR4VgQ: bets $1.80 and is all-in
0n9nsjvz4GIG4IyVHT0JVw: folds 
Uncalled bet ($1.80) returned to FC6tJ9EOiutXO8hnpR4VgQ
FC6tJ9EOiutXO8hnpR4VgQ collected $2.15 from pot
*** SUMMARY ***
Total pot $2.25 | Rake $0.10 
Board [Th Kd 3h]
Seat 1: PUTXJX6bVODW3ITgBX0GuQ folded before Flop (didn't bet)
Seat 3: 0n9nsjvz4GIG4IyVHT0JVw (button) folded on the Flop
Seat 4: FC6tJ9EOiutXO8hnpR4VgQ (small blind) collected ($2.15)
Seat 6: +v0nBUereMsRzYp2Knh/cQ (big blind) folded before Flop




PokerStars Game #59939399700:  Hold'em No Limit ($0.10/$0.25) - 2009/07/01 0:38:53 ET
Table 'SkaFM7xfUr/Nd+JFPb7f2w' 9-max Seat #2 is the button
Seat 2: QEbIGci+itdw+re8RM5fZA ($28.30 in chips) 
Seat 3: 4oA316mXLIui1QY63GXBUg ($25 in chips) 
Seat 4: DIBbjEYGs+TVdVgEB/4+3w ($39.20 in chips) 
Seat 5: GftT+l+xjKzcY0rMiNZfPg ($10.55 in chips) 
Seat 6: PskTLlFIRHSp61inskRzVg ($7.10 in chips) 
Seat 7: 7wo6Sr7QG3Zo6BaBDV1BOw ($5 in chips) 
Seat 8: Lro4e37x4FUa5P3yzDjskw ($10.85 in chips) 
Seat 9: STkR8XvpjNv79OOMhrlh2w ($59.45 in chips) 
4oA316mXLIui1QY63GXBUg: posts small blind $0.10
DIBbjEYGs+TVdVgEB/4+3w: posts big blind $0.25
*** HOLE CARDS ***
GftT+l+xjKzcY0rMiNZfPg: folds 
Apinooso joins the table at seat #1 
PskTLlFIRHSp61inskRzVg has timed out
PskTLlFIRHSp61inskRzVg: folds 
PskTLlFIRHSp61inskRzVg is sitting out
7wo6Sr7QG3Zo6BaBDV1BOw: folds 
Lro4e37x4FUa5P3yzDjskw: folds 
STkR8XvpjNv79OOMhrlh2w: folds 
QEbIGci+itdw+re8RM5fZA: folds 
4oA316mXLIui1QY63GXBUg: folds 
Uncalled bet ($0.15) returned to DIBbjEYGs+TVdVgEB/4+3w
DIBbjEYGs+TVdVgEB/4+3w collected $0.20 from pot
*** SUMMARY ***
Total pot $0.20 | Rake $0 
Seat 2: QEbIGci+itdw+re8RM5fZA (button) folded before Flop (didn't bet)
Seat 3: 4oA316mXLIui1QY63GXBUg (small blind) folded before Flop
Seat 4: DIBbjEYGs+TVdVgEB/4+3w (big blind) collected ($0.20)
Seat 5: GftT+l+xjKzcY0rMiNZfPg folded before Flop (didn't bet)
Seat 6: PskTLlFIRHSp61inskRzVg folded before Flop (didn't bet)
Seat 7: 7wo6Sr7QG3Zo6BaBDV1BOw folded before Flop (didn't bet)
Seat 8: Lro4e37x4FUa5P3yzDjskw folded before Flop (didn't bet)
Seat 9: STkR8XvpjNv79OOMhrlh2w folded before Flop (didn't bet)




PokerStars Game #59939399738:  Hold'em No Limit ($0.10/$0.25) - 2009/07/01 0:38:53 ET
Table 'nc6OeGk/wtaWV+6N+kgnZQ' 6-max Seat #6 is the button
Seat 1: 0/FYfBoKhINaqU/H5OSS1A ($5.95 in chips) 
Seat 6: yJgjVkWgiJ8vdWZjcUod2A ($4 in chips) 
yJgjVkWgiJ8vdWZjcUod2A: posts small blind $0.10
0/FYfBoKhINaqU/H5OSS1A: posts big blind $0.25
*** HOLE CARDS ***
yJgjVkWgiJ8vdWZjcUod2A: raises $0.50 to $0.75
0/FYfBoKhINaqU/H5OSS1A: folds 
Uncalled bet ($0.50) returned to yJgjVkWgiJ8vdWZjcUod2A
yJgjVkWgiJ8vdWZjcUod2A collected $0.50 from pot
yJgjVkWgiJ8vdWZjcUod2A: doesn't show hand 
*** SUMMARY ***
Total pot $0.50 | Rake $0 
Seat 1: 0/FYfBoKhINaqU/H5OSS1A (big blind) folded before Flop
Seat 6: yJgjVkWgiJ8vdWZjcUod2A (button) (small blind) collected ($0.50)




PokerStars Game #59939399616:  Hold'em No Limit ($0.10/$0.25) - 2009/07/01 0:38:53 ET
Table '3EebBlzq5yHSY2444L4zlg' 9-max Seat #8 is the button
Seat 1: 8B/dhbQjIWe6ASCdgzktNQ ($33.45 in chips) 
Seat 2: MIVCHqCqqlke0Lb0z7glcw ($25.60 in chips) 
Seat 3: IGbD5vKNhHe60dkdbjg/mw ($29.10 in chips) 
Seat 4: 1S/fpm+f42V/6MNZre+ccg ($25.45 in chips) 
Seat 5: 22Ph+hChb2fjC5+yk/mOew ($14.75 in chips) 
Seat 6: QEbIGci+itdw+re8RM5fZA ($28.15 in chips) 
Seat 7: DiSvPC2iudwL5j9u6Huyww ($28.90 in chips) 
Seat 8: Qi+clOtyDiibLdH2/1Qy8g ($27.85 in chips) 
Seat 9: GTcLfsDTPqgfHyhY9FNDMw ($10.30 in chips) 
GTcLfsDTPqgfHyhY9FNDMw: posts small blind $0.10
8B/dhbQjIWe6ASCdgzktNQ: posts big blind $0.25
*** HOLE CARDS ***
MIVCHqCqqlke0Lb0z7glcw: calls $0.25
IGbD5vKNhHe60dkdbjg/mw: calls $0.25
1S/fpm+f42V/6MNZre+ccg: folds 
22Ph+hChb2fjC5+yk/mOew: folds 
QEbIGci+itdw+re8RM5fZA: folds 
DiSvPC2iudwL5j9u6Huyww: folds 
Qi+clOtyDiibLdH2/1Qy8g: folds 
GTcLfsDTPqgfHyhY9FNDMw: calls $0.15
8B/dhbQjIWe6ASCdgzktNQ: checks 
*** FLOP *** [Kh 5s 8d]
GTcLfsDTPqgfHyhY9FNDMw: checks 
8B/dhbQjIWe6ASCdgzktNQ: bets $1
MIVCHqCqqlke0Lb0z7glcw: folds 
IGbD5vKNhHe60dkdbjg/mw: calls $1
GTcLfsDTPqgfHyhY9FNDMw: folds 
*** TURN *** [Kh 5s 8d] [6h]
8B/dhbQjIWe6ASCdgzktNQ: bets $2.50
IGbD5vKNhHe60dkdbjg/mw: calls $2.50
*** RIVER *** [Kh 5s 8d 6h] [Jd]
8B/dhbQjIWe6ASCdgzktNQ: bets $6
IGbD5vKNhHe60dkdbjg/mw: folds 
Uncalled bet ($6) returned to 8B/dhbQjIWe6ASCdgzktNQ
8B/dhbQjIWe6ASCdgzktNQ collected $7.65 from pot
8B/dhbQjIWe6ASCdgzktNQ: doesn't show hand 
*** SUMMARY ***
Total pot $8 | Rake $0.35 
Board [Kh 5s 8d 6h Jd]
Seat 1: 8B/dhbQjIWe6ASCdgzktNQ (big blind) collected ($7.65)
Seat 2: MIVCHqCqqlke0Lb0z7glcw folded on the Flop
Seat 3: IGbD5vKNhHe60dkdbjg/mw folded on the River
Seat 4: 1S/fpm+f42V/6MNZre+ccg folded before Flop (didn't bet)
Seat 5: 22Ph+hChb2fjC5+yk/mOew folded before Flop (didn't bet)
Seat 6: QEbIGci+itdw+re8RM5fZA folded before Flop (didn't bet)
Seat 7: DiSvPC2iudwL5j9u6Huyww folded before Flop (didn't bet)
Seat 8: Qi+clOtyDiibLdH2/1Qy8g (button) folded before Flop (didn't bet)
Seat 9: GTcLfsDTPqgfHyhY9FNDMw (small blind) folded on the Flop




PokerStars Game #59939400172:  Hold'em No Limit ($0.10/$0.25) - 2009/07/01 0:38:54 ET
Table 'ktio12Pyq06LsrFhIorSqA' 9-max Seat #2 is the button
Seat 1: QsLvCwfSWqP+CfjwUnjpXQ ($30.75 in chips) 
Seat 2: sX4bSd399rlGD2VqB7dh2Q ($8.70 in chips) 
Seat 3: 21oaELqROjaQrGRMDGa8pQ ($15.50 in chips) 
Seat 4: VzYduLriCNmLWxnPG/bmHA ($3.50 in chips) 
Seat 5: u5FxT1XSXMItxD9DAQOsoQ ($38.15 in chips) 
Seat 6: jQL6XIewylQ8MmZhhq2YFg ($39.25 in chips) 
Seat 7: XGCfQsxa6PfAg3kJtzUmww ($24.65 in chips) 
Seat 8: Z5y2J55JmfLYR6/DPAGHwQ ($13.30 in chips) 
Seat 9: 2Gn4w2tIKlLbK/3nwIeRYA ($7.50 in chips) 
21oaELqROjaQrGRMDGa8pQ: posts small blind $0.10
VzYduLriCNmLWxnPG/bmHA: posts big blind $0.25
*** HOLE CARDS ***
u5FxT1XSXMItxD9DAQOsoQ: folds 
jQL6XIewylQ8MmZhhq2YFg: folds 
XGCfQsxa6PfAg3kJtzUmww: calls $0.25
Z5y2J55JmfLYR6/DPAGHwQ: calls $0.25
2Gn4w2tIKlLbK/3nwIeRYA: folds 
QsLvCwfSWqP+CfjwUnjpXQ: folds 
QsLvCwfSWqP+CfjwUnjpXQ leaves the table
sX4bSd399rlGD2VqB7dh2Q: calls $0.25
21oaELqROjaQrGRMDGa8pQ: calls $0.15
VzYduLriCNmLWxnPG/bmHA: raises $0.25 to $0.50
XGCfQsxa6PfAg3kJtzUmww: calls $0.25
DerBendero joins the table at seat #1 
Z5y2J55JmfLYR6/DPAGHwQ: raises $1.50 to $2
sX4bSd399rlGD2VqB7dh2Q: folds 
21oaELqROjaQrGRMDGa8pQ: folds 
VzYduLriCNmLWxnPG/bmHA: raises $1.50 to $3.50 and is all-in
XGCfQsxa6PfAg3kJtzUmww: folds 
Z5y2J55JmfLYR6/DPAGHwQ: calls $1.50
*** FLOP *** [6c Ks Qd]
*** TURN *** [6c Ks Qd] [9d]
*** RIVER *** [6c Ks Qd 9d] [Tc]
*** SHOW DOWN ***
VzYduLriCNmLWxnPG/bmHA: shows [Ah Qh] (a pair of Queens)
Z5y2J55JmfLYR6/DPAGHwQ: shows [Jd Kd] (a straight, Nine to King)
Z5y2J55JmfLYR6/DPAGHwQ collected $7.60 from pot
*** SUMMARY ***
Total pot $8 | Rake $0.40 
Board [6c Ks Qd 9d Tc]
Seat 1: QsLvCwfSWqP+CfjwUnjpXQ folded before Flop (didn't bet)
Seat 2: sX4bSd399rlGD2VqB7dh2Q (button) folded before Flop
Seat 3: 21oaELqROjaQrGRMDGa8pQ (small blind) folded before Flop
Seat 4: VzYduLriCNmLWxnPG/bmHA (big blind) showed [Ah Qh] and lost with a pair of Queens
Seat 5: u5FxT1XSXMItxD9DAQOsoQ folded before Flop (didn't bet)
Seat 6: jQL6XIewylQ8MmZhhq2YFg folded before Flop (didn't bet)
Seat 7: XGCfQsxa6PfAg3kJtzUmww folded before Flop
Seat 8: Z5y2J55JmfLYR6/DPAGHwQ showed [Jd Kd] and won ($7.60) with a straight, Nine to King
Seat 9: 2Gn4w2tIKlLbK/3nwIeRYA folded before Flop (didn't bet)




PokerStars Game #59939400194:  Hold'em No Limit ($0.10/$0.25) - 2009/07/01 0:38:54 ET
Table 'Y9EhDWuqWWQFM9SelXAj5g' 9-max Seat #3 is the button
Seat 1: zDrucyjVn5aeekNEc3cJrA ($19.70 in chips) 
Seat 2: nEg1b6MIksd/4x5eLY735g ($40.10 in chips) 
Seat 3: CbXUS6Z2rXZxL1AKduNtmQ ($25 in chips) 
Seat 4: 5MgYq10OC5iGoxQFwlJVuw ($15.15 in chips) 
Seat 5: LY5GvFqMlE3xxbG85bDqlw ($8.50 in chips) 
Seat 6: STkR8XvpjNv79OOMhrlh2w ($25 in chips) 
Seat 7: aNpwfA31EREwO+ar4XzBCw ($30.60 in chips) 
Seat 8: XDxyajtqmdag0QPvwcOG7Q ($9.85 in chips) 
Seat 9: K7bAhhMMJ/XcTmGaBZVfFQ ($25.40 in chips) 
5MgYq10OC5iGoxQFwlJVuw: posts small blind $0.10
LY5GvFqMlE3xxbG85bDqlw: posts big blind $0.25
*** HOLE CARDS ***
STkR8XvpjNv79OOMhrlh2w: folds 
aNpwfA31EREwO+ar4XzBCw: folds 
XDxyajtqmdag0QPvwcOG7Q: folds 
K7bAhhMMJ/XcTmGaBZVfFQ: folds 
zDrucyjVn5aeekNEc3cJrA: folds 
nEg1b6MIksd/4x5eLY735g: folds 
CbXUS6Z2rXZxL1AKduNtmQ: folds 
5MgYq10OC5iGoxQFwlJVuw: folds 
Uncalled bet ($0.15) returned to LY5GvFqMlE3xxbG85bDqlw
LY5GvFqMlE3xxbG85bDqlw collected $0.20 from pot
LY5GvFqMlE3xxbG85bDqlw: doesn't show hand 
*** SUMMARY ***
Total pot $0.20 | Rake $0 
Seat 1: zDrucyjVn5aeekNEc3cJrA folded before Flop (didn't bet)
Seat 2: nEg1b6MIksd/4x5eLY735g folded before Flop (didn't bet)
Seat 3: CbXUS6Z2rXZxL1AKduNtmQ (button) folded before Flop (didn't bet)
Seat 4: 5MgYq10OC5iGoxQFwlJVuw (small blind) folded before Flop
Seat 5: LY5GvFqMlE3xxbG85bDqlw (big blind) collected ($0.20)
Seat 6: STkR8XvpjNv79OOMhrlh2w folded before Flop (didn't bet)
Seat 7: aNpwfA31EREwO+ar4XzBCw folded before Flop (didn't bet)
Seat 8: XDxyajtqmdag0QPvwcOG7Q folded before Flop (didn't bet)
Seat 9: K7bAhhMMJ/XcTmGaBZVfFQ folded before Flop (didn't bet)




PokerStars Game #59939400440:  Hold'em No Limit ($0.10/$0.25) - 2009/07/01 0:38:54 ET
Table 'jz4TpuH+ag+0iNe2ZcxckQ' 9-max Seat #8 is the button
Seat 1: xw6ysR8BJ8Nvn+ibEf2G9w ($6 in chips) 
Seat 2: 18G4P1XstjNvItdGUITxgw ($29.80 in chips) 
Seat 3: Z5NNIVvnhb2IJbLcI79WYQ ($3.50 in chips) 
Seat 4: k+2r6di6GXjNpAdrRkW9bA ($63.20 in chips) 
Seat 5: uJlzv9KL7hgCIqIS2ofoaw ($8.80 in chips) 
Seat 6: ymx/m/7IEqTY+OQPano2gg ($10.70 in chips) 
Seat 7: sJNHTWcSlLHRCZ9+YRLLqA ($25 in chips) 
Seat 8: J3kDdqAF7vHwmQ3VsAbsdA ($78.15 in chips) 
Seat 9: 8B/dhbQjIWe6ASCdgzktNQ ($25 in chips) 
8B/dhbQjIWe6ASCdgzktNQ: posts small blind $0.10
xw6ysR8BJ8Nvn+ibEf2G9w: posts big blind $0.25
*** HOLE CARDS ***
18G4P1XstjNvItdGUITxgw: folds 
Z5NNIVvnhb2IJbLcI79WYQ: folds 
k+2r6di6GXjNpAdrRkW9bA: folds 
uJlzv9KL7hgCIqIS2ofoaw: folds 
ymx/m/7IEqTY+OQPano2gg: folds 
sJNHTWcSlLHRCZ9+YRLLqA: folds 
J3kDdqAF7vHwmQ3VsAbsdA: calls $0.25
8B/dhbQjIWe6ASCdgzktNQ: raises $1.25 to $1.50
xw6ysR8BJ8Nvn+ibEf2G9w: calls $1.25
J3kDdqAF7vHwmQ3VsAbsdA: folds 
*** FLOP *** [6c Th 4h]
8B/dhbQjIWe6ASCdgzktNQ: checks 
xw6ysR8BJ8Nvn+ibEf2G9w: checks 
*** TURN *** [6c Th 4h] [4d]
8B/dhbQjIWe6ASCdgzktNQ: checks 
xw6ysR8BJ8Nvn+ibEf2G9w: bets $0.75
8B/dhbQjIWe6ASCdgzktNQ: folds 
Uncalled bet ($0.75) returned to xw6ysR8BJ8Nvn+ibEf2G9w
xw6ysR8BJ8Nvn+ibEf2G9w collected $3.10 from pot
*** SUMMARY ***
Total pot $3.25 | Rake $0.15 
Board [6c Th 4h 4d]
Seat 1: xw6ysR8BJ8Nvn+ibEf2G9w (big blind) collected ($3.10)
Seat 2: 18G4P1XstjNvItdGUITxgw folded before Flop (didn't bet)
Seat 3: Z5NNIVvnhb2IJbLcI79WYQ folded before Flop (didn't bet)
Seat 4: k+2r6di6GXjNpAdrRkW9bA folded before Flop (didn't bet)
Seat 5: uJlzv9KL7hgCIqIS2ofoaw folded before Flop (didn't bet)
Seat 6: ymx/m/7IEqTY+OQPano2gg folded before Flop (didn't bet)
Seat 7: sJNHTWcSlLHRCZ9+YRLLqA folded before Flop (didn't bet)
Seat 8: J3kDdqAF7vHwmQ3VsAbsdA (button) folded before Flop
Seat 9: 8B/dhbQjIWe6ASCdgzktNQ (small blind) folded on the Turn




PokerStars Game #59939400744:  Hold'em No Limit ($0.10/$0.25) - 2009/07/01 0:38:54 ET
Table 'MJ1SB76A4qJrlEa+C5e/8w' 6-max Seat #6 is the button
Seat 2: UA5OsKS3VPaxa7uC8La/kA ($27.60 in chips) 
Seat 3: IrrSNlaIjHnZjG6E7LgmEg ($16.65 in chips) 
Seat 5: eHsmIvAb2JREg4O6hNPnXg ($10 in chips) 
Seat 6: JFIAqU8lCZ0vWwEl4bdGsg ($25 in chips) 
UA5OsKS3VPaxa7uC8La/kA: posts small blind $0.10
IrrSNlaIjHnZjG6E7LgmEg: posts big blind $0.25
6boOPJDTFiEyZD2WdW0kCA: sits out 
*** HOLE CARDS ***
eHsmIvAb2JREg4O6hNPnXg: folds 
JFIAqU8lCZ0vWwEl4bdGsg: folds 
UA5OsKS3VPaxa7uC8La/kA: folds 
Uncalled bet ($0.15) returned to IrrSNlaIjHnZjG6E7LgmEg
IrrSNlaIjHnZjG6E7LgmEg collected $0.20 from pot
*** SUMMARY ***
Total pot $0.20 | Rake $0 
Seat 2: UA5OsKS3VPaxa7uC8La/kA (small blind) folded before Flop
Seat 3: IrrSNlaIjHnZjG6E7LgmEg (big blind) collected ($0.20)
Seat 5: eHsmIvAb2JREg4O6hNPnXg folded before Flop (didn't bet)
Seat 6: JFIAqU8lCZ0vWwEl4bdGsg (button) folded before Flop (didn't bet)




PokerStars Game #59939400476:  Hold'em No Limit ($0.10/$0.25) - 2009/07/01 0:38:54 ET
Table 'Zi9/NqNs3XoL1eWhMCyZyg' 9-max Seat #9 is the button
Seat 2: Th3FldXKQW6hWVVPahaoOQ ($31.15 in chips) 
Seat 3: rUpvA02nErFvZ4yFbDR8XA ($22 in chips) 
Seat 4: D3XCkXRktDfPlSguxwfnRA ($13.35 in chips) 
Seat 5: OiV1PWZ3IkN29JlmCcnTwQ ($4.65 in chips) 
Seat 6: b3P5tPsBbrP+aAO9+Ts/Nw ($37.85 in chips) 
Seat 7: qul+IMROTuFj45eWi2Tpvg ($48.05 in chips) 
Seat 9: tYsOBqdU1+x+yFI7zHO7hQ ($30.75 in chips) 
opOCI2p6kW0tINuVaAqmcQ will be allowed to play after the button
Th3FldXKQW6hWVVPahaoOQ: posts small blind $0.10
rUpvA02nErFvZ4yFbDR8XA: posts big blind $0.25
*** HOLE CARDS ***
D3XCkXRktDfPlSguxwfnRA: folds 
OiV1PWZ3IkN29JlmCcnTwQ: folds 
b3P5tPsBbrP+aAO9+Ts/Nw: folds 
qul+IMROTuFj45eWi2Tpvg: raises $0.50 to $0.75
tYsOBqdU1+x+yFI7zHO7hQ: folds 
Th3FldXKQW6hWVVPahaoOQ: folds 
rUpvA02nErFvZ4yFbDR8XA: folds 
Uncalled bet ($0.50) returned to qul+IMROTuFj45eWi2Tpvg
qul+IMROTuFj45eWi2Tpvg collected $0.60 from pot
*** SUMMARY ***
Total pot $0.60 | Rake $0 
Seat 2: Th3FldXKQW6hWVVPahaoOQ (small blind) folded before Flop
Seat 3: rUpvA02nErFvZ4yFbDR8XA (big blind) folded before Flop
Seat 4: D3XCkXRktDfPlSguxwfnRA folded before Flop (didn't bet)
Seat 5: OiV1PWZ3IkN29JlmCcnTwQ folded before Flop (didn't bet)
Seat 6: b3P5tPsBbrP+aAO9+Ts/Nw folded before Flop (didn't bet)
Seat 7: qul+IMROTuFj45eWi2Tpvg collected ($0.60)
Seat 9: tYsOBqdU1+x+yFI7zHO7hQ (button) folded before Flop (didn't bet)




PokerStars Game #59939400142:  Hold'em No Limit ($0.10/$0.25) - 2009/07/01 0:38:54 ET
Table 'MRfAiS/4JSfnUDlCcZo0wAhfHe8uKeSJMyWAjSdM7ROQx Seat #6 is the button
Seat 2: /gJNBeCkWL4o85/jvlZ4BA ($37.70 in chips) 
Seat 3: FYepjhAvF8ZdVCmqHIy+eQ ($49 in chips) 
Seat 4: Go8clNIDGP3feVvzBDG4pg ($19.75 in chips) 
Seat 5: qccGLncfUaN00Few5HsgYg ($28.25 in chips) 
Seat 6: VaDPspfGS2lnEkaGNrNqfg ($10 in chips) 
32YL2ZEp8NT4JB2RVM9euQ will be allowed to play after the button
/gJNBeCkWL4o85/jvlZ4BA: posts small blind $0.10
FYepjhAvF8ZdVCmqHIy+eQ: posts big blind $0.25
*** HOLE CARDS ***
Go8clNIDGP3feVvzBDG4pg: folds 
qccGLncfUaN00Few5HsgYg: raises $0.50 to $0.75
VaDPspfGS2lnEkaGNrNqfg: folds 
/gJNBeCkWL4o85/jvlZ4BA: folds 
FYepjhAvF8ZdVCmqHIy+eQ: folds 
Uncalled bet ($0.50) returned to qccGLncfUaN00Few5HsgYg
qccGLncfUaN00Few5HsgYg collected $0.60 from pot
*** SUMMARY ***
Total pot $0.60 | Rake $0 
Seat 2: /gJNBeCkWL4o85/jvlZ4BA (small blind) folded before Flop
Seat 3: FYepjhAvF8ZdVCmqHIy+eQ (big blind) folded before Flop
Seat 4: Go8clNIDGP3feVvzBDG4pg folded before Flop (didn't bet)
Seat 5: qccGLncfUaN00Few5HsgYg collected ($0.60)
Seat 6: VaDPspfGS2lnEkaGNrNqfg (button) folded before Flop (didn't bet)




PokerStars Game #59939400208:  Hold'em No Limit ($0.10/$0.25) - 2009/07/01 0:38:54 ET
Table 'Xi38lWH8L2JHRAsKYVX8Qg' 6-max Seat #3 is the button
Seat 1: AqQ7DFpHkgIzTwDu+rClcg ($4.55 in chips) 
Seat 2: YjCHRUY3WJtHMnkcRxvmug ($36.90 in chips) 
Seat 3: hFvl367f+GnfQv2riJlsTA ($11.30 in chips) 
Seat 4: d0J1xuhsynEY81YHwAvJ5g ($25 in chips) 
Seat 6: aogAb4Eienxztk8p2v9VVw ($24.35 in chips) 
d0J1xuhsynEY81YHwAvJ5g: posts small blind $0.10
aogAb4Eienxztk8p2v9VVw: posts big blind $0.25
*** HOLE CARDS ***
AqQ7DFpHkgIzTwDu+rClcg: folds 
79ID/ub1Pt/mDpCprVmOoA joins the table at seat #5 
YjCHRUY3WJtHMnkcRxvmug: calls $0.25
hFvl367f+GnfQv2riJlsTA: folds 
d0J1xuhsynEY81YHwAvJ5g: calls $0.15
aogAb4Eienxztk8p2v9VVw: raises $1.25 to $1.50
YjCHRUY3WJtHMnkcRxvmug: calls $1.25
d0J1xuhsynEY81YHwAvJ5g: calls $1.25
*** FLOP *** [6h Js 6d]
d0J1xuhsynEY81YHwAvJ5g: checks 
aogAb4Eienxztk8p2v9VVw: bets $1.75
YjCHRUY3WJtHMnkcRxvmug: calls $1.75
d0J1xuhsynEY81YHwAvJ5g: folds 
*** TURN *** [6h Js 6d] [8c]
aogAb4Eienxztk8p2v9VVw: checks 
YjCHRUY3WJtHMnkcRxvmug: bets $1
aogAb4Eienxztk8p2v9VVw: folds 
Uncalled bet ($1) returned to YjCHRUY3WJtHMnkcRxvmug
YjCHRUY3WJtHMnkcRxvmug collected $7.65 from pot
*** SUMMARY ***
Total pot $8 | Rake $0.35 
Board [6h Js 6d 8c]
Seat 1: AqQ7DFpHkgIzTwDu+rClcg folded before Flop (didn't bet)
Seat 2: YjCHRUY3WJtHMnkcRxvmug collected ($7.65)
Seat 3: hFvl367f+GnfQv2riJlsTA (button) folded before Flop (didn't bet)
Seat 4: d0J1xuhsynEY81YHwAvJ5g (small blind) folded on the Flop
Seat 6: aogAb4Eienxztk8p2v9VVw (big blind) folded on the Turn




PokerStars Game #59939400622:  Hold'em No Limit ($0.10/$0.25) - 2009/07/01 0:38:54 ET
Table 'gHbubGDeVSkmB4vFiqIN3Q' 6-max Seat #4 is the button
Seat 1: kG34n23qFQA3nzdOJTQ1dA ($26.25 in chips) 
Seat 2: 8LzEWRhg4wk8Jh9CqDhH3Q ($3.40 in chips) 
Seat 4: v+QfkGiuj9bgtuNoVnDO8w ($32.85 in chips) 
wvIIdlbCgePONQwXjx9xzQ will be allowed to play after the button
kG34n23qFQA3nzdOJTQ1dA: posts small blind $0.10
8LzEWRhg4wk8Jh9CqDhH3Q: posts big blind $0.25
*** HOLE CARDS ***
v+QfkGiuj9bgtuNoVnDO8w: folds 
kG34n23qFQA3nzdOJTQ1dA: folds 
Uncalled bet ($0.15) returned to 8LzEWRhg4wk8Jh9CqDhH3Q
8LzEWRhg4wk8Jh9CqDhH3Q collected $0.20 from pot
8LzEWRhg4wk8Jh9CqDhH3Q: doesn't show hand 
*** SUMMARY ***
Total pot $0.20 | Rake $0 
Seat 1: kG34n23qFQA3nzdOJTQ1dA (small blind) folded before Flop
Seat 2: 8LzEWRhg4wk8Jh9CqDhH3Q (big blind) collected ($0.20)
Seat 4: v+QfkGiuj9bgtuNoVnDO8w (button) folded before Flop (didn't bet)




PokerStars Game #59939401348:  Hold'em No Limit ($0.10/$0.25) - 2009/07/01 0:38:55 ET
Table 'ZEXL6Wh4qA4Afx8NnoBBAA' 6-max Seat #6 is the button
Seat 1: qo39V8/pMxxofM2aciLSWQ ($95.20 in chips) 
Seat 4: fZQg9veL7Dd/Z04ZTjC+wQ ($32.40 in chips) 
Seat 6: 3rZnxe2K3O+xcVdF94i8lA ($15.45 in chips) 
qo39V8/pMxxofM2aciLSWQ: posts small blind $0.10
fZQg9veL7Dd/Z04ZTjC+wQ: posts big blind $0.25
*** HOLE CARDS ***
3rZnxe2K3O+xcVdF94i8lA: calls $0.25
qo39V8/pMxxofM2aciLSWQ: folds 
WrLI51S2iMb8GLMB83gGqA joins the table at seat #2 
fZQg9veL7Dd/Z04ZTjC+wQ: checks 
*** FLOP *** [9h Ac As]
fZQg9veL7Dd/Z04ZTjC+wQ: checks 
3rZnxe2K3O+xcVdF94i8lA: checks 
*** TURN *** [9h Ac As] [3d]
fZQg9veL7Dd/Z04ZTjC+wQ: checks 
3rZnxe2K3O+xcVdF94i8lA: bets $0.75
fZQg9veL7Dd/Z04ZTjC+wQ: folds 
Uncalled bet ($0.75) returned to 3rZnxe2K3O+xcVdF94i8lA
3rZnxe2K3O+xcVdF94i8lA collected $0.60 from pot
3rZnxe2K3O+xcVdF94i8lA: doesn't show hand 
*** SUMMARY ***
Total pot $0.60 | Rake $0 
Board [9h Ac As 3d]
Seat 1: qo39V8/pMxxofM2aciLSWQ (small blind) folded before Flop
Seat 4: fZQg9veL7Dd/Z04ZTjC+wQ (big blind) folded on the Turn
Seat 6: 3rZnxe2K3O+xcVdF94i8lA (button) collected ($0.60)




PokerStars Game #59939401116:  Hold'em No Limit ($0.10/$0.25) - 2009/07/01 0:38:55 ET
Table '+198VWQSWBhYQOcizzuBkw' 6-max Seat #6 is the button
Seat 2: R6AGToFJQOYVZAjC2jXEKw ($29.15 in chips) 
Seat 3: BYxjLnV1/LL0aZcTbfAOvw ($27.60 in chips) 
Seat 4: TgDsTeCdLQt8kWbL00ByRA ($27.60 in chips) 
Seat 5: LtASJ9OlkqGrrUKGQlpGAw ($30.30 in chips) 
Seat 6: 7qRk4YH4/k/08LgJSv7rBQ ($30.55 in chips) 
R6AGToFJQOYVZAjC2jXEKw: posts small blind $0.10
BYxjLnV1/LL0aZcTbfAOvw: posts big blind $0.25
*** HOLE CARDS ***
TgDsTeCdLQt8kWbL00ByRA: folds 
LtASJ9OlkqGrrUKGQlpGAw: raises $0.50 to $0.75
7qRk4YH4/k/08LgJSv7rBQ: folds 
R6AGToFJQOYVZAjC2jXEKw: folds 
BYxjLnV1/LL0aZcTbfAOvw: folds 
Uncalled bet ($0.50) returned to LtASJ9OlkqGrrUKGQlpGAw
LtASJ9OlkqGrrUKGQlpGAw collected $0.60 from pot
LtASJ9OlkqGrrUKGQlpGAw: doesn't show hand 
*** SUMMARY ***
Total pot $0.60 | Rake $0 
Seat 2: R6AGToFJQOYVZAjC2jXEKw (small blind) folded before Flop
Seat 3: BYxjLnV1/LL0aZcTbfAOvw (big blind) folded before Flop
Seat 4: TgDsTeCdLQt8kWbL00ByRA folded before Flop (didn't bet)
Seat 5: LtASJ9OlkqGrrUKGQlpGAw collected ($0.60)
Seat 6: 7qRk4YH4/k/08LgJSv7rBQ (button) folded before Flop (didn't bet)




PokerStars Game #59939400914:  Hold'em No Limit ($0.10/$0.25) - 2009/07/01 0:38:55 ET
Table 'DhkrdW2UOy2PfjSW28Kq8w' 6-max Seat #3 is the button
Seat 1: vu2kzHaDtgr6NM7rdq0chA ($25 in chips) 
Seat 2: v+QfkGiuj9bgtuNoVnDO8w ($25 in chips) 
Seat 3: 66a/8+qw1AZLNh63FuclPA ($44.55 in chips) 
Seat 4: I1TxPvWj8NfG8orglCinNA ($26.05 in chips) 
Seat 5: SxIIgwXYLkwd6m3wLyPTCw ($47.85 in chips) 
Seat 6: SS/yfeArhULzIcOPe8MdPg ($25.85 in chips) 
I1TxPvWj8NfG8orglCinNA: posts small blind $0.10
SxIIgwXYLkwd6m3wLyPTCw: posts big blind $0.25
*** HOLE CARDS ***
SS/yfeArhULzIcOPe8MdPg: folds 
vu2kzHaDtgr6NM7rdq0chA: folds 
v+QfkGiuj9bgtuNoVnDO8w: folds 
66a/8+qw1AZLNh63FuclPA: raises $0.50 to $0.75
I1TxPvWj8NfG8orglCinNA: raises $2.50 to $3.25
SxIIgwXYLkwd6m3wLyPTCw: folds 
66a/8+qw1AZLNh63FuclPA: folds 
Uncalled bet ($2.50) returned to I1TxPvWj8NfG8orglCinNA
I1TxPvWj8NfG8orglCinNA collected $1.75 from pot
I1TxPvWj8NfG8orglCinNA: doesn't show hand 
*** SUMMARY ***
Total pot $1.75 | Rake $0 
Seat 1: vu2kzHaDtgr6NM7rdq0chA folded before Flop (didn't bet)
Seat 2: v+QfkGiuj9bgtuNoVnDO8w folded before Flop (didn't bet)
Seat 3: 66a/8+qw1AZLNh63FuclPA (button) folded before Flop
Seat 4: I1TxPvWj8NfG8orglCinNA (small blind) collected ($1.75)
Seat 5: SxIIgwXYLkwd6m3wLyPTCw (big blind) folded before Flop
Seat 6: SS/yfeArhULzIcOPe8MdPg folded before Flop (didn't bet)




PokerStars Game #59939401184:  Hold'em No Limit ($0.10/$0.25) - 2009/07/01 0:38:55 ET
Table 'iHlyuN1lFZ6WTlMBiiMYXAIIO2q2znuuAXmiZ2qFTcmgx Seat #8 is the button
Seat 2: R6nIVAjK7uhK3Hj0f85A+A ($29.45 in chips) 
Seat 3: QGjA4xtpxSpgzm+HC+ps4w ($22.50 in chips) 
Seat 4: z5GxcHlYz/GSz6W2uFiTtg ($24 in chips) 
Seat 5: 6LFELL8V3NTpb0xg7AOyEg ($11.90 in chips) 
Seat 6: M2QO2DxB5Wawg2h8HSpnYA ($11.80 in chips) 
Seat 7: gehe91e0IyVT0QU/XBkEyg ($33.50 in chips) 
Seat 8: TeWJxSETzbXGiYKx0y+dtg ($24.55 in chips) 
Seat 9: PqvgxdSg9z5VmrWpbYuz+g ($25 in chips) 
PqvgxdSg9z5VmrWpbYuz+g: posts small blind $0.10
R6nIVAjK7uhK3Hj0f85A+A: posts big blind $0.25
*** HOLE CARDS ***
QGjA4xtpxSpgzm+HC+ps4w: folds 
z5GxcHlYz/GSz6W2uFiTtg: folds 
6LFELL8V3NTpb0xg7AOyEg: raises $0.25 to $0.50
M2QO2DxB5Wawg2h8HSpnYA: calls $0.50
gehe91e0IyVT0QU/XBkEyg: folds 
TeWJxSETzbXGiYKx0y+dtg: folds 
PqvgxdSg9z5VmrWpbYuz+g: folds 
R6nIVAjK7uhK3Hj0f85A+A: folds 
*** FLOP *** [5h 9h Jh]
6LFELL8V3NTpb0xg7AOyEg: bets $0.50
M2QO2DxB5Wawg2h8HSpnYA: folds 
Uncalled bet ($0.50) returned to 6LFELL8V3NTpb0xg7AOyEg
6LFELL8V3NTpb0xg7AOyEg collected $1.30 from pot
6LFELL8V3NTpb0xg7AOyEg: doesn't show hand 
*** SUMMARY ***
Total pot $1.35 | Rake $0.05 
Board [5h 9h Jh]
Seat 2: R6nIVAjK7uhK3Hj0f85A+A (big blind) folded before Flop
Seat 3: QGjA4xtpxSpgzm+HC+ps4w folded before Flop (didn't bet)
Seat 4: z5GxcHlYz/GSz6W2uFiTtg folded before Flop (didn't bet)
Seat 5: 6LFELL8V3NTpb0xg7AOyEg collected ($1.30)
Seat 6: M2QO2DxB5Wawg2h8HSpnYA folded on the Flop
Seat 7: gehe91e0IyVT0QU/XBkEyg folded before Flop (didn't bet)
Seat 8: TeWJxSETzbXGiYKx0y+dtg (button) folded before Flop (didn't bet)
Seat 9: PqvgxdSg9z5VmrWpbYuz+g (small blind) folded before Flop




PokerStars Game #59939401196:  Hold'em No Limit ($0.10/$0.25) - 2009/07/01 0:38:55 ET
Table 'qInMnOOn7vKcj4bU7zju7g' 9-max Seat #6 is the button
Seat 1: 3PjJjazzeHcM4mbFeXmZBg ($3.55 in chips) 
Seat 2: f/H6PsHRl4W1JyNsEDvPtg ($14.75 in chips) 
Seat 3: zDrucyjVn5aeekNEc3cJrA ($28.15 in chips) 
Seat 4: ZbKV588BRlpe7vF42jT9yg ($9.80 in chips) 
Seat 5: aNpwfA31EREwO+ar4XzBCw ($34.80 in chips) 
Seat 6: r1pFKMwWp74QwhfPWJOAyw ($4.25 in chips) 
Seat 7: 8B/dhbQjIWe6ASCdgzktNQ ($27.45 in chips) 
Seat 9: K7bAhhMMJ/XcTmGaBZVfFQ ($24.25 in chips) 
8B/dhbQjIWe6ASCdgzktNQ: posts small blind $0.10
K7bAhhMMJ/XcTmGaBZVfFQ: posts big blind $0.25
*** HOLE CARDS ***
3PjJjazzeHcM4mbFeXmZBg: folds 
f/H6PsHRl4W1JyNsEDvPtg: folds 
zDrucyjVn5aeekNEc3cJrA: calls $0.25
ZbKV588BRlpe7vF42jT9yg: folds 
aNpwfA31EREwO+ar4XzBCw: folds 
r1pFKMwWp74QwhfPWJOAyw: folds 
8B/dhbQjIWe6ASCdgzktNQ: folds 
K7bAhhMMJ/XcTmGaBZVfFQ: checks 
*** FLOP *** [Js 3h 7d]
K7bAhhMMJ/XcTmGaBZVfFQ: checks 
zDrucyjVn5aeekNEc3cJrA: bets $1
K7bAhhMMJ/XcTmGaBZVfFQ: folds 
Uncalled bet ($1) returned to zDrucyjVn5aeekNEc3cJrA
zDrucyjVn5aeekNEc3cJrA collected $0.60 from pot
*** SUMMARY ***
Total pot $0.60 | Rake $0 
Board [Js 3h 7d]
Seat 1: 3PjJjazzeHcM4mbFeXmZBg folded before Flop (didn't bet)
Seat 2: f/H6PsHRl4W1JyNsEDvPtg folded before Flop (didn't bet)
Seat 3: zDrucyjVn5aeekNEc3cJrA collected ($0.60)
Seat 4: ZbKV588BRlpe7vF42jT9yg folded before Flop (didn't bet)
Seat 5: aNpwfA31EREwO+ar4XzBCw folded before Flop (didn't bet)
Seat 6: r1pFKMwWp74QwhfPWJOAyw (button) folded before Flop (didn't bet)
Seat 7: 8B/dhbQjIWe6ASCdgzktNQ (small blind) folded before Flop
Seat 9: K7bAhhMMJ/XcTmGaBZVfFQ (big blind) folded on the Flop




PokerStars Game #59939401286:  Hold'em No Limit ($0.10/$0.25) - 2009/07/01 0:38:55 ET
Table 'djcjiEGabFQO0MNG6jEeJQ' 9-max Seat #9 is the button
Seat 1: K7bAhhMMJ/XcTmGaBZVfFQ ($23.90 in chips) 
Seat 2: 1K6QGyJP9P9xmRac2fH4OQ ($26.60 in chips) 
Seat 3: 1S/fpm+f42V/6MNZre+ccg ($27.35 in chips) 
Seat 4: Z7GF1yA2ZTKm8gR4H8XDhg ($15.80 in chips) 
Seat 5: cZ99hugmLBj9KhTlc8nCSw ($37.15 in chips) 
Seat 6: aNpwfA31EREwO+ar4XzBCw ($59.55 in chips) 
Seat 7: 56S3mA6Zs3pGR+0p0vUCtg ($30.45 in chips) 
Seat 8: +sbyWwIcFp9kP0bDtMegfQ ($45.35 in chips) 
Seat 9: HPEB+AtKw1+C/cxU0o1ciw ($47.65 in chips) 
K7bAhhMMJ/XcTmGaBZVfFQ: posts small blind $0.10
1K6QGyJP9P9xmRac2fH4OQ: posts big blind $0.25
*** HOLE CARDS ***
1S/fpm+f42V/6MNZre+ccg: folds 
Z7GF1yA2ZTKm8gR4H8XDhg: raises $0.75 to $1
cZ99hugmLBj9KhTlc8nCSw: folds 
aNpwfA31EREwO+ar4XzBCw: folds 
56S3mA6Zs3pGR+0p0vUCtg: folds 
+sbyWwIcFp9kP0bDtMegfQ: folds 
HPEB+AtKw1+C/cxU0o1ciw: folds 
K7bAhhMMJ/XcTmGaBZVfFQ: folds 
1K6QGyJP9P9xmRac2fH4OQ: calls $0.75
*** FLOP *** [Ts As 8h]
1K6QGyJP9P9xmRac2fH4OQ: checks 
Z7GF1yA2ZTKm8gR4H8XDhg: bets $1.25
1K6QGyJP9P9xmRac2fH4OQ: raises $2.25 to $3.50
Z7GF1yA2ZTKm8gR4H8XDhg: calls $2.25
*** TURN *** [Ts As 8h] [9s]
1K6QGyJP9P9xmRac2fH4OQ: bets $6.60
Z7GF1yA2ZTKm8gR4H8XDhg: folds 
Uncalled bet ($6.60) returned to 1K6QGyJP9P9xmRac2fH4OQ
1K6QGyJP9P9xmRac2fH4OQ collected $8.65 from pot
1K6QGyJP9P9xmRac2fH4OQ: doesn't show hand 
*** SUMMARY ***
Total pot $9.10 | Rake $0.45 
Board [Ts As 8h 9s]
Seat 1: K7bAhhMMJ/XcTmGaBZVfFQ (small blind) folded before Flop
Seat 2: 1K6QGyJP9P9xmRac2fH4OQ (big blind) collected ($8.65)
Seat 3: 1S/fpm+f42V/6MNZre+ccg folded before Flop (didn't bet)
Seat 4: Z7GF1yA2ZTKm8gR4H8XDhg folded on the Turn
Seat 5: cZ99hugmLBj9KhTlc8nCSw folded before Flop (didn't bet)
Seat 6: aNpwfA31EREwO+ar4XzBCw folded before Flop (didn't bet)
Seat 7: 56S3mA6Zs3pGR+0p0vUCtg folded before Flop (didn't bet)
Seat 8: +sbyWwIcFp9kP0bDtMegfQ folded before Flop (didn't bet)
Seat 9: HPEB+AtKw1+C/cxU0o1ciw (button) folded before Flop (didn't bet)




PokerStars Game #59939400906:  Hold'em No Limit ($0.10/$0.25) - 2009/07/01 0:38:55 ET
Table 'PCxB2W9H6ma8SwsZlImuOw' 9-max Seat #8 is the button
Seat 1: 5s3p6yoJBNW438dsyKTP8g ($32 in chips) 
Seat 2: wjH6l1gQaEfv+C45sAOwIQ ($32.20 in chips) 
Seat 3: opOCI2p6kW0tINuVaAqmcQ ($29.50 in chips) 
Seat 4: ydoFOVgzvZv9ZhuWu9rXAw ($5 in chips) 
Seat 5: h4ggJZYBXV0mEZzYPYKfeA ($23.95 in chips) 
Seat 6: E2c0EwJuNHUUdumOOgYQYA ($7.30 in chips) 
Seat 7: EfRs3ibIxn+c9JDErwwNCg ($25.10 in chips) 
Seat 8: Hdb9b2QXBH2f6YwkTgMKdQ ($3.90 in chips) 
Seat 9: LWN1wPrLH+695JIriXxDuw ($9.75 in chips) 
LWN1wPrLH+695JIriXxDuw: posts small blind $0.10
5s3p6yoJBNW438dsyKTP8g: posts big blind $0.25
*** HOLE CARDS ***
wjH6l1gQaEfv+C45sAOwIQ: raises $0.75 to $1
opOCI2p6kW0tINuVaAqmcQ: folds 
ydoFOVgzvZv9ZhuWu9rXAw: folds 
h4ggJZYBXV0mEZzYPYKfeA: folds 
E2c0EwJuNHUUdumOOgYQYA: folds 
EfRs3ibIxn+c9JDErwwNCg: folds 
Hdb9b2QXBH2f6YwkTgMKdQ: folds 
LWN1wPrLH+695JIriXxDuw: calls $0.90
5s3p6yoJBNW438dsyKTP8g: calls $0.75
*** FLOP *** [Ah 6s Kc]
LWN1wPrLH+695JIriXxDuw: checks 
5s3p6yoJBNW438dsyKTP8g: checks 
wjH6l1gQaEfv+C45sAOwIQ: bets $1
LWN1wPrLH+695JIriXxDuw: calls $1
5s3p6yoJBNW438dsyKTP8g: folds 
*** TURN *** [Ah 6s Kc] [Ac]
LWN1wPrLH+695JIriXxDuw: checks 
wjH6l1gQaEfv+C45sAOwIQ: bets $1
LWN1wPrLH+695JIriXxDuw: calls $1
*** RIVER *** [Ah 6s Kc Ac] [Tc]
LWN1wPrLH+695JIriXxDuw: checks 
wjH6l1gQaEfv+C45sAOwIQ: bets $2.25
LWN1wPrLH+695JIriXxDuw: calls $2.25
*** SHOW DOWN ***
wjH6l1gQaEfv+C45sAOwIQ: shows [Kd Ad] (a full house, Aces full of Kings)
LWN1wPrLH+695JIriXxDuw: mucks hand 
wjH6l1gQaEfv+C45sAOwIQ collected $10.95 from pot
*** SUMMARY ***
Total pot $11.50 | Rake $0.55 
Board [Ah 6s Kc Ac Tc]
Seat 1: 5s3p6yoJBNW438dsyKTP8g (big blind) folded on the Flop
Seat 2: wjH6l1gQaEfv+C45sAOwIQ showed [Kd Ad] and won ($10.95) with a full house, Aces full of Kings
Seat 3: opOCI2p6kW0tINuVaAqmcQ folded before Flop (didn't bet)
Seat 4: ydoFOVgzvZv9ZhuWu9rXAw folded before Flop (didn't bet)
Seat 5: h4ggJZYBXV0mEZzYPYKfeA folded before Flop (didn't bet)
Seat 6: E2c0EwJuNHUUdumOOgYQYA folded before Flop (didn't bet)
Seat 7: EfRs3ibIxn+c9JDErwwNCg folded before Flop (didn't bet)
Seat 8: Hdb9b2QXBH2f6YwkTgMKdQ (button) folded before Flop (didn't bet)
Seat 9: LWN1wPrLH+695JIriXxDuw (small blind) mucked




PokerStars Game #59939401952:  Hold'em No Limit ($0.10/$0.25) - 2009/07/01 0:38:56 ET
Table 'JJzUs04lHpXg6nboT1/jeg' 6-max Seat #4 is the button
Seat 4: nwwpaieDRI0UPyVtChVHOg ($36.80 in chips) 
Seat 5: Vr2XE7yYBdg3RZSURDAPEg ($23.80 in chips) 
nwwpaieDRI0UPyVtChVHOg: posts small blind $0.10
Vr2XE7yYBdg3RZSURDAPEg: posts big blind $0.25
*** HOLE CARDS ***
nwwpaieDRI0UPyVtChVHOg: folds 
Uncalled bet ($0.15) returned to Vr2XE7yYBdg3RZSURDAPEg
Vr2XE7yYBdg3RZSURDAPEg collected $0.20 from pot
Vr2XE7yYBdg3RZSURDAPEg: doesn't show hand 
uUXdcVMNa05rfbntdvplfw joins the table at seat #3 
*** SUMMARY ***
Total pot $0.20 | Rake $0 
Seat 4: nwwpaieDRI0UPyVtChVHOg (button) (small blind) folded before Flop
Seat 5: Vr2XE7yYBdg3RZSURDAPEg (big blind) collected ($0.20)




PokerStars Game #59939401642:  Hold'em No Limit ($0.10/$0.25) - 2009/07/01 0:38:56 ET
Table 'SbSV5tlgLp0+/Z+13PW3Hg' 9-max Seat #3 is the button
Seat 1: NAP/FpFXsTsBxjDijlVzEg ($43.40 in chips) 
Seat 2: zDrucyjVn5aeekNEc3cJrA ($10.75 in chips) 
Seat 3: s7Q6uNouhe7aE8JdFb9E+A ($25 in chips) 
Seat 4: NNZypfH1f/VIj3Skf/XIzg ($4.75 in chips) 
Seat 5: z5GxcHlYz/GSz6W2uFiTtg ($19.60 in chips) 
Seat 6: qwr38jl5txoR36M7G5qi4A ($8.25 in chips) 
Seat 7: j4q3p0lesp63b1gZDwLBZw ($6.35 in chips) 
Seat 8: 7cv+9Zc9HIQHNvYsMfV3uA ($25.50 in chips) 
Seat 9: rXm4QDVJt67H20lM6n6Z7Q ($18.50 in chips) 
NNZypfH1f/VIj3Skf/XIzg: posts small blind $0.10
z5GxcHlYz/GSz6W2uFiTtg: posts big blind $0.25
*** HOLE CARDS ***
zDrucyjVn5aeekNEc3cJrA said, "lofl lucky u"
qwr38jl5txoR36M7G5qi4A: folds 
j4q3p0lesp63b1gZDwLBZw: folds 
7cv+9Zc9HIQHNvYsMfV3uA: folds 
rXm4QDVJt67H20lM6n6Z7Q: folds 
NAP/FpFXsTsBxjDijlVzEg: folds 
zDrucyjVn5aeekNEc3cJrA: folds 
s7Q6uNouhe7aE8JdFb9E+A: folds 
NNZypfH1f/VIj3Skf/XIzg: folds 
Uncalled bet ($0.15) returned to z5GxcHlYz/GSz6W2uFiTtg
z5GxcHlYz/GSz6W2uFiTtg collected $0.20 from pot
*** SUMMARY ***
Total pot $0.20 | Rake $0 
Seat 1: NAP/FpFXsTsBxjDijlVzEg folded before Flop (didn't bet)
Seat 2: zDrucyjVn5aeekNEc3cJrA folded before Flop (didn't bet)
Seat 3: s7Q6uNouhe7aE8JdFb9E+A (button) folded before Flop (didn't bet)
Seat 4: NNZypfH1f/VIj3Skf/XIzg (small blind) folded before Flop
Seat 5: z5GxcHlYz/GSz6W2uFiTtg (big blind) collected ($0.20)
Seat 6: qwr38jl5txoR36M7G5qi4A folded before Flop (didn't bet)
Seat 7: j4q3p0lesp63b1gZDwLBZw folded before Flop (didn't bet)
Seat 8: 7cv+9Zc9HIQHNvYsMfV3uA folded before Flop (didn't bet)
Seat 9: rXm4QDVJt67H20lM6n6Z7Q folded before Flop (didn't bet)




PokerStars Game #59939401828:  Hold'em No Limit ($0.10/$0.25) - 2009/07/01 0:38:56 ET
Table 'Jz+kWRxWNGk9w24fdQEveA' 9-max Seat #7 is the button
Seat 1: 1K6QGyJP9P9xmRac2fH4OQ ($25.80 in chips) 
Seat 2: ljemhp25Zg+nlA9DLCIiUw ($28.90 in chips) 
Seat 4: HPEB+AtKw1+C/cxU0o1ciw ($24.45 in chips) 
Seat 5: DdPXdieucQ+n99u1n3A+rQ ($5 in chips) 
Seat 6: boms8cM+kQJF0xGLbvuFtg ($10.65 in chips) 
Seat 7: st9jtdNbm1W5GfBwRaCVqQ ($31.35 in chips) 
Seat 8: G7adEXZse2f4gqTWfn/C+Q ($11.55 in chips) 
Seat 9: z7SDvPqXQA6iOv0833Gpig ($12.20 in chips) 
G7adEXZse2f4gqTWfn/C+Q: posts small blind $0.10
z7SDvPqXQA6iOv0833Gpig: posts big blind $0.25
*** HOLE CARDS ***
1K6QGyJP9P9xmRac2fH4OQ: folds 
ljemhp25Zg+nlA9DLCIiUw: folds 
HPEB+AtKw1+C/cxU0o1ciw: folds 
DdPXdieucQ+n99u1n3A+rQ: folds 
boms8cM+kQJF0xGLbvuFtg: calls $0.25
st9jtdNbm1W5GfBwRaCVqQ: folds 
G7adEXZse2f4gqTWfn/C+Q: calls $0.15
z7SDvPqXQA6iOv0833Gpig: checks 
*** FLOP *** [8d Ad 4h]
G7adEXZse2f4gqTWfn/C+Q: checks 
z7SDvPqXQA6iOv0833Gpig: checks 
boms8cM+kQJF0xGLbvuFtg: checks 
*** TURN *** [8d Ad 4h] [8s]
G7adEXZse2f4gqTWfn/C+Q: checks 
z7SDvPqXQA6iOv0833Gpig: bets $0.50
boms8cM+kQJF0xGLbvuFtg: folds 
G7adEXZse2f4gqTWfn/C+Q: folds 
Uncalled bet ($0.50) returned to z7SDvPqXQA6iOv0833Gpig
z7SDvPqXQA6iOv0833Gpig collected $0.75 from pot
z7SDvPqXQA6iOv0833Gpig: doesn't show hand 
*** SUMMARY ***
Total pot $0.75 | Rake $0 
Board [8d Ad 4h 8s]
Seat 1: 1K6QGyJP9P9xmRac2fH4OQ folded before Flop (didn't bet)
Seat 2: ljemhp25Zg+nlA9DLCIiUw folded before Flop (didn't bet)
Seat 4: HPEB+AtKw1+C/cxU0o1ciw folded before Flop (didn't bet)
Seat 5: DdPXdieucQ+n99u1n3A+rQ folded before Flop (didn't bet)
Seat 6: boms8cM+kQJF0xGLbvuFtg folded on the Turn
Seat 7: st9jtdNbm1W5GfBwRaCVqQ (button) folded before Flop (didn't bet)
Seat 8: G7adEXZse2f4gqTWfn/C+Q (small blind) folded on the Turn
Seat 9: z7SDvPqXQA6iOv0833Gpig (big blind) collected ($0.75)




PokerStars Game #59939401752:  Hold'em No Limit ($0.10/$0.25) - 2009/07/01 0:38:56 ET
Table '84TjTrgbsYZladOc4PWf4Q' 6-max Seat #4 is the button
Seat 1: 79ID/ub1Pt/mDpCprVmOoA ($29.65 in chips) 
Seat 2: qGHGf/553gQnDoklMRe3tg ($31.90 in chips) 
Seat 3: BYxjLnV1/LL0aZcTbfAOvw ($37.70 in chips) 
Seat 4: SxIIgwXYLkwd6m3wLyPTCw ($25 in chips) 
Seat 5: SFmT9ZsVopnukjvAzrxTRg ($36.95 in chips) 
Seat 6: 7qRk4YH4/k/08LgJSv7rBQ ($24.35 in chips) 
SFmT9ZsVopnukjvAzrxTRg: posts small blind $0.10
7qRk4YH4/k/08LgJSv7rBQ: posts big blind $0.25
*** HOLE CARDS ***
SFmT9ZsVopnukjvAzrxTRg said, "lol"
SFmT9ZsVopnukjvAzrxTRg said, "nh"
79ID/ub1Pt/mDpCprVmOoA: folds 
qGHGf/553gQnDoklMRe3tg: folds 
BYxjLnV1/LL0aZcTbfAOvw: raises $0.75 to $1
SFmT9ZsVopnukjvAzrxTRg said, "that was weird hand"
SxIIgwXYLkwd6m3wLyPTCw: folds 
SFmT9ZsVopnukjvAzrxTRg: folds 
7qRk4YH4/k/08LgJSv7rBQ: folds 
Uncalled bet ($0.75) returned to BYxjLnV1/LL0aZcTbfAOvw
BYxjLnV1/LL0aZcTbfAOvw collected $0.60 from pot
BYxjLnV1/LL0aZcTbfAOvw: doesn't show hand 
*** SUMMARY ***
Total pot $0.60 | Rake $0 
Seat 1: 79ID/ub1Pt/mDpCprVmOoA folded before Flop (didn't bet)
Seat 2: qGHGf/553gQnDoklMRe3tg folded before Flop (didn't bet)
Seat 3: BYxjLnV1/LL0aZcTbfAOvw collected ($0.60)
Seat 4: SxIIgwXYLkwd6m3wLyPTCw (button) folded before Flop (didn't bet)
Seat 5: SFmT9ZsVopnukjvAzrxTRg (small blind) folded before Flop
Seat 6: 7qRk4YH4/k/08LgJSv7rBQ (big blind) folded before Flop




PokerStars Game #59939401738:  Hold'em No Limit ($0.10/$0.25) - 2009/07/01 0:38:56 ET
Table 'g6ryG70feTw9nNm+XJLuXw' 6-max Seat #1 is the button
Seat 1: v+QfkGiuj9bgtuNoVnDO8w ($28.95 in chips) 
Seat 2: SxIIgwXYLkwd6m3wLyPTCw ($25.35 in chips) 
Seat 3: /6h8PvAHQmfuMUZ8OUF6Xw ($25 in chips) 
Seat 4: GC/9yVD59DUCX7hUI7gcLw ($37.10 in chips) 
Seat 5: EE16Ua5b1HSsYej5zeXOlA ($25.60 in chips) 
SxIIgwXYLkwd6m3wLyPTCw: posts small blind $0.10
/6h8PvAHQmfuMUZ8OUF6Xw: posts big blind $0.25
*** HOLE CARDS ***
GC/9yVD59DUCX7hUI7gcLw: folds 
EE16Ua5b1HSsYej5zeXOlA: folds 
v+QfkGiuj9bgtuNoVnDO8w: folds 
SxIIgwXYLkwd6m3wLyPTCw: folds 
Uncalled bet ($0.15) returned to /6h8PvAHQmfuMUZ8OUF6Xw
/6h8PvAHQmfuMUZ8OUF6Xw collected $0.20 from pot
/6h8PvAHQmfuMUZ8OUF6Xw: doesn't show hand 
*** SUMMARY ***
Total pot $0.20 | Rake $0 
Seat 1: v+QfkGiuj9bgtuNoVnDO8w (button) folded before Flop (didn't bet)
Seat 2: SxIIgwXYLkwd6m3wLyPTCw (small blind) folded before Flop
Seat 3: /6h8PvAHQmfuMUZ8OUF6Xw (big blind) collected ($0.20)
Seat 4: GC/9yVD59DUCX7hUI7gcLw folded before Flop (didn't bet)
Seat 5: EE16Ua5b1HSsYej5zeXOlA folded before Flop (didn't bet)




PokerStars Game #59939402690:  Hold'em No Limit ($0.10/$0.25) - 2009/07/01 0:38:57 ET
Table 'gnrUwXkIPE0C8xl6cB4Hyw' 9-max Seat #1 is the button
Seat 1: M5pvk/9nuNWrklZWei4CKw ($19.70 in chips) 
Seat 2: zVd+j+mjRjWkMTxR5u0Rbw ($6.10 in chips) 
Seat 3: s7Q6uNouhe7aE8JdFb9E+A ($25 in chips) 
Seat 5: UU+SYM9uvNEpASN41+yAdA ($29.15 in chips) 
Seat 6: W4TLQcZ2TiM73eIgpIvlGg ($23.60 in chips) 
Seat 8: oUgIL46CfA9GCdIuN1TVSw ($22 in chips) 
zVd+j+mjRjWkMTxR5u0Rbw: posts small blind $0.10
s7Q6uNouhe7aE8JdFb9E+A: posts big blind $0.25
*** HOLE CARDS ***
UU+SYM9uvNEpASN41+yAdA: folds 
W4TLQcZ2TiM73eIgpIvlGg: folds 
oUgIL46CfA9GCdIuN1TVSw: calls $0.25
UU+SYM9uvNEpASN41+yAdA said, "lol"
M5pvk/9nuNWrklZWei4CKw: calls $0.25
zVd+j+mjRjWkMTxR5u0Rbw: folds 
oUgIL46CfA9GCdIuN1TVSw said, "now say no u have no friends"
UU+SYM9uvNEpASN41+yAdA said, "dont get mad gay boy"
UU+SYM9uvNEpASN41+yAdA said, "its just a game"
hvydiesel joins the table at seat #4 
oUgIL46CfA9GCdIuN1TVSw said, "im not talking about poker wat so ever"
s7Q6uNouhe7aE8JdFb9E+A: checks 
*** FLOP *** [Kd Kc 5h]
Z9AeOQX3yzuSvKAm/xyovg joins the table at seat #7 
oUgIL46CfA9GCdIuN1TVSw said, "if u can comprehend reading"
s7Q6uNouhe7aE8JdFb9E+A: bets $0.60
UU+SYM9uvNEpASN41+yAdA said, "Im taking your money anyway gay boy"
oUgIL46CfA9GCdIuN1TVSw: calls $0.60
M5pvk/9nuNWrklZWei4CKw: folds 
*** TURN *** [Kd Kc 5h] [6c]
M5pvk/9nuNWrklZWei4CKw leaves the table
s7Q6uNouhe7aE8JdFb9E+A: checks 
oUgIL46CfA9GCdIuN1TVSw: checks 
*** RIVER *** [Kd Kc 5h 6c] [7h]
UU+SYM9uvNEpASN41+yAdA said, "lol"
s7Q6uNouhe7aE8JdFb9E+A: checks 
oUgIL46CfA9GCdIuN1TVSw: bets $0.95
UU+SYM9uvNEpASN41+yAdA said, "go all in gay boy"
s7Q6uNouhe7aE8JdFb9E+A: calls $0.95
*** SHOW DOWN ***
oUgIL46CfA9GCdIuN1TVSw: shows [2d Kh] (three of a kind, Kings)
s7Q6uNouhe7aE8JdFb9E+A: mucks hand 
oUgIL46CfA9GCdIuN1TVSw collected $3.80 from pot
*** SUMMARY ***
Total pot $3.95 | Rake $0.15 
Board [Kd Kc 5h 6c 7h]
Seat 1: M5pvk/9nuNWrklZWei4CKw (button) folded on the Flop
Seat 2: zVd+j+mjRjWkMTxR5u0Rbw (small blind) folded before Flop
Seat 3: s7Q6uNouhe7aE8JdFb9E+A (big blind) mucked
Seat 5: UU+SYM9uvNEpASN41+yAdA folded before Flop (didn't bet)
Seat 6: W4TLQcZ2TiM73eIgpIvlGg folded before Flop (didn't bet)
Seat 8: oUgIL46CfA9GCdIuN1TVSw showed [2d Kh] and won ($3.80) with three of a kind, Kings




PokerStars Game #59939402074:  Hold'em No Limit ($0.10/$0.25) - 2009/07/01 0:38:57 ET
Table '9SExUHslNkrPJ4XsrePaVw' 9-max Seat #3 is the button
Seat 1: qpbN+BUWX0f/ckQSmOcmkw ($8.40 in chips) 
Seat 2: ie4EwTMMFYxrCXcenJdzsw ($4.75 in chips) 
Seat 3: jeKWRUkMaVn8rEUjnJKqpg ($25 in chips) 
Seat 4: dyNjB7p93gTjZ0RXn2HnJA ($12.95 in chips) 
Seat 5: FZrgDbxAanC1xwZxXHJKVA ($13.50 in chips) 
Seat 6: DYB0aP91n+Rg/TIhycbaPQ ($14.20 in chips) 
Seat 8: t2nb95S5EEFOEzNx9Itz0g ($8.30 in chips) 
Seat 9: /THNzAxdv2lBxcf4XTj/0g ($15.75 in chips) 
dyNjB7p93gTjZ0RXn2HnJA: posts small blind $0.10
FZrgDbxAanC1xwZxXHJKVA: posts big blind $0.25
7cv+9Zc9HIQHNvYsMfV3uA: sits out 
*** HOLE CARDS ***
DYB0aP91n+Rg/TIhycbaPQ has timed out
DYB0aP91n+Rg/TIhycbaPQ: folds 
DYB0aP91n+Rg/TIhycbaPQ is sitting out
t2nb95S5EEFOEzNx9Itz0g: folds 
/THNzAxdv2lBxcf4XTj/0g: folds 
qpbN+BUWX0f/ckQSmOcmkw: calls $0.25
ie4EwTMMFYxrCXcenJdzsw: raises $1 to $1.25
jeKWRUkMaVn8rEUjnJKqpg: calls $1.25
dyNjB7p93gTjZ0RXn2HnJA: folds 
FZrgDbxAanC1xwZxXHJKVA: folds 
qpbN+BUWX0f/ckQSmOcmkw: calls $1
*** FLOP *** [6d 6h As]
qpbN+BUWX0f/ckQSmOcmkw: checks 
DYB0aP91n+Rg/TIhycbaPQ has returned
ie4EwTMMFYxrCXcenJdzsw: bets $1
jeKWRUkMaVn8rEUjnJKqpg: folds 
qpbN+BUWX0f/ckQSmOcmkw: raises $6.15 to $7.15 and is all-in
ie4EwTMMFYxrCXcenJdzsw: calls $2.50 and is all-in
Uncalled bet ($3.65) returned to qpbN+BUWX0f/ckQSmOcmkw
*** TURN *** [6d 6h As] [2h]
*** RIVER *** [6d 6h As 2h] [Ah]
*** SHOW DOWN ***
qpbN+BUWX0f/ckQSmOcmkw: shows [Ac Jh] (a full house, Aces full of Sixes)
ie4EwTMMFYxrCXcenJdzsw: mucks hand 
qpbN+BUWX0f/ckQSmOcmkw collected $10.60 from pot
*** SUMMARY ***
Total pot $11.10 | Rake $0.50 
Board [6d 6h As 2h Ah]
Seat 1: qpbN+BUWX0f/ckQSmOcmkw showed [Ac Jh] and won ($10.60) with a full house, Aces full of Sixes
Seat 2: ie4EwTMMFYxrCXcenJdzsw mucked
Seat 3: jeKWRUkMaVn8rEUjnJKqpg (button) folded on the Flop
Seat 4: dyNjB7p93gTjZ0RXn2HnJA (small blind) folded before Flop
Seat 5: FZrgDbxAanC1xwZxXHJKVA (big blind) folded before Flop
Seat 6: DYB0aP91n+Rg/TIhycbaPQ folded before Flop (didn't bet)
Seat 8: t2nb95S5EEFOEzNx9Itz0g folded before Flop (didn't bet)
Seat 9: /THNzAxdv2lBxcf4XTj/0g folded before Flop (didn't bet)




PokerStars Game #59939402258:  Hold'em No Limit ($0.10/$0.25) - 2009/07/01 0:38:57 ET
Table '7/qMNloI0nSXWiX5Y1watA' 9-max Seat #8 is the button
Seat 1: lF4l0ujUfJ9uYJOg9Ch9/g ($45.20 in chips) 
Seat 2: 8B/dhbQjIWe6ASCdgzktNQ ($25.75 in chips) 
Seat 3: nEg1b6MIksd/4x5eLY735g ($40.10 in chips) 
Seat 4: 18G4P1XstjNvItdGUITxgw ($25 in chips) 
Seat 5: dfNim92Z6XK1/h5SFW5vDg ($32.85 in chips) 
Seat 6: /rRB5qE14E0X2mwkBd4RUA ($15.25 in chips) 
Seat 7: z5GxcHlYz/GSz6W2uFiTtg ($11.20 in chips) 
Seat 8: ljemhp25Zg+nlA9DLCIiUw ($24.15 in chips) 
aPRz/2GxbXANYpVsQO8pdQ will be allowed to play after the button
lF4l0ujUfJ9uYJOg9Ch9/g: posts small blind $0.10
8B/dhbQjIWe6ASCdgzktNQ: posts big blind $0.25
*** HOLE CARDS ***
nEg1b6MIksd/4x5eLY735g: folds 
18G4P1XstjNvItdGUITxgw: raises $0.50 to $0.75
dfNim92Z6XK1/h5SFW5vDg: folds 
/rRB5qE14E0X2mwkBd4RUA: folds 
z5GxcHlYz/GSz6W2uFiTtg: folds 
ljemhp25Zg+nlA9DLCIiUw: folds 
lF4l0ujUfJ9uYJOg9Ch9/g: folds 
8B/dhbQjIWe6ASCdgzktNQ: folds 
Uncalled bet ($0.50) returned to 18G4P1XstjNvItdGUITxgw
18G4P1XstjNvItdGUITxgw collected $0.60 from pot
18G4P1XstjNvItdGUITxgw: doesn't show hand 
*** SUMMARY ***
Total pot $0.60 | Rake $0 
Seat 1: lF4l0ujUfJ9uYJOg9Ch9/g (small blind) folded before Flop
Seat 2: 8B/dhbQjIWe6ASCdgzktNQ (big blind) folded before Flop
Seat 3: nEg1b6MIksd/4x5eLY735g folded before Flop (didn't bet)
Seat 4: 18G4P1XstjNvItdGUITxgw collected ($0.60)
Seat 5: dfNim92Z6XK1/h5SFW5vDg folded before Flop (didn't bet)
Seat 6: /rRB5qE14E0X2mwkBd4RUA folded before Flop (didn't bet)
Seat 7: z5GxcHlYz/GSz6W2uFiTtg folded before Flop (didn't bet)
Seat 8: ljemhp25Zg+nlA9DLCIiUw (button) folded before Flop (didn't bet)




PokerStars Game #59939402708:  Hold'em No Limit ($0.10/$0.25) - 2009/07/01 0:38:57 ET
Table '3eK1r4Q4BSYFvsKkuTLpIA' 9-max Seat #9 is the button
Seat 1: qwr38jl5txoR36M7G5qi4A ($7.85 in chips) 
Seat 2: 7QzbjWT00wQpau1iqvUmMA ($5 in chips) 
Seat 3: 56S3mA6Zs3pGR+0p0vUCtg ($33.55 in chips) 
Seat 4: S2iyN4Q7njjhguIuE5g1CQ ($23.20 in chips) 
Seat 5: 1K6QGyJP9P9xmRac2fH4OQ ($31.90 in chips) 
Seat 6: +HvCCmsGSQeatf+GZ9zk8Q ($18.75 in chips) 
Seat 7: GTcLfsDTPqgfHyhY9FNDMw ($8 in chips) 
Seat 8: Cni99AOp8W/F0ZWCuHNcIA ($12.05 in chips) 
Seat 9: +sbyWwIcFp9kP0bDtMegfQ ($37.75 in chips) 
qwr38jl5txoR36M7G5qi4A: posts small blind $0.10
7QzbjWT00wQpau1iqvUmMA: posts big blind $0.25
*** HOLE CARDS ***
56S3mA6Zs3pGR+0p0vUCtg: folds 
S2iyN4Q7njjhguIuE5g1CQ: calls $0.25
1K6QGyJP9P9xmRac2fH4OQ: folds 
+HvCCmsGSQeatf+GZ9zk8Q: folds 
GTcLfsDTPqgfHyhY9FNDMw: folds 
Cni99AOp8W/F0ZWCuHNcIA: calls $0.25
+sbyWwIcFp9kP0bDtMegfQ: folds 
qwr38jl5txoR36M7G5qi4A: folds 
7QzbjWT00wQpau1iqvUmMA: checks 
*** FLOP *** [Th Kh 8h]
7QzbjWT00wQpau1iqvUmMA: checks 
S2iyN4Q7njjhguIuE5g1CQ: checks 
Cni99AOp8W/F0ZWCuHNcIA: bets $0.50
7QzbjWT00wQpau1iqvUmMA: folds 
S2iyN4Q7njjhguIuE5g1CQ: folds 
Uncalled bet ($0.50) returned to Cni99AOp8W/F0ZWCuHNcIA
Cni99AOp8W/F0ZWCuHNcIA collected $0.85 from pot
*** SUMMARY ***
Total pot $0.85 | Rake $0 
Board [Th Kh 8h]
Seat 1: qwr38jl5txoR36M7G5qi4A (small blind) folded before Flop
Seat 2: 7QzbjWT00wQpau1iqvUmMA (big blind) folded on the Flop
Seat 3: 56S3mA6Zs3pGR+0p0vUCtg folded before Flop (didn't bet)
Seat 4: S2iyN4Q7njjhguIuE5g1CQ folded on the Flop
Seat 5: 1K6QGyJP9P9xmRac2fH4OQ folded before Flop (didn't bet)
Seat 6: +HvCCmsGSQeatf+GZ9zk8Q folded before Flop (didn't bet)
Seat 7: GTcLfsDTPqgfHyhY9FNDMw folded before Flop (didn't bet)
Seat 8: Cni99AOp8W/F0ZWCuHNcIA collected ($0.85)
Seat 9: +sbyWwIcFp9kP0bDtMegfQ (button) folded before Flop (didn't bet)




PokerStars Game #59939403060:  Hold'em No Limit ($0.10/$0.25) - 2009/07/01 0:38:58 ET
Table 'FE/j6VqBY4j9Uq+VHURQCQ' 6-max Seat #4 is the button
Seat 1: wKFJ513ucluNNiMlkXcDOQ ($44.10 in chips) 
Seat 2: gh0Jkra5bJ5RFIDWbx9zqA ($12.60 in chips) 
Seat 3: Zijzy/UtPWzWVUo81HHVjQ ($49.75 in chips) 
Seat 4: cPO/1/dTcZpLkQFm3jH3Rg ($25 in chips) 
Seat 5: wsP46AGpqDjHZQmlRHKa9g ($25.10 in chips) 
Seat 6: kARKwAmU6kWJfiSICTYhVw ($14.35 in chips) 
wsP46AGpqDjHZQmlRHKa9g: posts small blind $0.10
kARKwAmU6kWJfiSICTYhVw: posts big blind $0.25
*** HOLE CARDS ***
wKFJ513ucluNNiMlkXcDOQ: folds 
gh0Jkra5bJ5RFIDWbx9zqA: folds 
Zijzy/UtPWzWVUo81HHVjQ has timed out
Zijzy/UtPWzWVUo81HHVjQ: folds 
Zijzy/UtPWzWVUo81HHVjQ is sitting out
Zijzy/UtPWzWVUo81HHVjQ has returned
cPO/1/dTcZpLkQFm3jH3Rg: folds 
wsP46AGpqDjHZQmlRHKa9g: folds 
Uncalled bet ($0.15) returned to kARKwAmU6kWJfiSICTYhVw
kARKwAmU6kWJfiSICTYhVw collected $0.20 from pot
*** SUMMARY ***
Total pot $0.20 | Rake $0 
Seat 1: wKFJ513ucluNNiMlkXcDOQ folded before Flop (didn't bet)
Seat 2: gh0Jkra5bJ5RFIDWbx9zqA folded before Flop (didn't bet)
Seat 3: Zijzy/UtPWzWVUo81HHVjQ folded before Flop (didn't bet)
Seat 4: cPO/1/dTcZpLkQFm3jH3Rg (button) folded before Flop (didn't bet)
Seat 5: wsP46AGpqDjHZQmlRHKa9g (small blind) folded before Flop
Seat 6: kARKwAmU6kWJfiSICTYhVw (big blind) collected ($0.20)




PokerStars Game #59939403320:  Hold'em No Limit ($0.10/$0.25) - 2009/07/01 0:38:58 ET
Table 'LG9H161ZAHDkOww+ih3Ptg' 6-max Seat #3 is the button
Seat 1: avl8CO/tc0F6eVSiB/KNRA ($24.75 in chips) 
Seat 2: 9jSiy0meE9XJKkdIZwyTEQ ($28.95 in chips) 
Seat 3: sT4sjqzVMH/fZHz0hkbIPw ($36.90 in chips) 
Seat 4: 0C28L4/59aRNtHoBhqTcLg ($34.80 in chips) 
Seat 5: oseFhpinoe+Zg4j5xyBjyQ ($43.90 in chips) 
0C28L4/59aRNtHoBhqTcLg: posts small blind $0.10
oseFhpinoe+Zg4j5xyBjyQ: posts big blind $0.25
*** HOLE CARDS ***
avl8CO/tc0F6eVSiB/KNRA: folds 
9jSiy0meE9XJKkdIZwyTEQ: folds 
sT4sjqzVMH/fZHz0hkbIPw: calls $0.25
0C28L4/59aRNtHoBhqTcLg: calls $0.15
oseFhpinoe+Zg4j5xyBjyQ: checks 
*** FLOP *** [9c Ks Kc]
0C28L4/59aRNtHoBhqTcLg: checks 
oseFhpinoe+Zg4j5xyBjyQ: checks 
sT4sjqzVMH/fZHz0hkbIPw: bets $0.75
0C28L4/59aRNtHoBhqTcLg: folds 
oseFhpinoe+Zg4j5xyBjyQ: folds 
Uncalled bet ($0.75) returned to sT4sjqzVMH/fZHz0hkbIPw
sT4sjqzVMH/fZHz0hkbIPw collected $0.75 from pot
sT4sjqzVMH/fZHz0hkbIPw: doesn't show hand 
*** SUMMARY ***
Total pot $0.75 | Rake $0 
Board [9c Ks Kc]
Seat 1: avl8CO/tc0F6eVSiB/KNRA folded before Flop (didn't bet)
Seat 2: 9jSiy0meE9XJKkdIZwyTEQ folded before Flop (didn't bet)
Seat 3: sT4sjqzVMH/fZHz0hkbIPw (button) collected ($0.75)
Seat 4: 0C28L4/59aRNtHoBhqTcLg (small blind) folded on the Flop
Seat 5: oseFhpinoe+Zg4j5xyBjyQ (big blind) folded on the Flop




PokerStars Game #59939403248:  Hold'em No Limit ($0.10/$0.25) - 2009/07/01 0:38:58 ET
Table 'hOE09W281uSob0XeJmUcRg' 6-max Seat #6 is the button
Seat 4: TslQs7AQSLbVtr4X8JOOOQ ($20.05 in chips) 
Seat 5: 66a/8+qw1AZLNh63FuclPA ($101.35 in chips) 
Seat 6: x4ZJ8E/TUrtoB7WiHcv8WA ($10.15 in chips) 
edio/rLJ06xeZOfLhoL3UA will be allowed to play after the button
TslQs7AQSLbVtr4X8JOOOQ: posts small blind $0.10
66a/8+qw1AZLNh63FuclPA: posts big blind $0.25
*** HOLE CARDS ***
x4ZJ8E/TUrtoB7WiHcv8WA: raises $0.25 to $0.50
TslQs7AQSLbVtr4X8JOOOQ: calls $0.40
66a/8+qw1AZLNh63FuclPA: folds 
*** FLOP *** [2d As 4h]
TslQs7AQSLbVtr4X8JOOOQ: checks 
x4ZJ8E/TUrtoB7WiHcv8WA: checks 
*** TURN *** [2d As 4h] [8h]
TslQs7AQSLbVtr4X8JOOOQ: checks 
x4ZJ8E/TUrtoB7WiHcv8WA: bets $1.25
TslQs7AQSLbVtr4X8JOOOQ: folds 
Uncalled bet ($1.25) returned to x4ZJ8E/TUrtoB7WiHcv8WA
x4ZJ8E/TUrtoB7WiHcv8WA collected $1.20 from pot
x4ZJ8E/TUrtoB7WiHcv8WA: doesn't show hand 
*** SUMMARY ***
Total pot $1.25 | Rake $0.05 
Board [2d As 4h 8h]
Seat 4: TslQs7AQSLbVtr4X8JOOOQ (small blind) folded on the Turn
Seat 5: 66a/8+qw1AZLNh63FuclPA (big blind) folded before Flop
Seat 6: x4ZJ8E/TUrtoB7WiHcv8WA (button) collected ($1.20)




PokerStars Game #59939403738:  Hold'em No Limit ($0.10/$0.25) - 2009/07/01 0:38:59 ET
Table 'vFZR6Kf2Th5xBXT9brGW6A' 6-max Seat #4 is the button
Seat 1: xRkU4+naLuz7dEZFbOn9cw ($35.30 in chips) 
Seat 2: REnO5xiZ66YabxDXq2ncvA ($51.70 in chips) 
Seat 4: 79ID/ub1Pt/mDpCprVmOoA ($25 in chips) 
Seat 5: NhUN/JpAprdJeamFBgJH1w ($25.45 in chips) 
Seat 6: d0J1xuhsynEY81YHwAvJ5g ($25 in chips) 
NhUN/JpAprdJeamFBgJH1w: posts small blind $0.10
d0J1xuhsynEY81YHwAvJ5g: posts big blind $0.25
*** HOLE CARDS ***
xRkU4+naLuz7dEZFbOn9cw: folds 
REnO5xiZ66YabxDXq2ncvA: folds 
79ID/ub1Pt/mDpCprVmOoA: raises $0.50 to $0.75
NhUN/JpAprdJeamFBgJH1w: folds 
d0J1xuhsynEY81YHwAvJ5g: folds 
Uncalled bet ($0.50) returned to 79ID/ub1Pt/mDpCprVmOoA
79ID/ub1Pt/mDpCprVmOoA collected $0.60 from pot
79ID/ub1Pt/mDpCprVmOoA: doesn't show hand 
*** SUMMARY ***
Total pot $0.60 | Rake $0 
Seat 1: xRkU4+naLuz7dEZFbOn9cw folded before Flop (didn't bet)
Seat 2: REnO5xiZ66YabxDXq2ncvA folded before Flop (didn't bet)
Seat 4: 79ID/ub1Pt/mDpCprVmOoA (button) collected ($0.60)
Seat 5: NhUN/JpAprdJeamFBgJH1w (small blind) folded before Flop
Seat 6: d0J1xuhsynEY81YHwAvJ5g (big blind) folded before Flop




PokerStars Game #59939403670:  Hold'em No Limit ($0.10/$0.25) - 2009/07/01 0:38:59 ET
Table 'yRuHgMpxv4rPBXeM6HFESw' 6-max Seat #3 is the button
Seat 2: iwlxXocltgSdaBmusNXanQ ($15.45 in chips) 
Seat 3: zZ8zH49EwNs0mqgppOaL9g ($50.55 in chips) 
Seat 4: ypXnt+kzrF/5y8QN2rkt1A ($19.15 in chips) 
Seat 5: gaPMxLGp9SOj4Lq6t+/0Ig ($14.75 in chips) 
Seat 6: 4YSTu0Cdzpppe1lUgCZGCQ ($25 in chips) 
ypXnt+kzrF/5y8QN2rkt1A: posts small blind $0.10
MkNgTuvyxpHXkeIm5JITHQ joins the table at seat #1 
gaPMxLGp9SOj4Lq6t+/0Ig: posts big blind $0.25
*** HOLE CARDS ***
4YSTu0Cdzpppe1lUgCZGCQ has timed out
4YSTu0Cdzpppe1lUgCZGCQ: folds 
4YSTu0Cdzpppe1lUgCZGCQ is sitting out
iwlxXocltgSdaBmusNXanQ: folds 
zZ8zH49EwNs0mqgppOaL9g: folds 
4YSTu0Cdzpppe1lUgCZGCQ has returned
ypXnt+kzrF/5y8QN2rkt1A: calls $0.15
gaPMxLGp9SOj4Lq6t+/0Ig: checks 
*** FLOP *** [7d Qc 3c]
ypXnt+kzrF/5y8QN2rkt1A: checks 
gaPMxLGp9SOj4Lq6t+/0Ig: bets $0.50
ypXnt+kzrF/5y8QN2rkt1A: calls $0.50
*** TURN *** [7d Qc 3c] [2s]
ypXnt+kzrF/5y8QN2rkt1A: bets $0.25
gaPMxLGp9SOj4Lq6t+/0Ig: calls $0.25
*** RIVER *** [7d Qc 3c 2s] [4s]
ypXnt+kzrF/5y8QN2rkt1A: bets $0.75
gaPMxLGp9SOj4Lq6t+/0Ig: folds 
Uncalled bet ($0.75) returned to ypXnt+kzrF/5y8QN2rkt1A
ypXnt+kzrF/5y8QN2rkt1A collected $1.95 from pot
ypXnt+kzrF/5y8QN2rkt1A: doesn't show hand 
*** SUMMARY ***
Total pot $2 | Rake $0.05 
Board [7d Qc 3c 2s 4s]
Seat 2: iwlxXocltgSdaBmusNXanQ folded before Flop (didn't bet)
Seat 3: zZ8zH49EwNs0mqgppOaL9g (button) folded before Flop (didn't bet)
Seat 4: ypXnt+kzrF/5y8QN2rkt1A (small blind) collected ($1.95)
Seat 5: gaPMxLGp9SOj4Lq6t+/0Ig (big blind) folded on the River
Seat 6: 4YSTu0Cdzpppe1lUgCZGCQ folded before Flop (didn't bet)




PokerStars Game #59939403550:  Hold'em No Limit ($0.10/$0.25) - 2009/07/01 0:38:59 ET
Table '8UiaYOdeBwzanG6w1SMeFg' 9-max Seat #7 is the button
Seat 2: 18G4P1XstjNvItdGUITxgw ($25 in chips) 
Seat 3: A7xJNkBMCQG6Zuocn2v8YQ ($14.60 in chips) 
Seat 4: H5Se03ZqSX7tbULXur2MAg ($29.85 in chips) 
Seat 5: UmzixCpC0bAc1lDEjgB3NQ ($19.30 in chips) 
Seat 6: N6fYvIzQLKaydFLKQGtMlQ ($23.30 in chips) 
Seat 7: E0iYnEVO2ho7dH3QcCjw7g ($26.75 in chips) 
Seat 8: hBMUlEpyU74r/fwDgIpXjQ ($47.95 in chips) 
hBMUlEpyU74r/fwDgIpXjQ: posts small blind $0.10
ux2QXCjHQkbhR6RxT0Abnw: is sitting out 
JxpnpCmvRAcrEUy7mq1iAg: is sitting out 
18G4P1XstjNvItdGUITxgw: posts big blind $0.25
*** HOLE CARDS ***
JxpnpCmvRAcrEUy7mq1iAg leaves the table
ux2QXCjHQkbhR6RxT0Abnw leaves the table
A7xJNkBMCQG6Zuocn2v8YQ: folds 
H5Se03ZqSX7tbULXur2MAg: folds 
UmzixCpC0bAc1lDEjgB3NQ: calls $0.25
N6fYvIzQLKaydFLKQGtMlQ: folds 
E0iYnEVO2ho7dH3QcCjw7g: raises $0.75 to $1
hBMUlEpyU74r/fwDgIpXjQ: calls $0.90
18G4P1XstjNvItdGUITxgw: folds 
UmzixCpC0bAc1lDEjgB3NQ: folds 
*** FLOP *** [Qs 6h 7c]
hBMUlEpyU74r/fwDgIpXjQ: checks 
E0iYnEVO2ho7dH3QcCjw7g: bets $1
hBMUlEpyU74r/fwDgIpXjQ: calls $1
*** TURN *** [Qs 6h 7c] [2h]
hBMUlEpyU74r/fwDgIpXjQ: checks 
E0iYnEVO2ho7dH3QcCjw7g: bets $3.50
hBMUlEpyU74r/fwDgIpXjQ: raises $5.50 to $9
eyesirish joins the table at seat #1 
E0iYnEVO2ho7dH3QcCjw7g said, "set eh"
E0iYnEVO2ho7dH3QcCjw7g: folds 
Uncalled bet ($5.50) returned to hBMUlEpyU74r/fwDgIpXjQ
hBMUlEpyU74r/fwDgIpXjQ collected $10.95 from pot
hBMUlEpyU74r/fwDgIpXjQ: doesn't show hand 
*** SUMMARY ***
Total pot $11.50 | Rake $0.55 
Board [Qs 6h 7c 2h]
Seat 2: 18G4P1XstjNvItdGUITxgw (big blind) folded before Flop
Seat 3: A7xJNkBMCQG6Zuocn2v8YQ folded before Flop (didn't bet)
Seat 4: H5Se03ZqSX7tbULXur2MAg folded before Flop (didn't bet)
Seat 5: UmzixCpC0bAc1lDEjgB3NQ folded before Flop
Seat 6: N6fYvIzQLKaydFLKQGtMlQ folded before Flop (didn't bet)
Seat 7: E0iYnEVO2ho7dH3QcCjw7g (button) folded on the Turn
Seat 8: hBMUlEpyU74r/fwDgIpXjQ (small blind) collected ($10.95)




PokerStars Game #59939403512:  Hold'em No Limit ($0.10/$0.25) - 2009/07/01 0:38:59 ET
Table '6aL2C8IFwHHr6SG6RgXaow' 9-max Seat #6 is the button
Seat 2: +gMmKt3DaQng9M42CmxIZg ($24.55 in chips) 
Seat 5: wre31HfyzQGpIvID1istxw ($14.35 in chips) 
Seat 6: HxDF4QSxC4z39D7teZpprQ ($33.40 in chips) 
Seat 7: rPToQDbLWB+dKnz7fcQSIg ($10.15 in chips) 
Seat 8: rQhYIYXSyH/IivYM1dlV5A ($14.40 in chips) 
Seat 9: yduPKWPzL8YlT5Zv/Nmrwg ($17.05 in chips) 
rPToQDbLWB+dKnz7fcQSIg: posts small blind $0.10
rQhYIYXSyH/IivYM1dlV5A: posts big blind $0.25
*** HOLE CARDS ***
yduPKWPzL8YlT5Zv/Nmrwg: raises $1 to $1.25
+gMmKt3DaQng9M42CmxIZg: folds 
wre31HfyzQGpIvID1istxw: folds 
HxDF4QSxC4z39D7teZpprQ: folds 
rPToQDbLWB+dKnz7fcQSIg: folds 
rQhYIYXSyH/IivYM1dlV5A: folds 
Uncalled bet ($1) returned to yduPKWPzL8YlT5Zv/Nmrwg
yduPKWPzL8YlT5Zv/Nmrwg collected $0.60 from pot
*** SUMMARY ***
Total pot $0.60 | Rake $0 
Seat 2: +gMmKt3DaQng9M42CmxIZg folded before Flop (didn't bet)
Seat 5: wre31HfyzQGpIvID1istxw folded before Flop (didn't bet)
Seat 6: HxDF4QSxC4z39D7teZpprQ (button) folded before Flop (didn't bet)
Seat 7: rPToQDbLWB+dKnz7fcQSIg (small blind) folded before Flop
Seat 8: rQhYIYXSyH/IivYM1dlV5A (big blind) folded before Flop
Seat 9: yduPKWPzL8YlT5Zv/Nmrwg collected ($0.60)




PokerStars Game #59939403778:  Hold'em No Limit ($0.10/$0.25) - 2009/07/01 0:38:59 ET
Table 'pgrBYaOEx/BuqK5iAtlFzw' 9-max Seat #5 is the button
Seat 3: bfSq6LBw0UvxeM5yfuWC7w ($15.10 in chips) 
Seat 5: efYVL4adq0ufQFnZCpL5Tw ($5.30 in chips) 
efYVL4adq0ufQFnZCpL5Tw: posts small blind $0.10
bfSq6LBw0UvxeM5yfuWC7w: posts big blind $0.25
*** HOLE CARDS ***
efYVL4adq0ufQFnZCpL5Tw: calls $0.15
bfSq6LBw0UvxeM5yfuWC7w: checks 
*** FLOP *** [Qh 9c Th]
bfSq6LBw0UvxeM5yfuWC7w: bets $0.25
efYVL4adq0ufQFnZCpL5Tw: calls $0.25
*** TURN *** [Qh 9c Th] [6h]
bfSq6LBw0UvxeM5yfuWC7w: bets $0.25
efYVL4adq0ufQFnZCpL5Tw: raises $0.50 to $0.75
bfSq6LBw0UvxeM5yfuWC7w: folds 
Uncalled bet ($0.50) returned to efYVL4adq0ufQFnZCpL5Tw
QsLvCwfSWqP+CfjwUnjpXQ joins the table at seat #1 
efYVL4adq0ufQFnZCpL5Tw collected $1.45 from pot
*** SUMMARY ***
Total pot $1.50 | Rake $0.05 
Board [Qh 9c Th 6h]
Seat 3: bfSq6LBw0UvxeM5yfuWC7w (big blind) folded on the Turn
Seat 5: efYVL4adq0ufQFnZCpL5Tw (button) (small blind) collected ($1.45)




PokerStars Game #59939403726:  Hold'em No Limit ($0.10/$0.25) - 2009/07/01 0:38:59 ET
Table '52Meibn9NOL4XtVi1p2Upw' 9-max Seat #1 is the button
Seat 1: LSrAei+fS8MYG9ie/GkG0Q ($15.70 in chips) 
Seat 2: BEIBUu2pIflPrCL+Iks4CQ ($12.35 in chips) 
Seat 3: MzBvksetB8XYtCt0FExJMg ($15.25 in chips) 
Seat 4: rCaXm4/EwAgWqCiClpbsqQ ($9 in chips) 
Seat 5: 4oA316mXLIui1QY63GXBUg ($27.10 in chips) 
Seat 6: 1wKfgJ8xXIiuc8C6qjkxhg ($3 in chips) 
Seat 7: R3KkgiqTvuhazyCqaD9cZg ($10 in chips) 
Seat 8: eKma8Z98pP7H8m4CEt075w ($23.10 in chips) 
Seat 9: 8B/dhbQjIWe6ASCdgzktNQ ($30.10 in chips) 
BEIBUu2pIflPrCL+Iks4CQ: posts small blind $0.10
MzBvksetB8XYtCt0FExJMg: posts big blind $0.25
*** HOLE CARDS ***
rCaXm4/EwAgWqCiClpbsqQ: folds 
4oA316mXLIui1QY63GXBUg: folds 
1wKfgJ8xXIiuc8C6qjkxhg: folds 
R3KkgiqTvuhazyCqaD9cZg: folds 
eKma8Z98pP7H8m4CEt075w: calls $0.25
8B/dhbQjIWe6ASCdgzktNQ: folds 
LSrAei+fS8MYG9ie/GkG0Q: folds 
BEIBUu2pIflPrCL+Iks4CQ: folds 
MzBvksetB8XYtCt0FExJMg: checks 
*** FLOP *** [Kh Jd Td]
MzBvksetB8XYtCt0FExJMg: checks 
eKma8Z98pP7H8m4CEt075w: bets $0.50
MzBvksetB8XYtCt0FExJMg: folds 
Uncalled bet ($0.50) returned to eKma8Z98pP7H8m4CEt075w
eKma8Z98pP7H8m4CEt075w collected $0.60 from pot
*** SUMMARY ***
Total pot $0.60 | Rake $0 
Board [Kh Jd Td]
Seat 1: LSrAei+fS8MYG9ie/GkG0Q (button) folded before Flop (didn't bet)
Seat 2: BEIBUu2pIflPrCL+Iks4CQ (small blind) folded before Flop
Seat 3: MzBvksetB8XYtCt0FExJMg (big blind) folded on the Flop
Seat 4: rCaXm4/EwAgWqCiClpbsqQ folded before Flop (didn't bet)
Seat 5: 4oA316mXLIui1QY63GXBUg folded before Flop (didn't bet)
Seat 6: 1wKfgJ8xXIiuc8C6qjkxhg folded before Flop (didn't bet)
Seat 7: R3KkgiqTvuhazyCqaD9cZg folded before Flop (didn't bet)
Seat 8: eKma8Z98pP7H8m4CEt075w collected ($0.60)
Seat 9: 8B/dhbQjIWe6ASCdgzktNQ folded before Flop (didn't bet)




PokerStars Game #59939403562:  Hold'em No Limit ($0.10/$0.25) - 2009/07/01 0:38:59 ET
Table 'I0ZcuiUTeLuGYv26Nah7YA' 9-max Seat #9 is the button
Seat 1: iMiqaPr7dx84UF0wNUeh8A ($19.80 in chips) 
Seat 2: zE0IkNrJoJD964o4eqmCxQ ($6.05 in chips) 
Seat 3: 1S/fpm+f42V/6MNZre+ccg ($27.95 in chips) 
Seat 4: 4awUyiDYTgylQKXZ9faBVA ($30.25 in chips) 
Seat 5: opOCI2p6kW0tINuVaAqmcQ ($45 in chips) 
Seat 6: JRV2PblFtPFz51l0Fwyz8g ($25 in chips) 
Seat 7: JxpnpCmvRAcrEUy7mq1iAg ($6.10 in chips) 
Seat 8: ijc1q+bpPQR12wxc0sWc4w ($15 in chips) 
Seat 9: 2mQl0jr5DPlr6jqhvCq8Xw ($3.85 in chips) 
iMiqaPr7dx84UF0wNUeh8A: posts small blind $0.10
zE0IkNrJoJD964o4eqmCxQ: posts big blind $0.25
JRV2PblFtPFz51l0Fwyz8g: posts big blind $0.25
ijc1q+bpPQR12wxc0sWc4w: posts big blind $0.25
*** HOLE CARDS ***
1S/fpm+f42V/6MNZre+ccg: calls $0.25
zE0IkNrJoJD964o4eqmCxQ said, "super, you should have bet, you passive moron....lolol"
4awUyiDYTgylQKXZ9faBVA: folds 
opOCI2p6kW0tINuVaAqmcQ: folds 
JRV2PblFtPFz51l0Fwyz8g: checks 
JxpnpCmvRAcrEUy7mq1iAg: folds 
ijc1q+bpPQR12wxc0sWc4w: checks 
2mQl0jr5DPlr6jqhvCq8Xw: calls $0.25
iMiqaPr7dx84UF0wNUeh8A: folds 
zE0IkNrJoJD964o4eqmCxQ: raises $0.50 to $0.75
1S/fpm+f42V/6MNZre+ccg: calls $0.50
JRV2PblFtPFz51l0Fwyz8g: folds 
ijc1q+bpPQR12wxc0sWc4w: calls $0.50
2mQl0jr5DPlr6jqhvCq8Xw: calls $0.50
*** FLOP *** [8s 3c Ts]
zE0IkNrJoJD964o4eqmCxQ: bets $1.25
iMiqaPr7dx84UF0wNUeh8A said, "why? did you "read" him for 3s?"
1S/fpm+f42V/6MNZre+ccg: folds 
ijc1q+bpPQR12wxc0sWc4w: folds 
zE0IkNrJoJD964o4eqmCxQ said, "no"
2mQl0jr5DPlr6jqhvCq8Xw: raises $1.85 to $3.10 and is all-in
zE0IkNrJoJD964o4eqmCxQ said, "but he was checking"
zE0IkNrJoJD964o4eqmCxQ: calls $1.85
*** TURN *** [8s 3c Ts] [3h]
*** RIVER *** [8s 3c Ts 3h] [7s]
*** SHOW DOWN ***
zE0IkNrJoJD964o4eqmCxQ: shows [Js Qd] (a pair of Threes)
2mQl0jr5DPlr6jqhvCq8Xw: shows [Tc Kc] (two pair, Tens and Threes)
2mQl0jr5DPlr6jqhvCq8Xw collected $9.10 from pot
*** SUMMARY ***
Total pot $9.55 | Rake $0.45 
Board [8s 3c Ts 3h 7s]
Seat 1: iMiqaPr7dx84UF0wNUeh8A (small blind) folded before Flop
Seat 2: zE0IkNrJoJD964o4eqmCxQ (big blind) showed [Js Qd] and lost with a pair of Threes
Seat 3: 1S/fpm+f42V/6MNZre+ccg folded on the Flop
Seat 4: 4awUyiDYTgylQKXZ9faBVA folded before Flop (didn't bet)
Seat 5: opOCI2p6kW0tINuVaAqmcQ folded before Flop (didn't bet)
Seat 6: JRV2PblFtPFz51l0Fwyz8g folded before Flop
Seat 7: JxpnpCmvRAcrEUy7mq1iAg folded before Flop (didn't bet)
Seat 8: ijc1q+bpPQR12wxc0sWc4w folded on the Flop
Seat 9: 2mQl0jr5DPlr6jqhvCq8Xw (button) showed [Tc Kc] and won ($9.10) with two pair, Tens and Threes




PokerStars Game #59939403666:  Hold'em No Limit ($0.10/$0.25) - 2009/07/01 0:38:59 ET
Table '4mnXP0EWt9mMZYzTIVDQ0w' 9-max Seat #5 is the button
Seat 1: PTFwg4rGxnfVvj2iP1OI2w ($16.60 in chips) 
Seat 2: j4q3p0lesp63b1gZDwLBZw ($5 in chips) 
Seat 4: E0iYnEVO2ho7dH3QcCjw7g ($20.45 in chips) 
Seat 5: sSN8Y0AlsBeidZXPKmwXSw ($12.90 in chips) 
Seat 6: n9toqYXSLowQ/sWq842dEQ ($11.25 in chips) 
Seat 7: s1y+qfkBnhgc67+X3ThjeA ($24.90 in chips) 
Seat 8: H9KUl8cmpLgEpOVDA00bCg ($4.65 in chips) 
Seat 9: wbCayoP+N6xpKgOfIqZsbA ($22.20 in chips) 
n9toqYXSLowQ/sWq842dEQ: posts small blind $0.10
s1y+qfkBnhgc67+X3ThjeA: posts big blind $0.25
*** HOLE CARDS ***
H9KUl8cmpLgEpOVDA00bCg: folds 
wbCayoP+N6xpKgOfIqZsbA: folds 
PTFwg4rGxnfVvj2iP1OI2w: calls $0.25
j4q3p0lesp63b1gZDwLBZw: raises $1 to $1.25
E0iYnEVO2ho7dH3QcCjw7g: folds 
sSN8Y0AlsBeidZXPKmwXSw: folds 
n9toqYXSLowQ/sWq842dEQ: folds 
s1y+qfkBnhgc67+X3ThjeA: folds 
PTFwg4rGxnfVvj2iP1OI2w: calls $1
*** FLOP *** [3c Th 2h]
PTFwg4rGxnfVvj2iP1OI2w: checks 
j4q3p0lesp63b1gZDwLBZw: bets $1.75
PTFwg4rGxnfVvj2iP1OI2w: folds 
Uncalled bet ($1.75) returned to j4q3p0lesp63b1gZDwLBZw
j4q3p0lesp63b1gZDwLBZw collected $2.75 from pot
j4q3p0lesp63b1gZDwLBZw: doesn't show hand 
*** SUMMARY ***
Total pot $2.85 | Rake $0.10 
Board [3c Th 2h]
Seat 1: PTFwg4rGxnfVvj2iP1OI2w folded on the Flop
Seat 2: j4q3p0lesp63b1gZDwLBZw collected ($2.75)
Seat 4: E0iYnEVO2ho7dH3QcCjw7g folded before Flop (didn't bet)
Seat 5: sSN8Y0AlsBeidZXPKmwXSw (button) folded before Flop (didn't bet)
Seat 6: n9toqYXSLowQ/sWq842dEQ (small blind) folded before Flop
Seat 7: s1y+qfkBnhgc67+X3ThjeA (big blind) folded before Flop
Seat 8: H9KUl8cmpLgEpOVDA00bCg folded before Flop (didn't bet)
Seat 9: wbCayoP+N6xpKgOfIqZsbA folded before Flop (didn't bet)




PokerStars Game #59939403592:  Hold'em No Limit ($0.10/$0.25) - 2009/07/01 0:38:59 ET
Table 'IfRHUn9gQQA9I/Z4tn+BoA' 9-max Seat #3 is the button
Seat 1: vSkQm2EelzwRGDDQQk0Fqw ($4.65 in chips) 
Seat 2: zgWbKMp0/btzsnVbQWKXww ($16.30 in chips) 
Seat 3: iAQDnrJCZVD1LzAGxTYegw ($26.25 in chips) 
Seat 4: QEbIGci+itdw+re8RM5fZA ($25 in chips) 
Seat 5: 10584482 ($14.85 in chips) 
Seat 6: UOjoGGQ58/uDS7V0xkjOrQ ($8.30 in chips) 
Seat 7: TeWJxSETzbXGiYKx0y+dtg ($25.85 in chips) 
Seat 8: cZ99hugmLBj9KhTlc8nCSw ($25 in chips) 
QEbIGci+itdw+re8RM5fZA: posts small blind $0.10
10584482: posts big blind $0.25
7cv+9Zc9HIQHNvYsMfV3uA: sits out 
*** HOLE CARDS ***
UOjoGGQ58/uDS7V0xkjOrQ: raises $0.25 to $0.50
TeWJxSETzbXGiYKx0y+dtg: folds 
cZ99hugmLBj9KhTlc8nCSw: folds 
vSkQm2EelzwRGDDQQk0Fqw: folds 
zgWbKMp0/btzsnVbQWKXww: folds 
iAQDnrJCZVD1LzAGxTYegw: folds 
QEbIGci+itdw+re8RM5fZA: folds 
10584482: calls $0.25
*** FLOP *** [6c Ts Ks]
10584482: bets $1
UOjoGGQ58/uDS7V0xkjOrQ: folds 
Uncalled bet ($1) returned to 10584482
10584482 collected $1.05 from pot
10584482: doesn't show hand 
*** SUMMARY ***
Total pot $1.10 | Rake $0.05 
Board [6c Ts Ks]
Seat 1: vSkQm2EelzwRGDDQQk0Fqw folded before Flop (didn't bet)
Seat 2: zgWbKMp0/btzsnVbQWKXww folded before Flop (didn't bet)
Seat 3: iAQDnrJCZVD1LzAGxTYegw (button) folded before Flop (didn't bet)
Seat 4: QEbIGci+itdw+re8RM5fZA (small blind) folded before Flop
Seat 5: 10584482 (big blind) collected ($1.05)
Seat 6: UOjoGGQ58/uDS7V0xkjOrQ folded on the Flop
Seat 7: TeWJxSETzbXGiYKx0y+dtg folded before Flop (didn't bet)
Seat 8: cZ99hugmLBj9KhTlc8nCSw folded before Flop (didn't bet)




PokerStars Game #59939403692:  Hold'em No Limit ($0.10/$0.25) - 2009/07/01 0:38:59 ET
Table 'WEMI3Mtn7dGARDbgNrKibg' 9-max Seat #5 is the button
Seat 2: tYsOBqdU1+x+yFI7zHO7hQ ($26.50 in chips) 
Seat 3: jZaChyamGXWcP+qALPP5Jg ($25 in chips) 
Seat 4: weRKhk7fsNpLvkjCucC/eQ ($20.90 in chips) 
Seat 5: st9jtdNbm1W5GfBwRaCVqQ ($23.90 in chips) 
Seat 6: VBHxUExRAMrbxUq/cVx9Gw ($4.75 in chips) 
Seat 7: DnDcAdn9P0zGovMERigpFA ($59 in chips) 
Seat 8: ghNKXUBl/H+t83JF079ZBA ($27.30 in chips) 
Seat 9: NTamLAiMZ86c5yM04t96LA ($56.95 in chips) 
NTamLAiMZ86c5yM04t96LA said, "aa"
VBHxUExRAMrbxUq/cVx9Gw: posts small blind $0.10
DnDcAdn9P0zGovMERigpFA: posts big blind $0.25
7cv+9Zc9HIQHNvYsMfV3uA: sits out 
*** HOLE CARDS ***
ghNKXUBl/H+t83JF079ZBA: folds 
NTamLAiMZ86c5yM04t96LA said, "nice"
NTamLAiMZ86c5yM04t96LA: calls $0.25
tYsOBqdU1+x+yFI7zHO7hQ: raises $1 to $1.25
jZaChyamGXWcP+qALPP5Jg: folds 
weRKhk7fsNpLvkjCucC/eQ: calls $1.25
st9jtdNbm1W5GfBwRaCVqQ: folds 
VBHxUExRAMrbxUq/cVx9Gw: folds 
NTamLAiMZ86c5yM04t96LA said, "aknow"
DnDcAdn9P0zGovMERigpFA: folds 
NTamLAiMZ86c5yM04t96LA: folds 
*** FLOP *** [2d 6c Jh]
tYsOBqdU1+x+yFI7zHO7hQ: bets $2.25
weRKhk7fsNpLvkjCucC/eQ: calls $2.25
*** TURN *** [2d 6c Jh] [3h]
tYsOBqdU1+x+yFI7zHO7hQ: bets $6
weRKhk7fsNpLvkjCucC/eQ: calls $6
*** RIVER *** [2d 6c Jh 3h] [4s]
tYsOBqdU1+x+yFI7zHO7hQ: bets $11.75
weRKhk7fsNpLvkjCucC/eQ: calls $11.40 and is all-in
Uncalled bet ($0.35) returned to tYsOBqdU1+x+yFI7zHO7hQ
*** SHOW DOWN ***
tYsOBqdU1+x+yFI7zHO7hQ: shows [Jc Ac] (a pair of Jacks)
weRKhk7fsNpLvkjCucC/eQ: mucks hand 
tYsOBqdU1+x+yFI7zHO7hQ collected $40.35 from pot
*** SUMMARY ***
Total pot $42.40 | Rake $2.05 
Board [2d 6c Jh 3h 4s]
Seat 2: tYsOBqdU1+x+yFI7zHO7hQ showed [Jc Ac] and won ($40.35) with a pair of Jacks
Seat 3: jZaChyamGXWcP+qALPP5Jg folded before Flop (didn't bet)
Seat 4: weRKhk7fsNpLvkjCucC/eQ mucked
Seat 5: st9jtdNbm1W5GfBwRaCVqQ (button) folded before Flop (didn't bet)
Seat 6: VBHxUExRAMrbxUq/cVx9Gw (small blind) folded before Flop
Seat 7: DnDcAdn9P0zGovMERigpFA (big blind) folded before Flop
Seat 8: ghNKXUBl/H+t83JF079ZBA folded before Flop (didn't bet)
Seat 9: NTamLAiMZ86c5yM04t96LA folded before Flop




PokerStars Game #59939404364:  Hold'em No Limit ($0.10/$0.25) - 2009/07/01 0:39:00 ET
Table 'xkqAWQFDrFt4p81M8UsoNw' 9-max Seat #8 is the button
Seat 2: z5GxcHlYz/GSz6W2uFiTtg ($34.55 in chips) 
Seat 3: HEUqKs2EYYGGXJCepUdL0g ($7.60 in chips) 
Seat 4: gY+PO8PaVC7pBPH/9HSv6Q ($4.60 in chips) 
Seat 5: OiV1PWZ3IkN29JlmCcnTwQ ($4.55 in chips) 
Seat 6: Yv4fucyyT28mjx8V5lxKJg ($24.25 in chips) 
Seat 7: MG90wfSJZnOejs/KD3vlQQ ($48.05 in chips) 
Seat 8: s7Q6uNouhe7aE8JdFb9E+A ($27.90 in chips) 
Seat 9: Wa7bjLwN7ptOQro84PxQGw ($4.85 in chips) 
Wa7bjLwN7ptOQro84PxQGw: posts small blind $0.10
z5GxcHlYz/GSz6W2uFiTtg: posts big blind $0.25
*** HOLE CARDS ***
HEUqKs2EYYGGXJCepUdL0g: folds 
gY+PO8PaVC7pBPH/9HSv6Q: raises $0.75 to $1
OiV1PWZ3IkN29JlmCcnTwQ: folds 
Yv4fucyyT28mjx8V5lxKJg: folds 
MG90wfSJZnOejs/KD3vlQQ: folds 
s7Q6uNouhe7aE8JdFb9E+A has timed out
s7Q6uNouhe7aE8JdFb9E+A: folds 
s7Q6uNouhe7aE8JdFb9E+A is sitting out
Wa7bjLwN7ptOQro84PxQGw: folds 
z5GxcHlYz/GSz6W2uFiTtg: folds 
Uncalled bet ($0.75) returned to gY+PO8PaVC7pBPH/9HSv6Q
gY+PO8PaVC7pBPH/9HSv6Q collected $0.60 from pot
*** SUMMARY ***
Total pot $0.60 | Rake $0 
Seat 2: z5GxcHlYz/GSz6W2uFiTtg (big blind) folded before Flop
Seat 3: HEUqKs2EYYGGXJCepUdL0g folded before Flop (didn't bet)
Seat 4: gY+PO8PaVC7pBPH/9HSv6Q collected ($0.60)
Seat 5: OiV1PWZ3IkN29JlmCcnTwQ folded before Flop (didn't bet)
Seat 6: Yv4fucyyT28mjx8V5lxKJg folded before Flop (didn't bet)
Seat 7: MG90wfSJZnOejs/KD3vlQQ folded before Flop (didn't bet)
Seat 8: s7Q6uNouhe7aE8JdFb9E+A (button) folded before Flop (didn't bet)
Seat 9: Wa7bjLwN7ptOQro84PxQGw (small blind) folded before Flop




PokerStars Game #59939404402:  Hold'em No Limit ($0.10/$0.25) - 2009/07/01 0:39:00 ET
Table 'bIGKmJgZehWJ+FAo8b85iw' 9-max Seat #7 is the button
Seat 2: Ut3g/kEEdCCbe/gbWrHnDg ($21.50 in chips) 
Seat 3: TeWJxSETzbXGiYKx0y+dtg ($36.40 in chips) 
Seat 4: EJRVVUAJEYLdm1qbO8TzuQ ($10.55 in chips) 
Seat 5: 7wo6Sr7QG3Zo6BaBDV1BOw ($6.80 in chips) 
Seat 6: H5Se03ZqSX7tbULXur2MAg ($21.95 in chips) 
Seat 7: DdPXdieucQ+n99u1n3A+rQ ($9.95 in chips) 
Seat 8: +2kMBNpY4nF1qNCRd8SJLA ($25 in chips) 
Seat 9: aNpwfA31EREwO+ar4XzBCw ($25 in chips) 
+2kMBNpY4nF1qNCRd8SJLA: posts small blind $0.10
aNpwfA31EREwO+ar4XzBCw: posts big blind $0.25
yyG4svzOpC1A+sUP/scg6w: sits out 
*** HOLE CARDS ***
Ut3g/kEEdCCbe/gbWrHnDg: folds 
TeWJxSETzbXGiYKx0y+dtg: folds 
EJRVVUAJEYLdm1qbO8TzuQ: folds 
7wo6Sr7QG3Zo6BaBDV1BOw: raises $0.50 to $0.75
H5Se03ZqSX7tbULXur2MAg: folds 
DdPXdieucQ+n99u1n3A+rQ: folds 
+2kMBNpY4nF1qNCRd8SJLA: folds 
aNpwfA31EREwO+ar4XzBCw: folds 
Uncalled bet ($0.50) returned to 7wo6Sr7QG3Zo6BaBDV1BOw
7wo6Sr7QG3Zo6BaBDV1BOw collected $0.60 from pot
7wo6Sr7QG3Zo6BaBDV1BOw: doesn't show hand 
*** SUMMARY ***
Total pot $0.60 | Rake $0 
Seat 2: Ut3g/kEEdCCbe/gbWrHnDg folded before Flop (didn't bet)
Seat 3: TeWJxSETzbXGiYKx0y+dtg folded before Flop (didn't bet)
Seat 4: EJRVVUAJEYLdm1qbO8TzuQ folded before Flop (didn't bet)
Seat 5: 7wo6Sr7QG3Zo6BaBDV1BOw collected ($0.60)
Seat 6: H5Se03ZqSX7tbULXur2MAg folded before Flop (didn't bet)
Seat 7: DdPXdieucQ+n99u1n3A+rQ (button) folded before Flop (didn't bet)
Seat 8: +2kMBNpY4nF1qNCRd8SJLA (small blind) folded before Flop
Seat 9: aNpwfA31EREwO+ar4XzBCw (big blind) folded before Flop




PokerStars Game #59939404166:  Hold'em No Limit ($0.10/$0.25) - 2009/07/01 0:39:00 ET
Table '6wawJ+MkkvuC3coG6r+Yhg' 6-max Seat #4 is the button
Seat 1: ELW+DKizJhLK7k40PMkD2Q ($25 in chips) 
Seat 3: KYBwVA7jgmSrbIEbEGElVg ($18.95 in chips) 
Seat 4: cS21pIxRHx5Gt42o7hPZzw ($12.75 in chips) 
Seat 5: A8uIskXJTblhVXWuYr+lkw ($14.75 in chips) 
A8uIskXJTblhVXWuYr+lkw: posts small blind $0.10
ELW+DKizJhLK7k40PMkD2Q: posts big blind $0.25
LtASJ9OlkqGrrUKGQlpGAw: sits out 
*** HOLE CARDS ***
KYBwVA7jgmSrbIEbEGElVg: folds 
cS21pIxRHx5Gt42o7hPZzw: folds 
A8uIskXJTblhVXWuYr+lkw: calls $0.15
ELW+DKizJhLK7k40PMkD2Q: raises $0.75 to $1
A8uIskXJTblhVXWuYr+lkw: calls $0.75
*** FLOP *** [7s 9h 8d]
varanasi has returned
A8uIskXJTblhVXWuYr+lkw: checks 
ELW+DKizJhLK7k40PMkD2Q: checks 
*** TURN *** [7s 9h 8d] [5d]
A8uIskXJTblhVXWuYr+lkw: bets $1
ELW+DKizJhLK7k40PMkD2Q: folds 
Uncalled bet ($1) returned to A8uIskXJTblhVXWuYr+lkw
A8uIskXJTblhVXWuYr+lkw collected $1.90 from pot
*** SUMMARY ***
Total pot $2 | Rake $0.10 
Board [7s 9h 8d 5d]
Seat 1: ELW+DKizJhLK7k40PMkD2Q (big blind) folded on the Turn
Seat 3: KYBwVA7jgmSrbIEbEGElVg folded before Flop (didn't bet)
Seat 4: cS21pIxRHx5Gt42o7hPZzw (button) folded before Flop (didn't bet)
Seat 5: A8uIskXJTblhVXWuYr+lkw (small blind) collected ($1.90)




PokerStars Game #59939404624:  Hold'em No Limit ($0.10/$0.25) - 2009/07/01 0:39:00 ET
Table '/asc7VQ/OpF/oVJ3erB80w' 9-max Seat #6 is the button
Seat 1: OiV1PWZ3IkN29JlmCcnTwQ ($4.70 in chips) 
Seat 2: Th3FldXKQW6hWVVPahaoOQ ($25.80 in chips) 
Seat 3: ie4EwTMMFYxrCXcenJdzsw ($6.45 in chips) 
Seat 4: H9KUl8cmpLgEpOVDA00bCg ($5.25 in chips) 
Seat 5: 8B/dhbQjIWe6ASCdgzktNQ ($25.25 in chips) 
Seat 6: t2nb95S5EEFOEzNx9Itz0g ($3.60 in chips) 
Seat 7: M2QO2DxB5Wawg2h8HSpnYA ($10 in chips) 
Seat 8: T5Hk9oiIr+JDDMnEqwFCrw ($7.05 in chips) 
Seat 9: UkJraTKWQIqFeHOyHQ7afQ ($14.90 in chips) 
M2QO2DxB5Wawg2h8HSpnYA: posts small blind $0.10
T5Hk9oiIr+JDDMnEqwFCrw: posts big blind $0.25
*** HOLE CARDS ***
UkJraTKWQIqFeHOyHQ7afQ: folds 
OiV1PWZ3IkN29JlmCcnTwQ: folds 
Th3FldXKQW6hWVVPahaoOQ: folds 
ie4EwTMMFYxrCXcenJdzsw: folds 
H9KUl8cmpLgEpOVDA00bCg: folds 
8B/dhbQjIWe6ASCdgzktNQ: folds 
t2nb95S5EEFOEzNx9Itz0g: raises $0.25 to $0.50
M2QO2DxB5Wawg2h8HSpnYA: calls $0.40
T5Hk9oiIr+JDDMnEqwFCrw: calls $0.25
*** FLOP *** [4s Js Th]
M2QO2DxB5Wawg2h8HSpnYA: checks 
T5Hk9oiIr+JDDMnEqwFCrw: checks 
t2nb95S5EEFOEzNx9Itz0g: checks 
*** TURN *** [4s Js Th] [8s]
M2QO2DxB5Wawg2h8HSpnYA: bets $0.75
T5Hk9oiIr+JDDMnEqwFCrw: calls $0.75
t2nb95S5EEFOEzNx9Itz0g: folds 
*** RIVER *** [4s Js Th 8s] [4d]
M2QO2DxB5Wawg2h8HSpnYA: bets $0.75
T5Hk9oiIr+JDDMnEqwFCrw: folds 
Uncalled bet ($0.75) returned to M2QO2DxB5Wawg2h8HSpnYA
M2QO2DxB5Wawg2h8HSpnYA collected $2.90 from pot
M2QO2DxB5Wawg2h8HSpnYA: doesn't show hand 
*** SUMMARY ***
Total pot $3 | Rake $0.10 
Board [4s Js Th 8s 4d]
Seat 1: OiV1PWZ3IkN29JlmCcnTwQ folded before Flop (didn't bet)
Seat 2: Th3FldXKQW6hWVVPahaoOQ folded before Flop (didn't bet)
Seat 3: ie4EwTMMFYxrCXcenJdzsw folded before Flop (didn't bet)
Seat 4: H9KUl8cmpLgEpOVDA00bCg folded before Flop (didn't bet)
Seat 5: 8B/dhbQjIWe6ASCdgzktNQ folded before Flop (didn't bet)
Seat 6: t2nb95S5EEFOEzNx9Itz0g (button) folded on the Turn
Seat 7: M2QO2DxB5Wawg2h8HSpnYA (small blind) collected ($2.90)
Seat 8: T5Hk9oiIr+JDDMnEqwFCrw (big blind) folded on the River
Seat 9: UkJraTKWQIqFeHOyHQ7afQ folded before Flop (didn't bet)




PokerStars Game #59939404498:  Hold'em No Limit ($0.10/$0.25) - 2009/07/01 0:39:00 ET
Table 'FBhJjLqab11/gKu8nyB/tw' 9-max Seat #3 is the button
Seat 1: +sbyWwIcFp9kP0bDtMegfQ ($21.80 in chips) 
Seat 2: 1pwQJV/Xr0GWPRefx/78VQ ($2.05 in chips) 
Seat 3: uy9x0X5l7O+IpGjLa77QgQ ($26.90 in chips) 
Seat 4: OTC1Bh+DhK778Qnsj6D8+A ($24.75 in chips) 
Seat 5: vZGoOTJLQLhkPj4I+LNGig ($45.25 in chips) 
Seat 6: QrNgXJWFdS+POsPJcil4aA ($19.85 in chips) 
Seat 7: 5Fj9JGGxQT7Djr6AyIiBVA ($24.90 in chips) 
Seat 8: 9lE3Zc4pjmKpQK8rDF1aaQ ($20.20 in chips) 
Seat 9: BEIBUu2pIflPrCL+Iks4CQ ($12.15 in chips) 
OTC1Bh+DhK778Qnsj6D8+A: posts small blind $0.10
vZGoOTJLQLhkPj4I+LNGig: posts big blind $0.25
*** HOLE CARDS ***
QrNgXJWFdS+POsPJcil4aA: folds 
5Fj9JGGxQT7Djr6AyIiBVA: folds 
9lE3Zc4pjmKpQK8rDF1aaQ: folds 
BEIBUu2pIflPrCL+Iks4CQ: folds 
+sbyWwIcFp9kP0bDtMegfQ: folds 
1pwQJV/Xr0GWPRefx/78VQ: folds 
uy9x0X5l7O+IpGjLa77QgQ: folds 
OTC1Bh+DhK778Qnsj6D8+A: calls $0.15
vZGoOTJLQLhkPj4I+LNGig: checks 
*** FLOP *** [Ad 5s 9c]
OTC1Bh+DhK778Qnsj6D8+A: checks 
vZGoOTJLQLhkPj4I+LNGig: checks 
*** TURN *** [Ad 5s 9c] [9h]
OTC1Bh+DhK778Qnsj6D8+A: checks 
vZGoOTJLQLhkPj4I+LNGig: checks 
*** RIVER *** [Ad 5s 9c 9h] [9s]
OTC1Bh+DhK778Qnsj6D8+A: checks 
vZGoOTJLQLhkPj4I+LNGig: checks 
*** SHOW DOWN ***
OTC1Bh+DhK778Qnsj6D8+A: shows [6h Qh] (three of a kind, Nines)
vZGoOTJLQLhkPj4I+LNGig: shows [3c Kd] (three of a kind, Nines - Ace+King kicker)
vZGoOTJLQLhkPj4I+LNGig collected $0.50 from pot
*** SUMMARY ***
Total pot $0.50 | Rake $0 
Board [Ad 5s 9c 9h 9s]
Seat 1: +sbyWwIcFp9kP0bDtMegfQ folded before Flop (didn't bet)
Seat 2: 1pwQJV/Xr0GWPRefx/78VQ folded before Flop (didn't bet)
Seat 3: uy9x0X5l7O+IpGjLa77QgQ (button) folded before Flop (didn't bet)
Seat 4: OTC1Bh+DhK778Qnsj6D8+A (small blind) showed [6h Qh] and lost with three of a kind, Nines
Seat 5: vZGoOTJLQLhkPj4I+LNGig (big blind) showed [3c Kd] and won ($0.50) with three of a kind, Nines
Seat 6: QrNgXJWFdS+POsPJcil4aA folded before Flop (didn't bet)
Seat 7: 5Fj9JGGxQT7Djr6AyIiBVA folded before Flop (didn't bet)
Seat 8: 9lE3Zc4pjmKpQK8rDF1aaQ folded before Flop (didn't bet)
Seat 9: BEIBUu2pIflPrCL+Iks4CQ folded before Flop (didn't bet)




PokerStars Game #59939404168:  Hold'em No Limit ($0.10/$0.25) - 2009/07/01 0:39:00 ET
Table 'aisAlB9GIV21BwfUW3+Nbg' 9-max Seat #6 is the button
Seat 1: H5Se03ZqSX7tbULXur2MAg ($22.70 in chips) 
Seat 2: 18G4P1XstjNvItdGUITxgw ($25 in chips) 
Seat 3: aaNpjkDAbOD7pVe8Z5CEgQ ($24.25 in chips) 
Seat 4: Z9AeOQX3yzuSvKAm/xyovg ($10 in chips) 
Seat 5: ghNKXUBl/H+t83JF079ZBA ($25 in chips) 
Seat 6: 9gmYYQesalMrUjaF7nKfrQ ($9.65 in chips) 
Seat 7: sWBBy1WroEskLNyJzhkUag ($13.50 in chips) 
Seat 8: VWUWpMLMj/Q1jRVpF7Aohw ($14.40 in chips) 
Seat 9: OlPJsgR4xypSg/w1z7Gyvw ($29.15 in chips) 
sWBBy1WroEskLNyJzhkUag: posts small blind $0.10
VWUWpMLMj/Q1jRVpF7Aohw: posts big blind $0.25
*** HOLE CARDS ***
OlPJsgR4xypSg/w1z7Gyvw: folds 
H5Se03ZqSX7tbULXur2MAg: folds 
18G4P1XstjNvItdGUITxgw: folds 
aaNpjkDAbOD7pVe8Z5CEgQ: calls $0.25
Z9AeOQX3yzuSvKAm/xyovg: folds 
ghNKXUBl/H+t83JF079ZBA: folds 
9gmYYQesalMrUjaF7nKfrQ: folds 
sWBBy1WroEskLNyJzhkUag: calls $0.15
VWUWpMLMj/Q1jRVpF7Aohw: checks 
*** FLOP *** [Tc 9s 2c]
sWBBy1WroEskLNyJzhkUag: checks 
VWUWpMLMj/Q1jRVpF7Aohw: checks 
aaNpjkDAbOD7pVe8Z5CEgQ: checks 
*** TURN *** [Tc 9s 2c] [As]
sWBBy1WroEskLNyJzhkUag: checks 
VWUWpMLMj/Q1jRVpF7Aohw: checks 
aaNpjkDAbOD7pVe8Z5CEgQ: checks 
*** RIVER *** [Tc 9s 2c As] [Qc]
sWBBy1WroEskLNyJzhkUag: checks 
VWUWpMLMj/Q1jRVpF7Aohw: checks 
aaNpjkDAbOD7pVe8Z5CEgQ: checks 
*** SHOW DOWN ***
sWBBy1WroEskLNyJzhkUag: shows [Jh 6c] (high card Ace)
VWUWpMLMj/Q1jRVpF7Aohw: mucks hand 
aaNpjkDAbOD7pVe8Z5CEgQ: mucks hand 
sWBBy1WroEskLNyJzhkUag collected $0.75 from pot
*** SUMMARY ***
Total pot $0.75 | Rake $0 
Board [Tc 9s 2c As Qc]
Seat 1: H5Se03ZqSX7tbULXur2MAg folded before Flop (didn't bet)
Seat 2: 18G4P1XstjNvItdGUITxgw folded before Flop (didn't bet)
Seat 3: aaNpjkDAbOD7pVe8Z5CEgQ mucked
Seat 4: Z9AeOQX3yzuSvKAm/xyovg folded before Flop (didn't bet)
Seat 5: ghNKXUBl/H+t83JF079ZBA folded before Flop (didn't bet)
Seat 6: 9gmYYQesalMrUjaF7nKfrQ (button) folded before Flop (didn't bet)
Seat 7: sWBBy1WroEskLNyJzhkUag (small blind) showed [Jh 6c] and won ($0.75) with high card Ace
Seat 8: VWUWpMLMj/Q1jRVpF7Aohw (big blind) mucked
Seat 9: OlPJsgR4xypSg/w1z7Gyvw folded before Flop (didn't bet)




PokerStars Game #59939404350:  Hold'em No Limit ($0.10/$0.25) - 2009/07/01 0:39:00 ET
Table 'i8VqsSY3xDtJ63IHleN8+A' 9-max Seat #8 is the button
Seat 1: D3XCkXRktDfPlSguxwfnRA ($15.30 in chips) 
Seat 2: SXqVW4Q0evTUVZG6BbUNIA ($47 in chips) 
Seat 3: HPEB+AtKw1+C/cxU0o1ciw ($56.20 in chips) 
Seat 4: G2offPrpnppc++nuXqs2JA ($15.15 in chips) 
Seat 5: DIBbjEYGs+TVdVgEB/4+3w ($24.90 in chips) 
Seat 6: Xpyqpb+DURDWnyJ3xTEIFQ ($24.75 in chips) 
Seat 7: j4q3p0lesp63b1gZDwLBZw ($6 in chips) 
Seat 8: 5MgYq10OC5iGoxQFwlJVuw ($12.70 in chips) 
Seat 9: vSkQm2EelzwRGDDQQk0Fqw ($6.35 in chips) 
vSkQm2EelzwRGDDQQk0Fqw: posts small blind $0.10
D3XCkXRktDfPlSguxwfnRA: posts big blind $0.25
*** HOLE CARDS ***
SXqVW4Q0evTUVZG6BbUNIA: folds 
HPEB+AtKw1+C/cxU0o1ciw: folds 
G2offPrpnppc++nuXqs2JA: folds 
DIBbjEYGs+TVdVgEB/4+3w: folds 
Xpyqpb+DURDWnyJ3xTEIFQ: folds 
j4q3p0lesp63b1gZDwLBZw: folds 
5MgYq10OC5iGoxQFwlJVuw: folds 
vSkQm2EelzwRGDDQQk0Fqw: folds 
Uncalled bet ($0.15) returned to D3XCkXRktDfPlSguxwfnRA
D3XCkXRktDfPlSguxwfnRA collected $0.20 from pot
*** SUMMARY ***
Total pot $0.20 | Rake $0 
Seat 1: D3XCkXRktDfPlSguxwfnRA (big blind) collected ($0.20)
Seat 2: SXqVW4Q0evTUVZG6BbUNIA folded before Flop (didn't bet)
Seat 3: HPEB+AtKw1+C/cxU0o1ciw folded before Flop (didn't bet)
Seat 4: G2offPrpnppc++nuXqs2JA folded before Flop (didn't bet)
Seat 5: DIBbjEYGs+TVdVgEB/4+3w folded before Flop (didn't bet)
Seat 6: Xpyqpb+DURDWnyJ3xTEIFQ folded before Flop (didn't bet)
Seat 7: j4q3p0lesp63b1gZDwLBZw folded before Flop (didn't bet)
Seat 8: 5MgYq10OC5iGoxQFwlJVuw (button) folded before Flop (didn't bet)
Seat 9: vSkQm2EelzwRGDDQQk0Fqw (small blind) folded before Flop




PokerStars Game #59939404358:  Hold'em No Limit ($0.10/$0.25) - 2009/07/01 0:39:00 ET
Table 'IdXp6nyeW4FYaEK4qKCnwQ' 9-max Seat #6 is the button
Seat 1: oZXtkl8jsN0rrT7D/pQTHA ($13.75 in chips) 
Seat 2: HPEB+AtKw1+C/cxU0o1ciw ($28.90 in chips) 
Seat 3: jiyia7h6fmxBdWBkH9lH5A ($3.70 in chips) 
Seat 6: 1K6QGyJP9P9xmRac2fH4OQ ($35.10 in chips) 
Seat 7: CYkY0dNBaYaKs8HVCVn3mQ ($6.40 in chips) 
Seat 8: cZ99hugmLBj9KhTlc8nCSw ($25 in chips) 
Seat 9: 4dd+rKHhaMiTl5LEkADvQQ ($4.90 in chips) 
CYkY0dNBaYaKs8HVCVn3mQ: posts small blind $0.10
cZ99hugmLBj9KhTlc8nCSw: posts big blind $0.25
*** HOLE CARDS ***
4dd+rKHhaMiTl5LEkADvQQ: folds 
oZXtkl8jsN0rrT7D/pQTHA: folds 
HPEB+AtKw1+C/cxU0o1ciw: folds 
jiyia7h6fmxBdWBkH9lH5A: folds 
4dd+rKHhaMiTl5LEkADvQQ leaves the table
1K6QGyJP9P9xmRac2fH4OQ: raises $0.55 to $0.80
CYkY0dNBaYaKs8HVCVn3mQ: calls $0.70
cZ99hugmLBj9KhTlc8nCSw: folds 
*** FLOP *** [Ks 4d 3h]
CYkY0dNBaYaKs8HVCVn3mQ: checks 
1K6QGyJP9P9xmRac2fH4OQ: bets $1.20
CYkY0dNBaYaKs8HVCVn3mQ: raises $1.30 to $2.50
jiyia7h6fmxBdWBkH9lH5A is sitting out
1K6QGyJP9P9xmRac2fH4OQ: folds 
Uncalled bet ($1.30) returned to CYkY0dNBaYaKs8HVCVn3mQ
CYkY0dNBaYaKs8HVCVn3mQ collected $4.05 from pot
CYkY0dNBaYaKs8HVCVn3mQ: doesn't show hand 
*** SUMMARY ***
Total pot $4.25 | Rake $0.20 
Board [Ks 4d 3h]
Seat 1: oZXtkl8jsN0rrT7D/pQTHA folded before Flop (didn't bet)
Seat 2: HPEB+AtKw1+C/cxU0o1ciw folded before Flop (didn't bet)
Seat 3: jiyia7h6fmxBdWBkH9lH5A folded before Flop (didn't bet)
Seat 6: 1K6QGyJP9P9xmRac2fH4OQ (button) folded on the Flop
Seat 7: CYkY0dNBaYaKs8HVCVn3mQ (small blind) collected ($4.05)
Seat 8: cZ99hugmLBj9KhTlc8nCSw (big blind) folded before Flop
Seat 9: 4dd+rKHhaMiTl5LEkADvQQ folded before Flop (didn't bet)




PokerStars Game #59939404644:  Hold'em No Limit ($0.10/$0.25) - 2009/07/01 0:39:00 ET
Table '0M5QEJGOThqZwQ/sjbjXYw' 6-max Seat #1 is the button
Seat 1: RVBrV53KVTJ2T2VL8ucnfw ($24.55 in chips) 
Seat 2: /gJNBeCkWL4o85/jvlZ4BA ($39.95 in chips) 
Seat 4: fZQg9veL7Dd/Z04ZTjC+wQ ($40.95 in chips) 
Seat 5: ErIN0JRL5srYjT6en1f8YQ ($26.85 in chips) 
Seat 6: mYz11CHiw5KsDCRD5T7/jg ($59.85 in chips) 
/gJNBeCkWL4o85/jvlZ4BA: posts small blind $0.10
fZQg9veL7Dd/Z04ZTjC+wQ: posts big blind $0.25
*** HOLE CARDS ***
ErIN0JRL5srYjT6en1f8YQ: folds 
mYz11CHiw5KsDCRD5T7/jg: folds 
RVBrV53KVTJ2T2VL8ucnfw: calls $0.25
/gJNBeCkWL4o85/jvlZ4BA: raises $1 to $1.25
fZQg9veL7Dd/Z04ZTjC+wQ: raises $2.50 to $3.75
RVBrV53KVTJ2T2VL8ucnfw: folds 
/gJNBeCkWL4o85/jvlZ4BA: calls $2.50
*** FLOP *** [As 7s Ac]
/gJNBeCkWL4o85/jvlZ4BA: bets $5
fZQg9veL7Dd/Z04ZTjC+wQ: calls $5
*** TURN *** [As 7s Ac] [9d]
/gJNBeCkWL4o85/jvlZ4BA: bets $31.20 and is all-in
fZQg9veL7Dd/Z04ZTjC+wQ: folds 
Uncalled bet ($31.20) returned to /gJNBeCkWL4o85/jvlZ4BA
/gJNBeCkWL4o85/jvlZ4BA collected $16.90 from pot
*** SUMMARY ***
Total pot $17.75 | Rake $0.85 
Board [As 7s Ac 9d]
Seat 1: RVBrV53KVTJ2T2VL8ucnfw (button) folded before Flop
Seat 2: /gJNBeCkWL4o85/jvlZ4BA (small blind) collected ($16.90)
Seat 4: fZQg9veL7Dd/Z04ZTjC+wQ (big blind) folded on the Turn
Seat 5: ErIN0JRL5srYjT6en1f8YQ folded before Flop (didn't bet)
Seat 6: mYz11CHiw5KsDCRD5T7/jg folded before Flop (didn't bet)




PokerStars Game #59939404918:  Hold'em No Limit ($0.10/$0.25) - 2009/07/01 0:39:01 ET
Table 'NtEQAxCeIK2io1CGtW658g' 6-max Seat #4 is the button
Seat 1: lnOV7k25gyN7L5t5YKTgIg ($20.50 in chips) 
Seat 2: nc79pm0LZRdhncq55evVqA ($25.90 in chips) 
Seat 4: 8296 ($12 in chips) 
Seat 5: FStoHe64SQWqAsjya9pDkQ ($27.60 in chips) 
Seat 6: /gJNBeCkWL4o85/jvlZ4BA ($62.35 in chips) 
FStoHe64SQWqAsjya9pDkQ: posts small blind $0.10
/gJNBeCkWL4o85/jvlZ4BA: posts big blind $0.25
m2yWOKfAxqHoy5DDN87Ttw: sits out 
*** HOLE CARDS ***
lnOV7k25gyN7L5t5YKTgIg: folds 
nc79pm0LZRdhncq55evVqA: folds 
8296: folds 
FStoHe64SQWqAsjya9pDkQ: raises $0.50 to $0.75
/gJNBeCkWL4o85/jvlZ4BA: folds 
Uncalled bet ($0.50) returned to FStoHe64SQWqAsjya9pDkQ
FStoHe64SQWqAsjya9pDkQ collected $0.50 from pot
FStoHe64SQWqAsjya9pDkQ: doesn't show hand 
*** SUMMARY ***
Total pot $0.50 | Rake $0 
Seat 1: lnOV7k25gyN7L5t5YKTgIg folded before Flop (didn't bet)
Seat 2: nc79pm0LZRdhncq55evVqA folded before Flop (didn't bet)
Seat 4: 8296 (button) folded before Flop (didn't bet)
Seat 5: FStoHe64SQWqAsjya9pDkQ (small blind) collected ($0.50)
Seat 6: /gJNBeCkWL4o85/jvlZ4BA (big blind) folded before Flop




PokerStars Game #59939405298:  Hold'em No Limit ($0.10/$0.25) - 2009/07/01 0:39:01 ET
Table 'VQNfcI8vTBCTvRfd3veTLQ' 6-max Seat #4 is the button
Seat 1: ymz+a8dgHSUFPooYplw7Ow ($23.50 in chips) 
Seat 2: KukIGupqqJCXA+Hp2bEFnA ($6.70 in chips) 
Seat 3: LtASJ9OlkqGrrUKGQlpGAw ($23.40 in chips) 
Seat 4: nc79pm0LZRdhncq55evVqA ($25.80 in chips) 
Seat 5: gX2vbKwS/8zZPENAWB7hxQ ($7.75 in chips) 
Seat 6: dlCLwmcvRShnuFDEVkdIEA ($15.10 in chips) 
gX2vbKwS/8zZPENAWB7hxQ: posts small blind $0.10
dlCLwmcvRShnuFDEVkdIEA: posts big blind $0.25
*** HOLE CARDS ***
ymz+a8dgHSUFPooYplw7Ow: calls $0.25
KukIGupqqJCXA+Hp2bEFnA: calls $0.25
LtASJ9OlkqGrrUKGQlpGAw: folds 
nc79pm0LZRdhncq55evVqA: folds 
gX2vbKwS/8zZPENAWB7hxQ: folds 
dlCLwmcvRShnuFDEVkdIEA: checks 
*** FLOP *** [9c Tc 2h]
dlCLwmcvRShnuFDEVkdIEA: checks 
ymz+a8dgHSUFPooYplw7Ow: bets $0.50
KukIGupqqJCXA+Hp2bEFnA: folds 
dlCLwmcvRShnuFDEVkdIEA: folds 
Uncalled bet ($0.50) returned to ymz+a8dgHSUFPooYplw7Ow
ymz+a8dgHSUFPooYplw7Ow collected $0.85 from pot
ymz+a8dgHSUFPooYplw7Ow: doesn't show hand 
*** SUMMARY ***
Total pot $0.85 | Rake $0 
Board [9c Tc 2h]
Seat 1: ymz+a8dgHSUFPooYplw7Ow collected ($0.85)
Seat 2: KukIGupqqJCXA+Hp2bEFnA folded on the Flop
Seat 3: LtASJ9OlkqGrrUKGQlpGAw folded before Flop (didn't bet)
Seat 4: nc79pm0LZRdhncq55evVqA (button) folded before Flop (didn't bet)
Seat 5: gX2vbKwS/8zZPENAWB7hxQ (small blind) folded before Flop
Seat 6: dlCLwmcvRShnuFDEVkdIEA (big blind) folded on the Flop




PokerStars Game #59939405062:  Hold'em No Limit ($0.10/$0.25) - 2009/07/01 0:39:01 ET
Table 'RUOqTfzbAVGS5x+J9aZMHA' 9-max Seat #6 is the button
Seat 1: KBBTLXGhPdPj+4X0QKMkcg ($15.60 in chips) 
Seat 2: Z5ZtGOON8kmSdSCll9Z3XA ($6.70 in chips) 
Seat 4: 18G4P1XstjNvItdGUITxgw ($29 in chips) 
Seat 5: opOCI2p6kW0tINuVaAqmcQ ($25 in chips) 
Seat 6: ljemhp25Zg+nlA9DLCIiUw ($33.45 in chips) 
Seat 8: 3RCAkueG3Vc13VpRStCB+w ($24.20 in chips) 
3RCAkueG3Vc13VpRStCB+w: posts small blind $0.10
KBBTLXGhPdPj+4X0QKMkcg: posts big blind $0.25
*** HOLE CARDS ***
Z5ZtGOON8kmSdSCll9Z3XA: folds 
18G4P1XstjNvItdGUITxgw: folds 
opOCI2p6kW0tINuVaAqmcQ: raises $0.50 to $0.75
ljemhp25Zg+nlA9DLCIiUw: folds 
3RCAkueG3Vc13VpRStCB+w: folds 
KBBTLXGhPdPj+4X0QKMkcg: calls $0.50
*** FLOP *** [5h Jd Tc]
KBBTLXGhPdPj+4X0QKMkcg: bets $0.25
opOCI2p6kW0tINuVaAqmcQ: calls $0.25
*** TURN *** [5h Jd Tc] [4s]
HxDF4QSxC4z39D7teZpprQ joins the table at seat #7 
KBBTLXGhPdPj+4X0QKMkcg: bets $0.50
opOCI2p6kW0tINuVaAqmcQ: calls $0.50
*** RIVER *** [5h Jd Tc 4s] [Qc]
KBBTLXGhPdPj+4X0QKMkcg: bets $0.50
opOCI2p6kW0tINuVaAqmcQ: raises $23 to $23.50 and is all-in
KBBTLXGhPdPj+4X0QKMkcg: folds 
Uncalled bet ($23) returned to opOCI2p6kW0tINuVaAqmcQ
opOCI2p6kW0tINuVaAqmcQ collected $3.95 from pot
opOCI2p6kW0tINuVaAqmcQ: doesn't show hand 
*** SUMMARY ***
Total pot $4.10 | Rake $0.15 
Board [5h Jd Tc 4s Qc]
Seat 1: KBBTLXGhPdPj+4X0QKMkcg (big blind) folded on the River
Seat 2: Z5ZtGOON8kmSdSCll9Z3XA folded before Flop (didn't bet)
Seat 4: 18G4P1XstjNvItdGUITxgw folded before Flop (didn't bet)
Seat 5: opOCI2p6kW0tINuVaAqmcQ collected ($3.95)
Seat 6: ljemhp25Zg+nlA9DLCIiUw (button) folded before Flop (didn't bet)
Seat 8: 3RCAkueG3Vc13VpRStCB+w (small blind) folded before Flop




PokerStars Game #59939404882:  Hold'em No Limit ($0.10/$0.25) - 2009/07/01 0:39:01 ET
Table 'yZgGBnUGXVCcEJdcqes8tw' 9-max Seat #6 is the button
Seat 1: SXqVW4Q0evTUVZG6BbUNIA ($24.05 in chips) 
Seat 2: MG90wfSJZnOejs/KD3vlQQ ($25 in chips) 
Seat 3: z5GxcHlYz/GSz6W2uFiTtg ($26.65 in chips) 
Seat 4: opOCI2p6kW0tINuVaAqmcQ ($25.35 in chips) 
Seat 5: IGz29GAFM1DpSdXX+wXg3g ($16.10 in chips) 
Seat 6: H9i0g723A2AKb4nSMXqMPQ ($19.95 in chips) 
Seat 7: eC8Pn1D6Y2pct8o62nQfvQ ($28.15 in chips) 
Seat 8: dmYlc+1cjwZMJ7wV+Z0rRg ($24.90 in chips) 
Seat 9: M/9j4wkHH9i1JM51vgi1VA ($31.35 in chips) 
eC8Pn1D6Y2pct8o62nQfvQ: posts small blind $0.10
dmYlc+1cjwZMJ7wV+Z0rRg: posts big blind $0.25
*** HOLE CARDS ***
M/9j4wkHH9i1JM51vgi1VA: folds 
SXqVW4Q0evTUVZG6BbUNIA: folds 
MG90wfSJZnOejs/KD3vlQQ: folds 
z5GxcHlYz/GSz6W2uFiTtg: folds 
opOCI2p6kW0tINuVaAqmcQ: raises $0.50 to $0.75
IGz29GAFM1DpSdXX+wXg3g: folds 
H9i0g723A2AKb4nSMXqMPQ: folds 
eC8Pn1D6Y2pct8o62nQfvQ: folds 
dmYlc+1cjwZMJ7wV+Z0rRg: folds 
Uncalled bet ($0.50) returned to opOCI2p6kW0tINuVaAqmcQ
opOCI2p6kW0tINuVaAqmcQ collected $0.60 from pot
opOCI2p6kW0tINuVaAqmcQ: doesn't show hand 
*** SUMMARY ***
Total pot $0.60 | Rake $0 
Seat 1: SXqVW4Q0evTUVZG6BbUNIA folded before Flop (didn't bet)
Seat 2: MG90wfSJZnOejs/KD3vlQQ folded before Flop (didn't bet)
Seat 3: z5GxcHlYz/GSz6W2uFiTtg folded before Flop (didn't bet)
Seat 4: opOCI2p6kW0tINuVaAqmcQ collected ($0.60)
Seat 5: IGz29GAFM1DpSdXX+wXg3g folded before Flop (didn't bet)
Seat 6: H9i0g723A2AKb4nSMXqMPQ (button) folded before Flop (didn't bet)
Seat 7: eC8Pn1D6Y2pct8o62nQfvQ (small blind) folded before Flop
Seat 8: dmYlc+1cjwZMJ7wV+Z0rRg (big blind) folded before Flop
Seat 9: M/9j4wkHH9i1JM51vgi1VA folded before Flop (didn't bet)




PokerStars Game #59939404924:  Hold'em No Limit ($0.10/$0.25) - 2009/07/01 0:39:01 ET
Table 'YlRA05h9BJ1EhOUSNUjJdg' 9-max Seat #6 is the button
Seat 2: Y2GFAe+PT7xnUUtgqCNDFw ($16.80 in chips) 
Seat 3: C91Mv1usdi9Vq9ljlQVsug ($54.30 in chips) 
Seat 4: HPEB+AtKw1+C/cxU0o1ciw ($30.70 in chips) 
Seat 5: oKO7b50N6TzXbPBr/mcrUA ($24.05 in chips) 
Seat 6: GMMsoUkaAAY5/vm1Kmh9pA ($15.95 in chips) 
Seat 7: oVDuzcEt1umAPOB/u6ZH9g ($25.45 in chips) 
Seat 8: j4q3p0lesp63b1gZDwLBZw ($5 in chips) 
Seat 9: hBMUlEpyU74r/fwDgIpXjQ ($25 in chips) 
oVDuzcEt1umAPOB/u6ZH9g: posts small blind $0.10
j4q3p0lesp63b1gZDwLBZw: posts big blind $0.25
5gHh6iDvZdEvYi59Pko1iA: sits out 
*** HOLE CARDS ***
oVDuzcEt1umAPOB/u6ZH9g said, "K/3"
hBMUlEpyU74r/fwDgIpXjQ: folds 
Y2GFAe+PT7xnUUtgqCNDFw: calls $0.25
C91Mv1usdi9Vq9ljlQVsug: folds 
HPEB+AtKw1+C/cxU0o1ciw: folds 
oKO7b50N6TzXbPBr/mcrUA: folds 
GMMsoUkaAAY5/vm1Kmh9pA: raises $1 to $1.25
oVDuzcEt1umAPOB/u6ZH9g: folds 
j4q3p0lesp63b1gZDwLBZw: folds 
Y2GFAe+PT7xnUUtgqCNDFw: calls $1
*** FLOP *** [6h As 3s]
Y2GFAe+PT7xnUUtgqCNDFw: checks 
GMMsoUkaAAY5/vm1Kmh9pA: checks 
*** TURN *** [6h As 3s] [Jh]
Y2GFAe+PT7xnUUtgqCNDFw: checks 
GMMsoUkaAAY5/vm1Kmh9pA: checks 
*** RIVER *** [6h As 3s Jh] [Jc]
Y2GFAe+PT7xnUUtgqCNDFw: bets $1
GMMsoUkaAAY5/vm1Kmh9pA: calls $1
*** SHOW DOWN ***
Y2GFAe+PT7xnUUtgqCNDFw: shows [Ah Jd] (a full house, Jacks full of Aces)
GMMsoUkaAAY5/vm1Kmh9pA: mucks hand 
Y2GFAe+PT7xnUUtgqCNDFw collected $4.65 from pot
*** SUMMARY ***
Total pot $4.85 | Rake $0.20 
Board [6h As 3s Jh Jc]
Seat 2: Y2GFAe+PT7xnUUtgqCNDFw showed [Ah Jd] and won ($4.65) with a full house, Jacks full of Aces
Seat 3: C91Mv1usdi9Vq9ljlQVsug folded before Flop (didn't bet)
Seat 4: HPEB+AtKw1+C/cxU0o1ciw folded before Flop (didn't bet)
Seat 5: oKO7b50N6TzXbPBr/mcrUA folded before Flop (didn't bet)
Seat 6: GMMsoUkaAAY5/vm1Kmh9pA (button) mucked
Seat 7: oVDuzcEt1umAPOB/u6ZH9g (small blind) folded before Flop
Seat 8: j4q3p0lesp63b1gZDwLBZw (big blind) folded before Flop
Seat 9: hBMUlEpyU74r/fwDgIpXjQ folded before Flop (didn't bet)




PokerStars Game #59939405460:  Hold'em No Limit ($0.10/$0.25) - 2009/07/01 0:39:02 ET
Table 'ONP9SkU1SytzTLuNlKzIPw' 9-max Seat #1 is the button
Seat 1: s7Q6uNouhe7aE8JdFb9E+A ($34.70 in chips) 
Seat 2: sJNHTWcSlLHRCZ9+YRLLqA ($25.60 in chips) 
Seat 3: 4BZw8NrbfRfUJKKKd1c2vA ($9.75 in chips) 
Seat 4: rKgOH+UzKBirOiqIwBD9Nw ($13.40 in chips) 
Seat 5: lSeLm4BdnSMLtIli62qjAQ ($4.75 in chips) 
Seat 6: 6X6eofOkuCCdkJdReOpjUQ ($16.25 in chips) 
Seat 7: DiSvPC2iudwL5j9u6Huyww ($26.20 in chips) 
Seat 8: sUVgUtgbfVx6JpvApozwhQ ($5 in chips) 
sJNHTWcSlLHRCZ9+YRLLqA: posts small blind $0.10
4BZw8NrbfRfUJKKKd1c2vA: posts big blind $0.25
yyG4svzOpC1A+sUP/scg6w: sits out 
*** HOLE CARDS ***
rKgOH+UzKBirOiqIwBD9Nw: calls $0.25
lSeLm4BdnSMLtIli62qjAQ: calls $0.25
6X6eofOkuCCdkJdReOpjUQ: raises $0.25 to $0.50
DiSvPC2iudwL5j9u6Huyww: folds 
sUVgUtgbfVx6JpvApozwhQ: raises $1 to $1.50
s7Q6uNouhe7aE8JdFb9E+A: folds 
sJNHTWcSlLHRCZ9+YRLLqA: folds 
4BZw8NrbfRfUJKKKd1c2vA: folds 
rKgOH+UzKBirOiqIwBD9Nw: calls $1.25
lSeLm4BdnSMLtIli62qjAQ: folds 
6X6eofOkuCCdkJdReOpjUQ: calls $1
*** FLOP *** [8d Qc 2h]
rKgOH+UzKBirOiqIwBD9Nw: bets $0.75
6X6eofOkuCCdkJdReOpjUQ: calls $0.75
sUVgUtgbfVx6JpvApozwhQ: calls $0.75
*** TURN *** [8d Qc 2h] [Th]
rKgOH+UzKBirOiqIwBD9Nw: bets $1.50
6X6eofOkuCCdkJdReOpjUQ: calls $1.50
sUVgUtgbfVx6JpvApozwhQ: folds 
*** RIVER *** [8d Qc 2h Th] [Jh]
rKgOH+UzKBirOiqIwBD9Nw: checks 
6X6eofOkuCCdkJdReOpjUQ: bets $3
rKgOH+UzKBirOiqIwBD9Nw: calls $3
*** SHOW DOWN ***
6X6eofOkuCCdkJdReOpjUQ: shows [Ad Kd] (a straight, Ten to Ace)
rKgOH+UzKBirOiqIwBD9Nw: mucks hand 
6X6eofOkuCCdkJdReOpjUQ collected $15.60 from pot
*** SUMMARY ***
Total pot $16.35 | Rake $0.75 
Board [8d Qc 2h Th Jh]
Seat 1: s7Q6uNouhe7aE8JdFb9E+A (button) folded before Flop (didn't bet)
Seat 2: sJNHTWcSlLHRCZ9+YRLLqA (small blind) folded before Flop
Seat 3: 4BZw8NrbfRfUJKKKd1c2vA (big blind) folded before Flop
Seat 4: rKgOH+UzKBirOiqIwBD9Nw mucked
Seat 5: lSeLm4BdnSMLtIli62qjAQ folded before Flop
Seat 6: 6X6eofOkuCCdkJdReOpjUQ showed [Ad Kd] and won ($15.60) with a straight, Ten to Ace
Seat 7: DiSvPC2iudwL5j9u6Huyww folded before Flop (didn't bet)
Seat 8: sUVgUtgbfVx6JpvApozwhQ folded on the Turn




PokerStars Game #59939405840:  Hold'em No Limit ($0.10/$0.25) - 2009/07/01 0:39:02 ET
Table 'R5f24ws6hGXlbvjq9ej+1Q' 9-max Seat #1 is the button
Seat 1: TeWJxSETzbXGiYKx0y+dtg ($26.30 in chips) 
Seat 2: 8lk6dG3H7iS/67/biw/vcQ ($27.05 in chips) 
Seat 4: jM9ExRdqCqq2e6TjpOBoRw ($16.70 in chips) 
Seat 5: YMlMWbkusacDBjx3A8lphw ($6.50 in chips) 
Seat 6: hPhp/RE3cJ5YGaQ2xOHXXg ($9.95 in chips) 
Seat 7: Z5ZtGOON8kmSdSCll9Z3XA ($8.35 in chips) 
Seat 8: qwr38jl5txoR36M7G5qi4A ($7.60 in chips) 
Seat 9: 33y9+GmQ3J84RvZXcraRTw ($27.65 in chips) 
8lk6dG3H7iS/67/biw/vcQ: posts small blind $0.10
jM9ExRdqCqq2e6TjpOBoRw: posts big blind $0.25
*** HOLE CARDS ***
YMlMWbkusacDBjx3A8lphw: folds 
hPhp/RE3cJ5YGaQ2xOHXXg: folds 
Z5ZtGOON8kmSdSCll9Z3XA: folds 
qwr38jl5txoR36M7G5qi4A: folds 
33y9+GmQ3J84RvZXcraRTw: calls $0.25
TeWJxSETzbXGiYKx0y+dtg: folds 
8lk6dG3H7iS/67/biw/vcQ: calls $0.15
jM9ExRdqCqq2e6TjpOBoRw: checks 
*** FLOP *** [Js Qh Kd]
8lk6dG3H7iS/67/biw/vcQ: checks 
jM9ExRdqCqq2e6TjpOBoRw: checks 
33y9+GmQ3J84RvZXcraRTw: checks 
*** TURN *** [Js Qh Kd] [5d]
8lk6dG3H7iS/67/biw/vcQ: checks 
jM9ExRdqCqq2e6TjpOBoRw: bets $0.25
33y9+GmQ3J84RvZXcraRTw: folds 
8lk6dG3H7iS/67/biw/vcQ: calls $0.25
*** RIVER *** [Js Qh Kd 5d] [7d]
8lk6dG3H7iS/67/biw/vcQ: checks 
jM9ExRdqCqq2e6TjpOBoRw: bets $0.50
8lk6dG3H7iS/67/biw/vcQ: folds 
Uncalled bet ($0.50) returned to jM9ExRdqCqq2e6TjpOBoRw
jM9ExRdqCqq2e6TjpOBoRw collected $1.20 from pot
jM9ExRdqCqq2e6TjpOBoRw: doesn't show hand 
*** SUMMARY ***
Total pot $1.25 | Rake $0.05 
Board [Js Qh Kd 5d 7d]
Seat 1: TeWJxSETzbXGiYKx0y+dtg (button) folded before Flop (didn't bet)
Seat 2: 8lk6dG3H7iS/67/biw/vcQ (small blind) folded on the River
Seat 4: jM9ExRdqCqq2e6TjpOBoRw (big blind) collected ($1.20)
Seat 5: YMlMWbkusacDBjx3A8lphw folded before Flop (didn't bet)
Seat 6: hPhp/RE3cJ5YGaQ2xOHXXg folded before Flop (didn't bet)
Seat 7: Z5ZtGOON8kmSdSCll9Z3XA folded before Flop (didn't bet)
Seat 8: qwr38jl5txoR36M7G5qi4A folded before Flop (didn't bet)
Seat 9: 33y9+GmQ3J84RvZXcraRTw folded on the Turn




PokerStars Game #59939406028:  Hold'em No Limit ($0.10/$0.25) - 2009/07/01 0:39:02 ET
Table 'Mef6A0EMopL6WaFO5/KO9g' 6-max Seat #4 is the button
Seat 1: ELW+DKizJhLK7k40PMkD2Q ($30 in chips) 
Seat 2: 8ClCHtFXGNplITm+63KB+Q ($33.50 in chips) 
Seat 4: pisIQ6Ztya1lC0kTtGSTHw ($58.70 in chips) 
Seat 5: WrLI51S2iMb8GLMB83gGqA ($29.30 in chips) 
WrLI51S2iMb8GLMB83gGqA: posts small blind $0.10
BYxjLnV1/LL0aZcTbfAOvw: is sitting out 
ELW+DKizJhLK7k40PMkD2Q: posts big blind $0.25
*** HOLE CARDS ***
BYxjLnV1/LL0aZcTbfAOvw leaves the table
8ClCHtFXGNplITm+63KB+Q: folds 
pisIQ6Ztya1lC0kTtGSTHw: calls $0.25
WrLI51S2iMb8GLMB83gGqA: folds 
ELW+DKizJhLK7k40PMkD2Q: checks 
*** FLOP *** [Qc Jd 4d]
ELW+DKizJhLK7k40PMkD2Q: checks 
Parks Playa joins the table at seat #6 
pisIQ6Ztya1lC0kTtGSTHw: bets $0.50
ELW+DKizJhLK7k40PMkD2Q: folds 
Uncalled bet ($0.50) returned to pisIQ6Ztya1lC0kTtGSTHw
pisIQ6Ztya1lC0kTtGSTHw collected $0.60 from pot
pisIQ6Ztya1lC0kTtGSTHw: doesn't show hand 
Wq26opBLDGJe91GRJn2epg joins the table at seat #3 
*** SUMMARY ***
Total pot $0.60 | Rake $0 
Board [Qc Jd 4d]
Seat 1: ELW+DKizJhLK7k40PMkD2Q (big blind) folded on the Flop
Seat 2: 8ClCHtFXGNplITm+63KB+Q folded before Flop (didn't bet)
Seat 4: pisIQ6Ztya1lC0kTtGSTHw (button) collected ($0.60)
Seat 5: WrLI51S2iMb8GLMB83gGqA (small blind) folded before Flop




PokerStars Game #59939405912:  Hold'em No Limit ($0.10/$0.25) - 2009/07/01 0:39:02 ET
Table 'xro+BVoe2Zuw1TYmz/McJQ' 9-max Seat #8 is the button
Seat 1: xEQxarad8/T4jJdpZy5LGw ($7.70 in chips) 
Seat 2: MXCztnYJ58KLHMztZvKrxA ($12.65 in chips) 
Seat 3: COsrwJSFHQtxlUcrYtDQPQ ($39.45 in chips) 
Seat 4: N2LVj3iImgnOoHVf8g0rIw ($18.85 in chips) 
Seat 5: 87Warq49WFhxNpfNtKRmcQ ($28.25 in chips) 
Seat 6: HPEB+AtKw1+C/cxU0o1ciw ($24.55 in chips) 
Seat 7: QEbIGci+itdw+re8RM5fZA ($25 in chips) 
Seat 8: ljemhp25Zg+nlA9DLCIiUw ($19.80 in chips) 
Seat 9: H5Se03ZqSX7tbULXur2MAg ($24.40 in chips) 
H5Se03ZqSX7tbULXur2MAg: posts small blind $0.10
xEQxarad8/T4jJdpZy5LGw: posts big blind $0.25
*** HOLE CARDS ***
MXCztnYJ58KLHMztZvKrxA: raises $0.50 to $0.75
COsrwJSFHQtxlUcrYtDQPQ: folds 
N2LVj3iImgnOoHVf8g0rIw: folds 
87Warq49WFhxNpfNtKRmcQ: folds 
HPEB+AtKw1+C/cxU0o1ciw: calls $0.75
QEbIGci+itdw+re8RM5fZA: folds 
ljemhp25Zg+nlA9DLCIiUw: folds 
H5Se03ZqSX7tbULXur2MAg: folds 
xEQxarad8/T4jJdpZy5LGw: folds 
*** FLOP *** [4s Js 7c]
MXCztnYJ58KLHMztZvKrxA: checks 
HPEB+AtKw1+C/cxU0o1ciw: checks 
*** TURN *** [4s Js 7c] [Qh]
MXCztnYJ58KLHMztZvKrxA: bets $0.75
HPEB+AtKw1+C/cxU0o1ciw: calls $0.75
*** RIVER *** [4s Js 7c Qh] [4d]
MXCztnYJ58KLHMztZvKrxA: checks 
HPEB+AtKw1+C/cxU0o1ciw: checks 
*** SHOW DOWN ***
MXCztnYJ58KLHMztZvKrxA: shows [Ts Kd] (a pair of Fours)
HPEB+AtKw1+C/cxU0o1ciw: shows [5h 5d] (two pair, Fives and Fours)
HPEB+AtKw1+C/cxU0o1ciw collected $3.20 from pot
*** SUMMARY ***
Total pot $3.35 | Rake $0.15 
Board [4s Js 7c Qh 4d]
Seat 1: xEQxarad8/T4jJdpZy5LGw (big blind) folded before Flop
Seat 2: MXCztnYJ58KLHMztZvKrxA showed [Ts Kd] and lost with a pair of Fours
Seat 3: COsrwJSFHQtxlUcrYtDQPQ folded before Flop (didn't bet)
Seat 4: N2LVj3iImgnOoHVf8g0rIw folded before Flop (didn't bet)
Seat 5: 87Warq49WFhxNpfNtKRmcQ folded before Flop (didn't bet)
Seat 6: HPEB+AtKw1+C/cxU0o1ciw showed [5h 5d] and won ($3.20) with two pair, Fives and Fours
Seat 7: QEbIGci+itdw+re8RM5fZA folded before Flop (didn't bet)
Seat 8: ljemhp25Zg+nlA9DLCIiUw (button) folded before Flop (didn't bet)
Seat 9: H5Se03ZqSX7tbULXur2MAg (small blind) folded before Flop




PokerStars Game #59939405696:  Hold'em No Limit ($0.10/$0.25) - 2009/07/01 0:39:02 ET
Table 'JJzUs04lHpXg6nboT1/jeg' 6-max Seat #4 is the button
Seat 3: uUXdcVMNa05rfbntdvplfw ($10 in chips) 
Seat 4: nwwpaieDRI0UPyVtChVHOg ($36.70 in chips) 
Seat 5: Vr2XE7yYBdg3RZSURDAPEg ($23.90 in chips) 
Vr2XE7yYBdg3RZSURDAPEg: posts small blind $0.10
uUXdcVMNa05rfbntdvplfw: posts big blind $0.25
*** HOLE CARDS ***
nwwpaieDRI0UPyVtChVHOg: folds 
Vr2XE7yYBdg3RZSURDAPEg: folds 
Uncalled bet ($0.15) returned to uUXdcVMNa05rfbntdvplfw
uUXdcVMNa05rfbntdvplfw collected $0.20 from pot
*** SUMMARY ***
Total pot $0.20 | Rake $0 
Seat 3: uUXdcVMNa05rfbntdvplfw (big blind) collected ($0.20)
Seat 4: nwwpaieDRI0UPyVtChVHOg (button) folded before Flop (didn't bet)
Seat 5: Vr2XE7yYBdg3RZSURDAPEg (small blind) folded before Flop




PokerStars Game #59939405742:  Hold'em No Limit ($0.10/$0.25) - 2009/07/01 0:39:02 ET
Table 'gHbubGDeVSkmB4vFiqIN3Q' 6-max Seat #1 is the button
Seat 1: kG34n23qFQA3nzdOJTQ1dA ($26.15 in chips) 
Seat 2: 8LzEWRhg4wk8Jh9CqDhH3Q ($3.50 in chips) 
Seat 4: v+QfkGiuj9bgtuNoVnDO8w ($32.85 in chips) 
8LzEWRhg4wk8Jh9CqDhH3Q: posts small blind $0.10
v+QfkGiuj9bgtuNoVnDO8w: posts big blind $0.25
wvIIdlbCgePONQwXjx9xzQ: sits out 
*** HOLE CARDS ***
kG34n23qFQA3nzdOJTQ1dA: folds 
8LzEWRhg4wk8Jh9CqDhH3Q: raises $0.50 to $0.75
v+QfkGiuj9bgtuNoVnDO8w: folds 
Uncalled bet ($0.50) returned to 8LzEWRhg4wk8Jh9CqDhH3Q
8LzEWRhg4wk8Jh9CqDhH3Q collected $0.50 from pot
8LzEWRhg4wk8Jh9CqDhH3Q: doesn't show hand 
*** SUMMARY ***
Total pot $0.50 | Rake $0 
Seat 1: kG34n23qFQA3nzdOJTQ1dA (button) folded before Flop (didn't bet)
Seat 2: 8LzEWRhg4wk8Jh9CqDhH3Q (small blind) collected ($0.50)
Seat 4: v+QfkGiuj9bgtuNoVnDO8w (big blind) folded before Flop




PokerStars Game #59939405938:  Hold'em No Limit ($0.10/$0.25) - 2009/07/01 0:39:02 ET
Table 'nc6OeGk/wtaWV+6N+kgnZQ' 6-max Seat #6 is the button
Seat 1: 0/FYfBoKhINaqU/H5OSS1A ($5.70 in chips) 
Seat 3: 8f0dtuUGqDbgE6up1lQAlg ($5 in chips) 
Seat 6: yJgjVkWgiJ8vdWZjcUod2A ($4.25 in chips) 
0/FYfBoKhINaqU/H5OSS1A: posts small blind $0.10
8f0dtuUGqDbgE6up1lQAlg: posts big blind $0.25
*** HOLE CARDS ***
yJgjVkWgiJ8vdWZjcUod2A: raises $0.50 to $0.75
0/FYfBoKhINaqU/H5OSS1A: folds 
8f0dtuUGqDbgE6up1lQAlg: calls $0.50
*** FLOP *** [7h 5d 7s]
8f0dtuUGqDbgE6up1lQAlg: checks 
yJgjVkWgiJ8vdWZjcUod2A: bets $0.75
8f0dtuUGqDbgE6up1lQAlg: folds 
Uncalled bet ($0.75) returned to yJgjVkWgiJ8vdWZjcUod2A
yJgjVkWgiJ8vdWZjcUod2A collected $1.55 from pot
yJgjVkWgiJ8vdWZjcUod2A: doesn't show hand 
*** SUMMARY ***
Total pot $1.60 | Rake $0.05 
Board [7h 5d 7s]
Seat 1: 0/FYfBoKhINaqU/H5OSS1A (small blind) folded before Flop
Seat 3: 8f0dtuUGqDbgE6up1lQAlg (big blind) folded on the Flop
Seat 6: yJgjVkWgiJ8vdWZjcUod2A (button) collected ($1.55)




PokerStars Game #59939406426:  Hold'em No Limit ($0.10/$0.25) - 2009/07/01 0:39:03 ET
Table 'M7d9IrgQUUFFy/SZ3ksLYg' 6-max Seat #4 is the button
Seat 1: cPO/1/dTcZpLkQFm3jH3Rg ($34.55 in chips) 
Seat 2: JE/wJXmjw3bpdmjwvh2pcg ($25.35 in chips) 
Seat 3: eHsmIvAb2JREg4O6hNPnXg ($15.60 in chips) 
Seat 4: 7FmwVDcdEtxDpHmP4hOXsQ ($29.90 in chips) 
Seat 6: /gJNBeCkWL4o85/jvlZ4BA ($25 in chips) 
/gJNBeCkWL4o85/jvlZ4BA: posts small blind $0.10
cPO/1/dTcZpLkQFm3jH3Rg: posts big blind $0.25
*** HOLE CARDS ***
JE/wJXmjw3bpdmjwvh2pcg: folds 
eHsmIvAb2JREg4O6hNPnXg: calls $0.25
7FmwVDcdEtxDpHmP4hOXsQ: folds 
/gJNBeCkWL4o85/jvlZ4BA: raises $1 to $1.25
cPO/1/dTcZpLkQFm3jH3Rg: folds 
eHsmIvAb2JREg4O6hNPnXg: folds 
Uncalled bet ($1) returned to /gJNBeCkWL4o85/jvlZ4BA
/gJNBeCkWL4o85/jvlZ4BA collected $0.75 from pot
*** SUMMARY ***
Total pot $0.75 | Rake $0 
Seat 1: cPO/1/dTcZpLkQFm3jH3Rg (big blind) folded before Flop
Seat 2: JE/wJXmjw3bpdmjwvh2pcg folded before Flop (didn't bet)
Seat 3: eHsmIvAb2JREg4O6hNPnXg folded before Flop
Seat 4: 7FmwVDcdEtxDpHmP4hOXsQ (button) folded before Flop (didn't bet)
Seat 6: /gJNBeCkWL4o85/jvlZ4BA (small blind) collected ($0.75)




PokerStars Game #59939406084:  Hold'em No Limit ($0.10/$0.25) - 2009/07/01 0:39:03 ET
Table 'dZNBGqFYSwfOVZvDJ4VjIQ' 6-max Seat #2 is the button
Seat 1: r0DiH4bZf5vkenb8ncDb3w ($12 in chips) 
Seat 2: NPueG39V6nKvDRuvBJ4U7g ($17.10 in chips) 
Seat 3: Qd4gQJ1hjQcU9/uDqd6Nlw ($11.95 in chips) 
Seat 5: hZJzYj+7+PvGu6ae1g//sQ ($11.40 in chips) 
Seat 6: VbudEd0ZG+qPwMO9h+hjXw ($15 in chips) 
Qd4gQJ1hjQcU9/uDqd6Nlw: posts small blind $0.10
hZJzYj+7+PvGu6ae1g//sQ: posts big blind $0.25
VbudEd0ZG+qPwMO9h+hjXw: posts big blind $0.25
*** HOLE CARDS ***
VbudEd0ZG+qPwMO9h+hjXw: checks 
r0DiH4bZf5vkenb8ncDb3w: raises $0.50 to $0.75
df01R5ThvHspD8FgKmaDvQ joins the table at seat #4 
NPueG39V6nKvDRuvBJ4U7g: calls $0.75
Qd4gQJ1hjQcU9/uDqd6Nlw: calls $0.65
hZJzYj+7+PvGu6ae1g//sQ: folds 
VbudEd0ZG+qPwMO9h+hjXw: calls $0.50
*** FLOP *** [7h 6c Kc]
Qd4gQJ1hjQcU9/uDqd6Nlw: checks 
VbudEd0ZG+qPwMO9h+hjXw: checks 
r0DiH4bZf5vkenb8ncDb3w: checks 
NPueG39V6nKvDRuvBJ4U7g: bets $0.75
Qd4gQJ1hjQcU9/uDqd6Nlw: folds 
VbudEd0ZG+qPwMO9h+hjXw: raises $0.75 to $1.50
r0DiH4bZf5vkenb8ncDb3w: folds 
NPueG39V6nKvDRuvBJ4U7g: calls $0.75
*** TURN *** [7h 6c Kc] [Jh]
VbudEd0ZG+qPwMO9h+hjXw: bets $2.75
r0DiH4bZf5vkenb8ncDb3w leaves the table
NPueG39V6nKvDRuvBJ4U7g: folds 
Uncalled bet ($2.75) returned to VbudEd0ZG+qPwMO9h+hjXw
VbudEd0ZG+qPwMO9h+hjXw collected $5.95 from pot
VbudEd0ZG+qPwMO9h+hjXw: doesn't show hand 
*** SUMMARY ***
Total pot $6.25 | Rake $0.30 
Board [7h 6c Kc Jh]
Seat 1: r0DiH4bZf5vkenb8ncDb3w folded on the Flop
Seat 2: NPueG39V6nKvDRuvBJ4U7g (button) folded on the Turn
Seat 3: Qd4gQJ1hjQcU9/uDqd6Nlw (small blind) folded on the Flop
Seat 5: hZJzYj+7+PvGu6ae1g//sQ (big blind) folded before Flop
Seat 6: VbudEd0ZG+qPwMO9h+hjXw collected ($5.95)




PokerStars Game #59939406474:  Hold'em No Limit ($0.10/$0.25) - 2009/07/01 0:39:03 ET
Table 'gkdjhbH1jaE3hwhPRIKMiQ' 6-max Seat #1 is the button
Seat 1: nc79pm0LZRdhncq55evVqA ($25 in chips) 
Seat 2: 1NNFfYMd5Hsphl/FYz9fNA ($32.60 in chips) 
Seat 4: 7uqewvdd5+KjmM7wl58k+w ($15.30 in chips) 
Seat 5: Ew/TYPQIsbQ2X8nm5iAJBg ($26.75 in chips) 
Seat 6: wqphQtauX5Qn7WRJZS1flA ($26 in chips) 
1NNFfYMd5Hsphl/FYz9fNA: posts small blind $0.10
7uqewvdd5+KjmM7wl58k+w: posts big blind $0.25
*** HOLE CARDS ***
Ew/TYPQIsbQ2X8nm5iAJBg: folds 
wqphQtauX5Qn7WRJZS1flA: folds 
nc79pm0LZRdhncq55evVqA: raises $0.75 to $1
1NNFfYMd5Hsphl/FYz9fNA: folds 
7uqewvdd5+KjmM7wl58k+w: folds 
Uncalled bet ($0.75) returned to nc79pm0LZRdhncq55evVqA
nc79pm0LZRdhncq55evVqA collected $0.60 from pot
nc79pm0LZRdhncq55evVqA: doesn't show hand 
*** SUMMARY ***
Total pot $0.60 | Rake $0 
Seat 1: nc79pm0LZRdhncq55evVqA (button) collected ($0.60)
Seat 2: 1NNFfYMd5Hsphl/FYz9fNA (small blind) folded before Flop
Seat 4: 7uqewvdd5+KjmM7wl58k+w (big blind) folded before Flop
Seat 5: Ew/TYPQIsbQ2X8nm5iAJBg folded before Flop (didn't bet)
Seat 6: wqphQtauX5Qn7WRJZS1flA folded before Flop (didn't bet)




PokerStars Game #59939406616:  Hold'em No Limit ($0.10/$0.25) - 2009/07/01 0:39:03 ET
Table 'hfHe8uKeSJMyWAjSdM7ROQ' 6-max Seat #4 is the button
Seat 1: eHsmIvAb2JREg4O6hNPnXg ($20.75 in chips) 
Seat 2: rnpAao581IcvQglpkpnkoQ ($7.05 in chips) 
Seat 3: og6TUWcndKo5oTDQjnQfjw ($27.55 in chips) 
Seat 4: iAfYkegiTr9eE85LoKmEgA ($7.60 in chips) 
Seat 5: euswrBD1XG0Q5hB1iGJBKQ ($24.55 in chips) 
Seat 6: SFmT9ZsVopnukjvAzrxTRg ($25 in chips) 
euswrBD1XG0Q5hB1iGJBKQ: posts small blind $0.10
SFmT9ZsVopnukjvAzrxTRg: posts big blind $0.25
*** HOLE CARDS ***
eHsmIvAb2JREg4O6hNPnXg: raises $0.75 to $1
rnpAao581IcvQglpkpnkoQ: folds 
og6TUWcndKo5oTDQjnQfjw: calls $1
iAfYkegiTr9eE85LoKmEgA: folds 
euswrBD1XG0Q5hB1iGJBKQ: folds 
SFmT9ZsVopnukjvAzrxTRg: folds 
*** FLOP *** [4s 6h 4h]
eHsmIvAb2JREg4O6hNPnXg: checks 
og6TUWcndKo5oTDQjnQfjw: bets $1
eHsmIvAb2JREg4O6hNPnXg: calls $1
*** TURN *** [4s 6h 4h] [3c]
eHsmIvAb2JREg4O6hNPnXg: checks 
og6TUWcndKo5oTDQjnQfjw: bets $2
eHsmIvAb2JREg4O6hNPnXg: folds 
Uncalled bet ($2) returned to og6TUWcndKo5oTDQjnQfjw
og6TUWcndKo5oTDQjnQfjw collected $4.15 from pot
og6TUWcndKo5oTDQjnQfjw: doesn't show hand 
*** SUMMARY ***
Total pot $4.35 | Rake $0.20 
Board [4s 6h 4h 3c]
Seat 1: eHsmIvAb2JREg4O6hNPnXg folded on the Turn
Seat 2: rnpAao581IcvQglpkpnkoQ folded before Flop (didn't bet)
Seat 3: og6TUWcndKo5oTDQjnQfjw collected ($4.15)
Seat 4: iAfYkegiTr9eE85LoKmEgA (button) folded before Flop (didn't bet)
Seat 5: euswrBD1XG0Q5hB1iGJBKQ (small blind) folded before Flop
Seat 6: SFmT9ZsVopnukjvAzrxTRg (big blind) folded before Flop




PokerStars Game #59939406258:  Hold'em No Limit ($0.10/$0.25) - 2009/07/01 0:39:03 ET
Table '9o8Yb3JpUqurD4pNVmOikQ' 6-max Seat #6 is the button
Seat 1: 5tB0F9NjPSUL4FzmzBMs2Q ($25 in chips) 
Seat 2: /gJNBeCkWL4o85/jvlZ4BA ($25.35 in chips) 
Seat 3: JgRqo1/2phbf7pab7N3BIQ ($8.50 in chips) 
Seat 4: YaAEMJGY5tem39deCUQRNw ($41.30 in chips) 
Seat 5: q9qPRjJC40e/Q9yuT+glwQ ($33.80 in chips) 
Seat 6: k9vn40MOqqb+xF+7GZ6v2g ($35.15 in chips) 
5tB0F9NjPSUL4FzmzBMs2Q: posts small blind $0.10
/gJNBeCkWL4o85/jvlZ4BA: posts big blind $0.25
*** HOLE CARDS ***
JgRqo1/2phbf7pab7N3BIQ: calls $0.25
YaAEMJGY5tem39deCUQRNw: folds 
q9qPRjJC40e/Q9yuT+glwQ: folds 
k9vn40MOqqb+xF+7GZ6v2g: folds 
5tB0F9NjPSUL4FzmzBMs2Q: folds 
/gJNBeCkWL4o85/jvlZ4BA: checks 
*** FLOP *** [4s Qd 8s]
/gJNBeCkWL4o85/jvlZ4BA: checks 
JgRqo1/2phbf7pab7N3BIQ: bets $0.25
/gJNBeCkWL4o85/jvlZ4BA: folds 
Uncalled bet ($0.25) returned to JgRqo1/2phbf7pab7N3BIQ
JgRqo1/2phbf7pab7N3BIQ collected $0.60 from pot
*** SUMMARY ***
Total pot $0.60 | Rake $0 
Board [4s Qd 8s]
Seat 1: 5tB0F9NjPSUL4FzmzBMs2Q (small blind) folded before Flop
Seat 2: /gJNBeCkWL4o85/jvlZ4BA (big blind) folded on the Flop
Seat 3: JgRqo1/2phbf7pab7N3BIQ collected ($0.60)
Seat 4: YaAEMJGY5tem39deCUQRNw folded before Flop (didn't bet)
Seat 5: q9qPRjJC40e/Q9yuT+glwQ folded before Flop (didn't bet)
Seat 6: k9vn40MOqqb+xF+7GZ6v2g (button) folded before Flop (didn't bet)




PokerStars Game #59939406600:  Hold'em No Limit ($0.10/$0.25) - 2009/07/01 0:39:03 ET
Table 'KKcpZYT1qeSWLmZFp9A4KA' 9-max Seat #2 is the button
Seat 2: vZGoOTJLQLhkPj4I+LNGig ($26.15 in chips) 
Seat 3: j4q3p0lesp63b1gZDwLBZw ($5 in chips) 
Seat 5: CbXUS6Z2rXZxL1AKduNtmQ ($34.25 in chips) 
Seat 6: 4awUyiDYTgylQKXZ9faBVA ($39.70 in chips) 
Seat 7: QEbIGci+itdw+re8RM5fZA ($26.45 in chips) 
Seat 8: CBv6rfZ34K2gts8YbQ4waw ($30.45 in chips) 
j4q3p0lesp63b1gZDwLBZw: posts small blind $0.10
jXz58rvCgq0VjyVjUBf2mw: is sitting out 
CbXUS6Z2rXZxL1AKduNtmQ: posts big blind $0.25
*** HOLE CARDS ***
jXz58rvCgq0VjyVjUBf2mw leaves the table
4awUyiDYTgylQKXZ9faBVA: folds 
QEbIGci+itdw+re8RM5fZA: folds 
CBv6rfZ34K2gts8YbQ4waw: folds 
vZGoOTJLQLhkPj4I+LNGig: folds 
j4q3p0lesp63b1gZDwLBZw: raises $0.75 to $1
CbXUS6Z2rXZxL1AKduNtmQ: folds 
Uncalled bet ($0.75) returned to j4q3p0lesp63b1gZDwLBZw
j4q3p0lesp63b1gZDwLBZw collected $0.50 from pot
j4q3p0lesp63b1gZDwLBZw: doesn't show hand 
*** SUMMARY ***
Total pot $0.50 | Rake $0 
Seat 2: vZGoOTJLQLhkPj4I+LNGig (button) folded before Flop (didn't bet)
Seat 3: j4q3p0lesp63b1gZDwLBZw (small blind) collected ($0.50)
Seat 5: CbXUS6Z2rXZxL1AKduNtmQ (big blind) folded before Flop
Seat 6: 4awUyiDYTgylQKXZ9faBVA folded before Flop (didn't bet)
Seat 7: QEbIGci+itdw+re8RM5fZA folded before Flop (didn't bet)
Seat 8: CBv6rfZ34K2gts8YbQ4waw folded before Flop (didn't bet)




PokerStars Game #59939406512:  Hold'em No Limit ($0.10/$0.25) - 2009/07/01 0:39:03 ET
Table 'hg+KpirwreMnBAFQr/SEUA' 9-max Seat #6 is the button
Seat 1: H5Se03ZqSX7tbULXur2MAg ($24.45 in chips) 
Seat 2: OlPJsgR4xypSg/w1z7Gyvw ($18.40 in chips) 
Seat 3: N6fYvIzQLKaydFLKQGtMlQ ($24.65 in chips) 
Seat 4: GGSFATxBXI5pXwoMMI70zg ($5.45 in chips) 
Seat 5: +2kMBNpY4nF1qNCRd8SJLA ($25 in chips) 
Seat 6: dAohy+E9dUFBp6GlYFiOtQ ($24.60 in chips) 
Seat 7: EcWpc/mcsCWBGKsSdZaXbA ($23.55 in chips) 
Seat 8: HPEB+AtKw1+C/cxU0o1ciw ($25 in chips) 
Seat 9: Il5IBomZPnY0uD8k+rlPyw ($47.90 in chips) 
EcWpc/mcsCWBGKsSdZaXbA: posts small blind $0.10
HPEB+AtKw1+C/cxU0o1ciw: posts big blind $0.25
*** HOLE CARDS ***
Il5IBomZPnY0uD8k+rlPyw: folds 
H5Se03ZqSX7tbULXur2MAg: folds 
OlPJsgR4xypSg/w1z7Gyvw: folds 
N6fYvIzQLKaydFLKQGtMlQ: folds 
GGSFATxBXI5pXwoMMI70zg: folds 
+2kMBNpY4nF1qNCRd8SJLA: folds 
dAohy+E9dUFBp6GlYFiOtQ: folds 
EcWpc/mcsCWBGKsSdZaXbA: folds 
Uncalled bet ($0.15) returned to HPEB+AtKw1+C/cxU0o1ciw
HPEB+AtKw1+C/cxU0o1ciw collected $0.20 from pot
HPEB+AtKw1+C/cxU0o1ciw: doesn't show hand 
*** SUMMARY ***
Total pot $0.20 | Rake $0 
Seat 1: H5Se03ZqSX7tbULXur2MAg folded before Flop (didn't bet)
Seat 2: OlPJsgR4xypSg/w1z7Gyvw folded before Flop (didn't bet)
Seat 3: N6fYvIzQLKaydFLKQGtMlQ folded before Flop (didn't bet)
Seat 4: GGSFATxBXI5pXwoMMI70zg folded before Flop (didn't bet)
Seat 5: +2kMBNpY4nF1qNCRd8SJLA folded before Flop (didn't bet)
Seat 6: dAohy+E9dUFBp6GlYFiOtQ (button) folded before Flop (didn't bet)
Seat 7: EcWpc/mcsCWBGKsSdZaXbA (small blind) folded before Flop
Seat 8: HPEB+AtKw1+C/cxU0o1ciw (big blind) collected ($0.20)
Seat 9: Il5IBomZPnY0uD8k+rlPyw folded before Flop (didn't bet)




PokerStars Game #59939406248:  Hold'em No Limit ($0.10/$0.25) - 2009/07/01 0:39:03 ET
Table '0XPo7K54oZIfG0xlNAcDRw' 9-max Seat #4 is the button
Seat 1: opOCI2p6kW0tINuVaAqmcQ ($29.65 in chips) 
Seat 2: Jbrpc6KkvYcsiySJzLmFuA ($15.40 in chips) 
Seat 3: 6qsItdeWZoOL5be2e1RFng ($11.50 in chips) 
Seat 4: vOEICaqlJhPYytg64XnnkQ ($12.60 in chips) 
Seat 5: 8B/dhbQjIWe6ASCdgzktNQ ($40.10 in chips) 
Seat 6: 9gmYYQesalMrUjaF7nKfrQ ($10.70 in chips) 
Seat 7: tYsOBqdU1+x+yFI7zHO7hQ ($45.85 in chips) 
Seat 8: 1Clf3cPrqoy/YgvWdWK1Xw ($6.25 in chips) 
Seat 9: s7Q6uNouhe7aE8JdFb9E+A ($25 in chips) 
8B/dhbQjIWe6ASCdgzktNQ: posts small blind $0.10
9gmYYQesalMrUjaF7nKfrQ: posts big blind $0.25
*** HOLE CARDS ***
tYsOBqdU1+x+yFI7zHO7hQ: folds 
1Clf3cPrqoy/YgvWdWK1Xw: folds 
s7Q6uNouhe7aE8JdFb9E+A: raises $0.75 to $1
opOCI2p6kW0tINuVaAqmcQ: folds 
Jbrpc6KkvYcsiySJzLmFuA: folds 
6qsItdeWZoOL5be2e1RFng: folds 
vOEICaqlJhPYytg64XnnkQ: folds 
8B/dhbQjIWe6ASCdgzktNQ: folds 
9gmYYQesalMrUjaF7nKfrQ: folds 
Uncalled bet ($0.75) returned to s7Q6uNouhe7aE8JdFb9E+A
s7Q6uNouhe7aE8JdFb9E+A collected $0.60 from pot
*** SUMMARY ***
Total pot $0.60 | Rake $0 
Seat 1: opOCI2p6kW0tINuVaAqmcQ folded before Flop (didn't bet)
Seat 2: Jbrpc6KkvYcsiySJzLmFuA folded before Flop (didn't bet)
Seat 3: 6qsItdeWZoOL5be2e1RFng folded before Flop (didn't bet)
Seat 4: vOEICaqlJhPYytg64XnnkQ (button) folded before Flop (didn't bet)
Seat 5: 8B/dhbQjIWe6ASCdgzktNQ (small blind) folded before Flop
Seat 6: 9gmYYQesalMrUjaF7nKfrQ (big blind) folded before Flop
Seat 7: tYsOBqdU1+x+yFI7zHO7hQ folded before Flop (didn't bet)
Seat 8: 1Clf3cPrqoy/YgvWdWK1Xw folded before Flop (didn't bet)
Seat 9: s7Q6uNouhe7aE8JdFb9E+A collected ($0.60)




PokerStars Game #59939406610:  Hold'em No Limit ($0.10/$0.25) - 2009/07/01 0:39:03 ET
Table 'M8kYidAX3ib7pLKW7edFLw' 6-max Seat #1 is the button
Seat 1: 4YSTu0Cdzpppe1lUgCZGCQ ($39.90 in chips) 
Seat 2: sbFQMajC1QuRxa8Jly3usQ ($23.80 in chips) 
Seat 4: /bjna2FTN7pPjqYGzmDE0Q ($23.40 in chips) 
Seat 5: bDKopKTvPi3W+PEnYUX3tg ($27.95 in chips) 
sbFQMajC1QuRxa8Jly3usQ: posts small blind $0.10
/bjna2FTN7pPjqYGzmDE0Q: posts big blind $0.25
*** HOLE CARDS ***
bDKopKTvPi3W+PEnYUX3tg: folds 
4YSTu0Cdzpppe1lUgCZGCQ: folds 
sbFQMajC1QuRxa8Jly3usQ: folds 
Uncalled bet ($0.15) returned to /bjna2FTN7pPjqYGzmDE0Q
sbFQMajC1QuRxa8Jly3usQ leaves the table
/bjna2FTN7pPjqYGzmDE0Q collected $0.20 from pot
/bjna2FTN7pPjqYGzmDE0Q: doesn't show hand 
*** SUMMARY ***
Total pot $0.20 | Rake $0 
Seat 1: 4YSTu0Cdzpppe1lUgCZGCQ (button) folded before Flop (didn't bet)
Seat 2: sbFQMajC1QuRxa8Jly3usQ (small blind) folded before Flop
Seat 4: /bjna2FTN7pPjqYGzmDE0Q (big blind) collected ($0.20)
Seat 5: bDKopKTvPi3W+PEnYUX3tg folded before Flop (didn't bet)




PokerStars Game #59939406710:  Hold'em No Limit ($0.10/$0.25) - 2009/07/01 0:39:04 ET
Table 'l8hUTjBTXBorNUR/tyvSLw' 9-max Seat #8 is the button
Seat 2: ZeR3hkj1gVv9J4yPCmRrjA ($50.85 in chips) 
Seat 3: 6TWO15+WfJ5HfI8CbJ4a0w ($8.50 in chips) 
Seat 4: vPtFvcPtn/Afz0sucO1cmQ ($37 in chips) 
Seat 5: S7Ki0P+0AIGPuIfGJjW0gg ($13.60 in chips) 
Seat 6: nkD1GtC3+ft+4U3Od0H10A ($14.20 in chips) 
Seat 7: awxYB5n5W4JUl1V4Xsn26g ($4.65 in chips) 
Seat 8: kZJjw0YSgO2CZKraCg0v8g ($12.65 in chips) 
Seat 9: zDrucyjVn5aeekNEc3cJrA ($35.85 in chips) 
zDrucyjVn5aeekNEc3cJrA: posts small blind $0.10
q9qPRjJC40e/Q9yuT+glwQ: is sitting out 
ZeR3hkj1gVv9J4yPCmRrjA: posts big blind $0.25
*** HOLE CARDS ***
6TWO15+WfJ5HfI8CbJ4a0w: folds 
vPtFvcPtn/Afz0sucO1cmQ: calls $0.25
S7Ki0P+0AIGPuIfGJjW0gg: folds 
nkD1GtC3+ft+4U3Od0H10A: folds 
awxYB5n5W4JUl1V4Xsn26g: folds 
kZJjw0YSgO2CZKraCg0v8g: calls $0.25
zDrucyjVn5aeekNEc3cJrA: folds 
ZeR3hkj1gVv9J4yPCmRrjA: checks 
*** FLOP *** [8s 7d 5h]
ZeR3hkj1gVv9J4yPCmRrjA: checks 
vPtFvcPtn/Afz0sucO1cmQ: bets $0.25
kZJjw0YSgO2CZKraCg0v8g: folds 
ZeR3hkj1gVv9J4yPCmRrjA: folds 
Uncalled bet ($0.25) returned to vPtFvcPtn/Afz0sucO1cmQ
vPtFvcPtn/Afz0sucO1cmQ collected $0.85 from pot
vPtFvcPtn/Afz0sucO1cmQ: doesn't show hand 
*** SUMMARY ***
Total pot $0.85 | Rake $0 
Board [8s 7d 5h]
Seat 2: ZeR3hkj1gVv9J4yPCmRrjA (big blind) folded on the Flop
Seat 3: 6TWO15+WfJ5HfI8CbJ4a0w folded before Flop (didn't bet)
Seat 4: vPtFvcPtn/Afz0sucO1cmQ collected ($0.85)
Seat 5: S7Ki0P+0AIGPuIfGJjW0gg folded before Flop (didn't bet)
Seat 6: nkD1GtC3+ft+4U3Od0H10A folded before Flop (didn't bet)
Seat 7: awxYB5n5W4JUl1V4Xsn26g folded before Flop (didn't bet)
Seat 8: kZJjw0YSgO2CZKraCg0v8g (button) folded on the Flop
Seat 9: zDrucyjVn5aeekNEc3cJrA (small blind) folded before Flop




PokerStars Game #59939407272:  Hold'em No Limit ($0.10/$0.25) - 2009/07/01 0:39:04 ET
Table 'isKy4XK8wJM0x735/D4hWA' 6-max Seat #1 is the button
Seat 1: 7FmwVDcdEtxDpHmP4hOXsQ ($25.85 in chips) 
Seat 3: 8ClCHtFXGNplITm+63KB+Q ($25 in chips) 
Seat 5: zlYHXTtJ5tcx9kwK2h5n9A ($37.65 in chips) 
Seat 6: M6xK/VklCvdyyrmvzATlxQ ($13.50 in chips) 
8ClCHtFXGNplITm+63KB+Q: posts small blind $0.10
zlYHXTtJ5tcx9kwK2h5n9A: posts big blind $0.25
*** HOLE CARDS ***
M6xK/VklCvdyyrmvzATlxQ: raises $0.50 to $0.75
7FmwVDcdEtxDpHmP4hOXsQ: folds 
8ClCHtFXGNplITm+63KB+Q: folds 
zlYHXTtJ5tcx9kwK2h5n9A: folds 
Uncalled bet ($0.50) returned to M6xK/VklCvdyyrmvzATlxQ
8ClCHtFXGNplITm+63KB+Q leaves the table
M6xK/VklCvdyyrmvzATlxQ collected $0.60 from pot
*** SUMMARY ***
Total pot $0.60 | Rake $0 
Seat 1: 7FmwVDcdEtxDpHmP4hOXsQ (button) folded before Flop (didn't bet)
Seat 3: 8ClCHtFXGNplITm+63KB+Q (small blind) folded before Flop
Seat 5: zlYHXTtJ5tcx9kwK2h5n9A (big blind) folded before Flop
Seat 6: M6xK/VklCvdyyrmvzATlxQ collected ($0.60)




PokerStars Game #59939406682:  Hold'em No Limit ($0.10/$0.25) - 2009/07/01 0:39:04 ET
Table '8QBBaev+cI2i/r2H6ml/lg' 9-max Seat #2 is the button
Seat 2: tYsOBqdU1+x+yFI7zHO7hQ ($25 in chips) 
Seat 4: ZoG0obuajzVjwgd7lNHjgg ($1.45 in chips) 
Seat 5: j4q3p0lesp63b1gZDwLBZw ($5 in chips) 
Seat 9: Ml2bY77EHbM51ZWD7dnIWg ($1.95 in chips) 
ZoG0obuajzVjwgd7lNHjgg: posts small blind $0.10
j4q3p0lesp63b1gZDwLBZw: posts big blind $0.25
*** HOLE CARDS ***
Ml2bY77EHbM51ZWD7dnIWg: folds 
tYsOBqdU1+x+yFI7zHO7hQ: raises $0.50 to $0.75
ZoG0obuajzVjwgd7lNHjgg: raises $0.70 to $1.45 and is all-in
j4q3p0lesp63b1gZDwLBZw: raises $3.55 to $5 and is all-in
tYsOBqdU1+x+yFI7zHO7hQ: folds 
Uncalled bet ($3.55) returned to j4q3p0lesp63b1gZDwLBZw
*** FLOP *** [3c Ts Tc]
*** TURN *** [3c Ts Tc] [Jc]
*** RIVER *** [3c Ts Tc Jc] [4h]
*** SHOW DOWN ***
ZoG0obuajzVjwgd7lNHjgg: shows [Jh Ks] (two pair, Jacks and Tens)
j4q3p0lesp63b1gZDwLBZw: mucks hand 
ZoG0obuajzVjwgd7lNHjgg collected $3.50 from pot
*** SUMMARY ***
Total pot $3.65 | Rake $0.15 
Board [3c Ts Tc Jc 4h]
Seat 2: tYsOBqdU1+x+yFI7zHO7hQ (button) folded before Flop
Seat 4: ZoG0obuajzVjwgd7lNHjgg (small blind) showed [Jh Ks] and won ($3.50) with two pair, Jacks and Tens
Seat 5: j4q3p0lesp63b1gZDwLBZw (big blind) mucked
Seat 9: Ml2bY77EHbM51ZWD7dnIWg folded before Flop (didn't bet)




PokerStars Game #59939406882:  Hold'em No Limit ($0.10/$0.25) - 2009/07/01 0:39:04 ET
Table 'KRiZ8S/xwAYkA4EWSX89ow' 9-max Seat #7 is the button
Seat 1: CYkY0dNBaYaKs8HVCVn3mQ ($5.35 in chips) 
Seat 2: vZGoOTJLQLhkPj4I+LNGig ($53.45 in chips) 
Seat 3: /fionJv+b9tkuIj/KKbXYw ($25.95 in chips) 
Seat 4: COsrwJSFHQtxlUcrYtDQPQ ($27.20 in chips) 
Seat 5: t2nb95S5EEFOEzNx9Itz0g ($5.30 in chips) 
Seat 6: DdPXdieucQ+n99u1n3A+rQ ($5.60 in chips) 
Seat 7: cZ99hugmLBj9KhTlc8nCSw ($25 in chips) 
Seat 8: nEg1b6MIksd/4x5eLY735g ($25.70 in chips) 
Seat 9: EcWpc/mcsCWBGKsSdZaXbA ($24.05 in chips) 
nEg1b6MIksd/4x5eLY735g: posts small blind $0.10
EcWpc/mcsCWBGKsSdZaXbA: posts big blind $0.25
*** HOLE CARDS ***
CYkY0dNBaYaKs8HVCVn3mQ: folds 
vZGoOTJLQLhkPj4I+LNGig: folds 
/fionJv+b9tkuIj/KKbXYw: folds 
COsrwJSFHQtxlUcrYtDQPQ: folds 
t2nb95S5EEFOEzNx9Itz0g: folds 
DdPXdieucQ+n99u1n3A+rQ: folds 
cZ99hugmLBj9KhTlc8nCSw: folds 
nEg1b6MIksd/4x5eLY735g: folds 
Uncalled bet ($0.15) returned to EcWpc/mcsCWBGKsSdZaXbA
EcWpc/mcsCWBGKsSdZaXbA collected $0.20 from pot
EcWpc/mcsCWBGKsSdZaXbA: doesn't show hand 
*** SUMMARY ***
Total pot $0.20 | Rake $0 
Seat 1: CYkY0dNBaYaKs8HVCVn3mQ folded before Flop (didn't bet)
Seat 2: vZGoOTJLQLhkPj4I+LNGig folded before Flop (didn't bet)
Seat 3: /fionJv+b9tkuIj/KKbXYw folded before Flop (didn't bet)
Seat 4: COsrwJSFHQtxlUcrYtDQPQ folded before Flop (didn't bet)
Seat 5: t2nb95S5EEFOEzNx9Itz0g folded before Flop (didn't bet)
Seat 6: DdPXdieucQ+n99u1n3A+rQ folded before Flop (didn't bet)
Seat 7: cZ99hugmLBj9KhTlc8nCSw (button) folded before Flop (didn't bet)
Seat 8: nEg1b6MIksd/4x5eLY735g (small blind) folded before Flop
Seat 9: EcWpc/mcsCWBGKsSdZaXbA (big blind) collected ($0.20)




PokerStars Game #59939406828:  Hold'em No Limit ($0.10/$0.25) - 2009/07/01 0:39:04 ET
Table 'AchTjdLS1zBUbH3ZIx6f0w' 6-max Seat #5 is the button
Seat 1: IzVI+wIP7IS+d0sugIrOPQ ($26.30 in chips) 
Seat 2: kG34n23qFQA3nzdOJTQ1dA ($40.55 in chips) 
Seat 3: ehifenV36yVvJMnV63D3cg ($6.10 in chips) 
Seat 4: q6WfTUAD9mowIP63ASq2Dg ($25.70 in chips) 
Seat 5: oBUDUfeUyCbZBsjxHZgSiw ($33.75 in chips) 
Seat 6: 5tB0F9NjPSUL4FzmzBMs2Q ($25 in chips) 
5tB0F9NjPSUL4FzmzBMs2Q: posts small blind $0.10
IzVI+wIP7IS+d0sugIrOPQ: posts big blind $0.25
*** HOLE CARDS ***
kG34n23qFQA3nzdOJTQ1dA: folds 
ehifenV36yVvJMnV63D3cg: folds 
q6WfTUAD9mowIP63ASq2Dg: raises $0.75 to $1
oBUDUfeUyCbZBsjxHZgSiw: folds 
5tB0F9NjPSUL4FzmzBMs2Q: folds 
IzVI+wIP7IS+d0sugIrOPQ: calls $0.75
*** FLOP *** [6c Kd 8s]
IzVI+wIP7IS+d0sugIrOPQ: checks 
q6WfTUAD9mowIP63ASq2Dg: bets $1.15
IzVI+wIP7IS+d0sugIrOPQ: folds 
Uncalled bet ($1.15) returned to q6WfTUAD9mowIP63ASq2Dg
q6WfTUAD9mowIP63ASq2Dg collected $2 from pot
*** SUMMARY ***
Total pot $2.10 | Rake $0.10 
Board [6c Kd 8s]
Seat 1: IzVI+wIP7IS+d0sugIrOPQ (big blind) folded on the Flop
Seat 2: kG34n23qFQA3nzdOJTQ1dA folded before Flop (didn't bet)
Seat 3: ehifenV36yVvJMnV63D3cg folded before Flop (didn't bet)
Seat 4: q6WfTUAD9mowIP63ASq2Dg collected ($2)
Seat 5: oBUDUfeUyCbZBsjxHZgSiw (button) folded before Flop (didn't bet)
Seat 6: 5tB0F9NjPSUL4FzmzBMs2Q (small blind) folded before Flop




PokerStars Game #59939406770:  Hold'em No Limit ($0.10/$0.25) - 2009/07/01 0:39:04 ET
Table 'IIO2q2znuuAXmiZ2qFTcmg' 6-max Seat #5 is the button
Seat 1: nwwpaieDRI0UPyVtChVHOg ($17.25 in chips) 
Seat 2: cS21pIxRHx5Gt42o7hPZzw ($14.45 in chips) 
Seat 3: hiTEr3yrERiQp3zHXRioVw ($14.75 in chips) 
Seat 4: 0HIrwssk0FQvyKULzUTtlg ($11.25 in chips) 
Seat 5: f9iRHw0d+kV7pbTYwF2+2g ($17.80 in chips) 
nwwpaieDRI0UPyVtChVHOg: posts small blind $0.10
cS21pIxRHx5Gt42o7hPZzw: posts big blind $0.25
*** HOLE CARDS ***
hiTEr3yrERiQp3zHXRioVw: folds 
0HIrwssk0FQvyKULzUTtlg: calls $0.25
f9iRHw0d+kV7pbTYwF2+2g: folds 
nwwpaieDRI0UPyVtChVHOg: calls $0.15
cS21pIxRHx5Gt42o7hPZzw: checks 
*** FLOP *** [Qd 8d 4d]
nwwpaieDRI0UPyVtChVHOg: checks 
cS21pIxRHx5Gt42o7hPZzw: checks 
0HIrwssk0FQvyKULzUTtlg: checks 
*** TURN *** [Qd 8d 4d] [6h]
nwwpaieDRI0UPyVtChVHOg: checks 
cS21pIxRHx5Gt42o7hPZzw: checks 
0HIrwssk0FQvyKULzUTtlg: checks 
*** RIVER *** [Qd 8d 4d 6h] [Ah]
nwwpaieDRI0UPyVtChVHOg: bets $0.50
cS21pIxRHx5Gt42o7hPZzw: folds 
0HIrwssk0FQvyKULzUTtlg: folds 
Uncalled bet ($0.50) returned to nwwpaieDRI0UPyVtChVHOg
nwwpaieDRI0UPyVtChVHOg collected $0.75 from pot
*** SUMMARY ***
Total pot $0.75 | Rake $0 
Board [Qd 8d 4d 6h Ah]
Seat 1: nwwpaieDRI0UPyVtChVHOg (small blind) collected ($0.75)
Seat 2: cS21pIxRHx5Gt42o7hPZzw (big blind) folded on the River
Seat 3: hiTEr3yrERiQp3zHXRioVw folded before Flop (didn't bet)
Seat 4: 0HIrwssk0FQvyKULzUTtlg folded on the River
Seat 5: f9iRHw0d+kV7pbTYwF2+2g (button) folded before Flop (didn't bet)




PokerStars Game #59939407834:  Hold'em No Limit ($0.10/$0.25) - 2009/07/01 0:39:05 ET
Table 'MiquQrQZJJq9ZtgRIp9HFQ' 6-max Seat #6 is the button
Seat 1: hM0MSDtq2ow7J40bSR04ig ($8 in chips) 
Seat 2: DMQLAmut/l19xN5STQndFg ($4.25 in chips) 
Seat 4: 0HIrwssk0FQvyKULzUTtlg ($16.80 in chips) 
Seat 5: LXN9U+5F+9if/ead2+w1nw ($44.10 in chips) 
Seat 6: X9oXZTg4PhZVR+ilX2OYbA ($14.65 in chips) 
hM0MSDtq2ow7J40bSR04ig: posts small blind $0.10
DMQLAmut/l19xN5STQndFg: posts big blind $0.25
*** HOLE CARDS ***
0HIrwssk0FQvyKULzUTtlg: folds 
LXN9U+5F+9if/ead2+w1nw: raises $0.50 to $0.75
X9oXZTg4PhZVR+ilX2OYbA: folds 
hM0MSDtq2ow7J40bSR04ig: folds 
DMQLAmut/l19xN5STQndFg: folds 
Uncalled bet ($0.50) returned to LXN9U+5F+9if/ead2+w1nw
LXN9U+5F+9if/ead2+w1nw collected $0.60 from pot
LXN9U+5F+9if/ead2+w1nw: doesn't show hand 
*** SUMMARY ***
Total pot $0.60 | Rake $0 
Seat 1: hM0MSDtq2ow7J40bSR04ig (small blind) folded before Flop
Seat 2: DMQLAmut/l19xN5STQndFg (big blind) folded before Flop
Seat 4: 0HIrwssk0FQvyKULzUTtlg folded before Flop (didn't bet)
Seat 5: LXN9U+5F+9if/ead2+w1nw collected ($0.60)
Seat 6: X9oXZTg4PhZVR+ilX2OYbA (button) folded before Flop (didn't bet)




PokerStars Game #59939407522:  Hold'em No Limit ($0.10/$0.25) - 2009/07/01 0:39:05 ET
Table 'v+LTGPWbrLum+Ggd4ef6lg' 9-max Seat #4 is the button
Seat 4: gGaFLzGESKP3Tj9N/K7QNA ($19.50 in chips) 
Seat 5: eJDZmZbsxdLJcAv2PolkwA ($14.75 in chips) 
Seat 7: YEdelvffSYRP4EDNfFp4dA ($13.60 in chips) 
Seat 8: +sbyWwIcFp9kP0bDtMegfQ ($28.65 in chips) 
Seat 9: cFmpjvcjNoVAEAIQIxWkYg ($25 in chips) 
eJDZmZbsxdLJcAv2PolkwA: posts small blind $0.10
YEdelvffSYRP4EDNfFp4dA: posts big blind $0.25
MIVCHqCqqlke0Lb0z7glcw: sits out 
*** HOLE CARDS ***
+sbyWwIcFp9kP0bDtMegfQ: folds 
cFmpjvcjNoVAEAIQIxWkYg: folds 
gGaFLzGESKP3Tj9N/K7QNA: folds 
eJDZmZbsxdLJcAv2PolkwA: calls $0.15
YEdelvffSYRP4EDNfFp4dA: checks 
*** FLOP *** [7h 4h Qd]
eJDZmZbsxdLJcAv2PolkwA: bets $0.25
YEdelvffSYRP4EDNfFp4dA: calls $0.25
*** TURN *** [7h 4h Qd] [6d]
eJDZmZbsxdLJcAv2PolkwA: bets $0.50
YEdelvffSYRP4EDNfFp4dA: raises $0.50 to $1
eJDZmZbsxdLJcAv2PolkwA: calls $0.50
*** RIVER *** [7h 4h Qd 6d] [9d]
eJDZmZbsxdLJcAv2PolkwA: checks 
YEdelvffSYRP4EDNfFp4dA: bets $0.50
eJDZmZbsxdLJcAv2PolkwA: folds 
Uncalled bet ($0.50) returned to YEdelvffSYRP4EDNfFp4dA
MIVCHqCqqlke0Lb0z7glcw leaves the table
YEdelvffSYRP4EDNfFp4dA collected $2.90 from pot
*** SUMMARY ***
Total pot $3 | Rake $0.10 
Board [7h 4h Qd 6d 9d]
Seat 4: gGaFLzGESKP3Tj9N/K7QNA (button) folded before Flop (didn't bet)
Seat 5: eJDZmZbsxdLJcAv2PolkwA (small blind) folded on the River
Seat 7: YEdelvffSYRP4EDNfFp4dA (big blind) collected ($2.90)
Seat 8: +sbyWwIcFp9kP0bDtMegfQ folded before Flop (didn't bet)
Seat 9: cFmpjvcjNoVAEAIQIxWkYg folded before Flop (didn't bet)




PokerStars Game #59939407730:  Hold'em No Limit ($0.10/$0.25) - 2009/07/01 0:39:05 ET
Table 'ohAuixfiLOYDylNUG5mNUw' 9-max Seat #9 is the button
Seat 1: AtRN1hdV8HbL3X4XogDaLA ($31.25 in chips) 
Seat 3: HVKi9hnDyvzObpL08/OarQ ($26.60 in chips) 
Seat 4: jeKWRUkMaVn8rEUjnJKqpg ($25 in chips) 
Seat 5: Z5ZtGOON8kmSdSCll9Z3XA ($16.60 in chips) 
Seat 7: WdsZPRB5ooUPinQdaX0QrA ($6.55 in chips) 
Seat 8: ppMlNkhYgErlt4fuJO7ADA ($13.20 in chips) 
Seat 9: hIss79a4pu7GzJZepfgOpg ($25.65 in chips) 
AtRN1hdV8HbL3X4XogDaLA: posts small blind $0.10
HVKi9hnDyvzObpL08/OarQ: posts big blind $0.25
opOCI2p6kW0tINuVaAqmcQ: sits out 
*** HOLE CARDS ***
jeKWRUkMaVn8rEUjnJKqpg: folds 
Z5ZtGOON8kmSdSCll9Z3XA: calls $0.25
WdsZPRB5ooUPinQdaX0QrA: folds 
ppMlNkhYgErlt4fuJO7ADA: calls $0.25
hIss79a4pu7GzJZepfgOpg: calls $0.25
AtRN1hdV8HbL3X4XogDaLA: calls $0.15
HVKi9hnDyvzObpL08/OarQ: checks 
*** FLOP *** [3s Ah As]
AtRN1hdV8HbL3X4XogDaLA: checks 
HVKi9hnDyvzObpL08/OarQ: checks 
Z5ZtGOON8kmSdSCll9Z3XA: checks 
ppMlNkhYgErlt4fuJO7ADA: checks 
hIss79a4pu7GzJZepfgOpg: checks 
*** TURN *** [3s Ah As] [Ts]
AtRN1hdV8HbL3X4XogDaLA: checks 
HVKi9hnDyvzObpL08/OarQ: checks 
Z5ZtGOON8kmSdSCll9Z3XA: checks 
ppMlNkhYgErlt4fuJO7ADA: checks 
hIss79a4pu7GzJZepfgOpg: checks 
*** RIVER *** [3s Ah As Ts] [Qs]
AtRN1hdV8HbL3X4XogDaLA: checks 
HVKi9hnDyvzObpL08/OarQ: checks 
Z5ZtGOON8kmSdSCll9Z3XA: checks 
ppMlNkhYgErlt4fuJO7ADA: checks 
hIss79a4pu7GzJZepfgOpg: bets $0.75
AtRN1hdV8HbL3X4XogDaLA: folds 
HVKi9hnDyvzObpL08/OarQ: folds 
Z5ZtGOON8kmSdSCll9Z3XA: folds 
ppMlNkhYgErlt4fuJO7ADA: folds 
Uncalled bet ($0.75) returned to hIss79a4pu7GzJZepfgOpg
hIss79a4pu7GzJZepfgOpg collected $1.20 from pot
hIss79a4pu7GzJZepfgOpg: doesn't show hand 
*** SUMMARY ***
Total pot $1.25 | Rake $0.05 
Board [3s Ah As Ts Qs]
Seat 1: AtRN1hdV8HbL3X4XogDaLA (small blind) folded on the River
Seat 3: HVKi9hnDyvzObpL08/OarQ (big blind) folded on the River
Seat 4: jeKWRUkMaVn8rEUjnJKqpg folded before Flop (didn't bet)
Seat 5: Z5ZtGOON8kmSdSCll9Z3XA folded on the River
Seat 7: WdsZPRB5ooUPinQdaX0QrA folded before Flop (didn't bet)
Seat 8: ppMlNkhYgErlt4fuJO7ADA folded on the River
Seat 9: hIss79a4pu7GzJZepfgOpg (button) collected ($1.20)




PokerStars Game #59939407560:  Hold'em No Limit ($0.10/$0.25) - 2009/07/01 0:39:05 ET
Table 'i93c3z9RLowvuJTKA2F4Jg' 6-max Seat #1 is the button
Seat 1: tbSZq5LHglyHk61mH9eDBw ($34.80 in chips) 
Seat 2: TSmua8tGK3sTbwi0ynrW9Q ($25 in chips) 
Seat 3: tVIFo6yuan1xauX1WIjH2w ($8.10 in chips) 
Seat 4: o86X2Q5GEDU3uP9oj1iFZA ($29.55 in chips) 
Seat 5: lYjWCpfCxX2kgcHY3v4Yow ($31.75 in chips) 
Seat 6: aSrj4lVmn2owyQ1RbbOqxQ ($25 in chips) 
TSmua8tGK3sTbwi0ynrW9Q: posts small blind $0.10
tVIFo6yuan1xauX1WIjH2w: posts big blind $0.25
*** HOLE CARDS ***
o86X2Q5GEDU3uP9oj1iFZA: calls $0.25
lYjWCpfCxX2kgcHY3v4Yow: folds 
aSrj4lVmn2owyQ1RbbOqxQ: folds 
tbSZq5LHglyHk61mH9eDBw: calls $0.25
TSmua8tGK3sTbwi0ynrW9Q: calls $0.15
tVIFo6yuan1xauX1WIjH2w: checks 
*** FLOP *** [4h Js Kd]
TSmua8tGK3sTbwi0ynrW9Q: checks 
tVIFo6yuan1xauX1WIjH2w: checks 
o86X2Q5GEDU3uP9oj1iFZA: checks 
tbSZq5LHglyHk61mH9eDBw: checks 
*** TURN *** [4h Js Kd] [8h]
TSmua8tGK3sTbwi0ynrW9Q: checks 
tVIFo6yuan1xauX1WIjH2w: checks 
o86X2Q5GEDU3uP9oj1iFZA: checks 
tbSZq5LHglyHk61mH9eDBw: bets $1
TSmua8tGK3sTbwi0ynrW9Q: folds 
tVIFo6yuan1xauX1WIjH2w: folds 
o86X2Q5GEDU3uP9oj1iFZA: folds 
Uncalled bet ($1) returned to tbSZq5LHglyHk61mH9eDBw
tbSZq5LHglyHk61mH9eDBw collected $0.95 from pot
*** SUMMARY ***
Total pot $1 | Rake $0.05 
Board [4h Js Kd 8h]
Seat 1: tbSZq5LHglyHk61mH9eDBw (button) collected ($0.95)
Seat 2: TSmua8tGK3sTbwi0ynrW9Q (small blind) folded on the Turn
Seat 3: tVIFo6yuan1xauX1WIjH2w (big blind) folded on the Turn
Seat 4: o86X2Q5GEDU3uP9oj1iFZA folded on the Turn
Seat 5: lYjWCpfCxX2kgcHY3v4Yow folded before Flop (didn't bet)
Seat 6: aSrj4lVmn2owyQ1RbbOqxQ folded before Flop (didn't bet)




PokerStars Game #59939407370:  Hold'em No Limit ($0.10/$0.25) - 2009/07/01 0:39:05 ET
Table 'APEHQjIcZHDZUA4iOjju2g' 6-max Seat #5 is the button
Seat 1: eHsmIvAb2JREg4O6hNPnXg ($8.35 in chips) 
Seat 2: 3zD3qLXT1bEffAoWGnc7wg ($25 in chips) 
Seat 3: E7KSkgfIsmIsp0vLnmGFmA ($13.40 in chips) 
Seat 4: EqXTTLKUlDlz7yi6ziyyWA ($35.40 in chips) 
Seat 5: /xN6gc9+8Hew0HxaB6VIVg ($31.75 in chips) 
Seat 6: y7HCJfEmolBCFdi/0j5TRg ($44.80 in chips) 
y7HCJfEmolBCFdi/0j5TRg: posts small blind $0.10
eHsmIvAb2JREg4O6hNPnXg: posts big blind $0.25
*** HOLE CARDS ***
3zD3qLXT1bEffAoWGnc7wg: raises $0.75 to $1
E7KSkgfIsmIsp0vLnmGFmA: folds 
EqXTTLKUlDlz7yi6ziyyWA: folds 
/xN6gc9+8Hew0HxaB6VIVg: folds 
y7HCJfEmolBCFdi/0j5TRg: folds 
eHsmIvAb2JREg4O6hNPnXg: folds 
Uncalled bet ($0.75) returned to 3zD3qLXT1bEffAoWGnc7wg
3zD3qLXT1bEffAoWGnc7wg collected $0.60 from pot
3zD3qLXT1bEffAoWGnc7wg: doesn't show hand 
*** SUMMARY ***
Total pot $0.60 | Rake $0 
Seat 1: eHsmIvAb2JREg4O6hNPnXg (big blind) folded before Flop
Seat 2: 3zD3qLXT1bEffAoWGnc7wg collected ($0.60)
Seat 3: E7KSkgfIsmIsp0vLnmGFmA folded before Flop (didn't bet)
Seat 4: EqXTTLKUlDlz7yi6ziyyWA folded before Flop (didn't bet)
Seat 5: /xN6gc9+8Hew0HxaB6VIVg (button) folded before Flop (didn't bet)
Seat 6: y7HCJfEmolBCFdi/0j5TRg (small blind) folded before Flop




PokerStars Game #59939407852:  Hold'em No Limit ($0.10/$0.25) - 2009/07/01 0:39:05 ET
Table 'CM/C/FZf3VHIp50RjmBucQ' 9-max Seat #5 is the button
Seat 1: 1Clf3cPrqoy/YgvWdWK1Xw ($5 in chips) 
Seat 2: 1S/fpm+f42V/6MNZre+ccg ($28.10 in chips) 
Seat 3: dfNim92Z6XK1/h5SFW5vDg ($29.40 in chips) 
Seat 4: oXv2YWrxjhmEfQAgUx964Q ($23.55 in chips) 
Seat 5: TeWJxSETzbXGiYKx0y+dtg ($36.80 in chips) 
Seat 6: 4awUyiDYTgylQKXZ9faBVA ($29.55 in chips) 
Seat 8: cZ99hugmLBj9KhTlc8nCSw ($26.75 in chips) 
Seat 9: Yv4fucyyT28mjx8V5lxKJg ($21.50 in chips) 
4awUyiDYTgylQKXZ9faBVA: posts small blind $0.10
QBNV6v6f+1ZHoaKcQDTWog: is sitting out 
cZ99hugmLBj9KhTlc8nCSw: posts big blind $0.25
*** HOLE CARDS ***
QBNV6v6f+1ZHoaKcQDTWog leaves the table
Yv4fucyyT28mjx8V5lxKJg: folds 
1Clf3cPrqoy/YgvWdWK1Xw: folds 
1S/fpm+f42V/6MNZre+ccg: folds 
dfNim92Z6XK1/h5SFW5vDg: folds 
oXv2YWrxjhmEfQAgUx964Q: raises $0.25 to $0.50
TeWJxSETzbXGiYKx0y+dtg: folds 
4awUyiDYTgylQKXZ9faBVA: folds 
cZ99hugmLBj9KhTlc8nCSw: calls $0.25
*** FLOP *** [2d 7d 9c]
cZ99hugmLBj9KhTlc8nCSw: checks 
oXv2YWrxjhmEfQAgUx964Q: bets $1.25
cZ99hugmLBj9KhTlc8nCSw: folds 
Uncalled bet ($1.25) returned to oXv2YWrxjhmEfQAgUx964Q
oXv2YWrxjhmEfQAgUx964Q collected $1.05 from pot
oXv2YWrxjhmEfQAgUx964Q: doesn't show hand 
*** SUMMARY ***
Total pot $1.10 | Rake $0.05 
Board [2d 7d 9c]
Seat 1: 1Clf3cPrqoy/YgvWdWK1Xw folded before Flop (didn't bet)
Seat 2: 1S/fpm+f42V/6MNZre+ccg folded before Flop (didn't bet)
Seat 3: dfNim92Z6XK1/h5SFW5vDg folded before Flop (didn't bet)
Seat 4: oXv2YWrxjhmEfQAgUx964Q collected ($1.05)
Seat 5: TeWJxSETzbXGiYKx0y+dtg (button) folded before Flop (didn't bet)
Seat 6: 4awUyiDYTgylQKXZ9faBVA (small blind) folded before Flop
Seat 8: cZ99hugmLBj9KhTlc8nCSw (big blind) folded on the Flop
Seat 9: Yv4fucyyT28mjx8V5lxKJg folded before Flop (didn't bet)




PokerStars Game #59939407728:  Hold'em No Limit ($0.10/$0.25) - 2009/07/01 0:39:05 ET
Table 'gYBWJG3hEuJg6kphY0yhMg' 9-max Seat #1 is the button
Seat 1: s7Q6uNouhe7aE8JdFb9E+A ($25.25 in chips) 
Seat 2: z2SmIaQ3+5n/eY1BN5HgPg ($17.80 in chips) 
Seat 3: OkWGxhGhDA0lvNLGWmJxug ($9.20 in chips) 
Seat 5: +sbyWwIcFp9kP0bDtMegfQ ($24.55 in chips) 
Seat 6: 9AI+W5n0har4qZZPPHsjKg ($4.65 in chips) 
Seat 7: xqvFhQD+76TQUT0AVOUMAg ($28 in chips) 
Seat 8: vEUoHYHDD7ub+fv3nZfhVw ($14.15 in chips) 
Seat 9: DxA2S3LbITR502Wya4qTnw ($2.45 in chips) 
z2SmIaQ3+5n/eY1BN5HgPg: posts small blind $0.10
OkWGxhGhDA0lvNLGWmJxug: posts big blind $0.25
*** HOLE CARDS ***
xiximaris joins the table at seat #4 
+sbyWwIcFp9kP0bDtMegfQ: folds 
9AI+W5n0har4qZZPPHsjKg: folds 
xqvFhQD+76TQUT0AVOUMAg: folds 
vEUoHYHDD7ub+fv3nZfhVw: raises $0.50 to $0.75
DxA2S3LbITR502Wya4qTnw: folds 
s7Q6uNouhe7aE8JdFb9E+A: folds 
z2SmIaQ3+5n/eY1BN5HgPg: folds 
OkWGxhGhDA0lvNLGWmJxug: calls $0.50
*** FLOP *** [Ts 3c 6c]
OkWGxhGhDA0lvNLGWmJxug: bets $0.50
vEUoHYHDD7ub+fv3nZfhVw: calls $0.50
*** TURN *** [Ts 3c 6c] [Jc]
OkWGxhGhDA0lvNLGWmJxug: bets $0.75
vEUoHYHDD7ub+fv3nZfhVw: calls $0.75
*** RIVER *** [Ts 3c 6c Jc] [8d]
OkWGxhGhDA0lvNLGWmJxug: bets $0.75
vEUoHYHDD7ub+fv3nZfhVw: folds 
Uncalled bet ($0.75) returned to OkWGxhGhDA0lvNLGWmJxug
vEUoHYHDD7ub+fv3nZfhVw leaves the table
OkWGxhGhDA0lvNLGWmJxug collected $3.90 from pot
OkWGxhGhDA0lvNLGWmJxug: doesn't show hand 
*** SUMMARY ***
Total pot $4.10 | Rake $0.20 
Board [Ts 3c 6c Jc 8d]
Seat 1: s7Q6uNouhe7aE8JdFb9E+A (button) folded before Flop (didn't bet)
Seat 2: z2SmIaQ3+5n/eY1BN5HgPg (small blind) folded before Flop
Seat 3: OkWGxhGhDA0lvNLGWmJxug (big blind) collected ($3.90)
Seat 5: +sbyWwIcFp9kP0bDtMegfQ folded before Flop (didn't bet)
Seat 6: 9AI+W5n0har4qZZPPHsjKg folded before Flop (didn't bet)
Seat 7: xqvFhQD+76TQUT0AVOUMAg folded before Flop (didn't bet)
Seat 8: vEUoHYHDD7ub+fv3nZfhVw folded on the River
Seat 9: DxA2S3LbITR502Wya4qTnw folded before Flop (didn't bet)




PokerStars Game #59939408046:  Hold'em No Limit ($0.10/$0.25) - 2009/07/01 0:39:06 ET
Table '3lL16FBjWXTx3AjK5lMRwwgkdjhbH1jaE3hwhPRIKMiQx Seat #9 is the button
Seat 1: fDGyaQz0cs2s4FOYxkbIHA ($7.90 in chips) 
Seat 2: YK2fIgjF+Z0ARwKKcGh1fw ($18.55 in chips) 
Seat 3: QEbIGci+itdw+re8RM5fZA ($26.25 in chips) 
Seat 4: ZWU9RNYtjmm4cElg1I0F4w ($61.95 in chips) 
Seat 5: M/9j4wkHH9i1JM51vgi1VA ($21.80 in chips) 
Seat 6: hBMUlEpyU74r/fwDgIpXjQ ($41.35 in chips) 
Seat 7: JxpnpCmvRAcrEUy7mq1iAg ($5.40 in chips) 
Seat 8: ljemhp25Zg+nlA9DLCIiUw ($23.30 in chips) 
Seat 9: b8t3jWrxzeEt9HtZtc9wUQ ($10.25 in chips) 
fDGyaQz0cs2s4FOYxkbIHA: posts small blind $0.10
YK2fIgjF+Z0ARwKKcGh1fw: posts big blind $0.25
*** HOLE CARDS ***
QEbIGci+itdw+re8RM5fZA: folds 
ZWU9RNYtjmm4cElg1I0F4w: raises $0.50 to $0.75
M/9j4wkHH9i1JM51vgi1VA: calls $0.75
hBMUlEpyU74r/fwDgIpXjQ: folds 
JxpnpCmvRAcrEUy7mq1iAg: folds 
ljemhp25Zg+nlA9DLCIiUw: folds 
b8t3jWrxzeEt9HtZtc9wUQ: folds 
fDGyaQz0cs2s4FOYxkbIHA: folds 
YK2fIgjF+Z0ARwKKcGh1fw: folds 
*** FLOP *** [Jd Kh 4s]
ZWU9RNYtjmm4cElg1I0F4w: checks 
M/9j4wkHH9i1JM51vgi1VA: checks 
*** TURN *** [Jd Kh 4s] [7c]
ZWU9RNYtjmm4cElg1I0F4w: checks 
M/9j4wkHH9i1JM51vgi1VA: checks 
*** RIVER *** [Jd Kh 4s 7c] [8s]
ZWU9RNYtjmm4cElg1I0F4w: checks 
M/9j4wkHH9i1JM51vgi1VA: checks 
*** SHOW DOWN ***
ZWU9RNYtjmm4cElg1I0F4w: shows [8h 9h] (a pair of Eights)
M/9j4wkHH9i1JM51vgi1VA: shows [Tc Th] (a pair of Tens)
M/9j4wkHH9i1JM51vgi1VA collected $1.80 from pot
*** SUMMARY ***
Total pot $1.85 | Rake $0.05 
Board [Jd Kh 4s 7c 8s]
Seat 1: fDGyaQz0cs2s4FOYxkbIHA (small blind) folded before Flop
Seat 2: YK2fIgjF+Z0ARwKKcGh1fw (big blind) folded before Flop
Seat 3: QEbIGci+itdw+re8RM5fZA folded before Flop (didn't bet)
Seat 4: ZWU9RNYtjmm4cElg1I0F4w showed [8h 9h] and lost with a pair of Eights
Seat 5: M/9j4wkHH9i1JM51vgi1VA showed [Tc Th] and won ($1.80) with a pair of Tens
Seat 6: hBMUlEpyU74r/fwDgIpXjQ folded before Flop (didn't bet)
Seat 7: JxpnpCmvRAcrEUy7mq1iAg folded before Flop (didn't bet)
Seat 8: ljemhp25Zg+nlA9DLCIiUw folded before Flop (didn't bet)
Seat 9: b8t3jWrxzeEt9HtZtc9wUQ (button) folded before Flop (didn't bet)




PokerStars Game #59939408002:  Hold'em No Limit ($0.10/$0.25) - 2009/07/01 0:39:06 ET
Table '1HT8bEDpLPhOXxmqMtzF8w' 9-max Seat #2 is the button
Seat 1: s7Q6uNouhe7aE8JdFb9E+A ($26.20 in chips) 
Seat 2: r6hsffOo1iKmaPYKwAZmFw ($32.15 in chips) 
Seat 3: UJbH2fMMSFUo/jbJteWjjQ ($4.85 in chips) 
Seat 4: Hlc+zGHlRwk7JHfQklkT2g ($8.30 in chips) 
Seat 5: +iRmxp/CsJ/zuqdUG3CXNw ($6.70 in chips) 
Seat 6: 4oA316mXLIui1QY63GXBUg ($25 in chips) 
Seat 7: DIBbjEYGs+TVdVgEB/4+3w ($30.60 in chips) 
Seat 8: ghNKXUBl/H+t83JF079ZBA ($25 in chips) 
Seat 9: 86vbuhJsyH+nbEg5qpDLyQ ($21.15 in chips) 
UJbH2fMMSFUo/jbJteWjjQ: posts small blind $0.10
Hlc+zGHlRwk7JHfQklkT2g: posts big blind $0.25
*** HOLE CARDS ***
+iRmxp/CsJ/zuqdUG3CXNw: folds 
4oA316mXLIui1QY63GXBUg: folds 
DIBbjEYGs+TVdVgEB/4+3w: folds 
ghNKXUBl/H+t83JF079ZBA: folds 
86vbuhJsyH+nbEg5qpDLyQ: raises $0.50 to $0.75
s7Q6uNouhe7aE8JdFb9E+A: folds 
r6hsffOo1iKmaPYKwAZmFw: folds 
UJbH2fMMSFUo/jbJteWjjQ: folds 
Hlc+zGHlRwk7JHfQklkT2g: folds 
Uncalled bet ($0.50) returned to 86vbuhJsyH+nbEg5qpDLyQ
86vbuhJsyH+nbEg5qpDLyQ collected $0.60 from pot
86vbuhJsyH+nbEg5qpDLyQ: doesn't show hand 
*** SUMMARY ***
Total pot $0.60 | Rake $0 
Seat 1: s7Q6uNouhe7aE8JdFb9E+A folded before Flop (didn't bet)
Seat 2: r6hsffOo1iKmaPYKwAZmFw (button) folded before Flop (didn't bet)
Seat 3: UJbH2fMMSFUo/jbJteWjjQ (small blind) folded before Flop
Seat 4: Hlc+zGHlRwk7JHfQklkT2g (big blind) folded before Flop
Seat 5: +iRmxp/CsJ/zuqdUG3CXNw folded before Flop (didn't bet)
Seat 6: 4oA316mXLIui1QY63GXBUg folded before Flop (didn't bet)
Seat 7: DIBbjEYGs+TVdVgEB/4+3w folded before Flop (didn't bet)
Seat 8: ghNKXUBl/H+t83JF079ZBA folded before Flop (didn't bet)
Seat 9: 86vbuhJsyH+nbEg5qpDLyQ collected ($0.60)




PokerStars Game #59939408254:  Hold'em No Limit ($0.10/$0.25) - 2009/07/01 0:39:06 ET
Table 'NgexmgEDEzICBeSO7YCrKQ' 6-max Seat #4 is the button
Seat 1: oseFhpinoe+Zg4j5xyBjyQ ($71.10 in chips) 
Seat 2: 32YL2ZEp8NT4JB2RVM9euQ ($16 in chips) 
Seat 3: JFIAqU8lCZ0vWwEl4bdGsg ($26.90 in chips) 
Seat 4: xx+iYCDJhHJmNzrfeloyEg ($36.85 in chips) 
Seat 5: /MXkdT8TTs8Qp2LVTQNw6w ($47.10 in chips) 
Seat 6: k9nHZTHt8hYhYRcW8NTb4g ($10.65 in chips) 
/MXkdT8TTs8Qp2LVTQNw6w said, ";)"
/MXkdT8TTs8Qp2LVTQNw6w: posts small blind $0.10
k9nHZTHt8hYhYRcW8NTb4g: posts big blind $0.25
*** HOLE CARDS ***
xx+iYCDJhHJmNzrfeloyEg said, "  Lots more profitable than Slick suited, sadly."
oseFhpinoe+Zg4j5xyBjyQ: folds 
32YL2ZEp8NT4JB2RVM9euQ: folds 
/MXkdT8TTs8Qp2LVTQNw6w said, "oh yeah"
JFIAqU8lCZ0vWwEl4bdGsg: folds 
xx+iYCDJhHJmNzrfeloyEg: folds 
/MXkdT8TTs8Qp2LVTQNw6w: calls $0.15
k9nHZTHt8hYhYRcW8NTb4g: checks 
*** FLOP *** [5s Ac Kh]
/MXkdT8TTs8Qp2LVTQNw6w: bets $0.25
k9nHZTHt8hYhYRcW8NTb4g: calls $0.25
*** TURN *** [5s Ac Kh] [Qd]
/MXkdT8TTs8Qp2LVTQNw6w: checks 
k9nHZTHt8hYhYRcW8NTb4g: bets $0.50
/MXkdT8TTs8Qp2LVTQNw6w: calls $0.50
*** RIVER *** [5s Ac Kh Qd] [5h]
/MXkdT8TTs8Qp2LVTQNw6w said, "lol"
/MXkdT8TTs8Qp2LVTQNw6w: checks 
k9nHZTHt8hYhYRcW8NTb4g: checks 
*** SHOW DOWN ***
/MXkdT8TTs8Qp2LVTQNw6w: shows [4h Kc] (two pair, Kings and Fives)
k9nHZTHt8hYhYRcW8NTb4g: shows [7s Kd] (two pair, Kings and Fives)
/MXkdT8TTs8Qp2LVTQNw6w collected $1 from pot
k9nHZTHt8hYhYRcW8NTb4g collected $0.95 from pot
*** SUMMARY ***
Total pot $2 | Rake $0.05 
Board [5s Ac Kh Qd 5h]
Seat 1: oseFhpinoe+Zg4j5xyBjyQ folded before Flop (didn't bet)
Seat 2: 32YL2ZEp8NT4JB2RVM9euQ folded before Flop (didn't bet)
Seat 3: JFIAqU8lCZ0vWwEl4bdGsg folded before Flop (didn't bet)
Seat 4: xx+iYCDJhHJmNzrfeloyEg (button) folded before Flop (didn't bet)
Seat 5: /MXkdT8TTs8Qp2LVTQNw6w (small blind) showed [4h Kc] and won ($1) with two pair, Kings and Fives
Seat 6: k9nHZTHt8hYhYRcW8NTb4g (big blind) showed [7s Kd] and won ($0.95) with two pair, Kings and Fives




PokerStars Game #59939407998:  Hold'em No Limit ($0.10/$0.25) - 2009/07/01 0:39:06 ET
Table 'nQC9LRg01NEuKFHF1nrDEw0XPo7K54oZIfG0xlNAcDRw-max Seat #2 is the button
Seat 1: Nj6/PdBvfG79w0yeIjPmmA ($14.70 in chips) 
Seat 2: cPO/1/dTcZpLkQFm3jH3Rg ($32.05 in chips) 
Seat 4: tLM9aw7T3kBEIhQEh1roOg ($6.50 in chips) 
Seat 5: kG34n23qFQA3nzdOJTQ1dA ($28.60 in chips) 
Seat 6: xQVFeVUDopz+akuEo2wXpQ ($46.60 in chips) 
tLM9aw7T3kBEIhQEh1roOg: posts small blind $0.10
kG34n23qFQA3nzdOJTQ1dA: posts big blind $0.25
*** HOLE CARDS ***
xQVFeVUDopz+akuEo2wXpQ: folds 
Nj6/PdBvfG79w0yeIjPmmA: calls $0.25
cPO/1/dTcZpLkQFm3jH3Rg: folds 
tLM9aw7T3kBEIhQEh1roOg: calls $0.15
kG34n23qFQA3nzdOJTQ1dA: checks 
*** FLOP *** [Kh Ad 9c]
tLM9aw7T3kBEIhQEh1roOg: checks 
kG34n23qFQA3nzdOJTQ1dA: checks 
Nj6/PdBvfG79w0yeIjPmmA: checks 
*** TURN *** [Kh Ad 9c] [3c]
tLM9aw7T3kBEIhQEh1roOg: checks 
kG34n23qFQA3nzdOJTQ1dA: checks 
Nj6/PdBvfG79w0yeIjPmmA: checks 
*** RIVER *** [Kh Ad 9c 3c] [6s]
tLM9aw7T3kBEIhQEh1roOg: checks 
kG34n23qFQA3nzdOJTQ1dA: checks 
Nj6/PdBvfG79w0yeIjPmmA: checks 
*** SHOW DOWN ***
tLM9aw7T3kBEIhQEh1roOg: shows [Qh 7c] (high card Ace)
kG34n23qFQA3nzdOJTQ1dA: shows [3d Qd] (a pair of Threes)
Nj6/PdBvfG79w0yeIjPmmA: mucks hand 
kG34n23qFQA3nzdOJTQ1dA collected $0.75 from pot
*** SUMMARY ***
Total pot $0.75 | Rake $0 
Board [Kh Ad 9c 3c 6s]
Seat 1: Nj6/PdBvfG79w0yeIjPmmA mucked
Seat 2: cPO/1/dTcZpLkQFm3jH3Rg (button) folded before Flop (didn't bet)
Seat 4: tLM9aw7T3kBEIhQEh1roOg (small blind) showed [Qh 7c] and lost with high card Ace
Seat 5: kG34n23qFQA3nzdOJTQ1dA (big blind) showed [3d Qd] and won ($0.75) with a pair of Threes
Seat 6: xQVFeVUDopz+akuEo2wXpQ folded before Flop (didn't bet)




PokerStars Game #59939408904:  Hold'em No Limit ($0.10/$0.25) - 2009/07/01 0:39:07 ET
Table 'O5NgMYt6EWbLBozZb3kseg' 6-max Seat #5 is the button
Seat 1: T2fEtpqj5ZyZAjEhNtsFAA ($38.95 in chips) 
Seat 2: VWbjqONyDvf8KegytgPLjQ ($61.40 in chips) 
Seat 4: aogAb4Eienxztk8p2v9VVw ($23.65 in chips) 
Seat 5: vu2kzHaDtgr6NM7rdq0chA ($45.50 in chips) 
Seat 6: k9vn40MOqqb+xF+7GZ6v2g ($22.95 in chips) 
k9vn40MOqqb+xF+7GZ6v2g: posts small blind $0.10
T2fEtpqj5ZyZAjEhNtsFAA: posts big blind $0.25
*** HOLE CARDS ***
VWbjqONyDvf8KegytgPLjQ: folds 
aogAb4Eienxztk8p2v9VVw: folds 
vu2kzHaDtgr6NM7rdq0chA: raises $1 to $1.25
k9vn40MOqqb+xF+7GZ6v2g: folds 
T2fEtpqj5ZyZAjEhNtsFAA: calls $1
*** FLOP *** [4s Qd 9h]
T2fEtpqj5ZyZAjEhNtsFAA: checks 
vu2kzHaDtgr6NM7rdq0chA: checks 
*** TURN *** [4s Qd 9h] [5s]
T2fEtpqj5ZyZAjEhNtsFAA: bets $0.25
vu2kzHaDtgr6NM7rdq0chA: calls $0.25
*** RIVER *** [4s Qd 9h 5s] [8d]
T2fEtpqj5ZyZAjEhNtsFAA: bets $0.50
vu2kzHaDtgr6NM7rdq0chA: calls $0.50
*** SHOW DOWN ***
T2fEtpqj5ZyZAjEhNtsFAA: shows [As 9d] (a pair of Nines)
vu2kzHaDtgr6NM7rdq0chA: mucks hand 
T2fEtpqj5ZyZAjEhNtsFAA collected $3.95 from pot
*** SUMMARY ***
Total pot $4.10 | Rake $0.15 
Board [4s Qd 9h 5s 8d]
Seat 1: T2fEtpqj5ZyZAjEhNtsFAA (big blind) showed [As 9d] and won ($3.95) with a pair of Nines
Seat 2: VWbjqONyDvf8KegytgPLjQ folded before Flop (didn't bet)
Seat 4: aogAb4Eienxztk8p2v9VVw folded before Flop (didn't bet)
Seat 5: vu2kzHaDtgr6NM7rdq0chA (button) mucked
Seat 6: k9vn40MOqqb+xF+7GZ6v2g (small blind) folded before Flop




PokerStars Game #59939408684:  Hold'em No Limit ($0.10/$0.25) - 2009/07/01 0:39:07 ET
Table 'ROYvQOMwUrvL3SOiHYcrWg' 9-max Seat #2 is the button
Seat 1: 7q7lZBfgmzjFr0jTNx4b6g ($11.35 in chips) 
Seat 2: hBMUlEpyU74r/fwDgIpXjQ ($48.85 in chips) 
Seat 4: SHegmCn8B0InbWE/zFlvOw ($28.80 in chips) 
Seat 5: jeKWRUkMaVn8rEUjnJKqpg ($25 in chips) 
Seat 6: ZWU9RNYtjmm4cElg1I0F4w ($33.35 in chips) 
Seat 7: tYsOBqdU1+x+yFI7zHO7hQ ($26.25 in chips) 
Seat 9: H361Owx55YUAYmPZdz+Hzg ($11.55 in chips) 
SHegmCn8B0InbWE/zFlvOw: posts small blind $0.10
jeKWRUkMaVn8rEUjnJKqpg: posts big blind $0.25
ModestZL: sits out 
*** HOLE CARDS ***
ZWU9RNYtjmm4cElg1I0F4w: folds 
tYsOBqdU1+x+yFI7zHO7hQ: folds 
H361Owx55YUAYmPZdz+Hzg: folds 
7q7lZBfgmzjFr0jTNx4b6g: folds 
hBMUlEpyU74r/fwDgIpXjQ: folds 
SHegmCn8B0InbWE/zFlvOw: folds 
Uncalled bet ($0.15) returned to jeKWRUkMaVn8rEUjnJKqpg
jeKWRUkMaVn8rEUjnJKqpg collected $0.20 from pot
jeKWRUkMaVn8rEUjnJKqpg: doesn't show hand 
*** SUMMARY ***
Total pot $0.20 | Rake $0 
Seat 1: 7q7lZBfgmzjFr0jTNx4b6g folded before Flop (didn't bet)
Seat 2: hBMUlEpyU74r/fwDgIpXjQ (button) folded before Flop (didn't bet)
Seat 4: SHegmCn8B0InbWE/zFlvOw (small blind) folded before Flop
Seat 5: jeKWRUkMaVn8rEUjnJKqpg (big blind) collected ($0.20)
Seat 6: ZWU9RNYtjmm4cElg1I0F4w folded before Flop (didn't bet)
Seat 7: tYsOBqdU1+x+yFI7zHO7hQ folded before Flop (didn't bet)
Seat 9: H361Owx55YUAYmPZdz+Hzg folded before Flop (didn't bet)




PokerStars Game #59939408994:  Hold'em No Limit ($0.10/$0.25) - 2009/07/01 0:39:07 ET
Table 'f9j+4UOgRPXbyNbQkZFm4w' 6-max Seat #3 is the button
Seat 1: trN/oHqTTbPw5MNuKrOpLw ($30.85 in chips) 
Seat 2: VHBox3ZuV+/MP3dz2hFEBQ ($5.10 in chips) 
Seat 3: wCBHaebpIJ2ZTqigoRi9DA ($17.75 in chips) 
Seat 4: hiTEr3yrERiQp3zHXRioVw ($21.85 in chips) 
Seat 5: 1lxYIAoJdZwAbzIkzWmSkw ($9 in chips) 
Seat 6: C84t1kUtjDF/zm38/Dpcng ($10.60 in chips) 
hiTEr3yrERiQp3zHXRioVw: posts small blind $0.10
1lxYIAoJdZwAbzIkzWmSkw: posts big blind $0.25
C84t1kUtjDF/zm38/Dpcng: posts big blind $0.25
*** HOLE CARDS ***
C84t1kUtjDF/zm38/Dpcng: checks 
trN/oHqTTbPw5MNuKrOpLw: folds 
VHBox3ZuV+/MP3dz2hFEBQ: folds 
wCBHaebpIJ2ZTqigoRi9DA: folds 
hiTEr3yrERiQp3zHXRioVw: folds 
1lxYIAoJdZwAbzIkzWmSkw: checks 
*** FLOP *** [6s 8d 7d]
1lxYIAoJdZwAbzIkzWmSkw: checks 
C84t1kUtjDF/zm38/Dpcng: bets $0.75
1lxYIAoJdZwAbzIkzWmSkw: folds 
Uncalled bet ($0.75) returned to C84t1kUtjDF/zm38/Dpcng
C84t1kUtjDF/zm38/Dpcng collected $0.60 from pot
*** SUMMARY ***
Total pot $0.60 | Rake $0 
Board [6s 8d 7d]
Seat 1: trN/oHqTTbPw5MNuKrOpLw folded before Flop (didn't bet)
Seat 2: VHBox3ZuV+/MP3dz2hFEBQ folded before Flop (didn't bet)
Seat 3: wCBHaebpIJ2ZTqigoRi9DA (button) folded before Flop (didn't bet)
Seat 4: hiTEr3yrERiQp3zHXRioVw (small blind) folded before Flop
Seat 5: 1lxYIAoJdZwAbzIkzWmSkw (big blind) folded on the Flop
Seat 6: C84t1kUtjDF/zm38/Dpcng collected ($0.60)




PokerStars Game #59939409012:  Hold'em No Limit ($0.10/$0.25) - 2009/07/01 0:39:07 ET
Table 'WEMI3Mtn7dGARDbgNrKibgQvLFJzpzymuOsaaRYi+8fgx Seat #4 is the button
Seat 2: R6nIVAjK7uhK3Hj0f85A+A ($23.70 in chips) 
Seat 3: W+vSAd2K80ck4uMklFb1OA ($6.70 in chips) 
Seat 4: MIVCHqCqqlke0Lb0z7glcw ($21.50 in chips) 
Seat 5: MG90wfSJZnOejs/KD3vlQQ ($25.35 in chips) 
Seat 6: /bZlLwyIh+PmlqdCRwfoTg ($11.75 in chips) 
Seat 7: rQhYIYXSyH/IivYM1dlV5A ($16.40 in chips) 
MG90wfSJZnOejs/KD3vlQQ: posts small blind $0.10
/bZlLwyIh+PmlqdCRwfoTg: posts big blind $0.25
*** HOLE CARDS ***
rQhYIYXSyH/IivYM1dlV5A: folds 
R6nIVAjK7uhK3Hj0f85A+A: folds 
W+vSAd2K80ck4uMklFb1OA: calls $0.25
MIVCHqCqqlke0Lb0z7glcw: folds 
MG90wfSJZnOejs/KD3vlQQ: calls $0.15
/bZlLwyIh+PmlqdCRwfoTg: raises $0.50 to $0.75
W+vSAd2K80ck4uMklFb1OA: calls $0.50
MG90wfSJZnOejs/KD3vlQQ: calls $0.50
*** FLOP *** [Ah 9h 5d]
MG90wfSJZnOejs/KD3vlQQ: checks 
/bZlLwyIh+PmlqdCRwfoTg: checks 
W+vSAd2K80ck4uMklFb1OA: checks 
*** TURN *** [Ah 9h 5d] [8c]
MIVCHqCqqlke0Lb0z7glcw leaves the table
MG90wfSJZnOejs/KD3vlQQ: checks 
/bZlLwyIh+PmlqdCRwfoTg: bets $0.75
W+vSAd2K80ck4uMklFb1OA: folds 
MG90wfSJZnOejs/KD3vlQQ: calls $0.75
*** RIVER *** [Ah 9h 5d 8c] [9d]
MG90wfSJZnOejs/KD3vlQQ: checks 
/bZlLwyIh+PmlqdCRwfoTg: bets $1.25
MG90wfSJZnOejs/KD3vlQQ: calls $1.25
*** SHOW DOWN ***
/bZlLwyIh+PmlqdCRwfoTg: shows [Qs Qc] (two pair, Queens and Nines)
MG90wfSJZnOejs/KD3vlQQ: mucks hand 
/bZlLwyIh+PmlqdCRwfoTg collected $5.95 from pot
*** SUMMARY ***
Total pot $6.25 | Rake $0.30 
Board [Ah 9h 5d 8c 9d]
Seat 2: R6nIVAjK7uhK3Hj0f85A+A folded before Flop (didn't bet)
Seat 3: W+vSAd2K80ck4uMklFb1OA folded on the Turn
Seat 4: MIVCHqCqqlke0Lb0z7glcw (button) folded before Flop (didn't bet)
Seat 5: MG90wfSJZnOejs/KD3vlQQ (small blind) mucked
Seat 6: /bZlLwyIh+PmlqdCRwfoTg (big blind) showed [Qs Qc] and won ($5.95) with two pair, Queens and Nines
Seat 7: rQhYIYXSyH/IivYM1dlV5A folded before Flop (didn't bet)




PokerStars Game #59939409186:  Hold'em No Limit ($0.10/$0.25) - 2009/07/01 0:39:07 ET
Table '+fuYjvJy9okLr23QyZtanA' 9-max Seat #4 is the button
Seat 1: s7Q6uNouhe7aE8JdFb9E+A ($30.90 in chips) 
Seat 4: H/l9NZvuOXwQIPOaVdj0rQ ($9.30 in chips) 
H/l9NZvuOXwQIPOaVdj0rQ: posts small blind $0.10
s7Q6uNouhe7aE8JdFb9E+A: posts big blind $0.25
*** HOLE CARDS ***
H/l9NZvuOXwQIPOaVdj0rQ: raises $0.75 to $1
s7Q6uNouhe7aE8JdFb9E+A: folds 
Uncalled bet ($0.75) returned to H/l9NZvuOXwQIPOaVdj0rQ
H/l9NZvuOXwQIPOaVdj0rQ collected $0.50 from pot
H/l9NZvuOXwQIPOaVdj0rQ: doesn't show hand 
*** SUMMARY ***
Total pot $0.50 | Rake $0 
Seat 1: s7Q6uNouhe7aE8JdFb9E+A (big blind) folded before Flop
Seat 4: H/l9NZvuOXwQIPOaVdj0rQ (button) (small blind) collected ($0.50)




PokerStars Game #59939408894:  Hold'em No Limit ($0.10/$0.25) - 2009/07/01 0:39:07 ET
Table '4hfTdIVT/qPsJNfWXLsVIw' 9-max Seat #2 is the button
Seat 1: GbHFBbLqLGz0Pwn6CJeAuw ($24.45 in chips) 
Seat 2: NB5rKy+grn9jKcWXclZ7WA ($33.40 in chips) 
Seat 3: opOCI2p6kW0tINuVaAqmcQ ($26.90 in chips) 
Seat 4: OiV1PWZ3IkN29JlmCcnTwQ ($4.90 in chips) 
Seat 6: VWUWpMLMj/Q1jRVpF7Aohw ($8.70 in chips) 
Seat 7: z5GxcHlYz/GSz6W2uFiTtg ($31.90 in chips) 
Seat 8: EfRs3ibIxn+c9JDErwwNCg ($31.65 in chips) 
Seat 9: K5byIbXY6S+c1wAeHitZow ($11.85 in chips) 
opOCI2p6kW0tINuVaAqmcQ: posts small blind $0.10
OiV1PWZ3IkN29JlmCcnTwQ: posts big blind $0.25
IBond007: sits out 
*** HOLE CARDS ***
VWUWpMLMj/Q1jRVpF7Aohw: folds 
z5GxcHlYz/GSz6W2uFiTtg: folds 
EfRs3ibIxn+c9JDErwwNCg: folds 
K5byIbXY6S+c1wAeHitZow: calls $0.25
GbHFBbLqLGz0Pwn6CJeAuw: calls $0.25
NB5rKy+grn9jKcWXclZ7WA: calls $0.25
opOCI2p6kW0tINuVaAqmcQ: folds 
OiV1PWZ3IkN29JlmCcnTwQ: checks 
*** FLOP *** [5c 2h Kc]
OiV1PWZ3IkN29JlmCcnTwQ: checks 
K5byIbXY6S+c1wAeHitZow: checks 
GbHFBbLqLGz0Pwn6CJeAuw: checks 
NB5rKy+grn9jKcWXclZ7WA: checks 
*** TURN *** [5c 2h Kc] [9s]
OiV1PWZ3IkN29JlmCcnTwQ: checks 
K5byIbXY6S+c1wAeHitZow: bets $0.25
GbHFBbLqLGz0Pwn6CJeAuw: folds 
NB5rKy+grn9jKcWXclZ7WA: folds 
OiV1PWZ3IkN29JlmCcnTwQ: folds 
Uncalled bet ($0.25) returned to K5byIbXY6S+c1wAeHitZow
K5byIbXY6S+c1wAeHitZow collected $1.05 from pot
*** SUMMARY ***
Total pot $1.10 | Rake $0.05 
Board [5c 2h Kc 9s]
Seat 1: GbHFBbLqLGz0Pwn6CJeAuw folded on the Turn
Seat 2: NB5rKy+grn9jKcWXclZ7WA (button) folded on the Turn
Seat 3: opOCI2p6kW0tINuVaAqmcQ (small blind) folded before Flop
Seat 4: OiV1PWZ3IkN29JlmCcnTwQ (big blind) folded on the Turn
Seat 6: VWUWpMLMj/Q1jRVpF7Aohw folded before Flop (didn't bet)
Seat 7: z5GxcHlYz/GSz6W2uFiTtg folded before Flop (didn't bet)
Seat 8: EfRs3ibIxn+c9JDErwwNCg folded before Flop (didn't bet)
Seat 9: K5byIbXY6S+c1wAeHitZow collected ($1.05)




PokerStars Game #59939409776:  Hold'em No Limit ($0.10/$0.25) - 2009/07/01 0:39:08 ET
Table 'GoBmKm3klK6VavJE4STfmQ' 9-max Seat #6 is the button
Seat 1: N6fYvIzQLKaydFLKQGtMlQ ($23.55 in chips) 
Seat 2: 1c/7DHPx5CDTmAfk8/bWeA ($15 in chips) 
Seat 3: 4awUyiDYTgylQKXZ9faBVA ($26.40 in chips) 
Seat 4: H5Se03ZqSX7tbULXur2MAg ($24.30 in chips) 
Seat 5: 8B/dhbQjIWe6ASCdgzktNQ ($25.20 in chips) 
Seat 6: S3QwXyGCcujfAwNubHpwbw ($6.05 in chips) 
Seat 7: s9a4d23HFxaL70yUWQ0/tQ ($21.25 in chips) 
Seat 8: cZ99hugmLBj9KhTlc8nCSw ($25.35 in chips) 
Seat 9: 1K6QGyJP9P9xmRac2fH4OQ ($47 in chips) 
s9a4d23HFxaL70yUWQ0/tQ: posts small blind $0.10
cZ99hugmLBj9KhTlc8nCSw: posts big blind $0.25
*** HOLE CARDS ***
1K6QGyJP9P9xmRac2fH4OQ: folds 
N6fYvIzQLKaydFLKQGtMlQ: folds 
1c/7DHPx5CDTmAfk8/bWeA: folds 
4awUyiDYTgylQKXZ9faBVA: folds 
H5Se03ZqSX7tbULXur2MAg: folds 
8B/dhbQjIWe6ASCdgzktNQ: folds 
S3QwXyGCcujfAwNubHpwbw: raises $0.25 to $0.50
s9a4d23HFxaL70yUWQ0/tQ: folds 
cZ99hugmLBj9KhTlc8nCSw: folds 
Uncalled bet ($0.25) returned to S3QwXyGCcujfAwNubHpwbw
S3QwXyGCcujfAwNubHpwbw collected $0.60 from pot
*** SUMMARY ***
Total pot $0.60 | Rake $0 
Seat 1: N6fYvIzQLKaydFLKQGtMlQ folded before Flop (didn't bet)
Seat 2: 1c/7DHPx5CDTmAfk8/bWeA folded before Flop (didn't bet)
Seat 3: 4awUyiDYTgylQKXZ9faBVA folded before Flop (didn't bet)
Seat 4: H5Se03ZqSX7tbULXur2MAg folded before Flop (didn't bet)
Seat 5: 8B/dhbQjIWe6ASCdgzktNQ folded before Flop (didn't bet)
Seat 6: S3QwXyGCcujfAwNubHpwbw (button) collected ($0.60)
Seat 7: s9a4d23HFxaL70yUWQ0/tQ (small blind) folded before Flop
Seat 8: cZ99hugmLBj9KhTlc8nCSw (big blind) folded before Flop
Seat 9: 1K6QGyJP9P9xmRac2fH4OQ folded before Flop (didn't bet)




PokerStars Game #59939409294:  Hold'em No Limit ($0.10/$0.25) - 2009/07/01 0:39:08 ET
Table 'srBTB98reCdD1TffxE6o7g' 6-max Seat #5 is the button
Seat 1: FEzezmgaiyVRh9sHKhd+9Q ($44.25 in chips) 
Seat 2: YaAEMJGY5tem39deCUQRNw ($61.35 in chips) 
Seat 3: 4YSTu0Cdzpppe1lUgCZGCQ ($36.65 in chips) 
Seat 4: nGcD53mEekM1riwMpyBSXw ($5.05 in chips) 
Seat 5: n2OZezRXTtdzQt4SuIy8TQ ($18.60 in chips) 
Seat 6: gaPMxLGp9SOj4Lq6t+/0Ig ($14.85 in chips) 
gaPMxLGp9SOj4Lq6t+/0Ig: posts small blind $0.10
FEzezmgaiyVRh9sHKhd+9Q: posts big blind $0.25
*** HOLE CARDS ***
YaAEMJGY5tem39deCUQRNw: folds 
4YSTu0Cdzpppe1lUgCZGCQ: raises $0.75 to $1
nGcD53mEekM1riwMpyBSXw: raises $4.05 to $5.05 and is all-in
n2OZezRXTtdzQt4SuIy8TQ: folds 
gaPMxLGp9SOj4Lq6t+/0Ig: folds 
FEzezmgaiyVRh9sHKhd+9Q: folds 
4YSTu0Cdzpppe1lUgCZGCQ: calls $4.05
*** FLOP *** [Kc 4h Qd]
*** TURN *** [Kc 4h Qd] [5s]
*** RIVER *** [Kc 4h Qd 5s] [Td]
*** SHOW DOWN ***
4YSTu0Cdzpppe1lUgCZGCQ: shows [As 9c] (high card Ace)
nGcD53mEekM1riwMpyBSXw: shows [Ah Jh] (a straight, Ten to Ace)
nGcD53mEekM1riwMpyBSXw collected $9.95 from pot
*** SUMMARY ***
Total pot $10.45 | Rake $0.50 
Board [Kc 4h Qd 5s Td]
Seat 1: FEzezmgaiyVRh9sHKhd+9Q (big blind) folded before Flop
Seat 2: YaAEMJGY5tem39deCUQRNw folded before Flop (didn't bet)
Seat 3: 4YSTu0Cdzpppe1lUgCZGCQ showed [As 9c] and lost with high card Ace
Seat 4: nGcD53mEekM1riwMpyBSXw showed [Ah Jh] and won ($9.95) with a straight, Ten to Ace
Seat 5: n2OZezRXTtdzQt4SuIy8TQ (button) folded before Flop (didn't bet)
Seat 6: gaPMxLGp9SOj4Lq6t+/0Ig (small blind) folded before Flop




PokerStars Game #59939409344:  Hold'em No Limit ($0.10/$0.25) - 2009/07/01 0:39:08 ET
Table '5NipxzzFB2DffzDpddyQoQ' 6-max Seat #6 is the button
Seat 1: TslQs7AQSLbVtr4X8JOOOQ ($15.10 in chips) 
Seat 2: jxrNE4qd8KCOIqHjQcwCrA ($40.80 in chips) 
Seat 3: qGHGf/553gQnDoklMRe3tg ($46.90 in chips) 
Seat 4: Inq44d7PQ+8TbEKfPeuxVQ ($6.35 in chips) 
Seat 5: cS21pIxRHx5Gt42o7hPZzw ($12.30 in chips) 
Seat 6: lYjWCpfCxX2kgcHY3v4Yow ($27.30 in chips) 
TslQs7AQSLbVtr4X8JOOOQ: posts small blind $0.10
jxrNE4qd8KCOIqHjQcwCrA: posts big blind $0.25
*** HOLE CARDS ***
qGHGf/553gQnDoklMRe3tg: raises $0.75 to $1
Inq44d7PQ+8TbEKfPeuxVQ: folds 
cS21pIxRHx5Gt42o7hPZzw: folds 
lYjWCpfCxX2kgcHY3v4Yow: folds 
TslQs7AQSLbVtr4X8JOOOQ: calls $0.90
jxrNE4qd8KCOIqHjQcwCrA: folds 
*** FLOP *** [7d 6h 3s]
TslQs7AQSLbVtr4X8JOOOQ: checks 
qGHGf/553gQnDoklMRe3tg: bets $1.50
TslQs7AQSLbVtr4X8JOOOQ: calls $1.50
*** TURN *** [7d 6h 3s] [Ks]
TslQs7AQSLbVtr4X8JOOOQ: checks 
qGHGf/553gQnDoklMRe3tg: checks 
*** RIVER *** [7d 6h 3s Ks] [6s]
TslQs7AQSLbVtr4X8JOOOQ: checks 
qGHGf/553gQnDoklMRe3tg: checks 
*** SHOW DOWN ***
TslQs7AQSLbVtr4X8JOOOQ: shows [2h 2c] (two pair, Sixes and Deuces)
qGHGf/553gQnDoklMRe3tg: shows [Jc Js] (two pair, Jacks and Sixes)
qGHGf/553gQnDoklMRe3tg collected $5 from pot
*** SUMMARY ***
Total pot $5.25 | Rake $0.25 
Board [7d 6h 3s Ks 6s]
Seat 1: TslQs7AQSLbVtr4X8JOOOQ (small blind) showed [2h 2c] and lost with two pair, Sixes and Deuces
Seat 2: jxrNE4qd8KCOIqHjQcwCrA (big blind) folded before Flop
Seat 3: qGHGf/553gQnDoklMRe3tg showed [Jc Js] and won ($5) with two pair, Jacks and Sixes
Seat 4: Inq44d7PQ+8TbEKfPeuxVQ folded before Flop (didn't bet)
Seat 5: cS21pIxRHx5Gt42o7hPZzw folded before Flop (didn't bet)
Seat 6: lYjWCpfCxX2kgcHY3v4Yow (button) folded before Flop (didn't bet)




PokerStars Game #59939409262:  Hold'em No Limit ($0.10/$0.25) - 2009/07/01 0:39:08 ET
Table '/JJyyIstHfkT7t/bW+WXgg' 6-max Seat #3 is the button
Seat 1: wsP46AGpqDjHZQmlRHKa9g ($26.15 in chips) 
Seat 2: eRDLpytVTPI4rY3iortMSw ($10.25 in chips) 
Seat 3: oc4ZGs0W+3RIg2yPyJw3ig ($25.85 in chips) 
Seat 4: ELW+DKizJhLK7k40PMkD2Q ($25.90 in chips) 
Seat 5: 2wkoolB4YxxVC2x99F9rcA ($25 in chips) 
Seat 6: d338A2rm6NtA1ECEZi4d2g ($16.50 in chips) 
ELW+DKizJhLK7k40PMkD2Q: posts small blind $0.10
2wkoolB4YxxVC2x99F9rcA: posts big blind $0.25
*** HOLE CARDS ***
d338A2rm6NtA1ECEZi4d2g: folds 
wsP46AGpqDjHZQmlRHKa9g: folds 
eRDLpytVTPI4rY3iortMSw: calls $0.25
oc4ZGs0W+3RIg2yPyJw3ig: folds 
ELW+DKizJhLK7k40PMkD2Q: folds 
2wkoolB4YxxVC2x99F9rcA: checks 
*** FLOP *** [3d 2h 9h]
2wkoolB4YxxVC2x99F9rcA: checks 
eRDLpytVTPI4rY3iortMSw: bets $0.25
2wkoolB4YxxVC2x99F9rcA: folds 
Uncalled bet ($0.25) returned to eRDLpytVTPI4rY3iortMSw
eRDLpytVTPI4rY3iortMSw collected $0.60 from pot
eRDLpytVTPI4rY3iortMSw: doesn't show hand 
*** SUMMARY ***
Total pot $0.60 | Rake $0 
Board [3d 2h 9h]
Seat 1: wsP46AGpqDjHZQmlRHKa9g folded before Flop (didn't bet)
Seat 2: eRDLpytVTPI4rY3iortMSw collected ($0.60)
Seat 3: oc4ZGs0W+3RIg2yPyJw3ig (button) folded before Flop (didn't bet)
Seat 4: ELW+DKizJhLK7k40PMkD2Q (small blind) folded before Flop
Seat 5: 2wkoolB4YxxVC2x99F9rcA (big blind) folded on the Flop
Seat 6: d338A2rm6NtA1ECEZi4d2g folded before Flop (didn't bet)




PokerStars Game #59939409412:  Hold'em No Limit ($0.10/$0.25) - 2009/07/01 0:39:08 ET
Table 'fIrOIN3HoXM27ZpRwKa6oA' 6-max Seat #3 is the button
Seat 1: I1TxPvWj8NfG8orglCinNA ($38.85 in chips) 
Seat 2: 5tB0F9NjPSUL4FzmzBMs2Q ($35.80 in chips) 
Seat 3: OElpcjPk5wP6xlAUngsAmg ($3.90 in chips) 
Seat 4: PEUgcMc+CzvN+vLwu5DsLQ ($3.05 in chips) 
Seat 5: 8ClCHtFXGNplITm+63KB+Q ($27.15 in chips) 
Seat 6: v+QfkGiuj9bgtuNoVnDO8w ($30.05 in chips) 
PEUgcMc+CzvN+vLwu5DsLQ: posts small blind $0.10
8ClCHtFXGNplITm+63KB+Q: posts big blind $0.25
*** HOLE CARDS ***
v+QfkGiuj9bgtuNoVnDO8w: folds 
I1TxPvWj8NfG8orglCinNA: folds 
5tB0F9NjPSUL4FzmzBMs2Q: folds 
OElpcjPk5wP6xlAUngsAmg: folds 
PEUgcMc+CzvN+vLwu5DsLQ: calls $0.15
8ClCHtFXGNplITm+63KB+Q: checks 
*** FLOP *** [3d 7c Kh]
PEUgcMc+CzvN+vLwu5DsLQ: bets $0.75
8ClCHtFXGNplITm+63KB+Q: folds 
Uncalled bet ($0.75) returned to PEUgcMc+CzvN+vLwu5DsLQ
PEUgcMc+CzvN+vLwu5DsLQ collected $0.50 from pot
PEUgcMc+CzvN+vLwu5DsLQ: doesn't show hand 
*** SUMMARY ***
Total pot $0.50 | Rake $0 
Board [3d 7c Kh]
Seat 1: I1TxPvWj8NfG8orglCinNA folded before Flop (didn't bet)
Seat 2: 5tB0F9NjPSUL4FzmzBMs2Q folded before Flop (didn't bet)
Seat 3: OElpcjPk5wP6xlAUngsAmg (button) folded before Flop (didn't bet)
Seat 4: PEUgcMc+CzvN+vLwu5DsLQ (small blind) collected ($0.50)
Seat 5: 8ClCHtFXGNplITm+63KB+Q (big blind) folded on the Flop
Seat 6: v+QfkGiuj9bgtuNoVnDO8w folded before Flop (didn't bet)




PokerStars Game #59939409566:  Hold'em No Limit ($0.10/$0.25) - 2009/07/01 0:39:08 ET
Table 'HbNAGS1OJWQKyfk7UfrYyw' 9-max Seat #2 is the button
Seat 1: YHeeiaUNFin/MUYZJuW1VA ($10.30 in chips) 
Seat 2: Jt0gcXubHx3//kZT9X5jGQ ($28.05 in chips) 
Seat 3: DIBbjEYGs+TVdVgEB/4+3w ($30.30 in chips) 
Seat 5: cu58S48zQeRuppc18okJLA ($14.65 in chips) 
Seat 6: W4TLQcZ2TiM73eIgpIvlGg ($24.75 in chips) 
Seat 9: 8IJfEa/AAO04NtzGHO9CFQ ($15.25 in chips) 
DIBbjEYGs+TVdVgEB/4+3w: posts small blind $0.10
cu58S48zQeRuppc18okJLA: posts big blind $0.25
*** HOLE CARDS ***
W4TLQcZ2TiM73eIgpIvlGg: calls $0.25
8IJfEa/AAO04NtzGHO9CFQ: folds 
YHeeiaUNFin/MUYZJuW1VA: calls $0.25
Jt0gcXubHx3//kZT9X5jGQ: folds 
DIBbjEYGs+TVdVgEB/4+3w: folds 
cu58S48zQeRuppc18okJLA: checks 
*** FLOP *** [6c 5h 8c]
cu58S48zQeRuppc18okJLA: bets $0.50
8IJfEa/AAO04NtzGHO9CFQ said, "im not as think as u drunk i am"
W4TLQcZ2TiM73eIgpIvlGg: raises $1 to $1.50
YHeeiaUNFin/MUYZJuW1VA: folds 
cu58S48zQeRuppc18okJLA: calls $1
*** TURN *** [6c 5h 8c] [5d]
cu58S48zQeRuppc18okJLA: checks 
W4TLQcZ2TiM73eIgpIvlGg: checks 
*** RIVER *** [6c 5h 8c 5d] [Qd]
cu58S48zQeRuppc18okJLA: checks 
Jt0gcXubHx3//kZT9X5jGQ said, "Igus i hade 3 Kings ;)"
W4TLQcZ2TiM73eIgpIvlGg: bets $23 and is all-in
cu58S48zQeRuppc18okJLA: folds 
Uncalled bet ($23) returned to W4TLQcZ2TiM73eIgpIvlGg
W4TLQcZ2TiM73eIgpIvlGg collected $3.70 from pot
*** SUMMARY ***
Total pot $3.85 | Rake $0.15 
Board [6c 5h 8c 5d Qd]
Seat 1: YHeeiaUNFin/MUYZJuW1VA folded on the Flop
Seat 2: Jt0gcXubHx3//kZT9X5jGQ (button) folded before Flop (didn't bet)
Seat 3: DIBbjEYGs+TVdVgEB/4+3w (small blind) folded before Flop
Seat 5: cu58S48zQeRuppc18okJLA (big blind) folded on the River
Seat 6: W4TLQcZ2TiM73eIgpIvlGg collected ($3.70)
Seat 9: 8IJfEa/AAO04NtzGHO9CFQ folded before Flop (didn't bet)




PokerStars Game #59939409524:  Hold'em No Limit ($0.10/$0.25) - 2009/07/01 0:39:08 ET
Table 'fRxOyfaHXkWUDLv4eSxFew' 9-max Seat #4 is the button
Seat 2: TeWJxSETzbXGiYKx0y+dtg ($24.30 in chips) 
Seat 3: hBMUlEpyU74r/fwDgIpXjQ ($25.20 in chips) 
Seat 4: aCVg6cCxQcqClhB9nq/p1w ($51.50 in chips) 
Seat 6: N/O9ADKpmqB2ASZuqgodlw ($6.90 in chips) 
Seat 7: 7cv+9Zc9HIQHNvYsMfV3uA ($54.40 in chips) 
Seat 8: 1K6QGyJP9P9xmRac2fH4OQ ($25 in chips) 
Seat 9: H5Se03ZqSX7tbULXur2MAg ($23.80 in chips) 
N/O9ADKpmqB2ASZuqgodlw: posts small blind $0.10
7cv+9Zc9HIQHNvYsMfV3uA: posts big blind $0.25
OlPJsgR4xypSg/w1z7Gyvw: sits out 
*** HOLE CARDS ***
1K6QGyJP9P9xmRac2fH4OQ: calls $0.25
H5Se03ZqSX7tbULXur2MAg: folds 
TeWJxSETzbXGiYKx0y+dtg: calls $0.25
hBMUlEpyU74r/fwDgIpXjQ: raises $1 to $1.25
aCVg6cCxQcqClhB9nq/p1w: folds 
N/O9ADKpmqB2ASZuqgodlw: folds 
7cv+9Zc9HIQHNvYsMfV3uA: folds 
1K6QGyJP9P9xmRac2fH4OQ: folds 
TeWJxSETzbXGiYKx0y+dtg: folds 
Uncalled bet ($1) returned to hBMUlEpyU74r/fwDgIpXjQ
hBMUlEpyU74r/fwDgIpXjQ collected $1.10 from pot
hBMUlEpyU74r/fwDgIpXjQ: doesn't show hand 
*** SUMMARY ***
Total pot $1.10 | Rake $0 
Seat 2: TeWJxSETzbXGiYKx0y+dtg folded before Flop
Seat 3: hBMUlEpyU74r/fwDgIpXjQ collected ($1.10)
Seat 4: aCVg6cCxQcqClhB9nq/p1w (button) folded before Flop (didn't bet)
Seat 6: N/O9ADKpmqB2ASZuqgodlw (small blind) folded before Flop
Seat 7: 7cv+9Zc9HIQHNvYsMfV3uA (big blind) folded before Flop
Seat 8: 1K6QGyJP9P9xmRac2fH4OQ folded before Flop
Seat 9: H5Se03ZqSX7tbULXur2MAg folded before Flop (didn't bet)




PokerStars Game #59939409564:  Hold'em No Limit ($0.10/$0.25) - 2009/07/01 0:39:08 ET
Table 'FuFyQHmlO/QqQp//rDRrPg' 6-max Seat #5 is the button
Seat 1: 4re+a1K56DcbV7DyVX/FMw ($15.45 in chips) 
Seat 3: uoOTv6ecGYEhLPY44ZTW+A ($11.35 in chips) 
Seat 4: Eznneya0vB6S+eXJdVleHA ($9.65 in chips) 
Seat 5: wAKC8C/zN0c8V5v13dm9mA ($25 in chips) 
Seat 6: Euh3U8PK9KVQP5CQdDjkeQ ($20.90 in chips) 
Euh3U8PK9KVQP5CQdDjkeQ: posts small blind $0.10
4re+a1K56DcbV7DyVX/FMw: posts big blind $0.25
0DvgWV5o6c/jYqQCjm4Haw: sits out 
*** HOLE CARDS ***
uoOTv6ecGYEhLPY44ZTW+A: folds 
Eznneya0vB6S+eXJdVleHA: folds 
wAKC8C/zN0c8V5v13dm9mA: folds 
Euh3U8PK9KVQP5CQdDjkeQ: folds 
Uncalled bet ($0.15) returned to 4re+a1K56DcbV7DyVX/FMw
4re+a1K56DcbV7DyVX/FMw collected $0.20 from pot
*** SUMMARY ***
Total pot $0.20 | Rake $0 
Seat 1: 4re+a1K56DcbV7DyVX/FMw (big blind) collected ($0.20)
Seat 3: uoOTv6ecGYEhLPY44ZTW+A folded before Flop (didn't bet)
Seat 4: Eznneya0vB6S+eXJdVleHA folded before Flop (didn't bet)
Seat 5: wAKC8C/zN0c8V5v13dm9mA (button) folded before Flop (didn't bet)
Seat 6: Euh3U8PK9KVQP5CQdDjkeQ (small blind) folded before Flop




PokerStars Game #59939409754:  Hold'em No Limit ($0.10/$0.25) - 2009/07/01 0:39:08 ET
Table 'JJzUs04lHpXg6nboT1/jeg' 6-max Seat #5 is the button
Seat 3: uUXdcVMNa05rfbntdvplfw ($10.10 in chips) 
Seat 4: nwwpaieDRI0UPyVtChVHOg ($36.70 in chips) 
Seat 5: Vr2XE7yYBdg3RZSURDAPEg ($23.80 in chips) 
uUXdcVMNa05rfbntdvplfw: posts small blind $0.10
nwwpaieDRI0UPyVtChVHOg: posts big blind $0.25
*** HOLE CARDS ***
Vr2XE7yYBdg3RZSURDAPEg: raises $0.50 to $0.75
uUXdcVMNa05rfbntdvplfw: folds 
nwwpaieDRI0UPyVtChVHOg: folds 
Uncalled bet ($0.50) returned to Vr2XE7yYBdg3RZSURDAPEg
Vr2XE7yYBdg3RZSURDAPEg collected $0.60 from pot
Vr2XE7yYBdg3RZSURDAPEg: doesn't show hand 
*** SUMMARY ***
Total pot $0.60 | Rake $0 
Seat 3: uUXdcVMNa05rfbntdvplfw (small blind) folded before Flop
Seat 4: nwwpaieDRI0UPyVtChVHOg (big blind) folded before Flop
Seat 5: Vr2XE7yYBdg3RZSURDAPEg (button) collected ($0.60)




PokerStars Game #59939409598:  Hold'em No Limit ($0.10/$0.25) - 2009/07/01 0:39:08 ET
Table 'sJ4KpS2GE5Qrsu1/cFjJUw' 9-max Seat #3 is the button
Seat 1: QsLvCwfSWqP+CfjwUnjpXQ ($14.40 in chips) 
Seat 3: eDil7UzSZCjyh1VP6SVXJQ ($7.05 in chips) 
Seat 8: f8ixGbSVIs6Be0mH69ldVQ ($15.10 in chips) 
danno12345 will be allowed to play after the button
f8ixGbSVIs6Be0mH69ldVQ: posts small blind $0.10
QsLvCwfSWqP+CfjwUnjpXQ: posts big blind $0.25
*** HOLE CARDS ***
eDil7UzSZCjyh1VP6SVXJQ: calls $0.25
f8ixGbSVIs6Be0mH69ldVQ: calls $0.15
QsLvCwfSWqP+CfjwUnjpXQ: checks 
*** FLOP *** [9c Kh 6h]
f8ixGbSVIs6Be0mH69ldVQ: checks 
QsLvCwfSWqP+CfjwUnjpXQ: checks 
eDil7UzSZCjyh1VP6SVXJQ: bets $0.25
danno12345 leaves the table
f8ixGbSVIs6Be0mH69ldVQ: folds 
QsLvCwfSWqP+CfjwUnjpXQ: folds 
Uncalled bet ($0.25) returned to eDil7UzSZCjyh1VP6SVXJQ
eDil7UzSZCjyh1VP6SVXJQ collected $0.75 from pot
eDil7UzSZCjyh1VP6SVXJQ: doesn't show hand 
*** SUMMARY ***
Total pot $0.75 | Rake $0 
Board [9c Kh 6h]
Seat 1: QsLvCwfSWqP+CfjwUnjpXQ (big blind) folded on the Flop
Seat 3: eDil7UzSZCjyh1VP6SVXJQ (button) collected ($0.75)
Seat 8: f8ixGbSVIs6Be0mH69ldVQ (small blind) folded on the Flop




PokerStars Game #59939410026:  Hold'em No Limit ($0.10/$0.25) - 2009/07/01 0:39:09 ET
Table 'dNYnr4D4id1jwnEU66Yowg' 9-max Seat #2 is the button
Seat 2: t2nb95S5EEFOEzNx9Itz0g ($6.35 in chips) 
Seat 5: k+2r6di6GXjNpAdrRkW9bA ($22.45 in chips) 
Seat 6: kqpa/IbqkUrwPb3hbA7/ww ($7.75 in chips) 
k+2r6di6GXjNpAdrRkW9bA: posts small blind $0.10
kqpa/IbqkUrwPb3hbA7/ww: posts big blind $0.25
*** HOLE CARDS ***
t2nb95S5EEFOEzNx9Itz0g: raises $0.25 to $0.50
k+2r6di6GXjNpAdrRkW9bA: calls $0.40
kqpa/IbqkUrwPb3hbA7/ww: calls $0.25
*** FLOP *** [Ac 4s 5h]
k+2r6di6GXjNpAdrRkW9bA: bets $0.75
kqpa/IbqkUrwPb3hbA7/ww: calls $0.75
t2nb95S5EEFOEzNx9Itz0g: folds 
*** TURN *** [Ac 4s 5h] [7s]
k+2r6di6GXjNpAdrRkW9bA: bets $1
kqpa/IbqkUrwPb3hbA7/ww: calls $1
*** RIVER *** [Ac 4s 5h 7s] [Qh]
k+2r6di6GXjNpAdrRkW9bA: bets $1
kqpa/IbqkUrwPb3hbA7/ww: folds 
Uncalled bet ($1) returned to k+2r6di6GXjNpAdrRkW9bA
kqpa/IbqkUrwPb3hbA7/ww is sitting out
k+2r6di6GXjNpAdrRkW9bA collected $4.80 from pot
k+2r6di6GXjNpAdrRkW9bA: doesn't show hand 
*** SUMMARY ***
Total pot $5 | Rake $0.20 
Board [Ac 4s 5h 7s Qh]
Seat 2: t2nb95S5EEFOEzNx9Itz0g (button) folded on the Flop
Seat 5: k+2r6di6GXjNpAdrRkW9bA (small blind) collected ($4.80)
Seat 6: kqpa/IbqkUrwPb3hbA7/ww (big blind) folded on the River




PokerStars Game #59939410184:  Hold'em No Limit ($0.10/$0.25) - 2009/07/01 0:39:09 ET
Table 'T/iCKJXGphRN3xcdwfE/JQ' 6-max Seat #4 is the button
Seat 1: zZ8zH49EwNs0mqgppOaL9g ($24 in chips) 
Seat 2: FHilMb2i2DbUCc9lplszog ($14.55 in chips) 
Seat 3: R6AGToFJQOYVZAjC2jXEKw ($25.85 in chips) 
Seat 4: yzFNNFIfC89bBPwpFPx2ow ($46.25 in chips) 
Seat 6: jKYGBgexhqKT13Xana4EHg ($10.80 in chips) 
jKYGBgexhqKT13Xana4EHg: posts small blind $0.10
zZ8zH49EwNs0mqgppOaL9g: posts big blind $0.25
*** HOLE CARDS ***
FHilMb2i2DbUCc9lplszog: folds 
R6AGToFJQOYVZAjC2jXEKw: folds 
yzFNNFIfC89bBPwpFPx2ow: folds 
jKYGBgexhqKT13Xana4EHg: calls $0.15
zZ8zH49EwNs0mqgppOaL9g: checks 
*** FLOP *** [Ts Jh Ad]
jKYGBgexhqKT13Xana4EHg: checks 
zZ8zH49EwNs0mqgppOaL9g: checks 
*** TURN *** [Ts Jh Ad] [2h]
jKYGBgexhqKT13Xana4EHg: checks 
zZ8zH49EwNs0mqgppOaL9g: bets $0.50
jKYGBgexhqKT13Xana4EHg: calls $0.50
*** RIVER *** [Ts Jh Ad 2h] [4h]
jKYGBgexhqKT13Xana4EHg: bets $0.75
zZ8zH49EwNs0mqgppOaL9g: folds 
Uncalled bet ($0.75) returned to jKYGBgexhqKT13Xana4EHg
jKYGBgexhqKT13Xana4EHg collected $1.45 from pot
jKYGBgexhqKT13Xana4EHg: doesn't show hand 
*** SUMMARY ***
Total pot $1.50 | Rake $0.05 
Board [Ts Jh Ad 2h 4h]
Seat 1: zZ8zH49EwNs0mqgppOaL9g (big blind) folded on the River
Seat 2: FHilMb2i2DbUCc9lplszog folded before Flop (didn't bet)
Seat 3: R6AGToFJQOYVZAjC2jXEKw folded before Flop (didn't bet)
Seat 4: yzFNNFIfC89bBPwpFPx2ow (button) folded before Flop (didn't bet)
Seat 6: jKYGBgexhqKT13Xana4EHg (small blind) collected ($1.45)




PokerStars Game #59939409896:  Hold'em No Limit ($0.10/$0.25) - 2009/07/01 0:39:09 ET
Table 'BpNkESDX1ip9c0K1hb5h7A' 6-max Seat #3 is the button
Seat 1: 9jSiy0meE9XJKkdIZwyTEQ ($28.75 in chips) 
Seat 3: cHhVLDikFlByGGN+CM3w/A ($24.50 in chips) 
Seat 4: tbhYGxTClzdFLMcTtjvJhg ($48.95 in chips) 
Seat 5: QvTX2yGq3uKJiKPmns4TKQ ($72.65 in chips) 
Seat 6: iUgsn+WyKFjjVd+tj13R2w ($14.75 in chips) 
tbhYGxTClzdFLMcTtjvJhg: posts small blind $0.10
QvTX2yGq3uKJiKPmns4TKQ: posts big blind $0.25
*** HOLE CARDS ***
iUgsn+WyKFjjVd+tj13R2w: calls $0.25
9jSiy0meE9XJKkdIZwyTEQ: folds 
cHhVLDikFlByGGN+CM3w/A: folds 
tbhYGxTClzdFLMcTtjvJhg: calls $0.15
QvTX2yGq3uKJiKPmns4TKQ: checks 
*** FLOP *** [6h Ts 7s]
tbhYGxTClzdFLMcTtjvJhg: checks 
QvTX2yGq3uKJiKPmns4TKQ: bets $0.75
iUgsn+WyKFjjVd+tj13R2w: calls $0.75
tbhYGxTClzdFLMcTtjvJhg: calls $0.75
*** TURN *** [6h Ts 7s] [8c]
tbhYGxTClzdFLMcTtjvJhg: checks 
QvTX2yGq3uKJiKPmns4TKQ: checks 
iUgsn+WyKFjjVd+tj13R2w: bets $0.50
tbhYGxTClzdFLMcTtjvJhg: folds 
QvTX2yGq3uKJiKPmns4TKQ: folds 
Uncalled bet ($0.50) returned to iUgsn+WyKFjjVd+tj13R2w
iUgsn+WyKFjjVd+tj13R2w collected $2.85 from pot
*** SUMMARY ***
Total pot $3 | Rake $0.15 
Board [6h Ts 7s 8c]
Seat 1: 9jSiy0meE9XJKkdIZwyTEQ folded before Flop (didn't bet)
Seat 3: cHhVLDikFlByGGN+CM3w/A (button) folded before Flop (didn't bet)
Seat 4: tbhYGxTClzdFLMcTtjvJhg (small blind) folded on the Turn
Seat 5: QvTX2yGq3uKJiKPmns4TKQ (big blind) folded on the Turn
Seat 6: iUgsn+WyKFjjVd+tj13R2w collected ($2.85)




PokerStars Game #59939410142:  Hold'em No Limit ($0.10/$0.25) - 2009/07/01 0:39:09 ET
Table '4XGDnEByOol5up4aB2KbJw' 6-max Seat #5 is the button
Seat 1: kyRaCIljYA6l33lSKQfNsg ($34.20 in chips) 
Seat 2: SFmT9ZsVopnukjvAzrxTRg ($26.25 in chips) 
Seat 3: LtASJ9OlkqGrrUKGQlpGAw ($23.60 in chips) 
Seat 4: sjoibHX/s93+8Kwa5aB1dA ($27.85 in chips) 
Seat 5: Dh01+rohD2p9pXLYeBlC5Q ($18.25 in chips) 
Seat 6: ELW+DKizJhLK7k40PMkD2Q ($28.20 in chips) 
ELW+DKizJhLK7k40PMkD2Q: posts small blind $0.10
kyRaCIljYA6l33lSKQfNsg: posts big blind $0.25
*** HOLE CARDS ***
SFmT9ZsVopnukjvAzrxTRg: folds 
LtASJ9OlkqGrrUKGQlpGAw: folds 
sjoibHX/s93+8Kwa5aB1dA: calls $0.25
Dh01+rohD2p9pXLYeBlC5Q: calls $0.25
ELW+DKizJhLK7k40PMkD2Q: folds 
kyRaCIljYA6l33lSKQfNsg: raises $1.50 to $1.75
sjoibHX/s93+8Kwa5aB1dA: folds 
Dh01+rohD2p9pXLYeBlC5Q: folds 
Uncalled bet ($1.50) returned to kyRaCIljYA6l33lSKQfNsg
kyRaCIljYA6l33lSKQfNsg collected $0.85 from pot
*** SUMMARY ***
Total pot $0.85 | Rake $0 
Seat 1: kyRaCIljYA6l33lSKQfNsg (big blind) collected ($0.85)
Seat 2: SFmT9ZsVopnukjvAzrxTRg folded before Flop (didn't bet)
Seat 3: LtASJ9OlkqGrrUKGQlpGAw folded before Flop (didn't bet)
Seat 4: sjoibHX/s93+8Kwa5aB1dA folded before Flop
Seat 5: Dh01+rohD2p9pXLYeBlC5Q (button) folded before Flop
Seat 6: ELW+DKizJhLK7k40PMkD2Q (small blind) folded before Flop




PokerStars Game #59939409916:  Hold'em No Limit ($0.10/$0.25) - 2009/07/01 0:39:09 ET
Table 'ORSZkZqq+7Ja2PdeCFAytA' 9-max Seat #5 is the button
Seat 1: Gpa8cld5y0mdOomHJgHhlA ($10.90 in chips) 
Seat 2: yduPKWPzL8YlT5Zv/Nmrwg ($10 in chips) 
Seat 3: nm4Dj/f+jJEwKVsUnKh73g ($24.75 in chips) 
Seat 4: b8t3jWrxzeEt9HtZtc9wUQ ($26.45 in chips) 
Seat 5: tYsOBqdU1+x+yFI7zHO7hQ ($31.30 in chips) 
Seat 8: opOCI2p6kW0tINuVaAqmcQ ($39.20 in chips) 
opOCI2p6kW0tINuVaAqmcQ: posts small blind $0.10
VBHxUExRAMrbxUq/cVx9Gw: is sitting out 
Gpa8cld5y0mdOomHJgHhlA: posts big blind $0.25
*** HOLE CARDS ***
ZoG0obuajzVjwgd7lNHjgg leaves the table
yduPKWPzL8YlT5Zv/Nmrwg: folds 
VBHxUExRAMrbxUq/cVx9Gw leaves the table
nm4Dj/f+jJEwKVsUnKh73g: folds 
b8t3jWrxzeEt9HtZtc9wUQ: folds 
tYsOBqdU1+x+yFI7zHO7hQ: folds 
opOCI2p6kW0tINuVaAqmcQ: folds 
Uncalled bet ($0.15) returned to Gpa8cld5y0mdOomHJgHhlA
Gpa8cld5y0mdOomHJgHhlA collected $0.20 from pot
*** SUMMARY ***
Total pot $0.20 | Rake $0 
Seat 1: Gpa8cld5y0mdOomHJgHhlA (big blind) collected ($0.20)
Seat 2: yduPKWPzL8YlT5Zv/Nmrwg folded before Flop (didn't bet)
Seat 3: nm4Dj/f+jJEwKVsUnKh73g folded before Flop (didn't bet)
Seat 4: b8t3jWrxzeEt9HtZtc9wUQ folded before Flop (didn't bet)
Seat 5: tYsOBqdU1+x+yFI7zHO7hQ (button) folded before Flop (didn't bet)
Seat 8: opOCI2p6kW0tINuVaAqmcQ (small blind) folded before Flop




PokerStars Game #59939410148:  Hold'em No Limit ($0.10/$0.25) - 2009/07/01 0:39:09 ET
Table 'GrYi0DZOHD1EvB+qiLExNw' 9-max Seat #5 is the button
Seat 1: 4awUyiDYTgylQKXZ9faBVA ($48.85 in chips) 
Seat 2: Th3FldXKQW6hWVVPahaoOQ ($26.65 in chips) 
Seat 3: 4oA316mXLIui1QY63GXBUg ($25 in chips) 
Seat 4: 0GQg6tdDMBDzY6FKumSo9w ($24.95 in chips) 
Seat 5: cZ99hugmLBj9KhTlc8nCSw ($48.50 in chips) 
Seat 6: H9KUl8cmpLgEpOVDA00bCg ($4.30 in chips) 
Seat 7: 1Clf3cPrqoy/YgvWdWK1Xw ($5.25 in chips) 
Seat 9: st9jtdNbm1W5GfBwRaCVqQ ($24.75 in chips) 
H9KUl8cmpLgEpOVDA00bCg: posts small blind $0.10
1Clf3cPrqoy/YgvWdWK1Xw: posts big blind $0.25
0GQg6tdDMBDzY6FKumSo9w: posts small & big blinds $0.35
*** HOLE CARDS ***
st9jtdNbm1W5GfBwRaCVqQ: folds 
4awUyiDYTgylQKXZ9faBVA: folds 
Th3FldXKQW6hWVVPahaoOQ: folds 
4oA316mXLIui1QY63GXBUg: folds 
nalbG/4/1Z1wQjRDWV7b2w has returned
0GQg6tdDMBDzY6FKumSo9w: checks 
cZ99hugmLBj9KhTlc8nCSw: folds 
H9KUl8cmpLgEpOVDA00bCg: folds 
1Clf3cPrqoy/YgvWdWK1Xw: checks 
*** FLOP *** [9s 6c 4h]
1Clf3cPrqoy/YgvWdWK1Xw: bets $0.50
0GQg6tdDMBDzY6FKumSo9w: calls $0.50
*** TURN *** [9s 6c 4h] [Qs]
1Clf3cPrqoy/YgvWdWK1Xw: checks 
0GQg6tdDMBDzY6FKumSo9w: bets $0.75
1Clf3cPrqoy/YgvWdWK1Xw: folds 
Uncalled bet ($0.75) returned to 0GQg6tdDMBDzY6FKumSo9w
0GQg6tdDMBDzY6FKumSo9w collected $1.65 from pot
0GQg6tdDMBDzY6FKumSo9w: doesn't show hand 
*** SUMMARY ***
Total pot $1.70 | Rake $0.05 
Board [9s 6c 4h Qs]
Seat 1: 4awUyiDYTgylQKXZ9faBVA folded before Flop (didn't bet)
Seat 2: Th3FldXKQW6hWVVPahaoOQ folded before Flop (didn't bet)
Seat 3: 4oA316mXLIui1QY63GXBUg folded before Flop (didn't bet)
Seat 4: 0GQg6tdDMBDzY6FKumSo9w collected ($1.65)
Seat 5: cZ99hugmLBj9KhTlc8nCSw (button) folded before Flop (didn't bet)
Seat 6: H9KUl8cmpLgEpOVDA00bCg (small blind) folded before Flop
Seat 7: 1Clf3cPrqoy/YgvWdWK1Xw (big blind) folded on the Turn
Seat 9: st9jtdNbm1W5GfBwRaCVqQ folded before Flop (didn't bet)




PokerStars Game #59939410466:  Hold'em No Limit ($0.10/$0.25) - 2009/07/01 0:39:10 ET
Table 'Is9eNmJA1KnBOw0lcVkxUQ' 9-max Seat #4 is the button
Seat 1: 56S3mA6Zs3pGR+0p0vUCtg ($36.80 in chips) 
Seat 2: VllYilcih0t+gMD4GTRlgQ ($40.40 in chips) 
Seat 3: zFrHk6ssFhTu+DiVzVXr+g ($15.85 in chips) 
Seat 4: cZ99hugmLBj9KhTlc8nCSw ($25 in chips) 
Seat 5: d9fERE+24v0MqnylCrXchQ ($5 in chips) 
Seat 6: HapyJHxV6lc3eqoT7yWL2A ($24.10 in chips) 
Seat 7: aNpwfA31EREwO+ar4XzBCw ($25 in chips) 
Seat 8: 1b3eMBC7sPXgDX9IYcruKg ($6.90 in chips) 
d9fERE+24v0MqnylCrXchQ: posts small blind $0.10
HapyJHxV6lc3eqoT7yWL2A: posts big blind $0.25
7wo6Sr7QG3Zo6BaBDV1BOw: sits out 
*** HOLE CARDS ***
aNpwfA31EREwO+ar4XzBCw: folds 
1b3eMBC7sPXgDX9IYcruKg: calls $0.25
56S3mA6Zs3pGR+0p0vUCtg: raises $1 to $1.25
VllYilcih0t+gMD4GTRlgQ: folds 
zFrHk6ssFhTu+DiVzVXr+g: folds 
cZ99hugmLBj9KhTlc8nCSw: folds 
d9fERE+24v0MqnylCrXchQ: calls $1.15
HapyJHxV6lc3eqoT7yWL2A: calls $1
1b3eMBC7sPXgDX9IYcruKg: calls $1
*** FLOP *** [4h 2c Qs]
d9fERE+24v0MqnylCrXchQ: checks 
HapyJHxV6lc3eqoT7yWL2A: bets $2.50
1b3eMBC7sPXgDX9IYcruKg: folds 
56S3mA6Zs3pGR+0p0vUCtg: calls $2.50
d9fERE+24v0MqnylCrXchQ: raises $1.25 to $3.75 and is all-in
HapyJHxV6lc3eqoT7yWL2A: calls $1.25
56S3mA6Zs3pGR+0p0vUCtg: calls $1.25
*** TURN *** [4h 2c Qs] [5h]
HapyJHxV6lc3eqoT7yWL2A: bets $3.50
56S3mA6Zs3pGR+0p0vUCtg: raises $4.50 to $8
HapyJHxV6lc3eqoT7yWL2A: calls $4.50
*** RIVER *** [4h 2c Qs 5h] [5s]
HapyJHxV6lc3eqoT7yWL2A: checks 
56S3mA6Zs3pGR+0p0vUCtg: bets $8.50
HapyJHxV6lc3eqoT7yWL2A: calls $8.50
*** SHOW DOWN ***
56S3mA6Zs3pGR+0p0vUCtg: shows [Ac Qh] (two pair, Queens and Fives)
HapyJHxV6lc3eqoT7yWL2A: shows [Ah Qd] (two pair, Queens and Fives)
HapyJHxV6lc3eqoT7yWL2A collected $15.75 from side pot
56S3mA6Zs3pGR+0p0vUCtg collected $15.70 from side pot
d9fERE+24v0MqnylCrXchQ: mucks hand 
d9fERE+24v0MqnylCrXchQ leaves the table
HapyJHxV6lc3eqoT7yWL2A collected $7.75 from main pot
56S3mA6Zs3pGR+0p0vUCtg collected $7.70 from main pot
*** SUMMARY ***
Total pot $49.25 Main pot $15.45. Side pot $31.45. | Rake $2.35 
Board [4h 2c Qs 5h 5s]
Seat 1: 56S3mA6Zs3pGR+0p0vUCtg showed [Ac Qh] and won ($23.40) with two pair, Queens and Fives
Seat 2: VllYilcih0t+gMD4GTRlgQ folded before Flop (didn't bet)
Seat 3: zFrHk6ssFhTu+DiVzVXr+g folded before Flop (didn't bet)
Seat 4: cZ99hugmLBj9KhTlc8nCSw (button) folded before Flop (didn't bet)
Seat 5: d9fERE+24v0MqnylCrXchQ (small blind) mucked
Seat 6: HapyJHxV6lc3eqoT7yWL2A (big blind) showed [Ah Qd] and won ($23.50) with two pair, Queens and Fives
Seat 7: aNpwfA31EREwO+ar4XzBCw folded before Flop (didn't bet)
Seat 8: 1b3eMBC7sPXgDX9IYcruKg folded on the Flop




PokerStars Game #59939410436:  Hold'em No Limit ($0.10/$0.25) - 2009/07/01 0:39:10 ET
Table 'SgI2Cobdjtkh0Fd0/eTTDg' 9-max Seat #4 is the button
Seat 1: JRfCWETUoKaEo7sf/Jy3Kg ($25.40 in chips) 
Seat 2: 8B/dhbQjIWe6ASCdgzktNQ ($42.20 in chips) 
Seat 3: OiV1PWZ3IkN29JlmCcnTwQ ($4.90 in chips) 
Seat 4: 18G4P1XstjNvItdGUITxgw ($25 in chips) 
Seat 5: w/RUHfVzKTf7Bc19nucLpQ ($8.15 in chips) 
Seat 6: f8ewQKsexlXbhtBqiLFb8A ($9.95 in chips) 
Seat 7: aJy680tKSaP5er559aSuGA ($22.70 in chips) 
Seat 9: cZ99hugmLBj9KhTlc8nCSw ($25.90 in chips) 
w/RUHfVzKTf7Bc19nucLpQ: posts small blind $0.10
f8ewQKsexlXbhtBqiLFb8A: posts big blind $0.25
*** HOLE CARDS ***
aJy680tKSaP5er559aSuGA: folds 
cZ99hugmLBj9KhTlc8nCSw: folds 
JRfCWETUoKaEo7sf/Jy3Kg: calls $0.25
8B/dhbQjIWe6ASCdgzktNQ: folds 
OiV1PWZ3IkN29JlmCcnTwQ: folds 
18G4P1XstjNvItdGUITxgw: folds 
w/RUHfVzKTf7Bc19nucLpQ: folds 
f8ewQKsexlXbhtBqiLFb8A: raises $0.50 to $0.75
JRfCWETUoKaEo7sf/Jy3Kg: calls $0.50
*** FLOP *** [9c 4h Js]
f8ewQKsexlXbhtBqiLFb8A: bets $1
JRfCWETUoKaEo7sf/Jy3Kg: folds 
Uncalled bet ($1) returned to f8ewQKsexlXbhtBqiLFb8A
f8ewQKsexlXbhtBqiLFb8A collected $1.55 from pot
*** SUMMARY ***
Total pot $1.60 | Rake $0.05 
Board [9c 4h Js]
Seat 1: JRfCWETUoKaEo7sf/Jy3Kg folded on the Flop
Seat 2: 8B/dhbQjIWe6ASCdgzktNQ folded before Flop (didn't bet)
Seat 3: OiV1PWZ3IkN29JlmCcnTwQ folded before Flop (didn't bet)
Seat 4: 18G4P1XstjNvItdGUITxgw (button) folded before Flop (didn't bet)
Seat 5: w/RUHfVzKTf7Bc19nucLpQ (small blind) folded before Flop
Seat 6: f8ewQKsexlXbhtBqiLFb8A (big blind) collected ($1.55)
Seat 7: aJy680tKSaP5er559aSuGA folded before Flop (didn't bet)
Seat 9: cZ99hugmLBj9KhTlc8nCSw folded before Flop (didn't bet)




PokerStars Game #59939410868:  Hold'em No Limit ($0.10/$0.25) - 2009/07/01 0:39:10 ET
Table 'Of/T60zpXg1GcjrZ7Lm//Q' 9-max Seat #6 is the button
Seat 1: Lro4e37x4FUa5P3yzDjskw ($7.80 in chips) 
Seat 2: hIss79a4pu7GzJZepfgOpg ($25.45 in chips) 
Seat 3: jeKWRUkMaVn8rEUjnJKqpg ($25 in chips) 
Seat 4: Czut6V7acIqUJrrobjKAZg ($25.05 in chips) 
Seat 5: 18G4P1XstjNvItdGUITxgw ($25 in chips) 
Seat 6: tYsOBqdU1+x+yFI7zHO7hQ ($25.75 in chips) 
Seat 7: s7Q6uNouhe7aE8JdFb9E+A ($34.35 in chips) 
Seat 8: ghNKXUBl/H+t83JF079ZBA ($29 in chips) 
Seat 9: TeWJxSETzbXGiYKx0y+dtg ($24.65 in chips) 
s7Q6uNouhe7aE8JdFb9E+A: posts small blind $0.10
ghNKXUBl/H+t83JF079ZBA: posts big blind $0.25
*** HOLE CARDS ***
TeWJxSETzbXGiYKx0y+dtg: folds 
Lro4e37x4FUa5P3yzDjskw: folds 
hIss79a4pu7GzJZepfgOpg: raises $0.75 to $1
jeKWRUkMaVn8rEUjnJKqpg: folds 
Czut6V7acIqUJrrobjKAZg: folds 
18G4P1XstjNvItdGUITxgw: folds 
tYsOBqdU1+x+yFI7zHO7hQ: folds 
s7Q6uNouhe7aE8JdFb9E+A has timed out
s7Q6uNouhe7aE8JdFb9E+A: folds 
s7Q6uNouhe7aE8JdFb9E+A is sitting out
s7Q6uNouhe7aE8JdFb9E+A has returned
ghNKXUBl/H+t83JF079ZBA: calls $0.75
*** FLOP *** [Ac 6d 3d]
ghNKXUBl/H+t83JF079ZBA: checks 
hIss79a4pu7GzJZepfgOpg: bets $1.50
ghNKXUBl/H+t83JF079ZBA: calls $1.50
*** TURN *** [Ac 6d 3d] [9c]
ghNKXUBl/H+t83JF079ZBA: checks 
hIss79a4pu7GzJZepfgOpg: checks 
*** RIVER *** [Ac 6d 3d 9c] [5h]
ghNKXUBl/H+t83JF079ZBA: checks 
hIss79a4pu7GzJZepfgOpg: checks 
*** SHOW DOWN ***
ghNKXUBl/H+t83JF079ZBA: shows [Ah Ks] (a pair of Aces)
hIss79a4pu7GzJZepfgOpg: mucks hand 
ghNKXUBl/H+t83JF079ZBA collected $4.85 from pot
*** SUMMARY ***
Total pot $5.10 | Rake $0.25 
Board [Ac 6d 3d 9c 5h]
Seat 1: Lro4e37x4FUa5P3yzDjskw folded before Flop (didn't bet)
Seat 2: hIss79a4pu7GzJZepfgOpg mucked
Seat 3: jeKWRUkMaVn8rEUjnJKqpg folded before Flop (didn't bet)
Seat 4: Czut6V7acIqUJrrobjKAZg folded before Flop (didn't bet)
Seat 5: 18G4P1XstjNvItdGUITxgw folded before Flop (didn't bet)
Seat 6: tYsOBqdU1+x+yFI7zHO7hQ (button) folded before Flop (didn't bet)
Seat 7: s7Q6uNouhe7aE8JdFb9E+A (small blind) folded before Flop
Seat 8: ghNKXUBl/H+t83JF079ZBA (big blind) showed [Ah Ks] and won ($4.85) with a pair of Aces
Seat 9: TeWJxSETzbXGiYKx0y+dtg folded before Flop (didn't bet)




PokerStars Game #59939410722:  Hold'em No Limit ($0.10/$0.25) - 2009/07/01 0:39:10 ET
Table 'R5qKG21jwFDYRcOht9qwqQ' 9-max Seat #1 is the button
Seat 1: OgISYvc5hA85YuDnsXCH+Q ($15.75 in chips) 
Seat 2: N6foVRyErHqcNmshkqextQ ($15.50 in chips) 
Seat 3: M2QO2DxB5Wawg2h8HSpnYA ($10 in chips) 
Seat 4: z5GxcHlYz/GSz6W2uFiTtg ($25.40 in chips) 
Seat 5: 8B/dhbQjIWe6ASCdgzktNQ ($25 in chips) 
Seat 6: sUVgUtgbfVx6JpvApozwhQ ($11.10 in chips) 
Seat 7: HYQiVfBGJsg4smSubKCBmA ($28.50 in chips) 
Seat 8: tYsOBqdU1+x+yFI7zHO7hQ ($25 in chips) 
Seat 9: MG90wfSJZnOejs/KD3vlQQ ($26 in chips) 
N6foVRyErHqcNmshkqextQ: posts small blind $0.10
M2QO2DxB5Wawg2h8HSpnYA: posts big blind $0.25
*** HOLE CARDS ***
z5GxcHlYz/GSz6W2uFiTtg: calls $0.25
8B/dhbQjIWe6ASCdgzktNQ: folds 
sUVgUtgbfVx6JpvApozwhQ: folds 
HYQiVfBGJsg4smSubKCBmA: folds 
tYsOBqdU1+x+yFI7zHO7hQ: folds 
MG90wfSJZnOejs/KD3vlQQ: folds 
OgISYvc5hA85YuDnsXCH+Q: calls $0.25
N6foVRyErHqcNmshkqextQ: folds 
M2QO2DxB5Wawg2h8HSpnYA: checks 
*** FLOP *** [Ah 3s Ts]
M2QO2DxB5Wawg2h8HSpnYA: checks 
z5GxcHlYz/GSz6W2uFiTtg: bets $0.50
OgISYvc5hA85YuDnsXCH+Q: folds 
M2QO2DxB5Wawg2h8HSpnYA: folds 
Uncalled bet ($0.50) returned to z5GxcHlYz/GSz6W2uFiTtg
z5GxcHlYz/GSz6W2uFiTtg collected $0.85 from pot
*** SUMMARY ***
Total pot $0.85 | Rake $0 
Board [Ah 3s Ts]
Seat 1: OgISYvc5hA85YuDnsXCH+Q (button) folded on the Flop
Seat 2: N6foVRyErHqcNmshkqextQ (small blind) folded before Flop
Seat 3: M2QO2DxB5Wawg2h8HSpnYA (big blind) folded on the Flop
Seat 4: z5GxcHlYz/GSz6W2uFiTtg collected ($0.85)
Seat 5: 8B/dhbQjIWe6ASCdgzktNQ folded before Flop (didn't bet)
Seat 6: sUVgUtgbfVx6JpvApozwhQ folded before Flop (didn't bet)
Seat 7: HYQiVfBGJsg4smSubKCBmA folded before Flop (didn't bet)
Seat 8: tYsOBqdU1+x+yFI7zHO7hQ folded before Flop (didn't bet)
Seat 9: MG90wfSJZnOejs/KD3vlQQ folded before Flop (didn't bet)




PokerStars Game #59939411060:  Hold'em No Limit ($0.10/$0.25) - 2009/07/01 0:39:10 ET
Table 'oG007Tb0LYbfANo6QWd16wWEMI3Mtn7dGARDbgNrKibgx Seat #6 is the button
Seat 1: GEZ4LFjiwTFoPklBgpSnlw ($18.55 in chips) 
Seat 2: zDrucyjVn5aeekNEc3cJrA ($23 in chips) 
Seat 3: 56S3mA6Zs3pGR+0p0vUCtg ($24.65 in chips) 
Seat 4: oKO7b50N6TzXbPBr/mcrUA ($21.60 in chips) 
Seat 5: MIVCHqCqqlke0Lb0z7glcw ($24.65 in chips) 
Seat 6: lxVahNAs/pc3YeLt9PSgbg ($19 in chips) 
Seat 7: sUVgUtgbfVx6JpvApozwhQ ($5 in chips) 
Seat 8: 0b9BiwFeJrba87+xtIuQxg ($8.30 in chips) 
Seat 9: 86vbuhJsyH+nbEg5qpDLyQ ($24.65 in chips) 
sUVgUtgbfVx6JpvApozwhQ: posts small blind $0.10
0b9BiwFeJrba87+xtIuQxg: posts big blind $0.25
*** HOLE CARDS ***
86vbuhJsyH+nbEg5qpDLyQ: calls $0.25
GEZ4LFjiwTFoPklBgpSnlw: folds 
zDrucyjVn5aeekNEc3cJrA: folds 
56S3mA6Zs3pGR+0p0vUCtg: folds 
oKO7b50N6TzXbPBr/mcrUA: folds 
MIVCHqCqqlke0Lb0z7glcw: folds 
lxVahNAs/pc3YeLt9PSgbg: calls $0.25
sUVgUtgbfVx6JpvApozwhQ: folds 
0b9BiwFeJrba87+xtIuQxg: checks 
*** FLOP *** [Td Js 6h]
0b9BiwFeJrba87+xtIuQxg: checks 
86vbuhJsyH+nbEg5qpDLyQ: bets $0.50
lxVahNAs/pc3YeLt9PSgbg: folds 
0b9BiwFeJrba87+xtIuQxg: calls $0.50
*** TURN *** [Td Js 6h] [6d]
0b9BiwFeJrba87+xtIuQxg: checks 
86vbuhJsyH+nbEg5qpDLyQ: bets $1.25
0b9BiwFeJrba87+xtIuQxg: folds 
Uncalled bet ($1.25) returned to 86vbuhJsyH+nbEg5qpDLyQ
86vbuhJsyH+nbEg5qpDLyQ collected $1.80 from pot
86vbuhJsyH+nbEg5qpDLyQ: doesn't show hand 
*** SUMMARY ***
Total pot $1.85 | Rake $0.05 
Board [Td Js 6h 6d]
Seat 1: GEZ4LFjiwTFoPklBgpSnlw folded before Flop (didn't bet)
Seat 2: zDrucyjVn5aeekNEc3cJrA folded before Flop (didn't bet)
Seat 3: 56S3mA6Zs3pGR+0p0vUCtg folded before Flop (didn't bet)
Seat 4: oKO7b50N6TzXbPBr/mcrUA folded before Flop (didn't bet)
Seat 5: MIVCHqCqqlke0Lb0z7glcw folded before Flop (didn't bet)
Seat 6: lxVahNAs/pc3YeLt9PSgbg (button) folded on the Flop
Seat 7: sUVgUtgbfVx6JpvApozwhQ (small blind) folded before Flop
Seat 8: 0b9BiwFeJrba87+xtIuQxg (big blind) folded on the Turn
Seat 9: 86vbuhJsyH+nbEg5qpDLyQ collected ($1.80)




PokerStars Game #59939410730:  Hold'em No Limit ($0.10/$0.25) - 2009/07/01 0:39:10 ET
Table 'Do4nrTNDYpK3sQjwFxX+Og' 6-max Seat #2 is the button
Seat 1: 7JrQNOR9wRBxq9ijFhWieg ($25.70 in chips) 
Seat 2: tzMoGl9F0PUr5NibYueeSw ($44.90 in chips) 
Seat 3: TSmua8tGK3sTbwi0ynrW9Q ($31.90 in chips) 
Seat 4: df7bIV965hvGEDiUAs5cfQ ($17.50 in chips) 
Seat 5: Ew/TYPQIsbQ2X8nm5iAJBg ($29.75 in chips) 
Seat 6: eHsmIvAb2JREg4O6hNPnXg ($24.45 in chips) 
TSmua8tGK3sTbwi0ynrW9Q: posts small blind $0.10
df7bIV965hvGEDiUAs5cfQ: posts big blind $0.25
*** HOLE CARDS ***
Ew/TYPQIsbQ2X8nm5iAJBg: folds 
eHsmIvAb2JREg4O6hNPnXg: folds 
7JrQNOR9wRBxq9ijFhWieg: folds 
tzMoGl9F0PUr5NibYueeSw: raises $0.50 to $0.75
TSmua8tGK3sTbwi0ynrW9Q: folds 
df7bIV965hvGEDiUAs5cfQ: calls $0.50
*** FLOP *** [Qh 4h 9h]
df7bIV965hvGEDiUAs5cfQ: checks 
tzMoGl9F0PUr5NibYueeSw: checks 
*** TURN *** [Qh 4h 9h] [Jh]
df7bIV965hvGEDiUAs5cfQ: checks 
tzMoGl9F0PUr5NibYueeSw: checks 
*** RIVER *** [Qh 4h 9h Jh] [Ah]
df7bIV965hvGEDiUAs5cfQ: checks 
tzMoGl9F0PUr5NibYueeSw: checks 
*** SHOW DOWN ***
df7bIV965hvGEDiUAs5cfQ: shows [Qc 5h] (a flush, Ace high)
tzMoGl9F0PUr5NibYueeSw: shows [Kd Ad] (a flush, Ace high - lower cards)
df7bIV965hvGEDiUAs5cfQ collected $1.55 from pot
*** SUMMARY ***
Total pot $1.60 | Rake $0.05 
Board [Qh 4h 9h Jh Ah]
Seat 1: 7JrQNOR9wRBxq9ijFhWieg folded before Flop (didn't bet)
Seat 2: tzMoGl9F0PUr5NibYueeSw (button) showed [Kd Ad] and lost with a flush, Ace high
Seat 3: TSmua8tGK3sTbwi0ynrW9Q (small blind) folded before Flop
Seat 4: df7bIV965hvGEDiUAs5cfQ (big blind) showed [Qc 5h] and won ($1.55) with a flush, Ace high
Seat 5: Ew/TYPQIsbQ2X8nm5iAJBg folded before Flop (didn't bet)
Seat 6: eHsmIvAb2JREg4O6hNPnXg folded before Flop (didn't bet)




PokerStars Game #59939410786:  Hold'em No Limit ($0.10/$0.25) - 2009/07/01 0:39:10 ET
Table '29D3eoQzK5kOAT0OIDS2uQ' 6-max Seat #5 is the button
Seat 1: kG34n23qFQA3nzdOJTQ1dA ($51.65 in chips) 
Seat 2: tbhYGxTClzdFLMcTtjvJhg ($44.20 in chips) 
Seat 3: z3tQwy28dp5FykDJC/wzQw ($19.35 in chips) 
Seat 4: yzFNNFIfC89bBPwpFPx2ow ($27.10 in chips) 
Seat 5: Q3EMN7b0ie81AFWkDrhCjw ($33.70 in chips) 
Seat 6: bWbV4MVB/vVpiES1Ut4hew ($44.20 in chips) 
bWbV4MVB/vVpiES1Ut4hew: posts small blind $0.10
kG34n23qFQA3nzdOJTQ1dA: posts big blind $0.25
*** HOLE CARDS ***
tbhYGxTClzdFLMcTtjvJhg: folds 
z3tQwy28dp5FykDJC/wzQw: folds 
yzFNNFIfC89bBPwpFPx2ow: folds 
Q3EMN7b0ie81AFWkDrhCjw: calls $0.25
bWbV4MVB/vVpiES1Ut4hew: folds 
kG34n23qFQA3nzdOJTQ1dA: checks 
*** FLOP *** [8c 6s 7h]
kG34n23qFQA3nzdOJTQ1dA: checks 
Q3EMN7b0ie81AFWkDrhCjw: bets $0.50
kG34n23qFQA3nzdOJTQ1dA: folds 
Uncalled bet ($0.50) returned to Q3EMN7b0ie81AFWkDrhCjw
Q3EMN7b0ie81AFWkDrhCjw collected $0.60 from pot
*** SUMMARY ***
Total pot $0.60 | Rake $0 
Board [8c 6s 7h]
Seat 1: kG34n23qFQA3nzdOJTQ1dA (big blind) folded on the Flop
Seat 2: tbhYGxTClzdFLMcTtjvJhg folded before Flop (didn't bet)
Seat 3: z3tQwy28dp5FykDJC/wzQw folded before Flop (didn't bet)
Seat 4: yzFNNFIfC89bBPwpFPx2ow folded before Flop (didn't bet)
Seat 5: Q3EMN7b0ie81AFWkDrhCjw (button) collected ($0.60)
Seat 6: bWbV4MVB/vVpiES1Ut4hew (small blind) folded before Flop




PokerStars Game #59939410812:  Hold'em No Limit ($0.10/$0.25) - 2009/07/01 0:39:10 ET
Table 'rjcb+nlE+0GuJ6lBhuCkkA' 6-max Seat #3 is the button
Seat 1: 9jSiy0meE9XJKkdIZwyTEQ ($26.05 in chips) 
Seat 2: d9ecz4Yhx6qRKe5k+fUWdw ($19.70 in chips) 
Seat 3: 8ClCHtFXGNplITm+63KB+Q ($24.65 in chips) 
Seat 4: NzIFHwilc5zU7QhjDTgTZA ($13.80 in chips) 
Seat 5: GC/9yVD59DUCX7hUI7gcLw ($43.25 in chips) 
Seat 6: 0DvgWV5o6c/jYqQCjm4Haw ($26.70 in chips) 
NzIFHwilc5zU7QhjDTgTZA: posts small blind $0.10
GC/9yVD59DUCX7hUI7gcLw: posts big blind $0.25
*** HOLE CARDS ***
0DvgWV5o6c/jYqQCjm4Haw: raises $0.50 to $0.75
9jSiy0meE9XJKkdIZwyTEQ: folds 
d9ecz4Yhx6qRKe5k+fUWdw: calls $0.75
8ClCHtFXGNplITm+63KB+Q: calls $0.75
NzIFHwilc5zU7QhjDTgTZA: calls $0.65
GC/9yVD59DUCX7hUI7gcLw: folds 
*** FLOP *** [9s 5c 5d]
NzIFHwilc5zU7QhjDTgTZA: checks 
0DvgWV5o6c/jYqQCjm4Haw: bets $2.30
d9ecz4Yhx6qRKe5k+fUWdw: folds 
8ClCHtFXGNplITm+63KB+Q: raises $3.20 to $5.50
NzIFHwilc5zU7QhjDTgTZA: folds 
0DvgWV5o6c/jYqQCjm4Haw: calls $3.20
*** TURN *** [9s 5c 5d] [Ah]
0DvgWV5o6c/jYqQCjm4Haw: checks 
8ClCHtFXGNplITm+63KB+Q: checks 
*** RIVER *** [9s 5c 5d Ah] [2s]
0DvgWV5o6c/jYqQCjm4Haw: bets $10.15
8ClCHtFXGNplITm+63KB+Q: folds 
Uncalled bet ($10.15) returned to 0DvgWV5o6c/jYqQCjm4Haw
0DvgWV5o6c/jYqQCjm4Haw collected $13.55 from pot
0DvgWV5o6c/jYqQCjm4Haw: doesn't show hand 
*** SUMMARY ***
Total pot $14.25 | Rake $0.70 
Board [9s 5c 5d Ah 2s]
Seat 1: 9jSiy0meE9XJKkdIZwyTEQ folded before Flop (didn't bet)
Seat 2: d9ecz4Yhx6qRKe5k+fUWdw folded on the Flop
Seat 3: 8ClCHtFXGNplITm+63KB+Q (button) folded on the River
Seat 4: NzIFHwilc5zU7QhjDTgTZA (small blind) folded on the Flop
Seat 5: GC/9yVD59DUCX7hUI7gcLw (big blind) folded before Flop
Seat 6: 0DvgWV5o6c/jYqQCjm4Haw collected ($13.55)




PokerStars Game #59939410738:  Hold'em No Limit ($0.10/$0.25) - 2009/07/01 0:39:10 ET
Table 'Qr+t8WGovMECkBv+cV1lrg' 6-max Seat #4 is the button
Seat 1: wFKQltIqUcrrkvre6g+fyw ($34.25 in chips) 
Seat 2: i48129QFpEQQ+UN4aNtmww ($5.30 in chips) 
Seat 3: bjJnMpKgoF+vgHW2f1NCsg ($17.55 in chips) 
Seat 4: 3rlIjSrvbZoI2IILbnetnA ($25.40 in chips) 
Seat 5: iwlxXocltgSdaBmusNXanQ ($14.75 in chips) 
Seat 6: j5NZbEJHsERuXjPHWqc1Nw ($21 in chips) 
iwlxXocltgSdaBmusNXanQ: posts small blind $0.10
j5NZbEJHsERuXjPHWqc1Nw: posts big blind $0.25
*** HOLE CARDS ***
wFKQltIqUcrrkvre6g+fyw: folds 
i48129QFpEQQ+UN4aNtmww: folds 
bjJnMpKgoF+vgHW2f1NCsg: calls $0.25
3rlIjSrvbZoI2IILbnetnA: folds 
iwlxXocltgSdaBmusNXanQ: calls $0.15
j5NZbEJHsERuXjPHWqc1Nw: raises $0.50 to $0.75
bjJnMpKgoF+vgHW2f1NCsg: calls $0.50
iwlxXocltgSdaBmusNXanQ: folds 
*** FLOP *** [9d Kd 9h]
j5NZbEJHsERuXjPHWqc1Nw: checks 
bjJnMpKgoF+vgHW2f1NCsg: bets $1.25
j5NZbEJHsERuXjPHWqc1Nw: folds 
Uncalled bet ($1.25) returned to bjJnMpKgoF+vgHW2f1NCsg
bjJnMpKgoF+vgHW2f1NCsg collected $1.70 from pot
*** SUMMARY ***
Total pot $1.75 | Rake $0.05 
Board [9d Kd 9h]
Seat 1: wFKQltIqUcrrkvre6g+fyw folded before Flop (didn't bet)
Seat 2: i48129QFpEQQ+UN4aNtmww folded before Flop (didn't bet)
Seat 3: bjJnMpKgoF+vgHW2f1NCsg collected ($1.70)
Seat 4: 3rlIjSrvbZoI2IILbnetnA (button) folded before Flop (didn't bet)
Seat 5: iwlxXocltgSdaBmusNXanQ (small blind) folded before Flop
Seat 6: j5NZbEJHsERuXjPHWqc1Nw (big blind) folded on the Flop




PokerStars Game #59939411606:  Hold'em No Limit ($0.10/$0.25) - 2009/07/01 0:39:11 ET
Table 'NtCSSONEf1zaJo3042tQug' 6-max Seat #4 is the button
Seat 1: pdS3fOhVgLVaTP0O0GlIvw ($8.30 in chips) 
Seat 2: nbv8IVGAEHbfjk01ulU6ow ($19.20 in chips) 
Seat 3: d0J1xuhsynEY81YHwAvJ5g ($25 in chips) 
Seat 4: dOX4wnYV2sEqvDbF+8KSCw ($25.15 in chips) 
Seat 5: l/t3k8+r77gRew8U2BJs4Q ($3.50 in chips) 
Seat 6: LxehwDpTQ19ph4Qmc78+Pw ($25 in chips) 
l/t3k8+r77gRew8U2BJs4Q: posts small blind $0.10
LxehwDpTQ19ph4Qmc78+Pw: posts big blind $0.25
*** HOLE CARDS ***
pdS3fOhVgLVaTP0O0GlIvw: raises $0.25 to $0.50
nbv8IVGAEHbfjk01ulU6ow: folds 
d0J1xuhsynEY81YHwAvJ5g: folds 
dOX4wnYV2sEqvDbF+8KSCw: folds 
l/t3k8+r77gRew8U2BJs4Q: folds 
LxehwDpTQ19ph4Qmc78+Pw: calls $0.25
*** FLOP *** [9s Qh Jd]
LxehwDpTQ19ph4Qmc78+Pw: bets $1
pdS3fOhVgLVaTP0O0GlIvw: raises $2 to $3
LxehwDpTQ19ph4Qmc78+Pw: calls $2
*** TURN *** [9s Qh Jd] [6c]
LxehwDpTQ19ph4Qmc78+Pw: checks 
pdS3fOhVgLVaTP0O0GlIvw: bets $4.80 and is all-in
LxehwDpTQ19ph4Qmc78+Pw: folds 
Uncalled bet ($4.80) returned to pdS3fOhVgLVaTP0O0GlIvw
pdS3fOhVgLVaTP0O0GlIvw collected $6.75 from pot
*** SUMMARY ***
Total pot $7.10 | Rake $0.35 
Board [9s Qh Jd 6c]
Seat 1: pdS3fOhVgLVaTP0O0GlIvw collected ($6.75)
Seat 2: nbv8IVGAEHbfjk01ulU6ow folded before Flop (didn't bet)
Seat 3: d0J1xuhsynEY81YHwAvJ5g folded before Flop (didn't bet)
Seat 4: dOX4wnYV2sEqvDbF+8KSCw (button) folded before Flop (didn't bet)
Seat 5: l/t3k8+r77gRew8U2BJs4Q (small blind) folded before Flop
Seat 6: LxehwDpTQ19ph4Qmc78+Pw (big blind) folded on the Turn




PokerStars Game #59939411324:  Hold'em No Limit ($0.10/$0.25) - 2009/07/01 0:39:11 ET
Table 'eOXPe2c6mG7DOFKvMsZZfA' 6-max Seat #6 is the button
Seat 1: ShXPHWfjhfmAwLgDdm6bRQ ($7.75 in chips) 
Seat 2: ELW+DKizJhLK7k40PMkD2Q ($33.10 in chips) 
Seat 3: kReyZ6g6Fu3tQ0nyjDf9kA ($14.55 in chips) 
Seat 4: zHHLkD2sRljslKKeQv/ZQw ($43.40 in chips) 
Seat 5: NhUN/JpAprdJeamFBgJH1w ($25 in chips) 
Seat 6: wKFJ513ucluNNiMlkXcDOQ ($41.55 in chips) 
ShXPHWfjhfmAwLgDdm6bRQ: posts small blind $0.10
ELW+DKizJhLK7k40PMkD2Q: posts big blind $0.25
*** HOLE CARDS ***
kReyZ6g6Fu3tQ0nyjDf9kA: raises $0.50 to $0.75
zHHLkD2sRljslKKeQv/ZQw: calls $0.75
NhUN/JpAprdJeamFBgJH1w: folds 
wKFJ513ucluNNiMlkXcDOQ: calls $0.75
ShXPHWfjhfmAwLgDdm6bRQ: folds 
ELW+DKizJhLK7k40PMkD2Q: folds 
*** FLOP *** [8c 7d 8s]
kReyZ6g6Fu3tQ0nyjDf9kA: checks 
zHHLkD2sRljslKKeQv/ZQw: checks 
wKFJ513ucluNNiMlkXcDOQ: checks 
*** TURN *** [8c 7d 8s] [4s]
kReyZ6g6Fu3tQ0nyjDf9kA: checks 
zHHLkD2sRljslKKeQv/ZQw: checks 
wKFJ513ucluNNiMlkXcDOQ: checks 
*** RIVER *** [8c 7d 8s 4s] [2h]
kReyZ6g6Fu3tQ0nyjDf9kA: checks 
zHHLkD2sRljslKKeQv/ZQw: checks 
wKFJ513ucluNNiMlkXcDOQ: checks 
*** SHOW DOWN ***
kReyZ6g6Fu3tQ0nyjDf9kA: shows [Tc Ac] (a pair of Eights)
zHHLkD2sRljslKKeQv/ZQw: mucks hand 
wKFJ513ucluNNiMlkXcDOQ: mucks hand 
kReyZ6g6Fu3tQ0nyjDf9kA collected $2.50 from pot
*** SUMMARY ***
Total pot $2.60 | Rake $0.10 
Board [8c 7d 8s 4s 2h]
Seat 1: ShXPHWfjhfmAwLgDdm6bRQ (small blind) folded before Flop
Seat 2: ELW+DKizJhLK7k40PMkD2Q (big blind) folded before Flop
Seat 3: kReyZ6g6Fu3tQ0nyjDf9kA showed [Tc Ac] and won ($2.50) with a pair of Eights
Seat 4: zHHLkD2sRljslKKeQv/ZQw mucked
Seat 5: NhUN/JpAprdJeamFBgJH1w folded before Flop (didn't bet)
Seat 6: wKFJ513ucluNNiMlkXcDOQ (button) mucked




PokerStars Game #59939411368:  Hold'em No Limit ($0.10/$0.25) - 2009/07/01 0:39:11 ET
Table 'rhQuIjJo0UQ7RRUlF9umHg' 6-max Seat #4 is the button
Seat 1: 5O3Hj9Qg0SqOyKEXoLpjPg ($58.60 in chips) 
Seat 2: Ew/TYPQIsbQ2X8nm5iAJBg ($25 in chips) 
Seat 3: nLE5Yo60EmSlJPyg0GgxXg ($17 in chips) 
Seat 4: buyjetgNT1McXtdaP4zynA ($23.40 in chips) 
Seat 5: 7qRk4YH4/k/08LgJSv7rBQ ($24.75 in chips) 
Seat 6: r284m4NA4rtNktI86R8/Yw ($11.30 in chips) 
7qRk4YH4/k/08LgJSv7rBQ: posts small blind $0.10
r284m4NA4rtNktI86R8/Yw: posts big blind $0.25
*** HOLE CARDS ***
5O3Hj9Qg0SqOyKEXoLpjPg: raises $0.25 to $0.50
Ew/TYPQIsbQ2X8nm5iAJBg: raises $0.25 to $0.75
nLE5Yo60EmSlJPyg0GgxXg said, "wow I had that one"
nLE5Yo60EmSlJPyg0GgxXg: folds 
buyjetgNT1McXtdaP4zynA: calls $0.75
7qRk4YH4/k/08LgJSv7rBQ: folds 
nLE5Yo60EmSlJPyg0GgxXg said, "nh"
r284m4NA4rtNktI86R8/Yw: folds 
5O3Hj9Qg0SqOyKEXoLpjPg said, "ty"
5O3Hj9Qg0SqOyKEXoLpjPg: raises $3.50 to $4.25
Ew/TYPQIsbQ2X8nm5iAJBg: calls $3.50
buyjetgNT1McXtdaP4zynA: folds 
*** FLOP *** [3c 3d 8h]
5O3Hj9Qg0SqOyKEXoLpjPg: bets $2
Ew/TYPQIsbQ2X8nm5iAJBg: calls $2
*** TURN *** [3c 3d 8h] [7h]
5O3Hj9Qg0SqOyKEXoLpjPg: bets $3
Ew/TYPQIsbQ2X8nm5iAJBg: calls $3
*** RIVER *** [3c 3d 8h 7h] [Th]
nLE5Yo60EmSlJPyg0GgxXg said, "I would have made the draw at the end J high"
5O3Hj9Qg0SqOyKEXoLpjPg: checks 
Ew/TYPQIsbQ2X8nm5iAJBg: bets $15.75 and is all-in
5O3Hj9Qg0SqOyKEXoLpjPg: calls $15.75
*** SHOW DOWN ***
Ew/TYPQIsbQ2X8nm5iAJBg: shows [9d Ad] (a pair of Threes)
5O3Hj9Qg0SqOyKEXoLpjPg: shows [Kc Kh] (two pair, Kings and Threes)
5O3Hj9Qg0SqOyKEXoLpjPg collected $48.60 from pot
*** SUMMARY ***
Total pot $51.10 | Rake $2.50 
Board [3c 3d 8h 7h Th]
Seat 1: 5O3Hj9Qg0SqOyKEXoLpjPg showed [Kc Kh] and won ($48.60) with two pair, Kings and Threes
Seat 2: Ew/TYPQIsbQ2X8nm5iAJBg showed [9d Ad] and lost with a pair of Threes
Seat 3: nLE5Yo60EmSlJPyg0GgxXg folded before Flop (didn't bet)
Seat 4: buyjetgNT1McXtdaP4zynA (button) folded before Flop
Seat 5: 7qRk4YH4/k/08LgJSv7rBQ (small blind) folded before Flop
Seat 6: r284m4NA4rtNktI86R8/Yw (big blind) folded before Flop




PokerStars Game #59939411188:  Hold'em No Limit ($0.10/$0.25) - 2009/07/01 0:39:11 ET
Table '8PD/MTROSMd6Y8mZeykbpg' 6-max Seat #2 is the button
Seat 1: 32YL2ZEp8NT4JB2RVM9euQ ($19.40 in chips) 
Seat 2: wAKC8C/zN0c8V5v13dm9mA ($25 in chips) 
Seat 3: EV5E02/xfaoDNHy7UQ195Q ($20.25 in chips) 
Seat 4: tTBLQIRkkVpjhASe6+jvXQ ($9.95 in chips) 
Seat 5: z3tQwy28dp5FykDJC/wzQw ($12.20 in chips) 
Seat 6: 096oPBXuIkGUyml0gVo5TA ($18.10 in chips) 
EV5E02/xfaoDNHy7UQ195Q: posts small blind $0.10
tTBLQIRkkVpjhASe6+jvXQ: posts big blind $0.25
*** HOLE CARDS ***
z3tQwy28dp5FykDJC/wzQw: folds 
096oPBXuIkGUyml0gVo5TA: raises $0.25 to $0.50
32YL2ZEp8NT4JB2RVM9euQ: folds 
wAKC8C/zN0c8V5v13dm9mA: folds 
EV5E02/xfaoDNHy7UQ195Q: calls $0.40
tTBLQIRkkVpjhASe6+jvXQ: calls $0.25
*** FLOP *** [7s 4s Jh]
EV5E02/xfaoDNHy7UQ195Q: bets $0.25
tTBLQIRkkVpjhASe6+jvXQ: folds 
096oPBXuIkGUyml0gVo5TA: raises $0.25 to $0.50
EV5E02/xfaoDNHy7UQ195Q: calls $0.25
*** TURN *** [7s 4s Jh] [3c]
EV5E02/xfaoDNHy7UQ195Q: checks 
096oPBXuIkGUyml0gVo5TA: bets $1
EV5E02/xfaoDNHy7UQ195Q: calls $1
*** RIVER *** [7s 4s Jh 3c] [Qh]
EV5E02/xfaoDNHy7UQ195Q: checks 
096oPBXuIkGUyml0gVo5TA: bets $1
EV5E02/xfaoDNHy7UQ195Q: raises $3 to $4
096oPBXuIkGUyml0gVo5TA: calls $3
*** SHOW DOWN ***
EV5E02/xfaoDNHy7UQ195Q: shows [Js Jc] (three of a kind, Jacks)
096oPBXuIkGUyml0gVo5TA: mucks hand 
EV5E02/xfaoDNHy7UQ195Q collected $11.90 from pot
*** SUMMARY ***
Total pot $12.50 | Rake $0.60 
Board [7s 4s Jh 3c Qh]
Seat 1: 32YL2ZEp8NT4JB2RVM9euQ folded before Flop (didn't bet)
Seat 2: wAKC8C/zN0c8V5v13dm9mA (button) folded before Flop (didn't bet)
Seat 3: EV5E02/xfaoDNHy7UQ195Q (small blind) showed [Js Jc] and won ($11.90) with three of a kind, Jacks
Seat 4: tTBLQIRkkVpjhASe6+jvXQ (big blind) folded on the Flop
Seat 5: z3tQwy28dp5FykDJC/wzQw folded before Flop (didn't bet)
Seat 6: 096oPBXuIkGUyml0gVo5TA mucked




PokerStars Game #59939411370:  Hold'em No Limit ($0.10/$0.25) - 2009/07/01 0:39:11 ET
Table '2VkNDXXsBj4bSZw/uK5atw' 6-max Seat #6 is the button
Seat 1: 7FmwVDcdEtxDpHmP4hOXsQ ($26.50 in chips) 
Seat 3: xBOVv8xEXtymVpAA5ZajSw ($38.15 in chips) 
Seat 4: yb6rnd48JuBccThV68VHAQ ($67.75 in chips) 
Seat 5: kyRaCIljYA6l33lSKQfNsg ($25 in chips) 
Seat 6: qGHGf/553gQnDoklMRe3tg ($25.65 in chips) 
7FmwVDcdEtxDpHmP4hOXsQ: posts small blind $0.10
xBOVv8xEXtymVpAA5ZajSw: posts big blind $0.25
*** HOLE CARDS ***
yb6rnd48JuBccThV68VHAQ: calls $0.25
kyRaCIljYA6l33lSKQfNsg: folds 
qGHGf/553gQnDoklMRe3tg: raises $1 to $1.25
7FmwVDcdEtxDpHmP4hOXsQ: folds 
xBOVv8xEXtymVpAA5ZajSw: folds 
yb6rnd48JuBccThV68VHAQ: calls $1
*** FLOP *** [5h 6d Ad]
yb6rnd48JuBccThV68VHAQ: bets $1
qGHGf/553gQnDoklMRe3tg: calls $1
*** TURN *** [5h 6d Ad] [2h]
yb6rnd48JuBccThV68VHAQ: bets $1.25
qGHGf/553gQnDoklMRe3tg: calls $1.25
*** RIVER *** [5h 6d Ad 2h] [2d]
yb6rnd48JuBccThV68VHAQ: bets $1.25
qGHGf/553gQnDoklMRe3tg: raises $1.25 to $2.50
cardume joins the table at seat #2 
xBOVv8xEXtymVpAA5ZajSw leaves the table
yb6rnd48JuBccThV68VHAQ: raises $1.25 to $3.75
qGHGf/553gQnDoklMRe3tg: calls $1.25
*** SHOW DOWN ***
yb6rnd48JuBccThV68VHAQ: shows [2c Ac] (a full house, Deuces full of Aces)
qGHGf/553gQnDoklMRe3tg: mucks hand 
yb6rnd48JuBccThV68VHAQ collected $14.15 from pot
*** SUMMARY ***
Total pot $14.85 | Rake $0.70 
Board [5h 6d Ad 2h 2d]
Seat 1: 7FmwVDcdEtxDpHmP4hOXsQ (small blind) folded before Flop
Seat 3: xBOVv8xEXtymVpAA5ZajSw (big blind) folded before Flop
Seat 4: yb6rnd48JuBccThV68VHAQ showed [2c Ac] and won ($14.15) with a full house, Deuces full of Aces
Seat 5: kyRaCIljYA6l33lSKQfNsg folded before Flop (didn't bet)
Seat 6: qGHGf/553gQnDoklMRe3tg (button) mucked




PokerStars Game #59939411132:  Hold'em No Limit ($0.10/$0.25) - 2009/07/01 0:39:11 ET
Table 'MRfAiS/4JSfnUDlCcZo0wAhfHe8uKeSJMyWAjSdM7ROQx Seat #2 is the button
Seat 2: /gJNBeCkWL4o85/jvlZ4BA ($37.60 in chips) 
Seat 3: FYepjhAvF8ZdVCmqHIy+eQ ($48.75 in chips) 
Seat 4: Go8clNIDGP3feVvzBDG4pg ($19.75 in chips) 
Seat 5: qccGLncfUaN00Few5HsgYg ($28.60 in chips) 
Seat 6: VaDPspfGS2lnEkaGNrNqfg ($10 in chips) 
FYepjhAvF8ZdVCmqHIy+eQ: posts small blind $0.10
Go8clNIDGP3feVvzBDG4pg: posts big blind $0.25
32YL2ZEp8NT4JB2RVM9euQ: sits out 
*** HOLE CARDS ***
qccGLncfUaN00Few5HsgYg: folds 
VaDPspfGS2lnEkaGNrNqfg: folds 
/gJNBeCkWL4o85/jvlZ4BA: folds 
FYepjhAvF8ZdVCmqHIy+eQ: raises $0.75 to $1
Go8clNIDGP3feVvzBDG4pg: folds 
Uncalled bet ($0.75) returned to FYepjhAvF8ZdVCmqHIy+eQ
FYepjhAvF8ZdVCmqHIy+eQ collected $0.50 from pot
FYepjhAvF8ZdVCmqHIy+eQ: doesn't show hand 
*** SUMMARY ***
Total pot $0.50 | Rake $0 
Seat 2: /gJNBeCkWL4o85/jvlZ4BA (button) folded before Flop (didn't bet)
Seat 3: FYepjhAvF8ZdVCmqHIy+eQ (small blind) collected ($0.50)
Seat 4: Go8clNIDGP3feVvzBDG4pg (big blind) folded before Flop
Seat 5: qccGLncfUaN00Few5HsgYg folded before Flop (didn't bet)
Seat 6: VaDPspfGS2lnEkaGNrNqfg folded before Flop (didn't bet)




PokerStars Game #59939412214:  Hold'em No Limit ($0.10/$0.25) - 2009/07/01 0:39:12 ET
Table 'GxdLtCpYxqT4aAbYqkEEpw' 6-max Seat #4 is the button
Seat 1: heEf/FkFGS9M1NmwH97YIA ($41.95 in chips) 
Seat 2: hADMNbkECXMb2C/C8R2Wlw ($23.15 in chips) 
Seat 3: 9jSiy0meE9XJKkdIZwyTEQ ($33.55 in chips) 
Seat 4: ErIN0JRL5srYjT6en1f8YQ ($24.20 in chips) 
Seat 5: q6WfTUAD9mowIP63ASq2Dg ($40.85 in chips) 
Seat 6: aogAb4Eienxztk8p2v9VVw ($26.75 in chips) 
q6WfTUAD9mowIP63ASq2Dg: posts small blind $0.10
aogAb4Eienxztk8p2v9VVw: posts big blind $0.25
*** HOLE CARDS ***
heEf/FkFGS9M1NmwH97YIA: raises $0.75 to $1
hADMNbkECXMb2C/C8R2Wlw: folds 
9jSiy0meE9XJKkdIZwyTEQ: folds 
ErIN0JRL5srYjT6en1f8YQ: calls $1
q6WfTUAD9mowIP63ASq2Dg: folds 
aogAb4Eienxztk8p2v9VVw: folds 
*** FLOP *** [As 9d Qc]
heEf/FkFGS9M1NmwH97YIA: bets $1.25
ErIN0JRL5srYjT6en1f8YQ: raises $2.50 to $3.75
heEf/FkFGS9M1NmwH97YIA: calls $2.50
*** TURN *** [As 9d Qc] [6h]
heEf/FkFGS9M1NmwH97YIA: checks 
ErIN0JRL5srYjT6en1f8YQ: bets $5.25
heEf/FkFGS9M1NmwH97YIA: folds 
Uncalled bet ($5.25) returned to ErIN0JRL5srYjT6en1f8YQ
ErIN0JRL5srYjT6en1f8YQ collected $9.40 from pot
ErIN0JRL5srYjT6en1f8YQ: doesn't show hand 
*** SUMMARY ***
Total pot $9.85 | Rake $0.45 
Board [As 9d Qc 6h]
Seat 1: heEf/FkFGS9M1NmwH97YIA folded on the Turn
Seat 2: hADMNbkECXMb2C/C8R2Wlw folded before Flop (didn't bet)
Seat 3: 9jSiy0meE9XJKkdIZwyTEQ folded before Flop (didn't bet)
Seat 4: ErIN0JRL5srYjT6en1f8YQ (button) collected ($9.40)
Seat 5: q6WfTUAD9mowIP63ASq2Dg (small blind) folded before Flop
Seat 6: aogAb4Eienxztk8p2v9VVw (big blind) folded before Flop




PokerStars Game #59939411930:  Hold'em No Limit ($0.10/$0.25) - 2009/07/01 0:39:12 ET
Table '1LkLBsok91+aSWIELy/cyw' 6-max Seat #5 is the button
Seat 1: /gJNBeCkWL4o85/jvlZ4BA ($26 in chips) 
Seat 2: oseFhpinoe+Zg4j5xyBjyQ ($25.95 in chips) 
Seat 3: wUwfsTnmpHcWa17qFlQr1Q ($5.70 in chips) 
Seat 4: vEZ/HxVuyR6kaq0BtZoUgQ ($13.85 in chips) 
Seat 5: trN/oHqTTbPw5MNuKrOpLw ($29.80 in chips) 
Seat 6: MuW7Zf0FjOGlCuY3aIrlsA ($23.35 in chips) 
MuW7Zf0FjOGlCuY3aIrlsA: posts small blind $0.10
/gJNBeCkWL4o85/jvlZ4BA: posts big blind $0.25
*** HOLE CARDS ***
oseFhpinoe+Zg4j5xyBjyQ: folds 
wUwfsTnmpHcWa17qFlQr1Q: folds 
vEZ/HxVuyR6kaq0BtZoUgQ: folds 
trN/oHqTTbPw5MNuKrOpLw: raises $0.50 to $0.75
MuW7Zf0FjOGlCuY3aIrlsA: calls $0.65
/gJNBeCkWL4o85/jvlZ4BA: calls $0.50
*** FLOP *** [Ad Qh Jh]
MuW7Zf0FjOGlCuY3aIrlsA: checks 
/gJNBeCkWL4o85/jvlZ4BA: checks 
trN/oHqTTbPw5MNuKrOpLw: checks 
*** TURN *** [Ad Qh Jh] [4h]
MuW7Zf0FjOGlCuY3aIrlsA: bets $1.50
/gJNBeCkWL4o85/jvlZ4BA: folds 
trN/oHqTTbPw5MNuKrOpLw: folds 
Uncalled bet ($1.50) returned to MuW7Zf0FjOGlCuY3aIrlsA
MuW7Zf0FjOGlCuY3aIrlsA collected $2.15 from pot
MuW7Zf0FjOGlCuY3aIrlsA: doesn't show hand 
*** SUMMARY ***
Total pot $2.25 | Rake $0.10 
Board [Ad Qh Jh 4h]
Seat 1: /gJNBeCkWL4o85/jvlZ4BA (big blind) folded on the Turn
Seat 2: oseFhpinoe+Zg4j5xyBjyQ folded before Flop (didn't bet)
Seat 3: wUwfsTnmpHcWa17qFlQr1Q folded before Flop (didn't bet)
Seat 4: vEZ/HxVuyR6kaq0BtZoUgQ folded before Flop (didn't bet)
Seat 5: trN/oHqTTbPw5MNuKrOpLw (button) folded on the Turn
Seat 6: MuW7Zf0FjOGlCuY3aIrlsA (small blind) collected ($2.15)




PokerStars Game #59939412108:  Hold'em No Limit ($0.10/$0.25) - 2009/07/01 0:39:12 ET
Table 'qryc9C/ELyQ3lubOaELNAQ' 6-max Seat #3 is the button
Seat 1: OZc6kkoTwtITj1ZfreJK1A ($21.25 in chips) 
Seat 2: qvQc9BHp2FhQjrltLiBN+w ($14.65 in chips) 
Seat 3: UXRtG8J9PoBZWTsNtqdoDA ($25.25 in chips) 
Seat 4: v+QfkGiuj9bgtuNoVnDO8w ($29.95 in chips) 
Seat 5: pV5UZbjsgam+HUQEd6G++w ($8.25 in chips) 
Seat 6: t2RfOOoa56xW0ZHJC0+5JQ ($9.05 in chips) 
v+QfkGiuj9bgtuNoVnDO8w: posts small blind $0.10
pV5UZbjsgam+HUQEd6G++w: posts big blind $0.25
*** HOLE CARDS ***
t2RfOOoa56xW0ZHJC0+5JQ: folds 
OZc6kkoTwtITj1ZfreJK1A: raises $0.25 to $0.50
qvQc9BHp2FhQjrltLiBN+w: folds 
UXRtG8J9PoBZWTsNtqdoDA: folds 
v+QfkGiuj9bgtuNoVnDO8w: folds 
pV5UZbjsgam+HUQEd6G++w: folds 
Uncalled bet ($0.25) returned to OZc6kkoTwtITj1ZfreJK1A
OZc6kkoTwtITj1ZfreJK1A collected $0.60 from pot
OZc6kkoTwtITj1ZfreJK1A: doesn't show hand 
*** SUMMARY ***
Total pot $0.60 | Rake $0 
Seat 1: OZc6kkoTwtITj1ZfreJK1A collected ($0.60)
Seat 2: qvQc9BHp2FhQjrltLiBN+w folded before Flop (didn't bet)
Seat 3: UXRtG8J9PoBZWTsNtqdoDA (button) folded before Flop (didn't bet)
Seat 4: v+QfkGiuj9bgtuNoVnDO8w (small blind) folded before Flop
Seat 5: pV5UZbjsgam+HUQEd6G++w (big blind) folded before Flop
Seat 6: t2RfOOoa56xW0ZHJC0+5JQ folded before Flop (didn't bet)




PokerStars Game #59939411902:  Hold'em No Limit ($0.10/$0.25) - 2009/07/01 0:39:12 ET
Table 'OvOqQoL/QnXuXuQjXo2hIQ' 9-max Seat #9 is the button
Seat 3: uJlzv9KL7hgCIqIS2ofoaw ($10.95 in chips) 
Seat 4: e8solDZU6VFefGEm0DJbUg ($11.50 in chips) 
Seat 5: sJNHTWcSlLHRCZ9+YRLLqA ($28.95 in chips) 
Seat 6: MIVCHqCqqlke0Lb0z7glcw ($46.65 in chips) 
Seat 7: aNpwfA31EREwO+ar4XzBCw ($26.80 in chips) 
Seat 9: VWUWpMLMj/Q1jRVpF7Aohw ($14.60 in chips) 
Xbfvrzh7Jjg4vOZkdMSfbA will be allowed to play after the button
uJlzv9KL7hgCIqIS2ofoaw: posts small blind $0.10
e8solDZU6VFefGEm0DJbUg: posts big blind $0.25
*** HOLE CARDS ***
sJNHTWcSlLHRCZ9+YRLLqA: folds 
MIVCHqCqqlke0Lb0z7glcw: calls $0.25
aNpwfA31EREwO+ar4XzBCw: folds 
VWUWpMLMj/Q1jRVpF7Aohw: folds 
uJlzv9KL7hgCIqIS2ofoaw: folds 
e8solDZU6VFefGEm0DJbUg: checks 
*** FLOP *** [Ac 9h Ts]
e8solDZU6VFefGEm0DJbUg: bets $0.25
MIVCHqCqqlke0Lb0z7glcw: folds 
Uncalled bet ($0.25) returned to e8solDZU6VFefGEm0DJbUg
e8solDZU6VFefGEm0DJbUg collected $0.60 from pot
e8solDZU6VFefGEm0DJbUg: doesn't show hand 
*** SUMMARY ***
Total pot $0.60 | Rake $0 
Board [Ac 9h Ts]
Seat 3: uJlzv9KL7hgCIqIS2ofoaw (small blind) folded before Flop
Seat 4: e8solDZU6VFefGEm0DJbUg (big blind) collected ($0.60)
Seat 5: sJNHTWcSlLHRCZ9+YRLLqA folded before Flop (didn't bet)
Seat 6: MIVCHqCqqlke0Lb0z7glcw folded on the Flop
Seat 7: aNpwfA31EREwO+ar4XzBCw folded before Flop (didn't bet)
Seat 9: VWUWpMLMj/Q1jRVpF7Aohw (button) folded before Flop (didn't bet)




PokerStars Game #59939412146:  Hold'em No Limit ($0.10/$0.25) - 2009/07/01 0:39:12 ET
Table '6aL2C8IFwHHr6SG6RgXaow' 9-max Seat #7 is the button
Seat 2: +gMmKt3DaQng9M42CmxIZg ($24.55 in chips) 
Seat 5: wre31HfyzQGpIvID1istxw ($14.35 in chips) 
Seat 6: HxDF4QSxC4z39D7teZpprQ ($33.40 in chips) 
Seat 7: rPToQDbLWB+dKnz7fcQSIg ($10.05 in chips) 
Seat 8: rQhYIYXSyH/IivYM1dlV5A ($14.15 in chips) 
Seat 9: yduPKWPzL8YlT5Zv/Nmrwg ($17.40 in chips) 
rQhYIYXSyH/IivYM1dlV5A: posts small blind $0.10
yduPKWPzL8YlT5Zv/Nmrwg: posts big blind $0.25
*** HOLE CARDS ***
+gMmKt3DaQng9M42CmxIZg: folds 
wre31HfyzQGpIvID1istxw: folds 
HxDF4QSxC4z39D7teZpprQ: calls $0.25
rPToQDbLWB+dKnz7fcQSIg: calls $0.25
rQhYIYXSyH/IivYM1dlV5A: calls $0.15
yduPKWPzL8YlT5Zv/Nmrwg: checks 
*** FLOP *** [4d Jc 4h]
rQhYIYXSyH/IivYM1dlV5A: checks 
yduPKWPzL8YlT5Zv/Nmrwg: checks 
HxDF4QSxC4z39D7teZpprQ: checks 
rPToQDbLWB+dKnz7fcQSIg: bets $0.50
rQhYIYXSyH/IivYM1dlV5A: folds 
yduPKWPzL8YlT5Zv/Nmrwg: folds 
HxDF4QSxC4z39D7teZpprQ: raises $1 to $1.50
rPToQDbLWB+dKnz7fcQSIg: calls $1
*** TURN *** [4d Jc 4h] [5d]
HxDF4QSxC4z39D7teZpprQ: bets $8.30
rPToQDbLWB+dKnz7fcQSIg: folds 
Uncalled bet ($8.30) returned to HxDF4QSxC4z39D7teZpprQ
HxDF4QSxC4z39D7teZpprQ collected $3.85 from pot
*** SUMMARY ***
Total pot $4 | Rake $0.15 
Board [4d Jc 4h 5d]
Seat 2: +gMmKt3DaQng9M42CmxIZg folded before Flop (didn't bet)
Seat 5: wre31HfyzQGpIvID1istxw folded before Flop (didn't bet)
Seat 6: HxDF4QSxC4z39D7teZpprQ collected ($3.85)
Seat 7: rPToQDbLWB+dKnz7fcQSIg (button) folded on the Turn
Seat 8: rQhYIYXSyH/IivYM1dlV5A (small blind) folded on the Flop
Seat 9: yduPKWPzL8YlT5Zv/Nmrwg (big blind) folded on the Flop




PokerStars Game #59939412758:  Hold'em No Limit ($0.10/$0.25) - 2009/07/01 0:39:13 ET
Table 'aaXqTKUnxrX9DYXtxhWXxA' 6-max Seat #3 is the button
Seat 1: njVkfGYrPiXfq4zLcgfVuA ($12.15 in chips) 
Seat 2: 1Zyw8DT57U6TzxWWRixa6Q ($12.80 in chips) 
Seat 3: cPO/1/dTcZpLkQFm3jH3Rg ($25 in chips) 
Seat 4: 4YSTu0Cdzpppe1lUgCZGCQ ($37.80 in chips) 
Seat 5: kyRaCIljYA6l33lSKQfNsg ($25.25 in chips) 
Seat 6: buyjetgNT1McXtdaP4zynA ($23.60 in chips) 
4YSTu0Cdzpppe1lUgCZGCQ: posts small blind $0.10
njVkfGYrPiXfq4zLcgfVuA said, "you forgot to show la3"
kyRaCIljYA6l33lSKQfNsg: posts big blind $0.25
*** HOLE CARDS ***
buyjetgNT1McXtdaP4zynA: calls $0.25
njVkfGYrPiXfq4zLcgfVuA: folds 
1Zyw8DT57U6TzxWWRixa6Q: calls $0.25
cPO/1/dTcZpLkQFm3jH3Rg: folds 
4YSTu0Cdzpppe1lUgCZGCQ: folds 
kyRaCIljYA6l33lSKQfNsg: checks 
*** FLOP *** [9c 5c Ah]
kyRaCIljYA6l33lSKQfNsg: checks 
buyjetgNT1McXtdaP4zynA: bets $0.75
1Zyw8DT57U6TzxWWRixa6Q: calls $0.75
kyRaCIljYA6l33lSKQfNsg: folds 
*** TURN *** [9c 5c Ah] [Jc]
buyjetgNT1McXtdaP4zynA: checks 
1Zyw8DT57U6TzxWWRixa6Q: bets $1.50
buyjetgNT1McXtdaP4zynA: folds 
Uncalled bet ($1.50) returned to 1Zyw8DT57U6TzxWWRixa6Q
1Zyw8DT57U6TzxWWRixa6Q collected $2.25 from pot
*** SUMMARY ***
Total pot $2.35 | Rake $0.10 
Board [9c 5c Ah Jc]
Seat 1: njVkfGYrPiXfq4zLcgfVuA folded before Flop (didn't bet)
Seat 2: 1Zyw8DT57U6TzxWWRixa6Q collected ($2.25)
Seat 3: cPO/1/dTcZpLkQFm3jH3Rg (button) folded before Flop (didn't bet)
Seat 4: 4YSTu0Cdzpppe1lUgCZGCQ (small blind) folded before Flop
Seat 5: kyRaCIljYA6l33lSKQfNsg (big blind) folded on the Flop
Seat 6: buyjetgNT1McXtdaP4zynA folded on the Turn




PokerStars Game #59939412848:  Hold'em No Limit ($0.10/$0.25) - 2009/07/01 0:39:13 ET
Table 'Loy/olZ5qoDOSvX4UTujGg' 6-max Seat #6 is the button
Seat 1: yzFNNFIfC89bBPwpFPx2ow ($28.60 in chips) 
Seat 3: 32YL2ZEp8NT4JB2RVM9euQ ($15.65 in chips) 
Seat 4: /gJNBeCkWL4o85/jvlZ4BA ($27.45 in chips) 
Seat 5: 4YSTu0Cdzpppe1lUgCZGCQ ($35.15 in chips) 
Seat 6: 7FmwVDcdEtxDpHmP4hOXsQ ($52.70 in chips) 
yzFNNFIfC89bBPwpFPx2ow: posts small blind $0.10
32YL2ZEp8NT4JB2RVM9euQ: posts big blind $0.25
*** HOLE CARDS ***
/gJNBeCkWL4o85/jvlZ4BA: folds 
4YSTu0Cdzpppe1lUgCZGCQ: folds 
7FmwVDcdEtxDpHmP4hOXsQ: folds 
yzFNNFIfC89bBPwpFPx2ow: folds 
Uncalled bet ($0.15) returned to 32YL2ZEp8NT4JB2RVM9euQ
32YL2ZEp8NT4JB2RVM9euQ collected $0.20 from pot
32YL2ZEp8NT4JB2RVM9euQ: doesn't show hand 
*** SUMMARY ***
Total pot $0.20 | Rake $0 
Seat 1: yzFNNFIfC89bBPwpFPx2ow (small blind) folded before Flop
Seat 3: 32YL2ZEp8NT4JB2RVM9euQ (big blind) collected ($0.20)
Seat 4: /gJNBeCkWL4o85/jvlZ4BA folded before Flop (didn't bet)
Seat 5: 4YSTu0Cdzpppe1lUgCZGCQ folded before Flop (didn't bet)
Seat 6: 7FmwVDcdEtxDpHmP4hOXsQ (button) folded before Flop (didn't bet)




PokerStars Game #59939412620:  Hold'em No Limit ($0.10/$0.25) - 2009/07/01 0:39:13 ET
Table 'MJ1SB76A4qJrlEa+C5e/8w' 6-max Seat #2 is the button
Seat 2: UA5OsKS3VPaxa7uC8La/kA ($27.50 in chips) 
Seat 3: IrrSNlaIjHnZjG6E7LgmEg ($16.75 in chips) 
Seat 4: 6boOPJDTFiEyZD2WdW0kCA ($15 in chips) 
Seat 5: eHsmIvAb2JREg4O6hNPnXg ($10 in chips) 
Seat 6: JFIAqU8lCZ0vWwEl4bdGsg ($25 in chips) 
IrrSNlaIjHnZjG6E7LgmEg: posts small blind $0.10
6boOPJDTFiEyZD2WdW0kCA: posts big blind $0.25
*** HOLE CARDS ***
eHsmIvAb2JREg4O6hNPnXg: folds 
JFIAqU8lCZ0vWwEl4bdGsg: folds 
UA5OsKS3VPaxa7uC8La/kA: raises $0.50 to $0.75
IrrSNlaIjHnZjG6E7LgmEg: calls $0.65
6boOPJDTFiEyZD2WdW0kCA: calls $0.50
*** FLOP *** [9s Ad Ac]
IrrSNlaIjHnZjG6E7LgmEg: checks 
6boOPJDTFiEyZD2WdW0kCA: checks 
UA5OsKS3VPaxa7uC8La/kA: bets $1
IrrSNlaIjHnZjG6E7LgmEg: folds 
6boOPJDTFiEyZD2WdW0kCA: folds 
Uncalled bet ($1) returned to UA5OsKS3VPaxa7uC8La/kA
UA5OsKS3VPaxa7uC8La/kA collected $2.15 from pot
*** SUMMARY ***
Total pot $2.25 | Rake $0.10 
Board [9s Ad Ac]
Seat 2: UA5OsKS3VPaxa7uC8La/kA (button) collected ($2.15)
Seat 3: IrrSNlaIjHnZjG6E7LgmEg (small blind) folded on the Flop
Seat 4: 6boOPJDTFiEyZD2WdW0kCA (big blind) folded on the Flop
Seat 5: eHsmIvAb2JREg4O6hNPnXg folded before Flop (didn't bet)
Seat 6: JFIAqU8lCZ0vWwEl4bdGsg folded before Flop (didn't bet)




PokerStars Game #59939412814:  Hold'em No Limit ($0.10/$0.25) - 2009/07/01 0:39:13 ET
Table 'fIMYcWwN4/aXFJvH5Z8Ymg' 6-max Seat #1 is the button
Seat 1: 64ZeDpsBsP594VsWmafRTQ ($16.85 in chips) 
Seat 2: vu2kzHaDtgr6NM7rdq0chA ($25.55 in chips) 
Seat 3: bWbV4MVB/vVpiES1Ut4hew ($46.25 in chips) 
Seat 4: 32YL2ZEp8NT4JB2RVM9euQ ($40.40 in chips) 
Seat 5: 9jSiy0meE9XJKkdIZwyTEQ ($29.75 in chips) 
vu2kzHaDtgr6NM7rdq0chA: posts small blind $0.10
bWbV4MVB/vVpiES1Ut4hew: posts big blind $0.25
*** HOLE CARDS ***
32YL2ZEp8NT4JB2RVM9euQ: folds 
9jSiy0meE9XJKkdIZwyTEQ: folds 
64ZeDpsBsP594VsWmafRTQ: raises $0.50 to $0.75
Parks Playa joins the table at seat #6 
vu2kzHaDtgr6NM7rdq0chA: folds 
bWbV4MVB/vVpiES1Ut4hew: folds 
Uncalled bet ($0.50) returned to 64ZeDpsBsP594VsWmafRTQ
64ZeDpsBsP594VsWmafRTQ collected $0.60 from pot
*** SUMMARY ***
Total pot $0.60 | Rake $0 
Seat 1: 64ZeDpsBsP594VsWmafRTQ (button) collected ($0.60)
Seat 2: vu2kzHaDtgr6NM7rdq0chA (small blind) folded before Flop
Seat 3: bWbV4MVB/vVpiES1Ut4hew (big blind) folded before Flop
Seat 4: 32YL2ZEp8NT4JB2RVM9euQ folded before Flop (didn't bet)
Seat 5: 9jSiy0meE9XJKkdIZwyTEQ folded before Flop (didn't bet)




PokerStars Game #59939412648:  Hold'em No Limit ($0.10/$0.25) - 2009/07/01 0:39:13 ET
Table '3Ns9nuTkynfwbBfBXzg6ww' 6-max Seat #3 is the button
Seat 3: 6PDO6dptGq0XLL8zHWIhgw ($48.10 in chips) 
Seat 4: kyRaCIljYA6l33lSKQfNsg ($25 in chips) 
Seat 5: kBQU/db00TVAMeomlhblPg ($22.20 in chips) 
kyRaCIljYA6l33lSKQfNsg: posts small blind $0.10
kBQU/db00TVAMeomlhblPg: posts big blind $0.25
*** HOLE CARDS ***
6PDO6dptGq0XLL8zHWIhgw: calls $0.25
kyRaCIljYA6l33lSKQfNsg: raises $0.75 to $1
kBQU/db00TVAMeomlhblPg: folds 
6PDO6dptGq0XLL8zHWIhgw: calls $0.75
*** FLOP *** [7d 8h Kd]
kyRaCIljYA6l33lSKQfNsg: bets $1.75
6PDO6dptGq0XLL8zHWIhgw: calls $1.75
*** TURN *** [7d 8h Kd] [Ks]
kyRaCIljYA6l33lSKQfNsg: bets $3.50
6PDO6dptGq0XLL8zHWIhgw: folds 
Uncalled bet ($3.50) returned to kyRaCIljYA6l33lSKQfNsg
kyRaCIljYA6l33lSKQfNsg collected $5.50 from pot
*** SUMMARY ***
Total pot $5.75 | Rake $0.25 
Board [7d 8h Kd Ks]
Seat 3: 6PDO6dptGq0XLL8zHWIhgw (button) folded on the Turn
Seat 4: kyRaCIljYA6l33lSKQfNsg (small blind) collected ($5.50)
Seat 5: kBQU/db00TVAMeomlhblPg (big blind) folded before Flop




PokerStars Game #59939412878:  Hold'em No Limit ($0.10/$0.25) - 2009/07/01 0:39:13 ET
Table 'ykyWGjhNu7AvZXov27T4ew' 9-max Seat #9 is the button
Seat 2: MG90wfSJZnOejs/KD3vlQQ ($25.10 in chips) 
Seat 3: r1pFKMwWp74QwhfPWJOAyw ($5.55 in chips) 
Seat 4: hBMUlEpyU74r/fwDgIpXjQ ($25.80 in chips) 
Seat 5: lMysP2jE94oJvWGA6K5puw ($7.75 in chips) 
Seat 6: opOCI2p6kW0tINuVaAqmcQ ($25 in chips) 
Seat 8: tYsOBqdU1+x+yFI7zHO7hQ ($32.30 in chips) 
Seat 9: Yv4fucyyT28mjx8V5lxKJg ($25.15 in chips) 
MG90wfSJZnOejs/KD3vlQQ: posts small blind $0.10
r1pFKMwWp74QwhfPWJOAyw: posts big blind $0.25
CYkY0dNBaYaKs8HVCVn3mQ: sits out 
*** HOLE CARDS ***
hBMUlEpyU74r/fwDgIpXjQ: folds 
lMysP2jE94oJvWGA6K5puw: raises $0.25 to $0.50
opOCI2p6kW0tINuVaAqmcQ: folds 
tYsOBqdU1+x+yFI7zHO7hQ: raises $2.50 to $3
Yv4fucyyT28mjx8V5lxKJg: calls $3
MG90wfSJZnOejs/KD3vlQQ: folds 
r1pFKMwWp74QwhfPWJOAyw: folds 
lMysP2jE94oJvWGA6K5puw: folds 
*** FLOP *** [Jh Ah 7s]
tYsOBqdU1+x+yFI7zHO7hQ: bets $4
Yv4fucyyT28mjx8V5lxKJg: folds 
Uncalled bet ($4) returned to tYsOBqdU1+x+yFI7zHO7hQ
tYsOBqdU1+x+yFI7zHO7hQ collected $6.55 from pot
tYsOBqdU1+x+yFI7zHO7hQ: doesn't show hand 
*** SUMMARY ***
Total pot $6.85 | Rake $0.30 
Board [Jh Ah 7s]
Seat 2: MG90wfSJZnOejs/KD3vlQQ (small blind) folded before Flop
Seat 3: r1pFKMwWp74QwhfPWJOAyw (big blind) folded before Flop
Seat 4: hBMUlEpyU74r/fwDgIpXjQ folded before Flop (didn't bet)
Seat 5: lMysP2jE94oJvWGA6K5puw folded before Flop
Seat 6: opOCI2p6kW0tINuVaAqmcQ folded before Flop (didn't bet)
Seat 8: tYsOBqdU1+x+yFI7zHO7hQ collected ($6.55)
Seat 9: Yv4fucyyT28mjx8V5lxKJg (button) folded on the Flop




PokerStars Game #59939412690:  Hold'em No Limit ($0.10/$0.25) - 2009/07/01 0:39:13 ET
Table 'QzXakDK7ZHNjgIpoUFGSKQ' 9-max Seat #1 is the button
Seat 1: vZGoOTJLQLhkPj4I+LNGig ($25 in chips) 
Seat 2: HVKi9hnDyvzObpL08/OarQ ($23.30 in chips) 
Seat 3: E4pjUoTJmJNmancGXn1nSw ($19.45 in chips) 
Seat 4: Yv4fucyyT28mjx8V5lxKJg ($24.25 in chips) 
Seat 5: NAP/FpFXsTsBxjDijlVzEg ($26.45 in chips) 
Seat 6: c7sk/W5UhCTyhjXh5MT/eg ($11.25 in chips) 
Seat 7: zUPSsmVPAK0z0iGmEx7WbA ($9.80 in chips) 
Seat 8: HXf7T9U74NXM5C+iMg8Cbg ($4.50 in chips) 
HVKi9hnDyvzObpL08/OarQ: posts small blind $0.10
E4pjUoTJmJNmancGXn1nSw: posts big blind $0.25
*** HOLE CARDS ***
Yv4fucyyT28mjx8V5lxKJg: folds 
NAP/FpFXsTsBxjDijlVzEg: folds 
c7sk/W5UhCTyhjXh5MT/eg: calls $0.25
zUPSsmVPAK0z0iGmEx7WbA: folds 
HXf7T9U74NXM5C+iMg8Cbg: folds 
vZGoOTJLQLhkPj4I+LNGig: folds 
HVKi9hnDyvzObpL08/OarQ: calls $0.15
hvydiesel joins the table at seat #9 
E4pjUoTJmJNmancGXn1nSw: checks 
*** FLOP *** [2s 8s Jc]
HVKi9hnDyvzObpL08/OarQ: bets $0.75
E4pjUoTJmJNmancGXn1nSw: folds 
c7sk/W5UhCTyhjXh5MT/eg: folds 
Uncalled bet ($0.75) returned to HVKi9hnDyvzObpL08/OarQ
HVKi9hnDyvzObpL08/OarQ collected $0.75 from pot
*** SUMMARY ***
Total pot $0.75 | Rake $0 
Board [2s 8s Jc]
Seat 1: vZGoOTJLQLhkPj4I+LNGig (button) folded before Flop (didn't bet)
Seat 2: HVKi9hnDyvzObpL08/OarQ (small blind) collected ($0.75)
Seat 3: E4pjUoTJmJNmancGXn1nSw (big blind) folded on the Flop
Seat 4: Yv4fucyyT28mjx8V5lxKJg folded before Flop (didn't bet)
Seat 5: NAP/FpFXsTsBxjDijlVzEg folded before Flop (didn't bet)
Seat 6: c7sk/W5UhCTyhjXh5MT/eg folded on the Flop
Seat 7: zUPSsmVPAK0z0iGmEx7WbA folded before Flop (didn't bet)
Seat 8: HXf7T9U74NXM5C+iMg8Cbg folded before Flop (didn't bet)




PokerStars Game #59939413206:  Hold'em No Limit ($0.10/$0.25) - 2009/07/01 0:39:14 ET
Table 'nRFAYu63wZNzrz/OBgzFTw' 9-max Seat #5 is the button
Seat 2: hJ4uYjNmSZdjrKA8cjZqCA ($20.20 in chips) 
Seat 3: EfRs3ibIxn+c9JDErwwNCg ($25 in chips) 
Seat 4: OiV1PWZ3IkN29JlmCcnTwQ ($5.50 in chips) 
Seat 5: vKdukiQ4ktU4yJ0Xx3MKnA ($28.80 in chips) 
Seat 6: DnDcAdn9P0zGovMERigpFA ($25 in chips) 
Seat 7: COsrwJSFHQtxlUcrYtDQPQ ($26.95 in chips) 
Seat 8: rhWCqDS9OBh/IoXY29BGMw ($19.55 in chips) 
Seat 9: SXqVW4Q0evTUVZG6BbUNIA ($33.50 in chips) 
DnDcAdn9P0zGovMERigpFA: posts small blind $0.10
COsrwJSFHQtxlUcrYtDQPQ: posts big blind $0.25
N6fYvIzQLKaydFLKQGtMlQ: sits out 
*** HOLE CARDS ***
rhWCqDS9OBh/IoXY29BGMw: folds 
SXqVW4Q0evTUVZG6BbUNIA: raises $0.50 to $0.75
hJ4uYjNmSZdjrKA8cjZqCA: folds 
EfRs3ibIxn+c9JDErwwNCg: raises $1.25 to $2
OiV1PWZ3IkN29JlmCcnTwQ: folds 
vKdukiQ4ktU4yJ0Xx3MKnA: folds 
DnDcAdn9P0zGovMERigpFA: folds 
COsrwJSFHQtxlUcrYtDQPQ: folds 
SXqVW4Q0evTUVZG6BbUNIA: calls $1.25
*** FLOP *** [5d Qc 3s]
SXqVW4Q0evTUVZG6BbUNIA: checks 
EfRs3ibIxn+c9JDErwwNCg: bets $2
SXqVW4Q0evTUVZG6BbUNIA: calls $2
*** TURN *** [5d Qc 3s] [Ad]
SXqVW4Q0evTUVZG6BbUNIA: checks 
EfRs3ibIxn+c9JDErwwNCg: checks 
*** RIVER *** [5d Qc 3s Ad] [Js]
SXqVW4Q0evTUVZG6BbUNIA: checks 
EfRs3ibIxn+c9JDErwwNCg: checks 
rhWCqDS9OBh/IoXY29BGMw leaves the table
*** SHOW DOWN ***
SXqVW4Q0evTUVZG6BbUNIA: shows [8s 8c] (a pair of Eights)
EfRs3ibIxn+c9JDErwwNCg: shows [Kd Kc] (a pair of Kings)
EfRs3ibIxn+c9JDErwwNCg collected $7.95 from pot
*** SUMMARY ***
Total pot $8.35 | Rake $0.40 
Board [5d Qc 3s Ad Js]
Seat 2: hJ4uYjNmSZdjrKA8cjZqCA folded before Flop (didn't bet)
Seat 3: EfRs3ibIxn+c9JDErwwNCg showed [Kd Kc] and won ($7.95) with a pair of Kings
Seat 4: OiV1PWZ3IkN29JlmCcnTwQ folded before Flop (didn't bet)
Seat 5: vKdukiQ4ktU4yJ0Xx3MKnA (button) folded before Flop (didn't bet)
Seat 6: DnDcAdn9P0zGovMERigpFA (small blind) folded before Flop
Seat 7: COsrwJSFHQtxlUcrYtDQPQ (big blind) folded before Flop
Seat 8: rhWCqDS9OBh/IoXY29BGMw folded before Flop (didn't bet)
Seat 9: SXqVW4Q0evTUVZG6BbUNIA showed [8s 8c] and lost with a pair of Eights




PokerStars Game #59939413116:  Hold'em No Limit ($0.10/$0.25) - 2009/07/01 0:39:14 ET
Table 'Yb2CyZosw7N3yRRVLhKnKg' 9-max Seat #5 is the button
Seat 1: lcT2xQLmuzNRe6+aWd6eww ($32.15 in chips) 
Seat 2: dmYlc+1cjwZMJ7wV+Z0rRg ($25.90 in chips) 
Seat 4: H5Se03ZqSX7tbULXur2MAg ($19.80 in chips) 
Seat 5: QUCO+kde5iROhmqVTzQ6KQ ($37.25 in chips) 
Seat 6: opOCI2p6kW0tINuVaAqmcQ ($25.65 in chips) 
Seat 7: OiV1PWZ3IkN29JlmCcnTwQ ($4.65 in chips) 
Seat 8: aJy680tKSaP5er559aSuGA ($22.50 in chips) 
Seat 9: aCVg6cCxQcqClhB9nq/p1w ($9.80 in chips) 
opOCI2p6kW0tINuVaAqmcQ: posts small blind $0.10
OiV1PWZ3IkN29JlmCcnTwQ: posts big blind $0.25
*** HOLE CARDS ***
aJy680tKSaP5er559aSuGA: folds 
aCVg6cCxQcqClhB9nq/p1w: raises $0.25 to $0.50
lcT2xQLmuzNRe6+aWd6eww: folds 
dmYlc+1cjwZMJ7wV+Z0rRg: folds 
H5Se03ZqSX7tbULXur2MAg: calls $0.50
QUCO+kde5iROhmqVTzQ6KQ: folds 
opOCI2p6kW0tINuVaAqmcQ: folds 
OiV1PWZ3IkN29JlmCcnTwQ: folds 
*** FLOP *** [5h Qh 3s]
aCVg6cCxQcqClhB9nq/p1w: bets $0.25
H5Se03ZqSX7tbULXur2MAg: raises $1.25 to $1.50
aCVg6cCxQcqClhB9nq/p1w: calls $1.25
*** TURN *** [5h Qh 3s] [Qc]
aCVg6cCxQcqClhB9nq/p1w: bets $7.80 and is all-in
H5Se03ZqSX7tbULXur2MAg: calls $7.80
*** RIVER *** [5h Qh 3s Qc] [Qd]
*** SHOW DOWN ***
aCVg6cCxQcqClhB9nq/p1w: shows [Ah Kd] (three of a kind, Queens)
H5Se03ZqSX7tbULXur2MAg: shows [Ac Qs] (four of a kind, Queens)
H5Se03ZqSX7tbULXur2MAg collected $19 from pot
*** SUMMARY ***
Total pot $19.95 | Rake $0.95 
Board [5h Qh 3s Qc Qd]
Seat 1: lcT2xQLmuzNRe6+aWd6eww folded before Flop (didn't bet)
Seat 2: dmYlc+1cjwZMJ7wV+Z0rRg folded before Flop (didn't bet)
Seat 4: H5Se03ZqSX7tbULXur2MAg showed [Ac Qs] and won ($19) with four of a kind, Queens
Seat 5: QUCO+kde5iROhmqVTzQ6KQ (button) folded before Flop (didn't bet)
Seat 6: opOCI2p6kW0tINuVaAqmcQ (small blind) folded before Flop
Seat 7: OiV1PWZ3IkN29JlmCcnTwQ (big blind) folded before Flop
Seat 8: aJy680tKSaP5er559aSuGA folded before Flop (didn't bet)
Seat 9: aCVg6cCxQcqClhB9nq/p1w showed [Ah Kd] and lost with three of a kind, Queens




PokerStars Game #59939413114:  Hold'em No Limit ($0.10/$0.25) - 2009/07/01 0:39:14 ET
Table 'YYMg5qzxK1m9eGRo4SbxtQ' 9-max Seat #4 is the button
Seat 1: DiSvPC2iudwL5j9u6Huyww ($25 in chips) 
Seat 2: uH1RN27w9SKa7TpVR9EFrQ ($14.90 in chips) 
Seat 3: N6fYvIzQLKaydFLKQGtMlQ ($24.05 in chips) 
Seat 4: H8sSXb2KLK0U38tU9YITDw ($10.90 in chips) 
Seat 5: BEIBUu2pIflPrCL+Iks4CQ ($19.40 in chips) 
Seat 6: gehe91e0IyVT0QU/XBkEyg ($41.95 in chips) 
Seat 7: hPhp/RE3cJ5YGaQ2xOHXXg ($4.30 in chips) 
Seat 8: 18G4P1XstjNvItdGUITxgw ($26.05 in chips) 
Seat 9: +sbyWwIcFp9kP0bDtMegfQ ($36.90 in chips) 
BEIBUu2pIflPrCL+Iks4CQ: posts small blind $0.10
gehe91e0IyVT0QU/XBkEyg: posts big blind $0.25
*** HOLE CARDS ***
hPhp/RE3cJ5YGaQ2xOHXXg: folds 
18G4P1XstjNvItdGUITxgw: folds 
+sbyWwIcFp9kP0bDtMegfQ: folds 
DiSvPC2iudwL5j9u6Huyww: folds 
uH1RN27w9SKa7TpVR9EFrQ: folds 
N6fYvIzQLKaydFLKQGtMlQ: folds 
H8sSXb2KLK0U38tU9YITDw: calls $0.25
BEIBUu2pIflPrCL+Iks4CQ: folds 
gehe91e0IyVT0QU/XBkEyg: checks 
*** FLOP *** [2d Qh 8d]
gehe91e0IyVT0QU/XBkEyg: checks 
H8sSXb2KLK0U38tU9YITDw: bets $0.25
gehe91e0IyVT0QU/XBkEyg: folds 
Uncalled bet ($0.25) returned to H8sSXb2KLK0U38tU9YITDw
H8sSXb2KLK0U38tU9YITDw collected $0.60 from pot
H8sSXb2KLK0U38tU9YITDw: doesn't show hand 
*** SUMMARY ***
Total pot $0.60 | Rake $0 
Board [2d Qh 8d]
Seat 1: DiSvPC2iudwL5j9u6Huyww folded before Flop (didn't bet)
Seat 2: uH1RN27w9SKa7TpVR9EFrQ folded before Flop (didn't bet)
Seat 3: N6fYvIzQLKaydFLKQGtMlQ folded before Flop (didn't bet)
Seat 4: H8sSXb2KLK0U38tU9YITDw (button) collected ($0.60)
Seat 5: BEIBUu2pIflPrCL+Iks4CQ (small blind) folded before Flop
Seat 6: gehe91e0IyVT0QU/XBkEyg (big blind) folded on the Flop
Seat 7: hPhp/RE3cJ5YGaQ2xOHXXg folded before Flop (didn't bet)
Seat 8: 18G4P1XstjNvItdGUITxgw folded before Flop (didn't bet)
Seat 9: +sbyWwIcFp9kP0bDtMegfQ folded before Flop (didn't bet)




PokerStars Game #59939413514:  Hold'em No Limit ($0.10/$0.25) - 2009/07/01 0:39:14 ET
Table '9L7XfAwuM7XsXE8LIg2o5Q' 6-max Seat #2 is the button
Seat 1: H6XbZVba2aKDXlG0la0uow ($9.35 in chips) 
Seat 2: oseFhpinoe+Zg4j5xyBjyQ ($6.40 in chips) 
Seat 3: 9StOHp+Y1T0K13JdgS2oQQ ($6.85 in chips) 
Seat 4: xBOVv8xEXtymVpAA5ZajSw ($82.15 in chips) 
Seat 6: k9nHZTHt8hYhYRcW8NTb4g ($29.45 in chips) 
raina1977 has returned
9StOHp+Y1T0K13JdgS2oQQ: posts small blind $0.10
xBOVv8xEXtymVpAA5ZajSw: posts big blind $0.25
*** HOLE CARDS ***
k9nHZTHt8hYhYRcW8NTb4g: folds 
H6XbZVba2aKDXlG0la0uow: folds 
oseFhpinoe+Zg4j5xyBjyQ: folds 
9StOHp+Y1T0K13JdgS2oQQ: raises $0.50 to $0.75
xBOVv8xEXtymVpAA5ZajSw: raises $16.75 to $17.50
9StOHp+Y1T0K13JdgS2oQQ: folds 
Uncalled bet ($16.75) returned to xBOVv8xEXtymVpAA5ZajSw
xBOVv8xEXtymVpAA5ZajSw collected $1.50 from pot
*** SUMMARY ***
Total pot $1.50 | Rake $0 
Seat 1: H6XbZVba2aKDXlG0la0uow folded before Flop (didn't bet)
Seat 2: oseFhpinoe+Zg4j5xyBjyQ (button) folded before Flop (didn't bet)
Seat 3: 9StOHp+Y1T0K13JdgS2oQQ (small blind) folded before Flop
Seat 4: xBOVv8xEXtymVpAA5ZajSw (big blind) collected ($1.50)
Seat 6: k9nHZTHt8hYhYRcW8NTb4g folded before Flop (didn't bet)




PokerStars Game #59939413400:  Hold'em No Limit ($0.10/$0.25) - 2009/07/01 0:39:14 ET
Table 'Pz8SfAzhP5nvWTsJRAxoDg' 6-max Seat #3 is the button
Seat 1: buyjetgNT1McXtdaP4zynA ($44.15 in chips) 
Seat 2: RYLaAIIwK9wxkPswt1yJYw ($23.05 in chips) 
Seat 3: mfrkWA3PTeYPkbO6hi98Aw ($30.50 in chips) 
Seat 4: 9U9Vy/656QCEfKznJWteag ($16.75 in chips) 
Seat 5: FYepjhAvF8ZdVCmqHIy+eQ ($30.30 in chips) 
Seat 6: FStoHe64SQWqAsjya9pDkQ ($25 in chips) 
9U9Vy/656QCEfKznJWteag: posts small blind $0.10
FYepjhAvF8ZdVCmqHIy+eQ: posts big blind $0.25
*** HOLE CARDS ***
FStoHe64SQWqAsjya9pDkQ: folds 
buyjetgNT1McXtdaP4zynA: calls $0.25
RYLaAIIwK9wxkPswt1yJYw: folds 
mfrkWA3PTeYPkbO6hi98Aw: folds 
9U9Vy/656QCEfKznJWteag: calls $0.15
FYepjhAvF8ZdVCmqHIy+eQ: checks 
*** FLOP *** [6h Ah 2s]
9U9Vy/656QCEfKznJWteag: checks 
FYepjhAvF8ZdVCmqHIy+eQ: checks 
buyjetgNT1McXtdaP4zynA: checks 
*** TURN *** [6h Ah 2s] [7d]
9U9Vy/656QCEfKznJWteag: checks 
FYepjhAvF8ZdVCmqHIy+eQ: checks 
buyjetgNT1McXtdaP4zynA: checks 
*** RIVER *** [6h Ah 2s 7d] [4h]
9U9Vy/656QCEfKznJWteag: checks 
FYepjhAvF8ZdVCmqHIy+eQ: checks 
buyjetgNT1McXtdaP4zynA: checks 
*** SHOW DOWN ***
9U9Vy/656QCEfKznJWteag: shows [Ts 8s] (high card Ace)
FYepjhAvF8ZdVCmqHIy+eQ: mucks hand 
buyjetgNT1McXtdaP4zynA: shows [Qs Td] (high card Ace - Queen kicker)
buyjetgNT1McXtdaP4zynA collected $0.75 from pot
*** SUMMARY ***
Total pot $0.75 | Rake $0 
Board [6h Ah 2s 7d 4h]
Seat 1: buyjetgNT1McXtdaP4zynA showed [Qs Td] and won ($0.75) with high card Ace
Seat 2: RYLaAIIwK9wxkPswt1yJYw folded before Flop (didn't bet)
Seat 3: mfrkWA3PTeYPkbO6hi98Aw (button) folded before Flop (didn't bet)
Seat 4: 9U9Vy/656QCEfKznJWteag (small blind) showed [Ts 8s] and lost with high card Ace
Seat 5: FYepjhAvF8ZdVCmqHIy+eQ (big blind) mucked
Seat 6: FStoHe64SQWqAsjya9pDkQ folded before Flop (didn't bet)




PokerStars Game #59939413068:  Hold'em No Limit ($0.10/$0.25) - 2009/07/01 0:39:14 ET
Table 'CBnRhp0d6E2+/NtM7Vbruw' 9-max Seat #5 is the button
Seat 1: WQe4GbiYBiPsb5WKFKkijQ ($5 in chips) 
Seat 2: DIBbjEYGs+TVdVgEB/4+3w ($36.15 in chips) 
Seat 4: FR1anYnrxOdUfdNDELZ4SQ ($19.50 in chips) 
Seat 5: R6nIVAjK7uhK3Hj0f85A+A ($23.55 in chips) 
Seat 7: 40uIA6odSc6GeRu392xZTA ($31.95 in chips) 
Seat 8: MG90wfSJZnOejs/KD3vlQQ ($36.05 in chips) 
40uIA6odSc6GeRu392xZTA: posts small blind $0.10
MG90wfSJZnOejs/KD3vlQQ: posts big blind $0.25
BHKu5wmAIC0UlfmA78se7A: sits out 
*** HOLE CARDS ***
WQe4GbiYBiPsb5WKFKkijQ: folds 
DIBbjEYGs+TVdVgEB/4+3w: folds 
FR1anYnrxOdUfdNDELZ4SQ: raises $0.25 to $0.50
R6nIVAjK7uhK3Hj0f85A+A: folds 
40uIA6odSc6GeRu392xZTA: folds 
MG90wfSJZnOejs/KD3vlQQ: folds 
Uncalled bet ($0.25) returned to FR1anYnrxOdUfdNDELZ4SQ
FR1anYnrxOdUfdNDELZ4SQ collected $0.60 from pot
*** SUMMARY ***
Total pot $0.60 | Rake $0 
Seat 1: WQe4GbiYBiPsb5WKFKkijQ folded before Flop (didn't bet)
Seat 2: DIBbjEYGs+TVdVgEB/4+3w folded before Flop (didn't bet)
Seat 4: FR1anYnrxOdUfdNDELZ4SQ collected ($0.60)
Seat 5: R6nIVAjK7uhK3Hj0f85A+A (button) folded before Flop (didn't bet)
Seat 7: 40uIA6odSc6GeRu392xZTA (small blind) folded before Flop
Seat 8: MG90wfSJZnOejs/KD3vlQQ (big blind) folded before Flop




PokerStars Game #59939414078:  Hold'em No Limit ($0.10/$0.25) - 2009/07/01 0:39:15 ET
Table 'LLHSnYPAXNI1sFlwPBn1tA' 6-max Seat #5 is the button
Seat 1: tVZW8k4GP+PvZ1DjD/9StA ($10.90 in chips) 
Seat 2: oseFhpinoe+Zg4j5xyBjyQ ($24.55 in chips) 
Seat 3: JFIAqU8lCZ0vWwEl4bdGsg ($28.15 in chips) 
Seat 4: FPlQHZog0ePFCETQ2KG4hQ ($27.20 in chips) 
Seat 5: jXbd3O6QdeNWctmpAsTgHA ($14.40 in chips) 
Seat 6: PCh4iIHq9rXvWY/FeXc/Jg ($31.35 in chips) 
PCh4iIHq9rXvWY/FeXc/Jg: posts small blind $0.10
tVZW8k4GP+PvZ1DjD/9StA: posts big blind $0.25
*** HOLE CARDS ***
oseFhpinoe+Zg4j5xyBjyQ: folds 
JFIAqU8lCZ0vWwEl4bdGsg: folds 
FPlQHZog0ePFCETQ2KG4hQ: folds 
jXbd3O6QdeNWctmpAsTgHA: folds 
PCh4iIHq9rXvWY/FeXc/Jg: folds 
Uncalled bet ($0.15) returned to tVZW8k4GP+PvZ1DjD/9StA
tVZW8k4GP+PvZ1DjD/9StA collected $0.20 from pot
tVZW8k4GP+PvZ1DjD/9StA: doesn't show hand 
*** SUMMARY ***
Total pot $0.20 | Rake $0 
Seat 1: tVZW8k4GP+PvZ1DjD/9StA (big blind) collected ($0.20)
Seat 2: oseFhpinoe+Zg4j5xyBjyQ folded before Flop (didn't bet)
Seat 3: JFIAqU8lCZ0vWwEl4bdGsg folded before Flop (didn't bet)
Seat 4: FPlQHZog0ePFCETQ2KG4hQ folded before Flop (didn't bet)
Seat 5: jXbd3O6QdeNWctmpAsTgHA (button) folded before Flop (didn't bet)
Seat 6: PCh4iIHq9rXvWY/FeXc/Jg (small blind) folded before Flop




PokerStars Game #59939414016:  Hold'em No Limit ($0.10/$0.25) - 2009/07/01 0:39:15 ET
Table 'YmPuuzhvRUvgdYcNs5kZKw' 9-max Seat #2 is the button
Seat 1: Qi+clOtyDiibLdH2/1Qy8g ($24.60 in chips) 
Seat 2: Z5ZtGOON8kmSdSCll9Z3XA ($17 in chips) 
Seat 3: uLP/lYn7oKq9xCChBXsXxw ($24.75 in chips) 
Seat 6: z5GxcHlYz/GSz6W2uFiTtg ($22.05 in chips) 
Seat 7: opOCI2p6kW0tINuVaAqmcQ ($25.15 in chips) 
Seat 8: IeNTEKD96WqM7qU1RpSvOQ ($13.55 in chips) 
Seat 9: 5IeCaraAnS03/jUIjZQAig ($6.85 in chips) 
uLP/lYn7oKq9xCChBXsXxw: posts small blind $0.10
JxpnpCmvRAcrEUy7mq1iAg: is sitting out 
ZwMqa2mn2qu4W4PkN7J+xg: is sitting out 
5IeCaraAnS03/jUIjZQAig said, "LOLOLOLOL"
z5GxcHlYz/GSz6W2uFiTtg: posts big blind $0.25
*** HOLE CARDS ***
JxpnpCmvRAcrEUy7mq1iAg leaves the table
ZwMqa2mn2qu4W4PkN7J+xg leaves the table
IeNTEKD96WqM7qU1RpSvOQ said, "muhahaha"
opOCI2p6kW0tINuVaAqmcQ: folds 
IeNTEKD96WqM7qU1RpSvOQ: folds 
5IeCaraAnS03/jUIjZQAig: calls $0.25
Qi+clOtyDiibLdH2/1Qy8g: calls $0.25
Z5ZtGOON8kmSdSCll9Z3XA: folds 
uLP/lYn7oKq9xCChBXsXxw: calls $0.15
z5GxcHlYz/GSz6W2uFiTtg: checks 
*** FLOP *** [7c Qc Qh]
uLP/lYn7oKq9xCChBXsXxw: checks 
z5GxcHlYz/GSz6W2uFiTtg: checks 
N6fYvIzQLKaydFLKQGtMlQ joins the table at seat #4 
5IeCaraAnS03/jUIjZQAig: checks 
Qi+clOtyDiibLdH2/1Qy8g: bets $0.50
uLP/lYn7oKq9xCChBXsXxw: folds 
Apinooso joins the table at seat #5 
z5GxcHlYz/GSz6W2uFiTtg: folds 
5IeCaraAnS03/jUIjZQAig: folds 
Uncalled bet ($0.50) returned to Qi+clOtyDiibLdH2/1Qy8g
Qi+clOtyDiibLdH2/1Qy8g collected $0.95 from pot
Qi+clOtyDiibLdH2/1Qy8g: doesn't show hand 
*** SUMMARY ***
Total pot $1 | Rake $0.05 
Board [7c Qc Qh]
Seat 1: Qi+clOtyDiibLdH2/1Qy8g collected ($0.95)
Seat 2: Z5ZtGOON8kmSdSCll9Z3XA (button) folded before Flop (didn't bet)
Seat 3: uLP/lYn7oKq9xCChBXsXxw (small blind) folded on the Flop
Seat 6: z5GxcHlYz/GSz6W2uFiTtg (big blind) folded on the Flop
Seat 7: opOCI2p6kW0tINuVaAqmcQ folded before Flop (didn't bet)
Seat 8: IeNTEKD96WqM7qU1RpSvOQ folded before Flop (didn't bet)
Seat 9: 5IeCaraAnS03/jUIjZQAig folded on the Flop




PokerStars Game #59939413702:  Hold'em No Limit ($0.10/$0.25) - 2009/07/01 0:39:15 ET
Table 'h3+tJ4Vtwq0R+eA8S73eZA' 9-max Seat #4 is the button
Seat 1: H5Se03ZqSX7tbULXur2MAg ($20.90 in chips) 
Seat 2: Th3FldXKQW6hWVVPahaoOQ ($27.40 in chips) 
Seat 3: crgjVDgmUqCw4RyLzbohWQ ($17 in chips) 
Seat 4: M2QO2DxB5Wawg2h8HSpnYA ($11.95 in chips) 
Seat 5: cZ99hugmLBj9KhTlc8nCSw ($31.55 in chips) 
Seat 6: TvIuLx9zUCE+9Li58iImOQ ($6.95 in chips) 
Seat 7: IIGtqtVGyvZR0ZMYMMPjeQ ($27 in chips) 
Seat 8: zWJ/yHAvi0TtCR9RMsJosQ ($24.75 in chips) 
Seat 9: qwr38jl5txoR36M7G5qi4A ($8.05 in chips) 
cZ99hugmLBj9KhTlc8nCSw: posts small blind $0.10
TvIuLx9zUCE+9Li58iImOQ: posts big blind $0.25
*** HOLE CARDS ***
IIGtqtVGyvZR0ZMYMMPjeQ: folds 
zWJ/yHAvi0TtCR9RMsJosQ: calls $0.25
qwr38jl5txoR36M7G5qi4A: folds 
H5Se03ZqSX7tbULXur2MAg: folds 
Th3FldXKQW6hWVVPahaoOQ: folds 
crgjVDgmUqCw4RyLzbohWQ: folds 
M2QO2DxB5Wawg2h8HSpnYA: folds 
cZ99hugmLBj9KhTlc8nCSw: folds 
TvIuLx9zUCE+9Li58iImOQ: checks 
*** FLOP *** [Kc 5s 5h]
TvIuLx9zUCE+9Li58iImOQ: checks 
zWJ/yHAvi0TtCR9RMsJosQ: bets $0.25
TvIuLx9zUCE+9Li58iImOQ: calls $0.25
*** TURN *** [Kc 5s 5h] [9d]
TvIuLx9zUCE+9Li58iImOQ: checks 
zWJ/yHAvi0TtCR9RMsJosQ: checks 
*** RIVER *** [Kc 5s 5h 9d] [Qc]
TvIuLx9zUCE+9Li58iImOQ: checks 
zWJ/yHAvi0TtCR9RMsJosQ: checks 
*** SHOW DOWN ***
TvIuLx9zUCE+9Li58iImOQ: shows [6s Qs] (two pair, Queens and Fives)
zWJ/yHAvi0TtCR9RMsJosQ: mucks hand 
TvIuLx9zUCE+9Li58iImOQ collected $1.05 from pot
*** SUMMARY ***
Total pot $1.10 | Rake $0.05 
Board [Kc 5s 5h 9d Qc]
Seat 1: H5Se03ZqSX7tbULXur2MAg folded before Flop (didn't bet)
Seat 2: Th3FldXKQW6hWVVPahaoOQ folded before Flop (didn't bet)
Seat 3: crgjVDgmUqCw4RyLzbohWQ folded before Flop (didn't bet)
Seat 4: M2QO2DxB5Wawg2h8HSpnYA (button) folded before Flop (didn't bet)
Seat 5: cZ99hugmLBj9KhTlc8nCSw (small blind) folded before Flop
Seat 6: TvIuLx9zUCE+9Li58iImOQ (big blind) showed [6s Qs] and won ($1.05) with two pair, Queens and Fives
Seat 7: IIGtqtVGyvZR0ZMYMMPjeQ folded before Flop (didn't bet)
Seat 8: zWJ/yHAvi0TtCR9RMsJosQ mucked
Seat 9: qwr38jl5txoR36M7G5qi4A folded before Flop (didn't bet)




PokerStars Game #59939413706:  Hold'em No Limit ($0.10/$0.25) - 2009/07/01 0:39:15 ET
Table 'NfXsh0UQA+o/kO9acV3WxA' 9-max Seat #5 is the button
Seat 1: H5Se03ZqSX7tbULXur2MAg ($24.30 in chips) 
Seat 2: 5/P8XWKnr8tBG9c+iHgFNA ($24 in chips) 
Seat 3: 1K6QGyJP9P9xmRac2fH4OQ ($37.45 in chips) 
Seat 4: sQ6szDwWrE+LMh1p4dVexA ($17.10 in chips) 
Seat 5: 3RCAkueG3Vc13VpRStCB+w ($36.40 in chips) 
Seat 6: jMfnkiGgGZI43Vhowb6MpA ($12.65 in chips) 
Seat 7: HPEB+AtKw1+C/cxU0o1ciw ($31.95 in chips) 
Seat 9: MgMavn/DzTzqKgHTZMsVSw ($25 in chips) 
jMfnkiGgGZI43Vhowb6MpA: posts small blind $0.10
HPEB+AtKw1+C/cxU0o1ciw: posts big blind $0.25
+sbyWwIcFp9kP0bDtMegfQ: sits out 
*** HOLE CARDS ***
MgMavn/DzTzqKgHTZMsVSw: folds 
H5Se03ZqSX7tbULXur2MAg: folds 
5/P8XWKnr8tBG9c+iHgFNA: folds 
1K6QGyJP9P9xmRac2fH4OQ: folds 
sQ6szDwWrE+LMh1p4dVexA: folds 
3RCAkueG3Vc13VpRStCB+w: raises $0.50 to $0.75
jMfnkiGgGZI43Vhowb6MpA: folds 
HPEB+AtKw1+C/cxU0o1ciw: folds 
Uncalled bet ($0.50) returned to 3RCAkueG3Vc13VpRStCB+w
3RCAkueG3Vc13VpRStCB+w collected $0.60 from pot
3RCAkueG3Vc13VpRStCB+w: doesn't show hand 
*** SUMMARY ***
Total pot $0.60 | Rake $0 
Seat 1: H5Se03ZqSX7tbULXur2MAg folded before Flop (didn't bet)
Seat 2: 5/P8XWKnr8tBG9c+iHgFNA folded before Flop (didn't bet)
Seat 3: 1K6QGyJP9P9xmRac2fH4OQ folded before Flop (didn't bet)
Seat 4: sQ6szDwWrE+LMh1p4dVexA folded before Flop (didn't bet)
Seat 5: 3RCAkueG3Vc13VpRStCB+w (button) collected ($0.60)
Seat 6: jMfnkiGgGZI43Vhowb6MpA (small blind) folded before Flop
Seat 7: HPEB+AtKw1+C/cxU0o1ciw (big blind) folded before Flop
Seat 9: MgMavn/DzTzqKgHTZMsVSw folded before Flop (didn't bet)




PokerStars Game #59939414120:  Hold'em No Limit ($0.10/$0.25) - 2009/07/01 0:39:15 ET
Table 'gHbubGDeVSkmB4vFiqIN3Q' 6-max Seat #2 is the button
Seat 1: kG34n23qFQA3nzdOJTQ1dA ($26.15 in chips) 
Seat 2: 8LzEWRhg4wk8Jh9CqDhH3Q ($3.75 in chips) 
Seat 4: v+QfkGiuj9bgtuNoVnDO8w ($32.60 in chips) 
Seat 6: wvIIdlbCgePONQwXjx9xzQ ($5 in chips) 
v+QfkGiuj9bgtuNoVnDO8w: posts small blind $0.10
wvIIdlbCgePONQwXjx9xzQ: posts big blind $0.25
*** HOLE CARDS ***
kG34n23qFQA3nzdOJTQ1dA: calls $0.25
8LzEWRhg4wk8Jh9CqDhH3Q: folds 
v+QfkGiuj9bgtuNoVnDO8w: folds 
wvIIdlbCgePONQwXjx9xzQ: checks 
*** FLOP *** [3c 6c 5d]
wvIIdlbCgePONQwXjx9xzQ: checks 
kG34n23qFQA3nzdOJTQ1dA: bets $0.50
wvIIdlbCgePONQwXjx9xzQ: folds 
Uncalled bet ($0.50) returned to kG34n23qFQA3nzdOJTQ1dA
8LzEWRhg4wk8Jh9CqDhH3Q said, "s"
kG34n23qFQA3nzdOJTQ1dA collected $0.60 from pot
*** SUMMARY ***
Total pot $0.60 | Rake $0 
Board [3c 6c 5d]
Seat 1: kG34n23qFQA3nzdOJTQ1dA collected ($0.60)
Seat 2: 8LzEWRhg4wk8Jh9CqDhH3Q (button) folded before Flop (didn't bet)
Seat 4: v+QfkGiuj9bgtuNoVnDO8w (small blind) folded before Flop
Seat 6: wvIIdlbCgePONQwXjx9xzQ (big blind) folded on the Flop




PokerStars Game #59939413832:  Hold'em No Limit ($0.10/$0.25) - 2009/07/01 0:39:15 ET
Table 'biAgO3TKQBU8XcrVAoU5TA' 6-max Seat #4 is the button
Seat 2: 7qRk4YH4/k/08LgJSv7rBQ ($25 in chips) 
Seat 3: 7AHdX4G8gYtDJyNY+wK+6Q ($30.65 in chips) 
Seat 4: 2/AObG8G5tKFCPZ+CdivJQ ($11.05 in chips) 
Seat 6: //i5P+6lSkIyZsqb+ojVQA ($14.25 in chips) 
//i5P+6lSkIyZsqb+ojVQA: posts small blind $0.10
7qRk4YH4/k/08LgJSv7rBQ: posts big blind $0.25
*** HOLE CARDS ***
7AHdX4G8gYtDJyNY+wK+6Q: folds 
2/AObG8G5tKFCPZ+CdivJQ: folds 
//i5P+6lSkIyZsqb+ojVQA: calls $0.15
7qRk4YH4/k/08LgJSv7rBQ: checks 
*** FLOP *** [Td 3h 5c]
//i5P+6lSkIyZsqb+ojVQA: checks 
7qRk4YH4/k/08LgJSv7rBQ: checks 
*** TURN *** [Td 3h 5c] [Ad]
//i5P+6lSkIyZsqb+ojVQA: checks 
7qRk4YH4/k/08LgJSv7rBQ: checks 
*** RIVER *** [Td 3h 5c Ad] [9c]
//i5P+6lSkIyZsqb+ojVQA: bets $0.25
7qRk4YH4/k/08LgJSv7rBQ: folds 
Uncalled bet ($0.25) returned to //i5P+6lSkIyZsqb+ojVQA
//i5P+6lSkIyZsqb+ojVQA collected $0.50 from pot
//i5P+6lSkIyZsqb+ojVQA: doesn't show hand 
*** SUMMARY ***
Total pot $0.50 | Rake $0 
Board [Td 3h 5c Ad 9c]
Seat 2: 7qRk4YH4/k/08LgJSv7rBQ (big blind) folded on the River
Seat 3: 7AHdX4G8gYtDJyNY+wK+6Q folded before Flop (didn't bet)
Seat 4: 2/AObG8G5tKFCPZ+CdivJQ (button) folded before Flop (didn't bet)
Seat 6: //i5P+6lSkIyZsqb+ojVQA (small blind) collected ($0.50)




PokerStars Game #59939414546:  Hold'em No Limit ($0.10/$0.25) - 2009/07/01 0:39:16 ET
Table 'zojWVNukhD2n8RTfHCOwwg' 9-max Seat #4 is the button
Seat 1: DIBbjEYGs+TVdVgEB/4+3w ($41.45 in chips) 
Seat 2: ZeR3hkj1gVv9J4yPCmRrjA ($27.35 in chips) 
Seat 3: 1esmRaxnod+zAkE+7BtzMA ($16.20 in chips) 
Seat 4: Pb7qJqn2QUbp+oYBNQxyyA ($25.65 in chips) 
Seat 6: 2xNcp4M2UG8Li2PMEnWcgA ($10.30 in chips) 
Seat 7: H5Se03ZqSX7tbULXur2MAg ($27.30 in chips) 
Seat 8: j4q3p0lesp63b1gZDwLBZw ($5 in chips) 
Seat 9: 4oA316mXLIui1QY63GXBUg ($25 in chips) 
2xNcp4M2UG8Li2PMEnWcgA: posts small blind $0.10
H5Se03ZqSX7tbULXur2MAg: posts big blind $0.25
*** HOLE CARDS ***
j4q3p0lesp63b1gZDwLBZw: folds 
4oA316mXLIui1QY63GXBUg: folds 
DIBbjEYGs+TVdVgEB/4+3w: folds 
ZeR3hkj1gVv9J4yPCmRrjA: folds 
1esmRaxnod+zAkE+7BtzMA: calls $0.25
Pb7qJqn2QUbp+oYBNQxyyA: raises $0.25 to $0.50
2xNcp4M2UG8Li2PMEnWcgA: folds 
H5Se03ZqSX7tbULXur2MAg: folds 
1esmRaxnod+zAkE+7BtzMA: calls $0.25
*** FLOP *** [Qh 3d 3s]
1esmRaxnod+zAkE+7BtzMA: checks 
Pb7qJqn2QUbp+oYBNQxyyA: bets $0.75
1esmRaxnod+zAkE+7BtzMA: folds 
Uncalled bet ($0.75) returned to Pb7qJqn2QUbp+oYBNQxyyA
Pb7qJqn2QUbp+oYBNQxyyA collected $1.30 from pot
Pb7qJqn2QUbp+oYBNQxyyA: doesn't show hand 
*** SUMMARY ***
Total pot $1.35 | Rake $0.05 
Board [Qh 3d 3s]
Seat 1: DIBbjEYGs+TVdVgEB/4+3w folded before Flop (didn't bet)
Seat 2: ZeR3hkj1gVv9J4yPCmRrjA folded before Flop (didn't bet)
Seat 3: 1esmRaxnod+zAkE+7BtzMA folded on the Flop
Seat 4: Pb7qJqn2QUbp+oYBNQxyyA (button) collected ($1.30)
Seat 6: 2xNcp4M2UG8Li2PMEnWcgA (small blind) folded before Flop
Seat 7: H5Se03ZqSX7tbULXur2MAg (big blind) folded before Flop
Seat 8: j4q3p0lesp63b1gZDwLBZw folded before Flop (didn't bet)
Seat 9: 4oA316mXLIui1QY63GXBUg folded before Flop (didn't bet)




PokerStars Game #59939414472:  Hold'em No Limit ($0.10/$0.25) - 2009/07/01 0:39:16 ET
Table 'KKk6y4pAXeymxYcd0uZLqg' 9-max Seat #9 is the button
Seat 1: HPEB+AtKw1+C/cxU0o1ciw ($24.65 in chips) 
Seat 3: 4oA316mXLIui1QY63GXBUg ($25 in chips) 
Seat 4: GTcLfsDTPqgfHyhY9FNDMw ($14.45 in chips) 
Seat 5: U0VVxBdRWdhRNdbJ+Qky1A ($46.10 in chips) 
Seat 6: LWN1wPrLH+695JIriXxDuw ($11.60 in chips) 
Seat 7: R3KkgiqTvuhazyCqaD9cZg ($10 in chips) 
Seat 8: +2kMBNpY4nF1qNCRd8SJLA ($26.10 in chips) 
Seat 9: j4q3p0lesp63b1gZDwLBZw ($5 in chips) 
HPEB+AtKw1+C/cxU0o1ciw: posts small blind $0.10
4oA316mXLIui1QY63GXBUg: posts big blind $0.25
*** HOLE CARDS ***
GTcLfsDTPqgfHyhY9FNDMw: raises $0.50 to $0.75
U0VVxBdRWdhRNdbJ+Qky1A: folds 
LWN1wPrLH+695JIriXxDuw: folds 
R3KkgiqTvuhazyCqaD9cZg: folds 
+2kMBNpY4nF1qNCRd8SJLA: folds 
j4q3p0lesp63b1gZDwLBZw: folds 
HPEB+AtKw1+C/cxU0o1ciw: folds 
4oA316mXLIui1QY63GXBUg: folds 
Uncalled bet ($0.50) returned to GTcLfsDTPqgfHyhY9FNDMw
GTcLfsDTPqgfHyhY9FNDMw collected $0.60 from pot
GTcLfsDTPqgfHyhY9FNDMw: doesn't show hand 
*** SUMMARY ***
Total pot $0.60 | Rake $0 
Seat 1: HPEB+AtKw1+C/cxU0o1ciw (small blind) folded before Flop
Seat 3: 4oA316mXLIui1QY63GXBUg (big blind) folded before Flop
Seat 4: GTcLfsDTPqgfHyhY9FNDMw collected ($0.60)
Seat 5: U0VVxBdRWdhRNdbJ+Qky1A folded before Flop (didn't bet)
Seat 6: LWN1wPrLH+695JIriXxDuw folded before Flop (didn't bet)
Seat 7: R3KkgiqTvuhazyCqaD9cZg folded before Flop (didn't bet)
Seat 8: +2kMBNpY4nF1qNCRd8SJLA folded before Flop (didn't bet)
Seat 9: j4q3p0lesp63b1gZDwLBZw (button) folded before Flop (didn't bet)




PokerStars Game #59939414664:  Hold'em No Limit ($0.10/$0.25) - 2009/07/01 0:39:16 ET
Table 'fHv1Mk7ZbLjprZTGWKPiEQ' 6-max Seat #4 is the button
Seat 1: nrBtxp+MnBtUJ1AIhZxHkg ($31.05 in chips) 
Seat 4: TSmua8tGK3sTbwi0ynrW9Q ($46.75 in chips) 
Seat 5: edio/rLJ06xeZOfLhoL3UA ($28.35 in chips) 
Seat 6: AjG0X+rNtc2W08eph8oqpw ($9.30 in chips) 
edio/rLJ06xeZOfLhoL3UA: posts small blind $0.10
AjG0X+rNtc2W08eph8oqpw: posts big blind $0.25
GINNAL-RASTA: sits out 
*** HOLE CARDS ***
nrBtxp+MnBtUJ1AIhZxHkg: folds 
HyeBXe7tNOZjTdX/zI0BZQ has returned
TSmua8tGK3sTbwi0ynrW9Q: folds 
edio/rLJ06xeZOfLhoL3UA: calls $0.15
AjG0X+rNtc2W08eph8oqpw: checks 
*** FLOP *** [4d 8h 7c]
edio/rLJ06xeZOfLhoL3UA: checks 
AjG0X+rNtc2W08eph8oqpw: checks 
*** TURN *** [4d 8h 7c] [Jd]
edio/rLJ06xeZOfLhoL3UA: bets $0.75
AjG0X+rNtc2W08eph8oqpw: folds 
Uncalled bet ($0.75) returned to edio/rLJ06xeZOfLhoL3UA
edio/rLJ06xeZOfLhoL3UA collected $0.50 from pot
edio/rLJ06xeZOfLhoL3UA: doesn't show hand 
*** SUMMARY ***
Total pot $0.50 | Rake $0 
Board [4d 8h 7c Jd]
Seat 1: nrBtxp+MnBtUJ1AIhZxHkg folded before Flop (didn't bet)
Seat 4: TSmua8tGK3sTbwi0ynrW9Q (button) folded before Flop (didn't bet)
Seat 5: edio/rLJ06xeZOfLhoL3UA (small blind) collected ($0.50)
Seat 6: AjG0X+rNtc2W08eph8oqpw (big blind) folded on the Turn




PokerStars Game #59939414778:  Hold'em No Limit ($0.10/$0.25) - 2009/07/01 0:39:16 ET
Table 'fvoGXKLawfAadYn02raohg' 9-max Seat #7 is the button
Seat 1: DIBbjEYGs+TVdVgEB/4+3w ($39.50 in chips) 
Seat 2: Ud3KoJmky17jahFh5jxdNA ($16 in chips) 
Seat 3: aNpwfA31EREwO+ar4XzBCw ($25 in chips) 
Seat 4: uibjYTUZq0zsChpZ84TeGQ ($14.10 in chips) 
Seat 5: 1Uq1Gp+AloSwO4jVgEdX+A ($25 in chips) 
Seat 6: SXqVW4Q0evTUVZG6BbUNIA ($31.25 in chips) 
Seat 7: 18G4P1XstjNvItdGUITxgw ($25.45 in chips) 
Seat 8: 4GJMmHGKzu+gVtalqRy7dA ($12.95 in chips) 
Seat 9: JKfTHkCJ+e5tjUU+K32h1A ($15.10 in chips) 
4GJMmHGKzu+gVtalqRy7dA: posts small blind $0.10
JKfTHkCJ+e5tjUU+K32h1A: posts big blind $0.25
*** HOLE CARDS ***
DIBbjEYGs+TVdVgEB/4+3w: folds 
Ud3KoJmky17jahFh5jxdNA: folds 
aNpwfA31EREwO+ar4XzBCw: folds 
uibjYTUZq0zsChpZ84TeGQ: raises $0.25 to $0.50
1Uq1Gp+AloSwO4jVgEdX+A: raises $1.50 to $2
SXqVW4Q0evTUVZG6BbUNIA: folds 
18G4P1XstjNvItdGUITxgw: folds 
4GJMmHGKzu+gVtalqRy7dA: folds 
JKfTHkCJ+e5tjUU+K32h1A: folds 
uibjYTUZq0zsChpZ84TeGQ: folds 
Uncalled bet ($1.50) returned to 1Uq1Gp+AloSwO4jVgEdX+A
1Uq1Gp+AloSwO4jVgEdX+A collected $1.35 from pot
1Uq1Gp+AloSwO4jVgEdX+A: doesn't show hand 
*** SUMMARY ***
Total pot $1.35 | Rake $0 
Seat 1: DIBbjEYGs+TVdVgEB/4+3w folded before Flop (didn't bet)
Seat 2: Ud3KoJmky17jahFh5jxdNA folded before Flop (didn't bet)
Seat 3: aNpwfA31EREwO+ar4XzBCw folded before Flop (didn't bet)
Seat 4: uibjYTUZq0zsChpZ84TeGQ folded before Flop
Seat 5: 1Uq1Gp+AloSwO4jVgEdX+A collected ($1.35)
Seat 6: SXqVW4Q0evTUVZG6BbUNIA folded before Flop (didn't bet)
Seat 7: 18G4P1XstjNvItdGUITxgw (button) folded before Flop (didn't bet)
Seat 8: 4GJMmHGKzu+gVtalqRy7dA (small blind) folded before Flop
Seat 9: JKfTHkCJ+e5tjUU+K32h1A (big blind) folded before Flop




PokerStars Game #59939414734:  Hold'em No Limit ($0.10/$0.25) - 2009/07/01 0:39:16 ET
Table '+198VWQSWBhYQOcizzuBkw' 6-max Seat #2 is the button
Seat 2: R6AGToFJQOYVZAjC2jXEKw ($29.05 in chips) 
Seat 3: BYxjLnV1/LL0aZcTbfAOvw ($27.35 in chips) 
Seat 4: TgDsTeCdLQt8kWbL00ByRA ($27.60 in chips) 
Seat 5: LtASJ9OlkqGrrUKGQlpGAw ($30.65 in chips) 
Seat 6: 7qRk4YH4/k/08LgJSv7rBQ ($30.55 in chips) 
BYxjLnV1/LL0aZcTbfAOvw: posts small blind $0.10
TgDsTeCdLQt8kWbL00ByRA: posts big blind $0.25
*** HOLE CARDS ***
LtASJ9OlkqGrrUKGQlpGAw: folds 
7qRk4YH4/k/08LgJSv7rBQ: raises $0.75 to $1
R6AGToFJQOYVZAjC2jXEKw: folds 
BYxjLnV1/LL0aZcTbfAOvw: folds 
TgDsTeCdLQt8kWbL00ByRA: folds 
Uncalled bet ($0.75) returned to 7qRk4YH4/k/08LgJSv7rBQ
7qRk4YH4/k/08LgJSv7rBQ collected $0.60 from pot
7qRk4YH4/k/08LgJSv7rBQ: doesn't show hand 
*** SUMMARY ***
Total pot $0.60 | Rake $0 
Seat 2: R6AGToFJQOYVZAjC2jXEKw (button) folded before Flop (didn't bet)
Seat 3: BYxjLnV1/LL0aZcTbfAOvw (small blind) folded before Flop
Seat 4: TgDsTeCdLQt8kWbL00ByRA (big blind) folded before Flop
Seat 5: LtASJ9OlkqGrrUKGQlpGAw folded before Flop (didn't bet)
Seat 6: 7qRk4YH4/k/08LgJSv7rBQ collected ($0.60)




PokerStars Game #59939414702:  Hold'em No Limit ($0.10/$0.25) - 2009/07/01 0:39:16 ET
Table 'AHkg4ChqzcMauBx6Qvz8Nw' 6-max Seat #4 is the button
Seat 2: /bjna2FTN7pPjqYGzmDE0Q ($22.05 in chips) 
Seat 3: Zi4SmoY9XJ0iI6ixiSZaWQ ($10 in chips) 
Seat 4: N7O9jUEx2YiQn1+yRYTHmw ($25.10 in chips) 
Seat 5: LtASJ9OlkqGrrUKGQlpGAw ($37.15 in chips) 
Seat 6: SFmT9ZsVopnukjvAzrxTRg ($53.40 in chips) 
LtASJ9OlkqGrrUKGQlpGAw: posts small blind $0.10
SFmT9ZsVopnukjvAzrxTRg: posts big blind $0.25
Zi4SmoY9XJ0iI6ixiSZaWQ: posts big blind $0.25
*** HOLE CARDS ***
/bjna2FTN7pPjqYGzmDE0Q: folds 
Zi4SmoY9XJ0iI6ixiSZaWQ: checks 
N7O9jUEx2YiQn1+yRYTHmw: raises $0.25 to $0.50
picmate joins the table at seat #1 
LtASJ9OlkqGrrUKGQlpGAw: folds 
SFmT9ZsVopnukjvAzrxTRg: folds 
Zi4SmoY9XJ0iI6ixiSZaWQ: calls $0.25
*** FLOP *** [Ts Kh 8d]
Zi4SmoY9XJ0iI6ixiSZaWQ: checks 
N7O9jUEx2YiQn1+yRYTHmw: bets $0.50
Zi4SmoY9XJ0iI6ixiSZaWQ: calls $0.50
*** TURN *** [Ts Kh 8d] [3d]
Zi4SmoY9XJ0iI6ixiSZaWQ: checks 
N7O9jUEx2YiQn1+yRYTHmw: checks 
*** RIVER *** [Ts Kh 8d 3d] [9d]
Zi4SmoY9XJ0iI6ixiSZaWQ: checks 
N7O9jUEx2YiQn1+yRYTHmw: bets $1
Zi4SmoY9XJ0iI6ixiSZaWQ: folds 
Uncalled bet ($1) returned to N7O9jUEx2YiQn1+yRYTHmw
N7O9jUEx2YiQn1+yRYTHmw collected $2.25 from pot
N7O9jUEx2YiQn1+yRYTHmw: doesn't show hand 
*** SUMMARY ***
Total pot $2.35 | Rake $0.10 
Board [Ts Kh 8d 3d 9d]
Seat 2: /bjna2FTN7pPjqYGzmDE0Q folded before Flop (didn't bet)
Seat 3: Zi4SmoY9XJ0iI6ixiSZaWQ folded on the River
Seat 4: N7O9jUEx2YiQn1+yRYTHmw (button) collected ($2.25)
Seat 5: LtASJ9OlkqGrrUKGQlpGAw (small blind) folded before Flop
Seat 6: SFmT9ZsVopnukjvAzrxTRg (big blind) folded before Flop




PokerStars Game #59939414822:  Hold'em No Limit ($0.10/$0.25) - 2009/07/01 0:39:16 ET
Table 'vFZR6Kf2Th5xBXT9brGW6A' 6-max Seat #5 is the button
Seat 1: xRkU4+naLuz7dEZFbOn9cw ($35.30 in chips) 
Seat 2: REnO5xiZ66YabxDXq2ncvA ($51.70 in chips) 
Seat 4: 79ID/ub1Pt/mDpCprVmOoA ($25.35 in chips) 
Seat 5: NhUN/JpAprdJeamFBgJH1w ($25.35 in chips) 
Seat 6: d0J1xuhsynEY81YHwAvJ5g ($25 in chips) 
d0J1xuhsynEY81YHwAvJ5g: posts small blind $0.10
xRkU4+naLuz7dEZFbOn9cw: posts big blind $0.25
*** HOLE CARDS ***
REnO5xiZ66YabxDXq2ncvA: folds 
79ID/ub1Pt/mDpCprVmOoA: raises $0.50 to $0.75
NhUN/JpAprdJeamFBgJH1w: folds 
d0J1xuhsynEY81YHwAvJ5g: folds 
xRkU4+naLuz7dEZFbOn9cw: folds 
Uncalled bet ($0.50) returned to 79ID/ub1Pt/mDpCprVmOoA
79ID/ub1Pt/mDpCprVmOoA collected $0.60 from pot
79ID/ub1Pt/mDpCprVmOoA: doesn't show hand 
*** SUMMARY ***
Total pot $0.60 | Rake $0 
Seat 1: xRkU4+naLuz7dEZFbOn9cw (big blind) folded before Flop
Seat 2: REnO5xiZ66YabxDXq2ncvA folded before Flop (didn't bet)
Seat 4: 79ID/ub1Pt/mDpCprVmOoA collected ($0.60)
Seat 5: NhUN/JpAprdJeamFBgJH1w (button) folded before Flop (didn't bet)
Seat 6: d0J1xuhsynEY81YHwAvJ5g (small blind) folded before Flop




PokerStars Game #59939414498:  Hold'em No Limit ($0.10/$0.25) - 2009/07/01 0:39:16 ET
Table 'nyTW9cVtYentc5V7xU/0jA' 6-max Seat #2 is the button
Seat 1: YfxPRDAWfqnGBhiIEdlTYg ($12 in chips) 
Seat 2: 7FmwVDcdEtxDpHmP4hOXsQ ($25 in chips) 
Seat 3: kG34n23qFQA3nzdOJTQ1dA ($24.65 in chips) 
Seat 4: r6u7MWSXF30/khcTYkrG9Q ($36.85 in chips) 
Seat 5: BedjMfrlRfPgSq7CXpPAmg ($25 in chips) 
Seat 6: dQJByDqHOLbgqX/HobyAJA ($7.75 in chips) 
kG34n23qFQA3nzdOJTQ1dA: posts small blind $0.10
r6u7MWSXF30/khcTYkrG9Q: posts big blind $0.25
*** HOLE CARDS ***
BedjMfrlRfPgSq7CXpPAmg: folds 
dQJByDqHOLbgqX/HobyAJA: folds 
YfxPRDAWfqnGBhiIEdlTYg: calls $0.25
7FmwVDcdEtxDpHmP4hOXsQ: folds 
kG34n23qFQA3nzdOJTQ1dA: folds 
r6u7MWSXF30/khcTYkrG9Q: checks 
*** FLOP *** [6d Ac 8h]
r6u7MWSXF30/khcTYkrG9Q: checks 
YfxPRDAWfqnGBhiIEdlTYg: checks 
*** TURN *** [6d Ac 8h] [Ah]
r6u7MWSXF30/khcTYkrG9Q: checks 
YfxPRDAWfqnGBhiIEdlTYg: checks 
*** RIVER *** [6d Ac 8h Ah] [8d]
r6u7MWSXF30/khcTYkrG9Q: checks 
YfxPRDAWfqnGBhiIEdlTYg: checks 
*** SHOW DOWN ***
r6u7MWSXF30/khcTYkrG9Q: shows [Th Js] (two pair, Aces and Eights)
YfxPRDAWfqnGBhiIEdlTYg: shows [9s Jd] (two pair, Aces and Eights)
r6u7MWSXF30/khcTYkrG9Q collected $0.30 from pot
YfxPRDAWfqnGBhiIEdlTYg collected $0.30 from pot
*** SUMMARY ***
Total pot $0.60 | Rake $0 
Board [6d Ac 8h Ah 8d]
Seat 1: YfxPRDAWfqnGBhiIEdlTYg showed [9s Jd] and won ($0.30) with two pair, Aces and Eights
Seat 2: 7FmwVDcdEtxDpHmP4hOXsQ (button) folded before Flop (didn't bet)
Seat 3: kG34n23qFQA3nzdOJTQ1dA (small blind) folded before Flop
Seat 4: r6u7MWSXF30/khcTYkrG9Q (big blind) showed [Th Js] and won ($0.30) with two pair, Aces and Eights
Seat 5: BedjMfrlRfPgSq7CXpPAmg folded before Flop (didn't bet)
Seat 6: dQJByDqHOLbgqX/HobyAJA folded before Flop (didn't bet)




PokerStars Game #59939414376:  Hold'em No Limit ($0.10/$0.25) - 2009/07/01 0:39:16 ET
Table '2AUmC2Rslg+QUbLfdgNdfg' 6-max Seat #5 is the button
Seat 1: lgP2sg9oZJsNSXCt7tbwRg ($16.60 in chips) 
Seat 2: CCxAG7iPVlAv3brCqrGBEg ($14.75 in chips) 
Seat 3: iauW7L/+7qzAuHow7CD75Q ($5.30 in chips) 
Seat 4: B6R6e73iyJNddUtXtvYr3Q ($47.95 in chips) 
Seat 5: 8ClCHtFXGNplITm+63KB+Q ($22.95 in chips) 
Seat 6: BvTq4Tu0zBOsniW3eFCnkQ ($32.90 in chips) 
BvTq4Tu0zBOsniW3eFCnkQ: posts small blind $0.10
lgP2sg9oZJsNSXCt7tbwRg: posts big blind $0.25
*** HOLE CARDS ***
CCxAG7iPVlAv3brCqrGBEg: calls $0.25
iauW7L/+7qzAuHow7CD75Q: calls $0.25
B6R6e73iyJNddUtXtvYr3Q: folds 
8ClCHtFXGNplITm+63KB+Q: folds 
BvTq4Tu0zBOsniW3eFCnkQ: folds 
lgP2sg9oZJsNSXCt7tbwRg: checks 
*** FLOP *** [8h 7s Qd]
lgP2sg9oZJsNSXCt7tbwRg: checks 
CCxAG7iPVlAv3brCqrGBEg: checks 
iauW7L/+7qzAuHow7CD75Q: bets $0.75
lgP2sg9oZJsNSXCt7tbwRg: folds 
CCxAG7iPVlAv3brCqrGBEg: calls $0.75
*** TURN *** [8h 7s Qd] [Tc]
CCxAG7iPVlAv3brCqrGBEg: checks 
iauW7L/+7qzAuHow7CD75Q: bets $1
CCxAG7iPVlAv3brCqrGBEg: calls $1
*** RIVER *** [8h 7s Qd Tc] [7d]
CCxAG7iPVlAv3brCqrGBEg: checks 
iauW7L/+7qzAuHow7CD75Q: checks 
*** SHOW DOWN ***
CCxAG7iPVlAv3brCqrGBEg: shows [5s 6s] (a pair of Sevens)
iauW7L/+7qzAuHow7CD75Q: shows [3h Qs] (two pair, Queens and Sevens)
iauW7L/+7qzAuHow7CD75Q collected $4.15 from pot
*** SUMMARY ***
Total pot $4.35 | Rake $0.20 
Board [8h 7s Qd Tc 7d]
Seat 1: lgP2sg9oZJsNSXCt7tbwRg (big blind) folded on the Flop
Seat 2: CCxAG7iPVlAv3brCqrGBEg showed [5s 6s] and lost with a pair of Sevens
Seat 3: iauW7L/+7qzAuHow7CD75Q showed [3h Qs] and won ($4.15) with two pair, Queens and Sevens
Seat 4: B6R6e73iyJNddUtXtvYr3Q folded before Flop (didn't bet)
Seat 5: 8ClCHtFXGNplITm+63KB+Q (button) folded before Flop (didn't bet)
Seat 6: BvTq4Tu0zBOsniW3eFCnkQ (small blind) folded before Flop




PokerStars Game #59939414782:  Hold'em No Limit ($0.10/$0.25) - 2009/07/01 0:39:16 ET
Table 'b64Z+5XI1xkQzNfq4QHr3A' 6-max Seat #6 is the button
Seat 1: qccGLncfUaN00Few5HsgYg ($50.55 in chips) 
Seat 2: SS/yfeArhULzIcOPe8MdPg ($34.75 in chips) 
Seat 3: u/yN5P9f3KlATg6WLWNkBQ ($25 in chips) 
Seat 4: SxIIgwXYLkwd6m3wLyPTCw ($25 in chips) 
Seat 5: d0J1xuhsynEY81YHwAvJ5g ($33.25 in chips) 
Seat 6: 8ClCHtFXGNplITm+63KB+Q ($38.35 in chips) 
qccGLncfUaN00Few5HsgYg: posts small blind $0.10
SS/yfeArhULzIcOPe8MdPg: posts big blind $0.25
u/yN5P9f3KlATg6WLWNkBQ: posts big blind $0.25
*** HOLE CARDS ***
u/yN5P9f3KlATg6WLWNkBQ: checks 
SxIIgwXYLkwd6m3wLyPTCw: folds 
d0J1xuhsynEY81YHwAvJ5g: folds 
8ClCHtFXGNplITm+63KB+Q: folds 
qccGLncfUaN00Few5HsgYg: raises $0.50 to $0.75
SS/yfeArhULzIcOPe8MdPg: folds 
u/yN5P9f3KlATg6WLWNkBQ: calls $0.50
*** FLOP *** [Kc Jd 4c]
qccGLncfUaN00Few5HsgYg: bets $1
u/yN5P9f3KlATg6WLWNkBQ: raises $2.50 to $3.50
qccGLncfUaN00Few5HsgYg: raises $46.30 to $49.80 and is all-in
u/yN5P9f3KlATg6WLWNkBQ: folds 
Uncalled bet ($46.30) returned to qccGLncfUaN00Few5HsgYg
qccGLncfUaN00Few5HsgYg collected $8.35 from pot
*** SUMMARY ***
Total pot $8.75 | Rake $0.40 
Board [Kc Jd 4c]
Seat 1: qccGLncfUaN00Few5HsgYg (small blind) collected ($8.35)
Seat 2: SS/yfeArhULzIcOPe8MdPg (big blind) folded before Flop
Seat 3: u/yN5P9f3KlATg6WLWNkBQ folded on the Flop
Seat 4: SxIIgwXYLkwd6m3wLyPTCw folded before Flop (didn't bet)
Seat 5: d0J1xuhsynEY81YHwAvJ5g folded before Flop (didn't bet)
Seat 6: 8ClCHtFXGNplITm+63KB+Q (button) folded before Flop (didn't bet)




PokerStars Game #59939414886:  Hold'em No Limit ($0.10/$0.25) - 2009/07/01 0:39:16 ET
Table 'xmJKTGBeWCwutccj3YfupQ' 6-max Seat #6 is the button
Seat 1: sVbkVl4OznxBCfi66UB9vw ($60.20 in chips) 
Seat 2: BedjMfrlRfPgSq7CXpPAmg ($48.80 in chips) 
Seat 3: FStoHe64SQWqAsjya9pDkQ ($25 in chips) 
Seat 4: uWjhTVMpuIroxXcmD3Okug ($41.90 in chips) 
Seat 5: oBUDUfeUyCbZBsjxHZgSiw ($18.05 in chips) 
Seat 6: lYjWCpfCxX2kgcHY3v4Yow ($26 in chips) 
sVbkVl4OznxBCfi66UB9vw: posts small blind $0.10
BedjMfrlRfPgSq7CXpPAmg: posts big blind $0.25
*** HOLE CARDS ***
FStoHe64SQWqAsjya9pDkQ: folds 
sVbkVl4OznxBCfi66UB9vw said, "punishment for what?"
uWjhTVMpuIroxXcmD3Okug: folds 
oBUDUfeUyCbZBsjxHZgSiw: folds 
lYjWCpfCxX2kgcHY3v4Yow: folds 
sVbkVl4OznxBCfi66UB9vw: raises $0.25 to $0.50
BedjMfrlRfPgSq7CXpPAmg: folds 
Uncalled bet ($0.25) returned to sVbkVl4OznxBCfi66UB9vw
sVbkVl4OznxBCfi66UB9vw collected $0.50 from pot
sVbkVl4OznxBCfi66UB9vw: doesn't show hand 
*** SUMMARY ***
Total pot $0.50 | Rake $0 
Seat 1: sVbkVl4OznxBCfi66UB9vw (small blind) collected ($0.50)
Seat 2: BedjMfrlRfPgSq7CXpPAmg (big blind) folded before Flop
Seat 3: FStoHe64SQWqAsjya9pDkQ folded before Flop (didn't bet)
Seat 4: uWjhTVMpuIroxXcmD3Okug folded before Flop (didn't bet)
Seat 5: oBUDUfeUyCbZBsjxHZgSiw folded before Flop (didn't bet)
Seat 6: lYjWCpfCxX2kgcHY3v4Yow (button) folded before Flop (didn't bet)




PokerStars Game #59939415246:  Hold'em No Limit ($0.10/$0.25) - 2009/07/01 0:39:17 ET
Table 'nB7Q7zfNfy6ig6DB+rsgWQ' 6-max Seat #1 is the button
Seat 1: ACU3rO57RhDJfAgHTq2ocA ($4.35 in chips) 
Seat 2: g6kf+5FIgWH33PmH6ZecMQ ($14.25 in chips) 
Seat 3: p3NYOxYhkL7txPRSeXHDeg ($35.10 in chips) 
Seat 4: YZjG5I7FqwMKy06BKVBS7w ($10.80 in chips) 
Seat 5: X0/5h4o4LdHWlM7o/9shzg ($7.30 in chips) 
Seat 6: BYxjLnV1/LL0aZcTbfAOvw ($38.40 in chips) 
g6kf+5FIgWH33PmH6ZecMQ: posts small blind $0.10
p3NYOxYhkL7txPRSeXHDeg: posts big blind $0.25
*** HOLE CARDS ***
YZjG5I7FqwMKy06BKVBS7w: calls $0.25
X0/5h4o4LdHWlM7o/9shzg: folds 
BYxjLnV1/LL0aZcTbfAOvw: raises $1 to $1.25
ACU3rO57RhDJfAgHTq2ocA: folds 
g6kf+5FIgWH33PmH6ZecMQ: folds 
p3NYOxYhkL7txPRSeXHDeg: folds 
YZjG5I7FqwMKy06BKVBS7w: calls $1
*** FLOP *** [Kh Kc Qs]
YZjG5I7FqwMKy06BKVBS7w: checks 
BYxjLnV1/LL0aZcTbfAOvw: checks 
*** TURN *** [Kh Kc Qs] [Kd]
YZjG5I7FqwMKy06BKVBS7w: checks 
BYxjLnV1/LL0aZcTbfAOvw: checks 
*** RIVER *** [Kh Kc Qs Kd] [6c]
YZjG5I7FqwMKy06BKVBS7w: checks 
BYxjLnV1/LL0aZcTbfAOvw: checks 
*** SHOW DOWN ***
YZjG5I7FqwMKy06BKVBS7w: shows [7h Th] (three of a kind, Kings)
BYxjLnV1/LL0aZcTbfAOvw: shows [Jd 9d] (three of a kind, Kings - Queen+Jack kicker)
BYxjLnV1/LL0aZcTbfAOvw collected $2.75 from pot
YZjG5I7FqwMKy06BKVBS7w said, "lol"
*** SUMMARY ***
Total pot $2.85 | Rake $0.10 
Board [Kh Kc Qs Kd 6c]
Seat 1: ACU3rO57RhDJfAgHTq2ocA (button) folded before Flop (didn't bet)
Seat 2: g6kf+5FIgWH33PmH6ZecMQ (small blind) folded before Flop
Seat 3: p3NYOxYhkL7txPRSeXHDeg (big blind) folded before Flop
Seat 4: YZjG5I7FqwMKy06BKVBS7w showed [7h Th] and lost with three of a kind, Kings
Seat 5: X0/5h4o4LdHWlM7o/9shzg folded before Flop (didn't bet)
Seat 6: BYxjLnV1/LL0aZcTbfAOvw showed [Jd 9d] and won ($2.75) with three of a kind, Kings




PokerStars Game #59939415372:  Hold'em No Limit ($0.10/$0.25) - 2009/07/01 0:39:17 ET
Table 'zW+7jPbOLCvlPu+dUGY5WQ' 6-max Seat #6 is the button
Seat 1: JE/wJXmjw3bpdmjwvh2pcg ($24.40 in chips) 
Seat 3: BedjMfrlRfPgSq7CXpPAmg ($64.10 in chips) 
Seat 4: Qv4VzEkN09uD11sjKv02Ig ($37.20 in chips) 
Seat 5: SFmT9ZsVopnukjvAzrxTRg ($51.70 in chips) 
Seat 6: BiLBinPhgpKAYzLgKJVU5A ($21.60 in chips) 
JE/wJXmjw3bpdmjwvh2pcg: posts small blind $0.10
BedjMfrlRfPgSq7CXpPAmg: posts big blind $0.25
*** HOLE CARDS ***
Qv4VzEkN09uD11sjKv02Ig: folds 
SFmT9ZsVopnukjvAzrxTRg: folds 
BiLBinPhgpKAYzLgKJVU5A: folds 
m/Xj2OoEbtQwxafkW0taNw leaves the table
JE/wJXmjw3bpdmjwvh2pcg: raises $1.25 to $1.50
BedjMfrlRfPgSq7CXpPAmg: folds 
Uncalled bet ($1.25) returned to JE/wJXmjw3bpdmjwvh2pcg
JE/wJXmjw3bpdmjwvh2pcg collected $0.50 from pot
JE/wJXmjw3bpdmjwvh2pcg: doesn't show hand 
*** SUMMARY ***
Total pot $0.50 | Rake $0 
Seat 1: JE/wJXmjw3bpdmjwvh2pcg (small blind) collected ($0.50)
Seat 3: BedjMfrlRfPgSq7CXpPAmg (big blind) folded before Flop
Seat 4: Qv4VzEkN09uD11sjKv02Ig folded before Flop (didn't bet)
Seat 5: SFmT9ZsVopnukjvAzrxTRg folded before Flop (didn't bet)
Seat 6: BiLBinPhgpKAYzLgKJVU5A (button) folded before Flop (didn't bet)




PokerStars Game #59939415506:  Hold'em No Limit ($0.10/$0.25) - 2009/07/01 0:39:17 ET
Table 'HzFR0rxmDAPu5GzYR0AlYg' 6-max Seat #1 is the button
Seat 1: v+QfkGiuj9bgtuNoVnDO8w ($25 in chips) 
Seat 2: UA5OsKS3VPaxa7uC8La/kA ($52.70 in chips) 
Seat 3: lfAPI6VglUPipZe8BpDaTA ($24.85 in chips) 
Seat 4: uy9x0X5l7O+IpGjLa77QgQ ($60.40 in chips) 
Seat 5: I1TxPvWj8NfG8orglCinNA ($25 in chips) 
uy9x0X5l7O+IpGjLa77QgQ said, "you think I'll tell you that?"
UA5OsKS3VPaxa7uC8La/kA: posts small blind $0.10
lfAPI6VglUPipZe8BpDaTA: posts big blind $0.25
*** HOLE CARDS ***
uy9x0X5l7O+IpGjLa77QgQ: folds 
mike czar said, "y not?"
I1TxPvWj8NfG8orglCinNA: folds 
mike czar said, "teach me a lesson"
v+QfkGiuj9bgtuNoVnDO8w: folds 
UA5OsKS3VPaxa7uC8La/kA: folds 
Uncalled bet ($0.15) returned to lfAPI6VglUPipZe8BpDaTA
UA5OsKS3VPaxa7uC8La/kA said, "lessons are extra"
lfAPI6VglUPipZe8BpDaTA collected $0.20 from pot
*** SUMMARY ***
Total pot $0.20 | Rake $0 
Seat 1: v+QfkGiuj9bgtuNoVnDO8w (button) folded before Flop (didn't bet)
Seat 2: UA5OsKS3VPaxa7uC8La/kA (small blind) folded before Flop
Seat 3: lfAPI6VglUPipZe8BpDaTA (big blind) collected ($0.20)
Seat 4: uy9x0X5l7O+IpGjLa77QgQ folded before Flop (didn't bet)
Seat 5: I1TxPvWj8NfG8orglCinNA folded before Flop (didn't bet)




PokerStars Game #59939415464:  Hold'em No Limit ($0.10/$0.25) - 2009/07/01 0:39:17 ET
Table 'NtEQAxCeIK2io1CGtW658g' 6-max Seat #5 is the button
Seat 1: lnOV7k25gyN7L5t5YKTgIg ($20.50 in chips) 
Seat 2: nc79pm0LZRdhncq55evVqA ($25.90 in chips) 
Seat 4: 8296 ($12 in chips) 
Seat 5: FStoHe64SQWqAsjya9pDkQ ($27.85 in chips) 
Seat 6: /gJNBeCkWL4o85/jvlZ4BA ($62.10 in chips) 
/gJNBeCkWL4o85/jvlZ4BA: posts small blind $0.10
lnOV7k25gyN7L5t5YKTgIg: posts big blind $0.25
m2yWOKfAxqHoy5DDN87Ttw: sits out 
*** HOLE CARDS ***
nc79pm0LZRdhncq55evVqA: folds 
8296: folds 
FStoHe64SQWqAsjya9pDkQ: folds 
/gJNBeCkWL4o85/jvlZ4BA: folds 
Uncalled bet ($0.15) returned to lnOV7k25gyN7L5t5YKTgIg
lnOV7k25gyN7L5t5YKTgIg collected $0.20 from pot
lnOV7k25gyN7L5t5YKTgIg: doesn't show hand 
*** SUMMARY ***
Total pot $0.20 | Rake $0 
Seat 1: lnOV7k25gyN7L5t5YKTgIg (big blind) collected ($0.20)
Seat 2: nc79pm0LZRdhncq55evVqA folded before Flop (didn't bet)
Seat 4: 8296 folded before Flop (didn't bet)
Seat 5: FStoHe64SQWqAsjya9pDkQ (button) folded before Flop (didn't bet)
Seat 6: /gJNBeCkWL4o85/jvlZ4BA (small blind) folded before Flop




PokerStars Game #59939415588:  Hold'em No Limit ($0.10/$0.25) - 2009/07/01 0:39:17 ET
Table 'dYNvO8G5kw5SRxb1Dljhogz2yOdY2zyGWG1gh9WV9XtQ Seat #3 is the button
Seat 1: Z3dcuTANgdUb/J4unoGPFQ ($16.35 in chips) 
Seat 2: vEBWvFD+KUWgDBKZKvA3SA ($5 in chips) 
Seat 3: 1Cs1GyQcoM1omwY7XZ3uRg ($15.35 in chips) 
Seat 5: W7XGvw6ngGVq2hFwXk8Myg ($15.45 in chips) 
Seat 7: DiSvPC2iudwL5j9u6Huyww ($25.50 in chips) 
Seat 8: 5hAPbqNrvJb8PtLiceXtlg6HoFYfVGBefsR5Vrz62qIw4.75 in chips) 
Seat 9: sUVgUtgbfVx6JpvApozwhQ ($5 in chips) 
sD+TKtt36XiiN6jqHiLwDA will be allowed to play after the button
W7XGvw6ngGVq2hFwXk8Myg: posts small blind $0.10
uH1RN27w9SKa7TpVR9EFrQ: is sitting out 
DiSvPC2iudwL5j9u6Huyww: posts big blind $0.25
vEBWvFD+KUWgDBKZKvA3SA: posts big blind $0.25
*** HOLE CARDS ***
uH1RN27w9SKa7TpVR9EFrQ has returned
5hAPbqNrvJb8PtLiceXtlg6HoFYfVGBefsR5Vrz62qIwlds 
sUVgUtgbfVx6JpvApozwhQ: folds 
Z3dcuTANgdUb/J4unoGPFQ: folds 
vEBWvFD+KUWgDBKZKvA3SA: checks 
1Cs1GyQcoM1omwY7XZ3uRg: calls $0.25
W7XGvw6ngGVq2hFwXk8Myg: calls $0.15
DiSvPC2iudwL5j9u6Huyww: checks 
*** FLOP *** [Ah Ts Jd]
W7XGvw6ngGVq2hFwXk8Myg: checks 
DiSvPC2iudwL5j9u6Huyww: checks 
vEBWvFD+KUWgDBKZKvA3SA: checks 
1Cs1GyQcoM1omwY7XZ3uRg: checks 
*** TURN *** [Ah Ts Jd] [5c]
W7XGvw6ngGVq2hFwXk8Myg: bets $0.25
DiSvPC2iudwL5j9u6Huyww: folds 
vEBWvFD+KUWgDBKZKvA3SA: calls $0.25
1Cs1GyQcoM1omwY7XZ3uRg: folds 
*** RIVER *** [Ah Ts Jd 5c] [8h]
W7XGvw6ngGVq2hFwXk8Myg: checks 
vEBWvFD+KUWgDBKZKvA3SA: checks 
*** SHOW DOWN ***
W7XGvw6ngGVq2hFwXk8Myg: shows [Th 7s] (a pair of Tens)
vEBWvFD+KUWgDBKZKvA3SA: mucks hand 
W7XGvw6ngGVq2hFwXk8Myg collected $1.45 from pot
*** SUMMARY ***
Total pot $1.50 | Rake $0.05 
Board [Ah Ts Jd 5c 8h]
Seat 1: Z3dcuTANgdUb/J4unoGPFQ folded before Flop (didn't bet)
Seat 2: vEBWvFD+KUWgDBKZKvA3SA mucked
Seat 3: 1Cs1GyQcoM1omwY7XZ3uRg (button) folded on the Turn
Seat 5: W7XGvw6ngGVq2hFwXk8Myg (small blind) showed [Th 7s] and won ($1.45) with a pair of Tens
Seat 7: DiSvPC2iudwL5j9u6Huyww (big blind) folded on the Turn
Seat 8: 5hAPbqNrvJb8PtLiceXtlg6HoFYfVGBefsR5Vrz62qIwded before Flop (didn't bet)
Seat 9: sUVgUtgbfVx6JpvApozwhQ folded before Flop (didn't bet)




PokerStars Game #59939415276:  Hold'em No Limit ($0.10/$0.25) - 2009/07/01 0:39:17 ET
Table 'vud0GB/ZlDCvUFhBFIaTlg' 9-max Seat #5 is the button
Seat 5: AwAabNdwDsTMb3aTomdOmg ($5.30 in chips) 
Seat 7: RzaVufWfW9CTnVYR7/Ge+w ($3.05 in chips) 
AwAabNdwDsTMb3aTomdOmg: posts small blind $0.10
RzaVufWfW9CTnVYR7/Ge+w: posts big blind $0.25
*** HOLE CARDS ***
AwAabNdwDsTMb3aTomdOmg: calls $0.15
RzaVufWfW9CTnVYR7/Ge+w: checks 
*** FLOP *** [As 2d 8d]
RzaVufWfW9CTnVYR7/Ge+w: bets $0.25
AwAabNdwDsTMb3aTomdOmg: raises $0.25 to $0.50
RzaVufWfW9CTnVYR7/Ge+w: calls $0.25
*** TURN *** [As 2d 8d] [6h]
RzaVufWfW9CTnVYR7/Ge+w: bets $0.25
AwAabNdwDsTMb3aTomdOmg: raises $0.25 to $0.50
RzaVufWfW9CTnVYR7/Ge+w: calls $0.25
*** RIVER *** [As 2d 8d 6h] [7s]
RzaVufWfW9CTnVYR7/Ge+w: checks 
AwAabNdwDsTMb3aTomdOmg: bets $1.25
RzaVufWfW9CTnVYR7/Ge+w: folds 
Uncalled bet ($1.25) returned to AwAabNdwDsTMb3aTomdOmg
AwAabNdwDsTMb3aTomdOmg collected $2.40 from pot
*** SUMMARY ***
Total pot $2.50 | Rake $0.10 
Board [As 2d 8d 6h 7s]
Seat 5: AwAabNdwDsTMb3aTomdOmg (button) (small blind) collected ($2.40)
Seat 7: RzaVufWfW9CTnVYR7/Ge+w (big blind) folded on the River




PokerStars Game #59939415114:  Hold'em No Limit ($0.10/$0.25) - 2009/07/01 0:39:17 ET
Table 'rtxA1Y01Nrq5VoyzTAuusQ' 9-max Seat #4 is the button
Seat 1: wfJUJWKI2zkvL7Vp7kqggA ($10 in chips) 
Seat 2: xtpoxBFB+5CWL2iFqk9Zlg ($35.10 in chips) 
Seat 3: K9fS1IUr5GpiJG7VkJ7IbA ($12.30 in chips) 
Seat 4: JxpnpCmvRAcrEUy7mq1iAg ($5 in chips) 
Seat 5: HG/hVrkvCiG0erBa6RyLZA ($13.75 in chips) 
Seat 6: qccGLncfUaN00Few5HsgYg ($24.65 in chips) 
Seat 7: N6fYvIzQLKaydFLKQGtMlQ ($24.30 in chips) 
Seat 8: EUSBQy2KGzT65/CXiIu59Q ($40.40 in chips) 
Seat 9: HPEB+AtKw1+C/cxU0o1ciw ($24.60 in chips) 
HG/hVrkvCiG0erBa6RyLZA: posts small blind $0.10
qccGLncfUaN00Few5HsgYg: posts big blind $0.25
*** HOLE CARDS ***
N6fYvIzQLKaydFLKQGtMlQ: raises $1 to $1.25
EUSBQy2KGzT65/CXiIu59Q: folds 
HPEB+AtKw1+C/cxU0o1ciw: folds 
wfJUJWKI2zkvL7Vp7kqggA: folds 
xtpoxBFB+5CWL2iFqk9Zlg: calls $1.25
K9fS1IUr5GpiJG7VkJ7IbA: folds 
JxpnpCmvRAcrEUy7mq1iAg: folds 
HG/hVrkvCiG0erBa6RyLZA: folds 
qccGLncfUaN00Few5HsgYg: calls $1
*** FLOP *** [5h 3d 2h]
qccGLncfUaN00Few5HsgYg: checks 
N6fYvIzQLKaydFLKQGtMlQ: checks 
xtpoxBFB+5CWL2iFqk9Zlg: bets $1.25
qccGLncfUaN00Few5HsgYg: folds 
N6fYvIzQLKaydFLKQGtMlQ: folds 
Uncalled bet ($1.25) returned to xtpoxBFB+5CWL2iFqk9Zlg
xtpoxBFB+5CWL2iFqk9Zlg collected $3.70 from pot
*** SUMMARY ***
Total pot $3.85 | Rake $0.15 
Board [5h 3d 2h]
Seat 1: wfJUJWKI2zkvL7Vp7kqggA folded before Flop (didn't bet)
Seat 2: xtpoxBFB+5CWL2iFqk9Zlg collected ($3.70)
Seat 3: K9fS1IUr5GpiJG7VkJ7IbA folded before Flop (didn't bet)
Seat 4: JxpnpCmvRAcrEUy7mq1iAg (button) folded before Flop (didn't bet)
Seat 5: HG/hVrkvCiG0erBa6RyLZA (small blind) folded before Flop
Seat 6: qccGLncfUaN00Few5HsgYg (big blind) folded on the Flop
Seat 7: N6fYvIzQLKaydFLKQGtMlQ folded on the Flop
Seat 8: EUSBQy2KGzT65/CXiIu59Q folded before Flop (didn't bet)
Seat 9: HPEB+AtKw1+C/cxU0o1ciw folded before Flop (didn't bet)




PokerStars Game #59939415512:  Hold'em No Limit ($0.10/$0.25) - 2009/07/01 0:39:17 ET
Table '9lYs7ljXi6AgFAxYHlKLJw' 9-max Seat #8 is the button
Seat 2: N6fYvIzQLKaydFLKQGtMlQ ($21.40 in chips) 
Seat 3: DnDcAdn9P0zGovMERigpFA ($27.85 in chips) 
Seat 4: UANt6y/SmDCY/jIxkBixcw ($30 in chips) 
Seat 5: dfNim92Z6XK1/h5SFW5vDg ($55.55 in chips) 
Seat 6: JtVGnq5doRa3PublncR+Yw ($20.45 in chips) 
Seat 7: ghNKXUBl/H+t83JF079ZBA ($30.10 in chips) 
Seat 8: Do7fcCjAx0vINJYUXuFoyA ($20.60 in chips) 
Seat 9: 18G4P1XstjNvItdGUITxgw ($26.40 in chips) 
18G4P1XstjNvItdGUITxgw: posts small blind $0.10
N6fYvIzQLKaydFLKQGtMlQ: posts big blind $0.25
*** HOLE CARDS ***
DnDcAdn9P0zGovMERigpFA has timed out
DnDcAdn9P0zGovMERigpFA: folds 
DnDcAdn9P0zGovMERigpFA is sitting out
UANt6y/SmDCY/jIxkBixcw: folds 
dfNim92Z6XK1/h5SFW5vDg: folds 
JtVGnq5doRa3PublncR+Yw: folds 
DnDcAdn9P0zGovMERigpFA has returned
ghNKXUBl/H+t83JF079ZBA: folds 
Do7fcCjAx0vINJYUXuFoyA: calls $0.25
18G4P1XstjNvItdGUITxgw: folds 
N6fYvIzQLKaydFLKQGtMlQ: checks 
*** FLOP *** [2c Qs 9s]
N6fYvIzQLKaydFLKQGtMlQ: checks 
Do7fcCjAx0vINJYUXuFoyA: checks 
*** TURN *** [2c Qs 9s] [9c]
N6fYvIzQLKaydFLKQGtMlQ: checks 
Do7fcCjAx0vINJYUXuFoyA: bets $0.75
N6fYvIzQLKaydFLKQGtMlQ: folds 
Uncalled bet ($0.75) returned to Do7fcCjAx0vINJYUXuFoyA
Do7fcCjAx0vINJYUXuFoyA collected $0.60 from pot
*** SUMMARY ***
Total pot $0.60 | Rake $0 
Board [2c Qs 9s 9c]
Seat 2: N6fYvIzQLKaydFLKQGtMlQ (big blind) folded on the Turn
Seat 3: DnDcAdn9P0zGovMERigpFA folded before Flop (didn't bet)
Seat 4: UANt6y/SmDCY/jIxkBixcw folded before Flop (didn't bet)
Seat 5: dfNim92Z6XK1/h5SFW5vDg folded before Flop (didn't bet)
Seat 6: JtVGnq5doRa3PublncR+Yw folded before Flop (didn't bet)
Seat 7: ghNKXUBl/H+t83JF079ZBA folded before Flop (didn't bet)
Seat 8: Do7fcCjAx0vINJYUXuFoyA (button) collected ($0.60)
Seat 9: 18G4P1XstjNvItdGUITxgw (small blind) folded before Flop




PokerStars Game #59939415674:  Hold'em No Limit ($0.10/$0.25) - 2009/07/01 0:39:18 ET
Table 'u5gc8WdJbaPqEonQaM8rHA' 9-max Seat #6 is the button
Seat 1: rXm4QDVJt67H20lM6n6Z7Q ($8.50 in chips) 
Seat 2: YcYxPZXJR8KffyXgr1BkHw ($27.60 in chips) 
Seat 4: QBNV6v6f+1ZHoaKcQDTWog ($30 in chips) 
Seat 6: iPe2eRZr++z/LEfORn3WBQ ($16.70 in chips) 
rXm4QDVJt67H20lM6n6Z7Q: posts small blind $0.10
YcYxPZXJR8KffyXgr1BkHw: posts big blind $0.25
*** HOLE CARDS ***
QBNV6v6f+1ZHoaKcQDTWog: folds 
iPe2eRZr++z/LEfORn3WBQ: raises $0.50 to $0.75
rXm4QDVJt67H20lM6n6Z7Q: folds 
YcYxPZXJR8KffyXgr1BkHw: folds 
Uncalled bet ($0.50) returned to iPe2eRZr++z/LEfORn3WBQ
iPe2eRZr++z/LEfORn3WBQ collected $0.60 from pot
iPe2eRZr++z/LEfORn3WBQ: doesn't show hand 
*** SUMMARY ***
Total pot $0.60 | Rake $0 
Seat 1: rXm4QDVJt67H20lM6n6Z7Q (small blind) folded before Flop
Seat 2: YcYxPZXJR8KffyXgr1BkHw (big blind) folded before Flop
Seat 4: QBNV6v6f+1ZHoaKcQDTWog folded before Flop (didn't bet)
Seat 6: iPe2eRZr++z/LEfORn3WBQ (button) collected ($0.60)




PokerStars Game #59939415782:  Hold'em No Limit ($0.10/$0.25) - 2009/07/01 0:39:18 ET
Table 'pgrBYaOEx/BuqK5iAtlFzw' 9-max Seat #3 is the button
Seat 3: bfSq6LBw0UvxeM5yfuWC7w ($14.35 in chips) 
Seat 5: efYVL4adq0ufQFnZCpL5Tw ($6 in chips) 
bfSq6LBw0UvxeM5yfuWC7w: posts small blind $0.10
efYVL4adq0ufQFnZCpL5Tw: posts big blind $0.25
*** HOLE CARDS ***
bfSq6LBw0UvxeM5yfuWC7w: calls $0.15
efYVL4adq0ufQFnZCpL5Tw: checks 
*** FLOP *** [Ks 2s 3s]
efYVL4adq0ufQFnZCpL5Tw: checks 
bfSq6LBw0UvxeM5yfuWC7w: bets $0.50
efYVL4adq0ufQFnZCpL5Tw: raises $1 to $1.50
bfSq6LBw0UvxeM5yfuWC7w: raises $12.60 to $14.10 and is all-in
efYVL4adq0ufQFnZCpL5Tw: calls $4.25 and is all-in
Uncalled bet ($8.35) returned to bfSq6LBw0UvxeM5yfuWC7w
*** TURN *** [Ks 2s 3s] [Kd]
*** RIVER *** [Ks 2s 3s Kd] [Td]
*** SHOW DOWN ***
efYVL4adq0ufQFnZCpL5Tw: shows [5s 4s] (a flush, King high)
bfSq6LBw0UvxeM5yfuWC7w: mucks hand 
efYVL4adq0ufQFnZCpL5Tw collected $11.40 from pot
*** SUMMARY ***
Total pot $12 | Rake $0.60 
Board [Ks 2s 3s Kd Td]
Seat 3: bfSq6LBw0UvxeM5yfuWC7w (button) (small blind) mucked
Seat 5: efYVL4adq0ufQFnZCpL5Tw (big blind) showed [5s 4s] and won ($11.40) with a flush, King high




PokerStars Game #59939415806:  Hold'em No Limit ($0.10/$0.25) - 2009/07/01 0:39:18 ET
Table '50f2Xa1b1jp6cfdTAgXFIg' 9-max Seat #7 is the button
Seat 1: JwUqpgqGHS96sdpExhhEqw ($8.60 in chips) 
Seat 2: OfGfQFPcghysTDljS9GQSQ ($18.25 in chips) 
Seat 3: aZHZRdpOTHSm1zLmzd6+ww ($23.50 in chips) 
Seat 4: ghNKXUBl/H+t83JF079ZBA ($29.60 in chips) 
Seat 5: OlPJsgR4xypSg/w1z7Gyvw ($55.75 in chips) 
Seat 6: Vl8zO7J9ZOnk8Og8eXFezg ($40.40 in chips) 
Seat 7: TeWJxSETzbXGiYKx0y+dtg ($25 in chips) 
Seat 8: jeKWRUkMaVn8rEUjnJKqpg ($25 in chips) 
Seat 9: gehe91e0IyVT0QU/XBkEyg ($25 in chips) 
jeKWRUkMaVn8rEUjnJKqpg: posts small blind $0.10
gehe91e0IyVT0QU/XBkEyg: posts big blind $0.25
*** HOLE CARDS ***
JwUqpgqGHS96sdpExhhEqw: folds 
OfGfQFPcghysTDljS9GQSQ: calls $0.25
aZHZRdpOTHSm1zLmzd6+ww: folds 
ghNKXUBl/H+t83JF079ZBA: folds 
OlPJsgR4xypSg/w1z7Gyvw: calls $0.25
Vl8zO7J9ZOnk8Og8eXFezg: folds 
TeWJxSETzbXGiYKx0y+dtg: folds 
jeKWRUkMaVn8rEUjnJKqpg: folds 
aZHZRdpOTHSm1zLmzd6+ww said, "why raise out of position on the bb"
gehe91e0IyVT0QU/XBkEyg: checks 
*** FLOP *** [7s 4h 3h]
gehe91e0IyVT0QU/XBkEyg: checks 
OfGfQFPcghysTDljS9GQSQ: checks 
aZHZRdpOTHSm1zLmzd6+ww said, "then fold to the first bet?"
OlPJsgR4xypSg/w1z7Gyvw: checks 
*** TURN *** [7s 4h 3h] [Kc]
jeKWRUkMaVn8rEUjnJKqpg said, "what you think i had stupi idiot"
gehe91e0IyVT0QU/XBkEyg: checks 
OfGfQFPcghysTDljS9GQSQ: checks 
OlPJsgR4xypSg/w1z7Gyvw: checks 
*** RIVER *** [7s 4h 3h Kc] [8h]
gehe91e0IyVT0QU/XBkEyg: checks 
aZHZRdpOTHSm1zLmzd6+ww said, "not enough to call the first bet idiot"
jeKWRUkMaVn8rEUjnJKqpg said, "then **** stupid idiot"
OfGfQFPcghysTDljS9GQSQ: bets $0.25
OlPJsgR4xypSg/w1z7Gyvw: folds 
jeKWRUkMaVn8rEUjnJKqpg said, "learn how to play this game"
jeKWRUkMaVn8rEUjnJKqpg said, "are we clear?"
gehe91e0IyVT0QU/XBkEyg: folds 
Uncalled bet ($0.25) returned to OfGfQFPcghysTDljS9GQSQ
OfGfQFPcghysTDljS9GQSQ collected $0.85 from pot
OfGfQFPcghysTDljS9GQSQ: doesn't show hand 
aZHZRdpOTHSm1zLmzd6+ww said, "lmao"
*** SUMMARY ***
Total pot $0.85 | Rake $0 
Board [7s 4h 3h Kc 8h]
Seat 1: JwUqpgqGHS96sdpExhhEqw folded before Flop (didn't bet)
Seat 2: OfGfQFPcghysTDljS9GQSQ collected ($0.85)
Seat 3: aZHZRdpOTHSm1zLmzd6+ww folded before Flop (didn't bet)
Seat 4: ghNKXUBl/H+t83JF079ZBA folded before Flop (didn't bet)
Seat 5: OlPJsgR4xypSg/w1z7Gyvw folded on the River
Seat 6: Vl8zO7J9ZOnk8Og8eXFezg folded before Flop (didn't bet)
Seat 7: TeWJxSETzbXGiYKx0y+dtg (button) folded before Flop (didn't bet)
Seat 8: jeKWRUkMaVn8rEUjnJKqpg (small blind) folded before Flop
Seat 9: gehe91e0IyVT0QU/XBkEyg (big blind) folded on the River




PokerStars Game #59939416014:  Hold'em No Limit ($0.10/$0.25) - 2009/07/01 0:39:18 ET
Table '+68ihX5Br1xgGorX6zsCBg' 9-max Seat #3 is the button
Seat 1: qwr38jl5txoR36M7G5qi4A ($8.40 in chips) 
Seat 2: 3PjJjazzeHcM4mbFeXmZBg ($8.60 in chips) 
Seat 3: DIBbjEYGs+TVdVgEB/4+3w ($25.40 in chips) 
Seat 4: STkR8XvpjNv79OOMhrlh2w ($25 in chips) 
Seat 5: AmFFUA8KSwLGIW6CfaP4JQ ($12.15 in chips) 
Seat 6: 8B/dhbQjIWe6ASCdgzktNQ ($25.25 in chips) 
Seat 7: LWN1wPrLH+695JIriXxDuw ($9.05 in chips) 
Seat 8: rUdM7gwmNCaxMNSb2CFPhQ ($13.20 in chips) 
Seat 9: 3wk6bqORFdwo0pZ1g2+Kqw ($21.15 in chips) 
STkR8XvpjNv79OOMhrlh2w: posts small blind $0.10
AmFFUA8KSwLGIW6CfaP4JQ: posts big blind $0.25
*** HOLE CARDS ***
8B/dhbQjIWe6ASCdgzktNQ: folds 
LWN1wPrLH+695JIriXxDuw: folds 
rUdM7gwmNCaxMNSb2CFPhQ: raises $0.50 to $0.75
3wk6bqORFdwo0pZ1g2+Kqw: raises $1.40 to $2.15
qwr38jl5txoR36M7G5qi4A: folds 
3PjJjazzeHcM4mbFeXmZBg: folds 
DIBbjEYGs+TVdVgEB/4+3w: folds 
STkR8XvpjNv79OOMhrlh2w: folds 
AmFFUA8KSwLGIW6CfaP4JQ: folds 
rUdM7gwmNCaxMNSb2CFPhQ: folds 
Uncalled bet ($1.40) returned to 3wk6bqORFdwo0pZ1g2+Kqw
3wk6bqORFdwo0pZ1g2+Kqw collected $1.85 from pot
3wk6bqORFdwo0pZ1g2+Kqw: doesn't show hand 
*** SUMMARY ***
Total pot $1.85 | Rake $0 
Seat 1: qwr38jl5txoR36M7G5qi4A folded before Flop (didn't bet)
Seat 2: 3PjJjazzeHcM4mbFeXmZBg folded before Flop (didn't bet)
Seat 3: DIBbjEYGs+TVdVgEB/4+3w (button) folded before Flop (didn't bet)
Seat 4: STkR8XvpjNv79OOMhrlh2w (small blind) folded before Flop
Seat 5: AmFFUA8KSwLGIW6CfaP4JQ (big blind) folded before Flop
Seat 6: 8B/dhbQjIWe6ASCdgzktNQ folded before Flop (didn't bet)
Seat 7: LWN1wPrLH+695JIriXxDuw folded before Flop (didn't bet)
Seat 8: rUdM7gwmNCaxMNSb2CFPhQ folded before Flop
Seat 9: 3wk6bqORFdwo0pZ1g2+Kqw collected ($1.85)




PokerStars Game #59939416012:  Hold'em No Limit ($0.10/$0.25) - 2009/07/01 0:39:18 ET
Table 'APEHQjIcZHDZUA4iOjju2g' 6-max Seat #6 is the button
Seat 1: eHsmIvAb2JREg4O6hNPnXg ($8.10 in chips) 
Seat 2: 3zD3qLXT1bEffAoWGnc7wg ($25.35 in chips) 
Seat 3: E7KSkgfIsmIsp0vLnmGFmA ($13.40 in chips) 
Seat 4: EqXTTLKUlDlz7yi6ziyyWA ($35.40 in chips) 
Seat 5: /xN6gc9+8Hew0HxaB6VIVg ($31.75 in chips) 
Seat 6: y7HCJfEmolBCFdi/0j5TRg ($44.70 in chips) 
eHsmIvAb2JREg4O6hNPnXg: posts small blind $0.10
3zD3qLXT1bEffAoWGnc7wg: posts big blind $0.25
*** HOLE CARDS ***
E7KSkgfIsmIsp0vLnmGFmA: folds 
EqXTTLKUlDlz7yi6ziyyWA: folds 
/xN6gc9+8Hew0HxaB6VIVg: calls $0.25
y7HCJfEmolBCFdi/0j5TRg: folds 
eHsmIvAb2JREg4O6hNPnXg: folds 
3zD3qLXT1bEffAoWGnc7wg: checks 
*** FLOP *** [Ks 2h 9s]
3zD3qLXT1bEffAoWGnc7wg: checks 
/xN6gc9+8Hew0HxaB6VIVg: checks 
*** TURN *** [Ks 2h 9s] [Qs]
3zD3qLXT1bEffAoWGnc7wg: checks 
/xN6gc9+8Hew0HxaB6VIVg: checks 
*** RIVER *** [Ks 2h 9s Qs] [Jd]
3zD3qLXT1bEffAoWGnc7wg: checks 
/xN6gc9+8Hew0HxaB6VIVg: bets $0.25
3zD3qLXT1bEffAoWGnc7wg: folds 
Uncalled bet ($0.25) returned to /xN6gc9+8Hew0HxaB6VIVg
/xN6gc9+8Hew0HxaB6VIVg collected $0.60 from pot
/xN6gc9+8Hew0HxaB6VIVg: doesn't show hand 
*** SUMMARY ***
Total pot $0.60 | Rake $0 
Board [Ks 2h 9s Qs Jd]
Seat 1: eHsmIvAb2JREg4O6hNPnXg (small blind) folded before Flop
Seat 2: 3zD3qLXT1bEffAoWGnc7wg (big blind) folded on the River
Seat 3: E7KSkgfIsmIsp0vLnmGFmA folded before Flop (didn't bet)
Seat 4: EqXTTLKUlDlz7yi6ziyyWA folded before Flop (didn't bet)
Seat 5: /xN6gc9+8Hew0HxaB6VIVg collected ($0.60)
Seat 6: y7HCJfEmolBCFdi/0j5TRg (button) folded before Flop (didn't bet)




PokerStars Game #59939416288:  Hold'em No Limit ($0.10/$0.25) - 2009/07/01 0:39:19 ET
Table 'oZuNsbNJuUyQLGKzQ/4JFg' 6-max Seat #3 is the button
Seat 1: /hq3j+3FbArzS8nEzmqRuw ($7.35 in chips) 
Seat 2: UA5OsKS3VPaxa7uC8La/kA ($30.25 in chips) 
Seat 3: 8ClCHtFXGNplITm+63KB+Q ($37.40 in chips) 
Seat 4: pWN7DVB+VCCiq83kllzEtg ($11.10 in chips) 
Seat 5: IH5lT4+CuQFyy32Qf5ydDw ($13.65 in chips) 
Seat 6: 34ttqW62uIRrqINCCmLcsw ($21.15 in chips) 
pWN7DVB+VCCiq83kllzEtg: posts small blind $0.10
IH5lT4+CuQFyy32Qf5ydDw: posts big blind $0.25
*** HOLE CARDS ***
34ttqW62uIRrqINCCmLcsw: folds 
/hq3j+3FbArzS8nEzmqRuw: folds 
UA5OsKS3VPaxa7uC8La/kA: folds 
8ClCHtFXGNplITm+63KB+Q: raises $0.75 to $1
pWN7DVB+VCCiq83kllzEtg: calls $0.90
IH5lT4+CuQFyy32Qf5ydDw: folds 
*** FLOP *** [4d Jd 3d]
pWN7DVB+VCCiq83kllzEtg: checks 
8ClCHtFXGNplITm+63KB+Q: checks 
*** TURN *** [4d Jd 3d] [Qh]
pWN7DVB+VCCiq83kllzEtg: bets $0.50
8ClCHtFXGNplITm+63KB+Q: folds 
Uncalled bet ($0.50) returned to pWN7DVB+VCCiq83kllzEtg
pWN7DVB+VCCiq83kllzEtg collected $2.15 from pot
pWN7DVB+VCCiq83kllzEtg: doesn't show hand 
*** SUMMARY ***
Total pot $2.25 | Rake $0.10 
Board [4d Jd 3d Qh]
Seat 1: /hq3j+3FbArzS8nEzmqRuw folded before Flop (didn't bet)
Seat 2: UA5OsKS3VPaxa7uC8La/kA folded before Flop (didn't bet)
Seat 3: 8ClCHtFXGNplITm+63KB+Q (button) folded on the Turn
Seat 4: pWN7DVB+VCCiq83kllzEtg (small blind) collected ($2.15)
Seat 5: IH5lT4+CuQFyy32Qf5ydDw (big blind) folded before Flop
Seat 6: 34ttqW62uIRrqINCCmLcsw folded before Flop (didn't bet)




PokerStars Game #59939416374:  Hold'em No Limit ($0.10/$0.25) - 2009/07/01 0:39:19 ET
Table 'sm5gqEvXgLbkkE4dryW/5g' 6-max Seat #6 is the button
Seat 1: gaPMxLGp9SOj4Lq6t+/0Ig ($14.35 in chips) 
Seat 2: s13YXIlhF/j3TO0bSnT7bA ($13.40 in chips) 
Seat 3: I1TxPvWj8NfG8orglCinNA ($25.35 in chips) 
Seat 4: BedjMfrlRfPgSq7CXpPAmg ($57.65 in chips) 
Seat 5: M+WmDyCD/ZMu/5t6/iH2kw ($73.75 in chips) 
Seat 6: wKFJ513ucluNNiMlkXcDOQ ($27.95 in chips) 
gaPMxLGp9SOj4Lq6t+/0Ig: posts small blind $0.10
s13YXIlhF/j3TO0bSnT7bA: posts big blind $0.25
*** HOLE CARDS ***
I1TxPvWj8NfG8orglCinNA: folds 
BedjMfrlRfPgSq7CXpPAmg: folds 
M+WmDyCD/ZMu/5t6/iH2kw: folds 
wKFJ513ucluNNiMlkXcDOQ: raises $0.75 to $1
gaPMxLGp9SOj4Lq6t+/0Ig: calls $0.90
s13YXIlhF/j3TO0bSnT7bA: calls $0.75
*** FLOP *** [3c 5d Qd]
gaPMxLGp9SOj4Lq6t+/0Ig: checks 
s13YXIlhF/j3TO0bSnT7bA: bets $1
wKFJ513ucluNNiMlkXcDOQ: raises $3 to $4
gaPMxLGp9SOj4Lq6t+/0Ig: folds 
s13YXIlhF/j3TO0bSnT7bA: calls $3
*** TURN *** [3c 5d Qd] [5h]
s13YXIlhF/j3TO0bSnT7bA: bets $8.40 and is all-in
wKFJ513ucluNNiMlkXcDOQ: folds 
Uncalled bet ($8.40) returned to s13YXIlhF/j3TO0bSnT7bA
s13YXIlhF/j3TO0bSnT7bA collected $10.50 from pot
*** SUMMARY ***
Total pot $11 | Rake $0.50 
Board [3c 5d Qd 5h]
Seat 1: gaPMxLGp9SOj4Lq6t+/0Ig (small blind) folded on the Flop
Seat 2: s13YXIlhF/j3TO0bSnT7bA (big blind) collected ($10.50)
Seat 3: I1TxPvWj8NfG8orglCinNA folded before Flop (didn't bet)
Seat 4: BedjMfrlRfPgSq7CXpPAmg folded before Flop (didn't bet)
Seat 5: M+WmDyCD/ZMu/5t6/iH2kw folded before Flop (didn't bet)
Seat 6: wKFJ513ucluNNiMlkXcDOQ (button) folded on the Turn




PokerStars Game #59939417290:  Hold'em No Limit ($0.10/$0.25) - 2009/07/01 0:39:20 ET
Table 'FuFyQHmlO/QqQp//rDRrPg' 6-max Seat #6 is the button
Seat 1: 4re+a1K56DcbV7DyVX/FMw ($15.55 in chips) 
Seat 2: 0DvgWV5o6c/jYqQCjm4Haw ($25 in chips) 
Seat 3: uoOTv6ecGYEhLPY44ZTW+A ($11.35 in chips) 
Seat 4: Eznneya0vB6S+eXJdVleHA ($9.65 in chips) 
Seat 5: wAKC8C/zN0c8V5v13dm9mA ($25 in chips) 
Seat 6: Euh3U8PK9KVQP5CQdDjkeQ ($20.80 in chips) 
4re+a1K56DcbV7DyVX/FMw: posts small blind $0.10
0DvgWV5o6c/jYqQCjm4Haw: posts big blind $0.25
*** HOLE CARDS ***
uoOTv6ecGYEhLPY44ZTW+A: calls $0.25
Eznneya0vB6S+eXJdVleHA: raises $0.25 to $0.50
wAKC8C/zN0c8V5v13dm9mA: calls $0.50
Euh3U8PK9KVQP5CQdDjkeQ: folds 
Euh3U8PK9KVQP5CQdDjkeQ leaves the table
4re+a1K56DcbV7DyVX/FMw: folds 
0DvgWV5o6c/jYqQCjm4Haw: folds 
uoOTv6ecGYEhLPY44ZTW+A: calls $0.25
*** FLOP *** [Qs Qc 6d]
uoOTv6ecGYEhLPY44ZTW+A: checks 
Eznneya0vB6S+eXJdVleHA: bets $0.25
wAKC8C/zN0c8V5v13dm9mA: raises $1.50 to $1.75
uoOTv6ecGYEhLPY44ZTW+A: folds 
Eznneya0vB6S+eXJdVleHA: folds 
Uncalled bet ($1.50) returned to wAKC8C/zN0c8V5v13dm9mA
wAKC8C/zN0c8V5v13dm9mA collected $2.25 from pot
*** SUMMARY ***
Total pot $2.35 | Rake $0.10 
Board [Qs Qc 6d]
Seat 1: 4re+a1K56DcbV7DyVX/FMw (small blind) folded before Flop
Seat 2: 0DvgWV5o6c/jYqQCjm4Haw (big blind) folded before Flop
Seat 3: uoOTv6ecGYEhLPY44ZTW+A folded on the Flop
Seat 4: Eznneya0vB6S+eXJdVleHA folded on the Flop
Seat 5: wAKC8C/zN0c8V5v13dm9mA collected ($2.25)
Seat 6: Euh3U8PK9KVQP5CQdDjkeQ (button) folded before Flop (didn't bet)




PokerStars Game #59939417286:  Hold'em No Limit ($0.10/$0.25) - 2009/07/01 0:39:20 ET
Table 'ER5H84HUgJx7HyDLnELLeA' 6-max Seat #2 is the button
Seat 1: pjM/xh4+RG8zrxCobDgYDg ($15.85 in chips) 
Seat 2: nc79pm0LZRdhncq55evVqA ($48.50 in chips) 
Seat 3: 2j+7KACUO5iqZ/NSvIH3vg ($6.15 in chips) 
Seat 4: tkRWn3WaJIfGmCXT2hPvJA ($18.55 in chips) 
Seat 5: mfrkWA3PTeYPkbO6hi98Aw ($23.40 in chips) 
2j+7KACUO5iqZ/NSvIH3vg: posts small blind $0.10
tkRWn3WaJIfGmCXT2hPvJA: posts big blind $0.25
FONMraB4GCHzDwDcfciKyw: sits out 
*** HOLE CARDS ***
mfrkWA3PTeYPkbO6hi98Aw: folds 
pjM/xh4+RG8zrxCobDgYDg: folds 
FONMraB4GCHzDwDcfciKyw leaves the table
nc79pm0LZRdhncq55evVqA: folds 
3zD3qLXT1bEffAoWGnc7wg joins the table at seat #6 
2j+7KACUO5iqZ/NSvIH3vg: folds 
Uncalled bet ($0.15) returned to tkRWn3WaJIfGmCXT2hPvJA
tkRWn3WaJIfGmCXT2hPvJA collected $0.20 from pot
*** SUMMARY ***
Total pot $0.20 | Rake $0 
Seat 1: pjM/xh4+RG8zrxCobDgYDg folded before Flop (didn't bet)
Seat 2: nc79pm0LZRdhncq55evVqA (button) folded before Flop (didn't bet)
Seat 3: 2j+7KACUO5iqZ/NSvIH3vg (small blind) folded before Flop
Seat 4: tkRWn3WaJIfGmCXT2hPvJA (big blind) collected ($0.20)
Seat 5: mfrkWA3PTeYPkbO6hi98Aw folded before Flop (didn't bet)




PokerStars Game #59939416940:  Hold'em No Limit ($0.10/$0.25) - 2009/07/01 0:39:20 ET
Table 'AUM6O+mgQAaLDZKMQ/5/gA' 9-max Seat #3 is the button
Seat 1: Eyuoq9VsHg1Puw0nNzXTjg ($6.60 in chips) 
Seat 2: p0Q0llBV74kraoiHI/UzWA ($25 in chips) 
Seat 3: 3m6VfX7io8SA31qh1zCkgQ ($12.75 in chips) 
Seat 4: GIv32m/KBYU5WdIHUImuIg ($4.85 in chips) 
Seat 5: +2kMBNpY4nF1qNCRd8SJLA ($25 in chips) 
GIv32m/KBYU5WdIHUImuIg: posts small blind $0.10
+2kMBNpY4nF1qNCRd8SJLA: posts big blind $0.25
p0Q0llBV74kraoiHI/UzWA: posts big blind $0.25
*** HOLE CARDS ***
Eyuoq9VsHg1Puw0nNzXTjg: folds 
p0Q0llBV74kraoiHI/UzWA: checks 
3m6VfX7io8SA31qh1zCkgQ: calls $0.25
cFmpjvcjNoVAEAIQIxWkYg joins the table at seat #6 
GIv32m/KBYU5WdIHUImuIg: folds 
+2kMBNpY4nF1qNCRd8SJLA: checks 
*** FLOP *** [Kd 5d Qc]
+2kMBNpY4nF1qNCRd8SJLA: checks 
p0Q0llBV74kraoiHI/UzWA: checks 
3m6VfX7io8SA31qh1zCkgQ: checks 
*** TURN *** [Kd 5d Qc] [8s]
+2kMBNpY4nF1qNCRd8SJLA: checks 
p0Q0llBV74kraoiHI/UzWA: checks 
3m6VfX7io8SA31qh1zCkgQ: checks 
*** RIVER *** [Kd 5d Qc 8s] [Ks]
+2kMBNpY4nF1qNCRd8SJLA: checks 
p0Q0llBV74kraoiHI/UzWA: checks 
3m6VfX7io8SA31qh1zCkgQ: bets $0.50
+2kMBNpY4nF1qNCRd8SJLA: folds 
p0Q0llBV74kraoiHI/UzWA: folds 
Uncalled bet ($0.50) returned to 3m6VfX7io8SA31qh1zCkgQ
3m6VfX7io8SA31qh1zCkgQ collected $0.85 from pot
3m6VfX7io8SA31qh1zCkgQ: doesn't show hand 
*** SUMMARY ***
Total pot $0.85 | Rake $0 
Board [Kd 5d Qc 8s Ks]
Seat 1: Eyuoq9VsHg1Puw0nNzXTjg folded before Flop (didn't bet)
Seat 2: p0Q0llBV74kraoiHI/UzWA folded on the River
Seat 3: 3m6VfX7io8SA31qh1zCkgQ (button) collected ($0.85)
Seat 4: GIv32m/KBYU5WdIHUImuIg (small blind) folded before Flop
Seat 5: +2kMBNpY4nF1qNCRd8SJLA (big blind) folded on the River




PokerStars Game #59939416998:  Hold'em No Limit ($0.10/$0.25) - 2009/07/01 0:39:20 ET
Table 'JJzUs04lHpXg6nboT1/jeg' 6-max Seat #3 is the button
Seat 3: uUXdcVMNa05rfbntdvplfw ($10 in chips) 
Seat 4: nwwpaieDRI0UPyVtChVHOg ($36.45 in chips) 
Seat 5: Vr2XE7yYBdg3RZSURDAPEg ($24.15 in chips) 
nwwpaieDRI0UPyVtChVHOg: posts small blind $0.10
Vr2XE7yYBdg3RZSURDAPEg: posts big blind $0.25
*** HOLE CARDS ***
uUXdcVMNa05rfbntdvplfw: folds 
nwwpaieDRI0UPyVtChVHOg: folds 
Uncalled bet ($0.15) returned to Vr2XE7yYBdg3RZSURDAPEg
Vr2XE7yYBdg3RZSURDAPEg collected $0.20 from pot
Vr2XE7yYBdg3RZSURDAPEg: doesn't show hand 
*** SUMMARY ***
Total pot $0.20 | Rake $0 
Seat 3: uUXdcVMNa05rfbntdvplfw (button) folded before Flop (didn't bet)
Seat 4: nwwpaieDRI0UPyVtChVHOg (small blind) folded before Flop
Seat 5: Vr2XE7yYBdg3RZSURDAPEg (big blind) collected ($0.20)




PokerStars Game #59939417220:  Hold'em No Limit ($0.10/$0.25) - 2009/07/01 0:39:20 ET
Table '0w9m+UkNlGMNoPyQqzWk6A' 9-max Seat #4 is the button
Seat 1: 28AHlgXlrYLdiBUJNBoqWA ($25.05 in chips) 
Seat 2: tYsOBqdU1+x+yFI7zHO7hQ ($31.35 in chips) 
Seat 3: VWwtMkIjXloiX/RKh7RGWQ ($8.25 in chips) 
Seat 4: noz/U+++KxL5MIp6+wWstg ($16.10 in chips) 
Seat 5: rPXwQUVloUl+qZm3CCtaJw ($17.10 in chips) 
Seat 6: sWBBy1WroEskLNyJzhkUag ($16.50 in chips) 
Seat 7: lrTLp1zpuCCs/e0pi2M8jw ($12.65 in chips) 
Seat 8: hPhp/RE3cJ5YGaQ2xOHXXg ($5.75 in chips) 
Seat 9: 56S3mA6Zs3pGR+0p0vUCtg ($24.95 in chips) 
rPXwQUVloUl+qZm3CCtaJw: posts small blind $0.10
sWBBy1WroEskLNyJzhkUag: posts big blind $0.25
*** HOLE CARDS ***
lrTLp1zpuCCs/e0pi2M8jw: folds 
hPhp/RE3cJ5YGaQ2xOHXXg: folds 
56S3mA6Zs3pGR+0p0vUCtg: folds 
28AHlgXlrYLdiBUJNBoqWA: folds 
tYsOBqdU1+x+yFI7zHO7hQ: raises $0.75 to $1
VWwtMkIjXloiX/RKh7RGWQ: folds 
noz/U+++KxL5MIp6+wWstg: calls $1
rPXwQUVloUl+qZm3CCtaJw: folds 
sWBBy1WroEskLNyJzhkUag: folds 
*** FLOP *** [Qc Ts Kd]
tYsOBqdU1+x+yFI7zHO7hQ: bets $1.75
noz/U+++KxL5MIp6+wWstg: raises $1.75 to $3.50
tYsOBqdU1+x+yFI7zHO7hQ: calls $1.75
*** TURN *** [Qc Ts Kd] [4h]
tYsOBqdU1+x+yFI7zHO7hQ: bets $4.25
noz/U+++KxL5MIp6+wWstg: raises $4.25 to $8.50
tYsOBqdU1+x+yFI7zHO7hQ: raises $8.75 to $17.25
noz/U+++KxL5MIp6+wWstg: calls $3.10 and is all-in
Uncalled bet ($5.65) returned to tYsOBqdU1+x+yFI7zHO7hQ
*** RIVER *** [Qc Ts Kd 4h] [Jc]
*** SHOW DOWN ***
tYsOBqdU1+x+yFI7zHO7hQ: shows [Jd Ad] (a straight, Ten to Ace)
noz/U+++KxL5MIp6+wWstg: mucks hand 
tYsOBqdU1+x+yFI7zHO7hQ collected $30.95 from pot
*** SUMMARY ***
Total pot $32.55 | Rake $1.60 
Board [Qc Ts Kd 4h Jc]
Seat 1: 28AHlgXlrYLdiBUJNBoqWA folded before Flop (didn't bet)
Seat 2: tYsOBqdU1+x+yFI7zHO7hQ showed [Jd Ad] and won ($30.95) with a straight, Ten to Ace
Seat 3: VWwtMkIjXloiX/RKh7RGWQ folded before Flop (didn't bet)
Seat 4: noz/U+++KxL5MIp6+wWstg (button) mucked
Seat 5: rPXwQUVloUl+qZm3CCtaJw (small blind) folded before Flop
Seat 6: sWBBy1WroEskLNyJzhkUag (big blind) folded before Flop
Seat 7: lrTLp1zpuCCs/e0pi2M8jw folded before Flop (didn't bet)
Seat 8: hPhp/RE3cJ5YGaQ2xOHXXg folded before Flop (didn't bet)
Seat 9: 56S3mA6Zs3pGR+0p0vUCtg folded before Flop (didn't bet)




PokerStars Game #59939417190:  Hold'em No Limit ($0.10/$0.25) - 2009/07/01 0:39:20 ET
Table 'm+FQg/QP0VP1ZA3V62WtOg' 9-max Seat #4 is the button
Seat 1: IK3/w7XV7rd8mVIsuasjYA ($3.40 in chips) 
Seat 2: oKO7b50N6TzXbPBr/mcrUA ($25.20 in chips) 
Seat 3: 4oA316mXLIui1QY63GXBUg ($25 in chips) 
Seat 4: 86vbuhJsyH+nbEg5qpDLyQ ($25 in chips) 
Seat 5: DnDcAdn9P0zGovMERigpFA ($25 in chips) 
Seat 6: 0kGr2KqzSs4y4kVqyDiTag ($15.25 in chips) 
Seat 7: Xt367jg1prYX1onqNvit0Q ($17.80 in chips) 
Seat 8: tZEGwCRajq0AFS6z46uW9w ($15.75 in chips) 
Seat 9: ghNKXUBl/H+t83JF079ZBA ($25 in chips) 
DnDcAdn9P0zGovMERigpFA: posts small blind $0.10
0kGr2KqzSs4y4kVqyDiTag: posts big blind $0.25
*** HOLE CARDS ***
Xt367jg1prYX1onqNvit0Q: folds 
tZEGwCRajq0AFS6z46uW9w: calls $0.25
ghNKXUBl/H+t83JF079ZBA: folds 
IK3/w7XV7rd8mVIsuasjYA: calls $0.25
Xt367jg1prYX1onqNvit0Q leaves the table
oKO7b50N6TzXbPBr/mcrUA: raises $0.50 to $0.75
4oA316mXLIui1QY63GXBUg: folds 
86vbuhJsyH+nbEg5qpDLyQ: folds 
DnDcAdn9P0zGovMERigpFA: folds 
0kGr2KqzSs4y4kVqyDiTag: calls $0.50
tZEGwCRajq0AFS6z46uW9w: calls $0.50
IK3/w7XV7rd8mVIsuasjYA: folds 
*** FLOP *** [7d Jh Ks]
0kGr2KqzSs4y4kVqyDiTag: checks 
tZEGwCRajq0AFS6z46uW9w: checks 
oKO7b50N6TzXbPBr/mcrUA: bets $1.50
MIVCHqCqqlke0Lb0z7glcw joins the table at seat #7 
0kGr2KqzSs4y4kVqyDiTag: folds 
tZEGwCRajq0AFS6z46uW9w: calls $1.50
*** TURN *** [7d Jh Ks] [Qc]
tZEGwCRajq0AFS6z46uW9w: checks 
oKO7b50N6TzXbPBr/mcrUA: bets $3.75
tZEGwCRajq0AFS6z46uW9w: raises $3.75 to $7.50
oKO7b50N6TzXbPBr/mcrUA: folds 
Uncalled bet ($3.75) returned to tZEGwCRajq0AFS6z46uW9w
tZEGwCRajq0AFS6z46uW9w collected $12.50 from pot
tZEGwCRajq0AFS6z46uW9w: shows [Kd Qd] (two pair, Kings and Queens)
*** SUMMARY ***
Total pot $13.10 | Rake $0.60 
Board [7d Jh Ks Qc]
Seat 1: IK3/w7XV7rd8mVIsuasjYA folded before Flop
Seat 2: oKO7b50N6TzXbPBr/mcrUA folded on the Turn
Seat 3: 4oA316mXLIui1QY63GXBUg folded before Flop (didn't bet)
Seat 4: 86vbuhJsyH+nbEg5qpDLyQ (button) folded before Flop (didn't bet)
Seat 5: DnDcAdn9P0zGovMERigpFA (small blind) folded before Flop
Seat 6: 0kGr2KqzSs4y4kVqyDiTag (big blind) folded on the Flop
Seat 7: Xt367jg1prYX1onqNvit0Q folded before Flop (didn't bet)
Seat 8: tZEGwCRajq0AFS6z46uW9w collected ($12.50)
Seat 9: ghNKXUBl/H+t83JF079ZBA folded before Flop (didn't bet)




PokerStars Game #59939417148:  Hold'em No Limit ($0.10/$0.25) - 2009/07/01 0:39:20 ET
Table 'HQOv+27sJF7e8+zUsBlT2w' 9-max Seat #4 is the button
Seat 1: CbXUS6Z2rXZxL1AKduNtmQ ($26.25 in chips) 
Seat 2: MG90wfSJZnOejs/KD3vlQQ ($25 in chips) 
Seat 3: 18G4P1XstjNvItdGUITxgw ($29.45 in chips) 
Seat 4: kRW/Cdh6F1t40Vs43OFbYA ($16.50 in chips) 
Seat 5: nD+0ILJGeuYzreVIK9/wcA ($15.25 in chips) 
Seat 6: vZGoOTJLQLhkPj4I+LNGig ($32.60 in chips) 
Seat 7: GmzfAfxcxu1kGbPC+9LkVg ($24.65 in chips) 
Seat 8: RaXCy4DBrUrZSg4MF8FyDg ($12.25 in chips) 
Seat 9: gehe91e0IyVT0QU/XBkEyg ($25 in chips) 
nD+0ILJGeuYzreVIK9/wcA: posts small blind $0.10
vZGoOTJLQLhkPj4I+LNGig: posts big blind $0.25
*** HOLE CARDS ***
GmzfAfxcxu1kGbPC+9LkVg: calls $0.25
RaXCy4DBrUrZSg4MF8FyDg: folds 
gehe91e0IyVT0QU/XBkEyg: folds 
CbXUS6Z2rXZxL1AKduNtmQ: folds 
MG90wfSJZnOejs/KD3vlQQ: folds 
18G4P1XstjNvItdGUITxgw: folds 
kRW/Cdh6F1t40Vs43OFbYA: calls $0.25
nD+0ILJGeuYzreVIK9/wcA: calls $0.15
vZGoOTJLQLhkPj4I+LNGig: checks 
*** FLOP *** [Qd Jd 9h]
nD+0ILJGeuYzreVIK9/wcA: checks 
vZGoOTJLQLhkPj4I+LNGig: checks 
GmzfAfxcxu1kGbPC+9LkVg: checks 
kRW/Cdh6F1t40Vs43OFbYA: checks 
*** TURN *** [Qd Jd 9h] [Tc]
nD+0ILJGeuYzreVIK9/wcA: bets $0.25
vZGoOTJLQLhkPj4I+LNGig: folds 
GmzfAfxcxu1kGbPC+9LkVg: folds 
kRW/Cdh6F1t40Vs43OFbYA: folds 
Uncalled bet ($0.25) returned to nD+0ILJGeuYzreVIK9/wcA
nD+0ILJGeuYzreVIK9/wcA collected $0.95 from pot
nD+0ILJGeuYzreVIK9/wcA: doesn't show hand 
*** SUMMARY ***
Total pot $1 | Rake $0.05 
Board [Qd Jd 9h Tc]
Seat 1: CbXUS6Z2rXZxL1AKduNtmQ folded before Flop (didn't bet)
Seat 2: MG90wfSJZnOejs/KD3vlQQ folded before Flop (didn't bet)
Seat 3: 18G4P1XstjNvItdGUITxgw folded before Flop (didn't bet)
Seat 4: kRW/Cdh6F1t40Vs43OFbYA (button) folded on the Turn
Seat 5: nD+0ILJGeuYzreVIK9/wcA (small blind) collected ($0.95)
Seat 6: vZGoOTJLQLhkPj4I+LNGig (big blind) folded on the Turn
Seat 7: GmzfAfxcxu1kGbPC+9LkVg folded on the Turn
Seat 8: RaXCy4DBrUrZSg4MF8FyDg folded before Flop (didn't bet)
Seat 9: gehe91e0IyVT0QU/XBkEyg folded before Flop (didn't bet)




PokerStars Game #59939417288:  Hold'em No Limit ($0.10/$0.25) - 2009/07/01 0:39:20 ET
Table 'jxoHy9yJy0bbH/Qx73FoPA' 9-max Seat #6 is the button
Seat 1: jN7A9nKK4RYzhFj4MrekhA ($15.10 in chips) 
Seat 3: /DYYmfrw4B9z+N2z81dNtA ($20.70 in chips) 
Seat 4: RJ/x9oZtt1RZLaJEQwZOxQ ($27.40 in chips) 
Seat 5: vO3QVRovWemcGMkm7ijAIA ($4.30 in chips) 
Seat 6: tYsOBqdU1+x+yFI7zHO7hQ ($51.90 in chips) 
Seat 7: HhlCy99+up/IQbbuxF6uXg ($7.75 in chips) 
Seat 8: hBMUlEpyU74r/fwDgIpXjQ ($30.60 in chips) 
Seat 9: IG1d4tXnNA98OKRYYE3l+A ($54.45 in chips) 
HhlCy99+up/IQbbuxF6uXg: posts small blind $0.10
hBMUlEpyU74r/fwDgIpXjQ: posts big blind $0.25
lacross84: sits out 
*** HOLE CARDS ***
IG1d4tXnNA98OKRYYE3l+A: calls $0.25
jN7A9nKK4RYzhFj4MrekhA: calls $0.25
/DYYmfrw4B9z+N2z81dNtA has timed out
/DYYmfrw4B9z+N2z81dNtA: folds 
/DYYmfrw4B9z+N2z81dNtA is sitting out
RJ/x9oZtt1RZLaJEQwZOxQ: folds 
vO3QVRovWemcGMkm7ijAIA: folds 
tYsOBqdU1+x+yFI7zHO7hQ: folds 
/DYYmfrw4B9z+N2z81dNtA has returned
HhlCy99+up/IQbbuxF6uXg: calls $0.15
hBMUlEpyU74r/fwDgIpXjQ: checks 
*** FLOP *** [Qd 2h 7c]
HhlCy99+up/IQbbuxF6uXg: checks 
hBMUlEpyU74r/fwDgIpXjQ: checks 
IG1d4tXnNA98OKRYYE3l+A: checks 
jN7A9nKK4RYzhFj4MrekhA: checks 
*** TURN *** [Qd 2h 7c] [2s]
HhlCy99+up/IQbbuxF6uXg: bets $0.50
hBMUlEpyU74r/fwDgIpXjQ: folds 
IG1d4tXnNA98OKRYYE3l+A: folds 
jN7A9nKK4RYzhFj4MrekhA: folds 
Uncalled bet ($0.50) returned to HhlCy99+up/IQbbuxF6uXg
HhlCy99+up/IQbbuxF6uXg collected $0.95 from pot
*** SUMMARY ***
Total pot $1 | Rake $0.05 
Board [Qd 2h 7c 2s]
Seat 1: jN7A9nKK4RYzhFj4MrekhA folded on the Turn
Seat 3: /DYYmfrw4B9z+N2z81dNtA folded before Flop (didn't bet)
Seat 4: RJ/x9oZtt1RZLaJEQwZOxQ folded before Flop (didn't bet)
Seat 5: vO3QVRovWemcGMkm7ijAIA folded before Flop (didn't bet)
Seat 6: tYsOBqdU1+x+yFI7zHO7hQ (button) folded before Flop (didn't bet)
Seat 7: HhlCy99+up/IQbbuxF6uXg (small blind) collected ($0.95)
Seat 8: hBMUlEpyU74r/fwDgIpXjQ (big blind) folded on the Turn
Seat 9: IG1d4tXnNA98OKRYYE3l+A folded on the Turn




PokerStars Game #59939417884:  Hold'em No Limit ($0.10/$0.25) - 2009/07/01 0:39:21 ET
Table '972HGIb0tQN/zRIK4TABEw' 9-max Seat #9 is the button
Seat 1: fHr2+mGa0RFK3qrpZcVUAQ ($10.50 in chips) 
Seat 2: lc6GpYOW7MM4G+/65wMxXA ($14.75 in chips) 
Seat 3: W4TLQcZ2TiM73eIgpIvlGg ($24.40 in chips) 
Seat 4: BnWWUASA3YjU/ovKqaKNpA ($7 in chips) 
Seat 5: oFwaTjy3ok/+qFghsrcGvg ($9.10 in chips) 
Seat 7: qS+jfnNoG75bT+uQ8CKhQA ($14.75 in chips) 
Seat 8: DIBbjEYGs+TVdVgEB/4+3w ($47 in chips) 
Seat 9: qUzFLsH4zPL5Zy77O+Qlbw ($2.85 in chips) 
fHr2+mGa0RFK3qrpZcVUAQ: posts small blind $0.10
lc6GpYOW7MM4G+/65wMxXA: posts big blind $0.25
*** HOLE CARDS ***
W4TLQcZ2TiM73eIgpIvlGg: calls $0.25
BnWWUASA3YjU/ovKqaKNpA: raises $0.50 to $0.75
oFwaTjy3ok/+qFghsrcGvg: folds 
qS+jfnNoG75bT+uQ8CKhQA: raises $1.75 to $2.50
DIBbjEYGs+TVdVgEB/4+3w: folds 
qUzFLsH4zPL5Zy77O+Qlbw: folds 
fHr2+mGa0RFK3qrpZcVUAQ: folds 
oFwaTjy3ok/+qFghsrcGvg leaves the table
BnWWUASA3YjU/ovKqaKNpA said, "zzzzzzzzzzzzzzzzzzzzzzzzzzzzzzzzzzzzzzzzzzzzzzzzzzzzzzzzzzzzzzzzzzzzzz"
oposssum joins the table at seat #5 
oposssum leaves the table
lc6GpYOW7MM4G+/65wMxXA has timed out
lc6GpYOW7MM4G+/65wMxXA: folds 
lc6GpYOW7MM4G+/65wMxXA is sitting out
W4TLQcZ2TiM73eIgpIvlGg: folds 
BnWWUASA3YjU/ovKqaKNpA: calls $1.75
*** FLOP *** [9c Ah 6s]
BnWWUASA3YjU/ovKqaKNpA: bets $2
qS+jfnNoG75bT+uQ8CKhQA: folds 
Uncalled bet ($2) returned to BnWWUASA3YjU/ovKqaKNpA
BnWWUASA3YjU/ovKqaKNpA collected $5.35 from pot
BnWWUASA3YjU/ovKqaKNpA: doesn't show hand 
*** SUMMARY ***
Total pot $5.60 | Rake $0.25 
Board [9c Ah 6s]
Seat 1: fHr2+mGa0RFK3qrpZcVUAQ (small blind) folded before Flop
Seat 2: lc6GpYOW7MM4G+/65wMxXA (big blind) folded before Flop
Seat 3: W4TLQcZ2TiM73eIgpIvlGg folded before Flop
Seat 4: BnWWUASA3YjU/ovKqaKNpA collected ($5.35)
Seat 5: oFwaTjy3ok/+qFghsrcGvg folded before Flop (didn't bet)
Seat 7: qS+jfnNoG75bT+uQ8CKhQA folded on the Flop
Seat 8: DIBbjEYGs+TVdVgEB/4+3w folded before Flop (didn't bet)
Seat 9: qUzFLsH4zPL5Zy77O+Qlbw (button) folded before Flop (didn't bet)




PokerStars Game #59939417956:  Hold'em No Limit ($0.10/$0.25) - 2009/07/01 0:39:21 ET
Table 'D1Yq70l0nNCyMV6DA42p+Q' 9-max Seat #3 is the button
Seat 1: z5GxcHlYz/GSz6W2uFiTtg ($14.60 in chips) 
Seat 2: OB0uLxxDeISeDjs0cxaocA ($31.25 in chips) 
Seat 3: j4q3p0lesp63b1gZDwLBZw ($5 in chips) 
Seat 5: gehe91e0IyVT0QU/XBkEyg ($25.80 in chips) 
Seat 6: MgMavn/DzTzqKgHTZMsVSw ($25 in chips) 
Seat 7: 9mw49/JQZ9pj0wFynA329g ($14.70 in chips) 
Seat 8: zDrucyjVn5aeekNEc3cJrA ($22.95 in chips) 
Seat 9: 3PjJjazzeHcM4mbFeXmZBg ($2.90 in chips) 
gehe91e0IyVT0QU/XBkEyg: posts small blind $0.10
MgMavn/DzTzqKgHTZMsVSw: posts big blind $0.25
*** HOLE CARDS ***
9mw49/JQZ9pj0wFynA329g: folds 
zDrucyjVn5aeekNEc3cJrA: folds 
3PjJjazzeHcM4mbFeXmZBg: folds 
z5GxcHlYz/GSz6W2uFiTtg: folds 
OB0uLxxDeISeDjs0cxaocA: calls $0.25
j4q3p0lesp63b1gZDwLBZw: folds 
gehe91e0IyVT0QU/XBkEyg: folds 
MgMavn/DzTzqKgHTZMsVSw: checks 
*** FLOP *** [2d 7s As]
MgMavn/DzTzqKgHTZMsVSw: checks 
OB0uLxxDeISeDjs0cxaocA: bets $1
MgMavn/DzTzqKgHTZMsVSw: folds 
Uncalled bet ($1) returned to OB0uLxxDeISeDjs0cxaocA
OB0uLxxDeISeDjs0cxaocA collected $0.60 from pot
OB0uLxxDeISeDjs0cxaocA: doesn't show hand 
*** SUMMARY ***
Total pot $0.60 | Rake $0 
Board [2d 7s As]
Seat 1: z5GxcHlYz/GSz6W2uFiTtg folded before Flop (didn't bet)
Seat 2: OB0uLxxDeISeDjs0cxaocA collected ($0.60)
Seat 3: j4q3p0lesp63b1gZDwLBZw (button) folded before Flop (didn't bet)
Seat 5: gehe91e0IyVT0QU/XBkEyg (small blind) folded before Flop
Seat 6: MgMavn/DzTzqKgHTZMsVSw (big blind) folded on the Flop
Seat 7: 9mw49/JQZ9pj0wFynA329g folded before Flop (didn't bet)
Seat 8: zDrucyjVn5aeekNEc3cJrA folded before Flop (didn't bet)
Seat 9: 3PjJjazzeHcM4mbFeXmZBg folded before Flop (didn't bet)




PokerStars Game #59939417758:  Hold'em No Limit ($0.10/$0.25) - 2009/07/01 0:39:21 ET
Table 'g6ryG70feTw9nNm+XJLuXw' 6-max Seat #2 is the button
Seat 1: v+QfkGiuj9bgtuNoVnDO8w ($28.95 in chips) 
Seat 2: SxIIgwXYLkwd6m3wLyPTCw ($25.25 in chips) 
Seat 3: /6h8PvAHQmfuMUZ8OUF6Xw ($25.10 in chips) 
Seat 4: GC/9yVD59DUCX7hUI7gcLw ($37.10 in chips) 
Seat 5: EE16Ua5b1HSsYej5zeXOlA ($25.60 in chips) 
/6h8PvAHQmfuMUZ8OUF6Xw: posts small blind $0.10
GC/9yVD59DUCX7hUI7gcLw: posts big blind $0.25
*** HOLE CARDS ***
EE16Ua5b1HSsYej5zeXOlA: folds 
v+QfkGiuj9bgtuNoVnDO8w: folds 
SxIIgwXYLkwd6m3wLyPTCw: folds 
/6h8PvAHQmfuMUZ8OUF6Xw: calls $0.15
GC/9yVD59DUCX7hUI7gcLw: raises $0.75 to $1
/6h8PvAHQmfuMUZ8OUF6Xw: calls $0.75
*** FLOP *** [Js 5h 7s]
/6h8PvAHQmfuMUZ8OUF6Xw: checks 
GC/9yVD59DUCX7hUI7gcLw: bets $1.25
/6h8PvAHQmfuMUZ8OUF6Xw: folds 
Uncalled bet ($1.25) returned to GC/9yVD59DUCX7hUI7gcLw
GC/9yVD59DUCX7hUI7gcLw collected $1.90 from pot
*** SUMMARY ***
Total pot $2 | Rake $0.10 
Board [Js 5h 7s]
Seat 1: v+QfkGiuj9bgtuNoVnDO8w folded before Flop (didn't bet)
Seat 2: SxIIgwXYLkwd6m3wLyPTCw (button) folded before Flop (didn't bet)
Seat 3: /6h8PvAHQmfuMUZ8OUF6Xw (small blind) folded on the Flop
Seat 4: GC/9yVD59DUCX7hUI7gcLw (big blind) collected ($1.90)
Seat 5: EE16Ua5b1HSsYej5zeXOlA folded before Flop (didn't bet)




PokerStars Game #59939417486:  Hold'em No Limit ($0.10/$0.25) - 2009/07/01 0:39:21 ET
Table 'UVjmXTtsmlX1HxwwZ59akg' 9-max Seat #3 is the button
Seat 1: zDrucyjVn5aeekNEc3cJrA ($27.30 in chips) 
Seat 2: COsrwJSFHQtxlUcrYtDQPQ ($27.25 in chips) 
Seat 3: N6fYvIzQLKaydFLKQGtMlQ ($24.65 in chips) 
Seat 4: aNpwfA31EREwO+ar4XzBCw ($25.10 in chips) 
Seat 6: DnDcAdn9P0zGovMERigpFA ($34.10 in chips) 
Seat 8: 1MicVRr41LapJvzzk3i8Tw ($11.70 in chips) 
Seat 9: CwVLsIXxfYxktnIIDbafCw ($14.15 in chips) 
aNpwfA31EREwO+ar4XzBCw: posts small blind $0.10
DnDcAdn9P0zGovMERigpFA: posts big blind $0.25
*** HOLE CARDS ***
1MicVRr41LapJvzzk3i8Tw said, "what are you taliking about?"
1MicVRr41LapJvzzk3i8Tw: folds 
CwVLsIXxfYxktnIIDbafCw: folds 
zDrucyjVn5aeekNEc3cJrA: folds 
COsrwJSFHQtxlUcrYtDQPQ: raises $0.55 to $0.80
CwVLsIXxfYxktnIIDbafCw said, "About you trying to bluff and folding at mnraise at the 9high flop"
N6fYvIzQLKaydFLKQGtMlQ: folds 
aNpwfA31EREwO+ar4XzBCw: folds 
DnDcAdn9P0zGovMERigpFA: folds 
Uncalled bet ($0.55) returned to COsrwJSFHQtxlUcrYtDQPQ
COsrwJSFHQtxlUcrYtDQPQ collected $0.60 from pot
COsrwJSFHQtxlUcrYtDQPQ: doesn't show hand 
*** SUMMARY ***
Total pot $0.60 | Rake $0 
Seat 1: zDrucyjVn5aeekNEc3cJrA folded before Flop (didn't bet)
Seat 2: COsrwJSFHQtxlUcrYtDQPQ collected ($0.60)
Seat 3: N6fYvIzQLKaydFLKQGtMlQ (button) folded before Flop (didn't bet)
Seat 4: aNpwfA31EREwO+ar4XzBCw (small blind) folded before Flop
Seat 6: DnDcAdn9P0zGovMERigpFA (big blind) folded before Flop
Seat 8: 1MicVRr41LapJvzzk3i8Tw folded before Flop (didn't bet)
Seat 9: CwVLsIXxfYxktnIIDbafCw folded before Flop (didn't bet)




PokerStars Game #59939418008:  Hold'em No Limit ($0.10/$0.25) - 2009/07/01 0:39:21 ET
Table 'uFgIyfWPagvEVGEb86da7A' 9-max Seat #6 is the button
Seat 2: o3zvoO+PsqGti+1NZGNRrQ ($6.60 in chips) 
Seat 3: q4GZp0xt5Unxtq8PS32SAQ ($35.70 in chips) 
Seat 5: Qi+clOtyDiibLdH2/1Qy8g ($17.30 in chips) 
Seat 6: zDrucyjVn5aeekNEc3cJrA ($23.70 in chips) 
Seat 8: MzxZJee3eU6Q0wg0XTfZew ($9.95 in chips) 
Seat 9: DnDcAdn9P0zGovMERigpFA ($25 in chips) 
MzxZJee3eU6Q0wg0XTfZew: posts small blind $0.10
DnDcAdn9P0zGovMERigpFA: posts big blind $0.25
5MgYq10OC5iGoxQFwlJVuw: sits out 
tjhousyomama: sits out 
*** HOLE CARDS ***
o3zvoO+PsqGti+1NZGNRrQ: calls $0.25
q4GZp0xt5Unxtq8PS32SAQ: folds 
Qi+clOtyDiibLdH2/1Qy8g: folds 
zDrucyjVn5aeekNEc3cJrA: calls $0.25
MzxZJee3eU6Q0wg0XTfZew: calls $0.15
DnDcAdn9P0zGovMERigpFA: checks 
*** FLOP *** [9h 2h Qd]
MzxZJee3eU6Q0wg0XTfZew: checks 
DnDcAdn9P0zGovMERigpFA: checks 
o3zvoO+PsqGti+1NZGNRrQ: checks 
inca7bar is connected 
zDrucyjVn5aeekNEc3cJrA: bets $0.75
MzxZJee3eU6Q0wg0XTfZew: calls $0.75
DnDcAdn9P0zGovMERigpFA: folds 
o3zvoO+PsqGti+1NZGNRrQ: folds 
*** TURN *** [9h 2h Qd] [8d]
MzxZJee3eU6Q0wg0XTfZew: bets $1.50
zDrucyjVn5aeekNEc3cJrA: folds 
Uncalled bet ($1.50) returned to MzxZJee3eU6Q0wg0XTfZew
MzxZJee3eU6Q0wg0XTfZew collected $2.40 from pot
*** SUMMARY ***
Total pot $2.50 | Rake $0.10 
Board [9h 2h Qd 8d]
Seat 2: o3zvoO+PsqGti+1NZGNRrQ folded on the Flop
Seat 3: q4GZp0xt5Unxtq8PS32SAQ folded before Flop (didn't bet)
Seat 5: Qi+clOtyDiibLdH2/1Qy8g folded before Flop (didn't bet)
Seat 6: zDrucyjVn5aeekNEc3cJrA (button) folded on the Turn
Seat 8: MzxZJee3eU6Q0wg0XTfZew (small blind) collected ($2.40)
Seat 9: DnDcAdn9P0zGovMERigpFA (big blind) folded on the Flop




PokerStars Game #59939417990:  Hold'em No Limit ($0.10/$0.25) - 2009/07/01 0:39:21 ET
Table 'ROYvQOMwUrvL3SOiHYcrWg' 9-max Seat #4 is the button
Seat 1: 7q7lZBfgmzjFr0jTNx4b6g ($11.35 in chips) 
Seat 2: hBMUlEpyU74r/fwDgIpXjQ ($48.85 in chips) 
Seat 4: SHegmCn8B0InbWE/zFlvOw ($28.70 in chips) 
Seat 5: jeKWRUkMaVn8rEUjnJKqpg ($25.10 in chips) 
Seat 7: tYsOBqdU1+x+yFI7zHO7hQ ($26.25 in chips) 
Seat 9: H361Owx55YUAYmPZdz+Hzg ($11.55 in chips) 
jeKWRUkMaVn8rEUjnJKqpg: posts small blind $0.10
ZWU9RNYtjmm4cElg1I0F4w: is sitting out 
tYsOBqdU1+x+yFI7zHO7hQ: posts big blind $0.25
ModestZL: sits out 
*** HOLE CARDS ***
ZWU9RNYtjmm4cElg1I0F4w leaves the table
H361Owx55YUAYmPZdz+Hzg has timed out
H361Owx55YUAYmPZdz+Hzg: folds 
H361Owx55YUAYmPZdz+Hzg is sitting out
OiV1PWZ3IkN29JlmCcnTwQ joins the table at seat #6 
7q7lZBfgmzjFr0jTNx4b6g: raises $0.50 to $0.75
hBMUlEpyU74r/fwDgIpXjQ: folds 
SHegmCn8B0InbWE/zFlvOw: folds 
jeKWRUkMaVn8rEUjnJKqpg: folds 
tYsOBqdU1+x+yFI7zHO7hQ: folds 
Uncalled bet ($0.50) returned to 7q7lZBfgmzjFr0jTNx4b6g
7q7lZBfgmzjFr0jTNx4b6g collected $0.60 from pot
*** SUMMARY ***
Total pot $0.60 | Rake $0 
Seat 1: 7q7lZBfgmzjFr0jTNx4b6g collected ($0.60)
Seat 2: hBMUlEpyU74r/fwDgIpXjQ folded before Flop (didn't bet)
Seat 4: SHegmCn8B0InbWE/zFlvOw (button) folded before Flop (didn't bet)
Seat 5: jeKWRUkMaVn8rEUjnJKqpg (small blind) folded before Flop
Seat 7: tYsOBqdU1+x+yFI7zHO7hQ (big blind) folded before Flop
Seat 9: H361Owx55YUAYmPZdz+Hzg folded before Flop (didn't bet)




PokerStars Game #59939418524:  Hold'em No Limit ($0.10/$0.25) - 2009/07/01 0:39:22 ET
Table 'nFlmVztKq1HJEWfxmdl15w' 9-max Seat #3 is the button
Seat 1: COsrwJSFHQtxlUcrYtDQPQ ($25 in chips) 
Seat 3: /XMgGtJ7mcWfe5s7McY9kw ($25 in chips) 
Seat 4: +5dSUwD+/k2ktlnutSMivw ($21.40 in chips) 
Seat 5: Tx6zQdk5Ozt9ObEBlU7jeg ($20.60 in chips) 
Seat 6: 4awUyiDYTgylQKXZ9faBVA ($29.60 in chips) 
Seat 7: Mm1VqYDg+pZQ8ufUXZHA1g ($9.80 in chips) 
Seat 9: LSrAei+fS8MYG9ie/GkG0Q ($16 in chips) 
+5dSUwD+/k2ktlnutSMivw: posts small blind $0.10
Tx6zQdk5Ozt9ObEBlU7jeg: posts big blind $0.25
+2kMBNpY4nF1qNCRd8SJLA: sits out 
*** HOLE CARDS ***
4awUyiDYTgylQKXZ9faBVA: folds 
Mm1VqYDg+pZQ8ufUXZHA1g: calls $0.25
LSrAei+fS8MYG9ie/GkG0Q: folds 
COsrwJSFHQtxlUcrYtDQPQ: raises $0.75 to $1
/XMgGtJ7mcWfe5s7McY9kw: folds 
+5dSUwD+/k2ktlnutSMivw: calls $0.90
Tx6zQdk5Ozt9ObEBlU7jeg: folds 
Mm1VqYDg+pZQ8ufUXZHA1g: calls $0.75
*** FLOP *** [7s 7c Ah]
+5dSUwD+/k2ktlnutSMivw: checks 
Mm1VqYDg+pZQ8ufUXZHA1g: checks 
COsrwJSFHQtxlUcrYtDQPQ: checks 
*** TURN *** [7s 7c Ah] [Qh]
+5dSUwD+/k2ktlnutSMivw: checks 
Mm1VqYDg+pZQ8ufUXZHA1g: bets $1.75
q9qPRjJC40e/Q9yuT+glwQ leaves the table
COsrwJSFHQtxlUcrYtDQPQ: folds 
+5dSUwD+/k2ktlnutSMivw: folds 
Uncalled bet ($1.75) returned to Mm1VqYDg+pZQ8ufUXZHA1g
Mm1VqYDg+pZQ8ufUXZHA1g collected $3.10 from pot
Mm1VqYDg+pZQ8ufUXZHA1g: doesn't show hand 
*** SUMMARY ***
Total pot $3.25 | Rake $0.15 
Board [7s 7c Ah Qh]
Seat 1: COsrwJSFHQtxlUcrYtDQPQ folded on the Turn
Seat 3: /XMgGtJ7mcWfe5s7McY9kw (button) folded before Flop (didn't bet)
Seat 4: +5dSUwD+/k2ktlnutSMivw (small blind) folded on the Turn
Seat 5: Tx6zQdk5Ozt9ObEBlU7jeg (big blind) folded before Flop
Seat 6: 4awUyiDYTgylQKXZ9faBVA folded before Flop (didn't bet)
Seat 7: Mm1VqYDg+pZQ8ufUXZHA1g collected ($3.10)
Seat 9: LSrAei+fS8MYG9ie/GkG0Q folded before Flop (didn't bet)




PokerStars Game #59939418388:  Hold'em No Limit ($0.10/$0.25) - 2009/07/01 0:39:22 ET
Table 'WjNvuuSgTjm8jh0j9vcCgQ' 9-max Seat #8 is the button
Seat 1: NKymidkL3Kg3ILZPvtLSVg ($10 in chips) 
Seat 3: 8B/dhbQjIWe6ASCdgzktNQ ($25 in chips) 
Seat 4: 3PjJjazzeHcM4mbFeXmZBg ($20.20 in chips) 
Seat 5: Qi+clOtyDiibLdH2/1Qy8g ($18.10 in chips) 
Seat 7: DdPXdieucQ+n99u1n3A+rQ ($4.65 in chips) 
Seat 8: ghNKXUBl/H+t83JF079ZBA ($25 in chips) 
Seat 9: DiSvPC2iudwL5j9u6Huyww ($29.80 in chips) 
DiSvPC2iudwL5j9u6Huyww: posts small blind $0.10
NKymidkL3Kg3ILZPvtLSVg: posts big blind $0.25
9gmYYQesalMrUjaF7nKfrQ: sits out 
*** HOLE CARDS ***
8B/dhbQjIWe6ASCdgzktNQ: folds 
3PjJjazzeHcM4mbFeXmZBg: folds 
Qi+clOtyDiibLdH2/1Qy8g: folds 
DdPXdieucQ+n99u1n3A+rQ: folds 
ghNKXUBl/H+t83JF079ZBA: folds 
DiSvPC2iudwL5j9u6Huyww: raises $0.50 to $0.75
NKymidkL3Kg3ILZPvtLSVg: folds 
Uncalled bet ($0.50) returned to DiSvPC2iudwL5j9u6Huyww
DiSvPC2iudwL5j9u6Huyww collected $0.50 from pot
DiSvPC2iudwL5j9u6Huyww: doesn't show hand 
*** SUMMARY ***
Total pot $0.50 | Rake $0 
Seat 1: NKymidkL3Kg3ILZPvtLSVg (big blind) folded before Flop
Seat 3: 8B/dhbQjIWe6ASCdgzktNQ folded before Flop (didn't bet)
Seat 4: 3PjJjazzeHcM4mbFeXmZBg folded before Flop (didn't bet)
Seat 5: Qi+clOtyDiibLdH2/1Qy8g folded before Flop (didn't bet)
Seat 7: DdPXdieucQ+n99u1n3A+rQ folded before Flop (didn't bet)
Seat 8: ghNKXUBl/H+t83JF079ZBA (button) folded before Flop (didn't bet)
Seat 9: DiSvPC2iudwL5j9u6Huyww (small blind) collected ($0.50)




PokerStars Game #59939418372:  Hold'em No Limit ($0.10/$0.25) - 2009/07/01 0:39:22 ET
Table 'M7d9IrgQUUFFy/SZ3ksLYg' 6-max Seat #6 is the button
Seat 1: cPO/1/dTcZpLkQFm3jH3Rg ($34.30 in chips) 
Seat 2: JE/wJXmjw3bpdmjwvh2pcg ($25.35 in chips) 
Seat 3: eHsmIvAb2JREg4O6hNPnXg ($15.35 in chips) 
Seat 4: 7FmwVDcdEtxDpHmP4hOXsQ ($29.90 in chips) 
Seat 6: /gJNBeCkWL4o85/jvlZ4BA ($25.50 in chips) 
cPO/1/dTcZpLkQFm3jH3Rg: posts small blind $0.10
JE/wJXmjw3bpdmjwvh2pcg: posts big blind $0.25
*** HOLE CARDS ***
eHsmIvAb2JREg4O6hNPnXg: raises $0.75 to $1
7FmwVDcdEtxDpHmP4hOXsQ: folds 
/gJNBeCkWL4o85/jvlZ4BA: folds 
cPO/1/dTcZpLkQFm3jH3Rg: folds 
JE/wJXmjw3bpdmjwvh2pcg: folds 
Uncalled bet ($0.75) returned to eHsmIvAb2JREg4O6hNPnXg
eHsmIvAb2JREg4O6hNPnXg collected $0.60 from pot
*** SUMMARY ***
Total pot $0.60 | Rake $0 
Seat 1: cPO/1/dTcZpLkQFm3jH3Rg (small blind) folded before Flop
Seat 2: JE/wJXmjw3bpdmjwvh2pcg (big blind) folded before Flop
Seat 3: eHsmIvAb2JREg4O6hNPnXg collected ($0.60)
Seat 4: 7FmwVDcdEtxDpHmP4hOXsQ folded before Flop (didn't bet)
Seat 6: /gJNBeCkWL4o85/jvlZ4BA (button) folded before Flop (didn't bet)




PokerStars Game #59939418140:  Hold'em No Limit ($0.10/$0.25) - 2009/07/01 0:39:22 ET
Table 'MiquQrQZJJq9ZtgRIp9HFQ' 6-max Seat #1 is the button
Seat 1: hM0MSDtq2ow7J40bSR04ig ($7.90 in chips) 
Seat 2: DMQLAmut/l19xN5STQndFg ($4 in chips) 
Seat 4: 0HIrwssk0FQvyKULzUTtlg ($16.80 in chips) 
Seat 5: LXN9U+5F+9if/ead2+w1nw ($44.45 in chips) 
Seat 6: X9oXZTg4PhZVR+ilX2OYbA ($14.65 in chips) 
DMQLAmut/l19xN5STQndFg: posts small blind $0.10
0HIrwssk0FQvyKULzUTtlg: posts big blind $0.25
*** HOLE CARDS ***
LXN9U+5F+9if/ead2+w1nw: calls $0.25
X9oXZTg4PhZVR+ilX2OYbA: calls $0.25
hM0MSDtq2ow7J40bSR04ig: raises $0.25 to $0.50
DMQLAmut/l19xN5STQndFg: calls $0.40
0HIrwssk0FQvyKULzUTtlg: raises $2.50 to $3
LXN9U+5F+9if/ead2+w1nw: folds 
X9oXZTg4PhZVR+ilX2OYbA: folds 
hM0MSDtq2ow7J40bSR04ig: calls $2.50
DMQLAmut/l19xN5STQndFg: folds 
*** FLOP *** [Qh 7s 2d]
0HIrwssk0FQvyKULzUTtlg: bets $2
hM0MSDtq2ow7J40bSR04ig: folds 
Uncalled bet ($2) returned to 0HIrwssk0FQvyKULzUTtlg
0HIrwssk0FQvyKULzUTtlg collected $6.65 from pot
*** SUMMARY ***
Total pot $7 | Rake $0.35 
Board [Qh 7s 2d]
Seat 1: hM0MSDtq2ow7J40bSR04ig (button) folded on the Flop
Seat 2: DMQLAmut/l19xN5STQndFg (small blind) folded before Flop
Seat 4: 0HIrwssk0FQvyKULzUTtlg (big blind) collected ($6.65)
Seat 5: LXN9U+5F+9if/ead2+w1nw folded before Flop
Seat 6: X9oXZTg4PhZVR+ilX2OYbA folded before Flop




PokerStars Game #59939418320:  Hold'em No Limit ($0.10/$0.25) - 2009/07/01 0:39:22 ET
Table 'nc6OeGk/wtaWV+6N+kgnZQ' 6-max Seat #1 is the button
Seat 1: 0/FYfBoKhINaqU/H5OSS1A ($5.60 in chips) 
Seat 3: 8f0dtuUGqDbgE6up1lQAlg ($4.25 in chips) 
Seat 6: yJgjVkWgiJ8vdWZjcUod2A ($5.05 in chips) 
8f0dtuUGqDbgE6up1lQAlg: posts small blind $0.10
yJgjVkWgiJ8vdWZjcUod2A: posts big blind $0.25
*** HOLE CARDS ***
0/FYfBoKhINaqU/H5OSS1A: folds 
8f0dtuUGqDbgE6up1lQAlg: calls $0.15
yJgjVkWgiJ8vdWZjcUod2A: raises $0.75 to $1
8f0dtuUGqDbgE6up1lQAlg: folds 
Uncalled bet ($0.75) returned to yJgjVkWgiJ8vdWZjcUod2A
yJgjVkWgiJ8vdWZjcUod2A collected $0.50 from pot
yJgjVkWgiJ8vdWZjcUod2A: doesn't show hand 
*** SUMMARY ***
Total pot $0.50 | Rake $0 
Seat 1: 0/FYfBoKhINaqU/H5OSS1A (button) folded before Flop (didn't bet)
Seat 3: 8f0dtuUGqDbgE6up1lQAlg (small blind) folded before Flop
Seat 6: yJgjVkWgiJ8vdWZjcUod2A (big blind) collected ($0.50)




PokerStars Game #59939418222:  Hold'em No Limit ($0.10/$0.25) - 2009/07/01 0:39:22 ET
Table 'VuY5ej47Cy8nOI3Wogmhzw' 6-max Seat #4 is the button
Seat 3: 0n9nsjvz4GIG4IyVHT0JVw ($5.60 in chips) 
Seat 4: FC6tJ9EOiutXO8hnpR4VgQ ($3.95 in chips) 
Seat 6: +v0nBUereMsRzYp2Knh/cQ ($10.30 in chips) 
+v0nBUereMsRzYp2Knh/cQ: posts small blind $0.10
PUTXJX6bVODW3ITgBX0GuQ: is sitting out 
0n9nsjvz4GIG4IyVHT0JVw: posts big blind $0.25
*** HOLE CARDS ***
FC6tJ9EOiutXO8hnpR4VgQ: raises $0.75 to $1
+v0nBUereMsRzYp2Knh/cQ: folds 
0n9nsjvz4GIG4IyVHT0JVw: folds 
Uncalled bet ($0.75) returned to FC6tJ9EOiutXO8hnpR4VgQ
PUTXJX6bVODW3ITgBX0GuQ leaves the table
FC6tJ9EOiutXO8hnpR4VgQ collected $0.60 from pot
FC6tJ9EOiutXO8hnpR4VgQ: shows [Ks Qs] (high card King)
*** SUMMARY ***
Total pot $0.60 | Rake $0 
Seat 3: 0n9nsjvz4GIG4IyVHT0JVw (big blind) folded before Flop
Seat 4: FC6tJ9EOiutXO8hnpR4VgQ (button) collected ($0.60)
Seat 6: +v0nBUereMsRzYp2Knh/cQ (small blind) folded before Flop




PokerStars Game #59939418298:  Hold'em No Limit ($0.10/$0.25) - 2009/07/01 0:39:22 ET
Table 'tANpk8z1C5o0Pq/hpYShHw' 9-max Seat #7 is the button
Seat 2: og4yH4sZUZdC8jjgW8zPJQ ($7.05 in chips) 
Seat 3: zDrucyjVn5aeekNEc3cJrA ($21.25 in chips) 
Seat 4: dmQRblfPJL8cP867vJRZkg ($7.50 in chips) 
Seat 5: kWxV1qKcmWEussgWafGYNA ($45.50 in chips) 
Seat 6: Vp8EaqUO6YyqsnwsLR8SNQ ($13.75 in chips) 
Seat 7: sv2dZaqHRlfCDrW63Guhvg ($4.90 in chips) 
Seat 8: sPhk0wImgnCyx4aYrPXnHA ($24.50 in chips) 
Seat 9: gE5rN2TDY1aXcZn/TOPeZw ($13.90 in chips) 
sPhk0wImgnCyx4aYrPXnHA: posts small blind $0.10
gE5rN2TDY1aXcZn/TOPeZw: posts big blind $0.25
rQhYIYXSyH/IivYM1dlV5A: sits out 
*** HOLE CARDS ***
og4yH4sZUZdC8jjgW8zPJQ: folds 
zDrucyjVn5aeekNEc3cJrA: folds 
dmQRblfPJL8cP867vJRZkg: folds 
kWxV1qKcmWEussgWafGYNA: raises $0.50 to $0.75
Vp8EaqUO6YyqsnwsLR8SNQ: calls $0.75
sv2dZaqHRlfCDrW63Guhvg: raises $4.15 to $4.90 and is all-in
sPhk0wImgnCyx4aYrPXnHA: folds 
gE5rN2TDY1aXcZn/TOPeZw: folds 
kWxV1qKcmWEussgWafGYNA: calls $4.15
Vp8EaqUO6YyqsnwsLR8SNQ: folds 
*** FLOP *** [Ks 4s Ah]
*** TURN *** [Ks 4s Ah] [3h]
*** RIVER *** [Ks 4s Ah 3h] [4c]
*** SHOW DOWN ***
kWxV1qKcmWEussgWafGYNA: shows [7c 7d] (two pair, Sevens and Fours)
sv2dZaqHRlfCDrW63Guhvg: shows [Kc Qc] (two pair, Kings and Fours)
sv2dZaqHRlfCDrW63Guhvg collected $10.40 from pot
*** SUMMARY ***
Total pot $10.90 | Rake $0.50 
Board [Ks 4s Ah 3h 4c]
Seat 2: og4yH4sZUZdC8jjgW8zPJQ folded before Flop (didn't bet)
Seat 3: zDrucyjVn5aeekNEc3cJrA folded before Flop (didn't bet)
Seat 4: dmQRblfPJL8cP867vJRZkg folded before Flop (didn't bet)
Seat 5: kWxV1qKcmWEussgWafGYNA showed [7c 7d] and lost with two pair, Sevens and Fours
Seat 6: Vp8EaqUO6YyqsnwsLR8SNQ folded before Flop
Seat 7: sv2dZaqHRlfCDrW63Guhvg (button) showed [Kc Qc] and won ($10.40) with two pair, Kings and Fours
Seat 8: sPhk0wImgnCyx4aYrPXnHA (small blind) folded before Flop
Seat 9: gE5rN2TDY1aXcZn/TOPeZw (big blind) folded before Flop




PokerStars Game #59939418488:  Hold'em No Limit ($0.10/$0.25) - 2009/07/01 0:39:22 ET
Table '8kaMIn+aON/ferW89Go6Pw' 9-max Seat #5 is the button
Seat 1: st9jtdNbm1W5GfBwRaCVqQ ($23.50 in chips) 
Seat 2: jeKWRUkMaVn8rEUjnJKqpg ($25 in chips) 
Seat 3: 7cv+9Zc9HIQHNvYsMfV3uA ($27.95 in chips) 
Seat 4: KRWTiGM4xH+MkvPtJz4+SA ($47.90 in chips) 
Seat 5: hIss79a4pu7GzJZepfgOpg ($31.35 in chips) 
Seat 6: 1S/fpm+f42V/6MNZre+ccg ($25 in chips) 
Seat 7: HVKi9hnDyvzObpL08/OarQ ($22.25 in chips) 
Seat 9: DiSvPC2iudwL5j9u6Huyww ($25.35 in chips) 
1S/fpm+f42V/6MNZre+ccg: posts small blind $0.10
HVKi9hnDyvzObpL08/OarQ: posts big blind $0.25
*** HOLE CARDS ***
DiSvPC2iudwL5j9u6Huyww: folds 
st9jtdNbm1W5GfBwRaCVqQ: raises $0.75 to $1
f7p49X29YgYZCOxWxJo6Lw joins the table at seat #8 
jeKWRUkMaVn8rEUjnJKqpg: folds 
7cv+9Zc9HIQHNvYsMfV3uA: folds 
KRWTiGM4xH+MkvPtJz4+SA: folds 
hIss79a4pu7GzJZepfgOpg: folds 
1S/fpm+f42V/6MNZre+ccg: folds 
HVKi9hnDyvzObpL08/OarQ: folds 
Uncalled bet ($0.75) returned to st9jtdNbm1W5GfBwRaCVqQ
st9jtdNbm1W5GfBwRaCVqQ collected $0.60 from pot
st9jtdNbm1W5GfBwRaCVqQ: doesn't show hand 
*** SUMMARY ***
Total pot $0.60 | Rake $0 
Seat 1: st9jtdNbm1W5GfBwRaCVqQ collected ($0.60)
Seat 2: jeKWRUkMaVn8rEUjnJKqpg folded before Flop (didn't bet)
Seat 3: 7cv+9Zc9HIQHNvYsMfV3uA folded before Flop (didn't bet)
Seat 4: KRWTiGM4xH+MkvPtJz4+SA folded before Flop (didn't bet)
Seat 5: hIss79a4pu7GzJZepfgOpg (button) folded before Flop (didn't bet)
Seat 6: 1S/fpm+f42V/6MNZre+ccg (small blind) folded before Flop
Seat 7: HVKi9hnDyvzObpL08/OarQ (big blind) folded before Flop
Seat 9: DiSvPC2iudwL5j9u6Huyww folded before Flop (didn't bet)




PokerStars Game #59939418402:  Hold'em No Limit ($0.10/$0.25) - 2009/07/01 0:39:22 ET
Table '7eunnLa5p3aGsPrUrNnn/A' 9-max Seat #4 is the button
Seat 1: Ml2bY77EHbM51ZWD7dnIWg ($29.75 in chips) 
Seat 2: aJy680tKSaP5er559aSuGA ($12.25 in chips) 
Seat 3: E0iYnEVO2ho7dH3QcCjw7g ($19.80 in chips) 
Seat 4: opOCI2p6kW0tINuVaAqmcQ ($30.70 in chips) 
Seat 5: JLfmdpDbz2ljMNE7ICboMQ ($7.80 in chips) 
Seat 6: jx9kXw1SAZrvXp9Nerz8+Q ($16.95 in chips) 
Seat 8: 1Clf3cPrqoy/YgvWdWK1Xw ($5 in chips) 
Seat 9: rUpvA02nErFvZ4yFbDR8XA ($21.05 in chips) 
JLfmdpDbz2ljMNE7ICboMQ: posts small blind $0.10
jx9kXw1SAZrvXp9Nerz8+Q: posts big blind $0.25
*** HOLE CARDS ***
ZWU9RNYtjmm4cElg1I0F4w leaves the table
1Clf3cPrqoy/YgvWdWK1Xw: folds 
rUpvA02nErFvZ4yFbDR8XA: folds 
Ml2bY77EHbM51ZWD7dnIWg: folds 
aJy680tKSaP5er559aSuGA: folds 
E0iYnEVO2ho7dH3QcCjw7g: raises $0.75 to $1
opOCI2p6kW0tINuVaAqmcQ: folds 
JLfmdpDbz2ljMNE7ICboMQ: folds 
jx9kXw1SAZrvXp9Nerz8+Q: calls $0.75
*** FLOP *** [5s 2h 7d]
jx9kXw1SAZrvXp9Nerz8+Q: checks 
sD+TKtt36XiiN6jqHiLwDA joins the table at seat #7 
E0iYnEVO2ho7dH3QcCjw7g: bets $2
jx9kXw1SAZrvXp9Nerz8+Q: folds 
Uncalled bet ($2) returned to E0iYnEVO2ho7dH3QcCjw7g
E0iYnEVO2ho7dH3QcCjw7g collected $2 from pot
*** SUMMARY ***
Total pot $2.10 | Rake $0.10 
Board [5s 2h 7d]
Seat 1: Ml2bY77EHbM51ZWD7dnIWg folded before Flop (didn't bet)
Seat 2: aJy680tKSaP5er559aSuGA folded before Flop (didn't bet)
Seat 3: E0iYnEVO2ho7dH3QcCjw7g collected ($2)
Seat 4: opOCI2p6kW0tINuVaAqmcQ (button) folded before Flop (didn't bet)
Seat 5: JLfmdpDbz2ljMNE7ICboMQ (small blind) folded before Flop
Seat 6: jx9kXw1SAZrvXp9Nerz8+Q (big blind) folded on the Flop
Seat 8: 1Clf3cPrqoy/YgvWdWK1Xw folded before Flop (didn't bet)
Seat 9: rUpvA02nErFvZ4yFbDR8XA folded before Flop (didn't bet)




PokerStars Game #59939418852:  Hold'em No Limit ($0.10/$0.25) - 2009/07/01 0:39:23 ET
Table '/VaaaFnlEJoYVomG9uxHkA' 9-max Seat #6 is the button
Seat 2: DIkeSkosO/tsUp9d2JVyTA ($13.10 in chips) 
Seat 3: 32P5dKDi4pEUiDHMQTV1uw ($23.25 in chips) 
Seat 4: j4q3p0lesp63b1gZDwLBZw ($5 in chips) 
Seat 5: LWN1wPrLH+695JIriXxDuw ($12.60 in chips) 
Seat 6: 5MgYq10OC5iGoxQFwlJVuw ($14.45 in chips) 
Seat 7: PjjWswkn2akmg6ArntxvuA ($34.05 in chips) 
Seat 8: n9toqYXSLowQ/sWq842dEQ ($12 in chips) 
Seat 9: r1pFKMwWp74QwhfPWJOAyw ($5.80 in chips) 
PjjWswkn2akmg6ArntxvuA: posts small blind $0.10
n9toqYXSLowQ/sWq842dEQ: posts big blind $0.25
*** HOLE CARDS ***
r1pFKMwWp74QwhfPWJOAyw: folds 
DIkeSkosO/tsUp9d2JVyTA: raises $0.75 to $1
32P5dKDi4pEUiDHMQTV1uw: folds 
j4q3p0lesp63b1gZDwLBZw: folds 
LWN1wPrLH+695JIriXxDuw: calls $1
5MgYq10OC5iGoxQFwlJVuw: folds 
PjjWswkn2akmg6ArntxvuA: folds 
n9toqYXSLowQ/sWq842dEQ: calls $0.75
*** FLOP *** [6d 4d 2d]
n9toqYXSLowQ/sWq842dEQ: bets $1
DIkeSkosO/tsUp9d2JVyTA: calls $1
LWN1wPrLH+695JIriXxDuw: raises $2 to $3
n9toqYXSLowQ/sWq842dEQ: calls $2
DIkeSkosO/tsUp9d2JVyTA: calls $2
*** TURN *** [6d 4d 2d] [3d]
n9toqYXSLowQ/sWq842dEQ: checks 
DIkeSkosO/tsUp9d2JVyTA: checks 
LWN1wPrLH+695JIriXxDuw: checks 
*** RIVER *** [6d 4d 2d 3d] [3s]
n9toqYXSLowQ/sWq842dEQ: checks 
DIkeSkosO/tsUp9d2JVyTA: checks 
LWN1wPrLH+695JIriXxDuw: bets $4.50
n9toqYXSLowQ/sWq842dEQ: calls $4.50
DIkeSkosO/tsUp9d2JVyTA: folds 
*** SHOW DOWN ***
LWN1wPrLH+695JIriXxDuw: shows [2s 2c] (a full house, Deuces full of Threes)
n9toqYXSLowQ/sWq842dEQ: mucks hand 
LWN1wPrLH+695JIriXxDuw collected $20.10 from pot
*** SUMMARY ***
Total pot $21.10 | Rake $1 
Board [6d 4d 2d 3d 3s]
Seat 2: DIkeSkosO/tsUp9d2JVyTA folded on the River
Seat 3: 32P5dKDi4pEUiDHMQTV1uw folded before Flop (didn't bet)
Seat 4: j4q3p0lesp63b1gZDwLBZw folded before Flop (didn't bet)
Seat 5: LWN1wPrLH+695JIriXxDuw showed [2s 2c] and won ($20.10) with a full house, Deuces full of Threes
Seat 6: 5MgYq10OC5iGoxQFwlJVuw (button) folded before Flop (didn't bet)
Seat 7: PjjWswkn2akmg6ArntxvuA (small blind) folded before Flop
Seat 8: n9toqYXSLowQ/sWq842dEQ (big blind) mucked
Seat 9: r1pFKMwWp74QwhfPWJOAyw folded before Flop (didn't bet)




PokerStars Game #59939419344:  Hold'em No Limit ($0.10/$0.25) - 2009/07/01 0:39:23 ET
Table 'luMgmRPIo47e7iXDlheIwA' 6-max Seat #4 is the button
Seat 2: 4YSTu0Cdzpppe1lUgCZGCQ ($34.75 in chips) 
Seat 3: W6Y6au0wf7gRAlqJYgOezw ($15 in chips) 
Seat 4: n2OZezRXTtdzQt4SuIy8TQ ($26 in chips) 
Seat 5: kG34n23qFQA3nzdOJTQ1dA ($46.65 in chips) 
kG34n23qFQA3nzdOJTQ1dA: posts small blind $0.10
4YSTu0Cdzpppe1lUgCZGCQ: posts big blind $0.25
W6Y6au0wf7gRAlqJYgOezw: posts big blind $0.25
*** HOLE CARDS ***
W6Y6au0wf7gRAlqJYgOezw: checks 
n2OZezRXTtdzQt4SuIy8TQ: folds 
kG34n23qFQA3nzdOJTQ1dA: folds 
4YSTu0Cdzpppe1lUgCZGCQ: checks 
*** FLOP *** [As Kc Th]
4YSTu0Cdzpppe1lUgCZGCQ: checks 
W6Y6au0wf7gRAlqJYgOezw: checks 
*** TURN *** [As Kc Th] [Ah]
4YSTu0Cdzpppe1lUgCZGCQ: checks 
W6Y6au0wf7gRAlqJYgOezw: checks 
*** RIVER *** [As Kc Th Ah] [6h]
4YSTu0Cdzpppe1lUgCZGCQ: checks 
W6Y6au0wf7gRAlqJYgOezw: checks 
*** SHOW DOWN ***
4YSTu0Cdzpppe1lUgCZGCQ: shows [6s 3c] (two pair, Aces and Sixes)
W6Y6au0wf7gRAlqJYgOezw: mucks hand 
4YSTu0Cdzpppe1lUgCZGCQ collected $0.60 from pot
*** SUMMARY ***
Total pot $0.60 | Rake $0 
Board [As Kc Th Ah 6h]
Seat 2: 4YSTu0Cdzpppe1lUgCZGCQ (big blind) showed [6s 3c] and won ($0.60) with two pair, Aces and Sixes
Seat 3: W6Y6au0wf7gRAlqJYgOezw mucked
Seat 4: n2OZezRXTtdzQt4SuIy8TQ (button) folded before Flop (didn't bet)
Seat 5: kG34n23qFQA3nzdOJTQ1dA (small blind) folded before Flop




PokerStars Game #59939418794:  Hold'em No Limit ($0.10/$0.25) - 2009/07/01 0:39:23 ET
Table 'wixGE3Zge1qBdnpWijIl/w' 9-max Seat #2 is the button
Seat 1: EcWpc/mcsCWBGKsSdZaXbA ($24.65 in chips) 
Seat 2: vbD+Kd6m/X3hUBBcGpUKjA ($7.85 in chips) 
Seat 3: DdPXdieucQ+n99u1n3A+rQ ($4.75 in chips) 
Seat 4: 4oA316mXLIui1QY63GXBUg ($25 in chips) 
Seat 5: MIVCHqCqqlke0Lb0z7glcw ($27.05 in chips) 
Seat 6: TlEYI/zXzaKGGsmuvWFd2A ($17.45 in chips) 
Seat 7: qIaaweMCAGmy9HZFT4r/6A ($54.90 in chips) 
Seat 8: hIss79a4pu7GzJZepfgOpg ($25 in chips) 
Seat 9: r6hsffOo1iKmaPYKwAZmFw ($25.75 in chips) 
DdPXdieucQ+n99u1n3A+rQ: posts small blind $0.10
4oA316mXLIui1QY63GXBUg: posts big blind $0.25
*** HOLE CARDS ***
MIVCHqCqqlke0Lb0z7glcw: calls $0.25
TlEYI/zXzaKGGsmuvWFd2A: raises $0.50 to $0.75
qIaaweMCAGmy9HZFT4r/6A: folds 
hIss79a4pu7GzJZepfgOpg: folds 
r6hsffOo1iKmaPYKwAZmFw: folds 
EcWpc/mcsCWBGKsSdZaXbA: folds 
vbD+Kd6m/X3hUBBcGpUKjA: folds 
DdPXdieucQ+n99u1n3A+rQ: folds 
4oA316mXLIui1QY63GXBUg: folds 
MIVCHqCqqlke0Lb0z7glcw: calls $0.50
*** FLOP *** [3h 2h 3d]
MIVCHqCqqlke0Lb0z7glcw: checks 
TlEYI/zXzaKGGsmuvWFd2A: bets $1.25
MIVCHqCqqlke0Lb0z7glcw: calls $1.25
*** TURN *** [3h 2h 3d] [9s]
MIVCHqCqqlke0Lb0z7glcw: checks 
TlEYI/zXzaKGGsmuvWFd2A: bets $4
MIVCHqCqqlke0Lb0z7glcw: calls $4
*** RIVER *** [3h 2h 3d 9s] [8h]
MIVCHqCqqlke0Lb0z7glcw: bets $6
TlEYI/zXzaKGGsmuvWFd2A: calls $6
*** SHOW DOWN ***
MIVCHqCqqlke0Lb0z7glcw: shows [Kd Kh] (two pair, Kings and Threes)
TlEYI/zXzaKGGsmuvWFd2A: mucks hand 
MIVCHqCqqlke0Lb0z7glcw collected $23.20 from pot
*** SUMMARY ***
Total pot $24.35 | Rake $1.15 
Board [3h 2h 3d 9s 8h]
Seat 1: EcWpc/mcsCWBGKsSdZaXbA folded before Flop (didn't bet)
Seat 2: vbD+Kd6m/X3hUBBcGpUKjA (button) folded before Flop (didn't bet)
Seat 3: DdPXdieucQ+n99u1n3A+rQ (small blind) folded before Flop
Seat 4: 4oA316mXLIui1QY63GXBUg (big blind) folded before Flop
Seat 5: MIVCHqCqqlke0Lb0z7glcw showed [Kd Kh] and won ($23.20) with two pair, Kings and Threes
Seat 6: TlEYI/zXzaKGGsmuvWFd2A mucked
Seat 7: qIaaweMCAGmy9HZFT4r/6A folded before Flop (didn't bet)
Seat 8: hIss79a4pu7GzJZepfgOpg folded before Flop (didn't bet)
Seat 9: r6hsffOo1iKmaPYKwAZmFw folded before Flop (didn't bet)




PokerStars Game #59939418996:  Hold'em No Limit ($0.10/$0.25) - 2009/07/01 0:39:23 ET
Table '+VTTYgQLH1awDHk+IAxqGg' 9-max Seat #2 is the button
Seat 1: s7Q6uNouhe7aE8JdFb9E+A ($25.60 in chips) 
Seat 2: 86vbuhJsyH+nbEg5qpDLyQ ($24.65 in chips) 
Seat 3: rSMoem/92WmnPjtw2tSQkA ($22.45 in chips) 
Seat 4: gE5rN2TDY1aXcZn/TOPeZw ($10.20 in chips) 
Seat 5: yK+pRpUZrQ4FOJcfjJy1eg ($5.85 in chips) 
Seat 6: gAlaEiNZy/H/QuIVwzvHAQ ($16.10 in chips) 
Seat 7: W4TLQcZ2TiM73eIgpIvlGg ($26.55 in chips) 
Seat 8: rg+23WZbUM/1tFGv4XhYYA ($4.75 in chips) 
Seat 9: CFZ+ACzShzC3naaIaOjbYQ ($7.90 in chips) 
rSMoem/92WmnPjtw2tSQkA: posts small blind $0.10
gE5rN2TDY1aXcZn/TOPeZw: posts big blind $0.25
*** HOLE CARDS ***
yK+pRpUZrQ4FOJcfjJy1eg: folds 
gAlaEiNZy/H/QuIVwzvHAQ: calls $0.25
yK+pRpUZrQ4FOJcfjJy1eg leaves the table
sD+TKtt36XiiN6jqHiLwDA joins the table at seat #5 
W4TLQcZ2TiM73eIgpIvlGg has timed out
W4TLQcZ2TiM73eIgpIvlGg: folds 
W4TLQcZ2TiM73eIgpIvlGg is sitting out
rg+23WZbUM/1tFGv4XhYYA: folds 
CFZ+ACzShzC3naaIaOjbYQ: calls $0.25
s7Q6uNouhe7aE8JdFb9E+A: folds 
86vbuhJsyH+nbEg5qpDLyQ: calls $0.25
rSMoem/92WmnPjtw2tSQkA: calls $0.15
gE5rN2TDY1aXcZn/TOPeZw: checks 
*** FLOP *** [5s Ks Ts]
rSMoem/92WmnPjtw2tSQkA: checks 
gE5rN2TDY1aXcZn/TOPeZw: checks 
gAlaEiNZy/H/QuIVwzvHAQ: bets $0.25
CFZ+ACzShzC3naaIaOjbYQ: folds 
86vbuhJsyH+nbEg5qpDLyQ: calls $0.25
rSMoem/92WmnPjtw2tSQkA: calls $0.25
gE5rN2TDY1aXcZn/TOPeZw: calls $0.25
*** TURN *** [5s Ks Ts] [5h]
rSMoem/92WmnPjtw2tSQkA: bets $2.25
gE5rN2TDY1aXcZn/TOPeZw: folds 
gAlaEiNZy/H/QuIVwzvHAQ: calls $2.25
86vbuhJsyH+nbEg5qpDLyQ: folds 
*** RIVER *** [5s Ks Ts 5h] [Ac]
W4TLQcZ2TiM73eIgpIvlGg has returned
rSMoem/92WmnPjtw2tSQkA: bets $3.75
gAlaEiNZy/H/QuIVwzvHAQ: calls $3.75
*** SHOW DOWN ***
rSMoem/92WmnPjtw2tSQkA: shows [5d 9c] (three of a kind, Fives)
gAlaEiNZy/H/QuIVwzvHAQ: mucks hand 
rSMoem/92WmnPjtw2tSQkA collected $13.60 from pot
*** SUMMARY ***
Total pot $14.25 | Rake $0.65 
Board [5s Ks Ts 5h Ac]
Seat 1: s7Q6uNouhe7aE8JdFb9E+A folded before Flop (didn't bet)
Seat 2: 86vbuhJsyH+nbEg5qpDLyQ (button) folded on the Turn
Seat 3: rSMoem/92WmnPjtw2tSQkA (small blind) showed [5d 9c] and won ($13.60) with three of a kind, Fives
Seat 4: gE5rN2TDY1aXcZn/TOPeZw (big blind) folded on the Turn
Seat 5: yK+pRpUZrQ4FOJcfjJy1eg folded before Flop (didn't bet)
Seat 6: gAlaEiNZy/H/QuIVwzvHAQ mucked
Seat 7: W4TLQcZ2TiM73eIgpIvlGg folded before Flop (didn't bet)
Seat 8: rg+23WZbUM/1tFGv4XhYYA folded before Flop (didn't bet)
Seat 9: CFZ+ACzShzC3naaIaOjbYQ folded on the Flop




PokerStars Game #59939418814:  Hold'em No Limit ($0.10/$0.25) - 2009/07/01 0:39:23 ET
Table 'mF3KHGMaTpaBZbtBoyfTeg' 6-max Seat #1 is the button
Seat 1: 0HAB2GdCAM7p7V00xueAVQ ($9.30 in chips) 
Seat 2: 4x9jCqgSw4272dnaIqnanw ($4.40 in chips) 
Seat 3: Hzrn9DZJegEZICufTNYkrg ($14.75 in chips) 
Seat 4: FYepjhAvF8ZdVCmqHIy+eQ ($25.90 in chips) 
Seat 5: sEQx9G5Cu8k1HNdQasxvUA ($28.05 in chips) 
4x9jCqgSw4272dnaIqnanw: posts small blind $0.10
Hzrn9DZJegEZICufTNYkrg: posts big blind $0.25
*** HOLE CARDS ***
FYepjhAvF8ZdVCmqHIy+eQ: folds 
sEQx9G5Cu8k1HNdQasxvUA: folds 
0HAB2GdCAM7p7V00xueAVQ: calls $0.25
4x9jCqgSw4272dnaIqnanw: calls $0.15
Hzrn9DZJegEZICufTNYkrg: checks 
*** FLOP *** [Qs 9d 2s]
4x9jCqgSw4272dnaIqnanw: checks 
Hzrn9DZJegEZICufTNYkrg: checks 
0HAB2GdCAM7p7V00xueAVQ: bets $0.25
4x9jCqgSw4272dnaIqnanw: folds 
Hzrn9DZJegEZICufTNYkrg: folds 
Uncalled bet ($0.25) returned to 0HAB2GdCAM7p7V00xueAVQ
0HAB2GdCAM7p7V00xueAVQ collected $0.75 from pot
0HAB2GdCAM7p7V00xueAVQ: doesn't show hand 
*** SUMMARY ***
Total pot $0.75 | Rake $0 
Board [Qs 9d 2s]
Seat 1: 0HAB2GdCAM7p7V00xueAVQ (button) collected ($0.75)
Seat 2: 4x9jCqgSw4272dnaIqnanw (small blind) folded on the Flop
Seat 3: Hzrn9DZJegEZICufTNYkrg (big blind) folded on the Flop
Seat 4: FYepjhAvF8ZdVCmqHIy+eQ folded before Flop (didn't bet)
Seat 5: sEQx9G5Cu8k1HNdQasxvUA folded before Flop (didn't bet)




PokerStars Game #59939419062:  Hold'em No Limit ($0.10/$0.25) - 2009/07/01 0:39:23 ET
Table 'l57rayEpPtZotP9nqgSWBg' 6-max Seat #5 is the button
Seat 1: oseFhpinoe+Zg4j5xyBjyQ ($20.50 in chips) 
Seat 2: ErIN0JRL5srYjT6en1f8YQ ($25 in chips) 
Seat 3: sEQx9G5Cu8k1HNdQasxvUA ($40.15 in chips) 
Seat 4: NIALbunHAyYqmfMf7mrPhw ($5 in chips) 
Seat 5: TSmua8tGK3sTbwi0ynrW9Q ($59.40 in chips) 
tjhousyomama will be allowed to play after the button
oseFhpinoe+Zg4j5xyBjyQ: posts small blind $0.10
ErIN0JRL5srYjT6en1f8YQ: posts big blind $0.25
NIALbunHAyYqmfMf7mrPhw: posts big blind $0.25
*** HOLE CARDS ***
sEQx9G5Cu8k1HNdQasxvUA: folds 
NIALbunHAyYqmfMf7mrPhw: checks 
TSmua8tGK3sTbwi0ynrW9Q: folds 
oseFhpinoe+Zg4j5xyBjyQ: folds 
ErIN0JRL5srYjT6en1f8YQ: checks 
*** FLOP *** [Js 3h Th]
ErIN0JRL5srYjT6en1f8YQ: checks 
NIALbunHAyYqmfMf7mrPhw: checks 
*** TURN *** [Js 3h Th] [Ts]
ErIN0JRL5srYjT6en1f8YQ: checks 
NIALbunHAyYqmfMf7mrPhw: bets $0.25
ErIN0JRL5srYjT6en1f8YQ: folds 
Uncalled bet ($0.25) returned to NIALbunHAyYqmfMf7mrPhw
NIALbunHAyYqmfMf7mrPhw collected $0.60 from pot
*** SUMMARY ***
Total pot $0.60 | Rake $0 
Board [Js 3h Th Ts]
Seat 1: oseFhpinoe+Zg4j5xyBjyQ (small blind) folded before Flop
Seat 2: ErIN0JRL5srYjT6en1f8YQ (big blind) folded on the Turn
Seat 3: sEQx9G5Cu8k1HNdQasxvUA folded before Flop (didn't bet)
Seat 4: NIALbunHAyYqmfMf7mrPhw collected ($0.60)
Seat 5: TSmua8tGK3sTbwi0ynrW9Q (button) folded before Flop (didn't bet)




PokerStars Game #59939418790:  Hold'em No Limit ($0.10/$0.25) - 2009/07/01 0:39:23 ET
Table 'ggwTHpIC5qhhHJSYjK1XCw' 6-max Seat #2 is the button
Seat 1: BYxjLnV1/LL0aZcTbfAOvw ($31.50 in chips) 
Seat 2: mBAp/L4XPhNEkNUlUTV4Iw ($16.05 in chips) 
Seat 3: SxIIgwXYLkwd6m3wLyPTCw ($25 in chips) 
Seat 4: JFIAqU8lCZ0vWwEl4bdGsg ($25.75 in chips) 
Seat 5: 6zbQpY/G44U1Xvj7DZex0A ($12.45 in chips) 
Seat 6: QOk5VUJeDqXaA3RlMSluGA ($17.60 in chips) 
SxIIgwXYLkwd6m3wLyPTCw: posts small blind $0.10
JFIAqU8lCZ0vWwEl4bdGsg: posts big blind $0.25
*** HOLE CARDS ***
6zbQpY/G44U1Xvj7DZex0A: raises $0.25 to $0.50
QOk5VUJeDqXaA3RlMSluGA: calls $0.50
BYxjLnV1/LL0aZcTbfAOvw: raises $2 to $2.50
mBAp/L4XPhNEkNUlUTV4Iw: folds 
SxIIgwXYLkwd6m3wLyPTCw: folds 
JFIAqU8lCZ0vWwEl4bdGsg: folds 
6zbQpY/G44U1Xvj7DZex0A: calls $2
QOk5VUJeDqXaA3RlMSluGA: calls $2
*** FLOP *** [Jh Kc 9d]
6zbQpY/G44U1Xvj7DZex0A: checks 
QOk5VUJeDqXaA3RlMSluGA: checks 
BYxjLnV1/LL0aZcTbfAOvw: checks 
*** TURN *** [Jh Kc 9d] [5h]
6zbQpY/G44U1Xvj7DZex0A: checks 
QOk5VUJeDqXaA3RlMSluGA: bets $3.90
BYxjLnV1/LL0aZcTbfAOvw: folds 
6zbQpY/G44U1Xvj7DZex0A: calls $3.90
*** RIVER *** [Jh Kc 9d 5h] [6h]
6zbQpY/G44U1Xvj7DZex0A: checks 
QOk5VUJeDqXaA3RlMSluGA: checks 
*** SHOW DOWN ***
6zbQpY/G44U1Xvj7DZex0A: shows [7s 6s] (a pair of Sixes)
QOk5VUJeDqXaA3RlMSluGA: mucks hand 
6zbQpY/G44U1Xvj7DZex0A collected $14.90 from pot
*** SUMMARY ***
Total pot $15.65 | Rake $0.75 
Board [Jh Kc 9d 5h 6h]
Seat 1: BYxjLnV1/LL0aZcTbfAOvw folded on the Turn
Seat 2: mBAp/L4XPhNEkNUlUTV4Iw (button) folded before Flop (didn't bet)
Seat 3: SxIIgwXYLkwd6m3wLyPTCw (small blind) folded before Flop
Seat 4: JFIAqU8lCZ0vWwEl4bdGsg (big blind) folded before Flop
Seat 5: 6zbQpY/G44U1Xvj7DZex0A showed [7s 6s] and won ($14.90) with a pair of Sixes
Seat 6: QOk5VUJeDqXaA3RlMSluGA mucked




PokerStars Game #59939419956:  Hold'em No Limit ($0.10/$0.25) - 2009/07/01 0:39:24 ET
Table 'tErGGDyESv/0llKumVeZuQ' 9-max Seat #8 is the button
Seat 1: R3KkgiqTvuhazyCqaD9cZg ($10 in chips) 
Seat 2: fnmp9YBEeLxBFinW2Sx+pg ($9.60 in chips) 
Seat 4: j1oAjkBBlFRUy+e+LF1vNQ ($4.70 in chips) 
Seat 6: zDrucyjVn5aeekNEc3cJrA ($29.25 in chips) 
Seat 7: s7Q6uNouhe7aE8JdFb9E+A ($25.65 in chips) 
Seat 8: Sv38qYH3jj8a8dddDi1aUA ($14.50 in chips) 
Seat 9: r284m4NA4rtNktI86R8/Yw ($15.55 in chips) 
r284m4NA4rtNktI86R8/Yw: posts small blind $0.10
R3KkgiqTvuhazyCqaD9cZg: posts big blind $0.25
*** HOLE CARDS ***
fnmp9YBEeLxBFinW2Sx+pg: folds 
j1oAjkBBlFRUy+e+LF1vNQ: calls $0.25
Apinooso joins the table at seat #3 
zDrucyjVn5aeekNEc3cJrA: folds 
s7Q6uNouhe7aE8JdFb9E+A: folds 
Sv38qYH3jj8a8dddDi1aUA: folds 
r284m4NA4rtNktI86R8/Yw: calls $0.15
R3KkgiqTvuhazyCqaD9cZg: raises $0.75 to $1
le+pqvOEeS8Vvxt8ogLv/w has returned
j1oAjkBBlFRUy+e+LF1vNQ: calls $0.75
r284m4NA4rtNktI86R8/Yw: calls $0.75
*** FLOP *** [Kd Kc 7c]
r284m4NA4rtNktI86R8/Yw: checks 
R3KkgiqTvuhazyCqaD9cZg: bets $1.50
j1oAjkBBlFRUy+e+LF1vNQ: folds 
r284m4NA4rtNktI86R8/Yw: folds 
Uncalled bet ($1.50) returned to R3KkgiqTvuhazyCqaD9cZg
R3KkgiqTvuhazyCqaD9cZg collected $2.85 from pot
R3KkgiqTvuhazyCqaD9cZg: doesn't show hand 
*** SUMMARY ***
Total pot $3 | Rake $0.15 
Board [Kd Kc 7c]
Seat 1: R3KkgiqTvuhazyCqaD9cZg (big blind) collected ($2.85)
Seat 2: fnmp9YBEeLxBFinW2Sx+pg folded before Flop (didn't bet)
Seat 4: j1oAjkBBlFRUy+e+LF1vNQ folded on the Flop
Seat 6: zDrucyjVn5aeekNEc3cJrA folded before Flop (didn't bet)
Seat 7: s7Q6uNouhe7aE8JdFb9E+A folded before Flop (didn't bet)
Seat 8: Sv38qYH3jj8a8dddDi1aUA (button) folded before Flop (didn't bet)
Seat 9: r284m4NA4rtNktI86R8/Yw (small blind) folded on the Flop




PokerStars Game #59939419678:  Hold'em No Limit ($0.10/$0.25) - 2009/07/01 0:39:24 ET
Table 'mdub7rJf3Z5tCT9s/+1+Wg' 9-max Seat #6 is the button
Seat 1: neWdS67T0XWLJXFjrqXj5g ($15.75 in chips) 
Seat 2: vSkQm2EelzwRGDDQQk0Fqw ($4.65 in chips) 
Seat 3: t2nb95S5EEFOEzNx9Itz0g ($5 in chips) 
Seat 4: fDGyaQz0cs2s4FOYxkbIHA ($4.55 in chips) 
Seat 5: dfNim92Z6XK1/h5SFW5vDg ($25 in chips) 
Seat 6: hAFbY0iBwr4mouozgvjZBg ($47.60 in chips) 
Seat 7: woe+9KKk+L3pZgMTuHcmog ($31.80 in chips) 
Seat 8: cZ99hugmLBj9KhTlc8nCSw ($25 in chips) 
Seat 9: tYsOBqdU1+x+yFI7zHO7hQ ($36.75 in chips) 
woe+9KKk+L3pZgMTuHcmog: posts small blind $0.10
cZ99hugmLBj9KhTlc8nCSw: posts big blind $0.25
*** HOLE CARDS ***
tYsOBqdU1+x+yFI7zHO7hQ: folds 
neWdS67T0XWLJXFjrqXj5g: raises $0.50 to $0.75
vSkQm2EelzwRGDDQQk0Fqw: folds 
t2nb95S5EEFOEzNx9Itz0g: folds 
fDGyaQz0cs2s4FOYxkbIHA: folds 
dfNim92Z6XK1/h5SFW5vDg: folds 
hAFbY0iBwr4mouozgvjZBg: folds 
woe+9KKk+L3pZgMTuHcmog: folds 
cZ99hugmLBj9KhTlc8nCSw: folds 
Uncalled bet ($0.50) returned to neWdS67T0XWLJXFjrqXj5g
neWdS67T0XWLJXFjrqXj5g collected $0.60 from pot
neWdS67T0XWLJXFjrqXj5g: doesn't show hand 
*** SUMMARY ***
Total pot $0.60 | Rake $0 
Seat 1: neWdS67T0XWLJXFjrqXj5g collected ($0.60)
Seat 2: vSkQm2EelzwRGDDQQk0Fqw folded before Flop (didn't bet)
Seat 3: t2nb95S5EEFOEzNx9Itz0g folded before Flop (didn't bet)
Seat 4: fDGyaQz0cs2s4FOYxkbIHA folded before Flop (didn't bet)
Seat 5: dfNim92Z6XK1/h5SFW5vDg folded before Flop (didn't bet)
Seat 6: hAFbY0iBwr4mouozgvjZBg (button) folded before Flop (didn't bet)
Seat 7: woe+9KKk+L3pZgMTuHcmog (small blind) folded before Flop
Seat 8: cZ99hugmLBj9KhTlc8nCSw (big blind) folded before Flop
Seat 9: tYsOBqdU1+x+yFI7zHO7hQ folded before Flop (didn't bet)




PokerStars Game #59939420562:  Hold'em No Limit ($0.10/$0.25) - 2009/07/01 0:39:25 ET
Table 'sDHjMRwfSiz7+NDdZLUiyA' 9-max Seat #4 is the button
Seat 1: N6fYvIzQLKaydFLKQGtMlQ ($25.90 in chips) 
Seat 2: ljemhp25Zg+nlA9DLCIiUw ($27.50 in chips) 
Seat 4: v5jnQ1gfh9nLla3kMXG7Yg ($16.15 in chips) 
Seat 8: 3hMkm4U5yTRrkGJkxfijaQ ($30.45 in chips) 
Seat 9: Xpyqpb+DURDWnyJ3xTEIFQ ($38.25 in chips) 
3hMkm4U5yTRrkGJkxfijaQ: posts small blind $0.10
Xpyqpb+DURDWnyJ3xTEIFQ: posts big blind $0.25
*** HOLE CARDS ***
N6fYvIzQLKaydFLKQGtMlQ: folds 
ljemhp25Zg+nlA9DLCIiUw: folds 
torch65 joins the table at seat #3 
v5jnQ1gfh9nLla3kMXG7Yg: calls $0.25
3hMkm4U5yTRrkGJkxfijaQ: calls $0.15
Xpyqpb+DURDWnyJ3xTEIFQ: checks 
*** FLOP *** [Js Kc Qd]
3hMkm4U5yTRrkGJkxfijaQ: checks 
Xpyqpb+DURDWnyJ3xTEIFQ: checks 
v5jnQ1gfh9nLla3kMXG7Yg: checks 
*** TURN *** [Js Kc Qd] [8h]
3hMkm4U5yTRrkGJkxfijaQ: checks 
Xpyqpb+DURDWnyJ3xTEIFQ: checks 
v5jnQ1gfh9nLla3kMXG7Yg: checks 
*** RIVER *** [Js Kc Qd 8h] [Kd]
3hMkm4U5yTRrkGJkxfijaQ: checks 
Xpyqpb+DURDWnyJ3xTEIFQ: checks 
v5jnQ1gfh9nLla3kMXG7Yg: checks 
*** SHOW DOWN ***
3hMkm4U5yTRrkGJkxfijaQ: shows [4h 5s] (a pair of Kings)
Xpyqpb+DURDWnyJ3xTEIFQ: shows [9h 7h] (a pair of Kings - Queen+Jack+Nine kicker)
v5jnQ1gfh9nLla3kMXG7Yg: shows [5c Th] (a pair of Kings - Queen+Jack+Ten kicker)
v5jnQ1gfh9nLla3kMXG7Yg collected $0.75 from pot
*** SUMMARY ***
Total pot $0.75 | Rake $0 
Board [Js Kc Qd 8h Kd]
Seat 1: N6fYvIzQLKaydFLKQGtMlQ folded before Flop (didn't bet)
Seat 2: ljemhp25Zg+nlA9DLCIiUw folded before Flop (didn't bet)
Seat 4: v5jnQ1gfh9nLla3kMXG7Yg (button) showed [5c Th] and won ($0.75) with a pair of Kings
Seat 8: 3hMkm4U5yTRrkGJkxfijaQ (small blind) showed [4h 5s] and lost with a pair of Kings
Seat 9: Xpyqpb+DURDWnyJ3xTEIFQ (big blind) showed [9h 7h] and lost with a pair of Kings




PokerStars Game #59939420478:  Hold'em No Limit ($0.10/$0.25) - 2009/07/01 0:39:25 ET
Table 'M8kYidAX3ib7pLKW7edFLw' 6-max Seat #4 is the button
Seat 1: 4YSTu0Cdzpppe1lUgCZGCQ ($39.90 in chips) 
Seat 4: /bjna2FTN7pPjqYGzmDE0Q ($23.50 in chips) 
Seat 5: bDKopKTvPi3W+PEnYUX3tg ($27.95 in chips) 
bDKopKTvPi3W+PEnYUX3tg: posts small blind $0.10
4YSTu0Cdzpppe1lUgCZGCQ: posts big blind $0.25
*** HOLE CARDS ***
/bjna2FTN7pPjqYGzmDE0Q: raises $0.45 to $0.70
bDKopKTvPi3W+PEnYUX3tg: folds 
4YSTu0Cdzpppe1lUgCZGCQ: folds 
Uncalled bet ($0.45) returned to /bjna2FTN7pPjqYGzmDE0Q
/bjna2FTN7pPjqYGzmDE0Q collected $0.60 from pot
/bjna2FTN7pPjqYGzmDE0Q: doesn't show hand 
*** SUMMARY ***
Total pot $0.60 | Rake $0 
Seat 1: 4YSTu0Cdzpppe1lUgCZGCQ (big blind) folded before Flop
Seat 4: /bjna2FTN7pPjqYGzmDE0Q (button) collected ($0.60)
Seat 5: bDKopKTvPi3W+PEnYUX3tg (small blind) folded before Flop




PokerStars Game #59939420504:  Hold'em No Limit ($0.10/$0.25) - 2009/07/01 0:39:25 ET
Table 'isKy4XK8wJM0x735/D4hWA' 6-max Seat #5 is the button
Seat 1: 7FmwVDcdEtxDpHmP4hOXsQ ($25.85 in chips) 
Seat 5: zlYHXTtJ5tcx9kwK2h5n9A ($37.40 in chips) 
Seat 6: M6xK/VklCvdyyrmvzATlxQ ($13.85 in chips) 
M6xK/VklCvdyyrmvzATlxQ: posts small blind $0.10
7FmwVDcdEtxDpHmP4hOXsQ: posts big blind $0.25
*** HOLE CARDS ***
zlYHXTtJ5tcx9kwK2h5n9A: folds 
WrLI51S2iMb8GLMB83gGqA joins the table at seat #2 
M6xK/VklCvdyyrmvzATlxQ: folds 
Uncalled bet ($0.15) returned to 7FmwVDcdEtxDpHmP4hOXsQ
7FmwVDcdEtxDpHmP4hOXsQ collected $0.20 from pot
7FmwVDcdEtxDpHmP4hOXsQ: doesn't show hand 
*** SUMMARY ***
Total pot $0.20 | Rake $0 
Seat 1: 7FmwVDcdEtxDpHmP4hOXsQ (big blind) collected ($0.20)
Seat 5: zlYHXTtJ5tcx9kwK2h5n9A (button) folded before Flop (didn't bet)
Seat 6: M6xK/VklCvdyyrmvzATlxQ (small blind) folded before Flop




PokerStars Game #59939420138:  Hold'em No Limit ($0.10/$0.25) - 2009/07/01 0:39:25 ET
Table '63h13e5p7cWe02rClZ1CHw' 6-max Seat #4 is the button
Seat 1: 7VfhiFY533nbUKvyEthASw ($14.40 in chips) 
Seat 2: k9nHZTHt8hYhYRcW8NTb4g ($10.15 in chips) 
Seat 3: 9jSiy0meE9XJKkdIZwyTEQ ($34.25 in chips) 
Seat 4: myagrRAhs0mdgmh5GNqvCw ($6.10 in chips) 
Seat 5: bE34il0XYGjWPD5/vbkMaQ ($12 in chips) 
Seat 6: mfrkWA3PTeYPkbO6hi98Aw ($35.10 in chips) 
bE34il0XYGjWPD5/vbkMaQ: posts small blind $0.10
mfrkWA3PTeYPkbO6hi98Aw: posts big blind $0.25
*** HOLE CARDS ***
7VfhiFY533nbUKvyEthASw: folds 
k9nHZTHt8hYhYRcW8NTb4g: folds 
9jSiy0meE9XJKkdIZwyTEQ: folds 
myagrRAhs0mdgmh5GNqvCw: calls $0.25
bE34il0XYGjWPD5/vbkMaQ: calls $0.15
mfrkWA3PTeYPkbO6hi98Aw: raises $1.25 to $1.50
myagrRAhs0mdgmh5GNqvCw: calls $1.25
bE34il0XYGjWPD5/vbkMaQ: calls $1.25
*** FLOP *** [7d 8s 5c]
bE34il0XYGjWPD5/vbkMaQ: checks 
mfrkWA3PTeYPkbO6hi98Aw: bets $3.50
myagrRAhs0mdgmh5GNqvCw: folds 
bE34il0XYGjWPD5/vbkMaQ: calls $3.50
*** TURN *** [7d 8s 5c] [Ad]
bE34il0XYGjWPD5/vbkMaQ: bets $7 and is all-in
mfrkWA3PTeYPkbO6hi98Aw: calls $7
*** RIVER *** [7d 8s 5c Ad] [7h]
*** SHOW DOWN ***
bE34il0XYGjWPD5/vbkMaQ: shows [As 6s] (two pair, Aces and Sevens)
mfrkWA3PTeYPkbO6hi98Aw: mucks hand 
bE34il0XYGjWPD5/vbkMaQ collected $24.30 from pot
*** SUMMARY ***
Total pot $25.50 | Rake $1.20 
Board [7d 8s 5c Ad 7h]
Seat 1: 7VfhiFY533nbUKvyEthASw folded before Flop (didn't bet)
Seat 2: k9nHZTHt8hYhYRcW8NTb4g folded before Flop (didn't bet)
Seat 3: 9jSiy0meE9XJKkdIZwyTEQ folded before Flop (didn't bet)
Seat 4: myagrRAhs0mdgmh5GNqvCw (button) folded on the Flop
Seat 5: bE34il0XYGjWPD5/vbkMaQ (small blind) showed [As 6s] and won ($24.30) with two pair, Aces and Sevens
Seat 6: mfrkWA3PTeYPkbO6hi98Aw (big blind) mucked




PokerStars Game #59939420604:  Hold'em No Limit ($0.10/$0.25) - 2009/07/01 0:39:25 ET
Table '84TjTrgbsYZladOc4PWf4Q' 6-max Seat #5 is the button
Seat 1: 79ID/ub1Pt/mDpCprVmOoA ($29.65 in chips) 
Seat 2: qGHGf/553gQnDoklMRe3tg ($31.90 in chips) 
Seat 3: BYxjLnV1/LL0aZcTbfAOvw ($38.05 in chips) 
Seat 4: SxIIgwXYLkwd6m3wLyPTCw ($25 in chips) 
Seat 5: SFmT9ZsVopnukjvAzrxTRg ($36.85 in chips) 
Seat 6: 7qRk4YH4/k/08LgJSv7rBQ ($24.10 in chips) 
7qRk4YH4/k/08LgJSv7rBQ: posts small blind $0.10
79ID/ub1Pt/mDpCprVmOoA: posts big blind $0.25
*** HOLE CARDS ***
qGHGf/553gQnDoklMRe3tg: folds 
BYxjLnV1/LL0aZcTbfAOvw: folds 
SxIIgwXYLkwd6m3wLyPTCw: folds 
SFmT9ZsVopnukjvAzrxTRg: folds 
7qRk4YH4/k/08LgJSv7rBQ: folds 
Uncalled bet ($0.15) returned to 79ID/ub1Pt/mDpCprVmOoA
79ID/ub1Pt/mDpCprVmOoA collected $0.20 from pot
79ID/ub1Pt/mDpCprVmOoA: doesn't show hand 
*** SUMMARY ***
Total pot $0.20 | Rake $0 
Seat 1: 79ID/ub1Pt/mDpCprVmOoA (big blind) collected ($0.20)
Seat 2: qGHGf/553gQnDoklMRe3tg folded before Flop (didn't bet)
Seat 3: BYxjLnV1/LL0aZcTbfAOvw folded before Flop (didn't bet)
Seat 4: SxIIgwXYLkwd6m3wLyPTCw folded before Flop (didn't bet)
Seat 5: SFmT9ZsVopnukjvAzrxTRg (button) folded before Flop (didn't bet)
Seat 6: 7qRk4YH4/k/08LgJSv7rBQ (small blind) folded before Flop




PokerStars Game #59939420660:  Hold'em No Limit ($0.10/$0.25) - 2009/07/01 0:39:25 ET
Table 'O6cwjhrMn9pfzx1Ngn5zkQ' 6-max Seat #6 is the button
Seat 1: k4mJ9nD/YOVTl8/kGW+U6w ($13.80 in chips) 
Seat 2: M6xK/VklCvdyyrmvzATlxQ ($13.30 in chips) 
Seat 3: EE16Ua5b1HSsYej5zeXOlA ($25 in chips) 
Seat 4: wKFJ513ucluNNiMlkXcDOQ ($31.75 in chips) 
Seat 5: niLn0xUVlqh8If80xRjzCA ($24 in chips) 
Seat 6: d0J1xuhsynEY81YHwAvJ5g ($27.05 in chips) 
k4mJ9nD/YOVTl8/kGW+U6w: posts small blind $0.10
M6xK/VklCvdyyrmvzATlxQ: posts big blind $0.25
*** HOLE CARDS ***
EE16Ua5b1HSsYej5zeXOlA: folds 
wKFJ513ucluNNiMlkXcDOQ: folds 
niLn0xUVlqh8If80xRjzCA: calls $0.25
d0J1xuhsynEY81YHwAvJ5g: folds 
k4mJ9nD/YOVTl8/kGW+U6w: folds 
M6xK/VklCvdyyrmvzATlxQ: checks 
*** FLOP *** [8h 9c 9d]
M6xK/VklCvdyyrmvzATlxQ: checks 
niLn0xUVlqh8If80xRjzCA: checks 
*** TURN *** [8h 9c 9d] [7s]
M6xK/VklCvdyyrmvzATlxQ: checks 
niLn0xUVlqh8If80xRjzCA: checks 
*** RIVER *** [8h 9c 9d 7s] [2d]
M6xK/VklCvdyyrmvzATlxQ: bets $0.25
niLn0xUVlqh8If80xRjzCA: raises $0.25 to $0.50
M6xK/VklCvdyyrmvzATlxQ: calls $0.25
*** SHOW DOWN ***
niLn0xUVlqh8If80xRjzCA: shows [Ad 6s] (a pair of Nines)
M6xK/VklCvdyyrmvzATlxQ: shows [7d 6c] (two pair, Nines and Sevens)
M6xK/VklCvdyyrmvzATlxQ collected $1.55 from pot
*** SUMMARY ***
Total pot $1.60 | Rake $0.05 
Board [8h 9c 9d 7s 2d]
Seat 1: k4mJ9nD/YOVTl8/kGW+U6w (small blind) folded before Flop
Seat 2: M6xK/VklCvdyyrmvzATlxQ (big blind) showed [7d 6c] and won ($1.55) with two pair, Nines and Sevens
Seat 3: EE16Ua5b1HSsYej5zeXOlA folded before Flop (didn't bet)
Seat 4: wKFJ513ucluNNiMlkXcDOQ folded before Flop (didn't bet)
Seat 5: niLn0xUVlqh8If80xRjzCA showed [Ad 6s] and lost with a pair of Nines
Seat 6: d0J1xuhsynEY81YHwAvJ5g (button) folded before Flop (didn't bet)




PokerStars Game #59939420652:  Hold'em No Limit ($0.10/$0.25) - 2009/07/01 0:39:25 ET
Table 'VQNfcI8vTBCTvRfd3veTLQ' 6-max Seat #5 is the button
Seat 1: ymz+a8dgHSUFPooYplw7Ow ($24.10 in chips) 
Seat 2: KukIGupqqJCXA+Hp2bEFnA ($6.45 in chips) 
Seat 3: LtASJ9OlkqGrrUKGQlpGAw ($23.40 in chips) 
Seat 4: nc79pm0LZRdhncq55evVqA ($25.80 in chips) 
Seat 5: gX2vbKwS/8zZPENAWB7hxQ ($7.65 in chips) 
Seat 6: dlCLwmcvRShnuFDEVkdIEA ($14.85 in chips) 
dlCLwmcvRShnuFDEVkdIEA: posts small blind $0.10
ymz+a8dgHSUFPooYplw7Ow: posts big blind $0.25
*** HOLE CARDS ***
KukIGupqqJCXA+Hp2bEFnA: folds 
LtASJ9OlkqGrrUKGQlpGAw: folds 
nc79pm0LZRdhncq55evVqA: raises $0.75 to $1
gX2vbKwS/8zZPENAWB7hxQ: folds 
dlCLwmcvRShnuFDEVkdIEA: calls $0.90
ymz+a8dgHSUFPooYplw7Ow: folds 
*** FLOP *** [Ac Qc 7c]
dlCLwmcvRShnuFDEVkdIEA: checks 
nc79pm0LZRdhncq55evVqA: bets $1.50
dlCLwmcvRShnuFDEVkdIEA: calls $1.50
*** TURN *** [Ac Qc 7c] [3d]
dlCLwmcvRShnuFDEVkdIEA: checks 
nc79pm0LZRdhncq55evVqA: checks 
*** RIVER *** [Ac Qc 7c 3d] [7d]
dlCLwmcvRShnuFDEVkdIEA: checks 
nc79pm0LZRdhncq55evVqA: bets $3
dlCLwmcvRShnuFDEVkdIEA: folds 
Uncalled bet ($3) returned to nc79pm0LZRdhncq55evVqA
nc79pm0LZRdhncq55evVqA collected $5 from pot
nc79pm0LZRdhncq55evVqA: doesn't show hand 
*** SUMMARY ***
Total pot $5.25 | Rake $0.25 
Board [Ac Qc 7c 3d 7d]
Seat 1: ymz+a8dgHSUFPooYplw7Ow (big blind) folded before Flop
Seat 2: KukIGupqqJCXA+Hp2bEFnA folded before Flop (didn't bet)
Seat 3: LtASJ9OlkqGrrUKGQlpGAw folded before Flop (didn't bet)
Seat 4: nc79pm0LZRdhncq55evVqA collected ($5)
Seat 5: gX2vbKwS/8zZPENAWB7hxQ (button) folded before Flop (didn't bet)
Seat 6: dlCLwmcvRShnuFDEVkdIEA (small blind) folded on the River




PokerStars Game #59939420948:  Hold'em No Limit ($0.10/$0.25) - 2009/07/01 0:39:26 ET
Table 'ShgkxBDL5IvR1qjzfRNc0A' 6-max Seat #6 is the button
Seat 1: /gJNBeCkWL4o85/jvlZ4BA ($25 in chips) 
Seat 2: mfrkWA3PTeYPkbO6hi98Aw ($38.85 in chips) 
Seat 3: JXSfL0FgBM1dIFwHP09Hnw ($25 in chips) 
Seat 4: kG34n23qFQA3nzdOJTQ1dA ($24.75 in chips) 
Seat 5: ferjiUxLWPNUKxvl8/xD/g ($44.30 in chips) 
Seat 6: 5tB0F9NjPSUL4FzmzBMs2Q ($30.20 in chips) 
/gJNBeCkWL4o85/jvlZ4BA: posts small blind $0.10
mfrkWA3PTeYPkbO6hi98Aw: posts big blind $0.25
*** HOLE CARDS ***
JXSfL0FgBM1dIFwHP09Hnw: folds 
kG34n23qFQA3nzdOJTQ1dA: folds 
ferjiUxLWPNUKxvl8/xD/g: folds 
5tB0F9NjPSUL4FzmzBMs2Q: folds 
/gJNBeCkWL4o85/jvlZ4BA: folds 
Uncalled bet ($0.15) returned to mfrkWA3PTeYPkbO6hi98Aw
mfrkWA3PTeYPkbO6hi98Aw collected $0.20 from pot
mfrkWA3PTeYPkbO6hi98Aw: doesn't show hand 
*** SUMMARY ***
Total pot $0.20 | Rake $0 
Seat 1: /gJNBeCkWL4o85/jvlZ4BA (small blind) folded before Flop
Seat 2: mfrkWA3PTeYPkbO6hi98Aw (big blind) collected ($0.20)
Seat 3: JXSfL0FgBM1dIFwHP09Hnw folded before Flop (didn't bet)
Seat 4: kG34n23qFQA3nzdOJTQ1dA folded before Flop (didn't bet)
Seat 5: ferjiUxLWPNUKxvl8/xD/g folded before Flop (didn't bet)
Seat 6: 5tB0F9NjPSUL4FzmzBMs2Q (button) folded before Flop (didn't bet)




PokerStars Game #59939420846:  Hold'em No Limit ($0.10/$0.25) - 2009/07/01 0:39:26 ET
Table 'KU/HrxqxwDz8HKEhYTZ6uw' 6-max Seat #1 is the button
Seat 1: gaPMxLGp9SOj4Lq6t+/0Ig ($27.65 in chips) 
Seat 2: kG34n23qFQA3nzdOJTQ1dA ($24.75 in chips) 
Seat 3: 3seg9SJ1y+HUPN0X0XKF5Q ($12.20 in chips) 
Seat 4: +yxuvzJHyIWsJ515X8zJTQ ($1.15 in chips) 
Seat 5: 4YSTu0Cdzpppe1lUgCZGCQ ($35.45 in chips) 
Seat 6: QIWnfLSqfMcoFfdDe5LZPg ($9.30 in chips) 
kG34n23qFQA3nzdOJTQ1dA: posts small blind $0.10
3seg9SJ1y+HUPN0X0XKF5Q: posts big blind $0.25
*** HOLE CARDS ***
+yxuvzJHyIWsJ515X8zJTQ: calls $0.25
4YSTu0Cdzpppe1lUgCZGCQ: folds 
QIWnfLSqfMcoFfdDe5LZPg: calls $0.25
gaPMxLGp9SOj4Lq6t+/0Ig: folds 
kG34n23qFQA3nzdOJTQ1dA: folds 
3seg9SJ1y+HUPN0X0XKF5Q: checks 
*** FLOP *** [3c 8s 5d]
3seg9SJ1y+HUPN0X0XKF5Q: checks 
+yxuvzJHyIWsJ515X8zJTQ: checks 
QIWnfLSqfMcoFfdDe5LZPg: bets $0.50
3seg9SJ1y+HUPN0X0XKF5Q: folds 
+yxuvzJHyIWsJ515X8zJTQ: folds 
Uncalled bet ($0.50) returned to QIWnfLSqfMcoFfdDe5LZPg
QIWnfLSqfMcoFfdDe5LZPg collected $0.85 from pot
*** SUMMARY ***
Total pot $0.85 | Rake $0 
Board [3c 8s 5d]
Seat 1: gaPMxLGp9SOj4Lq6t+/0Ig (button) folded before Flop (didn't bet)
Seat 2: kG34n23qFQA3nzdOJTQ1dA (small blind) folded before Flop
Seat 3: 3seg9SJ1y+HUPN0X0XKF5Q (big blind) folded on the Flop
Seat 4: +yxuvzJHyIWsJ515X8zJTQ folded on the Flop
Seat 5: 4YSTu0Cdzpppe1lUgCZGCQ folded before Flop (didn't bet)
Seat 6: QIWnfLSqfMcoFfdDe5LZPg collected ($0.85)




PokerStars Game #59939420868:  Hold'em No Limit ($0.10/$0.25) - 2009/07/01 0:39:26 ET
Table 'Ok3oDLIsTc2+KxPcI0bAOA' 6-max Seat #6 is the button
Seat 1: agQm3ugZ3qSVYNgNu1ddeA ($27.70 in chips) 
Seat 2: oseFhpinoe+Zg4j5xyBjyQ ($29.55 in chips) 
Seat 3: I1TxPvWj8NfG8orglCinNA ($25 in chips) 
Seat 4: WMiAkibyLuLJ32VI20myug ($12.05 in chips) 
Seat 5: nc79pm0LZRdhncq55evVqA ($28.25 in chips) 
Seat 6: JFIAqU8lCZ0vWwEl4bdGsg ($28.65 in chips) 
agQm3ugZ3qSVYNgNu1ddeA: posts small blind $0.10
oseFhpinoe+Zg4j5xyBjyQ: posts big blind $0.25
*** HOLE CARDS ***
I1TxPvWj8NfG8orglCinNA: folds 
WMiAkibyLuLJ32VI20myug: folds 
nc79pm0LZRdhncq55evVqA: folds 
JFIAqU8lCZ0vWwEl4bdGsg: folds 
agQm3ugZ3qSVYNgNu1ddeA: calls $0.15
oseFhpinoe+Zg4j5xyBjyQ: checks 
*** FLOP *** [Kh 6d 6h]
agQm3ugZ3qSVYNgNu1ddeA: bets $0.75
oseFhpinoe+Zg4j5xyBjyQ: raises $0.75 to $1.50
agQm3ugZ3qSVYNgNu1ddeA: folds 
Uncalled bet ($0.75) returned to oseFhpinoe+Zg4j5xyBjyQ
oseFhpinoe+Zg4j5xyBjyQ collected $1.90 from pot
oseFhpinoe+Zg4j5xyBjyQ: doesn't show hand 
*** SUMMARY ***
Total pot $2 | Rake $0.10 
Board [Kh 6d 6h]
Seat 1: agQm3ugZ3qSVYNgNu1ddeA (small blind) folded on the Flop
Seat 2: oseFhpinoe+Zg4j5xyBjyQ (big blind) collected ($1.90)
Seat 3: I1TxPvWj8NfG8orglCinNA folded before Flop (didn't bet)
Seat 4: WMiAkibyLuLJ32VI20myug folded before Flop (didn't bet)
Seat 5: nc79pm0LZRdhncq55evVqA folded before Flop (didn't bet)
Seat 6: JFIAqU8lCZ0vWwEl4bdGsg (button) folded before Flop (didn't bet)




PokerStars Game #59939420960:  Hold'em No Limit ($0.10/$0.25) - 2009/07/01 0:39:26 ET
Table 'SHi8+hK6i7E2dJ/3Agbyig' 6-max Seat #4 is the button
Seat 1: gPEN9Zp33YTm/mu9/SYP1w ($24.80 in chips) 
Seat 2: Zijzy/UtPWzWVUo81HHVjQ ($43.15 in chips) 
Seat 3: 2p/OXJK5bWQbcvYltdbSfg ($28.30 in chips) 
Seat 4: +KSG/hZ6NXRHDk1WHcV2+Q ($15.15 in chips) 
Seat 5: T5wrp/d5jarm+SxNy8OQAg ($18.25 in chips) 
Seat 6: NVWCcUck2mqZMp/UrHDLKQ ($12 in chips) 
T5wrp/d5jarm+SxNy8OQAg: posts small blind $0.10
NVWCcUck2mqZMp/UrHDLKQ: posts big blind $0.25
*** HOLE CARDS ***
gPEN9Zp33YTm/mu9/SYP1w: raises $0.25 to $0.50
Zijzy/UtPWzWVUo81HHVjQ has timed out
Zijzy/UtPWzWVUo81HHVjQ: folds 
Zijzy/UtPWzWVUo81HHVjQ is sitting out
2p/OXJK5bWQbcvYltdbSfg: calls $0.50
+KSG/hZ6NXRHDk1WHcV2+Q: folds 
T5wrp/d5jarm+SxNy8OQAg: calls $0.40
Zijzy/UtPWzWVUo81HHVjQ has returned
NVWCcUck2mqZMp/UrHDLKQ: calls $0.25
*** FLOP *** [Kc Jd 9c]
T5wrp/d5jarm+SxNy8OQAg: checks 
NVWCcUck2mqZMp/UrHDLKQ: checks 
gPEN9Zp33YTm/mu9/SYP1w: checks 
2p/OXJK5bWQbcvYltdbSfg: bets $2
T5wrp/d5jarm+SxNy8OQAg: calls $2
NVWCcUck2mqZMp/UrHDLKQ: folds 
gPEN9Zp33YTm/mu9/SYP1w: folds 
*** TURN *** [Kc Jd 9c] [9s]
T5wrp/d5jarm+SxNy8OQAg: checks 
2p/OXJK5bWQbcvYltdbSfg: checks 
*** RIVER *** [Kc Jd 9c 9s] [4s]
T5wrp/d5jarm+SxNy8OQAg: checks 
2p/OXJK5bWQbcvYltdbSfg: bets $2.75
T5wrp/d5jarm+SxNy8OQAg: folds 
Uncalled bet ($2.75) returned to 2p/OXJK5bWQbcvYltdbSfg
2p/OXJK5bWQbcvYltdbSfg collected $5.75 from pot
2p/OXJK5bWQbcvYltdbSfg: doesn't show hand 
*** SUMMARY ***
Total pot $6 | Rake $0.25 
Board [Kc Jd 9c 9s 4s]
Seat 1: gPEN9Zp33YTm/mu9/SYP1w folded on the Flop
Seat 2: Zijzy/UtPWzWVUo81HHVjQ folded before Flop (didn't bet)
Seat 3: 2p/OXJK5bWQbcvYltdbSfg collected ($5.75)
Seat 4: +KSG/hZ6NXRHDk1WHcV2+Q (button) folded before Flop (didn't bet)
Seat 5: T5wrp/d5jarm+SxNy8OQAg (small blind) folded on the River
Seat 6: NVWCcUck2mqZMp/UrHDLKQ (big blind) folded on the Flop




PokerStars Game #59939421128:  Hold'em No Limit ($0.10/$0.25) - 2009/07/01 0:39:26 ET
Table 'nteM56rtr9SxLEblf0fvbw' 9-max Seat #4 is the button
Seat 1: H9KUl8cmpLgEpOVDA00bCg ($5 in chips) 
Seat 2: ljemhp25Zg+nlA9DLCIiUw ($25.95 in chips) 
Seat 4: cZ99hugmLBj9KhTlc8nCSw ($25.15 in chips) 
Seat 5: aJy680tKSaP5er559aSuGA ($10.20 in chips) 
Seat 7: dfNim92Z6XK1/h5SFW5vDg ($49.15 in chips) 
Seat 8: RJ/x9oZtt1RZLaJEQwZOxQ ($44.15 in chips) 
Seat 9: t2nb95S5EEFOEzNx9Itz0g ($6.90 in chips) 
aJy680tKSaP5er559aSuGA: posts small blind $0.10
dfNim92Z6XK1/h5SFW5vDg: posts big blind $0.25
*** HOLE CARDS ***
LuckyShot



PokerStars Game #59939420728:  Hold'em No Limit ($0.10/$0.25) - 2009/07/01 0:39:26 ET
Table 'Qk/910N2Yhg8u5vqTJk50Q' 9-max Seat #5 is the button
Seat 1: zDrucyjVn5aeekNEc3cJrA ($25.25 in chips) 
Seat 2: Th3FldXKQW6hWVVPahaoOQ ($33.20 in chips) 
Seat 3: ghNKXUBl/H+t83JF079ZBA ($25 in chips) 
Seat 4: 33y9+GmQ3J84RvZXcraRTw ($21.45 in chips) 
Seat 5: 4oA316mXLIui1QY63GXBUg ($27.25 in chips) 
Seat 7: Wem/MTN+sc9vH/UZeT5YLQ ($9.75 in chips) 
Seat 8: H5Se03ZqSX7tbULXur2MAg ($25.10 in chips) 
Seat 9: M2QO2DxB5Wawg2h8HSpnYA ($10 in chips) 
SteveSupreme will be allowed to play after the button
Wem/MTN+sc9vH/UZeT5YLQ: posts small blind $0.10
H5Se03ZqSX7tbULXur2MAg: posts big blind $0.25
*** HOLE CARDS ***
M2QO2DxB5Wawg2h8HSpnYA: folds 
zDrucyjVn5aeekNEc3cJrA: folds 
Th3FldXKQW6hWVVPahaoOQ: folds 
ghNKXUBl/H+t83JF079ZBA: folds 
33y9+GmQ3J84RvZXcraRTw: calls $0.25
4oA316mXLIui1QY63GXBUg: folds 
Wem/MTN+sc9vH/UZeT5YLQ: calls $0.15
H5Se03ZqSX7tbULXur2MAg: checks 
*** FLOP *** [8h Ad Jc]
Wem/MTN+sc9vH/UZeT5YLQ: checks 
H5Se03ZqSX7tbULXur2MAg: bets $0.75
33y9+GmQ3J84RvZXcraRTw: folds 
Wem/MTN+sc9vH/UZeT5YLQ: folds 
Uncalled bet ($0.75) returned to H5Se03ZqSX7tbULXur2MAg
H5Se03ZqSX7tbULXur2MAg collected $0.75 from pot
*** SUMMARY ***
Total pot $0.75 | Rake $0 
Board [8h Ad Jc]
Seat 1: zDrucyjVn5aeekNEc3cJrA folded before Flop (didn't bet)
Seat 2: Th3FldXKQW6hWVVPahaoOQ folded before Flop (didn't bet)
Seat 3: ghNKXUBl/H+t83JF079ZBA folded before Flop (didn't bet)
Seat 4: 33y9+GmQ3J84RvZXcraRTw folded on the Flop
Seat 5: 4oA316mXLIui1QY63GXBUg (button) folded before Flop (didn't bet)
Seat 7: Wem/MTN+sc9vH/UZeT5YLQ (small blind) folded on the Flop
Seat 8: H5Se03ZqSX7tbULXur2MAg (big blind) collected ($0.75)
Seat 9: M2QO2DxB5Wawg2h8HSpnYA folded before Flop (didn't bet)




PokerStars Game #59939421086:  Hold'em No Limit ($0.10/$0.25) - 2009/07/01 0:39:26 ET
Table 'a6FCGVBMPcT7J7BDN9q1zQ' 9-max Seat #7 is the button
Seat 1: s7Q6uNouhe7aE8JdFb9E+A ($43.35 in chips) 
Seat 2: h4ggJZYBXV0mEZzYPYKfeA ($34.85 in chips) 
Seat 3: hIss79a4pu7GzJZepfgOpg ($25 in chips) 
Seat 5: JJk2ZoH7BSGLAgqFUL5pMg ($3.40 in chips) 
Seat 6: Z9AeOQX3yzuSvKAm/xyovg ($9.65 in chips) 
Seat 7: V0Yo5zRBVM8DYspLKafebg ($23.05 in chips) 
Seat 8: r6hsffOo1iKmaPYKwAZmFw ($51.45 in chips) 
Seat 9: WwcXelmo9g129XJixVb2NA ($14.75 in chips) 
r6hsffOo1iKmaPYKwAZmFw: posts small blind $0.10
WwcXelmo9g129XJixVb2NA: posts big blind $0.25
ydoFOVgzvZv9ZhuWu9rXAw: sits out 
*** HOLE CARDS ***
s7Q6uNouhe7aE8JdFb9E+A has timed out
s7Q6uNouhe7aE8JdFb9E+A: folds 
s7Q6uNouhe7aE8JdFb9E+A is sitting out
h4ggJZYBXV0mEZzYPYKfeA: folds 
hIss79a4pu7GzJZepfgOpg: folds 
s7Q6uNouhe7aE8JdFb9E+A has returned
JJk2ZoH7BSGLAgqFUL5pMg: calls $0.25
Z9AeOQX3yzuSvKAm/xyovg: folds 
V0Yo5zRBVM8DYspLKafebg: calls $0.25
r6hsffOo1iKmaPYKwAZmFw: folds 
WwcXelmo9g129XJixVb2NA: checks 
*** FLOP *** [Kd Ad Qs]
WwcXelmo9g129XJixVb2NA: checks 
JJk2ZoH7BSGLAgqFUL5pMg: bets $0.75
V0Yo5zRBVM8DYspLKafebg: calls $0.75
WwcXelmo9g129XJixVb2NA: folds 
*** TURN *** [Kd Ad Qs] [6c]
JJk2ZoH7BSGLAgqFUL5pMg: checks 
V0Yo5zRBVM8DYspLKafebg: checks 
*** RIVER *** [Kd Ad Qs 6c] [4c]
JJk2ZoH7BSGLAgqFUL5pMg: checks 
V0Yo5zRBVM8DYspLKafebg: checks 
*** SHOW DOWN ***
JJk2ZoH7BSGLAgqFUL5pMg: shows [3h 5c] (high card Ace)
V0Yo5zRBVM8DYspLKafebg: shows [8s Ks] (a pair of Kings)
V0Yo5zRBVM8DYspLKafebg collected $2.25 from pot
*** SUMMARY ***
Total pot $2.35 | Rake $0.10 
Board [Kd Ad Qs 6c 4c]
Seat 1: s7Q6uNouhe7aE8JdFb9E+A folded before Flop (didn't bet)
Seat 2: h4ggJZYBXV0mEZzYPYKfeA folded before Flop (didn't bet)
Seat 3: hIss79a4pu7GzJZepfgOpg folded before Flop (didn't bet)
Seat 5: JJk2ZoH7BSGLAgqFUL5pMg showed [3h 5c] and lost with high card Ace
Seat 6: Z9AeOQX3yzuSvKAm/xyovg folded before Flop (didn't bet)
Seat 7: V0Yo5zRBVM8DYspLKafebg (button) showed [8s Ks] and won ($2.25) with a pair of Kings
Seat 8: r6hsffOo1iKmaPYKwAZmFw (small blind) folded before Flop
Seat 9: WwcXelmo9g129XJixVb2NA (big blind) folded on the Flop




PokerStars Game #59939421712:  Hold'em No Limit ($0.10/$0.25) - 2009/07/01 0:39:27 ET
Table 'sgB7AwZtVgDTf4fi8RwWFQ' 9-max Seat #5 is the button
Seat 1: QEbIGci+itdw+re8RM5fZA ($25 in chips) 
Seat 2: DnDcAdn9P0zGovMERigpFA ($32 in chips) 
Seat 3: OlPJsgR4xypSg/w1z7Gyvw ($20.10 in chips) 
Seat 5: gPFzi0PLRAvfKu2GYwa1VA ($16.55 in chips) 
Seat 6: 1q23ISSsSMhv2lHXBfj9/A ($23.50 in chips) 
Seat 8: Nq5F1B22aaLLZ+D9HbzcGg ($21.65 in chips) 
Seat 9: MG90wfSJZnOejs/KD3vlQQ ($32.60 in chips) 
1q23ISSsSMhv2lHXBfj9/A: posts small blind $0.10
Nq5F1B22aaLLZ+D9HbzcGg: posts big blind $0.25
*** HOLE CARDS ***
MG90wfSJZnOejs/KD3vlQQ: folds 
QEbIGci+itdw+re8RM5fZA: folds 
DnDcAdn9P0zGovMERigpFA: folds 
OlPJsgR4xypSg/w1z7Gyvw: folds 
gPFzi0PLRAvfKu2GYwa1VA: folds 
1q23ISSsSMhv2lHXBfj9/A: folds 
Uncalled bet ($0.15) returned to Nq5F1B22aaLLZ+D9HbzcGg
Nq5F1B22aaLLZ+D9HbzcGg collected $0.20 from pot
Nq5F1B22aaLLZ+D9HbzcGg: doesn't show hand 
*** SUMMARY ***
Total pot $0.20 | Rake $0 
Seat 1: QEbIGci+itdw+re8RM5fZA folded before Flop (didn't bet)
Seat 2: DnDcAdn9P0zGovMERigpFA folded before Flop (didn't bet)
Seat 3: OlPJsgR4xypSg/w1z7Gyvw folded before Flop (didn't bet)
Seat 5: gPFzi0PLRAvfKu2GYwa1VA (button) folded before Flop (didn't bet)
Seat 6: 1q23ISSsSMhv2lHXBfj9/A (small blind) folded before Flop
Seat 8: Nq5F1B22aaLLZ+D9HbzcGg (big blind) collected ($0.20)
Seat 9: MG90wfSJZnOejs/KD3vlQQ folded before Flop (didn't bet)




PokerStars Game #59939421528:  Hold'em No Limit ($0.10/$0.25) - 2009/07/01 0:39:27 ET
Table 'JJzUs04lHpXg6nboT1/jeg' 6-max Seat #4 is the button
Seat 3: uUXdcVMNa05rfbntdvplfw ($10 in chips) 
Seat 4: nwwpaieDRI0UPyVtChVHOg ($36.35 in chips) 
Seat 5: Vr2XE7yYBdg3RZSURDAPEg ($24.25 in chips) 
Vr2XE7yYBdg3RZSURDAPEg: posts small blind $0.10
uUXdcVMNa05rfbntdvplfw: posts big blind $0.25
*** HOLE CARDS ***
nwwpaieDRI0UPyVtChVHOg: folds 
hcarral joins the table at seat #2 
Vr2XE7yYBdg3RZSURDAPEg: raises $0.50 to $0.75
uUXdcVMNa05rfbntdvplfw: calls $0.50
*** FLOP *** [Tc 3c As]
Vr2XE7yYBdg3RZSURDAPEg: checks 
uUXdcVMNa05rfbntdvplfw: bets $0.75
Vr2XE7yYBdg3RZSURDAPEg: folds 
Uncalled bet ($0.75) returned to uUXdcVMNa05rfbntdvplfw
uUXdcVMNa05rfbntdvplfw collected $1.45 from pot
*** SUMMARY ***
Total pot $1.50 | Rake $0.05 
Board [Tc 3c As]
Seat 3: uUXdcVMNa05rfbntdvplfw (big blind) collected ($1.45)
Seat 4: nwwpaieDRI0UPyVtChVHOg (button) folded before Flop (didn't bet)
Seat 5: Vr2XE7yYBdg3RZSURDAPEg (small blind) folded on the Flop




PokerStars Game #59939421312:  Hold'em No Limit ($0.10/$0.25) - 2009/07/01 0:39:27 ET
Table 'gkdjhbH1jaE3hwhPRIKMiQ' 6-max Seat #2 is the button
Seat 1: nc79pm0LZRdhncq55evVqA ($25.35 in chips) 
Seat 2: 1NNFfYMd5Hsphl/FYz9fNA ($32.50 in chips) 
Seat 4: 7uqewvdd5+KjmM7wl58k+w ($15.05 in chips) 
Seat 5: Ew/TYPQIsbQ2X8nm5iAJBg ($26.75 in chips) 
Seat 6: wqphQtauX5Qn7WRJZS1flA ($26 in chips) 
7uqewvdd5+KjmM7wl58k+w: posts small blind $0.10
Ew/TYPQIsbQ2X8nm5iAJBg: posts big blind $0.25
*** HOLE CARDS ***
wqphQtauX5Qn7WRJZS1flA: folds 
nc79pm0LZRdhncq55evVqA: folds 
1NNFfYMd5Hsphl/FYz9fNA: raises $0.50 to $0.75
7uqewvdd5+KjmM7wl58k+w: folds 
Ew/TYPQIsbQ2X8nm5iAJBg: calls $0.50
*** FLOP *** [4s 4c 9d]
Ew/TYPQIsbQ2X8nm5iAJBg: checks 
1NNFfYMd5Hsphl/FYz9fNA: checks 
*** TURN *** [4s 4c 9d] [4h]
Ew/TYPQIsbQ2X8nm5iAJBg: checks 
kG34n23qFQA3nzdOJTQ1dA joins the table at seat #3 
1NNFfYMd5Hsphl/FYz9fNA: bets $1
Ew/TYPQIsbQ2X8nm5iAJBg: folds 
Uncalled bet ($1) returned to 1NNFfYMd5Hsphl/FYz9fNA
1NNFfYMd5Hsphl/FYz9fNA collected $1.55 from pot
1NNFfYMd5Hsphl/FYz9fNA: doesn't show hand 
*** SUMMARY ***
Total pot $1.60 | Rake $0.05 
Board [4s 4c 9d 4h]
Seat 1: nc79pm0LZRdhncq55evVqA folded before Flop (didn't bet)
Seat 2: 1NNFfYMd5Hsphl/FYz9fNA (button) collected ($1.55)
Seat 4: 7uqewvdd5+KjmM7wl58k+w (small blind) folded before Flop
Seat 5: Ew/TYPQIsbQ2X8nm5iAJBg (big blind) folded on the Turn
Seat 6: wqphQtauX5Qn7WRJZS1flA folded before Flop (didn't bet)




PokerStars Game #59939421452:  Hold'em No Limit ($0.10/$0.25) - 2009/07/01 0:39:27 ET
Table '4XGDnEByOol5up4aB2KbJw' 6-max Seat #6 is the button
Seat 1: kyRaCIljYA6l33lSKQfNsg ($34.80 in chips) 
Seat 2: SFmT9ZsVopnukjvAzrxTRg ($26.25 in chips) 
Seat 3: LtASJ9OlkqGrrUKGQlpGAw ($23.60 in chips) 
Seat 4: sjoibHX/s93+8Kwa5aB1dA ($27.60 in chips) 
Seat 5: Dh01+rohD2p9pXLYeBlC5Q ($18 in chips) 
Seat 6: ELW+DKizJhLK7k40PMkD2Q ($28.10 in chips) 
kyRaCIljYA6l33lSKQfNsg: posts small blind $0.10
SFmT9ZsVopnukjvAzrxTRg: posts big blind $0.25
*** HOLE CARDS ***
LtASJ9OlkqGrrUKGQlpGAw: folds 
sjoibHX/s93+8Kwa5aB1dA: folds 
Dh01+rohD2p9pXLYeBlC5Q: folds 
ELW+DKizJhLK7k40PMkD2Q: folds 
kyRaCIljYA6l33lSKQfNsg: raises $0.50 to $0.75
SFmT9ZsVopnukjvAzrxTRg: calls $0.50
*** FLOP *** [Td As 5d]
kyRaCIljYA6l33lSKQfNsg: bets $1
SFmT9ZsVopnukjvAzrxTRg: calls $1
*** TURN *** [Td As 5d] [9h]
kyRaCIljYA6l33lSKQfNsg: bets $2
SFmT9ZsVopnukjvAzrxTRg: calls $2
*** RIVER *** [Td As 5d 9h] [Ah]
kyRaCIljYA6l33lSKQfNsg: bets $4.75
SFmT9ZsVopnukjvAzrxTRg: calls $4.75
*** SHOW DOWN ***
kyRaCIljYA6l33lSKQfNsg: shows [Jd 8d] (a pair of Aces)
SFmT9ZsVopnukjvAzrxTRg: shows [Jc Js] (two pair, Aces and Jacks)
SFmT9ZsVopnukjvAzrxTRg collected $16.20 from pot
*** SUMMARY ***
Total pot $17 | Rake $0.80 
Board [Td As 5d 9h Ah]
Seat 1: kyRaCIljYA6l33lSKQfNsg (small blind) showed [Jd 8d] and lost with a pair of Aces
Seat 2: SFmT9ZsVopnukjvAzrxTRg (big blind) showed [Jc Js] and won ($16.20) with two pair, Aces and Jacks
Seat 3: LtASJ9OlkqGrrUKGQlpGAw folded before Flop (didn't bet)
Seat 4: sjoibHX/s93+8Kwa5aB1dA folded before Flop (didn't bet)
Seat 5: Dh01+rohD2p9pXLYeBlC5Q folded before Flop (didn't bet)
Seat 6: ELW+DKizJhLK7k40PMkD2Q (button) folded before Flop (didn't bet)




PokerStars Game #59939421990:  Hold'em No Limit ($0.10/$0.25) - 2009/07/01 0:39:28 ET
Table '+198VWQSWBhYQOcizzuBkw' 6-max Seat #3 is the button
Seat 2: R6AGToFJQOYVZAjC2jXEKw ($29.05 in chips) 
Seat 3: BYxjLnV1/LL0aZcTbfAOvw ($27.25 in chips) 
Seat 4: TgDsTeCdLQt8kWbL00ByRA ($27.35 in chips) 
Seat 5: LtASJ9OlkqGrrUKGQlpGAw ($30.65 in chips) 
Seat 6: 7qRk4YH4/k/08LgJSv7rBQ ($30.90 in chips) 
TgDsTeCdLQt8kWbL00ByRA: posts small blind $0.10
LtASJ9OlkqGrrUKGQlpGAw: posts big blind $0.25
*** HOLE CARDS ***
7qRk4YH4/k/08LgJSv7rBQ: raises $0.75 to $1
R6AGToFJQOYVZAjC2jXEKw: folds 
BYxjLnV1/LL0aZcTbfAOvw: folds 
TgDsTeCdLQt8kWbL00ByRA: folds 
LtASJ9OlkqGrrUKGQlpGAw: folds 
Uncalled bet ($0.75) returned to 7qRk4YH4/k/08LgJSv7rBQ
7qRk4YH4/k/08LgJSv7rBQ collected $0.60 from pot
7qRk4YH4/k/08LgJSv7rBQ: doesn't show hand 
*** SUMMARY ***
Total pot $0.60 | Rake $0 
Seat 2: R6AGToFJQOYVZAjC2jXEKw folded before Flop (didn't bet)
Seat 3: BYxjLnV1/LL0aZcTbfAOvw (button) folded before Flop (didn't bet)
Seat 4: TgDsTeCdLQt8kWbL00ByRA (small blind) folded before Flop
Seat 5: LtASJ9OlkqGrrUKGQlpGAw (big blind) folded before Flop
Seat 6: 7qRk4YH4/k/08LgJSv7rBQ collected ($0.60)




PokerStars Game #59939422064:  Hold'em No Limit ($0.10/$0.25) - 2009/07/01 0:39:28 ET
Table 'MRfAiS/4JSfnUDlCcZo0wAhfHe8uKeSJMyWAjSdM7ROQx Seat #3 is the button
Seat 2: /gJNBeCkWL4o85/jvlZ4BA ($37.60 in chips) 
Seat 3: FYepjhAvF8ZdVCmqHIy+eQ ($49 in chips) 
Seat 4: Go8clNIDGP3feVvzBDG4pg ($19.50 in chips) 
Seat 5: qccGLncfUaN00Few5HsgYg ($28.60 in chips) 
Seat 6: VaDPspfGS2lnEkaGNrNqfg ($10 in chips) 
Go8clNIDGP3feVvzBDG4pg: posts small blind $0.10
qccGLncfUaN00Few5HsgYg: posts big blind $0.25
32YL2ZEp8NT4JB2RVM9euQ: sits out 
*** HOLE CARDS ***
VaDPspfGS2lnEkaGNrNqfg: calls $0.25
/gJNBeCkWL4o85/jvlZ4BA: raises $0.75 to $1
FYepjhAvF8ZdVCmqHIy+eQ: calls $1
Go8clNIDGP3feVvzBDG4pg: raises $1.25 to $2.25
32YL2ZEp8NT4JB2RVM9euQ leaves the table
qccGLncfUaN00Few5HsgYg: folds 
VaDPspfGS2lnEkaGNrNqfg: folds 
/gJNBeCkWL4o85/jvlZ4BA: calls $1.25
FYepjhAvF8ZdVCmqHIy+eQ: calls $1.25
*** FLOP *** [8h Kh 9d]
Go8clNIDGP3feVvzBDG4pg: bets $3.50
48oT5xFI+5CHUJlfoGrE4w joins the table at seat #1 
/gJNBeCkWL4o85/jvlZ4BA: folds 
FYepjhAvF8ZdVCmqHIy+eQ: folds 
Uncalled bet ($3.50) returned to Go8clNIDGP3feVvzBDG4pg
Go8clNIDGP3feVvzBDG4pg collected $6.90 from pot
*** SUMMARY ***
Total pot $7.25 | Rake $0.35 
Board [8h Kh 9d]
Seat 2: /gJNBeCkWL4o85/jvlZ4BA folded on the Flop
Seat 3: FYepjhAvF8ZdVCmqHIy+eQ (button) folded on the Flop
Seat 4: Go8clNIDGP3feVvzBDG4pg (small blind) collected ($6.90)
Seat 5: qccGLncfUaN00Few5HsgYg (big blind) folded before Flop
Seat 6: VaDPspfGS2lnEkaGNrNqfg folded before Flop




PokerStars Game #59939422234:  Hold'em No Limit ($0.10/$0.25) - 2009/07/01 0:39:28 ET
Table '4ZbiE0ZYjzqmgu6+sO1prg' 9-max Seat #7 is the button
Seat 1: N6fYvIzQLKaydFLKQGtMlQ ($25.90 in chips) 
Seat 2: w31DkWCTQDVIzsHIrFRDxA ($13.65 in chips) 
Seat 3: HPEB+AtKw1+C/cxU0o1ciw ($23.80 in chips) 
Seat 4: Eb2mDXvZ4iY02krYdOYwMA ($26.40 in chips) 
Seat 5: COsrwJSFHQtxlUcrYtDQPQ ($25 in chips) 
Seat 6: rXm4QDVJt67H20lM6n6Z7Q ($7.90 in chips) 
Seat 7: 3RCAkueG3Vc13VpRStCB+w ($21.05 in chips) 
Seat 8: cZ99hugmLBj9KhTlc8nCSw ($25 in chips) 
Seat 9: 1K6QGyJP9P9xmRac2fH4OQ ($99.10 in chips) 
cZ99hugmLBj9KhTlc8nCSw: posts small blind $0.10
1K6QGyJP9P9xmRac2fH4OQ: posts big blind $0.25
*** HOLE CARDS ***
N6fYvIzQLKaydFLKQGtMlQ: folds 
w31DkWCTQDVIzsHIrFRDxA: folds 
HPEB+AtKw1+C/cxU0o1ciw: folds 
Eb2mDXvZ4iY02krYdOYwMA: folds 
COsrwJSFHQtxlUcrYtDQPQ: folds 
rXm4QDVJt67H20lM6n6Z7Q: folds 
3RCAkueG3Vc13VpRStCB+w: folds 
cZ99hugmLBj9KhTlc8nCSw: folds 
Uncalled bet ($0.15) returned to 1K6QGyJP9P9xmRac2fH4OQ
1K6QGyJP9P9xmRac2fH4OQ collected $0.20 from pot
1K6QGyJP9P9xmRac2fH4OQ: doesn't show hand 
*** SUMMARY ***
Total pot $0.20 | Rake $0 
Seat 1: N6fYvIzQLKaydFLKQGtMlQ folded before Flop (didn't bet)
Seat 2: w31DkWCTQDVIzsHIrFRDxA folded before Flop (didn't bet)
Seat 3: HPEB+AtKw1+C/cxU0o1ciw folded before Flop (didn't bet)
Seat 4: Eb2mDXvZ4iY02krYdOYwMA folded before Flop (didn't bet)
Seat 5: COsrwJSFHQtxlUcrYtDQPQ folded before Flop (didn't bet)
Seat 6: rXm4QDVJt67H20lM6n6Z7Q folded before Flop (didn't bet)
Seat 7: 3RCAkueG3Vc13VpRStCB+w (button) folded before Flop (didn't bet)
Seat 8: cZ99hugmLBj9KhTlc8nCSw (small blind) folded before Flop
Seat 9: 1K6QGyJP9P9xmRac2fH4OQ (big blind) collected ($0.20)




PokerStars Game #59939423074:  Hold'em No Limit ($0.10/$0.25) - 2009/07/01 0:39:29 ET
Table 'Zi9/NqNs3XoL1eWhMCyZyg' 9-max Seat #2 is the button
Seat 2: Th3FldXKQW6hWVVPahaoOQ ($31.05 in chips) 
Seat 3: rUpvA02nErFvZ4yFbDR8XA ($21.75 in chips) 
Seat 4: D3XCkXRktDfPlSguxwfnRA ($13.35 in chips) 
Seat 5: OiV1PWZ3IkN29JlmCcnTwQ ($4.65 in chips) 
Seat 6: b3P5tPsBbrP+aAO9+Ts/Nw ($37.85 in chips) 
Seat 7: qul+IMROTuFj45eWi2Tpvg ($48.40 in chips) 
Seat 9: tYsOBqdU1+x+yFI7zHO7hQ ($30.75 in chips) 
rUpvA02nErFvZ4yFbDR8XA: posts small blind $0.10
D3XCkXRktDfPlSguxwfnRA: posts big blind $0.25
opOCI2p6kW0tINuVaAqmcQ: sits out 
*** HOLE CARDS ***
OiV1PWZ3IkN29JlmCcnTwQ: folds 
b3P5tPsBbrP+aAO9+Ts/Nw: folds 
qul+IMROTuFj45eWi2Tpvg has timed out
qul+IMROTuFj45eWi2Tpvg: folds 
qul+IMROTuFj45eWi2Tpvg is sitting out
qul+IMROTuFj45eWi2Tpvg has returned
tYsOBqdU1+x+yFI7zHO7hQ: raises $0.75 to $1
Th3FldXKQW6hWVVPahaoOQ: folds 
rUpvA02nErFvZ4yFbDR8XA: folds 
D3XCkXRktDfPlSguxwfnRA: folds 
Uncalled bet ($0.75) returned to tYsOBqdU1+x+yFI7zHO7hQ
tYsOBqdU1+x+yFI7zHO7hQ collected $0.60 from pot
tYsOBqdU1+x+yFI7zHO7hQ: doesn't show hand 
*** SUMMARY ***
Total pot $0.60 | Rake $0 
Seat 2: Th3FldXKQW6hWVVPahaoOQ (button) folded before Flop (didn't bet)
Seat 3: rUpvA02nErFvZ4yFbDR8XA (small blind) folded before Flop
Seat 4: D3XCkXRktDfPlSguxwfnRA (big blind) folded before Flop
Seat 5: OiV1PWZ3IkN29JlmCcnTwQ folded before Flop (didn't bet)
Seat 6: b3P5tPsBbrP+aAO9+Ts/Nw folded before Flop (didn't bet)
Seat 7: qul+IMROTuFj45eWi2Tpvg folded before Flop (didn't bet)
Seat 9: tYsOBqdU1+x+yFI7zHO7hQ collected ($0.60)




PokerStars Game #59939423294:  Hold'em No Limit ($0.10/$0.25) - 2009/07/01 0:39:29 ET
Table 'qryc9C/ELyQ3lubOaELNAQ' 6-max Seat #4 is the button
Seat 1: OZc6kkoTwtITj1ZfreJK1A ($21.60 in chips) 
Seat 2: qvQc9BHp2FhQjrltLiBN+w ($14.65 in chips) 
Seat 3: UXRtG8J9PoBZWTsNtqdoDA ($25.25 in chips) 
Seat 4: v+QfkGiuj9bgtuNoVnDO8w ($29.85 in chips) 
Seat 5: pV5UZbjsgam+HUQEd6G++w ($8 in chips) 
Seat 6: t2RfOOoa56xW0ZHJC0+5JQ ($9.05 in chips) 
pV5UZbjsgam+HUQEd6G++w: posts small blind $0.10
t2RfOOoa56xW0ZHJC0+5JQ: posts big blind $0.25
*** HOLE CARDS ***
OZc6kkoTwtITj1ZfreJK1A: raises $0.25 to $0.50
qvQc9BHp2FhQjrltLiBN+w: folds 
UXRtG8J9PoBZWTsNtqdoDA: calls $0.50
v+QfkGiuj9bgtuNoVnDO8w: calls $0.50
pV5UZbjsgam+HUQEd6G++w: folds 
t2RfOOoa56xW0ZHJC0+5JQ: folds 
*** FLOP *** [Qh 6h Th]
OZc6kkoTwtITj1ZfreJK1A: checks 
UXRtG8J9PoBZWTsNtqdoDA: bets $1
v+QfkGiuj9bgtuNoVnDO8w: folds 
OZc6kkoTwtITj1ZfreJK1A: calls $1
*** TURN *** [Qh 6h Th] [8s]
OZc6kkoTwtITj1ZfreJK1A: bets $1
UXRtG8J9PoBZWTsNtqdoDA: calls $1
*** RIVER *** [Qh 6h Th 8s] [8d]
OZc6kkoTwtITj1ZfreJK1A: bets $2.75
UXRtG8J9PoBZWTsNtqdoDA: calls $2.75
*** SHOW DOWN ***
OZc6kkoTwtITj1ZfreJK1A: shows [Ac Ad] (two pair, Aces and Eights)
UXRtG8J9PoBZWTsNtqdoDA: mucks hand 
OZc6kkoTwtITj1ZfreJK1A collected $10.80 from pot
*** SUMMARY ***
Total pot $11.35 | Rake $0.55 
Board [Qh 6h Th 8s 8d]
Seat 1: OZc6kkoTwtITj1ZfreJK1A showed [Ac Ad] and won ($10.80) with two pair, Aces and Eights
Seat 2: qvQc9BHp2FhQjrltLiBN+w folded before Flop (didn't bet)
Seat 3: UXRtG8J9PoBZWTsNtqdoDA mucked
Seat 4: v+QfkGiuj9bgtuNoVnDO8w (button) folded on the Flop
Seat 5: pV5UZbjsgam+HUQEd6G++w (small blind) folded before Flop
Seat 6: t2RfOOoa56xW0ZHJC0+5JQ (big blind) folded before Flop




PokerStars Game #59939423116:  Hold'em No Limit ($0.10/$0.25) - 2009/07/01 0:39:29 ET
Table 'x7YStLKc8hpt/pTgSetPKA' 9-max Seat #5 is the button
Seat 2: z5GxcHlYz/GSz6W2uFiTtg ($36.25 in chips) 
Seat 5: gxyie8xe6lDdpfG4quHtbw ($14.80 in chips) 
Seat 6: Yv4fucyyT28mjx8V5lxKJg ($31.90 in chips) 
Seat 7: +8FtfKCFr23+6O39P+U45Q ($29.85 in chips) 
Seat 8: jeKWRUkMaVn8rEUjnJKqpg ($33.65 in chips) 
Seat 9: nm4Dj/f+jJEwKVsUnKh73g ($22.25 in chips) 
Yv4fucyyT28mjx8V5lxKJg: posts small blind $0.10
+8FtfKCFr23+6O39P+U45Q: posts big blind $0.25
S7Ki0P+0AIGPuIfGJjW0gg: sits out 
*** HOLE CARDS ***
jeKWRUkMaVn8rEUjnJKqpg: folds 
nm4Dj/f+jJEwKVsUnKh73g: folds 
z5GxcHlYz/GSz6W2uFiTtg: folds 
gxyie8xe6lDdpfG4quHtbw: calls $0.25
Yv4fucyyT28mjx8V5lxKJg: folds 
+8FtfKCFr23+6O39P+U45Q: checks 
*** FLOP *** [4c Kc Td]
+8FtfKCFr23+6O39P+U45Q: checks 
gxyie8xe6lDdpfG4quHtbw: bets $0.50
+8FtfKCFr23+6O39P+U45Q: folds 
Uncalled bet ($0.50) returned to gxyie8xe6lDdpfG4quHtbw
gxyie8xe6lDdpfG4quHtbw collected $0.60 from pot
*** SUMMARY ***
Total pot $0.60 | Rake $0 
Board [4c Kc Td]
Seat 2: z5GxcHlYz/GSz6W2uFiTtg folded before Flop (didn't bet)
Seat 5: gxyie8xe6lDdpfG4quHtbw (button) collected ($0.60)
Seat 6: Yv4fucyyT28mjx8V5lxKJg (small blind) folded before Flop
Seat 7: +8FtfKCFr23+6O39P+U45Q (big blind) folded on the Flop
Seat 8: jeKWRUkMaVn8rEUjnJKqpg folded before Flop (didn't bet)
Seat 9: nm4Dj/f+jJEwKVsUnKh73g folded before Flop (didn't bet)




PokerStars Game #59939423616:  Hold'em No Limit ($0.10/$0.25) - 2009/07/01 0:39:30 ET
Table '5510FxlYzKi+U6MIpo8IPA' 6-max Seat #1 is the button
Seat 1: KM6ogk7SqyRlk3m9b0h+7A ($19.90 in chips) 
Seat 3: v+QfkGiuj9bgtuNoVnDO8w ($25.95 in chips) 
Seat 4: cPO/1/dTcZpLkQFm3jH3Rg ($29.40 in chips) 
Seat 5: 5E1iMY5xyboow7Xm0v7Idw ($13.65 in chips) 
Seat 6: SFmT9ZsVopnukjvAzrxTRg ($29.10 in chips) 
v+QfkGiuj9bgtuNoVnDO8w: posts small blind $0.10
cPO/1/dTcZpLkQFm3jH3Rg: posts big blind $0.25
*** HOLE CARDS ***
5E1iMY5xyboow7Xm0v7Idw: calls $0.25
SFmT9ZsVopnukjvAzrxTRg: folds 
KM6ogk7SqyRlk3m9b0h+7A: calls $0.25
v+QfkGiuj9bgtuNoVnDO8w: raises $1.50 to $1.75
cPO/1/dTcZpLkQFm3jH3Rg: calls $1.50
5E1iMY5xyboow7Xm0v7Idw: calls $1.50
KM6ogk7SqyRlk3m9b0h+7A: folds 
*** FLOP *** [5c 9d Jd]
v+QfkGiuj9bgtuNoVnDO8w: bets $4.25
cPO/1/dTcZpLkQFm3jH3Rg: folds 
5E1iMY5xyboow7Xm0v7Idw: folds 
Uncalled bet ($4.25) returned to v+QfkGiuj9bgtuNoVnDO8w
v+QfkGiuj9bgtuNoVnDO8w collected $5.25 from pot
v+QfkGiuj9bgtuNoVnDO8w: doesn't show hand 
*** SUMMARY ***
Total pot $5.50 | Rake $0.25 
Board [5c 9d Jd]
Seat 1: KM6ogk7SqyRlk3m9b0h+7A (button) folded before Flop
Seat 3: v+QfkGiuj9bgtuNoVnDO8w (small blind) collected ($5.25)
Seat 4: cPO/1/dTcZpLkQFm3jH3Rg (big blind) folded on the Flop
Seat 5: 5E1iMY5xyboow7Xm0v7Idw folded on the Flop
Seat 6: SFmT9ZsVopnukjvAzrxTRg folded before Flop (didn't bet)




PokerStars Game #59939423798:  Hold'em No Limit ($0.10/$0.25) - 2009/07/01 0:39:30 ET
Table 'HIOfhT0zga/KonFhIl6O3w' 9-max Seat #7 is the button
Seat 1: t2nb95S5EEFOEzNx9Itz0g ($6.20 in chips) 
Seat 2: er86weqXTpTB6/w2dKlYgA ($16.45 in chips) 
Seat 3: RxrlOCIHB/l30KL6EEws0g ($37.15 in chips) 
Seat 4: qwr38jl5txoR36M7G5qi4A ($8.10 in chips) 
Seat 5: K1MDeapSEyKyGPNZGOKfEg ($14.45 in chips) 
Seat 6: cZ99hugmLBj9KhTlc8nCSw ($25.70 in chips) 
Seat 7: H9KUl8cmpLgEpOVDA00bCg ($5.25 in chips) 
Seat 8: 3RCAkueG3Vc13VpRStCB+w ($25.60 in chips) 
Seat 9: dfNim92Z6XK1/h5SFW5vDg ($25 in chips) 
3RCAkueG3Vc13VpRStCB+w: posts small blind $0.10
dfNim92Z6XK1/h5SFW5vDg: posts big blind $0.25
*** HOLE CARDS ***
t2nb95S5EEFOEzNx9Itz0g: folds 
er86weqXTpTB6/w2dKlYgA: folds 
RxrlOCIHB/l30KL6EEws0g: folds 
qwr38jl5txoR36M7G5qi4A: folds 
K1MDeapSEyKyGPNZGOKfEg: calls $0.25
cZ99hugmLBj9KhTlc8nCSw: folds 
H9KUl8cmpLgEpOVDA00bCg: folds 
3RCAkueG3Vc13VpRStCB+w: folds 
dfNim92Z6XK1/h5SFW5vDg: checks 
*** FLOP *** [Qc 9s Kc]
dfNim92Z6XK1/h5SFW5vDg: checks 
K1MDeapSEyKyGPNZGOKfEg: checks 
*** TURN *** [Qc 9s Kc] [7h]
dfNim92Z6XK1/h5SFW5vDg: checks 
K1MDeapSEyKyGPNZGOKfEg: checks 
*** RIVER *** [Qc 9s Kc 7h] [3s]
dfNim92Z6XK1/h5SFW5vDg: checks 
K1MDeapSEyKyGPNZGOKfEg: checks 
*** SHOW DOWN ***
dfNim92Z6XK1/h5SFW5vDg: shows [Qs 4d] (a pair of Queens)
K1MDeapSEyKyGPNZGOKfEg: mucks hand 
dfNim92Z6XK1/h5SFW5vDg collected $0.60 from pot
*** SUMMARY ***
Total pot $0.60 | Rake $0 
Board [Qc 9s Kc 7h 3s]
Seat 1: t2nb95S5EEFOEzNx9Itz0g folded before Flop (didn't bet)
Seat 2: er86weqXTpTB6/w2dKlYgA folded before Flop (didn't bet)
Seat 3: RxrlOCIHB/l30KL6EEws0g folded before Flop (didn't bet)
Seat 4: qwr38jl5txoR36M7G5qi4A folded before Flop (didn't bet)
Seat 5: K1MDeapSEyKyGPNZGOKfEg mucked
Seat 6: cZ99hugmLBj9KhTlc8nCSw folded before Flop (didn't bet)
Seat 7: H9KUl8cmpLgEpOVDA00bCg (button) folded before Flop (didn't bet)
Seat 8: 3RCAkueG3Vc13VpRStCB+w (small blind) folded before Flop
Seat 9: dfNim92Z6XK1/h5SFW5vDg (big blind) showed [Qs 4d] and won ($0.60) with a pair of Queens




PokerStars Game #59939423564:  Hold'em No Limit ($0.10/$0.25) - 2009/07/01 0:39:30 ET
Table 'yAHDCs33TIgw3ra63xuU2Q' 9-max Seat #7 is the button
Seat 1: 8B/dhbQjIWe6ASCdgzktNQ ($26.15 in chips) 
Seat 2: LBrhQVB4w41YNd7kMYn/og ($19.35 in chips) 
Seat 3: H9KUl8cmpLgEpOVDA00bCg ($4.30 in chips) 
Seat 4: rUdM7gwmNCaxMNSb2CFPhQ ($11 in chips) 
Seat 5: 4awUyiDYTgylQKXZ9faBVA ($25 in chips) 
Seat 7: OiV1PWZ3IkN29JlmCcnTwQ ($4.90 in chips) 
Seat 8: tYsOBqdU1+x+yFI7zHO7hQ ($27.85 in chips) 
Seat 9: k+ydNCnnP3Hgwh0AnDYVrA ($14.40 in chips) 
tYsOBqdU1+x+yFI7zHO7hQ: posts small blind $0.10
k+ydNCnnP3Hgwh0AnDYVrA: posts big blind $0.25
*** HOLE CARDS ***
8B/dhbQjIWe6ASCdgzktNQ: folds 
LBrhQVB4w41YNd7kMYn/og: folds 
H9KUl8cmpLgEpOVDA00bCg: folds 
rUdM7gwmNCaxMNSb2CFPhQ: folds 
4awUyiDYTgylQKXZ9faBVA: folds 
cjelr2AqqD7It1Q2TXfgTQ leaves the table
OiV1PWZ3IkN29JlmCcnTwQ: folds 
tYsOBqdU1+x+yFI7zHO7hQ: folds 
Uncalled bet ($0.15) returned to k+ydNCnnP3Hgwh0AnDYVrA
k+ydNCnnP3Hgwh0AnDYVrA collected $0.20 from pot
k+ydNCnnP3Hgwh0AnDYVrA: doesn't show hand 
*** SUMMARY ***
Total pot $0.20 | Rake $0 
Seat 1: 8B/dhbQjIWe6ASCdgzktNQ folded before Flop (didn't bet)
Seat 2: LBrhQVB4w41YNd7kMYn/og folded before Flop (didn't bet)
Seat 3: H9KUl8cmpLgEpOVDA00bCg folded before Flop (didn't bet)
Seat 4: rUdM7gwmNCaxMNSb2CFPhQ folded before Flop (didn't bet)
Seat 5: 4awUyiDYTgylQKXZ9faBVA folded before Flop (didn't bet)
Seat 7: OiV1PWZ3IkN29JlmCcnTwQ (button) folded before Flop (didn't bet)
Seat 8: tYsOBqdU1+x+yFI7zHO7hQ (small blind) folded before Flop
Seat 9: k+ydNCnnP3Hgwh0AnDYVrA (big blind) collected ($0.20)




PokerStars Game #59939424486:  Hold'em No Limit ($0.10/$0.25) - 2009/07/01 0:39:31 ET
Table 'C8mMnVmvkagwolEzTvh07A' 9-max Seat #6 is the button
Seat 1: t2nb95S5EEFOEzNx9Itz0g ($5.35 in chips) 
Seat 2: CbXUS6Z2rXZxL1AKduNtmQ ($29.10 in chips) 
Seat 3: Th3FldXKQW6hWVVPahaoOQ ($25.35 in chips) 
Seat 4: dfNim92Z6XK1/h5SFW5vDg ($25 in chips) 
Seat 5: iGMlK+EhUflPB6jKQd95Cg ($25 in chips) 
Seat 6: QBNV6v6f+1ZHoaKcQDTWog ($27.35 in chips) 
Seat 8: N6fYvIzQLKaydFLKQGtMlQ ($22.65 in chips) 
Seat 9: 4awUyiDYTgylQKXZ9faBVA ($27.35 in chips) 
N6fYvIzQLKaydFLKQGtMlQ: posts small blind $0.10
4awUyiDYTgylQKXZ9faBVA: posts big blind $0.25
*** HOLE CARDS ***
t2nb95S5EEFOEzNx9Itz0g: folds 
CbXUS6Z2rXZxL1AKduNtmQ: calls $0.25
Th3FldXKQW6hWVVPahaoOQ: folds 
dfNim92Z6XK1/h5SFW5vDg: folds 
iGMlK+EhUflPB6jKQd95Cg: folds 
QBNV6v6f+1ZHoaKcQDTWog: folds 
QBNV6v6f+1ZHoaKcQDTWog leaves the table
N6fYvIzQLKaydFLKQGtMlQ: folds 
4awUyiDYTgylQKXZ9faBVA: raises $0.75 to $1
xiximaris joins the table at seat #6 
CbXUS6Z2rXZxL1AKduNtmQ: calls $0.75
*** FLOP *** [7s Kc 4c]
4awUyiDYTgylQKXZ9faBVA: checks 
CbXUS6Z2rXZxL1AKduNtmQ: checks 
*** TURN *** [7s Kc 4c] [8c]
4awUyiDYTgylQKXZ9faBVA: checks 
CbXUS6Z2rXZxL1AKduNtmQ: bets $1.20
4awUyiDYTgylQKXZ9faBVA: folds 
Uncalled bet ($1.20) returned to CbXUS6Z2rXZxL1AKduNtmQ
CbXUS6Z2rXZxL1AKduNtmQ collected $2 from pot
CbXUS6Z2rXZxL1AKduNtmQ: doesn't show hand 
*** SUMMARY ***
Total pot $2.10 | Rake $0.10 
Board [7s Kc 4c 8c]
Seat 1: t2nb95S5EEFOEzNx9Itz0g folded before Flop (didn't bet)
Seat 2: CbXUS6Z2rXZxL1AKduNtmQ collected ($2)
Seat 3: Th3FldXKQW6hWVVPahaoOQ folded before Flop (didn't bet)
Seat 4: dfNim92Z6XK1/h5SFW5vDg folded before Flop (didn't bet)
Seat 5: iGMlK+EhUflPB6jKQd95Cg folded before Flop (didn't bet)
Seat 6: QBNV6v6f+1ZHoaKcQDTWog (button) folded before Flop (didn't bet)
Seat 8: N6fYvIzQLKaydFLKQGtMlQ (small blind) folded before Flop
Seat 9: 4awUyiDYTgylQKXZ9faBVA (big blind) folded on the Turn




PokerStars Game #59939424222:  Hold'em No Limit ($0.10/$0.25) - 2009/07/01 0:39:31 ET
Table 'h02LhQ7B/Zk4ETRxxHhGYA' 9-max Seat #2 is the button
Seat 1: sD+TKtt36XiiN6jqHiLwDA ($22.40 in chips) 
Seat 2: RJ/x9oZtt1RZLaJEQwZOxQ ($27.95 in chips) 
Seat 4: tYsOBqdU1+x+yFI7zHO7hQ ($38.30 in chips) 
Seat 5: cUxk0Jk4lrUQv9CJl0LPlg ($16.95 in chips) 
Seat 6: kN/irnQSdb8jibbN4f1O+Q ($19.30 in chips) 
Seat 7: rUpvA02nErFvZ4yFbDR8XA ($19.45 in chips) 
Seat 8: 7tW694tRVJnYdoa16Dw4RQ ($25.45 in chips) 
Seat 9: 1c/7DHPx5CDTmAfk8/bWeA ($14.30 in chips) 
tYsOBqdU1+x+yFI7zHO7hQ: posts small blind $0.10
cUxk0Jk4lrUQv9CJl0LPlg: posts big blind $0.25
*** HOLE CARDS ***
kN/irnQSdb8jibbN4f1O+Q: calls $0.25
rUpvA02nErFvZ4yFbDR8XA: folds 
7tW694tRVJnYdoa16Dw4RQ: folds 
1c/7DHPx5CDTmAfk8/bWeA: folds 
sD+TKtt36XiiN6jqHiLwDA: folds 
RJ/x9oZtt1RZLaJEQwZOxQ: calls $0.25
tYsOBqdU1+x+yFI7zHO7hQ: folds 
cUxk0Jk4lrUQv9CJl0LPlg: checks 
*** FLOP *** [8h Ad Jc]
cUxk0Jk4lrUQv9CJl0LPlg: bets $0.50
kN/irnQSdb8jibbN4f1O+Q: calls $0.50
RJ/x9oZtt1RZLaJEQwZOxQ: folds 
*** TURN *** [8h Ad Jc] [9s]
kqpa/IbqkUrwPb3hbA7/ww joins the table at seat #3 
cUxk0Jk4lrUQv9CJl0LPlg: bets $0.50
kN/irnQSdb8jibbN4f1O+Q: calls $0.50
*** RIVER *** [8h Ad Jc 9s] [Ts]
cUxk0Jk4lrUQv9CJl0LPlg: bets $1.50
kN/irnQSdb8jibbN4f1O+Q: folds 
Uncalled bet ($1.50) returned to cUxk0Jk4lrUQv9CJl0LPlg
cUxk0Jk4lrUQv9CJl0LPlg collected $2.75 from pot
*** SUMMARY ***
Total pot $2.85 | Rake $0.10 
Board [8h Ad Jc 9s Ts]
Seat 1: sD+TKtt36XiiN6jqHiLwDA folded before Flop (didn't bet)
Seat 2: RJ/x9oZtt1RZLaJEQwZOxQ (button) folded on the Flop
Seat 4: tYsOBqdU1+x+yFI7zHO7hQ (small blind) folded before Flop
Seat 5: cUxk0Jk4lrUQv9CJl0LPlg (big blind) collected ($2.75)
Seat 6: kN/irnQSdb8jibbN4f1O+Q folded on the River
Seat 7: rUpvA02nErFvZ4yFbDR8XA folded before Flop (didn't bet)
Seat 8: 7tW694tRVJnYdoa16Dw4RQ folded before Flop (didn't bet)
Seat 9: 1c/7DHPx5CDTmAfk8/bWeA folded before Flop (didn't bet)




PokerStars Game #59939424382:  Hold'em No Limit ($0.10/$0.25) - 2009/07/01 0:39:31 ET
Table 'aT31tt16YvQM/Ue69HPLpA' 9-max Seat #5 is the button
Seat 1: uYY6p3irj4hBN7IeHiNGSw ($24.75 in chips) 
Seat 3: tYsOBqdU1+x+yFI7zHO7hQ ($26.65 in chips) 
Seat 4: s7Q6uNouhe7aE8JdFb9E+A ($25 in chips) 
Seat 5: cvtKnIIaTx2+P/KlOK+tfQ ($9.05 in chips) 
Seat 6: 7cv+9Zc9HIQHNvYsMfV3uA ($43.50 in chips) 
Seat 7: s8SPJjToEJz2mPsHsMqL0A ($5.40 in chips) 
Seat 8: lrTLp1zpuCCs/e0pi2M8jw ($44.85 in chips) 
Seat 9: SXqVW4Q0evTUVZG6BbUNIA ($30.75 in chips) 
7cv+9Zc9HIQHNvYsMfV3uA: posts small blind $0.10
s8SPJjToEJz2mPsHsMqL0A: posts big blind $0.25
CYkY0dNBaYaKs8HVCVn3mQ: sits out 
*** HOLE CARDS ***
lrTLp1zpuCCs/e0pi2M8jw: folds 
SXqVW4Q0evTUVZG6BbUNIA: folds 
uYY6p3irj4hBN7IeHiNGSw: folds 
tYsOBqdU1+x+yFI7zHO7hQ: folds 
s7Q6uNouhe7aE8JdFb9E+A: folds 
cvtKnIIaTx2+P/KlOK+tfQ: folds 
7cv+9Zc9HIQHNvYsMfV3uA: calls $0.15
s8SPJjToEJz2mPsHsMqL0A: checks 
*** FLOP *** [7d Kc Kh]
7cv+9Zc9HIQHNvYsMfV3uA: bets $0.50
s8SPJjToEJz2mPsHsMqL0A: calls $0.50
*** TURN *** [7d Kc Kh] [8h]
7cv+9Zc9HIQHNvYsMfV3uA: checks 
s8SPJjToEJz2mPsHsMqL0A: checks 
*** RIVER *** [7d Kc Kh 8h] [2h]
7cv+9Zc9HIQHNvYsMfV3uA: checks 
s8SPJjToEJz2mPsHsMqL0A: bets $4.65 and is all-in
7cv+9Zc9HIQHNvYsMfV3uA: folds 
Uncalled bet ($4.65) returned to s8SPJjToEJz2mPsHsMqL0A
s8SPJjToEJz2mPsHsMqL0A collected $1.45 from pot
*** SUMMARY ***
Total pot $1.50 | Rake $0.05 
Board [7d Kc Kh 8h 2h]
Seat 1: uYY6p3irj4hBN7IeHiNGSw folded before Flop (didn't bet)
Seat 3: tYsOBqdU1+x+yFI7zHO7hQ folded before Flop (didn't bet)
Seat 4: s7Q6uNouhe7aE8JdFb9E+A folded before Flop (didn't bet)
Seat 5: cvtKnIIaTx2+P/KlOK+tfQ (button) folded before Flop (didn't bet)
Seat 6: 7cv+9Zc9HIQHNvYsMfV3uA (small blind) folded on the River
Seat 7: s8SPJjToEJz2mPsHsMqL0A (big blind) collected ($1.45)
Seat 8: lrTLp1zpuCCs/e0pi2M8jw folded before Flop (didn't bet)
Seat 9: SXqVW4Q0evTUVZG6BbUNIA folded before Flop (didn't bet)




PokerStars Game #59939424142:  Hold'em No Limit ($0.10/$0.25) - 2009/07/01 0:39:31 ET
Table 'hOE09W281uSob0XeJmUcRg' 6-max Seat #4 is the button
Seat 1: edio/rLJ06xeZOfLhoL3UA ($15 in chips) 
Seat 4: TslQs7AQSLbVtr4X8JOOOQ ($19.55 in chips) 
Seat 5: 66a/8+qw1AZLNh63FuclPA ($101.10 in chips) 
Seat 6: x4ZJ8E/TUrtoB7WiHcv8WA ($10.85 in chips) 
66a/8+qw1AZLNh63FuclPA: posts small blind $0.10
x4ZJ8E/TUrtoB7WiHcv8WA: posts big blind $0.25
edio/rLJ06xeZOfLhoL3UA: posts big blind $0.25
*** HOLE CARDS ***
edio/rLJ06xeZOfLhoL3UA: checks 
TslQs7AQSLbVtr4X8JOOOQ: folds 
66a/8+qw1AZLNh63FuclPA: folds 
x4ZJ8E/TUrtoB7WiHcv8WA: checks 
*** FLOP *** [Ad Jc 4h]
x4ZJ8E/TUrtoB7WiHcv8WA: checks 
edio/rLJ06xeZOfLhoL3UA: bets $0.75
x4ZJ8E/TUrtoB7WiHcv8WA: folds 
Uncalled bet ($0.75) returned to edio/rLJ06xeZOfLhoL3UA
edio/rLJ06xeZOfLhoL3UA collected $0.60 from pot
edio/rLJ06xeZOfLhoL3UA: doesn't show hand 
*** SUMMARY ***
Total pot $0.60 | Rake $0 
Board [Ad Jc 4h]
Seat 1: edio/rLJ06xeZOfLhoL3UA collected ($0.60)
Seat 4: TslQs7AQSLbVtr4X8JOOOQ (button) folded before Flop (didn't bet)
Seat 5: 66a/8+qw1AZLNh63FuclPA (small blind) folded before Flop
Seat 6: x4ZJ8E/TUrtoB7WiHcv8WA (big blind) folded on the Flop




PokerStars Game #59939424344:  Hold'em No Limit ($0.10/$0.25) - 2009/07/01 0:39:31 ET
Table 'jItkp2PNTbH9Cf7gqsAF7g' 9-max Seat #8 is the button
Seat 1: OiV1PWZ3IkN29JlmCcnTwQ ($5 in chips) 
Seat 2: qwr38jl5txoR36M7G5qi4A ($7.50 in chips) 
Seat 3: E0iYnEVO2ho7dH3QcCjw7g ($24.35 in chips) 
Seat 4: GQTWTgG7Ydy9q/vohVnKmQ ($29.10 in chips) 
Seat 5: uH1RN27w9SKa7TpVR9EFrQ ($17.80 in chips) 
Seat 6: cZ99hugmLBj9KhTlc8nCSw ($58.60 in chips) 
Seat 7: st9jtdNbm1W5GfBwRaCVqQ ($21.50 in chips) 
Seat 8: t82lXIS9gxYmNHmDgWRFAQ ($11.85 in chips) 
Seat 9: H9KUl8cmpLgEpOVDA00bCg ($6.70 in chips) 
H9KUl8cmpLgEpOVDA00bCg: posts small blind $0.10
OiV1PWZ3IkN29JlmCcnTwQ: posts big blind $0.25
*** HOLE CARDS ***
qwr38jl5txoR36M7G5qi4A: folds 
E0iYnEVO2ho7dH3QcCjw7g: raises $0.50 to $0.75
GQTWTgG7Ydy9q/vohVnKmQ: folds 
uH1RN27w9SKa7TpVR9EFrQ: folds 
cZ99hugmLBj9KhTlc8nCSw: folds 
st9jtdNbm1W5GfBwRaCVqQ: folds 
t82lXIS9gxYmNHmDgWRFAQ: folds 
H9KUl8cmpLgEpOVDA00bCg: folds 
OiV1PWZ3IkN29JlmCcnTwQ: folds 
Uncalled bet ($0.50) returned to E0iYnEVO2ho7dH3QcCjw7g
E0iYnEVO2ho7dH3QcCjw7g collected $0.60 from pot
*** SUMMARY ***
Total pot $0.60 | Rake $0 
Seat 1: OiV1PWZ3IkN29JlmCcnTwQ (big blind) folded before Flop
Seat 2: qwr38jl5txoR36M7G5qi4A folded before Flop (didn't bet)
Seat 3: E0iYnEVO2ho7dH3QcCjw7g collected ($0.60)
Seat 4: GQTWTgG7Ydy9q/vohVnKmQ folded before Flop (didn't bet)
Seat 5: uH1RN27w9SKa7TpVR9EFrQ folded before Flop (didn't bet)
Seat 6: cZ99hugmLBj9KhTlc8nCSw folded before Flop (didn't bet)
Seat 7: st9jtdNbm1W5GfBwRaCVqQ folded before Flop (didn't bet)
Seat 8: t82lXIS9gxYmNHmDgWRFAQ (button) folded before Flop (didn't bet)
Seat 9: H9KUl8cmpLgEpOVDA00bCg (small blind) folded before Flop




PokerStars Game #59939424282:  Hold'em No Limit ($0.10/$0.25) - 2009/07/01 0:39:31 ET
Table '1zj0+miaIL9cvwnT/50pOA' 9-max Seat #9 is the button
Seat 1: spidnpwmoJ1L6yeNW7D5UA ($25.60 in chips) 
Seat 2: HPEB+AtKw1+C/cxU0o1ciw ($28.45 in chips) 
Seat 3: CYkY0dNBaYaKs8HVCVn3mQ ($5.85 in chips) 
Seat 4: 6esz1u5YivjsX0UoeMBm3w ($22.15 in chips) 
Seat 5: JxpnpCmvRAcrEUy7mq1iAg ($5.70 in chips) 
Seat 6: ydoFOVgzvZv9ZhuWu9rXAw ($5 in chips) 
Seat 7: 6oWOdVz2WG2azNuOj9rMgg ($16.45 in chips) 
Seat 8: HOiu48bZMhEZSoJa8mjiMw ($32.55 in chips) 
Seat 9: OiV1PWZ3IkN29JlmCcnTwQ ($5.25 in chips) 
spidnpwmoJ1L6yeNW7D5UA: posts small blind $0.10
HPEB+AtKw1+C/cxU0o1ciw: posts big blind $0.25
*** HOLE CARDS ***
CYkY0dNBaYaKs8HVCVn3mQ: folds 
6esz1u5YivjsX0UoeMBm3w: folds 
JxpnpCmvRAcrEUy7mq1iAg: folds 
ydoFOVgzvZv9ZhuWu9rXAw: folds 
6oWOdVz2WG2azNuOj9rMgg: folds 
HOiu48bZMhEZSoJa8mjiMw: folds 
OiV1PWZ3IkN29JlmCcnTwQ: folds 
spidnpwmoJ1L6yeNW7D5UA: folds 
Uncalled bet ($0.15) returned to HPEB+AtKw1+C/cxU0o1ciw
HPEB+AtKw1+C/cxU0o1ciw collected $0.20 from pot
HPEB+AtKw1+C/cxU0o1ciw: doesn't show hand 
*** SUMMARY ***
Total pot $0.20 | Rake $0 
Seat 1: spidnpwmoJ1L6yeNW7D5UA (small blind) folded before Flop
Seat 2: HPEB+AtKw1+C/cxU0o1ciw (big blind) collected ($0.20)
Seat 3: CYkY0dNBaYaKs8HVCVn3mQ folded before Flop (didn't bet)
Seat 4: 6esz1u5YivjsX0UoeMBm3w folded before Flop (didn't bet)
Seat 5: JxpnpCmvRAcrEUy7mq1iAg folded before Flop (didn't bet)
Seat 6: ydoFOVgzvZv9ZhuWu9rXAw folded before Flop (didn't bet)
Seat 7: 6oWOdVz2WG2azNuOj9rMgg folded before Flop (didn't bet)
Seat 8: HOiu48bZMhEZSoJa8mjiMw folded before Flop (didn't bet)
Seat 9: OiV1PWZ3IkN29JlmCcnTwQ (button) folded before Flop (didn't bet)




PokerStars Game #59939424364:  Hold'em No Limit ($0.10/$0.25) - 2009/07/01 0:39:31 ET
Table 'IIO2q2znuuAXmiZ2qFTcmg' 6-max Seat #1 is the button
Seat 1: nwwpaieDRI0UPyVtChVHOg ($17.75 in chips) 
Seat 2: cS21pIxRHx5Gt42o7hPZzw ($14.20 in chips) 
Seat 3: hiTEr3yrERiQp3zHXRioVw ($14.75 in chips) 
Seat 4: 0HIrwssk0FQvyKULzUTtlg ($11 in chips) 
Seat 5: f9iRHw0d+kV7pbTYwF2+2g ($17.80 in chips) 
cS21pIxRHx5Gt42o7hPZzw: posts small blind $0.10
hiTEr3yrERiQp3zHXRioVw: posts big blind $0.25
*** HOLE CARDS ***
0HIrwssk0FQvyKULzUTtlg: raises $0.75 to $1
f9iRHw0d+kV7pbTYwF2+2g: folds 
nwwpaieDRI0UPyVtChVHOg: folds 
cS21pIxRHx5Gt42o7hPZzw: folds 
hiTEr3yrERiQp3zHXRioVw: folds 
Uncalled bet ($0.75) returned to 0HIrwssk0FQvyKULzUTtlg
0HIrwssk0FQvyKULzUTtlg collected $0.60 from pot
*** SUMMARY ***
Total pot $0.60 | Rake $0 
Seat 1: nwwpaieDRI0UPyVtChVHOg (button) folded before Flop (didn't bet)
Seat 2: cS21pIxRHx5Gt42o7hPZzw (small blind) folded before Flop
Seat 3: hiTEr3yrERiQp3zHXRioVw (big blind) folded before Flop
Seat 4: 0HIrwssk0FQvyKULzUTtlg collected ($0.60)
Seat 5: f9iRHw0d+kV7pbTYwF2+2g folded before Flop (didn't bet)




PokerStars Game #59939424106:  Hold'em No Limit ($0.10/$0.25) - 2009/07/01 0:39:31 ET
Table '6ae4XiTo6B597KfSSMr8Cg' 9-max Seat #3 is the button
Seat 1: 49YfVBEOwzD3/FVw+dTTBQ ($5.65 in chips) 
Seat 2: 5s3p6yoJBNW438dsyKTP8g ($45.75 in chips) 
Seat 3: yyG4svzOpC1A+sUP/scg6w ($8.05 in chips) 
Seat 4: dfNim92Z6XK1/h5SFW5vDg ($48.85 in chips) 
Seat 5: 1K6QGyJP9P9xmRac2fH4OQ ($25 in chips) 
Seat 7: 18G4P1XstjNvItdGUITxgw ($25.25 in chips) 
Seat 9: E0iYnEVO2ho7dH3QcCjw7g ($34.70 in chips) 
dfNim92Z6XK1/h5SFW5vDg: posts small blind $0.10
1K6QGyJP9P9xmRac2fH4OQ: posts big blind $0.25
DlXs37dlX3tb7o/7lYXQSw: sits out 
lacross84: sits out 
*** HOLE CARDS ***
18G4P1XstjNvItdGUITxgw: folds 
E0iYnEVO2ho7dH3QcCjw7g: folds 
49YfVBEOwzD3/FVw+dTTBQ: folds 
5s3p6yoJBNW438dsyKTP8g: folds 
yyG4svzOpC1A+sUP/scg6w: folds 
dfNim92Z6XK1/h5SFW5vDg: folds 
Uncalled bet ($0.15) returned to 1K6QGyJP9P9xmRac2fH4OQ
1K6QGyJP9P9xmRac2fH4OQ collected $0.20 from pot
1K6QGyJP9P9xmRac2fH4OQ: doesn't show hand 
*** SUMMARY ***
Total pot $0.20 | Rake $0 
Seat 1: 49YfVBEOwzD3/FVw+dTTBQ folded before Flop (didn't bet)
Seat 2: 5s3p6yoJBNW438dsyKTP8g folded before Flop (didn't bet)
Seat 3: yyG4svzOpC1A+sUP/scg6w (button) folded before Flop (didn't bet)
Seat 4: dfNim92Z6XK1/h5SFW5vDg (small blind) folded before Flop
Seat 5: 1K6QGyJP9P9xmRac2fH4OQ (big blind) collected ($0.20)
Seat 7: 18G4P1XstjNvItdGUITxgw folded before Flop (didn't bet)
Seat 9: E0iYnEVO2ho7dH3QcCjw7g folded before Flop (didn't bet)




PokerStars Game #59939424184:  Hold'em No Limit ($0.10/$0.25) - 2009/07/01 0:39:31 ET
Table '/AhP8uWRzEEhOATYIdmn0A' 9-max Seat #3 is the button
Seat 1: +sbyWwIcFp9kP0bDtMegfQ ($23.75 in chips) 
Seat 2: nvWCCH1JBjMjQkSaXl2Mog ($16.95 in chips) 
Seat 3: vSkQm2EelzwRGDDQQk0Fqw ($4.65 in chips) 
Seat 5: BEIBUu2pIflPrCL+Iks4CQ ($13.25 in chips) 
Seat 6: 1K6QGyJP9P9xmRac2fH4OQ ($25 in chips) 
Seat 7: 4oA316mXLIui1QY63GXBUg ($25 in chips) 
Seat 9: DIBbjEYGs+TVdVgEB/4+3w ($29.25 in chips) 
BEIBUu2pIflPrCL+Iks4CQ: posts small blind $0.10
1K6QGyJP9P9xmRac2fH4OQ: posts big blind $0.25
CYkY0dNBaYaKs8HVCVn3mQ: sits out 
*** HOLE CARDS ***
4oA316mXLIui1QY63GXBUg: folds 
DIBbjEYGs+TVdVgEB/4+3w: folds 
+sbyWwIcFp9kP0bDtMegfQ: folds 
nvWCCH1JBjMjQkSaXl2Mog: raises $0.50 to $0.75
vSkQm2EelzwRGDDQQk0Fqw: folds 
BEIBUu2pIflPrCL+Iks4CQ: folds 
1K6QGyJP9P9xmRac2fH4OQ: folds 
Uncalled bet ($0.50) returned to nvWCCH1JBjMjQkSaXl2Mog
nvWCCH1JBjMjQkSaXl2Mog collected $0.60 from pot
*** SUMMARY ***
Total pot $0.60 | Rake $0 
Seat 1: +sbyWwIcFp9kP0bDtMegfQ folded before Flop (didn't bet)
Seat 2: nvWCCH1JBjMjQkSaXl2Mog collected ($0.60)
Seat 3: vSkQm2EelzwRGDDQQk0Fqw (button) folded before Flop (didn't bet)
Seat 5: BEIBUu2pIflPrCL+Iks4CQ (small blind) folded before Flop
Seat 6: 1K6QGyJP9P9xmRac2fH4OQ (big blind) folded before Flop
Seat 7: 4oA316mXLIui1QY63GXBUg folded before Flop (didn't bet)
Seat 9: DIBbjEYGs+TVdVgEB/4+3w folded before Flop (didn't bet)




PokerStars Game #59939425024:  Hold'em No Limit ($0.10/$0.25) - 2009/07/01 0:39:32 ET
Table '/XCUCUl3yW6tdTJQEhJKGw' 6-max Seat #1 is the button
Seat 1: p8J112JmNRnCwV2+NAEzCA ($15.30 in chips) 
Seat 2: 8ClCHtFXGNplITm+63KB+Q ($28.05 in chips) 
Seat 3: /gJNBeCkWL4o85/jvlZ4BA ($35.60 in chips) 
Seat 4: SFmT9ZsVopnukjvAzrxTRg ($25 in chips) 
Seat 5: 3rlIjSrvbZoI2IILbnetnA ($25 in chips) 
Seat 6: armfxZhGxeZVZBYAQFuIJQ ($36.45 in chips) 
8ClCHtFXGNplITm+63KB+Q: posts small blind $0.10
/gJNBeCkWL4o85/jvlZ4BA: posts big blind $0.25
*** HOLE CARDS ***
SFmT9ZsVopnukjvAzrxTRg: raises $0.75 to $1
3rlIjSrvbZoI2IILbnetnA: folds 
armfxZhGxeZVZBYAQFuIJQ: folds 
p8J112JmNRnCwV2+NAEzCA: folds 
8ClCHtFXGNplITm+63KB+Q: folds 
/gJNBeCkWL4o85/jvlZ4BA: folds 
Uncalled bet ($0.75) returned to SFmT9ZsVopnukjvAzrxTRg
SFmT9ZsVopnukjvAzrxTRg collected $0.60 from pot
SFmT9ZsVopnukjvAzrxTRg: doesn't show hand 
*** SUMMARY ***
Total pot $0.60 | Rake $0 
Seat 1: p8J112JmNRnCwV2+NAEzCA (button) folded before Flop (didn't bet)
Seat 2: 8ClCHtFXGNplITm+63KB+Q (small blind) folded before Flop
Seat 3: /gJNBeCkWL4o85/jvlZ4BA (big blind) folded before Flop
Seat 4: SFmT9ZsVopnukjvAzrxTRg collected ($0.60)
Seat 5: 3rlIjSrvbZoI2IILbnetnA folded before Flop (didn't bet)
Seat 6: armfxZhGxeZVZBYAQFuIJQ folded before Flop (didn't bet)




PokerStars Game #59939425296:  Hold'em No Limit ($0.10/$0.25) - 2009/07/01 0:39:32 ET
Table 'IRgQPZVA4+IaZZIQshgwyg' 6-max Seat #5 is the button
Seat 1: d0J1xuhsynEY81YHwAvJ5g ($25.35 in chips) 
Seat 2: 9jSiy0meE9XJKkdIZwyTEQ ($35.45 in chips) 
Seat 3: 8EEqTTh7T1q48sYDqbI2Xg ($26.35 in chips) 
Seat 4: PXXRy0uk7WED5BEf+ReJDQ ($14.15 in chips) 
Seat 5: PbMzPZIePKifKQZfKDkbIw ($27.35 in chips) 
Seat 6: qo39V8/pMxxofM2aciLSWQ ($37.95 in chips) 
qo39V8/pMxxofM2aciLSWQ: posts small blind $0.10
d0J1xuhsynEY81YHwAvJ5g: posts big blind $0.25
*** HOLE CARDS ***
9jSiy0meE9XJKkdIZwyTEQ: folds 
8EEqTTh7T1q48sYDqbI2Xg: folds 
PXXRy0uk7WED5BEf+ReJDQ: folds 
PbMzPZIePKifKQZfKDkbIw: folds 
qo39V8/pMxxofM2aciLSWQ: folds 
Uncalled bet ($0.15) returned to d0J1xuhsynEY81YHwAvJ5g
d0J1xuhsynEY81YHwAvJ5g collected $0.20 from pot
d0J1xuhsynEY81YHwAvJ5g: doesn't show hand 
*** SUMMARY ***
Total pot $0.20 | Rake $0 
Seat 1: d0J1xuhsynEY81YHwAvJ5g (big blind) collected ($0.20)
Seat 2: 9jSiy0meE9XJKkdIZwyTEQ folded before Flop (didn't bet)
Seat 3: 8EEqTTh7T1q48sYDqbI2Xg folded before Flop (didn't bet)
Seat 4: PXXRy0uk7WED5BEf+ReJDQ folded before Flop (didn't bet)
Seat 5: PbMzPZIePKifKQZfKDkbIw (button) folded before Flop (didn't bet)
Seat 6: qo39V8/pMxxofM2aciLSWQ (small blind) folded before Flop




PokerStars Game #59939424880:  Hold'em No Limit ($0.10/$0.25) - 2009/07/01 0:39:32 ET
Table 'oxYpQNT8OHNCvpMIFi7UoA' 9-max Seat #2 is the button
Seat 2: Ofo77cVa49gHqAMfHrrMbw ($12.60 in chips) 
Seat 4: ghNKXUBl/H+t83JF079ZBA ($25 in chips) 
Seat 5: SXqVW4Q0evTUVZG6BbUNIA ($34.15 in chips) 
Seat 6: +2kMBNpY4nF1qNCRd8SJLA ($25 in chips) 
Seat 8: OlPJsgR4xypSg/w1z7Gyvw ($19.10 in chips) 
Seat 9: KK7jFoJo1TzDCPdsfpPjtw ($40.80 in chips) 
Belzer74 will be allowed to play after the button
ghNKXUBl/H+t83JF079ZBA: posts small blind $0.10
SXqVW4Q0evTUVZG6BbUNIA: posts big blind $0.25
yyG4svzOpC1A+sUP/scg6w: sits out 
*** HOLE CARDS ***
H5Se03ZqSX7tbULXur2MAg has returned
+2kMBNpY4nF1qNCRd8SJLA: folds 
OlPJsgR4xypSg/w1z7Gyvw: folds 
KK7jFoJo1TzDCPdsfpPjtw: folds 
Ofo77cVa49gHqAMfHrrMbw: folds 
ghNKXUBl/H+t83JF079ZBA: folds 
Uncalled bet ($0.15) returned to SXqVW4Q0evTUVZG6BbUNIA
SXqVW4Q0evTUVZG6BbUNIA collected $0.20 from pot
SXqVW4Q0evTUVZG6BbUNIA: doesn't show hand 
*** SUMMARY ***
Total pot $0.20 | Rake $0 
Seat 2: Ofo77cVa49gHqAMfHrrMbw (button) folded before Flop (didn't bet)
Seat 4: ghNKXUBl/H+t83JF079ZBA (small blind) folded before Flop
Seat 5: SXqVW4Q0evTUVZG6BbUNIA (big blind) collected ($0.20)
Seat 6: +2kMBNpY4nF1qNCRd8SJLA folded before Flop (didn't bet)
Seat 8: OlPJsgR4xypSg/w1z7Gyvw folded before Flop (didn't bet)
Seat 9: KK7jFoJo1TzDCPdsfpPjtw folded before Flop (didn't bet)




PokerStars Game #59939425072:  Hold'em No Limit ($0.10/$0.25) - 2009/07/01 0:39:32 ET
Table '8TQqiBvztdoBMTFQQ4MYSA' 9-max Seat #5 is the button
Seat 1: LWN1wPrLH+695JIriXxDuw ($22.85 in chips) 
Seat 2: amD2PwT1xB7aC2k57sa7Ig ($22.70 in chips) 
Seat 3: DIBbjEYGs+TVdVgEB/4+3w ($25.15 in chips) 
Seat 4: EUMLvzDkECHBit+xa+uGjg ($14.45 in chips) 
Seat 5: vZGoOTJLQLhkPj4I+LNGig ($25 in chips) 
Seat 6: MIVCHqCqqlke0Lb0z7glcw ($37.70 in chips) 
Seat 7: STkR8XvpjNv79OOMhrlh2w ($25 in chips) 
Seat 8: 33a0y3nYwUhzkf9PNzg4/Q ($7.30 in chips) 
Seat 9: SXqVW4Q0evTUVZG6BbUNIA ($42.20 in chips) 
MIVCHqCqqlke0Lb0z7glcw: posts small blind $0.10
STkR8XvpjNv79OOMhrlh2w: posts big blind $0.25
*** HOLE CARDS ***
33a0y3nYwUhzkf9PNzg4/Q: calls $0.25
SXqVW4Q0evTUVZG6BbUNIA: folds 
LWN1wPrLH+695JIriXxDuw: folds 
amD2PwT1xB7aC2k57sa7Ig: folds 
DIBbjEYGs+TVdVgEB/4+3w: folds 
EUMLvzDkECHBit+xa+uGjg: folds 
vZGoOTJLQLhkPj4I+LNGig: calls $0.25
MIVCHqCqqlke0Lb0z7glcw: folds 
STkR8XvpjNv79OOMhrlh2w: checks 
*** FLOP *** [9h 3d Jh]
STkR8XvpjNv79OOMhrlh2w: checks 
33a0y3nYwUhzkf9PNzg4/Q: checks 
vZGoOTJLQLhkPj4I+LNGig: checks 
*** TURN *** [9h 3d Jh] [Ac]
STkR8XvpjNv79OOMhrlh2w: checks 
33a0y3nYwUhzkf9PNzg4/Q: bets $0.50
vZGoOTJLQLhkPj4I+LNGig: folds 
STkR8XvpjNv79OOMhrlh2w: folds 
Uncalled bet ($0.50) returned to 33a0y3nYwUhzkf9PNzg4/Q
33a0y3nYwUhzkf9PNzg4/Q collected $0.85 from pot
33a0y3nYwUhzkf9PNzg4/Q: doesn't show hand 
*** SUMMARY ***
Total pot $0.85 | Rake $0 
Board [9h 3d Jh Ac]
Seat 1: LWN1wPrLH+695JIriXxDuw folded before Flop (didn't bet)
Seat 2: amD2PwT1xB7aC2k57sa7Ig folded before Flop (didn't bet)
Seat 3: DIBbjEYGs+TVdVgEB/4+3w folded before Flop (didn't bet)
Seat 4: EUMLvzDkECHBit+xa+uGjg folded before Flop (didn't bet)
Seat 5: vZGoOTJLQLhkPj4I+LNGig (button) folded on the Turn
Seat 6: MIVCHqCqqlke0Lb0z7glcw (small blind) folded before Flop
Seat 7: STkR8XvpjNv79OOMhrlh2w (big blind) folded on the Turn
Seat 8: 33a0y3nYwUhzkf9PNzg4/Q collected ($0.85)
Seat 9: SXqVW4Q0evTUVZG6BbUNIA folded before Flop (didn't bet)




PokerStars Game #59939424678:  Hold'em No Limit ($0.10/$0.25) - 2009/07/01 0:39:32 ET
Table 'G26g8jde1eR+mmabeFeSlw' 9-max Seat #8 is the button
Seat 1: eygIcrabyU9hI2mw7NQsgg ($22 in chips) 
Seat 2: O2aLEhH7P83nWGvgV84KoA ($14.15 in chips) 
Seat 3: WKL8nUFr7TumC4EjLyqYzw ($5.50 in chips) 
Seat 4: 1Clf3cPrqoy/YgvWdWK1Xw ($5 in chips) 
Seat 5: hJ4uYjNmSZdjrKA8cjZqCA ($19 in chips) 
Seat 6: opOCI2p6kW0tINuVaAqmcQ ($25 in chips) 
Seat 7: nm4Dj/f+jJEwKVsUnKh73g ($26.25 in chips) 
Seat 8: G+6mJ0LVzvA9qwETH4Ostw ($25.65 in chips) 
Seat 9: VWUWpMLMj/Q1jRVpF7Aohw ($12 in chips) 
VWUWpMLMj/Q1jRVpF7Aohw: posts small blind $0.10
eygIcrabyU9hI2mw7NQsgg: posts big blind $0.25
*** HOLE CARDS ***
O2aLEhH7P83nWGvgV84KoA: folds 
WKL8nUFr7TumC4EjLyqYzw: folds 
1Clf3cPrqoy/YgvWdWK1Xw: folds 
hJ4uYjNmSZdjrKA8cjZqCA: folds 
opOCI2p6kW0tINuVaAqmcQ: folds 
nm4Dj/f+jJEwKVsUnKh73g: folds 
G+6mJ0LVzvA9qwETH4Ostw: calls $0.25
VWUWpMLMj/Q1jRVpF7Aohw: calls $0.15
eygIcrabyU9hI2mw7NQsgg: checks 
*** FLOP *** [Td Ks 3c]
VWUWpMLMj/Q1jRVpF7Aohw: bets $0.75
eygIcrabyU9hI2mw7NQsgg: folds 
G+6mJ0LVzvA9qwETH4Ostw: folds 
Uncalled bet ($0.75) returned to VWUWpMLMj/Q1jRVpF7Aohw
VWUWpMLMj/Q1jRVpF7Aohw collected $0.75 from pot
*** SUMMARY ***
Total pot $0.75 | Rake $0 
Board [Td Ks 3c]
Seat 1: eygIcrabyU9hI2mw7NQsgg (big blind) folded on the Flop
Seat 2: O2aLEhH7P83nWGvgV84KoA folded before Flop (didn't bet)
Seat 3: WKL8nUFr7TumC4EjLyqYzw folded before Flop (didn't bet)
Seat 4: 1Clf3cPrqoy/YgvWdWK1Xw folded before Flop (didn't bet)
Seat 5: hJ4uYjNmSZdjrKA8cjZqCA folded before Flop (didn't bet)
Seat 6: opOCI2p6kW0tINuVaAqmcQ folded before Flop (didn't bet)
Seat 7: nm4Dj/f+jJEwKVsUnKh73g folded before Flop (didn't bet)
Seat 8: G+6mJ0LVzvA9qwETH4Ostw (button) folded on the Flop
Seat 9: VWUWpMLMj/Q1jRVpF7Aohw (small blind) collected ($0.75)




PokerStars Game #59939424760:  Hold'em No Limit ($0.10/$0.25) - 2009/07/01 0:39:32 ET
Table 'BabJGL6tfXQp3leBGbYe8A' 9-max Seat #2 is the button
Seat 2: G5EFgY1bi50mF1iH/+B4yQ ($3 in chips) 
Seat 3: Jdj7AsGFrlkCgDXeWK322A ($24.25 in chips) 
Seat 4: Yk91gygnxgAKPGHZ/jPVSw ($9.45 in chips) 
Seat 5: fKqW4kzqpoOv+YKE5kp3FA ($4 in chips) 
Seat 6: ELKIDQ6mBSQJr3wiHYHtvw ($7.75 in chips) 
Seat 7: PS2bAPjvHsF4E9tIyk0xBg ($6.20 in chips) 
Seat 8: TJEefy+0K5gBV+8LA5OK7Q ($25 in chips) 
Seat 9: xEQxarad8/T4jJdpZy5LGw ($10.30 in chips) 
Jdj7AsGFrlkCgDXeWK322A: posts small blind $0.10
Yk91gygnxgAKPGHZ/jPVSw: posts big blind $0.25
TJEefy+0K5gBV+8LA5OK7Q: posts big blind $0.25
qwr38jl5txoR36M7G5qi4A: sits out 
*** HOLE CARDS ***
fKqW4kzqpoOv+YKE5kp3FA: calls $0.25
ELKIDQ6mBSQJr3wiHYHtvw: folds 
PS2bAPjvHsF4E9tIyk0xBg: raises $0.25 to $0.50
TJEefy+0K5gBV+8LA5OK7Q: folds 
xEQxarad8/T4jJdpZy5LGw: calls $0.50
G5EFgY1bi50mF1iH/+B4yQ: calls $0.50
Jdj7AsGFrlkCgDXeWK322A: folds 
Yk91gygnxgAKPGHZ/jPVSw: calls $0.25
fKqW4kzqpoOv+YKE5kp3FA: calls $0.25
*** FLOP *** [9s Kd Qs]
Yk91gygnxgAKPGHZ/jPVSw: checks 
fKqW4kzqpoOv+YKE5kp3FA: checks 
PS2bAPjvHsF4E9tIyk0xBg: bets $5.70 and is all-in
xEQxarad8/T4jJdpZy5LGw: folds 
G5EFgY1bi50mF1iH/+B4yQ: calls $2.50 and is all-in
Yk91gygnxgAKPGHZ/jPVSw: folds 
fKqW4kzqpoOv+YKE5kp3FA: calls $3.50 and is all-in
Uncalled bet ($2.20) returned to PS2bAPjvHsF4E9tIyk0xBg
*** TURN *** [9s Kd Qs] [Ts]
*** RIVER *** [9s Kd Qs Ts] [4c]
*** SHOW DOWN ***
fKqW4kzqpoOv+YKE5kp3FA: shows [Ah Ad] (a pair of Aces)
PS2bAPjvHsF4E9tIyk0xBg: mucks hand 
fKqW4kzqpoOv+YKE5kp3FA collected $1.90 from side pot
G5EFgY1bi50mF1iH/+B4yQ: shows [4s As] (a flush, Ace high)
G5EFgY1bi50mF1iH/+B4yQ collected $9.85 from main pot
*** SUMMARY ***
Total pot $12.35 Main pot $9.85. Side pot $1.90. | Rake $0.60 
Board [9s Kd Qs Ts 4c]
Seat 2: G5EFgY1bi50mF1iH/+B4yQ (button) showed [4s As] and won ($9.85) with a flush, Ace high
Seat 3: Jdj7AsGFrlkCgDXeWK322A (small blind) folded before Flop
Seat 4: Yk91gygnxgAKPGHZ/jPVSw (big blind) folded on the Flop
Seat 5: fKqW4kzqpoOv+YKE5kp3FA showed [Ah Ad] and won ($1.90) with a pair of Aces
Seat 6: ELKIDQ6mBSQJr3wiHYHtvw folded before Flop (didn't bet)
Seat 7: PS2bAPjvHsF4E9tIyk0xBg mucked
Seat 8: TJEefy+0K5gBV+8LA5OK7Q folded before Flop
Seat 9: xEQxarad8/T4jJdpZy5LGw folded on the Flop




PokerStars Game #59939425870:  Hold'em No Limit ($0.10/$0.25) - 2009/07/01 0:39:33 ET
Table 'ZiwAqg4o02gNro+JOAaFNg6wawJ+MkkvuC3coG6r+YhgSeat #1 is the button
Seat 1: j4q3p0lesp63b1gZDwLBZw ($5 in chips) 
Seat 2: tYsOBqdU1+x+yFI7zHO7hQ ($31.20 in chips) 
Seat 3: aNpwfA31EREwO+ar4XzBCw ($25 in chips) 
Seat 4: FJflwqC6fqOpM3j0q8Bptw ($17.90 in chips) 
Seat 6: hBMUlEpyU74r/fwDgIpXjQ ($27.95 in chips) 
Seat 7: ZWU9RNYtjmm4cElg1I0F4w ($27.20 in chips) 
Seat 8: CYkY0dNBaYaKs8HVCVn3mQ ($5 in chips) 
Seat 9: ljemhp25Zg+nlA9DLCIiUw ($24.65 in chips) 
tYsOBqdU1+x+yFI7zHO7hQ: posts small blind $0.10
aNpwfA31EREwO+ar4XzBCw: posts big blind $0.25
5hAPbqNrvJb8PtLiceXtlg6HoFYfVGBefsR5Vrz62qIwts out 
*** HOLE CARDS ***
FJflwqC6fqOpM3j0q8Bptw: calls $0.25
hBMUlEpyU74r/fwDgIpXjQ: folds 
ZWU9RNYtjmm4cElg1I0F4w: folds 
CYkY0dNBaYaKs8HVCVn3mQ: folds 
ZWU9RNYtjmm4cElg1I0F4w leaves the table
ljemhp25Zg+nlA9DLCIiUw: folds 
j4q3p0lesp63b1gZDwLBZw: raises $0.50 to $0.75
tYsOBqdU1+x+yFI7zHO7hQ: folds 
aNpwfA31EREwO+ar4XzBCw: folds 
opOCI2p6kW0tINuVaAqmcQ joins the table at seat #7 
FJflwqC6fqOpM3j0q8Bptw: folds 
Uncalled bet ($0.50) returned to j4q3p0lesp63b1gZDwLBZw
j4q3p0lesp63b1gZDwLBZw collected $0.85 from pot
j4q3p0lesp63b1gZDwLBZw: doesn't show hand 
*** SUMMARY ***
Total pot $0.85 | Rake $0 
Seat 1: j4q3p0lesp63b1gZDwLBZw (button) collected ($0.85)
Seat 2: tYsOBqdU1+x+yFI7zHO7hQ (small blind) folded before Flop
Seat 3: aNpwfA31EREwO+ar4XzBCw (big blind) folded before Flop
Seat 4: FJflwqC6fqOpM3j0q8Bptw folded before Flop
Seat 6: hBMUlEpyU74r/fwDgIpXjQ folded before Flop (didn't bet)
Seat 7: ZWU9RNYtjmm4cElg1I0F4w folded before Flop (didn't bet)
Seat 8: CYkY0dNBaYaKs8HVCVn3mQ folded before Flop (didn't bet)
Seat 9: ljemhp25Zg+nlA9DLCIiUw folded before Flop (didn't bet)




PokerStars Game #59939425512:  Hold'em No Limit ($0.10/$0.25) - 2009/07/01 0:39:33 ET
Table '9HJEqVOjSU5ECoVB4C4sgQ' 6-max Seat #1 is the button
Seat 1: EyMmRrAOlNpDOWLqSYRZdw ($27.45 in chips) 
Seat 2: sEQx9G5Cu8k1HNdQasxvUA ($35.85 in chips) 
Seat 3: KM6ogk7SqyRlk3m9b0h+7A ($14.10 in chips) 
Seat 4: mfrkWA3PTeYPkbO6hi98Aw ($34.40 in chips) 
Seat 5: ymz+a8dgHSUFPooYplw7Ow ($25 in chips) 
Seat 6: aOMbOQ6Ji1Gie6dYOurd5A ($14.10 in chips) 
sEQx9G5Cu8k1HNdQasxvUA: posts small blind $0.10
KM6ogk7SqyRlk3m9b0h+7A: posts big blind $0.25
ymz+a8dgHSUFPooYplw7Ow: posts big blind $0.25
*** HOLE CARDS ***
mfrkWA3PTeYPkbO6hi98Aw: raises $1 to $1.25
ymz+a8dgHSUFPooYplw7Ow: folds 
aOMbOQ6Ji1Gie6dYOurd5A: folds 
EyMmRrAOlNpDOWLqSYRZdw: folds 
sEQx9G5Cu8k1HNdQasxvUA: calls $1.15
KM6ogk7SqyRlk3m9b0h+7A: folds 
*** FLOP *** [8d Qh 2h]
sEQx9G5Cu8k1HNdQasxvUA: checks 
mfrkWA3PTeYPkbO6hi98Aw: bets $2
sEQx9G5Cu8k1HNdQasxvUA: calls $2
*** TURN *** [8d Qh 2h] [Td]
sEQx9G5Cu8k1HNdQasxvUA: checks 
mfrkWA3PTeYPkbO6hi98Aw: checks 
*** RIVER *** [8d Qh 2h Td] [6c]
sEQx9G5Cu8k1HNdQasxvUA: bets $3.25
mfrkWA3PTeYPkbO6hi98Aw: folds 
Uncalled bet ($3.25) returned to sEQx9G5Cu8k1HNdQasxvUA
sEQx9G5Cu8k1HNdQasxvUA collected $6.70 from pot
sEQx9G5Cu8k1HNdQasxvUA: doesn't show hand 
*** SUMMARY ***
Total pot $7 | Rake $0.30 
Board [8d Qh 2h Td 6c]
Seat 1: EyMmRrAOlNpDOWLqSYRZdw (button) folded before Flop (didn't bet)
Seat 2: sEQx9G5Cu8k1HNdQasxvUA (small blind) collected ($6.70)
Seat 3: KM6ogk7SqyRlk3m9b0h+7A (big blind) folded before Flop
Seat 4: mfrkWA3PTeYPkbO6hi98Aw folded on the River
Seat 5: ymz+a8dgHSUFPooYplw7Ow folded before Flop
Seat 6: aOMbOQ6Ji1Gie6dYOurd5A folded before Flop (didn't bet)




PokerStars Game #59939425718:  Hold'em No Limit ($0.10/$0.25) - 2009/07/01 0:39:33 ET
Table 'AchTjdLS1zBUbH3ZIx6f0w' 6-max Seat #6 is the button
Seat 1: IzVI+wIP7IS+d0sugIrOPQ ($25.30 in chips) 
Seat 2: kG34n23qFQA3nzdOJTQ1dA ($40.55 in chips) 
Seat 3: ehifenV36yVvJMnV63D3cg ($6.10 in chips) 
Seat 4: q6WfTUAD9mowIP63ASq2Dg ($26.70 in chips) 
Seat 5: oBUDUfeUyCbZBsjxHZgSiw ($33.75 in chips) 
Seat 6: 5tB0F9NjPSUL4FzmzBMs2Q ($25 in chips) 
IzVI+wIP7IS+d0sugIrOPQ: posts small blind $0.10
kG34n23qFQA3nzdOJTQ1dA: posts big blind $0.25
*** HOLE CARDS ***
ehifenV36yVvJMnV63D3cg: folds 
q6WfTUAD9mowIP63ASq2Dg: folds 
oBUDUfeUyCbZBsjxHZgSiw: folds 
5tB0F9NjPSUL4FzmzBMs2Q: folds 
IzVI+wIP7IS+d0sugIrOPQ: raises $0.75 to $1
kG34n23qFQA3nzdOJTQ1dA: folds 
Uncalled bet ($0.75) returned to IzVI+wIP7IS+d0sugIrOPQ
IzVI+wIP7IS+d0sugIrOPQ collected $0.50 from pot
IzVI+wIP7IS+d0sugIrOPQ: doesn't show hand 
*** SUMMARY ***
Total pot $0.50 | Rake $0 
Seat 1: IzVI+wIP7IS+d0sugIrOPQ (small blind) collected ($0.50)
Seat 2: kG34n23qFQA3nzdOJTQ1dA (big blind) folded before Flop
Seat 3: ehifenV36yVvJMnV63D3cg folded before Flop (didn't bet)
Seat 4: q6WfTUAD9mowIP63ASq2Dg folded before Flop (didn't bet)
Seat 5: oBUDUfeUyCbZBsjxHZgSiw folded before Flop (didn't bet)
Seat 6: 5tB0F9NjPSUL4FzmzBMs2Q (button) folded before Flop (didn't bet)




PokerStars Game #59939425498:  Hold'em No Limit ($0.10/$0.25) - 2009/07/01 0:39:33 ET
Table '3760QYRYyCWeXf0rLZ5S2g' 9-max Seat #9 is the button
Seat 1: COsrwJSFHQtxlUcrYtDQPQ ($25.10 in chips) 
Seat 2: zDrucyjVn5aeekNEc3cJrA ($21.20 in chips) 
Seat 3: aLYacoAY3e5d/M5ToF8Ujw ($20.70 in chips) 
Seat 5: MG90wfSJZnOejs/KD3vlQQ ($27.80 in chips) 
Seat 6: DnDcAdn9P0zGovMERigpFA ($47.05 in chips) 
Seat 8: nl78vdCYaG2sN+td5Z33sA ($7.75 in chips) 
Seat 9: aNpwfA31EREwO+ar4XzBCw ($25 in chips) 
COsrwJSFHQtxlUcrYtDQPQ: posts small blind $0.10
zDrucyjVn5aeekNEc3cJrA: posts big blind $0.25
*** HOLE CARDS ***
aLYacoAY3e5d/M5ToF8Ujw: folds 
MG90wfSJZnOejs/KD3vlQQ: raises $0.50 to $0.75
DnDcAdn9P0zGovMERigpFA: folds 
nl78vdCYaG2sN+td5Z33sA: calls $0.75
aNpwfA31EREwO+ar4XzBCw: folds 
COsrwJSFHQtxlUcrYtDQPQ: folds 
zDrucyjVn5aeekNEc3cJrA: folds 
*** FLOP *** [Qd 4s 8s]
MG90wfSJZnOejs/KD3vlQQ: bets $1.40
nl78vdCYaG2sN+td5Z33sA: folds 
Uncalled bet ($1.40) returned to MG90wfSJZnOejs/KD3vlQQ
MG90wfSJZnOejs/KD3vlQQ collected $1.80 from pot
MG90wfSJZnOejs/KD3vlQQ: doesn't show hand 
*** SUMMARY ***
Total pot $1.85 | Rake $0.05 
Board [Qd 4s 8s]
Seat 1: COsrwJSFHQtxlUcrYtDQPQ (small blind) folded before Flop
Seat 2: zDrucyjVn5aeekNEc3cJrA (big blind) folded before Flop
Seat 3: aLYacoAY3e5d/M5ToF8Ujw folded before Flop (didn't bet)
Seat 5: MG90wfSJZnOejs/KD3vlQQ collected ($1.80)
Seat 6: DnDcAdn9P0zGovMERigpFA folded before Flop (didn't bet)
Seat 8: nl78vdCYaG2sN+td5Z33sA folded on the Flop
Seat 9: aNpwfA31EREwO+ar4XzBCw (button) folded before Flop (didn't bet)




PokerStars Game #59939426442:  Hold'em No Limit ($0.10/$0.25) - 2009/07/01 0:39:34 ET
Table 'G+4ZdyRoPjgaJY/jxSlZzQ' 9-max Seat #5 is the button
Seat 1: 0Ui5PFTLvpoTRdxcc8BNSQ ($34.05 in chips) 
Seat 2: 4awUyiDYTgylQKXZ9faBVA ($36.05 in chips) 
Seat 3: opOCI2p6kW0tINuVaAqmcQ ($28.95 in chips) 
Seat 4: yindad6WXRlkjbK12URYkA ($10 in chips) 
Seat 5: s7Q6uNouhe7aE8JdFb9E+A ($26.25 in chips) 
Seat 6: gehe91e0IyVT0QU/XBkEyg ($25 in chips) 
Seat 9: AzTBzPGlrIHrrs1Q8oKcGA ($18.05 in chips) 
gehe91e0IyVT0QU/XBkEyg: posts small blind $0.10
ie4EwTMMFYxrCXcenJdzsw: is sitting out 
jXz58rvCgq0VjyVjUBf2mw: is sitting out 
AzTBzPGlrIHrrs1Q8oKcGA: posts big blind $0.25
*** HOLE CARDS ***
0Ui5PFTLvpoTRdxcc8BNSQ: folds 
4awUyiDYTgylQKXZ9faBVA: folds 
jXz58rvCgq0VjyVjUBf2mw leaves the table
opOCI2p6kW0tINuVaAqmcQ: folds 
yindad6WXRlkjbK12URYkA: raises $0.50 to $0.75
s7Q6uNouhe7aE8JdFb9E+A: folds 
gehe91e0IyVT0QU/XBkEyg: folds 
AzTBzPGlrIHrrs1Q8oKcGA: calls $0.50
*** FLOP *** [9h 8c 8d]
AzTBzPGlrIHrrs1Q8oKcGA: checks 
yindad6WXRlkjbK12URYkA: bets $1
AzTBzPGlrIHrrs1Q8oKcGA: folds 
Uncalled bet ($1) returned to yindad6WXRlkjbK12URYkA
yindad6WXRlkjbK12URYkA collected $1.55 from pot
*** SUMMARY ***
Total pot $1.60 | Rake $0.05 
Board [9h 8c 8d]
Seat 1: 0Ui5PFTLvpoTRdxcc8BNSQ folded before Flop (didn't bet)
Seat 2: 4awUyiDYTgylQKXZ9faBVA folded before Flop (didn't bet)
Seat 3: opOCI2p6kW0tINuVaAqmcQ folded before Flop (didn't bet)
Seat 4: yindad6WXRlkjbK12URYkA collected ($1.55)
Seat 5: s7Q6uNouhe7aE8JdFb9E+A (button) folded before Flop (didn't bet)
Seat 6: gehe91e0IyVT0QU/XBkEyg (small blind) folded before Flop
Seat 9: AzTBzPGlrIHrrs1Q8oKcGA (big blind) folded on the Flop




PokerStars Game #59939426408:  Hold'em No Limit ($0.10/$0.25) - 2009/07/01 0:39:34 ET
Table 'g+mPuNJBCHKE9ents7ZGtg' 6-max Seat #4 is the button
Seat 1: rlqzz6sTpiZGIiNuqy7QUA ($36.55 in chips) 
Seat 2: fZQg9veL7Dd/Z04ZTjC+wQ ($30.35 in chips) 
Seat 3: 9jSiy0meE9XJKkdIZwyTEQ ($25.25 in chips) 
Seat 4: mfrkWA3PTeYPkbO6hi98Aw ($27 in chips) 
Seat 6: MS2T205Bjud7PnNoANu4vQ ($48.85 in chips) 
MS2T205Bjud7PnNoANu4vQ: posts small blind $0.10
rlqzz6sTpiZGIiNuqy7QUA: posts big blind $0.25
*** HOLE CARDS ***
fZQg9veL7Dd/Z04ZTjC+wQ: folds 
9jSiy0meE9XJKkdIZwyTEQ: folds 
mfrkWA3PTeYPkbO6hi98Aw: folds 
MS2T205Bjud7PnNoANu4vQ: raises $0.50 to $0.75
rlqzz6sTpiZGIiNuqy7QUA: calls $0.50
*** FLOP *** [6d Qc Tc]
32YL2ZEp8NT4JB2RVM9euQ joins the table at seat #5 
MS2T205Bjud7PnNoANu4vQ: bets $1.25
rlqzz6sTpiZGIiNuqy7QUA: calls $1.25
*** TURN *** [6d Qc Tc] [5s]
MS2T205Bjud7PnNoANu4vQ: checks 
rlqzz6sTpiZGIiNuqy7QUA: bets $1
MS2T205Bjud7PnNoANu4vQ: calls $1
*** RIVER *** [6d Qc Tc 5s] [4c]
MS2T205Bjud7PnNoANu4vQ: checks 
rlqzz6sTpiZGIiNuqy7QUA: checks 
*** SHOW DOWN ***
MS2T205Bjud7PnNoANu4vQ: shows [5h 8h] (a pair of Fives)
rlqzz6sTpiZGIiNuqy7QUA: shows [9d Qd] (a pair of Queens)
rlqzz6sTpiZGIiNuqy7QUA collected $5.75 from pot
*** SUMMARY ***
Total pot $6 | Rake $0.25 
Board [6d Qc Tc 5s 4c]
Seat 1: rlqzz6sTpiZGIiNuqy7QUA (big blind) showed [9d Qd] and won ($5.75) with a pair of Queens
Seat 2: fZQg9veL7Dd/Z04ZTjC+wQ folded before Flop (didn't bet)
Seat 3: 9jSiy0meE9XJKkdIZwyTEQ folded before Flop (didn't bet)
Seat 4: mfrkWA3PTeYPkbO6hi98Aw (button) folded before Flop (didn't bet)
Seat 6: MS2T205Bjud7PnNoANu4vQ (small blind) showed [5h 8h] and lost with a pair of Fives




PokerStars Game #59939426418:  Hold'em No Limit ($0.10/$0.25) - 2009/07/01 0:39:34 ET
Table 'vFZR6Kf2Th5xBXT9brGW6A' 6-max Seat #6 is the button
Seat 1: xRkU4+naLuz7dEZFbOn9cw ($35.05 in chips) 
Seat 2: REnO5xiZ66YabxDXq2ncvA ($51.70 in chips) 
Seat 4: 79ID/ub1Pt/mDpCprVmOoA ($25.70 in chips) 
Seat 5: NhUN/JpAprdJeamFBgJH1w ($25.35 in chips) 
Seat 6: d0J1xuhsynEY81YHwAvJ5g ($25 in chips) 
xRkU4+naLuz7dEZFbOn9cw: posts small blind $0.10
REnO5xiZ66YabxDXq2ncvA: posts big blind $0.25
*** HOLE CARDS ***
79ID/ub1Pt/mDpCprVmOoA: raises $0.50 to $0.75
NhUN/JpAprdJeamFBgJH1w: folds 
d0J1xuhsynEY81YHwAvJ5g: calls $0.75
xRkU4+naLuz7dEZFbOn9cw: folds 
REnO5xiZ66YabxDXq2ncvA: folds 
*** FLOP *** [4s 2h 9s]
79ID/ub1Pt/mDpCprVmOoA: bets $1.50
d0J1xuhsynEY81YHwAvJ5g: calls $1.50
*** TURN *** [4s 2h 9s] [9c]
79ID/ub1Pt/mDpCprVmOoA: bets $3
d0J1xuhsynEY81YHwAvJ5g: calls $3
*** RIVER *** [4s 2h 9s 9c] [2c]
79ID/ub1Pt/mDpCprVmOoA: checks 
d0J1xuhsynEY81YHwAvJ5g: checks 
*** SHOW DOWN ***
79ID/ub1Pt/mDpCprVmOoA: shows [3s As] (two pair, Nines and Deuces)
d0J1xuhsynEY81YHwAvJ5g: shows [6h 6d] (two pair, Nines and Sixes)
d0J1xuhsynEY81YHwAvJ5g collected $10.35 from pot
*** SUMMARY ***
Total pot $10.85 | Rake $0.50 
Board [4s 2h 9s 9c 2c]
Seat 1: xRkU4+naLuz7dEZFbOn9cw (small blind) folded before Flop
Seat 2: REnO5xiZ66YabxDXq2ncvA (big blind) folded before Flop
Seat 4: 79ID/ub1Pt/mDpCprVmOoA showed [3s As] and lost with two pair, Nines and Deuces
Seat 5: NhUN/JpAprdJeamFBgJH1w folded before Flop (didn't bet)
Seat 6: d0J1xuhsynEY81YHwAvJ5g (button) showed [6h 6d] and won ($10.35) with two pair, Nines and Sixes




PokerStars Game #59939425910:  Hold'em No Limit ($0.10/$0.25) - 2009/07/01 0:39:34 ET
Table 'VuY5ej47Cy8nOI3Wogmhzw' 6-max Seat #6 is the button
Seat 3: 0n9nsjvz4GIG4IyVHT0JVw ($5.35 in chips) 
Seat 4: FC6tJ9EOiutXO8hnpR4VgQ ($4.30 in chips) 
Seat 6: +v0nBUereMsRzYp2Knh/cQ ($10.20 in chips) 
0n9nsjvz4GIG4IyVHT0JVw: posts small blind $0.10
FC6tJ9EOiutXO8hnpR4VgQ: posts big blind $0.25
*** HOLE CARDS ***
+v0nBUereMsRzYp2Knh/cQ: folds 
0n9nsjvz4GIG4IyVHT0JVw: folds 
Uncalled bet ($0.15) returned to FC6tJ9EOiutXO8hnpR4VgQ
FC6tJ9EOiutXO8hnpR4VgQ collected $0.20 from pot
*** SUMMARY ***
Total pot $0.20 | Rake $0 
Seat 3: 0n9nsjvz4GIG4IyVHT0JVw (small blind) folded before Flop
Seat 4: FC6tJ9EOiutXO8hnpR4VgQ (big blind) collected ($0.20)
Seat 6: +v0nBUereMsRzYp2Knh/cQ (button) folded before Flop (didn't bet)




PokerStars Game #59939426274:  Hold'em No Limit ($0.10/$0.25) - 2009/07/01 0:39:34 ET
Table 'gHbubGDeVSkmB4vFiqIN3Q' 6-max Seat #4 is the button
Seat 1: kG34n23qFQA3nzdOJTQ1dA ($26.50 in chips) 
Seat 2: 8LzEWRhg4wk8Jh9CqDhH3Q ($3.75 in chips) 
Seat 4: v+QfkGiuj9bgtuNoVnDO8w ($32.50 in chips) 
Seat 6: wvIIdlbCgePONQwXjx9xzQ ($4.75 in chips) 
wvIIdlbCgePONQwXjx9xzQ: posts small blind $0.10
kG34n23qFQA3nzdOJTQ1dA: posts big blind $0.25
*** HOLE CARDS ***
8LzEWRhg4wk8Jh9CqDhH3Q: folds 
v+QfkGiuj9bgtuNoVnDO8w: folds 
wvIIdlbCgePONQwXjx9xzQ: calls $0.15
kG34n23qFQA3nzdOJTQ1dA: checks 
*** FLOP *** [Ad 7d 5d]
wvIIdlbCgePONQwXjx9xzQ: checks 
kG34n23qFQA3nzdOJTQ1dA: checks 
*** TURN *** [Ad 7d 5d] [Jd]
wvIIdlbCgePONQwXjx9xzQ: checks 
kG34n23qFQA3nzdOJTQ1dA: checks 
*** RIVER *** [Ad 7d 5d Jd] [6h]
wvIIdlbCgePONQwXjx9xzQ: bets $0.25
kG34n23qFQA3nzdOJTQ1dA: folds 
Uncalled bet ($0.25) returned to wvIIdlbCgePONQwXjx9xzQ
kG34n23qFQA3nzdOJTQ1dA is sitting out
kG34n23qFQA3nzdOJTQ1dA leaves the table
wvIIdlbCgePONQwXjx9xzQ collected $0.50 from pot
wvIIdlbCgePONQwXjx9xzQ: doesn't show hand 
*** SUMMARY ***
Total pot $0.50 | Rake $0 
Board [Ad 7d 5d Jd 6h]
Seat 1: kG34n23qFQA3nzdOJTQ1dA (big blind) folded on the River
Seat 2: 8LzEWRhg4wk8Jh9CqDhH3Q folded before Flop (didn't bet)
Seat 4: v+QfkGiuj9bgtuNoVnDO8w (button) folded before Flop (didn't bet)
Seat 6: wvIIdlbCgePONQwXjx9xzQ (small blind) collected ($0.50)




PokerStars Game #59939426432:  Hold'em No Limit ($0.10/$0.25) - 2009/07/01 0:39:34 ET
Table 'n8mNkPYbe1AIQEkioNesZA' 9-max Seat #4 is the button
Seat 1: /VQLorsEOrMfI+KamzNQEA ($2.40 in chips) 
Seat 2: QEbIGci+itdw+re8RM5fZA ($35 in chips) 
Seat 3: zDrucyjVn5aeekNEc3cJrA ($19.70 in chips) 
Seat 4: ZeR3hkj1gVv9J4yPCmRrjA ($27.85 in chips) 
Seat 5: j5kXXioAn7mKbcDKt4UzMw ($14 in chips) 
Seat 6: HPEB+AtKw1+C/cxU0o1ciw ($38.55 in chips) 
Seat 7: BrlfhE2AlcawLAz+eF5BDg ($5.10 in chips) 
Seat 8: N6fYvIzQLKaydFLKQGtMlQ ($27.40 in chips) 
Seat 9: gehe91e0IyVT0QU/XBkEyg ($31.25 in chips) 
j5kXXioAn7mKbcDKt4UzMw: posts small blind $0.10
HPEB+AtKw1+C/cxU0o1ciw: posts big blind $0.25
*** HOLE CARDS ***
BrlfhE2AlcawLAz+eF5BDg: calls $0.25
N6fYvIzQLKaydFLKQGtMlQ: folds 
gehe91e0IyVT0QU/XBkEyg: calls $0.25
/VQLorsEOrMfI+KamzNQEA: folds 
QEbIGci+itdw+re8RM5fZA: folds 
zDrucyjVn5aeekNEc3cJrA: folds 
ZeR3hkj1gVv9J4yPCmRrjA: folds 
j5kXXioAn7mKbcDKt4UzMw: folds 
HPEB+AtKw1+C/cxU0o1ciw: raises $1 to $1.25
BrlfhE2AlcawLAz+eF5BDg: folds 
gehe91e0IyVT0QU/XBkEyg: calls $1
*** FLOP *** [6c 6d 8s]
HPEB+AtKw1+C/cxU0o1ciw: bets $1.50
gehe91e0IyVT0QU/XBkEyg: calls $1.50
*** TURN *** [6c 6d 8s] [Ad]
HPEB+AtKw1+C/cxU0o1ciw: checks 
gehe91e0IyVT0QU/XBkEyg: checks 
*** RIVER *** [6c 6d 8s Ad] [5s]
HPEB+AtKw1+C/cxU0o1ciw: bets $6
gehe91e0IyVT0QU/XBkEyg: folds 
Uncalled bet ($6) returned to HPEB+AtKw1+C/cxU0o1ciw
HPEB+AtKw1+C/cxU0o1ciw collected $5.60 from pot
HPEB+AtKw1+C/cxU0o1ciw: doesn't show hand 
*** SUMMARY ***
Total pot $5.85 | Rake $0.25 
Board [6c 6d 8s Ad 5s]
Seat 1: /VQLorsEOrMfI+KamzNQEA folded before Flop (didn't bet)
Seat 2: QEbIGci+itdw+re8RM5fZA folded before Flop (didn't bet)
Seat 3: zDrucyjVn5aeekNEc3cJrA folded before Flop (didn't bet)
Seat 4: ZeR3hkj1gVv9J4yPCmRrjA (button) folded before Flop (didn't bet)
Seat 5: j5kXXioAn7mKbcDKt4UzMw (small blind) folded before Flop
Seat 6: HPEB+AtKw1+C/cxU0o1ciw (big blind) collected ($5.60)
Seat 7: BrlfhE2AlcawLAz+eF5BDg folded before Flop
Seat 8: N6fYvIzQLKaydFLKQGtMlQ folded before Flop (didn't bet)
Seat 9: gehe91e0IyVT0QU/XBkEyg folded on the River




PokerStars Game #59939426458:  Hold'em No Limit ($0.10/$0.25) - 2009/07/01 0:39:34 ET
Table 'RPdw09/gGCIP4xFhDWJgXQ' 9-max Seat #1 is the button
Seat 1: aNpwfA31EREwO+ar4XzBCw ($25 in chips) 
Seat 2: Sd1tfhUq/M96GhXGv1hwFQ ($10.75 in chips) 
Seat 3: Qi+clOtyDiibLdH2/1Qy8g ($26.35 in chips) 
Seat 4: z5GxcHlYz/GSz6W2uFiTtg ($22.10 in chips) 
Seat 5: z0kymJfmEW9d8WGcY1n6OA ($2.50 in chips) 
Seat 6: monZeAwXUmIA1l84cUd2hw ($19.05 in chips) 
Seat 7: hIss79a4pu7GzJZepfgOpg ($25 in chips) 
Seat 8: MG90wfSJZnOejs/KD3vlQQ ($25 in chips) 
Seat 9: Yv4fucyyT28mjx8V5lxKJg ($48.20 in chips) 
Sd1tfhUq/M96GhXGv1hwFQ: posts small blind $0.10
Qi+clOtyDiibLdH2/1Qy8g: posts big blind $0.25
*** HOLE CARDS ***
z5GxcHlYz/GSz6W2uFiTtg: folds 
z0kymJfmEW9d8WGcY1n6OA: folds 
monZeAwXUmIA1l84cUd2hw: folds 
hIss79a4pu7GzJZepfgOpg: folds 
MG90wfSJZnOejs/KD3vlQQ: folds 
Yv4fucyyT28mjx8V5lxKJg: folds 
aNpwfA31EREwO+ar4XzBCw: folds 
Sd1tfhUq/M96GhXGv1hwFQ: raises $0.25 to $0.50
Qi+clOtyDiibLdH2/1Qy8g: folds 
Uncalled bet ($0.25) returned to Sd1tfhUq/M96GhXGv1hwFQ
Sd1tfhUq/M96GhXGv1hwFQ collected $0.50 from pot
*** SUMMARY ***
Total pot $0.50 | Rake $0 
Seat 1: aNpwfA31EREwO+ar4XzBCw (button) folded before Flop (didn't bet)
Seat 2: Sd1tfhUq/M96GhXGv1hwFQ (small blind) collected ($0.50)
Seat 3: Qi+clOtyDiibLdH2/1Qy8g (big blind) folded before Flop
Seat 4: z5GxcHlYz/GSz6W2uFiTtg folded before Flop (didn't bet)
Seat 5: z0kymJfmEW9d8WGcY1n6OA folded before Flop (didn't bet)
Seat 6: monZeAwXUmIA1l84cUd2hw folded before Flop (didn't bet)
Seat 7: hIss79a4pu7GzJZepfgOpg folded before Flop (didn't bet)
Seat 8: MG90wfSJZnOejs/KD3vlQQ folded before Flop (didn't bet)
Seat 9: Yv4fucyyT28mjx8V5lxKJg folded before Flop (didn't bet)




PokerStars Game #59939426780:  Hold'em No Limit ($0.10/$0.25) - 2009/07/01 0:39:35 ET
Table 'ouLhepGYovxB2x0QxH7cVg' 9-max Seat #8 is the button
Seat 1: ghNKXUBl/H+t83JF079ZBA ($30.70 in chips) 
Seat 2: r1Z5m4PwSI5ANp7qCE1OJw ($14.35 in chips) 
Seat 3: SkLOm0UugROBRt2EfMpOxQ ($24.25 in chips) 
Seat 4: a0Sx6GHY7ln2Ns2C97eXeA ($26.90 in chips) 
Seat 5: 18G4P1XstjNvItdGUITxgw ($25 in chips) 
Seat 6: r6hsffOo1iKmaPYKwAZmFw ($25.30 in chips) 
Seat 7: oHv2mIZJh3H0JR+WOZteZA ($20.15 in chips) 
Seat 8: opOCI2p6kW0tINuVaAqmcQ ($25 in chips) 
Seat 9: fIgGw0jPUR7labvJPaPbeg ($14.30 in chips) 
fIgGw0jPUR7labvJPaPbeg: posts small blind $0.10
ghNKXUBl/H+t83JF079ZBA: posts big blind $0.25
*** HOLE CARDS ***
r1Z5m4PwSI5ANp7qCE1OJw: folds 
SkLOm0UugROBRt2EfMpOxQ: folds 
a0Sx6GHY7ln2Ns2C97eXeA: folds 
18G4P1XstjNvItdGUITxgw: folds 
r6hsffOo1iKmaPYKwAZmFw: folds 
oHv2mIZJh3H0JR+WOZteZA: calls $0.25
opOCI2p6kW0tINuVaAqmcQ: folds 
fIgGw0jPUR7labvJPaPbeg: calls $0.15
ghNKXUBl/H+t83JF079ZBA: checks 
*** FLOP *** [6h 8c Td]
fIgGw0jPUR7labvJPaPbeg: checks 
ghNKXUBl/H+t83JF079ZBA: checks 
oHv2mIZJh3H0JR+WOZteZA: bets $0.50
fIgGw0jPUR7labvJPaPbeg: folds 
ghNKXUBl/H+t83JF079ZBA: folds 
Uncalled bet ($0.50) returned to oHv2mIZJh3H0JR+WOZteZA
oHv2mIZJh3H0JR+WOZteZA collected $0.75 from pot
oHv2mIZJh3H0JR+WOZteZA: doesn't show hand 
*** SUMMARY ***
Total pot $0.75 | Rake $0 
Board [6h 8c Td]
Seat 1: ghNKXUBl/H+t83JF079ZBA (big blind) folded on the Flop
Seat 2: r1Z5m4PwSI5ANp7qCE1OJw folded before Flop (didn't bet)
Seat 3: SkLOm0UugROBRt2EfMpOxQ folded before Flop (didn't bet)
Seat 4: a0Sx6GHY7ln2Ns2C97eXeA folded before Flop (didn't bet)
Seat 5: 18G4P1XstjNvItdGUITxgw folded before Flop (didn't bet)
Seat 6: r6hsffOo1iKmaPYKwAZmFw folded before Flop (didn't bet)
Seat 7: oHv2mIZJh3H0JR+WOZteZA collected ($0.75)
Seat 8: opOCI2p6kW0tINuVaAqmcQ (button) folded before Flop (didn't bet)
Seat 9: fIgGw0jPUR7labvJPaPbeg (small blind) folded on the Flop




PokerStars Game #59939426912:  Hold'em No Limit ($0.10/$0.25) - 2009/07/01 0:39:35 ET
Table '8qKBgCRnebT9/IvA6SmaPw' 9-max Seat #1 is the button
Seat 1: GTcLfsDTPqgfHyhY9FNDMw ($10.85 in chips) 
Seat 2: SXqVW4Q0evTUVZG6BbUNIA ($76.65 in chips) 
Seat 4: rXm4QDVJt67H20lM6n6Z7Q ($7 in chips) 
Seat 5: uJlzv9KL7hgCIqIS2ofoaw ($13.65 in chips) 
Seat 6: z5GxcHlYz/GSz6W2uFiTtg ($23.80 in chips) 
Seat 7: UbybWqarUDNRYlbnju2UUQ ($19.50 in chips) 
Seat 8: M2aiKD/Q1d8lySUIbBxeGg ($36.40 in chips) 
Seat 9: MOlR9YEgKTKLerVIDf8U7w ($48.75 in chips) 
SXqVW4Q0evTUVZG6BbUNIA: posts small blind $0.10
rXm4QDVJt67H20lM6n6Z7Q: posts big blind $0.25
*** HOLE CARDS ***
6P8bD/60Ol/baOjOb199qA leaves the table
uJlzv9KL7hgCIqIS2ofoaw: folds 
z5GxcHlYz/GSz6W2uFiTtg: folds 
UbybWqarUDNRYlbnju2UUQ: folds 
M2aiKD/Q1d8lySUIbBxeGg: folds 
MOlR9YEgKTKLerVIDf8U7w: folds 
xiximaris joins the table at seat #3 
GTcLfsDTPqgfHyhY9FNDMw: raises $0.50 to $0.75
SXqVW4Q0evTUVZG6BbUNIA: folds 
rXm4QDVJt67H20lM6n6Z7Q: folds 
Uncalled bet ($0.50) returned to GTcLfsDTPqgfHyhY9FNDMw
GTcLfsDTPqgfHyhY9FNDMw collected $0.60 from pot
GTcLfsDTPqgfHyhY9FNDMw: doesn't show hand 
*** SUMMARY ***
Total pot $0.60 | Rake $0 
Seat 1: GTcLfsDTPqgfHyhY9FNDMw (button) collected ($0.60)
Seat 2: SXqVW4Q0evTUVZG6BbUNIA (small blind) folded before Flop
Seat 4: rXm4QDVJt67H20lM6n6Z7Q (big blind) folded before Flop
Seat 5: uJlzv9KL7hgCIqIS2ofoaw folded before Flop (didn't bet)
Seat 6: z5GxcHlYz/GSz6W2uFiTtg folded before Flop (didn't bet)
Seat 7: UbybWqarUDNRYlbnju2UUQ folded before Flop (didn't bet)
Seat 8: M2aiKD/Q1d8lySUIbBxeGg folded before Flop (didn't bet)
Seat 9: MOlR9YEgKTKLerVIDf8U7w folded before Flop (didn't bet)




PokerStars Game #59939426684:  Hold'em No Limit ($0.10/$0.25) - 2009/07/01 0:39:35 ET
Table 'KEoOIegxPF91KooL2AelUA' 6-max Seat #5 is the button
Seat 1: wsP46AGpqDjHZQmlRHKa9g ($29.40 in chips) 
Seat 4: Vv37Oa9niKKVcR6Z7ceetw ($22.45 in chips) 
Seat 5: 2NLC44AHHKHEUooUQFYV+Q ($13 in chips) 
wsP46AGpqDjHZQmlRHKa9g: posts small blind $0.10
Vv37Oa9niKKVcR6Z7ceetw: posts big blind $0.25
*** HOLE CARDS ***
2NLC44AHHKHEUooUQFYV+Q: raises $1 to $1.25
wsP46AGpqDjHZQmlRHKa9g: folds 
Vv37Oa9niKKVcR6Z7ceetw: folds 
Uncalled bet ($1) returned to 2NLC44AHHKHEUooUQFYV+Q
2NLC44AHHKHEUooUQFYV+Q collected $0.60 from pot
2NLC44AHHKHEUooUQFYV+Q: doesn't show hand 
*** SUMMARY ***
Total pot $0.60 | Rake $0 
Seat 1: wsP46AGpqDjHZQmlRHKa9g (small blind) folded before Flop
Seat 4: Vv37Oa9niKKVcR6Z7ceetw (big blind) folded before Flop
Seat 5: 2NLC44AHHKHEUooUQFYV+Q (button) collected ($0.60)




PokerStars Game #59939427048:  Hold'em No Limit ($0.10/$0.25) - 2009/07/01 0:39:35 ET
Table 'zW+7jPbOLCvlPu+dUGY5WQ' 6-max Seat #1 is the button
Seat 1: JE/wJXmjw3bpdmjwvh2pcg ($24.65 in chips) 
Seat 3: BedjMfrlRfPgSq7CXpPAmg ($63.85 in chips) 
Seat 4: Qv4VzEkN09uD11sjKv02Ig ($37.20 in chips) 
Seat 5: SFmT9ZsVopnukjvAzrxTRg ($51.70 in chips) 
Seat 6: BiLBinPhgpKAYzLgKJVU5A ($21.60 in chips) 
BedjMfrlRfPgSq7CXpPAmg: posts small blind $0.10
Qv4VzEkN09uD11sjKv02Ig: posts big blind $0.25
*** HOLE CARDS ***
SFmT9ZsVopnukjvAzrxTRg: raises $0.75 to $1
BiLBinPhgpKAYzLgKJVU5A: folds 
JE/wJXmjw3bpdmjwvh2pcg: calls $1
DXgVFTcE3WofABsNJ5G/nw joins the table at seat #2 
BedjMfrlRfPgSq7CXpPAmg: folds 
Qv4VzEkN09uD11sjKv02Ig: calls $0.75
*** FLOP *** [8h 5c Jc]
Qv4VzEkN09uD11sjKv02Ig: checks 
SFmT9ZsVopnukjvAzrxTRg: bets $2
JE/wJXmjw3bpdmjwvh2pcg: calls $2
Qv4VzEkN09uD11sjKv02Ig: folds 
*** TURN *** [8h 5c Jc] [3c]
SFmT9ZsVopnukjvAzrxTRg: bets $5
JE/wJXmjw3bpdmjwvh2pcg: folds 
Uncalled bet ($5) returned to SFmT9ZsVopnukjvAzrxTRg
SFmT9ZsVopnukjvAzrxTRg collected $6.80 from pot
SFmT9ZsVopnukjvAzrxTRg: doesn't show hand 
*** SUMMARY ***
Total pot $7.10 | Rake $0.30 
Board [8h 5c Jc 3c]
Seat 1: JE/wJXmjw3bpdmjwvh2pcg (button) folded on the Turn
Seat 3: BedjMfrlRfPgSq7CXpPAmg (small blind) folded before Flop
Seat 4: Qv4VzEkN09uD11sjKv02Ig (big blind) folded on the Flop
Seat 5: SFmT9ZsVopnukjvAzrxTRg collected ($6.80)
Seat 6: BiLBinPhgpKAYzLgKJVU5A folded before Flop (didn't bet)




PokerStars Game #59939427310:  Hold'em No Limit ($0.10/$0.25) - 2009/07/01 0:39:36 ET
Table 'tq5CvS0RUqGkuBK0XTzqqg' 6-max Seat #6 is the button
Seat 1: 39EF5EcifdyPS7v+EnfxLg ($26.40 in chips) 
Seat 2: mfrkWA3PTeYPkbO6hi98Aw ($64.80 in chips) 
Seat 4: W7FS+h5B+OhmwF+cTt3ZPQ ($14.70 in chips) 
Seat 5: qGHGf/553gQnDoklMRe3tg ($20.15 in chips) 
Seat 6: hOfhw8jxWiq14wXGL4Bh/Q ($14.65 in chips) 
39EF5EcifdyPS7v+EnfxLg: posts small blind $0.10
mfrkWA3PTeYPkbO6hi98Aw: posts big blind $0.25
PbMzPZIePKifKQZfKDkbIw: sits out 
*** HOLE CARDS ***
W7FS+h5B+OhmwF+cTt3ZPQ: calls $0.25
qGHGf/553gQnDoklMRe3tg: calls $0.25
hOfhw8jxWiq14wXGL4Bh/Q: folds 
39EF5EcifdyPS7v+EnfxLg: calls $0.15
mfrkWA3PTeYPkbO6hi98Aw: checks 
*** FLOP *** [3h Jc Td]
39EF5EcifdyPS7v+EnfxLg: checks 
mfrkWA3PTeYPkbO6hi98Aw: bets $0.75
W7FS+h5B+OhmwF+cTt3ZPQ: folds 
qGHGf/553gQnDoklMRe3tg: folds 
39EF5EcifdyPS7v+EnfxLg: raises $0.75 to $1.50
mfrkWA3PTeYPkbO6hi98Aw: calls $0.75
*** TURN *** [3h Jc Td] [3s]
39EF5EcifdyPS7v+EnfxLg: checks 
mfrkWA3PTeYPkbO6hi98Aw: checks 
*** RIVER *** [3h Jc Td 3s] [4h]
39EF5EcifdyPS7v+EnfxLg: bets $2
mfrkWA3PTeYPkbO6hi98Aw: calls $2
*** SHOW DOWN ***
39EF5EcifdyPS7v+EnfxLg: shows [Ks Jh] (two pair, Jacks and Threes)
mfrkWA3PTeYPkbO6hi98Aw: shows [Ac Js] (two pair, Jacks and Threes - Ace kicker)
mfrkWA3PTeYPkbO6hi98Aw collected $7.65 from pot
*** SUMMARY ***
Total pot $8 | Rake $0.35 
Board [3h Jc Td 3s 4h]
Seat 1: 39EF5EcifdyPS7v+EnfxLg (small blind) showed [Ks Jh] and lost with two pair, Jacks and Threes
Seat 2: mfrkWA3PTeYPkbO6hi98Aw (big blind) showed [Ac Js] and won ($7.65) with two pair, Jacks and Threes
Seat 4: W7FS+h5B+OhmwF+cTt3ZPQ folded on the Flop
Seat 5: qGHGf/553gQnDoklMRe3tg folded on the Flop
Seat 6: hOfhw8jxWiq14wXGL4Bh/Q (button) folded before Flop (didn't bet)




PokerStars Game #59939427862:  Hold'em No Limit ($0.10/$0.25) - 2009/07/01 0:39:36 ET
Table 'fIrOIN3HoXM27ZpRwKa6oA' 6-max Seat #4 is the button
Seat 1: I1TxPvWj8NfG8orglCinNA ($38.85 in chips) 
Seat 2: 5tB0F9NjPSUL4FzmzBMs2Q ($35.80 in chips) 
Seat 3: OElpcjPk5wP6xlAUngsAmg ($3.90 in chips) 
Seat 4: PEUgcMc+CzvN+vLwu5DsLQ ($3.30 in chips) 
Seat 5: 8ClCHtFXGNplITm+63KB+Q ($26.90 in chips) 
Seat 6: v+QfkGiuj9bgtuNoVnDO8w ($30.05 in chips) 
8ClCHtFXGNplITm+63KB+Q: posts small blind $0.10
v+QfkGiuj9bgtuNoVnDO8w: posts big blind $0.25
*** HOLE CARDS ***
I1TxPvWj8NfG8orglCinNA: folds 
5tB0F9NjPSUL4FzmzBMs2Q: folds 
OElpcjPk5wP6xlAUngsAmg: raises $0.25 to $0.50
PEUgcMc+CzvN+vLwu5DsLQ: calls $0.50
8ClCHtFXGNplITm+63KB+Q: folds 
v+QfkGiuj9bgtuNoVnDO8w: folds 
*** FLOP *** [Ac Js 2c]
OElpcjPk5wP6xlAUngsAmg: bets $1
PEUgcMc+CzvN+vLwu5DsLQ: folds 
Uncalled bet ($1) returned to OElpcjPk5wP6xlAUngsAmg
OElpcjPk5wP6xlAUngsAmg collected $1.30 from pot
OElpcjPk5wP6xlAUngsAmg: doesn't show hand 
*** SUMMARY ***
Total pot $1.35 | Rake $0.05 
Board [Ac Js 2c]
Seat 1: I1TxPvWj8NfG8orglCinNA folded before Flop (didn't bet)
Seat 2: 5tB0F9NjPSUL4FzmzBMs2Q folded before Flop (didn't bet)
Seat 3: OElpcjPk5wP6xlAUngsAmg collected ($1.30)
Seat 4: PEUgcMc+CzvN+vLwu5DsLQ (button) folded on the Flop
Seat 5: 8ClCHtFXGNplITm+63KB+Q (small blind) folded before Flop
Seat 6: v+QfkGiuj9bgtuNoVnDO8w (big blind) folded before Flop




PokerStars Game #59939427860:  Hold'em No Limit ($0.10/$0.25) - 2009/07/01 0:39:36 ET
Table 'zhqgUUprOJ14VxKxPHcT/Q' 9-max Seat #9 is the button
Seat 3: G2offPrpnppc++nuXqs2JA ($17 in chips) 
Seat 4: EfeOSXE8Wc4WWEsgc3WzZg ($8.55 in chips) 
Seat 5: +sbyWwIcFp9kP0bDtMegfQ ($26.75 in chips) 
Seat 6: DIBbjEYGs+TVdVgEB/4+3w ($23.10 in chips) 
Seat 8: amD2PwT1xB7aC2k57sa7Ig ($29.20 in chips) 
Seat 9: 4awUyiDYTgylQKXZ9faBVA ($35.75 in chips) 
G2offPrpnppc++nuXqs2JA: posts small blind $0.10
EfeOSXE8Wc4WWEsgc3WzZg: posts big blind $0.25
aPRz/2GxbXANYpVsQO8pdQ: sits out 
*** HOLE CARDS ***
+sbyWwIcFp9kP0bDtMegfQ: folds 
DIBbjEYGs+TVdVgEB/4+3w: folds 
amD2PwT1xB7aC2k57sa7Ig: folds 
4awUyiDYTgylQKXZ9faBVA: raises $0.75 to $1
G2offPrpnppc++nuXqs2JA: folds 
aPRz/2GxbXANYpVsQO8pdQ leaves the table
EfeOSXE8Wc4WWEsgc3WzZg: folds 
Uncalled bet ($0.75) returned to 4awUyiDYTgylQKXZ9faBVA
4awUyiDYTgylQKXZ9faBVA collected $0.60 from pot
4awUyiDYTgylQKXZ9faBVA: doesn't show hand 
*** SUMMARY ***
Total pot $0.60 | Rake $0 
Seat 3: G2offPrpnppc++nuXqs2JA (small blind) folded before Flop
Seat 4: EfeOSXE8Wc4WWEsgc3WzZg (big blind) folded before Flop
Seat 5: +sbyWwIcFp9kP0bDtMegfQ folded before Flop (didn't bet)
Seat 6: DIBbjEYGs+TVdVgEB/4+3w folded before Flop (didn't bet)
Seat 8: amD2PwT1xB7aC2k57sa7Ig folded before Flop (didn't bet)
Seat 9: 4awUyiDYTgylQKXZ9faBVA (button) collected ($0.60)




PokerStars Game #59939427524:  Hold'em No Limit ($0.10/$0.25) - 2009/07/01 0:39:36 ET
Table 'ORSZkZqq+7Ja2PdeCFAytA' 9-max Seat #8 is the button
Seat 1: Gpa8cld5y0mdOomHJgHhlA ($11 in chips) 
Seat 2: yduPKWPzL8YlT5Zv/Nmrwg ($10 in chips) 
Seat 3: nm4Dj/f+jJEwKVsUnKh73g ($24.75 in chips) 
Seat 4: b8t3jWrxzeEt9HtZtc9wUQ ($26.45 in chips) 
Seat 5: tYsOBqdU1+x+yFI7zHO7hQ ($31.30 in chips) 
Seat 8: opOCI2p6kW0tINuVaAqmcQ ($39.10 in chips) 
Gpa8cld5y0mdOomHJgHhlA: posts small blind $0.10
yduPKWPzL8YlT5Zv/Nmrwg: posts big blind $0.25
*** HOLE CARDS ***
nm4Dj/f+jJEwKVsUnKh73g: folds 
b8t3jWrxzeEt9HtZtc9wUQ: folds 
tYsOBqdU1+x+yFI7zHO7hQ: folds 
opOCI2p6kW0tINuVaAqmcQ: raises $0.50 to $0.75
Gpa8cld5y0mdOomHJgHhlA: calls $0.65
yduPKWPzL8YlT5Zv/Nmrwg: folds 
*** FLOP *** [4d Ah Jd]
Gpa8cld5y0mdOomHJgHhlA: checks 
opOCI2p6kW0tINuVaAqmcQ: checks 
*** TURN *** [4d Ah Jd] [9c]
Gpa8cld5y0mdOomHJgHhlA: checks 
opOCI2p6kW0tINuVaAqmcQ: bets $1.50
Gpa8cld5y0mdOomHJgHhlA: calls $1.50
*** RIVER *** [4d Ah Jd 9c] [7h]
Gpa8cld5y0mdOomHJgHhlA: checks 
opOCI2p6kW0tINuVaAqmcQ: bets $3
Gpa8cld5y0mdOomHJgHhlA: folds 
Uncalled bet ($3) returned to opOCI2p6kW0tINuVaAqmcQ
opOCI2p6kW0tINuVaAqmcQ collected $4.55 from pot
*** SUMMARY ***
Total pot $4.75 | Rake $0.20 
Board [4d Ah Jd 9c 7h]
Seat 1: Gpa8cld5y0mdOomHJgHhlA (small blind) folded on the River
Seat 2: yduPKWPzL8YlT5Zv/Nmrwg (big blind) folded before Flop
Seat 3: nm4Dj/f+jJEwKVsUnKh73g folded before Flop (didn't bet)
Seat 4: b8t3jWrxzeEt9HtZtc9wUQ folded before Flop (didn't bet)
Seat 5: tYsOBqdU1+x+yFI7zHO7hQ folded before Flop (didn't bet)
Seat 8: opOCI2p6kW0tINuVaAqmcQ (button) collected ($4.55)




PokerStars Game #59939427664:  Hold'em No Limit ($0.10/$0.25) - 2009/07/01 0:39:36 ET
Table '0mmHveGuaIfIMQlNE1eqMg' 9-max Seat #9 is the button
Seat 1: 7QzbjWT00wQpau1iqvUmMA ($4.75 in chips) 
Seat 2: rQhYIYXSyH/IivYM1dlV5A ($52.40 in chips) 
Seat 3: ghNKXUBl/H+t83JF079ZBA ($26.40 in chips) 
Seat 4: r0/CtYRRIJAbPQm4qsv8LQ ($35.50 in chips) 
Seat 5: cVVfy+hwCb/YzSIyUWhKEw ($33 in chips) 
Seat 6: Xo1w+VqEZh0bV5wYupnNYg ($15.40 in chips) 
Seat 8: jiyia7h6fmxBdWBkH9lH5A ($2.95 in chips) 
Seat 9: W4TLQcZ2TiM73eIgpIvlGg ($34.50 in chips) 
7QzbjWT00wQpau1iqvUmMA: posts small blind $0.10
rQhYIYXSyH/IivYM1dlV5A: posts big blind $0.25
*** HOLE CARDS ***
ghNKXUBl/H+t83JF079ZBA: folds 
r0/CtYRRIJAbPQm4qsv8LQ: folds 
cVVfy+hwCb/YzSIyUWhKEw: calls $0.25
Xo1w+VqEZh0bV5wYupnNYg: folds 
W4TLQcZ2TiM73eIgpIvlGg said, "tough flop"
r0/CtYRRIJAbPQm4qsv8LQ said, "nh"
jiyia7h6fmxBdWBkH9lH5A: folds 
W4TLQcZ2TiM73eIgpIvlGg: folds 
7QzbjWT00wQpau1iqvUmMA: folds 
rQhYIYXSyH/IivYM1dlV5A: checks 
*** FLOP *** [6s 2d Ac]
rQhYIYXSyH/IivYM1dlV5A: bets $0.25
cVVfy+hwCb/YzSIyUWhKEw: folds 
Uncalled bet ($0.25) returned to rQhYIYXSyH/IivYM1dlV5A
rQhYIYXSyH/IivYM1dlV5A collected $0.60 from pot
*** SUMMARY ***
Total pot $0.60 | Rake $0 
Board [6s 2d Ac]
Seat 1: 7QzbjWT00wQpau1iqvUmMA (small blind) folded before Flop
Seat 2: rQhYIYXSyH/IivYM1dlV5A (big blind) collected ($0.60)
Seat 3: ghNKXUBl/H+t83JF079ZBA folded before Flop (didn't bet)
Seat 4: r0/CtYRRIJAbPQm4qsv8LQ folded before Flop (didn't bet)
Seat 5: cVVfy+hwCb/YzSIyUWhKEw folded on the Flop
Seat 6: Xo1w+VqEZh0bV5wYupnNYg folded before Flop (didn't bet)
Seat 8: jiyia7h6fmxBdWBkH9lH5A folded before Flop (didn't bet)
Seat 9: W4TLQcZ2TiM73eIgpIvlGg (button) folded before Flop (didn't bet)




PokerStars Game #59939427414:  Hold'em No Limit ($0.10/$0.25) - 2009/07/01 0:39:36 ET
Table 'ThBZ355rqvsb8UGb6ajbig' 9-max Seat #2 is the button
Seat 2: 4awUyiDYTgylQKXZ9faBVA ($25 in chips) 
Seat 3: LBrhQVB4w41YNd7kMYn/og ($9.70 in chips) 
Seat 4: GFNwOPqg/Zu4ZuokgGADNQ ($16 in chips) 
Seat 5: ljO8CPts14fBjr9/qK0Enw ($27.80 in chips) 
Seat 6: qwr38jl5txoR36M7G5qi4A ($7.50 in chips) 
Seat 7: t2nb95S5EEFOEzNx9Itz0g ($12.95 in chips) 
Seat 8: 6REZ3fl3I5Kaxoupd8cnLg ($14.75 in chips) 
Seat 9: 8B/dhbQjIWe6ASCdgzktNQ ($28.75 in chips) 
LBrhQVB4w41YNd7kMYn/og: posts small blind $0.10
GFNwOPqg/Zu4ZuokgGADNQ: posts big blind $0.25
*** HOLE CARDS ***
ljO8CPts14fBjr9/qK0Enw: raises $0.50 to $0.75
qwr38jl5txoR36M7G5qi4A: folds 
t2nb95S5EEFOEzNx9Itz0g: folds 
6REZ3fl3I5Kaxoupd8cnLg: folds 
8B/dhbQjIWe6ASCdgzktNQ: folds 
4awUyiDYTgylQKXZ9faBVA: folds 
LBrhQVB4w41YNd7kMYn/og: folds 
GFNwOPqg/Zu4ZuokgGADNQ: folds 
Uncalled bet ($0.50) returned to ljO8CPts14fBjr9/qK0Enw
ljO8CPts14fBjr9/qK0Enw collected $0.60 from pot
*** SUMMARY ***
Total pot $0.60 | Rake $0 
Seat 2: 4awUyiDYTgylQKXZ9faBVA (button) folded before Flop (didn't bet)
Seat 3: LBrhQVB4w41YNd7kMYn/og (small blind) folded before Flop
Seat 4: GFNwOPqg/Zu4ZuokgGADNQ (big blind) folded before Flop
Seat 5: ljO8CPts14fBjr9/qK0Enw collected ($0.60)
Seat 6: qwr38jl5txoR36M7G5qi4A folded before Flop (didn't bet)
Seat 7: t2nb95S5EEFOEzNx9Itz0g folded before Flop (didn't bet)
Seat 8: 6REZ3fl3I5Kaxoupd8cnLg folded before Flop (didn't bet)
Seat 9: 8B/dhbQjIWe6ASCdgzktNQ folded before Flop (didn't bet)




PokerStars Game #59939427850:  Hold'em No Limit ($0.10/$0.25) - 2009/07/01 0:39:36 ET
Table 'K/f0NNaoGuhSz5DrzgVw7Q' 9-max Seat #5 is the button
Seat 2: 18G4P1XstjNvItdGUITxgw ($25 in chips) 
Seat 3: VBHxUExRAMrbxUq/cVx9Gw ($5.25 in chips) 
Seat 4: 3L1qKVpA6QZjrddTpoh2zQ ($15.25 in chips) 
Seat 5: DnDcAdn9P0zGovMERigpFA ($25.40 in chips) 
Seat 6: 3PVK0IdMlq2fElkVzzr4bg ($16.75 in chips) 
Seat 7: st9jtdNbm1W5GfBwRaCVqQ ($22.80 in chips) 
Seat 8: E0iYnEVO2ho7dH3QcCjw7g ($20 in chips) 
Seat 9: B5Xu8WsfFPfBlsK3fbAtQQ ($11.70 in chips) 
3PVK0IdMlq2fElkVzzr4bg: posts small blind $0.10
st9jtdNbm1W5GfBwRaCVqQ: posts big blind $0.25
sD+TKtt36XiiN6jqHiLwDA: sits out 
*** HOLE CARDS ***
E0iYnEVO2ho7dH3QcCjw7g: folds 
B5Xu8WsfFPfBlsK3fbAtQQ: folds 
18G4P1XstjNvItdGUITxgw: folds 
VBHxUExRAMrbxUq/cVx9Gw: folds 
3L1qKVpA6QZjrddTpoh2zQ: raises $0.50 to $0.75
DnDcAdn9P0zGovMERigpFA: folds 
3PVK0IdMlq2fElkVzzr4bg: calls $0.65
st9jtdNbm1W5GfBwRaCVqQ: folds 
*** FLOP *** [8h Qc Tc]
3PVK0IdMlq2fElkVzzr4bg: checks 
3L1qKVpA6QZjrddTpoh2zQ: checks 
*** TURN *** [8h Qc Tc] [2d]
3PVK0IdMlq2fElkVzzr4bg: checks 
3L1qKVpA6QZjrddTpoh2zQ: bets $1
3PVK0IdMlq2fElkVzzr4bg: calls $1
*** RIVER *** [8h Qc Tc 2d] [Td]
3PVK0IdMlq2fElkVzzr4bg: checks 
3L1qKVpA6QZjrddTpoh2zQ: checks 
*** SHOW DOWN ***
3PVK0IdMlq2fElkVzzr4bg: shows [9h Kh] (a pair of Tens)
3L1qKVpA6QZjrddTpoh2zQ: mucks hand 
3PVK0IdMlq2fElkVzzr4bg collected $3.60 from pot
*** SUMMARY ***
Total pot $3.75 | Rake $0.15 
Board [8h Qc Tc 2d Td]
Seat 2: 18G4P1XstjNvItdGUITxgw folded before Flop (didn't bet)
Seat 3: VBHxUExRAMrbxUq/cVx9Gw folded before Flop (didn't bet)
Seat 4: 3L1qKVpA6QZjrddTpoh2zQ mucked
Seat 5: DnDcAdn9P0zGovMERigpFA (button) folded before Flop (didn't bet)
Seat 6: 3PVK0IdMlq2fElkVzzr4bg (small blind) showed [9h Kh] and won ($3.60) with a pair of Tens
Seat 7: st9jtdNbm1W5GfBwRaCVqQ (big blind) folded before Flop
Seat 8: E0iYnEVO2ho7dH3QcCjw7g folded before Flop (didn't bet)
Seat 9: B5Xu8WsfFPfBlsK3fbAtQQ folded before Flop (didn't bet)




PokerStars Game #59939427410:  Hold'em No Limit ($0.10/$0.25) - 2009/07/01 0:39:36 ET
Table 'MQJMxKDF6VYBWIKv7VfCog' 9-max Seat #5 is the button
Seat 1: cZ99hugmLBj9KhTlc8nCSw ($25.80 in chips) 
Seat 2: JxpnpCmvRAcrEUy7mq1iAg ($5.20 in chips) 
Seat 3: EfRs3ibIxn+c9JDErwwNCg ($26.05 in chips) 
Seat 4: JtVGnq5doRa3PublncR+Yw ($24.25 in chips) 
Seat 5: RJ/x9oZtt1RZLaJEQwZOxQ ($25.60 in chips) 
Seat 6: ydoFOVgzvZv9ZhuWu9rXAw ($5 in chips) 
Seat 7: dfNim92Z6XK1/h5SFW5vDg ($53.30 in chips) 
Seat 8: Z9AeOQX3yzuSvKAm/xyovg ($9.65 in chips) 
Seat 9: 1S/fpm+f42V/6MNZre+ccg ($36.25 in chips) 
ydoFOVgzvZv9ZhuWu9rXAw: posts small blind $0.10
dfNim92Z6XK1/h5SFW5vDg: posts big blind $0.25
*** HOLE CARDS ***
Z9AeOQX3yzuSvKAm/xyovg: folds 
1S/fpm+f42V/6MNZre+ccg: folds 
cZ99hugmLBj9KhTlc8nCSw: raises $0.50 to $0.75
JxpnpCmvRAcrEUy7mq1iAg: folds 
EfRs3ibIxn+c9JDErwwNCg: folds 
JtVGnq5doRa3PublncR+Yw: folds 
RJ/x9oZtt1RZLaJEQwZOxQ: folds 
ydoFOVgzvZv9ZhuWu9rXAw: folds 
dfNim92Z6XK1/h5SFW5vDg: folds 
Uncalled bet ($0.50) returned to cZ99hugmLBj9KhTlc8nCSw
cZ99hugmLBj9KhTlc8nCSw collected $0.60 from pot
*** SUMMARY ***
Total pot $0.60 | Rake $0 
Seat 1: cZ99hugmLBj9KhTlc8nCSw collected ($0.60)
Seat 2: JxpnpCmvRAcrEUy7mq1iAg folded before Flop (didn't bet)
Seat 3: EfRs3ibIxn+c9JDErwwNCg folded before Flop (didn't bet)
Seat 4: JtVGnq5doRa3PublncR+Yw folded before Flop (didn't bet)
Seat 5: RJ/x9oZtt1RZLaJEQwZOxQ (button) folded before Flop (didn't bet)
Seat 6: ydoFOVgzvZv9ZhuWu9rXAw (small blind) folded before Flop
Seat 7: dfNim92Z6XK1/h5SFW5vDg (big blind) folded before Flop
Seat 8: Z9AeOQX3yzuSvKAm/xyovg folded before Flop (didn't bet)
Seat 9: 1S/fpm+f42V/6MNZre+ccg folded before Flop (didn't bet)




PokerStars Game #59939427344:  Hold'em No Limit ($0.10/$0.25) - 2009/07/01 0:39:36 ET
Table 'iMiAw/kTZXopgYX4HI7sHg' 9-max Seat #7 is the button
Seat 1: 6LFELL8V3NTpb0xg7AOyEg ($22.15 in chips) 
Seat 2: QBNV6v6f+1ZHoaKcQDTWog ($18.20 in chips) 
Seat 3: HPEB+AtKw1+C/cxU0o1ciw ($22.55 in chips) 
Seat 4: S+cUFPGjDERB8nh2Ub77Bg ($12.60 in chips) 
Seat 5: UG5jx0ZzlHKfc+tNQpQoMQ ($1.90 in chips) 
Seat 6: mdk0yKND3u0wCmRU4tNRFg ($28.80 in chips) 
Seat 7: aPRz/2GxbXANYpVsQO8pdQ ($24.50 in chips) 
Seat 8: gU2i78hKxj5RUUH6zCK9bA ($6.50 in chips) 
Seat 9: K36tHfxDQBx3OFpy0baDPA ($19.20 in chips) 
gU2i78hKxj5RUUH6zCK9bA: posts small blind $0.10
K36tHfxDQBx3OFpy0baDPA: posts big blind $0.25
*** HOLE CARDS ***
6LFELL8V3NTpb0xg7AOyEg: folds 
QBNV6v6f+1ZHoaKcQDTWog: folds 
QBNV6v6f+1ZHoaKcQDTWog leaves the table
HPEB+AtKw1+C/cxU0o1ciw: folds 
S+cUFPGjDERB8nh2Ub77Bg: calls $0.25
UG5jx0ZzlHKfc+tNQpQoMQ: folds 
mdk0yKND3u0wCmRU4tNRFg: calls $0.25
6LFELL8V3NTpb0xg7AOyEg leaves the table
aPRz/2GxbXANYpVsQO8pdQ: folds 
qwr38jl5txoR36M7G5qi4A joins the table at seat #2 
gU2i78hKxj5RUUH6zCK9bA: folds 
K36tHfxDQBx3OFpy0baDPA: checks 
*** FLOP *** [5d 2c Qh]
K36tHfxDQBx3OFpy0baDPA: bets $0.25
S+cUFPGjDERB8nh2Ub77Bg: folds 
mdk0yKND3u0wCmRU4tNRFg: folds 
Uncalled bet ($0.25) returned to K36tHfxDQBx3OFpy0baDPA
K36tHfxDQBx3OFpy0baDPA collected $0.85 from pot
K36tHfxDQBx3OFpy0baDPA: doesn't show hand 
*** SUMMARY ***
Total pot $0.85 | Rake $0 
Board [5d 2c Qh]
Seat 1: 6LFELL8V3NTpb0xg7AOyEg folded before Flop (didn't bet)
Seat 2: QBNV6v6f+1ZHoaKcQDTWog folded before Flop (didn't bet)
Seat 3: HPEB+AtKw1+C/cxU0o1ciw folded before Flop (didn't bet)
Seat 4: S+cUFPGjDERB8nh2Ub77Bg folded on the Flop
Seat 5: UG5jx0ZzlHKfc+tNQpQoMQ folded before Flop (didn't bet)
Seat 6: mdk0yKND3u0wCmRU4tNRFg folded on the Flop
Seat 7: aPRz/2GxbXANYpVsQO8pdQ (button) folded before Flop (didn't bet)
Seat 8: gU2i78hKxj5RUUH6zCK9bA (small blind) folded before Flop
Seat 9: K36tHfxDQBx3OFpy0baDPA (big blind) collected ($0.85)




PokerStars Game #59939428482:  Hold'em No Limit ($0.10/$0.25) - 2009/07/01 0:39:37 ET
Table 'Utmw+yX+E/wdhNDIim90lQ' 9-max Seat #3 is the button
Seat 1: lwlnPm68QGGI/+pnAd4GAw ($60.10 in chips) 
Seat 2: iGMlK+EhUflPB6jKQd95Cg ($25.20 in chips) 
Seat 3: dfNim92Z6XK1/h5SFW5vDg ($25 in chips) 
Seat 4: ifYGvZDHQQ0aam4awTtHwA ($4.45 in chips) 
Seat 5: H9KUl8cmpLgEpOVDA00bCg ($4.30 in chips) 
Seat 6: /67o0BjW8sY1ZxYt7/6StQ ($13.60 in chips) 
Seat 7: CImUHesK+ZER4v/VCA9IUg ($64.80 in chips) 
Seat 8: DdPXdieucQ+n99u1n3A+rQ ($4.90 in chips) 
Seat 9: Th3FldXKQW6hWVVPahaoOQ ($27.50 in chips) 
ifYGvZDHQQ0aam4awTtHwA: posts small blind $0.10
lwlnPm68QGGI/+pnAd4GAw said, "thanks for the donation"
H9KUl8cmpLgEpOVDA00bCg: posts big blind $0.25
*** HOLE CARDS ***
/67o0BjW8sY1ZxYt7/6StQ: folds 
/67o0BjW8sY1ZxYt7/6StQ leaves the table
CImUHesK+ZER4v/VCA9IUg: folds 
DdPXdieucQ+n99u1n3A+rQ: folds 
ifYGvZDHQQ0aam4awTtHwA said, "you never live til you give"
Th3FldXKQW6hWVVPahaoOQ: folds 
OlPJsgR4xypSg/w1z7Gyvw joins the table at seat #6 
lwlnPm68QGGI/+pnAd4GAw has timed out
lwlnPm68QGGI/+pnAd4GAw: folds 
lwlnPm68QGGI/+pnAd4GAw is sitting out
iGMlK+EhUflPB6jKQd95Cg: folds 
dfNim92Z6XK1/h5SFW5vDg: folds 
ifYGvZDHQQ0aam4awTtHwA: raises $1.50 to $1.75
H9KUl8cmpLgEpOVDA00bCg: folds 
Uncalled bet ($1.50) returned to ifYGvZDHQQ0aam4awTtHwA
lwlnPm68QGGI/+pnAd4GAw has returned
ifYGvZDHQQ0aam4awTtHwA collected $0.50 from pot
*** SUMMARY ***
Total pot $0.50 | Rake $0 
Seat 1: lwlnPm68QGGI/+pnAd4GAw folded before Flop (didn't bet)
Seat 2: iGMlK+EhUflPB6jKQd95Cg folded before Flop (didn't bet)
Seat 3: dfNim92Z6XK1/h5SFW5vDg (button) folded before Flop (didn't bet)
Seat 4: ifYGvZDHQQ0aam4awTtHwA (small blind) collected ($0.50)
Seat 5: H9KUl8cmpLgEpOVDA00bCg (big blind) folded before Flop
Seat 6: /67o0BjW8sY1ZxYt7/6StQ folded before Flop (didn't bet)
Seat 7: CImUHesK+ZER4v/VCA9IUg folded before Flop (didn't bet)
Seat 8: DdPXdieucQ+n99u1n3A+rQ folded before Flop (didn't bet)
Seat 9: Th3FldXKQW6hWVVPahaoOQ folded before Flop (didn't bet)




PokerStars Game #59939428240:  Hold'em No Limit ($0.10/$0.25) - 2009/07/01 0:39:37 ET
Table 'sIHZ0lzLr4NGCaBUKhmYhAJj2eLzVCUVAGBmM+Og79iQax Seat #8 is the button
Seat 1: /XMgGtJ7mcWfe5s7McY9kw ($42.25 in chips) 
Seat 2: oMxwMC7+uAsJudeUN6aP0A ($12.65 in chips) 
Seat 3: HPEB+AtKw1+C/cxU0o1ciw ($24.05 in chips) 
Seat 4: aNpwfA31EREwO+ar4XzBCw ($47.05 in chips) 
Seat 5: UOx+/JnFB2Or6ZU9oasIlQ ($22.65 in chips) 
Seat 6: ZeR3hkj1gVv9J4yPCmRrjA ($32 in chips) 
Seat 8: 16Yp3bX9mgiQWREpX0V1Ag ($3.65 in chips) 
Seat 9: wU1LtrccnZo6PYKhlJ6ElQ ($36.45 in chips) 
wU1LtrccnZo6PYKhlJ6ElQ: posts small blind $0.10
/XMgGtJ7mcWfe5s7McY9kw: posts big blind $0.25
*** HOLE CARDS ***
oMxwMC7+uAsJudeUN6aP0A: calls $0.25
/XMgGtJ7mcWfe5s7McY9kw said, "vnh"
HPEB+AtKw1+C/cxU0o1ciw: folds 
aNpwfA31EREwO+ar4XzBCw: folds 
UOx+/JnFB2Or6ZU9oasIlQ: calls $0.25
ZeR3hkj1gVv9J4yPCmRrjA: folds 
16Yp3bX9mgiQWREpX0V1Ag: folds 
16Yp3bX9mgiQWREpX0V1Ag leaves the table
wU1LtrccnZo6PYKhlJ6ElQ: folds 
/XMgGtJ7mcWfe5s7McY9kw: checks 
*** FLOP *** [5s 7h Ad]
18G4P1XstjNvItdGUITxgw joins the table at seat #8 
/XMgGtJ7mcWfe5s7McY9kw: checks 
oMxwMC7+uAsJudeUN6aP0A: bets $0.50
UOx+/JnFB2Or6ZU9oasIlQ: calls $0.50
/XMgGtJ7mcWfe5s7McY9kw: calls $0.50
*** TURN *** [5s 7h Ad] [5c]
/XMgGtJ7mcWfe5s7McY9kw: checks 
oMxwMC7+uAsJudeUN6aP0A: bets $1
UOx+/JnFB2Or6ZU9oasIlQ: calls $1
/XMgGtJ7mcWfe5s7McY9kw: folds 
*** RIVER *** [5s 7h Ad 5c] [5h]
oMxwMC7+uAsJudeUN6aP0A: checks 
UOx+/JnFB2Or6ZU9oasIlQ: bets $2.25
oMxwMC7+uAsJudeUN6aP0A: raises $2.25 to $4.50
UOx+/JnFB2Or6ZU9oasIlQ: calls $2.25
*** SHOW DOWN ***
oMxwMC7+uAsJudeUN6aP0A: shows [Qc 5d] (four of a kind, Fives)
UOx+/JnFB2Or6ZU9oasIlQ: mucks hand 
oMxwMC7+uAsJudeUN6aP0A collected $12.70 from pot
*** SUMMARY ***
Total pot $13.35 | Rake $0.65 
Board [5s 7h Ad 5c 5h]
Seat 1: /XMgGtJ7mcWfe5s7McY9kw (big blind) folded on the Turn
Seat 2: oMxwMC7+uAsJudeUN6aP0A showed [Qc 5d] and won ($12.70) with four of a kind, Fives
Seat 3: HPEB+AtKw1+C/cxU0o1ciw folded before Flop (didn't bet)
Seat 4: aNpwfA31EREwO+ar4XzBCw folded before Flop (didn't bet)
Seat 5: UOx+/JnFB2Or6ZU9oasIlQ mucked
Seat 6: ZeR3hkj1gVv9J4yPCmRrjA folded before Flop (didn't bet)
Seat 8: 16Yp3bX9mgiQWREpX0V1Ag (button) folded before Flop (didn't bet)
Seat 9: wU1LtrccnZo6PYKhlJ6ElQ (small blind) folded before Flop




PokerStars Game #59939428072:  Hold'em No Limit ($0.10/$0.25) - 2009/07/01 0:39:37 ET
Table '7/qMNloI0nSXWiX5Y1watA' 9-max Seat #1 is the button
Seat 1: lF4l0ujUfJ9uYJOg9Ch9/g ($45.10 in chips) 
Seat 2: 8B/dhbQjIWe6ASCdgzktNQ ($25.50 in chips) 
Seat 3: nEg1b6MIksd/4x5eLY735g ($40.10 in chips) 
Seat 4: 18G4P1XstjNvItdGUITxgw ($25.35 in chips) 
Seat 5: dfNim92Z6XK1/h5SFW5vDg ($32.85 in chips) 
Seat 6: /rRB5qE14E0X2mwkBd4RUA ($15.25 in chips) 
Seat 7: z5GxcHlYz/GSz6W2uFiTtg ($11.20 in chips) 
Seat 8: ljemhp25Zg+nlA9DLCIiUw ($24.15 in chips) 
8B/dhbQjIWe6ASCdgzktNQ: posts small blind $0.10
nEg1b6MIksd/4x5eLY735g: posts big blind $0.25
aPRz/2GxbXANYpVsQO8pdQ: sits out 
*** HOLE CARDS ***
18G4P1XstjNvItdGUITxgw: folds 
dfNim92Z6XK1/h5SFW5vDg: folds 
/rRB5qE14E0X2mwkBd4RUA: folds 
/rRB5qE14E0X2mwkBd4RUA leaves the table
z5GxcHlYz/GSz6W2uFiTtg: folds 
ljemhp25Zg+nlA9DLCIiUw: raises $0.50 to $0.75
lF4l0ujUfJ9uYJOg9Ch9/g: folds 
8B/dhbQjIWe6ASCdgzktNQ: folds 
nEg1b6MIksd/4x5eLY735g: folds 
Uncalled bet ($0.50) returned to ljemhp25Zg+nlA9DLCIiUw
ljemhp25Zg+nlA9DLCIiUw collected $0.60 from pot
ljemhp25Zg+nlA9DLCIiUw: doesn't show hand 
*** SUMMARY ***
Total pot $0.60 | Rake $0 
Seat 1: lF4l0ujUfJ9uYJOg9Ch9/g (button) folded before Flop (didn't bet)
Seat 2: 8B/dhbQjIWe6ASCdgzktNQ (small blind) folded before Flop
Seat 3: nEg1b6MIksd/4x5eLY735g (big blind) folded before Flop
Seat 4: 18G4P1XstjNvItdGUITxgw folded before Flop (didn't bet)
Seat 5: dfNim92Z6XK1/h5SFW5vDg folded before Flop (didn't bet)
Seat 6: /rRB5qE14E0X2mwkBd4RUA folded before Flop (didn't bet)
Seat 7: z5GxcHlYz/GSz6W2uFiTtg folded before Flop (didn't bet)
Seat 8: ljemhp25Zg+nlA9DLCIiUw collected ($0.60)




PokerStars Game #59939428316:  Hold'em No Limit ($0.10/$0.25) - 2009/07/01 0:39:37 ET
Table 'z2yOdY2zyGWG1gh9WV9XtQ' 9-max Seat #8 is the button
Seat 1: k/tPF1MnFJtmPS14iqcejw ($29.45 in chips) 
Seat 2: s7Q6uNouhe7aE8JdFb9E+A ($25 in chips) 
Seat 3: 7AzEFY3y7BINbVpICeVrHA ($8.65 in chips) 
Seat 4: BMTbQu92kfh1+tEQba3Flw ($17.55 in chips) 
Seat 5: DYB0aP91n+Rg/TIhycbaPQ ($15.40 in chips) 
Seat 6: vZGoOTJLQLhkPj4I+LNGig ($25.25 in chips) 
Seat 7: zDrucyjVn5aeekNEc3cJrA ($26.45 in chips) 
Seat 8: hIss79a4pu7GzJZepfgOpg ($25 in chips) 
k/tPF1MnFJtmPS14iqcejw: posts small blind $0.10
s7Q6uNouhe7aE8JdFb9E+A: posts big blind $0.25
*** HOLE CARDS ***
7AzEFY3y7BINbVpICeVrHA: calls $0.25
BMTbQu92kfh1+tEQba3Flw: folds 
DYB0aP91n+Rg/TIhycbaPQ: calls $0.25
vZGoOTJLQLhkPj4I+LNGig: raises $1.25 to $1.50
zDrucyjVn5aeekNEc3cJrA: folds 
hIss79a4pu7GzJZepfgOpg: folds 
k/tPF1MnFJtmPS14iqcejw: folds 
s7Q6uNouhe7aE8JdFb9E+A: folds 
7AzEFY3y7BINbVpICeVrHA: calls $1.25
DYB0aP91n+Rg/TIhycbaPQ: calls $1.25
*** FLOP *** [3d 5s Jc]
7AzEFY3y7BINbVpICeVrHA: checks 
DYB0aP91n+Rg/TIhycbaPQ: bets $0.25
vZGoOTJLQLhkPj4I+LNGig: raises $3.75 to $4
7AzEFY3y7BINbVpICeVrHA: folds 
DYB0aP91n+Rg/TIhycbaPQ: folds 
Uncalled bet ($3.75) returned to vZGoOTJLQLhkPj4I+LNGig
vZGoOTJLQLhkPj4I+LNGig collected $5.10 from pot
vZGoOTJLQLhkPj4I+LNGig: doesn't show hand 
*** SUMMARY ***
Total pot $5.35 | Rake $0.25 
Board [3d 5s Jc]
Seat 1: k/tPF1MnFJtmPS14iqcejw (small blind) folded before Flop
Seat 2: s7Q6uNouhe7aE8JdFb9E+A (big blind) folded before Flop
Seat 3: 7AzEFY3y7BINbVpICeVrHA folded on the Flop
Seat 4: BMTbQu92kfh1+tEQba3Flw folded before Flop (didn't bet)
Seat 5: DYB0aP91n+Rg/TIhycbaPQ folded on the Flop
Seat 6: vZGoOTJLQLhkPj4I+LNGig collected ($5.10)
Seat 7: zDrucyjVn5aeekNEc3cJrA folded before Flop (didn't bet)
Seat 8: hIss79a4pu7GzJZepfgOpg (button) folded before Flop (didn't bet)




PokerStars Game #59939428164:  Hold'em No Limit ($0.10/$0.25) - 2009/07/01 0:39:37 ET
Table '8QBBaev+cI2i/r2H6ml/lg' 9-max Seat #4 is the button
Seat 2: tYsOBqdU1+x+yFI7zHO7hQ ($25 in chips) 
Seat 4: ZoG0obuajzVjwgd7lNHjgg ($3.50 in chips) 
Seat 5: j4q3p0lesp63b1gZDwLBZw ($5 in chips) 
Seat 9: Ml2bY77EHbM51ZWD7dnIWg ($1.95 in chips) 
j4q3p0lesp63b1gZDwLBZw: posts small blind $0.10
Ml2bY77EHbM51ZWD7dnIWg: posts big blind $0.25
*** HOLE CARDS ***
tYsOBqdU1+x+yFI7zHO7hQ: folds 
ZoG0obuajzVjwgd7lNHjgg: calls $0.25
j4q3p0lesp63b1gZDwLBZw: folds 
Ml2bY77EHbM51ZWD7dnIWg: checks 
*** FLOP *** [3c 8c As]
j4q3p0lesp63b1gZDwLBZw leaves the table
Ml2bY77EHbM51ZWD7dnIWg: checks 
ZoG0obuajzVjwgd7lNHjgg: bets $0.75
Ml2bY77EHbM51ZWD7dnIWg: folds 
Uncalled bet ($0.75) returned to ZoG0obuajzVjwgd7lNHjgg
ZoG0obuajzVjwgd7lNHjgg collected $0.60 from pot
*** SUMMARY ***
Total pot $0.60 | Rake $0 
Board [3c 8c As]
Seat 2: tYsOBqdU1+x+yFI7zHO7hQ folded before Flop (didn't bet)
Seat 4: ZoG0obuajzVjwgd7lNHjgg (button) collected ($0.60)
Seat 5: j4q3p0lesp63b1gZDwLBZw (small blind) folded before Flop
Seat 9: Ml2bY77EHbM51ZWD7dnIWg (big blind) folded on the Flop




PokerStars Game #59939428476:  Hold'em No Limit ($0.10/$0.25) - 2009/07/01 0:39:37 ET
Table '29D3eoQzK5kOAT0OIDS2uQ' 6-max Seat #6 is the button
Seat 1: kG34n23qFQA3nzdOJTQ1dA ($51.40 in chips) 
Seat 2: tbhYGxTClzdFLMcTtjvJhg ($44.20 in chips) 
Seat 3: z3tQwy28dp5FykDJC/wzQw ($19.35 in chips) 
Seat 4: yzFNNFIfC89bBPwpFPx2ow ($27.10 in chips) 
Seat 5: Q3EMN7b0ie81AFWkDrhCjw ($34.05 in chips) 
Seat 6: bWbV4MVB/vVpiES1Ut4hew ($44.10 in chips) 
kG34n23qFQA3nzdOJTQ1dA: posts small blind $0.10
tbhYGxTClzdFLMcTtjvJhg: posts big blind $0.25
*** HOLE CARDS ***
z3tQwy28dp5FykDJC/wzQw: calls $0.25
yzFNNFIfC89bBPwpFPx2ow: folds 
Q3EMN7b0ie81AFWkDrhCjw: calls $0.25
bWbV4MVB/vVpiES1Ut4hew: folds 
kG34n23qFQA3nzdOJTQ1dA: folds 
tbhYGxTClzdFLMcTtjvJhg: checks 
*** FLOP *** [Ac 3c 8s]
tbhYGxTClzdFLMcTtjvJhg: checks 
z3tQwy28dp5FykDJC/wzQw: checks 
Q3EMN7b0ie81AFWkDrhCjw: bets $0.50
tbhYGxTClzdFLMcTtjvJhg: folds 
z3tQwy28dp5FykDJC/wzQw: calls $0.50
*** TURN *** [Ac 3c 8s] [5c]
z3tQwy28dp5FykDJC/wzQw: checks 
Q3EMN7b0ie81AFWkDrhCjw: bets $0.50
z3tQwy28dp5FykDJC/wzQw: calls $0.50
*** RIVER *** [Ac 3c 8s 5c] [6s]
z3tQwy28dp5FykDJC/wzQw: checks 
Q3EMN7b0ie81AFWkDrhCjw: bets $0.50
z3tQwy28dp5FykDJC/wzQw: calls $0.50
*** SHOW DOWN ***
Q3EMN7b0ie81AFWkDrhCjw: shows [8h Qs] (a pair of Eights)
z3tQwy28dp5FykDJC/wzQw: shows [Th Ad] (a pair of Aces)
z3tQwy28dp5FykDJC/wzQw collected $3.70 from pot
*** SUMMARY ***
Total pot $3.85 | Rake $0.15 
Board [Ac 3c 8s 5c 6s]
Seat 1: kG34n23qFQA3nzdOJTQ1dA (small blind) folded before Flop
Seat 2: tbhYGxTClzdFLMcTtjvJhg (big blind) folded on the Flop
Seat 3: z3tQwy28dp5FykDJC/wzQw showed [Th Ad] and won ($3.70) with a pair of Aces
Seat 4: yzFNNFIfC89bBPwpFPx2ow folded before Flop (didn't bet)
Seat 5: Q3EMN7b0ie81AFWkDrhCjw showed [8h Qs] and lost with a pair of Eights
Seat 6: bWbV4MVB/vVpiES1Ut4hew (button) folded before Flop (didn't bet)




PokerStars Game #59939428406:  Hold'em No Limit ($0.10/$0.25) - 2009/07/01 0:39:37 ET
Table '2O5CgfSkSwrr4PDrlZ1RLQ' 6-max Seat #2 is the button
Seat 1: kyRaCIljYA6l33lSKQfNsg ($47.25 in chips) 
Seat 2: /gJNBeCkWL4o85/jvlZ4BA ($49.75 in chips) 
Seat 3: yzFNNFIfC89bBPwpFPx2ow ($25 in chips) 
Seat 4: 4x9jCqgSw4272dnaIqnanw ($9.25 in chips) 
Seat 5: AMrBn4Vx9aAo/vv6WHLk6w ($5.40 in chips) 
yzFNNFIfC89bBPwpFPx2ow: posts small blind $0.10
4x9jCqgSw4272dnaIqnanw: posts big blind $0.25
Pdog104: sits out 
*** HOLE CARDS ***
AMrBn4Vx9aAo/vv6WHLk6w: folds 
kyRaCIljYA6l33lSKQfNsg: raises $0.50 to $0.75
/gJNBeCkWL4o85/jvlZ4BA: folds 
yzFNNFIfC89bBPwpFPx2ow: folds 
4x9jCqgSw4272dnaIqnanw: folds 
Uncalled bet ($0.50) returned to kyRaCIljYA6l33lSKQfNsg
kyRaCIljYA6l33lSKQfNsg collected $0.60 from pot
*** SUMMARY ***
Total pot $0.60 | Rake $0 
Seat 1: kyRaCIljYA6l33lSKQfNsg collected ($0.60)
Seat 2: /gJNBeCkWL4o85/jvlZ4BA (button) folded before Flop (didn't bet)
Seat 3: yzFNNFIfC89bBPwpFPx2ow (small blind) folded before Flop
Seat 4: 4x9jCqgSw4272dnaIqnanw (big blind) folded before Flop
Seat 5: AMrBn4Vx9aAo/vv6WHLk6w folded before Flop (didn't bet)




PokerStars Game #59939429106:  Hold'em No Limit ($0.10/$0.25) - 2009/07/01 0:39:38 ET
Table 'mVdLgAdN9rGe6mMwSrDdGQ' 6-max Seat #2 is the button
Seat 1: 1tFjlBNp9g4Qjfo0vKlSzw ($13.15 in chips) 
Seat 2: fSUx4e1vURbgXyDBEcRbAg ($2 in chips) 
Seat 3: kG34n23qFQA3nzdOJTQ1dA ($24.40 in chips) 
Seat 5: oseFhpinoe+Zg4j5xyBjyQ ($56.95 in chips) 
Seat 6: Ew/TYPQIsbQ2X8nm5iAJBg ($24.65 in chips) 
kG34n23qFQA3nzdOJTQ1dA: posts small blind $0.10
oseFhpinoe+Zg4j5xyBjyQ: posts big blind $0.25
*** HOLE CARDS ***
Ew/TYPQIsbQ2X8nm5iAJBg: folds 
1tFjlBNp9g4Qjfo0vKlSzw: folds 
fSUx4e1vURbgXyDBEcRbAg: raises $0.75 to $1
kG34n23qFQA3nzdOJTQ1dA: folds 
oseFhpinoe+Zg4j5xyBjyQ: folds 
Uncalled bet ($0.75) returned to fSUx4e1vURbgXyDBEcRbAg
fSUx4e1vURbgXyDBEcRbAg collected $0.60 from pot
*** SUMMARY ***
Total pot $0.60 | Rake $0 
Seat 1: 1tFjlBNp9g4Qjfo0vKlSzw folded before Flop (didn't bet)
Seat 2: fSUx4e1vURbgXyDBEcRbAg (button) collected ($0.60)
Seat 3: kG34n23qFQA3nzdOJTQ1dA (small blind) folded before Flop
Seat 5: oseFhpinoe+Zg4j5xyBjyQ (big blind) folded before Flop
Seat 6: Ew/TYPQIsbQ2X8nm5iAJBg folded before Flop (didn't bet)




PokerStars Game #59939428974:  Hold'em No Limit ($0.10/$0.25) - 2009/07/01 0:39:38 ET
Table '+UzantPJ4smVdrh+4GTu1w' 6-max Seat #5 is the button
Seat 1: 3Bm6SLY1pwRvi98HLQUkvg ($2.15 in chips) 
Seat 2: tcbEu7VzyHQ+0lh+skbQhQ ($10.25 in chips) 
Seat 3: SS/yfeArhULzIcOPe8MdPg ($51.15 in chips) 
Seat 5: cj4VBQya7HtVL2zCGd5jLQ ($16.80 in chips) 
Seat 6: BYxjLnV1/LL0aZcTbfAOvw ($48.15 in chips) 
BYxjLnV1/LL0aZcTbfAOvw: posts small blind $0.10
3Bm6SLY1pwRvi98HLQUkvg: posts big blind $0.25
tjhousyomama: sits out 
*** HOLE CARDS ***
tcbEu7VzyHQ+0lh+skbQhQ: folds 
SS/yfeArhULzIcOPe8MdPg: folds 
cj4VBQya7HtVL2zCGd5jLQ: calls $0.25
BYxjLnV1/LL0aZcTbfAOvw: folds 
3Bm6SLY1pwRvi98HLQUkvg: checks 
*** FLOP *** [7d 9d 5s]
3Bm6SLY1pwRvi98HLQUkvg: checks 
cj4VBQya7HtVL2zCGd5jLQ: checks 
*** TURN *** [7d 9d 5s] [Kd]
3Bm6SLY1pwRvi98HLQUkvg: checks 
cj4VBQya7HtVL2zCGd5jLQ: checks 
*** RIVER *** [7d 9d 5s Kd] [Td]
3Bm6SLY1pwRvi98HLQUkvg: checks 
cj4VBQya7HtVL2zCGd5jLQ: bets $2
3Bm6SLY1pwRvi98HLQUkvg: folds 
Uncalled bet ($2) returned to cj4VBQya7HtVL2zCGd5jLQ
cj4VBQya7HtVL2zCGd5jLQ collected $0.60 from pot
*** SUMMARY ***
Total pot $0.60 | Rake $0 
Board [7d 9d 5s Kd Td]
Seat 1: 3Bm6SLY1pwRvi98HLQUkvg (big blind) folded on the River
Seat 2: tcbEu7VzyHQ+0lh+skbQhQ folded before Flop (didn't bet)
Seat 3: SS/yfeArhULzIcOPe8MdPg folded before Flop (didn't bet)
Seat 5: cj4VBQya7HtVL2zCGd5jLQ (button) collected ($0.60)
Seat 6: BYxjLnV1/LL0aZcTbfAOvw (small blind) folded before Flop




PokerStars Game #59939428780:  Hold'em No Limit ($0.10/$0.25) - 2009/07/01 0:39:38 ET
Table 'NtEQAxCeIK2io1CGtW658g' 6-max Seat #6 is the button
Seat 1: lnOV7k25gyN7L5t5YKTgIg ($20.60 in chips) 
Seat 2: nc79pm0LZRdhncq55evVqA ($25.90 in chips) 
Seat 4: 8296 ($12 in chips) 
Seat 5: FStoHe64SQWqAsjya9pDkQ ($27.85 in chips) 
Seat 6: /gJNBeCkWL4o85/jvlZ4BA ($62 in chips) 
lnOV7k25gyN7L5t5YKTgIg: posts small blind $0.10
nc79pm0LZRdhncq55evVqA: posts big blind $0.25
m2yWOKfAxqHoy5DDN87Ttw: sits out 
*** HOLE CARDS ***
8296: folds 
FStoHe64SQWqAsjya9pDkQ: raises $0.50 to $0.75
/gJNBeCkWL4o85/jvlZ4BA: folds 
lnOV7k25gyN7L5t5YKTgIg: folds 
nc79pm0LZRdhncq55evVqA: folds 
Uncalled bet ($0.50) returned to FStoHe64SQWqAsjya9pDkQ
FStoHe64SQWqAsjya9pDkQ collected $0.60 from pot
FStoHe64SQWqAsjya9pDkQ: doesn't show hand 
*** SUMMARY ***
Total pot $0.60 | Rake $0 
Seat 1: lnOV7k25gyN7L5t5YKTgIg (small blind) folded before Flop
Seat 2: nc79pm0LZRdhncq55evVqA (big blind) folded before Flop
Seat 4: 8296 folded before Flop (didn't bet)
Seat 5: FStoHe64SQWqAsjya9pDkQ collected ($0.60)
Seat 6: /gJNBeCkWL4o85/jvlZ4BA (button) folded before Flop (didn't bet)




PokerStars Game #59939428818:  Hold'em No Limit ($0.10/$0.25) - 2009/07/01 0:39:38 ET
Table 'nc6OeGk/wtaWV+6N+kgnZQ' 6-max Seat #3 is the button
Seat 1: 0/FYfBoKhINaqU/H5OSS1A ($5.60 in chips) 
Seat 3: 8f0dtuUGqDbgE6up1lQAlg ($4 in chips) 
Seat 6: yJgjVkWgiJ8vdWZjcUod2A ($5.30 in chips) 
yJgjVkWgiJ8vdWZjcUod2A: posts small blind $0.10
0/FYfBoKhINaqU/H5OSS1A: posts big blind $0.25
*** HOLE CARDS ***
8f0dtuUGqDbgE6up1lQAlg: calls $0.25
yJgjVkWgiJ8vdWZjcUod2A: raises $0.75 to $1
0/FYfBoKhINaqU/H5OSS1A: calls $0.75
8f0dtuUGqDbgE6up1lQAlg: folds 
*** FLOP *** [8c 7d Ad]
yJgjVkWgiJ8vdWZjcUod2A: bets $0.75
0/FYfBoKhINaqU/H5OSS1A: folds 
Uncalled bet ($0.75) returned to yJgjVkWgiJ8vdWZjcUod2A
yJgjVkWgiJ8vdWZjcUod2A collected $2.15 from pot
yJgjVkWgiJ8vdWZjcUod2A: doesn't show hand 
*** SUMMARY ***
Total pot $2.25 | Rake $0.10 
Board [8c 7d Ad]
Seat 1: 0/FYfBoKhINaqU/H5OSS1A (big blind) folded on the Flop
Seat 3: 8f0dtuUGqDbgE6up1lQAlg (button) folded before Flop
Seat 6: yJgjVkWgiJ8vdWZjcUod2A (small blind) collected ($2.15)




PokerStars Game #59939428604:  Hold'em No Limit ($0.10/$0.25) - 2009/07/01 0:39:38 ET
Table 'sJ4KpS2GE5Qrsu1/cFjJUw' 9-max Seat #8 is the button
Seat 1: QsLvCwfSWqP+CfjwUnjpXQ ($14.15 in chips) 
Seat 3: eDil7UzSZCjyh1VP6SVXJQ ($7.55 in chips) 
Seat 8: f8ixGbSVIs6Be0mH69ldVQ ($14.85 in chips) 
QsLvCwfSWqP+CfjwUnjpXQ: posts small blind $0.10
eDil7UzSZCjyh1VP6SVXJQ: posts big blind $0.25
*** HOLE CARDS ***
f8ixGbSVIs6Be0mH69ldVQ: folds 
QsLvCwfSWqP+CfjwUnjpXQ: raises $0.50 to $0.75
eDil7UzSZCjyh1VP6SVXJQ: folds 
Uncalled bet ($0.50) returned to QsLvCwfSWqP+CfjwUnjpXQ
QsLvCwfSWqP+CfjwUnjpXQ collected $0.50 from pot
*** SUMMARY ***
Total pot $0.50 | Rake $0 
Seat 1: QsLvCwfSWqP+CfjwUnjpXQ (small blind) collected ($0.50)
Seat 3: eDil7UzSZCjyh1VP6SVXJQ (big blind) folded before Flop
Seat 8: f8ixGbSVIs6Be0mH69ldVQ (button) folded before Flop (didn't bet)




PokerStars Game #59939428638:  Hold'em No Limit ($0.10/$0.25) - 2009/07/01 0:39:38 ET
Table 'GgmUtmhrYPRnhkqEEjD/Kw' 9-max Seat #6 is the button
Seat 2: ghNKXUBl/H+t83JF079ZBA ($25 in chips) 
Seat 3: DZek9vrzBExLUFtbWml/Eg ($11.05 in chips) 
Seat 4: uwmAXQRjyA4iX5kaC15P9A ($5.40 in chips) 
Seat 5: lwrOE80tuooHfIBx/4LUSw ($30.75 in chips) 
Seat 6: 4Ax0vobe1rLVIGZmkFINGA ($17.55 in chips) 
Seat 7: YwDw9cMqkbMznFK77rru4A ($8.65 in chips) 
Seat 8: mKwW7JjB4GQW2YtoYgqIgw ($12.45 in chips) 
YwDw9cMqkbMznFK77rru4A: posts small blind $0.10
mKwW7JjB4GQW2YtoYgqIgw: posts big blind $0.25
*** HOLE CARDS ***
4Ax0vobe1rLVIGZmkFINGA is connected 
ghNKXUBl/H+t83JF079ZBA: folds 
DZek9vrzBExLUFtbWml/Eg: folds 
uwmAXQRjyA4iX5kaC15P9A: folds 
lwrOE80tuooHfIBx/4LUSw: raises $0.50 to $0.75
4Ax0vobe1rLVIGZmkFINGA: folds 
YwDw9cMqkbMznFK77rru4A: folds 
mKwW7JjB4GQW2YtoYgqIgw: folds 
Uncalled bet ($0.50) returned to lwrOE80tuooHfIBx/4LUSw
lwrOE80tuooHfIBx/4LUSw collected $0.60 from pot
lwrOE80tuooHfIBx/4LUSw: doesn't show hand 
*** SUMMARY ***
Total pot $0.60 | Rake $0 
Seat 2: ghNKXUBl/H+t83JF079ZBA folded before Flop (didn't bet)
Seat 3: DZek9vrzBExLUFtbWml/Eg folded before Flop (didn't bet)
Seat 4: uwmAXQRjyA4iX5kaC15P9A folded before Flop (didn't bet)
Seat 5: lwrOE80tuooHfIBx/4LUSw collected ($0.60)
Seat 6: 4Ax0vobe1rLVIGZmkFINGA (button) folded before Flop (didn't bet)
Seat 7: YwDw9cMqkbMznFK77rru4A (small blind) folded before Flop
Seat 8: mKwW7JjB4GQW2YtoYgqIgw (big blind) folded before Flop




PokerStars Game #59939428810:  Hold'em No Limit ($0.10/$0.25) - 2009/07/01 0:39:38 ET
Table 'a0kk1yz54EMczhut3KjrxQ' 6-max Seat #4 is the button
Seat 1: V3LJvbHVJHmOj2fd7zIDhA ($29.25 in chips) 
Seat 2: nc79pm0LZRdhncq55evVqA ($25 in chips) 
Seat 3: FabaCGPqGJLjRL48CMvjiQ ($23.50 in chips) 
Seat 4: FYepjhAvF8ZdVCmqHIy+eQ ($26.70 in chips) 
Seat 5: cPO/1/dTcZpLkQFm3jH3Rg ($25 in chips) 
Seat 6: DTzxFTXVrCqrpjq9B9Vg/g ($15.35 in chips) 
cPO/1/dTcZpLkQFm3jH3Rg: posts small blind $0.10
DTzxFTXVrCqrpjq9B9Vg/g: posts big blind $0.25
*** HOLE CARDS ***
V3LJvbHVJHmOj2fd7zIDhA: calls $0.25
nc79pm0LZRdhncq55evVqA: folds 
FabaCGPqGJLjRL48CMvjiQ: calls $0.25
FYepjhAvF8ZdVCmqHIy+eQ: folds 
cPO/1/dTcZpLkQFm3jH3Rg: calls $0.15
DTzxFTXVrCqrpjq9B9Vg/g: checks 
*** FLOP *** [8d Tc 2h]
cPO/1/dTcZpLkQFm3jH3Rg: checks 
DTzxFTXVrCqrpjq9B9Vg/g: bets $0.50
V3LJvbHVJHmOj2fd7zIDhA: folds 
FabaCGPqGJLjRL48CMvjiQ: folds 
cPO/1/dTcZpLkQFm3jH3Rg: folds 
Uncalled bet ($0.50) returned to DTzxFTXVrCqrpjq9B9Vg/g
DTzxFTXVrCqrpjq9B9Vg/g collected $0.95 from pot
*** SUMMARY ***
Total pot $1 | Rake $0.05 
Board [8d Tc 2h]
Seat 1: V3LJvbHVJHmOj2fd7zIDhA folded on the Flop
Seat 2: nc79pm0LZRdhncq55evVqA folded before Flop (didn't bet)
Seat 3: FabaCGPqGJLjRL48CMvjiQ folded on the Flop
Seat 4: FYepjhAvF8ZdVCmqHIy+eQ (button) folded before Flop (didn't bet)
Seat 5: cPO/1/dTcZpLkQFm3jH3Rg (small blind) folded on the Flop
Seat 6: DTzxFTXVrCqrpjq9B9Vg/g (big blind) collected ($0.95)




PokerStars Game #59939429094:  Hold'em No Limit ($0.10/$0.25) - 2009/07/01 0:39:38 ET
Table 'P1IJQ2p3ACFySC35W1qwQw' 9-max Seat #2 is the button
Seat 2: E0iYnEVO2ho7dH3QcCjw7g ($20 in chips) 
Seat 3: Ml2bY77EHbM51ZWD7dnIWg ($11.35 in chips) 
Seat 4: LuckyShot



PokerStars Game #59939429028:  Hold'em No Limit ($0.10/$0.25) - 2009/07/01 0:39:38 ET
Table 'BmUMTVcNATeov2rAGYU0Qg' 9-max Seat #6 is the button
Seat 1: v5jnQ1gfh9nLla3kMXG7Yg ($4.75 in chips) 
Seat 2: jJnMGXoBXye+afMd0k0rUw ($11.80 in chips) 
Seat 3: hJ4uYjNmSZdjrKA8cjZqCA ($21.45 in chips) 
Seat 4: aNpwfA31EREwO+ar4XzBCw ($35.85 in chips) 
Seat 5: EBPuArucumZnjWoW71jHBg ($16.80 in chips) 
Seat 6: JxpnpCmvRAcrEUy7mq1iAg ($5.90 in chips) 
Seat 7: zWJ/yHAvi0TtCR9RMsJosQ ($55.70 in chips) 
Seat 8: f/H6PsHRl4W1JyNsEDvPtg ($14.50 in chips) 
Seat 9: ZWU9RNYtjmm4cElg1I0F4w ($57 in chips) 
zWJ/yHAvi0TtCR9RMsJosQ: posts small blind $0.10
f/H6PsHRl4W1JyNsEDvPtg: posts big blind $0.25
*** HOLE CARDS ***
ZWU9RNYtjmm4cElg1I0F4w: raises $0.50 to $0.75
v5jnQ1gfh9nLla3kMXG7Yg: folds 
jJnMGXoBXye+afMd0k0rUw: folds 
hJ4uYjNmSZdjrKA8cjZqCA: calls $0.75
aNpwfA31EREwO+ar4XzBCw: folds 
EBPuArucumZnjWoW71jHBg: calls $0.75
JxpnpCmvRAcrEUy7mq1iAg: folds 
zWJ/yHAvi0TtCR9RMsJosQ: folds 
f/H6PsHRl4W1JyNsEDvPtg: folds 
*** FLOP *** [5s 6h 9h]
ZWU9RNYtjmm4cElg1I0F4w: bets $1.80
hJ4uYjNmSZdjrKA8cjZqCA: calls $1.80
EBPuArucumZnjWoW71jHBg: calls $1.80
*** TURN *** [5s 6h 9h] [Qs]
ZWU9RNYtjmm4cElg1I0F4w: bets $5.35
hJ4uYjNmSZdjrKA8cjZqCA: calls $5.35
EBPuArucumZnjWoW71jHBg: raises $8.90 to $14.25 and is all-in
ZWU9RNYtjmm4cElg1I0F4w: calls $8.90
hJ4uYjNmSZdjrKA8cjZqCA: raises $4.65 to $18.90 and is all-in
ZWU9RNYtjmm4cElg1I0F4w: calls $4.65
*** RIVER *** [5s 6h 9h Qs] [6c]
*** SHOW DOWN ***
ZWU9RNYtjmm4cElg1I0F4w: shows [As Js] (a pair of Sixes)
hJ4uYjNmSZdjrKA8cjZqCA: mucks hand 
ZWU9RNYtjmm4cElg1I0F4w collected $8.85 from side pot
EBPuArucumZnjWoW71jHBg: shows [7d 8h] (a straight, Five to Nine)
EBPuArucumZnjWoW71jHBg collected $48.25 from main pot
*** SUMMARY ***
Total pot $60.05 Main pot $48.25. Side pot $8.85. | Rake $2.95 
Board [5s 6h 9h Qs 6c]
Seat 1: v5jnQ1gfh9nLla3kMXG7Yg folded before Flop (didn't bet)
Seat 2: jJnMGXoBXye+afMd0k0rUw folded before Flop (didn't bet)
Seat 3: hJ4uYjNmSZdjrKA8cjZqCA mucked
Seat 4: aNpwfA31EREwO+ar4XzBCw folded before Flop (didn't bet)
Seat 5: EBPuArucumZnjWoW71jHBg showed [7d 8h] and won ($48.25) with a straight, Five to Nine
Seat 6: JxpnpCmvRAcrEUy7mq1iAg (button) folded before Flop (didn't bet)
Seat 7: zWJ/yHAvi0TtCR9RMsJosQ (small blind) folded before Flop
Seat 8: f/H6PsHRl4W1JyNsEDvPtg (big blind) folded before Flop
Seat 9: ZWU9RNYtjmm4cElg1I0F4w showed [As Js] and won ($8.85) with a pair of Sixes




PokerStars Game #59939429822:  Hold'em No Limit ($0.10/$0.25) - 2009/07/01 0:39:39 ET
Table 'bIGKmJgZehWJ+FAo8b85iw' 9-max Seat #8 is the button
Seat 1: yyG4svzOpC1A+sUP/scg6w ($7.50 in chips) 
Seat 2: Ut3g/kEEdCCbe/gbWrHnDg ($21.50 in chips) 
Seat 3: TeWJxSETzbXGiYKx0y+dtg ($36.40 in chips) 
Seat 4: EJRVVUAJEYLdm1qbO8TzuQ ($10.55 in chips) 
Seat 5: 7wo6Sr7QG3Zo6BaBDV1BOw ($7.15 in chips) 
Seat 6: H5Se03ZqSX7tbULXur2MAg ($21.95 in chips) 
Seat 7: DdPXdieucQ+n99u1n3A+rQ ($9.95 in chips) 
Seat 8: +2kMBNpY4nF1qNCRd8SJLA ($25 in chips) 
Seat 9: aNpwfA31EREwO+ar4XzBCw ($25 in chips) 
aNpwfA31EREwO+ar4XzBCw: posts small blind $0.10
yyG4svzOpC1A+sUP/scg6w: posts big blind $0.25
*** HOLE CARDS ***
Ut3g/kEEdCCbe/gbWrHnDg: calls $0.25
TeWJxSETzbXGiYKx0y+dtg: folds 
EJRVVUAJEYLdm1qbO8TzuQ: folds 
7wo6Sr7QG3Zo6BaBDV1BOw: folds 
H5Se03ZqSX7tbULXur2MAg: folds 
DdPXdieucQ+n99u1n3A+rQ: raises $1 to $1.25
+2kMBNpY4nF1qNCRd8SJLA: folds 
aNpwfA31EREwO+ar4XzBCw: folds 
yyG4svzOpC1A+sUP/scg6w: folds 
Ut3g/kEEdCCbe/gbWrHnDg: calls $1
*** FLOP *** [Jd 6c 4s]
Ut3g/kEEdCCbe/gbWrHnDg: checks 
DdPXdieucQ+n99u1n3A+rQ: bets $1.75
Ut3g/kEEdCCbe/gbWrHnDg: folds 
Uncalled bet ($1.75) returned to DdPXdieucQ+n99u1n3A+rQ
DdPXdieucQ+n99u1n3A+rQ collected $2.75 from pot
DdPXdieucQ+n99u1n3A+rQ: doesn't show hand 
*** SUMMARY ***
Total pot $2.85 | Rake $0.10 
Board [Jd 6c 4s]
Seat 1: yyG4svzOpC1A+sUP/scg6w (big blind) folded before Flop
Seat 2: Ut3g/kEEdCCbe/gbWrHnDg folded on the Flop
Seat 3: TeWJxSETzbXGiYKx0y+dtg folded before Flop (didn't bet)
Seat 4: EJRVVUAJEYLdm1qbO8TzuQ folded before Flop (didn't bet)
Seat 5: 7wo6Sr7QG3Zo6BaBDV1BOw folded before Flop (didn't bet)
Seat 6: H5Se03ZqSX7tbULXur2MAg folded before Flop (didn't bet)
Seat 7: DdPXdieucQ+n99u1n3A+rQ collected ($2.75)
Seat 8: +2kMBNpY4nF1qNCRd8SJLA (button) folded before Flop (didn't bet)
Seat 9: aNpwfA31EREwO+ar4XzBCw (small blind) folded before Flop




PokerStars Game #59939429732:  Hold'em No Limit ($0.10/$0.25) - 2009/07/01 0:39:39 ET
Table 'yZgGBnUGXVCcEJdcqes8tw' 9-max Seat #7 is the button
Seat 1: SXqVW4Q0evTUVZG6BbUNIA ($24.05 in chips) 
Seat 2: MG90wfSJZnOejs/KD3vlQQ ($25 in chips) 
Seat 3: z5GxcHlYz/GSz6W2uFiTtg ($26.65 in chips) 
Seat 4: opOCI2p6kW0tINuVaAqmcQ ($25.70 in chips) 
Seat 5: IGz29GAFM1DpSdXX+wXg3g ($16.10 in chips) 
Seat 6: H9i0g723A2AKb4nSMXqMPQ ($19.95 in chips) 
Seat 7: eC8Pn1D6Y2pct8o62nQfvQ ($28.05 in chips) 
Seat 8: dmYlc+1cjwZMJ7wV+Z0rRg ($24.65 in chips) 
Seat 9: M/9j4wkHH9i1JM51vgi1VA ($31.35 in chips) 
dmYlc+1cjwZMJ7wV+Z0rRg: posts small blind $0.10
M/9j4wkHH9i1JM51vgi1VA: posts big blind $0.25
*** HOLE CARDS ***
SXqVW4Q0evTUVZG6BbUNIA: folds 
MG90wfSJZnOejs/KD3vlQQ: folds 
z5GxcHlYz/GSz6W2uFiTtg: folds 
opOCI2p6kW0tINuVaAqmcQ: folds 
IGz29GAFM1DpSdXX+wXg3g: raises $0.50 to $0.75
H9i0g723A2AKb4nSMXqMPQ: folds 
eC8Pn1D6Y2pct8o62nQfvQ: folds 
dmYlc+1cjwZMJ7wV+Z0rRg: folds 
M/9j4wkHH9i1JM51vgi1VA: calls $0.50
*** FLOP *** [3s 5h Qd]
M/9j4wkHH9i1JM51vgi1VA: checks 
IGz29GAFM1DpSdXX+wXg3g: checks 
*** TURN *** [3s 5h Qd] [Jc]
M/9j4wkHH9i1JM51vgi1VA: checks 
IGz29GAFM1DpSdXX+wXg3g: bets $0.75
M/9j4wkHH9i1JM51vgi1VA: folds 
Uncalled bet ($0.75) returned to IGz29GAFM1DpSdXX+wXg3g
IGz29GAFM1DpSdXX+wXg3g collected $1.55 from pot
*** SUMMARY ***
Total pot $1.60 | Rake $0.05 
Board [3s 5h Qd Jc]
Seat 1: SXqVW4Q0evTUVZG6BbUNIA folded before Flop (didn't bet)
Seat 2: MG90wfSJZnOejs/KD3vlQQ folded before Flop (didn't bet)
Seat 3: z5GxcHlYz/GSz6W2uFiTtg folded before Flop (didn't bet)
Seat 4: opOCI2p6kW0tINuVaAqmcQ folded before Flop (didn't bet)
Seat 5: IGz29GAFM1DpSdXX+wXg3g collected ($1.55)
Seat 6: H9i0g723A2AKb4nSMXqMPQ folded before Flop (didn't bet)
Seat 7: eC8Pn1D6Y2pct8o62nQfvQ (button) folded before Flop (didn't bet)
Seat 8: dmYlc+1cjwZMJ7wV+Z0rRg (small blind) folded before Flop
Seat 9: M/9j4wkHH9i1JM51vgi1VA (big blind) folded on the Turn




PokerStars Game #59939429766:  Hold'em No Limit ($0.10/$0.25) - 2009/07/01 0:39:39 ET
Table 'hg+KpirwreMnBAFQr/SEUA' 9-max Seat #7 is the button
Seat 1: H5Se03ZqSX7tbULXur2MAg ($24.45 in chips) 
Seat 2: OlPJsgR4xypSg/w1z7Gyvw ($18.40 in chips) 
Seat 3: N6fYvIzQLKaydFLKQGtMlQ ($24.65 in chips) 
Seat 4: GGSFATxBXI5pXwoMMI70zg ($5.45 in chips) 
Seat 5: +2kMBNpY4nF1qNCRd8SJLA ($25 in chips) 
Seat 6: dAohy+E9dUFBp6GlYFiOtQ ($24.60 in chips) 
Seat 7: EcWpc/mcsCWBGKsSdZaXbA ($23.45 in chips) 
Seat 8: HPEB+AtKw1+C/cxU0o1ciw ($25.10 in chips) 
HPEB+AtKw1+C/cxU0o1ciw: posts small blind $0.10
Il5IBomZPnY0uD8k+rlPyw: is sitting out 
Il5IBomZPnY0uD8k+rlPyw leaves the table
H5Se03ZqSX7tbULXur2MAg: posts big blind $0.25
*** HOLE CARDS ***
OlPJsgR4xypSg/w1z7Gyvw: folds 
N6fYvIzQLKaydFLKQGtMlQ: folds 
GGSFATxBXI5pXwoMMI70zg: folds 
+2kMBNpY4nF1qNCRd8SJLA: folds 
dAohy+E9dUFBp6GlYFiOtQ: calls $0.25
EcWpc/mcsCWBGKsSdZaXbA: folds 
HPEB+AtKw1+C/cxU0o1ciw: folds 
H5Se03ZqSX7tbULXur2MAg: checks 
*** FLOP *** [2d 5c 5d]
H5Se03ZqSX7tbULXur2MAg: checks 
dAohy+E9dUFBp6GlYFiOtQ: checks 
*** TURN *** [2d 5c 5d] [Ts]
H5Se03ZqSX7tbULXur2MAg: checks 
dAohy+E9dUFBp6GlYFiOtQ: checks 
*** RIVER *** [2d 5c 5d Ts] [4h]
H5Se03ZqSX7tbULXur2MAg: checks 
dAohy+E9dUFBp6GlYFiOtQ: checks 
*** SHOW DOWN ***
H5Se03ZqSX7tbULXur2MAg: shows [3c 9h] (a pair of Fives)
dAohy+E9dUFBp6GlYFiOtQ: shows [Qh 8s] (a pair of Fives - Queen kicker)
dAohy+E9dUFBp6GlYFiOtQ collected $0.60 from pot
*** SUMMARY ***
Total pot $0.60 | Rake $0 
Board [2d 5c 5d Ts 4h]
Seat 1: H5Se03ZqSX7tbULXur2MAg (big blind) showed [3c 9h] and lost with a pair of Fives
Seat 2: OlPJsgR4xypSg/w1z7Gyvw folded before Flop (didn't bet)
Seat 3: N6fYvIzQLKaydFLKQGtMlQ folded before Flop (didn't bet)
Seat 4: GGSFATxBXI5pXwoMMI70zg folded before Flop (didn't bet)
Seat 5: +2kMBNpY4nF1qNCRd8SJLA folded before Flop (didn't bet)
Seat 6: dAohy+E9dUFBp6GlYFiOtQ showed [Qh 8s] and won ($0.60) with a pair of Fives
Seat 7: EcWpc/mcsCWBGKsSdZaXbA (button) folded before Flop (didn't bet)
Seat 8: HPEB+AtKw1+C/cxU0o1ciw (small blind) folded before Flop




PokerStars Game #59939429618:  Hold'em No Limit ($0.10/$0.25) - 2009/07/01 0:39:39 ET
Table 'sIHZ0lzLr4NGCaBUKhmYhA' 6-max Seat #3 is the button
Seat 1: q6WfTUAD9mowIP63ASq2Dg ($34.45 in chips) 
Seat 2: 1xmHIWgZaOCqEMnW2GkFfw ($10.85 in chips) 
Seat 3: SxIIgwXYLkwd6m3wLyPTCw ($25.15 in chips) 
Seat 4: 4YSTu0Cdzpppe1lUgCZGCQ ($33.65 in chips) 
4YSTu0Cdzpppe1lUgCZGCQ: posts small blind $0.10
q6WfTUAD9mowIP63ASq2Dg: posts big blind $0.25
*** HOLE CARDS ***
1xmHIWgZaOCqEMnW2GkFfw: folds 
SxIIgwXYLkwd6m3wLyPTCw: folds 
4YSTu0Cdzpppe1lUgCZGCQ: folds 
Uncalled bet ($0.15) returned to q6WfTUAD9mowIP63ASq2Dg
q6WfTUAD9mowIP63ASq2Dg collected $0.20 from pot
q6WfTUAD9mowIP63ASq2Dg: doesn't show hand 
*** SUMMARY ***
Total pot $0.20 | Rake $0 
Seat 1: q6WfTUAD9mowIP63ASq2Dg (big blind) collected ($0.20)
Seat 2: 1xmHIWgZaOCqEMnW2GkFfw folded before Flop (didn't bet)
Seat 3: SxIIgwXYLkwd6m3wLyPTCw (button) folded before Flop (didn't bet)
Seat 4: 4YSTu0Cdzpppe1lUgCZGCQ (small blind) folded before Flop




PokerStars Game #59939429336:  Hold'em No Limit ($0.10/$0.25) - 2009/07/01 0:39:39 ET
Table 'sgdCtiuCu2BDZhyDi6RzTA' 6-max Seat #5 is the button
Seat 1: 3zD3qLXT1bEffAoWGnc7wg ($25 in chips) 
Seat 2: FONMraB4GCHzDwDcfciKyw ($25 in chips) 
Seat 3: yzFNNFIfC89bBPwpFPx2ow ($15.35 in chips) 
Seat 4: rVKEgilmMX+EkKzDVvhmxA ($8.15 in chips) 
Seat 5: kD/Cb2UM93FAVgDMhEEb5g ($12.50 in chips) 
Seat 6: KODslGU8ikCYS0/29dUkhg ($7.10 in chips) 
KODslGU8ikCYS0/29dUkhg: posts small blind $0.10
3zD3qLXT1bEffAoWGnc7wg: posts big blind $0.25
*** HOLE CARDS ***
FONMraB4GCHzDwDcfciKyw: folds 
yzFNNFIfC89bBPwpFPx2ow: folds 
FONMraB4GCHzDwDcfciKyw leaves the table
rVKEgilmMX+EkKzDVvhmxA: folds 
kD/Cb2UM93FAVgDMhEEb5g: raises $0.25 to $0.50
KODslGU8ikCYS0/29dUkhg: calls $0.40
3zD3qLXT1bEffAoWGnc7wg: folds 
*** FLOP *** [Kc Th 3c]
KODslGU8ikCYS0/29dUkhg: checks 
kD/Cb2UM93FAVgDMhEEb5g: checks 
*** TURN *** [Kc Th 3c] [Kd]
KODslGU8ikCYS0/29dUkhg: checks 
kD/Cb2UM93FAVgDMhEEb5g: bets $0.75
KODslGU8ikCYS0/29dUkhg: calls $0.75
*** RIVER *** [Kc Th 3c Kd] [Qc]
KODslGU8ikCYS0/29dUkhg: checks 
kD/Cb2UM93FAVgDMhEEb5g: bets $1.25
KODslGU8ikCYS0/29dUkhg: raises $2.50 to $3.75
kD/Cb2UM93FAVgDMhEEb5g: folds 
Uncalled bet ($2.50) returned to KODslGU8ikCYS0/29dUkhg
KODslGU8ikCYS0/29dUkhg collected $5 from pot
KODslGU8ikCYS0/29dUkhg: doesn't show hand 
*** SUMMARY ***
Total pot $5.25 | Rake $0.25 
Board [Kc Th 3c Kd Qc]
Seat 1: 3zD3qLXT1bEffAoWGnc7wg (big blind) folded before Flop
Seat 2: FONMraB4GCHzDwDcfciKyw folded before Flop (didn't bet)
Seat 3: yzFNNFIfC89bBPwpFPx2ow folded before Flop (didn't bet)
Seat 4: rVKEgilmMX+EkKzDVvhmxA folded before Flop (didn't bet)
Seat 5: kD/Cb2UM93FAVgDMhEEb5g (button) folded on the River
Seat 6: KODslGU8ikCYS0/29dUkhg (small blind) collected ($5)




PokerStars Game #59939430110:  Hold'em No Limit ($0.10/$0.25) - 2009/07/01 0:39:40 ET
Table '5SUMWYuPsGiOD0FY0QbgOw' 6-max Seat #6 is the button
Seat 1: pq78iqNUnoL9mPwPKXxOzg ($14.40 in chips) 
Seat 2: wKFJ513ucluNNiMlkXcDOQ ($25.30 in chips) 
Seat 3: JUE7yMMP0aN5jzhYbdqO6Q ($27.90 in chips) 
Seat 4: hln5cQA1YXs/ERC2LEyoSA ($8.25 in chips) 
Seat 5: v+QfkGiuj9bgtuNoVnDO8w ($28.70 in chips) 
Seat 6: jA7YMtfNUnAaebB7Lj74EA ($29.85 in chips) 
pq78iqNUnoL9mPwPKXxOzg: posts small blind $0.10
wKFJ513ucluNNiMlkXcDOQ: posts big blind $0.25
*** HOLE CARDS ***
JUE7yMMP0aN5jzhYbdqO6Q: calls $0.25
hln5cQA1YXs/ERC2LEyoSA: raises $0.75 to $1
v+QfkGiuj9bgtuNoVnDO8w: folds 
jA7YMtfNUnAaebB7Lj74EA: folds 
pq78iqNUnoL9mPwPKXxOzg: folds 
wKFJ513ucluNNiMlkXcDOQ: folds 
JUE7yMMP0aN5jzhYbdqO6Q: raises $1.25 to $2.25
hln5cQA1YXs/ERC2LEyoSA: calls $1.25
*** FLOP *** [Tc Qs 6d]
JUE7yMMP0aN5jzhYbdqO6Q: bets $4.50
hln5cQA1YXs/ERC2LEyoSA: folds 
Uncalled bet ($4.50) returned to JUE7yMMP0aN5jzhYbdqO6Q
JUE7yMMP0aN5jzhYbdqO6Q collected $4.65 from pot
JUE7yMMP0aN5jzhYbdqO6Q: doesn't show hand 
*** SUMMARY ***
Total pot $4.85 | Rake $0.20 
Board [Tc Qs 6d]
Seat 1: pq78iqNUnoL9mPwPKXxOzg (small blind) folded before Flop
Seat 2: wKFJ513ucluNNiMlkXcDOQ (big blind) folded before Flop
Seat 3: JUE7yMMP0aN5jzhYbdqO6Q collected ($4.65)
Seat 4: hln5cQA1YXs/ERC2LEyoSA folded on the Flop
Seat 5: v+QfkGiuj9bgtuNoVnDO8w folded before Flop (didn't bet)
Seat 6: jA7YMtfNUnAaebB7Lj74EA (button) folded before Flop (didn't bet)




PokerStars Game #59939429858:  Hold'em No Limit ($0.10/$0.25) - 2009/07/01 0:39:40 ET
Table 'DhkrdW2UOy2PfjSW28Kq8w' 6-max Seat #4 is the button
Seat 1: vu2kzHaDtgr6NM7rdq0chA ($25 in chips) 
Seat 2: v+QfkGiuj9bgtuNoVnDO8w ($25 in chips) 
Seat 3: 66a/8+qw1AZLNh63FuclPA ($43.80 in chips) 
Seat 4: I1TxPvWj8NfG8orglCinNA ($27.05 in chips) 
Seat 5: SxIIgwXYLkwd6m3wLyPTCw ($47.60 in chips) 
Seat 6: SS/yfeArhULzIcOPe8MdPg ($25.85 in chips) 
SxIIgwXYLkwd6m3wLyPTCw: posts small blind $0.10
SS/yfeArhULzIcOPe8MdPg: posts big blind $0.25
*** HOLE CARDS ***
vu2kzHaDtgr6NM7rdq0chA: folds 
v+QfkGiuj9bgtuNoVnDO8w: folds 
66a/8+qw1AZLNh63FuclPA: folds 
I1TxPvWj8NfG8orglCinNA: raises $0.75 to $1
SxIIgwXYLkwd6m3wLyPTCw: folds 
SS/yfeArhULzIcOPe8MdPg: folds 
Uncalled bet ($0.75) returned to I1TxPvWj8NfG8orglCinNA
I1TxPvWj8NfG8orglCinNA collected $0.60 from pot
I1TxPvWj8NfG8orglCinNA: doesn't show hand 
*** SUMMARY ***
Total pot $0.60 | Rake $0 
Seat 1: vu2kzHaDtgr6NM7rdq0chA folded before Flop (didn't bet)
Seat 2: v+QfkGiuj9bgtuNoVnDO8w folded before Flop (didn't bet)
Seat 3: 66a/8+qw1AZLNh63FuclPA folded before Flop (didn't bet)
Seat 4: I1TxPvWj8NfG8orglCinNA (button) collected ($0.60)
Seat 5: SxIIgwXYLkwd6m3wLyPTCw (small blind) folded before Flop
Seat 6: SS/yfeArhULzIcOPe8MdPg (big blind) folded before Flop




PokerStars Game #59939430150:  Hold'em No Limit ($0.10/$0.25) - 2009/07/01 0:39:40 ET
Table '9o8Yb3JpUqurD4pNVmOikQ' 6-max Seat #1 is the button
Seat 1: 5tB0F9NjPSUL4FzmzBMs2Q ($25 in chips) 
Seat 2: /gJNBeCkWL4o85/jvlZ4BA ($25.10 in chips) 
Seat 3: JgRqo1/2phbf7pab7N3BIQ ($8.85 in chips) 
Seat 4: YaAEMJGY5tem39deCUQRNw ($41.30 in chips) 
Seat 5: q9qPRjJC40e/Q9yuT+glwQ ($33.80 in chips) 
Seat 6: k9vn40MOqqb+xF+7GZ6v2g ($35.15 in chips) 
/gJNBeCkWL4o85/jvlZ4BA: posts small blind $0.10
JgRqo1/2phbf7pab7N3BIQ: posts big blind $0.25
*** HOLE CARDS ***
YaAEMJGY5tem39deCUQRNw: folds 
q9qPRjJC40e/Q9yuT+glwQ: raises $1 to $1.25
k9vn40MOqqb+xF+7GZ6v2g: folds 
5tB0F9NjPSUL4FzmzBMs2Q: folds 
/gJNBeCkWL4o85/jvlZ4BA: folds 
JgRqo1/2phbf7pab7N3BIQ: calls $1
*** FLOP *** [Tc 7d 9h]
JgRqo1/2phbf7pab7N3BIQ: checks 
q9qPRjJC40e/Q9yuT+glwQ: bets $2
JgRqo1/2phbf7pab7N3BIQ: folds 
Uncalled bet ($2) returned to q9qPRjJC40e/Q9yuT+glwQ
q9qPRjJC40e/Q9yuT+glwQ collected $2.50 from pot
q9qPRjJC40e/Q9yuT+glwQ: doesn't show hand 
*** SUMMARY ***
Total pot $2.60 | Rake $0.10 
Board [Tc 7d 9h]
Seat 1: 5tB0F9NjPSUL4FzmzBMs2Q (button) folded before Flop (didn't bet)
Seat 2: /gJNBeCkWL4o85/jvlZ4BA (small blind) folded before Flop
Seat 3: JgRqo1/2phbf7pab7N3BIQ (big blind) folded on the Flop
Seat 4: YaAEMJGY5tem39deCUQRNw folded before Flop (didn't bet)
Seat 5: q9qPRjJC40e/Q9yuT+glwQ collected ($2.50)
Seat 6: k9vn40MOqqb+xF+7GZ6v2g folded before Flop (didn't bet)




PokerStars Game #59939430230:  Hold'em No Limit ($0.10/$0.25) - 2009/07/01 0:39:40 ET
Table 'LwnjzXstPtSrqrV/oDpnXQ' 9-max Seat #2 is the button
Seat 1: sChhj/mp8dm+nGvBS5mOIA ($19.10 in chips) 
Seat 2: K7bAhhMMJ/XcTmGaBZVfFQ ($28.35 in chips) 
Seat 3: u+XLsbPQIcRvPRnS1bvZww ($11.10 in chips) 
Seat 4: nmvbguGv4wKulGg49bANbQ ($13.75 in chips) 
Seat 6: ljemhp25Zg+nlA9DLCIiUw ($31.40 in chips) 
Seat 8: h4ggJZYBXV0mEZzYPYKfeA ($32.80 in chips) 
Seat 9: N6fYvIzQLKaydFLKQGtMlQ ($24.40 in chips) 
u+XLsbPQIcRvPRnS1bvZww: posts small blind $0.10
nmvbguGv4wKulGg49bANbQ: posts big blind $0.25
Th3FldXKQW6hWVVPahaoOQ: sits out 
*** HOLE CARDS ***
ljemhp25Zg+nlA9DLCIiUw: folds 
h4ggJZYBXV0mEZzYPYKfeA: folds 
N6fYvIzQLKaydFLKQGtMlQ: folds 
sChhj/mp8dm+nGvBS5mOIA: folds 
K7bAhhMMJ/XcTmGaBZVfFQ: folds 
u+XLsbPQIcRvPRnS1bvZww: calls $0.15
joluis9 joins the table at seat #7 
nmvbguGv4wKulGg49bANbQ: checks 
*** FLOP *** [8c 2s 2c]
u+XLsbPQIcRvPRnS1bvZww: bets $0.25
nmvbguGv4wKulGg49bANbQ: folds 
Uncalled bet ($0.25) returned to u+XLsbPQIcRvPRnS1bvZww
u+XLsbPQIcRvPRnS1bvZww collected $0.50 from pot
u+XLsbPQIcRvPRnS1bvZww: doesn't show hand 
*** SUMMARY ***
Total pot $0.50 | Rake $0 
Board [8c 2s 2c]
Seat 1: sChhj/mp8dm+nGvBS5mOIA folded before Flop (didn't bet)
Seat 2: K7bAhhMMJ/XcTmGaBZVfFQ (button) folded before Flop (didn't bet)
Seat 3: u+XLsbPQIcRvPRnS1bvZww (small blind) collected ($0.50)
Seat 4: nmvbguGv4wKulGg49bANbQ (big blind) folded on the Flop
Seat 6: ljemhp25Zg+nlA9DLCIiUw folded before Flop (didn't bet)
Seat 8: h4ggJZYBXV0mEZzYPYKfeA folded before Flop (didn't bet)
Seat 9: N6fYvIzQLKaydFLKQGtMlQ folded before Flop (didn't bet)




PokerStars Game #59939429900:  Hold'em No Limit ($0.10/$0.25) - 2009/07/01 0:39:40 ET
Table 'Loy/olZ5qoDOSvX4UTujGg' 6-max Seat #1 is the button
Seat 1: yzFNNFIfC89bBPwpFPx2ow ($28.50 in chips) 
Seat 3: 32YL2ZEp8NT4JB2RVM9euQ ($15.75 in chips) 
Seat 4: /gJNBeCkWL4o85/jvlZ4BA ($27.45 in chips) 
Seat 5: 4YSTu0Cdzpppe1lUgCZGCQ ($35.15 in chips) 
Seat 6: 7FmwVDcdEtxDpHmP4hOXsQ ($52.70 in chips) 
32YL2ZEp8NT4JB2RVM9euQ: posts small blind $0.10
/gJNBeCkWL4o85/jvlZ4BA: posts big blind $0.25
*** HOLE CARDS ***
4YSTu0Cdzpppe1lUgCZGCQ: raises $0.75 to $1
7FmwVDcdEtxDpHmP4hOXsQ: folds 
yzFNNFIfC89bBPwpFPx2ow: folds 
32YL2ZEp8NT4JB2RVM9euQ: folds 
/gJNBeCkWL4o85/jvlZ4BA: folds 
Uncalled bet ($0.75) returned to 4YSTu0Cdzpppe1lUgCZGCQ
4YSTu0Cdzpppe1lUgCZGCQ collected $0.60 from pot
4YSTu0Cdzpppe1lUgCZGCQ: doesn't show hand 
*** SUMMARY ***
Total pot $0.60 | Rake $0 
Seat 1: yzFNNFIfC89bBPwpFPx2ow (button) folded before Flop (didn't bet)
Seat 3: 32YL2ZEp8NT4JB2RVM9euQ (small blind) folded before Flop
Seat 4: /gJNBeCkWL4o85/jvlZ4BA (big blind) folded before Flop
Seat 5: 4YSTu0Cdzpppe1lUgCZGCQ collected ($0.60)
Seat 6: 7FmwVDcdEtxDpHmP4hOXsQ folded before Flop (didn't bet)




PokerStars Game #59939430330:  Hold'em No Limit ($0.10/$0.25) - 2009/07/01 0:39:40 ET
Table 'isKy4XK8wJM0x735/D4hWA' 6-max Seat #6 is the button
Seat 1: 7FmwVDcdEtxDpHmP4hOXsQ ($25.95 in chips) 
Seat 2: WrLI51S2iMb8GLMB83gGqA ($25 in chips) 
Seat 5: zlYHXTtJ5tcx9kwK2h5n9A ($37.40 in chips) 
Seat 6: M6xK/VklCvdyyrmvzATlxQ ($13.75 in chips) 
7FmwVDcdEtxDpHmP4hOXsQ: posts small blind $0.10
WrLI51S2iMb8GLMB83gGqA: posts big blind $0.25
*** HOLE CARDS ***
zlYHXTtJ5tcx9kwK2h5n9A: folds 
M6xK/VklCvdyyrmvzATlxQ: folds 
7FmwVDcdEtxDpHmP4hOXsQ: raises $0.50 to $0.75
WrLI51S2iMb8GLMB83gGqA: raises $2.50 to $3.25
7FmwVDcdEtxDpHmP4hOXsQ: folds 
Uncalled bet ($2.50) returned to WrLI51S2iMb8GLMB83gGqA
k9vn40MOqqb+xF+7GZ6v2g joins the table at seat #4 
WrLI51S2iMb8GLMB83gGqA collected $1.50 from pot
WrLI51S2iMb8GLMB83gGqA: doesn't show hand 
*** SUMMARY ***
Total pot $1.50 | Rake $0 
Seat 1: 7FmwVDcdEtxDpHmP4hOXsQ (small blind) folded before Flop
Seat 2: WrLI51S2iMb8GLMB83gGqA (big blind) collected ($1.50)
Seat 5: zlYHXTtJ5tcx9kwK2h5n9A folded before Flop (didn't bet)
Seat 6: M6xK/VklCvdyyrmvzATlxQ (button) folded before Flop (didn't bet)




PokerStars Game #59939431140:  Hold'em No Limit ($0.10/$0.25) - 2009/07/01 0:39:41 ET
Table '8kaMIn+aON/ferW89Go6Pw' 9-max Seat #6 is the button
Seat 1: st9jtdNbm1W5GfBwRaCVqQ ($23.85 in chips) 
Seat 2: jeKWRUkMaVn8rEUjnJKqpg ($25 in chips) 
Seat 3: 7cv+9Zc9HIQHNvYsMfV3uA ($27.95 in chips) 
Seat 4: KRWTiGM4xH+MkvPtJz4+SA ($47.90 in chips) 
Seat 5: hIss79a4pu7GzJZepfgOpg ($31.35 in chips) 
Seat 6: 1S/fpm+f42V/6MNZre+ccg ($25 in chips) 
Seat 7: HVKi9hnDyvzObpL08/OarQ ($22 in chips) 
Seat 8: f7p49X29YgYZCOxWxJo6Lw ($10 in chips) 
Seat 9: DiSvPC2iudwL5j9u6Huyww ($25.35 in chips) 
HVKi9hnDyvzObpL08/OarQ: posts small blind $0.10
f7p49X29YgYZCOxWxJo6Lw: posts big blind $0.25
*** HOLE CARDS ***
DiSvPC2iudwL5j9u6Huyww: folds 
st9jtdNbm1W5GfBwRaCVqQ: raises $0.75 to $1
jeKWRUkMaVn8rEUjnJKqpg: folds 
7cv+9Zc9HIQHNvYsMfV3uA: folds 
KRWTiGM4xH+MkvPtJz4+SA: calls $1
hIss79a4pu7GzJZepfgOpg: folds 
1S/fpm+f42V/6MNZre+ccg: folds 
HVKi9hnDyvzObpL08/OarQ: folds 
f7p49X29YgYZCOxWxJo6Lw: calls $0.75
*** FLOP *** [As Th Tc]
f7p49X29YgYZCOxWxJo6Lw: checks 
st9jtdNbm1W5GfBwRaCVqQ: bets $2.20
KRWTiGM4xH+MkvPtJz4+SA: calls $2.20
f7p49X29YgYZCOxWxJo6Lw: calls $2.20
*** TURN *** [As Th Tc] [Jd]
f7p49X29YgYZCOxWxJo6Lw: checks 
st9jtdNbm1W5GfBwRaCVqQ: checks 
KRWTiGM4xH+MkvPtJz4+SA: checks 
*** RIVER *** [As Th Tc Jd] [Qd]
f7p49X29YgYZCOxWxJo6Lw: checks 
st9jtdNbm1W5GfBwRaCVqQ: bets $5
KRWTiGM4xH+MkvPtJz4+SA: folds 
f7p49X29YgYZCOxWxJo6Lw said, "kk"
f7p49X29YgYZCOxWxJo6Lw: folds 
Uncalled bet ($5) returned to st9jtdNbm1W5GfBwRaCVqQ
st9jtdNbm1W5GfBwRaCVqQ collected $9.25 from pot
st9jtdNbm1W5GfBwRaCVqQ: doesn't show hand 
*** SUMMARY ***
Total pot $9.70 | Rake $0.45 
Board [As Th Tc Jd Qd]
Seat 1: st9jtdNbm1W5GfBwRaCVqQ collected ($9.25)
Seat 2: jeKWRUkMaVn8rEUjnJKqpg folded before Flop (didn't bet)
Seat 3: 7cv+9Zc9HIQHNvYsMfV3uA folded before Flop (didn't bet)
Seat 4: KRWTiGM4xH+MkvPtJz4+SA folded on the River
Seat 5: hIss79a4pu7GzJZepfgOpg folded before Flop (didn't bet)
Seat 6: 1S/fpm+f42V/6MNZre+ccg (button) folded before Flop (didn't bet)
Seat 7: HVKi9hnDyvzObpL08/OarQ (small blind) folded before Flop
Seat 8: f7p49X29YgYZCOxWxJo6Lw (big blind) folded on the River
Seat 9: DiSvPC2iudwL5j9u6Huyww folded before Flop (didn't bet)




PokerStars Game #59939430754:  Hold'em No Limit ($0.10/$0.25) - 2009/07/01 0:39:41 ET
Table 'sSe6q4YTb/iS19t2eCFdsA' 9-max Seat #4 is the button
Seat 1: 5z3YkZTfH2GjoLK+6X7z2w ($11.55 in chips) 
Seat 2: rUpvA02nErFvZ4yFbDR8XA ($28.10 in chips) 
Seat 3: hBMUlEpyU74r/fwDgIpXjQ ($26.20 in chips) 
Seat 4: SXqVW4Q0evTUVZG6BbUNIA ($15.85 in chips) 
Seat 5: qS+jfnNoG75bT+uQ8CKhQA ($10.15 in chips) 
Seat 6: tYsOBqdU1+x+yFI7zHO7hQ ($26.40 in chips) 
Seat 7: t70KGeRtR3naHSqKDixsUg ($14.05 in chips) 
Seat 8: jeKWRUkMaVn8rEUjnJKqpg ($27.40 in chips) 
Seat 9: 4oA316mXLIui1QY63GXBUg ($25.60 in chips) 
qS+jfnNoG75bT+uQ8CKhQA: posts small blind $0.10
tYsOBqdU1+x+yFI7zHO7hQ: posts big blind $0.25
*** HOLE CARDS ***
t70KGeRtR3naHSqKDixsUg: calls $0.25
jeKWRUkMaVn8rEUjnJKqpg: folds 
4oA316mXLIui1QY63GXBUg: folds 
5z3YkZTfH2GjoLK+6X7z2w: folds 
rUpvA02nErFvZ4yFbDR8XA: folds 
hBMUlEpyU74r/fwDgIpXjQ: folds 
SXqVW4Q0evTUVZG6BbUNIA: folds 
qS+jfnNoG75bT+uQ8CKhQA: calls $0.15
tYsOBqdU1+x+yFI7zHO7hQ: checks 
*** FLOP *** [8h Qs Js]
qS+jfnNoG75bT+uQ8CKhQA: checks 
tYsOBqdU1+x+yFI7zHO7hQ: checks 
t70KGeRtR3naHSqKDixsUg: checks 
*** TURN *** [8h Qs Js] [8s]
qS+jfnNoG75bT+uQ8CKhQA: checks 
tYsOBqdU1+x+yFI7zHO7hQ: checks 
t70KGeRtR3naHSqKDixsUg: checks 
*** RIVER *** [8h Qs Js 8s] [8d]
qS+jfnNoG75bT+uQ8CKhQA: checks 
tYsOBqdU1+x+yFI7zHO7hQ: checks 
t70KGeRtR3naHSqKDixsUg: checks 
*** SHOW DOWN ***
qS+jfnNoG75bT+uQ8CKhQA: shows [Tc Ac] (three of a kind, Eights)
tYsOBqdU1+x+yFI7zHO7hQ: mucks hand 
t70KGeRtR3naHSqKDixsUg: mucks hand 
qS+jfnNoG75bT+uQ8CKhQA collected $0.75 from pot
*** SUMMARY ***
Total pot $0.75 | Rake $0 
Board [8h Qs Js 8s 8d]
Seat 1: 5z3YkZTfH2GjoLK+6X7z2w folded before Flop (didn't bet)
Seat 2: rUpvA02nErFvZ4yFbDR8XA folded before Flop (didn't bet)
Seat 3: hBMUlEpyU74r/fwDgIpXjQ folded before Flop (didn't bet)
Seat 4: SXqVW4Q0evTUVZG6BbUNIA (button) folded before Flop (didn't bet)
Seat 5: qS+jfnNoG75bT+uQ8CKhQA (small blind) showed [Tc Ac] and won ($0.75) with three of a kind, Eights
Seat 6: tYsOBqdU1+x+yFI7zHO7hQ (big blind) mucked
Seat 7: t70KGeRtR3naHSqKDixsUg mucked
Seat 8: jeKWRUkMaVn8rEUjnJKqpg folded before Flop (didn't bet)
Seat 9: 4oA316mXLIui1QY63GXBUg folded before Flop (didn't bet)




PokerStars Game #59939430812:  Hold'em No Limit ($0.10/$0.25) - 2009/07/01 0:39:41 ET
Table 'VuY5ej47Cy8nOI3Wogmhzw' 6-max Seat #3 is the button
Seat 3: 0n9nsjvz4GIG4IyVHT0JVw ($5.25 in chips) 
Seat 4: FC6tJ9EOiutXO8hnpR4VgQ ($4.40 in chips) 
Seat 6: +v0nBUereMsRzYp2Knh/cQ ($10.20 in chips) 
FC6tJ9EOiutXO8hnpR4VgQ: posts small blind $0.10
+v0nBUereMsRzYp2Knh/cQ: posts big blind $0.25
*** HOLE CARDS ***
0n9nsjvz4GIG4IyVHT0JVw: raises $0.50 to $0.75
FC6tJ9EOiutXO8hnpR4VgQ: folds 
+v0nBUereMsRzYp2Knh/cQ: calls $0.50
*** FLOP *** [Jh 9s Td]
+v0nBUereMsRzYp2Knh/cQ: bets $0.75
0n9nsjvz4GIG4IyVHT0JVw: calls $0.75
*** TURN *** [Jh 9s Td] [Ks]
+v0nBUereMsRzYp2Knh/cQ: bets $1
0n9nsjvz4GIG4IyVHT0JVw: calls $1
*** RIVER *** [Jh 9s Td Ks] [2h]
+v0nBUereMsRzYp2Knh/cQ: bets $1.50
0n9nsjvz4GIG4IyVHT0JVw: folds 
Uncalled bet ($1.50) returned to +v0nBUereMsRzYp2Knh/cQ
+v0nBUereMsRzYp2Knh/cQ collected $4.90 from pot
+v0nBUereMsRzYp2Knh/cQ: doesn't show hand 
*** SUMMARY ***
Total pot $5.10 | Rake $0.20 
Board [Jh 9s Td Ks 2h]
Seat 3: 0n9nsjvz4GIG4IyVHT0JVw (button) folded on the River
Seat 4: FC6tJ9EOiutXO8hnpR4VgQ (small blind) folded before Flop
Seat 6: +v0nBUereMsRzYp2Knh/cQ (big blind) collected ($4.90)




PokerStars Game #59939430808:  Hold'em No Limit ($0.10/$0.25) - 2009/07/01 0:39:41 ET
Table 'pPgW4R3kdH26lLi1MnE92w' 9-max Seat #8 is the button
Seat 1: dPWIrImjP1yFagoUVDKR0Q ($8.65 in chips) 
Seat 2: cZ99hugmLBj9KhTlc8nCSw ($28.60 in chips) 
Seat 3: og+56SuM1LUF/5l/Qtaw4Q ($11.80 in chips) 
Seat 4: hBMUlEpyU74r/fwDgIpXjQ ($31.15 in chips) 
Seat 5: HPEB+AtKw1+C/cxU0o1ciw ($34.35 in chips) 
Seat 8: aCVg6cCxQcqClhB9nq/p1w ($19.25 in chips) 
Seat 9: tcbEu7VzyHQ+0lh+skbQhQ ($18.25 in chips) 
tcbEu7VzyHQ+0lh+skbQhQ: posts small blind $0.10
dPWIrImjP1yFagoUVDKR0Q: posts big blind $0.25
sD+TKtt36XiiN6jqHiLwDA: sits out 
*** HOLE CARDS ***
VllYilcih0t+gMD4GTRlgQ joins the table at seat #6 
cZ99hugmLBj9KhTlc8nCSw: folds 
og+56SuM1LUF/5l/Qtaw4Q: raises $0.50 to $0.75
hBMUlEpyU74r/fwDgIpXjQ: folds 
HPEB+AtKw1+C/cxU0o1ciw: folds 
aCVg6cCxQcqClhB9nq/p1w: folds 
tcbEu7VzyHQ+0lh+skbQhQ: folds 
dPWIrImjP1yFagoUVDKR0Q: calls $0.50
*** FLOP *** [9s 8h Qs]
dPWIrImjP1yFagoUVDKR0Q: bets $0.75
og+56SuM1LUF/5l/Qtaw4Q: calls $0.75
*** TURN *** [9s 8h Qs] [7c]
dPWIrImjP1yFagoUVDKR0Q: bets $0.75
og+56SuM1LUF/5l/Qtaw4Q: raises $0.75 to $1.50
dPWIrImjP1yFagoUVDKR0Q: calls $0.75
*** RIVER *** [9s 8h Qs 7c] [7s]
dPWIrImjP1yFagoUVDKR0Q: bets $0.75
og+56SuM1LUF/5l/Qtaw4Q: folds 
Uncalled bet ($0.75) returned to dPWIrImjP1yFagoUVDKR0Q
dPWIrImjP1yFagoUVDKR0Q collected $5.85 from pot
dPWIrImjP1yFagoUVDKR0Q: doesn't show hand 
*** SUMMARY ***
Total pot $6.10 | Rake $0.25 
Board [9s 8h Qs 7c 7s]
Seat 1: dPWIrImjP1yFagoUVDKR0Q (big blind) collected ($5.85)
Seat 2: cZ99hugmLBj9KhTlc8nCSw folded before Flop (didn't bet)
Seat 3: og+56SuM1LUF/5l/Qtaw4Q folded on the River
Seat 4: hBMUlEpyU74r/fwDgIpXjQ folded before Flop (didn't bet)
Seat 5: HPEB+AtKw1+C/cxU0o1ciw folded before Flop (didn't bet)
Seat 8: aCVg6cCxQcqClhB9nq/p1w (button) folded before Flop (didn't bet)
Seat 9: tcbEu7VzyHQ+0lh+skbQhQ (small blind) folded before Flop




PokerStars Game #59939430610:  Hold'em No Limit ($0.10/$0.25) - 2009/07/01 0:39:41 ET
Table 'U0hCzoS0KCJL+eoE054K4Q' 9-max Seat #9 is the button
Seat 2: MG90wfSJZnOejs/KD3vlQQ ($25 in chips) 
Seat 3: u/r4MjA69AbvOh1qLp6Eig ($15 in chips) 
Seat 4: REZJH+hR80RwfrJtUNUJOw ($28.70 in chips) 
Seat 5: gN5V9qraLHmhKzjLHzt7qA ($15.85 in chips) 
Seat 7: NNZypfH1f/VIj3Skf/XIzg ($5 in chips) 
Seat 8: Xpyqpb+DURDWnyJ3xTEIFQ ($26.80 in chips) 
Seat 9: X9HkgGdfFul8DB9rhTbyFw ($37.35 in chips) 
CYkY0dNBaYaKs8HVCVn3mQ will be allowed to play after the button
MG90wfSJZnOejs/KD3vlQQ: posts small blind $0.10
u/r4MjA69AbvOh1qLp6Eig: posts big blind $0.25
*** HOLE CARDS ***
REZJH+hR80RwfrJtUNUJOw: raises $0.25 to $0.50
gN5V9qraLHmhKzjLHzt7qA: folds 
NNZypfH1f/VIj3Skf/XIzg: folds 
Xpyqpb+DURDWnyJ3xTEIFQ: folds 
X9HkgGdfFul8DB9rhTbyFw: folds 
MG90wfSJZnOejs/KD3vlQQ: folds 
u/r4MjA69AbvOh1qLp6Eig: folds 
Uncalled bet ($0.25) returned to REZJH+hR80RwfrJtUNUJOw
REZJH+hR80RwfrJtUNUJOw collected $0.60 from pot
REZJH+hR80RwfrJtUNUJOw: doesn't show hand 
*** SUMMARY ***
Total pot $0.60 | Rake $0 
Seat 2: MG90wfSJZnOejs/KD3vlQQ (small blind) folded before Flop
Seat 3: u/r4MjA69AbvOh1qLp6Eig (big blind) folded before Flop
Seat 4: REZJH+hR80RwfrJtUNUJOw collected ($0.60)
Seat 5: gN5V9qraLHmhKzjLHzt7qA folded before Flop (didn't bet)
Seat 7: NNZypfH1f/VIj3Skf/XIzg folded before Flop (didn't bet)
Seat 8: Xpyqpb+DURDWnyJ3xTEIFQ folded before Flop (didn't bet)
Seat 9: X9HkgGdfFul8DB9rhTbyFw (button) folded before Flop (didn't bet)




PokerStars Game #59939431826:  Hold'em No Limit ($0.10/$0.25) - 2009/07/01 0:39:42 ET
Table 'ER5H84HUgJx7HyDLnELLeA' 6-max Seat #3 is the button
Seat 1: pjM/xh4+RG8zrxCobDgYDg ($15.85 in chips) 
Seat 2: nc79pm0LZRdhncq55evVqA ($48.50 in chips) 
Seat 3: 2j+7KACUO5iqZ/NSvIH3vg ($6.05 in chips) 
Seat 4: tkRWn3WaJIfGmCXT2hPvJA ($18.65 in chips) 
Seat 5: mfrkWA3PTeYPkbO6hi98Aw ($23.40 in chips) 
tkRWn3WaJIfGmCXT2hPvJA: posts small blind $0.10
mfrkWA3PTeYPkbO6hi98Aw: posts big blind $0.25
3zD3qLXT1bEffAoWGnc7wg: sits out 
*** HOLE CARDS ***
pjM/xh4+RG8zrxCobDgYDg: folds 
nc79pm0LZRdhncq55evVqA: folds 
2j+7KACUO5iqZ/NSvIH3vg: folds 
tkRWn3WaJIfGmCXT2hPvJA: calls $0.15
mfrkWA3PTeYPkbO6hi98Aw: checks 
*** FLOP *** [2d Ts 2c]
tkRWn3WaJIfGmCXT2hPvJA: checks 
mfrkWA3PTeYPkbO6hi98Aw: checks 
*** TURN *** [2d Ts 2c] [Qh]
tkRWn3WaJIfGmCXT2hPvJA: checks 
mfrkWA3PTeYPkbO6hi98Aw: checks 
*** RIVER *** [2d Ts 2c Qh] [2s]
tkRWn3WaJIfGmCXT2hPvJA: bets $0.25
mfrkWA3PTeYPkbO6hi98Aw: folds 
Uncalled bet ($0.25) returned to tkRWn3WaJIfGmCXT2hPvJA
tkRWn3WaJIfGmCXT2hPvJA collected $0.50 from pot
*** SUMMARY ***
Total pot $0.50 | Rake $0 
Board [2d Ts 2c Qh 2s]
Seat 1: pjM/xh4+RG8zrxCobDgYDg folded before Flop (didn't bet)
Seat 2: nc79pm0LZRdhncq55evVqA folded before Flop (didn't bet)
Seat 3: 2j+7KACUO5iqZ/NSvIH3vg (button) folded before Flop (didn't bet)
Seat 4: tkRWn3WaJIfGmCXT2hPvJA (small blind) collected ($0.50)
Seat 5: mfrkWA3PTeYPkbO6hi98Aw (big blind) folded on the River




PokerStars Game #59939431720:  Hold'em No Limit ($0.10/$0.25) - 2009/07/01 0:39:42 ET
Table 'fIMYcWwN4/aXFJvH5Z8Ymg' 6-max Seat #2 is the button
Seat 1: 64ZeDpsBsP594VsWmafRTQ ($17.20 in chips) 
Seat 2: vu2kzHaDtgr6NM7rdq0chA ($25.45 in chips) 
Seat 3: bWbV4MVB/vVpiES1Ut4hew ($46 in chips) 
Seat 4: 32YL2ZEp8NT4JB2RVM9euQ ($40.40 in chips) 
Seat 5: 9jSiy0meE9XJKkdIZwyTEQ ($29.75 in chips) 
bWbV4MVB/vVpiES1Ut4hew: posts small blind $0.10
32YL2ZEp8NT4JB2RVM9euQ: posts big blind $0.25
Parks Playa: sits out 
*** HOLE CARDS ***
9jSiy0meE9XJKkdIZwyTEQ: folds 
64ZeDpsBsP594VsWmafRTQ: raises $0.50 to $0.75
vu2kzHaDtgr6NM7rdq0chA: folds 
bWbV4MVB/vVpiES1Ut4hew: calls $0.65
32YL2ZEp8NT4JB2RVM9euQ: folds 
*** FLOP *** [Ad Jd 9s]
bWbV4MVB/vVpiES1Ut4hew: checks 
64ZeDpsBsP594VsWmafRTQ: bets $1.25
bWbV4MVB/vVpiES1Ut4hew: calls $1.25
*** TURN *** [Ad Jd 9s] [2s]
bWbV4MVB/vVpiES1Ut4hew: checks 
64ZeDpsBsP594VsWmafRTQ: bets $3
bWbV4MVB/vVpiES1Ut4hew: calls $3
*** RIVER *** [Ad Jd 9s 2s] [Ks]
bWbV4MVB/vVpiES1Ut4hew: bets $24.25
64ZeDpsBsP594VsWmafRTQ: folds 
Uncalled bet ($24.25) returned to bWbV4MVB/vVpiES1Ut4hew
bWbV4MVB/vVpiES1Ut4hew collected $9.75 from pot
bWbV4MVB/vVpiES1Ut4hew: doesn't show hand 
*** SUMMARY ***
Total pot $10.25 | Rake $0.50 
Board [Ad Jd 9s 2s Ks]
Seat 1: 64ZeDpsBsP594VsWmafRTQ folded on the River
Seat 2: vu2kzHaDtgr6NM7rdq0chA (button) folded before Flop (didn't bet)
Seat 3: bWbV4MVB/vVpiES1Ut4hew (small blind) collected ($9.75)
Seat 4: 32YL2ZEp8NT4JB2RVM9euQ (big blind) folded before Flop
Seat 5: 9jSiy0meE9XJKkdIZwyTEQ folded before Flop (didn't bet)




PokerStars Game #59939431862:  Hold'em No Limit ($0.10/$0.25) - 2009/07/01 0:39:42 ET
Table '9iHhO6FyZVM8XpSc23TIgg' 6-max Seat #2 is the button
Seat 1: NhUN/JpAprdJeamFBgJH1w ($25 in chips) 
Seat 2: ErIN0JRL5srYjT6en1f8YQ ($32.05 in chips) 
Seat 3: EXTSABh+qTpWWrIkxl3wXg ($43.75 in chips) 
Seat 4: cfJccEfyn6IkquPN08hFsA ($33.55 in chips) 
Seat 5: WmfI+HZXhME/HMG8E3/H2w ($14 in chips) 
Seat 6: 5z4PIVM9IyDWfUi+/MMdTA ($17.50 in chips) 
EXTSABh+qTpWWrIkxl3wXg: posts small blind $0.10
cfJccEfyn6IkquPN08hFsA: posts big blind $0.25
*** HOLE CARDS ***
WmfI+HZXhME/HMG8E3/H2w: folds 
5z4PIVM9IyDWfUi+/MMdTA: raises $17.25 to $17.50 and is all-in
NhUN/JpAprdJeamFBgJH1w: folds 
ErIN0JRL5srYjT6en1f8YQ: folds 
EXTSABh+qTpWWrIkxl3wXg: folds 
cfJccEfyn6IkquPN08hFsA: folds 
Uncalled bet ($17.25) returned to 5z4PIVM9IyDWfUi+/MMdTA
5z4PIVM9IyDWfUi+/MMdTA collected $0.60 from pot
*** SUMMARY ***
Total pot $0.60 | Rake $0 
Seat 1: NhUN/JpAprdJeamFBgJH1w folded before Flop (didn't bet)
Seat 2: ErIN0JRL5srYjT6en1f8YQ (button) folded before Flop (didn't bet)
Seat 3: EXTSABh+qTpWWrIkxl3wXg (small blind) folded before Flop
Seat 4: cfJccEfyn6IkquPN08hFsA (big blind) folded before Flop
Seat 5: WmfI+HZXhME/HMG8E3/H2w folded before Flop (didn't bet)
Seat 6: 5z4PIVM9IyDWfUi+/MMdTA collected ($0.60)




PokerStars Game #59939431482:  Hold'em No Limit ($0.10/$0.25) - 2009/07/01 0:39:42 ET
Table 'FE/j6VqBY4j9Uq+VHURQCQ' 6-max Seat #5 is the button
Seat 1: wKFJ513ucluNNiMlkXcDOQ ($44.10 in chips) 
Seat 2: gh0Jkra5bJ5RFIDWbx9zqA ($12.60 in chips) 
Seat 3: Zijzy/UtPWzWVUo81HHVjQ ($49.75 in chips) 
Seat 4: cPO/1/dTcZpLkQFm3jH3Rg ($25 in chips) 
Seat 5: wsP46AGpqDjHZQmlRHKa9g ($25 in chips) 
Seat 6: kARKwAmU6kWJfiSICTYhVw ($14.45 in chips) 
kARKwAmU6kWJfiSICTYhVw: posts small blind $0.10
wKFJ513ucluNNiMlkXcDOQ: posts big blind $0.25
*** HOLE CARDS ***
gh0Jkra5bJ5RFIDWbx9zqA: folds 
gh0Jkra5bJ5RFIDWbx9zqA leaves the table
3zD3qLXT1bEffAoWGnc7wg joins the table at seat #2 
Zijzy/UtPWzWVUo81HHVjQ: folds 
cPO/1/dTcZpLkQFm3jH3Rg: raises $0.75 to $1
wsP46AGpqDjHZQmlRHKa9g: folds 
kARKwAmU6kWJfiSICTYhVw: folds 
wKFJ513ucluNNiMlkXcDOQ: folds 
Uncalled bet ($0.75) returned to cPO/1/dTcZpLkQFm3jH3Rg
cPO/1/dTcZpLkQFm3jH3Rg collected $0.60 from pot
*** SUMMARY ***
Total pot $0.60 | Rake $0 
Seat 1: wKFJ513ucluNNiMlkXcDOQ (big blind) folded before Flop
Seat 2: gh0Jkra5bJ5RFIDWbx9zqA folded before Flop (didn't bet)
Seat 3: Zijzy/UtPWzWVUo81HHVjQ folded before Flop (didn't bet)
Seat 4: cPO/1/dTcZpLkQFm3jH3Rg collected ($0.60)
Seat 5: wsP46AGpqDjHZQmlRHKa9g (button) folded before Flop (didn't bet)
Seat 6: kARKwAmU6kWJfiSICTYhVw (small blind) folded before Flop




PokerStars Game #59939431634:  Hold'em No Limit ($0.10/$0.25) - 2009/07/01 0:39:42 ET
Table 'wPWRBZPJl1HAnysw7qRR0A' 6-max Seat #4 is the button
Seat 1: cPO/1/dTcZpLkQFm3jH3Rg ($49.60 in chips) 
Seat 2: 48oT5xFI+5CHUJlfoGrE4w ($6.55 in chips) 
Seat 3: rPToQDbLWB+dKnz7fcQSIg ($10 in chips) 
Seat 4: kbpWbC+dJNBphHl1jtw7bw ($23.70 in chips) 
Seat 5: LtASJ9OlkqGrrUKGQlpGAw ($22.05 in chips) 
Seat 6: VLoE/jniCqHZuUkx8Esf6w ($28.30 in chips) 
LtASJ9OlkqGrrUKGQlpGAw: posts small blind $0.10
VLoE/jniCqHZuUkx8Esf6w: posts big blind $0.25
*** HOLE CARDS ***
cPO/1/dTcZpLkQFm3jH3Rg: folds 
48oT5xFI+5CHUJlfoGrE4w: folds 
rPToQDbLWB+dKnz7fcQSIg: folds 
kbpWbC+dJNBphHl1jtw7bw: calls $0.25
LtASJ9OlkqGrrUKGQlpGAw: calls $0.15
VLoE/jniCqHZuUkx8Esf6w: checks 
*** FLOP *** [6d Ts Kd]
LtASJ9OlkqGrrUKGQlpGAw: checks 
VLoE/jniCqHZuUkx8Esf6w: checks 
kbpWbC+dJNBphHl1jtw7bw: bets $0.50
LtASJ9OlkqGrrUKGQlpGAw: folds 
VLoE/jniCqHZuUkx8Esf6w: folds 
Uncalled bet ($0.50) returned to kbpWbC+dJNBphHl1jtw7bw
kbpWbC+dJNBphHl1jtw7bw collected $0.75 from pot
rPToQDbLWB+dKnz7fcQSIg leaves the table
kbpWbC+dJNBphHl1jtw7bw: doesn't show hand 
*** SUMMARY ***
Total pot $0.75 | Rake $0 
Board [6d Ts Kd]
Seat 1: cPO/1/dTcZpLkQFm3jH3Rg folded before Flop (didn't bet)
Seat 2: 48oT5xFI+5CHUJlfoGrE4w folded before Flop (didn't bet)
Seat 3: rPToQDbLWB+dKnz7fcQSIg folded before Flop (didn't bet)
Seat 4: kbpWbC+dJNBphHl1jtw7bw (button) collected ($0.75)
Seat 5: LtASJ9OlkqGrrUKGQlpGAw (small blind) folded on the Flop
Seat 6: VLoE/jniCqHZuUkx8Esf6w (big blind) folded on the Flop




PokerStars Game #59939431542:  Hold'em No Limit ($0.10/$0.25) - 2009/07/01 0:39:42 ET
Table 'rO1I30HnuCPB0M8qEX1TCQ' 9-max Seat #2 is the button
Seat 1: P32tOtZSz+L5ekobAPq2DA ($4.10 in chips) 
Seat 2: 33y9+GmQ3J84RvZXcraRTw ($21.05 in chips) 
Seat 3: 8Waresd9ixnijISc3GUypg ($12.45 in chips) 
Seat 4: spidnpwmoJ1L6yeNW7D5UA ($24 in chips) 
Seat 5: HVKi9hnDyvzObpL08/OarQ ($24.75 in chips) 
Seat 6: 6LFELL8V3NTpb0xg7AOyEg ($18.45 in chips) 
Seat 7: 4oA316mXLIui1QY63GXBUg ($30.75 in chips) 
Seat 8: DIBbjEYGs+TVdVgEB/4+3w ($37 in chips) 
Seat 9: PrviAnKmKklf+We6cR33cw ($30.50 in chips) 
8Waresd9ixnijISc3GUypg: posts small blind $0.10
spidnpwmoJ1L6yeNW7D5UA: posts big blind $0.25
*** HOLE CARDS ***
HVKi9hnDyvzObpL08/OarQ: folds 
6LFELL8V3NTpb0xg7AOyEg: folds 
4oA316mXLIui1QY63GXBUg: folds 
DIBbjEYGs+TVdVgEB/4+3w: folds 
PrviAnKmKklf+We6cR33cw: folds 
P32tOtZSz+L5ekobAPq2DA: calls $0.25
33y9+GmQ3J84RvZXcraRTw: folds 
8Waresd9ixnijISc3GUypg: calls $0.15
spidnpwmoJ1L6yeNW7D5UA: raises $12 to $12.25
P32tOtZSz+L5ekobAPq2DA: folds 
8Waresd9ixnijISc3GUypg: folds 
Uncalled bet ($12) returned to spidnpwmoJ1L6yeNW7D5UA
spidnpwmoJ1L6yeNW7D5UA collected $0.75 from pot
spidnpwmoJ1L6yeNW7D5UA: doesn't show hand 
*** SUMMARY ***
Total pot $0.75 | Rake $0 
Seat 1: P32tOtZSz+L5ekobAPq2DA folded before Flop
Seat 2: 33y9+GmQ3J84RvZXcraRTw (button) folded before Flop (didn't bet)
Seat 3: 8Waresd9ixnijISc3GUypg (small blind) folded before Flop
Seat 4: spidnpwmoJ1L6yeNW7D5UA (big blind) collected ($0.75)
Seat 5: HVKi9hnDyvzObpL08/OarQ folded before Flop (didn't bet)
Seat 6: 6LFELL8V3NTpb0xg7AOyEg folded before Flop (didn't bet)
Seat 7: 4oA316mXLIui1QY63GXBUg folded before Flop (didn't bet)
Seat 8: DIBbjEYGs+TVdVgEB/4+3w folded before Flop (didn't bet)
Seat 9: PrviAnKmKklf+We6cR33cw folded before Flop (didn't bet)




PokerStars Game #59939431510:  Hold'em No Limit ($0.10/$0.25) - 2009/07/01 0:39:42 ET
Table 'iHlyuN1lFZ6WTlMBiiMYXAIIO2q2znuuAXmiZ2qFTcmgx Seat #9 is the button
Seat 2: R6nIVAjK7uhK3Hj0f85A+A ($29.20 in chips) 
Seat 3: QGjA4xtpxSpgzm+HC+ps4w ($22.50 in chips) 
Seat 4: z5GxcHlYz/GSz6W2uFiTtg ($24 in chips) 
Seat 5: 6LFELL8V3NTpb0xg7AOyEg ($12.70 in chips) 
Seat 6: M2QO2DxB5Wawg2h8HSpnYA ($11.30 in chips) 
Seat 7: gehe91e0IyVT0QU/XBkEyg ($33.50 in chips) 
Seat 8: TeWJxSETzbXGiYKx0y+dtg ($24.55 in chips) 
Seat 9: PqvgxdSg9z5VmrWpbYuz+g ($25 in chips) 
R6nIVAjK7uhK3Hj0f85A+A: posts small blind $0.10
QGjA4xtpxSpgzm+HC+ps4w: posts big blind $0.25
*** HOLE CARDS ***
z5GxcHlYz/GSz6W2uFiTtg: folds 
6LFELL8V3NTpb0xg7AOyEg: folds 
M2QO2DxB5Wawg2h8HSpnYA: calls $0.25
gehe91e0IyVT0QU/XBkEyg: folds 
TeWJxSETzbXGiYKx0y+dtg: folds 
PqvgxdSg9z5VmrWpbYuz+g: raises $0.25 to $0.50
R6nIVAjK7uhK3Hj0f85A+A: folds 
QGjA4xtpxSpgzm+HC+ps4w: calls $0.25
M2QO2DxB5Wawg2h8HSpnYA: calls $0.25
*** FLOP *** [6h 9d Ah]
QGjA4xtpxSpgzm+HC+ps4w: checks 
M2QO2DxB5Wawg2h8HSpnYA: checks 
PqvgxdSg9z5VmrWpbYuz+g: checks 
*** TURN *** [6h 9d Ah] [Kh]
QGjA4xtpxSpgzm+HC+ps4w: checks 
M2QO2DxB5Wawg2h8HSpnYA: bets $0.75
PqvgxdSg9z5VmrWpbYuz+g: calls $0.75
QGjA4xtpxSpgzm+HC+ps4w: folds 
*** RIVER *** [6h 9d Ah Kh] [Qd]
M2QO2DxB5Wawg2h8HSpnYA: bets $1
PqvgxdSg9z5VmrWpbYuz+g: calls $1
*** SHOW DOWN ***
M2QO2DxB5Wawg2h8HSpnYA: shows [Th Qh] (a flush, Ace high)
PqvgxdSg9z5VmrWpbYuz+g: mucks hand 
M2QO2DxB5Wawg2h8HSpnYA collected $4.90 from pot
*** SUMMARY ***
Total pot $5.10 | Rake $0.20 
Board [6h 9d Ah Kh Qd]
Seat 2: R6nIVAjK7uhK3Hj0f85A+A (small blind) folded before Flop
Seat 3: QGjA4xtpxSpgzm+HC+ps4w (big blind) folded on the Turn
Seat 4: z5GxcHlYz/GSz6W2uFiTtg folded before Flop (didn't bet)
Seat 5: 6LFELL8V3NTpb0xg7AOyEg folded before Flop (didn't bet)
Seat 6: M2QO2DxB5Wawg2h8HSpnYA showed [Th Qh] and won ($4.90) with a flush, Ace high
Seat 7: gehe91e0IyVT0QU/XBkEyg folded before Flop (didn't bet)
Seat 8: TeWJxSETzbXGiYKx0y+dtg folded before Flop (didn't bet)
Seat 9: PqvgxdSg9z5VmrWpbYuz+g (button) mucked




PokerStars Game #59939432458:  Hold'em No Limit ($0.10/$0.25) - 2009/07/01 0:39:43 ET
Table 'KAnP7XvDtlku47YfJwdOVw' 9-max Seat #8 is the button
Seat 1: sJNHTWcSlLHRCZ9+YRLLqA ($33.55 in chips) 
Seat 2: CYkY0dNBaYaKs8HVCVn3mQ ($5 in chips) 
Seat 3: 7qgCOBwxmRRmkppeMkqy0Q ($7.40 in chips) 
Seat 5: MG90wfSJZnOejs/KD3vlQQ ($31.20 in chips) 
Seat 6: z5GxcHlYz/GSz6W2uFiTtg ($26.70 in chips) 
Seat 7: Lro4e37x4FUa5P3yzDjskw ($9.90 in chips) 
Seat 8: 3fPCxL5JUJVUL3eETYhxQQ ($8.90 in chips) 
Seat 9: qwr38jl5txoR36M7G5qi4A ($8.60 in chips) 
qwr38jl5txoR36M7G5qi4A: posts small blind $0.10
sJNHTWcSlLHRCZ9+YRLLqA: posts big blind $0.25
IrishMike123: sits out 
*** HOLE CARDS ***
CYkY0dNBaYaKs8HVCVn3mQ: folds 
7qgCOBwxmRRmkppeMkqy0Q: folds 
MG90wfSJZnOejs/KD3vlQQ: folds 
z5GxcHlYz/GSz6W2uFiTtg: calls $0.25
Lro4e37x4FUa5P3yzDjskw: folds 
3fPCxL5JUJVUL3eETYhxQQ: folds 
qwr38jl5txoR36M7G5qi4A: calls $0.15
sJNHTWcSlLHRCZ9+YRLLqA: checks 
*** FLOP *** [Ah Td Qc]
qwr38jl5txoR36M7G5qi4A: checks 
sJNHTWcSlLHRCZ9+YRLLqA: checks 
z5GxcHlYz/GSz6W2uFiTtg: bets $0.25
qwr38jl5txoR36M7G5qi4A: calls $0.25
sJNHTWcSlLHRCZ9+YRLLqA: folds 
*** TURN *** [Ah Td Qc] [Jd]
qwr38jl5txoR36M7G5qi4A: bets $0.75
z5GxcHlYz/GSz6W2uFiTtg: folds 
Uncalled bet ($0.75) returned to qwr38jl5txoR36M7G5qi4A
qwr38jl5txoR36M7G5qi4A collected $1.20 from pot
qwr38jl5txoR36M7G5qi4A: doesn't show hand 
*** SUMMARY ***
Total pot $1.25 | Rake $0.05 
Board [Ah Td Qc Jd]
Seat 1: sJNHTWcSlLHRCZ9+YRLLqA (big blind) folded on the Flop
Seat 2: CYkY0dNBaYaKs8HVCVn3mQ folded before Flop (didn't bet)
Seat 3: 7qgCOBwxmRRmkppeMkqy0Q folded before Flop (didn't bet)
Seat 5: MG90wfSJZnOejs/KD3vlQQ folded before Flop (didn't bet)
Seat 6: z5GxcHlYz/GSz6W2uFiTtg folded on the Turn
Seat 7: Lro4e37x4FUa5P3yzDjskw folded before Flop (didn't bet)
Seat 8: 3fPCxL5JUJVUL3eETYhxQQ (button) folded before Flop (didn't bet)
Seat 9: qwr38jl5txoR36M7G5qi4A (small blind) collected ($1.20)




PokerStars Game #59939432206:  Hold'em No Limit ($0.10/$0.25) - 2009/07/01 0:39:43 ET
Table 'RuT55t7dqtns1CdLsutksg' 9-max Seat #4 is the button
Seat 1: N6WEabmk+J6IGeE7kub1QQ ($41.10 in chips) 
Seat 2: CYkY0dNBaYaKs8HVCVn3mQ ($5.90 in chips) 
Seat 3: xOx0qYgTfvbPkTa+GuX0WA ($16.75 in chips) 
Seat 4: MG90wfSJZnOejs/KD3vlQQ ($25.75 in chips) 
Seat 5: 0D3Q+hLxjPei/5wgaaYhZA ($4.15 in chips) 
Seat 6: CqwJk5Z2+vb2f9j1o7IjKQ ($11.25 in chips) 
Seat 7: Il5IBomZPnY0uD8k+rlPyw ($18.90 in chips) 
Seat 9: oAO88RFrn7cbQFHZt8VrkA ($35.65 in chips) 
0D3Q+hLxjPei/5wgaaYhZA: posts small blind $0.10
CqwJk5Z2+vb2f9j1o7IjKQ: posts big blind $0.25
yyG4svzOpC1A+sUP/scg6w: sits out 
*** HOLE CARDS ***
Il5IBomZPnY0uD8k+rlPyw: folds 
oAO88RFrn7cbQFHZt8VrkA: raises $0.25 to $0.50
N6WEabmk+J6IGeE7kub1QQ: folds 
CYkY0dNBaYaKs8HVCVn3mQ: folds 
xOx0qYgTfvbPkTa+GuX0WA: calls $0.50
MG90wfSJZnOejs/KD3vlQQ: folds 
0D3Q+hLxjPei/5wgaaYhZA: folds 
CqwJk5Z2+vb2f9j1o7IjKQ: raises $1.25 to $1.75
oAO88RFrn7cbQFHZt8VrkA: folds 
xOx0qYgTfvbPkTa+GuX0WA: folds 
Uncalled bet ($1.25) returned to CqwJk5Z2+vb2f9j1o7IjKQ
CqwJk5Z2+vb2f9j1o7IjKQ collected $1.60 from pot
CqwJk5Z2+vb2f9j1o7IjKQ: doesn't show hand 
*** SUMMARY ***
Total pot $1.60 | Rake $0 
Seat 1: N6WEabmk+J6IGeE7kub1QQ folded before Flop (didn't bet)
Seat 2: CYkY0dNBaYaKs8HVCVn3mQ folded before Flop (didn't bet)
Seat 3: xOx0qYgTfvbPkTa+GuX0WA folded before Flop
Seat 4: MG90wfSJZnOejs/KD3vlQQ (button) folded before Flop (didn't bet)
Seat 5: 0D3Q+hLxjPei/5wgaaYhZA (small blind) folded before Flop
Seat 6: CqwJk5Z2+vb2f9j1o7IjKQ (big blind) collected ($1.60)
Seat 7: Il5IBomZPnY0uD8k+rlPyw folded before Flop (didn't bet)
Seat 9: oAO88RFrn7cbQFHZt8VrkA folded before Flop




PokerStars Game #59939432282:  Hold'em No Limit ($0.10/$0.25) - 2009/07/01 0:39:43 ET
Table '3lL16FBjWXTx3AjK5lMRwwgkdjhbH1jaE3hwhPRIKMiQx Seat #1 is the button
Seat 1: fDGyaQz0cs2s4FOYxkbIHA ($7.80 in chips) 
Seat 2: YK2fIgjF+Z0ARwKKcGh1fw ($18.30 in chips) 
Seat 3: QEbIGci+itdw+re8RM5fZA ($26.25 in chips) 
Seat 4: ZWU9RNYtjmm4cElg1I0F4w ($61.20 in chips) 
Seat 5: M/9j4wkHH9i1JM51vgi1VA ($22.85 in chips) 
Seat 6: hBMUlEpyU74r/fwDgIpXjQ ($41.35 in chips) 
Seat 7: JxpnpCmvRAcrEUy7mq1iAg ($5.40 in chips) 
Seat 8: ljemhp25Zg+nlA9DLCIiUw ($23.30 in chips) 
Seat 9: b8t3jWrxzeEt9HtZtc9wUQ ($10.25 in chips) 
YK2fIgjF+Z0ARwKKcGh1fw: posts small blind $0.10
QEbIGci+itdw+re8RM5fZA: posts big blind $0.25
*** HOLE CARDS ***
ZWU9RNYtjmm4cElg1I0F4w: folds 
M/9j4wkHH9i1JM51vgi1VA: folds 
hBMUlEpyU74r/fwDgIpXjQ: folds 
JxpnpCmvRAcrEUy7mq1iAg: folds 
ljemhp25Zg+nlA9DLCIiUw: folds 
b8t3jWrxzeEt9HtZtc9wUQ: calls $0.25
fDGyaQz0cs2s4FOYxkbIHA: folds 
YK2fIgjF+Z0ARwKKcGh1fw: folds 
QEbIGci+itdw+re8RM5fZA: checks 
*** FLOP *** [4c Kh Qh]
QEbIGci+itdw+re8RM5fZA: checks 
b8t3jWrxzeEt9HtZtc9wUQ: checks 
*** TURN *** [4c Kh Qh] [2c]
QEbIGci+itdw+re8RM5fZA: checks 
b8t3jWrxzeEt9HtZtc9wUQ: checks 
*** RIVER *** [4c Kh Qh 2c] [8c]
QEbIGci+itdw+re8RM5fZA: checks 
b8t3jWrxzeEt9HtZtc9wUQ: bets $0.50
QEbIGci+itdw+re8RM5fZA: folds 
Uncalled bet ($0.50) returned to b8t3jWrxzeEt9HtZtc9wUQ
b8t3jWrxzeEt9HtZtc9wUQ collected $0.60 from pot
b8t3jWrxzeEt9HtZtc9wUQ: doesn't show hand 
*** SUMMARY ***
Total pot $0.60 | Rake $0 
Board [4c Kh Qh 2c 8c]
Seat 1: fDGyaQz0cs2s4FOYxkbIHA (button) folded before Flop (didn't bet)
Seat 2: YK2fIgjF+Z0ARwKKcGh1fw (small blind) folded before Flop
Seat 3: QEbIGci+itdw+re8RM5fZA (big blind) folded on the River
Seat 4: ZWU9RNYtjmm4cElg1I0F4w folded before Flop (didn't bet)
Seat 5: M/9j4wkHH9i1JM51vgi1VA folded before Flop (didn't bet)
Seat 6: hBMUlEpyU74r/fwDgIpXjQ folded before Flop (didn't bet)
Seat 7: JxpnpCmvRAcrEUy7mq1iAg folded before Flop (didn't bet)
Seat 8: ljemhp25Zg+nlA9DLCIiUw folded before Flop (didn't bet)
Seat 9: b8t3jWrxzeEt9HtZtc9wUQ collected ($0.60)




PokerStars Game #59939432408:  Hold'em No Limit ($0.10/$0.25) - 2009/07/01 0:39:43 ET
Table '5VWnrlxdjwVfMWkVS2WE7A' 6-max Seat #3 is the button
Seat 1: BiLBinPhgpKAYzLgKJVU5A ($21.95 in chips) 
Seat 2: ELW+DKizJhLK7k40PMkD2Q ($24.65 in chips) 
Seat 3: cPO/1/dTcZpLkQFm3jH3Rg ($25 in chips) 
Seat 4: WZv4aSGl7ETtI/Z5BPKi7w ($28.85 in chips) 
Seat 5: JQZew0FjzS19kTjeNtrE+A ($45.65 in chips) 
Seat 6: LtASJ9OlkqGrrUKGQlpGAw ($20.75 in chips) 
WZv4aSGl7ETtI/Z5BPKi7w: posts small blind $0.10
JQZew0FjzS19kTjeNtrE+A: posts big blind $0.25
*** HOLE CARDS ***
LtASJ9OlkqGrrUKGQlpGAw: folds 
BiLBinPhgpKAYzLgKJVU5A: folds 
ELW+DKizJhLK7k40PMkD2Q: folds 
cPO/1/dTcZpLkQFm3jH3Rg: folds 
WZv4aSGl7ETtI/Z5BPKi7w: raises $0.25 to $0.50
JQZew0FjzS19kTjeNtrE+A: calls $0.25
*** FLOP *** [Tc 8c Qh]
WZv4aSGl7ETtI/Z5BPKi7w: bets $0.75
JQZew0FjzS19kTjeNtrE+A: calls $0.75
*** TURN *** [Tc 8c Qh] [3s]
WZv4aSGl7ETtI/Z5BPKi7w: bets $1
JQZew0FjzS19kTjeNtrE+A: calls $1
*** RIVER *** [Tc 8c Qh 3s] [Qd]
WZv4aSGl7ETtI/Z5BPKi7w: bets $3
JQZew0FjzS19kTjeNtrE+A: folds 
Uncalled bet ($3) returned to WZv4aSGl7ETtI/Z5BPKi7w
WZv4aSGl7ETtI/Z5BPKi7w collected $4.30 from pot
WZv4aSGl7ETtI/Z5BPKi7w: doesn't show hand 
*** SUMMARY ***
Total pot $4.50 | Rake $0.20 
Board [Tc 8c Qh 3s Qd]
Seat 1: BiLBinPhgpKAYzLgKJVU5A folded before Flop (didn't bet)
Seat 2: ELW+DKizJhLK7k40PMkD2Q folded before Flop (didn't bet)
Seat 3: cPO/1/dTcZpLkQFm3jH3Rg (button) folded before Flop (didn't bet)
Seat 4: WZv4aSGl7ETtI/Z5BPKi7w (small blind) collected ($4.30)
Seat 5: JQZew0FjzS19kTjeNtrE+A (big blind) folded on the River
Seat 6: LtASJ9OlkqGrrUKGQlpGAw folded before Flop (didn't bet)




PokerStars Game #59939431948:  Hold'em No Limit ($0.10/$0.25) - 2009/07/01 0:39:43 ET
Table 'ktio12Pyq06LsrFhIorSqA' 9-max Seat #3 is the button
Seat 2: sX4bSd399rlGD2VqB7dh2Q ($8.45 in chips) 
Seat 3: 21oaELqROjaQrGRMDGa8pQ ($15.25 in chips) 
Seat 5: u5FxT1XSXMItxD9DAQOsoQ ($38.15 in chips) 
Seat 6: jQL6XIewylQ8MmZhhq2YFg ($39.25 in chips) 
Seat 7: XGCfQsxa6PfAg3kJtzUmww ($24.15 in chips) 
Seat 8: Z5y2J55JmfLYR6/DPAGHwQ ($17.40 in chips) 
Seat 9: 2Gn4w2tIKlLbK/3nwIeRYA ($7.50 in chips) 
u5FxT1XSXMItxD9DAQOsoQ: posts small blind $0.10
jQL6XIewylQ8MmZhhq2YFg: posts big blind $0.25
DerBendero: sits out 
*** HOLE CARDS ***
XGCfQsxa6PfAg3kJtzUmww: folds 
Z5y2J55JmfLYR6/DPAGHwQ: folds 
VzYduLriCNmLWxnPG/bmHA leaves the table
2Gn4w2tIKlLbK/3nwIeRYA: calls $0.25
sX4bSd399rlGD2VqB7dh2Q: calls $0.25
21oaELqROjaQrGRMDGa8pQ: calls $0.25
u5FxT1XSXMItxD9DAQOsoQ: folds 
E0iYnEVO2ho7dH3QcCjw7g joins the table at seat #4 
jQL6XIewylQ8MmZhhq2YFg: checks 
*** FLOP *** [8d Ts 8h]
jQL6XIewylQ8MmZhhq2YFg: checks 
2Gn4w2tIKlLbK/3nwIeRYA: checks 
sX4bSd399rlGD2VqB7dh2Q: checks 
21oaELqROjaQrGRMDGa8pQ: bets $1
jQL6XIewylQ8MmZhhq2YFg: calls $1
2Gn4w2tIKlLbK/3nwIeRYA: calls $1
sX4bSd399rlGD2VqB7dh2Q: folds 
*** TURN *** [8d Ts 8h] [Qd]
jQL6XIewylQ8MmZhhq2YFg: bets $1.25
2Gn4w2tIKlLbK/3nwIeRYA: calls $1.25
21oaELqROjaQrGRMDGa8pQ: folds 
*** RIVER *** [8d Ts 8h Qd] [Qc]
jQL6XIewylQ8MmZhhq2YFg: bets $2
2Gn4w2tIKlLbK/3nwIeRYA: raises $3 to $5 and is all-in
jQL6XIewylQ8MmZhhq2YFg: calls $3
*** SHOW DOWN ***
2Gn4w2tIKlLbK/3nwIeRYA: shows [Jc Qh] (a full house, Queens full of Eights)
jQL6XIewylQ8MmZhhq2YFg: mucks hand 
2Gn4w2tIKlLbK/3nwIeRYA collected $15.80 from pot
*** SUMMARY ***
Total pot $16.60 | Rake $0.80 
Board [8d Ts 8h Qd Qc]
Seat 2: sX4bSd399rlGD2VqB7dh2Q folded on the Flop
Seat 3: 21oaELqROjaQrGRMDGa8pQ (button) folded on the Turn
Seat 5: u5FxT1XSXMItxD9DAQOsoQ (small blind) folded before Flop
Seat 6: jQL6XIewylQ8MmZhhq2YFg (big blind) mucked
Seat 7: XGCfQsxa6PfAg3kJtzUmww folded before Flop (didn't bet)
Seat 8: Z5y2J55JmfLYR6/DPAGHwQ folded before Flop (didn't bet)
Seat 9: 2Gn4w2tIKlLbK/3nwIeRYA showed [Jc Qh] and won ($15.80) with a full house, Queens full of Eights




PokerStars Game #59939433032:  Hold'em No Limit ($0.10/$0.25) - 2009/07/01 0:39:44 ET
Table 'zJTgUqdWn7ojWWqV4pItEQ' 9-max Seat #9 is the button
Seat 1: CbXUS6Z2rXZxL1AKduNtmQ ($30.45 in chips) 
Seat 2: 7wo6Sr7QG3Zo6BaBDV1BOw ($6.50 in chips) 
Seat 3: 2N94FgK4Y2izKFIB+wJOjw ($18.35 in chips) 
Seat 4: ZeR3hkj1gVv9J4yPCmRrjA ($33.50 in chips) 
Seat 6: cQQdn+v2h6ICJU1fq6mEyA ($24.15 in chips) 
Seat 7: 4oA316mXLIui1QY63GXBUg ($25 in chips) 
Seat 9: DnDcAdn9P0zGovMERigpFA ($25.25 in chips) 
CbXUS6Z2rXZxL1AKduNtmQ: posts small blind $0.10
7wo6Sr7QG3Zo6BaBDV1BOw: posts big blind $0.25
murdog71: sits out 
*** HOLE CARDS ***
2N94FgK4Y2izKFIB+wJOjw: raises $0.75 to $1
ZeR3hkj1gVv9J4yPCmRrjA: folds 
cQQdn+v2h6ICJU1fq6mEyA: calls $1
4oA316mXLIui1QY63GXBUg: folds 
DnDcAdn9P0zGovMERigpFA: folds 
CbXUS6Z2rXZxL1AKduNtmQ: folds 
7wo6Sr7QG3Zo6BaBDV1BOw: folds 
*** FLOP *** [4h Td Ad]
2N94FgK4Y2izKFIB+wJOjw: bets $1
cQQdn+v2h6ICJU1fq6mEyA: calls $1
*** TURN *** [4h Td Ad] [5h]
2N94FgK4Y2izKFIB+wJOjw: bets $2
cQQdn+v2h6ICJU1fq6mEyA: folds 
Uncalled bet ($2) returned to 2N94FgK4Y2izKFIB+wJOjw
2N94FgK4Y2izKFIB+wJOjw collected $4.15 from pot
2N94FgK4Y2izKFIB+wJOjw: doesn't show hand 
*** SUMMARY ***
Total pot $4.35 | Rake $0.20 
Board [4h Td Ad 5h]
Seat 1: CbXUS6Z2rXZxL1AKduNtmQ (small blind) folded before Flop
Seat 2: 7wo6Sr7QG3Zo6BaBDV1BOw (big blind) folded before Flop
Seat 3: 2N94FgK4Y2izKFIB+wJOjw collected ($4.15)
Seat 4: ZeR3hkj1gVv9J4yPCmRrjA folded before Flop (didn't bet)
Seat 6: cQQdn+v2h6ICJU1fq6mEyA folded on the Turn
Seat 7: 4oA316mXLIui1QY63GXBUg folded before Flop (didn't bet)
Seat 9: DnDcAdn9P0zGovMERigpFA (button) folded before Flop (didn't bet)




PokerStars Game #59939432878:  Hold'em No Limit ($0.10/$0.25) - 2009/07/01 0:39:44 ET
Table 'OvOqQoL/QnXuXuQjXo2hIQ' 9-max Seat #3 is the button
Seat 1: Xbfvrzh7Jjg4vOZkdMSfbA ($18.35 in chips) 
Seat 3: uJlzv9KL7hgCIqIS2ofoaw ($10.85 in chips) 
Seat 4: e8solDZU6VFefGEm0DJbUg ($11.85 in chips) 
Seat 5: sJNHTWcSlLHRCZ9+YRLLqA ($28.95 in chips) 
Seat 6: MIVCHqCqqlke0Lb0z7glcw ($46.40 in chips) 
Seat 7: aNpwfA31EREwO+ar4XzBCw ($26.80 in chips) 
Seat 9: VWUWpMLMj/Q1jRVpF7Aohw ($14.60 in chips) 
e8solDZU6VFefGEm0DJbUg: posts small blind $0.10
sJNHTWcSlLHRCZ9+YRLLqA: posts big blind $0.25
Xbfvrzh7Jjg4vOZkdMSfbA: posts small & big blinds $0.35
*** HOLE CARDS ***
MIVCHqCqqlke0Lb0z7glcw: folds 
aNpwfA31EREwO+ar4XzBCw: folds 
VWUWpMLMj/Q1jRVpF7Aohw: folds 
Xbfvrzh7Jjg4vOZkdMSfbA: raises $0.25 to $0.50
uJlzv9KL7hgCIqIS2ofoaw: calls $0.50
e8solDZU6VFefGEm0DJbUg: raises $0.25 to $0.75
sJNHTWcSlLHRCZ9+YRLLqA: folds 
Xbfvrzh7Jjg4vOZkdMSfbA: calls $0.25
uJlzv9KL7hgCIqIS2ofoaw: calls $0.25
*** FLOP *** [8s As 5h]
e8solDZU6VFefGEm0DJbUg: bets $0.50
Xbfvrzh7Jjg4vOZkdMSfbA: folds 
uJlzv9KL7hgCIqIS2ofoaw: raises $2 to $2.50
e8solDZU6VFefGEm0DJbUg: calls $2
*** TURN *** [8s As 5h] [Td]
e8solDZU6VFefGEm0DJbUg: bets $2
uJlzv9KL7hgCIqIS2ofoaw: calls $2
*** RIVER *** [8s As 5h Td] [9c]
e8solDZU6VFefGEm0DJbUg: checks 
uJlzv9KL7hgCIqIS2ofoaw: checks 
*** SHOW DOWN ***
e8solDZU6VFefGEm0DJbUg: shows [Kd Ks] (a pair of Kings)
uJlzv9KL7hgCIqIS2ofoaw: shows [Ac 7c] (a pair of Aces)
uJlzv9KL7hgCIqIS2ofoaw collected $11.05 from pot
*** SUMMARY ***
Total pot $11.60 | Rake $0.55 
Board [8s As 5h Td 9c]
Seat 1: Xbfvrzh7Jjg4vOZkdMSfbA folded on the Flop
Seat 3: uJlzv9KL7hgCIqIS2ofoaw (button) showed [Ac 7c] and won ($11.05) with a pair of Aces
Seat 4: e8solDZU6VFefGEm0DJbUg (small blind) showed [Kd Ks] and lost with a pair of Kings
Seat 5: sJNHTWcSlLHRCZ9+YRLLqA (big blind) folded before Flop
Seat 6: MIVCHqCqqlke0Lb0z7glcw folded before Flop (didn't bet)
Seat 7: aNpwfA31EREwO+ar4XzBCw folded before Flop (didn't bet)
Seat 9: VWUWpMLMj/Q1jRVpF7Aohw folded before Flop (didn't bet)




PokerStars Game #59939432726:  Hold'em No Limit ($0.10/$0.25) - 2009/07/01 0:39:44 ET
Table 'HzFR0rxmDAPu5GzYR0AlYg' 6-max Seat #2 is the button
Seat 1: v+QfkGiuj9bgtuNoVnDO8w ($25 in chips) 
Seat 2: UA5OsKS3VPaxa7uC8La/kA ($52.60 in chips) 
Seat 3: lfAPI6VglUPipZe8BpDaTA ($24.95 in chips) 
Seat 4: uy9x0X5l7O+IpGjLa77QgQ ($60.40 in chips) 
Seat 5: I1TxPvWj8NfG8orglCinNA ($25 in chips) 
lfAPI6VglUPipZe8BpDaTA: posts small blind $0.10
uy9x0X5l7O+IpGjLa77QgQ: posts big blind $0.25
*** HOLE CARDS ***
I1TxPvWj8NfG8orglCinNA: folds 
v+QfkGiuj9bgtuNoVnDO8w: folds 
mike czar said, "lol"
UA5OsKS3VPaxa7uC8La/kA: raises $0.50 to $0.75
lfAPI6VglUPipZe8BpDaTA: folds 
uy9x0X5l7O+IpGjLa77QgQ said, "sorry cant"
uy9x0X5l7O+IpGjLa77QgQ: folds 
Uncalled bet ($0.50) returned to UA5OsKS3VPaxa7uC8La/kA
UA5OsKS3VPaxa7uC8La/kA collected $0.60 from pot
mike czar leaves the table
*** SUMMARY ***
Total pot $0.60 | Rake $0 
Seat 1: v+QfkGiuj9bgtuNoVnDO8w folded before Flop (didn't bet)
Seat 2: UA5OsKS3VPaxa7uC8La/kA (button) collected ($0.60)
Seat 3: lfAPI6VglUPipZe8BpDaTA (small blind) folded before Flop
Seat 4: uy9x0X5l7O+IpGjLa77QgQ (big blind) folded before Flop
Seat 5: I1TxPvWj8NfG8orglCinNA folded before Flop (didn't bet)




PokerStars Game #59939433136:  Hold'em No Limit ($0.10/$0.25) - 2009/07/01 0:39:44 ET
Table 'oZuNsbNJuUyQLGKzQ/4JFg' 6-max Seat #4 is the button
Seat 1: /hq3j+3FbArzS8nEzmqRuw ($7.35 in chips) 
Seat 2: UA5OsKS3VPaxa7uC8La/kA ($30.25 in chips) 
Seat 3: 8ClCHtFXGNplITm+63KB+Q ($36.40 in chips) 
Seat 4: pWN7DVB+VCCiq83kllzEtg ($12.25 in chips) 
Seat 5: IH5lT4+CuQFyy32Qf5ydDw ($13.40 in chips) 
Seat 6: 34ttqW62uIRrqINCCmLcsw ($21.15 in chips) 
IH5lT4+CuQFyy32Qf5ydDw: posts small blind $0.10
34ttqW62uIRrqINCCmLcsw: posts big blind $0.25
*** HOLE CARDS ***
/hq3j+3FbArzS8nEzmqRuw: calls $0.25
UA5OsKS3VPaxa7uC8La/kA: folds 
8ClCHtFXGNplITm+63KB+Q: folds 
pWN7DVB+VCCiq83kllzEtg: calls $0.25
IH5lT4+CuQFyy32Qf5ydDw: raises $0.75 to $1
34ttqW62uIRrqINCCmLcsw: folds 
/hq3j+3FbArzS8nEzmqRuw: calls $0.75
pWN7DVB+VCCiq83kllzEtg: calls $0.75
*** FLOP *** [8c 2s 6h]
IH5lT4+CuQFyy32Qf5ydDw: checks 
/hq3j+3FbArzS8nEzmqRuw: checks 
pWN7DVB+VCCiq83kllzEtg: bets $1.50
IH5lT4+CuQFyy32Qf5ydDw: calls $1.50
/hq3j+3FbArzS8nEzmqRuw: folds 
*** TURN *** [8c 2s 6h] [4s]
IH5lT4+CuQFyy32Qf5ydDw: checks 
pWN7DVB+VCCiq83kllzEtg: bets $2.50
IH5lT4+CuQFyy32Qf5ydDw: calls $2.50
*** RIVER *** [8c 2s 6h 4s] [Ac]
IH5lT4+CuQFyy32Qf5ydDw: checks 
pWN7DVB+VCCiq83kllzEtg: checks 
*** SHOW DOWN ***
IH5lT4+CuQFyy32Qf5ydDw: shows [Qc As] (a pair of Aces)
pWN7DVB+VCCiq83kllzEtg: mucks hand 
IH5lT4+CuQFyy32Qf5ydDw collected $10.75 from pot
*** SUMMARY ***
Total pot $11.25 | Rake $0.50 
Board [8c 2s 6h 4s Ac]
Seat 1: /hq3j+3FbArzS8nEzmqRuw folded on the Flop
Seat 2: UA5OsKS3VPaxa7uC8La/kA folded before Flop (didn't bet)
Seat 3: 8ClCHtFXGNplITm+63KB+Q folded before Flop (didn't bet)
Seat 4: pWN7DVB+VCCiq83kllzEtg (button) mucked
Seat 5: IH5lT4+CuQFyy32Qf5ydDw (small blind) showed [Qc As] and won ($10.75) with a pair of Aces
Seat 6: 34ttqW62uIRrqINCCmLcsw (big blind) folded before Flop




PokerStars Game #59939432528:  Hold'em No Limit ($0.10/$0.25) - 2009/07/01 0:39:44 ET
Table 'xPn6TS/y/OWkX7Qa+MUuKA' 6-max Seat #3 is the button
Seat 1: JFIAqU8lCZ0vWwEl4bdGsg ($26.40 in chips) 
Seat 2: buyjetgNT1McXtdaP4zynA ($20.15 in chips) 
Seat 3: o08wk0F4gROLhZS04Iyl3w ($26.35 in chips) 
Seat 4: SS/yfeArhULzIcOPe8MdPg ($28.10 in chips) 
Seat 5: I1TxPvWj8NfG8orglCinNA ($39.40 in chips) 
Seat 6: oseFhpinoe+Zg4j5xyBjyQ ($55.05 in chips) 
SS/yfeArhULzIcOPe8MdPg: posts small blind $0.10
I1TxPvWj8NfG8orglCinNA: posts big blind $0.25
*** HOLE CARDS ***
oseFhpinoe+Zg4j5xyBjyQ: raises $0.25 to $0.50
JFIAqU8lCZ0vWwEl4bdGsg: raises $2.25 to $2.75
buyjetgNT1McXtdaP4zynA: folds 
o08wk0F4gROLhZS04Iyl3w: folds 
SS/yfeArhULzIcOPe8MdPg: folds 
I1TxPvWj8NfG8orglCinNA: folds 
oseFhpinoe+Zg4j5xyBjyQ: folds 
Uncalled bet ($2.25) returned to JFIAqU8lCZ0vWwEl4bdGsg
JFIAqU8lCZ0vWwEl4bdGsg collected $1.35 from pot
JFIAqU8lCZ0vWwEl4bdGsg: doesn't show hand 
*** SUMMARY ***
Total pot $1.35 | Rake $0 
Seat 1: JFIAqU8lCZ0vWwEl4bdGsg collected ($1.35)
Seat 2: buyjetgNT1McXtdaP4zynA folded before Flop (didn't bet)
Seat 3: o08wk0F4gROLhZS04Iyl3w (button) folded before Flop (didn't bet)
Seat 4: SS/yfeArhULzIcOPe8MdPg (small blind) folded before Flop
Seat 5: I1TxPvWj8NfG8orglCinNA (big blind) folded before Flop
Seat 6: oseFhpinoe+Zg4j5xyBjyQ folded before Flop




PokerStars Game #59939432850:  Hold'em No Limit ($0.10/$0.25) - 2009/07/01 0:39:44 ET
Table 'f9j+4UOgRPXbyNbQkZFm4w' 6-max Seat #4 is the button
Seat 1: trN/oHqTTbPw5MNuKrOpLw ($30.85 in chips) 
Seat 2: VHBox3ZuV+/MP3dz2hFEBQ ($5.10 in chips) 
Seat 3: wCBHaebpIJ2ZTqigoRi9DA ($17.75 in chips) 
Seat 4: hiTEr3yrERiQp3zHXRioVw ($21.75 in chips) 
Seat 5: 1lxYIAoJdZwAbzIkzWmSkw ($8.75 in chips) 
Seat 6: C84t1kUtjDF/zm38/Dpcng ($10.95 in chips) 
1lxYIAoJdZwAbzIkzWmSkw: posts small blind $0.10
C84t1kUtjDF/zm38/Dpcng: posts big blind $0.25
*** HOLE CARDS ***
trN/oHqTTbPw5MNuKrOpLw: folds 
VHBox3ZuV+/MP3dz2hFEBQ: folds 
wCBHaebpIJ2ZTqigoRi9DA: folds 
hiTEr3yrERiQp3zHXRioVw: folds 
1lxYIAoJdZwAbzIkzWmSkw: calls $0.15
C84t1kUtjDF/zm38/Dpcng: raises $0.25 to $0.50
1lxYIAoJdZwAbzIkzWmSkw: calls $0.25
*** FLOP *** [Ac Js 8s]
1lxYIAoJdZwAbzIkzWmSkw: checks 
C84t1kUtjDF/zm38/Dpcng: bets $0.25
1lxYIAoJdZwAbzIkzWmSkw: calls $0.25
*** TURN *** [Ac Js 8s] [6d]
1lxYIAoJdZwAbzIkzWmSkw: bets $0.75
C84t1kUtjDF/zm38/Dpcng: calls $0.75
*** RIVER *** [Ac Js 8s 6d] [3h]
1lxYIAoJdZwAbzIkzWmSkw: bets $1
C84t1kUtjDF/zm38/Dpcng: calls $1
*** SHOW DOWN ***
1lxYIAoJdZwAbzIkzWmSkw: shows [6s 4h] (a pair of Sixes)
C84t1kUtjDF/zm38/Dpcng: shows [Th As] (a pair of Aces)
C84t1kUtjDF/zm38/Dpcng collected $4.80 from pot
*** SUMMARY ***
Total pot $5 | Rake $0.20 
Board [Ac Js 8s 6d 3h]
Seat 1: trN/oHqTTbPw5MNuKrOpLw folded before Flop (didn't bet)
Seat 2: VHBox3ZuV+/MP3dz2hFEBQ folded before Flop (didn't bet)
Seat 3: wCBHaebpIJ2ZTqigoRi9DA folded before Flop (didn't bet)
Seat 4: hiTEr3yrERiQp3zHXRioVw (button) folded before Flop (didn't bet)
Seat 5: 1lxYIAoJdZwAbzIkzWmSkw (small blind) showed [6s 4h] and lost with a pair of Sixes
Seat 6: C84t1kUtjDF/zm38/Dpcng (big blind) showed [Th As] and won ($4.80) with a pair of Aces




PokerStars Game #59939433554:  Hold'em No Limit ($0.10/$0.25) - 2009/07/01 0:39:45 ET
Table 'xmJKTGBeWCwutccj3YfupQ' 6-max Seat #1 is the button
Seat 1: sVbkVl4OznxBCfi66UB9vw ($60.45 in chips) 
Seat 2: BedjMfrlRfPgSq7CXpPAmg ($48.55 in chips) 
Seat 3: FStoHe64SQWqAsjya9pDkQ ($25 in chips) 
Seat 4: uWjhTVMpuIroxXcmD3Okug ($41.90 in chips) 
Seat 5: oBUDUfeUyCbZBsjxHZgSiw ($18.05 in chips) 
Seat 6: lYjWCpfCxX2kgcHY3v4Yow ($26 in chips) 
BedjMfrlRfPgSq7CXpPAmg: posts small blind $0.10
FStoHe64SQWqAsjya9pDkQ: posts big blind $0.25
*** HOLE CARDS ***
uWjhTVMpuIroxXcmD3Okug: folds 
oBUDUfeUyCbZBsjxHZgSiw: folds 
lYjWCpfCxX2kgcHY3v4Yow: folds 
uWjhTVMpuIroxXcmD3Okug said, "who knows"
sVbkVl4OznxBCfi66UB9vw: raises $0.50 to $0.75
BedjMfrlRfPgSq7CXpPAmg: folds 
FStoHe64SQWqAsjya9pDkQ said, "its not the twilight zone. its simply poker. we're all trying to win, someone going to lose"
FStoHe64SQWqAsjya9pDkQ: folds 
Uncalled bet ($0.50) returned to sVbkVl4OznxBCfi66UB9vw
sVbkVl4OznxBCfi66UB9vw collected $0.60 from pot
*** SUMMARY ***
Total pot $0.60 | Rake $0 
Seat 1: sVbkVl4OznxBCfi66UB9vw (button) collected ($0.60)
Seat 2: BedjMfrlRfPgSq7CXpPAmg (small blind) folded before Flop
Seat 3: FStoHe64SQWqAsjya9pDkQ (big blind) folded before Flop
Seat 4: uWjhTVMpuIroxXcmD3Okug folded before Flop (didn't bet)
Seat 5: oBUDUfeUyCbZBsjxHZgSiw folded before Flop (didn't bet)
Seat 6: lYjWCpfCxX2kgcHY3v4Yow folded before Flop (didn't bet)




PokerStars Game #59939433716:  Hold'em No Limit ($0.10/$0.25) - 2009/07/01 0:39:45 ET
Table 'CBnRhp0d6E2+/NtM7Vbruw' 9-max Seat #7 is the button
Seat 1: WQe4GbiYBiPsb5WKFKkijQ ($5 in chips) 
Seat 2: DIBbjEYGs+TVdVgEB/4+3w ($36.15 in chips) 
Seat 4: FR1anYnrxOdUfdNDELZ4SQ ($19.85 in chips) 
Seat 5: R6nIVAjK7uhK3Hj0f85A+A ($23.55 in chips) 
Seat 7: 40uIA6odSc6GeRu392xZTA ($31.85 in chips) 
Seat 8: MG90wfSJZnOejs/KD3vlQQ ($35.80 in chips) 
Seat 9: BHKu5wmAIC0UlfmA78se7A ($5 in chips) 
MG90wfSJZnOejs/KD3vlQQ: posts small blind $0.10
BHKu5wmAIC0UlfmA78se7A: posts big blind $0.25
*** HOLE CARDS ***
WQe4GbiYBiPsb5WKFKkijQ: raises $0.25 to $0.50
DIBbjEYGs+TVdVgEB/4+3w: folds 
FR1anYnrxOdUfdNDELZ4SQ: calls $0.50
R6nIVAjK7uhK3Hj0f85A+A: calls $0.50
40uIA6odSc6GeRu392xZTA: calls $0.50
MG90wfSJZnOejs/KD3vlQQ: folds 
BHKu5wmAIC0UlfmA78se7A: folds 
*** FLOP *** [Ts 8d 9d]
WQe4GbiYBiPsb5WKFKkijQ: checks 
FR1anYnrxOdUfdNDELZ4SQ: checks 
R6nIVAjK7uhK3Hj0f85A+A: checks 
40uIA6odSc6GeRu392xZTA: bets $0.75
WQe4GbiYBiPsb5WKFKkijQ: folds 
FR1anYnrxOdUfdNDELZ4SQ: folds 
R6nIVAjK7uhK3Hj0f85A+A: calls $0.75
*** TURN *** [Ts 8d 9d] [Tc]
R6nIVAjK7uhK3Hj0f85A+A: checks 
40uIA6odSc6GeRu392xZTA: bets $1
R6nIVAjK7uhK3Hj0f85A+A: calls $1
*** RIVER *** [Ts 8d 9d Tc] [Js]
aNpwfA31EREwO+ar4XzBCw was removed from the table for failing to post
R6nIVAjK7uhK3Hj0f85A+A: checks 
PqvgxdSg9z5VmrWpbYuz+g joins the table at seat #6 
40uIA6odSc6GeRu392xZTA: checks 
aNpwfA31EREwO+ar4XzBCw joins the table at seat #3 
*** SHOW DOWN ***
R6nIVAjK7uhK3Hj0f85A+A: shows [7s 9s] (a straight, Seven to Jack)
40uIA6odSc6GeRu392xZTA: mucks hand 
R6nIVAjK7uhK3Hj0f85A+A collected $5.60 from pot
*** SUMMARY ***
Total pot $5.85 | Rake $0.25 
Board [Ts 8d 9d Tc Js]
Seat 1: WQe4GbiYBiPsb5WKFKkijQ folded on the Flop
Seat 2: DIBbjEYGs+TVdVgEB/4+3w folded before Flop (didn't bet)
Seat 4: FR1anYnrxOdUfdNDELZ4SQ folded on the Flop
Seat 5: R6nIVAjK7uhK3Hj0f85A+A showed [7s 9s] and won ($5.60) with a straight, Seven to Jack
Seat 7: 40uIA6odSc6GeRu392xZTA (button) mucked
Seat 8: MG90wfSJZnOejs/KD3vlQQ (small blind) folded before Flop
Seat 9: BHKu5wmAIC0UlfmA78se7A (big blind) folded before Flop




PokerStars Game #59939433698:  Hold'em No Limit ($0.10/$0.25) - 2009/07/01 0:39:45 ET
Table '4mnXP0EWt9mMZYzTIVDQ0w' 9-max Seat #6 is the button
Seat 1: PTFwg4rGxnfVvj2iP1OI2w ($15.35 in chips) 
Seat 2: j4q3p0lesp63b1gZDwLBZw ($6.50 in chips) 
Seat 4: E0iYnEVO2ho7dH3QcCjw7g ($20.45 in chips) 
Seat 5: sSN8Y0AlsBeidZXPKmwXSw ($12.90 in chips) 
Seat 6: n9toqYXSLowQ/sWq842dEQ ($11.15 in chips) 
Seat 7: s1y+qfkBnhgc67+X3ThjeA ($24.65 in chips) 
Seat 8: H9KUl8cmpLgEpOVDA00bCg ($4.65 in chips) 
Seat 9: wbCayoP+N6xpKgOfIqZsbA ($22.20 in chips) 
s1y+qfkBnhgc67+X3ThjeA: posts small blind $0.10
H9KUl8cmpLgEpOVDA00bCg: posts big blind $0.25
*** HOLE CARDS ***
wbCayoP+N6xpKgOfIqZsbA: folds 
PTFwg4rGxnfVvj2iP1OI2w: folds 
j4q3p0lesp63b1gZDwLBZw: folds 
E0iYnEVO2ho7dH3QcCjw7g: folds 
sSN8Y0AlsBeidZXPKmwXSw: folds 
n9toqYXSLowQ/sWq842dEQ: raises $0.50 to $0.75
s1y+qfkBnhgc67+X3ThjeA: folds 
H9KUl8cmpLgEpOVDA00bCg: folds 
Uncalled bet ($0.50) returned to n9toqYXSLowQ/sWq842dEQ
n9toqYXSLowQ/sWq842dEQ collected $0.60 from pot
*** SUMMARY ***
Total pot $0.60 | Rake $0 
Seat 1: PTFwg4rGxnfVvj2iP1OI2w folded before Flop (didn't bet)
Seat 2: j4q3p0lesp63b1gZDwLBZw folded before Flop (didn't bet)
Seat 4: E0iYnEVO2ho7dH3QcCjw7g folded before Flop (didn't bet)
Seat 5: sSN8Y0AlsBeidZXPKmwXSw folded before Flop (didn't bet)
Seat 6: n9toqYXSLowQ/sWq842dEQ (button) collected ($0.60)
Seat 7: s1y+qfkBnhgc67+X3ThjeA (small blind) folded before Flop
Seat 8: H9KUl8cmpLgEpOVDA00bCg (big blind) folded before Flop
Seat 9: wbCayoP+N6xpKgOfIqZsbA folded before Flop (didn't bet)




PokerStars Game #59939433840:  Hold'em No Limit ($0.10/$0.25) - 2009/07/01 0:39:46 ET
Table 'S6s+TmTlAjLHclBRvN5/fw' 9-max Seat #9 is the button
Seat 1: /XMgGtJ7mcWfe5s7McY9kw ($24.70 in chips) 
Seat 2: GGVjFwYkbwsuyKljxyML4g ($12.50 in chips) 
Seat 3: imHPFFqvfHGzsBBWeGuy4w ($20.95 in chips) 
Seat 4: M/9j4wkHH9i1JM51vgi1VA ($38.95 in chips) 
Seat 5: z5GxcHlYz/GSz6W2uFiTtg ($25.05 in chips) 
Seat 6: aNpwfA31EREwO+ar4XzBCw ($25.20 in chips) 
Seat 7: vSkQm2EelzwRGDDQQk0Fqw ($5.65 in chips) 
Seat 9: BODayQmPi2rEfae9e6hIlw ($28 in chips) 
/XMgGtJ7mcWfe5s7McY9kw: posts small blind $0.10
GGVjFwYkbwsuyKljxyML4g: posts big blind $0.25
*** HOLE CARDS ***
imHPFFqvfHGzsBBWeGuy4w: folds 
M/9j4wkHH9i1JM51vgi1VA: folds 
z5GxcHlYz/GSz6W2uFiTtg: folds 
aNpwfA31EREwO+ar4XzBCw: folds 
vSkQm2EelzwRGDDQQk0Fqw: folds 
BODayQmPi2rEfae9e6hIlw: raises $0.50 to $0.75
/XMgGtJ7mcWfe5s7McY9kw: folds 
GGVjFwYkbwsuyKljxyML4g: calls $0.50
*** FLOP *** [3h 2c Jd]
GGVjFwYkbwsuyKljxyML4g: checks 
BODayQmPi2rEfae9e6hIlw: checks 
*** TURN *** [3h 2c Jd] [Kc]
GGVjFwYkbwsuyKljxyML4g: checks 
BODayQmPi2rEfae9e6hIlw: bets $1
GGVjFwYkbwsuyKljxyML4g: folds 
Uncalled bet ($1) returned to BODayQmPi2rEfae9e6hIlw
BODayQmPi2rEfae9e6hIlw collected $1.55 from pot
BODayQmPi2rEfae9e6hIlw: doesn't show hand 
*** SUMMARY ***
Total pot $1.60 | Rake $0.05 
Board [3h 2c Jd Kc]
Seat 1: /XMgGtJ7mcWfe5s7McY9kw (small blind) folded before Flop
Seat 2: GGVjFwYkbwsuyKljxyML4g (big blind) folded on the Turn
Seat 3: imHPFFqvfHGzsBBWeGuy4w folded before Flop (didn't bet)
Seat 4: M/9j4wkHH9i1JM51vgi1VA folded before Flop (didn't bet)
Seat 5: z5GxcHlYz/GSz6W2uFiTtg folded before Flop (didn't bet)
Seat 6: aNpwfA31EREwO+ar4XzBCw folded before Flop (didn't bet)
Seat 7: vSkQm2EelzwRGDDQQk0Fqw folded before Flop (didn't bet)
Seat 9: BODayQmPi2rEfae9e6hIlw (button) collected ($1.55)




PokerStars Game #59939434080:  Hold'em No Limit ($0.10/$0.25) - 2009/07/01 0:39:46 ET
Table 'Y9EhDWuqWWQFM9SelXAj5g' 9-max Seat #4 is the button
Seat 1: zDrucyjVn5aeekNEc3cJrA ($19.70 in chips) 
Seat 2: nEg1b6MIksd/4x5eLY735g ($40.10 in chips) 
Seat 3: CbXUS6Z2rXZxL1AKduNtmQ ($25 in chips) 
Seat 4: 5MgYq10OC5iGoxQFwlJVuw ($15.05 in chips) 
Seat 5: LY5GvFqMlE3xxbG85bDqlw ($8.60 in chips) 
Seat 6: STkR8XvpjNv79OOMhrlh2w ($25 in chips) 
Seat 7: aNpwfA31EREwO+ar4XzBCw ($30.60 in chips) 
Seat 8: XDxyajtqmdag0QPvwcOG7Q ($9.85 in chips) 
Seat 9: K7bAhhMMJ/XcTmGaBZVfFQ ($25.40 in chips) 
LY5GvFqMlE3xxbG85bDqlw: posts small blind $0.10
STkR8XvpjNv79OOMhrlh2w: posts big blind $0.25
*** HOLE CARDS ***
aNpwfA31EREwO+ar4XzBCw: folds 
XDxyajtqmdag0QPvwcOG7Q: folds 
K7bAhhMMJ/XcTmGaBZVfFQ: folds 
zDrucyjVn5aeekNEc3cJrA: calls $0.25
nEg1b6MIksd/4x5eLY735g: folds 
CbXUS6Z2rXZxL1AKduNtmQ: folds 
5MgYq10OC5iGoxQFwlJVuw: folds 
LY5GvFqMlE3xxbG85bDqlw: calls $0.15
STkR8XvpjNv79OOMhrlh2w: checks 
*** FLOP *** [Qs 5d Qc]
LY5GvFqMlE3xxbG85bDqlw: checks 
STkR8XvpjNv79OOMhrlh2w: checks 
zDrucyjVn5aeekNEc3cJrA: checks 
*** TURN *** [Qs 5d Qc] [2d]
LY5GvFqMlE3xxbG85bDqlw: bets $0.25
STkR8XvpjNv79OOMhrlh2w: calls $0.25
zDrucyjVn5aeekNEc3cJrA: folds 
*** RIVER *** [Qs 5d Qc 2d] [Kh]
LY5GvFqMlE3xxbG85bDqlw: bets $0.25
STkR8XvpjNv79OOMhrlh2w: raises $0.75 to $1
LY5GvFqMlE3xxbG85bDqlw: calls $0.75
*** SHOW DOWN ***
STkR8XvpjNv79OOMhrlh2w: shows [Qd 8c] (three of a kind, Queens)
LY5GvFqMlE3xxbG85bDqlw: mucks hand 
STkR8XvpjNv79OOMhrlh2w collected $3.10 from pot
*** SUMMARY ***
Total pot $3.25 | Rake $0.15 
Board [Qs 5d Qc 2d Kh]
Seat 1: zDrucyjVn5aeekNEc3cJrA folded on the Turn
Seat 2: nEg1b6MIksd/4x5eLY735g folded before Flop (didn't bet)
Seat 3: CbXUS6Z2rXZxL1AKduNtmQ folded before Flop (didn't bet)
Seat 4: 5MgYq10OC5iGoxQFwlJVuw (button) folded before Flop (didn't bet)
Seat 5: LY5GvFqMlE3xxbG85bDqlw (small blind) mucked
Seat 6: STkR8XvpjNv79OOMhrlh2w (big blind) showed [Qd 8c] and won ($3.10) with three of a kind, Queens
Seat 7: aNpwfA31EREwO+ar4XzBCw folded before Flop (didn't bet)
Seat 8: XDxyajtqmdag0QPvwcOG7Q folded before Flop (didn't bet)
Seat 9: K7bAhhMMJ/XcTmGaBZVfFQ folded before Flop (didn't bet)




PokerStars Game #59939434238:  Hold'em No Limit ($0.10/$0.25) - 2009/07/01 0:39:46 ET
Table '+198VWQSWBhYQOcizzuBkw' 6-max Seat #4 is the button
Seat 2: R6AGToFJQOYVZAjC2jXEKw ($29.05 in chips) 
Seat 3: BYxjLnV1/LL0aZcTbfAOvw ($27.25 in chips) 
Seat 4: TgDsTeCdLQt8kWbL00ByRA ($27.25 in chips) 
Seat 5: LtASJ9OlkqGrrUKGQlpGAw ($30.40 in chips) 
Seat 6: 7qRk4YH4/k/08LgJSv7rBQ ($31.25 in chips) 
LtASJ9OlkqGrrUKGQlpGAw: posts small blind $0.10
7qRk4YH4/k/08LgJSv7rBQ: posts big blind $0.25
*** HOLE CARDS ***
R6AGToFJQOYVZAjC2jXEKw: folds 
BYxjLnV1/LL0aZcTbfAOvw: folds 
TgDsTeCdLQt8kWbL00ByRA: folds 
LtASJ9OlkqGrrUKGQlpGAw: folds 
Uncalled bet ($0.15) returned to 7qRk4YH4/k/08LgJSv7rBQ
7qRk4YH4/k/08LgJSv7rBQ collected $0.20 from pot
7qRk4YH4/k/08LgJSv7rBQ: doesn't show hand 
*** SUMMARY ***
Total pot $0.20 | Rake $0 
Seat 2: R6AGToFJQOYVZAjC2jXEKw folded before Flop (didn't bet)
Seat 3: BYxjLnV1/LL0aZcTbfAOvw folded before Flop (didn't bet)
Seat 4: TgDsTeCdLQt8kWbL00ByRA (button) folded before Flop (didn't bet)
Seat 5: LtASJ9OlkqGrrUKGQlpGAw (small blind) folded before Flop
Seat 6: 7qRk4YH4/k/08LgJSv7rBQ (big blind) collected ($0.20)




PokerStars Game #59939434282:  Hold'em No Limit ($0.10/$0.25) - 2009/07/01 0:39:46 ET
Table 'JJzUs04lHpXg6nboT1/jeg' 6-max Seat #5 is the button
Seat 3: uUXdcVMNa05rfbntdvplfw ($10.70 in chips) 
Seat 4: nwwpaieDRI0UPyVtChVHOg ($36.35 in chips) 
Seat 5: Vr2XE7yYBdg3RZSURDAPEg ($23.50 in chips) 
hcarral will be allowed to play after the button
uUXdcVMNa05rfbntdvplfw: posts small blind $0.10
nwwpaieDRI0UPyVtChVHOg: posts big blind $0.25
*** HOLE CARDS ***
Vr2XE7yYBdg3RZSURDAPEg: folds 
uUXdcVMNa05rfbntdvplfw: calls $0.15
nwwpaieDRI0UPyVtChVHOg: checks 
*** FLOP *** [2h 9h 4s]
uUXdcVMNa05rfbntdvplfw: bets $0.25
nwwpaieDRI0UPyVtChVHOg: folds 
Uncalled bet ($0.25) returned to uUXdcVMNa05rfbntdvplfw
uUXdcVMNa05rfbntdvplfw collected $0.50 from pot
*** SUMMARY ***
Total pot $0.50 | Rake $0 
Board [2h 9h 4s]
Seat 3: uUXdcVMNa05rfbntdvplfw (small blind) collected ($0.50)
Seat 4: nwwpaieDRI0UPyVtChVHOg (big blind) folded on the Flop
Seat 5: Vr2XE7yYBdg3RZSURDAPEg (button) folded before Flop (didn't bet)




PokerStars Game #59939434518:  Hold'em No Limit ($0.10/$0.25) - 2009/07/01 0:39:47 ET
Table 'pgrBYaOEx/BuqK5iAtlFzw' 9-max Seat #3 is the button
Seat 1: QsLvCwfSWqP+CfjwUnjpXQ ($15 in chips) 
Seat 3: bfSq6LBw0UvxeM5yfuWC7w ($8.35 in chips) 
Seat 5: efYVL4adq0ufQFnZCpL5Tw ($11.40 in chips) 
efYVL4adq0ufQFnZCpL5Tw: posts small blind $0.10
QsLvCwfSWqP+CfjwUnjpXQ: posts big blind $0.25
*** HOLE CARDS ***
bfSq6LBw0UvxeM5yfuWC7w: folds 
bfSq6LBw0UvxeM5yfuWC7w leaves the table
efYVL4adq0ufQFnZCpL5Tw: calls $0.15
QsLvCwfSWqP+CfjwUnjpXQ: checks 
*** FLOP *** [3h 6d 6s]
efYVL4adq0ufQFnZCpL5Tw: checks 
QsLvCwfSWqP+CfjwUnjpXQ: checks 
*** TURN *** [3h 6d 6s] [Ks]
efYVL4adq0ufQFnZCpL5Tw: checks 
QsLvCwfSWqP+CfjwUnjpXQ: bets $0.25
jensen770 joins the table at seat #4 
efYVL4adq0ufQFnZCpL5Tw: folds 
Uncalled bet ($0.25) returned to QsLvCwfSWqP+CfjwUnjpXQ
QsLvCwfSWqP+CfjwUnjpXQ collected $0.50 from pot
*** SUMMARY ***
Total pot $0.50 | Rake $0 
Board [3h 6d 6s Ks]
Seat 1: QsLvCwfSWqP+CfjwUnjpXQ (big blind) collected ($0.50)
Seat 3: bfSq6LBw0UvxeM5yfuWC7w (button) folded before Flop (didn't bet)
Seat 5: efYVL4adq0ufQFnZCpL5Tw (small blind) folded on the Turn




PokerStars Game #59939434770:  Hold'em No Limit ($0.10/$0.25) - 2009/07/01 0:39:47 ET
Table 'IIO2q2znuuAXmiZ2qFTcmg' 6-max Seat #2 is the button
Seat 1: nwwpaieDRI0UPyVtChVHOg ($17.75 in chips) 
Seat 2: cS21pIxRHx5Gt42o7hPZzw ($14.10 in chips) 
Seat 3: hiTEr3yrERiQp3zHXRioVw ($14.50 in chips) 
Seat 4: 0HIrwssk0FQvyKULzUTtlg ($11.35 in chips) 
Seat 5: f9iRHw0d+kV7pbTYwF2+2g ($17.80 in chips) 
hiTEr3yrERiQp3zHXRioVw: posts small blind $0.10
0HIrwssk0FQvyKULzUTtlg: posts big blind $0.25
*** HOLE CARDS ***
f9iRHw0d+kV7pbTYwF2+2g: folds 
nwwpaieDRI0UPyVtChVHOg: folds 
cS21pIxRHx5Gt42o7hPZzw: calls $0.25
hiTEr3yrERiQp3zHXRioVw: folds 
0HIrwssk0FQvyKULzUTtlg: raises $0.50 to $0.75
cS21pIxRHx5Gt42o7hPZzw: calls $0.50
*** FLOP *** [Ts Qh 5d]
0HIrwssk0FQvyKULzUTtlg: checks 
cS21pIxRHx5Gt42o7hPZzw: checks 
*** TURN *** [Ts Qh 5d] [2d]
0HIrwssk0FQvyKULzUTtlg: bets $0.75
cS21pIxRHx5Gt42o7hPZzw: calls $0.75
*** RIVER *** [Ts Qh 5d 2d] [4h]
0HIrwssk0FQvyKULzUTtlg: checks 
cS21pIxRHx5Gt42o7hPZzw: checks 
*** SHOW DOWN ***
0HIrwssk0FQvyKULzUTtlg: shows [3c 3d] (a pair of Threes)
cS21pIxRHx5Gt42o7hPZzw: shows [Ac 4s] (a pair of Fours)
cS21pIxRHx5Gt42o7hPZzw collected $2.95 from pot
*** SUMMARY ***
Total pot $3.10 | Rake $0.15 
Board [Ts Qh 5d 2d 4h]
Seat 1: nwwpaieDRI0UPyVtChVHOg folded before Flop (didn't bet)
Seat 2: cS21pIxRHx5Gt42o7hPZzw (button) showed [Ac 4s] and won ($2.95) with a pair of Fours
Seat 3: hiTEr3yrERiQp3zHXRioVw (small blind) folded before Flop
Seat 4: 0HIrwssk0FQvyKULzUTtlg (big blind) showed [3c 3d] and lost with a pair of Threes
Seat 5: f9iRHw0d+kV7pbTYwF2+2g folded before Flop (didn't bet)




PokerStars Game #59939434652:  Hold'em No Limit ($0.10/$0.25) - 2009/07/01 0:39:47 ET
Table 'Qr+t8WGovMECkBv+cV1lrg' 6-max Seat #5 is the button
Seat 1: wFKQltIqUcrrkvre6g+fyw ($34.25 in chips) 
Seat 2: i48129QFpEQQ+UN4aNtmww ($5.30 in chips) 
Seat 3: bjJnMpKgoF+vgHW2f1NCsg ($18.50 in chips) 
Seat 4: 3rlIjSrvbZoI2IILbnetnA ($25.40 in chips) 
Seat 5: iwlxXocltgSdaBmusNXanQ ($14.50 in chips) 
Seat 6: j5NZbEJHsERuXjPHWqc1Nw ($20.25 in chips) 
j5NZbEJHsERuXjPHWqc1Nw: posts small blind $0.10
wFKQltIqUcrrkvre6g+fyw: posts big blind $0.25
*** HOLE CARDS ***
i48129QFpEQQ+UN4aNtmww: folds 
bjJnMpKgoF+vgHW2f1NCsg: folds 
3rlIjSrvbZoI2IILbnetnA: folds 
iwlxXocltgSdaBmusNXanQ: raises $0.50 to $0.75
j5NZbEJHsERuXjPHWqc1Nw: folds 
wFKQltIqUcrrkvre6g+fyw: folds 
Uncalled bet ($0.50) returned to iwlxXocltgSdaBmusNXanQ
iwlxXocltgSdaBmusNXanQ collected $0.60 from pot
*** SUMMARY ***
Total pot $0.60 | Rake $0 
Seat 1: wFKQltIqUcrrkvre6g+fyw (big blind) folded before Flop
Seat 2: i48129QFpEQQ+UN4aNtmww folded before Flop (didn't bet)
Seat 3: bjJnMpKgoF+vgHW2f1NCsg folded before Flop (didn't bet)
Seat 4: 3rlIjSrvbZoI2IILbnetnA folded before Flop (didn't bet)
Seat 5: iwlxXocltgSdaBmusNXanQ (button) collected ($0.60)
Seat 6: j5NZbEJHsERuXjPHWqc1Nw (small blind) folded before Flop




PokerStars Game #59939434512:  Hold'em No Limit ($0.10/$0.25) - 2009/07/01 0:39:47 ET
Table '3Ns9nuTkynfwbBfBXzg6ww' 6-max Seat #5 is the button
Seat 4: kyRaCIljYA6l33lSKQfNsg ($27.75 in chips) 
Seat 5: kBQU/db00TVAMeomlhblPg ($21.95 in chips) 
kBQU/db00TVAMeomlhblPg: posts small blind $0.10
6PDO6dptGq0XLL8zHWIhgw: is sitting out 
6PDO6dptGq0XLL8zHWIhgw leaves the table
kyRaCIljYA6l33lSKQfNsg: posts big blind $0.25
*** HOLE CARDS ***
kBQU/db00TVAMeomlhblPg: calls $0.15
kyRaCIljYA6l33lSKQfNsg: checks 
*** FLOP *** [8h 6d Kh]
masseman12 joins the table at seat #3 
kyRaCIljYA6l33lSKQfNsg: checks 
kBQU/db00TVAMeomlhblPg: checks 
*** TURN *** [8h 6d Kh] [Kc]
kyRaCIljYA6l33lSKQfNsg: checks 
kBQU/db00TVAMeomlhblPg: bets $0.75
kyRaCIljYA6l33lSKQfNsg: folds 
Uncalled bet ($0.75) returned to kBQU/db00TVAMeomlhblPg
kBQU/db00TVAMeomlhblPg collected $0.50 from pot
*** SUMMARY ***
Total pot $0.50 | Rake $0 
Board [8h 6d Kh Kc]
Seat 4: kyRaCIljYA6l33lSKQfNsg (big blind) folded on the Turn
Seat 5: kBQU/db00TVAMeomlhblPg (button) (small blind) collected ($0.50)




PokerStars Game #59939434576:  Hold'em No Limit ($0.10/$0.25) - 2009/07/01 0:39:47 ET
Table 'dNYnr4D4id1jwnEU66Yowg' 9-max Seat #5 is the button
Seat 2: t2nb95S5EEFOEzNx9Itz0g ($5.85 in chips) 
Seat 5: k+2r6di6GXjNpAdrRkW9bA ($25 in chips) 
k+2r6di6GXjNpAdrRkW9bA: posts small blind $0.10
t2nb95S5EEFOEzNx9Itz0g: posts big blind $0.25
*** HOLE CARDS ***
kqpa/IbqkUrwPb3hbA7/ww leaves the table
k+2r6di6GXjNpAdrRkW9bA: calls $0.15
t2nb95S5EEFOEzNx9Itz0g: checks 
*** FLOP *** [Qh 8c 5d]
dave ruger joins the table at seat #1 
t2nb95S5EEFOEzNx9Itz0g: bets $0.50
k+2r6di6GXjNpAdrRkW9bA: folds 
Uncalled bet ($0.50) returned to t2nb95S5EEFOEzNx9Itz0g
t2nb95S5EEFOEzNx9Itz0g collected $0.50 from pot
t2nb95S5EEFOEzNx9Itz0g: doesn't show hand 
*** SUMMARY ***
Total pot $0.50 | Rake $0 
Board [Qh 8c 5d]
Seat 2: t2nb95S5EEFOEzNx9Itz0g (big blind) collected ($0.50)
Seat 5: k+2r6di6GXjNpAdrRkW9bA (button) (small blind) folded on the Flop




PokerStars Game #59939434974:  Hold'em No Limit ($0.10/$0.25) - 2009/07/01 0:39:47 ET
Table 'YlRA05h9BJ1EhOUSNUjJdg' 9-max Seat #7 is the button
Seat 1: 5gHh6iDvZdEvYi59Pko1iA ($5 in chips) 
Seat 2: Y2GFAe+PT7xnUUtgqCNDFw ($19.20 in chips) 
Seat 3: C91Mv1usdi9Vq9ljlQVsug ($54.30 in chips) 
Seat 4: HPEB+AtKw1+C/cxU0o1ciw ($30.70 in chips) 
Seat 5: oKO7b50N6TzXbPBr/mcrUA ($24.05 in chips) 
Seat 6: GMMsoUkaAAY5/vm1Kmh9pA ($13.70 in chips) 
Seat 7: oVDuzcEt1umAPOB/u6ZH9g ($25.35 in chips) 
Seat 8: j4q3p0lesp63b1gZDwLBZw ($5 in chips) 
Seat 9: hBMUlEpyU74r/fwDgIpXjQ ($25 in chips) 
j4q3p0lesp63b1gZDwLBZw: posts small blind $0.10
hBMUlEpyU74r/fwDgIpXjQ: posts big blind $0.25
5gHh6iDvZdEvYi59Pko1iA: posts big blind $0.25
*** HOLE CARDS ***
5gHh6iDvZdEvYi59Pko1iA: checks 
Y2GFAe+PT7xnUUtgqCNDFw: calls $0.25
C91Mv1usdi9Vq9ljlQVsug: folds 
HPEB+AtKw1+C/cxU0o1ciw: folds 
oKO7b50N6TzXbPBr/mcrUA: folds 
GMMsoUkaAAY5/vm1Kmh9pA: folds 
oVDuzcEt1umAPOB/u6ZH9g: folds 
j4q3p0lesp63b1gZDwLBZw: folds 
hBMUlEpyU74r/fwDgIpXjQ: checks 
*** FLOP *** [9d 4c 7h]
hBMUlEpyU74r/fwDgIpXjQ: checks 
5gHh6iDvZdEvYi59Pko1iA: checks 
Y2GFAe+PT7xnUUtgqCNDFw: bets $0.50
hBMUlEpyU74r/fwDgIpXjQ: folds 
5gHh6iDvZdEvYi59Pko1iA: folds 
Uncalled bet ($0.50) returned to Y2GFAe+PT7xnUUtgqCNDFw
Y2GFAe+PT7xnUUtgqCNDFw collected $0.85 from pot
Y2GFAe+PT7xnUUtgqCNDFw: doesn't show hand 
*** SUMMARY ***
Total pot $0.85 | Rake $0 
Board [9d 4c 7h]
Seat 1: 5gHh6iDvZdEvYi59Pko1iA folded on the Flop
Seat 2: Y2GFAe+PT7xnUUtgqCNDFw collected ($0.85)
Seat 3: C91Mv1usdi9Vq9ljlQVsug folded before Flop (didn't bet)
Seat 4: HPEB+AtKw1+C/cxU0o1ciw folded before Flop (didn't bet)
Seat 5: oKO7b50N6TzXbPBr/mcrUA folded before Flop (didn't bet)
Seat 6: GMMsoUkaAAY5/vm1Kmh9pA folded before Flop (didn't bet)
Seat 7: oVDuzcEt1umAPOB/u6ZH9g (button) folded before Flop (didn't bet)
Seat 8: j4q3p0lesp63b1gZDwLBZw (small blind) folded before Flop
Seat 9: hBMUlEpyU74r/fwDgIpXjQ (big blind) folded on the Flop




PokerStars Game #59939434992:  Hold'em No Limit ($0.10/$0.25) - 2009/07/01 0:39:47 ET
Table '8Z6T3ssCpo3VV849U4RgBw' 9-max Seat #7 is the button
Seat 1: 8dNQBtNvCvzVgSnmDgi/LA ($12 in chips) 
Seat 2: st9jtdNbm1W5GfBwRaCVqQ ($25.80 in chips) 
Seat 3: DdPXdieucQ+n99u1n3A+rQ ($3.95 in chips) 
Seat 4: swWFmLwqgpSU1P6HAmCGPw ($16.75 in chips) 
Seat 5: zDrucyjVn5aeekNEc3cJrA ($23.55 in chips) 
Seat 6: SXqVW4Q0evTUVZG6BbUNIA ($33.05 in chips) 
Seat 7: VBHxUExRAMrbxUq/cVx9Gw ($4.65 in chips) 
Seat 8: hPhp/RE3cJ5YGaQ2xOHXXg ($5 in chips) 
Seat 9: yfkbMbx4w7MXhQDFPxOq0A ($12.65 in chips) 
hPhp/RE3cJ5YGaQ2xOHXXg: posts small blind $0.10
yfkbMbx4w7MXhQDFPxOq0A: posts big blind $0.25
*** HOLE CARDS ***
8dNQBtNvCvzVgSnmDgi/LA: folds 
st9jtdNbm1W5GfBwRaCVqQ: folds 
DdPXdieucQ+n99u1n3A+rQ: folds 
swWFmLwqgpSU1P6HAmCGPw: folds 
zDrucyjVn5aeekNEc3cJrA: folds 
SXqVW4Q0evTUVZG6BbUNIA: folds 
VBHxUExRAMrbxUq/cVx9Gw: folds 
hPhp/RE3cJ5YGaQ2xOHXXg: folds 
Uncalled bet ($0.15) returned to yfkbMbx4w7MXhQDFPxOq0A
yfkbMbx4w7MXhQDFPxOq0A collected $0.20 from pot
*** SUMMARY ***
Total pot $0.20 | Rake $0 
Seat 1: 8dNQBtNvCvzVgSnmDgi/LA folded before Flop (didn't bet)
Seat 2: st9jtdNbm1W5GfBwRaCVqQ folded before Flop (didn't bet)
Seat 3: DdPXdieucQ+n99u1n3A+rQ folded before Flop (didn't bet)
Seat 4: swWFmLwqgpSU1P6HAmCGPw folded before Flop (didn't bet)
Seat 5: zDrucyjVn5aeekNEc3cJrA folded before Flop (didn't bet)
Seat 6: SXqVW4Q0evTUVZG6BbUNIA folded before Flop (didn't bet)
Seat 7: VBHxUExRAMrbxUq/cVx9Gw (button) folded before Flop (didn't bet)
Seat 8: hPhp/RE3cJ5YGaQ2xOHXXg (small blind) folded before Flop
Seat 9: yfkbMbx4w7MXhQDFPxOq0A (big blind) collected ($0.20)




PokerStars Game #59939434470:  Hold'em No Limit ($0.10/$0.25) - 2009/07/01 0:39:47 ET
Table 'IrJPyZ3JW2iIa+krdoSbJQ' 9-max Seat #2 is the button
Seat 1: 4+E2msto8r80F3SH2gctVA ($25.10 in chips) 
Seat 2: DdPXdieucQ+n99u1n3A+rQ ($4.70 in chips) 
Seat 3: vZGoOTJLQLhkPj4I+LNGig ($25 in chips) 
Seat 4: DnDcAdn9P0zGovMERigpFA ($25 in chips) 
Seat 5: sUVgUtgbfVx6JpvApozwhQ ($5.40 in chips) 
Seat 6: +sbyWwIcFp9kP0bDtMegfQ ($24.30 in chips) 
Seat 7: uH1RN27w9SKa7TpVR9EFrQ ($27.90 in chips) 
Seat 8: VBHxUExRAMrbxUq/cVx9Gw ($5 in chips) 
Seat 9: SXqVW4Q0evTUVZG6BbUNIA ($29.30 in chips) 
vZGoOTJLQLhkPj4I+LNGig: posts small blind $0.10
DnDcAdn9P0zGovMERigpFA: posts big blind $0.25
*** HOLE CARDS ***
sUVgUtgbfVx6JpvApozwhQ: folds 
+sbyWwIcFp9kP0bDtMegfQ: folds 
uH1RN27w9SKa7TpVR9EFrQ: calls $0.25
VBHxUExRAMrbxUq/cVx9Gw: folds 
SXqVW4Q0evTUVZG6BbUNIA: folds 
4+E2msto8r80F3SH2gctVA: folds 
DdPXdieucQ+n99u1n3A+rQ: raises $1 to $1.25
vZGoOTJLQLhkPj4I+LNGig: folds 
DnDcAdn9P0zGovMERigpFA: folds 
uH1RN27w9SKa7TpVR9EFrQ: raises $4 to $5.25
DdPXdieucQ+n99u1n3A+rQ: calls $3.45 and is all-in
Uncalled bet ($0.55) returned to uH1RN27w9SKa7TpVR9EFrQ
*** FLOP *** [Qh 2c 4s]
*** TURN *** [Qh 2c 4s] [5d]
*** RIVER *** [Qh 2c 4s 5d] [4c]
*** SHOW DOWN ***
uH1RN27w9SKa7TpVR9EFrQ: shows [Jc Js] (two pair, Jacks and Fours)
DdPXdieucQ+n99u1n3A+rQ: shows [Qd As] (two pair, Queens and Fours)
DdPXdieucQ+n99u1n3A+rQ collected $9.30 from pot
*** SUMMARY ***
Total pot $9.75 | Rake $0.45 
Board [Qh 2c 4s 5d 4c]
Seat 1: 4+E2msto8r80F3SH2gctVA folded before Flop (didn't bet)
Seat 2: DdPXdieucQ+n99u1n3A+rQ (button) showed [Qd As] and won ($9.30) with two pair, Queens and Fours
Seat 3: vZGoOTJLQLhkPj4I+LNGig (small blind) folded before Flop
Seat 4: DnDcAdn9P0zGovMERigpFA (big blind) folded before Flop
Seat 5: sUVgUtgbfVx6JpvApozwhQ folded before Flop (didn't bet)
Seat 6: +sbyWwIcFp9kP0bDtMegfQ folded before Flop (didn't bet)
Seat 7: uH1RN27w9SKa7TpVR9EFrQ showed [Jc Js] and lost with two pair, Jacks and Fours
Seat 8: VBHxUExRAMrbxUq/cVx9Gw folded before Flop (didn't bet)
Seat 9: SXqVW4Q0evTUVZG6BbUNIA folded before Flop (didn't bet)




PokerStars Game #59939434608:  Hold'em No Limit ($0.10/$0.25) - 2009/07/01 0:39:47 ET
Table 'KRiZ8S/xwAYkA4EWSX89ow' 9-max Seat #8 is the button
Seat 1: CYkY0dNBaYaKs8HVCVn3mQ ($5.35 in chips) 
Seat 2: vZGoOTJLQLhkPj4I+LNGig ($53.45 in chips) 
Seat 3: /fionJv+b9tkuIj/KKbXYw ($25.95 in chips) 
Seat 4: COsrwJSFHQtxlUcrYtDQPQ ($27.20 in chips) 
Seat 5: t2nb95S5EEFOEzNx9Itz0g ($5.30 in chips) 
Seat 6: DdPXdieucQ+n99u1n3A+rQ ($5.60 in chips) 
Seat 7: cZ99hugmLBj9KhTlc8nCSw ($25 in chips) 
Seat 8: nEg1b6MIksd/4x5eLY735g ($25.60 in chips) 
Seat 9: EcWpc/mcsCWBGKsSdZaXbA ($24.15 in chips) 
EcWpc/mcsCWBGKsSdZaXbA: posts small blind $0.10
CYkY0dNBaYaKs8HVCVn3mQ: posts big blind $0.25
*** HOLE CARDS ***
vZGoOTJLQLhkPj4I+LNGig: folds 
/fionJv+b9tkuIj/KKbXYw: folds 
COsrwJSFHQtxlUcrYtDQPQ: folds 
t2nb95S5EEFOEzNx9Itz0g: folds 
DdPXdieucQ+n99u1n3A+rQ: folds 
cZ99hugmLBj9KhTlc8nCSw: folds 
nEg1b6MIksd/4x5eLY735g: folds 
EcWpc/mcsCWBGKsSdZaXbA: folds 
Uncalled bet ($0.15) returned to CYkY0dNBaYaKs8HVCVn3mQ
CYkY0dNBaYaKs8HVCVn3mQ collected $0.20 from pot
CYkY0dNBaYaKs8HVCVn3mQ: doesn't show hand 
*** SUMMARY ***
Total pot $0.20 | Rake $0 
Seat 1: CYkY0dNBaYaKs8HVCVn3mQ (big blind) collected ($0.20)
Seat 2: vZGoOTJLQLhkPj4I+LNGig folded before Flop (didn't bet)
Seat 3: /fionJv+b9tkuIj/KKbXYw folded before Flop (didn't bet)
Seat 4: COsrwJSFHQtxlUcrYtDQPQ folded before Flop (didn't bet)
Seat 5: t2nb95S5EEFOEzNx9Itz0g folded before Flop (didn't bet)
Seat 6: DdPXdieucQ+n99u1n3A+rQ folded before Flop (didn't bet)
Seat 7: cZ99hugmLBj9KhTlc8nCSw folded before Flop (didn't bet)
Seat 8: nEg1b6MIksd/4x5eLY735g (button) folded before Flop (didn't bet)
Seat 9: EcWpc/mcsCWBGKsSdZaXbA (small blind) folded before Flop




PokerStars Game #59939435060:  Hold'em No Limit ($0.10/$0.25) - 2009/07/01 0:39:47 ET
Table 'dVzscin98UhGisTmV9BDcw' 9-max Seat #4 is the button
Seat 1: sBAwXpkpgyhyWbHIQcIJKA ($19.45 in chips) 
Seat 2: dfNim92Z6XK1/h5SFW5vDg ($29.15 in chips) 
Seat 3: 1Clf3cPrqoy/YgvWdWK1Xw ($5.25 in chips) 
Seat 4: aNpwfA31EREwO+ar4XzBCw ($25.25 in chips) 
Seat 5: ZMRQOoxoJ7Alx96gZhP2EQ ($65.55 in chips) 
Seat 6: hBMUlEpyU74r/fwDgIpXjQ ($25.25 in chips) 
Seat 7: nEg1b6MIksd/4x5eLY735g ($62.55 in chips) 
Seat 8: /vn2Qu2dvc9AMMq46Ae0jA ($5.70 in chips) 
Seat 9: OYa/ZJBO+suuezfWsUMhZw ($5.80 in chips) 
ZMRQOoxoJ7Alx96gZhP2EQ: posts small blind $0.10
hBMUlEpyU74r/fwDgIpXjQ: posts big blind $0.25
*** HOLE CARDS ***
nEg1b6MIksd/4x5eLY735g: raises $0.55 to $0.80
/vn2Qu2dvc9AMMq46Ae0jA: folds 
OYa/ZJBO+suuezfWsUMhZw: folds 
sBAwXpkpgyhyWbHIQcIJKA: folds 
dfNim92Z6XK1/h5SFW5vDg: folds 
1Clf3cPrqoy/YgvWdWK1Xw: folds 
aNpwfA31EREwO+ar4XzBCw: folds 
ZMRQOoxoJ7Alx96gZhP2EQ: folds 
hBMUlEpyU74r/fwDgIpXjQ: folds 
Uncalled bet ($0.55) returned to nEg1b6MIksd/4x5eLY735g
nEg1b6MIksd/4x5eLY735g collected $0.60 from pot
*** SUMMARY ***
Total pot $0.60 | Rake $0 
Seat 1: sBAwXpkpgyhyWbHIQcIJKA folded before Flop (didn't bet)
Seat 2: dfNim92Z6XK1/h5SFW5vDg folded before Flop (didn't bet)
Seat 3: 1Clf3cPrqoy/YgvWdWK1Xw folded before Flop (didn't bet)
Seat 4: aNpwfA31EREwO+ar4XzBCw (button) folded before Flop (didn't bet)
Seat 5: ZMRQOoxoJ7Alx96gZhP2EQ (small blind) folded before Flop
Seat 6: hBMUlEpyU74r/fwDgIpXjQ (big blind) folded before Flop
Seat 7: nEg1b6MIksd/4x5eLY735g collected ($0.60)
Seat 8: /vn2Qu2dvc9AMMq46Ae0jA folded before Flop (didn't bet)
Seat 9: OYa/ZJBO+suuezfWsUMhZw folded before Flop (didn't bet)




PokerStars Game #59939434490:  Hold'em No Limit ($0.10/$0.25) - 2009/07/01 0:39:47 ET
Table '+giHa6FUL6U5/AZnCJEGvQ' 9-max Seat #4 is the button
Seat 1: kYgmoJdHhyWAdwXflGZuKA ($35.45 in chips) 
Seat 2: YN6/TiJBEQVW8LDMQA1vFQ ($8.85 in chips) 
Seat 3: DIBbjEYGs+TVdVgEB/4+3w ($24.15 in chips) 
Seat 4: ljemhp25Zg+nlA9DLCIiUw ($50.35 in chips) 
Seat 5: zDrucyjVn5aeekNEc3cJrA ($47.25 in chips) 
Seat 6: cZ99hugmLBj9KhTlc8nCSw ($25 in chips) 
Seat 7: TeWJxSETzbXGiYKx0y+dtg ($24.55 in chips) 
Seat 8: t2nb95S5EEFOEzNx9Itz0g ($2.60 in chips) 
Seat 9: qwr38jl5txoR36M7G5qi4A ($7.50 in chips) 
zDrucyjVn5aeekNEc3cJrA: posts small blind $0.10
cZ99hugmLBj9KhTlc8nCSw: posts big blind $0.25
*** HOLE CARDS ***
TeWJxSETzbXGiYKx0y+dtg: folds 
t2nb95S5EEFOEzNx9Itz0g: folds 
qwr38jl5txoR36M7G5qi4A: folds 
kYgmoJdHhyWAdwXflGZuKA: raises $0.50 to $0.75
YN6/TiJBEQVW8LDMQA1vFQ: folds 
DIBbjEYGs+TVdVgEB/4+3w: folds 
ljemhp25Zg+nlA9DLCIiUw: folds 
zDrucyjVn5aeekNEc3cJrA: folds 
cZ99hugmLBj9KhTlc8nCSw: folds 
Uncalled bet ($0.50) returned to kYgmoJdHhyWAdwXflGZuKA
kYgmoJdHhyWAdwXflGZuKA collected $0.60 from pot
kYgmoJdHhyWAdwXflGZuKA: doesn't show hand 
*** SUMMARY ***
Total pot $0.60 | Rake $0 
Seat 1: kYgmoJdHhyWAdwXflGZuKA collected ($0.60)
Seat 2: YN6/TiJBEQVW8LDMQA1vFQ folded before Flop (didn't bet)
Seat 3: DIBbjEYGs+TVdVgEB/4+3w folded before Flop (didn't bet)
Seat 4: ljemhp25Zg+nlA9DLCIiUw (button) folded before Flop (didn't bet)
Seat 5: zDrucyjVn5aeekNEc3cJrA (small blind) folded before Flop
Seat 6: cZ99hugmLBj9KhTlc8nCSw (big blind) folded before Flop
Seat 7: TeWJxSETzbXGiYKx0y+dtg folded before Flop (didn't bet)
Seat 8: t2nb95S5EEFOEzNx9Itz0g folded before Flop (didn't bet)
Seat 9: qwr38jl5txoR36M7G5qi4A folded before Flop (didn't bet)




PokerStars Game #59939434802:  Hold'em No Limit ($0.10/$0.25) - 2009/07/01 0:39:47 ET
Table '3KDMdm1sfxFsNKkjc/PnBg' 9-max Seat #5 is the button
Seat 1: GQTWTgG7Ydy9q/vohVnKmQ ($25 in chips) 
Seat 2: rUpvA02nErFvZ4yFbDR8XA ($20.35 in chips) 
Seat 3: GftT+l+xjKzcY0rMiNZfPg ($27.30 in chips) 
Seat 4: 4xnojP+j2Tm8s9Bh7QC5+Q ($12.70 in chips) 
Seat 5: +2kMBNpY4nF1qNCRd8SJLA ($25 in chips) 
Seat 6: N1HHRe1nNMukTQB6qMn6Kw ($16.90 in chips) 
Seat 7: gehe91e0IyVT0QU/XBkEyg ($25 in chips) 
Seat 8: st9jtdNbm1W5GfBwRaCVqQ ($27.40 in chips) 
N1HHRe1nNMukTQB6qMn6Kw: posts small blind $0.10
gehe91e0IyVT0QU/XBkEyg: posts big blind $0.25
*** HOLE CARDS ***
st9jtdNbm1W5GfBwRaCVqQ: folds 
GQTWTgG7Ydy9q/vohVnKmQ: folds 
rUpvA02nErFvZ4yFbDR8XA: folds 
GftT+l+xjKzcY0rMiNZfPg: folds 
4xnojP+j2Tm8s9Bh7QC5+Q: folds 
+2kMBNpY4nF1qNCRd8SJLA: raises $0.75 to $1
N1HHRe1nNMukTQB6qMn6Kw: folds 
gehe91e0IyVT0QU/XBkEyg: folds 
Uncalled bet ($0.75) returned to +2kMBNpY4nF1qNCRd8SJLA
+2kMBNpY4nF1qNCRd8SJLA collected $0.60 from pot
*** SUMMARY ***
Total pot $0.60 | Rake $0 
Seat 1: GQTWTgG7Ydy9q/vohVnKmQ folded before Flop (didn't bet)
Seat 2: rUpvA02nErFvZ4yFbDR8XA folded before Flop (didn't bet)
Seat 3: GftT+l+xjKzcY0rMiNZfPg folded before Flop (didn't bet)
Seat 4: 4xnojP+j2Tm8s9Bh7QC5+Q folded before Flop (didn't bet)
Seat 5: +2kMBNpY4nF1qNCRd8SJLA (button) collected ($0.60)
Seat 6: N1HHRe1nNMukTQB6qMn6Kw (small blind) folded before Flop
Seat 7: gehe91e0IyVT0QU/XBkEyg (big blind) folded before Flop
Seat 8: st9jtdNbm1W5GfBwRaCVqQ folded before Flop (didn't bet)




PokerStars Game #59939434930:  Hold'em No Limit ($0.10/$0.25) - 2009/07/01 0:39:47 ET
Table 'sCop8wmj9zlSS2KJqk1QKQ' 9-max Seat #6 is the button
Seat 1: SXqVW4Q0evTUVZG6BbUNIA ($21.90 in chips) 
Seat 2: W4TLQcZ2TiM73eIgpIvlGg ($22.80 in chips) 
Seat 3: 6TWO15+WfJ5HfI8CbJ4a0w ($4.30 in chips) 
Seat 4: KNrY0Y/j01dK9gZK7dx7QA ($14.40 in chips) 
Seat 6: hZuGwtYmFKPmQ+v1wlmdfA ($35.45 in chips) 
Seat 7: 4dd+rKHhaMiTl5LEkADvQQ ($5 in chips) 
Seat 8: NNZypfH1f/VIj3Skf/XIzg ($4.75 in chips) 
Seat 9: tOdE7+08fkUzsTpCnhoPDA ($22.45 in chips) 
4dd+rKHhaMiTl5LEkADvQQ: posts small blind $0.10
NNZypfH1f/VIj3Skf/XIzg: posts big blind $0.25
sD+TKtt36XiiN6jqHiLwDA: sits out 
*** HOLE CARDS ***
tOdE7+08fkUzsTpCnhoPDA: calls $0.25
SXqVW4Q0evTUVZG6BbUNIA: folds 
W4TLQcZ2TiM73eIgpIvlGg: folds 
6TWO15+WfJ5HfI8CbJ4a0w: folds 
KNrY0Y/j01dK9gZK7dx7QA: folds 
hZuGwtYmFKPmQ+v1wlmdfA: raises $1 to $1.25
4dd+rKHhaMiTl5LEkADvQQ: folds 
NNZypfH1f/VIj3Skf/XIzg: raises $3.50 to $4.75 and is all-in
tOdE7+08fkUzsTpCnhoPDA: folds 
hZuGwtYmFKPmQ+v1wlmdfA: calls $3.50
*** FLOP *** [Jd 8d Kh]
*** TURN *** [Jd 8d Kh] [2d]
*** RIVER *** [Jd 8d Kh 2d] [9c]
*** SHOW DOWN ***
NNZypfH1f/VIj3Skf/XIzg: shows [6d 6s] (a pair of Sixes)
hZuGwtYmFKPmQ+v1wlmdfA: shows [Kc Ad] (a pair of Kings)
hZuGwtYmFKPmQ+v1wlmdfA collected $9.40 from pot
*** SUMMARY ***
Total pot $9.85 | Rake $0.45 
Board [Jd 8d Kh 2d 9c]
Seat 1: SXqVW4Q0evTUVZG6BbUNIA folded before Flop (didn't bet)
Seat 2: W4TLQcZ2TiM73eIgpIvlGg folded before Flop (didn't bet)
Seat 3: 6TWO15+WfJ5HfI8CbJ4a0w folded before Flop (didn't bet)
Seat 4: KNrY0Y/j01dK9gZK7dx7QA folded before Flop (didn't bet)
Seat 6: hZuGwtYmFKPmQ+v1wlmdfA (button) showed [Kc Ad] and won ($9.40) with a pair of Kings
Seat 7: 4dd+rKHhaMiTl5LEkADvQQ (small blind) folded before Flop
Seat 8: NNZypfH1f/VIj3Skf/XIzg (big blind) showed [6d 6s] and lost with a pair of Sixes
Seat 9: tOdE7+08fkUzsTpCnhoPDA folded before Flop




PokerStars Game #59939435088:  Hold'em No Limit ($0.10/$0.25) - 2009/07/01 0:39:47 ET
Table 'Ez9TB43XM4QgMDQkIW9DYw' 9-max Seat #3 is the button
Seat 1: YqWNLUj3exwMphJEDBi8Ug ($29.50 in chips) 
Seat 2: gtLY9BJ1dcPGyJ0NDNjaBg ($10.40 in chips) 
Seat 3: LorpmCSxb4uozpKwk8Awsg ($27.15 in chips) 
Seat 4: il+NK449FnwuQ8vyJ0Xn/g ($9.25 in chips) 
Seat 5: vZGoOTJLQLhkPj4I+LNGig ($25.60 in chips) 
Seat 6: 76o85YBHJ9veRYp2LPuluQ ($30.30 in chips) 
Seat 7: 18G4P1XstjNvItdGUITxgw ($25 in chips) 
Seat 9: QEbIGci+itdw+re8RM5fZA ($25 in chips) 
il+NK449FnwuQ8vyJ0Xn/g: posts small blind $0.10
vZGoOTJLQLhkPj4I+LNGig: posts big blind $0.25
+2kMBNpY4nF1qNCRd8SJLA: sits out 
*** HOLE CARDS ***
76o85YBHJ9veRYp2LPuluQ: calls $0.25
18G4P1XstjNvItdGUITxgw: folds 
QEbIGci+itdw+re8RM5fZA: folds 
YqWNLUj3exwMphJEDBi8Ug: calls $0.25
gtLY9BJ1dcPGyJ0NDNjaBg: folds 
LorpmCSxb4uozpKwk8Awsg: folds 
il+NK449FnwuQ8vyJ0Xn/g: calls $0.15
vZGoOTJLQLhkPj4I+LNGig: checks 
*** FLOP *** [Kc 6h 9s]
il+NK449FnwuQ8vyJ0Xn/g: checks 
vZGoOTJLQLhkPj4I+LNGig: checks 
76o85YBHJ9veRYp2LPuluQ: checks 
YqWNLUj3exwMphJEDBi8Ug: checks 
*** TURN *** [Kc 6h 9s] [As]
il+NK449FnwuQ8vyJ0Xn/g: checks 
vZGoOTJLQLhkPj4I+LNGig: checks 
76o85YBHJ9veRYp2LPuluQ: bets $0.50
YqWNLUj3exwMphJEDBi8Ug: folds 
il+NK449FnwuQ8vyJ0Xn/g: folds 
vZGoOTJLQLhkPj4I+LNGig: folds 
Uncalled bet ($0.50) returned to 76o85YBHJ9veRYp2LPuluQ
76o85YBHJ9veRYp2LPuluQ collected $0.95 from pot
76o85YBHJ9veRYp2LPuluQ: doesn't show hand 
*** SUMMARY ***
Total pot $1 | Rake $0.05 
Board [Kc 6h 9s As]
Seat 1: YqWNLUj3exwMphJEDBi8Ug folded on the Turn
Seat 2: gtLY9BJ1dcPGyJ0NDNjaBg folded before Flop (didn't bet)
Seat 3: LorpmCSxb4uozpKwk8Awsg (button) folded before Flop (didn't bet)
Seat 4: il+NK449FnwuQ8vyJ0Xn/g (small blind) folded on the Turn
Seat 5: vZGoOTJLQLhkPj4I+LNGig (big blind) folded on the Turn
Seat 6: 76o85YBHJ9veRYp2LPuluQ collected ($0.95)
Seat 7: 18G4P1XstjNvItdGUITxgw folded before Flop (didn't bet)
Seat 9: QEbIGci+itdw+re8RM5fZA folded before Flop (didn't bet)




PokerStars Game #59939435706:  Hold'em No Limit ($0.10/$0.25) - 2009/07/01 0:39:48 ET
Table 'u5gc8WdJbaPqEonQaM8rHA' 9-max Seat #1 is the button
Seat 1: rXm4QDVJt67H20lM6n6Z7Q ($8.40 in chips) 
Seat 2: YcYxPZXJR8KffyXgr1BkHw ($27.35 in chips) 
Seat 4: QBNV6v6f+1ZHoaKcQDTWog ($30 in chips) 
Seat 6: iPe2eRZr++z/LEfORn3WBQ ($17.05 in chips) 
YcYxPZXJR8KffyXgr1BkHw: posts small blind $0.10
QBNV6v6f+1ZHoaKcQDTWog: posts big blind $0.25
*** HOLE CARDS ***
golowa joins the table at seat #5 
iPe2eRZr++z/LEfORn3WBQ: folds 
rXm4QDVJt67H20lM6n6Z7Q: folds 
YcYxPZXJR8KffyXgr1BkHw: calls $0.15
QBNV6v6f+1ZHoaKcQDTWog: raises $0.25 to $0.50
YcYxPZXJR8KffyXgr1BkHw: calls $0.25
*** FLOP *** [Kh 5d 6h]
YcYxPZXJR8KffyXgr1BkHw: checks 
QBNV6v6f+1ZHoaKcQDTWog: checks 
*** TURN *** [Kh 5d 6h] [Ks]
YcYxPZXJR8KffyXgr1BkHw: checks 
QBNV6v6f+1ZHoaKcQDTWog: checks 
*** RIVER *** [Kh 5d 6h Ks] [7c]
YcYxPZXJR8KffyXgr1BkHw: checks 
QBNV6v6f+1ZHoaKcQDTWog: checks 
*** SHOW DOWN ***
YcYxPZXJR8KffyXgr1BkHw: shows [Js Ad] (a pair of Kings)
QBNV6v6f+1ZHoaKcQDTWog: mucks hand 
YcYxPZXJR8KffyXgr1BkHw collected $0.95 from pot
*** SUMMARY ***
Total pot $1 | Rake $0.05 
Board [Kh 5d 6h Ks 7c]
Seat 1: rXm4QDVJt67H20lM6n6Z7Q (button) folded before Flop (didn't bet)
Seat 2: YcYxPZXJR8KffyXgr1BkHw (small blind) showed [Js Ad] and won ($0.95) with a pair of Kings
Seat 4: QBNV6v6f+1ZHoaKcQDTWog (big blind) mucked
Seat 6: iPe2eRZr++z/LEfORn3WBQ folded before Flop (didn't bet)




PokerStars Game #59939435452:  Hold'em No Limit ($0.10/$0.25) - 2009/07/01 0:39:48 ET
Table 'ShgkxBDL5IvR1qjzfRNc0A' 6-max Seat #1 is the button
Seat 1: /gJNBeCkWL4o85/jvlZ4BA ($25 in chips) 
Seat 2: mfrkWA3PTeYPkbO6hi98Aw ($38.95 in chips) 
Seat 3: JXSfL0FgBM1dIFwHP09Hnw ($25 in chips) 
Seat 4: kG34n23qFQA3nzdOJTQ1dA ($24.75 in chips) 
Seat 5: ferjiUxLWPNUKxvl8/xD/g ($44.30 in chips) 
Seat 6: 5tB0F9NjPSUL4FzmzBMs2Q ($30.20 in chips) 
mfrkWA3PTeYPkbO6hi98Aw: posts small blind $0.10
JXSfL0FgBM1dIFwHP09Hnw: posts big blind $0.25
*** HOLE CARDS ***
kG34n23qFQA3nzdOJTQ1dA: folds 
ferjiUxLWPNUKxvl8/xD/g: folds 
5tB0F9NjPSUL4FzmzBMs2Q: folds 
/gJNBeCkWL4o85/jvlZ4BA: folds 
mfrkWA3PTeYPkbO6hi98Aw: folds 
Uncalled bet ($0.15) returned to JXSfL0FgBM1dIFwHP09Hnw
JXSfL0FgBM1dIFwHP09Hnw collected $0.20 from pot
JXSfL0FgBM1dIFwHP09Hnw: doesn't show hand 
*** SUMMARY ***
Total pot $0.20 | Rake $0 
Seat 1: /gJNBeCkWL4o85/jvlZ4BA (button) folded before Flop (didn't bet)
Seat 2: mfrkWA3PTeYPkbO6hi98Aw (small blind) folded before Flop
Seat 3: JXSfL0FgBM1dIFwHP09Hnw (big blind) collected ($0.20)
Seat 4: kG34n23qFQA3nzdOJTQ1dA folded before Flop (didn't bet)
Seat 5: ferjiUxLWPNUKxvl8/xD/g folded before Flop (didn't bet)
Seat 6: 5tB0F9NjPSUL4FzmzBMs2Q folded before Flop (didn't bet)




PokerStars Game #59939436102:  Hold'em No Limit ($0.10/$0.25) - 2009/07/01 0:39:49 ET
Table 'L5GvbdQO5aCZJSE6pyQ8OA' 6-max Seat #2 is the button
Seat 1: FOcO5GvOP3rgvLGPLVkg5g ($30.35 in chips) 
Seat 2: LxehwDpTQ19ph4Qmc78+Pw ($20.65 in chips) 
Seat 3: wKFJ513ucluNNiMlkXcDOQ ($25 in chips) 
Seat 4: ErIN0JRL5srYjT6en1f8YQ ($25 in chips) 
Seat 5: I60CfDZDrpMTu9pHHz8TFA ($68.10 in chips) 
Seat 6: v+QfkGiuj9bgtuNoVnDO8w ($35.25 in chips) 
wKFJ513ucluNNiMlkXcDOQ: posts small blind $0.10
ErIN0JRL5srYjT6en1f8YQ: posts big blind $0.25
*** HOLE CARDS ***
I60CfDZDrpMTu9pHHz8TFA: folds 
I60CfDZDrpMTu9pHHz8TFA leaves the table
v+QfkGiuj9bgtuNoVnDO8w: folds 
FOcO5GvOP3rgvLGPLVkg5g: folds 
LxehwDpTQ19ph4Qmc78+Pw: calls $0.25
wKFJ513ucluNNiMlkXcDOQ: raises $1.25 to $1.50
ErIN0JRL5srYjT6en1f8YQ: calls $1.25
LxehwDpTQ19ph4Qmc78+Pw: folds 
*** FLOP *** [5d As Kh]
kulemet joins the table at seat #5 
wKFJ513ucluNNiMlkXcDOQ: bets $2.30
ErIN0JRL5srYjT6en1f8YQ: calls $2.30
*** TURN *** [5d As Kh] [Kc]
wKFJ513ucluNNiMlkXcDOQ: checks 
ErIN0JRL5srYjT6en1f8YQ: checks 
*** RIVER *** [5d As Kh Kc] [Qh]
wKFJ513ucluNNiMlkXcDOQ: bets $3.25
ErIN0JRL5srYjT6en1f8YQ: folds 
Uncalled bet ($3.25) returned to wKFJ513ucluNNiMlkXcDOQ
wKFJ513ucluNNiMlkXcDOQ collected $7.50 from pot
wKFJ513ucluNNiMlkXcDOQ: doesn't show hand 
*** SUMMARY ***
Total pot $7.85 | Rake $0.35 
Board [5d As Kh Kc Qh]
Seat 1: FOcO5GvOP3rgvLGPLVkg5g folded before Flop (didn't bet)
Seat 2: LxehwDpTQ19ph4Qmc78+Pw (button) folded before Flop
Seat 3: wKFJ513ucluNNiMlkXcDOQ (small blind) collected ($7.50)
Seat 4: ErIN0JRL5srYjT6en1f8YQ (big blind) folded on the River
Seat 5: I60CfDZDrpMTu9pHHz8TFA folded before Flop (didn't bet)
Seat 6: v+QfkGiuj9bgtuNoVnDO8w folded before Flop (didn't bet)




PokerStars Game #59939436210:  Hold'em No Limit ($0.10/$0.25) - 2009/07/01 0:39:49 ET
Table 'IRgQPZVA4+IaZZIQshgwyg' 6-max Seat #6 is the button
Seat 1: d0J1xuhsynEY81YHwAvJ5g ($25.45 in chips) 
Seat 2: 9jSiy0meE9XJKkdIZwyTEQ ($35.45 in chips) 
Seat 3: 8EEqTTh7T1q48sYDqbI2Xg ($26.35 in chips) 
Seat 4: PXXRy0uk7WED5BEf+ReJDQ ($14.15 in chips) 
Seat 5: PbMzPZIePKifKQZfKDkbIw ($27.35 in chips) 
Seat 6: qo39V8/pMxxofM2aciLSWQ ($37.85 in chips) 
d0J1xuhsynEY81YHwAvJ5g: posts small blind $0.10
9jSiy0meE9XJKkdIZwyTEQ: posts big blind $0.25
*** HOLE CARDS ***
8EEqTTh7T1q48sYDqbI2Xg: calls $0.25
PXXRy0uk7WED5BEf+ReJDQ: folds 
PbMzPZIePKifKQZfKDkbIw: folds 
qo39V8/pMxxofM2aciLSWQ: folds 
d0J1xuhsynEY81YHwAvJ5g: calls $0.15
9jSiy0meE9XJKkdIZwyTEQ: checks 
*** FLOP *** [6h 6d 5h]
d0J1xuhsynEY81YHwAvJ5g: bets $0.50
9jSiy0meE9XJKkdIZwyTEQ: folds 
8EEqTTh7T1q48sYDqbI2Xg: calls $0.50
*** TURN *** [6h 6d 5h] [8s]
d0J1xuhsynEY81YHwAvJ5g: checks 
8EEqTTh7T1q48sYDqbI2Xg: bets $0.50
d0J1xuhsynEY81YHwAvJ5g: calls $0.50
*** RIVER *** [6h 6d 5h 8s] [Kd]
d0J1xuhsynEY81YHwAvJ5g: checks 
8EEqTTh7T1q48sYDqbI2Xg: checks 
*** SHOW DOWN ***
d0J1xuhsynEY81YHwAvJ5g: shows [As 5d] (two pair, Sixes and Fives)
8EEqTTh7T1q48sYDqbI2Xg: shows [Qh 8h] (two pair, Eights and Sixes)
8EEqTTh7T1q48sYDqbI2Xg collected $2.65 from pot
*** SUMMARY ***
Total pot $2.75 | Rake $0.10 
Board [6h 6d 5h 8s Kd]
Seat 1: d0J1xuhsynEY81YHwAvJ5g (small blind) showed [As 5d] and lost with two pair, Sixes and Fives
Seat 2: 9jSiy0meE9XJKkdIZwyTEQ (big blind) folded on the Flop
Seat 3: 8EEqTTh7T1q48sYDqbI2Xg showed [Qh 8h] and won ($2.65) with two pair, Eights and Sixes
Seat 4: PXXRy0uk7WED5BEf+ReJDQ folded before Flop (didn't bet)
Seat 5: PbMzPZIePKifKQZfKDkbIw folded before Flop (didn't bet)
Seat 6: qo39V8/pMxxofM2aciLSWQ (button) folded before Flop (didn't bet)




PokerStars Game #59939436126:  Hold'em No Limit ($0.10/$0.25) - 2009/07/01 0:39:49 ET
Table '0M5QEJGOThqZwQ/sjbjXYw' 6-max Seat #2 is the button
Seat 1: RVBrV53KVTJ2T2VL8ucnfw ($24.30 in chips) 
Seat 2: /gJNBeCkWL4o85/jvlZ4BA ($48.10 in chips) 
Seat 4: fZQg9veL7Dd/Z04ZTjC+wQ ($32.20 in chips) 
Seat 5: ErIN0JRL5srYjT6en1f8YQ ($26.85 in chips) 
Seat 6: mYz11CHiw5KsDCRD5T7/jg ($59.85 in chips) 
fZQg9veL7Dd/Z04ZTjC+wQ: posts small blind $0.10
ErIN0JRL5srYjT6en1f8YQ: posts big blind $0.25
*** HOLE CARDS ***
/gJNBeCkWL4o85/jvlZ4BA said, "*******"
mYz11CHiw5KsDCRD5T7/jg: calls $0.25
RVBrV53KVTJ2T2VL8ucnfw: folds 
fZQg9veL7Dd/Z04ZTjC+wQ said, "?"
/gJNBeCkWL4o85/jvlZ4BA: folds 
fZQg9veL7Dd/Z04ZTjC+wQ: folds 
ErIN0JRL5srYjT6en1f8YQ: checks 
*** FLOP *** [Qc As 7d]
/gJNBeCkWL4o85/jvlZ4BA said, "u reraise me everytime"
ErIN0JRL5srYjT6en1f8YQ: checks 
mYz11CHiw5KsDCRD5T7/jg: checks 
*** TURN *** [Qc As 7d] [Th]
ErIN0JRL5srYjT6en1f8YQ: checks 
fZQg9veL7Dd/Z04ZTjC+wQ said, "...."
mYz11CHiw5KsDCRD5T7/jg: checks 
*** RIVER *** [Qc As 7d Th] [2s]
fZQg9veL7Dd/Z04ZTjC+wQ said, "and i'll continue too"
ErIN0JRL5srYjT6en1f8YQ: checks 
mYz11CHiw5KsDCRD5T7/jg: checks 
*** SHOW DOWN ***
ErIN0JRL5srYjT6en1f8YQ: shows [Qs 4c] (a pair of Queens)
mYz11CHiw5KsDCRD5T7/jg: mucks hand 
/gJNBeCkWL4o85/jvlZ4BA said, "k"
ErIN0JRL5srYjT6en1f8YQ collected $0.60 from pot
*** SUMMARY ***
Total pot $0.60 | Rake $0 
Board [Qc As 7d Th 2s]
Seat 1: RVBrV53KVTJ2T2VL8ucnfw folded before Flop (didn't bet)
Seat 2: /gJNBeCkWL4o85/jvlZ4BA (button) folded before Flop (didn't bet)
Seat 4: fZQg9veL7Dd/Z04ZTjC+wQ (small blind) folded before Flop
Seat 5: ErIN0JRL5srYjT6en1f8YQ (big blind) showed [Qs 4c] and won ($0.60) with a pair of Queens
Seat 6: mYz11CHiw5KsDCRD5T7/jg mucked




PokerStars Game #59939436128:  Hold'em No Limit ($0.10/$0.25) - 2009/07/01 0:39:49 ET
Table 'ohAuixfiLOYDylNUG5mNUw' 9-max Seat #1 is the button
Seat 1: AtRN1hdV8HbL3X4XogDaLA ($31 in chips) 
Seat 3: HVKi9hnDyvzObpL08/OarQ ($26.35 in chips) 
Seat 4: jeKWRUkMaVn8rEUjnJKqpg ($25 in chips) 
Seat 5: Z5ZtGOON8kmSdSCll9Z3XA ($16.35 in chips) 
Seat 7: WdsZPRB5ooUPinQdaX0QrA ($6.55 in chips) 
Seat 8: ppMlNkhYgErlt4fuJO7ADA ($12.95 in chips) 
Seat 9: hIss79a4pu7GzJZepfgOpg ($26.60 in chips) 
HVKi9hnDyvzObpL08/OarQ: posts small blind $0.10
jeKWRUkMaVn8rEUjnJKqpg: posts big blind $0.25
opOCI2p6kW0tINuVaAqmcQ: sits out 
*** HOLE CARDS ***
Z5ZtGOON8kmSdSCll9Z3XA: calls $0.25
WdsZPRB5ooUPinQdaX0QrA: raises $0.75 to $1
ppMlNkhYgErlt4fuJO7ADA: calls $1
hIss79a4pu7GzJZepfgOpg: folds 
AtRN1hdV8HbL3X4XogDaLA: folds 
HVKi9hnDyvzObpL08/OarQ: folds 
jeKWRUkMaVn8rEUjnJKqpg: folds 
Z5ZtGOON8kmSdSCll9Z3XA: calls $0.75
*** FLOP *** [2d Ac 7d]
Z5ZtGOON8kmSdSCll9Z3XA: checks 
WdsZPRB5ooUPinQdaX0QrA: bets $1
ppMlNkhYgErlt4fuJO7ADA: folds 
Z5ZtGOON8kmSdSCll9Z3XA: calls $1
*** TURN *** [2d Ac 7d] [6s]
Z5ZtGOON8kmSdSCll9Z3XA: checks 
WdsZPRB5ooUPinQdaX0QrA: bets $1
Z5ZtGOON8kmSdSCll9Z3XA: calls $1
*** RIVER *** [2d Ac 7d 6s] [2h]
Z5ZtGOON8kmSdSCll9Z3XA: checks 
WdsZPRB5ooUPinQdaX0QrA: checks 
*** SHOW DOWN ***
Z5ZtGOON8kmSdSCll9Z3XA: shows [Ad Js] (two pair, Aces and Deuces)
WdsZPRB5ooUPinQdaX0QrA: mucks hand 
Z5ZtGOON8kmSdSCll9Z3XA collected $7 from pot
*** SUMMARY ***
Total pot $7.35 | Rake $0.35 
Board [2d Ac 7d 6s 2h]
Seat 1: AtRN1hdV8HbL3X4XogDaLA (button) folded before Flop (didn't bet)
Seat 3: HVKi9hnDyvzObpL08/OarQ (small blind) folded before Flop
Seat 4: jeKWRUkMaVn8rEUjnJKqpg (big blind) folded before Flop
Seat 5: Z5ZtGOON8kmSdSCll9Z3XA showed [Ad Js] and won ($7) with two pair, Aces and Deuces
Seat 7: WdsZPRB5ooUPinQdaX0QrA mucked
Seat 8: ppMlNkhYgErlt4fuJO7ADA folded on the Flop
Seat 9: hIss79a4pu7GzJZepfgOpg folded before Flop (didn't bet)




PokerStars Game #59939436176:  Hold'em No Limit ($0.10/$0.25) - 2009/07/01 0:39:49 ET
Table 'FgLmv9bi/fJP8ldfbTOpkg' 9-max Seat #4 is the button
Seat 1: opOCI2p6kW0tINuVaAqmcQ ($25 in chips) 
Seat 2: mpsfNtnMVDqQHTe92AhIdw ($18.65 in chips) 
Seat 4: WfS0TjI8FyLemNTOo1e9qA ($23.55 in chips) 
Seat 6: oKO7b50N6TzXbPBr/mcrUA ($32.45 in chips) 
Seat 7: eFrBtVXGVoMq1UwCDg8Exg ($25 in chips) 
Seat 8: sJNHTWcSlLHRCZ9+YRLLqA ($25 in chips) 
Seat 9: Th3FldXKQW6hWVVPahaoOQ ($25 in chips) 
oKO7b50N6TzXbPBr/mcrUA: posts small blind $0.10
eFrBtVXGVoMq1UwCDg8Exg: posts big blind $0.25
*** HOLE CARDS ***
sJNHTWcSlLHRCZ9+YRLLqA: folds 
Th3FldXKQW6hWVVPahaoOQ: folds 
opOCI2p6kW0tINuVaAqmcQ: raises $0.50 to $0.75
mpsfNtnMVDqQHTe92AhIdw: folds 
WfS0TjI8FyLemNTOo1e9qA: folds 
oKO7b50N6TzXbPBr/mcrUA: folds 
eFrBtVXGVoMq1UwCDg8Exg: folds 
Uncalled bet ($0.50) returned to opOCI2p6kW0tINuVaAqmcQ
opOCI2p6kW0tINuVaAqmcQ collected $0.60 from pot
opOCI2p6kW0tINuVaAqmcQ: doesn't show hand 
*** SUMMARY ***
Total pot $0.60 | Rake $0 
Seat 1: opOCI2p6kW0tINuVaAqmcQ collected ($0.60)
Seat 2: mpsfNtnMVDqQHTe92AhIdw folded before Flop (didn't bet)
Seat 4: WfS0TjI8FyLemNTOo1e9qA (button) folded before Flop (didn't bet)
Seat 6: oKO7b50N6TzXbPBr/mcrUA (small blind) folded before Flop
Seat 7: eFrBtVXGVoMq1UwCDg8Exg (big blind) folded before Flop
Seat 8: sJNHTWcSlLHRCZ9+YRLLqA folded before Flop (didn't bet)
Seat 9: Th3FldXKQW6hWVVPahaoOQ folded before Flop (didn't bet)




PokerStars Game #59939435772:  Hold'em No Limit ($0.10/$0.25) - 2009/07/01 0:39:49 ET
Table 'sIHZ0lzLr4NGCaBUKhmYhAr562aMIMs5kgo28FEU6lkAax Seat #4 is the button
Seat 1: vZGoOTJLQLhkPj4I+LNGig ($25 in chips) 
Seat 2: N8muFAHrFHW6elSMGuyVLQ ($14.75 in chips) 
Seat 3: vX2B+8jhZFyBctQ3P4IKEw ($8.15 in chips) 
Seat 4: XBq1lBzax7LjRqdJP2TqWg ($13.10 in chips) 
Seat 5: zDrucyjVn5aeekNEc3cJrA ($37.40 in chips) 
Seat 6: rCaXm4/EwAgWqCiClpbsqQ ($12.50 in chips) 
Seat 7: R6nIVAjK7uhK3Hj0f85A+A ($18.70 in chips) 
Seat 9: W4TLQcZ2TiM73eIgpIvlGg ($26.10 in chips) 
zDrucyjVn5aeekNEc3cJrA: posts small blind $0.10
rCaXm4/EwAgWqCiClpbsqQ: posts big blind $0.25
jk21: sits out 
*** HOLE CARDS ***
R6nIVAjK7uhK3Hj0f85A+A: folds 
W4TLQcZ2TiM73eIgpIvlGg: folds 
vZGoOTJLQLhkPj4I+LNGig: folds 
N8muFAHrFHW6elSMGuyVLQ: folds 
vX2B+8jhZFyBctQ3P4IKEw: calls $0.25
XBq1lBzax7LjRqdJP2TqWg: folds 
zDrucyjVn5aeekNEc3cJrA: folds 
rCaXm4/EwAgWqCiClpbsqQ: checks 
*** FLOP *** [6c 3s 4h]
rCaXm4/EwAgWqCiClpbsqQ: checks 
vX2B+8jhZFyBctQ3P4IKEw: bets $0.50
rCaXm4/EwAgWqCiClpbsqQ: calls $0.50
*** TURN *** [6c 3s 4h] [Ts]
rCaXm4/EwAgWqCiClpbsqQ: checks 
vX2B+8jhZFyBctQ3P4IKEw: checks 
*** RIVER *** [6c 3s 4h Ts] [Tc]
rCaXm4/EwAgWqCiClpbsqQ: bets $1.25
vX2B+8jhZFyBctQ3P4IKEw: calls $1.25
*** SHOW DOWN ***
rCaXm4/EwAgWqCiClpbsqQ: shows [5s Qd] (a pair of Tens)
vX2B+8jhZFyBctQ3P4IKEw: shows [6d Jd] (two pair, Tens and Sixes)
vX2B+8jhZFyBctQ3P4IKEw collected $3.90 from pot
*** SUMMARY ***
Total pot $4.10 | Rake $0.20 
Board [6c 3s 4h Ts Tc]
Seat 1: vZGoOTJLQLhkPj4I+LNGig folded before Flop (didn't bet)
Seat 2: N8muFAHrFHW6elSMGuyVLQ folded before Flop (didn't bet)
Seat 3: vX2B+8jhZFyBctQ3P4IKEw showed [6d Jd] and won ($3.90) with two pair, Tens and Sixes
Seat 4: XBq1lBzax7LjRqdJP2TqWg (button) folded before Flop (didn't bet)
Seat 5: zDrucyjVn5aeekNEc3cJrA (small blind) folded before Flop
Seat 6: rCaXm4/EwAgWqCiClpbsqQ (big blind) showed [5s Qd] and lost with a pair of Tens
Seat 7: R6nIVAjK7uhK3Hj0f85A+A folded before Flop (didn't bet)
Seat 9: W4TLQcZ2TiM73eIgpIvlGg folded before Flop (didn't bet)




PokerStars Game #59939436464:  Hold'em No Limit ($0.10/$0.25) - 2009/07/01 0:39:50 ET
Table 'biAgO3TKQBU8XcrVAoU5TA' 6-max Seat #6 is the button
Seat 2: 7qRk4YH4/k/08LgJSv7rBQ ($24.75 in chips) 
Seat 3: 7AHdX4G8gYtDJyNY+wK+6Q ($30.65 in chips) 
Seat 4: 2/AObG8G5tKFCPZ+CdivJQ ($11.05 in chips) 
Seat 6: //i5P+6lSkIyZsqb+ojVQA ($14.50 in chips) 
7qRk4YH4/k/08LgJSv7rBQ: posts small blind $0.10
7AHdX4G8gYtDJyNY+wK+6Q: posts big blind $0.25
*** HOLE CARDS ***
2/AObG8G5tKFCPZ+CdivJQ: raises $0.25 to $0.50
//i5P+6lSkIyZsqb+ojVQA: folds 
7qRk4YH4/k/08LgJSv7rBQ: calls $0.40
7AHdX4G8gYtDJyNY+wK+6Q: folds 
*** FLOP *** [3d 9h 5h]
7qRk4YH4/k/08LgJSv7rBQ: bets $0.75
2/AObG8G5tKFCPZ+CdivJQ: folds 
Uncalled bet ($0.75) returned to 7qRk4YH4/k/08LgJSv7rBQ
7qRk4YH4/k/08LgJSv7rBQ collected $1.20 from pot
7qRk4YH4/k/08LgJSv7rBQ: doesn't show hand 
*** SUMMARY ***
Total pot $1.25 | Rake $0.05 
Board [3d 9h 5h]
Seat 2: 7qRk4YH4/k/08LgJSv7rBQ (small blind) collected ($1.20)
Seat 3: 7AHdX4G8gYtDJyNY+wK+6Q (big blind) folded before Flop
Seat 4: 2/AObG8G5tKFCPZ+CdivJQ folded on the Flop
Seat 6: //i5P+6lSkIyZsqb+ojVQA (button) folded before Flop (didn't bet)




PokerStars Game #59939436870:  Hold'em No Limit ($0.10/$0.25) - 2009/07/01 0:39:50 ET
Table '+fuYjvJy9okLr23QyZtanA' 9-max Seat #1 is the button
Seat 1: s7Q6uNouhe7aE8JdFb9E+A ($30.65 in chips) 
Seat 4: H/l9NZvuOXwQIPOaVdj0rQ ($9.55 in chips) 
s7Q6uNouhe7aE8JdFb9E+A: posts small blind $0.10
H/l9NZvuOXwQIPOaVdj0rQ: posts big blind $0.25
*** HOLE CARDS ***
s7Q6uNouhe7aE8JdFb9E+A: raises $0.50 to $0.75
H/l9NZvuOXwQIPOaVdj0rQ: calls $0.50
*** FLOP *** [8c Ks 2s]
H/l9NZvuOXwQIPOaVdj0rQ: checks 
s7Q6uNouhe7aE8JdFb9E+A: bets $1
H/l9NZvuOXwQIPOaVdj0rQ: folds 
Uncalled bet ($1) returned to s7Q6uNouhe7aE8JdFb9E+A
s7Q6uNouhe7aE8JdFb9E+A collected $1.45 from pot
s7Q6uNouhe7aE8JdFb9E+A: doesn't show hand 
*** SUMMARY ***
Total pot $1.50 | Rake $0.05 
Board [8c Ks 2s]
Seat 1: s7Q6uNouhe7aE8JdFb9E+A (button) (small blind) collected ($1.45)
Seat 4: H/l9NZvuOXwQIPOaVdj0rQ (big blind) folded on the Flop




PokerStars Game #59939436512:  Hold'em No Limit ($0.10/$0.25) - 2009/07/01 0:39:50 ET
Table 'SkaFM7xfUr/Nd+JFPb7f2w' 9-max Seat #3 is the button
Seat 2: QEbIGci+itdw+re8RM5fZA ($28.30 in chips) 
Seat 3: 4oA316mXLIui1QY63GXBUg ($25 in chips) 
Seat 4: DIBbjEYGs+TVdVgEB/4+3w ($39.30 in chips) 
Seat 5: GftT+l+xjKzcY0rMiNZfPg ($10.55 in chips) 
Seat 7: 7wo6Sr7QG3Zo6BaBDV1BOw ($5 in chips) 
Seat 8: Lro4e37x4FUa5P3yzDjskw ($10.85 in chips) 
Seat 9: STkR8XvpjNv79OOMhrlh2w ($59.45 in chips) 
DIBbjEYGs+TVdVgEB/4+3w: posts small blind $0.10
GftT+l+xjKzcY0rMiNZfPg: posts big blind $0.25
Apinooso: sits out 
*** HOLE CARDS ***
7wo6Sr7QG3Zo6BaBDV1BOw: folds 
Lro4e37x4FUa5P3yzDjskw: raises $0.25 to $0.50
STkR8XvpjNv79OOMhrlh2w: folds 
PskTLlFIRHSp61inskRzVg has returned
QEbIGci+itdw+re8RM5fZA: folds 
4oA316mXLIui1QY63GXBUg: folds 
DIBbjEYGs+TVdVgEB/4+3w: folds 
GftT+l+xjKzcY0rMiNZfPg: calls $0.25
*** FLOP *** [6s Js 7c]
GftT+l+xjKzcY0rMiNZfPg: checks 
Lro4e37x4FUa5P3yzDjskw: checks 
*** TURN *** [6s Js 7c] [Qd]
GftT+l+xjKzcY0rMiNZfPg: checks 
Lro4e37x4FUa5P3yzDjskw: bets $0.50
GftT+l+xjKzcY0rMiNZfPg: calls $0.50
*** RIVER *** [6s Js 7c Qd] [Qs]
GftT+l+xjKzcY0rMiNZfPg: bets $2.25
Lro4e37x4FUa5P3yzDjskw: folds 
Uncalled bet ($2.25) returned to GftT+l+xjKzcY0rMiNZfPg
GftT+l+xjKzcY0rMiNZfPg collected $2 from pot
GftT+l+xjKzcY0rMiNZfPg: doesn't show hand 
*** SUMMARY ***
Total pot $2.10 | Rake $0.10 
Board [6s Js 7c Qd Qs]
Seat 2: QEbIGci+itdw+re8RM5fZA folded before Flop (didn't bet)
Seat 3: 4oA316mXLIui1QY63GXBUg (button) folded before Flop (didn't bet)
Seat 4: DIBbjEYGs+TVdVgEB/4+3w (small blind) folded before Flop
Seat 5: GftT+l+xjKzcY0rMiNZfPg (big blind) collected ($2)
Seat 7: 7wo6Sr7QG3Zo6BaBDV1BOw folded before Flop (didn't bet)
Seat 8: Lro4e37x4FUa5P3yzDjskw folded on the River
Seat 9: STkR8XvpjNv79OOMhrlh2w folded before Flop (didn't bet)




PokerStars Game #59939436478:  Hold'em No Limit ($0.10/$0.25) - 2009/07/01 0:39:50 ET
Table 'O5NgMYt6EWbLBozZb3kseg' 6-max Seat #6 is the button
Seat 1: T2fEtpqj5ZyZAjEhNtsFAA ($40.90 in chips) 
Seat 2: VWbjqONyDvf8KegytgPLjQ ($61.40 in chips) 
Seat 4: aogAb4Eienxztk8p2v9VVw ($23.65 in chips) 
Seat 5: vu2kzHaDtgr6NM7rdq0chA ($43.50 in chips) 
Seat 6: k9vn40MOqqb+xF+7GZ6v2g ($22.85 in chips) 
T2fEtpqj5ZyZAjEhNtsFAA: posts small blind $0.10
VWbjqONyDvf8KegytgPLjQ: posts big blind $0.25
*** HOLE CARDS ***
aogAb4Eienxztk8p2v9VVw: raises $0.75 to $1
vu2kzHaDtgr6NM7rdq0chA: folds 
k9vn40MOqqb+xF+7GZ6v2g: folds 
T2fEtpqj5ZyZAjEhNtsFAA: folds 
VWbjqONyDvf8KegytgPLjQ: folds 
Uncalled bet ($0.75) returned to aogAb4Eienxztk8p2v9VVw
aogAb4Eienxztk8p2v9VVw collected $0.60 from pot
aogAb4Eienxztk8p2v9VVw: doesn't show hand 
*** SUMMARY ***
Total pot $0.60 | Rake $0 
Seat 1: T2fEtpqj5ZyZAjEhNtsFAA (small blind) folded before Flop
Seat 2: VWbjqONyDvf8KegytgPLjQ (big blind) folded before Flop
Seat 4: aogAb4Eienxztk8p2v9VVw collected ($0.60)
Seat 5: vu2kzHaDtgr6NM7rdq0chA folded before Flop (didn't bet)
Seat 6: k9vn40MOqqb+xF+7GZ6v2g (button) folded before Flop (didn't bet)




PokerStars Game #59939437428:  Hold'em No Limit ($0.10/$0.25) - 2009/07/01 0:39:51 ET
Table 'FuFyQHmlO/QqQp//rDRrPg' 6-max Seat #1 is the button
Seat 1: 4re+a1K56DcbV7DyVX/FMw ($15.45 in chips) 
Seat 2: 0DvgWV5o6c/jYqQCjm4Haw ($25 in chips) 
Seat 3: uoOTv6ecGYEhLPY44ZTW+A ($10.85 in chips) 
Seat 4: Eznneya0vB6S+eXJdVleHA ($8.90 in chips) 
Seat 5: wAKC8C/zN0c8V5v13dm9mA ($26.50 in chips) 
0DvgWV5o6c/jYqQCjm4Haw: posts small blind $0.10
uoOTv6ecGYEhLPY44ZTW+A: posts big blind $0.25
*** HOLE CARDS ***
Eznneya0vB6S+eXJdVleHA: folds 
No1_Playa joins the table at seat #6 
wAKC8C/zN0c8V5v13dm9mA: folds 
4re+a1K56DcbV7DyVX/FMw: folds 
0DvgWV5o6c/jYqQCjm4Haw: folds 
Uncalled bet ($0.15) returned to uoOTv6ecGYEhLPY44ZTW+A
uoOTv6ecGYEhLPY44ZTW+A collected $0.20 from pot
uoOTv6ecGYEhLPY44ZTW+A: doesn't show hand 
*** SUMMARY ***
Total pot $0.20 | Rake $0 
Seat 1: 4re+a1K56DcbV7DyVX/FMw (button) folded before Flop (didn't bet)
Seat 2: 0DvgWV5o6c/jYqQCjm4Haw (small blind) folded before Flop
Seat 3: uoOTv6ecGYEhLPY44ZTW+A (big blind) collected ($0.20)
Seat 4: Eznneya0vB6S+eXJdVleHA folded before Flop (didn't bet)
Seat 5: wAKC8C/zN0c8V5v13dm9mA folded before Flop (didn't bet)




PokerStars Game #59939437016:  Hold'em No Limit ($0.10/$0.25) - 2009/07/01 0:39:51 ET
Table 'M7d9IrgQUUFFy/SZ3ksLYg' 6-max Seat #1 is the button
Seat 1: cPO/1/dTcZpLkQFm3jH3Rg ($34.20 in chips) 
Seat 2: JE/wJXmjw3bpdmjwvh2pcg ($25.10 in chips) 
Seat 3: eHsmIvAb2JREg4O6hNPnXg ($15.70 in chips) 
Seat 4: 7FmwVDcdEtxDpHmP4hOXsQ ($29.90 in chips) 
Seat 6: /gJNBeCkWL4o85/jvlZ4BA ($25.50 in chips) 
JE/wJXmjw3bpdmjwvh2pcg: posts small blind $0.10
eHsmIvAb2JREg4O6hNPnXg: posts big blind $0.25
*** HOLE CARDS ***
7FmwVDcdEtxDpHmP4hOXsQ: folds 
/gJNBeCkWL4o85/jvlZ4BA: folds 
cPO/1/dTcZpLkQFm3jH3Rg: folds 
JE/wJXmjw3bpdmjwvh2pcg: folds 
Uncalled bet ($0.15) returned to eHsmIvAb2JREg4O6hNPnXg
eHsmIvAb2JREg4O6hNPnXg collected $0.20 from pot
*** SUMMARY ***
Total pot $0.20 | Rake $0 
Seat 1: cPO/1/dTcZpLkQFm3jH3Rg (button) folded before Flop (didn't bet)
Seat 2: JE/wJXmjw3bpdmjwvh2pcg (small blind) folded before Flop
Seat 3: eHsmIvAb2JREg4O6hNPnXg (big blind) collected ($0.20)
Seat 4: 7FmwVDcdEtxDpHmP4hOXsQ folded before Flop (didn't bet)
Seat 6: /gJNBeCkWL4o85/jvlZ4BA folded before Flop (didn't bet)




PokerStars Game #59939437124:  Hold'em No Limit ($0.10/$0.25) - 2009/07/01 0:39:51 ET
Table '52Meibn9NOL4XtVi1p2Upw' 9-max Seat #2 is the button
Seat 1: LSrAei+fS8MYG9ie/GkG0Q ($15.70 in chips) 
Seat 2: BEIBUu2pIflPrCL+Iks4CQ ($12.25 in chips) 
Seat 3: MzBvksetB8XYtCt0FExJMg ($15 in chips) 
Seat 4: rCaXm4/EwAgWqCiClpbsqQ ($9 in chips) 
Seat 5: 4oA316mXLIui1QY63GXBUg ($27.10 in chips) 
Seat 6: 1wKfgJ8xXIiuc8C6qjkxhg ($3 in chips) 
Seat 7: R3KkgiqTvuhazyCqaD9cZg ($10 in chips) 
Seat 8: eKma8Z98pP7H8m4CEt075w ($23.45 in chips) 
Seat 9: 8B/dhbQjIWe6ASCdgzktNQ ($30.10 in chips) 
MzBvksetB8XYtCt0FExJMg: posts small blind $0.10
rCaXm4/EwAgWqCiClpbsqQ: posts big blind $0.25
*** HOLE CARDS ***
4oA316mXLIui1QY63GXBUg: folds 
1wKfgJ8xXIiuc8C6qjkxhg: calls $0.25
R3KkgiqTvuhazyCqaD9cZg: folds 
eKma8Z98pP7H8m4CEt075w: folds 
8B/dhbQjIWe6ASCdgzktNQ: folds 
LSrAei+fS8MYG9ie/GkG0Q: raises $0.50 to $0.75
BEIBUu2pIflPrCL+Iks4CQ: folds 
MzBvksetB8XYtCt0FExJMg: folds 
rCaXm4/EwAgWqCiClpbsqQ: folds 
1wKfgJ8xXIiuc8C6qjkxhg: raises $1 to $1.75
LSrAei+fS8MYG9ie/GkG0Q: raises $2 to $3.75
1wKfgJ8xXIiuc8C6qjkxhg: calls $1.25 and is all-in
Uncalled bet ($0.75) returned to LSrAei+fS8MYG9ie/GkG0Q
*** FLOP *** [Jh 3d 7c]
*** TURN *** [Jh 3d 7c] [8c]
*** RIVER *** [Jh 3d 7c 8c] [Kh]
*** SHOW DOWN ***
1wKfgJ8xXIiuc8C6qjkxhg: shows [Jd Jc] (three of a kind, Jacks)
LSrAei+fS8MYG9ie/GkG0Q: mucks hand 
1wKfgJ8xXIiuc8C6qjkxhg collected $6.05 from pot
*** SUMMARY ***
Total pot $6.35 | Rake $0.30 
Board [Jh 3d 7c 8c Kh]
Seat 1: LSrAei+fS8MYG9ie/GkG0Q mucked
Seat 2: BEIBUu2pIflPrCL+Iks4CQ (button) folded before Flop (didn't bet)
Seat 3: MzBvksetB8XYtCt0FExJMg (small blind) folded before Flop
Seat 4: rCaXm4/EwAgWqCiClpbsqQ (big blind) folded before Flop
Seat 5: 4oA316mXLIui1QY63GXBUg folded before Flop (didn't bet)
Seat 6: 1wKfgJ8xXIiuc8C6qjkxhg showed [Jd Jc] and won ($6.05) with three of a kind, Jacks
Seat 7: R3KkgiqTvuhazyCqaD9cZg folded before Flop (didn't bet)
Seat 8: eKma8Z98pP7H8m4CEt075w folded before Flop (didn't bet)
Seat 9: 8B/dhbQjIWe6ASCdgzktNQ folded before Flop (didn't bet)




PokerStars Game #59939437372:  Hold'em No Limit ($0.10/$0.25) - 2009/07/01 0:39:51 ET
Table 'by7aHYEDnDd144EXOXa/jA' 9-max Seat #3 is the button
Seat 1: zU1DfKpyUFgAuyEO9JqLHg ($8.85 in chips) 
Seat 2: vSkQm2EelzwRGDDQQk0Fqw ($4.90 in chips) 
Seat 3: 1Clf3cPrqoy/YgvWdWK1Xw ($5.55 in chips) 
Seat 4: vZGoOTJLQLhkPj4I+LNGig ($47.15 in chips) 
Seat 5: yyG4svzOpC1A+sUP/scg6w ($7.50 in chips) 
Seat 6: DIBbjEYGs+TVdVgEB/4+3w ($23.25 in chips) 
Seat 7: tWA6Uowb3ysfJYO6d8AUqw ($10.40 in chips) 
Seat 8: s7Q6uNouhe7aE8JdFb9E+A ($25.60 in chips) 
vZGoOTJLQLhkPj4I+LNGig: posts small blind $0.10
yyG4svzOpC1A+sUP/scg6w: posts big blind $0.25
*** HOLE CARDS ***
DIBbjEYGs+TVdVgEB/4+3w: folds 
tWA6Uowb3ysfJYO6d8AUqw: calls $0.25
s7Q6uNouhe7aE8JdFb9E+A: folds 
zU1DfKpyUFgAuyEO9JqLHg: folds 
vSkQm2EelzwRGDDQQk0Fqw: folds 
1Clf3cPrqoy/YgvWdWK1Xw: folds 
vZGoOTJLQLhkPj4I+LNGig: folds 
yyG4svzOpC1A+sUP/scg6w: checks 
*** FLOP *** [2c 9s 3d]
yyG4svzOpC1A+sUP/scg6w: checks 
tWA6Uowb3ysfJYO6d8AUqw: checks 
*** TURN *** [2c 9s 3d] [Ts]
yyG4svzOpC1A+sUP/scg6w: bets $0.50
tWA6Uowb3ysfJYO6d8AUqw: calls $0.50
*** RIVER *** [2c 9s 3d Ts] [5h]
yyG4svzOpC1A+sUP/scg6w: checks 
tWA6Uowb3ysfJYO6d8AUqw: bets $1
yyG4svzOpC1A+sUP/scg6w: folds 
Uncalled bet ($1) returned to tWA6Uowb3ysfJYO6d8AUqw
tWA6Uowb3ysfJYO6d8AUqw collected $1.55 from pot
tWA6Uowb3ysfJYO6d8AUqw: doesn't show hand 
*** SUMMARY ***
Total pot $1.60 | Rake $0.05 
Board [2c 9s 3d Ts 5h]
Seat 1: zU1DfKpyUFgAuyEO9JqLHg folded before Flop (didn't bet)
Seat 2: vSkQm2EelzwRGDDQQk0Fqw folded before Flop (didn't bet)
Seat 3: 1Clf3cPrqoy/YgvWdWK1Xw (button) folded before Flop (didn't bet)
Seat 4: vZGoOTJLQLhkPj4I+LNGig (small blind) folded before Flop
Seat 5: yyG4svzOpC1A+sUP/scg6w (big blind) folded on the River
Seat 6: DIBbjEYGs+TVdVgEB/4+3w folded before Flop (didn't bet)
Seat 7: tWA6Uowb3ysfJYO6d8AUqw collected ($1.55)
Seat 8: s7Q6uNouhe7aE8JdFb9E+A folded before Flop (didn't bet)




PokerStars Game #59939437062:  Hold'em No Limit ($0.10/$0.25) - 2009/07/01 0:39:51 ET
Table 'IfRHUn9gQQA9I/Z4tn+BoA' 9-max Seat #4 is the button
Seat 1: vSkQm2EelzwRGDDQQk0Fqw ($4.65 in chips) 
Seat 2: zgWbKMp0/btzsnVbQWKXww ($16.30 in chips) 
Seat 3: iAQDnrJCZVD1LzAGxTYegw ($26.25 in chips) 
Seat 4: QEbIGci+itdw+re8RM5fZA ($25 in chips) 
Seat 5: 10584482 ($15.40 in chips) 
Seat 6: UOjoGGQ58/uDS7V0xkjOrQ ($7.80 in chips) 
Seat 7: TeWJxSETzbXGiYKx0y+dtg ($25.85 in chips) 
Seat 8: cZ99hugmLBj9KhTlc8nCSw ($25 in chips) 
10584482: posts small blind $0.10
UOjoGGQ58/uDS7V0xkjOrQ: posts big blind $0.25
7cv+9Zc9HIQHNvYsMfV3uA: sits out 
*** HOLE CARDS ***
TeWJxSETzbXGiYKx0y+dtg: folds 
cZ99hugmLBj9KhTlc8nCSw: folds 
vSkQm2EelzwRGDDQQk0Fqw: folds 
zgWbKMp0/btzsnVbQWKXww: folds 
iAQDnrJCZVD1LzAGxTYegw: calls $0.25
QEbIGci+itdw+re8RM5fZA: folds 
10584482: raises $0.75 to $1
UOjoGGQ58/uDS7V0xkjOrQ: calls $0.75
iAQDnrJCZVD1LzAGxTYegw: calls $0.75
*** FLOP *** [Qh Kd 4h]
10584482: bets $1
UOjoGGQ58/uDS7V0xkjOrQ: folds 
iAQDnrJCZVD1LzAGxTYegw: folds 
Uncalled bet ($1) returned to 10584482
10584482 collected $2.85 from pot
10584482: doesn't show hand 
*** SUMMARY ***
Total pot $3 | Rake $0.15 
Board [Qh Kd 4h]
Seat 1: vSkQm2EelzwRGDDQQk0Fqw folded before Flop (didn't bet)
Seat 2: zgWbKMp0/btzsnVbQWKXww folded before Flop (didn't bet)
Seat 3: iAQDnrJCZVD1LzAGxTYegw folded on the Flop
Seat 4: QEbIGci+itdw+re8RM5fZA (button) folded before Flop (didn't bet)
Seat 5: 10584482 (small blind) collected ($2.85)
Seat 6: UOjoGGQ58/uDS7V0xkjOrQ (big blind) folded on the Flop
Seat 7: TeWJxSETzbXGiYKx0y+dtg folded before Flop (didn't bet)
Seat 8: cZ99hugmLBj9KhTlc8nCSw folded before Flop (didn't bet)




PokerStars Game #59939437834:  Hold'em No Limit ($0.10/$0.25) - 2009/07/01 0:39:52 ET
Table 'SgI2Cobdjtkh0Fd0/eTTDg' 9-max Seat #5 is the button
Seat 1: JRfCWETUoKaEo7sf/Jy3Kg ($24.65 in chips) 
Seat 2: 8B/dhbQjIWe6ASCdgzktNQ ($42.20 in chips) 
Seat 3: OiV1PWZ3IkN29JlmCcnTwQ ($4.90 in chips) 
Seat 4: 18G4P1XstjNvItdGUITxgw ($25 in chips) 
Seat 5: w/RUHfVzKTf7Bc19nucLpQ ($8.05 in chips) 
Seat 6: f8ewQKsexlXbhtBqiLFb8A ($10.75 in chips) 
Seat 7: aJy680tKSaP5er559aSuGA ($22.70 in chips) 
Seat 9: cZ99hugmLBj9KhTlc8nCSw ($25.90 in chips) 
f8ewQKsexlXbhtBqiLFb8A: posts small blind $0.10
aJy680tKSaP5er559aSuGA: posts big blind $0.25
*** HOLE CARDS ***
cZ99hugmLBj9KhTlc8nCSw: folds 
JRfCWETUoKaEo7sf/Jy3Kg: folds 
8B/dhbQjIWe6ASCdgzktNQ: folds 
OiV1PWZ3IkN29JlmCcnTwQ: folds 
18G4P1XstjNvItdGUITxgw: folds 
w/RUHfVzKTf7Bc19nucLpQ: folds 
f8ewQKsexlXbhtBqiLFb8A: calls $0.15
aJy680tKSaP5er559aSuGA: checks 
*** FLOP *** [Jd 7d 7s]
f8ewQKsexlXbhtBqiLFb8A: bets $0.25
aJy680tKSaP5er559aSuGA: folds 
Uncalled bet ($0.25) returned to f8ewQKsexlXbhtBqiLFb8A
f8ewQKsexlXbhtBqiLFb8A collected $0.50 from pot
*** SUMMARY ***
Total pot $0.50 | Rake $0 
Board [Jd 7d 7s]
Seat 1: JRfCWETUoKaEo7sf/Jy3Kg folded before Flop (didn't bet)
Seat 2: 8B/dhbQjIWe6ASCdgzktNQ folded before Flop (didn't bet)
Seat 3: OiV1PWZ3IkN29JlmCcnTwQ folded before Flop (didn't bet)
Seat 4: 18G4P1XstjNvItdGUITxgw folded before Flop (didn't bet)
Seat 5: w/RUHfVzKTf7Bc19nucLpQ (button) folded before Flop (didn't bet)
Seat 6: f8ewQKsexlXbhtBqiLFb8A (small blind) collected ($0.50)
Seat 7: aJy680tKSaP5er559aSuGA (big blind) folded on the Flop
Seat 9: cZ99hugmLBj9KhTlc8nCSw folded before Flop (didn't bet)




PokerStars Game #59939438080:  Hold'em No Limit ($0.10/$0.25) - 2009/07/01 0:39:52 ET
Table 'KKk6y4pAXeymxYcd0uZLqg' 9-max Seat #1 is the button
Seat 1: HPEB+AtKw1+C/cxU0o1ciw ($24.55 in chips) 
Seat 3: 4oA316mXLIui1QY63GXBUg ($25 in chips) 
Seat 4: GTcLfsDTPqgfHyhY9FNDMw ($14.80 in chips) 
Seat 5: U0VVxBdRWdhRNdbJ+Qky1A ($46.10 in chips) 
Seat 6: LWN1wPrLH+695JIriXxDuw ($11.60 in chips) 
Seat 7: R3KkgiqTvuhazyCqaD9cZg ($10 in chips) 
Seat 8: +2kMBNpY4nF1qNCRd8SJLA ($26.10 in chips) 
Seat 9: j4q3p0lesp63b1gZDwLBZw ($5 in chips) 
4oA316mXLIui1QY63GXBUg: posts small blind $0.10
GTcLfsDTPqgfHyhY9FNDMw: posts big blind $0.25
*** HOLE CARDS ***
U0VVxBdRWdhRNdbJ+Qky1A: folds 
LWN1wPrLH+695JIriXxDuw: folds 
R3KkgiqTvuhazyCqaD9cZg: folds 
+2kMBNpY4nF1qNCRd8SJLA: folds 
j4q3p0lesp63b1gZDwLBZw: folds 
HPEB+AtKw1+C/cxU0o1ciw: folds 
4oA316mXLIui1QY63GXBUg: folds 
Uncalled bet ($0.15) returned to GTcLfsDTPqgfHyhY9FNDMw
GTcLfsDTPqgfHyhY9FNDMw collected $0.20 from pot
GTcLfsDTPqgfHyhY9FNDMw: doesn't show hand 
*** SUMMARY ***
Total pot $0.20 | Rake $0 
Seat 1: HPEB+AtKw1+C/cxU0o1ciw (button) folded before Flop (didn't bet)
Seat 3: 4oA316mXLIui1QY63GXBUg (small blind) folded before Flop
Seat 4: GTcLfsDTPqgfHyhY9FNDMw (big blind) collected ($0.20)
Seat 5: U0VVxBdRWdhRNdbJ+Qky1A folded before Flop (didn't bet)
Seat 6: LWN1wPrLH+695JIriXxDuw folded before Flop (didn't bet)
Seat 7: R3KkgiqTvuhazyCqaD9cZg folded before Flop (didn't bet)
Seat 8: +2kMBNpY4nF1qNCRd8SJLA folded before Flop (didn't bet)
Seat 9: j4q3p0lesp63b1gZDwLBZw folded before Flop (didn't bet)




PokerStars Game #59939437806:  Hold'em No Limit ($0.10/$0.25) - 2009/07/01 0:39:52 ET
Table 'vud0GB/ZlDCvUFhBFIaTlg' 9-max Seat #7 is the button
Seat 5: AwAabNdwDsTMb3aTomdOmg ($6.45 in chips) 
Seat 7: RzaVufWfW9CTnVYR7/Ge+w ($1.80 in chips) 
RzaVufWfW9CTnVYR7/Ge+w: posts small blind $0.10
AwAabNdwDsTMb3aTomdOmg: posts big blind $0.25
*** HOLE CARDS ***
RzaVufWfW9CTnVYR7/Ge+w: folds 
Uncalled bet ($0.15) returned to AwAabNdwDsTMb3aTomdOmg
AwAabNdwDsTMb3aTomdOmg collected $0.20 from pot
*** SUMMARY ***
Total pot $0.20 | Rake $0 
Seat 5: AwAabNdwDsTMb3aTomdOmg (big blind) collected ($0.20)
Seat 7: RzaVufWfW9CTnVYR7/Ge+w (button) (small blind) folded before Flop




PokerStars Game #59939437964:  Hold'em No Limit ($0.10/$0.25) - 2009/07/01 0:39:52 ET
Table 'sJ4KpS2GE5Qrsu1/cFjJUw' 9-max Seat #1 is the button
Seat 1: QsLvCwfSWqP+CfjwUnjpXQ ($14.40 in chips) 
Seat 3: eDil7UzSZCjyh1VP6SVXJQ ($7.30 in chips) 
Seat 8: f8ixGbSVIs6Be0mH69ldVQ ($14.85 in chips) 
eDil7UzSZCjyh1VP6SVXJQ: posts small blind $0.10
f8ixGbSVIs6Be0mH69ldVQ: posts big blind $0.25
*** HOLE CARDS ***
QsLvCwfSWqP+CfjwUnjpXQ: folds 
eDil7UzSZCjyh1VP6SVXJQ: calls $0.15
f8ixGbSVIs6Be0mH69ldVQ: checks 
*** FLOP *** [5d 8c 6c]
eDil7UzSZCjyh1VP6SVXJQ: bets $0.25
f8ixGbSVIs6Be0mH69ldVQ: folds 
Uncalled bet ($0.25) returned to eDil7UzSZCjyh1VP6SVXJQ
eDil7UzSZCjyh1VP6SVXJQ collected $0.50 from pot
eDil7UzSZCjyh1VP6SVXJQ: doesn't show hand 
*** SUMMARY ***
Total pot $0.50 | Rake $0 
Board [5d 8c 6c]
Seat 1: QsLvCwfSWqP+CfjwUnjpXQ (button) folded before Flop (didn't bet)
Seat 3: eDil7UzSZCjyh1VP6SVXJQ (small blind) collected ($0.50)
Seat 8: f8ixGbSVIs6Be0mH69ldVQ (big blind) folded on the Flop




PokerStars Game #59939437670:  Hold'em No Limit ($0.10/$0.25) - 2009/07/01 0:39:52 ET
Table 'pAhiNHs/spaABQia+7gWNQ' 9-max Seat #5 is the button
Seat 1: /VQLorsEOrMfI+KamzNQEA ($4.70 in chips) 
Seat 3: xEQxarad8/T4jJdpZy5LGw ($8.90 in chips) 
Seat 5: /vn2Qu2dvc9AMMq46Ae0jA ($10.15 in chips) 
Seat 6: FinSxgTdEPV/yPQRl5uhmA ($49.70 in chips) 
Seat 7: 04UcDjK4SUEJctLqNtWFoQ ($9.25 in chips) 
Seat 8: vSkQm2EelzwRGDDQQk0Fqw ($14.05 in chips) 
Seat 9: /67o0BjW8sY1ZxYt7/6StQ ($13.40 in chips) 
FinSxgTdEPV/yPQRl5uhmA: posts small blind $0.10
04UcDjK4SUEJctLqNtWFoQ: posts big blind $0.25
hvydiesel: sits out 
lacross84: sits out 
*** HOLE CARDS ***
vSkQm2EelzwRGDDQQk0Fqw: folds 
/67o0BjW8sY1ZxYt7/6StQ: folds 
/VQLorsEOrMfI+KamzNQEA: folds 
xEQxarad8/T4jJdpZy5LGw: folds 
/vn2Qu2dvc9AMMq46Ae0jA: folds 
FinSxgTdEPV/yPQRl5uhmA: calls $0.15
04UcDjK4SUEJctLqNtWFoQ: checks 
*** FLOP *** [9s 6h Qd]
FinSxgTdEPV/yPQRl5uhmA: checks 
04UcDjK4SUEJctLqNtWFoQ: checks 
*** TURN *** [9s 6h Qd] [6c]
FinSxgTdEPV/yPQRl5uhmA: checks 
04UcDjK4SUEJctLqNtWFoQ: checks 
*** RIVER *** [9s 6h Qd 6c] [9c]
FinSxgTdEPV/yPQRl5uhmA: checks 
04UcDjK4SUEJctLqNtWFoQ: bets $0.75
FinSxgTdEPV/yPQRl5uhmA: folds 
Uncalled bet ($0.75) returned to 04UcDjK4SUEJctLqNtWFoQ
04UcDjK4SUEJctLqNtWFoQ collected $0.50 from pot
04UcDjK4SUEJctLqNtWFoQ: doesn't show hand 
*** SUMMARY ***
Total pot $0.50 | Rake $0 
Board [9s 6h Qd 6c 9c]
Seat 1: /VQLorsEOrMfI+KamzNQEA folded before Flop (didn't bet)
Seat 3: xEQxarad8/T4jJdpZy5LGw folded before Flop (didn't bet)
Seat 5: /vn2Qu2dvc9AMMq46Ae0jA (button) folded before Flop (didn't bet)
Seat 6: FinSxgTdEPV/yPQRl5uhmA (small blind) folded on the River
Seat 7: 04UcDjK4SUEJctLqNtWFoQ (big blind) collected ($0.50)
Seat 8: vSkQm2EelzwRGDDQQk0Fqw folded before Flop (didn't bet)
Seat 9: /67o0BjW8sY1ZxYt7/6StQ folded before Flop (didn't bet)




PokerStars Game #59939437930:  Hold'em No Limit ($0.10/$0.25) - 2009/07/01 0:39:52 ET
Table 'o0CDOvKO/bn1WjeymDrXfA' 6-max Seat #1 is the button
Seat 1: 32YL2ZEp8NT4JB2RVM9euQ ($16 in chips) 
Seat 2: oc4ZGs0W+3RIg2yPyJw3ig ($31 in chips) 
Seat 3: EqXTTLKUlDlz7yi6ziyyWA ($9.25 in chips) 
Seat 4: WvQKBeYmHv0ZkY7uzfWAAw ($7.90 in chips) 
Seat 5: u/yN5P9f3KlATg6WLWNkBQ ($29.60 in chips) 
Seat 6: Bada343Si4xKu3fNXY99AA ($20.95 in chips) 
oc4ZGs0W+3RIg2yPyJw3ig: posts small blind $0.10
EqXTTLKUlDlz7yi6ziyyWA: posts big blind $0.25
*** HOLE CARDS ***
WvQKBeYmHv0ZkY7uzfWAAw: folds 
WvQKBeYmHv0ZkY7uzfWAAw leaves the table
u/yN5P9f3KlATg6WLWNkBQ: calls $0.25
Bada343Si4xKu3fNXY99AA: folds 
32YL2ZEp8NT4JB2RVM9euQ: raises $1 to $1.25
oc4ZGs0W+3RIg2yPyJw3ig: folds 
EqXTTLKUlDlz7yi6ziyyWA: folds 
u/yN5P9f3KlATg6WLWNkBQ: folds 
Uncalled bet ($1) returned to 32YL2ZEp8NT4JB2RVM9euQ
32YL2ZEp8NT4JB2RVM9euQ collected $0.85 from pot
32YL2ZEp8NT4JB2RVM9euQ: doesn't show hand 
*** SUMMARY ***
Total pot $0.85 | Rake $0 
Seat 1: 32YL2ZEp8NT4JB2RVM9euQ (button) collected ($0.85)
Seat 2: oc4ZGs0W+3RIg2yPyJw3ig (small blind) folded before Flop
Seat 3: EqXTTLKUlDlz7yi6ziyyWA (big blind) folded before Flop
Seat 4: WvQKBeYmHv0ZkY7uzfWAAw folded before Flop (didn't bet)
Seat 5: u/yN5P9f3KlATg6WLWNkBQ folded before Flop
Seat 6: Bada343Si4xKu3fNXY99AA folded before Flop (didn't bet)




PokerStars Game #59939438420:  Hold'em No Limit ($0.10/$0.25) - 2009/07/01 0:39:53 ET
Table 'AchTjdLS1zBUbH3ZIx6f0w' 6-max Seat #1 is the button
Seat 1: IzVI+wIP7IS+d0sugIrOPQ ($25.55 in chips) 
Seat 2: kG34n23qFQA3nzdOJTQ1dA ($40.30 in chips) 
Seat 3: ehifenV36yVvJMnV63D3cg ($6.10 in chips) 
Seat 4: q6WfTUAD9mowIP63ASq2Dg ($26.70 in chips) 
Seat 5: oBUDUfeUyCbZBsjxHZgSiw ($33.75 in chips) 
Seat 6: 5tB0F9NjPSUL4FzmzBMs2Q ($25 in chips) 
kG34n23qFQA3nzdOJTQ1dA: posts small blind $0.10
ehifenV36yVvJMnV63D3cg: posts big blind $0.25
*** HOLE CARDS ***
q6WfTUAD9mowIP63ASq2Dg: folds 
oBUDUfeUyCbZBsjxHZgSiw: raises $0.75 to $1
5tB0F9NjPSUL4FzmzBMs2Q: folds 
IzVI+wIP7IS+d0sugIrOPQ: folds 
kG34n23qFQA3nzdOJTQ1dA: folds 
ehifenV36yVvJMnV63D3cg: calls $0.75
*** FLOP *** [Th 8h 9c]
ehifenV36yVvJMnV63D3cg: bets $0.50
oBUDUfeUyCbZBsjxHZgSiw: calls $0.50
*** TURN *** [Th 8h 9c] [6d]
ehifenV36yVvJMnV63D3cg: bets $0.75
oBUDUfeUyCbZBsjxHZgSiw: calls $0.75
*** RIVER *** [Th 8h 9c 6d] [2d]
ehifenV36yVvJMnV63D3cg: bets $2
oBUDUfeUyCbZBsjxHZgSiw: calls $2
*** SHOW DOWN ***
ehifenV36yVvJMnV63D3cg: shows [Jh As] (high card Ace)
oBUDUfeUyCbZBsjxHZgSiw: shows [Kc Ad] (high card Ace - King kicker)
oBUDUfeUyCbZBsjxHZgSiw collected $8.20 from pot
*** SUMMARY ***
Total pot $8.60 | Rake $0.40 
Board [Th 8h 9c 6d 2d]
Seat 1: IzVI+wIP7IS+d0sugIrOPQ (button) folded before Flop (didn't bet)
Seat 2: kG34n23qFQA3nzdOJTQ1dA (small blind) folded before Flop
Seat 3: ehifenV36yVvJMnV63D3cg (big blind) showed [Jh As] and lost with high card Ace
Seat 4: q6WfTUAD9mowIP63ASq2Dg folded before Flop (didn't bet)
Seat 5: oBUDUfeUyCbZBsjxHZgSiw showed [Kc Ad] and won ($8.20) with high card Ace
Seat 6: 5tB0F9NjPSUL4FzmzBMs2Q folded before Flop (didn't bet)




PokerStars Game #59939438636:  Hold'em No Limit ($0.10/$0.25) - 2009/07/01 0:39:53 ET
Table 'RUOqTfzbAVGS5x+J9aZMHA' 9-max Seat #8 is the button
Seat 1: KBBTLXGhPdPj+4X0QKMkcg ($13.60 in chips) 
Seat 2: Z5ZtGOON8kmSdSCll9Z3XA ($6.70 in chips) 
Seat 4: 18G4P1XstjNvItdGUITxgw ($29 in chips) 
Seat 5: opOCI2p6kW0tINuVaAqmcQ ($26.95 in chips) 
Seat 6: ljemhp25Zg+nlA9DLCIiUw ($33.45 in chips) 
Seat 8: 3RCAkueG3Vc13VpRStCB+w ($24.10 in chips) 
KBBTLXGhPdPj+4X0QKMkcg: posts small blind $0.10
Z5ZtGOON8kmSdSCll9Z3XA: posts big blind $0.25
HxDF4QSxC4z39D7teZpprQ: sits out 
*** HOLE CARDS ***
18G4P1XstjNvItdGUITxgw: folds 
opOCI2p6kW0tINuVaAqmcQ: folds 
ljemhp25Zg+nlA9DLCIiUw: folds 
3RCAkueG3Vc13VpRStCB+w: folds 
KBBTLXGhPdPj+4X0QKMkcg: calls $0.15
Z5ZtGOON8kmSdSCll9Z3XA: checks 
*** FLOP *** [6s 9d 9s]
KBBTLXGhPdPj+4X0QKMkcg: checks 
Z5ZtGOON8kmSdSCll9Z3XA: checks 
*** TURN *** [6s 9d 9s] [7d]
KBBTLXGhPdPj+4X0QKMkcg: bets $0.25
Z5ZtGOON8kmSdSCll9Z3XA: calls $0.25
*** RIVER *** [6s 9d 9s 7d] [Ts]
KBBTLXGhPdPj+4X0QKMkcg: bets $0.75
Z5ZtGOON8kmSdSCll9Z3XA: raises $0.75 to $1.50
KBBTLXGhPdPj+4X0QKMkcg: calls $0.75
*** SHOW DOWN ***
Z5ZtGOON8kmSdSCll9Z3XA: shows [As 8h] (a straight, Six to Ten)
KBBTLXGhPdPj+4X0QKMkcg: shows [Ac 8d] (a straight, Six to Ten)
KBBTLXGhPdPj+4X0QKMkcg collected $1.95 from pot
Z5ZtGOON8kmSdSCll9Z3XA collected $1.90 from pot
*** SUMMARY ***
Total pot $4 | Rake $0.15 
Board [6s 9d 9s 7d Ts]
Seat 1: KBBTLXGhPdPj+4X0QKMkcg (small blind) showed [Ac 8d] and won ($1.95) with a straight, Six to Ten
Seat 2: Z5ZtGOON8kmSdSCll9Z3XA (big blind) showed [As 8h] and won ($1.90) with a straight, Six to Ten
Seat 4: 18G4P1XstjNvItdGUITxgw folded before Flop (didn't bet)
Seat 5: opOCI2p6kW0tINuVaAqmcQ folded before Flop (didn't bet)
Seat 6: ljemhp25Zg+nlA9DLCIiUw folded before Flop (didn't bet)
Seat 8: 3RCAkueG3Vc13VpRStCB+w (button) folded before Flop (didn't bet)




PokerStars Game #59939438592:  Hold'em No Limit ($0.10/$0.25) - 2009/07/01 0:39:53 ET
Table 'KEoOIegxPF91KooL2AelUA' 6-max Seat #1 is the button
Seat 1: wsP46AGpqDjHZQmlRHKa9g ($29.30 in chips) 
Seat 4: Vv37Oa9niKKVcR6Z7ceetw ($22.20 in chips) 
Seat 5: 2NLC44AHHKHEUooUQFYV+Q ($13.35 in chips) 
Vv37Oa9niKKVcR6Z7ceetw: posts small blind $0.10
2NLC44AHHKHEUooUQFYV+Q: posts big blind $0.25
*** HOLE CARDS ***
wsP46AGpqDjHZQmlRHKa9g: folds 
Vv37Oa9niKKVcR6Z7ceetw: raises $0.50 to $0.75
2NLC44AHHKHEUooUQFYV+Q: calls $0.50
*** FLOP *** [Ad 2s 6d]
Vv37Oa9niKKVcR6Z7ceetw: checks 
2NLC44AHHKHEUooUQFYV+Q: bets $1
Vv37Oa9niKKVcR6Z7ceetw: raises $1 to $2
2NLC44AHHKHEUooUQFYV+Q: folds 
Uncalled bet ($1) returned to Vv37Oa9niKKVcR6Z7ceetw
Vv37Oa9niKKVcR6Z7ceetw collected $3.35 from pot
Vv37Oa9niKKVcR6Z7ceetw said, "2"
Vv37Oa9niKKVcR6Z7ceetw: doesn't show hand 
*** SUMMARY ***
Total pot $3.50 | Rake $0.15 
Board [Ad 2s 6d]
Seat 1: wsP46AGpqDjHZQmlRHKa9g (button) folded before Flop (didn't bet)
Seat 4: Vv37Oa9niKKVcR6Z7ceetw (small blind) collected ($3.35)
Seat 5: 2NLC44AHHKHEUooUQFYV+Q (big blind) folded on the Flop




PokerStars Game #59939438896:  Hold'em No Limit ($0.10/$0.25) - 2009/07/01 0:39:53 ET
Table 'IUwZ/e0bDHZPgsIWx0RnNg' 6-max Seat #6 is the button
Seat 2: mvFHK3pE7tCxJEqLjKC70Q ($24.40 in chips) 
Seat 3: dOX4wnYV2sEqvDbF+8KSCw ($29.90 in chips) 
Seat 4: IyZ9SVxKy7TJvRGFneWTMg ($30.35 in chips) 
Seat 5: wsP46AGpqDjHZQmlRHKa9g ($25 in chips) 
Seat 6: NhUN/JpAprdJeamFBgJH1w ($25 in chips) 
TriplePickle will be allowed to play after the button
mvFHK3pE7tCxJEqLjKC70Q: posts small blind $0.10
dOX4wnYV2sEqvDbF+8KSCw: posts big blind $0.25
*** HOLE CARDS ***
IyZ9SVxKy7TJvRGFneWTMg: raises $0.25 to $0.50
wsP46AGpqDjHZQmlRHKa9g: raises $2.25 to $2.75
NhUN/JpAprdJeamFBgJH1w: folds 
mvFHK3pE7tCxJEqLjKC70Q: folds 
dOX4wnYV2sEqvDbF+8KSCw: folds 
IyZ9SVxKy7TJvRGFneWTMg: folds 
Uncalled bet ($2.25) returned to wsP46AGpqDjHZQmlRHKa9g
wsP46AGpqDjHZQmlRHKa9g collected $1.35 from pot
*** SUMMARY ***
Total pot $1.35 | Rake $0 
Seat 2: mvFHK3pE7tCxJEqLjKC70Q (small blind) folded before Flop
Seat 3: dOX4wnYV2sEqvDbF+8KSCw (big blind) folded before Flop
Seat 4: IyZ9SVxKy7TJvRGFneWTMg folded before Flop
Seat 5: wsP46AGpqDjHZQmlRHKa9g collected ($1.35)
Seat 6: NhUN/JpAprdJeamFBgJH1w (button) folded before Flop (didn't bet)




PokerStars Game #59939438184:  Hold'em No Limit ($0.10/$0.25) - 2009/07/01 0:39:53 ET
Table 'SbSV5tlgLp0+/Z+13PW3Hg' 9-max Seat #4 is the button
Seat 1: NAP/FpFXsTsBxjDijlVzEg ($43.40 in chips) 
Seat 2: zDrucyjVn5aeekNEc3cJrA ($20.25 in chips) 
Seat 3: s7Q6uNouhe7aE8JdFb9E+A ($25 in chips) 
Seat 4: NNZypfH1f/VIj3Skf/XIzg ($4.65 in chips) 
Seat 5: z5GxcHlYz/GSz6W2uFiTtg ($19.70 in chips) 
Seat 6: qwr38jl5txoR36M7G5qi4A ($8.25 in chips) 
Seat 7: j4q3p0lesp63b1gZDwLBZw ($6.35 in chips) 
Seat 8: 7cv+9Zc9HIQHNvYsMfV3uA ($25.50 in chips) 
Seat 9: rXm4QDVJt67H20lM6n6Z7Q ($18.50 in chips) 
z5GxcHlYz/GSz6W2uFiTtg: posts small blind $0.10
qwr38jl5txoR36M7G5qi4A: posts big blind $0.25
*** HOLE CARDS ***
j4q3p0lesp63b1gZDwLBZw: raises $0.75 to $1
7cv+9Zc9HIQHNvYsMfV3uA: folds 
rXm4QDVJt67H20lM6n6Z7Q: folds 
NAP/FpFXsTsBxjDijlVzEg: folds 
zDrucyjVn5aeekNEc3cJrA: folds 
s7Q6uNouhe7aE8JdFb9E+A: folds 
NNZypfH1f/VIj3Skf/XIzg: folds 
z5GxcHlYz/GSz6W2uFiTtg: folds 
qwr38jl5txoR36M7G5qi4A: folds 
Uncalled bet ($0.75) returned to j4q3p0lesp63b1gZDwLBZw
j4q3p0lesp63b1gZDwLBZw collected $0.60 from pot
j4q3p0lesp63b1gZDwLBZw: doesn't show hand 
*** SUMMARY ***
Total pot $0.60 | Rake $0 
Seat 1: NAP/FpFXsTsBxjDijlVzEg folded before Flop (didn't bet)
Seat 2: zDrucyjVn5aeekNEc3cJrA folded before Flop (didn't bet)
Seat 3: s7Q6uNouhe7aE8JdFb9E+A folded before Flop (didn't bet)
Seat 4: NNZypfH1f/VIj3Skf/XIzg (button) folded before Flop (didn't bet)
Seat 5: z5GxcHlYz/GSz6W2uFiTtg (small blind) folded before Flop
Seat 6: qwr38jl5txoR36M7G5qi4A (big blind) folded before Flop
Seat 7: j4q3p0lesp63b1gZDwLBZw collected ($0.60)
Seat 8: 7cv+9Zc9HIQHNvYsMfV3uA folded before Flop (didn't bet)
Seat 9: rXm4QDVJt67H20lM6n6Z7Q folded before Flop (didn't bet)




PokerStars Game #59939438564:  Hold'em No Limit ($0.10/$0.25) - 2009/07/01 0:39:53 ET
Table '6ae4XiTo6B597KfSSMr8Cg' 9-max Seat #4 is the button
Seat 1: 49YfVBEOwzD3/FVw+dTTBQ ($5.65 in chips) 
Seat 2: 5s3p6yoJBNW438dsyKTP8g ($45.75 in chips) 
Seat 3: yyG4svzOpC1A+sUP/scg6w ($8.05 in chips) 
Seat 4: dfNim92Z6XK1/h5SFW5vDg ($48.75 in chips) 
Seat 5: 1K6QGyJP9P9xmRac2fH4OQ ($25.10 in chips) 
Seat 6: DlXs37dlX3tb7o/7lYXQSw ($25 in chips) 
Seat 7: 18G4P1XstjNvItdGUITxgw ($25.25 in chips) 
Seat 9: E0iYnEVO2ho7dH3QcCjw7g ($34.70 in chips) 
1K6QGyJP9P9xmRac2fH4OQ: posts small blind $0.10
DlXs37dlX3tb7o/7lYXQSw: posts big blind $0.25
lacross84: sits out 
*** HOLE CARDS ***
18G4P1XstjNvItdGUITxgw: raises $0.50 to $0.75
E0iYnEVO2ho7dH3QcCjw7g: folds 
49YfVBEOwzD3/FVw+dTTBQ: folds 
5s3p6yoJBNW438dsyKTP8g: folds 
yyG4svzOpC1A+sUP/scg6w: folds 
dfNim92Z6XK1/h5SFW5vDg: folds 
1K6QGyJP9P9xmRac2fH4OQ: folds 
DlXs37dlX3tb7o/7lYXQSw: folds 
Uncalled bet ($0.50) returned to 18G4P1XstjNvItdGUITxgw
18G4P1XstjNvItdGUITxgw collected $0.60 from pot
*** SUMMARY ***
Total pot $0.60 | Rake $0 
Seat 1: 49YfVBEOwzD3/FVw+dTTBQ folded before Flop (didn't bet)
Seat 2: 5s3p6yoJBNW438dsyKTP8g folded before Flop (didn't bet)
Seat 3: yyG4svzOpC1A+sUP/scg6w folded before Flop (didn't bet)
Seat 4: dfNim92Z6XK1/h5SFW5vDg (button) folded before Flop (didn't bet)
Seat 5: 1K6QGyJP9P9xmRac2fH4OQ (small blind) folded before Flop
Seat 6: DlXs37dlX3tb7o/7lYXQSw (big blind) folded before Flop
Seat 7: 18G4P1XstjNvItdGUITxgw collected ($0.60)
Seat 9: E0iYnEVO2ho7dH3QcCjw7g folded before Flop (didn't bet)




PokerStars Game #59939438382:  Hold'em No Limit ($0.10/$0.25) - 2009/07/01 0:39:53 ET
Table 'dZNBGqFYSwfOVZvDJ4VjIQ' 6-max Seat #3 is the button
Seat 2: NPueG39V6nKvDRuvBJ4U7g ($14.85 in chips) 
Seat 3: Qd4gQJ1hjQcU9/uDqd6Nlw ($11.20 in chips) 
Seat 5: hZJzYj+7+PvGu6ae1g//sQ ($11.15 in chips) 
Seat 6: VbudEd0ZG+qPwMO9h+hjXw ($18.70 in chips) 
df01R5ThvHspD8FgKmaDvQ will be allowed to play after the button
hZJzYj+7+PvGu6ae1g//sQ: posts small blind $0.10
VbudEd0ZG+qPwMO9h+hjXw: posts big blind $0.25
*** HOLE CARDS ***
NPueG39V6nKvDRuvBJ4U7g: folds 
Qd4gQJ1hjQcU9/uDqd6Nlw: calls $0.25
hZJzYj+7+PvGu6ae1g//sQ: calls $0.15
VbudEd0ZG+qPwMO9h+hjXw: checks 
*** FLOP *** [5s 4s Jc]
hZJzYj+7+PvGu6ae1g//sQ: checks 
VbudEd0ZG+qPwMO9h+hjXw: checks 
Qd4gQJ1hjQcU9/uDqd6Nlw: bets $0.25
hZJzYj+7+PvGu6ae1g//sQ: folds 
VbudEd0ZG+qPwMO9h+hjXw: folds 
Uncalled bet ($0.25) returned to Qd4gQJ1hjQcU9/uDqd6Nlw
Qd4gQJ1hjQcU9/uDqd6Nlw collected $0.75 from pot
Qd4gQJ1hjQcU9/uDqd6Nlw: doesn't show hand 
*** SUMMARY ***
Total pot $0.75 | Rake $0 
Board [5s 4s Jc]
Seat 2: NPueG39V6nKvDRuvBJ4U7g folded before Flop (didn't bet)
Seat 3: Qd4gQJ1hjQcU9/uDqd6Nlw (button) collected ($0.75)
Seat 5: hZJzYj+7+PvGu6ae1g//sQ (small blind) folded on the Flop
Seat 6: VbudEd0ZG+qPwMO9h+hjXw (big blind) folded on the Flop




PokerStars Game #59939439258:  Hold'em No Limit ($0.10/$0.25) - 2009/07/01 0:39:54 ET
Table 'Xi38lWH8L2JHRAsKYVX8Qg' 6-max Seat #4 is the button
Seat 1: AqQ7DFpHkgIzTwDu+rClcg ($4.55 in chips) 
Seat 2: YjCHRUY3WJtHMnkcRxvmug ($41.30 in chips) 
Seat 3: hFvl367f+GnfQv2riJlsTA ($11.30 in chips) 
Seat 4: d0J1xuhsynEY81YHwAvJ5g ($25 in chips) 
Seat 6: aogAb4Eienxztk8p2v9VVw ($21.10 in chips) 
79ID/ub1Pt/mDpCprVmOoA will be allowed to play after the button
aogAb4Eienxztk8p2v9VVw: posts small blind $0.10
AqQ7DFpHkgIzTwDu+rClcg: posts big blind $0.25
*** HOLE CARDS ***
YjCHRUY3WJtHMnkcRxvmug: calls $0.25
hFvl367f+GnfQv2riJlsTA: calls $0.25
d0J1xuhsynEY81YHwAvJ5g: folds 
aogAb4Eienxztk8p2v9VVw: folds 
AqQ7DFpHkgIzTwDu+rClcg: checks 
*** FLOP *** [9s Kh 8d]
AqQ7DFpHkgIzTwDu+rClcg: checks 
YjCHRUY3WJtHMnkcRxvmug: bets $0.50
hFvl367f+GnfQv2riJlsTA: folds 
AqQ7DFpHkgIzTwDu+rClcg: calls $0.50
*** TURN *** [9s Kh 8d] [3d]
AqQ7DFpHkgIzTwDu+rClcg: bets $1.25
YjCHRUY3WJtHMnkcRxvmug: folds 
Uncalled bet ($1.25) returned to AqQ7DFpHkgIzTwDu+rClcg
AqQ7DFpHkgIzTwDu+rClcg collected $1.80 from pot
*** SUMMARY ***
Total pot $1.85 | Rake $0.05 
Board [9s Kh 8d 3d]
Seat 1: AqQ7DFpHkgIzTwDu+rClcg (big blind) collected ($1.80)
Seat 2: YjCHRUY3WJtHMnkcRxvmug folded on the Turn
Seat 3: hFvl367f+GnfQv2riJlsTA folded on the Flop
Seat 4: d0J1xuhsynEY81YHwAvJ5g (button) folded before Flop (didn't bet)
Seat 6: aogAb4Eienxztk8p2v9VVw (small blind) folded before Flop




PokerStars Game #59939438942:  Hold'em No Limit ($0.10/$0.25) - 2009/07/01 0:39:54 ET
Table 'xkqAWQFDrFt4p81M8UsoNw' 9-max Seat #9 is the button
Seat 2: z5GxcHlYz/GSz6W2uFiTtg ($34.30 in chips) 
Seat 3: HEUqKs2EYYGGXJCepUdL0g ($7.60 in chips) 
Seat 4: gY+PO8PaVC7pBPH/9HSv6Q ($4.95 in chips) 
Seat 5: OiV1PWZ3IkN29JlmCcnTwQ ($4.55 in chips) 
Seat 6: Yv4fucyyT28mjx8V5lxKJg ($24.25 in chips) 
Seat 7: MG90wfSJZnOejs/KD3vlQQ ($48.05 in chips) 
Seat 9: Wa7bjLwN7ptOQro84PxQGw ($4.75 in chips) 
z5GxcHlYz/GSz6W2uFiTtg: posts small blind $0.10
HEUqKs2EYYGGXJCepUdL0g: posts big blind $0.25
*** HOLE CARDS ***
gY+PO8PaVC7pBPH/9HSv6Q: folds 
OiV1PWZ3IkN29JlmCcnTwQ: folds 
Yv4fucyyT28mjx8V5lxKJg: raises $0.75 to $1
MG90wfSJZnOejs/KD3vlQQ: folds 
Wa7bjLwN7ptOQro84PxQGw: folds 
z5GxcHlYz/GSz6W2uFiTtg: calls $0.90
HEUqKs2EYYGGXJCepUdL0g: folds 
*** FLOP *** [5s 2s Jh]
sasknative69 was removed from the table for failing to post
z5GxcHlYz/GSz6W2uFiTtg: checks 
Yv4fucyyT28mjx8V5lxKJg: checks 
*** TURN *** [5s 2s Jh] [Th]
z5GxcHlYz/GSz6W2uFiTtg: bets $1.50
Yv4fucyyT28mjx8V5lxKJg: folds 
Uncalled bet ($1.50) returned to z5GxcHlYz/GSz6W2uFiTtg
z5GxcHlYz/GSz6W2uFiTtg collected $2.15 from pot
*** SUMMARY ***
Total pot $2.25 | Rake $0.10 
Board [5s 2s Jh Th]
Seat 2: z5GxcHlYz/GSz6W2uFiTtg (small blind) collected ($2.15)
Seat 3: HEUqKs2EYYGGXJCepUdL0g (big blind) folded before Flop
Seat 4: gY+PO8PaVC7pBPH/9HSv6Q folded before Flop (didn't bet)
Seat 5: OiV1PWZ3IkN29JlmCcnTwQ folded before Flop (didn't bet)
Seat 6: Yv4fucyyT28mjx8V5lxKJg folded on the Turn
Seat 7: MG90wfSJZnOejs/KD3vlQQ folded before Flop (didn't bet)
Seat 9: Wa7bjLwN7ptOQro84PxQGw (button) folded before Flop (didn't bet)




PokerStars Game #59939438992:  Hold'em No Limit ($0.10/$0.25) - 2009/07/01 0:39:54 ET
Table 'srBTB98reCdD1TffxE6o7g' 6-max Seat #6 is the button
Seat 1: FEzezmgaiyVRh9sHKhd+9Q ($44 in chips) 
Seat 2: YaAEMJGY5tem39deCUQRNw ($61.35 in chips) 
Seat 3: 4YSTu0Cdzpppe1lUgCZGCQ ($31.60 in chips) 
Seat 4: nGcD53mEekM1riwMpyBSXw ($9.95 in chips) 
Seat 5: n2OZezRXTtdzQt4SuIy8TQ ($18.60 in chips) 
Seat 6: gaPMxLGp9SOj4Lq6t+/0Ig ($14.75 in chips) 
FEzezmgaiyVRh9sHKhd+9Q: posts small blind $0.10
YaAEMJGY5tem39deCUQRNw: posts big blind $0.25
*** HOLE CARDS ***
4YSTu0Cdzpppe1lUgCZGCQ: folds 
nGcD53mEekM1riwMpyBSXw: folds 
n2OZezRXTtdzQt4SuIy8TQ: calls $0.25
gaPMxLGp9SOj4Lq6t+/0Ig: calls $0.25
FEzezmgaiyVRh9sHKhd+9Q: folds 
nGcD53mEekM1riwMpyBSXw leaves the table
YaAEMJGY5tem39deCUQRNw: raises $1 to $1.25
n2OZezRXTtdzQt4SuIy8TQ: calls $1
gaPMxLGp9SOj4Lq6t+/0Ig: calls $1
*** FLOP *** [9c 4h 2h]
No1_Playa joins the table at seat #4 
YaAEMJGY5tem39deCUQRNw: bets $2.75
n2OZezRXTtdzQt4SuIy8TQ: calls $2.75
gaPMxLGp9SOj4Lq6t+/0Ig: raises $10.75 to $13.50 and is all-in
YaAEMJGY5tem39deCUQRNw: folds 
n2OZezRXTtdzQt4SuIy8TQ: calls $10.75
*** TURN *** [9c 4h 2h] [8c]
*** RIVER *** [9c 4h 2h 8c] [8h]
*** SHOW DOWN ***
n2OZezRXTtdzQt4SuIy8TQ: shows [2c 2s] (a full house, Deuces full of Eights)
gaPMxLGp9SOj4Lq6t+/0Ig: mucks hand 
n2OZezRXTtdzQt4SuIy8TQ collected $31.95 from pot
*** SUMMARY ***
Total pot $33.60 | Rake $1.65 
Board [9c 4h 2h 8c 8h]
Seat 1: FEzezmgaiyVRh9sHKhd+9Q (small blind) folded before Flop
Seat 2: YaAEMJGY5tem39deCUQRNw (big blind) folded on the Flop
Seat 3: 4YSTu0Cdzpppe1lUgCZGCQ folded before Flop (didn't bet)
Seat 4: nGcD53mEekM1riwMpyBSXw folded before Flop (didn't bet)
Seat 5: n2OZezRXTtdzQt4SuIy8TQ showed [2c 2s] and won ($31.95) with a full house, Deuces full of Eights
Seat 6: gaPMxLGp9SOj4Lq6t+/0Ig (button) mucked




PokerStars Game #59939439276:  Hold'em No Limit ($0.10/$0.25) - 2009/07/01 0:39:54 ET
Table 'NtEQAxCeIK2io1CGtW658g' 6-max Seat #1 is the button
Seat 1: lnOV7k25gyN7L5t5YKTgIg ($20.50 in chips) 
Seat 2: nc79pm0LZRdhncq55evVqA ($25.65 in chips) 
Seat 3: m2yWOKfAxqHoy5DDN87Ttw ($25 in chips) 
Seat 4: 8296 ($12 in chips) 
Seat 5: FStoHe64SQWqAsjya9pDkQ ($28.20 in chips) 
Seat 6: /gJNBeCkWL4o85/jvlZ4BA ($62 in chips) 
nc79pm0LZRdhncq55evVqA: posts small blind $0.10
m2yWOKfAxqHoy5DDN87Ttw: posts big blind $0.25
*** HOLE CARDS ***
8296: folds 
FStoHe64SQWqAsjya9pDkQ: folds 
/gJNBeCkWL4o85/jvlZ4BA: folds 
lnOV7k25gyN7L5t5YKTgIg: raises $0.50 to $0.75
nc79pm0LZRdhncq55evVqA: folds 
m2yWOKfAxqHoy5DDN87Ttw: folds 
Uncalled bet ($0.50) returned to lnOV7k25gyN7L5t5YKTgIg
lnOV7k25gyN7L5t5YKTgIg collected $0.60 from pot
lnOV7k25gyN7L5t5YKTgIg: doesn't show hand 
*** SUMMARY ***
Total pot $0.60 | Rake $0 
Seat 1: lnOV7k25gyN7L5t5YKTgIg (button) collected ($0.60)
Seat 2: nc79pm0LZRdhncq55evVqA (small blind) folded before Flop
Seat 3: m2yWOKfAxqHoy5DDN87Ttw (big blind) folded before Flop
Seat 4: 8296 folded before Flop (didn't bet)
Seat 5: FStoHe64SQWqAsjya9pDkQ folded before Flop (didn't bet)
Seat 6: /gJNBeCkWL4o85/jvlZ4BA folded before Flop (didn't bet)




PokerStars Game #59939439518:  Hold'em No Limit ($0.10/$0.25) - 2009/07/01 0:39:55 ET
Table 'sgB7AwZtVgDTf4fi8RwWFQ' 9-max Seat #6 is the button
Seat 1: QEbIGci+itdw+re8RM5fZA ($25 in chips) 
Seat 2: DnDcAdn9P0zGovMERigpFA ($32 in chips) 
Seat 3: OlPJsgR4xypSg/w1z7Gyvw ($20.10 in chips) 
Seat 5: gPFzi0PLRAvfKu2GYwa1VA ($16.55 in chips) 
Seat 6: 1q23ISSsSMhv2lHXBfj9/A ($23.40 in chips) 
Seat 8: Nq5F1B22aaLLZ+D9HbzcGg ($21.75 in chips) 
Seat 9: MG90wfSJZnOejs/KD3vlQQ ($32.60 in chips) 
Nq5F1B22aaLLZ+D9HbzcGg: posts small blind $0.10
MG90wfSJZnOejs/KD3vlQQ: posts big blind $0.25
*** HOLE CARDS ***
QEbIGci+itdw+re8RM5fZA: folds 
DnDcAdn9P0zGovMERigpFA: folds 
OlPJsgR4xypSg/w1z7Gyvw: folds 
gPFzi0PLRAvfKu2GYwa1VA: folds 
1q23ISSsSMhv2lHXBfj9/A: folds 
Nq5F1B22aaLLZ+D9HbzcGg: calls $0.15
MG90wfSJZnOejs/KD3vlQQ: checks 
*** FLOP *** [9c Tc 8h]
Nq5F1B22aaLLZ+D9HbzcGg: bets $0.75
MG90wfSJZnOejs/KD3vlQQ: folds 
Uncalled bet ($0.75) returned to Nq5F1B22aaLLZ+D9HbzcGg
Nq5F1B22aaLLZ+D9HbzcGg collected $0.50 from pot
Nq5F1B22aaLLZ+D9HbzcGg: doesn't show hand 
*** SUMMARY ***
Total pot $0.50 | Rake $0 
Board [9c Tc 8h]
Seat 1: QEbIGci+itdw+re8RM5fZA folded before Flop (didn't bet)
Seat 2: DnDcAdn9P0zGovMERigpFA folded before Flop (didn't bet)
Seat 3: OlPJsgR4xypSg/w1z7Gyvw folded before Flop (didn't bet)
Seat 5: gPFzi0PLRAvfKu2GYwa1VA folded before Flop (didn't bet)
Seat 6: 1q23ISSsSMhv2lHXBfj9/A (button) folded before Flop (didn't bet)
Seat 8: Nq5F1B22aaLLZ+D9HbzcGg (small blind) collected ($0.50)
Seat 9: MG90wfSJZnOejs/KD3vlQQ (big blind) folded on the Flop




PokerStars Game #59939439622:  Hold'em No Limit ($0.10/$0.25) - 2009/07/01 0:39:55 ET
Table 'g6ryG70feTw9nNm+XJLuXw' 6-max Seat #3 is the button
Seat 1: v+QfkGiuj9bgtuNoVnDO8w ($28.95 in chips) 
Seat 2: SxIIgwXYLkwd6m3wLyPTCw ($25.25 in chips) 
Seat 3: /6h8PvAHQmfuMUZ8OUF6Xw ($24.10 in chips) 
Seat 4: GC/9yVD59DUCX7hUI7gcLw ($38 in chips) 
Seat 5: EE16Ua5b1HSsYej5zeXOlA ($25.60 in chips) 
GC/9yVD59DUCX7hUI7gcLw: posts small blind $0.10
EE16Ua5b1HSsYej5zeXOlA: posts big blind $0.25
*** HOLE CARDS ***
v+QfkGiuj9bgtuNoVnDO8w: raises $0.75 to $1
SxIIgwXYLkwd6m3wLyPTCw: folds 
/6h8PvAHQmfuMUZ8OUF6Xw: calls $1
GC/9yVD59DUCX7hUI7gcLw: folds 
EE16Ua5b1HSsYej5zeXOlA: calls $0.75
*** FLOP *** [6d 7s 8h]
EE16Ua5b1HSsYej5zeXOlA: checks 
v+QfkGiuj9bgtuNoVnDO8w: checks 
/6h8PvAHQmfuMUZ8OUF6Xw: bets $2
EE16Ua5b1HSsYej5zeXOlA: folds 
v+QfkGiuj9bgtuNoVnDO8w: folds 
Uncalled bet ($2) returned to /6h8PvAHQmfuMUZ8OUF6Xw
/6h8PvAHQmfuMUZ8OUF6Xw collected $2.95 from pot
/6h8PvAHQmfuMUZ8OUF6Xw: doesn't show hand 
*** SUMMARY ***
Total pot $3.10 | Rake $0.15 
Board [6d 7s 8h]
Seat 1: v+QfkGiuj9bgtuNoVnDO8w folded on the Flop
Seat 2: SxIIgwXYLkwd6m3wLyPTCw folded before Flop (didn't bet)
Seat 3: /6h8PvAHQmfuMUZ8OUF6Xw (button) collected ($2.95)
Seat 4: GC/9yVD59DUCX7hUI7gcLw (small blind) folded before Flop
Seat 5: EE16Ua5b1HSsYej5zeXOlA (big blind) folded on the Flop




PokerStars Game #59939439684:  Hold'em No Limit ($0.10/$0.25) - 2009/07/01 0:39:55 ET
Table '6wawJ+MkkvuC3coG6r+Yhg' 6-max Seat #5 is the button
Seat 1: ELW+DKizJhLK7k40PMkD2Q ($25 in chips) 
Seat 2: LtASJ9OlkqGrrUKGQlpGAw ($27.90 in chips) 
Seat 3: KYBwVA7jgmSrbIEbEGElVg ($18.95 in chips) 
Seat 4: cS21pIxRHx5Gt42o7hPZzw ($12.75 in chips) 
Seat 5: A8uIskXJTblhVXWuYr+lkw ($15.65 in chips) 
varanasi will be allowed to play after the button
ELW+DKizJhLK7k40PMkD2Q: posts small blind $0.10
LtASJ9OlkqGrrUKGQlpGAw: posts big blind $0.25
*** HOLE CARDS ***
KYBwVA7jgmSrbIEbEGElVg: raises $0.25 to $0.50
cS21pIxRHx5Gt42o7hPZzw: folds 
A8uIskXJTblhVXWuYr+lkw: calls $0.50
ELW+DKizJhLK7k40PMkD2Q: folds 
LtASJ9OlkqGrrUKGQlpGAw: folds 
*** FLOP *** [9s Qs 6d]
KYBwVA7jgmSrbIEbEGElVg: bets $1
A8uIskXJTblhVXWuYr+lkw: folds 
Uncalled bet ($1) returned to KYBwVA7jgmSrbIEbEGElVg
KYBwVA7jgmSrbIEbEGElVg collected $1.30 from pot
*** SUMMARY ***
Total pot $1.35 | Rake $0.05 
Board [9s Qs 6d]
Seat 1: ELW+DKizJhLK7k40PMkD2Q (small blind) folded before Flop
Seat 2: LtASJ9OlkqGrrUKGQlpGAw (big blind) folded before Flop
Seat 3: KYBwVA7jgmSrbIEbEGElVg collected ($1.30)
Seat 4: cS21pIxRHx5Gt42o7hPZzw folded before Flop (didn't bet)
Seat 5: A8uIskXJTblhVXWuYr+lkw (button) folded on the Flop




PokerStars Game #59939439612:  Hold'em No Limit ($0.10/$0.25) - 2009/07/01 0:39:55 ET
Table 'Mef6A0EMopL6WaFO5/KO9g' 6-max Seat #5 is the button
Seat 1: ELW+DKizJhLK7k40PMkD2Q ($29.75 in chips) 
Seat 2: 8ClCHtFXGNplITm+63KB+Q ($33.50 in chips) 
Seat 3: Wq26opBLDGJe91GRJn2epg ($15 in chips) 
Seat 4: pisIQ6Ztya1lC0kTtGSTHw ($59.05 in chips) 
Seat 5: WrLI51S2iMb8GLMB83gGqA ($29.20 in chips) 
Parks Playa will be allowed to play after the button
ELW+DKizJhLK7k40PMkD2Q: posts small blind $0.10
8ClCHtFXGNplITm+63KB+Q: posts big blind $0.25
Wq26opBLDGJe91GRJn2epg: posts big blind $0.25
*** HOLE CARDS ***
Wq26opBLDGJe91GRJn2epg: checks 
pisIQ6Ztya1lC0kTtGSTHw: calls $0.25
WrLI51S2iMb8GLMB83gGqA: folds 
ELW+DKizJhLK7k40PMkD2Q: raises $0.75 to $1
8ClCHtFXGNplITm+63KB+Q: folds 
Wq26opBLDGJe91GRJn2epg: calls $0.75
pisIQ6Ztya1lC0kTtGSTHw: calls $0.75
*** FLOP *** [7d Qd Kd]
ELW+DKizJhLK7k40PMkD2Q: checks 
Wq26opBLDGJe91GRJn2epg: bets $1.25
pisIQ6Ztya1lC0kTtGSTHw: folds 
ELW+DKizJhLK7k40PMkD2Q: calls $1.25
*** TURN *** [7d Qd Kd] [7s]
ELW+DKizJhLK7k40PMkD2Q: checks 
Wq26opBLDGJe91GRJn2epg: bets $1.75
ELW+DKizJhLK7k40PMkD2Q: calls $1.75
*** RIVER *** [7d Qd Kd 7s] [7c]
ELW+DKizJhLK7k40PMkD2Q: checks 
Wq26opBLDGJe91GRJn2epg: bets $3
ELW+DKizJhLK7k40PMkD2Q: folds 
Uncalled bet ($3) returned to Wq26opBLDGJe91GRJn2epg
Wq26opBLDGJe91GRJn2epg collected $8.80 from pot
Wq26opBLDGJe91GRJn2epg: doesn't show hand 
*** SUMMARY ***
Total pot $9.25 | Rake $0.45 
Board [7d Qd Kd 7s 7c]
Seat 1: ELW+DKizJhLK7k40PMkD2Q (small blind) folded on the River
Seat 2: 8ClCHtFXGNplITm+63KB+Q (big blind) folded before Flop
Seat 3: Wq26opBLDGJe91GRJn2epg collected ($8.80)
Seat 4: pisIQ6Ztya1lC0kTtGSTHw folded on the Flop
Seat 5: WrLI51S2iMb8GLMB83gGqA (button) folded before Flop (didn't bet)




